PokerStars Game #59941741046:  Hold'em No Limit ($0.10/$0.25) - 2009/07/01 1:44:40 ET
Table 'xPn6TS/y/OWkX7Qa+MUuKA' 6-max Seat #4 is the button
Seat 1: JFIAqU8lCZ0vWwEl4bdGsg ($43.05 in chips) 
Seat 2: buyjetgNT1McXtdaP4zynA ($28.35 in chips) 
Seat 3: q6WfTUAD9mowIP63ASq2Dg ($24.90 in chips) 
Seat 4: SS/yfeArhULzIcOPe8MdPg ($28.65 in chips) 
Seat 5: lquriepNQBhDV5P1SWHhnA ($26.60 in chips) 
Seat 6: DihMHaz4WNETH1bPDe13kA ($25.35 in chips) 
lquriepNQBhDV5P1SWHhnA: posts small blind $0.10
DihMHaz4WNETH1bPDe13kA: posts big blind $0.25
*** HOLE CARDS ***
JFIAqU8lCZ0vWwEl4bdGsg: folds 
buyjetgNT1McXtdaP4zynA: calls $0.25
q6WfTUAD9mowIP63ASq2Dg: calls $0.25
SS/yfeArhULzIcOPe8MdPg: folds 
lquriepNQBhDV5P1SWHhnA: raises $0.50 to $0.75
DihMHaz4WNETH1bPDe13kA: folds 
buyjetgNT1McXtdaP4zynA: calls $0.50
q6WfTUAD9mowIP63ASq2Dg: calls $0.50
*** FLOP *** [Qh 6c 5s]
lquriepNQBhDV5P1SWHhnA: bets $2
buyjetgNT1McXtdaP4zynA: folds 
q6WfTUAD9mowIP63ASq2Dg: folds 
Uncalled bet ($2) returned to lquriepNQBhDV5P1SWHhnA
lquriepNQBhDV5P1SWHhnA collected $2.40 from pot
lquriepNQBhDV5P1SWHhnA: doesn't show hand 
*** SUMMARY ***
Total pot $2.50 | Rake $0.10 
Board [Qh 6c 5s]
Seat 1: JFIAqU8lCZ0vWwEl4bdGsg folded before Flop (didn't bet)
Seat 2: buyjetgNT1McXtdaP4zynA folded on the Flop
Seat 3: q6WfTUAD9mowIP63ASq2Dg folded on the Flop
Seat 4: SS/yfeArhULzIcOPe8MdPg (button) folded before Flop (didn't bet)
Seat 5: lquriepNQBhDV5P1SWHhnA (small blind) collected ($2.40)
Seat 6: DihMHaz4WNETH1bPDe13kA (big blind) folded before Flop




PokerStars Game #59941740820:  Hold'em No Limit ($0.10/$0.25) - 2009/07/01 1:44:40 ET
Table '29D3eoQzK5kOAT0OIDS2uQ' 6-max Seat #6 is the button
Seat 1: kG34n23qFQA3nzdOJTQ1dA ($46.50 in chips) 
Seat 2: FyE+TQ5JcCqI/tCCHf0jGA ($16.30 in chips) 
Seat 3: z3tQwy28dp5FykDJC/wzQw ($17.80 in chips) 
Seat 4: MqMK8OWPSY1V4stf1Hy5Jw ($35.90 in chips) 
Seat 5: Q3EMN7b0ie81AFWkDrhCjw ($23.65 in chips) 
Seat 6: bWbV4MVB/vVpiES1Ut4hew ($30.05 in chips) 
kG34n23qFQA3nzdOJTQ1dA: posts small blind $0.10
FyE+TQ5JcCqI/tCCHf0jGA: posts big blind $0.25
*** HOLE CARDS ***
z3tQwy28dp5FykDJC/wzQw: folds 
MqMK8OWPSY1V4stf1Hy5Jw: folds 
Q3EMN7b0ie81AFWkDrhCjw: calls $0.25
bWbV4MVB/vVpiES1Ut4hew: raises $1 to $1.25
kG34n23qFQA3nzdOJTQ1dA: folds 
FyE+TQ5JcCqI/tCCHf0jGA: folds 
Q3EMN7b0ie81AFWkDrhCjw: folds 
Uncalled bet ($1) returned to bWbV4MVB/vVpiES1Ut4hew
bWbV4MVB/vVpiES1Ut4hew collected $0.85 from pot
*** SUMMARY ***
Total pot $0.85 | Rake $0 
Seat 1: kG34n23qFQA3nzdOJTQ1dA (small blind) folded before Flop
Seat 2: FyE+TQ5JcCqI/tCCHf0jGA (big blind) folded before Flop
Seat 3: z3tQwy28dp5FykDJC/wzQw folded before Flop (didn't bet)
Seat 4: MqMK8OWPSY1V4stf1Hy5Jw folded before Flop (didn't bet)
Seat 5: Q3EMN7b0ie81AFWkDrhCjw folded before Flop
Seat 6: bWbV4MVB/vVpiES1Ut4hew (button) collected ($0.85)




PokerStars Game #59941740730:  Hold'em No Limit ($0.10/$0.25) - 2009/07/01 1:44:40 ET
Table '3Ns9nuTkynfwbBfBXzg6ww' 6-max Seat #5 is the button
Seat 1: epAUIB7h2FJXzUPRIvSkRA ($25.35 in chips) 
Seat 2: zxeVQGaMKDsDzmSY+AInjA ($36.65 in chips) 
Seat 3: eL3+wCBjFGfQ5FMdIZihwA ($24.30 in chips) 
Seat 4: qGHGf/553gQnDoklMRe3tg ($30.60 in chips) 
Seat 5: wqphQtauX5Qn7WRJZS1flA ($25.30 in chips) 
Seat 6: DE9hRlt14g+JdsRQ4wT7hg ($33.30 in chips) 
DE9hRlt14g+JdsRQ4wT7hg: posts small blind $0.10
epAUIB7h2FJXzUPRIvSkRA: posts big blind $0.25
*** HOLE CARDS ***
zxeVQGaMKDsDzmSY+AInjA: folds 
eL3+wCBjFGfQ5FMdIZihwA: folds 
qGHGf/553gQnDoklMRe3tg: folds 
wqphQtauX5Qn7WRJZS1flA: folds 
DE9hRlt14g+JdsRQ4wT7hg: folds 
Uncalled bet ($0.15) returned to epAUIB7h2FJXzUPRIvSkRA
epAUIB7h2FJXzUPRIvSkRA collected $0.20 from pot
epAUIB7h2FJXzUPRIvSkRA: doesn't show hand 
*** SUMMARY ***
Total pot $0.20 | Rake $0 
Seat 1: epAUIB7h2FJXzUPRIvSkRA (big blind) collected ($0.20)
Seat 2: zxeVQGaMKDsDzmSY+AInjA folded before Flop (didn't bet)
Seat 3: eL3+wCBjFGfQ5FMdIZihwA folded before Flop (didn't bet)
Seat 4: qGHGf/553gQnDoklMRe3tg folded before Flop (didn't bet)
Seat 5: wqphQtauX5Qn7WRJZS1flA (button) folded before Flop (didn't bet)
Seat 6: DE9hRlt14g+JdsRQ4wT7hg (small blind) folded before Flop




PokerStars Game #59941740560:  Hold'em No Limit ($0.10/$0.25) - 2009/07/01 1:44:40 ET
Table 'nXVbUw6/HYwA6x21+IZ3XQ' 9-max Seat #9 is the button
Seat 2: 9lvO/qyU+xrU95Teu1fv0g ($10.35 in chips) 
Seat 3: MB0wa15P+9QHcBApEdgQFw ($10 in chips) 
Seat 5: M/9j4wkHH9i1JM51vgi1VA ($28.70 in chips) 
Seat 6: ljemhp25Zg+nlA9DLCIiUw ($27.20 in chips) 
Seat 7: ShCS62CJp4MKfKLKvGKQbA ($12.15 in chips) 
Seat 8: dfNim92Z6XK1/h5SFW5vDg ($25 in chips) 
Seat 9: OTCjTlu92MEBtX/i9Gm7yA ($12.20 in chips) 
9lvO/qyU+xrU95Teu1fv0g: posts small blind $0.10
MB0wa15P+9QHcBApEdgQFw: posts big blind $0.25
SpiiQQAzy4MUgV3I5W8giw: sits out 
M/9j4wkHH9i1JM51vgi1VA: posts big blind $0.25
*** HOLE CARDS ***
M/9j4wkHH9i1JM51vgi1VA: checks 
ljemhp25Zg+nlA9DLCIiUw: folds 
ShCS62CJp4MKfKLKvGKQbA: calls $0.25
dfNim92Z6XK1/h5SFW5vDg: raises $1 to $1.25
OTCjTlu92MEBtX/i9Gm7yA: calls $1.25
9lvO/qyU+xrU95Teu1fv0g: folds 
MB0wa15P+9QHcBApEdgQFw: folds 
M/9j4wkHH9i1JM51vgi1VA: calls $1
ShCS62CJp4MKfKLKvGKQbA: calls $1
*** FLOP *** [Ts 2d 9c]
M/9j4wkHH9i1JM51vgi1VA: checks 
ShCS62CJp4MKfKLKvGKQbA: checks 
dfNim92Z6XK1/h5SFW5vDg: checks 
OTCjTlu92MEBtX/i9Gm7yA: checks 
*** TURN *** [Ts 2d 9c] [8s]
M/9j4wkHH9i1JM51vgi1VA: bets $1.25
zDrucyjVn5aeekNEc3cJrA has returned
ShCS62CJp4MKfKLKvGKQbA: folds 
dfNim92Z6XK1/h5SFW5vDg: folds 
OTCjTlu92MEBtX/i9Gm7yA: calls $1.25
*** RIVER *** [Ts 2d 9c 8s] [As]
M/9j4wkHH9i1JM51vgi1VA: checks 
OTCjTlu92MEBtX/i9Gm7yA: checks 
*** SHOW DOWN ***
M/9j4wkHH9i1JM51vgi1VA: shows [Jc Js] (a pair of Jacks)
OTCjTlu92MEBtX/i9Gm7yA: mucks hand 
M/9j4wkHH9i1JM51vgi1VA collected $7.50 from pot
*** SUMMARY ***
Total pot $7.85 | Rake $0.35 
Board [Ts 2d 9c 8s As]
Seat 2: 9lvO/qyU+xrU95Teu1fv0g (small blind) folded before Flop
Seat 3: MB0wa15P+9QHcBApEdgQFw (big blind) folded before Flop
Seat 5: M/9j4wkHH9i1JM51vgi1VA showed [Jc Js] and won ($7.50) with a pair of Jacks
Seat 6: ljemhp25Zg+nlA9DLCIiUw folded before Flop (didn't bet)
Seat 7: ShCS62CJp4MKfKLKvGKQbA folded on the Turn
Seat 8: dfNim92Z6XK1/h5SFW5vDg folded on the Turn
Seat 9: OTCjTlu92MEBtX/i9Gm7yA (button) mucked




PokerStars Game #59941740958:  Hold'em No Limit ($0.10/$0.25) - 2009/07/01 1:44:40 ET
Table 'ohAuixfiLOYDylNUG5mNUw' 9-max Seat #2 is the button
Seat 2: Th3FldXKQW6hWVVPahaoOQ ($27.40 in chips) 
Seat 3: gSakoFAgDDzXSb2eNBWKcg ($14.75 in chips) 
Seat 5: wub1jsnHlpWmOX4uczVADA ($7.15 in chips) 
Seat 6: MtVtHDqIJTyUcXkRBBDIVA ($25 in chips) 
Seat 7: +qc/EYCgLC65SpGvr35eNg ($24.65 in chips) 
Seat 8: ppMlNkhYgErlt4fuJO7ADA ($2.50 in chips) 
Seat 9: CT7Xj/V/O5rBlhtt+RZeFQ ($25.60 in chips) 
gSakoFAgDDzXSb2eNBWKcg: posts small blind $0.10
AiXn/9o1EwOPZUHujnh/bA has timed out while being disconnected
AiXn/9o1EwOPZUHujnh/bA: is sitting out 
wub1jsnHlpWmOX4uczVADA: posts big blind $0.25
qwr38jl5txoR36M7G5qi4A: sits out 
*** HOLE CARDS ***
MtVtHDqIJTyUcXkRBBDIVA: folds 
+qc/EYCgLC65SpGvr35eNg: folds 
ppMlNkhYgErlt4fuJO7ADA: folds 
CT7Xj/V/O5rBlhtt+RZeFQ: folds 
Th3FldXKQW6hWVVPahaoOQ: folds 
AiXn/9o1EwOPZUHujnh/bA has returned
gSakoFAgDDzXSb2eNBWKcg: folds 
Uncalled bet ($0.15) returned to wub1jsnHlpWmOX4uczVADA
wub1jsnHlpWmOX4uczVADA collected $0.20 from pot
*** SUMMARY ***
Total pot $0.20 | Rake $0 
Seat 2: Th3FldXKQW6hWVVPahaoOQ (button) folded before Flop (didn't bet)
Seat 3: gSakoFAgDDzXSb2eNBWKcg (small blind) folded before Flop
Seat 5: wub1jsnHlpWmOX4uczVADA (big blind) collected ($0.20)
Seat 6: MtVtHDqIJTyUcXkRBBDIVA folded before Flop (didn't bet)
Seat 7: +qc/EYCgLC65SpGvr35eNg folded before Flop (didn't bet)
Seat 8: ppMlNkhYgErlt4fuJO7ADA folded before Flop (didn't bet)
Seat 9: CT7Xj/V/O5rBlhtt+RZeFQ folded before Flop (didn't bet)




PokerStars Game #59941741384:  Hold'em No Limit ($0.10/$0.25) - 2009/07/01 1:44:41 ET
Table 'aaXqTKUnxrX9DYXtxhWXxA' 6-max Seat #6 is the button
Seat 1: aSrj4lVmn2owyQ1RbbOqxQ ($24.75 in chips) 
Seat 2: DE9hRlt14g+JdsRQ4wT7hg ($33.70 in chips) 
Seat 3: uUXdcVMNa05rfbntdvplfw ($8.35 in chips) 
Seat 4: 48oT5xFI+5CHUJlfoGrE4w ($9.65 in chips) 
Seat 5: kyRaCIljYA6l33lSKQfNsg ($26.95 in chips) 
Seat 6: buyjetgNT1McXtdaP4zynA ($49.20 in chips) 
aSrj4lVmn2owyQ1RbbOqxQ: posts small blind $0.10
DE9hRlt14g+JdsRQ4wT7hg: posts big blind $0.25
*** HOLE CARDS ***
uUXdcVMNa05rfbntdvplfw: folds 
48oT5xFI+5CHUJlfoGrE4w: folds 
kyRaCIljYA6l33lSKQfNsg: raises $0.50 to $0.75
buyjetgNT1McXtdaP4zynA: folds 
aSrj4lVmn2owyQ1RbbOqxQ: calls $0.65
DE9hRlt14g+JdsRQ4wT7hg: folds 
*** FLOP *** [Th 7c 4c]
aSrj4lVmn2owyQ1RbbOqxQ: checks 
kyRaCIljYA6l33lSKQfNsg: bets $1.25
aSrj4lVmn2owyQ1RbbOqxQ: raises $2.25 to $3.50
kyRaCIljYA6l33lSKQfNsg: folds 
Uncalled bet ($2.25) returned to aSrj4lVmn2owyQ1RbbOqxQ
aSrj4lVmn2owyQ1RbbOqxQ collected $4.05 from pot
aSrj4lVmn2owyQ1RbbOqxQ: doesn't show hand 
*** SUMMARY ***
Total pot $4.25 | Rake $0.20 
Board [Th 7c 4c]
Seat 1: aSrj4lVmn2owyQ1RbbOqxQ (small blind) collected ($4.05)
Seat 2: DE9hRlt14g+JdsRQ4wT7hg (big blind) folded before Flop
Seat 3: uUXdcVMNa05rfbntdvplfw folded before Flop (didn't bet)
Seat 4: 48oT5xFI+5CHUJlfoGrE4w folded before Flop (didn't bet)
Seat 5: kyRaCIljYA6l33lSKQfNsg folded on the Flop
Seat 6: buyjetgNT1McXtdaP4zynA (button) folded before Flop (didn't bet)




PokerStars Game #59941741296:  Hold'em No Limit ($0.10/$0.25) - 2009/07/01 1:44:41 ET
Table 'g+mPuNJBCHKE9ents7ZGtg' 6-max Seat #2 is the button
Seat 1: cezpHJ8FB07dj0xG+LhOvw ($58.65 in chips) 
Seat 2: fZQg9veL7Dd/Z04ZTjC+wQ ($65.70 in chips) 
Seat 3: FYepjhAvF8ZdVCmqHIy+eQ ($30 in chips) 
Seat 4: yVrjRIW0SMxgpvqSIPSe/w ($13.55 in chips) 
Seat 5: D3ikCR8c/o9jB5irZ3uGlw ($12.30 in chips) 
Seat 6: Mn2V28t5aGq2d09z+/o6Fw ($24.65 in chips) 
FYepjhAvF8ZdVCmqHIy+eQ: posts small blind $0.10
yVrjRIW0SMxgpvqSIPSe/w: posts big blind $0.25
*** HOLE CARDS ***
D3ikCR8c/o9jB5irZ3uGlw: calls $0.25
Mn2V28t5aGq2d09z+/o6Fw has timed out
Mn2V28t5aGq2d09z+/o6Fw: folds 
Mn2V28t5aGq2d09z+/o6Fw is sitting out
cezpHJ8FB07dj0xG+LhOvw: folds 
fZQg9veL7Dd/Z04ZTjC+wQ: folds 
Mn2V28t5aGq2d09z+/o6Fw has returned
FYepjhAvF8ZdVCmqHIy+eQ: folds 
yVrjRIW0SMxgpvqSIPSe/w: checks 
*** FLOP *** [Qc Ac 9d]
yVrjRIW0SMxgpvqSIPSe/w: checks 
D3ikCR8c/o9jB5irZ3uGlw: checks 
*** TURN *** [Qc Ac 9d] [Jh]
yVrjRIW0SMxgpvqSIPSe/w: checks 
D3ikCR8c/o9jB5irZ3uGlw: bets $0.25
yVrjRIW0SMxgpvqSIPSe/w: folds 
Uncalled bet ($0.25) returned to D3ikCR8c/o9jB5irZ3uGlw
D3ikCR8c/o9jB5irZ3uGlw collected $0.60 from pot
*** SUMMARY ***
Total pot $0.60 | Rake $0 
Board [Qc Ac 9d Jh]
Seat 1: cezpHJ8FB07dj0xG+LhOvw folded before Flop (didn't bet)
Seat 2: fZQg9veL7Dd/Z04ZTjC+wQ (button) folded before Flop (didn't bet)
Seat 3: FYepjhAvF8ZdVCmqHIy+eQ (small blind) folded before Flop
Seat 4: yVrjRIW0SMxgpvqSIPSe/w (big blind) folded on the Turn
Seat 5: D3ikCR8c/o9jB5irZ3uGlw collected ($0.60)
Seat 6: Mn2V28t5aGq2d09z+/o6Fw folded before Flop (didn't bet)




PokerStars Game #59941741300:  Hold'em No Limit ($0.10/$0.25) - 2009/07/01 1:44:41 ET
Table 'tq5CvS0RUqGkuBK0XTzqqg' 6-max Seat #6 is the button
Seat 1: +ZlnqPoP3Hg4BIUxDfKd/A ($30.20 in chips) 
Seat 2: 2m6ZFAdj01UZd4WtEySXXQ ($5.10 in chips) 
Seat 3: PbMzPZIePKifKQZfKDkbIw ($53.60 in chips) 
Seat 4: UT5XpwOH1ipkOF7n1MqDJA ($19.40 in chips) 
Seat 5: qGHGf/553gQnDoklMRe3tg ($33.05 in chips) 
Seat 6: L3/N/gliETan8N5Gim5h4Q ($25.70 in chips) 
+ZlnqPoP3Hg4BIUxDfKd/A: posts small blind $0.10
2m6ZFAdj01UZd4WtEySXXQ: posts big blind $0.25
*** HOLE CARDS ***
PbMzPZIePKifKQZfKDkbIw: calls $0.25
UT5XpwOH1ipkOF7n1MqDJA: raises $1 to $1.25
qGHGf/553gQnDoklMRe3tg: folds 
L3/N/gliETan8N5Gim5h4Q: raises $2.75 to $4
+ZlnqPoP3Hg4BIUxDfKd/A: folds 
2m6ZFAdj01UZd4WtEySXXQ: folds 
PbMzPZIePKifKQZfKDkbIw: folds 
UT5XpwOH1ipkOF7n1MqDJA: raises $15.40 to $19.40 and is all-in
L3/N/gliETan8N5Gim5h4Q: calls $15.40
*** FLOP *** [Qd 6d 2s]
*** TURN *** [Qd 6d 2s] [9d]
*** RIVER *** [Qd 6d 2s 9d] [3d]
*** SHOW DOWN ***
UT5XpwOH1ipkOF7n1MqDJA: shows [Qh Qs] (three of a kind, Queens)
L3/N/gliETan8N5Gim5h4Q: mucks hand 
UT5XpwOH1ipkOF7n1MqDJA collected $37.45 from pot
*** SUMMARY ***
Total pot $39.40 | Rake $1.95 
Board [Qd 6d 2s 9d 3d]
Seat 1: +ZlnqPoP3Hg4BIUxDfKd/A (small blind) folded before Flop
Seat 2: 2m6ZFAdj01UZd4WtEySXXQ (big blind) folded before Flop
Seat 3: PbMzPZIePKifKQZfKDkbIw folded before Flop
Seat 4: UT5XpwOH1ipkOF7n1MqDJA showed [Qh Qs] and won ($37.45) with three of a kind, Queens
Seat 5: qGHGf/553gQnDoklMRe3tg folded before Flop (didn't bet)
Seat 6: L3/N/gliETan8N5Gim5h4Q (button) mucked




PokerStars Game #59941741574:  Hold'em No Limit ($0.10/$0.25) - 2009/07/01 1:44:41 ET
Table 'Zi9/NqNs3XoL1eWhMCyZyg' 9-max Seat #5 is the button
Seat 2: 1wKfgJ8xXIiuc8C6qjkxhg ($4.75 in chips) 
Seat 3: ETC7YyRJTa2Ovhln64Ni5Q ($27.75 in chips) 
Seat 4: dmYlc+1cjwZMJ7wV+Z0rRg ($21.30 in chips) 
Seat 5: JTINtdu/1/EQCVfalLD/xQ ($11.05 in chips) 
Seat 6: YQhfmYhgnDDlWCAFmBb36Q ($14.75 in chips) 
Seat 7: 0QdZrkFD7aGKeBXPGbIomA ($4.10 in chips) 
Seat 8: nm4Dj/f+jJEwKVsUnKh73g ($37 in chips) 
Seat 9: tYsOBqdU1+x+yFI7zHO7hQ ($31.65 in chips) 
YQhfmYhgnDDlWCAFmBb36Q: posts small blind $0.10
0QdZrkFD7aGKeBXPGbIomA: posts big blind $0.25
X6+pSIPfovPcE87t+LmUKQ: sits out 
*** HOLE CARDS ***
nm4Dj/f+jJEwKVsUnKh73g: raises $0.25 to $0.50
tYsOBqdU1+x+yFI7zHO7hQ: folds 
1wKfgJ8xXIiuc8C6qjkxhg: folds 
ETC7YyRJTa2Ovhln64Ni5Q: folds 
dmYlc+1cjwZMJ7wV+Z0rRg: raises $0.75 to $1.25
JTINtdu/1/EQCVfalLD/xQ: folds 
YQhfmYhgnDDlWCAFmBb36Q: folds 
0QdZrkFD7aGKeBXPGbIomA: calls $1
nm4Dj/f+jJEwKVsUnKh73g: calls $0.75
*** FLOP *** [5h 2c Ks]
0QdZrkFD7aGKeBXPGbIomA: checks 
nm4Dj/f+jJEwKVsUnKh73g: checks 
dmYlc+1cjwZMJ7wV+Z0rRg: bets $2.50
0QdZrkFD7aGKeBXPGbIomA: folds 
nm4Dj/f+jJEwKVsUnKh73g: folds 
Uncalled bet ($2.50) returned to dmYlc+1cjwZMJ7wV+Z0rRg
dmYlc+1cjwZMJ7wV+Z0rRg collected $3.70 from pot
dmYlc+1cjwZMJ7wV+Z0rRg: doesn't show hand 
*** SUMMARY ***
Total pot $3.85 | Rake $0.15 
Board [5h 2c Ks]
Seat 2: 1wKfgJ8xXIiuc8C6qjkxhg folded before Flop (didn't bet)
Seat 3: ETC7YyRJTa2Ovhln64Ni5Q folded before Flop (didn't bet)
Seat 4: dmYlc+1cjwZMJ7wV+Z0rRg collected ($3.70)
Seat 5: JTINtdu/1/EQCVfalLD/xQ (button) folded before Flop (didn't bet)
Seat 6: YQhfmYhgnDDlWCAFmBb36Q (small blind) folded before Flop
Seat 7: 0QdZrkFD7aGKeBXPGbIomA (big blind) folded on the Flop
Seat 8: nm4Dj/f+jJEwKVsUnKh73g folded on the Flop
Seat 9: tYsOBqdU1+x+yFI7zHO7hQ folded before Flop (didn't bet)




PokerStars Game #59941741082:  Hold'em No Limit ($0.10/$0.25) - 2009/07/01 1:44:41 ET
Table '3760QYRYyCWeXf0rLZ5S2g' 9-max Seat #5 is the button
Seat 1: CT7Xj/V/O5rBlhtt+RZeFQ ($27.90 in chips) 
Seat 3: X78b5v/uhqeXXoAijbw/yg ($25.60 in chips) 
Seat 4: ziFpkH3wCzqB/qXeq/Hy7g ($25 in chips) 
Seat 5: Bb42QRQMhg5/Y0vHP8/2Xw ($28.70 in chips) 
Seat 6: q+Qdg0Hoir+SyL7haBrUnw ($13.50 in chips) 
Seat 7: 6C2DoQ+GZHBOpb+qyrSnqA ($5.75 in chips) 
Seat 8: pB8IyCfDFZaVpov3NHEVJg ($24.30 in chips) 
Seat 9: sGFnnRCa1YAHAUmWgsW6Qg ($10 in chips) 
q+Qdg0Hoir+SyL7haBrUnw: posts small blind $0.10
6C2DoQ+GZHBOpb+qyrSnqA: posts big blind $0.25
*** HOLE CARDS ***
pB8IyCfDFZaVpov3NHEVJg: folds 
pB8IyCfDFZaVpov3NHEVJg leaves the table
sGFnnRCa1YAHAUmWgsW6Qg: folds 
CT7Xj/V/O5rBlhtt+RZeFQ: folds 
X78b5v/uhqeXXoAijbw/yg: folds 
ziFpkH3wCzqB/qXeq/Hy7g: folds 
clJsV3v77RS07bDKY+705w joins the table at seat #8 
Bb42QRQMhg5/Y0vHP8/2Xw: folds 
q+Qdg0Hoir+SyL7haBrUnw: calls $0.15
6C2DoQ+GZHBOpb+qyrSnqA: checks 
*** FLOP *** [4d Ts Jd]
q+Qdg0Hoir+SyL7haBrUnw: checks 
6C2DoQ+GZHBOpb+qyrSnqA: bets $0.25
q+Qdg0Hoir+SyL7haBrUnw: folds 
Uncalled bet ($0.25) returned to 6C2DoQ+GZHBOpb+qyrSnqA
6C2DoQ+GZHBOpb+qyrSnqA collected $0.50 from pot
zDrucyjVn5aeekNEc3cJrA has returned
*** SUMMARY ***
Total pot $0.50 | Rake $0 
Board [4d Ts Jd]
Seat 1: CT7Xj/V/O5rBlhtt+RZeFQ folded before Flop (didn't bet)
Seat 3: X78b5v/uhqeXXoAijbw/yg folded before Flop (didn't bet)
Seat 4: ziFpkH3wCzqB/qXeq/Hy7g folded before Flop (didn't bet)
Seat 5: Bb42QRQMhg5/Y0vHP8/2Xw (button) folded before Flop (didn't bet)
Seat 6: q+Qdg0Hoir+SyL7haBrUnw (small blind) folded on the Flop
Seat 7: 6C2DoQ+GZHBOpb+qyrSnqA (big blind) collected ($0.50)
Seat 8: pB8IyCfDFZaVpov3NHEVJg folded before Flop (didn't bet)
Seat 9: sGFnnRCa1YAHAUmWgsW6Qg folded before Flop (didn't bet)




PokerStars Game #59941741694:  Hold'em No Limit ($0.10/$0.25) - 2009/07/01 1:44:42 ET
Table 'wRXcD9iXgBbdvKhWmfnBnw' 6-max Seat #2 is the button
Seat 2: vUr8qM1UsCElsCI9B/McdQ ($26.35 in chips) 
Seat 3: l4ToKwb3EVcEuva7hPqMCQ ($9.70 in chips) 
Seat 4: mnuJq+Q1IXKm/pCy+OzxmQ ($20 in chips) 
Seat 5: EE16Ua5b1HSsYej5zeXOlA ($43.75 in chips) 
Seat 6: JFIAqU8lCZ0vWwEl4bdGsg ($25 in chips) 
l4ToKwb3EVcEuva7hPqMCQ: posts small blind $0.10
mnuJq+Q1IXKm/pCy+OzxmQ: posts big blind $0.25
Mhj3q7cxev+XjXZxEE6/Cw: sits out 
*** HOLE CARDS ***
EE16Ua5b1HSsYej5zeXOlA: folds 
JFIAqU8lCZ0vWwEl4bdGsg: folds 
vUr8qM1UsCElsCI9B/McdQ: folds 
l4ToKwb3EVcEuva7hPqMCQ: calls $0.15
mnuJq+Q1IXKm/pCy+OzxmQ: checks 
*** FLOP *** [Jh 4d 3h]
l4ToKwb3EVcEuva7hPqMCQ: bets $0.25
mnuJq+Q1IXKm/pCy+OzxmQ: folds 
Uncalled bet ($0.25) returned to l4ToKwb3EVcEuva7hPqMCQ
l4ToKwb3EVcEuva7hPqMCQ collected $0.50 from pot
*** SUMMARY ***
Total pot $0.50 | Rake $0 
Board [Jh 4d 3h]
Seat 2: vUr8qM1UsCElsCI9B/McdQ (button) folded before Flop (didn't bet)
Seat 3: l4ToKwb3EVcEuva7hPqMCQ (small blind) collected ($0.50)
Seat 4: mnuJq+Q1IXKm/pCy+OzxmQ (big blind) folded on the Flop
Seat 5: EE16Ua5b1HSsYej5zeXOlA folded before Flop (didn't bet)
Seat 6: JFIAqU8lCZ0vWwEl4bdGsg folded before Flop (didn't bet)




PokerStars Game #59941741848:  Hold'em No Limit ($0.10/$0.25) - 2009/07/01 1:44:42 ET
Table 'PCxB2W9H6ma8SwsZlImuOw' 9-max Seat #7 is the button
Seat 1: SqibpGx+lf+brY0fJVvD0w ($25.10 in chips) 
Seat 2: wjH6l1gQaEfv+C45sAOwIQ ($38.20 in chips) 
Seat 3: J2a/QHAWUgo6beDRoEyg2g ($9.10 in chips) 
Seat 4: RsPwA2DnzOke3hD/Of/DUg ($2.55 in chips) 
Seat 5: GZO7tOXatVoX17M2DqPcUQ ($21.40 in chips) 
Seat 6: 5/6dWEBUHldD7iGXa2LwsQ ($15.50 in chips) 
Seat 7: c/9X4zftzphFxYtxp5kp9w ($27.40 in chips) 
Seat 8: Pt637jKksB5MzP0UNJAAkw ($25.85 in chips) 
Seat 9: COwSH15MvHaRF7en6/TRZQ ($4.65 in chips) 
Pt637jKksB5MzP0UNJAAkw: posts small blind $0.10
COwSH15MvHaRF7en6/TRZQ: posts big blind $0.25
*** HOLE CARDS ***
SqibpGx+lf+brY0fJVvD0w: folds 
wjH6l1gQaEfv+C45sAOwIQ: folds 
J2a/QHAWUgo6beDRoEyg2g: calls $0.25
RsPwA2DnzOke3hD/Of/DUg: folds 
GZO7tOXatVoX17M2DqPcUQ: folds 
5/6dWEBUHldD7iGXa2LwsQ: folds 
c/9X4zftzphFxYtxp5kp9w: folds 
Pt637jKksB5MzP0UNJAAkw: calls $0.15
COwSH15MvHaRF7en6/TRZQ: checks 
*** FLOP *** [4s Qs 5s]
Pt637jKksB5MzP0UNJAAkw: checks 
COwSH15MvHaRF7en6/TRZQ: bets $0.25
J2a/QHAWUgo6beDRoEyg2g: calls $0.25
Pt637jKksB5MzP0UNJAAkw: folds 
*** TURN *** [4s Qs 5s] [4c]
COwSH15MvHaRF7en6/TRZQ: bets $0.50
J2a/QHAWUgo6beDRoEyg2g: calls $0.50
*** RIVER *** [4s Qs 5s 4c] [Ad]
COwSH15MvHaRF7en6/TRZQ: bets $0.25
J2a/QHAWUgo6beDRoEyg2g: raises $1 to $1.25
COwSH15MvHaRF7en6/TRZQ: calls $1
*** SHOW DOWN ***
J2a/QHAWUgo6beDRoEyg2g: shows [6c 7s] (a pair of Fours)
COwSH15MvHaRF7en6/TRZQ: shows [Qc Ks] (two pair, Queens and Fours)
COwSH15MvHaRF7en6/TRZQ collected $4.55 from pot
*** SUMMARY ***
Total pot $4.75 | Rake $0.20 
Board [4s Qs 5s 4c Ad]
Seat 1: SqibpGx+lf+brY0fJVvD0w folded before Flop (didn't bet)
Seat 2: wjH6l1gQaEfv+C45sAOwIQ folded before Flop (didn't bet)
Seat 3: J2a/QHAWUgo6beDRoEyg2g showed [6c 7s] and lost with a pair of Fours
Seat 4: RsPwA2DnzOke3hD/Of/DUg folded before Flop (didn't bet)
Seat 5: GZO7tOXatVoX17M2DqPcUQ folded before Flop (didn't bet)
Seat 6: 5/6dWEBUHldD7iGXa2LwsQ folded before Flop (didn't bet)
Seat 7: c/9X4zftzphFxYtxp5kp9w (button) folded before Flop (didn't bet)
Seat 8: Pt637jKksB5MzP0UNJAAkw (small blind) folded on the Flop
Seat 9: COwSH15MvHaRF7en6/TRZQ (big blind) showed [Qc Ks] and won ($4.55) with two pair, Queens and Fours




PokerStars Game #59941741704:  Hold'em No Limit ($0.10/$0.25) - 2009/07/01 1:44:42 ET
Table 'NtCSSONEf1zaJo3042tQug' 6-max Seat #3 is the button
Seat 1: KXtdqb+rIMkjc0RvHDksGQ ($35.10 in chips) 
Seat 2: vqWjZmdQu/Hxw96/IJTWdQ ($27.30 in chips) 
Seat 3: 9kUKGKkblnIx3m8rlVol6Q ($15.65 in chips) 
Seat 4: HxD1kB8zCmalQSdWAkKmlg ($28.95 in chips) 
Seat 5: tOAk1Og4mVObMBOfvdDYOw ($30.40 in chips) 
Seat 6: LxehwDpTQ19ph4Qmc78+Pw ($29 in chips) 
HxD1kB8zCmalQSdWAkKmlg: posts small blind $0.10
tOAk1Og4mVObMBOfvdDYOw: posts big blind $0.25
*** HOLE CARDS ***
LxehwDpTQ19ph4Qmc78+Pw: folds 
KXtdqb+rIMkjc0RvHDksGQ: folds 
vqWjZmdQu/Hxw96/IJTWdQ: folds 
9kUKGKkblnIx3m8rlVol6Q: folds 
HxD1kB8zCmalQSdWAkKmlg: folds 
Uncalled bet ($0.15) returned to tOAk1Og4mVObMBOfvdDYOw
tOAk1Og4mVObMBOfvdDYOw collected $0.20 from pot
tOAk1Og4mVObMBOfvdDYOw: doesn't show hand 
*** SUMMARY ***
Total pot $0.20 | Rake $0 
Seat 1: KXtdqb+rIMkjc0RvHDksGQ folded before Flop (didn't bet)
Seat 2: vqWjZmdQu/Hxw96/IJTWdQ folded before Flop (didn't bet)
Seat 3: 9kUKGKkblnIx3m8rlVol6Q (button) folded before Flop (didn't bet)
Seat 4: HxD1kB8zCmalQSdWAkKmlg (small blind) folded before Flop
Seat 5: tOAk1Og4mVObMBOfvdDYOw (big blind) collected ($0.20)
Seat 6: LxehwDpTQ19ph4Qmc78+Pw folded before Flop (didn't bet)




PokerStars Game #59941741742:  Hold'em No Limit ($0.10/$0.25) - 2009/07/01 1:44:42 ET
Table 'nB7Q7zfNfy6ig6DB+rsgWQ' 6-max Seat #4 is the button
Seat 1: Hzy03WtPHMYwLYM7hTTxQw ($24 in chips) 
Seat 2: 4BHo0wlX9INjkj2727qE0w ($25 in chips) 
Seat 3: p3NYOxYhkL7txPRSeXHDeg ($32.60 in chips) 
Seat 4: DihMHaz4WNETH1bPDe13kA ($80.35 in chips) 
Seat 5: xC0kaiDYM6YTlgODL83O5A ($14.75 in chips) 
Seat 6: MEGIwX0eHRUj63lwYaNhVg ($7.45 in chips) 
xC0kaiDYM6YTlgODL83O5A: posts small blind $0.10
MEGIwX0eHRUj63lwYaNhVg: posts big blind $0.25
*** HOLE CARDS ***
Hzy03WtPHMYwLYM7hTTxQw: folds 
4BHo0wlX9INjkj2727qE0w: calls $0.25
p3NYOxYhkL7txPRSeXHDeg: folds 
DihMHaz4WNETH1bPDe13kA: calls $0.25
xC0kaiDYM6YTlgODL83O5A: calls $0.15
MEGIwX0eHRUj63lwYaNhVg: checks 
*** FLOP *** [7c Ts Kd]
xC0kaiDYM6YTlgODL83O5A: checks 
MEGIwX0eHRUj63lwYaNhVg: checks 
4BHo0wlX9INjkj2727qE0w: checks 
DihMHaz4WNETH1bPDe13kA: checks 
*** TURN *** [7c Ts Kd] [3s]
xC0kaiDYM6YTlgODL83O5A: checks 
MEGIwX0eHRUj63lwYaNhVg: checks 
4BHo0wlX9INjkj2727qE0w: bets $0.75
DihMHaz4WNETH1bPDe13kA: folds 
xC0kaiDYM6YTlgODL83O5A: calls $0.75
MEGIwX0eHRUj63lwYaNhVg: folds 
*** RIVER *** [7c Ts Kd 3s] [9s]
xC0kaiDYM6YTlgODL83O5A: bets $1
4BHo0wlX9INjkj2727qE0w: folds 
Uncalled bet ($1) returned to xC0kaiDYM6YTlgODL83O5A
xC0kaiDYM6YTlgODL83O5A collected $2.40 from pot
*** SUMMARY ***
Total pot $2.50 | Rake $0.10 
Board [7c Ts Kd 3s 9s]
Seat 1: Hzy03WtPHMYwLYM7hTTxQw folded before Flop (didn't bet)
Seat 2: 4BHo0wlX9INjkj2727qE0w folded on the River
Seat 3: p3NYOxYhkL7txPRSeXHDeg folded before Flop (didn't bet)
Seat 4: DihMHaz4WNETH1bPDe13kA (button) folded on the Turn
Seat 5: xC0kaiDYM6YTlgODL83O5A (small blind) collected ($2.40)
Seat 6: MEGIwX0eHRUj63lwYaNhVg (big blind) folded on the Turn




PokerStars Game #59941741664:  Hold'em No Limit ($0.10/$0.25) - 2009/07/01 1:44:42 ET
Table 'isKy4XK8wJM0x735/D4hWA' 6-max Seat #5 is the button
Seat 1: kwsRmpZ1ZaLooISs+zfyKg ($24.40 in chips) 
Seat 2: 6elpmfyt4Zw0yvd8lePSMQ ($39.25 in chips) 
Seat 3: jp34e617tIzV8tKIWmfAbA ($26.05 in chips) 
Seat 4: DFi/Lzkjsfv8QswS80JX9Q ($31.10 in chips) 
Seat 5: lquriepNQBhDV5P1SWHhnA ($25.25 in chips) 
Seat 6: GbCVUNssQ7mqsPWr7J4d3w ($4.40 in chips) 
GbCVUNssQ7mqsPWr7J4d3w: posts small blind $0.10
kwsRmpZ1ZaLooISs+zfyKg: posts big blind $0.25
*** HOLE CARDS ***
6elpmfyt4Zw0yvd8lePSMQ: folds 
jp34e617tIzV8tKIWmfAbA: folds 
DFi/Lzkjsfv8QswS80JX9Q: raises $0.75 to $1
lquriepNQBhDV5P1SWHhnA: folds 
GbCVUNssQ7mqsPWr7J4d3w: folds 
kwsRmpZ1ZaLooISs+zfyKg: folds 
Uncalled bet ($0.75) returned to DFi/Lzkjsfv8QswS80JX9Q
DFi/Lzkjsfv8QswS80JX9Q collected $0.60 from pot
DFi/Lzkjsfv8QswS80JX9Q: doesn't show hand 
*** SUMMARY ***
Total pot $0.60 | Rake $0 
Seat 1: kwsRmpZ1ZaLooISs+zfyKg (big blind) folded before Flop
Seat 2: 6elpmfyt4Zw0yvd8lePSMQ folded before Flop (didn't bet)
Seat 3: jp34e617tIzV8tKIWmfAbA folded before Flop (didn't bet)
Seat 4: DFi/Lzkjsfv8QswS80JX9Q collected ($0.60)
Seat 5: lquriepNQBhDV5P1SWHhnA (button) folded before Flop (didn't bet)
Seat 6: GbCVUNssQ7mqsPWr7J4d3w (small blind) folded before Flop




PokerStars Game #59941742280:  Hold'em No Limit ($0.10/$0.25) - 2009/07/01 1:44:43 ET
Table 'M7d9IrgQUUFFy/SZ3ksLYg' 6-max Seat #6 is the button
Seat 1: ypmjhffk/YHGc51wgVXUTw ($49.35 in chips) 
Seat 2: gqrr7lSWrQ1N8zKx8zZzvA ($8.80 in chips) 
Seat 3: 8JTm/CXBn3+kuQgcUOgPkw ($22.70 in chips) 
Seat 4: 8ClCHtFXGNplITm+63KB+Q ($24.55 in chips) 
Seat 5: kMa8BltUcBQVxnHfqdCfXg ($3.90 in chips) 
Seat 6: 7S16WhQHiAVLWwRuqPrpnw ($13.05 in chips) 
ypmjhffk/YHGc51wgVXUTw: posts small blind $0.10
gqrr7lSWrQ1N8zKx8zZzvA: posts big blind $0.25
*** HOLE CARDS ***
8JTm/CXBn3+kuQgcUOgPkw: calls $0.25
8ClCHtFXGNplITm+63KB+Q: folds 
kMa8BltUcBQVxnHfqdCfXg: calls $0.25
7S16WhQHiAVLWwRuqPrpnw: folds 
ypmjhffk/YHGc51wgVXUTw: folds 
gqrr7lSWrQ1N8zKx8zZzvA: checks 
*** FLOP *** [5d 7d 7c]
gqrr7lSWrQ1N8zKx8zZzvA: checks 
8JTm/CXBn3+kuQgcUOgPkw: checks 
kMa8BltUcBQVxnHfqdCfXg: checks 
*** TURN *** [5d 7d 7c] [Tc]
gqrr7lSWrQ1N8zKx8zZzvA: bets $0.50
8JTm/CXBn3+kuQgcUOgPkw: folds 
kMa8BltUcBQVxnHfqdCfXg: calls $0.50
*** RIVER *** [5d 7d 7c Tc] [8c]
gqrr7lSWrQ1N8zKx8zZzvA: bets $1
8JTm/CXBn3+kuQgcUOgPkw leaves the table
kMa8BltUcBQVxnHfqdCfXg: raises $2.15 to $3.15 and is all-in
gqrr7lSWrQ1N8zKx8zZzvA: calls $2.15
*** SHOW DOWN ***
kMa8BltUcBQVxnHfqdCfXg: shows [4c Jc] (a flush, Jack high)
gqrr7lSWrQ1N8zKx8zZzvA: mucks hand 
kMa8BltUcBQVxnHfqdCfXg collected $7.75 from pot
*** SUMMARY ***
Total pot $8.15 | Rake $0.40 
Board [5d 7d 7c Tc 8c]
Seat 1: ypmjhffk/YHGc51wgVXUTw (small blind) folded before Flop
Seat 2: gqrr7lSWrQ1N8zKx8zZzvA (big blind) mucked
Seat 3: 8JTm/CXBn3+kuQgcUOgPkw folded on the Turn
Seat 4: 8ClCHtFXGNplITm+63KB+Q folded before Flop (didn't bet)
Seat 5: kMa8BltUcBQVxnHfqdCfXg showed [4c Jc] and won ($7.75) with a flush, Jack high
Seat 6: 7S16WhQHiAVLWwRuqPrpnw (button) folded before Flop (didn't bet)




PokerStars Game #59941742468:  Hold'em No Limit ($0.10/$0.25) - 2009/07/01 1:44:43 ET
Table 'wPWRBZPJl1HAnysw7qRR0A' 6-max Seat #4 is the button
Seat 1: m7ne1MOFTQXlsXT7/R/rug ($6.90 in chips) 
Seat 2: xC0kaiDYM6YTlgODL83O5A ($15 in chips) 
Seat 3: 1ZpoLWO2nm2w1Nd1v9Sr3g ($7.45 in chips) 
Seat 4: epAUIB7h2FJXzUPRIvSkRA ($39.40 in chips) 
Seat 5: y0B+UpYpOUJz3JWtlJQBSA ($16.10 in chips) 
Seat 6: rx64Jzd1UJFfwJwXmv3z8w ($14.40 in chips) 
y0B+UpYpOUJz3JWtlJQBSA: posts small blind $0.10
rx64Jzd1UJFfwJwXmv3z8w: posts big blind $0.25
*** HOLE CARDS ***
m7ne1MOFTQXlsXT7/R/rug: calls $0.25
xC0kaiDYM6YTlgODL83O5A: folds 
1ZpoLWO2nm2w1Nd1v9Sr3g: calls $0.25
epAUIB7h2FJXzUPRIvSkRA: calls $0.25
y0B+UpYpOUJz3JWtlJQBSA: folds 
rx64Jzd1UJFfwJwXmv3z8w: raises $1.75 to $2
m7ne1MOFTQXlsXT7/R/rug: folds 
1ZpoLWO2nm2w1Nd1v9Sr3g: folds 
epAUIB7h2FJXzUPRIvSkRA: folds 
Uncalled bet ($1.75) returned to rx64Jzd1UJFfwJwXmv3z8w
rx64Jzd1UJFfwJwXmv3z8w collected $1.10 from pot
rx64Jzd1UJFfwJwXmv3z8w: doesn't show hand 
*** SUMMARY ***
Total pot $1.10 | Rake $0 
Seat 1: m7ne1MOFTQXlsXT7/R/rug folded before Flop
Seat 2: xC0kaiDYM6YTlgODL83O5A folded before Flop (didn't bet)
Seat 3: 1ZpoLWO2nm2w1Nd1v9Sr3g folded before Flop
Seat 4: epAUIB7h2FJXzUPRIvSkRA (button) folded before Flop
Seat 5: y0B+UpYpOUJz3JWtlJQBSA (small blind) folded before Flop
Seat 6: rx64Jzd1UJFfwJwXmv3z8w (big blind) collected ($1.10)




PokerStars Game #59941742372:  Hold'em No Limit ($0.10/$0.25) - 2009/07/01 1:44:43 ET
Table 'WY+lMaAoIdBZmwk27/RJCA' 6-max Seat #1 is the button
Seat 1: zHHLkD2sRljslKKeQv/ZQw ($26.10 in chips) 
Seat 2: NhUN/JpAprdJeamFBgJH1w ($27 in chips) 
Seat 3: QqiZLFrN8iOUT/GHw7ztOA ($25 in chips) 
Seat 4: 0av6tRNdi0Ui4f15L7gsVg ($25 in chips) 
Seat 5: vqWjZmdQu/Hxw96/IJTWdQ ($30.45 in chips) 
Seat 6: cWc85bEzdRzpUMhRKm8pwQ ($25.50 in chips) 
NhUN/JpAprdJeamFBgJH1w: posts small blind $0.10
QqiZLFrN8iOUT/GHw7ztOA: posts big blind $0.25
*** HOLE CARDS ***
0av6tRNdi0Ui4f15L7gsVg: folds 
vqWjZmdQu/Hxw96/IJTWdQ: folds 
cWc85bEzdRzpUMhRKm8pwQ: folds 
zHHLkD2sRljslKKeQv/ZQw: raises $0.50 to $0.75
NhUN/JpAprdJeamFBgJH1w: folds 
QqiZLFrN8iOUT/GHw7ztOA: raises $1 to $1.75
zHHLkD2sRljslKKeQv/ZQw: calls $1
*** FLOP *** [4c Jd 2s]
QqiZLFrN8iOUT/GHw7ztOA: bets $2.50
zHHLkD2sRljslKKeQv/ZQw: folds 
Uncalled bet ($2.50) returned to QqiZLFrN8iOUT/GHw7ztOA
QqiZLFrN8iOUT/GHw7ztOA collected $3.45 from pot
*** SUMMARY ***
Total pot $3.60 | Rake $0.15 
Board [4c Jd 2s]
Seat 1: zHHLkD2sRljslKKeQv/ZQw (button) folded on the Flop
Seat 2: NhUN/JpAprdJeamFBgJH1w (small blind) folded before Flop
Seat 3: QqiZLFrN8iOUT/GHw7ztOA (big blind) collected ($3.45)
Seat 4: 0av6tRNdi0Ui4f15L7gsVg folded before Flop (didn't bet)
Seat 5: vqWjZmdQu/Hxw96/IJTWdQ folded before Flop (didn't bet)
Seat 6: cWc85bEzdRzpUMhRKm8pwQ folded before Flop (didn't bet)




PokerStars Game #59941742596:  Hold'em No Limit ($0.10/$0.25) - 2009/07/01 1:44:43 ET
Table 'P2yJ+jwfNsBdF12fLKA6DQ' 9-max Seat #7 is the button
Seat 2: uQwmfH5LEVA5eyghJdyPUg ($11.40 in chips) 
Seat 4: 6NLAWFPZZfqlVkY8n9RULA ($14 in chips) 
Seat 5: B7VAFAMs/PYlYABlV+EkSA ($7.95 in chips) 
Seat 6: mUoFJKqCzIUABvOFbiINlQ ($12.30 in chips) 
Seat 7: yQc5nLaNmByxI15Jegu61w ($18.15 in chips) 
Seat 8: LMd3gq2uNfbWTfXTnSeQRw ($9.40 in chips) 
Seat 9: dN5zq7QdZCUe7NZFM6cECg ($18.75 in chips) 
LMd3gq2uNfbWTfXTnSeQRw: posts small blind $0.10
dN5zq7QdZCUe7NZFM6cECg: posts big blind $0.25
8EbrQ/EvFWt2cr0GaU82gQ: sits out 
*** HOLE CARDS ***
uQwmfH5LEVA5eyghJdyPUg: calls $0.25
6NLAWFPZZfqlVkY8n9RULA: folds 
B7VAFAMs/PYlYABlV+EkSA: calls $0.25
mUoFJKqCzIUABvOFbiINlQ: calls $0.25
yQc5nLaNmByxI15Jegu61w: folds 
LMd3gq2uNfbWTfXTnSeQRw: folds 
dN5zq7QdZCUe7NZFM6cECg: raises $0.25 to $0.50
uQwmfH5LEVA5eyghJdyPUg: calls $0.25
B7VAFAMs/PYlYABlV+EkSA: calls $0.25
zDrucyjVn5aeekNEc3cJrA has returned
mUoFJKqCzIUABvOFbiINlQ: calls $0.25
*** FLOP *** [Jh 2c 3c]
dN5zq7QdZCUe7NZFM6cECg: checks 
uQwmfH5LEVA5eyghJdyPUg: checks 
B7VAFAMs/PYlYABlV+EkSA: checks 
mUoFJKqCzIUABvOFbiINlQ: checks 
*** TURN *** [Jh 2c 3c] [4s]
dN5zq7QdZCUe7NZFM6cECg: checks 
uQwmfH5LEVA5eyghJdyPUg: checks 
B7VAFAMs/PYlYABlV+EkSA: checks 
mUoFJKqCzIUABvOFbiINlQ: bets $0.50
dN5zq7QdZCUe7NZFM6cECg: folds 
uQwmfH5LEVA5eyghJdyPUg: calls $0.50
B7VAFAMs/PYlYABlV+EkSA: folds 
*** RIVER *** [Jh 2c 3c 4s] [7d]
uQwmfH5LEVA5eyghJdyPUg: checks 
mUoFJKqCzIUABvOFbiINlQ: checks 
*** SHOW DOWN ***
uQwmfH5LEVA5eyghJdyPUg: shows [Kd 5d] (high card King)
mUoFJKqCzIUABvOFbiINlQ: shows [4h 8h] (a pair of Fours)
mUoFJKqCzIUABvOFbiINlQ collected $2.95 from pot
*** SUMMARY ***
Total pot $3.10 | Rake $0.15 
Board [Jh 2c 3c 4s 7d]
Seat 2: uQwmfH5LEVA5eyghJdyPUg showed [Kd 5d] and lost with high card King
Seat 4: 6NLAWFPZZfqlVkY8n9RULA folded before Flop (didn't bet)
Seat 5: B7VAFAMs/PYlYABlV+EkSA folded on the Turn
Seat 6: mUoFJKqCzIUABvOFbiINlQ showed [4h 8h] and won ($2.95) with a pair of Fours
Seat 7: yQc5nLaNmByxI15Jegu61w (button) folded before Flop (didn't bet)
Seat 8: LMd3gq2uNfbWTfXTnSeQRw (small blind) folded before Flop
Seat 9: dN5zq7QdZCUe7NZFM6cECg (big blind) folded on the Turn




PokerStars Game #59941742544:  Hold'em No Limit ($0.10/$0.25) - 2009/07/01 1:44:43 ET
Table 'ThBZ355rqvsb8UGb6ajbig' 9-max Seat #2 is the button
Seat 1: Z9W7+g1WMhhZDi7DwGbCFA ($5 in chips) 
Seat 2: 4awUyiDYTgylQKXZ9faBVA ($25.60 in chips) 
Seat 3: H5Se03ZqSX7tbULXur2MAg ($29.15 in chips) 
Seat 4: zgi+EUykT/pZQpoUG6+oEg ($4.65 in chips) 
Seat 5: cKlmpQMahVsmOaxFQDcoOg ($24.95 in chips) 
Seat 6: qwr38jl5txoR36M7G5qi4A ($9.65 in chips) 
Seat 7: zUXhymECc2C9W9ZNw6qppA ($17.55 in chips) 
Seat 8: PdIasPkzm2sqZnN41ZRXOg ($4.90 in chips) 
Seat 9: sD+TKtt36XiiN6jqHiLwDA ($23.85 in chips) 
H5Se03ZqSX7tbULXur2MAg: posts small blind $0.10
zgi+EUykT/pZQpoUG6+oEg: posts big blind $0.25
*** HOLE CARDS ***
cKlmpQMahVsmOaxFQDcoOg: folds 
qwr38jl5txoR36M7G5qi4A: raises $0.50 to $0.75
zUXhymECc2C9W9ZNw6qppA: calls $0.75
PdIasPkzm2sqZnN41ZRXOg: folds 
sD+TKtt36XiiN6jqHiLwDA: folds 
Z9W7+g1WMhhZDi7DwGbCFA: folds 
4awUyiDYTgylQKXZ9faBVA: folds 
H5Se03ZqSX7tbULXur2MAg: folds 
zgi+EUykT/pZQpoUG6+oEg: folds 
*** FLOP *** [Js 4d Kd]
qwr38jl5txoR36M7G5qi4A: bets $0.75
zUXhymECc2C9W9ZNw6qppA: calls $0.75
*** TURN *** [Js 4d Kd] [8h]
qwr38jl5txoR36M7G5qi4A: bets $1.50
zUXhymECc2C9W9ZNw6qppA: folds 
Uncalled bet ($1.50) returned to qwr38jl5txoR36M7G5qi4A
qwr38jl5txoR36M7G5qi4A collected $3.20 from pot
qwr38jl5txoR36M7G5qi4A: doesn't show hand 
*** SUMMARY ***
Total pot $3.35 | Rake $0.15 
Board [Js 4d Kd 8h]
Seat 1: Z9W7+g1WMhhZDi7DwGbCFA folded before Flop (didn't bet)
Seat 2: 4awUyiDYTgylQKXZ9faBVA (button) folded before Flop (didn't bet)
Seat 3: H5Se03ZqSX7tbULXur2MAg (small blind) folded before Flop
Seat 4: zgi+EUykT/pZQpoUG6+oEg (big blind) folded before Flop
Seat 5: cKlmpQMahVsmOaxFQDcoOg folded before Flop (didn't bet)
Seat 6: qwr38jl5txoR36M7G5qi4A collected ($3.20)
Seat 7: zUXhymECc2C9W9ZNw6qppA folded on the Turn
Seat 8: PdIasPkzm2sqZnN41ZRXOg folded before Flop (didn't bet)
Seat 9: sD+TKtt36XiiN6jqHiLwDA folded before Flop (didn't bet)




PokerStars Game #59941742538:  Hold'em No Limit ($0.10/$0.25) - 2009/07/01 1:44:43 ET
Table 'NfXsh0UQA+o/kO9acV3WxA' 9-max Seat #4 is the button
Seat 1: pN3IHvAKm2fz+sTRARTcrg ($24.65 in chips) 
Seat 2: mhpFs2SZupy4zLRb62FLFA ($25 in chips) 
Seat 3: wCUaomJ6Nq5zomVGdUHP+w ($19.50 in chips) 
Seat 4: r6hsffOo1iKmaPYKwAZmFw ($30.05 in chips) 
Seat 5: zgi+EUykT/pZQpoUG6+oEg ($4.75 in chips) 
Seat 7: yqkowiRWZ6NvRN9UUkYIlA ($5 in chips) 
Seat 8: +sbyWwIcFp9kP0bDtMegfQ ($41.75 in chips) 
Seat 9: uhrboV251dcgYniYTdFIcA ($25.35 in chips) 
zgi+EUykT/pZQpoUG6+oEg: posts small blind $0.10
yqkowiRWZ6NvRN9UUkYIlA: posts big blind $0.25
*** HOLE CARDS ***
+sbyWwIcFp9kP0bDtMegfQ: folds 
uhrboV251dcgYniYTdFIcA: raises $0.75 to $1
pN3IHvAKm2fz+sTRARTcrg: folds 
mhpFs2SZupy4zLRb62FLFA: folds 
clkou leaves the table
wCUaomJ6Nq5zomVGdUHP+w: folds 
r6hsffOo1iKmaPYKwAZmFw: folds 
zgi+EUykT/pZQpoUG6+oEg: folds 
yqkowiRWZ6NvRN9UUkYIlA: folds 
Uncalled bet ($0.75) returned to uhrboV251dcgYniYTdFIcA
uhrboV251dcgYniYTdFIcA collected $0.60 from pot
uhrboV251dcgYniYTdFIcA: doesn't show hand 
*** SUMMARY ***
Total pot $0.60 | Rake $0 
Seat 1: pN3IHvAKm2fz+sTRARTcrg folded before Flop (didn't bet)
Seat 2: mhpFs2SZupy4zLRb62FLFA folded before Flop (didn't bet)
Seat 3: wCUaomJ6Nq5zomVGdUHP+w folded before Flop (didn't bet)
Seat 4: r6hsffOo1iKmaPYKwAZmFw (button) folded before Flop (didn't bet)
Seat 5: zgi+EUykT/pZQpoUG6+oEg (small blind) folded before Flop
Seat 7: yqkowiRWZ6NvRN9UUkYIlA (big blind) folded before Flop
Seat 8: +sbyWwIcFp9kP0bDtMegfQ folded before Flop (didn't bet)
Seat 9: uhrboV251dcgYniYTdFIcA collected ($0.60)




PokerStars Game #59941742160:  Hold'em No Limit ($0.10/$0.25) - 2009/07/01 1:44:43 ET
Table 'a6FCGVBMPcT7J7BDN9q1zQ' 9-max Seat #3 is the button
Seat 2: M2QO2DxB5Wawg2h8HSpnYA ($14.45 in chips) 
Seat 3: tLcDklc2rBORNfixyRfVfw ($25.80 in chips) 
Seat 4: 8CoKLhwk8Ja6X+O9fxTEDg ($10.55 in chips) 
Seat 5: dtZ84flFEi4Q+SGrHMJRDQ ($27.05 in chips) 
Seat 6: dfNim92Z6XK1/h5SFW5vDg ($25 in chips) 
Seat 7: V0Yo5zRBVM8DYspLKafebg ($4.05 in chips) 
Seat 8: r6hsffOo1iKmaPYKwAZmFw ($65.70 in chips) 
Seat 9: wGigCmBR/9XWkPpvYos3aQ ($28.35 in chips) 
8CoKLhwk8Ja6X+O9fxTEDg: posts small blind $0.10
dtZ84flFEi4Q+SGrHMJRDQ: posts big blind $0.25
bXpVeaSTPBFSPJmeXxO7nw: sits out 
*** HOLE CARDS ***
dfNim92Z6XK1/h5SFW5vDg: folds 
V0Yo5zRBVM8DYspLKafebg: folds 
r6hsffOo1iKmaPYKwAZmFw: raises $0.75 to $1
wGigCmBR/9XWkPpvYos3aQ: folds 
M2QO2DxB5Wawg2h8HSpnYA: calls $1
tLcDklc2rBORNfixyRfVfw: folds 
8CoKLhwk8Ja6X+O9fxTEDg: folds 
8CoKLhwk8Ja6X+O9fxTEDg is sitting out
dtZ84flFEi4Q+SGrHMJRDQ: folds 
*** FLOP *** [Th 9d Jh]
r6hsffOo1iKmaPYKwAZmFw: bets $1.75
8CoKLhwk8Ja6X+O9fxTEDg leaves the table
M2QO2DxB5Wawg2h8HSpnYA said, "play bingo man!"
M2QO2DxB5Wawg2h8HSpnYA: folds 
Uncalled bet ($1.75) returned to r6hsffOo1iKmaPYKwAZmFw
r6hsffOo1iKmaPYKwAZmFw collected $2.25 from pot
r6hsffOo1iKmaPYKwAZmFw: doesn't show hand 
*** SUMMARY ***
Total pot $2.35 | Rake $0.10 
Board [Th 9d Jh]
Seat 2: M2QO2DxB5Wawg2h8HSpnYA folded on the Flop
Seat 3: tLcDklc2rBORNfixyRfVfw (button) folded before Flop (didn't bet)
Seat 4: 8CoKLhwk8Ja6X+O9fxTEDg (small blind) folded before Flop
Seat 5: dtZ84flFEi4Q+SGrHMJRDQ (big blind) folded before Flop
Seat 6: dfNim92Z6XK1/h5SFW5vDg folded before Flop (didn't bet)
Seat 7: V0Yo5zRBVM8DYspLKafebg folded before Flop (didn't bet)
Seat 8: r6hsffOo1iKmaPYKwAZmFw collected ($2.25)
Seat 9: wGigCmBR/9XWkPpvYos3aQ folded before Flop (didn't bet)




PokerStars Game #59941742302:  Hold'em No Limit ($0.10/$0.25) - 2009/07/01 1:44:43 ET
Table 'iMiAw/kTZXopgYX4HI7sHg' 9-max Seat #2 is the button
Seat 1: PdIasPkzm2sqZnN41ZRXOg ($5 in chips) 
Seat 2: qwr38jl5txoR36M7G5qi4A ($8.25 in chips) 
Seat 3: HPEB+AtKw1+C/cxU0o1ciw ($28 in chips) 
Seat 4: Z9W7+g1WMhhZDi7DwGbCFA ($5 in chips) 
Seat 5: 22dIObOuor/A+IKWkNoAlA ($5.10 in chips) 
Seat 6: Bb42QRQMhg5/Y0vHP8/2Xw ($28.70 in chips) 
Seat 8: tLcDklc2rBORNfixyRfVfw ($30.15 in chips) 
Seat 9: 7cv+9Zc9HIQHNvYsMfV3uA ($25 in chips) 
HPEB+AtKw1+C/cxU0o1ciw: posts small blind $0.10
Z9W7+g1WMhhZDi7DwGbCFA: posts big blind $0.25
ipLwYjdAXnvG54zETKPvbQ: sits out 
*** HOLE CARDS ***
22dIObOuor/A+IKWkNoAlA: folds 
Bb42QRQMhg5/Y0vHP8/2Xw: calls $0.25
tLcDklc2rBORNfixyRfVfw: folds 
7cv+9Zc9HIQHNvYsMfV3uA: folds 
PdIasPkzm2sqZnN41ZRXOg: folds 
qwr38jl5txoR36M7G5qi4A: folds 
HPEB+AtKw1+C/cxU0o1ciw: folds 
Z9W7+g1WMhhZDi7DwGbCFA: checks 
*** FLOP *** [2s 8s Ad]
Z9W7+g1WMhhZDi7DwGbCFA: checks 
Bb42QRQMhg5/Y0vHP8/2Xw: bets $0.75
Z9W7+g1WMhhZDi7DwGbCFA: folds 
Uncalled bet ($0.75) returned to Bb42QRQMhg5/Y0vHP8/2Xw
Bb42QRQMhg5/Y0vHP8/2Xw collected $0.60 from pot
*** SUMMARY ***
Total pot $0.60 | Rake $0 
Board [2s 8s Ad]
Seat 1: PdIasPkzm2sqZnN41ZRXOg folded before Flop (didn't bet)
Seat 2: qwr38jl5txoR36M7G5qi4A (button) folded before Flop (didn't bet)
Seat 3: HPEB+AtKw1+C/cxU0o1ciw (small blind) folded before Flop
Seat 4: Z9W7+g1WMhhZDi7DwGbCFA (big blind) folded on the Flop
Seat 5: 22dIObOuor/A+IKWkNoAlA folded before Flop (didn't bet)
Seat 6: Bb42QRQMhg5/Y0vHP8/2Xw collected ($0.60)
Seat 8: tLcDklc2rBORNfixyRfVfw folded before Flop (didn't bet)
Seat 9: 7cv+9Zc9HIQHNvYsMfV3uA folded before Flop (didn't bet)




PokerStars Game #59941742182:  Hold'em No Limit ($0.10/$0.25) - 2009/07/01 1:44:43 ET
Table 'CM/C/FZf3VHIp50RjmBucQ' 9-max Seat #4 is the button
Seat 2: xUw035gj8xeH3frcgPyCVw ($5.70 in chips) 
Seat 3: HPEB+AtKw1+C/cxU0o1ciw ($50.80 in chips) 
Seat 4: FYIiLXWy4mKC5ZGa/fnS0g ($10.25 in chips) 
Seat 5: oLa/tXLfSLLB28mcLGrxcg ($24.30 in chips) 
oLa/tXLfSLLB28mcLGrxcg: posts small blind $0.10
xUw035gj8xeH3frcgPyCVw: posts big blind $0.25
*** HOLE CARDS ***
HPEB+AtKw1+C/cxU0o1ciw: folds 
FYIiLXWy4mKC5ZGa/fnS0g: folds 
oLa/tXLfSLLB28mcLGrxcg: calls $0.15
xUw035gj8xeH3frcgPyCVw: raises $0.25 to $0.50
oLa/tXLfSLLB28mcLGrxcg: folds 
Uncalled bet ($0.25) returned to xUw035gj8xeH3frcgPyCVw
oLa/tXLfSLLB28mcLGrxcg leaves the table
xUw035gj8xeH3frcgPyCVw collected $0.50 from pot
*** SUMMARY ***
Total pot $0.50 | Rake $0 
Seat 2: xUw035gj8xeH3frcgPyCVw (big blind) collected ($0.50)
Seat 3: HPEB+AtKw1+C/cxU0o1ciw folded before Flop (didn't bet)
Seat 4: FYIiLXWy4mKC5ZGa/fnS0g (button) folded before Flop (didn't bet)
Seat 5: oLa/tXLfSLLB28mcLGrxcg (small blind) folded before Flop




PokerStars Game #59941743000:  Hold'em No Limit ($0.10/$0.25) - 2009/07/01 1:44:44 ET
Table 'AJGgX1ZYM8d68SWMvaLttg' 6-max Seat #5 is the button
Seat 2: zHHLkD2sRljslKKeQv/ZQw ($28.85 in chips) 
Seat 3: 8ClCHtFXGNplITm+63KB+Q ($39.05 in chips) 
Seat 4: Lz/GjRDgmgepqTR7qmS86w ($24.05 in chips) 
Seat 5: Hsvkc0/G2VV78oVmWYXecw ($5 in chips) 
Seat 6: UA5OsKS3VPaxa7uC8La/kA ($63.15 in chips) 
UA5OsKS3VPaxa7uC8La/kA: posts small blind $0.10
zHHLkD2sRljslKKeQv/ZQw: posts big blind $0.25
*** HOLE CARDS ***
8ClCHtFXGNplITm+63KB+Q: folds 
Lz/GjRDgmgepqTR7qmS86w: folds 
Lz/GjRDgmgepqTR7qmS86w is sitting out
Hsvkc0/G2VV78oVmWYXecw: folds 
Lz/GjRDgmgepqTR7qmS86w leaves the table
UA5OsKS3VPaxa7uC8La/kA: folds 
Uncalled bet ($0.15) returned to zHHLkD2sRljslKKeQv/ZQw
zHHLkD2sRljslKKeQv/ZQw collected $0.20 from pot
*** SUMMARY ***
Total pot $0.20 | Rake $0 
Seat 2: zHHLkD2sRljslKKeQv/ZQw (big blind) collected ($0.20)
Seat 3: 8ClCHtFXGNplITm+63KB+Q folded before Flop (didn't bet)
Seat 4: Lz/GjRDgmgepqTR7qmS86w folded before Flop (didn't bet)
Seat 5: Hsvkc0/G2VV78oVmWYXecw (button) folded before Flop (didn't bet)
Seat 6: UA5OsKS3VPaxa7uC8La/kA (small blind) folded before Flop




PokerStars Game #59941742968:  Hold'em No Limit ($0.10/$0.25) - 2009/07/01 1:44:44 ET
Table 'wGizWOswEL6P5QrvVkno/g' 6-max Seat #1 is the button
Seat 1: Qbfkn+ucISvbd1Xh32zAGA ($23.65 in chips) 
Seat 2: mfrkWA3PTeYPkbO6hi98Aw ($26.40 in chips) 
Seat 3: bJFzs6QmEEnz4miMfSDtcg ($12.90 in chips) 
Seat 4: 32YL2ZEp8NT4JB2RVM9euQ ($16.30 in chips) 
Seat 6: rfSnsAuAfXTb8w/obc9OVQ ($9.30 in chips) 
mfrkWA3PTeYPkbO6hi98Aw: posts small blind $0.10
bJFzs6QmEEnz4miMfSDtcg: posts big blind $0.25
*** HOLE CARDS ***
32YL2ZEp8NT4JB2RVM9euQ: folds 
rfSnsAuAfXTb8w/obc9OVQ: folds 
Qbfkn+ucISvbd1Xh32zAGA: folds 
mfrkWA3PTeYPkbO6hi98Aw: raises $0.75 to $1
bJFzs6QmEEnz4miMfSDtcg: folds 
Uncalled bet ($0.75) returned to mfrkWA3PTeYPkbO6hi98Aw
mfrkWA3PTeYPkbO6hi98Aw collected $0.50 from pot
mfrkWA3PTeYPkbO6hi98Aw: doesn't show hand 
*** SUMMARY ***
Total pot $0.50 | Rake $0 
Seat 1: Qbfkn+ucISvbd1Xh32zAGA (button) folded before Flop (didn't bet)
Seat 2: mfrkWA3PTeYPkbO6hi98Aw (small blind) collected ($0.50)
Seat 3: bJFzs6QmEEnz4miMfSDtcg (big blind) folded before Flop
Seat 4: 32YL2ZEp8NT4JB2RVM9euQ folded before Flop (didn't bet)
Seat 6: rfSnsAuAfXTb8w/obc9OVQ folded before Flop (didn't bet)




PokerStars Game #59941743034:  Hold'em No Limit ($0.10/$0.25) - 2009/07/01 1:44:44 ET
Table 'Of/T60zpXg1GcjrZ7Lm//Q' 9-max Seat #5 is the button
Seat 1: Lro4e37x4FUa5P3yzDjskw ($18.20 in chips) 
Seat 2: qwr38jl5txoR36M7G5qi4A ($9.90 in chips) 
Seat 3: 6RiVTYll/5D8zICp0MRpKw ($25 in chips) 
Seat 4: Czut6V7acIqUJrrobjKAZg ($16.65 in chips) 
Seat 5: IiLkthQMEje9LS79rCFQ1Q ($8.95 in chips) 
Seat 6: tYsOBqdU1+x+yFI7zHO7hQ ($31.55 in chips) 
Seat 7: PVxvfRTRvkgZf9WtquEkwQ ($25 in chips) 
Seat 8: ghNKXUBl/H+t83JF079ZBA ($26.50 in chips) 
Seat 9: egvg3mTBBVzMHnJPIQiKcA ($16.40 in chips) 
tYsOBqdU1+x+yFI7zHO7hQ: posts small blind $0.10
PVxvfRTRvkgZf9WtquEkwQ: posts big blind $0.25
*** HOLE CARDS ***
ghNKXUBl/H+t83JF079ZBA: folds 
egvg3mTBBVzMHnJPIQiKcA: folds 
Lro4e37x4FUa5P3yzDjskw: folds 
qwr38jl5txoR36M7G5qi4A: folds 
6RiVTYll/5D8zICp0MRpKw: folds 
Czut6V7acIqUJrrobjKAZg: calls $0.25
IiLkthQMEje9LS79rCFQ1Q: calls $0.25
tYsOBqdU1+x+yFI7zHO7hQ: folds 
PVxvfRTRvkgZf9WtquEkwQ: checks 
*** FLOP *** [Kc Qc 2h]
PVxvfRTRvkgZf9WtquEkwQ: checks 
Czut6V7acIqUJrrobjKAZg: checks 
IiLkthQMEje9LS79rCFQ1Q: checks 
*** TURN *** [Kc Qc 2h] [4h]
PVxvfRTRvkgZf9WtquEkwQ: checks 
Czut6V7acIqUJrrobjKAZg: checks 
IiLkthQMEje9LS79rCFQ1Q: bets $0.50
PVxvfRTRvkgZf9WtquEkwQ: calls $0.50
Czut6V7acIqUJrrobjKAZg: folds 
*** RIVER *** [Kc Qc 2h 4h] [5c]
PVxvfRTRvkgZf9WtquEkwQ: checks 
IiLkthQMEje9LS79rCFQ1Q: checks 
*** SHOW DOWN ***
PVxvfRTRvkgZf9WtquEkwQ: shows [Ts Jh] (high card King)
IiLkthQMEje9LS79rCFQ1Q: shows [Tc Qd] (a pair of Queens)
IiLkthQMEje9LS79rCFQ1Q collected $1.80 from pot
*** SUMMARY ***
Total pot $1.85 | Rake $0.05 
Board [Kc Qc 2h 4h 5c]
Seat 1: Lro4e37x4FUa5P3yzDjskw folded before Flop (didn't bet)
Seat 2: qwr38jl5txoR36M7G5qi4A folded before Flop (didn't bet)
Seat 3: 6RiVTYll/5D8zICp0MRpKw folded before Flop (didn't bet)
Seat 4: Czut6V7acIqUJrrobjKAZg folded on the Turn
Seat 5: IiLkthQMEje9LS79rCFQ1Q (button) showed [Tc Qd] and won ($1.80) with a pair of Queens
Seat 6: tYsOBqdU1+x+yFI7zHO7hQ (small blind) folded before Flop
Seat 7: PVxvfRTRvkgZf9WtquEkwQ (big blind) showed [Ts Jh] and lost with high card King
Seat 8: ghNKXUBl/H+t83JF079ZBA folded before Flop (didn't bet)
Seat 9: egvg3mTBBVzMHnJPIQiKcA folded before Flop (didn't bet)




PokerStars Game #59941742834:  Hold'em No Limit ($0.10/$0.25) - 2009/07/01 1:44:44 ET
Table 'ORSZkZqq+7Ja2PdeCFAytA' 9-max Seat #2 is the button
Seat 1: 3FkcXBaxKqxYVagfYUZlmw ($17.35 in chips) 
Seat 2: FzknuThd6oNi5WfR7ciTfA ($15.50 in chips) 
Seat 3: s9a4d23HFxaL70yUWQ0/tQ ($19.20 in chips) 
Seat 4: tbgfV2Egwn85xEt865GWQQ ($15.15 in chips) 
Seat 5: +lWbsq4dTcA70SX/+hnmpg ($5 in chips) 
Seat 6: gMF+EMhmwpnaM5TFQquf2A ($6 in chips) 
Seat 7: clJsV3v77RS07bDKY+705w ($5 in chips) 
Seat 8: npAYqa85pqnzfOK5ukX+BQ ($19.65 in chips) 
Seat 9: cMTFs4oCtNInkpDIecxT/w ($22.75 in chips) 
s9a4d23HFxaL70yUWQ0/tQ: posts small blind $0.10
tbgfV2Egwn85xEt865GWQQ: posts big blind $0.25
*** HOLE CARDS ***
+lWbsq4dTcA70SX/+hnmpg: folds 
gMF+EMhmwpnaM5TFQquf2A: raises $0.25 to $0.50
clJsV3v77RS07bDKY+705w: folds 
npAYqa85pqnzfOK5ukX+BQ: folds 
cMTFs4oCtNInkpDIecxT/w: calls $0.50
3FkcXBaxKqxYVagfYUZlmw: folds 
FzknuThd6oNi5WfR7ciTfA: calls $0.50
s9a4d23HFxaL70yUWQ0/tQ: folds 
tbgfV2Egwn85xEt865GWQQ: raises $2.35 to $2.85
gMF+EMhmwpnaM5TFQquf2A: folds 
cMTFs4oCtNInkpDIecxT/w: calls $2.35
FzknuThd6oNi5WfR7ciTfA: folds 
*** FLOP *** [Tc 9d 5s]
tbgfV2Egwn85xEt865GWQQ: bets $4.25
cMTFs4oCtNInkpDIecxT/w: folds 
Uncalled bet ($4.25) returned to tbgfV2Egwn85xEt865GWQQ
tbgfV2Egwn85xEt865GWQQ collected $6.50 from pot
FzknuThd6oNi5WfR7ciTfA leaves the table
tbgfV2Egwn85xEt865GWQQ: doesn't show hand 
*** SUMMARY ***
Total pot $6.80 | Rake $0.30 
Board [Tc 9d 5s]
Seat 1: 3FkcXBaxKqxYVagfYUZlmw folded before Flop (didn't bet)
Seat 2: FzknuThd6oNi5WfR7ciTfA (button) folded before Flop
Seat 3: s9a4d23HFxaL70yUWQ0/tQ (small blind) folded before Flop
Seat 4: tbgfV2Egwn85xEt865GWQQ (big blind) collected ($6.50)
Seat 5: +lWbsq4dTcA70SX/+hnmpg folded before Flop (didn't bet)
Seat 6: gMF+EMhmwpnaM5TFQquf2A folded before Flop
Seat 7: clJsV3v77RS07bDKY+705w folded before Flop (didn't bet)
Seat 8: npAYqa85pqnzfOK5ukX+BQ folded before Flop (didn't bet)
Seat 9: cMTFs4oCtNInkpDIecxT/w folded on the Flop




PokerStars Game #59941742986:  Hold'em No Limit ($0.10/$0.25) - 2009/07/01 1:44:44 ET
Table 'G+4ZdyRoPjgaJY/jxSlZzQ' 9-max Seat #9 is the button
Seat 1: ghNKXUBl/H+t83JF079ZBA ($23.40 in chips) 
Seat 2: CT7Xj/V/O5rBlhtt+RZeFQ ($25 in chips) 
Seat 3: FaGtAm5QUVcixGhAKIvbLg ($15.35 in chips) 
Seat 4: lSeLm4BdnSMLtIli62qjAQ ($10.65 in chips) 
Seat 5: BT6Oal0iO4P6kDuT7HFQDw ($15.45 in chips) 
Seat 6: oFwaTjy3ok/+qFghsrcGvg ($23.30 in chips) 
Seat 7: IK3/w7XV7rd8mVIsuasjYA ($4.40 in chips) 
Seat 8: bXpVeaSTPBFSPJmeXxO7nw ($4.65 in chips) 
Seat 9: tLcDklc2rBORNfixyRfVfw ($25 in chips) 
ghNKXUBl/H+t83JF079ZBA: posts small blind $0.10
CT7Xj/V/O5rBlhtt+RZeFQ: posts big blind $0.25
*** HOLE CARDS ***
FaGtAm5QUVcixGhAKIvbLg: calls $0.25
lSeLm4BdnSMLtIli62qjAQ: calls $0.25
BT6Oal0iO4P6kDuT7HFQDw: calls $0.25
oFwaTjy3ok/+qFghsrcGvg: folds 
IK3/w7XV7rd8mVIsuasjYA: calls $0.25
bXpVeaSTPBFSPJmeXxO7nw: folds 
tLcDklc2rBORNfixyRfVfw: folds 
ghNKXUBl/H+t83JF079ZBA: folds 
CT7Xj/V/O5rBlhtt+RZeFQ: checks 
*** FLOP *** [5h Th 6s]
CT7Xj/V/O5rBlhtt+RZeFQ: checks 
FaGtAm5QUVcixGhAKIvbLg: checks 
lSeLm4BdnSMLtIli62qjAQ: checks 
BT6Oal0iO4P6kDuT7HFQDw: bets $1.25
IK3/w7XV7rd8mVIsuasjYA: folds 
CT7Xj/V/O5rBlhtt+RZeFQ: folds 
FaGtAm5QUVcixGhAKIvbLg: folds 
lSeLm4BdnSMLtIli62qjAQ: folds 
Uncalled bet ($1.25) returned to BT6Oal0iO4P6kDuT7HFQDw
lSeLm4BdnSMLtIli62qjAQ is sitting out
BT6Oal0iO4P6kDuT7HFQDw collected $1.30 from pot
BT6Oal0iO4P6kDuT7HFQDw: doesn't show hand 
*** SUMMARY ***
Total pot $1.35 | Rake $0.05 
Board [5h Th 6s]
Seat 1: ghNKXUBl/H+t83JF079ZBA (small blind) folded before Flop
Seat 2: CT7Xj/V/O5rBlhtt+RZeFQ (big blind) folded on the Flop
Seat 3: FaGtAm5QUVcixGhAKIvbLg folded on the Flop
Seat 4: lSeLm4BdnSMLtIli62qjAQ folded on the Flop
Seat 5: BT6Oal0iO4P6kDuT7HFQDw collected ($1.30)
Seat 6: oFwaTjy3ok/+qFghsrcGvg folded before Flop (didn't bet)
Seat 7: IK3/w7XV7rd8mVIsuasjYA folded on the Flop
Seat 8: bXpVeaSTPBFSPJmeXxO7nw folded before Flop (didn't bet)
Seat 9: tLcDklc2rBORNfixyRfVfw (button) folded before Flop (didn't bet)




PokerStars Game #59941742954:  Hold'em No Limit ($0.10/$0.25) - 2009/07/01 1:44:44 ET
Table 'dVzscin98UhGisTmV9BDcw' 9-max Seat #3 is the button
Seat 1: sBAwXpkpgyhyWbHIQcIJKA ($17.55 in chips) 
Seat 2: dfNim92Z6XK1/h5SFW5vDg ($28.25 in chips) 
Seat 3: cZ99hugmLBj9KhTlc8nCSw ($25 in chips) 
Seat 4: aNpwfA31EREwO+ar4XzBCw ($42.35 in chips) 
Seat 7: cKlmpQMahVsmOaxFQDcoOg ($24.65 in chips) 
Seat 8: /vn2Qu2dvc9AMMq46Ae0jA ($44.40 in chips) 
Seat 9: arxNSjreDRGFg13EAM2F1w ($25.35 in chips) 
aNpwfA31EREwO+ar4XzBCw: posts small blind $0.10
bXpVeaSTPBFSPJmeXxO7nw: is sitting out 
cKlmpQMahVsmOaxFQDcoOg: posts big blind $0.25
*** HOLE CARDS ***
bXpVeaSTPBFSPJmeXxO7nw leaves the table
/vn2Qu2dvc9AMMq46Ae0jA: calls $0.25
E0iYnEVO2ho7dH3QcCjw7g joins the table at seat #5 
arxNSjreDRGFg13EAM2F1w: folds 
sBAwXpkpgyhyWbHIQcIJKA: calls $0.25
dfNim92Z6XK1/h5SFW5vDg: calls $0.25
A/OkFabqdcrG3ozpiYMiNQ joins the table at seat #6 
cZ99hugmLBj9KhTlc8nCSw: raises $1.25 to $1.50
aNpwfA31EREwO+ar4XzBCw: folds 
cKlmpQMahVsmOaxFQDcoOg: folds 
/vn2Qu2dvc9AMMq46Ae0jA: raises $42.90 to $44.40 and is all-in
sBAwXpkpgyhyWbHIQcIJKA: folds 
dfNim92Z6XK1/h5SFW5vDg: folds 
cZ99hugmLBj9KhTlc8nCSw: folds 
Uncalled bet ($42.90) returned to /vn2Qu2dvc9AMMq46Ae0jA
/vn2Qu2dvc9AMMq46Ae0jA collected $3.85 from pot
*** SUMMARY ***
Total pot $3.85 | Rake $0 
Seat 1: sBAwXpkpgyhyWbHIQcIJKA folded before Flop
Seat 2: dfNim92Z6XK1/h5SFW5vDg folded before Flop
Seat 3: cZ99hugmLBj9KhTlc8nCSw (button) folded before Flop
Seat 4: aNpwfA31EREwO+ar4XzBCw (small blind) folded before Flop
Seat 7: cKlmpQMahVsmOaxFQDcoOg (big blind) folded before Flop
Seat 8: /vn2Qu2dvc9AMMq46Ae0jA collected ($3.85)
Seat 9: arxNSjreDRGFg13EAM2F1w folded before Flop (didn't bet)




PokerStars Game #59941742802:  Hold'em No Limit ($0.10/$0.25) - 2009/07/01 1:44:44 ET
Table 'Dun24l/X8kjpUHWBhkVOFw' 6-max Seat #3 is the button
Seat 1: u3Ol7kv1LmvszuHNm9rc6w ($25 in chips) 
Seat 3: +E5iJKkKVfaTgTqzuXXv0g ($15 in chips) 
Seat 4: 7/ROHX4tuLekJ2diYIlMkw ($5 in chips) 
7/ROHX4tuLekJ2diYIlMkw: posts small blind $0.10
u3Ol7kv1LmvszuHNm9rc6w: posts big blind $0.25
*** HOLE CARDS ***
+E5iJKkKVfaTgTqzuXXv0g: folds 
7/ROHX4tuLekJ2diYIlMkw: calls $0.15
u3Ol7kv1LmvszuHNm9rc6w: raises $0.50 to $0.75
7/ROHX4tuLekJ2diYIlMkw: calls $0.50
*** FLOP *** [4h 3h 9c]
7/ROHX4tuLekJ2diYIlMkw: checks 
u3Ol7kv1LmvszuHNm9rc6w: bets $1.25
7/ROHX4tuLekJ2diYIlMkw: raises $3 to $4.25 and is all-in
u3Ol7kv1LmvszuHNm9rc6w: calls $3
6hUmfDYq+83kvxWoTBQmfw joins the table at seat #2 
*** TURN *** [4h 3h 9c] [Kd]
*** RIVER *** [4h 3h 9c Kd] [Kh]
*** SHOW DOWN ***
7/ROHX4tuLekJ2diYIlMkw: shows [9d 4d] (two pair, Kings and Nines)
u3Ol7kv1LmvszuHNm9rc6w: mucks hand 
7/ROHX4tuLekJ2diYIlMkw collected $9.55 from pot
*** SUMMARY ***
Total pot $10 | Rake $0.45 
Board [4h 3h 9c Kd Kh]
Seat 1: u3Ol7kv1LmvszuHNm9rc6w (big blind) mucked
Seat 3: +E5iJKkKVfaTgTqzuXXv0g (button) folded before Flop (didn't bet)
Seat 4: 7/ROHX4tuLekJ2diYIlMkw (small blind) showed [9d 4d] and won ($9.55) with two pair, Kings and Nines




PokerStars Game #59941742832:  Hold'em No Limit ($0.10/$0.25) - 2009/07/01 1:44:44 ET
Table 'KU/HrxqxwDz8HKEhYTZ6uw' 6-max Seat #4 is the button
Seat 1: 7LKoiQHXpTQXJvWQrw907g ($32.55 in chips) 
Seat 2: kG34n23qFQA3nzdOJTQ1dA ($25 in chips) 
Seat 3: SFmT9ZsVopnukjvAzrxTRg ($25 in chips) 
Seat 4: AGwMM0FUhYZf81+oXvYQMg ($25.90 in chips) 
Seat 5: iyZxqznXjv3vtvOJymkoLQ ($51 in chips) 
Seat 6: qWxkCeqApAWdAA0evrfDvQ ($17 in chips) 
iyZxqznXjv3vtvOJymkoLQ: posts small blind $0.10
qWxkCeqApAWdAA0evrfDvQ: posts big blind $0.25
*** HOLE CARDS ***
7LKoiQHXpTQXJvWQrw907g: calls $0.25
kG34n23qFQA3nzdOJTQ1dA: folds 
SFmT9ZsVopnukjvAzrxTRg: folds 
AGwMM0FUhYZf81+oXvYQMg: raises $0.50 to $0.75
iyZxqznXjv3vtvOJymkoLQ: folds 
qWxkCeqApAWdAA0evrfDvQ: folds 
7LKoiQHXpTQXJvWQrw907g: calls $0.50
*** FLOP *** [Ac Ks Ts]
7LKoiQHXpTQXJvWQrw907g: checks 
AGwMM0FUhYZf81+oXvYQMg: bets $1.25
7LKoiQHXpTQXJvWQrw907g: folds 
Uncalled bet ($1.25) returned to AGwMM0FUhYZf81+oXvYQMg
AGwMM0FUhYZf81+oXvYQMg collected $1.80 from pot
AGwMM0FUhYZf81+oXvYQMg: doesn't show hand 
*** SUMMARY ***
Total pot $1.85 | Rake $0.05 
Board [Ac Ks Ts]
Seat 1: 7LKoiQHXpTQXJvWQrw907g folded on the Flop
Seat 2: kG34n23qFQA3nzdOJTQ1dA folded before Flop (didn't bet)
Seat 3: SFmT9ZsVopnukjvAzrxTRg folded before Flop (didn't bet)
Seat 4: AGwMM0FUhYZf81+oXvYQMg (button) collected ($1.80)
Seat 5: iyZxqznXjv3vtvOJymkoLQ (small blind) folded before Flop
Seat 6: qWxkCeqApAWdAA0evrfDvQ (big blind) folded before Flop




PokerStars Game #59941742740:  Hold'em No Limit ($0.10/$0.25) - 2009/07/01 1:44:44 ET
Table 'IUwZ/e0bDHZPgsIWx0RnNg' 6-max Seat #3 is the button
Seat 1: V66QiVCQPofyl3a+dpPHQQ ($6.05 in chips) 
Seat 2: mvFHK3pE7tCxJEqLjKC70Q ($55.95 in chips) 
Seat 3: dOX4wnYV2sEqvDbF+8KSCw ($25 in chips) 
Seat 4: OIjOiBfQstWrK/RuXx7zcw ($4.95 in chips) 
Seat 5: 9bpVv1/Qh9IYtXuCtl5VtQ ($25 in chips) 
Seat 6: NhUN/JpAprdJeamFBgJH1w ($39.25 in chips) 
OIjOiBfQstWrK/RuXx7zcw: posts small blind $0.10
9bpVv1/Qh9IYtXuCtl5VtQ: posts big blind $0.25
*** HOLE CARDS ***
NhUN/JpAprdJeamFBgJH1w: folds 
V66QiVCQPofyl3a+dpPHQQ: calls $0.25
mvFHK3pE7tCxJEqLjKC70Q: folds 
dOX4wnYV2sEqvDbF+8KSCw: folds 
OIjOiBfQstWrK/RuXx7zcw: calls $0.15
9bpVv1/Qh9IYtXuCtl5VtQ: checks 
*** FLOP *** [8h 9d 6h]
OIjOiBfQstWrK/RuXx7zcw: bets $1
9bpVv1/Qh9IYtXuCtl5VtQ: folds 
V66QiVCQPofyl3a+dpPHQQ: folds 
Uncalled bet ($1) returned to OIjOiBfQstWrK/RuXx7zcw
OIjOiBfQstWrK/RuXx7zcw collected $0.75 from pot
OIjOiBfQstWrK/RuXx7zcw: doesn't show hand 
*** SUMMARY ***
Total pot $0.75 | Rake $0 
Board [8h 9d 6h]
Seat 1: V66QiVCQPofyl3a+dpPHQQ folded on the Flop
Seat 2: mvFHK3pE7tCxJEqLjKC70Q folded before Flop (didn't bet)
Seat 3: dOX4wnYV2sEqvDbF+8KSCw (button) folded before Flop (didn't bet)
Seat 4: OIjOiBfQstWrK/RuXx7zcw (small blind) collected ($0.75)
Seat 5: 9bpVv1/Qh9IYtXuCtl5VtQ (big blind) folded on the Flop
Seat 6: NhUN/JpAprdJeamFBgJH1w folded before Flop (didn't bet)




PokerStars Game #59941743098:  Hold'em No Limit ($0.10/$0.25) - 2009/07/01 1:44:44 ET
Table 'Pz8SfAzhP5nvWTsJRAxoDg' 6-max Seat #3 is the button
Seat 1: QiL+lEgEWwy21jk/ltaRLg ($47.50 in chips) 
Seat 2: xrf8tAXKQHG99HixCot1Iw ($1.80 in chips) 
Seat 3: mfrkWA3PTeYPkbO6hi98Aw ($27.85 in chips) 
Seat 4: 4lJto+Qj0K4JrFKvHaPTLw ($65.90 in chips) 
Seat 5: FYepjhAvF8ZdVCmqHIy+eQ ($28.40 in chips) 
Seat 6: QvTX2yGq3uKJiKPmns4TKQ ($24.65 in chips) 
4lJto+Qj0K4JrFKvHaPTLw: posts small blind $0.10
FYepjhAvF8ZdVCmqHIy+eQ: posts big blind $0.25
*** HOLE CARDS ***
QvTX2yGq3uKJiKPmns4TKQ: folds 
QiL+lEgEWwy21jk/ltaRLg: folds 
xrf8tAXKQHG99HixCot1Iw: folds 
xrf8tAXKQHG99HixCot1Iw leaves the table
mfrkWA3PTeYPkbO6hi98Aw: raises $0.75 to $1
4lJto+Qj0K4JrFKvHaPTLw: calls $0.90
FYepjhAvF8ZdVCmqHIy+eQ: folds 
*** FLOP *** [5c 8h 4s]
4lJto+Qj0K4JrFKvHaPTLw: bets $1.50
mfrkWA3PTeYPkbO6hi98Aw: folds 
Uncalled bet ($1.50) returned to 4lJto+Qj0K4JrFKvHaPTLw
4lJto+Qj0K4JrFKvHaPTLw collected $2.15 from pot
*** SUMMARY ***
Total pot $2.25 | Rake $0.10 
Board [5c 8h 4s]
Seat 1: QiL+lEgEWwy21jk/ltaRLg folded before Flop (didn't bet)
Seat 2: xrf8tAXKQHG99HixCot1Iw folded before Flop (didn't bet)
Seat 3: mfrkWA3PTeYPkbO6hi98Aw (button) folded on the Flop
Seat 4: 4lJto+Qj0K4JrFKvHaPTLw (small blind) collected ($2.15)
Seat 5: FYepjhAvF8ZdVCmqHIy+eQ (big blind) folded before Flop
Seat 6: QvTX2yGq3uKJiKPmns4TKQ folded before Flop (didn't bet)




PokerStars Game #59941743138:  Hold'em No Limit ($0.10/$0.25) - 2009/07/01 1:44:45 ET
Table '4UJB/UOZ5aepyF2v+hIoUg' 6-max Seat #4 is the button
Seat 1: 08V++DOqzaNrRNsHIwi25w ($26.60 in chips) 
Seat 2: mFv3iBCtrw9XfCDRB0d46Q ($4.55 in chips) 
Seat 3: zlYHXTtJ5tcx9kwK2h5n9A ($39 in chips) 
Seat 4: R6AGToFJQOYVZAjC2jXEKw ($23.85 in chips) 
Seat 5: 3zD3qLXT1bEffAoWGnc7wg ($25.65 in chips) 
Seat 6: 2aphcinkTZT0B0Uoah6cvQ ($16.85 in chips) 
3zD3qLXT1bEffAoWGnc7wg: posts small blind $0.10
2aphcinkTZT0B0Uoah6cvQ: posts big blind $0.25
*** HOLE CARDS ***
08V++DOqzaNrRNsHIwi25w: folds 
mFv3iBCtrw9XfCDRB0d46Q: folds 
zlYHXTtJ5tcx9kwK2h5n9A: raises $0.50 to $0.75
R6AGToFJQOYVZAjC2jXEKw: folds 
3zD3qLXT1bEffAoWGnc7wg: folds 
2aphcinkTZT0B0Uoah6cvQ: calls $0.50
*** FLOP *** [Tc 2c 3s]
2aphcinkTZT0B0Uoah6cvQ: checks 
zlYHXTtJ5tcx9kwK2h5n9A: checks 
*** TURN *** [Tc 2c 3s] [Jh]
2aphcinkTZT0B0Uoah6cvQ: bets $1
zlYHXTtJ5tcx9kwK2h5n9A: raises $2 to $3
2aphcinkTZT0B0Uoah6cvQ: calls $2
*** RIVER *** [Tc 2c 3s Jh] [3c]
2aphcinkTZT0B0Uoah6cvQ: checks 
zlYHXTtJ5tcx9kwK2h5n9A: checks 
*** SHOW DOWN ***
2aphcinkTZT0B0Uoah6cvQ: shows [Ts Ah] (two pair, Tens and Threes)
zlYHXTtJ5tcx9kwK2h5n9A: shows [Js Ac] (two pair, Jacks and Threes)
zlYHXTtJ5tcx9kwK2h5n9A collected $7.25 from pot
*** SUMMARY ***
Total pot $7.60 | Rake $0.35 
Board [Tc 2c 3s Jh 3c]
Seat 1: 08V++DOqzaNrRNsHIwi25w folded before Flop (didn't bet)
Seat 2: mFv3iBCtrw9XfCDRB0d46Q folded before Flop (didn't bet)
Seat 3: zlYHXTtJ5tcx9kwK2h5n9A showed [Js Ac] and won ($7.25) with two pair, Jacks and Threes
Seat 4: R6AGToFJQOYVZAjC2jXEKw (button) folded before Flop (didn't bet)
Seat 5: 3zD3qLXT1bEffAoWGnc7wg (small blind) folded before Flop
Seat 6: 2aphcinkTZT0B0Uoah6cvQ (big blind) showed [Ts Ah] and lost with two pair, Tens and Threes




PokerStars Game #59941743150:  Hold'em No Limit ($0.10/$0.25) - 2009/07/01 1:44:45 ET
Table 'jItkp2PNTbH9Cf7gqsAF7g' 9-max Seat #3 is the button
Seat 1: wGigCmBR/9XWkPpvYos3aQ ($25.70 in chips) 
Seat 2: qwr38jl5txoR36M7G5qi4A ($7.95 in chips) 
Seat 3: 0YaJElQVLqWThIZnqq3w1g ($15 in chips) 
Seat 4: oJOvZw/Iayou0f0k6dkBhg ($5.70 in chips) 
Seat 5: NO6qGDOw12lhu3zh1xW3Bg ($19.55 in chips) 
Seat 6: cZ99hugmLBj9KhTlc8nCSw ($53 in chips) 
Seat 8: cq6LACCDFivk2+PeoiB2sw ($6.65 in chips) 
Seat 9: dtZ84flFEi4Q+SGrHMJRDQ ($25.15 in chips) 
oJOvZw/Iayou0f0k6dkBhg: posts small blind $0.10
NO6qGDOw12lhu3zh1xW3Bg: posts big blind $0.25
*** HOLE CARDS ***
cZ99hugmLBj9KhTlc8nCSw: folds 
cq6LACCDFivk2+PeoiB2sw: folds 
dtZ84flFEi4Q+SGrHMJRDQ: folds 
wGigCmBR/9XWkPpvYos3aQ: raises $0.65 to $0.90
qwr38jl5txoR36M7G5qi4A: folds 
0YaJElQVLqWThIZnqq3w1g: calls $0.90
oJOvZw/Iayou0f0k6dkBhg: folds 
NO6qGDOw12lhu3zh1xW3Bg: folds 
*** FLOP *** [4h 3d 8s]
wGigCmBR/9XWkPpvYos3aQ: checks 
0YaJElQVLqWThIZnqq3w1g: checks 
*** TURN *** [4h 3d 8s] [Qd]
wGigCmBR/9XWkPpvYos3aQ: checks 
0YaJElQVLqWThIZnqq3w1g: checks 
*** RIVER *** [4h 3d 8s Qd] [4s]
wGigCmBR/9XWkPpvYos3aQ: checks 
0YaJElQVLqWThIZnqq3w1g: checks 
*** SHOW DOWN ***
wGigCmBR/9XWkPpvYos3aQ: shows [As 9s] (a pair of Fours)
0YaJElQVLqWThIZnqq3w1g: mucks hand 
wGigCmBR/9XWkPpvYos3aQ collected $2.05 from pot
*** SUMMARY ***
Total pot $2.15 | Rake $0.10 
Board [4h 3d 8s Qd 4s]
Seat 1: wGigCmBR/9XWkPpvYos3aQ showed [As 9s] and won ($2.05) with a pair of Fours
Seat 2: qwr38jl5txoR36M7G5qi4A folded before Flop (didn't bet)
Seat 3: 0YaJElQVLqWThIZnqq3w1g (button) mucked
Seat 4: oJOvZw/Iayou0f0k6dkBhg (small blind) folded before Flop
Seat 5: NO6qGDOw12lhu3zh1xW3Bg (big blind) folded before Flop
Seat 6: cZ99hugmLBj9KhTlc8nCSw folded before Flop (didn't bet)
Seat 8: cq6LACCDFivk2+PeoiB2sw folded before Flop (didn't bet)
Seat 9: dtZ84flFEi4Q+SGrHMJRDQ folded before Flop (didn't bet)




PokerStars Game #59941743152:  Hold'em No Limit ($0.10/$0.25) - 2009/07/01 1:44:45 ET
Table 'emoxgHTxg9Uqeu06oLzLyg' 6-max Seat #3 is the button
Seat 2: wIFhgE1PVdX6Xf6aVlSTPg ($28.55 in chips) 
Seat 3: uD5epdBxuyc30pF1dO958Q ($9.60 in chips) 
Seat 4: 3VAbqAWh8ncE2SJOYIx2ZQ ($11.75 in chips) 
Seat 5: OIjOiBfQstWrK/RuXx7zcw ($3.40 in chips) 
Seat 6: iHZrkhpIO/3+tKuAoPx8HQ ($2.65 in chips) 
3VAbqAWh8ncE2SJOYIx2ZQ: posts small blind $0.10
OIjOiBfQstWrK/RuXx7zcw: posts big blind $0.25
epAUIB7h2FJXzUPRIvSkRA: sits out 
*** HOLE CARDS ***
iHZrkhpIO/3+tKuAoPx8HQ: folds 
wIFhgE1PVdX6Xf6aVlSTPg: folds 
uD5epdBxuyc30pF1dO958Q: calls $0.25
3VAbqAWh8ncE2SJOYIx2ZQ: calls $0.15
OIjOiBfQstWrK/RuXx7zcw: checks 
*** FLOP *** [7d 8c 3d]
3VAbqAWh8ncE2SJOYIx2ZQ: checks 
OIjOiBfQstWrK/RuXx7zcw: bets $0.25
uD5epdBxuyc30pF1dO958Q: folds 
3VAbqAWh8ncE2SJOYIx2ZQ: calls $0.25
*** TURN *** [7d 8c 3d] [Js]
3VAbqAWh8ncE2SJOYIx2ZQ: checks 
OIjOiBfQstWrK/RuXx7zcw: bets $0.50
3VAbqAWh8ncE2SJOYIx2ZQ: calls $0.50
*** RIVER *** [7d 8c 3d Js] [4h]
3VAbqAWh8ncE2SJOYIx2ZQ: checks 
OIjOiBfQstWrK/RuXx7zcw: bets $1.75
3VAbqAWh8ncE2SJOYIx2ZQ: folds 
Uncalled bet ($1.75) returned to OIjOiBfQstWrK/RuXx7zcw
OIjOiBfQstWrK/RuXx7zcw collected $2.15 from pot
OIjOiBfQstWrK/RuXx7zcw: doesn't show hand 
*** SUMMARY ***
Total pot $2.25 | Rake $0.10 
Board [7d 8c 3d Js 4h]
Seat 2: wIFhgE1PVdX6Xf6aVlSTPg folded before Flop (didn't bet)
Seat 3: uD5epdBxuyc30pF1dO958Q (button) folded on the Flop
Seat 4: 3VAbqAWh8ncE2SJOYIx2ZQ (small blind) folded on the River
Seat 5: OIjOiBfQstWrK/RuXx7zcw (big blind) collected ($2.15)
Seat 6: iHZrkhpIO/3+tKuAoPx8HQ folded before Flop (didn't bet)




PokerStars Game #59941744154:  Hold'em No Limit ($0.10/$0.25) - 2009/07/01 1:44:46 ET
Table 'hfHe8uKeSJMyWAjSdM7ROQ' 6-max Seat #5 is the button
Seat 1: eHsmIvAb2JREg4O6hNPnXg ($40.45 in chips) 
Seat 2: QvTX2yGq3uKJiKPmns4TKQ ($30.15 in chips) 
Seat 3: oAzQdB2jFOH1NxFUPjYUGg ($26.40 in chips) 
Seat 4: b4wRQV3APH8irVk6bUFe2Q ($25.85 in chips) 
Seat 5: euswrBD1XG0Q5hB1iGJBKQ ($61.55 in chips) 
eL3+wCBjFGfQ5FMdIZihwA will be allowed to play after the button
eHsmIvAb2JREg4O6hNPnXg: posts small blind $0.10
QvTX2yGq3uKJiKPmns4TKQ: posts big blind $0.25
*** HOLE CARDS ***
oAzQdB2jFOH1NxFUPjYUGg: raises $0.25 to $0.50
b4wRQV3APH8irVk6bUFe2Q: folds 
euswrBD1XG0Q5hB1iGJBKQ: folds 
eHsmIvAb2JREg4O6hNPnXg: folds 
QvTX2yGq3uKJiKPmns4TKQ: folds 
Uncalled bet ($0.25) returned to oAzQdB2jFOH1NxFUPjYUGg
oAzQdB2jFOH1NxFUPjYUGg collected $0.60 from pot
oAzQdB2jFOH1NxFUPjYUGg: doesn't show hand 
*** SUMMARY ***
Total pot $0.60 | Rake $0 
Seat 1: eHsmIvAb2JREg4O6hNPnXg (small blind) folded before Flop
Seat 2: QvTX2yGq3uKJiKPmns4TKQ (big blind) folded before Flop
Seat 3: oAzQdB2jFOH1NxFUPjYUGg collected ($0.60)
Seat 4: b4wRQV3APH8irVk6bUFe2Q folded before Flop (didn't bet)
Seat 5: euswrBD1XG0Q5hB1iGJBKQ (button) folded before Flop (didn't bet)




PokerStars Game #59941743940:  Hold'em No Limit ($0.10/$0.25) - 2009/07/01 1:44:46 ET
Table 'aisAlB9GIV21BwfUW3+Nbg' 9-max Seat #9 is the button
Seat 1: SqibpGx+lf+brY0fJVvD0w ($24.40 in chips) 
Seat 2: +7GnIVpCmyuij3NJfOgsTw ($15.35 in chips) 
Seat 3: CvL9Ch1HYCVbTsfpNucitg ($4.80 in chips) 
Seat 4: sD+TKtt36XiiN6jqHiLwDA ($25.20 in chips) 
Seat 5: ghNKXUBl/H+t83JF079ZBA ($27.40 in chips) 
Seat 6: 9gmYYQesalMrUjaF7nKfrQ ($16.20 in chips) 
Seat 7: jGjM+5lCSe6f2MEwxQGOAg ($25.25 in chips) 
Seat 8: VWUWpMLMj/Q1jRVpF7Aohw ($11.65 in chips) 
Seat 9: N0hGpTAEAj9k5msS6LPLAw ($22.10 in chips) 
SqibpGx+lf+brY0fJVvD0w: posts small blind $0.10
+7GnIVpCmyuij3NJfOgsTw: posts big blind $0.25
*** HOLE CARDS ***
CvL9Ch1HYCVbTsfpNucitg: folds 
sD+TKtt36XiiN6jqHiLwDA: folds 
ghNKXUBl/H+t83JF079ZBA: raises $0.75 to $1
9gmYYQesalMrUjaF7nKfrQ: folds 
jGjM+5lCSe6f2MEwxQGOAg: calls $1
VWUWpMLMj/Q1jRVpF7Aohw: calls $1
N0hGpTAEAj9k5msS6LPLAw: folds 
SqibpGx+lf+brY0fJVvD0w: folds 
+7GnIVpCmyuij3NJfOgsTw: calls $0.75
*** FLOP *** [9c Ac As]
+7GnIVpCmyuij3NJfOgsTw: checks 
ghNKXUBl/H+t83JF079ZBA: bets $2.25
jGjM+5lCSe6f2MEwxQGOAg: folds 
VWUWpMLMj/Q1jRVpF7Aohw: raises $8.40 to $10.65 and is all-in
+7GnIVpCmyuij3NJfOgsTw: raises $3.70 to $14.35 and is all-in
ghNKXUBl/H+t83JF079ZBA: folds 
Uncalled bet ($3.70) returned to +7GnIVpCmyuij3NJfOgsTw
*** TURN *** [9c Ac As] [9h]
*** RIVER *** [9c Ac As 9h] [Kc]
*** SHOW DOWN ***
+7GnIVpCmyuij3NJfOgsTw: shows [Jd Ah] (a full house, Aces full of Nines)
VWUWpMLMj/Q1jRVpF7Aohw: shows [Ad Kh] (a full house, Aces full of Kings)
VWUWpMLMj/Q1jRVpF7Aohw collected $26.30 from pot
*** SUMMARY ***
Total pot $27.65 | Rake $1.35 
Board [9c Ac As 9h Kc]
Seat 1: SqibpGx+lf+brY0fJVvD0w (small blind) folded before Flop
Seat 2: +7GnIVpCmyuij3NJfOgsTw (big blind) showed [Jd Ah] and lost with a full house, Aces full of Nines
Seat 3: CvL9Ch1HYCVbTsfpNucitg folded before Flop (didn't bet)
Seat 4: sD+TKtt36XiiN6jqHiLwDA folded before Flop (didn't bet)
Seat 5: ghNKXUBl/H+t83JF079ZBA folded on the Flop
Seat 6: 9gmYYQesalMrUjaF7nKfrQ folded before Flop (didn't bet)
Seat 7: jGjM+5lCSe6f2MEwxQGOAg folded on the Flop
Seat 8: VWUWpMLMj/Q1jRVpF7Aohw showed [Ad Kh] and won ($26.30) with a full house, Aces full of Kings
Seat 9: N0hGpTAEAj9k5msS6LPLAw (button) folded before Flop (didn't bet)




PokerStars Game #59941743656:  Hold'em No Limit ($0.10/$0.25) - 2009/07/01 1:44:46 ET
Table 'vFZR6Kf2Th5xBXT9brGW6A' 6-max Seat #5 is the button
Seat 1: Q3EMN7b0ie81AFWkDrhCjw ($22 in chips) 
Seat 2: QiL+lEgEWwy21jk/ltaRLg ($22.40 in chips) 
Seat 3: SH1WjKVUjPiyXySjWSdazw ($21.35 in chips) 
Seat 4: 79ID/ub1Pt/mDpCprVmOoA ($35.20 in chips) 
Seat 5: SS/yfeArhULzIcOPe8MdPg ($26.30 in chips) 
Seat 6: 4x9jCqgSw4272dnaIqnanw ($5.35 in chips) 
4x9jCqgSw4272dnaIqnanw: posts small blind $0.10
Q3EMN7b0ie81AFWkDrhCjw: posts big blind $0.25
*** HOLE CARDS ***
QiL+lEgEWwy21jk/ltaRLg: folds 
SH1WjKVUjPiyXySjWSdazw: folds 
79ID/ub1Pt/mDpCprVmOoA: folds 
SS/yfeArhULzIcOPe8MdPg: folds 
4x9jCqgSw4272dnaIqnanw: raises $5.10 to $5.35 and is all-in
Q3EMN7b0ie81AFWkDrhCjw: calls $5.10
*** FLOP *** [5s Kh Qs]
*** TURN *** [5s Kh Qs] [Ah]
*** RIVER *** [5s Kh Qs Ah] [6h]
*** SHOW DOWN ***
4x9jCqgSw4272dnaIqnanw: shows [As Qh] (two pair, Aces and Queens)
Q3EMN7b0ie81AFWkDrhCjw: shows [Td Ts] (a pair of Tens)
4x9jCqgSw4272dnaIqnanw collected $10.20 from pot
*** SUMMARY ***
Total pot $10.70 | Rake $0.50 
Board [5s Kh Qs Ah 6h]
Seat 1: Q3EMN7b0ie81AFWkDrhCjw (big blind) showed [Td Ts] and lost with a pair of Tens
Seat 2: QiL+lEgEWwy21jk/ltaRLg folded before Flop (didn't bet)
Seat 3: SH1WjKVUjPiyXySjWSdazw folded before Flop (didn't bet)
Seat 4: 79ID/ub1Pt/mDpCprVmOoA folded before Flop (didn't bet)
Seat 5: SS/yfeArhULzIcOPe8MdPg (button) folded before Flop (didn't bet)
Seat 6: 4x9jCqgSw4272dnaIqnanw (small blind) showed [As Qh] and won ($10.20) with two pair, Aces and Queens




PokerStars Game #59941744508:  Hold'em No Limit ($0.10/$0.25) - 2009/07/01 1:44:47 ET
Table 'T/iCKJXGphRN3xcdwfE/JQ' 6-max Seat #5 is the button
Seat 1: wAKC8C/zN0c8V5v13dm9mA ($25 in chips) 
Seat 2: EeUZtMU058v2ObUACOF4Og ($32.35 in chips) 
Seat 3: IWAjoCPXtc1XUaZdp+pCpA ($23.35 in chips) 
Seat 4: tSR4329m40dZsN7YOpI9Kw ($52.95 in chips) 
Seat 5: gaPMxLGp9SOj4Lq6t+/0Ig ($7.75 in chips) 
Seat 6: Ey4Kn6PlnYb2srYYBJHvzg ($13.30 in chips) 
Ey4Kn6PlnYb2srYYBJHvzg: posts small blind $0.10
wAKC8C/zN0c8V5v13dm9mA: posts big blind $0.25
*** HOLE CARDS ***
EeUZtMU058v2ObUACOF4Og: folds 
IWAjoCPXtc1XUaZdp+pCpA: folds 
tSR4329m40dZsN7YOpI9Kw: folds 
gaPMxLGp9SOj4Lq6t+/0Ig: folds 
Ey4Kn6PlnYb2srYYBJHvzg: calls $0.15
wAKC8C/zN0c8V5v13dm9mA: checks 
*** FLOP *** [Qd 9d Kh]
Ey4Kn6PlnYb2srYYBJHvzg: bets $0.50
wAKC8C/zN0c8V5v13dm9mA: folds 
Uncalled bet ($0.50) returned to Ey4Kn6PlnYb2srYYBJHvzg
Ey4Kn6PlnYb2srYYBJHvzg collected $0.50 from pot
*** SUMMARY ***
Total pot $0.50 | Rake $0 
Board [Qd 9d Kh]
Seat 1: wAKC8C/zN0c8V5v13dm9mA (big blind) folded on the Flop
Seat 2: EeUZtMU058v2ObUACOF4Og folded before Flop (didn't bet)
Seat 3: IWAjoCPXtc1XUaZdp+pCpA folded before Flop (didn't bet)
Seat 4: tSR4329m40dZsN7YOpI9Kw folded before Flop (didn't bet)
Seat 5: gaPMxLGp9SOj4Lq6t+/0Ig (button) folded before Flop (didn't bet)
Seat 6: Ey4Kn6PlnYb2srYYBJHvzg (small blind) collected ($0.50)




PokerStars Game #59941744174:  Hold'em No Limit ($0.10/$0.25) - 2009/07/01 1:44:47 ET
Table 'mVdLgAdN9rGe6mMwSrDdGQ' 6-max Seat #3 is the button
Seat 1: OyJ0KTHA5cwh0/yCo1/rdA ($19.05 in chips) 
Seat 2: n9QqWD4tpbongUBX2Oi58w ($4.80 in chips) 
Seat 3: +baiVgI/ETnBARLe5mARCw ($13.95 in chips) 
Seat 4: scNSjC6yyKvvfklSkuzLrw ($9.70 in chips) 
Seat 5: +TMG/MBWpiEnc9t7i07eTA ($27.50 in chips) 
Seat 6: DihMHaz4WNETH1bPDe13kA ($47.80 in chips) 
scNSjC6yyKvvfklSkuzLrw: posts small blind $0.10
+TMG/MBWpiEnc9t7i07eTA: posts big blind $0.25
*** HOLE CARDS ***
DihMHaz4WNETH1bPDe13kA: folds 
OyJ0KTHA5cwh0/yCo1/rdA: folds 
n9QqWD4tpbongUBX2Oi58w: calls $0.25
+baiVgI/ETnBARLe5mARCw: folds 
scNSjC6yyKvvfklSkuzLrw: raises $0.50 to $0.75
+TMG/MBWpiEnc9t7i07eTA: calls $0.50
n9QqWD4tpbongUBX2Oi58w: calls $0.50
*** FLOP *** [8c 9h 9s]
scNSjC6yyKvvfklSkuzLrw: checks 
+TMG/MBWpiEnc9t7i07eTA: checks 
n9QqWD4tpbongUBX2Oi58w: checks 
*** TURN *** [8c 9h 9s] [3d]
scNSjC6yyKvvfklSkuzLrw: checks 
+TMG/MBWpiEnc9t7i07eTA: checks 
n9QqWD4tpbongUBX2Oi58w: bets $1.25
scNSjC6yyKvvfklSkuzLrw: folds 
+TMG/MBWpiEnc9t7i07eTA: folds 
Uncalled bet ($1.25) returned to n9QqWD4tpbongUBX2Oi58w
n9QqWD4tpbongUBX2Oi58w collected $2.15 from pot
n9QqWD4tpbongUBX2Oi58w: doesn't show hand 
*** SUMMARY ***
Total pot $2.25 | Rake $0.10 
Board [8c 9h 9s 3d]
Seat 1: OyJ0KTHA5cwh0/yCo1/rdA folded before Flop (didn't bet)
Seat 2: n9QqWD4tpbongUBX2Oi58w collected ($2.15)
Seat 3: +baiVgI/ETnBARLe5mARCw (button) folded before Flop (didn't bet)
Seat 4: scNSjC6yyKvvfklSkuzLrw (small blind) folded on the Turn
Seat 5: +TMG/MBWpiEnc9t7i07eTA (big blind) folded on the Turn
Seat 6: DihMHaz4WNETH1bPDe13kA folded before Flop (didn't bet)




PokerStars Game #59941744248:  Hold'em No Limit ($0.10/$0.25) - 2009/07/01 1:44:47 ET
Table 'zKwHJD0cmKNUure9qQTfFg' 6-max Seat #2 is the button
Seat 1: Hzrn9DZJegEZICufTNYkrg ($18.70 in chips) 
Seat 2: xrf8tAXKQHG99HixCot1Iw ($24.55 in chips) 
Seat 3: m9aw7LBAB5YX2ZqMtMkhqA ($15.95 in chips) 
Seat 4: v+QfkGiuj9bgtuNoVnDO8w ($25.80 in chips) 
Seat 5: E4AqQ1egsnu0oH2RqsbCmQ ($3.80 in chips) 
Seat 6: edio/rLJ06xeZOfLhoL3UA ($3.85 in chips) 
m9aw7LBAB5YX2ZqMtMkhqA: posts small blind $0.10
v+QfkGiuj9bgtuNoVnDO8w: posts big blind $0.25
*** HOLE CARDS ***
E4AqQ1egsnu0oH2RqsbCmQ: calls $0.25
edio/rLJ06xeZOfLhoL3UA: raises $0.75 to $1
Hzrn9DZJegEZICufTNYkrg: folds 
xrf8tAXKQHG99HixCot1Iw: folds 
m9aw7LBAB5YX2ZqMtMkhqA: folds 
v+QfkGiuj9bgtuNoVnDO8w: folds 
E4AqQ1egsnu0oH2RqsbCmQ: calls $0.75
*** FLOP *** [6s 7c 9c]
E4AqQ1egsnu0oH2RqsbCmQ: checks 
edio/rLJ06xeZOfLhoL3UA: bets $2.85 and is all-in
E4AqQ1egsnu0oH2RqsbCmQ: calls $2.80 and is all-in
Uncalled bet ($0.05) returned to edio/rLJ06xeZOfLhoL3UA
*** TURN *** [6s 7c 9c] [3d]
*** RIVER *** [6s 7c 9c 3d] [Qh]
*** SHOW DOWN ***
E4AqQ1egsnu0oH2RqsbCmQ: shows [Ad Td] (high card Ace)
edio/rLJ06xeZOfLhoL3UA: shows [5c 6c] (a pair of Sixes)
edio/rLJ06xeZOfLhoL3UA collected $7.60 from pot
*** SUMMARY ***
Total pot $7.95 | Rake $0.35 
Board [6s 7c 9c 3d Qh]
Seat 1: Hzrn9DZJegEZICufTNYkrg folded before Flop (didn't bet)
Seat 2: xrf8tAXKQHG99HixCot1Iw (button) folded before Flop (didn't bet)
Seat 3: m9aw7LBAB5YX2ZqMtMkhqA (small blind) folded before Flop
Seat 4: v+QfkGiuj9bgtuNoVnDO8w (big blind) folded before Flop
Seat 5: E4AqQ1egsnu0oH2RqsbCmQ showed [Ad Td] and lost with high card Ace
Seat 6: edio/rLJ06xeZOfLhoL3UA showed [5c 6c] and won ($7.60) with a pair of Sixes




PokerStars Game #59941744184:  Hold'em No Limit ($0.10/$0.25) - 2009/07/01 1:44:47 ET
Table 'NtEQAxCeIK2io1CGtW658g' 6-max Seat #6 is the button
Seat 1: X437kMQ7AujoaDgjguhU9w ($11.75 in chips) 
Seat 2: DgyznDqq/mLiCqQGMzc+Aw ($7 in chips) 
Seat 3: m2yWOKfAxqHoy5DDN87Ttw ($40.10 in chips) 
Seat 4: 8296 ($10.05 in chips) 
Seat 5: Hsvkc0/G2VV78oVmWYXecw ($5 in chips) 
Seat 6: /gJNBeCkWL4o85/jvlZ4BA ($64.35 in chips) 
X437kMQ7AujoaDgjguhU9w: posts small blind $0.10
DgyznDqq/mLiCqQGMzc+Aw: posts big blind $0.25
*** HOLE CARDS ***
m2yWOKfAxqHoy5DDN87Ttw: folds 
8296: folds 
Hsvkc0/G2VV78oVmWYXecw: folds 
/gJNBeCkWL4o85/jvlZ4BA: folds 
X437kMQ7AujoaDgjguhU9w: raises $0.50 to $0.75
m2yWOKfAxqHoy5DDN87Ttw leaves the table
DgyznDqq/mLiCqQGMzc+Aw: calls $0.50
*** FLOP *** [Kc 6c Kd]
X437kMQ7AujoaDgjguhU9w: bets $11 and is all-in
DgyznDqq/mLiCqQGMzc+Aw: folds 
Uncalled bet ($11) returned to X437kMQ7AujoaDgjguhU9w
X437kMQ7AujoaDgjguhU9w collected $1.45 from pot
X437kMQ7AujoaDgjguhU9w: doesn't show hand 
*** SUMMARY ***
Total pot $1.50 | Rake $0.05 
Board [Kc 6c Kd]
Seat 1: X437kMQ7AujoaDgjguhU9w (small blind) collected ($1.45)
Seat 2: DgyznDqq/mLiCqQGMzc+Aw (big blind) folded on the Flop
Seat 3: m2yWOKfAxqHoy5DDN87Ttw folded before Flop (didn't bet)
Seat 4: 8296 folded before Flop (didn't bet)
Seat 5: Hsvkc0/G2VV78oVmWYXecw folded before Flop (didn't bet)
Seat 6: /gJNBeCkWL4o85/jvlZ4BA (button) folded before Flop (didn't bet)




PokerStars Game #59941744690:  Hold'em No Limit ($0.10/$0.25) - 2009/07/01 1:44:47 ET
Table 'jxoHy9yJy0bbH/Qx73FoPA' 9-max Seat #5 is the button
Seat 1: j4q3p0lesp63b1gZDwLBZw ($6.60 in chips) 
Seat 2: F7pnn6czNpHvRM55XcA2EA ($45.50 in chips) 
Seat 3: CVqCt93Mk0MhKMaZ4LZDSQ ($11.20 in chips) 
Seat 5: rzZ3wFcwoPyKlQ0mB5JLRQ ($5 in chips) 
Seat 6: tYsOBqdU1+x+yFI7zHO7hQ ($62.65 in chips) 
Seat 7: wGigCmBR/9XWkPpvYos3aQ ($26.40 in chips) 
Seat 9: CvL9Ch1HYCVbTsfpNucitg ($4.90 in chips) 
tYsOBqdU1+x+yFI7zHO7hQ: posts small blind $0.10
wGigCmBR/9XWkPpvYos3aQ: posts big blind $0.25
Z9W7+g1WMhhZDi7DwGbCFA: sits out 
*** HOLE CARDS ***
CvL9Ch1HYCVbTsfpNucitg: folds 
sdhunter54 leaves the table
j4q3p0lesp63b1gZDwLBZw: folds 
F7pnn6czNpHvRM55XcA2EA: folds 
CVqCt93Mk0MhKMaZ4LZDSQ: calls $0.25
rzZ3wFcwoPyKlQ0mB5JLRQ: calls $0.25
tYsOBqdU1+x+yFI7zHO7hQ: folds 
wGigCmBR/9XWkPpvYos3aQ: checks 
*** FLOP *** [Tc 7h Kd]
bXpVeaSTPBFSPJmeXxO7nw joins the table at seat #4 
wGigCmBR/9XWkPpvYos3aQ: checks 
CVqCt93Mk0MhKMaZ4LZDSQ: checks 
rzZ3wFcwoPyKlQ0mB5JLRQ: bets $0.50
wGigCmBR/9XWkPpvYos3aQ: folds 
CVqCt93Mk0MhKMaZ4LZDSQ: calls $0.50
*** TURN *** [Tc 7h Kd] [3h]
CVqCt93Mk0MhKMaZ4LZDSQ: checks 
rzZ3wFcwoPyKlQ0mB5JLRQ: bets $1.50
CVqCt93Mk0MhKMaZ4LZDSQ: calls $1.50
*** RIVER *** [Tc 7h Kd 3h] [4c]
CVqCt93Mk0MhKMaZ4LZDSQ: checks 
rzZ3wFcwoPyKlQ0mB5JLRQ: bets $2.75 and is all-in
CVqCt93Mk0MhKMaZ4LZDSQ: folds 
Uncalled bet ($2.75) returned to rzZ3wFcwoPyKlQ0mB5JLRQ
rzZ3wFcwoPyKlQ0mB5JLRQ collected $4.65 from pot
*** SUMMARY ***
Total pot $4.85 | Rake $0.20 
Board [Tc 7h Kd 3h 4c]
Seat 1: j4q3p0lesp63b1gZDwLBZw folded before Flop (didn't bet)
Seat 2: F7pnn6czNpHvRM55XcA2EA folded before Flop (didn't bet)
Seat 3: CVqCt93Mk0MhKMaZ4LZDSQ folded on the River
Seat 5: rzZ3wFcwoPyKlQ0mB5JLRQ (button) collected ($4.65)
Seat 6: tYsOBqdU1+x+yFI7zHO7hQ (small blind) folded before Flop
Seat 7: wGigCmBR/9XWkPpvYos3aQ (big blind) folded on the Flop
Seat 9: CvL9Ch1HYCVbTsfpNucitg folded before Flop (didn't bet)




PokerStars Game #59941744246:  Hold'em No Limit ($0.10/$0.25) - 2009/07/01 1:44:47 ET
Table '52Meibn9NOL4XtVi1p2Upw' 9-max Seat #4 is the button
Seat 1: W6tExOcYX7qiy6Qdp+ZwFA ($6.80 in chips) 
Seat 3: Bb42QRQMhg5/Y0vHP8/2Xw ($25 in chips) 
Seat 4: oLa/tXLfSLLB28mcLGrxcg ($31.65 in chips) 
Seat 5: MXCztnYJ58KLHMztZvKrxA ($4.85 in chips) 
Seat 6: N5sUK8M0br9djLrW97V9pQ ($25 in chips) 
Seat 8: PFv56Q1PTkDC084eXIAYmw ($23.75 in chips) 
Seat 9: RCqMONFrSPSArZh2Jsar/w ($19.65 in chips) 
MXCztnYJ58KLHMztZvKrxA: posts small blind $0.10
N5sUK8M0br9djLrW97V9pQ: posts big blind $0.25
Qduu7ikeizo6q6Ei9YvcJA: sits out 
*** HOLE CARDS ***
PFv56Q1PTkDC084eXIAYmw: calls $0.25
RCqMONFrSPSArZh2Jsar/w: folds 
W6tExOcYX7qiy6Qdp+ZwFA: folds 
Bb42QRQMhg5/Y0vHP8/2Xw: folds 
oLa/tXLfSLLB28mcLGrxcg: folds 
MXCztnYJ58KLHMztZvKrxA: calls $0.15
N5sUK8M0br9djLrW97V9pQ: raises $1 to $1.25
PFv56Q1PTkDC084eXIAYmw: calls $1
MXCztnYJ58KLHMztZvKrxA: calls $1
*** FLOP *** [4c 2h 7d]
MXCztnYJ58KLHMztZvKrxA: checks 
N5sUK8M0br9djLrW97V9pQ: bets $2.50
PFv56Q1PTkDC084eXIAYmw: calls $2.50
MXCztnYJ58KLHMztZvKrxA: folds 
*** TURN *** [4c 2h 7d] [Jc]
N5sUK8M0br9djLrW97V9pQ: bets $8.25
BKKiMP leaves the table
PFv56Q1PTkDC084eXIAYmw: folds 
Uncalled bet ($8.25) returned to N5sUK8M0br9djLrW97V9pQ
N5sUK8M0br9djLrW97V9pQ collected $8.35 from pot
PFv56Q1PTkDC084eXIAYmw leaves the table
N5sUK8M0br9djLrW97V9pQ: doesn't show hand 
*** SUMMARY ***
Total pot $8.75 | Rake $0.40 
Board [4c 2h 7d Jc]
Seat 1: W6tExOcYX7qiy6Qdp+ZwFA folded before Flop (didn't bet)
Seat 3: Bb42QRQMhg5/Y0vHP8/2Xw folded before Flop (didn't bet)
Seat 4: oLa/tXLfSLLB28mcLGrxcg (button) folded before Flop (didn't bet)
Seat 5: MXCztnYJ58KLHMztZvKrxA (small blind) folded on the Flop
Seat 6: N5sUK8M0br9djLrW97V9pQ (big blind) collected ($8.35)
Seat 8: PFv56Q1PTkDC084eXIAYmw folded on the Turn
Seat 9: RCqMONFrSPSArZh2Jsar/w folded before Flop (didn't bet)




PokerStars Game #59941744362:  Hold'em No Limit ($0.10/$0.25) - 2009/07/01 1:44:47 ET
Table 'D1Yq70l0nNCyMV6DA42p+Q' 9-max Seat #6 is the button
Seat 2: zgi+EUykT/pZQpoUG6+oEg ($4.30 in chips) 
Seat 3: 9lvO/qyU+xrU95Teu1fv0g ($5.50 in chips) 
Seat 4: VWUWpMLMj/Q1jRVpF7Aohw ($8.90 in chips) 
Seat 5: gehe91e0IyVT0QU/XBkEyg ($25 in chips) 
Seat 6: wGigCmBR/9XWkPpvYos3aQ ($33.20 in chips) 
Seat 7: Lqytncc1Dsgt654eEBp/uw ($29.70 in chips) 
Seat 9: h5wEs8qXrBqfLa9GjaSBzg ($24.25 in chips) 
Lqytncc1Dsgt654eEBp/uw: posts small blind $0.10
h5wEs8qXrBqfLa9GjaSBzg: posts big blind $0.25
*** HOLE CARDS ***
zgi+EUykT/pZQpoUG6+oEg: folds 
9lvO/qyU+xrU95Teu1fv0g: folds 
VWUWpMLMj/Q1jRVpF7Aohw: folds 
gehe91e0IyVT0QU/XBkEyg: folds 
wGigCmBR/9XWkPpvYos3aQ: folds 
Lqytncc1Dsgt654eEBp/uw: calls $0.15
h5wEs8qXrBqfLa9GjaSBzg: checks 
*** FLOP *** [Qd 6d 5c]
Lqytncc1Dsgt654eEBp/uw: checks 
h5wEs8qXrBqfLa9GjaSBzg: checks 
*** TURN *** [Qd 6d 5c] [Th]
Lqytncc1Dsgt654eEBp/uw: checks 
h5wEs8qXrBqfLa9GjaSBzg: checks 
*** RIVER *** [Qd 6d 5c Th] [5s]
Lqytncc1Dsgt654eEBp/uw: checks 
h5wEs8qXrBqfLa9GjaSBzg: checks 
*** SHOW DOWN ***
Lqytncc1Dsgt654eEBp/uw: shows [9s 2h] (a pair of Fives)
h5wEs8qXrBqfLa9GjaSBzg: mucks hand 
Lqytncc1Dsgt654eEBp/uw collected $0.50 from pot
*** SUMMARY ***
Total pot $0.50 | Rake $0 
Board [Qd 6d 5c Th 5s]
Seat 2: zgi+EUykT/pZQpoUG6+oEg folded before Flop (didn't bet)
Seat 3: 9lvO/qyU+xrU95Teu1fv0g folded before Flop (didn't bet)
Seat 4: VWUWpMLMj/Q1jRVpF7Aohw folded before Flop (didn't bet)
Seat 5: gehe91e0IyVT0QU/XBkEyg folded before Flop (didn't bet)
Seat 6: wGigCmBR/9XWkPpvYos3aQ (button) folded before Flop (didn't bet)
Seat 7: Lqytncc1Dsgt654eEBp/uw (small blind) showed [9s 2h] and won ($0.50) with a pair of Fives
Seat 9: h5wEs8qXrBqfLa9GjaSBzg (big blind) mucked




PokerStars Game #59941744550:  Hold'em No Limit ($0.10/$0.25) - 2009/07/01 1:44:47 ET
Table 'K/f0NNaoGuhSz5DrzgVw7Q' 9-max Seat #5 is the button
Seat 1: sD+TKtt36XiiN6jqHiLwDA ($26.55 in chips) 
Seat 2: N7idMbhmEVNGZavVF2tgKg ($26.65 in chips) 
Seat 4: 9bCz0uv2nUmznwuI0OjVGw ($15.60 in chips) 
Seat 5: DnDcAdn9P0zGovMERigpFA ($40.85 in chips) 
Seat 7: egvg3mTBBVzMHnJPIQiKcA ($14.40 in chips) 
Seat 8: RCqMONFrSPSArZh2Jsar/w ($19.65 in chips) 
Seat 9: tLcDklc2rBORNfixyRfVfw ($25 in chips) 
3PVK0IdMlq2fElkVzzr4bg will be allowed to play after the button
egvg3mTBBVzMHnJPIQiKcA: posts small blind $0.10
RCqMONFrSPSArZh2Jsar/w: posts big blind $0.25
*** HOLE CARDS ***
tLcDklc2rBORNfixyRfVfw: folds 
sD+TKtt36XiiN6jqHiLwDA: folds 
N7idMbhmEVNGZavVF2tgKg: folds 
9bCz0uv2nUmznwuI0OjVGw: folds 
DnDcAdn9P0zGovMERigpFA: folds 
egvg3mTBBVzMHnJPIQiKcA: raises $0.50 to $0.75
RCqMONFrSPSArZh2Jsar/w: raises $1.50 to $2.25
egvg3mTBBVzMHnJPIQiKcA: calls $1.50
*** FLOP *** [7d 2c Th]
egvg3mTBBVzMHnJPIQiKcA: checks 
N7idMbhmEVNGZavVF2tgKg is sitting out
RCqMONFrSPSArZh2Jsar/w: bets $2.25
egvg3mTBBVzMHnJPIQiKcA: folds 
Uncalled bet ($2.25) returned to RCqMONFrSPSArZh2Jsar/w
N7idMbhmEVNGZavVF2tgKg leaves the table
RCqMONFrSPSArZh2Jsar/w collected $4.30 from pot
RCqMONFrSPSArZh2Jsar/w: doesn't show hand 
*** SUMMARY ***
Total pot $4.50 | Rake $0.20 
Board [7d 2c Th]
Seat 1: sD+TKtt36XiiN6jqHiLwDA folded before Flop (didn't bet)
Seat 2: N7idMbhmEVNGZavVF2tgKg folded before Flop (didn't bet)
Seat 4: 9bCz0uv2nUmznwuI0OjVGw folded before Flop (didn't bet)
Seat 5: DnDcAdn9P0zGovMERigpFA (button) folded before Flop (didn't bet)
Seat 7: egvg3mTBBVzMHnJPIQiKcA (small blind) folded on the Flop
Seat 8: RCqMONFrSPSArZh2Jsar/w (big blind) collected ($4.30)
Seat 9: tLcDklc2rBORNfixyRfVfw folded before Flop (didn't bet)




PokerStars Game #59941744554:  Hold'em No Limit ($0.10/$0.25) - 2009/07/01 1:44:47 ET
Table 'LXz5SsUCyWcm+4JDJh466A' 9-max Seat #1 is the button
Seat 1: MG90wfSJZnOejs/KD3vlQQ ($24.65 in chips) 
Seat 2: H5Se03ZqSX7tbULXur2MAg ($23.45 in chips) 
Seat 3: dfNim92Z6XK1/h5SFW5vDg ($25.50 in chips) 
Seat 4: K0b5wNInj6hUGRr6yzKFtw ($28.60 in chips) 
Seat 6: 6RiVTYll/5D8zICp0MRpKw ($24.75 in chips) 
Seat 7: J2a/QHAWUgo6beDRoEyg2g ($8.75 in chips) 
Seat 8: zOHElTcFiTsexeDCkAPYkQ ($36.45 in chips) 
Seat 9: dtZ84flFEi4Q+SGrHMJRDQ ($25 in chips) 
H5Se03ZqSX7tbULXur2MAg: posts small blind $0.10
dfNim92Z6XK1/h5SFW5vDg: posts big blind $0.25
*** HOLE CARDS ***
O02ScVDnDZwH6KjZNJZMzA leaves the table
K0b5wNInj6hUGRr6yzKFtw: calls $0.25
6RiVTYll/5D8zICp0MRpKw: folds 
J2a/QHAWUgo6beDRoEyg2g: calls $0.25
CGZe30OcuMyA3kN5MnfQcQ joins the table at seat #5 
zOHElTcFiTsexeDCkAPYkQ: raises $0.75 to $1
dtZ84flFEi4Q+SGrHMJRDQ: folds 
MG90wfSJZnOejs/KD3vlQQ: folds 
H5Se03ZqSX7tbULXur2MAg: folds 
dfNim92Z6XK1/h5SFW5vDg: folds 
K0b5wNInj6hUGRr6yzKFtw: calls $0.75
J2a/QHAWUgo6beDRoEyg2g: calls $0.75
*** FLOP *** [6h 9h 7c]
K0b5wNInj6hUGRr6yzKFtw: checks 
J2a/QHAWUgo6beDRoEyg2g: bets $0.50
zOHElTcFiTsexeDCkAPYkQ: raises $0.50 to $1
K0b5wNInj6hUGRr6yzKFtw: folds 
J2a/QHAWUgo6beDRoEyg2g: calls $0.50
*** TURN *** [6h 9h 7c] [8d]
J2a/QHAWUgo6beDRoEyg2g: checks 
zOHElTcFiTsexeDCkAPYkQ: checks 
*** RIVER *** [6h 9h 7c 8d] [2s]
J2a/QHAWUgo6beDRoEyg2g: checks 
zOHElTcFiTsexeDCkAPYkQ: checks 
*** SHOW DOWN ***
J2a/QHAWUgo6beDRoEyg2g: shows [Js 7d] (a pair of Sevens)
zOHElTcFiTsexeDCkAPYkQ: mucks hand 
J2a/QHAWUgo6beDRoEyg2g collected $5.10 from pot
*** SUMMARY ***
Total pot $5.35 | Rake $0.25 
Board [6h 9h 7c 8d 2s]
Seat 1: MG90wfSJZnOejs/KD3vlQQ (button) folded before Flop (didn't bet)
Seat 2: H5Se03ZqSX7tbULXur2MAg (small blind) folded before Flop
Seat 3: dfNim92Z6XK1/h5SFW5vDg (big blind) folded before Flop
Seat 4: K0b5wNInj6hUGRr6yzKFtw folded on the Flop
Seat 6: 6RiVTYll/5D8zICp0MRpKw folded before Flop (didn't bet)
Seat 7: J2a/QHAWUgo6beDRoEyg2g showed [Js 7d] and won ($5.10) with a pair of Sevens
Seat 8: zOHElTcFiTsexeDCkAPYkQ mucked
Seat 9: dtZ84flFEi4Q+SGrHMJRDQ folded before Flop (didn't bet)




PokerStars Game #59941744850:  Hold'em No Limit ($0.10/$0.25) - 2009/07/01 1:44:48 ET
Table '0mmHveGuaIfIMQlNE1eqMg' 9-max Seat #6 is the button
Seat 1: ydoFOVgzvZv9ZhuWu9rXAw ($5 in chips) 
Seat 2: rQhYIYXSyH/IivYM1dlV5A ($68.85 in chips) 
Seat 3: ghNKXUBl/H+t83JF079ZBA ($25 in chips) 
Seat 4: DnDcAdn9P0zGovMERigpFA ($36.10 in chips) 
Seat 5: Pt637jKksB5MzP0UNJAAkw ($8.85 in chips) 
Seat 6: 6RiVTYll/5D8zICp0MRpKw ($23.70 in chips) 
Seat 7: 5n7e7I+px7c6CQmLpPbtsg ($5.50 in chips) 
Seat 8: 0XACOSNrAWmqNv9k1nF8rw ($15 in chips) 
Seat 9: UNw/UrAelsQeSS17Rro/BA ($10.90 in chips) 
5n7e7I+px7c6CQmLpPbtsg: posts small blind $0.10
0XACOSNrAWmqNv9k1nF8rw: posts big blind $0.25
*** HOLE CARDS ***
UNw/UrAelsQeSS17Rro/BA: folds 
ydoFOVgzvZv9ZhuWu9rXAw: folds 
rQhYIYXSyH/IivYM1dlV5A: folds 
ghNKXUBl/H+t83JF079ZBA: folds 
DnDcAdn9P0zGovMERigpFA: folds 
Pt637jKksB5MzP0UNJAAkw: raises $0.75 to $1
6RiVTYll/5D8zICp0MRpKw: folds 
5n7e7I+px7c6CQmLpPbtsg: folds 
0XACOSNrAWmqNv9k1nF8rw: folds 
Uncalled bet ($0.75) returned to Pt637jKksB5MzP0UNJAAkw
Pt637jKksB5MzP0UNJAAkw collected $0.60 from pot
*** SUMMARY ***
Total pot $0.60 | Rake $0 
Seat 1: ydoFOVgzvZv9ZhuWu9rXAw folded before Flop (didn't bet)
Seat 2: rQhYIYXSyH/IivYM1dlV5A folded before Flop (didn't bet)
Seat 3: ghNKXUBl/H+t83JF079ZBA folded before Flop (didn't bet)
Seat 4: DnDcAdn9P0zGovMERigpFA folded before Flop (didn't bet)
Seat 5: Pt637jKksB5MzP0UNJAAkw collected ($0.60)
Seat 6: 6RiVTYll/5D8zICp0MRpKw (button) folded before Flop (didn't bet)
Seat 7: 5n7e7I+px7c6CQmLpPbtsg (small blind) folded before Flop
Seat 8: 0XACOSNrAWmqNv9k1nF8rw (big blind) folded before Flop
Seat 9: UNw/UrAelsQeSS17Rro/BA folded before Flop (didn't bet)




PokerStars Game #59941744790:  Hold'em No Limit ($0.10/$0.25) - 2009/07/01 1:44:48 ET
Table 'z2yOdY2zyGWG1gh9WV9XtQ' 9-max Seat #5 is the button
Seat 1: 7je+LC5Mfs6nL8YBVh4frQ ($5 in chips) 
Seat 2: bXpVeaSTPBFSPJmeXxO7nw ($4.65 in chips) 
Seat 3: X78b5v/uhqeXXoAijbw/yg ($26.65 in chips) 
Seat 4: Bb42QRQMhg5/Y0vHP8/2Xw ($25 in chips) 
Seat 5: W6tExOcYX7qiy6Qdp+ZwFA ($10.55 in chips) 
Seat 6: NBYmTySMtIicyMj5Vjzqhw ($24.90 in chips) 
Seat 9: wGigCmBR/9XWkPpvYos3aQ ($34.40 in chips) 
NBYmTySMtIicyMj5Vjzqhw: posts small blind $0.10
Mh2r9hTeTEDnh19sRZtW3g: is sitting out 
wGigCmBR/9XWkPpvYos3aQ: posts big blind $0.25
Bb42QRQMhg5/Y0vHP8/2Xw: posts big blind $0.25
*** HOLE CARDS ***
7je+LC5Mfs6nL8YBVh4frQ: folds 
Mh2r9hTeTEDnh19sRZtW3g leaves the table
7je+LC5Mfs6nL8YBVh4frQ leaves the table
bXpVeaSTPBFSPJmeXxO7nw: folds 
X78b5v/uhqeXXoAijbw/yg: folds 
Bb42QRQMhg5/Y0vHP8/2Xw: checks 
W6tExOcYX7qiy6Qdp+ZwFA: folds 
NBYmTySMtIicyMj5Vjzqhw: folds 
wGigCmBR/9XWkPpvYos3aQ: checks 
*** FLOP *** [7d 6d Jh]
wGigCmBR/9XWkPpvYos3aQ: checks 
Bb42QRQMhg5/Y0vHP8/2Xw: bets $0.75
wGigCmBR/9XWkPpvYos3aQ: folds 
Uncalled bet ($0.75) returned to Bb42QRQMhg5/Y0vHP8/2Xw
Bb42QRQMhg5/Y0vHP8/2Xw collected $0.60 from pot
*** SUMMARY ***
Total pot $0.60 | Rake $0 
Board [7d 6d Jh]
Seat 1: 7je+LC5Mfs6nL8YBVh4frQ folded before Flop (didn't bet)
Seat 2: bXpVeaSTPBFSPJmeXxO7nw folded before Flop (didn't bet)
Seat 3: X78b5v/uhqeXXoAijbw/yg folded before Flop (didn't bet)
Seat 4: Bb42QRQMhg5/Y0vHP8/2Xw collected ($0.60)
Seat 5: W6tExOcYX7qiy6Qdp+ZwFA (button) folded before Flop (didn't bet)
Seat 6: NBYmTySMtIicyMj5Vjzqhw (small blind) folded before Flop
Seat 9: wGigCmBR/9XWkPpvYos3aQ (big blind) folded on the Flop




PokerStars Game #59941744764:  Hold'em No Limit ($0.10/$0.25) - 2009/07/01 1:44:48 ET
Table '63uh7ZsO7Tnt+E8b/2bu3A' 6-max Seat #1 is the button
Seat 1: 0av6tRNdi0Ui4f15L7gsVg ($30.55 in chips) 
Seat 2: SFmT9ZsVopnukjvAzrxTRg ($28.45 in chips) 
Seat 3: yVP7GLZBzx47OPi6jzUxMw ($7.75 in chips) 
Seat 4: 2tYgzzRRW/D2GWb2A7f1jw ($14.15 in chips) 
Seat 5: GbCVUNssQ7mqsPWr7J4d3w ($4.40 in chips) 
Seat 6: qGHGf/553gQnDoklMRe3tg ($30.15 in chips) 
SFmT9ZsVopnukjvAzrxTRg: posts small blind $0.10
yVP7GLZBzx47OPi6jzUxMw: posts big blind $0.25
*** HOLE CARDS ***
2tYgzzRRW/D2GWb2A7f1jw: folds 
GbCVUNssQ7mqsPWr7J4d3w: folds 
2tYgzzRRW/D2GWb2A7f1jw leaves the table
qGHGf/553gQnDoklMRe3tg: folds 
0av6tRNdi0Ui4f15L7gsVg: folds 
SFmT9ZsVopnukjvAzrxTRg: folds 
Uncalled bet ($0.15) returned to yVP7GLZBzx47OPi6jzUxMw
yVP7GLZBzx47OPi6jzUxMw collected $0.20 from pot
yVP7GLZBzx47OPi6jzUxMw: doesn't show hand 
*** SUMMARY ***
Total pot $0.20 | Rake $0 
Seat 1: 0av6tRNdi0Ui4f15L7gsVg (button) folded before Flop (didn't bet)
Seat 2: SFmT9ZsVopnukjvAzrxTRg (small blind) folded before Flop
Seat 3: yVP7GLZBzx47OPi6jzUxMw (big blind) collected ($0.20)
Seat 4: 2tYgzzRRW/D2GWb2A7f1jw folded before Flop (didn't bet)
Seat 5: GbCVUNssQ7mqsPWr7J4d3w folded before Flop (didn't bet)
Seat 6: qGHGf/553gQnDoklMRe3tg folded before Flop (didn't bet)




PokerStars Game #59941745476:  Hold'em No Limit ($0.10/$0.25) - 2009/07/01 1:44:49 ET
Table 'FE/j6VqBY4j9Uq+VHURQCQ' 6-max Seat #1 is the button
Seat 1: ypmjhffk/YHGc51wgVXUTw ($42.60 in chips) 
Seat 2: 3zD3qLXT1bEffAoWGnc7wg ($39.85 in chips) 
Seat 3: lBoEwOFgzcERLIRUkUoRTw ($27.35 in chips) 
Seat 4: 7JyPCA0J2grhXQYxe1h3+A ($22.05 in chips) 
Seat 5: 4x9jCqgSw4272dnaIqnanw ($13.30 in chips) 
Seat 6: rpJ2ie+vculq8yrHlngRHQ ($11.55 in chips) 
3zD3qLXT1bEffAoWGnc7wg: posts small blind $0.10
lBoEwOFgzcERLIRUkUoRTw: posts big blind $0.25
*** HOLE CARDS ***
7JyPCA0J2grhXQYxe1h3+A: folds 
4x9jCqgSw4272dnaIqnanw: folds 
rpJ2ie+vculq8yrHlngRHQ: raises $2.50 to $2.75
ypmjhffk/YHGc51wgVXUTw: folds 
3zD3qLXT1bEffAoWGnc7wg: calls $2.65
lBoEwOFgzcERLIRUkUoRTw: folds 
*** FLOP *** [Js 4s 3c]
3zD3qLXT1bEffAoWGnc7wg: checks 
rpJ2ie+vculq8yrHlngRHQ: bets $4.50
3zD3qLXT1bEffAoWGnc7wg: folds 
Uncalled bet ($4.50) returned to rpJ2ie+vculq8yrHlngRHQ
rpJ2ie+vculq8yrHlngRHQ collected $5.50 from pot
*** SUMMARY ***
Total pot $5.75 | Rake $0.25 
Board [Js 4s 3c]
Seat 1: ypmjhffk/YHGc51wgVXUTw (button) folded before Flop (didn't bet)
Seat 2: 3zD3qLXT1bEffAoWGnc7wg (small blind) folded on the Flop
Seat 3: lBoEwOFgzcERLIRUkUoRTw (big blind) folded before Flop
Seat 4: 7JyPCA0J2grhXQYxe1h3+A folded before Flop (didn't bet)
Seat 5: 4x9jCqgSw4272dnaIqnanw folded before Flop (didn't bet)
Seat 6: rpJ2ie+vculq8yrHlngRHQ collected ($5.50)




PokerStars Game #59941745534:  Hold'em No Limit ($0.10/$0.25) - 2009/07/01 1:44:49 ET
Table '9o8Yb3JpUqurD4pNVmOikQ' 6-max Seat #5 is the button
Seat 1: SFmT9ZsVopnukjvAzrxTRg ($27.55 in chips) 
Seat 2: /gJNBeCkWL4o85/jvlZ4BA ($25 in chips) 
Seat 3: JgRqo1/2phbf7pab7N3BIQ ($23.85 in chips) 
Seat 4: j5NZbEJHsERuXjPHWqc1Nw ($10.90 in chips) 
Seat 5: QqiZLFrN8iOUT/GHw7ztOA ($24.15 in chips) 
Seat 6: LyDHtw3/yniNHW+DvLXbog ($25.80 in chips) 
LyDHtw3/yniNHW+DvLXbog: posts small blind $0.10
SFmT9ZsVopnukjvAzrxTRg: posts big blind $0.25
*** HOLE CARDS ***
/gJNBeCkWL4o85/jvlZ4BA: folds 
JgRqo1/2phbf7pab7N3BIQ: folds 
j5NZbEJHsERuXjPHWqc1Nw: raises $0.75 to $1
QqiZLFrN8iOUT/GHw7ztOA: folds 
LyDHtw3/yniNHW+DvLXbog: folds 
SFmT9ZsVopnukjvAzrxTRg: folds 
Uncalled bet ($0.75) returned to j5NZbEJHsERuXjPHWqc1Nw
j5NZbEJHsERuXjPHWqc1Nw collected $0.60 from pot
*** SUMMARY ***
Total pot $0.60 | Rake $0 
Seat 1: SFmT9ZsVopnukjvAzrxTRg (big blind) folded before Flop
Seat 2: /gJNBeCkWL4o85/jvlZ4BA folded before Flop (didn't bet)
Seat 3: JgRqo1/2phbf7pab7N3BIQ folded before Flop (didn't bet)
Seat 4: j5NZbEJHsERuXjPHWqc1Nw collected ($0.60)
Seat 5: QqiZLFrN8iOUT/GHw7ztOA (button) folded before Flop (didn't bet)
Seat 6: LyDHtw3/yniNHW+DvLXbog (small blind) folded before Flop




PokerStars Game #59941745498:  Hold'em No Limit ($0.10/$0.25) - 2009/07/01 1:44:49 ET
Table '3KDMdm1sfxFsNKkjc/PnBg' 9-max Seat #9 is the button
Seat 1: JvrJoga8hK8pnB3KGQHl1g ($8 in chips) 
Seat 2: 5WLo/V8l3QfpUdK9JPp99w ($24.55 in chips) 
Seat 3: OXPkK84/qv92EMwXPiG5rQ ($10 in chips) 
Seat 4: F7pnn6czNpHvRM55XcA2EA ($37.85 in chips) 
Seat 5: +2kMBNpY4nF1qNCRd8SJLA ($31.45 in chips) 
Seat 6: sGFnnRCa1YAHAUmWgsW6Qg ($9.85 in chips) 
Seat 7: gehe91e0IyVT0QU/XBkEyg ($31.80 in chips) 
Seat 8: LFnLiiWho1pLiR1Xvp5d/w ($8.55 in chips) 
Seat 9: K0b5wNInj6hUGRr6yzKFtw ($32.60 in chips) 
JvrJoga8hK8pnB3KGQHl1g: posts small blind $0.10
5WLo/V8l3QfpUdK9JPp99w: posts big blind $0.25
*** HOLE CARDS ***
OXPkK84/qv92EMwXPiG5rQ: folds 
F7pnn6czNpHvRM55XcA2EA: raises $0.75 to $1
+2kMBNpY4nF1qNCRd8SJLA: folds 
sGFnnRCa1YAHAUmWgsW6Qg: folds 
gehe91e0IyVT0QU/XBkEyg: folds 
LFnLiiWho1pLiR1Xvp5d/w: folds 
K0b5wNInj6hUGRr6yzKFtw: folds 
JvrJoga8hK8pnB3KGQHl1g: folds 
5WLo/V8l3QfpUdK9JPp99w: folds 
Uncalled bet ($0.75) returned to F7pnn6czNpHvRM55XcA2EA
F7pnn6czNpHvRM55XcA2EA collected $0.60 from pot
F7pnn6czNpHvRM55XcA2EA: doesn't show hand 
*** SUMMARY ***
Total pot $0.60 | Rake $0 
Seat 1: JvrJoga8hK8pnB3KGQHl1g (small blind) folded before Flop
Seat 2: 5WLo/V8l3QfpUdK9JPp99w (big blind) folded before Flop
Seat 3: OXPkK84/qv92EMwXPiG5rQ folded before Flop (didn't bet)
Seat 4: F7pnn6czNpHvRM55XcA2EA collected ($0.60)
Seat 5: +2kMBNpY4nF1qNCRd8SJLA folded before Flop (didn't bet)
Seat 6: sGFnnRCa1YAHAUmWgsW6Qg folded before Flop (didn't bet)
Seat 7: gehe91e0IyVT0QU/XBkEyg folded before Flop (didn't bet)
Seat 8: LFnLiiWho1pLiR1Xvp5d/w folded before Flop (didn't bet)
Seat 9: K0b5wNInj6hUGRr6yzKFtw (button) folded before Flop (didn't bet)




PokerStars Game #59941745696:  Hold'em No Limit ($0.10/$0.25) - 2009/07/01 1:44:49 ET
Table '50f2Xa1b1jp6cfdTAgXFIg' 9-max Seat #7 is the button
Seat 1: pplNliE3WonjkPRf+GZq2A ($28.05 in chips) 
Seat 3: RSojRXQHk0IRANbJYopT9g ($22.40 in chips) 
Seat 4: ghNKXUBl/H+t83JF079ZBA ($28.10 in chips) 
Seat 5: C1w4aCCgQVVSgNijoEahAg ($16.40 in chips) 
Seat 6: tLcDklc2rBORNfixyRfVfw ($25 in chips) 
Seat 7: w1ukf8uPa4+WH561TtVRxA ($25 in chips) 
Seat 8: x+W5+3qsdY4Iszf0hoH+Aw ($14.65 in chips) 
Seat 9: gehe91e0IyVT0QU/XBkEyg ($25.15 in chips) 
x+W5+3qsdY4Iszf0hoH+Aw: posts small blind $0.10
gehe91e0IyVT0QU/XBkEyg: posts big blind $0.25
*** HOLE CARDS ***
pplNliE3WonjkPRf+GZq2A: folds 
pplNliE3WonjkPRf+GZq2A leaves the table
RSojRXQHk0IRANbJYopT9g: folds 
ghNKXUBl/H+t83JF079ZBA: folds 
E0iYnEVO2ho7dH3QcCjw7g joins the table at seat #1 
C1w4aCCgQVVSgNijoEahAg: raises $0.50 to $0.75
tLcDklc2rBORNfixyRfVfw: folds 
w1ukf8uPa4+WH561TtVRxA: folds 
x+W5+3qsdY4Iszf0hoH+Aw: folds 
gehe91e0IyVT0QU/XBkEyg: folds 
Uncalled bet ($0.50) returned to C1w4aCCgQVVSgNijoEahAg
C1w4aCCgQVVSgNijoEahAg collected $0.60 from pot
*** SUMMARY ***
Total pot $0.60 | Rake $0 
Seat 1: pplNliE3WonjkPRf+GZq2A folded before Flop (didn't bet)
Seat 3: RSojRXQHk0IRANbJYopT9g folded before Flop (didn't bet)
Seat 4: ghNKXUBl/H+t83JF079ZBA folded before Flop (didn't bet)
Seat 5: C1w4aCCgQVVSgNijoEahAg collected ($0.60)
Seat 6: tLcDklc2rBORNfixyRfVfw folded before Flop (didn't bet)
Seat 7: w1ukf8uPa4+WH561TtVRxA (button) folded before Flop (didn't bet)
Seat 8: x+W5+3qsdY4Iszf0hoH+Aw (small blind) folded before Flop
Seat 9: gehe91e0IyVT0QU/XBkEyg (big blind) folded before Flop




PokerStars Game #59941745716:  Hold'em No Limit ($0.10/$0.25) - 2009/07/01 1:44:49 ET
Table '2clPgY3+dETPD/8zjXZdFw' 6-max Seat #1 is the button
Seat 1: 4WFKzsjLSGnvHbVxKabsvQ ($30.70 in chips) 
Seat 2: cWc85bEzdRzpUMhRKm8pwQ ($25.55 in chips) 
Seat 3: SFmT9ZsVopnukjvAzrxTRg ($25 in chips) 
Seat 4: ljjhtb6FVPTx9AT9HNdtqg ($22 in chips) 
Seat 5: LJI7A1YgDM7hgh7o56+ReQ ($29.90 in chips) 
cWc85bEzdRzpUMhRKm8pwQ: posts small blind $0.10
SFmT9ZsVopnukjvAzrxTRg: posts big blind $0.25
*** HOLE CARDS ***
ljjhtb6FVPTx9AT9HNdtqg: folds 
LJI7A1YgDM7hgh7o56+ReQ: folds 
4WFKzsjLSGnvHbVxKabsvQ: folds 
cWc85bEzdRzpUMhRKm8pwQ: folds 
Uncalled bet ($0.15) returned to SFmT9ZsVopnukjvAzrxTRg
SFmT9ZsVopnukjvAzrxTRg collected $0.20 from pot
SFmT9ZsVopnukjvAzrxTRg: doesn't show hand 
*** SUMMARY ***
Total pot $0.20 | Rake $0 
Seat 1: 4WFKzsjLSGnvHbVxKabsvQ (button) folded before Flop (didn't bet)
Seat 2: cWc85bEzdRzpUMhRKm8pwQ (small blind) folded before Flop
Seat 3: SFmT9ZsVopnukjvAzrxTRg (big blind) collected ($0.20)
Seat 4: ljjhtb6FVPTx9AT9HNdtqg folded before Flop (didn't bet)
Seat 5: LJI7A1YgDM7hgh7o56+ReQ folded before Flop (didn't bet)




PokerStars Game #59941745854:  Hold'em No Limit ($0.10/$0.25) - 2009/07/01 1:44:50 ET
Table 'r562aMIMs5kgo28FEU6lkA' 9-max Seat #3 is the button
Seat 1: H5Se03ZqSX7tbULXur2MAg ($17.55 in chips) 
Seat 2: N8muFAHrFHW6elSMGuyVLQ ($25.35 in chips) 
Seat 3: xoBFd/5k+L/pFn9VW1VyWg ($10.10 in chips) 
Seat 4: V6p0jQ/RhUsqpHLmXvEX4Q ($17 in chips) 
Seat 6: RCqMONFrSPSArZh2Jsar/w ($20 in chips) 
Seat 7: Bb42QRQMhg5/Y0vHP8/2Xw ($25 in chips) 
Seat 8: B6xHiX1SJkS0CUNCKDVwuQ ($20.90 in chips) 
Seat 9: yyG4svzOpC1A+sUP/scg6w ($7.50 in chips) 
V6p0jQ/RhUsqpHLmXvEX4Q: posts small blind $0.10
RCqMONFrSPSArZh2Jsar/w: posts big blind $0.25
*** HOLE CARDS ***
Bb42QRQMhg5/Y0vHP8/2Xw: folds 
B6xHiX1SJkS0CUNCKDVwuQ: folds 
yyG4svzOpC1A+sUP/scg6w: folds 
H5Se03ZqSX7tbULXur2MAg: folds 
N8muFAHrFHW6elSMGuyVLQ: folds 
xoBFd/5k+L/pFn9VW1VyWg: folds 
V6p0jQ/RhUsqpHLmXvEX4Q: folds 
Uncalled bet ($0.15) returned to RCqMONFrSPSArZh2Jsar/w
RCqMONFrSPSArZh2Jsar/w collected $0.20 from pot
RCqMONFrSPSArZh2Jsar/w: doesn't show hand 
*** SUMMARY ***
Total pot $0.20 | Rake $0 
Seat 1: H5Se03ZqSX7tbULXur2MAg folded before Flop (didn't bet)
Seat 2: N8muFAHrFHW6elSMGuyVLQ folded before Flop (didn't bet)
Seat 3: xoBFd/5k+L/pFn9VW1VyWg (button) folded before Flop (didn't bet)
Seat 4: V6p0jQ/RhUsqpHLmXvEX4Q (small blind) folded before Flop
Seat 6: RCqMONFrSPSArZh2Jsar/w (big blind) collected ($0.20)
Seat 7: Bb42QRQMhg5/Y0vHP8/2Xw folded before Flop (didn't bet)
Seat 8: B6xHiX1SJkS0CUNCKDVwuQ folded before Flop (didn't bet)
Seat 9: yyG4svzOpC1A+sUP/scg6w folded before Flop (didn't bet)




PokerStars Game #59941746182:  Hold'em No Limit ($0.10/$0.25) - 2009/07/01 1:44:50 ET
Table 'fIMYcWwN4/aXFJvH5Z8Ymg' 6-max Seat #5 is the button
Seat 1: DihMHaz4WNETH1bPDe13kA ($25 in chips) 
Seat 3: 9bpVv1/Qh9IYtXuCtl5VtQ ($25 in chips) 
Seat 4: 32YL2ZEp8NT4JB2RVM9euQ ($42.40 in chips) 
Seat 5: lquriepNQBhDV5P1SWHhnA ($25.35 in chips) 
Seat 6: jp34e617tIzV8tKIWmfAbA ($28.45 in chips) 
jp34e617tIzV8tKIWmfAbA: posts small blind $0.10
DihMHaz4WNETH1bPDe13kA: posts big blind $0.25
Mhj3q7cxev+XjXZxEE6/Cw: sits out 
*** HOLE CARDS ***
9bpVv1/Qh9IYtXuCtl5VtQ: folds 
32YL2ZEp8NT4JB2RVM9euQ: folds 
lquriepNQBhDV5P1SWHhnA: raises $0.50 to $0.75
jp34e617tIzV8tKIWmfAbA: folds 
DihMHaz4WNETH1bPDe13kA: folds 
Uncalled bet ($0.50) returned to lquriepNQBhDV5P1SWHhnA
lquriepNQBhDV5P1SWHhnA collected $0.60 from pot
lquriepNQBhDV5P1SWHhnA: doesn't show hand 
*** SUMMARY ***
Total pot $0.60 | Rake $0 
Seat 1: DihMHaz4WNETH1bPDe13kA (big blind) folded before Flop
Seat 3: 9bpVv1/Qh9IYtXuCtl5VtQ folded before Flop (didn't bet)
Seat 4: 32YL2ZEp8NT4JB2RVM9euQ folded before Flop (didn't bet)
Seat 5: lquriepNQBhDV5P1SWHhnA (button) collected ($0.60)
Seat 6: jp34e617tIzV8tKIWmfAbA (small blind) folded before Flop




PokerStars Game #59941746258:  Hold'em No Limit ($0.10/$0.25) - 2009/07/01 1:44:50 ET
Table 'gnrUwXkIPE0C8xl6cB4Hyw' 9-max Seat #9 is the button
Seat 1: EQXHDnIzAsORnIXRNtXRlA ($22.35 in chips) 
Seat 2: 7je+LC5Mfs6nL8YBVh4frQ ($5 in chips) 
Seat 3: PdIasPkzm2sqZnN41ZRXOg ($5 in chips) 
Seat 4: wGigCmBR/9XWkPpvYos3aQ ($25.35 in chips) 
Seat 5: gehe91e0IyVT0QU/XBkEyg ($26.90 in chips) 
Seat 6: dtZ84flFEi4Q+SGrHMJRDQ ($25.80 in chips) 
Seat 7: OXPkK84/qv92EMwXPiG5rQ ($9.95 in chips) 
Seat 8: 4awUyiDYTgylQKXZ9faBVA ($60.65 in chips) 
Seat 9: F7pnn6czNpHvRM55XcA2EA ($25.50 in chips) 
EQXHDnIzAsORnIXRNtXRlA: posts small blind $0.10
7je+LC5Mfs6nL8YBVh4frQ: posts big blind $0.25
*** HOLE CARDS ***
PdIasPkzm2sqZnN41ZRXOg: folds 
wGigCmBR/9XWkPpvYos3aQ: folds 
gehe91e0IyVT0QU/XBkEyg: folds 
dtZ84flFEi4Q+SGrHMJRDQ: folds 
OXPkK84/qv92EMwXPiG5rQ: folds 
4awUyiDYTgylQKXZ9faBVA: folds 
F7pnn6czNpHvRM55XcA2EA: folds 
EQXHDnIzAsORnIXRNtXRlA: folds 
Uncalled bet ($0.15) returned to 7je+LC5Mfs6nL8YBVh4frQ
7je+LC5Mfs6nL8YBVh4frQ collected $0.20 from pot
7je+LC5Mfs6nL8YBVh4frQ: doesn't show hand 
*** SUMMARY ***
Total pot $0.20 | Rake $0 
Seat 1: EQXHDnIzAsORnIXRNtXRlA (small blind) folded before Flop
Seat 2: 7je+LC5Mfs6nL8YBVh4frQ (big blind) collected ($0.20)
Seat 3: PdIasPkzm2sqZnN41ZRXOg folded before Flop (didn't bet)
Seat 4: wGigCmBR/9XWkPpvYos3aQ folded before Flop (didn't bet)
Seat 5: gehe91e0IyVT0QU/XBkEyg folded before Flop (didn't bet)
Seat 6: dtZ84flFEi4Q+SGrHMJRDQ folded before Flop (didn't bet)
Seat 7: OXPkK84/qv92EMwXPiG5rQ folded before Flop (didn't bet)
Seat 8: 4awUyiDYTgylQKXZ9faBVA folded before Flop (didn't bet)
Seat 9: F7pnn6czNpHvRM55XcA2EA (button) folded before Flop (didn't bet)




PokerStars Game #59941745944:  Hold'em No Limit ($0.10/$0.25) - 2009/07/01 1:44:50 ET
Table 'mF3KHGMaTpaBZbtBoyfTeg' 6-max Seat #5 is the button
Seat 1: 0HAB2GdCAM7p7V00xueAVQ ($24.05 in chips) 
Seat 2: 6qsh9pnysDKJNhfFhFmKRQ ($14.10 in chips) 
Seat 3: 9kUKGKkblnIx3m8rlVol6Q ($9.70 in chips) 
Seat 4: FYepjhAvF8ZdVCmqHIy+eQ ($25 in chips) 
Seat 5: 8ClCHtFXGNplITm+63KB+Q ($44.30 in chips) 
Seat 6: kG34n23qFQA3nzdOJTQ1dA ($27.50 in chips) 
kG34n23qFQA3nzdOJTQ1dA: posts small blind $0.10
0HAB2GdCAM7p7V00xueAVQ: posts big blind $0.25
*** HOLE CARDS ***
6qsh9pnysDKJNhfFhFmKRQ: folds 
9kUKGKkblnIx3m8rlVol6Q: folds 
FYepjhAvF8ZdVCmqHIy+eQ: folds 
8ClCHtFXGNplITm+63KB+Q: folds 
kG34n23qFQA3nzdOJTQ1dA: folds 
Uncalled bet ($0.15) returned to 0HAB2GdCAM7p7V00xueAVQ
0HAB2GdCAM7p7V00xueAVQ collected $0.20 from pot
*** SUMMARY ***
Total pot $0.20 | Rake $0 
Seat 1: 0HAB2GdCAM7p7V00xueAVQ (big blind) collected ($0.20)
Seat 2: 6qsh9pnysDKJNhfFhFmKRQ folded before Flop (didn't bet)
Seat 3: 9kUKGKkblnIx3m8rlVol6Q folded before Flop (didn't bet)
Seat 4: FYepjhAvF8ZdVCmqHIy+eQ folded before Flop (didn't bet)
Seat 5: 8ClCHtFXGNplITm+63KB+Q (button) folded before Flop (didn't bet)
Seat 6: kG34n23qFQA3nzdOJTQ1dA (small blind) folded before Flop




PokerStars Game #59941746116:  Hold'em No Limit ($0.10/$0.25) - 2009/07/01 1:44:50 ET
Table '4XGDnEByOol5up4aB2KbJw' 6-max Seat #2 is the button
Seat 1: kyRaCIljYA6l33lSKQfNsg ($26.50 in chips) 
Seat 2: SFmT9ZsVopnukjvAzrxTRg ($44.85 in chips) 
Seat 3: LtASJ9OlkqGrrUKGQlpGAw ($21.15 in chips) 
Seat 4: BV+K0Phf5VBHr7aZPKqbUQ ($25.75 in chips) 
Seat 5: Dh01+rohD2p9pXLYeBlC5Q ($16.50 in chips) 
Seat 6: a7Ux7aERFGCbT/L3ojVfAg ($8.75 in chips) 
LtASJ9OlkqGrrUKGQlpGAw: posts small blind $0.10
BV+K0Phf5VBHr7aZPKqbUQ: posts big blind $0.25
*** HOLE CARDS ***
Dh01+rohD2p9pXLYeBlC5Q: calls $0.25
a7Ux7aERFGCbT/L3ojVfAg: folds 
kyRaCIljYA6l33lSKQfNsg: folds 
SFmT9ZsVopnukjvAzrxTRg: folds 
LtASJ9OlkqGrrUKGQlpGAw: calls $0.15
BV+K0Phf5VBHr7aZPKqbUQ: checks 
*** FLOP *** [9c 3c 8s]
LtASJ9OlkqGrrUKGQlpGAw: checks 
BV+K0Phf5VBHr7aZPKqbUQ: checks 
Dh01+rohD2p9pXLYeBlC5Q: checks 
*** TURN *** [9c 3c 8s] [Jh]
LtASJ9OlkqGrrUKGQlpGAw: checks 
BV+K0Phf5VBHr7aZPKqbUQ: checks 
Dh01+rohD2p9pXLYeBlC5Q: checks 
*** RIVER *** [9c 3c 8s Jh] [6s]
LtASJ9OlkqGrrUKGQlpGAw: checks 
BV+K0Phf5VBHr7aZPKqbUQ: checks 
Dh01+rohD2p9pXLYeBlC5Q: checks 
*** SHOW DOWN ***
LtASJ9OlkqGrrUKGQlpGAw: shows [Qs Ad] (high card Ace)
BV+K0Phf5VBHr7aZPKqbUQ: mucks hand 
Dh01+rohD2p9pXLYeBlC5Q: shows [Kd Ah] (high card Ace - King kicker)
Dh01+rohD2p9pXLYeBlC5Q collected $0.75 from pot
*** SUMMARY ***
Total pot $0.75 | Rake $0 
Board [9c 3c 8s Jh 6s]
Seat 1: kyRaCIljYA6l33lSKQfNsg folded before Flop (didn't bet)
Seat 2: SFmT9ZsVopnukjvAzrxTRg (button) folded before Flop (didn't bet)
Seat 3: LtASJ9OlkqGrrUKGQlpGAw (small blind) showed [Qs Ad] and lost with high card Ace
Seat 4: BV+K0Phf5VBHr7aZPKqbUQ (big blind) mucked
Seat 5: Dh01+rohD2p9pXLYeBlC5Q showed [Kd Ah] and won ($0.75) with high card Ace
Seat 6: a7Ux7aERFGCbT/L3ojVfAg folded before Flop (didn't bet)




PokerStars Game #59941745840:  Hold'em No Limit ($0.10/$0.25) - 2009/07/01 1:44:50 ET
Table 'AHkg4ChqzcMauBx6Qvz8Nw' 6-max Seat #3 is the button
Seat 1: +RDf7SmUjY2kK0PzdBEYqg ($6.20 in chips) 
Seat 2: Vi0JMrTI2BGrPL7UIulJtA ($5.55 in chips) 
Seat 3: 9dToMv2GJLfi00HcpfMnIw ($24.15 in chips) 
Seat 4: Eznneya0vB6S+eXJdVleHA ($20.20 in chips) 
Seat 5: Bada343Si4xKu3fNXY99AA ($4.20 in chips) 
Seat 6: Hsvkc0/G2VV78oVmWYXecw ($5 in chips) 
Eznneya0vB6S+eXJdVleHA: posts small blind $0.10
Bada343Si4xKu3fNXY99AA: posts big blind $0.25
*** HOLE CARDS ***
Hsvkc0/G2VV78oVmWYXecw: folds 
+RDf7SmUjY2kK0PzdBEYqg: calls $0.25
Vi0JMrTI2BGrPL7UIulJtA: calls $0.25
9dToMv2GJLfi00HcpfMnIw: folds 
Eznneya0vB6S+eXJdVleHA: calls $0.15
Bada343Si4xKu3fNXY99AA: checks 
*** FLOP *** [8c 5s 5h]
Eznneya0vB6S+eXJdVleHA: bets $0.25
Bada343Si4xKu3fNXY99AA: folds 
+RDf7SmUjY2kK0PzdBEYqg: calls $0.25
Vi0JMrTI2BGrPL7UIulJtA: folds 
*** TURN *** [8c 5s 5h] [2h]
Eznneya0vB6S+eXJdVleHA: checks 
+RDf7SmUjY2kK0PzdBEYqg: bets $0.25
Eznneya0vB6S+eXJdVleHA: calls $0.25
*** RIVER *** [8c 5s 5h 2h] [6s]
Eznneya0vB6S+eXJdVleHA: checks 
+RDf7SmUjY2kK0PzdBEYqg: bets $0.75
Eznneya0vB6S+eXJdVleHA: folds 
Uncalled bet ($0.75) returned to +RDf7SmUjY2kK0PzdBEYqg
+RDf7SmUjY2kK0PzdBEYqg collected $1.95 from pot
*** SUMMARY ***
Total pot $2 | Rake $0.05 
Board [8c 5s 5h 2h 6s]
Seat 1: +RDf7SmUjY2kK0PzdBEYqg collected ($1.95)
Seat 2: Vi0JMrTI2BGrPL7UIulJtA folded on the Flop
Seat 3: 9dToMv2GJLfi00HcpfMnIw (button) folded before Flop (didn't bet)
Seat 4: Eznneya0vB6S+eXJdVleHA (small blind) folded on the River
Seat 5: Bada343Si4xKu3fNXY99AA (big blind) folded on the Flop
Seat 6: Hsvkc0/G2VV78oVmWYXecw folded before Flop (didn't bet)




PokerStars Game #59941745792:  Hold'em No Limit ($0.10/$0.25) - 2009/07/01 1:44:50 ET
Table '5VWnrlxdjwVfMWkVS2WE7A' 6-max Seat #6 is the button
Seat 1: 82p+w3EmUaFFHuwpSeGY1w ($14.25 in chips) 
Seat 2: LJI7A1YgDM7hgh7o56+ReQ ($26 in chips) 
Seat 3: SFmT9ZsVopnukjvAzrxTRg ($39.15 in chips) 
Seat 4: Pb/gJ3OxOZx57fFp0MDgkg ($35.35 in chips) 
Seat 5: SgMFmwYtNvq9Y+2ZxPSiWQ ($16.10 in chips) 
Seat 6: LtASJ9OlkqGrrUKGQlpGAw ($5.25 in chips) 
82p+w3EmUaFFHuwpSeGY1w: posts small blind $0.10
LJI7A1YgDM7hgh7o56+ReQ: posts big blind $0.25
*** HOLE CARDS ***
SFmT9ZsVopnukjvAzrxTRg: folds 
Pb/gJ3OxOZx57fFp0MDgkg: folds 
SgMFmwYtNvq9Y+2ZxPSiWQ: folds 
LtASJ9OlkqGrrUKGQlpGAw: folds 
82p+w3EmUaFFHuwpSeGY1w: calls $0.15
LJI7A1YgDM7hgh7o56+ReQ: checks 
*** FLOP *** [5d 2c Kh]
82p+w3EmUaFFHuwpSeGY1w: checks 
LJI7A1YgDM7hgh7o56+ReQ: checks 
*** TURN *** [5d 2c Kh] [5h]
82p+w3EmUaFFHuwpSeGY1w: checks 
LJI7A1YgDM7hgh7o56+ReQ: checks 
*** RIVER *** [5d 2c Kh 5h] [Qh]
82p+w3EmUaFFHuwpSeGY1w: checks 
LJI7A1YgDM7hgh7o56+ReQ: checks 
*** SHOW DOWN ***
82p+w3EmUaFFHuwpSeGY1w: shows [Ad 8s] (a pair of Fives)
LJI7A1YgDM7hgh7o56+ReQ: mucks hand 
82p+w3EmUaFFHuwpSeGY1w collected $0.50 from pot
*** SUMMARY ***
Total pot $0.50 | Rake $0 
Board [5d 2c Kh 5h Qh]
Seat 1: 82p+w3EmUaFFHuwpSeGY1w (small blind) showed [Ad 8s] and won ($0.50) with a pair of Fives
Seat 2: LJI7A1YgDM7hgh7o56+ReQ (big blind) mucked
Seat 3: SFmT9ZsVopnukjvAzrxTRg folded before Flop (didn't bet)
Seat 4: Pb/gJ3OxOZx57fFp0MDgkg folded before Flop (didn't bet)
Seat 5: SgMFmwYtNvq9Y+2ZxPSiWQ folded before Flop (didn't bet)
Seat 6: LtASJ9OlkqGrrUKGQlpGAw (button) folded before Flop (didn't bet)




PokerStars Game #59941746202:  Hold'em No Limit ($0.10/$0.25) - 2009/07/01 1:44:50 ET
Table 'jdhJTJjFq2KTttwJcd+7nQ' 6-max Seat #1 is the button
Seat 1: LtASJ9OlkqGrrUKGQlpGAw ($26.85 in chips) 
Seat 2: Hsvkc0/G2VV78oVmWYXecw ($5 in chips) 
Seat 3: vqWjZmdQu/Hxw96/IJTWdQ ($25.95 in chips) 
Seat 4: vx7FwRcelVSsvNYAdp/z0A ($7.15 in chips) 
Seat 5: BV+K0Phf5VBHr7aZPKqbUQ ($26.10 in chips) 
Seat 6: yb6rnd48JuBccThV68VHAQ ($16.25 in chips) 
Hsvkc0/G2VV78oVmWYXecw: posts small blind $0.10
vqWjZmdQu/Hxw96/IJTWdQ: posts big blind $0.25
*** HOLE CARDS ***
vx7FwRcelVSsvNYAdp/z0A: calls $0.25
BV+K0Phf5VBHr7aZPKqbUQ: folds 
yb6rnd48JuBccThV68VHAQ: calls $0.25
LtASJ9OlkqGrrUKGQlpGAw: folds 
Hsvkc0/G2VV78oVmWYXecw: folds 
vqWjZmdQu/Hxw96/IJTWdQ: checks 
*** FLOP *** [Jc 3h 9h]
vqWjZmdQu/Hxw96/IJTWdQ: bets $0.50
vx7FwRcelVSsvNYAdp/z0A: calls $0.50
yb6rnd48JuBccThV68VHAQ: calls $0.50
*** TURN *** [Jc 3h 9h] [2c]
vqWjZmdQu/Hxw96/IJTWdQ: checks 
vx7FwRcelVSsvNYAdp/z0A: checks 
yb6rnd48JuBccThV68VHAQ: checks 
*** RIVER *** [Jc 3h 9h 2c] [Td]
vqWjZmdQu/Hxw96/IJTWdQ: checks 
vx7FwRcelVSsvNYAdp/z0A: bets $0.25
yb6rnd48JuBccThV68VHAQ: raises $1 to $1.25
vqWjZmdQu/Hxw96/IJTWdQ: folds 
vx7FwRcelVSsvNYAdp/z0A: folds 
Uncalled bet ($1) returned to yb6rnd48JuBccThV68VHAQ
yb6rnd48JuBccThV68VHAQ collected $2.75 from pot
yb6rnd48JuBccThV68VHAQ: doesn't show hand 
*** SUMMARY ***
Total pot $2.85 | Rake $0.10 
Board [Jc 3h 9h 2c Td]
Seat 1: LtASJ9OlkqGrrUKGQlpGAw (button) folded before Flop (didn't bet)
Seat 2: Hsvkc0/G2VV78oVmWYXecw (small blind) folded before Flop
Seat 3: vqWjZmdQu/Hxw96/IJTWdQ (big blind) folded on the River
Seat 4: vx7FwRcelVSsvNYAdp/z0A folded on the River
Seat 5: BV+K0Phf5VBHr7aZPKqbUQ folded before Flop (didn't bet)
Seat 6: yb6rnd48JuBccThV68VHAQ collected ($2.75)




PokerStars Game #59941746296:  Hold'em No Limit ($0.10/$0.25) - 2009/07/01 1:44:51 ET
Table 'Do4nrTNDYpK3sQjwFxX+Og' 6-max Seat #1 is the button
Seat 1: 7JrQNOR9wRBxq9ijFhWieg ($38.05 in chips) 
Seat 2: tzMoGl9F0PUr5NibYueeSw ($67.50 in chips) 
Seat 3: TSmua8tGK3sTbwi0ynrW9Q ($26.70 in chips) 
Seat 4: cWc85bEzdRzpUMhRKm8pwQ ($33.40 in chips) 
Seat 5: Ew/TYPQIsbQ2X8nm5iAJBg ($35.20 in chips) 
Seat 6: lBoEwOFgzcERLIRUkUoRTw ($23.55 in chips) 
tzMoGl9F0PUr5NibYueeSw: posts small blind $0.10
TSmua8tGK3sTbwi0ynrW9Q: posts big blind $0.25
*** HOLE CARDS ***
cWc85bEzdRzpUMhRKm8pwQ: folds 
Ew/TYPQIsbQ2X8nm5iAJBg: raises $0.50 to $0.75
lBoEwOFgzcERLIRUkUoRTw: folds 
7JrQNOR9wRBxq9ijFhWieg: calls $0.75
tzMoGl9F0PUr5NibYueeSw: calls $0.65
TSmua8tGK3sTbwi0ynrW9Q: calls $0.50
*** FLOP *** [6s Kd 8c]
tzMoGl9F0PUr5NibYueeSw: checks 
TSmua8tGK3sTbwi0ynrW9Q: checks 
Ew/TYPQIsbQ2X8nm5iAJBg: checks 
7JrQNOR9wRBxq9ijFhWieg: checks 
*** TURN *** [6s Kd 8c] [4d]
tzMoGl9F0PUr5NibYueeSw: checks 
TSmua8tGK3sTbwi0ynrW9Q: bets $1.75
Ew/TYPQIsbQ2X8nm5iAJBg: calls $1.75
7JrQNOR9wRBxq9ijFhWieg: folds 
tzMoGl9F0PUr5NibYueeSw: folds 
*** RIVER *** [6s Kd 8c 4d] [4c]
TSmua8tGK3sTbwi0ynrW9Q: bets $3.25
Ew/TYPQIsbQ2X8nm5iAJBg: calls $3.25
*** SHOW DOWN ***
TSmua8tGK3sTbwi0ynrW9Q: shows [Ah 8h] (two pair, Eights and Fours)
Ew/TYPQIsbQ2X8nm5iAJBg: shows [8s Ac] (two pair, Eights and Fours)
TSmua8tGK3sTbwi0ynrW9Q collected $6.20 from pot
Ew/TYPQIsbQ2X8nm5iAJBg collected $6.20 from pot
*** SUMMARY ***
Total pot $13 | Rake $0.60 
Board [6s Kd 8c 4d 4c]
Seat 1: 7JrQNOR9wRBxq9ijFhWieg (button) folded on the Turn
Seat 2: tzMoGl9F0PUr5NibYueeSw (small blind) folded on the Turn
Seat 3: TSmua8tGK3sTbwi0ynrW9Q (big blind) showed [Ah 8h] and won ($6.20) with two pair, Eights and Fours
Seat 4: cWc85bEzdRzpUMhRKm8pwQ folded before Flop (didn't bet)
Seat 5: Ew/TYPQIsbQ2X8nm5iAJBg showed [8s Ac] and won ($6.20) with two pair, Eights and Fours
Seat 6: lBoEwOFgzcERLIRUkUoRTw folded before Flop (didn't bet)




PokerStars Game #59941746686:  Hold'em No Limit ($0.10/$0.25) - 2009/07/01 1:44:51 ET
Table '5NipxzzFB2DffzDpddyQoQ' 6-max Seat #3 is the button
Seat 1: W87HPwOk1KtWaYyshBe1gA ($21.25 in chips) 
Seat 2: iauW7L/+7qzAuHow7CD75Q ($9.50 in chips) 
Seat 3: QvTX2yGq3uKJiKPmns4TKQ ($2.55 in chips) 
Seat 4: NTamLAiMZ86c5yM04t96LA ($30.60 in chips) 
Seat 5: faP2NVl/cFTZ1nE4pXzg8Q ($33.85 in chips) 
Seat 6: 7JqTFMyeNSVWsmp/yW35Tw ($28.55 in chips) 
NTamLAiMZ86c5yM04t96LA: posts small blind $0.10
faP2NVl/cFTZ1nE4pXzg8Q: posts big blind $0.25
*** HOLE CARDS ***
7JqTFMyeNSVWsmp/yW35Tw: raises $0.50 to $0.75
W87HPwOk1KtWaYyshBe1gA: folds 
iauW7L/+7qzAuHow7CD75Q said, "who?"
faP2NVl/cFTZ1nE4pXzg8Q said, "thanks dude I was on a flush draw"
iauW7L/+7qzAuHow7CD75Q: raises $8.75 to $9.50 and is all-in
QvTX2yGq3uKJiKPmns4TKQ: calls $2.55 and is all-in
NTamLAiMZ86c5yM04t96LA: folds 
NTamLAiMZ86c5yM04t96LA said, "who u r dADDY"
iauW7L/+7qzAuHow7CD75Q said, "call"
faP2NVl/cFTZ1nE4pXzg8Q said, "yeah tuc town lol"
iauW7L/+7qzAuHow7CD75Q said, "everyone"
faP2NVl/cFTZ1nE4pXzg8Q: folds 
7JqTFMyeNSVWsmp/yW35Tw: folds 
Uncalled bet ($6.95) returned to iauW7L/+7qzAuHow7CD75Q
*** FLOP *** [7h 8d 2c]
*** TURN *** [7h 8d 2c] [Kh]
*** RIVER *** [7h 8d 2c Kh] [9c]
iauW7L/+7qzAuHow7CD75Q said, "i win"
*** SHOW DOWN ***
iauW7L/+7qzAuHow7CD75Q: shows [Ks As] (a pair of Kings)
QvTX2yGq3uKJiKPmns4TKQ: shows [Ah Ac] (a pair of Aces)
QvTX2yGq3uKJiKPmns4TKQ collected $5.90 from pot
iauW7L/+7qzAuHow7CD75Q said, "damn"
*** SUMMARY ***
Total pot $6.20 | Rake $0.30 
Board [7h 8d 2c Kh 9c]
Seat 1: W87HPwOk1KtWaYyshBe1gA folded before Flop (didn't bet)
Seat 2: iauW7L/+7qzAuHow7CD75Q showed [Ks As] and lost with a pair of Kings
Seat 3: QvTX2yGq3uKJiKPmns4TKQ (button) showed [Ah Ac] and won ($5.90) with a pair of Aces
Seat 4: NTamLAiMZ86c5yM04t96LA (small blind) folded before Flop
Seat 5: faP2NVl/cFTZ1nE4pXzg8Q (big blind) folded before Flop
Seat 6: 7JqTFMyeNSVWsmp/yW35Tw folded before Flop




PokerStars Game #59941746746:  Hold'em No Limit ($0.10/$0.25) - 2009/07/01 1:44:51 ET
Table 'x7YStLKc8hpt/pTgSetPKA' 9-max Seat #6 is the button
Seat 1: tYsOBqdU1+x+yFI7zHO7hQ ($25 in chips) 
Seat 3: S7Ki0P+0AIGPuIfGJjW0gg ($12.10 in chips) 
Seat 4: ydoFOVgzvZv9ZhuWu9rXAw ($5.15 in chips) 
Seat 6: 9YN2IkT2JYYKFErZtZvCtA ($48.05 in chips) 
Seat 7: dtZ84flFEi4Q+SGrHMJRDQ ($26.10 in chips) 
Seat 8: j4q3p0lesp63b1gZDwLBZw ($5 in chips) 
Seat 9: nm4Dj/f+jJEwKVsUnKh73g ($37.05 in chips) 
dtZ84flFEi4Q+SGrHMJRDQ: posts small blind $0.10
j4q3p0lesp63b1gZDwLBZw: posts big blind $0.25
tLcDklc2rBORNfixyRfVfw: sits out 
*** HOLE CARDS ***
nm4Dj/f+jJEwKVsUnKh73g: folds 
tYsOBqdU1+x+yFI7zHO7hQ: folds 
S7Ki0P+0AIGPuIfGJjW0gg: folds 
ydoFOVgzvZv9ZhuWu9rXAw: folds 
9YN2IkT2JYYKFErZtZvCtA: raises $0.75 to $1
dtZ84flFEi4Q+SGrHMJRDQ: folds 
j4q3p0lesp63b1gZDwLBZw: folds 
Uncalled bet ($0.75) returned to 9YN2IkT2JYYKFErZtZvCtA
9YN2IkT2JYYKFErZtZvCtA collected $0.60 from pot
9YN2IkT2JYYKFErZtZvCtA: doesn't show hand 
*** SUMMARY ***
Total pot $0.60 | Rake $0 
Seat 1: tYsOBqdU1+x+yFI7zHO7hQ folded before Flop (didn't bet)
Seat 3: S7Ki0P+0AIGPuIfGJjW0gg folded before Flop (didn't bet)
Seat 4: ydoFOVgzvZv9ZhuWu9rXAw folded before Flop (didn't bet)
Seat 6: 9YN2IkT2JYYKFErZtZvCtA (button) collected ($0.60)
Seat 7: dtZ84flFEi4Q+SGrHMJRDQ (small blind) folded before Flop
Seat 8: j4q3p0lesp63b1gZDwLBZw (big blind) folded before Flop
Seat 9: nm4Dj/f+jJEwKVsUnKh73g folded before Flop (didn't bet)




PokerStars Game #59941746748:  Hold'em No Limit ($0.10/$0.25) - 2009/07/01 1:44:51 ET
Table 'yAHDCs33TIgw3ra63xuU2Q' 9-max Seat #1 is the button
Seat 1: ydoFOVgzvZv9ZhuWu9rXAw ($5 in chips) 
Seat 3: g6UPjSyxNLffCi+EqqIlEg ($21.10 in chips) 
Seat 4: j5spkbnOCRiLGiH6iqBaqw ($8.60 in chips) 
Seat 5: 4awUyiDYTgylQKXZ9faBVA ($37.60 in chips) 
Seat 6: DnDcAdn9P0zGovMERigpFA ($26.30 in chips) 
Seat 8: tYsOBqdU1+x+yFI7zHO7hQ ($25 in chips) 
Seat 9: MtVtHDqIJTyUcXkRBBDIVA ($25.25 in chips) 
g6UPjSyxNLffCi+EqqIlEg: posts small blind $0.10
j5spkbnOCRiLGiH6iqBaqw: posts big blind $0.25
*** HOLE CARDS ***
4awUyiDYTgylQKXZ9faBVA: folds 
j4q3p0lesp63b1gZDwLBZw joins the table at seat #2 
DnDcAdn9P0zGovMERigpFA: folds 
tYsOBqdU1+x+yFI7zHO7hQ: folds 
MtVtHDqIJTyUcXkRBBDIVA: folds 
ydoFOVgzvZv9ZhuWu9rXAw: folds 
g6UPjSyxNLffCi+EqqIlEg: raises $0.25 to $0.50
j5spkbnOCRiLGiH6iqBaqw: calls $0.25
*** FLOP *** [7c 5c 2h]
dukepoker05 is disconnected 
g6UPjSyxNLffCi+EqqIlEg: bets $1
j5spkbnOCRiLGiH6iqBaqw: folds 
Uncalled bet ($1) returned to g6UPjSyxNLffCi+EqqIlEg
g6UPjSyxNLffCi+EqqIlEg collected $0.95 from pot
*** SUMMARY ***
Total pot $1 | Rake $0.05 
Board [7c 5c 2h]
Seat 1: ydoFOVgzvZv9ZhuWu9rXAw (button) folded before Flop (didn't bet)
Seat 3: g6UPjSyxNLffCi+EqqIlEg (small blind) collected ($0.95)
Seat 4: j5spkbnOCRiLGiH6iqBaqw (big blind) folded on the Flop
Seat 5: 4awUyiDYTgylQKXZ9faBVA folded before Flop (didn't bet)
Seat 6: DnDcAdn9P0zGovMERigpFA folded before Flop (didn't bet)
Seat 8: tYsOBqdU1+x+yFI7zHO7hQ folded before Flop (didn't bet)
Seat 9: MtVtHDqIJTyUcXkRBBDIVA folded before Flop (didn't bet)




PokerStars Game #59941747176:  Hold'em No Limit ($0.10/$0.25) - 2009/07/01 1:44:52 ET
Table 'KAnP7XvDtlku47YfJwdOVw' 9-max Seat #7 is the button
Seat 1: cH3q40adP+kFogl+2MtbkQ ($14.50 in chips) 
Seat 3: W6tExOcYX7qiy6Qdp+ZwFA ($7.60 in chips) 
Seat 4: OiV1PWZ3IkN29JlmCcnTwQ ($4.65 in chips) 
Seat 5: MG90wfSJZnOejs/KD3vlQQ ($33.05 in chips) 
Seat 7: Lro4e37x4FUa5P3yzDjskw ($6.80 in chips) 
Seat 8: OneeONzF0MoH0pEdcBndwA ($22.55 in chips) 
Seat 9: HDDm1BkZtdsRyw2DJdqq6A ($24.40 in chips) 
OneeONzF0MoH0pEdcBndwA: posts small blind $0.10
HDDm1BkZtdsRyw2DJdqq6A: posts big blind $0.25
E0iYnEVO2ho7dH3QcCjw7g: sits out 
*** HOLE CARDS ***
cH3q40adP+kFogl+2MtbkQ: calls $0.25
W6tExOcYX7qiy6Qdp+ZwFA: folds 
OiV1PWZ3IkN29JlmCcnTwQ: folds 
MG90wfSJZnOejs/KD3vlQQ: folds 
Lro4e37x4FUa5P3yzDjskw: folds 
OneeONzF0MoH0pEdcBndwA: folds 
HDDm1BkZtdsRyw2DJdqq6A: checks 
*** FLOP *** [Qh Js Ah]
HDDm1BkZtdsRyw2DJdqq6A: checks 
cH3q40adP+kFogl+2MtbkQ: bets $0.25
HDDm1BkZtdsRyw2DJdqq6A: calls $0.25
*** TURN *** [Qh Js Ah] [4d]
HDDm1BkZtdsRyw2DJdqq6A: checks 
cH3q40adP+kFogl+2MtbkQ: bets $0.50
HDDm1BkZtdsRyw2DJdqq6A: calls $0.50
*** RIVER *** [Qh Js Ah 4d] [Kd]
HDDm1BkZtdsRyw2DJdqq6A: checks 
cH3q40adP+kFogl+2MtbkQ: bets $1
HDDm1BkZtdsRyw2DJdqq6A: raises $1.50 to $2.50
cH3q40adP+kFogl+2MtbkQ: calls $1.50
*** SHOW DOWN ***
HDDm1BkZtdsRyw2DJdqq6A: shows [Td 9h] (a straight, Ten to Ace)
cH3q40adP+kFogl+2MtbkQ: shows [9d Ts] (a straight, Ten to Ace)
HDDm1BkZtdsRyw2DJdqq6A collected $3.40 from pot
cH3q40adP+kFogl+2MtbkQ collected $3.35 from pot
*** SUMMARY ***
Total pot $7.10 | Rake $0.35 
Board [Qh Js Ah 4d Kd]
Seat 1: cH3q40adP+kFogl+2MtbkQ showed [9d Ts] and won ($3.35) with a straight, Ten to Ace
Seat 3: W6tExOcYX7qiy6Qdp+ZwFA folded before Flop (didn't bet)
Seat 4: OiV1PWZ3IkN29JlmCcnTwQ folded before Flop (didn't bet)
Seat 5: MG90wfSJZnOejs/KD3vlQQ folded before Flop (didn't bet)
Seat 7: Lro4e37x4FUa5P3yzDjskw (button) folded before Flop (didn't bet)
Seat 8: OneeONzF0MoH0pEdcBndwA (small blind) folded before Flop
Seat 9: HDDm1BkZtdsRyw2DJdqq6A (big blind) showed [Td 9h] and won ($3.40) with a straight, Ten to Ace




PokerStars Game #59941746964:  Hold'em No Limit ($0.10/$0.25) - 2009/07/01 1:44:52 ET
Table 'ROYvQOMwUrvL3SOiHYcrWg' 9-max Seat #7 is the button
Seat 1: 22dIObOuor/A+IKWkNoAlA ($5 in chips) 
Seat 2: gehe91e0IyVT0QU/XBkEyg ($24.90 in chips) 
Seat 3: 8EbrQ/EvFWt2cr0GaU82gQ ($4.65 in chips) 
Seat 4: SHegmCn8B0InbWE/zFlvOw ($21.95 in chips) 
Seat 5: 7je+LC5Mfs6nL8YBVh4frQ ($4.65 in chips) 
Seat 6: P+9ymZQ3ktpQu1bn7HIjew ($20.50 in chips) 
Seat 7: tYsOBqdU1+x+yFI7zHO7hQ ($25 in chips) 
Seat 8: biJWLZ27fafNeBI2oT1KJw ($28.25 in chips) 
Seat 9: uhrboV251dcgYniYTdFIcA ($25.35 in chips) 
biJWLZ27fafNeBI2oT1KJw: posts small blind $0.10
uhrboV251dcgYniYTdFIcA: posts big blind $0.25
*** HOLE CARDS ***
22dIObOuor/A+IKWkNoAlA: folds 
gehe91e0IyVT0QU/XBkEyg: folds 
8EbrQ/EvFWt2cr0GaU82gQ: folds 
SHegmCn8B0InbWE/zFlvOw: folds 
7je+LC5Mfs6nL8YBVh4frQ: raises $0.50 to $0.75
P+9ymZQ3ktpQu1bn7HIjew: folds 
tYsOBqdU1+x+yFI7zHO7hQ: folds 
biJWLZ27fafNeBI2oT1KJw: folds 
uhrboV251dcgYniYTdFIcA: folds 
Uncalled bet ($0.50) returned to 7je+LC5Mfs6nL8YBVh4frQ
7je+LC5Mfs6nL8YBVh4frQ collected $0.60 from pot
7je+LC5Mfs6nL8YBVh4frQ: doesn't show hand 
*** SUMMARY ***
Total pot $0.60 | Rake $0 
Seat 1: 22dIObOuor/A+IKWkNoAlA folded before Flop (didn't bet)
Seat 2: gehe91e0IyVT0QU/XBkEyg folded before Flop (didn't bet)
Seat 3: 8EbrQ/EvFWt2cr0GaU82gQ folded before Flop (didn't bet)
Seat 4: SHegmCn8B0InbWE/zFlvOw folded before Flop (didn't bet)
Seat 5: 7je+LC5Mfs6nL8YBVh4frQ collected ($0.60)
Seat 6: P+9ymZQ3ktpQu1bn7HIjew folded before Flop (didn't bet)
Seat 7: tYsOBqdU1+x+yFI7zHO7hQ (button) folded before Flop (didn't bet)
Seat 8: biJWLZ27fafNeBI2oT1KJw (small blind) folded before Flop
Seat 9: uhrboV251dcgYniYTdFIcA (big blind) folded before Flop




PokerStars Game #59941747230:  Hold'em No Limit ($0.10/$0.25) - 2009/07/01 1:44:52 ET
Table '/AhP8uWRzEEhOATYIdmn0A' 9-max Seat #7 is the button
Seat 1: +sbyWwIcFp9kP0bDtMegfQ ($37.80 in chips) 
Seat 2: nx5EoCNZFR03YUOXyT22wQ ($17.30 in chips) 
Seat 3: jx6dnobNHstDG0tabsbKHQ ($3.30 in chips) 
Seat 4: bXpVeaSTPBFSPJmeXxO7nw ($6 in chips) 
Seat 6: 8EbrQ/EvFWt2cr0GaU82gQ ($5 in chips) 
Seat 7: cZ99hugmLBj9KhTlc8nCSw ($25 in chips) 
Seat 8: K86cg2ifCMFAlmzsfTDjig ($26.95 in chips) 
Seat 9: OfGfQFPcghysTDljS9GQSQ ($10 in chips) 
K86cg2ifCMFAlmzsfTDjig: posts small blind $0.10
OfGfQFPcghysTDljS9GQSQ: posts big blind $0.25
*** HOLE CARDS ***
+sbyWwIcFp9kP0bDtMegfQ: folds 
nx5EoCNZFR03YUOXyT22wQ: folds 
jx6dnobNHstDG0tabsbKHQ has timed out
jx6dnobNHstDG0tabsbKHQ: folds 
jx6dnobNHstDG0tabsbKHQ is sitting out
bXpVeaSTPBFSPJmeXxO7nw: folds 
8EbrQ/EvFWt2cr0GaU82gQ: folds 
cZ99hugmLBj9KhTlc8nCSw: folds 
K86cg2ifCMFAlmzsfTDjig: calls $0.15
OfGfQFPcghysTDljS9GQSQ: checks 
*** FLOP *** [6c Jd Qd]
K86cg2ifCMFAlmzsfTDjig: bets $0.25
OfGfQFPcghysTDljS9GQSQ: calls $0.25
*** TURN *** [6c Jd Qd] [2c]
BKKiMP leaves the table
K86cg2ifCMFAlmzsfTDjig: bets $0.25
iZ1f67Ok/207yzIQOu1Kdg joins the table at seat #5 
OfGfQFPcghysTDljS9GQSQ: calls $0.25
*** RIVER *** [6c Jd Qd 2c] [6h]
K86cg2ifCMFAlmzsfTDjig: checks 
OfGfQFPcghysTDljS9GQSQ: bets $1.25
jx6dnobNHstDG0tabsbKHQ has returned
K86cg2ifCMFAlmzsfTDjig: folds 
Uncalled bet ($1.25) returned to OfGfQFPcghysTDljS9GQSQ
OfGfQFPcghysTDljS9GQSQ collected $1.45 from pot
OfGfQFPcghysTDljS9GQSQ: doesn't show hand 
*** SUMMARY ***
Total pot $1.50 | Rake $0.05 
Board [6c Jd Qd 2c 6h]
Seat 1: +sbyWwIcFp9kP0bDtMegfQ folded before Flop (didn't bet)
Seat 2: nx5EoCNZFR03YUOXyT22wQ folded before Flop (didn't bet)
Seat 3: jx6dnobNHstDG0tabsbKHQ folded before Flop (didn't bet)
Seat 4: bXpVeaSTPBFSPJmeXxO7nw folded before Flop (didn't bet)
Seat 6: 8EbrQ/EvFWt2cr0GaU82gQ folded before Flop (didn't bet)
Seat 7: cZ99hugmLBj9KhTlc8nCSw (button) folded before Flop (didn't bet)
Seat 8: K86cg2ifCMFAlmzsfTDjig (small blind) folded on the River
Seat 9: OfGfQFPcghysTDljS9GQSQ (big blind) collected ($1.45)




PokerStars Game #59941747220:  Hold'em No Limit ($0.10/$0.25) - 2009/07/01 1:44:52 ET
Table 'BpNkESDX1ip9c0K1hb5h7A' 6-max Seat #5 is the button
Seat 1: 5YZdVjBPZVEdubN4xEMPEg ($31.75 in chips) 
Seat 3: fZQg9veL7Dd/Z04ZTjC+wQ ($27.90 in chips) 
Seat 4: kG34n23qFQA3nzdOJTQ1dA ($25.55 in chips) 
Seat 5: L3/N/gliETan8N5Gim5h4Q ($25.40 in chips) 
Seat 6: 8EEqTTh7T1q48sYDqbI2Xg ($21.25 in chips) 
8EEqTTh7T1q48sYDqbI2Xg: posts small blind $0.10
5YZdVjBPZVEdubN4xEMPEg: posts big blind $0.25
9U3ZKjCsarN0DjR6mSE8Ug: sits out 
*** HOLE CARDS ***
fZQg9veL7Dd/Z04ZTjC+wQ: folds 
kG34n23qFQA3nzdOJTQ1dA: calls $0.25
L3/N/gliETan8N5Gim5h4Q: folds 
8EEqTTh7T1q48sYDqbI2Xg: calls $0.15
5YZdVjBPZVEdubN4xEMPEg: checks 
*** FLOP *** [Th 9s Js]
8EEqTTh7T1q48sYDqbI2Xg: checks 
5YZdVjBPZVEdubN4xEMPEg: checks 
kG34n23qFQA3nzdOJTQ1dA: bets $0.50
8EEqTTh7T1q48sYDqbI2Xg: calls $0.50
5YZdVjBPZVEdubN4xEMPEg: folds 
*** TURN *** [Th 9s Js] [5h]
8EEqTTh7T1q48sYDqbI2Xg: checks 
kG34n23qFQA3nzdOJTQ1dA: checks 
*** RIVER *** [Th 9s Js 5h] [3h]
8EEqTTh7T1q48sYDqbI2Xg: checks 
kG34n23qFQA3nzdOJTQ1dA: checks 
*** SHOW DOWN ***
8EEqTTh7T1q48sYDqbI2Xg: shows [Ad 8s] (high card Ace)
kG34n23qFQA3nzdOJTQ1dA: shows [As Ks] (high card Ace - King kicker)
kG34n23qFQA3nzdOJTQ1dA collected $1.70 from pot
*** SUMMARY ***
Total pot $1.75 | Rake $0.05 
Board [Th 9s Js 5h 3h]
Seat 1: 5YZdVjBPZVEdubN4xEMPEg (big blind) folded on the Flop
Seat 3: fZQg9veL7Dd/Z04ZTjC+wQ folded before Flop (didn't bet)
Seat 4: kG34n23qFQA3nzdOJTQ1dA showed [As Ks] and won ($1.70) with high card Ace
Seat 5: L3/N/gliETan8N5Gim5h4Q (button) folded before Flop (didn't bet)
Seat 6: 8EEqTTh7T1q48sYDqbI2Xg (small blind) showed [Ad 8s] and lost with high card Ace




PokerStars Game #59941747694:  Hold'em No Limit ($0.10/$0.25) - 2009/07/01 1:44:53 ET
Table 'oJpFwZj9+FUGHX90Un8s9Q' 6-max Seat #4 is the button
Seat 1: 6DwBRH+xZ12AAZmeAg+aXw ($23.30 in chips) 
Seat 2: NtrVQ9UIql0rDCnKDKZ5FQ ($14.80 in chips) 
Seat 3: kyRaCIljYA6l33lSKQfNsg ($27 in chips) 
Seat 4: 6elpmfyt4Zw0yvd8lePSMQ ($21.80 in chips) 
Seat 5: kG34n23qFQA3nzdOJTQ1dA ($55.85 in chips) 
kG34n23qFQA3nzdOJTQ1dA: posts small blind $0.10
6DwBRH+xZ12AAZmeAg+aXw: posts big blind $0.25
*** HOLE CARDS ***
NtrVQ9UIql0rDCnKDKZ5FQ: folds 
edio/rLJ06xeZOfLhoL3UA leaves the table
kyRaCIljYA6l33lSKQfNsg: folds 
6elpmfyt4Zw0yvd8lePSMQ: calls $0.25
kG34n23qFQA3nzdOJTQ1dA: folds 
6DwBRH+xZ12AAZmeAg+aXw: raises $0.75 to $1
6elpmfyt4Zw0yvd8lePSMQ: folds 
Uncalled bet ($0.75) returned to 6DwBRH+xZ12AAZmeAg+aXw
6DwBRH+xZ12AAZmeAg+aXw collected $0.60 from pot
6DwBRH+xZ12AAZmeAg+aXw: doesn't show hand 
*** SUMMARY ***
Total pot $0.60 | Rake $0 
Seat 1: 6DwBRH+xZ12AAZmeAg+aXw (big blind) collected ($0.60)
Seat 2: NtrVQ9UIql0rDCnKDKZ5FQ folded before Flop (didn't bet)
Seat 3: kyRaCIljYA6l33lSKQfNsg folded before Flop (didn't bet)
Seat 4: 6elpmfyt4Zw0yvd8lePSMQ (button) folded before Flop
Seat 5: kG34n23qFQA3nzdOJTQ1dA (small blind) folded before Flop




PokerStars Game #59941747620:  Hold'em No Limit ($0.10/$0.25) - 2009/07/01 1:44:53 ET
Table 'IuqVbFI+pwnJjvwBCGSGAw' 6-max Seat #3 is the button
Seat 1: LyDHtw3/yniNHW+DvLXbog ($25.70 in chips) 
Seat 3: QiL+lEgEWwy21jk/ltaRLg ($21.40 in chips) 
Seat 4: DE9hRlt14g+JdsRQ4wT7hg ($26.45 in chips) 
Seat 5: if4dh6jhJXeN3/qd3qCp9g ($25.35 in chips) 
DE9hRlt14g+JdsRQ4wT7hg: posts small blind $0.10
if4dh6jhJXeN3/qd3qCp9g: posts big blind $0.25
xC0kaiDYM6YTlgODL83O5A: sits out 
*** HOLE CARDS ***
LyDHtw3/yniNHW+DvLXbog: folds 
QiL+lEgEWwy21jk/ltaRLg: folds 
DE9hRlt14g+JdsRQ4wT7hg: folds 
Uncalled bet ($0.15) returned to if4dh6jhJXeN3/qd3qCp9g
if4dh6jhJXeN3/qd3qCp9g collected $0.20 from pot
if4dh6jhJXeN3/qd3qCp9g: doesn't show hand 
*** SUMMARY ***
Total pot $0.20 | Rake $0 
Seat 1: LyDHtw3/yniNHW+DvLXbog folded before Flop (didn't bet)
Seat 3: QiL+lEgEWwy21jk/ltaRLg (button) folded before Flop (didn't bet)
Seat 4: DE9hRlt14g+JdsRQ4wT7hg (small blind) folded before Flop
Seat 5: if4dh6jhJXeN3/qd3qCp9g (big blind) collected ($0.20)




PokerStars Game #59941747676:  Hold'em No Limit ($0.10/$0.25) - 2009/07/01 1:44:53 ET
Table '9lYs7ljXi6AgFAxYHlKLJw' 9-max Seat #4 is the button
Seat 1: K0b5wNInj6hUGRr6yzKFtw ($37.15 in chips) 
Seat 2: 0XACOSNrAWmqNv9k1nF8rw ($18.20 in chips) 
Seat 3: arxNSjreDRGFg13EAM2F1w ($30.95 in chips) 
Seat 4: UANt6y/SmDCY/jIxkBixcw ($33 in chips) 
Seat 5: dfNim92Z6XK1/h5SFW5vDg ($51.70 in chips) 
Seat 6: tYsOBqdU1+x+yFI7zHO7hQ ($25 in chips) 
Seat 7: ghNKXUBl/H+t83JF079ZBA ($28.05 in chips) 
Seat 8: 9YN2IkT2JYYKFErZtZvCtA ($19.10 in chips) 
Seat 9: cKlmpQMahVsmOaxFQDcoOg ($19 in chips) 
dfNim92Z6XK1/h5SFW5vDg: posts small blind $0.10
tYsOBqdU1+x+yFI7zHO7hQ: posts big blind $0.25
*** HOLE CARDS ***
ghNKXUBl/H+t83JF079ZBA: folds 
9YN2IkT2JYYKFErZtZvCtA: raises $0.75 to $1
cKlmpQMahVsmOaxFQDcoOg: folds 
K0b5wNInj6hUGRr6yzKFtw: folds 
0XACOSNrAWmqNv9k1nF8rw: folds 
arxNSjreDRGFg13EAM2F1w: folds 
UANt6y/SmDCY/jIxkBixcw: folds 
dfNim92Z6XK1/h5SFW5vDg: folds 
tYsOBqdU1+x+yFI7zHO7hQ: folds 
Uncalled bet ($0.75) returned to 9YN2IkT2JYYKFErZtZvCtA
9YN2IkT2JYYKFErZtZvCtA collected $0.60 from pot
9YN2IkT2JYYKFErZtZvCtA: doesn't show hand 
*** SUMMARY ***
Total pot $0.60 | Rake $0 
Seat 1: K0b5wNInj6hUGRr6yzKFtw folded before Flop (didn't bet)
Seat 2: 0XACOSNrAWmqNv9k1nF8rw folded before Flop (didn't bet)
Seat 3: arxNSjreDRGFg13EAM2F1w folded before Flop (didn't bet)
Seat 4: UANt6y/SmDCY/jIxkBixcw (button) folded before Flop (didn't bet)
Seat 5: dfNim92Z6XK1/h5SFW5vDg (small blind) folded before Flop
Seat 6: tYsOBqdU1+x+yFI7zHO7hQ (big blind) folded before Flop
Seat 7: ghNKXUBl/H+t83JF079ZBA folded before Flop (didn't bet)
Seat 8: 9YN2IkT2JYYKFErZtZvCtA collected ($0.60)
Seat 9: cKlmpQMahVsmOaxFQDcoOg folded before Flop (didn't bet)




PokerStars Game #59941747322:  Hold'em No Limit ($0.10/$0.25) - 2009/07/01 1:44:53 ET
Table 'WjNvuuSgTjm8jh0j9vcCgQ' 9-max Seat #8 is the button
Seat 1: q+Qdg0Hoir+SyL7haBrUnw ($8.05 in chips) 
Seat 2: ghNKXUBl/H+t83JF079ZBA ($23.40 in chips) 
Seat 3: pSKReiGBNW9NsF2jAZnlwg ($22.35 in chips) 
Seat 4: X78b5v/uhqeXXoAijbw/yg ($31.35 in chips) 
Seat 5: ziFpkH3wCzqB/qXeq/Hy7g ($25 in chips) 
Seat 6: ubsjZomMWSV0hAiBLa7K1A ($21.25 in chips) 
Seat 7: NSX8YOj+RznxoL+rO1YU4w ($17.30 in chips) 
Seat 8: hZuGwtYmFKPmQ+v1wlmdfA ($17.40 in chips) 
Seat 9: CT7Xj/V/O5rBlhtt+RZeFQ ($25.35 in chips) 
CT7Xj/V/O5rBlhtt+RZeFQ: posts small blind $0.10
q+Qdg0Hoir+SyL7haBrUnw: posts big blind $0.25
*** HOLE CARDS ***
ghNKXUBl/H+t83JF079ZBA: folds 
pSKReiGBNW9NsF2jAZnlwg: folds 
X78b5v/uhqeXXoAijbw/yg: folds 
ziFpkH3wCzqB/qXeq/Hy7g: folds 
ubsjZomMWSV0hAiBLa7K1A: folds 
NSX8YOj+RznxoL+rO1YU4w: calls $0.25
hZuGwtYmFKPmQ+v1wlmdfA: folds 
CT7Xj/V/O5rBlhtt+RZeFQ: folds 
q+Qdg0Hoir+SyL7haBrUnw: checks 
*** FLOP *** [Ac Tc Js]
q+Qdg0Hoir+SyL7haBrUnw: checks 
NSX8YOj+RznxoL+rO1YU4w: bets $0.50
q+Qdg0Hoir+SyL7haBrUnw: folds 
Uncalled bet ($0.50) returned to NSX8YOj+RznxoL+rO1YU4w
NSX8YOj+RznxoL+rO1YU4w collected $0.60 from pot
NSX8YOj+RznxoL+rO1YU4w: doesn't show hand 
*** SUMMARY ***
Total pot $0.60 | Rake $0 
Board [Ac Tc Js]
Seat 1: q+Qdg0Hoir+SyL7haBrUnw (big blind) folded on the Flop
Seat 2: ghNKXUBl/H+t83JF079ZBA folded before Flop (didn't bet)
Seat 3: pSKReiGBNW9NsF2jAZnlwg folded before Flop (didn't bet)
Seat 4: X78b5v/uhqeXXoAijbw/yg folded before Flop (didn't bet)
Seat 5: ziFpkH3wCzqB/qXeq/Hy7g folded before Flop (didn't bet)
Seat 6: ubsjZomMWSV0hAiBLa7K1A folded before Flop (didn't bet)
Seat 7: NSX8YOj+RznxoL+rO1YU4w collected ($0.60)
Seat 8: hZuGwtYmFKPmQ+v1wlmdfA (button) folded before Flop (didn't bet)
Seat 9: CT7Xj/V/O5rBlhtt+RZeFQ (small blind) folded before Flop




PokerStars Game #59941747590:  Hold'em No Limit ($0.10/$0.25) - 2009/07/01 1:44:53 ET
Table 'eOXPe2c6mG7DOFKvMsZZfA' 6-max Seat #1 is the button
Seat 1: s21kVGMLPAoHdWR+muSonw ($25.05 in chips) 
Seat 2: gaPMxLGp9SOj4Lq6t+/0Ig ($7.20 in chips) 
Seat 3: kReyZ6g6Fu3tQ0nyjDf9kA ($27.10 in chips) 
Seat 4: zHHLkD2sRljslKKeQv/ZQw ($35.35 in chips) 
Seat 5: NhUN/JpAprdJeamFBgJH1w ($32.30 in chips) 
Seat 6: Qpv/hb5ak7LeaDig1L5L8w ($13.60 in chips) 
gaPMxLGp9SOj4Lq6t+/0Ig: posts small blind $0.10
kReyZ6g6Fu3tQ0nyjDf9kA: posts big blind $0.25
*** HOLE CARDS ***
zHHLkD2sRljslKKeQv/ZQw: folds 
NhUN/JpAprdJeamFBgJH1w: folds 
Qpv/hb5ak7LeaDig1L5L8w: folds 
s21kVGMLPAoHdWR+muSonw: raises $0.50 to $0.75
gaPMxLGp9SOj4Lq6t+/0Ig: folds 
kReyZ6g6Fu3tQ0nyjDf9kA: calls $0.50
*** FLOP *** [Jc Kc Qh]
kReyZ6g6Fu3tQ0nyjDf9kA: checks 
s21kVGMLPAoHdWR+muSonw: bets $0.75
kReyZ6g6Fu3tQ0nyjDf9kA: calls $0.75
*** TURN *** [Jc Kc Qh] [9c]
kReyZ6g6Fu3tQ0nyjDf9kA: checks 
s21kVGMLPAoHdWR+muSonw: bets $0.75
kReyZ6g6Fu3tQ0nyjDf9kA: folds 
Uncalled bet ($0.75) returned to s21kVGMLPAoHdWR+muSonw
s21kVGMLPAoHdWR+muSonw collected $2.95 from pot
s21kVGMLPAoHdWR+muSonw: doesn't show hand 
*** SUMMARY ***
Total pot $3.10 | Rake $0.15 
Board [Jc Kc Qh 9c]
Seat 1: s21kVGMLPAoHdWR+muSonw (button) collected ($2.95)
Seat 2: gaPMxLGp9SOj4Lq6t+/0Ig (small blind) folded before Flop
Seat 3: kReyZ6g6Fu3tQ0nyjDf9kA (big blind) folded on the Turn
Seat 4: zHHLkD2sRljslKKeQv/ZQw folded before Flop (didn't bet)
Seat 5: NhUN/JpAprdJeamFBgJH1w folded before Flop (didn't bet)
Seat 6: Qpv/hb5ak7LeaDig1L5L8w folded before Flop (didn't bet)




PokerStars Game #59941747718:  Hold'em No Limit ($0.10/$0.25) - 2009/07/01 1:44:53 ET
Table 'YONIZZNvg4uZ4xNUO1deeA' 6-max Seat #5 is the button
Seat 1: GbCVUNssQ7mqsPWr7J4d3w ($5 in chips) 
Seat 2: evMMX/0gSDH791KdSAOaSg ($17.20 in chips) 
Seat 3: Eksrep3hySi2jeDHuaWiOQ ($10.65 in chips) 
Seat 4: oNAHfBJOUelvVhf0IDMJUA ($11.55 in chips) 
Seat 5: if4dh6jhJXeN3/qd3qCp9g ($25 in chips) 
Seat 6: eL3+wCBjFGfQ5FMdIZihwA ($27.10 in chips) 
eL3+wCBjFGfQ5FMdIZihwA: posts small blind $0.10
GbCVUNssQ7mqsPWr7J4d3w: posts big blind $0.25
*** HOLE CARDS ***
evMMX/0gSDH791KdSAOaSg: folds 
Eksrep3hySi2jeDHuaWiOQ: raises $0.75 to $1
oNAHfBJOUelvVhf0IDMJUA: folds 
oNAHfBJOUelvVhf0IDMJUA leaves the table
if4dh6jhJXeN3/qd3qCp9g: folds 
eL3+wCBjFGfQ5FMdIZihwA: folds 
GbCVUNssQ7mqsPWr7J4d3w: folds 
Uncalled bet ($0.75) returned to Eksrep3hySi2jeDHuaWiOQ
w43JQj2oYPpKQVG4Yzlq1w joins the table at seat #4 
Eksrep3hySi2jeDHuaWiOQ collected $0.60 from pot
*** SUMMARY ***
Total pot $0.60 | Rake $0 
Seat 1: GbCVUNssQ7mqsPWr7J4d3w (big blind) folded before Flop
Seat 2: evMMX/0gSDH791KdSAOaSg folded before Flop (didn't bet)
Seat 3: Eksrep3hySi2jeDHuaWiOQ collected ($0.60)
Seat 4: oNAHfBJOUelvVhf0IDMJUA folded before Flop (didn't bet)
Seat 5: if4dh6jhJXeN3/qd3qCp9g (button) folded before Flop (didn't bet)
Seat 6: eL3+wCBjFGfQ5FMdIZihwA (small blind) folded before Flop




PokerStars Game #59941747910:  Hold'em No Limit ($0.10/$0.25) - 2009/07/01 1:44:54 ET
Table '63h13e5p7cWe02rClZ1CHw' 6-max Seat #3 is the button
Seat 1: pokjbbEcXXPlADXdSGHtZw ($18.75 in chips) 
Seat 2: k9nHZTHt8hYhYRcW8NTb4g ($30.15 in chips) 
Seat 3: mFv3iBCtrw9XfCDRB0d46Q ($4.65 in chips) 
Seat 4: xrf8tAXKQHG99HixCot1Iw ($23.45 in chips) 
Seat 5: iyZxqznXjv3vtvOJymkoLQ ($44.80 in chips) 
Seat 6: mfrkWA3PTeYPkbO6hi98Aw ($39.05 in chips) 
xrf8tAXKQHG99HixCot1Iw: posts small blind $0.10
iyZxqznXjv3vtvOJymkoLQ: posts big blind $0.25
*** HOLE CARDS ***
mfrkWA3PTeYPkbO6hi98Aw: raises $0.75 to $1
pokjbbEcXXPlADXdSGHtZw: folds 
k9nHZTHt8hYhYRcW8NTb4g: folds 
mFv3iBCtrw9XfCDRB0d46Q: folds 
xrf8tAXKQHG99HixCot1Iw: folds 
iyZxqznXjv3vtvOJymkoLQ: folds 
Uncalled bet ($0.75) returned to mfrkWA3PTeYPkbO6hi98Aw
mfrkWA3PTeYPkbO6hi98Aw collected $0.60 from pot
mfrkWA3PTeYPkbO6hi98Aw: doesn't show hand 
*** SUMMARY ***
Total pot $0.60 | Rake $0 
Seat 1: pokjbbEcXXPlADXdSGHtZw folded before Flop (didn't bet)
Seat 2: k9nHZTHt8hYhYRcW8NTb4g folded before Flop (didn't bet)
Seat 3: mFv3iBCtrw9XfCDRB0d46Q (button) folded before Flop (didn't bet)
Seat 4: xrf8tAXKQHG99HixCot1Iw (small blind) folded before Flop
Seat 5: iyZxqznXjv3vtvOJymkoLQ (big blind) folded before Flop
Seat 6: mfrkWA3PTeYPkbO6hi98Aw collected ($0.60)




PokerStars Game #59941747908:  Hold'em No Limit ($0.10/$0.25) - 2009/07/01 1:44:54 ET
Table 'gZetDqJh6q9A3mLO3ThCsAnc6OeGk/wtaWV+6N+kgnZQSeat #4 is the button
Seat 1: DihMHaz4WNETH1bPDe13kA ($26.05 in chips) 
Seat 2: JFIAqU8lCZ0vWwEl4bdGsg ($32.90 in chips) 
Seat 3: jp34e617tIzV8tKIWmfAbA ($33.80 in chips) 
Seat 4: BV+K0Phf5VBHr7aZPKqbUQ ($29 in chips) 
Seat 5: EKTLAV1bAterT0Mc1G6lBg5hAPbqNrvJb8PtLiceXtlg4.85 in chips) 
Seat 6: Mhj3q7cxev+XjXZxEE6/Cw ($25 in chips) 
EKTLAV1bAterT0Mc1G6lBg5hAPbqNrvJb8PtLiceXtlgsts small blind $0.10
Mhj3q7cxev+XjXZxEE6/Cw: posts big blind $0.25
*** HOLE CARDS ***
DihMHaz4WNETH1bPDe13kA: folds 
JFIAqU8lCZ0vWwEl4bdGsg: folds 
jp34e617tIzV8tKIWmfAbA: folds 
BV+K0Phf5VBHr7aZPKqbUQ: raises $0.50 to $0.75
EKTLAV1bAterT0Mc1G6lBg5hAPbqNrvJb8PtLiceXtlglds 
Mhj3q7cxev+XjXZxEE6/Cw: folds 
Uncalled bet ($0.50) returned to BV+K0Phf5VBHr7aZPKqbUQ
BV+K0Phf5VBHr7aZPKqbUQ collected $0.60 from pot
BV+K0Phf5VBHr7aZPKqbUQ: doesn't show hand 
*** SUMMARY ***
Total pot $0.60 | Rake $0 
Seat 1: DihMHaz4WNETH1bPDe13kA folded before Flop (didn't bet)
Seat 2: JFIAqU8lCZ0vWwEl4bdGsg folded before Flop (didn't bet)
Seat 3: jp34e617tIzV8tKIWmfAbA folded before Flop (didn't bet)
Seat 4: BV+K0Phf5VBHr7aZPKqbUQ (button) collected ($0.60)
Seat 5: EKTLAV1bAterT0Mc1G6lBg5hAPbqNrvJb8PtLiceXtlgall blind) folded before Flop
Seat 6: Mhj3q7cxev+XjXZxEE6/Cw (big blind) folded before Flop




PokerStars Game #59941748068:  Hold'em No Limit ($0.10/$0.25) - 2009/07/01 1:44:54 ET
Table 'ZEXL6Wh4qA4Afx8NnoBBAA' 6-max Seat #6 is the button
Seat 1: v8m8XHovI5tqEA9mvplDSw ($27.70 in chips) 
Seat 2: 6DwBRH+xZ12AAZmeAg+aXw ($24 in chips) 
Seat 3: +ZlnqPoP3Hg4BIUxDfKd/A ($32.05 in chips) 
Seat 4: FpN4KbLjlyRRKiVaQcoLqA ($29.60 in chips) 
Seat 5: if4dh6jhJXeN3/qd3qCp9g ($35.80 in chips) 
Seat 6: Lh8SlCq3OSDKWLUgAI/Lxw ($2 in chips) 
v8m8XHovI5tqEA9mvplDSw: posts small blind $0.10
6DwBRH+xZ12AAZmeAg+aXw: posts big blind $0.25
*** HOLE CARDS ***
+ZlnqPoP3Hg4BIUxDfKd/A: folds 
FpN4KbLjlyRRKiVaQcoLqA: calls $0.25
if4dh6jhJXeN3/qd3qCp9g: calls $0.25
Lh8SlCq3OSDKWLUgAI/Lxw: folds 
v8m8XHovI5tqEA9mvplDSw: calls $0.15
6DwBRH+xZ12AAZmeAg+aXw: checks 
*** FLOP *** [7d Tc 4c]
v8m8XHovI5tqEA9mvplDSw: checks 
6DwBRH+xZ12AAZmeAg+aXw: checks 
FpN4KbLjlyRRKiVaQcoLqA: checks 
if4dh6jhJXeN3/qd3qCp9g: checks 
*** TURN *** [7d Tc 4c] [Ks]
v8m8XHovI5tqEA9mvplDSw: checks 
6DwBRH+xZ12AAZmeAg+aXw: checks 
FpN4KbLjlyRRKiVaQcoLqA: checks 
if4dh6jhJXeN3/qd3qCp9g: bets $0.50
v8m8XHovI5tqEA9mvplDSw: folds 
6DwBRH+xZ12AAZmeAg+aXw: folds 
if4dh6jhJXeN3/qd3qCp9g said, "ty"
FpN4KbLjlyRRKiVaQcoLqA: folds 
Uncalled bet ($0.50) returned to if4dh6jhJXeN3/qd3qCp9g
if4dh6jhJXeN3/qd3qCp9g collected $0.95 from pot
if4dh6jhJXeN3/qd3qCp9g: doesn't show hand 
*** SUMMARY ***
Total pot $1 | Rake $0.05 
Board [7d Tc 4c Ks]
Seat 1: v8m8XHovI5tqEA9mvplDSw (small blind) folded on the Turn
Seat 2: 6DwBRH+xZ12AAZmeAg+aXw (big blind) folded on the Turn
Seat 3: +ZlnqPoP3Hg4BIUxDfKd/A folded before Flop (didn't bet)
Seat 4: FpN4KbLjlyRRKiVaQcoLqA folded on the Turn
Seat 5: if4dh6jhJXeN3/qd3qCp9g collected ($0.95)
Seat 6: Lh8SlCq3OSDKWLUgAI/Lxw (button) folded before Flop (didn't bet)




PokerStars Game #59941747968:  Hold'em No Limit ($0.10/$0.25) - 2009/07/01 1:44:54 ET
Table 'srBTB98reCdD1TffxE6o7g' 6-max Seat #1 is the button
Seat 1: SFmT9ZsVopnukjvAzrxTRg ($33.95 in chips) 
Seat 2: mfrkWA3PTeYPkbO6hi98Aw ($25.10 in chips) 
Seat 3: VOmI0x4dDPnTESZd5B4d1Q ($48.20 in chips) 
Seat 4: 6DwBRH+xZ12AAZmeAg+aXw ($16.55 in chips) 
Seat 5: 8zUCJvLYLFM8AG6K5zjIvg ($16.60 in chips) 
Seat 6: BV+K0Phf5VBHr7aZPKqbUQ ($34.60 in chips) 
mfrkWA3PTeYPkbO6hi98Aw: posts small blind $0.10
VOmI0x4dDPnTESZd5B4d1Q: posts big blind $0.25
*** HOLE CARDS ***
6DwBRH+xZ12AAZmeAg+aXw: folds 
8zUCJvLYLFM8AG6K5zjIvg: folds 
BV+K0Phf5VBHr7aZPKqbUQ: raises $0.50 to $0.75
SFmT9ZsVopnukjvAzrxTRg: folds 
mfrkWA3PTeYPkbO6hi98Aw: folds 
VOmI0x4dDPnTESZd5B4d1Q: folds 
Uncalled bet ($0.50) returned to BV+K0Phf5VBHr7aZPKqbUQ
BV+K0Phf5VBHr7aZPKqbUQ collected $0.60 from pot
BV+K0Phf5VBHr7aZPKqbUQ: doesn't show hand 
*** SUMMARY ***
Total pot $0.60 | Rake $0 
Seat 1: SFmT9ZsVopnukjvAzrxTRg (button) folded before Flop (didn't bet)
Seat 2: mfrkWA3PTeYPkbO6hi98Aw (small blind) folded before Flop
Seat 3: VOmI0x4dDPnTESZd5B4d1Q (big blind) folded before Flop
Seat 4: 6DwBRH+xZ12AAZmeAg+aXw folded before Flop (didn't bet)
Seat 5: 8zUCJvLYLFM8AG6K5zjIvg folded before Flop (didn't bet)
Seat 6: BV+K0Phf5VBHr7aZPKqbUQ collected ($0.60)




PokerStars Game #59941748044:  Hold'em No Limit ($0.10/$0.25) - 2009/07/01 1:44:54 ET
Table '3Ns9nuTkynfwbBfBXzg6ww' 6-max Seat #6 is the button
Seat 1: epAUIB7h2FJXzUPRIvSkRA ($25.45 in chips) 
Seat 2: zxeVQGaMKDsDzmSY+AInjA ($36.65 in chips) 
Seat 3: eL3+wCBjFGfQ5FMdIZihwA ($24.30 in chips) 
Seat 4: qGHGf/553gQnDoklMRe3tg ($30.60 in chips) 
Seat 5: wqphQtauX5Qn7WRJZS1flA ($25.30 in chips) 
Seat 6: DE9hRlt14g+JdsRQ4wT7hg ($33.20 in chips) 
epAUIB7h2FJXzUPRIvSkRA: posts small blind $0.10
zxeVQGaMKDsDzmSY+AInjA: posts big blind $0.25
*** HOLE CARDS ***
eL3+wCBjFGfQ5FMdIZihwA: folds 
qGHGf/553gQnDoklMRe3tg: folds 
wqphQtauX5Qn7WRJZS1flA: raises $0.50 to $0.75
DE9hRlt14g+JdsRQ4wT7hg: folds 
epAUIB7h2FJXzUPRIvSkRA: folds 
zxeVQGaMKDsDzmSY+AInjA: raises $0.50 to $1.25
wqphQtauX5Qn7WRJZS1flA: calls $0.50
*** FLOP *** [5h 4s 5d]
zxeVQGaMKDsDzmSY+AInjA: bets $1.50
wqphQtauX5Qn7WRJZS1flA: folds 
Uncalled bet ($1.50) returned to zxeVQGaMKDsDzmSY+AInjA
zxeVQGaMKDsDzmSY+AInjA collected $2.50 from pot
zxeVQGaMKDsDzmSY+AInjA: doesn't show hand 
*** SUMMARY ***
Total pot $2.60 | Rake $0.10 
Board [5h 4s 5d]
Seat 1: epAUIB7h2FJXzUPRIvSkRA (small blind) folded before Flop
Seat 2: zxeVQGaMKDsDzmSY+AInjA (big blind) collected ($2.50)
Seat 3: eL3+wCBjFGfQ5FMdIZihwA folded before Flop (didn't bet)
Seat 4: qGHGf/553gQnDoklMRe3tg folded before Flop (didn't bet)
Seat 5: wqphQtauX5Qn7WRJZS1flA folded on the Flop
Seat 6: DE9hRlt14g+JdsRQ4wT7hg (button) folded before Flop (didn't bet)




PokerStars Game #59941748184:  Hold'em No Limit ($0.10/$0.25) - 2009/07/01 1:44:54 ET
Table 'ktio12Pyq06LsrFhIorSqA' 9-max Seat #7 is the button
Seat 1: OneeONzF0MoH0pEdcBndwA ($38.75 in chips) 
Seat 2: tGsFgUKjSctVaAXabrlZxw ($4.40 in chips) 
Seat 5: e0pV1oisCAilWiG0FCxY6A ($16.75 in chips) 
Seat 6: jQL6XIewylQ8MmZhhq2YFg ($42.20 in chips) 
Seat 7: XGCfQsxa6PfAg3kJtzUmww ($22.10 in chips) 
Seat 9: H5Se03ZqSX7tbULXur2MAg ($26.40 in chips) 
H5Se03ZqSX7tbULXur2MAg: posts small blind $0.10
OneeONzF0MoH0pEdcBndwA: posts big blind $0.25
Z9W7+g1WMhhZDi7DwGbCFA: sits out 
*** HOLE CARDS ***
tGsFgUKjSctVaAXabrlZxw: calls $0.25
e0pV1oisCAilWiG0FCxY6A: folds 
0QdZrkFD7aGKeBXPGbIomA has returned
jQL6XIewylQ8MmZhhq2YFg: folds 
XGCfQsxa6PfAg3kJtzUmww: folds 
H5Se03ZqSX7tbULXur2MAg: folds 
OneeONzF0MoH0pEdcBndwA: checks 
*** FLOP *** [9d Td Js]
OneeONzF0MoH0pEdcBndwA: checks 
tGsFgUKjSctVaAXabrlZxw: bets $0.75
OneeONzF0MoH0pEdcBndwA: calls $0.75
*** TURN *** [9d Td Js] [Jd]
OneeONzF0MoH0pEdcBndwA: checks 
tGsFgUKjSctVaAXabrlZxw: bets $0.75
OneeONzF0MoH0pEdcBndwA: calls $0.75
*** RIVER *** [9d Td Js Jd] [4h]
OneeONzF0MoH0pEdcBndwA: checks 
tGsFgUKjSctVaAXabrlZxw: checks 
*** SHOW DOWN ***
OneeONzF0MoH0pEdcBndwA: shows [Qh Th] (two pair, Jacks and Tens)
tGsFgUKjSctVaAXabrlZxw: mucks hand 
OneeONzF0MoH0pEdcBndwA collected $3.45 from pot
*** SUMMARY ***
Total pot $3.60 | Rake $0.15 
Board [9d Td Js Jd 4h]
Seat 1: OneeONzF0MoH0pEdcBndwA (big blind) showed [Qh Th] and won ($3.45) with two pair, Jacks and Tens
Seat 2: tGsFgUKjSctVaAXabrlZxw mucked
Seat 5: e0pV1oisCAilWiG0FCxY6A folded before Flop (didn't bet)
Seat 6: jQL6XIewylQ8MmZhhq2YFg folded before Flop (didn't bet)
Seat 7: XGCfQsxa6PfAg3kJtzUmww (button) folded before Flop (didn't bet)
Seat 9: H5Se03ZqSX7tbULXur2MAg (small blind) folded before Flop




PokerStars Game #59941748072:  Hold'em No Limit ($0.10/$0.25) - 2009/07/01 1:44:54 ET
Table 'HbNAGS1OJWQKyfk7UfrYyw' 9-max Seat #5 is the button
Seat 2: fjwM06E3HzjUrynPRQi31Q ($5.85 in chips) 
Seat 5: z2SmIaQ3+5n/eY1BN5HgPg ($6.65 in chips) 
Seat 6: jntAuOS+eFQDYNiDN8dzag ($12.75 in chips) 
Yxal0LG80xJqTIctpMLWlg joins the table at seat #3 
jntAuOS+eFQDYNiDN8dzag: posts small blind $0.10
sliprywinwet joins the table at seat #7 
fjwM06E3HzjUrynPRQi31Q: posts big blind $0.25
sybren1st: sits out 
*** HOLE CARDS ***
z2SmIaQ3+5n/eY1BN5HgPg: folds 
maurito42 joins the table at seat #1 
Crucial_25 joins the table at seat #9 
DiSvPC2iudwL5j9u6Huyww joins the table at seat #8 
jntAuOS+eFQDYNiDN8dzag: calls $0.15
fjwM06E3HzjUrynPRQi31Q: checks 
*** FLOP *** [8s Ks 7c]
jntAuOS+eFQDYNiDN8dzag: checks 
fjwM06E3HzjUrynPRQi31Q: checks 
*** TURN *** [8s Ks 7c] [4h]
jntAuOS+eFQDYNiDN8dzag: checks 
fjwM06E3HzjUrynPRQi31Q: checks 
*** RIVER *** [8s Ks 7c 4h] [4s]
jntAuOS+eFQDYNiDN8dzag: checks 
fjwM06E3HzjUrynPRQi31Q: bets $1
jntAuOS+eFQDYNiDN8dzag: folds 
Uncalled bet ($1) returned to fjwM06E3HzjUrynPRQi31Q
fjwM06E3HzjUrynPRQi31Q collected $0.50 from pot
fjwM06E3HzjUrynPRQi31Q: doesn't show hand 
*** SUMMARY ***
Total pot $0.50 | Rake $0 
Board [8s Ks 7c 4h 4s]
Seat 2: fjwM06E3HzjUrynPRQi31Q (big blind) collected ($0.50)
Seat 5: z2SmIaQ3+5n/eY1BN5HgPg (button) folded before Flop (didn't bet)
Seat 6: jntAuOS+eFQDYNiDN8dzag (small blind) folded on the River




PokerStars Game #59941748052:  Hold'em No Limit ($0.10/$0.25) - 2009/07/01 1:44:54 ET
Table 'Ez9TB43XM4QgMDQkIW9DYw' 9-max Seat #1 is the button
Seat 1: ShCS62CJp4MKfKLKvGKQbA ($3.80 in chips) 
Seat 2: PFNLAvMkr8qKc7xCiH0wTA ($17.10 in chips) 
Seat 3: PdIasPkzm2sqZnN41ZRXOg ($5 in chips) 
Seat 5: qpG9m8I+cPw8VhB0mnGjYw ($33.15 in chips) 
Seat 6: 76o85YBHJ9veRYp2LPuluQ ($23.25 in chips) 
Seat 7: Bb42QRQMhg5/Y0vHP8/2Xw ($58.45 in chips) 
Seat 8: +2kMBNpY4nF1qNCRd8SJLA ($28.75 in chips) 
Seat 9: QEbIGci+itdw+re8RM5fZA ($25 in chips) 
PFNLAvMkr8qKc7xCiH0wTA: posts small blind $0.10
PdIasPkzm2sqZnN41ZRXOg: posts big blind $0.25
ubsjZomMWSV0hAiBLa7K1A: sits out 
*** HOLE CARDS ***
qpG9m8I+cPw8VhB0mnGjYw: folds 
76o85YBHJ9veRYp2LPuluQ: calls $0.25
Bb42QRQMhg5/Y0vHP8/2Xw: raises $0.75 to $1
+2kMBNpY4nF1qNCRd8SJLA: folds 
QEbIGci+itdw+re8RM5fZA: folds 
ShCS62CJp4MKfKLKvGKQbA: calls $1
PFNLAvMkr8qKc7xCiH0wTA: folds 
PdIasPkzm2sqZnN41ZRXOg: folds 
76o85YBHJ9veRYp2LPuluQ: calls $0.75
*** FLOP *** [Kd Ks 3c]
76o85YBHJ9veRYp2LPuluQ: checks 
Bb42QRQMhg5/Y0vHP8/2Xw: checks 
ShCS62CJp4MKfKLKvGKQbA: checks 
*** TURN *** [Kd Ks 3c] [Jd]
76o85YBHJ9veRYp2LPuluQ: checks 
Bb42QRQMhg5/Y0vHP8/2Xw: bets $1.50
ShCS62CJp4MKfKLKvGKQbA: calls $1.50
76o85YBHJ9veRYp2LPuluQ: calls $1.50
*** RIVER *** [Kd Ks 3c Jd] [Ac]
76o85YBHJ9veRYp2LPuluQ: checks 
Bb42QRQMhg5/Y0vHP8/2Xw: checks 
ShCS62CJp4MKfKLKvGKQbA: bets $1.30 and is all-in
76o85YBHJ9veRYp2LPuluQ: raises $6.70 to $8
Bb42QRQMhg5/Y0vHP8/2Xw: folds 
Uncalled bet ($6.70) returned to 76o85YBHJ9veRYp2LPuluQ
*** SHOW DOWN ***
76o85YBHJ9veRYp2LPuluQ: shows [2c Kc] (three of a kind, Kings)
ShCS62CJp4MKfKLKvGKQbA: shows [Jh Js] (a full house, Jacks full of Kings)
ShCS62CJp4MKfKLKvGKQbA collected $9.95 from pot
*** SUMMARY ***
Total pot $10.45 | Rake $0.50 
Board [Kd Ks 3c Jd Ac]
Seat 1: ShCS62CJp4MKfKLKvGKQbA (button) showed [Jh Js] and won ($9.95) with a full house, Jacks full of Kings
Seat 2: PFNLAvMkr8qKc7xCiH0wTA (small blind) folded before Flop
Seat 3: PdIasPkzm2sqZnN41ZRXOg (big blind) folded before Flop
Seat 5: qpG9m8I+cPw8VhB0mnGjYw folded before Flop (didn't bet)
Seat 6: 76o85YBHJ9veRYp2LPuluQ showed [2c Kc] and lost with three of a kind, Kings
Seat 7: Bb42QRQMhg5/Y0vHP8/2Xw folded on the River
Seat 8: +2kMBNpY4nF1qNCRd8SJLA folded before Flop (didn't bet)
Seat 9: QEbIGci+itdw+re8RM5fZA folded before Flop (didn't bet)




PokerStars Game #59941748004:  Hold'em No Limit ($0.10/$0.25) - 2009/07/01 1:44:54 ET
Table '2O5CgfSkSwrr4PDrlZ1RLQ' 6-max Seat #1 is the button
Seat 1: 3skmHD9EOATKdUzzyHh1KA ($30.20 in chips) 
Seat 2: wqphQtauX5Qn7WRJZS1flA ($24.75 in chips) 
Seat 3: oBUDUfeUyCbZBsjxHZgSiw ($23.60 in chips) 
Seat 5: 0av6tRNdi0Ui4f15L7gsVg ($25 in chips) 
Seat 6: tj9xqoqQaDaFw7u1oyZrtA ($54.45 in chips) 
wqphQtauX5Qn7WRJZS1flA: posts small blind $0.10
oBUDUfeUyCbZBsjxHZgSiw: posts big blind $0.25
epAUIB7h2FJXzUPRIvSkRA: sits out 
*** HOLE CARDS ***
0av6tRNdi0Ui4f15L7gsVg: raises $0.50 to $0.75
tj9xqoqQaDaFw7u1oyZrtA: folds 
3skmHD9EOATKdUzzyHh1KA: calls $0.75
wqphQtauX5Qn7WRJZS1flA: raises $2.25 to $3
oBUDUfeUyCbZBsjxHZgSiw: folds 
0av6tRNdi0Ui4f15L7gsVg: folds 
3skmHD9EOATKdUzzyHh1KA: folds 
Uncalled bet ($2.25) returned to wqphQtauX5Qn7WRJZS1flA
wqphQtauX5Qn7WRJZS1flA collected $2.50 from pot
wqphQtauX5Qn7WRJZS1flA: doesn't show hand 
*** SUMMARY ***
Total pot $2.50 | Rake $0 
Seat 1: 3skmHD9EOATKdUzzyHh1KA (button) folded before Flop
Seat 2: wqphQtauX5Qn7WRJZS1flA (small blind) collected ($2.50)
Seat 3: oBUDUfeUyCbZBsjxHZgSiw (big blind) folded before Flop
Seat 5: 0av6tRNdi0Ui4f15L7gsVg folded before Flop
Seat 6: tj9xqoqQaDaFw7u1oyZrtA folded before Flop (didn't bet)




PokerStars Game #59941748082:  Hold'em No Limit ($0.10/$0.25) - 2009/07/01 1:44:54 ET
Table 'HzFR0rxmDAPu5GzYR0AlYg' 6-max Seat #6 is the button
Seat 1: v+QfkGiuj9bgtuNoVnDO8w ($30.05 in chips) 
Seat 2: UA5OsKS3VPaxa7uC8La/kA ($51.25 in chips) 
Seat 3: kG34n23qFQA3nzdOJTQ1dA ($25.15 in chips) 
Seat 5: lquriepNQBhDV5P1SWHhnA ($29.85 in chips) 
Seat 6: jp34e617tIzV8tKIWmfAbA ($36.30 in chips) 
v+QfkGiuj9bgtuNoVnDO8w: posts small blind $0.10
UA5OsKS3VPaxa7uC8La/kA: posts big blind $0.25
Mhj3q7cxev+XjXZxEE6/Cw: sits out 
*** HOLE CARDS ***
kG34n23qFQA3nzdOJTQ1dA: folds 
lquriepNQBhDV5P1SWHhnA: folds 
jp34e617tIzV8tKIWmfAbA: raises $0.50 to $0.75
v+QfkGiuj9bgtuNoVnDO8w: raises $2 to $2.75
UA5OsKS3VPaxa7uC8La/kA: folds 
jp34e617tIzV8tKIWmfAbA: folds 
Uncalled bet ($2) returned to v+QfkGiuj9bgtuNoVnDO8w
v+QfkGiuj9bgtuNoVnDO8w collected $1.75 from pot
v+QfkGiuj9bgtuNoVnDO8w: doesn't show hand 
*** SUMMARY ***
Total pot $1.75 | Rake $0 
Seat 1: v+QfkGiuj9bgtuNoVnDO8w (small blind) collected ($1.75)
Seat 2: UA5OsKS3VPaxa7uC8La/kA (big blind) folded before Flop
Seat 3: kG34n23qFQA3nzdOJTQ1dA folded before Flop (didn't bet)
Seat 5: lquriepNQBhDV5P1SWHhnA folded before Flop (didn't bet)
Seat 6: jp34e617tIzV8tKIWmfAbA (button) folded before Flop




PokerStars Game #59941748474:  Hold'em No Limit ($0.10/$0.25) - 2009/07/01 1:44:55 ET
Table 'yZgGBnUGXVCcEJdcqes8tw' 9-max Seat #7 is the button
Seat 1: 6RiVTYll/5D8zICp0MRpKw ($28.95 in chips) 
Seat 2: MG90wfSJZnOejs/KD3vlQQ ($25 in chips) 
Seat 4: M2QO2DxB5Wawg2h8HSpnYA ($10 in chips) 
Seat 5: dfNim92Z6XK1/h5SFW5vDg ($25.05 in chips) 
Seat 6: RHqgdFvufLCYe54+qd2gcA ($5 in chips) 
Seat 7: eC8Pn1D6Y2pct8o62nQfvQ ($26.55 in chips) 
Seat 8: dtZ84flFEi4Q+SGrHMJRDQ ($31.65 in chips) 
Seat 9: M/9j4wkHH9i1JM51vgi1VA ($23.75 in chips) 
dtZ84flFEi4Q+SGrHMJRDQ: posts small blind $0.10
M/9j4wkHH9i1JM51vgi1VA: posts big blind $0.25
RHqgdFvufLCYe54+qd2gcA: posts big blind $0.25
*** HOLE CARDS ***
6RiVTYll/5D8zICp0MRpKw: calls $0.25
MG90wfSJZnOejs/KD3vlQQ: folds 
M2QO2DxB5Wawg2h8HSpnYA: folds 
dfNim92Z6XK1/h5SFW5vDg: calls $0.25
RHqgdFvufLCYe54+qd2gcA: checks 
eC8Pn1D6Y2pct8o62nQfvQ: folds 
dtZ84flFEi4Q+SGrHMJRDQ: folds 
M/9j4wkHH9i1JM51vgi1VA: checks 
*** FLOP *** [3s Js 5s]
M/9j4wkHH9i1JM51vgi1VA: checks 
6RiVTYll/5D8zICp0MRpKw: checks 
dfNim92Z6XK1/h5SFW5vDg: bets $1
RHqgdFvufLCYe54+qd2gcA: folds 
M/9j4wkHH9i1JM51vgi1VA: folds 
6RiVTYll/5D8zICp0MRpKw: folds 
Uncalled bet ($1) returned to dfNim92Z6XK1/h5SFW5vDg
dfNim92Z6XK1/h5SFW5vDg collected $1.05 from pot
dfNim92Z6XK1/h5SFW5vDg: doesn't show hand 
*** SUMMARY ***
Total pot $1.10 | Rake $0.05 
Board [3s Js 5s]
Seat 1: 6RiVTYll/5D8zICp0MRpKw folded on the Flop
Seat 2: MG90wfSJZnOejs/KD3vlQQ folded before Flop (didn't bet)
Seat 4: M2QO2DxB5Wawg2h8HSpnYA folded before Flop (didn't bet)
Seat 5: dfNim92Z6XK1/h5SFW5vDg collected ($1.05)
Seat 6: RHqgdFvufLCYe54+qd2gcA folded on the Flop
Seat 7: eC8Pn1D6Y2pct8o62nQfvQ (button) folded before Flop (didn't bet)
Seat 8: dtZ84flFEi4Q+SGrHMJRDQ (small blind) folded before Flop
Seat 9: M/9j4wkHH9i1JM51vgi1VA (big blind) folded on the Flop




PokerStars Game #59941748608:  Hold'em No Limit ($0.10/$0.25) - 2009/07/01 1:44:55 ET
Table '3EebBlzq5yHSY2444L4zlg' 9-max Seat #5 is the button
Seat 1: XMSS6mD5B42I8wasdOMipQ ($29.50 in chips) 
Seat 2: b9UnopCOpq2MWP1DwqSO3Q ($17.95 in chips) 
Seat 3: IGbD5vKNhHe60dkdbjg/mw ($41.45 in chips) 
Seat 5: PFNLAvMkr8qKc7xCiH0wTA ($23.45 in chips) 
Seat 6: QEbIGci+itdw+re8RM5fZA ($50.10 in chips) 
Seat 7: DiSvPC2iudwL5j9u6Huyww ($48.85 in chips) 
Seat 8: dtZ84flFEi4Q+SGrHMJRDQ ($26.90 in chips) 
Seat 9: iZmSlSzYu5fJ67tDdQzymQ ($27.95 in chips) 
QEbIGci+itdw+re8RM5fZA: posts small blind $0.10
DiSvPC2iudwL5j9u6Huyww: posts big blind $0.25
PdIasPkzm2sqZnN41ZRXOg: sits out 
*** HOLE CARDS ***
dtZ84flFEi4Q+SGrHMJRDQ: raises $0.75 to $1
iZmSlSzYu5fJ67tDdQzymQ: calls $1
XMSS6mD5B42I8wasdOMipQ: folds 
b9UnopCOpq2MWP1DwqSO3Q: folds 
IGbD5vKNhHe60dkdbjg/mw: folds 
PFNLAvMkr8qKc7xCiH0wTA: folds 
QEbIGci+itdw+re8RM5fZA: folds 
DiSvPC2iudwL5j9u6Huyww: folds 
*** FLOP *** [4s Ad 2d]
dtZ84flFEi4Q+SGrHMJRDQ: checks 
iZmSlSzYu5fJ67tDdQzymQ: bets $1
dtZ84flFEi4Q+SGrHMJRDQ: calls $1
*** TURN *** [4s Ad 2d] [Kh]
dtZ84flFEi4Q+SGrHMJRDQ: checks 
iZmSlSzYu5fJ67tDdQzymQ: checks 
*** RIVER *** [4s Ad 2d Kh] [9d]
dtZ84flFEi4Q+SGrHMJRDQ: checks 
iZmSlSzYu5fJ67tDdQzymQ: checks 
*** SHOW DOWN ***
dtZ84flFEi4Q+SGrHMJRDQ: shows [Qh Qd] (a pair of Queens)
iZmSlSzYu5fJ67tDdQzymQ: mucks hand 
dtZ84flFEi4Q+SGrHMJRDQ collected $4.15 from pot
*** SUMMARY ***
Total pot $4.35 | Rake $0.20 
Board [4s Ad 2d Kh 9d]
Seat 1: XMSS6mD5B42I8wasdOMipQ folded before Flop (didn't bet)
Seat 2: b9UnopCOpq2MWP1DwqSO3Q folded before Flop (didn't bet)
Seat 3: IGbD5vKNhHe60dkdbjg/mw folded before Flop (didn't bet)
Seat 5: PFNLAvMkr8qKc7xCiH0wTA (button) folded before Flop (didn't bet)
Seat 6: QEbIGci+itdw+re8RM5fZA (small blind) folded before Flop
Seat 7: DiSvPC2iudwL5j9u6Huyww (big blind) folded before Flop
Seat 8: dtZ84flFEi4Q+SGrHMJRDQ showed [Qh Qd] and won ($4.15) with a pair of Queens
Seat 9: iZmSlSzYu5fJ67tDdQzymQ mucked




PokerStars Game #59941748780:  Hold'em No Limit ($0.10/$0.25) - 2009/07/01 1:44:55 ET
Table 'ouLhepGYovxB2x0QxH7cVg' 9-max Seat #8 is the button
Seat 1: ghNKXUBl/H+t83JF079ZBA ($25.35 in chips) 
Seat 2: r1Z5m4PwSI5ANp7qCE1OJw ($18.85 in chips) 
Seat 3: bXpVeaSTPBFSPJmeXxO7nw ($5.25 in chips) 
Seat 4: a0Sx6GHY7ln2Ns2C97eXeA ($38.10 in chips) 
Seat 5: v60REj6f8jzMYT0VsZvaPQ ($10 in chips) 
Seat 7: JRV2PblFtPFz51l0Fwyz8g ($24.25 in chips) 
Seat 8: tLcDklc2rBORNfixyRfVfw ($25 in chips) 
Seat 9: ljemhp25Zg+nlA9DLCIiUw ($25.10 in chips) 
ljemhp25Zg+nlA9DLCIiUw: posts small blind $0.10
ghNKXUBl/H+t83JF079ZBA: posts big blind $0.25
*** HOLE CARDS ***
r1Z5m4PwSI5ANp7qCE1OJw: folds 
bXpVeaSTPBFSPJmeXxO7nw: folds 
a0Sx6GHY7ln2Ns2C97eXeA: folds 
v60REj6f8jzMYT0VsZvaPQ: folds 
JRV2PblFtPFz51l0Fwyz8g: folds 
tLcDklc2rBORNfixyRfVfw: raises $0.75 to $1
ljemhp25Zg+nlA9DLCIiUw: folds 
ghNKXUBl/H+t83JF079ZBA: folds 
Uncalled bet ($0.75) returned to tLcDklc2rBORNfixyRfVfw
tLcDklc2rBORNfixyRfVfw collected $0.60 from pot
tLcDklc2rBORNfixyRfVfw: doesn't show hand 
*** SUMMARY ***
Total pot $0.60 | Rake $0 
Seat 1: ghNKXUBl/H+t83JF079ZBA (big blind) folded before Flop
Seat 2: r1Z5m4PwSI5ANp7qCE1OJw folded before Flop (didn't bet)
Seat 3: bXpVeaSTPBFSPJmeXxO7nw folded before Flop (didn't bet)
Seat 4: a0Sx6GHY7ln2Ns2C97eXeA folded before Flop (didn't bet)
Seat 5: v60REj6f8jzMYT0VsZvaPQ folded before Flop (didn't bet)
Seat 7: JRV2PblFtPFz51l0Fwyz8g folded before Flop (didn't bet)
Seat 8: tLcDklc2rBORNfixyRfVfw (button) collected ($0.60)
Seat 9: ljemhp25Zg+nlA9DLCIiUw (small blind) folded before Flop




PokerStars Game #59941748588:  Hold'em No Limit ($0.10/$0.25) - 2009/07/01 1:44:55 ET
Table 'IIO2q2znuuAXmiZ2qFTcmg' 6-max Seat #5 is the button
Seat 2: cS21pIxRHx5Gt42o7hPZzw ($24.80 in chips) 
Seat 3: L3/N/gliETan8N5Gim5h4Q ($25.35 in chips) 
Seat 4: tSR4329m40dZsN7YOpI9Kw ($56.50 in chips) 
Seat 5: 9U3ZKjCsarN0DjR6mSE8Ug ($15.50 in chips) 
Seat 6: aogAb4Eienxztk8p2v9VVw ($36.85 in chips) 
aogAb4Eienxztk8p2v9VVw: posts small blind $0.10
cS21pIxRHx5Gt42o7hPZzw: posts big blind $0.25
*** HOLE CARDS ***
L3/N/gliETan8N5Gim5h4Q: folds 
tSR4329m40dZsN7YOpI9Kw: folds 
9U3ZKjCsarN0DjR6mSE8Ug: folds 
aogAb4Eienxztk8p2v9VVw: calls $0.15
cS21pIxRHx5Gt42o7hPZzw: checks 
*** FLOP *** [Js 6s 9h]
aogAb4Eienxztk8p2v9VVw: checks 
cS21pIxRHx5Gt42o7hPZzw: checks 
*** TURN *** [Js 6s 9h] [Jc]
aogAb4Eienxztk8p2v9VVw: checks 
cS21pIxRHx5Gt42o7hPZzw: checks 
*** RIVER *** [Js 6s 9h Jc] [9d]
aogAb4Eienxztk8p2v9VVw: bets $0.50
cS21pIxRHx5Gt42o7hPZzw: folds 
Uncalled bet ($0.50) returned to aogAb4Eienxztk8p2v9VVw
aogAb4Eienxztk8p2v9VVw collected $0.50 from pot
aogAb4Eienxztk8p2v9VVw: doesn't show hand 
*** SUMMARY ***
Total pot $0.50 | Rake $0 
Board [Js 6s 9h Jc 9d]
Seat 2: cS21pIxRHx5Gt42o7hPZzw (big blind) folded on the River
Seat 3: L3/N/gliETan8N5Gim5h4Q folded before Flop (didn't bet)
Seat 4: tSR4329m40dZsN7YOpI9Kw folded before Flop (didn't bet)
Seat 5: 9U3ZKjCsarN0DjR6mSE8Ug (button) folded before Flop (didn't bet)
Seat 6: aogAb4Eienxztk8p2v9VVw (small blind) collected ($0.50)




PokerStars Game #59941748500:  Hold'em No Limit ($0.10/$0.25) - 2009/07/01 1:44:55 ET
Table 'ER5H84HUgJx7HyDLnELLeA' 6-max Seat #6 is the button
Seat 1: LJI7A1YgDM7hgh7o56+ReQ ($27.25 in chips) 
Seat 2: buyjetgNT1McXtdaP4zynA ($20.25 in chips) 
Seat 4: vqWjZmdQu/Hxw96/IJTWdQ ($25.60 in chips) 
Seat 5: mfrkWA3PTeYPkbO6hi98Aw ($25.20 in chips) 
Seat 6: 3zD3qLXT1bEffAoWGnc7wg ($51 in chips) 
LJI7A1YgDM7hgh7o56+ReQ: posts small blind $0.10
buyjetgNT1McXtdaP4zynA: posts big blind $0.25
*** HOLE CARDS ***
vqWjZmdQu/Hxw96/IJTWdQ: raises $0.50 to $0.75
mfrkWA3PTeYPkbO6hi98Aw: calls $0.75
3zD3qLXT1bEffAoWGnc7wg: folds 
LJI7A1YgDM7hgh7o56+ReQ: folds 
buyjetgNT1McXtdaP4zynA: calls $0.50
*** FLOP *** [2h Ks 8s]
buyjetgNT1McXtdaP4zynA: checks 
vqWjZmdQu/Hxw96/IJTWdQ: checks 
mfrkWA3PTeYPkbO6hi98Aw: bets $1.75
buyjetgNT1McXtdaP4zynA: folds 
vqWjZmdQu/Hxw96/IJTWdQ: folds 
Uncalled bet ($1.75) returned to mfrkWA3PTeYPkbO6hi98Aw
mfrkWA3PTeYPkbO6hi98Aw collected $2.25 from pot
mfrkWA3PTeYPkbO6hi98Aw: doesn't show hand 
*** SUMMARY ***
Total pot $2.35 | Rake $0.10 
Board [2h Ks 8s]
Seat 1: LJI7A1YgDM7hgh7o56+ReQ (small blind) folded before Flop
Seat 2: buyjetgNT1McXtdaP4zynA (big blind) folded on the Flop
Seat 4: vqWjZmdQu/Hxw96/IJTWdQ folded on the Flop
Seat 5: mfrkWA3PTeYPkbO6hi98Aw collected ($2.25)
Seat 6: 3zD3qLXT1bEffAoWGnc7wg (button) folded before Flop (didn't bet)




PokerStars Game #59941748272:  Hold'em No Limit ($0.10/$0.25) - 2009/07/01 1:44:55 ET
Table '+giHa6FUL6U5/AZnCJEGvQ' 9-max Seat #4 is the button
Seat 4: 10f7J+bM02ZfDHx0PgkNSg ($14.20 in chips) 
Seat 6: GTMnTen6sQSoCpS9sggLbg ($25.45 in chips) 
10f7J+bM02ZfDHx0PgkNSg: posts small blind $0.10
GTMnTen6sQSoCpS9sggLbg: posts big blind $0.25
*** HOLE CARDS ***
10f7J+bM02ZfDHx0PgkNSg: folds 
Uncalled bet ($0.15) returned to GTMnTen6sQSoCpS9sggLbg
GTMnTen6sQSoCpS9sggLbg collected $0.20 from pot
GTMnTen6sQSoCpS9sggLbg: doesn't show hand 
*** SUMMARY ***
Total pot $0.20 | Rake $0 
Seat 4: 10f7J+bM02ZfDHx0PgkNSg (button) (small blind) folded before Flop
Seat 6: GTMnTen6sQSoCpS9sggLbg (big blind) collected ($0.20)




PokerStars Game #59941748678:  Hold'em No Limit ($0.10/$0.25) - 2009/07/01 1:44:55 ET
Table '7/qMNloI0nSXWiX5Y1watA' 9-max Seat #8 is the button
Seat 1: /LyhaB3V6jkgOfXORidqRQ ($7.10 in chips) 
Seat 2: wGigCmBR/9XWkPpvYos3aQ ($26.20 in chips) 
Seat 3: W2YYHvqjaEpRrO7stZkClQ ($4.35 in chips) 
Seat 4: K0LdhPeU31rviEPo6Sv3TA ($8.65 in chips) 
Seat 6: Y3DZ6qQlLeBhixDj4M9vmg ($17.25 in chips) 
Seat 8: ljemhp25Zg+nlA9DLCIiUw ($24.55 in chips) 
Seat 9: dmYlc+1cjwZMJ7wV+Z0rRg ($26.10 in chips) 
dmYlc+1cjwZMJ7wV+Z0rRg: posts small blind $0.10
/LyhaB3V6jkgOfXORidqRQ: posts big blind $0.25
*** HOLE CARDS ***
wGigCmBR/9XWkPpvYos3aQ: folds 
W2YYHvqjaEpRrO7stZkClQ: folds 
K0LdhPeU31rviEPo6Sv3TA: folds 
Y3DZ6qQlLeBhixDj4M9vmg: raises $0.50 to $0.75
ljemhp25Zg+nlA9DLCIiUw: folds 
dmYlc+1cjwZMJ7wV+Z0rRg: folds 
/LyhaB3V6jkgOfXORidqRQ: folds 
Uncalled bet ($0.50) returned to Y3DZ6qQlLeBhixDj4M9vmg
Y3DZ6qQlLeBhixDj4M9vmg collected $0.60 from pot
*** SUMMARY ***
Total pot $0.60 | Rake $0 
Seat 1: /LyhaB3V6jkgOfXORidqRQ (big blind) folded before Flop
Seat 2: wGigCmBR/9XWkPpvYos3aQ folded before Flop (didn't bet)
Seat 3: W2YYHvqjaEpRrO7stZkClQ folded before Flop (didn't bet)
Seat 4: K0LdhPeU31rviEPo6Sv3TA folded before Flop (didn't bet)
Seat 6: Y3DZ6qQlLeBhixDj4M9vmg collected ($0.60)
Seat 8: ljemhp25Zg+nlA9DLCIiUw (button) folded before Flop (didn't bet)
Seat 9: dmYlc+1cjwZMJ7wV+Z0rRg (small blind) folded before Flop




PokerStars Game #59941749290:  Hold'em No Limit ($0.10/$0.25) - 2009/07/01 1:44:56 ET
Table 'NtCSSONEf1zaJo3042tQug' 6-max Seat #4 is the button
Seat 1: KXtdqb+rIMkjc0RvHDksGQ ($35.10 in chips) 
Seat 2: vqWjZmdQu/Hxw96/IJTWdQ ($27.30 in chips) 
Seat 3: 9kUKGKkblnIx3m8rlVol6Q ($15.65 in chips) 
Seat 4: HxD1kB8zCmalQSdWAkKmlg ($28.85 in chips) 
Seat 5: tOAk1Og4mVObMBOfvdDYOw ($30.50 in chips) 
Seat 6: LxehwDpTQ19ph4Qmc78+Pw ($29 in chips) 
tOAk1Og4mVObMBOfvdDYOw: posts small blind $0.10
LxehwDpTQ19ph4Qmc78+Pw: posts big blind $0.25
*** HOLE CARDS ***
KXtdqb+rIMkjc0RvHDksGQ: folds 
vqWjZmdQu/Hxw96/IJTWdQ: folds 
9kUKGKkblnIx3m8rlVol6Q: folds 
HxD1kB8zCmalQSdWAkKmlg: folds 
tOAk1Og4mVObMBOfvdDYOw: folds 
Uncalled bet ($0.15) returned to LxehwDpTQ19ph4Qmc78+Pw
LxehwDpTQ19ph4Qmc78+Pw collected $0.20 from pot
LxehwDpTQ19ph4Qmc78+Pw: doesn't show hand 
*** SUMMARY ***
Total pot $0.20 | Rake $0 
Seat 1: KXtdqb+rIMkjc0RvHDksGQ folded before Flop (didn't bet)
Seat 2: vqWjZmdQu/Hxw96/IJTWdQ folded before Flop (didn't bet)
Seat 3: 9kUKGKkblnIx3m8rlVol6Q folded before Flop (didn't bet)
Seat 4: HxD1kB8zCmalQSdWAkKmlg (button) folded before Flop (didn't bet)
Seat 5: tOAk1Og4mVObMBOfvdDYOw (small blind) folded before Flop
Seat 6: LxehwDpTQ19ph4Qmc78+Pw (big blind) collected ($0.20)




PokerStars Game #59941749270:  Hold'em No Limit ($0.10/$0.25) - 2009/07/01 1:44:56 ET
Table 'fHv1Mk7ZbLjprZTGWKPiEQ' 6-max Seat #5 is the button
Seat 1: OIjOiBfQstWrK/RuXx7zcw ($3 in chips) 
Seat 2: 9U3ZKjCsarN0DjR6mSE8Ug ($15.05 in chips) 
Seat 3: /gJNBeCkWL4o85/jvlZ4BA ($27.15 in chips) 
Seat 4: TSmua8tGK3sTbwi0ynrW9Q ($58.80 in chips) 
Seat 5: LJI7A1YgDM7hgh7o56+ReQ ($26.30 in chips) 
Seat 6: AjG0X+rNtc2W08eph8oqpw ($35.95 in chips) 
AjG0X+rNtc2W08eph8oqpw: posts small blind $0.10
OIjOiBfQstWrK/RuXx7zcw: posts big blind $0.25
*** HOLE CARDS ***
9U3ZKjCsarN0DjR6mSE8Ug: calls $0.25
/gJNBeCkWL4o85/jvlZ4BA: raises $1 to $1.25
TSmua8tGK3sTbwi0ynrW9Q: folds 
LJI7A1YgDM7hgh7o56+ReQ: folds 
AjG0X+rNtc2W08eph8oqpw: calls $1.15
OIjOiBfQstWrK/RuXx7zcw: folds 
9U3ZKjCsarN0DjR6mSE8Ug: folds 
*** FLOP *** [9d Qs Ah]
AjG0X+rNtc2W08eph8oqpw: checks 
/gJNBeCkWL4o85/jvlZ4BA: bets $2.50
AjG0X+rNtc2W08eph8oqpw: calls $2.50
*** TURN *** [9d Qs Ah] [6h]
AjG0X+rNtc2W08eph8oqpw: checks 
/gJNBeCkWL4o85/jvlZ4BA: bets $5
AjG0X+rNtc2W08eph8oqpw: raises $5 to $10
/gJNBeCkWL4o85/jvlZ4BA: calls $5
*** RIVER *** [9d Qs Ah 6h] [5h]
AjG0X+rNtc2W08eph8oqpw: bets $5
/gJNBeCkWL4o85/jvlZ4BA: calls $5
*** SHOW DOWN ***
AjG0X+rNtc2W08eph8oqpw: shows [Qd Ad] (two pair, Aces and Queens)
/gJNBeCkWL4o85/jvlZ4BA: mucks hand 
AjG0X+rNtc2W08eph8oqpw collected $36.20 from pot
*** SUMMARY ***
Total pot $38 | Rake $1.80 
Board [9d Qs Ah 6h 5h]
Seat 1: OIjOiBfQstWrK/RuXx7zcw (big blind) folded before Flop
Seat 2: 9U3ZKjCsarN0DjR6mSE8Ug folded before Flop
Seat 3: /gJNBeCkWL4o85/jvlZ4BA mucked
Seat 4: TSmua8tGK3sTbwi0ynrW9Q folded before Flop (didn't bet)
Seat 5: LJI7A1YgDM7hgh7o56+ReQ (button) folded before Flop (didn't bet)
Seat 6: AjG0X+rNtc2W08eph8oqpw (small blind) showed [Qd Ad] and won ($36.20) with two pair, Aces and Queens




PokerStars Game #59941748868:  Hold'em No Limit ($0.10/$0.25) - 2009/07/01 1:44:56 ET
Table '5SUMWYuPsGiOD0FY0QbgOw' 6-max Seat #3 is the button
Seat 1: SFmT9ZsVopnukjvAzrxTRg ($25 in chips) 
Seat 2: xrf8tAXKQHG99HixCot1Iw ($37.50 in chips) 
Seat 3: MqMK8OWPSY1V4stf1Hy5Jw ($38.45 in chips) 
Seat 4: BV+K0Phf5VBHr7aZPKqbUQ ($25.10 in chips) 
Seat 5: v+QfkGiuj9bgtuNoVnDO8w ($40.40 in chips) 
Seat 6: jA7YMtfNUnAaebB7Lj74EA ($26.20 in chips) 
BV+K0Phf5VBHr7aZPKqbUQ: posts small blind $0.10
v+QfkGiuj9bgtuNoVnDO8w: posts big blind $0.25
*** HOLE CARDS ***
jA7YMtfNUnAaebB7Lj74EA: calls $0.25
SFmT9ZsVopnukjvAzrxTRg: folds 
xrf8tAXKQHG99HixCot1Iw: folds 
MqMK8OWPSY1V4stf1Hy5Jw: folds 
BV+K0Phf5VBHr7aZPKqbUQ: folds 
v+QfkGiuj9bgtuNoVnDO8w: checks 
*** FLOP *** [Jd 8h 3d]
v+QfkGiuj9bgtuNoVnDO8w: checks 
jA7YMtfNUnAaebB7Lj74EA: checks 
*** TURN *** [Jd 8h 3d] [5c]
v+QfkGiuj9bgtuNoVnDO8w: checks 
jA7YMtfNUnAaebB7Lj74EA: checks 
*** RIVER *** [Jd 8h 3d 5c] [8c]
v+QfkGiuj9bgtuNoVnDO8w: checks 
jA7YMtfNUnAaebB7Lj74EA: checks 
*** SHOW DOWN ***
v+QfkGiuj9bgtuNoVnDO8w: shows [Kh 9s] (a pair of Eights)
jA7YMtfNUnAaebB7Lj74EA: mucks hand 
v+QfkGiuj9bgtuNoVnDO8w collected $0.60 from pot
*** SUMMARY ***
Total pot $0.60 | Rake $0 
Board [Jd 8h 3d 5c 8c]
Seat 1: SFmT9ZsVopnukjvAzrxTRg folded before Flop (didn't bet)
Seat 2: xrf8tAXKQHG99HixCot1Iw folded before Flop (didn't bet)
Seat 3: MqMK8OWPSY1V4stf1Hy5Jw (button) folded before Flop (didn't bet)
Seat 4: BV+K0Phf5VBHr7aZPKqbUQ (small blind) folded before Flop
Seat 5: v+QfkGiuj9bgtuNoVnDO8w (big blind) showed [Kh 9s] and won ($0.60) with a pair of Eights
Seat 6: jA7YMtfNUnAaebB7Lj74EA mucked




PokerStars Game #59941749062:  Hold'em No Limit ($0.10/$0.25) - 2009/07/01 1:44:56 ET
Table 'MJ1SB76A4qJrlEa+C5e/8w' 6-max Seat #2 is the button
Seat 1: 0KDZiuXQg6UI9cqBR/AUnQ ($26 in chips) 
Seat 2: UA5OsKS3VPaxa7uC8La/kA ($37.05 in chips) 
Seat 3: DihMHaz4WNETH1bPDe13kA ($32.65 in chips) 
Seat 4: SFmT9ZsVopnukjvAzrxTRg ($27.80 in chips) 
Seat 5: Hsvkc0/G2VV78oVmWYXecw ($5 in chips) 
Seat 6: JFIAqU8lCZ0vWwEl4bdGsg ($30.30 in chips) 
DihMHaz4WNETH1bPDe13kA: posts small blind $0.10
SFmT9ZsVopnukjvAzrxTRg: posts big blind $0.25
*** HOLE CARDS ***
Hsvkc0/G2VV78oVmWYXecw: folds 
JFIAqU8lCZ0vWwEl4bdGsg: folds 
0KDZiuXQg6UI9cqBR/AUnQ is disconnected 
0KDZiuXQg6UI9cqBR/AUnQ is connected 
0KDZiuXQg6UI9cqBR/AUnQ: folds 
UA5OsKS3VPaxa7uC8La/kA: raises $0.50 to $0.75
DihMHaz4WNETH1bPDe13kA: folds 
SFmT9ZsVopnukjvAzrxTRg: folds 
Uncalled bet ($0.50) returned to UA5OsKS3VPaxa7uC8La/kA
UA5OsKS3VPaxa7uC8La/kA collected $0.60 from pot
*** SUMMARY ***
Total pot $0.60 | Rake $0 
Seat 1: 0KDZiuXQg6UI9cqBR/AUnQ folded before Flop (didn't bet)
Seat 2: UA5OsKS3VPaxa7uC8La/kA (button) collected ($0.60)
Seat 3: DihMHaz4WNETH1bPDe13kA (small blind) folded before Flop
Seat 4: SFmT9ZsVopnukjvAzrxTRg (big blind) folded before Flop
Seat 5: Hsvkc0/G2VV78oVmWYXecw folded before Flop (didn't bet)
Seat 6: JFIAqU8lCZ0vWwEl4bdGsg folded before Flop (didn't bet)




PokerStars Game #59941749186:  Hold'em No Limit ($0.10/$0.25) - 2009/07/01 1:44:56 ET
Table 'sJ4KpS2GE5Qrsu1/cFjJUw' 9-max Seat #5 is the button
Seat 1: eDlQ+S+6L4e6gM1dkZhGgQ ($18.70 in chips) 
Seat 2: tYsOBqdU1+x+yFI7zHO7hQ ($31.75 in chips) 
Seat 3: eK8qa6EPcH2zhtbmWSvc9g ($25 in chips) 
Seat 4: npAYqa85pqnzfOK5ukX+BQ ($25 in chips) 
Seat 5: Q/gZC63lfOMr7YhWKPCxoQ ($9.10 in chips) 
Seat 6: OefE+Csvj5KR7ClGf3Hc2g ($4.45 in chips) 
Seat 7: Wi8djHgewBlVhpKWfp7isQ ($7.50 in chips) 
Seat 8: S7Ki0P+0AIGPuIfGJjW0gg ($29.70 in chips) 
Seat 9: 3PmVnC/15cl4oyI1TKIt4g ($4.75 in chips) 
OefE+Csvj5KR7ClGf3Hc2g: posts small blind $0.10
Wi8djHgewBlVhpKWfp7isQ: posts big blind $0.25
*** HOLE CARDS ***
S7Ki0P+0AIGPuIfGJjW0gg: folds 
3PmVnC/15cl4oyI1TKIt4g: folds 
eDlQ+S+6L4e6gM1dkZhGgQ: calls $0.25
tYsOBqdU1+x+yFI7zHO7hQ: folds 
eK8qa6EPcH2zhtbmWSvc9g: folds 
npAYqa85pqnzfOK5ukX+BQ: folds 
Q/gZC63lfOMr7YhWKPCxoQ: calls $0.25
OefE+Csvj5KR7ClGf3Hc2g: folds 
Wi8djHgewBlVhpKWfp7isQ: checks 
*** FLOP *** [Jd 5h 2c]
Wi8djHgewBlVhpKWfp7isQ: bets $1
eDlQ+S+6L4e6gM1dkZhGgQ: folds 
Q/gZC63lfOMr7YhWKPCxoQ: folds 
Uncalled bet ($1) returned to Wi8djHgewBlVhpKWfp7isQ
Wi8djHgewBlVhpKWfp7isQ collected $0.85 from pot
Wi8djHgewBlVhpKWfp7isQ: doesn't show hand 
*** SUMMARY ***
Total pot $0.85 | Rake $0 
Board [Jd 5h 2c]
Seat 1: eDlQ+S+6L4e6gM1dkZhGgQ folded on the Flop
Seat 2: tYsOBqdU1+x+yFI7zHO7hQ folded before Flop (didn't bet)
Seat 3: eK8qa6EPcH2zhtbmWSvc9g folded before Flop (didn't bet)
Seat 4: npAYqa85pqnzfOK5ukX+BQ folded before Flop (didn't bet)
Seat 5: Q/gZC63lfOMr7YhWKPCxoQ (button) folded on the Flop
Seat 6: OefE+Csvj5KR7ClGf3Hc2g (small blind) folded before Flop
Seat 7: Wi8djHgewBlVhpKWfp7isQ (big blind) collected ($0.85)
Seat 8: S7Ki0P+0AIGPuIfGJjW0gg folded before Flop (didn't bet)
Seat 9: 3PmVnC/15cl4oyI1TKIt4g folded before Flop (didn't bet)




PokerStars Game #59941749214:  Hold'em No Limit ($0.10/$0.25) - 2009/07/01 1:44:56 ET
Table 'P1IJQ2p3ACFySC35W1qwQw' 9-max Seat #3 is the button
Seat 1: bXpVeaSTPBFSPJmeXxO7nw ($4.90 in chips) 
Seat 2: vO3QVRovWemcGMkm7ijAIA ($5.35 in chips) 
Seat 3: PVxvfRTRvkgZf9WtquEkwQ ($25 in chips) 
Seat 4: c/9X4zftzphFxYtxp5kp9w ($27.65 in chips) 
Seat 5: ghNKXUBl/H+t83JF079ZBA ($56.45 in chips) 
Seat 6: ljemhp25Zg+nlA9DLCIiUw ($64.45 in chips) 
Seat 7: 7je+LC5Mfs6nL8YBVh4frQ ($5.45 in chips) 
Seat 8: tLcDklc2rBORNfixyRfVfw ($26.60 in chips) 
Seat 9: XXajyXkgbSGJKxQP3mal/Q ($14.90 in chips) 
c/9X4zftzphFxYtxp5kp9w: posts small blind $0.10
ghNKXUBl/H+t83JF079ZBA: posts big blind $0.25
*** HOLE CARDS ***
ljemhp25Zg+nlA9DLCIiUw: folds 
7je+LC5Mfs6nL8YBVh4frQ: folds 
tLcDklc2rBORNfixyRfVfw: folds 
XXajyXkgbSGJKxQP3mal/Q: folds 
bXpVeaSTPBFSPJmeXxO7nw: folds 
vO3QVRovWemcGMkm7ijAIA: folds 
PVxvfRTRvkgZf9WtquEkwQ: folds 
c/9X4zftzphFxYtxp5kp9w: folds 
Uncalled bet ($0.15) returned to ghNKXUBl/H+t83JF079ZBA
ghNKXUBl/H+t83JF079ZBA collected $0.20 from pot
ghNKXUBl/H+t83JF079ZBA: doesn't show hand 
*** SUMMARY ***
Total pot $0.20 | Rake $0 
Seat 1: bXpVeaSTPBFSPJmeXxO7nw folded before Flop (didn't bet)
Seat 2: vO3QVRovWemcGMkm7ijAIA folded before Flop (didn't bet)
Seat 3: PVxvfRTRvkgZf9WtquEkwQ (button) folded before Flop (didn't bet)
Seat 4: c/9X4zftzphFxYtxp5kp9w (small blind) folded before Flop
Seat 5: ghNKXUBl/H+t83JF079ZBA (big blind) collected ($0.20)
Seat 6: ljemhp25Zg+nlA9DLCIiUw folded before Flop (didn't bet)
Seat 7: 7je+LC5Mfs6nL8YBVh4frQ folded before Flop (didn't bet)
Seat 8: tLcDklc2rBORNfixyRfVfw folded before Flop (didn't bet)
Seat 9: XXajyXkgbSGJKxQP3mal/Q folded before Flop (didn't bet)




PokerStars Game #59941748870:  Hold'em No Limit ($0.10/$0.25) - 2009/07/01 1:44:56 ET
Table '2VkNDXXsBj4bSZw/uK5atw' 6-max Seat #1 is the button
Seat 1: xrf8tAXKQHG99HixCot1Iw ($15.80 in chips) 
Seat 2: v6mkGzCBCCXcgWQNSYVtKg ($12.55 in chips) 
Seat 5: 7f0OkhFEOf3T+rVOFHRLnw ($21.55 in chips) 
Seat 6: n6UPMnVR4v8LFP0rWP73Fg ($9.85 in chips) 
v6mkGzCBCCXcgWQNSYVtKg: posts small blind $0.10
7f0OkhFEOf3T+rVOFHRLnw: posts big blind $0.25
*** HOLE CARDS ***
P+6Z5+8H5/Wyt/jHMovNvQ joins the table at seat #3 
n6UPMnVR4v8LFP0rWP73Fg: calls $0.25
4kIRqWKE/N0yUAcWVhLSoQ joins the table at seat #4 
xrf8tAXKQHG99HixCot1Iw: raises $0.75 to $1
v6mkGzCBCCXcgWQNSYVtKg: folds 
7f0OkhFEOf3T+rVOFHRLnw: calls $0.75
n6UPMnVR4v8LFP0rWP73Fg: calls $0.75
*** FLOP *** [Kc 2d As]
7f0OkhFEOf3T+rVOFHRLnw: checks 
n6UPMnVR4v8LFP0rWP73Fg: bets $0.75
xrf8tAXKQHG99HixCot1Iw: folds 
7f0OkhFEOf3T+rVOFHRLnw: calls $0.75
*** TURN *** [Kc 2d As] [8d]
7f0OkhFEOf3T+rVOFHRLnw: checks 
n6UPMnVR4v8LFP0rWP73Fg: checks 
*** RIVER *** [Kc 2d As 8d] [Qd]
7f0OkhFEOf3T+rVOFHRLnw: checks 
n6UPMnVR4v8LFP0rWP73Fg: bets $8.10 and is all-in
7f0OkhFEOf3T+rVOFHRLnw: folds 
Uncalled bet ($8.10) returned to n6UPMnVR4v8LFP0rWP73Fg
n6UPMnVR4v8LFP0rWP73Fg collected $4.40 from pot
n6UPMnVR4v8LFP0rWP73Fg: doesn't show hand 
*** SUMMARY ***
Total pot $4.60 | Rake $0.20 
Board [Kc 2d As 8d Qd]
Seat 1: xrf8tAXKQHG99HixCot1Iw (button) folded on the Flop
Seat 2: v6mkGzCBCCXcgWQNSYVtKg (small blind) folded before Flop
Seat 5: 7f0OkhFEOf3T+rVOFHRLnw (big blind) folded on the River
Seat 6: n6UPMnVR4v8LFP0rWP73Fg collected ($4.40)




PokerStars Game #59941749464:  Hold'em No Limit ($0.10/$0.25) - 2009/07/01 1:44:57 ET
Table 'FBhJjLqab11/gKu8nyB/tw' 9-max Seat #6 is the button
Seat 1: +sbyWwIcFp9kP0bDtMegfQ ($18.10 in chips) 
Seat 2: 1pwQJV/Xr0GWPRefx/78VQ ($28.50 in chips) 
Seat 3: V6p0jQ/RhUsqpHLmXvEX4Q ($9.35 in chips) 
Seat 4: CvL9Ch1HYCVbTsfpNucitg ($5.50 in chips) 
Seat 5: Mh2r9hTeTEDnh19sRZtW3g ($4.65 in chips) 
Seat 6: cZ99hugmLBj9KhTlc8nCSw ($25 in chips) 
Seat 7: CT7Xj/V/O5rBlhtt+RZeFQ ($25 in chips) 
Seat 8: Th3FldXKQW6hWVVPahaoOQ ($25 in chips) 
CT7Xj/V/O5rBlhtt+RZeFQ: posts small blind $0.10
Th3FldXKQW6hWVVPahaoOQ: posts big blind $0.25
*** HOLE CARDS ***
+sbyWwIcFp9kP0bDtMegfQ: folds 
1pwQJV/Xr0GWPRefx/78VQ: calls $0.25
V6p0jQ/RhUsqpHLmXvEX4Q: folds 
CvL9Ch1HYCVbTsfpNucitg: folds 
Mh2r9hTeTEDnh19sRZtW3g: folds 
cZ99hugmLBj9KhTlc8nCSw: folds 
CT7Xj/V/O5rBlhtt+RZeFQ: folds 
Th3FldXKQW6hWVVPahaoOQ: raises $1 to $1.25
1pwQJV/Xr0GWPRefx/78VQ: calls $1
*** FLOP *** [4d 2s 3h]
Th3FldXKQW6hWVVPahaoOQ: bets $1.25
1pwQJV/Xr0GWPRefx/78VQ: calls $1.25
*** TURN *** [4d 2s 3h] [Jh]
Th3FldXKQW6hWVVPahaoOQ: bets $2.50
BKKiMP leaves the table
1pwQJV/Xr0GWPRefx/78VQ: folds 
Uncalled bet ($2.50) returned to Th3FldXKQW6hWVVPahaoOQ
Th3FldXKQW6hWVVPahaoOQ collected $4.85 from pot
Th3FldXKQW6hWVVPahaoOQ: doesn't show hand 
*** SUMMARY ***
Total pot $5.10 | Rake $0.25 
Board [4d 2s 3h Jh]
Seat 1: +sbyWwIcFp9kP0bDtMegfQ folded before Flop (didn't bet)
Seat 2: 1pwQJV/Xr0GWPRefx/78VQ folded on the Turn
Seat 3: V6p0jQ/RhUsqpHLmXvEX4Q folded before Flop (didn't bet)
Seat 4: CvL9Ch1HYCVbTsfpNucitg folded before Flop (didn't bet)
Seat 5: Mh2r9hTeTEDnh19sRZtW3g folded before Flop (didn't bet)
Seat 6: cZ99hugmLBj9KhTlc8nCSw (button) folded before Flop (didn't bet)
Seat 7: CT7Xj/V/O5rBlhtt+RZeFQ (small blind) folded before Flop
Seat 8: Th3FldXKQW6hWVVPahaoOQ (big blind) collected ($4.85)




PokerStars Game #59941749882:  Hold'em No Limit ($0.10/$0.25) - 2009/07/01 1:44:57 ET
Table 'v+LTGPWbrLum+Ggd4ef6lg' 9-max Seat #8 is the button
Seat 1: zUXhymECc2C9W9ZNw6qppA ($9.65 in chips) 
Seat 2: r/xYbgD9yVdKFWRgSQD/+Q ($11.20 in chips) 
Seat 3: 7ovWM9c1nQLTFritEGRG/A ($3.60 in chips) 
Seat 4: bXpVeaSTPBFSPJmeXxO7nw ($9.05 in chips) 
Seat 5: +8OkYWUhGfkDbAtQl/ovYQ ($31.55 in chips) 
Seat 7: kUxTO3D2eQcx4oJIpJAK4Q ($7.35 in chips) 
Seat 8: +sbyWwIcFp9kP0bDtMegfQ ($32.25 in chips) 
Seat 9: cZ99hugmLBj9KhTlc8nCSw ($25 in chips) 
cZ99hugmLBj9KhTlc8nCSw: posts small blind $0.10
zUXhymECc2C9W9ZNw6qppA: posts big blind $0.25
+qc/EYCgLC65SpGvr35eNg: sits out 
*** HOLE CARDS ***
r/xYbgD9yVdKFWRgSQD/+Q: folds 
7ovWM9c1nQLTFritEGRG/A: calls $0.25
bXpVeaSTPBFSPJmeXxO7nw: folds 
+8OkYWUhGfkDbAtQl/ovYQ: raises $0.75 to $1
kUxTO3D2eQcx4oJIpJAK4Q: folds 
+sbyWwIcFp9kP0bDtMegfQ: calls $1
cZ99hugmLBj9KhTlc8nCSw: folds 
zUXhymECc2C9W9ZNw6qppA: folds 
7ovWM9c1nQLTFritEGRG/A: folds 
*** FLOP *** [3h Kd 4s]
+8OkYWUhGfkDbAtQl/ovYQ: checks 
+sbyWwIcFp9kP0bDtMegfQ: checks 
*** TURN *** [3h Kd 4s] [5d]
+8OkYWUhGfkDbAtQl/ovYQ: bets $0.25
+sbyWwIcFp9kP0bDtMegfQ: raises $2.75 to $3
+8OkYWUhGfkDbAtQl/ovYQ: calls $2.75
*** RIVER *** [3h Kd 4s 5d] [Qc]
+8OkYWUhGfkDbAtQl/ovYQ: bets $0.25
+sbyWwIcFp9kP0bDtMegfQ: raises $5 to $5.25
+8OkYWUhGfkDbAtQl/ovYQ: calls $5
*** SHOW DOWN ***
+sbyWwIcFp9kP0bDtMegfQ: shows [4d 4h] (three of a kind, Fours)
+8OkYWUhGfkDbAtQl/ovYQ: mucks hand 
+8OkYWUhGfkDbAtQl/ovYQ said, "nh"
+sbyWwIcFp9kP0bDtMegfQ collected $18.20 from pot
*** SUMMARY ***
Total pot $19.10 | Rake $0.90 
Board [3h Kd 4s 5d Qc]
Seat 1: zUXhymECc2C9W9ZNw6qppA (big blind) folded before Flop
Seat 2: r/xYbgD9yVdKFWRgSQD/+Q folded before Flop (didn't bet)
Seat 3: 7ovWM9c1nQLTFritEGRG/A folded before Flop
Seat 4: bXpVeaSTPBFSPJmeXxO7nw folded before Flop (didn't bet)
Seat 5: +8OkYWUhGfkDbAtQl/ovYQ mucked
Seat 7: kUxTO3D2eQcx4oJIpJAK4Q folded before Flop (didn't bet)
Seat 8: +sbyWwIcFp9kP0bDtMegfQ (button) showed [4d 4h] and won ($18.20) with three of a kind, Fours
Seat 9: cZ99hugmLBj9KhTlc8nCSw (small blind) folded before Flop




PokerStars Game #59941749428:  Hold'em No Limit ($0.10/$0.25) - 2009/07/01 1:44:57 ET
Table 'n8mNkPYbe1AIQEkioNesZA' 9-max Seat #6 is the button
Seat 1: 9lvO/qyU+xrU95Teu1fv0g ($5.55 in chips) 
Seat 2: QEbIGci+itdw+re8RM5fZA ($28.05 in chips) 
Seat 4: zgi+EUykT/pZQpoUG6+oEg ($5 in chips) 
Seat 5: wGigCmBR/9XWkPpvYos3aQ ($28.40 in chips) 
Seat 6: HPEB+AtKw1+C/cxU0o1ciw ($46.55 in chips) 
Seat 8: aNpwfA31EREwO+ar4XzBCw ($28.35 in chips) 
Seat 9: gehe91e0IyVT0QU/XBkEyg ($27.90 in chips) 
vNfw/x/HNt0WgQC8SveThg will be allowed to play after the button
aNpwfA31EREwO+ar4XzBCw: posts small blind $0.10
gehe91e0IyVT0QU/XBkEyg: posts big blind $0.25
*** HOLE CARDS ***
9lvO/qyU+xrU95Teu1fv0g: folds 
zDrucyjVn5aeekNEc3cJrA has returned
QEbIGci+itdw+re8RM5fZA: folds 
zgi+EUykT/pZQpoUG6+oEg: folds 
wGigCmBR/9XWkPpvYos3aQ: folds 
HPEB+AtKw1+C/cxU0o1ciw: folds 
aNpwfA31EREwO+ar4XzBCw: folds 
Uncalled bet ($0.15) returned to gehe91e0IyVT0QU/XBkEyg
gehe91e0IyVT0QU/XBkEyg collected $0.20 from pot
gehe91e0IyVT0QU/XBkEyg: doesn't show hand 
*** SUMMARY ***
Total pot $0.20 | Rake $0 
Seat 1: 9lvO/qyU+xrU95Teu1fv0g folded before Flop (didn't bet)
Seat 2: QEbIGci+itdw+re8RM5fZA folded before Flop (didn't bet)
Seat 4: zgi+EUykT/pZQpoUG6+oEg folded before Flop (didn't bet)
Seat 5: wGigCmBR/9XWkPpvYos3aQ folded before Flop (didn't bet)
Seat 6: HPEB+AtKw1+C/cxU0o1ciw (button) folded before Flop (didn't bet)
Seat 8: aNpwfA31EREwO+ar4XzBCw (small blind) folded before Flop
Seat 9: gehe91e0IyVT0QU/XBkEyg (big blind) collected ($0.20)




PokerStars Game #59941750238:  Hold'em No Limit ($0.10/$0.25) - 2009/07/01 1:44:58 ET
Table '84TjTrgbsYZladOc4PWf4Q' 6-max Seat #2 is the button
Seat 1: /kW0t5kKllzd8HO2uEapHQ ($20.70 in chips) 
Seat 2: RpaEX9P7BCvyfPRLiRNg0A ($42.95 in chips) 
Seat 3: Ar4vsUIUfJ7gbYh1c1m59g ($12.10 in chips) 
Seat 4: SxIIgwXYLkwd6m3wLyPTCw ($25 in chips) 
Seat 5: cezpHJ8FB07dj0xG+LhOvw ($26.85 in chips) 
Seat 6: wCUaomJ6Nq5zomVGdUHP+w ($18.50 in chips) 
Ar4vsUIUfJ7gbYh1c1m59g: posts small blind $0.10
SxIIgwXYLkwd6m3wLyPTCw: posts big blind $0.25
*** HOLE CARDS ***
cezpHJ8FB07dj0xG+LhOvw: folds 
wCUaomJ6Nq5zomVGdUHP+w: calls $0.25
/kW0t5kKllzd8HO2uEapHQ: calls $0.25
RpaEX9P7BCvyfPRLiRNg0A: raises $1 to $1.25
Ar4vsUIUfJ7gbYh1c1m59g: calls $1.15
SxIIgwXYLkwd6m3wLyPTCw: folds 
wCUaomJ6Nq5zomVGdUHP+w: folds 
/kW0t5kKllzd8HO2uEapHQ: folds 
*** FLOP *** [6d Ah 7d]
Ar4vsUIUfJ7gbYh1c1m59g: checks 
RpaEX9P7BCvyfPRLiRNg0A: bets $2
Ar4vsUIUfJ7gbYh1c1m59g: folds 
Uncalled bet ($2) returned to RpaEX9P7BCvyfPRLiRNg0A
RpaEX9P7BCvyfPRLiRNg0A collected $3.10 from pot
*** SUMMARY ***
Total pot $3.25 | Rake $0.15 
Board [6d Ah 7d]
Seat 1: /kW0t5kKllzd8HO2uEapHQ folded before Flop
Seat 2: RpaEX9P7BCvyfPRLiRNg0A (button) collected ($3.10)
Seat 3: Ar4vsUIUfJ7gbYh1c1m59g (small blind) folded on the Flop
Seat 4: SxIIgwXYLkwd6m3wLyPTCw (big blind) folded before Flop
Seat 5: cezpHJ8FB07dj0xG+LhOvw folded before Flop (didn't bet)
Seat 6: wCUaomJ6Nq5zomVGdUHP+w folded before Flop




PokerStars Game #59941750130:  Hold'em No Limit ($0.10/$0.25) - 2009/07/01 1:44:58 ET
Table 'o0CDOvKO/bn1WjeymDrXfA' 6-max Seat #3 is the button
Seat 1: if4dh6jhJXeN3/qd3qCp9g ($24.65 in chips) 
Seat 2: uAJL+E2git8iAiFyAvVOnw ($5.85 in chips) 
Seat 3: OtVWmpxX2/9L8bb1GSKTuA ($18.40 in chips) 
Seat 4: L3/N/gliETan8N5Gim5h4Q ($25 in chips) 
Seat 5: dOIoLBxmpLHSXBN9LZnf0Q ($40 in chips) 
Seat 6: SS/yfeArhULzIcOPe8MdPg ($25 in chips) 
L3/N/gliETan8N5Gim5h4Q: posts small blind $0.10
dOIoLBxmpLHSXBN9LZnf0Q: posts big blind $0.25
*** HOLE CARDS ***
SS/yfeArhULzIcOPe8MdPg: folds 
if4dh6jhJXeN3/qd3qCp9g: folds 
uAJL+E2git8iAiFyAvVOnw is disconnected 
uAJL+E2git8iAiFyAvVOnw has timed out while disconnected
uAJL+E2git8iAiFyAvVOnw: folds 
uAJL+E2git8iAiFyAvVOnw is sitting out
OtVWmpxX2/9L8bb1GSKTuA: raises $0.50 to $0.75
L3/N/gliETan8N5Gim5h4Q: folds 
dOIoLBxmpLHSXBN9LZnf0Q: calls $0.50
*** FLOP *** [7c 6s Qs]
L3/N/gliETan8N5Gim5h4Q leaves the table
dOIoLBxmpLHSXBN9LZnf0Q: checks 
OtVWmpxX2/9L8bb1GSKTuA: bets $0.75
dOIoLBxmpLHSXBN9LZnf0Q: calls $0.75
*** TURN *** [7c 6s Qs] [3s]
dOIoLBxmpLHSXBN9LZnf0Q: checks 
OtVWmpxX2/9L8bb1GSKTuA: bets $1
dOIoLBxmpLHSXBN9LZnf0Q: calls $1
*** RIVER *** [7c 6s Qs 3s] [8d]
dOIoLBxmpLHSXBN9LZnf0Q: checks 
OtVWmpxX2/9L8bb1GSKTuA: bets $1.25
dOIoLBxmpLHSXBN9LZnf0Q: calls $1.25
*** SHOW DOWN ***
OtVWmpxX2/9L8bb1GSKTuA: shows [Ts Qh] (a pair of Queens)
dOIoLBxmpLHSXBN9LZnf0Q: mucks hand 
OtVWmpxX2/9L8bb1GSKTuA collected $7.25 from pot
*** SUMMARY ***
Total pot $7.60 | Rake $0.35 
Board [7c 6s Qs 3s 8d]
Seat 1: if4dh6jhJXeN3/qd3qCp9g folded before Flop (didn't bet)
Seat 2: uAJL+E2git8iAiFyAvVOnw folded before Flop (didn't bet)
Seat 3: OtVWmpxX2/9L8bb1GSKTuA (button) showed [Ts Qh] and won ($7.25) with a pair of Queens
Seat 4: L3/N/gliETan8N5Gim5h4Q (small blind) folded before Flop
Seat 5: dOIoLBxmpLHSXBN9LZnf0Q (big blind) mucked
Seat 6: SS/yfeArhULzIcOPe8MdPg folded before Flop (didn't bet)




PokerStars Game #59941750100:  Hold'em No Limit ($0.10/$0.25) - 2009/07/01 1:44:58 ET
Table 'AJGgX1ZYM8d68SWMvaLttg' 6-max Seat #6 is the button
Seat 2: zHHLkD2sRljslKKeQv/ZQw ($28.95 in chips) 
Seat 3: 8ClCHtFXGNplITm+63KB+Q ($39.05 in chips) 
Seat 5: Hsvkc0/G2VV78oVmWYXecw ($5 in chips) 
Seat 6: UA5OsKS3VPaxa7uC8La/kA ($63.05 in chips) 
zHHLkD2sRljslKKeQv/ZQw: posts small blind $0.10
8ClCHtFXGNplITm+63KB+Q: posts big blind $0.25
*** HOLE CARDS ***
Hsvkc0/G2VV78oVmWYXecw: folds 
e30C3DfdG5TfPnR16/oMmA joins the table at seat #4 
UA5OsKS3VPaxa7uC8La/kA: raises $0.50 to $0.75
zHHLkD2sRljslKKeQv/ZQw: calls $0.65
8ClCHtFXGNplITm+63KB+Q: folds 
*** FLOP *** [Jh Jc 2h]
zHHLkD2sRljslKKeQv/ZQw: checks 
UA5OsKS3VPaxa7uC8La/kA: bets $1
zHHLkD2sRljslKKeQv/ZQw: folds 
Uncalled bet ($1) returned to UA5OsKS3VPaxa7uC8La/kA
UA5OsKS3VPaxa7uC8La/kA collected $1.70 from pot
*** SUMMARY ***
Total pot $1.75 | Rake $0.05 
Board [Jh Jc 2h]
Seat 2: zHHLkD2sRljslKKeQv/ZQw (small blind) folded on the Flop
Seat 3: 8ClCHtFXGNplITm+63KB+Q (big blind) folded before Flop
Seat 5: Hsvkc0/G2VV78oVmWYXecw folded before Flop (didn't bet)
Seat 6: UA5OsKS3VPaxa7uC8La/kA (button) collected ($1.70)




PokerStars Game #59941750308:  Hold'em No Limit ($0.10/$0.25) - 2009/07/01 1:44:58 ET
Table 'nyTW9cVtYentc5V7xU/0jA' 6-max Seat #1 is the button
Seat 1: HI20pVxSHPZ29u9IDkmICg ($12.60 in chips) 
Seat 2: v6mkGzCBCCXcgWQNSYVtKg ($5.90 in chips) 
Seat 3: kG34n23qFQA3nzdOJTQ1dA ($36.10 in chips) 
Seat 4: NkB3D4eVHHXvB9Edaugc1Q ($31.95 in chips) 
Seat 5: zZAcuQ0EvirdEuiIbeaocQ ($6.75 in chips) 
v6mkGzCBCCXcgWQNSYVtKg: posts small blind $0.10
kG34n23qFQA3nzdOJTQ1dA: posts big blind $0.25
zZAcuQ0EvirdEuiIbeaocQ: posts small & big blinds $0.35
*** HOLE CARDS ***
NkB3D4eVHHXvB9Edaugc1Q: folds 
zZAcuQ0EvirdEuiIbeaocQ: checks 
HI20pVxSHPZ29u9IDkmICg: calls $0.25
v6mkGzCBCCXcgWQNSYVtKg: folds 
kG34n23qFQA3nzdOJTQ1dA: checks 
*** FLOP *** [7h Qc 5h]
kG34n23qFQA3nzdOJTQ1dA: checks 
zZAcuQ0EvirdEuiIbeaocQ: bets $0.75
HI20pVxSHPZ29u9IDkmICg: folds 
kG34n23qFQA3nzdOJTQ1dA: folds 
Uncalled bet ($0.75) returned to zZAcuQ0EvirdEuiIbeaocQ
zZAcuQ0EvirdEuiIbeaocQ collected $0.95 from pot
zZAcuQ0EvirdEuiIbeaocQ: doesn't show hand 
*** SUMMARY ***
Total pot $0.95 | Rake $0 
Board [7h Qc 5h]
Seat 1: HI20pVxSHPZ29u9IDkmICg (button) folded on the Flop
Seat 2: v6mkGzCBCCXcgWQNSYVtKg (small blind) folded before Flop
Seat 3: kG34n23qFQA3nzdOJTQ1dA (big blind) folded on the Flop
Seat 4: NkB3D4eVHHXvB9Edaugc1Q folded before Flop (didn't bet)
Seat 5: zZAcuQ0EvirdEuiIbeaocQ collected ($0.95)




PokerStars Game #59941750712:  Hold'em No Limit ($0.10/$0.25) - 2009/07/01 1:44:59 ET
Table 'djcjiEGabFQO0MNG6jEeJQ' 9-max Seat #2 is the button
Seat 1: Bb42QRQMhg5/Y0vHP8/2Xw ($25.60 in chips) 
Seat 2: WKL8nUFr7TumC4EjLyqYzw ($5.25 in chips) 
Seat 3: zgi+EUykT/pZQpoUG6+oEg ($4.75 in chips) 
Seat 4: 2wcFsZsqEP5w1StUTVzJCg ($9.55 in chips) 
Seat 5: cZ99hugmLBj9KhTlc8nCSw ($42 in chips) 
Seat 6: aNpwfA31EREwO+ar4XzBCw ($74 in chips) 
Seat 7: 56S3mA6Zs3pGR+0p0vUCtg ($35.05 in chips) 
Seat 8: +sbyWwIcFp9kP0bDtMegfQ ($51.25 in chips) 
Seat 9: HPEB+AtKw1+C/cxU0o1ciw ($46.85 in chips) 
zgi+EUykT/pZQpoUG6+oEg: posts small blind $0.10
2wcFsZsqEP5w1StUTVzJCg: posts big blind $0.25
*** HOLE CARDS ***
cZ99hugmLBj9KhTlc8nCSw: folds 
cZ99hugmLBj9KhTlc8nCSw leaves the table
aNpwfA31EREwO+ar4XzBCw: folds 
56S3mA6Zs3pGR+0p0vUCtg: folds 
+sbyWwIcFp9kP0bDtMegfQ: folds 
HPEB+AtKw1+C/cxU0o1ciw: folds 
Bb42QRQMhg5/Y0vHP8/2Xw: folds 
WKL8nUFr7TumC4EjLyqYzw: folds 
zgi+EUykT/pZQpoUG6+oEg: folds 
Uncalled bet ($0.15) returned to 2wcFsZsqEP5w1StUTVzJCg
2wcFsZsqEP5w1StUTVzJCg collected $0.20 from pot
*** SUMMARY ***
Total pot $0.20 | Rake $0 
Seat 1: Bb42QRQMhg5/Y0vHP8/2Xw folded before Flop (didn't bet)
Seat 2: WKL8nUFr7TumC4EjLyqYzw (button) folded before Flop (didn't bet)
Seat 3: zgi+EUykT/pZQpoUG6+oEg (small blind) folded before Flop
Seat 4: 2wcFsZsqEP5w1StUTVzJCg (big blind) collected ($0.20)
Seat 5: cZ99hugmLBj9KhTlc8nCSw folded before Flop (didn't bet)
Seat 6: aNpwfA31EREwO+ar4XzBCw folded before Flop (didn't bet)
Seat 7: 56S3mA6Zs3pGR+0p0vUCtg folded before Flop (didn't bet)
Seat 8: +sbyWwIcFp9kP0bDtMegfQ folded before Flop (didn't bet)
Seat 9: HPEB+AtKw1+C/cxU0o1ciw folded before Flop (didn't bet)




PokerStars Game #59941750574:  Hold'em No Limit ($0.10/$0.25) - 2009/07/01 1:44:59 ET
Table '1zj0+miaIL9cvwnT/50pOA' 9-max Seat #3 is the button
Seat 1: PVxvfRTRvkgZf9WtquEkwQ ($25.35 in chips) 
Seat 2: HPEB+AtKw1+C/cxU0o1ciw ($42.95 in chips) 
Seat 3: dtZ84flFEi4Q+SGrHMJRDQ ($28.25 in chips) 
Seat 4: PdIasPkzm2sqZnN41ZRXOg ($4.75 in chips) 
Seat 5: 57qrNGHDvf6GhB8zVLsAtQ ($4.35 in chips) 
Seat 6: YZaC69gFrepA6oCGtu7E0w ($29.55 in chips) 
Seat 7: 6RiVTYll/5D8zICp0MRpKw ($23.90 in chips) 
Seat 8: Ihhh49x48fayPIyvl2Rsmg ($35.10 in chips) 
Seat 9: AyqFvLFzJDE7yMbXP362BA ($26.90 in chips) 
PdIasPkzm2sqZnN41ZRXOg: posts small blind $0.10
57qrNGHDvf6GhB8zVLsAtQ: posts big blind $0.25
*** HOLE CARDS ***
YZaC69gFrepA6oCGtu7E0w: folds 
6RiVTYll/5D8zICp0MRpKw: folds 
Ihhh49x48fayPIyvl2Rsmg: folds 
AyqFvLFzJDE7yMbXP362BA: raises $0.50 to $0.75
PVxvfRTRvkgZf9WtquEkwQ: folds 
HPEB+AtKw1+C/cxU0o1ciw: folds 
dtZ84flFEi4Q+SGrHMJRDQ: raises $1.50 to $2.25
PdIasPkzm2sqZnN41ZRXOg: folds 
57qrNGHDvf6GhB8zVLsAtQ: folds 
AyqFvLFzJDE7yMbXP362BA: folds 
Uncalled bet ($1.50) returned to dtZ84flFEi4Q+SGrHMJRDQ
dtZ84flFEi4Q+SGrHMJRDQ collected $1.85 from pot
dtZ84flFEi4Q+SGrHMJRDQ: doesn't show hand 
*** SUMMARY ***
Total pot $1.85 | Rake $0 
Seat 1: PVxvfRTRvkgZf9WtquEkwQ folded before Flop (didn't bet)
Seat 2: HPEB+AtKw1+C/cxU0o1ciw folded before Flop (didn't bet)
Seat 3: dtZ84flFEi4Q+SGrHMJRDQ (button) collected ($1.85)
Seat 4: PdIasPkzm2sqZnN41ZRXOg (small blind) folded before Flop
Seat 5: 57qrNGHDvf6GhB8zVLsAtQ (big blind) folded before Flop
Seat 6: YZaC69gFrepA6oCGtu7E0w folded before Flop (didn't bet)
Seat 7: 6RiVTYll/5D8zICp0MRpKw folded before Flop (didn't bet)
Seat 8: Ihhh49x48fayPIyvl2Rsmg folded before Flop (didn't bet)
Seat 9: AyqFvLFzJDE7yMbXP362BA folded before Flop




PokerStars Game #59941750838:  Hold'em No Limit ($0.10/$0.25) - 2009/07/01 1:44:59 ET
Table 'jz4TpuH+ag+0iNe2ZcxckQ' 9-max Seat #5 is the button
Seat 1: +C3eP/ysyROWbEXJFPswVA ($25 in chips) 
Seat 2: clJsV3v77RS07bDKY+705w ($5 in chips) 
Seat 3: egvg3mTBBVzMHnJPIQiKcA ($14.10 in chips) 
Seat 4: k+2r6di6GXjNpAdrRkW9bA ($59.65 in chips) 
Seat 5: v1BVHNGLbP/nx7QO6K7+Jw ($29.90 in chips) 
Seat 6: gO1uiTGTzn5Cd3PECuws1g ($13.75 in chips) 
Seat 7: tLcDklc2rBORNfixyRfVfw ($32 in chips) 
Seat 8: uhrboV251dcgYniYTdFIcA ($25 in chips) 
Seat 9: W2YYHvqjaEpRrO7stZkClQ ($5.80 in chips) 
gO1uiTGTzn5Cd3PECuws1g: posts small blind $0.10
tLcDklc2rBORNfixyRfVfw: posts big blind $0.25
*** HOLE CARDS ***
uhrboV251dcgYniYTdFIcA: folds 
W2YYHvqjaEpRrO7stZkClQ: folds 
+C3eP/ysyROWbEXJFPswVA: raises $0.50 to $0.75
clJsV3v77RS07bDKY+705w: folds 
egvg3mTBBVzMHnJPIQiKcA: folds 
k+2r6di6GXjNpAdrRkW9bA: folds 
v1BVHNGLbP/nx7QO6K7+Jw: raises $0.50 to $1.25
gO1uiTGTzn5Cd3PECuws1g: folds 
tLcDklc2rBORNfixyRfVfw: folds 
+C3eP/ysyROWbEXJFPswVA: raises $2.75 to $4
v1BVHNGLbP/nx7QO6K7+Jw: calls $2.75
*** FLOP *** [3d 8h Ks]
+C3eP/ysyROWbEXJFPswVA: bets $4
v1BVHNGLbP/nx7QO6K7+Jw: calls $4
*** TURN *** [3d 8h Ks] [6c]
+C3eP/ysyROWbEXJFPswVA: checks 
v1BVHNGLbP/nx7QO6K7+Jw: bets $12.75
+C3eP/ysyROWbEXJFPswVA: folds 
Uncalled bet ($12.75) returned to v1BVHNGLbP/nx7QO6K7+Jw
v1BVHNGLbP/nx7QO6K7+Jw collected $15.60 from pot
v1BVHNGLbP/nx7QO6K7+Jw: doesn't show hand 
*** SUMMARY ***
Total pot $16.35 | Rake $0.75 
Board [3d 8h Ks 6c]
Seat 1: +C3eP/ysyROWbEXJFPswVA folded on the Turn
Seat 2: clJsV3v77RS07bDKY+705w folded before Flop (didn't bet)
Seat 3: egvg3mTBBVzMHnJPIQiKcA folded before Flop (didn't bet)
Seat 4: k+2r6di6GXjNpAdrRkW9bA folded before Flop (didn't bet)
Seat 5: v1BVHNGLbP/nx7QO6K7+Jw (button) collected ($15.60)
Seat 6: gO1uiTGTzn5Cd3PECuws1g (small blind) folded before Flop
Seat 7: tLcDklc2rBORNfixyRfVfw (big blind) folded before Flop
Seat 8: uhrboV251dcgYniYTdFIcA folded before Flop (didn't bet)
Seat 9: W2YYHvqjaEpRrO7stZkClQ folded before Flop (didn't bet)




PokerStars Game #59941750796:  Hold'em No Limit ($0.10/$0.25) - 2009/07/01 1:44:59 ET
Table 'nc6OeGk/wtaWV+6N+kgnZQ' 6-max Seat #4 is the button
Seat 1: tSR4329m40dZsN7YOpI9Kw ($39 in chips) 
Seat 2: 8ClCHtFXGNplITm+63KB+Q ($34.75 in chips) 
Seat 3: y8wpMWGSX2zHZijurx21mg ($7.10 in chips) 
Seat 4: 3zD3qLXT1bEffAoWGnc7wg ($29.60 in chips) 
Seat 5: HCS0lMAAPmZE2Tl8J/SuKw ($10.95 in chips) 
Seat 6: mFv3iBCtrw9XfCDRB0d46Q ($3.55 in chips) 
HCS0lMAAPmZE2Tl8J/SuKw: posts small blind $0.10
mFv3iBCtrw9XfCDRB0d46Q: posts big blind $0.25
*** HOLE CARDS ***
tSR4329m40dZsN7YOpI9Kw: raises $0.50 to $0.75
8ClCHtFXGNplITm+63KB+Q: folds 
y8wpMWGSX2zHZijurx21mg: folds 
3zD3qLXT1bEffAoWGnc7wg: calls $0.75
HCS0lMAAPmZE2Tl8J/SuKw: folds 
mFv3iBCtrw9XfCDRB0d46Q: folds 
*** FLOP *** [Td 2h Ac]
tSR4329m40dZsN7YOpI9Kw: bets $1
3zD3qLXT1bEffAoWGnc7wg: raises $1.75 to $2.75
tSR4329m40dZsN7YOpI9Kw: folds 
Uncalled bet ($1.75) returned to 3zD3qLXT1bEffAoWGnc7wg
3zD3qLXT1bEffAoWGnc7wg collected $3.70 from pot
3zD3qLXT1bEffAoWGnc7wg: doesn't show hand 
*** SUMMARY ***
Total pot $3.85 | Rake $0.15 
Board [Td 2h Ac]
Seat 1: tSR4329m40dZsN7YOpI9Kw folded on the Flop
Seat 2: 8ClCHtFXGNplITm+63KB+Q folded before Flop (didn't bet)
Seat 3: y8wpMWGSX2zHZijurx21mg folded before Flop (didn't bet)
Seat 4: 3zD3qLXT1bEffAoWGnc7wg (button) collected ($3.70)
Seat 5: HCS0lMAAPmZE2Tl8J/SuKw (small blind) folded before Flop
Seat 6: mFv3iBCtrw9XfCDRB0d46Q (big blind) folded before Flop




PokerStars Game #59941751306:  Hold'em No Limit ($0.10/$0.25) - 2009/07/01 1:45:00 ET
Table 'SHi8+hK6i7E2dJ/3Agbyig' 6-max Seat #2 is the button
Seat 1: gPEN9Zp33YTm/mu9/SYP1w ($24.65 in chips) 
Seat 2: LJI7A1YgDM7hgh7o56+ReQ ($28.45 in chips) 
Seat 3: P1Z7LWu+VU+WmJsI4mr0wA ($23.75 in chips) 
Seat 4: u0ikXOhAPSCLmg+l17oGRw ($10.50 in chips) 
Seat 5: v8m8XHovI5tqEA9mvplDSw ($53.45 in chips) 
Seat 6: cWc85bEzdRzpUMhRKm8pwQ ($32.30 in chips) 
P1Z7LWu+VU+WmJsI4mr0wA: posts small blind $0.10
u0ikXOhAPSCLmg+l17oGRw: posts big blind $0.25
*** HOLE CARDS ***
v8m8XHovI5tqEA9mvplDSw: raises $0.50 to $0.75
cWc85bEzdRzpUMhRKm8pwQ: folds 
gPEN9Zp33YTm/mu9/SYP1w: calls $0.75
LJI7A1YgDM7hgh7o56+ReQ: folds 
P1Z7LWu+VU+WmJsI4mr0wA: calls $0.65
u0ikXOhAPSCLmg+l17oGRw: calls $0.50
*** FLOP *** [Tc 5c Jh]
P1Z7LWu+VU+WmJsI4mr0wA: checks 
u0ikXOhAPSCLmg+l17oGRw: checks 
v8m8XHovI5tqEA9mvplDSw: checks 
gPEN9Zp33YTm/mu9/SYP1w: checks 
*** TURN *** [Tc 5c Jh] [Kd]
P1Z7LWu+VU+WmJsI4mr0wA: checks 
u0ikXOhAPSCLmg+l17oGRw: checks 
v8m8XHovI5tqEA9mvplDSw: checks 
gPEN9Zp33YTm/mu9/SYP1w: checks 
*** RIVER *** [Tc 5c Jh Kd] [7s]
P1Z7LWu+VU+WmJsI4mr0wA: checks 
u0ikXOhAPSCLmg+l17oGRw: checks 
v8m8XHovI5tqEA9mvplDSw: checks 
gPEN9Zp33YTm/mu9/SYP1w: bets $2.75
P1Z7LWu+VU+WmJsI4mr0wA: folds 
u0ikXOhAPSCLmg+l17oGRw: folds 
v8m8XHovI5tqEA9mvplDSw: folds 
Uncalled bet ($2.75) returned to gPEN9Zp33YTm/mu9/SYP1w
gPEN9Zp33YTm/mu9/SYP1w collected $2.85 from pot
*** SUMMARY ***
Total pot $3 | Rake $0.15 
Board [Tc 5c Jh Kd 7s]
Seat 1: gPEN9Zp33YTm/mu9/SYP1w collected ($2.85)
Seat 2: LJI7A1YgDM7hgh7o56+ReQ (button) folded before Flop (didn't bet)
Seat 3: P1Z7LWu+VU+WmJsI4mr0wA (small blind) folded on the River
Seat 4: u0ikXOhAPSCLmg+l17oGRw (big blind) folded on the River
Seat 5: v8m8XHovI5tqEA9mvplDSw folded on the River
Seat 6: cWc85bEzdRzpUMhRKm8pwQ folded before Flop (didn't bet)




PokerStars Game #59941751184:  Hold'em No Limit ($0.10/$0.25) - 2009/07/01 1:45:00 ET
Table 'LwnjzXstPtSrqrV/oDpnXQ' 9-max Seat #2 is the button
Seat 1: 9YN2IkT2JYYKFErZtZvCtA ($17.45 in chips) 
Seat 2: uLP/lYn7oKq9xCChBXsXxw ($26.65 in chips) 
Seat 3: 7je+LC5Mfs6nL8YBVh4frQ ($4.05 in chips) 
Seat 4: CmngQmkKTp8tkl6GMRTl6w ($9.60 in chips) 
Seat 5: Th3FldXKQW6hWVVPahaoOQ ($26.25 in chips) 
Seat 6: ljemhp25Zg+nlA9DLCIiUw ($39.85 in chips) 
Seat 7: c/Dw/6HyqldTzIRodAIZmg ($13.75 in chips) 
Seat 8: ShXPHWfjhfmAwLgDdm6bRQ ($12.35 in chips) 
Seat 9: q6WfTUAD9mowIP63ASq2Dgz/khFDKGihQjwgoiKKPOeg70 in chips) 
7je+LC5Mfs6nL8YBVh4frQ: posts small blind $0.10
CmngQmkKTp8tkl6GMRTl6w: posts big blind $0.25
*** HOLE CARDS ***
Th3FldXKQW6hWVVPahaoOQ: folds 
ljemhp25Zg+nlA9DLCIiUw: folds 
c/Dw/6HyqldTzIRodAIZmg: folds 
ShXPHWfjhfmAwLgDdm6bRQ: calls $0.25
q6WfTUAD9mowIP63ASq2Dgz/khFDKGihQjwgoiKKPOegs 
9YN2IkT2JYYKFErZtZvCtA: folds 
uLP/lYn7oKq9xCChBXsXxw: folds 
7je+LC5Mfs6nL8YBVh4frQ: calls $0.15
CmngQmkKTp8tkl6GMRTl6w: checks 
*** FLOP *** [6h 7d 7s]
7je+LC5Mfs6nL8YBVh4frQ: checks 
CmngQmkKTp8tkl6GMRTl6w: checks 
ShXPHWfjhfmAwLgDdm6bRQ: checks 
*** TURN *** [6h 7d 7s] [3h]
7je+LC5Mfs6nL8YBVh4frQ: checks 
CmngQmkKTp8tkl6GMRTl6w: checks 
ShXPHWfjhfmAwLgDdm6bRQ: bets $0.25
7je+LC5Mfs6nL8YBVh4frQ: folds 
CmngQmkKTp8tkl6GMRTl6w: calls $0.25
*** RIVER *** [6h 7d 7s 3h] [3d]
CmngQmkKTp8tkl6GMRTl6w: checks 
ShXPHWfjhfmAwLgDdm6bRQ: bets $0.25
CmngQmkKTp8tkl6GMRTl6w: calls $0.25
*** SHOW DOWN ***
ShXPHWfjhfmAwLgDdm6bRQ: shows [8h 6c] (two pair, Sevens and Sixes)
CmngQmkKTp8tkl6GMRTl6w: mucks hand 
ShXPHWfjhfmAwLgDdm6bRQ collected $1.70 from pot
*** SUMMARY ***
Total pot $1.75 | Rake $0.05 
Board [6h 7d 7s 3h 3d]
Seat 1: 9YN2IkT2JYYKFErZtZvCtA folded before Flop (didn't bet)
Seat 2: uLP/lYn7oKq9xCChBXsXxw (button) folded before Flop (didn't bet)
Seat 3: 7je+LC5Mfs6nL8YBVh4frQ (small blind) folded on the Turn
Seat 4: CmngQmkKTp8tkl6GMRTl6w (big blind) mucked
Seat 5: Th3FldXKQW6hWVVPahaoOQ folded before Flop (didn't bet)
Seat 6: ljemhp25Zg+nlA9DLCIiUw folded before Flop (didn't bet)
Seat 7: c/Dw/6HyqldTzIRodAIZmg folded before Flop (didn't bet)
Seat 8: ShXPHWfjhfmAwLgDdm6bRQ showed [8h 6c] and won ($1.70) with two pair, Sevens and Sixes
Seat 9: q6WfTUAD9mowIP63ASq2Dgz/khFDKGihQjwgoiKKPOegd before Flop (didn't bet)




PokerStars Game #59941751796:  Hold'em No Limit ($0.10/$0.25) - 2009/07/01 1:45:01 ET
Table '4ZbiE0ZYjzqmgu6+sO1prg' 9-max Seat #3 is the button
Seat 1: eXiRSFoUjkV5taBc4N8rMQ ($9.10 in chips) 
Seat 2: 9lvO/qyU+xrU95Teu1fv0g ($5.20 in chips) 
Seat 3: HPEB+AtKw1+C/cxU0o1ciw ($25.20 in chips) 
Seat 4: w1ukf8uPa4+WH561TtVRxA ($25 in chips) 
Seat 5: +2kMBNpY4nF1qNCRd8SJLA ($43.95 in chips) 
Seat 7: aNpwfA31EREwO+ar4XzBCw ($26.30 in chips) 
Seat 8: cZ99hugmLBj9KhTlc8nCSw ($29.60 in chips) 
Seat 9: RCqMONFrSPSArZh2Jsar/w ($20.35 in chips) 
w1ukf8uPa4+WH561TtVRxA: posts small blind $0.10
+2kMBNpY4nF1qNCRd8SJLA: posts big blind $0.25
*** HOLE CARDS ***
aNpwfA31EREwO+ar4XzBCw: folds 
cZ99hugmLBj9KhTlc8nCSw: folds 
RCqMONFrSPSArZh2Jsar/w: folds 
eXiRSFoUjkV5taBc4N8rMQ: folds 
9lvO/qyU+xrU95Teu1fv0g: folds 
HPEB+AtKw1+C/cxU0o1ciw: folds 
w1ukf8uPa4+WH561TtVRxA: raises $0.75 to $1
+2kMBNpY4nF1qNCRd8SJLA: folds 
Uncalled bet ($0.75) returned to w1ukf8uPa4+WH561TtVRxA
w1ukf8uPa4+WH561TtVRxA collected $0.50 from pot
w1ukf8uPa4+WH561TtVRxA: doesn't show hand 
*** SUMMARY ***
Total pot $0.50 | Rake $0 
Seat 1: eXiRSFoUjkV5taBc4N8rMQ folded before Flop (didn't bet)
Seat 2: 9lvO/qyU+xrU95Teu1fv0g folded before Flop (didn't bet)
Seat 3: HPEB+AtKw1+C/cxU0o1ciw (button) folded before Flop (didn't bet)
Seat 4: w1ukf8uPa4+WH561TtVRxA (small blind) collected ($0.50)
Seat 5: +2kMBNpY4nF1qNCRd8SJLA (big blind) folded before Flop
Seat 7: aNpwfA31EREwO+ar4XzBCw folded before Flop (didn't bet)
Seat 8: cZ99hugmLBj9KhTlc8nCSw folded before Flop (didn't bet)
Seat 9: RCqMONFrSPSArZh2Jsar/w folded before Flop (didn't bet)




PokerStars Game #59941751448:  Hold'em No Limit ($0.10/$0.25) - 2009/07/01 1:45:01 ET
Table 'Ok3oDLIsTc2+KxPcI0bAOA' 6-max Seat #2 is the button
Seat 1: agQm3ugZ3qSVYNgNu1ddeA ($40.75 in chips) 
Seat 2: wPSNSp4HYtytRMXTu3oPSQ ($26.95 in chips) 
Seat 3: lquriepNQBhDV5P1SWHhnA ($36.20 in chips) 
Seat 4: LJI7A1YgDM7hgh7o56+ReQ ($36.90 in chips) 
Seat 5: DFi/Lzkjsfv8QswS80JX9Q ($28.25 in chips) 
Seat 6: Hsvkc0/G2VV78oVmWYXecw ($5 in chips) 
lquriepNQBhDV5P1SWHhnA: posts small blind $0.10
LJI7A1YgDM7hgh7o56+ReQ: posts big blind $0.25
*** HOLE CARDS ***
DFi/Lzkjsfv8QswS80JX9Q: raises $0.75 to $1
Hsvkc0/G2VV78oVmWYXecw: folds 
agQm3ugZ3qSVYNgNu1ddeA: folds 
wPSNSp4HYtytRMXTu3oPSQ: folds 
lquriepNQBhDV5P1SWHhnA: folds 
LJI7A1YgDM7hgh7o56+ReQ: folds 
Uncalled bet ($0.75) returned to DFi/Lzkjsfv8QswS80JX9Q
DFi/Lzkjsfv8QswS80JX9Q collected $0.60 from pot
DFi/Lzkjsfv8QswS80JX9Q: doesn't show hand 
*** SUMMARY ***
Total pot $0.60 | Rake $0 
Seat 1: agQm3ugZ3qSVYNgNu1ddeA folded before Flop (didn't bet)
Seat 2: wPSNSp4HYtytRMXTu3oPSQ (button) folded before Flop (didn't bet)
Seat 3: lquriepNQBhDV5P1SWHhnA (small blind) folded before Flop
Seat 4: LJI7A1YgDM7hgh7o56+ReQ (big blind) folded before Flop
Seat 5: DFi/Lzkjsfv8QswS80JX9Q collected ($0.60)
Seat 6: Hsvkc0/G2VV78oVmWYXecw folded before Flop (didn't bet)




PokerStars Game #59941751894:  Hold'em No Limit ($0.10/$0.25) - 2009/07/01 1:45:01 ET
Table 'ukli1Y7ieC5JQMTEFxM2Nw' 6-max Seat #6 is the button
Seat 1: N162H80ZIQevUf2EzGahCA ($8.90 in chips) 
Seat 2: u/yN5P9f3KlATg6WLWNkBQ ($43.30 in chips) 
Seat 3: ExeoJ1G/rSmWa3tRz7TlCA ($23.45 in chips) 
Seat 4: if4dh6jhJXeN3/qd3qCp9g ($28.35 in chips) 
Seat 5: Se+H4Z4PDr6+eIUDJX1rpg ($15.35 in chips) 
Seat 6: 32YL2ZEp8NT4JB2RVM9euQ ($30.15 in chips) 
N162H80ZIQevUf2EzGahCA: posts small blind $0.10
u/yN5P9f3KlATg6WLWNkBQ: posts big blind $0.25
*** HOLE CARDS ***
ExeoJ1G/rSmWa3tRz7TlCA: folds 
if4dh6jhJXeN3/qd3qCp9g: raises $0.75 to $1
Se+H4Z4PDr6+eIUDJX1rpg: calls $1
32YL2ZEp8NT4JB2RVM9euQ: folds 
N162H80ZIQevUf2EzGahCA: folds 
u/yN5P9f3KlATg6WLWNkBQ: calls $0.75
*** FLOP *** [3c Td 3d]
u/yN5P9f3KlATg6WLWNkBQ: checks 
if4dh6jhJXeN3/qd3qCp9g: checks 
Se+H4Z4PDr6+eIUDJX1rpg: bets $2
u/yN5P9f3KlATg6WLWNkBQ: folds 
if4dh6jhJXeN3/qd3qCp9g: folds 
Uncalled bet ($2) returned to Se+H4Z4PDr6+eIUDJX1rpg
Se+H4Z4PDr6+eIUDJX1rpg collected $2.95 from pot
Se+H4Z4PDr6+eIUDJX1rpg: doesn't show hand 
*** SUMMARY ***
Total pot $3.10 | Rake $0.15 
Board [3c Td 3d]
Seat 1: N162H80ZIQevUf2EzGahCA (small blind) folded before Flop
Seat 2: u/yN5P9f3KlATg6WLWNkBQ (big blind) folded on the Flop
Seat 3: ExeoJ1G/rSmWa3tRz7TlCA folded before Flop (didn't bet)
Seat 4: if4dh6jhJXeN3/qd3qCp9g folded on the Flop
Seat 5: Se+H4Z4PDr6+eIUDJX1rpg collected ($2.95)
Seat 6: 32YL2ZEp8NT4JB2RVM9euQ (button) folded before Flop (didn't bet)




PokerStars Game #59941751564:  Hold'em No Limit ($0.10/$0.25) - 2009/07/01 1:45:01 ET
Table 'Mef6A0EMopL6WaFO5/KO9g' 6-max Seat #4 is the button
Seat 1: GbCVUNssQ7mqsPWr7J4d3w ($4.30 in chips) 
Seat 2: 8ClCHtFXGNplITm+63KB+Q ($29.90 in chips) 
Seat 3: Wq26opBLDGJe91GRJn2epg ($17.15 in chips) 
Seat 4: lquriepNQBhDV5P1SWHhnA ($25 in chips) 
Seat 5: DihMHaz4WNETH1bPDe13kA ($25 in chips) 
Seat 6: jp34e617tIzV8tKIWmfAbA ($33.65 in chips) 
DihMHaz4WNETH1bPDe13kA: posts small blind $0.10
jp34e617tIzV8tKIWmfAbA: posts big blind $0.25
*** HOLE CARDS ***
GbCVUNssQ7mqsPWr7J4d3w: folds 
8ClCHtFXGNplITm+63KB+Q: folds 
Wq26opBLDGJe91GRJn2epg: raises $0.50 to $0.75
lquriepNQBhDV5P1SWHhnA: calls $0.75
DihMHaz4WNETH1bPDe13kA: folds 
jp34e617tIzV8tKIWmfAbA: folds 
*** FLOP *** [7s Th Ts]
Wq26opBLDGJe91GRJn2epg: bets $1
lquriepNQBhDV5P1SWHhnA: folds 
Uncalled bet ($1) returned to Wq26opBLDGJe91GRJn2epg
Wq26opBLDGJe91GRJn2epg collected $1.80 from pot
Wq26opBLDGJe91GRJn2epg: doesn't show hand 
*** SUMMARY ***
Total pot $1.85 | Rake $0.05 
Board [7s Th Ts]
Seat 1: GbCVUNssQ7mqsPWr7J4d3w folded before Flop (didn't bet)
Seat 2: 8ClCHtFXGNplITm+63KB+Q folded before Flop (didn't bet)
Seat 3: Wq26opBLDGJe91GRJn2epg collected ($1.80)
Seat 4: lquriepNQBhDV5P1SWHhnA (button) folded on the Flop
Seat 5: DihMHaz4WNETH1bPDe13kA (small blind) folded before Flop
Seat 6: jp34e617tIzV8tKIWmfAbA (big blind) folded before Flop




PokerStars Game #59941751954:  Hold'em No Limit ($0.10/$0.25) - 2009/07/01 1:45:02 ET
Table 'edvgY2YQ1I34euq4EVqGnA' 6-max Seat #6 is the button
Seat 1: mvFHK3pE7tCxJEqLjKC70Q ($25 in chips) 
Seat 2: Hsvkc0/G2VV78oVmWYXecw ($5 in chips) 
Seat 3: mFv3iBCtrw9XfCDRB0d46Q ($3.55 in chips) 
Seat 4: TI/C5Q+DEl4fLR3AofwYdg ($22.15 in chips) 
Seat 5: EE16Ua5b1HSsYej5zeXOlA ($56.75 in chips) 
Seat 6: kG34n23qFQA3nzdOJTQ1dA ($71.35 in chips) 
mvFHK3pE7tCxJEqLjKC70Q: posts small blind $0.10
Hsvkc0/G2VV78oVmWYXecw: posts big blind $0.25
*** HOLE CARDS ***
mFv3iBCtrw9XfCDRB0d46Q: folds 
TI/C5Q+DEl4fLR3AofwYdg: folds 
EE16Ua5b1HSsYej5zeXOlA: raises $0.50 to $0.75
kG34n23qFQA3nzdOJTQ1dA: folds 
mvFHK3pE7tCxJEqLjKC70Q: folds 
Hsvkc0/G2VV78oVmWYXecw: folds 
Uncalled bet ($0.50) returned to EE16Ua5b1HSsYej5zeXOlA
EE16Ua5b1HSsYej5zeXOlA collected $0.60 from pot
EE16Ua5b1HSsYej5zeXOlA: doesn't show hand 
*** SUMMARY ***
Total pot $0.60 | Rake $0 
Seat 1: mvFHK3pE7tCxJEqLjKC70Q (small blind) folded before Flop
Seat 2: Hsvkc0/G2VV78oVmWYXecw (big blind) folded before Flop
Seat 3: mFv3iBCtrw9XfCDRB0d46Q folded before Flop (didn't bet)
Seat 4: TI/C5Q+DEl4fLR3AofwYdg folded before Flop (didn't bet)
Seat 5: EE16Ua5b1HSsYej5zeXOlA collected ($0.60)
Seat 6: kG34n23qFQA3nzdOJTQ1dA (button) folded before Flop (didn't bet)




PokerStars Game #59941752374:  Hold'em No Limit ($0.10/$0.25) - 2009/07/01 1:45:02 ET
Table 'O6cwjhrMn9pfzx1Ngn5zkQ' 6-max Seat #4 is the button
Seat 1: LJI7A1YgDM7hgh7o56+ReQ ($27.80 in chips) 
Seat 2: tSR4329m40dZsN7YOpI9Kw ($29.35 in chips) 
Seat 3: EE16Ua5b1HSsYej5zeXOlA ($25.45 in chips) 
Seat 4: mfrkWA3PTeYPkbO6hi98Aw ($23.95 in chips) 
Seat 5: niLn0xUVlqh8If80xRjzCA ($28.20 in chips) 
Seat 6: 4TM16KVgEiQpLi4bVVWbVQ ($32.70 in chips) 
niLn0xUVlqh8If80xRjzCA: posts small blind $0.10
4TM16KVgEiQpLi4bVVWbVQ: posts big blind $0.25
*** HOLE CARDS ***
LJI7A1YgDM7hgh7o56+ReQ: folds 
tSR4329m40dZsN7YOpI9Kw: folds 
EE16Ua5b1HSsYej5zeXOlA: folds 
mfrkWA3PTeYPkbO6hi98Aw: folds 
niLn0xUVlqh8If80xRjzCA: calls $0.15
4TM16KVgEiQpLi4bVVWbVQ: checks 
*** FLOP *** [Kc 5c 3s]
niLn0xUVlqh8If80xRjzCA: checks 
4TM16KVgEiQpLi4bVVWbVQ: checks 
*** TURN *** [Kc 5c 3s] [2d]
niLn0xUVlqh8If80xRjzCA: checks 
4TM16KVgEiQpLi4bVVWbVQ: checks 
*** RIVER *** [Kc 5c 3s 2d] [Kd]
niLn0xUVlqh8If80xRjzCA: bets $0.25
4TM16KVgEiQpLi4bVVWbVQ: raises $0.75 to $1
niLn0xUVlqh8If80xRjzCA: folds 
Uncalled bet ($0.75) returned to 4TM16KVgEiQpLi4bVVWbVQ
4TM16KVgEiQpLi4bVVWbVQ collected $0.95 from pot
*** SUMMARY ***
Total pot $1 | Rake $0.05 
Board [Kc 5c 3s 2d Kd]
Seat 1: LJI7A1YgDM7hgh7o56+ReQ folded before Flop (didn't bet)
Seat 2: tSR4329m40dZsN7YOpI9Kw folded before Flop (didn't bet)
Seat 3: EE16Ua5b1HSsYej5zeXOlA folded before Flop (didn't bet)
Seat 4: mfrkWA3PTeYPkbO6hi98Aw (button) folded before Flop (didn't bet)
Seat 5: niLn0xUVlqh8If80xRjzCA (small blind) folded on the River
Seat 6: 4TM16KVgEiQpLi4bVVWbVQ (big blind) collected ($0.95)




PokerStars Game #59941752132:  Hold'em No Limit ($0.10/$0.25) - 2009/07/01 1:45:02 ET
Table 'sm5gqEvXgLbkkE4dryW/5g' 6-max Seat #2 is the button
Seat 1: v8m8XHovI5tqEA9mvplDSw ($40.20 in chips) 
Seat 2: 5xs5/u2z1CO9zkRvH72MQg ($19.15 in chips) 
Seat 3: UT5XpwOH1ipkOF7n1MqDJA ($22.40 in chips) 
Seat 4: cWc85bEzdRzpUMhRKm8pwQ ($25.75 in chips) 
Seat 6: aogAb4Eienxztk8p2v9VVw ($20.40 in chips) 
UT5XpwOH1ipkOF7n1MqDJA: posts small blind $0.10
cWc85bEzdRzpUMhRKm8pwQ: posts big blind $0.25
*** HOLE CARDS ***
aogAb4Eienxztk8p2v9VVw: folds 
v8m8XHovI5tqEA9mvplDSw: folds 
5xs5/u2z1CO9zkRvH72MQg: calls $0.25
UT5XpwOH1ipkOF7n1MqDJA: calls $0.15
cWc85bEzdRzpUMhRKm8pwQ: raises $1 to $1.25
5xs5/u2z1CO9zkRvH72MQg: folds 
UT5XpwOH1ipkOF7n1MqDJA: folds 
Uncalled bet ($1) returned to cWc85bEzdRzpUMhRKm8pwQ
cWc85bEzdRzpUMhRKm8pwQ collected $0.75 from pot
*** SUMMARY ***
Total pot $0.75 | Rake $0 
Seat 1: v8m8XHovI5tqEA9mvplDSw folded before Flop (didn't bet)
Seat 2: 5xs5/u2z1CO9zkRvH72MQg (button) folded before Flop
Seat 3: UT5XpwOH1ipkOF7n1MqDJA (small blind) folded before Flop
Seat 4: cWc85bEzdRzpUMhRKm8pwQ (big blind) collected ($0.75)
Seat 6: aogAb4Eienxztk8p2v9VVw folded before Flop (didn't bet)




PokerStars Game #59941752758:  Hold'em No Limit ($0.10/$0.25) - 2009/07/01 1:45:03 ET
Table 'mF3KHGMaTpaBZbtBoyfTeg' 6-max Seat #6 is the button
Seat 1: 0HAB2GdCAM7p7V00xueAVQ ($24.15 in chips) 
Seat 3: 9kUKGKkblnIx3m8rlVol6Q ($9.70 in chips) 
Seat 4: FYepjhAvF8ZdVCmqHIy+eQ ($25 in chips) 
Seat 5: 8ClCHtFXGNplITm+63KB+Q ($44.30 in chips) 
Seat 6: kG34n23qFQA3nzdOJTQ1dA ($27.40 in chips) 
0HAB2GdCAM7p7V00xueAVQ: posts small blind $0.10
6qsh9pnysDKJNhfFhFmKRQ: is sitting out 
9kUKGKkblnIx3m8rlVol6Q: posts big blind $0.25
*** HOLE CARDS ***
6qsh9pnysDKJNhfFhFmKRQ leaves the table
FYepjhAvF8ZdVCmqHIy+eQ: folds 
8ClCHtFXGNplITm+63KB+Q: folds 
kG34n23qFQA3nzdOJTQ1dA: calls $0.25
0HAB2GdCAM7p7V00xueAVQ: calls $0.15
9kUKGKkblnIx3m8rlVol6Q: checks 
*** FLOP *** [Ac 7s 5c]
xrf8tAXKQHG99HixCot1Iw joins the table at seat #2 
0HAB2GdCAM7p7V00xueAVQ: checks 
9kUKGKkblnIx3m8rlVol6Q: checks 
kG34n23qFQA3nzdOJTQ1dA: checks 
*** TURN *** [Ac 7s 5c] [Qs]
0HAB2GdCAM7p7V00xueAVQ: checks 
9kUKGKkblnIx3m8rlVol6Q: checks 
kG34n23qFQA3nzdOJTQ1dA: checks 
*** RIVER *** [Ac 7s 5c Qs] [3c]
0HAB2GdCAM7p7V00xueAVQ: checks 
9kUKGKkblnIx3m8rlVol6Q: bets $0.75
kG34n23qFQA3nzdOJTQ1dA: folds 
0HAB2GdCAM7p7V00xueAVQ: folds 
Uncalled bet ($0.75) returned to 9kUKGKkblnIx3m8rlVol6Q
9kUKGKkblnIx3m8rlVol6Q collected $0.75 from pot
9kUKGKkblnIx3m8rlVol6Q: doesn't show hand 
*** SUMMARY ***
Total pot $0.75 | Rake $0 
Board [Ac 7s 5c Qs 3c]
Seat 1: 0HAB2GdCAM7p7V00xueAVQ (small blind) folded on the River
Seat 3: 9kUKGKkblnIx3m8rlVol6Q (big blind) collected ($0.75)
Seat 4: FYepjhAvF8ZdVCmqHIy+eQ folded before Flop (didn't bet)
Seat 5: 8ClCHtFXGNplITm+63KB+Q folded before Flop (didn't bet)
Seat 6: kG34n23qFQA3nzdOJTQ1dA (button) folded on the River




PokerStars Game #59941752560:  Hold'em No Limit ($0.10/$0.25) - 2009/07/01 1:45:03 ET
Table 'M8kYidAX3ib7pLKW7edFLw' 6-max Seat #5 is the button
Seat 1: jp34e617tIzV8tKIWmfAbA ($25.35 in chips) 
Seat 2: ypmjhffk/YHGc51wgVXUTw ($27.30 in chips) 
Seat 3: cezpHJ8FB07dj0xG+LhOvw ($27.10 in chips) 
Seat 4: Hsvkc0/G2VV78oVmWYXecw ($6.05 in chips) 
Seat 5: bDKopKTvPi3W+PEnYUX3tg ($44.50 in chips) 
Seat 6: NqFoyDgzLwu4dOmSRXnFBA ($20.70 in chips) 
NqFoyDgzLwu4dOmSRXnFBA: posts small blind $0.10
jp34e617tIzV8tKIWmfAbA: posts big blind $0.25
*** HOLE CARDS ***
ypmjhffk/YHGc51wgVXUTw: folds 
cezpHJ8FB07dj0xG+LhOvw: folds 
Hsvkc0/G2VV78oVmWYXecw: raises $0.50 to $0.75
bDKopKTvPi3W+PEnYUX3tg: calls $0.75
NqFoyDgzLwu4dOmSRXnFBA: folds 
jp34e617tIzV8tKIWmfAbA: calls $0.50
*** FLOP *** [8d Kc 8h]
jp34e617tIzV8tKIWmfAbA: checks 
Hsvkc0/G2VV78oVmWYXecw: checks 
bDKopKTvPi3W+PEnYUX3tg: bets $1.50
jp34e617tIzV8tKIWmfAbA: folds 
Hsvkc0/G2VV78oVmWYXecw: folds 
Uncalled bet ($1.50) returned to bDKopKTvPi3W+PEnYUX3tg
bDKopKTvPi3W+PEnYUX3tg collected $2.25 from pot
bDKopKTvPi3W+PEnYUX3tg: doesn't show hand 
*** SUMMARY ***
Total pot $2.35 | Rake $0.10 
Board [8d Kc 8h]
Seat 1: jp34e617tIzV8tKIWmfAbA (big blind) folded on the Flop
Seat 2: ypmjhffk/YHGc51wgVXUTw folded before Flop (didn't bet)
Seat 3: cezpHJ8FB07dj0xG+LhOvw folded before Flop (didn't bet)
Seat 4: Hsvkc0/G2VV78oVmWYXecw folded on the Flop
Seat 5: bDKopKTvPi3W+PEnYUX3tg (button) collected ($2.25)
Seat 6: NqFoyDgzLwu4dOmSRXnFBA (small blind) folded before Flop




PokerStars Game #59941752742:  Hold'em No Limit ($0.10/$0.25) - 2009/07/01 1:45:03 ET
Table 'dZNBGqFYSwfOVZvDJ4VjIQ' 6-max Seat #1 is the button
Seat 1: v+QfkGiuj9bgtuNoVnDO8w ($37.45 in chips) 
Seat 2: 3zD3qLXT1bEffAoWGnc7wg ($25.10 in chips) 
Seat 3: kyRaCIljYA6l33lSKQfNsg ($28.30 in chips) 
Seat 4: mFv3iBCtrw9XfCDRB0d46Q ($6.15 in chips) 
Seat 5: +ZlnqPoP3Hg4BIUxDfKd/A ($33.25 in chips) 
Seat 6: ypmjhffk/YHGc51wgVXUTw ($29.40 in chips) 
3zD3qLXT1bEffAoWGnc7wg: posts small blind $0.10
kyRaCIljYA6l33lSKQfNsg: posts big blind $0.25
*** HOLE CARDS ***
mFv3iBCtrw9XfCDRB0d46Q: folds 
+ZlnqPoP3Hg4BIUxDfKd/A: raises $0.75 to $1
ypmjhffk/YHGc51wgVXUTw: folds 
v+QfkGiuj9bgtuNoVnDO8w: folds 
3zD3qLXT1bEffAoWGnc7wg: folds 
kyRaCIljYA6l33lSKQfNsg: folds 
Uncalled bet ($0.75) returned to +ZlnqPoP3Hg4BIUxDfKd/A
+ZlnqPoP3Hg4BIUxDfKd/A collected $0.60 from pot
+ZlnqPoP3Hg4BIUxDfKd/A: doesn't show hand 
*** SUMMARY ***
Total pot $0.60 | Rake $0 
Seat 1: v+QfkGiuj9bgtuNoVnDO8w (button) folded before Flop (didn't bet)
Seat 2: 3zD3qLXT1bEffAoWGnc7wg (small blind) folded before Flop
Seat 3: kyRaCIljYA6l33lSKQfNsg (big blind) folded before Flop
Seat 4: mFv3iBCtrw9XfCDRB0d46Q folded before Flop (didn't bet)
Seat 5: +ZlnqPoP3Hg4BIUxDfKd/A collected ($0.60)
Seat 6: ypmjhffk/YHGc51wgVXUTw folded before Flop (didn't bet)




PokerStars Game #59941752886:  Hold'em No Limit ($0.10/$0.25) - 2009/07/01 1:45:03 ET
Table 'KEoOIegxPF91KooL2AelUA' 6-max Seat #4 is the button
Seat 1: wsP46AGpqDjHZQmlRHKa9g ($42.25 in chips) 
Seat 2: 0Bg59Tnte1Tc7C4i9Jd9cQ ($7.90 in chips) 
Seat 3: zxeVQGaMKDsDzmSY+AInjA ($10.70 in chips) 
Seat 4: Wo60l2GQnSEc3bxPVyvIUw ($11.35 in chips) 
Seat 5: 08V++DOqzaNrRNsHIwi25w ($49.45 in chips) 
Seat 6: AMrBn4Vx9aAo/vv6WHLk6w ($3.15 in chips) 
08V++DOqzaNrRNsHIwi25w: posts small blind $0.10
AMrBn4Vx9aAo/vv6WHLk6w: posts big blind $0.25
*** HOLE CARDS ***
wsP46AGpqDjHZQmlRHKa9g: folds 
0Bg59Tnte1Tc7C4i9Jd9cQ is disconnected 
0Bg59Tnte1Tc7C4i9Jd9cQ has timed out while disconnected
0Bg59Tnte1Tc7C4i9Jd9cQ: folds 
0Bg59Tnte1Tc7C4i9Jd9cQ is sitting out
zxeVQGaMKDsDzmSY+AInjA: folds 
Wo60l2GQnSEc3bxPVyvIUw: raises $0.75 to $1
08V++DOqzaNrRNsHIwi25w: calls $0.90
AMrBn4Vx9aAo/vv6WHLk6w: folds 
*** FLOP *** [8d 2s 6h]
08V++DOqzaNrRNsHIwi25w: checks 
wsP46AGpqDjHZQmlRHKa9g leaves the table
Wo60l2GQnSEc3bxPVyvIUw: bets $1.25
0Bg59Tnte1Tc7C4i9Jd9cQ is connected 
08V++DOqzaNrRNsHIwi25w: calls $1.25
*** TURN *** [8d 2s 6h] [Jh]
0Bg59Tnte1Tc7C4i9Jd9cQ has returned
08V++DOqzaNrRNsHIwi25w: checks 
Wo60l2GQnSEc3bxPVyvIUw: checks 
*** RIVER *** [8d 2s 6h Jh] [5h]
08V++DOqzaNrRNsHIwi25w: checks 
Wo60l2GQnSEc3bxPVyvIUw: checks 
*** SHOW DOWN ***
08V++DOqzaNrRNsHIwi25w: shows [Ts As] (high card Ace)
Wo60l2GQnSEc3bxPVyvIUw: mucks hand 
08V++DOqzaNrRNsHIwi25w collected $4.55 from pot
*** SUMMARY ***
Total pot $4.75 | Rake $0.20 
Board [8d 2s 6h Jh 5h]
Seat 1: wsP46AGpqDjHZQmlRHKa9g folded before Flop (didn't bet)
Seat 2: 0Bg59Tnte1Tc7C4i9Jd9cQ folded before Flop (didn't bet)
Seat 3: zxeVQGaMKDsDzmSY+AInjA folded before Flop (didn't bet)
Seat 4: Wo60l2GQnSEc3bxPVyvIUw (button) mucked
Seat 5: 08V++DOqzaNrRNsHIwi25w (small blind) showed [Ts As] and won ($4.55) with high card Ace
Seat 6: AMrBn4Vx9aAo/vv6WHLk6w (big blind) folded before Flop




PokerStars Game #59941752668:  Hold'em No Limit ($0.10/$0.25) - 2009/07/01 1:45:03 ET
Table '/VaaaFnlEJoYVomG9uxHkA' 9-max Seat #1 is the button
Seat 1: Th3FldXKQW6hWVVPahaoOQ ($30.90 in chips) 
Seat 2: DIkeSkosO/tsUp9d2JVyTA ($57.05 in chips) 
Seat 3: MtVtHDqIJTyUcXkRBBDIVA ($26.50 in chips) 
Seat 4: j4q3p0lesp63b1gZDwLBZw ($5 in chips) 
Seat 5: cZ99hugmLBj9KhTlc8nCSw ($25 in chips) 
Seat 7: F7pnn6czNpHvRM55XcA2EA ($25.50 in chips) 
Seat 8: dfNim92Z6XK1/h5SFW5vDg ($45.75 in chips) 
DIkeSkosO/tsUp9d2JVyTA: posts small blind $0.10
MtVtHDqIJTyUcXkRBBDIVA: posts big blind $0.25
DdPXdieucQ+n99u1n3A+rQ: sits out 
*** HOLE CARDS ***
j4q3p0lesp63b1gZDwLBZw: folds 
cZ99hugmLBj9KhTlc8nCSw: folds 
dukepoker05 is disconnected 
F7pnn6czNpHvRM55XcA2EA: raises $0.75 to $1
dfNim92Z6XK1/h5SFW5vDg: folds 
Th3FldXKQW6hWVVPahaoOQ: folds 
DIkeSkosO/tsUp9d2JVyTA: raises $1.25 to $2.25
MtVtHDqIJTyUcXkRBBDIVA: folds 
F7pnn6czNpHvRM55XcA2EA: raises $4.25 to $6.50
DIkeSkosO/tsUp9d2JVyTA: calls $4.25
*** FLOP *** [Tc 7h 2s]
DIkeSkosO/tsUp9d2JVyTA: checks 
F7pnn6czNpHvRM55XcA2EA: bets $7.25
DIkeSkosO/tsUp9d2JVyTA: folds 
Uncalled bet ($7.25) returned to F7pnn6czNpHvRM55XcA2EA
F7pnn6czNpHvRM55XcA2EA collected $12.60 from pot
F7pnn6czNpHvRM55XcA2EA: doesn't show hand 
*** SUMMARY ***
Total pot $13.25 | Rake $0.65 
Board [Tc 7h 2s]
Seat 1: Th3FldXKQW6hWVVPahaoOQ (button) folded before Flop (didn't bet)
Seat 2: DIkeSkosO/tsUp9d2JVyTA (small blind) folded on the Flop
Seat 3: MtVtHDqIJTyUcXkRBBDIVA (big blind) folded before Flop
Seat 4: j4q3p0lesp63b1gZDwLBZw folded before Flop (didn't bet)
Seat 5: cZ99hugmLBj9KhTlc8nCSw folded before Flop (didn't bet)
Seat 7: F7pnn6czNpHvRM55XcA2EA collected ($12.60)
Seat 8: dfNim92Z6XK1/h5SFW5vDg folded before Flop (didn't bet)




PokerStars Game #59941752936:  Hold'em No Limit ($0.10/$0.25) - 2009/07/01 1:45:04 ET
Table '29D3eoQzK5kOAT0OIDS2uQ' 6-max Seat #1 is the button
Seat 1: kG34n23qFQA3nzdOJTQ1dA ($46.40 in chips) 
Seat 2: FyE+TQ5JcCqI/tCCHf0jGA ($16.05 in chips) 
Seat 3: z3tQwy28dp5FykDJC/wzQw ($17.80 in chips) 
Seat 4: MqMK8OWPSY1V4stf1Hy5Jw ($35.90 in chips) 
Seat 5: Q3EMN7b0ie81AFWkDrhCjw ($23.40 in chips) 
Seat 6: bWbV4MVB/vVpiES1Ut4hew ($30.65 in chips) 
FyE+TQ5JcCqI/tCCHf0jGA: posts small blind $0.10
z3tQwy28dp5FykDJC/wzQw: posts big blind $0.25
*** HOLE CARDS ***
MqMK8OWPSY1V4stf1Hy5Jw: folds 
Q3EMN7b0ie81AFWkDrhCjw: calls $0.25
bWbV4MVB/vVpiES1Ut4hew: folds 
kG34n23qFQA3nzdOJTQ1dA: folds 
FyE+TQ5JcCqI/tCCHf0jGA: raises $1 to $1.25
z3tQwy28dp5FykDJC/wzQw: folds 
Q3EMN7b0ie81AFWkDrhCjw: calls $1
*** FLOP *** [7d 2d Qc]
FyE+TQ5JcCqI/tCCHf0jGA: bets $1.25
Q3EMN7b0ie81AFWkDrhCjw: folds 
Uncalled bet ($1.25) returned to FyE+TQ5JcCqI/tCCHf0jGA
FyE+TQ5JcCqI/tCCHf0jGA collected $2.65 from pot
*** SUMMARY ***
Total pot $2.75 | Rake $0.10 
Board [7d 2d Qc]
Seat 1: kG34n23qFQA3nzdOJTQ1dA (button) folded before Flop (didn't bet)
Seat 2: FyE+TQ5JcCqI/tCCHf0jGA (small blind) collected ($2.65)
Seat 3: z3tQwy28dp5FykDJC/wzQw (big blind) folded before Flop
Seat 4: MqMK8OWPSY1V4stf1Hy5Jw folded before Flop (didn't bet)
Seat 5: Q3EMN7b0ie81AFWkDrhCjw folded on the Flop
Seat 6: bWbV4MVB/vVpiES1Ut4hew folded before Flop (didn't bet)




PokerStars Game #59941753342:  Hold'em No Limit ($0.10/$0.25) - 2009/07/01 1:45:04 ET
Table 'TJS4XvvOjO3k7mH74HJw5g' 9-max Seat #7 is the button
Seat 1: K8I2mpRME07ZlOsT2x75Lg ($5.95 in chips) 
Seat 5: UlMB386Cfzy3EwurQoBjcA ($10.95 in chips) 
Seat 6: SRik8xyC/rVIBoX7VaOoMA ($13.90 in chips) 
Seat 7: B9u+i1s5aZZkmLTLUopTBg ($14.65 in chips) 
Seat 8: Qv4VzEkN09uD11sjKv02Ig ($18.80 in chips) 
Seat 9: +sbyWwIcFp9kP0bDtMegfQ ($42.65 in chips) 
Qv4VzEkN09uD11sjKv02Ig: posts small blind $0.10
+sbyWwIcFp9kP0bDtMegfQ: posts big blind $0.25
yqkowiRWZ6NvRN9UUkYIlA: sits out 
8EbrQ/EvFWt2cr0GaU82gQ: sits out 
*** HOLE CARDS ***
K8I2mpRME07ZlOsT2x75Lg: raises $0.25 to $0.50
UlMB386Cfzy3EwurQoBjcA: calls $0.50
SRik8xyC/rVIBoX7VaOoMA: folds 
B9u+i1s5aZZkmLTLUopTBg: folds 
javo78 leaves the table
Qv4VzEkN09uD11sjKv02Ig: folds 
+sbyWwIcFp9kP0bDtMegfQ: folds 
*** FLOP *** [8c Qc Jd]
K8I2mpRME07ZlOsT2x75Lg: checks 
clJsV3v77RS07bDKY+705w joins the table at seat #4 
UlMB386Cfzy3EwurQoBjcA: bets $0.75
K8I2mpRME07ZlOsT2x75Lg: calls $0.75
*** TURN *** [8c Qc Jd] [Kh]
K8I2mpRME07ZlOsT2x75Lg: bets $0.75
UlMB386Cfzy3EwurQoBjcA: calls $0.75
*** RIVER *** [8c Qc Jd Kh] [Qd]
K8I2mpRME07ZlOsT2x75Lg: bets $0.75
UlMB386Cfzy3EwurQoBjcA: calls $0.75
*** SHOW DOWN ***
K8I2mpRME07ZlOsT2x75Lg: shows [9h Ks] (two pair, Kings and Queens)
UlMB386Cfzy3EwurQoBjcA: mucks hand 
K8I2mpRME07ZlOsT2x75Lg collected $5.60 from pot
*** SUMMARY ***
Total pot $5.85 | Rake $0.25 
Board [8c Qc Jd Kh Qd]
Seat 1: K8I2mpRME07ZlOsT2x75Lg showed [9h Ks] and won ($5.60) with two pair, Kings and Queens
Seat 5: UlMB386Cfzy3EwurQoBjcA mucked
Seat 6: SRik8xyC/rVIBoX7VaOoMA folded before Flop (didn't bet)
Seat 7: B9u+i1s5aZZkmLTLUopTBg (button) folded before Flop (didn't bet)
Seat 8: Qv4VzEkN09uD11sjKv02Ig (small blind) folded before Flop
Seat 9: +sbyWwIcFp9kP0bDtMegfQ (big blind) folded before Flop




PokerStars Game #59941753262:  Hold'em No Limit ($0.10/$0.25) - 2009/07/01 1:45:04 ET
Table '9iHhO6FyZVM8XpSc23TIgg' 6-max Seat #6 is the button
Seat 1: NhUN/JpAprdJeamFBgJH1w ($37.40 in chips) 
Seat 2: bJFzs6QmEEnz4miMfSDtcg ($40.05 in chips) 
Seat 3: TSmua8tGK3sTbwi0ynrW9Q ($26.50 in chips) 
Seat 4: cfJccEfyn6IkquPN08hFsA ($15 in chips) 
Seat 6: iyZxqznXjv3vtvOJymkoLQ ($34.20 in chips) 
NhUN/JpAprdJeamFBgJH1w: posts small blind $0.10
bJFzs6QmEEnz4miMfSDtcg: posts big blind $0.25
cfJccEfyn6IkquPN08hFsA: posts small blind $0.10
*** HOLE CARDS ***
TSmua8tGK3sTbwi0ynrW9Q: folds 
cfJccEfyn6IkquPN08hFsA: folds 
iyZxqznXjv3vtvOJymkoLQ: folds 
NhUN/JpAprdJeamFBgJH1w: folds 
Uncalled bet ($0.15) returned to bJFzs6QmEEnz4miMfSDtcg
bJFzs6QmEEnz4miMfSDtcg collected $0.30 from pot
*** SUMMARY ***
Total pot $0.30 | Rake $0 
Seat 1: NhUN/JpAprdJeamFBgJH1w (small blind) folded before Flop
Seat 2: bJFzs6QmEEnz4miMfSDtcg (big blind) collected ($0.30)
Seat 3: TSmua8tGK3sTbwi0ynrW9Q folded before Flop (didn't bet)
Seat 4: cfJccEfyn6IkquPN08hFsA folded before Flop
Seat 6: iyZxqznXjv3vtvOJymkoLQ (button) folded before Flop (didn't bet)




PokerStars Game #59941752998:  Hold'em No Limit ($0.10/$0.25) - 2009/07/01 1:45:04 ET
Table '63uh7ZsO7Tnt+E8b/2bu3A' 6-max Seat #2 is the button
Seat 1: 0av6tRNdi0Ui4f15L7gsVg ($30.55 in chips) 
Seat 2: SFmT9ZsVopnukjvAzrxTRg ($28.35 in chips) 
Seat 3: yVP7GLZBzx47OPi6jzUxMw ($7.85 in chips) 
Seat 5: GbCVUNssQ7mqsPWr7J4d3w ($4.40 in chips) 
Seat 6: qGHGf/553gQnDoklMRe3tg ($30.15 in chips) 
yVP7GLZBzx47OPi6jzUxMw: posts small blind $0.10
GbCVUNssQ7mqsPWr7J4d3w: posts big blind $0.25
*** HOLE CARDS ***
qGHGf/553gQnDoklMRe3tg: folds 
0av6tRNdi0Ui4f15L7gsVg: folds 
SFmT9ZsVopnukjvAzrxTRg: folds 
yVP7GLZBzx47OPi6jzUxMw: raises $0.50 to $0.75
GbCVUNssQ7mqsPWr7J4d3w: folds 
Uncalled bet ($0.50) returned to yVP7GLZBzx47OPi6jzUxMw
yVP7GLZBzx47OPi6jzUxMw collected $0.50 from pot
yVP7GLZBzx47OPi6jzUxMw: doesn't show hand 
*** SUMMARY ***
Total pot $0.50 | Rake $0 
Seat 1: 0av6tRNdi0Ui4f15L7gsVg folded before Flop (didn't bet)
Seat 2: SFmT9ZsVopnukjvAzrxTRg (button) folded before Flop (didn't bet)
Seat 3: yVP7GLZBzx47OPi6jzUxMw (small blind) collected ($0.50)
Seat 5: GbCVUNssQ7mqsPWr7J4d3w (big blind) folded before Flop
Seat 6: qGHGf/553gQnDoklMRe3tg folded before Flop (didn't bet)




PokerStars Game #59941753290:  Hold'em No Limit ($0.10/$0.25) - 2009/07/01 1:45:04 ET
Table '2clPgY3+dETPD/8zjXZdFw' 6-max Seat #2 is the button
Seat 1: 4WFKzsjLSGnvHbVxKabsvQ ($30.70 in chips) 
Seat 2: cWc85bEzdRzpUMhRKm8pwQ ($25.45 in chips) 
Seat 3: SFmT9ZsVopnukjvAzrxTRg ($25.10 in chips) 
Seat 4: ljjhtb6FVPTx9AT9HNdtqg ($25 in chips) 
Seat 5: LJI7A1YgDM7hgh7o56+ReQ ($29.90 in chips) 
SFmT9ZsVopnukjvAzrxTRg: posts small blind $0.10
ljjhtb6FVPTx9AT9HNdtqg: posts big blind $0.25
*** HOLE CARDS ***
LJI7A1YgDM7hgh7o56+ReQ: folds 
4WFKzsjLSGnvHbVxKabsvQ: folds 
cWc85bEzdRzpUMhRKm8pwQ: folds 
SFmT9ZsVopnukjvAzrxTRg: raises $0.75 to $1
ljjhtb6FVPTx9AT9HNdtqg: calls $0.75
*** FLOP *** [2h Ts Jc]
SFmT9ZsVopnukjvAzrxTRg: bets $1.25
ljjhtb6FVPTx9AT9HNdtqg: folds 
Uncalled bet ($1.25) returned to SFmT9ZsVopnukjvAzrxTRg
SFmT9ZsVopnukjvAzrxTRg collected $1.90 from pot
SFmT9ZsVopnukjvAzrxTRg: doesn't show hand 
*** SUMMARY ***
Total pot $2 | Rake $0.10 
Board [2h Ts Jc]
Seat 1: 4WFKzsjLSGnvHbVxKabsvQ folded before Flop (didn't bet)
Seat 2: cWc85bEzdRzpUMhRKm8pwQ (button) folded before Flop (didn't bet)
Seat 3: SFmT9ZsVopnukjvAzrxTRg (small blind) collected ($1.90)
Seat 4: ljjhtb6FVPTx9AT9HNdtqg (big blind) folded on the Flop
Seat 5: LJI7A1YgDM7hgh7o56+ReQ folded before Flop (didn't bet)




PokerStars Game #59941753858:  Hold'em No Limit ($0.10/$0.25) - 2009/07/01 1:45:05 ET
Table '6aL2C8IFwHHr6SG6RgXaow' 9-max Seat #9 is the button
Seat 1: bXpVeaSTPBFSPJmeXxO7nw ($4.75 in chips) 
Seat 3: aCVg6cCxQcqClhB9nq/p1w ($12.90 in chips) 
Seat 4: BT6Oal0iO4P6kDuT7HFQDw ($18.35 in chips) 
Seat 5: wre31HfyzQGpIvID1istxw ($21.20 in chips) 
Seat 6: gehe91e0IyVT0QU/XBkEyg ($27.10 in chips) 
Seat 7: QJxYAPJ6uPZZcpdN+RvWcQ ($25 in chips) 
Seat 8: rQhYIYXSyH/IivYM1dlV5A ($22.45 in chips) 
Seat 9: CgIo2ItZqi4o3ayVG6HanQ ($24 in chips) 
bXpVeaSTPBFSPJmeXxO7nw: posts small blind $0.10
aCVg6cCxQcqClhB9nq/p1w: posts big blind $0.25
*** HOLE CARDS ***
BT6Oal0iO4P6kDuT7HFQDw: folds 
wre31HfyzQGpIvID1istxw: folds 
gehe91e0IyVT0QU/XBkEyg: folds 
QJxYAPJ6uPZZcpdN+RvWcQ: folds 
rQhYIYXSyH/IivYM1dlV5A: folds 
CgIo2ItZqi4o3ayVG6HanQ: folds 
bXpVeaSTPBFSPJmeXxO7nw: folds 
Uncalled bet ($0.15) returned to aCVg6cCxQcqClhB9nq/p1w
aCVg6cCxQcqClhB9nq/p1w collected $0.20 from pot
aCVg6cCxQcqClhB9nq/p1w leaves the table
*** SUMMARY ***
Total pot $0.20 | Rake $0 
Seat 1: bXpVeaSTPBFSPJmeXxO7nw (small blind) folded before Flop
Seat 3: aCVg6cCxQcqClhB9nq/p1w (big blind) collected ($0.20)
Seat 4: BT6Oal0iO4P6kDuT7HFQDw folded before Flop (didn't bet)
Seat 5: wre31HfyzQGpIvID1istxw folded before Flop (didn't bet)
Seat 6: gehe91e0IyVT0QU/XBkEyg folded before Flop (didn't bet)
Seat 7: QJxYAPJ6uPZZcpdN+RvWcQ folded before Flop (didn't bet)
Seat 8: rQhYIYXSyH/IivYM1dlV5A folded before Flop (didn't bet)
Seat 9: CgIo2ItZqi4o3ayVG6HanQ (button) folded before Flop (didn't bet)




PokerStars Game #59941753806:  Hold'em No Limit ($0.10/$0.25) - 2009/07/01 1:45:05 ET
Table '+giHa6FUL6U5/AZnCJEGvQ' 9-max Seat #6 is the button
Seat 4: 10f7J+bM02ZfDHx0PgkNSg ($14.10 in chips) 
Seat 6: GTMnTen6sQSoCpS9sggLbg ($25.55 in chips) 
GTMnTen6sQSoCpS9sggLbg: posts small blind $0.10
10f7J+bM02ZfDHx0PgkNSg: posts big blind $0.25
*** HOLE CARDS ***
GTMnTen6sQSoCpS9sggLbg: raises $0.50 to $0.75
10f7J+bM02ZfDHx0PgkNSg: folds 
Uncalled bet ($0.50) returned to GTMnTen6sQSoCpS9sggLbg
GTMnTen6sQSoCpS9sggLbg collected $0.50 from pot
GTMnTen6sQSoCpS9sggLbg: doesn't show hand 
*** SUMMARY ***
Total pot $0.50 | Rake $0 
Seat 4: 10f7J+bM02ZfDHx0PgkNSg (big blind) folded before Flop
Seat 6: GTMnTen6sQSoCpS9sggLbg (button) (small blind) collected ($0.50)




PokerStars Game #59941753840:  Hold'em No Limit ($0.10/$0.25) - 2009/07/01 1:45:05 ET
Table 'YlRA05h9BJ1EhOUSNUjJdg' 9-max Seat #7 is the button
Seat 1: dtZ84flFEi4Q+SGrHMJRDQ ($25 in chips) 
Seat 2: Y2GFAe+PT7xnUUtgqCNDFw ($12.05 in chips) 
Seat 3: Z5ZtGOON8kmSdSCll9Z3XA ($13.20 in chips) 
Seat 4: HPEB+AtKw1+C/cxU0o1ciw ($31.35 in chips) 
Seat 5: sx0lGrkT9fd4yFR+3cXUQg ($11.65 in chips) 
Seat 6: QEbIGci+itdw+re8RM5fZA ($44 in chips) 
Seat 7: dfNim92Z6XK1/h5SFW5vDg ($25 in chips) 
Seat 8: dmYlc+1cjwZMJ7wV+Z0rRg ($32.65 in chips) 
Seat 9: Z9AeOQX3yzuSvKAm/xyovg ($9.85 in chips) 
dmYlc+1cjwZMJ7wV+Z0rRg: posts small blind $0.10
Z9AeOQX3yzuSvKAm/xyovg: posts big blind $0.25
*** HOLE CARDS ***
dtZ84flFEi4Q+SGrHMJRDQ: folds 
Y2GFAe+PT7xnUUtgqCNDFw: folds 
Z5ZtGOON8kmSdSCll9Z3XA: folds 
HPEB+AtKw1+C/cxU0o1ciw: calls $0.25
sx0lGrkT9fd4yFR+3cXUQg: folds 
QEbIGci+itdw+re8RM5fZA: folds 
dfNim92Z6XK1/h5SFW5vDg: folds 
dmYlc+1cjwZMJ7wV+Z0rRg: folds 
Z9AeOQX3yzuSvKAm/xyovg: checks 
*** FLOP *** [Js 5h 4d]
Z9AeOQX3yzuSvKAm/xyovg: bets $0.50
HPEB+AtKw1+C/cxU0o1ciw: folds 
Uncalled bet ($0.50) returned to Z9AeOQX3yzuSvKAm/xyovg
Z9AeOQX3yzuSvKAm/xyovg collected $0.60 from pot
*** SUMMARY ***
Total pot $0.60 | Rake $0 
Board [Js 5h 4d]
Seat 1: dtZ84flFEi4Q+SGrHMJRDQ folded before Flop (didn't bet)
Seat 2: Y2GFAe+PT7xnUUtgqCNDFw folded before Flop (didn't bet)
Seat 3: Z5ZtGOON8kmSdSCll9Z3XA folded before Flop (didn't bet)
Seat 4: HPEB+AtKw1+C/cxU0o1ciw folded on the Flop
Seat 5: sx0lGrkT9fd4yFR+3cXUQg folded before Flop (didn't bet)
Seat 6: QEbIGci+itdw+re8RM5fZA folded before Flop (didn't bet)
Seat 7: dfNim92Z6XK1/h5SFW5vDg (button) folded before Flop (didn't bet)
Seat 8: dmYlc+1cjwZMJ7wV+Z0rRg (small blind) folded before Flop
Seat 9: Z9AeOQX3yzuSvKAm/xyovg (big blind) collected ($0.60)




PokerStars Game #59941753932:  Hold'em No Limit ($0.10/$0.25) - 2009/07/01 1:45:05 ET
Table 'L5GvbdQO5aCZJSE6pyQ8OA' 6-max Seat #4 is the button
Seat 1: eFj4lr1nuXLyCWNTShr1bg ($11.10 in chips) 
Seat 2: DihMHaz4WNETH1bPDe13kA ($31.30 in chips) 
Seat 3: JFIAqU8lCZ0vWwEl4bdGsg ($25.45 in chips) 
Seat 4: trN/oHqTTbPw5MNuKrOpLw ($28.30 in chips) 
Seat 5: LyDHtw3/yniNHW+DvLXbog ($26.75 in chips) 
Seat 6: v+QfkGiuj9bgtuNoVnDO8w ($39.40 in chips) 
LyDHtw3/yniNHW+DvLXbog: posts small blind $0.10
v+QfkGiuj9bgtuNoVnDO8w: posts big blind $0.25
*** HOLE CARDS ***
eFj4lr1nuXLyCWNTShr1bg: raises $0.50 to $0.75
DihMHaz4WNETH1bPDe13kA: folds 
JFIAqU8lCZ0vWwEl4bdGsg: folds 
trN/oHqTTbPw5MNuKrOpLw: folds 
LyDHtw3/yniNHW+DvLXbog: folds 
v+QfkGiuj9bgtuNoVnDO8w: folds 
Uncalled bet ($0.50) returned to eFj4lr1nuXLyCWNTShr1bg
eFj4lr1nuXLyCWNTShr1bg collected $0.60 from pot
eFj4lr1nuXLyCWNTShr1bg: doesn't show hand 
*** SUMMARY ***
Total pot $0.60 | Rake $0 
Seat 1: eFj4lr1nuXLyCWNTShr1bg collected ($0.60)
Seat 2: DihMHaz4WNETH1bPDe13kA folded before Flop (didn't bet)
Seat 3: JFIAqU8lCZ0vWwEl4bdGsg folded before Flop (didn't bet)
Seat 4: trN/oHqTTbPw5MNuKrOpLw (button) folded before Flop (didn't bet)
Seat 5: LyDHtw3/yniNHW+DvLXbog (small blind) folded before Flop
Seat 6: v+QfkGiuj9bgtuNoVnDO8w (big blind) folded before Flop




PokerStars Game #59941753646:  Hold'em No Limit ($0.10/$0.25) - 2009/07/01 1:45:05 ET
Table 'ggwTHpIC5qhhHJSYjK1XCw' 6-max Seat #2 is the button
Seat 1: MqMK8OWPSY1V4stf1Hy5Jw ($80 in chips) 
Seat 2: /gJNBeCkWL4o85/jvlZ4BA ($25.95 in chips) 
Seat 3: SxIIgwXYLkwd6m3wLyPTCw ($69.45 in chips) 
Seat 4: JFIAqU8lCZ0vWwEl4bdGsg ($25.60 in chips) 
Seat 5: BvqhBa7W/To51LhEiIU/lw ($5.40 in chips) 
Seat 6: 732E3Iz0geWMK40ej+U9HA ($10.40 in chips) 
SxIIgwXYLkwd6m3wLyPTCw: posts small blind $0.10
JFIAqU8lCZ0vWwEl4bdGsg: posts big blind $0.25
*** HOLE CARDS ***
BvqhBa7W/To51LhEiIU/lw: calls $0.25
732E3Iz0geWMK40ej+U9HA: calls $0.25
MqMK8OWPSY1V4stf1Hy5Jw: folds 
/gJNBeCkWL4o85/jvlZ4BA: folds 
SxIIgwXYLkwd6m3wLyPTCw: folds 
JFIAqU8lCZ0vWwEl4bdGsg: checks 
*** FLOP *** [Qs Jh Qc]
JFIAqU8lCZ0vWwEl4bdGsg: checks 
BvqhBa7W/To51LhEiIU/lw: checks 
732E3Iz0geWMK40ej+U9HA: checks 
*** TURN *** [Qs Jh Qc] [5s]
JFIAqU8lCZ0vWwEl4bdGsg: checks 
BvqhBa7W/To51LhEiIU/lw: bets $0.25
732E3Iz0geWMK40ej+U9HA: calls $0.25
JFIAqU8lCZ0vWwEl4bdGsg: calls $0.25
*** RIVER *** [Qs Jh Qc 5s] [Ad]
JFIAqU8lCZ0vWwEl4bdGsg: checks 
BvqhBa7W/To51LhEiIU/lw: bets $0.25
732E3Iz0geWMK40ej+U9HA: folds 
JFIAqU8lCZ0vWwEl4bdGsg: folds 
Uncalled bet ($0.25) returned to BvqhBa7W/To51LhEiIU/lw
732E3Iz0geWMK40ej+U9HA is sitting out
BvqhBa7W/To51LhEiIU/lw collected $1.55 from pot
BvqhBa7W/To51LhEiIU/lw: doesn't show hand 
*** SUMMARY ***
Total pot $1.60 | Rake $0.05 
Board [Qs Jh Qc 5s Ad]
Seat 1: MqMK8OWPSY1V4stf1Hy5Jw folded before Flop (didn't bet)
Seat 2: /gJNBeCkWL4o85/jvlZ4BA (button) folded before Flop (didn't bet)
Seat 3: SxIIgwXYLkwd6m3wLyPTCw (small blind) folded before Flop
Seat 4: JFIAqU8lCZ0vWwEl4bdGsg (big blind) folded on the River
Seat 5: BvqhBa7W/To51LhEiIU/lw collected ($1.55)
Seat 6: 732E3Iz0geWMK40ej+U9HA folded on the River




PokerStars Game #59941753828:  Hold'em No Limit ($0.10/$0.25) - 2009/07/01 1:45:05 ET
Table 'IRgQPZVA4+IaZZIQshgwyg' 6-max Seat #6 is the button
Seat 1: cezpHJ8FB07dj0xG+LhOvw ($27.65 in chips) 
Seat 2: lquriepNQBhDV5P1SWHhnA ($25 in chips) 
Seat 3: DihMHaz4WNETH1bPDe13kA ($27.45 in chips) 
Seat 4: DE9hRlt14g+JdsRQ4wT7hg ($27.15 in chips) 
Seat 5: PbMzPZIePKifKQZfKDkbIw ($37.10 in chips) 
Seat 6: XbIIdTtuN1xO7zurECHBTg ($7.65 in chips) 
cezpHJ8FB07dj0xG+LhOvw: posts small blind $0.10
lquriepNQBhDV5P1SWHhnA: posts big blind $0.25
*** HOLE CARDS ***
DihMHaz4WNETH1bPDe13kA: folds 
DE9hRlt14g+JdsRQ4wT7hg: folds 
PbMzPZIePKifKQZfKDkbIw: folds 
XbIIdTtuN1xO7zurECHBTg: folds 
XbIIdTtuN1xO7zurECHBTg is sitting out
cezpHJ8FB07dj0xG+LhOvw: folds 
Uncalled bet ($0.15) returned to lquriepNQBhDV5P1SWHhnA
lquriepNQBhDV5P1SWHhnA collected $0.20 from pot
lquriepNQBhDV5P1SWHhnA: doesn't show hand 
XbIIdTtuN1xO7zurECHBTg leaves the table
*** SUMMARY ***
Total pot $0.20 | Rake $0 
Seat 1: cezpHJ8FB07dj0xG+LhOvw (small blind) folded before Flop
Seat 2: lquriepNQBhDV5P1SWHhnA (big blind) collected ($0.20)
Seat 3: DihMHaz4WNETH1bPDe13kA folded before Flop (didn't bet)
Seat 4: DE9hRlt14g+JdsRQ4wT7hg folded before Flop (didn't bet)
Seat 5: PbMzPZIePKifKQZfKDkbIw folded before Flop (didn't bet)
Seat 6: XbIIdTtuN1xO7zurECHBTg (button) folded before Flop (didn't bet)




PokerStars Game #59941754276:  Hold'em No Limit ($0.10/$0.25) - 2009/07/01 1:45:06 ET
Table 'FuFyQHmlO/QqQp//rDRrPg' 6-max Seat #3 is the button
Seat 1: jp34e617tIzV8tKIWmfAbA ($27.40 in chips) 
Seat 2: G3h3THGB1j3qdHDVHpnJWg ($31.35 in chips) 
Seat 3: EeUZtMU058v2ObUACOF4Og ($29.85 in chips) 
Seat 4: Ahsa9Yk5NPmCqQstq1EoQA ($23.20 in chips) 
Seat 5: xrf8tAXKQHG99HixCot1Iw ($25.60 in chips) 
Seat 6: 6DwBRH+xZ12AAZmeAg+aXw ($49.55 in chips) 
Ahsa9Yk5NPmCqQstq1EoQA: posts small blind $0.10
xrf8tAXKQHG99HixCot1Iw: posts big blind $0.25
*** HOLE CARDS ***
6DwBRH+xZ12AAZmeAg+aXw: raises $0.50 to $0.75
jp34e617tIzV8tKIWmfAbA: folds 
G3h3THGB1j3qdHDVHpnJWg: folds 
EeUZtMU058v2ObUACOF4Og: folds 
Ahsa9Yk5NPmCqQstq1EoQA: calls $0.65
xrf8tAXKQHG99HixCot1Iw: folds 
*** FLOP *** [4d 4c 9c]
Ahsa9Yk5NPmCqQstq1EoQA: bets $0.25
6DwBRH+xZ12AAZmeAg+aXw: raises $1 to $1.25
Ahsa9Yk5NPmCqQstq1EoQA: calls $1
*** TURN *** [4d 4c 9c] [Td]
Ahsa9Yk5NPmCqQstq1EoQA: checks 
6DwBRH+xZ12AAZmeAg+aXw: bets $2.75
Ahsa9Yk5NPmCqQstq1EoQA: folds 
Uncalled bet ($2.75) returned to 6DwBRH+xZ12AAZmeAg+aXw
6DwBRH+xZ12AAZmeAg+aXw collected $4.05 from pot
6DwBRH+xZ12AAZmeAg+aXw: doesn't show hand 
*** SUMMARY ***
Total pot $4.25 | Rake $0.20 
Board [4d 4c 9c Td]
Seat 1: jp34e617tIzV8tKIWmfAbA folded before Flop (didn't bet)
Seat 2: G3h3THGB1j3qdHDVHpnJWg folded before Flop (didn't bet)
Seat 3: EeUZtMU058v2ObUACOF4Og (button) folded before Flop (didn't bet)
Seat 4: Ahsa9Yk5NPmCqQstq1EoQA (small blind) folded on the Turn
Seat 5: xrf8tAXKQHG99HixCot1Iw (big blind) folded before Flop
Seat 6: 6DwBRH+xZ12AAZmeAg+aXw collected ($4.05)




PokerStars Game #59941754518:  Hold'em No Limit ($0.10/$0.25) - 2009/07/01 1:45:06 ET
Table 'VuY5ej47Cy8nOI3Wogmhzw' 6-max Seat #4 is the button
Seat 1: EeUZtMU058v2ObUACOF4Og ($37.85 in chips) 
Seat 2: AM6Yl+3esmhhMBlSnQhWbg ($17.85 in chips) 
Seat 3: v+QfkGiuj9bgtuNoVnDO8w ($28.05 in chips) 
Seat 4: QqiZLFrN8iOUT/GHw7ztOA ($25 in chips) 
Seat 5: iK/41//HmnLiIn0CVNNfyA ($14.20 in chips) 
Seat 6: +KblIivb6tainScpwm14RQ ($6.75 in chips) 
iK/41//HmnLiIn0CVNNfyA: posts small blind $0.10
+KblIivb6tainScpwm14RQ: posts big blind $0.25
*** HOLE CARDS ***
EeUZtMU058v2ObUACOF4Og: folds 
AM6Yl+3esmhhMBlSnQhWbg: folds 
v+QfkGiuj9bgtuNoVnDO8w: folds 
QqiZLFrN8iOUT/GHw7ztOA: folds 
iK/41//HmnLiIn0CVNNfyA: folds 
Uncalled bet ($0.15) returned to +KblIivb6tainScpwm14RQ
+KblIivb6tainScpwm14RQ collected $0.20 from pot
*** SUMMARY ***
Total pot $0.20 | Rake $0 
Seat 1: EeUZtMU058v2ObUACOF4Og folded before Flop (didn't bet)
Seat 2: AM6Yl+3esmhhMBlSnQhWbg folded before Flop (didn't bet)
Seat 3: v+QfkGiuj9bgtuNoVnDO8w folded before Flop (didn't bet)
Seat 4: QqiZLFrN8iOUT/GHw7ztOA (button) folded before Flop (didn't bet)
Seat 5: iK/41//HmnLiIn0CVNNfyA (small blind) folded before Flop
Seat 6: +KblIivb6tainScpwm14RQ (big blind) collected ($0.20)




PokerStars Game #59941754254:  Hold'em No Limit ($0.10/$0.25) - 2009/07/01 1:45:06 ET
Table 'tANpk8z1C5o0Pq/hpYShHw' 9-max Seat #4 is the button
Seat 1: rQhYIYXSyH/IivYM1dlV5A ($16.90 in chips) 
Seat 2: og4yH4sZUZdC8jjgW8zPJQ ($8.60 in chips) 
Seat 4: j4q3p0lesp63b1gZDwLBZw ($5 in chips) 
Seat 5: X6+pSIPfovPcE87t+LmUKQ ($4.50 in chips) 
Seat 6: kN0AWJG6biW8tHtuF+wTjA ($15.05 in chips) 
Seat 7: aNpwfA31EREwO+ar4XzBCw ($27.30 in chips) 
Seat 9: gE5rN2TDY1aXcZn/TOPeZw ($7.95 in chips) 
X6+pSIPfovPcE87t+LmUKQ: posts small blind $0.10
kN0AWJG6biW8tHtuF+wTjA: posts big blind $0.25
Z9W7+g1WMhhZDi7DwGbCFA: sits out 
*** HOLE CARDS ***
aNpwfA31EREwO+ar4XzBCw: folds 
gE5rN2TDY1aXcZn/TOPeZw: folds 
rQhYIYXSyH/IivYM1dlV5A: folds 
og4yH4sZUZdC8jjgW8zPJQ: folds 
j4q3p0lesp63b1gZDwLBZw: folds 
X6+pSIPfovPcE87t+LmUKQ: calls $0.15
zDrucyjVn5aeekNEc3cJrA has returned
kN0AWJG6biW8tHtuF+wTjA: raises $0.25 to $0.50
X6+pSIPfovPcE87t+LmUKQ: raises $4 to $4.50 and is all-in
kN0AWJG6biW8tHtuF+wTjA: calls $4
*** FLOP *** [6s 7s 6d]
*** TURN *** [6s 7s 6d] [5s]
*** RIVER *** [6s 7s 6d 5s] [4h]
*** SHOW DOWN ***
X6+pSIPfovPcE87t+LmUKQ: shows [Ad Ks] (a pair of Sixes)
kN0AWJG6biW8tHtuF+wTjA: mucks hand 
X6+pSIPfovPcE87t+LmUKQ collected $8.55 from pot
*** SUMMARY ***
Total pot $9 | Rake $0.45 
Board [6s 7s 6d 5s 4h]
Seat 1: rQhYIYXSyH/IivYM1dlV5A folded before Flop (didn't bet)
Seat 2: og4yH4sZUZdC8jjgW8zPJQ folded before Flop (didn't bet)
Seat 4: j4q3p0lesp63b1gZDwLBZw (button) folded before Flop (didn't bet)
Seat 5: X6+pSIPfovPcE87t+LmUKQ (small blind) showed [Ad Ks] and won ($8.55) with a pair of Sixes
Seat 6: kN0AWJG6biW8tHtuF+wTjA (big blind) mucked
Seat 7: aNpwfA31EREwO+ar4XzBCw folded before Flop (didn't bet)
Seat 9: gE5rN2TDY1aXcZn/TOPeZw folded before Flop (didn't bet)




PokerStars Game #59941754080:  Hold'em No Limit ($0.10/$0.25) - 2009/07/01 1:45:06 ET
Table 'rtxA1Y01Nrq5VoyzTAuusQ' 9-max Seat #3 is the button
Seat 1: w1ukf8uPa4+WH561TtVRxA ($26.55 in chips) 
Seat 2: Th3FldXKQW6hWVVPahaoOQ ($25 in chips) 
Seat 3: K9fS1IUr5GpiJG7VkJ7IbA ($4.90 in chips) 
Seat 4: RHqgdFvufLCYe54+qd2gcA ($4.75 in chips) 
Seat 5: MtVtHDqIJTyUcXkRBBDIVA ($32.40 in chips) 
Seat 7: 3PmVnC/15cl4oyI1TKIt4g ($9.65 in chips) 
Seat 8: DnDcAdn9P0zGovMERigpFA ($25.35 in chips) 
Seat 9: HPEB+AtKw1+C/cxU0o1ciw ($22.95 in chips) 
RHqgdFvufLCYe54+qd2gcA: posts small blind $0.10
MtVtHDqIJTyUcXkRBBDIVA: posts big blind $0.25
*** HOLE CARDS ***
3PmVnC/15cl4oyI1TKIt4g: folds 
DnDcAdn9P0zGovMERigpFA: folds 
HPEB+AtKw1+C/cxU0o1ciw: calls $0.25
w1ukf8uPa4+WH561TtVRxA: folds 
Th3FldXKQW6hWVVPahaoOQ: folds 
K9fS1IUr5GpiJG7VkJ7IbA: calls $0.25
RHqgdFvufLCYe54+qd2gcA: folds 
MtVtHDqIJTyUcXkRBBDIVA: raises $1.50 to $1.75
HPEB+AtKw1+C/cxU0o1ciw: folds 
K9fS1IUr5GpiJG7VkJ7IbA: folds 
Uncalled bet ($1.50) returned to MtVtHDqIJTyUcXkRBBDIVA
MtVtHDqIJTyUcXkRBBDIVA collected $0.85 from pot
MtVtHDqIJTyUcXkRBBDIVA: doesn't show hand 
*** SUMMARY ***
Total pot $0.85 | Rake $0 
Seat 1: w1ukf8uPa4+WH561TtVRxA folded before Flop (didn't bet)
Seat 2: Th3FldXKQW6hWVVPahaoOQ folded before Flop (didn't bet)
Seat 3: K9fS1IUr5GpiJG7VkJ7IbA (button) folded before Flop
Seat 4: RHqgdFvufLCYe54+qd2gcA (small blind) folded before Flop
Seat 5: MtVtHDqIJTyUcXkRBBDIVA (big blind) collected ($0.85)
Seat 7: 3PmVnC/15cl4oyI1TKIt4g folded before Flop (didn't bet)
Seat 8: DnDcAdn9P0zGovMERigpFA folded before Flop (didn't bet)
Seat 9: HPEB+AtKw1+C/cxU0o1ciw folded before Flop




PokerStars Game #59941754330:  Hold'em No Limit ($0.10/$0.25) - 2009/07/01 1:45:06 ET
Table 'CBnRhp0d6E2+/NtM7Vbruw' 9-max Seat #5 is the button
Seat 1: WQe4GbiYBiPsb5WKFKkijQ ($10.75 in chips) 
Seat 2: cZ99hugmLBj9KhTlc8nCSw ($26.85 in chips) 
Seat 3: aNpwfA31EREwO+ar4XzBCw ($33.70 in chips) 
Seat 5: CT7Xj/V/O5rBlhtt+RZeFQ ($25 in chips) 
Seat 6: CvL9Ch1HYCVbTsfpNucitg ($4.40 in chips) 
Seat 7: j4q3p0lesp63b1gZDwLBZw ($5 in chips) 
Seat 8: MG90wfSJZnOejs/KD3vlQQ ($25 in chips) 
Seat 9: xHZZRLAaFUIC8WWI8ljOJA ($29.90 in chips) 
CvL9Ch1HYCVbTsfpNucitg: posts small blind $0.10
j4q3p0lesp63b1gZDwLBZw: posts big blind $0.25
*** HOLE CARDS ***
MG90wfSJZnOejs/KD3vlQQ: folds 
xHZZRLAaFUIC8WWI8ljOJA: folds 
WQe4GbiYBiPsb5WKFKkijQ: folds 
cZ99hugmLBj9KhTlc8nCSw: folds 
aNpwfA31EREwO+ar4XzBCw: folds 
CT7Xj/V/O5rBlhtt+RZeFQ: folds 
CvL9Ch1HYCVbTsfpNucitg: folds 
Uncalled bet ($0.15) returned to j4q3p0lesp63b1gZDwLBZw
j4q3p0lesp63b1gZDwLBZw collected $0.20 from pot
j4q3p0lesp63b1gZDwLBZw: doesn't show hand 
*** SUMMARY ***
Total pot $0.20 | Rake $0 
Seat 1: WQe4GbiYBiPsb5WKFKkijQ folded before Flop (didn't bet)
Seat 2: cZ99hugmLBj9KhTlc8nCSw folded before Flop (didn't bet)
Seat 3: aNpwfA31EREwO+ar4XzBCw folded before Flop (didn't bet)
Seat 5: CT7Xj/V/O5rBlhtt+RZeFQ (button) folded before Flop (didn't bet)
Seat 6: CvL9Ch1HYCVbTsfpNucitg (small blind) folded before Flop
Seat 7: j4q3p0lesp63b1gZDwLBZw (big blind) collected ($0.20)
Seat 8: MG90wfSJZnOejs/KD3vlQQ folded before Flop (didn't bet)
Seat 9: xHZZRLAaFUIC8WWI8ljOJA folded before Flop (didn't bet)




PokerStars Game #59941754048:  Hold'em No Limit ($0.10/$0.25) - 2009/07/01 1:45:06 ET
Table 'vud0GB/ZlDCvUFhBFIaTlg' 9-max Seat #7 is the button
Seat 1: DiSvPC2iudwL5j9u6Huyww ($28.50 in chips) 
Seat 2: tLcDklc2rBORNfixyRfVfw ($26.30 in chips) 
Seat 3: W2YYHvqjaEpRrO7stZkClQ ($4.30 in chips) 
Seat 4: dWgEDExmVO0d+rRmUYCU5w ($15.35 in chips) 
Seat 5: eK8qa6EPcH2zhtbmWSvc9g ($25 in chips) 
Seat 6: gehe91e0IyVT0QU/XBkEyg ($25 in chips) 
Seat 7: iG7VeTyBWf6wYNvZpbTcbw ($20.05 in chips) 
Seat 9: PdIasPkzm2sqZnN41ZRXOg ($5.45 in chips) 
E0iYnEVO2ho7dH3QcCjw7g will be allowed to play after the button
PdIasPkzm2sqZnN41ZRXOg: posts small blind $0.10
DiSvPC2iudwL5j9u6Huyww: posts big blind $0.25
*** HOLE CARDS ***
tLcDklc2rBORNfixyRfVfw: folds 
W2YYHvqjaEpRrO7stZkClQ: folds 
dWgEDExmVO0d+rRmUYCU5w: folds 
eK8qa6EPcH2zhtbmWSvc9g: calls $0.25
gehe91e0IyVT0QU/XBkEyg: folds 
iG7VeTyBWf6wYNvZpbTcbw: folds 
PdIasPkzm2sqZnN41ZRXOg: calls $0.15
DiSvPC2iudwL5j9u6Huyww: checks 
*** FLOP *** [3h Kc Tc]
PdIasPkzm2sqZnN41ZRXOg: checks 
DiSvPC2iudwL5j9u6Huyww: bets $0.25
eK8qa6EPcH2zhtbmWSvc9g: folds 
PdIasPkzm2sqZnN41ZRXOg: folds 
Uncalled bet ($0.25) returned to DiSvPC2iudwL5j9u6Huyww
DiSvPC2iudwL5j9u6Huyww collected $0.75 from pot
DiSvPC2iudwL5j9u6Huyww: doesn't show hand 
*** SUMMARY ***
Total pot $0.75 | Rake $0 
Board [3h Kc Tc]
Seat 1: DiSvPC2iudwL5j9u6Huyww (big blind) collected ($0.75)
Seat 2: tLcDklc2rBORNfixyRfVfw folded before Flop (didn't bet)
Seat 3: W2YYHvqjaEpRrO7stZkClQ folded before Flop (didn't bet)
Seat 4: dWgEDExmVO0d+rRmUYCU5w folded before Flop (didn't bet)
Seat 5: eK8qa6EPcH2zhtbmWSvc9g folded on the Flop
Seat 6: gehe91e0IyVT0QU/XBkEyg folded before Flop (didn't bet)
Seat 7: iG7VeTyBWf6wYNvZpbTcbw (button) folded before Flop (didn't bet)
Seat 9: PdIasPkzm2sqZnN41ZRXOg (small blind) folded on the Flop




PokerStars Game #59941754174:  Hold'em No Limit ($0.10/$0.25) - 2009/07/01 1:45:06 ET
Table 'Qr+t8WGovMECkBv+cV1lrg' 6-max Seat #3 is the button
Seat 1: EeUZtMU058v2ObUACOF4Og ($44.75 in chips) 
Seat 2: vqWjZmdQu/Hxw96/IJTWdQ ($25 in chips) 
Seat 3: uZKkrGByYgd4/ZBX2d4z+w ($26.65 in chips) 
Seat 4: 1NNFfYMd5Hsphl/FYz9fNA ($62.15 in chips) 
Seat 5: 9q7YGTKe9k5fYb4fmZc3Ww ($32.35 in chips) 
1NNFfYMd5Hsphl/FYz9fNA: posts small blind $0.10
9q7YGTKe9k5fYb4fmZc3Ww: posts big blind $0.25
9U3ZKjCsarN0DjR6mSE8Ug: sits out 
*** HOLE CARDS ***
EeUZtMU058v2ObUACOF4Og: folds 
vqWjZmdQu/Hxw96/IJTWdQ: folds 
uZKkrGByYgd4/ZBX2d4z+w: calls $0.25
1NNFfYMd5Hsphl/FYz9fNA: calls $0.15
9q7YGTKe9k5fYb4fmZc3Ww: checks 
*** FLOP *** [6s 7h Qd]
1NNFfYMd5Hsphl/FYz9fNA: checks 
9q7YGTKe9k5fYb4fmZc3Ww: checks 
uZKkrGByYgd4/ZBX2d4z+w: checks 
*** TURN *** [6s 7h Qd] [8c]
1NNFfYMd5Hsphl/FYz9fNA: bets $0.50
9q7YGTKe9k5fYb4fmZc3Ww: folds 
uZKkrGByYgd4/ZBX2d4z+w: folds 
Uncalled bet ($0.50) returned to 1NNFfYMd5Hsphl/FYz9fNA
1NNFfYMd5Hsphl/FYz9fNA collected $0.75 from pot
1NNFfYMd5Hsphl/FYz9fNA: doesn't show hand 
*** SUMMARY ***
Total pot $0.75 | Rake $0 
Board [6s 7h Qd 8c]
Seat 1: EeUZtMU058v2ObUACOF4Og folded before Flop (didn't bet)
Seat 2: vqWjZmdQu/Hxw96/IJTWdQ folded before Flop (didn't bet)
Seat 3: uZKkrGByYgd4/ZBX2d4z+w (button) folded on the Turn
Seat 4: 1NNFfYMd5Hsphl/FYz9fNA (small blind) collected ($0.75)
Seat 5: 9q7YGTKe9k5fYb4fmZc3Ww (big blind) folded on the Turn




PokerStars Game #59941754866:  Hold'em No Limit ($0.10/$0.25) - 2009/07/01 1:45:07 ET
Table '52Meibn9NOL4XtVi1p2UpwpyZQRcpxhWj2y2cT/ydvwwx Seat #3 is the button
Seat 1: egvg3mTBBVzMHnJPIQiKcA ($16.30 in chips) 
Seat 2: Th3FldXKQW6hWVVPahaoOQ ($98.10 in chips) 
Seat 3: zgi+EUykT/pZQpoUG6+oEg ($4.30 in chips) 
Seat 4: NjesyqE7PJi4nEOa0oOq9w ($15.85 in chips) 
Seat 5: 5n7e7I+px7c6CQmLpPbtsg ($4.70 in chips) 
Seat 7: sGFnnRCa1YAHAUmWgsW6Qg ($9.50 in chips) 
Seat 8: ipgcO7Pa6LC8XWpVttZfnA ($5 in chips) 
Seat 9: bC+Wg1ntzw3N48OwuR1eag ($8.40 in chips) 
NjesyqE7PJi4nEOa0oOq9w: posts small blind $0.10
5n7e7I+px7c6CQmLpPbtsg: posts big blind $0.25
uvfXVx90QtCYG4geTioN+A: sits out 
*** HOLE CARDS ***
sGFnnRCa1YAHAUmWgsW6Qg: folds 
ipgcO7Pa6LC8XWpVttZfnA: folds 
bC+Wg1ntzw3N48OwuR1eag: raises $0.25 to $0.50
egvg3mTBBVzMHnJPIQiKcA: folds 
Th3FldXKQW6hWVVPahaoOQ: calls $0.50
zgi+EUykT/pZQpoUG6+oEg: folds 
NjesyqE7PJi4nEOa0oOq9w: calls $0.40
5n7e7I+px7c6CQmLpPbtsg: folds 
*** FLOP *** [Th Qc 2d]
NjesyqE7PJi4nEOa0oOq9w: checks 
bC+Wg1ntzw3N48OwuR1eag: checks 
Th3FldXKQW6hWVVPahaoOQ: checks 
*** TURN *** [Th Qc 2d] [Kh]
NjesyqE7PJi4nEOa0oOq9w: bets $0.50
bC+Wg1ntzw3N48OwuR1eag: calls $0.50
Th3FldXKQW6hWVVPahaoOQ: raises $1.75 to $2.25
NjesyqE7PJi4nEOa0oOq9w: folds 
bC+Wg1ntzw3N48OwuR1eag: calls $1.75
*** RIVER *** [Th Qc 2d Kh] [Kc]
bC+Wg1ntzw3N48OwuR1eag: checks 
Th3FldXKQW6hWVVPahaoOQ: bets $95.35 and is all-in
bC+Wg1ntzw3N48OwuR1eag: folds 
Uncalled bet ($95.35) returned to Th3FldXKQW6hWVVPahaoOQ
Th3FldXKQW6hWVVPahaoOQ collected $6.45 from pot
Th3FldXKQW6hWVVPahaoOQ: doesn't show hand 
*** SUMMARY ***
Total pot $6.75 | Rake $0.30 
Board [Th Qc 2d Kh Kc]
Seat 1: egvg3mTBBVzMHnJPIQiKcA folded before Flop (didn't bet)
Seat 2: Th3FldXKQW6hWVVPahaoOQ collected ($6.45)
Seat 3: zgi+EUykT/pZQpoUG6+oEg (button) folded before Flop (didn't bet)
Seat 4: NjesyqE7PJi4nEOa0oOq9w (small blind) folded on the Turn
Seat 5: 5n7e7I+px7c6CQmLpPbtsg (big blind) folded before Flop
Seat 7: sGFnnRCa1YAHAUmWgsW6Qg folded before Flop (didn't bet)
Seat 8: ipgcO7Pa6LC8XWpVttZfnA folded before Flop (didn't bet)
Seat 9: bC+Wg1ntzw3N48OwuR1eag folded on the River




PokerStars Game #59941754700:  Hold'em No Limit ($0.10/$0.25) - 2009/07/01 1:45:07 ET
Table 'sSe6q4YTb/iS19t2eCFdsA' 9-max Seat #2 is the button
Seat 1: hJ4uYjNmSZdjrKA8cjZqCA ($19.50 in chips) 
Seat 2: 3l+i+xMeyDndSXMF2A5CDA ($5 in chips) 
Seat 4: 22dIObOuor/A+IKWkNoAlA ($8.60 in chips) 
Seat 5: qS+jfnNoG75bT+uQ8CKhQA ($10.05 in chips) 
Seat 6: tYsOBqdU1+x+yFI7zHO7hQ ($27.35 in chips) 
Seat 7: t70KGeRtR3naHSqKDixsUg ($4.50 in chips) 
Seat 8: hvXZ0zFPZFP8Hf6dS36YEw ($15.40 in chips) 
Seat 9: Z9W7+g1WMhhZDi7DwGbCFA ($5 in chips) 
OXPkK84/qv92EMwXPiG5rQ will be allowed to play after the button
22dIObOuor/A+IKWkNoAlA: posts small blind $0.10
qS+jfnNoG75bT+uQ8CKhQA: posts big blind $0.25
*** HOLE CARDS ***
tYsOBqdU1+x+yFI7zHO7hQ: folds 
t70KGeRtR3naHSqKDixsUg: calls $0.25
hvXZ0zFPZFP8Hf6dS36YEw: folds 
Z9W7+g1WMhhZDi7DwGbCFA: folds 
hJ4uYjNmSZdjrKA8cjZqCA: folds 
3l+i+xMeyDndSXMF2A5CDA: raises $0.75 to $1
22dIObOuor/A+IKWkNoAlA: folds 
qS+jfnNoG75bT+uQ8CKhQA: folds 
t70KGeRtR3naHSqKDixsUg: calls $0.75
*** FLOP *** [5s Kh Ah]
t70KGeRtR3naHSqKDixsUg: checks 
3l+i+xMeyDndSXMF2A5CDA: bets $1.25
t70KGeRtR3naHSqKDixsUg: folds 
Uncalled bet ($1.25) returned to 3l+i+xMeyDndSXMF2A5CDA
3l+i+xMeyDndSXMF2A5CDA collected $2.25 from pot
3l+i+xMeyDndSXMF2A5CDA: doesn't show hand 
*** SUMMARY ***
Total pot $2.35 | Rake $0.10 
Board [5s Kh Ah]
Seat 1: hJ4uYjNmSZdjrKA8cjZqCA folded before Flop (didn't bet)
Seat 2: 3l+i+xMeyDndSXMF2A5CDA (button) collected ($2.25)
Seat 4: 22dIObOuor/A+IKWkNoAlA (small blind) folded before Flop
Seat 5: qS+jfnNoG75bT+uQ8CKhQA (big blind) folded before Flop
Seat 6: tYsOBqdU1+x+yFI7zHO7hQ folded before Flop (didn't bet)
Seat 7: t70KGeRtR3naHSqKDixsUg folded on the Flop
Seat 8: hvXZ0zFPZFP8Hf6dS36YEw folded before Flop (didn't bet)
Seat 9: Z9W7+g1WMhhZDi7DwGbCFA folded before Flop (didn't bet)




PokerStars Game #59941754698:  Hold'em No Limit ($0.10/$0.25) - 2009/07/01 1:45:07 ET
Table 'nQC9LRg01NEuKFHF1nrDEw0XPo7K54oZIfG0xlNAcDRw-max Seat #1 is the button
Seat 1: qf+LMbROj8/qY878wkFHbQ ($14.80 in chips) 
Seat 2: ZhV6dUX9NQhT4zf7t+ZLJg ($22 in chips) 
Seat 3: 6+g0Lb6vfRDZkElV8ieHyQ ($24.85 in chips) 
Seat 5: kG34n23qFQA3nzdOJTQ1dA ($29.05 in chips) 
Seat 6: xQVFeVUDopz+akuEo2wXpQ ($55.60 in chips) 
ZhV6dUX9NQhT4zf7t+ZLJg: posts small blind $0.10
6+g0Lb6vfRDZkElV8ieHyQ: posts big blind $0.25
*** HOLE CARDS ***
kG34n23qFQA3nzdOJTQ1dA: folds 
xQVFeVUDopz+akuEo2wXpQ: calls $0.25
qf+LMbROj8/qY878wkFHbQ: folds 
ZhV6dUX9NQhT4zf7t+ZLJg: calls $0.15
6+g0Lb6vfRDZkElV8ieHyQ: checks 
*** FLOP *** [4h Kd 9d]
ZhV6dUX9NQhT4zf7t+ZLJg: checks 
6+g0Lb6vfRDZkElV8ieHyQ: checks 
xQVFeVUDopz+akuEo2wXpQ: checks 
*** TURN *** [4h Kd 9d] [2h]
ZhV6dUX9NQhT4zf7t+ZLJg: checks 
6+g0Lb6vfRDZkElV8ieHyQ: checks 
xQVFeVUDopz+akuEo2wXpQ: checks 
*** RIVER *** [4h Kd 9d 2h] [Th]
ZhV6dUX9NQhT4zf7t+ZLJg: checks 
6+g0Lb6vfRDZkElV8ieHyQ: checks 
xQVFeVUDopz+akuEo2wXpQ: bets $0.25
ZhV6dUX9NQhT4zf7t+ZLJg: folds 
6+g0Lb6vfRDZkElV8ieHyQ: calls $0.25
*** SHOW DOWN ***
xQVFeVUDopz+akuEo2wXpQ: shows [Qh Tc] (a pair of Tens)
6+g0Lb6vfRDZkElV8ieHyQ: mucks hand 
xQVFeVUDopz+akuEo2wXpQ collected $1.20 from pot
*** SUMMARY ***
Total pot $1.25 | Rake $0.05 
Board [4h Kd 9d 2h Th]
Seat 1: qf+LMbROj8/qY878wkFHbQ (button) folded before Flop (didn't bet)
Seat 2: ZhV6dUX9NQhT4zf7t+ZLJg (small blind) folded on the River
Seat 3: 6+g0Lb6vfRDZkElV8ieHyQ (big blind) mucked
Seat 5: kG34n23qFQA3nzdOJTQ1dA folded before Flop (didn't bet)
Seat 6: xQVFeVUDopz+akuEo2wXpQ showed [Qh Tc] and won ($1.20) with a pair of Tens




PokerStars Game #59941754662:  Hold'em No Limit ($0.10/$0.25) - 2009/07/01 1:45:07 ET
Table 'NtEQAxCeIK2io1CGtW658g' 6-max Seat #1 is the button
Seat 1: X437kMQ7AujoaDgjguhU9w ($12.45 in chips) 
Seat 2: DgyznDqq/mLiCqQGMzc+Aw ($6.25 in chips) 
Seat 4: 8296 ($10.05 in chips) 
Seat 5: Hsvkc0/G2VV78oVmWYXecw ($5 in chips) 
Seat 6: /gJNBeCkWL4o85/jvlZ4BA ($64.35 in chips) 
DgyznDqq/mLiCqQGMzc+Aw: posts small blind $0.10
8296: posts big blind $0.25
*** HOLE CARDS ***
Hsvkc0/G2VV78oVmWYXecw: raises $0.50 to $0.75
/gJNBeCkWL4o85/jvlZ4BA: folds 
X437kMQ7AujoaDgjguhU9w: folds 
DgyznDqq/mLiCqQGMzc+Aw: calls $0.65
8296: folds 
*** FLOP *** [Qc 3c 9s]
DgyznDqq/mLiCqQGMzc+Aw: bets $0.25
Hsvkc0/G2VV78oVmWYXecw: raises $0.75 to $1
DgyznDqq/mLiCqQGMzc+Aw: calls $0.75
*** TURN *** [Qc 3c 9s] [As]
DgyznDqq/mLiCqQGMzc+Aw: checks 
Hsvkc0/G2VV78oVmWYXecw: checks 
*** RIVER *** [Qc 3c 9s As] [6h]
DgyznDqq/mLiCqQGMzc+Aw: bets $1.25
Hsvkc0/G2VV78oVmWYXecw: calls $1.25
*** SHOW DOWN ***
DgyznDqq/mLiCqQGMzc+Aw: shows [9c Ac] (two pair, Aces and Nines)
Hsvkc0/G2VV78oVmWYXecw: mucks hand 
DgyznDqq/mLiCqQGMzc+Aw collected $5.95 from pot
*** SUMMARY ***
Total pot $6.25 | Rake $0.30 
Board [Qc 3c 9s As 6h]
Seat 1: X437kMQ7AujoaDgjguhU9w (button) folded before Flop (didn't bet)
Seat 2: DgyznDqq/mLiCqQGMzc+Aw (small blind) showed [9c Ac] and won ($5.95) with two pair, Aces and Nines
Seat 4: 8296 (big blind) folded before Flop
Seat 5: Hsvkc0/G2VV78oVmWYXecw mucked
Seat 6: /gJNBeCkWL4o85/jvlZ4BA folded before Flop (didn't bet)




PokerStars Game #59941754774:  Hold'em No Limit ($0.10/$0.25) - 2009/07/01 1:45:07 ET
Table 'VQNfcI8vTBCTvRfd3veTLQ' 6-max Seat #2 is the button
Seat 1: QiL+lEgEWwy21jk/ltaRLg ($17.10 in chips) 
Seat 2: 79ID/ub1Pt/mDpCprVmOoA ($31.55 in chips) 
Seat 3: LtASJ9OlkqGrrUKGQlpGAw ($11.50 in chips) 
Seat 4: QIWnfLSqfMcoFfdDe5LZPg ($37.80 in chips) 
Seat 5: gX2vbKwS/8zZPENAWB7hxQ ($24.45 in chips) 
Seat 6: LJI7A1YgDM7hgh7o56+ReQ ($27.70 in chips) 
LtASJ9OlkqGrrUKGQlpGAw: posts small blind $0.10
QIWnfLSqfMcoFfdDe5LZPg: posts big blind $0.25
*** HOLE CARDS ***
gX2vbKwS/8zZPENAWB7hxQ: calls $0.25
LJI7A1YgDM7hgh7o56+ReQ: folds 
QiL+lEgEWwy21jk/ltaRLg: calls $0.25
79ID/ub1Pt/mDpCprVmOoA: folds 
LtASJ9OlkqGrrUKGQlpGAw: calls $0.15
QIWnfLSqfMcoFfdDe5LZPg: raises $0.75 to $1
gX2vbKwS/8zZPENAWB7hxQ: calls $0.75
QiL+lEgEWwy21jk/ltaRLg: calls $0.75
LtASJ9OlkqGrrUKGQlpGAw: folds 
*** FLOP *** [8s As 2s]
QIWnfLSqfMcoFfdDe5LZPg: bets $2
gX2vbKwS/8zZPENAWB7hxQ: folds 
QiL+lEgEWwy21jk/ltaRLg: folds 
Uncalled bet ($2) returned to QIWnfLSqfMcoFfdDe5LZPg
QIWnfLSqfMcoFfdDe5LZPg collected $3.10 from pot
QIWnfLSqfMcoFfdDe5LZPg: doesn't show hand 
*** SUMMARY ***
Total pot $3.25 | Rake $0.15 
Board [8s As 2s]
Seat 1: QiL+lEgEWwy21jk/ltaRLg folded on the Flop
Seat 2: 79ID/ub1Pt/mDpCprVmOoA (button) folded before Flop (didn't bet)
Seat 3: LtASJ9OlkqGrrUKGQlpGAw (small blind) folded before Flop
Seat 4: QIWnfLSqfMcoFfdDe5LZPg (big blind) collected ($3.10)
Seat 5: gX2vbKwS/8zZPENAWB7hxQ folded on the Flop
Seat 6: LJI7A1YgDM7hgh7o56+ReQ folded before Flop (didn't bet)




PokerStars Game #59941754874:  Hold'em No Limit ($0.10/$0.25) - 2009/07/01 1:45:07 ET
Table 'Xi38lWH8L2JHRAsKYVX8Qg' 6-max Seat #2 is the button
Seat 1: shP7DFAtX7gXcgMJX/OmRQ ($18.45 in chips) 
Seat 2: VOmI0x4dDPnTESZd5B4d1Q ($9.10 in chips) 
Seat 3: 6DwBRH+xZ12AAZmeAg+aXw ($35.30 in chips) 
Seat 4: kG34n23qFQA3nzdOJTQ1dA ($24.85 in chips) 
Seat 5: 79ID/ub1Pt/mDpCprVmOoA ($77.95 in chips) 
Seat 6: kyRaCIljYA6l33lSKQfNsg ($29.40 in chips) 
6DwBRH+xZ12AAZmeAg+aXw: posts small blind $0.10
kG34n23qFQA3nzdOJTQ1dA: posts big blind $0.25
*** HOLE CARDS ***
79ID/ub1Pt/mDpCprVmOoA: folds 
kyRaCIljYA6l33lSKQfNsg: folds 
shP7DFAtX7gXcgMJX/OmRQ: calls $0.25
VOmI0x4dDPnTESZd5B4d1Q: folds 
6DwBRH+xZ12AAZmeAg+aXw: folds 
kG34n23qFQA3nzdOJTQ1dA: checks 
*** FLOP *** [4d 6c 4h]
kG34n23qFQA3nzdOJTQ1dA: checks 
shP7DFAtX7gXcgMJX/OmRQ: checks 
*** TURN *** [4d 6c 4h] [Td]
kG34n23qFQA3nzdOJTQ1dA: checks 
shP7DFAtX7gXcgMJX/OmRQ: bets $0.75
kG34n23qFQA3nzdOJTQ1dA: folds 
Uncalled bet ($0.75) returned to shP7DFAtX7gXcgMJX/OmRQ
shP7DFAtX7gXcgMJX/OmRQ collected $0.60 from pot
shP7DFAtX7gXcgMJX/OmRQ: doesn't show hand 
*** SUMMARY ***
Total pot $0.60 | Rake $0 
Board [4d 6c 4h Td]
Seat 1: shP7DFAtX7gXcgMJX/OmRQ collected ($0.60)
Seat 2: VOmI0x4dDPnTESZd5B4d1Q (button) folded before Flop (didn't bet)
Seat 3: 6DwBRH+xZ12AAZmeAg+aXw (small blind) folded before Flop
Seat 4: kG34n23qFQA3nzdOJTQ1dA (big blind) folded on the Turn
Seat 5: 79ID/ub1Pt/mDpCprVmOoA folded before Flop (didn't bet)
Seat 6: kyRaCIljYA6l33lSKQfNsg folded before Flop (didn't bet)




PokerStars Game #59941755454:  Hold'em No Limit ($0.10/$0.25) - 2009/07/01 1:45:08 ET
Table 'NtCSSONEf1zaJo3042tQug' 6-max Seat #5 is the button
Seat 1: KXtdqb+rIMkjc0RvHDksGQ ($35.10 in chips) 
Seat 2: vqWjZmdQu/Hxw96/IJTWdQ ($27.30 in chips) 
Seat 3: 9kUKGKkblnIx3m8rlVol6Q ($15.65 in chips) 
Seat 4: HxD1kB8zCmalQSdWAkKmlg ($28.85 in chips) 
Seat 5: tOAk1Og4mVObMBOfvdDYOw ($30.40 in chips) 
Seat 6: LxehwDpTQ19ph4Qmc78+Pw ($29.10 in chips) 
LxehwDpTQ19ph4Qmc78+Pw: posts small blind $0.10
KXtdqb+rIMkjc0RvHDksGQ: posts big blind $0.25
*** HOLE CARDS ***
vqWjZmdQu/Hxw96/IJTWdQ: raises $0.50 to $0.75
9kUKGKkblnIx3m8rlVol6Q: folds 
HxD1kB8zCmalQSdWAkKmlg: folds 
tOAk1Og4mVObMBOfvdDYOw: folds 
LxehwDpTQ19ph4Qmc78+Pw: folds 
KXtdqb+rIMkjc0RvHDksGQ: calls $0.50
*** FLOP *** [Ks 2s Ad]
KXtdqb+rIMkjc0RvHDksGQ: checks 
vqWjZmdQu/Hxw96/IJTWdQ: checks 
*** TURN *** [Ks 2s Ad] [As]
KXtdqb+rIMkjc0RvHDksGQ: bets $1
vqWjZmdQu/Hxw96/IJTWdQ: folds 
Uncalled bet ($1) returned to KXtdqb+rIMkjc0RvHDksGQ
KXtdqb+rIMkjc0RvHDksGQ collected $1.55 from pot
KXtdqb+rIMkjc0RvHDksGQ: doesn't show hand 
*** SUMMARY ***
Total pot $1.60 | Rake $0.05 
Board [Ks 2s Ad As]
Seat 1: KXtdqb+rIMkjc0RvHDksGQ (big blind) collected ($1.55)
Seat 2: vqWjZmdQu/Hxw96/IJTWdQ folded on the Turn
Seat 3: 9kUKGKkblnIx3m8rlVol6Q folded before Flop (didn't bet)
Seat 4: HxD1kB8zCmalQSdWAkKmlg folded before Flop (didn't bet)
Seat 5: tOAk1Og4mVObMBOfvdDYOw (button) folded before Flop (didn't bet)
Seat 6: LxehwDpTQ19ph4Qmc78+Pw (small blind) folded before Flop




PokerStars Game #59941755586:  Hold'em No Limit ($0.10/$0.25) - 2009/07/01 1:45:08 ET
Table '0w9m+UkNlGMNoPyQqzWk6A' 9-max Seat #6 is the button
Seat 1: yoL2UPRJrmSO7wXIS4Ak4g ($27.85 in chips) 
Seat 2: tYsOBqdU1+x+yFI7zHO7hQ ($50.05 in chips) 
Seat 3: VWwtMkIjXloiX/RKh7RGWQ ($14.30 in chips) 
Seat 5: HPEB+AtKw1+C/cxU0o1ciw ($48.30 in chips) 
Seat 6: CgIo2ItZqi4o3ayVG6HanQ ($29.65 in chips) 
Seat 7: 57qrNGHDvf6GhB8zVLsAtQ ($4.55 in chips) 
Seat 9: KqS/lY/fNB9qUxokm9QfeA ($10.25 in chips) 
57qrNGHDvf6GhB8zVLsAtQ: posts small blind $0.10
KqS/lY/fNB9qUxokm9QfeA: posts big blind $0.25
*** HOLE CARDS ***
yoL2UPRJrmSO7wXIS4Ak4g: raises $0.50 to $0.75
tYsOBqdU1+x+yFI7zHO7hQ: folds 
VWwtMkIjXloiX/RKh7RGWQ: calls $0.75
cZ99hugmLBj9KhTlc8nCSw joins the table at seat #8 
HPEB+AtKw1+C/cxU0o1ciw: folds 
CgIo2ItZqi4o3ayVG6HanQ: folds 
57qrNGHDvf6GhB8zVLsAtQ: folds 
KqS/lY/fNB9qUxokm9QfeA: calls $0.50
*** FLOP *** [7h 4s 5c]
KqS/lY/fNB9qUxokm9QfeA: checks 
yoL2UPRJrmSO7wXIS4Ak4g: bets $2
VWwtMkIjXloiX/RKh7RGWQ: calls $2
KqS/lY/fNB9qUxokm9QfeA: calls $2
*** TURN *** [7h 4s 5c] [Jh]
KqS/lY/fNB9qUxokm9QfeA: checks 
yoL2UPRJrmSO7wXIS4Ak4g: bets $4
VWwtMkIjXloiX/RKh7RGWQ: folds 
KqS/lY/fNB9qUxokm9QfeA: folds 
Uncalled bet ($4) returned to yoL2UPRJrmSO7wXIS4Ak4g
yoL2UPRJrmSO7wXIS4Ak4g collected $7.95 from pot
yoL2UPRJrmSO7wXIS4Ak4g: doesn't show hand 
*** SUMMARY ***
Total pot $8.35 | Rake $0.40 
Board [7h 4s 5c Jh]
Seat 1: yoL2UPRJrmSO7wXIS4Ak4g collected ($7.95)
Seat 2: tYsOBqdU1+x+yFI7zHO7hQ folded before Flop (didn't bet)
Seat 3: VWwtMkIjXloiX/RKh7RGWQ folded on the Turn
Seat 5: HPEB+AtKw1+C/cxU0o1ciw folded before Flop (didn't bet)
Seat 6: CgIo2ItZqi4o3ayVG6HanQ (button) folded before Flop (didn't bet)
Seat 7: 57qrNGHDvf6GhB8zVLsAtQ (small blind) folded before Flop
Seat 9: KqS/lY/fNB9qUxokm9QfeA (big blind) folded on the Turn




PokerStars Game #59941755072:  Hold'em No Limit ($0.10/$0.25) - 2009/07/01 1:45:08 ET
Table '8Z6T3ssCpo3VV849U4RgBw' 9-max Seat #1 is the button
Seat 1: Z9W7+g1WMhhZDi7DwGbCFA ($6.15 in chips) 
Seat 2: SpiiQQAzy4MUgV3I5W8giw ($24.10 in chips) 
Seat 3: tLcDklc2rBORNfixyRfVfw ($41.50 in chips) 
Seat 4: RCqMONFrSPSArZh2Jsar/w ($18.90 in chips) 
Seat 6: sGFnnRCa1YAHAUmWgsW6Qg ($10 in chips) 
Seat 7: oLa/tXLfSLLB28mcLGrxcg ($24.05 in chips) 
Seat 8: PdIasPkzm2sqZnN41ZRXOg ($5.25 in chips) 
Seat 9: HDDm1BkZtdsRyw2DJdqq6A ($22.70 in chips) 
SpiiQQAzy4MUgV3I5W8giw: posts small blind $0.10
tLcDklc2rBORNfixyRfVfw: posts big blind $0.25
*** HOLE CARDS ***
RCqMONFrSPSArZh2Jsar/w: folds 
sGFnnRCa1YAHAUmWgsW6Qg: folds 
oLa/tXLfSLLB28mcLGrxcg: folds 
PdIasPkzm2sqZnN41ZRXOg: folds 
HDDm1BkZtdsRyw2DJdqq6A: calls $0.25
Z9W7+g1WMhhZDi7DwGbCFA: folds 
SpiiQQAzy4MUgV3I5W8giw: calls $0.15
tLcDklc2rBORNfixyRfVfw: checks 
*** FLOP *** [6s 3h Qc]
SpiiQQAzy4MUgV3I5W8giw: bets $0.75
tLcDklc2rBORNfixyRfVfw: folds 
HDDm1BkZtdsRyw2DJdqq6A: calls $0.75
*** TURN *** [6s 3h Qc] [7c]
SpiiQQAzy4MUgV3I5W8giw: bets $2
HDDm1BkZtdsRyw2DJdqq6A: calls $2
*** RIVER *** [6s 3h Qc 7c] [9s]
SpiiQQAzy4MUgV3I5W8giw: checks 
HDDm1BkZtdsRyw2DJdqq6A: bets $2
SpiiQQAzy4MUgV3I5W8giw: calls $2
*** SHOW DOWN ***
HDDm1BkZtdsRyw2DJdqq6A: shows [7s 7d] (three of a kind, Sevens)
SpiiQQAzy4MUgV3I5W8giw: mucks hand 
HDDm1BkZtdsRyw2DJdqq6A collected $9.80 from pot
*** SUMMARY ***
Total pot $10.25 | Rake $0.45 
Board [6s 3h Qc 7c 9s]
Seat 1: Z9W7+g1WMhhZDi7DwGbCFA (button) folded before Flop (didn't bet)
Seat 2: SpiiQQAzy4MUgV3I5W8giw (small blind) mucked
Seat 3: tLcDklc2rBORNfixyRfVfw (big blind) folded on the Flop
Seat 4: RCqMONFrSPSArZh2Jsar/w folded before Flop (didn't bet)
Seat 6: sGFnnRCa1YAHAUmWgsW6Qg folded before Flop (didn't bet)
Seat 7: oLa/tXLfSLLB28mcLGrxcg folded before Flop (didn't bet)
Seat 8: PdIasPkzm2sqZnN41ZRXOg folded before Flop (didn't bet)
Seat 9: HDDm1BkZtdsRyw2DJdqq6A showed [7s 7d] and won ($9.80) with three of a kind, Sevens




PokerStars Game #59941755258:  Hold'em No Limit ($0.10/$0.25) - 2009/07/01 1:45:08 ET
Table 'oJpFwZj9+FUGHX90Un8s9Q' 6-max Seat #5 is the button
Seat 1: 6DwBRH+xZ12AAZmeAg+aXw ($23.65 in chips) 
Seat 2: NtrVQ9UIql0rDCnKDKZ5FQ ($14.80 in chips) 
Seat 3: kyRaCIljYA6l33lSKQfNsg ($27 in chips) 
Seat 4: 6elpmfyt4Zw0yvd8lePSMQ ($21.55 in chips) 
Seat 5: kG34n23qFQA3nzdOJTQ1dA ($55.75 in chips) 
7LpHJVeM6k1mQdC6HXYzww joins the table at seat #6 
6DwBRH+xZ12AAZmeAg+aXw: posts small blind $0.10
NtrVQ9UIql0rDCnKDKZ5FQ: posts big blind $0.25
*** HOLE CARDS ***
kyRaCIljYA6l33lSKQfNsg: raises $0.50 to $0.75
6elpmfyt4Zw0yvd8lePSMQ: folds 
kG34n23qFQA3nzdOJTQ1dA: calls $0.75
6DwBRH+xZ12AAZmeAg+aXw: folds 
NtrVQ9UIql0rDCnKDKZ5FQ: folds 
*** FLOP *** [Ks Ah Kd]
kyRaCIljYA6l33lSKQfNsg: checks 
kG34n23qFQA3nzdOJTQ1dA: checks 
*** TURN *** [Ks Ah Kd] [5c]
kyRaCIljYA6l33lSKQfNsg: checks 
kG34n23qFQA3nzdOJTQ1dA: checks 
*** RIVER *** [Ks Ah Kd 5c] [2d]
kyRaCIljYA6l33lSKQfNsg: checks 
kG34n23qFQA3nzdOJTQ1dA: bets $2
kyRaCIljYA6l33lSKQfNsg: folds 
Uncalled bet ($2) returned to kG34n23qFQA3nzdOJTQ1dA
kG34n23qFQA3nzdOJTQ1dA collected $1.80 from pot
*** SUMMARY ***
Total pot $1.85 | Rake $0.05 
Board [Ks Ah Kd 5c 2d]
Seat 1: 6DwBRH+xZ12AAZmeAg+aXw (small blind) folded before Flop
Seat 2: NtrVQ9UIql0rDCnKDKZ5FQ (big blind) folded before Flop
Seat 3: kyRaCIljYA6l33lSKQfNsg folded on the River
Seat 4: 6elpmfyt4Zw0yvd8lePSMQ folded before Flop (didn't bet)
Seat 5: kG34n23qFQA3nzdOJTQ1dA (button) collected ($1.80)




PokerStars Game #59941756154:  Hold'em No Limit ($0.10/$0.25) - 2009/07/01 1:45:09 ET
Table 'g6ryG70feTw9nNm+XJLuXw' 6-max Seat #5 is the button
Seat 1: v+QfkGiuj9bgtuNoVnDO8w ($35.35 in chips) 
Seat 2: SxIIgwXYLkwd6m3wLyPTCw ($33.10 in chips) 
Seat 3: cezpHJ8FB07dj0xG+LhOvw ($25 in chips) 
Seat 4: GC/9yVD59DUCX7hUI7gcLw ($45.50 in chips) 
Seat 5: EE16Ua5b1HSsYej5zeXOlA ($25.35 in chips) 
Mhj3q7cxev+XjXZxEE6/Cw will be allowed to play after the button
v+QfkGiuj9bgtuNoVnDO8w: posts small blind $0.10
SxIIgwXYLkwd6m3wLyPTCw: posts big blind $0.25
*** HOLE CARDS ***
cezpHJ8FB07dj0xG+LhOvw: folds 
GC/9yVD59DUCX7hUI7gcLw: raises $0.75 to $1
EE16Ua5b1HSsYej5zeXOlA: folds 
v+QfkGiuj9bgtuNoVnDO8w: folds 
SxIIgwXYLkwd6m3wLyPTCw: folds 
Uncalled bet ($0.75) returned to GC/9yVD59DUCX7hUI7gcLw
GC/9yVD59DUCX7hUI7gcLw collected $0.60 from pot
*** SUMMARY ***
Total pot $0.60 | Rake $0 
Seat 1: v+QfkGiuj9bgtuNoVnDO8w (small blind) folded before Flop
Seat 2: SxIIgwXYLkwd6m3wLyPTCw (big blind) folded before Flop
Seat 3: cezpHJ8FB07dj0xG+LhOvw folded before Flop (didn't bet)
Seat 4: GC/9yVD59DUCX7hUI7gcLw collected ($0.60)
Seat 5: EE16Ua5b1HSsYej5zeXOlA (button) folded before Flop (didn't bet)




PokerStars Game #59941755994:  Hold'em No Limit ($0.10/$0.25) - 2009/07/01 1:45:09 ET
Table 'wGizWOswEL6P5QrvVkno/g' 6-max Seat #2 is the button
Seat 1: Qbfkn+ucISvbd1Xh32zAGA ($23.65 in chips) 
Seat 2: mfrkWA3PTeYPkbO6hi98Aw ($26.65 in chips) 
Seat 3: bJFzs6QmEEnz4miMfSDtcg ($12.65 in chips) 
Seat 4: 32YL2ZEp8NT4JB2RVM9euQ ($16.30 in chips) 
Seat 6: rfSnsAuAfXTb8w/obc9OVQ ($9.30 in chips) 
bJFzs6QmEEnz4miMfSDtcg: posts small blind $0.10
32YL2ZEp8NT4JB2RVM9euQ: posts big blind $0.25
*** HOLE CARDS ***
rfSnsAuAfXTb8w/obc9OVQ: raises $0.25 to $0.50
Qbfkn+ucISvbd1Xh32zAGA: calls $0.50
mfrkWA3PTeYPkbO6hi98Aw: calls $0.50
bJFzs6QmEEnz4miMfSDtcg: folds 
32YL2ZEp8NT4JB2RVM9euQ: calls $0.25
*** FLOP *** [Ts 6h 6d]
32YL2ZEp8NT4JB2RVM9euQ: checks 
rfSnsAuAfXTb8w/obc9OVQ: bets $3.75
Qbfkn+ucISvbd1Xh32zAGA: calls $3.75
mfrkWA3PTeYPkbO6hi98Aw: folds 
32YL2ZEp8NT4JB2RVM9euQ: folds 
*** TURN *** [Ts 6h 6d] [9d]
rfSnsAuAfXTb8w/obc9OVQ: checks 
wsP46AGpqDjHZQmlRHKa9g leaves the table
Qbfkn+ucISvbd1Xh32zAGA: bets $5.25
rfSnsAuAfXTb8w/obc9OVQ: calls $5.05 and is all-in
Uncalled bet ($0.20) returned to Qbfkn+ucISvbd1Xh32zAGA
*** RIVER *** [Ts 6h 6d 9d] [As]
*** SHOW DOWN ***
rfSnsAuAfXTb8w/obc9OVQ: shows [Kh Tc] (two pair, Tens and Sixes)
Qbfkn+ucISvbd1Xh32zAGA: shows [Qs Qh] (two pair, Queens and Sixes)
Qbfkn+ucISvbd1Xh32zAGA collected $18.75 from pot
*** SUMMARY ***
Total pot $19.70 | Rake $0.95 
Board [Ts 6h 6d 9d As]
Seat 1: Qbfkn+ucISvbd1Xh32zAGA showed [Qs Qh] and won ($18.75) with two pair, Queens and Sixes
Seat 2: mfrkWA3PTeYPkbO6hi98Aw (button) folded on the Flop
Seat 3: bJFzs6QmEEnz4miMfSDtcg (small blind) folded before Flop
Seat 4: 32YL2ZEp8NT4JB2RVM9euQ (big blind) folded on the Flop
Seat 6: rfSnsAuAfXTb8w/obc9OVQ showed [Kh Tc] and lost with two pair, Tens and Sixes




PokerStars Game #59941756080:  Hold'em No Limit ($0.10/$0.25) - 2009/07/01 1:45:09 ET
Table 'hfHe8uKeSJMyWAjSdM7ROQ' 6-max Seat #1 is the button
Seat 1: eHsmIvAb2JREg4O6hNPnXg ($40.35 in chips) 
Seat 2: QvTX2yGq3uKJiKPmns4TKQ ($29.90 in chips) 
Seat 3: oAzQdB2jFOH1NxFUPjYUGg ($26.75 in chips) 
Seat 4: b4wRQV3APH8irVk6bUFe2Q ($25.85 in chips) 
Seat 5: euswrBD1XG0Q5hB1iGJBKQ ($61.55 in chips) 
QvTX2yGq3uKJiKPmns4TKQ: posts small blind $0.10
oAzQdB2jFOH1NxFUPjYUGg: posts big blind $0.25
eL3+wCBjFGfQ5FMdIZihwA: sits out 
*** HOLE CARDS ***
b4wRQV3APH8irVk6bUFe2Q: folds 
euswrBD1XG0Q5hB1iGJBKQ: folds 
eHsmIvAb2JREg4O6hNPnXg: raises $0.50 to $0.75
QvTX2yGq3uKJiKPmns4TKQ: folds 
oAzQdB2jFOH1NxFUPjYUGg: folds 
Uncalled bet ($0.50) returned to eHsmIvAb2JREg4O6hNPnXg
eHsmIvAb2JREg4O6hNPnXg collected $0.60 from pot
*** SUMMARY ***
Total pot $0.60 | Rake $0 
Seat 1: eHsmIvAb2JREg4O6hNPnXg (button) collected ($0.60)
Seat 2: QvTX2yGq3uKJiKPmns4TKQ (small blind) folded before Flop
Seat 3: oAzQdB2jFOH1NxFUPjYUGg (big blind) folded before Flop
Seat 4: b4wRQV3APH8irVk6bUFe2Q folded before Flop (didn't bet)
Seat 5: euswrBD1XG0Q5hB1iGJBKQ folded before Flop (didn't bet)




PokerStars Game #59941755822:  Hold'em No Limit ($0.10/$0.25) - 2009/07/01 1:45:09 ET
Table '9SExUHslNkrPJ4XsrePaVw' 9-max Seat #1 is the button
Seat 1: RHqgdFvufLCYe54+qd2gcA ($4.50 in chips) 
Seat 2: cZ99hugmLBj9KhTlc8nCSw ($43.85 in chips) 
Seat 3: EP17SQz/iWcuYdNOGeBgkw ($14.15 in chips) 
Seat 4: 4awUyiDYTgylQKXZ9faBVA ($25 in chips) 
Seat 5: L+eJnUyhY8bMNYw755K8XQ ($14.50 in chips) 
Seat 6: YPJ90cgNXDABdYJcqmwB0A ($20.95 in chips) 
Seat 7: 7cv+9Zc9HIQHNvYsMfV3uA ($29.20 in chips) 
Seat 8: tLcDklc2rBORNfixyRfVfw ($25.35 in chips) 
Seat 9: /THNzAxdv2lBxcf4XTj/0g ($8.65 in chips) 
cZ99hugmLBj9KhTlc8nCSw: posts small blind $0.10
EP17SQz/iWcuYdNOGeBgkw: posts big blind $0.25
*** HOLE CARDS ***
4awUyiDYTgylQKXZ9faBVA: folds 
L+eJnUyhY8bMNYw755K8XQ: folds 
YPJ90cgNXDABdYJcqmwB0A: folds 
7cv+9Zc9HIQHNvYsMfV3uA: folds 
tLcDklc2rBORNfixyRfVfw: folds 
/THNzAxdv2lBxcf4XTj/0g: calls $0.25
RHqgdFvufLCYe54+qd2gcA: folds 
cZ99hugmLBj9KhTlc8nCSw: folds 
EP17SQz/iWcuYdNOGeBgkw: checks 
*** FLOP *** [6h Js 9s]
EP17SQz/iWcuYdNOGeBgkw: checks 
/THNzAxdv2lBxcf4XTj/0g: bets $0.75
EP17SQz/iWcuYdNOGeBgkw: folds 
Uncalled bet ($0.75) returned to /THNzAxdv2lBxcf4XTj/0g
/THNzAxdv2lBxcf4XTj/0g collected $0.60 from pot
*** SUMMARY ***
Total pot $0.60 | Rake $0 
Board [6h Js 9s]
Seat 1: RHqgdFvufLCYe54+qd2gcA (button) folded before Flop (didn't bet)
Seat 2: cZ99hugmLBj9KhTlc8nCSw (small blind) folded before Flop
Seat 3: EP17SQz/iWcuYdNOGeBgkw (big blind) folded on the Flop
Seat 4: 4awUyiDYTgylQKXZ9faBVA folded before Flop (didn't bet)
Seat 5: L+eJnUyhY8bMNYw755K8XQ folded before Flop (didn't bet)
Seat 6: YPJ90cgNXDABdYJcqmwB0A folded before Flop (didn't bet)
Seat 7: 7cv+9Zc9HIQHNvYsMfV3uA folded before Flop (didn't bet)
Seat 8: tLcDklc2rBORNfixyRfVfw folded before Flop (didn't bet)
Seat 9: /THNzAxdv2lBxcf4XTj/0g collected ($0.60)




PokerStars Game #59941755856:  Hold'em No Limit ($0.10/$0.25) - 2009/07/01 1:45:09 ET
Table 'rhQuIjJo0UQ7RRUlF9umHg' 6-max Seat #5 is the button
Seat 1: 5O3Hj9Qg0SqOyKEXoLpjPg ($145.75 in chips) 
Seat 2: Ew/TYPQIsbQ2X8nm5iAJBg ($25 in chips) 
Seat 3: if4dh6jhJXeN3/qd3qCp9g ($27.40 in chips) 
Seat 4: buyjetgNT1McXtdaP4zynA ($40.25 in chips) 
Seat 5: dOX4wnYV2sEqvDbF+8KSCw ($53.15 in chips) 
Seat 6: /gJNBeCkWL4o85/jvlZ4BA ($52.15 in chips) 
/gJNBeCkWL4o85/jvlZ4BA: posts small blind $0.10
5O3Hj9Qg0SqOyKEXoLpjPg: posts big blind $0.25
*** HOLE CARDS ***
Ew/TYPQIsbQ2X8nm5iAJBg: raises $0.50 to $0.75
if4dh6jhJXeN3/qd3qCp9g: folds 
buyjetgNT1McXtdaP4zynA: calls $0.75
dOX4wnYV2sEqvDbF+8KSCw: calls $0.75
/gJNBeCkWL4o85/jvlZ4BA: folds 
5O3Hj9Qg0SqOyKEXoLpjPg: raises $0.50 to $1.25
Ew/TYPQIsbQ2X8nm5iAJBg: calls $0.50
buyjetgNT1McXtdaP4zynA: calls $0.50
dOX4wnYV2sEqvDbF+8KSCw: calls $0.50
*** FLOP *** [4d 5h 8c]
5O3Hj9Qg0SqOyKEXoLpjPg: bets $5.75
Ew/TYPQIsbQ2X8nm5iAJBg: calls $5.75
buyjetgNT1McXtdaP4zynA: folds 
dOX4wnYV2sEqvDbF+8KSCw: folds 
*** TURN *** [4d 5h 8c] [Kc]
5O3Hj9Qg0SqOyKEXoLpjPg: bets $1
Ew/TYPQIsbQ2X8nm5iAJBg: calls $1
*** RIVER *** [4d 5h 8c Kc] [Js]
5O3Hj9Qg0SqOyKEXoLpjPg: bets $1
Ew/TYPQIsbQ2X8nm5iAJBg: calls $1
*** SHOW DOWN ***
5O3Hj9Qg0SqOyKEXoLpjPg: shows [8h Ah] (a pair of Eights)
Ew/TYPQIsbQ2X8nm5iAJBg: mucks hand 
5O3Hj9Qg0SqOyKEXoLpjPg collected $19.65 from pot
*** SUMMARY ***
Total pot $20.60 | Rake $0.95 
Board [4d 5h 8c Kc Js]
Seat 1: 5O3Hj9Qg0SqOyKEXoLpjPg (big blind) showed [8h Ah] and won ($19.65) with a pair of Eights
Seat 2: Ew/TYPQIsbQ2X8nm5iAJBg mucked
Seat 3: if4dh6jhJXeN3/qd3qCp9g folded before Flop (didn't bet)
Seat 4: buyjetgNT1McXtdaP4zynA folded on the Flop
Seat 5: dOX4wnYV2sEqvDbF+8KSCw (button) folded on the Flop
Seat 6: /gJNBeCkWL4o85/jvlZ4BA (small blind) folded before Flop




PokerStars Game #59941756136:  Hold'em No Limit ($0.10/$0.25) - 2009/07/01 1:45:09 ET
Table '4hfTdIVT/qPsJNfWXLsVIw' 9-max Seat #5 is the button
Seat 1: GbHFBbLqLGz0Pwn6CJeAuw ($41.30 in chips) 
Seat 2: Pt637jKksB5MzP0UNJAAkw ($36.70 in chips) 
Seat 3: xnVwSkROfRtOw4eSoDANtw ($8.20 in chips) 
Seat 5: dtZ84flFEi4Q+SGrHMJRDQ ($25.10 in chips) 
Seat 6: VWUWpMLMj/Q1jRVpF7Aohw ($12.65 in chips) 
Seat 8: 7cv+9Zc9HIQHNvYsMfV3uA ($29 in chips) 
VWUWpMLMj/Q1jRVpF7Aohw: posts small blind $0.10
7cv+9Zc9HIQHNvYsMfV3uA: posts big blind $0.25
3PmVnC/15cl4oyI1TKIt4g: sits out 
*** HOLE CARDS ***
GbHFBbLqLGz0Pwn6CJeAuw: folds 
Pt637jKksB5MzP0UNJAAkw: raises $0.75 to $1
xnVwSkROfRtOw4eSoDANtw: calls $1
dtZ84flFEi4Q+SGrHMJRDQ: folds 
VWUWpMLMj/Q1jRVpF7Aohw: folds 
9njEKzpOKC62MllUFUBWrA has returned
7cv+9Zc9HIQHNvYsMfV3uA: folds 
*** FLOP *** [Qc Ad 6d]
Pt637jKksB5MzP0UNJAAkw: bets $1.25
xnVwSkROfRtOw4eSoDANtw: raises $1.25 to $2.50
Pt637jKksB5MzP0UNJAAkw: raises $33.20 to $35.70 and is all-in
xnVwSkROfRtOw4eSoDANtw: folds 
Uncalled bet ($33.20) returned to Pt637jKksB5MzP0UNJAAkw
Pt637jKksB5MzP0UNJAAkw collected $7 from pot
Pt637jKksB5MzP0UNJAAkw: doesn't show hand 
*** SUMMARY ***
Total pot $7.35 | Rake $0.35 
Board [Qc Ad 6d]
Seat 1: GbHFBbLqLGz0Pwn6CJeAuw folded before Flop (didn't bet)
Seat 2: Pt637jKksB5MzP0UNJAAkw collected ($7)
Seat 3: xnVwSkROfRtOw4eSoDANtw folded on the Flop
Seat 5: dtZ84flFEi4Q+SGrHMJRDQ (button) folded before Flop (didn't bet)
Seat 6: VWUWpMLMj/Q1jRVpF7Aohw (small blind) folded before Flop
Seat 8: 7cv+9Zc9HIQHNvYsMfV3uA (big blind) folded before Flop




PokerStars Game #59941756384:  Hold'em No Limit ($0.10/$0.25) - 2009/07/01 1:45:10 ET
Table 'oG007Tb0LYbfANo6QWd16wWEMI3Mtn7dGARDbgNrKibgx Seat #5 is the button
Seat 1: DiSvPC2iudwL5j9u6Huyww ($46.65 in chips) 
Seat 4: zgi+EUykT/pZQpoUG6+oEg ($5 in chips) 
Seat 5: 8f0dtuUGqDbgE6up1lQAlg ($5.75 in chips) 
Seat 6: yqkowiRWZ6NvRN9UUkYIlA ($5 in chips) 
Seat 7: Mh2r9hTeTEDnh19sRZtW3g ($4.75 in chips) 
Seat 8: q4cNXFZGNhLfrTyVrIy6Mg ($15.15 in chips) 
Seat 9: EVqHvqty1ZsuvDFiSXlSqQ ($18.85 in chips) 
yqkowiRWZ6NvRN9UUkYIlA: posts small blind $0.10
Mh2r9hTeTEDnh19sRZtW3g: posts big blind $0.25
pN3IHvAKm2fz+sTRARTcrg: sits out 
*** HOLE CARDS ***
q4cNXFZGNhLfrTyVrIy6Mg: calls $0.25
EVqHvqty1ZsuvDFiSXlSqQ: calls $0.25
DiSvPC2iudwL5j9u6Huyww: folds 
zgi+EUykT/pZQpoUG6+oEg: folds 
8f0dtuUGqDbgE6up1lQAlg: calls $0.25
yqkowiRWZ6NvRN9UUkYIlA: folds 
Mh2r9hTeTEDnh19sRZtW3g: raises $4.50 to $4.75 and is all-in
q4cNXFZGNhLfrTyVrIy6Mg: folds 
EVqHvqty1ZsuvDFiSXlSqQ: calls $4.50
8f0dtuUGqDbgE6up1lQAlg: folds 
*** FLOP *** [Kc 3c 3d]
*** TURN *** [Kc 3c 3d] [Td]
*** RIVER *** [Kc 3c 3d Td] [Qd]
*** SHOW DOWN ***
Mh2r9hTeTEDnh19sRZtW3g: shows [Js As] (a straight, Ten to Ace)
EVqHvqty1ZsuvDFiSXlSqQ: shows [Ad 8d] (a flush, Ace high)
EVqHvqty1ZsuvDFiSXlSqQ collected $9.60 from pot
*** SUMMARY ***
Total pot $10.10 | Rake $0.50 
Board [Kc 3c 3d Td Qd]
Seat 1: DiSvPC2iudwL5j9u6Huyww folded before Flop (didn't bet)
Seat 4: zgi+EUykT/pZQpoUG6+oEg folded before Flop (didn't bet)
Seat 5: 8f0dtuUGqDbgE6up1lQAlg (button) folded before Flop
Seat 6: yqkowiRWZ6NvRN9UUkYIlA (small blind) folded before Flop
Seat 7: Mh2r9hTeTEDnh19sRZtW3g (big blind) showed [Js As] and lost with a straight, Ten to Ace
Seat 8: q4cNXFZGNhLfrTyVrIy6Mg folded before Flop
Seat 9: EVqHvqty1ZsuvDFiSXlSqQ showed [Ad 8d] and won ($9.60) with a flush, Ace high




PokerStars Game #59941756600:  Hold'em No Limit ($0.10/$0.25) - 2009/07/01 1:45:10 ET
Table 'RPdw09/gGCIP4xFhDWJgXQ' 9-max Seat #7 is the button
Seat 1: aNpwfA31EREwO+ar4XzBCw ($27.50 in chips) 
Seat 2: Sd1tfhUq/M96GhXGv1hwFQ ($8.55 in chips) 
Seat 3: g5LAv1J/3Thw1zs/SEyfzw ($18.25 in chips) 
Seat 5: gehe91e0IyVT0QU/XBkEyg ($30.35 in chips) 
Seat 6: monZeAwXUmIA1l84cUd2hw ($14.50 in chips) 
Seat 7: EP17SQz/iWcuYdNOGeBgkw ($13.90 in chips) 
Seat 8: MG90wfSJZnOejs/KD3vlQQ ($29.90 in chips) 
Seat 9: O02ScVDnDZwH6KjZNJZMzA ($5 in chips) 
MG90wfSJZnOejs/KD3vlQQ: posts small blind $0.10
O02ScVDnDZwH6KjZNJZMzA: posts big blind $0.25
*** HOLE CARDS ***
aNpwfA31EREwO+ar4XzBCw: raises $0.75 to $1
Sd1tfhUq/M96GhXGv1hwFQ: folds 
g5LAv1J/3Thw1zs/SEyfzw: folds 
gehe91e0IyVT0QU/XBkEyg: folds 
monZeAwXUmIA1l84cUd2hw: folds 
EP17SQz/iWcuYdNOGeBgkw: folds 
MG90wfSJZnOejs/KD3vlQQ: folds 
O02ScVDnDZwH6KjZNJZMzA: folds 
Uncalled bet ($0.75) returned to aNpwfA31EREwO+ar4XzBCw
aNpwfA31EREwO+ar4XzBCw collected $0.60 from pot
aNpwfA31EREwO+ar4XzBCw: doesn't show hand 
*** SUMMARY ***
Total pot $0.60 | Rake $0 
Seat 1: aNpwfA31EREwO+ar4XzBCw collected ($0.60)
Seat 2: Sd1tfhUq/M96GhXGv1hwFQ folded before Flop (didn't bet)
Seat 3: g5LAv1J/3Thw1zs/SEyfzw folded before Flop (didn't bet)
Seat 5: gehe91e0IyVT0QU/XBkEyg folded before Flop (didn't bet)
Seat 6: monZeAwXUmIA1l84cUd2hw folded before Flop (didn't bet)
Seat 7: EP17SQz/iWcuYdNOGeBgkw (button) folded before Flop (didn't bet)
Seat 8: MG90wfSJZnOejs/KD3vlQQ (small blind) folded before Flop
Seat 9: O02ScVDnDZwH6KjZNJZMzA (big blind) folded before Flop




PokerStars Game #59941757208:  Hold'em No Limit ($0.10/$0.25) - 2009/07/01 1:45:11 ET
Table '4mnXP0EWt9mMZYzTIVDQ0w' 9-max Seat #2 is the button
Seat 1: Z5y2J55JmfLYR6/DPAGHwQ ($21.10 in chips) 
Seat 2: BLEU2x2bnGRovIelAY6slA ($25.15 in chips) 
Seat 4: 9lvO/qyU+xrU95Teu1fv0g ($6.75 in chips) 
Seat 5: sSN8Y0AlsBeidZXPKmwXSw ($24.95 in chips) 
Seat 6: 5yjzPss7Y4kAWNDat3e0yQ ($29.10 in chips) 
Seat 7: OiV1PWZ3IkN29JlmCcnTwQ ($6.20 in chips) 
Seat 8: 9YN2IkT2JYYKFErZtZvCtA ($20 in chips) 
Seat 9: N/O9ADKpmqB2ASZuqgodlw ($9.40 in chips) 
ompa52 was removed from the table for failing to post
9lvO/qyU+xrU95Teu1fv0g: posts small blind $0.10
sSN8Y0AlsBeidZXPKmwXSw: posts big blind $0.25
*** HOLE CARDS ***
5yjzPss7Y4kAWNDat3e0yQ: folds 
OiV1PWZ3IkN29JlmCcnTwQ: folds 
9YN2IkT2JYYKFErZtZvCtA: folds 
N/O9ADKpmqB2ASZuqgodlw: folds 
Z5y2J55JmfLYR6/DPAGHwQ: folds 
BLEU2x2bnGRovIelAY6slA: folds 
9lvO/qyU+xrU95Teu1fv0g: calls $0.15
sSN8Y0AlsBeidZXPKmwXSw: checks 
*** FLOP *** [Kc Kd Qh]
9lvO/qyU+xrU95Teu1fv0g: checks 
sSN8Y0AlsBeidZXPKmwXSw: bets $0.50
9lvO/qyU+xrU95Teu1fv0g: folds 
Uncalled bet ($0.50) returned to sSN8Y0AlsBeidZXPKmwXSw
sSN8Y0AlsBeidZXPKmwXSw collected $0.50 from pot
*** SUMMARY ***
Total pot $0.50 | Rake $0 
Board [Kc Kd Qh]
Seat 1: Z5y2J55JmfLYR6/DPAGHwQ folded before Flop (didn't bet)
Seat 2: BLEU2x2bnGRovIelAY6slA (button) folded before Flop (didn't bet)
Seat 4: 9lvO/qyU+xrU95Teu1fv0g (small blind) folded on the Flop
Seat 5: sSN8Y0AlsBeidZXPKmwXSw (big blind) collected ($0.50)
Seat 6: 5yjzPss7Y4kAWNDat3e0yQ folded before Flop (didn't bet)
Seat 7: OiV1PWZ3IkN29JlmCcnTwQ folded before Flop (didn't bet)
Seat 8: 9YN2IkT2JYYKFErZtZvCtA folded before Flop (didn't bet)
Seat 9: N/O9ADKpmqB2ASZuqgodlw folded before Flop (didn't bet)




PokerStars Game #59941756836:  Hold'em No Limit ($0.10/$0.25) - 2009/07/01 1:45:11 ET
Table 'IuqVbFI+pwnJjvwBCGSGAw' 6-max Seat #4 is the button
Seat 1: LyDHtw3/yniNHW+DvLXbog ($25.70 in chips) 
Seat 3: QiL+lEgEWwy21jk/ltaRLg ($21.40 in chips) 
Seat 4: DE9hRlt14g+JdsRQ4wT7hg ($26.35 in chips) 
Seat 5: if4dh6jhJXeN3/qd3qCp9g ($25.45 in chips) 
Seat 6: xC0kaiDYM6YTlgODL83O5A ($15 in chips) 
if4dh6jhJXeN3/qd3qCp9g: posts small blind $0.10
xC0kaiDYM6YTlgODL83O5A: posts big blind $0.25
*** HOLE CARDS ***
LyDHtw3/yniNHW+DvLXbog: raises $0.75 to $1
QiL+lEgEWwy21jk/ltaRLg: folds 
DE9hRlt14g+JdsRQ4wT7hg: folds 
if4dh6jhJXeN3/qd3qCp9g: folds 
xC0kaiDYM6YTlgODL83O5A: calls $0.75
*** FLOP *** [6s 7s Ks]
xC0kaiDYM6YTlgODL83O5A: checks 
LyDHtw3/yniNHW+DvLXbog: bets $1.50
xC0kaiDYM6YTlgODL83O5A: folds 
Uncalled bet ($1.50) returned to LyDHtw3/yniNHW+DvLXbog
LyDHtw3/yniNHW+DvLXbog collected $2 from pot
LyDHtw3/yniNHW+DvLXbog: doesn't show hand 
*** SUMMARY ***
Total pot $2.10 | Rake $0.10 
Board [6s 7s Ks]
Seat 1: LyDHtw3/yniNHW+DvLXbog collected ($2)
Seat 3: QiL+lEgEWwy21jk/ltaRLg folded before Flop (didn't bet)
Seat 4: DE9hRlt14g+JdsRQ4wT7hg (button) folded before Flop (didn't bet)
Seat 5: if4dh6jhJXeN3/qd3qCp9g (small blind) folded before Flop
Seat 6: xC0kaiDYM6YTlgODL83O5A (big blind) folded on the Flop




PokerStars Game #59941757224:  Hold'em No Limit ($0.10/$0.25) - 2009/07/01 1:45:11 ET
Table 'WEMI3Mtn7dGARDbgNrKibg' 9-max Seat #2 is the button
Seat 1: Th3FldXKQW6hWVVPahaoOQ ($30.50 in chips) 
Seat 2: tYsOBqdU1+x+yFI7zHO7hQ ($49.20 in chips) 
Seat 3: qwr38jl5txoR36M7G5qi4A ($7.50 in chips) 
Seat 4: Z5NNIVvnhb2IJbLcI79WYQ ($5.25 in chips) 
Seat 5: yzPZQFeaQTNf1YK3a0zRIw ($14.80 in chips) 
Seat 6: arxNSjreDRGFg13EAM2F1w ($25.45 in chips) 
Seat 7: DnDcAdn9P0zGovMERigpFA ($54.90 in chips) 
Seat 8: ghNKXUBl/H+t83JF079ZBA ($29.60 in chips) 
Seat 9: 2wcFsZsqEP5w1StUTVzJCg ($4.50 in chips) 
qwr38jl5txoR36M7G5qi4A: posts small blind $0.10
Z5NNIVvnhb2IJbLcI79WYQ: posts big blind $0.25
*** HOLE CARDS ***
yzPZQFeaQTNf1YK3a0zRIw: calls $0.25
arxNSjreDRGFg13EAM2F1w: folds 
DnDcAdn9P0zGovMERigpFA: folds 
ghNKXUBl/H+t83JF079ZBA: folds 
2wcFsZsqEP5w1StUTVzJCg: folds 
Th3FldXKQW6hWVVPahaoOQ: folds 
tYsOBqdU1+x+yFI7zHO7hQ: folds 
qwr38jl5txoR36M7G5qi4A: folds 
Z5NNIVvnhb2IJbLcI79WYQ: checks 
*** FLOP *** [Jc 4c 9c]
Z5NNIVvnhb2IJbLcI79WYQ: checks 
yzPZQFeaQTNf1YK3a0zRIw: bets $0.75
Z5NNIVvnhb2IJbLcI79WYQ: calls $0.75
*** TURN *** [Jc 4c 9c] [4h]
Z5NNIVvnhb2IJbLcI79WYQ: checks 
yzPZQFeaQTNf1YK3a0zRIw: bets $0.75
Z5NNIVvnhb2IJbLcI79WYQ: raises $0.75 to $1.50
yzPZQFeaQTNf1YK3a0zRIw: calls $0.75
*** RIVER *** [Jc 4c 9c 4h] [2d]
Z5NNIVvnhb2IJbLcI79WYQ: bets $2.75 and is all-in
yzPZQFeaQTNf1YK3a0zRIw: calls $2.75
*** SHOW DOWN ***
Z5NNIVvnhb2IJbLcI79WYQ: shows [4d 9d] (a full house, Fours full of Nines)
yzPZQFeaQTNf1YK3a0zRIw: mucks hand 
Z5NNIVvnhb2IJbLcI79WYQ collected $10.10 from pot
*** SUMMARY ***
Total pot $10.60 | Rake $0.50 
Board [Jc 4c 9c 4h 2d]
Seat 1: Th3FldXKQW6hWVVPahaoOQ folded before Flop (didn't bet)
Seat 2: tYsOBqdU1+x+yFI7zHO7hQ (button) folded before Flop (didn't bet)
Seat 3: qwr38jl5txoR36M7G5qi4A (small blind) folded before Flop
Seat 4: Z5NNIVvnhb2IJbLcI79WYQ (big blind) showed [4d 9d] and won ($10.10) with a full house, Fours full of Nines
Seat 5: yzPZQFeaQTNf1YK3a0zRIw mucked
Seat 6: arxNSjreDRGFg13EAM2F1w folded before Flop (didn't bet)
Seat 7: DnDcAdn9P0zGovMERigpFA folded before Flop (didn't bet)
Seat 8: ghNKXUBl/H+t83JF079ZBA folded before Flop (didn't bet)
Seat 9: 2wcFsZsqEP5w1StUTVzJCg folded before Flop (didn't bet)




PokerStars Game #59941756994:  Hold'em No Limit ($0.10/$0.25) - 2009/07/01 1:45:11 ET
Table 'SbSV5tlgLp0+/Z+13PW3Hg' 9-max Seat #8 is the button
Seat 1: x+W5+3qsdY4Iszf0hoH+Aw ($17.55 in chips) 
Seat 3: CT7Xj/V/O5rBlhtt+RZeFQ ($25.35 in chips) 
Seat 4: puj3K/wrNjEj86ZL/MyfLA ($9.65 in chips) 
Seat 5: aNpwfA31EREwO+ar4XzBCw ($25 in chips) 
Seat 6: pN3IHvAKm2fz+sTRARTcrg ($25.40 in chips) 
Seat 8: qBdqLaJhO+1itcMk70bsfA ($8.65 in chips) 
Seat 9: X78b5v/uhqeXXoAijbw/yg ($25 in chips) 
X78b5v/uhqeXXoAijbw/yg: posts small blind $0.10
x+W5+3qsdY4Iszf0hoH+Aw: posts big blind $0.25
*** HOLE CARDS ***
Cman920 leaves the table
CT7Xj/V/O5rBlhtt+RZeFQ: calls $0.25
3PmVnC/15cl4oyI1TKIt4g joins the table at seat #7 
puj3K/wrNjEj86ZL/MyfLA: folds 
aNpwfA31EREwO+ar4XzBCw: folds 
pN3IHvAKm2fz+sTRARTcrg: folds 
qBdqLaJhO+1itcMk70bsfA: calls $0.25
X78b5v/uhqeXXoAijbw/yg: folds 
x+W5+3qsdY4Iszf0hoH+Aw: checks 
*** FLOP *** [Ks 4h 4c]
x+W5+3qsdY4Iszf0hoH+Aw: checks 
CT7Xj/V/O5rBlhtt+RZeFQ: checks 
qBdqLaJhO+1itcMk70bsfA: checks 
*** TURN *** [Ks 4h 4c] [9d]
x+W5+3qsdY4Iszf0hoH+Aw: checks 
CT7Xj/V/O5rBlhtt+RZeFQ: checks 
qBdqLaJhO+1itcMk70bsfA: checks 
*** RIVER *** [Ks 4h 4c 9d] [7c]
x+W5+3qsdY4Iszf0hoH+Aw: checks 
CT7Xj/V/O5rBlhtt+RZeFQ: checks 
qBdqLaJhO+1itcMk70bsfA: checks 
*** SHOW DOWN ***
x+W5+3qsdY4Iszf0hoH+Aw: shows [Qd 5s] (a pair of Fours)
CT7Xj/V/O5rBlhtt+RZeFQ: shows [2h Ah] (a pair of Fours - Ace kicker)
qBdqLaJhO+1itcMk70bsfA: mucks hand 
CT7Xj/V/O5rBlhtt+RZeFQ collected $0.85 from pot
*** SUMMARY ***
Total pot $0.85 | Rake $0 
Board [Ks 4h 4c 9d 7c]
Seat 1: x+W5+3qsdY4Iszf0hoH+Aw (big blind) showed [Qd 5s] and lost with a pair of Fours
Seat 3: CT7Xj/V/O5rBlhtt+RZeFQ showed [2h Ah] and won ($0.85) with a pair of Fours
Seat 4: puj3K/wrNjEj86ZL/MyfLA folded before Flop (didn't bet)
Seat 5: aNpwfA31EREwO+ar4XzBCw folded before Flop (didn't bet)
Seat 6: pN3IHvAKm2fz+sTRARTcrg folded before Flop (didn't bet)
Seat 8: qBdqLaJhO+1itcMk70bsfA (button) mucked
Seat 9: X78b5v/uhqeXXoAijbw/yg (small blind) folded before Flop




PokerStars Game #59941757114:  Hold'em No Limit ($0.10/$0.25) - 2009/07/01 1:45:11 ET
Table '2AUmC2Rslg+QUbLfdgNdfg' 6-max Seat #6 is the button
Seat 1: YDXAegrCnzc0l6TSDNboXQ ($26 in chips) 
Seat 2: PLksyNlTVRVZwxJVC2/1eA ($22.50 in chips) 
Seat 3: JFIAqU8lCZ0vWwEl4bdGsg ($25.70 in chips) 
Seat 4: lquriepNQBhDV5P1SWHhnA ($26.25 in chips) 
Seat 5: AMc4cCwUJhokdGRYIaVPhQ ($22.60 in chips) 
Seat 6: xBWc54v+UTSJOiKpbAbJWg ($11.05 in chips) 
YDXAegrCnzc0l6TSDNboXQ: posts small blind $0.10
PLksyNlTVRVZwxJVC2/1eA: posts big blind $0.25
AMc4cCwUJhokdGRYIaVPhQ: posts small & big blinds $0.35
*** HOLE CARDS ***
JFIAqU8lCZ0vWwEl4bdGsg: folds 
lquriepNQBhDV5P1SWHhnA: folds 
AMc4cCwUJhokdGRYIaVPhQ: checks 
xBWc54v+UTSJOiKpbAbJWg: calls $0.25
YDXAegrCnzc0l6TSDNboXQ: calls $0.15
PLksyNlTVRVZwxJVC2/1eA: checks 
*** FLOP *** [Kc 3c 7c]
YDXAegrCnzc0l6TSDNboXQ: checks 
PLksyNlTVRVZwxJVC2/1eA: checks 
AMc4cCwUJhokdGRYIaVPhQ: bets $0.75
xBWc54v+UTSJOiKpbAbJWg: folds 
YDXAegrCnzc0l6TSDNboXQ: calls $0.75
PLksyNlTVRVZwxJVC2/1eA: folds 
*** TURN *** [Kc 3c 7c] [5d]
YDXAegrCnzc0l6TSDNboXQ: checks 
AMc4cCwUJhokdGRYIaVPhQ: bets $1.25
YDXAegrCnzc0l6TSDNboXQ: calls $1.25
*** RIVER *** [Kc 3c 7c 5d] [Qd]
YDXAegrCnzc0l6TSDNboXQ: checks 
AMc4cCwUJhokdGRYIaVPhQ: bets $2
YDXAegrCnzc0l6TSDNboXQ: folds 
Uncalled bet ($2) returned to AMc4cCwUJhokdGRYIaVPhQ
AMc4cCwUJhokdGRYIaVPhQ collected $4.85 from pot
AMc4cCwUJhokdGRYIaVPhQ: doesn't show hand 
*** SUMMARY ***
Total pot $5.10 | Rake $0.25 
Board [Kc 3c 7c 5d Qd]
Seat 1: YDXAegrCnzc0l6TSDNboXQ (small blind) folded on the River
Seat 2: PLksyNlTVRVZwxJVC2/1eA (big blind) folded on the Flop
Seat 3: JFIAqU8lCZ0vWwEl4bdGsg folded before Flop (didn't bet)
Seat 4: lquriepNQBhDV5P1SWHhnA folded before Flop (didn't bet)
Seat 5: AMc4cCwUJhokdGRYIaVPhQ collected ($4.85)
Seat 6: xBWc54v+UTSJOiKpbAbJWg (button) folded on the Flop




PokerStars Game #59941757186:  Hold'em No Limit ($0.10/$0.25) - 2009/07/01 1:45:11 ET
Table 'KU/HrxqxwDz8HKEhYTZ6uw' 6-max Seat #5 is the button
Seat 1: 7LKoiQHXpTQXJvWQrw907g ($31.80 in chips) 
Seat 2: kG34n23qFQA3nzdOJTQ1dA ($25 in chips) 
Seat 3: SFmT9ZsVopnukjvAzrxTRg ($25 in chips) 
Seat 4: AGwMM0FUhYZf81+oXvYQMg ($26.95 in chips) 
Seat 5: iyZxqznXjv3vtvOJymkoLQ ($50.90 in chips) 
Seat 6: qWxkCeqApAWdAA0evrfDvQ ($16.75 in chips) 
qWxkCeqApAWdAA0evrfDvQ: posts small blind $0.10
7LKoiQHXpTQXJvWQrw907g: posts big blind $0.25
*** HOLE CARDS ***
kG34n23qFQA3nzdOJTQ1dA: folds 
SFmT9ZsVopnukjvAzrxTRg: folds 
AGwMM0FUhYZf81+oXvYQMg: folds 
iyZxqznXjv3vtvOJymkoLQ: folds 
qWxkCeqApAWdAA0evrfDvQ: calls $0.15
7LKoiQHXpTQXJvWQrw907g: checks 
*** FLOP *** [Tc 5s 6c]
qWxkCeqApAWdAA0evrfDvQ: checks 
7LKoiQHXpTQXJvWQrw907g: checks 
*** TURN *** [Tc 5s 6c] [Jd]
qWxkCeqApAWdAA0evrfDvQ: bets $0.50
7LKoiQHXpTQXJvWQrw907g: folds 
Uncalled bet ($0.50) returned to qWxkCeqApAWdAA0evrfDvQ
qWxkCeqApAWdAA0evrfDvQ collected $0.50 from pot
*** SUMMARY ***
Total pot $0.50 | Rake $0 
Board [Tc 5s 6c Jd]
Seat 1: 7LKoiQHXpTQXJvWQrw907g (big blind) folded on the Turn
Seat 2: kG34n23qFQA3nzdOJTQ1dA folded before Flop (didn't bet)
Seat 3: SFmT9ZsVopnukjvAzrxTRg folded before Flop (didn't bet)
Seat 4: AGwMM0FUhYZf81+oXvYQMg folded before Flop (didn't bet)
Seat 5: iyZxqznXjv3vtvOJymkoLQ (button) folded before Flop (didn't bet)
Seat 6: qWxkCeqApAWdAA0evrfDvQ (small blind) collected ($0.50)




PokerStars Game #59941757250:  Hold'em No Limit ($0.10/$0.25) - 2009/07/01 1:45:11 ET
Table 'oZuNsbNJuUyQLGKzQ/4JFg' 6-max Seat #5 is the button
Seat 1: vqWjZmdQu/Hxw96/IJTWdQ ($25.70 in chips) 
Seat 2: UA5OsKS3VPaxa7uC8La/kA ($34.50 in chips) 
Seat 3: 8ClCHtFXGNplITm+63KB+Q ($51 in chips) 
Seat 4: 9bpVv1/Qh9IYtXuCtl5VtQ ($25.80 in chips) 
Seat 5: oBUDUfeUyCbZBsjxHZgSiw ($25.55 in chips) 
Seat 6: fwg6dK1+r4jy/y+JqenYYQ ($13.90 in chips) 
fwg6dK1+r4jy/y+JqenYYQ: posts small blind $0.10
vqWjZmdQu/Hxw96/IJTWdQ: posts big blind $0.25
*** HOLE CARDS ***
UA5OsKS3VPaxa7uC8La/kA: folds 
8ClCHtFXGNplITm+63KB+Q: folds 
9bpVv1/Qh9IYtXuCtl5VtQ: folds 
oBUDUfeUyCbZBsjxHZgSiw: raises $0.75 to $1
fwg6dK1+r4jy/y+JqenYYQ: folds 
vqWjZmdQu/Hxw96/IJTWdQ: folds 
Uncalled bet ($0.75) returned to oBUDUfeUyCbZBsjxHZgSiw
oBUDUfeUyCbZBsjxHZgSiw collected $0.60 from pot
*** SUMMARY ***
Total pot $0.60 | Rake $0 
Seat 1: vqWjZmdQu/Hxw96/IJTWdQ (big blind) folded before Flop
Seat 2: UA5OsKS3VPaxa7uC8La/kA folded before Flop (didn't bet)
Seat 3: 8ClCHtFXGNplITm+63KB+Q folded before Flop (didn't bet)
Seat 4: 9bpVv1/Qh9IYtXuCtl5VtQ folded before Flop (didn't bet)
Seat 5: oBUDUfeUyCbZBsjxHZgSiw (button) collected ($0.60)
Seat 6: fwg6dK1+r4jy/y+JqenYYQ (small blind) folded before Flop




PokerStars Game #59941756998:  Hold'em No Limit ($0.10/$0.25) - 2009/07/01 1:45:11 ET
Table 'C47I7CmrmFr8Oo7wOovVwQ' 6-max Seat #1 is the button
Seat 1: v6mkGzCBCCXcgWQNSYVtKg ($6.40 in chips) 
Seat 2: hOaWAImn5/MZDAWAPlYHCw ($4.90 in chips) 
Seat 3: H+8eOP3XJHXjACRDTiIHTQ ($17.70 in chips) 
Seat 4: yY5JuFtDfXWRaZlVby4LLw ($8.90 in chips) 
Seat 5: or309yYY9Y9bfFWtrB0yUg ($12.60 in chips) 
Seat 6: pD7ri5wL3vsa6S1ulMYQmQ ($24.50 in chips) 
hOaWAImn5/MZDAWAPlYHCw: posts small blind $0.10
H+8eOP3XJHXjACRDTiIHTQ: posts big blind $0.25
*** HOLE CARDS ***
yY5JuFtDfXWRaZlVby4LLw: calls $0.25
or309yYY9Y9bfFWtrB0yUg: folds 
pD7ri5wL3vsa6S1ulMYQmQ: folds 
v6mkGzCBCCXcgWQNSYVtKg: raises $0.25 to $0.50
hOaWAImn5/MZDAWAPlYHCw: calls $0.40
H+8eOP3XJHXjACRDTiIHTQ: calls $0.25
yY5JuFtDfXWRaZlVby4LLw: calls $0.25
*** FLOP *** [4c 6d 9c]
hOaWAImn5/MZDAWAPlYHCw: checks 
H+8eOP3XJHXjACRDTiIHTQ: checks 
yY5JuFtDfXWRaZlVby4LLw: checks 
v6mkGzCBCCXcgWQNSYVtKg: bets $1
hOaWAImn5/MZDAWAPlYHCw: calls $1
H+8eOP3XJHXjACRDTiIHTQ: folds 
yY5JuFtDfXWRaZlVby4LLw: folds 
*** TURN *** [4c 6d 9c] [4h]
hOaWAImn5/MZDAWAPlYHCw: checks 
v6mkGzCBCCXcgWQNSYVtKg: bets $1.75
hOaWAImn5/MZDAWAPlYHCw: calls $1.75
*** RIVER *** [4c 6d 9c 4h] [Td]
hOaWAImn5/MZDAWAPlYHCw: checks 
v6mkGzCBCCXcgWQNSYVtKg: bets $3.15 and is all-in
hOaWAImn5/MZDAWAPlYHCw: calls $1.65 and is all-in
Uncalled bet ($1.50) returned to v6mkGzCBCCXcgWQNSYVtKg
*** SHOW DOWN ***
v6mkGzCBCCXcgWQNSYVtKg: shows [Jd Jc] (two pair, Jacks and Fours)
hOaWAImn5/MZDAWAPlYHCw: mucks hand 
v6mkGzCBCCXcgWQNSYVtKg collected $10.30 from pot
*** SUMMARY ***
Total pot $10.80 | Rake $0.50 
Board [4c 6d 9c 4h Td]
Seat 1: v6mkGzCBCCXcgWQNSYVtKg (button) showed [Jd Jc] and won ($10.30) with two pair, Jacks and Fours
Seat 2: hOaWAImn5/MZDAWAPlYHCw (small blind) mucked
Seat 3: H+8eOP3XJHXjACRDTiIHTQ (big blind) folded on the Flop
Seat 4: yY5JuFtDfXWRaZlVby4LLw folded on the Flop
Seat 5: or309yYY9Y9bfFWtrB0yUg folded before Flop (didn't bet)
Seat 6: pD7ri5wL3vsa6S1ulMYQmQ folded before Flop (didn't bet)




PokerStars Game #59941757832:  Hold'em No Limit ($0.10/$0.25) - 2009/07/01 1:45:12 ET
Table 'APEHQjIcZHDZUA4iOjju2g' 6-max Seat #4 is the button
Seat 1: DE9hRlt14g+JdsRQ4wT7hg ($25 in chips) 
Seat 2: 3zD3qLXT1bEffAoWGnc7wg ($36.25 in chips) 
Seat 3: 3e/idKqDuPE10t6Zvr//SQ ($24.05 in chips) 
Seat 4: w2mQ4VsGljGwWXydz8tw2A ($35.35 in chips) 
Seat 5: /xN6gc9+8Hew0HxaB6VIVg ($46.75 in chips) 
Seat 6: KXtdqb+rIMkjc0RvHDksGQ ($25.95 in chips) 
/xN6gc9+8Hew0HxaB6VIVg: posts small blind $0.10
KXtdqb+rIMkjc0RvHDksGQ: posts big blind $0.25
*** HOLE CARDS ***
DE9hRlt14g+JdsRQ4wT7hg: folds 
3zD3qLXT1bEffAoWGnc7wg: raises $0.50 to $0.75
3e/idKqDuPE10t6Zvr//SQ: folds 
w2mQ4VsGljGwWXydz8tw2A: folds 
/xN6gc9+8Hew0HxaB6VIVg: calls $0.65
KXtdqb+rIMkjc0RvHDksGQ: calls $0.50
*** FLOP *** [Ah Ac Qd]
/xN6gc9+8Hew0HxaB6VIVg: checks 
KXtdqb+rIMkjc0RvHDksGQ: checks 
3zD3qLXT1bEffAoWGnc7wg: checks 
*** TURN *** [Ah Ac Qd] [7c]
/xN6gc9+8Hew0HxaB6VIVg: checks 
KXtdqb+rIMkjc0RvHDksGQ: bets $1.50
3zD3qLXT1bEffAoWGnc7wg: folds 
/xN6gc9+8Hew0HxaB6VIVg: folds 
Uncalled bet ($1.50) returned to KXtdqb+rIMkjc0RvHDksGQ
KXtdqb+rIMkjc0RvHDksGQ collected $2.15 from pot
KXtdqb+rIMkjc0RvHDksGQ: doesn't show hand 
*** SUMMARY ***
Total pot $2.25 | Rake $0.10 
Board [Ah Ac Qd 7c]
Seat 1: DE9hRlt14g+JdsRQ4wT7hg folded before Flop (didn't bet)
Seat 2: 3zD3qLXT1bEffAoWGnc7wg folded on the Turn
Seat 3: 3e/idKqDuPE10t6Zvr//SQ folded before Flop (didn't bet)
Seat 4: w2mQ4VsGljGwWXydz8tw2A (button) folded before Flop (didn't bet)
Seat 5: /xN6gc9+8Hew0HxaB6VIVg (small blind) folded on the Turn
Seat 6: KXtdqb+rIMkjc0RvHDksGQ (big blind) collected ($2.15)




PokerStars Game #59941757344:  Hold'em No Limit ($0.10/$0.25) - 2009/07/01 1:45:12 ET
Table 'BmUMTVcNATeov2rAGYU0Qg' 9-max Seat #2 is the button
Seat 1: QEbIGci+itdw+re8RM5fZA ($33.60 in chips) 
Seat 2: jJnMGXoBXye+afMd0k0rUw ($11.65 in chips) 
Seat 3: ir5Jy8ck6DrdqgJ/3chcWw ($8.20 in chips) 
Seat 4: aNpwfA31EREwO+ar4XzBCw ($37.85 in chips) 
Seat 5: QBNcj9fHxkh/+s/oVw+JmQ ($23.60 in chips) 
Seat 6: w1ukf8uPa4+WH561TtVRxA ($25 in chips) 
Seat 7: CmngQmkKTp8tkl6GMRTl6w ($8.50 in chips) 
Seat 8: f/H6PsHRl4W1JyNsEDvPtg ($34.80 in chips) 
Seat 9: /artgaAtyUtUtD8FZo6puA ($11.10 in chips) 
ir5Jy8ck6DrdqgJ/3chcWw: posts small blind $0.10
aNpwfA31EREwO+ar4XzBCw: posts big blind $0.25
*** HOLE CARDS ***
QBNcj9fHxkh/+s/oVw+JmQ: folds 
w1ukf8uPa4+WH561TtVRxA: folds 
CmngQmkKTp8tkl6GMRTl6w: folds 
f/H6PsHRl4W1JyNsEDvPtg: folds 
/artgaAtyUtUtD8FZo6puA: calls $0.25
QEbIGci+itdw+re8RM5fZA: folds 
jJnMGXoBXye+afMd0k0rUw: folds 
ir5Jy8ck6DrdqgJ/3chcWw: calls $0.15
aNpwfA31EREwO+ar4XzBCw: checks 
*** FLOP *** [Kc 7c 2d]
ir5Jy8ck6DrdqgJ/3chcWw: bets $0.25
f/H6PsHRl4W1JyNsEDvPtg leaves the table
aNpwfA31EREwO+ar4XzBCw: folds 
/artgaAtyUtUtD8FZo6puA: calls $0.25
*** TURN *** [Kc 7c 2d] [Tc]
ir5Jy8ck6DrdqgJ/3chcWw: checks 
/artgaAtyUtUtD8FZo6puA: bets $1
ir5Jy8ck6DrdqgJ/3chcWw: calls $1
*** RIVER *** [Kc 7c 2d Tc] [Qc]
razor365 joins the table at seat #8 
ir5Jy8ck6DrdqgJ/3chcWw: bets $0.50
/artgaAtyUtUtD8FZo6puA: folds 
Uncalled bet ($0.50) returned to ir5Jy8ck6DrdqgJ/3chcWw
ir5Jy8ck6DrdqgJ/3chcWw collected $3.10 from pot
*** SUMMARY ***
Total pot $3.25 | Rake $0.15 
Board [Kc 7c 2d Tc Qc]
Seat 1: QEbIGci+itdw+re8RM5fZA folded before Flop (didn't bet)
Seat 2: jJnMGXoBXye+afMd0k0rUw (button) folded before Flop (didn't bet)
Seat 3: ir5Jy8ck6DrdqgJ/3chcWw (small blind) collected ($3.10)
Seat 4: aNpwfA31EREwO+ar4XzBCw (big blind) folded on the Flop
Seat 5: QBNcj9fHxkh/+s/oVw+JmQ folded before Flop (didn't bet)
Seat 6: w1ukf8uPa4+WH561TtVRxA folded before Flop (didn't bet)
Seat 7: CmngQmkKTp8tkl6GMRTl6w folded before Flop (didn't bet)
Seat 8: f/H6PsHRl4W1JyNsEDvPtg folded before Flop (didn't bet)
Seat 9: /artgaAtyUtUtD8FZo6puA folded on the River




PokerStars Game #59941757440:  Hold'em No Limit ($0.10/$0.25) - 2009/07/01 1:45:12 ET
Table 'dNYnr4D4id1jwnEU66Yowg' 9-max Seat #3 is the button
Seat 1: 9lvO/qyU+xrU95Teu1fv0g ($4.40 in chips) 
Seat 2: Qduu7ikeizo6q6Ei9YvcJA ($24.65 in chips) 
Seat 3: IOx4EH8+y3jYZJc/LTRvOw ($25.75 in chips) 
Seat 4: VBHxUExRAMrbxUq/cVx9Gw ($4.70 in chips) 
Seat 5: 7cv+9Zc9HIQHNvYsMfV3uA ($25 in chips) 
Seat 6: 8EbrQ/EvFWt2cr0GaU82gQ ($4.65 in chips) 
Seat 7: DiSvPC2iudwL5j9u6Huyww ($25 in chips) 
Seat 8: RCqMONFrSPSArZh2Jsar/w ($34.10 in chips) 
Seat 9: /FE4MKSoQhXaDp4PBoLM2g ($14.50 in chips) 
VBHxUExRAMrbxUq/cVx9Gw: posts small blind $0.10
7cv+9Zc9HIQHNvYsMfV3uA: posts big blind $0.25
*** HOLE CARDS ***
8EbrQ/EvFWt2cr0GaU82gQ: folds 
DiSvPC2iudwL5j9u6Huyww: folds 
RCqMONFrSPSArZh2Jsar/w: folds 
/FE4MKSoQhXaDp4PBoLM2g: calls $0.25
9lvO/qyU+xrU95Teu1fv0g: folds 
Qduu7ikeizo6q6Ei9YvcJA: folds 
IOx4EH8+y3jYZJc/LTRvOw: folds 
VBHxUExRAMrbxUq/cVx9Gw: folds 
7cv+9Zc9HIQHNvYsMfV3uA: checks 
*** FLOP *** [Kc Tc Td]
7cv+9Zc9HIQHNvYsMfV3uA: checks 
/FE4MKSoQhXaDp4PBoLM2g: checks 
*** TURN *** [Kc Tc Td] [5h]
7cv+9Zc9HIQHNvYsMfV3uA: checks 
/FE4MKSoQhXaDp4PBoLM2g: checks 
*** RIVER *** [Kc Tc Td 5h] [7h]
7cv+9Zc9HIQHNvYsMfV3uA: checks 
/FE4MKSoQhXaDp4PBoLM2g: bets $0.50
7cv+9Zc9HIQHNvYsMfV3uA: folds 
Uncalled bet ($0.50) returned to /FE4MKSoQhXaDp4PBoLM2g
/FE4MKSoQhXaDp4PBoLM2g collected $0.60 from pot
/FE4MKSoQhXaDp4PBoLM2g: doesn't show hand 
*** SUMMARY ***
Total pot $0.60 | Rake $0 
Board [Kc Tc Td 5h 7h]
Seat 1: 9lvO/qyU+xrU95Teu1fv0g folded before Flop (didn't bet)
Seat 2: Qduu7ikeizo6q6Ei9YvcJA folded before Flop (didn't bet)
Seat 3: IOx4EH8+y3jYZJc/LTRvOw (button) folded before Flop (didn't bet)
Seat 4: VBHxUExRAMrbxUq/cVx9Gw (small blind) folded before Flop
Seat 5: 7cv+9Zc9HIQHNvYsMfV3uA (big blind) folded on the River
Seat 6: 8EbrQ/EvFWt2cr0GaU82gQ folded before Flop (didn't bet)
Seat 7: DiSvPC2iudwL5j9u6Huyww folded before Flop (didn't bet)
Seat 8: RCqMONFrSPSArZh2Jsar/w folded before Flop (didn't bet)
Seat 9: /FE4MKSoQhXaDp4PBoLM2g collected ($0.60)




PokerStars Game #59941757696:  Hold'em No Limit ($0.10/$0.25) - 2009/07/01 1:45:12 ET
Table '+fuYjvJy9okLr23QyZtanA' 9-max Seat #2 is the button
Seat 1: l9hUFnOCgg4TPYga9bvxhw ($10.70 in chips) 
Seat 2: tLcDklc2rBORNfixyRfVfw ($25 in chips) 
Seat 3: eK8qa6EPcH2zhtbmWSvc9g ($52.40 in chips) 
Seat 4: Bb42QRQMhg5/Y0vHP8/2Xw ($30.50 in chips) 
Seat 5: bXpVeaSTPBFSPJmeXxO7nw ($4.65 in chips) 
Seat 6: wGigCmBR/9XWkPpvYos3aQ ($30.20 in chips) 
Seat 7: dfNim92Z6XK1/h5SFW5vDg ($26.55 in chips) 
Seat 8: KqS/lY/fNB9qUxokm9QfeA ($12.25 in chips) 
Seat 9: OMhlmt2waO3z43ZSFNMmog ($27.90 in chips) 
eK8qa6EPcH2zhtbmWSvc9g: posts small blind $0.10
Bb42QRQMhg5/Y0vHP8/2Xw: posts big blind $0.25
*** HOLE CARDS ***
bXpVeaSTPBFSPJmeXxO7nw: folds 
wGigCmBR/9XWkPpvYos3aQ: folds 
dfNim92Z6XK1/h5SFW5vDg: folds 
KqS/lY/fNB9qUxokm9QfeA: calls $0.25
OMhlmt2waO3z43ZSFNMmog: calls $0.25
l9hUFnOCgg4TPYga9bvxhw: folds 
tLcDklc2rBORNfixyRfVfw: folds 
eK8qa6EPcH2zhtbmWSvc9g: folds 
Bb42QRQMhg5/Y0vHP8/2Xw: checks 
*** FLOP *** [3h Th 9c]
Bb42QRQMhg5/Y0vHP8/2Xw: checks 
KqS/lY/fNB9qUxokm9QfeA: checks 
OMhlmt2waO3z43ZSFNMmog: bets $1.25
Bb42QRQMhg5/Y0vHP8/2Xw: folds 
KqS/lY/fNB9qUxokm9QfeA: calls $1.25
*** TURN *** [3h Th 9c] [4c]
KqS/lY/fNB9qUxokm9QfeA: checks 
OMhlmt2waO3z43ZSFNMmog: checks 
*** RIVER *** [3h Th 9c 4c] [2s]
KqS/lY/fNB9qUxokm9QfeA: bets $1.50
OMhlmt2waO3z43ZSFNMmog: calls $1.50
*** SHOW DOWN ***
KqS/lY/fNB9qUxokm9QfeA: shows [Qd Jd] (high card Queen)
OMhlmt2waO3z43ZSFNMmog: shows [9h Qh] (a pair of Nines)
OMhlmt2waO3z43ZSFNMmog collected $6.05 from pot
*** SUMMARY ***
Total pot $6.35 | Rake $0.30 
Board [3h Th 9c 4c 2s]
Seat 1: l9hUFnOCgg4TPYga9bvxhw folded before Flop (didn't bet)
Seat 2: tLcDklc2rBORNfixyRfVfw (button) folded before Flop (didn't bet)
Seat 3: eK8qa6EPcH2zhtbmWSvc9g (small blind) folded before Flop
Seat 4: Bb42QRQMhg5/Y0vHP8/2Xw (big blind) folded on the Flop
Seat 5: bXpVeaSTPBFSPJmeXxO7nw folded before Flop (didn't bet)
Seat 6: wGigCmBR/9XWkPpvYos3aQ folded before Flop (didn't bet)
Seat 7: dfNim92Z6XK1/h5SFW5vDg folded before Flop (didn't bet)
Seat 8: KqS/lY/fNB9qUxokm9QfeA showed [Qd Jd] and lost with high card Queen
Seat 9: OMhlmt2waO3z43ZSFNMmog showed [9h Qh] and won ($6.05) with a pair of Nines




PokerStars Game #59941757448:  Hold'em No Limit ($0.10/$0.25) - 2009/07/01 1:45:12 ET
Table 'GrYi0DZOHD1EvB+qiLExNw' 9-max Seat #2 is the button
Seat 1: sk7OEPqYdQE7GJKyQHkssg ($13 in chips) 
Seat 2: Th3FldXKQW6hWVVPahaoOQ ($46.70 in chips) 
Seat 4: 8x95tVlB4uFBVHp71KihMA ($35.50 in chips) 
Seat 5: cZ99hugmLBj9KhTlc8nCSw ($25.30 in chips) 
Seat 6: arxNSjreDRGFg13EAM2F1w ($25.25 in chips) 
Seat 7: 9lvO/qyU+xrU95Teu1fv0g ($19.35 in chips) 
Seat 8: MtVtHDqIJTyUcXkRBBDIVA ($25 in chips) 
Seat 9: 5hAPbqNrvJb8PtLiceXtlg ($13.40 in chips) 
RHqgdFvufLCYe54+qd2gcA will be allowed to play after the button
8x95tVlB4uFBVHp71KihMA: posts small blind $0.10
cZ99hugmLBj9KhTlc8nCSw: posts big blind $0.25
*** HOLE CARDS ***
arxNSjreDRGFg13EAM2F1w: calls $0.25
9lvO/qyU+xrU95Teu1fv0g: raises $0.75 to $1
MtVtHDqIJTyUcXkRBBDIVA: folds 
5hAPbqNrvJb8PtLiceXtlg: folds 
sk7OEPqYdQE7GJKyQHkssg: folds 
sk7OEPqYdQE7GJKyQHkssg leaves the table
Th3FldXKQW6hWVVPahaoOQ: folds 
8x95tVlB4uFBVHp71KihMA: folds 
cZ99hugmLBj9KhTlc8nCSw: folds 
7je+LC5Mfs6nL8YBVh4frQ joins the table at seat #1 
arxNSjreDRGFg13EAM2F1w: calls $0.75
*** FLOP *** [Td Qc 2d]
arxNSjreDRGFg13EAM2F1w: checks 
9lvO/qyU+xrU95Teu1fv0g: bets $1.25
arxNSjreDRGFg13EAM2F1w: calls $1.25
*** TURN *** [Td Qc 2d] [2h]
arxNSjreDRGFg13EAM2F1w: checks 
9lvO/qyU+xrU95Teu1fv0g: bets $2
arxNSjreDRGFg13EAM2F1w: calls $2
*** RIVER *** [Td Qc 2d 2h] [Ac]
arxNSjreDRGFg13EAM2F1w: checks 
9lvO/qyU+xrU95Teu1fv0g: bets $4
arxNSjreDRGFg13EAM2F1w: folds 
Uncalled bet ($4) returned to 9lvO/qyU+xrU95Teu1fv0g
9lvO/qyU+xrU95Teu1fv0g collected $8.45 from pot
*** SUMMARY ***
Total pot $8.85 | Rake $0.40 
Board [Td Qc 2d 2h Ac]
Seat 1: sk7OEPqYdQE7GJKyQHkssg folded before Flop (didn't bet)
Seat 2: Th3FldXKQW6hWVVPahaoOQ (button) folded before Flop (didn't bet)
Seat 4: 8x95tVlB4uFBVHp71KihMA (small blind) folded before Flop
Seat 5: cZ99hugmLBj9KhTlc8nCSw (big blind) folded before Flop
Seat 6: arxNSjreDRGFg13EAM2F1w folded on the River
Seat 7: 9lvO/qyU+xrU95Teu1fv0g collected ($8.45)
Seat 8: MtVtHDqIJTyUcXkRBBDIVA folded before Flop (didn't bet)
Seat 9: 5hAPbqNrvJb8PtLiceXtlg folded before Flop (didn't bet)




PokerStars Game #59941757528:  Hold'em No Limit ($0.10/$0.25) - 2009/07/01 1:45:12 ET
Table '3lS+sU5k6mwJCS2nFMmQ6Q' 9-max Seat #6 is the button
Seat 1: VWUWpMLMj/Q1jRVpF7Aohw ($13.45 in chips) 
Seat 3: 1DXccE2UUK5DIRVGlOKnTA ($11.95 in chips) 
Seat 4: ydoFOVgzvZv9ZhuWu9rXAw ($10.70 in chips) 
Seat 5: NcPAt5YjVvDFEJTTgAVj8g ($5.75 in chips) 
Seat 6: hJ4uYjNmSZdjrKA8cjZqCA ($35.75 in chips) 
Seat 7: Th3FldXKQW6hWVVPahaoOQ ($31.30 in chips) 
Seat 8: 9lvO/qyU+xrU95Teu1fv0g ($5 in chips) 
Seat 9: 4awUyiDYTgylQKXZ9faBVA ($49.20 in chips) 
Th3FldXKQW6hWVVPahaoOQ: posts small blind $0.10
9lvO/qyU+xrU95Teu1fv0g: posts big blind $0.25
PdIasPkzm2sqZnN41ZRXOg: sits out 
*** HOLE CARDS ***
4awUyiDYTgylQKXZ9faBVA: folds 
VWUWpMLMj/Q1jRVpF7Aohw: folds 
1DXccE2UUK5DIRVGlOKnTA: folds 
ydoFOVgzvZv9ZhuWu9rXAw: folds 
NcPAt5YjVvDFEJTTgAVj8g: calls $0.25
hJ4uYjNmSZdjrKA8cjZqCA: folds 
Th3FldXKQW6hWVVPahaoOQ: folds 
9lvO/qyU+xrU95Teu1fv0g: checks 
*** FLOP *** [Th 2s Qd]
9lvO/qyU+xrU95Teu1fv0g: bets $0.50
NcPAt5YjVvDFEJTTgAVj8g: folds 
Uncalled bet ($0.50) returned to 9lvO/qyU+xrU95Teu1fv0g
9lvO/qyU+xrU95Teu1fv0g collected $0.60 from pot
*** SUMMARY ***
Total pot $0.60 | Rake $0 
Board [Th 2s Qd]
Seat 1: VWUWpMLMj/Q1jRVpF7Aohw folded before Flop (didn't bet)
Seat 3: 1DXccE2UUK5DIRVGlOKnTA folded before Flop (didn't bet)
Seat 4: ydoFOVgzvZv9ZhuWu9rXAw folded before Flop (didn't bet)
Seat 5: NcPAt5YjVvDFEJTTgAVj8g folded on the Flop
Seat 6: hJ4uYjNmSZdjrKA8cjZqCA (button) folded before Flop (didn't bet)
Seat 7: Th3FldXKQW6hWVVPahaoOQ (small blind) folded before Flop
Seat 8: 9lvO/qyU+xrU95Teu1fv0g (big blind) collected ($0.60)
Seat 9: 4awUyiDYTgylQKXZ9faBVA folded before Flop (didn't bet)




PokerStars Game #59941757666:  Hold'em No Limit ($0.10/$0.25) - 2009/07/01 1:45:12 ET
Table 'zW+7jPbOLCvlPu+dUGY5WQ' 6-max Seat #6 is the button
Seat 1: eL3+wCBjFGfQ5FMdIZihwA ($26.60 in chips) 
Seat 2: cEMJmfAUQZmMChZe6aacKw ($8.60 in chips) 
Seat 4: i48129QFpEQQ+UN4aNtmww ($20.30 in chips) 
Seat 6: qGHGf/553gQnDoklMRe3tg ($24.65 in chips) 
eL3+wCBjFGfQ5FMdIZihwA: posts small blind $0.10
cEMJmfAUQZmMChZe6aacKw: posts big blind $0.25
Hsvkc0/G2VV78oVmWYXecw: sits out 
*** HOLE CARDS ***
i48129QFpEQQ+UN4aNtmww: folds 
qGHGf/553gQnDoklMRe3tg: raises $0.75 to $1
eL3+wCBjFGfQ5FMdIZihwA: folds 
cEMJmfAUQZmMChZe6aacKw: folds 
Uncalled bet ($0.75) returned to qGHGf/553gQnDoklMRe3tg
qGHGf/553gQnDoklMRe3tg collected $0.60 from pot
qGHGf/553gQnDoklMRe3tg: doesn't show hand 
*** SUMMARY ***
Total pot $0.60 | Rake $0 
Seat 1: eL3+wCBjFGfQ5FMdIZihwA (small blind) folded before Flop
Seat 2: cEMJmfAUQZmMChZe6aacKw (big blind) folded before Flop
Seat 4: i48129QFpEQQ+UN4aNtmww folded before Flop (didn't bet)
Seat 6: qGHGf/553gQnDoklMRe3tg (button) collected ($0.60)




PokerStars Game #59941758342:  Hold'em No Limit ($0.10/$0.25) - 2009/07/01 1:45:13 ET
Table 'NfXsh0UQA+o/kO9acV3WxA' 9-max Seat #5 is the button
Seat 1: pN3IHvAKm2fz+sTRARTcrg ($24.65 in chips) 
Seat 2: mhpFs2SZupy4zLRb62FLFA ($25 in chips) 
Seat 3: wCUaomJ6Nq5zomVGdUHP+w ($19.50 in chips) 
Seat 4: r6hsffOo1iKmaPYKwAZmFw ($30.05 in chips) 
Seat 5: zgi+EUykT/pZQpoUG6+oEg ($4.65 in chips) 
Seat 7: yqkowiRWZ6NvRN9UUkYIlA ($5 in chips) 
Seat 8: +sbyWwIcFp9kP0bDtMegfQ ($41.75 in chips) 
Seat 9: uhrboV251dcgYniYTdFIcA ($25.70 in chips) 
yqkowiRWZ6NvRN9UUkYIlA: posts small blind $0.10
+sbyWwIcFp9kP0bDtMegfQ: posts big blind $0.25
*** HOLE CARDS ***
uhrboV251dcgYniYTdFIcA: raises $0.75 to $1
pN3IHvAKm2fz+sTRARTcrg: folds 
mhpFs2SZupy4zLRb62FLFA: folds 
wCUaomJ6Nq5zomVGdUHP+w: raises $1 to $2
r6hsffOo1iKmaPYKwAZmFw: folds 
zgi+EUykT/pZQpoUG6+oEg: folds 
yqkowiRWZ6NvRN9UUkYIlA: folds 
qwr38jl5txoR36M7G5qi4A joins the table at seat #6 
+sbyWwIcFp9kP0bDtMegfQ: folds 
uhrboV251dcgYniYTdFIcA: calls $1
*** FLOP *** [As 7h 3h]
uhrboV251dcgYniYTdFIcA: checks 
wCUaomJ6Nq5zomVGdUHP+w: checks 
*** TURN *** [As 7h 3h] [7s]
uhrboV251dcgYniYTdFIcA: bets $1.50
wCUaomJ6Nq5zomVGdUHP+w: calls $1.50
*** RIVER *** [As 7h 3h 7s] [Td]
uhrboV251dcgYniYTdFIcA: bets $4.25
wCUaomJ6Nq5zomVGdUHP+w: folds 
Uncalled bet ($4.25) returned to uhrboV251dcgYniYTdFIcA
uhrboV251dcgYniYTdFIcA collected $7 from pot
uhrboV251dcgYniYTdFIcA: doesn't show hand 
*** SUMMARY ***
Total pot $7.35 | Rake $0.35 
Board [As 7h 3h 7s Td]
Seat 1: pN3IHvAKm2fz+sTRARTcrg folded before Flop (didn't bet)
Seat 2: mhpFs2SZupy4zLRb62FLFA folded before Flop (didn't bet)
Seat 3: wCUaomJ6Nq5zomVGdUHP+w folded on the River
Seat 4: r6hsffOo1iKmaPYKwAZmFw folded before Flop (didn't bet)
Seat 5: zgi+EUykT/pZQpoUG6+oEg (button) folded before Flop (didn't bet)
Seat 7: yqkowiRWZ6NvRN9UUkYIlA (small blind) folded before Flop
Seat 8: +sbyWwIcFp9kP0bDtMegfQ (big blind) folded before Flop
Seat 9: uhrboV251dcgYniYTdFIcA collected ($7)




PokerStars Game #59941758268:  Hold'em No Limit ($0.10/$0.25) - 2009/07/01 1:45:13 ET
Table 'fRxOyfaHXkWUDLv4eSxFew' 9-max Seat #9 is the button
Seat 1: 6RiVTYll/5D8zICp0MRpKw ($28.90 in chips) 
Seat 2: M2QO2DxB5Wawg2h8HSpnYA ($10.35 in chips) 
Seat 4: MtVtHDqIJTyUcXkRBBDIVA ($27.60 in chips) 
Seat 5: dmYlc+1cjwZMJ7wV+Z0rRg ($22.75 in chips) 
Seat 6: arxNSjreDRGFg13EAM2F1w ($27.05 in chips) 
Seat 7: 1/DuWziR8CXhWB71aPQd9Q ($11.80 in chips) 
Seat 8: 5n7e7I+px7c6CQmLpPbtsg ($5.90 in chips) 
Seat 9: H5Se03ZqSX7tbULXur2MAg ($32.65 in chips) 
6RiVTYll/5D8zICp0MRpKw: posts small blind $0.10
M2QO2DxB5Wawg2h8HSpnYA: posts big blind $0.25
E0iYnEVO2ho7dH3QcCjw7g: sits out 
*** HOLE CARDS ***
MtVtHDqIJTyUcXkRBBDIVA: raises $0.50 to $0.75
dmYlc+1cjwZMJ7wV+Z0rRg: folds 
arxNSjreDRGFg13EAM2F1w: folds 
1/DuWziR8CXhWB71aPQd9Q: folds 
5n7e7I+px7c6CQmLpPbtsg: folds 
H5Se03ZqSX7tbULXur2MAg: folds 
6RiVTYll/5D8zICp0MRpKw: folds 
M2QO2DxB5Wawg2h8HSpnYA: folds 
Uncalled bet ($0.50) returned to MtVtHDqIJTyUcXkRBBDIVA
MtVtHDqIJTyUcXkRBBDIVA collected $0.60 from pot
MtVtHDqIJTyUcXkRBBDIVA: doesn't show hand 
*** SUMMARY ***
Total pot $0.60 | Rake $0 
Seat 1: 6RiVTYll/5D8zICp0MRpKw (small blind) folded before Flop
Seat 2: M2QO2DxB5Wawg2h8HSpnYA (big blind) folded before Flop
Seat 4: MtVtHDqIJTyUcXkRBBDIVA collected ($0.60)
Seat 5: dmYlc+1cjwZMJ7wV+Z0rRg folded before Flop (didn't bet)
Seat 6: arxNSjreDRGFg13EAM2F1w folded before Flop (didn't bet)
Seat 7: 1/DuWziR8CXhWB71aPQd9Q folded before Flop (didn't bet)
Seat 8: 5n7e7I+px7c6CQmLpPbtsg folded before Flop (didn't bet)
Seat 9: H5Se03ZqSX7tbULXur2MAg (button) folded before Flop (didn't bet)




PokerStars Game #59941758240:  Hold'em No Limit ($0.10/$0.25) - 2009/07/01 1:45:13 ET
Table '0M5QEJGOThqZwQ/sjbjXYw' 6-max Seat #3 is the button
Seat 2: /gJNBeCkWL4o85/jvlZ4BA ($34.60 in chips) 
Seat 3: 3zD3qLXT1bEffAoWGnc7wg ($25 in chips) 
Seat 4: oBUDUfeUyCbZBsjxHZgSiw ($22.35 in chips) 
Seat 5: cWc85bEzdRzpUMhRKm8pwQ ($28.05 in chips) 
Seat 6: bb63I02U6p9a5MNFa1gCiw ($26 in chips) 
oBUDUfeUyCbZBsjxHZgSiw: posts small blind $0.10
cWc85bEzdRzpUMhRKm8pwQ: posts big blind $0.25
*** HOLE CARDS ***
bb63I02U6p9a5MNFa1gCiw: raises $0.25 to $0.50
/gJNBeCkWL4o85/jvlZ4BA: folds 
3zD3qLXT1bEffAoWGnc7wg: calls $0.50
oBUDUfeUyCbZBsjxHZgSiw: folds 
cWc85bEzdRzpUMhRKm8pwQ: calls $0.25
*** FLOP *** [2h Qs 2s]
cWc85bEzdRzpUMhRKm8pwQ: checks 
bb63I02U6p9a5MNFa1gCiw: bets $0.25
3zD3qLXT1bEffAoWGnc7wg: folds 
cWc85bEzdRzpUMhRKm8pwQ: calls $0.25
*** TURN *** [2h Qs 2s] [8s]
cWc85bEzdRzpUMhRKm8pwQ: checks 
bb63I02U6p9a5MNFa1gCiw: bets $1
cWc85bEzdRzpUMhRKm8pwQ: folds 
Uncalled bet ($1) returned to bb63I02U6p9a5MNFa1gCiw
bb63I02U6p9a5MNFa1gCiw collected $2 from pot
bb63I02U6p9a5MNFa1gCiw: doesn't show hand 
*** SUMMARY ***
Total pot $2.10 | Rake $0.10 
Board [2h Qs 2s 8s]
Seat 2: /gJNBeCkWL4o85/jvlZ4BA folded before Flop (didn't bet)
Seat 3: 3zD3qLXT1bEffAoWGnc7wg (button) folded on the Flop
Seat 4: oBUDUfeUyCbZBsjxHZgSiw (small blind) folded before Flop
Seat 5: cWc85bEzdRzpUMhRKm8pwQ (big blind) folded on the Turn
Seat 6: bb63I02U6p9a5MNFa1gCiw collected ($2)




PokerStars Game #59941757934:  Hold'em No Limit ($0.10/$0.25) - 2009/07/01 1:45:13 ET
Table 'sDHjMRwfSiz7+NDdZLUiyA' 9-max Seat #5 is the button
Seat 1: VGwr1eqhvdUtMfBFCvBnmg ($10.85 in chips) 
Seat 2: ljemhp25Zg+nlA9DLCIiUw ($25.70 in chips) 
Seat 3: SGA1WpAnQxFdFAYyt362gQ ($18.05 in chips) 
Seat 4: eK8qa6EPcH2zhtbmWSvc9g ($25 in chips) 
Seat 5: IGRfskE1v9H9Bn+fz8AgNQ ($37.05 in chips) 
Seat 6: 1qa0qHOCKZM3Uipx9DxYtQ ($15.90 in chips) 
Seat 7: K0b5wNInj6hUGRr6yzKFtw ($37.65 in chips) 
Seat 8: 3hMkm4U5yTRrkGJkxfijaQ ($2.90 in chips) 
Seat 9: 3PmVnC/15cl4oyI1TKIt4g ($4.05 in chips) 
1qa0qHOCKZM3Uipx9DxYtQ: posts small blind $0.10
K0b5wNInj6hUGRr6yzKFtw: posts big blind $0.25
*** HOLE CARDS ***
3hMkm4U5yTRrkGJkxfijaQ: calls $0.25
3PmVnC/15cl4oyI1TKIt4g: folds 
VGwr1eqhvdUtMfBFCvBnmg: calls $0.25
ljemhp25Zg+nlA9DLCIiUw: folds 
SGA1WpAnQxFdFAYyt362gQ: folds 
eK8qa6EPcH2zhtbmWSvc9g: calls $0.25
IGRfskE1v9H9Bn+fz8AgNQ: folds 
1qa0qHOCKZM3Uipx9DxYtQ: folds 
K0b5wNInj6hUGRr6yzKFtw: checks 
*** FLOP *** [2c 8c 6s]
K0b5wNInj6hUGRr6yzKFtw: checks 
3hMkm4U5yTRrkGJkxfijaQ: checks 
VGwr1eqhvdUtMfBFCvBnmg: bets $0.25
eK8qa6EPcH2zhtbmWSvc9g: raises $0.75 to $1
K0b5wNInj6hUGRr6yzKFtw: folds 
3hMkm4U5yTRrkGJkxfijaQ: folds 
VGwr1eqhvdUtMfBFCvBnmg: folds 
Uncalled bet ($0.75) returned to eK8qa6EPcH2zhtbmWSvc9g
eK8qa6EPcH2zhtbmWSvc9g collected $1.55 from pot
eK8qa6EPcH2zhtbmWSvc9g: doesn't show hand 
*** SUMMARY ***
Total pot $1.60 | Rake $0.05 
Board [2c 8c 6s]
Seat 1: VGwr1eqhvdUtMfBFCvBnmg folded on the Flop
Seat 2: ljemhp25Zg+nlA9DLCIiUw folded before Flop (didn't bet)
Seat 3: SGA1WpAnQxFdFAYyt362gQ folded before Flop (didn't bet)
Seat 4: eK8qa6EPcH2zhtbmWSvc9g collected ($1.55)
Seat 5: IGRfskE1v9H9Bn+fz8AgNQ (button) folded before Flop (didn't bet)
Seat 6: 1qa0qHOCKZM3Uipx9DxYtQ (small blind) folded before Flop
Seat 7: K0b5wNInj6hUGRr6yzKFtw (big blind) folded on the Flop
Seat 8: 3hMkm4U5yTRrkGJkxfijaQ folded on the Flop
Seat 9: 3PmVnC/15cl4oyI1TKIt4g folded before Flop (didn't bet)




PokerStars Game #59941758276:  Hold'em No Limit ($0.10/$0.25) - 2009/07/01 1:45:13 ET
Table 'IdXp6nyeW4FYaEK4qKCnwQ' 9-max Seat #2 is the button
Seat 1: tLcDklc2rBORNfixyRfVfw ($25 in chips) 
Seat 2: HPEB+AtKw1+C/cxU0o1ciw ($30.85 in chips) 
Seat 3: eK8qa6EPcH2zhtbmWSvc9g ($33.15 in chips) 
Seat 4: j4q3p0lesp63b1gZDwLBZw ($5.35 in chips) 
Seat 5: U41wNf6XauAiBOQaKu2ZIA ($23.15 in chips) 
Seat 6: arxNSjreDRGFg13EAM2F1w ($30.05 in chips) 
Seat 7: w1ukf8uPa4+WH561TtVRxA ($37 in chips) 
Seat 8: dtZ84flFEi4Q+SGrHMJRDQ ($31.10 in chips) 
Seat 9: s2xLPOl/vhl/26apJ3vsOQ ($28.90 in chips) 
eK8qa6EPcH2zhtbmWSvc9g: posts small blind $0.10
j4q3p0lesp63b1gZDwLBZw: posts big blind $0.25
*** HOLE CARDS ***
U41wNf6XauAiBOQaKu2ZIA: folds 
arxNSjreDRGFg13EAM2F1w: folds 
w1ukf8uPa4+WH561TtVRxA: folds 
dtZ84flFEi4Q+SGrHMJRDQ: folds 
s2xLPOl/vhl/26apJ3vsOQ: folds 
tLcDklc2rBORNfixyRfVfw: folds 
HPEB+AtKw1+C/cxU0o1ciw: folds 
eK8qa6EPcH2zhtbmWSvc9g: folds 
Uncalled bet ($0.15) returned to j4q3p0lesp63b1gZDwLBZw
j4q3p0lesp63b1gZDwLBZw collected $0.20 from pot
j4q3p0lesp63b1gZDwLBZw: doesn't show hand 
*** SUMMARY ***
Total pot $0.20 | Rake $0 
Seat 1: tLcDklc2rBORNfixyRfVfw folded before Flop (didn't bet)
Seat 2: HPEB+AtKw1+C/cxU0o1ciw (button) folded before Flop (didn't bet)
Seat 3: eK8qa6EPcH2zhtbmWSvc9g (small blind) folded before Flop
Seat 4: j4q3p0lesp63b1gZDwLBZw (big blind) collected ($0.20)
Seat 5: U41wNf6XauAiBOQaKu2ZIA folded before Flop (didn't bet)
Seat 6: arxNSjreDRGFg13EAM2F1w folded before Flop (didn't bet)
Seat 7: w1ukf8uPa4+WH561TtVRxA folded before Flop (didn't bet)
Seat 8: dtZ84flFEi4Q+SGrHMJRDQ folded before Flop (didn't bet)
Seat 9: s2xLPOl/vhl/26apJ3vsOQ folded before Flop (didn't bet)




PokerStars Game #59941758054:  Hold'em No Limit ($0.10/$0.25) - 2009/07/01 1:45:13 ET
Table '8PD/MTROSMd6Y8mZeykbpg' 6-max Seat #6 is the button
Seat 1: fxNpaToxECtD2Goelmg9vA ($29.10 in chips) 
Seat 2: 4TM16KVgEiQpLi4bVVWbVQ ($23.50 in chips) 
Seat 3: vqWjZmdQu/Hxw96/IJTWdQ ($25 in chips) 
Seat 4: DFi/Lzkjsfv8QswS80JX9Q ($53.70 in chips) 
Seat 5: z3tQwy28dp5FykDJC/wzQw ($25.60 in chips) 
Seat 6: trN/oHqTTbPw5MNuKrOpLw ($25.70 in chips) 
fxNpaToxECtD2Goelmg9vA: posts small blind $0.10
4TM16KVgEiQpLi4bVVWbVQ: posts big blind $0.25
*** HOLE CARDS ***
vqWjZmdQu/Hxw96/IJTWdQ: folds 
DFi/Lzkjsfv8QswS80JX9Q: folds 
z3tQwy28dp5FykDJC/wzQw: calls $0.25
trN/oHqTTbPw5MNuKrOpLw: folds 
fxNpaToxECtD2Goelmg9vA: calls $0.15
4TM16KVgEiQpLi4bVVWbVQ: checks 
*** FLOP *** [2h 5c 2s]
fxNpaToxECtD2Goelmg9vA: checks 
4TM16KVgEiQpLi4bVVWbVQ: checks 
z3tQwy28dp5FykDJC/wzQw: bets $0.50
fxNpaToxECtD2Goelmg9vA: folds 
4TM16KVgEiQpLi4bVVWbVQ: calls $0.50
*** TURN *** [2h 5c 2s] [8s]
4TM16KVgEiQpLi4bVVWbVQ: checks 
z3tQwy28dp5FykDJC/wzQw: checks 
*** RIVER *** [2h 5c 2s 8s] [3h]
4TM16KVgEiQpLi4bVVWbVQ: checks 
z3tQwy28dp5FykDJC/wzQw: checks 
*** SHOW DOWN ***
4TM16KVgEiQpLi4bVVWbVQ: shows [Kc 4c] (a pair of Deuces)
z3tQwy28dp5FykDJC/wzQw: shows [8h Ah] (two pair, Eights and Deuces)
z3tQwy28dp5FykDJC/wzQw collected $1.70 from pot
*** SUMMARY ***
Total pot $1.75 | Rake $0.05 
Board [2h 5c 2s 8s 3h]
Seat 1: fxNpaToxECtD2Goelmg9vA (small blind) folded on the Flop
Seat 2: 4TM16KVgEiQpLi4bVVWbVQ (big blind) showed [Kc 4c] and lost with a pair of Deuces
Seat 3: vqWjZmdQu/Hxw96/IJTWdQ folded before Flop (didn't bet)
Seat 4: DFi/Lzkjsfv8QswS80JX9Q folded before Flop (didn't bet)
Seat 5: z3tQwy28dp5FykDJC/wzQw showed [8h Ah] and won ($1.70) with two pair, Eights and Deuces
Seat 6: trN/oHqTTbPw5MNuKrOpLw (button) folded before Flop (didn't bet)




PokerStars Game #59941758242:  Hold'em No Limit ($0.10/$0.25) - 2009/07/01 1:45:13 ET
Table '9o8Yb3JpUqurD4pNVmOikQ' 6-max Seat #6 is the button
Seat 1: SFmT9ZsVopnukjvAzrxTRg ($27.30 in chips) 
Seat 2: /gJNBeCkWL4o85/jvlZ4BA ($25 in chips) 
Seat 3: JgRqo1/2phbf7pab7N3BIQ ($23.85 in chips) 
Seat 4: j5NZbEJHsERuXjPHWqc1Nw ($11.25 in chips) 
Seat 5: QqiZLFrN8iOUT/GHw7ztOA ($24.15 in chips) 
Seat 6: LyDHtw3/yniNHW+DvLXbog ($25.70 in chips) 
SFmT9ZsVopnukjvAzrxTRg: posts small blind $0.10
/gJNBeCkWL4o85/jvlZ4BA: posts big blind $0.25
*** HOLE CARDS ***
JgRqo1/2phbf7pab7N3BIQ: folds 
j5NZbEJHsERuXjPHWqc1Nw: calls $0.25
QqiZLFrN8iOUT/GHw7ztOA: folds 
LyDHtw3/yniNHW+DvLXbog: folds 
SFmT9ZsVopnukjvAzrxTRg: folds 
/gJNBeCkWL4o85/jvlZ4BA: checks 
*** FLOP *** [Jd Jc Ks]
/gJNBeCkWL4o85/jvlZ4BA: checks 
j5NZbEJHsERuXjPHWqc1Nw: checks 
*** TURN *** [Jd Jc Ks] [8d]
/gJNBeCkWL4o85/jvlZ4BA: checks 
j5NZbEJHsERuXjPHWqc1Nw: checks 
*** RIVER *** [Jd Jc Ks 8d] [7s]
/gJNBeCkWL4o85/jvlZ4BA: checks 
j5NZbEJHsERuXjPHWqc1Nw: checks 
*** SHOW DOWN ***
/gJNBeCkWL4o85/jvlZ4BA: shows [7d Ad] (two pair, Jacks and Sevens)
j5NZbEJHsERuXjPHWqc1Nw: mucks hand 
/gJNBeCkWL4o85/jvlZ4BA collected $0.60 from pot
*** SUMMARY ***
Total pot $0.60 | Rake $0 
Board [Jd Jc Ks 8d 7s]
Seat 1: SFmT9ZsVopnukjvAzrxTRg (small blind) folded before Flop
Seat 2: /gJNBeCkWL4o85/jvlZ4BA (big blind) showed [7d Ad] and won ($0.60) with two pair, Jacks and Sevens
Seat 3: JgRqo1/2phbf7pab7N3BIQ folded before Flop (didn't bet)
Seat 4: j5NZbEJHsERuXjPHWqc1Nw mucked
Seat 5: QqiZLFrN8iOUT/GHw7ztOA folded before Flop (didn't bet)
Seat 6: LyDHtw3/yniNHW+DvLXbog (button) folded before Flop (didn't bet)




PokerStars Game #59941758664:  Hold'em No Limit ($0.10/$0.25) - 2009/07/01 1:45:14 ET
Table '9L7XfAwuM7XsXE8LIg2o5Q' 6-max Seat #6 is the button
Seat 1: dOIoLBxmpLHSXBN9LZnf0Q ($23.95 in chips) 
Seat 2: LJI7A1YgDM7hgh7o56+ReQ ($28.90 in chips) 
Seat 3: mFv3iBCtrw9XfCDRB0d46Q ($4.65 in chips) 
Seat 4: jp34e617tIzV8tKIWmfAbA ($38.45 in chips) 
Seat 5: zsU1ijOyYEi+40wBKPEbmw ($8.65 in chips) 
Seat 6: k9nHZTHt8hYhYRcW8NTb4g ($37.30 in chips) 
dOIoLBxmpLHSXBN9LZnf0Q: posts small blind $0.10
LJI7A1YgDM7hgh7o56+ReQ: posts big blind $0.25
zsU1ijOyYEi+40wBKPEbmw: posts big blind $0.25
*** HOLE CARDS ***
mFv3iBCtrw9XfCDRB0d46Q: folds 
jp34e617tIzV8tKIWmfAbA: folds 
zsU1ijOyYEi+40wBKPEbmw: checks 
k9nHZTHt8hYhYRcW8NTb4g: raises $0.75 to $1
dOIoLBxmpLHSXBN9LZnf0Q: folds 
LJI7A1YgDM7hgh7o56+ReQ: folds 
zsU1ijOyYEi+40wBKPEbmw: folds 
Uncalled bet ($0.75) returned to k9nHZTHt8hYhYRcW8NTb4g
k9nHZTHt8hYhYRcW8NTb4g collected $0.85 from pot
k9nHZTHt8hYhYRcW8NTb4g: doesn't show hand 
*** SUMMARY ***
Total pot $0.85 | Rake $0 
Seat 1: dOIoLBxmpLHSXBN9LZnf0Q (small blind) folded before Flop
Seat 2: LJI7A1YgDM7hgh7o56+ReQ (big blind) folded before Flop
Seat 3: mFv3iBCtrw9XfCDRB0d46Q folded before Flop (didn't bet)
Seat 4: jp34e617tIzV8tKIWmfAbA folded before Flop (didn't bet)
Seat 5: zsU1ijOyYEi+40wBKPEbmw folded before Flop
Seat 6: k9nHZTHt8hYhYRcW8NTb4g (button) collected ($0.85)




PokerStars Game #59941758690:  Hold'em No Limit ($0.10/$0.25) - 2009/07/01 1:45:14 ET
Table 'srBTB98reCdD1TffxE6o7g' 6-max Seat #2 is the button
Seat 1: SFmT9ZsVopnukjvAzrxTRg ($33.95 in chips) 
Seat 2: mfrkWA3PTeYPkbO6hi98Aw ($25 in chips) 
Seat 3: VOmI0x4dDPnTESZd5B4d1Q ($47.95 in chips) 
Seat 4: 6DwBRH+xZ12AAZmeAg+aXw ($16.55 in chips) 
Seat 5: 8zUCJvLYLFM8AG6K5zjIvg ($16.60 in chips) 
Seat 6: BV+K0Phf5VBHr7aZPKqbUQ ($34.95 in chips) 
VOmI0x4dDPnTESZd5B4d1Q: posts small blind $0.10
6DwBRH+xZ12AAZmeAg+aXw: posts big blind $0.25
*** HOLE CARDS ***
8zUCJvLYLFM8AG6K5zjIvg: raises $1.25 to $1.50
BV+K0Phf5VBHr7aZPKqbUQ: folds 
SFmT9ZsVopnukjvAzrxTRg: folds 
mfrkWA3PTeYPkbO6hi98Aw: folds 
VOmI0x4dDPnTESZd5B4d1Q: calls $1.40
6DwBRH+xZ12AAZmeAg+aXw: folds 
*** FLOP *** [8c Kd 9c]
VOmI0x4dDPnTESZd5B4d1Q: checks 
8zUCJvLYLFM8AG6K5zjIvg: bets $1.50
VOmI0x4dDPnTESZd5B4d1Q: raises $3.25 to $4.75
8zUCJvLYLFM8AG6K5zjIvg: calls $3.25
*** TURN *** [8c Kd 9c] [2d]
VOmI0x4dDPnTESZd5B4d1Q: checks 
8zUCJvLYLFM8AG6K5zjIvg: bets $1.50
VOmI0x4dDPnTESZd5B4d1Q: folds 
Uncalled bet ($1.50) returned to 8zUCJvLYLFM8AG6K5zjIvg
8zUCJvLYLFM8AG6K5zjIvg collected $12.15 from pot
8zUCJvLYLFM8AG6K5zjIvg is sitting out
8zUCJvLYLFM8AG6K5zjIvg: shows [Js Ks] (a pair of Kings)
*** SUMMARY ***
Total pot $12.75 | Rake $0.60 
Board [8c Kd 9c 2d]
Seat 1: SFmT9ZsVopnukjvAzrxTRg folded before Flop (didn't bet)
Seat 2: mfrkWA3PTeYPkbO6hi98Aw (button) folded before Flop (didn't bet)
Seat 3: VOmI0x4dDPnTESZd5B4d1Q (small blind) folded on the Turn
Seat 4: 6DwBRH+xZ12AAZmeAg+aXw (big blind) folded before Flop
Seat 5: 8zUCJvLYLFM8AG6K5zjIvg collected ($12.15)
Seat 6: BV+K0Phf5VBHr7aZPKqbUQ folded before Flop (didn't bet)




PokerStars Game #59941758564:  Hold'em No Limit ($0.10/$0.25) - 2009/07/01 1:45:14 ET
Table 'MiquQrQZJJq9ZtgRIp9HFQ' 6-max Seat #1 is the button
Seat 1: c3J/KYZ4cNsUEuz8v57I5A ($20.55 in chips) 
Seat 2: 2+6voGl1T1DO63JePptI3g ($19.10 in chips) 
Seat 3: 9h7TNZ1TDGRUJXA6rI+ZTw ($9.75 in chips) 
Seat 4: wAKC8C/zN0c8V5v13dm9mA ($58.30 in chips) 
Seat 5: iyZxqznXjv3vtvOJymkoLQ ($26.75 in chips) 
Seat 6: GbCVUNssQ7mqsPWr7J4d3w ($5 in chips) 
2+6voGl1T1DO63JePptI3g: posts small blind $0.10
9h7TNZ1TDGRUJXA6rI+ZTw: posts big blind $0.25
*** HOLE CARDS ***
wAKC8C/zN0c8V5v13dm9mA: folds 
iyZxqznXjv3vtvOJymkoLQ: folds 
GbCVUNssQ7mqsPWr7J4d3w: folds 
c3J/KYZ4cNsUEuz8v57I5A: raises $0.50 to $0.75
2+6voGl1T1DO63JePptI3g: folds 
9h7TNZ1TDGRUJXA6rI+ZTw: folds 
Uncalled bet ($0.50) returned to c3J/KYZ4cNsUEuz8v57I5A
c3J/KYZ4cNsUEuz8v57I5A collected $0.60 from pot
c3J/KYZ4cNsUEuz8v57I5A: doesn't show hand 
*** SUMMARY ***
Total pot $0.60 | Rake $0 
Seat 1: c3J/KYZ4cNsUEuz8v57I5A (button) collected ($0.60)
Seat 2: 2+6voGl1T1DO63JePptI3g (small blind) folded before Flop
Seat 3: 9h7TNZ1TDGRUJXA6rI+ZTw (big blind) folded before Flop
Seat 4: wAKC8C/zN0c8V5v13dm9mA folded before Flop (didn't bet)
Seat 5: iyZxqznXjv3vtvOJymkoLQ folded before Flop (didn't bet)
Seat 6: GbCVUNssQ7mqsPWr7J4d3w folded before Flop (didn't bet)




PokerStars Game #59941758444:  Hold'em No Limit ($0.10/$0.25) - 2009/07/01 1:45:14 ET
Table 'uFgIyfWPagvEVGEb86da7A' 9-max Seat #2 is the button
Seat 1: CT7Xj/V/O5rBlhtt+RZeFQ ($25.75 in chips) 
Seat 2: o3zvoO+PsqGti+1NZGNRrQ ($1.25 in chips) 
Seat 3: eGAnPT3w+iltM7HF59dzIg ($6 in chips) 
Seat 4: IGRfskE1v9H9Bn+fz8AgNQ ($27.25 in chips) 
Seat 5: X78b5v/uhqeXXoAijbw/yg ($28.30 in chips) 
Seat 7: 9zx7Mlww974uHUqoiq2eXA ($11.85 in chips) 
Seat 8: uLP/lYn7oKq9xCChBXsXxw ($24.30 in chips) 
Seat 9: sL5EaDXc90Iyxlm8ERXRQw ($18 in chips) 
eGAnPT3w+iltM7HF59dzIg: posts small blind $0.10
IGRfskE1v9H9Bn+fz8AgNQ: posts big blind $0.25
*** HOLE CARDS ***
X78b5v/uhqeXXoAijbw/yg: folds 
9zx7Mlww974uHUqoiq2eXA: folds 
uLP/lYn7oKq9xCChBXsXxw: folds 
sL5EaDXc90Iyxlm8ERXRQw: raises $0.25 to $0.50
CT7Xj/V/O5rBlhtt+RZeFQ: folds 
o3zvoO+PsqGti+1NZGNRrQ: folds 
eGAnPT3w+iltM7HF59dzIg: folds 
IGRfskE1v9H9Bn+fz8AgNQ: folds 
Uncalled bet ($0.25) returned to sL5EaDXc90Iyxlm8ERXRQw
sL5EaDXc90Iyxlm8ERXRQw collected $0.60 from pot
sL5EaDXc90Iyxlm8ERXRQw: doesn't show hand 
*** SUMMARY ***
Total pot $0.60 | Rake $0 
Seat 1: CT7Xj/V/O5rBlhtt+RZeFQ folded before Flop (didn't bet)
Seat 2: o3zvoO+PsqGti+1NZGNRrQ (button) folded before Flop (didn't bet)
Seat 3: eGAnPT3w+iltM7HF59dzIg (small blind) folded before Flop
Seat 4: IGRfskE1v9H9Bn+fz8AgNQ (big blind) folded before Flop
Seat 5: X78b5v/uhqeXXoAijbw/yg folded before Flop (didn't bet)
Seat 7: 9zx7Mlww974uHUqoiq2eXA folded before Flop (didn't bet)
Seat 8: uLP/lYn7oKq9xCChBXsXxw folded before Flop (didn't bet)
Seat 9: sL5EaDXc90Iyxlm8ERXRQw collected ($0.60)




PokerStars Game #59941758512:  Hold'em No Limit ($0.10/$0.25) - 2009/07/01 1:45:14 ET
Table '/JJyyIstHfkT7t/bW+WXgg' 6-max Seat #5 is the button
Seat 2: obJgSnVgWWWaAUtVILo77Q ($18 in chips) 
Seat 3: DR0nVIhVP77oEBlO9J8vlg ($36.05 in chips) 
Seat 4: JFIAqU8lCZ0vWwEl4bdGsg ($35.05 in chips) 
Seat 5: +ZlnqPoP3Hg4BIUxDfKd/A ($47.80 in chips) 
Seat 6: UmcUp27+PbgBItv3ZNlAWQ ($25 in chips) 
UmcUp27+PbgBItv3ZNlAWQ: posts small blind $0.10
obJgSnVgWWWaAUtVILo77Q: posts big blind $0.25
*** HOLE CARDS ***
DR0nVIhVP77oEBlO9J8vlg: raises $0.50 to $0.75
JFIAqU8lCZ0vWwEl4bdGsg: folds 
+ZlnqPoP3Hg4BIUxDfKd/A: calls $0.75
UmcUp27+PbgBItv3ZNlAWQ: folds 
obJgSnVgWWWaAUtVILo77Q: folds 
*** FLOP *** [Qc 4h Th]
DR0nVIhVP77oEBlO9J8vlg: checks 
+ZlnqPoP3Hg4BIUxDfKd/A: checks 
*** TURN *** [Qc 4h Th] [Jd]
DR0nVIhVP77oEBlO9J8vlg: bets $1
+ZlnqPoP3Hg4BIUxDfKd/A: folds 
Uncalled bet ($1) returned to DR0nVIhVP77oEBlO9J8vlg
DR0nVIhVP77oEBlO9J8vlg collected $1.80 from pot
DR0nVIhVP77oEBlO9J8vlg: doesn't show hand 
*** SUMMARY ***
Total pot $1.85 | Rake $0.05 
Board [Qc 4h Th Jd]
Seat 2: obJgSnVgWWWaAUtVILo77Q (big blind) folded before Flop
Seat 3: DR0nVIhVP77oEBlO9J8vlg collected ($1.80)
Seat 4: JFIAqU8lCZ0vWwEl4bdGsg folded before Flop (didn't bet)
Seat 5: +ZlnqPoP3Hg4BIUxDfKd/A (button) folded on the Turn
Seat 6: UmcUp27+PbgBItv3ZNlAWQ (small blind) folded before Flop




PokerStars Game #59941759410:  Hold'em No Limit ($0.10/$0.25) - 2009/07/01 1:45:15 ET
Table 'JJzUs04lHpXg6nboT1/jeg' 6-max Seat #5 is the button
Seat 1: MqMK8OWPSY1V4stf1Hy5Jw ($38.95 in chips) 
Seat 2: jxfR29d+dK/7h7s3SvCk+g ($9 in chips) 
Seat 3: 4zXbHDe39qNX46dAo81b4w ($7.30 in chips) 
Seat 4: 7VfhiFY533nbUKvyEthASw ($29.50 in chips) 
Seat 5: QvTX2yGq3uKJiKPmns4TKQ ($18.60 in chips) 
Seat 6: wqphQtauX5Qn7WRJZS1flA ($29.05 in chips) 
wqphQtauX5Qn7WRJZS1flA: posts small blind $0.10
MqMK8OWPSY1V4stf1Hy5Jw: posts big blind $0.25
*** HOLE CARDS ***
jxfR29d+dK/7h7s3SvCk+g: raises $0.50 to $0.75
4zXbHDe39qNX46dAo81b4w: folds 
7VfhiFY533nbUKvyEthASw: folds 
QvTX2yGq3uKJiKPmns4TKQ: folds 
wqphQtauX5Qn7WRJZS1flA: folds 
MqMK8OWPSY1V4stf1Hy5Jw: folds 
Uncalled bet ($0.50) returned to jxfR29d+dK/7h7s3SvCk+g
jxfR29d+dK/7h7s3SvCk+g collected $0.60 from pot
*** SUMMARY ***
Total pot $0.60 | Rake $0 
Seat 1: MqMK8OWPSY1V4stf1Hy5Jw (big blind) folded before Flop
Seat 2: jxfR29d+dK/7h7s3SvCk+g collected ($0.60)
Seat 3: 4zXbHDe39qNX46dAo81b4w folded before Flop (didn't bet)
Seat 4: 7VfhiFY533nbUKvyEthASw folded before Flop (didn't bet)
Seat 5: QvTX2yGq3uKJiKPmns4TKQ (button) folded before Flop (didn't bet)
Seat 6: wqphQtauX5Qn7WRJZS1flA (small blind) folded before Flop




PokerStars Game #59941758908:  Hold'em No Limit ($0.10/$0.25) - 2009/07/01 1:45:15 ET
Table 'vFZR6Kf2Th5xBXT9brGW6A' 6-max Seat #6 is the button
Seat 1: Q3EMN7b0ie81AFWkDrhCjw ($16.65 in chips) 
Seat 2: QiL+lEgEWwy21jk/ltaRLg ($22.40 in chips) 
Seat 3: SH1WjKVUjPiyXySjWSdazw ($21.35 in chips) 
Seat 4: 79ID/ub1Pt/mDpCprVmOoA ($35.20 in chips) 
Seat 5: SS/yfeArhULzIcOPe8MdPg ($26.30 in chips) 
Seat 6: 4x9jCqgSw4272dnaIqnanw ($10.20 in chips) 
Q3EMN7b0ie81AFWkDrhCjw: posts small blind $0.10
QiL+lEgEWwy21jk/ltaRLg: posts big blind $0.25
*** HOLE CARDS ***
SH1WjKVUjPiyXySjWSdazw: calls $0.25
79ID/ub1Pt/mDpCprVmOoA: folds 
SS/yfeArhULzIcOPe8MdPg: folds 
4x9jCqgSw4272dnaIqnanw: calls $0.25
Q3EMN7b0ie81AFWkDrhCjw: calls $0.15
QiL+lEgEWwy21jk/ltaRLg: checks 
*** FLOP *** [Js Ac 3h]
Q3EMN7b0ie81AFWkDrhCjw: checks 
QiL+lEgEWwy21jk/ltaRLg: checks 
SH1WjKVUjPiyXySjWSdazw: checks 
4x9jCqgSw4272dnaIqnanw: bets $9.95 and is all-in
Q3EMN7b0ie81AFWkDrhCjw: folds 
QiL+lEgEWwy21jk/ltaRLg: folds 
SH1WjKVUjPiyXySjWSdazw: folds 
Uncalled bet ($9.95) returned to 4x9jCqgSw4272dnaIqnanw
4x9jCqgSw4272dnaIqnanw collected $0.95 from pot
*** SUMMARY ***
Total pot $1 | Rake $0.05 
Board [Js Ac 3h]
Seat 1: Q3EMN7b0ie81AFWkDrhCjw (small blind) folded on the Flop
Seat 2: QiL+lEgEWwy21jk/ltaRLg (big blind) folded on the Flop
Seat 3: SH1WjKVUjPiyXySjWSdazw folded on the Flop
Seat 4: 79ID/ub1Pt/mDpCprVmOoA folded before Flop (didn't bet)
Seat 5: SS/yfeArhULzIcOPe8MdPg folded before Flop (didn't bet)
Seat 6: 4x9jCqgSw4272dnaIqnanw (button) collected ($0.95)




PokerStars Game #59941759010:  Hold'em No Limit ($0.10/$0.25) - 2009/07/01 1:45:15 ET
Table 'biAgO3TKQBU8XcrVAoU5TA' 6-max Seat #1 is the button
Seat 1: jhDPlkir8wBYAddboBuF7Q ($16.55 in chips) 
Seat 2: GbCVUNssQ7mqsPWr7J4d3w ($7.40 in chips) 
Seat 3: mfrkWA3PTeYPkbO6hi98Aw ($32.40 in chips) 
Seat 4: Hsvkc0/G2VV78oVmWYXecw ($5 in chips) 
Seat 5: n6UPMnVR4v8LFP0rWP73Fg ($11.60 in chips) 
Seat 6: wMiE3yTbDJGOLOF9th7KPA ($6.70 in chips) 
GbCVUNssQ7mqsPWr7J4d3w: posts small blind $0.10
mfrkWA3PTeYPkbO6hi98Aw: posts big blind $0.25
*** HOLE CARDS ***
Hsvkc0/G2VV78oVmWYXecw: folds 
n6UPMnVR4v8LFP0rWP73Fg: calls $0.25
wMiE3yTbDJGOLOF9th7KPA: calls $0.25
jhDPlkir8wBYAddboBuF7Q: folds 
GbCVUNssQ7mqsPWr7J4d3w: calls $0.15
mfrkWA3PTeYPkbO6hi98Aw: checks 
*** FLOP *** [9c As Qd]
GbCVUNssQ7mqsPWr7J4d3w: checks 
mfrkWA3PTeYPkbO6hi98Aw: checks 
n6UPMnVR4v8LFP0rWP73Fg: checks 
wMiE3yTbDJGOLOF9th7KPA: checks 
*** TURN *** [9c As Qd] [Td]
GbCVUNssQ7mqsPWr7J4d3w: checks 
mfrkWA3PTeYPkbO6hi98Aw: checks 
n6UPMnVR4v8LFP0rWP73Fg: checks 
wMiE3yTbDJGOLOF9th7KPA: bets $0.25
GbCVUNssQ7mqsPWr7J4d3w: folds 
mfrkWA3PTeYPkbO6hi98Aw: calls $0.25
n6UPMnVR4v8LFP0rWP73Fg: calls $0.25
*** RIVER *** [9c As Qd Td] [7s]
mfrkWA3PTeYPkbO6hi98Aw: checks 
n6UPMnVR4v8LFP0rWP73Fg: checks 
wMiE3yTbDJGOLOF9th7KPA: checks 
*** SHOW DOWN ***
mfrkWA3PTeYPkbO6hi98Aw: shows [8c 8d] (a pair of Eights)
n6UPMnVR4v8LFP0rWP73Fg: mucks hand 
wMiE3yTbDJGOLOF9th7KPA: shows [Kc Ts] (a pair of Tens)
wMiE3yTbDJGOLOF9th7KPA collected $1.70 from pot
*** SUMMARY ***
Total pot $1.75 | Rake $0.05 
Board [9c As Qd Td 7s]
Seat 1: jhDPlkir8wBYAddboBuF7Q (button) folded before Flop (didn't bet)
Seat 2: GbCVUNssQ7mqsPWr7J4d3w (small blind) folded on the Turn
Seat 3: mfrkWA3PTeYPkbO6hi98Aw (big blind) showed [8c 8d] and lost with a pair of Eights
Seat 4: Hsvkc0/G2VV78oVmWYXecw folded before Flop (didn't bet)
Seat 5: n6UPMnVR4v8LFP0rWP73Fg mucked
Seat 6: wMiE3yTbDJGOLOF9th7KPA showed [Kc Ts] and won ($1.70) with a pair of Tens




PokerStars Game #59941759384:  Hold'em No Limit ($0.10/$0.25) - 2009/07/01 1:45:15 ET
Table 'fIMYcWwN4/aXFJvH5Z8Ymg' 6-max Seat #6 is the button
Seat 1: DihMHaz4WNETH1bPDe13kA ($25 in chips) 
Seat 2: Mhj3q7cxev+XjXZxEE6/Cw ($25 in chips) 
Seat 3: 9bpVv1/Qh9IYtXuCtl5VtQ ($25 in chips) 
Seat 4: 32YL2ZEp8NT4JB2RVM9euQ ($42.40 in chips) 
Seat 5: lquriepNQBhDV5P1SWHhnA ($25.70 in chips) 
Seat 6: jp34e617tIzV8tKIWmfAbA ($28.35 in chips) 
DihMHaz4WNETH1bPDe13kA: posts small blind $0.10
Mhj3q7cxev+XjXZxEE6/Cw: posts big blind $0.25
*** HOLE CARDS ***
9bpVv1/Qh9IYtXuCtl5VtQ: folds 
32YL2ZEp8NT4JB2RVM9euQ: folds 
lquriepNQBhDV5P1SWHhnA: folds 
jp34e617tIzV8tKIWmfAbA: raises $0.50 to $0.75
DihMHaz4WNETH1bPDe13kA: folds 
Mhj3q7cxev+XjXZxEE6/Cw: folds 
Uncalled bet ($0.50) returned to jp34e617tIzV8tKIWmfAbA
jp34e617tIzV8tKIWmfAbA collected $0.60 from pot
jp34e617tIzV8tKIWmfAbA: doesn't show hand 
*** SUMMARY ***
Total pot $0.60 | Rake $0 
Seat 1: DihMHaz4WNETH1bPDe13kA (small blind) folded before Flop
Seat 2: Mhj3q7cxev+XjXZxEE6/Cw (big blind) folded before Flop
Seat 3: 9bpVv1/Qh9IYtXuCtl5VtQ folded before Flop (didn't bet)
Seat 4: 32YL2ZEp8NT4JB2RVM9euQ folded before Flop (didn't bet)
Seat 5: lquriepNQBhDV5P1SWHhnA folded before Flop (didn't bet)
Seat 6: jp34e617tIzV8tKIWmfAbA (button) collected ($0.60)




PokerStars Game #59941758994:  Hold'em No Limit ($0.10/$0.25) - 2009/07/01 1:45:15 ET
Table 'tErGGDyESv/0llKumVeZuQ' 9-max Seat #2 is the button
Seat 1: 3PmVnC/15cl4oyI1TKIt4g ($5 in chips) 
Seat 2: pN3IHvAKm2fz+sTRARTcrg ($28.85 in chips) 
Seat 4: yqkowiRWZ6NvRN9UUkYIlA ($5 in chips) 
Seat 5: 6RQUxA3jk+ePxB/+Hc0IKw ($13.85 in chips) 
Seat 7: uhrboV251dcgYniYTdFIcA ($29.15 in chips) 
Seat 8: clJsV3v77RS07bDKY+705w ($5 in chips) 
Seat 9: d6n762oPkegG086ZJyV5MA ($16.65 in chips) 
qwr38jl5txoR36M7G5qi4A will be allowed to play after the button
yqkowiRWZ6NvRN9UUkYIlA: posts small blind $0.10
6RQUxA3jk+ePxB/+Hc0IKw: posts big blind $0.25
clJsV3v77RS07bDKY+705w: posts big blind $0.25
*** HOLE CARDS ***
uhrboV251dcgYniYTdFIcA: folds 
clJsV3v77RS07bDKY+705w: checks 
d6n762oPkegG086ZJyV5MA: calls $0.25
3PmVnC/15cl4oyI1TKIt4g: folds 
pN3IHvAKm2fz+sTRARTcrg: folds 
yqkowiRWZ6NvRN9UUkYIlA: folds 
6RQUxA3jk+ePxB/+Hc0IKw: checks 
*** FLOP *** [6h 3s 4s]
6RQUxA3jk+ePxB/+Hc0IKw: bets $0.75
clJsV3v77RS07bDKY+705w: folds 
d6n762oPkegG086ZJyV5MA: calls $0.75
*** TURN *** [6h 3s 4s] [3h]
6RQUxA3jk+ePxB/+Hc0IKw: checks 
d6n762oPkegG086ZJyV5MA: checks 
*** RIVER *** [6h 3s 4s 3h] [3c]
6RQUxA3jk+ePxB/+Hc0IKw: bets $0.75
d6n762oPkegG086ZJyV5MA: calls $0.75
*** SHOW DOWN ***
6RQUxA3jk+ePxB/+Hc0IKw: shows [Kh 8h] (three of a kind, Threes)
d6n762oPkegG086ZJyV5MA: shows [4c Ad] (a full house, Threes full of Fours)
d6n762oPkegG086ZJyV5MA collected $3.70 from pot
*** SUMMARY ***
Total pot $3.85 | Rake $0.15 
Board [6h 3s 4s 3h 3c]
Seat 1: 3PmVnC/15cl4oyI1TKIt4g folded before Flop (didn't bet)
Seat 2: pN3IHvAKm2fz+sTRARTcrg (button) folded before Flop (didn't bet)
Seat 4: yqkowiRWZ6NvRN9UUkYIlA (small blind) folded before Flop
Seat 5: 6RQUxA3jk+ePxB/+Hc0IKw (big blind) showed [Kh 8h] and lost with three of a kind, Threes
Seat 7: uhrboV251dcgYniYTdFIcA folded before Flop (didn't bet)
Seat 8: clJsV3v77RS07bDKY+705w folded on the Flop
Seat 9: d6n762oPkegG086ZJyV5MA showed [4c Ad] and won ($3.70) with a full house, Threes full of Fours




PokerStars Game #59941759078:  Hold'em No Limit ($0.10/$0.25) - 2009/07/01 1:45:15 ET
Table 'R5qKG21jwFDYRcOht9qwqQ' 9-max Seat #5 is the button
Seat 2: N6foVRyErHqcNmshkqextQ ($13.80 in chips) 
Seat 3: M2QO2DxB5Wawg2h8HSpnYA ($13 in chips) 
Seat 5: zUXhymECc2C9W9ZNw6qppA ($9.55 in chips) 
Seat 6: EP17SQz/iWcuYdNOGeBgkw ($14.75 in chips) 
Seat 7: zgi+EUykT/pZQpoUG6+oEg ($5 in chips) 
Seat 8: tYsOBqdU1+x+yFI7zHO7hQ ($35.05 in chips) 
Seat 9: MG90wfSJZnOejs/KD3vlQQ ($32.25 in chips) 
EP17SQz/iWcuYdNOGeBgkw: posts small blind $0.10
zgi+EUykT/pZQpoUG6+oEg: posts big blind $0.25
N5sUK8M0br9djLrW97V9pQ: sits out 
*** HOLE CARDS ***
tYsOBqdU1+x+yFI7zHO7hQ: folds 
MG90wfSJZnOejs/KD3vlQQ: folds 
N6foVRyErHqcNmshkqextQ: folds 
M2QO2DxB5Wawg2h8HSpnYA: folds 
zUXhymECc2C9W9ZNw6qppA: raises $0.25 to $0.50
EP17SQz/iWcuYdNOGeBgkw: calls $0.40
zgi+EUykT/pZQpoUG6+oEg: folds 
*** FLOP *** [3s 7h Tc]
EP17SQz/iWcuYdNOGeBgkw: bets $0.50
zUXhymECc2C9W9ZNw6qppA: calls $0.50
*** TURN *** [3s 7h Tc] [7d]
EP17SQz/iWcuYdNOGeBgkw: bets $1
zUXhymECc2C9W9ZNw6qppA: folds 
Uncalled bet ($1) returned to EP17SQz/iWcuYdNOGeBgkw
EP17SQz/iWcuYdNOGeBgkw collected $2.15 from pot
EP17SQz/iWcuYdNOGeBgkw: doesn't show hand 
*** SUMMARY ***
Total pot $2.25 | Rake $0.10 
Board [3s 7h Tc 7d]
Seat 2: N6foVRyErHqcNmshkqextQ folded before Flop (didn't bet)
Seat 3: M2QO2DxB5Wawg2h8HSpnYA folded before Flop (didn't bet)
Seat 5: zUXhymECc2C9W9ZNw6qppA (button) folded on the Turn
Seat 6: EP17SQz/iWcuYdNOGeBgkw (small blind) collected ($2.15)
Seat 7: zgi+EUykT/pZQpoUG6+oEg (big blind) folded before Flop
Seat 8: tYsOBqdU1+x+yFI7zHO7hQ folded before Flop (didn't bet)
Seat 9: MG90wfSJZnOejs/KD3vlQQ folded before Flop (didn't bet)




PokerStars Game #59941759438:  Hold'em No Limit ($0.10/$0.25) - 2009/07/01 1:45:15 ET
Table 'CM/C/FZf3VHIp50RjmBucQ' 9-max Seat #2 is the button
Seat 2: xUw035gj8xeH3frcgPyCVw ($5.95 in chips) 
Seat 3: HPEB+AtKw1+C/cxU0o1ciw ($50.80 in chips) 
Seat 4: FYIiLXWy4mKC5ZGa/fnS0g ($10.25 in chips) 
HPEB+AtKw1+C/cxU0o1ciw: posts small blind $0.10
FYIiLXWy4mKC5ZGa/fnS0g: posts big blind $0.25
*** HOLE CARDS ***
xUw035gj8xeH3frcgPyCVw: raises $0.75 to $1
HPEB+AtKw1+C/cxU0o1ciw: folds 
FYIiLXWy4mKC5ZGa/fnS0g: calls $0.75
*** FLOP *** [9d Qc 5h]
FYIiLXWy4mKC5ZGa/fnS0g: checks 
xUw035gj8xeH3frcgPyCVw: checks 
*** TURN *** [9d Qc 5h] [As]
FYIiLXWy4mKC5ZGa/fnS0g: checks 
xUw035gj8xeH3frcgPyCVw: checks 
*** RIVER *** [9d Qc 5h As] [2d]
FYIiLXWy4mKC5ZGa/fnS0g: bets $1
t3m1RlE+8m1yb0ojo8ikCw joins the table at seat #5 
xUw035gj8xeH3frcgPyCVw: raises $2 to $3
FqpibuVWLNsAN/Z7ROZLnA joins the table at seat #6 
FYIiLXWy4mKC5ZGa/fnS0g: raises $3 to $6
xUw035gj8xeH3frcgPyCVw: calls $1.95 and is all-in
Uncalled bet ($1.05) returned to FYIiLXWy4mKC5ZGa/fnS0g
*** SHOW DOWN ***
FYIiLXWy4mKC5ZGa/fnS0g: shows [5c 5d] (three of a kind, Fives)
xUw035gj8xeH3frcgPyCVw: shows [9h Qd] (two pair, Queens and Nines)
FYIiLXWy4mKC5ZGa/fnS0g collected $11.45 from pot
*** SUMMARY ***
Total pot $12 | Rake $0.55 
Board [9d Qc 5h As 2d]
Seat 2: xUw035gj8xeH3frcgPyCVw (button) showed [9h Qd] and lost with two pair, Queens and Nines
Seat 3: HPEB+AtKw1+C/cxU0o1ciw (small blind) folded before Flop
Seat 4: FYIiLXWy4mKC5ZGa/fnS0g (big blind) showed [5c 5d] and won ($11.45) with three of a kind, Fives




PokerStars Game #59941759782:  Hold'em No Limit ($0.10/$0.25) - 2009/07/01 1:45:16 ET
Table 'Loy/olZ5qoDOSvX4UTujGg' 6-max Seat #6 is the button
Seat 1: HipgaJhkN4ie/tTw4dK3Ug ($13.75 in chips) 
Seat 2: 4z7mPbMLNp4TezHXin63Vw ($16.40 in chips) 
Seat 3: 32YL2ZEp8NT4JB2RVM9euQ ($15.70 in chips) 
Seat 4: /gJNBeCkWL4o85/jvlZ4BA ($28.20 in chips) 
Seat 5: Ar4vsUIUfJ7gbYh1c1m59g ($15 in chips) 
Seat 6: qGHGf/553gQnDoklMRe3tg ($26.15 in chips) 
HipgaJhkN4ie/tTw4dK3Ug: posts small blind $0.10
4z7mPbMLNp4TezHXin63Vw: posts big blind $0.25
Ar4vsUIUfJ7gbYh1c1m59g: posts big blind $0.25
*** HOLE CARDS ***
32YL2ZEp8NT4JB2RVM9euQ: folds 
/gJNBeCkWL4o85/jvlZ4BA: raises $1 to $1.25
Ar4vsUIUfJ7gbYh1c1m59g: folds 
qGHGf/553gQnDoklMRe3tg: folds 
HipgaJhkN4ie/tTw4dK3Ug: calls $1.15
4z7mPbMLNp4TezHXin63Vw: folds 
*** FLOP *** [3d 8s 6s]
HipgaJhkN4ie/tTw4dK3Ug: bets $1
/gJNBeCkWL4o85/jvlZ4BA: raises $2 to $3
HipgaJhkN4ie/tTw4dK3Ug: folds 
Uncalled bet ($2) returned to /gJNBeCkWL4o85/jvlZ4BA
/gJNBeCkWL4o85/jvlZ4BA collected $4.80 from pot
*** SUMMARY ***
Total pot $5 | Rake $0.20 
Board [3d 8s 6s]
Seat 1: HipgaJhkN4ie/tTw4dK3Ug (small blind) folded on the Flop
Seat 2: 4z7mPbMLNp4TezHXin63Vw (big blind) folded before Flop
Seat 3: 32YL2ZEp8NT4JB2RVM9euQ folded before Flop (didn't bet)
Seat 4: /gJNBeCkWL4o85/jvlZ4BA collected ($4.80)
Seat 5: Ar4vsUIUfJ7gbYh1c1m59g folded before Flop
Seat 6: qGHGf/553gQnDoklMRe3tg (button) folded before Flop (didn't bet)




PokerStars Game #59941759534:  Hold'em No Limit ($0.10/$0.25) - 2009/07/01 1:45:16 ET
Table 'isKy4XK8wJM0x735/D4hWA' 6-max Seat #6 is the button
Seat 1: kwsRmpZ1ZaLooISs+zfyKg ($24.15 in chips) 
Seat 2: 6elpmfyt4Zw0yvd8lePSMQ ($39.25 in chips) 
Seat 3: jp34e617tIzV8tKIWmfAbA ($26.05 in chips) 
Seat 4: DFi/Lzkjsfv8QswS80JX9Q ($31.45 in chips) 
Seat 5: lquriepNQBhDV5P1SWHhnA ($25.25 in chips) 
Seat 6: GbCVUNssQ7mqsPWr7J4d3w ($4.30 in chips) 
kwsRmpZ1ZaLooISs+zfyKg: posts small blind $0.10
6elpmfyt4Zw0yvd8lePSMQ: posts big blind $0.25
*** HOLE CARDS ***
jp34e617tIzV8tKIWmfAbA: folds 
DFi/Lzkjsfv8QswS80JX9Q: folds 
lquriepNQBhDV5P1SWHhnA: raises $0.50 to $0.75
GbCVUNssQ7mqsPWr7J4d3w: folds 
kwsRmpZ1ZaLooISs+zfyKg: folds 
6elpmfyt4Zw0yvd8lePSMQ: folds 
Uncalled bet ($0.50) returned to lquriepNQBhDV5P1SWHhnA
lquriepNQBhDV5P1SWHhnA collected $0.60 from pot
lquriepNQBhDV5P1SWHhnA: doesn't show hand 
*** SUMMARY ***
Total pot $0.60 | Rake $0 
Seat 1: kwsRmpZ1ZaLooISs+zfyKg (small blind) folded before Flop
Seat 2: 6elpmfyt4Zw0yvd8lePSMQ (big blind) folded before Flop
Seat 3: jp34e617tIzV8tKIWmfAbA folded before Flop (didn't bet)
Seat 4: DFi/Lzkjsfv8QswS80JX9Q folded before Flop (didn't bet)
Seat 5: lquriepNQBhDV5P1SWHhnA collected ($0.60)
Seat 6: GbCVUNssQ7mqsPWr7J4d3w (button) folded before Flop (didn't bet)




PokerStars Game #59941759540:  Hold'em No Limit ($0.10/$0.25) - 2009/07/01 1:45:16 ET
Table 'm+FQg/QP0VP1ZA3V62WtOg' 9-max Seat #3 is the button
Seat 3: +KblIivb6tainScpwm14RQ ($6.50 in chips) 
Seat 5: wf5j8xvJtko6ZXyCbzzlVQ ($8.75 in chips) 
Seat 6: CT7Xj/V/O5rBlhtt+RZeFQ ($41.20 in chips) 
Seat 7: TPAF9YkMsjQFq978RNWZEQ ($18.20 in chips) 
Seat 9: zUXhymECc2C9W9ZNw6qppA ($10.20 in chips) 
dubÃ©705 will be allowed to play after the button
wf5j8xvJtko6ZXyCbzzlVQ: posts small blind $0.10
CT7Xj/V/O5rBlhtt+RZeFQ: posts big blind $0.25
E0iYnEVO2ho7dH3QcCjw7g: sits out 
qwr38jl5txoR36M7G5qi4A: sits out 
*** HOLE CARDS ***
TPAF9YkMsjQFq978RNWZEQ: folds 
Fmarsh leaves the table
zUXhymECc2C9W9ZNw6qppA: raises $0.75 to $1
+KblIivb6tainScpwm14RQ: folds 
yqkowiRWZ6NvRN9UUkYIlA joins the table at seat #2 
wf5j8xvJtko6ZXyCbzzlVQ: folds 
CT7Xj/V/O5rBlhtt+RZeFQ: calls $0.75
*** FLOP *** [3h 6h 5s]
CT7Xj/V/O5rBlhtt+RZeFQ: checks 
zUXhymECc2C9W9ZNw6qppA: checks 
*** TURN *** [3h 6h 5s] [Kc]
CT7Xj/V/O5rBlhtt+RZeFQ: bets $1.50
zUXhymECc2C9W9ZNw6qppA: calls $1.50
*** RIVER *** [3h 6h 5s Kc] [Qs]
CT7Xj/V/O5rBlhtt+RZeFQ: checks 
zUXhymECc2C9W9ZNw6qppA: bets $2
CT7Xj/V/O5rBlhtt+RZeFQ: folds 
Uncalled bet ($2) returned to zUXhymECc2C9W9ZNw6qppA
zUXhymECc2C9W9ZNw6qppA collected $4.85 from pot
*** SUMMARY ***
Total pot $5.10 | Rake $0.25 
Board [3h 6h 5s Kc Qs]
Seat 3: +KblIivb6tainScpwm14RQ (button) folded before Flop (didn't bet)
Seat 5: wf5j8xvJtko6ZXyCbzzlVQ (small blind) folded before Flop
Seat 6: CT7Xj/V/O5rBlhtt+RZeFQ (big blind) folded on the River
Seat 7: TPAF9YkMsjQFq978RNWZEQ folded before Flop (didn't bet)
Seat 9: zUXhymECc2C9W9ZNw6qppA collected ($4.85)




PokerStars Game #59941759686:  Hold'em No Limit ($0.10/$0.25) - 2009/07/01 1:45:16 ET
Table 'aT31tt16YvQM/Ue69HPLpA' 9-max Seat #8 is the button
Seat 1: fIgGw0jPUR7labvJPaPbeg ($11.45 in chips) 
Seat 2: PdIasPkzm2sqZnN41ZRXOg ($5 in chips) 
Seat 3: tYsOBqdU1+x+yFI7zHO7hQ ($25.15 in chips) 
Seat 4: wGigCmBR/9XWkPpvYos3aQ ($26.35 in chips) 
Seat 5: s2xLPOl/vhl/26apJ3vsOQ ($37.65 in chips) 
Seat 6: 7cv+9Zc9HIQHNvYsMfV3uA ($57.45 in chips) 
Seat 7: W8cIfrCR+zA8pCNyIuHu8g ($34.25 in chips) 
Seat 8: W6tExOcYX7qiy6Qdp+ZwFA ($4.65 in chips) 
Seat 9: TvIuLx9zUCE+9Li58iImOQ ($16.45 in chips) 
TvIuLx9zUCE+9Li58iImOQ: posts small blind $0.10
fIgGw0jPUR7labvJPaPbeg: posts big blind $0.25
*** HOLE CARDS ***
PdIasPkzm2sqZnN41ZRXOg: folds 
tYsOBqdU1+x+yFI7zHO7hQ: folds 
wGigCmBR/9XWkPpvYos3aQ: folds 
s2xLPOl/vhl/26apJ3vsOQ: folds 
7cv+9Zc9HIQHNvYsMfV3uA: raises $0.75 to $1
W8cIfrCR+zA8pCNyIuHu8g: folds 
W6tExOcYX7qiy6Qdp+ZwFA: folds 
TvIuLx9zUCE+9Li58iImOQ: calls $0.90
fIgGw0jPUR7labvJPaPbeg: folds 
*** FLOP *** [7c Qh 2s]
TvIuLx9zUCE+9Li58iImOQ: checks 
7cv+9Zc9HIQHNvYsMfV3uA: bets $1.50
TvIuLx9zUCE+9Li58iImOQ: calls $1.50
*** TURN *** [7c Qh 2s] [2c]
TvIuLx9zUCE+9Li58iImOQ: checks 
7cv+9Zc9HIQHNvYsMfV3uA: bets $3.75
TvIuLx9zUCE+9Li58iImOQ: folds 
Uncalled bet ($3.75) returned to 7cv+9Zc9HIQHNvYsMfV3uA
7cv+9Zc9HIQHNvYsMfV3uA collected $5 from pot
7cv+9Zc9HIQHNvYsMfV3uA: doesn't show hand 
*** SUMMARY ***
Total pot $5.25 | Rake $0.25 
Board [7c Qh 2s 2c]
Seat 1: fIgGw0jPUR7labvJPaPbeg (big blind) folded before Flop
Seat 2: PdIasPkzm2sqZnN41ZRXOg folded before Flop (didn't bet)
Seat 3: tYsOBqdU1+x+yFI7zHO7hQ folded before Flop (didn't bet)
Seat 4: wGigCmBR/9XWkPpvYos3aQ folded before Flop (didn't bet)
Seat 5: s2xLPOl/vhl/26apJ3vsOQ folded before Flop (didn't bet)
Seat 6: 7cv+9Zc9HIQHNvYsMfV3uA collected ($5)
Seat 7: W8cIfrCR+zA8pCNyIuHu8g folded before Flop (didn't bet)
Seat 8: W6tExOcYX7qiy6Qdp+ZwFA (button) folded before Flop (didn't bet)
Seat 9: TvIuLx9zUCE+9Li58iImOQ (small blind) folded on the Turn




PokerStars Game #59941760288:  Hold'em No Limit ($0.10/$0.25) - 2009/07/01 1:45:17 ET
Table '3eK1r4Q4BSYFvsKkuTLpIA' 9-max Seat #4 is the button
Seat 1: vSkQm2EelzwRGDDQQk0Fqw ($4.30 in chips) 
Seat 2: aNpwfA31EREwO+ar4XzBCw ($28.10 in chips) 
Seat 3: 56S3mA6Zs3pGR+0p0vUCtg ($35.85 in chips) 
Seat 4: +2kMBNpY4nF1qNCRd8SJLA ($25 in chips) 
Seat 5: 775TiRJajPtN/ucpTmHrXA ($19.65 in chips) 
Seat 6: +HvCCmsGSQeatf+GZ9zk8Q ($29.70 in chips) 
Seat 7: ljemhp25Zg+nlA9DLCIiUw ($25 in chips) 
Seat 8: /29aHLC+Q6KCDcNv2bPfAg ($12.30 in chips) 
Seat 9: +sbyWwIcFp9kP0bDtMegfQ ($60.40 in chips) 
775TiRJajPtN/ucpTmHrXA: posts small blind $0.10
+HvCCmsGSQeatf+GZ9zk8Q said, "jesus"
+HvCCmsGSQeatf+GZ9zk8Q said, "i need to stop bluffing"
+HvCCmsGSQeatf+GZ9zk8Q: posts big blind $0.25
*** HOLE CARDS ***
ljemhp25Zg+nlA9DLCIiUw: folds 
/29aHLC+Q6KCDcNv2bPfAg: raises $0.25 to $0.50
+sbyWwIcFp9kP0bDtMegfQ: folds 
vSkQm2EelzwRGDDQQk0Fqw: folds 
aNpwfA31EREwO+ar4XzBCw: folds 
56S3mA6Zs3pGR+0p0vUCtg: folds 
+2kMBNpY4nF1qNCRd8SJLA: folds 
775TiRJajPtN/ucpTmHrXA: folds 
+HvCCmsGSQeatf+GZ9zk8Q: folds 
Uncalled bet ($0.25) returned to /29aHLC+Q6KCDcNv2bPfAg
/29aHLC+Q6KCDcNv2bPfAg collected $0.60 from pot
*** SUMMARY ***
Total pot $0.60 | Rake $0 
Seat 1: vSkQm2EelzwRGDDQQk0Fqw folded before Flop (didn't bet)
Seat 2: aNpwfA31EREwO+ar4XzBCw folded before Flop (didn't bet)
Seat 3: 56S3mA6Zs3pGR+0p0vUCtg folded before Flop (didn't bet)
Seat 4: +2kMBNpY4nF1qNCRd8SJLA (button) folded before Flop (didn't bet)
Seat 5: 775TiRJajPtN/ucpTmHrXA (small blind) folded before Flop
Seat 6: +HvCCmsGSQeatf+GZ9zk8Q (big blind) folded before Flop
Seat 7: ljemhp25Zg+nlA9DLCIiUw folded before Flop (didn't bet)
Seat 8: /29aHLC+Q6KCDcNv2bPfAg collected ($0.60)
Seat 9: +sbyWwIcFp9kP0bDtMegfQ folded before Flop (didn't bet)




PokerStars Game #59941760002:  Hold'em No Limit ($0.10/$0.25) - 2009/07/01 1:45:17 ET
Table 'WEMI3Mtn7dGARDbgNrKibgQvLFJzpzymuOsaaRYi+8fgx Seat #1 is the button
Seat 1: cZ99hugmLBj9KhTlc8nCSw ($25 in chips) 
Seat 2: PdIasPkzm2sqZnN41ZRXOg ($4.75 in chips) 
Seat 3: Qduu7ikeizo6q6Ei9YvcJA ($25 in chips) 
Seat 4: tLcDklc2rBORNfixyRfVfw ($25.60 in chips) 
Seat 5: MG90wfSJZnOejs/KD3vlQQ ($36.75 in chips) 
Seat 6: vKdukiQ4ktU4yJ0Xx3MKnA ($9.75 in chips) 
Seat 7: rQhYIYXSyH/IivYM1dlV5A ($11.20 in chips) 
Seat 8: gehe91e0IyVT0QU/XBkEyg ($27.35 in chips) 
Seat 9: BWzInv8o0kN1pJybv/VjpQ ($43.75 in chips) 
PdIasPkzm2sqZnN41ZRXOg: posts small blind $0.10
Qduu7ikeizo6q6Ei9YvcJA: posts big blind $0.25
*** HOLE CARDS ***
tLcDklc2rBORNfixyRfVfw: folds 
MG90wfSJZnOejs/KD3vlQQ: folds 
vKdukiQ4ktU4yJ0Xx3MKnA: raises $1.25 to $1.50
rQhYIYXSyH/IivYM1dlV5A: folds 
gehe91e0IyVT0QU/XBkEyg: folds 
BWzInv8o0kN1pJybv/VjpQ: folds 
cZ99hugmLBj9KhTlc8nCSw: folds 
PdIasPkzm2sqZnN41ZRXOg: folds 
Qduu7ikeizo6q6Ei9YvcJA: folds 
Uncalled bet ($1.25) returned to vKdukiQ4ktU4yJ0Xx3MKnA
vKdukiQ4ktU4yJ0Xx3MKnA collected $0.60 from pot
vKdukiQ4ktU4yJ0Xx3MKnA: doesn't show hand 
*** SUMMARY ***
Total pot $0.60 | Rake $0 
Seat 1: cZ99hugmLBj9KhTlc8nCSw (button) folded before Flop (didn't bet)
Seat 2: PdIasPkzm2sqZnN41ZRXOg (small blind) folded before Flop
Seat 3: Qduu7ikeizo6q6Ei9YvcJA (big blind) folded before Flop
Seat 4: tLcDklc2rBORNfixyRfVfw folded before Flop (didn't bet)
Seat 5: MG90wfSJZnOejs/KD3vlQQ folded before Flop (didn't bet)
Seat 6: vKdukiQ4ktU4yJ0Xx3MKnA collected ($0.60)
Seat 7: rQhYIYXSyH/IivYM1dlV5A folded before Flop (didn't bet)
Seat 8: gehe91e0IyVT0QU/XBkEyg folded before Flop (didn't bet)
Seat 9: BWzInv8o0kN1pJybv/VjpQ folded before Flop (didn't bet)




PokerStars Game #59941759998:  Hold'em No Limit ($0.10/$0.25) - 2009/07/01 1:45:17 ET
Table 'P1IJQ2p3ACFySC35W1qwQw' 9-max Seat #4 is the button
Seat 1: bXpVeaSTPBFSPJmeXxO7nw ($4.90 in chips) 
Seat 2: vO3QVRovWemcGMkm7ijAIA ($5.35 in chips) 
Seat 3: PVxvfRTRvkgZf9WtquEkwQ ($25 in chips) 
Seat 4: c/9X4zftzphFxYtxp5kp9w ($27.55 in chips) 
Seat 5: ghNKXUBl/H+t83JF079ZBA ($56.55 in chips) 
Seat 6: ljemhp25Zg+nlA9DLCIiUw ($64.45 in chips) 
Seat 7: 7je+LC5Mfs6nL8YBVh4frQ ($5.45 in chips) 
Seat 8: tLcDklc2rBORNfixyRfVfw ($26.60 in chips) 
Seat 9: XXajyXkgbSGJKxQP3mal/Q ($14.90 in chips) 
ghNKXUBl/H+t83JF079ZBA: posts small blind $0.10
ljemhp25Zg+nlA9DLCIiUw: posts big blind $0.25
*** HOLE CARDS ***
7je+LC5Mfs6nL8YBVh4frQ: folds 
tLcDklc2rBORNfixyRfVfw: folds 
XXajyXkgbSGJKxQP3mal/Q: calls $0.25
bXpVeaSTPBFSPJmeXxO7nw: raises $4.65 to $4.90 and is all-in
vO3QVRovWemcGMkm7ijAIA: folds 
PVxvfRTRvkgZf9WtquEkwQ: folds 
c/9X4zftzphFxYtxp5kp9w: folds 
ghNKXUBl/H+t83JF079ZBA: folds 
ljemhp25Zg+nlA9DLCIiUw: folds 
XXajyXkgbSGJKxQP3mal/Q: folds 
Uncalled bet ($4.65) returned to bXpVeaSTPBFSPJmeXxO7nw
bXpVeaSTPBFSPJmeXxO7nw collected $0.85 from pot
bXpVeaSTPBFSPJmeXxO7nw: doesn't show hand 
*** SUMMARY ***
Total pot $0.85 | Rake $0 
Seat 1: bXpVeaSTPBFSPJmeXxO7nw collected ($0.85)
Seat 2: vO3QVRovWemcGMkm7ijAIA folded before Flop (didn't bet)
Seat 3: PVxvfRTRvkgZf9WtquEkwQ folded before Flop (didn't bet)
Seat 4: c/9X4zftzphFxYtxp5kp9w (button) folded before Flop (didn't bet)
Seat 5: ghNKXUBl/H+t83JF079ZBA (small blind) folded before Flop
Seat 6: ljemhp25Zg+nlA9DLCIiUw (big blind) folded before Flop
Seat 7: 7je+LC5Mfs6nL8YBVh4frQ folded before Flop (didn't bet)
Seat 8: tLcDklc2rBORNfixyRfVfw folded before Flop (didn't bet)
Seat 9: XXajyXkgbSGJKxQP3mal/Q folded before Flop




PokerStars Game #59941760456:  Hold'em No Limit ($0.10/$0.25) - 2009/07/01 1:45:17 ET
Table '9iHhO6FyZVM8XpSc23TIgg' 6-max Seat #1 is the button
Seat 1: NhUN/JpAprdJeamFBgJH1w ($37.30 in chips) 
Seat 2: bJFzs6QmEEnz4miMfSDtcg ($40.25 in chips) 
Seat 3: TSmua8tGK3sTbwi0ynrW9Q ($26.50 in chips) 
Seat 4: cfJccEfyn6IkquPN08hFsA ($14.90 in chips) 
Seat 6: iyZxqznXjv3vtvOJymkoLQ ($34.20 in chips) 
bJFzs6QmEEnz4miMfSDtcg: posts small blind $0.10
TSmua8tGK3sTbwi0ynrW9Q: posts big blind $0.25
*** HOLE CARDS ***
cfJccEfyn6IkquPN08hFsA: calls $0.25
iyZxqznXjv3vtvOJymkoLQ: folds 
NhUN/JpAprdJeamFBgJH1w: folds 
bJFzs6QmEEnz4miMfSDtcg: calls $0.15
TSmua8tGK3sTbwi0ynrW9Q: checks 
*** FLOP *** [Ad 8c 7c]
bJFzs6QmEEnz4miMfSDtcg: checks 
OMGl+YMGogf2JWIRfT2/Yg joins the table at seat #5 
TSmua8tGK3sTbwi0ynrW9Q: bets $0.75
cfJccEfyn6IkquPN08hFsA: calls $0.75
bJFzs6QmEEnz4miMfSDtcg: calls $0.75
*** TURN *** [Ad 8c 7c] [8d]
bJFzs6QmEEnz4miMfSDtcg: checks 
TSmua8tGK3sTbwi0ynrW9Q: checks 
cfJccEfyn6IkquPN08hFsA: checks 
*** RIVER *** [Ad 8c 7c 8d] [Js]
bJFzs6QmEEnz4miMfSDtcg: folds 
TSmua8tGK3sTbwi0ynrW9Q: checks 
cfJccEfyn6IkquPN08hFsA: bets $1.75
TSmua8tGK3sTbwi0ynrW9Q: calls $1.75
*** SHOW DOWN ***
cfJccEfyn6IkquPN08hFsA: shows [Ts 8s] (three of a kind, Eights)
TSmua8tGK3sTbwi0ynrW9Q: mucks hand 
cfJccEfyn6IkquPN08hFsA collected $6.20 from pot
*** SUMMARY ***
Total pot $6.50 | Rake $0.30 
Board [Ad 8c 7c 8d Js]
Seat 1: NhUN/JpAprdJeamFBgJH1w (button) folded before Flop (didn't bet)
Seat 2: bJFzs6QmEEnz4miMfSDtcg (small blind) folded on the River
Seat 3: TSmua8tGK3sTbwi0ynrW9Q (big blind) mucked
Seat 4: cfJccEfyn6IkquPN08hFsA showed [Ts 8s] and won ($6.20) with three of a kind, Eights
Seat 6: iyZxqznXjv3vtvOJymkoLQ folded before Flop (didn't bet)




PokerStars Game #59941760416:  Hold'em No Limit ($0.10/$0.25) - 2009/07/01 1:45:17 ET
Table 'DhkrdW2UOy2PfjSW28Kq8w' 6-max Seat #6 is the button
Seat 2: v+QfkGiuj9bgtuNoVnDO8w ($25 in chips) 
Seat 3: B3X187C0tXFUfQpCu8pe8A ($21.65 in chips) 
Seat 5: SxIIgwXYLkwd6m3wLyPTCw ($51 in chips) 
Seat 6: DihMHaz4WNETH1bPDe13kA ($26.55 in chips) 
Mhj3q7cxev+XjXZxEE6/Cw will be allowed to play after the button
v+QfkGiuj9bgtuNoVnDO8w: posts small blind $0.10
B3X187C0tXFUfQpCu8pe8A: posts big blind $0.25
*** HOLE CARDS ***
SxIIgwXYLkwd6m3wLyPTCw: folds 
DihMHaz4WNETH1bPDe13kA: raises $0.50 to $0.75
v+QfkGiuj9bgtuNoVnDO8w: folds 
B3X187C0tXFUfQpCu8pe8A: calls $0.50
*** FLOP *** [3d 4d 9h]
B3X187C0tXFUfQpCu8pe8A: checks 
DihMHaz4WNETH1bPDe13kA: checks 
*** TURN *** [3d 4d 9h] [8d]
B3X187C0tXFUfQpCu8pe8A: checks 
DihMHaz4WNETH1bPDe13kA: checks 
*** RIVER *** [3d 4d 9h 8d] [9d]
B3X187C0tXFUfQpCu8pe8A: checks 
DihMHaz4WNETH1bPDe13kA: checks 
*** SHOW DOWN ***
B3X187C0tXFUfQpCu8pe8A: shows [Tc 4c] (two pair, Nines and Fours)
DihMHaz4WNETH1bPDe13kA: shows [Js 8s] (two pair, Nines and Eights)
DihMHaz4WNETH1bPDe13kA collected $1.55 from pot
*** SUMMARY ***
Total pot $1.60 | Rake $0.05 
Board [3d 4d 9h 8d 9d]
Seat 2: v+QfkGiuj9bgtuNoVnDO8w (small blind) folded before Flop
Seat 3: B3X187C0tXFUfQpCu8pe8A (big blind) showed [Tc 4c] and lost with two pair, Nines and Fours
Seat 5: SxIIgwXYLkwd6m3wLyPTCw folded before Flop (didn't bet)
Seat 6: DihMHaz4WNETH1bPDe13kA (button) showed [Js 8s] and won ($1.55) with two pair, Nines and Eights




PokerStars Game #59941760244:  Hold'em No Limit ($0.10/$0.25) - 2009/07/01 1:45:17 ET
Table '+198VWQSWBhYQOcizzuBkw' 6-max Seat #4 is the button
Seat 1: 34ttqW62uIRrqINCCmLcsw ($14.90 in chips) 
Seat 2: iauW7L/+7qzAuHow7CD75Q ($10.70 in chips) 
Seat 3: vw7gefupgmOJJN8lUemdWg ($24.05 in chips) 
Seat 4: TgDsTeCdLQt8kWbL00ByRA ($14.75 in chips) 
Seat 5: LtASJ9OlkqGrrUKGQlpGAw ($25.45 in chips) 
Seat 6: leEQ84f6wJYu5SB/vj27wg ($2.90 in chips) 
LtASJ9OlkqGrrUKGQlpGAw: posts small blind $0.10
leEQ84f6wJYu5SB/vj27wg: posts big blind $0.25
*** HOLE CARDS ***
34ttqW62uIRrqINCCmLcsw: calls $0.25
iauW7L/+7qzAuHow7CD75Q: folds 
vw7gefupgmOJJN8lUemdWg: folds 
TgDsTeCdLQt8kWbL00ByRA: folds 
LtASJ9OlkqGrrUKGQlpGAw: folds 
leEQ84f6wJYu5SB/vj27wg: checks 
*** FLOP *** [Kd Jh 8s]
leEQ84f6wJYu5SB/vj27wg: checks 
34ttqW62uIRrqINCCmLcsw: checks 
*** TURN *** [Kd Jh 8s] [Kh]
leEQ84f6wJYu5SB/vj27wg: checks 
34ttqW62uIRrqINCCmLcsw: checks 
*** RIVER *** [Kd Jh 8s Kh] [4c]
vw7gefupgmOJJN8lUemdWg said, "8 9 knewit would not come never does for me"
leEQ84f6wJYu5SB/vj27wg: checks 
34ttqW62uIRrqINCCmLcsw: bets $0.50
leEQ84f6wJYu5SB/vj27wg: folds 
Uncalled bet ($0.50) returned to 34ttqW62uIRrqINCCmLcsw
34ttqW62uIRrqINCCmLcsw collected $0.60 from pot
34ttqW62uIRrqINCCmLcsw: doesn't show hand 
*** SUMMARY ***
Total pot $0.60 | Rake $0 
Board [Kd Jh 8s Kh 4c]
Seat 1: 34ttqW62uIRrqINCCmLcsw collected ($0.60)
Seat 2: iauW7L/+7qzAuHow7CD75Q folded before Flop (didn't bet)
Seat 3: vw7gefupgmOJJN8lUemdWg folded before Flop (didn't bet)
Seat 4: TgDsTeCdLQt8kWbL00ByRA (button) folded before Flop (didn't bet)
Seat 5: LtASJ9OlkqGrrUKGQlpGAw (small blind) folded before Flop
Seat 6: leEQ84f6wJYu5SB/vj27wg (big blind) folded on the River




PokerStars Game #59941760146:  Hold'em No Limit ($0.10/$0.25) - 2009/07/01 1:45:17 ET
Table '5VWnrlxdjwVfMWkVS2WE7A' 6-max Seat #1 is the button
Seat 1: 82p+w3EmUaFFHuwpSeGY1w ($14.50 in chips) 
Seat 2: LJI7A1YgDM7hgh7o56+ReQ ($25.75 in chips) 
Seat 3: SFmT9ZsVopnukjvAzrxTRg ($39.15 in chips) 
Seat 4: Pb/gJ3OxOZx57fFp0MDgkg ($35.35 in chips) 
Seat 5: SgMFmwYtNvq9Y+2ZxPSiWQ ($16.10 in chips) 
Seat 6: LtASJ9OlkqGrrUKGQlpGAw ($5.25 in chips) 
LJI7A1YgDM7hgh7o56+ReQ: posts small blind $0.10
SFmT9ZsVopnukjvAzrxTRg: posts big blind $0.25
*** HOLE CARDS ***
Pb/gJ3OxOZx57fFp0MDgkg: raises $0.40 to $0.65
SgMFmwYtNvq9Y+2ZxPSiWQ: folds 
LtASJ9OlkqGrrUKGQlpGAw: folds 
82p+w3EmUaFFHuwpSeGY1w: folds 
LJI7A1YgDM7hgh7o56+ReQ: folds 
SFmT9ZsVopnukjvAzrxTRg: folds 
Uncalled bet ($0.40) returned to Pb/gJ3OxOZx57fFp0MDgkg
Pb/gJ3OxOZx57fFp0MDgkg collected $0.60 from pot
*** SUMMARY ***
Total pot $0.60 | Rake $0 
Seat 1: 82p+w3EmUaFFHuwpSeGY1w (button) folded before Flop (didn't bet)
Seat 2: LJI7A1YgDM7hgh7o56+ReQ (small blind) folded before Flop
Seat 3: SFmT9ZsVopnukjvAzrxTRg (big blind) folded before Flop
Seat 4: Pb/gJ3OxOZx57fFp0MDgkg collected ($0.60)
Seat 5: SgMFmwYtNvq9Y+2ZxPSiWQ folded before Flop (didn't bet)
Seat 6: LtASJ9OlkqGrrUKGQlpGAw folded before Flop (didn't bet)




PokerStars Game #59941760346:  Hold'em No Limit ($0.10/$0.25) - 2009/07/01 1:45:17 ET
Table 'rjcb+nlE+0GuJ6lBhuCkkA' 6-max Seat #5 is the button
Seat 1: lBoEwOFgzcERLIRUkUoRTw ($13.60 in chips) 
Seat 2: lJphax9e7/+O/3YCKPJ0yQ ($6.10 in chips) 
Seat 3: 8ClCHtFXGNplITm+63KB+Q ($66.15 in chips) 
Seat 4: BV+K0Phf5VBHr7aZPKqbUQ ($36.40 in chips) 
Seat 5: GC/9yVD59DUCX7hUI7gcLw ($29 in chips) 
Seat 6: 32YL2ZEp8NT4JB2RVM9euQ ($16.15 in chips) 
32YL2ZEp8NT4JB2RVM9euQ: posts small blind $0.10
lBoEwOFgzcERLIRUkUoRTw: posts big blind $0.25
*** HOLE CARDS ***
lJphax9e7/+O/3YCKPJ0yQ: calls $0.25
8ClCHtFXGNplITm+63KB+Q: raises $0.75 to $1
BV+K0Phf5VBHr7aZPKqbUQ: folds 
GC/9yVD59DUCX7hUI7gcLw: folds 
32YL2ZEp8NT4JB2RVM9euQ: folds 
lBoEwOFgzcERLIRUkUoRTw: folds 
lJphax9e7/+O/3YCKPJ0yQ: calls $0.75
*** FLOP *** [5d Th Kh]
lJphax9e7/+O/3YCKPJ0yQ: bets $0.50
8ClCHtFXGNplITm+63KB+Q: folds 
Uncalled bet ($0.50) returned to lJphax9e7/+O/3YCKPJ0yQ
lJphax9e7/+O/3YCKPJ0yQ collected $2.25 from pot
*** SUMMARY ***
Total pot $2.35 | Rake $0.10 
Board [5d Th Kh]
Seat 1: lBoEwOFgzcERLIRUkUoRTw (big blind) folded before Flop
Seat 2: lJphax9e7/+O/3YCKPJ0yQ collected ($2.25)
Seat 3: 8ClCHtFXGNplITm+63KB+Q folded on the Flop
Seat 4: BV+K0Phf5VBHr7aZPKqbUQ folded before Flop (didn't bet)
Seat 5: GC/9yVD59DUCX7hUI7gcLw (button) folded before Flop (didn't bet)
Seat 6: 32YL2ZEp8NT4JB2RVM9euQ (small blind) folded before Flop




PokerStars Game #59941760470:  Hold'em No Limit ($0.10/$0.25) - 2009/07/01 1:45:17 ET
Table 'sgdCtiuCu2BDZhyDi6RzTA' 6-max Seat #4 is the button
Seat 1: 3zD3qLXT1bEffAoWGnc7wg ($35.75 in chips) 
Seat 2: XD1i5m5PvBDnRzJaG/vINw ($24.05 in chips) 
Seat 3: eL3+wCBjFGfQ5FMdIZihwA ($25.50 in chips) 
Seat 4: rVKEgilmMX+EkKzDVvhmxA ($8.35 in chips) 
Seat 5: 0tQitW75xfmVWKldYHjmOQ ($3.15 in chips) 
Seat 6: KODslGU8ikCYS0/29dUkhg ($33.20 in chips) 
0tQitW75xfmVWKldYHjmOQ: posts small blind $0.10
KODslGU8ikCYS0/29dUkhg: posts big blind $0.25
*** HOLE CARDS ***
3zD3qLXT1bEffAoWGnc7wg: folds 
XD1i5m5PvBDnRzJaG/vINw: folds 
eL3+wCBjFGfQ5FMdIZihwA: folds 
rVKEgilmMX+EkKzDVvhmxA: raises $0.25 to $0.50
0tQitW75xfmVWKldYHjmOQ: folds 
KODslGU8ikCYS0/29dUkhg: calls $0.25
*** FLOP *** [Qs Ad Jd]
KODslGU8ikCYS0/29dUkhg: checks 
rVKEgilmMX+EkKzDVvhmxA: bets $0.50
KODslGU8ikCYS0/29dUkhg: calls $0.50
*** TURN *** [Qs Ad Jd] [Qc]
KODslGU8ikCYS0/29dUkhg: bets $1
rVKEgilmMX+EkKzDVvhmxA: folds 
Uncalled bet ($1) returned to KODslGU8ikCYS0/29dUkhg
KODslGU8ikCYS0/29dUkhg collected $2 from pot
KODslGU8ikCYS0/29dUkhg: doesn't show hand 
*** SUMMARY ***
Total pot $2.10 | Rake $0.10 
Board [Qs Ad Jd Qc]
Seat 1: 3zD3qLXT1bEffAoWGnc7wg folded before Flop (didn't bet)
Seat 2: XD1i5m5PvBDnRzJaG/vINw folded before Flop (didn't bet)
Seat 3: eL3+wCBjFGfQ5FMdIZihwA folded before Flop (didn't bet)
Seat 4: rVKEgilmMX+EkKzDVvhmxA (button) folded on the Turn
Seat 5: 0tQitW75xfmVWKldYHjmOQ (small blind) folded before Flop
Seat 6: KODslGU8ikCYS0/29dUkhg (big blind) collected ($2)




PokerStars Game #59941760494:  Hold'em No Limit ($0.10/$0.25) - 2009/07/01 1:45:17 ET
Table 'YYMg5qzxK1m9eGRo4SbxtQ' 9-max Seat #1 is the button
Seat 1: 3PmVnC/15cl4oyI1TKIt4g ($5 in chips) 
Seat 2: f/H6PsHRl4W1JyNsEDvPtg ($12.90 in chips) 
Seat 3: eK8qa6EPcH2zhtbmWSvc9g ($25 in chips) 
Seat 4: ROxrieegd9WYtWcUKJAlbg ($14.50 in chips) 
Seat 8: xoBFd/5k+L/pFn9VW1VyWg ($14.20 in chips) 
Seat 9: +sbyWwIcFp9kP0bDtMegfQ ($31.60 in chips) 
f/H6PsHRl4W1JyNsEDvPtg: posts small blind $0.10
eK8qa6EPcH2zhtbmWSvc9g: posts big blind $0.25
eebse2009: sits out 
*** HOLE CARDS ***
ROxrieegd9WYtWcUKJAlbg: calls $0.25
xoBFd/5k+L/pFn9VW1VyWg: folds 
+sbyWwIcFp9kP0bDtMegfQ: folds 
3PmVnC/15cl4oyI1TKIt4g: folds 
f/H6PsHRl4W1JyNsEDvPtg: raises $0.50 to $0.75
eK8qa6EPcH2zhtbmWSvc9g: folds 
ROxrieegd9WYtWcUKJAlbg: calls $0.50
*** FLOP *** [Qh 9d Ks]
BKKiMP leaves the table
f/H6PsHRl4W1JyNsEDvPtg: bets $1
ROxrieegd9WYtWcUKJAlbg: folds 
Uncalled bet ($1) returned to f/H6PsHRl4W1JyNsEDvPtg
f/H6PsHRl4W1JyNsEDvPtg collected $1.70 from pot
4awUyiDYTgylQKXZ9faBVA joins the table at seat #5 
*** SUMMARY ***
Total pot $1.75 | Rake $0.05 
Board [Qh 9d Ks]
Seat 1: 3PmVnC/15cl4oyI1TKIt4g (button) folded before Flop (didn't bet)
Seat 2: f/H6PsHRl4W1JyNsEDvPtg (small blind) collected ($1.70)
Seat 3: eK8qa6EPcH2zhtbmWSvc9g (big blind) folded before Flop
Seat 4: ROxrieegd9WYtWcUKJAlbg folded on the Flop
Seat 8: xoBFd/5k+L/pFn9VW1VyWg folded before Flop (didn't bet)
Seat 9: +sbyWwIcFp9kP0bDtMegfQ folded before Flop (didn't bet)




PokerStars Game #59941760912:  Hold'em No Limit ($0.10/$0.25) - 2009/07/01 1:45:18 ET
Table 'VuY5ej47Cy8nOI3Wogmhzw' 6-max Seat #5 is the button
Seat 1: EeUZtMU058v2ObUACOF4Og ($37.85 in chips) 
Seat 2: AM6Yl+3esmhhMBlSnQhWbg ($17.85 in chips) 
Seat 3: v+QfkGiuj9bgtuNoVnDO8w ($28.05 in chips) 
Seat 4: QqiZLFrN8iOUT/GHw7ztOA ($25 in chips) 
Seat 5: iK/41//HmnLiIn0CVNNfyA ($14.10 in chips) 
Seat 6: +KblIivb6tainScpwm14RQ ($6.85 in chips) 
+KblIivb6tainScpwm14RQ: posts small blind $0.10
EeUZtMU058v2ObUACOF4Og: posts big blind $0.25
*** HOLE CARDS ***
AM6Yl+3esmhhMBlSnQhWbg: folds 
v+QfkGiuj9bgtuNoVnDO8w: raises $0.75 to $1
QqiZLFrN8iOUT/GHw7ztOA: folds 
iK/41//HmnLiIn0CVNNfyA: folds 
+KblIivb6tainScpwm14RQ: folds 
EeUZtMU058v2ObUACOF4Og: folds 
Uncalled bet ($0.75) returned to v+QfkGiuj9bgtuNoVnDO8w
v+QfkGiuj9bgtuNoVnDO8w collected $0.60 from pot
v+QfkGiuj9bgtuNoVnDO8w: doesn't show hand 
*** SUMMARY ***
Total pot $0.60 | Rake $0 
Seat 1: EeUZtMU058v2ObUACOF4Og (big blind) folded before Flop
Seat 2: AM6Yl+3esmhhMBlSnQhWbg folded before Flop (didn't bet)
Seat 3: v+QfkGiuj9bgtuNoVnDO8w collected ($0.60)
Seat 4: QqiZLFrN8iOUT/GHw7ztOA folded before Flop (didn't bet)
Seat 5: iK/41//HmnLiIn0CVNNfyA (button) folded before Flop (didn't bet)
Seat 6: +KblIivb6tainScpwm14RQ (small blind) folded before Flop




PokerStars Game #59941760832:  Hold'em No Limit ($0.10/$0.25) - 2009/07/01 1:45:18 ET
Table 'l8hUTjBTXBorNUR/tyvSLw' 9-max Seat #5 is the button
Seat 1: cZ99hugmLBj9KhTlc8nCSw ($27.85 in chips) 
Seat 2: B6xHiX1SJkS0CUNCKDVwuQ ($20.90 in chips) 
Seat 3: ShCS62CJp4MKfKLKvGKQbA ($9.10 in chips) 
Seat 4: vPtFvcPtn/Afz0sucO1cmQ ($36.95 in chips) 
Seat 5: yyG4svzOpC1A+sUP/scg6w ($6.75 in chips) 
Seat 6: EVqHvqty1ZsuvDFiSXlSqQ ($24.30 in chips) 
Seat 7: F7pnn6czNpHvRM55XcA2EA ($33.40 in chips) 
Seat 8: Mh2r9hTeTEDnh19sRZtW3g ($5 in chips) 
EVqHvqty1ZsuvDFiSXlSqQ: posts small blind $0.10
F7pnn6czNpHvRM55XcA2EA: posts big blind $0.25
*** HOLE CARDS ***
Mh2r9hTeTEDnh19sRZtW3g: folds 
cZ99hugmLBj9KhTlc8nCSw: folds 
B6xHiX1SJkS0CUNCKDVwuQ: calls $0.25
ShCS62CJp4MKfKLKvGKQbA: folds 
vPtFvcPtn/Afz0sucO1cmQ: folds 
yyG4svzOpC1A+sUP/scg6w: calls $0.25
EVqHvqty1ZsuvDFiSXlSqQ: folds 
F7pnn6czNpHvRM55XcA2EA: checks 
*** FLOP *** [5d 4d 3h]
F7pnn6czNpHvRM55XcA2EA: checks 
zDrucyjVn5aeekNEc3cJrA has returned
B6xHiX1SJkS0CUNCKDVwuQ: bets $0.75
yyG4svzOpC1A+sUP/scg6w: folds 
F7pnn6czNpHvRM55XcA2EA: folds 
Uncalled bet ($0.75) returned to B6xHiX1SJkS0CUNCKDVwuQ
B6xHiX1SJkS0CUNCKDVwuQ collected $0.85 from pot
B6xHiX1SJkS0CUNCKDVwuQ: doesn't show hand 
*** SUMMARY ***
Total pot $0.85 | Rake $0 
Board [5d 4d 3h]
Seat 1: cZ99hugmLBj9KhTlc8nCSw folded before Flop (didn't bet)
Seat 2: B6xHiX1SJkS0CUNCKDVwuQ collected ($0.85)
Seat 3: ShCS62CJp4MKfKLKvGKQbA folded before Flop (didn't bet)
Seat 4: vPtFvcPtn/Afz0sucO1cmQ folded before Flop (didn't bet)
Seat 5: yyG4svzOpC1A+sUP/scg6w (button) folded on the Flop
Seat 6: EVqHvqty1ZsuvDFiSXlSqQ (small blind) folded before Flop
Seat 7: F7pnn6czNpHvRM55XcA2EA (big blind) folded on the Flop
Seat 8: Mh2r9hTeTEDnh19sRZtW3g folded before Flop (didn't bet)




PokerStars Game #59941760700:  Hold'em No Limit ($0.10/$0.25) - 2009/07/01 1:45:18 ET
Table '63uh7ZsO7Tnt+E8b/2bu3A' 6-max Seat #3 is the button
Seat 1: 0av6tRNdi0Ui4f15L7gsVg ($30.55 in chips) 
Seat 2: SFmT9ZsVopnukjvAzrxTRg ($28.35 in chips) 
Seat 3: yVP7GLZBzx47OPi6jzUxMw ($8.10 in chips) 
Seat 5: GbCVUNssQ7mqsPWr7J4d3w ($4.15 in chips) 
Seat 6: qGHGf/553gQnDoklMRe3tg ($30.15 in chips) 
GbCVUNssQ7mqsPWr7J4d3w: posts small blind $0.10
qGHGf/553gQnDoklMRe3tg: posts big blind $0.25
*** HOLE CARDS ***
0av6tRNdi0Ui4f15L7gsVg: folds 
SFmT9ZsVopnukjvAzrxTRg: folds 
yVP7GLZBzx47OPi6jzUxMw: raises $0.50 to $0.75
GbCVUNssQ7mqsPWr7J4d3w: folds 
qGHGf/553gQnDoklMRe3tg: folds 
Uncalled bet ($0.50) returned to yVP7GLZBzx47OPi6jzUxMw
yVP7GLZBzx47OPi6jzUxMw collected $0.60 from pot
yVP7GLZBzx47OPi6jzUxMw: doesn't show hand 
*** SUMMARY ***
Total pot $0.60 | Rake $0 
Seat 1: 0av6tRNdi0Ui4f15L7gsVg folded before Flop (didn't bet)
Seat 2: SFmT9ZsVopnukjvAzrxTRg folded before Flop (didn't bet)
Seat 3: yVP7GLZBzx47OPi6jzUxMw (button) collected ($0.60)
Seat 5: GbCVUNssQ7mqsPWr7J4d3w (small blind) folded before Flop
Seat 6: qGHGf/553gQnDoklMRe3tg (big blind) folded before Flop




PokerStars Game #59941760616:  Hold'em No Limit ($0.10/$0.25) - 2009/07/01 1:45:18 ET
Table 'zKwHJD0cmKNUure9qQTfFg' 6-max Seat #3 is the button
Seat 1: Hzrn9DZJegEZICufTNYkrg ($18.70 in chips) 
Seat 2: xrf8tAXKQHG99HixCot1Iw ($25 in chips) 
Seat 3: m9aw7LBAB5YX2ZqMtMkhqA ($15.85 in chips) 
Seat 4: v+QfkGiuj9bgtuNoVnDO8w ($25.55 in chips) 
Seat 6: edio/rLJ06xeZOfLhoL3UA ($7.65 in chips) 
v+QfkGiuj9bgtuNoVnDO8w: posts small blind $0.10
edio/rLJ06xeZOfLhoL3UA: posts big blind $0.25
*** HOLE CARDS ***
Hzrn9DZJegEZICufTNYkrg: folds 
E4AqQ1egsnu0oH2RqsbCmQ has returned
xrf8tAXKQHG99HixCot1Iw: folds 
m9aw7LBAB5YX2ZqMtMkhqA: folds 
v+QfkGiuj9bgtuNoVnDO8w: folds 
Uncalled bet ($0.15) returned to edio/rLJ06xeZOfLhoL3UA
edio/rLJ06xeZOfLhoL3UA collected $0.20 from pot
edio/rLJ06xeZOfLhoL3UA: doesn't show hand 
*** SUMMARY ***
Total pot $0.20 | Rake $0 
Seat 1: Hzrn9DZJegEZICufTNYkrg folded before Flop (didn't bet)
Seat 2: xrf8tAXKQHG99HixCot1Iw folded before Flop (didn't bet)
Seat 3: m9aw7LBAB5YX2ZqMtMkhqA (button) folded before Flop (didn't bet)
Seat 4: v+QfkGiuj9bgtuNoVnDO8w (small blind) folded before Flop
Seat 6: edio/rLJ06xeZOfLhoL3UA (big blind) collected ($0.20)




PokerStars Game #59941761010:  Hold'em No Limit ($0.10/$0.25) - 2009/07/01 1:45:18 ET
Table '+giHa6FUL6U5/AZnCJEGvQ' 9-max Seat #4 is the button
Seat 4: 10f7J+bM02ZfDHx0PgkNSg ($13.85 in chips) 
Seat 6: GTMnTen6sQSoCpS9sggLbg ($25.80 in chips) 
10f7J+bM02ZfDHx0PgkNSg: posts small blind $0.10
GTMnTen6sQSoCpS9sggLbg: posts big blind $0.25
*** HOLE CARDS ***
10f7J+bM02ZfDHx0PgkNSg: calls $0.15
GTMnTen6sQSoCpS9sggLbg: checks 
*** FLOP *** [Kh Qh 9c]
GTMnTen6sQSoCpS9sggLbg: checks 
10f7J+bM02ZfDHx0PgkNSg: checks 
*** TURN *** [Kh Qh 9c] [4h]
GTMnTen6sQSoCpS9sggLbg: checks 
10f7J+bM02ZfDHx0PgkNSg: checks 
*** RIVER *** [Kh Qh 9c 4h] [6d]
GTMnTen6sQSoCpS9sggLbg: checks 
10f7J+bM02ZfDHx0PgkNSg: bets $0.25
GTMnTen6sQSoCpS9sggLbg: calls $0.25
*** SHOW DOWN ***
10f7J+bM02ZfDHx0PgkNSg: shows [Td 9s] (a pair of Nines)
GTMnTen6sQSoCpS9sggLbg: mucks hand 
10f7J+bM02ZfDHx0PgkNSg collected $0.95 from pot
*** SUMMARY ***
Total pot $1 | Rake $0.05 
Board [Kh Qh 9c 4h 6d]
Seat 4: 10f7J+bM02ZfDHx0PgkNSg (button) (small blind) showed [Td 9s] and won ($0.95) with a pair of Nines
Seat 6: GTMnTen6sQSoCpS9sggLbg (big blind) mucked




PokerStars Game #59941760698:  Hold'em No Limit ($0.10/$0.25) - 2009/07/01 1:45:18 ET
Table 'nFlmVztKq1HJEWfxmdl15w' 9-max Seat #3 is the button
Seat 1: cZ99hugmLBj9KhTlc8nCSw ($25 in chips) 
Seat 2: Th3FldXKQW6hWVVPahaoOQ ($38.40 in chips) 
Seat 3: DdPXdieucQ+n99u1n3A+rQ ($5.70 in chips) 
Seat 4: +5dSUwD+/k2ktlnutSMivw ($14.25 in chips) 
Seat 5: Tx6zQdk5Ozt9ObEBlU7jeg ($32.55 in chips) 
Seat 6: 4awUyiDYTgylQKXZ9faBVA ($36 in chips) 
Seat 7: dfNim92Z6XK1/h5SFW5vDg ($35.30 in chips) 
Seat 8: +2kMBNpY4nF1qNCRd8SJLA ($33.90 in chips) 
Seat 9: DnDcAdn9P0zGovMERigpFA ($25 in chips) 
+5dSUwD+/k2ktlnutSMivw: posts small blind $0.10
Tx6zQdk5Ozt9ObEBlU7jeg: posts big blind $0.25
*** HOLE CARDS ***
4awUyiDYTgylQKXZ9faBVA: folds 
dfNim92Z6XK1/h5SFW5vDg: folds 
+2kMBNpY4nF1qNCRd8SJLA: calls $0.25
DnDcAdn9P0zGovMERigpFA: folds 
cZ99hugmLBj9KhTlc8nCSw: folds 
Th3FldXKQW6hWVVPahaoOQ: folds 
DdPXdieucQ+n99u1n3A+rQ: folds 
+5dSUwD+/k2ktlnutSMivw: calls $0.15
Tx6zQdk5Ozt9ObEBlU7jeg: checks 
*** FLOP *** [8h 3c 3d]
+5dSUwD+/k2ktlnutSMivw: checks 
Tx6zQdk5Ozt9ObEBlU7jeg: checks 
+2kMBNpY4nF1qNCRd8SJLA: checks 
*** TURN *** [8h 3c 3d] [4d]
+5dSUwD+/k2ktlnutSMivw: bets $1
Tx6zQdk5Ozt9ObEBlU7jeg: raises $1 to $2
+2kMBNpY4nF1qNCRd8SJLA: folds 
+5dSUwD+/k2ktlnutSMivw: calls $1
*** RIVER *** [8h 3c 3d 4d] [6d]
+5dSUwD+/k2ktlnutSMivw: checks 
Tx6zQdk5Ozt9ObEBlU7jeg: checks 
*** SHOW DOWN ***
+5dSUwD+/k2ktlnutSMivw: shows [4c Td] (two pair, Fours and Threes)
Tx6zQdk5Ozt9ObEBlU7jeg: shows [7d 3h] (three of a kind, Threes)
Tx6zQdk5Ozt9ObEBlU7jeg collected $4.55 from pot
*** SUMMARY ***
Total pot $4.75 | Rake $0.20 
Board [8h 3c 3d 4d 6d]
Seat 1: cZ99hugmLBj9KhTlc8nCSw folded before Flop (didn't bet)
Seat 2: Th3FldXKQW6hWVVPahaoOQ folded before Flop (didn't bet)
Seat 3: DdPXdieucQ+n99u1n3A+rQ (button) folded before Flop (didn't bet)
Seat 4: +5dSUwD+/k2ktlnutSMivw (small blind) showed [4c Td] and lost with two pair, Fours and Threes
Seat 5: Tx6zQdk5Ozt9ObEBlU7jeg (big blind) showed [7d 3h] and won ($4.55) with three of a kind, Threes
Seat 6: 4awUyiDYTgylQKXZ9faBVA folded before Flop (didn't bet)
Seat 7: dfNim92Z6XK1/h5SFW5vDg folded before Flop (didn't bet)
Seat 8: +2kMBNpY4nF1qNCRd8SJLA folded on the Turn
Seat 9: DnDcAdn9P0zGovMERigpFA folded before Flop (didn't bet)




PokerStars Game #59941761154:  Hold'em No Limit ($0.10/$0.25) - 2009/07/01 1:45:19 ET
Table 'gnrUwXkIPE0C8xl6cB4Hyw' 9-max Seat #1 is the button
Seat 1: EQXHDnIzAsORnIXRNtXRlA ($22.25 in chips) 
Seat 2: 7je+LC5Mfs6nL8YBVh4frQ ($5.10 in chips) 
Seat 3: PdIasPkzm2sqZnN41ZRXOg ($5 in chips) 
Seat 4: wGigCmBR/9XWkPpvYos3aQ ($25.35 in chips) 
Seat 5: gehe91e0IyVT0QU/XBkEyg ($26.90 in chips) 
Seat 6: dtZ84flFEi4Q+SGrHMJRDQ ($25.80 in chips) 
Seat 7: OXPkK84/qv92EMwXPiG5rQ ($9.95 in chips) 
Seat 8: 4awUyiDYTgylQKXZ9faBVA ($60.65 in chips) 
Seat 9: F7pnn6czNpHvRM55XcA2EA ($25.50 in chips) 
7je+LC5Mfs6nL8YBVh4frQ: posts small blind $0.10
PdIasPkzm2sqZnN41ZRXOg: posts big blind $0.25
*** HOLE CARDS ***
wGigCmBR/9XWkPpvYos3aQ: folds 
gehe91e0IyVT0QU/XBkEyg: folds 
dtZ84flFEi4Q+SGrHMJRDQ: folds 
OXPkK84/qv92EMwXPiG5rQ: folds 
4awUyiDYTgylQKXZ9faBVA: folds 
F7pnn6czNpHvRM55XcA2EA: folds 
EQXHDnIzAsORnIXRNtXRlA: folds 
7je+LC5Mfs6nL8YBVh4frQ: folds 
Uncalled bet ($0.15) returned to PdIasPkzm2sqZnN41ZRXOg
PdIasPkzm2sqZnN41ZRXOg collected $0.20 from pot
PdIasPkzm2sqZnN41ZRXOg: doesn't show hand 
*** SUMMARY ***
Total pot $0.20 | Rake $0 
Seat 1: EQXHDnIzAsORnIXRNtXRlA (button) folded before Flop (didn't bet)
Seat 2: 7je+LC5Mfs6nL8YBVh4frQ (small blind) folded before Flop
Seat 3: PdIasPkzm2sqZnN41ZRXOg (big blind) collected ($0.20)
Seat 4: wGigCmBR/9XWkPpvYos3aQ folded before Flop (didn't bet)
Seat 5: gehe91e0IyVT0QU/XBkEyg folded before Flop (didn't bet)
Seat 6: dtZ84flFEi4Q+SGrHMJRDQ folded before Flop (didn't bet)
Seat 7: OXPkK84/qv92EMwXPiG5rQ folded before Flop (didn't bet)
Seat 8: 4awUyiDYTgylQKXZ9faBVA folded before Flop (didn't bet)
Seat 9: F7pnn6czNpHvRM55XcA2EA folded before Flop (didn't bet)




PokerStars Game #59941761472:  Hold'em No Limit ($0.10/$0.25) - 2009/07/01 1:45:19 ET
Table 'wRXcD9iXgBbdvKhWmfnBnw' 6-max Seat #3 is the button
Seat 2: vUr8qM1UsCElsCI9B/McdQ ($26.35 in chips) 
Seat 3: l4ToKwb3EVcEuva7hPqMCQ ($9.95 in chips) 
Seat 4: mnuJq+Q1IXKm/pCy+OzxmQ ($19.75 in chips) 
Seat 5: EE16Ua5b1HSsYej5zeXOlA ($43.75 in chips) 
Seat 6: JFIAqU8lCZ0vWwEl4bdGsg ($25 in chips) 
mnuJq+Q1IXKm/pCy+OzxmQ: posts small blind $0.10
EE16Ua5b1HSsYej5zeXOlA: posts big blind $0.25
Mhj3q7cxev+XjXZxEE6/Cw: sits out 
*** HOLE CARDS ***
JFIAqU8lCZ0vWwEl4bdGsg: folds 
vUr8qM1UsCElsCI9B/McdQ: calls $0.25
l4ToKwb3EVcEuva7hPqMCQ: folds 
mnuJq+Q1IXKm/pCy+OzxmQ: calls $0.15
EE16Ua5b1HSsYej5zeXOlA: checks 
*** FLOP *** [Kc 6s 3c]
mnuJq+Q1IXKm/pCy+OzxmQ: checks 
EE16Ua5b1HSsYej5zeXOlA: checks 
vUr8qM1UsCElsCI9B/McdQ: bets $0.25
mnuJq+Q1IXKm/pCy+OzxmQ: calls $0.25
EE16Ua5b1HSsYej5zeXOlA: calls $0.25
*** TURN *** [Kc 6s 3c] [7h]
mnuJq+Q1IXKm/pCy+OzxmQ: checks 
EE16Ua5b1HSsYej5zeXOlA: checks 
vUr8qM1UsCElsCI9B/McdQ: bets $1
mnuJq+Q1IXKm/pCy+OzxmQ: folds 
EE16Ua5b1HSsYej5zeXOlA: calls $1
*** RIVER *** [Kc 6s 3c 7h] [Qc]
EE16Ua5b1HSsYej5zeXOlA: bets $1.75
vUr8qM1UsCElsCI9B/McdQ: calls $1.75
*** SHOW DOWN ***
EE16Ua5b1HSsYej5zeXOlA: shows [8c 5c] (a flush, King high)
vUr8qM1UsCElsCI9B/McdQ: mucks hand 
EE16Ua5b1HSsYej5zeXOlA collected $6.70 from pot
*** SUMMARY ***
Total pot $7 | Rake $0.30 
Board [Kc 6s 3c 7h Qc]
Seat 2: vUr8qM1UsCElsCI9B/McdQ mucked
Seat 3: l4ToKwb3EVcEuva7hPqMCQ (button) folded before Flop (didn't bet)
Seat 4: mnuJq+Q1IXKm/pCy+OzxmQ (small blind) folded on the Turn
Seat 5: EE16Ua5b1HSsYej5zeXOlA (big blind) showed [8c 5c] and won ($6.70) with a flush, King high
Seat 6: JFIAqU8lCZ0vWwEl4bdGsg folded before Flop (didn't bet)




PokerStars Game #59941761218:  Hold'em No Limit ($0.10/$0.25) - 2009/07/01 1:45:19 ET
Table 'T/iCKJXGphRN3xcdwfE/JQ' 6-max Seat #6 is the button
Seat 1: wAKC8C/zN0c8V5v13dm9mA ($25 in chips) 
Seat 2: EeUZtMU058v2ObUACOF4Og ($32.35 in chips) 
Seat 3: IWAjoCPXtc1XUaZdp+pCpA ($23.35 in chips) 
Seat 4: tSR4329m40dZsN7YOpI9Kw ($52.95 in chips) 
Seat 5: gaPMxLGp9SOj4Lq6t+/0Ig ($7.75 in chips) 
Seat 6: Ey4Kn6PlnYb2srYYBJHvzg ($13.55 in chips) 
wAKC8C/zN0c8V5v13dm9mA: posts small blind $0.10
EeUZtMU058v2ObUACOF4Og: posts big blind $0.25
*** HOLE CARDS ***
IWAjoCPXtc1XUaZdp+pCpA: folds 
tSR4329m40dZsN7YOpI9Kw: folds 
gaPMxLGp9SOj4Lq6t+/0Ig: raises $7.50 to $7.75 and is all-in
Ey4Kn6PlnYb2srYYBJHvzg: folds 
wAKC8C/zN0c8V5v13dm9mA: folds 
EeUZtMU058v2ObUACOF4Og: folds 
Uncalled bet ($7.50) returned to gaPMxLGp9SOj4Lq6t+/0Ig
gaPMxLGp9SOj4Lq6t+/0Ig collected $0.60 from pot
gaPMxLGp9SOj4Lq6t+/0Ig: doesn't show hand 
*** SUMMARY ***
Total pot $0.60 | Rake $0 
Seat 1: wAKC8C/zN0c8V5v13dm9mA (small blind) folded before Flop
Seat 2: EeUZtMU058v2ObUACOF4Og (big blind) folded before Flop
Seat 3: IWAjoCPXtc1XUaZdp+pCpA folded before Flop (didn't bet)
Seat 4: tSR4329m40dZsN7YOpI9Kw folded before Flop (didn't bet)
Seat 5: gaPMxLGp9SOj4Lq6t+/0Ig collected ($0.60)
Seat 6: Ey4Kn6PlnYb2srYYBJHvzg (button) folded before Flop (didn't bet)




PokerStars Game #59941761224:  Hold'em No Limit ($0.10/$0.25) - 2009/07/01 1:45:19 ET
Table 'FE/j6VqBY4j9Uq+VHURQCQ' 6-max Seat #2 is the button
Seat 1: ypmjhffk/YHGc51wgVXUTw ($42.60 in chips) 
Seat 2: 3zD3qLXT1bEffAoWGnc7wg ($37.10 in chips) 
Seat 3: lBoEwOFgzcERLIRUkUoRTw ($27.10 in chips) 
Seat 4: 7JyPCA0J2grhXQYxe1h3+A ($22.05 in chips) 
Seat 5: 4x9jCqgSw4272dnaIqnanw ($13.30 in chips) 
Seat 6: rpJ2ie+vculq8yrHlngRHQ ($14.30 in chips) 
lBoEwOFgzcERLIRUkUoRTw: posts small blind $0.10
7JyPCA0J2grhXQYxe1h3+A: posts big blind $0.25
*** HOLE CARDS ***
4x9jCqgSw4272dnaIqnanw: folds 
rpJ2ie+vculq8yrHlngRHQ: calls $0.25
ypmjhffk/YHGc51wgVXUTw: raises $0.75 to $1
3zD3qLXT1bEffAoWGnc7wg: folds 
lBoEwOFgzcERLIRUkUoRTw: folds 
7JyPCA0J2grhXQYxe1h3+A: raises $1.25 to $2.25
rpJ2ie+vculq8yrHlngRHQ: calls $2
ypmjhffk/YHGc51wgVXUTw: calls $1.25
*** FLOP *** [7s 5c 2c]
7JyPCA0J2grhXQYxe1h3+A: checks 
rpJ2ie+vculq8yrHlngRHQ: bets $4
ypmjhffk/YHGc51wgVXUTw: folds 
7JyPCA0J2grhXQYxe1h3+A: calls $4
*** TURN *** [7s 5c 2c] [4c]
7JyPCA0J2grhXQYxe1h3+A: checks 
rpJ2ie+vculq8yrHlngRHQ: bets $8.05 and is all-in
7JyPCA0J2grhXQYxe1h3+A: calls $8.05
*** RIVER *** [7s 5c 2c 4c] [Qs]
*** SHOW DOWN ***
7JyPCA0J2grhXQYxe1h3+A: shows [Ac Kh] (high card Ace)
rpJ2ie+vculq8yrHlngRHQ: shows [Jc 8c] (a flush, Jack high)
rpJ2ie+vculq8yrHlngRHQ collected $29.45 from pot
*** SUMMARY ***
Total pot $30.95 | Rake $1.50 
Board [7s 5c 2c 4c Qs]
Seat 1: ypmjhffk/YHGc51wgVXUTw folded on the Flop
Seat 2: 3zD3qLXT1bEffAoWGnc7wg (button) folded before Flop (didn't bet)
Seat 3: lBoEwOFgzcERLIRUkUoRTw (small blind) folded before Flop
Seat 4: 7JyPCA0J2grhXQYxe1h3+A (big blind) showed [Ac Kh] and lost with high card Ace
Seat 5: 4x9jCqgSw4272dnaIqnanw folded before Flop (didn't bet)
Seat 6: rpJ2ie+vculq8yrHlngRHQ showed [Jc 8c] and won ($29.45) with a flush, Jack high




PokerStars Game #59941761618:  Hold'em No Limit ($0.10/$0.25) - 2009/07/01 1:45:19 ET
Table '6wawJ+MkkvuC3coG6r+Yhg' 6-max Seat #2 is the button
Seat 1: JQZew0FjzS19kTjeNtrE+A ($28.25 in chips) 
Seat 2: LtASJ9OlkqGrrUKGQlpGAw ($34.15 in chips) 
Seat 3: 3zD3qLXT1bEffAoWGnc7wg ($61.35 in chips) 
Seat 4: yxmjNFGiKI3b+XQGJzJVIg ($28.30 in chips) 
Seat 5: FZrgDbxAanC1xwZxXHJKVA ($1.95 in chips) 
Seat 6: B3X187C0tXFUfQpCu8pe8A ($25.50 in chips) 
3zD3qLXT1bEffAoWGnc7wg: posts small blind $0.10
yxmjNFGiKI3b+XQGJzJVIg: posts big blind $0.25
*** HOLE CARDS ***
FZrgDbxAanC1xwZxXHJKVA: raises $0.25 to $0.50
B3X187C0tXFUfQpCu8pe8A: folds 
JQZew0FjzS19kTjeNtrE+A: folds 
LtASJ9OlkqGrrUKGQlpGAw: folds 
3zD3qLXT1bEffAoWGnc7wg: folds 
yxmjNFGiKI3b+XQGJzJVIg: folds 
Uncalled bet ($0.25) returned to FZrgDbxAanC1xwZxXHJKVA
FZrgDbxAanC1xwZxXHJKVA collected $0.60 from pot
*** SUMMARY ***
Total pot $0.60 | Rake $0 
Seat 1: JQZew0FjzS19kTjeNtrE+A folded before Flop (didn't bet)
Seat 2: LtASJ9OlkqGrrUKGQlpGAw (button) folded before Flop (didn't bet)
Seat 3: 3zD3qLXT1bEffAoWGnc7wg (small blind) folded before Flop
Seat 4: yxmjNFGiKI3b+XQGJzJVIg (big blind) folded before Flop
Seat 5: FZrgDbxAanC1xwZxXHJKVA collected ($0.60)
Seat 6: B3X187C0tXFUfQpCu8pe8A folded before Flop (didn't bet)




PokerStars Game #59941761584:  Hold'em No Limit ($0.10/$0.25) - 2009/07/01 1:45:19 ET
Table 'QegsWX65l3n/K0A8XB78yg' 6-max Seat #3 is the button
Seat 1: p6adJRMXMBLr+xtQzqazIQ ($17.65 in chips) 
Seat 2: GC/9yVD59DUCX7hUI7gcLw ($57.85 in chips) 
Seat 3: iIgNoBh+3/Ix1/fLsg+HuA ($5.65 in chips) 
Seat 4: epAUIB7h2FJXzUPRIvSkRA ($25 in chips) 
Seat 5: QqiZLFrN8iOUT/GHw7ztOA ($25 in chips) 
Seat 6: 5PWs02z65jSO5pr/M6wx/w ($2.50 in chips) 
epAUIB7h2FJXzUPRIvSkRA: posts small blind $0.10
QqiZLFrN8iOUT/GHw7ztOA: posts big blind $0.25
*** HOLE CARDS ***
5PWs02z65jSO5pr/M6wx/w: folds 
p6adJRMXMBLr+xtQzqazIQ: raises $0.75 to $1
GC/9yVD59DUCX7hUI7gcLw: folds 
iIgNoBh+3/Ix1/fLsg+HuA: folds 
epAUIB7h2FJXzUPRIvSkRA: folds 
QqiZLFrN8iOUT/GHw7ztOA: folds 
Uncalled bet ($0.75) returned to p6adJRMXMBLr+xtQzqazIQ
p6adJRMXMBLr+xtQzqazIQ collected $0.60 from pot
p6adJRMXMBLr+xtQzqazIQ: doesn't show hand 
*** SUMMARY ***
Total pot $0.60 | Rake $0 
Seat 1: p6adJRMXMBLr+xtQzqazIQ collected ($0.60)
Seat 2: GC/9yVD59DUCX7hUI7gcLw folded before Flop (didn't bet)
Seat 3: iIgNoBh+3/Ix1/fLsg+HuA (button) folded before Flop (didn't bet)
Seat 4: epAUIB7h2FJXzUPRIvSkRA (small blind) folded before Flop
Seat 5: QqiZLFrN8iOUT/GHw7ztOA (big blind) folded before Flop
Seat 6: 5PWs02z65jSO5pr/M6wx/w folded before Flop (didn't bet)




PokerStars Game #59941761142:  Hold'em No Limit ($0.10/$0.25) - 2009/07/01 1:45:19 ET
Table '2vH5RcmkT0F4XNS/EmmyMA' 6-max Seat #6 is the button
Seat 1: hOaWAImn5/MZDAWAPlYHCw ($6.25 in chips) 
Seat 2: W6Y6au0wf7gRAlqJYgOezw ($11.85 in chips) 
Seat 3: t8P79jKZYh/Wpx2V73pSqg ($30.85 in chips) 
Seat 4: FC6tJ9EOiutXO8hnpR4VgQ ($5.65 in chips) 
Seat 5: Hsvkc0/G2VV78oVmWYXecw ($5.15 in chips) 
Seat 6: if4dh6jhJXeN3/qd3qCp9g ($25.45 in chips) 
hOaWAImn5/MZDAWAPlYHCw: posts small blind $0.10
W6Y6au0wf7gRAlqJYgOezw: posts big blind $0.25
*** HOLE CARDS ***
t8P79jKZYh/Wpx2V73pSqg: raises $0.25 to $0.50
FC6tJ9EOiutXO8hnpR4VgQ: folds 
Hsvkc0/G2VV78oVmWYXecw: folds 
if4dh6jhJXeN3/qd3qCp9g: calls $0.50
hOaWAImn5/MZDAWAPlYHCw: calls $0.40
W6Y6au0wf7gRAlqJYgOezw: folds 
*** FLOP *** [3d Kc 6h]
hOaWAImn5/MZDAWAPlYHCw: bets $0.75
t8P79jKZYh/Wpx2V73pSqg: folds 
if4dh6jhJXeN3/qd3qCp9g: calls $0.75
*** TURN *** [3d Kc 6h] [Td]
hOaWAImn5/MZDAWAPlYHCw: checks 
if4dh6jhJXeN3/qd3qCp9g: checks 
*** RIVER *** [3d Kc 6h Td] [7d]
hOaWAImn5/MZDAWAPlYHCw: bets $1
if4dh6jhJXeN3/qd3qCp9g: folds 
Uncalled bet ($1) returned to hOaWAImn5/MZDAWAPlYHCw
hOaWAImn5/MZDAWAPlYHCw collected $3.10 from pot
hOaWAImn5/MZDAWAPlYHCw: doesn't show hand 
*** SUMMARY ***
Total pot $3.25 | Rake $0.15 
Board [3d Kc 6h Td 7d]
Seat 1: hOaWAImn5/MZDAWAPlYHCw (small blind) collected ($3.10)
Seat 2: W6Y6au0wf7gRAlqJYgOezw (big blind) folded before Flop
Seat 3: t8P79jKZYh/Wpx2V73pSqg folded on the Flop
Seat 4: FC6tJ9EOiutXO8hnpR4VgQ folded before Flop (didn't bet)
Seat 5: Hsvkc0/G2VV78oVmWYXecw folded before Flop (didn't bet)
Seat 6: if4dh6jhJXeN3/qd3qCp9g (button) folded on the River




PokerStars Game #59941762006:  Hold'em No Limit ($0.10/$0.25) - 2009/07/01 1:45:20 ET
Table '5NipxzzFB2DffzDpddyQoQ' 6-max Seat #4 is the button
Seat 1: W87HPwOk1KtWaYyshBe1gA ($21.25 in chips) 
Seat 2: iauW7L/+7qzAuHow7CD75Q ($6.95 in chips) 
Seat 3: QvTX2yGq3uKJiKPmns4TKQ ($5.90 in chips) 
Seat 4: NTamLAiMZ86c5yM04t96LA ($30.50 in chips) 
Seat 5: faP2NVl/cFTZ1nE4pXzg8Q ($33.60 in chips) 
Seat 6: 7JqTFMyeNSVWsmp/yW35Tw ($27.80 in chips) 
faP2NVl/cFTZ1nE4pXzg8Q: posts small blind $0.10
7JqTFMyeNSVWsmp/yW35Tw: posts big blind $0.25
*** HOLE CARDS ***
W87HPwOk1KtWaYyshBe1gA: folds 
iauW7L/+7qzAuHow7CD75Q: folds 
QvTX2yGq3uKJiKPmns4TKQ: folds 
NTamLAiMZ86c5yM04t96LA: calls $0.25
faP2NVl/cFTZ1nE4pXzg8Q: calls $0.15
NTamLAiMZ86c5yM04t96LA said, "IM UP ALOT TONIGHT"
7JqTFMyeNSVWsmp/yW35Tw: checks 
*** FLOP *** [Ac 3h Qs]
faP2NVl/cFTZ1nE4pXzg8Q: checks 
7JqTFMyeNSVWsmp/yW35Tw: checks 
NTamLAiMZ86c5yM04t96LA: bets $0.75
faP2NVl/cFTZ1nE4pXzg8Q: folds 
7JqTFMyeNSVWsmp/yW35Tw: folds 
Uncalled bet ($0.75) returned to NTamLAiMZ86c5yM04t96LA
NTamLAiMZ86c5yM04t96LA collected $0.75 from pot
NTamLAiMZ86c5yM04t96LA: shows [Ah 2s] (a pair of Aces)
*** SUMMARY ***
Total pot $0.75 | Rake $0 
Board [Ac 3h Qs]
Seat 1: W87HPwOk1KtWaYyshBe1gA folded before Flop (didn't bet)
Seat 2: iauW7L/+7qzAuHow7CD75Q folded before Flop (didn't bet)
Seat 3: QvTX2yGq3uKJiKPmns4TKQ folded before Flop (didn't bet)
Seat 4: NTamLAiMZ86c5yM04t96LA (button) collected ($0.75)
Seat 5: faP2NVl/cFTZ1nE4pXzg8Q (small blind) folded on the Flop
Seat 6: 7JqTFMyeNSVWsmp/yW35Tw (big blind) folded on the Flop




PokerStars Game #59941761888:  Hold'em No Limit ($0.10/$0.25) - 2009/07/01 1:45:20 ET
Table '+UzantPJ4smVdrh+4GTu1w' 6-max Seat #3 is the button
Seat 1: TSmua8tGK3sTbwi0ynrW9Q ($28.35 in chips) 
Seat 2: tcbEu7VzyHQ+0lh+skbQhQ ($41 in chips) 
Seat 3: SS/yfeArhULzIcOPe8MdPg ($33.55 in chips) 
Seat 4: UmcUp27+PbgBItv3ZNlAWQ ($26.90 in chips) 
Seat 5: cj4VBQya7HtVL2zCGd5jLQ ($56.05 in chips) 
Seat 6: fZQg9veL7Dd/Z04ZTjC+wQ ($25 in chips) 
UmcUp27+PbgBItv3ZNlAWQ: posts small blind $0.10
cj4VBQya7HtVL2zCGd5jLQ: posts big blind $0.25
*** HOLE CARDS ***
fZQg9veL7Dd/Z04ZTjC+wQ: folds 
TSmua8tGK3sTbwi0ynrW9Q: calls $0.25
tcbEu7VzyHQ+0lh+skbQhQ: folds 
SS/yfeArhULzIcOPe8MdPg: raises $1 to $1.25
UmcUp27+PbgBItv3ZNlAWQ: folds 
cj4VBQya7HtVL2zCGd5jLQ: folds 
TSmua8tGK3sTbwi0ynrW9Q: folds 
Uncalled bet ($1) returned to SS/yfeArhULzIcOPe8MdPg
SS/yfeArhULzIcOPe8MdPg collected $0.85 from pot
*** SUMMARY ***
Total pot $0.85 | Rake $0 
Seat 1: TSmua8tGK3sTbwi0ynrW9Q folded before Flop
Seat 2: tcbEu7VzyHQ+0lh+skbQhQ folded before Flop (didn't bet)
Seat 3: SS/yfeArhULzIcOPe8MdPg (button) collected ($0.85)
Seat 4: UmcUp27+PbgBItv3ZNlAWQ (small blind) folded before Flop
Seat 5: cj4VBQya7HtVL2zCGd5jLQ (big blind) folded before Flop
Seat 6: fZQg9veL7Dd/Z04ZTjC+wQ folded before Flop (didn't bet)




PokerStars Game #59941762078:  Hold'em No Limit ($0.10/$0.25) - 2009/07/01 1:45:20 ET
Table 'x7YStLKc8hpt/pTgSetPKA' 9-max Seat #7 is the button
Seat 1: tYsOBqdU1+x+yFI7zHO7hQ ($25 in chips) 
Seat 3: S7Ki0P+0AIGPuIfGJjW0gg ($12.10 in chips) 
Seat 4: ydoFOVgzvZv9ZhuWu9rXAw ($5.15 in chips) 
Seat 6: 9YN2IkT2JYYKFErZtZvCtA ($48.40 in chips) 
Seat 7: dtZ84flFEi4Q+SGrHMJRDQ ($26 in chips) 
Seat 8: j4q3p0lesp63b1gZDwLBZw ($5 in chips) 
Seat 9: nm4Dj/f+jJEwKVsUnKh73g ($37.05 in chips) 
j4q3p0lesp63b1gZDwLBZw: posts small blind $0.10
nm4Dj/f+jJEwKVsUnKh73g: posts big blind $0.25
tLcDklc2rBORNfixyRfVfw: sits out 
*** HOLE CARDS ***
tYsOBqdU1+x+yFI7zHO7hQ: raises $0.75 to $1
S7Ki0P+0AIGPuIfGJjW0gg: folds 
ydoFOVgzvZv9ZhuWu9rXAw: folds 
9YN2IkT2JYYKFErZtZvCtA: calls $1
dtZ84flFEi4Q+SGrHMJRDQ: folds 
j4q3p0lesp63b1gZDwLBZw: folds 
nm4Dj/f+jJEwKVsUnKh73g: folds 
*** FLOP *** [3s 5s 8d]
tYsOBqdU1+x+yFI7zHO7hQ: bets $1.50
9YN2IkT2JYYKFErZtZvCtA: folds 
Uncalled bet ($1.50) returned to tYsOBqdU1+x+yFI7zHO7hQ
tYsOBqdU1+x+yFI7zHO7hQ collected $2.25 from pot
tYsOBqdU1+x+yFI7zHO7hQ: doesn't show hand 
*** SUMMARY ***
Total pot $2.35 | Rake $0.10 
Board [3s 5s 8d]
Seat 1: tYsOBqdU1+x+yFI7zHO7hQ collected ($2.25)
Seat 3: S7Ki0P+0AIGPuIfGJjW0gg folded before Flop (didn't bet)
Seat 4: ydoFOVgzvZv9ZhuWu9rXAw folded before Flop (didn't bet)
Seat 6: 9YN2IkT2JYYKFErZtZvCtA folded on the Flop
Seat 7: dtZ84flFEi4Q+SGrHMJRDQ (button) folded before Flop (didn't bet)
Seat 8: j4q3p0lesp63b1gZDwLBZw (small blind) folded before Flop
Seat 9: nm4Dj/f+jJEwKVsUnKh73g (big blind) folded before Flop




PokerStars Game #59941761956:  Hold'em No Limit ($0.10/$0.25) - 2009/07/01 1:45:20 ET
Table 'xro+BVoe2Zuw1TYmz/McJQ' 9-max Seat #7 is the button
Seat 1: xEQxarad8/T4jJdpZy5LGw ($9.40 in chips) 
Seat 2: vSkQm2EelzwRGDDQQk0Fqw ($4.65 in chips) 
Seat 4: N2LVj3iImgnOoHVf8g0rIw ($45.90 in chips) 
Seat 5: w48D7DZIjuBit2n4FRDJ5Q ($14.85 in chips) 
Seat 6: HPEB+AtKw1+C/cxU0o1ciw ($26.50 in chips) 
Seat 7: QEbIGci+itdw+re8RM5fZA ($30.80 in chips) 
Seat 8: ljemhp25Zg+nlA9DLCIiUw ($22.75 in chips) 
Seat 9: H5Se03ZqSX7tbULXur2MAg ($13.65 in chips) 
ljemhp25Zg+nlA9DLCIiUw: posts small blind $0.10
H5Se03ZqSX7tbULXur2MAg: posts big blind $0.25
PdIasPkzm2sqZnN41ZRXOg: sits out 
*** HOLE CARDS ***
xEQxarad8/T4jJdpZy5LGw: folds 
xEQxarad8/T4jJdpZy5LGw leaves the table
vSkQm2EelzwRGDDQQk0Fqw: folds 
N2LVj3iImgnOoHVf8g0rIw: raises $0.75 to $1
w48D7DZIjuBit2n4FRDJ5Q: folds 
HPEB+AtKw1+C/cxU0o1ciw: folds 
QEbIGci+itdw+re8RM5fZA: folds 
ljemhp25Zg+nlA9DLCIiUw: folds 
H5Se03ZqSX7tbULXur2MAg: folds 
Uncalled bet ($0.75) returned to N2LVj3iImgnOoHVf8g0rIw
H5Se03ZqSX7tbULXur2MAg leaves the table
N2LVj3iImgnOoHVf8g0rIw collected $0.60 from pot
*** SUMMARY ***
Total pot $0.60 | Rake $0 
Seat 1: xEQxarad8/T4jJdpZy5LGw folded before Flop (didn't bet)
Seat 2: vSkQm2EelzwRGDDQQk0Fqw folded before Flop (didn't bet)
Seat 4: N2LVj3iImgnOoHVf8g0rIw collected ($0.60)
Seat 5: w48D7DZIjuBit2n4FRDJ5Q folded before Flop (didn't bet)
Seat 6: HPEB+AtKw1+C/cxU0o1ciw folded before Flop (didn't bet)
Seat 7: QEbIGci+itdw+re8RM5fZA (button) folded before Flop (didn't bet)
Seat 8: ljemhp25Zg+nlA9DLCIiUw (small blind) folded before Flop
Seat 9: H5Se03ZqSX7tbULXur2MAg (big blind) folded before Flop




PokerStars Game #59941762120:  Hold'em No Limit ($0.10/$0.25) - 2009/07/01 1:45:20 ET
Table 'Pz8SfAzhP5nvWTsJRAxoDg' 6-max Seat #4 is the button
Seat 1: QiL+lEgEWwy21jk/ltaRLg ($47.50 in chips) 
Seat 3: mfrkWA3PTeYPkbO6hi98Aw ($26.85 in chips) 
Seat 4: 4lJto+Qj0K4JrFKvHaPTLw ($67.05 in chips) 
Seat 5: FYepjhAvF8ZdVCmqHIy+eQ ($28.15 in chips) 
Seat 6: QvTX2yGq3uKJiKPmns4TKQ ($24.65 in chips) 
FYepjhAvF8ZdVCmqHIy+eQ: posts small blind $0.10
QvTX2yGq3uKJiKPmns4TKQ: posts big blind $0.25
*** HOLE CARDS ***
QiL+lEgEWwy21jk/ltaRLg: folds 
mfrkWA3PTeYPkbO6hi98Aw: raises $0.75 to $1
4lJto+Qj0K4JrFKvHaPTLw: folds 
FYepjhAvF8ZdVCmqHIy+eQ: folds 
QvTX2yGq3uKJiKPmns4TKQ: raises $1.25 to $2.25
mfrkWA3PTeYPkbO6hi98Aw: calls $1.25
*** FLOP *** [4s Kh 2c]
QvTX2yGq3uKJiKPmns4TKQ: bets $1.50
k021eD5in2AjaloW5PalMg joins the table at seat #2 
mfrkWA3PTeYPkbO6hi98Aw: folds 
Uncalled bet ($1.50) returned to QvTX2yGq3uKJiKPmns4TKQ
QvTX2yGq3uKJiKPmns4TKQ collected $4.40 from pot
QvTX2yGq3uKJiKPmns4TKQ: doesn't show hand 
*** SUMMARY ***
Total pot $4.60 | Rake $0.20 
Board [4s Kh 2c]
Seat 1: QiL+lEgEWwy21jk/ltaRLg folded before Flop (didn't bet)
Seat 3: mfrkWA3PTeYPkbO6hi98Aw folded on the Flop
Seat 4: 4lJto+Qj0K4JrFKvHaPTLw (button) folded before Flop (didn't bet)
Seat 5: FYepjhAvF8ZdVCmqHIy+eQ (small blind) folded before Flop
Seat 6: QvTX2yGq3uKJiKPmns4TKQ (big blind) collected ($4.40)




PokerStars Game #59941762122:  Hold'em No Limit ($0.10/$0.25) - 2009/07/01 1:45:20 ET
Table 'Dun24l/X8kjpUHWBhkVOFw' 6-max Seat #4 is the button
Seat 1: u3Ol7kv1LmvszuHNm9rc6w ($20 in chips) 
Seat 2: 6hUmfDYq+83kvxWoTBQmfw ($25 in chips) 
Seat 3: +E5iJKkKVfaTgTqzuXXv0g ($15 in chips) 
Seat 4: 7/ROHX4tuLekJ2diYIlMkw ($9.55 in chips) 
u3Ol7kv1LmvszuHNm9rc6w: posts small blind $0.10
6hUmfDYq+83kvxWoTBQmfw: posts big blind $0.25
*** HOLE CARDS ***
+E5iJKkKVfaTgTqzuXXv0g: raises $0.25 to $0.50
7/ROHX4tuLekJ2diYIlMkw: calls $0.50
xrf8tAXKQHG99HixCot1Iw joins the table at seat #6 
u3Ol7kv1LmvszuHNm9rc6w: calls $0.40
6hUmfDYq+83kvxWoTBQmfw: raises $0.25 to $0.75
+E5iJKkKVfaTgTqzuXXv0g: calls $0.25
7/ROHX4tuLekJ2diYIlMkw: calls $0.25
u3Ol7kv1LmvszuHNm9rc6w: calls $0.25
*** FLOP *** [Kh 3s Jh]
KYBwVA7jgmSrbIEbEGElVg joins the table at seat #5 
u3Ol7kv1LmvszuHNm9rc6w: checks 
6hUmfDYq+83kvxWoTBQmfw: checks 
+E5iJKkKVfaTgTqzuXXv0g: bets $0.75
7/ROHX4tuLekJ2diYIlMkw: folds 
u3Ol7kv1LmvszuHNm9rc6w: calls $0.75
6hUmfDYq+83kvxWoTBQmfw: folds 
*** TURN *** [Kh 3s Jh] [As]
u3Ol7kv1LmvszuHNm9rc6w: checks 
+E5iJKkKVfaTgTqzuXXv0g: checks 
*** RIVER *** [Kh 3s Jh As] [Jc]
u3Ol7kv1LmvszuHNm9rc6w: checks 
+E5iJKkKVfaTgTqzuXXv0g: checks 
*** SHOW DOWN ***
u3Ol7kv1LmvszuHNm9rc6w: shows [2s 3h] (two pair, Jacks and Threes)
+E5iJKkKVfaTgTqzuXXv0g: mucks hand 
u3Ol7kv1LmvszuHNm9rc6w collected $4.30 from pot
*** SUMMARY ***
Total pot $4.50 | Rake $0.20 
Board [Kh 3s Jh As Jc]
Seat 1: u3Ol7kv1LmvszuHNm9rc6w (small blind) showed [2s 3h] and won ($4.30) with two pair, Jacks and Threes
Seat 2: 6hUmfDYq+83kvxWoTBQmfw (big blind) folded on the Flop
Seat 3: +E5iJKkKVfaTgTqzuXXv0g mucked
Seat 4: 7/ROHX4tuLekJ2diYIlMkw (button) folded on the Flop




PokerStars Game #59941761710:  Hold'em No Limit ($0.10/$0.25) - 2009/07/01 1:45:20 ET
Table '9lYs7ljXi6AgFAxYHlKLJw' 9-max Seat #5 is the button
Seat 1: K0b5wNInj6hUGRr6yzKFtw ($37.15 in chips) 
Seat 2: 0XACOSNrAWmqNv9k1nF8rw ($18.20 in chips) 
Seat 3: arxNSjreDRGFg13EAM2F1w ($30.95 in chips) 
Seat 4: UANt6y/SmDCY/jIxkBixcw ($33 in chips) 
Seat 5: dfNim92Z6XK1/h5SFW5vDg ($51.60 in chips) 
Seat 6: tYsOBqdU1+x+yFI7zHO7hQ ($25 in chips) 
Seat 7: ghNKXUBl/H+t83JF079ZBA ($28.05 in chips) 
Seat 8: 9YN2IkT2JYYKFErZtZvCtA ($19.45 in chips) 
Seat 9: cKlmpQMahVsmOaxFQDcoOg ($19 in chips) 
tYsOBqdU1+x+yFI7zHO7hQ: posts small blind $0.10
ghNKXUBl/H+t83JF079ZBA: posts big blind $0.25
*** HOLE CARDS ***
9YN2IkT2JYYKFErZtZvCtA: folds 
cKlmpQMahVsmOaxFQDcoOg: folds 
K0b5wNInj6hUGRr6yzKFtw: folds 
0XACOSNrAWmqNv9k1nF8rw: calls $0.25
arxNSjreDRGFg13EAM2F1w: raises $0.75 to $1
UANt6y/SmDCY/jIxkBixcw: folds 
dfNim92Z6XK1/h5SFW5vDg: folds 
tYsOBqdU1+x+yFI7zHO7hQ: folds 
ghNKXUBl/H+t83JF079ZBA: folds 
0XACOSNrAWmqNv9k1nF8rw: calls $0.75
*** FLOP *** [Jc 8s Ah]
0XACOSNrAWmqNv9k1nF8rw: checks 
arxNSjreDRGFg13EAM2F1w: checks 
*** TURN *** [Jc 8s Ah] [Th]
0XACOSNrAWmqNv9k1nF8rw: bets $0.25
arxNSjreDRGFg13EAM2F1w: calls $0.25
*** RIVER *** [Jc 8s Ah Th] [3c]
0XACOSNrAWmqNv9k1nF8rw: bets $0.25
arxNSjreDRGFg13EAM2F1w: calls $0.25
*** SHOW DOWN ***
0XACOSNrAWmqNv9k1nF8rw: shows [9c Ts] (a pair of Tens)
arxNSjreDRGFg13EAM2F1w: shows [Qh Qd] (a pair of Queens)
arxNSjreDRGFg13EAM2F1w collected $3.20 from pot
*** SUMMARY ***
Total pot $3.35 | Rake $0.15 
Board [Jc 8s Ah Th 3c]
Seat 1: K0b5wNInj6hUGRr6yzKFtw folded before Flop (didn't bet)
Seat 2: 0XACOSNrAWmqNv9k1nF8rw showed [9c Ts] and lost with a pair of Tens
Seat 3: arxNSjreDRGFg13EAM2F1w showed [Qh Qd] and won ($3.20) with a pair of Queens
Seat 4: UANt6y/SmDCY/jIxkBixcw folded before Flop (didn't bet)
Seat 5: dfNim92Z6XK1/h5SFW5vDg (button) folded before Flop (didn't bet)
Seat 6: tYsOBqdU1+x+yFI7zHO7hQ (small blind) folded before Flop
Seat 7: ghNKXUBl/H+t83JF079ZBA (big blind) folded before Flop
Seat 8: 9YN2IkT2JYYKFErZtZvCtA folded before Flop (didn't bet)
Seat 9: cKlmpQMahVsmOaxFQDcoOg folded before Flop (didn't bet)




PokerStars Game #59941762216:  Hold'em No Limit ($0.10/$0.25) - 2009/07/01 1:45:21 ET
Table '63h13e5p7cWe02rClZ1CHw' 6-max Seat #4 is the button
Seat 1: pokjbbEcXXPlADXdSGHtZw ($18.75 in chips) 
Seat 2: k9nHZTHt8hYhYRcW8NTb4g ($30.15 in chips) 
Seat 3: mFv3iBCtrw9XfCDRB0d46Q ($4.65 in chips) 
Seat 4: xrf8tAXKQHG99HixCot1Iw ($25 in chips) 
Seat 5: iyZxqznXjv3vtvOJymkoLQ ($44.55 in chips) 
Seat 6: mfrkWA3PTeYPkbO6hi98Aw ($39.40 in chips) 
iyZxqznXjv3vtvOJymkoLQ: posts small blind $0.10
mfrkWA3PTeYPkbO6hi98Aw: posts big blind $0.25
*** HOLE CARDS ***
pokjbbEcXXPlADXdSGHtZw: calls $0.25
k9nHZTHt8hYhYRcW8NTb4g: raises $0.50 to $0.75
mFv3iBCtrw9XfCDRB0d46Q: folds 
xrf8tAXKQHG99HixCot1Iw: folds 
iyZxqznXjv3vtvOJymkoLQ: folds 
mfrkWA3PTeYPkbO6hi98Aw: folds 
pokjbbEcXXPlADXdSGHtZw: calls $0.50
*** FLOP *** [4c Jd 5c]
pokjbbEcXXPlADXdSGHtZw: checks 
k9nHZTHt8hYhYRcW8NTb4g: bets $1.25
pokjbbEcXXPlADXdSGHtZw: calls $1.25
*** TURN *** [4c Jd 5c] [Tc]
pokjbbEcXXPlADXdSGHtZw: bets $2
k9nHZTHt8hYhYRcW8NTb4g: calls $2
*** RIVER *** [4c Jd 5c Tc] [2h]
pokjbbEcXXPlADXdSGHtZw: bets $2
k9nHZTHt8hYhYRcW8NTb4g: folds 
Uncalled bet ($2) returned to pokjbbEcXXPlADXdSGHtZw
pokjbbEcXXPlADXdSGHtZw collected $7.95 from pot
*** SUMMARY ***
Total pot $8.35 | Rake $0.40 
Board [4c Jd 5c Tc 2h]
Seat 1: pokjbbEcXXPlADXdSGHtZw collected ($7.95)
Seat 2: k9nHZTHt8hYhYRcW8NTb4g folded on the River
Seat 3: mFv3iBCtrw9XfCDRB0d46Q folded before Flop (didn't bet)
Seat 4: xrf8tAXKQHG99HixCot1Iw (button) folded before Flop (didn't bet)
Seat 5: iyZxqznXjv3vtvOJymkoLQ (small blind) folded before Flop
Seat 6: mfrkWA3PTeYPkbO6hi98Aw (big blind) folded before Flop




PokerStars Game #59941762482:  Hold'em No Limit ($0.10/$0.25) - 2009/07/01 1:45:21 ET
Table 'UVjmXTtsmlX1HxwwZ59akg' 9-max Seat #5 is the button
Seat 2: q+Qdg0Hoir+SyL7haBrUnw ($7.80 in chips) 
Seat 3: GmzfAfxcxu1kGbPC+9LkVg ($24.65 in chips) 
Seat 4: X78b5v/uhqeXXoAijbw/yg ($25 in chips) 
Seat 5: Bb42QRQMhg5/Y0vHP8/2Xw ($39.95 in chips) 
Seat 6: st9jtdNbm1W5GfBwRaCVqQ ($27.35 in chips) 
Seat 9: ljemhp25Zg+nlA9DLCIiUw ($25 in chips) 
st9jtdNbm1W5GfBwRaCVqQ: posts small blind $0.10
ljemhp25Zg+nlA9DLCIiUw: posts big blind $0.25
*** HOLE CARDS ***
q+Qdg0Hoir+SyL7haBrUnw: folds 
GmzfAfxcxu1kGbPC+9LkVg: folds 
X78b5v/uhqeXXoAijbw/yg: folds 
Bb42QRQMhg5/Y0vHP8/2Xw: folds 
st9jtdNbm1W5GfBwRaCVqQ: calls $0.15
ljemhp25Zg+nlA9DLCIiUw: checks 
*** FLOP *** [3h 7d Ks]
st9jtdNbm1W5GfBwRaCVqQ: checks 
ljemhp25Zg+nlA9DLCIiUw: checks 
*** TURN *** [3h 7d Ks] [5c]
st9jtdNbm1W5GfBwRaCVqQ: checks 
ljemhp25Zg+nlA9DLCIiUw: checks 
*** RIVER *** [3h 7d Ks 5c] [Qc]
st9jtdNbm1W5GfBwRaCVqQ: checks 
ljemhp25Zg+nlA9DLCIiUw: checks 
*** SHOW DOWN ***
st9jtdNbm1W5GfBwRaCVqQ: shows [9c Js] (high card King)
ljemhp25Zg+nlA9DLCIiUw: mucks hand 
st9jtdNbm1W5GfBwRaCVqQ collected $0.50 from pot
*** SUMMARY ***
Total pot $0.50 | Rake $0 
Board [3h 7d Ks 5c Qc]
Seat 2: q+Qdg0Hoir+SyL7haBrUnw folded before Flop (didn't bet)
Seat 3: GmzfAfxcxu1kGbPC+9LkVg folded before Flop (didn't bet)
Seat 4: X78b5v/uhqeXXoAijbw/yg folded before Flop (didn't bet)
Seat 5: Bb42QRQMhg5/Y0vHP8/2Xw (button) folded before Flop (didn't bet)
Seat 6: st9jtdNbm1W5GfBwRaCVqQ (small blind) showed [9c Js] and won ($0.50) with high card King
Seat 9: ljemhp25Zg+nlA9DLCIiUw (big blind) mucked




PokerStars Game #59941763078:  Hold'em No Limit ($0.10/$0.25) - 2009/07/01 1:45:22 ET
Table 'Ok3oDLIsTc2+KxPcI0bAOA' 6-max Seat #3 is the button
Seat 1: agQm3ugZ3qSVYNgNu1ddeA ($40.75 in chips) 
Seat 2: wPSNSp4HYtytRMXTu3oPSQ ($26.95 in chips) 
Seat 3: lquriepNQBhDV5P1SWHhnA ($36.10 in chips) 
Seat 4: LJI7A1YgDM7hgh7o56+ReQ ($36.65 in chips) 
Seat 5: DFi/Lzkjsfv8QswS80JX9Q ($28.60 in chips) 
Seat 6: Hsvkc0/G2VV78oVmWYXecw ($5 in chips) 
LJI7A1YgDM7hgh7o56+ReQ: posts small blind $0.10
DFi/Lzkjsfv8QswS80JX9Q: posts big blind $0.25
*** HOLE CARDS ***
Hsvkc0/G2VV78oVmWYXecw: folds 
agQm3ugZ3qSVYNgNu1ddeA: folds 
wPSNSp4HYtytRMXTu3oPSQ: folds 
lquriepNQBhDV5P1SWHhnA: raises $0.50 to $0.75
LJI7A1YgDM7hgh7o56+ReQ: folds 
DFi/Lzkjsfv8QswS80JX9Q: folds 
Uncalled bet ($0.50) returned to lquriepNQBhDV5P1SWHhnA
lquriepNQBhDV5P1SWHhnA collected $0.60 from pot
lquriepNQBhDV5P1SWHhnA: doesn't show hand 
*** SUMMARY ***
Total pot $0.60 | Rake $0 
Seat 1: agQm3ugZ3qSVYNgNu1ddeA folded before Flop (didn't bet)
Seat 2: wPSNSp4HYtytRMXTu3oPSQ folded before Flop (didn't bet)
Seat 3: lquriepNQBhDV5P1SWHhnA (button) collected ($0.60)
Seat 4: LJI7A1YgDM7hgh7o56+ReQ (small blind) folded before Flop
Seat 5: DFi/Lzkjsfv8QswS80JX9Q (big blind) folded before Flop
Seat 6: Hsvkc0/G2VV78oVmWYXecw folded before Flop (didn't bet)




PokerStars Game #59941762870:  Hold'em No Limit ($0.10/$0.25) - 2009/07/01 1:45:22 ET
Table 'qryc9C/ELyQ3lubOaELNAQ' 6-max Seat #2 is the button
Seat 1: OZc6kkoTwtITj1ZfreJK1A ($65.95 in chips) 
Seat 2: LtASJ9OlkqGrrUKGQlpGAw ($29.95 in chips) 
Seat 3: wvIIdlbCgePONQwXjx9xzQ ($4.25 in chips) 
Seat 4: v+QfkGiuj9bgtuNoVnDO8w ($25.05 in chips) 
Seat 5: 9StOHp+Y1T0K13JdgS2oQQ ($37.40 in chips) 
Seat 6: u+J1MTXS2qhNVMbsBemNLg ($5 in chips) 
wvIIdlbCgePONQwXjx9xzQ: posts small blind $0.10
v+QfkGiuj9bgtuNoVnDO8w: posts big blind $0.25
*** HOLE CARDS ***
9StOHp+Y1T0K13JdgS2oQQ: folds 
u+J1MTXS2qhNVMbsBemNLg: folds 
OZc6kkoTwtITj1ZfreJK1A: calls $0.25
LtASJ9OlkqGrrUKGQlpGAw: folds 
wvIIdlbCgePONQwXjx9xzQ: raises $0.50 to $0.75
v+QfkGiuj9bgtuNoVnDO8w: folds 
OZc6kkoTwtITj1ZfreJK1A: raises $0.50 to $1.25
wvIIdlbCgePONQwXjx9xzQ: calls $0.50
*** FLOP *** [8d 6c 4d]
wvIIdlbCgePONQwXjx9xzQ: checks 
u+J1MTXS2qhNVMbsBemNLg leaves the table
OZc6kkoTwtITj1ZfreJK1A: bets $2.50
wvIIdlbCgePONQwXjx9xzQ: raises $0.50 to $3 and is all-in
OZc6kkoTwtITj1ZfreJK1A: calls $0.50
*** TURN *** [8d 6c 4d] [5s]
*** RIVER *** [8d 6c 4d 5s] [7c]
*** SHOW DOWN ***
wvIIdlbCgePONQwXjx9xzQ: shows [Kd Ks] (a straight, Four to Eight)
OZc6kkoTwtITj1ZfreJK1A: shows [Js Kh] (a straight, Four to Eight)
wvIIdlbCgePONQwXjx9xzQ collected $4.20 from pot
OZc6kkoTwtITj1ZfreJK1A collected $4.15 from pot
*** SUMMARY ***
Total pot $8.75 | Rake $0.40 
Board [8d 6c 4d 5s 7c]
Seat 1: OZc6kkoTwtITj1ZfreJK1A showed [Js Kh] and won ($4.15) with a straight, Four to Eight
Seat 2: LtASJ9OlkqGrrUKGQlpGAw (button) folded before Flop (didn't bet)
Seat 3: wvIIdlbCgePONQwXjx9xzQ (small blind) showed [Kd Ks] and won ($4.20) with a straight, Four to Eight
Seat 4: v+QfkGiuj9bgtuNoVnDO8w (big blind) folded before Flop
Seat 5: 9StOHp+Y1T0K13JdgS2oQQ folded before Flop (didn't bet)
Seat 6: u+J1MTXS2qhNVMbsBemNLg folded before Flop (didn't bet)




PokerStars Game #59941763086:  Hold'em No Limit ($0.10/$0.25) - 2009/07/01 1:45:22 ET
Table 'AchTjdLS1zBUbH3ZIx6f0w' 6-max Seat #6 is the button
Seat 1: rZ0bUtoerhFGDUSRQMnFog ($28.10 in chips) 
Seat 2: kG34n23qFQA3nzdOJTQ1dA ($66.25 in chips) 
Seat 3: k9vn40MOqqb+xF+7GZ6v2g ($30.25 in chips) 
Seat 4: q6WfTUAD9mowIP63ASq2Dg ($30.55 in chips) 
Seat 5: 0av6tRNdi0Ui4f15L7gsVg ($26 in chips) 
Seat 6: epAUIB7h2FJXzUPRIvSkRA ($25 in chips) 
rZ0bUtoerhFGDUSRQMnFog: posts small blind $0.10
kG34n23qFQA3nzdOJTQ1dA: posts big blind $0.25
*** HOLE CARDS ***
k9vn40MOqqb+xF+7GZ6v2g: folds 
q6WfTUAD9mowIP63ASq2Dg has timed out
q6WfTUAD9mowIP63ASq2Dg: folds 
q6WfTUAD9mowIP63ASq2Dg is sitting out
0av6tRNdi0Ui4f15L7gsVg: folds 
epAUIB7h2FJXzUPRIvSkRA: raises $0.75 to $1
rZ0bUtoerhFGDUSRQMnFog: folds 
q6WfTUAD9mowIP63ASq2Dg has returned
kG34n23qFQA3nzdOJTQ1dA: folds 
Uncalled bet ($0.75) returned to epAUIB7h2FJXzUPRIvSkRA
epAUIB7h2FJXzUPRIvSkRA collected $0.60 from pot
epAUIB7h2FJXzUPRIvSkRA: doesn't show hand 
*** SUMMARY ***
Total pot $0.60 | Rake $0 
Seat 1: rZ0bUtoerhFGDUSRQMnFog (small blind) folded before Flop
Seat 2: kG34n23qFQA3nzdOJTQ1dA (big blind) folded before Flop
Seat 3: k9vn40MOqqb+xF+7GZ6v2g folded before Flop (didn't bet)
Seat 4: q6WfTUAD9mowIP63ASq2Dg folded before Flop (didn't bet)
Seat 5: 0av6tRNdi0Ui4f15L7gsVg folded before Flop (didn't bet)
Seat 6: epAUIB7h2FJXzUPRIvSkRA (button) collected ($0.60)




PokerStars Game #59941763100:  Hold'em No Limit ($0.10/$0.25) - 2009/07/01 1:45:22 ET
Table '6aL2C8IFwHHr6SG6RgXaow' 9-max Seat #1 is the button
Seat 1: bXpVeaSTPBFSPJmeXxO7nw ($4.65 in chips) 
Seat 4: BT6Oal0iO4P6kDuT7HFQDw ($18.35 in chips) 
Seat 5: wre31HfyzQGpIvID1istxw ($21.20 in chips) 
Seat 6: gehe91e0IyVT0QU/XBkEyg ($27.10 in chips) 
Seat 7: QJxYAPJ6uPZZcpdN+RvWcQ ($25 in chips) 
Seat 8: rQhYIYXSyH/IivYM1dlV5A ($22.45 in chips) 
Seat 9: CgIo2ItZqi4o3ayVG6HanQ ($24 in chips) 
BT6Oal0iO4P6kDuT7HFQDw: posts small blind $0.10
wre31HfyzQGpIvID1istxw: posts big blind $0.25
*** HOLE CARDS ***
gehe91e0IyVT0QU/XBkEyg: folds 
clJsV3v77RS07bDKY+705w joins the table at seat #3 
QJxYAPJ6uPZZcpdN+RvWcQ: folds 
rQhYIYXSyH/IivYM1dlV5A: folds 
CgIo2ItZqi4o3ayVG6HanQ: folds 
bXpVeaSTPBFSPJmeXxO7nw: folds 
BT6Oal0iO4P6kDuT7HFQDw: folds 
Uncalled bet ($0.15) returned to wre31HfyzQGpIvID1istxw
wre31HfyzQGpIvID1istxw collected $0.20 from pot
*** SUMMARY ***
Total pot $0.20 | Rake $0 
Seat 1: bXpVeaSTPBFSPJmeXxO7nw (button) folded before Flop (didn't bet)
Seat 4: BT6Oal0iO4P6kDuT7HFQDw (small blind) folded before Flop
Seat 5: wre31HfyzQGpIvID1istxw (big blind) collected ($0.20)
Seat 6: gehe91e0IyVT0QU/XBkEyg folded before Flop (didn't bet)
Seat 7: QJxYAPJ6uPZZcpdN+RvWcQ folded before Flop (didn't bet)
Seat 8: rQhYIYXSyH/IivYM1dlV5A folded before Flop (didn't bet)
Seat 9: CgIo2ItZqi4o3ayVG6HanQ folded before Flop (didn't bet)




PokerStars Game #59941763016:  Hold'em No Limit ($0.10/$0.25) - 2009/07/01 1:45:22 ET
Table '0XPo7K54oZIfG0xlNAcDRw' 9-max Seat #5 is the button
Seat 1: 7cv+9Zc9HIQHNvYsMfV3uA ($29.35 in chips) 
Seat 2: Prl9QvWQw/mISF4dSnnQUQ ($10.10 in chips) 
Seat 3: RHqgdFvufLCYe54+qd2gcA ($4.75 in chips) 
Seat 4: RubYqfvGrz2z+5ReNIj9QQ ($30.30 in chips) 
Seat 5: iOmwbUN7u4JFkV6VCA49aA ($15.15 in chips) 
Seat 6: M1nKET7WOTLbVPuAbJa3EA ($14.75 in chips) 
Seat 7: tYsOBqdU1+x+yFI7zHO7hQ ($28.80 in chips) 
Seat 8: v5jnQ1gfh9nLla3kMXG7Yg ($15.70 in chips) 
Seat 9: CmngQmkKTp8tkl6GMRTl6w ($13.60 in chips) 
M1nKET7WOTLbVPuAbJa3EA: posts small blind $0.10
tYsOBqdU1+x+yFI7zHO7hQ: posts big blind $0.25
*** HOLE CARDS ***
v5jnQ1gfh9nLla3kMXG7Yg: calls $0.25
CmngQmkKTp8tkl6GMRTl6w: folds 
iOmwbUN7u4JFkV6VCA49aA said, "q 2 taxi"
7cv+9Zc9HIQHNvYsMfV3uA: folds 
iOmwbUN7u4JFkV6VCA49aA said, "sick"
Prl9QvWQw/mISF4dSnnQUQ: folds 
RHqgdFvufLCYe54+qd2gcA: folds 
RubYqfvGrz2z+5ReNIj9QQ: raises $0.50 to $0.75
iOmwbUN7u4JFkV6VCA49aA: folds 
M1nKET7WOTLbVPuAbJa3EA: folds 
tYsOBqdU1+x+yFI7zHO7hQ: folds 
v5jnQ1gfh9nLla3kMXG7Yg: calls $0.50
*** FLOP *** [4h Jd Ad]
v5jnQ1gfh9nLla3kMXG7Yg: checks 
RubYqfvGrz2z+5ReNIj9QQ: bets $1.25
v5jnQ1gfh9nLla3kMXG7Yg: folds 
Uncalled bet ($1.25) returned to RubYqfvGrz2z+5ReNIj9QQ
RubYqfvGrz2z+5ReNIj9QQ collected $1.80 from pot
RubYqfvGrz2z+5ReNIj9QQ: doesn't show hand 
*** SUMMARY ***
Total pot $1.85 | Rake $0.05 
Board [4h Jd Ad]
Seat 1: 7cv+9Zc9HIQHNvYsMfV3uA folded before Flop (didn't bet)
Seat 2: Prl9QvWQw/mISF4dSnnQUQ folded before Flop (didn't bet)
Seat 3: RHqgdFvufLCYe54+qd2gcA folded before Flop (didn't bet)
Seat 4: RubYqfvGrz2z+5ReNIj9QQ collected ($1.80)
Seat 5: iOmwbUN7u4JFkV6VCA49aA (button) folded before Flop (didn't bet)
Seat 6: M1nKET7WOTLbVPuAbJa3EA (small blind) folded before Flop
Seat 7: tYsOBqdU1+x+yFI7zHO7hQ (big blind) folded before Flop
Seat 8: v5jnQ1gfh9nLla3kMXG7Yg folded on the Flop
Seat 9: CmngQmkKTp8tkl6GMRTl6w folded before Flop (didn't bet)




PokerStars Game #59941763050:  Hold'em No Limit ($0.10/$0.25) - 2009/07/01 1:45:22 ET
Table 'rO1I30HnuCPB0M8qEX1TCQ' 9-max Seat #7 is the button
Seat 1: dfsOFy2nKDeSF9SjtdIyVA ($13.20 in chips) 
Seat 2: z1hPotrGOZjUjyoopZ7Ulg ($21.70 in chips) 
Seat 3: 2wcFsZsqEP5w1StUTVzJCg ($13.15 in chips) 
Seat 4: yyG4svzOpC1A+sUP/scg6w ($10.40 in chips) 
Seat 5: W6tExOcYX7qiy6Qdp+ZwFA ($5.10 in chips) 
Seat 6: 5n7e7I+px7c6CQmLpPbtsg ($4.65 in chips) 
Seat 7: bXpVeaSTPBFSPJmeXxO7nw ($4.65 in chips) 
Seat 8: 6mStmDUknIn/RyBEoiIyoQ ($2.05 in chips) 
Seat 9: wnerYvSRWT9Sm4X3ip/c8w ($25 in chips) 
6mStmDUknIn/RyBEoiIyoQ: posts small blind $0.10
wnerYvSRWT9Sm4X3ip/c8w: posts big blind $0.25
*** HOLE CARDS ***
dfsOFy2nKDeSF9SjtdIyVA: folds 
dfsOFy2nKDeSF9SjtdIyVA is sitting out
z1hPotrGOZjUjyoopZ7Ulg: folds 
2wcFsZsqEP5w1StUTVzJCg: folds 
dfsOFy2nKDeSF9SjtdIyVA leaves the table
yyG4svzOpC1A+sUP/scg6w: folds 
W6tExOcYX7qiy6Qdp+ZwFA: raises $0.50 to $0.75
5n7e7I+px7c6CQmLpPbtsg: folds 
bXpVeaSTPBFSPJmeXxO7nw: folds 
6mStmDUknIn/RyBEoiIyoQ: calls $0.65
wnerYvSRWT9Sm4X3ip/c8w: folds 
*** FLOP *** [Jd 4h 5h]
6mStmDUknIn/RyBEoiIyoQ: bets $1.30 and is all-in
W6tExOcYX7qiy6Qdp+ZwFA: calls $1.30
*** TURN *** [Jd 4h 5h] [Ah]
*** RIVER *** [Jd 4h 5h Ah] [6c]
*** SHOW DOWN ***
6mStmDUknIn/RyBEoiIyoQ: shows [Jh 9d] (a pair of Jacks)
W6tExOcYX7qiy6Qdp+ZwFA: shows [Ac Qs] (a pair of Aces)
W6tExOcYX7qiy6Qdp+ZwFA collected $4.15 from pot
*** SUMMARY ***
Total pot $4.35 | Rake $0.20 
Board [Jd 4h 5h Ah 6c]
Seat 1: dfsOFy2nKDeSF9SjtdIyVA folded before Flop (didn't bet)
Seat 2: z1hPotrGOZjUjyoopZ7Ulg folded before Flop (didn't bet)
Seat 3: 2wcFsZsqEP5w1StUTVzJCg folded before Flop (didn't bet)
Seat 4: yyG4svzOpC1A+sUP/scg6w folded before Flop (didn't bet)
Seat 5: W6tExOcYX7qiy6Qdp+ZwFA showed [Ac Qs] and won ($4.15) with a pair of Aces
Seat 6: 5n7e7I+px7c6CQmLpPbtsg folded before Flop (didn't bet)
Seat 7: bXpVeaSTPBFSPJmeXxO7nw (button) folded before Flop (didn't bet)
Seat 8: 6mStmDUknIn/RyBEoiIyoQ (small blind) showed [Jh 9d] and lost with a pair of Jacks
Seat 9: wnerYvSRWT9Sm4X3ip/c8w (big blind) folded before Flop




PokerStars Game #59941762810:  Hold'em No Limit ($0.10/$0.25) - 2009/07/01 1:45:22 ET
Table 'hg+KpirwreMnBAFQr/SEUA' 9-max Seat #7 is the button
Seat 1: H5Se03ZqSX7tbULXur2MAg ($33.80 in chips) 
Seat 2: cpnBzHjFACn5zAY56UIvNA ($20.60 in chips) 
Seat 3: DdyXKuBx0HAOC7dWZmGxWg ($24.25 in chips) 
Seat 5: +2kMBNpY4nF1qNCRd8SJLA ($25 in chips) 
Seat 6: Bb42QRQMhg5/Y0vHP8/2Xw ($25 in chips) 
Seat 7: 5LSuZS4qvcUri/Byfkln7w ($7.50 in chips) 
Seat 8: HPEB+AtKw1+C/cxU0o1ciw ($23.50 in chips) 
Seat 9: xbecloQJYmBOSkzT9lZ+rg ($20.50 in chips) 
HPEB+AtKw1+C/cxU0o1ciw: posts small blind $0.10
xbecloQJYmBOSkzT9lZ+rg: posts big blind $0.25
Z9W7+g1WMhhZDi7DwGbCFA: sits out 
*** HOLE CARDS ***
H5Se03ZqSX7tbULXur2MAg: folds 
cpnBzHjFACn5zAY56UIvNA: folds 
DdyXKuBx0HAOC7dWZmGxWg: folds 
+2kMBNpY4nF1qNCRd8SJLA: folds 
Bb42QRQMhg5/Y0vHP8/2Xw: raises $0.75 to $1
5LSuZS4qvcUri/Byfkln7w: folds 
HPEB+AtKw1+C/cxU0o1ciw: folds 
xbecloQJYmBOSkzT9lZ+rg: folds 
Uncalled bet ($0.75) returned to Bb42QRQMhg5/Y0vHP8/2Xw
Bb42QRQMhg5/Y0vHP8/2Xw collected $0.60 from pot
*** SUMMARY ***
Total pot $0.60 | Rake $0 
Seat 1: H5Se03ZqSX7tbULXur2MAg folded before Flop (didn't bet)
Seat 2: cpnBzHjFACn5zAY56UIvNA folded before Flop (didn't bet)
Seat 3: DdyXKuBx0HAOC7dWZmGxWg folded before Flop (didn't bet)
Seat 5: +2kMBNpY4nF1qNCRd8SJLA folded before Flop (didn't bet)
Seat 6: Bb42QRQMhg5/Y0vHP8/2Xw collected ($0.60)
Seat 7: 5LSuZS4qvcUri/Byfkln7w (button) folded before Flop (didn't bet)
Seat 8: HPEB+AtKw1+C/cxU0o1ciw (small blind) folded before Flop
Seat 9: xbecloQJYmBOSkzT9lZ+rg (big blind) folded before Flop




PokerStars Game #59941762730:  Hold'em No Limit ($0.10/$0.25) - 2009/07/01 1:45:22 ET
Table '50f2Xa1b1jp6cfdTAgXFIg' 9-max Seat #8 is the button
Seat 1: E0iYnEVO2ho7dH3QcCjw7g ($20 in chips) 
Seat 3: RSojRXQHk0IRANbJYopT9g ($22.40 in chips) 
Seat 4: ghNKXUBl/H+t83JF079ZBA ($28.10 in chips) 
Seat 5: C1w4aCCgQVVSgNijoEahAg ($16.75 in chips) 
Seat 6: tLcDklc2rBORNfixyRfVfw ($25 in chips) 
Seat 7: w1ukf8uPa4+WH561TtVRxA ($25 in chips) 
Seat 8: x+W5+3qsdY4Iszf0hoH+Aw ($14.55 in chips) 
Seat 9: gehe91e0IyVT0QU/XBkEyg ($25 in chips) 
dukepoker05 is disconnected 
gehe91e0IyVT0QU/XBkEyg: posts small blind $0.10
E0iYnEVO2ho7dH3QcCjw7g: posts big blind $0.25
*** HOLE CARDS ***
RSojRXQHk0IRANbJYopT9g: folds 
ghNKXUBl/H+t83JF079ZBA: folds 
C1w4aCCgQVVSgNijoEahAg: folds 
tLcDklc2rBORNfixyRfVfw: raises $0.75 to $1
w1ukf8uPa4+WH561TtVRxA: folds 
x+W5+3qsdY4Iszf0hoH+Aw: folds 
gehe91e0IyVT0QU/XBkEyg: calls $0.90
E0iYnEVO2ho7dH3QcCjw7g: folds 
*** FLOP *** [Td Qs 4d]
gehe91e0IyVT0QU/XBkEyg: checks 
tLcDklc2rBORNfixyRfVfw: bets $1.50
gehe91e0IyVT0QU/XBkEyg: calls $1.50
*** TURN *** [Td Qs 4d] [3h]
gehe91e0IyVT0QU/XBkEyg: checks 
tLcDklc2rBORNfixyRfVfw: bets $3.50
gehe91e0IyVT0QU/XBkEyg: folds 
Uncalled bet ($3.50) returned to tLcDklc2rBORNfixyRfVfw
tLcDklc2rBORNfixyRfVfw collected $5 from pot
tLcDklc2rBORNfixyRfVfw: doesn't show hand 
*** SUMMARY ***
Total pot $5.25 | Rake $0.25 
Board [Td Qs 4d 3h]
Seat 1: E0iYnEVO2ho7dH3QcCjw7g (big blind) folded before Flop
Seat 3: RSojRXQHk0IRANbJYopT9g folded before Flop (didn't bet)
Seat 4: ghNKXUBl/H+t83JF079ZBA folded before Flop (didn't bet)
Seat 5: C1w4aCCgQVVSgNijoEahAg folded before Flop (didn't bet)
Seat 6: tLcDklc2rBORNfixyRfVfw collected ($5)
Seat 7: w1ukf8uPa4+WH561TtVRxA folded before Flop (didn't bet)
Seat 8: x+W5+3qsdY4Iszf0hoH+Aw (button) folded before Flop (didn't bet)
Seat 9: gehe91e0IyVT0QU/XBkEyg (small blind) folded on the Turn




PokerStars Game #59941763362:  Hold'em No Limit ($0.10/$0.25) - 2009/07/01 1:45:23 ET
Table 'bIGKmJgZehWJ+FAo8b85iw' 9-max Seat #2 is the button
Seat 1: yyG4svzOpC1A+sUP/scg6w ($3.20 in chips) 
Seat 2: cCjRCvseA9rZn7Xr+GCCHg ($21.35 in chips) 
Seat 3: /FyMUX+W/tpNFcRWbUTJxQ ($23.60 in chips) 
Seat 4: LGxBRjCRn6KlQ/6B4eoXbA ($38.55 in chips) 
Seat 5: uLP/lYn7oKq9xCChBXsXxw ($25.25 in chips) 
Seat 6: PFNLAvMkr8qKc7xCiH0wTA ($17.85 in chips) 
Seat 8: +2kMBNpY4nF1qNCRd8SJLA ($54.20 in chips) 
Seat 9: aNpwfA31EREwO+ar4XzBCw ($31.75 in chips) 
/FyMUX+W/tpNFcRWbUTJxQ: posts small blind $0.10
LGxBRjCRn6KlQ/6B4eoXbA: posts big blind $0.25
*** HOLE CARDS ***
LGxBRjCRn6KlQ/6B4eoXbA said, "more"
HDDm1BkZtdsRyw2DJdqq6A leaves the table
uLP/lYn7oKq9xCChBXsXxw: calls $0.25
PFNLAvMkr8qKc7xCiH0wTA: raises $0.75 to $1
+2kMBNpY4nF1qNCRd8SJLA: folds 
aNpwfA31EREwO+ar4XzBCw: folds 
yyG4svzOpC1A+sUP/scg6w: folds 
mMd8CDS/but3UC+Zp7Up2w joins the table at seat #7 
cCjRCvseA9rZn7Xr+GCCHg: folds 
/FyMUX+W/tpNFcRWbUTJxQ: folds 
LGxBRjCRn6KlQ/6B4eoXbA: folds 
uLP/lYn7oKq9xCChBXsXxw: folds 
Uncalled bet ($0.75) returned to PFNLAvMkr8qKc7xCiH0wTA
PFNLAvMkr8qKc7xCiH0wTA collected $0.85 from pot
PFNLAvMkr8qKc7xCiH0wTA: doesn't show hand 
*** SUMMARY ***
Total pot $0.85 | Rake $0 
Seat 1: yyG4svzOpC1A+sUP/scg6w folded before Flop (didn't bet)
Seat 2: cCjRCvseA9rZn7Xr+GCCHg (button) folded before Flop (didn't bet)
Seat 3: /FyMUX+W/tpNFcRWbUTJxQ (small blind) folded before Flop
Seat 4: LGxBRjCRn6KlQ/6B4eoXbA (big blind) folded before Flop
Seat 5: uLP/lYn7oKq9xCChBXsXxw folded before Flop
Seat 6: PFNLAvMkr8qKc7xCiH0wTA collected ($0.85)
Seat 8: +2kMBNpY4nF1qNCRd8SJLA folded before Flop (didn't bet)
Seat 9: aNpwfA31EREwO+ar4XzBCw folded before Flop (didn't bet)




PokerStars Game #59941763636:  Hold'em No Limit ($0.10/$0.25) - 2009/07/01 1:45:23 ET
Table 'ouLhepGYovxB2x0QxH7cVg' 9-max Seat #9 is the button
Seat 1: ghNKXUBl/H+t83JF079ZBA ($25.10 in chips) 
Seat 2: r1Z5m4PwSI5ANp7qCE1OJw ($18.85 in chips) 
Seat 3: bXpVeaSTPBFSPJmeXxO7nw ($5.25 in chips) 
Seat 4: a0Sx6GHY7ln2Ns2C97eXeA ($38.10 in chips) 
Seat 5: v60REj6f8jzMYT0VsZvaPQ ($10 in chips) 
Seat 7: JRV2PblFtPFz51l0Fwyz8g ($24.25 in chips) 
Seat 8: tLcDklc2rBORNfixyRfVfw ($25.35 in chips) 
Seat 9: ljemhp25Zg+nlA9DLCIiUw ($25 in chips) 
ghNKXUBl/H+t83JF079ZBA: posts small blind $0.10
r1Z5m4PwSI5ANp7qCE1OJw: posts big blind $0.25
*** HOLE CARDS ***
bXpVeaSTPBFSPJmeXxO7nw: folds 
a0Sx6GHY7ln2Ns2C97eXeA: folds 
v60REj6f8jzMYT0VsZvaPQ: folds 
JRV2PblFtPFz51l0Fwyz8g: folds 
tLcDklc2rBORNfixyRfVfw: folds 
lSeLm4BdnSMLtIli62qjAQ leaves the table
ljemhp25Zg+nlA9DLCIiUw: raises $0.50 to $0.75
ghNKXUBl/H+t83JF079ZBA: folds 
r1Z5m4PwSI5ANp7qCE1OJw: folds 
Uncalled bet ($0.50) returned to ljemhp25Zg+nlA9DLCIiUw
ljemhp25Zg+nlA9DLCIiUw collected $0.60 from pot
ljemhp25Zg+nlA9DLCIiUw: doesn't show hand 
*** SUMMARY ***
Total pot $0.60 | Rake $0 
Seat 1: ghNKXUBl/H+t83JF079ZBA (small blind) folded before Flop
Seat 2: r1Z5m4PwSI5ANp7qCE1OJw (big blind) folded before Flop
Seat 3: bXpVeaSTPBFSPJmeXxO7nw folded before Flop (didn't bet)
Seat 4: a0Sx6GHY7ln2Ns2C97eXeA folded before Flop (didn't bet)
Seat 5: v60REj6f8jzMYT0VsZvaPQ folded before Flop (didn't bet)
Seat 7: JRV2PblFtPFz51l0Fwyz8g folded before Flop (didn't bet)
Seat 8: tLcDklc2rBORNfixyRfVfw folded before Flop (didn't bet)
Seat 9: ljemhp25Zg+nlA9DLCIiUw (button) collected ($0.60)




PokerStars Game #59941763428:  Hold'em No Limit ($0.10/$0.25) - 2009/07/01 1:45:23 ET
Table 'LG9H161ZAHDkOww+ih3Ptg' 6-max Seat #3 is the button
Seat 1: avl8CO/tc0F6eVSiB/KNRA ($24.75 in chips) 
Seat 2: kwsRmpZ1ZaLooISs+zfyKg ($25.70 in chips) 
Seat 3: 5Evvx7UYqXTBuvIc/9s/hA ($15.95 in chips) 
Seat 4: 0C28L4/59aRNtHoBhqTcLg ($60.30 in chips) 
Seat 6: v8m8XHovI5tqEA9mvplDSw ($26.40 in chips) 
0C28L4/59aRNtHoBhqTcLg: posts small blind $0.10
MyPlaySucks: is sitting out 
MyPlaySucks leaves the table
v8m8XHovI5tqEA9mvplDSw: posts big blind $0.25
*** HOLE CARDS ***
avl8CO/tc0F6eVSiB/KNRA: folds 
kwsRmpZ1ZaLooISs+zfyKg: folds 
5Evvx7UYqXTBuvIc/9s/hA: folds 
0C28L4/59aRNtHoBhqTcLg: calls $0.15
v8m8XHovI5tqEA9mvplDSw: checks 
*** FLOP *** [Kc Kd Jh]
0C28L4/59aRNtHoBhqTcLg: checks 
v8m8XHovI5tqEA9mvplDSw: checks 
*** TURN *** [Kc Kd Jh] [4s]
0C28L4/59aRNtHoBhqTcLg: checks 
Nessi BÃ¤r joins the table at seat #5 
v8m8XHovI5tqEA9mvplDSw: checks 
*** RIVER *** [Kc Kd Jh 4s] [7c]
0C28L4/59aRNtHoBhqTcLg: checks 
v8m8XHovI5tqEA9mvplDSw: checks 
*** SHOW DOWN ***
0C28L4/59aRNtHoBhqTcLg: shows [5h 7d] (two pair, Kings and Sevens)
v8m8XHovI5tqEA9mvplDSw: shows [Jd 3c] (two pair, Kings and Jacks)
v8m8XHovI5tqEA9mvplDSw collected $0.50 from pot
*** SUMMARY ***
Total pot $0.50 | Rake $0 
Board [Kc Kd Jh 4s 7c]
Seat 1: avl8CO/tc0F6eVSiB/KNRA folded before Flop (didn't bet)
Seat 2: kwsRmpZ1ZaLooISs+zfyKg folded before Flop (didn't bet)
Seat 3: 5Evvx7UYqXTBuvIc/9s/hA (button) folded before Flop (didn't bet)
Seat 4: 0C28L4/59aRNtHoBhqTcLg (small blind) showed [5h 7d] and lost with two pair, Kings and Sevens
Seat 6: v8m8XHovI5tqEA9mvplDSw (big blind) showed [Jd 3c] and won ($0.50) with two pair, Kings and Jacks




PokerStars Game #59941763518:  Hold'em No Limit ($0.10/$0.25) - 2009/07/01 1:45:23 ET
Table '0mmHveGuaIfIMQlNE1eqMg' 9-max Seat #7 is the button
Seat 1: ydoFOVgzvZv9ZhuWu9rXAw ($5 in chips) 
Seat 2: rQhYIYXSyH/IivYM1dlV5A ($68.85 in chips) 
Seat 3: ghNKXUBl/H+t83JF079ZBA ($25 in chips) 
Seat 4: DnDcAdn9P0zGovMERigpFA ($36.10 in chips) 
Seat 5: Pt637jKksB5MzP0UNJAAkw ($9.20 in chips) 
Seat 6: 6RiVTYll/5D8zICp0MRpKw ($23.70 in chips) 
Seat 7: 5n7e7I+px7c6CQmLpPbtsg ($5.40 in chips) 
Seat 8: 0XACOSNrAWmqNv9k1nF8rw ($14.75 in chips) 
Seat 9: UNw/UrAelsQeSS17Rro/BA ($10.90 in chips) 
0XACOSNrAWmqNv9k1nF8rw: posts small blind $0.10
UNw/UrAelsQeSS17Rro/BA: posts big blind $0.25
*** HOLE CARDS ***
ydoFOVgzvZv9ZhuWu9rXAw: folds 
rQhYIYXSyH/IivYM1dlV5A: folds 
ghNKXUBl/H+t83JF079ZBA: folds 
DnDcAdn9P0zGovMERigpFA: folds 
Pt637jKksB5MzP0UNJAAkw: folds 
6RiVTYll/5D8zICp0MRpKw: folds 
5n7e7I+px7c6CQmLpPbtsg: raises $0.75 to $1
0XACOSNrAWmqNv9k1nF8rw: folds 
UNw/UrAelsQeSS17Rro/BA: folds 
Uncalled bet ($0.75) returned to 5n7e7I+px7c6CQmLpPbtsg
5n7e7I+px7c6CQmLpPbtsg collected $0.60 from pot
5n7e7I+px7c6CQmLpPbtsg: doesn't show hand 
*** SUMMARY ***
Total pot $0.60 | Rake $0 
Seat 1: ydoFOVgzvZv9ZhuWu9rXAw folded before Flop (didn't bet)
Seat 2: rQhYIYXSyH/IivYM1dlV5A folded before Flop (didn't bet)
Seat 3: ghNKXUBl/H+t83JF079ZBA folded before Flop (didn't bet)
Seat 4: DnDcAdn9P0zGovMERigpFA folded before Flop (didn't bet)
Seat 5: Pt637jKksB5MzP0UNJAAkw folded before Flop (didn't bet)
Seat 6: 6RiVTYll/5D8zICp0MRpKw folded before Flop (didn't bet)
Seat 7: 5n7e7I+px7c6CQmLpPbtsg (button) collected ($0.60)
Seat 8: 0XACOSNrAWmqNv9k1nF8rw (small blind) folded before Flop
Seat 9: UNw/UrAelsQeSS17Rro/BA (big blind) folded before Flop




PokerStars Game #59941763396:  Hold'em No Limit ($0.10/$0.25) - 2009/07/01 1:45:23 ET
Table 'U0hCzoS0KCJL+eoE054K4Q' 9-max Seat #1 is the button
Seat 1: XVEauYThJRhSTUAMxB/2ow ($38.10 in chips) 
Seat 2: MG90wfSJZnOejs/KD3vlQQ ($25 in chips) 
Seat 3: 8Cp1H3sSs8+jTTwLfeYKcw ($27.20 in chips) 
Seat 4: Bb42QRQMhg5/Y0vHP8/2Xw ($25 in chips) 
Seat 5: zgi+EUykT/pZQpoUG6+oEg ($6 in chips) 
Seat 6: V6p0jQ/RhUsqpHLmXvEX4Q ($11.90 in chips) 
Seat 7: uetHVityNsFnyX2bBnKe2A ($18.35 in chips) 
Seat 8: K0b5wNInj6hUGRr6yzKFtw ($27.45 in chips) 
Seat 9: wGigCmBR/9XWkPpvYos3aQ ($34.80 in chips) 
MG90wfSJZnOejs/KD3vlQQ: posts small blind $0.10
8Cp1H3sSs8+jTTwLfeYKcw: posts big blind $0.25
*** HOLE CARDS ***
Bb42QRQMhg5/Y0vHP8/2Xw: folds 
zgi+EUykT/pZQpoUG6+oEg: folds 
V6p0jQ/RhUsqpHLmXvEX4Q: folds 
uetHVityNsFnyX2bBnKe2A: folds 
K0b5wNInj6hUGRr6yzKFtw: folds 
wGigCmBR/9XWkPpvYos3aQ: folds 
XVEauYThJRhSTUAMxB/2ow: folds 
MG90wfSJZnOejs/KD3vlQQ: raises $0.50 to $0.75
8Cp1H3sSs8+jTTwLfeYKcw: calls $0.50
*** FLOP *** [Jd As 3c]
MG90wfSJZnOejs/KD3vlQQ: bets $1.40
8Cp1H3sSs8+jTTwLfeYKcw: folds 
Uncalled bet ($1.40) returned to MG90wfSJZnOejs/KD3vlQQ
MG90wfSJZnOejs/KD3vlQQ collected $1.45 from pot
MG90wfSJZnOejs/KD3vlQQ: doesn't show hand 
*** SUMMARY ***
Total pot $1.50 | Rake $0.05 
Board [Jd As 3c]
Seat 1: XVEauYThJRhSTUAMxB/2ow (button) folded before Flop (didn't bet)
Seat 2: MG90wfSJZnOejs/KD3vlQQ (small blind) collected ($1.45)
Seat 3: 8Cp1H3sSs8+jTTwLfeYKcw (big blind) folded on the Flop
Seat 4: Bb42QRQMhg5/Y0vHP8/2Xw folded before Flop (didn't bet)
Seat 5: zgi+EUykT/pZQpoUG6+oEg folded before Flop (didn't bet)
Seat 6: V6p0jQ/RhUsqpHLmXvEX4Q folded before Flop (didn't bet)
Seat 7: uetHVityNsFnyX2bBnKe2A folded before Flop (didn't bet)
Seat 8: K0b5wNInj6hUGRr6yzKFtw folded before Flop (didn't bet)
Seat 9: wGigCmBR/9XWkPpvYos3aQ folded before Flop (didn't bet)




PokerStars Game #59941763780:  Hold'em No Limit ($0.10/$0.25) - 2009/07/01 1:45:23 ET
Table 'dZNBGqFYSwfOVZvDJ4VjIQ' 6-max Seat #2 is the button
Seat 1: v+QfkGiuj9bgtuNoVnDO8w ($37.45 in chips) 
Seat 2: 3zD3qLXT1bEffAoWGnc7wg ($25 in chips) 
Seat 3: kyRaCIljYA6l33lSKQfNsg ($28.05 in chips) 
Seat 4: mFv3iBCtrw9XfCDRB0d46Q ($6.15 in chips) 
Seat 5: +ZlnqPoP3Hg4BIUxDfKd/A ($33.60 in chips) 
Seat 6: ypmjhffk/YHGc51wgVXUTw ($29.40 in chips) 
kyRaCIljYA6l33lSKQfNsg: posts small blind $0.10
mFv3iBCtrw9XfCDRB0d46Q: posts big blind $0.25
*** HOLE CARDS ***
+ZlnqPoP3Hg4BIUxDfKd/A: raises $0.75 to $1
ypmjhffk/YHGc51wgVXUTw: folds 
v+QfkGiuj9bgtuNoVnDO8w: folds 
3zD3qLXT1bEffAoWGnc7wg: raises $1 to $2
kyRaCIljYA6l33lSKQfNsg: folds 
mFv3iBCtrw9XfCDRB0d46Q: folds 
+ZlnqPoP3Hg4BIUxDfKd/A: calls $1
*** FLOP *** [Ac 6s 5d]
+ZlnqPoP3Hg4BIUxDfKd/A: checks 
3zD3qLXT1bEffAoWGnc7wg: checks 
*** TURN *** [Ac 6s 5d] [6c]
+ZlnqPoP3Hg4BIUxDfKd/A: checks 
3zD3qLXT1bEffAoWGnc7wg: checks 
*** RIVER *** [Ac 6s 5d 6c] [Jd]
+ZlnqPoP3Hg4BIUxDfKd/A: bets $2
3zD3qLXT1bEffAoWGnc7wg: raises $3.25 to $5.25
+ZlnqPoP3Hg4BIUxDfKd/A: folds 
Uncalled bet ($3.25) returned to 3zD3qLXT1bEffAoWGnc7wg
3zD3qLXT1bEffAoWGnc7wg collected $7.95 from pot
3zD3qLXT1bEffAoWGnc7wg: doesn't show hand 
*** SUMMARY ***
Total pot $8.35 | Rake $0.40 
Board [Ac 6s 5d 6c Jd]
Seat 1: v+QfkGiuj9bgtuNoVnDO8w folded before Flop (didn't bet)
Seat 2: 3zD3qLXT1bEffAoWGnc7wg (button) collected ($7.95)
Seat 3: kyRaCIljYA6l33lSKQfNsg (small blind) folded before Flop
Seat 4: mFv3iBCtrw9XfCDRB0d46Q (big blind) folded before Flop
Seat 5: +ZlnqPoP3Hg4BIUxDfKd/A folded on the River
Seat 6: ypmjhffk/YHGc51wgVXUTw folded before Flop (didn't bet)




PokerStars Game #59941764280:  Hold'em No Limit ($0.10/$0.25) - 2009/07/01 1:45:24 ET
Table '7/qMNloI0nSXWiX5Y1watA' 9-max Seat #9 is the button
Seat 1: /LyhaB3V6jkgOfXORidqRQ ($6.85 in chips) 
Seat 2: wGigCmBR/9XWkPpvYos3aQ ($26.20 in chips) 
Seat 3: W2YYHvqjaEpRrO7stZkClQ ($4.35 in chips) 
Seat 4: K0LdhPeU31rviEPo6Sv3TA ($8.65 in chips) 
Seat 6: Y3DZ6qQlLeBhixDj4M9vmg ($17.60 in chips) 
Seat 8: ljemhp25Zg+nlA9DLCIiUw ($24.55 in chips) 
Seat 9: dmYlc+1cjwZMJ7wV+Z0rRg ($26 in chips) 
/LyhaB3V6jkgOfXORidqRQ: posts small blind $0.10
wGigCmBR/9XWkPpvYos3aQ: posts big blind $0.25
*** HOLE CARDS ***
W2YYHvqjaEpRrO7stZkClQ: folds 
K0LdhPeU31rviEPo6Sv3TA: folds 
Y3DZ6qQlLeBhixDj4M9vmg: calls $0.25
ljemhp25Zg+nlA9DLCIiUw: raises $0.75 to $1
dmYlc+1cjwZMJ7wV+Z0rRg: folds 
/LyhaB3V6jkgOfXORidqRQ: folds 
wGigCmBR/9XWkPpvYos3aQ: folds 
Y3DZ6qQlLeBhixDj4M9vmg: folds 
Uncalled bet ($0.75) returned to ljemhp25Zg+nlA9DLCIiUw
ljemhp25Zg+nlA9DLCIiUw collected $0.85 from pot
ljemhp25Zg+nlA9DLCIiUw: doesn't show hand 
*** SUMMARY ***
Total pot $0.85 | Rake $0 
Seat 1: /LyhaB3V6jkgOfXORidqRQ (small blind) folded before Flop
Seat 2: wGigCmBR/9XWkPpvYos3aQ (big blind) folded before Flop
Seat 3: W2YYHvqjaEpRrO7stZkClQ folded before Flop (didn't bet)
Seat 4: K0LdhPeU31rviEPo6Sv3TA folded before Flop (didn't bet)
Seat 6: Y3DZ6qQlLeBhixDj4M9vmg folded before Flop
Seat 8: ljemhp25Zg+nlA9DLCIiUw collected ($0.85)
Seat 9: dmYlc+1cjwZMJ7wV+Z0rRg (button) folded before Flop (didn't bet)




PokerStars Game #59941764246:  Hold'em No Limit ($0.10/$0.25) - 2009/07/01 1:45:24 ET
Table 'Yb2CyZosw7N3yRRVLhKnKg' 9-max Seat #2 is the button
Seat 1: c/9X4zftzphFxYtxp5kp9w ($13.80 in chips) 
Seat 2: dtZ84flFEi4Q+SGrHMJRDQ ($26.90 in chips) 
Seat 3: wUanlt/hhheMA+jOrJk2Tg ($9.75 in chips) 
Seat 4: FG10kumpruEJ3PQJ7oGglQ ($14.05 in chips) 
Seat 5: T5Hk9oiIr+JDDMnEqwFCrw ($2.25 in chips) 
Seat 6: CgIo2ItZqi4o3ayVG6HanQ ($43.95 in chips) 
Seat 7: ljemhp25Zg+nlA9DLCIiUw ($26.10 in chips) 
Seat 8: HxDF4QSxC4z39D7teZpprQ ($10.75 in chips) 
Seat 9: 6DVf3fwEGECnjQ4Yp9AsFw ($15.50 in chips) 
wUanlt/hhheMA+jOrJk2Tg: posts small blind $0.10
FG10kumpruEJ3PQJ7oGglQ: posts big blind $0.25
*** HOLE CARDS ***
T5Hk9oiIr+JDDMnEqwFCrw: folds 
CgIo2ItZqi4o3ayVG6HanQ: folds 
ljemhp25Zg+nlA9DLCIiUw: folds 
HxDF4QSxC4z39D7teZpprQ: folds 
6DVf3fwEGECnjQ4Yp9AsFw: raises $0.50 to $0.75
c/9X4zftzphFxYtxp5kp9w: folds 
dtZ84flFEi4Q+SGrHMJRDQ: calls $0.75
wUanlt/hhheMA+jOrJk2Tg: folds 
FG10kumpruEJ3PQJ7oGglQ: folds 
*** FLOP *** [2c 9h Ks]
6DVf3fwEGECnjQ4Yp9AsFw: bets $1.25
dtZ84flFEi4Q+SGrHMJRDQ: folds 
Uncalled bet ($1.25) returned to 6DVf3fwEGECnjQ4Yp9AsFw
6DVf3fwEGECnjQ4Yp9AsFw collected $1.80 from pot
6DVf3fwEGECnjQ4Yp9AsFw: doesn't show hand 
*** SUMMARY ***
Total pot $1.85 | Rake $0.05 
Board [2c 9h Ks]
Seat 1: c/9X4zftzphFxYtxp5kp9w folded before Flop (didn't bet)
Seat 2: dtZ84flFEi4Q+SGrHMJRDQ (button) folded on the Flop
Seat 3: wUanlt/hhheMA+jOrJk2Tg (small blind) folded before Flop
Seat 4: FG10kumpruEJ3PQJ7oGglQ (big blind) folded before Flop
Seat 5: T5Hk9oiIr+JDDMnEqwFCrw folded before Flop (didn't bet)
Seat 6: CgIo2ItZqi4o3ayVG6HanQ folded before Flop (didn't bet)
Seat 7: ljemhp25Zg+nlA9DLCIiUw folded before Flop (didn't bet)
Seat 8: HxDF4QSxC4z39D7teZpprQ folded before Flop (didn't bet)
Seat 9: 6DVf3fwEGECnjQ4Yp9AsFw collected ($1.80)




PokerStars Game #59941764324:  Hold'em No Limit ($0.10/$0.25) - 2009/07/01 1:45:24 ET
Table 'IfRHUn9gQQA9I/Z4tn+BoA' 9-max Seat #4 is the button
Seat 1: imHPFFqvfHGzsBBWeGuy4w ($24.35 in chips) 
Seat 2: VWUWpMLMj/Q1jRVpF7Aohw ($16.95 in chips) 
Seat 3: ModuIAhh03puxW6XFxQ3Nw ($11.15 in chips) 
Seat 4: QEbIGci+itdw+re8RM5fZA ($33.55 in chips) 
Seat 5: DdPXdieucQ+n99u1n3A+rQ ($4.75 in chips) 
Seat 6: UOjoGGQ58/uDS7V0xkjOrQ ($16.95 in chips) 
Seat 7: YzqSxP03XxZPbgPifgt69g ($29.10 in chips) 
Seat 8: cZ99hugmLBj9KhTlc8nCSw ($27.75 in chips) 
Seat 9: 7cv+9Zc9HIQHNvYsMfV3uA ($47.75 in chips) 
DdPXdieucQ+n99u1n3A+rQ: posts small blind $0.10
UOjoGGQ58/uDS7V0xkjOrQ: posts big blind $0.25
*** HOLE CARDS ***
YzqSxP03XxZPbgPifgt69g: folds 
cZ99hugmLBj9KhTlc8nCSw: raises $0.50 to $0.75
7cv+9Zc9HIQHNvYsMfV3uA: folds 
imHPFFqvfHGzsBBWeGuy4w: folds 
VWUWpMLMj/Q1jRVpF7Aohw: folds 
ModuIAhh03puxW6XFxQ3Nw: folds 
QEbIGci+itdw+re8RM5fZA: folds 
DdPXdieucQ+n99u1n3A+rQ: folds 
UOjoGGQ58/uDS7V0xkjOrQ: folds 
Uncalled bet ($0.50) returned to cZ99hugmLBj9KhTlc8nCSw
cZ99hugmLBj9KhTlc8nCSw collected $0.60 from pot
*** SUMMARY ***
Total pot $0.60 | Rake $0 
Seat 1: imHPFFqvfHGzsBBWeGuy4w folded before Flop (didn't bet)
Seat 2: VWUWpMLMj/Q1jRVpF7Aohw folded before Flop (didn't bet)
Seat 3: ModuIAhh03puxW6XFxQ3Nw folded before Flop (didn't bet)
Seat 4: QEbIGci+itdw+re8RM5fZA (button) folded before Flop (didn't bet)
Seat 5: DdPXdieucQ+n99u1n3A+rQ (small blind) folded before Flop
Seat 6: UOjoGGQ58/uDS7V0xkjOrQ (big blind) folded before Flop
Seat 7: YzqSxP03XxZPbgPifgt69g folded before Flop (didn't bet)
Seat 8: cZ99hugmLBj9KhTlc8nCSw collected ($0.60)
Seat 9: 7cv+9Zc9HIQHNvYsMfV3uA folded before Flop (didn't bet)




PokerStars Game #59941764274:  Hold'em No Limit ($0.10/$0.25) - 2009/07/01 1:45:24 ET
Table '+68ihX5Br1xgGorX6zsCBg' 9-max Seat #1 is the button
Seat 1: IFB2mhulUVYIbb+KWwDC9w ($3.95 in chips) 
Seat 2: TeAfhXG1R60d8yPEHN3JiA ($28.90 in chips) 
Seat 3: PdIasPkzm2sqZnN41ZRXOg ($5 in chips) 
Seat 4: Oi0EiPIjriUb/6zT65YeWA ($26.95 in chips) 
Seat 5: ghNKXUBl/H+t83JF079ZBA ($29 in chips) 
Seat 6: X78b5v/uhqeXXoAijbw/yg ($26.40 in chips) 
Seat 7: V6p0jQ/RhUsqpHLmXvEX4Q ($14.35 in chips) 
Seat 8: Ut3g/kEEdCCbe/gbWrHnDg ($6.80 in chips) 
Seat 9: DiSvPC2iudwL5j9u6Huyww ($32.75 in chips) 
TeAfhXG1R60d8yPEHN3JiA: posts small blind $0.10
PdIasPkzm2sqZnN41ZRXOg: posts big blind $0.25
*** HOLE CARDS ***
Oi0EiPIjriUb/6zT65YeWA: folds 
ghNKXUBl/H+t83JF079ZBA: folds 
X78b5v/uhqeXXoAijbw/yg: folds 
V6p0jQ/RhUsqpHLmXvEX4Q: raises $0.75 to $1
Ut3g/kEEdCCbe/gbWrHnDg: calls $1
DiSvPC2iudwL5j9u6Huyww: folds 
IFB2mhulUVYIbb+KWwDC9w: folds 
TeAfhXG1R60d8yPEHN3JiA: calls $0.90
PdIasPkzm2sqZnN41ZRXOg: folds 
*** FLOP *** [2c Jc Ah]
TeAfhXG1R60d8yPEHN3JiA: checks 
V6p0jQ/RhUsqpHLmXvEX4Q: checks 
Ut3g/kEEdCCbe/gbWrHnDg: checks 
*** TURN *** [2c Jc Ah] [8h]
TeAfhXG1R60d8yPEHN3JiA: checks 
V6p0jQ/RhUsqpHLmXvEX4Q: checks 
Ut3g/kEEdCCbe/gbWrHnDg: checks 
*** RIVER *** [2c Jc Ah 8h] [2d]
TeAfhXG1R60d8yPEHN3JiA: checks 
V6p0jQ/RhUsqpHLmXvEX4Q: checks 
Ut3g/kEEdCCbe/gbWrHnDg: checks 
*** SHOW DOWN ***
TeAfhXG1R60d8yPEHN3JiA: shows [9d 3d] (a pair of Deuces)
V6p0jQ/RhUsqpHLmXvEX4Q: shows [Tc Ts] (two pair, Tens and Deuces)
Ut3g/kEEdCCbe/gbWrHnDg: mucks hand 
Ut3g/kEEdCCbe/gbWrHnDg is sitting out
V6p0jQ/RhUsqpHLmXvEX4Q collected $3.10 from pot
*** SUMMARY ***
Total pot $3.25 | Rake $0.15 
Board [2c Jc Ah 8h 2d]
Seat 1: IFB2mhulUVYIbb+KWwDC9w (button) folded before Flop (didn't bet)
Seat 2: TeAfhXG1R60d8yPEHN3JiA (small blind) showed [9d 3d] and lost with a pair of Deuces
Seat 3: PdIasPkzm2sqZnN41ZRXOg (big blind) folded before Flop
Seat 4: Oi0EiPIjriUb/6zT65YeWA folded before Flop (didn't bet)
Seat 5: ghNKXUBl/H+t83JF079ZBA folded before Flop (didn't bet)
Seat 6: X78b5v/uhqeXXoAijbw/yg folded before Flop (didn't bet)
Seat 7: V6p0jQ/RhUsqpHLmXvEX4Q showed [Tc Ts] and won ($3.10) with two pair, Tens and Deuces
Seat 8: Ut3g/kEEdCCbe/gbWrHnDg mucked
Seat 9: DiSvPC2iudwL5j9u6Huyww folded before Flop (didn't bet)




PokerStars Game #59941764088:  Hold'em No Limit ($0.10/$0.25) - 2009/07/01 1:45:24 ET
Table 'luMgmRPIo47e7iXDlheIwA' 6-max Seat #4 is the button
Seat 1: EQ3WxdGe/KZrM6Lx4T02sg ($39.60 in chips) 
Seat 2: NhUN/JpAprdJeamFBgJH1w ($25 in chips) 
Seat 4: xrf8tAXKQHG99HixCot1Iw ($25 in chips) 
Seat 5: cWc85bEzdRzpUMhRKm8pwQ ($43.75 in chips) 
Seat 6: qGHGf/553gQnDoklMRe3tg ($24.90 in chips) 
cWc85bEzdRzpUMhRKm8pwQ: posts small blind $0.10
qGHGf/553gQnDoklMRe3tg: posts big blind $0.25
*** HOLE CARDS ***
W6Y6au0wf7gRAlqJYgOezw leaves the table
EQ3WxdGe/KZrM6Lx4T02sg: calls $0.25
NhUN/JpAprdJeamFBgJH1w: folds 
xrf8tAXKQHG99HixCot1Iw: raises $0.75 to $1
cWc85bEzdRzpUMhRKm8pwQ: folds 
w43JQj2oYPpKQVG4Yzlq1w joins the table at seat #3 
qGHGf/553gQnDoklMRe3tg: folds 
EQ3WxdGe/KZrM6Lx4T02sg: calls $0.75
*** FLOP *** [Jh Ah Ad]
EQ3WxdGe/KZrM6Lx4T02sg: checks 
xrf8tAXKQHG99HixCot1Iw: bets $1.25
EQ3WxdGe/KZrM6Lx4T02sg: folds 
Uncalled bet ($1.25) returned to xrf8tAXKQHG99HixCot1Iw
xrf8tAXKQHG99HixCot1Iw collected $2.25 from pot
xrf8tAXKQHG99HixCot1Iw: doesn't show hand 
*** SUMMARY ***
Total pot $2.35 | Rake $0.10 
Board [Jh Ah Ad]
Seat 1: EQ3WxdGe/KZrM6Lx4T02sg folded on the Flop
Seat 2: NhUN/JpAprdJeamFBgJH1w folded before Flop (didn't bet)
Seat 4: xrf8tAXKQHG99HixCot1Iw (button) collected ($2.25)
Seat 5: cWc85bEzdRzpUMhRKm8pwQ (small blind) folded before Flop
Seat 6: qGHGf/553gQnDoklMRe3tg (big blind) folded before Flop




PokerStars Game #59941763916:  Hold'em No Limit ($0.10/$0.25) - 2009/07/01 1:45:24 ET
Table 'IIO2q2znuuAXmiZ2qFTcmg' 6-max Seat #6 is the button
Seat 2: cS21pIxRHx5Gt42o7hPZzw ($24.55 in chips) 
Seat 3: L3/N/gliETan8N5Gim5h4Q ($25.35 in chips) 
Seat 4: tSR4329m40dZsN7YOpI9Kw ($56.50 in chips) 
Seat 5: 9U3ZKjCsarN0DjR6mSE8Ug ($15.50 in chips) 
Seat 6: aogAb4Eienxztk8p2v9VVw ($37.10 in chips) 
cS21pIxRHx5Gt42o7hPZzw: posts small blind $0.10
L3/N/gliETan8N5Gim5h4Q: posts big blind $0.25
*** HOLE CARDS ***
tSR4329m40dZsN7YOpI9Kw: folds 
9U3ZKjCsarN0DjR6mSE8Ug: folds 
aogAb4Eienxztk8p2v9VVw: raises $0.50 to $0.75
cS21pIxRHx5Gt42o7hPZzw: folds 
L3/N/gliETan8N5Gim5h4Q: calls $0.50
*** FLOP *** [Js 9c Ac]
L3/N/gliETan8N5Gim5h4Q: checks 
aogAb4Eienxztk8p2v9VVw: bets $1
L3/N/gliETan8N5Gim5h4Q: folds 
Uncalled bet ($1) returned to aogAb4Eienxztk8p2v9VVw
aogAb4Eienxztk8p2v9VVw collected $1.55 from pot
aogAb4Eienxztk8p2v9VVw: doesn't show hand 
*** SUMMARY ***
Total pot $1.60 | Rake $0.05 
Board [Js 9c Ac]
Seat 2: cS21pIxRHx5Gt42o7hPZzw (small blind) folded before Flop
Seat 3: L3/N/gliETan8N5Gim5h4Q (big blind) folded on the Flop
Seat 4: tSR4329m40dZsN7YOpI9Kw folded before Flop (didn't bet)
Seat 5: 9U3ZKjCsarN0DjR6mSE8Ug folded before Flop (didn't bet)
Seat 6: aogAb4Eienxztk8p2v9VVw (button) collected ($1.55)




PokerStars Game #59941764340:  Hold'em No Limit ($0.10/$0.25) - 2009/07/01 1:45:25 ET
Table 'sm5gqEvXgLbkkE4dryW/5g' 6-max Seat #3 is the button
Seat 1: v8m8XHovI5tqEA9mvplDSw ($40.20 in chips) 
Seat 2: 5xs5/u2z1CO9zkRvH72MQg ($18.90 in chips) 
Seat 3: UT5XpwOH1ipkOF7n1MqDJA ($22.15 in chips) 
Seat 4: cWc85bEzdRzpUMhRKm8pwQ ($26.25 in chips) 
Seat 6: aogAb4Eienxztk8p2v9VVw ($20.40 in chips) 
cWc85bEzdRzpUMhRKm8pwQ: posts small blind $0.10
aogAb4Eienxztk8p2v9VVw: posts big blind $0.25
*** HOLE CARDS ***
v8m8XHovI5tqEA9mvplDSw: folds 
5xs5/u2z1CO9zkRvH72MQg: calls $0.25
UT5XpwOH1ipkOF7n1MqDJA: folds 
cWc85bEzdRzpUMhRKm8pwQ: folds 
aogAb4Eienxztk8p2v9VVw: checks 
*** FLOP *** [9s Ad Jc]
aogAb4Eienxztk8p2v9VVw: checks 
5xs5/u2z1CO9zkRvH72MQg: checks 
*** TURN *** [9s Ad Jc] [4d]
aogAb4Eienxztk8p2v9VVw: checks 
5xs5/u2z1CO9zkRvH72MQg: checks 
*** RIVER *** [9s Ad Jc 4d] [8s]
aogAb4Eienxztk8p2v9VVw: checks 
5xs5/u2z1CO9zkRvH72MQg: checks 
*** SHOW DOWN ***
aogAb4Eienxztk8p2v9VVw: shows [8d 5d] (a pair of Eights)
5xs5/u2z1CO9zkRvH72MQg: mucks hand 
aogAb4Eienxztk8p2v9VVw collected $0.60 from pot
*** SUMMARY ***
Total pot $0.60 | Rake $0 
Board [9s Ad Jc 4d 8s]
Seat 1: v8m8XHovI5tqEA9mvplDSw folded before Flop (didn't bet)
Seat 2: 5xs5/u2z1CO9zkRvH72MQg mucked
Seat 3: UT5XpwOH1ipkOF7n1MqDJA (button) folded before Flop (didn't bet)
Seat 4: cWc85bEzdRzpUMhRKm8pwQ (small blind) folded before Flop
Seat 6: aogAb4Eienxztk8p2v9VVw (big blind) showed [8d 5d] and won ($0.60) with a pair of Eights




PokerStars Game #59941764674:  Hold'em No Limit ($0.10/$0.25) - 2009/07/01 1:45:25 ET
Table 'emoxgHTxg9Uqeu06oLzLyg' 6-max Seat #4 is the button
Seat 2: wIFhgE1PVdX6Xf6aVlSTPg ($28.55 in chips) 
Seat 3: uD5epdBxuyc30pF1dO958Q ($9.35 in chips) 
Seat 4: 3VAbqAWh8ncE2SJOYIx2ZQ ($10.75 in chips) 
Seat 5: OIjOiBfQstWrK/RuXx7zcw ($4.55 in chips) 
Seat 6: iHZrkhpIO/3+tKuAoPx8HQ ($2.65 in chips) 
OIjOiBfQstWrK/RuXx7zcw: posts small blind $0.10
iHZrkhpIO/3+tKuAoPx8HQ: posts big blind $0.25
epAUIB7h2FJXzUPRIvSkRA: sits out 
*** HOLE CARDS ***
wIFhgE1PVdX6Xf6aVlSTPg: folds 
uD5epdBxuyc30pF1dO958Q: folds 
3VAbqAWh8ncE2SJOYIx2ZQ: calls $0.25
OIjOiBfQstWrK/RuXx7zcw: calls $0.15
iHZrkhpIO/3+tKuAoPx8HQ: checks 
*** FLOP *** [4d Kd 9s]
OIjOiBfQstWrK/RuXx7zcw: checks 
iHZrkhpIO/3+tKuAoPx8HQ: checks 
3VAbqAWh8ncE2SJOYIx2ZQ: bets $0.75
OIjOiBfQstWrK/RuXx7zcw: folds 
iHZrkhpIO/3+tKuAoPx8HQ: folds 
Uncalled bet ($0.75) returned to 3VAbqAWh8ncE2SJOYIx2ZQ
3VAbqAWh8ncE2SJOYIx2ZQ collected $0.75 from pot
*** SUMMARY ***
Total pot $0.75 | Rake $0 
Board [4d Kd 9s]
Seat 2: wIFhgE1PVdX6Xf6aVlSTPg folded before Flop (didn't bet)
Seat 3: uD5epdBxuyc30pF1dO958Q folded before Flop (didn't bet)
Seat 4: 3VAbqAWh8ncE2SJOYIx2ZQ (button) collected ($0.75)
Seat 5: OIjOiBfQstWrK/RuXx7zcw (small blind) folded on the Flop
Seat 6: iHZrkhpIO/3+tKuAoPx8HQ (big blind) folded on the Flop




PokerStars Game #59941764446:  Hold'em No Limit ($0.10/$0.25) - 2009/07/01 1:45:25 ET
Table 'IRgQPZVA4+IaZZIQshgwyg' 6-max Seat #1 is the button
Seat 1: cezpHJ8FB07dj0xG+LhOvw ($27.55 in chips) 
Seat 2: lquriepNQBhDV5P1SWHhnA ($25.10 in chips) 
Seat 3: DihMHaz4WNETH1bPDe13kA ($27.45 in chips) 
Seat 4: DE9hRlt14g+JdsRQ4wT7hg ($27.15 in chips) 
Seat 5: PbMzPZIePKifKQZfKDkbIw ($37.10 in chips) 
lquriepNQBhDV5P1SWHhnA: posts small blind $0.10
DihMHaz4WNETH1bPDe13kA: posts big blind $0.25
*** HOLE CARDS ***
DE9hRlt14g+JdsRQ4wT7hg: folds 
PbMzPZIePKifKQZfKDkbIw: folds 
cezpHJ8FB07dj0xG+LhOvw: folds 
lquriepNQBhDV5P1SWHhnA: folds 
Uncalled bet ($0.15) returned to DihMHaz4WNETH1bPDe13kA
DihMHaz4WNETH1bPDe13kA collected $0.20 from pot
*** SUMMARY ***
Total pot $0.20 | Rake $0 
Seat 1: cezpHJ8FB07dj0xG+LhOvw (button) folded before Flop (didn't bet)
Seat 2: lquriepNQBhDV5P1SWHhnA (small blind) folded before Flop
Seat 3: DihMHaz4WNETH1bPDe13kA (big blind) collected ($0.20)
Seat 4: DE9hRlt14g+JdsRQ4wT7hg folded before Flop (didn't bet)
Seat 5: PbMzPZIePKifKQZfKDkbIw folded before Flop (didn't bet)




PokerStars Game #59941764502:  Hold'em No Limit ($0.10/$0.25) - 2009/07/01 1:45:25 ET
Table 'nIRjSqm6RYUWJlyW2loYKA' 6-max Seat #3 is the button
Seat 2: NndRCAk4vU5JGDhTyy5LZg ($15.30 in chips) 
Seat 3: HbKNMWUwblC7HKtRCUhBWw ($20.50 in chips) 
Seat 4: /ZSSWvl8im2y38j1uEUAGA ($14.75 in chips) 
Seat 5: df01R5ThvHspD8FgKmaDvQ ($24.75 in chips) 
Seat 6: OIjOiBfQstWrK/RuXx7zcw ($5.95 in chips) 
/ZSSWvl8im2y38j1uEUAGA: posts small blind $0.10
df01R5ThvHspD8FgKmaDvQ: posts big blind $0.25
*** HOLE CARDS ***
OIjOiBfQstWrK/RuXx7zcw: folds 
NndRCAk4vU5JGDhTyy5LZg: folds 
HbKNMWUwblC7HKtRCUhBWw: folds 
tÃ¸ffe35 leaves the table
/ZSSWvl8im2y38j1uEUAGA: calls $0.15
df01R5ThvHspD8FgKmaDvQ: checks 
*** FLOP *** [Kd 3d Th]
/ZSSWvl8im2y38j1uEUAGA: checks 
w43JQj2oYPpKQVG4Yzlq1w joins the table at seat #1 
df01R5ThvHspD8FgKmaDvQ: checks 
*** TURN *** [Kd 3d Th] [3h]
/ZSSWvl8im2y38j1uEUAGA: checks 
df01R5ThvHspD8FgKmaDvQ: checks 
*** RIVER *** [Kd 3d Th 3h] [Ts]
/ZSSWvl8im2y38j1uEUAGA: bets $0.50
df01R5ThvHspD8FgKmaDvQ: folds 
Uncalled bet ($0.50) returned to /ZSSWvl8im2y38j1uEUAGA
/ZSSWvl8im2y38j1uEUAGA collected $0.50 from pot
*** SUMMARY ***
Total pot $0.50 | Rake $0 
Board [Kd 3d Th 3h Ts]
Seat 2: NndRCAk4vU5JGDhTyy5LZg folded before Flop (didn't bet)
Seat 3: HbKNMWUwblC7HKtRCUhBWw (button) folded before Flop (didn't bet)
Seat 4: /ZSSWvl8im2y38j1uEUAGA (small blind) collected ($0.50)
Seat 5: df01R5ThvHspD8FgKmaDvQ (big blind) folded on the River
Seat 6: OIjOiBfQstWrK/RuXx7zcw folded before Flop (didn't bet)




PokerStars Game #59941764468:  Hold'em No Limit ($0.10/$0.25) - 2009/07/01 1:45:25 ET
Table 'axb9RsG8Zj1A0LEukTeFrQ' 9-max Seat #4 is the button
Seat 1: qwr38jl5txoR36M7G5qi4A ($8.50 in chips) 
Seat 2: zDrucyjVn5aeekNEc3cJrA ($19.75 in chips) 
Seat 3: H5Se03ZqSX7tbULXur2MAg ($23.35 in chips) 
Seat 4: tLcDklc2rBORNfixyRfVfw ($27.10 in chips) 
Seat 5: rLSSHKOHnb6yzVfDoQM/RA ($14.60 in chips) 
Seat 6: Iu9xjReQYvxYiqQm8n6MXQ ($5.35 in chips) 
Seat 7: PdIasPkzm2sqZnN41ZRXOg ($5 in chips) 
Seat 8: VBHxUExRAMrbxUq/cVx9Gw ($4.30 in chips) 
Seat 9: qbQE8CifKB4+OEvNF/61Rw ($58.45 in chips) 
rLSSHKOHnb6yzVfDoQM/RA: posts small blind $0.10
Iu9xjReQYvxYiqQm8n6MXQ: posts big blind $0.25
zDrucyjVn5aeekNEc3cJrA: posts small & big blinds $0.35
*** HOLE CARDS ***
PdIasPkzm2sqZnN41ZRXOg: folds 
VBHxUExRAMrbxUq/cVx9Gw: folds 
qbQE8CifKB4+OEvNF/61Rw: calls $0.25
qwr38jl5txoR36M7G5qi4A: folds 
zDrucyjVn5aeekNEc3cJrA: checks 
H5Se03ZqSX7tbULXur2MAg: folds 
tLcDklc2rBORNfixyRfVfw: folds 
rLSSHKOHnb6yzVfDoQM/RA: calls $0.15
Iu9xjReQYvxYiqQm8n6MXQ: checks 
*** FLOP *** [Jh 7c 2c]
rLSSHKOHnb6yzVfDoQM/RA: checks 
Iu9xjReQYvxYiqQm8n6MXQ: bets $0.25
qbQE8CifKB4+OEvNF/61Rw: folds 
zDrucyjVn5aeekNEc3cJrA: calls $0.25
rLSSHKOHnb6yzVfDoQM/RA: calls $0.25
*** TURN *** [Jh 7c 2c] [2h]
rLSSHKOHnb6yzVfDoQM/RA: checks 
Iu9xjReQYvxYiqQm8n6MXQ: bets $0.50
zDrucyjVn5aeekNEc3cJrA: calls $0.50
rLSSHKOHnb6yzVfDoQM/RA: folds 
*** RIVER *** [Jh 7c 2c 2h] [8h]
Iu9xjReQYvxYiqQm8n6MXQ: checks 
zDrucyjVn5aeekNEc3cJrA: checks 
*** SHOW DOWN ***
Iu9xjReQYvxYiqQm8n6MXQ: shows [7d 6s] (two pair, Sevens and Deuces)
zDrucyjVn5aeekNEc3cJrA: shows [7s Qc] (two pair, Sevens and Deuces - Queen kicker)
zDrucyjVn5aeekNEc3cJrA collected $2.75 from pot
*** SUMMARY ***
Total pot $2.85 | Rake $0.10 
Board [Jh 7c 2c 2h 8h]
Seat 1: qwr38jl5txoR36M7G5qi4A folded before Flop (didn't bet)
Seat 2: zDrucyjVn5aeekNEc3cJrA showed [7s Qc] and won ($2.75) with two pair, Sevens and Deuces
Seat 3: H5Se03ZqSX7tbULXur2MAg folded before Flop (didn't bet)
Seat 4: tLcDklc2rBORNfixyRfVfw (button) folded before Flop (didn't bet)
Seat 5: rLSSHKOHnb6yzVfDoQM/RA (small blind) folded on the Turn
Seat 6: Iu9xjReQYvxYiqQm8n6MXQ (big blind) showed [7d 6s] and lost with two pair, Sevens and Deuces
Seat 7: PdIasPkzm2sqZnN41ZRXOg folded before Flop (didn't bet)
Seat 8: VBHxUExRAMrbxUq/cVx9Gw folded before Flop (didn't bet)
Seat 9: qbQE8CifKB4+OEvNF/61Rw folded on the Flop




PokerStars Game #59941764438:  Hold'em No Limit ($0.10/$0.25) - 2009/07/01 1:45:25 ET
Table 'IUwZ/e0bDHZPgsIWx0RnNg' 6-max Seat #4 is the button
Seat 1: V66QiVCQPofyl3a+dpPHQQ ($5.80 in chips) 
Seat 2: mvFHK3pE7tCxJEqLjKC70Q ($55.95 in chips) 
Seat 3: dOX4wnYV2sEqvDbF+8KSCw ($25 in chips) 
Seat 4: OIjOiBfQstWrK/RuXx7zcw ($5.45 in chips) 
Seat 5: 9bpVv1/Qh9IYtXuCtl5VtQ ($24.75 in chips) 
Seat 6: NhUN/JpAprdJeamFBgJH1w ($39.25 in chips) 
9bpVv1/Qh9IYtXuCtl5VtQ: posts small blind $0.10
NhUN/JpAprdJeamFBgJH1w: posts big blind $0.25
*** HOLE CARDS ***
V66QiVCQPofyl3a+dpPHQQ: folds 
mvFHK3pE7tCxJEqLjKC70Q: folds 
dOX4wnYV2sEqvDbF+8KSCw: raises $0.75 to $1
OIjOiBfQstWrK/RuXx7zcw: calls $1
9bpVv1/Qh9IYtXuCtl5VtQ: folds 
NhUN/JpAprdJeamFBgJH1w: folds 
*** FLOP *** [6d 7c 3d]
dOX4wnYV2sEqvDbF+8KSCw: bets $1.50
OIjOiBfQstWrK/RuXx7zcw: folds 
Uncalled bet ($1.50) returned to dOX4wnYV2sEqvDbF+8KSCw
dOX4wnYV2sEqvDbF+8KSCw collected $2.25 from pot
dOX4wnYV2sEqvDbF+8KSCw: doesn't show hand 
*** SUMMARY ***
Total pot $2.35 | Rake $0.10 
Board [6d 7c 3d]
Seat 1: V66QiVCQPofyl3a+dpPHQQ folded before Flop (didn't bet)
Seat 2: mvFHK3pE7tCxJEqLjKC70Q folded before Flop (didn't bet)
Seat 3: dOX4wnYV2sEqvDbF+8KSCw collected ($2.25)
Seat 4: OIjOiBfQstWrK/RuXx7zcw (button) folded on the Flop
Seat 5: 9bpVv1/Qh9IYtXuCtl5VtQ (small blind) folded before Flop
Seat 6: NhUN/JpAprdJeamFBgJH1w (big blind) folded before Flop




PokerStars Game #59941764794:  Hold'em No Limit ($0.10/$0.25) - 2009/07/01 1:45:25 ET
Table 'mk323gviqdkOY5Aek/1EWg' 6-max Seat #3 is the button
Seat 1: L3/N/gliETan8N5Gim5h4Q ($25.40 in chips) 
Seat 2: GC/9yVD59DUCX7hUI7gcLw ($55.65 in chips) 
Seat 3: NuqYPwTLZYQhxOoVK3Yqlw ($23.30 in chips) 
Seat 4: +baiVgI/ETnBARLe5mARCw ($11.65 in chips) 
Seat 5: kjYRzIfvZNNflYMYRkkSVA ($29 in chips) 
Seat 6: KkXSr5xFjxLSD3wtAvT+WQ ($9 in chips) 
+baiVgI/ETnBARLe5mARCw: posts small blind $0.10
kjYRzIfvZNNflYMYRkkSVA: posts big blind $0.25
*** HOLE CARDS ***
KkXSr5xFjxLSD3wtAvT+WQ: folds 
L3/N/gliETan8N5Gim5h4Q: folds 
GC/9yVD59DUCX7hUI7gcLw: folds 
NuqYPwTLZYQhxOoVK3Yqlw: raises $0.75 to $1
+baiVgI/ETnBARLe5mARCw: folds 
kjYRzIfvZNNflYMYRkkSVA: calls $0.75
*** FLOP *** [9c 9d Qc]
kjYRzIfvZNNflYMYRkkSVA: checks 
NuqYPwTLZYQhxOoVK3Yqlw: bets $1.50
kjYRzIfvZNNflYMYRkkSVA: calls $1.50
*** TURN *** [9c 9d Qc] [7d]
kjYRzIfvZNNflYMYRkkSVA: checks 
L3/N/gliETan8N5Gim5h4Q leaves the table
NuqYPwTLZYQhxOoVK3Yqlw: bets $4.80
kjYRzIfvZNNflYMYRkkSVA: raises $21.70 to $26.50 and is all-in
7cx44/slbeTw+Cy7QB8Trg joins the table at seat #1 
NuqYPwTLZYQhxOoVK3Yqlw: folds 
Uncalled bet ($21.70) returned to kjYRzIfvZNNflYMYRkkSVA
kjYRzIfvZNNflYMYRkkSVA collected $14 from pot
kjYRzIfvZNNflYMYRkkSVA: doesn't show hand 
*** SUMMARY ***
Total pot $14.70 | Rake $0.70 
Board [9c 9d Qc 7d]
Seat 1: L3/N/gliETan8N5Gim5h4Q folded before Flop (didn't bet)
Seat 2: GC/9yVD59DUCX7hUI7gcLw folded before Flop (didn't bet)
Seat 3: NuqYPwTLZYQhxOoVK3Yqlw (button) folded on the Turn
Seat 4: +baiVgI/ETnBARLe5mARCw (small blind) folded before Flop
Seat 5: kjYRzIfvZNNflYMYRkkSVA (big blind) collected ($14)
Seat 6: KkXSr5xFjxLSD3wtAvT+WQ folded before Flop (didn't bet)




PokerStars Game #59941765268:  Hold'em No Limit ($0.10/$0.25) - 2009/07/01 1:45:26 ET
Table '2O5CgfSkSwrr4PDrlZ1RLQ' 6-max Seat #2 is the button
Seat 1: 3skmHD9EOATKdUzzyHh1KA ($29.45 in chips) 
Seat 2: wqphQtauX5Qn7WRJZS1flA ($26.50 in chips) 
Seat 3: oBUDUfeUyCbZBsjxHZgSiw ($23.35 in chips) 
Seat 4: epAUIB7h2FJXzUPRIvSkRA ($25 in chips) 
Seat 5: 0av6tRNdi0Ui4f15L7gsVg ($24.25 in chips) 
Seat 6: tj9xqoqQaDaFw7u1oyZrtA ($54.45 in chips) 
oBUDUfeUyCbZBsjxHZgSiw: posts small blind $0.10
epAUIB7h2FJXzUPRIvSkRA: posts big blind $0.25
*** HOLE CARDS ***
0av6tRNdi0Ui4f15L7gsVg: folds 
tj9xqoqQaDaFw7u1oyZrtA: calls $0.25
3skmHD9EOATKdUzzyHh1KA: folds 
wqphQtauX5Qn7WRJZS1flA has timed out
wqphQtauX5Qn7WRJZS1flA: folds 
wqphQtauX5Qn7WRJZS1flA is sitting out
wqphQtauX5Qn7WRJZS1flA has returned
oBUDUfeUyCbZBsjxHZgSiw: raises $0.75 to $1
epAUIB7h2FJXzUPRIvSkRA: folds 
tj9xqoqQaDaFw7u1oyZrtA: calls $0.75
*** FLOP *** [As 4h 7s]
oBUDUfeUyCbZBsjxHZgSiw: bets $1.25
tj9xqoqQaDaFw7u1oyZrtA: folds 
Uncalled bet ($1.25) returned to oBUDUfeUyCbZBsjxHZgSiw
oBUDUfeUyCbZBsjxHZgSiw collected $2.15 from pot
*** SUMMARY ***
Total pot $2.25 | Rake $0.10 
Board [As 4h 7s]
Seat 1: 3skmHD9EOATKdUzzyHh1KA folded before Flop (didn't bet)
Seat 2: wqphQtauX5Qn7WRJZS1flA (button) folded before Flop (didn't bet)
Seat 3: oBUDUfeUyCbZBsjxHZgSiw (small blind) collected ($2.15)
Seat 4: epAUIB7h2FJXzUPRIvSkRA (big blind) folded before Flop
Seat 5: 0av6tRNdi0Ui4f15L7gsVg folded before Flop (didn't bet)
Seat 6: tj9xqoqQaDaFw7u1oyZrtA folded on the Flop




PokerStars Game #59941764894:  Hold'em No Limit ($0.10/$0.25) - 2009/07/01 1:45:26 ET
Table 'NgexmgEDEzICBeSO7YCrKQ' 6-max Seat #2 is the button
Seat 1: cezpHJ8FB07dj0xG+LhOvw ($29.45 in chips) 
Seat 2: 32YL2ZEp8NT4JB2RVM9euQ ($21.55 in chips) 
Seat 3: JFIAqU8lCZ0vWwEl4bdGsg ($26.60 in chips) 
Seat 4: xx+iYCDJhHJmNzrfeloyEg ($23.65 in chips) 
Seat 5: /MXkdT8TTs8Qp2LVTQNw6w ($42.20 in chips) 
Seat 6: k9nHZTHt8hYhYRcW8NTb4g ($10.95 in chips) 
JFIAqU8lCZ0vWwEl4bdGsg: posts small blind $0.10
xx+iYCDJhHJmNzrfeloyEg: posts big blind $0.25
*** HOLE CARDS ***
/MXkdT8TTs8Qp2LVTQNw6w: folds 
k9nHZTHt8hYhYRcW8NTb4g: raises $0.50 to $0.75
cezpHJ8FB07dj0xG+LhOvw: folds 
32YL2ZEp8NT4JB2RVM9euQ: folds 
JFIAqU8lCZ0vWwEl4bdGsg: folds 
/MXkdT8TTs8Qp2LVTQNw6w said, "good bet, ery nearly laid it down"
xx+iYCDJhHJmNzrfeloyEg said, "  I must have a dishonest face."
xx+iYCDJhHJmNzrfeloyEg: folds 
Uncalled bet ($0.50) returned to k9nHZTHt8hYhYRcW8NTb4g
k9nHZTHt8hYhYRcW8NTb4g collected $0.60 from pot
k9nHZTHt8hYhYRcW8NTb4g: doesn't show hand 
*** SUMMARY ***
Total pot $0.60 | Rake $0 
Seat 1: cezpHJ8FB07dj0xG+LhOvw folded before Flop (didn't bet)
Seat 2: 32YL2ZEp8NT4JB2RVM9euQ (button) folded before Flop (didn't bet)
Seat 3: JFIAqU8lCZ0vWwEl4bdGsg (small blind) folded before Flop
Seat 4: xx+iYCDJhHJmNzrfeloyEg (big blind) folded before Flop
Seat 5: /MXkdT8TTs8Qp2LVTQNw6w folded before Flop (didn't bet)
Seat 6: k9nHZTHt8hYhYRcW8NTb4g collected ($0.60)




PokerStars Game #59941765284:  Hold'em No Limit ($0.10/$0.25) - 2009/07/01 1:45:26 ET
Table '5SUMWYuPsGiOD0FY0QbgOw' 6-max Seat #4 is the button
Seat 1: SFmT9ZsVopnukjvAzrxTRg ($25 in chips) 
Seat 2: xrf8tAXKQHG99HixCot1Iw ($37.50 in chips) 
Seat 3: MqMK8OWPSY1V4stf1Hy5Jw ($38.45 in chips) 
Seat 4: BV+K0Phf5VBHr7aZPKqbUQ ($25 in chips) 
Seat 5: v+QfkGiuj9bgtuNoVnDO8w ($40.75 in chips) 
Seat 6: jA7YMtfNUnAaebB7Lj74EA ($25.95 in chips) 
v+QfkGiuj9bgtuNoVnDO8w: posts small blind $0.10
jA7YMtfNUnAaebB7Lj74EA: posts big blind $0.25
*** HOLE CARDS ***
SFmT9ZsVopnukjvAzrxTRg: folds 
xrf8tAXKQHG99HixCot1Iw: folds 
MqMK8OWPSY1V4stf1Hy5Jw: folds 
BV+K0Phf5VBHr7aZPKqbUQ: folds 
v+QfkGiuj9bgtuNoVnDO8w: folds 
Uncalled bet ($0.15) returned to jA7YMtfNUnAaebB7Lj74EA
jA7YMtfNUnAaebB7Lj74EA collected $0.20 from pot
*** SUMMARY ***
Total pot $0.20 | Rake $0 
Seat 1: SFmT9ZsVopnukjvAzrxTRg folded before Flop (didn't bet)
Seat 2: xrf8tAXKQHG99HixCot1Iw folded before Flop (didn't bet)
Seat 3: MqMK8OWPSY1V4stf1Hy5Jw folded before Flop (didn't bet)
Seat 4: BV+K0Phf5VBHr7aZPKqbUQ (button) folded before Flop (didn't bet)
Seat 5: v+QfkGiuj9bgtuNoVnDO8w (small blind) folded before Flop
Seat 6: jA7YMtfNUnAaebB7Lj74EA (big blind) collected ($0.20)




PokerStars Game #59941764900:  Hold'em No Limit ($0.10/$0.25) - 2009/07/01 1:45:26 ET
Table 'g+mPuNJBCHKE9ents7ZGtg' 6-max Seat #3 is the button
Seat 1: cezpHJ8FB07dj0xG+LhOvw ($58.65 in chips) 
Seat 2: fZQg9veL7Dd/Z04ZTjC+wQ ($65.70 in chips) 
Seat 3: FYepjhAvF8ZdVCmqHIy+eQ ($29.90 in chips) 
Seat 4: yVrjRIW0SMxgpvqSIPSe/w ($13.30 in chips) 
Seat 5: D3ikCR8c/o9jB5irZ3uGlw ($12.65 in chips) 
Seat 6: Mn2V28t5aGq2d09z+/o6Fw ($24.65 in chips) 
yVrjRIW0SMxgpvqSIPSe/w: posts small blind $0.10
D3ikCR8c/o9jB5irZ3uGlw: posts big blind $0.25
*** HOLE CARDS ***
Mn2V28t5aGq2d09z+/o6Fw: folds 
cezpHJ8FB07dj0xG+LhOvw: folds 
fZQg9veL7Dd/Z04ZTjC+wQ: raises $0.50 to $0.75
FYepjhAvF8ZdVCmqHIy+eQ: folds 
yVrjRIW0SMxgpvqSIPSe/w: raises $2 to $2.75
D3ikCR8c/o9jB5irZ3uGlw: folds 
fZQg9veL7Dd/Z04ZTjC+wQ: folds 
Uncalled bet ($2) returned to yVrjRIW0SMxgpvqSIPSe/w
yVrjRIW0SMxgpvqSIPSe/w collected $1.75 from pot
*** SUMMARY ***
Total pot $1.75 | Rake $0 
Seat 1: cezpHJ8FB07dj0xG+LhOvw folded before Flop (didn't bet)
Seat 2: fZQg9veL7Dd/Z04ZTjC+wQ folded before Flop
Seat 3: FYepjhAvF8ZdVCmqHIy+eQ (button) folded before Flop (didn't bet)
Seat 4: yVrjRIW0SMxgpvqSIPSe/w (small blind) collected ($1.75)
Seat 5: D3ikCR8c/o9jB5irZ3uGlw (big blind) folded before Flop
Seat 6: Mn2V28t5aGq2d09z+/o6Fw folded before Flop (didn't bet)




PokerStars Game #59941765084:  Hold'em No Limit ($0.10/$0.25) - 2009/07/01 1:45:26 ET
Table '/asc7VQ/OpF/oVJ3erB80w' 9-max Seat #2 is the button
Seat 2: +LseQ4csMghI3KY4cLSGMQ ($9.85 in chips) 
Seat 3: WEb58GPxGJGcxGh34AFZRQ ($6.85 in chips) 
Seat 4: Rjy74A2wdEiDWplMcUbA+w ($18.35 in chips) 
Seat 5: QB9VESHry/CRTDKMGwKwsQ ($42.45 in chips) 
Seat 7: 7Qlge5BZqMQvXxiy4HU3Hw ($6.50 in chips) 
Seat 8: jB7U2KxE3pjvDhvZHXK2Ag ($18.60 in chips) 
Seat 9: zUXhymECc2C9W9ZNw6qppA ($19.05 in chips) 
WEb58GPxGJGcxGh34AFZRQ: posts small blind $0.10
Rjy74A2wdEiDWplMcUbA+w: posts big blind $0.25
wnerYvSRWT9Sm4X3ip/c8w: sits out 
*** HOLE CARDS ***
QB9VESHry/CRTDKMGwKwsQ: folds 
7Qlge5BZqMQvXxiy4HU3Hw: folds 
jB7U2KxE3pjvDhvZHXK2Ag: folds 
zUXhymECc2C9W9ZNw6qppA: folds 
+LseQ4csMghI3KY4cLSGMQ: calls $0.25
WEb58GPxGJGcxGh34AFZRQ: folds 
Rjy74A2wdEiDWplMcUbA+w: checks 
*** FLOP *** [Td Kc 7d]
Rjy74A2wdEiDWplMcUbA+w: checks 
+LseQ4csMghI3KY4cLSGMQ: bets $0.25
Rjy74A2wdEiDWplMcUbA+w: calls $0.25
*** TURN *** [Td Kc 7d] [Ah]
Rjy74A2wdEiDWplMcUbA+w: bets $0.25
+LseQ4csMghI3KY4cLSGMQ: raises $0.25 to $0.50
7Qlge5BZqMQvXxiy4HU3Hw said, "OLE DUCKY CALLS A RAISE WITH A 2 OFFSUIT AND HITS RUNNER RUNNER ACES"
Rjy74A2wdEiDWplMcUbA+w: raises $0.25 to $0.75
+LseQ4csMghI3KY4cLSGMQ: raises $1.25 to $2
Rjy74A2wdEiDWplMcUbA+w: raises $15.85 to $17.85 and is all-in
+LseQ4csMghI3KY4cLSGMQ: calls $7.35 and is all-in
Uncalled bet ($8.50) returned to Rjy74A2wdEiDWplMcUbA+w
*** RIVER *** [Td Kc 7d Ah] [Kh]
*** SHOW DOWN ***
Rjy74A2wdEiDWplMcUbA+w: shows [Jc Qs] (a straight, Ten to Ace)
+LseQ4csMghI3KY4cLSGMQ: shows [7c 7h] (a full house, Sevens full of Kings)
+LseQ4csMghI3KY4cLSGMQ collected $18.85 from pot
*** SUMMARY ***
Total pot $19.80 | Rake $0.95 
Board [Td Kc 7d Ah Kh]
Seat 2: +LseQ4csMghI3KY4cLSGMQ (button) showed [7c 7h] and won ($18.85) with a full house, Sevens full of Kings
Seat 3: WEb58GPxGJGcxGh34AFZRQ (small blind) folded before Flop
Seat 4: Rjy74A2wdEiDWplMcUbA+w (big blind) showed [Jc Qs] and lost with a straight, Ten to Ace
Seat 5: QB9VESHry/CRTDKMGwKwsQ folded before Flop (didn't bet)
Seat 7: 7Qlge5BZqMQvXxiy4HU3Hw folded before Flop (didn't bet)
Seat 8: jB7U2KxE3pjvDhvZHXK2Ag folded before Flop (didn't bet)
Seat 9: zUXhymECc2C9W9ZNw6qppA folded before Flop (didn't bet)




PokerStars Game #59941765778:  Hold'em No Limit ($0.10/$0.25) - 2009/07/01 1:45:27 ET
Table 'S6s+TmTlAjLHclBRvN5/fw' 9-max Seat #4 is the button
Seat 3: z2SmIaQ3+5n/eY1BN5HgPg ($6.45 in chips) 
Seat 4: RSal7+azPhXeqQO5L8XPfg ($13.50 in chips) 
RSal7+azPhXeqQO5L8XPfg: posts small blind $0.10
z2SmIaQ3+5n/eY1BN5HgPg: posts big blind $0.25
*** HOLE CARDS ***
RSal7+azPhXeqQO5L8XPfg: calls $0.15
z2SmIaQ3+5n/eY1BN5HgPg: checks 
*** FLOP *** [Kc 3d 8h]
z2SmIaQ3+5n/eY1BN5HgPg: checks 
RSal7+azPhXeqQO5L8XPfg: checks 
*** TURN *** [Kc 3d 8h] [As]
z2SmIaQ3+5n/eY1BN5HgPg: checks 
RSal7+azPhXeqQO5L8XPfg: bets $0.25
z2SmIaQ3+5n/eY1BN5HgPg: folds 
Uncalled bet ($0.25) returned to RSal7+azPhXeqQO5L8XPfg
RSal7+azPhXeqQO5L8XPfg collected $0.50 from pot
RSal7+azPhXeqQO5L8XPfg: doesn't show hand 
*** SUMMARY ***
Total pot $0.50 | Rake $0 
Board [Kc 3d 8h As]
Seat 3: z2SmIaQ3+5n/eY1BN5HgPg (big blind) folded on the Turn
Seat 4: RSal7+azPhXeqQO5L8XPfg (button) (small blind) collected ($0.50)




PokerStars Game #59941765494:  Hold'em No Limit ($0.10/$0.25) - 2009/07/01 1:45:27 ET
Table 'ROYvQOMwUrvL3SOiHYcrWg' 9-max Seat #8 is the button
Seat 1: 22dIObOuor/A+IKWkNoAlA ($5 in chips) 
Seat 2: gehe91e0IyVT0QU/XBkEyg ($24.90 in chips) 
Seat 3: 8EbrQ/EvFWt2cr0GaU82gQ ($4.65 in chips) 
Seat 4: SHegmCn8B0InbWE/zFlvOw ($21.95 in chips) 
Seat 5: 7je+LC5Mfs6nL8YBVh4frQ ($5 in chips) 
Seat 6: P+9ymZQ3ktpQu1bn7HIjew ($20.50 in chips) 
Seat 7: tYsOBqdU1+x+yFI7zHO7hQ ($25 in chips) 
Seat 8: biJWLZ27fafNeBI2oT1KJw ($28.15 in chips) 
Seat 9: uhrboV251dcgYniYTdFIcA ($25.10 in chips) 
uhrboV251dcgYniYTdFIcA: posts small blind $0.10
22dIObOuor/A+IKWkNoAlA: posts big blind $0.25
*** HOLE CARDS ***
gehe91e0IyVT0QU/XBkEyg: folds 
8EbrQ/EvFWt2cr0GaU82gQ: folds 
SHegmCn8B0InbWE/zFlvOw: calls $0.25
7je+LC5Mfs6nL8YBVh4frQ: folds 
P+9ymZQ3ktpQu1bn7HIjew: folds 
tYsOBqdU1+x+yFI7zHO7hQ: folds 
biJWLZ27fafNeBI2oT1KJw: folds 
uhrboV251dcgYniYTdFIcA: calls $0.15
22dIObOuor/A+IKWkNoAlA: checks 
*** FLOP *** [Tc 8h 5d]
uhrboV251dcgYniYTdFIcA: checks 
22dIObOuor/A+IKWkNoAlA: bets $0.25
SHegmCn8B0InbWE/zFlvOw: folds 
uhrboV251dcgYniYTdFIcA: folds 
Uncalled bet ($0.25) returned to 22dIObOuor/A+IKWkNoAlA
22dIObOuor/A+IKWkNoAlA collected $0.75 from pot
22dIObOuor/A+IKWkNoAlA: doesn't show hand 
*** SUMMARY ***
Total pot $0.75 | Rake $0 
Board [Tc 8h 5d]
Seat 1: 22dIObOuor/A+IKWkNoAlA (big blind) collected ($0.75)
Seat 2: gehe91e0IyVT0QU/XBkEyg folded before Flop (didn't bet)
Seat 3: 8EbrQ/EvFWt2cr0GaU82gQ folded before Flop (didn't bet)
Seat 4: SHegmCn8B0InbWE/zFlvOw folded on the Flop
Seat 5: 7je+LC5Mfs6nL8YBVh4frQ folded before Flop (didn't bet)
Seat 6: P+9ymZQ3ktpQu1bn7HIjew folded before Flop (didn't bet)
Seat 7: tYsOBqdU1+x+yFI7zHO7hQ folded before Flop (didn't bet)
Seat 8: biJWLZ27fafNeBI2oT1KJw (button) folded before Flop (didn't bet)
Seat 9: uhrboV251dcgYniYTdFIcA (small blind) folded on the Flop




PokerStars Game #59941765862:  Hold'em No Limit ($0.10/$0.25) - 2009/07/01 1:45:27 ET
Table 'pPgW4R3kdH26lLi1MnE92w' 9-max Seat #1 is the button
Seat 1: F4P6SxCNY4vxdb318G9RwA ($19.25 in chips) 
Seat 2: cZ99hugmLBj9KhTlc8nCSw ($27.25 in chips) 
Seat 3: WaS7+xnv4bIVHoru6nxczA ($13.75 in chips) 
Seat 5: HPEB+AtKw1+C/cxU0o1ciw ($22.25 in chips) 
Seat 6: VllYilcih0t+gMD4GTRlgQ ($25.40 in chips) 
Seat 7: sD+TKtt36XiiN6jqHiLwDA ($29.05 in chips) 
Seat 8: aCVg6cCxQcqClhB9nq/p1w ($29.95 in chips) 
Seat 9: tcbEu7VzyHQ+0lh+skbQhQ ($63.75 in chips) 
cZ99hugmLBj9KhTlc8nCSw: posts small blind $0.10
WaS7+xnv4bIVHoru6nxczA: posts big blind $0.25
iZ1f67Ok/207yzIQOu1Kdg: sits out 
*** HOLE CARDS ***
HPEB+AtKw1+C/cxU0o1ciw: folds 
VllYilcih0t+gMD4GTRlgQ: folds 
sD+TKtt36XiiN6jqHiLwDA: folds 
aCVg6cCxQcqClhB9nq/p1w: folds 
aCVg6cCxQcqClhB9nq/p1w leaves the table
tcbEu7VzyHQ+0lh+skbQhQ: folds 
F4P6SxCNY4vxdb318G9RwA: raises $1 to $1.25
cZ99hugmLBj9KhTlc8nCSw: folds 
WaS7+xnv4bIVHoru6nxczA: folds 
Uncalled bet ($1) returned to F4P6SxCNY4vxdb318G9RwA
clJsV3v77RS07bDKY+705w joins the table at seat #8 
F4P6SxCNY4vxdb318G9RwA collected $0.60 from pot
*** SUMMARY ***
Total pot $0.60 | Rake $0 
Seat 1: F4P6SxCNY4vxdb318G9RwA (button) collected ($0.60)
Seat 2: cZ99hugmLBj9KhTlc8nCSw (small blind) folded before Flop
Seat 3: WaS7+xnv4bIVHoru6nxczA (big blind) folded before Flop
Seat 5: HPEB+AtKw1+C/cxU0o1ciw folded before Flop (didn't bet)
Seat 6: VllYilcih0t+gMD4GTRlgQ folded before Flop (didn't bet)
Seat 7: sD+TKtt36XiiN6jqHiLwDA folded before Flop (didn't bet)
Seat 8: aCVg6cCxQcqClhB9nq/p1w folded before Flop (didn't bet)
Seat 9: tcbEu7VzyHQ+0lh+skbQhQ folded before Flop (didn't bet)




PokerStars Game #59941765720:  Hold'em No Limit ($0.10/$0.25) - 2009/07/01 1:45:27 ET
Table 'AJGgX1ZYM8d68SWMvaLttg' 6-max Seat #2 is the button
Seat 2: zHHLkD2sRljslKKeQv/ZQw ($28.20 in chips) 
Seat 3: 8ClCHtFXGNplITm+63KB+Q ($38.80 in chips) 
Seat 4: e30C3DfdG5TfPnR16/oMmA ($10 in chips) 
Seat 5: Hsvkc0/G2VV78oVmWYXecw ($5 in chips) 
Seat 6: UA5OsKS3VPaxa7uC8La/kA ($64 in chips) 
8ClCHtFXGNplITm+63KB+Q: posts small blind $0.10
e30C3DfdG5TfPnR16/oMmA: posts big blind $0.25
*** HOLE CARDS ***
Hsvkc0/G2VV78oVmWYXecw: folds 
UA5OsKS3VPaxa7uC8La/kA: folds 
zHHLkD2sRljslKKeQv/ZQw: raises $1 to $1.25
8ClCHtFXGNplITm+63KB+Q: folds 
e30C3DfdG5TfPnR16/oMmA: calls $1
*** FLOP *** [7c Qc 5h]
e30C3DfdG5TfPnR16/oMmA: bets $1.50
zHHLkD2sRljslKKeQv/ZQw: raises $3 to $4.50
e30C3DfdG5TfPnR16/oMmA: raises $3 to $7.50
zHHLkD2sRljslKKeQv/ZQw: raises $3 to $10.50
e30C3DfdG5TfPnR16/oMmA: calls $1.25 and is all-in
Uncalled bet ($1.75) returned to zHHLkD2sRljslKKeQv/ZQw
*** TURN *** [7c Qc 5h] [Qs]
*** RIVER *** [7c Qc 5h Qs] [6h]
*** SHOW DOWN ***
e30C3DfdG5TfPnR16/oMmA: shows [7h 9c] (two pair, Queens and Sevens)
zHHLkD2sRljslKKeQv/ZQw: mucks hand 
e30C3DfdG5TfPnR16/oMmA collected $19.10 from pot
*** SUMMARY ***
Total pot $20.10 | Rake $1 
Board [7c Qc 5h Qs 6h]
Seat 2: zHHLkD2sRljslKKeQv/ZQw (button) mucked
Seat 3: 8ClCHtFXGNplITm+63KB+Q (small blind) folded before Flop
Seat 4: e30C3DfdG5TfPnR16/oMmA (big blind) showed [7h 9c] and won ($19.10) with two pair, Queens and Sevens
Seat 5: Hsvkc0/G2VV78oVmWYXecw folded before Flop (didn't bet)
Seat 6: UA5OsKS3VPaxa7uC8La/kA folded before Flop (didn't bet)




PokerStars Game #59941766138:  Hold'em No Limit ($0.10/$0.25) - 2009/07/01 1:45:28 ET
Table 'oxYpQNT8OHNCvpMIFi7UoA' 9-max Seat #2 is the button
Seat 1: EVqHvqty1ZsuvDFiSXlSqQ ($33.20 in chips) 
Seat 2: 8+iP8mvFyeAviW/yUH1CJg ($29.70 in chips) 
Seat 3: ubsjZomMWSV0hAiBLa7K1A ($19.90 in chips) 
Seat 4: eK8qa6EPcH2zhtbmWSvc9g ($25 in chips) 
Seat 5: ZoqLw33zTU6EsjOkfv/cGw ($19.90 in chips) 
Seat 6: VBHxUExRAMrbxUq/cVx9Gw ($5.40 in chips) 
Seat 7: X78b5v/uhqeXXoAijbw/yg ($36.65 in chips) 
Seat 9: pN3IHvAKm2fz+sTRARTcrg ($25 in chips) 
ubsjZomMWSV0hAiBLa7K1A: posts small blind $0.10
eK8qa6EPcH2zhtbmWSvc9g: posts big blind $0.25
*** HOLE CARDS ***
ZoqLw33zTU6EsjOkfv/cGw: folds 
VBHxUExRAMrbxUq/cVx9Gw: folds 
X78b5v/uhqeXXoAijbw/yg: folds 
pN3IHvAKm2fz+sTRARTcrg: folds 
EVqHvqty1ZsuvDFiSXlSqQ: folds 
8+iP8mvFyeAviW/yUH1CJg: calls $0.25
ubsjZomMWSV0hAiBLa7K1A: folds 
eK8qa6EPcH2zhtbmWSvc9g: checks 
*** FLOP *** [9c Kh 2h]
eK8qa6EPcH2zhtbmWSvc9g: checks 
8+iP8mvFyeAviW/yUH1CJg: checks 
*** TURN *** [9c Kh 2h] [Tc]
eK8qa6EPcH2zhtbmWSvc9g: checks 
8+iP8mvFyeAviW/yUH1CJg: bets $0.75
eK8qa6EPcH2zhtbmWSvc9g: folds 
Uncalled bet ($0.75) returned to 8+iP8mvFyeAviW/yUH1CJg
8+iP8mvFyeAviW/yUH1CJg collected $0.60 from pot
*** SUMMARY ***
Total pot $0.60 | Rake $0 
Board [9c Kh 2h Tc]
Seat 1: EVqHvqty1ZsuvDFiSXlSqQ folded before Flop (didn't bet)
Seat 2: 8+iP8mvFyeAviW/yUH1CJg (button) collected ($0.60)
Seat 3: ubsjZomMWSV0hAiBLa7K1A (small blind) folded before Flop
Seat 4: eK8qa6EPcH2zhtbmWSvc9g (big blind) folded on the Turn
Seat 5: ZoqLw33zTU6EsjOkfv/cGw folded before Flop (didn't bet)
Seat 6: VBHxUExRAMrbxUq/cVx9Gw folded before Flop (didn't bet)
Seat 7: X78b5v/uhqeXXoAijbw/yg folded before Flop (didn't bet)
Seat 9: pN3IHvAKm2fz+sTRARTcrg folded before Flop (didn't bet)




PokerStars Game #59941766378:  Hold'em No Limit ($0.10/$0.25) - 2009/07/01 1:45:28 ET
Table 'z2yOdY2zyGWG1gh9WV9XtQ' 9-max Seat #6 is the button
Seat 3: X78b5v/uhqeXXoAijbw/yg ($26.65 in chips) 
Seat 4: Bb42QRQMhg5/Y0vHP8/2Xw ($25.35 in chips) 
Seat 5: W6tExOcYX7qiy6Qdp+ZwFA ($10.55 in chips) 
Seat 6: NBYmTySMtIicyMj5Vjzqhw ($24.80 in chips) 
Seat 9: wGigCmBR/9XWkPpvYos3aQ ($34.15 in chips) 
wGigCmBR/9XWkPpvYos3aQ: posts small blind $0.10
18G4P1XstjNvItdGUITxgw joins the table at seat #8 
bXpVeaSTPBFSPJmeXxO7nw: is sitting out 
bXpVeaSTPBFSPJmeXxO7nw leaves the table
X78b5v/uhqeXXoAijbw/yg: posts big blind $0.25
*** HOLE CARDS ***
18G4P1XstjNvItdGUITxgw leaves the table
zDrucyjVn5aeekNEc3cJrA has returned
Bb42QRQMhg5/Y0vHP8/2Xw: folds 
W6tExOcYX7qiy6Qdp+ZwFA: folds 
NBYmTySMtIicyMj5Vjzqhw: calls $0.25
wGigCmBR/9XWkPpvYos3aQ: raises $1.25 to $1.50
X78b5v/uhqeXXoAijbw/yg: folds 
NBYmTySMtIicyMj5Vjzqhw: folds 
Uncalled bet ($1.25) returned to wGigCmBR/9XWkPpvYos3aQ
wGigCmBR/9XWkPpvYos3aQ collected $0.75 from pot
wGigCmBR/9XWkPpvYos3aQ: doesn't show hand 
nAWaA+gDUSWOad+I9mKUEg joins the table at seat #8 
*** SUMMARY ***
Total pot $0.75 | Rake $0 
Seat 3: X78b5v/uhqeXXoAijbw/yg (big blind) folded before Flop
Seat 4: Bb42QRQMhg5/Y0vHP8/2Xw folded before Flop (didn't bet)
Seat 5: W6tExOcYX7qiy6Qdp+ZwFA folded before Flop (didn't bet)
Seat 6: NBYmTySMtIicyMj5Vjzqhw (button) folded before Flop
Seat 9: wGigCmBR/9XWkPpvYos3aQ (small blind) collected ($0.75)




PokerStars Game #59941765934:  Hold'em No Limit ($0.10/$0.25) - 2009/07/01 1:45:28 ET
Table 'nc6OeGk/wtaWV+6N+kgnZQ' 6-max Seat #5 is the button
Seat 1: tSR4329m40dZsN7YOpI9Kw ($37.25 in chips) 
Seat 2: 8ClCHtFXGNplITm+63KB+Q ($34.75 in chips) 
Seat 3: y8wpMWGSX2zHZijurx21mg ($7.10 in chips) 
Seat 4: 3zD3qLXT1bEffAoWGnc7wg ($31.55 in chips) 
Seat 5: HCS0lMAAPmZE2Tl8J/SuKw ($10.85 in chips) 
Seat 6: mFv3iBCtrw9XfCDRB0d46Q ($3.30 in chips) 
mFv3iBCtrw9XfCDRB0d46Q: posts small blind $0.10
tSR4329m40dZsN7YOpI9Kw: posts big blind $0.25
*** HOLE CARDS ***
8ClCHtFXGNplITm+63KB+Q: folds 
y8wpMWGSX2zHZijurx21mg: folds 
3zD3qLXT1bEffAoWGnc7wg: folds 
HCS0lMAAPmZE2Tl8J/SuKw: calls $0.25
mFv3iBCtrw9XfCDRB0d46Q: raises $3.05 to $3.30 and is all-in
tSR4329m40dZsN7YOpI9Kw: folds 
HCS0lMAAPmZE2Tl8J/SuKw: folds 
Uncalled bet ($3.05) returned to mFv3iBCtrw9XfCDRB0d46Q
mFv3iBCtrw9XfCDRB0d46Q collected $0.75 from pot
mFv3iBCtrw9XfCDRB0d46Q: doesn't show hand 
*** SUMMARY ***
Total pot $0.75 | Rake $0 
Seat 1: tSR4329m40dZsN7YOpI9Kw (big blind) folded before Flop
Seat 2: 8ClCHtFXGNplITm+63KB+Q folded before Flop (didn't bet)
Seat 3: y8wpMWGSX2zHZijurx21mg folded before Flop (didn't bet)
Seat 4: 3zD3qLXT1bEffAoWGnc7wg folded before Flop (didn't bet)
Seat 5: HCS0lMAAPmZE2Tl8J/SuKw (button) folded before Flop
Seat 6: mFv3iBCtrw9XfCDRB0d46Q (small blind) collected ($0.75)




PokerStars Game #59941766398:  Hold'em No Limit ($0.10/$0.25) - 2009/07/01 1:45:28 ET
Table 'aaXqTKUnxrX9DYXtxhWXxA' 6-max Seat #1 is the button
Seat 1: aSrj4lVmn2owyQ1RbbOqxQ ($26.80 in chips) 
Seat 2: DE9hRlt14g+JdsRQ4wT7hg ($33.45 in chips) 
Seat 3: uUXdcVMNa05rfbntdvplfw ($8.35 in chips) 
Seat 4: 48oT5xFI+5CHUJlfoGrE4w ($9.65 in chips) 
Seat 5: kyRaCIljYA6l33lSKQfNsg ($24.95 in chips) 
Seat 6: buyjetgNT1McXtdaP4zynA ($49.20 in chips) 
DE9hRlt14g+JdsRQ4wT7hg: posts small blind $0.10
uUXdcVMNa05rfbntdvplfw: posts big blind $0.25
*** HOLE CARDS ***
48oT5xFI+5CHUJlfoGrE4w: raises $0.25 to $0.50
kyRaCIljYA6l33lSKQfNsg: folds 
buyjetgNT1McXtdaP4zynA: folds 
aSrj4lVmn2owyQ1RbbOqxQ: folds 
DE9hRlt14g+JdsRQ4wT7hg: folds 
uUXdcVMNa05rfbntdvplfw: calls $0.25
*** FLOP *** [Qc 5c 9s]
uUXdcVMNa05rfbntdvplfw: checks 
48oT5xFI+5CHUJlfoGrE4w: checks 
*** TURN *** [Qc 5c 9s] [3c]
uUXdcVMNa05rfbntdvplfw: bets $0.50
48oT5xFI+5CHUJlfoGrE4w: folds 
Uncalled bet ($0.50) returned to uUXdcVMNa05rfbntdvplfw
uUXdcVMNa05rfbntdvplfw collected $1.05 from pot
*** SUMMARY ***
Total pot $1.10 | Rake $0.05 
Board [Qc 5c 9s 3c]
Seat 1: aSrj4lVmn2owyQ1RbbOqxQ (button) folded before Flop (didn't bet)
Seat 2: DE9hRlt14g+JdsRQ4wT7hg (small blind) folded before Flop
Seat 3: uUXdcVMNa05rfbntdvplfw (big blind) collected ($1.05)
Seat 4: 48oT5xFI+5CHUJlfoGrE4w folded on the Turn
Seat 5: kyRaCIljYA6l33lSKQfNsg folded before Flop (didn't bet)
Seat 6: buyjetgNT1McXtdaP4zynA folded before Flop (didn't bet)




PokerStars Game #59941766066:  Hold'em No Limit ($0.10/$0.25) - 2009/07/01 1:45:28 ET
Table 'YONIZZNvg4uZ4xNUO1deeA' 6-max Seat #6 is the button
Seat 1: GbCVUNssQ7mqsPWr7J4d3w ($4.75 in chips) 
Seat 2: evMMX/0gSDH791KdSAOaSg ($17.20 in chips) 
Seat 3: Eksrep3hySi2jeDHuaWiOQ ($11 in chips) 
Seat 4: w43JQj2oYPpKQVG4Yzlq1w ($25 in chips) 
Seat 5: if4dh6jhJXeN3/qd3qCp9g ($25 in chips) 
Seat 6: eL3+wCBjFGfQ5FMdIZihwA ($27 in chips) 
GbCVUNssQ7mqsPWr7J4d3w: posts small blind $0.10
evMMX/0gSDH791KdSAOaSg: posts big blind $0.25
w43JQj2oYPpKQVG4Yzlq1w: posts big blind $0.25
*** HOLE CARDS ***
Eksrep3hySi2jeDHuaWiOQ: folds 
w43JQj2oYPpKQVG4Yzlq1w: checks 
if4dh6jhJXeN3/qd3qCp9g: folds 
eL3+wCBjFGfQ5FMdIZihwA: folds 
GbCVUNssQ7mqsPWr7J4d3w: folds 
evMMX/0gSDH791KdSAOaSg: checks 
*** FLOP *** [Kc 5h Ad]
evMMX/0gSDH791KdSAOaSg: checks 
w43JQj2oYPpKQVG4Yzlq1w: checks 
*** TURN *** [Kc 5h Ad] [Qd]
evMMX/0gSDH791KdSAOaSg: checks 
w43JQj2oYPpKQVG4Yzlq1w: bets $0.75
evMMX/0gSDH791KdSAOaSg: folds 
Uncalled bet ($0.75) returned to w43JQj2oYPpKQVG4Yzlq1w
w43JQj2oYPpKQVG4Yzlq1w collected $0.60 from pot
*** SUMMARY ***
Total pot $0.60 | Rake $0 
Board [Kc 5h Ad Qd]
Seat 1: GbCVUNssQ7mqsPWr7J4d3w (small blind) folded before Flop
Seat 2: evMMX/0gSDH791KdSAOaSg (big blind) folded on the Turn
Seat 3: Eksrep3hySi2jeDHuaWiOQ folded before Flop (didn't bet)
Seat 4: w43JQj2oYPpKQVG4Yzlq1w collected ($0.60)
Seat 5: if4dh6jhJXeN3/qd3qCp9g folded before Flop (didn't bet)
Seat 6: eL3+wCBjFGfQ5FMdIZihwA (button) folded before Flop (didn't bet)




PokerStars Game #59941766310:  Hold'em No Limit ($0.10/$0.25) - 2009/07/01 1:45:28 ET
Table 'MiquQrQZJJq9ZtgRIp9HFQ' 6-max Seat #2 is the button
Seat 1: c3J/KYZ4cNsUEuz8v57I5A ($20.90 in chips) 
Seat 2: 2+6voGl1T1DO63JePptI3g ($19 in chips) 
Seat 3: 9h7TNZ1TDGRUJXA6rI+ZTw ($9.50 in chips) 
Seat 4: wAKC8C/zN0c8V5v13dm9mA ($58.30 in chips) 
Seat 5: iyZxqznXjv3vtvOJymkoLQ ($26.75 in chips) 
Seat 6: GbCVUNssQ7mqsPWr7J4d3w ($5 in chips) 
9h7TNZ1TDGRUJXA6rI+ZTw: posts small blind $0.10
wAKC8C/zN0c8V5v13dm9mA: posts big blind $0.25
*** HOLE CARDS ***
iyZxqznXjv3vtvOJymkoLQ: folds 
GbCVUNssQ7mqsPWr7J4d3w: folds 
c3J/KYZ4cNsUEuz8v57I5A: raises $0.50 to $0.75
2+6voGl1T1DO63JePptI3g: folds 
9h7TNZ1TDGRUJXA6rI+ZTw: folds 
wAKC8C/zN0c8V5v13dm9mA: folds 
Uncalled bet ($0.50) returned to c3J/KYZ4cNsUEuz8v57I5A
c3J/KYZ4cNsUEuz8v57I5A collected $0.60 from pot
c3J/KYZ4cNsUEuz8v57I5A: doesn't show hand 
*** SUMMARY ***
Total pot $0.60 | Rake $0 
Seat 1: c3J/KYZ4cNsUEuz8v57I5A collected ($0.60)
Seat 2: 2+6voGl1T1DO63JePptI3g (button) folded before Flop (didn't bet)
Seat 3: 9h7TNZ1TDGRUJXA6rI+ZTw (small blind) folded before Flop
Seat 4: wAKC8C/zN0c8V5v13dm9mA (big blind) folded before Flop
Seat 5: iyZxqznXjv3vtvOJymkoLQ folded before Flop (didn't bet)
Seat 6: GbCVUNssQ7mqsPWr7J4d3w folded before Flop (didn't bet)




PokerStars Game #59941766434:  Hold'em No Limit ($0.10/$0.25) - 2009/07/01 1:45:29 ET
Table '4UJB/UOZ5aepyF2v+hIoUg' 6-max Seat #5 is the button
Seat 1: 08V++DOqzaNrRNsHIwi25w ($26.60 in chips) 
Seat 2: mFv3iBCtrw9XfCDRB0d46Q ($4.55 in chips) 
Seat 3: zlYHXTtJ5tcx9kwK2h5n9A ($42.50 in chips) 
Seat 4: R6AGToFJQOYVZAjC2jXEKw ($23.85 in chips) 
Seat 5: 3zD3qLXT1bEffAoWGnc7wg ($25.55 in chips) 
Seat 6: 2aphcinkTZT0B0Uoah6cvQ ($13.10 in chips) 
2aphcinkTZT0B0Uoah6cvQ: posts small blind $0.10
08V++DOqzaNrRNsHIwi25w: posts big blind $0.25
*** HOLE CARDS ***
mFv3iBCtrw9XfCDRB0d46Q: folds 
zlYHXTtJ5tcx9kwK2h5n9A: calls $0.25
R6AGToFJQOYVZAjC2jXEKw: folds 
3zD3qLXT1bEffAoWGnc7wg: folds 
2aphcinkTZT0B0Uoah6cvQ: calls $0.15
08V++DOqzaNrRNsHIwi25w: checks 
*** FLOP *** [Qd Kh Ks]
2aphcinkTZT0B0Uoah6cvQ: checks 
08V++DOqzaNrRNsHIwi25w: checks 
zlYHXTtJ5tcx9kwK2h5n9A: checks 
*** TURN *** [Qd Kh Ks] [Jh]
2aphcinkTZT0B0Uoah6cvQ: checks 
08V++DOqzaNrRNsHIwi25w: checks 
zlYHXTtJ5tcx9kwK2h5n9A: checks 
*** RIVER *** [Qd Kh Ks Jh] [7h]
2aphcinkTZT0B0Uoah6cvQ: checks 
08V++DOqzaNrRNsHIwi25w: checks 
zlYHXTtJ5tcx9kwK2h5n9A: checks 
*** SHOW DOWN ***
2aphcinkTZT0B0Uoah6cvQ: shows [Ad 3s] (a pair of Kings)
08V++DOqzaNrRNsHIwi25w: shows [Js 9h] (two pair, Kings and Jacks)
zlYHXTtJ5tcx9kwK2h5n9A: mucks hand 
08V++DOqzaNrRNsHIwi25w collected $0.75 from pot
*** SUMMARY ***
Total pot $0.75 | Rake $0 
Board [Qd Kh Ks Jh 7h]
Seat 1: 08V++DOqzaNrRNsHIwi25w (big blind) showed [Js 9h] and won ($0.75) with two pair, Kings and Jacks
Seat 2: mFv3iBCtrw9XfCDRB0d46Q folded before Flop (didn't bet)
Seat 3: zlYHXTtJ5tcx9kwK2h5n9A mucked
Seat 4: R6AGToFJQOYVZAjC2jXEKw folded before Flop (didn't bet)
Seat 5: 3zD3qLXT1bEffAoWGnc7wg (button) folded before Flop (didn't bet)
Seat 6: 2aphcinkTZT0B0Uoah6cvQ (small blind) showed [Ad 3s] and lost with a pair of Kings




PokerStars Game #59941766824:  Hold'em No Limit ($0.10/$0.25) - 2009/07/01 1:45:29 ET
Table 'Is9eNmJA1KnBOw0lcVkxUQ' 9-max Seat #2 is the button
Seat 1: 56S3mA6Zs3pGR+0p0vUCtg ($32 in chips) 
Seat 2: VllYilcih0t+gMD4GTRlgQ ($37.50 in chips) 
Seat 3: ubsjZomMWSV0hAiBLa7K1A ($19.25 in chips) 
Seat 4: cZ99hugmLBj9KhTlc8nCSw ($25 in chips) 
Seat 6: HapyJHxV6lc3eqoT7yWL2A ($34.50 in chips) 
Seat 7: aNpwfA31EREwO+ar4XzBCw ($28.30 in chips) 
Seat 8: Th3FldXKQW6hWVVPahaoOQ ($25.50 in chips) 
Seat 9: DdPXdieucQ+n99u1n3A+rQ ($4.90 in chips) 
ubsjZomMWSV0hAiBLa7K1A: posts small blind $0.10
cZ99hugmLBj9KhTlc8nCSw: posts big blind $0.25
Qduu7ikeizo6q6Ei9YvcJA: sits out 
*** HOLE CARDS ***
HapyJHxV6lc3eqoT7yWL2A: raises $0.75 to $1
aNpwfA31EREwO+ar4XzBCw: folds 
Th3FldXKQW6hWVVPahaoOQ: folds 
DdPXdieucQ+n99u1n3A+rQ: folds 
56S3mA6Zs3pGR+0p0vUCtg: folds 
VllYilcih0t+gMD4GTRlgQ: calls $1
ubsjZomMWSV0hAiBLa7K1A: folds 
cZ99hugmLBj9KhTlc8nCSw: folds 
*** FLOP *** [Td Jh 9d]
HapyJHxV6lc3eqoT7yWL2A: bets $1.25
VllYilcih0t+gMD4GTRlgQ: calls $1.25
*** TURN *** [Td Jh 9d] [2h]
HapyJHxV6lc3eqoT7yWL2A: bets $2.25
VllYilcih0t+gMD4GTRlgQ: raises $3.50 to $5.75
HapyJHxV6lc3eqoT7yWL2A: calls $3.50
*** RIVER *** [Td Jh 9d 2h] [7d]
HapyJHxV6lc3eqoT7yWL2A: checks 
VllYilcih0t+gMD4GTRlgQ: bets $4.25
HapyJHxV6lc3eqoT7yWL2A: raises $11.25 to $15.50
VllYilcih0t+gMD4GTRlgQ: calls $11.25
*** SHOW DOWN ***
HapyJHxV6lc3eqoT7yWL2A: shows [Qd Ah] (high card Ace)
VllYilcih0t+gMD4GTRlgQ: shows [Ts 9s] (two pair, Tens and Nines)
VllYilcih0t+gMD4GTRlgQ collected $45.05 from pot
*** SUMMARY ***
Total pot $47.35 | Rake $2.30 
Board [Td Jh 9d 2h 7d]
Seat 1: 56S3mA6Zs3pGR+0p0vUCtg folded before Flop (didn't bet)
Seat 2: VllYilcih0t+gMD4GTRlgQ (button) showed [Ts 9s] and won ($45.05) with two pair, Tens and Nines
Seat 3: ubsjZomMWSV0hAiBLa7K1A (small blind) folded before Flop
Seat 4: cZ99hugmLBj9KhTlc8nCSw (big blind) folded before Flop
Seat 6: HapyJHxV6lc3eqoT7yWL2A showed [Qd Ah] and lost with high card Ace
Seat 7: aNpwfA31EREwO+ar4XzBCw folded before Flop (didn't bet)
Seat 8: Th3FldXKQW6hWVVPahaoOQ folded before Flop (didn't bet)
Seat 9: DdPXdieucQ+n99u1n3A+rQ folded before Flop (didn't bet)




PokerStars Game #59941766930:  Hold'em No Limit ($0.10/$0.25) - 2009/07/01 1:45:29 ET
Table 'zW+7jPbOLCvlPu+dUGY5WQ' 6-max Seat #1 is the button
Seat 1: eL3+wCBjFGfQ5FMdIZihwA ($26.50 in chips) 
Seat 2: cEMJmfAUQZmMChZe6aacKw ($8.35 in chips) 
Seat 4: i48129QFpEQQ+UN4aNtmww ($20.30 in chips) 
Seat 6: qGHGf/553gQnDoklMRe3tg ($25 in chips) 
cEMJmfAUQZmMChZe6aacKw: posts small blind $0.10
i48129QFpEQQ+UN4aNtmww: posts big blind $0.25
Hsvkc0/G2VV78oVmWYXecw: sits out 
*** HOLE CARDS ***
qGHGf/553gQnDoklMRe3tg: folds 
eL3+wCBjFGfQ5FMdIZihwA: folds 
cEMJmfAUQZmMChZe6aacKw: calls $0.15
i48129QFpEQQ+UN4aNtmww: checks 
*** FLOP *** [8d 2h 2c]
cEMJmfAUQZmMChZe6aacKw: checks 
i48129QFpEQQ+UN4aNtmww: checks 
*** TURN *** [8d 2h 2c] [Ts]
cEMJmfAUQZmMChZe6aacKw: checks 
i48129QFpEQQ+UN4aNtmww: checks 
*** RIVER *** [8d 2h 2c Ts] [4h]
cEMJmfAUQZmMChZe6aacKw: bets $0.25
i48129QFpEQQ+UN4aNtmww: folds 
Uncalled bet ($0.25) returned to cEMJmfAUQZmMChZe6aacKw
cEMJmfAUQZmMChZe6aacKw collected $0.50 from pot
*** SUMMARY ***
Total pot $0.50 | Rake $0 
Board [8d 2h 2c Ts 4h]
Seat 1: eL3+wCBjFGfQ5FMdIZihwA (button) folded before Flop (didn't bet)
Seat 2: cEMJmfAUQZmMChZe6aacKw (small blind) collected ($0.50)
Seat 4: i48129QFpEQQ+UN4aNtmww (big blind) folded on the River
Seat 6: qGHGf/553gQnDoklMRe3tg folded before Flop (didn't bet)




PokerStars Game #59941766682:  Hold'em No Limit ($0.10/$0.25) - 2009/07/01 1:45:29 ET
Table 'z2yOdY2zyGWG1gh9WV9XtQdYNvO8G5kw5SRxb1Dljhog Seat #1 is the button
Seat 1: vSkQm2EelzwRGDDQQk0Fqw ($8.85 in chips) 
Seat 2: PkBmevN3LdXkPj1LHOoTnQ ($10.20 in chips) 
Seat 3: 1Cs1GyQcoM1omwY7XZ3uRg ($12.75 in chips) 
Seat 4: sD+TKtt36XiiN6jqHiLwDA ($28.10 in chips) 
Seat 5: W7XGvw6ngGVq2hFwXk8Myg ($25.60 in chips) 
Seat 6: 22dIObOuor/A+IKWkNoAlA ($8.05 in chips) 
Seat 7: DiSvPC2iudwL5j9u6Huyww ($39.75 in chips) 
Seat 8: 5hAPbqNrvJb8PtLiceXtlg6HoFYfVGBefsR5Vrz62qIw0 in chips) 
Seat 9: PdIasPkzm2sqZnN41ZRXOg ($5 in chips) 
PkBmevN3LdXkPj1LHOoTnQ: posts small blind $0.10
1Cs1GyQcoM1omwY7XZ3uRg: posts big blind $0.25
*** HOLE CARDS ***
sD+TKtt36XiiN6jqHiLwDA: folds 
W7XGvw6ngGVq2hFwXk8Myg: folds 
22dIObOuor/A+IKWkNoAlA: calls $0.25
DiSvPC2iudwL5j9u6Huyww: folds 
5hAPbqNrvJb8PtLiceXtlg6HoFYfVGBefsR5Vrz62qIwlds 
PdIasPkzm2sqZnN41ZRXOg: folds 
vSkQm2EelzwRGDDQQk0Fqw: calls $0.25
PkBmevN3LdXkPj1LHOoTnQ: calls $0.15
1Cs1GyQcoM1omwY7XZ3uRg: checks 
*** FLOP *** [9s 8s 3h]
PkBmevN3LdXkPj1LHOoTnQ: bets $4.50
1Cs1GyQcoM1omwY7XZ3uRg: folds 
22dIObOuor/A+IKWkNoAlA: folds 
vSkQm2EelzwRGDDQQk0Fqw: raises $4.10 to $8.60 and is all-in
PkBmevN3LdXkPj1LHOoTnQ: calls $4.10
*** TURN *** [9s 8s 3h] [Ks]
*** RIVER *** [9s 8s 3h Ks] [4d]
*** SHOW DOWN ***
PkBmevN3LdXkPj1LHOoTnQ: shows [Jd Jh] (a pair of Jacks)
vSkQm2EelzwRGDDQQk0Fqw: shows [9d Kd] (two pair, Kings and Nines)
vSkQm2EelzwRGDDQQk0Fqw collected $17.30 from pot
*** SUMMARY ***
Total pot $18.20 | Rake $0.90 
Board [9s 8s 3h Ks 4d]
Seat 1: vSkQm2EelzwRGDDQQk0Fqw (button) showed [9d Kd] and won ($17.30) with two pair, Kings and Nines
Seat 2: PkBmevN3LdXkPj1LHOoTnQ (small blind) showed [Jd Jh] and lost with a pair of Jacks
Seat 3: 1Cs1GyQcoM1omwY7XZ3uRg (big blind) folded on the Flop
Seat 4: sD+TKtt36XiiN6jqHiLwDA folded before Flop (didn't bet)
Seat 5: W7XGvw6ngGVq2hFwXk8Myg folded before Flop (didn't bet)
Seat 6: 22dIObOuor/A+IKWkNoAlA folded on the Flop
Seat 7: DiSvPC2iudwL5j9u6Huyww folded before Flop (didn't bet)
Seat 8: 5hAPbqNrvJb8PtLiceXtlg6HoFYfVGBefsR5Vrz62qIwded before Flop (didn't bet)
Seat 9: PdIasPkzm2sqZnN41ZRXOg folded before Flop (didn't bet)




PokerStars Game #59941767062:  Hold'em No Limit ($0.10/$0.25) - 2009/07/01 1:45:30 ET
Table '3lL16FBjWXTx3AjK5lMRww' 9-max Seat #1 is the button
Seat 1: fDGyaQz0cs2s4FOYxkbIHA ($16.55 in chips) 
Seat 2: c/9X4zftzphFxYtxp5kp9w ($21.65 in chips) 
Seat 3: QEbIGci+itdw+re8RM5fZA ($27.95 in chips) 
Seat 4: Z3a37Ry74FVl+CBZtAONiA ($5.55 in chips) 
Seat 5: M/9j4wkHH9i1JM51vgi1VA ($37.30 in chips) 
Seat 6: zUXhymECc2C9W9ZNw6qppA ($9.15 in chips) 
Seat 7: 6RiVTYll/5D8zICp0MRpKw ($25.70 in chips) 
Seat 8: ljemhp25Zg+nlA9DLCIiUw ($25 in chips) 
Seat 9: 00Ybni1cxfHtqmdWwh31Xg ($10.30 in chips) 
c/9X4zftzphFxYtxp5kp9w: posts small blind $0.10
QEbIGci+itdw+re8RM5fZA: posts big blind $0.25
*** HOLE CARDS ***
Z3a37Ry74FVl+CBZtAONiA: calls $0.25
M/9j4wkHH9i1JM51vgi1VA: folds 
zUXhymECc2C9W9ZNw6qppA has timed out
zUXhymECc2C9W9ZNw6qppA: folds 
zUXhymECc2C9W9ZNw6qppA is sitting out
6RiVTYll/5D8zICp0MRpKw: calls $0.25
ljemhp25Zg+nlA9DLCIiUw: folds 
00Ybni1cxfHtqmdWwh31Xg: folds 
fDGyaQz0cs2s4FOYxkbIHA: folds 
c/9X4zftzphFxYtxp5kp9w: folds 
zUXhymECc2C9W9ZNw6qppA has returned
QEbIGci+itdw+re8RM5fZA: checks 
*** FLOP *** [4c Kh Ah]
QEbIGci+itdw+re8RM5fZA: checks 
Z3a37Ry74FVl+CBZtAONiA: checks 
6RiVTYll/5D8zICp0MRpKw: checks 
*** TURN *** [4c Kh Ah] [3c]
QEbIGci+itdw+re8RM5fZA: checks 
Z3a37Ry74FVl+CBZtAONiA: bets $0.50
6RiVTYll/5D8zICp0MRpKw: calls $0.50
QEbIGci+itdw+re8RM5fZA: calls $0.50
*** RIVER *** [4c Kh Ah 3c] [8d]
QEbIGci+itdw+re8RM5fZA: checks 
Z3a37Ry74FVl+CBZtAONiA: bets $1
6RiVTYll/5D8zICp0MRpKw: folds 
QEbIGci+itdw+re8RM5fZA: folds 
Uncalled bet ($1) returned to Z3a37Ry74FVl+CBZtAONiA
Z3a37Ry74FVl+CBZtAONiA collected $2.25 from pot
*** SUMMARY ***
Total pot $2.35 | Rake $0.10 
Board [4c Kh Ah 3c 8d]
Seat 1: fDGyaQz0cs2s4FOYxkbIHA (button) folded before Flop (didn't bet)
Seat 2: c/9X4zftzphFxYtxp5kp9w (small blind) folded before Flop
Seat 3: QEbIGci+itdw+re8RM5fZA (big blind) folded on the River
Seat 4: Z3a37Ry74FVl+CBZtAONiA collected ($2.25)
Seat 5: M/9j4wkHH9i1JM51vgi1VA folded before Flop (didn't bet)
Seat 6: zUXhymECc2C9W9ZNw6qppA folded before Flop (didn't bet)
Seat 7: 6RiVTYll/5D8zICp0MRpKw folded on the River
Seat 8: ljemhp25Zg+nlA9DLCIiUw folded before Flop (didn't bet)
Seat 9: 00Ybni1cxfHtqmdWwh31Xg folded before Flop (didn't bet)




PokerStars Game #59941766996:  Hold'em No Limit ($0.10/$0.25) - 2009/07/01 1:45:30 ET
Table '1HT8bEDpLPhOXxmqMtzF8w' 9-max Seat #7 is the button
Seat 1: YkkKQUDI0iWatY4h0WWaAQ ($12.90 in chips) 
Seat 2: r6hsffOo1iKmaPYKwAZmFw ($29 in chips) 
Seat 3: oLa/tXLfSLLB28mcLGrxcg ($24.75 in chips) 
Seat 4: aNpwfA31EREwO+ar4XzBCw ($25 in chips) 
Seat 5: CT2YIt3dXaE9eOIkS7FwNw ($22.55 in chips) 
Seat 6: bXpVeaSTPBFSPJmeXxO7nw ($5.25 in chips) 
Seat 7: PMhmqYBPHOAXjH25lRz69g ($16.80 in chips) 
Seat 8: ghNKXUBl/H+t83JF079ZBA ($33.25 in chips) 
Seat 9: Z9W7+g1WMhhZDi7DwGbCFA ($5 in chips) 
ghNKXUBl/H+t83JF079ZBA: posts small blind $0.10
Z9W7+g1WMhhZDi7DwGbCFA: posts big blind $0.25
*** HOLE CARDS ***
YkkKQUDI0iWatY4h0WWaAQ: folds 
r6hsffOo1iKmaPYKwAZmFw: folds 
oLa/tXLfSLLB28mcLGrxcg: folds 
aNpwfA31EREwO+ar4XzBCw: folds 
CT2YIt3dXaE9eOIkS7FwNw: folds 
bXpVeaSTPBFSPJmeXxO7nw: folds 
PMhmqYBPHOAXjH25lRz69g: folds 
ghNKXUBl/H+t83JF079ZBA: folds 
Uncalled bet ($0.15) returned to Z9W7+g1WMhhZDi7DwGbCFA
Z9W7+g1WMhhZDi7DwGbCFA collected $0.20 from pot
Z9W7+g1WMhhZDi7DwGbCFA: doesn't show hand 
*** SUMMARY ***
Total pot $0.20 | Rake $0 
Seat 1: YkkKQUDI0iWatY4h0WWaAQ folded before Flop (didn't bet)
Seat 2: r6hsffOo1iKmaPYKwAZmFw folded before Flop (didn't bet)
Seat 3: oLa/tXLfSLLB28mcLGrxcg folded before Flop (didn't bet)
Seat 4: aNpwfA31EREwO+ar4XzBCw folded before Flop (didn't bet)
Seat 5: CT2YIt3dXaE9eOIkS7FwNw folded before Flop (didn't bet)
Seat 6: bXpVeaSTPBFSPJmeXxO7nw folded before Flop (didn't bet)
Seat 7: PMhmqYBPHOAXjH25lRz69g (button) folded before Flop (didn't bet)
Seat 8: ghNKXUBl/H+t83JF079ZBA (small blind) folded before Flop
Seat 9: Z9W7+g1WMhhZDi7DwGbCFA (big blind) collected ($0.20)




PokerStars Game #59941767104:  Hold'em No Limit ($0.10/$0.25) - 2009/07/01 1:45:30 ET
Table 'r562aMIMs5kgo28FEU6lkA' 9-max Seat #4 is the button
Seat 1: H5Se03ZqSX7tbULXur2MAg ($17.55 in chips) 
Seat 2: N8muFAHrFHW6elSMGuyVLQ ($25.35 in chips) 
Seat 3: xoBFd/5k+L/pFn9VW1VyWg ($10.10 in chips) 
Seat 4: V6p0jQ/RhUsqpHLmXvEX4Q ($16.90 in chips) 
Seat 6: RCqMONFrSPSArZh2Jsar/w ($20.10 in chips) 
Seat 7: Bb42QRQMhg5/Y0vHP8/2Xw ($25 in chips) 
Seat 8: B6xHiX1SJkS0CUNCKDVwuQ ($20.90 in chips) 
Seat 9: yyG4svzOpC1A+sUP/scg6w ($7.50 in chips) 
RCqMONFrSPSArZh2Jsar/w: posts small blind $0.10
Bb42QRQMhg5/Y0vHP8/2Xw: posts big blind $0.25
*** HOLE CARDS ***
B6xHiX1SJkS0CUNCKDVwuQ: folds 
yyG4svzOpC1A+sUP/scg6w: folds 
H5Se03ZqSX7tbULXur2MAg: raises $0.75 to $1
N8muFAHrFHW6elSMGuyVLQ: folds 
xoBFd/5k+L/pFn9VW1VyWg: folds 
V6p0jQ/RhUsqpHLmXvEX4Q: calls $1
RCqMONFrSPSArZh2Jsar/w: folds 
Bb42QRQMhg5/Y0vHP8/2Xw: folds 
*** FLOP *** [5d 3h 2h]
H5Se03ZqSX7tbULXur2MAg: bets $1.75
V6p0jQ/RhUsqpHLmXvEX4Q: calls $1.75
*** TURN *** [5d 3h 2h] [9h]
H5Se03ZqSX7tbULXur2MAg: checks 
V6p0jQ/RhUsqpHLmXvEX4Q: bets $4
H5Se03ZqSX7tbULXur2MAg: folds 
Uncalled bet ($4) returned to V6p0jQ/RhUsqpHLmXvEX4Q
V6p0jQ/RhUsqpHLmXvEX4Q collected $5.60 from pot
*** SUMMARY ***
Total pot $5.85 | Rake $0.25 
Board [5d 3h 2h 9h]
Seat 1: H5Se03ZqSX7tbULXur2MAg folded on the Turn
Seat 2: N8muFAHrFHW6elSMGuyVLQ folded before Flop (didn't bet)
Seat 3: xoBFd/5k+L/pFn9VW1VyWg folded before Flop (didn't bet)
Seat 4: V6p0jQ/RhUsqpHLmXvEX4Q (button) collected ($5.60)
Seat 6: RCqMONFrSPSArZh2Jsar/w (small blind) folded before Flop
Seat 7: Bb42QRQMhg5/Y0vHP8/2Xw (big blind) folded before Flop
Seat 8: B6xHiX1SJkS0CUNCKDVwuQ folded before Flop (didn't bet)
Seat 9: yyG4svzOpC1A+sUP/scg6w folded before Flop (didn't bet)




PokerStars Game #59941767250:  Hold'em No Limit ($0.10/$0.25) - 2009/07/01 1:45:30 ET
Table 'HzFR0rxmDAPu5GzYR0AlYg' 6-max Seat #1 is the button
Seat 1: v+QfkGiuj9bgtuNoVnDO8w ($31.05 in chips) 
Seat 2: UA5OsKS3VPaxa7uC8La/kA ($51 in chips) 
Seat 3: kG34n23qFQA3nzdOJTQ1dA ($25.15 in chips) 
Seat 5: lquriepNQBhDV5P1SWHhnA ($29.85 in chips) 
Seat 6: jp34e617tIzV8tKIWmfAbA ($35.55 in chips) 
UA5OsKS3VPaxa7uC8La/kA: posts small blind $0.10
kG34n23qFQA3nzdOJTQ1dA: posts big blind $0.25
Mhj3q7cxev+XjXZxEE6/Cw: sits out 
*** HOLE CARDS ***
lquriepNQBhDV5P1SWHhnA: folds 
jp34e617tIzV8tKIWmfAbA: folds 
v+QfkGiuj9bgtuNoVnDO8w: raises $0.75 to $1
UA5OsKS3VPaxa7uC8La/kA: folds 
kG34n23qFQA3nzdOJTQ1dA: calls $0.75
*** FLOP *** [7h 5c Jc]
kG34n23qFQA3nzdOJTQ1dA: checks 
v+QfkGiuj9bgtuNoVnDO8w: bets $1.50
kG34n23qFQA3nzdOJTQ1dA: folds 
Uncalled bet ($1.50) returned to v+QfkGiuj9bgtuNoVnDO8w
v+QfkGiuj9bgtuNoVnDO8w collected $2 from pot
v+QfkGiuj9bgtuNoVnDO8w: doesn't show hand 
*** SUMMARY ***
Total pot $2.10 | Rake $0.10 
Board [7h 5c Jc]
Seat 1: v+QfkGiuj9bgtuNoVnDO8w (button) collected ($2)
Seat 2: UA5OsKS3VPaxa7uC8La/kA (small blind) folded before Flop
Seat 3: kG34n23qFQA3nzdOJTQ1dA (big blind) folded on the Flop
Seat 5: lquriepNQBhDV5P1SWHhnA folded before Flop (didn't bet)
Seat 6: jp34e617tIzV8tKIWmfAbA folded before Flop (didn't bet)




PokerStars Game #59941767440:  Hold'em No Limit ($0.10/$0.25) - 2009/07/01 1:45:30 ET
Table '2clPgY3+dETPD/8zjXZdFw' 6-max Seat #3 is the button
Seat 1: 4WFKzsjLSGnvHbVxKabsvQ ($30.70 in chips) 
Seat 2: cWc85bEzdRzpUMhRKm8pwQ ($25.45 in chips) 
Seat 3: SFmT9ZsVopnukjvAzrxTRg ($26 in chips) 
Seat 4: ljjhtb6FVPTx9AT9HNdtqg ($25 in chips) 
Seat 5: LJI7A1YgDM7hgh7o56+ReQ ($29.90 in chips) 
ljjhtb6FVPTx9AT9HNdtqg: posts small blind $0.10
LJI7A1YgDM7hgh7o56+ReQ: posts big blind $0.25
*** HOLE CARDS ***
4WFKzsjLSGnvHbVxKabsvQ: folds 
cWc85bEzdRzpUMhRKm8pwQ: folds 
SFmT9ZsVopnukjvAzrxTRg: folds 
ljjhtb6FVPTx9AT9HNdtqg: raises $0.50 to $0.75
LJI7A1YgDM7hgh7o56+ReQ: folds 
Uncalled bet ($0.50) returned to ljjhtb6FVPTx9AT9HNdtqg
ljjhtb6FVPTx9AT9HNdtqg collected $0.50 from pot
ljjhtb6FVPTx9AT9HNdtqg: doesn't show hand 
*** SUMMARY ***
Total pot $0.50 | Rake $0 
Seat 1: 4WFKzsjLSGnvHbVxKabsvQ folded before Flop (didn't bet)
Seat 2: cWc85bEzdRzpUMhRKm8pwQ folded before Flop (didn't bet)
Seat 3: SFmT9ZsVopnukjvAzrxTRg (button) folded before Flop (didn't bet)
Seat 4: ljjhtb6FVPTx9AT9HNdtqg (small blind) collected ($0.50)
Seat 5: LJI7A1YgDM7hgh7o56+ReQ (big blind) folded before Flop




PokerStars Game #59941767432:  Hold'em No Limit ($0.10/$0.25) - 2009/07/01 1:45:30 ET
Table 'edvgY2YQ1I34euq4EVqGnA' 6-max Seat #1 is the button
Seat 1: mvFHK3pE7tCxJEqLjKC70Q ($24.90 in chips) 
Seat 2: Hsvkc0/G2VV78oVmWYXecw ($5 in chips) 
Seat 3: mFv3iBCtrw9XfCDRB0d46Q ($3.55 in chips) 
Seat 4: TI/C5Q+DEl4fLR3AofwYdg ($22.15 in chips) 
Seat 5: EE16Ua5b1HSsYej5zeXOlA ($57.10 in chips) 
Seat 6: kG34n23qFQA3nzdOJTQ1dA ($71.35 in chips) 
Hsvkc0/G2VV78oVmWYXecw: posts small blind $0.10
mFv3iBCtrw9XfCDRB0d46Q: posts big blind $0.25
*** HOLE CARDS ***
TI/C5Q+DEl4fLR3AofwYdg: raises $0.75 to $1
EE16Ua5b1HSsYej5zeXOlA: folds 
kG34n23qFQA3nzdOJTQ1dA: folds 
mvFHK3pE7tCxJEqLjKC70Q: folds 
Hsvkc0/G2VV78oVmWYXecw: folds 
mFv3iBCtrw9XfCDRB0d46Q: folds 
Uncalled bet ($0.75) returned to TI/C5Q+DEl4fLR3AofwYdg
TI/C5Q+DEl4fLR3AofwYdg collected $0.60 from pot
TI/C5Q+DEl4fLR3AofwYdg: doesn't show hand 
*** SUMMARY ***
Total pot $0.60 | Rake $0 
Seat 1: mvFHK3pE7tCxJEqLjKC70Q (button) folded before Flop (didn't bet)
Seat 2: Hsvkc0/G2VV78oVmWYXecw (small blind) folded before Flop
Seat 3: mFv3iBCtrw9XfCDRB0d46Q (big blind) folded before Flop
Seat 4: TI/C5Q+DEl4fLR3AofwYdg collected ($0.60)
Seat 5: EE16Ua5b1HSsYej5zeXOlA folded before Flop (didn't bet)
Seat 6: kG34n23qFQA3nzdOJTQ1dA folded before Flop (didn't bet)




PokerStars Game #59941767134:  Hold'em No Limit ($0.10/$0.25) - 2009/07/01 1:45:30 ET
Table 'JPFXJXa5xBkjZ/W15BKqeQ' 9-max Seat #3 is the button
Seat 1: mNQH7Afv3tbDKl2tAb9BOg ($19.25 in chips) 
Seat 2: XMSS6mD5B42I8wasdOMipQ ($12.75 in chips) 
Seat 3: 56S3mA6Zs3pGR+0p0vUCtg ($19.20 in chips) 
Seat 4: wGigCmBR/9XWkPpvYos3aQ ($26.50 in chips) 
Seat 5: cZ99hugmLBj9KhTlc8nCSw ($25.60 in chips) 
Seat 6: tLcDklc2rBORNfixyRfVfw ($25.35 in chips) 
wGigCmBR/9XWkPpvYos3aQ: posts small blind $0.10
cZ99hugmLBj9KhTlc8nCSw: posts big blind $0.25
PdIasPkzm2sqZnN41ZRXOg: sits out 
V6p0jQ/RhUsqpHLmXvEX4Q: sits out 
*** HOLE CARDS ***
tLcDklc2rBORNfixyRfVfw: folds 
mNQH7Afv3tbDKl2tAb9BOg: raises $0.50 to $0.75
XMSS6mD5B42I8wasdOMipQ: folds 
56S3mA6Zs3pGR+0p0vUCtg: folds 
wGigCmBR/9XWkPpvYos3aQ: folds 
cZ99hugmLBj9KhTlc8nCSw: folds 
Uncalled bet ($0.50) returned to mNQH7Afv3tbDKl2tAb9BOg
mNQH7Afv3tbDKl2tAb9BOg collected $0.60 from pot
mNQH7Afv3tbDKl2tAb9BOg: doesn't show hand 
*** SUMMARY ***
Total pot $0.60 | Rake $0 
Seat 1: mNQH7Afv3tbDKl2tAb9BOg collected ($0.60)
Seat 2: XMSS6mD5B42I8wasdOMipQ folded before Flop (didn't bet)
Seat 3: 56S3mA6Zs3pGR+0p0vUCtg (button) folded before Flop (didn't bet)
Seat 4: wGigCmBR/9XWkPpvYos3aQ (small blind) folded before Flop
Seat 5: cZ99hugmLBj9KhTlc8nCSw (big blind) folded before Flop
Seat 6: tLcDklc2rBORNfixyRfVfw folded before Flop (didn't bet)




PokerStars Game #59941767180:  Hold'em No Limit ($0.10/$0.25) - 2009/07/01 1:45:30 ET
Table 'Qk/910N2Yhg8u5vqTJk50Q' 9-max Seat #2 is the button
Seat 2: Th3FldXKQW6hWVVPahaoOQ ($45.05 in chips) 
Seat 3: ghNKXUBl/H+t83JF079ZBA ($25.75 in chips) 
Seat 5: zReBEigsxqZnag0RZAgpgA ($15.25 in chips) 
Seat 6: nAWaA+gDUSWOad+I9mKUEg ($11.35 in chips) 
Seat 7: aNpwfA31EREwO+ar4XzBCw ($26.35 in chips) 
Seat 8: 9PMD136+PrUsTwnP6fczyA ($12.65 in chips) 
Seat 9: M2QO2DxB5Wawg2h8HSpnYA ($17.70 in chips) 
ghNKXUBl/H+t83JF079ZBA: posts small blind $0.10
zReBEigsxqZnag0RZAgpgA: posts big blind $0.25
*** HOLE CARDS ***
nAWaA+gDUSWOad+I9mKUEg: folds 
Vegaas leaves the table
aNpwfA31EREwO+ar4XzBCw: folds 
9PMD136+PrUsTwnP6fczyA: calls $0.25
M2QO2DxB5Wawg2h8HSpnYA: folds 
nAWaA+gDUSWOad+I9mKUEg leaves the table
Th3FldXKQW6hWVVPahaoOQ: folds 
ghNKXUBl/H+t83JF079ZBA: folds 
zReBEigsxqZnag0RZAgpgA: checks 
*** FLOP *** [Tc Js 5c]
zReBEigsxqZnag0RZAgpgA: checks 
9PMD136+PrUsTwnP6fczyA: bets $0.25
zReBEigsxqZnag0RZAgpgA: folds 
Uncalled bet ($0.25) returned to 9PMD136+PrUsTwnP6fczyA
9PMD136+PrUsTwnP6fczyA collected $0.60 from pot
9PMD136+PrUsTwnP6fczyA: shows [5d Ah] (a pair of Fives)
*** SUMMARY ***
Total pot $0.60 | Rake $0 
Board [Tc Js 5c]
Seat 2: Th3FldXKQW6hWVVPahaoOQ (button) folded before Flop (didn't bet)
Seat 3: ghNKXUBl/H+t83JF079ZBA (small blind) folded before Flop
Seat 5: zReBEigsxqZnag0RZAgpgA (big blind) folded on the Flop
Seat 6: nAWaA+gDUSWOad+I9mKUEg folded before Flop (didn't bet)
Seat 7: aNpwfA31EREwO+ar4XzBCw folded before Flop (didn't bet)
Seat 8: 9PMD136+PrUsTwnP6fczyA collected ($0.60)
Seat 9: M2QO2DxB5Wawg2h8HSpnYA folded before Flop (didn't bet)




PokerStars Game #59941767878:  Hold'em No Limit ($0.10/$0.25) - 2009/07/01 1:45:31 ET
Table 'dVzscin98UhGisTmV9BDcw' 9-max Seat #4 is the button
Seat 1: sBAwXpkpgyhyWbHIQcIJKA ($17.30 in chips) 
Seat 2: dfNim92Z6XK1/h5SFW5vDg ($28 in chips) 
Seat 3: cZ99hugmLBj9KhTlc8nCSw ($25 in chips) 
Seat 4: aNpwfA31EREwO+ar4XzBCw ($42.25 in chips) 
Seat 7: cKlmpQMahVsmOaxFQDcoOg ($24.40 in chips) 
Seat 8: /vn2Qu2dvc9AMMq46Ae0jA ($46.75 in chips) 
Seat 9: arxNSjreDRGFg13EAM2F1w ($25.35 in chips) 
E0iYnEVO2ho7dH3QcCjw7g will be allowed to play after the button
A/OkFabqdcrG3ozpiYMiNQ will be allowed to play after the button
cKlmpQMahVsmOaxFQDcoOg: posts small blind $0.10
/vn2Qu2dvc9AMMq46Ae0jA: posts big blind $0.25
*** HOLE CARDS ***
arxNSjreDRGFg13EAM2F1w: folds 
sBAwXpkpgyhyWbHIQcIJKA: folds 
dfNim92Z6XK1/h5SFW5vDg: folds 
cZ99hugmLBj9KhTlc8nCSw: folds 
aNpwfA31EREwO+ar4XzBCw: folds 
cKlmpQMahVsmOaxFQDcoOg: folds 
Uncalled bet ($0.15) returned to /vn2Qu2dvc9AMMq46Ae0jA
/vn2Qu2dvc9AMMq46Ae0jA collected $0.20 from pot
*** SUMMARY ***
Total pot $0.20 | Rake $0 
Seat 1: sBAwXpkpgyhyWbHIQcIJKA folded before Flop (didn't bet)
Seat 2: dfNim92Z6XK1/h5SFW5vDg folded before Flop (didn't bet)
Seat 3: cZ99hugmLBj9KhTlc8nCSw folded before Flop (didn't bet)
Seat 4: aNpwfA31EREwO+ar4XzBCw (button) folded before Flop (didn't bet)
Seat 7: cKlmpQMahVsmOaxFQDcoOg (small blind) folded before Flop
Seat 8: /vn2Qu2dvc9AMMq46Ae0jA (big blind) collected ($0.20)
Seat 9: arxNSjreDRGFg13EAM2F1w folded before Flop (didn't bet)




PokerStars Game #59941767754:  Hold'em No Limit ($0.10/$0.25) - 2009/07/01 1:45:31 ET
Table 'oZuNsbNJuUyQLGKzQ/4JFg' 6-max Seat #6 is the button
Seat 1: vqWjZmdQu/Hxw96/IJTWdQ ($25.45 in chips) 
Seat 2: UA5OsKS3VPaxa7uC8La/kA ($34.50 in chips) 
Seat 3: 8ClCHtFXGNplITm+63KB+Q ($51 in chips) 
Seat 4: 9bpVv1/Qh9IYtXuCtl5VtQ ($25.80 in chips) 
Seat 5: oBUDUfeUyCbZBsjxHZgSiw ($25.90 in chips) 
Seat 6: fwg6dK1+r4jy/y+JqenYYQ ($13.80 in chips) 
vqWjZmdQu/Hxw96/IJTWdQ: posts small blind $0.10
UA5OsKS3VPaxa7uC8La/kA: posts big blind $0.25
*** HOLE CARDS ***
8ClCHtFXGNplITm+63KB+Q: folds 
9bpVv1/Qh9IYtXuCtl5VtQ: folds 
oBUDUfeUyCbZBsjxHZgSiw: raises $0.75 to $1
fwg6dK1+r4jy/y+JqenYYQ: folds 
vqWjZmdQu/Hxw96/IJTWdQ: folds 
UA5OsKS3VPaxa7uC8La/kA: folds 
Uncalled bet ($0.75) returned to oBUDUfeUyCbZBsjxHZgSiw
oBUDUfeUyCbZBsjxHZgSiw collected $0.60 from pot
*** SUMMARY ***
Total pot $0.60 | Rake $0 
Seat 1: vqWjZmdQu/Hxw96/IJTWdQ (small blind) folded before Flop
Seat 2: UA5OsKS3VPaxa7uC8La/kA (big blind) folded before Flop
Seat 3: 8ClCHtFXGNplITm+63KB+Q folded before Flop (didn't bet)
Seat 4: 9bpVv1/Qh9IYtXuCtl5VtQ folded before Flop (didn't bet)
Seat 5: oBUDUfeUyCbZBsjxHZgSiw collected ($0.60)
Seat 6: fwg6dK1+r4jy/y+JqenYYQ (button) folded before Flop (didn't bet)




PokerStars Game #59941767462:  Hold'em No Limit ($0.10/$0.25) - 2009/07/01 1:45:31 ET
Table 'nlpa8xI95gAflovnFxB2yg' 6-max Seat #6 is the button
Seat 1: fZQg9veL7Dd/Z04ZTjC+wQ ($61.90 in chips) 
Seat 2: Yuyy/pDz3yAO3EbHYRYnKw ($24.40 in chips) 
Seat 3: DihMHaz4WNETH1bPDe13kA ($25 in chips) 
Seat 4: if4dh6jhJXeN3/qd3qCp9g ($52.35 in chips) 
Seat 5: FDWzjQgBA5K04jOIY/j22w ($5.80 in chips) 
Seat 6: ATNFxN8fYVfSZMQW8dvbvw ($5.30 in chips) 
fZQg9veL7Dd/Z04ZTjC+wQ: posts small blind $0.10
Yuyy/pDz3yAO3EbHYRYnKw: posts big blind $0.25
*** HOLE CARDS ***
DihMHaz4WNETH1bPDe13kA: folds 
if4dh6jhJXeN3/qd3qCp9g: folds 
FDWzjQgBA5K04jOIY/j22w: folds 
ATNFxN8fYVfSZMQW8dvbvw: raises $0.50 to $0.75
fZQg9veL7Dd/Z04ZTjC+wQ: folds 
Yuyy/pDz3yAO3EbHYRYnKw: folds 
Uncalled bet ($0.50) returned to ATNFxN8fYVfSZMQW8dvbvw
ATNFxN8fYVfSZMQW8dvbvw collected $0.60 from pot
ATNFxN8fYVfSZMQW8dvbvw: doesn't show hand 
*** SUMMARY ***
Total pot $0.60 | Rake $0 
Seat 1: fZQg9veL7Dd/Z04ZTjC+wQ (small blind) folded before Flop
Seat 2: Yuyy/pDz3yAO3EbHYRYnKw (big blind) folded before Flop
Seat 3: DihMHaz4WNETH1bPDe13kA folded before Flop (didn't bet)
Seat 4: if4dh6jhJXeN3/qd3qCp9g folded before Flop (didn't bet)
Seat 5: FDWzjQgBA5K04jOIY/j22w folded before Flop (didn't bet)
Seat 6: ATNFxN8fYVfSZMQW8dvbvw (button) collected ($0.60)




PokerStars Game #59941767640:  Hold'em No Limit ($0.10/$0.25) - 2009/07/01 1:45:31 ET
Table 'Mef6A0EMopL6WaFO5/KO9g' 6-max Seat #5 is the button
Seat 1: GbCVUNssQ7mqsPWr7J4d3w ($4.30 in chips) 
Seat 2: 8ClCHtFXGNplITm+63KB+Q ($29.90 in chips) 
Seat 3: Wq26opBLDGJe91GRJn2epg ($18.20 in chips) 
Seat 4: lquriepNQBhDV5P1SWHhnA ($25 in chips) 
Seat 5: DihMHaz4WNETH1bPDe13kA ($25 in chips) 
Seat 6: jp34e617tIzV8tKIWmfAbA ($33.40 in chips) 
jp34e617tIzV8tKIWmfAbA: posts small blind $0.10
GbCVUNssQ7mqsPWr7J4d3w: posts big blind $0.25
*** HOLE CARDS ***
8ClCHtFXGNplITm+63KB+Q: folds 
Wq26opBLDGJe91GRJn2epg: folds 
lquriepNQBhDV5P1SWHhnA: folds 
DihMHaz4WNETH1bPDe13kA: folds 
jp34e617tIzV8tKIWmfAbA: folds 
Uncalled bet ($0.15) returned to GbCVUNssQ7mqsPWr7J4d3w
GbCVUNssQ7mqsPWr7J4d3w collected $0.20 from pot
GbCVUNssQ7mqsPWr7J4d3w: doesn't show hand 
*** SUMMARY ***
Total pot $0.20 | Rake $0 
Seat 1: GbCVUNssQ7mqsPWr7J4d3w (big blind) collected ($0.20)
Seat 2: 8ClCHtFXGNplITm+63KB+Q folded before Flop (didn't bet)
Seat 3: Wq26opBLDGJe91GRJn2epg folded before Flop (didn't bet)
Seat 4: lquriepNQBhDV5P1SWHhnA folded before Flop (didn't bet)
Seat 5: DihMHaz4WNETH1bPDe13kA (button) folded before Flop (didn't bet)
Seat 6: jp34e617tIzV8tKIWmfAbA (small blind) folded before Flop




PokerStars Game #59941767618:  Hold'em No Limit ($0.10/$0.25) - 2009/07/01 1:45:31 ET
Table 'jItkp2PNTbH9Cf7gqsAF7g' 9-max Seat #4 is the button
Seat 1: wGigCmBR/9XWkPpvYos3aQ ($26.85 in chips) 
Seat 2: qwr38jl5txoR36M7G5qi4A ($7.95 in chips) 
Seat 3: 0YaJElQVLqWThIZnqq3w1g ($14.10 in chips) 
Seat 4: oJOvZw/Iayou0f0k6dkBhg ($5.60 in chips) 
Seat 5: NO6qGDOw12lhu3zh1xW3Bg ($19.30 in chips) 
Seat 6: cZ99hugmLBj9KhTlc8nCSw ($53 in chips) 
Seat 8: cq6LACCDFivk2+PeoiB2sw ($6.65 in chips) 
Seat 9: dtZ84flFEi4Q+SGrHMJRDQ ($25.15 in chips) 
NO6qGDOw12lhu3zh1xW3Bg: posts small blind $0.10
cZ99hugmLBj9KhTlc8nCSw: posts big blind $0.25
*** HOLE CARDS ***
cq6LACCDFivk2+PeoiB2sw: folds 
dtZ84flFEi4Q+SGrHMJRDQ: folds 
wGigCmBR/9XWkPpvYos3aQ: folds 
qwr38jl5txoR36M7G5qi4A: folds 
0YaJElQVLqWThIZnqq3w1g: calls $0.25
oJOvZw/Iayou0f0k6dkBhg: calls $0.25
NO6qGDOw12lhu3zh1xW3Bg: raises $0.50 to $0.75
cZ99hugmLBj9KhTlc8nCSw: folds 
0YaJElQVLqWThIZnqq3w1g: calls $0.50
oJOvZw/Iayou0f0k6dkBhg: calls $0.50
*** FLOP *** [Qd 8c Jh]
NO6qGDOw12lhu3zh1xW3Bg: bets $0.75
0YaJElQVLqWThIZnqq3w1g: calls $0.75
oJOvZw/Iayou0f0k6dkBhg: folds 
*** TURN *** [Qd 8c Jh] [Ac]
NO6qGDOw12lhu3zh1xW3Bg: bets $1
0YaJElQVLqWThIZnqq3w1g: folds 
Uncalled bet ($1) returned to NO6qGDOw12lhu3zh1xW3Bg
NO6qGDOw12lhu3zh1xW3Bg collected $3.85 from pot
NO6qGDOw12lhu3zh1xW3Bg: doesn't show hand 
*** SUMMARY ***
Total pot $4 | Rake $0.15 
Board [Qd 8c Jh Ac]
Seat 1: wGigCmBR/9XWkPpvYos3aQ folded before Flop (didn't bet)
Seat 2: qwr38jl5txoR36M7G5qi4A folded before Flop (didn't bet)
Seat 3: 0YaJElQVLqWThIZnqq3w1g folded on the Turn
Seat 4: oJOvZw/Iayou0f0k6dkBhg (button) folded on the Flop
Seat 5: NO6qGDOw12lhu3zh1xW3Bg (small blind) collected ($3.85)
Seat 6: cZ99hugmLBj9KhTlc8nCSw (big blind) folded before Flop
Seat 8: cq6LACCDFivk2+PeoiB2sw folded before Flop (didn't bet)
Seat 9: dtZ84flFEi4Q+SGrHMJRDQ folded before Flop (didn't bet)




PokerStars Game #59941767784:  Hold'em No Limit ($0.10/$0.25) - 2009/07/01 1:45:31 ET
Table 'rpIHGyt2QpgQc5bvptAvDQ' 9-max Seat #7 is the button
Seat 2: FX0yWp7Ul3dMebXB0cFjEw ($4.95 in chips) 
Seat 3: N6a/f6AW8S8G3JFw9IFxAg ($9.75 in chips) 
Seat 4: ASXDkj9tmvF/T2AsNuxg7g ($6.20 in chips) 
Seat 5: XhSvfX1gy0yx/qeW+SOeTw ($9.30 in chips) 
Seat 6: Mq1ESwxx3LEsA4HjKKjU3Q ($18.90 in chips) 
Seat 7: GHgIdzlzMAmRmmX7jgXtuQ ($4.75 in chips) 
Seat 8: oUgIL46CfA9GCdIuN1TVSw ($9.45 in chips) 
Seat 9: HQMjiff9S04k8kyC4fHVgw ($5 in chips) 
oUgIL46CfA9GCdIuN1TVSw: posts small blind $0.10
HQMjiff9S04k8kyC4fHVgw: posts big blind $0.25
E0iYnEVO2ho7dH3QcCjw7g: sits out 
*** HOLE CARDS ***
FX0yWp7Ul3dMebXB0cFjEw: calls $0.25
N6a/f6AW8S8G3JFw9IFxAg: calls $0.25
ASXDkj9tmvF/T2AsNuxg7g: folds 
XhSvfX1gy0yx/qeW+SOeTw: folds 
Mq1ESwxx3LEsA4HjKKjU3Q: folds 
GHgIdzlzMAmRmmX7jgXtuQ: calls $0.25
oUgIL46CfA9GCdIuN1TVSw: calls $0.15
HQMjiff9S04k8kyC4fHVgw: raises $0.75 to $1
FX0yWp7Ul3dMebXB0cFjEw: calls $0.75
N6a/f6AW8S8G3JFw9IFxAg: calls $0.75
GHgIdzlzMAmRmmX7jgXtuQ: calls $0.75
oUgIL46CfA9GCdIuN1TVSw: folds 
*** FLOP *** [2s 3d 4s]
HQMjiff9S04k8kyC4fHVgw: bets $4 and is all-in
FX0yWp7Ul3dMebXB0cFjEw: folds 
N6a/f6AW8S8G3JFw9IFxAg: calls $4
GHgIdzlzMAmRmmX7jgXtuQ: folds 
*** TURN *** [2s 3d 4s] [As]
*** RIVER *** [2s 3d 4s As] [4d]
*** SHOW DOWN ***
HQMjiff9S04k8kyC4fHVgw: shows [Ts Td] (two pair, Tens and Fours)
N6a/f6AW8S8G3JFw9IFxAg: shows [7h 5h] (a straight, Ace to Five)
N6a/f6AW8S8G3JFw9IFxAg collected $11.65 from pot
*** SUMMARY ***
Total pot $12.25 | Rake $0.60 
Board [2s 3d 4s As 4d]
Seat 2: FX0yWp7Ul3dMebXB0cFjEw folded on the Flop
Seat 3: N6a/f6AW8S8G3JFw9IFxAg showed [7h 5h] and won ($11.65) with a straight, Ace to Five
Seat 4: ASXDkj9tmvF/T2AsNuxg7g folded before Flop (didn't bet)
Seat 5: XhSvfX1gy0yx/qeW+SOeTw folded before Flop (didn't bet)
Seat 6: Mq1ESwxx3LEsA4HjKKjU3Q folded before Flop (didn't bet)
Seat 7: GHgIdzlzMAmRmmX7jgXtuQ (button) folded on the Flop
Seat 8: oUgIL46CfA9GCdIuN1TVSw (small blind) folded before Flop
Seat 9: HQMjiff9S04k8kyC4fHVgw (big blind) showed [Ts Td] and lost with two pair, Tens and Fours




PokerStars Game #59941767734:  Hold'em No Limit ($0.10/$0.25) - 2009/07/01 1:45:31 ET
Table 'sJ4KpS2GE5Qrsu1/cFjJUw' 9-max Seat #6 is the button
Seat 1: eDlQ+S+6L4e6gM1dkZhGgQ ($18.45 in chips) 
Seat 2: tYsOBqdU1+x+yFI7zHO7hQ ($31.75 in chips) 
Seat 3: eK8qa6EPcH2zhtbmWSvc9g ($25 in chips) 
Seat 4: npAYqa85pqnzfOK5ukX+BQ ($25 in chips) 
Seat 5: Q/gZC63lfOMr7YhWKPCxoQ ($8.85 in chips) 
Seat 6: OefE+Csvj5KR7ClGf3Hc2g ($4.35 in chips) 
Seat 7: Wi8djHgewBlVhpKWfp7isQ ($8.10 in chips) 
Seat 8: S7Ki0P+0AIGPuIfGJjW0gg ($29.70 in chips) 
Seat 9: 3PmVnC/15cl4oyI1TKIt4g ($4.75 in chips) 
Wi8djHgewBlVhpKWfp7isQ: posts small blind $0.10
S7Ki0P+0AIGPuIfGJjW0gg: posts big blind $0.25
*** HOLE CARDS ***
3PmVnC/15cl4oyI1TKIt4g: folds 
eDlQ+S+6L4e6gM1dkZhGgQ: folds 
tYsOBqdU1+x+yFI7zHO7hQ: folds 
eK8qa6EPcH2zhtbmWSvc9g: folds 
npAYqa85pqnzfOK5ukX+BQ: raises $0.75 to $1
Q/gZC63lfOMr7YhWKPCxoQ: folds 
OefE+Csvj5KR7ClGf3Hc2g: folds 
Wi8djHgewBlVhpKWfp7isQ: folds 
S7Ki0P+0AIGPuIfGJjW0gg: calls $0.75
*** FLOP *** [4d 3d Jh]
S7Ki0P+0AIGPuIfGJjW0gg: bets $1
npAYqa85pqnzfOK5ukX+BQ: folds 
Uncalled bet ($1) returned to S7Ki0P+0AIGPuIfGJjW0gg
S7Ki0P+0AIGPuIfGJjW0gg collected $2 from pot
S7Ki0P+0AIGPuIfGJjW0gg: doesn't show hand 
*** SUMMARY ***
Total pot $2.10 | Rake $0.10 
Board [4d 3d Jh]
Seat 1: eDlQ+S+6L4e6gM1dkZhGgQ folded before Flop (didn't bet)
Seat 2: tYsOBqdU1+x+yFI7zHO7hQ folded before Flop (didn't bet)
Seat 3: eK8qa6EPcH2zhtbmWSvc9g folded before Flop (didn't bet)
Seat 4: npAYqa85pqnzfOK5ukX+BQ folded on the Flop
Seat 5: Q/gZC63lfOMr7YhWKPCxoQ folded before Flop (didn't bet)
Seat 6: OefE+Csvj5KR7ClGf3Hc2g (button) folded before Flop (didn't bet)
Seat 7: Wi8djHgewBlVhpKWfp7isQ (small blind) folded before Flop
Seat 8: S7Ki0P+0AIGPuIfGJjW0gg (big blind) collected ($2)
Seat 9: 3PmVnC/15cl4oyI1TKIt4g folded before Flop (didn't bet)




PokerStars Game #59941767490:  Hold'em No Limit ($0.10/$0.25) - 2009/07/01 1:45:31 ET
Table 'KYX9dFNuOA9l2PV46IebqQ' 9-max Seat #9 is the button
Seat 1: qZqVFan2U+GAA/c5LQFbcw ($9.75 in chips) 
Seat 2: z2SmIaQ3+5n/eY1BN5HgPg ($6.25 in chips) 
Seat 3: Uq3NSX4cIFaXe7pbXQuU+Q ($2.55 in chips) 
Seat 4: rPXwQUVloUl+qZm3CCtaJw ($8.80 in chips) 
Seat 5: g7MXhRmNZxv1lIkKkUKa4w ($13 in chips) 
Seat 6: 4QYM+pWPc3J+6i8Zv8LvLg ($13.05 in chips) 
Seat 7: FVZtQJMz59M6BoiON/88Xg ($14.85 in chips) 
Seat 8: KRWTiGM4xH+MkvPtJz4+SA ($24.65 in chips) 
Seat 9: 6NECk10orj8iqgD3pZ2A0Q ($5 in chips) 
qZqVFan2U+GAA/c5LQFbcw: posts small blind $0.10
z2SmIaQ3+5n/eY1BN5HgPg: posts big blind $0.25
*** HOLE CARDS ***
Uq3NSX4cIFaXe7pbXQuU+Q: raises $2.30 to $2.55 and is all-in
rPXwQUVloUl+qZm3CCtaJw: calls $2.55
qZqVFan2U+GAA/c5LQFbcw said, "what a foken joke"
g7MXhRmNZxv1lIkKkUKa4w: folds 
4QYM+pWPc3J+6i8Zv8LvLg: calls $2.55
FVZtQJMz59M6BoiON/88Xg: folds 
KRWTiGM4xH+MkvPtJz4+SA: folds 
6NECk10orj8iqgD3pZ2A0Q: folds 
qZqVFan2U+GAA/c5LQFbcw: folds 
z2SmIaQ3+5n/eY1BN5HgPg: folds 
*** FLOP *** [Qh Td Ac]
rPXwQUVloUl+qZm3CCtaJw: bets $6.25 and is all-in
4QYM+pWPc3J+6i8Zv8LvLg: calls $6.25
*** TURN *** [Qh Td Ac] [As]
*** RIVER *** [Qh Td Ac As] [7d]
*** SHOW DOWN ***
rPXwQUVloUl+qZm3CCtaJw: shows [Tc Qc] (two pair, Aces and Queens)
4QYM+pWPc3J+6i8Zv8LvLg: shows [Ah Jh] (three of a kind, Aces)
4QYM+pWPc3J+6i8Zv8LvLg collected $11.90 from side pot
Uq3NSX4cIFaXe7pbXQuU+Q: shows [Kc Jc] (a straight, Ten to Ace)
Uq3NSX4cIFaXe7pbXQuU+Q collected $7.60 from main pot
*** SUMMARY ***
Total pot $20.50 Main pot $7.60. Side pot $11.90. | Rake $1 
Board [Qh Td Ac As 7d]
Seat 1: qZqVFan2U+GAA/c5LQFbcw (small blind) folded before Flop
Seat 2: z2SmIaQ3+5n/eY1BN5HgPg (big blind) folded before Flop
Seat 3: Uq3NSX4cIFaXe7pbXQuU+Q showed [Kc Jc] and won ($7.60) with a straight, Ten to Ace
Seat 4: rPXwQUVloUl+qZm3CCtaJw showed [Tc Qc] and lost with two pair, Aces and Queens
Seat 5: g7MXhRmNZxv1lIkKkUKa4w folded before Flop (didn't bet)
Seat 6: 4QYM+pWPc3J+6i8Zv8LvLg showed [Ah Jh] and won ($11.90) with three of a kind, Aces
Seat 7: FVZtQJMz59M6BoiON/88Xg folded before Flop (didn't bet)
Seat 8: KRWTiGM4xH+MkvPtJz4+SA folded before Flop (didn't bet)
Seat 9: 6NECk10orj8iqgD3pZ2A0Q (button) folded before Flop (didn't bet)




PokerStars Game #59941768438:  Hold'em No Limit ($0.10/$0.25) - 2009/07/01 1:45:32 ET
Table 'mdub7rJf3Z5tCT9s/+1+Wg' 9-max Seat #1 is the button
Seat 1: cZ99hugmLBj9KhTlc8nCSw ($28.90 in chips) 
Seat 2: 539MC3AwKLWVFwzABc644Q ($10.40 in chips) 
Seat 3: PdIasPkzm2sqZnN41ZRXOg ($5.35 in chips) 
Seat 4: fDGyaQz0cs2s4FOYxkbIHA ($14.85 in chips) 
Seat 5: dfNim92Z6XK1/h5SFW5vDg ($26.25 in chips) 
Seat 6: T/CCwAWe2yhO0c4oHNwicw ($23.25 in chips) 
Seat 7: woe+9KKk+L3pZgMTuHcmog ($15.70 in chips) 
Seat 8: Z9AeOQX3yzuSvKAm/xyovg ($5.90 in chips) 
Seat 9: tYsOBqdU1+x+yFI7zHO7hQ ($36.05 in chips) 
539MC3AwKLWVFwzABc644Q: posts small blind $0.10
PdIasPkzm2sqZnN41ZRXOg: posts big blind $0.25
*** HOLE CARDS ***
fDGyaQz0cs2s4FOYxkbIHA: folds 
dfNim92Z6XK1/h5SFW5vDg: folds 
T/CCwAWe2yhO0c4oHNwicw: folds 
woe+9KKk+L3pZgMTuHcmog: calls $0.25
Z9AeOQX3yzuSvKAm/xyovg: folds 
tYsOBqdU1+x+yFI7zHO7hQ: folds 
cZ99hugmLBj9KhTlc8nCSw: folds 
539MC3AwKLWVFwzABc644Q: folds 
PdIasPkzm2sqZnN41ZRXOg: checks 
*** FLOP *** [3h 4c 5c]
PdIasPkzm2sqZnN41ZRXOg: bets $0.75
woe+9KKk+L3pZgMTuHcmog: folds 
Uncalled bet ($0.75) returned to PdIasPkzm2sqZnN41ZRXOg
PdIasPkzm2sqZnN41ZRXOg collected $0.60 from pot
PdIasPkzm2sqZnN41ZRXOg: doesn't show hand 
*** SUMMARY ***
Total pot $0.60 | Rake $0 
Board [3h 4c 5c]
Seat 1: cZ99hugmLBj9KhTlc8nCSw (button) folded before Flop (didn't bet)
Seat 2: 539MC3AwKLWVFwzABc644Q (small blind) folded before Flop
Seat 3: PdIasPkzm2sqZnN41ZRXOg (big blind) collected ($0.60)
Seat 4: fDGyaQz0cs2s4FOYxkbIHA folded before Flop (didn't bet)
Seat 5: dfNim92Z6XK1/h5SFW5vDg folded before Flop (didn't bet)
Seat 6: T/CCwAWe2yhO0c4oHNwicw folded before Flop (didn't bet)
Seat 7: woe+9KKk+L3pZgMTuHcmog folded on the Flop
Seat 8: Z9AeOQX3yzuSvKAm/xyovg folded before Flop (didn't bet)
Seat 9: tYsOBqdU1+x+yFI7zHO7hQ folded before Flop (didn't bet)




PokerStars Game #59941768222:  Hold'em No Limit ($0.10/$0.25) - 2009/07/01 1:45:32 ET
Table 'djcjiEGabFQO0MNG6jEeJQ' 9-max Seat #3 is the button
Seat 1: Bb42QRQMhg5/Y0vHP8/2Xw ($25.60 in chips) 
Seat 2: WKL8nUFr7TumC4EjLyqYzw ($5.25 in chips) 
Seat 3: zgi+EUykT/pZQpoUG6+oEg ($4.65 in chips) 
Seat 4: 2wcFsZsqEP5w1StUTVzJCg ($9.65 in chips) 
Seat 6: aNpwfA31EREwO+ar4XzBCw ($74 in chips) 
Seat 7: 56S3mA6Zs3pGR+0p0vUCtg ($35.05 in chips) 
Seat 8: +sbyWwIcFp9kP0bDtMegfQ ($51.25 in chips) 
Seat 9: HPEB+AtKw1+C/cxU0o1ciw ($46.85 in chips) 
2wcFsZsqEP5w1StUTVzJCg: posts small blind $0.10
aNpwfA31EREwO+ar4XzBCw: posts big blind $0.25
*** HOLE CARDS ***
56S3mA6Zs3pGR+0p0vUCtg: raises $1 to $1.25
+sbyWwIcFp9kP0bDtMegfQ: folds 
HPEB+AtKw1+C/cxU0o1ciw: folds 
Bb42QRQMhg5/Y0vHP8/2Xw: folds 
WKL8nUFr7TumC4EjLyqYzw: folds 
zgi+EUykT/pZQpoUG6+oEg: folds 
2wcFsZsqEP5w1StUTVzJCg: folds 
aNpwfA31EREwO+ar4XzBCw: folds 
Uncalled bet ($1) returned to 56S3mA6Zs3pGR+0p0vUCtg
56S3mA6Zs3pGR+0p0vUCtg collected $0.60 from pot
56S3mA6Zs3pGR+0p0vUCtg: doesn't show hand 
*** SUMMARY ***
Total pot $0.60 | Rake $0 
Seat 1: Bb42QRQMhg5/Y0vHP8/2Xw folded before Flop (didn't bet)
Seat 2: WKL8nUFr7TumC4EjLyqYzw folded before Flop (didn't bet)
Seat 3: zgi+EUykT/pZQpoUG6+oEg (button) folded before Flop (didn't bet)
Seat 4: 2wcFsZsqEP5w1StUTVzJCg (small blind) folded before Flop
Seat 6: aNpwfA31EREwO+ar4XzBCw (big blind) folded before Flop
Seat 7: 56S3mA6Zs3pGR+0p0vUCtg collected ($0.60)
Seat 8: +sbyWwIcFp9kP0bDtMegfQ folded before Flop (didn't bet)
Seat 9: HPEB+AtKw1+C/cxU0o1ciw folded before Flop (didn't bet)




PokerStars Game #59941768202:  Hold'em No Limit ($0.10/$0.25) - 2009/07/01 1:45:32 ET
Table 'Jz+kWRxWNGk9w24fdQEveA' 9-max Seat #9 is the button
Seat 1: Z9W7+g1WMhhZDi7DwGbCFA ($5 in chips) 
Seat 2: ljemhp25Zg+nlA9DLCIiUw ($38.85 in chips) 
Seat 4: HPEB+AtKw1+C/cxU0o1ciw ($29 in chips) 
Seat 5: d6eSA7wOH5mRaSyVDVRBLw ($11.75 in chips) 
Seat 6: BXkjaKe7T/rw37TNNtBVwQ ($5.35 in chips) 
Seat 7: wGigCmBR/9XWkPpvYos3aQ ($26.75 in chips) 
Seat 8: j4q3p0lesp63b1gZDwLBZw ($5 in chips) 
Seat 9: V6p0jQ/RhUsqpHLmXvEX4Q ($17.35 in chips) 
Z9W7+g1WMhhZDi7DwGbCFA: posts small blind $0.10
ljemhp25Zg+nlA9DLCIiUw: posts big blind $0.25
N5sUK8M0br9djLrW97V9pQ: sits out 
*** HOLE CARDS ***
HPEB+AtKw1+C/cxU0o1ciw: folds 
d6eSA7wOH5mRaSyVDVRBLw: calls $0.25
BXkjaKe7T/rw37TNNtBVwQ: folds 
wGigCmBR/9XWkPpvYos3aQ: folds 
j4q3p0lesp63b1gZDwLBZw: folds 
V6p0jQ/RhUsqpHLmXvEX4Q: folds 
Z9W7+g1WMhhZDi7DwGbCFA: folds 
ljemhp25Zg+nlA9DLCIiUw: raises $0.75 to $1
d6eSA7wOH5mRaSyVDVRBLw: calls $0.75
*** FLOP *** [4s 4h 5c]
ljemhp25Zg+nlA9DLCIiUw: checks 
d6eSA7wOH5mRaSyVDVRBLw: bets $1
ljemhp25Zg+nlA9DLCIiUw: folds 
Uncalled bet ($1) returned to d6eSA7wOH5mRaSyVDVRBLw
d6eSA7wOH5mRaSyVDVRBLw collected $2 from pot
d6eSA7wOH5mRaSyVDVRBLw: doesn't show hand 
*** SUMMARY ***
Total pot $2.10 | Rake $0.10 
Board [4s 4h 5c]
Seat 1: Z9W7+g1WMhhZDi7DwGbCFA (small blind) folded before Flop
Seat 2: ljemhp25Zg+nlA9DLCIiUw (big blind) folded on the Flop
Seat 4: HPEB+AtKw1+C/cxU0o1ciw folded before Flop (didn't bet)
Seat 5: d6eSA7wOH5mRaSyVDVRBLw collected ($2)
Seat 6: BXkjaKe7T/rw37TNNtBVwQ folded before Flop (didn't bet)
Seat 7: wGigCmBR/9XWkPpvYos3aQ folded before Flop (didn't bet)
Seat 8: j4q3p0lesp63b1gZDwLBZw folded before Flop (didn't bet)
Seat 9: V6p0jQ/RhUsqpHLmXvEX4Q (button) folded before Flop (didn't bet)




PokerStars Game #59941768190:  Hold'em No Limit ($0.10/$0.25) - 2009/07/01 1:45:32 ET
Table 'G+4ZdyRoPjgaJY/jxSlZzQ' 9-max Seat #1 is the button
Seat 1: ghNKXUBl/H+t83JF079ZBA ($23.40 in chips) 
Seat 2: CT7Xj/V/O5rBlhtt+RZeFQ ($25 in chips) 
Seat 3: FaGtAm5QUVcixGhAKIvbLg ($15.10 in chips) 
Seat 5: BT6Oal0iO4P6kDuT7HFQDw ($16.50 in chips) 
Seat 6: oFwaTjy3ok/+qFghsrcGvg ($23.30 in chips) 
Seat 7: IK3/w7XV7rd8mVIsuasjYA ($4.15 in chips) 
Seat 8: bXpVeaSTPBFSPJmeXxO7nw ($4.65 in chips) 
Seat 9: tLcDklc2rBORNfixyRfVfw ($25 in chips) 
CT7Xj/V/O5rBlhtt+RZeFQ: posts small blind $0.10
FaGtAm5QUVcixGhAKIvbLg: posts big blind $0.25
*** HOLE CARDS ***
BT6Oal0iO4P6kDuT7HFQDw: folds 
lSeLm4BdnSMLtIli62qjAQ leaves the table
oFwaTjy3ok/+qFghsrcGvg: calls $0.25
IK3/w7XV7rd8mVIsuasjYA: folds 
IK3/w7XV7rd8mVIsuasjYA leaves the table
bXpVeaSTPBFSPJmeXxO7nw: folds 
3PmVnC/15cl4oyI1TKIt4g joins the table at seat #4 
tLcDklc2rBORNfixyRfVfw: raises $1 to $1.25
ghNKXUBl/H+t83JF079ZBA: folds 
CT7Xj/V/O5rBlhtt+RZeFQ: folds 
FaGtAm5QUVcixGhAKIvbLg: calls $1
oFwaTjy3ok/+qFghsrcGvg: folds 
*** FLOP *** [Kd 9h Ac]
qwr38jl5txoR36M7G5qi4A joins the table at seat #7 
FaGtAm5QUVcixGhAKIvbLg: checks 
tLcDklc2rBORNfixyRfVfw: bets $2
FaGtAm5QUVcixGhAKIvbLg: folds 
Uncalled bet ($2) returned to tLcDklc2rBORNfixyRfVfw
tLcDklc2rBORNfixyRfVfw collected $2.75 from pot
tLcDklc2rBORNfixyRfVfw: doesn't show hand 
*** SUMMARY ***
Total pot $2.85 | Rake $0.10 
Board [Kd 9h Ac]
Seat 1: ghNKXUBl/H+t83JF079ZBA (button) folded before Flop (didn't bet)
Seat 2: CT7Xj/V/O5rBlhtt+RZeFQ (small blind) folded before Flop
Seat 3: FaGtAm5QUVcixGhAKIvbLg (big blind) folded on the Flop
Seat 5: BT6Oal0iO4P6kDuT7HFQDw folded before Flop (didn't bet)
Seat 6: oFwaTjy3ok/+qFghsrcGvg folded before Flop
Seat 7: IK3/w7XV7rd8mVIsuasjYA folded before Flop (didn't bet)
Seat 8: bXpVeaSTPBFSPJmeXxO7nw folded before Flop (didn't bet)
Seat 9: tLcDklc2rBORNfixyRfVfw collected ($2.75)




PokerStars Game #59941768414:  Hold'em No Limit ($0.10/$0.25) - 2009/07/01 1:45:32 ET
Table 'ohAuixfiLOYDylNUG5mNUw' 9-max Seat #3 is the button
Seat 2: Th3FldXKQW6hWVVPahaoOQ ($27.40 in chips) 
Seat 3: gSakoFAgDDzXSb2eNBWKcg ($14.65 in chips) 
Seat 5: wub1jsnHlpWmOX4uczVADA ($7.25 in chips) 
Seat 6: MtVtHDqIJTyUcXkRBBDIVA ($25 in chips) 
Seat 7: +qc/EYCgLC65SpGvr35eNg ($24.65 in chips) 
Seat 8: ppMlNkhYgErlt4fuJO7ADA ($2.50 in chips) 
Seat 9: CT7Xj/V/O5rBlhtt+RZeFQ ($25.60 in chips) 
AiXn/9o1EwOPZUHujnh/bA will be allowed to play after the button
wub1jsnHlpWmOX4uczVADA is connected 
wub1jsnHlpWmOX4uczVADA: posts small blind $0.10
MtVtHDqIJTyUcXkRBBDIVA: posts big blind $0.25
qwr38jl5txoR36M7G5qi4A: sits out 
*** HOLE CARDS ***
+qc/EYCgLC65SpGvr35eNg: folds 
ppMlNkhYgErlt4fuJO7ADA: calls $0.25
CT7Xj/V/O5rBlhtt+RZeFQ: folds 
AiXn/9o1EwOPZUHujnh/bA leaves the table
Th3FldXKQW6hWVVPahaoOQ: raises $1 to $1.25
gSakoFAgDDzXSb2eNBWKcg: folds 
wub1jsnHlpWmOX4uczVADA: folds 
clJsV3v77RS07bDKY+705w joins the table at seat #4 
MtVtHDqIJTyUcXkRBBDIVA: folds 
ppMlNkhYgErlt4fuJO7ADA: calls $1
*** FLOP *** [4c 3c 2c]
wub1jsnHlpWmOX4uczVADA leaves the table
ppMlNkhYgErlt4fuJO7ADA: checks 
z5GxcHlYz/GSz6W2uFiTtg joins the table at seat #5 
z5GxcHlYz/GSz6W2uFiTtg is sitting out
Th3FldXKQW6hWVVPahaoOQ: checks 
*** TURN *** [4c 3c 2c] [5d]
ppMlNkhYgErlt4fuJO7ADA: bets $1.25 and is all-in
Th3FldXKQW6hWVVPahaoOQ: folds 
Uncalled bet ($1.25) returned to ppMlNkhYgErlt4fuJO7ADA
ppMlNkhYgErlt4fuJO7ADA collected $2.75 from pot
*** SUMMARY ***
Total pot $2.85 | Rake $0.10 
Board [4c 3c 2c 5d]
Seat 2: Th3FldXKQW6hWVVPahaoOQ folded on the Turn
Seat 3: gSakoFAgDDzXSb2eNBWKcg (button) folded before Flop (didn't bet)
Seat 5: wub1jsnHlpWmOX4uczVADA (small blind) folded before Flop
Seat 6: MtVtHDqIJTyUcXkRBBDIVA (big blind) folded before Flop
Seat 7: +qc/EYCgLC65SpGvr35eNg folded before Flop (didn't bet)
Seat 8: ppMlNkhYgErlt4fuJO7ADA collected ($2.75)
Seat 9: CT7Xj/V/O5rBlhtt+RZeFQ folded before Flop (didn't bet)




PokerStars Game #59941768654:  Hold'em No Limit ($0.10/$0.25) - 2009/07/01 1:45:33 ET
Table 'JJzUs04lHpXg6nboT1/jeg' 6-max Seat #6 is the button
Seat 1: MqMK8OWPSY1V4stf1Hy5Jw ($38.70 in chips) 
Seat 2: jxfR29d+dK/7h7s3SvCk+g ($9.35 in chips) 
Seat 3: 4zXbHDe39qNX46dAo81b4w ($7.30 in chips) 
Seat 4: 7VfhiFY533nbUKvyEthASw ($29.50 in chips) 
Seat 5: QvTX2yGq3uKJiKPmns4TKQ ($18.60 in chips) 
Seat 6: wqphQtauX5Qn7WRJZS1flA ($28.95 in chips) 
MqMK8OWPSY1V4stf1Hy5Jw: posts small blind $0.10
jxfR29d+dK/7h7s3SvCk+g: posts big blind $0.25
*** HOLE CARDS ***
4zXbHDe39qNX46dAo81b4w: raises $0.25 to $0.50
7VfhiFY533nbUKvyEthASw: folds 
QvTX2yGq3uKJiKPmns4TKQ: folds 
wqphQtauX5Qn7WRJZS1flA has timed out
wqphQtauX5Qn7WRJZS1flA: folds 
wqphQtauX5Qn7WRJZS1flA is sitting out
MqMK8OWPSY1V4stf1Hy5Jw: calls $0.40
jxfR29d+dK/7h7s3SvCk+g: calls $0.25
*** FLOP *** [9d 5d 7h]
MqMK8OWPSY1V4stf1Hy5Jw: checks 
jxfR29d+dK/7h7s3SvCk+g: checks 
4zXbHDe39qNX46dAo81b4w: bets $0.75
MqMK8OWPSY1V4stf1Hy5Jw: folds 
jxfR29d+dK/7h7s3SvCk+g: raises $1 to $1.75
4zXbHDe39qNX46dAo81b4w: raises $5.05 to $6.80 and is all-in
jxfR29d+dK/7h7s3SvCk+g: folds 
Uncalled bet ($5.05) returned to 4zXbHDe39qNX46dAo81b4w
4zXbHDe39qNX46dAo81b4w collected $4.80 from pot
*** SUMMARY ***
Total pot $5 | Rake $0.20 
Board [9d 5d 7h]
Seat 1: MqMK8OWPSY1V4stf1Hy5Jw (small blind) folded on the Flop
Seat 2: jxfR29d+dK/7h7s3SvCk+g (big blind) folded on the Flop
Seat 3: 4zXbHDe39qNX46dAo81b4w collected ($4.80)
Seat 4: 7VfhiFY533nbUKvyEthASw folded before Flop (didn't bet)
Seat 5: QvTX2yGq3uKJiKPmns4TKQ folded before Flop (didn't bet)
Seat 6: wqphQtauX5Qn7WRJZS1flA (button) folded before Flop (didn't bet)




PokerStars Game #59941768838:  Hold'em No Limit ($0.10/$0.25) - 2009/07/01 1:45:33 ET
Table 'VuY5ej47Cy8nOI3Wogmhzw' 6-max Seat #6 is the button
Seat 1: EeUZtMU058v2ObUACOF4Og ($37.60 in chips) 
Seat 2: AM6Yl+3esmhhMBlSnQhWbg ($17.85 in chips) 
Seat 3: v+QfkGiuj9bgtuNoVnDO8w ($28.40 in chips) 
Seat 4: QqiZLFrN8iOUT/GHw7ztOA ($25 in chips) 
Seat 5: iK/41//HmnLiIn0CVNNfyA ($14.10 in chips) 
Seat 6: +KblIivb6tainScpwm14RQ ($6.75 in chips) 
EeUZtMU058v2ObUACOF4Og: posts small blind $0.10
AM6Yl+3esmhhMBlSnQhWbg: posts big blind $0.25
*** HOLE CARDS ***
v+QfkGiuj9bgtuNoVnDO8w: raises $0.75 to $1
QqiZLFrN8iOUT/GHw7ztOA: folds 
iK/41//HmnLiIn0CVNNfyA: raises $1.25 to $2.25
+KblIivb6tainScpwm14RQ: folds 
EeUZtMU058v2ObUACOF4Og: folds 
AM6Yl+3esmhhMBlSnQhWbg: folds 
v+QfkGiuj9bgtuNoVnDO8w: raises $26.15 to $28.40 and is all-in
iK/41//HmnLiIn0CVNNfyA: calls $11.85 and is all-in
Uncalled bet ($14.30) returned to v+QfkGiuj9bgtuNoVnDO8w
*** FLOP *** [9c Js 9h]
*** TURN *** [9c Js 9h] [3c]
*** RIVER *** [9c Js 9h 3c] [4c]
*** SHOW DOWN ***
v+QfkGiuj9bgtuNoVnDO8w: shows [Qh Qd] (two pair, Queens and Nines)
iK/41//HmnLiIn0CVNNfyA: mucks hand 
v+QfkGiuj9bgtuNoVnDO8w collected $27.15 from pot
*** SUMMARY ***
Total pot $28.55 | Rake $1.40 
Board [9c Js 9h 3c 4c]
Seat 1: EeUZtMU058v2ObUACOF4Og (small blind) folded before Flop
Seat 2: AM6Yl+3esmhhMBlSnQhWbg (big blind) folded before Flop
Seat 3: v+QfkGiuj9bgtuNoVnDO8w showed [Qh Qd] and won ($27.15) with two pair, Queens and Nines
Seat 4: QqiZLFrN8iOUT/GHw7ztOA folded before Flop (didn't bet)
Seat 5: iK/41//HmnLiIn0CVNNfyA mucked
Seat 6: +KblIivb6tainScpwm14RQ (button) folded before Flop (didn't bet)




PokerStars Game #59941768806:  Hold'em No Limit ($0.10/$0.25) - 2009/07/01 1:45:33 ET
Table 'h02LhQ7B/Zk4ETRxxHhGYA' 9-max Seat #8 is the button
Seat 1: sD+TKtt36XiiN6jqHiLwDA ($28 in chips) 
Seat 2: 9lvO/qyU+xrU95Teu1fv0g ($6.30 in chips) 
Seat 3: arxNSjreDRGFg13EAM2F1w ($25 in chips) 
Seat 4: tYsOBqdU1+x+yFI7zHO7hQ ($38.10 in chips) 
Seat 5: cUxk0Jk4lrUQv9CJl0LPlg ($28 in chips) 
Seat 6: UvM6sxFT7el5hVDehvWvTA ($31.20 in chips) 
Seat 7: y7w8+Oqq4SkI1dkRDCx2Zg ($3.50 in chips) 
Seat 8: mUoFJKqCzIUABvOFbiINlQ ($14.50 in chips) 
sD+TKtt36XiiN6jqHiLwDA: posts small blind $0.10
9lvO/qyU+xrU95Teu1fv0g: posts big blind $0.25
*** HOLE CARDS ***
arxNSjreDRGFg13EAM2F1w: calls $0.25
HcU1ud5gMXGuhN1QChAhfQ joins the table at seat #9 
tYsOBqdU1+x+yFI7zHO7hQ: folds 
cUxk0Jk4lrUQv9CJl0LPlg: folds 
UvM6sxFT7el5hVDehvWvTA: folds 
y7w8+Oqq4SkI1dkRDCx2Zg: folds 
mUoFJKqCzIUABvOFbiINlQ: folds 
sD+TKtt36XiiN6jqHiLwDA: raises $0.75 to $1
9lvO/qyU+xrU95Teu1fv0g: folds 
arxNSjreDRGFg13EAM2F1w: calls $0.75
*** FLOP *** [2d 8c 8s]
sD+TKtt36XiiN6jqHiLwDA: bets $2.25
arxNSjreDRGFg13EAM2F1w: calls $2.25
*** TURN *** [2d 8c 8s] [4s]
sD+TKtt36XiiN6jqHiLwDA: checks 
arxNSjreDRGFg13EAM2F1w: bets $3
sD+TKtt36XiiN6jqHiLwDA: calls $3
*** RIVER *** [2d 8c 8s 4s] [Ad]
sD+TKtt36XiiN6jqHiLwDA: checks 
arxNSjreDRGFg13EAM2F1w: bets $9.50
sD+TKtt36XiiN6jqHiLwDA: folds 
Uncalled bet ($9.50) returned to arxNSjreDRGFg13EAM2F1w
arxNSjreDRGFg13EAM2F1w collected $12.15 from pot
arxNSjreDRGFg13EAM2F1w: doesn't show hand 
*** SUMMARY ***
Total pot $12.75 | Rake $0.60 
Board [2d 8c 8s 4s Ad]
Seat 1: sD+TKtt36XiiN6jqHiLwDA (small blind) folded on the River
Seat 2: 9lvO/qyU+xrU95Teu1fv0g (big blind) folded before Flop
Seat 3: arxNSjreDRGFg13EAM2F1w collected ($12.15)
Seat 4: tYsOBqdU1+x+yFI7zHO7hQ folded before Flop (didn't bet)
Seat 5: cUxk0Jk4lrUQv9CJl0LPlg folded before Flop (didn't bet)
Seat 6: UvM6sxFT7el5hVDehvWvTA folded before Flop (didn't bet)
Seat 7: y7w8+Oqq4SkI1dkRDCx2Zg folded before Flop (didn't bet)
Seat 8: mUoFJKqCzIUABvOFbiINlQ (button) folded before Flop (didn't bet)




PokerStars Game #59941768892:  Hold'em No Limit ($0.10/$0.25) - 2009/07/01 1:45:33 ET
Table 'Jj2eLzVCUVAGBmM+Og79iQ' 9-max Seat #4 is the button
Seat 1: ShXPHWfjhfmAwLgDdm6bRQ ($6.75 in chips) 
Seat 2: oMxwMC7+uAsJudeUN6aP0A ($14.60 in chips) 
Seat 3: HPEB+AtKw1+C/cxU0o1ciw ($24.65 in chips) 
Seat 4: aNpwfA31EREwO+ar4XzBCw ($44 in chips) 
Seat 5: UkF1eqqUN0CCiimXAuN7og ($4.75 in chips) 
Seat 6: jZURAM/dgGCX+5lATlZugw ($17.85 in chips) 
Seat 7: K0b5wNInj6hUGRr6yzKFtw ($59.50 in chips) 
Seat 8: H5Se03ZqSX7tbULXur2MAg ($20.60 in chips) 
UkF1eqqUN0CCiimXAuN7og: posts small blind $0.10
jZURAM/dgGCX+5lATlZugw: posts big blind $0.25
vSkQm2EelzwRGDDQQk0Fqw: sits out 
*** HOLE CARDS ***
K0b5wNInj6hUGRr6yzKFtw: folds 
H5Se03ZqSX7tbULXur2MAg: folds 
ShXPHWfjhfmAwLgDdm6bRQ: folds 
oMxwMC7+uAsJudeUN6aP0A: folds 
HPEB+AtKw1+C/cxU0o1ciw: calls $0.25
aNpwfA31EREwO+ar4XzBCw: raises $1 to $1.25
UkF1eqqUN0CCiimXAuN7og: folds 
jZURAM/dgGCX+5lATlZugw: folds 
HPEB+AtKw1+C/cxU0o1ciw: folds 
Uncalled bet ($1) returned to aNpwfA31EREwO+ar4XzBCw
aNpwfA31EREwO+ar4XzBCw collected $0.85 from pot
aNpwfA31EREwO+ar4XzBCw: doesn't show hand 
*** SUMMARY ***
Total pot $0.85 | Rake $0 
Seat 1: ShXPHWfjhfmAwLgDdm6bRQ folded before Flop (didn't bet)
Seat 2: oMxwMC7+uAsJudeUN6aP0A folded before Flop (didn't bet)
Seat 3: HPEB+AtKw1+C/cxU0o1ciw folded before Flop
Seat 4: aNpwfA31EREwO+ar4XzBCw (button) collected ($0.85)
Seat 5: UkF1eqqUN0CCiimXAuN7og (small blind) folded before Flop
Seat 6: jZURAM/dgGCX+5lATlZugw (big blind) folded before Flop
Seat 7: K0b5wNInj6hUGRr6yzKFtw folded before Flop (didn't bet)
Seat 8: H5Se03ZqSX7tbULXur2MAg folded before Flop (didn't bet)




PokerStars Game #59941768922:  Hold'em No Limit ($0.10/$0.25) - 2009/07/01 1:45:33 ET
Table 'G26g8jde1eR+mmabeFeSlw' 9-max Seat #6 is the button
Seat 1: qpG9m8I+cPw8VhB0mnGjYw ($29.15 in chips) 
Seat 2: BFYwQ0J4xWUQvouudojivA ($15.35 in chips) 
Seat 3: WKL8nUFr7TumC4EjLyqYzw ($6.50 in chips) 
Seat 4: 8EbrQ/EvFWt2cr0GaU82gQ ($4.65 in chips) 
Seat 5: hJ4uYjNmSZdjrKA8cjZqCA ($30.70 in chips) 
Seat 6: AHGkesF/mi4sDMpqrxBUoA ($8.55 in chips) 
Seat 7: nm4Dj/f+jJEwKVsUnKh73g ($40.35 in chips) 
Seat 8: CvL9Ch1HYCVbTsfpNucitg ($5 in chips) 
Seat 9: VWUWpMLMj/Q1jRVpF7Aohw ($13.65 in chips) 
nm4Dj/f+jJEwKVsUnKh73g: posts small blind $0.10
CvL9Ch1HYCVbTsfpNucitg: posts big blind $0.25
*** HOLE CARDS ***
VWUWpMLMj/Q1jRVpF7Aohw: folds 
qpG9m8I+cPw8VhB0mnGjYw: calls $0.25
BFYwQ0J4xWUQvouudojivA: folds 
WKL8nUFr7TumC4EjLyqYzw: folds 
8EbrQ/EvFWt2cr0GaU82gQ: folds 
hJ4uYjNmSZdjrKA8cjZqCA: calls $0.25
AHGkesF/mi4sDMpqrxBUoA: folds 
nm4Dj/f+jJEwKVsUnKh73g: folds 
CvL9Ch1HYCVbTsfpNucitg: checks 
*** FLOP *** [Qs 7c 8c]
CvL9Ch1HYCVbTsfpNucitg: bets $1
qpG9m8I+cPw8VhB0mnGjYw: folds 
hJ4uYjNmSZdjrKA8cjZqCA: folds 
Uncalled bet ($1) returned to CvL9Ch1HYCVbTsfpNucitg
CvL9Ch1HYCVbTsfpNucitg collected $0.85 from pot
CvL9Ch1HYCVbTsfpNucitg: doesn't show hand 
*** SUMMARY ***
Total pot $0.85 | Rake $0 
Board [Qs 7c 8c]
Seat 1: qpG9m8I+cPw8VhB0mnGjYw folded on the Flop
Seat 2: BFYwQ0J4xWUQvouudojivA folded before Flop (didn't bet)
Seat 3: WKL8nUFr7TumC4EjLyqYzw folded before Flop (didn't bet)
Seat 4: 8EbrQ/EvFWt2cr0GaU82gQ folded before Flop (didn't bet)
Seat 5: hJ4uYjNmSZdjrKA8cjZqCA folded on the Flop
Seat 6: AHGkesF/mi4sDMpqrxBUoA (button) folded before Flop (didn't bet)
Seat 7: nm4Dj/f+jJEwKVsUnKh73g (small blind) folded before Flop
Seat 8: CvL9Ch1HYCVbTsfpNucitg (big blind) collected ($0.85)
Seat 9: VWUWpMLMj/Q1jRVpF7Aohw folded before Flop (didn't bet)




PokerStars Game #59941769102:  Hold'em No Limit ($0.10/$0.25) - 2009/07/01 1:45:34 ET
Table 'nyTW9cVtYentc5V7xU/0jA' 6-max Seat #2 is the button
Seat 1: HI20pVxSHPZ29u9IDkmICg ($12.35 in chips) 
Seat 2: v6mkGzCBCCXcgWQNSYVtKg ($5.80 in chips) 
Seat 3: kG34n23qFQA3nzdOJTQ1dA ($35.85 in chips) 
Seat 4: NkB3D4eVHHXvB9Edaugc1Q ($31.95 in chips) 
Seat 5: zZAcuQ0EvirdEuiIbeaocQ ($7.35 in chips) 
kG34n23qFQA3nzdOJTQ1dA: posts small blind $0.10
NkB3D4eVHHXvB9Edaugc1Q: posts big blind $0.25
*** HOLE CARDS ***
zZAcuQ0EvirdEuiIbeaocQ: calls $0.25
HI20pVxSHPZ29u9IDkmICg: folds 
v6mkGzCBCCXcgWQNSYVtKg: folds 
kG34n23qFQA3nzdOJTQ1dA: folds 
NkB3D4eVHHXvB9Edaugc1Q: checks 
*** FLOP *** [Kd 8d 4c]
NkB3D4eVHHXvB9Edaugc1Q: bets $0.25
zZAcuQ0EvirdEuiIbeaocQ: folds 
Uncalled bet ($0.25) returned to NkB3D4eVHHXvB9Edaugc1Q
NkB3D4eVHHXvB9Edaugc1Q collected $0.60 from pot
NkB3D4eVHHXvB9Edaugc1Q: doesn't show hand 
*** SUMMARY ***
Total pot $0.60 | Rake $0 
Board [Kd 8d 4c]
Seat 1: HI20pVxSHPZ29u9IDkmICg folded before Flop (didn't bet)
Seat 2: v6mkGzCBCCXcgWQNSYVtKg (button) folded before Flop (didn't bet)
Seat 3: kG34n23qFQA3nzdOJTQ1dA (small blind) folded before Flop
Seat 4: NkB3D4eVHHXvB9Edaugc1Q (big blind) collected ($0.60)
Seat 5: zZAcuQ0EvirdEuiIbeaocQ folded on the Flop




PokerStars Game #59941769288:  Hold'em No Limit ($0.10/$0.25) - 2009/07/01 1:45:34 ET
Table '63uh7ZsO7Tnt+E8b/2bu3A' 6-max Seat #5 is the button
Seat 1: 0av6tRNdi0Ui4f15L7gsVg ($30.55 in chips) 
Seat 2: SFmT9ZsVopnukjvAzrxTRg ($28.35 in chips) 
Seat 3: yVP7GLZBzx47OPi6jzUxMw ($8.45 in chips) 
Seat 5: GbCVUNssQ7mqsPWr7J4d3w ($4.05 in chips) 
Seat 6: qGHGf/553gQnDoklMRe3tg ($29.90 in chips) 
qGHGf/553gQnDoklMRe3tg: posts small blind $0.10
0av6tRNdi0Ui4f15L7gsVg: posts big blind $0.25
*** HOLE CARDS ***
SFmT9ZsVopnukjvAzrxTRg: folds 
yVP7GLZBzx47OPi6jzUxMw: folds 
GbCVUNssQ7mqsPWr7J4d3w: folds 
qGHGf/553gQnDoklMRe3tg: raises $0.75 to $1
0av6tRNdi0Ui4f15L7gsVg: folds 
Uncalled bet ($0.75) returned to qGHGf/553gQnDoklMRe3tg
qGHGf/553gQnDoklMRe3tg collected $0.50 from pot
rnpAao581IcvQglpkpnkoQ joins the table at seat #4 
*** SUMMARY ***
Total pot $0.50 | Rake $0 
Seat 1: 0av6tRNdi0Ui4f15L7gsVg (big blind) folded before Flop
Seat 2: SFmT9ZsVopnukjvAzrxTRg folded before Flop (didn't bet)
Seat 3: yVP7GLZBzx47OPi6jzUxMw folded before Flop (didn't bet)
Seat 5: GbCVUNssQ7mqsPWr7J4d3w (button) folded before Flop (didn't bet)
Seat 6: qGHGf/553gQnDoklMRe3tg (small blind) collected ($0.50)




PokerStars Game #59941769086:  Hold'em No Limit ($0.10/$0.25) - 2009/07/01 1:45:34 ET
Table '3LMlz3V4AziGlU+ikmyU8w' 6-max Seat #2 is the button
Seat 1: Wxq4Qyj0DnDXj2+taEOJFQ ($54.90 in chips) 
Seat 2: uR3AbFJLoOX86DOTtTgGcg ($27.15 in chips) 
Seat 3: Hzy03WtPHMYwLYM7hTTxQw ($1.70 in chips) 
Seat 4: 6DwBRH+xZ12AAZmeAg+aXw ($19.90 in chips) 
Seat 5: tOAk1Og4mVObMBOfvdDYOw ($25 in chips) 
Hzy03WtPHMYwLYM7hTTxQw: posts small blind $0.10
6DwBRH+xZ12AAZmeAg+aXw: posts big blind $0.25
7LpHJVeM6k1mQdC6HXYzww: sits out 
*** HOLE CARDS ***
tOAk1Og4mVObMBOfvdDYOw: folds 
Wxq4Qyj0DnDXj2+taEOJFQ: calls $0.25
uR3AbFJLoOX86DOTtTgGcg: calls $0.25
Hzy03WtPHMYwLYM7hTTxQw: folds 
6DwBRH+xZ12AAZmeAg+aXw: checks 
*** FLOP *** [Tc Td Ks]
6DwBRH+xZ12AAZmeAg+aXw: checks 
Wxq4Qyj0DnDXj2+taEOJFQ: bets $0.50
uR3AbFJLoOX86DOTtTgGcg: folds 
6DwBRH+xZ12AAZmeAg+aXw: folds 
Uncalled bet ($0.50) returned to Wxq4Qyj0DnDXj2+taEOJFQ
Wxq4Qyj0DnDXj2+taEOJFQ collected $0.85 from pot
*** SUMMARY ***
Total pot $0.85 | Rake $0 
Board [Tc Td Ks]
Seat 1: Wxq4Qyj0DnDXj2+taEOJFQ collected ($0.85)
Seat 2: uR3AbFJLoOX86DOTtTgGcg (button) folded on the Flop
Seat 3: Hzy03WtPHMYwLYM7hTTxQw (small blind) folded before Flop
Seat 4: 6DwBRH+xZ12AAZmeAg+aXw (big blind) folded on the Flop
Seat 5: tOAk1Og4mVObMBOfvdDYOw folded before Flop (didn't bet)




PokerStars Game #59941769406:  Hold'em No Limit ($0.10/$0.25) - 2009/07/01 1:45:34 ET
Table 'gZetDqJh6q9A3mLO3ThCsAnc6OeGk/wtaWV+6N+kgnZQSeat #5 is the button
Seat 1: DihMHaz4WNETH1bPDe13kA ($26.05 in chips) 
Seat 2: JFIAqU8lCZ0vWwEl4bdGsg ($32.90 in chips) 
Seat 3: jp34e617tIzV8tKIWmfAbA ($33.80 in chips) 
Seat 4: BV+K0Phf5VBHr7aZPKqbUQ ($29.35 in chips) 
Seat 5: EKTLAV1bAterT0Mc1G6lBg5hAPbqNrvJb8PtLiceXtlg4.75 in chips) 
Seat 6: Mhj3q7cxev+XjXZxEE6/Cw ($25 in chips) 
Mhj3q7cxev+XjXZxEE6/Cw: posts small blind $0.10
DihMHaz4WNETH1bPDe13kA: posts big blind $0.25
*** HOLE CARDS ***
JFIAqU8lCZ0vWwEl4bdGsg: folds 
jp34e617tIzV8tKIWmfAbA: folds 
BV+K0Phf5VBHr7aZPKqbUQ: folds 
EKTLAV1bAterT0Mc1G6lBg5hAPbqNrvJb8PtLiceXtlglds 
Mhj3q7cxev+XjXZxEE6/Cw: raises $0.50 to $0.75
DihMHaz4WNETH1bPDe13kA: raises $1.20 to $1.95
Mhj3q7cxev+XjXZxEE6/Cw: folds 
Uncalled bet ($1.20) returned to DihMHaz4WNETH1bPDe13kA
DihMHaz4WNETH1bPDe13kA collected $1.50 from pot
*** SUMMARY ***
Total pot $1.50 | Rake $0 
Seat 1: DihMHaz4WNETH1bPDe13kA (big blind) collected ($1.50)
Seat 2: JFIAqU8lCZ0vWwEl4bdGsg folded before Flop (didn't bet)
Seat 3: jp34e617tIzV8tKIWmfAbA folded before Flop (didn't bet)
Seat 4: BV+K0Phf5VBHr7aZPKqbUQ folded before Flop (didn't bet)
Seat 5: EKTLAV1bAterT0Mc1G6lBg5hAPbqNrvJb8PtLiceXtlgtton) folded before Flop (didn't bet)
Seat 6: Mhj3q7cxev+XjXZxEE6/Cw (small blind) folded before Flop




PokerStars Game #59941769240:  Hold'em No Limit ($0.10/$0.25) - 2009/07/01 1:45:34 ET
Table 'L5GvbdQO5aCZJSE6pyQ8OA' 6-max Seat #5 is the button
Seat 1: eFj4lr1nuXLyCWNTShr1bg ($11.45 in chips) 
Seat 2: DihMHaz4WNETH1bPDe13kA ($31.30 in chips) 
Seat 3: JFIAqU8lCZ0vWwEl4bdGsg ($25.45 in chips) 
Seat 4: trN/oHqTTbPw5MNuKrOpLw ($28.30 in chips) 
Seat 5: LyDHtw3/yniNHW+DvLXbog ($26.65 in chips) 
Seat 6: v+QfkGiuj9bgtuNoVnDO8w ($39.15 in chips) 
v+QfkGiuj9bgtuNoVnDO8w: posts small blind $0.10
eFj4lr1nuXLyCWNTShr1bg: posts big blind $0.25
*** HOLE CARDS ***
DihMHaz4WNETH1bPDe13kA: folds 
JFIAqU8lCZ0vWwEl4bdGsg: folds 
trN/oHqTTbPw5MNuKrOpLw: raises $0.50 to $0.75
LyDHtw3/yniNHW+DvLXbog: folds 
v+QfkGiuj9bgtuNoVnDO8w: folds 
eFj4lr1nuXLyCWNTShr1bg: folds 
Uncalled bet ($0.50) returned to trN/oHqTTbPw5MNuKrOpLw
trN/oHqTTbPw5MNuKrOpLw collected $0.60 from pot
trN/oHqTTbPw5MNuKrOpLw: doesn't show hand 
*** SUMMARY ***
Total pot $0.60 | Rake $0 
Seat 1: eFj4lr1nuXLyCWNTShr1bg (big blind) folded before Flop
Seat 2: DihMHaz4WNETH1bPDe13kA folded before Flop (didn't bet)
Seat 3: JFIAqU8lCZ0vWwEl4bdGsg folded before Flop (didn't bet)
Seat 4: trN/oHqTTbPw5MNuKrOpLw collected ($0.60)
Seat 5: LyDHtw3/yniNHW+DvLXbog (button) folded before Flop (didn't bet)
Seat 6: v+QfkGiuj9bgtuNoVnDO8w (small blind) folded before Flop




PokerStars Game #59941769474:  Hold'em No Limit ($0.10/$0.25) - 2009/07/01 1:45:34 ET
Table '6wawJ+MkkvuC3coG6r+Yhg' 6-max Seat #3 is the button
Seat 1: JQZew0FjzS19kTjeNtrE+A ($28.25 in chips) 
Seat 2: LtASJ9OlkqGrrUKGQlpGAw ($34.15 in chips) 
Seat 3: 3zD3qLXT1bEffAoWGnc7wg ($61.25 in chips) 
Seat 4: yxmjNFGiKI3b+XQGJzJVIg ($28.05 in chips) 
Seat 5: FZrgDbxAanC1xwZxXHJKVA ($2.30 in chips) 
Seat 6: B3X187C0tXFUfQpCu8pe8A ($25.50 in chips) 
yxmjNFGiKI3b+XQGJzJVIg: posts small blind $0.10
FZrgDbxAanC1xwZxXHJKVA: posts big blind $0.25
*** HOLE CARDS ***
B3X187C0tXFUfQpCu8pe8A: folds 
JQZew0FjzS19kTjeNtrE+A: folds 
LtASJ9OlkqGrrUKGQlpGAw: folds 
3zD3qLXT1bEffAoWGnc7wg: folds 
yxmjNFGiKI3b+XQGJzJVIg: raises $0.50 to $0.75
FZrgDbxAanC1xwZxXHJKVA: calls $0.50
*** FLOP *** [2h 8d Jh]
yxmjNFGiKI3b+XQGJzJVIg: bets $2
FZrgDbxAanC1xwZxXHJKVA: calls $1.55 and is all-in
Uncalled bet ($0.45) returned to yxmjNFGiKI3b+XQGJzJVIg
*** TURN *** [2h 8d Jh] [Kh]
*** RIVER *** [2h 8d Jh Kh] [Td]
*** SHOW DOWN ***
yxmjNFGiKI3b+XQGJzJVIg: shows [4h 4d] (a pair of Fours)
FZrgDbxAanC1xwZxXHJKVA: shows [6s 6h] (a pair of Sixes)
FZrgDbxAanC1xwZxXHJKVA collected $4.40 from pot
*** SUMMARY ***
Total pot $4.60 | Rake $0.20 
Board [2h 8d Jh Kh Td]
Seat 1: JQZew0FjzS19kTjeNtrE+A folded before Flop (didn't bet)
Seat 2: LtASJ9OlkqGrrUKGQlpGAw folded before Flop (didn't bet)
Seat 3: 3zD3qLXT1bEffAoWGnc7wg (button) folded before Flop (didn't bet)
Seat 4: yxmjNFGiKI3b+XQGJzJVIg (small blind) showed [4h 4d] and lost with a pair of Fours
Seat 5: FZrgDbxAanC1xwZxXHJKVA (big blind) showed [6s 6h] and won ($4.40) with a pair of Sixes
Seat 6: B3X187C0tXFUfQpCu8pe8A folded before Flop (didn't bet)




PokerStars Game #59941769450:  Hold'em No Limit ($0.10/$0.25) - 2009/07/01 1:45:34 ET
Table 'tq5CvS0RUqGkuBK0XTzqqg' 6-max Seat #1 is the button
Seat 1: +ZlnqPoP3Hg4BIUxDfKd/A ($30.10 in chips) 
Seat 2: 2m6ZFAdj01UZd4WtEySXXQ ($4.85 in chips) 
Seat 3: PbMzPZIePKifKQZfKDkbIw ($53.35 in chips) 
Seat 4: UT5XpwOH1ipkOF7n1MqDJA ($37.45 in chips) 
Seat 5: qGHGf/553gQnDoklMRe3tg ($33.05 in chips) 
Seat 6: L3/N/gliETan8N5Gim5h4Q ($25 in chips) 
2m6ZFAdj01UZd4WtEySXXQ: posts small blind $0.10
PbMzPZIePKifKQZfKDkbIw: posts big blind $0.25
*** HOLE CARDS ***
UT5XpwOH1ipkOF7n1MqDJA: calls $0.25
qGHGf/553gQnDoklMRe3tg: raises $1 to $1.25
L3/N/gliETan8N5Gim5h4Q: calls $1.25
+ZlnqPoP3Hg4BIUxDfKd/A: folds 
2m6ZFAdj01UZd4WtEySXXQ: folds 
PbMzPZIePKifKQZfKDkbIw: folds 
UT5XpwOH1ipkOF7n1MqDJA: calls $1
*** FLOP *** [2d Ah Jh]
UT5XpwOH1ipkOF7n1MqDJA: checks 
qGHGf/553gQnDoklMRe3tg: bets $2.50
L3/N/gliETan8N5Gim5h4Q: folds 
L3/N/gliETan8N5Gim5h4Q leaves the table
UT5XpwOH1ipkOF7n1MqDJA: calls $2.50
*** TURN *** [2d Ah Jh] [Jd]
UT5XpwOH1ipkOF7n1MqDJA: checks 
QqiZLFrN8iOUT/GHw7ztOA joins the table at seat #6 
qGHGf/553gQnDoklMRe3tg: checks 
*** RIVER *** [2d Ah Jh Jd] [6s]
UT5XpwOH1ipkOF7n1MqDJA: checks 
qGHGf/553gQnDoklMRe3tg: checks 
*** SHOW DOWN ***
UT5XpwOH1ipkOF7n1MqDJA: shows [Kh 5h] (a pair of Jacks)
qGHGf/553gQnDoklMRe3tg: shows [9s 9h] (two pair, Jacks and Nines)
qGHGf/553gQnDoklMRe3tg collected $8.70 from pot
*** SUMMARY ***
Total pot $9.10 | Rake $0.40 
Board [2d Ah Jh Jd 6s]
Seat 1: +ZlnqPoP3Hg4BIUxDfKd/A (button) folded before Flop (didn't bet)
Seat 2: 2m6ZFAdj01UZd4WtEySXXQ (small blind) folded before Flop
Seat 3: PbMzPZIePKifKQZfKDkbIw (big blind) folded before Flop
Seat 4: UT5XpwOH1ipkOF7n1MqDJA showed [Kh 5h] and lost with a pair of Jacks
Seat 5: qGHGf/553gQnDoklMRe3tg showed [9s 9h] and won ($8.70) with two pair, Jacks and Nines
Seat 6: L3/N/gliETan8N5Gim5h4Q folded on the Flop




PokerStars Game #59941769186:  Hold'em No Limit ($0.10/$0.25) - 2009/07/01 1:45:34 ET
Table 'yAHDCs33TIgw3ra63xuU2Q' 9-max Seat #3 is the button
Seat 1: ydoFOVgzvZv9ZhuWu9rXAw ($5 in chips) 
Seat 3: g6UPjSyxNLffCi+EqqIlEg ($21.55 in chips) 
Seat 4: j5spkbnOCRiLGiH6iqBaqw ($8.10 in chips) 
Seat 5: 4awUyiDYTgylQKXZ9faBVA ($37.60 in chips) 
Seat 6: DnDcAdn9P0zGovMERigpFA ($26.30 in chips) 
Seat 8: tYsOBqdU1+x+yFI7zHO7hQ ($25 in chips) 
Seat 9: MtVtHDqIJTyUcXkRBBDIVA ($25.25 in chips) 
j5spkbnOCRiLGiH6iqBaqw: posts small blind $0.10
4awUyiDYTgylQKXZ9faBVA: posts big blind $0.25
j4q3p0lesp63b1gZDwLBZw: sits out 
*** HOLE CARDS ***
DnDcAdn9P0zGovMERigpFA: folds 
tYsOBqdU1+x+yFI7zHO7hQ: folds 
MtVtHDqIJTyUcXkRBBDIVA: raises $0.50 to $0.75
ydoFOVgzvZv9ZhuWu9rXAw: raises $1.50 to $2.25
g6UPjSyxNLffCi+EqqIlEg: folds 
j5spkbnOCRiLGiH6iqBaqw: folds 
4awUyiDYTgylQKXZ9faBVA: folds 
MtVtHDqIJTyUcXkRBBDIVA: raises $23 to $25.25 and is all-in
ydoFOVgzvZv9ZhuWu9rXAw: calls $2.75 and is all-in
Uncalled bet ($20.25) returned to MtVtHDqIJTyUcXkRBBDIVA
*** FLOP *** [7d Kc 7h]
*** TURN *** [7d Kc 7h] [4h]
*** RIVER *** [7d Kc 7h 4h] [8d]
*** SHOW DOWN ***
MtVtHDqIJTyUcXkRBBDIVA: shows [Th Ts] (two pair, Tens and Sevens)
ydoFOVgzvZv9ZhuWu9rXAw: shows [Ad As] (two pair, Aces and Sevens)
ydoFOVgzvZv9ZhuWu9rXAw collected $9.85 from pot
*** SUMMARY ***
Total pot $10.35 | Rake $0.50 
Board [7d Kc 7h 4h 8d]
Seat 1: ydoFOVgzvZv9ZhuWu9rXAw showed [Ad As] and won ($9.85) with two pair, Aces and Sevens
Seat 3: g6UPjSyxNLffCi+EqqIlEg (button) folded before Flop (didn't bet)
Seat 4: j5spkbnOCRiLGiH6iqBaqw (small blind) folded before Flop
Seat 5: 4awUyiDYTgylQKXZ9faBVA (big blind) folded before Flop
Seat 6: DnDcAdn9P0zGovMERigpFA folded before Flop (didn't bet)
Seat 8: tYsOBqdU1+x+yFI7zHO7hQ folded before Flop (didn't bet)
Seat 9: MtVtHDqIJTyUcXkRBBDIVA showed [Th Ts] and lost with two pair, Tens and Sevens




PokerStars Game #59941769552:  Hold'em No Limit ($0.10/$0.25) - 2009/07/01 1:45:35 ET
Table 'D1Yq70l0nNCyMV6DA42p+Q' 9-max Seat #7 is the button
Seat 2: zgi+EUykT/pZQpoUG6+oEg ($4.30 in chips) 
Seat 3: 9lvO/qyU+xrU95Teu1fv0g ($5.50 in chips) 
Seat 4: VWUWpMLMj/Q1jRVpF7Aohw ($8.90 in chips) 
Seat 5: gehe91e0IyVT0QU/XBkEyg ($25 in chips) 
Seat 6: wGigCmBR/9XWkPpvYos3aQ ($33.20 in chips) 
Seat 7: Lqytncc1Dsgt654eEBp/uw ($29.95 in chips) 
Seat 9: h5wEs8qXrBqfLa9GjaSBzg ($24 in chips) 
h5wEs8qXrBqfLa9GjaSBzg: posts small blind $0.10
zgi+EUykT/pZQpoUG6+oEg: posts big blind $0.25
*** HOLE CARDS ***
9lvO/qyU+xrU95Teu1fv0g: folds 
VWUWpMLMj/Q1jRVpF7Aohw: folds 
zDrucyjVn5aeekNEc3cJrA has returned
gehe91e0IyVT0QU/XBkEyg: folds 
wGigCmBR/9XWkPpvYos3aQ: folds 
Lqytncc1Dsgt654eEBp/uw: calls $0.25
h5wEs8qXrBqfLa9GjaSBzg: raises $1 to $1.25
zgi+EUykT/pZQpoUG6+oEg: folds 
Lqytncc1Dsgt654eEBp/uw: calls $1
*** FLOP *** [Kh 4s 8d]
h5wEs8qXrBqfLa9GjaSBzg: bets $2
Lqytncc1Dsgt654eEBp/uw: calls $2
*** TURN *** [Kh 4s 8d] [9s]
h5wEs8qXrBqfLa9GjaSBzg: checks 
Lqytncc1Dsgt654eEBp/uw: bets $4.25
h5wEs8qXrBqfLa9GjaSBzg: folds 
Uncalled bet ($4.25) returned to Lqytncc1Dsgt654eEBp/uw
Lqytncc1Dsgt654eEBp/uw collected $6.45 from pot
Lqytncc1Dsgt654eEBp/uw: doesn't show hand 
*** SUMMARY ***
Total pot $6.75 | Rake $0.30 
Board [Kh 4s 8d 9s]
Seat 2: zgi+EUykT/pZQpoUG6+oEg (big blind) folded before Flop
Seat 3: 9lvO/qyU+xrU95Teu1fv0g folded before Flop (didn't bet)
Seat 4: VWUWpMLMj/Q1jRVpF7Aohw folded before Flop (didn't bet)
Seat 5: gehe91e0IyVT0QU/XBkEyg folded before Flop (didn't bet)
Seat 6: wGigCmBR/9XWkPpvYos3aQ folded before Flop (didn't bet)
Seat 7: Lqytncc1Dsgt654eEBp/uw (button) collected ($6.45)
Seat 9: h5wEs8qXrBqfLa9GjaSBzg (small blind) folded on the Turn




PokerStars Game #59941769828:  Hold'em No Limit ($0.10/$0.25) - 2009/07/01 1:45:35 ET
Table '4XGDnEByOol5up4aB2KbJw' 6-max Seat #3 is the button
Seat 1: kyRaCIljYA6l33lSKQfNsg ($26.50 in chips) 
Seat 2: SFmT9ZsVopnukjvAzrxTRg ($44.85 in chips) 
Seat 3: LtASJ9OlkqGrrUKGQlpGAw ($20.90 in chips) 
Seat 4: BV+K0Phf5VBHr7aZPKqbUQ ($25.50 in chips) 
Seat 5: Dh01+rohD2p9pXLYeBlC5Q ($17 in chips) 
Seat 6: a7Ux7aERFGCbT/L3ojVfAg ($8.75 in chips) 
BV+K0Phf5VBHr7aZPKqbUQ: posts small blind $0.10
Dh01+rohD2p9pXLYeBlC5Q: posts big blind $0.25
*** HOLE CARDS ***
a7Ux7aERFGCbT/L3ojVfAg: calls $0.25
kyRaCIljYA6l33lSKQfNsg: folds 
SFmT9ZsVopnukjvAzrxTRg: raises $0.75 to $1
LtASJ9OlkqGrrUKGQlpGAw: folds 
BV+K0Phf5VBHr7aZPKqbUQ: folds 
Dh01+rohD2p9pXLYeBlC5Q: folds 
a7Ux7aERFGCbT/L3ojVfAg: calls $0.75
*** FLOP *** [Tc 6h Td]
a7Ux7aERFGCbT/L3ojVfAg: checks 
SFmT9ZsVopnukjvAzrxTRg: bets $1.50
a7Ux7aERFGCbT/L3ojVfAg: folds 
Uncalled bet ($1.50) returned to SFmT9ZsVopnukjvAzrxTRg
SFmT9ZsVopnukjvAzrxTRg collected $2.25 from pot
SFmT9ZsVopnukjvAzrxTRg: doesn't show hand 
*** SUMMARY ***
Total pot $2.35 | Rake $0.10 
Board [Tc 6h Td]
Seat 1: kyRaCIljYA6l33lSKQfNsg folded before Flop (didn't bet)
Seat 2: SFmT9ZsVopnukjvAzrxTRg collected ($2.25)
Seat 3: LtASJ9OlkqGrrUKGQlpGAw (button) folded before Flop (didn't bet)
Seat 4: BV+K0Phf5VBHr7aZPKqbUQ (small blind) folded before Flop
Seat 5: Dh01+rohD2p9pXLYeBlC5Q (big blind) folded before Flop
Seat 6: a7Ux7aERFGCbT/L3ojVfAg folded on the Flop




PokerStars Game #59941769914:  Hold'em No Limit ($0.10/$0.25) - 2009/07/01 1:45:35 ET
Table 'AHkg4ChqzcMauBx6Qvz8Nw' 6-max Seat #4 is the button
Seat 1: +RDf7SmUjY2kK0PzdBEYqg ($7.40 in chips) 
Seat 2: Vi0JMrTI2BGrPL7UIulJtA ($5.30 in chips) 
Seat 3: 9dToMv2GJLfi00HcpfMnIw ($24.15 in chips) 
Seat 4: Eznneya0vB6S+eXJdVleHA ($19.45 in chips) 
Seat 5: Bada343Si4xKu3fNXY99AA ($3.95 in chips) 
Seat 6: Hsvkc0/G2VV78oVmWYXecw ($5 in chips) 
Bada343Si4xKu3fNXY99AA: posts small blind $0.10
Hsvkc0/G2VV78oVmWYXecw: posts big blind $0.25
*** HOLE CARDS ***
+RDf7SmUjY2kK0PzdBEYqg: calls $0.25
Vi0JMrTI2BGrPL7UIulJtA: folds 
9dToMv2GJLfi00HcpfMnIw: raises $0.25 to $0.50
Eznneya0vB6S+eXJdVleHA: raises $0.25 to $0.75
Bada343Si4xKu3fNXY99AA: folds 
Hsvkc0/G2VV78oVmWYXecw: folds 
+RDf7SmUjY2kK0PzdBEYqg: calls $0.50
9dToMv2GJLfi00HcpfMnIw: calls $0.25
*** FLOP *** [9d 8s Kh]
+RDf7SmUjY2kK0PzdBEYqg: checks 
9dToMv2GJLfi00HcpfMnIw: bets $0.75
Eznneya0vB6S+eXJdVleHA: calls $0.75
+RDf7SmUjY2kK0PzdBEYqg: folds 
*** TURN *** [9d 8s Kh] [Qs]
9dToMv2GJLfi00HcpfMnIw: bets $1
Eznneya0vB6S+eXJdVleHA: calls $1
*** RIVER *** [9d 8s Kh Qs] [Ks]
9dToMv2GJLfi00HcpfMnIw: bets $3.75
Eznneya0vB6S+eXJdVleHA: folds 
Uncalled bet ($3.75) returned to 9dToMv2GJLfi00HcpfMnIw
9dToMv2GJLfi00HcpfMnIw collected $5.85 from pot
9dToMv2GJLfi00HcpfMnIw: doesn't show hand 
*** SUMMARY ***
Total pot $6.10 | Rake $0.25 
Board [9d 8s Kh Qs Ks]
Seat 1: +RDf7SmUjY2kK0PzdBEYqg folded on the Flop
Seat 2: Vi0JMrTI2BGrPL7UIulJtA folded before Flop (didn't bet)
Seat 3: 9dToMv2GJLfi00HcpfMnIw collected ($5.85)
Seat 4: Eznneya0vB6S+eXJdVleHA (button) folded on the River
Seat 5: Bada343Si4xKu3fNXY99AA (small blind) folded before Flop
Seat 6: Hsvkc0/G2VV78oVmWYXecw (big blind) folded before Flop




PokerStars Game #59941769654:  Hold'em No Limit ($0.10/$0.25) - 2009/07/01 1:45:35 ET
Table 'Qr+t8WGovMECkBv+cV1lrg' 6-max Seat #4 is the button
Seat 1: EeUZtMU058v2ObUACOF4Og ($44.75 in chips) 
Seat 2: vqWjZmdQu/Hxw96/IJTWdQ ($25 in chips) 
Seat 3: uZKkrGByYgd4/ZBX2d4z+w ($26.40 in chips) 
Seat 4: 1NNFfYMd5Hsphl/FYz9fNA ($62.65 in chips) 
Seat 5: 9q7YGTKe9k5fYb4fmZc3Ww ($32.10 in chips) 
Seat 6: 9U3ZKjCsarN0DjR6mSE8Ug ($14 in chips) 
9q7YGTKe9k5fYb4fmZc3Ww: posts small blind $0.10
9U3ZKjCsarN0DjR6mSE8Ug: posts big blind $0.25
*** HOLE CARDS ***
EeUZtMU058v2ObUACOF4Og: folds 
vqWjZmdQu/Hxw96/IJTWdQ: folds 
uZKkrGByYgd4/ZBX2d4z+w: folds 
1NNFfYMd5Hsphl/FYz9fNA: folds 
9q7YGTKe9k5fYb4fmZc3Ww: folds 
Uncalled bet ($0.15) returned to 9U3ZKjCsarN0DjR6mSE8Ug
9U3ZKjCsarN0DjR6mSE8Ug collected $0.20 from pot
9U3ZKjCsarN0DjR6mSE8Ug: doesn't show hand 
*** SUMMARY ***
Total pot $0.20 | Rake $0 
Seat 1: EeUZtMU058v2ObUACOF4Og folded before Flop (didn't bet)
Seat 2: vqWjZmdQu/Hxw96/IJTWdQ folded before Flop (didn't bet)
Seat 3: uZKkrGByYgd4/ZBX2d4z+w folded before Flop (didn't bet)
Seat 4: 1NNFfYMd5Hsphl/FYz9fNA (button) folded before Flop (didn't bet)
Seat 5: 9q7YGTKe9k5fYb4fmZc3Ww (small blind) folded before Flop
Seat 6: 9U3ZKjCsarN0DjR6mSE8Ug (big blind) collected ($0.20)




PokerStars Game #59941769754:  Hold'em No Limit ($0.10/$0.25) - 2009/07/01 1:45:35 ET
Table 'n8mNkPYbe1AIQEkioNesZA' 9-max Seat #8 is the button
Seat 1: 9lvO/qyU+xrU95Teu1fv0g ($5.55 in chips) 
Seat 2: QEbIGci+itdw+re8RM5fZA ($28.05 in chips) 
Seat 3: zDrucyjVn5aeekNEc3cJrA ($19 in chips) 
Seat 4: zgi+EUykT/pZQpoUG6+oEg ($5 in chips) 
Seat 5: wGigCmBR/9XWkPpvYos3aQ ($28.40 in chips) 
Seat 6: HPEB+AtKw1+C/cxU0o1ciw ($46.55 in chips) 
Seat 7: vNfw/x/HNt0WgQC8SveThg ($5 in chips) 
Seat 8: aNpwfA31EREwO+ar4XzBCw ($28.25 in chips) 
Seat 9: gehe91e0IyVT0QU/XBkEyg ($28 in chips) 
gehe91e0IyVT0QU/XBkEyg: posts small blind $0.10
9lvO/qyU+xrU95Teu1fv0g: posts big blind $0.25
vNfw/x/HNt0WgQC8SveThg: posts big blind $0.25
*** HOLE CARDS ***
QEbIGci+itdw+re8RM5fZA: raises $0.75 to $1
zDrucyjVn5aeekNEc3cJrA: folds 
zgi+EUykT/pZQpoUG6+oEg: folds 
wGigCmBR/9XWkPpvYos3aQ: folds 
HPEB+AtKw1+C/cxU0o1ciw: folds 
vNfw/x/HNt0WgQC8SveThg: calls $0.75
aNpwfA31EREwO+ar4XzBCw: folds 
gehe91e0IyVT0QU/XBkEyg: folds 
9lvO/qyU+xrU95Teu1fv0g: folds 
*** FLOP *** [3s 8d 8s]
QEbIGci+itdw+re8RM5fZA: bets $1.25
vNfw/x/HNt0WgQC8SveThg: folds 
Uncalled bet ($1.25) returned to QEbIGci+itdw+re8RM5fZA
QEbIGci+itdw+re8RM5fZA collected $2.25 from pot
QEbIGci+itdw+re8RM5fZA: doesn't show hand 
*** SUMMARY ***
Total pot $2.35 | Rake $0.10 
Board [3s 8d 8s]
Seat 1: 9lvO/qyU+xrU95Teu1fv0g (big blind) folded before Flop
Seat 2: QEbIGci+itdw+re8RM5fZA collected ($2.25)
Seat 3: zDrucyjVn5aeekNEc3cJrA folded before Flop (didn't bet)
Seat 4: zgi+EUykT/pZQpoUG6+oEg folded before Flop (didn't bet)
Seat 5: wGigCmBR/9XWkPpvYos3aQ folded before Flop (didn't bet)
Seat 6: HPEB+AtKw1+C/cxU0o1ciw folded before Flop (didn't bet)
Seat 7: vNfw/x/HNt0WgQC8SveThg folded on the Flop
Seat 8: aNpwfA31EREwO+ar4XzBCw (button) folded before Flop (didn't bet)
Seat 9: gehe91e0IyVT0QU/XBkEyg (small blind) folded before Flop




PokerStars Game #59941769906:  Hold'em No Limit ($0.10/$0.25) - 2009/07/01 1:45:35 ET
Table '3760QYRYyCWeXf0rLZ5S2g' 9-max Seat #6 is the button
Seat 1: CT7Xj/V/O5rBlhtt+RZeFQ ($27.90 in chips) 
Seat 2: zDrucyjVn5aeekNEc3cJrA ($27.55 in chips) 
Seat 3: X78b5v/uhqeXXoAijbw/yg ($25.60 in chips) 
Seat 4: ziFpkH3wCzqB/qXeq/Hy7g ($25 in chips) 
Seat 5: Bb42QRQMhg5/Y0vHP8/2Xw ($28.70 in chips) 
Seat 6: q+Qdg0Hoir+SyL7haBrUnw ($13.25 in chips) 
Seat 7: 6C2DoQ+GZHBOpb+qyrSnqA ($6 in chips) 
Seat 8: clJsV3v77RS07bDKY+705w ($5 in chips) 
Seat 9: sGFnnRCa1YAHAUmWgsW6Qg ($10 in chips) 
6C2DoQ+GZHBOpb+qyrSnqA: posts small blind $0.10
clJsV3v77RS07bDKY+705w: posts big blind $0.25
zDrucyjVn5aeekNEc3cJrA: posts small blind $0.10
*** HOLE CARDS ***
sGFnnRCa1YAHAUmWgsW6Qg: folds 
CT7Xj/V/O5rBlhtt+RZeFQ: folds 
zDrucyjVn5aeekNEc3cJrA: folds 
X78b5v/uhqeXXoAijbw/yg: folds 
ziFpkH3wCzqB/qXeq/Hy7g: folds 
Bb42QRQMhg5/Y0vHP8/2Xw: folds 
q+Qdg0Hoir+SyL7haBrUnw: folds 
6C2DoQ+GZHBOpb+qyrSnqA: calls $0.15
clJsV3v77RS07bDKY+705w: checks 
*** FLOP *** [4d Qc Qs]
6C2DoQ+GZHBOpb+qyrSnqA: checks 
clJsV3v77RS07bDKY+705w: checks 
*** TURN *** [4d Qc Qs] [4s]
6C2DoQ+GZHBOpb+qyrSnqA: checks 
clJsV3v77RS07bDKY+705w: bets $0.50
6C2DoQ+GZHBOpb+qyrSnqA: folds 
Uncalled bet ($0.50) returned to clJsV3v77RS07bDKY+705w
clJsV3v77RS07bDKY+705w collected $0.60 from pot
clJsV3v77RS07bDKY+705w: doesn't show hand 
*** SUMMARY ***
Total pot $0.60 | Rake $0 
Board [4d Qc Qs 4s]
Seat 1: CT7Xj/V/O5rBlhtt+RZeFQ folded before Flop (didn't bet)
Seat 2: zDrucyjVn5aeekNEc3cJrA folded before Flop
Seat 3: X78b5v/uhqeXXoAijbw/yg folded before Flop (didn't bet)
Seat 4: ziFpkH3wCzqB/qXeq/Hy7g folded before Flop (didn't bet)
Seat 5: Bb42QRQMhg5/Y0vHP8/2Xw folded before Flop (didn't bet)
Seat 6: q+Qdg0Hoir+SyL7haBrUnw (button) folded before Flop (didn't bet)
Seat 7: 6C2DoQ+GZHBOpb+qyrSnqA (small blind) folded on the Turn
Seat 8: clJsV3v77RS07bDKY+705w (big blind) collected ($0.60)
Seat 9: sGFnnRCa1YAHAUmWgsW6Qg folded before Flop (didn't bet)




PokerStars Game #59941770274:  Hold'em No Limit ($0.10/$0.25) - 2009/07/01 1:45:36 ET
Table 'BabJGL6tfXQp3leBGbYe8A' 9-max Seat #2 is the button
Seat 1: qwr38jl5txoR36M7G5qi4A ($10 in chips) 
Seat 2: dtZ84flFEi4Q+SGrHMJRDQ ($35.65 in chips) 
Seat 3: sD+TKtt36XiiN6jqHiLwDA ($28.55 in chips) 
Seat 4: gehe91e0IyVT0QU/XBkEyg ($28.45 in chips) 
Seat 5: GrNTWMdwy+jC6Lred1eDng ($15 in chips) 
Seat 6: egvg3mTBBVzMHnJPIQiKcA ($13.90 in chips) 
Seat 7: eK8qa6EPcH2zhtbmWSvc9g ($27.85 in chips) 
Seat 8: OXPkK84/qv92EMwXPiG5rQ ($9.75 in chips) 
Seat 9: P+9ymZQ3ktpQu1bn7HIjew ($9.50 in chips) 
sD+TKtt36XiiN6jqHiLwDA: posts small blind $0.10
gehe91e0IyVT0QU/XBkEyg: posts big blind $0.25
*** HOLE CARDS ***
GrNTWMdwy+jC6Lred1eDng: folds 
egvg3mTBBVzMHnJPIQiKcA: folds 
eK8qa6EPcH2zhtbmWSvc9g: folds 
OXPkK84/qv92EMwXPiG5rQ: folds 
P+9ymZQ3ktpQu1bn7HIjew: folds 
qwr38jl5txoR36M7G5qi4A: folds 
dtZ84flFEi4Q+SGrHMJRDQ: folds 
sD+TKtt36XiiN6jqHiLwDA: raises $0.75 to $1
gehe91e0IyVT0QU/XBkEyg: folds 
Uncalled bet ($0.75) returned to sD+TKtt36XiiN6jqHiLwDA
sD+TKtt36XiiN6jqHiLwDA collected $0.50 from pot
sD+TKtt36XiiN6jqHiLwDA: doesn't show hand 
*** SUMMARY ***
Total pot $0.50 | Rake $0 
Seat 1: qwr38jl5txoR36M7G5qi4A folded before Flop (didn't bet)
Seat 2: dtZ84flFEi4Q+SGrHMJRDQ (button) folded before Flop (didn't bet)
Seat 3: sD+TKtt36XiiN6jqHiLwDA (small blind) collected ($0.50)
Seat 4: gehe91e0IyVT0QU/XBkEyg (big blind) folded before Flop
Seat 5: GrNTWMdwy+jC6Lred1eDng folded before Flop (didn't bet)
Seat 6: egvg3mTBBVzMHnJPIQiKcA folded before Flop (didn't bet)
Seat 7: eK8qa6EPcH2zhtbmWSvc9g folded before Flop (didn't bet)
Seat 8: OXPkK84/qv92EMwXPiG5rQ folded before Flop (didn't bet)
Seat 9: P+9ymZQ3ktpQu1bn7HIjew folded before Flop (didn't bet)




PokerStars Game #59941770120:  Hold'em No Limit ($0.10/$0.25) - 2009/07/01 1:45:36 ET
Table 'PCxB2W9H6ma8SwsZlImuOw' 9-max Seat #8 is the button
Seat 1: SqibpGx+lf+brY0fJVvD0w ($25.10 in chips) 
Seat 2: wjH6l1gQaEfv+C45sAOwIQ ($38.20 in chips) 
Seat 3: J2a/QHAWUgo6beDRoEyg2g ($6.85 in chips) 
Seat 4: RsPwA2DnzOke3hD/Of/DUg ($2.55 in chips) 
Seat 5: GZO7tOXatVoX17M2DqPcUQ ($21.40 in chips) 
Seat 6: 5/6dWEBUHldD7iGXa2LwsQ ($15.50 in chips) 
Seat 7: c/9X4zftzphFxYtxp5kp9w ($27.40 in chips) 
Seat 8: Pt637jKksB5MzP0UNJAAkw ($25.60 in chips) 
Seat 9: COwSH15MvHaRF7en6/TRZQ ($6.95 in chips) 
COwSH15MvHaRF7en6/TRZQ: posts small blind $0.10
SqibpGx+lf+brY0fJVvD0w: posts big blind $0.25
*** HOLE CARDS ***
wjH6l1gQaEfv+C45sAOwIQ: folds 
J2a/QHAWUgo6beDRoEyg2g: calls $0.25
RsPwA2DnzOke3hD/Of/DUg: folds 
wjH6l1gQaEfv+C45sAOwIQ said, "good luck all"
GZO7tOXatVoX17M2DqPcUQ: folds 
5/6dWEBUHldD7iGXa2LwsQ: calls $0.25
c/9X4zftzphFxYtxp5kp9w: folds 
Pt637jKksB5MzP0UNJAAkw: folds 
COwSH15MvHaRF7en6/TRZQ: calls $0.15
wjH6l1gQaEfv+C45sAOwIQ said, "have a great night"
SqibpGx+lf+brY0fJVvD0w: checks 
*** FLOP *** [7d Kh 7s]
wjH6l1gQaEfv+C45sAOwIQ is sitting out
COwSH15MvHaRF7en6/TRZQ: checks 
SqibpGx+lf+brY0fJVvD0w: checks 
J2a/QHAWUgo6beDRoEyg2g: checks 
5/6dWEBUHldD7iGXa2LwsQ: checks 
*** TURN *** [7d Kh 7s] [8s]
wjH6l1gQaEfv+C45sAOwIQ leaves the table
COwSH15MvHaRF7en6/TRZQ: checks 
Pt637jKksB5MzP0UNJAAkw said, "you too"
SqibpGx+lf+brY0fJVvD0w: checks 
bXpVeaSTPBFSPJmeXxO7nw joins the table at seat #2 
J2a/QHAWUgo6beDRoEyg2g: checks 
5/6dWEBUHldD7iGXa2LwsQ: checks 
*** RIVER *** [7d Kh 7s 8s] [7c]
COwSH15MvHaRF7en6/TRZQ: checks 
SqibpGx+lf+brY0fJVvD0w: checks 
J2a/QHAWUgo6beDRoEyg2g: checks 
5/6dWEBUHldD7iGXa2LwsQ: checks 
*** SHOW DOWN ***
COwSH15MvHaRF7en6/TRZQ: shows [Ts Qc] (three of a kind, Sevens)
SqibpGx+lf+brY0fJVvD0w: shows [4d Qh] (three of a kind, Sevens)
J2a/QHAWUgo6beDRoEyg2g: mucks hand 
5/6dWEBUHldD7iGXa2LwsQ: shows [Ac 4c] (three of a kind, Sevens - Ace kicker)
5/6dWEBUHldD7iGXa2LwsQ collected $0.95 from pot
*** SUMMARY ***
Total pot $1 | Rake $0.05 
Board [7d Kh 7s 8s 7c]
Seat 1: SqibpGx+lf+brY0fJVvD0w (big blind) showed [4d Qh] and lost with three of a kind, Sevens
Seat 2: wjH6l1gQaEfv+C45sAOwIQ folded before Flop (didn't bet)
Seat 3: J2a/QHAWUgo6beDRoEyg2g mucked
Seat 4: RsPwA2DnzOke3hD/Of/DUg folded before Flop (didn't bet)
Seat 5: GZO7tOXatVoX17M2DqPcUQ folded before Flop (didn't bet)
Seat 6: 5/6dWEBUHldD7iGXa2LwsQ showed [Ac 4c] and won ($0.95) with three of a kind, Sevens
Seat 7: c/9X4zftzphFxYtxp5kp9w folded before Flop (didn't bet)
Seat 8: Pt637jKksB5MzP0UNJAAkw (button) folded before Flop (didn't bet)
Seat 9: COwSH15MvHaRF7en6/TRZQ (small blind) showed [Ts Qc] and lost with three of a kind, Sevens




PokerStars Game #59941770090:  Hold'em No Limit ($0.10/$0.25) - 2009/07/01 1:45:36 ET
Table 'CBnRhp0d6E2+/NtM7Vbruw' 9-max Seat #6 is the button
Seat 1: WQe4GbiYBiPsb5WKFKkijQ ($10.75 in chips) 
Seat 2: cZ99hugmLBj9KhTlc8nCSw ($26.85 in chips) 
Seat 3: aNpwfA31EREwO+ar4XzBCw ($33.70 in chips) 
Seat 5: CT7Xj/V/O5rBlhtt+RZeFQ ($25 in chips) 
Seat 6: CvL9Ch1HYCVbTsfpNucitg ($4.30 in chips) 
Seat 7: j4q3p0lesp63b1gZDwLBZw ($5.10 in chips) 
Seat 8: MG90wfSJZnOejs/KD3vlQQ ($25 in chips) 
Seat 9: xHZZRLAaFUIC8WWI8ljOJA ($29.90 in chips) 
j4q3p0lesp63b1gZDwLBZw: posts small blind $0.10
MG90wfSJZnOejs/KD3vlQQ: posts big blind $0.25
*** HOLE CARDS ***
xHZZRLAaFUIC8WWI8ljOJA: folds 
WQe4GbiYBiPsb5WKFKkijQ: folds 
cZ99hugmLBj9KhTlc8nCSw: folds 
aNpwfA31EREwO+ar4XzBCw: folds 
CT7Xj/V/O5rBlhtt+RZeFQ: folds 
CvL9Ch1HYCVbTsfpNucitg: folds 
j4q3p0lesp63b1gZDwLBZw: folds 
Uncalled bet ($0.15) returned to MG90wfSJZnOejs/KD3vlQQ
MG90wfSJZnOejs/KD3vlQQ collected $0.20 from pot
MG90wfSJZnOejs/KD3vlQQ: doesn't show hand 
*** SUMMARY ***
Total pot $0.20 | Rake $0 
Seat 1: WQe4GbiYBiPsb5WKFKkijQ folded before Flop (didn't bet)
Seat 2: cZ99hugmLBj9KhTlc8nCSw folded before Flop (didn't bet)
Seat 3: aNpwfA31EREwO+ar4XzBCw folded before Flop (didn't bet)
Seat 5: CT7Xj/V/O5rBlhtt+RZeFQ folded before Flop (didn't bet)
Seat 6: CvL9Ch1HYCVbTsfpNucitg (button) folded before Flop (didn't bet)
Seat 7: j4q3p0lesp63b1gZDwLBZw (small blind) folded before Flop
Seat 8: MG90wfSJZnOejs/KD3vlQQ (big blind) collected ($0.20)
Seat 9: xHZZRLAaFUIC8WWI8ljOJA folded before Flop (didn't bet)




PokerStars Game #59941770448:  Hold'em No Limit ($0.10/$0.25) - 2009/07/01 1:45:36 ET
Table 'l57rayEpPtZotP9nqgSWBg' 6-max Seat #6 is the button
Seat 1: DihMHaz4WNETH1bPDe13kA ($58.80 in chips) 
Seat 2: p6adJRMXMBLr+xtQzqazIQ ($15.55 in chips) 
Seat 3: L3/N/gliETan8N5Gim5h4Q ($25 in chips) 
Seat 4: OqkdGXy1SCzuN5Q0wNlFSg ($22.60 in chips) 
Seat 5: WKJHaZPUgrpTVyLOEjLYmg ($11 in chips) 
Seat 6: IGRfskE1v9H9Bn+fz8AgNQ ($15.20 in chips) 
DihMHaz4WNETH1bPDe13kA: posts small blind $0.10
p6adJRMXMBLr+xtQzqazIQ: posts big blind $0.25
*** HOLE CARDS ***
L3/N/gliETan8N5Gim5h4Q: folds 
OqkdGXy1SCzuN5Q0wNlFSg: folds 
WKJHaZPUgrpTVyLOEjLYmg: folds 
IGRfskE1v9H9Bn+fz8AgNQ: calls $0.25
DihMHaz4WNETH1bPDe13kA: folds 
p6adJRMXMBLr+xtQzqazIQ: checks 
*** FLOP *** [Ah As 3d]
p6adJRMXMBLr+xtQzqazIQ: checks 
IGRfskE1v9H9Bn+fz8AgNQ: bets $0.50
L3/N/gliETan8N5Gim5h4Q leaves the table
p6adJRMXMBLr+xtQzqazIQ: folds 
Uncalled bet ($0.50) returned to IGRfskE1v9H9Bn+fz8AgNQ
IGRfskE1v9H9Bn+fz8AgNQ collected $0.60 from pot
IGRfskE1v9H9Bn+fz8AgNQ: doesn't show hand 
xC0kaiDYM6YTlgODL83O5A joins the table at seat #3 
*** SUMMARY ***
Total pot $0.60 | Rake $0 
Board [Ah As 3d]
Seat 1: DihMHaz4WNETH1bPDe13kA (small blind) folded before Flop
Seat 2: p6adJRMXMBLr+xtQzqazIQ (big blind) folded on the Flop
Seat 3: L3/N/gliETan8N5Gim5h4Q folded before Flop (didn't bet)
Seat 4: OqkdGXy1SCzuN5Q0wNlFSg folded before Flop (didn't bet)
Seat 5: WKJHaZPUgrpTVyLOEjLYmg folded before Flop (didn't bet)
Seat 6: IGRfskE1v9H9Bn+fz8AgNQ (button) collected ($0.60)




PokerStars Game #59941770910:  Hold'em No Limit ($0.10/$0.25) - 2009/07/01 1:45:37 ET
Table 'VQNfcI8vTBCTvRfd3veTLQ' 6-max Seat #3 is the button
Seat 1: QiL+lEgEWwy21jk/ltaRLg ($16.10 in chips) 
Seat 2: 79ID/ub1Pt/mDpCprVmOoA ($31.55 in chips) 
Seat 3: LtASJ9OlkqGrrUKGQlpGAw ($11.25 in chips) 
Seat 4: QIWnfLSqfMcoFfdDe5LZPg ($39.90 in chips) 
Seat 5: gX2vbKwS/8zZPENAWB7hxQ ($23.45 in chips) 
Seat 6: LJI7A1YgDM7hgh7o56+ReQ ($27.70 in chips) 
QIWnfLSqfMcoFfdDe5LZPg: posts small blind $0.10
gX2vbKwS/8zZPENAWB7hxQ: posts big blind $0.25
*** HOLE CARDS ***
LJI7A1YgDM7hgh7o56+ReQ: folds 
QiL+lEgEWwy21jk/ltaRLg: raises $0.75 to $1
79ID/ub1Pt/mDpCprVmOoA: calls $1
LtASJ9OlkqGrrUKGQlpGAw: folds 
QIWnfLSqfMcoFfdDe5LZPg: calls $0.90
gX2vbKwS/8zZPENAWB7hxQ: calls $0.75
*** FLOP *** [3d Kh Qs]
QIWnfLSqfMcoFfdDe5LZPg: checks 
gX2vbKwS/8zZPENAWB7hxQ: checks 
QiL+lEgEWwy21jk/ltaRLg: checks 
79ID/ub1Pt/mDpCprVmOoA: checks 
*** TURN *** [3d Kh Qs] [Th]
QIWnfLSqfMcoFfdDe5LZPg: checks 
gX2vbKwS/8zZPENAWB7hxQ: checks 
QiL+lEgEWwy21jk/ltaRLg: checks 
79ID/ub1Pt/mDpCprVmOoA: checks 
*** RIVER *** [3d Kh Qs Th] [Jh]
QIWnfLSqfMcoFfdDe5LZPg: checks 
gX2vbKwS/8zZPENAWB7hxQ: bets $2
QiL+lEgEWwy21jk/ltaRLg: folds 
79ID/ub1Pt/mDpCprVmOoA: folds 
QIWnfLSqfMcoFfdDe5LZPg: folds 
Uncalled bet ($2) returned to gX2vbKwS/8zZPENAWB7hxQ
gX2vbKwS/8zZPENAWB7hxQ collected $3.80 from pot
*** SUMMARY ***
Total pot $4 | Rake $0.20 
Board [3d Kh Qs Th Jh]
Seat 1: QiL+lEgEWwy21jk/ltaRLg folded on the River
Seat 2: 79ID/ub1Pt/mDpCprVmOoA folded on the River
Seat 3: LtASJ9OlkqGrrUKGQlpGAw (button) folded before Flop (didn't bet)
Seat 4: QIWnfLSqfMcoFfdDe5LZPg (small blind) folded on the River
Seat 5: gX2vbKwS/8zZPENAWB7hxQ (big blind) collected ($3.80)
Seat 6: LJI7A1YgDM7hgh7o56+ReQ folded before Flop (didn't bet)




PokerStars Game #59941770936:  Hold'em No Limit ($0.10/$0.25) - 2009/07/01 1:45:37 ET
Table 'WY+lMaAoIdBZmwk27/RJCA' 6-max Seat #2 is the button
Seat 1: zHHLkD2sRljslKKeQv/ZQw ($24.35 in chips) 
Seat 2: NhUN/JpAprdJeamFBgJH1w ($26.90 in chips) 
Seat 3: QqiZLFrN8iOUT/GHw7ztOA ($26.70 in chips) 
Seat 4: 0av6tRNdi0Ui4f15L7gsVg ($25 in chips) 
Seat 5: vqWjZmdQu/Hxw96/IJTWdQ ($30.45 in chips) 
Seat 6: cWc85bEzdRzpUMhRKm8pwQ ($25.50 in chips) 
QqiZLFrN8iOUT/GHw7ztOA: posts small blind $0.10
0av6tRNdi0Ui4f15L7gsVg: posts big blind $0.25
*** HOLE CARDS ***
vqWjZmdQu/Hxw96/IJTWdQ: folds 
cWc85bEzdRzpUMhRKm8pwQ: folds 
zHHLkD2sRljslKKeQv/ZQw: folds 
NhUN/JpAprdJeamFBgJH1w: folds 
QqiZLFrN8iOUT/GHw7ztOA: folds 
Uncalled bet ($0.15) returned to 0av6tRNdi0Ui4f15L7gsVg
0av6tRNdi0Ui4f15L7gsVg collected $0.20 from pot
0av6tRNdi0Ui4f15L7gsVg: doesn't show hand 
*** SUMMARY ***
Total pot $0.20 | Rake $0 
Seat 1: zHHLkD2sRljslKKeQv/ZQw folded before Flop (didn't bet)
Seat 2: NhUN/JpAprdJeamFBgJH1w (button) folded before Flop (didn't bet)
Seat 3: QqiZLFrN8iOUT/GHw7ztOA (small blind) folded before Flop
Seat 4: 0av6tRNdi0Ui4f15L7gsVg (big blind) collected ($0.20)
Seat 5: vqWjZmdQu/Hxw96/IJTWdQ folded before Flop (didn't bet)
Seat 6: cWc85bEzdRzpUMhRKm8pwQ folded before Flop (didn't bet)




PokerStars Game #59941770756:  Hold'em No Limit ($0.10/$0.25) - 2009/07/01 1:45:37 ET
Table 'Y9EhDWuqWWQFM9SelXAj5g' 9-max Seat #2 is the button
Seat 2: W+njF1UnarGN2q2zP+R+cg ($8.40 in chips) 
Seat 4: V6p0jQ/RhUsqpHLmXvEX4Q ($13.10 in chips) 
Seat 5: CvL9Ch1HYCVbTsfpNucitg ($6.70 in chips) 
Seat 6: egvg3mTBBVzMHnJPIQiKcA ($14 in chips) 
Seat 7: aNpwfA31EREwO+ar4XzBCw ($26.60 in chips) 
Seat 8: XDxyajtqmdag0QPvwcOG7Q ($11.10 in chips) 
Seat 9: bOrfviVhRBpaOfMqUc74Tw ($21.15 in chips) 
XBq1lBzax7LjRqdJP2TqWg will be allowed to play after the button
V6p0jQ/RhUsqpHLmXvEX4Q: posts small blind $0.10
CvL9Ch1HYCVbTsfpNucitg: posts big blind $0.25
*** HOLE CARDS ***
egvg3mTBBVzMHnJPIQiKcA: folds 
aNpwfA31EREwO+ar4XzBCw: folds 
XDxyajtqmdag0QPvwcOG7Q: calls $0.25
bOrfviVhRBpaOfMqUc74Tw: raises $1.50 to $1.75
W+njF1UnarGN2q2zP+R+cg: folds 
V6p0jQ/RhUsqpHLmXvEX4Q: folds 
CvL9Ch1HYCVbTsfpNucitg: folds 
XDxyajtqmdag0QPvwcOG7Q: calls $1.50
*** FLOP *** [4h 6c Ah]
XDxyajtqmdag0QPvwcOG7Q: checks 
bOrfviVhRBpaOfMqUc74Tw: bets $1.75
XDxyajtqmdag0QPvwcOG7Q: raises $1.75 to $3.50
bOrfviVhRBpaOfMqUc74Tw: folds 
Uncalled bet ($1.75) returned to XDxyajtqmdag0QPvwcOG7Q
XDxyajtqmdag0QPvwcOG7Q collected $7 from pot
*** SUMMARY ***
Total pot $7.35 | Rake $0.35 
Board [4h 6c Ah]
Seat 2: W+njF1UnarGN2q2zP+R+cg (button) folded before Flop (didn't bet)
Seat 4: V6p0jQ/RhUsqpHLmXvEX4Q (small blind) folded before Flop
Seat 5: CvL9Ch1HYCVbTsfpNucitg (big blind) folded before Flop
Seat 6: egvg3mTBBVzMHnJPIQiKcA folded before Flop (didn't bet)
Seat 7: aNpwfA31EREwO+ar4XzBCw folded before Flop (didn't bet)
Seat 8: XDxyajtqmdag0QPvwcOG7Q collected ($7)
Seat 9: bOrfviVhRBpaOfMqUc74Tw folded on the Flop




PokerStars Game #59941770916:  Hold'em No Limit ($0.10/$0.25) - 2009/07/01 1:45:37 ET
Table 'QzXakDK7ZHNjgIpoUFGSKQ' 9-max Seat #2 is the button
Seat 1: w1ukf8uPa4+WH561TtVRxA ($26.70 in chips) 
Seat 2: QEbIGci+itdw+re8RM5fZA ($25 in chips) 
Seat 3: eK8qa6EPcH2zhtbmWSvc9g ($25.40 in chips) 
Seat 4: 12pxJGeALcKLTBryE6kFxA ($14.60 in chips) 
Seat 5: MtVtHDqIJTyUcXkRBBDIVA ($27.90 in chips) 
Seat 6: gehe91e0IyVT0QU/XBkEyg ($25 in chips) 
Seat 7: wGigCmBR/9XWkPpvYos3aQ ($29.90 in chips) 
Seat 9: lwrOE80tuooHfIBx/4LUSw ($24.15 in chips) 
eK8qa6EPcH2zhtbmWSvc9g: posts small blind $0.10
12pxJGeALcKLTBryE6kFxA: posts big blind $0.25
Z9W7+g1WMhhZDi7DwGbCFA: sits out 
*** HOLE CARDS ***
MtVtHDqIJTyUcXkRBBDIVA: raises $0.50 to $0.75
gehe91e0IyVT0QU/XBkEyg: folds 
wGigCmBR/9XWkPpvYos3aQ: folds 
lwrOE80tuooHfIBx/4LUSw: folds 
w1ukf8uPa4+WH561TtVRxA: raises $1 to $1.75
QEbIGci+itdw+re8RM5fZA: folds 
eK8qa6EPcH2zhtbmWSvc9g: folds 
12pxJGeALcKLTBryE6kFxA: folds 
MtVtHDqIJTyUcXkRBBDIVA: calls $1
*** FLOP *** [2c 7h 4c]
MtVtHDqIJTyUcXkRBBDIVA: checks 
w1ukf8uPa4+WH561TtVRxA: bets $2
MtVtHDqIJTyUcXkRBBDIVA: calls $2
*** TURN *** [2c 7h 4c] [5s]
MtVtHDqIJTyUcXkRBBDIVA: checks 
w1ukf8uPa4+WH561TtVRxA: checks 
*** RIVER *** [2c 7h 4c 5s] [2s]
MtVtHDqIJTyUcXkRBBDIVA: bets $0.75
w1ukf8uPa4+WH561TtVRxA: calls $0.75
*** SHOW DOWN ***
MtVtHDqIJTyUcXkRBBDIVA: shows [8c 8s] (two pair, Eights and Deuces)
w1ukf8uPa4+WH561TtVRxA: mucks hand 
MtVtHDqIJTyUcXkRBBDIVA collected $8.90 from pot
*** SUMMARY ***
Total pot $9.35 | Rake $0.45 
Board [2c 7h 4c 5s 2s]
Seat 1: w1ukf8uPa4+WH561TtVRxA mucked
Seat 2: QEbIGci+itdw+re8RM5fZA (button) folded before Flop (didn't bet)
Seat 3: eK8qa6EPcH2zhtbmWSvc9g (small blind) folded before Flop
Seat 4: 12pxJGeALcKLTBryE6kFxA (big blind) folded before Flop
Seat 5: MtVtHDqIJTyUcXkRBBDIVA showed [8c 8s] and won ($8.90) with two pair, Eights and Deuces
Seat 6: gehe91e0IyVT0QU/XBkEyg folded before Flop (didn't bet)
Seat 7: wGigCmBR/9XWkPpvYos3aQ folded before Flop (didn't bet)
Seat 9: lwrOE80tuooHfIBx/4LUSw folded before Flop (didn't bet)




PokerStars Game #59941770914:  Hold'em No Limit ($0.10/$0.25) - 2009/07/01 1:45:37 ET
Table 'Zi9/NqNs3XoL1eWhMCyZyg' 9-max Seat #6 is the button
Seat 2: 1wKfgJ8xXIiuc8C6qjkxhg ($4.75 in chips) 
Seat 3: ETC7YyRJTa2Ovhln64Ni5Q ($27.75 in chips) 
Seat 4: dmYlc+1cjwZMJ7wV+Z0rRg ($23.75 in chips) 
Seat 5: JTINtdu/1/EQCVfalLD/xQ ($11.05 in chips) 
Seat 6: YQhfmYhgnDDlWCAFmBb36Q ($14.65 in chips) 
Seat 7: 0QdZrkFD7aGKeBXPGbIomA ($2.85 in chips) 
Seat 8: nm4Dj/f+jJEwKVsUnKh73g ($35.75 in chips) 
Seat 9: tYsOBqdU1+x+yFI7zHO7hQ ($31.65 in chips) 
0QdZrkFD7aGKeBXPGbIomA: posts small blind $0.10
nm4Dj/f+jJEwKVsUnKh73g: posts big blind $0.25
X6+pSIPfovPcE87t+LmUKQ: sits out 
*** HOLE CARDS ***
tYsOBqdU1+x+yFI7zHO7hQ: folds 
1wKfgJ8xXIiuc8C6qjkxhg: folds 
ETC7YyRJTa2Ovhln64Ni5Q: folds 
dmYlc+1cjwZMJ7wV+Z0rRg: folds 
JTINtdu/1/EQCVfalLD/xQ: folds 
YQhfmYhgnDDlWCAFmBb36Q: raises $0.25 to $0.50
0QdZrkFD7aGKeBXPGbIomA: calls $0.40
nm4Dj/f+jJEwKVsUnKh73g: folds 
*** FLOP *** [Js 6s Qd]
0QdZrkFD7aGKeBXPGbIomA: checks 
YQhfmYhgnDDlWCAFmBb36Q: bets $0.50
0QdZrkFD7aGKeBXPGbIomA: calls $0.50
*** TURN *** [Js 6s Qd] [5s]
0QdZrkFD7aGKeBXPGbIomA: checks 
YQhfmYhgnDDlWCAFmBb36Q: bets $0.50
0QdZrkFD7aGKeBXPGbIomA: calls $0.50
*** RIVER *** [Js 6s Qd 5s] [6d]
0QdZrkFD7aGKeBXPGbIomA: checks 
YQhfmYhgnDDlWCAFmBb36Q: bets $1.50
0QdZrkFD7aGKeBXPGbIomA: folds 
Uncalled bet ($1.50) returned to YQhfmYhgnDDlWCAFmBb36Q
YQhfmYhgnDDlWCAFmBb36Q collected $3.10 from pot
YQhfmYhgnDDlWCAFmBb36Q: doesn't show hand 
*** SUMMARY ***
Total pot $3.25 | Rake $0.15 
Board [Js 6s Qd 5s 6d]
Seat 2: 1wKfgJ8xXIiuc8C6qjkxhg folded before Flop (didn't bet)
Seat 3: ETC7YyRJTa2Ovhln64Ni5Q folded before Flop (didn't bet)
Seat 4: dmYlc+1cjwZMJ7wV+Z0rRg folded before Flop (didn't bet)
Seat 5: JTINtdu/1/EQCVfalLD/xQ folded before Flop (didn't bet)
Seat 6: YQhfmYhgnDDlWCAFmBb36Q (button) collected ($3.10)
Seat 7: 0QdZrkFD7aGKeBXPGbIomA (small blind) folded on the River
Seat 8: nm4Dj/f+jJEwKVsUnKh73g (big blind) folded before Flop
Seat 9: tYsOBqdU1+x+yFI7zHO7hQ folded before Flop (didn't bet)




PokerStars Game #59941770934:  Hold'em No Limit ($0.10/$0.25) - 2009/07/01 1:45:37 ET
Table 'Utmw+yX+E/wdhNDIim90lQ' 9-max Seat #3 is the button
Seat 1: cZ99hugmLBj9KhTlc8nCSw ($30.70 in chips) 
Seat 2: iGMlK+EhUflPB6jKQd95Cg ($27.35 in chips) 
Seat 3: dfNim92Z6XK1/h5SFW5vDg ($25 in chips) 
Seat 4: ifYGvZDHQQ0aam4awTtHwA ($25.60 in chips) 
Seat 5: ghNKXUBl/H+t83JF079ZBA ($25 in chips) 
Seat 6: OlPJsgR4xypSg/w1z7Gyvw ($34.40 in chips) 
Seat 8: Mh2r9hTeTEDnh19sRZtW3g ($5 in chips) 
Seat 9: Th3FldXKQW6hWVVPahaoOQ ($28.50 in chips) 
ifYGvZDHQQ0aam4awTtHwA: posts small blind $0.10
ghNKXUBl/H+t83JF079ZBA: posts big blind $0.25
*** HOLE CARDS ***
OlPJsgR4xypSg/w1z7Gyvw: folds 
Mh2r9hTeTEDnh19sRZtW3g: folds 
Th3FldXKQW6hWVVPahaoOQ: folds 
cZ99hugmLBj9KhTlc8nCSw: folds 
iGMlK+EhUflPB6jKQd95Cg: folds 
dfNim92Z6XK1/h5SFW5vDg: folds 
ifYGvZDHQQ0aam4awTtHwA: calls $0.15
ghNKXUBl/H+t83JF079ZBA: checks 
*** FLOP *** [7d 6s 2c]
ifYGvZDHQQ0aam4awTtHwA: bets $1
ghNKXUBl/H+t83JF079ZBA: folds 
Uncalled bet ($1) returned to ifYGvZDHQQ0aam4awTtHwA
ifYGvZDHQQ0aam4awTtHwA collected $0.50 from pot
*** SUMMARY ***
Total pot $0.50 | Rake $0 
Board [7d 6s 2c]
Seat 1: cZ99hugmLBj9KhTlc8nCSw folded before Flop (didn't bet)
Seat 2: iGMlK+EhUflPB6jKQd95Cg folded before Flop (didn't bet)
Seat 3: dfNim92Z6XK1/h5SFW5vDg (button) folded before Flop (didn't bet)
Seat 4: ifYGvZDHQQ0aam4awTtHwA (small blind) collected ($0.50)
Seat 5: ghNKXUBl/H+t83JF079ZBA (big blind) folded on the Flop
Seat 6: OlPJsgR4xypSg/w1z7Gyvw folded before Flop (didn't bet)
Seat 8: Mh2r9hTeTEDnh19sRZtW3g folded before Flop (didn't bet)
Seat 9: Th3FldXKQW6hWVVPahaoOQ folded before Flop (didn't bet)




PokerStars Game #59941770688:  Hold'em No Limit ($0.10/$0.25) - 2009/07/01 1:45:37 ET
Table 'ORSZkZqq+7Ja2PdeCFAytA' 9-max Seat #3 is the button
Seat 1: 3FkcXBaxKqxYVagfYUZlmw ($17.35 in chips) 
Seat 3: s9a4d23HFxaL70yUWQ0/tQ ($19.10 in chips) 
Seat 4: tbgfV2Egwn85xEt865GWQQ ($18.80 in chips) 
Seat 5: +lWbsq4dTcA70SX/+hnmpg ($5 in chips) 
Seat 6: gMF+EMhmwpnaM5TFQquf2A ($5.50 in chips) 
Seat 7: clJsV3v77RS07bDKY+705w ($5 in chips) 
Seat 8: npAYqa85pqnzfOK5ukX+BQ ($19.65 in chips) 
Seat 9: cMTFs4oCtNInkpDIecxT/w ($19.90 in chips) 
tbgfV2Egwn85xEt865GWQQ: posts small blind $0.10
+lWbsq4dTcA70SX/+hnmpg: posts big blind $0.25
*** HOLE CARDS ***
gMF+EMhmwpnaM5TFQquf2A: folds 
clJsV3v77RS07bDKY+705w: folds 
npAYqa85pqnzfOK5ukX+BQ: calls $0.25
cMTFs4oCtNInkpDIecxT/w: folds 
3FkcXBaxKqxYVagfYUZlmw: folds 
s9a4d23HFxaL70yUWQ0/tQ: folds 
tbgfV2Egwn85xEt865GWQQ: calls $0.15
+lWbsq4dTcA70SX/+hnmpg: checks 
*** FLOP *** [Js 6s Qd]
j4q3p0lesp63b1gZDwLBZw joins the table at seat #2 
tbgfV2Egwn85xEt865GWQQ: checks 
+lWbsq4dTcA70SX/+hnmpg: checks 
npAYqa85pqnzfOK5ukX+BQ: checks 
*** TURN *** [Js 6s Qd] [4d]
tbgfV2Egwn85xEt865GWQQ: checks 
+lWbsq4dTcA70SX/+hnmpg: checks 
npAYqa85pqnzfOK5ukX+BQ: checks 
*** RIVER *** [Js 6s Qd 4d] [Ac]
tbgfV2Egwn85xEt865GWQQ: checks 
+lWbsq4dTcA70SX/+hnmpg: bets $0.75
npAYqa85pqnzfOK5ukX+BQ: folds 
tbgfV2Egwn85xEt865GWQQ: folds 
Uncalled bet ($0.75) returned to +lWbsq4dTcA70SX/+hnmpg
+lWbsq4dTcA70SX/+hnmpg collected $0.75 from pot
+lWbsq4dTcA70SX/+hnmpg: doesn't show hand 
*** SUMMARY ***
Total pot $0.75 | Rake $0 
Board [Js 6s Qd 4d Ac]
Seat 1: 3FkcXBaxKqxYVagfYUZlmw folded before Flop (didn't bet)
Seat 3: s9a4d23HFxaL70yUWQ0/tQ (button) folded before Flop (didn't bet)
Seat 4: tbgfV2Egwn85xEt865GWQQ (small blind) folded on the River
Seat 5: +lWbsq4dTcA70SX/+hnmpg (big blind) collected ($0.75)
Seat 6: gMF+EMhmwpnaM5TFQquf2A folded before Flop (didn't bet)
Seat 7: clJsV3v77RS07bDKY+705w folded before Flop (didn't bet)
Seat 8: npAYqa85pqnzfOK5ukX+BQ folded on the River
Seat 9: cMTFs4oCtNInkpDIecxT/w folded before Flop (didn't bet)




PokerStars Game #59941770534:  Hold'em No Limit ($0.10/$0.25) - 2009/07/01 1:45:37 ET
Table 'zKwHJD0cmKNUure9qQTfFg' 6-max Seat #4 is the button
Seat 1: Hzrn9DZJegEZICufTNYkrg ($18.70 in chips) 
Seat 2: xrf8tAXKQHG99HixCot1Iw ($25 in chips) 
Seat 3: m9aw7LBAB5YX2ZqMtMkhqA ($15.85 in chips) 
Seat 4: v+QfkGiuj9bgtuNoVnDO8w ($25.45 in chips) 
Seat 6: edio/rLJ06xeZOfLhoL3UA ($7.75 in chips) 
E4AqQ1egsnu0oH2RqsbCmQ will be allowed to play after the button
edio/rLJ06xeZOfLhoL3UA: posts small blind $0.10
Hzrn9DZJegEZICufTNYkrg: posts big blind $0.25
*** HOLE CARDS ***
xrf8tAXKQHG99HixCot1Iw: folds 
m9aw7LBAB5YX2ZqMtMkhqA: calls $0.25
v+QfkGiuj9bgtuNoVnDO8w: folds 
edio/rLJ06xeZOfLhoL3UA: calls $0.15
Hzrn9DZJegEZICufTNYkrg: checks 
*** FLOP *** [4c 5s Ad]
edio/rLJ06xeZOfLhoL3UA: checks 
Hzrn9DZJegEZICufTNYkrg: checks 
m9aw7LBAB5YX2ZqMtMkhqA: checks 
*** TURN *** [4c 5s Ad] [5c]
edio/rLJ06xeZOfLhoL3UA: bets $0.75
Hzrn9DZJegEZICufTNYkrg: calls $0.75
m9aw7LBAB5YX2ZqMtMkhqA: folds 
*** RIVER *** [4c 5s Ad 5c] [2s]
edio/rLJ06xeZOfLhoL3UA: bets $3
Hzrn9DZJegEZICufTNYkrg: folds 
Uncalled bet ($3) returned to edio/rLJ06xeZOfLhoL3UA
edio/rLJ06xeZOfLhoL3UA collected $2.15 from pot
edio/rLJ06xeZOfLhoL3UA: doesn't show hand 
*** SUMMARY ***
Total pot $2.25 | Rake $0.10 
Board [4c 5s Ad 5c 2s]
Seat 1: Hzrn9DZJegEZICufTNYkrg (big blind) folded on the River
Seat 2: xrf8tAXKQHG99HixCot1Iw folded before Flop (didn't bet)
Seat 3: m9aw7LBAB5YX2ZqMtMkhqA folded on the Turn
Seat 4: v+QfkGiuj9bgtuNoVnDO8w (button) folded before Flop (didn't bet)
Seat 6: edio/rLJ06xeZOfLhoL3UA (small blind) collected ($2.15)




PokerStars Game #59941771066:  Hold'em No Limit ($0.10/$0.25) - 2009/07/01 1:45:38 ET
Table 'pgrBYaOEx/BuqK5iAtlFzw' 9-max Seat #2 is the button
Seat 1: 6O+8t5ikoK+pNiFXnN/Fyw ($14.90 in chips) 
Seat 2: 2Xwi447v1rBHM+92U0CduA ($3.65 in chips) 
Seat 3: Bb42QRQMhg5/Y0vHP8/2Xw ($25 in chips) 
Seat 4: oLa/tXLfSLLB28mcLGrxcg ($24.40 in chips) 
Seat 5: BWzInv8o0kN1pJybv/VjpQ ($29 in chips) 
Seat 6: eubS00Znk+qsx0B0+7/Zow ($21.85 in chips) 
Seat 7: eK8qa6EPcH2zhtbmWSvc9g ($25 in chips) 
Seat 8: tLcDklc2rBORNfixyRfVfw ($27.45 in chips) 
Bb42QRQMhg5/Y0vHP8/2Xw: posts small blind $0.10
oLa/tXLfSLLB28mcLGrxcg: posts big blind $0.25
Z9W7+g1WMhhZDi7DwGbCFA: sits out 
*** HOLE CARDS ***
BWzInv8o0kN1pJybv/VjpQ: calls $0.25
eubS00Znk+qsx0B0+7/Zow: folds 
eK8qa6EPcH2zhtbmWSvc9g: folds 
tLcDklc2rBORNfixyRfVfw: folds 
6O+8t5ikoK+pNiFXnN/Fyw: calls $0.25
2Xwi447v1rBHM+92U0CduA: folds 
Bb42QRQMhg5/Y0vHP8/2Xw: calls $0.15
oLa/tXLfSLLB28mcLGrxcg: checks 
*** FLOP *** [3d 4s 8c]
Bb42QRQMhg5/Y0vHP8/2Xw: checks 
oLa/tXLfSLLB28mcLGrxcg: checks 
BWzInv8o0kN1pJybv/VjpQ: checks 
6O+8t5ikoK+pNiFXnN/Fyw: bets $0.50
Bb42QRQMhg5/Y0vHP8/2Xw: folds 
oLa/tXLfSLLB28mcLGrxcg: folds 
BWzInv8o0kN1pJybv/VjpQ: folds 
Uncalled bet ($0.50) returned to 6O+8t5ikoK+pNiFXnN/Fyw
6O+8t5ikoK+pNiFXnN/Fyw collected $0.95 from pot
*** SUMMARY ***
Total pot $1 | Rake $0.05 
Board [3d 4s 8c]
Seat 1: 6O+8t5ikoK+pNiFXnN/Fyw collected ($0.95)
Seat 2: 2Xwi447v1rBHM+92U0CduA (button) folded before Flop (didn't bet)
Seat 3: Bb42QRQMhg5/Y0vHP8/2Xw (small blind) folded on the Flop
Seat 4: oLa/tXLfSLLB28mcLGrxcg (big blind) folded on the Flop
Seat 5: BWzInv8o0kN1pJybv/VjpQ folded on the Flop
Seat 6: eubS00Znk+qsx0B0+7/Zow folded before Flop (didn't bet)
Seat 7: eK8qa6EPcH2zhtbmWSvc9g folded before Flop (didn't bet)
Seat 8: tLcDklc2rBORNfixyRfVfw folded before Flop (didn't bet)




PokerStars Game #59941771408:  Hold'em No Limit ($0.10/$0.25) - 2009/07/01 1:45:38 ET
Table 'hfHe8uKeSJMyWAjSdM7ROQMRfAiS/4JSfnUDlCcZo0wAx Seat #3 is the button
Seat 1: 48oT5xFI+5CHUJlfoGrE4w ($30.15 in chips) 
Seat 2: /gJNBeCkWL4o85/jvlZ4BA ($29.35 in chips) 
Seat 3: FYepjhAvF8ZdVCmqHIy+eQ ($38.70 in chips) 
Seat 4: b4wRQV3APH8irVk6bUFe2Q ($36.45 in chips) 
Seat 6: L3/N/gliETan8N5Gim5h4Q ($25 in chips) 
b4wRQV3APH8irVk6bUFe2Q: posts small blind $0.10
L3/N/gliETan8N5Gim5h4Q: posts big blind $0.25
*** HOLE CARDS ***
48oT5xFI+5CHUJlfoGrE4w: calls $0.25
/gJNBeCkWL4o85/jvlZ4BA: folds 
FYepjhAvF8ZdVCmqHIy+eQ: folds 
b4wRQV3APH8irVk6bUFe2Q: raises $1 to $1.25
L3/N/gliETan8N5Gim5h4Q: folds 
48oT5xFI+5CHUJlfoGrE4w: folds 
Uncalled bet ($1) returned to b4wRQV3APH8irVk6bUFe2Q
L3/N/gliETan8N5Gim5h4Q leaves the table
b4wRQV3APH8irVk6bUFe2Q collected $0.75 from pot
*** SUMMARY ***
Total pot $0.75 | Rake $0 
Seat 1: 48oT5xFI+5CHUJlfoGrE4w folded before Flop
Seat 2: /gJNBeCkWL4o85/jvlZ4BA folded before Flop (didn't bet)
Seat 3: FYepjhAvF8ZdVCmqHIy+eQ (button) folded before Flop (didn't bet)
Seat 4: b4wRQV3APH8irVk6bUFe2Q (small blind) collected ($0.75)
Seat 6: L3/N/gliETan8N5Gim5h4Q (big blind) folded before Flop




PokerStars Game #59941771124:  Hold'em No Limit ($0.10/$0.25) - 2009/07/01 1:45:38 ET
Table '1zj0+miaIL9cvwnT/50pOA' 9-max Seat #4 is the button
Seat 1: PVxvfRTRvkgZf9WtquEkwQ ($25.35 in chips) 
Seat 2: HPEB+AtKw1+C/cxU0o1ciw ($42.95 in chips) 
Seat 3: dtZ84flFEi4Q+SGrHMJRDQ ($29.35 in chips) 
Seat 4: PdIasPkzm2sqZnN41ZRXOg ($5 in chips) 
Seat 5: 57qrNGHDvf6GhB8zVLsAtQ ($4.10 in chips) 
Seat 6: YZaC69gFrepA6oCGtu7E0w ($29.55 in chips) 
Seat 7: 6RiVTYll/5D8zICp0MRpKw ($23.90 in chips) 
Seat 8: Ihhh49x48fayPIyvl2Rsmg ($35.10 in chips) 
Seat 9: AyqFvLFzJDE7yMbXP362BA ($26.15 in chips) 
57qrNGHDvf6GhB8zVLsAtQ: posts small blind $0.10
YZaC69gFrepA6oCGtu7E0w: posts big blind $0.25
*** HOLE CARDS ***
6RiVTYll/5D8zICp0MRpKw: folds 
Ihhh49x48fayPIyvl2Rsmg: folds 
AyqFvLFzJDE7yMbXP362BA: raises $0.50 to $0.75
PVxvfRTRvkgZf9WtquEkwQ: folds 
HPEB+AtKw1+C/cxU0o1ciw: folds 
dtZ84flFEi4Q+SGrHMJRDQ: folds 
PdIasPkzm2sqZnN41ZRXOg: folds 
57qrNGHDvf6GhB8zVLsAtQ: raises $0.75 to $1.50
YZaC69gFrepA6oCGtu7E0w: folds 
AyqFvLFzJDE7yMbXP362BA: calls $0.75
*** FLOP *** [8h 7s Jh]
57qrNGHDvf6GhB8zVLsAtQ: bets $1
AyqFvLFzJDE7yMbXP362BA: calls $1
*** TURN *** [8h 7s Jh] [Ad]
57qrNGHDvf6GhB8zVLsAtQ: bets $1.60 and is all-in
AyqFvLFzJDE7yMbXP362BA: calls $1.60
*** RIVER *** [8h 7s Jh Ad] [5c]
*** SHOW DOWN ***
57qrNGHDvf6GhB8zVLsAtQ: shows [Ah Qs] (a pair of Aces)
AyqFvLFzJDE7yMbXP362BA: mucks hand 
57qrNGHDvf6GhB8zVLsAtQ collected $8.05 from pot
*** SUMMARY ***
Total pot $8.45 | Rake $0.40 
Board [8h 7s Jh Ad 5c]
Seat 1: PVxvfRTRvkgZf9WtquEkwQ folded before Flop (didn't bet)
Seat 2: HPEB+AtKw1+C/cxU0o1ciw folded before Flop (didn't bet)
Seat 3: dtZ84flFEi4Q+SGrHMJRDQ folded before Flop (didn't bet)
Seat 4: PdIasPkzm2sqZnN41ZRXOg (button) folded before Flop (didn't bet)
Seat 5: 57qrNGHDvf6GhB8zVLsAtQ (small blind) showed [Ah Qs] and won ($8.05) with a pair of Aces
Seat 6: YZaC69gFrepA6oCGtu7E0w (big blind) folded before Flop
Seat 7: 6RiVTYll/5D8zICp0MRpKw folded before Flop (didn't bet)
Seat 8: Ihhh49x48fayPIyvl2Rsmg folded before Flop (didn't bet)
Seat 9: AyqFvLFzJDE7yMbXP362BA mucked




PokerStars Game #59941771172:  Hold'em No Limit ($0.10/$0.25) - 2009/07/01 1:45:38 ET
Table 'wPWRBZPJl1HAnysw7qRR0A' 6-max Seat #5 is the button
Seat 1: m7ne1MOFTQXlsXT7/R/rug ($6.65 in chips) 
Seat 2: xC0kaiDYM6YTlgODL83O5A ($15 in chips) 
Seat 3: 1ZpoLWO2nm2w1Nd1v9Sr3g ($7.20 in chips) 
Seat 4: epAUIB7h2FJXzUPRIvSkRA ($39.15 in chips) 
Seat 5: y0B+UpYpOUJz3JWtlJQBSA ($16 in chips) 
Seat 6: rx64Jzd1UJFfwJwXmv3z8w ($15.25 in chips) 
rx64Jzd1UJFfwJwXmv3z8w: posts small blind $0.10
m7ne1MOFTQXlsXT7/R/rug: posts big blind $0.25
*** HOLE CARDS ***
xC0kaiDYM6YTlgODL83O5A: folds 
1ZpoLWO2nm2w1Nd1v9Sr3g: folds 
epAUIB7h2FJXzUPRIvSkRA: folds 
y0B+UpYpOUJz3JWtlJQBSA: folds 
rx64Jzd1UJFfwJwXmv3z8w: folds 
Uncalled bet ($0.15) returned to m7ne1MOFTQXlsXT7/R/rug
m7ne1MOFTQXlsXT7/R/rug collected $0.20 from pot
*** SUMMARY ***
Total pot $0.20 | Rake $0 
Seat 1: m7ne1MOFTQXlsXT7/R/rug (big blind) collected ($0.20)
Seat 2: xC0kaiDYM6YTlgODL83O5A folded before Flop (didn't bet)
Seat 3: 1ZpoLWO2nm2w1Nd1v9Sr3g folded before Flop (didn't bet)
Seat 4: epAUIB7h2FJXzUPRIvSkRA folded before Flop (didn't bet)
Seat 5: y0B+UpYpOUJz3JWtlJQBSA (button) folded before Flop (didn't bet)
Seat 6: rx64Jzd1UJFfwJwXmv3z8w (small blind) folded before Flop




PokerStars Game #59941771130:  Hold'em No Limit ($0.10/$0.25) - 2009/07/01 1:45:38 ET
Table 'isKy4XK8wJM0x735/D4hWA' 6-max Seat #1 is the button
Seat 1: kwsRmpZ1ZaLooISs+zfyKg ($24.05 in chips) 
Seat 2: 6elpmfyt4Zw0yvd8lePSMQ ($39 in chips) 
Seat 3: jp34e617tIzV8tKIWmfAbA ($26.05 in chips) 
Seat 4: DFi/Lzkjsfv8QswS80JX9Q ($31.45 in chips) 
Seat 5: lquriepNQBhDV5P1SWHhnA ($25.60 in chips) 
Seat 6: GbCVUNssQ7mqsPWr7J4d3w ($4.30 in chips) 
6elpmfyt4Zw0yvd8lePSMQ: posts small blind $0.10
jp34e617tIzV8tKIWmfAbA: posts big blind $0.25
*** HOLE CARDS ***
DFi/Lzkjsfv8QswS80JX9Q: folds 
lquriepNQBhDV5P1SWHhnA: folds 
GbCVUNssQ7mqsPWr7J4d3w: folds 
kwsRmpZ1ZaLooISs+zfyKg: folds 
6elpmfyt4Zw0yvd8lePSMQ: calls $0.15
jp34e617tIzV8tKIWmfAbA: checks 
*** FLOP *** [Ac Kh Ks]
6elpmfyt4Zw0yvd8lePSMQ: bets $0.50
jp34e617tIzV8tKIWmfAbA: folds 
Uncalled bet ($0.50) returned to 6elpmfyt4Zw0yvd8lePSMQ
6elpmfyt4Zw0yvd8lePSMQ collected $0.50 from pot
6elpmfyt4Zw0yvd8lePSMQ: doesn't show hand 
*** SUMMARY ***
Total pot $0.50 | Rake $0 
Board [Ac Kh Ks]
Seat 1: kwsRmpZ1ZaLooISs+zfyKg (button) folded before Flop (didn't bet)
Seat 2: 6elpmfyt4Zw0yvd8lePSMQ (small blind) collected ($0.50)
Seat 3: jp34e617tIzV8tKIWmfAbA (big blind) folded on the Flop
Seat 4: DFi/Lzkjsfv8QswS80JX9Q folded before Flop (didn't bet)
Seat 5: lquriepNQBhDV5P1SWHhnA folded before Flop (didn't bet)
Seat 6: GbCVUNssQ7mqsPWr7J4d3w folded before Flop (didn't bet)




PokerStars Game #59941771326:  Hold'em No Limit ($0.10/$0.25) - 2009/07/01 1:45:38 ET
Table 'K/f0NNaoGuhSz5DrzgVw7Q' 9-max Seat #7 is the button
Seat 1: sD+TKtt36XiiN6jqHiLwDA ($26.55 in chips) 
Seat 4: 9bCz0uv2nUmznwuI0OjVGw ($15.60 in chips) 
Seat 5: DnDcAdn9P0zGovMERigpFA ($40.85 in chips) 
Seat 7: egvg3mTBBVzMHnJPIQiKcA ($12.15 in chips) 
Seat 8: RCqMONFrSPSArZh2Jsar/w ($21.70 in chips) 
Seat 9: tLcDklc2rBORNfixyRfVfw ($25 in chips) 
RCqMONFrSPSArZh2Jsar/w: posts small blind $0.10
tLcDklc2rBORNfixyRfVfw: posts big blind $0.25
3PVK0IdMlq2fElkVzzr4bg: sits out 
*** HOLE CARDS ***
sD+TKtt36XiiN6jqHiLwDA: folds 
9bCz0uv2nUmznwuI0OjVGw: calls $0.25
DnDcAdn9P0zGovMERigpFA: folds 
egvg3mTBBVzMHnJPIQiKcA: folds 
RCqMONFrSPSArZh2Jsar/w: calls $0.15
tLcDklc2rBORNfixyRfVfw: checks 
*** FLOP *** [7c Qs Th]
RCqMONFrSPSArZh2Jsar/w: checks 
tLcDklc2rBORNfixyRfVfw: checks 
9bCz0uv2nUmznwuI0OjVGw: bets $0.25
zgi+EUykT/pZQpoUG6+oEg joins the table at seat #2 
RCqMONFrSPSArZh2Jsar/w: raises $0.50 to $0.75
tLcDklc2rBORNfixyRfVfw: folds 
9bCz0uv2nUmznwuI0OjVGw: calls $0.50
*** TURN *** [7c Qs Th] [2d]
RCqMONFrSPSArZh2Jsar/w: bets $1
9bCz0uv2nUmznwuI0OjVGw: calls $1
*** RIVER *** [7c Qs Th 2d] [9c]
RCqMONFrSPSArZh2Jsar/w: bets $1
9bCz0uv2nUmznwuI0OjVGw: calls $1
*** SHOW DOWN ***
RCqMONFrSPSArZh2Jsar/w: shows [9h Tc] (two pair, Tens and Nines)
9bCz0uv2nUmznwuI0OjVGw: mucks hand 
RCqMONFrSPSArZh2Jsar/w collected $5.95 from pot
*** SUMMARY ***
Total pot $6.25 | Rake $0.30 
Board [7c Qs Th 2d 9c]
Seat 1: sD+TKtt36XiiN6jqHiLwDA folded before Flop (didn't bet)
Seat 4: 9bCz0uv2nUmznwuI0OjVGw mucked
Seat 5: DnDcAdn9P0zGovMERigpFA folded before Flop (didn't bet)
Seat 7: egvg3mTBBVzMHnJPIQiKcA (button) folded before Flop (didn't bet)
Seat 8: RCqMONFrSPSArZh2Jsar/w (small blind) showed [9h Tc] and won ($5.95) with two pair, Tens and Nines
Seat 9: tLcDklc2rBORNfixyRfVfw (big blind) folded on the Flop




PokerStars Game #59941771954:  Hold'em No Limit ($0.10/$0.25) - 2009/07/01 1:45:39 ET
Table 'KU/HrxqxwDz8HKEhYTZ6uw' 6-max Seat #6 is the button
Seat 1: 7LKoiQHXpTQXJvWQrw907g ($31.55 in chips) 
Seat 2: kG34n23qFQA3nzdOJTQ1dA ($25 in chips) 
Seat 3: SFmT9ZsVopnukjvAzrxTRg ($25 in chips) 
Seat 4: AGwMM0FUhYZf81+oXvYQMg ($26.95 in chips) 
Seat 5: iyZxqznXjv3vtvOJymkoLQ ($50.90 in chips) 
Seat 6: qWxkCeqApAWdAA0evrfDvQ ($17 in chips) 
7LKoiQHXpTQXJvWQrw907g: posts small blind $0.10
kG34n23qFQA3nzdOJTQ1dA: posts big blind $0.25
*** HOLE CARDS ***
SFmT9ZsVopnukjvAzrxTRg: raises $0.75 to $1
AGwMM0FUhYZf81+oXvYQMg: folds 
iyZxqznXjv3vtvOJymkoLQ: folds 
qWxkCeqApAWdAA0evrfDvQ: calls $1
7LKoiQHXpTQXJvWQrw907g: calls $0.90
kG34n23qFQA3nzdOJTQ1dA: folds 
*** FLOP *** [Ah Kh Kd]
7LKoiQHXpTQXJvWQrw907g: checks 
SFmT9ZsVopnukjvAzrxTRg: checks 
qWxkCeqApAWdAA0evrfDvQ: bets $0.75
7LKoiQHXpTQXJvWQrw907g: calls $0.75
SFmT9ZsVopnukjvAzrxTRg: folds 
*** TURN *** [Ah Kh Kd] [3d]
7LKoiQHXpTQXJvWQrw907g: checks 
qWxkCeqApAWdAA0evrfDvQ: checks 
*** RIVER *** [Ah Kh Kd 3d] [5s]
7LKoiQHXpTQXJvWQrw907g: bets $3.75
qWxkCeqApAWdAA0evrfDvQ: calls $3.75
*** SHOW DOWN ***
7LKoiQHXpTQXJvWQrw907g: shows [7s 7h] (two pair, Kings and Sevens)
qWxkCeqApAWdAA0evrfDvQ: mucks hand 
7LKoiQHXpTQXJvWQrw907g collected $11.65 from pot
*** SUMMARY ***
Total pot $12.25 | Rake $0.60 
Board [Ah Kh Kd 3d 5s]
Seat 1: 7LKoiQHXpTQXJvWQrw907g (small blind) showed [7s 7h] and won ($11.65) with two pair, Kings and Sevens
Seat 2: kG34n23qFQA3nzdOJTQ1dA (big blind) folded before Flop
Seat 3: SFmT9ZsVopnukjvAzrxTRg folded on the Flop
Seat 4: AGwMM0FUhYZf81+oXvYQMg folded before Flop (didn't bet)
Seat 5: iyZxqznXjv3vtvOJymkoLQ folded before Flop (didn't bet)
Seat 6: qWxkCeqApAWdAA0evrfDvQ (button) mucked




PokerStars Game #59941771638:  Hold'em No Limit ($0.10/$0.25) - 2009/07/01 1:45:39 ET
Table '5VWnrlxdjwVfMWkVS2WE7A' 6-max Seat #2 is the button
Seat 1: 82p+w3EmUaFFHuwpSeGY1w ($14.50 in chips) 
Seat 2: LJI7A1YgDM7hgh7o56+ReQ ($25.65 in chips) 
Seat 3: SFmT9ZsVopnukjvAzrxTRg ($38.90 in chips) 
Seat 4: Pb/gJ3OxOZx57fFp0MDgkg ($35.70 in chips) 
Seat 5: SgMFmwYtNvq9Y+2ZxPSiWQ ($16.10 in chips) 
Seat 6: LtASJ9OlkqGrrUKGQlpGAw ($5.25 in chips) 
SFmT9ZsVopnukjvAzrxTRg: posts small blind $0.10
Pb/gJ3OxOZx57fFp0MDgkg: posts big blind $0.25
*** HOLE CARDS ***
SgMFmwYtNvq9Y+2ZxPSiWQ: folds 
LtASJ9OlkqGrrUKGQlpGAw: folds 
82p+w3EmUaFFHuwpSeGY1w: folds 
LJI7A1YgDM7hgh7o56+ReQ: folds 
SFmT9ZsVopnukjvAzrxTRg: calls $0.15
Pb/gJ3OxOZx57fFp0MDgkg: checks 
*** FLOP *** [2c 3h 7c]
SFmT9ZsVopnukjvAzrxTRg: bets $0.50
Pb/gJ3OxOZx57fFp0MDgkg: calls $0.50
*** TURN *** [2c 3h 7c] [Ks]
SFmT9ZsVopnukjvAzrxTRg: bets $1
Pb/gJ3OxOZx57fFp0MDgkg: folds 
Uncalled bet ($1) returned to SFmT9ZsVopnukjvAzrxTRg
SFmT9ZsVopnukjvAzrxTRg collected $1.45 from pot
SFmT9ZsVopnukjvAzrxTRg: doesn't show hand 
*** SUMMARY ***
Total pot $1.50 | Rake $0.05 
Board [2c 3h 7c Ks]
Seat 1: 82p+w3EmUaFFHuwpSeGY1w folded before Flop (didn't bet)
Seat 2: LJI7A1YgDM7hgh7o56+ReQ (button) folded before Flop (didn't bet)
Seat 3: SFmT9ZsVopnukjvAzrxTRg (small blind) collected ($1.45)
Seat 4: Pb/gJ3OxOZx57fFp0MDgkg (big blind) folded on the Turn
Seat 5: SgMFmwYtNvq9Y+2ZxPSiWQ folded before Flop (didn't bet)
Seat 6: LtASJ9OlkqGrrUKGQlpGAw folded before Flop (didn't bet)




PokerStars Game #59941771678:  Hold'em No Limit ($0.10/$0.25) - 2009/07/01 1:45:39 ET
Table '29D3eoQzK5kOAT0OIDS2uQ' 6-max Seat #2 is the button
Seat 1: kG34n23qFQA3nzdOJTQ1dA ($46.40 in chips) 
Seat 2: FyE+TQ5JcCqI/tCCHf0jGA ($17.45 in chips) 
Seat 3: z3tQwy28dp5FykDJC/wzQw ($17.55 in chips) 
Seat 4: MqMK8OWPSY1V4stf1Hy5Jw ($35.90 in chips) 
Seat 5: Q3EMN7b0ie81AFWkDrhCjw ($22.15 in chips) 
Seat 6: bWbV4MVB/vVpiES1Ut4hew ($30.65 in chips) 
z3tQwy28dp5FykDJC/wzQw: posts small blind $0.10
MqMK8OWPSY1V4stf1Hy5Jw: posts big blind $0.25
*** HOLE CARDS ***
Q3EMN7b0ie81AFWkDrhCjw: calls $0.25
bWbV4MVB/vVpiES1Ut4hew: folds 
kG34n23qFQA3nzdOJTQ1dA: folds 
FyE+TQ5JcCqI/tCCHf0jGA: folds 
z3tQwy28dp5FykDJC/wzQw: folds 
MqMK8OWPSY1V4stf1Hy5Jw: checks 
*** FLOP *** [4h 3d Ts]
MqMK8OWPSY1V4stf1Hy5Jw: checks 
Q3EMN7b0ie81AFWkDrhCjw: bets $0.75
MqMK8OWPSY1V4stf1Hy5Jw: folds 
Uncalled bet ($0.75) returned to Q3EMN7b0ie81AFWkDrhCjw
Q3EMN7b0ie81AFWkDrhCjw collected $0.60 from pot
*** SUMMARY ***
Total pot $0.60 | Rake $0 
Board [4h 3d Ts]
Seat 1: kG34n23qFQA3nzdOJTQ1dA folded before Flop (didn't bet)
Seat 2: FyE+TQ5JcCqI/tCCHf0jGA (button) folded before Flop (didn't bet)
Seat 3: z3tQwy28dp5FykDJC/wzQw (small blind) folded before Flop
Seat 4: MqMK8OWPSY1V4stf1Hy5Jw (big blind) folded on the Flop
Seat 5: Q3EMN7b0ie81AFWkDrhCjw collected ($0.60)
Seat 6: bWbV4MVB/vVpiES1Ut4hew folded before Flop (didn't bet)




PokerStars Game #59941771818:  Hold'em No Limit ($0.10/$0.25) - 2009/07/01 1:45:39 ET
Table 'rtxA1Y01Nrq5VoyzTAuusQ' 9-max Seat #4 is the button
Seat 1: w1ukf8uPa4+WH561TtVRxA ($26.55 in chips) 
Seat 2: Th3FldXKQW6hWVVPahaoOQ ($25 in chips) 
Seat 3: K9fS1IUr5GpiJG7VkJ7IbA ($4.65 in chips) 
Seat 4: RHqgdFvufLCYe54+qd2gcA ($4.65 in chips) 
Seat 5: MtVtHDqIJTyUcXkRBBDIVA ($33 in chips) 
Seat 8: DnDcAdn9P0zGovMERigpFA ($25.35 in chips) 
Seat 9: HPEB+AtKw1+C/cxU0o1ciw ($22.70 in chips) 
MtVtHDqIJTyUcXkRBBDIVA: posts small blind $0.10
3PmVnC/15cl4oyI1TKIt4g: is sitting out 
DnDcAdn9P0zGovMERigpFA: posts big blind $0.25
*** HOLE CARDS ***
HPEB+AtKw1+C/cxU0o1ciw: folds 
3PmVnC/15cl4oyI1TKIt4g leaves the table
w1ukf8uPa4+WH561TtVRxA: folds 
Th3FldXKQW6hWVVPahaoOQ: folds 
K9fS1IUr5GpiJG7VkJ7IbA: raises $0.50 to $0.75
RHqgdFvufLCYe54+qd2gcA: folds 
MtVtHDqIJTyUcXkRBBDIVA: folds 
DnDcAdn9P0zGovMERigpFA: folds 
Uncalled bet ($0.50) returned to K9fS1IUr5GpiJG7VkJ7IbA
K9fS1IUr5GpiJG7VkJ7IbA collected $0.60 from pot
*** SUMMARY ***
Total pot $0.60 | Rake $0 
Seat 1: w1ukf8uPa4+WH561TtVRxA folded before Flop (didn't bet)
Seat 2: Th3FldXKQW6hWVVPahaoOQ folded before Flop (didn't bet)
Seat 3: K9fS1IUr5GpiJG7VkJ7IbA collected ($0.60)
Seat 4: RHqgdFvufLCYe54+qd2gcA (button) folded before Flop (didn't bet)
Seat 5: MtVtHDqIJTyUcXkRBBDIVA (small blind) folded before Flop
Seat 8: DnDcAdn9P0zGovMERigpFA (big blind) folded before Flop
Seat 9: HPEB+AtKw1+C/cxU0o1ciw folded before Flop (didn't bet)




PokerStars Game #59941771730:  Hold'em No Limit ($0.10/$0.25) - 2009/07/01 1:45:39 ET
Table 'xkqAWQFDrFt4p81M8UsoNw' 9-max Seat #6 is the button
Seat 1: tLcDklc2rBORNfixyRfVfw ($28.25 in chips) 
Seat 3: xHZZRLAaFUIC8WWI8ljOJA ($24 in chips) 
Seat 4: wGigCmBR/9XWkPpvYos3aQ ($25.10 in chips) 
Seat 6: 6RiVTYll/5D8zICp0MRpKw ($22.75 in chips) 
Seat 7: MG90wfSJZnOejs/KD3vlQQ ($42.80 in chips) 
Seat 8: MaqsqnOOkbNuPf4oWvOtnA ($43.75 in chips) 
Seat 9: Z9AeOQX3yzuSvKAm/xyovg ($9.65 in chips) 
MG90wfSJZnOejs/KD3vlQQ: posts small blind $0.10
MaqsqnOOkbNuPf4oWvOtnA: posts big blind $0.25
H5Se03ZqSX7tbULXur2MAg: sits out 
*** HOLE CARDS ***
Z9AeOQX3yzuSvKAm/xyovg: folds 
tLcDklc2rBORNfixyRfVfw: folds 
xHZZRLAaFUIC8WWI8ljOJA has timed out
xHZZRLAaFUIC8WWI8ljOJA: folds 
xHZZRLAaFUIC8WWI8ljOJA is sitting out
wGigCmBR/9XWkPpvYos3aQ: folds 
xHZZRLAaFUIC8WWI8ljOJA has returned
6RiVTYll/5D8zICp0MRpKw has timed out
6RiVTYll/5D8zICp0MRpKw: folds 
6RiVTYll/5D8zICp0MRpKw is sitting out
6RiVTYll/5D8zICp0MRpKw has returned
MG90wfSJZnOejs/KD3vlQQ: raises $0.50 to $0.75
MaqsqnOOkbNuPf4oWvOtnA: calls $0.50
*** FLOP *** [9c 2s 3c]
MG90wfSJZnOejs/KD3vlQQ: bets $1.20
MaqsqnOOkbNuPf4oWvOtnA: folds 
Uncalled bet ($1.20) returned to MG90wfSJZnOejs/KD3vlQQ
MG90wfSJZnOejs/KD3vlQQ collected $1.45 from pot
MG90wfSJZnOejs/KD3vlQQ: doesn't show hand 
*** SUMMARY ***
Total pot $1.50 | Rake $0.05 
Board [9c 2s 3c]
Seat 1: tLcDklc2rBORNfixyRfVfw folded before Flop (didn't bet)
Seat 3: xHZZRLAaFUIC8WWI8ljOJA folded before Flop (didn't bet)
Seat 4: wGigCmBR/9XWkPpvYos3aQ folded before Flop (didn't bet)
Seat 6: 6RiVTYll/5D8zICp0MRpKw (button) folded before Flop (didn't bet)
Seat 7: MG90wfSJZnOejs/KD3vlQQ (small blind) collected ($1.45)
Seat 8: MaqsqnOOkbNuPf4oWvOtnA (big blind) folded on the Flop
Seat 9: Z9AeOQX3yzuSvKAm/xyovg folded before Flop (didn't bet)




PokerStars Game #59941771840:  Hold'em No Limit ($0.10/$0.25) - 2009/07/01 1:45:39 ET
Table 'Of/T60zpXg1GcjrZ7Lm//Q' 9-max Seat #6 is the button
Seat 1: Lro4e37x4FUa5P3yzDjskw ($18.20 in chips) 
Seat 2: qwr38jl5txoR36M7G5qi4A ($9.90 in chips) 
Seat 3: 6RiVTYll/5D8zICp0MRpKw ($25 in chips) 
Seat 4: Czut6V7acIqUJrrobjKAZg ($16.40 in chips) 
Seat 5: IiLkthQMEje9LS79rCFQ1Q ($10 in chips) 
Seat 6: tYsOBqdU1+x+yFI7zHO7hQ ($31.45 in chips) 
Seat 7: PVxvfRTRvkgZf9WtquEkwQ ($25 in chips) 
Seat 8: ghNKXUBl/H+t83JF079ZBA ($26.50 in chips) 
Seat 9: egvg3mTBBVzMHnJPIQiKcA ($16.40 in chips) 
PVxvfRTRvkgZf9WtquEkwQ: posts small blind $0.10
ghNKXUBl/H+t83JF079ZBA: posts big blind $0.25
*** HOLE CARDS ***
egvg3mTBBVzMHnJPIQiKcA: folds 
Lro4e37x4FUa5P3yzDjskw: folds 
qwr38jl5txoR36M7G5qi4A: folds 
6RiVTYll/5D8zICp0MRpKw: folds 
Czut6V7acIqUJrrobjKAZg: raises $0.75 to $1
IiLkthQMEje9LS79rCFQ1Q: calls $1
tYsOBqdU1+x+yFI7zHO7hQ: folds 
PVxvfRTRvkgZf9WtquEkwQ: calls $0.90
ghNKXUBl/H+t83JF079ZBA: folds 
*** FLOP *** [8c 3s As]
PVxvfRTRvkgZf9WtquEkwQ: checks 
Czut6V7acIqUJrrobjKAZg: bets $2
IiLkthQMEje9LS79rCFQ1Q: calls $2
PVxvfRTRvkgZf9WtquEkwQ: folds 
*** TURN *** [8c 3s As] [2c]
Czut6V7acIqUJrrobjKAZg: bets $7
IiLkthQMEje9LS79rCFQ1Q: calls $7 and is all-in
*** RIVER *** [8c 3s As 2c] [9h]
*** SHOW DOWN ***
Czut6V7acIqUJrrobjKAZg: shows [Js 9s] (a pair of Nines)
IiLkthQMEje9LS79rCFQ1Q: shows [Ad Qd] (a pair of Aces)
IiLkthQMEje9LS79rCFQ1Q collected $20.25 from pot
*** SUMMARY ***
Total pot $21.25 | Rake $1 
Board [8c 3s As 2c 9h]
Seat 1: Lro4e37x4FUa5P3yzDjskw folded before Flop (didn't bet)
Seat 2: qwr38jl5txoR36M7G5qi4A folded before Flop (didn't bet)
Seat 3: 6RiVTYll/5D8zICp0MRpKw folded before Flop (didn't bet)
Seat 4: Czut6V7acIqUJrrobjKAZg showed [Js 9s] and lost with a pair of Nines
Seat 5: IiLkthQMEje9LS79rCFQ1Q showed [Ad Qd] and won ($20.25) with a pair of Aces
Seat 6: tYsOBqdU1+x+yFI7zHO7hQ (button) folded before Flop (didn't bet)
Seat 7: PVxvfRTRvkgZf9WtquEkwQ (small blind) folded on the Flop
Seat 8: ghNKXUBl/H+t83JF079ZBA (big blind) folded before Flop
Seat 9: egvg3mTBBVzMHnJPIQiKcA folded before Flop (didn't bet)




PokerStars Game #59941772132:  Hold'em No Limit ($0.10/$0.25) - 2009/07/01 1:45:39 ET
Table 'YlRA05h9BJ1EhOUSNUjJdg' 9-max Seat #8 is the button
Seat 1: dtZ84flFEi4Q+SGrHMJRDQ ($25 in chips) 
Seat 2: Y2GFAe+PT7xnUUtgqCNDFw ($12.05 in chips) 
Seat 3: Z5ZtGOON8kmSdSCll9Z3XA ($13.20 in chips) 
Seat 4: HPEB+AtKw1+C/cxU0o1ciw ($31.10 in chips) 
Seat 5: sx0lGrkT9fd4yFR+3cXUQg ($11.65 in chips) 
Seat 6: QEbIGci+itdw+re8RM5fZA ($44 in chips) 
Seat 7: dfNim92Z6XK1/h5SFW5vDg ($25 in chips) 
Seat 8: dmYlc+1cjwZMJ7wV+Z0rRg ($32.55 in chips) 
Seat 9: Z9AeOQX3yzuSvKAm/xyovg ($10.20 in chips) 
Z9AeOQX3yzuSvKAm/xyovg: posts small blind $0.10
dtZ84flFEi4Q+SGrHMJRDQ: posts big blind $0.25
*** HOLE CARDS ***
Y2GFAe+PT7xnUUtgqCNDFw: calls $0.25
Z5ZtGOON8kmSdSCll9Z3XA: folds 
HPEB+AtKw1+C/cxU0o1ciw: calls $0.25
sx0lGrkT9fd4yFR+3cXUQg: folds 
QEbIGci+itdw+re8RM5fZA: folds 
dfNim92Z6XK1/h5SFW5vDg: folds 
dmYlc+1cjwZMJ7wV+Z0rRg: folds 
Z9AeOQX3yzuSvKAm/xyovg: folds 
dtZ84flFEi4Q+SGrHMJRDQ: checks 
*** FLOP *** [3h 7h Jh]
dtZ84flFEi4Q+SGrHMJRDQ: checks 
Y2GFAe+PT7xnUUtgqCNDFw: checks 
HPEB+AtKw1+C/cxU0o1ciw: bets $0.75
dtZ84flFEi4Q+SGrHMJRDQ: folds 
Y2GFAe+PT7xnUUtgqCNDFw: calls $0.75
*** TURN *** [3h 7h Jh] [2s]
Y2GFAe+PT7xnUUtgqCNDFw: checks 
HPEB+AtKw1+C/cxU0o1ciw: bets $1.75
Y2GFAe+PT7xnUUtgqCNDFw: calls $1.75
*** RIVER *** [3h 7h Jh 2s] [3c]
Y2GFAe+PT7xnUUtgqCNDFw: checks 
HPEB+AtKw1+C/cxU0o1ciw: bets $3.80
Y2GFAe+PT7xnUUtgqCNDFw: folds 
Uncalled bet ($3.80) returned to HPEB+AtKw1+C/cxU0o1ciw
HPEB+AtKw1+C/cxU0o1ciw collected $5.60 from pot
HPEB+AtKw1+C/cxU0o1ciw: doesn't show hand 
*** SUMMARY ***
Total pot $5.85 | Rake $0.25 
Board [3h 7h Jh 2s 3c]
Seat 1: dtZ84flFEi4Q+SGrHMJRDQ (big blind) folded on the Flop
Seat 2: Y2GFAe+PT7xnUUtgqCNDFw folded on the River
Seat 3: Z5ZtGOON8kmSdSCll9Z3XA folded before Flop (didn't bet)
Seat 4: HPEB+AtKw1+C/cxU0o1ciw collected ($5.60)
Seat 5: sx0lGrkT9fd4yFR+3cXUQg folded before Flop (didn't bet)
Seat 6: QEbIGci+itdw+re8RM5fZA folded before Flop (didn't bet)
Seat 7: dfNim92Z6XK1/h5SFW5vDg folded before Flop (didn't bet)
Seat 8: dmYlc+1cjwZMJ7wV+Z0rRg (button) folded before Flop (didn't bet)
Seat 9: Z9AeOQX3yzuSvKAm/xyovg (small blind) folded before Flop




PokerStars Game #59941771976:  Hold'em No Limit ($0.10/$0.25) - 2009/07/01 1:45:39 ET
Table 'IrJPyZ3JW2iIa+krdoSbJQ' 9-max Seat #6 is the button
Seat 1: Bb42QRQMhg5/Y0vHP8/2Xw ($26.25 in chips) 
Seat 2: X78b5v/uhqeXXoAijbw/yg ($42.95 in chips) 
Seat 3: CT7Xj/V/O5rBlhtt+RZeFQ ($25 in chips) 
Seat 4: bXpVeaSTPBFSPJmeXxO7nw ($4.65 in chips) 
Seat 5: tLcDklc2rBORNfixyRfVfw ($30.30 in chips) 
Seat 6: +sbyWwIcFp9kP0bDtMegfQ ($24.60 in chips) 
Seat 8: zZqOSFjPK4R4cwx0dONetw ($18.65 in chips) 
Seat 9: Mh2r9hTeTEDnh19sRZtW3g ($5.80 in chips) 
ozqb9Z1ZOsDwxxq9IKmjUA will be allowed to play after the button
zZqOSFjPK4R4cwx0dONetw: posts small blind $0.10
Mh2r9hTeTEDnh19sRZtW3g: posts big blind $0.25
*** HOLE CARDS ***
Bb42QRQMhg5/Y0vHP8/2Xw: folds 
X78b5v/uhqeXXoAijbw/yg: folds 
CT7Xj/V/O5rBlhtt+RZeFQ: folds 
bXpVeaSTPBFSPJmeXxO7nw: folds 
tLcDklc2rBORNfixyRfVfw: folds 
+sbyWwIcFp9kP0bDtMegfQ: folds 
zZqOSFjPK4R4cwx0dONetw: calls $0.15
Mh2r9hTeTEDnh19sRZtW3g: raises $0.75 to $1
zZqOSFjPK4R4cwx0dONetw: calls $0.75
*** FLOP *** [5s 3h 2c]
zZqOSFjPK4R4cwx0dONetw: checks 
Mh2r9hTeTEDnh19sRZtW3g: bets $1.25
zZqOSFjPK4R4cwx0dONetw: calls $1.25
*** TURN *** [5s 3h 2c] [6c]
zZqOSFjPK4R4cwx0dONetw: checks 
Mh2r9hTeTEDnh19sRZtW3g: checks 
*** RIVER *** [5s 3h 2c 6c] [Td]
zZqOSFjPK4R4cwx0dONetw: bets $2
Mh2r9hTeTEDnh19sRZtW3g: calls $2
*** SHOW DOWN ***
zZqOSFjPK4R4cwx0dONetw: shows [2d As] (a pair of Deuces)
Mh2r9hTeTEDnh19sRZtW3g: shows [5c 8c] (a pair of Fives)
Mh2r9hTeTEDnh19sRZtW3g collected $8.10 from pot
*** SUMMARY ***
Total pot $8.50 | Rake $0.40 
Board [5s 3h 2c 6c Td]
Seat 1: Bb42QRQMhg5/Y0vHP8/2Xw folded before Flop (didn't bet)
Seat 2: X78b5v/uhqeXXoAijbw/yg folded before Flop (didn't bet)
Seat 3: CT7Xj/V/O5rBlhtt+RZeFQ folded before Flop (didn't bet)
Seat 4: bXpVeaSTPBFSPJmeXxO7nw folded before Flop (didn't bet)
Seat 5: tLcDklc2rBORNfixyRfVfw folded before Flop (didn't bet)
Seat 6: +sbyWwIcFp9kP0bDtMegfQ (button) folded before Flop (didn't bet)
Seat 8: zZqOSFjPK4R4cwx0dONetw (small blind) showed [2d As] and lost with a pair of Deuces
Seat 9: Mh2r9hTeTEDnh19sRZtW3g (big blind) showed [5c 8c] and won ($8.10) with a pair of Fives




PokerStars Game #59941772130:  Hold'em No Limit ($0.10/$0.25) - 2009/07/01 1:45:39 ET
Table 'NtEQAxCeIK2io1CGtW658g' 6-max Seat #2 is the button
Seat 1: X437kMQ7AujoaDgjguhU9w ($12.45 in chips) 
Seat 2: DgyznDqq/mLiCqQGMzc+Aw ($9.20 in chips) 
Seat 4: 8296 ($9.80 in chips) 
Seat 5: Hsvkc0/G2VV78oVmWYXecw ($5 in chips) 
Seat 6: /gJNBeCkWL4o85/jvlZ4BA ($64.35 in chips) 
8296: posts small blind $0.10
Hsvkc0/G2VV78oVmWYXecw: posts big blind $0.25
*** HOLE CARDS ***
5nwDw10uIM0XEyLhla0oGA joins the table at seat #3 
/gJNBeCkWL4o85/jvlZ4BA: raises $0.75 to $1
X437kMQ7AujoaDgjguhU9w: folds 
DgyznDqq/mLiCqQGMzc+Aw: folds 
8296: folds 
Hsvkc0/G2VV78oVmWYXecw: folds 
Uncalled bet ($0.75) returned to /gJNBeCkWL4o85/jvlZ4BA
/gJNBeCkWL4o85/jvlZ4BA collected $0.60 from pot
*** SUMMARY ***
Total pot $0.60 | Rake $0 
Seat 1: X437kMQ7AujoaDgjguhU9w folded before Flop (didn't bet)
Seat 2: DgyznDqq/mLiCqQGMzc+Aw (button) folded before Flop (didn't bet)
Seat 4: 8296 (small blind) folded before Flop
Seat 5: Hsvkc0/G2VV78oVmWYXecw (big blind) folded before Flop
Seat 6: /gJNBeCkWL4o85/jvlZ4BA collected ($0.60)




PokerStars Game #59941772342:  Hold'em No Limit ($0.10/$0.25) - 2009/07/01 1:45:40 ET
Table 'by7aHYEDnDd144EXOXa/jA' 9-max Seat #2 is the button
Seat 1: j4q3p0lesp63b1gZDwLBZw ($7.65 in chips) 
Seat 2: vSkQm2EelzwRGDDQQk0Fqw ($5.60 in chips) 
Seat 3: HOEaXncFu2ij+D5/CANAZA ($11.60 in chips) 
Seat 4: 2Xwi447v1rBHM+92U0CduA ($4.25 in chips) 
Seat 5: yyG4svzOpC1A+sUP/scg6w ($4.20 in chips) 
Seat 6: sC4BsflLWW26Qm9m+1AwJQ ($14.40 in chips) 
Seat 8: 7je+LC5Mfs6nL8YBVh4frQ ($3.50 in chips) 
Seat 9: K0b5wNInj6hUGRr6yzKFtw ($25.05 in chips) 
HOEaXncFu2ij+D5/CANAZA: posts small blind $0.10
2Xwi447v1rBHM+92U0CduA: posts big blind $0.25
Z9W7+g1WMhhZDi7DwGbCFA: sits out 
*** HOLE CARDS ***
yyG4svzOpC1A+sUP/scg6w: folds 
sC4BsflLWW26Qm9m+1AwJQ: folds 
7je+LC5Mfs6nL8YBVh4frQ: folds 
K0b5wNInj6hUGRr6yzKFtw: folds 
j4q3p0lesp63b1gZDwLBZw: folds 
vSkQm2EelzwRGDDQQk0Fqw: folds 
HOEaXncFu2ij+D5/CANAZA: calls $0.15
2Xwi447v1rBHM+92U0CduA: checks 
*** FLOP *** [3d 4s 6c]
HOEaXncFu2ij+D5/CANAZA: checks 
2Xwi447v1rBHM+92U0CduA: bets $0.75
HOEaXncFu2ij+D5/CANAZA: folds 
Uncalled bet ($0.75) returned to 2Xwi447v1rBHM+92U0CduA
2Xwi447v1rBHM+92U0CduA collected $0.50 from pot
2Xwi447v1rBHM+92U0CduA: doesn't show hand 
*** SUMMARY ***
Total pot $0.50 | Rake $0 
Board [3d 4s 6c]
Seat 1: j4q3p0lesp63b1gZDwLBZw folded before Flop (didn't bet)
Seat 2: vSkQm2EelzwRGDDQQk0Fqw (button) folded before Flop (didn't bet)
Seat 3: HOEaXncFu2ij+D5/CANAZA (small blind) folded on the Flop
Seat 4: 2Xwi447v1rBHM+92U0CduA (big blind) collected ($0.50)
Seat 5: yyG4svzOpC1A+sUP/scg6w folded before Flop (didn't bet)
Seat 6: sC4BsflLWW26Qm9m+1AwJQ folded before Flop (didn't bet)
Seat 8: 7je+LC5Mfs6nL8YBVh4frQ folded before Flop (didn't bet)
Seat 9: K0b5wNInj6hUGRr6yzKFtw folded before Flop (didn't bet)




PokerStars Game #59941772576:  Hold'em No Limit ($0.10/$0.25) - 2009/07/01 1:45:40 ET
Table 'nQC9LRg01NEuKFHF1nrDEw0XPo7K54oZIfG0xlNAcDRw-max Seat #2 is the button
Seat 1: qf+LMbROj8/qY878wkFHbQ ($14.80 in chips) 
Seat 2: ZhV6dUX9NQhT4zf7t+ZLJg ($21.75 in chips) 
Seat 3: 6+g0Lb6vfRDZkElV8ieHyQ ($24.35 in chips) 
Seat 5: kG34n23qFQA3nzdOJTQ1dA ($29.05 in chips) 
Seat 6: xQVFeVUDopz+akuEo2wXpQ ($56.30 in chips) 
6+g0Lb6vfRDZkElV8ieHyQ: posts small blind $0.10
kG34n23qFQA3nzdOJTQ1dA: posts big blind $0.25
*** HOLE CARDS ***
xQVFeVUDopz+akuEo2wXpQ: folds 
qf+LMbROj8/qY878wkFHbQ: folds 
ZhV6dUX9NQhT4zf7t+ZLJg: raises $0.75 to $1
6+g0Lb6vfRDZkElV8ieHyQ: folds 
kG34n23qFQA3nzdOJTQ1dA: folds 
Uncalled bet ($0.75) returned to ZhV6dUX9NQhT4zf7t+ZLJg
ZhV6dUX9NQhT4zf7t+ZLJg collected $0.60 from pot
*** SUMMARY ***
Total pot $0.60 | Rake $0 
Seat 1: qf+LMbROj8/qY878wkFHbQ folded before Flop (didn't bet)
Seat 2: ZhV6dUX9NQhT4zf7t+ZLJg (button) collected ($0.60)
Seat 3: 6+g0Lb6vfRDZkElV8ieHyQ (small blind) folded before Flop
Seat 5: kG34n23qFQA3nzdOJTQ1dA (big blind) folded before Flop
Seat 6: xQVFeVUDopz+akuEo2wXpQ folded before Flop (didn't bet)




PokerStars Game #59941772172:  Hold'em No Limit ($0.10/$0.25) - 2009/07/01 1:45:40 ET
Table 'M7d9IrgQUUFFy/SZ3ksLYg' 6-max Seat #1 is the button
Seat 1: ypmjhffk/YHGc51wgVXUTw ($49.25 in chips) 
Seat 2: gqrr7lSWrQ1N8zKx8zZzvA ($4.90 in chips) 
Seat 4: 8ClCHtFXGNplITm+63KB+Q ($24.55 in chips) 
Seat 5: kMa8BltUcBQVxnHfqdCfXg ($7.75 in chips) 
Seat 6: 7S16WhQHiAVLWwRuqPrpnw ($13.05 in chips) 
gqrr7lSWrQ1N8zKx8zZzvA: posts small blind $0.10
8ClCHtFXGNplITm+63KB+Q: posts big blind $0.25
*** HOLE CARDS ***
epAUIB7h2FJXzUPRIvSkRA joins the table at seat #3 
kMa8BltUcBQVxnHfqdCfXg: calls $0.25
7S16WhQHiAVLWwRuqPrpnw has timed out
7S16WhQHiAVLWwRuqPrpnw: folds 
7S16WhQHiAVLWwRuqPrpnw is sitting out
ypmjhffk/YHGc51wgVXUTw: folds 
gqrr7lSWrQ1N8zKx8zZzvA: calls $0.15
8ClCHtFXGNplITm+63KB+Q: checks 
*** FLOP *** [5s Kd 7h]
gqrr7lSWrQ1N8zKx8zZzvA: checks 
8ClCHtFXGNplITm+63KB+Q: checks 
kMa8BltUcBQVxnHfqdCfXg: bets $0.50
gqrr7lSWrQ1N8zKx8zZzvA: folds 
8ClCHtFXGNplITm+63KB+Q: folds 
Uncalled bet ($0.50) returned to kMa8BltUcBQVxnHfqdCfXg
kMa8BltUcBQVxnHfqdCfXg collected $0.75 from pot
*** SUMMARY ***
Total pot $0.75 | Rake $0 
Board [5s Kd 7h]
Seat 1: ypmjhffk/YHGc51wgVXUTw (button) folded before Flop (didn't bet)
Seat 2: gqrr7lSWrQ1N8zKx8zZzvA (small blind) folded on the Flop
Seat 4: 8ClCHtFXGNplITm+63KB+Q (big blind) folded on the Flop
Seat 5: kMa8BltUcBQVxnHfqdCfXg collected ($0.75)
Seat 6: 7S16WhQHiAVLWwRuqPrpnw folded before Flop (didn't bet)




PokerStars Game #59941772654:  Hold'em No Limit ($0.10/$0.25) - 2009/07/01 1:45:40 ET
Table 'Xi38lWH8L2JHRAsKYVX8Qg' 6-max Seat #3 is the button
Seat 1: shP7DFAtX7gXcgMJX/OmRQ ($18.80 in chips) 
Seat 2: VOmI0x4dDPnTESZd5B4d1Q ($9.10 in chips) 
Seat 3: 6DwBRH+xZ12AAZmeAg+aXw ($35.20 in chips) 
Seat 4: kG34n23qFQA3nzdOJTQ1dA ($24.60 in chips) 
Seat 5: 79ID/ub1Pt/mDpCprVmOoA ($77.95 in chips) 
Seat 6: kyRaCIljYA6l33lSKQfNsg ($29.40 in chips) 
kG34n23qFQA3nzdOJTQ1dA: posts small blind $0.10
79ID/ub1Pt/mDpCprVmOoA: posts big blind $0.25
*** HOLE CARDS ***
kyRaCIljYA6l33lSKQfNsg: folds 
shP7DFAtX7gXcgMJX/OmRQ: calls $0.25
VOmI0x4dDPnTESZd5B4d1Q: folds 
6DwBRH+xZ12AAZmeAg+aXw: folds 
kG34n23qFQA3nzdOJTQ1dA: folds 
79ID/ub1Pt/mDpCprVmOoA: checks 
*** FLOP *** [Ts 3d Ks]
79ID/ub1Pt/mDpCprVmOoA: checks 
shP7DFAtX7gXcgMJX/OmRQ: bets $0.50
79ID/ub1Pt/mDpCprVmOoA: folds 
Uncalled bet ($0.50) returned to shP7DFAtX7gXcgMJX/OmRQ
shP7DFAtX7gXcgMJX/OmRQ collected $0.60 from pot
shP7DFAtX7gXcgMJX/OmRQ: doesn't show hand 
*** SUMMARY ***
Total pot $0.60 | Rake $0 
Board [Ts 3d Ks]
Seat 1: shP7DFAtX7gXcgMJX/OmRQ collected ($0.60)
Seat 2: VOmI0x4dDPnTESZd5B4d1Q folded before Flop (didn't bet)
Seat 3: 6DwBRH+xZ12AAZmeAg+aXw (button) folded before Flop (didn't bet)
Seat 4: kG34n23qFQA3nzdOJTQ1dA (small blind) folded before Flop
Seat 5: 79ID/ub1Pt/mDpCprVmOoA (big blind) folded on the Flop
Seat 6: kyRaCIljYA6l33lSKQfNsg folded before Flop (didn't bet)




PokerStars Game #59941772766:  Hold'em No Limit ($0.10/$0.25) - 2009/07/01 1:45:41 ET
Table 'C8mMnVmvkagwolEzTvh07A' 9-max Seat #7 is the button
Seat 1: PqvgxdSg9z5VmrWpbYuz+g ($27.50 in chips) 
Seat 2: Bb42QRQMhg5/Y0vHP8/2Xw ($25 in chips) 
Seat 3: Th3FldXKQW6hWVVPahaoOQ ($35.35 in chips) 
Seat 4: dfNim92Z6XK1/h5SFW5vDg ($25 in chips) 
Seat 5: iGMlK+EhUflPB6jKQd95Cg ($27.50 in chips) 
Seat 6: AiXn/9o1EwOPZUHujnh/bA ($18.50 in chips) 
Seat 7: qmEgnPhQt24xdw/ZRVPLbA ($46.50 in chips) 
Seat 9: 4awUyiDYTgylQKXZ9faBVA ($25 in chips) 
4awUyiDYTgylQKXZ9faBVA: posts small blind $0.10
PqvgxdSg9z5VmrWpbYuz+g: posts big blind $0.25
*** HOLE CARDS ***
Bb42QRQMhg5/Y0vHP8/2Xw: folds 
Th3FldXKQW6hWVVPahaoOQ: folds 
dfNim92Z6XK1/h5SFW5vDg: folds 
iGMlK+EhUflPB6jKQd95Cg: raises $0.50 to $0.75
AiXn/9o1EwOPZUHujnh/bA: folds 
qmEgnPhQt24xdw/ZRVPLbA: raises $2.75 to $3.50
4awUyiDYTgylQKXZ9faBVA: calls $3.40
PqvgxdSg9z5VmrWpbYuz+g: folds 
iGMlK+EhUflPB6jKQd95Cg: calls $2.75
*** FLOP *** [5h 2c As]
4awUyiDYTgylQKXZ9faBVA: checks 
iGMlK+EhUflPB6jKQd95Cg: checks 
qmEgnPhQt24xdw/ZRVPLbA: bets $6.25
4awUyiDYTgylQKXZ9faBVA: calls $6.25
iGMlK+EhUflPB6jKQd95Cg: folds 
*** TURN *** [5h 2c As] [3c]
4awUyiDYTgylQKXZ9faBVA: bets $15.25 and is all-in
qmEgnPhQt24xdw/ZRVPLbA: folds 
Uncalled bet ($15.25) returned to 4awUyiDYTgylQKXZ9faBVA
4awUyiDYTgylQKXZ9faBVA collected $22.15 from pot
4awUyiDYTgylQKXZ9faBVA: doesn't show hand 
*** SUMMARY ***
Total pot $23.25 | Rake $1.10 
Board [5h 2c As 3c]
Seat 1: PqvgxdSg9z5VmrWpbYuz+g (big blind) folded before Flop
Seat 2: Bb42QRQMhg5/Y0vHP8/2Xw folded before Flop (didn't bet)
Seat 3: Th3FldXKQW6hWVVPahaoOQ folded before Flop (didn't bet)
Seat 4: dfNim92Z6XK1/h5SFW5vDg folded before Flop (didn't bet)
Seat 5: iGMlK+EhUflPB6jKQd95Cg folded on the Flop
Seat 6: AiXn/9o1EwOPZUHujnh/bA folded before Flop (didn't bet)
Seat 7: qmEgnPhQt24xdw/ZRVPLbA (button) folded on the Turn
Seat 9: 4awUyiDYTgylQKXZ9faBVA (small blind) collected ($22.15)




PokerStars Game #59941772866:  Hold'em No Limit ($0.10/$0.25) - 2009/07/01 1:45:41 ET
Table 'zhqgUUprOJ14VxKxPHcT/Q' 9-max Seat #2 is the button
Seat 1: 22dIObOuor/A+IKWkNoAlA ($5.50 in chips) 
Seat 2: GY095KWhBevJ1Ttvl8WseA ($14.25 in chips) 
Seat 3: 4XHsdGnQ76EBdBvsrSs8bA ($24.90 in chips) 
Seat 4: wGigCmBR/9XWkPpvYos3aQ ($33.45 in chips) 
Seat 5: +sbyWwIcFp9kP0bDtMegfQ ($33.60 in chips) 
Seat 7: sGFnnRCa1YAHAUmWgsW6Qg ($11 in chips) 
Seat 8: EQXHDnIzAsORnIXRNtXRlA ($24.10 in chips) 
Seat 9: 4awUyiDYTgylQKXZ9faBVA ($25.80 in chips) 
4XHsdGnQ76EBdBvsrSs8bA: posts small blind $0.10
wGigCmBR/9XWkPpvYos3aQ: posts big blind $0.25
PdIasPkzm2sqZnN41ZRXOg: sits out 
*** HOLE CARDS ***
+sbyWwIcFp9kP0bDtMegfQ: folds 
sGFnnRCa1YAHAUmWgsW6Qg: folds 
EQXHDnIzAsORnIXRNtXRlA: folds 
4awUyiDYTgylQKXZ9faBVA: folds 
22dIObOuor/A+IKWkNoAlA: folds 
GY095KWhBevJ1Ttvl8WseA: folds 
4XHsdGnQ76EBdBvsrSs8bA: folds 
Uncalled bet ($0.15) returned to wGigCmBR/9XWkPpvYos3aQ
wGigCmBR/9XWkPpvYos3aQ collected $0.20 from pot
wGigCmBR/9XWkPpvYos3aQ: doesn't show hand 
*** SUMMARY ***
Total pot $0.20 | Rake $0 
Seat 1: 22dIObOuor/A+IKWkNoAlA folded before Flop (didn't bet)
Seat 2: GY095KWhBevJ1Ttvl8WseA (button) folded before Flop (didn't bet)
Seat 3: 4XHsdGnQ76EBdBvsrSs8bA (small blind) folded before Flop
Seat 4: wGigCmBR/9XWkPpvYos3aQ (big blind) collected ($0.20)
Seat 5: +sbyWwIcFp9kP0bDtMegfQ folded before Flop (didn't bet)
Seat 7: sGFnnRCa1YAHAUmWgsW6Qg folded before Flop (didn't bet)
Seat 8: EQXHDnIzAsORnIXRNtXRlA folded before Flop (didn't bet)
Seat 9: 4awUyiDYTgylQKXZ9faBVA folded before Flop (didn't bet)




PokerStars Game #59941772864:  Hold'em No Limit ($0.10/$0.25) - 2009/07/01 1:45:41 ET
Table 'oJpFwZj9+FUGHX90Un8s9Q' 6-max Seat #1 is the button
Seat 1: 6DwBRH+xZ12AAZmeAg+aXw ($23.55 in chips) 
Seat 2: NtrVQ9UIql0rDCnKDKZ5FQ ($14.55 in chips) 
Seat 3: kyRaCIljYA6l33lSKQfNsg ($26.25 in chips) 
Seat 4: 6elpmfyt4Zw0yvd8lePSMQ ($21.55 in chips) 
Seat 5: kG34n23qFQA3nzdOJTQ1dA ($56.80 in chips) 
NtrVQ9UIql0rDCnKDKZ5FQ: posts small blind $0.10
kyRaCIljYA6l33lSKQfNsg: posts big blind $0.25
7LpHJVeM6k1mQdC6HXYzww: sits out 
*** HOLE CARDS ***
6elpmfyt4Zw0yvd8lePSMQ: folds 
kG34n23qFQA3nzdOJTQ1dA: calls $0.25
6DwBRH+xZ12AAZmeAg+aXw: folds 
NtrVQ9UIql0rDCnKDKZ5FQ: calls $0.15
kyRaCIljYA6l33lSKQfNsg: checks 
*** FLOP *** [7s 6c 4c]
NtrVQ9UIql0rDCnKDKZ5FQ: checks 
kyRaCIljYA6l33lSKQfNsg: checks 
kG34n23qFQA3nzdOJTQ1dA: bets $0.50
NtrVQ9UIql0rDCnKDKZ5FQ: calls $0.50
kyRaCIljYA6l33lSKQfNsg: folds 
*** TURN *** [7s 6c 4c] [5s]
NtrVQ9UIql0rDCnKDKZ5FQ: checks 
kG34n23qFQA3nzdOJTQ1dA: checks 
*** RIVER *** [7s 6c 4c 5s] [7d]
NtrVQ9UIql0rDCnKDKZ5FQ: bets $0.25
kG34n23qFQA3nzdOJTQ1dA: calls $0.25
*** SHOW DOWN ***
NtrVQ9UIql0rDCnKDKZ5FQ: shows [Ts 7h] (three of a kind, Sevens)
kG34n23qFQA3nzdOJTQ1dA: mucks hand 
NtrVQ9UIql0rDCnKDKZ5FQ collected $2.15 from pot
*** SUMMARY ***
Total pot $2.25 | Rake $0.10 
Board [7s 6c 4c 5s 7d]
Seat 1: 6DwBRH+xZ12AAZmeAg+aXw (button) folded before Flop (didn't bet)
Seat 2: NtrVQ9UIql0rDCnKDKZ5FQ (small blind) showed [Ts 7h] and won ($2.15) with three of a kind, Sevens
Seat 3: kyRaCIljYA6l33lSKQfNsg (big blind) folded on the Flop
Seat 4: 6elpmfyt4Zw0yvd8lePSMQ folded before Flop (didn't bet)
Seat 5: kG34n23qFQA3nzdOJTQ1dA mucked




PokerStars Game #59941773264:  Hold'em No Limit ($0.10/$0.25) - 2009/07/01 1:45:42 ET
Table 'hOE09W281uSob0XeJmUcRg' 6-max Seat #5 is the button
Seat 1: mfrkWA3PTeYPkbO6hi98Aw ($27.30 in chips) 
Seat 2: lRKJ8o/CnOPFwfHHm6ioMw ($12.25 in chips) 
Seat 3: y+a/yGW/Jy4bPJFnaeTz5w ($13.60 in chips) 
Seat 5: JFIAqU8lCZ0vWwEl4bdGsg ($25.25 in chips) 
Seat 6: x4ZJ8E/TUrtoB7WiHcv8WA ($17.10 in chips) 
x4ZJ8E/TUrtoB7WiHcv8WA: posts small blind $0.10
mfrkWA3PTeYPkbO6hi98Aw: posts big blind $0.25
*** HOLE CARDS ***
lRKJ8o/CnOPFwfHHm6ioMw: calls $0.25
y+a/yGW/Jy4bPJFnaeTz5w: folds 
JFIAqU8lCZ0vWwEl4bdGsg: folds 
x4ZJ8E/TUrtoB7WiHcv8WA: calls $0.15
mfrkWA3PTeYPkbO6hi98Aw: checks 
*** FLOP *** [8h 6d 8d]
x4ZJ8E/TUrtoB7WiHcv8WA: checks 
mfrkWA3PTeYPkbO6hi98Aw: checks 
lRKJ8o/CnOPFwfHHm6ioMw: checks 
*** TURN *** [8h 6d 8d] [3s]
x4ZJ8E/TUrtoB7WiHcv8WA: checks 
mfrkWA3PTeYPkbO6hi98Aw: checks 
lRKJ8o/CnOPFwfHHm6ioMw: checks 
*** RIVER *** [8h 6d 8d 3s] [3c]
x4ZJ8E/TUrtoB7WiHcv8WA: checks 
mfrkWA3PTeYPkbO6hi98Aw: checks 
lRKJ8o/CnOPFwfHHm6ioMw: bets $0.25
x4ZJ8E/TUrtoB7WiHcv8WA: calls $0.25
mfrkWA3PTeYPkbO6hi98Aw: folds 
*** SHOW DOWN ***
lRKJ8o/CnOPFwfHHm6ioMw: shows [Qs Kd] (two pair, Eights and Threes)
x4ZJ8E/TUrtoB7WiHcv8WA: mucks hand 
lRKJ8o/CnOPFwfHHm6ioMw collected $1.20 from pot
*** SUMMARY ***
Total pot $1.25 | Rake $0.05 
Board [8h 6d 8d 3s 3c]
Seat 1: mfrkWA3PTeYPkbO6hi98Aw (big blind) folded on the River
Seat 2: lRKJ8o/CnOPFwfHHm6ioMw showed [Qs Kd] and won ($1.20) with two pair, Eights and Threes
Seat 3: y+a/yGW/Jy4bPJFnaeTz5w folded before Flop (didn't bet)
Seat 5: JFIAqU8lCZ0vWwEl4bdGsg (button) folded before Flop (didn't bet)
Seat 6: x4ZJ8E/TUrtoB7WiHcv8WA (small blind) mucked




PokerStars Game #59941773444:  Hold'em No Limit ($0.10/$0.25) - 2009/07/01 1:45:42 ET
Table 'ER5H84HUgJx7HyDLnELLeA' 6-max Seat #1 is the button
Seat 1: LJI7A1YgDM7hgh7o56+ReQ ($27.15 in chips) 
Seat 2: buyjetgNT1McXtdaP4zynA ($19.50 in chips) 
Seat 4: vqWjZmdQu/Hxw96/IJTWdQ ($25 in chips) 
Seat 5: mfrkWA3PTeYPkbO6hi98Aw ($26.70 in chips) 
Seat 6: 3zD3qLXT1bEffAoWGnc7wg ($51 in chips) 
buyjetgNT1McXtdaP4zynA: posts small blind $0.10
vqWjZmdQu/Hxw96/IJTWdQ: posts big blind $0.25
*** HOLE CARDS ***
mfrkWA3PTeYPkbO6hi98Aw: folds 
3zD3qLXT1bEffAoWGnc7wg: folds 
LJI7A1YgDM7hgh7o56+ReQ: folds 
buyjetgNT1McXtdaP4zynA: calls $0.15
vqWjZmdQu/Hxw96/IJTWdQ: checks 
*** FLOP *** [Ah Ts 7d]
buyjetgNT1McXtdaP4zynA: checks 
vqWjZmdQu/Hxw96/IJTWdQ: checks 
*** TURN *** [Ah Ts 7d] [Jc]
buyjetgNT1McXtdaP4zynA: bets $0.50
vqWjZmdQu/Hxw96/IJTWdQ: folds 
Uncalled bet ($0.50) returned to buyjetgNT1McXtdaP4zynA
h8w8ting is connected 
buyjetgNT1McXtdaP4zynA collected $0.50 from pot
h8w8ting has returned
*** SUMMARY ***
Total pot $0.50 | Rake $0 
Board [Ah Ts 7d Jc]
Seat 1: LJI7A1YgDM7hgh7o56+ReQ (button) folded before Flop (didn't bet)
Seat 2: buyjetgNT1McXtdaP4zynA (small blind) collected ($0.50)
Seat 4: vqWjZmdQu/Hxw96/IJTWdQ (big blind) folded on the Turn
Seat 5: mfrkWA3PTeYPkbO6hi98Aw folded before Flop (didn't bet)
Seat 6: 3zD3qLXT1bEffAoWGnc7wg folded before Flop (didn't bet)




PokerStars Game #59941773458:  Hold'em No Limit ($0.10/$0.25) - 2009/07/01 1:45:42 ET
Table 'mVdLgAdN9rGe6mMwSrDdGQ' 6-max Seat #4 is the button
Seat 1: OyJ0KTHA5cwh0/yCo1/rdA ($19.05 in chips) 
Seat 2: n9QqWD4tpbongUBX2Oi58w ($6.20 in chips) 
Seat 3: +baiVgI/ETnBARLe5mARCw ($13.95 in chips) 
Seat 4: scNSjC6yyKvvfklSkuzLrw ($8.95 in chips) 
Seat 5: +TMG/MBWpiEnc9t7i07eTA ($26.75 in chips) 
Seat 6: DihMHaz4WNETH1bPDe13kA ($47.80 in chips) 
+TMG/MBWpiEnc9t7i07eTA: posts small blind $0.10
DihMHaz4WNETH1bPDe13kA: posts big blind $0.25
*** HOLE CARDS ***
OyJ0KTHA5cwh0/yCo1/rdA: folds 
n9QqWD4tpbongUBX2Oi58w: folds 
+baiVgI/ETnBARLe5mARCw: folds 
scNSjC6yyKvvfklSkuzLrw: calls $0.25
+TMG/MBWpiEnc9t7i07eTA: folds 
DihMHaz4WNETH1bPDe13kA: checks 
*** FLOP *** [Ah 9s 5d]
DihMHaz4WNETH1bPDe13kA: checks 
scNSjC6yyKvvfklSkuzLrw: bets $0.50
DihMHaz4WNETH1bPDe13kA: folds 
Uncalled bet ($0.50) returned to scNSjC6yyKvvfklSkuzLrw
scNSjC6yyKvvfklSkuzLrw collected $0.60 from pot
*** SUMMARY ***
Total pot $0.60 | Rake $0 
Board [Ah 9s 5d]
Seat 1: OyJ0KTHA5cwh0/yCo1/rdA folded before Flop (didn't bet)
Seat 2: n9QqWD4tpbongUBX2Oi58w folded before Flop (didn't bet)
Seat 3: +baiVgI/ETnBARLe5mARCw folded before Flop (didn't bet)
Seat 4: scNSjC6yyKvvfklSkuzLrw (button) collected ($0.60)
Seat 5: +TMG/MBWpiEnc9t7i07eTA (small blind) folded before Flop
Seat 6: DihMHaz4WNETH1bPDe13kA (big blind) folded on the Flop




PokerStars Game #59941773166:  Hold'em No Limit ($0.10/$0.25) - 2009/07/01 1:45:42 ET
Table 'Ok3oDLIsTc2+KxPcI0bAOA' 6-max Seat #4 is the button
Seat 1: agQm3ugZ3qSVYNgNu1ddeA ($40.75 in chips) 
Seat 2: wPSNSp4HYtytRMXTu3oPSQ ($26.95 in chips) 
Seat 3: lquriepNQBhDV5P1SWHhnA ($36.45 in chips) 
Seat 4: LJI7A1YgDM7hgh7o56+ReQ ($36.55 in chips) 
Seat 5: DFi/Lzkjsfv8QswS80JX9Q ($28.35 in chips) 
Seat 6: Hsvkc0/G2VV78oVmWYXecw ($5 in chips) 
DFi/Lzkjsfv8QswS80JX9Q: posts small blind $0.10
Hsvkc0/G2VV78oVmWYXecw: posts big blind $0.25
*** HOLE CARDS ***
agQm3ugZ3qSVYNgNu1ddeA: calls $0.25
wPSNSp4HYtytRMXTu3oPSQ: folds 
lquriepNQBhDV5P1SWHhnA: folds 
LJI7A1YgDM7hgh7o56+ReQ: raises $1 to $1.25
DFi/Lzkjsfv8QswS80JX9Q: raises $2 to $3.25
Hsvkc0/G2VV78oVmWYXecw: folds 
agQm3ugZ3qSVYNgNu1ddeA: folds 
LJI7A1YgDM7hgh7o56+ReQ: folds 
Uncalled bet ($2) returned to DFi/Lzkjsfv8QswS80JX9Q
DFi/Lzkjsfv8QswS80JX9Q collected $3 from pot
DFi/Lzkjsfv8QswS80JX9Q: doesn't show hand 
*** SUMMARY ***
Total pot $3 | Rake $0 
Seat 1: agQm3ugZ3qSVYNgNu1ddeA folded before Flop
Seat 2: wPSNSp4HYtytRMXTu3oPSQ folded before Flop (didn't bet)
Seat 3: lquriepNQBhDV5P1SWHhnA folded before Flop (didn't bet)
Seat 4: LJI7A1YgDM7hgh7o56+ReQ (button) folded before Flop
Seat 5: DFi/Lzkjsfv8QswS80JX9Q (small blind) collected ($3)
Seat 6: Hsvkc0/G2VV78oVmWYXecw (big blind) folded before Flop




PokerStars Game #59941773440:  Hold'em No Limit ($0.10/$0.25) - 2009/07/01 1:45:42 ET
Table '3Ns9nuTkynfwbBfBXzg6ww' 6-max Seat #1 is the button
Seat 1: epAUIB7h2FJXzUPRIvSkRA ($25.35 in chips) 
Seat 2: zxeVQGaMKDsDzmSY+AInjA ($37.90 in chips) 
Seat 3: eL3+wCBjFGfQ5FMdIZihwA ($24.30 in chips) 
Seat 4: qGHGf/553gQnDoklMRe3tg ($30.60 in chips) 
Seat 5: wqphQtauX5Qn7WRJZS1flA ($24.05 in chips) 
Seat 6: DE9hRlt14g+JdsRQ4wT7hg ($33.20 in chips) 
zxeVQGaMKDsDzmSY+AInjA: posts small blind $0.10
eL3+wCBjFGfQ5FMdIZihwA: posts big blind $0.25
*** HOLE CARDS ***
qGHGf/553gQnDoklMRe3tg: folds 
wqphQtauX5Qn7WRJZS1flA has timed out
wqphQtauX5Qn7WRJZS1flA: folds 
wqphQtauX5Qn7WRJZS1flA is sitting out
wqphQtauX5Qn7WRJZS1flA has returned
DE9hRlt14g+JdsRQ4wT7hg: raises $0.75 to $1
epAUIB7h2FJXzUPRIvSkRA: folds 
zxeVQGaMKDsDzmSY+AInjA: calls $0.90
eL3+wCBjFGfQ5FMdIZihwA: folds 
*** FLOP *** [6s Jh 9s]
zxeVQGaMKDsDzmSY+AInjA: checks 
DE9hRlt14g+JdsRQ4wT7hg: bets $1.50
zxeVQGaMKDsDzmSY+AInjA: calls $1.50
*** TURN *** [6s Jh 9s] [8d]
zxeVQGaMKDsDzmSY+AInjA: checks 
DE9hRlt14g+JdsRQ4wT7hg: bets $3.75
zxeVQGaMKDsDzmSY+AInjA: calls $3.75
*** RIVER *** [6s Jh 9s 8d] [Ac]
zxeVQGaMKDsDzmSY+AInjA: checks 
DE9hRlt14g+JdsRQ4wT7hg: bets $10
zxeVQGaMKDsDzmSY+AInjA: folds 
Uncalled bet ($10) returned to DE9hRlt14g+JdsRQ4wT7hg
DE9hRlt14g+JdsRQ4wT7hg collected $12.15 from pot
DE9hRlt14g+JdsRQ4wT7hg: doesn't show hand 
*** SUMMARY ***
Total pot $12.75 | Rake $0.60 
Board [6s Jh 9s 8d Ac]
Seat 1: epAUIB7h2FJXzUPRIvSkRA (button) folded before Flop (didn't bet)
Seat 2: zxeVQGaMKDsDzmSY+AInjA (small blind) folded on the River
Seat 3: eL3+wCBjFGfQ5FMdIZihwA (big blind) folded before Flop
Seat 4: qGHGf/553gQnDoklMRe3tg folded before Flop (didn't bet)
Seat 5: wqphQtauX5Qn7WRJZS1flA folded before Flop (didn't bet)
Seat 6: DE9hRlt14g+JdsRQ4wT7hg collected ($12.15)




PokerStars Game #59941773958:  Hold'em No Limit ($0.10/$0.25) - 2009/07/01 1:45:43 ET
Table 'T/iCKJXGphRN3xcdwfE/JQ' 6-max Seat #1 is the button
Seat 1: wAKC8C/zN0c8V5v13dm9mA ($25 in chips) 
Seat 2: EeUZtMU058v2ObUACOF4Og ($32.10 in chips) 
Seat 3: IWAjoCPXtc1XUaZdp+pCpA ($23.35 in chips) 
Seat 4: tSR4329m40dZsN7YOpI9Kw ($52.95 in chips) 
Seat 5: gaPMxLGp9SOj4Lq6t+/0Ig ($8.10 in chips) 
Seat 6: Ey4Kn6PlnYb2srYYBJHvzg ($13.55 in chips) 
EeUZtMU058v2ObUACOF4Og: posts small blind $0.10
IWAjoCPXtc1XUaZdp+pCpA: posts big blind $0.25
*** HOLE CARDS ***
tSR4329m40dZsN7YOpI9Kw: folds 
gaPMxLGp9SOj4Lq6t+/0Ig: folds 
tSR4329m40dZsN7YOpI9Kw leaves the table
Ey4Kn6PlnYb2srYYBJHvzg: folds 
wAKC8C/zN0c8V5v13dm9mA: raises $0.75 to $1
EeUZtMU058v2ObUACOF4Og: folds 
IWAjoCPXtc1XUaZdp+pCpA: folds 
Uncalled bet ($0.75) returned to wAKC8C/zN0c8V5v13dm9mA
wAKC8C/zN0c8V5v13dm9mA collected $0.60 from pot
*** SUMMARY ***
Total pot $0.60 | Rake $0 
Seat 1: wAKC8C/zN0c8V5v13dm9mA (button) collected ($0.60)
Seat 2: EeUZtMU058v2ObUACOF4Og (small blind) folded before Flop
Seat 3: IWAjoCPXtc1XUaZdp+pCpA (big blind) folded before Flop
Seat 4: tSR4329m40dZsN7YOpI9Kw folded before Flop (didn't bet)
Seat 5: gaPMxLGp9SOj4Lq6t+/0Ig folded before Flop (didn't bet)
Seat 6: Ey4Kn6PlnYb2srYYBJHvzg folded before Flop (didn't bet)




PokerStars Game #59941773828:  Hold'em No Limit ($0.10/$0.25) - 2009/07/01 1:45:43 ET
Table 'xPn6TS/y/OWkX7Qa+MUuKA' 6-max Seat #5 is the button
Seat 1: JFIAqU8lCZ0vWwEl4bdGsg ($43.05 in chips) 
Seat 2: buyjetgNT1McXtdaP4zynA ($27.60 in chips) 
Seat 3: q6WfTUAD9mowIP63ASq2Dg ($24.15 in chips) 
Seat 4: SS/yfeArhULzIcOPe8MdPg ($28.65 in chips) 
Seat 5: lquriepNQBhDV5P1SWHhnA ($28.25 in chips) 
Seat 6: DihMHaz4WNETH1bPDe13kA ($25.10 in chips) 
DihMHaz4WNETH1bPDe13kA: posts small blind $0.10
JFIAqU8lCZ0vWwEl4bdGsg: posts big blind $0.25
*** HOLE CARDS ***
buyjetgNT1McXtdaP4zynA: folds 
q6WfTUAD9mowIP63ASq2Dg: folds 
SS/yfeArhULzIcOPe8MdPg: folds 
lquriepNQBhDV5P1SWHhnA: raises $0.50 to $0.75
DihMHaz4WNETH1bPDe13kA: folds 
JFIAqU8lCZ0vWwEl4bdGsg: folds 
Uncalled bet ($0.50) returned to lquriepNQBhDV5P1SWHhnA
lquriepNQBhDV5P1SWHhnA collected $0.60 from pot
lquriepNQBhDV5P1SWHhnA: doesn't show hand 
*** SUMMARY ***
Total pot $0.60 | Rake $0 
Seat 1: JFIAqU8lCZ0vWwEl4bdGsg (big blind) folded before Flop
Seat 2: buyjetgNT1McXtdaP4zynA folded before Flop (didn't bet)
Seat 3: q6WfTUAD9mowIP63ASq2Dg folded before Flop (didn't bet)
Seat 4: SS/yfeArhULzIcOPe8MdPg folded before Flop (didn't bet)
Seat 5: lquriepNQBhDV5P1SWHhnA (button) collected ($0.60)
Seat 6: DihMHaz4WNETH1bPDe13kA (small blind) folded before Flop




PokerStars Game #59941774130:  Hold'em No Limit ($0.10/$0.25) - 2009/07/01 1:45:43 ET
Table 'iMiAw/kTZXopgYX4HI7sHg' 9-max Seat #3 is the button
Seat 1: PdIasPkzm2sqZnN41ZRXOg ($5 in chips) 
Seat 2: qwr38jl5txoR36M7G5qi4A ($8.25 in chips) 
Seat 3: HPEB+AtKw1+C/cxU0o1ciw ($27.90 in chips) 
Seat 4: Z9W7+g1WMhhZDi7DwGbCFA ($5 in chips) 
Seat 5: 22dIObOuor/A+IKWkNoAlA ($5.10 in chips) 
Seat 6: Bb42QRQMhg5/Y0vHP8/2Xw ($29.05 in chips) 
Seat 8: tLcDklc2rBORNfixyRfVfw ($30.15 in chips) 
Seat 9: 7cv+9Zc9HIQHNvYsMfV3uA ($25 in chips) 
Z9W7+g1WMhhZDi7DwGbCFA: posts small blind $0.10
22dIObOuor/A+IKWkNoAlA: posts big blind $0.25
ipLwYjdAXnvG54zETKPvbQ: sits out 
*** HOLE CARDS ***
Bb42QRQMhg5/Y0vHP8/2Xw: folds 
tLcDklc2rBORNfixyRfVfw: calls $0.25
7cv+9Zc9HIQHNvYsMfV3uA: folds 
PdIasPkzm2sqZnN41ZRXOg: folds 
qwr38jl5txoR36M7G5qi4A: folds 
HPEB+AtKw1+C/cxU0o1ciw: folds 
Z9W7+g1WMhhZDi7DwGbCFA: folds 
22dIObOuor/A+IKWkNoAlA: checks 
*** FLOP *** [3h Ah Tc]
22dIObOuor/A+IKWkNoAlA: checks 
tLcDklc2rBORNfixyRfVfw: checks 
*** TURN *** [3h Ah Tc] [Jc]
22dIObOuor/A+IKWkNoAlA: bets $0.25
tLcDklc2rBORNfixyRfVfw: folds 
Uncalled bet ($0.25) returned to 22dIObOuor/A+IKWkNoAlA
22dIObOuor/A+IKWkNoAlA collected $0.60 from pot
22dIObOuor/A+IKWkNoAlA: doesn't show hand 
*** SUMMARY ***
Total pot $0.60 | Rake $0 
Board [3h Ah Tc Jc]
Seat 1: PdIasPkzm2sqZnN41ZRXOg folded before Flop (didn't bet)
Seat 2: qwr38jl5txoR36M7G5qi4A folded before Flop (didn't bet)
Seat 3: HPEB+AtKw1+C/cxU0o1ciw (button) folded before Flop (didn't bet)
Seat 4: Z9W7+g1WMhhZDi7DwGbCFA (small blind) folded before Flop
Seat 5: 22dIObOuor/A+IKWkNoAlA (big blind) collected ($0.60)
Seat 6: Bb42QRQMhg5/Y0vHP8/2Xw folded before Flop (didn't bet)
Seat 8: tLcDklc2rBORNfixyRfVfw folded on the Turn
Seat 9: 7cv+9Zc9HIQHNvYsMfV3uA folded before Flop (didn't bet)




PokerStars Game #59941773956:  Hold'em No Limit ($0.10/$0.25) - 2009/07/01 1:45:43 ET
Table 'IRgQPZVA4+IaZZIQshgwyg' 6-max Seat #2 is the button
Seat 1: cezpHJ8FB07dj0xG+LhOvw ($27.55 in chips) 
Seat 2: lquriepNQBhDV5P1SWHhnA ($25 in chips) 
Seat 3: DihMHaz4WNETH1bPDe13kA ($27.55 in chips) 
Seat 4: DE9hRlt14g+JdsRQ4wT7hg ($27.15 in chips) 
Seat 5: PbMzPZIePKifKQZfKDkbIw ($37.10 in chips) 
DihMHaz4WNETH1bPDe13kA: posts small blind $0.10
DE9hRlt14g+JdsRQ4wT7hg: posts big blind $0.25
*** HOLE CARDS ***
PbMzPZIePKifKQZfKDkbIw: folds 
cezpHJ8FB07dj0xG+LhOvw: folds 
lquriepNQBhDV5P1SWHhnA: raises $0.50 to $0.75
DihMHaz4WNETH1bPDe13kA: folds 
DE9hRlt14g+JdsRQ4wT7hg: calls $0.50
*** FLOP *** [5c 8c Qc]
x9/USY6PsmgUGQeluFLKDw joins the table at seat #6 
DE9hRlt14g+JdsRQ4wT7hg: checks 
lquriepNQBhDV5P1SWHhnA: bets $1
PbMzPZIePKifKQZfKDkbIw is sitting out
DE9hRlt14g+JdsRQ4wT7hg: raises $2.25 to $3.25
lquriepNQBhDV5P1SWHhnA: calls $2.25
*** TURN *** [5c 8c Qc] [3c]
DE9hRlt14g+JdsRQ4wT7hg: checks 
lquriepNQBhDV5P1SWHhnA: bets $5
DE9hRlt14g+JdsRQ4wT7hg: folds 
Uncalled bet ($5) returned to lquriepNQBhDV5P1SWHhnA
PbMzPZIePKifKQZfKDkbIw leaves the table
lquriepNQBhDV5P1SWHhnA collected $7.70 from pot
lquriepNQBhDV5P1SWHhnA: doesn't show hand 
*** SUMMARY ***
Total pot $8.10 | Rake $0.40 
Board [5c 8c Qc 3c]
Seat 1: cezpHJ8FB07dj0xG+LhOvw folded before Flop (didn't bet)
Seat 2: lquriepNQBhDV5P1SWHhnA (button) collected ($7.70)
Seat 3: DihMHaz4WNETH1bPDe13kA (small blind) folded before Flop
Seat 4: DE9hRlt14g+JdsRQ4wT7hg (big blind) folded on the Turn
Seat 5: PbMzPZIePKifKQZfKDkbIw folded before Flop (didn't bet)




PokerStars Game #59941774060:  Hold'em No Limit ($0.10/$0.25) - 2009/07/01 1:45:43 ET
Table 'aisAlB9GIV21BwfUW3+Nbg' 9-max Seat #1 is the button
Seat 1: SqibpGx+lf+brY0fJVvD0w ($24.30 in chips) 
Seat 2: +7GnIVpCmyuij3NJfOgsTw ($3.70 in chips) 
Seat 3: CvL9Ch1HYCVbTsfpNucitg ($4.80 in chips) 
Seat 4: sD+TKtt36XiiN6jqHiLwDA ($25.20 in chips) 
Seat 5: ghNKXUBl/H+t83JF079ZBA ($25 in chips) 
Seat 6: 9gmYYQesalMrUjaF7nKfrQ ($16.20 in chips) 
Seat 7: jGjM+5lCSe6f2MEwxQGOAg ($24.25 in chips) 
Seat 8: VWUWpMLMj/Q1jRVpF7Aohw ($26.30 in chips) 
Seat 9: N0hGpTAEAj9k5msS6LPLAw ($22.10 in chips) 
+7GnIVpCmyuij3NJfOgsTw: posts small blind $0.10
CvL9Ch1HYCVbTsfpNucitg: posts big blind $0.25
*** HOLE CARDS ***
sD+TKtt36XiiN6jqHiLwDA: folds 
ghNKXUBl/H+t83JF079ZBA: folds 
9gmYYQesalMrUjaF7nKfrQ: folds 
jGjM+5lCSe6f2MEwxQGOAg: raises $0.25 to $0.50
VWUWpMLMj/Q1jRVpF7Aohw: folds 
N0hGpTAEAj9k5msS6LPLAw: folds 
SqibpGx+lf+brY0fJVvD0w: folds 
+7GnIVpCmyuij3NJfOgsTw: folds 
CvL9Ch1HYCVbTsfpNucitg: folds 
Uncalled bet ($0.25) returned to jGjM+5lCSe6f2MEwxQGOAg
+7GnIVpCmyuij3NJfOgsTw leaves the table
jGjM+5lCSe6f2MEwxQGOAg collected $0.60 from pot
*** SUMMARY ***
Total pot $0.60 | Rake $0 
Seat 1: SqibpGx+lf+brY0fJVvD0w (button) folded before Flop (didn't bet)
Seat 2: +7GnIVpCmyuij3NJfOgsTw (small blind) folded before Flop
Seat 3: CvL9Ch1HYCVbTsfpNucitg (big blind) folded before Flop
Seat 4: sD+TKtt36XiiN6jqHiLwDA folded before Flop (didn't bet)
Seat 5: ghNKXUBl/H+t83JF079ZBA folded before Flop (didn't bet)
Seat 6: 9gmYYQesalMrUjaF7nKfrQ folded before Flop (didn't bet)
Seat 7: jGjM+5lCSe6f2MEwxQGOAg collected ($0.60)
Seat 8: VWUWpMLMj/Q1jRVpF7Aohw folded before Flop (didn't bet)
Seat 9: N0hGpTAEAj9k5msS6LPLAw folded before Flop (didn't bet)




PokerStars Game #59941774536:  Hold'em No Limit ($0.10/$0.25) - 2009/07/01 1:45:44 ET
Table 'sCop8wmj9zlSS2KJqk1QKQ' 9-max Seat #7 is the button
Seat 1: dtZ84flFEi4Q+SGrHMJRDQ ($40.85 in chips) 
Seat 2: YZaC69gFrepA6oCGtu7E0w ($40.05 in chips) 
Seat 3: M/9j4wkHH9i1JM51vgi1VA ($24.75 in chips) 
Seat 4: msUzkZl2RntUnTl6E8WaNA ($10.55 in chips) 
Seat 5: RHqgdFvufLCYe54+qd2gcA ($8.95 in chips) 
Seat 6: hZuGwtYmFKPmQ+v1wlmdfA ($42.70 in chips) 
Seat 7: 1gbA06IVB5XVZNlkqj7zJw ($12.85 in chips) 
Seat 8: xnVwSkROfRtOw4eSoDANtw ($20.40 in chips) 
Seat 9: tLcDklc2rBORNfixyRfVfw ($25 in chips) 
xnVwSkROfRtOw4eSoDANtw: posts small blind $0.10
tLcDklc2rBORNfixyRfVfw: posts big blind $0.25
*** HOLE CARDS ***
dtZ84flFEi4Q+SGrHMJRDQ: folds 
YZaC69gFrepA6oCGtu7E0w: folds 
M/9j4wkHH9i1JM51vgi1VA: folds 
msUzkZl2RntUnTl6E8WaNA: calls $0.25
RHqgdFvufLCYe54+qd2gcA: folds 
hZuGwtYmFKPmQ+v1wlmdfA: calls $0.25
1gbA06IVB5XVZNlkqj7zJw: calls $0.25
xnVwSkROfRtOw4eSoDANtw: folds 
tLcDklc2rBORNfixyRfVfw: checks 
*** FLOP *** [As Kh 4c]
tLcDklc2rBORNfixyRfVfw: checks 
msUzkZl2RntUnTl6E8WaNA: checks 
hZuGwtYmFKPmQ+v1wlmdfA: bets $0.75
1gbA06IVB5XVZNlkqj7zJw: folds 
tLcDklc2rBORNfixyRfVfw: folds 
1gbA06IVB5XVZNlkqj7zJw leaves the table
msUzkZl2RntUnTl6E8WaNA: calls $0.75
*** TURN *** [As Kh 4c] [Ts]
msUzkZl2RntUnTl6E8WaNA: checks 
18G4P1XstjNvItdGUITxgw joins the table at seat #7 
hZuGwtYmFKPmQ+v1wlmdfA: bets $1
msUzkZl2RntUnTl6E8WaNA: raises $1 to $2
hZuGwtYmFKPmQ+v1wlmdfA: calls $1
*** RIVER *** [As Kh 4c Ts] [Qc]
msUzkZl2RntUnTl6E8WaNA: bets $2.25
hZuGwtYmFKPmQ+v1wlmdfA: calls $2.25
*** SHOW DOWN ***
msUzkZl2RntUnTl6E8WaNA: shows [Kd Kc] (three of a kind, Kings)
hZuGwtYmFKPmQ+v1wlmdfA: mucks hand 
msUzkZl2RntUnTl6E8WaNA collected $10.60 from pot
*** SUMMARY ***
Total pot $11.10 | Rake $0.50 
Board [As Kh 4c Ts Qc]
Seat 1: dtZ84flFEi4Q+SGrHMJRDQ folded before Flop (didn't bet)
Seat 2: YZaC69gFrepA6oCGtu7E0w folded before Flop (didn't bet)
Seat 3: M/9j4wkHH9i1JM51vgi1VA folded before Flop (didn't bet)
Seat 4: msUzkZl2RntUnTl6E8WaNA showed [Kd Kc] and won ($10.60) with three of a kind, Kings
Seat 5: RHqgdFvufLCYe54+qd2gcA folded before Flop (didn't bet)
Seat 6: hZuGwtYmFKPmQ+v1wlmdfA mucked
Seat 7: 1gbA06IVB5XVZNlkqj7zJw (button) folded on the Flop
Seat 8: xnVwSkROfRtOw4eSoDANtw (small blind) folded before Flop
Seat 9: tLcDklc2rBORNfixyRfVfw (big blind) folded on the Flop




PokerStars Game #59941774382:  Hold'em No Limit ($0.10/$0.25) - 2009/07/01 1:45:44 ET
Table '8QBBaev+cI2i/r2H6ml/lg' 9-max Seat #5 is the button
Seat 1: s2xLPOl/vhl/26apJ3vsOQ ($35.80 in chips) 
Seat 2: y7tkvDmwKjURBkr73SZPXw ($12.25 in chips) 
Seat 3: zgi+EUykT/pZQpoUG6+oEg ($4.30 in chips) 
Seat 4: ytpGB2nr/CLVHnyKMRiEFQ ($16 in chips) 
Seat 5: 0QdZrkFD7aGKeBXPGbIomA ($11.35 in chips) 
Seat 6: X6+pSIPfovPcE87t+LmUKQ ($4.50 in chips) 
Seat 7: eK8qa6EPcH2zhtbmWSvc9g ($31.05 in chips) 
Seat 8: vr1IK/Q4HXm8s8V0/dePzQ ($11.85 in chips) 
Seat 9: EUMLvzDkECHBit+xa+uGjg ($24.75 in chips) 
X6+pSIPfovPcE87t+LmUKQ: posts small blind $0.10
eK8qa6EPcH2zhtbmWSvc9g: posts big blind $0.25
*** HOLE CARDS ***
vr1IK/Q4HXm8s8V0/dePzQ: calls $0.25
EUMLvzDkECHBit+xa+uGjg: folds 
s2xLPOl/vhl/26apJ3vsOQ: folds 
y7tkvDmwKjURBkr73SZPXw: folds 
zgi+EUykT/pZQpoUG6+oEg: folds 
ytpGB2nr/CLVHnyKMRiEFQ: folds 
0QdZrkFD7aGKeBXPGbIomA: calls $0.25
X6+pSIPfovPcE87t+LmUKQ: raises $2 to $2.25
eK8qa6EPcH2zhtbmWSvc9g: folds 
vr1IK/Q4HXm8s8V0/dePzQ: folds 
0QdZrkFD7aGKeBXPGbIomA: folds 
Uncalled bet ($2) returned to X6+pSIPfovPcE87t+LmUKQ
X6+pSIPfovPcE87t+LmUKQ collected $1 from pot
X6+pSIPfovPcE87t+LmUKQ: shows [Js Jh] (a pair of Jacks)
*** SUMMARY ***
Total pot $1 | Rake $0 
Seat 1: s2xLPOl/vhl/26apJ3vsOQ folded before Flop (didn't bet)
Seat 2: y7tkvDmwKjURBkr73SZPXw folded before Flop (didn't bet)
Seat 3: zgi+EUykT/pZQpoUG6+oEg folded before Flop (didn't bet)
Seat 4: ytpGB2nr/CLVHnyKMRiEFQ folded before Flop (didn't bet)
Seat 5: 0QdZrkFD7aGKeBXPGbIomA (button) folded before Flop
Seat 6: X6+pSIPfovPcE87t+LmUKQ (small blind) collected ($1)
Seat 7: eK8qa6EPcH2zhtbmWSvc9g (big blind) folded before Flop
Seat 8: vr1IK/Q4HXm8s8V0/dePzQ folded before Flop
Seat 9: EUMLvzDkECHBit+xa+uGjg folded before Flop (didn't bet)




PokerStars Game #59941774390:  Hold'em No Limit ($0.10/$0.25) - 2009/07/01 1:45:44 ET
Table 'M8kYidAX3ib7pLKW7edFLw' 6-max Seat #6 is the button
Seat 1: jp34e617tIzV8tKIWmfAbA ($25 in chips) 
Seat 2: ypmjhffk/YHGc51wgVXUTw ($27.30 in chips) 
Seat 3: cezpHJ8FB07dj0xG+LhOvw ($27.10 in chips) 
Seat 4: Hsvkc0/G2VV78oVmWYXecw ($5.30 in chips) 
Seat 5: bDKopKTvPi3W+PEnYUX3tg ($46 in chips) 
Seat 6: NqFoyDgzLwu4dOmSRXnFBA ($20.60 in chips) 
jp34e617tIzV8tKIWmfAbA: posts small blind $0.10
ypmjhffk/YHGc51wgVXUTw: posts big blind $0.25
*** HOLE CARDS ***
cezpHJ8FB07dj0xG+LhOvw: folds 
Hsvkc0/G2VV78oVmWYXecw: folds 
bDKopKTvPi3W+PEnYUX3tg: folds 
NqFoyDgzLwu4dOmSRXnFBA: raises $0.75 to $1
jp34e617tIzV8tKIWmfAbA: folds 
ypmjhffk/YHGc51wgVXUTw: calls $0.75
*** FLOP *** [5d 8c Qh]
ypmjhffk/YHGc51wgVXUTw: checks 
NqFoyDgzLwu4dOmSRXnFBA: bets $1
ypmjhffk/YHGc51wgVXUTw: calls $1
*** TURN *** [5d 8c Qh] [3c]
ypmjhffk/YHGc51wgVXUTw: checks 
NqFoyDgzLwu4dOmSRXnFBA: bets $1
ypmjhffk/YHGc51wgVXUTw: calls $1
*** RIVER *** [5d 8c Qh 3c] [4s]
ypmjhffk/YHGc51wgVXUTw: checks 
NqFoyDgzLwu4dOmSRXnFBA: bets $2
ypmjhffk/YHGc51wgVXUTw: calls $2
*** SHOW DOWN ***
NqFoyDgzLwu4dOmSRXnFBA: shows [Th Qc] (a pair of Queens)
ypmjhffk/YHGc51wgVXUTw: mucks hand 
NqFoyDgzLwu4dOmSRXnFBA collected $9.65 from pot
*** SUMMARY ***
Total pot $10.10 | Rake $0.45 
Board [5d 8c Qh 3c 4s]
Seat 1: jp34e617tIzV8tKIWmfAbA (small blind) folded before Flop
Seat 2: ypmjhffk/YHGc51wgVXUTw (big blind) mucked
Seat 3: cezpHJ8FB07dj0xG+LhOvw folded before Flop (didn't bet)
Seat 4: Hsvkc0/G2VV78oVmWYXecw folded before Flop (didn't bet)
Seat 5: bDKopKTvPi3W+PEnYUX3tg folded before Flop (didn't bet)
Seat 6: NqFoyDgzLwu4dOmSRXnFBA (button) showed [Th Qc] and won ($9.65) with a pair of Queens




PokerStars Game #59941774214:  Hold'em No Limit ($0.10/$0.25) - 2009/07/01 1:45:44 ET
Table 'O6cwjhrMn9pfzx1Ngn5zkQ' 6-max Seat #5 is the button
Seat 1: LJI7A1YgDM7hgh7o56+ReQ ($27.80 in chips) 
Seat 2: tSR4329m40dZsN7YOpI9Kw ($29.35 in chips) 
Seat 3: EE16Ua5b1HSsYej5zeXOlA ($25.45 in chips) 
Seat 4: mfrkWA3PTeYPkbO6hi98Aw ($23.95 in chips) 
Seat 5: niLn0xUVlqh8If80xRjzCA ($27.70 in chips) 
Seat 6: 4TM16KVgEiQpLi4bVVWbVQ ($33.15 in chips) 
4TM16KVgEiQpLi4bVVWbVQ: posts small blind $0.10
LJI7A1YgDM7hgh7o56+ReQ: posts big blind $0.25
*** HOLE CARDS ***
tSR4329m40dZsN7YOpI9Kw: folds 
EE16Ua5b1HSsYej5zeXOlA: folds 
mfrkWA3PTeYPkbO6hi98Aw: folds 
niLn0xUVlqh8If80xRjzCA: calls $0.25
4TM16KVgEiQpLi4bVVWbVQ: folds 
LJI7A1YgDM7hgh7o56+ReQ: checks 
*** FLOP *** [Ac 8c As]
LJI7A1YgDM7hgh7o56+ReQ: checks 
niLn0xUVlqh8If80xRjzCA: bets $0.25
LJI7A1YgDM7hgh7o56+ReQ: folds 
Uncalled bet ($0.25) returned to niLn0xUVlqh8If80xRjzCA
niLn0xUVlqh8If80xRjzCA collected $0.60 from pot
niLn0xUVlqh8If80xRjzCA: doesn't show hand 
*** SUMMARY ***
Total pot $0.60 | Rake $0 
Board [Ac 8c As]
Seat 1: LJI7A1YgDM7hgh7o56+ReQ (big blind) folded on the Flop
Seat 2: tSR4329m40dZsN7YOpI9Kw folded before Flop (didn't bet)
Seat 3: EE16Ua5b1HSsYej5zeXOlA folded before Flop (didn't bet)
Seat 4: mfrkWA3PTeYPkbO6hi98Aw folded before Flop (didn't bet)
Seat 5: niLn0xUVlqh8If80xRjzCA (button) collected ($0.60)
Seat 6: 4TM16KVgEiQpLi4bVVWbVQ (small blind) folded before Flop




PokerStars Game #59941774510:  Hold'em No Limit ($0.10/$0.25) - 2009/07/01 1:45:44 ET
Table 'fIMYcWwN4/aXFJvH5Z8Ymg' 6-max Seat #1 is the button
Seat 1: DihMHaz4WNETH1bPDe13kA ($25 in chips) 
Seat 2: Mhj3q7cxev+XjXZxEE6/Cw ($25 in chips) 
Seat 3: 9bpVv1/Qh9IYtXuCtl5VtQ ($25 in chips) 
Seat 4: 32YL2ZEp8NT4JB2RVM9euQ ($42.40 in chips) 
Seat 5: lquriepNQBhDV5P1SWHhnA ($25.70 in chips) 
Seat 6: jp34e617tIzV8tKIWmfAbA ($28.70 in chips) 
Mhj3q7cxev+XjXZxEE6/Cw: posts small blind $0.10
9bpVv1/Qh9IYtXuCtl5VtQ: posts big blind $0.25
*** HOLE CARDS ***
32YL2ZEp8NT4JB2RVM9euQ: folds 
lquriepNQBhDV5P1SWHhnA: folds 
jp34e617tIzV8tKIWmfAbA: folds 
DihMHaz4WNETH1bPDe13kA: folds 
Mhj3q7cxev+XjXZxEE6/Cw: raises $0.50 to $0.75
9bpVv1/Qh9IYtXuCtl5VtQ: folds 
Uncalled bet ($0.50) returned to Mhj3q7cxev+XjXZxEE6/Cw
Mhj3q7cxev+XjXZxEE6/Cw collected $0.50 from pot
Mhj3q7cxev+XjXZxEE6/Cw: doesn't show hand 
*** SUMMARY ***
Total pot $0.50 | Rake $0 
Seat 1: DihMHaz4WNETH1bPDe13kA (button) folded before Flop (didn't bet)
Seat 2: Mhj3q7cxev+XjXZxEE6/Cw (small blind) collected ($0.50)
Seat 3: 9bpVv1/Qh9IYtXuCtl5VtQ (big blind) folded before Flop
Seat 4: 32YL2ZEp8NT4JB2RVM9euQ folded before Flop (didn't bet)
Seat 5: lquriepNQBhDV5P1SWHhnA folded before Flop (didn't bet)
Seat 6: jp34e617tIzV8tKIWmfAbA folded before Flop (didn't bet)




PokerStars Game #59941775070:  Hold'em No Limit ($0.10/$0.25) - 2009/07/01 1:45:45 ET
Table 'Qr+t8WGovMECkBv+cV1lrg' 6-max Seat #5 is the button
Seat 1: EeUZtMU058v2ObUACOF4Og ($44.75 in chips) 
Seat 2: vqWjZmdQu/Hxw96/IJTWdQ ($25 in chips) 
Seat 3: uZKkrGByYgd4/ZBX2d4z+w ($26.40 in chips) 
Seat 4: 1NNFfYMd5Hsphl/FYz9fNA ($62.65 in chips) 
Seat 5: 9q7YGTKe9k5fYb4fmZc3Ww ($32 in chips) 
Seat 6: 9U3ZKjCsarN0DjR6mSE8Ug ($14.10 in chips) 
9U3ZKjCsarN0DjR6mSE8Ug: posts small blind $0.10
EeUZtMU058v2ObUACOF4Og: posts big blind $0.25
*** HOLE CARDS ***
vqWjZmdQu/Hxw96/IJTWdQ: folds 
uZKkrGByYgd4/ZBX2d4z+w: raises $0.75 to $1
1NNFfYMd5Hsphl/FYz9fNA: folds 
9q7YGTKe9k5fYb4fmZc3Ww: folds 
9U3ZKjCsarN0DjR6mSE8Ug: folds 
EeUZtMU058v2ObUACOF4Og: folds 
Uncalled bet ($0.75) returned to uZKkrGByYgd4/ZBX2d4z+w
uZKkrGByYgd4/ZBX2d4z+w collected $0.60 from pot
uZKkrGByYgd4/ZBX2d4z+w: shows [Qh Qd] (a pair of Queens)
*** SUMMARY ***
Total pot $0.60 | Rake $0 
Seat 1: EeUZtMU058v2ObUACOF4Og (big blind) folded before Flop
Seat 2: vqWjZmdQu/Hxw96/IJTWdQ folded before Flop (didn't bet)
Seat 3: uZKkrGByYgd4/ZBX2d4z+w collected ($0.60)
Seat 4: 1NNFfYMd5Hsphl/FYz9fNA folded before Flop (didn't bet)
Seat 5: 9q7YGTKe9k5fYb4fmZc3Ww (button) folded before Flop (didn't bet)
Seat 6: 9U3ZKjCsarN0DjR6mSE8Ug (small blind) folded before Flop




PokerStars Game #59941774774:  Hold'em No Limit ($0.10/$0.25) - 2009/07/01 1:45:45 ET
Table 'RUOqTfzbAVGS5x+J9aZMHA' 9-max Seat #3 is the button
Seat 1: DnDcAdn9P0zGovMERigpFA ($25 in chips) 
Seat 2: Z5ZtGOON8kmSdSCll9Z3XA ($8 in chips) 
Seat 3: Th3FldXKQW6hWVVPahaoOQ ($25 in chips) 
Seat 4: K9Az8li/CO2TicltVWKamA ($32.55 in chips) 
Seat 5: MtVtHDqIJTyUcXkRBBDIVA ($26.65 in chips) 
Seat 6: ljemhp25Zg+nlA9DLCIiUw ($48.35 in chips) 
Seat 7: zgi+EUykT/pZQpoUG6+oEg ($4.30 in chips) 
Seat 8: dfNim92Z6XK1/h5SFW5vDg ($29.20 in chips) 
Seat 9: cZ99hugmLBj9KhTlc8nCSw ($25 in chips) 
K9Az8li/CO2TicltVWKamA: posts small blind $0.10
MtVtHDqIJTyUcXkRBBDIVA: posts big blind $0.25
*** HOLE CARDS ***
ljemhp25Zg+nlA9DLCIiUw: folds 
zgi+EUykT/pZQpoUG6+oEg: folds 
dfNim92Z6XK1/h5SFW5vDg: folds 
cZ99hugmLBj9KhTlc8nCSw: folds 
DnDcAdn9P0zGovMERigpFA: raises $0.75 to $1
Z5ZtGOON8kmSdSCll9Z3XA: folds 
Th3FldXKQW6hWVVPahaoOQ: folds 
K9Az8li/CO2TicltVWKamA: calls $0.90
MtVtHDqIJTyUcXkRBBDIVA: folds 
*** FLOP *** [Ks Ac 9d]
K9Az8li/CO2TicltVWKamA: checks 
DnDcAdn9P0zGovMERigpFA: bets $1.50
K9Az8li/CO2TicltVWKamA: folds 
Uncalled bet ($1.50) returned to DnDcAdn9P0zGovMERigpFA
DnDcAdn9P0zGovMERigpFA collected $2.15 from pot
DnDcAdn9P0zGovMERigpFA: doesn't show hand 
*** SUMMARY ***
Total pot $2.25 | Rake $0.10 
Board [Ks Ac 9d]
Seat 1: DnDcAdn9P0zGovMERigpFA collected ($2.15)
Seat 2: Z5ZtGOON8kmSdSCll9Z3XA folded before Flop (didn't bet)
Seat 3: Th3FldXKQW6hWVVPahaoOQ (button) folded before Flop (didn't bet)
Seat 4: K9Az8li/CO2TicltVWKamA (small blind) folded on the Flop
Seat 5: MtVtHDqIJTyUcXkRBBDIVA (big blind) folded before Flop
Seat 6: ljemhp25Zg+nlA9DLCIiUw folded before Flop (didn't bet)
Seat 7: zgi+EUykT/pZQpoUG6+oEg folded before Flop (didn't bet)
Seat 8: dfNim92Z6XK1/h5SFW5vDg folded before Flop (didn't bet)
Seat 9: cZ99hugmLBj9KhTlc8nCSw folded before Flop (didn't bet)




PokerStars Game #59941774866:  Hold'em No Limit ($0.10/$0.25) - 2009/07/01 1:45:45 ET
Table 'ykyWGjhNu7AvZXov27T4ew' 9-max Seat #6 is the button
Seat 2: MG90wfSJZnOejs/KD3vlQQ ($39.60 in chips) 
Seat 3: NPI9ArW8kwrb6a2IAL6xMQ ($26.65 in chips) 
Seat 4: W6tExOcYX7qiy6Qdp+ZwFA ($5.90 in chips) 
Seat 5: CmngQmkKTp8tkl6GMRTl6w ($8.50 in chips) 
Seat 6: AiXn/9o1EwOPZUHujnh/bA ($20.15 in chips) 
Seat 7: npAYqa85pqnzfOK5ukX+BQ ($21.40 in chips) 
Seat 8: tYsOBqdU1+x+yFI7zHO7hQ ($49.35 in chips) 
Seat 9: wk9M6R3w+aDHpr8WV87RmQ ($11.25 in chips) 
npAYqa85pqnzfOK5ukX+BQ: posts small blind $0.10
tYsOBqdU1+x+yFI7zHO7hQ: posts big blind $0.25
skUI2T7o4P1rz460mMbAOg: sits out 
*** HOLE CARDS ***
wk9M6R3w+aDHpr8WV87RmQ: folds 
MG90wfSJZnOejs/KD3vlQQ: folds 
NPI9ArW8kwrb6a2IAL6xMQ: folds 
W6tExOcYX7qiy6Qdp+ZwFA: folds 
CmngQmkKTp8tkl6GMRTl6w: folds 
AiXn/9o1EwOPZUHujnh/bA: folds 
npAYqa85pqnzfOK5ukX+BQ: folds 
Uncalled bet ($0.15) returned to tYsOBqdU1+x+yFI7zHO7hQ
tYsOBqdU1+x+yFI7zHO7hQ collected $0.20 from pot
tYsOBqdU1+x+yFI7zHO7hQ: doesn't show hand 
*** SUMMARY ***
Total pot $0.20 | Rake $0 
Seat 2: MG90wfSJZnOejs/KD3vlQQ folded before Flop (didn't bet)
Seat 3: NPI9ArW8kwrb6a2IAL6xMQ folded before Flop (didn't bet)
Seat 4: W6tExOcYX7qiy6Qdp+ZwFA folded before Flop (didn't bet)
Seat 5: CmngQmkKTp8tkl6GMRTl6w folded before Flop (didn't bet)
Seat 6: AiXn/9o1EwOPZUHujnh/bA (button) folded before Flop (didn't bet)
Seat 7: npAYqa85pqnzfOK5ukX+BQ (small blind) folded before Flop
Seat 8: tYsOBqdU1+x+yFI7zHO7hQ (big blind) collected ($0.20)
Seat 9: wk9M6R3w+aDHpr8WV87RmQ folded before Flop (didn't bet)




PokerStars Game #59941774706:  Hold'em No Limit ($0.10/$0.25) - 2009/07/01 1:45:45 ET
Table '2clPgY3+dETPD/8zjXZdFw' 6-max Seat #4 is the button
Seat 2: cWc85bEzdRzpUMhRKm8pwQ ($25.45 in chips) 
Seat 3: SFmT9ZsVopnukjvAzrxTRg ($26 in chips) 
Seat 4: ljjhtb6FVPTx9AT9HNdtqg ($25.25 in chips) 
Seat 5: LJI7A1YgDM7hgh7o56+ReQ ($29.65 in chips) 
LJI7A1YgDM7hgh7o56+ReQ: posts small blind $0.10
4WFKzsjLSGnvHbVxKabsvQ: is sitting out 
cWc85bEzdRzpUMhRKm8pwQ: posts big blind $0.25
*** HOLE CARDS ***
SFmT9ZsVopnukjvAzrxTRg: folds 
4WFKzsjLSGnvHbVxKabsvQ leaves the table
SFmT9ZsVopnukjvAzrxTRg leaves the table
ljjhtb6FVPTx9AT9HNdtqg: folds 
LJI7A1YgDM7hgh7o56+ReQ: folds 
Uncalled bet ($0.15) returned to cWc85bEzdRzpUMhRKm8pwQ
FL1UWpN6oReBdznWDOy9Gg joins the table at seat #3 
cWc85bEzdRzpUMhRKm8pwQ collected $0.20 from pot
*** SUMMARY ***
Total pot $0.20 | Rake $0 
Seat 2: cWc85bEzdRzpUMhRKm8pwQ (big blind) collected ($0.20)
Seat 3: SFmT9ZsVopnukjvAzrxTRg folded before Flop (didn't bet)
Seat 4: ljjhtb6FVPTx9AT9HNdtqg (button) folded before Flop (didn't bet)
Seat 5: LJI7A1YgDM7hgh7o56+ReQ (small blind) folded before Flop




PokerStars Game #59941775368:  Hold'em No Limit ($0.10/$0.25) - 2009/07/01 1:45:46 ET
Table '4mnXP0EWt9mMZYzTIVDQ0w' 9-max Seat #4 is the button
Seat 1: Z5y2J55JmfLYR6/DPAGHwQ ($21.10 in chips) 
Seat 2: BLEU2x2bnGRovIelAY6slA ($25.15 in chips) 
Seat 4: 9lvO/qyU+xrU95Teu1fv0g ($6.50 in chips) 
Seat 5: sSN8Y0AlsBeidZXPKmwXSw ($25.20 in chips) 
Seat 6: 5yjzPss7Y4kAWNDat3e0yQ ($29.10 in chips) 
Seat 7: OiV1PWZ3IkN29JlmCcnTwQ ($6.20 in chips) 
Seat 8: 9YN2IkT2JYYKFErZtZvCtA ($20 in chips) 
Seat 9: N/O9ADKpmqB2ASZuqgodlw ($9.40 in chips) 
sSN8Y0AlsBeidZXPKmwXSw: posts small blind $0.10
5yjzPss7Y4kAWNDat3e0yQ: posts big blind $0.25
*** HOLE CARDS ***
OiV1PWZ3IkN29JlmCcnTwQ: folds 
9YN2IkT2JYYKFErZtZvCtA: folds 
OiV1PWZ3IkN29JlmCcnTwQ leaves the table
N/O9ADKpmqB2ASZuqgodlw: folds 
Z5y2J55JmfLYR6/DPAGHwQ: folds 
BLEU2x2bnGRovIelAY6slA: folds 
9lvO/qyU+xrU95Teu1fv0g: folds 
sSN8Y0AlsBeidZXPKmwXSw: folds 
Uncalled bet ($0.15) returned to 5yjzPss7Y4kAWNDat3e0yQ
5yjzPss7Y4kAWNDat3e0yQ collected $0.20 from pot
5yjzPss7Y4kAWNDat3e0yQ: doesn't show hand 
*** SUMMARY ***
Total pot $0.20 | Rake $0 
Seat 1: Z5y2J55JmfLYR6/DPAGHwQ folded before Flop (didn't bet)
Seat 2: BLEU2x2bnGRovIelAY6slA folded before Flop (didn't bet)
Seat 4: 9lvO/qyU+xrU95Teu1fv0g (button) folded before Flop (didn't bet)
Seat 5: sSN8Y0AlsBeidZXPKmwXSw (small blind) folded before Flop
Seat 6: 5yjzPss7Y4kAWNDat3e0yQ (big blind) collected ($0.20)
Seat 7: OiV1PWZ3IkN29JlmCcnTwQ folded before Flop (didn't bet)
Seat 8: 9YN2IkT2JYYKFErZtZvCtA folded before Flop (didn't bet)
Seat 9: N/O9ADKpmqB2ASZuqgodlw folded before Flop (didn't bet)




PokerStars Game #59941775630:  Hold'em No Limit ($0.10/$0.25) - 2009/07/01 1:45:46 ET
Table 'uFgIyfWPagvEVGEb86da7A' 9-max Seat #3 is the button
Seat 1: CT7Xj/V/O5rBlhtt+RZeFQ ($25.75 in chips) 
Seat 2: o3zvoO+PsqGti+1NZGNRrQ ($1.25 in chips) 
Seat 3: eGAnPT3w+iltM7HF59dzIg ($5.90 in chips) 
Seat 4: IGRfskE1v9H9Bn+fz8AgNQ ($27 in chips) 
Seat 5: X78b5v/uhqeXXoAijbw/yg ($28.30 in chips) 
Seat 7: 9zx7Mlww974uHUqoiq2eXA ($11.85 in chips) 
Seat 8: uLP/lYn7oKq9xCChBXsXxw ($24.30 in chips) 
Seat 9: sL5EaDXc90Iyxlm8ERXRQw ($18.35 in chips) 
IGRfskE1v9H9Bn+fz8AgNQ: posts small blind $0.10
zDrucyjVn5aeekNEc3cJrA has returned
X78b5v/uhqeXXoAijbw/yg: posts big blind $0.25
*** HOLE CARDS ***
9zx7Mlww974uHUqoiq2eXA: folds 
uLP/lYn7oKq9xCChBXsXxw: folds 
sL5EaDXc90Iyxlm8ERXRQw: folds 
CT7Xj/V/O5rBlhtt+RZeFQ: folds 
o3zvoO+PsqGti+1NZGNRrQ: folds 
eGAnPT3w+iltM7HF59dzIg: calls $0.25
IGRfskE1v9H9Bn+fz8AgNQ: folds 
X78b5v/uhqeXXoAijbw/yg: checks 
*** FLOP *** [2c Js Qh]
X78b5v/uhqeXXoAijbw/yg: checks 
eGAnPT3w+iltM7HF59dzIg: checks 
*** TURN *** [2c Js Qh] [Jh]
X78b5v/uhqeXXoAijbw/yg: checks 
eGAnPT3w+iltM7HF59dzIg: checks 
*** RIVER *** [2c Js Qh Jh] [4s]
X78b5v/uhqeXXoAijbw/yg: checks 
eGAnPT3w+iltM7HF59dzIg: checks 
*** SHOW DOWN ***
X78b5v/uhqeXXoAijbw/yg: shows [7h 4c] (two pair, Jacks and Fours)
eGAnPT3w+iltM7HF59dzIg: mucks hand 
X78b5v/uhqeXXoAijbw/yg collected $0.60 from pot
*** SUMMARY ***
Total pot $0.60 | Rake $0 
Board [2c Js Qh Jh 4s]
Seat 1: CT7Xj/V/O5rBlhtt+RZeFQ folded before Flop (didn't bet)
Seat 2: o3zvoO+PsqGti+1NZGNRrQ folded before Flop (didn't bet)
Seat 3: eGAnPT3w+iltM7HF59dzIg (button) mucked
Seat 4: IGRfskE1v9H9Bn+fz8AgNQ (small blind) folded before Flop
Seat 5: X78b5v/uhqeXXoAijbw/yg (big blind) showed [7h 4c] and won ($0.60) with two pair, Jacks and Fours
Seat 7: 9zx7Mlww974uHUqoiq2eXA folded before Flop (didn't bet)
Seat 8: uLP/lYn7oKq9xCChBXsXxw folded before Flop (didn't bet)
Seat 9: sL5EaDXc90Iyxlm8ERXRQw folded before Flop (didn't bet)




PokerStars Game #59941775644:  Hold'em No Limit ($0.10/$0.25) - 2009/07/01 1:45:46 ET
Table 'xmJKTGBeWCwutccj3YfupQ' 6-max Seat #3 is the button
Seat 1: sVbkVl4OznxBCfi66UB9vw ($43.15 in chips) 
Seat 3: T5wrp/d5jarm+SxNy8OQAg ($23.95 in chips) 
Seat 4: uWjhTVMpuIroxXcmD3Okug ($9.50 in chips) 
Seat 5: DE9hRlt14g+JdsRQ4wT7hg ($28.25 in chips) 
Seat 6: 9bpVv1/Qh9IYtXuCtl5VtQ ($24.65 in chips) 
uWjhTVMpuIroxXcmD3Okug: posts small blind $0.10
DE9hRlt14g+JdsRQ4wT7hg: posts big blind $0.25
*** HOLE CARDS ***
AxhCSFlGEh+FAc+VUD31JQ leaves the table
uWjhTVMpuIroxXcmD3Okug said, "gh"
QqiZLFrN8iOUT/GHw7ztOA joins the table at seat #2 
9bpVv1/Qh9IYtXuCtl5VtQ: folds 
sVbkVl4OznxBCfi66UB9vw said, "ty"
sVbkVl4OznxBCfi66UB9vw: raises $0.45 to $0.70
T5wrp/d5jarm+SxNy8OQAg: calls $0.70
uWjhTVMpuIroxXcmD3Okug: calls $0.60
DE9hRlt14g+JdsRQ4wT7hg: folds 
*** FLOP *** [Ah 6s 6c]
uWjhTVMpuIroxXcmD3Okug: checks 
sVbkVl4OznxBCfi66UB9vw: checks 
T5wrp/d5jarm+SxNy8OQAg: bets $1.75
uWjhTVMpuIroxXcmD3Okug: folds 
sVbkVl4OznxBCfi66UB9vw: folds 
Uncalled bet ($1.75) returned to T5wrp/d5jarm+SxNy8OQAg
T5wrp/d5jarm+SxNy8OQAg collected $2.25 from pot
*** SUMMARY ***
Total pot $2.35 | Rake $0.10 
Board [Ah 6s 6c]
Seat 1: sVbkVl4OznxBCfi66UB9vw folded on the Flop
Seat 3: T5wrp/d5jarm+SxNy8OQAg (button) collected ($2.25)
Seat 4: uWjhTVMpuIroxXcmD3Okug (small blind) folded on the Flop
Seat 5: DE9hRlt14g+JdsRQ4wT7hg (big blind) folded before Flop
Seat 6: 9bpVv1/Qh9IYtXuCtl5VtQ folded before Flop (didn't bet)




PokerStars Game #59941775320:  Hold'em No Limit ($0.10/$0.25) - 2009/07/01 1:45:46 ET
Table 'NtCSSONEf1zaJo3042tQug' 6-max Seat #6 is the button
Seat 1: KXtdqb+rIMkjc0RvHDksGQ ($35.90 in chips) 
Seat 2: vqWjZmdQu/Hxw96/IJTWdQ ($26.55 in chips) 
Seat 3: 9kUKGKkblnIx3m8rlVol6Q ($15.65 in chips) 
Seat 4: HxD1kB8zCmalQSdWAkKmlg ($28.85 in chips) 
Seat 5: tOAk1Og4mVObMBOfvdDYOw ($30.40 in chips) 
Seat 6: LxehwDpTQ19ph4Qmc78+Pw ($29 in chips) 
KXtdqb+rIMkjc0RvHDksGQ: posts small blind $0.10
vqWjZmdQu/Hxw96/IJTWdQ: posts big blind $0.25
*** HOLE CARDS ***
9kUKGKkblnIx3m8rlVol6Q: folds 
HxD1kB8zCmalQSdWAkKmlg: folds 
tOAk1Og4mVObMBOfvdDYOw: raises $0.75 to $1
LxehwDpTQ19ph4Qmc78+Pw: folds 
KXtdqb+rIMkjc0RvHDksGQ: calls $0.90
vqWjZmdQu/Hxw96/IJTWdQ: folds 
*** FLOP *** [Js 7h 6d]
KXtdqb+rIMkjc0RvHDksGQ: checks 
tOAk1Og4mVObMBOfvdDYOw: bets $1.50
KXtdqb+rIMkjc0RvHDksGQ: folds 
Uncalled bet ($1.50) returned to tOAk1Og4mVObMBOfvdDYOw
tOAk1Og4mVObMBOfvdDYOw collected $2.15 from pot
tOAk1Og4mVObMBOfvdDYOw: doesn't show hand 
*** SUMMARY ***
Total pot $2.25 | Rake $0.10 
Board [Js 7h 6d]
Seat 1: KXtdqb+rIMkjc0RvHDksGQ (small blind) folded on the Flop
Seat 2: vqWjZmdQu/Hxw96/IJTWdQ (big blind) folded before Flop
Seat 3: 9kUKGKkblnIx3m8rlVol6Q folded before Flop (didn't bet)
Seat 4: HxD1kB8zCmalQSdWAkKmlg folded before Flop (didn't bet)
Seat 5: tOAk1Og4mVObMBOfvdDYOw collected ($2.15)
Seat 6: LxehwDpTQ19ph4Qmc78+Pw (button) folded before Flop (didn't bet)




PokerStars Game #59941775158:  Hold'em No Limit ($0.10/$0.25) - 2009/07/01 1:45:46 ET
Table '5SUMWYuPsGiOD0FY0QbgOw' 6-max Seat #5 is the button
Seat 1: SFmT9ZsVopnukjvAzrxTRg ($25 in chips) 
Seat 2: xrf8tAXKQHG99HixCot1Iw ($37.50 in chips) 
Seat 3: MqMK8OWPSY1V4stf1Hy5Jw ($38.45 in chips) 
Seat 4: BV+K0Phf5VBHr7aZPKqbUQ ($25 in chips) 
Seat 5: v+QfkGiuj9bgtuNoVnDO8w ($40.65 in chips) 
Seat 6: jA7YMtfNUnAaebB7Lj74EA ($26.05 in chips) 
jA7YMtfNUnAaebB7Lj74EA: posts small blind $0.10
SFmT9ZsVopnukjvAzrxTRg: posts big blind $0.25
*** HOLE CARDS ***
xrf8tAXKQHG99HixCot1Iw: folds 
MqMK8OWPSY1V4stf1Hy5Jw: folds 
BV+K0Phf5VBHr7aZPKqbUQ: folds 
v+QfkGiuj9bgtuNoVnDO8w: raises $0.75 to $1
jA7YMtfNUnAaebB7Lj74EA: calls $0.90
SFmT9ZsVopnukjvAzrxTRg: folds 
*** FLOP *** [Ac 2s Kc]
jA7YMtfNUnAaebB7Lj74EA: checks 
v+QfkGiuj9bgtuNoVnDO8w: bets $1.75
jA7YMtfNUnAaebB7Lj74EA: folds 
Uncalled bet ($1.75) returned to v+QfkGiuj9bgtuNoVnDO8w
v+QfkGiuj9bgtuNoVnDO8w collected $2.15 from pot
v+QfkGiuj9bgtuNoVnDO8w: doesn't show hand 
*** SUMMARY ***
Total pot $2.25 | Rake $0.10 
Board [Ac 2s Kc]
Seat 1: SFmT9ZsVopnukjvAzrxTRg (big blind) folded before Flop
Seat 2: xrf8tAXKQHG99HixCot1Iw folded before Flop (didn't bet)
Seat 3: MqMK8OWPSY1V4stf1Hy5Jw folded before Flop (didn't bet)
Seat 4: BV+K0Phf5VBHr7aZPKqbUQ folded before Flop (didn't bet)
Seat 5: v+QfkGiuj9bgtuNoVnDO8w (button) collected ($2.15)
Seat 6: jA7YMtfNUnAaebB7Lj74EA (small blind) folded on the Flop




PokerStars Game #59941775532:  Hold'em No Limit ($0.10/$0.25) - 2009/07/01 1:45:46 ET
Table 'x7YStLKc8hpt/pTgSetPKA' 9-max Seat #8 is the button
Seat 1: tYsOBqdU1+x+yFI7zHO7hQ ($26.25 in chips) 
Seat 3: S7Ki0P+0AIGPuIfGJjW0gg ($12.10 in chips) 
Seat 4: ydoFOVgzvZv9ZhuWu9rXAw ($5.15 in chips) 
Seat 6: 9YN2IkT2JYYKFErZtZvCtA ($47.40 in chips) 
Seat 7: dtZ84flFEi4Q+SGrHMJRDQ ($26 in chips) 
Seat 8: j4q3p0lesp63b1gZDwLBZw ($5 in chips) 
Seat 9: nm4Dj/f+jJEwKVsUnKh73g ($36.80 in chips) 
nm4Dj/f+jJEwKVsUnKh73g: posts small blind $0.10
tYsOBqdU1+x+yFI7zHO7hQ: posts big blind $0.25
tLcDklc2rBORNfixyRfVfw: sits out 
*** HOLE CARDS ***
S7Ki0P+0AIGPuIfGJjW0gg: folds 
ydoFOVgzvZv9ZhuWu9rXAw: folds 
9YN2IkT2JYYKFErZtZvCtA: raises $0.75 to $1
dtZ84flFEi4Q+SGrHMJRDQ: folds 
j4q3p0lesp63b1gZDwLBZw: folds 
nm4Dj/f+jJEwKVsUnKh73g: folds 
tYsOBqdU1+x+yFI7zHO7hQ: folds 
Uncalled bet ($0.75) returned to 9YN2IkT2JYYKFErZtZvCtA
9YN2IkT2JYYKFErZtZvCtA collected $0.60 from pot
9YN2IkT2JYYKFErZtZvCtA: doesn't show hand 
*** SUMMARY ***
Total pot $0.60 | Rake $0 
Seat 1: tYsOBqdU1+x+yFI7zHO7hQ (big blind) folded before Flop
Seat 3: S7Ki0P+0AIGPuIfGJjW0gg folded before Flop (didn't bet)
Seat 4: ydoFOVgzvZv9ZhuWu9rXAw folded before Flop (didn't bet)
Seat 6: 9YN2IkT2JYYKFErZtZvCtA collected ($0.60)
Seat 7: dtZ84flFEi4Q+SGrHMJRDQ folded before Flop (didn't bet)
Seat 8: j4q3p0lesp63b1gZDwLBZw (button) folded before Flop (didn't bet)
Seat 9: nm4Dj/f+jJEwKVsUnKh73g (small blind) folded before Flop




PokerStars Game #59941776020:  Hold'em No Limit ($0.10/$0.25) - 2009/07/01 1:45:47 ET
Table 'BpNkESDX1ip9c0K1hb5h7A' 6-max Seat #6 is the button
Seat 1: 5YZdVjBPZVEdubN4xEMPEg ($31.50 in chips) 
Seat 2: 9U3ZKjCsarN0DjR6mSE8Ug ($14 in chips) 
Seat 3: fZQg9veL7Dd/Z04ZTjC+wQ ($27.90 in chips) 
Seat 4: kG34n23qFQA3nzdOJTQ1dA ($26.50 in chips) 
Seat 5: L3/N/gliETan8N5Gim5h4Q ($25.40 in chips) 
Seat 6: 8EEqTTh7T1q48sYDqbI2Xg ($20.50 in chips) 
5YZdVjBPZVEdubN4xEMPEg: posts small blind $0.10
9U3ZKjCsarN0DjR6mSE8Ug: posts big blind $0.25
*** HOLE CARDS ***
fZQg9veL7Dd/Z04ZTjC+wQ: folds 
kG34n23qFQA3nzdOJTQ1dA: folds 
L3/N/gliETan8N5Gim5h4Q: folds 
8EEqTTh7T1q48sYDqbI2Xg: calls $0.25
5YZdVjBPZVEdubN4xEMPEg: raises $0.50 to $0.75
9U3ZKjCsarN0DjR6mSE8Ug: calls $0.50
8EEqTTh7T1q48sYDqbI2Xg: calls $0.50
*** FLOP *** [4c 4h 9d]
L3/N/gliETan8N5Gim5h4Q leaves the table
5YZdVjBPZVEdubN4xEMPEg: bets $1
OMGl+YMGogf2JWIRfT2/Yg joins the table at seat #5 
9U3ZKjCsarN0DjR6mSE8Ug: calls $1
8EEqTTh7T1q48sYDqbI2Xg: folds 
*** TURN *** [4c 4h 9d] [Kh]
5YZdVjBPZVEdubN4xEMPEg: checks 
9U3ZKjCsarN0DjR6mSE8Ug: checks 
*** RIVER *** [4c 4h 9d Kh] [2h]
5YZdVjBPZVEdubN4xEMPEg: bets $1.50
9U3ZKjCsarN0DjR6mSE8Ug: raises $2.25 to $3.75
5YZdVjBPZVEdubN4xEMPEg: calls $2.25
*** SHOW DOWN ***
9U3ZKjCsarN0DjR6mSE8Ug: shows [4s Ks] (a full house, Fours full of Kings)
5YZdVjBPZVEdubN4xEMPEg: mucks hand 
9U3ZKjCsarN0DjR6mSE8Ug collected $11.20 from pot
*** SUMMARY ***
Total pot $11.75 | Rake $0.55 
Board [4c 4h 9d Kh 2h]
Seat 1: 5YZdVjBPZVEdubN4xEMPEg (small blind) mucked
Seat 2: 9U3ZKjCsarN0DjR6mSE8Ug (big blind) showed [4s Ks] and won ($11.20) with a full house, Fours full of Kings
Seat 3: fZQg9veL7Dd/Z04ZTjC+wQ folded before Flop (didn't bet)
Seat 4: kG34n23qFQA3nzdOJTQ1dA folded before Flop (didn't bet)
Seat 5: L3/N/gliETan8N5Gim5h4Q folded before Flop (didn't bet)
Seat 6: 8EEqTTh7T1q48sYDqbI2Xg (button) folded on the Flop




PokerStars Game #59941776108:  Hold'em No Limit ($0.10/$0.25) - 2009/07/01 1:45:47 ET
Table 'gnrUwXkIPE0C8xl6cB4Hyw' 9-max Seat #2 is the button
Seat 1: EQXHDnIzAsORnIXRNtXRlA ($22.25 in chips) 
Seat 2: 7je+LC5Mfs6nL8YBVh4frQ ($5 in chips) 
Seat 3: PdIasPkzm2sqZnN41ZRXOg ($5.10 in chips) 
Seat 4: wGigCmBR/9XWkPpvYos3aQ ($25.35 in chips) 
Seat 5: gehe91e0IyVT0QU/XBkEyg ($26.90 in chips) 
Seat 6: dtZ84flFEi4Q+SGrHMJRDQ ($25.80 in chips) 
Seat 7: OXPkK84/qv92EMwXPiG5rQ ($9.95 in chips) 
Seat 8: 4awUyiDYTgylQKXZ9faBVA ($60.65 in chips) 
Seat 9: F7pnn6czNpHvRM55XcA2EA ($25.50 in chips) 
PdIasPkzm2sqZnN41ZRXOg: posts small blind $0.10
wGigCmBR/9XWkPpvYos3aQ: posts big blind $0.25
*** HOLE CARDS ***
gehe91e0IyVT0QU/XBkEyg: folds 
dtZ84flFEi4Q+SGrHMJRDQ: folds 
OXPkK84/qv92EMwXPiG5rQ: folds 
4awUyiDYTgylQKXZ9faBVA: folds 
F7pnn6czNpHvRM55XcA2EA: folds 
EQXHDnIzAsORnIXRNtXRlA: raises $0.50 to $0.75
7je+LC5Mfs6nL8YBVh4frQ: folds 
PdIasPkzm2sqZnN41ZRXOg: folds 
wGigCmBR/9XWkPpvYos3aQ: folds 
Uncalled bet ($0.50) returned to EQXHDnIzAsORnIXRNtXRlA
EQXHDnIzAsORnIXRNtXRlA collected $0.60 from pot
*** SUMMARY ***
Total pot $0.60 | Rake $0 
Seat 1: EQXHDnIzAsORnIXRNtXRlA collected ($0.60)
Seat 2: 7je+LC5Mfs6nL8YBVh4frQ (button) folded before Flop (didn't bet)
Seat 3: PdIasPkzm2sqZnN41ZRXOg (small blind) folded before Flop
Seat 4: wGigCmBR/9XWkPpvYos3aQ (big blind) folded before Flop
Seat 5: gehe91e0IyVT0QU/XBkEyg folded before Flop (didn't bet)
Seat 6: dtZ84flFEi4Q+SGrHMJRDQ folded before Flop (didn't bet)
Seat 7: OXPkK84/qv92EMwXPiG5rQ folded before Flop (didn't bet)
Seat 8: 4awUyiDYTgylQKXZ9faBVA folded before Flop (didn't bet)
Seat 9: F7pnn6czNpHvRM55XcA2EA folded before Flop (didn't bet)




PokerStars Game #59941776506:  Hold'em No Limit ($0.10/$0.25) - 2009/07/01 1:45:48 ET
Table 'AUM6O+mgQAaLDZKMQ/5/gA' 9-max Seat #5 is the button
Seat 1: EIObtVVE4WXRXvLGJA6NHw ($12.50 in chips) 
Seat 2: z5GxcHlYz/GSz6W2uFiTtg ($25 in chips) 
Seat 3: CvL9Ch1HYCVbTsfpNucitg ($5 in chips) 
Seat 4: 4awUyiDYTgylQKXZ9faBVA ($27.70 in chips) 
Seat 5: +2kMBNpY4nF1qNCRd8SJLA ($25.30 in chips) 
Seat 6: v5jnQ1gfh9nLla3kMXG7Yg ($6.95 in chips) 
Seat 7: Bb42QRQMhg5/Y0vHP8/2Xw ($28.85 in chips) 
Seat 8: zDrucyjVn5aeekNEc3cJrA ($17.40 in chips) 
Seat 9: eK8qa6EPcH2zhtbmWSvc9g ($30.70 in chips) 
v5jnQ1gfh9nLla3kMXG7Yg: posts small blind $0.10
Bb42QRQMhg5/Y0vHP8/2Xw: posts big blind $0.25
z5GxcHlYz/GSz6W2uFiTtg: posts big blind $0.25
*** HOLE CARDS ***
zDrucyjVn5aeekNEc3cJrA: folds 
eK8qa6EPcH2zhtbmWSvc9g: raises $0.75 to $1
EIObtVVE4WXRXvLGJA6NHw: calls $1
z5GxcHlYz/GSz6W2uFiTtg has timed out
z5GxcHlYz/GSz6W2uFiTtg: folds 
z5GxcHlYz/GSz6W2uFiTtg is sitting out
CvL9Ch1HYCVbTsfpNucitg: folds 
4awUyiDYTgylQKXZ9faBVA: folds 
+2kMBNpY4nF1qNCRd8SJLA: folds 
v5jnQ1gfh9nLla3kMXG7Yg: calls $0.90
Bb42QRQMhg5/Y0vHP8/2Xw: folds 
*** FLOP *** [7h Th 3s]
v5jnQ1gfh9nLla3kMXG7Yg: checks 
eK8qa6EPcH2zhtbmWSvc9g: checks 
EIObtVVE4WXRXvLGJA6NHw: checks 
*** TURN *** [7h Th 3s] [9h]
v5jnQ1gfh9nLla3kMXG7Yg: checks 
eK8qa6EPcH2zhtbmWSvc9g: checks 
EIObtVVE4WXRXvLGJA6NHw: bets $1.50
v5jnQ1gfh9nLla3kMXG7Yg: raises $4.45 to $5.95 and is all-in
eK8qa6EPcH2zhtbmWSvc9g: folds 
EIObtVVE4WXRXvLGJA6NHw: folds 
Uncalled bet ($4.45) returned to v5jnQ1gfh9nLla3kMXG7Yg
v5jnQ1gfh9nLla3kMXG7Yg collected $6.20 from pot
v5jnQ1gfh9nLla3kMXG7Yg: doesn't show hand 
*** SUMMARY ***
Total pot $6.50 | Rake $0.30 
Board [7h Th 3s 9h]
Seat 1: EIObtVVE4WXRXvLGJA6NHw folded on the Turn
Seat 2: z5GxcHlYz/GSz6W2uFiTtg folded before Flop
Seat 3: CvL9Ch1HYCVbTsfpNucitg folded before Flop (didn't bet)
Seat 4: 4awUyiDYTgylQKXZ9faBVA folded before Flop (didn't bet)
Seat 5: +2kMBNpY4nF1qNCRd8SJLA (button) folded before Flop (didn't bet)
Seat 6: v5jnQ1gfh9nLla3kMXG7Yg (small blind) collected ($6.20)
Seat 7: Bb42QRQMhg5/Y0vHP8/2Xw (big blind) folded before Flop
Seat 8: zDrucyjVn5aeekNEc3cJrA folded before Flop (didn't bet)
Seat 9: eK8qa6EPcH2zhtbmWSvc9g folded on the Turn




PokerStars Game #59941776568:  Hold'em No Limit ($0.10/$0.25) - 2009/07/01 1:45:48 ET
Table 'HIOfhT0zga/KonFhIl6O3w' 9-max Seat #1 is the button
Seat 1: oLa/tXLfSLLB28mcLGrxcg ($26.20 in chips) 
Seat 2: er86weqXTpTB6/w2dKlYgA ($17 in chips) 
Seat 3: X6+pSIPfovPcE87t+LmUKQ ($5 in chips) 
Seat 4: qwr38jl5txoR36M7G5qi4A ($8.65 in chips) 
Seat 5: K1MDeapSEyKyGPNZGOKfEg ($36.10 in chips) 
Seat 6: MThMMgdB293VOucmN9sliQ ($25.45 in chips) 
Seat 7: wvlPJBB0PtYkfeeSRDaIvQ ($13.45 in chips) 
Seat 9: dfNim92Z6XK1/h5SFW5vDg ($28.70 in chips) 
er86weqXTpTB6/w2dKlYgA: posts small blind $0.10
X6+pSIPfovPcE87t+LmUKQ: posts big blind $0.25
SpiiQQAzy4MUgV3I5W8giw: sits out 
*** HOLE CARDS ***
qwr38jl5txoR36M7G5qi4A: folds 
K1MDeapSEyKyGPNZGOKfEg: folds 
MThMMgdB293VOucmN9sliQ: calls $0.25
wvlPJBB0PtYkfeeSRDaIvQ: folds 
dfNim92Z6XK1/h5SFW5vDg: folds 
oLa/tXLfSLLB28mcLGrxcg: folds 
er86weqXTpTB6/w2dKlYgA: calls $0.15
X6+pSIPfovPcE87t+LmUKQ: checks 
*** FLOP *** [8h Ad 3s]
er86weqXTpTB6/w2dKlYgA: checks 
X6+pSIPfovPcE87t+LmUKQ: checks 
MThMMgdB293VOucmN9sliQ: bets $0.50
er86weqXTpTB6/w2dKlYgA: folds 
X6+pSIPfovPcE87t+LmUKQ: folds 
Uncalled bet ($0.50) returned to MThMMgdB293VOucmN9sliQ
MThMMgdB293VOucmN9sliQ collected $0.75 from pot
*** SUMMARY ***
Total pot $0.75 | Rake $0 
Board [8h Ad 3s]
Seat 1: oLa/tXLfSLLB28mcLGrxcg (button) folded before Flop (didn't bet)
Seat 2: er86weqXTpTB6/w2dKlYgA (small blind) folded on the Flop
Seat 3: X6+pSIPfovPcE87t+LmUKQ (big blind) folded on the Flop
Seat 4: qwr38jl5txoR36M7G5qi4A folded before Flop (didn't bet)
Seat 5: K1MDeapSEyKyGPNZGOKfEg folded before Flop (didn't bet)
Seat 6: MThMMgdB293VOucmN9sliQ collected ($0.75)
Seat 7: wvlPJBB0PtYkfeeSRDaIvQ folded before Flop (didn't bet)
Seat 9: dfNim92Z6XK1/h5SFW5vDg folded before Flop (didn't bet)




PokerStars Game #59941776394:  Hold'em No Limit ($0.10/$0.25) - 2009/07/01 1:45:48 ET
Table 'RPdw09/gGCIP4xFhDWJgXQ' 9-max Seat #8 is the button
Seat 1: aNpwfA31EREwO+ar4XzBCw ($27.85 in chips) 
Seat 2: Sd1tfhUq/M96GhXGv1hwFQ ($8.55 in chips) 
Seat 3: g5LAv1J/3Thw1zs/SEyfzw ($18.25 in chips) 
Seat 5: gehe91e0IyVT0QU/XBkEyg ($30.35 in chips) 
Seat 6: monZeAwXUmIA1l84cUd2hw ($14.50 in chips) 
Seat 7: EP17SQz/iWcuYdNOGeBgkw ($13.90 in chips) 
Seat 8: MG90wfSJZnOejs/KD3vlQQ ($29.80 in chips) 
Seat 9: O02ScVDnDZwH6KjZNJZMzA ($4.75 in chips) 
O02ScVDnDZwH6KjZNJZMzA: posts small blind $0.10
aNpwfA31EREwO+ar4XzBCw: posts big blind $0.25
*** HOLE CARDS ***
Sd1tfhUq/M96GhXGv1hwFQ: calls $0.25
g5LAv1J/3Thw1zs/SEyfzw: folds 
gehe91e0IyVT0QU/XBkEyg: raises $0.75 to $1
monZeAwXUmIA1l84cUd2hw: folds 
EP17SQz/iWcuYdNOGeBgkw: folds 
MG90wfSJZnOejs/KD3vlQQ: folds 
O02ScVDnDZwH6KjZNJZMzA: folds 
aNpwfA31EREwO+ar4XzBCw: folds 
Sd1tfhUq/M96GhXGv1hwFQ: calls $0.75
*** FLOP *** [Qs 4c Jh]
Sd1tfhUq/M96GhXGv1hwFQ: checks 
gehe91e0IyVT0QU/XBkEyg: bets $2
Sd1tfhUq/M96GhXGv1hwFQ: folds 
Uncalled bet ($2) returned to gehe91e0IyVT0QU/XBkEyg
gehe91e0IyVT0QU/XBkEyg collected $2.25 from pot
gehe91e0IyVT0QU/XBkEyg: doesn't show hand 
*** SUMMARY ***
Total pot $2.35 | Rake $0.10 
Board [Qs 4c Jh]
Seat 1: aNpwfA31EREwO+ar4XzBCw (big blind) folded before Flop
Seat 2: Sd1tfhUq/M96GhXGv1hwFQ folded on the Flop
Seat 3: g5LAv1J/3Thw1zs/SEyfzw folded before Flop (didn't bet)
Seat 5: gehe91e0IyVT0QU/XBkEyg collected ($2.25)
Seat 6: monZeAwXUmIA1l84cUd2hw folded before Flop (didn't bet)
Seat 7: EP17SQz/iWcuYdNOGeBgkw folded before Flop (didn't bet)
Seat 8: MG90wfSJZnOejs/KD3vlQQ (button) folded before Flop (didn't bet)
Seat 9: O02ScVDnDZwH6KjZNJZMzA (small blind) folded before Flop




PokerStars Game #59941776572:  Hold'em No Limit ($0.10/$0.25) - 2009/07/01 1:45:48 ET
Table 'b64Z+5XI1xkQzNfq4QHr3A' 6-max Seat #3 is the button
Seat 2: A6SjYLoKeIpFjPq0BK/2WA ($5 in chips) 
Seat 3: u/yN5P9f3KlATg6WLWNkBQ ($49.50 in chips) 
Seat 4: SxIIgwXYLkwd6m3wLyPTCw ($10.60 in chips) 
Seat 5: JFIAqU8lCZ0vWwEl4bdGsg ($58.35 in chips) 
Seat 6: 8ClCHtFXGNplITm+63KB+Q ($35.85 in chips) 
SxIIgwXYLkwd6m3wLyPTCw: posts small blind $0.10
JFIAqU8lCZ0vWwEl4bdGsg: posts big blind $0.25
A6SjYLoKeIpFjPq0BK/2WA: posts big blind $0.25
*** HOLE CARDS ***
8ClCHtFXGNplITm+63KB+Q: raises $0.75 to $1
A6SjYLoKeIpFjPq0BK/2WA: folds 
u/yN5P9f3KlATg6WLWNkBQ: calls $1
SxIIgwXYLkwd6m3wLyPTCw: folds 
JFIAqU8lCZ0vWwEl4bdGsg: folds 
*** FLOP *** [Ad 3h 3c]
SxIIgwXYLkwd6m3wLyPTCw leaves the table
8ClCHtFXGNplITm+63KB+Q: bets $1.75
u/yN5P9f3KlATg6WLWNkBQ: raises $3.75 to $5.50
8ClCHtFXGNplITm+63KB+Q: folds 
Uncalled bet ($3.75) returned to u/yN5P9f3KlATg6WLWNkBQ
564zqq2DUHXR3tdsOJU6JA joins the table at seat #4 
u/yN5P9f3KlATg6WLWNkBQ collected $5.80 from pot
u/yN5P9f3KlATg6WLWNkBQ: doesn't show hand 
*** SUMMARY ***
Total pot $6.10 | Rake $0.30 
Board [Ad 3h 3c]
Seat 2: A6SjYLoKeIpFjPq0BK/2WA folded before Flop
Seat 3: u/yN5P9f3KlATg6WLWNkBQ (button) collected ($5.80)
Seat 4: SxIIgwXYLkwd6m3wLyPTCw (small blind) folded before Flop
Seat 5: JFIAqU8lCZ0vWwEl4bdGsg (big blind) folded before Flop
Seat 6: 8ClCHtFXGNplITm+63KB+Q folded on the Flop




PokerStars Game #59941776420:  Hold'em No Limit ($0.10/$0.25) - 2009/07/01 1:45:48 ET
Table 'hfHe8uKeSJMyWAjSdM7ROQ' 6-max Seat #2 is the button
Seat 1: eHsmIvAb2JREg4O6hNPnXg ($40.70 in chips) 
Seat 2: QvTX2yGq3uKJiKPmns4TKQ ($29.80 in chips) 
Seat 3: oAzQdB2jFOH1NxFUPjYUGg ($26.50 in chips) 
Seat 4: b4wRQV3APH8irVk6bUFe2Q ($25.85 in chips) 
Seat 5: euswrBD1XG0Q5hB1iGJBKQ ($61.55 in chips) 
oAzQdB2jFOH1NxFUPjYUGg: posts small blind $0.10
b4wRQV3APH8irVk6bUFe2Q: posts big blind $0.25
eL3+wCBjFGfQ5FMdIZihwA: sits out 
*** HOLE CARDS ***
euswrBD1XG0Q5hB1iGJBKQ: folds 
eHsmIvAb2JREg4O6hNPnXg: folds 
QvTX2yGq3uKJiKPmns4TKQ: calls $0.25
oAzQdB2jFOH1NxFUPjYUGg: calls $0.15
b4wRQV3APH8irVk6bUFe2Q: checks 
*** FLOP *** [Qd Jc Kh]
oAzQdB2jFOH1NxFUPjYUGg: checks 
b4wRQV3APH8irVk6bUFe2Q: checks 
QvTX2yGq3uKJiKPmns4TKQ: checks 
*** TURN *** [Qd Jc Kh] [8s]
oAzQdB2jFOH1NxFUPjYUGg: checks 
b4wRQV3APH8irVk6bUFe2Q: bets $0.50
QvTX2yGq3uKJiKPmns4TKQ: folds 
oAzQdB2jFOH1NxFUPjYUGg: folds 
Uncalled bet ($0.50) returned to b4wRQV3APH8irVk6bUFe2Q
b4wRQV3APH8irVk6bUFe2Q collected $0.75 from pot
*** SUMMARY ***
Total pot $0.75 | Rake $0 
Board [Qd Jc Kh 8s]
Seat 1: eHsmIvAb2JREg4O6hNPnXg folded before Flop (didn't bet)
Seat 2: QvTX2yGq3uKJiKPmns4TKQ (button) folded on the Turn
Seat 3: oAzQdB2jFOH1NxFUPjYUGg (small blind) folded on the Turn
Seat 4: b4wRQV3APH8irVk6bUFe2Q (big blind) collected ($0.75)
Seat 5: euswrBD1XG0Q5hB1iGJBKQ folded before Flop (didn't bet)




PokerStars Game #59941776570:  Hold'em No Limit ($0.10/$0.25) - 2009/07/01 1:45:48 ET
Table 'g+mPuNJBCHKE9ents7ZGtg' 6-max Seat #4 is the button
Seat 1: cezpHJ8FB07dj0xG+LhOvw ($58.65 in chips) 
Seat 2: fZQg9veL7Dd/Z04ZTjC+wQ ($64.95 in chips) 
Seat 3: FYepjhAvF8ZdVCmqHIy+eQ ($29.90 in chips) 
Seat 4: yVrjRIW0SMxgpvqSIPSe/w ($14.30 in chips) 
Seat 5: D3ikCR8c/o9jB5irZ3uGlw ($12.40 in chips) 
Seat 6: Mn2V28t5aGq2d09z+/o6Fw ($24.65 in chips) 
D3ikCR8c/o9jB5irZ3uGlw: posts small blind $0.10
Mn2V28t5aGq2d09z+/o6Fw: posts big blind $0.25
*** HOLE CARDS ***
cezpHJ8FB07dj0xG+LhOvw: folds 
fZQg9veL7Dd/Z04ZTjC+wQ: folds 
FYepjhAvF8ZdVCmqHIy+eQ: folds 
yVrjRIW0SMxgpvqSIPSe/w: calls $0.25
D3ikCR8c/o9jB5irZ3uGlw: calls $0.15
Mn2V28t5aGq2d09z+/o6Fw: checks 
*** FLOP *** [4c 4s Js]
D3ikCR8c/o9jB5irZ3uGlw: checks 
Mn2V28t5aGq2d09z+/o6Fw: bets $0.50
yVrjRIW0SMxgpvqSIPSe/w: raises $1.25 to $1.75
D3ikCR8c/o9jB5irZ3uGlw: folds 
Mn2V28t5aGq2d09z+/o6Fw: calls $1.25
*** TURN *** [4c 4s Js] [3s]
Mn2V28t5aGq2d09z+/o6Fw: checks 
yVrjRIW0SMxgpvqSIPSe/w: bets $12.30 and is all-in
Mn2V28t5aGq2d09z+/o6Fw: folds 
Uncalled bet ($12.30) returned to yVrjRIW0SMxgpvqSIPSe/w
yVrjRIW0SMxgpvqSIPSe/w collected $4.05 from pot
*** SUMMARY ***
Total pot $4.25 | Rake $0.20 
Board [4c 4s Js 3s]
Seat 1: cezpHJ8FB07dj0xG+LhOvw folded before Flop (didn't bet)
Seat 2: fZQg9veL7Dd/Z04ZTjC+wQ folded before Flop (didn't bet)
Seat 3: FYepjhAvF8ZdVCmqHIy+eQ folded before Flop (didn't bet)
Seat 4: yVrjRIW0SMxgpvqSIPSe/w (button) collected ($4.05)
Seat 5: D3ikCR8c/o9jB5irZ3uGlw (small blind) folded on the Flop
Seat 6: Mn2V28t5aGq2d09z+/o6Fw (big blind) folded on the Turn




PokerStars Game #59941776800:  Hold'em No Limit ($0.10/$0.25) - 2009/07/01 1:45:48 ET
Table 'vFZR6Kf2Th5xBXT9brGW6A' 6-max Seat #1 is the button
Seat 1: Q3EMN7b0ie81AFWkDrhCjw ($25 in chips) 
Seat 2: QiL+lEgEWwy21jk/ltaRLg ($22.15 in chips) 
Seat 3: SH1WjKVUjPiyXySjWSdazw ($21.10 in chips) 
Seat 4: 79ID/ub1Pt/mDpCprVmOoA ($35.20 in chips) 
Seat 5: SS/yfeArhULzIcOPe8MdPg ($26.30 in chips) 
Seat 6: 4x9jCqgSw4272dnaIqnanw ($10.90 in chips) 
QiL+lEgEWwy21jk/ltaRLg: posts small blind $0.10
SH1WjKVUjPiyXySjWSdazw: posts big blind $0.25
*** HOLE CARDS ***
79ID/ub1Pt/mDpCprVmOoA: folds 
SS/yfeArhULzIcOPe8MdPg: folds 
4x9jCqgSw4272dnaIqnanw: folds 
Q3EMN7b0ie81AFWkDrhCjw: raises $0.50 to $0.75
QiL+lEgEWwy21jk/ltaRLg: folds 
SH1WjKVUjPiyXySjWSdazw: raises $0.75 to $1.50
Q3EMN7b0ie81AFWkDrhCjw: calls $0.75
*** FLOP *** [3s As 8h]
SH1WjKVUjPiyXySjWSdazw: checks 
Q3EMN7b0ie81AFWkDrhCjw: bets $2.50
SH1WjKVUjPiyXySjWSdazw: raises $3.50 to $6
Q3EMN7b0ie81AFWkDrhCjw: calls $3.50
*** TURN *** [3s As 8h] [4s]
SH1WjKVUjPiyXySjWSdazw: bets $13.60 and is all-in
Q3EMN7b0ie81AFWkDrhCjw: calls $13.60
*** RIVER *** [3s As 8h 4s] [3c]
*** SHOW DOWN ***
SH1WjKVUjPiyXySjWSdazw: shows [8d Ad] (two pair, Aces and Eights)
Q3EMN7b0ie81AFWkDrhCjw: mucks hand 
SH1WjKVUjPiyXySjWSdazw collected $40.25 from pot
*** SUMMARY ***
Total pot $42.30 | Rake $2.05 
Board [3s As 8h 4s 3c]
Seat 1: Q3EMN7b0ie81AFWkDrhCjw (button) mucked
Seat 2: QiL+lEgEWwy21jk/ltaRLg (small blind) folded before Flop
Seat 3: SH1WjKVUjPiyXySjWSdazw (big blind) showed [8d Ad] and won ($40.25) with two pair, Aces and Eights
Seat 4: 79ID/ub1Pt/mDpCprVmOoA folded before Flop (didn't bet)
Seat 5: SS/yfeArhULzIcOPe8MdPg folded before Flop (didn't bet)
Seat 6: 4x9jCqgSw4272dnaIqnanw folded before Flop (didn't bet)




PokerStars Game #59941776626:  Hold'em No Limit ($0.10/$0.25) - 2009/07/01 1:45:48 ET
Table 'jdhJTJjFq2KTttwJcd+7nQ' 6-max Seat #2 is the button
Seat 1: LtASJ9OlkqGrrUKGQlpGAw ($26.85 in chips) 
Seat 2: Hsvkc0/G2VV78oVmWYXecw ($5 in chips) 
Seat 3: vqWjZmdQu/Hxw96/IJTWdQ ($25.20 in chips) 
Seat 4: vx7FwRcelVSsvNYAdp/z0A ($6.15 in chips) 
Seat 5: BV+K0Phf5VBHr7aZPKqbUQ ($26.10 in chips) 
Seat 6: yb6rnd48JuBccThV68VHAQ ($18 in chips) 
vqWjZmdQu/Hxw96/IJTWdQ: posts small blind $0.10
vx7FwRcelVSsvNYAdp/z0A: posts big blind $0.25
*** HOLE CARDS ***
BV+K0Phf5VBHr7aZPKqbUQ: folds 
yb6rnd48JuBccThV68VHAQ: calls $0.25
LtASJ9OlkqGrrUKGQlpGAw: folds 
Hsvkc0/G2VV78oVmWYXecw: folds 
vqWjZmdQu/Hxw96/IJTWdQ: calls $0.15
vx7FwRcelVSsvNYAdp/z0A: checks 
*** FLOP *** [9d Td 6d]
vqWjZmdQu/Hxw96/IJTWdQ: bets $0.50
vx7FwRcelVSsvNYAdp/z0A: folds 
yb6rnd48JuBccThV68VHAQ: calls $0.50
*** TURN *** [9d Td 6d] [Tc]
vqWjZmdQu/Hxw96/IJTWdQ: bets $1.50
yb6rnd48JuBccThV68VHAQ: calls $1.50
*** RIVER *** [9d Td 6d Tc] [Jd]
vqWjZmdQu/Hxw96/IJTWdQ: checks 
yb6rnd48JuBccThV68VHAQ: bets $1.50
vqWjZmdQu/Hxw96/IJTWdQ: folds 
Uncalled bet ($1.50) returned to yb6rnd48JuBccThV68VHAQ
yb6rnd48JuBccThV68VHAQ collected $4.55 from pot
yb6rnd48JuBccThV68VHAQ: doesn't show hand 
*** SUMMARY ***
Total pot $4.75 | Rake $0.20 
Board [9d Td 6d Tc Jd]
Seat 1: LtASJ9OlkqGrrUKGQlpGAw folded before Flop (didn't bet)
Seat 2: Hsvkc0/G2VV78oVmWYXecw (button) folded before Flop (didn't bet)
Seat 3: vqWjZmdQu/Hxw96/IJTWdQ (small blind) folded on the River
Seat 4: vx7FwRcelVSsvNYAdp/z0A (big blind) folded on the Flop
Seat 5: BV+K0Phf5VBHr7aZPKqbUQ folded before Flop (didn't bet)
Seat 6: yb6rnd48JuBccThV68VHAQ collected ($4.55)




PokerStars Game #59941776590:  Hold'em No Limit ($0.10/$0.25) - 2009/07/01 1:45:48 ET
Table 'MiquQrQZJJq9ZtgRIp9HFQ' 6-max Seat #3 is the button
Seat 1: c3J/KYZ4cNsUEuz8v57I5A ($21.25 in chips) 
Seat 2: 2+6voGl1T1DO63JePptI3g ($19 in chips) 
Seat 3: 9h7TNZ1TDGRUJXA6rI+ZTw ($9.40 in chips) 
Seat 4: wAKC8C/zN0c8V5v13dm9mA ($58.05 in chips) 
Seat 5: iyZxqznXjv3vtvOJymkoLQ ($26.75 in chips) 
Seat 6: GbCVUNssQ7mqsPWr7J4d3w ($5 in chips) 
wAKC8C/zN0c8V5v13dm9mA: posts small blind $0.10
iyZxqznXjv3vtvOJymkoLQ: posts big blind $0.25
*** HOLE CARDS ***
GbCVUNssQ7mqsPWr7J4d3w: folds 
c3J/KYZ4cNsUEuz8v57I5A: folds 
2+6voGl1T1DO63JePptI3g: folds 
9h7TNZ1TDGRUJXA6rI+ZTw: folds 
wAKC8C/zN0c8V5v13dm9mA: folds 
Uncalled bet ($0.15) returned to iyZxqznXjv3vtvOJymkoLQ
iyZxqznXjv3vtvOJymkoLQ collected $0.20 from pot
iyZxqznXjv3vtvOJymkoLQ: doesn't show hand 
*** SUMMARY ***
Total pot $0.20 | Rake $0 
Seat 1: c3J/KYZ4cNsUEuz8v57I5A folded before Flop (didn't bet)
Seat 2: 2+6voGl1T1DO63JePptI3g folded before Flop (didn't bet)
Seat 3: 9h7TNZ1TDGRUJXA6rI+ZTw (button) folded before Flop (didn't bet)
Seat 4: wAKC8C/zN0c8V5v13dm9mA (small blind) folded before Flop
Seat 5: iyZxqznXjv3vtvOJymkoLQ (big blind) collected ($0.20)
Seat 6: GbCVUNssQ7mqsPWr7J4d3w folded before Flop (didn't bet)




PokerStars Game #59941776838:  Hold'em No Limit ($0.10/$0.25) - 2009/07/01 1:45:49 ET
Table '9L7XfAwuM7XsXE8LIg2o5Q' 6-max Seat #1 is the button
Seat 1: dOIoLBxmpLHSXBN9LZnf0Q ($23.85 in chips) 
Seat 2: LJI7A1YgDM7hgh7o56+ReQ ($28.65 in chips) 
Seat 3: mFv3iBCtrw9XfCDRB0d46Q ($4.65 in chips) 
Seat 4: jp34e617tIzV8tKIWmfAbA ($38.45 in chips) 
Seat 5: zsU1ijOyYEi+40wBKPEbmw ($8.40 in chips) 
Seat 6: k9nHZTHt8hYhYRcW8NTb4g ($37.90 in chips) 
LJI7A1YgDM7hgh7o56+ReQ: posts small blind $0.10
mFv3iBCtrw9XfCDRB0d46Q: posts big blind $0.25
*** HOLE CARDS ***
jp34e617tIzV8tKIWmfAbA: raises $0.50 to $0.75
zsU1ijOyYEi+40wBKPEbmw: folds 
k9nHZTHt8hYhYRcW8NTb4g: folds 
dOIoLBxmpLHSXBN9LZnf0Q: folds 
LJI7A1YgDM7hgh7o56+ReQ: folds 
mFv3iBCtrw9XfCDRB0d46Q: folds 
Uncalled bet ($0.50) returned to jp34e617tIzV8tKIWmfAbA
jp34e617tIzV8tKIWmfAbA collected $0.60 from pot
jp34e617tIzV8tKIWmfAbA: doesn't show hand 
*** SUMMARY ***
Total pot $0.60 | Rake $0 
Seat 1: dOIoLBxmpLHSXBN9LZnf0Q (button) folded before Flop (didn't bet)
Seat 2: LJI7A1YgDM7hgh7o56+ReQ (small blind) folded before Flop
Seat 3: mFv3iBCtrw9XfCDRB0d46Q (big blind) folded before Flop
Seat 4: jp34e617tIzV8tKIWmfAbA collected ($0.60)
Seat 5: zsU1ijOyYEi+40wBKPEbmw folded before Flop (didn't bet)
Seat 6: k9nHZTHt8hYhYRcW8NTb4g folded before Flop (didn't bet)




PokerStars Game #59941776868:  Hold'em No Limit ($0.10/$0.25) - 2009/07/01 1:45:49 ET
Table 'ktio12Pyq06LsrFhIorSqA' 9-max Seat #9 is the button
Seat 1: OneeONzF0MoH0pEdcBndwA ($40.45 in chips) 
Seat 2: tGsFgUKjSctVaAXabrlZxw ($2.65 in chips) 
Seat 4: 0QdZrkFD7aGKeBXPGbIomA ($5 in chips) 
Seat 5: e0pV1oisCAilWiG0FCxY6A ($16.75 in chips) 
Seat 6: jQL6XIewylQ8MmZhhq2YFg ($42.20 in chips) 
Seat 7: XGCfQsxa6PfAg3kJtzUmww ($22.10 in chips) 
Seat 9: H5Se03ZqSX7tbULXur2MAg ($26.30 in chips) 
OneeONzF0MoH0pEdcBndwA: posts small blind $0.10
tGsFgUKjSctVaAXabrlZxw: posts big blind $0.25
Z9W7+g1WMhhZDi7DwGbCFA: sits out 
*** HOLE CARDS ***
0QdZrkFD7aGKeBXPGbIomA: folds 
e0pV1oisCAilWiG0FCxY6A: folds 
jQL6XIewylQ8MmZhhq2YFg: folds 
XGCfQsxa6PfAg3kJtzUmww: folds 
H5Se03ZqSX7tbULXur2MAg: folds 
OneeONzF0MoH0pEdcBndwA: raises $0.50 to $0.75
tGsFgUKjSctVaAXabrlZxw: raises $1.90 to $2.65 and is all-in
OneeONzF0MoH0pEdcBndwA: calls $1.90
*** FLOP *** [7s 6c Ts]
*** TURN *** [7s 6c Ts] [2d]
*** RIVER *** [7s 6c Ts 2d] [5h]
*** SHOW DOWN ***
OneeONzF0MoH0pEdcBndwA: shows [Kc Jc] (high card King)
tGsFgUKjSctVaAXabrlZxw: shows [Qd Td] (a pair of Tens)
tGsFgUKjSctVaAXabrlZxw collected $5.05 from pot
*** SUMMARY ***
Total pot $5.30 | Rake $0.25 
Board [7s 6c Ts 2d 5h]
Seat 1: OneeONzF0MoH0pEdcBndwA (small blind) showed [Kc Jc] and lost with high card King
Seat 2: tGsFgUKjSctVaAXabrlZxw (big blind) showed [Qd Td] and won ($5.05) with a pair of Tens
Seat 4: 0QdZrkFD7aGKeBXPGbIomA folded before Flop (didn't bet)
Seat 5: e0pV1oisCAilWiG0FCxY6A folded before Flop (didn't bet)
Seat 6: jQL6XIewylQ8MmZhhq2YFg folded before Flop (didn't bet)
Seat 7: XGCfQsxa6PfAg3kJtzUmww folded before Flop (didn't bet)
Seat 9: H5Se03ZqSX7tbULXur2MAg (button) folded before Flop (didn't bet)




PokerStars Game #59941776950:  Hold'em No Limit ($0.10/$0.25) - 2009/07/01 1:45:49 ET
Table '4hfTdIVT/qPsJNfWXLsVIw' 9-max Seat #6 is the button
Seat 1: GbHFBbLqLGz0Pwn6CJeAuw ($41.30 in chips) 
Seat 2: Pt637jKksB5MzP0UNJAAkw ($40.20 in chips) 
Seat 3: xnVwSkROfRtOw4eSoDANtw ($4.70 in chips) 
Seat 5: dtZ84flFEi4Q+SGrHMJRDQ ($25.10 in chips) 
Seat 6: VWUWpMLMj/Q1jRVpF7Aohw ($12.55 in chips) 
Seat 8: 7cv+9Zc9HIQHNvYsMfV3uA ($28.75 in chips) 
Seat 9: 9njEKzpOKC62MllUFUBWrA ($24.35 in chips) 
z5GxcHlYz/GSz6W2uFiTtg was removed from the table for failing to post
7cv+9Zc9HIQHNvYsMfV3uA: posts small blind $0.10
9njEKzpOKC62MllUFUBWrA: posts big blind $0.25
3PmVnC/15cl4oyI1TKIt4g: sits out 
*** HOLE CARDS ***
GbHFBbLqLGz0Pwn6CJeAuw: folds 
Pt637jKksB5MzP0UNJAAkw: folds 
xnVwSkROfRtOw4eSoDANtw: folds 
dtZ84flFEi4Q+SGrHMJRDQ: folds 
VWUWpMLMj/Q1jRVpF7Aohw: raises $0.75 to $1
7cv+9Zc9HIQHNvYsMfV3uA: folds 
9njEKzpOKC62MllUFUBWrA: folds 
Uncalled bet ($0.75) returned to VWUWpMLMj/Q1jRVpF7Aohw
VWUWpMLMj/Q1jRVpF7Aohw collected $0.60 from pot
d7YasxuGLPiL7pj8IcGThw joins the table at seat #7 
*** SUMMARY ***
Total pot $0.60 | Rake $0 
Seat 1: GbHFBbLqLGz0Pwn6CJeAuw folded before Flop (didn't bet)
Seat 2: Pt637jKksB5MzP0UNJAAkw folded before Flop (didn't bet)
Seat 3: xnVwSkROfRtOw4eSoDANtw folded before Flop (didn't bet)
Seat 5: dtZ84flFEi4Q+SGrHMJRDQ folded before Flop (didn't bet)
Seat 6: VWUWpMLMj/Q1jRVpF7Aohw (button) collected ($0.60)
Seat 8: 7cv+9Zc9HIQHNvYsMfV3uA (small blind) folded before Flop
Seat 9: 9njEKzpOKC62MllUFUBWrA (big blind) folded before Flop




PokerStars Game #59941776922:  Hold'em No Limit ($0.10/$0.25) - 2009/07/01 1:45:49 ET
Table '3EebBlzq5yHSY2444L4zlg' 9-max Seat #6 is the button
Seat 1: XMSS6mD5B42I8wasdOMipQ ($29.50 in chips) 
Seat 2: b9UnopCOpq2MWP1DwqSO3Q ($17.95 in chips) 
Seat 3: IGbD5vKNhHe60dkdbjg/mw ($41.45 in chips) 
Seat 5: PFNLAvMkr8qKc7xCiH0wTA ($23.45 in chips) 
Seat 6: QEbIGci+itdw+re8RM5fZA ($50 in chips) 
Seat 7: DiSvPC2iudwL5j9u6Huyww ($48.60 in chips) 
Seat 8: dtZ84flFEi4Q+SGrHMJRDQ ($29.05 in chips) 
Seat 9: iZmSlSzYu5fJ67tDdQzymQ ($25.95 in chips) 
DiSvPC2iudwL5j9u6Huyww: posts small blind $0.10
dtZ84flFEi4Q+SGrHMJRDQ: posts big blind $0.25
PdIasPkzm2sqZnN41ZRXOg: sits out 
*** HOLE CARDS ***
iZmSlSzYu5fJ67tDdQzymQ: folds 
XMSS6mD5B42I8wasdOMipQ: folds 
b9UnopCOpq2MWP1DwqSO3Q: calls $0.25
IGbD5vKNhHe60dkdbjg/mw: folds 
PFNLAvMkr8qKc7xCiH0wTA: calls $0.25
QEbIGci+itdw+re8RM5fZA: folds 
DiSvPC2iudwL5j9u6Huyww: calls $0.15
dtZ84flFEi4Q+SGrHMJRDQ: checks 
*** FLOP *** [9h 2c 4d]
DiSvPC2iudwL5j9u6Huyww: checks 
dtZ84flFEi4Q+SGrHMJRDQ: checks 
b9UnopCOpq2MWP1DwqSO3Q: checks 
PFNLAvMkr8qKc7xCiH0wTA: bets $0.75
DiSvPC2iudwL5j9u6Huyww: folds 
dtZ84flFEi4Q+SGrHMJRDQ: folds 
b9UnopCOpq2MWP1DwqSO3Q: folds 
Uncalled bet ($0.75) returned to PFNLAvMkr8qKc7xCiH0wTA
PFNLAvMkr8qKc7xCiH0wTA collected $0.95 from pot
PFNLAvMkr8qKc7xCiH0wTA: doesn't show hand 
*** SUMMARY ***
Total pot $1 | Rake $0.05 
Board [9h 2c 4d]
Seat 1: XMSS6mD5B42I8wasdOMipQ folded before Flop (didn't bet)
Seat 2: b9UnopCOpq2MWP1DwqSO3Q folded on the Flop
Seat 3: IGbD5vKNhHe60dkdbjg/mw folded before Flop (didn't bet)
Seat 5: PFNLAvMkr8qKc7xCiH0wTA collected ($0.95)
Seat 6: QEbIGci+itdw+re8RM5fZA (button) folded before Flop (didn't bet)
Seat 7: DiSvPC2iudwL5j9u6Huyww (small blind) folded on the Flop
Seat 8: dtZ84flFEi4Q+SGrHMJRDQ (big blind) folded on the Flop
Seat 9: iZmSlSzYu5fJ67tDdQzymQ folded before Flop (didn't bet)




PokerStars Game #59941777012:  Hold'em No Limit ($0.10/$0.25) - 2009/07/01 1:45:49 ET
Table 'Pz8SfAzhP5nvWTsJRAxoDg' 6-max Seat #5 is the button
Seat 1: QiL+lEgEWwy21jk/ltaRLg ($47.50 in chips) 
Seat 3: mfrkWA3PTeYPkbO6hi98Aw ($24.60 in chips) 
Seat 4: 4lJto+Qj0K4JrFKvHaPTLw ($67.05 in chips) 
Seat 5: FYepjhAvF8ZdVCmqHIy+eQ ($28.05 in chips) 
Seat 6: QvTX2yGq3uKJiKPmns4TKQ ($26.80 in chips) 
QvTX2yGq3uKJiKPmns4TKQ: posts small blind $0.10
QiL+lEgEWwy21jk/ltaRLg: posts big blind $0.25
k021eD5in2AjaloW5PalMg: sits out 
*** HOLE CARDS ***
mfrkWA3PTeYPkbO6hi98Aw: folds 
4lJto+Qj0K4JrFKvHaPTLw: raises $0.75 to $1
FYepjhAvF8ZdVCmqHIy+eQ: folds 
QvTX2yGq3uKJiKPmns4TKQ: folds 
QiL+lEgEWwy21jk/ltaRLg: folds 
Uncalled bet ($0.75) returned to 4lJto+Qj0K4JrFKvHaPTLw
4lJto+Qj0K4JrFKvHaPTLw collected $0.60 from pot
4lJto+Qj0K4JrFKvHaPTLw: doesn't show hand 
*** SUMMARY ***
Total pot $0.60 | Rake $0 
Seat 1: QiL+lEgEWwy21jk/ltaRLg (big blind) folded before Flop
Seat 3: mfrkWA3PTeYPkbO6hi98Aw folded before Flop (didn't bet)
Seat 4: 4lJto+Qj0K4JrFKvHaPTLw collected ($0.60)
Seat 5: FYepjhAvF8ZdVCmqHIy+eQ (button) folded before Flop (didn't bet)
Seat 6: QvTX2yGq3uKJiKPmns4TKQ (small blind) folded before Flop




PokerStars Game #59941777656:  Hold'em No Limit ($0.10/$0.25) - 2009/07/01 1:45:50 ET
Table 'wixGE3Zge1qBdnpWijIl/w' 9-max Seat #6 is the button
Seat 1: 4GJMmHGKzu+gVtalqRy7dA ($19.10 in chips) 
Seat 2: DnDcAdn9P0zGovMERigpFA ($79.60 in chips) 
Seat 3: Bb42QRQMhg5/Y0vHP8/2Xw ($25 in chips) 
Seat 5: H5Se03ZqSX7tbULXur2MAg ($23.70 in chips) 
Seat 6: AP/rNvbsacTb4XtaAgKPiQ ($20.70 in chips) 
Seat 7: mMd8CDS/but3UC+Zp7Up2w ($20.80 in chips) 
Seat 8: ShCS62CJp4MKfKLKvGKQbA ($15.15 in chips) 
Seat 9: r6hsffOo1iKmaPYKwAZmFw ($29.15 in chips) 
mMd8CDS/but3UC+Zp7Up2w: posts small blind $0.10
ShCS62CJp4MKfKLKvGKQbA: posts big blind $0.25
X6+pSIPfovPcE87t+LmUKQ: sits out 
*** HOLE CARDS ***
r6hsffOo1iKmaPYKwAZmFw: folds 
4GJMmHGKzu+gVtalqRy7dA: raises $0.75 to $1
DnDcAdn9P0zGovMERigpFA: calls $1
Bb42QRQMhg5/Y0vHP8/2Xw: folds 
H5Se03ZqSX7tbULXur2MAg: calls $1
AP/rNvbsacTb4XtaAgKPiQ: calls $1
mMd8CDS/but3UC+Zp7Up2w: folds 
ShCS62CJp4MKfKLKvGKQbA: folds 
*** FLOP *** [Kd 6h 3d]
4GJMmHGKzu+gVtalqRy7dA: bets $1.50
DnDcAdn9P0zGovMERigpFA: folds 
H5Se03ZqSX7tbULXur2MAg: folds 
AP/rNvbsacTb4XtaAgKPiQ: calls $1.50
*** TURN *** [Kd 6h 3d] [Jh]
4GJMmHGKzu+gVtalqRy7dA: bets $1
AP/rNvbsacTb4XtaAgKPiQ: raises $3 to $4
4GJMmHGKzu+gVtalqRy7dA: calls $3
*** RIVER *** [Kd 6h 3d Jh] [2c]
4GJMmHGKzu+gVtalqRy7dA: checks 
AP/rNvbsacTb4XtaAgKPiQ: checks 
*** SHOW DOWN ***
4GJMmHGKzu+gVtalqRy7dA: shows [Ah Kc] (a pair of Kings)
AP/rNvbsacTb4XtaAgKPiQ: mucks hand 
4GJMmHGKzu+gVtalqRy7dA collected $14.60 from pot
*** SUMMARY ***
Total pot $15.35 | Rake $0.75 
Board [Kd 6h 3d Jh 2c]
Seat 1: 4GJMmHGKzu+gVtalqRy7dA showed [Ah Kc] and won ($14.60) with a pair of Kings
Seat 2: DnDcAdn9P0zGovMERigpFA folded on the Flop
Seat 3: Bb42QRQMhg5/Y0vHP8/2Xw folded before Flop (didn't bet)
Seat 5: H5Se03ZqSX7tbULXur2MAg folded on the Flop
Seat 6: AP/rNvbsacTb4XtaAgKPiQ (button) mucked
Seat 7: mMd8CDS/but3UC+Zp7Up2w (small blind) folded before Flop
Seat 8: ShCS62CJp4MKfKLKvGKQbA (big blind) folded before Flop
Seat 9: r6hsffOo1iKmaPYKwAZmFw folded before Flop (didn't bet)




PokerStars Game #59941777670:  Hold'em No Limit ($0.10/$0.25) - 2009/07/01 1:45:50 ET
Table '6aL2C8IFwHHr6SG6RgXaow' 9-max Seat #4 is the button
Seat 1: bXpVeaSTPBFSPJmeXxO7nw ($4.65 in chips) 
Seat 3: clJsV3v77RS07bDKY+705w ($5 in chips) 
Seat 4: BT6Oal0iO4P6kDuT7HFQDw ($18.25 in chips) 
Seat 5: wre31HfyzQGpIvID1istxw ($21.30 in chips) 
Seat 6: gehe91e0IyVT0QU/XBkEyg ($27.10 in chips) 
Seat 7: QJxYAPJ6uPZZcpdN+RvWcQ ($25 in chips) 
Seat 8: rQhYIYXSyH/IivYM1dlV5A ($22.45 in chips) 
Seat 9: CgIo2ItZqi4o3ayVG6HanQ ($24 in chips) 
wre31HfyzQGpIvID1istxw: posts small blind $0.10
gehe91e0IyVT0QU/XBkEyg: posts big blind $0.25
clJsV3v77RS07bDKY+705w: posts big blind $0.25
*** HOLE CARDS ***
QJxYAPJ6uPZZcpdN+RvWcQ: folds 
rQhYIYXSyH/IivYM1dlV5A: folds 
CgIo2ItZqi4o3ayVG6HanQ: calls $0.25
bXpVeaSTPBFSPJmeXxO7nw: raises $4.40 to $4.65 and is all-in
clJsV3v77RS07bDKY+705w: folds 
BT6Oal0iO4P6kDuT7HFQDw: folds 
wre31HfyzQGpIvID1istxw: folds 
gehe91e0IyVT0QU/XBkEyg: folds 
CgIo2ItZqi4o3ayVG6HanQ: folds 
Uncalled bet ($4.40) returned to bXpVeaSTPBFSPJmeXxO7nw
bXpVeaSTPBFSPJmeXxO7nw collected $1.10 from pot
bXpVeaSTPBFSPJmeXxO7nw: doesn't show hand 
*** SUMMARY ***
Total pot $1.10 | Rake $0 
Seat 1: bXpVeaSTPBFSPJmeXxO7nw collected ($1.10)
Seat 3: clJsV3v77RS07bDKY+705w folded before Flop
Seat 4: BT6Oal0iO4P6kDuT7HFQDw (button) folded before Flop (didn't bet)
Seat 5: wre31HfyzQGpIvID1istxw (small blind) folded before Flop
Seat 6: gehe91e0IyVT0QU/XBkEyg (big blind) folded before Flop
Seat 7: QJxYAPJ6uPZZcpdN+RvWcQ folded before Flop (didn't bet)
Seat 8: rQhYIYXSyH/IivYM1dlV5A folded before Flop (didn't bet)
Seat 9: CgIo2ItZqi4o3ayVG6HanQ folded before Flop




PokerStars Game #59941777724:  Hold'em No Limit ($0.10/$0.25) - 2009/07/01 1:45:50 ET
Table '/JJyyIstHfkT7t/bW+WXgg' 6-max Seat #6 is the button
Seat 2: obJgSnVgWWWaAUtVILo77Q ($17.75 in chips) 
Seat 3: DR0nVIhVP77oEBlO9J8vlg ($37.10 in chips) 
Seat 4: JFIAqU8lCZ0vWwEl4bdGsg ($35.05 in chips) 
Seat 5: +ZlnqPoP3Hg4BIUxDfKd/A ($47.05 in chips) 
Seat 6: UmcUp27+PbgBItv3ZNlAWQ ($25 in chips) 
obJgSnVgWWWaAUtVILo77Q: posts small blind $0.10
DR0nVIhVP77oEBlO9J8vlg: posts big blind $0.25
*** HOLE CARDS ***
wsP46AGpqDjHZQmlRHKa9g leaves the table
JFIAqU8lCZ0vWwEl4bdGsg: raises $0.60 to $0.85
+ZlnqPoP3Hg4BIUxDfKd/A: calls $0.85
UmcUp27+PbgBItv3ZNlAWQ: folds 
obJgSnVgWWWaAUtVILo77Q: folds 
xC0kaiDYM6YTlgODL83O5A joins the table at seat #1 
DR0nVIhVP77oEBlO9J8vlg: folds 
*** FLOP *** [6d Ah Tc]
JFIAqU8lCZ0vWwEl4bdGsg: bets $2
+ZlnqPoP3Hg4BIUxDfKd/A: folds 
Uncalled bet ($2) returned to JFIAqU8lCZ0vWwEl4bdGsg
JFIAqU8lCZ0vWwEl4bdGsg collected $1.95 from pot
JFIAqU8lCZ0vWwEl4bdGsg: doesn't show hand 
*** SUMMARY ***
Total pot $2.05 | Rake $0.10 
Board [6d Ah Tc]
Seat 2: obJgSnVgWWWaAUtVILo77Q (small blind) folded before Flop
Seat 3: DR0nVIhVP77oEBlO9J8vlg (big blind) folded before Flop
Seat 4: JFIAqU8lCZ0vWwEl4bdGsg collected ($1.95)
Seat 5: +ZlnqPoP3Hg4BIUxDfKd/A folded on the Flop
Seat 6: UmcUp27+PbgBItv3ZNlAWQ (button) folded before Flop (didn't bet)




PokerStars Game #59941777558:  Hold'em No Limit ($0.10/$0.25) - 2009/07/01 1:45:50 ET
Table 'nXVbUw6/HYwA6x21+IZ3XQ' 9-max Seat #2 is the button
Seat 1: zDrucyjVn5aeekNEc3cJrA ($17.10 in chips) 
Seat 2: 9lvO/qyU+xrU95Teu1fv0g ($10.25 in chips) 
Seat 3: MB0wa15P+9QHcBApEdgQFw ($9.75 in chips) 
Seat 4: SpiiQQAzy4MUgV3I5W8giw ($25 in chips) 
Seat 5: M/9j4wkHH9i1JM51vgi1VA ($33.70 in chips) 
Seat 6: ljemhp25Zg+nlA9DLCIiUw ($27.20 in chips) 
Seat 7: ShCS62CJp4MKfKLKvGKQbA ($10.90 in chips) 
Seat 8: dfNim92Z6XK1/h5SFW5vDg ($25 in chips) 
Seat 9: OTCjTlu92MEBtX/i9Gm7yA ($9.70 in chips) 
MB0wa15P+9QHcBApEdgQFw: posts small blind $0.10
SpiiQQAzy4MUgV3I5W8giw: posts big blind $0.25
zDrucyjVn5aeekNEc3cJrA: posts small & big blinds $0.35
*** HOLE CARDS ***
M/9j4wkHH9i1JM51vgi1VA: folds 
ljemhp25Zg+nlA9DLCIiUw: folds 
ShCS62CJp4MKfKLKvGKQbA: raises $0.75 to $1
dfNim92Z6XK1/h5SFW5vDg: folds 
OTCjTlu92MEBtX/i9Gm7yA: folds 
zDrucyjVn5aeekNEc3cJrA: folds 
9lvO/qyU+xrU95Teu1fv0g: folds 
MB0wa15P+9QHcBApEdgQFw: folds 
SpiiQQAzy4MUgV3I5W8giw: folds 
Uncalled bet ($0.75) returned to ShCS62CJp4MKfKLKvGKQbA
ShCS62CJp4MKfKLKvGKQbA collected $0.95 from pot
*** SUMMARY ***
Total pot $0.95 | Rake $0 
Seat 1: zDrucyjVn5aeekNEc3cJrA folded before Flop
Seat 2: 9lvO/qyU+xrU95Teu1fv0g (button) folded before Flop (didn't bet)
Seat 3: MB0wa15P+9QHcBApEdgQFw (small blind) folded before Flop
Seat 4: SpiiQQAzy4MUgV3I5W8giw (big blind) folded before Flop
Seat 5: M/9j4wkHH9i1JM51vgi1VA folded before Flop (didn't bet)
Seat 6: ljemhp25Zg+nlA9DLCIiUw folded before Flop (didn't bet)
Seat 7: ShCS62CJp4MKfKLKvGKQbA collected ($0.95)
Seat 8: dfNim92Z6XK1/h5SFW5vDg folded before Flop (didn't bet)
Seat 9: OTCjTlu92MEBtX/i9Gm7yA folded before Flop (didn't bet)




PokerStars Game #59941777744:  Hold'em No Limit ($0.10/$0.25) - 2009/07/01 1:45:50 ET
Table 'WjNvuuSgTjm8jh0j9vcCgQ' 9-max Seat #9 is the button
Seat 1: q+Qdg0Hoir+SyL7haBrUnw ($7.80 in chips) 
Seat 2: ghNKXUBl/H+t83JF079ZBA ($23.40 in chips) 
Seat 3: pSKReiGBNW9NsF2jAZnlwg ($22.35 in chips) 
Seat 4: X78b5v/uhqeXXoAijbw/yg ($31.35 in chips) 
Seat 5: ziFpkH3wCzqB/qXeq/Hy7g ($25 in chips) 
Seat 6: ubsjZomMWSV0hAiBLa7K1A ($21.25 in chips) 
Seat 7: NSX8YOj+RznxoL+rO1YU4w ($17.65 in chips) 
Seat 8: hZuGwtYmFKPmQ+v1wlmdfA ($17.40 in chips) 
Seat 9: CT7Xj/V/O5rBlhtt+RZeFQ ($25.25 in chips) 
q+Qdg0Hoir+SyL7haBrUnw: posts small blind $0.10
ghNKXUBl/H+t83JF079ZBA: posts big blind $0.25
*** HOLE CARDS ***
pSKReiGBNW9NsF2jAZnlwg: folds 
X78b5v/uhqeXXoAijbw/yg: folds 
ziFpkH3wCzqB/qXeq/Hy7g: folds 
ubsjZomMWSV0hAiBLa7K1A: raises $0.50 to $0.75
NSX8YOj+RznxoL+rO1YU4w: folds 
hZuGwtYmFKPmQ+v1wlmdfA: folds 
CT7Xj/V/O5rBlhtt+RZeFQ: folds 
q+Qdg0Hoir+SyL7haBrUnw: folds 
ghNKXUBl/H+t83JF079ZBA: folds 
Uncalled bet ($0.50) returned to ubsjZomMWSV0hAiBLa7K1A
ubsjZomMWSV0hAiBLa7K1A collected $0.60 from pot
ubsjZomMWSV0hAiBLa7K1A: doesn't show hand 
*** SUMMARY ***
Total pot $0.60 | Rake $0 
Seat 1: q+Qdg0Hoir+SyL7haBrUnw (small blind) folded before Flop
Seat 2: ghNKXUBl/H+t83JF079ZBA (big blind) folded before Flop
Seat 3: pSKReiGBNW9NsF2jAZnlwg folded before Flop (didn't bet)
Seat 4: X78b5v/uhqeXXoAijbw/yg folded before Flop (didn't bet)
Seat 5: ziFpkH3wCzqB/qXeq/Hy7g folded before Flop (didn't bet)
Seat 6: ubsjZomMWSV0hAiBLa7K1A collected ($0.60)
Seat 7: NSX8YOj+RznxoL+rO1YU4w folded before Flop (didn't bet)
Seat 8: hZuGwtYmFKPmQ+v1wlmdfA folded before Flop (didn't bet)
Seat 9: CT7Xj/V/O5rBlhtt+RZeFQ (button) folded before Flop (didn't bet)




PokerStars Game #59941777308:  Hold'em No Limit ($0.10/$0.25) - 2009/07/01 1:45:50 ET
Table 'IdXp6nyeW4FYaEK4qKCnwQ' 9-max Seat #3 is the button
Seat 1: tLcDklc2rBORNfixyRfVfw ($25 in chips) 
Seat 2: HPEB+AtKw1+C/cxU0o1ciw ($30.85 in chips) 
Seat 3: eK8qa6EPcH2zhtbmWSvc9g ($33.05 in chips) 
Seat 4: j4q3p0lesp63b1gZDwLBZw ($5.45 in chips) 
Seat 5: U41wNf6XauAiBOQaKu2ZIA ($23.15 in chips) 
Seat 6: arxNSjreDRGFg13EAM2F1w ($30.05 in chips) 
Seat 7: w1ukf8uPa4+WH561TtVRxA ($37 in chips) 
Seat 8: dtZ84flFEi4Q+SGrHMJRDQ ($31.10 in chips) 
Seat 9: s2xLPOl/vhl/26apJ3vsOQ ($28.90 in chips) 
j4q3p0lesp63b1gZDwLBZw: posts small blind $0.10
U41wNf6XauAiBOQaKu2ZIA: posts big blind $0.25
*** HOLE CARDS ***
arxNSjreDRGFg13EAM2F1w: folds 
w1ukf8uPa4+WH561TtVRxA: folds 
dtZ84flFEi4Q+SGrHMJRDQ: folds 
s2xLPOl/vhl/26apJ3vsOQ: raises $0.75 to $1
tLcDklc2rBORNfixyRfVfw: folds 
HPEB+AtKw1+C/cxU0o1ciw: folds 
eK8qa6EPcH2zhtbmWSvc9g: folds 
j4q3p0lesp63b1gZDwLBZw: folds 
U41wNf6XauAiBOQaKu2ZIA: folds 
Uncalled bet ($0.75) returned to s2xLPOl/vhl/26apJ3vsOQ
s2xLPOl/vhl/26apJ3vsOQ collected $0.60 from pot
*** SUMMARY ***
Total pot $0.60 | Rake $0 
Seat 1: tLcDklc2rBORNfixyRfVfw folded before Flop (didn't bet)
Seat 2: HPEB+AtKw1+C/cxU0o1ciw folded before Flop (didn't bet)
Seat 3: eK8qa6EPcH2zhtbmWSvc9g (button) folded before Flop (didn't bet)
Seat 4: j4q3p0lesp63b1gZDwLBZw (small blind) folded before Flop
Seat 5: U41wNf6XauAiBOQaKu2ZIA (big blind) folded before Flop
Seat 6: arxNSjreDRGFg13EAM2F1w folded before Flop (didn't bet)
Seat 7: w1ukf8uPa4+WH561TtVRxA folded before Flop (didn't bet)
Seat 8: dtZ84flFEi4Q+SGrHMJRDQ folded before Flop (didn't bet)
Seat 9: s2xLPOl/vhl/26apJ3vsOQ collected ($0.60)




PokerStars Game #59941777476:  Hold'em No Limit ($0.10/$0.25) - 2009/07/01 1:45:50 ET
Table 'eOXPe2c6mG7DOFKvMsZZfA' 6-max Seat #2 is the button
Seat 1: s21kVGMLPAoHdWR+muSonw ($26.50 in chips) 
Seat 2: gaPMxLGp9SOj4Lq6t+/0Ig ($7.10 in chips) 
Seat 3: kReyZ6g6Fu3tQ0nyjDf9kA ($25.60 in chips) 
Seat 4: zHHLkD2sRljslKKeQv/ZQw ($35.35 in chips) 
Seat 5: NhUN/JpAprdJeamFBgJH1w ($32.30 in chips) 
Seat 6: Qpv/hb5ak7LeaDig1L5L8w ($13.60 in chips) 
kReyZ6g6Fu3tQ0nyjDf9kA: posts small blind $0.10
zHHLkD2sRljslKKeQv/ZQw: posts big blind $0.25
*** HOLE CARDS ***
NhUN/JpAprdJeamFBgJH1w: folds 
Qpv/hb5ak7LeaDig1L5L8w: folds 
s21kVGMLPAoHdWR+muSonw: calls $0.25
gaPMxLGp9SOj4Lq6t+/0Ig: folds 
kReyZ6g6Fu3tQ0nyjDf9kA: calls $0.15
zHHLkD2sRljslKKeQv/ZQw: checks 
*** FLOP *** [Td 5c 6s]
kReyZ6g6Fu3tQ0nyjDf9kA: checks 
zHHLkD2sRljslKKeQv/ZQw: bets $0.75
s21kVGMLPAoHdWR+muSonw: folds 
kReyZ6g6Fu3tQ0nyjDf9kA: folds 
Uncalled bet ($0.75) returned to zHHLkD2sRljslKKeQv/ZQw
zHHLkD2sRljslKKeQv/ZQw collected $0.75 from pot
*** SUMMARY ***
Total pot $0.75 | Rake $0 
Board [Td 5c 6s]
Seat 1: s21kVGMLPAoHdWR+muSonw folded on the Flop
Seat 2: gaPMxLGp9SOj4Lq6t+/0Ig (button) folded before Flop (didn't bet)
Seat 3: kReyZ6g6Fu3tQ0nyjDf9kA (small blind) folded on the Flop
Seat 4: zHHLkD2sRljslKKeQv/ZQw (big blind) collected ($0.75)
Seat 5: NhUN/JpAprdJeamFBgJH1w folded before Flop (didn't bet)
Seat 6: Qpv/hb5ak7LeaDig1L5L8w folded before Flop (didn't bet)




PokerStars Game #59941777512:  Hold'em No Limit ($0.10/$0.25) - 2009/07/01 1:45:50 ET
Table '+198VWQSWBhYQOcizzuBkw' 6-max Seat #5 is the button
Seat 1: 34ttqW62uIRrqINCCmLcsw ($15.25 in chips) 
Seat 2: iauW7L/+7qzAuHow7CD75Q ($10.70 in chips) 
Seat 3: vw7gefupgmOJJN8lUemdWg ($24.05 in chips) 
Seat 4: TgDsTeCdLQt8kWbL00ByRA ($14.75 in chips) 
Seat 5: LtASJ9OlkqGrrUKGQlpGAw ($25.35 in chips) 
Seat 6: leEQ84f6wJYu5SB/vj27wg ($2.65 in chips) 
leEQ84f6wJYu5SB/vj27wg: posts small blind $0.10
34ttqW62uIRrqINCCmLcsw: posts big blind $0.25
*** HOLE CARDS ***
iauW7L/+7qzAuHow7CD75Q: folds 
vw7gefupgmOJJN8lUemdWg: raises $0.25 to $0.50
TgDsTeCdLQt8kWbL00ByRA: folds 
LtASJ9OlkqGrrUKGQlpGAw: folds 
leEQ84f6wJYu5SB/vj27wg: calls $0.40
34ttqW62uIRrqINCCmLcsw said, "lol"
34ttqW62uIRrqINCCmLcsw: folds 
*** FLOP *** [6d Ts Ad]
leEQ84f6wJYu5SB/vj27wg: checks 
34ttqW62uIRrqINCCmLcsw said, ":)"
vw7gefupgmOJJN8lUemdWg: bets $0.50
leEQ84f6wJYu5SB/vj27wg: calls $0.50
*** TURN *** [6d Ts Ad] [3d]
leEQ84f6wJYu5SB/vj27wg: checks 
vw7gefupgmOJJN8lUemdWg: checks 
*** RIVER *** [6d Ts Ad 3d] [7h]
leEQ84f6wJYu5SB/vj27wg: checks 
vw7gefupgmOJJN8lUemdWg: checks 
*** SHOW DOWN ***
leEQ84f6wJYu5SB/vj27wg: shows [Jh Kd] (high card Ace)
vw7gefupgmOJJN8lUemdWg: mucks hand 
leEQ84f6wJYu5SB/vj27wg collected $2.15 from pot
*** SUMMARY ***
Total pot $2.25 | Rake $0.10 
Board [6d Ts Ad 3d 7h]
Seat 1: 34ttqW62uIRrqINCCmLcsw (big blind) folded before Flop
Seat 2: iauW7L/+7qzAuHow7CD75Q folded before Flop (didn't bet)
Seat 3: vw7gefupgmOJJN8lUemdWg mucked
Seat 4: TgDsTeCdLQt8kWbL00ByRA folded before Flop (didn't bet)
Seat 5: LtASJ9OlkqGrrUKGQlpGAw (button) folded before Flop (didn't bet)
Seat 6: leEQ84f6wJYu5SB/vj27wg (small blind) showed [Jh Kd] and won ($2.15) with high card Ace




PokerStars Game #59941777526:  Hold'em No Limit ($0.10/$0.25) - 2009/07/01 1:45:50 ET
Table 'Mef6A0EMopL6WaFO5/KO9g' 6-max Seat #6 is the button
Seat 1: GbCVUNssQ7mqsPWr7J4d3w ($4.40 in chips) 
Seat 2: 8ClCHtFXGNplITm+63KB+Q ($29.90 in chips) 
Seat 3: Wq26opBLDGJe91GRJn2epg ($18.20 in chips) 
Seat 4: lquriepNQBhDV5P1SWHhnA ($25 in chips) 
Seat 5: DihMHaz4WNETH1bPDe13kA ($25 in chips) 
Seat 6: jp34e617tIzV8tKIWmfAbA ($33.30 in chips) 
GbCVUNssQ7mqsPWr7J4d3w: posts small blind $0.10
8ClCHtFXGNplITm+63KB+Q: posts big blind $0.25
*** HOLE CARDS ***
Wq26opBLDGJe91GRJn2epg: folds 
lquriepNQBhDV5P1SWHhnA: folds 
DihMHaz4WNETH1bPDe13kA: folds 
jp34e617tIzV8tKIWmfAbA: folds 
GbCVUNssQ7mqsPWr7J4d3w: folds 
Uncalled bet ($0.15) returned to 8ClCHtFXGNplITm+63KB+Q
8ClCHtFXGNplITm+63KB+Q collected $0.20 from pot
8ClCHtFXGNplITm+63KB+Q: doesn't show hand 
*** SUMMARY ***
Total pot $0.20 | Rake $0 
Seat 1: GbCVUNssQ7mqsPWr7J4d3w (small blind) folded before Flop
Seat 2: 8ClCHtFXGNplITm+63KB+Q (big blind) collected ($0.20)
Seat 3: Wq26opBLDGJe91GRJn2epg folded before Flop (didn't bet)
Seat 4: lquriepNQBhDV5P1SWHhnA folded before Flop (didn't bet)
Seat 5: DihMHaz4WNETH1bPDe13kA folded before Flop (didn't bet)
Seat 6: jp34e617tIzV8tKIWmfAbA (button) folded before Flop (didn't bet)




PokerStars Game #59941778118:  Hold'em No Limit ($0.10/$0.25) - 2009/07/01 1:45:51 ET
Table '4ZbiE0ZYjzqmgu6+sO1prg' 9-max Seat #4 is the button
Seat 1: eXiRSFoUjkV5taBc4N8rMQ ($9.10 in chips) 
Seat 2: 9lvO/qyU+xrU95Teu1fv0g ($5.20 in chips) 
Seat 3: HPEB+AtKw1+C/cxU0o1ciw ($25.20 in chips) 
Seat 4: w1ukf8uPa4+WH561TtVRxA ($25.25 in chips) 
Seat 5: +2kMBNpY4nF1qNCRd8SJLA ($43.70 in chips) 
Seat 7: aNpwfA31EREwO+ar4XzBCw ($26.30 in chips) 
Seat 8: cZ99hugmLBj9KhTlc8nCSw ($29.60 in chips) 
Seat 9: RCqMONFrSPSArZh2Jsar/w ($20.35 in chips) 
+2kMBNpY4nF1qNCRd8SJLA: posts small blind $0.10
aNpwfA31EREwO+ar4XzBCw: posts big blind $0.25
*** HOLE CARDS ***
cZ99hugmLBj9KhTlc8nCSw: folds 
RCqMONFrSPSArZh2Jsar/w: folds 
eXiRSFoUjkV5taBc4N8rMQ: calls $0.25
9lvO/qyU+xrU95Teu1fv0g: folds 
HPEB+AtKw1+C/cxU0o1ciw: folds 
w1ukf8uPa4+WH561TtVRxA: folds 
+2kMBNpY4nF1qNCRd8SJLA: folds 
aNpwfA31EREwO+ar4XzBCw: checks 
*** FLOP *** [As Ah Jd]
aNpwfA31EREwO+ar4XzBCw: checks 
eXiRSFoUjkV5taBc4N8rMQ: checks 
*** TURN *** [As Ah Jd] [Jc]
aNpwfA31EREwO+ar4XzBCw: checks 
eXiRSFoUjkV5taBc4N8rMQ: checks 
*** RIVER *** [As Ah Jd Jc] [Ac]
aNpwfA31EREwO+ar4XzBCw: checks 
eXiRSFoUjkV5taBc4N8rMQ: bets $0.75
aNpwfA31EREwO+ar4XzBCw: folds 
Uncalled bet ($0.75) returned to eXiRSFoUjkV5taBc4N8rMQ
eXiRSFoUjkV5taBc4N8rMQ collected $0.60 from pot
eXiRSFoUjkV5taBc4N8rMQ: shows [Qs 2s] (a full house, Aces full of Jacks)
*** SUMMARY ***
Total pot $0.60 | Rake $0 
Board [As Ah Jd Jc Ac]
Seat 1: eXiRSFoUjkV5taBc4N8rMQ collected ($0.60)
Seat 2: 9lvO/qyU+xrU95Teu1fv0g folded before Flop (didn't bet)
Seat 3: HPEB+AtKw1+C/cxU0o1ciw folded before Flop (didn't bet)
Seat 4: w1ukf8uPa4+WH561TtVRxA (button) folded before Flop (didn't bet)
Seat 5: +2kMBNpY4nF1qNCRd8SJLA (small blind) folded before Flop
Seat 7: aNpwfA31EREwO+ar4XzBCw (big blind) folded on the River
Seat 8: cZ99hugmLBj9KhTlc8nCSw folded before Flop (didn't bet)
Seat 9: RCqMONFrSPSArZh2Jsar/w folded before Flop (didn't bet)




PokerStars Game #59941777908:  Hold'em No Limit ($0.10/$0.25) - 2009/07/01 1:45:51 ET
Table 'tANpk8z1C5o0Pq/hpYShHw' 9-max Seat #5 is the button
Seat 1: rQhYIYXSyH/IivYM1dlV5A ($16.90 in chips) 
Seat 2: og4yH4sZUZdC8jjgW8zPJQ ($8.60 in chips) 
Seat 3: zDrucyjVn5aeekNEc3cJrA ($18.05 in chips) 
Seat 4: j4q3p0lesp63b1gZDwLBZw ($5 in chips) 
Seat 5: X6+pSIPfovPcE87t+LmUKQ ($8.55 in chips) 
Seat 6: kN0AWJG6biW8tHtuF+wTjA ($10.55 in chips) 
Seat 7: aNpwfA31EREwO+ar4XzBCw ($27.30 in chips) 
Seat 9: gE5rN2TDY1aXcZn/TOPeZw ($7.95 in chips) 
kN0AWJG6biW8tHtuF+wTjA: posts small blind $0.10
aNpwfA31EREwO+ar4XzBCw: posts big blind $0.25
Z9W7+g1WMhhZDi7DwGbCFA: sits out 
zDrucyjVn5aeekNEc3cJrA: posts small & big blinds $0.35
*** HOLE CARDS ***
gE5rN2TDY1aXcZn/TOPeZw: folds 
rQhYIYXSyH/IivYM1dlV5A: folds 
og4yH4sZUZdC8jjgW8zPJQ: folds 
zDrucyjVn5aeekNEc3cJrA: checks 
j4q3p0lesp63b1gZDwLBZw: folds 
X6+pSIPfovPcE87t+LmUKQ: folds 
kN0AWJG6biW8tHtuF+wTjA: calls $0.15
aNpwfA31EREwO+ar4XzBCw: checks 
*** FLOP *** [4s 7d Kd]
kN0AWJG6biW8tHtuF+wTjA: checks 
aNpwfA31EREwO+ar4XzBCw: checks 
zDrucyjVn5aeekNEc3cJrA: bets $1
kN0AWJG6biW8tHtuF+wTjA: folds 
aNpwfA31EREwO+ar4XzBCw: folds 
Uncalled bet ($1) returned to zDrucyjVn5aeekNEc3cJrA
zDrucyjVn5aeekNEc3cJrA collected $0.85 from pot
*** SUMMARY ***
Total pot $0.85 | Rake $0 
Board [4s 7d Kd]
Seat 1: rQhYIYXSyH/IivYM1dlV5A folded before Flop (didn't bet)
Seat 2: og4yH4sZUZdC8jjgW8zPJQ folded before Flop (didn't bet)
Seat 3: zDrucyjVn5aeekNEc3cJrA collected ($0.85)
Seat 4: j4q3p0lesp63b1gZDwLBZw folded before Flop (didn't bet)
Seat 5: X6+pSIPfovPcE87t+LmUKQ (button) folded before Flop (didn't bet)
Seat 6: kN0AWJG6biW8tHtuF+wTjA (small blind) folded on the Flop
Seat 7: aNpwfA31EREwO+ar4XzBCw (big blind) folded on the Flop
Seat 9: gE5rN2TDY1aXcZn/TOPeZw folded before Flop (didn't bet)




PokerStars Game #59941778060:  Hold'em No Limit ($0.10/$0.25) - 2009/07/01 1:45:51 ET
Table '63uh7ZsO7Tnt+E8b/2bu3A' 6-max Seat #6 is the button
Seat 1: 0av6tRNdi0Ui4f15L7gsVg ($30.30 in chips) 
Seat 2: SFmT9ZsVopnukjvAzrxTRg ($28.35 in chips) 
Seat 3: yVP7GLZBzx47OPi6jzUxMw ($8.45 in chips) 
Seat 5: GbCVUNssQ7mqsPWr7J4d3w ($4.05 in chips) 
Seat 6: qGHGf/553gQnDoklMRe3tg ($30.15 in chips) 
0av6tRNdi0Ui4f15L7gsVg: posts small blind $0.10
SFmT9ZsVopnukjvAzrxTRg: posts big blind $0.25
rnpAao581IcvQglpkpnkoQ: sits out 
*** HOLE CARDS ***
yVP7GLZBzx47OPi6jzUxMw: folds 
GbCVUNssQ7mqsPWr7J4d3w: folds 
qGHGf/553gQnDoklMRe3tg: folds 
0av6tRNdi0Ui4f15L7gsVg: folds 
Uncalled bet ($0.15) returned to SFmT9ZsVopnukjvAzrxTRg
SFmT9ZsVopnukjvAzrxTRg collected $0.20 from pot
SFmT9ZsVopnukjvAzrxTRg: doesn't show hand 
*** SUMMARY ***
Total pot $0.20 | Rake $0 
Seat 1: 0av6tRNdi0Ui4f15L7gsVg (small blind) folded before Flop
Seat 2: SFmT9ZsVopnukjvAzrxTRg (big blind) collected ($0.20)
Seat 3: yVP7GLZBzx47OPi6jzUxMw folded before Flop (didn't bet)
Seat 5: GbCVUNssQ7mqsPWr7J4d3w folded before Flop (didn't bet)
Seat 6: qGHGf/553gQnDoklMRe3tg (button) folded before Flop (didn't bet)




PokerStars Game #59941778334:  Hold'em No Limit ($0.10/$0.25) - 2009/07/01 1:45:52 ET
Table '3lS+sU5k6mwJCS2nFMmQ6Q' 9-max Seat #7 is the button
Seat 1: VWUWpMLMj/Q1jRVpF7Aohw ($13.45 in chips) 
Seat 3: 1DXccE2UUK5DIRVGlOKnTA ($11.95 in chips) 
Seat 4: ydoFOVgzvZv9ZhuWu9rXAw ($10.70 in chips) 
Seat 5: NcPAt5YjVvDFEJTTgAVj8g ($5.50 in chips) 
Seat 6: hJ4uYjNmSZdjrKA8cjZqCA ($35.75 in chips) 
Seat 7: Th3FldXKQW6hWVVPahaoOQ ($31.20 in chips) 
Seat 8: 9lvO/qyU+xrU95Teu1fv0g ($5.35 in chips) 
Seat 9: 4awUyiDYTgylQKXZ9faBVA ($49.20 in chips) 
9lvO/qyU+xrU95Teu1fv0g: posts small blind $0.10
4awUyiDYTgylQKXZ9faBVA: posts big blind $0.25
PdIasPkzm2sqZnN41ZRXOg: sits out 
*** HOLE CARDS ***
VWUWpMLMj/Q1jRVpF7Aohw: folds 
1DXccE2UUK5DIRVGlOKnTA: folds 
ydoFOVgzvZv9ZhuWu9rXAw: folds 
NcPAt5YjVvDFEJTTgAVj8g: folds 
hJ4uYjNmSZdjrKA8cjZqCA: folds 
Th3FldXKQW6hWVVPahaoOQ: raises $0.50 to $0.75
9lvO/qyU+xrU95Teu1fv0g: folds 
4awUyiDYTgylQKXZ9faBVA: folds 
Uncalled bet ($0.50) returned to Th3FldXKQW6hWVVPahaoOQ
Th3FldXKQW6hWVVPahaoOQ collected $0.60 from pot
Th3FldXKQW6hWVVPahaoOQ: doesn't show hand 
*** SUMMARY ***
Total pot $0.60 | Rake $0 
Seat 1: VWUWpMLMj/Q1jRVpF7Aohw folded before Flop (didn't bet)
Seat 3: 1DXccE2UUK5DIRVGlOKnTA folded before Flop (didn't bet)
Seat 4: ydoFOVgzvZv9ZhuWu9rXAw folded before Flop (didn't bet)
Seat 5: NcPAt5YjVvDFEJTTgAVj8g folded before Flop (didn't bet)
Seat 6: hJ4uYjNmSZdjrKA8cjZqCA folded before Flop (didn't bet)
Seat 7: Th3FldXKQW6hWVVPahaoOQ (button) collected ($0.60)
Seat 8: 9lvO/qyU+xrU95Teu1fv0g (small blind) folded before Flop
Seat 9: 4awUyiDYTgylQKXZ9faBVA (big blind) folded before Flop




PokerStars Game #59941778296:  Hold'em No Limit ($0.10/$0.25) - 2009/07/01 1:45:52 ET
Table 'IuqVbFI+pwnJjvwBCGSGAw' 6-max Seat #5 is the button
Seat 1: LyDHtw3/yniNHW+DvLXbog ($26.70 in chips) 
Seat 3: QiL+lEgEWwy21jk/ltaRLg ($21.40 in chips) 
Seat 4: DE9hRlt14g+JdsRQ4wT7hg ($26.35 in chips) 
Seat 5: if4dh6jhJXeN3/qd3qCp9g ($25.35 in chips) 
Seat 6: xC0kaiDYM6YTlgODL83O5A ($14 in chips) 
wsP46AGpqDjHZQmlRHKa9g leaves the table
w43JQj2oYPpKQVG4Yzlq1w joins the table at seat #2 
xC0kaiDYM6YTlgODL83O5A: posts small blind $0.10
LyDHtw3/yniNHW+DvLXbog: posts big blind $0.25
*** HOLE CARDS ***
QiL+lEgEWwy21jk/ltaRLg: folds 
DE9hRlt14g+JdsRQ4wT7hg: raises $0.75 to $1
if4dh6jhJXeN3/qd3qCp9g: folds 
xC0kaiDYM6YTlgODL83O5A: folds 
LyDHtw3/yniNHW+DvLXbog: folds 
Uncalled bet ($0.75) returned to DE9hRlt14g+JdsRQ4wT7hg
DE9hRlt14g+JdsRQ4wT7hg collected $0.60 from pot
DE9hRlt14g+JdsRQ4wT7hg: doesn't show hand 
*** SUMMARY ***
Total pot $0.60 | Rake $0 
Seat 1: LyDHtw3/yniNHW+DvLXbog (big blind) folded before Flop
Seat 3: QiL+lEgEWwy21jk/ltaRLg folded before Flop (didn't bet)
Seat 4: DE9hRlt14g+JdsRQ4wT7hg collected ($0.60)
Seat 5: if4dh6jhJXeN3/qd3qCp9g (button) folded before Flop (didn't bet)
Seat 6: xC0kaiDYM6YTlgODL83O5A (small blind) folded before Flop




PokerStars Game #59941778514:  Hold'em No Limit ($0.10/$0.25) - 2009/07/01 1:45:52 ET
Table 'nc6OeGk/wtaWV+6N+kgnZQ' 6-max Seat #6 is the button
Seat 1: tSR4329m40dZsN7YOpI9Kw ($37 in chips) 
Seat 2: 8ClCHtFXGNplITm+63KB+Q ($34.75 in chips) 
Seat 3: y8wpMWGSX2zHZijurx21mg ($7.10 in chips) 
Seat 4: 3zD3qLXT1bEffAoWGnc7wg ($31.55 in chips) 
Seat 5: HCS0lMAAPmZE2Tl8J/SuKw ($10.60 in chips) 
Seat 6: mFv3iBCtrw9XfCDRB0d46Q ($3.80 in chips) 
tSR4329m40dZsN7YOpI9Kw: posts small blind $0.10
8ClCHtFXGNplITm+63KB+Q: posts big blind $0.25
*** HOLE CARDS ***
y8wpMWGSX2zHZijurx21mg: calls $0.25
3zD3qLXT1bEffAoWGnc7wg: folds 
HCS0lMAAPmZE2Tl8J/SuKw: calls $0.25
mFv3iBCtrw9XfCDRB0d46Q: folds 
tSR4329m40dZsN7YOpI9Kw: folds 
8ClCHtFXGNplITm+63KB+Q: checks 
*** FLOP *** [4c 7d 8h]
8ClCHtFXGNplITm+63KB+Q: checks 
y8wpMWGSX2zHZijurx21mg: checks 
HCS0lMAAPmZE2Tl8J/SuKw: bets $0.50
8ClCHtFXGNplITm+63KB+Q: calls $0.50
y8wpMWGSX2zHZijurx21mg: calls $0.50
*** TURN *** [4c 7d 8h] [7s]
8ClCHtFXGNplITm+63KB+Q: bets $0.50
y8wpMWGSX2zHZijurx21mg: raises $0.50 to $1
HCS0lMAAPmZE2Tl8J/SuKw: folds 
8ClCHtFXGNplITm+63KB+Q: calls $0.50
*** RIVER *** [4c 7d 8h 7s] [3h]
8ClCHtFXGNplITm+63KB+Q: bets $1
y8wpMWGSX2zHZijurx21mg: calls $1
*** SHOW DOWN ***
8ClCHtFXGNplITm+63KB+Q: shows [7h Jc] (three of a kind, Sevens)
y8wpMWGSX2zHZijurx21mg: mucks hand 
8ClCHtFXGNplITm+63KB+Q collected $6.05 from pot
*** SUMMARY ***
Total pot $6.35 | Rake $0.30 
Board [4c 7d 8h 7s 3h]
Seat 1: tSR4329m40dZsN7YOpI9Kw (small blind) folded before Flop
Seat 2: 8ClCHtFXGNplITm+63KB+Q (big blind) showed [7h Jc] and won ($6.05) with three of a kind, Sevens
Seat 3: y8wpMWGSX2zHZijurx21mg mucked
Seat 4: 3zD3qLXT1bEffAoWGnc7wg folded before Flop (didn't bet)
Seat 5: HCS0lMAAPmZE2Tl8J/SuKw folded on the Turn
Seat 6: mFv3iBCtrw9XfCDRB0d46Q (button) folded before Flop (didn't bet)




PokerStars Game #59941778860:  Hold'em No Limit ($0.10/$0.25) - 2009/07/01 1:45:52 ET
Table '+2VxGVfkEqJ1AYfQy/JH2w' 6-max Seat #2 is the button
Seat 1: if4dh6jhJXeN3/qd3qCp9g ($27.90 in chips) 
Seat 2: qllppsCmUqovlriIWCeM/g ($5.15 in chips) 
Seat 3: epAUIB7h2FJXzUPRIvSkRA ($25 in chips) 
Seat 4: y+a/yGW/Jy4bPJFnaeTz5w ($16.60 in chips) 
Seat 5: XD1i5m5PvBDnRzJaG/vINw ($20.60 in chips) 
Seat 6: L3/N/gliETan8N5Gim5h4Q ($25 in chips) 
epAUIB7h2FJXzUPRIvSkRA: posts small blind $0.10
y+a/yGW/Jy4bPJFnaeTz5w: posts big blind $0.25
*** HOLE CARDS ***
XD1i5m5PvBDnRzJaG/vINw: folds 
L3/N/gliETan8N5Gim5h4Q: folds 
if4dh6jhJXeN3/qd3qCp9g: raises $0.50 to $0.75
qllppsCmUqovlriIWCeM/g: folds 
epAUIB7h2FJXzUPRIvSkRA: folds 
y+a/yGW/Jy4bPJFnaeTz5w: folds 
Uncalled bet ($0.50) returned to if4dh6jhJXeN3/qd3qCp9g
L3/N/gliETan8N5Gim5h4Q leaves the table
if4dh6jhJXeN3/qd3qCp9g collected $0.60 from pot
if4dh6jhJXeN3/qd3qCp9g: doesn't show hand 
*** SUMMARY ***
Total pot $0.60 | Rake $0 
Seat 1: if4dh6jhJXeN3/qd3qCp9g collected ($0.60)
Seat 2: qllppsCmUqovlriIWCeM/g (button) folded before Flop (didn't bet)
Seat 3: epAUIB7h2FJXzUPRIvSkRA (small blind) folded before Flop
Seat 4: y+a/yGW/Jy4bPJFnaeTz5w (big blind) folded before Flop
Seat 5: XD1i5m5PvBDnRzJaG/vINw folded before Flop (didn't bet)
Seat 6: L3/N/gliETan8N5Gim5h4Q folded before Flop (didn't bet)




PokerStars Game #59941778600:  Hold'em No Limit ($0.10/$0.25) - 2009/07/01 1:45:52 ET
Table 'a6FCGVBMPcT7J7BDN9q1zQ' 9-max Seat #5 is the button
Seat 2: M2QO2DxB5Wawg2h8HSpnYA ($13.45 in chips) 
Seat 3: tLcDklc2rBORNfixyRfVfw ($25.80 in chips) 
Seat 5: dtZ84flFEi4Q+SGrHMJRDQ ($26.80 in chips) 
Seat 6: dfNim92Z6XK1/h5SFW5vDg ($25 in chips) 
Seat 7: V0Yo5zRBVM8DYspLKafebg ($4.05 in chips) 
Seat 8: r6hsffOo1iKmaPYKwAZmFw ($66.95 in chips) 
Seat 9: wGigCmBR/9XWkPpvYos3aQ ($28.35 in chips) 
dfNim92Z6XK1/h5SFW5vDg: posts small blind $0.10
V0Yo5zRBVM8DYspLKafebg: posts big blind $0.25
bXpVeaSTPBFSPJmeXxO7nw: sits out 
*** HOLE CARDS ***
8EbrQ/EvFWt2cr0GaU82gQ joins the table at seat #4 
r6hsffOo1iKmaPYKwAZmFw: folds 
wGigCmBR/9XWkPpvYos3aQ: folds 
M2QO2DxB5Wawg2h8HSpnYA: folds 
tLcDklc2rBORNfixyRfVfw: raises $0.75 to $1
dtZ84flFEi4Q+SGrHMJRDQ: folds 
dfNim92Z6XK1/h5SFW5vDg: folds 
V0Yo5zRBVM8DYspLKafebg: calls $0.75
*** FLOP *** [9s Ah Kh]
V0Yo5zRBVM8DYspLKafebg: checks 
tLcDklc2rBORNfixyRfVfw: checks 
*** TURN *** [9s Ah Kh] [Qd]
V0Yo5zRBVM8DYspLKafebg: bets $1
tLcDklc2rBORNfixyRfVfw: folds 
Uncalled bet ($1) returned to V0Yo5zRBVM8DYspLKafebg
V0Yo5zRBVM8DYspLKafebg collected $2 from pot
*** SUMMARY ***
Total pot $2.10 | Rake $0.10 
Board [9s Ah Kh Qd]
Seat 2: M2QO2DxB5Wawg2h8HSpnYA folded before Flop (didn't bet)
Seat 3: tLcDklc2rBORNfixyRfVfw folded on the Turn
Seat 5: dtZ84flFEi4Q+SGrHMJRDQ (button) folded before Flop (didn't bet)
Seat 6: dfNim92Z6XK1/h5SFW5vDg (small blind) folded before Flop
Seat 7: V0Yo5zRBVM8DYspLKafebg (big blind) collected ($2)
Seat 8: r6hsffOo1iKmaPYKwAZmFw folded before Flop (didn't bet)
Seat 9: wGigCmBR/9XWkPpvYos3aQ folded before Flop (didn't bet)




PokerStars Game #59941778908:  Hold'em No Limit ($0.10/$0.25) - 2009/07/01 1:45:53 ET
Table 'dVzscin98UhGisTmV9BDcw' 9-max Seat #7 is the button
Seat 1: sBAwXpkpgyhyWbHIQcIJKA ($17.30 in chips) 
Seat 2: dfNim92Z6XK1/h5SFW5vDg ($28 in chips) 
Seat 3: cZ99hugmLBj9KhTlc8nCSw ($25 in chips) 
Seat 4: aNpwfA31EREwO+ar4XzBCw ($42.25 in chips) 
Seat 7: cKlmpQMahVsmOaxFQDcoOg ($24.30 in chips) 
Seat 8: /vn2Qu2dvc9AMMq46Ae0jA ($46.85 in chips) 
Seat 9: arxNSjreDRGFg13EAM2F1w ($25.35 in chips) 
/vn2Qu2dvc9AMMq46Ae0jA: posts small blind $0.10
arxNSjreDRGFg13EAM2F1w: posts big blind $0.25
E0iYnEVO2ho7dH3QcCjw7g: sits out 
A/OkFabqdcrG3ozpiYMiNQ: sits out 
*** HOLE CARDS ***
sBAwXpkpgyhyWbHIQcIJKA: folds 
dfNim92Z6XK1/h5SFW5vDg: raises $0.75 to $1
cZ99hugmLBj9KhTlc8nCSw: folds 
aNpwfA31EREwO+ar4XzBCw: folds 
cKlmpQMahVsmOaxFQDcoOg: folds 
/vn2Qu2dvc9AMMq46Ae0jA: folds 
arxNSjreDRGFg13EAM2F1w: folds 
Uncalled bet ($0.75) returned to dfNim92Z6XK1/h5SFW5vDg
dfNim92Z6XK1/h5SFW5vDg collected $0.60 from pot
dfNim92Z6XK1/h5SFW5vDg: doesn't show hand 
*** SUMMARY ***
Total pot $0.60 | Rake $0 
Seat 1: sBAwXpkpgyhyWbHIQcIJKA folded before Flop (didn't bet)
Seat 2: dfNim92Z6XK1/h5SFW5vDg collected ($0.60)
Seat 3: cZ99hugmLBj9KhTlc8nCSw folded before Flop (didn't bet)
Seat 4: aNpwfA31EREwO+ar4XzBCw folded before Flop (didn't bet)
Seat 7: cKlmpQMahVsmOaxFQDcoOg (button) folded before Flop (didn't bet)
Seat 8: /vn2Qu2dvc9AMMq46Ae0jA (small blind) folded before Flop
Seat 9: arxNSjreDRGFg13EAM2F1w (big blind) folded before Flop




PokerStars Game #59941779050:  Hold'em No Limit ($0.10/$0.25) - 2009/07/01 1:45:53 ET
Table '84TjTrgbsYZladOc4PWf4Q' 6-max Seat #3 is the button
Seat 1: /kW0t5kKllzd8HO2uEapHQ ($20.45 in chips) 
Seat 2: RpaEX9P7BCvyfPRLiRNg0A ($44.80 in chips) 
Seat 3: Ar4vsUIUfJ7gbYh1c1m59g ($10.85 in chips) 
Seat 4: SxIIgwXYLkwd6m3wLyPTCw ($24.75 in chips) 
Seat 5: cezpHJ8FB07dj0xG+LhOvw ($26.85 in chips) 
Seat 6: wCUaomJ6Nq5zomVGdUHP+w ($18.25 in chips) 
SxIIgwXYLkwd6m3wLyPTCw: posts small blind $0.10
cezpHJ8FB07dj0xG+LhOvw: posts big blind $0.25
*** HOLE CARDS ***
wCUaomJ6Nq5zomVGdUHP+w: calls $0.25
/kW0t5kKllzd8HO2uEapHQ: folds 
RpaEX9P7BCvyfPRLiRNg0A: folds 
Ar4vsUIUfJ7gbYh1c1m59g: folds 
SxIIgwXYLkwd6m3wLyPTCw: folds 
cezpHJ8FB07dj0xG+LhOvw: checks 
*** FLOP *** [5h 9h 9d]
cezpHJ8FB07dj0xG+LhOvw: checks 
wCUaomJ6Nq5zomVGdUHP+w: checks 
*** TURN *** [5h 9h 9d] [4h]
cezpHJ8FB07dj0xG+LhOvw: checks 
wCUaomJ6Nq5zomVGdUHP+w: checks 
*** RIVER *** [5h 9h 9d 4h] [Ah]
cezpHJ8FB07dj0xG+LhOvw: checks 
wCUaomJ6Nq5zomVGdUHP+w: checks 
*** SHOW DOWN ***
cezpHJ8FB07dj0xG+LhOvw: shows [6c 8h] (a flush, Ace high)
wCUaomJ6Nq5zomVGdUHP+w: mucks hand 
cezpHJ8FB07dj0xG+LhOvw collected $0.60 from pot
*** SUMMARY ***
Total pot $0.60 | Rake $0 
Board [5h 9h 9d 4h Ah]
Seat 1: /kW0t5kKllzd8HO2uEapHQ folded before Flop (didn't bet)
Seat 2: RpaEX9P7BCvyfPRLiRNg0A folded before Flop (didn't bet)
Seat 3: Ar4vsUIUfJ7gbYh1c1m59g (button) folded before Flop (didn't bet)
Seat 4: SxIIgwXYLkwd6m3wLyPTCw (small blind) folded before Flop
Seat 5: cezpHJ8FB07dj0xG+LhOvw (big blind) showed [6c 8h] and won ($0.60) with a flush, Ace high
Seat 6: wCUaomJ6Nq5zomVGdUHP+w mucked




PokerStars Game #59941779344:  Hold'em No Limit ($0.10/$0.25) - 2009/07/01 1:45:53 ET
Table 'rjcb+nlE+0GuJ6lBhuCkkA' 6-max Seat #6 is the button
Seat 1: lBoEwOFgzcERLIRUkUoRTw ($13.35 in chips) 
Seat 2: lJphax9e7/+O/3YCKPJ0yQ ($7.35 in chips) 
Seat 3: 8ClCHtFXGNplITm+63KB+Q ($65.15 in chips) 
Seat 4: BV+K0Phf5VBHr7aZPKqbUQ ($36.40 in chips) 
Seat 5: GC/9yVD59DUCX7hUI7gcLw ($29 in chips) 
Seat 6: 32YL2ZEp8NT4JB2RVM9euQ ($16.05 in chips) 
lBoEwOFgzcERLIRUkUoRTw: posts small blind $0.10
lJphax9e7/+O/3YCKPJ0yQ: posts big blind $0.25
*** HOLE CARDS ***
8ClCHtFXGNplITm+63KB+Q: folds 
BV+K0Phf5VBHr7aZPKqbUQ: raises $0.50 to $0.75
GC/9yVD59DUCX7hUI7gcLw: folds 
32YL2ZEp8NT4JB2RVM9euQ: folds 
lBoEwOFgzcERLIRUkUoRTw: folds 
lJphax9e7/+O/3YCKPJ0yQ: raises $0.50 to $1.25
BV+K0Phf5VBHr7aZPKqbUQ: calls $0.50
*** FLOP *** [4d 5c 6d]
lJphax9e7/+O/3YCKPJ0yQ: bets $0.75
BV+K0Phf5VBHr7aZPKqbUQ: folds 
Uncalled bet ($0.75) returned to lJphax9e7/+O/3YCKPJ0yQ
lJphax9e7/+O/3YCKPJ0yQ collected $2.50 from pot
*** SUMMARY ***
Total pot $2.60 | Rake $0.10 
Board [4d 5c 6d]
Seat 1: lBoEwOFgzcERLIRUkUoRTw (small blind) folded before Flop
Seat 2: lJphax9e7/+O/3YCKPJ0yQ (big blind) collected ($2.50)
Seat 3: 8ClCHtFXGNplITm+63KB+Q folded before Flop (didn't bet)
Seat 4: BV+K0Phf5VBHr7aZPKqbUQ folded on the Flop
Seat 5: GC/9yVD59DUCX7hUI7gcLw folded before Flop (didn't bet)
Seat 6: 32YL2ZEp8NT4JB2RVM9euQ (button) folded before Flop (didn't bet)




PokerStars Game #59941779078:  Hold'em No Limit ($0.10/$0.25) - 2009/07/01 1:45:53 ET
Table '+VTTYgQLH1awDHk+IAxqGg' 9-max Seat #2 is the button
Seat 1: arxNSjreDRGFg13EAM2F1w ($26.90 in chips) 
Seat 2: 2wcFsZsqEP5w1StUTVzJCg ($5.85 in chips) 
Seat 3: AiXn/9o1EwOPZUHujnh/bA ($11.90 in chips) 
Seat 4: gE5rN2TDY1aXcZn/TOPeZw ($10.65 in chips) 
Seat 5: sD+TKtt36XiiN6jqHiLwDA ($25.15 in chips) 
Seat 7: ljemhp25Zg+nlA9DLCIiUw ($24.25 in chips) 
Seat 8: 10vzP4r6ldwGLbYHKd9www ($17.65 in chips) 
Seat 9: S7Ki0P+0AIGPuIfGJjW0gg ($61 in chips) 
AiXn/9o1EwOPZUHujnh/bA: posts small blind $0.10
gE5rN2TDY1aXcZn/TOPeZw: posts big blind $0.25
*** HOLE CARDS ***
sD+TKtt36XiiN6jqHiLwDA: folds 
ljemhp25Zg+nlA9DLCIiUw: folds 
10vzP4r6ldwGLbYHKd9www: calls $0.25
S7Ki0P+0AIGPuIfGJjW0gg: folds 
arxNSjreDRGFg13EAM2F1w: folds 
2wcFsZsqEP5w1StUTVzJCg: folds 
AiXn/9o1EwOPZUHujnh/bA: calls $0.15
gE5rN2TDY1aXcZn/TOPeZw: checks 
*** FLOP *** [7c Th 3h]
AiXn/9o1EwOPZUHujnh/bA: checks 
gE5rN2TDY1aXcZn/TOPeZw: checks 
10vzP4r6ldwGLbYHKd9www: bets $0.50
AiXn/9o1EwOPZUHujnh/bA: folds 
gE5rN2TDY1aXcZn/TOPeZw: folds 
Uncalled bet ($0.50) returned to 10vzP4r6ldwGLbYHKd9www
10vzP4r6ldwGLbYHKd9www collected $0.75 from pot
*** SUMMARY ***
Total pot $0.75 | Rake $0 
Board [7c Th 3h]
Seat 1: arxNSjreDRGFg13EAM2F1w folded before Flop (didn't bet)
Seat 2: 2wcFsZsqEP5w1StUTVzJCg (button) folded before Flop (didn't bet)
Seat 3: AiXn/9o1EwOPZUHujnh/bA (small blind) folded on the Flop
Seat 4: gE5rN2TDY1aXcZn/TOPeZw (big blind) folded on the Flop
Seat 5: sD+TKtt36XiiN6jqHiLwDA folded before Flop (didn't bet)
Seat 7: ljemhp25Zg+nlA9DLCIiUw folded before Flop (didn't bet)
Seat 8: 10vzP4r6ldwGLbYHKd9www collected ($0.75)
Seat 9: S7Ki0P+0AIGPuIfGJjW0gg folded before Flop (didn't bet)




PokerStars Game #59941779354:  Hold'em No Limit ($0.10/$0.25) - 2009/07/01 1:45:53 ET
Table 'ouLhepGYovxB2x0QxH7cVg' 9-max Seat #1 is the button
Seat 1: ghNKXUBl/H+t83JF079ZBA ($25 in chips) 
Seat 2: r1Z5m4PwSI5ANp7qCE1OJw ($18.60 in chips) 
Seat 3: bXpVeaSTPBFSPJmeXxO7nw ($5.25 in chips) 
Seat 4: a0Sx6GHY7ln2Ns2C97eXeA ($38.10 in chips) 
Seat 5: v60REj6f8jzMYT0VsZvaPQ ($10 in chips) 
Seat 7: JRV2PblFtPFz51l0Fwyz8g ($24.25 in chips) 
Seat 8: tLcDklc2rBORNfixyRfVfw ($25.35 in chips) 
Seat 9: ljemhp25Zg+nlA9DLCIiUw ($25.35 in chips) 
r1Z5m4PwSI5ANp7qCE1OJw: posts small blind $0.10
bXpVeaSTPBFSPJmeXxO7nw: posts big blind $0.25
*** HOLE CARDS ***
a0Sx6GHY7ln2Ns2C97eXeA: folds 
Hein MÃ¼ck 76 joins the table at seat #6 
v60REj6f8jzMYT0VsZvaPQ: folds 
JRV2PblFtPFz51l0Fwyz8g: folds 
tLcDklc2rBORNfixyRfVfw: folds 
ljemhp25Zg+nlA9DLCIiUw: folds 
ghNKXUBl/H+t83JF079ZBA: folds 
r1Z5m4PwSI5ANp7qCE1OJw: calls $0.15
bXpVeaSTPBFSPJmeXxO7nw: checks 
*** FLOP *** [9d 6h Ac]
r1Z5m4PwSI5ANp7qCE1OJw: checks 
bXpVeaSTPBFSPJmeXxO7nw: bets $0.50
r1Z5m4PwSI5ANp7qCE1OJw: raises $0.75 to $1.25
bXpVeaSTPBFSPJmeXxO7nw: calls $0.75
*** TURN *** [9d 6h Ac] [8h]
r1Z5m4PwSI5ANp7qCE1OJw: bets $3.25
bXpVeaSTPBFSPJmeXxO7nw: raises $0.50 to $3.75 and is all-in
r1Z5m4PwSI5ANp7qCE1OJw: calls $0.50
*** RIVER *** [9d 6h Ac 8h] [9h]
*** SHOW DOWN ***
r1Z5m4PwSI5ANp7qCE1OJw: shows [6d Ah] (two pair, Aces and Nines)
bXpVeaSTPBFSPJmeXxO7nw: mucks hand 
r1Z5m4PwSI5ANp7qCE1OJw collected $10 from pot
*** SUMMARY ***
Total pot $10.50 | Rake $0.50 
Board [9d 6h Ac 8h 9h]
Seat 1: ghNKXUBl/H+t83JF079ZBA (button) folded before Flop (didn't bet)
Seat 2: r1Z5m4PwSI5ANp7qCE1OJw (small blind) showed [6d Ah] and won ($10) with two pair, Aces and Nines
Seat 3: bXpVeaSTPBFSPJmeXxO7nw (big blind) mucked
Seat 4: a0Sx6GHY7ln2Ns2C97eXeA folded before Flop (didn't bet)
Seat 5: v60REj6f8jzMYT0VsZvaPQ folded before Flop (didn't bet)
Seat 7: JRV2PblFtPFz51l0Fwyz8g folded before Flop (didn't bet)
Seat 8: tLcDklc2rBORNfixyRfVfw folded before Flop (didn't bet)
Seat 9: ljemhp25Zg+nlA9DLCIiUw folded before Flop (didn't bet)




PokerStars Game #59941779272:  Hold'em No Limit ($0.10/$0.25) - 2009/07/01 1:45:53 ET
Table 'sSe6q4YTb/iS19t2eCFdsA' 9-max Seat #4 is the button
Seat 1: hJ4uYjNmSZdjrKA8cjZqCA ($19.50 in chips) 
Seat 2: 3l+i+xMeyDndSXMF2A5CDA ($6.25 in chips) 
Seat 3: OXPkK84/qv92EMwXPiG5rQ ($10 in chips) 
Seat 4: 22dIObOuor/A+IKWkNoAlA ($8.50 in chips) 
Seat 5: qS+jfnNoG75bT+uQ8CKhQA ($9.80 in chips) 
Seat 6: tYsOBqdU1+x+yFI7zHO7hQ ($27.35 in chips) 
Seat 7: t70KGeRtR3naHSqKDixsUg ($3.50 in chips) 
Seat 8: hvXZ0zFPZFP8Hf6dS36YEw ($15.40 in chips) 
Seat 9: Z9W7+g1WMhhZDi7DwGbCFA ($5 in chips) 
qS+jfnNoG75bT+uQ8CKhQA: posts small blind $0.10
tYsOBqdU1+x+yFI7zHO7hQ: posts big blind $0.25
OXPkK84/qv92EMwXPiG5rQ: posts big blind $0.25
*** HOLE CARDS ***
t70KGeRtR3naHSqKDixsUg: folds 
hvXZ0zFPZFP8Hf6dS36YEw: raises $3.25 to $3.50
Z9W7+g1WMhhZDi7DwGbCFA: folds 
hJ4uYjNmSZdjrKA8cjZqCA: folds 
3l+i+xMeyDndSXMF2A5CDA: folds 
OXPkK84/qv92EMwXPiG5rQ: folds 
22dIObOuor/A+IKWkNoAlA: folds 
qS+jfnNoG75bT+uQ8CKhQA: folds 
tYsOBqdU1+x+yFI7zHO7hQ: folds 
Uncalled bet ($3.25) returned to hvXZ0zFPZFP8Hf6dS36YEw
hvXZ0zFPZFP8Hf6dS36YEw collected $0.85 from pot
*** SUMMARY ***
Total pot $0.85 | Rake $0 
Seat 1: hJ4uYjNmSZdjrKA8cjZqCA folded before Flop (didn't bet)
Seat 2: 3l+i+xMeyDndSXMF2A5CDA folded before Flop (didn't bet)
Seat 3: OXPkK84/qv92EMwXPiG5rQ folded before Flop
Seat 4: 22dIObOuor/A+IKWkNoAlA (button) folded before Flop (didn't bet)
Seat 5: qS+jfnNoG75bT+uQ8CKhQA (small blind) folded before Flop
Seat 6: tYsOBqdU1+x+yFI7zHO7hQ (big blind) folded before Flop
Seat 7: t70KGeRtR3naHSqKDixsUg folded before Flop (didn't bet)
Seat 8: hvXZ0zFPZFP8Hf6dS36YEw collected ($0.85)
Seat 9: Z9W7+g1WMhhZDi7DwGbCFA folded before Flop (didn't bet)




PokerStars Game #59941779904:  Hold'em No Limit ($0.10/$0.25) - 2009/07/01 1:45:54 ET
Table 'S6s+TmTlAjLHclBRvN5/fw' 9-max Seat #3 is the button
Seat 3: z2SmIaQ3+5n/eY1BN5HgPg ($6.20 in chips) 
Seat 4: RSal7+azPhXeqQO5L8XPfg ($13.75 in chips) 
z2SmIaQ3+5n/eY1BN5HgPg: posts small blind $0.10
RSal7+azPhXeqQO5L8XPfg: posts big blind $0.25
*** HOLE CARDS ***
z2SmIaQ3+5n/eY1BN5HgPg: raises $0.75 to $1
RSal7+azPhXeqQO5L8XPfg: calls $0.75
*** FLOP *** [As Kc 7h]
RSal7+azPhXeqQO5L8XPfg: bets $0.50
z2SmIaQ3+5n/eY1BN5HgPg: raises $2 to $2.50
RSal7+azPhXeqQO5L8XPfg: folds 
Uncalled bet ($2) returned to z2SmIaQ3+5n/eY1BN5HgPg
z2SmIaQ3+5n/eY1BN5HgPg collected $2.90 from pot
z2SmIaQ3+5n/eY1BN5HgPg: doesn't show hand 
8hSJOE8UscCqt6t47gp0/g joins the table at seat #5 
*** SUMMARY ***
Total pot $3 | Rake $0.10 
Board [As Kc 7h]
Seat 3: z2SmIaQ3+5n/eY1BN5HgPg (button) (small blind) collected ($2.90)
Seat 4: RSal7+azPhXeqQO5L8XPfg (big blind) folded on the Flop




PokerStars Game #59941779862:  Hold'em No Limit ($0.10/$0.25) - 2009/07/01 1:45:54 ET
Table 'jz4TpuH+ag+0iNe2ZcxckQ' 9-max Seat #6 is the button
Seat 1: +C3eP/ysyROWbEXJFPswVA ($17 in chips) 
Seat 2: clJsV3v77RS07bDKY+705w ($5 in chips) 
Seat 3: egvg3mTBBVzMHnJPIQiKcA ($14.10 in chips) 
Seat 4: k+2r6di6GXjNpAdrRkW9bA ($59.65 in chips) 
Seat 5: v1BVHNGLbP/nx7QO6K7+Jw ($37.50 in chips) 
Seat 6: gO1uiTGTzn5Cd3PECuws1g ($13.65 in chips) 
Seat 7: tLcDklc2rBORNfixyRfVfw ($31.75 in chips) 
Seat 8: uhrboV251dcgYniYTdFIcA ($25 in chips) 
Seat 9: W2YYHvqjaEpRrO7stZkClQ ($5.80 in chips) 
tLcDklc2rBORNfixyRfVfw: posts small blind $0.10
uhrboV251dcgYniYTdFIcA: posts big blind $0.25
*** HOLE CARDS ***
W2YYHvqjaEpRrO7stZkClQ: folds 
+C3eP/ysyROWbEXJFPswVA: folds 
clJsV3v77RS07bDKY+705w: folds 
egvg3mTBBVzMHnJPIQiKcA: raises $0.50 to $0.75
k+2r6di6GXjNpAdrRkW9bA: calls $0.75
v1BVHNGLbP/nx7QO6K7+Jw: folds 
gO1uiTGTzn5Cd3PECuws1g: folds 
tLcDklc2rBORNfixyRfVfw: folds 
uhrboV251dcgYniYTdFIcA: folds 
*** FLOP *** [Ts 3d Jd]
egvg3mTBBVzMHnJPIQiKcA: bets $0.75
k+2r6di6GXjNpAdrRkW9bA: calls $0.75
*** TURN *** [Ts 3d Jd] [2s]
egvg3mTBBVzMHnJPIQiKcA: bets $1.25
k+2r6di6GXjNpAdrRkW9bA: folds 
Uncalled bet ($1.25) returned to egvg3mTBBVzMHnJPIQiKcA
egvg3mTBBVzMHnJPIQiKcA collected $3.20 from pot
egvg3mTBBVzMHnJPIQiKcA: doesn't show hand 
*** SUMMARY ***
Total pot $3.35 | Rake $0.15 
Board [Ts 3d Jd 2s]
Seat 1: +C3eP/ysyROWbEXJFPswVA folded before Flop (didn't bet)
Seat 2: clJsV3v77RS07bDKY+705w folded before Flop (didn't bet)
Seat 3: egvg3mTBBVzMHnJPIQiKcA collected ($3.20)
Seat 4: k+2r6di6GXjNpAdrRkW9bA folded on the Turn
Seat 5: v1BVHNGLbP/nx7QO6K7+Jw folded before Flop (didn't bet)
Seat 6: gO1uiTGTzn5Cd3PECuws1g (button) folded before Flop (didn't bet)
Seat 7: tLcDklc2rBORNfixyRfVfw (small blind) folded before Flop
Seat 8: uhrboV251dcgYniYTdFIcA (big blind) folded before Flop
Seat 9: W2YYHvqjaEpRrO7stZkClQ folded before Flop (didn't bet)




PokerStars Game #59941779650:  Hold'em No Limit ($0.10/$0.25) - 2009/07/01 1:45:54 ET
Table 'jxoHy9yJy0bbH/Qx73FoPA' 9-max Seat #6 is the button
Seat 1: j4q3p0lesp63b1gZDwLBZw ($6.60 in chips) 
Seat 2: F7pnn6czNpHvRM55XcA2EA ($45.50 in chips) 
Seat 3: CVqCt93Mk0MhKMaZ4LZDSQ ($8.95 in chips) 
Seat 5: rzZ3wFcwoPyKlQ0mB5JLRQ ($7.40 in chips) 
Seat 6: tYsOBqdU1+x+yFI7zHO7hQ ($62.55 in chips) 
Seat 7: wGigCmBR/9XWkPpvYos3aQ ($26.15 in chips) 
Seat 8: Z9W7+g1WMhhZDi7DwGbCFA ($5 in chips) 
Seat 9: CvL9Ch1HYCVbTsfpNucitg ($4.90 in chips) 
wGigCmBR/9XWkPpvYos3aQ: posts small blind $0.10
Z9W7+g1WMhhZDi7DwGbCFA: posts big blind $0.25
bXpVeaSTPBFSPJmeXxO7nw: sits out 
*** HOLE CARDS ***
CvL9Ch1HYCVbTsfpNucitg: folds 
j4q3p0lesp63b1gZDwLBZw: folds 
F7pnn6czNpHvRM55XcA2EA: folds 
CVqCt93Mk0MhKMaZ4LZDSQ: folds 
rzZ3wFcwoPyKlQ0mB5JLRQ: raises $0.50 to $0.75
tYsOBqdU1+x+yFI7zHO7hQ: folds 
wGigCmBR/9XWkPpvYos3aQ: folds 
Z9W7+g1WMhhZDi7DwGbCFA: folds 
Uncalled bet ($0.50) returned to rzZ3wFcwoPyKlQ0mB5JLRQ
rzZ3wFcwoPyKlQ0mB5JLRQ collected $0.60 from pot
rzZ3wFcwoPyKlQ0mB5JLRQ: shows [Ks Kd] (a pair of Kings)
*** SUMMARY ***
Total pot $0.60 | Rake $0 
Seat 1: j4q3p0lesp63b1gZDwLBZw folded before Flop (didn't bet)
Seat 2: F7pnn6czNpHvRM55XcA2EA folded before Flop (didn't bet)
Seat 3: CVqCt93Mk0MhKMaZ4LZDSQ folded before Flop (didn't bet)
Seat 5: rzZ3wFcwoPyKlQ0mB5JLRQ collected ($0.60)
Seat 6: tYsOBqdU1+x+yFI7zHO7hQ (button) folded before Flop (didn't bet)
Seat 7: wGigCmBR/9XWkPpvYos3aQ (small blind) folded before Flop
Seat 8: Z9W7+g1WMhhZDi7DwGbCFA (big blind) folded before Flop
Seat 9: CvL9Ch1HYCVbTsfpNucitg folded before Flop (didn't bet)




PokerStars Game #59941779476:  Hold'em No Limit ($0.10/$0.25) - 2009/07/01 1:45:54 ET
Table 'nQC9LRg01NEuKFHF1nrDEw0XPo7K54oZIfG0xlNAcDRw-max Seat #3 is the button
Seat 1: qf+LMbROj8/qY878wkFHbQ ($14.80 in chips) 
Seat 2: ZhV6dUX9NQhT4zf7t+ZLJg ($22.10 in chips) 
Seat 3: 6+g0Lb6vfRDZkElV8ieHyQ ($24.25 in chips) 
Seat 5: kG34n23qFQA3nzdOJTQ1dA ($28.80 in chips) 
Seat 6: xQVFeVUDopz+akuEo2wXpQ ($56.30 in chips) 
Q1uciOZPBR/WkAlqa6cL4A was removed from the table for failing to post
kG34n23qFQA3nzdOJTQ1dA: posts small blind $0.10
xQVFeVUDopz+akuEo2wXpQ: posts big blind $0.25
*** HOLE CARDS ***
qf+LMbROj8/qY878wkFHbQ: folds 
ZhV6dUX9NQhT4zf7t+ZLJg: calls $0.25
6+g0Lb6vfRDZkElV8ieHyQ: calls $0.25
kG34n23qFQA3nzdOJTQ1dA: folds 
xQVFeVUDopz+akuEo2wXpQ: checks 
*** FLOP *** [7h Td 9c]
xQVFeVUDopz+akuEo2wXpQ: checks 
ZhV6dUX9NQhT4zf7t+ZLJg: bets $0.25
6+g0Lb6vfRDZkElV8ieHyQ: raises $0.25 to $0.50
xQVFeVUDopz+akuEo2wXpQ: calls $0.50
ZhV6dUX9NQhT4zf7t+ZLJg: calls $0.25
*** TURN *** [7h Td 9c] [9d]
xQVFeVUDopz+akuEo2wXpQ: checks 
ZhV6dUX9NQhT4zf7t+ZLJg: checks 
6+g0Lb6vfRDZkElV8ieHyQ: bets $0.75
xQVFeVUDopz+akuEo2wXpQ: folds 
ZhV6dUX9NQhT4zf7t+ZLJg: calls $0.75
*** RIVER *** [7h Td 9c 9d] [4c]
ZhV6dUX9NQhT4zf7t+ZLJg: checks 
u3Ol7kv1LmvszuHNm9rc6w joins the table at seat #4 
6+g0Lb6vfRDZkElV8ieHyQ: bets $1.25
ZhV6dUX9NQhT4zf7t+ZLJg: folds 
Uncalled bet ($1.25) returned to 6+g0Lb6vfRDZkElV8ieHyQ
6+g0Lb6vfRDZkElV8ieHyQ collected $3.70 from pot
*** SUMMARY ***
Total pot $3.85 | Rake $0.15 
Board [7h Td 9c 9d 4c]
Seat 1: qf+LMbROj8/qY878wkFHbQ folded before Flop (didn't bet)
Seat 2: ZhV6dUX9NQhT4zf7t+ZLJg folded on the River
Seat 3: 6+g0Lb6vfRDZkElV8ieHyQ (button) collected ($3.70)
Seat 5: kG34n23qFQA3nzdOJTQ1dA (small blind) folded before Flop
Seat 6: xQVFeVUDopz+akuEo2wXpQ (big blind) folded on the Turn




PokerStars Game #59941779846:  Hold'em No Limit ($0.10/$0.25) - 2009/07/01 1:45:54 ET
Table 'Do4nrTNDYpK3sQjwFxX+Og' 6-max Seat #2 is the button
Seat 1: 7JrQNOR9wRBxq9ijFhWieg ($37.30 in chips) 
Seat 2: tzMoGl9F0PUr5NibYueeSw ($66.75 in chips) 
Seat 3: TSmua8tGK3sTbwi0ynrW9Q ($27.15 in chips) 
Seat 4: cWc85bEzdRzpUMhRKm8pwQ ($33.40 in chips) 
Seat 5: Ew/TYPQIsbQ2X8nm5iAJBg ($35.65 in chips) 
Seat 6: lBoEwOFgzcERLIRUkUoRTw ($23.55 in chips) 
TSmua8tGK3sTbwi0ynrW9Q: posts small blind $0.10
cWc85bEzdRzpUMhRKm8pwQ: posts big blind $0.25
*** HOLE CARDS ***
Ew/TYPQIsbQ2X8nm5iAJBg: folds 
lBoEwOFgzcERLIRUkUoRTw: folds 
7JrQNOR9wRBxq9ijFhWieg: folds 
tzMoGl9F0PUr5NibYueeSw: raises $0.50 to $0.75
TSmua8tGK3sTbwi0ynrW9Q: calls $0.65
cWc85bEzdRzpUMhRKm8pwQ: folds 
*** FLOP *** [Qh Ac 3h]
TSmua8tGK3sTbwi0ynrW9Q: checks 
tzMoGl9F0PUr5NibYueeSw: checks 
*** TURN *** [Qh Ac 3h] [5h]
TSmua8tGK3sTbwi0ynrW9Q: checks 
tzMoGl9F0PUr5NibYueeSw: checks 
*** RIVER *** [Qh Ac 3h 5h] [6c]
TSmua8tGK3sTbwi0ynrW9Q: checks 
tzMoGl9F0PUr5NibYueeSw: bets $1.50
Ew/TYPQIsbQ2X8nm5iAJBg leaves the table
TSmua8tGK3sTbwi0ynrW9Q: folds 
Uncalled bet ($1.50) returned to tzMoGl9F0PUr5NibYueeSw
tzMoGl9F0PUr5NibYueeSw collected $1.70 from pot
tzMoGl9F0PUr5NibYueeSw: doesn't show hand 
*** SUMMARY ***
Total pot $1.75 | Rake $0.05 
Board [Qh Ac 3h 5h 6c]
Seat 1: 7JrQNOR9wRBxq9ijFhWieg folded before Flop (didn't bet)
Seat 2: tzMoGl9F0PUr5NibYueeSw (button) collected ($1.70)
Seat 3: TSmua8tGK3sTbwi0ynrW9Q (small blind) folded on the River
Seat 4: cWc85bEzdRzpUMhRKm8pwQ (big blind) folded before Flop
Seat 5: Ew/TYPQIsbQ2X8nm5iAJBg folded before Flop (didn't bet)
Seat 6: lBoEwOFgzcERLIRUkUoRTw folded before Flop (didn't bet)




PokerStars Game #59941779934:  Hold'em No Limit ($0.10/$0.25) - 2009/07/01 1:45:54 ET
Table 'edvgY2YQ1I34euq4EVqGnA' 6-max Seat #2 is the button
Seat 1: mvFHK3pE7tCxJEqLjKC70Q ($24.90 in chips) 
Seat 2: Hsvkc0/G2VV78oVmWYXecw ($5 in chips) 
Seat 3: mFv3iBCtrw9XfCDRB0d46Q ($3.30 in chips) 
Seat 4: TI/C5Q+DEl4fLR3AofwYdg ($22.50 in chips) 
Seat 5: EE16Ua5b1HSsYej5zeXOlA ($57.10 in chips) 
Seat 6: kG34n23qFQA3nzdOJTQ1dA ($71.35 in chips) 
mFv3iBCtrw9XfCDRB0d46Q: posts small blind $0.10
TI/C5Q+DEl4fLR3AofwYdg: posts big blind $0.25
*** HOLE CARDS ***
EE16Ua5b1HSsYej5zeXOlA: folds 
kG34n23qFQA3nzdOJTQ1dA: folds 
mvFHK3pE7tCxJEqLjKC70Q: raises $0.50 to $0.75
Hsvkc0/G2VV78oVmWYXecw: folds 
mFv3iBCtrw9XfCDRB0d46Q: folds 
TI/C5Q+DEl4fLR3AofwYdg: folds 
Uncalled bet ($0.50) returned to mvFHK3pE7tCxJEqLjKC70Q
mvFHK3pE7tCxJEqLjKC70Q collected $0.60 from pot
mvFHK3pE7tCxJEqLjKC70Q: doesn't show hand 
*** SUMMARY ***
Total pot $0.60 | Rake $0 
Seat 1: mvFHK3pE7tCxJEqLjKC70Q collected ($0.60)
Seat 2: Hsvkc0/G2VV78oVmWYXecw (button) folded before Flop (didn't bet)
Seat 3: mFv3iBCtrw9XfCDRB0d46Q (small blind) folded before Flop
Seat 4: TI/C5Q+DEl4fLR3AofwYdg (big blind) folded before Flop
Seat 5: EE16Ua5b1HSsYej5zeXOlA folded before Flop (didn't bet)
Seat 6: kG34n23qFQA3nzdOJTQ1dA folded before Flop (didn't bet)




PokerStars Game #59941779752:  Hold'em No Limit ($0.10/$0.25) - 2009/07/01 1:45:54 ET
Table 'wPWRBZPJl1HAnysw7qRR0A' 6-max Seat #6 is the button
Seat 1: m7ne1MOFTQXlsXT7/R/rug ($6.75 in chips) 
Seat 2: xC0kaiDYM6YTlgODL83O5A ($15 in chips) 
Seat 3: 1ZpoLWO2nm2w1Nd1v9Sr3g ($7.20 in chips) 
Seat 4: epAUIB7h2FJXzUPRIvSkRA ($39.15 in chips) 
Seat 5: y0B+UpYpOUJz3JWtlJQBSA ($16 in chips) 
Seat 6: rx64Jzd1UJFfwJwXmv3z8w ($15.15 in chips) 
m7ne1MOFTQXlsXT7/R/rug: posts small blind $0.10
xC0kaiDYM6YTlgODL83O5A: posts big blind $0.25
*** HOLE CARDS ***
1ZpoLWO2nm2w1Nd1v9Sr3g: raises $0.75 to $1
epAUIB7h2FJXzUPRIvSkRA: folds 
y0B+UpYpOUJz3JWtlJQBSA: folds 
rx64Jzd1UJFfwJwXmv3z8w: folds 
m7ne1MOFTQXlsXT7/R/rug: folds 
xC0kaiDYM6YTlgODL83O5A: folds 
Uncalled bet ($0.75) returned to 1ZpoLWO2nm2w1Nd1v9Sr3g
1ZpoLWO2nm2w1Nd1v9Sr3g collected $0.60 from pot
1ZpoLWO2nm2w1Nd1v9Sr3g: doesn't show hand 
*** SUMMARY ***
Total pot $0.60 | Rake $0 
Seat 1: m7ne1MOFTQXlsXT7/R/rug (small blind) folded before Flop
Seat 2: xC0kaiDYM6YTlgODL83O5A (big blind) folded before Flop
Seat 3: 1ZpoLWO2nm2w1Nd1v9Sr3g collected ($0.60)
Seat 4: epAUIB7h2FJXzUPRIvSkRA folded before Flop (didn't bet)
Seat 5: y0B+UpYpOUJz3JWtlJQBSA folded before Flop (didn't bet)
Seat 6: rx64Jzd1UJFfwJwXmv3z8w (button) folded before Flop (didn't bet)




PokerStars Game #59941779772:  Hold'em No Limit ($0.10/$0.25) - 2009/07/01 1:45:54 ET
Table 'SgI2Cobdjtkh0Fd0/eTTDg' 9-max Seat #5 is the button
Seat 1: NcPAt5YjVvDFEJTTgAVj8g ($5.95 in chips) 
Seat 2: uUc5QTI8+ZdC95UnznCsqg ($14.25 in chips) 
Seat 3: OiV1PWZ3IkN29JlmCcnTwQ ($5 in chips) 
Seat 4: s1y+qfkBnhgc67+X3ThjeA ($9.90 in chips) 
Seat 5: RHqgdFvufLCYe54+qd2gcA ($6.25 in chips) 
Seat 6: 6RiVTYll/5D8zICp0MRpKw ($26 in chips) 
Seat 9: cZ99hugmLBj9KhTlc8nCSw ($30.95 in chips) 
6RiVTYll/5D8zICp0MRpKw: posts small blind $0.10
Archi91: is sitting out 
cZ99hugmLBj9KhTlc8nCSw: posts big blind $0.25
*** HOLE CARDS ***
Archi91 leaves the table
NcPAt5YjVvDFEJTTgAVj8g: calls $0.25
geripete leaves the table
uUc5QTI8+ZdC95UnznCsqg: folds 
OiV1PWZ3IkN29JlmCcnTwQ: folds 
s1y+qfkBnhgc67+X3ThjeA: calls $0.25
RHqgdFvufLCYe54+qd2gcA: folds 
6RiVTYll/5D8zICp0MRpKw: calls $0.15
cZ99hugmLBj9KhTlc8nCSw: checks 
*** FLOP *** [Qd As Ts]
6RiVTYll/5D8zICp0MRpKw: checks 
cZ99hugmLBj9KhTlc8nCSw: checks 
NcPAt5YjVvDFEJTTgAVj8g: checks 
s1y+qfkBnhgc67+X3ThjeA: bets $0.25
6RiVTYll/5D8zICp0MRpKw: raises $1 to $1.25
cZ99hugmLBj9KhTlc8nCSw: folds 
NcPAt5YjVvDFEJTTgAVj8g: folds 
s1y+qfkBnhgc67+X3ThjeA: calls $1
*** TURN *** [Qd As Ts] [Kh]
6RiVTYll/5D8zICp0MRpKw: checks 
s1y+qfkBnhgc67+X3ThjeA: checks 
*** RIVER *** [Qd As Ts Kh] [8c]
M. Catalig joins the table at seat #7 
6RiVTYll/5D8zICp0MRpKw: bets $1.25
NcPAt5YjVvDFEJTTgAVj8g leaves the table
s1y+qfkBnhgc67+X3ThjeA: folds 
Uncalled bet ($1.25) returned to 6RiVTYll/5D8zICp0MRpKw
6RiVTYll/5D8zICp0MRpKw collected $3.35 from pot
*** SUMMARY ***
Total pot $3.50 | Rake $0.15 
Board [Qd As Ts Kh 8c]
Seat 1: NcPAt5YjVvDFEJTTgAVj8g folded on the Flop
Seat 2: uUc5QTI8+ZdC95UnznCsqg folded before Flop (didn't bet)
Seat 3: OiV1PWZ3IkN29JlmCcnTwQ folded before Flop (didn't bet)
Seat 4: s1y+qfkBnhgc67+X3ThjeA folded on the River
Seat 5: RHqgdFvufLCYe54+qd2gcA (button) folded before Flop (didn't bet)
Seat 6: 6RiVTYll/5D8zICp0MRpKw (small blind) collected ($3.35)
Seat 9: cZ99hugmLBj9KhTlc8nCSw (big blind) folded on the Flop




PokerStars Game #59941780400:  Hold'em No Limit ($0.10/$0.25) - 2009/07/01 1:45:55 ET
Table 'MJ1SB76A4qJrlEa+C5e/8w' 6-max Seat #3 is the button
Seat 1: 0KDZiuXQg6UI9cqBR/AUnQ ($26 in chips) 
Seat 2: UA5OsKS3VPaxa7uC8La/kA ($37.40 in chips) 
Seat 3: DihMHaz4WNETH1bPDe13kA ($32.55 in chips) 
Seat 4: SFmT9ZsVopnukjvAzrxTRg ($27.55 in chips) 
Seat 5: Hsvkc0/G2VV78oVmWYXecw ($5 in chips) 
Seat 6: JFIAqU8lCZ0vWwEl4bdGsg ($30.30 in chips) 
SFmT9ZsVopnukjvAzrxTRg: posts small blind $0.10
Hsvkc0/G2VV78oVmWYXecw: posts big blind $0.25
*** HOLE CARDS ***
JFIAqU8lCZ0vWwEl4bdGsg: folds 
0KDZiuXQg6UI9cqBR/AUnQ: folds 
UA5OsKS3VPaxa7uC8La/kA is connected 
UA5OsKS3VPaxa7uC8La/kA: folds 
DihMHaz4WNETH1bPDe13kA: folds 
SFmT9ZsVopnukjvAzrxTRg: raises $0.75 to $1
Hsvkc0/G2VV78oVmWYXecw: folds 
Uncalled bet ($0.75) returned to SFmT9ZsVopnukjvAzrxTRg
SFmT9ZsVopnukjvAzrxTRg collected $0.50 from pot
SFmT9ZsVopnukjvAzrxTRg: doesn't show hand 
*** SUMMARY ***
Total pot $0.50 | Rake $0 
Seat 1: 0KDZiuXQg6UI9cqBR/AUnQ folded before Flop (didn't bet)
Seat 2: UA5OsKS3VPaxa7uC8La/kA folded before Flop (didn't bet)
Seat 3: DihMHaz4WNETH1bPDe13kA (button) folded before Flop (didn't bet)
Seat 4: SFmT9ZsVopnukjvAzrxTRg (small blind) collected ($0.50)
Seat 5: Hsvkc0/G2VV78oVmWYXecw (big blind) folded before Flop
Seat 6: JFIAqU8lCZ0vWwEl4bdGsg folded before Flop (didn't bet)




PokerStars Game #59941780116:  Hold'em No Limit ($0.10/$0.25) - 2009/07/01 1:45:55 ET
Table '+UzantPJ4smVdrh+4GTu1w' 6-max Seat #4 is the button
Seat 1: TSmua8tGK3sTbwi0ynrW9Q ($28.10 in chips) 
Seat 2: tcbEu7VzyHQ+0lh+skbQhQ ($41 in chips) 
Seat 3: SS/yfeArhULzIcOPe8MdPg ($34.15 in chips) 
Seat 4: UmcUp27+PbgBItv3ZNlAWQ ($26.80 in chips) 
Seat 5: cj4VBQya7HtVL2zCGd5jLQ ($55.80 in chips) 
Seat 6: fZQg9veL7Dd/Z04ZTjC+wQ ($25 in chips) 
cj4VBQya7HtVL2zCGd5jLQ: posts small blind $0.10
fZQg9veL7Dd/Z04ZTjC+wQ: posts big blind $0.25
*** HOLE CARDS ***
TSmua8tGK3sTbwi0ynrW9Q: folds 
tcbEu7VzyHQ+0lh+skbQhQ: folds 
SS/yfeArhULzIcOPe8MdPg: raises $0.75 to $1
UmcUp27+PbgBItv3ZNlAWQ: folds 
cj4VBQya7HtVL2zCGd5jLQ: folds 
fZQg9veL7Dd/Z04ZTjC+wQ: folds 
Uncalled bet ($0.75) returned to SS/yfeArhULzIcOPe8MdPg
SS/yfeArhULzIcOPe8MdPg collected $0.60 from pot
*** SUMMARY ***
Total pot $0.60 | Rake $0 
Seat 1: TSmua8tGK3sTbwi0ynrW9Q folded before Flop (didn't bet)
Seat 2: tcbEu7VzyHQ+0lh+skbQhQ folded before Flop (didn't bet)
Seat 3: SS/yfeArhULzIcOPe8MdPg collected ($0.60)
Seat 4: UmcUp27+PbgBItv3ZNlAWQ (button) folded before Flop (didn't bet)
Seat 5: cj4VBQya7HtVL2zCGd5jLQ (small blind) folded before Flop
Seat 6: fZQg9veL7Dd/Z04ZTjC+wQ (big blind) folded before Flop




PokerStars Game #59941780354:  Hold'em No Limit ($0.10/$0.25) - 2009/07/01 1:45:55 ET
Table 'gYBWJG3hEuJg6kphY0yhMg' 9-max Seat #1 is the button
Seat 1: AcL/hxc9eT0dCr2TYk/0Dg ($25.80 in chips) 
Seat 2: RCqMONFrSPSArZh2Jsar/w ($19.75 in chips) 
Seat 3: wGigCmBR/9XWkPpvYos3aQ ($25.35 in chips) 
Seat 4: V6p0jQ/RhUsqpHLmXvEX4Q ($11.15 in chips) 
Seat 5: +sbyWwIcFp9kP0bDtMegfQ ($27.95 in chips) 
Seat 7: aIEQGxUJwm61WfazSNFCdA ($10.55 in chips) 
Seat 8: 7je+LC5Mfs6nL8YBVh4frQ ($4.75 in chips) 
Seat 9: Bb42QRQMhg5/Y0vHP8/2Xw ($28.55 in chips) 
RCqMONFrSPSArZh2Jsar/w: posts small blind $0.10
wGigCmBR/9XWkPpvYos3aQ: posts big blind $0.25
Z9W7+g1WMhhZDi7DwGbCFA: sits out 
*** HOLE CARDS ***
V6p0jQ/RhUsqpHLmXvEX4Q: folds 
+sbyWwIcFp9kP0bDtMegfQ: raises $0.25 to $0.50
aIEQGxUJwm61WfazSNFCdA: folds 
7je+LC5Mfs6nL8YBVh4frQ: folds 
Bb42QRQMhg5/Y0vHP8/2Xw: calls $0.50
AcL/hxc9eT0dCr2TYk/0Dg: folds 
RCqMONFrSPSArZh2Jsar/w: folds 
wGigCmBR/9XWkPpvYos3aQ: folds 
*** FLOP *** [As Ac 3c]
+sbyWwIcFp9kP0bDtMegfQ: checks 
Bb42QRQMhg5/Y0vHP8/2Xw: checks 
*** TURN *** [As Ac 3c] [8d]
+sbyWwIcFp9kP0bDtMegfQ: checks 
Bb42QRQMhg5/Y0vHP8/2Xw: checks 
*** RIVER *** [As Ac 3c 8d] [8c]
+sbyWwIcFp9kP0bDtMegfQ: checks 
Bb42QRQMhg5/Y0vHP8/2Xw: checks 
*** SHOW DOWN ***
+sbyWwIcFp9kP0bDtMegfQ: shows [7d 7h] (two pair, Aces and Eights)
Bb42QRQMhg5/Y0vHP8/2Xw: mucks hand 
+sbyWwIcFp9kP0bDtMegfQ collected $1.30 from pot
*** SUMMARY ***
Total pot $1.35 | Rake $0.05 
Board [As Ac 3c 8d 8c]
Seat 1: AcL/hxc9eT0dCr2TYk/0Dg (button) folded before Flop (didn't bet)
Seat 2: RCqMONFrSPSArZh2Jsar/w (small blind) folded before Flop
Seat 3: wGigCmBR/9XWkPpvYos3aQ (big blind) folded before Flop
Seat 4: V6p0jQ/RhUsqpHLmXvEX4Q folded before Flop (didn't bet)
Seat 5: +sbyWwIcFp9kP0bDtMegfQ showed [7d 7h] and won ($1.30) with two pair, Aces and Eights
Seat 7: aIEQGxUJwm61WfazSNFCdA folded before Flop (didn't bet)
Seat 8: 7je+LC5Mfs6nL8YBVh4frQ folded before Flop (didn't bet)
Seat 9: Bb42QRQMhg5/Y0vHP8/2Xw mucked




PokerStars Game #59941780842:  Hold'em No Limit ($0.10/$0.25) - 2009/07/01 1:45:56 ET
Table 'nIRjSqm6RYUWJlyW2loYKA' 6-max Seat #4 is the button
Seat 2: NndRCAk4vU5JGDhTyy5LZg ($15.30 in chips) 
Seat 3: HbKNMWUwblC7HKtRCUhBWw ($20.50 in chips) 
Seat 4: /ZSSWvl8im2y38j1uEUAGA ($15 in chips) 
Seat 5: df01R5ThvHspD8FgKmaDvQ ($24.50 in chips) 
Seat 6: OIjOiBfQstWrK/RuXx7zcw ($5.95 in chips) 
df01R5ThvHspD8FgKmaDvQ: posts small blind $0.10
OIjOiBfQstWrK/RuXx7zcw: posts big blind $0.25
w43JQj2oYPpKQVG4Yzlq1w: sits out 
*** HOLE CARDS ***
NndRCAk4vU5JGDhTyy5LZg: folds 
HbKNMWUwblC7HKtRCUhBWw: raises $0.75 to $1
/ZSSWvl8im2y38j1uEUAGA: folds 
df01R5ThvHspD8FgKmaDvQ: folds 
OIjOiBfQstWrK/RuXx7zcw: calls $0.75
*** FLOP *** [2c Kc 6d]
OIjOiBfQstWrK/RuXx7zcw: checks 
HbKNMWUwblC7HKtRCUhBWw: checks 
*** TURN *** [2c Kc 6d] [Kd]
OIjOiBfQstWrK/RuXx7zcw: checks 
HbKNMWUwblC7HKtRCUhBWw: checks 
*** RIVER *** [2c Kc 6d Kd] [6s]
OIjOiBfQstWrK/RuXx7zcw: checks 
HbKNMWUwblC7HKtRCUhBWw: bets $1
OIjOiBfQstWrK/RuXx7zcw: calls $1
*** SHOW DOWN ***
HbKNMWUwblC7HKtRCUhBWw: shows [Jc Ah] (two pair, Kings and Sixes)
OIjOiBfQstWrK/RuXx7zcw: shows [2d Ad] (two pair, Kings and Sixes)
OIjOiBfQstWrK/RuXx7zcw collected $1.95 from pot
HbKNMWUwblC7HKtRCUhBWw collected $1.95 from pot
*** SUMMARY ***
Total pot $4.10 | Rake $0.20 
Board [2c Kc 6d Kd 6s]
Seat 2: NndRCAk4vU5JGDhTyy5LZg folded before Flop (didn't bet)
Seat 3: HbKNMWUwblC7HKtRCUhBWw showed [Jc Ah] and won ($1.95) with two pair, Kings and Sixes
Seat 4: /ZSSWvl8im2y38j1uEUAGA (button) folded before Flop (didn't bet)
Seat 5: df01R5ThvHspD8FgKmaDvQ (small blind) folded before Flop
Seat 6: OIjOiBfQstWrK/RuXx7zcw (big blind) showed [2d Ad] and won ($1.95) with two pair, Kings and Sixes




PokerStars Game #59941780846:  Hold'em No Limit ($0.10/$0.25) - 2009/07/01 1:45:56 ET
Table 'P1IJQ2p3ACFySC35W1qwQw' 9-max Seat #5 is the button
Seat 1: bXpVeaSTPBFSPJmeXxO7nw ($5.50 in chips) 
Seat 2: vO3QVRovWemcGMkm7ijAIA ($5.35 in chips) 
Seat 3: PVxvfRTRvkgZf9WtquEkwQ ($25 in chips) 
Seat 4: c/9X4zftzphFxYtxp5kp9w ($27.55 in chips) 
Seat 5: ghNKXUBl/H+t83JF079ZBA ($56.45 in chips) 
Seat 6: ljemhp25Zg+nlA9DLCIiUw ($64.20 in chips) 
Seat 7: 7je+LC5Mfs6nL8YBVh4frQ ($5.45 in chips) 
Seat 8: tLcDklc2rBORNfixyRfVfw ($26.60 in chips) 
Seat 9: XXajyXkgbSGJKxQP3mal/Q ($14.65 in chips) 
ljemhp25Zg+nlA9DLCIiUw: posts small blind $0.10
7je+LC5Mfs6nL8YBVh4frQ: posts big blind $0.25
*** HOLE CARDS ***
tLcDklc2rBORNfixyRfVfw: folds 
XXajyXkgbSGJKxQP3mal/Q: raises $0.50 to $0.75
bXpVeaSTPBFSPJmeXxO7nw: folds 
vO3QVRovWemcGMkm7ijAIA: folds 
PVxvfRTRvkgZf9WtquEkwQ: calls $0.75
c/9X4zftzphFxYtxp5kp9w: folds 
ghNKXUBl/H+t83JF079ZBA: folds 
ljemhp25Zg+nlA9DLCIiUw: folds 
7je+LC5Mfs6nL8YBVh4frQ: folds 
*** FLOP *** [2h 2c Ac]
XXajyXkgbSGJKxQP3mal/Q: checks 
PVxvfRTRvkgZf9WtquEkwQ: bets $1
XXajyXkgbSGJKxQP3mal/Q: folds 
Uncalled bet ($1) returned to PVxvfRTRvkgZf9WtquEkwQ
PVxvfRTRvkgZf9WtquEkwQ collected $1.80 from pot
PVxvfRTRvkgZf9WtquEkwQ: doesn't show hand 
*** SUMMARY ***
Total pot $1.85 | Rake $0.05 
Board [2h 2c Ac]
Seat 1: bXpVeaSTPBFSPJmeXxO7nw folded before Flop (didn't bet)
Seat 2: vO3QVRovWemcGMkm7ijAIA folded before Flop (didn't bet)
Seat 3: PVxvfRTRvkgZf9WtquEkwQ collected ($1.80)
Seat 4: c/9X4zftzphFxYtxp5kp9w folded before Flop (didn't bet)
Seat 5: ghNKXUBl/H+t83JF079ZBA (button) folded before Flop (didn't bet)
Seat 6: ljemhp25Zg+nlA9DLCIiUw (small blind) folded before Flop
Seat 7: 7je+LC5Mfs6nL8YBVh4frQ (big blind) folded before Flop
Seat 8: tLcDklc2rBORNfixyRfVfw folded before Flop (didn't bet)
Seat 9: XXajyXkgbSGJKxQP3mal/Q folded on the Flop




PokerStars Game #59941780704:  Hold'em No Limit ($0.10/$0.25) - 2009/07/01 1:45:56 ET
Table 'GxdLtCpYxqT4aAbYqkEEpw' 6-max Seat #5 is the button
Seat 1: 2d/PU00mMdO9azAaXqcSbw ($9.35 in chips) 
Seat 2: MCCWc70bl051s/EF6nHRcA ($25 in chips) 
Seat 3: LpmZGzLpOmfZUF7EV4ZlrQ ($16.25 in chips) 
Seat 4: 6wzJiRvp8HY6t+MQGnSIzA ($10.55 in chips) 
Seat 5: q6WfTUAD9mowIP63ASq2Dg ($46.10 in chips) 
Seat 6: DFi/Lzkjsfv8QswS80JX9Q ($25 in chips) 
DFi/Lzkjsfv8QswS80JX9Q: posts small blind $0.10
2d/PU00mMdO9azAaXqcSbw: posts big blind $0.25
MCCWc70bl051s/EF6nHRcA: posts big blind $0.25
*** HOLE CARDS ***
MCCWc70bl051s/EF6nHRcA: checks 
LpmZGzLpOmfZUF7EV4ZlrQ: folds 
6wzJiRvp8HY6t+MQGnSIzA: calls $0.25
q6WfTUAD9mowIP63ASq2Dg: raises $0.60 to $0.85
DFi/Lzkjsfv8QswS80JX9Q: folds 
2d/PU00mMdO9azAaXqcSbw: folds 
MCCWc70bl051s/EF6nHRcA: folds 
6wzJiRvp8HY6t+MQGnSIzA: calls $0.60
*** FLOP *** [3s Ah As]
6wzJiRvp8HY6t+MQGnSIzA: checks 
q6WfTUAD9mowIP63ASq2Dg: checks 
*** TURN *** [3s Ah As] [Qs]
6wzJiRvp8HY6t+MQGnSIzA: bets $0.50
q6WfTUAD9mowIP63ASq2Dg: folds 
Uncalled bet ($0.50) returned to 6wzJiRvp8HY6t+MQGnSIzA
6wzJiRvp8HY6t+MQGnSIzA collected $2.20 from pot
6wzJiRvp8HY6t+MQGnSIzA: doesn't show hand 
*** SUMMARY ***
Total pot $2.30 | Rake $0.10 
Board [3s Ah As Qs]
Seat 1: 2d/PU00mMdO9azAaXqcSbw (big blind) folded before Flop
Seat 2: MCCWc70bl051s/EF6nHRcA folded before Flop
Seat 3: LpmZGzLpOmfZUF7EV4ZlrQ folded before Flop (didn't bet)
Seat 4: 6wzJiRvp8HY6t+MQGnSIzA collected ($2.20)
Seat 5: q6WfTUAD9mowIP63ASq2Dg (button) folded on the Turn
Seat 6: DFi/Lzkjsfv8QswS80JX9Q (small blind) folded before Flop




PokerStars Game #59941781032:  Hold'em No Limit ($0.10/$0.25) - 2009/07/01 1:45:57 ET
Table 'FuFyQHmlO/QqQp//rDRrPg' 6-max Seat #4 is the button
Seat 1: jp34e617tIzV8tKIWmfAbA ($27.40 in chips) 
Seat 2: G3h3THGB1j3qdHDVHpnJWg ($31.35 in chips) 
Seat 3: EeUZtMU058v2ObUACOF4Og ($29.85 in chips) 
Seat 4: Ahsa9Yk5NPmCqQstq1EoQA ($21.20 in chips) 
Seat 5: xrf8tAXKQHG99HixCot1Iw ($25.35 in chips) 
Seat 6: 6DwBRH+xZ12AAZmeAg+aXw ($51.60 in chips) 
xrf8tAXKQHG99HixCot1Iw: posts small blind $0.10
6DwBRH+xZ12AAZmeAg+aXw: posts big blind $0.25
*** HOLE CARDS ***
jp34e617tIzV8tKIWmfAbA: folds 
G3h3THGB1j3qdHDVHpnJWg: calls $0.25
EeUZtMU058v2ObUACOF4Og: folds 
Ahsa9Yk5NPmCqQstq1EoQA: calls $0.25
xrf8tAXKQHG99HixCot1Iw: folds 
6DwBRH+xZ12AAZmeAg+aXw: checks 
*** FLOP *** [7h Qc 6d]
6DwBRH+xZ12AAZmeAg+aXw: checks 
G3h3THGB1j3qdHDVHpnJWg has timed out
G3h3THGB1j3qdHDVHpnJWg: checks 
Ahsa9Yk5NPmCqQstq1EoQA: bets $0.50
6DwBRH+xZ12AAZmeAg+aXw: folds 
G3h3THGB1j3qdHDVHpnJWg: folds 
Uncalled bet ($0.50) returned to Ahsa9Yk5NPmCqQstq1EoQA
Ahsa9Yk5NPmCqQstq1EoQA collected $0.85 from pot
*** SUMMARY ***
Total pot $0.85 | Rake $0 
Board [7h Qc 6d]
Seat 1: jp34e617tIzV8tKIWmfAbA folded before Flop (didn't bet)
Seat 2: G3h3THGB1j3qdHDVHpnJWg folded on the Flop
Seat 3: EeUZtMU058v2ObUACOF4Og folded before Flop (didn't bet)
Seat 4: Ahsa9Yk5NPmCqQstq1EoQA (button) collected ($0.85)
Seat 5: xrf8tAXKQHG99HixCot1Iw (small blind) folded before Flop
Seat 6: 6DwBRH+xZ12AAZmeAg+aXw (big blind) folded on the Flop




PokerStars Game #59941781046:  Hold'em No Limit ($0.10/$0.25) - 2009/07/01 1:45:57 ET
Table 'WY+lMaAoIdBZmwk27/RJCA' 6-max Seat #3 is the button
Seat 1: zHHLkD2sRljslKKeQv/ZQw ($24.35 in chips) 
Seat 2: NhUN/JpAprdJeamFBgJH1w ($26.90 in chips) 
Seat 3: QqiZLFrN8iOUT/GHw7ztOA ($26.60 in chips) 
Seat 4: 0av6tRNdi0Ui4f15L7gsVg ($25.10 in chips) 
Seat 5: vqWjZmdQu/Hxw96/IJTWdQ ($30.45 in chips) 
Seat 6: cWc85bEzdRzpUMhRKm8pwQ ($25.50 in chips) 
0av6tRNdi0Ui4f15L7gsVg: posts small blind $0.10
vqWjZmdQu/Hxw96/IJTWdQ: posts big blind $0.25
*** HOLE CARDS ***
cWc85bEzdRzpUMhRKm8pwQ: folds 
zHHLkD2sRljslKKeQv/ZQw: raises $1 to $1.25
NhUN/JpAprdJeamFBgJH1w: folds 
QqiZLFrN8iOUT/GHw7ztOA: folds 
0av6tRNdi0Ui4f15L7gsVg: folds 
vqWjZmdQu/Hxw96/IJTWdQ: raises $1.50 to $2.75
zHHLkD2sRljslKKeQv/ZQw: raises $21.60 to $24.35 and is all-in
vqWjZmdQu/Hxw96/IJTWdQ: folds 
Uncalled bet ($21.60) returned to zHHLkD2sRljslKKeQv/ZQw
zHHLkD2sRljslKKeQv/ZQw collected $5.60 from pot
*** SUMMARY ***
Total pot $5.60 | Rake $0 
Seat 1: zHHLkD2sRljslKKeQv/ZQw collected ($5.60)
Seat 2: NhUN/JpAprdJeamFBgJH1w folded before Flop (didn't bet)
Seat 3: QqiZLFrN8iOUT/GHw7ztOA (button) folded before Flop (didn't bet)
Seat 4: 0av6tRNdi0Ui4f15L7gsVg (small blind) folded before Flop
Seat 5: vqWjZmdQu/Hxw96/IJTWdQ (big blind) folded before Flop
Seat 6: cWc85bEzdRzpUMhRKm8pwQ folded before Flop (didn't bet)




PokerStars Game #59941781412:  Hold'em No Limit ($0.10/$0.25) - 2009/07/01 1:45:57 ET
Table 'z2yOdY2zyGWG1gh9WV9XtQ' 9-max Seat #9 is the button
Seat 3: X78b5v/uhqeXXoAijbw/yg ($26.40 in chips) 
Seat 4: Bb42QRQMhg5/Y0vHP8/2Xw ($25.35 in chips) 
Seat 5: W6tExOcYX7qiy6Qdp+ZwFA ($10.55 in chips) 
Seat 6: NBYmTySMtIicyMj5Vjzqhw ($24.55 in chips) 
Seat 7: zDrucyjVn5aeekNEc3cJrA ($23.35 in chips) 
Seat 8: nAWaA+gDUSWOad+I9mKUEg ($6.35 in chips) 
Seat 9: wGigCmBR/9XWkPpvYos3aQ ($34.65 in chips) 
X78b5v/uhqeXXoAijbw/yg: posts small blind $0.10
Bb42QRQMhg5/Y0vHP8/2Xw: posts big blind $0.25
zDrucyjVn5aeekNEc3cJrA: posts small & big blinds $0.35
nAWaA+gDUSWOad+I9mKUEg: posts big blind $0.25
*** HOLE CARDS ***
W6tExOcYX7qiy6Qdp+ZwFA: folds 
W6tExOcYX7qiy6Qdp+ZwFA leaves the table
NBYmTySMtIicyMj5Vjzqhw: raises $0.25 to $0.50
8iyfEWL3auLDt9HEV3U5Vg joins the table at seat #1 
zDrucyjVn5aeekNEc3cJrA: calls $0.25
nAWaA+gDUSWOad+I9mKUEg: calls $0.25
wGigCmBR/9XWkPpvYos3aQ: folds 
X78b5v/uhqeXXoAijbw/yg: folds 
Bb42QRQMhg5/Y0vHP8/2Xw: folds 
*** FLOP *** [8s Ts 4h]
NBYmTySMtIicyMj5Vjzqhw: checks 
zDrucyjVn5aeekNEc3cJrA: checks 
nAWaA+gDUSWOad+I9mKUEg: bets $0.75
NBYmTySMtIicyMj5Vjzqhw: calls $0.75
zDrucyjVn5aeekNEc3cJrA: calls $0.75
*** TURN *** [8s Ts 4h] [6c]
NBYmTySMtIicyMj5Vjzqhw: checks 
zDrucyjVn5aeekNEc3cJrA: checks 
nAWaA+gDUSWOad+I9mKUEg: bets $1.25
NBYmTySMtIicyMj5Vjzqhw: calls $1.25
zDrucyjVn5aeekNEc3cJrA: folds 
*** RIVER *** [8s Ts 4h 6c] [Kh]
NBYmTySMtIicyMj5Vjzqhw: checks 
nAWaA+gDUSWOad+I9mKUEg: bets $3.85 and is all-in
NBYmTySMtIicyMj5Vjzqhw: calls $3.85
*** SHOW DOWN ***
nAWaA+gDUSWOad+I9mKUEg: shows [Qs 9h] (high card King)
NBYmTySMtIicyMj5Vjzqhw: shows [8d 8c] (three of a kind, Eights)
NBYmTySMtIicyMj5Vjzqhw collected $13.70 from pot
nAWaA+gDUSWOad+I9mKUEg leaves the table
*** SUMMARY ***
Total pot $14.40 | Rake $0.70 
Board [8s Ts 4h 6c Kh]
Seat 3: X78b5v/uhqeXXoAijbw/yg (small blind) folded before Flop
Seat 4: Bb42QRQMhg5/Y0vHP8/2Xw (big blind) folded before Flop
Seat 5: W6tExOcYX7qiy6Qdp+ZwFA folded before Flop (didn't bet)
Seat 6: NBYmTySMtIicyMj5Vjzqhw showed [8d 8c] and won ($13.70) with three of a kind, Eights
Seat 7: zDrucyjVn5aeekNEc3cJrA folded on the Turn
Seat 8: nAWaA+gDUSWOad+I9mKUEg showed [Qs 9h] and lost with high card King
Seat 9: wGigCmBR/9XWkPpvYos3aQ (button) folded before Flop (didn't bet)




PokerStars Game #59941781176:  Hold'em No Limit ($0.10/$0.25) - 2009/07/01 1:45:57 ET
Table '0mmHveGuaIfIMQlNE1eqMg' 9-max Seat #8 is the button
Seat 1: ydoFOVgzvZv9ZhuWu9rXAw ($5 in chips) 
Seat 2: rQhYIYXSyH/IivYM1dlV5A ($68.85 in chips) 
Seat 3: ghNKXUBl/H+t83JF079ZBA ($25 in chips) 
Seat 4: DnDcAdn9P0zGovMERigpFA ($36.10 in chips) 
Seat 5: Pt637jKksB5MzP0UNJAAkw ($9.20 in chips) 
Seat 6: 6RiVTYll/5D8zICp0MRpKw ($23.70 in chips) 
Seat 7: 5n7e7I+px7c6CQmLpPbtsg ($5.75 in chips) 
Seat 8: 0XACOSNrAWmqNv9k1nF8rw ($14.65 in chips) 
Seat 9: UNw/UrAelsQeSS17Rro/BA ($10.65 in chips) 
UNw/UrAelsQeSS17Rro/BA: posts small blind $0.10
ydoFOVgzvZv9ZhuWu9rXAw: posts big blind $0.25
*** HOLE CARDS ***
rQhYIYXSyH/IivYM1dlV5A: folds 
ghNKXUBl/H+t83JF079ZBA: folds 
DnDcAdn9P0zGovMERigpFA: folds 
Pt637jKksB5MzP0UNJAAkw: folds 
6RiVTYll/5D8zICp0MRpKw has timed out
6RiVTYll/5D8zICp0MRpKw: folds 
6RiVTYll/5D8zICp0MRpKw is sitting out
6RiVTYll/5D8zICp0MRpKw has returned
5n7e7I+px7c6CQmLpPbtsg: folds 
0XACOSNrAWmqNv9k1nF8rw: folds 
UNw/UrAelsQeSS17Rro/BA: calls $0.15
ydoFOVgzvZv9ZhuWu9rXAw: checks 
*** FLOP *** [4d Th 8h]
UNw/UrAelsQeSS17Rro/BA: bets $0.75
ydoFOVgzvZv9ZhuWu9rXAw: folds 
Uncalled bet ($0.75) returned to UNw/UrAelsQeSS17Rro/BA
UNw/UrAelsQeSS17Rro/BA collected $0.50 from pot
*** SUMMARY ***
Total pot $0.50 | Rake $0 
Board [4d Th 8h]
Seat 1: ydoFOVgzvZv9ZhuWu9rXAw (big blind) folded on the Flop
Seat 2: rQhYIYXSyH/IivYM1dlV5A folded before Flop (didn't bet)
Seat 3: ghNKXUBl/H+t83JF079ZBA folded before Flop (didn't bet)
Seat 4: DnDcAdn9P0zGovMERigpFA folded before Flop (didn't bet)
Seat 5: Pt637jKksB5MzP0UNJAAkw folded before Flop (didn't bet)
Seat 6: 6RiVTYll/5D8zICp0MRpKw folded before Flop (didn't bet)
Seat 7: 5n7e7I+px7c6CQmLpPbtsg folded before Flop (didn't bet)
Seat 8: 0XACOSNrAWmqNv9k1nF8rw (button) folded before Flop (didn't bet)
Seat 9: UNw/UrAelsQeSS17Rro/BA (small blind) collected ($0.50)




PokerStars Game #59941781498:  Hold'em No Limit ($0.10/$0.25) - 2009/07/01 1:45:57 ET
Table 'nyTW9cVtYentc5V7xU/0jA' 6-max Seat #3 is the button
Seat 1: HI20pVxSHPZ29u9IDkmICg ($12.35 in chips) 
Seat 2: v6mkGzCBCCXcgWQNSYVtKg ($5.80 in chips) 
Seat 3: kG34n23qFQA3nzdOJTQ1dA ($35.75 in chips) 
Seat 4: NkB3D4eVHHXvB9Edaugc1Q ($32.30 in chips) 
Seat 5: zZAcuQ0EvirdEuiIbeaocQ ($7.10 in chips) 
NkB3D4eVHHXvB9Edaugc1Q: posts small blind $0.10
zZAcuQ0EvirdEuiIbeaocQ: posts big blind $0.25
*** HOLE CARDS ***
HI20pVxSHPZ29u9IDkmICg: raises $0.50 to $0.75
v6mkGzCBCCXcgWQNSYVtKg: folds 
kG34n23qFQA3nzdOJTQ1dA: folds 
NkB3D4eVHHXvB9Edaugc1Q: folds 
zZAcuQ0EvirdEuiIbeaocQ: calls $0.50
*** FLOP *** [Ac 8h 3d]
zZAcuQ0EvirdEuiIbeaocQ: checks 
HI20pVxSHPZ29u9IDkmICg: bets $0.75
zZAcuQ0EvirdEuiIbeaocQ: folds 
Uncalled bet ($0.75) returned to HI20pVxSHPZ29u9IDkmICg
HI20pVxSHPZ29u9IDkmICg collected $1.55 from pot
*** SUMMARY ***
Total pot $1.60 | Rake $0.05 
Board [Ac 8h 3d]
Seat 1: HI20pVxSHPZ29u9IDkmICg collected ($1.55)
Seat 2: v6mkGzCBCCXcgWQNSYVtKg folded before Flop (didn't bet)
Seat 3: kG34n23qFQA3nzdOJTQ1dA (button) folded before Flop (didn't bet)
Seat 4: NkB3D4eVHHXvB9Edaugc1Q (small blind) folded before Flop
Seat 5: zZAcuQ0EvirdEuiIbeaocQ (big blind) folded on the Flop




PokerStars Game #59941781408:  Hold'em No Limit ($0.10/$0.25) - 2009/07/01 1:45:57 ET
Table 'mF3KHGMaTpaBZbtBoyfTeg' 6-max Seat #1 is the button
Seat 1: 0HAB2GdCAM7p7V00xueAVQ ($23.90 in chips) 
Seat 3: 9kUKGKkblnIx3m8rlVol6Q ($10.20 in chips) 
Seat 4: FYepjhAvF8ZdVCmqHIy+eQ ($25 in chips) 
Seat 5: 8ClCHtFXGNplITm+63KB+Q ($44.30 in chips) 
Seat 6: kG34n23qFQA3nzdOJTQ1dA ($27.15 in chips) 
xrf8tAXKQHG99HixCot1Iw will be allowed to play after the button
9kUKGKkblnIx3m8rlVol6Q: posts small blind $0.10
FYepjhAvF8ZdVCmqHIy+eQ: posts big blind $0.25
*** HOLE CARDS ***
8ClCHtFXGNplITm+63KB+Q: folds 
kG34n23qFQA3nzdOJTQ1dA: folds 
0HAB2GdCAM7p7V00xueAVQ: folds 
9kUKGKkblnIx3m8rlVol6Q: calls $0.15
FYepjhAvF8ZdVCmqHIy+eQ: raises $0.75 to $1
9kUKGKkblnIx3m8rlVol6Q: calls $0.75
*** FLOP *** [8c 5c 5s]
9kUKGKkblnIx3m8rlVol6Q: checks 
FYepjhAvF8ZdVCmqHIy+eQ: checks 
*** TURN *** [8c 5c 5s] [7d]
9kUKGKkblnIx3m8rlVol6Q: checks 
FYepjhAvF8ZdVCmqHIy+eQ: checks 
*** RIVER *** [8c 5c 5s 7d] [9h]
9kUKGKkblnIx3m8rlVol6Q: checks 
FYepjhAvF8ZdVCmqHIy+eQ: checks 
*** SHOW DOWN ***
9kUKGKkblnIx3m8rlVol6Q: shows [Jd 9d] (two pair, Nines and Fives)
FYepjhAvF8ZdVCmqHIy+eQ: mucks hand 
9kUKGKkblnIx3m8rlVol6Q collected $1.90 from pot
*** SUMMARY ***
Total pot $2 | Rake $0.10 
Board [8c 5c 5s 7d 9h]
Seat 1: 0HAB2GdCAM7p7V00xueAVQ (button) folded before Flop (didn't bet)
Seat 3: 9kUKGKkblnIx3m8rlVol6Q (small blind) showed [Jd 9d] and won ($1.90) with two pair, Nines and Fives
Seat 4: FYepjhAvF8ZdVCmqHIy+eQ (big blind) mucked
Seat 5: 8ClCHtFXGNplITm+63KB+Q folded before Flop (didn't bet)
Seat 6: kG34n23qFQA3nzdOJTQ1dA folded before Flop (didn't bet)




PokerStars Game #59941781162:  Hold'em No Limit ($0.10/$0.25) - 2009/07/01 1:45:57 ET
Table '2VkNDXXsBj4bSZw/uK5atw' 6-max Seat #2 is the button
Seat 1: xrf8tAXKQHG99HixCot1Iw ($25 in chips) 
Seat 2: v6mkGzCBCCXcgWQNSYVtKg ($12.45 in chips) 
Seat 5: 7f0OkhFEOf3T+rVOFHRLnw ($19.80 in chips) 
Seat 6: n6UPMnVR4v8LFP0rWP73Fg ($12.50 in chips) 
P+6Z5+8H5/Wyt/jHMovNvQ will be allowed to play after the button
4kIRqWKE/N0yUAcWVhLSoQ will be allowed to play after the button
7f0OkhFEOf3T+rVOFHRLnw: posts small blind $0.10
n6UPMnVR4v8LFP0rWP73Fg: posts big blind $0.25
*** HOLE CARDS ***
xrf8tAXKQHG99HixCot1Iw: folds 
v6mkGzCBCCXcgWQNSYVtKg: folds 
7f0OkhFEOf3T+rVOFHRLnw: raises $0.50 to $0.75
n6UPMnVR4v8LFP0rWP73Fg: folds 
Uncalled bet ($0.50) returned to 7f0OkhFEOf3T+rVOFHRLnw
7f0OkhFEOf3T+rVOFHRLnw collected $0.50 from pot
*** SUMMARY ***
Total pot $0.50 | Rake $0 
Seat 1: xrf8tAXKQHG99HixCot1Iw folded before Flop (didn't bet)
Seat 2: v6mkGzCBCCXcgWQNSYVtKg (button) folded before Flop (didn't bet)
Seat 5: 7f0OkhFEOf3T+rVOFHRLnw (small blind) collected ($0.50)
Seat 6: n6UPMnVR4v8LFP0rWP73Fg (big blind) folded before Flop




PokerStars Game #59941781692:  Hold'em No Limit ($0.10/$0.25) - 2009/07/01 1:45:58 ET
Table 'qInMnOOn7vKcj4bU7zju7g' 9-max Seat #5 is the button
Seat 1: CT7Xj/V/O5rBlhtt+RZeFQ ($38.40 in chips) 
Seat 2: HgIyqrvSG8TRRZl5mlzfHA ($68.10 in chips) 
Seat 3: zDrucyjVn5aeekNEc3cJrA ($26.05 in chips) 
Seat 4: ScCuCTbi71/EWsLKZXaZeg ($16.15 in chips) 
Seat 5: KlccfkOygm1GJZoSZYEgBw ($14.15 in chips) 
Seat 6: 4awUyiDYTgylQKXZ9faBVA ($25 in chips) 
Seat 8: Mh2r9hTeTEDnh19sRZtW3g ($5.70 in chips) 
Seat 9: sbArFaUiGjfmf5dg1O4ffg ($3.70 in chips) 
4awUyiDYTgylQKXZ9faBVA: posts small blind $0.10
DdPXdieucQ+n99u1n3A+rQ: is sitting out 
Mh2r9hTeTEDnh19sRZtW3g: posts big blind $0.25
*** HOLE CARDS ***
DdPXdieucQ+n99u1n3A+rQ leaves the table
sbArFaUiGjfmf5dg1O4ffg: folds 
CT7Xj/V/O5rBlhtt+RZeFQ: folds 
HgIyqrvSG8TRRZl5mlzfHA: calls $0.25
zDrucyjVn5aeekNEc3cJrA: calls $0.25
ScCuCTbi71/EWsLKZXaZeg: raises $0.25 to $0.50
KlccfkOygm1GJZoSZYEgBw: calls $0.50
4awUyiDYTgylQKXZ9faBVA: folds 
st9jtdNbm1W5GfBwRaCVqQ joins the table at seat #7 
Mh2r9hTeTEDnh19sRZtW3g: folds 
HgIyqrvSG8TRRZl5mlzfHA: folds 
zDrucyjVn5aeekNEc3cJrA: folds 
*** FLOP *** [5c 5h 3d]
ScCuCTbi71/EWsLKZXaZeg: checks 
KlccfkOygm1GJZoSZYEgBw: checks 
*** TURN *** [5c 5h 3d] [5d]
ScCuCTbi71/EWsLKZXaZeg: bets $2
KlccfkOygm1GJZoSZYEgBw: folds 
Uncalled bet ($2) returned to ScCuCTbi71/EWsLKZXaZeg
ScCuCTbi71/EWsLKZXaZeg collected $1.80 from pot
*** SUMMARY ***
Total pot $1.85 | Rake $0.05 
Board [5c 5h 3d 5d]
Seat 1: CT7Xj/V/O5rBlhtt+RZeFQ folded before Flop (didn't bet)
Seat 2: HgIyqrvSG8TRRZl5mlzfHA folded before Flop
Seat 3: zDrucyjVn5aeekNEc3cJrA folded before Flop
Seat 4: ScCuCTbi71/EWsLKZXaZeg collected ($1.80)
Seat 5: KlccfkOygm1GJZoSZYEgBw (button) folded on the Turn
Seat 6: 4awUyiDYTgylQKXZ9faBVA (small blind) folded before Flop
Seat 8: Mh2r9hTeTEDnh19sRZtW3g (big blind) folded before Flop
Seat 9: sbArFaUiGjfmf5dg1O4ffg folded before Flop (didn't bet)




PokerStars Game #59941781726:  Hold'em No Limit ($0.10/$0.25) - 2009/07/01 1:45:58 ET
Table 'vud0GB/ZlDCvUFhBFIaTlg' 9-max Seat #9 is the button
Seat 1: DiSvPC2iudwL5j9u6Huyww ($29 in chips) 
Seat 2: tLcDklc2rBORNfixyRfVfw ($26.30 in chips) 
Seat 3: W2YYHvqjaEpRrO7stZkClQ ($4.30 in chips) 
Seat 4: dWgEDExmVO0d+rRmUYCU5w ($15.35 in chips) 
Seat 5: eK8qa6EPcH2zhtbmWSvc9g ($25 in chips) 
Seat 6: gehe91e0IyVT0QU/XBkEyg ($25 in chips) 
Seat 7: iG7VeTyBWf6wYNvZpbTcbw ($20.05 in chips) 
Seat 9: PdIasPkzm2sqZnN41ZRXOg ($5.20 in chips) 
DiSvPC2iudwL5j9u6Huyww: posts small blind $0.10
tLcDklc2rBORNfixyRfVfw: posts big blind $0.25
E0iYnEVO2ho7dH3QcCjw7g: sits out 
*** HOLE CARDS ***
W2YYHvqjaEpRrO7stZkClQ: folds 
dWgEDExmVO0d+rRmUYCU5w: calls $0.25
eK8qa6EPcH2zhtbmWSvc9g: folds 
gehe91e0IyVT0QU/XBkEyg: folds 
iG7VeTyBWf6wYNvZpbTcbw: folds 
PdIasPkzm2sqZnN41ZRXOg: folds 
DiSvPC2iudwL5j9u6Huyww: calls $0.15
tLcDklc2rBORNfixyRfVfw: checks 
*** FLOP *** [4c Ts 9d]
DiSvPC2iudwL5j9u6Huyww: checks 
tLcDklc2rBORNfixyRfVfw: checks 
dWgEDExmVO0d+rRmUYCU5w: checks 
*** TURN *** [4c Ts 9d] [5d]
DiSvPC2iudwL5j9u6Huyww: checks 
tLcDklc2rBORNfixyRfVfw: checks 
dWgEDExmVO0d+rRmUYCU5w: checks 
*** RIVER *** [4c Ts 9d 5d] [Kc]
DiSvPC2iudwL5j9u6Huyww: bets $0.50
tLcDklc2rBORNfixyRfVfw: folds 
dWgEDExmVO0d+rRmUYCU5w: folds 
Uncalled bet ($0.50) returned to DiSvPC2iudwL5j9u6Huyww
DiSvPC2iudwL5j9u6Huyww collected $0.75 from pot
DiSvPC2iudwL5j9u6Huyww: doesn't show hand 
*** SUMMARY ***
Total pot $0.75 | Rake $0 
Board [4c Ts 9d 5d Kc]
Seat 1: DiSvPC2iudwL5j9u6Huyww (small blind) collected ($0.75)
Seat 2: tLcDklc2rBORNfixyRfVfw (big blind) folded on the River
Seat 3: W2YYHvqjaEpRrO7stZkClQ folded before Flop (didn't bet)
Seat 4: dWgEDExmVO0d+rRmUYCU5w folded on the River
Seat 5: eK8qa6EPcH2zhtbmWSvc9g folded before Flop (didn't bet)
Seat 6: gehe91e0IyVT0QU/XBkEyg folded before Flop (didn't bet)
Seat 7: iG7VeTyBWf6wYNvZpbTcbw folded before Flop (didn't bet)
Seat 9: PdIasPkzm2sqZnN41ZRXOg (button) folded before Flop (didn't bet)




PokerStars Game #59941781674:  Hold'em No Limit ($0.10/$0.25) - 2009/07/01 1:45:58 ET
Table '0M5QEJGOThqZwQ/sjbjXYw' 6-max Seat #4 is the button
Seat 2: /gJNBeCkWL4o85/jvlZ4BA ($34.60 in chips) 
Seat 3: 3zD3qLXT1bEffAoWGnc7wg ($25 in chips) 
Seat 4: oBUDUfeUyCbZBsjxHZgSiw ($22.25 in chips) 
Seat 5: cWc85bEzdRzpUMhRKm8pwQ ($27.30 in chips) 
Seat 6: bb63I02U6p9a5MNFa1gCiw ($27.25 in chips) 
cWc85bEzdRzpUMhRKm8pwQ: posts small blind $0.10
bb63I02U6p9a5MNFa1gCiw: posts big blind $0.25
*** HOLE CARDS ***
/gJNBeCkWL4o85/jvlZ4BA: folds 
3zD3qLXT1bEffAoWGnc7wg: folds 
oBUDUfeUyCbZBsjxHZgSiw: folds 
cWc85bEzdRzpUMhRKm8pwQ: raises $0.75 to $1
bb63I02U6p9a5MNFa1gCiw: calls $0.75
*** FLOP *** [3d Ac 7d]
cWc85bEzdRzpUMhRKm8pwQ: bets $1.50
bb63I02U6p9a5MNFa1gCiw: folds 
Uncalled bet ($1.50) returned to cWc85bEzdRzpUMhRKm8pwQ
cWc85bEzdRzpUMhRKm8pwQ collected $1.90 from pot
*** SUMMARY ***
Total pot $2 | Rake $0.10 
Board [3d Ac 7d]
Seat 2: /gJNBeCkWL4o85/jvlZ4BA folded before Flop (didn't bet)
Seat 3: 3zD3qLXT1bEffAoWGnc7wg folded before Flop (didn't bet)
Seat 4: oBUDUfeUyCbZBsjxHZgSiw (button) folded before Flop (didn't bet)
Seat 5: cWc85bEzdRzpUMhRKm8pwQ (small blind) collected ($1.90)
Seat 6: bb63I02U6p9a5MNFa1gCiw (big blind) folded on the Flop




PokerStars Game #59941781562:  Hold'em No Limit ($0.10/$0.25) - 2009/07/01 1:45:58 ET
Table 'KTZXQ4LREPjpS54R3DFTsw' 9-max Seat #2 is the button
Seat 1: dSjkBIV7Bv+ZCIWNBguf7w ($40.85 in chips) 
Seat 2: OlPJsgR4xypSg/w1z7Gyvw ($19.50 in chips) 
Seat 3: H5Se03ZqSX7tbULXur2MAg ($23.40 in chips) 
Seat 4: K0b5wNInj6hUGRr6yzKFtw ($64 in chips) 
Seat 5: HPEB+AtKw1+C/cxU0o1ciw ($29.95 in chips) 
Seat 6: Mh2r9hTeTEDnh19sRZtW3g ($5.70 in chips) 
Seat 7: yyG4svzOpC1A+sUP/scg6w ($10.95 in chips) 
Seat 8: X1ucS3BHyBPongKl1Q+eEQ ($18.60 in chips) 
Seat 9: V6p0jQ/RhUsqpHLmXvEX4Q ($13.45 in chips) 
H5Se03ZqSX7tbULXur2MAg: posts small blind $0.10
K0b5wNInj6hUGRr6yzKFtw: posts big blind $0.25
*** HOLE CARDS ***
HPEB+AtKw1+C/cxU0o1ciw: folds 
Mh2r9hTeTEDnh19sRZtW3g: folds 
yyG4svzOpC1A+sUP/scg6w: folds 
X1ucS3BHyBPongKl1Q+eEQ: folds 
V6p0jQ/RhUsqpHLmXvEX4Q: folds 
X1ucS3BHyBPongKl1Q+eEQ leaves the table
dSjkBIV7Bv+ZCIWNBguf7w has timed out
dSjkBIV7Bv+ZCIWNBguf7w: folds 
dSjkBIV7Bv+ZCIWNBguf7w is sitting out
dSjkBIV7Bv+ZCIWNBguf7w has returned
OlPJsgR4xypSg/w1z7Gyvw: folds 
H5Se03ZqSX7tbULXur2MAg: folds 
Uncalled bet ($0.15) returned to K0b5wNInj6hUGRr6yzKFtw
K0b5wNInj6hUGRr6yzKFtw collected $0.20 from pot
K0b5wNInj6hUGRr6yzKFtw: doesn't show hand 
*** SUMMARY ***
Total pot $0.20 | Rake $0 
Seat 1: dSjkBIV7Bv+ZCIWNBguf7w folded before Flop (didn't bet)
Seat 2: OlPJsgR4xypSg/w1z7Gyvw (button) folded before Flop (didn't bet)
Seat 3: H5Se03ZqSX7tbULXur2MAg (small blind) folded before Flop
Seat 4: K0b5wNInj6hUGRr6yzKFtw (big blind) collected ($0.20)
Seat 5: HPEB+AtKw1+C/cxU0o1ciw folded before Flop (didn't bet)
Seat 6: Mh2r9hTeTEDnh19sRZtW3g folded before Flop (didn't bet)
Seat 7: yyG4svzOpC1A+sUP/scg6w folded before Flop (didn't bet)
Seat 8: X1ucS3BHyBPongKl1Q+eEQ folded before Flop (didn't bet)
Seat 9: V6p0jQ/RhUsqpHLmXvEX4Q folded before Flop (didn't bet)




PokerStars Game #59941782092:  Hold'em No Limit ($0.10/$0.25) - 2009/07/01 1:45:58 ET
Table 'fRxOyfaHXkWUDLv4eSxFew' 9-max Seat #1 is the button
Seat 1: 6RiVTYll/5D8zICp0MRpKw ($28.80 in chips) 
Seat 2: M2QO2DxB5Wawg2h8HSpnYA ($10.10 in chips) 
Seat 3: E0iYnEVO2ho7dH3QcCjw7g ($20 in chips) 
Seat 4: MtVtHDqIJTyUcXkRBBDIVA ($27.95 in chips) 
Seat 5: dmYlc+1cjwZMJ7wV+Z0rRg ($22.75 in chips) 
Seat 6: arxNSjreDRGFg13EAM2F1w ($27.05 in chips) 
Seat 7: 1/DuWziR8CXhWB71aPQd9Q ($11.80 in chips) 
Seat 8: 5n7e7I+px7c6CQmLpPbtsg ($5.90 in chips) 
Seat 9: H5Se03ZqSX7tbULXur2MAg ($32.65 in chips) 
M2QO2DxB5Wawg2h8HSpnYA: posts small blind $0.10
E0iYnEVO2ho7dH3QcCjw7g: posts big blind $0.25
*** HOLE CARDS ***
MtVtHDqIJTyUcXkRBBDIVA: folds 
dmYlc+1cjwZMJ7wV+Z0rRg: folds 
arxNSjreDRGFg13EAM2F1w: folds 
1/DuWziR8CXhWB71aPQd9Q: folds 
5n7e7I+px7c6CQmLpPbtsg: folds 
H5Se03ZqSX7tbULXur2MAg: folds 
6RiVTYll/5D8zICp0MRpKw: folds 
M2QO2DxB5Wawg2h8HSpnYA: folds 
Uncalled bet ($0.15) returned to E0iYnEVO2ho7dH3QcCjw7g
E0iYnEVO2ho7dH3QcCjw7g collected $0.20 from pot
*** SUMMARY ***
Total pot $0.20 | Rake $0 
Seat 1: 6RiVTYll/5D8zICp0MRpKw (button) folded before Flop (didn't bet)
Seat 2: M2QO2DxB5Wawg2h8HSpnYA (small blind) folded before Flop
Seat 3: E0iYnEVO2ho7dH3QcCjw7g (big blind) collected ($0.20)
Seat 4: MtVtHDqIJTyUcXkRBBDIVA folded before Flop (didn't bet)
Seat 5: dmYlc+1cjwZMJ7wV+Z0rRg folded before Flop (didn't bet)
Seat 6: arxNSjreDRGFg13EAM2F1w folded before Flop (didn't bet)
Seat 7: 1/DuWziR8CXhWB71aPQd9Q folded before Flop (didn't bet)
Seat 8: 5n7e7I+px7c6CQmLpPbtsg folded before Flop (didn't bet)
Seat 9: H5Se03ZqSX7tbULXur2MAg folded before Flop (didn't bet)




PokerStars Game #59941781760:  Hold'em No Limit ($0.10/$0.25) - 2009/07/01 1:45:58 ET
Table 'L5GvbdQO5aCZJSE6pyQ8OA' 6-max Seat #6 is the button
Seat 1: eFj4lr1nuXLyCWNTShr1bg ($11.20 in chips) 
Seat 2: DihMHaz4WNETH1bPDe13kA ($31.30 in chips) 
Seat 3: JFIAqU8lCZ0vWwEl4bdGsg ($25.45 in chips) 
Seat 4: trN/oHqTTbPw5MNuKrOpLw ($28.65 in chips) 
Seat 5: LyDHtw3/yniNHW+DvLXbog ($26.65 in chips) 
Seat 6: v+QfkGiuj9bgtuNoVnDO8w ($39.05 in chips) 
eFj4lr1nuXLyCWNTShr1bg: posts small blind $0.10
DihMHaz4WNETH1bPDe13kA: posts big blind $0.25
*** HOLE CARDS ***
JFIAqU8lCZ0vWwEl4bdGsg: folds 
trN/oHqTTbPw5MNuKrOpLw: folds 
LyDHtw3/yniNHW+DvLXbog: raises $0.75 to $1
v+QfkGiuj9bgtuNoVnDO8w: folds 
eFj4lr1nuXLyCWNTShr1bg: folds 
eFj4lr1nuXLyCWNTShr1bg is sitting out
DihMHaz4WNETH1bPDe13kA: folds 
Uncalled bet ($0.75) returned to LyDHtw3/yniNHW+DvLXbog
LyDHtw3/yniNHW+DvLXbog collected $0.60 from pot
LyDHtw3/yniNHW+DvLXbog: doesn't show hand 
*** SUMMARY ***
Total pot $0.60 | Rake $0 
Seat 1: eFj4lr1nuXLyCWNTShr1bg (small blind) folded before Flop
Seat 2: DihMHaz4WNETH1bPDe13kA (big blind) folded before Flop
Seat 3: JFIAqU8lCZ0vWwEl4bdGsg folded before Flop (didn't bet)
Seat 4: trN/oHqTTbPw5MNuKrOpLw folded before Flop (didn't bet)
Seat 5: LyDHtw3/yniNHW+DvLXbog collected ($0.60)
Seat 6: v+QfkGiuj9bgtuNoVnDO8w (button) folded before Flop (didn't bet)




PokerStars Game #59941781852:  Hold'em No Limit ($0.10/$0.25) - 2009/07/01 1:45:58 ET
Table 'nlpa8xI95gAflovnFxB2yg' 6-max Seat #1 is the button
Seat 1: fZQg9veL7Dd/Z04ZTjC+wQ ($61.80 in chips) 
Seat 2: Yuyy/pDz3yAO3EbHYRYnKw ($24.15 in chips) 
Seat 3: DihMHaz4WNETH1bPDe13kA ($25 in chips) 
Seat 4: if4dh6jhJXeN3/qd3qCp9g ($52.35 in chips) 
Seat 5: FDWzjQgBA5K04jOIY/j22w ($5.80 in chips) 
Seat 6: ATNFxN8fYVfSZMQW8dvbvw ($5.65 in chips) 
Yuyy/pDz3yAO3EbHYRYnKw: posts small blind $0.10
DihMHaz4WNETH1bPDe13kA: posts big blind $0.25
*** HOLE CARDS ***
if4dh6jhJXeN3/qd3qCp9g: folds 
FDWzjQgBA5K04jOIY/j22w: folds 
ATNFxN8fYVfSZMQW8dvbvw: folds 
fZQg9veL7Dd/Z04ZTjC+wQ: folds 
Yuyy/pDz3yAO3EbHYRYnKw: raises $0.50 to $0.75
DihMHaz4WNETH1bPDe13kA: folds 
Uncalled bet ($0.50) returned to Yuyy/pDz3yAO3EbHYRYnKw
Yuyy/pDz3yAO3EbHYRYnKw collected $0.50 from pot
Yuyy/pDz3yAO3EbHYRYnKw: doesn't show hand 
*** SUMMARY ***
Total pot $0.50 | Rake $0 
Seat 1: fZQg9veL7Dd/Z04ZTjC+wQ (button) folded before Flop (didn't bet)
Seat 2: Yuyy/pDz3yAO3EbHYRYnKw (small blind) collected ($0.50)
Seat 3: DihMHaz4WNETH1bPDe13kA (big blind) folded before Flop
Seat 4: if4dh6jhJXeN3/qd3qCp9g folded before Flop (didn't bet)
Seat 5: FDWzjQgBA5K04jOIY/j22w folded before Flop (didn't bet)
Seat 6: ATNFxN8fYVfSZMQW8dvbvw folded before Flop (didn't bet)




PokerStars Game #59941782472:  Hold'em No Limit ($0.10/$0.25) - 2009/07/01 1:45:59 ET
Table 'Loy/olZ5qoDOSvX4UTujGg' 6-max Seat #1 is the button
Seat 1: HipgaJhkN4ie/tTw4dK3Ug ($11.50 in chips) 
Seat 2: 4z7mPbMLNp4TezHXin63Vw ($16.15 in chips) 
Seat 3: 32YL2ZEp8NT4JB2RVM9euQ ($15.70 in chips) 
Seat 4: /gJNBeCkWL4o85/jvlZ4BA ($30.75 in chips) 
Seat 5: Ar4vsUIUfJ7gbYh1c1m59g ($14.75 in chips) 
Seat 6: qGHGf/553gQnDoklMRe3tg ($26.15 in chips) 
4z7mPbMLNp4TezHXin63Vw: posts small blind $0.10
32YL2ZEp8NT4JB2RVM9euQ: posts big blind $0.25
*** HOLE CARDS ***
/gJNBeCkWL4o85/jvlZ4BA: raises $0.75 to $1
Ar4vsUIUfJ7gbYh1c1m59g: folds 
HipgaJhkN4ie/tTw4dK3Ug said, "i had AQ"
qGHGf/553gQnDoklMRe3tg: folds 
HipgaJhkN4ie/tTw4dK3Ug: folds 
4z7mPbMLNp4TezHXin63Vw: folds 
32YL2ZEp8NT4JB2RVM9euQ: folds 
Uncalled bet ($0.75) returned to /gJNBeCkWL4o85/jvlZ4BA
/gJNBeCkWL4o85/jvlZ4BA collected $0.60 from pot
*** SUMMARY ***
Total pot $0.60 | Rake $0 
Seat 1: HipgaJhkN4ie/tTw4dK3Ug (button) folded before Flop (didn't bet)
Seat 2: 4z7mPbMLNp4TezHXin63Vw (small blind) folded before Flop
Seat 3: 32YL2ZEp8NT4JB2RVM9euQ (big blind) folded before Flop
Seat 4: /gJNBeCkWL4o85/jvlZ4BA collected ($0.60)
Seat 5: Ar4vsUIUfJ7gbYh1c1m59g folded before Flop (didn't bet)
Seat 6: qGHGf/553gQnDoklMRe3tg folded before Flop (didn't bet)




PokerStars Game #59941782480:  Hold'em No Limit ($0.10/$0.25) - 2009/07/01 1:45:59 ET
Table 'vZfV/Uj0q8joA1du9sRJSg' 6-max Seat #2 is the button
Seat 1: Hsvkc0/G2VV78oVmWYXecw ($6.05 in chips) 
Seat 2: wMiE3yTbDJGOLOF9th7KPA ($5.40 in chips) 
Seat 3: cWc85bEzdRzpUMhRKm8pwQ ($25 in chips) 
Seat 4: v+QfkGiuj9bgtuNoVnDO8w ($44.35 in chips) 
Seat 5: kyRaCIljYA6l33lSKQfNsg ($27.85 in chips) 
Seat 6: 8ClCHtFXGNplITm+63KB+Q ($49.05 in chips) 
cWc85bEzdRzpUMhRKm8pwQ: posts small blind $0.10
v+QfkGiuj9bgtuNoVnDO8w: posts big blind $0.25
*** HOLE CARDS ***
kyRaCIljYA6l33lSKQfNsg: raises $0.50 to $0.75
8ClCHtFXGNplITm+63KB+Q: folds 
Hsvkc0/G2VV78oVmWYXecw: folds 
wMiE3yTbDJGOLOF9th7KPA: calls $0.75
cWc85bEzdRzpUMhRKm8pwQ: folds 
v+QfkGiuj9bgtuNoVnDO8w: calls $0.50
*** FLOP *** [Td 6h 7c]
v+QfkGiuj9bgtuNoVnDO8w: checks 
kyRaCIljYA6l33lSKQfNsg: bets $0.75
wMiE3yTbDJGOLOF9th7KPA: calls $0.75
v+QfkGiuj9bgtuNoVnDO8w: folds 
*** TURN *** [Td 6h 7c] [Tc]
kyRaCIljYA6l33lSKQfNsg: bets $6.25
wMiE3yTbDJGOLOF9th7KPA: folds 
Uncalled bet ($6.25) returned to kyRaCIljYA6l33lSKQfNsg
kyRaCIljYA6l33lSKQfNsg collected $3.70 from pot
*** SUMMARY ***
Total pot $3.85 | Rake $0.15 
Board [Td 6h 7c Tc]
Seat 1: Hsvkc0/G2VV78oVmWYXecw folded before Flop (didn't bet)
Seat 2: wMiE3yTbDJGOLOF9th7KPA (button) folded on the Turn
Seat 3: cWc85bEzdRzpUMhRKm8pwQ (small blind) folded before Flop
Seat 4: v+QfkGiuj9bgtuNoVnDO8w (big blind) folded on the Flop
Seat 5: kyRaCIljYA6l33lSKQfNsg collected ($3.70)
Seat 6: 8ClCHtFXGNplITm+63KB+Q folded before Flop (didn't bet)




PokerStars Game #59941782568:  Hold'em No Limit ($0.10/$0.25) - 2009/07/01 1:45:59 ET
Table 'T/iCKJXGphRN3xcdwfE/JQ' 6-max Seat #2 is the button
Seat 1: wAKC8C/zN0c8V5v13dm9mA ($25.35 in chips) 
Seat 2: EeUZtMU058v2ObUACOF4Og ($32 in chips) 
Seat 3: IWAjoCPXtc1XUaZdp+pCpA ($23.10 in chips) 
Seat 5: gaPMxLGp9SOj4Lq6t+/0Ig ($8.10 in chips) 
Seat 6: Ey4Kn6PlnYb2srYYBJHvzg ($13.55 in chips) 
IWAjoCPXtc1XUaZdp+pCpA: posts small blind $0.10
gaPMxLGp9SOj4Lq6t+/0Ig: posts big blind $0.25
*** HOLE CARDS ***
Ey4Kn6PlnYb2srYYBJHvzg: calls $0.25
wAKC8C/zN0c8V5v13dm9mA: folds 
EeUZtMU058v2ObUACOF4Og: folds 
IWAjoCPXtc1XUaZdp+pCpA: calls $0.15
m2yWOKfAxqHoy5DDN87Ttw joins the table at seat #4 
gaPMxLGp9SOj4Lq6t+/0Ig: checks 
*** FLOP *** [5h Qs Qc]
IWAjoCPXtc1XUaZdp+pCpA: checks 
gaPMxLGp9SOj4Lq6t+/0Ig: checks 
Ey4Kn6PlnYb2srYYBJHvzg: bets $1
IWAjoCPXtc1XUaZdp+pCpA: folds 
gaPMxLGp9SOj4Lq6t+/0Ig: folds 
Uncalled bet ($1) returned to Ey4Kn6PlnYb2srYYBJHvzg
Ey4Kn6PlnYb2srYYBJHvzg collected $0.75 from pot
*** SUMMARY ***
Total pot $0.75 | Rake $0 
Board [5h Qs Qc]
Seat 1: wAKC8C/zN0c8V5v13dm9mA folded before Flop (didn't bet)
Seat 2: EeUZtMU058v2ObUACOF4Og (button) folded before Flop (didn't bet)
Seat 3: IWAjoCPXtc1XUaZdp+pCpA (small blind) folded on the Flop
Seat 5: gaPMxLGp9SOj4Lq6t+/0Ig (big blind) folded on the Flop
Seat 6: Ey4Kn6PlnYb2srYYBJHvzg collected ($0.75)




PokerStars Game #59941782800:  Hold'em No Limit ($0.10/$0.25) - 2009/07/01 1:46:00 ET
Table 'hg+KpirwreMnBAFQr/SEUA' 9-max Seat #8 is the button
Seat 1: H5Se03ZqSX7tbULXur2MAg ($33.80 in chips) 
Seat 2: cpnBzHjFACn5zAY56UIvNA ($20.60 in chips) 
Seat 3: DdyXKuBx0HAOC7dWZmGxWg ($24.25 in chips) 
Seat 5: +2kMBNpY4nF1qNCRd8SJLA ($25 in chips) 
Seat 6: Bb42QRQMhg5/Y0vHP8/2Xw ($25.35 in chips) 
Seat 7: 5LSuZS4qvcUri/Byfkln7w ($7.50 in chips) 
Seat 8: HPEB+AtKw1+C/cxU0o1ciw ($23.40 in chips) 
Seat 9: xbecloQJYmBOSkzT9lZ+rg ($20.25 in chips) 
xbecloQJYmBOSkzT9lZ+rg: posts small blind $0.10
H5Se03ZqSX7tbULXur2MAg: posts big blind $0.25
Z9W7+g1WMhhZDi7DwGbCFA: sits out 
*** HOLE CARDS ***
cpnBzHjFACn5zAY56UIvNA: folds 
DdyXKuBx0HAOC7dWZmGxWg: folds 
+2kMBNpY4nF1qNCRd8SJLA: folds 
Bb42QRQMhg5/Y0vHP8/2Xw: folds 
5LSuZS4qvcUri/Byfkln7w: calls $0.25
HPEB+AtKw1+C/cxU0o1ciw: folds 
xbecloQJYmBOSkzT9lZ+rg: calls $0.15
H5Se03ZqSX7tbULXur2MAg: checks 
*** FLOP *** [3s Td Qh]
xbecloQJYmBOSkzT9lZ+rg: checks 
H5Se03ZqSX7tbULXur2MAg: checks 
5LSuZS4qvcUri/Byfkln7w: checks 
*** TURN *** [3s Td Qh] [Js]
xbecloQJYmBOSkzT9lZ+rg: checks 
H5Se03ZqSX7tbULXur2MAg: checks 
5LSuZS4qvcUri/Byfkln7w: checks 
*** RIVER *** [3s Td Qh Js] [5c]
xbecloQJYmBOSkzT9lZ+rg: checks 
H5Se03ZqSX7tbULXur2MAg: checks 
5LSuZS4qvcUri/Byfkln7w: checks 
*** SHOW DOWN ***
xbecloQJYmBOSkzT9lZ+rg: shows [5s 8s] (a pair of Fives)
H5Se03ZqSX7tbULXur2MAg: shows [6d 6h] (a pair of Sixes)
5LSuZS4qvcUri/Byfkln7w: mucks hand 
H5Se03ZqSX7tbULXur2MAg collected $0.75 from pot
*** SUMMARY ***
Total pot $0.75 | Rake $0 
Board [3s Td Qh Js 5c]
Seat 1: H5Se03ZqSX7tbULXur2MAg (big blind) showed [6d 6h] and won ($0.75) with a pair of Sixes
Seat 2: cpnBzHjFACn5zAY56UIvNA folded before Flop (didn't bet)
Seat 3: DdyXKuBx0HAOC7dWZmGxWg folded before Flop (didn't bet)
Seat 5: +2kMBNpY4nF1qNCRd8SJLA folded before Flop (didn't bet)
Seat 6: Bb42QRQMhg5/Y0vHP8/2Xw folded before Flop (didn't bet)
Seat 7: 5LSuZS4qvcUri/Byfkln7w mucked
Seat 8: HPEB+AtKw1+C/cxU0o1ciw (button) folded before Flop (didn't bet)
Seat 9: xbecloQJYmBOSkzT9lZ+rg (small blind) showed [5s 8s] and lost with a pair of Fives




PokerStars Game #59941782916:  Hold'em No Limit ($0.10/$0.25) - 2009/07/01 1:46:00 ET
Table 'bIGKmJgZehWJ+FAo8b85iw' 9-max Seat #3 is the button
Seat 1: yyG4svzOpC1A+sUP/scg6w ($3.20 in chips) 
Seat 2: cCjRCvseA9rZn7Xr+GCCHg ($21.35 in chips) 
Seat 3: /FyMUX+W/tpNFcRWbUTJxQ ($23.50 in chips) 
Seat 4: LGxBRjCRn6KlQ/6B4eoXbA ($38.30 in chips) 
Seat 5: uLP/lYn7oKq9xCChBXsXxw ($25 in chips) 
Seat 6: PFNLAvMkr8qKc7xCiH0wTA ($18.45 in chips) 
Seat 8: +2kMBNpY4nF1qNCRd8SJLA ($54.20 in chips) 
Seat 9: aNpwfA31EREwO+ar4XzBCw ($31.75 in chips) 
LGxBRjCRn6KlQ/6B4eoXbA: posts small blind $0.10
uLP/lYn7oKq9xCChBXsXxw: posts big blind $0.25
mMd8CDS/but3UC+Zp7Up2w: sits out 
*** HOLE CARDS ***
PFNLAvMkr8qKc7xCiH0wTA: folds 
+2kMBNpY4nF1qNCRd8SJLA: folds 
aNpwfA31EREwO+ar4XzBCw: folds 
yyG4svzOpC1A+sUP/scg6w: folds 
cCjRCvseA9rZn7Xr+GCCHg: folds 
/FyMUX+W/tpNFcRWbUTJxQ: folds 
LGxBRjCRn6KlQ/6B4eoXbA: raises $1.75 to $2
uLP/lYn7oKq9xCChBXsXxw: folds 
Uncalled bet ($1.75) returned to LGxBRjCRn6KlQ/6B4eoXbA
LGxBRjCRn6KlQ/6B4eoXbA collected $0.50 from pot
LGxBRjCRn6KlQ/6B4eoXbA: doesn't show hand 
*** SUMMARY ***
Total pot $0.50 | Rake $0 
Seat 1: yyG4svzOpC1A+sUP/scg6w folded before Flop (didn't bet)
Seat 2: cCjRCvseA9rZn7Xr+GCCHg folded before Flop (didn't bet)
Seat 3: /FyMUX+W/tpNFcRWbUTJxQ (button) folded before Flop (didn't bet)
Seat 4: LGxBRjCRn6KlQ/6B4eoXbA (small blind) collected ($0.50)
Seat 5: uLP/lYn7oKq9xCChBXsXxw (big blind) folded before Flop
Seat 6: PFNLAvMkr8qKc7xCiH0wTA folded before Flop (didn't bet)
Seat 8: +2kMBNpY4nF1qNCRd8SJLA folded before Flop (didn't bet)
Seat 9: aNpwfA31EREwO+ar4XzBCw folded before Flop (didn't bet)




PokerStars Game #59941782830:  Hold'em No Limit ($0.10/$0.25) - 2009/07/01 1:46:00 ET
Table 'CM/C/FZf3VHIp50RjmBucQ' 9-max Seat #3 is the button
Seat 3: HPEB+AtKw1+C/cxU0o1ciw ($50.70 in chips) 
Seat 4: FYIiLXWy4mKC5ZGa/fnS0g ($15.75 in chips) 
Seat 5: t3m1RlE+8m1yb0ojo8ikCw ($15 in chips) 
Seat 6: FqpibuVWLNsAN/Z7ROZLnA ($7.65 in chips) 
FYIiLXWy4mKC5ZGa/fnS0g: posts small blind $0.10
t3m1RlE+8m1yb0ojo8ikCw: posts big blind $0.25
FqpibuVWLNsAN/Z7ROZLnA: posts big blind $0.25
*** HOLE CARDS ***
FqpibuVWLNsAN/Z7ROZLnA: raises $0.25 to $0.50
xUw035gj8xeH3frcgPyCVw has returned
xUw035gj8xeH3frcgPyCVw leaves the table
HPEB+AtKw1+C/cxU0o1ciw: folds 
FYIiLXWy4mKC5ZGa/fnS0g: folds 
t3m1RlE+8m1yb0ojo8ikCw: raises $0.50 to $1
FqpibuVWLNsAN/Z7ROZLnA: calls $0.50
*** FLOP *** [5h 8c Th]
t3m1RlE+8m1yb0ojo8ikCw: checks 
FqpibuVWLNsAN/Z7ROZLnA: bets $2.50
t3m1RlE+8m1yb0ojo8ikCw: folds 
Uncalled bet ($2.50) returned to FqpibuVWLNsAN/Z7ROZLnA
+aNWwNic2LVhXcMqH+ezrA joins the table at seat #2 
FqpibuVWLNsAN/Z7ROZLnA collected $2 from pot
P8h+GtgJJRwRh2YdssBtbg joins the table at seat #1 
FqpibuVWLNsAN/Z7ROZLnA: doesn't show hand 
*** SUMMARY ***
Total pot $2.10 | Rake $0.10 
Board [5h 8c Th]
Seat 3: HPEB+AtKw1+C/cxU0o1ciw (button) folded before Flop (didn't bet)
Seat 4: FYIiLXWy4mKC5ZGa/fnS0g (small blind) folded before Flop
Seat 5: t3m1RlE+8m1yb0ojo8ikCw (big blind) folded on the Flop
Seat 6: FqpibuVWLNsAN/Z7ROZLnA collected ($2)




PokerStars Game #59941782834:  Hold'em No Limit ($0.10/$0.25) - 2009/07/01 1:46:00 ET
Table 'aT31tt16YvQM/Ue69HPLpA' 9-max Seat #9 is the button
Seat 1: fIgGw0jPUR7labvJPaPbeg ($11.20 in chips) 
Seat 2: PdIasPkzm2sqZnN41ZRXOg ($5 in chips) 
Seat 3: tYsOBqdU1+x+yFI7zHO7hQ ($25.15 in chips) 
Seat 4: wGigCmBR/9XWkPpvYos3aQ ($26.35 in chips) 
Seat 5: s2xLPOl/vhl/26apJ3vsOQ ($37.65 in chips) 
Seat 6: 7cv+9Zc9HIQHNvYsMfV3uA ($59.95 in chips) 
Seat 7: W8cIfrCR+zA8pCNyIuHu8g ($34.25 in chips) 
Seat 8: W6tExOcYX7qiy6Qdp+ZwFA ($4.65 in chips) 
Seat 9: TvIuLx9zUCE+9Li58iImOQ ($13.95 in chips) 
fIgGw0jPUR7labvJPaPbeg: posts small blind $0.10
PdIasPkzm2sqZnN41ZRXOg: posts big blind $0.25
*** HOLE CARDS ***
tYsOBqdU1+x+yFI7zHO7hQ: folds 
wGigCmBR/9XWkPpvYos3aQ: folds 
s2xLPOl/vhl/26apJ3vsOQ: folds 
7cv+9Zc9HIQHNvYsMfV3uA: folds 
W8cIfrCR+zA8pCNyIuHu8g: raises $0.50 to $0.75
W6tExOcYX7qiy6Qdp+ZwFA: folds 
TvIuLx9zUCE+9Li58iImOQ: folds 
fIgGw0jPUR7labvJPaPbeg: calls $0.65
PdIasPkzm2sqZnN41ZRXOg: folds 
*** FLOP *** [4c 5d As]
fIgGw0jPUR7labvJPaPbeg: checks 
W8cIfrCR+zA8pCNyIuHu8g: bets $0.50
fIgGw0jPUR7labvJPaPbeg: folds 
Uncalled bet ($0.50) returned to W8cIfrCR+zA8pCNyIuHu8g
W8cIfrCR+zA8pCNyIuHu8g collected $1.70 from pot
W8cIfrCR+zA8pCNyIuHu8g: doesn't show hand 
*** SUMMARY ***
Total pot $1.75 | Rake $0.05 
Board [4c 5d As]
Seat 1: fIgGw0jPUR7labvJPaPbeg (small blind) folded on the Flop
Seat 2: PdIasPkzm2sqZnN41ZRXOg (big blind) folded before Flop
Seat 3: tYsOBqdU1+x+yFI7zHO7hQ folded before Flop (didn't bet)
Seat 4: wGigCmBR/9XWkPpvYos3aQ folded before Flop (didn't bet)
Seat 5: s2xLPOl/vhl/26apJ3vsOQ folded before Flop (didn't bet)
Seat 6: 7cv+9Zc9HIQHNvYsMfV3uA folded before Flop (didn't bet)
Seat 7: W8cIfrCR+zA8pCNyIuHu8g collected ($1.70)
Seat 8: W6tExOcYX7qiy6Qdp+ZwFA folded before Flop (didn't bet)
Seat 9: TvIuLx9zUCE+9Li58iImOQ (button) folded before Flop (didn't bet)




PokerStars Game #59941782960:  Hold'em No Limit ($0.10/$0.25) - 2009/07/01 1:46:00 ET
Table '1HT8bEDpLPhOXxmqMtzF8w' 9-max Seat #8 is the button
Seat 1: YkkKQUDI0iWatY4h0WWaAQ ($12.90 in chips) 
Seat 2: r6hsffOo1iKmaPYKwAZmFw ($29 in chips) 
Seat 3: oLa/tXLfSLLB28mcLGrxcg ($24.75 in chips) 
Seat 4: aNpwfA31EREwO+ar4XzBCw ($25 in chips) 
Seat 5: CT2YIt3dXaE9eOIkS7FwNw ($22.55 in chips) 
Seat 6: bXpVeaSTPBFSPJmeXxO7nw ($5.25 in chips) 
Seat 7: PMhmqYBPHOAXjH25lRz69g ($16.80 in chips) 
Seat 8: ghNKXUBl/H+t83JF079ZBA ($33.15 in chips) 
Seat 9: Z9W7+g1WMhhZDi7DwGbCFA ($5.10 in chips) 
Z9W7+g1WMhhZDi7DwGbCFA: posts small blind $0.10
YkkKQUDI0iWatY4h0WWaAQ: posts big blind $0.25
*** HOLE CARDS ***
r6hsffOo1iKmaPYKwAZmFw: folds 
oLa/tXLfSLLB28mcLGrxcg: folds 
aNpwfA31EREwO+ar4XzBCw: folds 
CT2YIt3dXaE9eOIkS7FwNw: folds 
CT2YIt3dXaE9eOIkS7FwNw leaves the table
bXpVeaSTPBFSPJmeXxO7nw: folds 
PMhmqYBPHOAXjH25lRz69g: folds 
ghNKXUBl/H+t83JF079ZBA: folds 
Z9W7+g1WMhhZDi7DwGbCFA: folds 
Uncalled bet ($0.15) returned to YkkKQUDI0iWatY4h0WWaAQ
YkkKQUDI0iWatY4h0WWaAQ collected $0.20 from pot
*** SUMMARY ***
Total pot $0.20 | Rake $0 
Seat 1: YkkKQUDI0iWatY4h0WWaAQ (big blind) collected ($0.20)
Seat 2: r6hsffOo1iKmaPYKwAZmFw folded before Flop (didn't bet)
Seat 3: oLa/tXLfSLLB28mcLGrxcg folded before Flop (didn't bet)
Seat 4: aNpwfA31EREwO+ar4XzBCw folded before Flop (didn't bet)
Seat 5: CT2YIt3dXaE9eOIkS7FwNw folded before Flop (didn't bet)
Seat 6: bXpVeaSTPBFSPJmeXxO7nw folded before Flop (didn't bet)
Seat 7: PMhmqYBPHOAXjH25lRz69g folded before Flop (didn't bet)
Seat 8: ghNKXUBl/H+t83JF079ZBA (button) folded before Flop (didn't bet)
Seat 9: Z9W7+g1WMhhZDi7DwGbCFA (small blind) folded before Flop




PokerStars Game #59941783126:  Hold'em No Limit ($0.10/$0.25) - 2009/07/01 1:46:00 ET
Table 'aaXqTKUnxrX9DYXtxhWXxA' 6-max Seat #2 is the button
Seat 1: aSrj4lVmn2owyQ1RbbOqxQ ($26.80 in chips) 
Seat 2: DE9hRlt14g+JdsRQ4wT7hg ($33.35 in chips) 
Seat 3: uUXdcVMNa05rfbntdvplfw ($8.90 in chips) 
Seat 4: 48oT5xFI+5CHUJlfoGrE4w ($9.15 in chips) 
Seat 5: kyRaCIljYA6l33lSKQfNsg ($24.95 in chips) 
Seat 6: buyjetgNT1McXtdaP4zynA ($49.20 in chips) 
uUXdcVMNa05rfbntdvplfw: posts small blind $0.10
48oT5xFI+5CHUJlfoGrE4w: posts big blind $0.25
*** HOLE CARDS ***
kyRaCIljYA6l33lSKQfNsg: folds 
buyjetgNT1McXtdaP4zynA: raises $0.50 to $0.75
aSrj4lVmn2owyQ1RbbOqxQ: folds 
DE9hRlt14g+JdsRQ4wT7hg: folds 
uUXdcVMNa05rfbntdvplfw: calls $0.65
48oT5xFI+5CHUJlfoGrE4w: folds 
*** FLOP *** [7d 5s Qh]
uUXdcVMNa05rfbntdvplfw: checks 
buyjetgNT1McXtdaP4zynA: bets $1.25
uUXdcVMNa05rfbntdvplfw: folds 
Uncalled bet ($1.25) returned to buyjetgNT1McXtdaP4zynA
buyjetgNT1McXtdaP4zynA collected $1.70 from pot
*** SUMMARY ***
Total pot $1.75 | Rake $0.05 
Board [7d 5s Qh]
Seat 1: aSrj4lVmn2owyQ1RbbOqxQ folded before Flop (didn't bet)
Seat 2: DE9hRlt14g+JdsRQ4wT7hg (button) folded before Flop (didn't bet)
Seat 3: uUXdcVMNa05rfbntdvplfw (small blind) folded on the Flop
Seat 4: 48oT5xFI+5CHUJlfoGrE4w (big blind) folded before Flop
Seat 5: kyRaCIljYA6l33lSKQfNsg folded before Flop (didn't bet)
Seat 6: buyjetgNT1McXtdaP4zynA collected ($1.70)




PokerStars Game #59941783386:  Hold'em No Limit ($0.10/$0.25) - 2009/07/01 1:46:01 ET
Table 'NgexmgEDEzICBeSO7YCrKQ' 6-max Seat #3 is the button
Seat 1: cezpHJ8FB07dj0xG+LhOvw ($29.45 in chips) 
Seat 2: 32YL2ZEp8NT4JB2RVM9euQ ($21.55 in chips) 
Seat 3: JFIAqU8lCZ0vWwEl4bdGsg ($26.50 in chips) 
Seat 4: xx+iYCDJhHJmNzrfeloyEg ($23.40 in chips) 
Seat 5: /MXkdT8TTs8Qp2LVTQNw6w ($42.20 in chips) 
Seat 6: k9nHZTHt8hYhYRcW8NTb4g ($11.30 in chips) 
xx+iYCDJhHJmNzrfeloyEg: posts small blind $0.10
/MXkdT8TTs8Qp2LVTQNw6w: posts big blind $0.25
*** HOLE CARDS ***
/MXkdT8TTs8Qp2LVTQNw6w said, "i just couldnt put you on a ten"
k9nHZTHt8hYhYRcW8NTb4g: folds 
cezpHJ8FB07dj0xG+LhOvw: folds 
32YL2ZEp8NT4JB2RVM9euQ: folds 
JFIAqU8lCZ0vWwEl4bdGsg: raises $0.60 to $0.85
/MXkdT8TTs8Qp2LVTQNw6w said, "maybe AK, but i've got to call"
xx+iYCDJhHJmNzrfeloyEg: calls $0.75
/MXkdT8TTs8Qp2LVTQNw6w: folds 
*** FLOP *** [2c Td Qd]
xx+iYCDJhHJmNzrfeloyEg: checks 
JFIAqU8lCZ0vWwEl4bdGsg: bets $1.25
xx+iYCDJhHJmNzrfeloyEg: folds 
Uncalled bet ($1.25) returned to JFIAqU8lCZ0vWwEl4bdGsg
JFIAqU8lCZ0vWwEl4bdGsg collected $1.90 from pot
JFIAqU8lCZ0vWwEl4bdGsg: doesn't show hand 
*** SUMMARY ***
Total pot $1.95 | Rake $0.05 
Board [2c Td Qd]
Seat 1: cezpHJ8FB07dj0xG+LhOvw folded before Flop (didn't bet)
Seat 2: 32YL2ZEp8NT4JB2RVM9euQ folded before Flop (didn't bet)
Seat 3: JFIAqU8lCZ0vWwEl4bdGsg (button) collected ($1.90)
Seat 4: xx+iYCDJhHJmNzrfeloyEg (small blind) folded on the Flop
Seat 5: /MXkdT8TTs8Qp2LVTQNw6w (big blind) folded before Flop
Seat 6: k9nHZTHt8hYhYRcW8NTb4g folded before Flop (didn't bet)




PokerStars Game #59941783582:  Hold'em No Limit ($0.10/$0.25) - 2009/07/01 1:46:01 ET
Table 'Qr+t8WGovMECkBv+cV1lrg' 6-max Seat #6 is the button
Seat 1: EeUZtMU058v2ObUACOF4Og ($44.50 in chips) 
Seat 2: vqWjZmdQu/Hxw96/IJTWdQ ($25 in chips) 
Seat 3: uZKkrGByYgd4/ZBX2d4z+w ($26.75 in chips) 
Seat 4: 1NNFfYMd5Hsphl/FYz9fNA ($62.65 in chips) 
Seat 5: 9q7YGTKe9k5fYb4fmZc3Ww ($32 in chips) 
Seat 6: 9U3ZKjCsarN0DjR6mSE8Ug ($14 in chips) 
EeUZtMU058v2ObUACOF4Og: posts small blind $0.10
vqWjZmdQu/Hxw96/IJTWdQ: posts big blind $0.25
*** HOLE CARDS ***
uZKkrGByYgd4/ZBX2d4z+w: folds 
1NNFfYMd5Hsphl/FYz9fNA: folds 
9q7YGTKe9k5fYb4fmZc3Ww: folds 
9U3ZKjCsarN0DjR6mSE8Ug: folds 
EeUZtMU058v2ObUACOF4Og: calls $0.15
vqWjZmdQu/Hxw96/IJTWdQ: checks 
*** FLOP *** [6h Kc As]
EeUZtMU058v2ObUACOF4Og: bets $0.25
vqWjZmdQu/Hxw96/IJTWdQ: folds 
Uncalled bet ($0.25) returned to EeUZtMU058v2ObUACOF4Og
EeUZtMU058v2ObUACOF4Og collected $0.50 from pot
EeUZtMU058v2ObUACOF4Og: doesn't show hand 
*** SUMMARY ***
Total pot $0.50 | Rake $0 
Board [6h Kc As]
Seat 1: EeUZtMU058v2ObUACOF4Og (small blind) collected ($0.50)
Seat 2: vqWjZmdQu/Hxw96/IJTWdQ (big blind) folded on the Flop
Seat 3: uZKkrGByYgd4/ZBX2d4z+w folded before Flop (didn't bet)
Seat 4: 1NNFfYMd5Hsphl/FYz9fNA folded before Flop (didn't bet)
Seat 5: 9q7YGTKe9k5fYb4fmZc3Ww folded before Flop (didn't bet)
Seat 6: 9U3ZKjCsarN0DjR6mSE8Ug (button) folded before Flop (didn't bet)




PokerStars Game #59941783848:  Hold'em No Limit ($0.10/$0.25) - 2009/07/01 1:46:02 ET
Table '5NipxzzFB2DffzDpddyQoQ' 6-max Seat #5 is the button
Seat 1: W87HPwOk1KtWaYyshBe1gA ($21.25 in chips) 
Seat 2: iauW7L/+7qzAuHow7CD75Q ($6.95 in chips) 
Seat 3: QvTX2yGq3uKJiKPmns4TKQ ($5.90 in chips) 
Seat 4: NTamLAiMZ86c5yM04t96LA ($31 in chips) 
Seat 5: faP2NVl/cFTZ1nE4pXzg8Q ($33.35 in chips) 
Seat 6: 7JqTFMyeNSVWsmp/yW35Tw ($27.55 in chips) 
7JqTFMyeNSVWsmp/yW35Tw: posts small blind $0.10
W87HPwOk1KtWaYyshBe1gA: posts big blind $0.25
*** HOLE CARDS ***
iauW7L/+7qzAuHow7CD75Q: calls $0.25
QvTX2yGq3uKJiKPmns4TKQ: folds 
NTamLAiMZ86c5yM04t96LA: folds 
faP2NVl/cFTZ1nE4pXzg8Q: calls $0.25
7JqTFMyeNSVWsmp/yW35Tw: calls $0.15
W87HPwOk1KtWaYyshBe1gA: checks 
*** FLOP *** [Ac 2d 2s]
7JqTFMyeNSVWsmp/yW35Tw: checks 
W87HPwOk1KtWaYyshBe1gA: checks 
iauW7L/+7qzAuHow7CD75Q: checks 
faP2NVl/cFTZ1nE4pXzg8Q: bets $1.25
7JqTFMyeNSVWsmp/yW35Tw: folds 
W87HPwOk1KtWaYyshBe1gA: folds 
iauW7L/+7qzAuHow7CD75Q: folds 
Uncalled bet ($1.25) returned to faP2NVl/cFTZ1nE4pXzg8Q
faP2NVl/cFTZ1nE4pXzg8Q collected $0.95 from pot
faP2NVl/cFTZ1nE4pXzg8Q: shows [As Jd] (two pair, Aces and Deuces)
*** SUMMARY ***
Total pot $1 | Rake $0.05 
Board [Ac 2d 2s]
Seat 1: W87HPwOk1KtWaYyshBe1gA (big blind) folded on the Flop
Seat 2: iauW7L/+7qzAuHow7CD75Q folded on the Flop
Seat 3: QvTX2yGq3uKJiKPmns4TKQ folded before Flop (didn't bet)
Seat 4: NTamLAiMZ86c5yM04t96LA folded before Flop (didn't bet)
Seat 5: faP2NVl/cFTZ1nE4pXzg8Q (button) collected ($0.95)
Seat 6: 7JqTFMyeNSVWsmp/yW35Tw (small blind) folded on the Flop




PokerStars Game #59941784092:  Hold'em No Limit ($0.10/$0.25) - 2009/07/01 1:46:02 ET
Table 'Pz8SfAzhP5nvWTsJRAxoDg' 6-max Seat #6 is the button
Seat 1: QiL+lEgEWwy21jk/ltaRLg ($47.25 in chips) 
Seat 2: k021eD5in2AjaloW5PalMg ($10 in chips) 
Seat 3: mfrkWA3PTeYPkbO6hi98Aw ($24.60 in chips) 
Seat 4: 4lJto+Qj0K4JrFKvHaPTLw ($67.40 in chips) 
Seat 5: FYepjhAvF8ZdVCmqHIy+eQ ($28.05 in chips) 
Seat 6: QvTX2yGq3uKJiKPmns4TKQ ($26.70 in chips) 
QiL+lEgEWwy21jk/ltaRLg: posts small blind $0.10
k021eD5in2AjaloW5PalMg: posts big blind $0.25
*** HOLE CARDS ***
mfrkWA3PTeYPkbO6hi98Aw: folds 
4lJto+Qj0K4JrFKvHaPTLw: folds 
FYepjhAvF8ZdVCmqHIy+eQ: folds 
QvTX2yGq3uKJiKPmns4TKQ: raises $0.75 to $1
QiL+lEgEWwy21jk/ltaRLg: folds 
k021eD5in2AjaloW5PalMg: calls $0.75
*** FLOP *** [6s Tc 8s]
k021eD5in2AjaloW5PalMg: bets $0.50
QvTX2yGq3uKJiKPmns4TKQ: raises $1.25 to $1.75
k021eD5in2AjaloW5PalMg: calls $1.25
*** TURN *** [6s Tc 8s] [5h]
k021eD5in2AjaloW5PalMg: bets $0.75
QvTX2yGq3uKJiKPmns4TKQ: raises $2.75 to $3.50
k021eD5in2AjaloW5PalMg: calls $2.75
*** RIVER *** [6s Tc 8s 5h] [4s]
k021eD5in2AjaloW5PalMg: bets $3.75 and is all-in
QvTX2yGq3uKJiKPmns4TKQ: calls $3.75
*** SHOW DOWN ***
k021eD5in2AjaloW5PalMg: shows [Js Ts] (a flush, Jack high)
QvTX2yGq3uKJiKPmns4TKQ: mucks hand 
k021eD5in2AjaloW5PalMg collected $19.15 from pot
*** SUMMARY ***
Total pot $20.10 | Rake $0.95 
Board [6s Tc 8s 5h 4s]
Seat 1: QiL+lEgEWwy21jk/ltaRLg (small blind) folded before Flop
Seat 2: k021eD5in2AjaloW5PalMg (big blind) showed [Js Ts] and won ($19.15) with a flush, Jack high
Seat 3: mfrkWA3PTeYPkbO6hi98Aw folded before Flop (didn't bet)
Seat 4: 4lJto+Qj0K4JrFKvHaPTLw folded before Flop (didn't bet)
Seat 5: FYepjhAvF8ZdVCmqHIy+eQ folded before Flop (didn't bet)
Seat 6: QvTX2yGq3uKJiKPmns4TKQ (button) mucked




PokerStars Game #59941783722:  Hold'em No Limit ($0.10/$0.25) - 2009/07/01 1:46:02 ET
Table 'KAnP7XvDtlku47YfJwdOVw' 9-max Seat #8 is the button
Seat 1: cH3q40adP+kFogl+2MtbkQ ($14.35 in chips) 
Seat 3: W6tExOcYX7qiy6Qdp+ZwFA ($7.60 in chips) 
Seat 4: OiV1PWZ3IkN29JlmCcnTwQ ($4.65 in chips) 
Seat 5: MG90wfSJZnOejs/KD3vlQQ ($33.05 in chips) 
Seat 7: Lro4e37x4FUa5P3yzDjskw ($6.80 in chips) 
Seat 8: OneeONzF0MoH0pEdcBndwA ($22.45 in chips) 
Seat 9: HDDm1BkZtdsRyw2DJdqq6A ($24.30 in chips) 
HDDm1BkZtdsRyw2DJdqq6A: posts small blind $0.10
cH3q40adP+kFogl+2MtbkQ: posts big blind $0.25
E0iYnEVO2ho7dH3QcCjw7g: sits out 
*** HOLE CARDS ***
W6tExOcYX7qiy6Qdp+ZwFA: folds 
OiV1PWZ3IkN29JlmCcnTwQ: folds 
MG90wfSJZnOejs/KD3vlQQ: raises $0.50 to $0.75
Lro4e37x4FUa5P3yzDjskw: folds 
OneeONzF0MoH0pEdcBndwA: folds 
HDDm1BkZtdsRyw2DJdqq6A: calls $0.65
cH3q40adP+kFogl+2MtbkQ: folds 
*** FLOP *** [7s 9c 4s]
HDDm1BkZtdsRyw2DJdqq6A: checks 
MG90wfSJZnOejs/KD3vlQQ: bets $1.40
HDDm1BkZtdsRyw2DJdqq6A: folds 
Uncalled bet ($1.40) returned to MG90wfSJZnOejs/KD3vlQQ
MG90wfSJZnOejs/KD3vlQQ collected $1.70 from pot
MG90wfSJZnOejs/KD3vlQQ: doesn't show hand 
*** SUMMARY ***
Total pot $1.75 | Rake $0.05 
Board [7s 9c 4s]
Seat 1: cH3q40adP+kFogl+2MtbkQ (big blind) folded before Flop
Seat 3: W6tExOcYX7qiy6Qdp+ZwFA folded before Flop (didn't bet)
Seat 4: OiV1PWZ3IkN29JlmCcnTwQ folded before Flop (didn't bet)
Seat 5: MG90wfSJZnOejs/KD3vlQQ collected ($1.70)
Seat 7: Lro4e37x4FUa5P3yzDjskw folded before Flop (didn't bet)
Seat 8: OneeONzF0MoH0pEdcBndwA (button) folded before Flop (didn't bet)
Seat 9: HDDm1BkZtdsRyw2DJdqq6A (small blind) folded on the Flop




PokerStars Game #59941783980:  Hold'em No Limit ($0.10/$0.25) - 2009/07/01 1:46:02 ET
Table '+giHa6FUL6U5/AZnCJEGvQ' 9-max Seat #6 is the button
Seat 4: 10f7J+bM02ZfDHx0PgkNSg ($14.30 in chips) 
Seat 6: GTMnTen6sQSoCpS9sggLbg ($25.30 in chips) 
GTMnTen6sQSoCpS9sggLbg: posts small blind $0.10
10f7J+bM02ZfDHx0PgkNSg: posts big blind $0.25
*** HOLE CARDS ***
GTMnTen6sQSoCpS9sggLbg: raises $0.50 to $0.75
10f7J+bM02ZfDHx0PgkNSg: folds 
Uncalled bet ($0.50) returned to GTMnTen6sQSoCpS9sggLbg
GTMnTen6sQSoCpS9sggLbg collected $0.50 from pot
GTMnTen6sQSoCpS9sggLbg: shows [4c 4d] (a pair of Fours)
*** SUMMARY ***
Total pot $0.50 | Rake $0 
Seat 4: 10f7J+bM02ZfDHx0PgkNSg (big blind) folded before Flop
Seat 6: GTMnTen6sQSoCpS9sggLbg (button) (small blind) collected ($0.50)




PokerStars Game #59941783938:  Hold'em No Limit ($0.10/$0.25) - 2009/07/01 1:46:02 ET
Table 'sm5gqEvXgLbkkE4dryW/5g' 6-max Seat #4 is the button
Seat 1: v8m8XHovI5tqEA9mvplDSw ($40.20 in chips) 
Seat 2: 5xs5/u2z1CO9zkRvH72MQg ($18.65 in chips) 
Seat 3: UT5XpwOH1ipkOF7n1MqDJA ($22.15 in chips) 
Seat 4: cWc85bEzdRzpUMhRKm8pwQ ($26.15 in chips) 
Seat 6: aogAb4Eienxztk8p2v9VVw ($20.75 in chips) 
aogAb4Eienxztk8p2v9VVw: posts small blind $0.10
v8m8XHovI5tqEA9mvplDSw: posts big blind $0.25
*** HOLE CARDS ***
5xs5/u2z1CO9zkRvH72MQg: calls $0.25
UT5XpwOH1ipkOF7n1MqDJA: folds 
cWc85bEzdRzpUMhRKm8pwQ: folds 
aogAb4Eienxztk8p2v9VVw: folds 
v8m8XHovI5tqEA9mvplDSw: checks 
*** FLOP *** [As 6s 2s]
v8m8XHovI5tqEA9mvplDSw: checks 
5xs5/u2z1CO9zkRvH72MQg: bets $0.85
v8m8XHovI5tqEA9mvplDSw: folds 
Uncalled bet ($0.85) returned to 5xs5/u2z1CO9zkRvH72MQg
5xs5/u2z1CO9zkRvH72MQg collected $0.60 from pot
*** SUMMARY ***
Total pot $0.60 | Rake $0 
Board [As 6s 2s]
Seat 1: v8m8XHovI5tqEA9mvplDSw (big blind) folded on the Flop
Seat 2: 5xs5/u2z1CO9zkRvH72MQg collected ($0.60)
Seat 3: UT5XpwOH1ipkOF7n1MqDJA folded before Flop (didn't bet)
Seat 4: cWc85bEzdRzpUMhRKm8pwQ (button) folded before Flop (didn't bet)
Seat 6: aogAb4Eienxztk8p2v9VVw (small blind) folded before Flop




PokerStars Game #59941783720:  Hold'em No Limit ($0.10/$0.25) - 2009/07/01 1:46:02 ET
Table '63uh7ZsO7Tnt+E8b/2bu3A' 6-max Seat #1 is the button
Seat 1: 0av6tRNdi0Ui4f15L7gsVg ($30.20 in chips) 
Seat 2: SFmT9ZsVopnukjvAzrxTRg ($28.45 in chips) 
Seat 3: yVP7GLZBzx47OPi6jzUxMw ($8.45 in chips) 
Seat 5: GbCVUNssQ7mqsPWr7J4d3w ($4.05 in chips) 
Seat 6: qGHGf/553gQnDoklMRe3tg ($30.15 in chips) 
SFmT9ZsVopnukjvAzrxTRg: posts small blind $0.10
yVP7GLZBzx47OPi6jzUxMw: posts big blind $0.25
rnpAao581IcvQglpkpnkoQ: sits out 
*** HOLE CARDS ***
GbCVUNssQ7mqsPWr7J4d3w: folds 
qGHGf/553gQnDoklMRe3tg: raises $0.75 to $1
0av6tRNdi0Ui4f15L7gsVg: folds 
SFmT9ZsVopnukjvAzrxTRg: calls $0.90
yVP7GLZBzx47OPi6jzUxMw: calls $0.75
*** FLOP *** [3h 4h 2h]
SFmT9ZsVopnukjvAzrxTRg: bets $1.75
yVP7GLZBzx47OPi6jzUxMw: folds 
qGHGf/553gQnDoklMRe3tg: folds 
Uncalled bet ($1.75) returned to SFmT9ZsVopnukjvAzrxTRg
SFmT9ZsVopnukjvAzrxTRg collected $2.85 from pot
SFmT9ZsVopnukjvAzrxTRg: doesn't show hand 
*** SUMMARY ***
Total pot $3 | Rake $0.15 
Board [3h 4h 2h]
Seat 1: 0av6tRNdi0Ui4f15L7gsVg (button) folded before Flop (didn't bet)
Seat 2: SFmT9ZsVopnukjvAzrxTRg (small blind) collected ($2.85)
Seat 3: yVP7GLZBzx47OPi6jzUxMw (big blind) folded on the Flop
Seat 5: GbCVUNssQ7mqsPWr7J4d3w folded before Flop (didn't bet)
Seat 6: qGHGf/553gQnDoklMRe3tg folded on the Flop




PokerStars Game #59941784358:  Hold'em No Limit ($0.10/$0.25) - 2009/07/01 1:46:03 ET
Table 'g6ryG70feTw9nNm+XJLuXw' 6-max Seat #1 is the button
Seat 1: v+QfkGiuj9bgtuNoVnDO8w ($35.25 in chips) 
Seat 2: SxIIgwXYLkwd6m3wLyPTCw ($32.85 in chips) 
Seat 3: cezpHJ8FB07dj0xG+LhOvw ($25 in chips) 
Seat 4: GC/9yVD59DUCX7hUI7gcLw ($45.85 in chips) 
Seat 5: EE16Ua5b1HSsYej5zeXOlA ($25.35 in chips) 
SxIIgwXYLkwd6m3wLyPTCw: posts small blind $0.10
cezpHJ8FB07dj0xG+LhOvw: posts big blind $0.25
Mhj3q7cxev+XjXZxEE6/Cw: sits out 
*** HOLE CARDS ***
GC/9yVD59DUCX7hUI7gcLw: folds 
EE16Ua5b1HSsYej5zeXOlA: folds 
v+QfkGiuj9bgtuNoVnDO8w: folds 
SxIIgwXYLkwd6m3wLyPTCw: folds 
Uncalled bet ($0.15) returned to cezpHJ8FB07dj0xG+LhOvw
cezpHJ8FB07dj0xG+LhOvw collected $0.20 from pot
*** SUMMARY ***
Total pot $0.20 | Rake $0 
Seat 1: v+QfkGiuj9bgtuNoVnDO8w (button) folded before Flop (didn't bet)
Seat 2: SxIIgwXYLkwd6m3wLyPTCw (small blind) folded before Flop
Seat 3: cezpHJ8FB07dj0xG+LhOvw (big blind) collected ($0.20)
Seat 4: GC/9yVD59DUCX7hUI7gcLw folded before Flop (didn't bet)
Seat 5: EE16Ua5b1HSsYej5zeXOlA folded before Flop (didn't bet)




PokerStars Game #59941784548:  Hold'em No Limit ($0.10/$0.25) - 2009/07/01 1:46:03 ET
Table '2clPgY3+dETPD/8zjXZdFw' 6-max Seat #5 is the button
Seat 2: cWc85bEzdRzpUMhRKm8pwQ ($25.55 in chips) 
Seat 3: FL1UWpN6oReBdznWDOy9Gg ($15 in chips) 
Seat 4: ljjhtb6FVPTx9AT9HNdtqg ($25.25 in chips) 
Seat 5: LJI7A1YgDM7hgh7o56+ReQ ($29.55 in chips) 
cWc85bEzdRzpUMhRKm8pwQ: posts small blind $0.10
FL1UWpN6oReBdznWDOy9Gg: posts big blind $0.25
*** HOLE CARDS ***
ljjhtb6FVPTx9AT9HNdtqg: calls $0.25
LJI7A1YgDM7hgh7o56+ReQ: folds 
cWc85bEzdRzpUMhRKm8pwQ: calls $0.15
FL1UWpN6oReBdznWDOy9Gg: checks 
*** FLOP *** [3h 6s 4s]
7cx44/slbeTw+Cy7QB8Trg joins the table at seat #1 
cWc85bEzdRzpUMhRKm8pwQ: checks 
FL1UWpN6oReBdznWDOy9Gg: checks 
ljjhtb6FVPTx9AT9HNdtqg: checks 
*** TURN *** [3h 6s 4s] [4d]
cWc85bEzdRzpUMhRKm8pwQ: checks 
FL1UWpN6oReBdznWDOy9Gg: bets $0.25
ljjhtb6FVPTx9AT9HNdtqg: calls $0.25
cWc85bEzdRzpUMhRKm8pwQ: folds 
*** RIVER *** [3h 6s 4s 4d] [Ks]
FL1UWpN6oReBdznWDOy9Gg: checks 
ljjhtb6FVPTx9AT9HNdtqg: checks 
*** SHOW DOWN ***
FL1UWpN6oReBdznWDOy9Gg: shows [8h 6h] (two pair, Sixes and Fours)
ljjhtb6FVPTx9AT9HNdtqg: mucks hand 
FL1UWpN6oReBdznWDOy9Gg collected $1.20 from pot
*** SUMMARY ***
Total pot $1.25 | Rake $0.05 
Board [3h 6s 4s 4d Ks]
Seat 2: cWc85bEzdRzpUMhRKm8pwQ (small blind) folded on the Turn
Seat 3: FL1UWpN6oReBdznWDOy9Gg (big blind) showed [8h 6h] and won ($1.20) with two pair, Sixes and Fours
Seat 4: ljjhtb6FVPTx9AT9HNdtqg mucked
Seat 5: LJI7A1YgDM7hgh7o56+ReQ (button) folded before Flop (didn't bet)




PokerStars Game #59941784362:  Hold'em No Limit ($0.10/$0.25) - 2009/07/01 1:46:03 ET
Table '9SExUHslNkrPJ4XsrePaVw' 9-max Seat #2 is the button
Seat 1: RHqgdFvufLCYe54+qd2gcA ($4.50 in chips) 
Seat 2: cZ99hugmLBj9KhTlc8nCSw ($43.75 in chips) 
Seat 3: EP17SQz/iWcuYdNOGeBgkw ($13.90 in chips) 
Seat 4: 4awUyiDYTgylQKXZ9faBVA ($25 in chips) 
Seat 5: L+eJnUyhY8bMNYw755K8XQ ($14.50 in chips) 
Seat 6: YPJ90cgNXDABdYJcqmwB0A ($20.95 in chips) 
Seat 7: 7cv+9Zc9HIQHNvYsMfV3uA ($29.20 in chips) 
Seat 8: tLcDklc2rBORNfixyRfVfw ($25.35 in chips) 
Seat 9: /THNzAxdv2lBxcf4XTj/0g ($9 in chips) 
EP17SQz/iWcuYdNOGeBgkw: posts small blind $0.10
4awUyiDYTgylQKXZ9faBVA: posts big blind $0.25
*** HOLE CARDS ***
L+eJnUyhY8bMNYw755K8XQ: calls $0.25
YPJ90cgNXDABdYJcqmwB0A: folds 
7cv+9Zc9HIQHNvYsMfV3uA: raises $0.75 to $1
tLcDklc2rBORNfixyRfVfw: folds 
/THNzAxdv2lBxcf4XTj/0g: folds 
RHqgdFvufLCYe54+qd2gcA: folds 
cZ99hugmLBj9KhTlc8nCSw: folds 
EP17SQz/iWcuYdNOGeBgkw: folds 
4awUyiDYTgylQKXZ9faBVA: folds 
L+eJnUyhY8bMNYw755K8XQ: calls $0.75
*** FLOP *** [3d 5c 7d]
L+eJnUyhY8bMNYw755K8XQ: bets $2.50
7cv+9Zc9HIQHNvYsMfV3uA: folds 
Uncalled bet ($2.50) returned to L+eJnUyhY8bMNYw755K8XQ
L+eJnUyhY8bMNYw755K8XQ collected $2.25 from pot
*** SUMMARY ***
Total pot $2.35 | Rake $0.10 
Board [3d 5c 7d]
Seat 1: RHqgdFvufLCYe54+qd2gcA folded before Flop (didn't bet)
Seat 2: cZ99hugmLBj9KhTlc8nCSw (button) folded before Flop (didn't bet)
Seat 3: EP17SQz/iWcuYdNOGeBgkw (small blind) folded before Flop
Seat 4: 4awUyiDYTgylQKXZ9faBVA (big blind) folded before Flop
Seat 5: L+eJnUyhY8bMNYw755K8XQ collected ($2.25)
Seat 6: YPJ90cgNXDABdYJcqmwB0A folded before Flop (didn't bet)
Seat 7: 7cv+9Zc9HIQHNvYsMfV3uA folded on the Flop
Seat 8: tLcDklc2rBORNfixyRfVfw folded before Flop (didn't bet)
Seat 9: /THNzAxdv2lBxcf4XTj/0g folded before Flop (didn't bet)




PokerStars Game #59941784662:  Hold'em No Limit ($0.10/$0.25) - 2009/07/01 1:46:03 ET
Table '7/qMNloI0nSXWiX5Y1watA' 9-max Seat #1 is the button
Seat 1: /LyhaB3V6jkgOfXORidqRQ ($6.75 in chips) 
Seat 2: wGigCmBR/9XWkPpvYos3aQ ($25.95 in chips) 
Seat 3: W2YYHvqjaEpRrO7stZkClQ ($4.35 in chips) 
Seat 4: K0LdhPeU31rviEPo6Sv3TA ($8.65 in chips) 
Seat 6: Y3DZ6qQlLeBhixDj4M9vmg ($17.35 in chips) 
Seat 8: ljemhp25Zg+nlA9DLCIiUw ($25.15 in chips) 
Seat 9: dmYlc+1cjwZMJ7wV+Z0rRg ($26 in chips) 
wGigCmBR/9XWkPpvYos3aQ: posts small blind $0.10
W2YYHvqjaEpRrO7stZkClQ: posts big blind $0.25
*** HOLE CARDS ***
K0LdhPeU31rviEPo6Sv3TA: folds 
Y3DZ6qQlLeBhixDj4M9vmg: calls $0.25
ljemhp25Zg+nlA9DLCIiUw: raises $0.75 to $1
dmYlc+1cjwZMJ7wV+Z0rRg: folds 
/LyhaB3V6jkgOfXORidqRQ: folds 
wGigCmBR/9XWkPpvYos3aQ: folds 
W2YYHvqjaEpRrO7stZkClQ: folds 
Y3DZ6qQlLeBhixDj4M9vmg: calls $0.75
*** FLOP *** [4h Kh 4d]
Y3DZ6qQlLeBhixDj4M9vmg: checks 
ljemhp25Zg+nlA9DLCIiUw: bets $1.50
Y3DZ6qQlLeBhixDj4M9vmg: folds 
Uncalled bet ($1.50) returned to ljemhp25Zg+nlA9DLCIiUw
ljemhp25Zg+nlA9DLCIiUw collected $2.25 from pot
ljemhp25Zg+nlA9DLCIiUw: doesn't show hand 
*** SUMMARY ***
Total pot $2.35 | Rake $0.10 
Board [4h Kh 4d]
Seat 1: /LyhaB3V6jkgOfXORidqRQ (button) folded before Flop (didn't bet)
Seat 2: wGigCmBR/9XWkPpvYos3aQ (small blind) folded before Flop
Seat 3: W2YYHvqjaEpRrO7stZkClQ (big blind) folded before Flop
Seat 4: K0LdhPeU31rviEPo6Sv3TA folded before Flop (didn't bet)
Seat 6: Y3DZ6qQlLeBhixDj4M9vmg folded on the Flop
Seat 8: ljemhp25Zg+nlA9DLCIiUw collected ($2.25)
Seat 9: dmYlc+1cjwZMJ7wV+Z0rRg folded before Flop (didn't bet)




PokerStars Game #59941784208:  Hold'em No Limit ($0.10/$0.25) - 2009/07/01 1:46:03 ET
Table 'APEHQjIcZHDZUA4iOjju2g' 6-max Seat #5 is the button
Seat 1: DE9hRlt14g+JdsRQ4wT7hg ($25 in chips) 
Seat 2: 3zD3qLXT1bEffAoWGnc7wg ($35.50 in chips) 
Seat 3: 3e/idKqDuPE10t6Zvr//SQ ($24.05 in chips) 
Seat 4: w2mQ4VsGljGwWXydz8tw2A ($35.35 in chips) 
Seat 5: /xN6gc9+8Hew0HxaB6VIVg ($46 in chips) 
Seat 6: KXtdqb+rIMkjc0RvHDksGQ ($27.35 in chips) 
KXtdqb+rIMkjc0RvHDksGQ: posts small blind $0.10
DE9hRlt14g+JdsRQ4wT7hg: posts big blind $0.25
*** HOLE CARDS ***
3zD3qLXT1bEffAoWGnc7wg: folds 
3e/idKqDuPE10t6Zvr//SQ: folds 
w2mQ4VsGljGwWXydz8tw2A: calls $0.25
/xN6gc9+8Hew0HxaB6VIVg: folds 
KXtdqb+rIMkjc0RvHDksGQ: calls $0.15
DE9hRlt14g+JdsRQ4wT7hg: checks 
*** FLOP *** [9s 9c 2s]
KXtdqb+rIMkjc0RvHDksGQ: checks 
DE9hRlt14g+JdsRQ4wT7hg: checks 
w2mQ4VsGljGwWXydz8tw2A: bets $0.75
KXtdqb+rIMkjc0RvHDksGQ: folds 
DE9hRlt14g+JdsRQ4wT7hg: folds 
Uncalled bet ($0.75) returned to w2mQ4VsGljGwWXydz8tw2A
w2mQ4VsGljGwWXydz8tw2A collected $0.75 from pot
*** SUMMARY ***
Total pot $0.75 | Rake $0 
Board [9s 9c 2s]
Seat 1: DE9hRlt14g+JdsRQ4wT7hg (big blind) folded on the Flop
Seat 2: 3zD3qLXT1bEffAoWGnc7wg folded before Flop (didn't bet)
Seat 3: 3e/idKqDuPE10t6Zvr//SQ folded before Flop (didn't bet)
Seat 4: w2mQ4VsGljGwWXydz8tw2A collected ($0.75)
Seat 5: /xN6gc9+8Hew0HxaB6VIVg (button) folded before Flop (didn't bet)
Seat 6: KXtdqb+rIMkjc0RvHDksGQ (small blind) folded on the Flop




PokerStars Game #59941784756:  Hold'em No Limit ($0.10/$0.25) - 2009/07/01 1:46:04 ET
Table 'NtEQAxCeIK2io1CGtW658g' 6-max Seat #4 is the button
Seat 1: X437kMQ7AujoaDgjguhU9w ($12.45 in chips) 
Seat 2: DgyznDqq/mLiCqQGMzc+Aw ($9.20 in chips) 
Seat 3: 5nwDw10uIM0XEyLhla0oGA ($25 in chips) 
Seat 4: 8296 ($9.70 in chips) 
Seat 5: Hsvkc0/G2VV78oVmWYXecw ($5 in chips) 
Seat 6: /gJNBeCkWL4o85/jvlZ4BA ($64.70 in chips) 
Hsvkc0/G2VV78oVmWYXecw: posts small blind $0.10
/gJNBeCkWL4o85/jvlZ4BA: posts big blind $0.25
5nwDw10uIM0XEyLhla0oGA: posts big blind $0.25
*** HOLE CARDS ***
X437kMQ7AujoaDgjguhU9w: calls $0.25
DgyznDqq/mLiCqQGMzc+Aw: folds 
5nwDw10uIM0XEyLhla0oGA: checks 
8296: calls $0.25
Hsvkc0/G2VV78oVmWYXecw: calls $0.15
/gJNBeCkWL4o85/jvlZ4BA: checks 
*** FLOP *** [Ac Jd 5c]
Hsvkc0/G2VV78oVmWYXecw: checks 
/gJNBeCkWL4o85/jvlZ4BA: checks 
X437kMQ7AujoaDgjguhU9w: checks 
5nwDw10uIM0XEyLhla0oGA: bets $1
8296: folds 
Hsvkc0/G2VV78oVmWYXecw: calls $1
/gJNBeCkWL4o85/jvlZ4BA: folds 
X437kMQ7AujoaDgjguhU9w: folds 
*** TURN *** [Ac Jd 5c] [7c]
Hsvkc0/G2VV78oVmWYXecw: checks 
5nwDw10uIM0XEyLhla0oGA: checks 
*** RIVER *** [Ac Jd 5c 7c] [Th]
Hsvkc0/G2VV78oVmWYXecw: bets $2.50
5nwDw10uIM0XEyLhla0oGA: folds 
Uncalled bet ($2.50) returned to Hsvkc0/G2VV78oVmWYXecw
Hsvkc0/G2VV78oVmWYXecw collected $3.10 from pot
Hsvkc0/G2VV78oVmWYXecw: doesn't show hand 
*** SUMMARY ***
Total pot $3.25 | Rake $0.15 
Board [Ac Jd 5c 7c Th]
Seat 1: X437kMQ7AujoaDgjguhU9w folded on the Flop
Seat 2: DgyznDqq/mLiCqQGMzc+Aw folded before Flop (didn't bet)
Seat 3: 5nwDw10uIM0XEyLhla0oGA folded on the River
Seat 4: 8296 (button) folded on the Flop
Seat 5: Hsvkc0/G2VV78oVmWYXecw (small blind) collected ($3.10)
Seat 6: /gJNBeCkWL4o85/jvlZ4BA (big blind) folded on the Flop




PokerStars Game #59941785004:  Hold'em No Limit ($0.10/$0.25) - 2009/07/01 1:46:04 ET
Table '3KDMdm1sfxFsNKkjc/PnBg' 9-max Seat #1 is the button
Seat 1: JvrJoga8hK8pnB3KGQHl1g ($7.90 in chips) 
Seat 2: 5WLo/V8l3QfpUdK9JPp99w ($24.30 in chips) 
Seat 3: OXPkK84/qv92EMwXPiG5rQ ($10 in chips) 
Seat 4: F7pnn6czNpHvRM55XcA2EA ($38.20 in chips) 
Seat 5: +2kMBNpY4nF1qNCRd8SJLA ($31.45 in chips) 
Seat 6: sGFnnRCa1YAHAUmWgsW6Qg ($9.85 in chips) 
Seat 7: gehe91e0IyVT0QU/XBkEyg ($31.80 in chips) 
Seat 8: LFnLiiWho1pLiR1Xvp5d/w ($8.55 in chips) 
Seat 9: K0b5wNInj6hUGRr6yzKFtw ($32.60 in chips) 
5WLo/V8l3QfpUdK9JPp99w: posts small blind $0.10
OXPkK84/qv92EMwXPiG5rQ: posts big blind $0.25
*** HOLE CARDS ***
F7pnn6czNpHvRM55XcA2EA: folds 
+2kMBNpY4nF1qNCRd8SJLA: raises $0.75 to $1
sGFnnRCa1YAHAUmWgsW6Qg: calls $1
gehe91e0IyVT0QU/XBkEyg: folds 
LFnLiiWho1pLiR1Xvp5d/w: calls $1
K0b5wNInj6hUGRr6yzKFtw: folds 
JvrJoga8hK8pnB3KGQHl1g: folds 
5WLo/V8l3QfpUdK9JPp99w: folds 
OXPkK84/qv92EMwXPiG5rQ: folds 
*** FLOP *** [Th Qs 3c]
+2kMBNpY4nF1qNCRd8SJLA: checks 
JvrJoga8hK8pnB3KGQHl1g leaves the table
sGFnnRCa1YAHAUmWgsW6Qg: checks 
LFnLiiWho1pLiR1Xvp5d/w: bets $1.50
+2kMBNpY4nF1qNCRd8SJLA: folds 
sGFnnRCa1YAHAUmWgsW6Qg: calls $1.50
*** TURN *** [Th Qs 3c] [Qd]
sGFnnRCa1YAHAUmWgsW6Qg: bets $7.35 and is all-in
LFnLiiWho1pLiR1Xvp5d/w: folds 
Uncalled bet ($7.35) returned to sGFnnRCa1YAHAUmWgsW6Qg
MedvedOffUA joins the table at seat #1 
sGFnnRCa1YAHAUmWgsW6Qg collected $6.05 from pot
sGFnnRCa1YAHAUmWgsW6Qg: doesn't show hand 
*** SUMMARY ***
Total pot $6.35 | Rake $0.30 
Board [Th Qs 3c Qd]
Seat 1: JvrJoga8hK8pnB3KGQHl1g (button) folded before Flop (didn't bet)
Seat 2: 5WLo/V8l3QfpUdK9JPp99w (small blind) folded before Flop
Seat 3: OXPkK84/qv92EMwXPiG5rQ (big blind) folded before Flop
Seat 4: F7pnn6czNpHvRM55XcA2EA folded before Flop (didn't bet)
Seat 5: +2kMBNpY4nF1qNCRd8SJLA folded on the Flop
Seat 6: sGFnnRCa1YAHAUmWgsW6Qg collected ($6.05)
Seat 7: gehe91e0IyVT0QU/XBkEyg folded before Flop (didn't bet)
Seat 8: LFnLiiWho1pLiR1Xvp5d/w folded on the Turn
Seat 9: K0b5wNInj6hUGRr6yzKFtw folded before Flop (didn't bet)




PokerStars Game #59941784894:  Hold'em No Limit ($0.10/$0.25) - 2009/07/01 1:46:04 ET
Table 'ThBZ355rqvsb8UGb6ajbig' 9-max Seat #3 is the button
Seat 1: Z9W7+g1WMhhZDi7DwGbCFA ($5 in chips) 
Seat 2: 4awUyiDYTgylQKXZ9faBVA ($25.60 in chips) 
Seat 3: H5Se03ZqSX7tbULXur2MAg ($29.05 in chips) 
Seat 4: zgi+EUykT/pZQpoUG6+oEg ($4.40 in chips) 
Seat 5: cKlmpQMahVsmOaxFQDcoOg ($24.95 in chips) 
Seat 6: qwr38jl5txoR36M7G5qi4A ($11.35 in chips) 
Seat 7: zUXhymECc2C9W9ZNw6qppA ($16.05 in chips) 
Seat 8: PdIasPkzm2sqZnN41ZRXOg ($4.90 in chips) 
Seat 9: sD+TKtt36XiiN6jqHiLwDA ($23.85 in chips) 
zgi+EUykT/pZQpoUG6+oEg: posts small blind $0.10
cKlmpQMahVsmOaxFQDcoOg: posts big blind $0.25
*** HOLE CARDS ***
qwr38jl5txoR36M7G5qi4A: folds 
zUXhymECc2C9W9ZNw6qppA: folds 
PdIasPkzm2sqZnN41ZRXOg: folds 
sD+TKtt36XiiN6jqHiLwDA: folds 
Z9W7+g1WMhhZDi7DwGbCFA: folds 
4awUyiDYTgylQKXZ9faBVA: raises $0.75 to $1
H5Se03ZqSX7tbULXur2MAg: folds 
zgi+EUykT/pZQpoUG6+oEg: folds 
cKlmpQMahVsmOaxFQDcoOg: folds 
Uncalled bet ($0.75) returned to 4awUyiDYTgylQKXZ9faBVA
4awUyiDYTgylQKXZ9faBVA collected $0.60 from pot
4awUyiDYTgylQKXZ9faBVA: doesn't show hand 
*** SUMMARY ***
Total pot $0.60 | Rake $0 
Seat 1: Z9W7+g1WMhhZDi7DwGbCFA folded before Flop (didn't bet)
Seat 2: 4awUyiDYTgylQKXZ9faBVA collected ($0.60)
Seat 3: H5Se03ZqSX7tbULXur2MAg (button) folded before Flop (didn't bet)
Seat 4: zgi+EUykT/pZQpoUG6+oEg (small blind) folded before Flop
Seat 5: cKlmpQMahVsmOaxFQDcoOg (big blind) folded before Flop
Seat 6: qwr38jl5txoR36M7G5qi4A folded before Flop (didn't bet)
Seat 7: zUXhymECc2C9W9ZNw6qppA folded before Flop (didn't bet)
Seat 8: PdIasPkzm2sqZnN41ZRXOg folded before Flop (didn't bet)
Seat 9: sD+TKtt36XiiN6jqHiLwDA folded before Flop (didn't bet)




PokerStars Game #59941784794:  Hold'em No Limit ($0.10/$0.25) - 2009/07/01 1:46:04 ET
Table 'ggwTHpIC5qhhHJSYjK1XCw' 6-max Seat #3 is the button
Seat 1: MqMK8OWPSY1V4stf1Hy5Jw ($80 in chips) 
Seat 2: /gJNBeCkWL4o85/jvlZ4BA ($25.95 in chips) 
Seat 3: SxIIgwXYLkwd6m3wLyPTCw ($69.35 in chips) 
Seat 4: JFIAqU8lCZ0vWwEl4bdGsg ($25.10 in chips) 
Seat 5: BvqhBa7W/To51LhEiIU/lw ($6.45 in chips) 
JFIAqU8lCZ0vWwEl4bdGsg: posts small blind $0.10
BvqhBa7W/To51LhEiIU/lw: posts big blind $0.25
*** HOLE CARDS ***
MqMK8OWPSY1V4stf1Hy5Jw: folds 
/gJNBeCkWL4o85/jvlZ4BA: folds 
SxIIgwXYLkwd6m3wLyPTCw: folds 
JFIAqU8lCZ0vWwEl4bdGsg: folds 
Uncalled bet ($0.15) returned to BvqhBa7W/To51LhEiIU/lw
BvqhBa7W/To51LhEiIU/lw collected $0.20 from pot
BvqhBa7W/To51LhEiIU/lw: doesn't show hand 
*** SUMMARY ***
Total pot $0.20 | Rake $0 
Seat 1: MqMK8OWPSY1V4stf1Hy5Jw folded before Flop (didn't bet)
Seat 2: /gJNBeCkWL4o85/jvlZ4BA folded before Flop (didn't bet)
Seat 3: SxIIgwXYLkwd6m3wLyPTCw (button) folded before Flop (didn't bet)
Seat 4: JFIAqU8lCZ0vWwEl4bdGsg (small blind) folded before Flop
Seat 5: BvqhBa7W/To51LhEiIU/lw (big blind) collected ($0.20)




PokerStars Game #59941784740:  Hold'em No Limit ($0.10/$0.25) - 2009/07/01 1:46:04 ET
Table '3LMlz3V4AziGlU+ikmyU8w' 6-max Seat #3 is the button
Seat 1: Wxq4Qyj0DnDXj2+taEOJFQ ($55.50 in chips) 
Seat 2: uR3AbFJLoOX86DOTtTgGcg ($26.90 in chips) 
Seat 3: Hzy03WtPHMYwLYM7hTTxQw ($25 in chips) 
Seat 4: 6DwBRH+xZ12AAZmeAg+aXw ($19.65 in chips) 
Seat 5: tOAk1Og4mVObMBOfvdDYOw ($25 in chips) 
6DwBRH+xZ12AAZmeAg+aXw: posts small blind $0.10
tOAk1Og4mVObMBOfvdDYOw: posts big blind $0.25
7LpHJVeM6k1mQdC6HXYzww: sits out 
*** HOLE CARDS ***
Wxq4Qyj0DnDXj2+taEOJFQ: folds 
uR3AbFJLoOX86DOTtTgGcg: raises $1.25 to $1.50
Hzy03WtPHMYwLYM7hTTxQw: folds 
6DwBRH+xZ12AAZmeAg+aXw: calls $1.40
tOAk1Og4mVObMBOfvdDYOw: folds 
*** FLOP *** [9d Ac 5h]
6DwBRH+xZ12AAZmeAg+aXw: checks 
uR3AbFJLoOX86DOTtTgGcg: checks 
*** TURN *** [9d Ac 5h] [8s]
6DwBRH+xZ12AAZmeAg+aXw: checks 
uR3AbFJLoOX86DOTtTgGcg: checks 
*** RIVER *** [9d Ac 5h 8s] [9c]
6DwBRH+xZ12AAZmeAg+aXw: checks 
uR3AbFJLoOX86DOTtTgGcg: bets $2.25
6DwBRH+xZ12AAZmeAg+aXw: calls $2.25
*** SHOW DOWN ***
uR3AbFJLoOX86DOTtTgGcg: shows [Jc 4c] (a pair of Nines)
6DwBRH+xZ12AAZmeAg+aXw: shows [7c 7h] (two pair, Nines and Sevens)
6DwBRH+xZ12AAZmeAg+aXw collected $7.40 from pot
*** SUMMARY ***
Total pot $7.75 | Rake $0.35 
Board [9d Ac 5h 8s 9c]
Seat 1: Wxq4Qyj0DnDXj2+taEOJFQ folded before Flop (didn't bet)
Seat 2: uR3AbFJLoOX86DOTtTgGcg showed [Jc 4c] and lost with a pair of Nines
Seat 3: Hzy03WtPHMYwLYM7hTTxQw (button) folded before Flop (didn't bet)
Seat 4: 6DwBRH+xZ12AAZmeAg+aXw (small blind) showed [7c 7h] and won ($7.40) with two pair, Nines and Sevens
Seat 5: tOAk1Og4mVObMBOfvdDYOw (big blind) folded before Flop




PokerStars Game #59941785244:  Hold'em No Limit ($0.10/$0.25) - 2009/07/01 1:46:05 ET
Table 'ykyWGjhNu7AvZXov27T4ew' 9-max Seat #7 is the button
Seat 1: skUI2T7o4P1rz460mMbAOg ($10 in chips) 
Seat 2: MG90wfSJZnOejs/KD3vlQQ ($39.60 in chips) 
Seat 3: NPI9ArW8kwrb6a2IAL6xMQ ($26.65 in chips) 
Seat 4: W6tExOcYX7qiy6Qdp+ZwFA ($5.90 in chips) 
Seat 5: CmngQmkKTp8tkl6GMRTl6w ($8.50 in chips) 
Seat 6: AiXn/9o1EwOPZUHujnh/bA ($20.15 in chips) 
Seat 7: npAYqa85pqnzfOK5ukX+BQ ($21.30 in chips) 
Seat 8: tYsOBqdU1+x+yFI7zHO7hQ ($49.45 in chips) 
tYsOBqdU1+x+yFI7zHO7hQ: posts small blind $0.10
wk9M6R3w+aDHpr8WV87RmQ: is sitting out 
skUI2T7o4P1rz460mMbAOg: posts big blind $0.25
*** HOLE CARDS ***
wk9M6R3w+aDHpr8WV87RmQ has returned
MG90wfSJZnOejs/KD3vlQQ: folds 
NPI9ArW8kwrb6a2IAL6xMQ: calls $0.25
W6tExOcYX7qiy6Qdp+ZwFA: folds 
CmngQmkKTp8tkl6GMRTl6w: folds 
AiXn/9o1EwOPZUHujnh/bA: folds 
npAYqa85pqnzfOK5ukX+BQ: folds 
tYsOBqdU1+x+yFI7zHO7hQ: folds 
skUI2T7o4P1rz460mMbAOg: checks 
*** FLOP *** [Th 8s 4s]
skUI2T7o4P1rz460mMbAOg: checks 
NPI9ArW8kwrb6a2IAL6xMQ: checks 
*** TURN *** [Th 8s 4s] [3d]
skUI2T7o4P1rz460mMbAOg: bets $0.50
NPI9ArW8kwrb6a2IAL6xMQ: folds 
Uncalled bet ($0.50) returned to skUI2T7o4P1rz460mMbAOg
skUI2T7o4P1rz460mMbAOg collected $0.60 from pot
*** SUMMARY ***
Total pot $0.60 | Rake $0 
Board [Th 8s 4s 3d]
Seat 1: skUI2T7o4P1rz460mMbAOg (big blind) collected ($0.60)
Seat 2: MG90wfSJZnOejs/KD3vlQQ folded before Flop (didn't bet)
Seat 3: NPI9ArW8kwrb6a2IAL6xMQ folded on the Turn
Seat 4: W6tExOcYX7qiy6Qdp+ZwFA folded before Flop (didn't bet)
Seat 5: CmngQmkKTp8tkl6GMRTl6w folded before Flop (didn't bet)
Seat 6: AiXn/9o1EwOPZUHujnh/bA folded before Flop (didn't bet)
Seat 7: npAYqa85pqnzfOK5ukX+BQ (button) folded before Flop (didn't bet)
Seat 8: tYsOBqdU1+x+yFI7zHO7hQ (small blind) folded before Flop




PokerStars Game #59941785568:  Hold'em No Limit ($0.10/$0.25) - 2009/07/01 1:46:05 ET
Table 'pPgW4R3kdH26lLi1MnE92w' 9-max Seat #2 is the button
Seat 1: F4P6SxCNY4vxdb318G9RwA ($19.60 in chips) 
Seat 2: cZ99hugmLBj9KhTlc8nCSw ($27.15 in chips) 
Seat 3: WaS7+xnv4bIVHoru6nxczA ($13.50 in chips) 
Seat 4: iZ1f67Ok/207yzIQOu1Kdg ($5 in chips) 
Seat 5: HPEB+AtKw1+C/cxU0o1ciw ($22.25 in chips) 
Seat 6: VllYilcih0t+gMD4GTRlgQ ($25.40 in chips) 
Seat 7: sD+TKtt36XiiN6jqHiLwDA ($29.05 in chips) 
Seat 8: clJsV3v77RS07bDKY+705w ($5 in chips) 
Seat 9: tcbEu7VzyHQ+0lh+skbQhQ ($63.75 in chips) 
WaS7+xnv4bIVHoru6nxczA: posts small blind $0.10
iZ1f67Ok/207yzIQOu1Kdg: posts big blind $0.25
clJsV3v77RS07bDKY+705w: posts big blind $0.25
*** HOLE CARDS ***
HPEB+AtKw1+C/cxU0o1ciw: folds 
VllYilcih0t+gMD4GTRlgQ: folds 
sD+TKtt36XiiN6jqHiLwDA: folds 
clJsV3v77RS07bDKY+705w: checks 
tcbEu7VzyHQ+0lh+skbQhQ: calls $0.25
F4P6SxCNY4vxdb318G9RwA: calls $0.25
cZ99hugmLBj9KhTlc8nCSw: folds 
WaS7+xnv4bIVHoru6nxczA: calls $0.15
iZ1f67Ok/207yzIQOu1Kdg: checks 
*** FLOP *** [6h Td 7d]
WaS7+xnv4bIVHoru6nxczA: checks 
iZ1f67Ok/207yzIQOu1Kdg: checks 
clJsV3v77RS07bDKY+705w: checks 
tcbEu7VzyHQ+0lh+skbQhQ: bets $0.75
F4P6SxCNY4vxdb318G9RwA: calls $0.75
WaS7+xnv4bIVHoru6nxczA: folds 
iZ1f67Ok/207yzIQOu1Kdg: folds 
clJsV3v77RS07bDKY+705w: folds 
*** TURN *** [6h Td 7d] [Kc]
tcbEu7VzyHQ+0lh+skbQhQ: bets $1.75
F4P6SxCNY4vxdb318G9RwA: folds 
Uncalled bet ($1.75) returned to tcbEu7VzyHQ+0lh+skbQhQ
tcbEu7VzyHQ+0lh+skbQhQ collected $2.65 from pot
*** SUMMARY ***
Total pot $2.75 | Rake $0.10 
Board [6h Td 7d Kc]
Seat 1: F4P6SxCNY4vxdb318G9RwA folded on the Turn
Seat 2: cZ99hugmLBj9KhTlc8nCSw (button) folded before Flop (didn't bet)
Seat 3: WaS7+xnv4bIVHoru6nxczA (small blind) folded on the Flop
Seat 4: iZ1f67Ok/207yzIQOu1Kdg (big blind) folded on the Flop
Seat 5: HPEB+AtKw1+C/cxU0o1ciw folded before Flop (didn't bet)
Seat 6: VllYilcih0t+gMD4GTRlgQ folded before Flop (didn't bet)
Seat 7: sD+TKtt36XiiN6jqHiLwDA folded before Flop (didn't bet)
Seat 8: clJsV3v77RS07bDKY+705w folded on the Flop
Seat 9: tcbEu7VzyHQ+0lh+skbQhQ collected ($2.65)




PokerStars Game #59941785286:  Hold'em No Limit ($0.10/$0.25) - 2009/07/01 1:46:05 ET
Table 'QegsWX65l3n/K0A8XB78yg' 6-max Seat #5 is the button
Seat 1: p6adJRMXMBLr+xtQzqazIQ ($18 in chips) 
Seat 2: GC/9yVD59DUCX7hUI7gcLw ($57.85 in chips) 
Seat 3: iIgNoBh+3/Ix1/fLsg+HuA ($6 in chips) 
Seat 4: epAUIB7h2FJXzUPRIvSkRA ($25 in chips) 
Seat 5: QqiZLFrN8iOUT/GHw7ztOA ($24.65 in chips) 
Seat 6: 5PWs02z65jSO5pr/M6wx/w ($2.25 in chips) 
5PWs02z65jSO5pr/M6wx/w: posts small blind $0.10
p6adJRMXMBLr+xtQzqazIQ: posts big blind $0.25
*** HOLE CARDS ***
GC/9yVD59DUCX7hUI7gcLw: folds 
iIgNoBh+3/Ix1/fLsg+HuA: folds 
epAUIB7h2FJXzUPRIvSkRA: raises $0.75 to $1
QqiZLFrN8iOUT/GHw7ztOA: folds 
5PWs02z65jSO5pr/M6wx/w: calls $0.90
p6adJRMXMBLr+xtQzqazIQ: calls $0.75
*** FLOP *** [Kc As 6s]
5PWs02z65jSO5pr/M6wx/w: checks 
p6adJRMXMBLr+xtQzqazIQ: checks 
epAUIB7h2FJXzUPRIvSkRA: bets $2
5PWs02z65jSO5pr/M6wx/w: calls $1.25 and is all-in
p6adJRMXMBLr+xtQzqazIQ: calls $2
*** TURN *** [Kc As 6s] [6d]
p6adJRMXMBLr+xtQzqazIQ: checks 
epAUIB7h2FJXzUPRIvSkRA: bets $4
p6adJRMXMBLr+xtQzqazIQ: calls $4
*** RIVER *** [Kc As 6s 6d] [Qd]
p6adJRMXMBLr+xtQzqazIQ: checks 
epAUIB7h2FJXzUPRIvSkRA: checks 
*** SHOW DOWN ***
p6adJRMXMBLr+xtQzqazIQ: shows [Ac 9h] (two pair, Aces and Sixes)
epAUIB7h2FJXzUPRIvSkRA: shows [5h Ad] (two pair, Aces and Sixes)
p6adJRMXMBLr+xtQzqazIQ collected $4.55 from side pot
epAUIB7h2FJXzUPRIvSkRA collected $4.50 from side pot
5PWs02z65jSO5pr/M6wx/w: shows [Ts Jc] (a straight, Ten to Ace)
5PWs02z65jSO5pr/M6wx/w collected $6.45 from main pot
*** SUMMARY ***
Total pot $16.25 Main pot $6.45. Side pot $9.05. | Rake $0.75 
Board [Kc As 6s 6d Qd]
Seat 1: p6adJRMXMBLr+xtQzqazIQ (big blind) showed [Ac 9h] and won ($4.55) with two pair, Aces and Sixes
Seat 2: GC/9yVD59DUCX7hUI7gcLw folded before Flop (didn't bet)
Seat 3: iIgNoBh+3/Ix1/fLsg+HuA folded before Flop (didn't bet)
Seat 4: epAUIB7h2FJXzUPRIvSkRA showed [5h Ad] and won ($4.50) with two pair, Aces and Sixes
Seat 5: QqiZLFrN8iOUT/GHw7ztOA (button) folded before Flop (didn't bet)
Seat 6: 5PWs02z65jSO5pr/M6wx/w (small blind) showed [Ts Jc] and won ($6.45) with a straight, Ten to Ace




PokerStars Game #59941785798:  Hold'em No Limit ($0.10/$0.25) - 2009/07/01 1:46:06 ET
Table '4XGDnEByOol5up4aB2KbJw' 6-max Seat #4 is the button
Seat 1: kyRaCIljYA6l33lSKQfNsg ($26.50 in chips) 
Seat 2: SFmT9ZsVopnukjvAzrxTRg ($46.10 in chips) 
Seat 3: LtASJ9OlkqGrrUKGQlpGAw ($20.90 in chips) 
Seat 4: BV+K0Phf5VBHr7aZPKqbUQ ($25.40 in chips) 
Seat 5: Dh01+rohD2p9pXLYeBlC5Q ($16.75 in chips) 
Seat 6: a7Ux7aERFGCbT/L3ojVfAg ($7.75 in chips) 
Dh01+rohD2p9pXLYeBlC5Q: posts small blind $0.10
a7Ux7aERFGCbT/L3ojVfAg: posts big blind $0.25
*** HOLE CARDS ***
kyRaCIljYA6l33lSKQfNsg: folds 
SFmT9ZsVopnukjvAzrxTRg: raises $0.75 to $1
LtASJ9OlkqGrrUKGQlpGAw: folds 
BV+K0Phf5VBHr7aZPKqbUQ: folds 
Dh01+rohD2p9pXLYeBlC5Q: folds 
a7Ux7aERFGCbT/L3ojVfAg: folds 
Uncalled bet ($0.75) returned to SFmT9ZsVopnukjvAzrxTRg
SFmT9ZsVopnukjvAzrxTRg collected $0.60 from pot
SFmT9ZsVopnukjvAzrxTRg: doesn't show hand 
*** SUMMARY ***
Total pot $0.60 | Rake $0 
Seat 1: kyRaCIljYA6l33lSKQfNsg folded before Flop (didn't bet)
Seat 2: SFmT9ZsVopnukjvAzrxTRg collected ($0.60)
Seat 3: LtASJ9OlkqGrrUKGQlpGAw folded before Flop (didn't bet)
Seat 4: BV+K0Phf5VBHr7aZPKqbUQ (button) folded before Flop (didn't bet)
Seat 5: Dh01+rohD2p9pXLYeBlC5Q (small blind) folded before Flop
Seat 6: a7Ux7aERFGCbT/L3ojVfAg (big blind) folded before Flop




PokerStars Game #59941786036:  Hold'em No Limit ($0.10/$0.25) - 2009/07/01 1:46:06 ET
Table '60nA7av6bws9VnNmVwculA' 6-max Seat #6 is the button
Seat 1: if4dh6jhJXeN3/qd3qCp9g ($24.40 in chips) 
Seat 2: Bada343Si4xKu3fNXY99AA ($3.85 in chips) 
Seat 3: mnuJq+Q1IXKm/pCy+OzxmQ ($20.35 in chips) 
Seat 4: +baiVgI/ETnBARLe5mARCw ($18.85 in chips) 
Seat 5: zXh+lOT41Q2iWgCNj+OcRw ($12.35 in chips) 
Seat 6: mfrkWA3PTeYPkbO6hi98Aw ($24.75 in chips) 
if4dh6jhJXeN3/qd3qCp9g: posts small blind $0.10
Bada343Si4xKu3fNXY99AA: posts big blind $0.25
*** HOLE CARDS ***
mnuJq+Q1IXKm/pCy+OzxmQ: folds 
+baiVgI/ETnBARLe5mARCw: folds 
zXh+lOT41Q2iWgCNj+OcRw: folds 
mfrkWA3PTeYPkbO6hi98Aw: folds 
if4dh6jhJXeN3/qd3qCp9g: raises $0.75 to $1
Bada343Si4xKu3fNXY99AA: folds 
Uncalled bet ($0.75) returned to if4dh6jhJXeN3/qd3qCp9g
if4dh6jhJXeN3/qd3qCp9g collected $0.50 from pot
if4dh6jhJXeN3/qd3qCp9g: doesn't show hand 
*** SUMMARY ***
Total pot $0.50 | Rake $0 
Seat 1: if4dh6jhJXeN3/qd3qCp9g (small blind) collected ($0.50)
Seat 2: Bada343Si4xKu3fNXY99AA (big blind) folded before Flop
Seat 3: mnuJq+Q1IXKm/pCy+OzxmQ folded before Flop (didn't bet)
Seat 4: +baiVgI/ETnBARLe5mARCw folded before Flop (didn't bet)
Seat 5: zXh+lOT41Q2iWgCNj+OcRw folded before Flop (didn't bet)
Seat 6: mfrkWA3PTeYPkbO6hi98Aw (button) folded before Flop (didn't bet)




PokerStars Game #59941785674:  Hold'em No Limit ($0.10/$0.25) - 2009/07/01 1:46:06 ET
Table 'MiquQrQZJJq9ZtgRIp9HFQ' 6-max Seat #4 is the button
Seat 1: c3J/KYZ4cNsUEuz8v57I5A ($21.25 in chips) 
Seat 2: 2+6voGl1T1DO63JePptI3g ($19 in chips) 
Seat 3: 9h7TNZ1TDGRUJXA6rI+ZTw ($9.40 in chips) 
Seat 4: wAKC8C/zN0c8V5v13dm9mA ($57.95 in chips) 
Seat 5: iyZxqznXjv3vtvOJymkoLQ ($26.85 in chips) 
Seat 6: GbCVUNssQ7mqsPWr7J4d3w ($5 in chips) 
iyZxqznXjv3vtvOJymkoLQ: posts small blind $0.10
GbCVUNssQ7mqsPWr7J4d3w: posts big blind $0.25
*** HOLE CARDS ***
c3J/KYZ4cNsUEuz8v57I5A: folds 
2+6voGl1T1DO63JePptI3g: folds 
9h7TNZ1TDGRUJXA6rI+ZTw: calls $0.25
wAKC8C/zN0c8V5v13dm9mA: folds 
iyZxqznXjv3vtvOJymkoLQ: folds 
GbCVUNssQ7mqsPWr7J4d3w: checks 
*** FLOP *** [As Ah 6c]
GbCVUNssQ7mqsPWr7J4d3w: checks 
9h7TNZ1TDGRUJXA6rI+ZTw: checks 
*** TURN *** [As Ah 6c] [8s]
GbCVUNssQ7mqsPWr7J4d3w: checks 
9h7TNZ1TDGRUJXA6rI+ZTw: checks 
*** RIVER *** [As Ah 6c 8s] [7s]
GbCVUNssQ7mqsPWr7J4d3w: checks 
9h7TNZ1TDGRUJXA6rI+ZTw: checks 
*** SHOW DOWN ***
GbCVUNssQ7mqsPWr7J4d3w: shows [6h Jh] (two pair, Aces and Sixes)
9h7TNZ1TDGRUJXA6rI+ZTw: shows [8d Qc] (two pair, Aces and Eights)
9h7TNZ1TDGRUJXA6rI+ZTw collected $0.60 from pot
*** SUMMARY ***
Total pot $0.60 | Rake $0 
Board [As Ah 6c 8s 7s]
Seat 1: c3J/KYZ4cNsUEuz8v57I5A folded before Flop (didn't bet)
Seat 2: 2+6voGl1T1DO63JePptI3g folded before Flop (didn't bet)
Seat 3: 9h7TNZ1TDGRUJXA6rI+ZTw showed [8d Qc] and won ($0.60) with two pair, Aces and Eights
Seat 4: wAKC8C/zN0c8V5v13dm9mA (button) folded before Flop (didn't bet)
Seat 5: iyZxqznXjv3vtvOJymkoLQ (small blind) folded before Flop
Seat 6: GbCVUNssQ7mqsPWr7J4d3w (big blind) showed [6h Jh] and lost with two pair, Aces and Sixes




PokerStars Game #59941786064:  Hold'em No Limit ($0.10/$0.25) - 2009/07/01 1:46:06 ET
Table 'rO1I30HnuCPB0M8qEX1TCQ' 9-max Seat #9 is the button
Seat 2: z1hPotrGOZjUjyoopZ7Ulg ($21.70 in chips) 
Seat 3: 2wcFsZsqEP5w1StUTVzJCg ($13.15 in chips) 
Seat 4: yyG4svzOpC1A+sUP/scg6w ($10.40 in chips) 
Seat 5: W6tExOcYX7qiy6Qdp+ZwFA ($7.20 in chips) 
Seat 6: 5n7e7I+px7c6CQmLpPbtsg ($4.65 in chips) 
Seat 7: bXpVeaSTPBFSPJmeXxO7nw ($4.65 in chips) 
Seat 9: wnerYvSRWT9Sm4X3ip/c8w ($24.75 in chips) 
z1hPotrGOZjUjyoopZ7Ulg: posts small blind $0.10
2wcFsZsqEP5w1StUTVzJCg: posts big blind $0.25
*** HOLE CARDS ***
yyG4svzOpC1A+sUP/scg6w: folds 
W6tExOcYX7qiy6Qdp+ZwFA: folds 
6mStmDUknIn/RyBEoiIyoQ leaves the table
5n7e7I+px7c6CQmLpPbtsg: folds 
bXpVeaSTPBFSPJmeXxO7nw: raises $4.40 to $4.65 and is all-in
wnerYvSRWT9Sm4X3ip/c8w: folds 
z1hPotrGOZjUjyoopZ7Ulg: calls $4.55
2wcFsZsqEP5w1StUTVzJCg: folds 
*** FLOP *** [4h 9h Jh]
*** TURN *** [4h 9h Jh] [2c]
*** RIVER *** [4h 9h Jh 2c] [Qc]
*** SHOW DOWN ***
z1hPotrGOZjUjyoopZ7Ulg: shows [4s 4c] (three of a kind, Fours)
bXpVeaSTPBFSPJmeXxO7nw: mucks hand 
z1hPotrGOZjUjyoopZ7Ulg collected $9.10 from pot
*** SUMMARY ***
Total pot $9.55 | Rake $0.45 
Board [4h 9h Jh 2c Qc]
Seat 2: z1hPotrGOZjUjyoopZ7Ulg (small blind) showed [4s 4c] and won ($9.10) with three of a kind, Fours
Seat 3: 2wcFsZsqEP5w1StUTVzJCg (big blind) folded before Flop
Seat 4: yyG4svzOpC1A+sUP/scg6w folded before Flop (didn't bet)
Seat 5: W6tExOcYX7qiy6Qdp+ZwFA folded before Flop (didn't bet)
Seat 6: 5n7e7I+px7c6CQmLpPbtsg folded before Flop (didn't bet)
Seat 7: bXpVeaSTPBFSPJmeXxO7nw mucked
Seat 9: wnerYvSRWT9Sm4X3ip/c8w (button) folded before Flop (didn't bet)




PokerStars Game #59941786294:  Hold'em No Limit ($0.10/$0.25) - 2009/07/01 1:46:07 ET
Table 'dZNBGqFYSwfOVZvDJ4VjIQ' 6-max Seat #3 is the button
Seat 1: v+QfkGiuj9bgtuNoVnDO8w ($37.45 in chips) 
Seat 2: 3zD3qLXT1bEffAoWGnc7wg ($28.95 in chips) 
Seat 3: kyRaCIljYA6l33lSKQfNsg ($27.95 in chips) 
Seat 4: mFv3iBCtrw9XfCDRB0d46Q ($5.90 in chips) 
Seat 5: +ZlnqPoP3Hg4BIUxDfKd/A ($29.60 in chips) 
Seat 6: ypmjhffk/YHGc51wgVXUTw ($29.40 in chips) 
mFv3iBCtrw9XfCDRB0d46Q: posts small blind $0.10
+ZlnqPoP3Hg4BIUxDfKd/A: posts big blind $0.25
*** HOLE CARDS ***
ypmjhffk/YHGc51wgVXUTw has timed out
ypmjhffk/YHGc51wgVXUTw: folds 
ypmjhffk/YHGc51wgVXUTw is sitting out
ypmjhffk/YHGc51wgVXUTw has returned
v+QfkGiuj9bgtuNoVnDO8w: folds 
3zD3qLXT1bEffAoWGnc7wg: folds 
kyRaCIljYA6l33lSKQfNsg: raises $0.50 to $0.75
mFv3iBCtrw9XfCDRB0d46Q: folds 
+ZlnqPoP3Hg4BIUxDfKd/A: folds 
Uncalled bet ($0.50) returned to kyRaCIljYA6l33lSKQfNsg
kyRaCIljYA6l33lSKQfNsg collected $0.60 from pot
*** SUMMARY ***
Total pot $0.60 | Rake $0 
Seat 1: v+QfkGiuj9bgtuNoVnDO8w folded before Flop (didn't bet)
Seat 2: 3zD3qLXT1bEffAoWGnc7wg folded before Flop (didn't bet)
Seat 3: kyRaCIljYA6l33lSKQfNsg (button) collected ($0.60)
Seat 4: mFv3iBCtrw9XfCDRB0d46Q (small blind) folded before Flop
Seat 5: +ZlnqPoP3Hg4BIUxDfKd/A (big blind) folded before Flop
Seat 6: ypmjhffk/YHGc51wgVXUTw folded before Flop (didn't bet)




PokerStars Game #59941786714:  Hold'em No Limit ($0.10/$0.25) - 2009/07/01 1:46:07 ET
Table 'Xi38lWH8L2JHRAsKYVX8Qg' 6-max Seat #4 is the button
Seat 1: shP7DFAtX7gXcgMJX/OmRQ ($19.15 in chips) 
Seat 2: VOmI0x4dDPnTESZd5B4d1Q ($9.10 in chips) 
Seat 3: 6DwBRH+xZ12AAZmeAg+aXw ($35.20 in chips) 
Seat 4: kG34n23qFQA3nzdOJTQ1dA ($24.50 in chips) 
Seat 5: 79ID/ub1Pt/mDpCprVmOoA ($77.70 in chips) 
Seat 6: kyRaCIljYA6l33lSKQfNsg ($29.40 in chips) 
79ID/ub1Pt/mDpCprVmOoA: posts small blind $0.10
kyRaCIljYA6l33lSKQfNsg: posts big blind $0.25
*** HOLE CARDS ***
shP7DFAtX7gXcgMJX/OmRQ: folds 
VOmI0x4dDPnTESZd5B4d1Q: folds 
6DwBRH+xZ12AAZmeAg+aXw: folds 
kG34n23qFQA3nzdOJTQ1dA: folds 
79ID/ub1Pt/mDpCprVmOoA: folds 
Uncalled bet ($0.15) returned to kyRaCIljYA6l33lSKQfNsg
kyRaCIljYA6l33lSKQfNsg collected $0.20 from pot
*** SUMMARY ***
Total pot $0.20 | Rake $0 
Seat 1: shP7DFAtX7gXcgMJX/OmRQ folded before Flop (didn't bet)
Seat 2: VOmI0x4dDPnTESZd5B4d1Q folded before Flop (didn't bet)
Seat 3: 6DwBRH+xZ12AAZmeAg+aXw folded before Flop (didn't bet)
Seat 4: kG34n23qFQA3nzdOJTQ1dA (button) folded before Flop (didn't bet)
Seat 5: 79ID/ub1Pt/mDpCprVmOoA (small blind) folded before Flop
Seat 6: kyRaCIljYA6l33lSKQfNsg (big blind) collected ($0.20)




PokerStars Game #59941786720:  Hold'em No Limit ($0.10/$0.25) - 2009/07/01 1:46:07 ET
Table 'JPFXJXa5xBkjZ/W15BKqeQ' 9-max Seat #4 is the button
Seat 1: mNQH7Afv3tbDKl2tAb9BOg ($19.60 in chips) 
Seat 2: XMSS6mD5B42I8wasdOMipQ ($12.75 in chips) 
Seat 3: 56S3mA6Zs3pGR+0p0vUCtg ($19.20 in chips) 
Seat 4: wGigCmBR/9XWkPpvYos3aQ ($26.40 in chips) 
Seat 5: cZ99hugmLBj9KhTlc8nCSw ($25.35 in chips) 
Seat 6: tLcDklc2rBORNfixyRfVfw ($25.35 in chips) 
cZ99hugmLBj9KhTlc8nCSw: posts small blind $0.10
tLcDklc2rBORNfixyRfVfw: posts big blind $0.25
PdIasPkzm2sqZnN41ZRXOg: sits out 
V6p0jQ/RhUsqpHLmXvEX4Q: sits out 
*** HOLE CARDS ***
mNQH7Afv3tbDKl2tAb9BOg: folds 
XMSS6mD5B42I8wasdOMipQ: raises $0.50 to $0.75
56S3mA6Zs3pGR+0p0vUCtg: folds 
wGigCmBR/9XWkPpvYos3aQ: folds 
cZ99hugmLBj9KhTlc8nCSw: folds 
tLcDklc2rBORNfixyRfVfw: folds 
Uncalled bet ($0.50) returned to XMSS6mD5B42I8wasdOMipQ
XMSS6mD5B42I8wasdOMipQ collected $0.60 from pot
*** SUMMARY ***
Total pot $0.60 | Rake $0 
Seat 1: mNQH7Afv3tbDKl2tAb9BOg folded before Flop (didn't bet)
Seat 2: XMSS6mD5B42I8wasdOMipQ collected ($0.60)
Seat 3: 56S3mA6Zs3pGR+0p0vUCtg folded before Flop (didn't bet)
Seat 4: wGigCmBR/9XWkPpvYos3aQ (button) folded before Flop (didn't bet)
Seat 5: cZ99hugmLBj9KhTlc8nCSw (small blind) folded before Flop
Seat 6: tLcDklc2rBORNfixyRfVfw (big blind) folded before Flop




PokerStars Game #59941787054:  Hold'em No Limit ($0.10/$0.25) - 2009/07/01 1:46:08 ET
Table 'AchTjdLS1zBUbH3ZIx6f0w' 6-max Seat #1 is the button
Seat 1: rZ0bUtoerhFGDUSRQMnFog ($28 in chips) 
Seat 2: kG34n23qFQA3nzdOJTQ1dA ($66 in chips) 
Seat 3: k9vn40MOqqb+xF+7GZ6v2g ($30.25 in chips) 
Seat 4: q6WfTUAD9mowIP63ASq2Dg ($30.55 in chips) 
Seat 5: 0av6tRNdi0Ui4f15L7gsVg ($26 in chips) 
Seat 6: epAUIB7h2FJXzUPRIvSkRA ($25.35 in chips) 
kG34n23qFQA3nzdOJTQ1dA: posts small blind $0.10
k9vn40MOqqb+xF+7GZ6v2g: posts big blind $0.25
*** HOLE CARDS ***
q6WfTUAD9mowIP63ASq2Dg: folds 
0av6tRNdi0Ui4f15L7gsVg: raises $0.50 to $0.75
epAUIB7h2FJXzUPRIvSkRA: folds 
rZ0bUtoerhFGDUSRQMnFog: calls $0.75
kG34n23qFQA3nzdOJTQ1dA: folds 
k9vn40MOqqb+xF+7GZ6v2g: folds 
*** FLOP *** [2h Th Kc]
0av6tRNdi0Ui4f15L7gsVg: checks 
rZ0bUtoerhFGDUSRQMnFog: checks 
*** TURN *** [2h Th Kc] [3c]
0av6tRNdi0Ui4f15L7gsVg: bets $1
rZ0bUtoerhFGDUSRQMnFog: calls $1
*** RIVER *** [2h Th Kc 3c] [5c]
0av6tRNdi0Ui4f15L7gsVg: checks 
rZ0bUtoerhFGDUSRQMnFog: bets $1.75
0av6tRNdi0Ui4f15L7gsVg: folds 
Uncalled bet ($1.75) returned to rZ0bUtoerhFGDUSRQMnFog
rZ0bUtoerhFGDUSRQMnFog collected $3.70 from pot
rZ0bUtoerhFGDUSRQMnFog: doesn't show hand 
*** SUMMARY ***
Total pot $3.85 | Rake $0.15 
Board [2h Th Kc 3c 5c]
Seat 1: rZ0bUtoerhFGDUSRQMnFog (button) collected ($3.70)
Seat 2: kG34n23qFQA3nzdOJTQ1dA (small blind) folded before Flop
Seat 3: k9vn40MOqqb+xF+7GZ6v2g (big blind) folded before Flop
Seat 4: q6WfTUAD9mowIP63ASq2Dg folded before Flop (didn't bet)
Seat 5: 0av6tRNdi0Ui4f15L7gsVg folded on the River
Seat 6: epAUIB7h2FJXzUPRIvSkRA folded before Flop (didn't bet)




PokerStars Game #59941787282:  Hold'em No Limit ($0.10/$0.25) - 2009/07/01 1:46:08 ET
Table 'R5qKG21jwFDYRcOht9qwqQ' 9-max Seat #6 is the button
Seat 2: N6foVRyErHqcNmshkqextQ ($13.80 in chips) 
Seat 3: M2QO2DxB5Wawg2h8HSpnYA ($13 in chips) 
Seat 5: zUXhymECc2C9W9ZNw6qppA ($8.55 in chips) 
Seat 6: EP17SQz/iWcuYdNOGeBgkw ($15.90 in chips) 
Seat 7: zgi+EUykT/pZQpoUG6+oEg ($4.75 in chips) 
Seat 8: tYsOBqdU1+x+yFI7zHO7hQ ($35.05 in chips) 
Seat 9: MG90wfSJZnOejs/KD3vlQQ ($32.25 in chips) 
zgi+EUykT/pZQpoUG6+oEg: posts small blind $0.10
tYsOBqdU1+x+yFI7zHO7hQ: posts big blind $0.25
N5sUK8M0br9djLrW97V9pQ: sits out 
*** HOLE CARDS ***
MG90wfSJZnOejs/KD3vlQQ: raises $0.50 to $0.75
N6foVRyErHqcNmshkqextQ: folds 
M2QO2DxB5Wawg2h8HSpnYA: calls $0.75
zUXhymECc2C9W9ZNw6qppA: folds 
EP17SQz/iWcuYdNOGeBgkw: folds 
zgi+EUykT/pZQpoUG6+oEg: folds 
tYsOBqdU1+x+yFI7zHO7hQ: folds 
*** FLOP *** [4d 2d 4h]
MG90wfSJZnOejs/KD3vlQQ: bets $1.40
M2QO2DxB5Wawg2h8HSpnYA: calls $1.40
*** TURN *** [4d 2d 4h] [5c]
MG90wfSJZnOejs/KD3vlQQ: bets $3.40
M2QO2DxB5Wawg2h8HSpnYA: calls $3.40
*** RIVER *** [4d 2d 4h 5c] [Qh]
zUXhymECc2C9W9ZNw6qppA is disconnected 
zUXhymECc2C9W9ZNw6qppA is connected 
MG90wfSJZnOejs/KD3vlQQ: bets $7.30
M2QO2DxB5Wawg2h8HSpnYA: folds 
Uncalled bet ($7.30) returned to MG90wfSJZnOejs/KD3vlQQ
MG90wfSJZnOejs/KD3vlQQ collected $10.90 from pot
MG90wfSJZnOejs/KD3vlQQ: doesn't show hand 
*** SUMMARY ***
Total pot $11.45 | Rake $0.55 
Board [4d 2d 4h 5c Qh]
Seat 2: N6foVRyErHqcNmshkqextQ folded before Flop (didn't bet)
Seat 3: M2QO2DxB5Wawg2h8HSpnYA folded on the River
Seat 5: zUXhymECc2C9W9ZNw6qppA folded before Flop (didn't bet)
Seat 6: EP17SQz/iWcuYdNOGeBgkw (button) folded before Flop (didn't bet)
Seat 7: zgi+EUykT/pZQpoUG6+oEg (small blind) folded before Flop
Seat 8: tYsOBqdU1+x+yFI7zHO7hQ (big blind) folded before Flop
Seat 9: MG90wfSJZnOejs/KD3vlQQ collected ($10.90)




PokerStars Game #59941786870:  Hold'em No Limit ($0.10/$0.25) - 2009/07/01 1:46:08 ET
Table 'WEMI3Mtn7dGARDbgNrKibgQvLFJzpzymuOsaaRYi+8fgx Seat #2 is the button
Seat 1: cZ99hugmLBj9KhTlc8nCSw ($25 in chips) 
Seat 2: PdIasPkzm2sqZnN41ZRXOg ($5 in chips) 
Seat 3: Qduu7ikeizo6q6Ei9YvcJA ($24.75 in chips) 
Seat 4: tLcDklc2rBORNfixyRfVfw ($25.60 in chips) 
Seat 5: MG90wfSJZnOejs/KD3vlQQ ($36.75 in chips) 
Seat 6: vKdukiQ4ktU4yJ0Xx3MKnA ($10.10 in chips) 
Seat 7: rQhYIYXSyH/IivYM1dlV5A ($11.20 in chips) 
Seat 8: gehe91e0IyVT0QU/XBkEyg ($27.35 in chips) 
Seat 9: BWzInv8o0kN1pJybv/VjpQ ($43.75 in chips) 
Qduu7ikeizo6q6Ei9YvcJA: posts small blind $0.10
tLcDklc2rBORNfixyRfVfw: posts big blind $0.25
*** HOLE CARDS ***
MG90wfSJZnOejs/KD3vlQQ: folds 
vKdukiQ4ktU4yJ0Xx3MKnA: raises $0.25 to $0.50
rQhYIYXSyH/IivYM1dlV5A: folds 
gehe91e0IyVT0QU/XBkEyg: folds 
BWzInv8o0kN1pJybv/VjpQ: folds 
cZ99hugmLBj9KhTlc8nCSw: raises $1 to $1.50
PdIasPkzm2sqZnN41ZRXOg: folds 
Qduu7ikeizo6q6Ei9YvcJA: folds 
tLcDklc2rBORNfixyRfVfw: folds 
vKdukiQ4ktU4yJ0Xx3MKnA: calls $1
*** FLOP *** [Jh 3d 5d]
vKdukiQ4ktU4yJ0Xx3MKnA: checks 
cZ99hugmLBj9KhTlc8nCSw: bets $2.25
vKdukiQ4ktU4yJ0Xx3MKnA: folds 
Uncalled bet ($2.25) returned to cZ99hugmLBj9KhTlc8nCSw
cZ99hugmLBj9KhTlc8nCSw collected $3.20 from pot
cZ99hugmLBj9KhTlc8nCSw: doesn't show hand 
*** SUMMARY ***
Total pot $3.35 | Rake $0.15 
Board [Jh 3d 5d]
Seat 1: cZ99hugmLBj9KhTlc8nCSw collected ($3.20)
Seat 2: PdIasPkzm2sqZnN41ZRXOg (button) folded before Flop (didn't bet)
Seat 3: Qduu7ikeizo6q6Ei9YvcJA (small blind) folded before Flop
Seat 4: tLcDklc2rBORNfixyRfVfw (big blind) folded before Flop
Seat 5: MG90wfSJZnOejs/KD3vlQQ folded before Flop (didn't bet)
Seat 6: vKdukiQ4ktU4yJ0Xx3MKnA folded on the Flop
Seat 7: rQhYIYXSyH/IivYM1dlV5A folded before Flop (didn't bet)
Seat 8: gehe91e0IyVT0QU/XBkEyg folded before Flop (didn't bet)
Seat 9: BWzInv8o0kN1pJybv/VjpQ folded before Flop (didn't bet)




PokerStars Game #59941787480:  Hold'em No Limit ($0.10/$0.25) - 2009/07/01 1:46:09 ET
Table 'l8hUTjBTXBorNUR/tyvSLw' 9-max Seat #6 is the button
Seat 1: cZ99hugmLBj9KhTlc8nCSw ($27.85 in chips) 
Seat 2: B6xHiX1SJkS0CUNCKDVwuQ ($21.50 in chips) 
Seat 3: ShCS62CJp4MKfKLKvGKQbA ($9.10 in chips) 
Seat 4: vPtFvcPtn/Afz0sucO1cmQ ($36.95 in chips) 
Seat 5: yyG4svzOpC1A+sUP/scg6w ($6.50 in chips) 
Seat 6: EVqHvqty1ZsuvDFiSXlSqQ ($24.20 in chips) 
Seat 7: F7pnn6czNpHvRM55XcA2EA ($33.15 in chips) 
Seat 8: Mh2r9hTeTEDnh19sRZtW3g ($5 in chips) 
Seat 9: zDrucyjVn5aeekNEc3cJrA ($32.70 in chips) 
F7pnn6czNpHvRM55XcA2EA: posts small blind $0.10
Mh2r9hTeTEDnh19sRZtW3g: posts big blind $0.25
*** HOLE CARDS ***
zDrucyjVn5aeekNEc3cJrA: folds 
cZ99hugmLBj9KhTlc8nCSw: folds 
B6xHiX1SJkS0CUNCKDVwuQ: folds 
ShCS62CJp4MKfKLKvGKQbA: folds 
vPtFvcPtn/Afz0sucO1cmQ: calls $0.25
yyG4svzOpC1A+sUP/scg6w: folds 
EVqHvqty1ZsuvDFiSXlSqQ: calls $0.25
F7pnn6czNpHvRM55XcA2EA: raises $1.25 to $1.50
Mh2r9hTeTEDnh19sRZtW3g: folds 
vPtFvcPtn/Afz0sucO1cmQ: folds 
EVqHvqty1ZsuvDFiSXlSqQ: folds 
Uncalled bet ($1.25) returned to F7pnn6czNpHvRM55XcA2EA
F7pnn6czNpHvRM55XcA2EA collected $1 from pot
F7pnn6czNpHvRM55XcA2EA: doesn't show hand 
*** SUMMARY ***
Total pot $1 | Rake $0 
Seat 1: cZ99hugmLBj9KhTlc8nCSw folded before Flop (didn't bet)
Seat 2: B6xHiX1SJkS0CUNCKDVwuQ folded before Flop (didn't bet)
Seat 3: ShCS62CJp4MKfKLKvGKQbA folded before Flop (didn't bet)
Seat 4: vPtFvcPtn/Afz0sucO1cmQ folded before Flop
Seat 5: yyG4svzOpC1A+sUP/scg6w folded before Flop (didn't bet)
Seat 6: EVqHvqty1ZsuvDFiSXlSqQ (button) folded before Flop
Seat 7: F7pnn6czNpHvRM55XcA2EA (small blind) collected ($1)
Seat 8: Mh2r9hTeTEDnh19sRZtW3g (big blind) folded before Flop
Seat 9: zDrucyjVn5aeekNEc3cJrA folded before Flop (didn't bet)




PokerStars Game #59941787532:  Hold'em No Limit ($0.10/$0.25) - 2009/07/01 1:46:09 ET
Table 'mdub7rJf3Z5tCT9s/+1+Wg' 9-max Seat #2 is the button
Seat 1: cZ99hugmLBj9KhTlc8nCSw ($28.90 in chips) 
Seat 2: 539MC3AwKLWVFwzABc644Q ($10.30 in chips) 
Seat 3: PdIasPkzm2sqZnN41ZRXOg ($5.70 in chips) 
Seat 4: fDGyaQz0cs2s4FOYxkbIHA ($14.85 in chips) 
Seat 5: dfNim92Z6XK1/h5SFW5vDg ($26.25 in chips) 
Seat 6: T/CCwAWe2yhO0c4oHNwicw ($23.25 in chips) 
Seat 7: woe+9KKk+L3pZgMTuHcmog ($15.45 in chips) 
Seat 8: Z9AeOQX3yzuSvKAm/xyovg ($5.90 in chips) 
Seat 9: tYsOBqdU1+x+yFI7zHO7hQ ($36.05 in chips) 
PdIasPkzm2sqZnN41ZRXOg: posts small blind $0.10
fDGyaQz0cs2s4FOYxkbIHA: posts big blind $0.25
*** HOLE CARDS ***
dfNim92Z6XK1/h5SFW5vDg: folds 
T/CCwAWe2yhO0c4oHNwicw: folds 
woe+9KKk+L3pZgMTuHcmog: calls $0.25
Z9AeOQX3yzuSvKAm/xyovg: folds 
tYsOBqdU1+x+yFI7zHO7hQ: folds 
cZ99hugmLBj9KhTlc8nCSw: folds 
539MC3AwKLWVFwzABc644Q: calls $0.25
PdIasPkzm2sqZnN41ZRXOg: folds 
fDGyaQz0cs2s4FOYxkbIHA: checks 
*** FLOP *** [Kh 4s Qh]
Z9AeOQX3yzuSvKAm/xyovg leaves the table
fDGyaQz0cs2s4FOYxkbIHA: checks 
bXpVeaSTPBFSPJmeXxO7nw joins the table at seat #8 
woe+9KKk+L3pZgMTuHcmog: checks 
539MC3AwKLWVFwzABc644Q: checks 
*** TURN *** [Kh 4s Qh] [Qd]
fDGyaQz0cs2s4FOYxkbIHA: checks 
woe+9KKk+L3pZgMTuHcmog: checks 
539MC3AwKLWVFwzABc644Q: bets $0.25
fDGyaQz0cs2s4FOYxkbIHA: folds 
woe+9KKk+L3pZgMTuHcmog: folds 
Uncalled bet ($0.25) returned to 539MC3AwKLWVFwzABc644Q
539MC3AwKLWVFwzABc644Q collected $0.85 from pot
*** SUMMARY ***
Total pot $0.85 | Rake $0 
Board [Kh 4s Qh Qd]
Seat 1: cZ99hugmLBj9KhTlc8nCSw folded before Flop (didn't bet)
Seat 2: 539MC3AwKLWVFwzABc644Q (button) collected ($0.85)
Seat 3: PdIasPkzm2sqZnN41ZRXOg (small blind) folded before Flop
Seat 4: fDGyaQz0cs2s4FOYxkbIHA (big blind) folded on the Turn
Seat 5: dfNim92Z6XK1/h5SFW5vDg folded before Flop (didn't bet)
Seat 6: T/CCwAWe2yhO0c4oHNwicw folded before Flop (didn't bet)
Seat 7: woe+9KKk+L3pZgMTuHcmog folded on the Turn
Seat 8: Z9AeOQX3yzuSvKAm/xyovg folded before Flop (didn't bet)
Seat 9: tYsOBqdU1+x+yFI7zHO7hQ folded before Flop (didn't bet)




PokerStars Game #59941787734:  Hold'em No Limit ($0.10/$0.25) - 2009/07/01 1:46:09 ET
Table 'xPn6TS/y/OWkX7Qa+MUuKA' 6-max Seat #6 is the button
Seat 1: JFIAqU8lCZ0vWwEl4bdGsg ($42.80 in chips) 
Seat 2: buyjetgNT1McXtdaP4zynA ($27.60 in chips) 
Seat 3: q6WfTUAD9mowIP63ASq2Dg ($24.15 in chips) 
Seat 4: SS/yfeArhULzIcOPe8MdPg ($28.65 in chips) 
Seat 5: lquriepNQBhDV5P1SWHhnA ($28.60 in chips) 
Seat 6: DihMHaz4WNETH1bPDe13kA ($25 in chips) 
JFIAqU8lCZ0vWwEl4bdGsg: posts small blind $0.10
buyjetgNT1McXtdaP4zynA: posts big blind $0.25
*** HOLE CARDS ***
q6WfTUAD9mowIP63ASq2Dg: raises $0.60 to $0.85
SS/yfeArhULzIcOPe8MdPg: folds 
lquriepNQBhDV5P1SWHhnA: folds 
DihMHaz4WNETH1bPDe13kA: folds 
JFIAqU8lCZ0vWwEl4bdGsg: folds 
buyjetgNT1McXtdaP4zynA: folds 
Uncalled bet ($0.60) returned to q6WfTUAD9mowIP63ASq2Dg
q6WfTUAD9mowIP63ASq2Dg collected $0.60 from pot
q6WfTUAD9mowIP63ASq2Dg: doesn't show hand 
*** SUMMARY ***
Total pot $0.60 | Rake $0 
Seat 1: JFIAqU8lCZ0vWwEl4bdGsg (small blind) folded before Flop
Seat 2: buyjetgNT1McXtdaP4zynA (big blind) folded before Flop
Seat 3: q6WfTUAD9mowIP63ASq2Dg collected ($0.60)
Seat 4: SS/yfeArhULzIcOPe8MdPg folded before Flop (didn't bet)
Seat 5: lquriepNQBhDV5P1SWHhnA folded before Flop (didn't bet)
Seat 6: DihMHaz4WNETH1bPDe13kA (button) folded before Flop (didn't bet)




PokerStars Game #59941788410:  Hold'em No Limit ($0.10/$0.25) - 2009/07/01 1:46:10 ET
Table 'HzFR0rxmDAPu5GzYR0AlYg' 6-max Seat #2 is the button
Seat 1: v+QfkGiuj9bgtuNoVnDO8w ($32.05 in chips) 
Seat 2: UA5OsKS3VPaxa7uC8La/kA ($50.90 in chips) 
Seat 3: kG34n23qFQA3nzdOJTQ1dA ($25 in chips) 
Seat 4: Mhj3q7cxev+XjXZxEE6/Cw ($25 in chips) 
Seat 5: lquriepNQBhDV5P1SWHhnA ($29.85 in chips) 
Seat 6: jp34e617tIzV8tKIWmfAbA ($35.55 in chips) 
kG34n23qFQA3nzdOJTQ1dA: posts small blind $0.10
Mhj3q7cxev+XjXZxEE6/Cw: posts big blind $0.25
*** HOLE CARDS ***
lquriepNQBhDV5P1SWHhnA: folds 
jp34e617tIzV8tKIWmfAbA: folds 
v+QfkGiuj9bgtuNoVnDO8w: folds 
UA5OsKS3VPaxa7uC8La/kA: raises $0.50 to $0.75
kG34n23qFQA3nzdOJTQ1dA: folds 
Mhj3q7cxev+XjXZxEE6/Cw: folds 
Uncalled bet ($0.50) returned to UA5OsKS3VPaxa7uC8La/kA
UA5OsKS3VPaxa7uC8La/kA collected $0.60 from pot
*** SUMMARY ***
Total pot $0.60 | Rake $0 
Seat 1: v+QfkGiuj9bgtuNoVnDO8w folded before Flop (didn't bet)
Seat 2: UA5OsKS3VPaxa7uC8La/kA (button) collected ($0.60)
Seat 3: kG34n23qFQA3nzdOJTQ1dA (small blind) folded before Flop
Seat 4: Mhj3q7cxev+XjXZxEE6/Cw (big blind) folded before Flop
Seat 5: lquriepNQBhDV5P1SWHhnA folded before Flop (didn't bet)
Seat 6: jp34e617tIzV8tKIWmfAbA folded before Flop (didn't bet)




PokerStars Game #59941788208:  Hold'em No Limit ($0.10/$0.25) - 2009/07/01 1:46:10 ET
Table 'Ok3oDLIsTc2+KxPcI0bAOA' 6-max Seat #5 is the button
Seat 1: agQm3ugZ3qSVYNgNu1ddeA ($40.50 in chips) 
Seat 2: wPSNSp4HYtytRMXTu3oPSQ ($26.95 in chips) 
Seat 3: lquriepNQBhDV5P1SWHhnA ($36.45 in chips) 
Seat 4: LJI7A1YgDM7hgh7o56+ReQ ($35.30 in chips) 
Seat 5: DFi/Lzkjsfv8QswS80JX9Q ($30.10 in chips) 
Seat 6: Hsvkc0/G2VV78oVmWYXecw ($5 in chips) 
Hsvkc0/G2VV78oVmWYXecw: posts small blind $0.10
agQm3ugZ3qSVYNgNu1ddeA: posts big blind $0.25
*** HOLE CARDS ***
wPSNSp4HYtytRMXTu3oPSQ: calls $0.25
lquriepNQBhDV5P1SWHhnA: folds 
LJI7A1YgDM7hgh7o56+ReQ: raises $1 to $1.25
DFi/Lzkjsfv8QswS80JX9Q: folds 
Hsvkc0/G2VV78oVmWYXecw: folds 
agQm3ugZ3qSVYNgNu1ddeA: calls $1
wPSNSp4HYtytRMXTu3oPSQ: calls $1
*** FLOP *** [2h 4d 4h]
agQm3ugZ3qSVYNgNu1ddeA: checks 
wPSNSp4HYtytRMXTu3oPSQ: checks 
LJI7A1YgDM7hgh7o56+ReQ: checks 
*** TURN *** [2h 4d 4h] [5d]
agQm3ugZ3qSVYNgNu1ddeA: checks 
wPSNSp4HYtytRMXTu3oPSQ: checks 
LJI7A1YgDM7hgh7o56+ReQ: checks 
*** RIVER *** [2h 4d 4h 5d] [6c]
agQm3ugZ3qSVYNgNu1ddeA: checks 
wPSNSp4HYtytRMXTu3oPSQ: bets $2.25
LJI7A1YgDM7hgh7o56+ReQ: folds 
agQm3ugZ3qSVYNgNu1ddeA: folds 
Uncalled bet ($2.25) returned to wPSNSp4HYtytRMXTu3oPSQ
wPSNSp4HYtytRMXTu3oPSQ collected $3.70 from pot
wPSNSp4HYtytRMXTu3oPSQ: doesn't show hand 
*** SUMMARY ***
Total pot $3.85 | Rake $0.15 
Board [2h 4d 4h 5d 6c]
Seat 1: agQm3ugZ3qSVYNgNu1ddeA (big blind) folded on the River
Seat 2: wPSNSp4HYtytRMXTu3oPSQ collected ($3.70)
Seat 3: lquriepNQBhDV5P1SWHhnA folded before Flop (didn't bet)
Seat 4: LJI7A1YgDM7hgh7o56+ReQ folded on the River
Seat 5: DFi/Lzkjsfv8QswS80JX9Q (button) folded before Flop (didn't bet)
Seat 6: Hsvkc0/G2VV78oVmWYXecw (small blind) folded before Flop




PokerStars Game #59941787940:  Hold'em No Limit ($0.10/$0.25) - 2009/07/01 1:46:10 ET
Table 'xro+BVoe2Zuw1TYmz/McJQ' 9-max Seat #8 is the button
Seat 2: vSkQm2EelzwRGDDQQk0Fqw ($4.65 in chips) 
Seat 4: N2LVj3iImgnOoHVf8g0rIw ($46.25 in chips) 
Seat 5: w48D7DZIjuBit2n4FRDJ5Q ($14.85 in chips) 
Seat 6: HPEB+AtKw1+C/cxU0o1ciw ($26.50 in chips) 
Seat 7: QEbIGci+itdw+re8RM5fZA ($30.80 in chips) 
Seat 8: ljemhp25Zg+nlA9DLCIiUw ($22.65 in chips) 
vSkQm2EelzwRGDDQQk0Fqw: posts small blind $0.10
PdIasPkzm2sqZnN41ZRXOg: is sitting out 
PdIasPkzm2sqZnN41ZRXOg leaves the table
N2LVj3iImgnOoHVf8g0rIw: posts big blind $0.25
*** HOLE CARDS ***
w48D7DZIjuBit2n4FRDJ5Q: folds 
HPEB+AtKw1+C/cxU0o1ciw: folds 
w48D7DZIjuBit2n4FRDJ5Q leaves the table
QEbIGci+itdw+re8RM5fZA: folds 
ljemhp25Zg+nlA9DLCIiUw: folds 
vSkQm2EelzwRGDDQQk0Fqw: raises $0.50 to $0.75
N2LVj3iImgnOoHVf8g0rIw: calls $0.50
*** FLOP *** [8s Th 6h]
vSkQm2EelzwRGDDQQk0Fqw: bets $1
N2LVj3iImgnOoHVf8g0rIw: calls $1
*** TURN *** [8s Th 6h] [Kc]
vSkQm2EelzwRGDDQQk0Fqw: bets $2.90 and is all-in
N2LVj3iImgnOoHVf8g0rIw: calls $2.90
*** RIVER *** [8s Th 6h Kc] [5s]
*** SHOW DOWN ***
vSkQm2EelzwRGDDQQk0Fqw: shows [Js Kh] (a pair of Kings)
N2LVj3iImgnOoHVf8g0rIw: mucks hand 
vSkQm2EelzwRGDDQQk0Fqw collected $8.85 from pot
*** SUMMARY ***
Total pot $9.30 | Rake $0.45 
Board [8s Th 6h Kc 5s]
Seat 2: vSkQm2EelzwRGDDQQk0Fqw (small blind) showed [Js Kh] and won ($8.85) with a pair of Kings
Seat 4: N2LVj3iImgnOoHVf8g0rIw (big blind) mucked
Seat 5: w48D7DZIjuBit2n4FRDJ5Q folded before Flop (didn't bet)
Seat 6: HPEB+AtKw1+C/cxU0o1ciw folded before Flop (didn't bet)
Seat 7: QEbIGci+itdw+re8RM5fZA folded before Flop (didn't bet)
Seat 8: ljemhp25Zg+nlA9DLCIiUw (button) folded before Flop (didn't bet)




PokerStars Game #59941788486:  Hold'em No Limit ($0.10/$0.25) - 2009/07/01 1:46:10 ET
Table '4hfTdIVT/qPsJNfWXLsVIw' 9-max Seat #8 is the button
Seat 1: GbHFBbLqLGz0Pwn6CJeAuw ($41.30 in chips) 
Seat 2: Pt637jKksB5MzP0UNJAAkw ($40.20 in chips) 
Seat 3: xnVwSkROfRtOw4eSoDANtw ($4.70 in chips) 
Seat 5: dtZ84flFEi4Q+SGrHMJRDQ ($25.10 in chips) 
Seat 6: VWUWpMLMj/Q1jRVpF7Aohw ($12.90 in chips) 
Seat 8: 7cv+9Zc9HIQHNvYsMfV3uA ($28.65 in chips) 
Seat 9: 9njEKzpOKC62MllUFUBWrA ($24.10 in chips) 
9njEKzpOKC62MllUFUBWrA: posts small blind $0.10
GbHFBbLqLGz0Pwn6CJeAuw: posts big blind $0.25
3PmVnC/15cl4oyI1TKIt4g: sits out 
d7YasxuGLPiL7pj8IcGThw: sits out 
*** HOLE CARDS ***
Pt637jKksB5MzP0UNJAAkw: folds 
xnVwSkROfRtOw4eSoDANtw: folds 
dtZ84flFEi4Q+SGrHMJRDQ: folds 
VWUWpMLMj/Q1jRVpF7Aohw: folds 
7cv+9Zc9HIQHNvYsMfV3uA: raises $0.75 to $1
9njEKzpOKC62MllUFUBWrA: folds 
GbHFBbLqLGz0Pwn6CJeAuw: calls $0.75
*** FLOP *** [9h Qc Ts]
GbHFBbLqLGz0Pwn6CJeAuw: checks 
7cv+9Zc9HIQHNvYsMfV3uA: checks 
*** TURN *** [9h Qc Ts] [7s]
GbHFBbLqLGz0Pwn6CJeAuw: bets $0.75
7cv+9Zc9HIQHNvYsMfV3uA: calls $0.75
*** RIVER *** [9h Qc Ts 7s] [As]
GbHFBbLqLGz0Pwn6CJeAuw: bets $0.75
7cv+9Zc9HIQHNvYsMfV3uA: raises $2.50 to $3.25
GbHFBbLqLGz0Pwn6CJeAuw: calls $2.50
*** SHOW DOWN ***
7cv+9Zc9HIQHNvYsMfV3uA: shows [Ad 9s] (two pair, Aces and Nines)
GbHFBbLqLGz0Pwn6CJeAuw: shows [Ah Jd] (a pair of Aces)
7cv+9Zc9HIQHNvYsMfV3uA collected $9.65 from pot
*** SUMMARY ***
Total pot $10.10 | Rake $0.45 
Board [9h Qc Ts 7s As]
Seat 1: GbHFBbLqLGz0Pwn6CJeAuw (big blind) showed [Ah Jd] and lost with a pair of Aces
Seat 2: Pt637jKksB5MzP0UNJAAkw folded before Flop (didn't bet)
Seat 3: xnVwSkROfRtOw4eSoDANtw folded before Flop (didn't bet)
Seat 5: dtZ84flFEi4Q+SGrHMJRDQ folded before Flop (didn't bet)
Seat 6: VWUWpMLMj/Q1jRVpF7Aohw folded before Flop (didn't bet)
Seat 8: 7cv+9Zc9HIQHNvYsMfV3uA (button) showed [Ad 9s] and won ($9.65) with two pair, Aces and Nines
Seat 9: 9njEKzpOKC62MllUFUBWrA (small blind) folded before Flop




PokerStars Game #59941788168:  Hold'em No Limit ($0.10/$0.25) - 2009/07/01 1:46:10 ET
Table 'BabJGL6tfXQp3leBGbYe8A' 9-max Seat #3 is the button
Seat 1: qwr38jl5txoR36M7G5qi4A ($10 in chips) 
Seat 2: dtZ84flFEi4Q+SGrHMJRDQ ($35.65 in chips) 
Seat 3: sD+TKtt36XiiN6jqHiLwDA ($28.80 in chips) 
Seat 4: gehe91e0IyVT0QU/XBkEyg ($28.20 in chips) 
Seat 5: GrNTWMdwy+jC6Lred1eDng ($15 in chips) 
Seat 6: egvg3mTBBVzMHnJPIQiKcA ($13.90 in chips) 
Seat 7: eK8qa6EPcH2zhtbmWSvc9g ($27.85 in chips) 
Seat 8: OXPkK84/qv92EMwXPiG5rQ ($9.75 in chips) 
Seat 9: P+9ymZQ3ktpQu1bn7HIjew ($9.50 in chips) 
gehe91e0IyVT0QU/XBkEyg: posts small blind $0.10
GrNTWMdwy+jC6Lred1eDng: posts big blind $0.25
*** HOLE CARDS ***
egvg3mTBBVzMHnJPIQiKcA: folds 
eK8qa6EPcH2zhtbmWSvc9g: folds 
OXPkK84/qv92EMwXPiG5rQ: folds 
P+9ymZQ3ktpQu1bn7HIjew: folds 
qwr38jl5txoR36M7G5qi4A: folds 
dtZ84flFEi4Q+SGrHMJRDQ: calls $0.25
sD+TKtt36XiiN6jqHiLwDA: folds 
gehe91e0IyVT0QU/XBkEyg: folds 
GrNTWMdwy+jC6Lred1eDng: checks 
*** FLOP *** [Jc Ad 8d]
GrNTWMdwy+jC6Lred1eDng: checks 
dtZ84flFEi4Q+SGrHMJRDQ: bets $0.50
GrNTWMdwy+jC6Lred1eDng: calls $0.50
*** TURN *** [Jc Ad 8d] [7h]
GrNTWMdwy+jC6Lred1eDng: checks 
dtZ84flFEi4Q+SGrHMJRDQ: checks 
*** RIVER *** [Jc Ad 8d 7h] [4c]
GrNTWMdwy+jC6Lred1eDng: bets $1.50
dtZ84flFEi4Q+SGrHMJRDQ: raises $3 to $4.50
GrNTWMdwy+jC6Lred1eDng: calls $3
*** SHOW DOWN ***
dtZ84flFEi4Q+SGrHMJRDQ: shows [4h 4s] (three of a kind, Fours)
GrNTWMdwy+jC6Lred1eDng: mucks hand 
dtZ84flFEi4Q+SGrHMJRDQ collected $10.10 from pot
GrNTWMdwy+jC6Lred1eDng said, "LOL"
*** SUMMARY ***
Total pot $10.60 | Rake $0.50 
Board [Jc Ad 8d 7h 4c]
Seat 1: qwr38jl5txoR36M7G5qi4A folded before Flop (didn't bet)
Seat 2: dtZ84flFEi4Q+SGrHMJRDQ showed [4h 4s] and won ($10.10) with three of a kind, Fours
Seat 3: sD+TKtt36XiiN6jqHiLwDA (button) folded before Flop (didn't bet)
Seat 4: gehe91e0IyVT0QU/XBkEyg (small blind) folded before Flop
Seat 5: GrNTWMdwy+jC6Lred1eDng (big blind) mucked
Seat 6: egvg3mTBBVzMHnJPIQiKcA folded before Flop (didn't bet)
Seat 7: eK8qa6EPcH2zhtbmWSvc9g folded before Flop (didn't bet)
Seat 8: OXPkK84/qv92EMwXPiG5rQ folded before Flop (didn't bet)
Seat 9: P+9ymZQ3ktpQu1bn7HIjew folded before Flop (didn't bet)




PokerStars Game #59941788222:  Hold'em No Limit ($0.10/$0.25) - 2009/07/01 1:46:10 ET
Table 'Yb2CyZosw7N3yRRVLhKnKg' 9-max Seat #3 is the button
Seat 1: c/9X4zftzphFxYtxp5kp9w ($13.80 in chips) 
Seat 2: dtZ84flFEi4Q+SGrHMJRDQ ($26.15 in chips) 
Seat 3: wUanlt/hhheMA+jOrJk2Tg ($9.65 in chips) 
Seat 4: FG10kumpruEJ3PQJ7oGglQ ($13.80 in chips) 
Seat 5: T5Hk9oiIr+JDDMnEqwFCrw ($2.25 in chips) 
Seat 6: CgIo2ItZqi4o3ayVG6HanQ ($43.95 in chips) 
Seat 7: ljemhp25Zg+nlA9DLCIiUw ($26.10 in chips) 
Seat 8: HxDF4QSxC4z39D7teZpprQ ($10.75 in chips) 
Seat 9: 6DVf3fwEGECnjQ4Yp9AsFw ($16.55 in chips) 
FG10kumpruEJ3PQJ7oGglQ: posts small blind $0.10
T5Hk9oiIr+JDDMnEqwFCrw: posts big blind $0.25
*** HOLE CARDS ***
CgIo2ItZqi4o3ayVG6HanQ: calls $0.25
ljemhp25Zg+nlA9DLCIiUw: folds 
HxDF4QSxC4z39D7teZpprQ: folds 
6DVf3fwEGECnjQ4Yp9AsFw: folds 
c/9X4zftzphFxYtxp5kp9w: raises $0.50 to $0.75
dtZ84flFEi4Q+SGrHMJRDQ: folds 
wUanlt/hhheMA+jOrJk2Tg: folds 
FG10kumpruEJ3PQJ7oGglQ: folds 
T5Hk9oiIr+JDDMnEqwFCrw: raises $1.50 to $2.25 and is all-in
CgIo2ItZqi4o3ayVG6HanQ: calls $2
c/9X4zftzphFxYtxp5kp9w: calls $1.50
*** FLOP *** [Th 5h 6d]
CgIo2ItZqi4o3ayVG6HanQ: checks 
c/9X4zftzphFxYtxp5kp9w: checks 
*** TURN *** [Th 5h 6d] [Kh]
CgIo2ItZqi4o3ayVG6HanQ: checks 
c/9X4zftzphFxYtxp5kp9w: checks 
*** RIVER *** [Th 5h 6d Kh] [9c]
CgIo2ItZqi4o3ayVG6HanQ: bets $3.25
c/9X4zftzphFxYtxp5kp9w: folds 
Uncalled bet ($3.25) returned to CgIo2ItZqi4o3ayVG6HanQ
*** SHOW DOWN ***
CgIo2ItZqi4o3ayVG6HanQ: shows [Qc Js] (a straight, Nine to King)
T5Hk9oiIr+JDDMnEqwFCrw: mucks hand 
CgIo2ItZqi4o3ayVG6HanQ collected $6.55 from pot
*** SUMMARY ***
Total pot $6.85 | Rake $0.30 
Board [Th 5h 6d Kh 9c]
Seat 1: c/9X4zftzphFxYtxp5kp9w folded on the River
Seat 2: dtZ84flFEi4Q+SGrHMJRDQ folded before Flop (didn't bet)
Seat 3: wUanlt/hhheMA+jOrJk2Tg (button) folded before Flop (didn't bet)
Seat 4: FG10kumpruEJ3PQJ7oGglQ (small blind) folded before Flop
Seat 5: T5Hk9oiIr+JDDMnEqwFCrw (big blind) mucked
Seat 6: CgIo2ItZqi4o3ayVG6HanQ showed [Qc Js] and won ($6.55) with a straight, Nine to King
Seat 7: ljemhp25Zg+nlA9DLCIiUw folded before Flop (didn't bet)
Seat 8: HxDF4QSxC4z39D7teZpprQ folded before Flop (didn't bet)
Seat 9: 6DVf3fwEGECnjQ4Yp9AsFw folded before Flop (didn't bet)




PokerStars Game #59941788010:  Hold'em No Limit ($0.10/$0.25) - 2009/07/01 1:46:10 ET
Table 'IfRHUn9gQQA9I/Z4tn+BoA' 9-max Seat #5 is the button
Seat 1: imHPFFqvfHGzsBBWeGuy4w ($24.35 in chips) 
Seat 2: VWUWpMLMj/Q1jRVpF7Aohw ($16.95 in chips) 
Seat 3: ModuIAhh03puxW6XFxQ3Nw ($11.15 in chips) 
Seat 4: QEbIGci+itdw+re8RM5fZA ($33.55 in chips) 
Seat 5: DdPXdieucQ+n99u1n3A+rQ ($4.65 in chips) 
Seat 6: UOjoGGQ58/uDS7V0xkjOrQ ($16.70 in chips) 
Seat 7: YzqSxP03XxZPbgPifgt69g ($29.10 in chips) 
Seat 8: cZ99hugmLBj9KhTlc8nCSw ($28.10 in chips) 
Seat 9: 7cv+9Zc9HIQHNvYsMfV3uA ($47.75 in chips) 
UOjoGGQ58/uDS7V0xkjOrQ: posts small blind $0.10
YzqSxP03XxZPbgPifgt69g: posts big blind $0.25
*** HOLE CARDS ***
cZ99hugmLBj9KhTlc8nCSw: folds 
7cv+9Zc9HIQHNvYsMfV3uA: folds 
imHPFFqvfHGzsBBWeGuy4w: folds 
VWUWpMLMj/Q1jRVpF7Aohw: folds 
ModuIAhh03puxW6XFxQ3Nw: raises $0.50 to $0.75
QEbIGci+itdw+re8RM5fZA: folds 
DdPXdieucQ+n99u1n3A+rQ: folds 
UOjoGGQ58/uDS7V0xkjOrQ: calls $0.65
YzqSxP03XxZPbgPifgt69g: folds 
*** FLOP *** [Ks Th 2h]
UOjoGGQ58/uDS7V0xkjOrQ: checks 
ModuIAhh03puxW6XFxQ3Nw: bets $1.25
UOjoGGQ58/uDS7V0xkjOrQ: calls $1.25
*** TURN *** [Ks Th 2h] [4h]
UOjoGGQ58/uDS7V0xkjOrQ: checks 
ModuIAhh03puxW6XFxQ3Nw: bets $2
UOjoGGQ58/uDS7V0xkjOrQ: calls $2
*** RIVER *** [Ks Th 2h 4h] [6c]
UOjoGGQ58/uDS7V0xkjOrQ: checks 
ModuIAhh03puxW6XFxQ3Nw: bets $2.75
UOjoGGQ58/uDS7V0xkjOrQ: calls $2.75
*** SHOW DOWN ***
ModuIAhh03puxW6XFxQ3Nw: shows [Td Kc] (two pair, Kings and Tens)
UOjoGGQ58/uDS7V0xkjOrQ: mucks hand 
ModuIAhh03puxW6XFxQ3Nw collected $13.10 from pot
*** SUMMARY ***
Total pot $13.75 | Rake $0.65 
Board [Ks Th 2h 4h 6c]
Seat 1: imHPFFqvfHGzsBBWeGuy4w folded before Flop (didn't bet)
Seat 2: VWUWpMLMj/Q1jRVpF7Aohw folded before Flop (didn't bet)
Seat 3: ModuIAhh03puxW6XFxQ3Nw showed [Td Kc] and won ($13.10) with two pair, Kings and Tens
Seat 4: QEbIGci+itdw+re8RM5fZA folded before Flop (didn't bet)
Seat 5: DdPXdieucQ+n99u1n3A+rQ (button) folded before Flop (didn't bet)
Seat 6: UOjoGGQ58/uDS7V0xkjOrQ (small blind) mucked
Seat 7: YzqSxP03XxZPbgPifgt69g (big blind) folded before Flop
Seat 8: cZ99hugmLBj9KhTlc8nCSw folded before Flop (didn't bet)
Seat 9: 7cv+9Zc9HIQHNvYsMfV3uA folded before Flop (didn't bet)




PokerStars Game #59941788012:  Hold'em No Limit ($0.10/$0.25) - 2009/07/01 1:46:10 ET
Table 'yZgGBnUGXVCcEJdcqes8tw' 9-max Seat #8 is the button
Seat 1: 6RiVTYll/5D8zICp0MRpKw ($28.70 in chips) 
Seat 2: MG90wfSJZnOejs/KD3vlQQ ($25 in chips) 
Seat 4: M2QO2DxB5Wawg2h8HSpnYA ($10 in chips) 
Seat 5: dfNim92Z6XK1/h5SFW5vDg ($25.85 in chips) 
Seat 6: RHqgdFvufLCYe54+qd2gcA ($4.75 in chips) 
Seat 7: eC8Pn1D6Y2pct8o62nQfvQ ($26.55 in chips) 
Seat 8: dtZ84flFEi4Q+SGrHMJRDQ ($31.55 in chips) 
Seat 9: M/9j4wkHH9i1JM51vgi1VA ($23.50 in chips) 
M/9j4wkHH9i1JM51vgi1VA: posts small blind $0.10
6RiVTYll/5D8zICp0MRpKw: posts big blind $0.25
*** HOLE CARDS ***
MG90wfSJZnOejs/KD3vlQQ: folds 
M2QO2DxB5Wawg2h8HSpnYA: folds 
dfNim92Z6XK1/h5SFW5vDg: folds 
RHqgdFvufLCYe54+qd2gcA: raises $0.75 to $1
eC8Pn1D6Y2pct8o62nQfvQ: calls $1
dtZ84flFEi4Q+SGrHMJRDQ: folds 
M/9j4wkHH9i1JM51vgi1VA: folds 
6RiVTYll/5D8zICp0MRpKw: folds 
*** FLOP *** [Jh Td 8s]
RHqgdFvufLCYe54+qd2gcA: bets $1.25
RHqgdFvufLCYe54+qd2gcA said, "?"
eC8Pn1D6Y2pct8o62nQfvQ: calls $1.25
*** TURN *** [Jh Td 8s] [3h]
RHqgdFvufLCYe54+qd2gcA: bets $2.50 and is all-in
eC8Pn1D6Y2pct8o62nQfvQ: calls $2.50
*** RIVER *** [Jh Td 8s 3h] [7s]
*** SHOW DOWN ***
RHqgdFvufLCYe54+qd2gcA: shows [Qd Kc] (high card King)
eC8Pn1D6Y2pct8o62nQfvQ: shows [Ah Ks] (high card Ace)
eC8Pn1D6Y2pct8o62nQfvQ collected $9.40 from pot
*** SUMMARY ***
Total pot $9.85 | Rake $0.45 
Board [Jh Td 8s 3h 7s]
Seat 1: 6RiVTYll/5D8zICp0MRpKw (big blind) folded before Flop
Seat 2: MG90wfSJZnOejs/KD3vlQQ folded before Flop (didn't bet)
Seat 4: M2QO2DxB5Wawg2h8HSpnYA folded before Flop (didn't bet)
Seat 5: dfNim92Z6XK1/h5SFW5vDg folded before Flop (didn't bet)
Seat 6: RHqgdFvufLCYe54+qd2gcA showed [Qd Kc] and lost with high card King
Seat 7: eC8Pn1D6Y2pct8o62nQfvQ showed [Ah Ks] and won ($9.40) with high card Ace
Seat 8: dtZ84flFEi4Q+SGrHMJRDQ (button) folded before Flop (didn't bet)
Seat 9: M/9j4wkHH9i1JM51vgi1VA (small blind) folded before Flop




PokerStars Game #59941788164:  Hold'em No Limit ($0.10/$0.25) - 2009/07/01 1:46:10 ET
Table 'wGizWOswEL6P5QrvVkno/g' 6-max Seat #3 is the button
Seat 1: Qbfkn+ucISvbd1Xh32zAGA ($33.10 in chips) 
Seat 2: mfrkWA3PTeYPkbO6hi98Aw ($26.15 in chips) 
Seat 3: bJFzs6QmEEnz4miMfSDtcg ($12.55 in chips) 
Seat 4: 32YL2ZEp8NT4JB2RVM9euQ ($15.80 in chips) 
32YL2ZEp8NT4JB2RVM9euQ: posts small blind $0.10
Qbfkn+ucISvbd1Xh32zAGA: posts big blind $0.25
*** HOLE CARDS ***
mfrkWA3PTeYPkbO6hi98Aw: raises $0.75 to $1
rfSnsAuAfXTb8w/obc9OVQ has returned
bJFzs6QmEEnz4miMfSDtcg: calls $1
32YL2ZEp8NT4JB2RVM9euQ: folds 
rfSnsAuAfXTb8w/obc9OVQ leaves the table
Qbfkn+ucISvbd1Xh32zAGA: calls $0.75
*** FLOP *** [3h Ts Ah]
Qbfkn+ucISvbd1Xh32zAGA: checks 
mfrkWA3PTeYPkbO6hi98Aw: bets $2
bJFzs6QmEEnz4miMfSDtcg: folds 
Qbfkn+ucISvbd1Xh32zAGA: folds 
Uncalled bet ($2) returned to mfrkWA3PTeYPkbO6hi98Aw
mfrkWA3PTeYPkbO6hi98Aw collected $2.95 from pot
mfrkWA3PTeYPkbO6hi98Aw: doesn't show hand 
*** SUMMARY ***
Total pot $3.10 | Rake $0.15 
Board [3h Ts Ah]
Seat 1: Qbfkn+ucISvbd1Xh32zAGA (big blind) folded on the Flop
Seat 2: mfrkWA3PTeYPkbO6hi98Aw collected ($2.95)
Seat 3: bJFzs6QmEEnz4miMfSDtcg (button) folded on the Flop
Seat 4: 32YL2ZEp8NT4JB2RVM9euQ (small blind) folded before Flop




PokerStars Game #59941788704:  Hold'em No Limit ($0.10/$0.25) - 2009/07/01 1:46:11 ET
Table 'KYX9dFNuOA9l2PV46IebqQ' 9-max Seat #1 is the button
Seat 1: qZqVFan2U+GAA/c5LQFbcw ($9.65 in chips) 
Seat 2: z2SmIaQ3+5n/eY1BN5HgPg ($6 in chips) 
Seat 3: Uq3NSX4cIFaXe7pbXQuU+Q ($7.60 in chips) 
Seat 5: g7MXhRmNZxv1lIkKkUKa4w ($13 in chips) 
Seat 6: 4QYM+pWPc3J+6i8Zv8LvLg ($16.15 in chips) 
Seat 7: FVZtQJMz59M6BoiON/88Xg ($14.85 in chips) 
Seat 8: KRWTiGM4xH+MkvPtJz4+SA ($24.65 in chips) 
Seat 9: 6NECk10orj8iqgD3pZ2A0Q ($5 in chips) 
z2SmIaQ3+5n/eY1BN5HgPg: posts small blind $0.10
Uq3NSX4cIFaXe7pbXQuU+Q: posts big blind $0.25
*** HOLE CARDS ***
g7MXhRmNZxv1lIkKkUKa4w: folds 
4QYM+pWPc3J+6i8Zv8LvLg: folds 
FVZtQJMz59M6BoiON/88Xg: folds 
KRWTiGM4xH+MkvPtJz4+SA: folds 
6NECk10orj8iqgD3pZ2A0Q: folds 
qZqVFan2U+GAA/c5LQFbcw: raises $0.50 to $0.75
rPXwQUVloUl+qZm3CCtaJw leaves the table
z2SmIaQ3+5n/eY1BN5HgPg: raises $0.50 to $1.25
Uq3NSX4cIFaXe7pbXQuU+Q: folds 
qZqVFan2U+GAA/c5LQFbcw: raises $1.50 to $2.75
z2SmIaQ3+5n/eY1BN5HgPg: calls $1.50
*** FLOP *** [Jc 2h 9c]
z2SmIaQ3+5n/eY1BN5HgPg: bets $3.25 and is all-in
qZqVFan2U+GAA/c5LQFbcw: calls $3.25
*** TURN *** [Jc 2h 9c] [As]
*** RIVER *** [Jc 2h 9c As] [4d]
*** SHOW DOWN ***
z2SmIaQ3+5n/eY1BN5HgPg: shows [7d Qd] (high card Ace)
qZqVFan2U+GAA/c5LQFbcw: shows [Ac Kc] (a pair of Aces)
z2SmIaQ3+5n/eY1BN5HgPg leaves the table
qZqVFan2U+GAA/c5LQFbcw collected $11.65 from pot
*** SUMMARY ***
Total pot $12.25 | Rake $0.60 
Board [Jc 2h 9c As 4d]
Seat 1: qZqVFan2U+GAA/c5LQFbcw (button) showed [Ac Kc] and won ($11.65) with a pair of Aces
Seat 2: z2SmIaQ3+5n/eY1BN5HgPg (small blind) showed [7d Qd] and lost with high card Ace
Seat 3: Uq3NSX4cIFaXe7pbXQuU+Q (big blind) folded before Flop
Seat 5: g7MXhRmNZxv1lIkKkUKa4w folded before Flop (didn't bet)
Seat 6: 4QYM+pWPc3J+6i8Zv8LvLg folded before Flop (didn't bet)
Seat 7: FVZtQJMz59M6BoiON/88Xg folded before Flop (didn't bet)
Seat 8: KRWTiGM4xH+MkvPtJz4+SA folded before Flop (didn't bet)
Seat 9: 6NECk10orj8iqgD3pZ2A0Q folded before Flop (didn't bet)




PokerStars Game #59941788700:  Hold'em No Limit ($0.10/$0.25) - 2009/07/01 1:46:11 ET
Table 'LwnjzXstPtSrqrV/oDpnXQ' 9-max Seat #3 is the button
Seat 1: 9YN2IkT2JYYKFErZtZvCtA ($17.45 in chips) 
Seat 2: uLP/lYn7oKq9xCChBXsXxw ($26.65 in chips) 
Seat 3: 7je+LC5Mfs6nL8YBVh4frQ ($3.80 in chips) 
Seat 4: CmngQmkKTp8tkl6GMRTl6w ($8.85 in chips) 
Seat 5: Th3FldXKQW6hWVVPahaoOQ ($26.25 in chips) 
Seat 6: ljemhp25Zg+nlA9DLCIiUw ($39.85 in chips) 
Seat 7: c/Dw/6HyqldTzIRodAIZmg ($13.75 in chips) 
Seat 8: ShXPHWfjhfmAwLgDdm6bRQ ($13.30 in chips) 
Seat 9: q6WfTUAD9mowIP63ASq2Dgz/khFDKGihQjwgoiKKPOeg70 in chips) 
CmngQmkKTp8tkl6GMRTl6w: posts small blind $0.10
Th3FldXKQW6hWVVPahaoOQ: posts big blind $0.25
*** HOLE CARDS ***
ljemhp25Zg+nlA9DLCIiUw: folds 
c/Dw/6HyqldTzIRodAIZmg: folds 
ShXPHWfjhfmAwLgDdm6bRQ: folds 
q6WfTUAD9mowIP63ASq2Dgz/khFDKGihQjwgoiKKPOeges $0.50 to $0.75
9YN2IkT2JYYKFErZtZvCtA: folds 
uLP/lYn7oKq9xCChBXsXxw: folds 
7je+LC5Mfs6nL8YBVh4frQ: folds 
CmngQmkKTp8tkl6GMRTl6w: folds 
Th3FldXKQW6hWVVPahaoOQ: folds 
Uncalled bet ($0.50) returned to q6WfTUAD9mowIP63ASq2Dgz/khFDKGihQjwgoiKKPOegq6WfTUAD9mowIP63ASq2Dgt collected $0.60 from pot
q6WfTUAD9mowIP63ASq2Dgz/khFDKGihQjwgoiKKPOegn't show hand 
*** SUMMARY ***
Total pot $0.60 | Rake $0 
Seat 1: 9YN2IkT2JYYKFErZtZvCtA folded before Flop (didn't bet)
Seat 2: uLP/lYn7oKq9xCChBXsXxw folded before Flop (didn't bet)
Seat 3: 7je+LC5Mfs6nL8YBVh4frQ (button) folded before Flop (didn't bet)
Seat 4: CmngQmkKTp8tkl6GMRTl6w (small blind) folded before Flop
Seat 5: Th3FldXKQW6hWVVPahaoOQ (big blind) folded before Flop
Seat 6: ljemhp25Zg+nlA9DLCIiUw folded before Flop (didn't bet)
Seat 7: c/Dw/6HyqldTzIRodAIZmg folded before Flop (didn't bet)
Seat 8: ShXPHWfjhfmAwLgDdm6bRQ folded before Flop (didn't bet)
Seat 9: q6WfTUAD9mowIP63ASq2Dgz/khFDKGihQjwgoiKKPOegcted ($0.60)




PokerStars Game #59941788806:  Hold'em No Limit ($0.10/$0.25) - 2009/07/01 1:46:11 ET
Table '4mnXP0EWt9mMZYzTIVDQ0w' 9-max Seat #5 is the button
Seat 1: Z5y2J55JmfLYR6/DPAGHwQ ($21.10 in chips) 
Seat 2: BLEU2x2bnGRovIelAY6slA ($25.15 in chips) 
Seat 4: 9lvO/qyU+xrU95Teu1fv0g ($6.50 in chips) 
Seat 5: sSN8Y0AlsBeidZXPKmwXSw ($25.10 in chips) 
Seat 6: 5yjzPss7Y4kAWNDat3e0yQ ($29.20 in chips) 
Seat 8: 9YN2IkT2JYYKFErZtZvCtA ($20 in chips) 
Seat 9: N/O9ADKpmqB2ASZuqgodlw ($9.40 in chips) 
5yjzPss7Y4kAWNDat3e0yQ: posts small blind $0.10
9YN2IkT2JYYKFErZtZvCtA: posts big blind $0.25
*** HOLE CARDS ***
N/O9ADKpmqB2ASZuqgodlw: folds 
Z5y2J55JmfLYR6/DPAGHwQ: folds 
BLEU2x2bnGRovIelAY6slA: folds 
ompa52 joins the table at seat #3 
9lvO/qyU+xrU95Teu1fv0g: folds 
sSN8Y0AlsBeidZXPKmwXSw: folds 
5yjzPss7Y4kAWNDat3e0yQ: folds 
Uncalled bet ($0.15) returned to 9YN2IkT2JYYKFErZtZvCtA
9YN2IkT2JYYKFErZtZvCtA collected $0.20 from pot
9YN2IkT2JYYKFErZtZvCtA: doesn't show hand 
*** SUMMARY ***
Total pot $0.20 | Rake $0 
Seat 1: Z5y2J55JmfLYR6/DPAGHwQ folded before Flop (didn't bet)
Seat 2: BLEU2x2bnGRovIelAY6slA folded before Flop (didn't bet)
Seat 4: 9lvO/qyU+xrU95Teu1fv0g folded before Flop (didn't bet)
Seat 5: sSN8Y0AlsBeidZXPKmwXSw (button) folded before Flop (didn't bet)
Seat 6: 5yjzPss7Y4kAWNDat3e0yQ (small blind) folded before Flop
Seat 8: 9YN2IkT2JYYKFErZtZvCtA (big blind) collected ($0.20)
Seat 9: N/O9ADKpmqB2ASZuqgodlw folded before Flop (didn't bet)




PokerStars Game #59941788534:  Hold'em No Limit ($0.10/$0.25) - 2009/07/01 1:46:11 ET
Table 'rtxA1Y01Nrq5VoyzTAuusQ' 9-max Seat #5 is the button
Seat 1: w1ukf8uPa4+WH561TtVRxA ($26.55 in chips) 
Seat 2: Th3FldXKQW6hWVVPahaoOQ ($25 in chips) 
Seat 3: K9fS1IUr5GpiJG7VkJ7IbA ($5 in chips) 
Seat 4: RHqgdFvufLCYe54+qd2gcA ($4.65 in chips) 
Seat 5: MtVtHDqIJTyUcXkRBBDIVA ($32.90 in chips) 
Seat 8: DnDcAdn9P0zGovMERigpFA ($25.10 in chips) 
Seat 9: HPEB+AtKw1+C/cxU0o1ciw ($22.70 in chips) 
DnDcAdn9P0zGovMERigpFA: posts small blind $0.10
HPEB+AtKw1+C/cxU0o1ciw: posts big blind $0.25
*** HOLE CARDS ***
w1ukf8uPa4+WH561TtVRxA: raises $0.50 to $0.75
Th3FldXKQW6hWVVPahaoOQ: folds 
K9fS1IUr5GpiJG7VkJ7IbA: folds 
RHqgdFvufLCYe54+qd2gcA: folds 
MtVtHDqIJTyUcXkRBBDIVA: folds 
DnDcAdn9P0zGovMERigpFA: folds 
HPEB+AtKw1+C/cxU0o1ciw: folds 
Uncalled bet ($0.50) returned to w1ukf8uPa4+WH561TtVRxA
w1ukf8uPa4+WH561TtVRxA collected $0.60 from pot
w1ukf8uPa4+WH561TtVRxA: doesn't show hand 
W6tExOcYX7qiy6Qdp+ZwFA joins the table at seat #7 
*** SUMMARY ***
Total pot $0.60 | Rake $0 
Seat 1: w1ukf8uPa4+WH561TtVRxA collected ($0.60)
Seat 2: Th3FldXKQW6hWVVPahaoOQ folded before Flop (didn't bet)
Seat 3: K9fS1IUr5GpiJG7VkJ7IbA folded before Flop (didn't bet)
Seat 4: RHqgdFvufLCYe54+qd2gcA folded before Flop (didn't bet)
Seat 5: MtVtHDqIJTyUcXkRBBDIVA (button) folded before Flop (didn't bet)
Seat 8: DnDcAdn9P0zGovMERigpFA (small blind) folded before Flop
Seat 9: HPEB+AtKw1+C/cxU0o1ciw (big blind) folded before Flop




PokerStars Game #59941788682:  Hold'em No Limit ($0.10/$0.25) - 2009/07/01 1:46:11 ET
Table '63h13e5p7cWe02rClZ1CHw' 6-max Seat #5 is the button
Seat 1: pokjbbEcXXPlADXdSGHtZw ($22.70 in chips) 
Seat 2: k9nHZTHt8hYhYRcW8NTb4g ($26.15 in chips) 
Seat 3: mFv3iBCtrw9XfCDRB0d46Q ($4.65 in chips) 
Seat 4: xrf8tAXKQHG99HixCot1Iw ($25 in chips) 
Seat 5: iyZxqznXjv3vtvOJymkoLQ ($44.45 in chips) 
Seat 6: mfrkWA3PTeYPkbO6hi98Aw ($39.15 in chips) 
mfrkWA3PTeYPkbO6hi98Aw: posts small blind $0.10
pokjbbEcXXPlADXdSGHtZw: posts big blind $0.25
*** HOLE CARDS ***
k9nHZTHt8hYhYRcW8NTb4g: raises $0.50 to $0.75
mFv3iBCtrw9XfCDRB0d46Q: folds 
xrf8tAXKQHG99HixCot1Iw: calls $0.75
iyZxqznXjv3vtvOJymkoLQ: folds 
mfrkWA3PTeYPkbO6hi98Aw: folds 
pokjbbEcXXPlADXdSGHtZw: folds 
*** FLOP *** [9d Qd 6s]
k9nHZTHt8hYhYRcW8NTb4g: checks 
xrf8tAXKQHG99HixCot1Iw: bets $1
k9nHZTHt8hYhYRcW8NTb4g: calls $1
*** TURN *** [9d Qd 6s] [Jd]
k9nHZTHt8hYhYRcW8NTb4g: checks 
xrf8tAXKQHG99HixCot1Iw: bets $2.75
k9nHZTHt8hYhYRcW8NTb4g: folds 
Uncalled bet ($2.75) returned to xrf8tAXKQHG99HixCot1Iw
xrf8tAXKQHG99HixCot1Iw collected $3.70 from pot
xrf8tAXKQHG99HixCot1Iw: doesn't show hand 
*** SUMMARY ***
Total pot $3.85 | Rake $0.15 
Board [9d Qd 6s Jd]
Seat 1: pokjbbEcXXPlADXdSGHtZw (big blind) folded before Flop
Seat 2: k9nHZTHt8hYhYRcW8NTb4g folded on the Turn
Seat 3: mFv3iBCtrw9XfCDRB0d46Q folded before Flop (didn't bet)
Seat 4: xrf8tAXKQHG99HixCot1Iw collected ($3.70)
Seat 5: iyZxqznXjv3vtvOJymkoLQ (button) folded before Flop (didn't bet)
Seat 6: mfrkWA3PTeYPkbO6hi98Aw (small blind) folded before Flop




PokerStars Game #59941788736:  Hold'em No Limit ($0.10/$0.25) - 2009/07/01 1:46:11 ET
Table 'oZuNsbNJuUyQLGKzQ/4JFg' 6-max Seat #1 is the button
Seat 1: vqWjZmdQu/Hxw96/IJTWdQ ($25.35 in chips) 
Seat 2: UA5OsKS3VPaxa7uC8La/kA ($34.25 in chips) 
Seat 3: 8ClCHtFXGNplITm+63KB+Q ($51 in chips) 
Seat 4: 9bpVv1/Qh9IYtXuCtl5VtQ ($25.80 in chips) 
Seat 5: oBUDUfeUyCbZBsjxHZgSiw ($26.25 in chips) 
Seat 6: fwg6dK1+r4jy/y+JqenYYQ ($13.80 in chips) 
UA5OsKS3VPaxa7uC8La/kA: posts small blind $0.10
8ClCHtFXGNplITm+63KB+Q: posts big blind $0.25
*** HOLE CARDS ***
9bpVv1/Qh9IYtXuCtl5VtQ: folds 
oBUDUfeUyCbZBsjxHZgSiw: raises $0.75 to $1
fwg6dK1+r4jy/y+JqenYYQ: folds 
vqWjZmdQu/Hxw96/IJTWdQ: folds 
UA5OsKS3VPaxa7uC8La/kA is connected 
UA5OsKS3VPaxa7uC8La/kA: folds 
8ClCHtFXGNplITm+63KB+Q: folds 
Uncalled bet ($0.75) returned to oBUDUfeUyCbZBsjxHZgSiw
oBUDUfeUyCbZBsjxHZgSiw collected $0.60 from pot
*** SUMMARY ***
Total pot $0.60 | Rake $0 
Seat 1: vqWjZmdQu/Hxw96/IJTWdQ (button) folded before Flop (didn't bet)
Seat 2: UA5OsKS3VPaxa7uC8La/kA (small blind) folded before Flop
Seat 3: 8ClCHtFXGNplITm+63KB+Q (big blind) folded before Flop
Seat 4: 9bpVv1/Qh9IYtXuCtl5VtQ folded before Flop (didn't bet)
Seat 5: oBUDUfeUyCbZBsjxHZgSiw collected ($0.60)
Seat 6: fwg6dK1+r4jy/y+JqenYYQ folded before Flop (didn't bet)




PokerStars Game #59941789514:  Hold'em No Limit ($0.10/$0.25) - 2009/07/01 1:46:12 ET
Table '29D3eoQzK5kOAT0OIDS2uQ' 6-max Seat #3 is the button
Seat 1: kG34n23qFQA3nzdOJTQ1dA ($46.40 in chips) 
Seat 2: FyE+TQ5JcCqI/tCCHf0jGA ($17.45 in chips) 
Seat 3: z3tQwy28dp5FykDJC/wzQw ($17.45 in chips) 
Seat 4: MqMK8OWPSY1V4stf1Hy5Jw ($35.65 in chips) 
Seat 5: Q3EMN7b0ie81AFWkDrhCjw ($22.50 in chips) 
Seat 6: bWbV4MVB/vVpiES1Ut4hew ($30.65 in chips) 
MqMK8OWPSY1V4stf1Hy5Jw: posts small blind $0.10
Q3EMN7b0ie81AFWkDrhCjw: posts big blind $0.25
*** HOLE CARDS ***
bWbV4MVB/vVpiES1Ut4hew: folds 
kG34n23qFQA3nzdOJTQ1dA: folds 
FyE+TQ5JcCqI/tCCHf0jGA: folds 
z3tQwy28dp5FykDJC/wzQw: folds 
MqMK8OWPSY1V4stf1Hy5Jw: folds 
Uncalled bet ($0.15) returned to Q3EMN7b0ie81AFWkDrhCjw
Q3EMN7b0ie81AFWkDrhCjw collected $0.20 from pot
*** SUMMARY ***
Total pot $0.20 | Rake $0 
Seat 1: kG34n23qFQA3nzdOJTQ1dA folded before Flop (didn't bet)
Seat 2: FyE+TQ5JcCqI/tCCHf0jGA folded before Flop (didn't bet)
Seat 3: z3tQwy28dp5FykDJC/wzQw (button) folded before Flop (didn't bet)
Seat 4: MqMK8OWPSY1V4stf1Hy5Jw (small blind) folded before Flop
Seat 5: Q3EMN7b0ie81AFWkDrhCjw (big blind) collected ($0.20)
Seat 6: bWbV4MVB/vVpiES1Ut4hew folded before Flop (didn't bet)




PokerStars Game #59941789096:  Hold'em No Limit ($0.10/$0.25) - 2009/07/01 1:46:12 ET
Table 'SHi8+hK6i7E2dJ/3Agbyig' 6-max Seat #3 is the button
Seat 1: gPEN9Zp33YTm/mu9/SYP1w ($26.75 in chips) 
Seat 2: LJI7A1YgDM7hgh7o56+ReQ ($28.45 in chips) 
Seat 3: P1Z7LWu+VU+WmJsI4mr0wA ($23 in chips) 
Seat 4: u0ikXOhAPSCLmg+l17oGRw ($9.75 in chips) 
Seat 5: v8m8XHovI5tqEA9mvplDSw ($52.70 in chips) 
Seat 6: cWc85bEzdRzpUMhRKm8pwQ ($32.30 in chips) 
u0ikXOhAPSCLmg+l17oGRw: posts small blind $0.10
gPEN9Zp33YTm/mu9/SYP1w said, "if i was there"
v8m8XHovI5tqEA9mvplDSw: posts big blind $0.25
*** HOLE CARDS ***
cWc85bEzdRzpUMhRKm8pwQ: folds 
gPEN9Zp33YTm/mu9/SYP1w: calls $0.25
LJI7A1YgDM7hgh7o56+ReQ: folds 
P1Z7LWu+VU+WmJsI4mr0wA: calls $0.25
u0ikXOhAPSCLmg+l17oGRw: raises $0.25 to $0.50
v8m8XHovI5tqEA9mvplDSw: folds 
gPEN9Zp33YTm/mu9/SYP1w: calls $0.25
P1Z7LWu+VU+WmJsI4mr0wA: calls $0.25
*** FLOP *** [8c Qh 4d]
u0ikXOhAPSCLmg+l17oGRw: bets $1
gPEN9Zp33YTm/mu9/SYP1w: folds 
P1Z7LWu+VU+WmJsI4mr0wA: folds 
Uncalled bet ($1) returned to u0ikXOhAPSCLmg+l17oGRw
u0ikXOhAPSCLmg+l17oGRw collected $1.70 from pot
*** SUMMARY ***
Total pot $1.75 | Rake $0.05 
Board [8c Qh 4d]
Seat 1: gPEN9Zp33YTm/mu9/SYP1w folded on the Flop
Seat 2: LJI7A1YgDM7hgh7o56+ReQ folded before Flop (didn't bet)
Seat 3: P1Z7LWu+VU+WmJsI4mr0wA (button) folded on the Flop
Seat 4: u0ikXOhAPSCLmg+l17oGRw (small blind) collected ($1.70)
Seat 5: v8m8XHovI5tqEA9mvplDSw (big blind) folded before Flop
Seat 6: cWc85bEzdRzpUMhRKm8pwQ folded before Flop (didn't bet)




PokerStars Game #59941789394:  Hold'em No Limit ($0.10/$0.25) - 2009/07/01 1:46:12 ET
Table 'TJS4XvvOjO3k7mH74HJw5g' 9-max Seat #8 is the button
Seat 1: K8I2mpRME07ZlOsT2x75Lg ($8.80 in chips) 
Seat 5: UlMB386Cfzy3EwurQoBjcA ($8.20 in chips) 
Seat 6: SRik8xyC/rVIBoX7VaOoMA ($13.90 in chips) 
Seat 7: B9u+i1s5aZZkmLTLUopTBg ($14.65 in chips) 
Seat 8: Qv4VzEkN09uD11sjKv02Ig ($18.70 in chips) 
Seat 9: +sbyWwIcFp9kP0bDtMegfQ ($42.40 in chips) 
+sbyWwIcFp9kP0bDtMegfQ: posts small blind $0.10
K8I2mpRME07ZlOsT2x75Lg: posts big blind $0.25
yqkowiRWZ6NvRN9UUkYIlA: sits out 
8EbrQ/EvFWt2cr0GaU82gQ: sits out 
clJsV3v77RS07bDKY+705w: sits out 
*** HOLE CARDS ***
UlMB386Cfzy3EwurQoBjcA: raises $0.50 to $0.75
SRik8xyC/rVIBoX7VaOoMA: folds 
B9u+i1s5aZZkmLTLUopTBg: folds 
Qv4VzEkN09uD11sjKv02Ig: calls $0.75
+sbyWwIcFp9kP0bDtMegfQ: folds 
K8I2mpRME07ZlOsT2x75Lg: calls $0.50
*** FLOP *** [7h 7c 4s]
K8I2mpRME07ZlOsT2x75Lg: checks 
UlMB386Cfzy3EwurQoBjcA: bets $1.75
Qv4VzEkN09uD11sjKv02Ig: folds 
K8I2mpRME07ZlOsT2x75Lg: folds 
Uncalled bet ($1.75) returned to UlMB386Cfzy3EwurQoBjcA
UlMB386Cfzy3EwurQoBjcA collected $2.25 from pot
UlMB386Cfzy3EwurQoBjcA: doesn't show hand 
*** SUMMARY ***
Total pot $2.35 | Rake $0.10 
Board [7h 7c 4s]
Seat 1: K8I2mpRME07ZlOsT2x75Lg (big blind) folded on the Flop
Seat 5: UlMB386Cfzy3EwurQoBjcA collected ($2.25)
Seat 6: SRik8xyC/rVIBoX7VaOoMA folded before Flop (didn't bet)
Seat 7: B9u+i1s5aZZkmLTLUopTBg folded before Flop (didn't bet)
Seat 8: Qv4VzEkN09uD11sjKv02Ig (button) folded on the Flop
Seat 9: +sbyWwIcFp9kP0bDtMegfQ (small blind) folded before Flop




PokerStars Game #59941789398:  Hold'em No Limit ($0.10/$0.25) - 2009/07/01 1:46:12 ET
Table 'x7YStLKc8hpt/pTgSetPKA' 9-max Seat #9 is the button
Seat 1: tYsOBqdU1+x+yFI7zHO7hQ ($26 in chips) 
Seat 3: S7Ki0P+0AIGPuIfGJjW0gg ($12.10 in chips) 
Seat 4: ydoFOVgzvZv9ZhuWu9rXAw ($5.15 in chips) 
Seat 6: 9YN2IkT2JYYKFErZtZvCtA ($47.75 in chips) 
Seat 7: dtZ84flFEi4Q+SGrHMJRDQ ($26 in chips) 
Seat 8: j4q3p0lesp63b1gZDwLBZw ($5 in chips) 
Seat 9: nm4Dj/f+jJEwKVsUnKh73g ($36.70 in chips) 
tYsOBqdU1+x+yFI7zHO7hQ: posts small blind $0.10
S7Ki0P+0AIGPuIfGJjW0gg: posts big blind $0.25
tLcDklc2rBORNfixyRfVfw: sits out 
*** HOLE CARDS ***
ydoFOVgzvZv9ZhuWu9rXAw: folds 
9YN2IkT2JYYKFErZtZvCtA: raises $0.50 to $0.75
dtZ84flFEi4Q+SGrHMJRDQ: folds 
j4q3p0lesp63b1gZDwLBZw: folds 
nm4Dj/f+jJEwKVsUnKh73g: calls $0.75
tYsOBqdU1+x+yFI7zHO7hQ: folds 
S7Ki0P+0AIGPuIfGJjW0gg: calls $0.50
*** FLOP *** [4s Kh 7d]
S7Ki0P+0AIGPuIfGJjW0gg: checks 
9YN2IkT2JYYKFErZtZvCtA: bets $1
nm4Dj/f+jJEwKVsUnKh73g: folds 
S7Ki0P+0AIGPuIfGJjW0gg: folds 
Uncalled bet ($1) returned to 9YN2IkT2JYYKFErZtZvCtA
9YN2IkT2JYYKFErZtZvCtA collected $2.25 from pot
9YN2IkT2JYYKFErZtZvCtA: doesn't show hand 
*** SUMMARY ***
Total pot $2.35 | Rake $0.10 
Board [4s Kh 7d]
Seat 1: tYsOBqdU1+x+yFI7zHO7hQ (small blind) folded before Flop
Seat 3: S7Ki0P+0AIGPuIfGJjW0gg (big blind) folded on the Flop
Seat 4: ydoFOVgzvZv9ZhuWu9rXAw folded before Flop (didn't bet)
Seat 6: 9YN2IkT2JYYKFErZtZvCtA collected ($2.25)
Seat 7: dtZ84flFEi4Q+SGrHMJRDQ folded before Flop (didn't bet)
Seat 8: j4q3p0lesp63b1gZDwLBZw folded before Flop (didn't bet)
Seat 9: nm4Dj/f+jJEwKVsUnKh73g (button) folded on the Flop




PokerStars Game #59941789930:  Hold'em No Limit ($0.10/$0.25) - 2009/07/01 1:46:13 ET
Table '9L7XfAwuM7XsXE8LIg2o5Q' 6-max Seat #2 is the button
Seat 1: dOIoLBxmpLHSXBN9LZnf0Q ($23.85 in chips) 
Seat 2: LJI7A1YgDM7hgh7o56+ReQ ($28.55 in chips) 
Seat 3: mFv3iBCtrw9XfCDRB0d46Q ($4.40 in chips) 
Seat 4: jp34e617tIzV8tKIWmfAbA ($38.80 in chips) 
Seat 5: zsU1ijOyYEi+40wBKPEbmw ($8.40 in chips) 
Seat 6: k9nHZTHt8hYhYRcW8NTb4g ($37.90 in chips) 
mFv3iBCtrw9XfCDRB0d46Q: posts small blind $0.10
jp34e617tIzV8tKIWmfAbA: posts big blind $0.25
*** HOLE CARDS ***
zsU1ijOyYEi+40wBKPEbmw: raises $0.50 to $0.75
k9nHZTHt8hYhYRcW8NTb4g: calls $0.75
dOIoLBxmpLHSXBN9LZnf0Q: folds 
LJI7A1YgDM7hgh7o56+ReQ: folds 
mFv3iBCtrw9XfCDRB0d46Q: folds 
jp34e617tIzV8tKIWmfAbA: folds 
*** FLOP *** [Th 4s Td]
zsU1ijOyYEi+40wBKPEbmw: bets $1.50
k9nHZTHt8hYhYRcW8NTb4g: calls $1.50
*** TURN *** [Th 4s Td] [5h]
zsU1ijOyYEi+40wBKPEbmw: bets $6.15 and is all-in
k9nHZTHt8hYhYRcW8NTb4g: folds 
Uncalled bet ($6.15) returned to zsU1ijOyYEi+40wBKPEbmw
zsU1ijOyYEi+40wBKPEbmw collected $4.65 from pot
zsU1ijOyYEi+40wBKPEbmw: doesn't show hand 
*** SUMMARY ***
Total pot $4.85 | Rake $0.20 
Board [Th 4s Td 5h]
Seat 1: dOIoLBxmpLHSXBN9LZnf0Q folded before Flop (didn't bet)
Seat 2: LJI7A1YgDM7hgh7o56+ReQ (button) folded before Flop (didn't bet)
Seat 3: mFv3iBCtrw9XfCDRB0d46Q (small blind) folded before Flop
Seat 4: jp34e617tIzV8tKIWmfAbA (big blind) folded before Flop
Seat 5: zsU1ijOyYEi+40wBKPEbmw collected ($4.65)
Seat 6: k9nHZTHt8hYhYRcW8NTb4g folded on the Turn




PokerStars Game #59941790048:  Hold'em No Limit ($0.10/$0.25) - 2009/07/01 1:46:13 ET
Table 'O5NgMYt6EWbLBozZb3kseg' 6-max Seat #4 is the button
Seat 3: nEezgRkm8mxa3J5ySz1mJQ ($8 in chips) 
Seat 4: ItRgvLhXTZHvtZowz+dbIw ($15 in chips) 
ItRgvLhXTZHvtZowz+dbIw: posts small blind $0.10
/gJNBeCkWL4o85/jvlZ4BA: is sitting out 
AxhCSFlGEh+FAc+VUD31JQ joins the table at seat #1 
nEezgRkm8mxa3J5ySz1mJQ: posts big blind $0.25
*** HOLE CARDS ***
/gJNBeCkWL4o85/jvlZ4BA leaves the table
ItRgvLhXTZHvtZowz+dbIw: calls $0.15
3m6VfX7io8SA31qh1zCkgQ joins the table at seat #6 
nEezgRkm8mxa3J5ySz1mJQ: raises $0.50 to $0.75
ItRgvLhXTZHvtZowz+dbIw: calls $0.50
*** FLOP *** [7d Jc 6d]
ZZm/rg8aThjE+A2LiItuzA joins the table at seat #2 
nEezgRkm8mxa3J5ySz1mJQ: checks 
ItRgvLhXTZHvtZowz+dbIw: checks 
*** TURN *** [7d Jc 6d] [3h]
nEezgRkm8mxa3J5ySz1mJQ: checks 
ItRgvLhXTZHvtZowz+dbIw: checks 
*** RIVER *** [7d Jc 6d 3h] [Td]
nEezgRkm8mxa3J5ySz1mJQ: bets $1
u3Ol7kv1LmvszuHNm9rc6w joins the table at seat #5 
ItRgvLhXTZHvtZowz+dbIw: calls $1
*** SHOW DOWN ***
nEezgRkm8mxa3J5ySz1mJQ: shows [Kd Kc] (a pair of Kings)
ItRgvLhXTZHvtZowz+dbIw: mucks hand 
nEezgRkm8mxa3J5ySz1mJQ collected $3.35 from pot
*** SUMMARY ***
Total pot $3.50 | Rake $0.15 
Board [7d Jc 6d 3h Td]
Seat 3: nEezgRkm8mxa3J5ySz1mJQ (big blind) showed [Kd Kc] and won ($3.35) with a pair of Kings
Seat 4: ItRgvLhXTZHvtZowz+dbIw (button) (small blind) mucked




PokerStars Game #59941789818:  Hold'em No Limit ($0.10/$0.25) - 2009/07/01 1:46:13 ET
Table '9lYs7ljXi6AgFAxYHlKLJw' 9-max Seat #6 is the button
Seat 1: K0b5wNInj6hUGRr6yzKFtw ($37.15 in chips) 
Seat 2: 0XACOSNrAWmqNv9k1nF8rw ($16.70 in chips) 
Seat 3: arxNSjreDRGFg13EAM2F1w ($32.65 in chips) 
Seat 4: UANt6y/SmDCY/jIxkBixcw ($33 in chips) 
Seat 5: dfNim92Z6XK1/h5SFW5vDg ($51.60 in chips) 
Seat 6: tYsOBqdU1+x+yFI7zHO7hQ ($25 in chips) 
Seat 7: ghNKXUBl/H+t83JF079ZBA ($27.80 in chips) 
Seat 8: 9YN2IkT2JYYKFErZtZvCtA ($19.45 in chips) 
Seat 9: cKlmpQMahVsmOaxFQDcoOg ($19 in chips) 
ghNKXUBl/H+t83JF079ZBA: posts small blind $0.10
9YN2IkT2JYYKFErZtZvCtA: posts big blind $0.25
*** HOLE CARDS ***
cKlmpQMahVsmOaxFQDcoOg: folds 
K0b5wNInj6hUGRr6yzKFtw: folds 
0XACOSNrAWmqNv9k1nF8rw: folds 
arxNSjreDRGFg13EAM2F1w: raises $0.50 to $0.75
UANt6y/SmDCY/jIxkBixcw: folds 
dfNim92Z6XK1/h5SFW5vDg: folds 
tYsOBqdU1+x+yFI7zHO7hQ: folds 
ghNKXUBl/H+t83JF079ZBA: folds 
9YN2IkT2JYYKFErZtZvCtA: calls $0.50
*** FLOP *** [6s Th 8h]
9YN2IkT2JYYKFErZtZvCtA: checks 
arxNSjreDRGFg13EAM2F1w: bets $1
9YN2IkT2JYYKFErZtZvCtA: folds 
Uncalled bet ($1) returned to arxNSjreDRGFg13EAM2F1w
arxNSjreDRGFg13EAM2F1w collected $1.55 from pot
arxNSjreDRGFg13EAM2F1w: doesn't show hand 
*** SUMMARY ***
Total pot $1.60 | Rake $0.05 
Board [6s Th 8h]
Seat 1: K0b5wNInj6hUGRr6yzKFtw folded before Flop (didn't bet)
Seat 2: 0XACOSNrAWmqNv9k1nF8rw folded before Flop (didn't bet)
Seat 3: arxNSjreDRGFg13EAM2F1w collected ($1.55)
Seat 4: UANt6y/SmDCY/jIxkBixcw folded before Flop (didn't bet)
Seat 5: dfNim92Z6XK1/h5SFW5vDg folded before Flop (didn't bet)
Seat 6: tYsOBqdU1+x+yFI7zHO7hQ (button) folded before Flop (didn't bet)
Seat 7: ghNKXUBl/H+t83JF079ZBA (small blind) folded before Flop
Seat 8: 9YN2IkT2JYYKFErZtZvCtA (big blind) folded on the Flop
Seat 9: cKlmpQMahVsmOaxFQDcoOg folded before Flop (didn't bet)




PokerStars Game #59941789712:  Hold'em No Limit ($0.10/$0.25) - 2009/07/01 1:46:13 ET
Table 'sJ4KpS2GE5Qrsu1/cFjJUw' 9-max Seat #7 is the button
Seat 1: eDlQ+S+6L4e6gM1dkZhGgQ ($18.45 in chips) 
Seat 2: tYsOBqdU1+x+yFI7zHO7hQ ($31.75 in chips) 
Seat 3: eK8qa6EPcH2zhtbmWSvc9g ($25 in chips) 
Seat 4: npAYqa85pqnzfOK5ukX+BQ ($24 in chips) 
Seat 5: Q/gZC63lfOMr7YhWKPCxoQ ($8.85 in chips) 
Seat 6: OefE+Csvj5KR7ClGf3Hc2g ($4.35 in chips) 
Seat 7: Wi8djHgewBlVhpKWfp7isQ ($8 in chips) 
Seat 8: S7Ki0P+0AIGPuIfGJjW0gg ($30.70 in chips) 
Seat 9: 3PmVnC/15cl4oyI1TKIt4g ($4.75 in chips) 
S7Ki0P+0AIGPuIfGJjW0gg: posts small blind $0.10
3PmVnC/15cl4oyI1TKIt4g: posts big blind $0.25
*** HOLE CARDS ***
eDlQ+S+6L4e6gM1dkZhGgQ: folds 
tYsOBqdU1+x+yFI7zHO7hQ: folds 
eK8qa6EPcH2zhtbmWSvc9g: folds 
npAYqa85pqnzfOK5ukX+BQ: folds 
Q/gZC63lfOMr7YhWKPCxoQ: calls $0.25
OefE+Csvj5KR7ClGf3Hc2g: folds 
Wi8djHgewBlVhpKWfp7isQ: raises $0.50 to $0.75
S7Ki0P+0AIGPuIfGJjW0gg: folds 
3PmVnC/15cl4oyI1TKIt4g: folds 
Q/gZC63lfOMr7YhWKPCxoQ: folds 
Uncalled bet ($0.50) returned to Wi8djHgewBlVhpKWfp7isQ
Wi8djHgewBlVhpKWfp7isQ collected $0.85 from pot
Wi8djHgewBlVhpKWfp7isQ: doesn't show hand 
*** SUMMARY ***
Total pot $0.85 | Rake $0 
Seat 1: eDlQ+S+6L4e6gM1dkZhGgQ folded before Flop (didn't bet)
Seat 2: tYsOBqdU1+x+yFI7zHO7hQ folded before Flop (didn't bet)
Seat 3: eK8qa6EPcH2zhtbmWSvc9g folded before Flop (didn't bet)
Seat 4: npAYqa85pqnzfOK5ukX+BQ folded before Flop (didn't bet)
Seat 5: Q/gZC63lfOMr7YhWKPCxoQ folded before Flop
Seat 6: OefE+Csvj5KR7ClGf3Hc2g folded before Flop (didn't bet)
Seat 7: Wi8djHgewBlVhpKWfp7isQ (button) collected ($0.85)
Seat 8: S7Ki0P+0AIGPuIfGJjW0gg (small blind) folded before Flop
Seat 9: 3PmVnC/15cl4oyI1TKIt4g (big blind) folded before Flop




PokerStars Game #59941789838:  Hold'em No Limit ($0.10/$0.25) - 2009/07/01 1:46:13 ET
Table 'gnrUwXkIPE0C8xl6cB4Hyw' 9-max Seat #3 is the button
Seat 1: EQXHDnIzAsORnIXRNtXRlA ($22.60 in chips) 
Seat 2: 7je+LC5Mfs6nL8YBVh4frQ ($5 in chips) 
Seat 3: PdIasPkzm2sqZnN41ZRXOg ($5 in chips) 
Seat 4: wGigCmBR/9XWkPpvYos3aQ ($25.10 in chips) 
Seat 5: gehe91e0IyVT0QU/XBkEyg ($26.90 in chips) 
Seat 6: dtZ84flFEi4Q+SGrHMJRDQ ($25.80 in chips) 
Seat 7: OXPkK84/qv92EMwXPiG5rQ ($9.95 in chips) 
Seat 8: 4awUyiDYTgylQKXZ9faBVA ($60.65 in chips) 
Seat 9: F7pnn6czNpHvRM55XcA2EA ($25.50 in chips) 
wGigCmBR/9XWkPpvYos3aQ: posts small blind $0.10
gehe91e0IyVT0QU/XBkEyg: posts big blind $0.25
*** HOLE CARDS ***
dtZ84flFEi4Q+SGrHMJRDQ: folds 
OXPkK84/qv92EMwXPiG5rQ: folds 
4awUyiDYTgylQKXZ9faBVA: folds 
F7pnn6czNpHvRM55XcA2EA: folds 
EQXHDnIzAsORnIXRNtXRlA: folds 
7je+LC5Mfs6nL8YBVh4frQ: folds 
PdIasPkzm2sqZnN41ZRXOg: folds 
wGigCmBR/9XWkPpvYos3aQ: folds 
Uncalled bet ($0.15) returned to gehe91e0IyVT0QU/XBkEyg
gehe91e0IyVT0QU/XBkEyg collected $0.20 from pot
*** SUMMARY ***
Total pot $0.20 | Rake $0 
Seat 1: EQXHDnIzAsORnIXRNtXRlA folded before Flop (didn't bet)
Seat 2: 7je+LC5Mfs6nL8YBVh4frQ folded before Flop (didn't bet)
Seat 3: PdIasPkzm2sqZnN41ZRXOg (button) folded before Flop (didn't bet)
Seat 4: wGigCmBR/9XWkPpvYos3aQ (small blind) folded before Flop
Seat 5: gehe91e0IyVT0QU/XBkEyg (big blind) collected ($0.20)
Seat 6: dtZ84flFEi4Q+SGrHMJRDQ folded before Flop (didn't bet)
Seat 7: OXPkK84/qv92EMwXPiG5rQ folded before Flop (didn't bet)
Seat 8: 4awUyiDYTgylQKXZ9faBVA folded before Flop (didn't bet)
Seat 9: F7pnn6czNpHvRM55XcA2EA folded before Flop (didn't bet)




PokerStars Game #59941789830:  Hold'em No Limit ($0.10/$0.25) - 2009/07/01 1:46:13 ET
Table 'jItkp2PNTbH9Cf7gqsAF7g' 9-max Seat #5 is the button
Seat 1: wGigCmBR/9XWkPpvYos3aQ ($26.85 in chips) 
Seat 2: qwr38jl5txoR36M7G5qi4A ($7.95 in chips) 
Seat 3: 0YaJElQVLqWThIZnqq3w1g ($12.60 in chips) 
Seat 4: oJOvZw/Iayou0f0k6dkBhg ($4.85 in chips) 
Seat 5: NO6qGDOw12lhu3zh1xW3Bg ($21.65 in chips) 
Seat 6: cZ99hugmLBj9KhTlc8nCSw ($52.75 in chips) 
Seat 8: cq6LACCDFivk2+PeoiB2sw ($6.65 in chips) 
Seat 9: dtZ84flFEi4Q+SGrHMJRDQ ($25.15 in chips) 
cZ99hugmLBj9KhTlc8nCSw: posts small blind $0.10
cq6LACCDFivk2+PeoiB2sw: posts big blind $0.25
*** HOLE CARDS ***
dtZ84flFEi4Q+SGrHMJRDQ: folds 
wGigCmBR/9XWkPpvYos3aQ: folds 
qwr38jl5txoR36M7G5qi4A: folds 
0YaJElQVLqWThIZnqq3w1g: folds 
oJOvZw/Iayou0f0k6dkBhg: raises $0.25 to $0.50
NO6qGDOw12lhu3zh1xW3Bg: calls $0.50
cZ99hugmLBj9KhTlc8nCSw: raises $1.75 to $2.25
cq6LACCDFivk2+PeoiB2sw: folds 
oJOvZw/Iayou0f0k6dkBhg: folds 
NO6qGDOw12lhu3zh1xW3Bg: folds 
Uncalled bet ($1.75) returned to cZ99hugmLBj9KhTlc8nCSw
cZ99hugmLBj9KhTlc8nCSw collected $1.75 from pot
cZ99hugmLBj9KhTlc8nCSw: doesn't show hand 
*** SUMMARY ***
Total pot $1.75 | Rake $0 
Seat 1: wGigCmBR/9XWkPpvYos3aQ folded before Flop (didn't bet)
Seat 2: qwr38jl5txoR36M7G5qi4A folded before Flop (didn't bet)
Seat 3: 0YaJElQVLqWThIZnqq3w1g folded before Flop (didn't bet)
Seat 4: oJOvZw/Iayou0f0k6dkBhg folded before Flop
Seat 5: NO6qGDOw12lhu3zh1xW3Bg (button) folded before Flop
Seat 6: cZ99hugmLBj9KhTlc8nCSw (small blind) collected ($1.75)
Seat 8: cq6LACCDFivk2+PeoiB2sw (big blind) folded before Flop
Seat 9: dtZ84flFEi4Q+SGrHMJRDQ folded before Flop (didn't bet)




PokerStars Game #59941789768:  Hold'em No Limit ($0.10/$0.25) - 2009/07/01 1:46:13 ET
Table 'FE/j6VqBY4j9Uq+VHURQCQ' 6-max Seat #3 is the button
Seat 1: ypmjhffk/YHGc51wgVXUTw ($40.35 in chips) 
Seat 2: 3zD3qLXT1bEffAoWGnc7wg ($37.10 in chips) 
Seat 3: lBoEwOFgzcERLIRUkUoRTw ($27 in chips) 
Seat 4: 7JyPCA0J2grhXQYxe1h3+A ($7.75 in chips) 
Seat 6: rpJ2ie+vculq8yrHlngRHQ ($29.45 in chips) 
7JyPCA0J2grhXQYxe1h3+A: posts small blind $0.10
4x9jCqgSw4272dnaIqnanw: is sitting out 
rpJ2ie+vculq8yrHlngRHQ: posts big blind $0.25
*** HOLE CARDS ***
ypmjhffk/YHGc51wgVXUTw: raises $0.50 to $0.75
3zD3qLXT1bEffAoWGnc7wg: folds 
lBoEwOFgzcERLIRUkUoRTw: folds 
4x9jCqgSw4272dnaIqnanw leaves the table
7JyPCA0J2grhXQYxe1h3+A: calls $0.65
rpJ2ie+vculq8yrHlngRHQ: calls $0.50
*** FLOP *** [2h Qd Kd]
7JyPCA0J2grhXQYxe1h3+A: checks 
rpJ2ie+vculq8yrHlngRHQ: checks 
ypmjhffk/YHGc51wgVXUTw: checks 
*** TURN *** [2h Qd Kd] [2d]
7JyPCA0J2grhXQYxe1h3+A: checks 
rpJ2ie+vculq8yrHlngRHQ: checks 
bJFzs6QmEEnz4miMfSDtcg joins the table at seat #5 
ypmjhffk/YHGc51wgVXUTw: bets $1.75
7JyPCA0J2grhXQYxe1h3+A: folds 
rpJ2ie+vculq8yrHlngRHQ: folds 
Uncalled bet ($1.75) returned to ypmjhffk/YHGc51wgVXUTw
rpJ2ie+vculq8yrHlngRHQ leaves the table
ypmjhffk/YHGc51wgVXUTw collected $2.15 from pot
ypmjhffk/YHGc51wgVXUTw: doesn't show hand 
*** SUMMARY ***
Total pot $2.25 | Rake $0.10 
Board [2h Qd Kd 2d]
Seat 1: ypmjhffk/YHGc51wgVXUTw collected ($2.15)
Seat 2: 3zD3qLXT1bEffAoWGnc7wg folded before Flop (didn't bet)
Seat 3: lBoEwOFgzcERLIRUkUoRTw (button) folded before Flop (didn't bet)
Seat 4: 7JyPCA0J2grhXQYxe1h3+A (small blind) folded on the Turn
Seat 6: rpJ2ie+vculq8yrHlngRHQ (big blind) folded on the Turn




PokerStars Game #59941789572:  Hold'em No Limit ($0.10/$0.25) - 2009/07/01 1:46:13 ET
Table 'Dun24l/X8kjpUHWBhkVOFw' 6-max Seat #1 is the button
Seat 1: u3Ol7kv1LmvszuHNm9rc6w ($22.80 in chips) 
Seat 2: 6hUmfDYq+83kvxWoTBQmfw ($24.25 in chips) 
Seat 3: +E5iJKkKVfaTgTqzuXXv0g ($13.50 in chips) 
Seat 4: 7/ROHX4tuLekJ2diYIlMkw ($8.80 in chips) 
Seat 5: KYBwVA7jgmSrbIEbEGElVg ($22.80 in chips) 
6hUmfDYq+83kvxWoTBQmfw: posts small blind $0.10
+E5iJKkKVfaTgTqzuXXv0g: posts big blind $0.25
KYBwVA7jgmSrbIEbEGElVg: posts big blind $0.25
xrf8tAXKQHG99HixCot1Iw: sits out 
*** HOLE CARDS ***
7/ROHX4tuLekJ2diYIlMkw: folds 
KYBwVA7jgmSrbIEbEGElVg: checks 
u3Ol7kv1LmvszuHNm9rc6w: folds 
6hUmfDYq+83kvxWoTBQmfw: calls $0.15
+E5iJKkKVfaTgTqzuXXv0g: checks 
*** FLOP *** [Tc 9c 4s]
6hUmfDYq+83kvxWoTBQmfw: checks 
+E5iJKkKVfaTgTqzuXXv0g: checks 
KYBwVA7jgmSrbIEbEGElVg: bets $0.50
6hUmfDYq+83kvxWoTBQmfw: folds 
+E5iJKkKVfaTgTqzuXXv0g: folds 
Uncalled bet ($0.50) returned to KYBwVA7jgmSrbIEbEGElVg
KYBwVA7jgmSrbIEbEGElVg collected $0.75 from pot
*** SUMMARY ***
Total pot $0.75 | Rake $0 
Board [Tc 9c 4s]
Seat 1: u3Ol7kv1LmvszuHNm9rc6w (button) folded before Flop (didn't bet)
Seat 2: 6hUmfDYq+83kvxWoTBQmfw (small blind) folded on the Flop
Seat 3: +E5iJKkKVfaTgTqzuXXv0g (big blind) folded on the Flop
Seat 4: 7/ROHX4tuLekJ2diYIlMkw folded before Flop (didn't bet)
Seat 5: KYBwVA7jgmSrbIEbEGElVg collected ($0.75)




PokerStars Game #59941789746:  Hold'em No Limit ($0.10/$0.25) - 2009/07/01 1:46:13 ET
Table 'm+FQg/QP0VP1ZA3V62WtOg' 9-max Seat #5 is the button
Seat 3: +KblIivb6tainScpwm14RQ ($6.50 in chips) 
Seat 5: wf5j8xvJtko6ZXyCbzzlVQ ($8.65 in chips) 
Seat 6: CT7Xj/V/O5rBlhtt+RZeFQ ($38.70 in chips) 
Seat 7: TPAF9YkMsjQFq978RNWZEQ ($18.20 in chips) 
Seat 9: zUXhymECc2C9W9ZNw6qppA ($12.55 in chips) 
CT7Xj/V/O5rBlhtt+RZeFQ: posts small blind $0.10
TPAF9YkMsjQFq978RNWZEQ: posts big blind $0.25
E0iYnEVO2ho7dH3QcCjw7g: sits out 
qwr38jl5txoR36M7G5qi4A: sits out 
yqkowiRWZ6NvRN9UUkYIlA: sits out 
dubÃ©705: sits out 
*** HOLE CARDS ***
zUXhymECc2C9W9ZNw6qppA: calls $0.25
+KblIivb6tainScpwm14RQ: folds 
wf5j8xvJtko6ZXyCbzzlVQ: folds 
CT7Xj/V/O5rBlhtt+RZeFQ: folds 
TPAF9YkMsjQFq978RNWZEQ: checks 
*** FLOP *** [Kh Th 8h]
TPAF9YkMsjQFq978RNWZEQ: bets $0.75
zUXhymECc2C9W9ZNw6qppA: raises $2.50 to $3.25
TPAF9YkMsjQFq978RNWZEQ: calls $2.50
*** TURN *** [Kh Th 8h] [3h]
TPAF9YkMsjQFq978RNWZEQ: checks 
zUXhymECc2C9W9ZNw6qppA: checks 
*** RIVER *** [Kh Th 8h 3h] [2s]
TPAF9YkMsjQFq978RNWZEQ: checks 
zUXhymECc2C9W9ZNw6qppA: bets $2.50
TPAF9YkMsjQFq978RNWZEQ: raises $2.50 to $5
zUXhymECc2C9W9ZNw6qppA: calls $2.50
*** SHOW DOWN ***
TPAF9YkMsjQFq978RNWZEQ: shows [Qh 4s] (a flush, King high)
zUXhymECc2C9W9ZNw6qppA: mucks hand 
TPAF9YkMsjQFq978RNWZEQ collected $16.30 from pot
*** SUMMARY ***
Total pot $17.10 | Rake $0.80 
Board [Kh Th 8h 3h 2s]
Seat 3: +KblIivb6tainScpwm14RQ folded before Flop (didn't bet)
Seat 5: wf5j8xvJtko6ZXyCbzzlVQ (button) folded before Flop (didn't bet)
Seat 6: CT7Xj/V/O5rBlhtt+RZeFQ (small blind) folded before Flop
Seat 7: TPAF9YkMsjQFq978RNWZEQ (big blind) showed [Qh 4s] and won ($16.30) with a flush, King high
Seat 9: zUXhymECc2C9W9ZNw6qppA mucked




PokerStars Game #59941790444:  Hold'em No Limit ($0.10/$0.25) - 2009/07/01 1:46:14 ET
Table 'LG9H161ZAHDkOww+ih3Ptg' 6-max Seat #4 is the button
Seat 1: avl8CO/tc0F6eVSiB/KNRA ($24.75 in chips) 
Seat 2: kwsRmpZ1ZaLooISs+zfyKg ($25.70 in chips) 
Seat 3: 5Evvx7UYqXTBuvIc/9s/hA ($15.95 in chips) 
Seat 4: 0C28L4/59aRNtHoBhqTcLg ($60.05 in chips) 
Seat 6: v8m8XHovI5tqEA9mvplDSw ($26.65 in chips) 
Nessi BÃ¤r will be allowed to play after the button
v8m8XHovI5tqEA9mvplDSw: posts small blind $0.10
avl8CO/tc0F6eVSiB/KNRA: posts big blind $0.25
*** HOLE CARDS ***
kwsRmpZ1ZaLooISs+zfyKg: folds 
5Evvx7UYqXTBuvIc/9s/hA: raises $0.50 to $0.75
0C28L4/59aRNtHoBhqTcLg: folds 
v8m8XHovI5tqEA9mvplDSw: calls $0.65
avl8CO/tc0F6eVSiB/KNRA: folds 
*** FLOP *** [Td 6h 3s]
v8m8XHovI5tqEA9mvplDSw: bets $1.25
5Evvx7UYqXTBuvIc/9s/hA: folds 
Uncalled bet ($1.25) returned to v8m8XHovI5tqEA9mvplDSw
v8m8XHovI5tqEA9mvplDSw collected $1.70 from pot
v8m8XHovI5tqEA9mvplDSw: doesn't show hand 
*** SUMMARY ***
Total pot $1.75 | Rake $0.05 
Board [Td 6h 3s]
Seat 1: avl8CO/tc0F6eVSiB/KNRA (big blind) folded before Flop
Seat 2: kwsRmpZ1ZaLooISs+zfyKg folded before Flop (didn't bet)
Seat 3: 5Evvx7UYqXTBuvIc/9s/hA folded on the Flop
Seat 4: 0C28L4/59aRNtHoBhqTcLg (button) folded before Flop (didn't bet)
Seat 6: v8m8XHovI5tqEA9mvplDSw (small blind) collected ($1.70)




PokerStars Game #59941790490:  Hold'em No Limit ($0.10/$0.25) - 2009/07/01 1:46:14 ET
Table 'zW+7jPbOLCvlPu+dUGY5WQ' 6-max Seat #2 is the button
Seat 1: eL3+wCBjFGfQ5FMdIZihwA ($26.50 in chips) 
Seat 2: cEMJmfAUQZmMChZe6aacKw ($8.60 in chips) 
Seat 4: i48129QFpEQQ+UN4aNtmww ($20.05 in chips) 
Seat 5: Hsvkc0/G2VV78oVmWYXecw ($5 in chips) 
Seat 6: qGHGf/553gQnDoklMRe3tg ($25 in chips) 
i48129QFpEQQ+UN4aNtmww: posts small blind $0.10
Hsvkc0/G2VV78oVmWYXecw: posts big blind $0.25
*** HOLE CARDS ***
qGHGf/553gQnDoklMRe3tg: folds 
eL3+wCBjFGfQ5FMdIZihwA: folds 
cEMJmfAUQZmMChZe6aacKw: raises $0.50 to $0.75
i48129QFpEQQ+UN4aNtmww: calls $0.65
Hsvkc0/G2VV78oVmWYXecw: folds 
*** FLOP *** [6c 4d 7h]
i48129QFpEQQ+UN4aNtmww: checks 
cEMJmfAUQZmMChZe6aacKw: bets $0.75
i48129QFpEQQ+UN4aNtmww: calls $0.75
*** TURN *** [6c 4d 7h] [Ad]
i48129QFpEQQ+UN4aNtmww: checks 
cEMJmfAUQZmMChZe6aacKw: bets $2.25
i48129QFpEQQ+UN4aNtmww: folds 
Uncalled bet ($2.25) returned to cEMJmfAUQZmMChZe6aacKw
cEMJmfAUQZmMChZe6aacKw collected $3.10 from pot
cEMJmfAUQZmMChZe6aacKw: doesn't show hand 
*** SUMMARY ***
Total pot $3.25 | Rake $0.15 
Board [6c 4d 7h Ad]
Seat 1: eL3+wCBjFGfQ5FMdIZihwA folded before Flop (didn't bet)
Seat 2: cEMJmfAUQZmMChZe6aacKw (button) collected ($3.10)
Seat 4: i48129QFpEQQ+UN4aNtmww (small blind) folded on the Turn
Seat 5: Hsvkc0/G2VV78oVmWYXecw (big blind) folded before Flop
Seat 6: qGHGf/553gQnDoklMRe3tg folded before Flop (didn't bet)




PokerStars Game #59941790210:  Hold'em No Limit ($0.10/$0.25) - 2009/07/01 1:46:14 ET
Table '2VkNDXXsBj4bSZw/uK5atw' 6-max Seat #5 is the button
Seat 1: xrf8tAXKQHG99HixCot1Iw ($25 in chips) 
Seat 2: v6mkGzCBCCXcgWQNSYVtKg ($12.45 in chips) 
Seat 4: 4kIRqWKE/N0yUAcWVhLSoQ ($15 in chips) 
Seat 5: 7f0OkhFEOf3T+rVOFHRLnw ($20.05 in chips) 
Seat 6: n6UPMnVR4v8LFP0rWP73Fg ($12.25 in chips) 
n6UPMnVR4v8LFP0rWP73Fg: posts small blind $0.10
xrf8tAXKQHG99HixCot1Iw: posts big blind $0.25
P+6Z5+8H5/Wyt/jHMovNvQ: sits out 
4kIRqWKE/N0yUAcWVhLSoQ: posts big blind $0.25
*** HOLE CARDS ***
v6mkGzCBCCXcgWQNSYVtKg: calls $0.25
4kIRqWKE/N0yUAcWVhLSoQ: checks 
7f0OkhFEOf3T+rVOFHRLnw: folds 
n6UPMnVR4v8LFP0rWP73Fg: calls $0.15
xrf8tAXKQHG99HixCot1Iw: checks 
*** FLOP *** [4h Kh 8d]
n6UPMnVR4v8LFP0rWP73Fg: bets $1
xrf8tAXKQHG99HixCot1Iw: folds 
v6mkGzCBCCXcgWQNSYVtKg: folds 
4kIRqWKE/N0yUAcWVhLSoQ: folds 
Uncalled bet ($1) returned to n6UPMnVR4v8LFP0rWP73Fg
n6UPMnVR4v8LFP0rWP73Fg collected $0.95 from pot
n6UPMnVR4v8LFP0rWP73Fg: doesn't show hand 
*** SUMMARY ***
Total pot $1 | Rake $0.05 
Board [4h Kh 8d]
Seat 1: xrf8tAXKQHG99HixCot1Iw (big blind) folded on the Flop
Seat 2: v6mkGzCBCCXcgWQNSYVtKg folded on the Flop
Seat 4: 4kIRqWKE/N0yUAcWVhLSoQ folded on the Flop
Seat 5: 7f0OkhFEOf3T+rVOFHRLnw (button) folded before Flop (didn't bet)
Seat 6: n6UPMnVR4v8LFP0rWP73Fg (small blind) collected ($0.95)




PokerStars Game #59941790194:  Hold'em No Limit ($0.10/$0.25) - 2009/07/01 1:46:14 ET
Table 'wPWRBZPJl1HAnysw7qRR0A' 6-max Seat #1 is the button
Seat 1: m7ne1MOFTQXlsXT7/R/rug ($6.65 in chips) 
Seat 2: xC0kaiDYM6YTlgODL83O5A ($14.75 in chips) 
Seat 3: 1ZpoLWO2nm2w1Nd1v9Sr3g ($7.55 in chips) 
Seat 4: epAUIB7h2FJXzUPRIvSkRA ($39.15 in chips) 
Seat 5: y0B+UpYpOUJz3JWtlJQBSA ($16 in chips) 
Seat 6: rx64Jzd1UJFfwJwXmv3z8w ($15.15 in chips) 
xC0kaiDYM6YTlgODL83O5A: posts small blind $0.10
1ZpoLWO2nm2w1Nd1v9Sr3g: posts big blind $0.25
*** HOLE CARDS ***
epAUIB7h2FJXzUPRIvSkRA: folds 
y0B+UpYpOUJz3JWtlJQBSA: calls $0.25
rx64Jzd1UJFfwJwXmv3z8w: folds 
m7ne1MOFTQXlsXT7/R/rug: calls $0.25
xC0kaiDYM6YTlgODL83O5A: folds 
1ZpoLWO2nm2w1Nd1v9Sr3g: checks 
*** FLOP *** [9s 6s 9h]
1ZpoLWO2nm2w1Nd1v9Sr3g: checks 
y0B+UpYpOUJz3JWtlJQBSA: checks 
m7ne1MOFTQXlsXT7/R/rug: checks 
*** TURN *** [9s 6s 9h] [2s]
1ZpoLWO2nm2w1Nd1v9Sr3g: bets $1.25
y0B+UpYpOUJz3JWtlJQBSA: folds 
m7ne1MOFTQXlsXT7/R/rug: folds 
Uncalled bet ($1.25) returned to 1ZpoLWO2nm2w1Nd1v9Sr3g
1ZpoLWO2nm2w1Nd1v9Sr3g collected $0.85 from pot
1ZpoLWO2nm2w1Nd1v9Sr3g: doesn't show hand 
*** SUMMARY ***
Total pot $0.85 | Rake $0 
Board [9s 6s 9h 2s]
Seat 1: m7ne1MOFTQXlsXT7/R/rug (button) folded on the Turn
Seat 2: xC0kaiDYM6YTlgODL83O5A (small blind) folded before Flop
Seat 3: 1ZpoLWO2nm2w1Nd1v9Sr3g (big blind) collected ($0.85)
Seat 4: epAUIB7h2FJXzUPRIvSkRA folded before Flop (didn't bet)
Seat 5: y0B+UpYpOUJz3JWtlJQBSA folded on the Turn
Seat 6: rx64Jzd1UJFfwJwXmv3z8w folded before Flop (didn't bet)




PokerStars Game #59941791000:  Hold'em No Limit ($0.10/$0.25) - 2009/07/01 1:46:15 ET
Table 'gZetDqJh6q9A3mLO3ThCsAnc6OeGk/wtaWV+6N+kgnZQSeat #6 is the button
Seat 1: DihMHaz4WNETH1bPDe13kA ($26.80 in chips) 
Seat 2: JFIAqU8lCZ0vWwEl4bdGsg ($32.90 in chips) 
Seat 3: jp34e617tIzV8tKIWmfAbA ($33.80 in chips) 
Seat 4: BV+K0Phf5VBHr7aZPKqbUQ ($29.35 in chips) 
Seat 5: EKTLAV1bAterT0Mc1G6lBg5hAPbqNrvJb8PtLiceXtlg4.75 in chips) 
Seat 6: Mhj3q7cxev+XjXZxEE6/Cw ($25 in chips) 
DihMHaz4WNETH1bPDe13kA: posts small blind $0.10
JFIAqU8lCZ0vWwEl4bdGsg: posts big blind $0.25
*** HOLE CARDS ***
jp34e617tIzV8tKIWmfAbA: folds 
BV+K0Phf5VBHr7aZPKqbUQ: folds 
EKTLAV1bAterT0Mc1G6lBg5hAPbqNrvJb8PtLiceXtlglds 
Mhj3q7cxev+XjXZxEE6/Cw: folds 
DihMHaz4WNETH1bPDe13kA: raises $0.50 to $0.75
JFIAqU8lCZ0vWwEl4bdGsg: raises $1.50 to $2.25
DihMHaz4WNETH1bPDe13kA: calls $1.50
*** FLOP *** [Ks 3h 6h]
DihMHaz4WNETH1bPDe13kA: checks 
JFIAqU8lCZ0vWwEl4bdGsg: bets $3
DihMHaz4WNETH1bPDe13kA: folds 
Uncalled bet ($3) returned to JFIAqU8lCZ0vWwEl4bdGsg
JFIAqU8lCZ0vWwEl4bdGsg collected $4.30 from pot
JFIAqU8lCZ0vWwEl4bdGsg: doesn't show hand 
*** SUMMARY ***
Total pot $4.50 | Rake $0.20 
Board [Ks 3h 6h]
Seat 1: DihMHaz4WNETH1bPDe13kA (small blind) folded on the Flop
Seat 2: JFIAqU8lCZ0vWwEl4bdGsg (big blind) collected ($4.30)
Seat 3: jp34e617tIzV8tKIWmfAbA folded before Flop (didn't bet)
Seat 4: BV+K0Phf5VBHr7aZPKqbUQ folded before Flop (didn't bet)
Seat 5: EKTLAV1bAterT0Mc1G6lBg5hAPbqNrvJb8PtLiceXtlgded before Flop (didn't bet)
Seat 6: Mhj3q7cxev+XjXZxEE6/Cw (button) folded before Flop (didn't bet)




PokerStars Game #59941790748:  Hold'em No Limit ($0.10/$0.25) - 2009/07/01 1:46:15 ET
Table '+198VWQSWBhYQOcizzuBkw' 6-max Seat #6 is the button
Seat 1: 34ttqW62uIRrqINCCmLcsw ($15 in chips) 
Seat 2: iauW7L/+7qzAuHow7CD75Q ($10.70 in chips) 
Seat 3: vw7gefupgmOJJN8lUemdWg ($23.05 in chips) 
Seat 4: TgDsTeCdLQt8kWbL00ByRA ($14.75 in chips) 
Seat 5: LtASJ9OlkqGrrUKGQlpGAw ($25.35 in chips) 
Seat 6: leEQ84f6wJYu5SB/vj27wg ($3.80 in chips) 
34ttqW62uIRrqINCCmLcsw: posts small blind $0.10
iauW7L/+7qzAuHow7CD75Q: posts big blind $0.25
*** HOLE CARDS ***
vw7gefupgmOJJN8lUemdWg: raises $0.50 to $0.75
TgDsTeCdLQt8kWbL00ByRA: folds 
LtASJ9OlkqGrrUKGQlpGAw: folds 
leEQ84f6wJYu5SB/vj27wg: folds 
34ttqW62uIRrqINCCmLcsw: calls $0.65
iauW7L/+7qzAuHow7CD75Q: folds 
*** FLOP *** [7s Kd 7c]
34ttqW62uIRrqINCCmLcsw: bets $0.50
vw7gefupgmOJJN8lUemdWg: folds 
Uncalled bet ($0.50) returned to 34ttqW62uIRrqINCCmLcsw
34ttqW62uIRrqINCCmLcsw collected $1.70 from pot
34ttqW62uIRrqINCCmLcsw: doesn't show hand 
*** SUMMARY ***
Total pot $1.75 | Rake $0.05 
Board [7s Kd 7c]
Seat 1: 34ttqW62uIRrqINCCmLcsw (small blind) collected ($1.70)
Seat 2: iauW7L/+7qzAuHow7CD75Q (big blind) folded before Flop
Seat 3: vw7gefupgmOJJN8lUemdWg folded on the Flop
Seat 4: TgDsTeCdLQt8kWbL00ByRA folded before Flop (didn't bet)
Seat 5: LtASJ9OlkqGrrUKGQlpGAw folded before Flop (didn't bet)
Seat 6: leEQ84f6wJYu5SB/vj27wg (button) folded before Flop (didn't bet)




PokerStars Game #59941790684:  Hold'em No Limit ($0.10/$0.25) - 2009/07/01 1:46:15 ET
Table 'nB7Q7zfNfy6ig6DB+rsgWQ' 6-max Seat #5 is the button
Seat 1: Hzy03WtPHMYwLYM7hTTxQw ($24 in chips) 
Seat 2: 4BHo0wlX9INjkj2727qE0w ($24 in chips) 
Seat 3: p3NYOxYhkL7txPRSeXHDeg ($32.60 in chips) 
Seat 4: DihMHaz4WNETH1bPDe13kA ($80.10 in chips) 
Seat 5: xC0kaiDYM6YTlgODL83O5A ($16.15 in chips) 
Seat 6: MEGIwX0eHRUj63lwYaNhVg ($7.20 in chips) 
MEGIwX0eHRUj63lwYaNhVg: posts small blind $0.10
Hzy03WtPHMYwLYM7hTTxQw: posts big blind $0.25
*** HOLE CARDS ***
4BHo0wlX9INjkj2727qE0w: calls $0.25
p3NYOxYhkL7txPRSeXHDeg: folds 
DihMHaz4WNETH1bPDe13kA: folds 
xC0kaiDYM6YTlgODL83O5A: calls $0.25
MEGIwX0eHRUj63lwYaNhVg: raises $1.25 to $1.50
Hzy03WtPHMYwLYM7hTTxQw: folds 
4BHo0wlX9INjkj2727qE0w: folds 
xC0kaiDYM6YTlgODL83O5A: folds 
Uncalled bet ($1.25) returned to MEGIwX0eHRUj63lwYaNhVg
MEGIwX0eHRUj63lwYaNhVg collected $1 from pot
MEGIwX0eHRUj63lwYaNhVg: doesn't show hand 
*** SUMMARY ***
Total pot $1 | Rake $0 
Seat 1: Hzy03WtPHMYwLYM7hTTxQw (big blind) folded before Flop
Seat 2: 4BHo0wlX9INjkj2727qE0w folded before Flop
Seat 3: p3NYOxYhkL7txPRSeXHDeg folded before Flop (didn't bet)
Seat 4: DihMHaz4WNETH1bPDe13kA folded before Flop (didn't bet)
Seat 5: xC0kaiDYM6YTlgODL83O5A (button) folded before Flop
Seat 6: MEGIwX0eHRUj63lwYaNhVg (small blind) collected ($1)




PokerStars Game #59941790856:  Hold'em No Limit ($0.10/$0.25) - 2009/07/01 1:46:15 ET
Table '4UJB/UOZ5aepyF2v+hIoUg' 6-max Seat #6 is the button
Seat 1: 08V++DOqzaNrRNsHIwi25w ($27.10 in chips) 
Seat 2: mFv3iBCtrw9XfCDRB0d46Q ($4.55 in chips) 
Seat 3: zlYHXTtJ5tcx9kwK2h5n9A ($42.25 in chips) 
Seat 4: R6AGToFJQOYVZAjC2jXEKw ($23.85 in chips) 
Seat 5: 3zD3qLXT1bEffAoWGnc7wg ($25.55 in chips) 
Seat 6: 2aphcinkTZT0B0Uoah6cvQ ($12.85 in chips) 
08V++DOqzaNrRNsHIwi25w: posts small blind $0.10
mFv3iBCtrw9XfCDRB0d46Q: posts big blind $0.25
*** HOLE CARDS ***
zlYHXTtJ5tcx9kwK2h5n9A: calls $0.25
R6AGToFJQOYVZAjC2jXEKw: folds 
3zD3qLXT1bEffAoWGnc7wg: raises $1 to $1.25
2aphcinkTZT0B0Uoah6cvQ: folds 
08V++DOqzaNrRNsHIwi25w: folds 
mFv3iBCtrw9XfCDRB0d46Q: folds 
zlYHXTtJ5tcx9kwK2h5n9A: folds 
Uncalled bet ($1) returned to 3zD3qLXT1bEffAoWGnc7wg
3zD3qLXT1bEffAoWGnc7wg collected $0.85 from pot
3zD3qLXT1bEffAoWGnc7wg: doesn't show hand 
*** SUMMARY ***
Total pot $0.85 | Rake $0 
Seat 1: 08V++DOqzaNrRNsHIwi25w (small blind) folded before Flop
Seat 2: mFv3iBCtrw9XfCDRB0d46Q (big blind) folded before Flop
Seat 3: zlYHXTtJ5tcx9kwK2h5n9A folded before Flop
Seat 4: R6AGToFJQOYVZAjC2jXEKw folded before Flop (didn't bet)
Seat 5: 3zD3qLXT1bEffAoWGnc7wg collected ($0.85)
Seat 6: 2aphcinkTZT0B0Uoah6cvQ (button) folded before Flop (didn't bet)




PokerStars Game #59941790770:  Hold'em No Limit ($0.10/$0.25) - 2009/07/01 1:46:15 ET
Table '6wawJ+MkkvuC3coG6r+Yhg' 6-max Seat #4 is the button
Seat 1: JQZew0FjzS19kTjeNtrE+A ($28.25 in chips) 
Seat 2: LtASJ9OlkqGrrUKGQlpGAw ($34.15 in chips) 
Seat 3: 3zD3qLXT1bEffAoWGnc7wg ($61.25 in chips) 
Seat 4: yxmjNFGiKI3b+XQGJzJVIg ($25.75 in chips) 
Seat 5: FZrgDbxAanC1xwZxXHJKVA ($4.40 in chips) 
Seat 6: B3X187C0tXFUfQpCu8pe8A ($25.50 in chips) 
FZrgDbxAanC1xwZxXHJKVA: posts small blind $0.10
B3X187C0tXFUfQpCu8pe8A: posts big blind $0.25
*** HOLE CARDS ***
JQZew0FjzS19kTjeNtrE+A: folds 
LtASJ9OlkqGrrUKGQlpGAw: folds 
3zD3qLXT1bEffAoWGnc7wg: folds 
yxmjNFGiKI3b+XQGJzJVIg: raises $0.50 to $0.75
FZrgDbxAanC1xwZxXHJKVA: folds 
B3X187C0tXFUfQpCu8pe8A: folds 
Uncalled bet ($0.50) returned to yxmjNFGiKI3b+XQGJzJVIg
yxmjNFGiKI3b+XQGJzJVIg collected $0.60 from pot
*** SUMMARY ***
Total pot $0.60 | Rake $0 
Seat 1: JQZew0FjzS19kTjeNtrE+A folded before Flop (didn't bet)
Seat 2: LtASJ9OlkqGrrUKGQlpGAw folded before Flop (didn't bet)
Seat 3: 3zD3qLXT1bEffAoWGnc7wg folded before Flop (didn't bet)
Seat 4: yxmjNFGiKI3b+XQGJzJVIg (button) collected ($0.60)
Seat 5: FZrgDbxAanC1xwZxXHJKVA (small blind) folded before Flop
Seat 6: B3X187C0tXFUfQpCu8pe8A (big blind) folded before Flop




PokerStars Game #59941790648:  Hold'em No Limit ($0.10/$0.25) - 2009/07/01 1:46:15 ET
Table 'biAgO3TKQBU8XcrVAoU5TA' 6-max Seat #2 is the button
Seat 1: jhDPlkir8wBYAddboBuF7Q ($16.55 in chips) 
Seat 2: GbCVUNssQ7mqsPWr7J4d3w ($7.15 in chips) 
Seat 3: mfrkWA3PTeYPkbO6hi98Aw ($31.90 in chips) 
Seat 4: Hsvkc0/G2VV78oVmWYXecw ($5 in chips) 
Seat 5: n6UPMnVR4v8LFP0rWP73Fg ($11.10 in chips) 
Seat 6: wMiE3yTbDJGOLOF9th7KPA ($7.90 in chips) 
mfrkWA3PTeYPkbO6hi98Aw: posts small blind $0.10
Hsvkc0/G2VV78oVmWYXecw: posts big blind $0.25
*** HOLE CARDS ***
n6UPMnVR4v8LFP0rWP73Fg: calls $0.25
wMiE3yTbDJGOLOF9th7KPA: calls $0.25
jhDPlkir8wBYAddboBuF7Q: folds 
GbCVUNssQ7mqsPWr7J4d3w: folds 
mfrkWA3PTeYPkbO6hi98Aw: calls $0.15
Hsvkc0/G2VV78oVmWYXecw: checks 
*** FLOP *** [Ah 8h 2h]
mfrkWA3PTeYPkbO6hi98Aw: checks 
Hsvkc0/G2VV78oVmWYXecw: checks 
n6UPMnVR4v8LFP0rWP73Fg: checks 
wMiE3yTbDJGOLOF9th7KPA: checks 
*** TURN *** [Ah 8h 2h] [7s]
mfrkWA3PTeYPkbO6hi98Aw: checks 
Hsvkc0/G2VV78oVmWYXecw: checks 
n6UPMnVR4v8LFP0rWP73Fg: checks 
wMiE3yTbDJGOLOF9th7KPA: bets $0.25
mfrkWA3PTeYPkbO6hi98Aw: folds 
Hsvkc0/G2VV78oVmWYXecw: folds 
n6UPMnVR4v8LFP0rWP73Fg: folds 
Uncalled bet ($0.25) returned to wMiE3yTbDJGOLOF9th7KPA
wMiE3yTbDJGOLOF9th7KPA collected $0.95 from pot
*** SUMMARY ***
Total pot $1 | Rake $0.05 
Board [Ah 8h 2h 7s]
Seat 1: jhDPlkir8wBYAddboBuF7Q folded before Flop (didn't bet)
Seat 2: GbCVUNssQ7mqsPWr7J4d3w (button) folded before Flop (didn't bet)
Seat 3: mfrkWA3PTeYPkbO6hi98Aw (small blind) folded on the Turn
Seat 4: Hsvkc0/G2VV78oVmWYXecw (big blind) folded on the Turn
Seat 5: n6UPMnVR4v8LFP0rWP73Fg folded on the Turn
Seat 6: wMiE3yTbDJGOLOF9th7KPA collected ($0.95)




PokerStars Game #59941790670:  Hold'em No Limit ($0.10/$0.25) - 2009/07/01 1:46:15 ET
Table 'djcjiEGabFQO0MNG6jEeJQ' 9-max Seat #4 is the button
Seat 1: Bb42QRQMhg5/Y0vHP8/2Xw ($25.60 in chips) 
Seat 2: WKL8nUFr7TumC4EjLyqYzw ($5.25 in chips) 
Seat 3: zgi+EUykT/pZQpoUG6+oEg ($4.65 in chips) 
Seat 4: 2wcFsZsqEP5w1StUTVzJCg ($9.55 in chips) 
Seat 6: aNpwfA31EREwO+ar4XzBCw ($73.75 in chips) 
Seat 8: +sbyWwIcFp9kP0bDtMegfQ ($51.25 in chips) 
Seat 9: HPEB+AtKw1+C/cxU0o1ciw ($46.85 in chips) 
aNpwfA31EREwO+ar4XzBCw: posts small blind $0.10
56S3mA6Zs3pGR+0p0vUCtg: is sitting out 
+sbyWwIcFp9kP0bDtMegfQ: posts big blind $0.25
*** HOLE CARDS ***
HPEB+AtKw1+C/cxU0o1ciw: folds 
56S3mA6Zs3pGR+0p0vUCtg leaves the table
Bb42QRQMhg5/Y0vHP8/2Xw: folds 
WKL8nUFr7TumC4EjLyqYzw: folds 
zgi+EUykT/pZQpoUG6+oEg: folds 
2wcFsZsqEP5w1StUTVzJCg: folds 
aNpwfA31EREwO+ar4XzBCw: raises $0.75 to $1
+sbyWwIcFp9kP0bDtMegfQ: calls $0.75
*** FLOP *** [Tc Ah As]
aNpwfA31EREwO+ar4XzBCw: bets $1.25
+sbyWwIcFp9kP0bDtMegfQ: raises $3 to $4.25
aNpwfA31EREwO+ar4XzBCw: calls $3
*** TURN *** [Tc Ah As] [Js]
aNpwfA31EREwO+ar4XzBCw: checks 
+sbyWwIcFp9kP0bDtMegfQ: checks 
*** RIVER *** [Tc Ah As Js] [4h]
aNpwfA31EREwO+ar4XzBCw: checks 
+sbyWwIcFp9kP0bDtMegfQ: checks 
*** SHOW DOWN ***
aNpwfA31EREwO+ar4XzBCw: shows [6h Ad] (three of a kind, Aces)
+sbyWwIcFp9kP0bDtMegfQ: mucks hand 
aNpwfA31EREwO+ar4XzBCw collected $10 from pot
*** SUMMARY ***
Total pot $10.50 | Rake $0.50 
Board [Tc Ah As Js 4h]
Seat 1: Bb42QRQMhg5/Y0vHP8/2Xw folded before Flop (didn't bet)
Seat 2: WKL8nUFr7TumC4EjLyqYzw folded before Flop (didn't bet)
Seat 3: zgi+EUykT/pZQpoUG6+oEg folded before Flop (didn't bet)
Seat 4: 2wcFsZsqEP5w1StUTVzJCg (button) folded before Flop (didn't bet)
Seat 6: aNpwfA31EREwO+ar4XzBCw (small blind) showed [6h Ad] and won ($10) with three of a kind, Aces
Seat 8: +sbyWwIcFp9kP0bDtMegfQ (big blind) mucked
Seat 9: HPEB+AtKw1+C/cxU0o1ciw folded before Flop (didn't bet)




PokerStars Game #59941790992:  Hold'em No Limit ($0.10/$0.25) - 2009/07/01 1:46:15 ET
Table 'rpIHGyt2QpgQc5bvptAvDQ' 9-max Seat #8 is the button
Seat 2: FX0yWp7Ul3dMebXB0cFjEw ($3.95 in chips) 
Seat 3: N6a/f6AW8S8G3JFw9IFxAg ($16.40 in chips) 
Seat 4: ASXDkj9tmvF/T2AsNuxg7g ($6.20 in chips) 
Seat 5: XhSvfX1gy0yx/qeW+SOeTw ($9.30 in chips) 
Seat 6: Mq1ESwxx3LEsA4HjKKjU3Q ($18.90 in chips) 
Seat 7: GHgIdzlzMAmRmmX7jgXtuQ ($3.75 in chips) 
Seat 8: oUgIL46CfA9GCdIuN1TVSw ($9.20 in chips) 
E0iYnEVO2ho7dH3QcCjw7g will be allowed to play after the button
FX0yWp7Ul3dMebXB0cFjEw: posts small blind $0.10
N6a/f6AW8S8G3JFw9IFxAg: posts big blind $0.25
*** HOLE CARDS ***
HQMjiff9S04k8kyC4fHVgw leaves the table
ASXDkj9tmvF/T2AsNuxg7g: folds 
XhSvfX1gy0yx/qeW+SOeTw: folds 
Mq1ESwxx3LEsA4HjKKjU3Q: raises $0.60 to $0.85
GHgIdzlzMAmRmmX7jgXtuQ: folds 
oUgIL46CfA9GCdIuN1TVSw: folds 
eebse2009 joins the table at seat #9 
FX0yWp7Ul3dMebXB0cFjEw: folds 
N6a/f6AW8S8G3JFw9IFxAg: folds 
Uncalled bet ($0.60) returned to Mq1ESwxx3LEsA4HjKKjU3Q
Mq1ESwxx3LEsA4HjKKjU3Q collected $0.60 from pot
Mq1ESwxx3LEsA4HjKKjU3Q: doesn't show hand 
*** SUMMARY ***
Total pot $0.60 | Rake $0 
Seat 2: FX0yWp7Ul3dMebXB0cFjEw (small blind) folded before Flop
Seat 3: N6a/f6AW8S8G3JFw9IFxAg (big blind) folded before Flop
Seat 4: ASXDkj9tmvF/T2AsNuxg7g folded before Flop (didn't bet)
Seat 5: XhSvfX1gy0yx/qeW+SOeTw folded before Flop (didn't bet)
Seat 6: Mq1ESwxx3LEsA4HjKKjU3Q collected ($0.60)
Seat 7: GHgIdzlzMAmRmmX7jgXtuQ folded before Flop (didn't bet)
Seat 8: oUgIL46CfA9GCdIuN1TVSw (button) folded before Flop (didn't bet)




PokerStars Game #59941790668:  Hold'em No Limit ($0.10/$0.25) - 2009/07/01 1:46:15 ET
Table 'dVzscin98UhGisTmV9BDcw' 9-max Seat #8 is the button
Seat 1: sBAwXpkpgyhyWbHIQcIJKA ($17.30 in chips) 
Seat 2: dfNim92Z6XK1/h5SFW5vDg ($28.35 in chips) 
Seat 3: cZ99hugmLBj9KhTlc8nCSw ($25 in chips) 
Seat 4: aNpwfA31EREwO+ar4XzBCw ($42.25 in chips) 
Seat 7: cKlmpQMahVsmOaxFQDcoOg ($24.30 in chips) 
Seat 8: /vn2Qu2dvc9AMMq46Ae0jA ($46.75 in chips) 
Seat 9: arxNSjreDRGFg13EAM2F1w ($25.10 in chips) 
arxNSjreDRGFg13EAM2F1w: posts small blind $0.10
sBAwXpkpgyhyWbHIQcIJKA: posts big blind $0.25
E0iYnEVO2ho7dH3QcCjw7g: sits out 
A/OkFabqdcrG3ozpiYMiNQ: sits out 
*** HOLE CARDS ***
dfNim92Z6XK1/h5SFW5vDg: folds 
cZ99hugmLBj9KhTlc8nCSw: folds 
aNpwfA31EREwO+ar4XzBCw: folds 
cKlmpQMahVsmOaxFQDcoOg: raises $0.50 to $0.75
/vn2Qu2dvc9AMMq46Ae0jA: folds 
arxNSjreDRGFg13EAM2F1w: calls $0.65
sBAwXpkpgyhyWbHIQcIJKA: folds 
*** FLOP *** [4h Qc 5s]
arxNSjreDRGFg13EAM2F1w: checks 
cKlmpQMahVsmOaxFQDcoOg: bets $1.50
arxNSjreDRGFg13EAM2F1w: folds 
Uncalled bet ($1.50) returned to cKlmpQMahVsmOaxFQDcoOg
cKlmpQMahVsmOaxFQDcoOg collected $1.70 from pot
*** SUMMARY ***
Total pot $1.75 | Rake $0.05 
Board [4h Qc 5s]
Seat 1: sBAwXpkpgyhyWbHIQcIJKA (big blind) folded before Flop
Seat 2: dfNim92Z6XK1/h5SFW5vDg folded before Flop (didn't bet)
Seat 3: cZ99hugmLBj9KhTlc8nCSw folded before Flop (didn't bet)
Seat 4: aNpwfA31EREwO+ar4XzBCw folded before Flop (didn't bet)
Seat 7: cKlmpQMahVsmOaxFQDcoOg collected ($1.70)
Seat 8: /vn2Qu2dvc9AMMq46Ae0jA (button) folded before Flop (didn't bet)
Seat 9: arxNSjreDRGFg13EAM2F1w (small blind) folded on the Flop




PokerStars Game #59941790854:  Hold'em No Limit ($0.10/$0.25) - 2009/07/01 1:46:15 ET
Table 'XX2OuOsa8/8AC+/mR/Az6g' 9-max Seat #6 is the button
Seat 1: 56S3mA6Zs3pGR+0p0vUCtg ($24.40 in chips) 
Seat 2: Bb42QRQMhg5/Y0vHP8/2Xw ($27.10 in chips) 
Seat 3: oLa/tXLfSLLB28mcLGrxcg ($24.60 in chips) 
Seat 4: 52uIvr1a/mxEYD1W0ESvdQ ($38.55 in chips) 
Seat 5: SpiiQQAzy4MUgV3I5W8giw ($21.15 in chips) 
Seat 6: RCqMONFrSPSArZh2Jsar/w ($18.50 in chips) 
Seat 8: qwr38jl5txoR36M7G5qi4A ($10.10 in chips) 
Seat 9: V6p0jQ/RhUsqpHLmXvEX4Q ($12.35 in chips) 
qwr38jl5txoR36M7G5qi4A: posts small blind $0.10
V6p0jQ/RhUsqpHLmXvEX4Q: posts big blind $0.25
*** HOLE CARDS ***
56S3mA6Zs3pGR+0p0vUCtg: folds 
Bb42QRQMhg5/Y0vHP8/2Xw: calls $0.25
oLa/tXLfSLLB28mcLGrxcg: folds 
52uIvr1a/mxEYD1W0ESvdQ: calls $0.25
SpiiQQAzy4MUgV3I5W8giw: folds 
RCqMONFrSPSArZh2Jsar/w: raises $1 to $1.25
qwr38jl5txoR36M7G5qi4A: folds 
V6p0jQ/RhUsqpHLmXvEX4Q: folds 
Bb42QRQMhg5/Y0vHP8/2Xw: folds 
52uIvr1a/mxEYD1W0ESvdQ: calls $1
*** FLOP *** [4c 4s Ac]
52uIvr1a/mxEYD1W0ESvdQ: checks 
RCqMONFrSPSArZh2Jsar/w: bets $1.50
52uIvr1a/mxEYD1W0ESvdQ: folds 
Uncalled bet ($1.50) returned to RCqMONFrSPSArZh2Jsar/w
52uIvr1a/mxEYD1W0ESvdQ leaves the table
RCqMONFrSPSArZh2Jsar/w collected $2.95 from pot
RCqMONFrSPSArZh2Jsar/w: doesn't show hand 
*** SUMMARY ***
Total pot $3.10 | Rake $0.15 
Board [4c 4s Ac]
Seat 1: 56S3mA6Zs3pGR+0p0vUCtg folded before Flop (didn't bet)
Seat 2: Bb42QRQMhg5/Y0vHP8/2Xw folded before Flop
Seat 3: oLa/tXLfSLLB28mcLGrxcg folded before Flop (didn't bet)
Seat 4: 52uIvr1a/mxEYD1W0ESvdQ folded on the Flop
Seat 5: SpiiQQAzy4MUgV3I5W8giw folded before Flop (didn't bet)
Seat 6: RCqMONFrSPSArZh2Jsar/w (button) collected ($2.95)
Seat 8: qwr38jl5txoR36M7G5qi4A (small blind) folded before Flop
Seat 9: V6p0jQ/RhUsqpHLmXvEX4Q (big blind) folded before Flop




PokerStars Game #59941790742:  Hold'em No Limit ($0.10/$0.25) - 2009/07/01 1:46:15 ET
Table 'O6cwjhrMn9pfzx1Ngn5zkQ' 6-max Seat #6 is the button
Seat 1: LJI7A1YgDM7hgh7o56+ReQ ($27.55 in chips) 
Seat 3: EE16Ua5b1HSsYej5zeXOlA ($25.45 in chips) 
Seat 4: mfrkWA3PTeYPkbO6hi98Aw ($23.95 in chips) 
Seat 5: niLn0xUVlqh8If80xRjzCA ($28.05 in chips) 
Seat 6: 4TM16KVgEiQpLi4bVVWbVQ ($33.05 in chips) 
LJI7A1YgDM7hgh7o56+ReQ: posts small blind $0.10
tSR4329m40dZsN7YOpI9Kw: is sitting out 
EE16Ua5b1HSsYej5zeXOlA: posts big blind $0.25
*** HOLE CARDS ***
tSR4329m40dZsN7YOpI9Kw leaves the table
mfrkWA3PTeYPkbO6hi98Aw: folds 
niLn0xUVlqh8If80xRjzCA: calls $0.25
4TM16KVgEiQpLi4bVVWbVQ: folds 
LJI7A1YgDM7hgh7o56+ReQ: folds 
EE16Ua5b1HSsYej5zeXOlA: checks 
*** FLOP *** [Js 4s 9c]
EE16Ua5b1HSsYej5zeXOlA: checks 
niLn0xUVlqh8If80xRjzCA: checks 
*** TURN *** [Js 4s 9c] [Th]
asianthug90 joins the table at seat #2 
EE16Ua5b1HSsYej5zeXOlA: checks 
niLn0xUVlqh8If80xRjzCA: bets $0.25
EE16Ua5b1HSsYej5zeXOlA: folds 
Uncalled bet ($0.25) returned to niLn0xUVlqh8If80xRjzCA
niLn0xUVlqh8If80xRjzCA collected $0.60 from pot
niLn0xUVlqh8If80xRjzCA: doesn't show hand 
*** SUMMARY ***
Total pot $0.60 | Rake $0 
Board [Js 4s 9c Th]
Seat 1: LJI7A1YgDM7hgh7o56+ReQ (small blind) folded before Flop
Seat 3: EE16Ua5b1HSsYej5zeXOlA (big blind) folded on the Turn
Seat 4: mfrkWA3PTeYPkbO6hi98Aw folded before Flop (didn't bet)
Seat 5: niLn0xUVlqh8If80xRjzCA collected ($0.60)
Seat 6: 4TM16KVgEiQpLi4bVVWbVQ (button) folded before Flop (didn't bet)




PokerStars Game #59941790848:  Hold'em No Limit ($0.10/$0.25) - 2009/07/01 1:46:15 ET
Table 'srBTB98reCdD1TffxE6o7g' 6-max Seat #3 is the button
Seat 1: SFmT9ZsVopnukjvAzrxTRg ($33.95 in chips) 
Seat 2: mfrkWA3PTeYPkbO6hi98Aw ($25 in chips) 
Seat 3: VOmI0x4dDPnTESZd5B4d1Q ($41.70 in chips) 
Seat 4: 6DwBRH+xZ12AAZmeAg+aXw ($16.30 in chips) 
Seat 6: BV+K0Phf5VBHr7aZPKqbUQ ($34.95 in chips) 
8zUCJvLYLFM8AG6K5zjIvg leaves the table
6DwBRH+xZ12AAZmeAg+aXw: posts small blind $0.10
BV+K0Phf5VBHr7aZPKqbUQ: posts big blind $0.25
*** HOLE CARDS ***
SFmT9ZsVopnukjvAzrxTRg: folds 
mfrkWA3PTeYPkbO6hi98Aw: folds 
VOmI0x4dDPnTESZd5B4d1Q: raises $1.75 to $2
K1zv48sQUGQiaLk5VWWDqw joins the table at seat #5 
6DwBRH+xZ12AAZmeAg+aXw: folds 
BV+K0Phf5VBHr7aZPKqbUQ: folds 
Uncalled bet ($1.75) returned to VOmI0x4dDPnTESZd5B4d1Q
VOmI0x4dDPnTESZd5B4d1Q collected $0.60 from pot
VOmI0x4dDPnTESZd5B4d1Q: doesn't show hand 
*** SUMMARY ***
Total pot $0.60 | Rake $0 
Seat 1: SFmT9ZsVopnukjvAzrxTRg folded before Flop (didn't bet)
Seat 2: mfrkWA3PTeYPkbO6hi98Aw folded before Flop (didn't bet)
Seat 3: VOmI0x4dDPnTESZd5B4d1Q (button) collected ($0.60)
Seat 4: 6DwBRH+xZ12AAZmeAg+aXw (small blind) folded before Flop
Seat 6: BV+K0Phf5VBHr7aZPKqbUQ (big blind) folded before Flop




PokerStars Game #59941790572:  Hold'em No Limit ($0.10/$0.25) - 2009/07/01 1:46:15 ET
Table 'zKwHJD0cmKNUure9qQTfFg' 6-max Seat #6 is the button
Seat 1: Hzrn9DZJegEZICufTNYkrg ($17.70 in chips) 
Seat 2: xrf8tAXKQHG99HixCot1Iw ($25 in chips) 
Seat 3: m9aw7LBAB5YX2ZqMtMkhqA ($15.60 in chips) 
Seat 4: v+QfkGiuj9bgtuNoVnDO8w ($25.45 in chips) 
Seat 6: edio/rLJ06xeZOfLhoL3UA ($8.90 in chips) 
Hzrn9DZJegEZICufTNYkrg: posts small blind $0.10
xrf8tAXKQHG99HixCot1Iw: posts big blind $0.25
E4AqQ1egsnu0oH2RqsbCmQ: sits out 
*** HOLE CARDS ***
m9aw7LBAB5YX2ZqMtMkhqA: calls $0.25
v+QfkGiuj9bgtuNoVnDO8w: folds 
edio/rLJ06xeZOfLhoL3UA: folds 
Hzrn9DZJegEZICufTNYkrg: calls $0.15
xrf8tAXKQHG99HixCot1Iw: checks 
*** FLOP *** [5c 2h 5h]
Hzrn9DZJegEZICufTNYkrg: bets $0.25
xrf8tAXKQHG99HixCot1Iw: calls $0.25
m9aw7LBAB5YX2ZqMtMkhqA: calls $0.25
*** TURN *** [5c 2h 5h] [9c]
Hzrn9DZJegEZICufTNYkrg: bets $0.25
xrf8tAXKQHG99HixCot1Iw: folds 
m9aw7LBAB5YX2ZqMtMkhqA: calls $0.25
*** RIVER *** [5c 2h 5h 9c] [6h]
Hzrn9DZJegEZICufTNYkrg: bets $0.25
m9aw7LBAB5YX2ZqMtMkhqA: calls $0.25
*** SHOW DOWN ***
Hzrn9DZJegEZICufTNYkrg: shows [Td Th] (two pair, Tens and Fives)
m9aw7LBAB5YX2ZqMtMkhqA: mucks hand 
Hzrn9DZJegEZICufTNYkrg collected $2.40 from pot
*** SUMMARY ***
Total pot $2.50 | Rake $0.10 
Board [5c 2h 5h 9c 6h]
Seat 1: Hzrn9DZJegEZICufTNYkrg (small blind) showed [Td Th] and won ($2.40) with two pair, Tens and Fives
Seat 2: xrf8tAXKQHG99HixCot1Iw (big blind) folded on the Turn
Seat 3: m9aw7LBAB5YX2ZqMtMkhqA mucked
Seat 4: v+QfkGiuj9bgtuNoVnDO8w folded before Flop (didn't bet)
Seat 6: edio/rLJ06xeZOfLhoL3UA (button) folded before Flop (didn't bet)




PokerStars Game #59941791574:  Hold'em No Limit ($0.10/$0.25) - 2009/07/01 1:46:16 ET
Table 'jxoHy9yJy0bbH/Qx73FoPA' 9-max Seat #7 is the button
Seat 1: j4q3p0lesp63b1gZDwLBZw ($6.60 in chips) 
Seat 2: F7pnn6czNpHvRM55XcA2EA ($45.50 in chips) 
Seat 3: CVqCt93Mk0MhKMaZ4LZDSQ ($8.95 in chips) 
Seat 5: rzZ3wFcwoPyKlQ0mB5JLRQ ($7.75 in chips) 
Seat 6: tYsOBqdU1+x+yFI7zHO7hQ ($62.55 in chips) 
Seat 7: wGigCmBR/9XWkPpvYos3aQ ($26.05 in chips) 
Seat 8: Z9W7+g1WMhhZDi7DwGbCFA ($5 in chips) 
Seat 9: CvL9Ch1HYCVbTsfpNucitg ($4.90 in chips) 
Z9W7+g1WMhhZDi7DwGbCFA: posts small blind $0.10
CvL9Ch1HYCVbTsfpNucitg: posts big blind $0.25
bXpVeaSTPBFSPJmeXxO7nw: sits out 
*** HOLE CARDS ***
j4q3p0lesp63b1gZDwLBZw: folds 
F7pnn6czNpHvRM55XcA2EA: folds 
CVqCt93Mk0MhKMaZ4LZDSQ: raises $0.50 to $0.75
rzZ3wFcwoPyKlQ0mB5JLRQ: folds 
tYsOBqdU1+x+yFI7zHO7hQ: folds 
wGigCmBR/9XWkPpvYos3aQ: folds 
Z9W7+g1WMhhZDi7DwGbCFA: folds 
CvL9Ch1HYCVbTsfpNucitg: folds 
Uncalled bet ($0.50) returned to CVqCt93Mk0MhKMaZ4LZDSQ
CVqCt93Mk0MhKMaZ4LZDSQ collected $0.60 from pot
*** SUMMARY ***
Total pot $0.60 | Rake $0 
Seat 1: j4q3p0lesp63b1gZDwLBZw folded before Flop (didn't bet)
Seat 2: F7pnn6czNpHvRM55XcA2EA folded before Flop (didn't bet)
Seat 3: CVqCt93Mk0MhKMaZ4LZDSQ collected ($0.60)
Seat 5: rzZ3wFcwoPyKlQ0mB5JLRQ folded before Flop (didn't bet)
Seat 6: tYsOBqdU1+x+yFI7zHO7hQ folded before Flop (didn't bet)
Seat 7: wGigCmBR/9XWkPpvYos3aQ (button) folded before Flop (didn't bet)
Seat 8: Z9W7+g1WMhhZDi7DwGbCFA (small blind) folded before Flop
Seat 9: CvL9Ch1HYCVbTsfpNucitg (big blind) folded before Flop




PokerStars Game #59941791208:  Hold'em No Limit ($0.10/$0.25) - 2009/07/01 1:46:16 ET
Table '50f2Xa1b1jp6cfdTAgXFIg' 9-max Seat #9 is the button
Seat 1: E0iYnEVO2ho7dH3QcCjw7g ($19.75 in chips) 
Seat 3: RSojRXQHk0IRANbJYopT9g ($22.40 in chips) 
Seat 4: ghNKXUBl/H+t83JF079ZBA ($28.10 in chips) 
Seat 5: C1w4aCCgQVVSgNijoEahAg ($16.75 in chips) 
Seat 6: tLcDklc2rBORNfixyRfVfw ($27.50 in chips) 
Seat 7: w1ukf8uPa4+WH561TtVRxA ($25 in chips) 
Seat 8: x+W5+3qsdY4Iszf0hoH+Aw ($14.55 in chips) 
Seat 9: gehe91e0IyVT0QU/XBkEyg ($25 in chips) 
E0iYnEVO2ho7dH3QcCjw7g: posts small blind $0.10
RSojRXQHk0IRANbJYopT9g: posts big blind $0.25
*** HOLE CARDS ***
ghNKXUBl/H+t83JF079ZBA: folds 
C1w4aCCgQVVSgNijoEahAg: raises $0.25 to $0.50
tLcDklc2rBORNfixyRfVfw: folds 
w1ukf8uPa4+WH561TtVRxA: folds 
x+W5+3qsdY4Iszf0hoH+Aw: folds 
gehe91e0IyVT0QU/XBkEyg: folds 
E0iYnEVO2ho7dH3QcCjw7g: folds 
RSojRXQHk0IRANbJYopT9g: calls $0.25
*** FLOP *** [4h 9d Kc]
RSojRXQHk0IRANbJYopT9g: bets $0.50
C1w4aCCgQVVSgNijoEahAg: raises $1 to $1.50
RSojRXQHk0IRANbJYopT9g: folds 
Uncalled bet ($1) returned to C1w4aCCgQVVSgNijoEahAg
C1w4aCCgQVVSgNijoEahAg collected $2 from pot
C1w4aCCgQVVSgNijoEahAg: shows [4s 4c] (three of a kind, Fours)
*** SUMMARY ***
Total pot $2.10 | Rake $0.10 
Board [4h 9d Kc]
Seat 1: E0iYnEVO2ho7dH3QcCjw7g (small blind) folded before Flop
Seat 3: RSojRXQHk0IRANbJYopT9g (big blind) folded on the Flop
Seat 4: ghNKXUBl/H+t83JF079ZBA folded before Flop (didn't bet)
Seat 5: C1w4aCCgQVVSgNijoEahAg collected ($2)
Seat 6: tLcDklc2rBORNfixyRfVfw folded before Flop (didn't bet)
Seat 7: w1ukf8uPa4+WH561TtVRxA folded before Flop (didn't bet)
Seat 8: x+W5+3qsdY4Iszf0hoH+Aw folded before Flop (didn't bet)
Seat 9: gehe91e0IyVT0QU/XBkEyg (button) folded before Flop (didn't bet)




PokerStars Game #59941791612:  Hold'em No Limit ($0.10/$0.25) - 2009/07/01 1:46:16 ET
Table 'DhkrdW2UOy2PfjSW28Kq8w' 6-max Seat #2 is the button
Seat 2: v+QfkGiuj9bgtuNoVnDO8w ($25 in chips) 
Seat 3: B3X187C0tXFUfQpCu8pe8A ($20.90 in chips) 
Seat 5: SxIIgwXYLkwd6m3wLyPTCw ($51 in chips) 
Seat 6: DihMHaz4WNETH1bPDe13kA ($27.35 in chips) 
B3X187C0tXFUfQpCu8pe8A: posts small blind $0.10
SxIIgwXYLkwd6m3wLyPTCw: posts big blind $0.25
Mhj3q7cxev+XjXZxEE6/Cw: sits out 
*** HOLE CARDS ***
DihMHaz4WNETH1bPDe13kA: folds 
v+QfkGiuj9bgtuNoVnDO8w: raises $0.75 to $1
B3X187C0tXFUfQpCu8pe8A: calls $0.90
SxIIgwXYLkwd6m3wLyPTCw: folds 
*** FLOP *** [3s 4d Qc]
B3X187C0tXFUfQpCu8pe8A: checks 
v+QfkGiuj9bgtuNoVnDO8w: checks 
*** TURN *** [3s 4d Qc] [Kc]
B3X187C0tXFUfQpCu8pe8A: checks 
moondyne1124 has returned
v+QfkGiuj9bgtuNoVnDO8w: bets $1.50
B3X187C0tXFUfQpCu8pe8A: folds 
Uncalled bet ($1.50) returned to v+QfkGiuj9bgtuNoVnDO8w
v+QfkGiuj9bgtuNoVnDO8w collected $2.15 from pot
v+QfkGiuj9bgtuNoVnDO8w: doesn't show hand 
*** SUMMARY ***
Total pot $2.25 | Rake $0.10 
Board [3s 4d Qc Kc]
Seat 2: v+QfkGiuj9bgtuNoVnDO8w (button) collected ($2.15)
Seat 3: B3X187C0tXFUfQpCu8pe8A (small blind) folded on the Turn
Seat 5: SxIIgwXYLkwd6m3wLyPTCw (big blind) folded before Flop
Seat 6: DihMHaz4WNETH1bPDe13kA folded before Flop (didn't bet)




PokerStars Game #59941791436:  Hold'em No Limit ($0.10/$0.25) - 2009/07/01 1:46:16 ET
Table 'IIO2q2znuuAXmiZ2qFTcmg' 6-max Seat #5 is the button
Seat 2: cS21pIxRHx5Gt42o7hPZzw ($24.20 in chips) 
Seat 5: 9U3ZKjCsarN0DjR6mSE8Ug ($15.85 in chips) 
Seat 6: aogAb4Eienxztk8p2v9VVw ($37.90 in chips) 
aogAb4Eienxztk8p2v9VVw: posts small blind $0.10
cS21pIxRHx5Gt42o7hPZzw: posts big blind $0.25
*** HOLE CARDS ***
9U3ZKjCsarN0DjR6mSE8Ug: folds 
aogAb4Eienxztk8p2v9VVw: folds 
Uncalled bet ($0.15) returned to cS21pIxRHx5Gt42o7hPZzw
cS21pIxRHx5Gt42o7hPZzw collected $0.20 from pot
*** SUMMARY ***
Total pot $0.20 | Rake $0 
Seat 2: cS21pIxRHx5Gt42o7hPZzw (big blind) collected ($0.20)
Seat 5: 9U3ZKjCsarN0DjR6mSE8Ug (button) folded before Flop (didn't bet)
Seat 6: aogAb4Eienxztk8p2v9VVw (small blind) folded before Flop




PokerStars Game #59941791426:  Hold'em No Limit ($0.10/$0.25) - 2009/07/01 1:46:16 ET
Table 'ZEXL6Wh4qA4Afx8NnoBBAA' 6-max Seat #1 is the button
Seat 1: v8m8XHovI5tqEA9mvplDSw ($27.45 in chips) 
Seat 2: 6DwBRH+xZ12AAZmeAg+aXw ($23.75 in chips) 
Seat 3: +ZlnqPoP3Hg4BIUxDfKd/A ($32.05 in chips) 
Seat 4: FpN4KbLjlyRRKiVaQcoLqA ($29.35 in chips) 
Seat 5: if4dh6jhJXeN3/qd3qCp9g ($36.50 in chips) 
Seat 6: Lh8SlCq3OSDKWLUgAI/Lxw ($2 in chips) 
6DwBRH+xZ12AAZmeAg+aXw: posts small blind $0.10
+ZlnqPoP3Hg4BIUxDfKd/A: posts big blind $0.25
*** HOLE CARDS ***
FpN4KbLjlyRRKiVaQcoLqA: calls $0.25
if4dh6jhJXeN3/qd3qCp9g: folds 
Lh8SlCq3OSDKWLUgAI/Lxw: calls $0.25
v8m8XHovI5tqEA9mvplDSw: folds 
6DwBRH+xZ12AAZmeAg+aXw: calls $0.15
+ZlnqPoP3Hg4BIUxDfKd/A: raises $1.50 to $1.75
FpN4KbLjlyRRKiVaQcoLqA: folds 
Lh8SlCq3OSDKWLUgAI/Lxw: folds 
6DwBRH+xZ12AAZmeAg+aXw: folds 
Uncalled bet ($1.50) returned to +ZlnqPoP3Hg4BIUxDfKd/A
+ZlnqPoP3Hg4BIUxDfKd/A collected $1 from pot
+ZlnqPoP3Hg4BIUxDfKd/A: doesn't show hand 
*** SUMMARY ***
Total pot $1 | Rake $0 
Seat 1: v8m8XHovI5tqEA9mvplDSw (button) folded before Flop (didn't bet)
Seat 2: 6DwBRH+xZ12AAZmeAg+aXw (small blind) folded before Flop
Seat 3: +ZlnqPoP3Hg4BIUxDfKd/A (big blind) collected ($1)
Seat 4: FpN4KbLjlyRRKiVaQcoLqA folded before Flop
Seat 5: if4dh6jhJXeN3/qd3qCp9g folded before Flop (didn't bet)
Seat 6: Lh8SlCq3OSDKWLUgAI/Lxw folded before Flop




PokerStars Game #59941791438:  Hold'em No Limit ($0.10/$0.25) - 2009/07/01 1:46:16 ET
Table 'emoxgHTxg9Uqeu06oLzLyg' 6-max Seat #6 is the button
Seat 1: epAUIB7h2FJXzUPRIvSkRA ($25.50 in chips) 
Seat 2: wIFhgE1PVdX6Xf6aVlSTPg ($28.55 in chips) 
Seat 3: uD5epdBxuyc30pF1dO958Q ($9.35 in chips) 
Seat 4: 3VAbqAWh8ncE2SJOYIx2ZQ ($11.25 in chips) 
Seat 5: OIjOiBfQstWrK/RuXx7zcw ($4.05 in chips) 
Seat 6: iHZrkhpIO/3+tKuAoPx8HQ ($2.15 in chips) 
epAUIB7h2FJXzUPRIvSkRA: posts small blind $0.10
wIFhgE1PVdX6Xf6aVlSTPg: posts big blind $0.25
*** HOLE CARDS ***
uD5epdBxuyc30pF1dO958Q: calls $0.25
3VAbqAWh8ncE2SJOYIx2ZQ: calls $0.25
OIjOiBfQstWrK/RuXx7zcw: folds 
iHZrkhpIO/3+tKuAoPx8HQ: raises $1.90 to $2.15 and is all-in
epAUIB7h2FJXzUPRIvSkRA: folds 
wIFhgE1PVdX6Xf6aVlSTPg: folds 
uD5epdBxuyc30pF1dO958Q: calls $1.90
3VAbqAWh8ncE2SJOYIx2ZQ: folds 
*** FLOP *** [3d Jc 4c]
*** TURN *** [3d Jc 4c] [5c]
*** RIVER *** [3d Jc 4c 5c] [Jd]
*** SHOW DOWN ***
uD5epdBxuyc30pF1dO958Q: shows [Ac 3s] (two pair, Jacks and Threes)
iHZrkhpIO/3+tKuAoPx8HQ: mucks hand 
uD5epdBxuyc30pF1dO958Q collected $4.70 from pot
*** SUMMARY ***
Total pot $4.90 | Rake $0.20 
Board [3d Jc 4c 5c Jd]
Seat 1: epAUIB7h2FJXzUPRIvSkRA (small blind) folded before Flop
Seat 2: wIFhgE1PVdX6Xf6aVlSTPg (big blind) folded before Flop
Seat 3: uD5epdBxuyc30pF1dO958Q showed [Ac 3s] and won ($4.70) with two pair, Jacks and Threes
Seat 4: 3VAbqAWh8ncE2SJOYIx2ZQ folded before Flop
Seat 5: OIjOiBfQstWrK/RuXx7zcw folded before Flop (didn't bet)
Seat 6: iHZrkhpIO/3+tKuAoPx8HQ (button) mucked




PokerStars Game #59941791616:  Hold'em No Limit ($0.10/$0.25) - 2009/07/01 1:46:16 ET
Table 'isKy4XK8wJM0x735/D4hWA' 6-max Seat #2 is the button
Seat 1: kwsRmpZ1ZaLooISs+zfyKg ($24.05 in chips) 
Seat 2: 6elpmfyt4Zw0yvd8lePSMQ ($39.25 in chips) 
Seat 3: jp34e617tIzV8tKIWmfAbA ($25.80 in chips) 
Seat 4: DFi/Lzkjsfv8QswS80JX9Q ($31.45 in chips) 
Seat 5: lquriepNQBhDV5P1SWHhnA ($25.60 in chips) 
Seat 6: GbCVUNssQ7mqsPWr7J4d3w ($4.30 in chips) 
jp34e617tIzV8tKIWmfAbA: posts small blind $0.10
DFi/Lzkjsfv8QswS80JX9Q: posts big blind $0.25
*** HOLE CARDS ***
lquriepNQBhDV5P1SWHhnA: folds 
GbCVUNssQ7mqsPWr7J4d3w: folds 
kwsRmpZ1ZaLooISs+zfyKg: folds 
6elpmfyt4Zw0yvd8lePSMQ: folds 
jp34e617tIzV8tKIWmfAbA: raises $0.50 to $0.75
DFi/Lzkjsfv8QswS80JX9Q: folds 
Uncalled bet ($0.50) returned to jp34e617tIzV8tKIWmfAbA
jp34e617tIzV8tKIWmfAbA collected $0.50 from pot
*** SUMMARY ***
Total pot $0.50 | Rake $0 
Seat 1: kwsRmpZ1ZaLooISs+zfyKg folded before Flop (didn't bet)
Seat 2: 6elpmfyt4Zw0yvd8lePSMQ (button) folded before Flop (didn't bet)
Seat 3: jp34e617tIzV8tKIWmfAbA (small blind) collected ($0.50)
Seat 4: DFi/Lzkjsfv8QswS80JX9Q (big blind) folded before Flop
Seat 5: lquriepNQBhDV5P1SWHhnA folded before Flop (didn't bet)
Seat 6: GbCVUNssQ7mqsPWr7J4d3w folded before Flop (didn't bet)




PokerStars Game #59941791654:  Hold'em No Limit ($0.10/$0.25) - 2009/07/01 1:46:17 ET
Table 'edvgY2YQ1I34euq4EVqGnA' 6-max Seat #3 is the button
Seat 1: mvFHK3pE7tCxJEqLjKC70Q ($25.25 in chips) 
Seat 2: Hsvkc0/G2VV78oVmWYXecw ($5 in chips) 
Seat 3: mFv3iBCtrw9XfCDRB0d46Q ($3.20 in chips) 
Seat 4: TI/C5Q+DEl4fLR3AofwYdg ($22.25 in chips) 
Seat 5: EE16Ua5b1HSsYej5zeXOlA ($57.10 in chips) 
Seat 6: kG34n23qFQA3nzdOJTQ1dA ($71.35 in chips) 
TI/C5Q+DEl4fLR3AofwYdg: posts small blind $0.10
EE16Ua5b1HSsYej5zeXOlA: posts big blind $0.25
*** HOLE CARDS ***
kG34n23qFQA3nzdOJTQ1dA: folds 
mvFHK3pE7tCxJEqLjKC70Q: calls $0.25
Hsvkc0/G2VV78oVmWYXecw: folds 
mFv3iBCtrw9XfCDRB0d46Q: folds 
TI/C5Q+DEl4fLR3AofwYdg: raises $0.75 to $1
EE16Ua5b1HSsYej5zeXOlA: folds 
mvFHK3pE7tCxJEqLjKC70Q: calls $0.75
*** FLOP *** [2c Kd Th]
TI/C5Q+DEl4fLR3AofwYdg: bets $1.75
mvFHK3pE7tCxJEqLjKC70Q: folds 
Uncalled bet ($1.75) returned to TI/C5Q+DEl4fLR3AofwYdg
TI/C5Q+DEl4fLR3AofwYdg collected $2.15 from pot
TI/C5Q+DEl4fLR3AofwYdg: doesn't show hand 
*** SUMMARY ***
Total pot $2.25 | Rake $0.10 
Board [2c Kd Th]
Seat 1: mvFHK3pE7tCxJEqLjKC70Q folded on the Flop
Seat 2: Hsvkc0/G2VV78oVmWYXecw folded before Flop (didn't bet)
Seat 3: mFv3iBCtrw9XfCDRB0d46Q (button) folded before Flop (didn't bet)
Seat 4: TI/C5Q+DEl4fLR3AofwYdg (small blind) collected ($2.15)
Seat 5: EE16Ua5b1HSsYej5zeXOlA (big blind) folded before Flop
Seat 6: kG34n23qFQA3nzdOJTQ1dA folded before Flop (didn't bet)




PokerStars Game #59941792006:  Hold'em No Limit ($0.10/$0.25) - 2009/07/01 1:46:17 ET
Table 'UVjmXTtsmlX1HxwwZ59akg' 9-max Seat #6 is the button
Seat 2: q+Qdg0Hoir+SyL7haBrUnw ($7.80 in chips) 
Seat 3: GmzfAfxcxu1kGbPC+9LkVg ($24.65 in chips) 
Seat 4: X78b5v/uhqeXXoAijbw/yg ($25 in chips) 
Seat 5: Bb42QRQMhg5/Y0vHP8/2Xw ($39.95 in chips) 
Seat 6: st9jtdNbm1W5GfBwRaCVqQ ($27.60 in chips) 
Seat 9: ljemhp25Zg+nlA9DLCIiUw ($24.75 in chips) 
d7YasxuGLPiL7pj8IcGThw joins the table at seat #7 
ljemhp25Zg+nlA9DLCIiUw: posts small blind $0.10
q+Qdg0Hoir+SyL7haBrUnw: posts big blind $0.25
*** HOLE CARDS ***
GmzfAfxcxu1kGbPC+9LkVg: folds 
X78b5v/uhqeXXoAijbw/yg: folds 
Bb42QRQMhg5/Y0vHP8/2Xw: folds 
st9jtdNbm1W5GfBwRaCVqQ: folds 
ljemhp25Zg+nlA9DLCIiUw: folds 
Uncalled bet ($0.15) returned to q+Qdg0Hoir+SyL7haBrUnw
q+Qdg0Hoir+SyL7haBrUnw collected $0.20 from pot
zDrucyjVn5aeekNEc3cJrA has returned
q+Qdg0Hoir+SyL7haBrUnw: doesn't show hand 
*** SUMMARY ***
Total pot $0.20 | Rake $0 
Seat 2: q+Qdg0Hoir+SyL7haBrUnw (big blind) collected ($0.20)
Seat 3: GmzfAfxcxu1kGbPC+9LkVg folded before Flop (didn't bet)
Seat 4: X78b5v/uhqeXXoAijbw/yg folded before Flop (didn't bet)
Seat 5: Bb42QRQMhg5/Y0vHP8/2Xw folded before Flop (didn't bet)
Seat 6: st9jtdNbm1W5GfBwRaCVqQ (button) folded before Flop (didn't bet)
Seat 9: ljemhp25Zg+nlA9DLCIiUw (small blind) folded before Flop




PokerStars Game #59941791672:  Hold'em No Limit ($0.10/$0.25) - 2009/07/01 1:46:17 ET
Table 'aisAlB9GIV21BwfUW3+Nbg' 9-max Seat #3 is the button
Seat 1: SqibpGx+lf+brY0fJVvD0w ($24.30 in chips) 
Seat 3: CvL9Ch1HYCVbTsfpNucitg ($4.55 in chips) 
Seat 4: sD+TKtt36XiiN6jqHiLwDA ($25.20 in chips) 
Seat 5: ghNKXUBl/H+t83JF079ZBA ($25 in chips) 
Seat 6: 9gmYYQesalMrUjaF7nKfrQ ($16.20 in chips) 
Seat 7: jGjM+5lCSe6f2MEwxQGOAg ($24.60 in chips) 
Seat 8: VWUWpMLMj/Q1jRVpF7Aohw ($26.30 in chips) 
Seat 9: N0hGpTAEAj9k5msS6LPLAw ($22.10 in chips) 
sD+TKtt36XiiN6jqHiLwDA: posts small blind $0.10
ghNKXUBl/H+t83JF079ZBA: posts big blind $0.25
*** HOLE CARDS ***
9gmYYQesalMrUjaF7nKfrQ: folds 
jGjM+5lCSe6f2MEwxQGOAg: raises $0.25 to $0.50
Z9AeOQX3yzuSvKAm/xyovg joins the table at seat #2 
VWUWpMLMj/Q1jRVpF7Aohw has timed out
VWUWpMLMj/Q1jRVpF7Aohw: folds 
VWUWpMLMj/Q1jRVpF7Aohw is sitting out
N0hGpTAEAj9k5msS6LPLAw: folds 
SqibpGx+lf+brY0fJVvD0w: folds 
CvL9Ch1HYCVbTsfpNucitg: folds 
sD+TKtt36XiiN6jqHiLwDA: folds 
VWUWpMLMj/Q1jRVpF7Aohw has returned
ghNKXUBl/H+t83JF079ZBA: calls $0.25
*** FLOP *** [8s 7c Ac]
ghNKXUBl/H+t83JF079ZBA: checks 
jGjM+5lCSe6f2MEwxQGOAg: bets $0.50
ghNKXUBl/H+t83JF079ZBA: calls $0.50
*** TURN *** [8s 7c Ac] [9s]
ghNKXUBl/H+t83JF079ZBA: checks 
jGjM+5lCSe6f2MEwxQGOAg: checks 
*** RIVER *** [8s 7c Ac 9s] [7d]
ghNKXUBl/H+t83JF079ZBA: bets $1.50
jGjM+5lCSe6f2MEwxQGOAg: folds 
Uncalled bet ($1.50) returned to ghNKXUBl/H+t83JF079ZBA
ghNKXUBl/H+t83JF079ZBA collected $2 from pot
ghNKXUBl/H+t83JF079ZBA: doesn't show hand 
*** SUMMARY ***
Total pot $2.10 | Rake $0.10 
Board [8s 7c Ac 9s 7d]
Seat 1: SqibpGx+lf+brY0fJVvD0w folded before Flop (didn't bet)
Seat 3: CvL9Ch1HYCVbTsfpNucitg (button) folded before Flop (didn't bet)
Seat 4: sD+TKtt36XiiN6jqHiLwDA (small blind) folded before Flop
Seat 5: ghNKXUBl/H+t83JF079ZBA (big blind) collected ($2)
Seat 6: 9gmYYQesalMrUjaF7nKfrQ folded before Flop (didn't bet)
Seat 7: jGjM+5lCSe6f2MEwxQGOAg folded on the River
Seat 8: VWUWpMLMj/Q1jRVpF7Aohw folded before Flop (didn't bet)
Seat 9: N0hGpTAEAj9k5msS6LPLAw folded before Flop (didn't bet)




PokerStars Game #59941792076:  Hold'em No Limit ($0.10/$0.25) - 2009/07/01 1:46:17 ET
Table '+2VxGVfkEqJ1AYfQy/JH2w' 6-max Seat #3 is the button
Seat 1: if4dh6jhJXeN3/qd3qCp9g ($28.25 in chips) 
Seat 2: qllppsCmUqovlriIWCeM/g ($5.15 in chips) 
Seat 3: epAUIB7h2FJXzUPRIvSkRA ($25 in chips) 
Seat 4: y+a/yGW/Jy4bPJFnaeTz5w ($16.35 in chips) 
Seat 5: XD1i5m5PvBDnRzJaG/vINw ($25 in chips) 
y+a/yGW/Jy4bPJFnaeTz5w: posts small blind $0.10
XD1i5m5PvBDnRzJaG/vINw: posts big blind $0.25
*** HOLE CARDS ***
if4dh6jhJXeN3/qd3qCp9g: folds 
YQNVDzvw3TmGaFiq9MhRgA joins the table at seat #6 
qllppsCmUqovlriIWCeM/g: folds 
epAUIB7h2FJXzUPRIvSkRA: folds 
y+a/yGW/Jy4bPJFnaeTz5w: calls $0.15
XD1i5m5PvBDnRzJaG/vINw: checks 
*** FLOP *** [Js Jh Ah]
y+a/yGW/Jy4bPJFnaeTz5w: bets $0.25
XD1i5m5PvBDnRzJaG/vINw: folds 
Uncalled bet ($0.25) returned to y+a/yGW/Jy4bPJFnaeTz5w
y+a/yGW/Jy4bPJFnaeTz5w collected $0.50 from pot
y+a/yGW/Jy4bPJFnaeTz5w: doesn't show hand 
*** SUMMARY ***
Total pot $0.50 | Rake $0 
Board [Js Jh Ah]
Seat 1: if4dh6jhJXeN3/qd3qCp9g folded before Flop (didn't bet)
Seat 2: qllppsCmUqovlriIWCeM/g folded before Flop (didn't bet)
Seat 3: epAUIB7h2FJXzUPRIvSkRA (button) folded before Flop (didn't bet)
Seat 4: y+a/yGW/Jy4bPJFnaeTz5w (small blind) collected ($0.50)
Seat 5: XD1i5m5PvBDnRzJaG/vINw (big blind) folded on the Flop




PokerStars Game #59941791962:  Hold'em No Limit ($0.10/$0.25) - 2009/07/01 1:46:17 ET
Table '+giHa6FUL6U5/AZnCJEGvQ' 9-max Seat #4 is the button
Seat 4: 10f7J+bM02ZfDHx0PgkNSg ($14.05 in chips) 
Seat 6: GTMnTen6sQSoCpS9sggLbg ($25.55 in chips) 
10f7J+bM02ZfDHx0PgkNSg: posts small blind $0.10
GTMnTen6sQSoCpS9sggLbg: posts big blind $0.25
*** HOLE CARDS ***
varanasi joins the table at seat #3 
10f7J+bM02ZfDHx0PgkNSg: calls $0.15
GTMnTen6sQSoCpS9sggLbg: checks 
*** FLOP *** [7s 9d Th]
GTMnTen6sQSoCpS9sggLbg: checks 
10f7J+bM02ZfDHx0PgkNSg: bets $0.25
GTMnTen6sQSoCpS9sggLbg: calls $0.25
*** TURN *** [7s 9d Th] [Jh]
GTMnTen6sQSoCpS9sggLbg: checks 
10f7J+bM02ZfDHx0PgkNSg: checks 
*** RIVER *** [7s 9d Th Jh] [7d]
varanasi is sitting out
GTMnTen6sQSoCpS9sggLbg: checks 
varanasi leaves the table
10f7J+bM02ZfDHx0PgkNSg: checks 
*** SHOW DOWN ***
GTMnTen6sQSoCpS9sggLbg: shows [6s 2c] (a pair of Sevens)
10f7J+bM02ZfDHx0PgkNSg: shows [Ad Ac] (two pair, Aces and Sevens)
10f7J+bM02ZfDHx0PgkNSg collected $0.95 from pot
*** SUMMARY ***
Total pot $1 | Rake $0.05 
Board [7s 9d Th Jh 7d]
Seat 4: 10f7J+bM02ZfDHx0PgkNSg (button) (small blind) showed [Ad Ac] and won ($0.95) with two pair, Aces and Sevens
Seat 6: GTMnTen6sQSoCpS9sggLbg (big blind) showed [6s 2c] and lost with a pair of Sevens




PokerStars Game #59941791806:  Hold'em No Limit ($0.10/$0.25) - 2009/07/01 1:46:17 ET
Table '3eK1r4Q4BSYFvsKkuTLpIA' 9-max Seat #5 is the button
Seat 1: vSkQm2EelzwRGDDQQk0Fqw ($4.30 in chips) 
Seat 2: aNpwfA31EREwO+ar4XzBCw ($28.10 in chips) 
Seat 3: 56S3mA6Zs3pGR+0p0vUCtg ($35.85 in chips) 
Seat 4: +2kMBNpY4nF1qNCRd8SJLA ($25 in chips) 
Seat 5: 775TiRJajPtN/ucpTmHrXA ($19.55 in chips) 
Seat 6: +HvCCmsGSQeatf+GZ9zk8Q ($29.45 in chips) 
Seat 7: ljemhp25Zg+nlA9DLCIiUw ($25 in chips) 
Seat 8: /29aHLC+Q6KCDcNv2bPfAg ($12.65 in chips) 
Seat 9: +sbyWwIcFp9kP0bDtMegfQ ($60.40 in chips) 
+HvCCmsGSQeatf+GZ9zk8Q: posts small blind $0.10
ljemhp25Zg+nlA9DLCIiUw: posts big blind $0.25
*** HOLE CARDS ***
/29aHLC+Q6KCDcNv2bPfAg: calls $0.25
+sbyWwIcFp9kP0bDtMegfQ: folds 
vSkQm2EelzwRGDDQQk0Fqw: folds 
aNpwfA31EREwO+ar4XzBCw: folds 
56S3mA6Zs3pGR+0p0vUCtg: folds 
+2kMBNpY4nF1qNCRd8SJLA: folds 
775TiRJajPtN/ucpTmHrXA: calls $0.25
+HvCCmsGSQeatf+GZ9zk8Q: calls $0.15
ljemhp25Zg+nlA9DLCIiUw: checks 
*** FLOP *** [7h 7s 6h]
+HvCCmsGSQeatf+GZ9zk8Q: checks 
ljemhp25Zg+nlA9DLCIiUw: checks 
/29aHLC+Q6KCDcNv2bPfAg: checks 
775TiRJajPtN/ucpTmHrXA: checks 
*** TURN *** [7h 7s 6h] [Ac]
+HvCCmsGSQeatf+GZ9zk8Q: checks 
ljemhp25Zg+nlA9DLCIiUw: checks 
/29aHLC+Q6KCDcNv2bPfAg: checks 
775TiRJajPtN/ucpTmHrXA: bets $2.75
+HvCCmsGSQeatf+GZ9zk8Q: folds 
ljemhp25Zg+nlA9DLCIiUw: folds 
/29aHLC+Q6KCDcNv2bPfAg: calls $2.75
*** RIVER *** [7h 7s 6h Ac] [As]
/29aHLC+Q6KCDcNv2bPfAg: checks 
775TiRJajPtN/ucpTmHrXA: bets $3
/29aHLC+Q6KCDcNv2bPfAg: calls $3
*** SHOW DOWN ***
775TiRJajPtN/ucpTmHrXA: shows [Kc Jd] (two pair, Aces and Sevens)
/29aHLC+Q6KCDcNv2bPfAg: shows [3d 7d] (a full house, Sevens full of Aces)
/29aHLC+Q6KCDcNv2bPfAg collected $11.90 from pot
*** SUMMARY ***
Total pot $12.50 | Rake $0.60 
Board [7h 7s 6h Ac As]
Seat 1: vSkQm2EelzwRGDDQQk0Fqw folded before Flop (didn't bet)
Seat 2: aNpwfA31EREwO+ar4XzBCw folded before Flop (didn't bet)
Seat 3: 56S3mA6Zs3pGR+0p0vUCtg folded before Flop (didn't bet)
Seat 4: +2kMBNpY4nF1qNCRd8SJLA folded before Flop (didn't bet)
Seat 5: 775TiRJajPtN/ucpTmHrXA (button) showed [Kc Jd] and lost with two pair, Aces and Sevens
Seat 6: +HvCCmsGSQeatf+GZ9zk8Q (small blind) folded on the Turn
Seat 7: ljemhp25Zg+nlA9DLCIiUw (big blind) folded on the Turn
Seat 8: /29aHLC+Q6KCDcNv2bPfAg showed [3d 7d] and won ($11.90) with a full house, Sevens full of Aces
Seat 9: +sbyWwIcFp9kP0bDtMegfQ folded before Flop (didn't bet)




PokerStars Game #59941791678:  Hold'em No Limit ($0.10/$0.25) - 2009/07/01 1:46:17 ET
Table 'dNYnr4D4id1jwnEU66Yowg' 9-max Seat #4 is the button
Seat 1: 9lvO/qyU+xrU95Teu1fv0g ($4.40 in chips) 
Seat 2: Qduu7ikeizo6q6Ei9YvcJA ($24.65 in chips) 
Seat 3: IOx4EH8+y3jYZJc/LTRvOw ($25.75 in chips) 
Seat 4: VBHxUExRAMrbxUq/cVx9Gw ($5 in chips) 
Seat 5: 7cv+9Zc9HIQHNvYsMfV3uA ($25 in chips) 
Seat 6: 8EbrQ/EvFWt2cr0GaU82gQ ($4.65 in chips) 
Seat 7: DiSvPC2iudwL5j9u6Huyww ($25 in chips) 
Seat 8: RCqMONFrSPSArZh2Jsar/w ($34.10 in chips) 
Seat 9: /FE4MKSoQhXaDp4PBoLM2g ($14.85 in chips) 
7cv+9Zc9HIQHNvYsMfV3uA: posts small blind $0.10
8EbrQ/EvFWt2cr0GaU82gQ: posts big blind $0.25
*** HOLE CARDS ***
DiSvPC2iudwL5j9u6Huyww: folds 
RCqMONFrSPSArZh2Jsar/w: folds 
/FE4MKSoQhXaDp4PBoLM2g: calls $0.25
9lvO/qyU+xrU95Teu1fv0g: folds 
Qduu7ikeizo6q6Ei9YvcJA: folds 
IOx4EH8+y3jYZJc/LTRvOw: folds 
VBHxUExRAMrbxUq/cVx9Gw: folds 
7cv+9Zc9HIQHNvYsMfV3uA: calls $0.15
8EbrQ/EvFWt2cr0GaU82gQ: checks 
*** FLOP *** [5c 7c Th]
7cv+9Zc9HIQHNvYsMfV3uA: bets $0.50
8EbrQ/EvFWt2cr0GaU82gQ: folds 
/FE4MKSoQhXaDp4PBoLM2g: calls $0.50
*** TURN *** [5c 7c Th] [Ts]
7cv+9Zc9HIQHNvYsMfV3uA: bets $1.25
/FE4MKSoQhXaDp4PBoLM2g: calls $1.25
*** RIVER *** [5c 7c Th Ts] [Ah]
7cv+9Zc9HIQHNvYsMfV3uA: bets $2.75
/FE4MKSoQhXaDp4PBoLM2g: folds 
Uncalled bet ($2.75) returned to 7cv+9Zc9HIQHNvYsMfV3uA
7cv+9Zc9HIQHNvYsMfV3uA collected $4.05 from pot
7cv+9Zc9HIQHNvYsMfV3uA: doesn't show hand 
*** SUMMARY ***
Total pot $4.25 | Rake $0.20 
Board [5c 7c Th Ts Ah]
Seat 1: 9lvO/qyU+xrU95Teu1fv0g folded before Flop (didn't bet)
Seat 2: Qduu7ikeizo6q6Ei9YvcJA folded before Flop (didn't bet)
Seat 3: IOx4EH8+y3jYZJc/LTRvOw folded before Flop (didn't bet)
Seat 4: VBHxUExRAMrbxUq/cVx9Gw (button) folded before Flop (didn't bet)
Seat 5: 7cv+9Zc9HIQHNvYsMfV3uA (small blind) collected ($4.05)
Seat 6: 8EbrQ/EvFWt2cr0GaU82gQ (big blind) folded on the Flop
Seat 7: DiSvPC2iudwL5j9u6Huyww folded before Flop (didn't bet)
Seat 8: RCqMONFrSPSArZh2Jsar/w folded before Flop (didn't bet)
Seat 9: /FE4MKSoQhXaDp4PBoLM2g folded on the River




PokerStars Game #59941791948:  Hold'em No Limit ($0.10/$0.25) - 2009/07/01 1:46:17 ET
Table '+fuYjvJy9okLr23QyZtanA' 9-max Seat #3 is the button
Seat 1: l9hUFnOCgg4TPYga9bvxhw ($10.70 in chips) 
Seat 2: tLcDklc2rBORNfixyRfVfw ($25 in chips) 
Seat 3: eK8qa6EPcH2zhtbmWSvc9g ($52.30 in chips) 
Seat 4: Bb42QRQMhg5/Y0vHP8/2Xw ($30.25 in chips) 
Seat 5: bXpVeaSTPBFSPJmeXxO7nw ($4.65 in chips) 
Seat 6: wGigCmBR/9XWkPpvYos3aQ ($30.20 in chips) 
Seat 7: dfNim92Z6XK1/h5SFW5vDg ($26.55 in chips) 
Seat 8: KqS/lY/fNB9qUxokm9QfeA ($9.25 in chips) 
Seat 9: OMhlmt2waO3z43ZSFNMmog ($30.95 in chips) 
Bb42QRQMhg5/Y0vHP8/2Xw: posts small blind $0.10
bXpVeaSTPBFSPJmeXxO7nw: posts big blind $0.25
*** HOLE CARDS ***
wGigCmBR/9XWkPpvYos3aQ: folds 
dfNim92Z6XK1/h5SFW5vDg: raises $0.75 to $1
KqS/lY/fNB9qUxokm9QfeA: folds 
OMhlmt2waO3z43ZSFNMmog: calls $1
l9hUFnOCgg4TPYga9bvxhw: raises $1 to $2
tLcDklc2rBORNfixyRfVfw: folds 
eK8qa6EPcH2zhtbmWSvc9g: folds 
Bb42QRQMhg5/Y0vHP8/2Xw: folds 
bXpVeaSTPBFSPJmeXxO7nw: folds 
dfNim92Z6XK1/h5SFW5vDg: raises $3.75 to $5.75
OMhlmt2waO3z43ZSFNMmog: folds 
l9hUFnOCgg4TPYga9bvxhw: raises $4.95 to $10.70 and is all-in
dfNim92Z6XK1/h5SFW5vDg: calls $4.95
*** FLOP *** [Ts 3d 6c]
*** TURN *** [Ts 3d 6c] [6d]
*** RIVER *** [Ts 3d 6c 6d] [8h]
*** SHOW DOWN ***
dfNim92Z6XK1/h5SFW5vDg: shows [Kd Kh] (two pair, Kings and Sixes)
l9hUFnOCgg4TPYga9bvxhw: mucks hand 
dfNim92Z6XK1/h5SFW5vDg collected $21.65 from pot
*** SUMMARY ***
Total pot $22.75 | Rake $1.10 
Board [Ts 3d 6c 6d 8h]
Seat 1: l9hUFnOCgg4TPYga9bvxhw mucked
Seat 2: tLcDklc2rBORNfixyRfVfw folded before Flop (didn't bet)
Seat 3: eK8qa6EPcH2zhtbmWSvc9g (button) folded before Flop (didn't bet)
Seat 4: Bb42QRQMhg5/Y0vHP8/2Xw (small blind) folded before Flop
Seat 5: bXpVeaSTPBFSPJmeXxO7nw (big blind) folded before Flop
Seat 6: wGigCmBR/9XWkPpvYos3aQ folded before Flop (didn't bet)
Seat 7: dfNim92Z6XK1/h5SFW5vDg showed [Kd Kh] and won ($21.65) with two pair, Kings and Sixes
Seat 8: KqS/lY/fNB9qUxokm9QfeA folded before Flop (didn't bet)
Seat 9: OMhlmt2waO3z43ZSFNMmog folded before Flop




PokerStars Game #59941792460:  Hold'em No Limit ($0.10/$0.25) - 2009/07/01 1:46:18 ET
Table 'BmUMTVcNATeov2rAGYU0Qg' 9-max Seat #3 is the button
Seat 1: QEbIGci+itdw+re8RM5fZA ($33.60 in chips) 
Seat 2: jJnMGXoBXye+afMd0k0rUw ($11.65 in chips) 
Seat 3: ir5Jy8ck6DrdqgJ/3chcWw ($9.80 in chips) 
Seat 4: aNpwfA31EREwO+ar4XzBCw ($37.60 in chips) 
Seat 5: QBNcj9fHxkh/+s/oVw+JmQ ($23.60 in chips) 
Seat 6: w1ukf8uPa4+WH561TtVRxA ($25 in chips) 
Seat 7: CmngQmkKTp8tkl6GMRTl6w ($8.50 in chips) 
Seat 9: /artgaAtyUtUtD8FZo6puA ($9.60 in chips) 
aNpwfA31EREwO+ar4XzBCw: posts small blind $0.10
QBNcj9fHxkh/+s/oVw+JmQ: posts big blind $0.25
razor365: sits out 
*** HOLE CARDS ***
w1ukf8uPa4+WH561TtVRxA has timed out
w1ukf8uPa4+WH561TtVRxA: folds 
w1ukf8uPa4+WH561TtVRxA is sitting out
CmngQmkKTp8tkl6GMRTl6w: folds 
/artgaAtyUtUtD8FZo6puA: calls $0.25
w1ukf8uPa4+WH561TtVRxA has returned
QEbIGci+itdw+re8RM5fZA: folds 
jJnMGXoBXye+afMd0k0rUw: folds 
ir5Jy8ck6DrdqgJ/3chcWw: folds 
aNpwfA31EREwO+ar4XzBCw: calls $0.15
QBNcj9fHxkh/+s/oVw+JmQ: checks 
*** FLOP *** [7c 4d Jh]
aNpwfA31EREwO+ar4XzBCw: checks 
QBNcj9fHxkh/+s/oVw+JmQ: bets $0.50
/artgaAtyUtUtD8FZo6puA: folds 
aNpwfA31EREwO+ar4XzBCw: folds 
Uncalled bet ($0.50) returned to QBNcj9fHxkh/+s/oVw+JmQ
QBNcj9fHxkh/+s/oVw+JmQ collected $0.75 from pot
QBNcj9fHxkh/+s/oVw+JmQ: doesn't show hand 
*** SUMMARY ***
Total pot $0.75 | Rake $0 
Board [7c 4d Jh]
Seat 1: QEbIGci+itdw+re8RM5fZA folded before Flop (didn't bet)
Seat 2: jJnMGXoBXye+afMd0k0rUw folded before Flop (didn't bet)
Seat 3: ir5Jy8ck6DrdqgJ/3chcWw (button) folded before Flop (didn't bet)
Seat 4: aNpwfA31EREwO+ar4XzBCw (small blind) folded on the Flop
Seat 5: QBNcj9fHxkh/+s/oVw+JmQ (big blind) collected ($0.75)
Seat 6: w1ukf8uPa4+WH561TtVRxA folded before Flop (didn't bet)
Seat 7: CmngQmkKTp8tkl6GMRTl6w folded before Flop (didn't bet)
Seat 9: /artgaAtyUtUtD8FZo6puA folded on the Flop




PokerStars Game #59941792608:  Hold'em No Limit ($0.10/$0.25) - 2009/07/01 1:46:18 ET
Table 'fIMYcWwN4/aXFJvH5Z8Ymg' 6-max Seat #2 is the button
Seat 1: DihMHaz4WNETH1bPDe13kA ($25 in chips) 
Seat 2: Mhj3q7cxev+XjXZxEE6/Cw ($25.25 in chips) 
Seat 3: 9bpVv1/Qh9IYtXuCtl5VtQ ($24.75 in chips) 
Seat 5: lquriepNQBhDV5P1SWHhnA ($25.70 in chips) 
Seat 6: jp34e617tIzV8tKIWmfAbA ($28.70 in chips) 
9bpVv1/Qh9IYtXuCtl5VtQ: posts small blind $0.10
32YL2ZEp8NT4JB2RVM9euQ: is sitting out 
lquriepNQBhDV5P1SWHhnA: posts big blind $0.25
*** HOLE CARDS ***
32YL2ZEp8NT4JB2RVM9euQ leaves the table
jp34e617tIzV8tKIWmfAbA: folds 
DihMHaz4WNETH1bPDe13kA: folds 
Mhj3q7cxev+XjXZxEE6/Cw: raises $0.50 to $0.75
7cx44/slbeTw+Cy7QB8Trg joins the table at seat #4 
9bpVv1/Qh9IYtXuCtl5VtQ: folds 
lquriepNQBhDV5P1SWHhnA: folds 
Uncalled bet ($0.50) returned to Mhj3q7cxev+XjXZxEE6/Cw
Mhj3q7cxev+XjXZxEE6/Cw collected $0.60 from pot
Mhj3q7cxev+XjXZxEE6/Cw: doesn't show hand 
*** SUMMARY ***
Total pot $0.60 | Rake $0 
Seat 1: DihMHaz4WNETH1bPDe13kA folded before Flop (didn't bet)
Seat 2: Mhj3q7cxev+XjXZxEE6/Cw (button) collected ($0.60)
Seat 3: 9bpVv1/Qh9IYtXuCtl5VtQ (small blind) folded before Flop
Seat 5: lquriepNQBhDV5P1SWHhnA (big blind) folded before Flop
Seat 6: jp34e617tIzV8tKIWmfAbA folded before Flop (didn't bet)




PokerStars Game #59941792374:  Hold'em No Limit ($0.10/$0.25) - 2009/07/01 1:46:18 ET
Table 'hfHe8uKeSJMyWAjSdM7ROQMRfAiS/4JSfnUDlCcZo0wAx Seat #4 is the button
Seat 1: 48oT5xFI+5CHUJlfoGrE4w ($29.90 in chips) 
Seat 2: /gJNBeCkWL4o85/jvlZ4BA ($29.35 in chips) 
Seat 3: FYepjhAvF8ZdVCmqHIy+eQ ($38.70 in chips) 
Seat 4: b4wRQV3APH8irVk6bUFe2Q ($36.95 in chips) 
48oT5xFI+5CHUJlfoGrE4w: posts small blind $0.10
/gJNBeCkWL4o85/jvlZ4BA: posts big blind $0.25
*** HOLE CARDS ***
FYepjhAvF8ZdVCmqHIy+eQ: folds 
b4wRQV3APH8irVk6bUFe2Q: folds 
48oT5xFI+5CHUJlfoGrE4w: calls $0.15
/gJNBeCkWL4o85/jvlZ4BA: checks 
*** FLOP *** [4d Kd 9c]
48oT5xFI+5CHUJlfoGrE4w: bets $0.50
/gJNBeCkWL4o85/jvlZ4BA: folds 
Uncalled bet ($0.50) returned to 48oT5xFI+5CHUJlfoGrE4w
48oT5xFI+5CHUJlfoGrE4w collected $0.50 from pot
48oT5xFI+5CHUJlfoGrE4w: doesn't show hand 
*** SUMMARY ***
Total pot $0.50 | Rake $0 
Board [4d Kd 9c]
Seat 1: 48oT5xFI+5CHUJlfoGrE4w (small blind) collected ($0.50)
Seat 2: /gJNBeCkWL4o85/jvlZ4BA (big blind) folded on the Flop
Seat 3: FYepjhAvF8ZdVCmqHIy+eQ folded before Flop (didn't bet)
Seat 4: b4wRQV3APH8irVk6bUFe2Q (button) folded before Flop (didn't bet)




PokerStars Game #59941792908:  Hold'em No Limit ($0.10/$0.25) - 2009/07/01 1:46:19 ET
Table 'P2yJ+jwfNsBdF12fLKA6DQ' 9-max Seat #8 is the button
Seat 1: zDrucyjVn5aeekNEc3cJrA ($22.35 in chips) 
Seat 2: uQwmfH5LEVA5eyghJdyPUg ($10.40 in chips) 
Seat 4: 6NLAWFPZZfqlVkY8n9RULA ($14 in chips) 
Seat 5: B7VAFAMs/PYlYABlV+EkSA ($7.45 in chips) 
Seat 6: mUoFJKqCzIUABvOFbiINlQ ($14.25 in chips) 
Seat 7: yQc5nLaNmByxI15Jegu61w ($18.15 in chips) 
Seat 8: LMd3gq2uNfbWTfXTnSeQRw ($9.30 in chips) 
Seat 9: dN5zq7QdZCUe7NZFM6cECg ($18.25 in chips) 
dN5zq7QdZCUe7NZFM6cECg: posts small blind $0.10
zDrucyjVn5aeekNEc3cJrA: posts big blind $0.25
8EbrQ/EvFWt2cr0GaU82gQ: sits out 
*** HOLE CARDS ***
uQwmfH5LEVA5eyghJdyPUg: folds 
6NLAWFPZZfqlVkY8n9RULA: folds 
B7VAFAMs/PYlYABlV+EkSA: folds 
mUoFJKqCzIUABvOFbiINlQ: folds 
yQc5nLaNmByxI15Jegu61w: folds 
LMd3gq2uNfbWTfXTnSeQRw: folds 
dN5zq7QdZCUe7NZFM6cECg: raises $0.75 to $1
zDrucyjVn5aeekNEc3cJrA: calls $0.75
*** FLOP *** [Ts 2h 5s]
dN5zq7QdZCUe7NZFM6cECg: bets $1.50
zDrucyjVn5aeekNEc3cJrA: folds 
Uncalled bet ($1.50) returned to dN5zq7QdZCUe7NZFM6cECg
dN5zq7QdZCUe7NZFM6cECg collected $1.90 from pot
dN5zq7QdZCUe7NZFM6cECg: doesn't show hand 
*** SUMMARY ***
Total pot $2 | Rake $0.10 
Board [Ts 2h 5s]
Seat 1: zDrucyjVn5aeekNEc3cJrA (big blind) folded on the Flop
Seat 2: uQwmfH5LEVA5eyghJdyPUg folded before Flop (didn't bet)
Seat 4: 6NLAWFPZZfqlVkY8n9RULA folded before Flop (didn't bet)
Seat 5: B7VAFAMs/PYlYABlV+EkSA folded before Flop (didn't bet)
Seat 6: mUoFJKqCzIUABvOFbiINlQ folded before Flop (didn't bet)
Seat 7: yQc5nLaNmByxI15Jegu61w folded before Flop (didn't bet)
Seat 8: LMd3gq2uNfbWTfXTnSeQRw (button) folded before Flop (didn't bet)
Seat 9: dN5zq7QdZCUe7NZFM6cECg (small blind) collected ($1.90)




PokerStars Game #59941792846:  Hold'em No Limit ($0.10/$0.25) - 2009/07/01 1:46:19 ET
Table 'G26g8jde1eR+mmabeFeSlw' 9-max Seat #7 is the button
Seat 1: qpG9m8I+cPw8VhB0mnGjYw ($28.90 in chips) 
Seat 2: BFYwQ0J4xWUQvouudojivA ($15.35 in chips) 
Seat 3: WKL8nUFr7TumC4EjLyqYzw ($6.50 in chips) 
Seat 4: 8EbrQ/EvFWt2cr0GaU82gQ ($4.65 in chips) 
Seat 5: hJ4uYjNmSZdjrKA8cjZqCA ($30.45 in chips) 
Seat 6: AHGkesF/mi4sDMpqrxBUoA ($8.55 in chips) 
Seat 7: nm4Dj/f+jJEwKVsUnKh73g ($40.25 in chips) 
Seat 8: CvL9Ch1HYCVbTsfpNucitg ($5.60 in chips) 
Seat 9: VWUWpMLMj/Q1jRVpF7Aohw ($13.65 in chips) 
CvL9Ch1HYCVbTsfpNucitg: posts small blind $0.10
VWUWpMLMj/Q1jRVpF7Aohw: posts big blind $0.25
*** HOLE CARDS ***
qpG9m8I+cPw8VhB0mnGjYw: folds 
qpG9m8I+cPw8VhB0mnGjYw leaves the table
BFYwQ0J4xWUQvouudojivA: raises $0.50 to $0.75
WKL8nUFr7TumC4EjLyqYzw: folds 
wnerYvSRWT9Sm4X3ip/c8w joins the table at seat #1 
8EbrQ/EvFWt2cr0GaU82gQ: raises $1.50 to $2.25
hJ4uYjNmSZdjrKA8cjZqCA: folds 
AHGkesF/mi4sDMpqrxBUoA: folds 
nm4Dj/f+jJEwKVsUnKh73g: folds 
CvL9Ch1HYCVbTsfpNucitg: folds 
VWUWpMLMj/Q1jRVpF7Aohw: folds 
BFYwQ0J4xWUQvouudojivA: folds 
Uncalled bet ($1.50) returned to 8EbrQ/EvFWt2cr0GaU82gQ
8EbrQ/EvFWt2cr0GaU82gQ collected $1.85 from pot
8EbrQ/EvFWt2cr0GaU82gQ: doesn't show hand 
*** SUMMARY ***
Total pot $1.85 | Rake $0 
Seat 1: qpG9m8I+cPw8VhB0mnGjYw folded before Flop (didn't bet)
Seat 2: BFYwQ0J4xWUQvouudojivA folded before Flop
Seat 3: WKL8nUFr7TumC4EjLyqYzw folded before Flop (didn't bet)
Seat 4: 8EbrQ/EvFWt2cr0GaU82gQ collected ($1.85)
Seat 5: hJ4uYjNmSZdjrKA8cjZqCA folded before Flop (didn't bet)
Seat 6: AHGkesF/mi4sDMpqrxBUoA folded before Flop (didn't bet)
Seat 7: nm4Dj/f+jJEwKVsUnKh73g (button) folded before Flop (didn't bet)
Seat 8: CvL9Ch1HYCVbTsfpNucitg (small blind) folded before Flop
Seat 9: VWUWpMLMj/Q1jRVpF7Aohw (big blind) folded before Flop




PokerStars Game #59941792882:  Hold'em No Limit ($0.10/$0.25) - 2009/07/01 1:46:19 ET
Table '2O5CgfSkSwrr4PDrlZ1RLQ' 6-max Seat #3 is the button
Seat 1: 3skmHD9EOATKdUzzyHh1KA ($29.45 in chips) 
Seat 2: wqphQtauX5Qn7WRJZS1flA ($26.50 in chips) 
Seat 3: oBUDUfeUyCbZBsjxHZgSiw ($24.50 in chips) 
Seat 4: epAUIB7h2FJXzUPRIvSkRA ($25 in chips) 
Seat 5: 0av6tRNdi0Ui4f15L7gsVg ($24.25 in chips) 
Seat 6: tj9xqoqQaDaFw7u1oyZrtA ($53.45 in chips) 
epAUIB7h2FJXzUPRIvSkRA: posts small blind $0.10
0av6tRNdi0Ui4f15L7gsVg: posts big blind $0.25
*** HOLE CARDS ***
tj9xqoqQaDaFw7u1oyZrtA: calls $0.25
3skmHD9EOATKdUzzyHh1KA: folds 
wqphQtauX5Qn7WRJZS1flA: folds 
oBUDUfeUyCbZBsjxHZgSiw: raises $0.75 to $1
epAUIB7h2FJXzUPRIvSkRA: folds 
0av6tRNdi0Ui4f15L7gsVg: folds 
tj9xqoqQaDaFw7u1oyZrtA: calls $0.75
*** FLOP *** [Ad 7d 2s]
tj9xqoqQaDaFw7u1oyZrtA: checks 
oBUDUfeUyCbZBsjxHZgSiw: checks 
*** TURN *** [Ad 7d 2s] [Ac]
tj9xqoqQaDaFw7u1oyZrtA: bets $0.50
oBUDUfeUyCbZBsjxHZgSiw: calls $0.50
*** RIVER *** [Ad 7d 2s Ac] [6c]
tj9xqoqQaDaFw7u1oyZrtA: bets $1.75
oBUDUfeUyCbZBsjxHZgSiw: calls $1.75
*** SHOW DOWN ***
tj9xqoqQaDaFw7u1oyZrtA: shows [As Jh] (three of a kind, Aces)
oBUDUfeUyCbZBsjxHZgSiw: mucks hand 
tj9xqoqQaDaFw7u1oyZrtA collected $6.55 from pot
*** SUMMARY ***
Total pot $6.85 | Rake $0.30 
Board [Ad 7d 2s Ac 6c]
Seat 1: 3skmHD9EOATKdUzzyHh1KA folded before Flop (didn't bet)
Seat 2: wqphQtauX5Qn7WRJZS1flA folded before Flop (didn't bet)
Seat 3: oBUDUfeUyCbZBsjxHZgSiw (button) mucked
Seat 4: epAUIB7h2FJXzUPRIvSkRA (small blind) folded before Flop
Seat 5: 0av6tRNdi0Ui4f15L7gsVg (big blind) folded before Flop
Seat 6: tj9xqoqQaDaFw7u1oyZrtA showed [As Jh] and won ($6.55) with three of a kind, Aces




PokerStars Game #59941792934:  Hold'em No Limit ($0.10/$0.25) - 2009/07/01 1:46:19 ET
Table 'l57rayEpPtZotP9nqgSWBg' 6-max Seat #1 is the button
Seat 1: DihMHaz4WNETH1bPDe13kA ($58.70 in chips) 
Seat 2: p6adJRMXMBLr+xtQzqazIQ ($15.30 in chips) 
Seat 3: xC0kaiDYM6YTlgODL83O5A ($15 in chips) 
Seat 4: OqkdGXy1SCzuN5Q0wNlFSg ($22.60 in chips) 
Seat 5: WKJHaZPUgrpTVyLOEjLYmg ($11 in chips) 
Seat 6: IGRfskE1v9H9Bn+fz8AgNQ ($15.55 in chips) 
p6adJRMXMBLr+xtQzqazIQ: posts small blind $0.10
xC0kaiDYM6YTlgODL83O5A: posts big blind $0.25
*** HOLE CARDS ***
OqkdGXy1SCzuN5Q0wNlFSg: calls $0.25
WKJHaZPUgrpTVyLOEjLYmg: calls $0.25
IGRfskE1v9H9Bn+fz8AgNQ: folds 
DihMHaz4WNETH1bPDe13kA: folds 
p6adJRMXMBLr+xtQzqazIQ: calls $0.15
xC0kaiDYM6YTlgODL83O5A: checks 
*** FLOP *** [7h Js Qc]
p6adJRMXMBLr+xtQzqazIQ: checks 
xC0kaiDYM6YTlgODL83O5A: checks 
OqkdGXy1SCzuN5Q0wNlFSg: checks 
WKJHaZPUgrpTVyLOEjLYmg: bets $0.50
p6adJRMXMBLr+xtQzqazIQ: folds 
xC0kaiDYM6YTlgODL83O5A: calls $0.50
OqkdGXy1SCzuN5Q0wNlFSg: folds 
*** TURN *** [7h Js Qc] [5h]
xC0kaiDYM6YTlgODL83O5A: checks 
WKJHaZPUgrpTVyLOEjLYmg: bets $0.75
xC0kaiDYM6YTlgODL83O5A: folds 
Uncalled bet ($0.75) returned to WKJHaZPUgrpTVyLOEjLYmg
WKJHaZPUgrpTVyLOEjLYmg collected $1.95 from pot
*** SUMMARY ***
Total pot $2 | Rake $0.05 
Board [7h Js Qc 5h]
Seat 1: DihMHaz4WNETH1bPDe13kA (button) folded before Flop (didn't bet)
Seat 2: p6adJRMXMBLr+xtQzqazIQ (small blind) folded on the Flop
Seat 3: xC0kaiDYM6YTlgODL83O5A (big blind) folded on the Turn
Seat 4: OqkdGXy1SCzuN5Q0wNlFSg folded on the Flop
Seat 5: WKJHaZPUgrpTVyLOEjLYmg collected ($1.95)
Seat 6: IGRfskE1v9H9Bn+fz8AgNQ folded before Flop (didn't bet)




PokerStars Game #59941792806:  Hold'em No Limit ($0.10/$0.25) - 2009/07/01 1:46:19 ET
Table 'Mef6A0EMopL6WaFO5/KO9g' 6-max Seat #1 is the button
Seat 1: GbCVUNssQ7mqsPWr7J4d3w ($4.30 in chips) 
Seat 2: 8ClCHtFXGNplITm+63KB+Q ($30 in chips) 
Seat 3: Wq26opBLDGJe91GRJn2epg ($18.20 in chips) 
Seat 4: lquriepNQBhDV5P1SWHhnA ($25 in chips) 
Seat 5: DihMHaz4WNETH1bPDe13kA ($25 in chips) 
Seat 6: jp34e617tIzV8tKIWmfAbA ($33.30 in chips) 
8ClCHtFXGNplITm+63KB+Q: posts small blind $0.10
Wq26opBLDGJe91GRJn2epg: posts big blind $0.25
*** HOLE CARDS ***
lquriepNQBhDV5P1SWHhnA: folds 
DihMHaz4WNETH1bPDe13kA: folds 
jp34e617tIzV8tKIWmfAbA: raises $0.50 to $0.75
GbCVUNssQ7mqsPWr7J4d3w: raises $3.55 to $4.30 and is all-in
8ClCHtFXGNplITm+63KB+Q: folds 
Wq26opBLDGJe91GRJn2epg: folds 
jp34e617tIzV8tKIWmfAbA: calls $3.55
*** FLOP *** [Qc 5s 7c]
*** TURN *** [Qc 5s 7c] [9c]
*** RIVER *** [Qc 5s 7c 9c] [Tc]
*** SHOW DOWN ***
jp34e617tIzV8tKIWmfAbA: shows [6c 6s] (a flush, Queen high)
GbCVUNssQ7mqsPWr7J4d3w: mucks hand 
jp34e617tIzV8tKIWmfAbA collected $8.55 from pot
*** SUMMARY ***
Total pot $8.95 | Rake $0.40 
Board [Qc 5s 7c 9c Tc]
Seat 1: GbCVUNssQ7mqsPWr7J4d3w (button) mucked
Seat 2: 8ClCHtFXGNplITm+63KB+Q (small blind) folded before Flop
Seat 3: Wq26opBLDGJe91GRJn2epg (big blind) folded before Flop
Seat 4: lquriepNQBhDV5P1SWHhnA folded before Flop (didn't bet)
Seat 5: DihMHaz4WNETH1bPDe13kA folded before Flop (didn't bet)
Seat 6: jp34e617tIzV8tKIWmfAbA showed [6c 6s] and won ($8.55) with a flush, Queen high




PokerStars Game #59941792814:  Hold'em No Limit ($0.10/$0.25) - 2009/07/01 1:46:19 ET
Table '0w9m+UkNlGMNoPyQqzWk6A' 9-max Seat #7 is the button
Seat 2: tYsOBqdU1+x+yFI7zHO7hQ ($50.05 in chips) 
Seat 3: VWwtMkIjXloiX/RKh7RGWQ ($11.55 in chips) 
Seat 5: HPEB+AtKw1+C/cxU0o1ciw ($48.30 in chips) 
Seat 6: CgIo2ItZqi4o3ayVG6HanQ ($29.65 in chips) 
Seat 7: 57qrNGHDvf6GhB8zVLsAtQ ($4.45 in chips) 
Seat 9: KqS/lY/fNB9qUxokm9QfeA ($7.50 in chips) 
cZ99hugmLBj9KhTlc8nCSw will be allowed to play after the button
KqS/lY/fNB9qUxokm9QfeA: posts small blind $0.10
yoL2UPRJrmSO7wXIS4Ak4g: is sitting out 
tYsOBqdU1+x+yFI7zHO7hQ: posts big blind $0.25
*** HOLE CARDS ***
VWwtMkIjXloiX/RKh7RGWQ: calls $0.25
HPEB+AtKw1+C/cxU0o1ciw: folds 
yoL2UPRJrmSO7wXIS4Ak4g leaves the table
CgIo2ItZqi4o3ayVG6HanQ: folds 
57qrNGHDvf6GhB8zVLsAtQ: folds 
KqS/lY/fNB9qUxokm9QfeA: calls $0.15
tYsOBqdU1+x+yFI7zHO7hQ: checks 
*** FLOP *** [Qh 2d Ac]
18G4P1XstjNvItdGUITxgw joins the table at seat #1 
KqS/lY/fNB9qUxokm9QfeA: checks 
tYsOBqdU1+x+yFI7zHO7hQ: checks 
VWwtMkIjXloiX/RKh7RGWQ: bets $0.75
KqS/lY/fNB9qUxokm9QfeA: folds 
tYsOBqdU1+x+yFI7zHO7hQ: folds 
Uncalled bet ($0.75) returned to VWwtMkIjXloiX/RKh7RGWQ
VWwtMkIjXloiX/RKh7RGWQ collected $0.75 from pot
*** SUMMARY ***
Total pot $0.75 | Rake $0 
Board [Qh 2d Ac]
Seat 2: tYsOBqdU1+x+yFI7zHO7hQ (big blind) folded on the Flop
Seat 3: VWwtMkIjXloiX/RKh7RGWQ collected ($0.75)
Seat 5: HPEB+AtKw1+C/cxU0o1ciw folded before Flop (didn't bet)
Seat 6: CgIo2ItZqi4o3ayVG6HanQ folded before Flop (didn't bet)
Seat 7: 57qrNGHDvf6GhB8zVLsAtQ (button) folded before Flop (didn't bet)
Seat 9: KqS/lY/fNB9qUxokm9QfeA (small blind) folded on the Flop




PokerStars Game #59941793294:  Hold'em No Limit ($0.10/$0.25) - 2009/07/01 1:46:20 ET
Table 'IUwZ/e0bDHZPgsIWx0RnNg' 6-max Seat #5 is the button
Seat 1: V66QiVCQPofyl3a+dpPHQQ ($5.80 in chips) 
Seat 2: mvFHK3pE7tCxJEqLjKC70Q ($55.95 in chips) 
Seat 3: dOX4wnYV2sEqvDbF+8KSCw ($26.25 in chips) 
Seat 4: OIjOiBfQstWrK/RuXx7zcw ($4.45 in chips) 
Seat 5: 9bpVv1/Qh9IYtXuCtl5VtQ ($24.65 in chips) 
Seat 6: NhUN/JpAprdJeamFBgJH1w ($39 in chips) 
NhUN/JpAprdJeamFBgJH1w: posts small blind $0.10
V66QiVCQPofyl3a+dpPHQQ: posts big blind $0.25
*** HOLE CARDS ***
mvFHK3pE7tCxJEqLjKC70Q: folds 
dOX4wnYV2sEqvDbF+8KSCw: raises $0.75 to $1
OIjOiBfQstWrK/RuXx7zcw: folds 
9bpVv1/Qh9IYtXuCtl5VtQ: folds 
NhUN/JpAprdJeamFBgJH1w: folds 
V66QiVCQPofyl3a+dpPHQQ: calls $0.75
*** FLOP *** [Ah 6d 2s]
V66QiVCQPofyl3a+dpPHQQ: checks 
dOX4wnYV2sEqvDbF+8KSCw: bets $1.50
V66QiVCQPofyl3a+dpPHQQ: folds 
Uncalled bet ($1.50) returned to dOX4wnYV2sEqvDbF+8KSCw
dOX4wnYV2sEqvDbF+8KSCw collected $2 from pot
dOX4wnYV2sEqvDbF+8KSCw: doesn't show hand 
*** SUMMARY ***
Total pot $2.10 | Rake $0.10 
Board [Ah 6d 2s]
Seat 1: V66QiVCQPofyl3a+dpPHQQ (big blind) folded on the Flop
Seat 2: mvFHK3pE7tCxJEqLjKC70Q folded before Flop (didn't bet)
Seat 3: dOX4wnYV2sEqvDbF+8KSCw collected ($2)
Seat 4: OIjOiBfQstWrK/RuXx7zcw folded before Flop (didn't bet)
Seat 5: 9bpVv1/Qh9IYtXuCtl5VtQ (button) folded before Flop (didn't bet)
Seat 6: NhUN/JpAprdJeamFBgJH1w (small blind) folded before Flop




PokerStars Game #59941793698:  Hold'em No Limit ($0.10/$0.25) - 2009/07/01 1:46:20 ET
Table '5VWnrlxdjwVfMWkVS2WE7A' 6-max Seat #3 is the button
Seat 1: 82p+w3EmUaFFHuwpSeGY1w ($14.50 in chips) 
Seat 2: LJI7A1YgDM7hgh7o56+ReQ ($25.65 in chips) 
Seat 3: SFmT9ZsVopnukjvAzrxTRg ($39.60 in chips) 
Seat 4: Pb/gJ3OxOZx57fFp0MDgkg ($34.95 in chips) 
Seat 5: SgMFmwYtNvq9Y+2ZxPSiWQ ($16.10 in chips) 
Seat 6: LtASJ9OlkqGrrUKGQlpGAw ($5.25 in chips) 
Pb/gJ3OxOZx57fFp0MDgkg: posts small blind $0.10
SgMFmwYtNvq9Y+2ZxPSiWQ: posts big blind $0.25
*** HOLE CARDS ***
LtASJ9OlkqGrrUKGQlpGAw: folds 
82p+w3EmUaFFHuwpSeGY1w: folds 
LJI7A1YgDM7hgh7o56+ReQ: raises $0.75 to $1
SFmT9ZsVopnukjvAzrxTRg: calls $1
Pb/gJ3OxOZx57fFp0MDgkg: folds 
SgMFmwYtNvq9Y+2ZxPSiWQ: raises $1.25 to $2.25
LJI7A1YgDM7hgh7o56+ReQ: calls $1.25
SFmT9ZsVopnukjvAzrxTRg: calls $1.25
*** FLOP *** [Jc Jh 9c]
SgMFmwYtNvq9Y+2ZxPSiWQ: checks 
LJI7A1YgDM7hgh7o56+ReQ: bets $4.50
SFmT9ZsVopnukjvAzrxTRg: folds 
SgMFmwYtNvq9Y+2ZxPSiWQ: calls $4.50
*** TURN *** [Jc Jh 9c] [8s]
SgMFmwYtNvq9Y+2ZxPSiWQ: checks 
LJI7A1YgDM7hgh7o56+ReQ: bets $11.25
SgMFmwYtNvq9Y+2ZxPSiWQ: calls $9.35 and is all-in
Uncalled bet ($1.90) returned to LJI7A1YgDM7hgh7o56+ReQ
*** RIVER *** [Jc Jh 9c 8s] [3s]
*** SHOW DOWN ***
SgMFmwYtNvq9Y+2ZxPSiWQ: shows [Kc Kh] (two pair, Kings and Jacks)
LJI7A1YgDM7hgh7o56+ReQ: shows [Js As] (three of a kind, Jacks)
LJI7A1YgDM7hgh7o56+ReQ collected $32.90 from pot
*** SUMMARY ***
Total pot $34.55 | Rake $1.65 
Board [Jc Jh 9c 8s 3s]
Seat 1: 82p+w3EmUaFFHuwpSeGY1w folded before Flop (didn't bet)
Seat 2: LJI7A1YgDM7hgh7o56+ReQ showed [Js As] and won ($32.90) with three of a kind, Jacks
Seat 3: SFmT9ZsVopnukjvAzrxTRg (button) folded on the Flop
Seat 4: Pb/gJ3OxOZx57fFp0MDgkg (small blind) folded before Flop
Seat 5: SgMFmwYtNvq9Y+2ZxPSiWQ (big blind) showed [Kc Kh] and lost with two pair, Kings and Jacks
Seat 6: LtASJ9OlkqGrrUKGQlpGAw folded before Flop (didn't bet)




PokerStars Game #59941793374:  Hold'em No Limit ($0.10/$0.25) - 2009/07/01 1:46:20 ET
Table 'VQNfcI8vTBCTvRfd3veTLQ' 6-max Seat #4 is the button
Seat 1: QiL+lEgEWwy21jk/ltaRLg ($15.10 in chips) 
Seat 2: 79ID/ub1Pt/mDpCprVmOoA ($30.55 in chips) 
Seat 3: LtASJ9OlkqGrrUKGQlpGAw ($11.25 in chips) 
Seat 4: QIWnfLSqfMcoFfdDe5LZPg ($38.90 in chips) 
Seat 5: gX2vbKwS/8zZPENAWB7hxQ ($26.25 in chips) 
Seat 6: LJI7A1YgDM7hgh7o56+ReQ ($27.70 in chips) 
gX2vbKwS/8zZPENAWB7hxQ: posts small blind $0.10
LJI7A1YgDM7hgh7o56+ReQ: posts big blind $0.25
*** HOLE CARDS ***
QiL+lEgEWwy21jk/ltaRLg: calls $0.25
79ID/ub1Pt/mDpCprVmOoA: folds 
LtASJ9OlkqGrrUKGQlpGAw: folds 
QIWnfLSqfMcoFfdDe5LZPg: folds 
gX2vbKwS/8zZPENAWB7hxQ: raises $1 to $1.25
LJI7A1YgDM7hgh7o56+ReQ: folds 
QiL+lEgEWwy21jk/ltaRLg: calls $1
*** FLOP *** [5s 8h Js]
gX2vbKwS/8zZPENAWB7hxQ: checks 
QiL+lEgEWwy21jk/ltaRLg: checks 
*** TURN *** [5s 8h Js] [3h]
gX2vbKwS/8zZPENAWB7hxQ: bets $2.25
QiL+lEgEWwy21jk/ltaRLg: folds 
Uncalled bet ($2.25) returned to gX2vbKwS/8zZPENAWB7hxQ
gX2vbKwS/8zZPENAWB7hxQ collected $2.65 from pot
*** SUMMARY ***
Total pot $2.75 | Rake $0.10 
Board [5s 8h Js 3h]
Seat 1: QiL+lEgEWwy21jk/ltaRLg folded on the Turn
Seat 2: 79ID/ub1Pt/mDpCprVmOoA folded before Flop (didn't bet)
Seat 3: LtASJ9OlkqGrrUKGQlpGAw folded before Flop (didn't bet)
Seat 4: QIWnfLSqfMcoFfdDe5LZPg (button) folded before Flop (didn't bet)
Seat 5: gX2vbKwS/8zZPENAWB7hxQ (small blind) collected ($2.65)
Seat 6: LJI7A1YgDM7hgh7o56+ReQ (big blind) folded before Flop




PokerStars Game #59941793262:  Hold'em No Limit ($0.10/$0.25) - 2009/07/01 1:46:20 ET
Table 'ROYvQOMwUrvL3SOiHYcrWg' 9-max Seat #9 is the button
Seat 1: 22dIObOuor/A+IKWkNoAlA ($5.50 in chips) 
Seat 2: gehe91e0IyVT0QU/XBkEyg ($24.90 in chips) 
Seat 3: 8EbrQ/EvFWt2cr0GaU82gQ ($4.65 in chips) 
Seat 4: SHegmCn8B0InbWE/zFlvOw ($21.70 in chips) 
Seat 5: 7je+LC5Mfs6nL8YBVh4frQ ($5 in chips) 
Seat 6: P+9ymZQ3ktpQu1bn7HIjew ($20.50 in chips) 
Seat 7: tYsOBqdU1+x+yFI7zHO7hQ ($25 in chips) 
Seat 8: biJWLZ27fafNeBI2oT1KJw ($28.15 in chips) 
Seat 9: uhrboV251dcgYniYTdFIcA ($25 in chips) 
22dIObOuor/A+IKWkNoAlA: posts small blind $0.10
gehe91e0IyVT0QU/XBkEyg: posts big blind $0.25
*** HOLE CARDS ***
8EbrQ/EvFWt2cr0GaU82gQ: folds 
SHegmCn8B0InbWE/zFlvOw: folds 
7je+LC5Mfs6nL8YBVh4frQ: folds 
P+9ymZQ3ktpQu1bn7HIjew: folds 
tYsOBqdU1+x+yFI7zHO7hQ: folds 
biJWLZ27fafNeBI2oT1KJw: folds 
uhrboV251dcgYniYTdFIcA: calls $0.25
22dIObOuor/A+IKWkNoAlA: folds 
gehe91e0IyVT0QU/XBkEyg: checks 
*** FLOP *** [4s 7h Tc]
gehe91e0IyVT0QU/XBkEyg: checks 
uhrboV251dcgYniYTdFIcA: checks 
*** TURN *** [4s 7h Tc] [6d]
gehe91e0IyVT0QU/XBkEyg: bets $0.50
uhrboV251dcgYniYTdFIcA: folds 
Uncalled bet ($0.50) returned to gehe91e0IyVT0QU/XBkEyg
gehe91e0IyVT0QU/XBkEyg collected $0.60 from pot
*** SUMMARY ***
Total pot $0.60 | Rake $0 
Board [4s 7h Tc 6d]
Seat 1: 22dIObOuor/A+IKWkNoAlA (small blind) folded before Flop
Seat 2: gehe91e0IyVT0QU/XBkEyg (big blind) collected ($0.60)
Seat 3: 8EbrQ/EvFWt2cr0GaU82gQ folded before Flop (didn't bet)
Seat 4: SHegmCn8B0InbWE/zFlvOw folded before Flop (didn't bet)
Seat 5: 7je+LC5Mfs6nL8YBVh4frQ folded before Flop (didn't bet)
Seat 6: P+9ymZQ3ktpQu1bn7HIjew folded before Flop (didn't bet)
Seat 7: tYsOBqdU1+x+yFI7zHO7hQ folded before Flop (didn't bet)
Seat 8: biJWLZ27fafNeBI2oT1KJw folded before Flop (didn't bet)
Seat 9: uhrboV251dcgYniYTdFIcA (button) folded on the Turn




PokerStars Game #59941793312:  Hold'em No Limit ($0.10/$0.25) - 2009/07/01 1:46:20 ET
Table 'FBhJjLqab11/gKu8nyB/tw' 9-max Seat #7 is the button
Seat 1: +sbyWwIcFp9kP0bDtMegfQ ($18.10 in chips) 
Seat 2: 1pwQJV/Xr0GWPRefx/78VQ ($26 in chips) 
Seat 3: V6p0jQ/RhUsqpHLmXvEX4Q ($9.35 in chips) 
Seat 4: CvL9Ch1HYCVbTsfpNucitg ($5.50 in chips) 
Seat 5: Mh2r9hTeTEDnh19sRZtW3g ($4.65 in chips) 
Seat 6: cZ99hugmLBj9KhTlc8nCSw ($25 in chips) 
Seat 7: CT7Xj/V/O5rBlhtt+RZeFQ ($25 in chips) 
Seat 8: Th3FldXKQW6hWVVPahaoOQ ($27.35 in chips) 
H5Se03ZqSX7tbULXur2MAg joins the table at seat #9 
Th3FldXKQW6hWVVPahaoOQ: posts small blind $0.10
+sbyWwIcFp9kP0bDtMegfQ: posts big blind $0.25
*** HOLE CARDS ***
1pwQJV/Xr0GWPRefx/78VQ: calls $0.25
V6p0jQ/RhUsqpHLmXvEX4Q: folds 
CvL9Ch1HYCVbTsfpNucitg: folds 
Mh2r9hTeTEDnh19sRZtW3g: folds 
cZ99hugmLBj9KhTlc8nCSw: raises $0.75 to $1
CT7Xj/V/O5rBlhtt+RZeFQ: raises $1.25 to $2.25
Th3FldXKQW6hWVVPahaoOQ: folds 
+sbyWwIcFp9kP0bDtMegfQ: folds 
1pwQJV/Xr0GWPRefx/78VQ: calls $2
cZ99hugmLBj9KhTlc8nCSw: calls $1.25
*** FLOP *** [9s 8d 5h]
1pwQJV/Xr0GWPRefx/78VQ: checks 
cZ99hugmLBj9KhTlc8nCSw: checks 
CT7Xj/V/O5rBlhtt+RZeFQ: checks 
*** TURN *** [9s 8d 5h] [8c]
1pwQJV/Xr0GWPRefx/78VQ: bets $2
cZ99hugmLBj9KhTlc8nCSw: raises $4 to $6
CT7Xj/V/O5rBlhtt+RZeFQ: folds 
1pwQJV/Xr0GWPRefx/78VQ: folds 
Uncalled bet ($4) returned to cZ99hugmLBj9KhTlc8nCSw
cZ99hugmLBj9KhTlc8nCSw collected $10.60 from pot
*** SUMMARY ***
Total pot $11.10 | Rake $0.50 
Board [9s 8d 5h 8c]
Seat 1: +sbyWwIcFp9kP0bDtMegfQ (big blind) folded before Flop
Seat 2: 1pwQJV/Xr0GWPRefx/78VQ folded on the Turn
Seat 3: V6p0jQ/RhUsqpHLmXvEX4Q folded before Flop (didn't bet)
Seat 4: CvL9Ch1HYCVbTsfpNucitg folded before Flop (didn't bet)
Seat 5: Mh2r9hTeTEDnh19sRZtW3g folded before Flop (didn't bet)
Seat 6: cZ99hugmLBj9KhTlc8nCSw collected ($10.60)
Seat 7: CT7Xj/V/O5rBlhtt+RZeFQ (button) folded on the Turn
Seat 8: Th3FldXKQW6hWVVPahaoOQ (small blind) folded before Flop




PokerStars Game #59941793470:  Hold'em No Limit ($0.10/$0.25) - 2009/07/01 1:46:20 ET
Table 'G+4ZdyRoPjgaJY/jxSlZzQ' 9-max Seat #2 is the button
Seat 1: ghNKXUBl/H+t83JF079ZBA ($23.40 in chips) 
Seat 2: CT7Xj/V/O5rBlhtt+RZeFQ ($25 in chips) 
Seat 3: FaGtAm5QUVcixGhAKIvbLg ($13.85 in chips) 
Seat 4: 3PmVnC/15cl4oyI1TKIt4g ($5 in chips) 
Seat 5: BT6Oal0iO4P6kDuT7HFQDw ($16.50 in chips) 
Seat 6: oFwaTjy3ok/+qFghsrcGvg ($23.05 in chips) 
Seat 8: bXpVeaSTPBFSPJmeXxO7nw ($4.65 in chips) 
Seat 9: tLcDklc2rBORNfixyRfVfw ($26.50 in chips) 
FaGtAm5QUVcixGhAKIvbLg: posts small blind $0.10
3PmVnC/15cl4oyI1TKIt4g: posts big blind $0.25
qwr38jl5txoR36M7G5qi4A: sits out 
*** HOLE CARDS ***
BT6Oal0iO4P6kDuT7HFQDw: folds 
oFwaTjy3ok/+qFghsrcGvg: folds 
bXpVeaSTPBFSPJmeXxO7nw: folds 
tLcDklc2rBORNfixyRfVfw: folds 
ghNKXUBl/H+t83JF079ZBA: raises $0.50 to $0.75
CT7Xj/V/O5rBlhtt+RZeFQ: folds 
FaGtAm5QUVcixGhAKIvbLg: folds 
3PmVnC/15cl4oyI1TKIt4g: folds 
Uncalled bet ($0.50) returned to ghNKXUBl/H+t83JF079ZBA
ghNKXUBl/H+t83JF079ZBA collected $0.60 from pot
ghNKXUBl/H+t83JF079ZBA: doesn't show hand 
*** SUMMARY ***
Total pot $0.60 | Rake $0 
Seat 1: ghNKXUBl/H+t83JF079ZBA collected ($0.60)
Seat 2: CT7Xj/V/O5rBlhtt+RZeFQ (button) folded before Flop (didn't bet)
Seat 3: FaGtAm5QUVcixGhAKIvbLg (small blind) folded before Flop
Seat 4: 3PmVnC/15cl4oyI1TKIt4g (big blind) folded before Flop
Seat 5: BT6Oal0iO4P6kDuT7HFQDw folded before Flop (didn't bet)
Seat 6: oFwaTjy3ok/+qFghsrcGvg folded before Flop (didn't bet)
Seat 8: bXpVeaSTPBFSPJmeXxO7nw folded before Flop (didn't bet)
Seat 9: tLcDklc2rBORNfixyRfVfw folded before Flop (didn't bet)




PokerStars Game #59941793620:  Hold'em No Limit ($0.10/$0.25) - 2009/07/01 1:46:20 ET
Table 'AJGgX1ZYM8d68SWMvaLttg' 6-max Seat #3 is the button
Seat 2: zHHLkD2sRljslKKeQv/ZQw ($18.20 in chips) 
Seat 3: 8ClCHtFXGNplITm+63KB+Q ($38.70 in chips) 
Seat 4: e30C3DfdG5TfPnR16/oMmA ($19.10 in chips) 
Seat 5: Hsvkc0/G2VV78oVmWYXecw ($5 in chips) 
Seat 6: UA5OsKS3VPaxa7uC8La/kA ($64 in chips) 
e30C3DfdG5TfPnR16/oMmA: posts small blind $0.10
Hsvkc0/G2VV78oVmWYXecw: posts big blind $0.25
*** HOLE CARDS ***
Q1uciOZPBR/WkAlqa6cL4A leaves the table
UA5OsKS3VPaxa7uC8La/kA has timed out while being disconnected
UA5OsKS3VPaxa7uC8La/kA: folds 
UA5OsKS3VPaxa7uC8La/kA is sitting out
Q1uciOZPBR/WkAlqa6cL4A joins the table at seat #1 
zHHLkD2sRljslKKeQv/ZQw: calls $0.25
UA5OsKS3VPaxa7uC8La/kA is connected 
8ClCHtFXGNplITm+63KB+Q: folds 
e30C3DfdG5TfPnR16/oMmA: raises $0.25 to $0.50
Hsvkc0/G2VV78oVmWYXecw: folds 
zHHLkD2sRljslKKeQv/ZQw: calls $0.25
*** FLOP *** [5d Jh 4c]
e30C3DfdG5TfPnR16/oMmA: bets $1
zHHLkD2sRljslKKeQv/ZQw: folds 
Uncalled bet ($1) returned to e30C3DfdG5TfPnR16/oMmA
e30C3DfdG5TfPnR16/oMmA collected $1.20 from pot
*** SUMMARY ***
Total pot $1.25 | Rake $0.05 
Board [5d Jh 4c]
Seat 2: zHHLkD2sRljslKKeQv/ZQw folded on the Flop
Seat 3: 8ClCHtFXGNplITm+63KB+Q (button) folded before Flop (didn't bet)
Seat 4: e30C3DfdG5TfPnR16/oMmA (small blind) collected ($1.20)
Seat 5: Hsvkc0/G2VV78oVmWYXecw (big blind) folded before Flop
Seat 6: UA5OsKS3VPaxa7uC8La/kA folded before Flop (didn't bet)




PokerStars Game #59941794232:  Hold'em No Limit ($0.10/$0.25) - 2009/07/01 1:46:21 ET
Table 'Jj2eLzVCUVAGBmM+Og79iQ' 9-max Seat #5 is the button
Seat 1: ShXPHWfjhfmAwLgDdm6bRQ ($6.75 in chips) 
Seat 2: oMxwMC7+uAsJudeUN6aP0A ($14.60 in chips) 
Seat 3: HPEB+AtKw1+C/cxU0o1ciw ($24.40 in chips) 
Seat 4: aNpwfA31EREwO+ar4XzBCw ($44.60 in chips) 
Seat 5: UkF1eqqUN0CCiimXAuN7og ($4.65 in chips) 
Seat 6: jZURAM/dgGCX+5lATlZugw ($17.60 in chips) 
Seat 7: K0b5wNInj6hUGRr6yzKFtw ($59.50 in chips) 
Seat 8: H5Se03ZqSX7tbULXur2MAg ($20.60 in chips) 
jZURAM/dgGCX+5lATlZugw: posts small blind $0.10
K0b5wNInj6hUGRr6yzKFtw: posts big blind $0.25
vSkQm2EelzwRGDDQQk0Fqw: sits out 
*** HOLE CARDS ***
H5Se03ZqSX7tbULXur2MAg: folds 
ShXPHWfjhfmAwLgDdm6bRQ: calls $0.25
oMxwMC7+uAsJudeUN6aP0A: folds 
HPEB+AtKw1+C/cxU0o1ciw: folds 
aNpwfA31EREwO+ar4XzBCw: folds 
UkF1eqqUN0CCiimXAuN7og: folds 
jZURAM/dgGCX+5lATlZugw: calls $0.15
K0b5wNInj6hUGRr6yzKFtw: checks 
*** FLOP *** [Ah 2c 2h]
jZURAM/dgGCX+5lATlZugw: checks 
K0b5wNInj6hUGRr6yzKFtw: checks 
ShXPHWfjhfmAwLgDdm6bRQ: bets $1
jZURAM/dgGCX+5lATlZugw: folds 
K0b5wNInj6hUGRr6yzKFtw: folds 
Uncalled bet ($1) returned to ShXPHWfjhfmAwLgDdm6bRQ
ShXPHWfjhfmAwLgDdm6bRQ collected $0.75 from pot
ShXPHWfjhfmAwLgDdm6bRQ: doesn't show hand 
*** SUMMARY ***
Total pot $0.75 | Rake $0 
Board [Ah 2c 2h]
Seat 1: ShXPHWfjhfmAwLgDdm6bRQ collected ($0.75)
Seat 2: oMxwMC7+uAsJudeUN6aP0A folded before Flop (didn't bet)
Seat 3: HPEB+AtKw1+C/cxU0o1ciw folded before Flop (didn't bet)
Seat 4: aNpwfA31EREwO+ar4XzBCw folded before Flop (didn't bet)
Seat 5: UkF1eqqUN0CCiimXAuN7og (button) folded before Flop (didn't bet)
Seat 6: jZURAM/dgGCX+5lATlZugw (small blind) folded on the Flop
Seat 7: K0b5wNInj6hUGRr6yzKFtw (big blind) folded on the Flop
Seat 8: H5Se03ZqSX7tbULXur2MAg folded before Flop (didn't bet)




PokerStars Game #59941794010:  Hold'em No Limit ($0.10/$0.25) - 2009/07/01 1:46:21 ET
Table 'i93c3z9RLowvuJTKA2F4Jg' 6-max Seat #6 is the button
Seat 1: tbSZq5LHglyHk61mH9eDBw ($30.20 in chips) 
Seat 2: TSmua8tGK3sTbwi0ynrW9Q ($29.05 in chips) 
Seat 3: v8m8XHovI5tqEA9mvplDSw ($31.30 in chips) 
Seat 4: o86X2Q5GEDU3uP9oj1iFZA ($29.80 in chips) 
Seat 6: FpN4KbLjlyRRKiVaQcoLqA ($18.25 in chips) 
tbSZq5LHglyHk61mH9eDBw: posts small blind $0.10
TSmua8tGK3sTbwi0ynrW9Q: posts big blind $0.25
TI/C5Q+DEl4fLR3AofwYdg: sits out 
*** HOLE CARDS ***
v8m8XHovI5tqEA9mvplDSw: raises $0.50 to $0.75
o86X2Q5GEDU3uP9oj1iFZA: raises $2.25 to $3
FpN4KbLjlyRRKiVaQcoLqA: folds 
tbSZq5LHglyHk61mH9eDBw: folds 
TSmua8tGK3sTbwi0ynrW9Q: calls $2.75
v8m8XHovI5tqEA9mvplDSw: calls $2.25
*** FLOP *** [9c 2c 3d]
TSmua8tGK3sTbwi0ynrW9Q: checks 
v8m8XHovI5tqEA9mvplDSw: checks 
o86X2Q5GEDU3uP9oj1iFZA: bets $5
TSmua8tGK3sTbwi0ynrW9Q: folds 
v8m8XHovI5tqEA9mvplDSw: folds 
Uncalled bet ($5) returned to o86X2Q5GEDU3uP9oj1iFZA
o86X2Q5GEDU3uP9oj1iFZA collected $8.65 from pot
o86X2Q5GEDU3uP9oj1iFZA: doesn't show hand 
*** SUMMARY ***
Total pot $9.10 | Rake $0.45 
Board [9c 2c 3d]
Seat 1: tbSZq5LHglyHk61mH9eDBw (small blind) folded before Flop
Seat 2: TSmua8tGK3sTbwi0ynrW9Q (big blind) folded on the Flop
Seat 3: v8m8XHovI5tqEA9mvplDSw folded on the Flop
Seat 4: o86X2Q5GEDU3uP9oj1iFZA collected ($8.65)
Seat 6: FpN4KbLjlyRRKiVaQcoLqA (button) folded before Flop (didn't bet)




PokerStars Game #59941793974:  Hold'em No Limit ($0.10/$0.25) - 2009/07/01 1:46:21 ET
Table '0XPo7K54oZIfG0xlNAcDRw' 9-max Seat #6 is the button
Seat 1: 7cv+9Zc9HIQHNvYsMfV3uA ($29.35 in chips) 
Seat 2: Prl9QvWQw/mISF4dSnnQUQ ($10.10 in chips) 
Seat 3: RHqgdFvufLCYe54+qd2gcA ($4.75 in chips) 
Seat 4: RubYqfvGrz2z+5ReNIj9QQ ($31.35 in chips) 
Seat 5: iOmwbUN7u4JFkV6VCA49aA ($15.15 in chips) 
Seat 6: M1nKET7WOTLbVPuAbJa3EA ($14.65 in chips) 
Seat 7: tYsOBqdU1+x+yFI7zHO7hQ ($28.55 in chips) 
Seat 8: v5jnQ1gfh9nLla3kMXG7Yg ($14.95 in chips) 
Seat 9: CmngQmkKTp8tkl6GMRTl6w ($13.60 in chips) 
tYsOBqdU1+x+yFI7zHO7hQ: posts small blind $0.10
v5jnQ1gfh9nLla3kMXG7Yg: posts big blind $0.25
*** HOLE CARDS ***
CmngQmkKTp8tkl6GMRTl6w: folds 
7cv+9Zc9HIQHNvYsMfV3uA: folds 
Prl9QvWQw/mISF4dSnnQUQ: folds 
RHqgdFvufLCYe54+qd2gcA: folds 
RubYqfvGrz2z+5ReNIj9QQ: calls $0.25
iOmwbUN7u4JFkV6VCA49aA: raises $1 to $1.25
M1nKET7WOTLbVPuAbJa3EA: folds 
tYsOBqdU1+x+yFI7zHO7hQ: folds 
v5jnQ1gfh9nLla3kMXG7Yg: folds 
RubYqfvGrz2z+5ReNIj9QQ: folds 
Uncalled bet ($1) returned to iOmwbUN7u4JFkV6VCA49aA
iOmwbUN7u4JFkV6VCA49aA collected $0.85 from pot
*** SUMMARY ***
Total pot $0.85 | Rake $0 
Seat 1: 7cv+9Zc9HIQHNvYsMfV3uA folded before Flop (didn't bet)
Seat 2: Prl9QvWQw/mISF4dSnnQUQ folded before Flop (didn't bet)
Seat 3: RHqgdFvufLCYe54+qd2gcA folded before Flop (didn't bet)
Seat 4: RubYqfvGrz2z+5ReNIj9QQ folded before Flop
Seat 5: iOmwbUN7u4JFkV6VCA49aA collected ($0.85)
Seat 6: M1nKET7WOTLbVPuAbJa3EA (button) folded before Flop (didn't bet)
Seat 7: tYsOBqdU1+x+yFI7zHO7hQ (small blind) folded before Flop
Seat 8: v5jnQ1gfh9nLla3kMXG7Yg (big blind) folded before Flop
Seat 9: CmngQmkKTp8tkl6GMRTl6w folded before Flop (didn't bet)




PokerStars Game #59941793968:  Hold'em No Limit ($0.10/$0.25) - 2009/07/01 1:46:21 ET
Table '+UzantPJ4smVdrh+4GTu1w' 6-max Seat #5 is the button
Seat 1: TSmua8tGK3sTbwi0ynrW9Q ($28.10 in chips) 
Seat 2: tcbEu7VzyHQ+0lh+skbQhQ ($41 in chips) 
Seat 3: SS/yfeArhULzIcOPe8MdPg ($34.50 in chips) 
Seat 4: UmcUp27+PbgBItv3ZNlAWQ ($26.80 in chips) 
Seat 5: cj4VBQya7HtVL2zCGd5jLQ ($55.70 in chips) 
Seat 6: fZQg9veL7Dd/Z04ZTjC+wQ ($25 in chips) 
fZQg9veL7Dd/Z04ZTjC+wQ: posts small blind $0.10
TSmua8tGK3sTbwi0ynrW9Q: posts big blind $0.25
*** HOLE CARDS ***
tcbEu7VzyHQ+0lh+skbQhQ: raises $0.75 to $1
SS/yfeArhULzIcOPe8MdPg: folds 
UmcUp27+PbgBItv3ZNlAWQ: folds 
cj4VBQya7HtVL2zCGd5jLQ: folds 
fZQg9veL7Dd/Z04ZTjC+wQ: folds 
TSmua8tGK3sTbwi0ynrW9Q: folds 
Uncalled bet ($0.75) returned to tcbEu7VzyHQ+0lh+skbQhQ
tcbEu7VzyHQ+0lh+skbQhQ collected $0.60 from pot
*** SUMMARY ***
Total pot $0.60 | Rake $0 
Seat 1: TSmua8tGK3sTbwi0ynrW9Q (big blind) folded before Flop
Seat 2: tcbEu7VzyHQ+0lh+skbQhQ collected ($0.60)
Seat 3: SS/yfeArhULzIcOPe8MdPg folded before Flop (didn't bet)
Seat 4: UmcUp27+PbgBItv3ZNlAWQ folded before Flop (didn't bet)
Seat 5: cj4VBQya7HtVL2zCGd5jLQ (button) folded before Flop (didn't bet)
Seat 6: fZQg9veL7Dd/Z04ZTjC+wQ (small blind) folded before Flop




PokerStars Game #59941794118:  Hold'em No Limit ($0.10/$0.25) - 2009/07/01 1:46:21 ET
Table 'Qk/910N2Yhg8u5vqTJk50Q' 9-max Seat #3 is the button
Seat 2: Th3FldXKQW6hWVVPahaoOQ ($45.05 in chips) 
Seat 3: ghNKXUBl/H+t83JF079ZBA ($25.65 in chips) 
Seat 5: zReBEigsxqZnag0RZAgpgA ($15 in chips) 
Seat 7: aNpwfA31EREwO+ar4XzBCw ($26.35 in chips) 
Seat 8: 9PMD136+PrUsTwnP6fczyA ($13 in chips) 
Seat 9: M2QO2DxB5Wawg2h8HSpnYA ($17.70 in chips) 
zReBEigsxqZnag0RZAgpgA: posts small blind $0.10
aNpwfA31EREwO+ar4XzBCw: posts big blind $0.25
*** HOLE CARDS ***
9PMD136+PrUsTwnP6fczyA: calls $0.25
M2QO2DxB5Wawg2h8HSpnYA: folds 
Th3FldXKQW6hWVVPahaoOQ: folds 
ghNKXUBl/H+t83JF079ZBA: folds 
zReBEigsxqZnag0RZAgpgA: calls $0.15
aNpwfA31EREwO+ar4XzBCw: checks 
*** FLOP *** [5h Kh 4d]
zReBEigsxqZnag0RZAgpgA: checks 
U41wNf6XauAiBOQaKu2ZIA joins the table at seat #6 
aNpwfA31EREwO+ar4XzBCw: checks 
9PMD136+PrUsTwnP6fczyA: checks 
*** TURN *** [5h Kh 4d] [7s]
zReBEigsxqZnag0RZAgpgA: checks 
aNpwfA31EREwO+ar4XzBCw: bets $0.50
9PMD136+PrUsTwnP6fczyA: calls $0.50
zReBEigsxqZnag0RZAgpgA: folds 
*** RIVER *** [5h Kh 4d 7s] [5d]
Hein MÃ¼ck 76 joins the table at seat #4 
aNpwfA31EREwO+ar4XzBCw: bets $1
9PMD136+PrUsTwnP6fczyA: raises $1 to $2
aNpwfA31EREwO+ar4XzBCw: calls $1
*** SHOW DOWN ***
9PMD136+PrUsTwnP6fczyA: shows [Ah As] (two pair, Aces and Fives)
aNpwfA31EREwO+ar4XzBCw: mucks hand 
9PMD136+PrUsTwnP6fczyA collected $5.50 from pot
*** SUMMARY ***
Total pot $5.75 | Rake $0.25 
Board [5h Kh 4d 7s 5d]
Seat 2: Th3FldXKQW6hWVVPahaoOQ folded before Flop (didn't bet)
Seat 3: ghNKXUBl/H+t83JF079ZBA (button) folded before Flop (didn't bet)
Seat 5: zReBEigsxqZnag0RZAgpgA (small blind) folded on the Turn
Seat 7: aNpwfA31EREwO+ar4XzBCw (big blind) mucked
Seat 8: 9PMD136+PrUsTwnP6fczyA showed [Ah As] and won ($5.50) with two pair, Aces and Fives
Seat 9: M2QO2DxB5Wawg2h8HSpnYA folded before Flop (didn't bet)




PokerStars Game #59941794670:  Hold'em No Limit ($0.10/$0.25) - 2009/07/01 1:46:22 ET
Table 'rhQuIjJo0UQ7RRUlF9umHg' 6-max Seat #6 is the button
Seat 1: 5O3Hj9Qg0SqOyKEXoLpjPg ($156.40 in chips) 
Seat 2: Ew/TYPQIsbQ2X8nm5iAJBg ($16 in chips) 
Seat 3: if4dh6jhJXeN3/qd3qCp9g ($27.40 in chips) 
Seat 4: buyjetgNT1McXtdaP4zynA ($39 in chips) 
Seat 5: dOX4wnYV2sEqvDbF+8KSCw ($51.90 in chips) 
Seat 6: /gJNBeCkWL4o85/jvlZ4BA ($52.05 in chips) 
5O3Hj9Qg0SqOyKEXoLpjPg: posts small blind $0.10
Ew/TYPQIsbQ2X8nm5iAJBg: posts big blind $0.25
*** HOLE CARDS ***
if4dh6jhJXeN3/qd3qCp9g: folds 
buyjetgNT1McXtdaP4zynA: raises $0.75 to $1
dOX4wnYV2sEqvDbF+8KSCw: folds 
/gJNBeCkWL4o85/jvlZ4BA: folds 
5O3Hj9Qg0SqOyKEXoLpjPg: calls $0.90
Ew/TYPQIsbQ2X8nm5iAJBg: folds 
*** FLOP *** [Js 2s Ts]
5O3Hj9Qg0SqOyKEXoLpjPg: checks 
buyjetgNT1McXtdaP4zynA: bets $2
5O3Hj9Qg0SqOyKEXoLpjPg: folds 
Uncalled bet ($2) returned to buyjetgNT1McXtdaP4zynA
buyjetgNT1McXtdaP4zynA collected $2.15 from pot
buyjetgNT1McXtdaP4zynA: doesn't show hand 
*** SUMMARY ***
Total pot $2.25 | Rake $0.10 
Board [Js 2s Ts]
Seat 1: 5O3Hj9Qg0SqOyKEXoLpjPg (small blind) folded on the Flop
Seat 2: Ew/TYPQIsbQ2X8nm5iAJBg (big blind) folded before Flop
Seat 3: if4dh6jhJXeN3/qd3qCp9g folded before Flop (didn't bet)
Seat 4: buyjetgNT1McXtdaP4zynA collected ($2.15)
Seat 5: dOX4wnYV2sEqvDbF+8KSCw folded before Flop (didn't bet)
Seat 6: /gJNBeCkWL4o85/jvlZ4BA (button) folded before Flop (didn't bet)




PokerStars Game #59941794742:  Hold'em No Limit ($0.10/$0.25) - 2009/07/01 1:46:22 ET
Table '8PD/MTROSMd6Y8mZeykbpg' 6-max Seat #1 is the button
Seat 1: fxNpaToxECtD2Goelmg9vA ($28.85 in chips) 
Seat 2: 4TM16KVgEiQpLi4bVVWbVQ ($22.75 in chips) 
Seat 3: vqWjZmdQu/Hxw96/IJTWdQ ($25 in chips) 
Seat 4: DFi/Lzkjsfv8QswS80JX9Q ($53.70 in chips) 
Seat 5: z3tQwy28dp5FykDJC/wzQw ($26.55 in chips) 
Seat 6: trN/oHqTTbPw5MNuKrOpLw ($25.70 in chips) 
4TM16KVgEiQpLi4bVVWbVQ: posts small blind $0.10
vqWjZmdQu/Hxw96/IJTWdQ: posts big blind $0.25
*** HOLE CARDS ***
DFi/Lzkjsfv8QswS80JX9Q: folds 
z3tQwy28dp5FykDJC/wzQw: folds 
trN/oHqTTbPw5MNuKrOpLw: folds 
fxNpaToxECtD2Goelmg9vA: folds 
4TM16KVgEiQpLi4bVVWbVQ: folds 
Uncalled bet ($0.15) returned to vqWjZmdQu/Hxw96/IJTWdQ
vqWjZmdQu/Hxw96/IJTWdQ collected $0.20 from pot
vqWjZmdQu/Hxw96/IJTWdQ: doesn't show hand 
*** SUMMARY ***
Total pot $0.20 | Rake $0 
Seat 1: fxNpaToxECtD2Goelmg9vA (button) folded before Flop (didn't bet)
Seat 2: 4TM16KVgEiQpLi4bVVWbVQ (small blind) folded before Flop
Seat 3: vqWjZmdQu/Hxw96/IJTWdQ (big blind) collected ($0.20)
Seat 4: DFi/Lzkjsfv8QswS80JX9Q folded before Flop (didn't bet)
Seat 5: z3tQwy28dp5FykDJC/wzQw folded before Flop (didn't bet)
Seat 6: trN/oHqTTbPw5MNuKrOpLw folded before Flop (didn't bet)




PokerStars Game #59941794828:  Hold'em No Limit ($0.10/$0.25) - 2009/07/01 1:46:22 ET
Table 'YONIZZNvg4uZ4xNUO1deeA' 6-max Seat #1 is the button
Seat 1: GbCVUNssQ7mqsPWr7J4d3w ($4.65 in chips) 
Seat 2: evMMX/0gSDH791KdSAOaSg ($16.95 in chips) 
Seat 3: Eksrep3hySi2jeDHuaWiOQ ($11 in chips) 
Seat 4: w43JQj2oYPpKQVG4Yzlq1w ($25.35 in chips) 
Seat 5: if4dh6jhJXeN3/qd3qCp9g ($25 in chips) 
Seat 6: eL3+wCBjFGfQ5FMdIZihwA ($27 in chips) 
evMMX/0gSDH791KdSAOaSg: posts small blind $0.10
Eksrep3hySi2jeDHuaWiOQ: posts big blind $0.25
*** HOLE CARDS ***
w43JQj2oYPpKQVG4Yzlq1w: folds 
if4dh6jhJXeN3/qd3qCp9g: folds 
eL3+wCBjFGfQ5FMdIZihwA: folds 
GbCVUNssQ7mqsPWr7J4d3w: folds 
evMMX/0gSDH791KdSAOaSg: raises $0.50 to $0.75
Eksrep3hySi2jeDHuaWiOQ: folds 
Uncalled bet ($0.50) returned to evMMX/0gSDH791KdSAOaSg
evMMX/0gSDH791KdSAOaSg collected $0.50 from pot
*** SUMMARY ***
Total pot $0.50 | Rake $0 
Seat 1: GbCVUNssQ7mqsPWr7J4d3w (button) folded before Flop (didn't bet)
Seat 2: evMMX/0gSDH791KdSAOaSg (small blind) collected ($0.50)
Seat 3: Eksrep3hySi2jeDHuaWiOQ (big blind) folded before Flop
Seat 4: w43JQj2oYPpKQVG4Yzlq1w folded before Flop (didn't bet)
Seat 5: if4dh6jhJXeN3/qd3qCp9g folded before Flop (didn't bet)
Seat 6: eL3+wCBjFGfQ5FMdIZihwA folded before Flop (didn't bet)




PokerStars Game #59941794654:  Hold'em No Limit ($0.10/$0.25) - 2009/07/01 1:46:22 ET
Table 'S6s+TmTlAjLHclBRvN5/fw' 9-max Seat #3 is the button
Seat 3: z2SmIaQ3+5n/eY1BN5HgPg ($7.60 in chips) 
Seat 4: RSal7+azPhXeqQO5L8XPfg ($12.25 in chips) 
Seat 5: 8hSJOE8UscCqt6t47gp0/g ($9 in chips) 
RSal7+azPhXeqQO5L8XPfg: posts small blind $0.10
8hSJOE8UscCqt6t47gp0/g: posts big blind $0.25
*** HOLE CARDS ***
z2SmIaQ3+5n/eY1BN5HgPg: folds 
RSal7+azPhXeqQO5L8XPfg: calls $0.15
8hSJOE8UscCqt6t47gp0/g: checks 
*** FLOP *** [Ts 3c Tc]
RSal7+azPhXeqQO5L8XPfg: bets $0.25
8hSJOE8UscCqt6t47gp0/g: calls $0.25
*** TURN *** [Ts 3c Tc] [5c]
RSal7+azPhXeqQO5L8XPfg: bets $0.25
lQXp8ud1KwKUS+00XK0YEQ joins the table at seat #2 
8hSJOE8UscCqt6t47gp0/g: calls $0.25
*** RIVER *** [Ts 3c Tc 5c] [Js]
RSal7+azPhXeqQO5L8XPfg: bets $1.75
8hSJOE8UscCqt6t47gp0/g: calls $1.75
*** SHOW DOWN ***
RSal7+azPhXeqQO5L8XPfg: shows [2c 4c] (a flush, Ten high)
8hSJOE8UscCqt6t47gp0/g: shows [3h Jc] (two pair, Jacks and Tens)
RSal7+azPhXeqQO5L8XPfg collected $4.80 from pot
*** SUMMARY ***
Total pot $5 | Rake $0.20 
Board [Ts 3c Tc 5c Js]
Seat 3: z2SmIaQ3+5n/eY1BN5HgPg (button) folded before Flop (didn't bet)
Seat 4: RSal7+azPhXeqQO5L8XPfg (small blind) showed [2c 4c] and won ($4.80) with a flush, Ten high
Seat 5: 8hSJOE8UscCqt6t47gp0/g (big blind) showed [3h Jc] and lost with two pair, Jacks and Tens




PokerStars Game #59941794604:  Hold'em No Limit ($0.10/$0.25) - 2009/07/01 1:46:22 ET
Table 'yAHDCs33TIgw3ra63xuU2Q' 9-max Seat #4 is the button
Seat 1: ydoFOVgzvZv9ZhuWu9rXAw ($9.85 in chips) 
Seat 3: g6UPjSyxNLffCi+EqqIlEg ($21.55 in chips) 
Seat 4: j5spkbnOCRiLGiH6iqBaqw ($8 in chips) 
Seat 5: 4awUyiDYTgylQKXZ9faBVA ($37.35 in chips) 
Seat 6: DnDcAdn9P0zGovMERigpFA ($26.30 in chips) 
Seat 8: tYsOBqdU1+x+yFI7zHO7hQ ($25 in chips) 
Seat 9: MtVtHDqIJTyUcXkRBBDIVA ($25 in chips) 
4awUyiDYTgylQKXZ9faBVA: posts small blind $0.10
DnDcAdn9P0zGovMERigpFA: posts big blind $0.25
j4q3p0lesp63b1gZDwLBZw: sits out 
*** HOLE CARDS ***
tYsOBqdU1+x+yFI7zHO7hQ: folds 
MtVtHDqIJTyUcXkRBBDIVA: folds 
ydoFOVgzvZv9ZhuWu9rXAw: folds 
g6UPjSyxNLffCi+EqqIlEg: raises $0.25 to $0.50
j5spkbnOCRiLGiH6iqBaqw: calls $0.50
4awUyiDYTgylQKXZ9faBVA: folds 
DnDcAdn9P0zGovMERigpFA: folds 
*** FLOP *** [7c 5s 9c]
g6UPjSyxNLffCi+EqqIlEg: checks 
j5spkbnOCRiLGiH6iqBaqw: checks 
*** TURN *** [7c 5s 9c] [Ts]
g6UPjSyxNLffCi+EqqIlEg: checks 
j5spkbnOCRiLGiH6iqBaqw: checks 
*** RIVER *** [7c 5s 9c Ts] [Td]
g6UPjSyxNLffCi+EqqIlEg: checks 
j5spkbnOCRiLGiH6iqBaqw: checks 
*** SHOW DOWN ***
g6UPjSyxNLffCi+EqqIlEg: shows [Ad 3s] (a pair of Tens)
j5spkbnOCRiLGiH6iqBaqw: shows [Ac 5h] (two pair, Tens and Fives)
j5spkbnOCRiLGiH6iqBaqw collected $1.30 from pot
*** SUMMARY ***
Total pot $1.35 | Rake $0.05 
Board [7c 5s 9c Ts Td]
Seat 1: ydoFOVgzvZv9ZhuWu9rXAw folded before Flop (didn't bet)
Seat 3: g6UPjSyxNLffCi+EqqIlEg showed [Ad 3s] and lost with a pair of Tens
Seat 4: j5spkbnOCRiLGiH6iqBaqw (button) showed [Ac 5h] and won ($1.30) with two pair, Tens and Fives
Seat 5: 4awUyiDYTgylQKXZ9faBVA (small blind) folded before Flop
Seat 6: DnDcAdn9P0zGovMERigpFA (big blind) folded before Flop
Seat 8: tYsOBqdU1+x+yFI7zHO7hQ folded before Flop (didn't bet)
Seat 9: MtVtHDqIJTyUcXkRBBDIVA folded before Flop (didn't bet)




PokerStars Game #59941794738:  Hold'em No Limit ($0.10/$0.25) - 2009/07/01 1:46:22 ET
Table '6aL2C8IFwHHr6SG6RgXaow' 9-max Seat #5 is the button
Seat 1: bXpVeaSTPBFSPJmeXxO7nw ($5.50 in chips) 
Seat 3: clJsV3v77RS07bDKY+705w ($5 in chips) 
Seat 4: BT6Oal0iO4P6kDuT7HFQDw ($18.25 in chips) 
Seat 5: wre31HfyzQGpIvID1istxw ($21.20 in chips) 
Seat 6: gehe91e0IyVT0QU/XBkEyg ($26.85 in chips) 
Seat 8: rQhYIYXSyH/IivYM1dlV5A ($22.45 in chips) 
Seat 9: CgIo2ItZqi4o3ayVG6HanQ ($23.75 in chips) 
gehe91e0IyVT0QU/XBkEyg: posts small blind $0.10
QJxYAPJ6uPZZcpdN+RvWcQ: is sitting out 
rQhYIYXSyH/IivYM1dlV5A: posts big blind $0.25
*** HOLE CARDS ***
QJxYAPJ6uPZZcpdN+RvWcQ leaves the table
CgIo2ItZqi4o3ayVG6HanQ: calls $0.25
bXpVeaSTPBFSPJmeXxO7nw: folds 
E0iYnEVO2ho7dH3QcCjw7g joins the table at seat #7 
clJsV3v77RS07bDKY+705w: folds 
BT6Oal0iO4P6kDuT7HFQDw: calls $0.25
wre31HfyzQGpIvID1istxw: calls $0.25
gehe91e0IyVT0QU/XBkEyg: folds 
rQhYIYXSyH/IivYM1dlV5A: checks 
*** FLOP *** [9h 4s 3d]
rQhYIYXSyH/IivYM1dlV5A: checks 
CgIo2ItZqi4o3ayVG6HanQ: checks 
BT6Oal0iO4P6kDuT7HFQDw: bets $0.75
wre31HfyzQGpIvID1istxw: folds 
rQhYIYXSyH/IivYM1dlV5A: folds 
CgIo2ItZqi4o3ayVG6HanQ: folds 
Uncalled bet ($0.75) returned to BT6Oal0iO4P6kDuT7HFQDw
BT6Oal0iO4P6kDuT7HFQDw collected $1.05 from pot
BT6Oal0iO4P6kDuT7HFQDw: doesn't show hand 
*** SUMMARY ***
Total pot $1.10 | Rake $0.05 
Board [9h 4s 3d]
Seat 1: bXpVeaSTPBFSPJmeXxO7nw folded before Flop (didn't bet)
Seat 3: clJsV3v77RS07bDKY+705w folded before Flop (didn't bet)
Seat 4: BT6Oal0iO4P6kDuT7HFQDw collected ($1.05)
Seat 5: wre31HfyzQGpIvID1istxw (button) folded on the Flop
Seat 6: gehe91e0IyVT0QU/XBkEyg (small blind) folded before Flop
Seat 8: rQhYIYXSyH/IivYM1dlV5A (big blind) folded on the Flop
Seat 9: CgIo2ItZqi4o3ayVG6HanQ folded on the Flop




PokerStars Game #59941794740:  Hold'em No Limit ($0.10/$0.25) - 2009/07/01 1:46:22 ET
Table '8QBBaev+cI2i/r2H6ml/lg' 9-max Seat #6 is the button
Seat 1: s2xLPOl/vhl/26apJ3vsOQ ($35.80 in chips) 
Seat 2: y7tkvDmwKjURBkr73SZPXw ($12.25 in chips) 
Seat 3: zgi+EUykT/pZQpoUG6+oEg ($4.30 in chips) 
Seat 4: ytpGB2nr/CLVHnyKMRiEFQ ($16 in chips) 
Seat 5: 0QdZrkFD7aGKeBXPGbIomA ($11.10 in chips) 
Seat 6: X6+pSIPfovPcE87t+LmUKQ ($5.25 in chips) 
Seat 7: eK8qa6EPcH2zhtbmWSvc9g ($30.80 in chips) 
Seat 8: vr1IK/Q4HXm8s8V0/dePzQ ($11.60 in chips) 
Seat 9: EUMLvzDkECHBit+xa+uGjg ($24.75 in chips) 
eK8qa6EPcH2zhtbmWSvc9g: posts small blind $0.10
vr1IK/Q4HXm8s8V0/dePzQ: posts big blind $0.25
*** HOLE CARDS ***
EUMLvzDkECHBit+xa+uGjg: folds 
s2xLPOl/vhl/26apJ3vsOQ: folds 
y7tkvDmwKjURBkr73SZPXw: folds 
zgi+EUykT/pZQpoUG6+oEg: folds 
ytpGB2nr/CLVHnyKMRiEFQ: folds 
0QdZrkFD7aGKeBXPGbIomA: raises $0.75 to $1
X6+pSIPfovPcE87t+LmUKQ: folds 
eK8qa6EPcH2zhtbmWSvc9g: folds 
vr1IK/Q4HXm8s8V0/dePzQ: folds 
Uncalled bet ($0.75) returned to 0QdZrkFD7aGKeBXPGbIomA
0QdZrkFD7aGKeBXPGbIomA collected $0.60 from pot
0QdZrkFD7aGKeBXPGbIomA: doesn't show hand 
*** SUMMARY ***
Total pot $0.60 | Rake $0 
Seat 1: s2xLPOl/vhl/26apJ3vsOQ folded before Flop (didn't bet)
Seat 2: y7tkvDmwKjURBkr73SZPXw folded before Flop (didn't bet)
Seat 3: zgi+EUykT/pZQpoUG6+oEg folded before Flop (didn't bet)
Seat 4: ytpGB2nr/CLVHnyKMRiEFQ folded before Flop (didn't bet)
Seat 5: 0QdZrkFD7aGKeBXPGbIomA collected ($0.60)
Seat 6: X6+pSIPfovPcE87t+LmUKQ (button) folded before Flop (didn't bet)
Seat 7: eK8qa6EPcH2zhtbmWSvc9g (small blind) folded before Flop
Seat 8: vr1IK/Q4HXm8s8V0/dePzQ (big blind) folded before Flop
Seat 9: EUMLvzDkECHBit+xa+uGjg folded before Flop (didn't bet)




PokerStars Game #59941794746:  Hold'em No Limit ($0.10/$0.25) - 2009/07/01 1:46:22 ET
Table 'GgmUtmhrYPRnhkqEEjD/Kw' 9-max Seat #5 is the button
Seat 2: ghNKXUBl/H+t83JF079ZBA ($25.15 in chips) 
Seat 3: dYvYZ723QlKIPiDa0pkedQ ($8.25 in chips) 
Seat 4: dfNim92Z6XK1/h5SFW5vDg ($25 in chips) 
Seat 5: ljemhp25Zg+nlA9DLCIiUw ($26.50 in chips) 
Seat 6: 4Ax0vobe1rLVIGZmkFINGA ($20.75 in chips) 
Seat 7: YwDw9cMqkbMznFK77rru4A ($4.90 in chips) 
Seat 8: DdPXdieucQ+n99u1n3A+rQ ($4.65 in chips) 
Seat 9: V6p0jQ/RhUsqpHLmXvEX4Q ($13.95 in chips) 
4Ax0vobe1rLVIGZmkFINGA: posts small blind $0.10
YwDw9cMqkbMznFK77rru4A: posts big blind $0.25
bXpVeaSTPBFSPJmeXxO7nw: sits out 
*** HOLE CARDS ***
DdPXdieucQ+n99u1n3A+rQ: folds 
V6p0jQ/RhUsqpHLmXvEX4Q: raises $0.75 to $1
ghNKXUBl/H+t83JF079ZBA: folds 
dYvYZ723QlKIPiDa0pkedQ: folds 
dfNim92Z6XK1/h5SFW5vDg: folds 
ljemhp25Zg+nlA9DLCIiUw: folds 
4Ax0vobe1rLVIGZmkFINGA: calls $0.90
YwDw9cMqkbMznFK77rru4A: folds 
*** FLOP *** [Ts 7d Td]
4Ax0vobe1rLVIGZmkFINGA: checks 
V6p0jQ/RhUsqpHLmXvEX4Q: checks 
*** TURN *** [Ts 7d Td] [5h]
4Ax0vobe1rLVIGZmkFINGA: bets $0.50
V6p0jQ/RhUsqpHLmXvEX4Q: calls $0.50
*** RIVER *** [Ts 7d Td 5h] [9d]
4Ax0vobe1rLVIGZmkFINGA: checks 
V6p0jQ/RhUsqpHLmXvEX4Q: bets $1.50
4Ax0vobe1rLVIGZmkFINGA: folds 
Uncalled bet ($1.50) returned to V6p0jQ/RhUsqpHLmXvEX4Q
V6p0jQ/RhUsqpHLmXvEX4Q collected $3.10 from pot
*** SUMMARY ***
Total pot $3.25 | Rake $0.15 
Board [Ts 7d Td 5h 9d]
Seat 2: ghNKXUBl/H+t83JF079ZBA folded before Flop (didn't bet)
Seat 3: dYvYZ723QlKIPiDa0pkedQ folded before Flop (didn't bet)
Seat 4: dfNim92Z6XK1/h5SFW5vDg folded before Flop (didn't bet)
Seat 5: ljemhp25Zg+nlA9DLCIiUw (button) folded before Flop (didn't bet)
Seat 6: 4Ax0vobe1rLVIGZmkFINGA (small blind) folded on the River
Seat 7: YwDw9cMqkbMznFK77rru4A (big blind) folded before Flop
Seat 8: DdPXdieucQ+n99u1n3A+rQ folded before Flop (didn't bet)
Seat 9: V6p0jQ/RhUsqpHLmXvEX4Q collected ($3.10)




PokerStars Game #59941794642:  Hold'em No Limit ($0.10/$0.25) - 2009/07/01 1:46:22 ET
Table '/JJyyIstHfkT7t/bW+WXgg' 6-max Seat #2 is the button
Seat 2: obJgSnVgWWWaAUtVILo77Q ($17.65 in chips) 
Seat 3: DR0nVIhVP77oEBlO9J8vlg ($36.85 in chips) 
Seat 4: JFIAqU8lCZ0vWwEl4bdGsg ($36.15 in chips) 
Seat 5: +ZlnqPoP3Hg4BIUxDfKd/A ($46.20 in chips) 
Seat 6: UmcUp27+PbgBItv3ZNlAWQ ($25 in chips) 
DR0nVIhVP77oEBlO9J8vlg: posts small blind $0.10
JFIAqU8lCZ0vWwEl4bdGsg: posts big blind $0.25
xC0kaiDYM6YTlgODL83O5A: sits out 
*** HOLE CARDS ***
+ZlnqPoP3Hg4BIUxDfKd/A: folds 
UmcUp27+PbgBItv3ZNlAWQ: folds 
obJgSnVgWWWaAUtVILo77Q: raises $0.50 to $0.75
DR0nVIhVP77oEBlO9J8vlg: folds 
JFIAqU8lCZ0vWwEl4bdGsg: folds 
Uncalled bet ($0.50) returned to obJgSnVgWWWaAUtVILo77Q
obJgSnVgWWWaAUtVILo77Q collected $0.60 from pot
obJgSnVgWWWaAUtVILo77Q: doesn't show hand 
*** SUMMARY ***
Total pot $0.60 | Rake $0 
Seat 2: obJgSnVgWWWaAUtVILo77Q (button) collected ($0.60)
Seat 3: DR0nVIhVP77oEBlO9J8vlg (small blind) folded before Flop
Seat 4: JFIAqU8lCZ0vWwEl4bdGsg (big blind) folded before Flop
Seat 5: +ZlnqPoP3Hg4BIUxDfKd/A folded before Flop (didn't bet)
Seat 6: UmcUp27+PbgBItv3ZNlAWQ folded before Flop (didn't bet)




PokerStars Game #59941795154:  Hold'em No Limit ($0.10/$0.25) - 2009/07/01 1:46:23 ET
Table 'g6ryG70feTw9nNm+XJLuXw' 6-max Seat #2 is the button
Seat 1: v+QfkGiuj9bgtuNoVnDO8w ($35.25 in chips) 
Seat 2: SxIIgwXYLkwd6m3wLyPTCw ($32.75 in chips) 
Seat 3: cezpHJ8FB07dj0xG+LhOvw ($25.10 in chips) 
Seat 4: GC/9yVD59DUCX7hUI7gcLw ($45.85 in chips) 
Seat 5: EE16Ua5b1HSsYej5zeXOlA ($25.35 in chips) 
cezpHJ8FB07dj0xG+LhOvw: posts small blind $0.10
GC/9yVD59DUCX7hUI7gcLw: posts big blind $0.25
Mhj3q7cxev+XjXZxEE6/Cw: sits out 
*** HOLE CARDS ***
EE16Ua5b1HSsYej5zeXOlA: folds 
v+QfkGiuj9bgtuNoVnDO8w: folds 
SxIIgwXYLkwd6m3wLyPTCw: raises $0.50 to $0.75
cezpHJ8FB07dj0xG+LhOvw: folds 
GC/9yVD59DUCX7hUI7gcLw: calls $0.50
*** FLOP *** [Tc 7h 9c]
GC/9yVD59DUCX7hUI7gcLw: checks 
SxIIgwXYLkwd6m3wLyPTCw: bets $1.25
GC/9yVD59DUCX7hUI7gcLw: folds 
Uncalled bet ($1.25) returned to SxIIgwXYLkwd6m3wLyPTCw
SxIIgwXYLkwd6m3wLyPTCw collected $1.55 from pot
SxIIgwXYLkwd6m3wLyPTCw: doesn't show hand 
*** SUMMARY ***
Total pot $1.60 | Rake $0.05 
Board [Tc 7h 9c]
Seat 1: v+QfkGiuj9bgtuNoVnDO8w folded before Flop (didn't bet)
Seat 2: SxIIgwXYLkwd6m3wLyPTCw (button) collected ($1.55)
Seat 3: cezpHJ8FB07dj0xG+LhOvw (small blind) folded before Flop
Seat 4: GC/9yVD59DUCX7hUI7gcLw (big blind) folded on the Flop
Seat 5: EE16Ua5b1HSsYej5zeXOlA folded before Flop (didn't bet)




PokerStars Game #59941795298:  Hold'em No Limit ($0.10/$0.25) - 2009/07/01 1:46:23 ET
Table 'ER5H84HUgJx7HyDLnELLeA' 6-max Seat #2 is the button
Seat 1: LJI7A1YgDM7hgh7o56+ReQ ($27.15 in chips) 
Seat 2: buyjetgNT1McXtdaP4zynA ($19.75 in chips) 
Seat 4: vqWjZmdQu/Hxw96/IJTWdQ ($25 in chips) 
Seat 5: mfrkWA3PTeYPkbO6hi98Aw ($26.70 in chips) 
Seat 6: 3zD3qLXT1bEffAoWGnc7wg ($51 in chips) 
h8w8ting will be allowed to play after the button
vqWjZmdQu/Hxw96/IJTWdQ: posts small blind $0.10
mfrkWA3PTeYPkbO6hi98Aw: posts big blind $0.25
*** HOLE CARDS ***
3zD3qLXT1bEffAoWGnc7wg: folds 
h8w8ting leaves the table
LJI7A1YgDM7hgh7o56+ReQ: raises $0.50 to $0.75
buyjetgNT1McXtdaP4zynA has timed out
buyjetgNT1McXtdaP4zynA: folds 
buyjetgNT1McXtdaP4zynA is sitting out
buyjetgNT1McXtdaP4zynA has returned
vqWjZmdQu/Hxw96/IJTWdQ: folds 
mfrkWA3PTeYPkbO6hi98Aw: folds 
Uncalled bet ($0.50) returned to LJI7A1YgDM7hgh7o56+ReQ
cS21pIxRHx5Gt42o7hPZzw joins the table at seat #3 
LJI7A1YgDM7hgh7o56+ReQ collected $0.60 from pot
LJI7A1YgDM7hgh7o56+ReQ: doesn't show hand 
*** SUMMARY ***
Total pot $0.60 | Rake $0 
Seat 1: LJI7A1YgDM7hgh7o56+ReQ collected ($0.60)
Seat 2: buyjetgNT1McXtdaP4zynA (button) folded before Flop (didn't bet)
Seat 4: vqWjZmdQu/Hxw96/IJTWdQ (small blind) folded before Flop
Seat 5: mfrkWA3PTeYPkbO6hi98Aw (big blind) folded before Flop
Seat 6: 3zD3qLXT1bEffAoWGnc7wg folded before Flop (didn't bet)




PokerStars Game #59941795114:  Hold'em No Limit ($0.10/$0.25) - 2009/07/01 1:46:23 ET
Table 'VuY5ej47Cy8nOI3Wogmhzw' 6-max Seat #1 is the button
Seat 1: EeUZtMU058v2ObUACOF4Og ($37.50 in chips) 
Seat 2: AM6Yl+3esmhhMBlSnQhWbg ($17.60 in chips) 
Seat 3: v+QfkGiuj9bgtuNoVnDO8w ($41.45 in chips) 
Seat 4: QqiZLFrN8iOUT/GHw7ztOA ($25 in chips) 
Seat 6: +KblIivb6tainScpwm14RQ ($6.75 in chips) 
AM6Yl+3esmhhMBlSnQhWbg: posts small blind $0.10
v+QfkGiuj9bgtuNoVnDO8w: posts big blind $0.25
*** HOLE CARDS ***
iK/41//HmnLiIn0CVNNfyA leaves the table
QqiZLFrN8iOUT/GHw7ztOA: folds 
+KblIivb6tainScpwm14RQ: folds 
EeUZtMU058v2ObUACOF4Og: raises $0.75 to $1
j0aDOn9Nft1HLTQvGu1UwA joins the table at seat #5 
AM6Yl+3esmhhMBlSnQhWbg: raises $1 to $2
v+QfkGiuj9bgtuNoVnDO8w: folds 
EeUZtMU058v2ObUACOF4Og: calls $1
*** FLOP *** [Ad 3s 4d]
AM6Yl+3esmhhMBlSnQhWbg: bets $2
EeUZtMU058v2ObUACOF4Og: calls $2
*** TURN *** [Ad 3s 4d] [7d]
AM6Yl+3esmhhMBlSnQhWbg: checks 
EeUZtMU058v2ObUACOF4Og: bets $2
AM6Yl+3esmhhMBlSnQhWbg: folds 
Uncalled bet ($2) returned to EeUZtMU058v2ObUACOF4Og
EeUZtMU058v2ObUACOF4Og collected $7.85 from pot
EeUZtMU058v2ObUACOF4Og: doesn't show hand 
*** SUMMARY ***
Total pot $8.25 | Rake $0.40 
Board [Ad 3s 4d 7d]
Seat 1: EeUZtMU058v2ObUACOF4Og (button) collected ($7.85)
Seat 2: AM6Yl+3esmhhMBlSnQhWbg (small blind) folded on the Turn
Seat 3: v+QfkGiuj9bgtuNoVnDO8w (big blind) folded before Flop
Seat 4: QqiZLFrN8iOUT/GHw7ztOA folded before Flop (didn't bet)
Seat 6: +KblIivb6tainScpwm14RQ folded before Flop (didn't bet)




PokerStars Game #59941795276:  Hold'em No Limit ($0.10/$0.25) - 2009/07/01 1:46:23 ET
Table '972HGIb0tQN/zRIK4TABEw' 9-max Seat #4 is the button
Seat 1: fHr2+mGa0RFK3qrpZcVUAQ ($6.85 in chips) 
Seat 3: aNpwfA31EREwO+ar4XzBCw ($25 in chips) 
Seat 4: Bb42QRQMhg5/Y0vHP8/2Xw ($25 in chips) 
Seat 5: swK30YlQuxRQO7QFr4ZxCA ($45.80 in chips) 
Seat 7: qS+jfnNoG75bT+uQ8CKhQA ($14.75 in chips) 
Seat 8: sGFnnRCa1YAHAUmWgsW6Qg ($8.80 in chips) 
Seat 9: 3PmVnC/15cl4oyI1TKIt4g ($3.95 in chips) 
swK30YlQuxRQO7QFr4ZxCA: posts small blind $0.10
qS+jfnNoG75bT+uQ8CKhQA: posts big blind $0.25
*** HOLE CARDS ***
sGFnnRCa1YAHAUmWgsW6Qg: folds 
3PmVnC/15cl4oyI1TKIt4g: folds 
fHr2+mGa0RFK3qrpZcVUAQ: folds 
Teresa777 has returned
rintinton leaves the table
aNpwfA31EREwO+ar4XzBCw: raises $0.75 to $1
Bb42QRQMhg5/Y0vHP8/2Xw: folds 
swK30YlQuxRQO7QFr4ZxCA: folds 
qS+jfnNoG75bT+uQ8CKhQA: folds 
Uncalled bet ($0.75) returned to aNpwfA31EREwO+ar4XzBCw
Teresa777 leaves the table
aNpwfA31EREwO+ar4XzBCw collected $0.60 from pot
aNpwfA31EREwO+ar4XzBCw: doesn't show hand 
*** SUMMARY ***
Total pot $0.60 | Rake $0 
Seat 1: fHr2+mGa0RFK3qrpZcVUAQ folded before Flop (didn't bet)
Seat 3: aNpwfA31EREwO+ar4XzBCw collected ($0.60)
Seat 4: Bb42QRQMhg5/Y0vHP8/2Xw (button) folded before Flop (didn't bet)
Seat 5: swK30YlQuxRQO7QFr4ZxCA (small blind) folded before Flop
Seat 7: qS+jfnNoG75bT+uQ8CKhQA (big blind) folded before Flop
Seat 8: sGFnnRCa1YAHAUmWgsW6Qg folded before Flop (didn't bet)
Seat 9: 3PmVnC/15cl4oyI1TKIt4g folded before Flop (didn't bet)




PokerStars Game #59941795232:  Hold'em No Limit ($0.10/$0.25) - 2009/07/01 1:46:23 ET
Table 'fHv1Mk7ZbLjprZTGWKPiEQ' 6-max Seat #6 is the button
Seat 1: OIjOiBfQstWrK/RuXx7zcw ($2.75 in chips) 
Seat 2: 9U3ZKjCsarN0DjR6mSE8Ug ($14.80 in chips) 
Seat 3: /gJNBeCkWL4o85/jvlZ4BA ($25 in chips) 
Seat 4: TSmua8tGK3sTbwi0ynrW9Q ($58.80 in chips) 
Seat 5: LJI7A1YgDM7hgh7o56+ReQ ($26.30 in chips) 
Seat 6: AjG0X+rNtc2W08eph8oqpw ($53.40 in chips) 
OIjOiBfQstWrK/RuXx7zcw: posts small blind $0.10
9U3ZKjCsarN0DjR6mSE8Ug: posts big blind $0.25
*** HOLE CARDS ***
/gJNBeCkWL4o85/jvlZ4BA: folds 
TSmua8tGK3sTbwi0ynrW9Q: folds 
LJI7A1YgDM7hgh7o56+ReQ: folds 
AjG0X+rNtc2W08eph8oqpw: folds 
AjG0X+rNtc2W08eph8oqpw said, "ty"
OIjOiBfQstWrK/RuXx7zcw: raises $0.25 to $0.50
9U3ZKjCsarN0DjR6mSE8Ug: calls $0.25
*** FLOP *** [Jd 5d Kh]
OIjOiBfQstWrK/RuXx7zcw: bets $0.25
9U3ZKjCsarN0DjR6mSE8Ug: folds 
Uncalled bet ($0.25) returned to OIjOiBfQstWrK/RuXx7zcw
OIjOiBfQstWrK/RuXx7zcw collected $0.95 from pot
OIjOiBfQstWrK/RuXx7zcw: doesn't show hand 
*** SUMMARY ***
Total pot $1 | Rake $0.05 
Board [Jd 5d Kh]
Seat 1: OIjOiBfQstWrK/RuXx7zcw (small blind) collected ($0.95)
Seat 2: 9U3ZKjCsarN0DjR6mSE8Ug (big blind) folded on the Flop
Seat 3: /gJNBeCkWL4o85/jvlZ4BA folded before Flop (didn't bet)
Seat 4: TSmua8tGK3sTbwi0ynrW9Q folded before Flop (didn't bet)
Seat 5: LJI7A1YgDM7hgh7o56+ReQ folded before Flop (didn't bet)
Seat 6: AjG0X+rNtc2W08eph8oqpw (button) folded before Flop (didn't bet)




PokerStars Game #59941795798:  Hold'em No Limit ($0.10/$0.25) - 2009/07/01 1:46:24 ET
Table 'Loy/olZ5qoDOSvX4UTujGg' 6-max Seat #2 is the button
Seat 1: HipgaJhkN4ie/tTw4dK3Ug ($11.50 in chips) 
Seat 2: 4z7mPbMLNp4TezHXin63Vw ($16.05 in chips) 
Seat 3: 32YL2ZEp8NT4JB2RVM9euQ ($15.45 in chips) 
Seat 4: /gJNBeCkWL4o85/jvlZ4BA ($31.10 in chips) 
Seat 5: Ar4vsUIUfJ7gbYh1c1m59g ($14.75 in chips) 
Seat 6: qGHGf/553gQnDoklMRe3tg ($26.15 in chips) 
32YL2ZEp8NT4JB2RVM9euQ: posts small blind $0.10
/gJNBeCkWL4o85/jvlZ4BA: posts big blind $0.25
*** HOLE CARDS ***
HipgaJhkN4ie/tTw4dK3Ug said, "and you /gJNBeCkWL4o85/jvlZ4BA"
Ar4vsUIUfJ7gbYh1c1m59g: folds 
qGHGf/553gQnDoklMRe3tg: folds 
HipgaJhkN4ie/tTw4dK3Ug: raises $0.25 to $0.50
4z7mPbMLNp4TezHXin63Vw: calls $0.50
32YL2ZEp8NT4JB2RVM9euQ: folds 
/gJNBeCkWL4o85/jvlZ4BA: folds 
*** FLOP *** [Ad Qh 5h]
HipgaJhkN4ie/tTw4dK3Ug: checks 
4z7mPbMLNp4TezHXin63Vw: checks 
*** TURN *** [Ad Qh 5h] [Ks]
HipgaJhkN4ie/tTw4dK3Ug: bets $0.25
4z7mPbMLNp4TezHXin63Vw: calls $0.25
*** RIVER *** [Ad Qh 5h Ks] [2c]
HipgaJhkN4ie/tTw4dK3Ug: bets $0.50
4z7mPbMLNp4TezHXin63Vw: folds 
Uncalled bet ($0.50) returned to HipgaJhkN4ie/tTw4dK3Ug
HipgaJhkN4ie/tTw4dK3Ug collected $1.80 from pot
*** SUMMARY ***
Total pot $1.85 | Rake $0.05 
Board [Ad Qh 5h Ks 2c]
Seat 1: HipgaJhkN4ie/tTw4dK3Ug collected ($1.80)
Seat 2: 4z7mPbMLNp4TezHXin63Vw (button) folded on the River
Seat 3: 32YL2ZEp8NT4JB2RVM9euQ (small blind) folded before Flop
Seat 4: /gJNBeCkWL4o85/jvlZ4BA (big blind) folded before Flop
Seat 5: Ar4vsUIUfJ7gbYh1c1m59g folded before Flop (didn't bet)
Seat 6: qGHGf/553gQnDoklMRe3tg folded before Flop (didn't bet)




PokerStars Game #59941795608:  Hold'em No Limit ($0.10/$0.25) - 2009/07/01 1:46:24 ET
Table '9o8Yb3JpUqurD4pNVmOikQ' 6-max Seat #1 is the button
Seat 1: SFmT9ZsVopnukjvAzrxTRg ($27.20 in chips) 
Seat 2: /gJNBeCkWL4o85/jvlZ4BA ($25.35 in chips) 
Seat 3: JgRqo1/2phbf7pab7N3BIQ ($23.85 in chips) 
Seat 4: j5NZbEJHsERuXjPHWqc1Nw ($11 in chips) 
Seat 5: QqiZLFrN8iOUT/GHw7ztOA ($24.15 in chips) 
Seat 6: LyDHtw3/yniNHW+DvLXbog ($25.70 in chips) 
/gJNBeCkWL4o85/jvlZ4BA: posts small blind $0.10
JgRqo1/2phbf7pab7N3BIQ: posts big blind $0.25
*** HOLE CARDS ***
j5NZbEJHsERuXjPHWqc1Nw: raises $0.75 to $1
QqiZLFrN8iOUT/GHw7ztOA: folds 
LyDHtw3/yniNHW+DvLXbog: folds 
SFmT9ZsVopnukjvAzrxTRg: folds 
/gJNBeCkWL4o85/jvlZ4BA: folds 
JgRqo1/2phbf7pab7N3BIQ: folds 
Uncalled bet ($0.75) returned to j5NZbEJHsERuXjPHWqc1Nw
j5NZbEJHsERuXjPHWqc1Nw collected $0.60 from pot
*** SUMMARY ***
Total pot $0.60 | Rake $0 
Seat 1: SFmT9ZsVopnukjvAzrxTRg (button) folded before Flop (didn't bet)
Seat 2: /gJNBeCkWL4o85/jvlZ4BA (small blind) folded before Flop
Seat 3: JgRqo1/2phbf7pab7N3BIQ (big blind) folded before Flop
Seat 4: j5NZbEJHsERuXjPHWqc1Nw collected ($0.60)
Seat 5: QqiZLFrN8iOUT/GHw7ztOA folded before Flop (didn't bet)
Seat 6: LyDHtw3/yniNHW+DvLXbog folded before Flop (didn't bet)




PokerStars Game #59941795658:  Hold'em No Limit ($0.10/$0.25) - 2009/07/01 1:46:24 ET
Table 'SbSV5tlgLp0+/Z+13PW3Hg' 9-max Seat #9 is the button
Seat 1: x+W5+3qsdY4Iszf0hoH+Aw ($17.30 in chips) 
Seat 3: CT7Xj/V/O5rBlhtt+RZeFQ ($25.95 in chips) 
Seat 4: puj3K/wrNjEj86ZL/MyfLA ($9.65 in chips) 
Seat 5: aNpwfA31EREwO+ar4XzBCw ($25 in chips) 
Seat 6: pN3IHvAKm2fz+sTRARTcrg ($25.40 in chips) 
Seat 8: qBdqLaJhO+1itcMk70bsfA ($8.40 in chips) 
Seat 9: X78b5v/uhqeXXoAijbw/yg ($25 in chips) 
x+W5+3qsdY4Iszf0hoH+Aw: posts small blind $0.10
CT7Xj/V/O5rBlhtt+RZeFQ: posts big blind $0.25
3PmVnC/15cl4oyI1TKIt4g: sits out 
*** HOLE CARDS ***
puj3K/wrNjEj86ZL/MyfLA: raises $0.50 to $0.75
aNpwfA31EREwO+ar4XzBCw: folds 
pN3IHvAKm2fz+sTRARTcrg: folds 
qBdqLaJhO+1itcMk70bsfA: calls $0.75
X78b5v/uhqeXXoAijbw/yg: folds 
x+W5+3qsdY4Iszf0hoH+Aw: raises $2 to $2.75
CT7Xj/V/O5rBlhtt+RZeFQ: folds 
puj3K/wrNjEj86ZL/MyfLA: folds 
qBdqLaJhO+1itcMk70bsfA: folds 
Uncalled bet ($2) returned to x+W5+3qsdY4Iszf0hoH+Aw
x+W5+3qsdY4Iszf0hoH+Aw collected $2.50 from pot
x+W5+3qsdY4Iszf0hoH+Aw: doesn't show hand 
*** SUMMARY ***
Total pot $2.50 | Rake $0 
Seat 1: x+W5+3qsdY4Iszf0hoH+Aw (small blind) collected ($2.50)
Seat 3: CT7Xj/V/O5rBlhtt+RZeFQ (big blind) folded before Flop
Seat 4: puj3K/wrNjEj86ZL/MyfLA folded before Flop
Seat 5: aNpwfA31EREwO+ar4XzBCw folded before Flop (didn't bet)
Seat 6: pN3IHvAKm2fz+sTRARTcrg folded before Flop (didn't bet)
Seat 8: qBdqLaJhO+1itcMk70bsfA folded before Flop
Seat 9: X78b5v/uhqeXXoAijbw/yg (button) folded before Flop (didn't bet)




PokerStars Game #59941795414:  Hold'em No Limit ($0.10/$0.25) - 2009/07/01 1:46:24 ET
Table 'tErGGDyESv/0llKumVeZuQ' 9-max Seat #4 is the button
Seat 1: 3PmVnC/15cl4oyI1TKIt4g ($5 in chips) 
Seat 2: pN3IHvAKm2fz+sTRARTcrg ($28.85 in chips) 
Seat 4: yqkowiRWZ6NvRN9UUkYIlA ($5 in chips) 
Seat 5: 6RQUxA3jk+ePxB/+Hc0IKw ($12.10 in chips) 
Seat 7: uhrboV251dcgYniYTdFIcA ($29.15 in chips) 
Seat 8: clJsV3v77RS07bDKY+705w ($5 in chips) 
Seat 9: d6n762oPkegG086ZJyV5MA ($18.60 in chips) 
6RQUxA3jk+ePxB/+Hc0IKw: posts small blind $0.10
uhrboV251dcgYniYTdFIcA: posts big blind $0.25
qwr38jl5txoR36M7G5qi4A: sits out 
*** HOLE CARDS ***
clJsV3v77RS07bDKY+705w: folds 
d6n762oPkegG086ZJyV5MA: raises $1 to $1.25
3PmVnC/15cl4oyI1TKIt4g: folds 
pN3IHvAKm2fz+sTRARTcrg: folds 
yqkowiRWZ6NvRN9UUkYIlA: folds 
6RQUxA3jk+ePxB/+Hc0IKw: folds 
uhrboV251dcgYniYTdFIcA: folds 
Uncalled bet ($1) returned to d6n762oPkegG086ZJyV5MA
d6n762oPkegG086ZJyV5MA collected $0.60 from pot
d6n762oPkegG086ZJyV5MA: doesn't show hand 
*** SUMMARY ***
Total pot $0.60 | Rake $0 
Seat 1: 3PmVnC/15cl4oyI1TKIt4g folded before Flop (didn't bet)
Seat 2: pN3IHvAKm2fz+sTRARTcrg folded before Flop (didn't bet)
Seat 4: yqkowiRWZ6NvRN9UUkYIlA (button) folded before Flop (didn't bet)
Seat 5: 6RQUxA3jk+ePxB/+Hc0IKw (small blind) folded before Flop
Seat 7: uhrboV251dcgYniYTdFIcA (big blind) folded before Flop
Seat 8: clJsV3v77RS07bDKY+705w folded before Flop (didn't bet)
Seat 9: d6n762oPkegG086ZJyV5MA collected ($0.60)




PokerStars Game #59941795438:  Hold'em No Limit ($0.10/$0.25) - 2009/07/01 1:46:24 ET
Table '/VaaaFnlEJoYVomG9uxHkA' 9-max Seat #2 is the button
Seat 1: Th3FldXKQW6hWVVPahaoOQ ($30.90 in chips) 
Seat 2: DIkeSkosO/tsUp9d2JVyTA ($50.55 in chips) 
Seat 3: MtVtHDqIJTyUcXkRBBDIVA ($26.25 in chips) 
Seat 4: j4q3p0lesp63b1gZDwLBZw ($5 in chips) 
Seat 5: cZ99hugmLBj9KhTlc8nCSw ($25 in chips) 
Seat 7: F7pnn6czNpHvRM55XcA2EA ($31.60 in chips) 
Seat 8: dfNim92Z6XK1/h5SFW5vDg ($45.75 in chips) 
MtVtHDqIJTyUcXkRBBDIVA: posts small blind $0.10
j4q3p0lesp63b1gZDwLBZw: posts big blind $0.25
DdPXdieucQ+n99u1n3A+rQ: sits out 
*** HOLE CARDS ***
cZ99hugmLBj9KhTlc8nCSw: folds 
F7pnn6czNpHvRM55XcA2EA: folds 
dfNim92Z6XK1/h5SFW5vDg: folds 
Th3FldXKQW6hWVVPahaoOQ: raises $0.75 to $1
DIkeSkosO/tsUp9d2JVyTA: calls $1
MtVtHDqIJTyUcXkRBBDIVA: folds 
j4q3p0lesp63b1gZDwLBZw: folds 
*** FLOP *** [9c Ad 4h]
Th3FldXKQW6hWVVPahaoOQ: bets $1.25
DIkeSkosO/tsUp9d2JVyTA: calls $1.25
*** TURN *** [9c Ad 4h] [4d]
Th3FldXKQW6hWVVPahaoOQ: checks 
DIkeSkosO/tsUp9d2JVyTA: bets $2
Th3FldXKQW6hWVVPahaoOQ: calls $2
*** RIVER *** [9c Ad 4h 4d] [3s]
Th3FldXKQW6hWVVPahaoOQ: checks 
DIkeSkosO/tsUp9d2JVyTA: checks 
*** SHOW DOWN ***
Th3FldXKQW6hWVVPahaoOQ: shows [Qs Qh] (two pair, Queens and Fours)
DIkeSkosO/tsUp9d2JVyTA: shows [8d Ah] (two pair, Aces and Fours)
DIkeSkosO/tsUp9d2JVyTA collected $8.45 from pot
*** SUMMARY ***
Total pot $8.85 | Rake $0.40 
Board [9c Ad 4h 4d 3s]
Seat 1: Th3FldXKQW6hWVVPahaoOQ showed [Qs Qh] and lost with two pair, Queens and Fours
Seat 2: DIkeSkosO/tsUp9d2JVyTA (button) showed [8d Ah] and won ($8.45) with two pair, Aces and Fours
Seat 3: MtVtHDqIJTyUcXkRBBDIVA (small blind) folded before Flop
Seat 4: j4q3p0lesp63b1gZDwLBZw (big blind) folded before Flop
Seat 5: cZ99hugmLBj9KhTlc8nCSw folded before Flop (didn't bet)
Seat 7: F7pnn6czNpHvRM55XcA2EA folded before Flop (didn't bet)
Seat 8: dfNim92Z6XK1/h5SFW5vDg folded before Flop (didn't bet)




PokerStars Game #59941795590:  Hold'em No Limit ($0.10/$0.25) - 2009/07/01 1:46:24 ET
Table 'luMgmRPIo47e7iXDlheIwA' 6-max Seat #5 is the button
Seat 1: EQ3WxdGe/KZrM6Lx4T02sg ($38.60 in chips) 
Seat 2: NhUN/JpAprdJeamFBgJH1w ($25 in chips) 
Seat 4: xrf8tAXKQHG99HixCot1Iw ($26.25 in chips) 
Seat 5: cWc85bEzdRzpUMhRKm8pwQ ($43.65 in chips) 
Seat 6: qGHGf/553gQnDoklMRe3tg ($24.65 in chips) 
qGHGf/553gQnDoklMRe3tg: posts small blind $0.10
EQ3WxdGe/KZrM6Lx4T02sg: posts big blind $0.25
w43JQj2oYPpKQVG4Yzlq1w: sits out 
*** HOLE CARDS ***
NhUN/JpAprdJeamFBgJH1w: folds 
xrf8tAXKQHG99HixCot1Iw: folds 
cWc85bEzdRzpUMhRKm8pwQ: folds 
qGHGf/553gQnDoklMRe3tg: folds 
Uncalled bet ($0.15) returned to EQ3WxdGe/KZrM6Lx4T02sg
EQ3WxdGe/KZrM6Lx4T02sg collected $0.20 from pot
*** SUMMARY ***
Total pot $0.20 | Rake $0 
Seat 1: EQ3WxdGe/KZrM6Lx4T02sg (big blind) collected ($0.20)
Seat 2: NhUN/JpAprdJeamFBgJH1w folded before Flop (didn't bet)
Seat 4: xrf8tAXKQHG99HixCot1Iw folded before Flop (didn't bet)
Seat 5: cWc85bEzdRzpUMhRKm8pwQ (button) folded before Flop (didn't bet)
Seat 6: qGHGf/553gQnDoklMRe3tg (small blind) folded before Flop




PokerStars Game #59941795742:  Hold'em No Limit ($0.10/$0.25) - 2009/07/01 1:46:24 ET
Table 'oJpFwZj9+FUGHX90Un8s9Q' 6-max Seat #2 is the button
Seat 1: 6DwBRH+xZ12AAZmeAg+aXw ($23.55 in chips) 
Seat 2: NtrVQ9UIql0rDCnKDKZ5FQ ($15.70 in chips) 
Seat 3: kyRaCIljYA6l33lSKQfNsg ($26 in chips) 
Seat 4: 6elpmfyt4Zw0yvd8lePSMQ ($21.55 in chips) 
Seat 5: kG34n23qFQA3nzdOJTQ1dA ($55.80 in chips) 
kyRaCIljYA6l33lSKQfNsg: posts small blind $0.10
6elpmfyt4Zw0yvd8lePSMQ: posts big blind $0.25
7LpHJVeM6k1mQdC6HXYzww: sits out 
*** HOLE CARDS ***
kG34n23qFQA3nzdOJTQ1dA: folds 
6DwBRH+xZ12AAZmeAg+aXw: folds 
NtrVQ9UIql0rDCnKDKZ5FQ: folds 
kyRaCIljYA6l33lSKQfNsg: folds 
Uncalled bet ($0.15) returned to 6elpmfyt4Zw0yvd8lePSMQ
6elpmfyt4Zw0yvd8lePSMQ collected $0.20 from pot
6elpmfyt4Zw0yvd8lePSMQ: doesn't show hand 
*** SUMMARY ***
Total pot $0.20 | Rake $0 
Seat 1: 6DwBRH+xZ12AAZmeAg+aXw folded before Flop (didn't bet)
Seat 2: NtrVQ9UIql0rDCnKDKZ5FQ (button) folded before Flop (didn't bet)
Seat 3: kyRaCIljYA6l33lSKQfNsg (small blind) folded before Flop
Seat 4: 6elpmfyt4Zw0yvd8lePSMQ (big blind) collected ($0.20)
Seat 5: kG34n23qFQA3nzdOJTQ1dA folded before Flop (didn't bet)




PokerStars Game #59941795476:  Hold'em No Limit ($0.10/$0.25) - 2009/07/01 1:46:24 ET
Table 'U0hCzoS0KCJL+eoE054K4Q' 9-max Seat #2 is the button
Seat 1: XVEauYThJRhSTUAMxB/2ow ($38.10 in chips) 
Seat 2: MG90wfSJZnOejs/KD3vlQQ ($25.70 in chips) 
Seat 3: 8Cp1H3sSs8+jTTwLfeYKcw ($26.45 in chips) 
Seat 4: Bb42QRQMhg5/Y0vHP8/2Xw ($25 in chips) 
Seat 5: zgi+EUykT/pZQpoUG6+oEg ($6 in chips) 
Seat 6: V6p0jQ/RhUsqpHLmXvEX4Q ($11.90 in chips) 
Seat 7: uetHVityNsFnyX2bBnKe2A ($18.35 in chips) 
Seat 8: K0b5wNInj6hUGRr6yzKFtw ($27.45 in chips) 
Seat 9: wGigCmBR/9XWkPpvYos3aQ ($34.80 in chips) 
8Cp1H3sSs8+jTTwLfeYKcw: posts small blind $0.10
Bb42QRQMhg5/Y0vHP8/2Xw: posts big blind $0.25
*** HOLE CARDS ***
zgi+EUykT/pZQpoUG6+oEg: folds 
V6p0jQ/RhUsqpHLmXvEX4Q: folds 
uetHVityNsFnyX2bBnKe2A: folds 
K0b5wNInj6hUGRr6yzKFtw: folds 
wGigCmBR/9XWkPpvYos3aQ: raises $0.65 to $0.90
XVEauYThJRhSTUAMxB/2ow: calls $0.90
MG90wfSJZnOejs/KD3vlQQ: calls $0.90
8Cp1H3sSs8+jTTwLfeYKcw: calls $0.80
Bb42QRQMhg5/Y0vHP8/2Xw: folds 
*** FLOP *** [Ah 4s 6s]
8Cp1H3sSs8+jTTwLfeYKcw: checks 
wGigCmBR/9XWkPpvYos3aQ: checks 
XVEauYThJRhSTUAMxB/2ow: checks 
MG90wfSJZnOejs/KD3vlQQ: checks 
*** TURN *** [Ah 4s 6s] [Kh]
8Cp1H3sSs8+jTTwLfeYKcw: checks 
wGigCmBR/9XWkPpvYos3aQ: checks 
XVEauYThJRhSTUAMxB/2ow: checks 
MG90wfSJZnOejs/KD3vlQQ: bets $2.80
8Cp1H3sSs8+jTTwLfeYKcw: folds 
wGigCmBR/9XWkPpvYos3aQ: folds 
XVEauYThJRhSTUAMxB/2ow: folds 
Uncalled bet ($2.80) returned to MG90wfSJZnOejs/KD3vlQQ
MG90wfSJZnOejs/KD3vlQQ collected $3.70 from pot
MG90wfSJZnOejs/KD3vlQQ: doesn't show hand 
*** SUMMARY ***
Total pot $3.85 | Rake $0.15 
Board [Ah 4s 6s Kh]
Seat 1: XVEauYThJRhSTUAMxB/2ow folded on the Turn
Seat 2: MG90wfSJZnOejs/KD3vlQQ (button) collected ($3.70)
Seat 3: 8Cp1H3sSs8+jTTwLfeYKcw (small blind) folded on the Turn
Seat 4: Bb42QRQMhg5/Y0vHP8/2Xw (big blind) folded before Flop
Seat 5: zgi+EUykT/pZQpoUG6+oEg folded before Flop (didn't bet)
Seat 6: V6p0jQ/RhUsqpHLmXvEX4Q folded before Flop (didn't bet)
Seat 7: uetHVityNsFnyX2bBnKe2A folded before Flop (didn't bet)
Seat 8: K0b5wNInj6hUGRr6yzKFtw folded before Flop (didn't bet)
Seat 9: wGigCmBR/9XWkPpvYos3aQ folded on the Turn




PokerStars Game #59941796006:  Hold'em No Limit ($0.10/$0.25) - 2009/07/01 1:46:25 ET
Table 'KKk6y4pAXeymxYcd0uZLqg' 9-max Seat #3 is the button
Seat 1: HPEB+AtKw1+C/cxU0o1ciw ($24.55 in chips) 
Seat 3: tLcDklc2rBORNfixyRfVfw ($25 in chips) 
Seat 4: YciNm3fUXAQaJeXG1rhrbw ($8.30 in chips) 
Seat 5: wGigCmBR/9XWkPpvYos3aQ ($38.85 in chips) 
Seat 6: QEbIGci+itdw+re8RM5fZA ($25 in chips) 
Seat 7: JjOuv8Vf56aiQjWi/rTPFA ($23.25 in chips) 
Seat 8: +2kMBNpY4nF1qNCRd8SJLA ($36.05 in chips) 
Seat 9: oLa/tXLfSLLB28mcLGrxcg ($25.45 in chips) 
YciNm3fUXAQaJeXG1rhrbw: posts small blind $0.10
wGigCmBR/9XWkPpvYos3aQ: posts big blind $0.25
*** HOLE CARDS ***
QEbIGci+itdw+re8RM5fZA: folds 
JjOuv8Vf56aiQjWi/rTPFA: folds 
+2kMBNpY4nF1qNCRd8SJLA: folds 
oLa/tXLfSLLB28mcLGrxcg: folds 
HPEB+AtKw1+C/cxU0o1ciw: raises $0.75 to $1
tLcDklc2rBORNfixyRfVfw: folds 
YciNm3fUXAQaJeXG1rhrbw: folds 
wGigCmBR/9XWkPpvYos3aQ: folds 
Uncalled bet ($0.75) returned to HPEB+AtKw1+C/cxU0o1ciw
HPEB+AtKw1+C/cxU0o1ciw collected $0.60 from pot
HPEB+AtKw1+C/cxU0o1ciw: doesn't show hand 
*** SUMMARY ***
Total pot $0.60 | Rake $0 
Seat 1: HPEB+AtKw1+C/cxU0o1ciw collected ($0.60)
Seat 3: tLcDklc2rBORNfixyRfVfw (button) folded before Flop (didn't bet)
Seat 4: YciNm3fUXAQaJeXG1rhrbw (small blind) folded before Flop
Seat 5: wGigCmBR/9XWkPpvYos3aQ (big blind) folded before Flop
Seat 6: QEbIGci+itdw+re8RM5fZA folded before Flop (didn't bet)
Seat 7: JjOuv8Vf56aiQjWi/rTPFA folded before Flop (didn't bet)
Seat 8: +2kMBNpY4nF1qNCRd8SJLA folded before Flop (didn't bet)
Seat 9: oLa/tXLfSLLB28mcLGrxcg folded before Flop (didn't bet)




PokerStars Game #59941796290:  Hold'em No Limit ($0.10/$0.25) - 2009/07/01 1:46:25 ET
Table 'IIO2q2znuuAXmiZ2qFTcmg' 6-max Seat #6 is the button
Seat 2: cS21pIxRHx5Gt42o7hPZzw ($24.30 in chips) 
Seat 5: 9U3ZKjCsarN0DjR6mSE8Ug ($15.85 in chips) 
Seat 6: aogAb4Eienxztk8p2v9VVw ($37.80 in chips) 
cS21pIxRHx5Gt42o7hPZzw: posts small blind $0.10
9U3ZKjCsarN0DjR6mSE8Ug: posts big blind $0.25
*** HOLE CARDS ***
aogAb4Eienxztk8p2v9VVw: folds 
aogAb4Eienxztk8p2v9VVw leaves the table
cS21pIxRHx5Gt42o7hPZzw: calls $0.15
9U3ZKjCsarN0DjR6mSE8Ug: checks 
*** FLOP *** [6c 3c Kh]
cS21pIxRHx5Gt42o7hPZzw: bets $0.75
9U3ZKjCsarN0DjR6mSE8Ug: folds 
Uncalled bet ($0.75) returned to cS21pIxRHx5Gt42o7hPZzw
cS21pIxRHx5Gt42o7hPZzw collected $0.50 from pot
cS21pIxRHx5Gt42o7hPZzw is sitting out
*** SUMMARY ***
Total pot $0.50 | Rake $0 
Board [6c 3c Kh]
Seat 2: cS21pIxRHx5Gt42o7hPZzw (small blind) collected ($0.50)
Seat 5: 9U3ZKjCsarN0DjR6mSE8Ug (big blind) folded on the Flop
Seat 6: aogAb4Eienxztk8p2v9VVw (button) folded before Flop (didn't bet)




PokerStars Game #59941795972:  Hold'em No Limit ($0.10/$0.25) - 2009/07/01 1:46:25 ET
Table 'NtCSSONEf1zaJo3042tQug' 6-max Seat #1 is the button
Seat 1: KXtdqb+rIMkjc0RvHDksGQ ($34.90 in chips) 
Seat 2: vqWjZmdQu/Hxw96/IJTWdQ ($26.30 in chips) 
Seat 3: 9kUKGKkblnIx3m8rlVol6Q ($15.65 in chips) 
Seat 4: HxD1kB8zCmalQSdWAkKmlg ($28.85 in chips) 
Seat 5: tOAk1Og4mVObMBOfvdDYOw ($31.55 in chips) 
Seat 6: LxehwDpTQ19ph4Qmc78+Pw ($29 in chips) 
vqWjZmdQu/Hxw96/IJTWdQ: posts small blind $0.10
9kUKGKkblnIx3m8rlVol6Q: posts big blind $0.25
*** HOLE CARDS ***
HxD1kB8zCmalQSdWAkKmlg: folds 
tOAk1Og4mVObMBOfvdDYOw: folds 
LxehwDpTQ19ph4Qmc78+Pw: folds 
KXtdqb+rIMkjc0RvHDksGQ: folds 
vqWjZmdQu/Hxw96/IJTWdQ: folds 
Uncalled bet ($0.15) returned to 9kUKGKkblnIx3m8rlVol6Q
9kUKGKkblnIx3m8rlVol6Q collected $0.20 from pot
9kUKGKkblnIx3m8rlVol6Q: doesn't show hand 
*** SUMMARY ***
Total pot $0.20 | Rake $0 
Seat 1: KXtdqb+rIMkjc0RvHDksGQ (button) folded before Flop (didn't bet)
Seat 2: vqWjZmdQu/Hxw96/IJTWdQ (small blind) folded before Flop
Seat 3: 9kUKGKkblnIx3m8rlVol6Q (big blind) collected ($0.20)
Seat 4: HxD1kB8zCmalQSdWAkKmlg folded before Flop (didn't bet)
Seat 5: tOAk1Og4mVObMBOfvdDYOw folded before Flop (didn't bet)
Seat 6: LxehwDpTQ19ph4Qmc78+Pw folded before Flop (didn't bet)




PokerStars Game #59941796240:  Hold'em No Limit ($0.10/$0.25) - 2009/07/01 1:46:25 ET
Table 'mVdLgAdN9rGe6mMwSrDdGQ' 6-max Seat #5 is the button
Seat 1: OyJ0KTHA5cwh0/yCo1/rdA ($19.05 in chips) 
Seat 2: n9QqWD4tpbongUBX2Oi58w ($6.20 in chips) 
Seat 3: +baiVgI/ETnBARLe5mARCw ($13.95 in chips) 
Seat 4: scNSjC6yyKvvfklSkuzLrw ($9.30 in chips) 
Seat 5: +TMG/MBWpiEnc9t7i07eTA ($26.65 in chips) 
Seat 6: DihMHaz4WNETH1bPDe13kA ($47.55 in chips) 
DihMHaz4WNETH1bPDe13kA: posts small blind $0.10
OyJ0KTHA5cwh0/yCo1/rdA: posts big blind $0.25
*** HOLE CARDS ***
n9QqWD4tpbongUBX2Oi58w: calls $0.25
+baiVgI/ETnBARLe5mARCw: folds 
scNSjC6yyKvvfklSkuzLrw: calls $0.25
+TMG/MBWpiEnc9t7i07eTA: calls $0.25
DihMHaz4WNETH1bPDe13kA: folds 
OyJ0KTHA5cwh0/yCo1/rdA: checks 
*** FLOP *** [6h Kc 3h]
OyJ0KTHA5cwh0/yCo1/rdA: checks 
n9QqWD4tpbongUBX2Oi58w: checks 
scNSjC6yyKvvfklSkuzLrw: bets $0.75
+TMG/MBWpiEnc9t7i07eTA: folds 
OyJ0KTHA5cwh0/yCo1/rdA: raises $1.75 to $2.50
n9QqWD4tpbongUBX2Oi58w: folds 
scNSjC6yyKvvfklSkuzLrw: calls $1.75
*** TURN *** [6h Kc 3h] [9d]
OyJ0KTHA5cwh0/yCo1/rdA: bets $5.25
scNSjC6yyKvvfklSkuzLrw: raises $1.30 to $6.55 and is all-in
OyJ0KTHA5cwh0/yCo1/rdA: calls $1.30
*** RIVER *** [6h Kc 3h 9d] [Ts]
*** SHOW DOWN ***
OyJ0KTHA5cwh0/yCo1/rdA: shows [Ks 6c] (two pair, Kings and Sixes)
scNSjC6yyKvvfklSkuzLrw: shows [Kd 9h] (two pair, Kings and Nines)
scNSjC6yyKvvfklSkuzLrw collected $18.30 from pot
*** SUMMARY ***
Total pot $19.20 | Rake $0.90 
Board [6h Kc 3h 9d Ts]
Seat 1: OyJ0KTHA5cwh0/yCo1/rdA (big blind) showed [Ks 6c] and lost with two pair, Kings and Sixes
Seat 2: n9QqWD4tpbongUBX2Oi58w folded on the Flop
Seat 3: +baiVgI/ETnBARLe5mARCw folded before Flop (didn't bet)
Seat 4: scNSjC6yyKvvfklSkuzLrw showed [Kd 9h] and won ($18.30) with two pair, Kings and Nines
Seat 5: +TMG/MBWpiEnc9t7i07eTA (button) folded on the Flop
Seat 6: DihMHaz4WNETH1bPDe13kA (small blind) folded before Flop




PokerStars Game #59941795846:  Hold'em No Limit ($0.10/$0.25) - 2009/07/01 1:46:25 ET
Table '4XGDnEByOol5up4aB2KbJw' 6-max Seat #5 is the button
Seat 1: kyRaCIljYA6l33lSKQfNsg ($26.50 in chips) 
Seat 2: SFmT9ZsVopnukjvAzrxTRg ($46.45 in chips) 
Seat 3: LtASJ9OlkqGrrUKGQlpGAw ($20.90 in chips) 
Seat 4: BV+K0Phf5VBHr7aZPKqbUQ ($25.40 in chips) 
Seat 5: Dh01+rohD2p9pXLYeBlC5Q ($16.65 in chips) 
Seat 6: a7Ux7aERFGCbT/L3ojVfAg ($7.50 in chips) 
a7Ux7aERFGCbT/L3ojVfAg: posts small blind $0.10
kyRaCIljYA6l33lSKQfNsg: posts big blind $0.25
*** HOLE CARDS ***
SFmT9ZsVopnukjvAzrxTRg: folds 
LtASJ9OlkqGrrUKGQlpGAw: folds 
BV+K0Phf5VBHr7aZPKqbUQ: raises $0.50 to $0.75
Dh01+rohD2p9pXLYeBlC5Q: folds 
a7Ux7aERFGCbT/L3ojVfAg: calls $0.65
kyRaCIljYA6l33lSKQfNsg: folds 
*** FLOP *** [5s 8h Tc]
a7Ux7aERFGCbT/L3ojVfAg: checks 
BV+K0Phf5VBHr7aZPKqbUQ: bets $1
a7Ux7aERFGCbT/L3ojVfAg: calls $1
*** TURN *** [5s 8h Tc] [Ad]
a7Ux7aERFGCbT/L3ojVfAg: checks 
BV+K0Phf5VBHr7aZPKqbUQ: bets $1.75
a7Ux7aERFGCbT/L3ojVfAg: calls $1.75
*** RIVER *** [5s 8h Tc Ad] [5h]
a7Ux7aERFGCbT/L3ojVfAg: checks 
BV+K0Phf5VBHr7aZPKqbUQ: checks 
*** SHOW DOWN ***
a7Ux7aERFGCbT/L3ojVfAg: shows [As 8s] (two pair, Aces and Eights)
BV+K0Phf5VBHr7aZPKqbUQ: mucks hand 
a7Ux7aERFGCbT/L3ojVfAg collected $6.90 from pot
*** SUMMARY ***
Total pot $7.25 | Rake $0.35 
Board [5s 8h Tc Ad 5h]
Seat 1: kyRaCIljYA6l33lSKQfNsg (big blind) folded before Flop
Seat 2: SFmT9ZsVopnukjvAzrxTRg folded before Flop (didn't bet)
Seat 3: LtASJ9OlkqGrrUKGQlpGAw folded before Flop (didn't bet)
Seat 4: BV+K0Phf5VBHr7aZPKqbUQ mucked
Seat 5: Dh01+rohD2p9pXLYeBlC5Q (button) folded before Flop (didn't bet)
Seat 6: a7Ux7aERFGCbT/L3ojVfAg (small blind) showed [As 8s] and won ($6.90) with two pair, Aces and Eights




PokerStars Game #59941796314:  Hold'em No Limit ($0.10/$0.25) - 2009/07/01 1:46:25 ET
Table '5NipxzzFB2DffzDpddyQoQ' 6-max Seat #6 is the button
Seat 1: W87HPwOk1KtWaYyshBe1gA ($21 in chips) 
Seat 2: iauW7L/+7qzAuHow7CD75Q ($6.70 in chips) 
Seat 3: QvTX2yGq3uKJiKPmns4TKQ ($5.90 in chips) 
Seat 4: NTamLAiMZ86c5yM04t96LA ($31 in chips) 
Seat 5: faP2NVl/cFTZ1nE4pXzg8Q ($34.05 in chips) 
Seat 6: 7JqTFMyeNSVWsmp/yW35Tw ($27.30 in chips) 
W87HPwOk1KtWaYyshBe1gA: posts small blind $0.10
iauW7L/+7qzAuHow7CD75Q: posts big blind $0.25
*** HOLE CARDS ***
QvTX2yGq3uKJiKPmns4TKQ: raises $5.65 to $5.90 and is all-in
NTamLAiMZ86c5yM04t96LA: folds 
faP2NVl/cFTZ1nE4pXzg8Q: calls $5.90
7JqTFMyeNSVWsmp/yW35Tw: folds 
W87HPwOk1KtWaYyshBe1gA: folds 
iauW7L/+7qzAuHow7CD75Q: folds 
*** FLOP *** [5h Kc As]
NTamLAiMZ86c5yM04t96LA said, "55 CALLER"
*** TURN *** [5h Kc As] [Ac]
*** RIVER *** [5h Kc As Ac] [Ts]
iauW7L/+7qzAuHow7CD75Q said, "2005"
*** SHOW DOWN ***
QvTX2yGq3uKJiKPmns4TKQ: shows [Qh Ah] (three of a kind, Aces)
faP2NVl/cFTZ1nE4pXzg8Q: mucks hand 
QvTX2yGq3uKJiKPmns4TKQ collected $11.55 from pot
*** SUMMARY ***
Total pot $12.15 | Rake $0.60 
Board [5h Kc As Ac Ts]
Seat 1: W87HPwOk1KtWaYyshBe1gA (small blind) folded before Flop
Seat 2: iauW7L/+7qzAuHow7CD75Q (big blind) folded before Flop
Seat 3: QvTX2yGq3uKJiKPmns4TKQ showed [Qh Ah] and won ($11.55) with three of a kind, Aces
Seat 4: NTamLAiMZ86c5yM04t96LA folded before Flop (didn't bet)
Seat 5: faP2NVl/cFTZ1nE4pXzg8Q mucked
Seat 6: 7JqTFMyeNSVWsmp/yW35Tw (button) folded before Flop (didn't bet)




PokerStars Game #59941796762:  Hold'em No Limit ($0.10/$0.25) - 2009/07/01 1:46:26 ET
Table 'eOXPe2c6mG7DOFKvMsZZfA' 6-max Seat #3 is the button
Seat 1: s21kVGMLPAoHdWR+muSonw ($26.25 in chips) 
Seat 2: gaPMxLGp9SOj4Lq6t+/0Ig ($7.10 in chips) 
Seat 3: kReyZ6g6Fu3tQ0nyjDf9kA ($25.35 in chips) 
Seat 4: zHHLkD2sRljslKKeQv/ZQw ($35.85 in chips) 
Seat 5: NhUN/JpAprdJeamFBgJH1w ($32.30 in chips) 
Seat 6: Qpv/hb5ak7LeaDig1L5L8w ($13.60 in chips) 
zHHLkD2sRljslKKeQv/ZQw: posts small blind $0.10
NhUN/JpAprdJeamFBgJH1w: posts big blind $0.25
*** HOLE CARDS ***
Qpv/hb5ak7LeaDig1L5L8w: folds 
s21kVGMLPAoHdWR+muSonw: folds 
gaPMxLGp9SOj4Lq6t+/0Ig: folds 
kReyZ6g6Fu3tQ0nyjDf9kA: folds 
zHHLkD2sRljslKKeQv/ZQw: calls $0.15
NhUN/JpAprdJeamFBgJH1w: raises $1 to $1.25
zHHLkD2sRljslKKeQv/ZQw: calls $1
*** FLOP *** [Ks 9h 4c]
zHHLkD2sRljslKKeQv/ZQw: checks 
NhUN/JpAprdJeamFBgJH1w: checks 
*** TURN *** [Ks 9h 4c] [6s]
zHHLkD2sRljslKKeQv/ZQw: bets $0.75
NhUN/JpAprdJeamFBgJH1w: raises $2.25 to $3
zHHLkD2sRljslKKeQv/ZQw: folds 
Uncalled bet ($2.25) returned to NhUN/JpAprdJeamFBgJH1w
NhUN/JpAprdJeamFBgJH1w collected $3.85 from pot
NhUN/JpAprdJeamFBgJH1w: doesn't show hand 
*** SUMMARY ***
Total pot $4 | Rake $0.15 
Board [Ks 9h 4c 6s]
Seat 1: s21kVGMLPAoHdWR+muSonw folded before Flop (didn't bet)
Seat 2: gaPMxLGp9SOj4Lq6t+/0Ig folded before Flop (didn't bet)
Seat 3: kReyZ6g6Fu3tQ0nyjDf9kA (button) folded before Flop (didn't bet)
Seat 4: zHHLkD2sRljslKKeQv/ZQw (small blind) folded on the Turn
Seat 5: NhUN/JpAprdJeamFBgJH1w (big blind) collected ($3.85)
Seat 6: Qpv/hb5ak7LeaDig1L5L8w folded before Flop (didn't bet)




PokerStars Game #59941796672:  Hold'em No Limit ($0.10/$0.25) - 2009/07/01 1:46:26 ET
Table 'KU/HrxqxwDz8HKEhYTZ6uw' 6-max Seat #1 is the button
Seat 1: 7LKoiQHXpTQXJvWQrw907g ($37.70 in chips) 
Seat 2: kG34n23qFQA3nzdOJTQ1dA ($24.75 in chips) 
Seat 3: SFmT9ZsVopnukjvAzrxTRg ($25 in chips) 
Seat 4: AGwMM0FUhYZf81+oXvYQMg ($26.95 in chips) 
Seat 5: iyZxqznXjv3vtvOJymkoLQ ($50.90 in chips) 
Seat 6: qWxkCeqApAWdAA0evrfDvQ ($11.50 in chips) 
kG34n23qFQA3nzdOJTQ1dA: posts small blind $0.10
SFmT9ZsVopnukjvAzrxTRg: posts big blind $0.25
*** HOLE CARDS ***
AGwMM0FUhYZf81+oXvYQMg: folds 
iyZxqznXjv3vtvOJymkoLQ: folds 
qWxkCeqApAWdAA0evrfDvQ: calls $0.25
7LKoiQHXpTQXJvWQrw907g: folds 
kG34n23qFQA3nzdOJTQ1dA: folds 
SFmT9ZsVopnukjvAzrxTRg: checks 
*** FLOP *** [Tc 2s Kd]
SFmT9ZsVopnukjvAzrxTRg: checks 
qWxkCeqApAWdAA0evrfDvQ: checks 
*** TURN *** [Tc 2s Kd] [8d]
SFmT9ZsVopnukjvAzrxTRg: bets $0.50
qWxkCeqApAWdAA0evrfDvQ: folds 
Uncalled bet ($0.50) returned to SFmT9ZsVopnukjvAzrxTRg
SFmT9ZsVopnukjvAzrxTRg collected $0.60 from pot
SFmT9ZsVopnukjvAzrxTRg: doesn't show hand 
*** SUMMARY ***
Total pot $0.60 | Rake $0 
Board [Tc 2s Kd 8d]
Seat 1: 7LKoiQHXpTQXJvWQrw907g (button) folded before Flop (didn't bet)
Seat 2: kG34n23qFQA3nzdOJTQ1dA (small blind) folded before Flop
Seat 3: SFmT9ZsVopnukjvAzrxTRg (big blind) collected ($0.60)
Seat 4: AGwMM0FUhYZf81+oXvYQMg folded before Flop (didn't bet)
Seat 5: iyZxqznXjv3vtvOJymkoLQ folded before Flop (didn't bet)
Seat 6: qWxkCeqApAWdAA0evrfDvQ folded on the Turn




PokerStars Game #59941796806:  Hold'em No Limit ($0.10/$0.25) - 2009/07/01 1:46:26 ET
Table 'nlpa8xI95gAflovnFxB2yg' 6-max Seat #2 is the button
Seat 1: fZQg9veL7Dd/Z04ZTjC+wQ ($61.80 in chips) 
Seat 2: Yuyy/pDz3yAO3EbHYRYnKw ($24.40 in chips) 
Seat 3: DihMHaz4WNETH1bPDe13kA ($25 in chips) 
Seat 4: if4dh6jhJXeN3/qd3qCp9g ($52.35 in chips) 
Seat 5: FDWzjQgBA5K04jOIY/j22w ($5.80 in chips) 
Seat 6: ATNFxN8fYVfSZMQW8dvbvw ($5.65 in chips) 
DihMHaz4WNETH1bPDe13kA: posts small blind $0.10
if4dh6jhJXeN3/qd3qCp9g: posts big blind $0.25
*** HOLE CARDS ***
FDWzjQgBA5K04jOIY/j22w: raises $0.50 to $0.75
ATNFxN8fYVfSZMQW8dvbvw: folds 
fZQg9veL7Dd/Z04ZTjC+wQ: folds 
Yuyy/pDz3yAO3EbHYRYnKw: folds 
DihMHaz4WNETH1bPDe13kA: folds 
if4dh6jhJXeN3/qd3qCp9g: folds 
Uncalled bet ($0.50) returned to FDWzjQgBA5K04jOIY/j22w
FDWzjQgBA5K04jOIY/j22w collected $0.60 from pot
FDWzjQgBA5K04jOIY/j22w: doesn't show hand 
*** SUMMARY ***
Total pot $0.60 | Rake $0 
Seat 1: fZQg9veL7Dd/Z04ZTjC+wQ folded before Flop (didn't bet)
Seat 2: Yuyy/pDz3yAO3EbHYRYnKw (button) folded before Flop (didn't bet)
Seat 3: DihMHaz4WNETH1bPDe13kA (small blind) folded before Flop
Seat 4: if4dh6jhJXeN3/qd3qCp9g (big blind) folded before Flop
Seat 5: FDWzjQgBA5K04jOIY/j22w collected ($0.60)
Seat 6: ATNFxN8fYVfSZMQW8dvbvw folded before Flop (didn't bet)




PokerStars Game #59941796796:  Hold'em No Limit ($0.10/$0.25) - 2009/07/01 1:46:26 ET
Table 'nIRjSqm6RYUWJlyW2loYKA' 6-max Seat #5 is the button
Seat 1: w43JQj2oYPpKQVG4Yzlq1w ($25 in chips) 
Seat 2: NndRCAk4vU5JGDhTyy5LZg ($15.30 in chips) 
Seat 3: HbKNMWUwblC7HKtRCUhBWw ($20.45 in chips) 
Seat 4: /ZSSWvl8im2y38j1uEUAGA ($15 in chips) 
Seat 5: df01R5ThvHspD8FgKmaDvQ ($24.40 in chips) 
Seat 6: OIjOiBfQstWrK/RuXx7zcw ($5.90 in chips) 
OIjOiBfQstWrK/RuXx7zcw: posts small blind $0.10
w43JQj2oYPpKQVG4Yzlq1w: posts big blind $0.25
*** HOLE CARDS ***
NndRCAk4vU5JGDhTyy5LZg: calls $0.25
HbKNMWUwblC7HKtRCUhBWw: calls $0.25
/ZSSWvl8im2y38j1uEUAGA: raises $0.50 to $0.75
df01R5ThvHspD8FgKmaDvQ: folds 
OIjOiBfQstWrK/RuXx7zcw: calls $0.65
w43JQj2oYPpKQVG4Yzlq1w: folds 
NndRCAk4vU5JGDhTyy5LZg: calls $0.50
HbKNMWUwblC7HKtRCUhBWw: calls $0.50
*** FLOP *** [5h Kd 9c]
OIjOiBfQstWrK/RuXx7zcw: checks 
NndRCAk4vU5JGDhTyy5LZg: checks 
HbKNMWUwblC7HKtRCUhBWw: checks 
/ZSSWvl8im2y38j1uEUAGA: bets $1.25
OIjOiBfQstWrK/RuXx7zcw: folds 
NndRCAk4vU5JGDhTyy5LZg: folds 
HbKNMWUwblC7HKtRCUhBWw: calls $1.25
*** TURN *** [5h Kd 9c] [2h]
HbKNMWUwblC7HKtRCUhBWw: checks 
/ZSSWvl8im2y38j1uEUAGA: bets $3.50
HbKNMWUwblC7HKtRCUhBWw: raises $4.75 to $8.25
/ZSSWvl8im2y38j1uEUAGA: folds 
Uncalled bet ($4.75) returned to HbKNMWUwblC7HKtRCUhBWw
HbKNMWUwblC7HKtRCUhBWw collected $12.15 from pot
HbKNMWUwblC7HKtRCUhBWw: doesn't show hand 
*** SUMMARY ***
Total pot $12.75 | Rake $0.60 
Board [5h Kd 9c 2h]
Seat 1: w43JQj2oYPpKQVG4Yzlq1w (big blind) folded before Flop
Seat 2: NndRCAk4vU5JGDhTyy5LZg folded on the Flop
Seat 3: HbKNMWUwblC7HKtRCUhBWw collected ($12.15)
Seat 4: /ZSSWvl8im2y38j1uEUAGA folded on the Turn
Seat 5: df01R5ThvHspD8FgKmaDvQ (button) folded before Flop (didn't bet)
Seat 6: OIjOiBfQstWrK/RuXx7zcw (small blind) folded on the Flop




PokerStars Game #59941796366:  Hold'em No Limit ($0.10/$0.25) - 2009/07/01 1:46:26 ET
Table '4mnXP0EWt9mMZYzTIVDQ0w' 9-max Seat #6 is the button
Seat 1: Z5y2J55JmfLYR6/DPAGHwQ ($21.10 in chips) 
Seat 2: BLEU2x2bnGRovIelAY6slA ($25.15 in chips) 
Seat 4: 9lvO/qyU+xrU95Teu1fv0g ($6.50 in chips) 
Seat 5: sSN8Y0AlsBeidZXPKmwXSw ($25.10 in chips) 
Seat 6: 5yjzPss7Y4kAWNDat3e0yQ ($29.10 in chips) 
Seat 8: 9YN2IkT2JYYKFErZtZvCtA ($20.10 in chips) 
Seat 9: N/O9ADKpmqB2ASZuqgodlw ($9.40 in chips) 
9YN2IkT2JYYKFErZtZvCtA: posts small blind $0.10
N/O9ADKpmqB2ASZuqgodlw: posts big blind $0.25
ompa52: sits out 
*** HOLE CARDS ***
Z5y2J55JmfLYR6/DPAGHwQ: folds 
BLEU2x2bnGRovIelAY6slA: folds 
9lvO/qyU+xrU95Teu1fv0g: folds 
TtioUKOdJQDGtQyRAYC5Xg joins the table at seat #7 
sSN8Y0AlsBeidZXPKmwXSw: folds 
5yjzPss7Y4kAWNDat3e0yQ: calls $0.25
9YN2IkT2JYYKFErZtZvCtA: raises $0.75 to $1
N/O9ADKpmqB2ASZuqgodlw: folds 
5yjzPss7Y4kAWNDat3e0yQ: calls $0.75
*** FLOP *** [8c Kc Td]
9YN2IkT2JYYKFErZtZvCtA: bets $1.50
5yjzPss7Y4kAWNDat3e0yQ: raises $4.50 to $6
9YN2IkT2JYYKFErZtZvCtA: calls $4.50
*** TURN *** [8c Kc Td] [9s]
9YN2IkT2JYYKFErZtZvCtA: checks 
5yjzPss7Y4kAWNDat3e0yQ: bets $22.10 and is all-in
9YN2IkT2JYYKFErZtZvCtA: folds 
Uncalled bet ($22.10) returned to 5yjzPss7Y4kAWNDat3e0yQ
5yjzPss7Y4kAWNDat3e0yQ collected $13.55 from pot
5yjzPss7Y4kAWNDat3e0yQ: doesn't show hand 
*** SUMMARY ***
Total pot $14.25 | Rake $0.70 
Board [8c Kc Td 9s]
Seat 1: Z5y2J55JmfLYR6/DPAGHwQ folded before Flop (didn't bet)
Seat 2: BLEU2x2bnGRovIelAY6slA folded before Flop (didn't bet)
Seat 4: 9lvO/qyU+xrU95Teu1fv0g folded before Flop (didn't bet)
Seat 5: sSN8Y0AlsBeidZXPKmwXSw folded before Flop (didn't bet)
Seat 6: 5yjzPss7Y4kAWNDat3e0yQ (button) collected ($13.55)
Seat 8: 9YN2IkT2JYYKFErZtZvCtA (small blind) folded on the Turn
Seat 9: N/O9ADKpmqB2ASZuqgodlw (big blind) folded before Flop




PokerStars Game #59941796384:  Hold'em No Limit ($0.10/$0.25) - 2009/07/01 1:46:26 ET
Table 'by7aHYEDnDd144EXOXa/jA' 9-max Seat #3 is the button
Seat 1: j4q3p0lesp63b1gZDwLBZw ($7.65 in chips) 
Seat 2: vSkQm2EelzwRGDDQQk0Fqw ($5.60 in chips) 
Seat 3: HOEaXncFu2ij+D5/CANAZA ($11.35 in chips) 
Seat 4: 2Xwi447v1rBHM+92U0CduA ($4.50 in chips) 
Seat 5: yyG4svzOpC1A+sUP/scg6w ($4.20 in chips) 
Seat 6: sC4BsflLWW26Qm9m+1AwJQ ($14.40 in chips) 
Seat 8: 7je+LC5Mfs6nL8YBVh4frQ ($3.50 in chips) 
Seat 9: K0b5wNInj6hUGRr6yzKFtw ($25.05 in chips) 
2Xwi447v1rBHM+92U0CduA: posts small blind $0.10
yyG4svzOpC1A+sUP/scg6w: posts big blind $0.25
Z9W7+g1WMhhZDi7DwGbCFA: sits out 
*** HOLE CARDS ***
sC4BsflLWW26Qm9m+1AwJQ: calls $0.25
7je+LC5Mfs6nL8YBVh4frQ: folds 
K0b5wNInj6hUGRr6yzKFtw: folds 
j4q3p0lesp63b1gZDwLBZw: folds 
vSkQm2EelzwRGDDQQk0Fqw: raises $1 to $1.25
HOEaXncFu2ij+D5/CANAZA: folds 
2Xwi447v1rBHM+92U0CduA: folds 
yyG4svzOpC1A+sUP/scg6w: folds 
sC4BsflLWW26Qm9m+1AwJQ: calls $1
*** FLOP *** [4s 3h Qd]
sC4BsflLWW26Qm9m+1AwJQ: bets $0.75
vSkQm2EelzwRGDDQQk0Fqw: raises $1.25 to $2
sC4BsflLWW26Qm9m+1AwJQ: calls $1.25
*** TURN *** [4s 3h Qd] [8c]
sC4BsflLWW26Qm9m+1AwJQ: checks 
vSkQm2EelzwRGDDQQk0Fqw: bets $2.35 and is all-in
sC4BsflLWW26Qm9m+1AwJQ: folds 
Uncalled bet ($2.35) returned to vSkQm2EelzwRGDDQQk0Fqw
vSkQm2EelzwRGDDQQk0Fqw collected $6.55 from pot
vSkQm2EelzwRGDDQQk0Fqw: doesn't show hand 
*** SUMMARY ***
Total pot $6.85 | Rake $0.30 
Board [4s 3h Qd 8c]
Seat 1: j4q3p0lesp63b1gZDwLBZw folded before Flop (didn't bet)
Seat 2: vSkQm2EelzwRGDDQQk0Fqw collected ($6.55)
Seat 3: HOEaXncFu2ij+D5/CANAZA (button) folded before Flop (didn't bet)
Seat 4: 2Xwi447v1rBHM+92U0CduA (small blind) folded before Flop
Seat 5: yyG4svzOpC1A+sUP/scg6w (big blind) folded before Flop
Seat 6: sC4BsflLWW26Qm9m+1AwJQ folded on the Turn
Seat 8: 7je+LC5Mfs6nL8YBVh4frQ folded before Flop (didn't bet)
Seat 9: K0b5wNInj6hUGRr6yzKFtw folded before Flop (didn't bet)




PokerStars Game #59941796662:  Hold'em No Limit ($0.10/$0.25) - 2009/07/01 1:46:26 ET
Table '0M5QEJGOThqZwQ/sjbjXYw' 6-max Seat #5 is the button
Seat 2: /gJNBeCkWL4o85/jvlZ4BA ($34.60 in chips) 
Seat 3: 3zD3qLXT1bEffAoWGnc7wg ($25 in chips) 
Seat 4: oBUDUfeUyCbZBsjxHZgSiw ($22.25 in chips) 
Seat 5: cWc85bEzdRzpUMhRKm8pwQ ($28.20 in chips) 
Seat 6: bb63I02U6p9a5MNFa1gCiw ($26.25 in chips) 
bb63I02U6p9a5MNFa1gCiw: posts small blind $0.10
/gJNBeCkWL4o85/jvlZ4BA: posts big blind $0.25
*** HOLE CARDS ***
3zD3qLXT1bEffAoWGnc7wg: folds 
oBUDUfeUyCbZBsjxHZgSiw: folds 
cWc85bEzdRzpUMhRKm8pwQ: folds 
bb63I02U6p9a5MNFa1gCiw: raises $0.25 to $0.50
/gJNBeCkWL4o85/jvlZ4BA: folds 
Uncalled bet ($0.25) returned to bb63I02U6p9a5MNFa1gCiw
bb63I02U6p9a5MNFa1gCiw collected $0.50 from pot
bb63I02U6p9a5MNFa1gCiw: doesn't show hand 
*** SUMMARY ***
Total pot $0.50 | Rake $0 
Seat 2: /gJNBeCkWL4o85/jvlZ4BA (big blind) folded before Flop
Seat 3: 3zD3qLXT1bEffAoWGnc7wg folded before Flop (didn't bet)
Seat 4: oBUDUfeUyCbZBsjxHZgSiw folded before Flop (didn't bet)
Seat 5: cWc85bEzdRzpUMhRKm8pwQ (button) folded before Flop (didn't bet)
Seat 6: bb63I02U6p9a5MNFa1gCiw (small blind) collected ($0.50)




PokerStars Game #59941796746:  Hold'em No Limit ($0.10/$0.25) - 2009/07/01 1:46:26 ET
Table 'nXVbUw6/HYwA6x21+IZ3XQ' 9-max Seat #3 is the button
Seat 1: zDrucyjVn5aeekNEc3cJrA ($16.75 in chips) 
Seat 2: 9lvO/qyU+xrU95Teu1fv0g ($10.25 in chips) 
Seat 3: MB0wa15P+9QHcBApEdgQFw ($9.65 in chips) 
Seat 4: SpiiQQAzy4MUgV3I5W8giw ($24.75 in chips) 
Seat 5: M/9j4wkHH9i1JM51vgi1VA ($33.70 in chips) 
Seat 6: ljemhp25Zg+nlA9DLCIiUw ($27.20 in chips) 
Seat 7: ShCS62CJp4MKfKLKvGKQbA ($11.60 in chips) 
Seat 8: dfNim92Z6XK1/h5SFW5vDg ($25 in chips) 
Seat 9: OTCjTlu92MEBtX/i9Gm7yA ($9.70 in chips) 
SpiiQQAzy4MUgV3I5W8giw: posts small blind $0.10
M/9j4wkHH9i1JM51vgi1VA: posts big blind $0.25
*** HOLE CARDS ***
ljemhp25Zg+nlA9DLCIiUw: folds 
ShCS62CJp4MKfKLKvGKQbA: folds 
dfNim92Z6XK1/h5SFW5vDg: folds 
OTCjTlu92MEBtX/i9Gm7yA: raises $0.25 to $0.50
zDrucyjVn5aeekNEc3cJrA: folds 
9lvO/qyU+xrU95Teu1fv0g: folds 
MB0wa15P+9QHcBApEdgQFw: folds 
SpiiQQAzy4MUgV3I5W8giw: folds 
M/9j4wkHH9i1JM51vgi1VA: calls $0.25
*** FLOP *** [Th 2s 4c]
M/9j4wkHH9i1JM51vgi1VA: checks 
OTCjTlu92MEBtX/i9Gm7yA: bets $0.75
M/9j4wkHH9i1JM51vgi1VA: calls $0.75
*** TURN *** [Th 2s 4c] [Jc]
M/9j4wkHH9i1JM51vgi1VA: checks 
OTCjTlu92MEBtX/i9Gm7yA: bets $0.75
M/9j4wkHH9i1JM51vgi1VA: calls $0.75
*** RIVER *** [Th 2s 4c Jc] [Tc]
M/9j4wkHH9i1JM51vgi1VA: checks 
OTCjTlu92MEBtX/i9Gm7yA: bets $1
M/9j4wkHH9i1JM51vgi1VA: folds 
Uncalled bet ($1) returned to OTCjTlu92MEBtX/i9Gm7yA
OTCjTlu92MEBtX/i9Gm7yA collected $3.90 from pot
OTCjTlu92MEBtX/i9Gm7yA: doesn't show hand 
*** SUMMARY ***
Total pot $4.10 | Rake $0.20 
Board [Th 2s 4c Jc Tc]
Seat 1: zDrucyjVn5aeekNEc3cJrA folded before Flop (didn't bet)
Seat 2: 9lvO/qyU+xrU95Teu1fv0g folded before Flop (didn't bet)
Seat 3: MB0wa15P+9QHcBApEdgQFw (button) folded before Flop (didn't bet)
Seat 4: SpiiQQAzy4MUgV3I5W8giw (small blind) folded before Flop
Seat 5: M/9j4wkHH9i1JM51vgi1VA (big blind) folded on the River
Seat 6: ljemhp25Zg+nlA9DLCIiUw folded before Flop (didn't bet)
Seat 7: ShCS62CJp4MKfKLKvGKQbA folded before Flop (didn't bet)
Seat 8: dfNim92Z6XK1/h5SFW5vDg folded before Flop (didn't bet)
Seat 9: OTCjTlu92MEBtX/i9Gm7yA collected ($3.90)




PokerStars Game #59941797256:  Hold'em No Limit ($0.10/$0.25) - 2009/07/01 1:46:27 ET
Table 'sDHjMRwfSiz7+NDdZLUiyA' 9-max Seat #6 is the button
Seat 1: VGwr1eqhvdUtMfBFCvBnmg ($10.35 in chips) 
Seat 2: ljemhp25Zg+nlA9DLCIiUw ($25.70 in chips) 
Seat 3: SGA1WpAnQxFdFAYyt362gQ ($18.05 in chips) 
Seat 4: eK8qa6EPcH2zhtbmWSvc9g ($26.05 in chips) 
Seat 5: IGRfskE1v9H9Bn+fz8AgNQ ($37.05 in chips) 
Seat 6: 1qa0qHOCKZM3Uipx9DxYtQ ($15.80 in chips) 
Seat 7: K0b5wNInj6hUGRr6yzKFtw ($37.40 in chips) 
Seat 8: 3hMkm4U5yTRrkGJkxfijaQ ($2.65 in chips) 
Seat 9: 3PmVnC/15cl4oyI1TKIt4g ($4.05 in chips) 
K0b5wNInj6hUGRr6yzKFtw: posts small blind $0.10
3hMkm4U5yTRrkGJkxfijaQ: posts big blind $0.25
*** HOLE CARDS ***
3PmVnC/15cl4oyI1TKIt4g: folds 
VGwr1eqhvdUtMfBFCvBnmg: folds 
ljemhp25Zg+nlA9DLCIiUw: folds 
SGA1WpAnQxFdFAYyt362gQ: folds 
eK8qa6EPcH2zhtbmWSvc9g: folds 
IGRfskE1v9H9Bn+fz8AgNQ: raises $0.50 to $0.75
1qa0qHOCKZM3Uipx9DxYtQ: folds 
K0b5wNInj6hUGRr6yzKFtw: folds 
3hMkm4U5yTRrkGJkxfijaQ: calls $0.50
*** FLOP *** [6h 6c 7h]
3hMkm4U5yTRrkGJkxfijaQ: checks 
IGRfskE1v9H9Bn+fz8AgNQ: bets $2
3hMkm4U5yTRrkGJkxfijaQ: folds 
Uncalled bet ($2) returned to IGRfskE1v9H9Bn+fz8AgNQ
IGRfskE1v9H9Bn+fz8AgNQ collected $1.55 from pot
IGRfskE1v9H9Bn+fz8AgNQ: doesn't show hand 
*** SUMMARY ***
Total pot $1.60 | Rake $0.05 
Board [6h 6c 7h]
Seat 1: VGwr1eqhvdUtMfBFCvBnmg folded before Flop (didn't bet)
Seat 2: ljemhp25Zg+nlA9DLCIiUw folded before Flop (didn't bet)
Seat 3: SGA1WpAnQxFdFAYyt362gQ folded before Flop (didn't bet)
Seat 4: eK8qa6EPcH2zhtbmWSvc9g folded before Flop (didn't bet)
Seat 5: IGRfskE1v9H9Bn+fz8AgNQ collected ($1.55)
Seat 6: 1qa0qHOCKZM3Uipx9DxYtQ (button) folded before Flop (didn't bet)
Seat 7: K0b5wNInj6hUGRr6yzKFtw (small blind) folded before Flop
Seat 8: 3hMkm4U5yTRrkGJkxfijaQ (big blind) folded on the Flop
Seat 9: 3PmVnC/15cl4oyI1TKIt4g folded before Flop (didn't bet)




PokerStars Game #59941796876:  Hold'em No Limit ($0.10/$0.25) - 2009/07/01 1:46:27 ET
Table 'sSe6q4YTb/iS19t2eCFdsA' 9-max Seat #5 is the button
Seat 1: hJ4uYjNmSZdjrKA8cjZqCA ($19.50 in chips) 
Seat 2: 3l+i+xMeyDndSXMF2A5CDA ($6.25 in chips) 
Seat 3: OXPkK84/qv92EMwXPiG5rQ ($9.75 in chips) 
Seat 4: 22dIObOuor/A+IKWkNoAlA ($8.50 in chips) 
Seat 5: qS+jfnNoG75bT+uQ8CKhQA ($9.70 in chips) 
Seat 6: tYsOBqdU1+x+yFI7zHO7hQ ($27.10 in chips) 
Seat 7: t70KGeRtR3naHSqKDixsUg ($3.50 in chips) 
Seat 8: hvXZ0zFPZFP8Hf6dS36YEw ($16 in chips) 
Seat 9: Z9W7+g1WMhhZDi7DwGbCFA ($5 in chips) 
tYsOBqdU1+x+yFI7zHO7hQ: posts small blind $0.10
t70KGeRtR3naHSqKDixsUg: posts big blind $0.25
*** HOLE CARDS ***
hvXZ0zFPZFP8Hf6dS36YEw: folds 
Z9W7+g1WMhhZDi7DwGbCFA: folds 
hJ4uYjNmSZdjrKA8cjZqCA: calls $0.25
3l+i+xMeyDndSXMF2A5CDA: folds 
OXPkK84/qv92EMwXPiG5rQ: folds 
22dIObOuor/A+IKWkNoAlA: folds 
qS+jfnNoG75bT+uQ8CKhQA: folds 
tYsOBqdU1+x+yFI7zHO7hQ: folds 
t70KGeRtR3naHSqKDixsUg: checks 
*** FLOP *** [6d Kd Tc]
t70KGeRtR3naHSqKDixsUg: checks 
hJ4uYjNmSZdjrKA8cjZqCA: bets $0.50
t70KGeRtR3naHSqKDixsUg: calls $0.50
*** TURN *** [6d Kd Tc] [Js]
t70KGeRtR3naHSqKDixsUg: bets $0.50
hJ4uYjNmSZdjrKA8cjZqCA: folds 
Uncalled bet ($0.50) returned to t70KGeRtR3naHSqKDixsUg
t70KGeRtR3naHSqKDixsUg collected $1.55 from pot
*** SUMMARY ***
Total pot $1.60 | Rake $0.05 
Board [6d Kd Tc Js]
Seat 1: hJ4uYjNmSZdjrKA8cjZqCA folded on the Turn
Seat 2: 3l+i+xMeyDndSXMF2A5CDA folded before Flop (didn't bet)
Seat 3: OXPkK84/qv92EMwXPiG5rQ folded before Flop (didn't bet)
Seat 4: 22dIObOuor/A+IKWkNoAlA folded before Flop (didn't bet)
Seat 5: qS+jfnNoG75bT+uQ8CKhQA (button) folded before Flop (didn't bet)
Seat 6: tYsOBqdU1+x+yFI7zHO7hQ (small blind) folded before Flop
Seat 7: t70KGeRtR3naHSqKDixsUg (big blind) collected ($1.55)
Seat 8: hvXZ0zFPZFP8Hf6dS36YEw folded before Flop (didn't bet)
Seat 9: Z9W7+g1WMhhZDi7DwGbCFA folded before Flop (didn't bet)




PokerStars Game #59941797340:  Hold'em No Limit ($0.10/$0.25) - 2009/07/01 1:46:27 ET
Table 'hOE09W281uSob0XeJmUcRg' 6-max Seat #6 is the button
Seat 1: mfrkWA3PTeYPkbO6hi98Aw ($27.05 in chips) 
Seat 2: lRKJ8o/CnOPFwfHHm6ioMw ($12.95 in chips) 
Seat 3: y+a/yGW/Jy4bPJFnaeTz5w ($13.60 in chips) 
Seat 5: JFIAqU8lCZ0vWwEl4bdGsg ($25.25 in chips) 
Seat 6: x4ZJ8E/TUrtoB7WiHcv8WA ($16.60 in chips) 
mfrkWA3PTeYPkbO6hi98Aw: posts small blind $0.10
lRKJ8o/CnOPFwfHHm6ioMw: posts big blind $0.25
*** HOLE CARDS ***
y+a/yGW/Jy4bPJFnaeTz5w: folds 
JFIAqU8lCZ0vWwEl4bdGsg: raises $0.60 to $0.85
x4ZJ8E/TUrtoB7WiHcv8WA: folds 
mfrkWA3PTeYPkbO6hi98Aw: folds 
lRKJ8o/CnOPFwfHHm6ioMw: calls $0.60
*** FLOP *** [Qc Qs 2c]
lRKJ8o/CnOPFwfHHm6ioMw: checks 
JFIAqU8lCZ0vWwEl4bdGsg: bets $1.25
lRKJ8o/CnOPFwfHHm6ioMw: folds 
Uncalled bet ($1.25) returned to JFIAqU8lCZ0vWwEl4bdGsg
JFIAqU8lCZ0vWwEl4bdGsg collected $1.75 from pot
JFIAqU8lCZ0vWwEl4bdGsg: doesn't show hand 
*** SUMMARY ***
Total pot $1.80 | Rake $0.05 
Board [Qc Qs 2c]
Seat 1: mfrkWA3PTeYPkbO6hi98Aw (small blind) folded before Flop
Seat 2: lRKJ8o/CnOPFwfHHm6ioMw (big blind) folded on the Flop
Seat 3: y+a/yGW/Jy4bPJFnaeTz5w folded before Flop (didn't bet)
Seat 5: JFIAqU8lCZ0vWwEl4bdGsg collected ($1.75)
Seat 6: x4ZJ8E/TUrtoB7WiHcv8WA (button) folded before Flop (didn't bet)




PokerStars Game #59941797344:  Hold'em No Limit ($0.10/$0.25) - 2009/07/01 1:46:27 ET
Table 'KEoOIegxPF91KooL2AelUA' 6-max Seat #5 is the button
Seat 2: 0Bg59Tnte1Tc7C4i9Jd9cQ ($7.90 in chips) 
Seat 3: zxeVQGaMKDsDzmSY+AInjA ($10.70 in chips) 
Seat 4: Wo60l2GQnSEc3bxPVyvIUw ($9.10 in chips) 
Seat 5: 08V++DOqzaNrRNsHIwi25w ($51.75 in chips) 
Seat 6: AMrBn4Vx9aAo/vv6WHLk6w ($2.90 in chips) 
AMrBn4Vx9aAo/vv6WHLk6w: posts small blind $0.10
0Bg59Tnte1Tc7C4i9Jd9cQ: posts big blind $0.25
*** HOLE CARDS ***
32YL2ZEp8NT4JB2RVM9euQ joins the table at seat #1 
zxeVQGaMKDsDzmSY+AInjA: calls $0.25
Wo60l2GQnSEc3bxPVyvIUw: folds 
08V++DOqzaNrRNsHIwi25w: folds 
AMrBn4Vx9aAo/vv6WHLk6w: calls $0.15
0Bg59Tnte1Tc7C4i9Jd9cQ: checks 
*** FLOP *** [3d Ac 6d]
AMrBn4Vx9aAo/vv6WHLk6w: checks 
0Bg59Tnte1Tc7C4i9Jd9cQ: bets $0.75
zxeVQGaMKDsDzmSY+AInjA: calls $0.75
AMrBn4Vx9aAo/vv6WHLk6w: folds 
*** TURN *** [3d Ac 6d] [As]
0Bg59Tnte1Tc7C4i9Jd9cQ: bets $0.75
zxeVQGaMKDsDzmSY+AInjA: calls $0.75
*** RIVER *** [3d Ac 6d As] [Ah]
0Bg59Tnte1Tc7C4i9Jd9cQ: bets $1
zxeVQGaMKDsDzmSY+AInjA: raises $7.95 to $8.95 and is all-in
0Bg59Tnte1Tc7C4i9Jd9cQ: folds 
Uncalled bet ($7.95) returned to zxeVQGaMKDsDzmSY+AInjA
zxeVQGaMKDsDzmSY+AInjA collected $5.50 from pot
*** SUMMARY ***
Total pot $5.75 | Rake $0.25 
Board [3d Ac 6d As Ah]
Seat 2: 0Bg59Tnte1Tc7C4i9Jd9cQ (big blind) folded on the River
Seat 3: zxeVQGaMKDsDzmSY+AInjA collected ($5.50)
Seat 4: Wo60l2GQnSEc3bxPVyvIUw folded before Flop (didn't bet)
Seat 5: 08V++DOqzaNrRNsHIwi25w (button) folded before Flop (didn't bet)
Seat 6: AMrBn4Vx9aAo/vv6WHLk6w (small blind) folded on the Flop




PokerStars Game #59941797368:  Hold'em No Limit ($0.10/$0.25) - 2009/07/01 1:46:27 ET
Table 'tq5CvS0RUqGkuBK0XTzqqg' 6-max Seat #2 is the button
Seat 1: +ZlnqPoP3Hg4BIUxDfKd/A ($30.10 in chips) 
Seat 2: 2m6ZFAdj01UZd4WtEySXXQ ($4.75 in chips) 
Seat 4: UT5XpwOH1ipkOF7n1MqDJA ($33.70 in chips) 
Seat 5: qGHGf/553gQnDoklMRe3tg ($38 in chips) 
PbMzPZIePKifKQZfKDkbIw: is sitting out 
UT5XpwOH1ipkOF7n1MqDJA: posts small blind $0.10
qGHGf/553gQnDoklMRe3tg: posts big blind $0.25
QqiZLFrN8iOUT/GHw7ztOA: sits out 
*** HOLE CARDS ***
+ZlnqPoP3Hg4BIUxDfKd/A: folds 
2m6ZFAdj01UZd4WtEySXXQ: calls $0.25
UT5XpwOH1ipkOF7n1MqDJA: calls $0.15
qGHGf/553gQnDoklMRe3tg: checks 
*** FLOP *** [8s 7c Jh]
PbMzPZIePKifKQZfKDkbIw leaves the table
UT5XpwOH1ipkOF7n1MqDJA: bets $0.75
08V++DOqzaNrRNsHIwi25w joins the table at seat #3 
qGHGf/553gQnDoklMRe3tg: folds 
2m6ZFAdj01UZd4WtEySXXQ: folds 
Uncalled bet ($0.75) returned to UT5XpwOH1ipkOF7n1MqDJA
UT5XpwOH1ipkOF7n1MqDJA collected $0.75 from pot
*** SUMMARY ***
Total pot $0.75 | Rake $0 
Board [8s 7c Jh]
Seat 1: +ZlnqPoP3Hg4BIUxDfKd/A folded before Flop (didn't bet)
Seat 2: 2m6ZFAdj01UZd4WtEySXXQ (button) folded on the Flop
Seat 4: UT5XpwOH1ipkOF7n1MqDJA (small blind) collected ($0.75)
Seat 5: qGHGf/553gQnDoklMRe3tg (big blind) folded on the Flop




PokerStars Game #59941797322:  Hold'em No Limit ($0.10/$0.25) - 2009/07/01 1:46:27 ET
Table 'YYMg5qzxK1m9eGRo4SbxtQ' 9-max Seat #2 is the button
Seat 1: 3PmVnC/15cl4oyI1TKIt4g ($5 in chips) 
Seat 2: f/H6PsHRl4W1JyNsEDvPtg ($13.85 in chips) 
Seat 3: eK8qa6EPcH2zhtbmWSvc9g ($25 in chips) 
Seat 4: ROxrieegd9WYtWcUKJAlbg ($13.75 in chips) 
Seat 8: xoBFd/5k+L/pFn9VW1VyWg ($14.20 in chips) 
Seat 9: +sbyWwIcFp9kP0bDtMegfQ ($31.60 in chips) 
eK8qa6EPcH2zhtbmWSvc9g: posts small blind $0.10
ROxrieegd9WYtWcUKJAlbg: posts big blind $0.25
4awUyiDYTgylQKXZ9faBVA: sits out 
eebse2009: sits out 
*** HOLE CARDS ***
xoBFd/5k+L/pFn9VW1VyWg: folds 
+sbyWwIcFp9kP0bDtMegfQ: folds 
3PmVnC/15cl4oyI1TKIt4g: folds 
f/H6PsHRl4W1JyNsEDvPtg: folds 
eK8qa6EPcH2zhtbmWSvc9g: raises $0.50 to $0.75
ROxrieegd9WYtWcUKJAlbg: folds 
Uncalled bet ($0.50) returned to eK8qa6EPcH2zhtbmWSvc9g
S5VeQLgBIiHrfs9AB2vBwA has returned
eK8qa6EPcH2zhtbmWSvc9g collected $0.50 from pot
eK8qa6EPcH2zhtbmWSvc9g: doesn't show hand 
*** SUMMARY ***
Total pot $0.50 | Rake $0 
Seat 1: 3PmVnC/15cl4oyI1TKIt4g folded before Flop (didn't bet)
Seat 2: f/H6PsHRl4W1JyNsEDvPtg (button) folded before Flop (didn't bet)
Seat 3: eK8qa6EPcH2zhtbmWSvc9g (small blind) collected ($0.50)
Seat 4: ROxrieegd9WYtWcUKJAlbg (big blind) folded before Flop
Seat 8: xoBFd/5k+L/pFn9VW1VyWg folded before Flop (didn't bet)
Seat 9: +sbyWwIcFp9kP0bDtMegfQ folded before Flop (didn't bet)




PokerStars Game #59941797830:  Hold'em No Limit ($0.10/$0.25) - 2009/07/01 1:46:28 ET
Table 'NfXsh0UQA+o/kO9acV3WxA' 9-max Seat #7 is the button
Seat 1: pN3IHvAKm2fz+sTRARTcrg ($24.65 in chips) 
Seat 2: mhpFs2SZupy4zLRb62FLFA ($25 in chips) 
Seat 3: wCUaomJ6Nq5zomVGdUHP+w ($16 in chips) 
Seat 4: r6hsffOo1iKmaPYKwAZmFw ($30.05 in chips) 
Seat 5: zgi+EUykT/pZQpoUG6+oEg ($4.65 in chips) 
Seat 7: yqkowiRWZ6NvRN9UUkYIlA ($5 in chips) 
Seat 8: +sbyWwIcFp9kP0bDtMegfQ ($41.50 in chips) 
Seat 9: uhrboV251dcgYniYTdFIcA ($29.20 in chips) 
+sbyWwIcFp9kP0bDtMegfQ: posts small blind $0.10
uhrboV251dcgYniYTdFIcA: posts big blind $0.25
wCUaomJ6Nq5zomVGdUHP+w said, "***"
qwr38jl5txoR36M7G5qi4A: sits out 
*** HOLE CARDS ***
pN3IHvAKm2fz+sTRARTcrg: folds 
mhpFs2SZupy4zLRb62FLFA: folds 
wCUaomJ6Nq5zomVGdUHP+w: calls $0.25
r6hsffOo1iKmaPYKwAZmFw: folds 
zgi+EUykT/pZQpoUG6+oEg: folds 
yqkowiRWZ6NvRN9UUkYIlA: folds 
+sbyWwIcFp9kP0bDtMegfQ: calls $0.15
uhrboV251dcgYniYTdFIcA: checks 
*** FLOP *** [4c Tc 9h]
+sbyWwIcFp9kP0bDtMegfQ: checks 
uhrboV251dcgYniYTdFIcA: checks 
wCUaomJ6Nq5zomVGdUHP+w: bets $0.50
+sbyWwIcFp9kP0bDtMegfQ: calls $0.50
uhrboV251dcgYniYTdFIcA: folds 
*** TURN *** [4c Tc 9h] [9s]
+sbyWwIcFp9kP0bDtMegfQ: checks 
wCUaomJ6Nq5zomVGdUHP+w: bets $1
+sbyWwIcFp9kP0bDtMegfQ: calls $1
*** RIVER *** [4c Tc 9h 9s] [Jd]
+sbyWwIcFp9kP0bDtMegfQ: bets $0.25
wCUaomJ6Nq5zomVGdUHP+w: raises $1.25 to $1.50
+sbyWwIcFp9kP0bDtMegfQ: folds 
Uncalled bet ($1.25) returned to wCUaomJ6Nq5zomVGdUHP+w
wCUaomJ6Nq5zomVGdUHP+w collected $4.05 from pot
*** SUMMARY ***
Total pot $4.25 | Rake $0.20 
Board [4c Tc 9h 9s Jd]
Seat 1: pN3IHvAKm2fz+sTRARTcrg folded before Flop (didn't bet)
Seat 2: mhpFs2SZupy4zLRb62FLFA folded before Flop (didn't bet)
Seat 3: wCUaomJ6Nq5zomVGdUHP+w collected ($4.05)
Seat 4: r6hsffOo1iKmaPYKwAZmFw folded before Flop (didn't bet)
Seat 5: zgi+EUykT/pZQpoUG6+oEg folded before Flop (didn't bet)
Seat 7: yqkowiRWZ6NvRN9UUkYIlA (button) folded before Flop (didn't bet)
Seat 8: +sbyWwIcFp9kP0bDtMegfQ (small blind) folded on the River
Seat 9: uhrboV251dcgYniYTdFIcA (big blind) folded on the Flop




PokerStars Game #59941798360:  Hold'em No Limit ($0.10/$0.25) - 2009/07/01 1:46:29 ET
Table 'ktio12Pyq06LsrFhIorSqA' 9-max Seat #1 is the button
Seat 1: OneeONzF0MoH0pEdcBndwA ($37.80 in chips) 
Seat 2: tGsFgUKjSctVaAXabrlZxw ($5.05 in chips) 
Seat 3: Z9W7+g1WMhhZDi7DwGbCFA ($5 in chips) 
Seat 4: 0QdZrkFD7aGKeBXPGbIomA ($5 in chips) 
Seat 5: e0pV1oisCAilWiG0FCxY6A ($16.75 in chips) 
Seat 6: jQL6XIewylQ8MmZhhq2YFg ($42.20 in chips) 
Seat 7: XGCfQsxa6PfAg3kJtzUmww ($22.10 in chips) 
Seat 9: H5Se03ZqSX7tbULXur2MAg ($26.30 in chips) 
tGsFgUKjSctVaAXabrlZxw: posts small blind $0.10
Z9W7+g1WMhhZDi7DwGbCFA: posts big blind $0.25
*** HOLE CARDS ***
0QdZrkFD7aGKeBXPGbIomA: folds 
e0pV1oisCAilWiG0FCxY6A: folds 
jQL6XIewylQ8MmZhhq2YFg: folds 
XGCfQsxa6PfAg3kJtzUmww: folds 
H5Se03ZqSX7tbULXur2MAg: folds 
OneeONzF0MoH0pEdcBndwA: folds 
tGsFgUKjSctVaAXabrlZxw: folds 
Uncalled bet ($0.15) returned to Z9W7+g1WMhhZDi7DwGbCFA
Z9W7+g1WMhhZDi7DwGbCFA collected $0.20 from pot
Z9W7+g1WMhhZDi7DwGbCFA: doesn't show hand 
*** SUMMARY ***
Total pot $0.20 | Rake $0 
Seat 1: OneeONzF0MoH0pEdcBndwA (button) folded before Flop (didn't bet)
Seat 2: tGsFgUKjSctVaAXabrlZxw (small blind) folded before Flop
Seat 3: Z9W7+g1WMhhZDi7DwGbCFA (big blind) collected ($0.20)
Seat 4: 0QdZrkFD7aGKeBXPGbIomA folded before Flop (didn't bet)
Seat 5: e0pV1oisCAilWiG0FCxY6A folded before Flop (didn't bet)
Seat 6: jQL6XIewylQ8MmZhhq2YFg folded before Flop (didn't bet)
Seat 7: XGCfQsxa6PfAg3kJtzUmww folded before Flop (didn't bet)
Seat 9: H5Se03ZqSX7tbULXur2MAg folded before Flop (didn't bet)




PokerStars Game #59941798006:  Hold'em No Limit ($0.10/$0.25) - 2009/07/01 1:46:29 ET
Table '3lS+sU5k6mwJCS2nFMmQ6Q' 9-max Seat #8 is the button
Seat 1: VWUWpMLMj/Q1jRVpF7Aohw ($13.45 in chips) 
Seat 3: 1DXccE2UUK5DIRVGlOKnTA ($11.95 in chips) 
Seat 4: ydoFOVgzvZv9ZhuWu9rXAw ($10.70 in chips) 
Seat 5: NcPAt5YjVvDFEJTTgAVj8g ($5.50 in chips) 
Seat 6: hJ4uYjNmSZdjrKA8cjZqCA ($35.75 in chips) 
Seat 7: Th3FldXKQW6hWVVPahaoOQ ($31.55 in chips) 
Seat 8: 9lvO/qyU+xrU95Teu1fv0g ($5.25 in chips) 
Seat 9: 4awUyiDYTgylQKXZ9faBVA ($48.95 in chips) 
4awUyiDYTgylQKXZ9faBVA: posts small blind $0.10
VWUWpMLMj/Q1jRVpF7Aohw: posts big blind $0.25
PdIasPkzm2sqZnN41ZRXOg: sits out 
*** HOLE CARDS ***
1DXccE2UUK5DIRVGlOKnTA: folds 
ydoFOVgzvZv9ZhuWu9rXAw: folds 
NcPAt5YjVvDFEJTTgAVj8g: calls $0.25
hJ4uYjNmSZdjrKA8cjZqCA: folds 
Th3FldXKQW6hWVVPahaoOQ: folds 
9lvO/qyU+xrU95Teu1fv0g: folds 
4awUyiDYTgylQKXZ9faBVA: folds 
VWUWpMLMj/Q1jRVpF7Aohw: checks 
*** FLOP *** [Qh Qs 5d]
VWUWpMLMj/Q1jRVpF7Aohw: checks 
NcPAt5YjVvDFEJTTgAVj8g: checks 
*** TURN *** [Qh Qs 5d] [4s]
VWUWpMLMj/Q1jRVpF7Aohw: checks 
NcPAt5YjVvDFEJTTgAVj8g: checks 
*** RIVER *** [Qh Qs 5d 4s] [8h]
VWUWpMLMj/Q1jRVpF7Aohw: checks 
NcPAt5YjVvDFEJTTgAVj8g: checks 
*** SHOW DOWN ***
VWUWpMLMj/Q1jRVpF7Aohw: shows [6s Ac] (a pair of Queens)
NcPAt5YjVvDFEJTTgAVj8g: mucks hand 
VWUWpMLMj/Q1jRVpF7Aohw collected $0.60 from pot
*** SUMMARY ***
Total pot $0.60 | Rake $0 
Board [Qh Qs 5d 4s 8h]
Seat 1: VWUWpMLMj/Q1jRVpF7Aohw (big blind) showed [6s Ac] and won ($0.60) with a pair of Queens
Seat 3: 1DXccE2UUK5DIRVGlOKnTA folded before Flop (didn't bet)
Seat 4: ydoFOVgzvZv9ZhuWu9rXAw folded before Flop (didn't bet)
Seat 5: NcPAt5YjVvDFEJTTgAVj8g mucked
Seat 6: hJ4uYjNmSZdjrKA8cjZqCA folded before Flop (didn't bet)
Seat 7: Th3FldXKQW6hWVVPahaoOQ folded before Flop (didn't bet)
Seat 8: 9lvO/qyU+xrU95Teu1fv0g (button) folded before Flop (didn't bet)
Seat 9: 4awUyiDYTgylQKXZ9faBVA (small blind) folded before Flop




PokerStars Game #59941798380:  Hold'em No Limit ($0.10/$0.25) - 2009/07/01 1:46:29 ET
Table 'v+LTGPWbrLum+Ggd4ef6lg' 9-max Seat #9 is the button
Seat 1: zUXhymECc2C9W9ZNw6qppA ($9.40 in chips) 
Seat 2: r/xYbgD9yVdKFWRgSQD/+Q ($11.20 in chips) 
Seat 3: 7ovWM9c1nQLTFritEGRG/A ($3.35 in chips) 
Seat 4: bXpVeaSTPBFSPJmeXxO7nw ($9.05 in chips) 
Seat 5: +8OkYWUhGfkDbAtQl/ovYQ ($22.30 in chips) 
Seat 7: kUxTO3D2eQcx4oJIpJAK4Q ($7.35 in chips) 
Seat 8: +sbyWwIcFp9kP0bDtMegfQ ($41.20 in chips) 
Seat 9: cZ99hugmLBj9KhTlc8nCSw ($25 in chips) 
zUXhymECc2C9W9ZNw6qppA: posts small blind $0.10
r/xYbgD9yVdKFWRgSQD/+Q: posts big blind $0.25
+qc/EYCgLC65SpGvr35eNg: sits out 
*** HOLE CARDS ***
7ovWM9c1nQLTFritEGRG/A: calls $0.25
bXpVeaSTPBFSPJmeXxO7nw: folds 
+8OkYWUhGfkDbAtQl/ovYQ: raises $3 to $3.25
kUxTO3D2eQcx4oJIpJAK4Q: folds 
+sbyWwIcFp9kP0bDtMegfQ: folds 
cZ99hugmLBj9KhTlc8nCSw: folds 
zUXhymECc2C9W9ZNw6qppA: folds 
r/xYbgD9yVdKFWRgSQD/+Q: folds 
7ovWM9c1nQLTFritEGRG/A: folds 
Uncalled bet ($3) returned to +8OkYWUhGfkDbAtQl/ovYQ
+8OkYWUhGfkDbAtQl/ovYQ collected $0.85 from pot
zUXhymECc2C9W9ZNw6qppA is disconnected 
+8OkYWUhGfkDbAtQl/ovYQ: doesn't show hand 
zUXhymECc2C9W9ZNw6qppA is connected 
*** SUMMARY ***
Total pot $0.85 | Rake $0 
Seat 1: zUXhymECc2C9W9ZNw6qppA (small blind) folded before Flop
Seat 2: r/xYbgD9yVdKFWRgSQD/+Q (big blind) folded before Flop
Seat 3: 7ovWM9c1nQLTFritEGRG/A folded before Flop
Seat 4: bXpVeaSTPBFSPJmeXxO7nw folded before Flop (didn't bet)
Seat 5: +8OkYWUhGfkDbAtQl/ovYQ collected ($0.85)
Seat 7: kUxTO3D2eQcx4oJIpJAK4Q folded before Flop (didn't bet)
Seat 8: +sbyWwIcFp9kP0bDtMegfQ folded before Flop (didn't bet)
Seat 9: cZ99hugmLBj9KhTlc8nCSw (button) folded before Flop (didn't bet)




PokerStars Game #59941798036:  Hold'em No Limit ($0.10/$0.25) - 2009/07/01 1:46:29 ET
Table 'ggwTHpIC5qhhHJSYjK1XCw' 6-max Seat #4 is the button
Seat 1: MqMK8OWPSY1V4stf1Hy5Jw ($80 in chips) 
Seat 2: /gJNBeCkWL4o85/jvlZ4BA ($25.95 in chips) 
Seat 3: SxIIgwXYLkwd6m3wLyPTCw ($69.35 in chips) 
Seat 4: JFIAqU8lCZ0vWwEl4bdGsg ($25 in chips) 
Seat 5: BvqhBa7W/To51LhEiIU/lw ($6.55 in chips) 
BvqhBa7W/To51LhEiIU/lw: posts small blind $0.10
MqMK8OWPSY1V4stf1Hy5Jw: posts big blind $0.25
*** HOLE CARDS ***
/gJNBeCkWL4o85/jvlZ4BA: folds 
SxIIgwXYLkwd6m3wLyPTCw: folds 
JFIAqU8lCZ0vWwEl4bdGsg: folds 
BvqhBa7W/To51LhEiIU/lw: calls $0.15
MqMK8OWPSY1V4stf1Hy5Jw: checks 
*** FLOP *** [4d 7h Kh]
BvqhBa7W/To51LhEiIU/lw: checks 
MqMK8OWPSY1V4stf1Hy5Jw: bets $0.50
BvqhBa7W/To51LhEiIU/lw: folds 
Uncalled bet ($0.50) returned to MqMK8OWPSY1V4stf1Hy5Jw
MqMK8OWPSY1V4stf1Hy5Jw collected $0.50 from pot
MqMK8OWPSY1V4stf1Hy5Jw: doesn't show hand 
*** SUMMARY ***
Total pot $0.50 | Rake $0 
Board [4d 7h Kh]
Seat 1: MqMK8OWPSY1V4stf1Hy5Jw (big blind) collected ($0.50)
Seat 2: /gJNBeCkWL4o85/jvlZ4BA folded before Flop (didn't bet)
Seat 3: SxIIgwXYLkwd6m3wLyPTCw folded before Flop (didn't bet)
Seat 4: JFIAqU8lCZ0vWwEl4bdGsg (button) folded before Flop (didn't bet)
Seat 5: BvqhBa7W/To51LhEiIU/lw (small blind) folded on the Flop




PokerStars Game #59941798124:  Hold'em No Limit ($0.10/$0.25) - 2009/07/01 1:46:29 ET
Table 'mF3KHGMaTpaBZbtBoyfTeg' 6-max Seat #3 is the button
Seat 1: 0HAB2GdCAM7p7V00xueAVQ ($23.90 in chips) 
Seat 3: 9kUKGKkblnIx3m8rlVol6Q ($11.10 in chips) 
Seat 4: FYepjhAvF8ZdVCmqHIy+eQ ($25 in chips) 
Seat 5: 8ClCHtFXGNplITm+63KB+Q ($44.30 in chips) 
Seat 6: kG34n23qFQA3nzdOJTQ1dA ($27.15 in chips) 
FYepjhAvF8ZdVCmqHIy+eQ: posts small blind $0.10
8ClCHtFXGNplITm+63KB+Q: posts big blind $0.25
xrf8tAXKQHG99HixCot1Iw: sits out 
*** HOLE CARDS ***
kG34n23qFQA3nzdOJTQ1dA: folds 
0HAB2GdCAM7p7V00xueAVQ: calls $0.25
9kUKGKkblnIx3m8rlVol6Q: folds 
FYepjhAvF8ZdVCmqHIy+eQ: folds 
8ClCHtFXGNplITm+63KB+Q: checks 
*** FLOP *** [9c 9h 7d]
8ClCHtFXGNplITm+63KB+Q: bets $0.50
0HAB2GdCAM7p7V00xueAVQ: calls $0.50
*** TURN *** [9c 9h 7d] [Qh]
8ClCHtFXGNplITm+63KB+Q: checks 
0HAB2GdCAM7p7V00xueAVQ: checks 
*** RIVER *** [9c 9h 7d Qh] [6h]
8ClCHtFXGNplITm+63KB+Q: checks 
0HAB2GdCAM7p7V00xueAVQ: checks 
*** SHOW DOWN ***
8ClCHtFXGNplITm+63KB+Q: shows [As 7c] (two pair, Nines and Sevens)
0HAB2GdCAM7p7V00xueAVQ: mucks hand 
8ClCHtFXGNplITm+63KB+Q collected $1.55 from pot
*** SUMMARY ***
Total pot $1.60 | Rake $0.05 
Board [9c 9h 7d Qh 6h]
Seat 1: 0HAB2GdCAM7p7V00xueAVQ mucked
Seat 3: 9kUKGKkblnIx3m8rlVol6Q (button) folded before Flop (didn't bet)
Seat 4: FYepjhAvF8ZdVCmqHIy+eQ (small blind) folded before Flop
Seat 5: 8ClCHtFXGNplITm+63KB+Q (big blind) showed [As 7c] and won ($1.55) with two pair, Nines and Sevens
Seat 6: kG34n23qFQA3nzdOJTQ1dA folded before Flop (didn't bet)




PokerStars Game #59941798214:  Hold'em No Limit ($0.10/$0.25) - 2009/07/01 1:46:29 ET
Table 'nFlmVztKq1HJEWfxmdl15w' 9-max Seat #4 is the button
Seat 1: cZ99hugmLBj9KhTlc8nCSw ($25 in chips) 
Seat 2: Th3FldXKQW6hWVVPahaoOQ ($38.40 in chips) 
Seat 3: DdPXdieucQ+n99u1n3A+rQ ($5.70 in chips) 
Seat 4: +5dSUwD+/k2ktlnutSMivw ($12 in chips) 
Seat 5: Tx6zQdk5Ozt9ObEBlU7jeg ($34.85 in chips) 
Seat 6: 4awUyiDYTgylQKXZ9faBVA ($36 in chips) 
Seat 7: dfNim92Z6XK1/h5SFW5vDg ($35.30 in chips) 
Seat 8: +2kMBNpY4nF1qNCRd8SJLA ($33.65 in chips) 
Seat 9: DnDcAdn9P0zGovMERigpFA ($25 in chips) 
Tx6zQdk5Ozt9ObEBlU7jeg: posts small blind $0.10
4awUyiDYTgylQKXZ9faBVA: posts big blind $0.25
*** HOLE CARDS ***
dfNim92Z6XK1/h5SFW5vDg: folds 
+2kMBNpY4nF1qNCRd8SJLA: folds 
DnDcAdn9P0zGovMERigpFA: folds 
cZ99hugmLBj9KhTlc8nCSw: folds 
Th3FldXKQW6hWVVPahaoOQ: folds 
DdPXdieucQ+n99u1n3A+rQ: folds 
+5dSUwD+/k2ktlnutSMivw: folds 
Tx6zQdk5Ozt9ObEBlU7jeg: calls $0.15
4awUyiDYTgylQKXZ9faBVA: checks 
*** FLOP *** [4d Jd 2h]
Tx6zQdk5Ozt9ObEBlU7jeg: checks 
4awUyiDYTgylQKXZ9faBVA: checks 
*** TURN *** [4d Jd 2h] [Ah]
Tx6zQdk5Ozt9ObEBlU7jeg: checks 
4awUyiDYTgylQKXZ9faBVA: checks 
*** RIVER *** [4d Jd 2h Ah] [Ts]
Tx6zQdk5Ozt9ObEBlU7jeg: checks 
4awUyiDYTgylQKXZ9faBVA: checks 
*** SHOW DOWN ***
Tx6zQdk5Ozt9ObEBlU7jeg: shows [3s 8c] (high card Ace)
4awUyiDYTgylQKXZ9faBVA: shows [Th 8s] (a pair of Tens)
4awUyiDYTgylQKXZ9faBVA collected $0.50 from pot
*** SUMMARY ***
Total pot $0.50 | Rake $0 
Board [4d Jd 2h Ah Ts]
Seat 1: cZ99hugmLBj9KhTlc8nCSw folded before Flop (didn't bet)
Seat 2: Th3FldXKQW6hWVVPahaoOQ folded before Flop (didn't bet)
Seat 3: DdPXdieucQ+n99u1n3A+rQ folded before Flop (didn't bet)
Seat 4: +5dSUwD+/k2ktlnutSMivw (button) folded before Flop (didn't bet)
Seat 5: Tx6zQdk5Ozt9ObEBlU7jeg (small blind) showed [3s 8c] and lost with high card Ace
Seat 6: 4awUyiDYTgylQKXZ9faBVA (big blind) showed [Th 8s] and won ($0.50) with a pair of Tens
Seat 7: dfNim92Z6XK1/h5SFW5vDg folded before Flop (didn't bet)
Seat 8: +2kMBNpY4nF1qNCRd8SJLA folded before Flop (didn't bet)
Seat 9: DnDcAdn9P0zGovMERigpFA folded before Flop (didn't bet)




PokerStars Game #59941798178:  Hold'em No Limit ($0.10/$0.25) - 2009/07/01 1:46:29 ET
Table 'IdXp6nyeW4FYaEK4qKCnwQ' 9-max Seat #4 is the button
Seat 1: tLcDklc2rBORNfixyRfVfw ($25 in chips) 
Seat 2: HPEB+AtKw1+C/cxU0o1ciw ($30.85 in chips) 
Seat 3: eK8qa6EPcH2zhtbmWSvc9g ($33.05 in chips) 
Seat 4: j4q3p0lesp63b1gZDwLBZw ($5.35 in chips) 
Seat 5: U41wNf6XauAiBOQaKu2ZIA ($22.90 in chips) 
Seat 6: arxNSjreDRGFg13EAM2F1w ($30.05 in chips) 
Seat 7: w1ukf8uPa4+WH561TtVRxA ($37 in chips) 
Seat 8: dtZ84flFEi4Q+SGrHMJRDQ ($31.10 in chips) 
Seat 9: s2xLPOl/vhl/26apJ3vsOQ ($29.25 in chips) 
U41wNf6XauAiBOQaKu2ZIA: posts small blind $0.10
arxNSjreDRGFg13EAM2F1w: posts big blind $0.25
*** HOLE CARDS ***
w1ukf8uPa4+WH561TtVRxA: folds 
dtZ84flFEi4Q+SGrHMJRDQ: folds 
s2xLPOl/vhl/26apJ3vsOQ: folds 
tLcDklc2rBORNfixyRfVfw: folds 
HPEB+AtKw1+C/cxU0o1ciw: folds 
eK8qa6EPcH2zhtbmWSvc9g: folds 
j4q3p0lesp63b1gZDwLBZw: folds 
U41wNf6XauAiBOQaKu2ZIA: raises $0.25 to $0.50
arxNSjreDRGFg13EAM2F1w: calls $0.25
*** FLOP *** [Tc Js 7c]
U41wNf6XauAiBOQaKu2ZIA: checks 
arxNSjreDRGFg13EAM2F1w: bets $0.50
U41wNf6XauAiBOQaKu2ZIA: folds 
Uncalled bet ($0.50) returned to arxNSjreDRGFg13EAM2F1w
arxNSjreDRGFg13EAM2F1w collected $0.95 from pot
arxNSjreDRGFg13EAM2F1w: doesn't show hand 
U41wNf6XauAiBOQaKu2ZIA leaves the table
*** SUMMARY ***
Total pot $1 | Rake $0.05 
Board [Tc Js 7c]
Seat 1: tLcDklc2rBORNfixyRfVfw folded before Flop (didn't bet)
Seat 2: HPEB+AtKw1+C/cxU0o1ciw folded before Flop (didn't bet)
Seat 3: eK8qa6EPcH2zhtbmWSvc9g folded before Flop (didn't bet)
Seat 4: j4q3p0lesp63b1gZDwLBZw (button) folded before Flop (didn't bet)
Seat 5: U41wNf6XauAiBOQaKu2ZIA (small blind) folded on the Flop
Seat 6: arxNSjreDRGFg13EAM2F1w (big blind) collected ($0.95)
Seat 7: w1ukf8uPa4+WH561TtVRxA folded before Flop (didn't bet)
Seat 8: dtZ84flFEi4Q+SGrHMJRDQ folded before Flop (didn't bet)
Seat 9: s2xLPOl/vhl/26apJ3vsOQ folded before Flop (didn't bet)




PokerStars Game #59941798828:  Hold'em No Limit ($0.10/$0.25) - 2009/07/01 1:46:30 ET
Table 'Utmw+yX+E/wdhNDIim90lQ' 9-max Seat #4 is the button
Seat 1: cZ99hugmLBj9KhTlc8nCSw ($30.70 in chips) 
Seat 2: iGMlK+EhUflPB6jKQd95Cg ($27.35 in chips) 
Seat 3: dfNim92Z6XK1/h5SFW5vDg ($25 in chips) 
Seat 4: ifYGvZDHQQ0aam4awTtHwA ($25.85 in chips) 
Seat 5: ghNKXUBl/H+t83JF079ZBA ($25 in chips) 
Seat 6: OlPJsgR4xypSg/w1z7Gyvw ($34.40 in chips) 
Seat 8: Mh2r9hTeTEDnh19sRZtW3g ($5 in chips) 
Seat 9: Th3FldXKQW6hWVVPahaoOQ ($28.50 in chips) 
ghNKXUBl/H+t83JF079ZBA: posts small blind $0.10
OlPJsgR4xypSg/w1z7Gyvw: posts big blind $0.25
*** HOLE CARDS ***
Mh2r9hTeTEDnh19sRZtW3g: folds 
AKDario has returned
Th3FldXKQW6hWVVPahaoOQ: calls $0.25
cZ99hugmLBj9KhTlc8nCSw: raises $0.75 to $1
iGMlK+EhUflPB6jKQd95Cg: folds 
dfNim92Z6XK1/h5SFW5vDg: folds 
ifYGvZDHQQ0aam4awTtHwA: folds 
ghNKXUBl/H+t83JF079ZBA: folds 
OlPJsgR4xypSg/w1z7Gyvw: folds 
Th3FldXKQW6hWVVPahaoOQ: calls $0.75
*** FLOP *** [8h Js Ts]
Th3FldXKQW6hWVVPahaoOQ: checks 
cZ99hugmLBj9KhTlc8nCSw: bets $1.50
Th3FldXKQW6hWVVPahaoOQ: folds 
Uncalled bet ($1.50) returned to cZ99hugmLBj9KhTlc8nCSw
cZ99hugmLBj9KhTlc8nCSw collected $2.25 from pot
*** SUMMARY ***
Total pot $2.35 | Rake $0.10 
Board [8h Js Ts]
Seat 1: cZ99hugmLBj9KhTlc8nCSw collected ($2.25)
Seat 2: iGMlK+EhUflPB6jKQd95Cg folded before Flop (didn't bet)
Seat 3: dfNim92Z6XK1/h5SFW5vDg folded before Flop (didn't bet)
Seat 4: ifYGvZDHQQ0aam4awTtHwA (button) folded before Flop (didn't bet)
Seat 5: ghNKXUBl/H+t83JF079ZBA (small blind) folded before Flop
Seat 6: OlPJsgR4xypSg/w1z7Gyvw (big blind) folded before Flop
Seat 8: Mh2r9hTeTEDnh19sRZtW3g folded before Flop (didn't bet)
Seat 9: Th3FldXKQW6hWVVPahaoOQ folded on the Flop




PokerStars Game #59941798508:  Hold'em No Limit ($0.10/$0.25) - 2009/07/01 1:46:30 ET
Table 'nyTW9cVtYentc5V7xU/0jA' 6-max Seat #4 is the button
Seat 1: HI20pVxSHPZ29u9IDkmICg ($13.15 in chips) 
Seat 2: v6mkGzCBCCXcgWQNSYVtKg ($5.80 in chips) 
Seat 3: kG34n23qFQA3nzdOJTQ1dA ($35.75 in chips) 
Seat 4: NkB3D4eVHHXvB9Edaugc1Q ($32.20 in chips) 
Seat 5: zZAcuQ0EvirdEuiIbeaocQ ($6.35 in chips) 
zZAcuQ0EvirdEuiIbeaocQ: posts small blind $0.10
HI20pVxSHPZ29u9IDkmICg: posts big blind $0.25
*** HOLE CARDS ***
v6mkGzCBCCXcgWQNSYVtKg: calls $0.25
kG34n23qFQA3nzdOJTQ1dA: folds 
NkB3D4eVHHXvB9Edaugc1Q: folds 
Q1uciOZPBR/WkAlqa6cL4A leaves the table
zZAcuQ0EvirdEuiIbeaocQ: raises $0.50 to $0.75
HI20pVxSHPZ29u9IDkmICg: folds 
v6mkGzCBCCXcgWQNSYVtKg: calls $0.50
*** FLOP *** [9h 4s 2h]
zZAcuQ0EvirdEuiIbeaocQ: bets $0.75
v6mkGzCBCCXcgWQNSYVtKg: calls $0.75
*** TURN *** [9h 4s 2h] [Qd]
zZAcuQ0EvirdEuiIbeaocQ: bets $1.25
v6mkGzCBCCXcgWQNSYVtKg: calls $1.25
*** RIVER *** [9h 4s 2h Qd] [4c]
zZAcuQ0EvirdEuiIbeaocQ: checks 
v6mkGzCBCCXcgWQNSYVtKg: bets $3.05 and is all-in
zZAcuQ0EvirdEuiIbeaocQ: folds 
Uncalled bet ($3.05) returned to v6mkGzCBCCXcgWQNSYVtKg
thomefan251 joins the table at seat #6 
v6mkGzCBCCXcgWQNSYVtKg collected $5.50 from pot
*** SUMMARY ***
Total pot $5.75 | Rake $0.25 
Board [9h 4s 2h Qd 4c]
Seat 1: HI20pVxSHPZ29u9IDkmICg (big blind) folded before Flop
Seat 2: v6mkGzCBCCXcgWQNSYVtKg collected ($5.50)
Seat 3: kG34n23qFQA3nzdOJTQ1dA folded before Flop (didn't bet)
Seat 4: NkB3D4eVHHXvB9Edaugc1Q (button) folded before Flop (didn't bet)
Seat 5: zZAcuQ0EvirdEuiIbeaocQ (small blind) folded on the River




PokerStars Game #59941800070:  Hold'em No Limit ($0.10/$0.25) - 2009/07/01 1:46:32 ET
Table 'g+mPuNJBCHKE9ents7ZGtg' 6-max Seat #5 is the button
Seat 1: cezpHJ8FB07dj0xG+LhOvw ($58.65 in chips) 
Seat 2: fZQg9veL7Dd/Z04ZTjC+wQ ($64.95 in chips) 
Seat 3: FYepjhAvF8ZdVCmqHIy+eQ ($29.90 in chips) 
Seat 4: yVrjRIW0SMxgpvqSIPSe/w ($16.35 in chips) 
Seat 5: D3ikCR8c/o9jB5irZ3uGlw ($12.15 in chips) 
Seat 6: Mn2V28t5aGq2d09z+/o6Fw ($22.65 in chips) 
Mn2V28t5aGq2d09z+/o6Fw: posts small blind $0.10
cezpHJ8FB07dj0xG+LhOvw: posts big blind $0.25
*** HOLE CARDS ***
fZQg9veL7Dd/Z04ZTjC+wQ: folds 
FYepjhAvF8ZdVCmqHIy+eQ: folds 
yVrjRIW0SMxgpvqSIPSe/w: folds 
D3ikCR8c/o9jB5irZ3uGlw: raises $0.25 to $0.50
Mn2V28t5aGq2d09z+/o6Fw: folds 
cezpHJ8FB07dj0xG+LhOvw: folds 
Uncalled bet ($0.25) returned to D3ikCR8c/o9jB5irZ3uGlw
D3ikCR8c/o9jB5irZ3uGlw collected $0.60 from pot
*** SUMMARY ***
Total pot $0.60 | Rake $0 
Seat 1: cezpHJ8FB07dj0xG+LhOvw (big blind) folded before Flop
Seat 2: fZQg9veL7Dd/Z04ZTjC+wQ folded before Flop (didn't bet)
Seat 3: FYepjhAvF8ZdVCmqHIy+eQ folded before Flop (didn't bet)
Seat 4: yVrjRIW0SMxgpvqSIPSe/w folded before Flop (didn't bet)
Seat 5: D3ikCR8c/o9jB5irZ3uGlw (button) collected ($0.60)
Seat 6: Mn2V28t5aGq2d09z+/o6Fw (small blind) folded before Flop




PokerStars Game #59941800032:  Hold'em No Limit ($0.10/$0.25) - 2009/07/01 1:46:32 ET
Table 'sgdCtiuCu2BDZhyDi6RzTA' 6-max Seat #5 is the button
Seat 1: 3zD3qLXT1bEffAoWGnc7wg ($35.75 in chips) 
Seat 2: XD1i5m5PvBDnRzJaG/vINw ($24.05 in chips) 
Seat 3: eL3+wCBjFGfQ5FMdIZihwA ($25.50 in chips) 
Seat 4: rVKEgilmMX+EkKzDVvhmxA ($7.35 in chips) 
Seat 5: 0tQitW75xfmVWKldYHjmOQ ($3.05 in chips) 
Seat 6: KODslGU8ikCYS0/29dUkhg ($34.20 in chips) 
KODslGU8ikCYS0/29dUkhg: posts small blind $0.10
3zD3qLXT1bEffAoWGnc7wg: posts big blind $0.25
*** HOLE CARDS ***
XD1i5m5PvBDnRzJaG/vINw: folds 
eL3+wCBjFGfQ5FMdIZihwA: folds 
rVKEgilmMX+EkKzDVvhmxA: folds 
0tQitW75xfmVWKldYHjmOQ: folds 
KODslGU8ikCYS0/29dUkhg: calls $0.15
3zD3qLXT1bEffAoWGnc7wg: checks 
*** FLOP *** [Ah Ac 7s]
KODslGU8ikCYS0/29dUkhg: checks 
3zD3qLXT1bEffAoWGnc7wg: checks 
*** TURN *** [Ah Ac 7s] [6c]
KODslGU8ikCYS0/29dUkhg: checks 
3zD3qLXT1bEffAoWGnc7wg: checks 
*** RIVER *** [Ah Ac 7s 6c] [Qc]
KODslGU8ikCYS0/29dUkhg: bets $1.75
3zD3qLXT1bEffAoWGnc7wg: folds 
Uncalled bet ($1.75) returned to KODslGU8ikCYS0/29dUkhg
KODslGU8ikCYS0/29dUkhg collected $0.50 from pot
*** SUMMARY ***
Total pot $0.50 | Rake $0 
Board [Ah Ac 7s 6c Qc]
Seat 1: 3zD3qLXT1bEffAoWGnc7wg (big blind) folded on the River
Seat 2: XD1i5m5PvBDnRzJaG/vINw folded before Flop (didn't bet)
Seat 3: eL3+wCBjFGfQ5FMdIZihwA folded before Flop (didn't bet)
Seat 4: rVKEgilmMX+EkKzDVvhmxA folded before Flop (didn't bet)
Seat 5: 0tQitW75xfmVWKldYHjmOQ (button) folded before Flop (didn't bet)
Seat 6: KODslGU8ikCYS0/29dUkhg (small blind) collected ($0.50)




PokerStars Game #59941800192:  Hold'em No Limit ($0.10/$0.25) - 2009/07/01 1:46:33 ET
Table 'aaXqTKUnxrX9DYXtxhWXxA' 6-max Seat #3 is the button
Seat 1: aSrj4lVmn2owyQ1RbbOqxQ ($26.80 in chips) 
Seat 2: DE9hRlt14g+JdsRQ4wT7hg ($33.35 in chips) 
Seat 3: uUXdcVMNa05rfbntdvplfw ($8.15 in chips) 
Seat 4: 48oT5xFI+5CHUJlfoGrE4w ($8.90 in chips) 
Seat 5: kyRaCIljYA6l33lSKQfNsg ($24.95 in chips) 
Seat 6: buyjetgNT1McXtdaP4zynA ($50.15 in chips) 
48oT5xFI+5CHUJlfoGrE4w: posts small blind $0.10
kyRaCIljYA6l33lSKQfNsg: posts big blind $0.25
*** HOLE CARDS ***
buyjetgNT1McXtdaP4zynA: folds 
aSrj4lVmn2owyQ1RbbOqxQ: raises $0.75 to $1
DE9hRlt14g+JdsRQ4wT7hg: folds 
uUXdcVMNa05rfbntdvplfw: folds 
48oT5xFI+5CHUJlfoGrE4w: folds 
kyRaCIljYA6l33lSKQfNsg: folds 
Uncalled bet ($0.75) returned to aSrj4lVmn2owyQ1RbbOqxQ
aSrj4lVmn2owyQ1RbbOqxQ collected $0.60 from pot
aSrj4lVmn2owyQ1RbbOqxQ: doesn't show hand 
*** SUMMARY ***
Total pot $0.60 | Rake $0 
Seat 1: aSrj4lVmn2owyQ1RbbOqxQ collected ($0.60)
Seat 2: DE9hRlt14g+JdsRQ4wT7hg folded before Flop (didn't bet)
Seat 3: uUXdcVMNa05rfbntdvplfw (button) folded before Flop (didn't bet)
Seat 4: 48oT5xFI+5CHUJlfoGrE4w (small blind) folded before Flop
Seat 5: kyRaCIljYA6l33lSKQfNsg (big blind) folded before Flop
Seat 6: buyjetgNT1McXtdaP4zynA folded before Flop (didn't bet)




PokerStars Game #59941800352:  Hold'em No Limit ($0.10/$0.25) - 2009/07/01 1:46:33 ET
Table 'AHkg4ChqzcMauBx6Qvz8Nw' 6-max Seat #5 is the button
Seat 1: +RDf7SmUjY2kK0PzdBEYqg ($6.65 in chips) 
Seat 2: Vi0JMrTI2BGrPL7UIulJtA ($5.30 in chips) 
Seat 3: 9dToMv2GJLfi00HcpfMnIw ($27.50 in chips) 
Seat 4: Eznneya0vB6S+eXJdVleHA ($16.95 in chips) 
Seat 5: Bada343Si4xKu3fNXY99AA ($3.85 in chips) 
Seat 6: Hsvkc0/G2VV78oVmWYXecw ($5 in chips) 
Hsvkc0/G2VV78oVmWYXecw: posts small blind $0.10
+RDf7SmUjY2kK0PzdBEYqg: posts big blind $0.25
*** HOLE CARDS ***
Vi0JMrTI2BGrPL7UIulJtA: folds 
Eznneya0vB6S+eXJdVleHA said, "i had pocked 10"
9dToMv2GJLfi00HcpfMnIw: folds 
Eznneya0vB6S+eXJdVleHA: folds 
Bada343Si4xKu3fNXY99AA: calls $0.25
Hsvkc0/G2VV78oVmWYXecw: folds 
+RDf7SmUjY2kK0PzdBEYqg: checks 
*** FLOP *** [9d 3h 5c]
9dToMv2GJLfi00HcpfMnIw said, "kings"
+RDf7SmUjY2kK0PzdBEYqg: checks 
Bada343Si4xKu3fNXY99AA: checks 
*** TURN *** [9d 3h 5c] [As]
+RDf7SmUjY2kK0PzdBEYqg: checks 
Eznneya0vB6S+eXJdVleHA said, "f.e lol"
Bada343Si4xKu3fNXY99AA: bets $0.50
+RDf7SmUjY2kK0PzdBEYqg: folds 
Uncalled bet ($0.50) returned to Bada343Si4xKu3fNXY99AA
Bada343Si4xKu3fNXY99AA collected $0.60 from pot
*** SUMMARY ***
Total pot $0.60 | Rake $0 
Board [9d 3h 5c As]
Seat 1: +RDf7SmUjY2kK0PzdBEYqg (big blind) folded on the Turn
Seat 2: Vi0JMrTI2BGrPL7UIulJtA folded before Flop (didn't bet)
Seat 3: 9dToMv2GJLfi00HcpfMnIw folded before Flop (didn't bet)
Seat 4: Eznneya0vB6S+eXJdVleHA folded before Flop (didn't bet)
Seat 5: Bada343Si4xKu3fNXY99AA (button) collected ($0.60)
Seat 6: Hsvkc0/G2VV78oVmWYXecw (small blind) folded before Flop




PokerStars Game #59941800306:  Hold'em No Limit ($0.10/$0.25) - 2009/07/01 1:46:33 ET
Table 'vFZR6Kf2Th5xBXT9brGW6A' 6-max Seat #2 is the button
Seat 1: Q3EMN7b0ie81AFWkDrhCjw ($3.90 in chips) 
Seat 2: QiL+lEgEWwy21jk/ltaRLg ($22.05 in chips) 
Seat 3: SH1WjKVUjPiyXySjWSdazw ($40.25 in chips) 
Seat 4: 79ID/ub1Pt/mDpCprVmOoA ($35.20 in chips) 
Seat 5: SS/yfeArhULzIcOPe8MdPg ($26.30 in chips) 
Seat 6: 4x9jCqgSw4272dnaIqnanw ($10.90 in chips) 
SH1WjKVUjPiyXySjWSdazw: posts small blind $0.10
79ID/ub1Pt/mDpCprVmOoA: posts big blind $0.25
*** HOLE CARDS ***
SS/yfeArhULzIcOPe8MdPg: folds 
4x9jCqgSw4272dnaIqnanw: folds 
Q3EMN7b0ie81AFWkDrhCjw: folds 
Q3EMN7b0ie81AFWkDrhCjw leaves the table
QiL+lEgEWwy21jk/ltaRLg: folds 
SH1WjKVUjPiyXySjWSdazw: raises $0.50 to $0.75
79ID/ub1Pt/mDpCprVmOoA: folds 
Uncalled bet ($0.50) returned to SH1WjKVUjPiyXySjWSdazw
Q1uciOZPBR/WkAlqa6cL4A joins the table at seat #1 
SH1WjKVUjPiyXySjWSdazw collected $0.50 from pot
SH1WjKVUjPiyXySjWSdazw: doesn't show hand 
*** SUMMARY ***
Total pot $0.50 | Rake $0 
Seat 1: Q3EMN7b0ie81AFWkDrhCjw folded before Flop (didn't bet)
Seat 2: QiL+lEgEWwy21jk/ltaRLg (button) folded before Flop (didn't bet)
Seat 3: SH1WjKVUjPiyXySjWSdazw (small blind) collected ($0.50)
Seat 4: 79ID/ub1Pt/mDpCprVmOoA (big blind) folded before Flop
Seat 5: SS/yfeArhULzIcOPe8MdPg folded before Flop (didn't bet)
Seat 6: 4x9jCqgSw4272dnaIqnanw folded before Flop (didn't bet)




PokerStars Game #59941800486:  Hold'em No Limit ($0.10/$0.25) - 2009/07/01 1:46:33 ET
Table '29D3eoQzK5kOAT0OIDS2uQ' 6-max Seat #4 is the button
Seat 1: kG34n23qFQA3nzdOJTQ1dA ($46.40 in chips) 
Seat 2: FyE+TQ5JcCqI/tCCHf0jGA ($17.45 in chips) 
Seat 3: z3tQwy28dp5FykDJC/wzQw ($17.45 in chips) 
Seat 4: MqMK8OWPSY1V4stf1Hy5Jw ($35.55 in chips) 
Seat 5: Q3EMN7b0ie81AFWkDrhCjw ($22.60 in chips) 
Seat 6: bWbV4MVB/vVpiES1Ut4hew ($30.65 in chips) 
Q3EMN7b0ie81AFWkDrhCjw: posts small blind $0.10
bWbV4MVB/vVpiES1Ut4hew: posts big blind $0.25
*** HOLE CARDS ***
kG34n23qFQA3nzdOJTQ1dA: folds 
FyE+TQ5JcCqI/tCCHf0jGA: folds 
z3tQwy28dp5FykDJC/wzQw: calls $0.25
MqMK8OWPSY1V4stf1Hy5Jw: raises $0.75 to $1
Q3EMN7b0ie81AFWkDrhCjw: calls $0.90
bWbV4MVB/vVpiES1Ut4hew: raises $4.25 to $5.25
z3tQwy28dp5FykDJC/wzQw: folds 
MqMK8OWPSY1V4stf1Hy5Jw: folds 
Q3EMN7b0ie81AFWkDrhCjw: folds 
Uncalled bet ($4.25) returned to bWbV4MVB/vVpiES1Ut4hew
bWbV4MVB/vVpiES1Ut4hew collected $3.25 from pot
*** SUMMARY ***
Total pot $3.25 | Rake $0 
Seat 1: kG34n23qFQA3nzdOJTQ1dA folded before Flop (didn't bet)
Seat 2: FyE+TQ5JcCqI/tCCHf0jGA folded before Flop (didn't bet)
Seat 3: z3tQwy28dp5FykDJC/wzQw folded before Flop
Seat 4: MqMK8OWPSY1V4stf1Hy5Jw (button) folded before Flop
Seat 5: Q3EMN7b0ie81AFWkDrhCjw (small blind) folded before Flop
Seat 6: bWbV4MVB/vVpiES1Ut4hew (big blind) collected ($3.25)




PokerStars Game #59941800314:  Hold'em No Limit ($0.10/$0.25) - 2009/07/01 1:46:33 ET
Table 'rjcb+nlE+0GuJ6lBhuCkkA' 6-max Seat #1 is the button
Seat 1: lBoEwOFgzcERLIRUkUoRTw ($13.25 in chips) 
Seat 2: lJphax9e7/+O/3YCKPJ0yQ ($8.60 in chips) 
Seat 3: 8ClCHtFXGNplITm+63KB+Q ($65.15 in chips) 
Seat 4: BV+K0Phf5VBHr7aZPKqbUQ ($35.15 in chips) 
Seat 5: GC/9yVD59DUCX7hUI7gcLw ($29 in chips) 
Seat 6: 32YL2ZEp8NT4JB2RVM9euQ ($16.05 in chips) 
lJphax9e7/+O/3YCKPJ0yQ: posts small blind $0.10
8ClCHtFXGNplITm+63KB+Q: posts big blind $0.25
*** HOLE CARDS ***
BV+K0Phf5VBHr7aZPKqbUQ: folds 
GC/9yVD59DUCX7hUI7gcLw: folds 
32YL2ZEp8NT4JB2RVM9euQ: folds 
lBoEwOFgzcERLIRUkUoRTw: folds 
lJphax9e7/+O/3YCKPJ0yQ: calls $0.15
8ClCHtFXGNplITm+63KB+Q: raises $1 to $1.25
lJphax9e7/+O/3YCKPJ0yQ: calls $1
*** FLOP *** [6c Kh 6s]
lJphax9e7/+O/3YCKPJ0yQ: checks 
8ClCHtFXGNplITm+63KB+Q: bets $2.25
lJphax9e7/+O/3YCKPJ0yQ: folds 
Uncalled bet ($2.25) returned to 8ClCHtFXGNplITm+63KB+Q
8ClCHtFXGNplITm+63KB+Q collected $2.40 from pot
8ClCHtFXGNplITm+63KB+Q: doesn't show hand 
*** SUMMARY ***
Total pot $2.50 | Rake $0.10 
Board [6c Kh 6s]
Seat 1: lBoEwOFgzcERLIRUkUoRTw (button) folded before Flop (didn't bet)
Seat 2: lJphax9e7/+O/3YCKPJ0yQ (small blind) folded on the Flop
Seat 3: 8ClCHtFXGNplITm+63KB+Q (big blind) collected ($2.40)
Seat 4: BV+K0Phf5VBHr7aZPKqbUQ folded before Flop (didn't bet)
Seat 5: GC/9yVD59DUCX7hUI7gcLw folded before Flop (didn't bet)
Seat 6: 32YL2ZEp8NT4JB2RVM9euQ folded before Flop (didn't bet)




PokerStars Game #59941800518:  Hold'em No Limit ($0.10/$0.25) - 2009/07/01 1:46:33 ET
Table 'MiquQrQZJJq9ZtgRIp9HFQ' 6-max Seat #5 is the button
Seat 1: c3J/KYZ4cNsUEuz8v57I5A ($21.25 in chips) 
Seat 2: 2+6voGl1T1DO63JePptI3g ($19 in chips) 
Seat 3: 9h7TNZ1TDGRUJXA6rI+ZTw ($9.75 in chips) 
Seat 4: wAKC8C/zN0c8V5v13dm9mA ($57.95 in chips) 
Seat 5: iyZxqznXjv3vtvOJymkoLQ ($26.75 in chips) 
Seat 6: GbCVUNssQ7mqsPWr7J4d3w ($4.75 in chips) 
GbCVUNssQ7mqsPWr7J4d3w: posts small blind $0.10
c3J/KYZ4cNsUEuz8v57I5A: posts big blind $0.25
*** HOLE CARDS ***
2+6voGl1T1DO63JePptI3g: raises $0.25 to $0.50
9h7TNZ1TDGRUJXA6rI+ZTw: folds 
wAKC8C/zN0c8V5v13dm9mA: raises $1 to $1.50
iyZxqznXjv3vtvOJymkoLQ: folds 
GbCVUNssQ7mqsPWr7J4d3w: folds 
c3J/KYZ4cNsUEuz8v57I5A: folds 
2+6voGl1T1DO63JePptI3g: calls $1
*** FLOP *** [Td Tc 2h]
2+6voGl1T1DO63JePptI3g: checks 
wAKC8C/zN0c8V5v13dm9mA: bets $2
2+6voGl1T1DO63JePptI3g: calls $2
*** TURN *** [Td Tc 2h] [2d]
2+6voGl1T1DO63JePptI3g: checks 
wAKC8C/zN0c8V5v13dm9mA: checks 
*** RIVER *** [Td Tc 2h 2d] [Jc]
2+6voGl1T1DO63JePptI3g: bets $7.50
wAKC8C/zN0c8V5v13dm9mA: folds 
Uncalled bet ($7.50) returned to 2+6voGl1T1DO63JePptI3g
2+6voGl1T1DO63JePptI3g collected $7 from pot
*** SUMMARY ***
Total pot $7.35 | Rake $0.35 
Board [Td Tc 2h 2d Jc]
Seat 1: c3J/KYZ4cNsUEuz8v57I5A (big blind) folded before Flop
Seat 2: 2+6voGl1T1DO63JePptI3g collected ($7)
Seat 3: 9h7TNZ1TDGRUJXA6rI+ZTw folded before Flop (didn't bet)
Seat 4: wAKC8C/zN0c8V5v13dm9mA folded on the River
Seat 5: iyZxqznXjv3vtvOJymkoLQ (button) folded before Flop (didn't bet)
Seat 6: GbCVUNssQ7mqsPWr7J4d3w (small blind) folded before Flop




PokerStars Game #59941800292:  Hold'em No Limit ($0.10/$0.25) - 2009/07/01 1:46:33 ET
Table '52Meibn9NOL4XtVi1p2Upw' 9-max Seat #5 is the button
Seat 1: W6tExOcYX7qiy6Qdp+ZwFA ($6.80 in chips) 
Seat 3: Bb42QRQMhg5/Y0vHP8/2Xw ($25 in chips) 
Seat 4: oLa/tXLfSLLB28mcLGrxcg ($31.65 in chips) 
Seat 5: MXCztnYJ58KLHMztZvKrxA ($3.60 in chips) 
Seat 6: N5sUK8M0br9djLrW97V9pQ ($29.60 in chips) 
Seat 7: Qduu7ikeizo6q6Ei9YvcJA ($25 in chips) 
Seat 9: RCqMONFrSPSArZh2Jsar/w ($19.65 in chips) 
N5sUK8M0br9djLrW97V9pQ: posts small blind $0.10
Qduu7ikeizo6q6Ei9YvcJA: posts big blind $0.25
*** HOLE CARDS ***
RCqMONFrSPSArZh2Jsar/w: folds 
W6tExOcYX7qiy6Qdp+ZwFA: folds 
w7VrLGwaVQzOQXfRqJitMQ joins the table at seat #8 
Bb42QRQMhg5/Y0vHP8/2Xw: folds 
oLa/tXLfSLLB28mcLGrxcg: folds 
Yslaketh joins the table at seat #2 
MXCztnYJ58KLHMztZvKrxA: folds 
N5sUK8M0br9djLrW97V9pQ: folds 
Uncalled bet ($0.15) returned to Qduu7ikeizo6q6Ei9YvcJA
Qduu7ikeizo6q6Ei9YvcJA collected $0.20 from pot
Qduu7ikeizo6q6Ei9YvcJA: doesn't show hand 
*** SUMMARY ***
Total pot $0.20 | Rake $0 
Seat 1: W6tExOcYX7qiy6Qdp+ZwFA folded before Flop (didn't bet)
Seat 3: Bb42QRQMhg5/Y0vHP8/2Xw folded before Flop (didn't bet)
Seat 4: oLa/tXLfSLLB28mcLGrxcg folded before Flop (didn't bet)
Seat 5: MXCztnYJ58KLHMztZvKrxA (button) folded before Flop (didn't bet)
Seat 6: N5sUK8M0br9djLrW97V9pQ (small blind) folded before Flop
Seat 7: Qduu7ikeizo6q6Ei9YvcJA (big blind) collected ($0.20)
Seat 9: RCqMONFrSPSArZh2Jsar/w folded before Flop (didn't bet)




PokerStars Game #59941800262:  Hold'em No Limit ($0.10/$0.25) - 2009/07/01 1:46:33 ET
Table 'CBnRhp0d6E2+/NtM7Vbruw' 9-max Seat #7 is the button
Seat 1: WQe4GbiYBiPsb5WKFKkijQ ($10.75 in chips) 
Seat 2: cZ99hugmLBj9KhTlc8nCSw ($26.85 in chips) 
Seat 3: aNpwfA31EREwO+ar4XzBCw ($33.70 in chips) 
Seat 5: CT7Xj/V/O5rBlhtt+RZeFQ ($25 in chips) 
Seat 6: CvL9Ch1HYCVbTsfpNucitg ($4.30 in chips) 
Seat 7: j4q3p0lesp63b1gZDwLBZw ($5 in chips) 
Seat 8: MG90wfSJZnOejs/KD3vlQQ ($25.10 in chips) 
Seat 9: xHZZRLAaFUIC8WWI8ljOJA ($29.90 in chips) 
MG90wfSJZnOejs/KD3vlQQ: posts small blind $0.10
xHZZRLAaFUIC8WWI8ljOJA: posts big blind $0.25
*** HOLE CARDS ***
WQe4GbiYBiPsb5WKFKkijQ: folds 
WQe4GbiYBiPsb5WKFKkijQ leaves the table
18G4P1XstjNvItdGUITxgw joins the table at seat #1 
cZ99hugmLBj9KhTlc8nCSw: folds 
aNpwfA31EREwO+ar4XzBCw: folds 
CT7Xj/V/O5rBlhtt+RZeFQ: folds 
CvL9Ch1HYCVbTsfpNucitg: folds 
j4q3p0lesp63b1gZDwLBZw: folds 
MG90wfSJZnOejs/KD3vlQQ: raises $0.50 to $0.75
xHZZRLAaFUIC8WWI8ljOJA: folds 
Uncalled bet ($0.50) returned to MG90wfSJZnOejs/KD3vlQQ
MG90wfSJZnOejs/KD3vlQQ collected $0.50 from pot
MG90wfSJZnOejs/KD3vlQQ: doesn't show hand 
*** SUMMARY ***
Total pot $0.50 | Rake $0 
Seat 1: WQe4GbiYBiPsb5WKFKkijQ folded before Flop (didn't bet)
Seat 2: cZ99hugmLBj9KhTlc8nCSw folded before Flop (didn't bet)
Seat 3: aNpwfA31EREwO+ar4XzBCw folded before Flop (didn't bet)
Seat 5: CT7Xj/V/O5rBlhtt+RZeFQ folded before Flop (didn't bet)
Seat 6: CvL9Ch1HYCVbTsfpNucitg folded before Flop (didn't bet)
Seat 7: j4q3p0lesp63b1gZDwLBZw (button) folded before Flop (didn't bet)
Seat 8: MG90wfSJZnOejs/KD3vlQQ (small blind) collected ($0.50)
Seat 9: xHZZRLAaFUIC8WWI8ljOJA (big blind) folded before Flop




PokerStars Game #59941800628:  Hold'em No Limit ($0.10/$0.25) - 2009/07/01 1:46:33 ET
Table 'Y9EhDWuqWWQFM9SelXAj5g' 9-max Seat #4 is the button
Seat 2: W+njF1UnarGN2q2zP+R+cg ($8.40 in chips) 
Seat 3: XBq1lBzax7LjRqdJP2TqWg ($6.45 in chips) 
Seat 4: V6p0jQ/RhUsqpHLmXvEX4Q ($13 in chips) 
Seat 5: CvL9Ch1HYCVbTsfpNucitg ($6.45 in chips) 
Seat 6: egvg3mTBBVzMHnJPIQiKcA ($14 in chips) 
Seat 7: aNpwfA31EREwO+ar4XzBCw ($26.60 in chips) 
Seat 8: XDxyajtqmdag0QPvwcOG7Q ($14.60 in chips) 
Seat 9: bOrfviVhRBpaOfMqUc74Tw ($17.65 in chips) 
CvL9Ch1HYCVbTsfpNucitg: posts small blind $0.10
egvg3mTBBVzMHnJPIQiKcA: posts big blind $0.25
XBq1lBzax7LjRqdJP2TqWg: posts big blind $0.25
*** HOLE CARDS ***
aNpwfA31EREwO+ar4XzBCw: folds 
XDxyajtqmdag0QPvwcOG7Q: folds 
bOrfviVhRBpaOfMqUc74Tw: folds 
W+njF1UnarGN2q2zP+R+cg: calls $0.25
XBq1lBzax7LjRqdJP2TqWg: checks 
V6p0jQ/RhUsqpHLmXvEX4Q: folds 
CvL9Ch1HYCVbTsfpNucitg: calls $0.15
egvg3mTBBVzMHnJPIQiKcA: checks 
*** FLOP *** [Ah Qh 6d]
CvL9Ch1HYCVbTsfpNucitg: checks 
egvg3mTBBVzMHnJPIQiKcA: checks 
W+njF1UnarGN2q2zP+R+cg: bets $0.75
XBq1lBzax7LjRqdJP2TqWg: raises $0.75 to $1.50
zDrucyjVn5aeekNEc3cJrA has returned
CvL9Ch1HYCVbTsfpNucitg: folds 
egvg3mTBBVzMHnJPIQiKcA: folds 
W+njF1UnarGN2q2zP+R+cg: calls $0.75
*** TURN *** [Ah Qh 6d] [4s]
W+njF1UnarGN2q2zP+R+cg: checks 
XBq1lBzax7LjRqdJP2TqWg: bets $1
W+njF1UnarGN2q2zP+R+cg: calls $1
*** RIVER *** [Ah Qh 6d 4s] [Jh]
W+njF1UnarGN2q2zP+R+cg: checks 
XBq1lBzax7LjRqdJP2TqWg: checks 
*** SHOW DOWN ***
W+njF1UnarGN2q2zP+R+cg: shows [Kh Ad] (a pair of Aces)
XBq1lBzax7LjRqdJP2TqWg: mucks hand 
W+njF1UnarGN2q2zP+R+cg collected $5.75 from pot
*** SUMMARY ***
Total pot $6 | Rake $0.25 
Board [Ah Qh 6d 4s Jh]
Seat 2: W+njF1UnarGN2q2zP+R+cg showed [Kh Ad] and won ($5.75) with a pair of Aces
Seat 3: XBq1lBzax7LjRqdJP2TqWg mucked
Seat 4: V6p0jQ/RhUsqpHLmXvEX4Q (button) folded before Flop (didn't bet)
Seat 5: CvL9Ch1HYCVbTsfpNucitg (small blind) folded on the Flop
Seat 6: egvg3mTBBVzMHnJPIQiKcA (big blind) folded on the Flop
Seat 7: aNpwfA31EREwO+ar4XzBCw folded before Flop (didn't bet)
Seat 8: XDxyajtqmdag0QPvwcOG7Q folded before Flop (didn't bet)
Seat 9: bOrfviVhRBpaOfMqUc74Tw folded before Flop (didn't bet)




PokerStars Game #59941800270:  Hold'em No Limit ($0.10/$0.25) - 2009/07/01 1:46:33 ET
Table 'zhqgUUprOJ14VxKxPHcT/Q' 9-max Seat #3 is the button
Seat 1: 22dIObOuor/A+IKWkNoAlA ($5.50 in chips) 
Seat 2: GY095KWhBevJ1Ttvl8WseA ($14.25 in chips) 
Seat 3: 4XHsdGnQ76EBdBvsrSs8bA ($24.80 in chips) 
Seat 4: wGigCmBR/9XWkPpvYos3aQ ($33.55 in chips) 
Seat 5: +sbyWwIcFp9kP0bDtMegfQ ($33.60 in chips) 
Seat 7: sGFnnRCa1YAHAUmWgsW6Qg ($11 in chips) 
Seat 8: EQXHDnIzAsORnIXRNtXRlA ($24.10 in chips) 
Seat 9: 4awUyiDYTgylQKXZ9faBVA ($25.80 in chips) 
wGigCmBR/9XWkPpvYos3aQ: posts small blind $0.10
+sbyWwIcFp9kP0bDtMegfQ: posts big blind $0.25
PdIasPkzm2sqZnN41ZRXOg: sits out 
*** HOLE CARDS ***
sGFnnRCa1YAHAUmWgsW6Qg: folds 
EQXHDnIzAsORnIXRNtXRlA: calls $0.25
4awUyiDYTgylQKXZ9faBVA: raises $1 to $1.25
22dIObOuor/A+IKWkNoAlA: folds 
GY095KWhBevJ1Ttvl8WseA: folds 
4XHsdGnQ76EBdBvsrSs8bA: calls $1.25
wGigCmBR/9XWkPpvYos3aQ: folds 
+sbyWwIcFp9kP0bDtMegfQ: folds 
EQXHDnIzAsORnIXRNtXRlA: calls $1
*** FLOP *** [3c Ad 4c]
EQXHDnIzAsORnIXRNtXRlA: bets $0.50
4awUyiDYTgylQKXZ9faBVA: folds 
4XHsdGnQ76EBdBvsrSs8bA: calls $0.50
*** TURN *** [3c Ad 4c] [7c]
EQXHDnIzAsORnIXRNtXRlA: checks 
4XHsdGnQ76EBdBvsrSs8bA: bets $1.25
EQXHDnIzAsORnIXRNtXRlA: calls $1.25
*** RIVER *** [3c Ad 4c 7c] [Jd]
EQXHDnIzAsORnIXRNtXRlA: bets $1.25
4XHsdGnQ76EBdBvsrSs8bA: calls $1.25
*** SHOW DOWN ***
EQXHDnIzAsORnIXRNtXRlA: shows [Jh Ah] (two pair, Aces and Jacks)
4XHsdGnQ76EBdBvsrSs8bA: mucks hand 
EQXHDnIzAsORnIXRNtXRlA collected $9.65 from pot
*** SUMMARY ***
Total pot $10.10 | Rake $0.45 
Board [3c Ad 4c 7c Jd]
Seat 1: 22dIObOuor/A+IKWkNoAlA folded before Flop (didn't bet)
Seat 2: GY095KWhBevJ1Ttvl8WseA folded before Flop (didn't bet)
Seat 3: 4XHsdGnQ76EBdBvsrSs8bA (button) mucked
Seat 4: wGigCmBR/9XWkPpvYos3aQ (small blind) folded before Flop
Seat 5: +sbyWwIcFp9kP0bDtMegfQ (big blind) folded before Flop
Seat 7: sGFnnRCa1YAHAUmWgsW6Qg folded before Flop (didn't bet)
Seat 8: EQXHDnIzAsORnIXRNtXRlA showed [Jh Ah] and won ($9.65) with two pair, Aces and Jacks
Seat 9: 4awUyiDYTgylQKXZ9faBVA folded on the Flop




PokerStars Game #59941800632:  Hold'em No Limit ($0.10/$0.25) - 2009/07/01 1:46:33 ET
Table 'ORSZkZqq+7Ja2PdeCFAytA' 9-max Seat #4 is the button
Seat 1: 3FkcXBaxKqxYVagfYUZlmw ($17.35 in chips) 
Seat 3: s9a4d23HFxaL70yUWQ0/tQ ($19.10 in chips) 
Seat 4: tbgfV2Egwn85xEt865GWQQ ($18.55 in chips) 
Seat 5: +lWbsq4dTcA70SX/+hnmpg ($5.50 in chips) 
Seat 6: gMF+EMhmwpnaM5TFQquf2A ($5.50 in chips) 
Seat 7: clJsV3v77RS07bDKY+705w ($5 in chips) 
Seat 8: npAYqa85pqnzfOK5ukX+BQ ($19.40 in chips) 
Seat 9: cMTFs4oCtNInkpDIecxT/w ($19.90 in chips) 
+lWbsq4dTcA70SX/+hnmpg: posts small blind $0.10
gMF+EMhmwpnaM5TFQquf2A: posts big blind $0.25
j4q3p0lesp63b1gZDwLBZw: sits out 
*** HOLE CARDS ***
clJsV3v77RS07bDKY+705w: folds 
npAYqa85pqnzfOK5ukX+BQ: folds 
cMTFs4oCtNInkpDIecxT/w: raises $0.25 to $0.50
3FkcXBaxKqxYVagfYUZlmw: folds 
s9a4d23HFxaL70yUWQ0/tQ: folds 
tbgfV2Egwn85xEt865GWQQ: calls $0.50
+lWbsq4dTcA70SX/+hnmpg: folds 
gMF+EMhmwpnaM5TFQquf2A: calls $0.25
*** FLOP *** [2s Ts Jh]
gMF+EMhmwpnaM5TFQquf2A: checks 
cMTFs4oCtNInkpDIecxT/w: bets $0.75
tbgfV2Egwn85xEt865GWQQ: folds 
gMF+EMhmwpnaM5TFQquf2A: folds 
Uncalled bet ($0.75) returned to cMTFs4oCtNInkpDIecxT/w
cMTFs4oCtNInkpDIecxT/w collected $1.55 from pot
*** SUMMARY ***
Total pot $1.60 | Rake $0.05 
Board [2s Ts Jh]
Seat 1: 3FkcXBaxKqxYVagfYUZlmw folded before Flop (didn't bet)
Seat 3: s9a4d23HFxaL70yUWQ0/tQ folded before Flop (didn't bet)
Seat 4: tbgfV2Egwn85xEt865GWQQ (button) folded on the Flop
Seat 5: +lWbsq4dTcA70SX/+hnmpg (small blind) folded before Flop
Seat 6: gMF+EMhmwpnaM5TFQquf2A (big blind) folded on the Flop
Seat 7: clJsV3v77RS07bDKY+705w folded before Flop (didn't bet)
Seat 8: npAYqa85pqnzfOK5ukX+BQ folded before Flop (didn't bet)
Seat 9: cMTFs4oCtNInkpDIecxT/w collected ($1.55)




PokerStars Game #59941800424:  Hold'em No Limit ($0.10/$0.25) - 2009/07/01 1:46:33 ET
Table '9iHhO6FyZVM8XpSc23TIgg' 6-max Seat #2 is the button
Seat 1: NhUN/JpAprdJeamFBgJH1w ($37.30 in chips) 
Seat 2: bJFzs6QmEEnz4miMfSDtcg ($39.25 in chips) 
Seat 3: TSmua8tGK3sTbwi0ynrW9Q ($25 in chips) 
Seat 4: cfJccEfyn6IkquPN08hFsA ($18.35 in chips) 
Seat 6: iyZxqznXjv3vtvOJymkoLQ ($34.20 in chips) 
TSmua8tGK3sTbwi0ynrW9Q: posts small blind $0.10
cfJccEfyn6IkquPN08hFsA: posts big blind $0.25
OMGl+YMGogf2JWIRfT2/Yg: sits out 
*** HOLE CARDS ***
iyZxqznXjv3vtvOJymkoLQ: folds 
NhUN/JpAprdJeamFBgJH1w: folds 
bJFzs6QmEEnz4miMfSDtcg: folds 
TSmua8tGK3sTbwi0ynrW9Q: raises $0.50 to $0.75
cfJccEfyn6IkquPN08hFsA: folds 
Uncalled bet ($0.50) returned to TSmua8tGK3sTbwi0ynrW9Q
TSmua8tGK3sTbwi0ynrW9Q collected $0.50 from pot
*** SUMMARY ***
Total pot $0.50 | Rake $0 
Seat 1: NhUN/JpAprdJeamFBgJH1w folded before Flop (didn't bet)
Seat 2: bJFzs6QmEEnz4miMfSDtcg (button) folded before Flop (didn't bet)
Seat 3: TSmua8tGK3sTbwi0ynrW9Q (small blind) collected ($0.50)
Seat 4: cfJccEfyn6IkquPN08hFsA (big blind) folded before Flop
Seat 6: iyZxqznXjv3vtvOJymkoLQ folded before Flop (didn't bet)




PokerStars Game #59941800200:  Hold'em No Limit ($0.10/$0.25) - 2009/07/01 1:46:33 ET
Table 'xmJKTGBeWCwutccj3YfupQ' 6-max Seat #4 is the button
Seat 1: sVbkVl4OznxBCfi66UB9vw ($42.45 in chips) 
Seat 3: T5wrp/d5jarm+SxNy8OQAg ($25.50 in chips) 
Seat 4: uWjhTVMpuIroxXcmD3Okug ($8.80 in chips) 
Seat 5: DE9hRlt14g+JdsRQ4wT7hg ($28 in chips) 
Seat 6: 9bpVv1/Qh9IYtXuCtl5VtQ ($24.65 in chips) 
DE9hRlt14g+JdsRQ4wT7hg: posts small blind $0.10
9bpVv1/Qh9IYtXuCtl5VtQ: posts big blind $0.25
QqiZLFrN8iOUT/GHw7ztOA: sits out 
*** HOLE CARDS ***
sVbkVl4OznxBCfi66UB9vw: calls $0.25
T5wrp/d5jarm+SxNy8OQAg: folds 
uWjhTVMpuIroxXcmD3Okug: folds 
DE9hRlt14g+JdsRQ4wT7hg: raises $1.25 to $1.50
9bpVv1/Qh9IYtXuCtl5VtQ: folds 
sVbkVl4OznxBCfi66UB9vw: calls $1.25
*** FLOP *** [Qs 4h Qd]
DE9hRlt14g+JdsRQ4wT7hg: bets $2
T5wrp/d5jarm+SxNy8OQAg said, "u just got ur money abck"
sVbkVl4OznxBCfi66UB9vw: folds 
Uncalled bet ($2) returned to DE9hRlt14g+JdsRQ4wT7hg
DE9hRlt14g+JdsRQ4wT7hg collected $3.10 from pot
DE9hRlt14g+JdsRQ4wT7hg: doesn't show hand 
*** SUMMARY ***
Total pot $3.25 | Rake $0.15 
Board [Qs 4h Qd]
Seat 1: sVbkVl4OznxBCfi66UB9vw folded on the Flop
Seat 3: T5wrp/d5jarm+SxNy8OQAg folded before Flop (didn't bet)
Seat 4: uWjhTVMpuIroxXcmD3Okug (button) folded before Flop (didn't bet)
Seat 5: DE9hRlt14g+JdsRQ4wT7hg (small blind) collected ($3.10)
Seat 6: 9bpVv1/Qh9IYtXuCtl5VtQ (big blind) folded before Flop




PokerStars Game #59941800584:  Hold'em No Limit ($0.10/$0.25) - 2009/07/01 1:46:33 ET
Table 'WjNvuuSgTjm8jh0j9vcCgQ' 9-max Seat #1 is the button
Seat 1: q+Qdg0Hoir+SyL7haBrUnw ($7.70 in chips) 
Seat 2: ghNKXUBl/H+t83JF079ZBA ($25 in chips) 
Seat 3: pSKReiGBNW9NsF2jAZnlwg ($22.35 in chips) 
Seat 4: X78b5v/uhqeXXoAijbw/yg ($31.35 in chips) 
Seat 5: ziFpkH3wCzqB/qXeq/Hy7g ($25 in chips) 
Seat 6: ubsjZomMWSV0hAiBLa7K1A ($21.60 in chips) 
Seat 7: NSX8YOj+RznxoL+rO1YU4w ($17.65 in chips) 
Seat 8: hZuGwtYmFKPmQ+v1wlmdfA ($17.40 in chips) 
Seat 9: CT7Xj/V/O5rBlhtt+RZeFQ ($25.25 in chips) 
ghNKXUBl/H+t83JF079ZBA: posts small blind $0.10
pSKReiGBNW9NsF2jAZnlwg: posts big blind $0.25
*** HOLE CARDS ***
X78b5v/uhqeXXoAijbw/yg: folds 
ziFpkH3wCzqB/qXeq/Hy7g: raises $0.75 to $1
ubsjZomMWSV0hAiBLa7K1A: calls $1
NSX8YOj+RznxoL+rO1YU4w: folds 
hZuGwtYmFKPmQ+v1wlmdfA: folds 
CT7Xj/V/O5rBlhtt+RZeFQ: folds 
q+Qdg0Hoir+SyL7haBrUnw: folds 
ghNKXUBl/H+t83JF079ZBA: folds 
pSKReiGBNW9NsF2jAZnlwg: calls $0.75
*** FLOP *** [6d 3c Kc]
pSKReiGBNW9NsF2jAZnlwg: checks 
ziFpkH3wCzqB/qXeq/Hy7g: bets $1.75
ubsjZomMWSV0hAiBLa7K1A: folds 
pSKReiGBNW9NsF2jAZnlwg: folds 
Uncalled bet ($1.75) returned to ziFpkH3wCzqB/qXeq/Hy7g
ziFpkH3wCzqB/qXeq/Hy7g collected $2.95 from pot
ziFpkH3wCzqB/qXeq/Hy7g: doesn't show hand 
*** SUMMARY ***
Total pot $3.10 | Rake $0.15 
Board [6d 3c Kc]
Seat 1: q+Qdg0Hoir+SyL7haBrUnw (button) folded before Flop (didn't bet)
Seat 2: ghNKXUBl/H+t83JF079ZBA (small blind) folded before Flop
Seat 3: pSKReiGBNW9NsF2jAZnlwg (big blind) folded on the Flop
Seat 4: X78b5v/uhqeXXoAijbw/yg folded before Flop (didn't bet)
Seat 5: ziFpkH3wCzqB/qXeq/Hy7g collected ($2.95)
Seat 6: ubsjZomMWSV0hAiBLa7K1A folded on the Flop
Seat 7: NSX8YOj+RznxoL+rO1YU4w folded before Flop (didn't bet)
Seat 8: hZuGwtYmFKPmQ+v1wlmdfA folded before Flop (didn't bet)
Seat 9: CT7Xj/V/O5rBlhtt+RZeFQ folded before Flop (didn't bet)




PokerStars Game #59941800174:  Hold'em No Limit ($0.10/$0.25) - 2009/07/01 1:46:33 ET
Table 'jz4TpuH+ag+0iNe2ZcxckQ' 9-max Seat #7 is the button
Seat 1: +C3eP/ysyROWbEXJFPswVA ($17 in chips) 
Seat 2: clJsV3v77RS07bDKY+705w ($5 in chips) 
Seat 3: egvg3mTBBVzMHnJPIQiKcA ($15.80 in chips) 
Seat 4: k+2r6di6GXjNpAdrRkW9bA ($58.15 in chips) 
Seat 5: v1BVHNGLbP/nx7QO6K7+Jw ($37.50 in chips) 
Seat 6: gO1uiTGTzn5Cd3PECuws1g ($13.65 in chips) 
Seat 7: tLcDklc2rBORNfixyRfVfw ($31.65 in chips) 
Seat 8: uhrboV251dcgYniYTdFIcA ($25 in chips) 
Seat 9: W2YYHvqjaEpRrO7stZkClQ ($5.80 in chips) 
uhrboV251dcgYniYTdFIcA: posts small blind $0.10
W2YYHvqjaEpRrO7stZkClQ: posts big blind $0.25
*** HOLE CARDS ***
+C3eP/ysyROWbEXJFPswVA: calls $0.25
clJsV3v77RS07bDKY+705w: folds 
egvg3mTBBVzMHnJPIQiKcA: folds 
k+2r6di6GXjNpAdrRkW9bA: folds 
v1BVHNGLbP/nx7QO6K7+Jw: folds 
gO1uiTGTzn5Cd3PECuws1g: folds 
tLcDklc2rBORNfixyRfVfw: calls $0.25
uhrboV251dcgYniYTdFIcA: folds 
W2YYHvqjaEpRrO7stZkClQ: checks 
*** FLOP *** [2s Qc 3s]
W2YYHvqjaEpRrO7stZkClQ: checks 
+C3eP/ysyROWbEXJFPswVA: bets $0.50
tLcDklc2rBORNfixyRfVfw: raises $2 to $2.50
W2YYHvqjaEpRrO7stZkClQ: folds 
+C3eP/ysyROWbEXJFPswVA: calls $2
*** TURN *** [2s Qc 3s] [Td]
+C3eP/ysyROWbEXJFPswVA: checks 
tLcDklc2rBORNfixyRfVfw: bets $4.50
+C3eP/ysyROWbEXJFPswVA: calls $4.50
*** RIVER *** [2s Qc 3s Td] [5h]
+C3eP/ysyROWbEXJFPswVA: checks 
tLcDklc2rBORNfixyRfVfw: bets $5
+C3eP/ysyROWbEXJFPswVA: calls $5
*** SHOW DOWN ***
tLcDklc2rBORNfixyRfVfw: shows [3c 3d] (three of a kind, Threes)
+C3eP/ysyROWbEXJFPswVA: mucks hand 
tLcDklc2rBORNfixyRfVfw collected $23.65 from pot
*** SUMMARY ***
Total pot $24.85 | Rake $1.20 
Board [2s Qc 3s Td 5h]
Seat 1: +C3eP/ysyROWbEXJFPswVA mucked
Seat 2: clJsV3v77RS07bDKY+705w folded before Flop (didn't bet)
Seat 3: egvg3mTBBVzMHnJPIQiKcA folded before Flop (didn't bet)
Seat 4: k+2r6di6GXjNpAdrRkW9bA folded before Flop (didn't bet)
Seat 5: v1BVHNGLbP/nx7QO6K7+Jw folded before Flop (didn't bet)
Seat 6: gO1uiTGTzn5Cd3PECuws1g folded before Flop (didn't bet)
Seat 7: tLcDklc2rBORNfixyRfVfw (button) showed [3c 3d] and won ($23.65) with three of a kind, Threes
Seat 8: uhrboV251dcgYniYTdFIcA (small blind) folded before Flop
Seat 9: W2YYHvqjaEpRrO7stZkClQ (big blind) folded on the Flop




PokerStars Game #59941800786:  Hold'em No Limit ($0.10/$0.25) - 2009/07/01 1:46:34 ET
Table 'oG007Tb0LYbfANo6QWd16wWEMI3Mtn7dGARDbgNrKibgx Seat #6 is the button
Seat 1: DiSvPC2iudwL5j9u6Huyww ($46.65 in chips) 
Seat 4: zgi+EUykT/pZQpoUG6+oEg ($5 in chips) 
Seat 5: 8f0dtuUGqDbgE6up1lQAlg ($5.50 in chips) 
Seat 6: yqkowiRWZ6NvRN9UUkYIlA ($5 in chips) 
Seat 7: Mh2r9hTeTEDnh19sRZtW3g ($5 in chips) 
Seat 8: q4cNXFZGNhLfrTyVrIy6Mg ($14.90 in chips) 
Seat 9: EVqHvqty1ZsuvDFiSXlSqQ ($23.70 in chips) 
Mh2r9hTeTEDnh19sRZtW3g: posts small blind $0.10
q4cNXFZGNhLfrTyVrIy6Mg: posts big blind $0.25
pN3IHvAKm2fz+sTRARTcrg: sits out 
*** HOLE CARDS ***
EVqHvqty1ZsuvDFiSXlSqQ: calls $0.25
DiSvPC2iudwL5j9u6Huyww: folds 
zgi+EUykT/pZQpoUG6+oEg: folds 
8f0dtuUGqDbgE6up1lQAlg: folds 
yqkowiRWZ6NvRN9UUkYIlA: folds 
Mh2r9hTeTEDnh19sRZtW3g: folds 
q4cNXFZGNhLfrTyVrIy6Mg: checks 
*** FLOP *** [9h 6s 9d]
q4cNXFZGNhLfrTyVrIy6Mg: checks 
zDrucyjVn5aeekNEc3cJrA has returned
EVqHvqty1ZsuvDFiSXlSqQ: checks 
*** TURN *** [9h 6s 9d] [5h]
q4cNXFZGNhLfrTyVrIy6Mg: checks 
EVqHvqty1ZsuvDFiSXlSqQ: checks 
*** RIVER *** [9h 6s 9d 5h] [Ac]
q4cNXFZGNhLfrTyVrIy6Mg: bets $0.25
EVqHvqty1ZsuvDFiSXlSqQ: calls $0.25
*** SHOW DOWN ***
q4cNXFZGNhLfrTyVrIy6Mg: shows [Kc Tc] (a pair of Nines)
EVqHvqty1ZsuvDFiSXlSqQ: shows [Ad Kd] (two pair, Aces and Nines)
EVqHvqty1ZsuvDFiSXlSqQ collected $1.05 from pot
*** SUMMARY ***
Total pot $1.10 | Rake $0.05 
Board [9h 6s 9d 5h Ac]
Seat 1: DiSvPC2iudwL5j9u6Huyww folded before Flop (didn't bet)
Seat 4: zgi+EUykT/pZQpoUG6+oEg folded before Flop (didn't bet)
Seat 5: 8f0dtuUGqDbgE6up1lQAlg folded before Flop (didn't bet)
Seat 6: yqkowiRWZ6NvRN9UUkYIlA (button) folded before Flop (didn't bet)
Seat 7: Mh2r9hTeTEDnh19sRZtW3g (small blind) folded before Flop
Seat 8: q4cNXFZGNhLfrTyVrIy6Mg (big blind) showed [Kc Tc] and lost with a pair of Nines
Seat 9: EVqHvqty1ZsuvDFiSXlSqQ showed [Ad Kd] and won ($1.05) with two pair, Aces and Nines




PokerStars Game #59941800944:  Hold'em No Limit ($0.10/$0.25) - 2009/07/01 1:46:34 ET
Table '6wawJ+MkkvuC3coG6r+Yhg' 6-max Seat #5 is the button
Seat 1: JQZew0FjzS19kTjeNtrE+A ($28.25 in chips) 
Seat 2: LtASJ9OlkqGrrUKGQlpGAw ($34.15 in chips) 
Seat 3: 3zD3qLXT1bEffAoWGnc7wg ($61.25 in chips) 
Seat 4: yxmjNFGiKI3b+XQGJzJVIg ($26.10 in chips) 
Seat 5: FZrgDbxAanC1xwZxXHJKVA ($4.30 in chips) 
Seat 6: B3X187C0tXFUfQpCu8pe8A ($25.25 in chips) 
B3X187C0tXFUfQpCu8pe8A: posts small blind $0.10
JQZew0FjzS19kTjeNtrE+A: posts big blind $0.25
*** HOLE CARDS ***
LtASJ9OlkqGrrUKGQlpGAw: folds 
3zD3qLXT1bEffAoWGnc7wg: folds 
yxmjNFGiKI3b+XQGJzJVIg: folds 
FZrgDbxAanC1xwZxXHJKVA: folds 
B3X187C0tXFUfQpCu8pe8A: folds 
Uncalled bet ($0.15) returned to JQZew0FjzS19kTjeNtrE+A
JQZew0FjzS19kTjeNtrE+A collected $0.20 from pot
*** SUMMARY ***
Total pot $0.20 | Rake $0 
Seat 1: JQZew0FjzS19kTjeNtrE+A (big blind) collected ($0.20)
Seat 2: LtASJ9OlkqGrrUKGQlpGAw folded before Flop (didn't bet)
Seat 3: 3zD3qLXT1bEffAoWGnc7wg folded before Flop (didn't bet)
Seat 4: yxmjNFGiKI3b+XQGJzJVIg folded before Flop (didn't bet)
Seat 5: FZrgDbxAanC1xwZxXHJKVA (button) folded before Flop (didn't bet)
Seat 6: B3X187C0tXFUfQpCu8pe8A (small blind) folded before Flop




PokerStars Game #59941800874:  Hold'em No Limit ($0.10/$0.25) - 2009/07/01 1:46:34 ET
Table 'jdhJTJjFq2KTttwJcd+7nQ' 6-max Seat #3 is the button
Seat 1: LtASJ9OlkqGrrUKGQlpGAw ($26.85 in chips) 
Seat 2: Hsvkc0/G2VV78oVmWYXecw ($5 in chips) 
Seat 3: vqWjZmdQu/Hxw96/IJTWdQ ($25 in chips) 
Seat 4: vx7FwRcelVSsvNYAdp/z0A ($5.90 in chips) 
Seat 5: BV+K0Phf5VBHr7aZPKqbUQ ($26.10 in chips) 
Seat 6: yb6rnd48JuBccThV68VHAQ ($20.30 in chips) 
vx7FwRcelVSsvNYAdp/z0A: posts small blind $0.10
BV+K0Phf5VBHr7aZPKqbUQ: posts big blind $0.25
*** HOLE CARDS ***
yb6rnd48JuBccThV68VHAQ: folds 
LtASJ9OlkqGrrUKGQlpGAw: folds 
Hsvkc0/G2VV78oVmWYXecw: folds 
vqWjZmdQu/Hxw96/IJTWdQ: folds 
vx7FwRcelVSsvNYAdp/z0A: raises $0.25 to $0.50
BV+K0Phf5VBHr7aZPKqbUQ: folds 
Uncalled bet ($0.25) returned to vx7FwRcelVSsvNYAdp/z0A
vx7FwRcelVSsvNYAdp/z0A collected $0.50 from pot
*** SUMMARY ***
Total pot $0.50 | Rake $0 
Seat 1: LtASJ9OlkqGrrUKGQlpGAw folded before Flop (didn't bet)
Seat 2: Hsvkc0/G2VV78oVmWYXecw folded before Flop (didn't bet)
Seat 3: vqWjZmdQu/Hxw96/IJTWdQ (button) folded before Flop (didn't bet)
Seat 4: vx7FwRcelVSsvNYAdp/z0A (small blind) collected ($0.50)
Seat 5: BV+K0Phf5VBHr7aZPKqbUQ (big blind) folded before Flop
Seat 6: yb6rnd48JuBccThV68VHAQ folded before Flop (didn't bet)




PokerStars Game #59941801162:  Hold'em No Limit ($0.10/$0.25) - 2009/07/01 1:46:35 ET
Table '+198VWQSWBhYQOcizzuBkw' 6-max Seat #1 is the button
Seat 1: 34ttqW62uIRrqINCCmLcsw ($15.95 in chips) 
Seat 2: iauW7L/+7qzAuHow7CD75Q ($10.45 in chips) 
Seat 3: vw7gefupgmOJJN8lUemdWg ($22.30 in chips) 
Seat 4: TgDsTeCdLQt8kWbL00ByRA ($14.75 in chips) 
Seat 5: LtASJ9OlkqGrrUKGQlpGAw ($25.35 in chips) 
Seat 6: leEQ84f6wJYu5SB/vj27wg ($3.80 in chips) 
iauW7L/+7qzAuHow7CD75Q: posts small blind $0.10
vw7gefupgmOJJN8lUemdWg: posts big blind $0.25
*** HOLE CARDS ***
TgDsTeCdLQt8kWbL00ByRA: folds 
LtASJ9OlkqGrrUKGQlpGAw: folds 
leEQ84f6wJYu5SB/vj27wg: folds 
34ttqW62uIRrqINCCmLcsw: calls $0.25
iauW7L/+7qzAuHow7CD75Q: folds 
vw7gefupgmOJJN8lUemdWg: raises $0.75 to $1
34ttqW62uIRrqINCCmLcsw: calls $0.75
*** FLOP *** [Qc 8d Ac]
vw7gefupgmOJJN8lUemdWg: bets $1
34ttqW62uIRrqINCCmLcsw: raises $2 to $3
vw7gefupgmOJJN8lUemdWg: calls $2
*** TURN *** [Qc 8d Ac] [3d]
vw7gefupgmOJJN8lUemdWg: checks 
34ttqW62uIRrqINCCmLcsw: bets $5
vw7gefupgmOJJN8lUemdWg: folds 
Uncalled bet ($5) returned to 34ttqW62uIRrqINCCmLcsw
34ttqW62uIRrqINCCmLcsw collected $7.70 from pot
34ttqW62uIRrqINCCmLcsw: doesn't show hand 
*** SUMMARY ***
Total pot $8.10 | Rake $0.40 
Board [Qc 8d Ac 3d]
Seat 1: 34ttqW62uIRrqINCCmLcsw (button) collected ($7.70)
Seat 2: iauW7L/+7qzAuHow7CD75Q (small blind) folded before Flop
Seat 3: vw7gefupgmOJJN8lUemdWg (big blind) folded on the Turn
Seat 4: TgDsTeCdLQt8kWbL00ByRA folded before Flop (didn't bet)
Seat 5: LtASJ9OlkqGrrUKGQlpGAw folded before Flop (didn't bet)
Seat 6: leEQ84f6wJYu5SB/vj27wg folded before Flop (didn't bet)




PokerStars Game #59941801248:  Hold'em No Limit ($0.10/$0.25) - 2009/07/01 1:46:35 ET
Table '6wawJ+MkkvuC3coG6r+YhgZiwAqg4o02gNro+JOAaFNgSeat #9 is the button
Seat 1: 6RiVTYll/5D8zICp0MRpKw ($29.95 in chips) 
Seat 3: aNpwfA31EREwO+ar4XzBCw ($29 in chips) 
Seat 5: 5hAPbqNrvJb8PtLiceXtlg6HoFYfVGBefsR5Vrz62qIw8.15 in chips) 
Seat 6: 5n7e7I+px7c6CQmLpPbtsg ($5 in chips) 
Seat 7: yyG4svzOpC1A+sUP/scg6w ($7.45 in chips) 
Seat 8: VLIsy+xjx3olLSYO3JLS6g ($8.35 in chips) 
Seat 9: ljemhp25Zg+nlA9DLCIiUw ($24.90 in chips) 
6RiVTYll/5D8zICp0MRpKw: posts small blind $0.10
tYsOBqdU1+x+yFI7zHO7hQ: is sitting out 
aNpwfA31EREwO+ar4XzBCw: posts big blind $0.25
RHqgdFvufLCYe54+qd2gcA: sits out 
*** HOLE CARDS ***
tYsOBqdU1+x+yFI7zHO7hQ leaves the table
5hAPbqNrvJb8PtLiceXtlg6HoFYfVGBefsR5Vrz62qIwlds 
5n7e7I+px7c6CQmLpPbtsg: folds 
yyG4svzOpC1A+sUP/scg6w: calls $0.25
VLIsy+xjx3olLSYO3JLS6g: raises $0.75 to $1
ljemhp25Zg+nlA9DLCIiUw: folds 
6RiVTYll/5D8zICp0MRpKw: folds 
aNpwfA31EREwO+ar4XzBCw: folds 
lewis+fi joins the table at seat #2 
yyG4svzOpC1A+sUP/scg6w: folds 
Uncalled bet ($0.75) returned to VLIsy+xjx3olLSYO3JLS6g
VLIsy+xjx3olLSYO3JLS6g collected $0.85 from pot
VLIsy+xjx3olLSYO3JLS6g: doesn't show hand 
*** SUMMARY ***
Total pot $0.85 | Rake $0 
Seat 1: 6RiVTYll/5D8zICp0MRpKw (small blind) folded before Flop
Seat 3: aNpwfA31EREwO+ar4XzBCw (big blind) folded before Flop
Seat 5: 5hAPbqNrvJb8PtLiceXtlg6HoFYfVGBefsR5Vrz62qIwded before Flop (didn't bet)
Seat 6: 5n7e7I+px7c6CQmLpPbtsg folded before Flop (didn't bet)
Seat 7: yyG4svzOpC1A+sUP/scg6w folded before Flop
Seat 8: VLIsy+xjx3olLSYO3JLS6g collected ($0.85)
Seat 9: ljemhp25Zg+nlA9DLCIiUw (button) folded before Flop (didn't bet)




PokerStars Game #59941801226:  Hold'em No Limit ($0.10/$0.25) - 2009/07/01 1:46:35 ET
Table 'ThBZ355rqvsb8UGb6ajbig' 9-max Seat #4 is the button
Seat 1: Z9W7+g1WMhhZDi7DwGbCFA ($5 in chips) 
Seat 2: 4awUyiDYTgylQKXZ9faBVA ($25.95 in chips) 
Seat 3: H5Se03ZqSX7tbULXur2MAg ($29.05 in chips) 
Seat 4: zgi+EUykT/pZQpoUG6+oEg ($4.30 in chips) 
Seat 5: cKlmpQMahVsmOaxFQDcoOg ($24.70 in chips) 
Seat 6: qwr38jl5txoR36M7G5qi4A ($11.35 in chips) 
Seat 7: zUXhymECc2C9W9ZNw6qppA ($16.05 in chips) 
Seat 8: PdIasPkzm2sqZnN41ZRXOg ($4.90 in chips) 
Seat 9: sD+TKtt36XiiN6jqHiLwDA ($23.85 in chips) 
cKlmpQMahVsmOaxFQDcoOg: posts small blind $0.10
qwr38jl5txoR36M7G5qi4A: posts big blind $0.25
*** HOLE CARDS ***
zUXhymECc2C9W9ZNw6qppA has timed out
zUXhymECc2C9W9ZNw6qppA: folds 
zUXhymECc2C9W9ZNw6qppA is sitting out
PdIasPkzm2sqZnN41ZRXOg: calls $0.25
sD+TKtt36XiiN6jqHiLwDA: folds 
Z9W7+g1WMhhZDi7DwGbCFA: calls $0.25
4awUyiDYTgylQKXZ9faBVA: folds 
H5Se03ZqSX7tbULXur2MAg: calls $0.25
zgi+EUykT/pZQpoUG6+oEg: folds 
cKlmpQMahVsmOaxFQDcoOg: folds 
zUXhymECc2C9W9ZNw6qppA is disconnected 
zUXhymECc2C9W9ZNw6qppA is connected 
qwr38jl5txoR36M7G5qi4A: checks 
*** FLOP *** [3c 8c 6h]
zUXhymECc2C9W9ZNw6qppA has returned
qwr38jl5txoR36M7G5qi4A: checks 
PdIasPkzm2sqZnN41ZRXOg: checks 
Z9W7+g1WMhhZDi7DwGbCFA: bets $0.75
H5Se03ZqSX7tbULXur2MAg: calls $0.75
qwr38jl5txoR36M7G5qi4A: folds 
PdIasPkzm2sqZnN41ZRXOg: calls $0.75
*** TURN *** [3c 8c 6h] [3h]
PdIasPkzm2sqZnN41ZRXOg: checks 
Z9W7+g1WMhhZDi7DwGbCFA: bets $1
H5Se03ZqSX7tbULXur2MAg: folds 
PdIasPkzm2sqZnN41ZRXOg: raises $2.90 to $3.90 and is all-in
Z9W7+g1WMhhZDi7DwGbCFA: calls $2.90
*** RIVER *** [3c 8c 6h 3h] [3s]
*** SHOW DOWN ***
PdIasPkzm2sqZnN41ZRXOg: shows [9d 9c] (a full house, Threes full of Nines)
Z9W7+g1WMhhZDi7DwGbCFA: shows [Jh Js] (a full house, Threes full of Jacks)
Z9W7+g1WMhhZDi7DwGbCFA collected $10.60 from pot
*** SUMMARY ***
Total pot $11.15 | Rake $0.55 
Board [3c 8c 6h 3h 3s]
Seat 1: Z9W7+g1WMhhZDi7DwGbCFA showed [Jh Js] and won ($10.60) with a full house, Threes full of Jacks
Seat 2: 4awUyiDYTgylQKXZ9faBVA folded before Flop (didn't bet)
Seat 3: H5Se03ZqSX7tbULXur2MAg folded on the Turn
Seat 4: zgi+EUykT/pZQpoUG6+oEg (button) folded before Flop (didn't bet)
Seat 5: cKlmpQMahVsmOaxFQDcoOg (small blind) folded before Flop
Seat 6: qwr38jl5txoR36M7G5qi4A (big blind) folded on the Flop
Seat 7: zUXhymECc2C9W9ZNw6qppA folded before Flop (didn't bet)
Seat 8: PdIasPkzm2sqZnN41ZRXOg showed [9d 9c] and lost with a full house, Threes full of Nines
Seat 9: sD+TKtt36XiiN6jqHiLwDA folded before Flop (didn't bet)




PokerStars Game #59941801310:  Hold'em No Limit ($0.10/$0.25) - 2009/07/01 1:46:35 ET
Table 'gnrUwXkIPE0C8xl6cB4Hyw' 9-max Seat #4 is the button
Seat 1: EQXHDnIzAsORnIXRNtXRlA ($22.60 in chips) 
Seat 2: 7je+LC5Mfs6nL8YBVh4frQ ($5 in chips) 
Seat 3: PdIasPkzm2sqZnN41ZRXOg ($5 in chips) 
Seat 4: wGigCmBR/9XWkPpvYos3aQ ($25 in chips) 
Seat 5: gehe91e0IyVT0QU/XBkEyg ($27 in chips) 
Seat 6: dtZ84flFEi4Q+SGrHMJRDQ ($25.80 in chips) 
Seat 7: OXPkK84/qv92EMwXPiG5rQ ($9.95 in chips) 
Seat 8: 4awUyiDYTgylQKXZ9faBVA ($60.65 in chips) 
Seat 9: F7pnn6czNpHvRM55XcA2EA ($25.50 in chips) 
gehe91e0IyVT0QU/XBkEyg: posts small blind $0.10
dtZ84flFEi4Q+SGrHMJRDQ: posts big blind $0.25
*** HOLE CARDS ***
OXPkK84/qv92EMwXPiG5rQ: folds 
4awUyiDYTgylQKXZ9faBVA: folds 
F7pnn6czNpHvRM55XcA2EA: folds 
EQXHDnIzAsORnIXRNtXRlA: folds 
7je+LC5Mfs6nL8YBVh4frQ: folds 
PdIasPkzm2sqZnN41ZRXOg: folds 
wGigCmBR/9XWkPpvYos3aQ: folds 
gehe91e0IyVT0QU/XBkEyg: folds 
Uncalled bet ($0.15) returned to dtZ84flFEi4Q+SGrHMJRDQ
dtZ84flFEi4Q+SGrHMJRDQ collected $0.20 from pot
dtZ84flFEi4Q+SGrHMJRDQ: doesn't show hand 
*** SUMMARY ***
Total pot $0.20 | Rake $0 
Seat 1: EQXHDnIzAsORnIXRNtXRlA folded before Flop (didn't bet)
Seat 2: 7je+LC5Mfs6nL8YBVh4frQ folded before Flop (didn't bet)
Seat 3: PdIasPkzm2sqZnN41ZRXOg folded before Flop (didn't bet)
Seat 4: wGigCmBR/9XWkPpvYos3aQ (button) folded before Flop (didn't bet)
Seat 5: gehe91e0IyVT0QU/XBkEyg (small blind) folded before Flop
Seat 6: dtZ84flFEi4Q+SGrHMJRDQ (big blind) collected ($0.20)
Seat 7: OXPkK84/qv92EMwXPiG5rQ folded before Flop (didn't bet)
Seat 8: 4awUyiDYTgylQKXZ9faBVA folded before Flop (didn't bet)
Seat 9: F7pnn6czNpHvRM55XcA2EA folded before Flop (didn't bet)




PokerStars Game #59941801238:  Hold'em No Limit ($0.10/$0.25) - 2009/07/01 1:46:35 ET
Table '1HT8bEDpLPhOXxmqMtzF8w' 9-max Seat #9 is the button
Seat 1: YkkKQUDI0iWatY4h0WWaAQ ($13 in chips) 
Seat 2: r6hsffOo1iKmaPYKwAZmFw ($29 in chips) 
Seat 3: oLa/tXLfSLLB28mcLGrxcg ($24.75 in chips) 
Seat 4: aNpwfA31EREwO+ar4XzBCw ($25 in chips) 
Seat 6: bXpVeaSTPBFSPJmeXxO7nw ($5.25 in chips) 
Seat 7: PMhmqYBPHOAXjH25lRz69g ($16.80 in chips) 
Seat 8: ghNKXUBl/H+t83JF079ZBA ($33.15 in chips) 
Seat 9: Z9W7+g1WMhhZDi7DwGbCFA ($5 in chips) 
YkkKQUDI0iWatY4h0WWaAQ: posts small blind $0.10
r6hsffOo1iKmaPYKwAZmFw: posts big blind $0.25
*** HOLE CARDS ***
z5GxcHlYz/GSz6W2uFiTtg joins the table at seat #5 
z5GxcHlYz/GSz6W2uFiTtg is sitting out
oLa/tXLfSLLB28mcLGrxcg: folds 
aNpwfA31EREwO+ar4XzBCw: folds 
bXpVeaSTPBFSPJmeXxO7nw: folds 
PMhmqYBPHOAXjH25lRz69g: folds 
ghNKXUBl/H+t83JF079ZBA: folds 
Z9W7+g1WMhhZDi7DwGbCFA: folds 
YkkKQUDI0iWatY4h0WWaAQ: folds 
Uncalled bet ($0.15) returned to r6hsffOo1iKmaPYKwAZmFw
r6hsffOo1iKmaPYKwAZmFw collected $0.20 from pot
r6hsffOo1iKmaPYKwAZmFw: doesn't show hand 
*** SUMMARY ***
Total pot $0.20 | Rake $0 
Seat 1: YkkKQUDI0iWatY4h0WWaAQ (small blind) folded before Flop
Seat 2: r6hsffOo1iKmaPYKwAZmFw (big blind) collected ($0.20)
Seat 3: oLa/tXLfSLLB28mcLGrxcg folded before Flop (didn't bet)
Seat 4: aNpwfA31EREwO+ar4XzBCw folded before Flop (didn't bet)
Seat 6: bXpVeaSTPBFSPJmeXxO7nw folded before Flop (didn't bet)
Seat 7: PMhmqYBPHOAXjH25lRz69g folded before Flop (didn't bet)
Seat 8: ghNKXUBl/H+t83JF079ZBA folded before Flop (didn't bet)
Seat 9: Z9W7+g1WMhhZDi7DwGbCFA (button) folded before Flop (didn't bet)




PokerStars Game #59941801304:  Hold'em No Limit ($0.10/$0.25) - 2009/07/01 1:46:35 ET
Table 'b64Z+5XI1xkQzNfq4QHr3A' 6-max Seat #5 is the button
Seat 2: A6SjYLoKeIpFjPq0BK/2WA ($4.75 in chips) 
Seat 3: u/yN5P9f3KlATg6WLWNkBQ ($52.55 in chips) 
Seat 4: 564zqq2DUHXR3tdsOJU6JA ($15 in chips) 
Seat 5: JFIAqU8lCZ0vWwEl4bdGsg ($58.10 in chips) 
Seat 6: 8ClCHtFXGNplITm+63KB+Q ($33.10 in chips) 
8ClCHtFXGNplITm+63KB+Q: posts small blind $0.10
A6SjYLoKeIpFjPq0BK/2WA: posts big blind $0.25
564zqq2DUHXR3tdsOJU6JA: posts big blind $0.25
*** HOLE CARDS ***
u/yN5P9f3KlATg6WLWNkBQ: folds 
564zqq2DUHXR3tdsOJU6JA: checks 
u/yN5P9f3KlATg6WLWNkBQ leaves the table
JFIAqU8lCZ0vWwEl4bdGsg: folds 
8ClCHtFXGNplITm+63KB+Q: folds 
7cx44/slbeTw+Cy7QB8Trg joins the table at seat #3 
A6SjYLoKeIpFjPq0BK/2WA: checks 
*** FLOP *** [Kd Qh Tc]
A6SjYLoKeIpFjPq0BK/2WA: checks 
564zqq2DUHXR3tdsOJU6JA: bets $0.75
A6SjYLoKeIpFjPq0BK/2WA: folds 
Uncalled bet ($0.75) returned to 564zqq2DUHXR3tdsOJU6JA
564zqq2DUHXR3tdsOJU6JA collected $0.60 from pot
564zqq2DUHXR3tdsOJU6JA: doesn't show hand 
*** SUMMARY ***
Total pot $0.60 | Rake $0 
Board [Kd Qh Tc]
Seat 2: A6SjYLoKeIpFjPq0BK/2WA (big blind) folded on the Flop
Seat 3: u/yN5P9f3KlATg6WLWNkBQ folded before Flop (didn't bet)
Seat 4: 564zqq2DUHXR3tdsOJU6JA collected ($0.60)
Seat 5: JFIAqU8lCZ0vWwEl4bdGsg (button) folded before Flop (didn't bet)
Seat 6: 8ClCHtFXGNplITm+63KB+Q (small blind) folded before Flop




PokerStars Game #59941801858:  Hold'em No Limit ($0.10/$0.25) - 2009/07/01 1:46:36 ET
Table 'rpIHGyt2QpgQc5bvptAvDQ' 9-max Seat #2 is the button
Seat 2: FX0yWp7Ul3dMebXB0cFjEw ($3.85 in chips) 
Seat 3: N6a/f6AW8S8G3JFw9IFxAg ($16.15 in chips) 
Seat 4: ASXDkj9tmvF/T2AsNuxg7g ($6.20 in chips) 
Seat 5: XhSvfX1gy0yx/qeW+SOeTw ($9.30 in chips) 
Seat 6: Mq1ESwxx3LEsA4HjKKjU3Q ($19.25 in chips) 
Seat 7: GHgIdzlzMAmRmmX7jgXtuQ ($3.75 in chips) 
Seat 8: oUgIL46CfA9GCdIuN1TVSw ($9.20 in chips) 
N6a/f6AW8S8G3JFw9IFxAg: posts small blind $0.10
ASXDkj9tmvF/T2AsNuxg7g: posts big blind $0.25
eebse2009: sits out 
E0iYnEVO2ho7dH3QcCjw7g: sits out 
*** HOLE CARDS ***
XhSvfX1gy0yx/qeW+SOeTw: calls $0.25
Mq1ESwxx3LEsA4HjKKjU3Q: folds 
GHgIdzlzMAmRmmX7jgXtuQ: folds 
oUgIL46CfA9GCdIuN1TVSw: calls $0.25
FX0yWp7Ul3dMebXB0cFjEw: calls $0.25
N6a/f6AW8S8G3JFw9IFxAg: calls $0.15
ASXDkj9tmvF/T2AsNuxg7g: checks 
*** FLOP *** [Jh 7s 6c]
N6a/f6AW8S8G3JFw9IFxAg: bets $0.25
ASXDkj9tmvF/T2AsNuxg7g: folds 
XhSvfX1gy0yx/qeW+SOeTw: calls $0.25
oUgIL46CfA9GCdIuN1TVSw: folds 
FX0yWp7Ul3dMebXB0cFjEw: calls $0.25
*** TURN *** [Jh 7s 6c] [2d]
N6a/f6AW8S8G3JFw9IFxAg: bets $0.25
XhSvfX1gy0yx/qeW+SOeTw: calls $0.25
FX0yWp7Ul3dMebXB0cFjEw: calls $0.25
*** RIVER *** [Jh 7s 6c 2d] [5h]
N6a/f6AW8S8G3JFw9IFxAg: bets $0.25
XhSvfX1gy0yx/qeW+SOeTw: calls $0.25
FX0yWp7Ul3dMebXB0cFjEw: calls $0.25
*** SHOW DOWN ***
N6a/f6AW8S8G3JFw9IFxAg: shows [8d 6h] (a pair of Sixes)
XhSvfX1gy0yx/qeW+SOeTw: mucks hand 
FX0yWp7Ul3dMebXB0cFjEw: mucks hand 
N6a/f6AW8S8G3JFw9IFxAg collected $3.35 from pot
*** SUMMARY ***
Total pot $3.50 | Rake $0.15 
Board [Jh 7s 6c 2d 5h]
Seat 2: FX0yWp7Ul3dMebXB0cFjEw (button) mucked
Seat 3: N6a/f6AW8S8G3JFw9IFxAg (small blind) showed [8d 6h] and won ($3.35) with a pair of Sixes
Seat 4: ASXDkj9tmvF/T2AsNuxg7g (big blind) folded on the Flop
Seat 5: XhSvfX1gy0yx/qeW+SOeTw mucked
Seat 6: Mq1ESwxx3LEsA4HjKKjU3Q folded before Flop (didn't bet)
Seat 7: GHgIdzlzMAmRmmX7jgXtuQ folded before Flop (didn't bet)
Seat 8: oUgIL46CfA9GCdIuN1TVSw folded on the Flop




PokerStars Game #59941802134:  Hold'em No Limit ($0.10/$0.25) - 2009/07/01 1:46:36 ET
Table 'NgexmgEDEzICBeSO7YCrKQ' 6-max Seat #4 is the button
Seat 1: cezpHJ8FB07dj0xG+LhOvw ($29.45 in chips) 
Seat 2: 32YL2ZEp8NT4JB2RVM9euQ ($21.55 in chips) 
Seat 3: JFIAqU8lCZ0vWwEl4bdGsg ($27.55 in chips) 
Seat 4: xx+iYCDJhHJmNzrfeloyEg ($22.55 in chips) 
Seat 5: /MXkdT8TTs8Qp2LVTQNw6w ($41.95 in chips) 
Seat 6: k9nHZTHt8hYhYRcW8NTb4g ($11.30 in chips) 
/MXkdT8TTs8Qp2LVTQNw6w: posts small blind $0.10
k9nHZTHt8hYhYRcW8NTb4g: posts big blind $0.25
*** HOLE CARDS ***
cezpHJ8FB07dj0xG+LhOvw: folds 
32YL2ZEp8NT4JB2RVM9euQ: folds 
JFIAqU8lCZ0vWwEl4bdGsg: folds 
xx+iYCDJhHJmNzrfeloyEg: calls $0.25
/MXkdT8TTs8Qp2LVTQNw6w: calls $0.15
k9nHZTHt8hYhYRcW8NTb4g: checks 
*** FLOP *** [Ac 5h 9d]
/MXkdT8TTs8Qp2LVTQNw6w: bets $0.25
k9nHZTHt8hYhYRcW8NTb4g: folds 
xx+iYCDJhHJmNzrfeloyEg: folds 
Uncalled bet ($0.25) returned to /MXkdT8TTs8Qp2LVTQNw6w
/MXkdT8TTs8Qp2LVTQNw6w collected $0.75 from pot
/MXkdT8TTs8Qp2LVTQNw6w: doesn't show hand 
*** SUMMARY ***
Total pot $0.75 | Rake $0 
Board [Ac 5h 9d]
Seat 1: cezpHJ8FB07dj0xG+LhOvw folded before Flop (didn't bet)
Seat 2: 32YL2ZEp8NT4JB2RVM9euQ folded before Flop (didn't bet)
Seat 3: JFIAqU8lCZ0vWwEl4bdGsg folded before Flop (didn't bet)
Seat 4: xx+iYCDJhHJmNzrfeloyEg (button) folded on the Flop
Seat 5: /MXkdT8TTs8Qp2LVTQNw6w (small blind) collected ($0.75)
Seat 6: k9nHZTHt8hYhYRcW8NTb4g (big blind) folded on the Flop




PokerStars Game #59941802076:  Hold'em No Limit ($0.10/$0.25) - 2009/07/01 1:46:36 ET
Table '5SUMWYuPsGiOD0FY0QbgOw' 6-max Seat #6 is the button
Seat 1: SFmT9ZsVopnukjvAzrxTRg ($25 in chips) 
Seat 2: xrf8tAXKQHG99HixCot1Iw ($37.50 in chips) 
Seat 3: MqMK8OWPSY1V4stf1Hy5Jw ($38.45 in chips) 
Seat 4: BV+K0Phf5VBHr7aZPKqbUQ ($25 in chips) 
Seat 5: v+QfkGiuj9bgtuNoVnDO8w ($41.80 in chips) 
Seat 6: jA7YMtfNUnAaebB7Lj74EA ($25.05 in chips) 
SFmT9ZsVopnukjvAzrxTRg: posts small blind $0.10
xrf8tAXKQHG99HixCot1Iw: posts big blind $0.25
*** HOLE CARDS ***
MqMK8OWPSY1V4stf1Hy5Jw: folds 
BV+K0Phf5VBHr7aZPKqbUQ: folds 
v+QfkGiuj9bgtuNoVnDO8w: raises $0.75 to $1
jA7YMtfNUnAaebB7Lj74EA: folds 
SFmT9ZsVopnukjvAzrxTRg: folds 
xrf8tAXKQHG99HixCot1Iw: raises $2.50 to $3.50
v+QfkGiuj9bgtuNoVnDO8w: folds 
Uncalled bet ($2.50) returned to xrf8tAXKQHG99HixCot1Iw
xrf8tAXKQHG99HixCot1Iw collected $2.10 from pot
xrf8tAXKQHG99HixCot1Iw: doesn't show hand 
*** SUMMARY ***
Total pot $2.10 | Rake $0 
Seat 1: SFmT9ZsVopnukjvAzrxTRg (small blind) folded before Flop
Seat 2: xrf8tAXKQHG99HixCot1Iw (big blind) collected ($2.10)
Seat 3: MqMK8OWPSY1V4stf1Hy5Jw folded before Flop (didn't bet)
Seat 4: BV+K0Phf5VBHr7aZPKqbUQ folded before Flop (didn't bet)
Seat 5: v+QfkGiuj9bgtuNoVnDO8w folded before Flop
Seat 6: jA7YMtfNUnAaebB7Lj74EA (button) folded before Flop (didn't bet)




PokerStars Game #59941801924:  Hold'em No Limit ($0.10/$0.25) - 2009/07/01 1:46:36 ET
Table '4UJB/UOZ5aepyF2v+hIoUg' 6-max Seat #1 is the button
Seat 1: 08V++DOqzaNrRNsHIwi25w ($27 in chips) 
Seat 2: mFv3iBCtrw9XfCDRB0d46Q ($4.30 in chips) 
Seat 3: zlYHXTtJ5tcx9kwK2h5n9A ($42 in chips) 
Seat 4: R6AGToFJQOYVZAjC2jXEKw ($23.85 in chips) 
Seat 5: 3zD3qLXT1bEffAoWGnc7wg ($26.15 in chips) 
Seat 6: 2aphcinkTZT0B0Uoah6cvQ ($12.85 in chips) 
mFv3iBCtrw9XfCDRB0d46Q: posts small blind $0.10
zlYHXTtJ5tcx9kwK2h5n9A: posts big blind $0.25
*** HOLE CARDS ***
R6AGToFJQOYVZAjC2jXEKw: calls $0.25
3zD3qLXT1bEffAoWGnc7wg: folds 
2aphcinkTZT0B0Uoah6cvQ: folds 
08V++DOqzaNrRNsHIwi25w: folds 
mFv3iBCtrw9XfCDRB0d46Q: folds 
zlYHXTtJ5tcx9kwK2h5n9A: raises $0.50 to $0.75
R6AGToFJQOYVZAjC2jXEKw: calls $0.50
*** FLOP *** [Ad Js Qs]
zlYHXTtJ5tcx9kwK2h5n9A: checks 
R6AGToFJQOYVZAjC2jXEKw: bets $0.75
zlYHXTtJ5tcx9kwK2h5n9A: raises $0.75 to $1.50
R6AGToFJQOYVZAjC2jXEKw: calls $0.75
*** TURN *** [Ad Js Qs] [4h]
zlYHXTtJ5tcx9kwK2h5n9A: bets $3.50
R6AGToFJQOYVZAjC2jXEKw: folds 
Uncalled bet ($3.50) returned to zlYHXTtJ5tcx9kwK2h5n9A
zlYHXTtJ5tcx9kwK2h5n9A collected $4.40 from pot
*** SUMMARY ***
Total pot $4.60 | Rake $0.20 
Board [Ad Js Qs 4h]
Seat 1: 08V++DOqzaNrRNsHIwi25w (button) folded before Flop (didn't bet)
Seat 2: mFv3iBCtrw9XfCDRB0d46Q (small blind) folded before Flop
Seat 3: zlYHXTtJ5tcx9kwK2h5n9A (big blind) collected ($4.40)
Seat 4: R6AGToFJQOYVZAjC2jXEKw folded on the Turn
Seat 5: 3zD3qLXT1bEffAoWGnc7wg folded before Flop (didn't bet)
Seat 6: 2aphcinkTZT0B0Uoah6cvQ folded before Flop (didn't bet)




PokerStars Game #59941801710:  Hold'em No Limit ($0.10/$0.25) - 2009/07/01 1:46:36 ET
Table 'HzFR0rxmDAPu5GzYR0AlYg' 6-max Seat #3 is the button
Seat 1: v+QfkGiuj9bgtuNoVnDO8w ($32.05 in chips) 
Seat 2: UA5OsKS3VPaxa7uC8La/kA ($51.25 in chips) 
Seat 3: kG34n23qFQA3nzdOJTQ1dA ($24.90 in chips) 
Seat 4: Mhj3q7cxev+XjXZxEE6/Cw ($25 in chips) 
Seat 5: lquriepNQBhDV5P1SWHhnA ($29.85 in chips) 
Seat 6: jp34e617tIzV8tKIWmfAbA ($35.55 in chips) 
Mhj3q7cxev+XjXZxEE6/Cw: posts small blind $0.10
lquriepNQBhDV5P1SWHhnA: posts big blind $0.25
*** HOLE CARDS ***
jp34e617tIzV8tKIWmfAbA: raises $0.50 to $0.75
v+QfkGiuj9bgtuNoVnDO8w: folds 
UA5OsKS3VPaxa7uC8La/kA is connected 
UA5OsKS3VPaxa7uC8La/kA: folds 
kG34n23qFQA3nzdOJTQ1dA: folds 
Mhj3q7cxev+XjXZxEE6/Cw: folds 
lquriepNQBhDV5P1SWHhnA: folds 
Uncalled bet ($0.50) returned to jp34e617tIzV8tKIWmfAbA
jp34e617tIzV8tKIWmfAbA collected $0.60 from pot
jp34e617tIzV8tKIWmfAbA: doesn't show hand 
*** SUMMARY ***
Total pot $0.60 | Rake $0 
Seat 1: v+QfkGiuj9bgtuNoVnDO8w folded before Flop (didn't bet)
Seat 2: UA5OsKS3VPaxa7uC8La/kA folded before Flop (didn't bet)
Seat 3: kG34n23qFQA3nzdOJTQ1dA (button) folded before Flop (didn't bet)
Seat 4: Mhj3q7cxev+XjXZxEE6/Cw (small blind) folded before Flop
Seat 5: lquriepNQBhDV5P1SWHhnA (big blind) folded before Flop
Seat 6: jp34e617tIzV8tKIWmfAbA collected ($0.60)




PokerStars Game #59941802654:  Hold'em No Limit ($0.10/$0.25) - 2009/07/01 1:46:37 ET
Table 'IuqVbFI+pwnJjvwBCGSGAw' 6-max Seat #6 is the button
Seat 1: LyDHtw3/yniNHW+DvLXbog ($26.45 in chips) 
Seat 2: w43JQj2oYPpKQVG4Yzlq1w ($25 in chips) 
Seat 3: QiL+lEgEWwy21jk/ltaRLg ($21.40 in chips) 
Seat 4: DE9hRlt14g+JdsRQ4wT7hg ($26.70 in chips) 
Seat 5: if4dh6jhJXeN3/qd3qCp9g ($25.35 in chips) 
Seat 6: xC0kaiDYM6YTlgODL83O5A ($13.90 in chips) 
LyDHtw3/yniNHW+DvLXbog: posts small blind $0.10
w43JQj2oYPpKQVG4Yzlq1w: posts big blind $0.25
*** HOLE CARDS ***
QiL+lEgEWwy21jk/ltaRLg: folds 
DE9hRlt14g+JdsRQ4wT7hg: folds 
if4dh6jhJXeN3/qd3qCp9g: raises $0.50 to $0.75
xC0kaiDYM6YTlgODL83O5A: calls $0.75
LyDHtw3/yniNHW+DvLXbog: calls $0.65
w43JQj2oYPpKQVG4Yzlq1w: folds 
*** FLOP *** [Qd 9s 3s]
LyDHtw3/yniNHW+DvLXbog: bets $2
if4dh6jhJXeN3/qd3qCp9g: folds 
xC0kaiDYM6YTlgODL83O5A: folds 
Uncalled bet ($2) returned to LyDHtw3/yniNHW+DvLXbog
LyDHtw3/yniNHW+DvLXbog collected $2.40 from pot
LyDHtw3/yniNHW+DvLXbog: doesn't show hand 
*** SUMMARY ***
Total pot $2.50 | Rake $0.10 
Board [Qd 9s 3s]
Seat 1: LyDHtw3/yniNHW+DvLXbog (small blind) collected ($2.40)
Seat 2: w43JQj2oYPpKQVG4Yzlq1w (big blind) folded before Flop
Seat 3: QiL+lEgEWwy21jk/ltaRLg folded before Flop (didn't bet)
Seat 4: DE9hRlt14g+JdsRQ4wT7hg folded before Flop (didn't bet)
Seat 5: if4dh6jhJXeN3/qd3qCp9g folded on the Flop
Seat 6: xC0kaiDYM6YTlgODL83O5A (button) folded on the Flop




PokerStars Game #59941802488:  Hold'em No Limit ($0.10/$0.25) - 2009/07/01 1:46:37 ET
Table 'isKy4XK8wJM0x735/D4hWA' 6-max Seat #3 is the button
Seat 1: kwsRmpZ1ZaLooISs+zfyKg ($24.05 in chips) 
Seat 2: 6elpmfyt4Zw0yvd8lePSMQ ($39.25 in chips) 
Seat 3: jp34e617tIzV8tKIWmfAbA ($26.05 in chips) 
Seat 4: DFi/Lzkjsfv8QswS80JX9Q ($31.20 in chips) 
Seat 5: lquriepNQBhDV5P1SWHhnA ($25.60 in chips) 
Seat 6: GbCVUNssQ7mqsPWr7J4d3w ($4.30 in chips) 
DFi/Lzkjsfv8QswS80JX9Q: posts small blind $0.10
lquriepNQBhDV5P1SWHhnA: posts big blind $0.25
*** HOLE CARDS ***
GbCVUNssQ7mqsPWr7J4d3w: folds 
kwsRmpZ1ZaLooISs+zfyKg: folds 
6elpmfyt4Zw0yvd8lePSMQ: folds 
jp34e617tIzV8tKIWmfAbA: folds 
DFi/Lzkjsfv8QswS80JX9Q: folds 
Uncalled bet ($0.15) returned to lquriepNQBhDV5P1SWHhnA
lquriepNQBhDV5P1SWHhnA collected $0.20 from pot
lquriepNQBhDV5P1SWHhnA: doesn't show hand 
*** SUMMARY ***
Total pot $0.20 | Rake $0 
Seat 1: kwsRmpZ1ZaLooISs+zfyKg folded before Flop (didn't bet)
Seat 2: 6elpmfyt4Zw0yvd8lePSMQ folded before Flop (didn't bet)
Seat 3: jp34e617tIzV8tKIWmfAbA (button) folded before Flop (didn't bet)
Seat 4: DFi/Lzkjsfv8QswS80JX9Q (small blind) folded before Flop
Seat 5: lquriepNQBhDV5P1SWHhnA (big blind) collected ($0.20)
Seat 6: GbCVUNssQ7mqsPWr7J4d3w folded before Flop (didn't bet)




PokerStars Game #59941802648:  Hold'em No Limit ($0.10/$0.25) - 2009/07/01 1:46:37 ET
Table 'WY+lMaAoIdBZmwk27/RJCA' 6-max Seat #4 is the button
Seat 1: zHHLkD2sRljslKKeQv/ZQw ($27.20 in chips) 
Seat 2: NhUN/JpAprdJeamFBgJH1w ($26.90 in chips) 
Seat 3: QqiZLFrN8iOUT/GHw7ztOA ($26.60 in chips) 
Seat 4: 0av6tRNdi0Ui4f15L7gsVg ($25 in chips) 
Seat 5: vqWjZmdQu/Hxw96/IJTWdQ ($27.70 in chips) 
Seat 6: cWc85bEzdRzpUMhRKm8pwQ ($25.50 in chips) 
vqWjZmdQu/Hxw96/IJTWdQ: posts small blind $0.10
cWc85bEzdRzpUMhRKm8pwQ: posts big blind $0.25
*** HOLE CARDS ***
zHHLkD2sRljslKKeQv/ZQw: calls $0.25
NhUN/JpAprdJeamFBgJH1w: folds 
QqiZLFrN8iOUT/GHw7ztOA: folds 
0av6tRNdi0Ui4f15L7gsVg: folds 
vqWjZmdQu/Hxw96/IJTWdQ: folds 
cWc85bEzdRzpUMhRKm8pwQ: checks 
*** FLOP *** [4s 4c 6c]
cWc85bEzdRzpUMhRKm8pwQ: checks 
zHHLkD2sRljslKKeQv/ZQw: checks 
*** TURN *** [4s 4c 6c] [Ad]
cWc85bEzdRzpUMhRKm8pwQ: bets $0.50
zHHLkD2sRljslKKeQv/ZQw: folds 
Uncalled bet ($0.50) returned to cWc85bEzdRzpUMhRKm8pwQ
cWc85bEzdRzpUMhRKm8pwQ collected $0.60 from pot
*** SUMMARY ***
Total pot $0.60 | Rake $0 
Board [4s 4c 6c Ad]
Seat 1: zHHLkD2sRljslKKeQv/ZQw folded on the Turn
Seat 2: NhUN/JpAprdJeamFBgJH1w folded before Flop (didn't bet)
Seat 3: QqiZLFrN8iOUT/GHw7ztOA folded before Flop (didn't bet)
Seat 4: 0av6tRNdi0Ui4f15L7gsVg (button) folded before Flop (didn't bet)
Seat 5: vqWjZmdQu/Hxw96/IJTWdQ (small blind) folded before Flop
Seat 6: cWc85bEzdRzpUMhRKm8pwQ (big blind) collected ($0.60)




PokerStars Game #59941802708:  Hold'em No Limit ($0.10/$0.25) - 2009/07/01 1:46:37 ET
Table '/asc7VQ/OpF/oVJ3erB80w' 9-max Seat #3 is the button
Seat 2: +LseQ4csMghI3KY4cLSGMQ ($18.85 in chips) 
Seat 3: WEb58GPxGJGcxGh34AFZRQ ($6.75 in chips) 
Seat 4: Rjy74A2wdEiDWplMcUbA+w ($8.50 in chips) 
Seat 5: QB9VESHry/CRTDKMGwKwsQ ($42.45 in chips) 
Seat 7: 7Qlge5BZqMQvXxiy4HU3Hw ($6.50 in chips) 
Seat 8: jB7U2KxE3pjvDhvZHXK2Ag ($18.60 in chips) 
Seat 9: zUXhymECc2C9W9ZNw6qppA ($19.05 in chips) 
Rjy74A2wdEiDWplMcUbA+w: posts small blind $0.10
QB9VESHry/CRTDKMGwKwsQ: posts big blind $0.25
wnerYvSRWT9Sm4X3ip/c8w: sits out 
*** HOLE CARDS ***
7Qlge5BZqMQvXxiy4HU3Hw: calls $0.25
jB7U2KxE3pjvDhvZHXK2Ag: folds 
zUXhymECc2C9W9ZNw6qppA has timed out
zUXhymECc2C9W9ZNw6qppA: folds 
zUXhymECc2C9W9ZNw6qppA is sitting out
+LseQ4csMghI3KY4cLSGMQ: calls $0.25
Rjy74A2wdEiDWplMcUbA+w said, "wow what a suck out"
WEb58GPxGJGcxGh34AFZRQ: calls $0.25
Rjy74A2wdEiDWplMcUbA+w: calls $0.15
QB9VESHry/CRTDKMGwKwsQ: checks 
*** FLOP *** [3c 6s 5d]
zUXhymECc2C9W9ZNw6qppA is disconnected 
Rjy74A2wdEiDWplMcUbA+w: checks 
zUXhymECc2C9W9ZNw6qppA is connected 
QB9VESHry/CRTDKMGwKwsQ: bets $0.50
zUXhymECc2C9W9ZNw6qppA has returned
7Qlge5BZqMQvXxiy4HU3Hw said, "parrot u from alabama"
7Qlge5BZqMQvXxiy4HU3Hw: folds 
+LseQ4csMghI3KY4cLSGMQ: raises $0.50 to $1
WEb58GPxGJGcxGh34AFZRQ: folds 
Rjy74A2wdEiDWplMcUbA+w: folds 
QB9VESHry/CRTDKMGwKwsQ: calls $0.50
*** TURN *** [3c 6s 5d] [Qc]
QB9VESHry/CRTDKMGwKwsQ: checks 
+LseQ4csMghI3KY4cLSGMQ: bets $0.25
QB9VESHry/CRTDKMGwKwsQ: calls $0.25
*** RIVER *** [3c 6s 5d Qc] [2h]
QB9VESHry/CRTDKMGwKwsQ: checks 
Rjy74A2wdEiDWplMcUbA+w said, "no, arkansas"
+LseQ4csMghI3KY4cLSGMQ: bets $4
QB9VESHry/CRTDKMGwKwsQ: folds 
Uncalled bet ($4) returned to +LseQ4csMghI3KY4cLSGMQ
+LseQ4csMghI3KY4cLSGMQ collected $3.60 from pot
*** SUMMARY ***
Total pot $3.75 | Rake $0.15 
Board [3c 6s 5d Qc 2h]
Seat 2: +LseQ4csMghI3KY4cLSGMQ collected ($3.60)
Seat 3: WEb58GPxGJGcxGh34AFZRQ (button) folded on the Flop
Seat 4: Rjy74A2wdEiDWplMcUbA+w (small blind) folded on the Flop
Seat 5: QB9VESHry/CRTDKMGwKwsQ (big blind) folded on the River
Seat 7: 7Qlge5BZqMQvXxiy4HU3Hw folded on the Flop
Seat 8: jB7U2KxE3pjvDhvZHXK2Ag folded before Flop (didn't bet)
Seat 9: zUXhymECc2C9W9ZNw6qppA folded before Flop (didn't bet)




PokerStars Game #59941802422:  Hold'em No Limit ($0.10/$0.25) - 2009/07/01 1:46:37 ET
Table 'M7d9IrgQUUFFy/SZ3ksLYg' 6-max Seat #2 is the button
Seat 1: ypmjhffk/YHGc51wgVXUTw ($49.25 in chips) 
Seat 2: gqrr7lSWrQ1N8zKx8zZzvA ($4.65 in chips) 
Seat 4: 8ClCHtFXGNplITm+63KB+Q ($24.30 in chips) 
Seat 5: kMa8BltUcBQVxnHfqdCfXg ($8.25 in chips) 
epAUIB7h2FJXzUPRIvSkRA will be allowed to play after the button
8ClCHtFXGNplITm+63KB+Q: posts small blind $0.10
kMa8BltUcBQVxnHfqdCfXg: posts big blind $0.25
*** HOLE CARDS ***
ypmjhffk/YHGc51wgVXUTw: folds 
gqrr7lSWrQ1N8zKx8zZzvA: folds 
gqrr7lSWrQ1N8zKx8zZzvA is sitting out
gqrr7lSWrQ1N8zKx8zZzvA leaves the table
8ClCHtFXGNplITm+63KB+Q: folds 
Uncalled bet ($0.15) returned to kMa8BltUcBQVxnHfqdCfXg
kMa8BltUcBQVxnHfqdCfXg collected $0.20 from pot
*** SUMMARY ***
Total pot $0.20 | Rake $0 
Seat 1: ypmjhffk/YHGc51wgVXUTw folded before Flop (didn't bet)
Seat 2: gqrr7lSWrQ1N8zKx8zZzvA (button) folded before Flop (didn't bet)
Seat 4: 8ClCHtFXGNplITm+63KB+Q (small blind) folded before Flop
Seat 5: kMa8BltUcBQVxnHfqdCfXg (big blind) collected ($0.20)




PokerStars Game #59941803276:  Hold'em No Limit ($0.10/$0.25) - 2009/07/01 1:46:38 ET
Table 'oxYpQNT8OHNCvpMIFi7UoA' 9-max Seat #3 is the button
Seat 1: EVqHvqty1ZsuvDFiSXlSqQ ($33.20 in chips) 
Seat 2: 8+iP8mvFyeAviW/yUH1CJg ($30.05 in chips) 
Seat 3: ubsjZomMWSV0hAiBLa7K1A ($19.80 in chips) 
Seat 4: eK8qa6EPcH2zhtbmWSvc9g ($25 in chips) 
Seat 5: ZoqLw33zTU6EsjOkfv/cGw ($19.90 in chips) 
Seat 6: VBHxUExRAMrbxUq/cVx9Gw ($5.40 in chips) 
Seat 7: X78b5v/uhqeXXoAijbw/yg ($36.65 in chips) 
Seat 9: pN3IHvAKm2fz+sTRARTcrg ($25 in chips) 
eK8qa6EPcH2zhtbmWSvc9g: posts small blind $0.10
ZoqLw33zTU6EsjOkfv/cGw: posts big blind $0.25
*** HOLE CARDS ***
VBHxUExRAMrbxUq/cVx9Gw: folds 
X78b5v/uhqeXXoAijbw/yg: raises $0.75 to $1
pN3IHvAKm2fz+sTRARTcrg: folds 
EVqHvqty1ZsuvDFiSXlSqQ: folds 
8+iP8mvFyeAviW/yUH1CJg: calls $1
ubsjZomMWSV0hAiBLa7K1A: folds 
eK8qa6EPcH2zhtbmWSvc9g: folds 
ZoqLw33zTU6EsjOkfv/cGw: calls $0.75
*** FLOP *** [6c Jc 7c]
ZoqLw33zTU6EsjOkfv/cGw: checks 
X78b5v/uhqeXXoAijbw/yg: checks 
8+iP8mvFyeAviW/yUH1CJg: checks 
*** TURN *** [6c Jc 7c] [Qd]
ZoqLw33zTU6EsjOkfv/cGw: checks 
X78b5v/uhqeXXoAijbw/yg: checks 
8+iP8mvFyeAviW/yUH1CJg: checks 
*** RIVER *** [6c Jc 7c Qd] [Kc]
ZoqLw33zTU6EsjOkfv/cGw: checks 
X78b5v/uhqeXXoAijbw/yg: checks 
8+iP8mvFyeAviW/yUH1CJg: bets $1.25
ZoqLw33zTU6EsjOkfv/cGw: folds 
X78b5v/uhqeXXoAijbw/yg: folds 
Uncalled bet ($1.25) returned to 8+iP8mvFyeAviW/yUH1CJg
8+iP8mvFyeAviW/yUH1CJg collected $2.95 from pot
*** SUMMARY ***
Total pot $3.10 | Rake $0.15 
Board [6c Jc 7c Qd Kc]
Seat 1: EVqHvqty1ZsuvDFiSXlSqQ folded before Flop (didn't bet)
Seat 2: 8+iP8mvFyeAviW/yUH1CJg collected ($2.95)
Seat 3: ubsjZomMWSV0hAiBLa7K1A (button) folded before Flop (didn't bet)
Seat 4: eK8qa6EPcH2zhtbmWSvc9g (small blind) folded before Flop
Seat 5: ZoqLw33zTU6EsjOkfv/cGw (big blind) folded on the River
Seat 6: VBHxUExRAMrbxUq/cVx9Gw folded before Flop (didn't bet)
Seat 7: X78b5v/uhqeXXoAijbw/yg folded on the River
Seat 9: pN3IHvAKm2fz+sTRARTcrg folded before Flop (didn't bet)




PokerStars Game #59941803010:  Hold'em No Limit ($0.10/$0.25) - 2009/07/01 1:46:38 ET
Table 'HIOfhT0zga/KonFhIl6O3w' 9-max Seat #2 is the button
Seat 1: oLa/tXLfSLLB28mcLGrxcg ($26.20 in chips) 
Seat 2: er86weqXTpTB6/w2dKlYgA ($16.75 in chips) 
Seat 3: X6+pSIPfovPcE87t+LmUKQ ($4.75 in chips) 
Seat 4: qwr38jl5txoR36M7G5qi4A ($8.65 in chips) 
Seat 5: K1MDeapSEyKyGPNZGOKfEg ($36.10 in chips) 
Seat 6: MThMMgdB293VOucmN9sliQ ($25.95 in chips) 
Seat 7: wvlPJBB0PtYkfeeSRDaIvQ ($13.45 in chips) 
Seat 9: dfNim92Z6XK1/h5SFW5vDg ($28.70 in chips) 
X6+pSIPfovPcE87t+LmUKQ: posts small blind $0.10
qwr38jl5txoR36M7G5qi4A: posts big blind $0.25
SpiiQQAzy4MUgV3I5W8giw: sits out 
*** HOLE CARDS ***
K1MDeapSEyKyGPNZGOKfEg: calls $0.25
MThMMgdB293VOucmN9sliQ: folds 
wvlPJBB0PtYkfeeSRDaIvQ: folds 
dfNim92Z6XK1/h5SFW5vDg: folds 
oLa/tXLfSLLB28mcLGrxcg: folds 
er86weqXTpTB6/w2dKlYgA: calls $0.25
X6+pSIPfovPcE87t+LmUKQ: calls $0.15
qwr38jl5txoR36M7G5qi4A: checks 
*** FLOP *** [5h Ah 8d]
X6+pSIPfovPcE87t+LmUKQ: checks 
qwr38jl5txoR36M7G5qi4A: checks 
K1MDeapSEyKyGPNZGOKfEg: checks 
er86weqXTpTB6/w2dKlYgA: checks 
*** TURN *** [5h Ah 8d] [Kh]
X6+pSIPfovPcE87t+LmUKQ: checks 
qwr38jl5txoR36M7G5qi4A: checks 
K1MDeapSEyKyGPNZGOKfEg: bets $0.75
er86weqXTpTB6/w2dKlYgA: folds 
X6+pSIPfovPcE87t+LmUKQ: folds 
qwr38jl5txoR36M7G5qi4A: folds 
Uncalled bet ($0.75) returned to K1MDeapSEyKyGPNZGOKfEg
K1MDeapSEyKyGPNZGOKfEg collected $0.95 from pot
*** SUMMARY ***
Total pot $1 | Rake $0.05 
Board [5h Ah 8d Kh]
Seat 1: oLa/tXLfSLLB28mcLGrxcg folded before Flop (didn't bet)
Seat 2: er86weqXTpTB6/w2dKlYgA (button) folded on the Turn
Seat 3: X6+pSIPfovPcE87t+LmUKQ (small blind) folded on the Turn
Seat 4: qwr38jl5txoR36M7G5qi4A (big blind) folded on the Turn
Seat 5: K1MDeapSEyKyGPNZGOKfEg collected ($0.95)
Seat 6: MThMMgdB293VOucmN9sliQ folded before Flop (didn't bet)
Seat 7: wvlPJBB0PtYkfeeSRDaIvQ folded before Flop (didn't bet)
Seat 9: dfNim92Z6XK1/h5SFW5vDg folded before Flop (didn't bet)




PokerStars Game #59941803162:  Hold'em No Limit ($0.10/$0.25) - 2009/07/01 1:46:38 ET
Table '3EebBlzq5yHSY2444L4zlg' 9-max Seat #7 is the button
Seat 1: XMSS6mD5B42I8wasdOMipQ ($29.50 in chips) 
Seat 2: b9UnopCOpq2MWP1DwqSO3Q ($17.70 in chips) 
Seat 3: IGbD5vKNhHe60dkdbjg/mw ($41.45 in chips) 
Seat 5: PFNLAvMkr8qKc7xCiH0wTA ($24.15 in chips) 
Seat 6: QEbIGci+itdw+re8RM5fZA ($50 in chips) 
Seat 7: DiSvPC2iudwL5j9u6Huyww ($48.35 in chips) 
Seat 8: dtZ84flFEi4Q+SGrHMJRDQ ($28.80 in chips) 
Seat 9: iZmSlSzYu5fJ67tDdQzymQ ($25.95 in chips) 
dtZ84flFEi4Q+SGrHMJRDQ: posts small blind $0.10
iZmSlSzYu5fJ67tDdQzymQ: posts big blind $0.25
PdIasPkzm2sqZnN41ZRXOg: sits out 
*** HOLE CARDS ***
XMSS6mD5B42I8wasdOMipQ: folds 
b9UnopCOpq2MWP1DwqSO3Q: folds 
IGbD5vKNhHe60dkdbjg/mw: raises $0.75 to $1
PFNLAvMkr8qKc7xCiH0wTA: calls $1
QEbIGci+itdw+re8RM5fZA: folds 
DiSvPC2iudwL5j9u6Huyww: folds 
dtZ84flFEi4Q+SGrHMJRDQ: folds 
iZmSlSzYu5fJ67tDdQzymQ: calls $0.75
*** FLOP *** [6c 3c 7h]
iZmSlSzYu5fJ67tDdQzymQ: checks 
IGbD5vKNhHe60dkdbjg/mw: bets $2.25
PFNLAvMkr8qKc7xCiH0wTA: raises $3 to $5.25
iZmSlSzYu5fJ67tDdQzymQ: calls $5.25
IGbD5vKNhHe60dkdbjg/mw: raises $3 to $8.25
PFNLAvMkr8qKc7xCiH0wTA: raises $14.90 to $23.15 and is all-in
b9UnopCOpq2MWP1DwqSO3Q said, "PJ"
iZmSlSzYu5fJ67tDdQzymQ: folds 
IGbD5vKNhHe60dkdbjg/mw: calls $14.90
*** TURN *** [6c 3c 7h] [Th]
*** RIVER *** [6c 3c 7h Th] [6d]
*** SHOW DOWN ***
IGbD5vKNhHe60dkdbjg/mw: shows [4s 4d] (two pair, Sixes and Fours)
PFNLAvMkr8qKc7xCiH0wTA: shows [7c 7d] (a full house, Sevens full of Sixes)
PFNLAvMkr8qKc7xCiH0wTA collected $51.95 from pot
*** SUMMARY ***
Total pot $54.65 | Rake $2.70 
Board [6c 3c 7h Th 6d]
Seat 1: XMSS6mD5B42I8wasdOMipQ folded before Flop (didn't bet)
Seat 2: b9UnopCOpq2MWP1DwqSO3Q folded before Flop (didn't bet)
Seat 3: IGbD5vKNhHe60dkdbjg/mw showed [4s 4d] and lost with two pair, Sixes and Fours
Seat 5: PFNLAvMkr8qKc7xCiH0wTA showed [7c 7d] and won ($51.95) with a full house, Sevens full of Sixes
Seat 6: QEbIGci+itdw+re8RM5fZA folded before Flop (didn't bet)
Seat 7: DiSvPC2iudwL5j9u6Huyww (button) folded before Flop (didn't bet)
Seat 8: dtZ84flFEi4Q+SGrHMJRDQ (small blind) folded before Flop
Seat 9: iZmSlSzYu5fJ67tDdQzymQ (big blind) folded on the Flop




PokerStars Game #59941802810:  Hold'em No Limit ($0.10/$0.25) - 2009/07/01 1:46:38 ET
Table 'wRXcD9iXgBbdvKhWmfnBnw' 6-max Seat #4 is the button
Seat 2: vUr8qM1UsCElsCI9B/McdQ ($23.10 in chips) 
Seat 3: l4ToKwb3EVcEuva7hPqMCQ ($9.95 in chips) 
Seat 4: mnuJq+Q1IXKm/pCy+OzxmQ ($19.25 in chips) 
Seat 5: EE16Ua5b1HSsYej5zeXOlA ($47.20 in chips) 
Seat 6: JFIAqU8lCZ0vWwEl4bdGsg ($25 in chips) 
EE16Ua5b1HSsYej5zeXOlA: posts small blind $0.10
JFIAqU8lCZ0vWwEl4bdGsg: posts big blind $0.25
Mhj3q7cxev+XjXZxEE6/Cw: sits out 
*** HOLE CARDS ***
vUr8qM1UsCElsCI9B/McdQ: folds 
l4ToKwb3EVcEuva7hPqMCQ: calls $0.25
mnuJq+Q1IXKm/pCy+OzxmQ: folds 
EE16Ua5b1HSsYej5zeXOlA: folds 
JFIAqU8lCZ0vWwEl4bdGsg: checks 
*** FLOP *** [8s Qc 4d]
JFIAqU8lCZ0vWwEl4bdGsg: checks 
l4ToKwb3EVcEuva7hPqMCQ: checks 
*** TURN *** [8s Qc 4d] [5s]
JFIAqU8lCZ0vWwEl4bdGsg: bets $0.60
l4ToKwb3EVcEuva7hPqMCQ: raises $0.60 to $1.20
JFIAqU8lCZ0vWwEl4bdGsg: raises $1.80 to $3
l4ToKwb3EVcEuva7hPqMCQ: calls $1.80
*** RIVER *** [8s Qc 4d 5s] [3c]
JFIAqU8lCZ0vWwEl4bdGsg: bets $7
l4ToKwb3EVcEuva7hPqMCQ: calls $6.70 and is all-in
Uncalled bet ($0.30) returned to JFIAqU8lCZ0vWwEl4bdGsg
*** SHOW DOWN ***
JFIAqU8lCZ0vWwEl4bdGsg: shows [7s 6h] (a straight, Four to Eight)
l4ToKwb3EVcEuva7hPqMCQ: mucks hand 
JFIAqU8lCZ0vWwEl4bdGsg collected $19.05 from pot
l4ToKwb3EVcEuva7hPqMCQ leaves the table
*** SUMMARY ***
Total pot $20 | Rake $0.95 
Board [8s Qc 4d 5s 3c]
Seat 2: vUr8qM1UsCElsCI9B/McdQ folded before Flop (didn't bet)
Seat 3: l4ToKwb3EVcEuva7hPqMCQ mucked
Seat 4: mnuJq+Q1IXKm/pCy+OzxmQ (button) folded before Flop (didn't bet)
Seat 5: EE16Ua5b1HSsYej5zeXOlA (small blind) folded before Flop
Seat 6: JFIAqU8lCZ0vWwEl4bdGsg (big blind) showed [7s 6h] and won ($19.05) with a straight, Four to Eight




PokerStars Game #59941802992:  Hold'em No Limit ($0.10/$0.25) - 2009/07/01 1:46:38 ET
Table '63uh7ZsO7Tnt+E8b/2bu3A' 6-max Seat #2 is the button
Seat 1: 0av6tRNdi0Ui4f15L7gsVg ($30.20 in chips) 
Seat 2: SFmT9ZsVopnukjvAzrxTRg ($30.30 in chips) 
Seat 3: yVP7GLZBzx47OPi6jzUxMw ($7.45 in chips) 
Seat 4: rnpAao581IcvQglpkpnkoQ ($11.25 in chips) 
Seat 5: GbCVUNssQ7mqsPWr7J4d3w ($4.05 in chips) 
Seat 6: qGHGf/553gQnDoklMRe3tg ($29.15 in chips) 
yVP7GLZBzx47OPi6jzUxMw: posts small blind $0.10
rnpAao581IcvQglpkpnkoQ: posts big blind $0.25
*** HOLE CARDS ***
GbCVUNssQ7mqsPWr7J4d3w: folds 
qGHGf/553gQnDoklMRe3tg: folds 
0av6tRNdi0Ui4f15L7gsVg: folds 
SFmT9ZsVopnukjvAzrxTRg: folds 
yVP7GLZBzx47OPi6jzUxMw: folds 
Uncalled bet ($0.15) returned to rnpAao581IcvQglpkpnkoQ
rnpAao581IcvQglpkpnkoQ collected $0.20 from pot
*** SUMMARY ***
Total pot $0.20 | Rake $0 
Seat 1: 0av6tRNdi0Ui4f15L7gsVg folded before Flop (didn't bet)
Seat 2: SFmT9ZsVopnukjvAzrxTRg (button) folded before Flop (didn't bet)
Seat 3: yVP7GLZBzx47OPi6jzUxMw (small blind) folded before Flop
Seat 4: rnpAao581IcvQglpkpnkoQ (big blind) collected ($0.20)
Seat 5: GbCVUNssQ7mqsPWr7J4d3w folded before Flop (didn't bet)
Seat 6: qGHGf/553gQnDoklMRe3tg folded before Flop (didn't bet)




PokerStars Game #59941802932:  Hold'em No Limit ($0.10/$0.25) - 2009/07/01 1:46:38 ET
Table 'Xi38lWH8L2JHRAsKYVX8Qg' 6-max Seat #5 is the button
Seat 1: shP7DFAtX7gXcgMJX/OmRQ ($19.15 in chips) 
Seat 2: VOmI0x4dDPnTESZd5B4d1Q ($9.10 in chips) 
Seat 3: 6DwBRH+xZ12AAZmeAg+aXw ($35.20 in chips) 
Seat 4: kG34n23qFQA3nzdOJTQ1dA ($24.50 in chips) 
Seat 5: 79ID/ub1Pt/mDpCprVmOoA ($77.60 in chips) 
Seat 6: kyRaCIljYA6l33lSKQfNsg ($29.50 in chips) 
kyRaCIljYA6l33lSKQfNsg: posts small blind $0.10
shP7DFAtX7gXcgMJX/OmRQ: posts big blind $0.25
*** HOLE CARDS ***
VOmI0x4dDPnTESZd5B4d1Q: folds 
6DwBRH+xZ12AAZmeAg+aXw: folds 
kG34n23qFQA3nzdOJTQ1dA: folds 
79ID/ub1Pt/mDpCprVmOoA: folds 
kyRaCIljYA6l33lSKQfNsg: raises $0.50 to $0.75
shP7DFAtX7gXcgMJX/OmRQ: folds 
Uncalled bet ($0.50) returned to kyRaCIljYA6l33lSKQfNsg
kyRaCIljYA6l33lSKQfNsg collected $0.50 from pot
*** SUMMARY ***
Total pot $0.50 | Rake $0 
Seat 1: shP7DFAtX7gXcgMJX/OmRQ (big blind) folded before Flop
Seat 2: VOmI0x4dDPnTESZd5B4d1Q folded before Flop (didn't bet)
Seat 3: 6DwBRH+xZ12AAZmeAg+aXw folded before Flop (didn't bet)
Seat 4: kG34n23qFQA3nzdOJTQ1dA folded before Flop (didn't bet)
Seat 5: 79ID/ub1Pt/mDpCprVmOoA (button) folded before Flop (didn't bet)
Seat 6: kyRaCIljYA6l33lSKQfNsg (small blind) collected ($0.50)




PokerStars Game #59941803498:  Hold'em No Limit ($0.10/$0.25) - 2009/07/01 1:46:39 ET
Table 'CM/C/FZf3VHIp50RjmBucQ' 9-max Seat #4 is the button
Seat 1: P8h+GtgJJRwRh2YdssBtbg ($5 in chips) 
Seat 2: +aNWwNic2LVhXcMqH+ezrA ($15.65 in chips) 
Seat 3: HPEB+AtKw1+C/cxU0o1ciw ($50.70 in chips) 
Seat 4: FYIiLXWy4mKC5ZGa/fnS0g ($15.65 in chips) 
Seat 5: t3m1RlE+8m1yb0ojo8ikCw ($14 in chips) 
Seat 6: FqpibuVWLNsAN/Z7ROZLnA ($8.65 in chips) 
t3m1RlE+8m1yb0ojo8ikCw: posts small blind $0.10
FqpibuVWLNsAN/Z7ROZLnA: posts big blind $0.25
P8h+GtgJJRwRh2YdssBtbg: posts big blind $0.25
+T7KwHtNiHQt6JhQegSH/w joins the table at seat #7 
+aNWwNic2LVhXcMqH+ezrA: posts big blind $0.25
*** HOLE CARDS ***
P8h+GtgJJRwRh2YdssBtbg: checks 
+aNWwNic2LVhXcMqH+ezrA: checks 
HPEB+AtKw1+C/cxU0o1ciw: raises $1.25 to $1.50
FYIiLXWy4mKC5ZGa/fnS0g: folds 
t3m1RlE+8m1yb0ojo8ikCw: folds 
FqpibuVWLNsAN/Z7ROZLnA: calls $1.25
P8h+GtgJJRwRh2YdssBtbg: folds 
+aNWwNic2LVhXcMqH+ezrA: folds 
*** FLOP *** [6s 7d 4h]
FqpibuVWLNsAN/Z7ROZLnA: checks 
HPEB+AtKw1+C/cxU0o1ciw: bets $2
FqpibuVWLNsAN/Z7ROZLnA: calls $2
*** TURN *** [6s 7d 4h] [Ah]
FqpibuVWLNsAN/Z7ROZLnA: checks 
SlimQuinn joins the table at seat #8 
HPEB+AtKw1+C/cxU0o1ciw: bets $3.60
FqpibuVWLNsAN/Z7ROZLnA: folds 
Uncalled bet ($3.60) returned to HPEB+AtKw1+C/cxU0o1ciw
HPEB+AtKw1+C/cxU0o1ciw collected $7.25 from pot
HPEB+AtKw1+C/cxU0o1ciw: doesn't show hand 
*** SUMMARY ***
Total pot $7.60 | Rake $0.35 
Board [6s 7d 4h Ah]
Seat 1: P8h+GtgJJRwRh2YdssBtbg folded before Flop
Seat 2: +aNWwNic2LVhXcMqH+ezrA folded before Flop
Seat 3: HPEB+AtKw1+C/cxU0o1ciw collected ($7.25)
Seat 4: FYIiLXWy4mKC5ZGa/fnS0g (button) folded before Flop (didn't bet)
Seat 5: t3m1RlE+8m1yb0ojo8ikCw (small blind) folded before Flop
Seat 6: FqpibuVWLNsAN/Z7ROZLnA (big blind) folded on the Turn




PokerStars Game #59941803320:  Hold'em No Limit ($0.10/$0.25) - 2009/07/01 1:46:39 ET
Table 'rtxA1Y01Nrq5VoyzTAuusQ' 9-max Seat #8 is the button
Seat 1: w1ukf8uPa4+WH561TtVRxA ($26.90 in chips) 
Seat 2: Th3FldXKQW6hWVVPahaoOQ ($25 in chips) 
Seat 3: K9fS1IUr5GpiJG7VkJ7IbA ($5 in chips) 
Seat 4: RHqgdFvufLCYe54+qd2gcA ($4.65 in chips) 
Seat 5: MtVtHDqIJTyUcXkRBBDIVA ($32.90 in chips) 
Seat 8: DnDcAdn9P0zGovMERigpFA ($25 in chips) 
Seat 9: HPEB+AtKw1+C/cxU0o1ciw ($22.45 in chips) 
HPEB+AtKw1+C/cxU0o1ciw: posts small blind $0.10
w1ukf8uPa4+WH561TtVRxA: posts big blind $0.25
W6tExOcYX7qiy6Qdp+ZwFA: sits out 
*** HOLE CARDS ***
Th3FldXKQW6hWVVPahaoOQ: folds 
K9fS1IUr5GpiJG7VkJ7IbA: raises $0.50 to $0.75
RHqgdFvufLCYe54+qd2gcA: folds 
MtVtHDqIJTyUcXkRBBDIVA: calls $0.75
DnDcAdn9P0zGovMERigpFA: folds 
HPEB+AtKw1+C/cxU0o1ciw: folds 
w1ukf8uPa4+WH561TtVRxA: folds 
*** FLOP *** [Ac 2h 9s]
K9fS1IUr5GpiJG7VkJ7IbA: bets $0.75
MtVtHDqIJTyUcXkRBBDIVA: calls $0.75
*** TURN *** [Ac 2h 9s] [Jh]
K9fS1IUr5GpiJG7VkJ7IbA: bets $1.50
MtVtHDqIJTyUcXkRBBDIVA: calls $1.50
*** RIVER *** [Ac 2h 9s Jh] [6d]
K9fS1IUr5GpiJG7VkJ7IbA: bets $2 and is all-in
MtVtHDqIJTyUcXkRBBDIVA: folds 
Uncalled bet ($2) returned to K9fS1IUr5GpiJG7VkJ7IbA
K9fS1IUr5GpiJG7VkJ7IbA collected $6.05 from pot
*** SUMMARY ***
Total pot $6.35 | Rake $0.30 
Board [Ac 2h 9s Jh 6d]
Seat 1: w1ukf8uPa4+WH561TtVRxA (big blind) folded before Flop
Seat 2: Th3FldXKQW6hWVVPahaoOQ folded before Flop (didn't bet)
Seat 3: K9fS1IUr5GpiJG7VkJ7IbA collected ($6.05)
Seat 4: RHqgdFvufLCYe54+qd2gcA folded before Flop (didn't bet)
Seat 5: MtVtHDqIJTyUcXkRBBDIVA folded on the River
Seat 8: DnDcAdn9P0zGovMERigpFA (button) folded before Flop (didn't bet)
Seat 9: HPEB+AtKw1+C/cxU0o1ciw (small blind) folded before Flop




PokerStars Game #59941803572:  Hold'em No Limit ($0.10/$0.25) - 2009/07/01 1:46:39 ET
Table '2VkNDXXsBj4bSZw/uK5atw' 6-max Seat #6 is the button
Seat 1: xrf8tAXKQHG99HixCot1Iw ($25 in chips) 
Seat 2: v6mkGzCBCCXcgWQNSYVtKg ($12.20 in chips) 
Seat 4: 4kIRqWKE/N0yUAcWVhLSoQ ($14.75 in chips) 
Seat 5: 7f0OkhFEOf3T+rVOFHRLnw ($20.05 in chips) 
Seat 6: n6UPMnVR4v8LFP0rWP73Fg ($12.95 in chips) 
xrf8tAXKQHG99HixCot1Iw: posts small blind $0.10
v6mkGzCBCCXcgWQNSYVtKg: posts big blind $0.25
P+6Z5+8H5/Wyt/jHMovNvQ: sits out 
*** HOLE CARDS ***
4kIRqWKE/N0yUAcWVhLSoQ: folds 
7f0OkhFEOf3T+rVOFHRLnw: folds 
n6UPMnVR4v8LFP0rWP73Fg: folds 
xrf8tAXKQHG99HixCot1Iw: raises $0.50 to $0.75
v6mkGzCBCCXcgWQNSYVtKg: folds 
Uncalled bet ($0.50) returned to xrf8tAXKQHG99HixCot1Iw
xrf8tAXKQHG99HixCot1Iw collected $0.50 from pot
xrf8tAXKQHG99HixCot1Iw: doesn't show hand 
*** SUMMARY ***
Total pot $0.50 | Rake $0 
Seat 1: xrf8tAXKQHG99HixCot1Iw (small blind) collected ($0.50)
Seat 2: v6mkGzCBCCXcgWQNSYVtKg (big blind) folded before Flop
Seat 4: 4kIRqWKE/N0yUAcWVhLSoQ folded before Flop (didn't bet)
Seat 5: 7f0OkhFEOf3T+rVOFHRLnw folded before Flop (didn't bet)
Seat 6: n6UPMnVR4v8LFP0rWP73Fg (button) folded before Flop (didn't bet)




PokerStars Game #59941804188:  Hold'em No Limit ($0.10/$0.25) - 2009/07/01 1:46:40 ET
Table 'bIGKmJgZehWJ+FAo8b85iw' 9-max Seat #4 is the button
Seat 1: yyG4svzOpC1A+sUP/scg6w ($3.20 in chips) 
Seat 2: cCjRCvseA9rZn7Xr+GCCHg ($21.35 in chips) 
Seat 3: /FyMUX+W/tpNFcRWbUTJxQ ($23.50 in chips) 
Seat 4: LGxBRjCRn6KlQ/6B4eoXbA ($38.55 in chips) 
Seat 5: uLP/lYn7oKq9xCChBXsXxw ($24.75 in chips) 
Seat 6: PFNLAvMkr8qKc7xCiH0wTA ($18.45 in chips) 
Seat 8: +2kMBNpY4nF1qNCRd8SJLA ($54.20 in chips) 
Seat 9: aNpwfA31EREwO+ar4XzBCw ($31.75 in chips) 
uLP/lYn7oKq9xCChBXsXxw: posts small blind $0.10
PFNLAvMkr8qKc7xCiH0wTA: posts big blind $0.25
mMd8CDS/but3UC+Zp7Up2w: sits out 
*** HOLE CARDS ***
+2kMBNpY4nF1qNCRd8SJLA: folds 
aNpwfA31EREwO+ar4XzBCw: folds 
yyG4svzOpC1A+sUP/scg6w: calls $0.25
cCjRCvseA9rZn7Xr+GCCHg: raises $1.25 to $1.50
/FyMUX+W/tpNFcRWbUTJxQ: folds 
LGxBRjCRn6KlQ/6B4eoXbA: folds 
uLP/lYn7oKq9xCChBXsXxw: folds 
PFNLAvMkr8qKc7xCiH0wTA: calls $1.25
yyG4svzOpC1A+sUP/scg6w: calls $1.25
*** FLOP *** [Jd 6c Qc]
PFNLAvMkr8qKc7xCiH0wTA: checks 
yyG4svzOpC1A+sUP/scg6w: checks 
cCjRCvseA9rZn7Xr+GCCHg: bets $4.25
PFNLAvMkr8qKc7xCiH0wTA: folds 
yyG4svzOpC1A+sUP/scg6w: calls $1.70 and is all-in
Uncalled bet ($2.55) returned to cCjRCvseA9rZn7Xr+GCCHg
*** TURN *** [Jd 6c Qc] [6h]
*** RIVER *** [Jd 6c Qc 6h] [9d]
*** SHOW DOWN ***
yyG4svzOpC1A+sUP/scg6w: shows [Kh Qh] (two pair, Queens and Sixes)
cCjRCvseA9rZn7Xr+GCCHg: shows [Ah Ac] (two pair, Aces and Sixes)
cCjRCvseA9rZn7Xr+GCCHg collected $7.65 from pot
*** SUMMARY ***
Total pot $8 | Rake $0.35 
Board [Jd 6c Qc 6h 9d]
Seat 1: yyG4svzOpC1A+sUP/scg6w showed [Kh Qh] and lost with two pair, Queens and Sixes
Seat 2: cCjRCvseA9rZn7Xr+GCCHg showed [Ah Ac] and won ($7.65) with two pair, Aces and Sixes
Seat 3: /FyMUX+W/tpNFcRWbUTJxQ folded before Flop (didn't bet)
Seat 4: LGxBRjCRn6KlQ/6B4eoXbA (button) folded before Flop (didn't bet)
Seat 5: uLP/lYn7oKq9xCChBXsXxw (small blind) folded before Flop
Seat 6: PFNLAvMkr8qKc7xCiH0wTA (big blind) folded on the Flop
Seat 8: +2kMBNpY4nF1qNCRd8SJLA folded before Flop (didn't bet)
Seat 9: aNpwfA31EREwO+ar4XzBCw folded before Flop (didn't bet)




PokerStars Game #59941803922:  Hold'em No Limit ($0.10/$0.25) - 2009/07/01 1:46:40 ET
Table 'pAhiNHs/spaABQia+7gWNQ' 9-max Seat #5 is the button
Seat 1: ipgcO7Pa6LC8XWpVttZfnA ($3.65 in chips) 
Seat 2: dfNim92Z6XK1/h5SFW5vDg ($25.25 in chips) 
Seat 4: Qduu7ikeizo6q6Ei9YvcJA ($48.75 in chips) 
Seat 5: OlPJsgR4xypSg/w1z7Gyvw ($31.65 in chips) 
Seat 6: oLa/tXLfSLLB28mcLGrxcg ($25 in chips) 
Seat 7: +WTkVY3GeLxqGQBbMZQiWQ ($5.90 in chips) 
Seat 8: PskTLlFIRHSp61inskRzVg ($14 in chips) 
Seat 9: zgi+EUykT/pZQpoUG6+oEg ($6.15 in chips) 
oLa/tXLfSLLB28mcLGrxcg: posts small blind $0.10
+WTkVY3GeLxqGQBbMZQiWQ: posts big blind $0.25
bXpVeaSTPBFSPJmeXxO7nw: sits out 
*** HOLE CARDS ***
PskTLlFIRHSp61inskRzVg: folds 
zgi+EUykT/pZQpoUG6+oEg: folds 
ipgcO7Pa6LC8XWpVttZfnA: folds 
dfNim92Z6XK1/h5SFW5vDg: folds 
Qduu7ikeizo6q6Ei9YvcJA: raises $0.75 to $1
OlPJsgR4xypSg/w1z7Gyvw: calls $1
oLa/tXLfSLLB28mcLGrxcg: folds 
+WTkVY3GeLxqGQBbMZQiWQ: calls $0.75
*** FLOP *** [7d 2c Th]
+WTkVY3GeLxqGQBbMZQiWQ: checks 
Qduu7ikeizo6q6Ei9YvcJA: checks 
OlPJsgR4xypSg/w1z7Gyvw: checks 
*** TURN *** [7d 2c Th] [5h]
+WTkVY3GeLxqGQBbMZQiWQ: checks 
Qduu7ikeizo6q6Ei9YvcJA: checks 
OlPJsgR4xypSg/w1z7Gyvw: bets $1.50
+WTkVY3GeLxqGQBbMZQiWQ: folds 
Qduu7ikeizo6q6Ei9YvcJA: folds 
Uncalled bet ($1.50) returned to OlPJsgR4xypSg/w1z7Gyvw
OlPJsgR4xypSg/w1z7Gyvw collected $2.95 from pot
OlPJsgR4xypSg/w1z7Gyvw: doesn't show hand 
*** SUMMARY ***
Total pot $3.10 | Rake $0.15 
Board [7d 2c Th 5h]
Seat 1: ipgcO7Pa6LC8XWpVttZfnA folded before Flop (didn't bet)
Seat 2: dfNim92Z6XK1/h5SFW5vDg folded before Flop (didn't bet)
Seat 4: Qduu7ikeizo6q6Ei9YvcJA folded on the Turn
Seat 5: OlPJsgR4xypSg/w1z7Gyvw (button) collected ($2.95)
Seat 6: oLa/tXLfSLLB28mcLGrxcg (small blind) folded before Flop
Seat 7: +WTkVY3GeLxqGQBbMZQiWQ (big blind) folded on the Turn
Seat 8: PskTLlFIRHSp61inskRzVg folded before Flop (didn't bet)
Seat 9: zgi+EUykT/pZQpoUG6+oEg folded before Flop (didn't bet)




PokerStars Game #59941804164:  Hold'em No Limit ($0.10/$0.25) - 2009/07/01 1:46:40 ET
Table 'T/iCKJXGphRN3xcdwfE/JQ' 6-max Seat #3 is the button
Seat 1: wAKC8C/zN0c8V5v13dm9mA ($25.35 in chips) 
Seat 2: EeUZtMU058v2ObUACOF4Og ($32 in chips) 
Seat 3: IWAjoCPXtc1XUaZdp+pCpA ($22.85 in chips) 
Seat 5: gaPMxLGp9SOj4Lq6t+/0Ig ($7.85 in chips) 
Seat 6: Ey4Kn6PlnYb2srYYBJHvzg ($14.05 in chips) 
m2yWOKfAxqHoy5DDN87Ttw will be allowed to play after the button
gaPMxLGp9SOj4Lq6t+/0Ig: posts small blind $0.10
Ey4Kn6PlnYb2srYYBJHvzg: posts big blind $0.25
*** HOLE CARDS ***
wAKC8C/zN0c8V5v13dm9mA: folds 
EeUZtMU058v2ObUACOF4Og: folds 
IWAjoCPXtc1XUaZdp+pCpA: raises $0.50 to $0.75
gaPMxLGp9SOj4Lq6t+/0Ig: raises $7.10 to $7.85 and is all-in
Ey4Kn6PlnYb2srYYBJHvzg: folds 
IWAjoCPXtc1XUaZdp+pCpA: folds 
Uncalled bet ($7.10) returned to gaPMxLGp9SOj4Lq6t+/0Ig
gaPMxLGp9SOj4Lq6t+/0Ig collected $1.75 from pot
gaPMxLGp9SOj4Lq6t+/0Ig: doesn't show hand 
*** SUMMARY ***
Total pot $1.75 | Rake $0 
Seat 1: wAKC8C/zN0c8V5v13dm9mA folded before Flop (didn't bet)
Seat 2: EeUZtMU058v2ObUACOF4Og folded before Flop (didn't bet)
Seat 3: IWAjoCPXtc1XUaZdp+pCpA (button) folded before Flop
Seat 5: gaPMxLGp9SOj4Lq6t+/0Ig (small blind) collected ($1.75)
Seat 6: Ey4Kn6PlnYb2srYYBJHvzg (big blind) folded before Flop




PokerStars Game #59941803950:  Hold'em No Limit ($0.10/$0.25) - 2009/07/01 1:46:40 ET
Table 'luMgmRPIo47e7iXDlheIwA' 6-max Seat #6 is the button
Seat 1: EQ3WxdGe/KZrM6Lx4T02sg ($38.70 in chips) 
Seat 2: NhUN/JpAprdJeamFBgJH1w ($25 in chips) 
Seat 4: xrf8tAXKQHG99HixCot1Iw ($26.25 in chips) 
Seat 5: cWc85bEzdRzpUMhRKm8pwQ ($43.65 in chips) 
Seat 6: qGHGf/553gQnDoklMRe3tg ($24.55 in chips) 
EQ3WxdGe/KZrM6Lx4T02sg: posts small blind $0.10
NhUN/JpAprdJeamFBgJH1w: posts big blind $0.25
w43JQj2oYPpKQVG4Yzlq1w: sits out 
*** HOLE CARDS ***
xrf8tAXKQHG99HixCot1Iw: folds 
cWc85bEzdRzpUMhRKm8pwQ: raises $0.75 to $1
qGHGf/553gQnDoklMRe3tg: folds 
EQ3WxdGe/KZrM6Lx4T02sg: calls $0.90
NhUN/JpAprdJeamFBgJH1w: folds 
*** FLOP *** [7c 4c Qd]
EQ3WxdGe/KZrM6Lx4T02sg: checks 
cWc85bEzdRzpUMhRKm8pwQ: checks 
*** TURN *** [7c 4c Qd] [9h]
EQ3WxdGe/KZrM6Lx4T02sg: bets $0.25
cWc85bEzdRzpUMhRKm8pwQ: calls $0.25
*** RIVER *** [7c 4c Qd 9h] [4s]
EQ3WxdGe/KZrM6Lx4T02sg: bets $0.25
cWc85bEzdRzpUMhRKm8pwQ: calls $0.25
*** SHOW DOWN ***
EQ3WxdGe/KZrM6Lx4T02sg: shows [Ah 5d] (a pair of Fours)
cWc85bEzdRzpUMhRKm8pwQ: shows [Jc Ad] (a pair of Fours - Ace+Queen+Jack kicker)
cWc85bEzdRzpUMhRKm8pwQ collected $3.10 from pot
*** SUMMARY ***
Total pot $3.25 | Rake $0.15 
Board [7c 4c Qd 9h 4s]
Seat 1: EQ3WxdGe/KZrM6Lx4T02sg (small blind) showed [Ah 5d] and lost with a pair of Fours
Seat 2: NhUN/JpAprdJeamFBgJH1w (big blind) folded before Flop
Seat 4: xrf8tAXKQHG99HixCot1Iw folded before Flop (didn't bet)
Seat 5: cWc85bEzdRzpUMhRKm8pwQ showed [Jc Ad] and won ($3.10) with a pair of Fours
Seat 6: qGHGf/553gQnDoklMRe3tg (button) folded before Flop (didn't bet)




PokerStars Game #59941804044:  Hold'em No Limit ($0.10/$0.25) - 2009/07/01 1:46:40 ET
Table 'hfHe8uKeSJMyWAjSdM7ROQ' 6-max Seat #3 is the button
Seat 1: eHsmIvAb2JREg4O6hNPnXg ($40.70 in chips) 
Seat 2: QvTX2yGq3uKJiKPmns4TKQ ($29.55 in chips) 
Seat 3: oAzQdB2jFOH1NxFUPjYUGg ($26.25 in chips) 
Seat 4: b4wRQV3APH8irVk6bUFe2Q ($26.35 in chips) 
Seat 5: euswrBD1XG0Q5hB1iGJBKQ ($61.55 in chips) 
b4wRQV3APH8irVk6bUFe2Q: posts small blind $0.10
euswrBD1XG0Q5hB1iGJBKQ: posts big blind $0.25
eL3+wCBjFGfQ5FMdIZihwA: sits out 
*** HOLE CARDS ***
eHsmIvAb2JREg4O6hNPnXg: raises $0.50 to $0.75
QvTX2yGq3uKJiKPmns4TKQ: folds 
oAzQdB2jFOH1NxFUPjYUGg: calls $0.75
b4wRQV3APH8irVk6bUFe2Q: folds 
euswrBD1XG0Q5hB1iGJBKQ: folds 
*** FLOP *** [9s Js 3c]
eHsmIvAb2JREg4O6hNPnXg: bets $0.75
oAzQdB2jFOH1NxFUPjYUGg: raises $1.25 to $2
eHsmIvAb2JREg4O6hNPnXg: calls $1.25
*** TURN *** [9s Js 3c] [6s]
eHsmIvAb2JREg4O6hNPnXg: checks 
oAzQdB2jFOH1NxFUPjYUGg: bets $1.50
eHsmIvAb2JREg4O6hNPnXg: calls $1.50
*** RIVER *** [9s Js 3c 6s] [Jd]
eHsmIvAb2JREg4O6hNPnXg: checks 
oAzQdB2jFOH1NxFUPjYUGg: checks 
*** SHOW DOWN ***
eHsmIvAb2JREg4O6hNPnXg: shows [Th Ts] (two pair, Jacks and Tens)
oAzQdB2jFOH1NxFUPjYUGg: mucks hand 
eHsmIvAb2JREg4O6hNPnXg collected $8.45 from pot
*** SUMMARY ***
Total pot $8.85 | Rake $0.40 
Board [9s Js 3c 6s Jd]
Seat 1: eHsmIvAb2JREg4O6hNPnXg showed [Th Ts] and won ($8.45) with two pair, Jacks and Tens
Seat 2: QvTX2yGq3uKJiKPmns4TKQ folded before Flop (didn't bet)
Seat 3: oAzQdB2jFOH1NxFUPjYUGg (button) mucked
Seat 4: b4wRQV3APH8irVk6bUFe2Q (small blind) folded before Flop
Seat 5: euswrBD1XG0Q5hB1iGJBKQ (big blind) folded before Flop




PokerStars Game #59941804108:  Hold'em No Limit ($0.10/$0.25) - 2009/07/01 1:46:40 ET
Table 'qryc9C/ELyQ3lubOaELNAQ' 6-max Seat #3 is the button
Seat 1: OZc6kkoTwtITj1ZfreJK1A ($65.85 in chips) 
Seat 2: LtASJ9OlkqGrrUKGQlpGAw ($29.95 in chips) 
Seat 3: wvIIdlbCgePONQwXjx9xzQ ($4.20 in chips) 
Seat 4: v+QfkGiuj9bgtuNoVnDO8w ($25 in chips) 
Seat 5: 9StOHp+Y1T0K13JdgS2oQQ ($37.40 in chips) 
xmdItDBraeGrrs3wzz1J3w joins the table at seat #6 
v+QfkGiuj9bgtuNoVnDO8w: posts small blind $0.10
9StOHp+Y1T0K13JdgS2oQQ: posts big blind $0.25
*** HOLE CARDS ***
OZc6kkoTwtITj1ZfreJK1A: folds 
LtASJ9OlkqGrrUKGQlpGAw: raises $0.50 to $0.75
wvIIdlbCgePONQwXjx9xzQ: folds 
v+QfkGiuj9bgtuNoVnDO8w: folds 
9StOHp+Y1T0K13JdgS2oQQ: folds 
Uncalled bet ($0.50) returned to LtASJ9OlkqGrrUKGQlpGAw
LtASJ9OlkqGrrUKGQlpGAw collected $0.60 from pot
LtASJ9OlkqGrrUKGQlpGAw: doesn't show hand 
*** SUMMARY ***
Total pot $0.60 | Rake $0 
Seat 1: OZc6kkoTwtITj1ZfreJK1A folded before Flop (didn't bet)
Seat 2: LtASJ9OlkqGrrUKGQlpGAw collected ($0.60)
Seat 3: wvIIdlbCgePONQwXjx9xzQ (button) folded before Flop (didn't bet)
Seat 4: v+QfkGiuj9bgtuNoVnDO8w (small blind) folded before Flop
Seat 5: 9StOHp+Y1T0K13JdgS2oQQ (big blind) folded before Flop




PokerStars Game #59941804194:  Hold'em No Limit ($0.10/$0.25) - 2009/07/01 1:46:40 ET
Table 'C47I7CmrmFr8Oo7wOovVwQ' 6-max Seat #3 is the button
Seat 1: v6mkGzCBCCXcgWQNSYVtKg ($11.80 in chips) 
Seat 3: H+8eOP3XJHXjACRDTiIHTQ ($17.20 in chips) 
Seat 4: yY5JuFtDfXWRaZlVby4LLw ($8.40 in chips) 
Seat 5: or309yYY9Y9bfFWtrB0yUg ($12.60 in chips) 
Seat 6: pD7ri5wL3vsa6S1ulMYQmQ ($24.50 in chips) 
yY5JuFtDfXWRaZlVby4LLw: posts small blind $0.10
or309yYY9Y9bfFWtrB0yUg: posts big blind $0.25
*** HOLE CARDS ***
hOaWAImn5/MZDAWAPlYHCw leaves the table
pD7ri5wL3vsa6S1ulMYQmQ: folds 
v6mkGzCBCCXcgWQNSYVtKg: folds 
H+8eOP3XJHXjACRDTiIHTQ: calls $0.25
yY5JuFtDfXWRaZlVby4LLw: calls $0.15
8JTm/CXBn3+kuQgcUOgPkw joins the table at seat #2 
or309yYY9Y9bfFWtrB0yUg: checks 
*** FLOP *** [6d Qc Jh]
yY5JuFtDfXWRaZlVby4LLw: checks 
or309yYY9Y9bfFWtrB0yUg: checks 
H+8eOP3XJHXjACRDTiIHTQ: bets $0.25
yY5JuFtDfXWRaZlVby4LLw: calls $0.25
or309yYY9Y9bfFWtrB0yUg: raises $0.50 to $0.75
H+8eOP3XJHXjACRDTiIHTQ: calls $0.50
yY5JuFtDfXWRaZlVby4LLw: folds 
*** TURN *** [6d Qc Jh] [2h]
or309yYY9Y9bfFWtrB0yUg: checks 
H+8eOP3XJHXjACRDTiIHTQ: checks 
*** RIVER *** [6d Qc Jh 2h] [5c]
or309yYY9Y9bfFWtrB0yUg: checks 
H+8eOP3XJHXjACRDTiIHTQ: bets $3.50
or309yYY9Y9bfFWtrB0yUg: calls $3.50
*** SHOW DOWN ***
H+8eOP3XJHXjACRDTiIHTQ: shows [5s Jc] (two pair, Jacks and Fives)
or309yYY9Y9bfFWtrB0yUg: mucks hand 
H+8eOP3XJHXjACRDTiIHTQ collected $9.05 from pot
*** SUMMARY ***
Total pot $9.50 | Rake $0.45 
Board [6d Qc Jh 2h 5c]
Seat 1: v6mkGzCBCCXcgWQNSYVtKg folded before Flop (didn't bet)
Seat 3: H+8eOP3XJHXjACRDTiIHTQ (button) showed [5s Jc] and won ($9.05) with two pair, Jacks and Fives
Seat 4: yY5JuFtDfXWRaZlVby4LLw (small blind) folded on the Flop
Seat 5: or309yYY9Y9bfFWtrB0yUg (big blind) mucked
Seat 6: pD7ri5wL3vsa6S1ulMYQmQ folded before Flop (didn't bet)




PokerStars Game #59941804078:  Hold'em No Limit ($0.10/$0.25) - 2009/07/01 1:46:40 ET
Table 'APEHQjIcZHDZUA4iOjju2g' 6-max Seat #6 is the button
Seat 1: DE9hRlt14g+JdsRQ4wT7hg ($25 in chips) 
Seat 2: 3zD3qLXT1bEffAoWGnc7wg ($35.50 in chips) 
Seat 3: 3e/idKqDuPE10t6Zvr//SQ ($24.05 in chips) 
Seat 4: w2mQ4VsGljGwWXydz8tw2A ($35.85 in chips) 
Seat 5: /xN6gc9+8Hew0HxaB6VIVg ($46 in chips) 
Seat 6: KXtdqb+rIMkjc0RvHDksGQ ($27.10 in chips) 
DE9hRlt14g+JdsRQ4wT7hg: posts small blind $0.10
3zD3qLXT1bEffAoWGnc7wg: posts big blind $0.25
*** HOLE CARDS ***
3e/idKqDuPE10t6Zvr//SQ: folds 
w2mQ4VsGljGwWXydz8tw2A: folds 
/xN6gc9+8Hew0HxaB6VIVg: folds 
KXtdqb+rIMkjc0RvHDksGQ: raises $0.50 to $0.75
DE9hRlt14g+JdsRQ4wT7hg: calls $0.65
3zD3qLXT1bEffAoWGnc7wg: folds 
*** FLOP *** [Jh 5d 6d]
DE9hRlt14g+JdsRQ4wT7hg: checks 
KXtdqb+rIMkjc0RvHDksGQ: bets $1
DE9hRlt14g+JdsRQ4wT7hg: raises $2.25 to $3.25
KXtdqb+rIMkjc0RvHDksGQ: calls $2.25
*** TURN *** [Jh 5d 6d] [2s]
DE9hRlt14g+JdsRQ4wT7hg: bets $4.75
KXtdqb+rIMkjc0RvHDksGQ: calls $4.75
*** RIVER *** [Jh 5d 6d 2s] [5s]
DE9hRlt14g+JdsRQ4wT7hg: checks 
KXtdqb+rIMkjc0RvHDksGQ: checks 
*** SHOW DOWN ***
DE9hRlt14g+JdsRQ4wT7hg: shows [4d 4c] (two pair, Fives and Fours)
KXtdqb+rIMkjc0RvHDksGQ: shows [Jd Ks] (two pair, Jacks and Fives)
KXtdqb+rIMkjc0RvHDksGQ collected $16.90 from pot
*** SUMMARY ***
Total pot $17.75 | Rake $0.85 
Board [Jh 5d 6d 2s 5s]
Seat 1: DE9hRlt14g+JdsRQ4wT7hg (small blind) showed [4d 4c] and lost with two pair, Fives and Fours
Seat 2: 3zD3qLXT1bEffAoWGnc7wg (big blind) folded before Flop
Seat 3: 3e/idKqDuPE10t6Zvr//SQ folded before Flop (didn't bet)
Seat 4: w2mQ4VsGljGwWXydz8tw2A folded before Flop (didn't bet)
Seat 5: /xN6gc9+8Hew0HxaB6VIVg folded before Flop (didn't bet)
Seat 6: KXtdqb+rIMkjc0RvHDksGQ (button) showed [Jd Ks] and won ($16.90) with two pair, Jacks and Fives




PokerStars Game #59941804788:  Hold'em No Limit ($0.10/$0.25) - 2009/07/01 1:46:41 ET
Table '2AUmC2Rslg+QUbLfdgNdfg' 6-max Seat #1 is the button
Seat 1: YDXAegrCnzc0l6TSDNboXQ ($23.75 in chips) 
Seat 2: PLksyNlTVRVZwxJVC2/1eA ($22.25 in chips) 
Seat 3: JFIAqU8lCZ0vWwEl4bdGsg ($25.70 in chips) 
Seat 4: lquriepNQBhDV5P1SWHhnA ($26.25 in chips) 
Seat 5: AMc4cCwUJhokdGRYIaVPhQ ($25.10 in chips) 
Seat 6: xBWc54v+UTSJOiKpbAbJWg ($10.80 in chips) 
PLksyNlTVRVZwxJVC2/1eA: posts small blind $0.10
JFIAqU8lCZ0vWwEl4bdGsg: posts big blind $0.25
*** HOLE CARDS ***
lquriepNQBhDV5P1SWHhnA: folds 
AMc4cCwUJhokdGRYIaVPhQ: raises $0.25 to $0.50
xBWc54v+UTSJOiKpbAbJWg: folds 
YDXAegrCnzc0l6TSDNboXQ: folds 
PLksyNlTVRVZwxJVC2/1eA: raises $1.50 to $2
JFIAqU8lCZ0vWwEl4bdGsg: folds 
AMc4cCwUJhokdGRYIaVPhQ: calls $1.50
*** FLOP *** [4h Jh 7h]
PLksyNlTVRVZwxJVC2/1eA: bets $3
AMc4cCwUJhokdGRYIaVPhQ: raises $3 to $6
PLksyNlTVRVZwxJVC2/1eA: calls $3
*** TURN *** [4h Jh 7h] [Kc]
PLksyNlTVRVZwxJVC2/1eA: checks 
AMc4cCwUJhokdGRYIaVPhQ: bets $4.50
PLksyNlTVRVZwxJVC2/1eA: calls $4.50
*** RIVER *** [4h Jh 7h Kc] [5s]
PLksyNlTVRVZwxJVC2/1eA: checks 
AMc4cCwUJhokdGRYIaVPhQ: bets $5.75
PLksyNlTVRVZwxJVC2/1eA: folds 
Uncalled bet ($5.75) returned to AMc4cCwUJhokdGRYIaVPhQ
AMc4cCwUJhokdGRYIaVPhQ collected $24.05 from pot
AMc4cCwUJhokdGRYIaVPhQ: doesn't show hand 
*** SUMMARY ***
Total pot $25.25 | Rake $1.20 
Board [4h Jh 7h Kc 5s]
Seat 1: YDXAegrCnzc0l6TSDNboXQ (button) folded before Flop (didn't bet)
Seat 2: PLksyNlTVRVZwxJVC2/1eA (small blind) folded on the River
Seat 3: JFIAqU8lCZ0vWwEl4bdGsg (big blind) folded before Flop
Seat 4: lquriepNQBhDV5P1SWHhnA folded before Flop (didn't bet)
Seat 5: AMc4cCwUJhokdGRYIaVPhQ collected ($24.05)
Seat 6: xBWc54v+UTSJOiKpbAbJWg folded before Flop (didn't bet)




PokerStars Game #59941804360:  Hold'em No Limit ($0.10/$0.25) - 2009/07/01 1:46:41 ET
Table '60nA7av6bws9VnNmVwculA' 6-max Seat #1 is the button
Seat 1: if4dh6jhJXeN3/qd3qCp9g ($24.65 in chips) 
Seat 2: Bada343Si4xKu3fNXY99AA ($3.60 in chips) 
Seat 3: mnuJq+Q1IXKm/pCy+OzxmQ ($20.35 in chips) 
Seat 4: +baiVgI/ETnBARLe5mARCw ($18.85 in chips) 
Seat 5: zXh+lOT41Q2iWgCNj+OcRw ($12.35 in chips) 
Seat 6: mfrkWA3PTeYPkbO6hi98Aw ($24.75 in chips) 
Bada343Si4xKu3fNXY99AA: posts small blind $0.10
mnuJq+Q1IXKm/pCy+OzxmQ: posts big blind $0.25
*** HOLE CARDS ***
+baiVgI/ETnBARLe5mARCw: calls $0.25
zXh+lOT41Q2iWgCNj+OcRw: folds 
mfrkWA3PTeYPkbO6hi98Aw: folds 
if4dh6jhJXeN3/qd3qCp9g: folds 
Bada343Si4xKu3fNXY99AA: folds 
mnuJq+Q1IXKm/pCy+OzxmQ: checks 
*** FLOP *** [Jd 8h Kd]
mnuJq+Q1IXKm/pCy+OzxmQ: checks 
+baiVgI/ETnBARLe5mARCw: checks 
*** TURN *** [Jd 8h Kd] [3c]
mnuJq+Q1IXKm/pCy+OzxmQ: checks 
+baiVgI/ETnBARLe5mARCw: checks 
*** RIVER *** [Jd 8h Kd 3c] [5s]
mnuJq+Q1IXKm/pCy+OzxmQ: checks 
+baiVgI/ETnBARLe5mARCw: checks 
*** SHOW DOWN ***
mnuJq+Q1IXKm/pCy+OzxmQ: shows [As 6d] (high card Ace)
+baiVgI/ETnBARLe5mARCw: mucks hand 
mnuJq+Q1IXKm/pCy+OzxmQ collected $0.60 from pot
*** SUMMARY ***
Total pot $0.60 | Rake $0 
Board [Jd 8h Kd 3c 5s]
Seat 1: if4dh6jhJXeN3/qd3qCp9g (button) folded before Flop (didn't bet)
Seat 2: Bada343Si4xKu3fNXY99AA (small blind) folded before Flop
Seat 3: mnuJq+Q1IXKm/pCy+OzxmQ (big blind) showed [As 6d] and won ($0.60) with high card Ace
Seat 4: +baiVgI/ETnBARLe5mARCw mucked
Seat 5: zXh+lOT41Q2iWgCNj+OcRw folded before Flop (didn't bet)
Seat 6: mfrkWA3PTeYPkbO6hi98Aw folded before Flop (didn't bet)




PokerStars Game #59941804554:  Hold'em No Limit ($0.10/$0.25) - 2009/07/01 1:46:41 ET
Table '3LMlz3V4AziGlU+ikmyU8w' 6-max Seat #4 is the button
Seat 1: Wxq4Qyj0DnDXj2+taEOJFQ ($55.50 in chips) 
Seat 2: uR3AbFJLoOX86DOTtTgGcg ($23.15 in chips) 
Seat 3: Hzy03WtPHMYwLYM7hTTxQw ($25 in chips) 
Seat 4: 6DwBRH+xZ12AAZmeAg+aXw ($23.30 in chips) 
Seat 5: tOAk1Og4mVObMBOfvdDYOw ($25 in chips) 
Seat 6: 7LpHJVeM6k1mQdC6HXYzww ($25 in chips) 
tOAk1Og4mVObMBOfvdDYOw: posts small blind $0.10
7LpHJVeM6k1mQdC6HXYzww: posts big blind $0.25
*** HOLE CARDS ***
Wxq4Qyj0DnDXj2+taEOJFQ: folds 
uR3AbFJLoOX86DOTtTgGcg: calls $0.25
Hzy03WtPHMYwLYM7hTTxQw: folds 
6DwBRH+xZ12AAZmeAg+aXw: folds 
tOAk1Og4mVObMBOfvdDYOw: calls $0.15
7LpHJVeM6k1mQdC6HXYzww: checks 
*** FLOP *** [9h 2h Td]
tOAk1Og4mVObMBOfvdDYOw: checks 
7LpHJVeM6k1mQdC6HXYzww: checks 
uR3AbFJLoOX86DOTtTgGcg: checks 
*** TURN *** [9h 2h Td] [4s]
tOAk1Og4mVObMBOfvdDYOw: checks 
7LpHJVeM6k1mQdC6HXYzww: checks 
uR3AbFJLoOX86DOTtTgGcg: checks 
*** RIVER *** [9h 2h Td 4s] [Tc]
tOAk1Og4mVObMBOfvdDYOw: checks 
7LpHJVeM6k1mQdC6HXYzww: checks 
uR3AbFJLoOX86DOTtTgGcg: checks 
*** SHOW DOWN ***
tOAk1Og4mVObMBOfvdDYOw: shows [4c Kc] (two pair, Tens and Fours)
7LpHJVeM6k1mQdC6HXYzww: mucks hand 
uR3AbFJLoOX86DOTtTgGcg: mucks hand 
tOAk1Og4mVObMBOfvdDYOw collected $0.75 from pot
*** SUMMARY ***
Total pot $0.75 | Rake $0 
Board [9h 2h Td 4s Tc]
Seat 1: Wxq4Qyj0DnDXj2+taEOJFQ folded before Flop (didn't bet)
Seat 2: uR3AbFJLoOX86DOTtTgGcg mucked
Seat 3: Hzy03WtPHMYwLYM7hTTxQw folded before Flop (didn't bet)
Seat 4: 6DwBRH+xZ12AAZmeAg+aXw (button) folded before Flop (didn't bet)
Seat 5: tOAk1Og4mVObMBOfvdDYOw (small blind) showed [4c Kc] and won ($0.75) with two pair, Tens and Fours
Seat 6: 7LpHJVeM6k1mQdC6HXYzww (big blind) mucked




PokerStars Game #59941804666:  Hold'em No Limit ($0.10/$0.25) - 2009/07/01 1:46:41 ET
Table 'JPFXJXa5xBkjZ/W15BKqeQ' 9-max Seat #5 is the button
Seat 1: mNQH7Afv3tbDKl2tAb9BOg ($19.60 in chips) 
Seat 2: XMSS6mD5B42I8wasdOMipQ ($13.10 in chips) 
Seat 3: 56S3mA6Zs3pGR+0p0vUCtg ($19.20 in chips) 
Seat 4: wGigCmBR/9XWkPpvYos3aQ ($26.40 in chips) 
Seat 5: cZ99hugmLBj9KhTlc8nCSw ($25.25 in chips) 
Seat 6: tLcDklc2rBORNfixyRfVfw ($25.10 in chips) 
Seat 7: PdIasPkzm2sqZnN41ZRXOg ($5 in chips) 
tLcDklc2rBORNfixyRfVfw: posts small blind $0.10
PdIasPkzm2sqZnN41ZRXOg: posts big blind $0.25
V6p0jQ/RhUsqpHLmXvEX4Q: sits out 
*** HOLE CARDS ***
mNQH7Afv3tbDKl2tAb9BOg: folds 
XMSS6mD5B42I8wasdOMipQ: folds 
56S3mA6Zs3pGR+0p0vUCtg: folds 
wGigCmBR/9XWkPpvYos3aQ: folds 
cZ99hugmLBj9KhTlc8nCSw: raises $0.50 to $0.75
tLcDklc2rBORNfixyRfVfw: folds 
PdIasPkzm2sqZnN41ZRXOg: folds 
Uncalled bet ($0.50) returned to cZ99hugmLBj9KhTlc8nCSw
cZ99hugmLBj9KhTlc8nCSw collected $0.60 from pot
cZ99hugmLBj9KhTlc8nCSw: doesn't show hand 
*** SUMMARY ***
Total pot $0.60 | Rake $0 
Seat 1: mNQH7Afv3tbDKl2tAb9BOg folded before Flop (didn't bet)
Seat 2: XMSS6mD5B42I8wasdOMipQ folded before Flop (didn't bet)
Seat 3: 56S3mA6Zs3pGR+0p0vUCtg folded before Flop (didn't bet)
Seat 4: wGigCmBR/9XWkPpvYos3aQ folded before Flop (didn't bet)
Seat 5: cZ99hugmLBj9KhTlc8nCSw (button) collected ($0.60)
Seat 6: tLcDklc2rBORNfixyRfVfw (small blind) folded before Flop
Seat 7: PdIasPkzm2sqZnN41ZRXOg (big blind) folded before Flop




PokerStars Game #59941804306:  Hold'em No Limit ($0.10/$0.25) - 2009/07/01 1:46:41 ET
Table 'jxoHy9yJy0bbH/Qx73FoPA' 9-max Seat #8 is the button
Seat 1: j4q3p0lesp63b1gZDwLBZw ($6.60 in chips) 
Seat 2: F7pnn6czNpHvRM55XcA2EA ($45.50 in chips) 
Seat 3: CVqCt93Mk0MhKMaZ4LZDSQ ($9.30 in chips) 
Seat 5: rzZ3wFcwoPyKlQ0mB5JLRQ ($7.75 in chips) 
Seat 6: tYsOBqdU1+x+yFI7zHO7hQ ($62.55 in chips) 
Seat 7: wGigCmBR/9XWkPpvYos3aQ ($26.05 in chips) 
Seat 8: Z9W7+g1WMhhZDi7DwGbCFA ($5 in chips) 
Seat 9: CvL9Ch1HYCVbTsfpNucitg ($4.65 in chips) 
CvL9Ch1HYCVbTsfpNucitg: posts small blind $0.10
j4q3p0lesp63b1gZDwLBZw: posts big blind $0.25
bXpVeaSTPBFSPJmeXxO7nw: sits out 
*** HOLE CARDS ***
F7pnn6czNpHvRM55XcA2EA: folds 
CVqCt93Mk0MhKMaZ4LZDSQ: folds 
rzZ3wFcwoPyKlQ0mB5JLRQ: folds 
tYsOBqdU1+x+yFI7zHO7hQ: folds 
wGigCmBR/9XWkPpvYos3aQ: raises $0.65 to $0.90
Z9W7+g1WMhhZDi7DwGbCFA: folds 
CvL9Ch1HYCVbTsfpNucitg: folds 
j4q3p0lesp63b1gZDwLBZw: folds 
Uncalled bet ($0.65) returned to wGigCmBR/9XWkPpvYos3aQ
wGigCmBR/9XWkPpvYos3aQ collected $0.60 from pot
wGigCmBR/9XWkPpvYos3aQ: doesn't show hand 
*** SUMMARY ***
Total pot $0.60 | Rake $0 
Seat 1: j4q3p0lesp63b1gZDwLBZw (big blind) folded before Flop
Seat 2: F7pnn6czNpHvRM55XcA2EA folded before Flop (didn't bet)
Seat 3: CVqCt93Mk0MhKMaZ4LZDSQ folded before Flop (didn't bet)
Seat 5: rzZ3wFcwoPyKlQ0mB5JLRQ folded before Flop (didn't bet)
Seat 6: tYsOBqdU1+x+yFI7zHO7hQ folded before Flop (didn't bet)
Seat 7: wGigCmBR/9XWkPpvYos3aQ collected ($0.60)
Seat 8: Z9W7+g1WMhhZDi7DwGbCFA (button) folded before Flop (didn't bet)
Seat 9: CvL9Ch1HYCVbTsfpNucitg (small blind) folded before Flop




PokerStars Game #59941804310:  Hold'em No Limit ($0.10/$0.25) - 2009/07/01 1:46:41 ET
Table 'oJpFwZj9+FUGHX90Un8s9Q' 6-max Seat #3 is the button
Seat 1: 6DwBRH+xZ12AAZmeAg+aXw ($23.55 in chips) 
Seat 2: NtrVQ9UIql0rDCnKDKZ5FQ ($15.70 in chips) 
Seat 3: kyRaCIljYA6l33lSKQfNsg ($25.90 in chips) 
Seat 4: 6elpmfyt4Zw0yvd8lePSMQ ($21.65 in chips) 
Seat 5: kG34n23qFQA3nzdOJTQ1dA ($55.80 in chips) 
6elpmfyt4Zw0yvd8lePSMQ: posts small blind $0.10
kG34n23qFQA3nzdOJTQ1dA: posts big blind $0.25
7LpHJVeM6k1mQdC6HXYzww: sits out 
*** HOLE CARDS ***
6DwBRH+xZ12AAZmeAg+aXw: raises $0.50 to $0.75
NtrVQ9UIql0rDCnKDKZ5FQ: folds 
kyRaCIljYA6l33lSKQfNsg: folds 
6elpmfyt4Zw0yvd8lePSMQ: folds 
kG34n23qFQA3nzdOJTQ1dA: folds 
Uncalled bet ($0.50) returned to 6DwBRH+xZ12AAZmeAg+aXw
6DwBRH+xZ12AAZmeAg+aXw collected $0.60 from pot
6DwBRH+xZ12AAZmeAg+aXw: doesn't show hand 
*** SUMMARY ***
Total pot $0.60 | Rake $0 
Seat 1: 6DwBRH+xZ12AAZmeAg+aXw collected ($0.60)
Seat 2: NtrVQ9UIql0rDCnKDKZ5FQ folded before Flop (didn't bet)
Seat 3: kyRaCIljYA6l33lSKQfNsg (button) folded before Flop (didn't bet)
Seat 4: 6elpmfyt4Zw0yvd8lePSMQ (small blind) folded before Flop
Seat 5: kG34n23qFQA3nzdOJTQ1dA (big blind) folded before Flop




PokerStars Game #59941804516:  Hold'em No Limit ($0.10/$0.25) - 2009/07/01 1:46:41 ET
Table 'h02LhQ7B/Zk4ETRxxHhGYA' 9-max Seat #1 is the button
Seat 1: sD+TKtt36XiiN6jqHiLwDA ($21.75 in chips) 
Seat 2: 9lvO/qyU+xrU95Teu1fv0g ($6.05 in chips) 
Seat 3: arxNSjreDRGFg13EAM2F1w ($30.90 in chips) 
Seat 4: tYsOBqdU1+x+yFI7zHO7hQ ($38.10 in chips) 
Seat 5: cUxk0Jk4lrUQv9CJl0LPlg ($28 in chips) 
Seat 6: UvM6sxFT7el5hVDehvWvTA ($31.20 in chips) 
Seat 7: y7w8+Oqq4SkI1dkRDCx2Zg ($3.50 in chips) 
Seat 8: mUoFJKqCzIUABvOFbiINlQ ($14.50 in chips) 
Seat 9: HcU1ud5gMXGuhN1QChAhfQ ($25 in chips) 
9lvO/qyU+xrU95Teu1fv0g: posts small blind $0.10
arxNSjreDRGFg13EAM2F1w: posts big blind $0.25
HcU1ud5gMXGuhN1QChAhfQ: posts big blind $0.25
*** HOLE CARDS ***
tYsOBqdU1+x+yFI7zHO7hQ: folds 
cUxk0Jk4lrUQv9CJl0LPlg: calls $0.25
UvM6sxFT7el5hVDehvWvTA: folds 
y7w8+Oqq4SkI1dkRDCx2Zg: folds 
mUoFJKqCzIUABvOFbiINlQ: calls $0.25
HcU1ud5gMXGuhN1QChAhfQ: checks 
sD+TKtt36XiiN6jqHiLwDA: folds 
9lvO/qyU+xrU95Teu1fv0g: raises $1.25 to $1.50
arxNSjreDRGFg13EAM2F1w: folds 
cUxk0Jk4lrUQv9CJl0LPlg: folds 
mUoFJKqCzIUABvOFbiINlQ: folds 
HcU1ud5gMXGuhN1QChAhfQ: folds 
Uncalled bet ($1.25) returned to 9lvO/qyU+xrU95Teu1fv0g
9lvO/qyU+xrU95Teu1fv0g collected $1.25 from pot
9lvO/qyU+xrU95Teu1fv0g: shows [Kh Ah] (high card Ace)
*** SUMMARY ***
Total pot $1.25 | Rake $0 
Seat 1: sD+TKtt36XiiN6jqHiLwDA (button) folded before Flop (didn't bet)
Seat 2: 9lvO/qyU+xrU95Teu1fv0g (small blind) collected ($1.25)
Seat 3: arxNSjreDRGFg13EAM2F1w (big blind) folded before Flop
Seat 4: tYsOBqdU1+x+yFI7zHO7hQ folded before Flop (didn't bet)
Seat 5: cUxk0Jk4lrUQv9CJl0LPlg folded before Flop
Seat 6: UvM6sxFT7el5hVDehvWvTA folded before Flop (didn't bet)
Seat 7: y7w8+Oqq4SkI1dkRDCx2Zg folded before Flop (didn't bet)
Seat 8: mUoFJKqCzIUABvOFbiINlQ folded before Flop
Seat 9: HcU1ud5gMXGuhN1QChAhfQ folded before Flop




PokerStars Game #59941804508:  Hold'em No Limit ($0.10/$0.25) - 2009/07/01 1:46:41 ET
Table 'axb9RsG8Zj1A0LEukTeFrQ' 9-max Seat #5 is the button
Seat 1: qwr38jl5txoR36M7G5qi4A ($8.50 in chips) 
Seat 2: zDrucyjVn5aeekNEc3cJrA ($21.40 in chips) 
Seat 3: H5Se03ZqSX7tbULXur2MAg ($23.35 in chips) 
Seat 4: tLcDklc2rBORNfixyRfVfw ($27.10 in chips) 
Seat 5: rLSSHKOHnb6yzVfDoQM/RA ($14.10 in chips) 
Seat 6: Iu9xjReQYvxYiqQm8n6MXQ ($4.35 in chips) 
Seat 7: PdIasPkzm2sqZnN41ZRXOg ($5 in chips) 
Seat 8: VBHxUExRAMrbxUq/cVx9Gw ($5 in chips) 
Seat 9: qbQE8CifKB4+OEvNF/61Rw ($58.20 in chips) 
Iu9xjReQYvxYiqQm8n6MXQ: posts small blind $0.10
PdIasPkzm2sqZnN41ZRXOg: posts big blind $0.25
*** HOLE CARDS ***
VBHxUExRAMrbxUq/cVx9Gw: folds 
qbQE8CifKB4+OEvNF/61Rw: calls $0.25
qwr38jl5txoR36M7G5qi4A: folds 
zDrucyjVn5aeekNEc3cJrA: folds 
H5Se03ZqSX7tbULXur2MAg: calls $0.25
tLcDklc2rBORNfixyRfVfw: raises $1.75 to $2
rLSSHKOHnb6yzVfDoQM/RA: calls $2
Iu9xjReQYvxYiqQm8n6MXQ: folds 
PdIasPkzm2sqZnN41ZRXOg: folds 
qbQE8CifKB4+OEvNF/61Rw: folds 
H5Se03ZqSX7tbULXur2MAg: folds 
*** FLOP *** [Ac 6c 3s]
tLcDklc2rBORNfixyRfVfw: checks 
rLSSHKOHnb6yzVfDoQM/RA: checks 
*** TURN *** [Ac 6c 3s] [6s]
tLcDklc2rBORNfixyRfVfw: checks 
rLSSHKOHnb6yzVfDoQM/RA: bets $1.50
tLcDklc2rBORNfixyRfVfw: calls $1.50
*** RIVER *** [Ac 6c 3s 6s] [9d]
tLcDklc2rBORNfixyRfVfw: checks 
rLSSHKOHnb6yzVfDoQM/RA: checks 
*** SHOW DOWN ***
tLcDklc2rBORNfixyRfVfw: shows [Ks Kc] (two pair, Kings and Sixes)
rLSSHKOHnb6yzVfDoQM/RA: shows [Ah Jh] (two pair, Aces and Sixes)
rLSSHKOHnb6yzVfDoQM/RA collected $7.50 from pot
*** SUMMARY ***
Total pot $7.85 | Rake $0.35 
Board [Ac 6c 3s 6s 9d]
Seat 1: qwr38jl5txoR36M7G5qi4A folded before Flop (didn't bet)
Seat 2: zDrucyjVn5aeekNEc3cJrA folded before Flop (didn't bet)
Seat 3: H5Se03ZqSX7tbULXur2MAg folded before Flop
Seat 4: tLcDklc2rBORNfixyRfVfw showed [Ks Kc] and lost with two pair, Kings and Sixes
Seat 5: rLSSHKOHnb6yzVfDoQM/RA (button) showed [Ah Jh] and won ($7.50) with two pair, Aces and Sixes
Seat 6: Iu9xjReQYvxYiqQm8n6MXQ (small blind) folded before Flop
Seat 7: PdIasPkzm2sqZnN41ZRXOg (big blind) folded before Flop
Seat 8: VBHxUExRAMrbxUq/cVx9Gw folded before Flop (didn't bet)
Seat 9: qbQE8CifKB4+OEvNF/61Rw folded before Flop




PokerStars Game #59941805132:  Hold'em No Limit ($0.10/$0.25) - 2009/07/01 1:46:42 ET
Table 'LwnjzXstPtSrqrV/oDpnXQ' 9-max Seat #4 is the button
Seat 1: 9YN2IkT2JYYKFErZtZvCtA ($17.45 in chips) 
Seat 2: uLP/lYn7oKq9xCChBXsXxw ($26.65 in chips) 
Seat 3: 7je+LC5Mfs6nL8YBVh4frQ ($3.80 in chips) 
Seat 4: CmngQmkKTp8tkl6GMRTl6w ($8.75 in chips) 
Seat 5: Th3FldXKQW6hWVVPahaoOQ ($26 in chips) 
Seat 6: ljemhp25Zg+nlA9DLCIiUw ($39.85 in chips) 
Seat 7: c/Dw/6HyqldTzIRodAIZmg ($13.75 in chips) 
Seat 8: ShXPHWfjhfmAwLgDdm6bRQ ($13.30 in chips) 
Seat 9: q6WfTUAD9mowIP63ASq2Dgz/khFDKGihQjwgoiKKPOeg05 in chips) 
Th3FldXKQW6hWVVPahaoOQ: posts small blind $0.10
ljemhp25Zg+nlA9DLCIiUw: posts big blind $0.25
*** HOLE CARDS ***
c/Dw/6HyqldTzIRodAIZmg: folds 
ShXPHWfjhfmAwLgDdm6bRQ: folds 
q6WfTUAD9mowIP63ASq2Dgz/khFDKGihQjwgoiKKPOegs $0.25
9YN2IkT2JYYKFErZtZvCtA: folds 
uLP/lYn7oKq9xCChBXsXxw: folds 
7je+LC5Mfs6nL8YBVh4frQ: folds 
CmngQmkKTp8tkl6GMRTl6w: folds 
Th3FldXKQW6hWVVPahaoOQ: folds 
ljemhp25Zg+nlA9DLCIiUw: checks 
*** FLOP *** [8d 4s Ac]
ljemhp25Zg+nlA9DLCIiUw: checks 
q6WfTUAD9mowIP63ASq2Dgz/khFDKGihQjwgoiKKPOeg $0.75
ljemhp25Zg+nlA9DLCIiUw: folds 
Uncalled bet ($0.75) returned to q6WfTUAD9mowIP63ASq2Dgz/khFDKGihQjwgoiKKPOegq6WfTUAD9mowIP63ASq2Dgt collected $0.60 from pot
q6WfTUAD9mowIP63ASq2Dgz/khFDKGihQjwgoiKKPOegn't show hand 
*** SUMMARY ***
Total pot $0.60 | Rake $0 
Board [8d 4s Ac]
Seat 1: 9YN2IkT2JYYKFErZtZvCtA folded before Flop (didn't bet)
Seat 2: uLP/lYn7oKq9xCChBXsXxw folded before Flop (didn't bet)
Seat 3: 7je+LC5Mfs6nL8YBVh4frQ folded before Flop (didn't bet)
Seat 4: CmngQmkKTp8tkl6GMRTl6w (button) folded before Flop (didn't bet)
Seat 5: Th3FldXKQW6hWVVPahaoOQ (small blind) folded before Flop
Seat 6: ljemhp25Zg+nlA9DLCIiUw (big blind) folded on the Flop
Seat 7: c/Dw/6HyqldTzIRodAIZmg folded before Flop (didn't bet)
Seat 8: ShXPHWfjhfmAwLgDdm6bRQ folded before Flop (didn't bet)
Seat 9: q6WfTUAD9mowIP63ASq2Dgz/khFDKGihQjwgoiKKPOegcted ($0.60)




PokerStars Game #59941805138:  Hold'em No Limit ($0.10/$0.25) - 2009/07/01 1:46:42 ET
Table 'RUOqTfzbAVGS5x+J9aZMHA' 9-max Seat #4 is the button
Seat 1: DnDcAdn9P0zGovMERigpFA ($26.15 in chips) 
Seat 2: Z5ZtGOON8kmSdSCll9Z3XA ($8 in chips) 
Seat 3: Th3FldXKQW6hWVVPahaoOQ ($25 in chips) 
Seat 4: K9Az8li/CO2TicltVWKamA ($31.55 in chips) 
Seat 5: MtVtHDqIJTyUcXkRBBDIVA ($26.40 in chips) 
Seat 6: ljemhp25Zg+nlA9DLCIiUw ($48.35 in chips) 
Seat 7: zgi+EUykT/pZQpoUG6+oEg ($4.30 in chips) 
Seat 8: dfNim92Z6XK1/h5SFW5vDg ($29.20 in chips) 
Seat 9: cZ99hugmLBj9KhTlc8nCSw ($25 in chips) 
MtVtHDqIJTyUcXkRBBDIVA: posts small blind $0.10
ljemhp25Zg+nlA9DLCIiUw: posts big blind $0.25
*** HOLE CARDS ***
zgi+EUykT/pZQpoUG6+oEg: folds 
dfNim92Z6XK1/h5SFW5vDg: folds 
cZ99hugmLBj9KhTlc8nCSw: folds 
DnDcAdn9P0zGovMERigpFA: folds 
Z5ZtGOON8kmSdSCll9Z3XA: folds 
Th3FldXKQW6hWVVPahaoOQ: raises $0.50 to $0.75
K9Az8li/CO2TicltVWKamA: calls $0.75
MtVtHDqIJTyUcXkRBBDIVA: folds 
ljemhp25Zg+nlA9DLCIiUw: folds 
*** FLOP *** [Qc 7s 6c]
Th3FldXKQW6hWVVPahaoOQ: bets $1
K9Az8li/CO2TicltVWKamA: raises $2 to $3
Th3FldXKQW6hWVVPahaoOQ: folds 
Uncalled bet ($2) returned to K9Az8li/CO2TicltVWKamA
K9Az8li/CO2TicltVWKamA collected $3.70 from pot
K9Az8li/CO2TicltVWKamA: doesn't show hand 
*** SUMMARY ***
Total pot $3.85 | Rake $0.15 
Board [Qc 7s 6c]
Seat 1: DnDcAdn9P0zGovMERigpFA folded before Flop (didn't bet)
Seat 2: Z5ZtGOON8kmSdSCll9Z3XA folded before Flop (didn't bet)
Seat 3: Th3FldXKQW6hWVVPahaoOQ folded on the Flop
Seat 4: K9Az8li/CO2TicltVWKamA (button) collected ($3.70)
Seat 5: MtVtHDqIJTyUcXkRBBDIVA (small blind) folded before Flop
Seat 6: ljemhp25Zg+nlA9DLCIiUw (big blind) folded before Flop
Seat 7: zgi+EUykT/pZQpoUG6+oEg folded before Flop (didn't bet)
Seat 8: dfNim92Z6XK1/h5SFW5vDg folded before Flop (didn't bet)
Seat 9: cZ99hugmLBj9KhTlc8nCSw folded before Flop (didn't bet)




PokerStars Game #59941805194:  Hold'em No Limit ($0.10/$0.25) - 2009/07/01 1:46:42 ET
Table 'aT31tt16YvQM/Ue69HPLpA' 9-max Seat #1 is the button
Seat 1: fIgGw0jPUR7labvJPaPbeg ($10.45 in chips) 
Seat 2: PdIasPkzm2sqZnN41ZRXOg ($4.75 in chips) 
Seat 3: tYsOBqdU1+x+yFI7zHO7hQ ($25.15 in chips) 
Seat 4: wGigCmBR/9XWkPpvYos3aQ ($26.35 in chips) 
Seat 5: s2xLPOl/vhl/26apJ3vsOQ ($37.65 in chips) 
Seat 6: 7cv+9Zc9HIQHNvYsMfV3uA ($59.95 in chips) 
Seat 7: W8cIfrCR+zA8pCNyIuHu8g ($35.20 in chips) 
Seat 8: W6tExOcYX7qiy6Qdp+ZwFA ($4.65 in chips) 
Seat 9: TvIuLx9zUCE+9Li58iImOQ ($13.95 in chips) 
PdIasPkzm2sqZnN41ZRXOg: posts small blind $0.10
tYsOBqdU1+x+yFI7zHO7hQ: posts big blind $0.25
*** HOLE CARDS ***
wGigCmBR/9XWkPpvYos3aQ: folds 
s2xLPOl/vhl/26apJ3vsOQ: folds 
7cv+9Zc9HIQHNvYsMfV3uA: folds 
W8cIfrCR+zA8pCNyIuHu8g: folds 
W6tExOcYX7qiy6Qdp+ZwFA: folds 
TvIuLx9zUCE+9Li58iImOQ: folds 
fIgGw0jPUR7labvJPaPbeg: raises $0.50 to $0.75
PdIasPkzm2sqZnN41ZRXOg: folds 
tYsOBqdU1+x+yFI7zHO7hQ: raises $2.25 to $3
fIgGw0jPUR7labvJPaPbeg: calls $2.25
*** FLOP *** [6d Kc 7c]
tYsOBqdU1+x+yFI7zHO7hQ: bets $3.50
fIgGw0jPUR7labvJPaPbeg: raises $3.95 to $7.45 and is all-in
tYsOBqdU1+x+yFI7zHO7hQ: calls $3.95
*** TURN *** [6d Kc 7c] [5c]
*** RIVER *** [6d Kc 7c 5c] [2d]
*** SHOW DOWN ***
tYsOBqdU1+x+yFI7zHO7hQ: shows [Qh Qc] (a pair of Queens)
fIgGw0jPUR7labvJPaPbeg: mucks hand 
tYsOBqdU1+x+yFI7zHO7hQ collected $20 from pot
*** SUMMARY ***
Total pot $21 | Rake $1 
Board [6d Kc 7c 5c 2d]
Seat 1: fIgGw0jPUR7labvJPaPbeg (button) mucked
Seat 2: PdIasPkzm2sqZnN41ZRXOg (small blind) folded before Flop
Seat 3: tYsOBqdU1+x+yFI7zHO7hQ (big blind) showed [Qh Qc] and won ($20) with a pair of Queens
Seat 4: wGigCmBR/9XWkPpvYos3aQ folded before Flop (didn't bet)
Seat 5: s2xLPOl/vhl/26apJ3vsOQ folded before Flop (didn't bet)
Seat 6: 7cv+9Zc9HIQHNvYsMfV3uA folded before Flop (didn't bet)
Seat 7: W8cIfrCR+zA8pCNyIuHu8g folded before Flop (didn't bet)
Seat 8: W6tExOcYX7qiy6Qdp+ZwFA folded before Flop (didn't bet)
Seat 9: TvIuLx9zUCE+9Li58iImOQ folded before Flop (didn't bet)




PokerStars Game #59941805280:  Hold'em No Limit ($0.10/$0.25) - 2009/07/01 1:46:42 ET
Table 'RPdw09/gGCIP4xFhDWJgXQ' 9-max Seat #9 is the button
Seat 1: aNpwfA31EREwO+ar4XzBCw ($27.60 in chips) 
Seat 2: Sd1tfhUq/M96GhXGv1hwFQ ($7.55 in chips) 
Seat 3: g5LAv1J/3Thw1zs/SEyfzw ($18.25 in chips) 
Seat 5: gehe91e0IyVT0QU/XBkEyg ($31.60 in chips) 
Seat 6: monZeAwXUmIA1l84cUd2hw ($14.50 in chips) 
Seat 7: EP17SQz/iWcuYdNOGeBgkw ($13.90 in chips) 
Seat 8: MG90wfSJZnOejs/KD3vlQQ ($29.80 in chips) 
Seat 9: O02ScVDnDZwH6KjZNJZMzA ($4.65 in chips) 
aNpwfA31EREwO+ar4XzBCw: posts small blind $0.10
Sd1tfhUq/M96GhXGv1hwFQ: posts big blind $0.25
*** HOLE CARDS ***
g5LAv1J/3Thw1zs/SEyfzw: calls $0.25
gehe91e0IyVT0QU/XBkEyg: folds 
monZeAwXUmIA1l84cUd2hw: folds 
EP17SQz/iWcuYdNOGeBgkw: calls $0.25
MG90wfSJZnOejs/KD3vlQQ: folds 
O02ScVDnDZwH6KjZNJZMzA: calls $0.25
aNpwfA31EREwO+ar4XzBCw: folds 
Sd1tfhUq/M96GhXGv1hwFQ: checks 
*** FLOP *** [4h 4d 8c]
Sd1tfhUq/M96GhXGv1hwFQ: bets $1
g5LAv1J/3Thw1zs/SEyfzw: folds 
EP17SQz/iWcuYdNOGeBgkw: folds 
O02ScVDnDZwH6KjZNJZMzA: folds 
Uncalled bet ($1) returned to Sd1tfhUq/M96GhXGv1hwFQ
Sd1tfhUq/M96GhXGv1hwFQ collected $1.05 from pot
*** SUMMARY ***
Total pot $1.10 | Rake $0.05 
Board [4h 4d 8c]
Seat 1: aNpwfA31EREwO+ar4XzBCw (small blind) folded before Flop
Seat 2: Sd1tfhUq/M96GhXGv1hwFQ (big blind) collected ($1.05)
Seat 3: g5LAv1J/3Thw1zs/SEyfzw folded on the Flop
Seat 5: gehe91e0IyVT0QU/XBkEyg folded before Flop (didn't bet)
Seat 6: monZeAwXUmIA1l84cUd2hw folded before Flop (didn't bet)
Seat 7: EP17SQz/iWcuYdNOGeBgkw folded on the Flop
Seat 8: MG90wfSJZnOejs/KD3vlQQ folded before Flop (didn't bet)
Seat 9: O02ScVDnDZwH6KjZNJZMzA (button) folded on the Flop




PokerStars Game #59941804842:  Hold'em No Limit ($0.10/$0.25) - 2009/07/01 1:46:42 ET
Table 'Zi9/NqNs3XoL1eWhMCyZyg' 9-max Seat #7 is the button
Seat 1: X6+pSIPfovPcE87t+LmUKQ ($5 in chips) 
Seat 2: 1wKfgJ8xXIiuc8C6qjkxhg ($4.75 in chips) 
Seat 3: ETC7YyRJTa2Ovhln64Ni5Q ($27.75 in chips) 
Seat 4: dmYlc+1cjwZMJ7wV+Z0rRg ($23.75 in chips) 
Seat 5: JTINtdu/1/EQCVfalLD/xQ ($11.05 in chips) 
Seat 6: YQhfmYhgnDDlWCAFmBb36Q ($16.25 in chips) 
Seat 7: 0QdZrkFD7aGKeBXPGbIomA ($1.35 in chips) 
Seat 8: nm4Dj/f+jJEwKVsUnKh73g ($35.50 in chips) 
nm4Dj/f+jJEwKVsUnKh73g: posts small blind $0.10
tYsOBqdU1+x+yFI7zHO7hQ: is sitting out 
X6+pSIPfovPcE87t+LmUKQ: posts big blind $0.25
*** HOLE CARDS ***
tYsOBqdU1+x+yFI7zHO7hQ leaves the table
1wKfgJ8xXIiuc8C6qjkxhg: calls $0.25
ETC7YyRJTa2Ovhln64Ni5Q: folds 
dmYlc+1cjwZMJ7wV+Z0rRg: folds 
JTINtdu/1/EQCVfalLD/xQ: calls $0.25
YQhfmYhgnDDlWCAFmBb36Q: folds 
0QdZrkFD7aGKeBXPGbIomA: raises $0.75 to $1
nm4Dj/f+jJEwKVsUnKh73g: folds 
X6+pSIPfovPcE87t+LmUKQ: folds 
1wKfgJ8xXIiuc8C6qjkxhg: folds 
JTINtdu/1/EQCVfalLD/xQ: folds 
Uncalled bet ($0.75) returned to 0QdZrkFD7aGKeBXPGbIomA
0QdZrkFD7aGKeBXPGbIomA collected $1.10 from pot
0QdZrkFD7aGKeBXPGbIomA: doesn't show hand 
*** SUMMARY ***
Total pot $1.10 | Rake $0 
Seat 1: X6+pSIPfovPcE87t+LmUKQ (big blind) folded before Flop
Seat 2: 1wKfgJ8xXIiuc8C6qjkxhg folded before Flop
Seat 3: ETC7YyRJTa2Ovhln64Ni5Q folded before Flop (didn't bet)
Seat 4: dmYlc+1cjwZMJ7wV+Z0rRg folded before Flop (didn't bet)
Seat 5: JTINtdu/1/EQCVfalLD/xQ folded before Flop
Seat 6: YQhfmYhgnDDlWCAFmBb36Q folded before Flop (didn't bet)
Seat 7: 0QdZrkFD7aGKeBXPGbIomA (button) collected ($1.10)
Seat 8: nm4Dj/f+jJEwKVsUnKh73g (small blind) folded before Flop




PokerStars Game #59941805230:  Hold'em No Limit ($0.10/$0.25) - 2009/07/01 1:46:42 ET
Table 'sm5gqEvXgLbkkE4dryW/5g' 6-max Seat #6 is the button
Seat 1: v8m8XHovI5tqEA9mvplDSw ($39.95 in chips) 
Seat 2: 5xs5/u2z1CO9zkRvH72MQg ($19 in chips) 
Seat 3: UT5XpwOH1ipkOF7n1MqDJA ($22.15 in chips) 
Seat 4: cWc85bEzdRzpUMhRKm8pwQ ($26.15 in chips) 
Seat 6: aogAb4Eienxztk8p2v9VVw ($20.65 in chips) 
v8m8XHovI5tqEA9mvplDSw: posts small blind $0.10
5xs5/u2z1CO9zkRvH72MQg: posts big blind $0.25
*** HOLE CARDS ***
UT5XpwOH1ipkOF7n1MqDJA: calls $0.25
cWc85bEzdRzpUMhRKm8pwQ: folds 
aogAb4Eienxztk8p2v9VVw: raises $1 to $1.25
v8m8XHovI5tqEA9mvplDSw: folds 
5xs5/u2z1CO9zkRvH72MQg: calls $1
UT5XpwOH1ipkOF7n1MqDJA: folds 
*** FLOP *** [3s 4h Kd]
5xs5/u2z1CO9zkRvH72MQg: checks 
aogAb4Eienxztk8p2v9VVw: bets $1.75
5xs5/u2z1CO9zkRvH72MQg: folds 
Uncalled bet ($1.75) returned to aogAb4Eienxztk8p2v9VVw
aogAb4Eienxztk8p2v9VVw collected $2.75 from pot
aogAb4Eienxztk8p2v9VVw: doesn't show hand 
*** SUMMARY ***
Total pot $2.85 | Rake $0.10 
Board [3s 4h Kd]
Seat 1: v8m8XHovI5tqEA9mvplDSw (small blind) folded before Flop
Seat 2: 5xs5/u2z1CO9zkRvH72MQg (big blind) folded on the Flop
Seat 3: UT5XpwOH1ipkOF7n1MqDJA folded before Flop
Seat 4: cWc85bEzdRzpUMhRKm8pwQ folded before Flop (didn't bet)
Seat 6: aogAb4Eienxztk8p2v9VVw (button) collected ($2.75)




PokerStars Game #59941805018:  Hold'em No Limit ($0.10/$0.25) - 2009/07/01 1:46:42 ET
Table 'IRgQPZVA4+IaZZIQshgwyg' 6-max Seat #3 is the button
Seat 1: cezpHJ8FB07dj0xG+LhOvw ($27.55 in chips) 
Seat 2: lquriepNQBhDV5P1SWHhnA ($28.70 in chips) 
Seat 3: DihMHaz4WNETH1bPDe13kA ($27.45 in chips) 
Seat 4: DE9hRlt14g+JdsRQ4wT7hg ($25 in chips) 
Seat 6: x9/USY6PsmgUGQeluFLKDw ($21.65 in chips) 
DE9hRlt14g+JdsRQ4wT7hg: posts small blind $0.10
x9/USY6PsmgUGQeluFLKDw: posts big blind $0.25
*** HOLE CARDS ***
cezpHJ8FB07dj0xG+LhOvw: folds 
lquriepNQBhDV5P1SWHhnA: folds 
w43JQj2oYPpKQVG4Yzlq1w joins the table at seat #5 
DihMHaz4WNETH1bPDe13kA: raises $0.50 to $0.75
DE9hRlt14g+JdsRQ4wT7hg: folds 
x9/USY6PsmgUGQeluFLKDw: folds 
Uncalled bet ($0.50) returned to DihMHaz4WNETH1bPDe13kA
DihMHaz4WNETH1bPDe13kA collected $0.60 from pot
*** SUMMARY ***
Total pot $0.60 | Rake $0 
Seat 1: cezpHJ8FB07dj0xG+LhOvw folded before Flop (didn't bet)
Seat 2: lquriepNQBhDV5P1SWHhnA folded before Flop (didn't bet)
Seat 3: DihMHaz4WNETH1bPDe13kA (button) collected ($0.60)
Seat 4: DE9hRlt14g+JdsRQ4wT7hg (small blind) folded before Flop
Seat 6: x9/USY6PsmgUGQeluFLKDw (big blind) folded before Flop




PokerStars Game #59941805298:  Hold'em No Limit ($0.10/$0.25) - 2009/07/01 1:46:42 ET
Table 'GxdLtCpYxqT4aAbYqkEEpw' 6-max Seat #6 is the button
Seat 1: 2d/PU00mMdO9azAaXqcSbw ($9.10 in chips) 
Seat 2: MCCWc70bl051s/EF6nHRcA ($24.75 in chips) 
Seat 3: LpmZGzLpOmfZUF7EV4ZlrQ ($16.25 in chips) 
Seat 4: 6wzJiRvp8HY6t+MQGnSIzA ($11.90 in chips) 
Seat 5: q6WfTUAD9mowIP63ASq2Dg ($45.25 in chips) 
Seat 6: DFi/Lzkjsfv8QswS80JX9Q ($25 in chips) 
2d/PU00mMdO9azAaXqcSbw: posts small blind $0.10
MCCWc70bl051s/EF6nHRcA: posts big blind $0.25
*** HOLE CARDS ***
LpmZGzLpOmfZUF7EV4ZlrQ has timed out while being disconnected
LpmZGzLpOmfZUF7EV4ZlrQ: folds 
LpmZGzLpOmfZUF7EV4ZlrQ is sitting out
6wzJiRvp8HY6t+MQGnSIzA: raises $0.50 to $0.75
q6WfTUAD9mowIP63ASq2Dg: folds 
DFi/Lzkjsfv8QswS80JX9Q: folds 
2d/PU00mMdO9azAaXqcSbw: calls $0.65
MCCWc70bl051s/EF6nHRcA: folds 
*** FLOP *** [3d Ks Qh]
LpmZGzLpOmfZUF7EV4ZlrQ is disconnected 
2d/PU00mMdO9azAaXqcSbw: bets $1.25
6wzJiRvp8HY6t+MQGnSIzA: folds 
Uncalled bet ($1.25) returned to 2d/PU00mMdO9azAaXqcSbw
2d/PU00mMdO9azAaXqcSbw collected $1.70 from pot
2d/PU00mMdO9azAaXqcSbw: doesn't show hand 
*** SUMMARY ***
Total pot $1.75 | Rake $0.05 
Board [3d Ks Qh]
Seat 1: 2d/PU00mMdO9azAaXqcSbw (small blind) collected ($1.70)
Seat 2: MCCWc70bl051s/EF6nHRcA (big blind) folded before Flop
Seat 3: LpmZGzLpOmfZUF7EV4ZlrQ folded before Flop (didn't bet)
Seat 4: 6wzJiRvp8HY6t+MQGnSIzA folded on the Flop
Seat 5: q6WfTUAD9mowIP63ASq2Dg folded before Flop (didn't bet)
Seat 6: DFi/Lzkjsfv8QswS80JX9Q (button) folded before Flop (didn't bet)




PokerStars Game #59941805038:  Hold'em No Limit ($0.10/$0.25) - 2009/07/01 1:46:42 ET
Table 'Pz8SfAzhP5nvWTsJRAxoDg' 6-max Seat #1 is the button
Seat 1: QiL+lEgEWwy21jk/ltaRLg ($47.15 in chips) 
Seat 2: k021eD5in2AjaloW5PalMg ($19.15 in chips) 
Seat 3: mfrkWA3PTeYPkbO6hi98Aw ($24.60 in chips) 
Seat 4: 4lJto+Qj0K4JrFKvHaPTLw ($67.40 in chips) 
Seat 5: FYepjhAvF8ZdVCmqHIy+eQ ($28.05 in chips) 
Seat 6: QvTX2yGq3uKJiKPmns4TKQ ($16.70 in chips) 
k021eD5in2AjaloW5PalMg: posts small blind $0.10
mfrkWA3PTeYPkbO6hi98Aw: posts big blind $0.25
*** HOLE CARDS ***
4lJto+Qj0K4JrFKvHaPTLw: folds 
FYepjhAvF8ZdVCmqHIy+eQ: raises $0.75 to $1
QvTX2yGq3uKJiKPmns4TKQ: raises $15.70 to $16.70 and is all-in
QiL+lEgEWwy21jk/ltaRLg: folds 
k021eD5in2AjaloW5PalMg: folds 
mfrkWA3PTeYPkbO6hi98Aw: folds 
FYepjhAvF8ZdVCmqHIy+eQ: folds 
Uncalled bet ($15.70) returned to QvTX2yGq3uKJiKPmns4TKQ
QvTX2yGq3uKJiKPmns4TKQ collected $2.35 from pot
QvTX2yGq3uKJiKPmns4TKQ: doesn't show hand 
*** SUMMARY ***
Total pot $2.35 | Rake $0 
Seat 1: QiL+lEgEWwy21jk/ltaRLg (button) folded before Flop (didn't bet)
Seat 2: k021eD5in2AjaloW5PalMg (small blind) folded before Flop
Seat 3: mfrkWA3PTeYPkbO6hi98Aw (big blind) folded before Flop
Seat 4: 4lJto+Qj0K4JrFKvHaPTLw folded before Flop (didn't bet)
Seat 5: FYepjhAvF8ZdVCmqHIy+eQ folded before Flop
Seat 6: QvTX2yGq3uKJiKPmns4TKQ collected ($2.35)




PokerStars Game #59941805726:  Hold'em No Limit ($0.10/$0.25) - 2009/07/01 1:46:43 ET
Table 'xPn6TS/y/OWkX7Qa+MUuKA' 6-max Seat #1 is the button
Seat 1: JFIAqU8lCZ0vWwEl4bdGsg ($42.70 in chips) 
Seat 2: buyjetgNT1McXtdaP4zynA ($27.35 in chips) 
Seat 3: q6WfTUAD9mowIP63ASq2Dg ($24.50 in chips) 
Seat 4: SS/yfeArhULzIcOPe8MdPg ($28.65 in chips) 
Seat 5: lquriepNQBhDV5P1SWHhnA ($28.60 in chips) 
Seat 6: DihMHaz4WNETH1bPDe13kA ($25 in chips) 
buyjetgNT1McXtdaP4zynA: posts small blind $0.10
q6WfTUAD9mowIP63ASq2Dg: posts big blind $0.25
*** HOLE CARDS ***
SS/yfeArhULzIcOPe8MdPg: folds 
lquriepNQBhDV5P1SWHhnA: folds 
DihMHaz4WNETH1bPDe13kA: folds 
JFIAqU8lCZ0vWwEl4bdGsg: folds 
buyjetgNT1McXtdaP4zynA: raises $0.75 to $1
q6WfTUAD9mowIP63ASq2Dg: folds 
Uncalled bet ($0.75) returned to buyjetgNT1McXtdaP4zynA
buyjetgNT1McXtdaP4zynA collected $0.50 from pot
*** SUMMARY ***
Total pot $0.50 | Rake $0 
Seat 1: JFIAqU8lCZ0vWwEl4bdGsg (button) folded before Flop (didn't bet)
Seat 2: buyjetgNT1McXtdaP4zynA (small blind) collected ($0.50)
Seat 3: q6WfTUAD9mowIP63ASq2Dg (big blind) folded before Flop
Seat 4: SS/yfeArhULzIcOPe8MdPg folded before Flop (didn't bet)
Seat 5: lquriepNQBhDV5P1SWHhnA folded before Flop (didn't bet)
Seat 6: DihMHaz4WNETH1bPDe13kA folded before Flop (didn't bet)




PokerStars Game #59941805548:  Hold'em No Limit ($0.10/$0.25) - 2009/07/01 1:46:43 ET
Table 'K/f0NNaoGuhSz5DrzgVw7Q' 9-max Seat #8 is the button
Seat 1: sD+TKtt36XiiN6jqHiLwDA ($26.55 in chips) 
Seat 4: 9bCz0uv2nUmznwuI0OjVGw ($12.60 in chips) 
Seat 5: DnDcAdn9P0zGovMERigpFA ($40.85 in chips) 
Seat 7: egvg3mTBBVzMHnJPIQiKcA ($12.15 in chips) 
Seat 8: RCqMONFrSPSArZh2Jsar/w ($24.65 in chips) 
Seat 9: tLcDklc2rBORNfixyRfVfw ($25 in chips) 
tLcDklc2rBORNfixyRfVfw: posts small blind $0.10
sD+TKtt36XiiN6jqHiLwDA: posts big blind $0.25
zgi+EUykT/pZQpoUG6+oEg: sits out 
3PVK0IdMlq2fElkVzzr4bg: sits out 
*** HOLE CARDS ***
9bCz0uv2nUmznwuI0OjVGw: calls $0.25
DnDcAdn9P0zGovMERigpFA: calls $0.25
egvg3mTBBVzMHnJPIQiKcA: folds 
RCqMONFrSPSArZh2Jsar/w: folds 
tLcDklc2rBORNfixyRfVfw: calls $0.15
sD+TKtt36XiiN6jqHiLwDA: checks 
*** FLOP *** [7h 3d Ad]
tLcDklc2rBORNfixyRfVfw: checks 
sD+TKtt36XiiN6jqHiLwDA: checks 
9bCz0uv2nUmznwuI0OjVGw: bets $0.50
DnDcAdn9P0zGovMERigpFA: folds 
tLcDklc2rBORNfixyRfVfw: folds 
sD+TKtt36XiiN6jqHiLwDA: calls $0.50
*** TURN *** [7h 3d Ad] [5d]
sD+TKtt36XiiN6jqHiLwDA: checks 
9bCz0uv2nUmznwuI0OjVGw: bets $1.50
sD+TKtt36XiiN6jqHiLwDA: folds 
Uncalled bet ($1.50) returned to 9bCz0uv2nUmznwuI0OjVGw
9bCz0uv2nUmznwuI0OjVGw collected $1.95 from pot
9bCz0uv2nUmznwuI0OjVGw: doesn't show hand 
*** SUMMARY ***
Total pot $2 | Rake $0.05 
Board [7h 3d Ad 5d]
Seat 1: sD+TKtt36XiiN6jqHiLwDA (big blind) folded on the Turn
Seat 4: 9bCz0uv2nUmznwuI0OjVGw collected ($1.95)
Seat 5: DnDcAdn9P0zGovMERigpFA folded on the Flop
Seat 7: egvg3mTBBVzMHnJPIQiKcA folded before Flop (didn't bet)
Seat 8: RCqMONFrSPSArZh2Jsar/w (button) folded before Flop (didn't bet)
Seat 9: tLcDklc2rBORNfixyRfVfw (small blind) folded on the Flop




PokerStars Game #59941805808:  Hold'em No Limit ($0.10/$0.25) - 2009/07/01 1:46:43 ET
Table 'r562aMIMs5kgo28FEU6lkA' 9-max Seat #6 is the button
Seat 1: H5Se03ZqSX7tbULXur2MAg ($14.80 in chips) 
Seat 2: N8muFAHrFHW6elSMGuyVLQ ($25.35 in chips) 
Seat 3: xoBFd/5k+L/pFn9VW1VyWg ($10.10 in chips) 
Seat 4: V6p0jQ/RhUsqpHLmXvEX4Q ($19.75 in chips) 
Seat 6: RCqMONFrSPSArZh2Jsar/w ($20 in chips) 
Seat 7: Bb42QRQMhg5/Y0vHP8/2Xw ($25 in chips) 
Seat 8: B6xHiX1SJkS0CUNCKDVwuQ ($20.90 in chips) 
Seat 9: yyG4svzOpC1A+sUP/scg6w ($7.50 in chips) 
Bb42QRQMhg5/Y0vHP8/2Xw: posts small blind $0.10
B6xHiX1SJkS0CUNCKDVwuQ: posts big blind $0.25
*** HOLE CARDS ***
yyG4svzOpC1A+sUP/scg6w: folds 
H5Se03ZqSX7tbULXur2MAg: folds 
N8muFAHrFHW6elSMGuyVLQ: folds 
xoBFd/5k+L/pFn9VW1VyWg: folds 
V6p0jQ/RhUsqpHLmXvEX4Q: folds 
RCqMONFrSPSArZh2Jsar/w: folds 
Bb42QRQMhg5/Y0vHP8/2Xw: folds 
Uncalled bet ($0.15) returned to B6xHiX1SJkS0CUNCKDVwuQ
zDrucyjVn5aeekNEc3cJrA has returned
B6xHiX1SJkS0CUNCKDVwuQ collected $0.20 from pot
B6xHiX1SJkS0CUNCKDVwuQ: doesn't show hand 
*** SUMMARY ***
Total pot $0.20 | Rake $0 
Seat 1: H5Se03ZqSX7tbULXur2MAg folded before Flop (didn't bet)
Seat 2: N8muFAHrFHW6elSMGuyVLQ folded before Flop (didn't bet)
Seat 3: xoBFd/5k+L/pFn9VW1VyWg folded before Flop (didn't bet)
Seat 4: V6p0jQ/RhUsqpHLmXvEX4Q folded before Flop (didn't bet)
Seat 6: RCqMONFrSPSArZh2Jsar/w (button) folded before Flop (didn't bet)
Seat 7: Bb42QRQMhg5/Y0vHP8/2Xw (small blind) folded before Flop
Seat 8: B6xHiX1SJkS0CUNCKDVwuQ (big blind) collected ($0.20)
Seat 9: yyG4svzOpC1A+sUP/scg6w folded before Flop (didn't bet)




PokerStars Game #59941805744:  Hold'em No Limit ($0.10/$0.25) - 2009/07/01 1:46:43 ET
Table 'G+4ZdyRoPjgaJY/jxSlZzQ' 9-max Seat #3 is the button
Seat 1: ghNKXUBl/H+t83JF079ZBA ($23.75 in chips) 
Seat 2: CT7Xj/V/O5rBlhtt+RZeFQ ($25 in chips) 
Seat 3: FaGtAm5QUVcixGhAKIvbLg ($13.75 in chips) 
Seat 4: 3PmVnC/15cl4oyI1TKIt4g ($4.75 in chips) 
Seat 5: BT6Oal0iO4P6kDuT7HFQDw ($16.50 in chips) 
Seat 6: oFwaTjy3ok/+qFghsrcGvg ($23.05 in chips) 
Seat 8: bXpVeaSTPBFSPJmeXxO7nw ($4.65 in chips) 
Seat 9: tLcDklc2rBORNfixyRfVfw ($26.50 in chips) 
3PmVnC/15cl4oyI1TKIt4g: posts small blind $0.10
BT6Oal0iO4P6kDuT7HFQDw: posts big blind $0.25
qwr38jl5txoR36M7G5qi4A: sits out 
*** HOLE CARDS ***
oFwaTjy3ok/+qFghsrcGvg: calls $0.25
bXpVeaSTPBFSPJmeXxO7nw: folds 
tLcDklc2rBORNfixyRfVfw: folds 
ghNKXUBl/H+t83JF079ZBA: folds 
CT7Xj/V/O5rBlhtt+RZeFQ: folds 
FaGtAm5QUVcixGhAKIvbLg: calls $0.25
3PmVnC/15cl4oyI1TKIt4g: folds 
BT6Oal0iO4P6kDuT7HFQDw: checks 
*** FLOP *** [8h 6c 9h]
BT6Oal0iO4P6kDuT7HFQDw: bets $0.75
oFwaTjy3ok/+qFghsrcGvg: calls $0.75
FaGtAm5QUVcixGhAKIvbLg: calls $0.75
*** TURN *** [8h 6c 9h] [8d]
BT6Oal0iO4P6kDuT7HFQDw: bets $2
oFwaTjy3ok/+qFghsrcGvg: folds 
FaGtAm5QUVcixGhAKIvbLg: calls $2
*** RIVER *** [8h 6c 9h 8d] [3h]
BT6Oal0iO4P6kDuT7HFQDw: checks 
FaGtAm5QUVcixGhAKIvbLg: bets $4.50
BT6Oal0iO4P6kDuT7HFQDw: calls $4.50
*** SHOW DOWN ***
FaGtAm5QUVcixGhAKIvbLg: shows [Js 7c] (a pair of Eights)
BT6Oal0iO4P6kDuT7HFQDw: shows [8c 5c] (three of a kind, Eights)
BT6Oal0iO4P6kDuT7HFQDw collected $15.35 from pot
*** SUMMARY ***
Total pot $16.10 | Rake $0.75 
Board [8h 6c 9h 8d 3h]
Seat 1: ghNKXUBl/H+t83JF079ZBA folded before Flop (didn't bet)
Seat 2: CT7Xj/V/O5rBlhtt+RZeFQ folded before Flop (didn't bet)
Seat 3: FaGtAm5QUVcixGhAKIvbLg (button) showed [Js 7c] and lost with a pair of Eights
Seat 4: 3PmVnC/15cl4oyI1TKIt4g (small blind) folded before Flop
Seat 5: BT6Oal0iO4P6kDuT7HFQDw (big blind) showed [8c 5c] and won ($15.35) with three of a kind, Eights
Seat 6: oFwaTjy3ok/+qFghsrcGvg folded on the Turn
Seat 8: bXpVeaSTPBFSPJmeXxO7nw folded before Flop (didn't bet)
Seat 9: tLcDklc2rBORNfixyRfVfw folded before Flop (didn't bet)




PokerStars Game #59941805802:  Hold'em No Limit ($0.10/$0.25) - 2009/07/01 1:46:43 ET
Table 'L5GvbdQO5aCZJSE6pyQ8OA' 6-max Seat #2 is the button
Seat 2: DihMHaz4WNETH1bPDe13kA ($31.05 in chips) 
Seat 3: JFIAqU8lCZ0vWwEl4bdGsg ($25.45 in chips) 
Seat 4: trN/oHqTTbPw5MNuKrOpLw ($28.65 in chips) 
Seat 5: LyDHtw3/yniNHW+DvLXbog ($27 in chips) 
Seat 6: v+QfkGiuj9bgtuNoVnDO8w ($39.05 in chips) 
JFIAqU8lCZ0vWwEl4bdGsg: posts small blind $0.10
trN/oHqTTbPw5MNuKrOpLw: posts big blind $0.25
*** HOLE CARDS ***
LyDHtw3/yniNHW+DvLXbog: folds 
v+QfkGiuj9bgtuNoVnDO8w: folds 
DihMHaz4WNETH1bPDe13kA: folds 
JFIAqU8lCZ0vWwEl4bdGsg: raises $0.60 to $0.85
trN/oHqTTbPw5MNuKrOpLw: folds 
Uncalled bet ($0.60) returned to JFIAqU8lCZ0vWwEl4bdGsg
JFIAqU8lCZ0vWwEl4bdGsg collected $0.50 from pot
JFIAqU8lCZ0vWwEl4bdGsg: doesn't show hand 
*** SUMMARY ***
Total pot $0.50 | Rake $0 
Seat 2: DihMHaz4WNETH1bPDe13kA (button) folded before Flop (didn't bet)
Seat 3: JFIAqU8lCZ0vWwEl4bdGsg (small blind) collected ($0.50)
Seat 4: trN/oHqTTbPw5MNuKrOpLw (big blind) folded before Flop
Seat 5: LyDHtw3/yniNHW+DvLXbog folded before Flop (didn't bet)
Seat 6: v+QfkGiuj9bgtuNoVnDO8w folded before Flop (didn't bet)




PokerStars Game #59941805884:  Hold'em No Limit ($0.10/$0.25) - 2009/07/01 1:46:43 ET
Table 'BpNkESDX1ip9c0K1hb5h7A' 6-max Seat #1 is the button
Seat 1: 5YZdVjBPZVEdubN4xEMPEg ($26 in chips) 
Seat 2: 9U3ZKjCsarN0DjR6mSE8Ug ($19.70 in chips) 
Seat 3: fZQg9veL7Dd/Z04ZTjC+wQ ($27.90 in chips) 
Seat 4: kG34n23qFQA3nzdOJTQ1dA ($26.50 in chips) 
Seat 6: 8EEqTTh7T1q48sYDqbI2Xg ($19.75 in chips) 
9U3ZKjCsarN0DjR6mSE8Ug: posts small blind $0.10
fZQg9veL7Dd/Z04ZTjC+wQ: posts big blind $0.25
OMGl+YMGogf2JWIRfT2/Yg: sits out 
*** HOLE CARDS ***
kG34n23qFQA3nzdOJTQ1dA: folds 
8EEqTTh7T1q48sYDqbI2Xg: calls $0.25
5YZdVjBPZVEdubN4xEMPEg: raises $0.75 to $1
9U3ZKjCsarN0DjR6mSE8Ug: folds 
fZQg9veL7Dd/Z04ZTjC+wQ: calls $0.75
8EEqTTh7T1q48sYDqbI2Xg: folds 
*** FLOP *** [6c As 6d]
fZQg9veL7Dd/Z04ZTjC+wQ: checks 
5YZdVjBPZVEdubN4xEMPEg: bets $0.75
fZQg9veL7Dd/Z04ZTjC+wQ: calls $0.75
*** TURN *** [6c As 6d] [Qh]
fZQg9veL7Dd/Z04ZTjC+wQ: checks 
5YZdVjBPZVEdubN4xEMPEg: bets $1
fZQg9veL7Dd/Z04ZTjC+wQ: raises $1.25 to $2.25
5YZdVjBPZVEdubN4xEMPEg: calls $1.25
*** RIVER *** [6c As 6d Qh] [7c]
fZQg9veL7Dd/Z04ZTjC+wQ: bets $6.50
5YZdVjBPZVEdubN4xEMPEg: calls $6.50
*** SHOW DOWN ***
fZQg9veL7Dd/Z04ZTjC+wQ: shows [6s 6h] (four of a kind, Sixes)
5YZdVjBPZVEdubN4xEMPEg: mucks hand 
fZQg9veL7Dd/Z04ZTjC+wQ collected $20.35 from pot
*** SUMMARY ***
Total pot $21.35 | Rake $1 
Board [6c As 6d Qh 7c]
Seat 1: 5YZdVjBPZVEdubN4xEMPEg (button) mucked
Seat 2: 9U3ZKjCsarN0DjR6mSE8Ug (small blind) folded before Flop
Seat 3: fZQg9veL7Dd/Z04ZTjC+wQ (big blind) showed [6s 6h] and won ($20.35) with four of a kind, Sixes
Seat 4: kG34n23qFQA3nzdOJTQ1dA folded before Flop (didn't bet)
Seat 6: 8EEqTTh7T1q48sYDqbI2Xg folded before Flop




PokerStars Game #59941805774:  Hold'em No Limit ($0.10/$0.25) - 2009/07/01 1:46:43 ET
Table 'z2yOdY2zyGWG1gh9WV9XtQdYNvO8G5kw5SRxb1Dljhog Seat #2 is the button
Seat 1: vSkQm2EelzwRGDDQQk0Fqw ($17.30 in chips) 
Seat 2: PkBmevN3LdXkPj1LHOoTnQ ($1.35 in chips) 
Seat 3: 1Cs1GyQcoM1omwY7XZ3uRg ($12.50 in chips) 
Seat 4: sD+TKtt36XiiN6jqHiLwDA ($28.10 in chips) 
Seat 5: W7XGvw6ngGVq2hFwXk8Myg ($25.60 in chips) 
Seat 6: 22dIObOuor/A+IKWkNoAlA ($7.80 in chips) 
Seat 7: DiSvPC2iudwL5j9u6Huyww ($39.75 in chips) 
Seat 8: 5hAPbqNrvJb8PtLiceXtlg6HoFYfVGBefsR5Vrz62qIw0 in chips) 
Seat 9: PdIasPkzm2sqZnN41ZRXOg ($5 in chips) 
1Cs1GyQcoM1omwY7XZ3uRg: posts small blind $0.10
sD+TKtt36XiiN6jqHiLwDA: posts big blind $0.25
*** HOLE CARDS ***
W7XGvw6ngGVq2hFwXk8Myg: folds 
22dIObOuor/A+IKWkNoAlA: folds 
DiSvPC2iudwL5j9u6Huyww: folds 
5hAPbqNrvJb8PtLiceXtlg6HoFYfVGBefsR5Vrz62qIwlds 
PdIasPkzm2sqZnN41ZRXOg: folds 
vSkQm2EelzwRGDDQQk0Fqw: folds 
PkBmevN3LdXkPj1LHOoTnQ: folds 
1Cs1GyQcoM1omwY7XZ3uRg: calls $0.15
sD+TKtt36XiiN6jqHiLwDA: checks 
*** FLOP *** [5s Ts Kc]
1Cs1GyQcoM1omwY7XZ3uRg: checks 
sD+TKtt36XiiN6jqHiLwDA: bets $0.75
1Cs1GyQcoM1omwY7XZ3uRg: folds 
Uncalled bet ($0.75) returned to sD+TKtt36XiiN6jqHiLwDA
sD+TKtt36XiiN6jqHiLwDA collected $0.50 from pot
sD+TKtt36XiiN6jqHiLwDA: doesn't show hand 
*** SUMMARY ***
Total pot $0.50 | Rake $0 
Board [5s Ts Kc]
Seat 1: vSkQm2EelzwRGDDQQk0Fqw folded before Flop (didn't bet)
Seat 2: PkBmevN3LdXkPj1LHOoTnQ (button) folded before Flop (didn't bet)
Seat 3: 1Cs1GyQcoM1omwY7XZ3uRg (small blind) folded on the Flop
Seat 4: sD+TKtt36XiiN6jqHiLwDA (big blind) collected ($0.50)
Seat 5: W7XGvw6ngGVq2hFwXk8Myg folded before Flop (didn't bet)
Seat 6: 22dIObOuor/A+IKWkNoAlA folded before Flop (didn't bet)
Seat 7: DiSvPC2iudwL5j9u6Huyww folded before Flop (didn't bet)
Seat 8: 5hAPbqNrvJb8PtLiceXtlg6HoFYfVGBefsR5Vrz62qIwded before Flop (didn't bet)
Seat 9: PdIasPkzm2sqZnN41ZRXOg folded before Flop (didn't bet)




PokerStars Game #59941806246:  Hold'em No Limit ($0.10/$0.25) - 2009/07/01 1:46:44 ET
Table 'iMiAw/kTZXopgYX4HI7sHg' 9-max Seat #4 is the button
Seat 1: PdIasPkzm2sqZnN41ZRXOg ($5 in chips) 
Seat 2: qwr38jl5txoR36M7G5qi4A ($8.25 in chips) 
Seat 3: HPEB+AtKw1+C/cxU0o1ciw ($27.90 in chips) 
Seat 4: Z9W7+g1WMhhZDi7DwGbCFA ($5 in chips) 
Seat 5: 22dIObOuor/A+IKWkNoAlA ($5.45 in chips) 
Seat 6: Bb42QRQMhg5/Y0vHP8/2Xw ($29.05 in chips) 
Seat 8: tLcDklc2rBORNfixyRfVfw ($29.90 in chips) 
Seat 9: 7cv+9Zc9HIQHNvYsMfV3uA ($25 in chips) 
22dIObOuor/A+IKWkNoAlA: posts small blind $0.10
Bb42QRQMhg5/Y0vHP8/2Xw: posts big blind $0.25
ipLwYjdAXnvG54zETKPvbQ: sits out 
*** HOLE CARDS ***
tLcDklc2rBORNfixyRfVfw: folds 
7cv+9Zc9HIQHNvYsMfV3uA: folds 
PdIasPkzm2sqZnN41ZRXOg: folds 
qwr38jl5txoR36M7G5qi4A: folds 
HPEB+AtKw1+C/cxU0o1ciw: folds 
Z9W7+g1WMhhZDi7DwGbCFA: folds 
22dIObOuor/A+IKWkNoAlA: folds 
Uncalled bet ($0.15) returned to Bb42QRQMhg5/Y0vHP8/2Xw
Bb42QRQMhg5/Y0vHP8/2Xw collected $0.20 from pot
*** SUMMARY ***
Total pot $0.20 | Rake $0 
Seat 1: PdIasPkzm2sqZnN41ZRXOg folded before Flop (didn't bet)
Seat 2: qwr38jl5txoR36M7G5qi4A folded before Flop (didn't bet)
Seat 3: HPEB+AtKw1+C/cxU0o1ciw folded before Flop (didn't bet)
Seat 4: Z9W7+g1WMhhZDi7DwGbCFA (button) folded before Flop (didn't bet)
Seat 5: 22dIObOuor/A+IKWkNoAlA (small blind) folded before Flop
Seat 6: Bb42QRQMhg5/Y0vHP8/2Xw (big blind) collected ($0.20)
Seat 8: tLcDklc2rBORNfixyRfVfw folded before Flop (didn't bet)
Seat 9: 7cv+9Zc9HIQHNvYsMfV3uA folded before Flop (didn't bet)




PokerStars Game #59941805974:  Hold'em No Limit ($0.10/$0.25) - 2009/07/01 1:46:44 ET
Table 'Do4nrTNDYpK3sQjwFxX+Og' 6-max Seat #3 is the button
Seat 1: 7JrQNOR9wRBxq9ijFhWieg ($37.30 in chips) 
Seat 2: tzMoGl9F0PUr5NibYueeSw ($67.70 in chips) 
Seat 3: TSmua8tGK3sTbwi0ynrW9Q ($26.40 in chips) 
Seat 4: cWc85bEzdRzpUMhRKm8pwQ ($33.15 in chips) 
Seat 6: lBoEwOFgzcERLIRUkUoRTw ($23.55 in chips) 
cWc85bEzdRzpUMhRKm8pwQ: posts small blind $0.10
lBoEwOFgzcERLIRUkUoRTw: posts big blind $0.25
*** HOLE CARDS ***
aogAb4Eienxztk8p2v9VVw joins the table at seat #5 
7JrQNOR9wRBxq9ijFhWieg: raises $0.50 to $0.75
tzMoGl9F0PUr5NibYueeSw: folds 
TSmua8tGK3sTbwi0ynrW9Q: folds 
cWc85bEzdRzpUMhRKm8pwQ: folds 
lBoEwOFgzcERLIRUkUoRTw: folds 
Uncalled bet ($0.50) returned to 7JrQNOR9wRBxq9ijFhWieg
7JrQNOR9wRBxq9ijFhWieg collected $0.60 from pot
7JrQNOR9wRBxq9ijFhWieg: doesn't show hand 
*** SUMMARY ***
Total pot $0.60 | Rake $0 
Seat 1: 7JrQNOR9wRBxq9ijFhWieg collected ($0.60)
Seat 2: tzMoGl9F0PUr5NibYueeSw folded before Flop (didn't bet)
Seat 3: TSmua8tGK3sTbwi0ynrW9Q (button) folded before Flop (didn't bet)
Seat 4: cWc85bEzdRzpUMhRKm8pwQ (small blind) folded before Flop
Seat 6: lBoEwOFgzcERLIRUkUoRTw (big blind) folded before Flop




PokerStars Game #59941806198:  Hold'em No Limit ($0.10/$0.25) - 2009/07/01 1:46:44 ET
Table 'o0CDOvKO/bn1WjeymDrXfA' 6-max Seat #5 is the button
Seat 1: if4dh6jhJXeN3/qd3qCp9g ($24.65 in chips) 
Seat 3: OtVWmpxX2/9L8bb1GSKTuA ($21.90 in chips) 
Seat 5: dOIoLBxmpLHSXBN9LZnf0Q ($36.25 in chips) 
Seat 6: SS/yfeArhULzIcOPe8MdPg ($25 in chips) 
SS/yfeArhULzIcOPe8MdPg: posts small blind $0.10
if4dh6jhJXeN3/qd3qCp9g: posts big blind $0.25
*** HOLE CARDS ***
OtVWmpxX2/9L8bb1GSKTuA: folds 
dOIoLBxmpLHSXBN9LZnf0Q: calls $0.25
the3bigO joins the table at seat #4 
SS/yfeArhULzIcOPe8MdPg: folds 
if4dh6jhJXeN3/qd3qCp9g: checks 
*** FLOP *** [Jh 9s 5s]
if4dh6jhJXeN3/qd3qCp9g: checks 
uAJL+E2git8iAiFyAvVOnw is connected 
dOIoLBxmpLHSXBN9LZnf0Q: bets $0.25
if4dh6jhJXeN3/qd3qCp9g: raises $1 to $1.25
uAJL+E2git8iAiFyAvVOnw has returned
dOIoLBxmpLHSXBN9LZnf0Q: calls $1
*** TURN *** [Jh 9s 5s] [3c]
if4dh6jhJXeN3/qd3qCp9g: bets $2.25
dOIoLBxmpLHSXBN9LZnf0Q: calls $2.25
*** RIVER *** [Jh 9s 5s 3c] [6c]
the3bigO is disconnected 
if4dh6jhJXeN3/qd3qCp9g: bets $5.50
dOIoLBxmpLHSXBN9LZnf0Q: folds 
Uncalled bet ($5.50) returned to if4dh6jhJXeN3/qd3qCp9g
if4dh6jhJXeN3/qd3qCp9g collected $7.25 from pot
if4dh6jhJXeN3/qd3qCp9g: doesn't show hand 
*** SUMMARY ***
Total pot $7.60 | Rake $0.35 
Board [Jh 9s 5s 3c 6c]
Seat 1: if4dh6jhJXeN3/qd3qCp9g (big blind) collected ($7.25)
Seat 3: OtVWmpxX2/9L8bb1GSKTuA folded before Flop (didn't bet)
Seat 5: dOIoLBxmpLHSXBN9LZnf0Q (button) folded on the River
Seat 6: SS/yfeArhULzIcOPe8MdPg (small blind) folded before Flop




PokerStars Game #59941806582:  Hold'em No Limit ($0.10/$0.25) - 2009/07/01 1:46:45 ET
Table 'nQC9LRg01NEuKFHF1nrDEw0XPo7K54oZIfG0xlNAcDRw-max Seat #5 is the button
Seat 1: qf+LMbROj8/qY878wkFHbQ ($14.80 in chips) 
Seat 2: ZhV6dUX9NQhT4zf7t+ZLJg ($20.60 in chips) 
Seat 3: 6+g0Lb6vfRDZkElV8ieHyQ ($26.45 in chips) 
Seat 5: kG34n23qFQA3nzdOJTQ1dA ($28.70 in chips) 
Seat 6: xQVFeVUDopz+akuEo2wXpQ ($55.55 in chips) 
xQVFeVUDopz+akuEo2wXpQ: posts small blind $0.10
qf+LMbROj8/qY878wkFHbQ: posts big blind $0.25
u3Ol7kv1LmvszuHNm9rc6w: sits out 
*** HOLE CARDS ***
ZhV6dUX9NQhT4zf7t+ZLJg: folds 
6+g0Lb6vfRDZkElV8ieHyQ: folds 
kG34n23qFQA3nzdOJTQ1dA: folds 
xQVFeVUDopz+akuEo2wXpQ: calls $0.15
qf+LMbROj8/qY878wkFHbQ: checks 
*** FLOP *** [7h Qc 4h]
xQVFeVUDopz+akuEo2wXpQ: bets $0.25
qf+LMbROj8/qY878wkFHbQ: folds 
Uncalled bet ($0.25) returned to xQVFeVUDopz+akuEo2wXpQ
xQVFeVUDopz+akuEo2wXpQ collected $0.50 from pot
*** SUMMARY ***
Total pot $0.50 | Rake $0 
Board [7h Qc 4h]
Seat 1: qf+LMbROj8/qY878wkFHbQ (big blind) folded on the Flop
Seat 2: ZhV6dUX9NQhT4zf7t+ZLJg folded before Flop (didn't bet)
Seat 3: 6+g0Lb6vfRDZkElV8ieHyQ folded before Flop (didn't bet)
Seat 5: kG34n23qFQA3nzdOJTQ1dA (button) folded before Flop (didn't bet)
Seat 6: xQVFeVUDopz+akuEo2wXpQ (small blind) collected ($0.50)




PokerStars Game #59941806626:  Hold'em No Limit ($0.10/$0.25) - 2009/07/01 1:46:45 ET
Table '0M5QEJGOThqZwQ/sjbjXYw' 6-max Seat #6 is the button
Seat 2: /gJNBeCkWL4o85/jvlZ4BA ($34.35 in chips) 
Seat 3: 3zD3qLXT1bEffAoWGnc7wg ($25 in chips) 
Seat 4: oBUDUfeUyCbZBsjxHZgSiw ($22.25 in chips) 
Seat 5: cWc85bEzdRzpUMhRKm8pwQ ($28.20 in chips) 
Seat 6: bb63I02U6p9a5MNFa1gCiw ($26.50 in chips) 
/gJNBeCkWL4o85/jvlZ4BA: posts small blind $0.10
3zD3qLXT1bEffAoWGnc7wg: posts big blind $0.25
*** HOLE CARDS ***
oBUDUfeUyCbZBsjxHZgSiw: folds 
cWc85bEzdRzpUMhRKm8pwQ: raises $0.75 to $1
bb63I02U6p9a5MNFa1gCiw: calls $1
/gJNBeCkWL4o85/jvlZ4BA: folds 
3zD3qLXT1bEffAoWGnc7wg: folds 
*** FLOP *** [Kh Jd 2s]
cWc85bEzdRzpUMhRKm8pwQ: bets $1.50
bb63I02U6p9a5MNFa1gCiw: calls $1.50
*** TURN *** [Kh Jd 2s] [Ad]
cWc85bEzdRzpUMhRKm8pwQ: bets $3
bb63I02U6p9a5MNFa1gCiw: calls $3
*** RIVER *** [Kh Jd 2s Ad] [7d]
cWc85bEzdRzpUMhRKm8pwQ: checks 
bb63I02U6p9a5MNFa1gCiw: checks 
*** SHOW DOWN ***
cWc85bEzdRzpUMhRKm8pwQ: shows [Ah Th] (a pair of Aces)
bb63I02U6p9a5MNFa1gCiw: mucks hand 
cWc85bEzdRzpUMhRKm8pwQ collected $10.80 from pot
*** SUMMARY ***
Total pot $11.35 | Rake $0.55 
Board [Kh Jd 2s Ad 7d]
Seat 2: /gJNBeCkWL4o85/jvlZ4BA (small blind) folded before Flop
Seat 3: 3zD3qLXT1bEffAoWGnc7wg (big blind) folded before Flop
Seat 4: oBUDUfeUyCbZBsjxHZgSiw folded before Flop (didn't bet)
Seat 5: cWc85bEzdRzpUMhRKm8pwQ showed [Ah Th] and won ($10.80) with a pair of Aces
Seat 6: bb63I02U6p9a5MNFa1gCiw (button) mucked




PokerStars Game #59941806712:  Hold'em No Limit ($0.10/$0.25) - 2009/07/01 1:46:45 ET
Table 'WEMI3Mtn7dGARDbgNrKibg' 9-max Seat #3 is the button
Seat 1: Th3FldXKQW6hWVVPahaoOQ ($30.50 in chips) 
Seat 2: tYsOBqdU1+x+yFI7zHO7hQ ($49.20 in chips) 
Seat 3: qwr38jl5txoR36M7G5qi4A ($10 in chips) 
Seat 4: Z5NNIVvnhb2IJbLcI79WYQ ($10.10 in chips) 
Seat 5: yzPZQFeaQTNf1YK3a0zRIw ($9.55 in chips) 
Seat 6: arxNSjreDRGFg13EAM2F1w ($25.45 in chips) 
Seat 7: DnDcAdn9P0zGovMERigpFA ($54.90 in chips) 
Seat 8: ghNKXUBl/H+t83JF079ZBA ($29.60 in chips) 
Seat 9: 2wcFsZsqEP5w1StUTVzJCg ($4.50 in chips) 
Z5NNIVvnhb2IJbLcI79WYQ: posts small blind $0.10
yzPZQFeaQTNf1YK3a0zRIw: posts big blind $0.25
*** HOLE CARDS ***
arxNSjreDRGFg13EAM2F1w: folds 
DnDcAdn9P0zGovMERigpFA: folds 
ghNKXUBl/H+t83JF079ZBA: folds 
2wcFsZsqEP5w1StUTVzJCg: folds 
Th3FldXKQW6hWVVPahaoOQ: folds 
tYsOBqdU1+x+yFI7zHO7hQ: folds 
qwr38jl5txoR36M7G5qi4A: folds 
Z5NNIVvnhb2IJbLcI79WYQ: calls $0.15
yzPZQFeaQTNf1YK3a0zRIw: checks 
*** FLOP *** [Qh Qd 8c]
Z5NNIVvnhb2IJbLcI79WYQ: checks 
yzPZQFeaQTNf1YK3a0zRIw: checks 
*** TURN *** [Qh Qd 8c] [7c]
Z5NNIVvnhb2IJbLcI79WYQ: bets $0.25
yzPZQFeaQTNf1YK3a0zRIw: calls $0.25
*** RIVER *** [Qh Qd 8c 7c] [Tc]
Z5NNIVvnhb2IJbLcI79WYQ: checks 
yzPZQFeaQTNf1YK3a0zRIw: checks 
*** SHOW DOWN ***
Z5NNIVvnhb2IJbLcI79WYQ: shows [4d 7d] (two pair, Queens and Sevens)
yzPZQFeaQTNf1YK3a0zRIw: mucks hand 
Z5NNIVvnhb2IJbLcI79WYQ collected $0.95 from pot
*** SUMMARY ***
Total pot $1 | Rake $0.05 
Board [Qh Qd 8c 7c Tc]
Seat 1: Th3FldXKQW6hWVVPahaoOQ folded before Flop (didn't bet)
Seat 2: tYsOBqdU1+x+yFI7zHO7hQ folded before Flop (didn't bet)
Seat 3: qwr38jl5txoR36M7G5qi4A (button) folded before Flop (didn't bet)
Seat 4: Z5NNIVvnhb2IJbLcI79WYQ (small blind) showed [4d 7d] and won ($0.95) with two pair, Queens and Sevens
Seat 5: yzPZQFeaQTNf1YK3a0zRIw (big blind) mucked
Seat 6: arxNSjreDRGFg13EAM2F1w folded before Flop (didn't bet)
Seat 7: DnDcAdn9P0zGovMERigpFA folded before Flop (didn't bet)
Seat 8: ghNKXUBl/H+t83JF079ZBA folded before Flop (didn't bet)
Seat 9: 2wcFsZsqEP5w1StUTVzJCg folded before Flop (didn't bet)




PokerStars Game #59941806930:  Hold'em No Limit ($0.10/$0.25) - 2009/07/01 1:46:45 ET
Table '8PD/MTROSMd6Y8mZeykbpg' 6-max Seat #2 is the button
Seat 1: fxNpaToxECtD2Goelmg9vA ($28.85 in chips) 
Seat 2: 4TM16KVgEiQpLi4bVVWbVQ ($22.65 in chips) 
Seat 3: vqWjZmdQu/Hxw96/IJTWdQ ($25.10 in chips) 
Seat 4: DFi/Lzkjsfv8QswS80JX9Q ($53.70 in chips) 
Seat 5: z3tQwy28dp5FykDJC/wzQw ($26.55 in chips) 
Seat 6: trN/oHqTTbPw5MNuKrOpLw ($25.70 in chips) 
vqWjZmdQu/Hxw96/IJTWdQ: posts small blind $0.10
DFi/Lzkjsfv8QswS80JX9Q: posts big blind $0.25
*** HOLE CARDS ***
z3tQwy28dp5FykDJC/wzQw: folds 
trN/oHqTTbPw5MNuKrOpLw: raises $0.50 to $0.75
fxNpaToxECtD2Goelmg9vA: folds 
4TM16KVgEiQpLi4bVVWbVQ: raises $1.25 to $2
vqWjZmdQu/Hxw96/IJTWdQ: folds 
DFi/Lzkjsfv8QswS80JX9Q: folds 
trN/oHqTTbPw5MNuKrOpLw: calls $1.25
*** FLOP *** [9h 3h 4h]
trN/oHqTTbPw5MNuKrOpLw: checks 
4TM16KVgEiQpLi4bVVWbVQ: bets $2.50
trN/oHqTTbPw5MNuKrOpLw: folds 
Uncalled bet ($2.50) returned to 4TM16KVgEiQpLi4bVVWbVQ
4TM16KVgEiQpLi4bVVWbVQ collected $4.15 from pot
*** SUMMARY ***
Total pot $4.35 | Rake $0.20 
Board [9h 3h 4h]
Seat 1: fxNpaToxECtD2Goelmg9vA folded before Flop (didn't bet)
Seat 2: 4TM16KVgEiQpLi4bVVWbVQ (button) collected ($4.15)
Seat 3: vqWjZmdQu/Hxw96/IJTWdQ (small blind) folded before Flop
Seat 4: DFi/Lzkjsfv8QswS80JX9Q (big blind) folded before Flop
Seat 5: z3tQwy28dp5FykDJC/wzQw folded before Flop (didn't bet)
Seat 6: trN/oHqTTbPw5MNuKrOpLw folded on the Flop




PokerStars Game #59941806872:  Hold'em No Limit ($0.10/$0.25) - 2009/07/01 1:46:45 ET
Table '7/qMNloI0nSXWiX5Y1watA' 9-max Seat #2 is the button
Seat 1: /LyhaB3V6jkgOfXORidqRQ ($6.75 in chips) 
Seat 2: wGigCmBR/9XWkPpvYos3aQ ($25.85 in chips) 
Seat 3: W2YYHvqjaEpRrO7stZkClQ ($4.10 in chips) 
Seat 4: K0LdhPeU31rviEPo6Sv3TA ($8.65 in chips) 
Seat 6: Y3DZ6qQlLeBhixDj4M9vmg ($16.35 in chips) 
Seat 8: ljemhp25Zg+nlA9DLCIiUw ($26.40 in chips) 
Seat 9: dmYlc+1cjwZMJ7wV+Z0rRg ($26 in chips) 
W2YYHvqjaEpRrO7stZkClQ: posts small blind $0.10
K0LdhPeU31rviEPo6Sv3TA: posts big blind $0.25
*** HOLE CARDS ***
Y3DZ6qQlLeBhixDj4M9vmg: folds 
ljemhp25Zg+nlA9DLCIiUw: folds 
dmYlc+1cjwZMJ7wV+Z0rRg: raises $0.50 to $0.75
/LyhaB3V6jkgOfXORidqRQ: folds 
wGigCmBR/9XWkPpvYos3aQ: calls $0.75
W2YYHvqjaEpRrO7stZkClQ: folds 
K0LdhPeU31rviEPo6Sv3TA: folds 
*** FLOP *** [Jd Kh 4c]
dmYlc+1cjwZMJ7wV+Z0rRg: bets $0.75
wGigCmBR/9XWkPpvYos3aQ: folds 
Uncalled bet ($0.75) returned to dmYlc+1cjwZMJ7wV+Z0rRg
dmYlc+1cjwZMJ7wV+Z0rRg collected $1.80 from pot
dmYlc+1cjwZMJ7wV+Z0rRg: doesn't show hand 
*** SUMMARY ***
Total pot $1.85 | Rake $0.05 
Board [Jd Kh 4c]
Seat 1: /LyhaB3V6jkgOfXORidqRQ folded before Flop (didn't bet)
Seat 2: wGigCmBR/9XWkPpvYos3aQ (button) folded on the Flop
Seat 3: W2YYHvqjaEpRrO7stZkClQ (small blind) folded before Flop
Seat 4: K0LdhPeU31rviEPo6Sv3TA (big blind) folded before Flop
Seat 6: Y3DZ6qQlLeBhixDj4M9vmg folded before Flop (didn't bet)
Seat 8: ljemhp25Zg+nlA9DLCIiUw folded before Flop (didn't bet)
Seat 9: dmYlc+1cjwZMJ7wV+Z0rRg collected ($1.80)




PokerStars Game #59941807128:  Hold'em No Limit ($0.10/$0.25) - 2009/07/01 1:46:46 ET
Table 'dZNBGqFYSwfOVZvDJ4VjIQ' 6-max Seat #4 is the button
Seat 1: v+QfkGiuj9bgtuNoVnDO8w ($37.45 in chips) 
Seat 2: 3zD3qLXT1bEffAoWGnc7wg ($28.95 in chips) 
Seat 3: kyRaCIljYA6l33lSKQfNsg ($28.30 in chips) 
Seat 4: mFv3iBCtrw9XfCDRB0d46Q ($5.80 in chips) 
Seat 5: +ZlnqPoP3Hg4BIUxDfKd/A ($29.35 in chips) 
Seat 6: ypmjhffk/YHGc51wgVXUTw ($29.40 in chips) 
+ZlnqPoP3Hg4BIUxDfKd/A: posts small blind $0.10
ypmjhffk/YHGc51wgVXUTw: posts big blind $0.25
*** HOLE CARDS ***
v+QfkGiuj9bgtuNoVnDO8w: folds 
3zD3qLXT1bEffAoWGnc7wg: folds 
kyRaCIljYA6l33lSKQfNsg: folds 
mFv3iBCtrw9XfCDRB0d46Q: folds 
+ZlnqPoP3Hg4BIUxDfKd/A: folds 
Uncalled bet ($0.15) returned to ypmjhffk/YHGc51wgVXUTw
ypmjhffk/YHGc51wgVXUTw collected $0.20 from pot
ypmjhffk/YHGc51wgVXUTw: doesn't show hand 
*** SUMMARY ***
Total pot $0.20 | Rake $0 
Seat 1: v+QfkGiuj9bgtuNoVnDO8w folded before Flop (didn't bet)
Seat 2: 3zD3qLXT1bEffAoWGnc7wg folded before Flop (didn't bet)
Seat 3: kyRaCIljYA6l33lSKQfNsg folded before Flop (didn't bet)
Seat 4: mFv3iBCtrw9XfCDRB0d46Q (button) folded before Flop (didn't bet)
Seat 5: +ZlnqPoP3Hg4BIUxDfKd/A (small blind) folded before Flop
Seat 6: ypmjhffk/YHGc51wgVXUTw (big blind) collected ($0.20)




PokerStars Game #59941807026:  Hold'em No Limit ($0.10/$0.25) - 2009/07/01 1:46:46 ET
Table '1zj0+miaIL9cvwnT/50pOA' 9-max Seat #5 is the button
Seat 1: PVxvfRTRvkgZf9WtquEkwQ ($25.35 in chips) 
Seat 2: HPEB+AtKw1+C/cxU0o1ciw ($42.95 in chips) 
Seat 3: dtZ84flFEi4Q+SGrHMJRDQ ($29.35 in chips) 
Seat 4: PdIasPkzm2sqZnN41ZRXOg ($5 in chips) 
Seat 5: 57qrNGHDvf6GhB8zVLsAtQ ($8.05 in chips) 
Seat 6: YZaC69gFrepA6oCGtu7E0w ($29.30 in chips) 
Seat 7: 6RiVTYll/5D8zICp0MRpKw ($23.90 in chips) 
Seat 8: Ihhh49x48fayPIyvl2Rsmg ($35.10 in chips) 
Seat 9: AyqFvLFzJDE7yMbXP362BA ($22.05 in chips) 
YZaC69gFrepA6oCGtu7E0w: posts small blind $0.10
6RiVTYll/5D8zICp0MRpKw: posts big blind $0.25
*** HOLE CARDS ***
Ihhh49x48fayPIyvl2Rsmg: folds 
AyqFvLFzJDE7yMbXP362BA: raises $0.75 to $1
PVxvfRTRvkgZf9WtquEkwQ: calls $1
HPEB+AtKw1+C/cxU0o1ciw: folds 
dtZ84flFEi4Q+SGrHMJRDQ: folds 
PdIasPkzm2sqZnN41ZRXOg: folds 
57qrNGHDvf6GhB8zVLsAtQ: folds 
YZaC69gFrepA6oCGtu7E0w: folds 
6RiVTYll/5D8zICp0MRpKw: calls $0.75
*** FLOP *** [Jh Qd 4h]
6RiVTYll/5D8zICp0MRpKw: checks 
AyqFvLFzJDE7yMbXP362BA: bets $1.75
PVxvfRTRvkgZf9WtquEkwQ: calls $1.75
6RiVTYll/5D8zICp0MRpKw: raises $21.15 to $22.90 and is all-in
AyqFvLFzJDE7yMbXP362BA: folds 
PVxvfRTRvkgZf9WtquEkwQ: folds 
Uncalled bet ($21.15) returned to 6RiVTYll/5D8zICp0MRpKw
6RiVTYll/5D8zICp0MRpKw collected $7.95 from pot
*** SUMMARY ***
Total pot $8.35 | Rake $0.40 
Board [Jh Qd 4h]
Seat 1: PVxvfRTRvkgZf9WtquEkwQ folded on the Flop
Seat 2: HPEB+AtKw1+C/cxU0o1ciw folded before Flop (didn't bet)
Seat 3: dtZ84flFEi4Q+SGrHMJRDQ folded before Flop (didn't bet)
Seat 4: PdIasPkzm2sqZnN41ZRXOg folded before Flop (didn't bet)
Seat 5: 57qrNGHDvf6GhB8zVLsAtQ (button) folded before Flop (didn't bet)
Seat 6: YZaC69gFrepA6oCGtu7E0w (small blind) folded before Flop
Seat 7: 6RiVTYll/5D8zICp0MRpKw (big blind) collected ($7.95)
Seat 8: Ihhh49x48fayPIyvl2Rsmg folded before Flop (didn't bet)
Seat 9: AyqFvLFzJDE7yMbXP362BA folded on the Flop




PokerStars Game #59941807392:  Hold'em No Limit ($0.10/$0.25) - 2009/07/01 1:46:46 ET
Table 'zKwHJD0cmKNUure9qQTfFg' 6-max Seat #1 is the button
Seat 1: Hzrn9DZJegEZICufTNYkrg ($19.10 in chips) 
Seat 2: xrf8tAXKQHG99HixCot1Iw ($25 in chips) 
Seat 3: m9aw7LBAB5YX2ZqMtMkhqA ($14.60 in chips) 
Seat 4: v+QfkGiuj9bgtuNoVnDO8w ($25.45 in chips) 
Seat 6: edio/rLJ06xeZOfLhoL3UA ($8.90 in chips) 
xrf8tAXKQHG99HixCot1Iw: posts small blind $0.10
m9aw7LBAB5YX2ZqMtMkhqA: posts big blind $0.25
E4AqQ1egsnu0oH2RqsbCmQ: sits out 
*** HOLE CARDS ***
v+QfkGiuj9bgtuNoVnDO8w: folds 
edio/rLJ06xeZOfLhoL3UA: raises $1 to $1.25
Hzrn9DZJegEZICufTNYkrg: folds 
xrf8tAXKQHG99HixCot1Iw: folds 
m9aw7LBAB5YX2ZqMtMkhqA: folds 
Uncalled bet ($1) returned to edio/rLJ06xeZOfLhoL3UA
edio/rLJ06xeZOfLhoL3UA collected $0.60 from pot
edio/rLJ06xeZOfLhoL3UA: doesn't show hand 
*** SUMMARY ***
Total pot $0.60 | Rake $0 
Seat 1: Hzrn9DZJegEZICufTNYkrg (button) folded before Flop (didn't bet)
Seat 2: xrf8tAXKQHG99HixCot1Iw (small blind) folded before Flop
Seat 3: m9aw7LBAB5YX2ZqMtMkhqA (big blind) folded before Flop
Seat 4: v+QfkGiuj9bgtuNoVnDO8w folded before Flop (didn't bet)
Seat 6: edio/rLJ06xeZOfLhoL3UA collected ($0.60)




PokerStars Game #59941807876:  Hold'em No Limit ($0.10/$0.25) - 2009/07/01 1:46:47 ET
Table '52Meibn9NOL4XtVi1p2UpwpyZQRcpxhWj2y2cT/ydvwwx Seat #4 is the button
Seat 1: egvg3mTBBVzMHnJPIQiKcA ($16.30 in chips) 
Seat 2: Th3FldXKQW6hWVVPahaoOQ ($101.80 in chips) 
Seat 3: zgi+EUykT/pZQpoUG6+oEg ($4.30 in chips) 
Seat 4: NjesyqE7PJi4nEOa0oOq9w ($14.85 in chips) 
Seat 5: 5n7e7I+px7c6CQmLpPbtsg ($4.45 in chips) 
Seat 6: uvfXVx90QtCYG4geTioN+A ($25 in chips) 
Seat 7: sGFnnRCa1YAHAUmWgsW6Qg ($9.50 in chips) 
Seat 8: ipgcO7Pa6LC8XWpVttZfnA ($5 in chips) 
Seat 9: bC+Wg1ntzw3N48OwuR1eag ($5.65 in chips) 
5n7e7I+px7c6CQmLpPbtsg: posts small blind $0.10
uvfXVx90QtCYG4geTioN+A: posts big blind $0.25
*** HOLE CARDS ***
sGFnnRCa1YAHAUmWgsW6Qg: folds 
ipgcO7Pa6LC8XWpVttZfnA: folds 
bC+Wg1ntzw3N48OwuR1eag is disconnected 
bC+Wg1ntzw3N48OwuR1eag is connected 
bC+Wg1ntzw3N48OwuR1eag: raises $0.25 to $0.50
egvg3mTBBVzMHnJPIQiKcA: folds 
Th3FldXKQW6hWVVPahaoOQ: folds 
zgi+EUykT/pZQpoUG6+oEg: folds 
NjesyqE7PJi4nEOa0oOq9w: calls $0.50
5n7e7I+px7c6CQmLpPbtsg: folds 
uvfXVx90QtCYG4geTioN+A: folds 
*** FLOP *** [Th 2s Ad]
bC+Wg1ntzw3N48OwuR1eag is disconnected 
bC+Wg1ntzw3N48OwuR1eag is connected 
bC+Wg1ntzw3N48OwuR1eag: checks 
NjesyqE7PJi4nEOa0oOq9w: bets $0.75
bC+Wg1ntzw3N48OwuR1eag: folds 
Uncalled bet ($0.75) returned to NjesyqE7PJi4nEOa0oOq9w
NjesyqE7PJi4nEOa0oOq9w collected $1.30 from pot
*** SUMMARY ***
Total pot $1.35 | Rake $0.05 
Board [Th 2s Ad]
Seat 1: egvg3mTBBVzMHnJPIQiKcA folded before Flop (didn't bet)
Seat 2: Th3FldXKQW6hWVVPahaoOQ folded before Flop (didn't bet)
Seat 3: zgi+EUykT/pZQpoUG6+oEg folded before Flop (didn't bet)
Seat 4: NjesyqE7PJi4nEOa0oOq9w (button) collected ($1.30)
Seat 5: 5n7e7I+px7c6CQmLpPbtsg (small blind) folded before Flop
Seat 6: uvfXVx90QtCYG4geTioN+A (big blind) folded before Flop
Seat 7: sGFnnRCa1YAHAUmWgsW6Qg folded before Flop (didn't bet)
Seat 8: ipgcO7Pa6LC8XWpVttZfnA folded before Flop (didn't bet)
Seat 9: bC+Wg1ntzw3N48OwuR1eag folded on the Flop




PokerStars Game #59941807506:  Hold'em No Limit ($0.10/$0.25) - 2009/07/01 1:46:47 ET
Table 'Jz+kWRxWNGk9w24fdQEveA' 9-max Seat #1 is the button
Seat 1: Z9W7+g1WMhhZDi7DwGbCFA ($5 in chips) 
Seat 2: ljemhp25Zg+nlA9DLCIiUw ($37.85 in chips) 
Seat 3: N5sUK8M0br9djLrW97V9pQ ($25 in chips) 
Seat 4: HPEB+AtKw1+C/cxU0o1ciw ($29 in chips) 
Seat 5: d6eSA7wOH5mRaSyVDVRBLw ($12.75 in chips) 
Seat 6: BXkjaKe7T/rw37TNNtBVwQ ($5.35 in chips) 
Seat 7: wGigCmBR/9XWkPpvYos3aQ ($26.75 in chips) 
Seat 8: j4q3p0lesp63b1gZDwLBZw ($5 in chips) 
Seat 9: V6p0jQ/RhUsqpHLmXvEX4Q ($17.35 in chips) 
ljemhp25Zg+nlA9DLCIiUw: posts small blind $0.10
N5sUK8M0br9djLrW97V9pQ: posts big blind $0.25
*** HOLE CARDS ***
HPEB+AtKw1+C/cxU0o1ciw: folds 
d6eSA7wOH5mRaSyVDVRBLw: calls $0.25
BXkjaKe7T/rw37TNNtBVwQ: folds 
wGigCmBR/9XWkPpvYos3aQ: raises $1 to $1.25
j4q3p0lesp63b1gZDwLBZw: folds 
V6p0jQ/RhUsqpHLmXvEX4Q: folds 
Z9W7+g1WMhhZDi7DwGbCFA: folds 
ljemhp25Zg+nlA9DLCIiUw: folds 
N5sUK8M0br9djLrW97V9pQ: folds 
d6eSA7wOH5mRaSyVDVRBLw: folds 
Uncalled bet ($1) returned to wGigCmBR/9XWkPpvYos3aQ
wGigCmBR/9XWkPpvYos3aQ collected $0.85 from pot
wGigCmBR/9XWkPpvYos3aQ: doesn't show hand 
*** SUMMARY ***
Total pot $0.85 | Rake $0 
Seat 1: Z9W7+g1WMhhZDi7DwGbCFA (button) folded before Flop (didn't bet)
Seat 2: ljemhp25Zg+nlA9DLCIiUw (small blind) folded before Flop
Seat 3: N5sUK8M0br9djLrW97V9pQ (big blind) folded before Flop
Seat 4: HPEB+AtKw1+C/cxU0o1ciw folded before Flop (didn't bet)
Seat 5: d6eSA7wOH5mRaSyVDVRBLw folded before Flop
Seat 6: BXkjaKe7T/rw37TNNtBVwQ folded before Flop (didn't bet)
Seat 7: wGigCmBR/9XWkPpvYos3aQ collected ($0.85)
Seat 8: j4q3p0lesp63b1gZDwLBZw folded before Flop (didn't bet)
Seat 9: V6p0jQ/RhUsqpHLmXvEX4Q folded before Flop (didn't bet)




PokerStars Game #59941808190:  Hold'em No Limit ($0.10/$0.25) - 2009/07/01 1:46:48 ET
Table 'sJ4KpS2GE5Qrsu1/cFjJUw' 9-max Seat #8 is the button
Seat 1: eDlQ+S+6L4e6gM1dkZhGgQ ($18.45 in chips) 
Seat 2: tYsOBqdU1+x+yFI7zHO7hQ ($31.75 in chips) 
Seat 3: eK8qa6EPcH2zhtbmWSvc9g ($25 in chips) 
Seat 4: npAYqa85pqnzfOK5ukX+BQ ($24 in chips) 
Seat 5: Q/gZC63lfOMr7YhWKPCxoQ ($8.60 in chips) 
Seat 6: OefE+Csvj5KR7ClGf3Hc2g ($4.35 in chips) 
Seat 7: Wi8djHgewBlVhpKWfp7isQ ($8.60 in chips) 
Seat 8: S7Ki0P+0AIGPuIfGJjW0gg ($30.60 in chips) 
Seat 9: 3PmVnC/15cl4oyI1TKIt4g ($4.50 in chips) 
3PmVnC/15cl4oyI1TKIt4g: posts small blind $0.10
eDlQ+S+6L4e6gM1dkZhGgQ: posts big blind $0.25
*** HOLE CARDS ***
tYsOBqdU1+x+yFI7zHO7hQ: folds 
eK8qa6EPcH2zhtbmWSvc9g: folds 
npAYqa85pqnzfOK5ukX+BQ: folds 
Q/gZC63lfOMr7YhWKPCxoQ: raises $0.25 to $0.50
OefE+Csvj5KR7ClGf3Hc2g: calls $0.50
Wi8djHgewBlVhpKWfp7isQ: folds 
S7Ki0P+0AIGPuIfGJjW0gg: folds 
3PmVnC/15cl4oyI1TKIt4g: folds 
eDlQ+S+6L4e6gM1dkZhGgQ: calls $0.25
*** FLOP *** [9s 5s 3h]
eDlQ+S+6L4e6gM1dkZhGgQ: checks 
Q/gZC63lfOMr7YhWKPCxoQ: checks 
OefE+Csvj5KR7ClGf3Hc2g: checks 
*** TURN *** [9s 5s 3h] [6h]
eDlQ+S+6L4e6gM1dkZhGgQ: checks 
Q/gZC63lfOMr7YhWKPCxoQ: checks 
OefE+Csvj5KR7ClGf3Hc2g: checks 
*** RIVER *** [9s 5s 3h 6h] [Jd]
eDlQ+S+6L4e6gM1dkZhGgQ: bets $0.25
Q/gZC63lfOMr7YhWKPCxoQ: folds 
OefE+Csvj5KR7ClGf3Hc2g: folds 
Uncalled bet ($0.25) returned to eDlQ+S+6L4e6gM1dkZhGgQ
eDlQ+S+6L4e6gM1dkZhGgQ collected $1.55 from pot
*** SUMMARY ***
Total pot $1.60 | Rake $0.05 
Board [9s 5s 3h 6h Jd]
Seat 1: eDlQ+S+6L4e6gM1dkZhGgQ (big blind) collected ($1.55)
Seat 2: tYsOBqdU1+x+yFI7zHO7hQ folded before Flop (didn't bet)
Seat 3: eK8qa6EPcH2zhtbmWSvc9g folded before Flop (didn't bet)
Seat 4: npAYqa85pqnzfOK5ukX+BQ folded before Flop (didn't bet)
Seat 5: Q/gZC63lfOMr7YhWKPCxoQ folded on the River
Seat 6: OefE+Csvj5KR7ClGf3Hc2g folded on the River
Seat 7: Wi8djHgewBlVhpKWfp7isQ folded before Flop (didn't bet)
Seat 8: S7Ki0P+0AIGPuIfGJjW0gg (button) folded before Flop (didn't bet)
Seat 9: 3PmVnC/15cl4oyI1TKIt4g (small blind) folded before Flop




PokerStars Game #59941808426:  Hold'em No Limit ($0.10/$0.25) - 2009/07/01 1:46:48 ET
Table 'YlRA05h9BJ1EhOUSNUjJdg' 9-max Seat #9 is the button
Seat 1: dtZ84flFEi4Q+SGrHMJRDQ ($25 in chips) 
Seat 2: Y2GFAe+PT7xnUUtgqCNDFw ($9.30 in chips) 
Seat 3: Z5ZtGOON8kmSdSCll9Z3XA ($13.20 in chips) 
Seat 4: HPEB+AtKw1+C/cxU0o1ciw ($33.95 in chips) 
Seat 5: sx0lGrkT9fd4yFR+3cXUQg ($11.65 in chips) 
Seat 6: QEbIGci+itdw+re8RM5fZA ($44 in chips) 
Seat 7: dfNim92Z6XK1/h5SFW5vDg ($25 in chips) 
Seat 8: dmYlc+1cjwZMJ7wV+Z0rRg ($32.55 in chips) 
Seat 9: Z9AeOQX3yzuSvKAm/xyovg ($10.10 in chips) 
dtZ84flFEi4Q+SGrHMJRDQ: posts small blind $0.10
Y2GFAe+PT7xnUUtgqCNDFw: posts big blind $0.25
*** HOLE CARDS ***
Z5ZtGOON8kmSdSCll9Z3XA: folds 
HPEB+AtKw1+C/cxU0o1ciw: folds 
sx0lGrkT9fd4yFR+3cXUQg: folds 
QEbIGci+itdw+re8RM5fZA: folds 
dfNim92Z6XK1/h5SFW5vDg: folds 
dmYlc+1cjwZMJ7wV+Z0rRg: folds 
Z9AeOQX3yzuSvKAm/xyovg: folds 
dtZ84flFEi4Q+SGrHMJRDQ: calls $0.15
Y2GFAe+PT7xnUUtgqCNDFw: checks 
*** FLOP *** [4h 3c Kd]
dtZ84flFEi4Q+SGrHMJRDQ: checks 
Y2GFAe+PT7xnUUtgqCNDFw: checks 
*** TURN *** [4h 3c Kd] [Kc]
dtZ84flFEi4Q+SGrHMJRDQ: checks 
Y2GFAe+PT7xnUUtgqCNDFw: checks 
*** RIVER *** [4h 3c Kd Kc] [Ts]
dtZ84flFEi4Q+SGrHMJRDQ: checks 
Y2GFAe+PT7xnUUtgqCNDFw: checks 
*** SHOW DOWN ***
dtZ84flFEi4Q+SGrHMJRDQ: shows [6h Th] (two pair, Kings and Tens)
Y2GFAe+PT7xnUUtgqCNDFw: mucks hand 
dtZ84flFEi4Q+SGrHMJRDQ collected $0.50 from pot
*** SUMMARY ***
Total pot $0.50 | Rake $0 
Board [4h 3c Kd Kc Ts]
Seat 1: dtZ84flFEi4Q+SGrHMJRDQ (small blind) showed [6h Th] and won ($0.50) with two pair, Kings and Tens
Seat 2: Y2GFAe+PT7xnUUtgqCNDFw (big blind) mucked
Seat 3: Z5ZtGOON8kmSdSCll9Z3XA folded before Flop (didn't bet)
Seat 4: HPEB+AtKw1+C/cxU0o1ciw folded before Flop (didn't bet)
Seat 5: sx0lGrkT9fd4yFR+3cXUQg folded before Flop (didn't bet)
Seat 6: QEbIGci+itdw+re8RM5fZA folded before Flop (didn't bet)
Seat 7: dfNim92Z6XK1/h5SFW5vDg folded before Flop (didn't bet)
Seat 8: dmYlc+1cjwZMJ7wV+Z0rRg folded before Flop (didn't bet)
Seat 9: Z9AeOQX3yzuSvKAm/xyovg (button) folded before Flop (didn't bet)




PokerStars Game #59941808054:  Hold'em No Limit ($0.10/$0.25) - 2009/07/01 1:46:48 ET
Table '8QBBaev+cI2i/r2H6ml/lg' 9-max Seat #7 is the button
Seat 1: s2xLPOl/vhl/26apJ3vsOQ ($35.80 in chips) 
Seat 2: y7tkvDmwKjURBkr73SZPXw ($12.25 in chips) 
Seat 3: zgi+EUykT/pZQpoUG6+oEg ($4.30 in chips) 
Seat 4: ytpGB2nr/CLVHnyKMRiEFQ ($16 in chips) 
Seat 5: 0QdZrkFD7aGKeBXPGbIomA ($11.45 in chips) 
Seat 6: X6+pSIPfovPcE87t+LmUKQ ($5.25 in chips) 
Seat 7: eK8qa6EPcH2zhtbmWSvc9g ($30.70 in chips) 
Seat 8: vr1IK/Q4HXm8s8V0/dePzQ ($11.35 in chips) 
Seat 9: EUMLvzDkECHBit+xa+uGjg ($24.75 in chips) 
vr1IK/Q4HXm8s8V0/dePzQ: posts small blind $0.10
EUMLvzDkECHBit+xa+uGjg: posts big blind $0.25
*** HOLE CARDS ***
s2xLPOl/vhl/26apJ3vsOQ: folds 
y7tkvDmwKjURBkr73SZPXw: folds 
zgi+EUykT/pZQpoUG6+oEg: folds 
ytpGB2nr/CLVHnyKMRiEFQ: folds 
0QdZrkFD7aGKeBXPGbIomA: folds 
X6+pSIPfovPcE87t+LmUKQ: folds 
eK8qa6EPcH2zhtbmWSvc9g: folds 
vr1IK/Q4HXm8s8V0/dePzQ: calls $0.15
EUMLvzDkECHBit+xa+uGjg: checks 
*** FLOP *** [7c Td 7h]
vr1IK/Q4HXm8s8V0/dePzQ: bets $0.50
EUMLvzDkECHBit+xa+uGjg: folds 
Uncalled bet ($0.50) returned to vr1IK/Q4HXm8s8V0/dePzQ
vr1IK/Q4HXm8s8V0/dePzQ collected $0.50 from pot
vr1IK/Q4HXm8s8V0/dePzQ: doesn't show hand 
*** SUMMARY ***
Total pot $0.50 | Rake $0 
Board [7c Td 7h]
Seat 1: s2xLPOl/vhl/26apJ3vsOQ folded before Flop (didn't bet)
Seat 2: y7tkvDmwKjURBkr73SZPXw folded before Flop (didn't bet)
Seat 3: zgi+EUykT/pZQpoUG6+oEg folded before Flop (didn't bet)
Seat 4: ytpGB2nr/CLVHnyKMRiEFQ folded before Flop (didn't bet)
Seat 5: 0QdZrkFD7aGKeBXPGbIomA folded before Flop (didn't bet)
Seat 6: X6+pSIPfovPcE87t+LmUKQ folded before Flop (didn't bet)
Seat 7: eK8qa6EPcH2zhtbmWSvc9g (button) folded before Flop (didn't bet)
Seat 8: vr1IK/Q4HXm8s8V0/dePzQ (small blind) collected ($0.50)
Seat 9: EUMLvzDkECHBit+xa+uGjg (big blind) folded on the Flop




PokerStars Game #59941808388:  Hold'em No Limit ($0.10/$0.25) - 2009/07/01 1:46:48 ET
Table 'GrYi0DZOHD1EvB+qiLExNw' 9-max Seat #4 is the button
Seat 2: Th3FldXKQW6hWVVPahaoOQ ($46.70 in chips) 
Seat 3: RHqgdFvufLCYe54+qd2gcA ($5 in chips) 
Seat 4: 8x95tVlB4uFBVHp71KihMA ($35.40 in chips) 
Seat 5: cZ99hugmLBj9KhTlc8nCSw ($25.05 in chips) 
Seat 6: arxNSjreDRGFg13EAM2F1w ($25 in chips) 
Seat 7: 9lvO/qyU+xrU95Teu1fv0g ($23.55 in chips) 
Seat 8: MtVtHDqIJTyUcXkRBBDIVA ($25 in chips) 
Seat 9: 5hAPbqNrvJb8PtLiceXtlg ($13.40 in chips) 
cZ99hugmLBj9KhTlc8nCSw: posts small blind $0.10
arxNSjreDRGFg13EAM2F1w: posts big blind $0.25
7je+LC5Mfs6nL8YBVh4frQ: sits out 
RHqgdFvufLCYe54+qd2gcA: posts big blind $0.25
*** HOLE CARDS ***
9lvO/qyU+xrU95Teu1fv0g: folds 
MtVtHDqIJTyUcXkRBBDIVA: folds 
5hAPbqNrvJb8PtLiceXtlg: folds 
Th3FldXKQW6hWVVPahaoOQ: folds 
RHqgdFvufLCYe54+qd2gcA: checks 
8x95tVlB4uFBVHp71KihMA: folds 
cZ99hugmLBj9KhTlc8nCSw: folds 
arxNSjreDRGFg13EAM2F1w: checks 
*** FLOP *** [5h 9h 2h]
arxNSjreDRGFg13EAM2F1w: checks 
RHqgdFvufLCYe54+qd2gcA: checks 
*** TURN *** [5h 9h 2h] [Kd]
arxNSjreDRGFg13EAM2F1w: bets $0.25
RHqgdFvufLCYe54+qd2gcA: folds 
Uncalled bet ($0.25) returned to arxNSjreDRGFg13EAM2F1w
arxNSjreDRGFg13EAM2F1w collected $0.60 from pot
arxNSjreDRGFg13EAM2F1w: doesn't show hand 
*** SUMMARY ***
Total pot $0.60 | Rake $0 
Board [5h 9h 2h Kd]
Seat 2: Th3FldXKQW6hWVVPahaoOQ folded before Flop (didn't bet)
Seat 3: RHqgdFvufLCYe54+qd2gcA folded on the Turn
Seat 4: 8x95tVlB4uFBVHp71KihMA (button) folded before Flop (didn't bet)
Seat 5: cZ99hugmLBj9KhTlc8nCSw (small blind) folded before Flop
Seat 6: arxNSjreDRGFg13EAM2F1w (big blind) collected ($0.60)
Seat 7: 9lvO/qyU+xrU95Teu1fv0g folded before Flop (didn't bet)
Seat 8: MtVtHDqIJTyUcXkRBBDIVA folded before Flop (didn't bet)
Seat 9: 5hAPbqNrvJb8PtLiceXtlg folded before Flop (didn't bet)




PokerStars Game #59941808082:  Hold'em No Limit ($0.10/$0.25) - 2009/07/01 1:46:48 ET
Table '8Z6T3ssCpo3VV849U4RgBw' 9-max Seat #2 is the button
Seat 1: Z9W7+g1WMhhZDi7DwGbCFA ($6.15 in chips) 
Seat 2: SpiiQQAzy4MUgV3I5W8giw ($19.10 in chips) 
Seat 3: tLcDklc2rBORNfixyRfVfw ($41.25 in chips) 
Seat 4: RCqMONFrSPSArZh2Jsar/w ($18.90 in chips) 
Seat 6: sGFnnRCa1YAHAUmWgsW6Qg ($10 in chips) 
Seat 7: oLa/tXLfSLLB28mcLGrxcg ($24.05 in chips) 
Seat 8: PdIasPkzm2sqZnN41ZRXOg ($5.25 in chips) 
Seat 9: HDDm1BkZtdsRyw2DJdqq6A ($27.50 in chips) 
tLcDklc2rBORNfixyRfVfw: posts small blind $0.10
RCqMONFrSPSArZh2Jsar/w: posts big blind $0.25
*** HOLE CARDS ***
sGFnnRCa1YAHAUmWgsW6Qg: calls $0.25
oLa/tXLfSLLB28mcLGrxcg: folds 
PdIasPkzm2sqZnN41ZRXOg: folds 
HDDm1BkZtdsRyw2DJdqq6A: folds 
Z9W7+g1WMhhZDi7DwGbCFA: folds 
SpiiQQAzy4MUgV3I5W8giw: folds 
tLcDklc2rBORNfixyRfVfw: folds 
RCqMONFrSPSArZh2Jsar/w: checks 
*** FLOP *** [2h Qc Ad]
zDrucyjVn5aeekNEc3cJrA has returned
RCqMONFrSPSArZh2Jsar/w: checks 
sGFnnRCa1YAHAUmWgsW6Qg: bets $0.75
RCqMONFrSPSArZh2Jsar/w: raises $0.75 to $1.50
sGFnnRCa1YAHAUmWgsW6Qg: folds 
Uncalled bet ($0.75) returned to RCqMONFrSPSArZh2Jsar/w
RCqMONFrSPSArZh2Jsar/w collected $2 from pot
RCqMONFrSPSArZh2Jsar/w: doesn't show hand 
*** SUMMARY ***
Total pot $2.10 | Rake $0.10 
Board [2h Qc Ad]
Seat 1: Z9W7+g1WMhhZDi7DwGbCFA folded before Flop (didn't bet)
Seat 2: SpiiQQAzy4MUgV3I5W8giw (button) folded before Flop (didn't bet)
Seat 3: tLcDklc2rBORNfixyRfVfw (small blind) folded before Flop
Seat 4: RCqMONFrSPSArZh2Jsar/w (big blind) collected ($2)
Seat 6: sGFnnRCa1YAHAUmWgsW6Qg folded on the Flop
Seat 7: oLa/tXLfSLLB28mcLGrxcg folded before Flop (didn't bet)
Seat 8: PdIasPkzm2sqZnN41ZRXOg folded before Flop (didn't bet)
Seat 9: HDDm1BkZtdsRyw2DJdqq6A folded before Flop (didn't bet)




PokerStars Game #59941807992:  Hold'em No Limit ($0.10/$0.25) - 2009/07/01 1:46:48 ET
Table 'LG9H161ZAHDkOww+ih3Ptg' 6-max Seat #6 is the button
Seat 1: avl8CO/tc0F6eVSiB/KNRA ($24.50 in chips) 
Seat 2: kwsRmpZ1ZaLooISs+zfyKg ($25.70 in chips) 
Seat 3: 5Evvx7UYqXTBuvIc/9s/hA ($15.20 in chips) 
Seat 4: 0C28L4/59aRNtHoBhqTcLg ($60.05 in chips) 
Seat 6: v8m8XHovI5tqEA9mvplDSw ($27.60 in chips) 
avl8CO/tc0F6eVSiB/KNRA: posts small blind $0.10
kwsRmpZ1ZaLooISs+zfyKg: posts big blind $0.25
Nessi BÃ¤r: sits out 
*** HOLE CARDS ***
5Evvx7UYqXTBuvIc/9s/hA: folds 
0C28L4/59aRNtHoBhqTcLg: raises $0.40 to $0.65
v8m8XHovI5tqEA9mvplDSw: folds 
avl8CO/tc0F6eVSiB/KNRA: calls $0.55
kwsRmpZ1ZaLooISs+zfyKg: folds 
*** FLOP *** [6h 9s Tc]
avl8CO/tc0F6eVSiB/KNRA: checks 
0C28L4/59aRNtHoBhqTcLg: bets $0.55
avl8CO/tc0F6eVSiB/KNRA: calls $0.55
*** TURN *** [6h 9s Tc] [6s]
avl8CO/tc0F6eVSiB/KNRA: checks 
0C28L4/59aRNtHoBhqTcLg: checks 
*** RIVER *** [6h 9s Tc 6s] [Js]
avl8CO/tc0F6eVSiB/KNRA: checks 
0C28L4/59aRNtHoBhqTcLg: checks 
*** SHOW DOWN ***
avl8CO/tc0F6eVSiB/KNRA: shows [Th Ad] (two pair, Tens and Sixes)
0C28L4/59aRNtHoBhqTcLg: mucks hand 
avl8CO/tc0F6eVSiB/KNRA collected $2.55 from pot
*** SUMMARY ***
Total pot $2.65 | Rake $0.10 
Board [6h 9s Tc 6s Js]
Seat 1: avl8CO/tc0F6eVSiB/KNRA (small blind) showed [Th Ad] and won ($2.55) with two pair, Tens and Sixes
Seat 2: kwsRmpZ1ZaLooISs+zfyKg (big blind) folded before Flop
Seat 3: 5Evvx7UYqXTBuvIc/9s/hA folded before Flop (didn't bet)
Seat 4: 0C28L4/59aRNtHoBhqTcLg mucked
Seat 6: v8m8XHovI5tqEA9mvplDSw (button) folded before Flop (didn't bet)




PokerStars Game #59941808218:  Hold'em No Limit ($0.10/$0.25) - 2009/07/01 1:46:48 ET
Table 'HbNAGS1OJWQKyfk7UfrYyw' 9-max Seat #6 is the button
Seat 2: fjwM06E3HzjUrynPRQi31Q ($6.10 in chips) 
Seat 3: Yxal0LG80xJqTIctpMLWlg ($5 in chips) 
Seat 5: z2SmIaQ3+5n/eY1BN5HgPg ($6.65 in chips) 
Seat 6: jntAuOS+eFQDYNiDN8dzag ($12.50 in chips) 
sliprywinwet will be allowed to play after the button
DiSvPC2iudwL5j9u6Huyww will be allowed to play after the button
Crucial_25 will be allowed to play after the button
maurito42 will be allowed to play after the button
fjwM06E3HzjUrynPRQi31Q: posts small blind $0.10
Yxal0LG80xJqTIctpMLWlg: posts big blind $0.25
sybren1st: sits out 
*** HOLE CARDS ***
z2SmIaQ3+5n/eY1BN5HgPg: calls $0.25
jntAuOS+eFQDYNiDN8dzag: folds 
fjwM06E3HzjUrynPRQi31Q: folds 
Yxal0LG80xJqTIctpMLWlg: checks 
*** FLOP *** [5c Ts Kd]
Yxal0LG80xJqTIctpMLWlg: checks 
z2SmIaQ3+5n/eY1BN5HgPg: bets $0.25
Yxal0LG80xJqTIctpMLWlg: calls $0.25
*** TURN *** [5c Ts Kd] [9s]
Yxal0LG80xJqTIctpMLWlg: checks 
z2SmIaQ3+5n/eY1BN5HgPg: bets $0.75
Yxal0LG80xJqTIctpMLWlg: calls $0.75
*** RIVER *** [5c Ts Kd 9s] [3s]
Yxal0LG80xJqTIctpMLWlg: checks 
z2SmIaQ3+5n/eY1BN5HgPg: bets $3.75
Yxal0LG80xJqTIctpMLWlg: folds 
Uncalled bet ($3.75) returned to z2SmIaQ3+5n/eY1BN5HgPg
z2SmIaQ3+5n/eY1BN5HgPg collected $2.50 from pot
z2SmIaQ3+5n/eY1BN5HgPg: doesn't show hand 
z2SmIaQ3+5n/eY1BN5HgPg leaves the table
*** SUMMARY ***
Total pot $2.60 | Rake $0.10 
Board [5c Ts Kd 9s 3s]
Seat 2: fjwM06E3HzjUrynPRQi31Q (small blind) folded before Flop
Seat 3: Yxal0LG80xJqTIctpMLWlg (big blind) folded on the River
Seat 5: z2SmIaQ3+5n/eY1BN5HgPg collected ($2.50)
Seat 6: jntAuOS+eFQDYNiDN8dzag (button) folded before Flop (didn't bet)




PokerStars Game #59941808384:  Hold'em No Limit ($0.10/$0.25) - 2009/07/01 1:46:48 ET
Table '6wawJ+MkkvuC3coG6r+Yhg' 6-max Seat #6 is the button
Seat 1: JQZew0FjzS19kTjeNtrE+A ($28.35 in chips) 
Seat 2: LtASJ9OlkqGrrUKGQlpGAw ($34.15 in chips) 
Seat 3: 3zD3qLXT1bEffAoWGnc7wg ($61.25 in chips) 
Seat 4: yxmjNFGiKI3b+XQGJzJVIg ($26.10 in chips) 
Seat 5: FZrgDbxAanC1xwZxXHJKVA ($4.30 in chips) 
Seat 6: B3X187C0tXFUfQpCu8pe8A ($25.15 in chips) 
JQZew0FjzS19kTjeNtrE+A: posts small blind $0.10
LtASJ9OlkqGrrUKGQlpGAw: posts big blind $0.25
*** HOLE CARDS ***
3zD3qLXT1bEffAoWGnc7wg: folds 
yxmjNFGiKI3b+XQGJzJVIg: raises $0.50 to $0.75
FZrgDbxAanC1xwZxXHJKVA: folds 
B3X187C0tXFUfQpCu8pe8A: folds 
JQZew0FjzS19kTjeNtrE+A: calls $0.65
LtASJ9OlkqGrrUKGQlpGAw: folds 
*** FLOP *** [6h 4h Kd]
JQZew0FjzS19kTjeNtrE+A: checks 
yxmjNFGiKI3b+XQGJzJVIg: bets $1.25
JQZew0FjzS19kTjeNtrE+A: calls $1.25
*** TURN *** [6h 4h Kd] [Kh]
JQZew0FjzS19kTjeNtrE+A: checks 
yxmjNFGiKI3b+XQGJzJVIg: bets $2.25
JQZew0FjzS19kTjeNtrE+A: calls $2.25
*** RIVER *** [6h 4h Kd Kh] [Js]
JQZew0FjzS19kTjeNtrE+A: checks 
yxmjNFGiKI3b+XQGJzJVIg: bets $4.25
JQZew0FjzS19kTjeNtrE+A: calls $4.25
*** SHOW DOWN ***
yxmjNFGiKI3b+XQGJzJVIg: shows [Ks Ah] (three of a kind, Kings)
JQZew0FjzS19kTjeNtrE+A: mucks hand 
yxmjNFGiKI3b+XQGJzJVIg collected $16.45 from pot
*** SUMMARY ***
Total pot $17.25 | Rake $0.80 
Board [6h 4h Kd Kh Js]
Seat 1: JQZew0FjzS19kTjeNtrE+A (small blind) mucked
Seat 2: LtASJ9OlkqGrrUKGQlpGAw (big blind) folded before Flop
Seat 3: 3zD3qLXT1bEffAoWGnc7wg folded before Flop (didn't bet)
Seat 4: yxmjNFGiKI3b+XQGJzJVIg showed [Ks Ah] and won ($16.45) with three of a kind, Kings
Seat 5: FZrgDbxAanC1xwZxXHJKVA folded before Flop (didn't bet)
Seat 6: B3X187C0tXFUfQpCu8pe8A (button) folded before Flop (didn't bet)




PokerStars Game #59941808272:  Hold'em No Limit ($0.10/$0.25) - 2009/07/01 1:46:48 ET
Table 'Qr+t8WGovMECkBv+cV1lrg' 6-max Seat #1 is the button
Seat 1: EeUZtMU058v2ObUACOF4Og ($44.75 in chips) 
Seat 2: vqWjZmdQu/Hxw96/IJTWdQ ($25 in chips) 
Seat 3: uZKkrGByYgd4/ZBX2d4z+w ($26.75 in chips) 
Seat 4: 1NNFfYMd5Hsphl/FYz9fNA ($62.65 in chips) 
Seat 5: 9q7YGTKe9k5fYb4fmZc3Ww ($32 in chips) 
Seat 6: 9U3ZKjCsarN0DjR6mSE8Ug ($14 in chips) 
vqWjZmdQu/Hxw96/IJTWdQ: posts small blind $0.10
uZKkrGByYgd4/ZBX2d4z+w: posts big blind $0.25
*** HOLE CARDS ***
1NNFfYMd5Hsphl/FYz9fNA: raises $0.50 to $0.75
9q7YGTKe9k5fYb4fmZc3Ww: folds 
9U3ZKjCsarN0DjR6mSE8Ug: folds 
EeUZtMU058v2ObUACOF4Og: folds 
vqWjZmdQu/Hxw96/IJTWdQ: raises $1.75 to $2.50
uZKkrGByYgd4/ZBX2d4z+w: calls $2.25
1NNFfYMd5Hsphl/FYz9fNA: calls $1.75
*** FLOP *** [9c Ts Ks]
vqWjZmdQu/Hxw96/IJTWdQ: bets $2
uZKkrGByYgd4/ZBX2d4z+w: calls $2
1NNFfYMd5Hsphl/FYz9fNA: folds 
*** TURN *** [9c Ts Ks] [Js]
vqWjZmdQu/Hxw96/IJTWdQ: checks 
uZKkrGByYgd4/ZBX2d4z+w: bets $2
vqWjZmdQu/Hxw96/IJTWdQ: calls $2
*** RIVER *** [9c Ts Ks Js] [Td]
vqWjZmdQu/Hxw96/IJTWdQ: bets $9.25
uZKkrGByYgd4/ZBX2d4z+w: calls $9.25
*** SHOW DOWN ***
vqWjZmdQu/Hxw96/IJTWdQ: shows [Kc Kd] (a full house, Kings full of Tens)
uZKkrGByYgd4/ZBX2d4z+w: shows [Qh Qd] (a straight, Nine to King)
vqWjZmdQu/Hxw96/IJTWdQ collected $32.35 from pot
*** SUMMARY ***
Total pot $34 | Rake $1.65 
Board [9c Ts Ks Js Td]
Seat 1: EeUZtMU058v2ObUACOF4Og (button) folded before Flop (didn't bet)
Seat 2: vqWjZmdQu/Hxw96/IJTWdQ (small blind) showed [Kc Kd] and won ($32.35) with a full house, Kings full of Tens
Seat 3: uZKkrGByYgd4/ZBX2d4z+w (big blind) showed [Qh Qd] and lost with a straight, Nine to King
Seat 4: 1NNFfYMd5Hsphl/FYz9fNA folded on the Flop
Seat 5: 9q7YGTKe9k5fYb4fmZc3Ww folded before Flop (didn't bet)
Seat 6: 9U3ZKjCsarN0DjR6mSE8Ug folded before Flop (didn't bet)




PokerStars Game #59941808150:  Hold'em No Limit ($0.10/$0.25) - 2009/07/01 1:46:48 ET
Table '+UzantPJ4smVdrh+4GTu1w' 6-max Seat #6 is the button
Seat 1: TSmua8tGK3sTbwi0ynrW9Q ($27.85 in chips) 
Seat 2: tcbEu7VzyHQ+0lh+skbQhQ ($41.35 in chips) 
Seat 3: SS/yfeArhULzIcOPe8MdPg ($34.50 in chips) 
Seat 4: UmcUp27+PbgBItv3ZNlAWQ ($26.80 in chips) 
Seat 5: cj4VBQya7HtVL2zCGd5jLQ ($55.70 in chips) 
Seat 6: fZQg9veL7Dd/Z04ZTjC+wQ ($25 in chips) 
TSmua8tGK3sTbwi0ynrW9Q: posts small blind $0.10
tcbEu7VzyHQ+0lh+skbQhQ: posts big blind $0.25
*** HOLE CARDS ***
SS/yfeArhULzIcOPe8MdPg: folds 
UmcUp27+PbgBItv3ZNlAWQ: folds 
cj4VBQya7HtVL2zCGd5jLQ: folds 
fZQg9veL7Dd/Z04ZTjC+wQ: folds 
TSmua8tGK3sTbwi0ynrW9Q: raises $0.75 to $1
tcbEu7VzyHQ+0lh+skbQhQ: raises $1.50 to $2.50
TSmua8tGK3sTbwi0ynrW9Q: raises $4 to $6.50
tcbEu7VzyHQ+0lh+skbQhQ: calls $4
*** FLOP *** [Js Jc Tc]
TSmua8tGK3sTbwi0ynrW9Q: checks 
tcbEu7VzyHQ+0lh+skbQhQ: bets $5
TSmua8tGK3sTbwi0ynrW9Q: calls $5
*** TURN *** [Js Jc Tc] [As]
TSmua8tGK3sTbwi0ynrW9Q: checks 
tcbEu7VzyHQ+0lh+skbQhQ: checks 
*** RIVER *** [Js Jc Tc As] [Td]
TSmua8tGK3sTbwi0ynrW9Q: bets $12
tcbEu7VzyHQ+0lh+skbQhQ: folds 
Uncalled bet ($12) returned to TSmua8tGK3sTbwi0ynrW9Q
TSmua8tGK3sTbwi0ynrW9Q collected $21.90 from pot
*** SUMMARY ***
Total pot $23 | Rake $1.10 
Board [Js Jc Tc As Td]
Seat 1: TSmua8tGK3sTbwi0ynrW9Q (small blind) collected ($21.90)
Seat 2: tcbEu7VzyHQ+0lh+skbQhQ (big blind) folded on the River
Seat 3: SS/yfeArhULzIcOPe8MdPg folded before Flop (didn't bet)
Seat 4: UmcUp27+PbgBItv3ZNlAWQ folded before Flop (didn't bet)
Seat 5: cj4VBQya7HtVL2zCGd5jLQ folded before Flop (didn't bet)
Seat 6: fZQg9veL7Dd/Z04ZTjC+wQ (button) folded before Flop (didn't bet)




PokerStars Game #59941808130:  Hold'em No Limit ($0.10/$0.25) - 2009/07/01 1:46:48 ET
Table 'x7YStLKc8hpt/pTgSetPKA' 9-max Seat #1 is the button
Seat 1: tYsOBqdU1+x+yFI7zHO7hQ ($25.90 in chips) 
Seat 3: S7Ki0P+0AIGPuIfGJjW0gg ($11.35 in chips) 
Seat 4: ydoFOVgzvZv9ZhuWu9rXAw ($5.15 in chips) 
Seat 6: 9YN2IkT2JYYKFErZtZvCtA ($49.25 in chips) 
Seat 7: dtZ84flFEi4Q+SGrHMJRDQ ($26 in chips) 
Seat 8: j4q3p0lesp63b1gZDwLBZw ($5 in chips) 
Seat 9: nm4Dj/f+jJEwKVsUnKh73g ($35.95 in chips) 
S7Ki0P+0AIGPuIfGJjW0gg: posts small blind $0.10
ydoFOVgzvZv9ZhuWu9rXAw: posts big blind $0.25
tLcDklc2rBORNfixyRfVfw: sits out 
*** HOLE CARDS ***
9YN2IkT2JYYKFErZtZvCtA: folds 
dtZ84flFEi4Q+SGrHMJRDQ: folds 
j4q3p0lesp63b1gZDwLBZw: folds 
nm4Dj/f+jJEwKVsUnKh73g: folds 
tYsOBqdU1+x+yFI7zHO7hQ: folds 
S7Ki0P+0AIGPuIfGJjW0gg: raises $0.50 to $0.75
ydoFOVgzvZv9ZhuWu9rXAw: folds 
Uncalled bet ($0.50) returned to S7Ki0P+0AIGPuIfGJjW0gg
S7Ki0P+0AIGPuIfGJjW0gg collected $0.50 from pot
S7Ki0P+0AIGPuIfGJjW0gg: doesn't show hand 
*** SUMMARY ***
Total pot $0.50 | Rake $0 
Seat 1: tYsOBqdU1+x+yFI7zHO7hQ (button) folded before Flop (didn't bet)
Seat 3: S7Ki0P+0AIGPuIfGJjW0gg (small blind) collected ($0.50)
Seat 4: ydoFOVgzvZv9ZhuWu9rXAw (big blind) folded before Flop
Seat 6: 9YN2IkT2JYYKFErZtZvCtA folded before Flop (didn't bet)
Seat 7: dtZ84flFEi4Q+SGrHMJRDQ folded before Flop (didn't bet)
Seat 8: j4q3p0lesp63b1gZDwLBZw folded before Flop (didn't bet)
Seat 9: nm4Dj/f+jJEwKVsUnKh73g folded before Flop (didn't bet)




PokerStars Game #59941808728:  Hold'em No Limit ($0.10/$0.25) - 2009/07/01 1:46:49 ET
Table 'a6FCGVBMPcT7J7BDN9q1zQ' 9-max Seat #6 is the button
Seat 2: M2QO2DxB5Wawg2h8HSpnYA ($13.45 in chips) 
Seat 3: tLcDklc2rBORNfixyRfVfw ($25 in chips) 
Seat 5: dtZ84flFEi4Q+SGrHMJRDQ ($26.80 in chips) 
Seat 6: dfNim92Z6XK1/h5SFW5vDg ($25 in chips) 
Seat 7: V0Yo5zRBVM8DYspLKafebg ($5.05 in chips) 
Seat 8: r6hsffOo1iKmaPYKwAZmFw ($66.95 in chips) 
Seat 9: wGigCmBR/9XWkPpvYos3aQ ($28.35 in chips) 
V0Yo5zRBVM8DYspLKafebg: posts small blind $0.10
r6hsffOo1iKmaPYKwAZmFw: posts big blind $0.25
bXpVeaSTPBFSPJmeXxO7nw: sits out 
8EbrQ/EvFWt2cr0GaU82gQ: sits out 
*** HOLE CARDS ***
wGigCmBR/9XWkPpvYos3aQ: folds 
M2QO2DxB5Wawg2h8HSpnYA: folds 
tLcDklc2rBORNfixyRfVfw: folds 
dtZ84flFEi4Q+SGrHMJRDQ: calls $0.25
dfNim92Z6XK1/h5SFW5vDg: folds 
V0Yo5zRBVM8DYspLKafebg: calls $0.15
r6hsffOo1iKmaPYKwAZmFw: checks 
*** FLOP *** [4s Qh 6c]
V0Yo5zRBVM8DYspLKafebg: checks 
r6hsffOo1iKmaPYKwAZmFw: checks 
dtZ84flFEi4Q+SGrHMJRDQ: checks 
*** TURN *** [4s Qh 6c] [Tc]
V0Yo5zRBVM8DYspLKafebg: checks 
r6hsffOo1iKmaPYKwAZmFw: bets $0.75
dtZ84flFEi4Q+SGrHMJRDQ: folds 
V0Yo5zRBVM8DYspLKafebg: calls $0.75
*** RIVER *** [4s Qh 6c Tc] [6s]
V0Yo5zRBVM8DYspLKafebg: bets $1.25
r6hsffOo1iKmaPYKwAZmFw: calls $1.25
*** SHOW DOWN ***
V0Yo5zRBVM8DYspLKafebg: shows [6d 5s] (three of a kind, Sixes)
r6hsffOo1iKmaPYKwAZmFw: mucks hand 
V0Yo5zRBVM8DYspLKafebg collected $4.55 from pot
*** SUMMARY ***
Total pot $4.75 | Rake $0.20 
Board [4s Qh 6c Tc 6s]
Seat 2: M2QO2DxB5Wawg2h8HSpnYA folded before Flop (didn't bet)
Seat 3: tLcDklc2rBORNfixyRfVfw folded before Flop (didn't bet)
Seat 5: dtZ84flFEi4Q+SGrHMJRDQ folded on the Turn
Seat 6: dfNim92Z6XK1/h5SFW5vDg (button) folded before Flop (didn't bet)
Seat 7: V0Yo5zRBVM8DYspLKafebg (small blind) showed [6d 5s] and won ($4.55) with three of a kind, Sixes
Seat 8: r6hsffOo1iKmaPYKwAZmFw (big blind) mucked
Seat 9: wGigCmBR/9XWkPpvYos3aQ folded before Flop (didn't bet)




PokerStars Game #59941808920:  Hold'em No Limit ($0.10/$0.25) - 2009/07/01 1:46:49 ET
Table 'M8kYidAX3ib7pLKW7edFLw' 6-max Seat #1 is the button
Seat 1: jp34e617tIzV8tKIWmfAbA ($25 in chips) 
Seat 2: ypmjhffk/YHGc51wgVXUTw ($25 in chips) 
Seat 3: cezpHJ8FB07dj0xG+LhOvw ($27.10 in chips) 
Seat 4: Hsvkc0/G2VV78oVmWYXecw ($5.30 in chips) 
Seat 5: bDKopKTvPi3W+PEnYUX3tg ($46 in chips) 
Seat 6: NqFoyDgzLwu4dOmSRXnFBA ($25.25 in chips) 
ypmjhffk/YHGc51wgVXUTw: posts small blind $0.10
cezpHJ8FB07dj0xG+LhOvw: posts big blind $0.25
*** HOLE CARDS ***
Hsvkc0/G2VV78oVmWYXecw: folds 
bDKopKTvPi3W+PEnYUX3tg: raises $0.50 to $0.75
NqFoyDgzLwu4dOmSRXnFBA: folds 
jp34e617tIzV8tKIWmfAbA: folds 
ypmjhffk/YHGc51wgVXUTw: folds 
cezpHJ8FB07dj0xG+LhOvw: folds 
Uncalled bet ($0.50) returned to bDKopKTvPi3W+PEnYUX3tg
bDKopKTvPi3W+PEnYUX3tg collected $0.60 from pot
bDKopKTvPi3W+PEnYUX3tg: doesn't show hand 
*** SUMMARY ***
Total pot $0.60 | Rake $0 
Seat 1: jp34e617tIzV8tKIWmfAbA (button) folded before Flop (didn't bet)
Seat 2: ypmjhffk/YHGc51wgVXUTw (small blind) folded before Flop
Seat 3: cezpHJ8FB07dj0xG+LhOvw (big blind) folded before Flop
Seat 4: Hsvkc0/G2VV78oVmWYXecw folded before Flop (didn't bet)
Seat 5: bDKopKTvPi3W+PEnYUX3tg collected ($0.60)
Seat 6: NqFoyDgzLwu4dOmSRXnFBA folded before Flop (didn't bet)




PokerStars Game #59941808562:  Hold'em No Limit ($0.10/$0.25) - 2009/07/01 1:46:49 ET
Table 'hfHe8uKeSJMyWAjSdM7ROQMRfAiS/4JSfnUDlCcZo0wAx Seat #1 is the button
Seat 1: 48oT5xFI+5CHUJlfoGrE4w ($30.15 in chips) 
Seat 2: /gJNBeCkWL4o85/jvlZ4BA ($29.10 in chips) 
Seat 3: FYepjhAvF8ZdVCmqHIy+eQ ($38.70 in chips) 
Seat 4: b4wRQV3APH8irVk6bUFe2Q ($36.95 in chips) 
/gJNBeCkWL4o85/jvlZ4BA: posts small blind $0.10
FYepjhAvF8ZdVCmqHIy+eQ: posts big blind $0.25
*** HOLE CARDS ***
b4wRQV3APH8irVk6bUFe2Q: folds 
Superchimp8 was removed from the table for failing to post
48oT5xFI+5CHUJlfoGrE4w: folds 
Q1uciOZPBR/WkAlqa6cL4A joins the table at seat #5 
df01R5ThvHspD8FgKmaDvQ joins the table at seat #6 
/gJNBeCkWL4o85/jvlZ4BA: calls $0.15
FYepjhAvF8ZdVCmqHIy+eQ: checks 
*** FLOP *** [8h 3c 6h]
/gJNBeCkWL4o85/jvlZ4BA: checks 
FYepjhAvF8ZdVCmqHIy+eQ: checks 
*** TURN *** [8h 3c 6h] [Js]
/gJNBeCkWL4o85/jvlZ4BA: checks 
FYepjhAvF8ZdVCmqHIy+eQ: checks 
*** RIVER *** [8h 3c 6h Js] [Jh]
/gJNBeCkWL4o85/jvlZ4BA: checks 
FYepjhAvF8ZdVCmqHIy+eQ: checks 
*** SHOW DOWN ***
/gJNBeCkWL4o85/jvlZ4BA: shows [Qc 9d] (a pair of Jacks)
FYepjhAvF8ZdVCmqHIy+eQ: shows [3h Td] (two pair, Jacks and Threes)
FYepjhAvF8ZdVCmqHIy+eQ collected $0.50 from pot
*** SUMMARY ***
Total pot $0.50 | Rake $0 
Board [8h 3c 6h Js Jh]
Seat 1: 48oT5xFI+5CHUJlfoGrE4w (button) folded before Flop (didn't bet)
Seat 2: /gJNBeCkWL4o85/jvlZ4BA (small blind) showed [Qc 9d] and lost with a pair of Jacks
Seat 3: FYepjhAvF8ZdVCmqHIy+eQ (big blind) showed [3h Td] and won ($0.50) with two pair, Jacks and Threes
Seat 4: b4wRQV3APH8irVk6bUFe2Q folded before Flop (didn't bet)




PokerStars Game #59941808518:  Hold'em No Limit ($0.10/$0.25) - 2009/07/01 1:46:49 ET
Table 'vFZR6Kf2Th5xBXT9brGW6A' 6-max Seat #3 is the button
Seat 2: QiL+lEgEWwy21jk/ltaRLg ($22.05 in chips) 
Seat 3: SH1WjKVUjPiyXySjWSdazw ($40.50 in chips) 
Seat 4: 79ID/ub1Pt/mDpCprVmOoA ($34.95 in chips) 
Seat 5: SS/yfeArhULzIcOPe8MdPg ($26.30 in chips) 
Seat 6: 4x9jCqgSw4272dnaIqnanw ($10.90 in chips) 
79ID/ub1Pt/mDpCprVmOoA: posts small blind $0.10
SS/yfeArhULzIcOPe8MdPg: posts big blind $0.25
Q1uciOZPBR/WkAlqa6cL4A: sits out 
*** HOLE CARDS ***
4x9jCqgSw4272dnaIqnanw: folds 
QiL+lEgEWwy21jk/ltaRLg: calls $0.25
SH1WjKVUjPiyXySjWSdazw: folds 
79ID/ub1Pt/mDpCprVmOoA: folds 
SS/yfeArhULzIcOPe8MdPg: checks 
*** FLOP *** [Td Jc Kd]
SS/yfeArhULzIcOPe8MdPg: bets $0.50
QiL+lEgEWwy21jk/ltaRLg: calls $0.50
*** TURN *** [Td Jc Kd] [Kh]
SS/yfeArhULzIcOPe8MdPg: bets $1
QiL+lEgEWwy21jk/ltaRLg: folds 
Uncalled bet ($1) returned to SS/yfeArhULzIcOPe8MdPg
SS/yfeArhULzIcOPe8MdPg collected $1.55 from pot
*** SUMMARY ***
Total pot $1.60 | Rake $0.05 
Board [Td Jc Kd Kh]
Seat 2: QiL+lEgEWwy21jk/ltaRLg folded on the Turn
Seat 3: SH1WjKVUjPiyXySjWSdazw (button) folded before Flop (didn't bet)
Seat 4: 79ID/ub1Pt/mDpCprVmOoA (small blind) folded before Flop
Seat 5: SS/yfeArhULzIcOPe8MdPg (big blind) collected ($1.55)
Seat 6: 4x9jCqgSw4272dnaIqnanw folded before Flop (didn't bet)




PokerStars Game #59941808582:  Hold'em No Limit ($0.10/$0.25) - 2009/07/01 1:46:49 ET
Table 'fIMYcWwN4/aXFJvH5Z8Ymg' 6-max Seat #3 is the button
Seat 1: DihMHaz4WNETH1bPDe13kA ($25 in chips) 
Seat 2: Mhj3q7cxev+XjXZxEE6/Cw ($25.60 in chips) 
Seat 3: 9bpVv1/Qh9IYtXuCtl5VtQ ($24.65 in chips) 
Seat 5: lquriepNQBhDV5P1SWHhnA ($25.45 in chips) 
Seat 6: jp34e617tIzV8tKIWmfAbA ($28.70 in chips) 
7cx44/slbeTw+Cy7QB8Trg will be allowed to play after the button
lquriepNQBhDV5P1SWHhnA: posts small blind $0.10
jp34e617tIzV8tKIWmfAbA: posts big blind $0.25
*** HOLE CARDS ***
DihMHaz4WNETH1bPDe13kA: folds 
Mhj3q7cxev+XjXZxEE6/Cw: folds 
9bpVv1/Qh9IYtXuCtl5VtQ: folds 
lquriepNQBhDV5P1SWHhnA: folds 
Uncalled bet ($0.15) returned to jp34e617tIzV8tKIWmfAbA
jp34e617tIzV8tKIWmfAbA collected $0.20 from pot
*** SUMMARY ***
Total pot $0.20 | Rake $0 
Seat 1: DihMHaz4WNETH1bPDe13kA folded before Flop (didn't bet)
Seat 2: Mhj3q7cxev+XjXZxEE6/Cw folded before Flop (didn't bet)
Seat 3: 9bpVv1/Qh9IYtXuCtl5VtQ (button) folded before Flop (didn't bet)
Seat 5: lquriepNQBhDV5P1SWHhnA (small blind) folded before Flop
Seat 6: jp34e617tIzV8tKIWmfAbA (big blind) collected ($0.20)




PokerStars Game #59941808760:  Hold'em No Limit ($0.10/$0.25) - 2009/07/01 1:46:49 ET
Table '9SExUHslNkrPJ4XsrePaVw' 9-max Seat #3 is the button
Seat 1: RHqgdFvufLCYe54+qd2gcA ($4.50 in chips) 
Seat 2: cZ99hugmLBj9KhTlc8nCSw ($43.75 in chips) 
Seat 3: EP17SQz/iWcuYdNOGeBgkw ($13.80 in chips) 
Seat 4: 4awUyiDYTgylQKXZ9faBVA ($25 in chips) 
Seat 5: L+eJnUyhY8bMNYw755K8XQ ($15.75 in chips) 
Seat 6: YPJ90cgNXDABdYJcqmwB0A ($20.95 in chips) 
Seat 7: 7cv+9Zc9HIQHNvYsMfV3uA ($28.20 in chips) 
Seat 8: tLcDklc2rBORNfixyRfVfw ($25.35 in chips) 
Seat 9: /THNzAxdv2lBxcf4XTj/0g ($9 in chips) 
4awUyiDYTgylQKXZ9faBVA: posts small blind $0.10
L+eJnUyhY8bMNYw755K8XQ: posts big blind $0.25
*** HOLE CARDS ***
YPJ90cgNXDABdYJcqmwB0A: folds 
7cv+9Zc9HIQHNvYsMfV3uA: folds 
tLcDklc2rBORNfixyRfVfw: folds 
/THNzAxdv2lBxcf4XTj/0g: raises $0.75 to $1
RHqgdFvufLCYe54+qd2gcA: folds 
cZ99hugmLBj9KhTlc8nCSw: folds 
EP17SQz/iWcuYdNOGeBgkw: folds 
4awUyiDYTgylQKXZ9faBVA: folds 
L+eJnUyhY8bMNYw755K8XQ: folds 
Uncalled bet ($0.75) returned to /THNzAxdv2lBxcf4XTj/0g
/THNzAxdv2lBxcf4XTj/0g collected $0.60 from pot
*** SUMMARY ***
Total pot $0.60 | Rake $0 
Seat 1: RHqgdFvufLCYe54+qd2gcA folded before Flop (didn't bet)
Seat 2: cZ99hugmLBj9KhTlc8nCSw folded before Flop (didn't bet)
Seat 3: EP17SQz/iWcuYdNOGeBgkw (button) folded before Flop (didn't bet)
Seat 4: 4awUyiDYTgylQKXZ9faBVA (small blind) folded before Flop
Seat 5: L+eJnUyhY8bMNYw755K8XQ (big blind) folded before Flop
Seat 6: YPJ90cgNXDABdYJcqmwB0A folded before Flop (didn't bet)
Seat 7: 7cv+9Zc9HIQHNvYsMfV3uA folded before Flop (didn't bet)
Seat 8: tLcDklc2rBORNfixyRfVfw folded before Flop (didn't bet)
Seat 9: /THNzAxdv2lBxcf4XTj/0g collected ($0.60)




PokerStars Game #59941808628:  Hold'em No Limit ($0.10/$0.25) - 2009/07/01 1:46:49 ET
Table 'PCxB2W9H6ma8SwsZlImuOw' 9-max Seat #9 is the button
Seat 1: SqibpGx+lf+brY0fJVvD0w ($24.85 in chips) 
Seat 2: bXpVeaSTPBFSPJmeXxO7nw ($5 in chips) 
Seat 3: J2a/QHAWUgo6beDRoEyg2g ($6.60 in chips) 
Seat 4: RsPwA2DnzOke3hD/Of/DUg ($2.55 in chips) 
Seat 5: GZO7tOXatVoX17M2DqPcUQ ($21.40 in chips) 
Seat 6: 5/6dWEBUHldD7iGXa2LwsQ ($16.20 in chips) 
Seat 7: c/9X4zftzphFxYtxp5kp9w ($27.40 in chips) 
Seat 8: Pt637jKksB5MzP0UNJAAkw ($25.60 in chips) 
Seat 9: COwSH15MvHaRF7en6/TRZQ ($6.70 in chips) 
SqibpGx+lf+brY0fJVvD0w: posts small blind $0.10
bXpVeaSTPBFSPJmeXxO7nw: posts big blind $0.25
*** HOLE CARDS ***
J2a/QHAWUgo6beDRoEyg2g: raises $0.25 to $0.50
RsPwA2DnzOke3hD/Of/DUg: folds 
GZO7tOXatVoX17M2DqPcUQ: folds 
5/6dWEBUHldD7iGXa2LwsQ: folds 
c/9X4zftzphFxYtxp5kp9w: folds 
Pt637jKksB5MzP0UNJAAkw: folds 
COwSH15MvHaRF7en6/TRZQ: folds 
SqibpGx+lf+brY0fJVvD0w: folds 
bXpVeaSTPBFSPJmeXxO7nw: folds 
Uncalled bet ($0.25) returned to J2a/QHAWUgo6beDRoEyg2g
J2a/QHAWUgo6beDRoEyg2g collected $0.60 from pot
*** SUMMARY ***
Total pot $0.60 | Rake $0 
Seat 1: SqibpGx+lf+brY0fJVvD0w (small blind) folded before Flop
Seat 2: bXpVeaSTPBFSPJmeXxO7nw (big blind) folded before Flop
Seat 3: J2a/QHAWUgo6beDRoEyg2g collected ($0.60)
Seat 4: RsPwA2DnzOke3hD/Of/DUg folded before Flop (didn't bet)
Seat 5: GZO7tOXatVoX17M2DqPcUQ folded before Flop (didn't bet)
Seat 6: 5/6dWEBUHldD7iGXa2LwsQ folded before Flop (didn't bet)
Seat 7: c/9X4zftzphFxYtxp5kp9w folded before Flop (didn't bet)
Seat 8: Pt637jKksB5MzP0UNJAAkw folded before Flop (didn't bet)
Seat 9: COwSH15MvHaRF7en6/TRZQ (button) folded before Flop (didn't bet)




PokerStars Game #59941808850:  Hold'em No Limit ($0.10/$0.25) - 2009/07/01 1:46:49 ET
Table 'P1IJQ2p3ACFySC35W1qwQw' 9-max Seat #6 is the button
Seat 1: bXpVeaSTPBFSPJmeXxO7nw ($5.50 in chips) 
Seat 2: vO3QVRovWemcGMkm7ijAIA ($5.35 in chips) 
Seat 3: PVxvfRTRvkgZf9WtquEkwQ ($26.05 in chips) 
Seat 4: c/9X4zftzphFxYtxp5kp9w ($27.55 in chips) 
Seat 5: ghNKXUBl/H+t83JF079ZBA ($56.45 in chips) 
Seat 6: ljemhp25Zg+nlA9DLCIiUw ($64.10 in chips) 
Seat 7: 7je+LC5Mfs6nL8YBVh4frQ ($5.20 in chips) 
Seat 8: tLcDklc2rBORNfixyRfVfw ($26.60 in chips) 
Seat 9: XXajyXkgbSGJKxQP3mal/Q ($13.90 in chips) 
7je+LC5Mfs6nL8YBVh4frQ: posts small blind $0.10
tLcDklc2rBORNfixyRfVfw: posts big blind $0.25
*** HOLE CARDS ***
XXajyXkgbSGJKxQP3mal/Q: folds 
bXpVeaSTPBFSPJmeXxO7nw: folds 
vO3QVRovWemcGMkm7ijAIA: raises $0.50 to $0.75
PVxvfRTRvkgZf9WtquEkwQ: calls $0.75
XXajyXkgbSGJKxQP3mal/Q leaves the table
c/9X4zftzphFxYtxp5kp9w: folds 
ghNKXUBl/H+t83JF079ZBA: folds 
ljemhp25Zg+nlA9DLCIiUw: folds 
7je+LC5Mfs6nL8YBVh4frQ: folds 
tLcDklc2rBORNfixyRfVfw: folds 
*** FLOP *** [9c 6h 6c]
vO3QVRovWemcGMkm7ijAIA: bets $1
PVxvfRTRvkgZf9WtquEkwQ: calls $1
*** TURN *** [9c 6h 6c] [Ah]
vO3QVRovWemcGMkm7ijAIA: checks 
PVxvfRTRvkgZf9WtquEkwQ: bets $1.50
vO3QVRovWemcGMkm7ijAIA: folds 
Uncalled bet ($1.50) returned to PVxvfRTRvkgZf9WtquEkwQ
PVxvfRTRvkgZf9WtquEkwQ collected $3.70 from pot
PVxvfRTRvkgZf9WtquEkwQ: doesn't show hand 
*** SUMMARY ***
Total pot $3.85 | Rake $0.15 
Board [9c 6h 6c Ah]
Seat 1: bXpVeaSTPBFSPJmeXxO7nw folded before Flop (didn't bet)
Seat 2: vO3QVRovWemcGMkm7ijAIA folded on the Turn
Seat 3: PVxvfRTRvkgZf9WtquEkwQ collected ($3.70)
Seat 4: c/9X4zftzphFxYtxp5kp9w folded before Flop (didn't bet)
Seat 5: ghNKXUBl/H+t83JF079ZBA folded before Flop (didn't bet)
Seat 6: ljemhp25Zg+nlA9DLCIiUw (button) folded before Flop (didn't bet)
Seat 7: 7je+LC5Mfs6nL8YBVh4frQ (small blind) folded before Flop
Seat 8: tLcDklc2rBORNfixyRfVfw (big blind) folded before Flop
Seat 9: XXajyXkgbSGJKxQP3mal/Q folded before Flop (didn't bet)




PokerStars Game #59941808972:  Hold'em No Limit ($0.10/$0.25) - 2009/07/01 1:46:50 ET
Table 'ouLhepGYovxB2x0QxH7cVg' 9-max Seat #2 is the button
Seat 1: ghNKXUBl/H+t83JF079ZBA ($25 in chips) 
Seat 2: r1Z5m4PwSI5ANp7qCE1OJw ($23.35 in chips) 
Seat 3: bXpVeaSTPBFSPJmeXxO7nw ($5 in chips) 
Seat 4: a0Sx6GHY7ln2Ns2C97eXeA ($38.10 in chips) 
Seat 5: v60REj6f8jzMYT0VsZvaPQ ($10 in chips) 
Seat 7: JRV2PblFtPFz51l0Fwyz8g ($24.25 in chips) 
Seat 8: tLcDklc2rBORNfixyRfVfw ($25.35 in chips) 
Seat 9: ljemhp25Zg+nlA9DLCIiUw ($25.35 in chips) 
bXpVeaSTPBFSPJmeXxO7nw: posts small blind $0.10
a0Sx6GHY7ln2Ns2C97eXeA: posts big blind $0.25
Hein MÃ¼ck 76: sits out 
*** HOLE CARDS ***
v60REj6f8jzMYT0VsZvaPQ: calls $0.25
JRV2PblFtPFz51l0Fwyz8g: folds 
tLcDklc2rBORNfixyRfVfw: folds 
ljemhp25Zg+nlA9DLCIiUw: raises $0.75 to $1
ghNKXUBl/H+t83JF079ZBA: folds 
r1Z5m4PwSI5ANp7qCE1OJw: folds 
bXpVeaSTPBFSPJmeXxO7nw: folds 
a0Sx6GHY7ln2Ns2C97eXeA: folds 
v60REj6f8jzMYT0VsZvaPQ: calls $0.75
*** FLOP *** [2s Kd 8c]
v60REj6f8jzMYT0VsZvaPQ: bets $1.50
ljemhp25Zg+nlA9DLCIiUw: folds 
Uncalled bet ($1.50) returned to v60REj6f8jzMYT0VsZvaPQ
v60REj6f8jzMYT0VsZvaPQ collected $2.25 from pot
*** SUMMARY ***
Total pot $2.35 | Rake $0.10 
Board [2s Kd 8c]
Seat 1: ghNKXUBl/H+t83JF079ZBA folded before Flop (didn't bet)
Seat 2: r1Z5m4PwSI5ANp7qCE1OJw (button) folded before Flop (didn't bet)
Seat 3: bXpVeaSTPBFSPJmeXxO7nw (small blind) folded before Flop
Seat 4: a0Sx6GHY7ln2Ns2C97eXeA (big blind) folded before Flop
Seat 5: v60REj6f8jzMYT0VsZvaPQ collected ($2.25)
Seat 7: JRV2PblFtPFz51l0Fwyz8g folded before Flop (didn't bet)
Seat 8: tLcDklc2rBORNfixyRfVfw folded before Flop (didn't bet)
Seat 9: ljemhp25Zg+nlA9DLCIiUw folded on the Flop




PokerStars Game #59941809272:  Hold'em No Limit ($0.10/$0.25) - 2009/07/01 1:46:50 ET
Table 'srBTB98reCdD1TffxE6o7g' 6-max Seat #4 is the button
Seat 1: SFmT9ZsVopnukjvAzrxTRg ($33.95 in chips) 
Seat 2: mfrkWA3PTeYPkbO6hi98Aw ($25 in chips) 
Seat 3: VOmI0x4dDPnTESZd5B4d1Q ($42.05 in chips) 
Seat 4: 6DwBRH+xZ12AAZmeAg+aXw ($16.20 in chips) 
Seat 6: BV+K0Phf5VBHr7aZPKqbUQ ($34.70 in chips) 
K1zv48sQUGQiaLk5VWWDqw will be allowed to play after the button
BV+K0Phf5VBHr7aZPKqbUQ: posts small blind $0.10
SFmT9ZsVopnukjvAzrxTRg: posts big blind $0.25
*** HOLE CARDS ***
mfrkWA3PTeYPkbO6hi98Aw: raises $0.75 to $1
VOmI0x4dDPnTESZd5B4d1Q: folds 
VOmI0x4dDPnTESZd5B4d1Q is sitting out
6DwBRH+xZ12AAZmeAg+aXw: folds 
BV+K0Phf5VBHr7aZPKqbUQ: folds 
SFmT9ZsVopnukjvAzrxTRg: folds 
Uncalled bet ($0.75) returned to mfrkWA3PTeYPkbO6hi98Aw
mfrkWA3PTeYPkbO6hi98Aw collected $0.60 from pot
mfrkWA3PTeYPkbO6hi98Aw: doesn't show hand 
*** SUMMARY ***
Total pot $0.60 | Rake $0 
Seat 1: SFmT9ZsVopnukjvAzrxTRg (big blind) folded before Flop
Seat 2: mfrkWA3PTeYPkbO6hi98Aw collected ($0.60)
Seat 3: VOmI0x4dDPnTESZd5B4d1Q folded before Flop (didn't bet)
Seat 4: 6DwBRH+xZ12AAZmeAg+aXw (button) folded before Flop (didn't bet)
Seat 6: BV+K0Phf5VBHr7aZPKqbUQ (small blind) folded before Flop




PokerStars Game #59941809276:  Hold'em No Limit ($0.10/$0.25) - 2009/07/01 1:46:50 ET
Table 'tq5CvS0RUqGkuBK0XTzqqg' 6-max Seat #4 is the button
Seat 1: +ZlnqPoP3Hg4BIUxDfKd/A ($30.10 in chips) 
Seat 2: 2m6ZFAdj01UZd4WtEySXXQ ($4.50 in chips) 
Seat 4: UT5XpwOH1ipkOF7n1MqDJA ($34.20 in chips) 
Seat 5: qGHGf/553gQnDoklMRe3tg ($37.75 in chips) 
Seat 6: QqiZLFrN8iOUT/GHw7ztOA ($25 in chips) 
qGHGf/553gQnDoklMRe3tg: posts small blind $0.10
QqiZLFrN8iOUT/GHw7ztOA: posts big blind $0.25
08V++DOqzaNrRNsHIwi25w: sits out 
*** HOLE CARDS ***
+ZlnqPoP3Hg4BIUxDfKd/A: folds 
2m6ZFAdj01UZd4WtEySXXQ: folds 
UT5XpwOH1ipkOF7n1MqDJA: calls $0.25
qGHGf/553gQnDoklMRe3tg: folds 
QqiZLFrN8iOUT/GHw7ztOA: checks 
*** FLOP *** [7c 4c 6d]
QqiZLFrN8iOUT/GHw7ztOA: checks 
UT5XpwOH1ipkOF7n1MqDJA: bets $0.50
QqiZLFrN8iOUT/GHw7ztOA: folds 
Uncalled bet ($0.50) returned to UT5XpwOH1ipkOF7n1MqDJA
UT5XpwOH1ipkOF7n1MqDJA collected $0.60 from pot
*** SUMMARY ***
Total pot $0.60 | Rake $0 
Board [7c 4c 6d]
Seat 1: +ZlnqPoP3Hg4BIUxDfKd/A folded before Flop (didn't bet)
Seat 2: 2m6ZFAdj01UZd4WtEySXXQ folded before Flop (didn't bet)
Seat 4: UT5XpwOH1ipkOF7n1MqDJA (button) collected ($0.60)
Seat 5: qGHGf/553gQnDoklMRe3tg (small blind) folded before Flop
Seat 6: QqiZLFrN8iOUT/GHw7ztOA (big blind) folded on the Flop




PokerStars Game #59941809060:  Hold'em No Limit ($0.10/$0.25) - 2009/07/01 1:46:50 ET
Table 'NtCSSONEf1zaJo3042tQug' 6-max Seat #2 is the button
Seat 1: KXtdqb+rIMkjc0RvHDksGQ ($34.90 in chips) 
Seat 2: vqWjZmdQu/Hxw96/IJTWdQ ($26.20 in chips) 
Seat 3: 9kUKGKkblnIx3m8rlVol6Q ($15.75 in chips) 
Seat 4: HxD1kB8zCmalQSdWAkKmlg ($28.85 in chips) 
Seat 5: tOAk1Og4mVObMBOfvdDYOw ($31.55 in chips) 
Seat 6: LxehwDpTQ19ph4Qmc78+Pw ($29 in chips) 
9kUKGKkblnIx3m8rlVol6Q: posts small blind $0.10
HxD1kB8zCmalQSdWAkKmlg: posts big blind $0.25
*** HOLE CARDS ***
tOAk1Og4mVObMBOfvdDYOw: folds 
LxehwDpTQ19ph4Qmc78+Pw: calls $0.25
KXtdqb+rIMkjc0RvHDksGQ: folds 
vqWjZmdQu/Hxw96/IJTWdQ: raises $1 to $1.25
9kUKGKkblnIx3m8rlVol6Q: folds 
HxD1kB8zCmalQSdWAkKmlg: folds 
LxehwDpTQ19ph4Qmc78+Pw: raises $1 to $2.25
vqWjZmdQu/Hxw96/IJTWdQ: calls $1
*** FLOP *** [9d 8s 3c]
LxehwDpTQ19ph4Qmc78+Pw: checks 
vqWjZmdQu/Hxw96/IJTWdQ: checks 
*** TURN *** [9d 8s 3c] [6c]
LxehwDpTQ19ph4Qmc78+Pw: bets $2.25
vqWjZmdQu/Hxw96/IJTWdQ: folds 
Uncalled bet ($2.25) returned to LxehwDpTQ19ph4Qmc78+Pw
LxehwDpTQ19ph4Qmc78+Pw collected $4.65 from pot
LxehwDpTQ19ph4Qmc78+Pw: doesn't show hand 
*** SUMMARY ***
Total pot $4.85 | Rake $0.20 
Board [9d 8s 3c 6c]
Seat 1: KXtdqb+rIMkjc0RvHDksGQ folded before Flop (didn't bet)
Seat 2: vqWjZmdQu/Hxw96/IJTWdQ (button) folded on the Turn
Seat 3: 9kUKGKkblnIx3m8rlVol6Q (small blind) folded before Flop
Seat 4: HxD1kB8zCmalQSdWAkKmlg (big blind) folded before Flop
Seat 5: tOAk1Og4mVObMBOfvdDYOw folded before Flop (didn't bet)
Seat 6: LxehwDpTQ19ph4Qmc78+Pw collected ($4.65)




PokerStars Game #59941809452:  Hold'em No Limit ($0.10/$0.25) - 2009/07/01 1:46:50 ET
Table '9L7XfAwuM7XsXE8LIg2o5Q' 6-max Seat #3 is the button
Seat 1: dOIoLBxmpLHSXBN9LZnf0Q ($23.85 in chips) 
Seat 2: LJI7A1YgDM7hgh7o56+ReQ ($28.55 in chips) 
Seat 3: mFv3iBCtrw9XfCDRB0d46Q ($4.30 in chips) 
Seat 4: jp34e617tIzV8tKIWmfAbA ($38.55 in chips) 
Seat 5: zsU1ijOyYEi+40wBKPEbmw ($10.80 in chips) 
Seat 6: k9nHZTHt8hYhYRcW8NTb4g ($35.65 in chips) 
jp34e617tIzV8tKIWmfAbA: posts small blind $0.10
zsU1ijOyYEi+40wBKPEbmw: posts big blind $0.25
*** HOLE CARDS ***
k9nHZTHt8hYhYRcW8NTb4g: calls $0.25
dOIoLBxmpLHSXBN9LZnf0Q: folds 
LJI7A1YgDM7hgh7o56+ReQ: folds 
mFv3iBCtrw9XfCDRB0d46Q: folds 
jp34e617tIzV8tKIWmfAbA: folds 
zsU1ijOyYEi+40wBKPEbmw: checks 
*** FLOP *** [9c Ks 6d]
zsU1ijOyYEi+40wBKPEbmw: bets $0.50
k9nHZTHt8hYhYRcW8NTb4g: calls $0.50
*** TURN *** [9c Ks 6d] [3c]
zsU1ijOyYEi+40wBKPEbmw: bets $2.75
k9nHZTHt8hYhYRcW8NTb4g: raises $32.15 to $34.90 and is all-in
zsU1ijOyYEi+40wBKPEbmw: calls $7.30 and is all-in
Uncalled bet ($24.85) returned to k9nHZTHt8hYhYRcW8NTb4g
*** RIVER *** [9c Ks 6d 3c] [3h]
*** SHOW DOWN ***
zsU1ijOyYEi+40wBKPEbmw: shows [2c Kc] (two pair, Kings and Threes)
k9nHZTHt8hYhYRcW8NTb4g: mucks hand 
zsU1ijOyYEi+40wBKPEbmw collected $20.65 from pot
*** SUMMARY ***
Total pot $21.70 | Rake $1.05 
Board [9c Ks 6d 3c 3h]
Seat 1: dOIoLBxmpLHSXBN9LZnf0Q folded before Flop (didn't bet)
Seat 2: LJI7A1YgDM7hgh7o56+ReQ folded before Flop (didn't bet)
Seat 3: mFv3iBCtrw9XfCDRB0d46Q (button) folded before Flop (didn't bet)
Seat 4: jp34e617tIzV8tKIWmfAbA (small blind) folded before Flop
Seat 5: zsU1ijOyYEi+40wBKPEbmw (big blind) showed [2c Kc] and won ($20.65) with two pair, Kings and Threes
Seat 6: k9nHZTHt8hYhYRcW8NTb4g mucked




PokerStars Game #59941809228:  Hold'em No Limit ($0.10/$0.25) - 2009/07/01 1:46:50 ET
Table 'g+mPuNJBCHKE9ents7ZGtg' 6-max Seat #6 is the button
Seat 1: cezpHJ8FB07dj0xG+LhOvw ($58.40 in chips) 
Seat 2: fZQg9veL7Dd/Z04ZTjC+wQ ($64.95 in chips) 
Seat 3: FYepjhAvF8ZdVCmqHIy+eQ ($29.90 in chips) 
Seat 4: yVrjRIW0SMxgpvqSIPSe/w ($16.35 in chips) 
Seat 5: D3ikCR8c/o9jB5irZ3uGlw ($12.50 in chips) 
Seat 6: Mn2V28t5aGq2d09z+/o6Fw ($22.55 in chips) 
cezpHJ8FB07dj0xG+LhOvw: posts small blind $0.10
fZQg9veL7Dd/Z04ZTjC+wQ: posts big blind $0.25
*** HOLE CARDS ***
FYepjhAvF8ZdVCmqHIy+eQ: folds 
yVrjRIW0SMxgpvqSIPSe/w: calls $0.25
D3ikCR8c/o9jB5irZ3uGlw: calls $0.25
Mn2V28t5aGq2d09z+/o6Fw: calls $0.25
cezpHJ8FB07dj0xG+LhOvw: calls $0.15
fZQg9veL7Dd/Z04ZTjC+wQ: checks 
*** FLOP *** [Ks 7s 3s]
cezpHJ8FB07dj0xG+LhOvw: checks 
fZQg9veL7Dd/Z04ZTjC+wQ: checks 
yVrjRIW0SMxgpvqSIPSe/w: bets $0.50
D3ikCR8c/o9jB5irZ3uGlw: folds 
Mn2V28t5aGq2d09z+/o6Fw: calls $0.50
cezpHJ8FB07dj0xG+LhOvw: folds 
fZQg9veL7Dd/Z04ZTjC+wQ: folds 
*** TURN *** [Ks 7s 3s] [Js]
yVrjRIW0SMxgpvqSIPSe/w: bets $1
Mn2V28t5aGq2d09z+/o6Fw: raises $2 to $3
yVrjRIW0SMxgpvqSIPSe/w: folds 
Uncalled bet ($2) returned to Mn2V28t5aGq2d09z+/o6Fw
Mn2V28t5aGq2d09z+/o6Fw collected $4.05 from pot
Mn2V28t5aGq2d09z+/o6Fw: doesn't show hand 
*** SUMMARY ***
Total pot $4.25 | Rake $0.20 
Board [Ks 7s 3s Js]
Seat 1: cezpHJ8FB07dj0xG+LhOvw (small blind) folded on the Flop
Seat 2: fZQg9veL7Dd/Z04ZTjC+wQ (big blind) folded on the Flop
Seat 3: FYepjhAvF8ZdVCmqHIy+eQ folded before Flop (didn't bet)
Seat 4: yVrjRIW0SMxgpvqSIPSe/w folded on the Turn
Seat 5: D3ikCR8c/o9jB5irZ3uGlw folded on the Flop
Seat 6: Mn2V28t5aGq2d09z+/o6Fw (button) collected ($4.05)




PokerStars Game #59941809180:  Hold'em No Limit ($0.10/$0.25) - 2009/07/01 1:46:50 ET
Table '9o8Yb3JpUqurD4pNVmOikQ' 6-max Seat #2 is the button
Seat 1: SFmT9ZsVopnukjvAzrxTRg ($27.20 in chips) 
Seat 2: /gJNBeCkWL4o85/jvlZ4BA ($25.25 in chips) 
Seat 3: JgRqo1/2phbf7pab7N3BIQ ($23.60 in chips) 
Seat 4: j5NZbEJHsERuXjPHWqc1Nw ($11.35 in chips) 
Seat 5: QqiZLFrN8iOUT/GHw7ztOA ($24.15 in chips) 
Seat 6: LyDHtw3/yniNHW+DvLXbog ($25.70 in chips) 
JgRqo1/2phbf7pab7N3BIQ: posts small blind $0.10
j5NZbEJHsERuXjPHWqc1Nw: posts big blind $0.25
*** HOLE CARDS ***
QqiZLFrN8iOUT/GHw7ztOA: folds 
LyDHtw3/yniNHW+DvLXbog: folds 
SFmT9ZsVopnukjvAzrxTRg: folds 
/gJNBeCkWL4o85/jvlZ4BA: folds 
JgRqo1/2phbf7pab7N3BIQ: folds 
Uncalled bet ($0.15) returned to j5NZbEJHsERuXjPHWqc1Nw
j5NZbEJHsERuXjPHWqc1Nw collected $0.20 from pot
j5NZbEJHsERuXjPHWqc1Nw: doesn't show hand 
*** SUMMARY ***
Total pot $0.20 | Rake $0 
Seat 1: SFmT9ZsVopnukjvAzrxTRg folded before Flop (didn't bet)
Seat 2: /gJNBeCkWL4o85/jvlZ4BA (button) folded before Flop (didn't bet)
Seat 3: JgRqo1/2phbf7pab7N3BIQ (small blind) folded before Flop
Seat 4: j5NZbEJHsERuXjPHWqc1Nw (big blind) collected ($0.20)
Seat 5: QqiZLFrN8iOUT/GHw7ztOA folded before Flop (didn't bet)
Seat 6: LyDHtw3/yniNHW+DvLXbog folded before Flop (didn't bet)




PokerStars Game #59941809740:  Hold'em No Limit ($0.10/$0.25) - 2009/07/01 1:46:51 ET
Table '63uh7ZsO7Tnt+E8b/2bu3A' 6-max Seat #3 is the button
Seat 1: 0av6tRNdi0Ui4f15L7gsVg ($30.20 in chips) 
Seat 2: SFmT9ZsVopnukjvAzrxTRg ($30.30 in chips) 
Seat 3: yVP7GLZBzx47OPi6jzUxMw ($7.35 in chips) 
Seat 4: rnpAao581IcvQglpkpnkoQ ($11.35 in chips) 
Seat 5: GbCVUNssQ7mqsPWr7J4d3w ($4.05 in chips) 
Seat 6: qGHGf/553gQnDoklMRe3tg ($29.15 in chips) 
rnpAao581IcvQglpkpnkoQ: posts small blind $0.10
GbCVUNssQ7mqsPWr7J4d3w: posts big blind $0.25
*** HOLE CARDS ***
qGHGf/553gQnDoklMRe3tg: raises $0.75 to $1
0av6tRNdi0Ui4f15L7gsVg: folds 
SFmT9ZsVopnukjvAzrxTRg: folds 
yVP7GLZBzx47OPi6jzUxMw: folds 
rnpAao581IcvQglpkpnkoQ: folds 
GbCVUNssQ7mqsPWr7J4d3w: folds 
Uncalled bet ($0.75) returned to qGHGf/553gQnDoklMRe3tg
qGHGf/553gQnDoklMRe3tg collected $0.60 from pot
*** SUMMARY ***
Total pot $0.60 | Rake $0 
Seat 1: 0av6tRNdi0Ui4f15L7gsVg folded before Flop (didn't bet)
Seat 2: SFmT9ZsVopnukjvAzrxTRg folded before Flop (didn't bet)
Seat 3: yVP7GLZBzx47OPi6jzUxMw (button) folded before Flop (didn't bet)
Seat 4: rnpAao581IcvQglpkpnkoQ (small blind) folded before Flop
Seat 5: GbCVUNssQ7mqsPWr7J4d3w (big blind) folded before Flop
Seat 6: qGHGf/553gQnDoklMRe3tg collected ($0.60)




PokerStars Game #59941810024:  Hold'em No Limit ($0.10/$0.25) - 2009/07/01 1:46:51 ET
Table 'ukli1Y7ieC5JQMTEFxM2Nw' 6-max Seat #1 is the button
Seat 1: N162H80ZIQevUf2EzGahCA ($8.80 in chips) 
Seat 2: u/yN5P9f3KlATg6WLWNkBQ ($42.30 in chips) 
Seat 3: ExeoJ1G/rSmWa3tRz7TlCA ($23.45 in chips) 
Seat 4: if4dh6jhJXeN3/qd3qCp9g ($27.35 in chips) 
Seat 5: Se+H4Z4PDr6+eIUDJX1rpg ($17.30 in chips) 
Seat 6: 32YL2ZEp8NT4JB2RVM9euQ ($30.15 in chips) 
u/yN5P9f3KlATg6WLWNkBQ: posts small blind $0.10
ExeoJ1G/rSmWa3tRz7TlCA: posts big blind $0.25
*** HOLE CARDS ***
if4dh6jhJXeN3/qd3qCp9g: folds 
Se+H4Z4PDr6+eIUDJX1rpg: raises $0.75 to $1
32YL2ZEp8NT4JB2RVM9euQ: folds 
N162H80ZIQevUf2EzGahCA: folds 
u/yN5P9f3KlATg6WLWNkBQ: folds 
ExeoJ1G/rSmWa3tRz7TlCA: folds 
Uncalled bet ($0.75) returned to Se+H4Z4PDr6+eIUDJX1rpg
Se+H4Z4PDr6+eIUDJX1rpg collected $0.60 from pot
Se+H4Z4PDr6+eIUDJX1rpg: doesn't show hand 
*** SUMMARY ***
Total pot $0.60 | Rake $0 
Seat 1: N162H80ZIQevUf2EzGahCA (button) folded before Flop (didn't bet)
Seat 2: u/yN5P9f3KlATg6WLWNkBQ (small blind) folded before Flop
Seat 3: ExeoJ1G/rSmWa3tRz7TlCA (big blind) folded before Flop
Seat 4: if4dh6jhJXeN3/qd3qCp9g folded before Flop (didn't bet)
Seat 5: Se+H4Z4PDr6+eIUDJX1rpg collected ($0.60)
Seat 6: 32YL2ZEp8NT4JB2RVM9euQ folded before Flop (didn't bet)




PokerStars Game #59941809628:  Hold'em No Limit ($0.10/$0.25) - 2009/07/01 1:46:51 ET
Table 'ohAuixfiLOYDylNUG5mNUw' 9-max Seat #6 is the button
Seat 2: Th3FldXKQW6hWVVPahaoOQ ($26.15 in chips) 
Seat 3: gSakoFAgDDzXSb2eNBWKcg ($14.65 in chips) 
Seat 4: clJsV3v77RS07bDKY+705w ($5 in chips) 
Seat 6: MtVtHDqIJTyUcXkRBBDIVA ($25 in chips) 
Seat 8: ppMlNkhYgErlt4fuJO7ADA ($4 in chips) 
Seat 9: CT7Xj/V/O5rBlhtt+RZeFQ ($25.60 in chips) 
+qc/EYCgLC65SpGvr35eNg: is sitting out 
ppMlNkhYgErlt4fuJO7ADA: posts small blind $0.10
CT7Xj/V/O5rBlhtt+RZeFQ: posts big blind $0.25
qwr38jl5txoR36M7G5qi4A: sits out 
clJsV3v77RS07bDKY+705w: posts big blind $0.25
*** HOLE CARDS ***
+qc/EYCgLC65SpGvr35eNg leaves the table
Th3FldXKQW6hWVVPahaoOQ: folds 
Moxie 55 joins the table at seat #7 
gSakoFAgDDzXSb2eNBWKcg: calls $0.25
clJsV3v77RS07bDKY+705w: checks 
MtVtHDqIJTyUcXkRBBDIVA: folds 
ppMlNkhYgErlt4fuJO7ADA: calls $0.15
CT7Xj/V/O5rBlhtt+RZeFQ: checks 
*** FLOP *** [4h 9c Qd]
ppMlNkhYgErlt4fuJO7ADA: checks 
CT7Xj/V/O5rBlhtt+RZeFQ: checks 
gSakoFAgDDzXSb2eNBWKcg: checks 
clJsV3v77RS07bDKY+705w: checks 
*** TURN *** [4h 9c Qd] [2d]
ppMlNkhYgErlt4fuJO7ADA: bets $0.25
CT7Xj/V/O5rBlhtt+RZeFQ: folds 
gSakoFAgDDzXSb2eNBWKcg: calls $0.25
clJsV3v77RS07bDKY+705w: folds 
*** RIVER *** [4h 9c Qd 2d] [Ah]
ppMlNkhYgErlt4fuJO7ADA: checks 
gSakoFAgDDzXSb2eNBWKcg: checks 
*** SHOW DOWN ***
ppMlNkhYgErlt4fuJO7ADA: shows [8h 2c] (a pair of Deuces)
gSakoFAgDDzXSb2eNBWKcg: mucks hand 
ppMlNkhYgErlt4fuJO7ADA collected $1.45 from pot
*** SUMMARY ***
Total pot $1.50 | Rake $0.05 
Board [4h 9c Qd 2d Ah]
Seat 2: Th3FldXKQW6hWVVPahaoOQ folded before Flop (didn't bet)
Seat 3: gSakoFAgDDzXSb2eNBWKcg mucked
Seat 4: clJsV3v77RS07bDKY+705w folded on the Turn
Seat 6: MtVtHDqIJTyUcXkRBBDIVA (button) folded before Flop (didn't bet)
Seat 8: ppMlNkhYgErlt4fuJO7ADA (small blind) showed [8h 2c] and won ($1.45) with a pair of Deuces
Seat 9: CT7Xj/V/O5rBlhtt+RZeFQ (big blind) folded on the Turn




PokerStars Game #59941809672:  Hold'em No Limit ($0.10/$0.25) - 2009/07/01 1:46:51 ET
Table 'xkqAWQFDrFt4p81M8UsoNw' 9-max Seat #7 is the button
Seat 1: tLcDklc2rBORNfixyRfVfw ($28.25 in chips) 
Seat 3: xHZZRLAaFUIC8WWI8ljOJA ($24 in chips) 
Seat 4: wGigCmBR/9XWkPpvYos3aQ ($25.10 in chips) 
Seat 6: 6RiVTYll/5D8zICp0MRpKw ($22.75 in chips) 
Seat 7: MG90wfSJZnOejs/KD3vlQQ ($43.50 in chips) 
Seat 8: MaqsqnOOkbNuPf4oWvOtnA ($43 in chips) 
Seat 9: Z9AeOQX3yzuSvKAm/xyovg ($9.65 in chips) 
MaqsqnOOkbNuPf4oWvOtnA: posts small blind $0.10
Z9AeOQX3yzuSvKAm/xyovg: posts big blind $0.25
H5Se03ZqSX7tbULXur2MAg: sits out 
*** HOLE CARDS ***
tLcDklc2rBORNfixyRfVfw: folds 
xHZZRLAaFUIC8WWI8ljOJA: folds 
wGigCmBR/9XWkPpvYos3aQ: folds 
6RiVTYll/5D8zICp0MRpKw: folds 
MG90wfSJZnOejs/KD3vlQQ: folds 
MaqsqnOOkbNuPf4oWvOtnA: raises $0.25 to $0.50
Z9AeOQX3yzuSvKAm/xyovg: folds 
Uncalled bet ($0.25) returned to MaqsqnOOkbNuPf4oWvOtnA
MaqsqnOOkbNuPf4oWvOtnA collected $0.50 from pot
*** SUMMARY ***
Total pot $0.50 | Rake $0 
Seat 1: tLcDklc2rBORNfixyRfVfw folded before Flop (didn't bet)
Seat 3: xHZZRLAaFUIC8WWI8ljOJA folded before Flop (didn't bet)
Seat 4: wGigCmBR/9XWkPpvYos3aQ folded before Flop (didn't bet)
Seat 6: 6RiVTYll/5D8zICp0MRpKw folded before Flop (didn't bet)
Seat 7: MG90wfSJZnOejs/KD3vlQQ (button) folded before Flop (didn't bet)
Seat 8: MaqsqnOOkbNuPf4oWvOtnA (small blind) collected ($0.50)
Seat 9: Z9AeOQX3yzuSvKAm/xyovg (big blind) folded before Flop




PokerStars Game #59941810246:  Hold'em No Limit ($0.10/$0.25) - 2009/07/01 1:46:52 ET
Table 'wPWRBZPJl1HAnysw7qRR0A' 6-max Seat #2 is the button
Seat 1: m7ne1MOFTQXlsXT7/R/rug ($6.40 in chips) 
Seat 2: xC0kaiDYM6YTlgODL83O5A ($14.65 in chips) 
Seat 3: 1ZpoLWO2nm2w1Nd1v9Sr3g ($8.15 in chips) 
Seat 4: epAUIB7h2FJXzUPRIvSkRA ($39.15 in chips) 
Seat 5: y0B+UpYpOUJz3JWtlJQBSA ($15.75 in chips) 
Seat 6: rx64Jzd1UJFfwJwXmv3z8w ($15.15 in chips) 
1ZpoLWO2nm2w1Nd1v9Sr3g: posts small blind $0.10
epAUIB7h2FJXzUPRIvSkRA: posts big blind $0.25
*** HOLE CARDS ***
y0B+UpYpOUJz3JWtlJQBSA: folds 
rx64Jzd1UJFfwJwXmv3z8w: raises $0.75 to $1
m7ne1MOFTQXlsXT7/R/rug: folds 
xC0kaiDYM6YTlgODL83O5A: folds 
1ZpoLWO2nm2w1Nd1v9Sr3g: folds 
epAUIB7h2FJXzUPRIvSkRA: raises $2.50 to $3.50
rx64Jzd1UJFfwJwXmv3z8w: calls $2.50
*** FLOP *** [Ah 4c 6s]
epAUIB7h2FJXzUPRIvSkRA: bets $4
rx64Jzd1UJFfwJwXmv3z8w: raises $7.65 to $11.65 and is all-in
epAUIB7h2FJXzUPRIvSkRA: calls $7.65
*** TURN *** [Ah 4c 6s] [2h]
*** RIVER *** [Ah 4c 6s 2h] [Jd]
*** SHOW DOWN ***
epAUIB7h2FJXzUPRIvSkRA: shows [Kc As] (a pair of Aces)
rx64Jzd1UJFfwJwXmv3z8w: mucks hand 
epAUIB7h2FJXzUPRIvSkRA collected $28.90 from pot
*** SUMMARY ***
Total pot $30.40 | Rake $1.50 
Board [Ah 4c 6s 2h Jd]
Seat 1: m7ne1MOFTQXlsXT7/R/rug folded before Flop (didn't bet)
Seat 2: xC0kaiDYM6YTlgODL83O5A (button) folded before Flop (didn't bet)
Seat 3: 1ZpoLWO2nm2w1Nd1v9Sr3g (small blind) folded before Flop
Seat 4: epAUIB7h2FJXzUPRIvSkRA (big blind) showed [Kc As] and won ($28.90) with a pair of Aces
Seat 5: y0B+UpYpOUJz3JWtlJQBSA folded before Flop (didn't bet)
Seat 6: rx64Jzd1UJFfwJwXmv3z8w mucked




PokerStars Game #59941810088:  Hold'em No Limit ($0.10/$0.25) - 2009/07/01 1:46:52 ET
Table 'pgrBYaOEx/BuqK5iAtlFzw' 9-max Seat #3 is the button
Seat 1: 6O+8t5ikoK+pNiFXnN/Fyw ($15.60 in chips) 
Seat 2: 2Xwi447v1rBHM+92U0CduA ($3.65 in chips) 
Seat 3: Bb42QRQMhg5/Y0vHP8/2Xw ($25 in chips) 
Seat 4: oLa/tXLfSLLB28mcLGrxcg ($24.15 in chips) 
Seat 5: BWzInv8o0kN1pJybv/VjpQ ($28.75 in chips) 
Seat 6: eubS00Znk+qsx0B0+7/Zow ($21.85 in chips) 
Seat 7: eK8qa6EPcH2zhtbmWSvc9g ($25 in chips) 
Seat 8: tLcDklc2rBORNfixyRfVfw ($27.45 in chips) 
oLa/tXLfSLLB28mcLGrxcg: posts small blind $0.10
BWzInv8o0kN1pJybv/VjpQ: posts big blind $0.25
Z9W7+g1WMhhZDi7DwGbCFA: sits out 
*** HOLE CARDS ***
eubS00Znk+qsx0B0+7/Zow: calls $0.25
eK8qa6EPcH2zhtbmWSvc9g: folds 
tLcDklc2rBORNfixyRfVfw: folds 
6O+8t5ikoK+pNiFXnN/Fyw: calls $0.25
2Xwi447v1rBHM+92U0CduA: folds 
Bb42QRQMhg5/Y0vHP8/2Xw: folds 
oLa/tXLfSLLB28mcLGrxcg: calls $0.15
BWzInv8o0kN1pJybv/VjpQ: checks 
*** FLOP *** [5d 2c 7h]
oLa/tXLfSLLB28mcLGrxcg: checks 
BWzInv8o0kN1pJybv/VjpQ: checks 
eubS00Znk+qsx0B0+7/Zow: bets $0.25
6O+8t5ikoK+pNiFXnN/Fyw: calls $0.25
oLa/tXLfSLLB28mcLGrxcg: folds 
BWzInv8o0kN1pJybv/VjpQ: folds 
*** TURN *** [5d 2c 7h] [Ks]
eubS00Znk+qsx0B0+7/Zow: bets $0.50
6O+8t5ikoK+pNiFXnN/Fyw: raises $0.50 to $1
eubS00Znk+qsx0B0+7/Zow: calls $0.50
*** RIVER *** [5d 2c 7h Ks] [3c]
eubS00Znk+qsx0B0+7/Zow: checks 
6O+8t5ikoK+pNiFXnN/Fyw: bets $1.25
eubS00Znk+qsx0B0+7/Zow: calls $1.25
*** SHOW DOWN ***
6O+8t5ikoK+pNiFXnN/Fyw: shows [6d Kd] (a pair of Kings)
eubS00Znk+qsx0B0+7/Zow: mucks hand 
6O+8t5ikoK+pNiFXnN/Fyw collected $5.75 from pot
*** SUMMARY ***
Total pot $6 | Rake $0.25 
Board [5d 2c 7h Ks 3c]
Seat 1: 6O+8t5ikoK+pNiFXnN/Fyw showed [6d Kd] and won ($5.75) with a pair of Kings
Seat 2: 2Xwi447v1rBHM+92U0CduA folded before Flop (didn't bet)
Seat 3: Bb42QRQMhg5/Y0vHP8/2Xw (button) folded before Flop (didn't bet)
Seat 4: oLa/tXLfSLLB28mcLGrxcg (small blind) folded on the Flop
Seat 5: BWzInv8o0kN1pJybv/VjpQ (big blind) folded on the Flop
Seat 6: eubS00Znk+qsx0B0+7/Zow mucked
Seat 7: eK8qa6EPcH2zhtbmWSvc9g folded before Flop (didn't bet)
Seat 8: tLcDklc2rBORNfixyRfVfw folded before Flop (didn't bet)




PokerStars Game #59941810372:  Hold'em No Limit ($0.10/$0.25) - 2009/07/01 1:46:52 ET
Table 'Dun24l/X8kjpUHWBhkVOFw' 6-max Seat #2 is the button
Seat 1: u3Ol7kv1LmvszuHNm9rc6w ($22.80 in chips) 
Seat 2: 6hUmfDYq+83kvxWoTBQmfw ($24 in chips) 
Seat 3: +E5iJKkKVfaTgTqzuXXv0g ($13.25 in chips) 
Seat 4: 7/ROHX4tuLekJ2diYIlMkw ($8.80 in chips) 
Seat 5: KYBwVA7jgmSrbIEbEGElVg ($23.30 in chips) 
+E5iJKkKVfaTgTqzuXXv0g: posts small blind $0.10
7/ROHX4tuLekJ2diYIlMkw: posts big blind $0.25
xrf8tAXKQHG99HixCot1Iw: sits out 
*** HOLE CARDS ***
KYBwVA7jgmSrbIEbEGElVg: folds 
u3Ol7kv1LmvszuHNm9rc6w: raises $0.50 to $0.75
6hUmfDYq+83kvxWoTBQmfw: folds 
+E5iJKkKVfaTgTqzuXXv0g: folds 
7/ROHX4tuLekJ2diYIlMkw: folds 
Uncalled bet ($0.50) returned to u3Ol7kv1LmvszuHNm9rc6w
u3Ol7kv1LmvszuHNm9rc6w collected $0.60 from pot
u3Ol7kv1LmvszuHNm9rc6w: doesn't show hand 
*** SUMMARY ***
Total pot $0.60 | Rake $0 
Seat 1: u3Ol7kv1LmvszuHNm9rc6w collected ($0.60)
Seat 2: 6hUmfDYq+83kvxWoTBQmfw (button) folded before Flop (didn't bet)
Seat 3: +E5iJKkKVfaTgTqzuXXv0g (small blind) folded before Flop
Seat 4: 7/ROHX4tuLekJ2diYIlMkw (big blind) folded before Flop
Seat 5: KYBwVA7jgmSrbIEbEGElVg folded before Flop (didn't bet)




PokerStars Game #59941810438:  Hold'em No Limit ($0.10/$0.25) - 2009/07/01 1:46:52 ET
Table 'Of/T60zpXg1GcjrZ7Lm//Q' 9-max Seat #7 is the button
Seat 1: Lro4e37x4FUa5P3yzDjskw ($18.20 in chips) 
Seat 2: qwr38jl5txoR36M7G5qi4A ($9.90 in chips) 
Seat 3: 6RiVTYll/5D8zICp0MRpKw ($25 in chips) 
Seat 4: Czut6V7acIqUJrrobjKAZg ($6.40 in chips) 
Seat 5: IiLkthQMEje9LS79rCFQ1Q ($20.25 in chips) 
Seat 6: tYsOBqdU1+x+yFI7zHO7hQ ($31.45 in chips) 
Seat 7: PVxvfRTRvkgZf9WtquEkwQ ($25 in chips) 
Seat 8: ghNKXUBl/H+t83JF079ZBA ($26.25 in chips) 
Seat 9: egvg3mTBBVzMHnJPIQiKcA ($16.40 in chips) 
ghNKXUBl/H+t83JF079ZBA: posts small blind $0.10
egvg3mTBBVzMHnJPIQiKcA: posts big blind $0.25
*** HOLE CARDS ***
Lro4e37x4FUa5P3yzDjskw: folds 
qwr38jl5txoR36M7G5qi4A: folds 
6RiVTYll/5D8zICp0MRpKw: folds 
Czut6V7acIqUJrrobjKAZg: folds 
IiLkthQMEje9LS79rCFQ1Q: raises $1 to $1.25
tYsOBqdU1+x+yFI7zHO7hQ: folds 
PVxvfRTRvkgZf9WtquEkwQ: folds 
ghNKXUBl/H+t83JF079ZBA: folds 
egvg3mTBBVzMHnJPIQiKcA: calls $1
*** FLOP *** [6d 6c Kd]
egvg3mTBBVzMHnJPIQiKcA: checks 
IiLkthQMEje9LS79rCFQ1Q: bets $1.25
egvg3mTBBVzMHnJPIQiKcA: folds 
Uncalled bet ($1.25) returned to IiLkthQMEje9LS79rCFQ1Q
IiLkthQMEje9LS79rCFQ1Q collected $2.50 from pot
IiLkthQMEje9LS79rCFQ1Q: shows [Ac Ah] (two pair, Aces and Sixes)
*** SUMMARY ***
Total pot $2.60 | Rake $0.10 
Board [6d 6c Kd]
Seat 1: Lro4e37x4FUa5P3yzDjskw folded before Flop (didn't bet)
Seat 2: qwr38jl5txoR36M7G5qi4A folded before Flop (didn't bet)
Seat 3: 6RiVTYll/5D8zICp0MRpKw folded before Flop (didn't bet)
Seat 4: Czut6V7acIqUJrrobjKAZg folded before Flop (didn't bet)
Seat 5: IiLkthQMEje9LS79rCFQ1Q collected ($2.50)
Seat 6: tYsOBqdU1+x+yFI7zHO7hQ folded before Flop (didn't bet)
Seat 7: PVxvfRTRvkgZf9WtquEkwQ (button) folded before Flop (didn't bet)
Seat 8: ghNKXUBl/H+t83JF079ZBA (small blind) folded before Flop
Seat 9: egvg3mTBBVzMHnJPIQiKcA (big blind) folded on the Flop




PokerStars Game #59941810582:  Hold'em No Limit ($0.10/$0.25) - 2009/07/01 1:46:53 ET
Table 'wGizWOswEL6P5QrvVkno/g' 6-max Seat #4 is the button
Seat 1: Qbfkn+ucISvbd1Xh32zAGA ($32.10 in chips) 
Seat 2: mfrkWA3PTeYPkbO6hi98Aw ($28.10 in chips) 
Seat 3: bJFzs6QmEEnz4miMfSDtcg ($11.55 in chips) 
Seat 4: 32YL2ZEp8NT4JB2RVM9euQ ($15.70 in chips) 
Qbfkn+ucISvbd1Xh32zAGA: posts small blind $0.10
mfrkWA3PTeYPkbO6hi98Aw: posts big blind $0.25
*** HOLE CARDS ***
bJFzs6QmEEnz4miMfSDtcg: calls $0.25
32YL2ZEp8NT4JB2RVM9euQ: raises $0.75 to $1
Qbfkn+ucISvbd1Xh32zAGA: folds 
mfrkWA3PTeYPkbO6hi98Aw: folds 
bJFzs6QmEEnz4miMfSDtcg: calls $0.75
*** FLOP *** [6c Qc Kh]
bJFzs6QmEEnz4miMfSDtcg: checks 
32YL2ZEp8NT4JB2RVM9euQ: checks 
*** TURN *** [6c Qc Kh] [5s]
bJFzs6QmEEnz4miMfSDtcg: checks 
32YL2ZEp8NT4JB2RVM9euQ: checks 
*** RIVER *** [6c Qc Kh 5s] [Js]
bJFzs6QmEEnz4miMfSDtcg: checks 
32YL2ZEp8NT4JB2RVM9euQ: checks 
*** SHOW DOWN ***
bJFzs6QmEEnz4miMfSDtcg: shows [4d 4s] (a pair of Fours)
32YL2ZEp8NT4JB2RVM9euQ: mucks hand 
BuAE7g7dRfuqGPmQDlGyGg joins the table at seat #6 
bJFzs6QmEEnz4miMfSDtcg collected $2.25 from pot
bJFzs6QmEEnz4miMfSDtcg is sitting out
*** SUMMARY ***
Total pot $2.35 | Rake $0.10 
Board [6c Qc Kh 5s Js]
Seat 1: Qbfkn+ucISvbd1Xh32zAGA (small blind) folded before Flop
Seat 2: mfrkWA3PTeYPkbO6hi98Aw (big blind) folded before Flop
Seat 3: bJFzs6QmEEnz4miMfSDtcg showed [4d 4s] and won ($2.25) with a pair of Fours
Seat 4: 32YL2ZEp8NT4JB2RVM9euQ (button) mucked




PokerStars Game #59941811024:  Hold'em No Limit ($0.10/$0.25) - 2009/07/01 1:46:53 ET
Table 'nB7Q7zfNfy6ig6DB+rsgWQ' 6-max Seat #6 is the button
Seat 1: Hzy03WtPHMYwLYM7hTTxQw ($23.75 in chips) 
Seat 2: 4BHo0wlX9INjkj2727qE0w ($23.75 in chips) 
Seat 3: p3NYOxYhkL7txPRSeXHDeg ($32.60 in chips) 
Seat 4: DihMHaz4WNETH1bPDe13kA ($80.10 in chips) 
Seat 5: xC0kaiDYM6YTlgODL83O5A ($15.90 in chips) 
Seat 6: MEGIwX0eHRUj63lwYaNhVg ($7.95 in chips) 
Hzy03WtPHMYwLYM7hTTxQw: posts small blind $0.10
4BHo0wlX9INjkj2727qE0w: posts big blind $0.25
*** HOLE CARDS ***
p3NYOxYhkL7txPRSeXHDeg: folds 
DihMHaz4WNETH1bPDe13kA: folds 
xC0kaiDYM6YTlgODL83O5A: calls $0.25
MEGIwX0eHRUj63lwYaNhVg: folds 
Hzy03WtPHMYwLYM7hTTxQw: calls $0.15
4BHo0wlX9INjkj2727qE0w: raises $0.25 to $0.50
xC0kaiDYM6YTlgODL83O5A: calls $0.25
Hzy03WtPHMYwLYM7hTTxQw: calls $0.25
*** FLOP *** [Kh As 2c]
Hzy03WtPHMYwLYM7hTTxQw: checks 
4BHo0wlX9INjkj2727qE0w: bets $0.75
xC0kaiDYM6YTlgODL83O5A: folds 
Hzy03WtPHMYwLYM7hTTxQw: folds 
Uncalled bet ($0.75) returned to 4BHo0wlX9INjkj2727qE0w
4BHo0wlX9INjkj2727qE0w collected $1.45 from pot
*** SUMMARY ***
Total pot $1.50 | Rake $0.05 
Board [Kh As 2c]
Seat 1: Hzy03WtPHMYwLYM7hTTxQw (small blind) folded on the Flop
Seat 2: 4BHo0wlX9INjkj2727qE0w (big blind) collected ($1.45)
Seat 3: p3NYOxYhkL7txPRSeXHDeg folded before Flop (didn't bet)
Seat 4: DihMHaz4WNETH1bPDe13kA folded before Flop (didn't bet)
Seat 5: xC0kaiDYM6YTlgODL83O5A folded on the Flop
Seat 6: MEGIwX0eHRUj63lwYaNhVg (button) folded before Flop (didn't bet)




PokerStars Game #59941810778:  Hold'em No Limit ($0.10/$0.25) - 2009/07/01 1:46:53 ET
Table 'jdhJTJjFq2KTttwJcd+7nQ' 6-max Seat #4 is the button
Seat 1: LtASJ9OlkqGrrUKGQlpGAw ($26.85 in chips) 
Seat 2: Hsvkc0/G2VV78oVmWYXecw ($5 in chips) 
Seat 3: vqWjZmdQu/Hxw96/IJTWdQ ($25 in chips) 
Seat 4: vx7FwRcelVSsvNYAdp/z0A ($6.15 in chips) 
Seat 5: BV+K0Phf5VBHr7aZPKqbUQ ($25.85 in chips) 
Seat 6: yb6rnd48JuBccThV68VHAQ ($20.30 in chips) 
BV+K0Phf5VBHr7aZPKqbUQ: posts small blind $0.10
yb6rnd48JuBccThV68VHAQ: posts big blind $0.25
*** HOLE CARDS ***
LtASJ9OlkqGrrUKGQlpGAw: folds 
Hsvkc0/G2VV78oVmWYXecw: folds 
vqWjZmdQu/Hxw96/IJTWdQ: folds 
vx7FwRcelVSsvNYAdp/z0A: raises $0.25 to $0.50
BV+K0Phf5VBHr7aZPKqbUQ: folds 
yb6rnd48JuBccThV68VHAQ: folds 
Uncalled bet ($0.25) returned to vx7FwRcelVSsvNYAdp/z0A
vx7FwRcelVSsvNYAdp/z0A collected $0.60 from pot
vx7FwRcelVSsvNYAdp/z0A: doesn't show hand 
*** SUMMARY ***
Total pot $0.60 | Rake $0 
Seat 1: LtASJ9OlkqGrrUKGQlpGAw folded before Flop (didn't bet)
Seat 2: Hsvkc0/G2VV78oVmWYXecw folded before Flop (didn't bet)
Seat 3: vqWjZmdQu/Hxw96/IJTWdQ folded before Flop (didn't bet)
Seat 4: vx7FwRcelVSsvNYAdp/z0A (button) collected ($0.60)
Seat 5: BV+K0Phf5VBHr7aZPKqbUQ (small blind) folded before Flop
Seat 6: yb6rnd48JuBccThV68VHAQ (big blind) folded before Flop




PokerStars Game #59941811286:  Hold'em No Limit ($0.10/$0.25) - 2009/07/01 1:46:54 ET
Table 'rhQuIjJo0UQ7RRUlF9umHg' 6-max Seat #1 is the button
Seat 1: 5O3Hj9Qg0SqOyKEXoLpjPg ($155.40 in chips) 
Seat 2: Ew/TYPQIsbQ2X8nm5iAJBg ($19.30 in chips) 
Seat 3: if4dh6jhJXeN3/qd3qCp9g ($27.40 in chips) 
Seat 4: buyjetgNT1McXtdaP4zynA ($40.15 in chips) 
Seat 5: dOX4wnYV2sEqvDbF+8KSCw ($51.90 in chips) 
Seat 6: /gJNBeCkWL4o85/jvlZ4BA ($52.05 in chips) 
Ew/TYPQIsbQ2X8nm5iAJBg: posts small blind $0.10
if4dh6jhJXeN3/qd3qCp9g: posts big blind $0.25
*** HOLE CARDS ***
buyjetgNT1McXtdaP4zynA: raises $0.75 to $1
dOX4wnYV2sEqvDbF+8KSCw: calls $1
/gJNBeCkWL4o85/jvlZ4BA: folds 
5O3Hj9Qg0SqOyKEXoLpjPg: calls $1
Ew/TYPQIsbQ2X8nm5iAJBg: folds 
if4dh6jhJXeN3/qd3qCp9g: folds 
*** FLOP *** [3h Ks Jc]
buyjetgNT1McXtdaP4zynA: checks 
dOX4wnYV2sEqvDbF+8KSCw: checks 
5O3Hj9Qg0SqOyKEXoLpjPg: bets $2
buyjetgNT1McXtdaP4zynA: calls $2
dOX4wnYV2sEqvDbF+8KSCw: raises $4 to $6
5O3Hj9Qg0SqOyKEXoLpjPg: calls $4
buyjetgNT1McXtdaP4zynA: folds 
*** TURN *** [3h Ks Jc] [Qd]
dOX4wnYV2sEqvDbF+8KSCw: checks 
5O3Hj9Qg0SqOyKEXoLpjPg: checks 
*** RIVER *** [3h Ks Jc Qd] [Js]
dOX4wnYV2sEqvDbF+8KSCw: bets $8
5O3Hj9Qg0SqOyKEXoLpjPg: calls $8
*** SHOW DOWN ***
dOX4wnYV2sEqvDbF+8KSCw: shows [6h Kh] (two pair, Kings and Jacks)
5O3Hj9Qg0SqOyKEXoLpjPg: mucks hand 
dOX4wnYV2sEqvDbF+8KSCw collected $31.75 from pot
*** SUMMARY ***
Total pot $33.35 | Rake $1.60 
Board [3h Ks Jc Qd Js]
Seat 1: 5O3Hj9Qg0SqOyKEXoLpjPg (button) mucked
Seat 2: Ew/TYPQIsbQ2X8nm5iAJBg (small blind) folded before Flop
Seat 3: if4dh6jhJXeN3/qd3qCp9g (big blind) folded before Flop
Seat 4: buyjetgNT1McXtdaP4zynA folded on the Flop
Seat 5: dOX4wnYV2sEqvDbF+8KSCw showed [6h Kh] and won ($31.75) with two pair, Kings and Jacks
Seat 6: /gJNBeCkWL4o85/jvlZ4BA folded before Flop (didn't bet)




PokerStars Game #59941811482:  Hold'em No Limit ($0.10/$0.25) - 2009/07/01 1:46:54 ET
Table '2VkNDXXsBj4bSZw/uK5atw' 6-max Seat #1 is the button
Seat 1: xrf8tAXKQHG99HixCot1Iw ($25.25 in chips) 
Seat 2: v6mkGzCBCCXcgWQNSYVtKg ($11.95 in chips) 
Seat 3: P+6Z5+8H5/Wyt/jHMovNvQ ($25 in chips) 
Seat 4: 4kIRqWKE/N0yUAcWVhLSoQ ($14.75 in chips) 
Seat 5: 7f0OkhFEOf3T+rVOFHRLnw ($20.05 in chips) 
Seat 6: n6UPMnVR4v8LFP0rWP73Fg ($12.95 in chips) 
v6mkGzCBCCXcgWQNSYVtKg: posts small blind $0.10
P+6Z5+8H5/Wyt/jHMovNvQ: posts big blind $0.25
*** HOLE CARDS ***
4kIRqWKE/N0yUAcWVhLSoQ: calls $0.25
7f0OkhFEOf3T+rVOFHRLnw: folds 
n6UPMnVR4v8LFP0rWP73Fg: folds 
xrf8tAXKQHG99HixCot1Iw: folds 
v6mkGzCBCCXcgWQNSYVtKg: calls $0.15
P+6Z5+8H5/Wyt/jHMovNvQ: checks 
*** FLOP *** [Ac Ad 2d]
v6mkGzCBCCXcgWQNSYVtKg: checks 
P+6Z5+8H5/Wyt/jHMovNvQ: checks 
4kIRqWKE/N0yUAcWVhLSoQ: checks 
*** TURN *** [Ac Ad 2d] [7d]
v6mkGzCBCCXcgWQNSYVtKg: checks 
P+6Z5+8H5/Wyt/jHMovNvQ: checks 
4kIRqWKE/N0yUAcWVhLSoQ: checks 
*** RIVER *** [Ac Ad 2d 7d] [9h]
v6mkGzCBCCXcgWQNSYVtKg: bets $0.50
P+6Z5+8H5/Wyt/jHMovNvQ: calls $0.50
4kIRqWKE/N0yUAcWVhLSoQ: folds 
*** SHOW DOWN ***
v6mkGzCBCCXcgWQNSYVtKg: shows [As 7h] (a full house, Aces full of Sevens)
P+6Z5+8H5/Wyt/jHMovNvQ: mucks hand 
v6mkGzCBCCXcgWQNSYVtKg collected $1.70 from pot
*** SUMMARY ***
Total pot $1.75 | Rake $0.05 
Board [Ac Ad 2d 7d 9h]
Seat 1: xrf8tAXKQHG99HixCot1Iw (button) folded before Flop (didn't bet)
Seat 2: v6mkGzCBCCXcgWQNSYVtKg (small blind) showed [As 7h] and won ($1.70) with a full house, Aces full of Sevens
Seat 3: P+6Z5+8H5/Wyt/jHMovNvQ (big blind) mucked
Seat 4: 4kIRqWKE/N0yUAcWVhLSoQ folded on the River
Seat 5: 7f0OkhFEOf3T+rVOFHRLnw folded before Flop (didn't bet)
Seat 6: n6UPMnVR4v8LFP0rWP73Fg folded before Flop (didn't bet)




PokerStars Game #59941811422:  Hold'em No Limit ($0.10/$0.25) - 2009/07/01 1:46:54 ET
Table 'oJpFwZj9+FUGHX90Un8s9Q' 6-max Seat #4 is the button
Seat 1: 6DwBRH+xZ12AAZmeAg+aXw ($23.90 in chips) 
Seat 2: NtrVQ9UIql0rDCnKDKZ5FQ ($15.70 in chips) 
Seat 3: kyRaCIljYA6l33lSKQfNsg ($25.90 in chips) 
Seat 4: 6elpmfyt4Zw0yvd8lePSMQ ($21.55 in chips) 
Seat 5: kG34n23qFQA3nzdOJTQ1dA ($55.55 in chips) 
Seat 6: 7LpHJVeM6k1mQdC6HXYzww ($25 in chips) 
kG34n23qFQA3nzdOJTQ1dA: posts small blind $0.10
7LpHJVeM6k1mQdC6HXYzww: posts big blind $0.25
*** HOLE CARDS ***
6DwBRH+xZ12AAZmeAg+aXw: folds 
NtrVQ9UIql0rDCnKDKZ5FQ: folds 
kyRaCIljYA6l33lSKQfNsg: folds 
6elpmfyt4Zw0yvd8lePSMQ: folds 
kG34n23qFQA3nzdOJTQ1dA: folds 
Uncalled bet ($0.15) returned to 7LpHJVeM6k1mQdC6HXYzww
7LpHJVeM6k1mQdC6HXYzww collected $0.20 from pot
7LpHJVeM6k1mQdC6HXYzww: doesn't show hand 
*** SUMMARY ***
Total pot $0.20 | Rake $0 
Seat 1: 6DwBRH+xZ12AAZmeAg+aXw folded before Flop (didn't bet)
Seat 2: NtrVQ9UIql0rDCnKDKZ5FQ folded before Flop (didn't bet)
Seat 3: kyRaCIljYA6l33lSKQfNsg folded before Flop (didn't bet)
Seat 4: 6elpmfyt4Zw0yvd8lePSMQ (button) folded before Flop (didn't bet)
Seat 5: kG34n23qFQA3nzdOJTQ1dA (small blind) folded before Flop
Seat 6: 7LpHJVeM6k1mQdC6HXYzww (big blind) collected ($0.20)




PokerStars Game #59941811438:  Hold'em No Limit ($0.10/$0.25) - 2009/07/01 1:46:54 ET
Table 'isKy4XK8wJM0x735/D4hWA' 6-max Seat #4 is the button
Seat 1: kwsRmpZ1ZaLooISs+zfyKg ($24.05 in chips) 
Seat 2: 6elpmfyt4Zw0yvd8lePSMQ ($39.25 in chips) 
Seat 3: jp34e617tIzV8tKIWmfAbA ($26.05 in chips) 
Seat 4: DFi/Lzkjsfv8QswS80JX9Q ($31.10 in chips) 
Seat 5: lquriepNQBhDV5P1SWHhnA ($25.70 in chips) 
Seat 6: GbCVUNssQ7mqsPWr7J4d3w ($4.30 in chips) 
lquriepNQBhDV5P1SWHhnA: posts small blind $0.10
GbCVUNssQ7mqsPWr7J4d3w: posts big blind $0.25
*** HOLE CARDS ***
kwsRmpZ1ZaLooISs+zfyKg: raises $0.75 to $1
6elpmfyt4Zw0yvd8lePSMQ: folds 
jp34e617tIzV8tKIWmfAbA: folds 
DFi/Lzkjsfv8QswS80JX9Q: folds 
lquriepNQBhDV5P1SWHhnA: folds 
GbCVUNssQ7mqsPWr7J4d3w: folds 
Uncalled bet ($0.75) returned to kwsRmpZ1ZaLooISs+zfyKg
kwsRmpZ1ZaLooISs+zfyKg collected $0.60 from pot
*** SUMMARY ***
Total pot $0.60 | Rake $0 
Seat 1: kwsRmpZ1ZaLooISs+zfyKg collected ($0.60)
Seat 2: 6elpmfyt4Zw0yvd8lePSMQ folded before Flop (didn't bet)
Seat 3: jp34e617tIzV8tKIWmfAbA folded before Flop (didn't bet)
Seat 4: DFi/Lzkjsfv8QswS80JX9Q (button) folded before Flop (didn't bet)
Seat 5: lquriepNQBhDV5P1SWHhnA (small blind) folded before Flop
Seat 6: GbCVUNssQ7mqsPWr7J4d3w (big blind) folded before Flop




PokerStars Game #59941811290:  Hold'em No Limit ($0.10/$0.25) - 2009/07/01 1:46:54 ET
Table 'Xi38lWH8L2JHRAsKYVX8Qg' 6-max Seat #6 is the button
Seat 1: shP7DFAtX7gXcgMJX/OmRQ ($18.90 in chips) 
Seat 2: VOmI0x4dDPnTESZd5B4d1Q ($9.10 in chips) 
Seat 3: 6DwBRH+xZ12AAZmeAg+aXw ($35.20 in chips) 
Seat 4: kG34n23qFQA3nzdOJTQ1dA ($24.50 in chips) 
Seat 5: 79ID/ub1Pt/mDpCprVmOoA ($77.60 in chips) 
Seat 6: kyRaCIljYA6l33lSKQfNsg ($29.75 in chips) 
shP7DFAtX7gXcgMJX/OmRQ: posts small blind $0.10
VOmI0x4dDPnTESZd5B4d1Q: posts big blind $0.25
*** HOLE CARDS ***
6DwBRH+xZ12AAZmeAg+aXw: raises $0.50 to $0.75
kG34n23qFQA3nzdOJTQ1dA: folds 
79ID/ub1Pt/mDpCprVmOoA: folds 
kyRaCIljYA6l33lSKQfNsg: folds 
shP7DFAtX7gXcgMJX/OmRQ: calls $0.65
VOmI0x4dDPnTESZd5B4d1Q has timed out
VOmI0x4dDPnTESZd5B4d1Q: folds 
*** FLOP *** [6h 4h 6c]
VOmI0x4dDPnTESZd5B4d1Q is sitting out
VOmI0x4dDPnTESZd5B4d1Q has returned
shP7DFAtX7gXcgMJX/OmRQ: checks 
6DwBRH+xZ12AAZmeAg+aXw: bets $1
shP7DFAtX7gXcgMJX/OmRQ: calls $1
*** TURN *** [6h 4h 6c] [Ts]
shP7DFAtX7gXcgMJX/OmRQ: checks 
6DwBRH+xZ12AAZmeAg+aXw: checks 
*** RIVER *** [6h 4h 6c Ts] [Kh]
shP7DFAtX7gXcgMJX/OmRQ: bets $2
6DwBRH+xZ12AAZmeAg+aXw: calls $2
*** SHOW DOWN ***
shP7DFAtX7gXcgMJX/OmRQ: shows [Qh 5h] (a flush, King high)
6DwBRH+xZ12AAZmeAg+aXw: mucks hand 
shP7DFAtX7gXcgMJX/OmRQ collected $7.40 from pot
*** SUMMARY ***
Total pot $7.75 | Rake $0.35 
Board [6h 4h 6c Ts Kh]
Seat 1: shP7DFAtX7gXcgMJX/OmRQ (small blind) showed [Qh 5h] and won ($7.40) with a flush, King high
Seat 2: VOmI0x4dDPnTESZd5B4d1Q (big blind) folded before Flop
Seat 3: 6DwBRH+xZ12AAZmeAg+aXw mucked
Seat 4: kG34n23qFQA3nzdOJTQ1dA folded before Flop (didn't bet)
Seat 5: 79ID/ub1Pt/mDpCprVmOoA folded before Flop (didn't bet)
Seat 6: kyRaCIljYA6l33lSKQfNsg (button) folded before Flop (didn't bet)




PokerStars Game #59941811186:  Hold'em No Limit ($0.10/$0.25) - 2009/07/01 1:46:54 ET
Table 'KYX9dFNuOA9l2PV46IebqQ' 9-max Seat #3 is the button
Seat 1: qZqVFan2U+GAA/c5LQFbcw ($15.30 in chips) 
Seat 3: Uq3NSX4cIFaXe7pbXQuU+Q ($7.35 in chips) 
Seat 5: g7MXhRmNZxv1lIkKkUKa4w ($13 in chips) 
Seat 6: 4QYM+pWPc3J+6i8Zv8LvLg ($16.15 in chips) 
Seat 7: FVZtQJMz59M6BoiON/88Xg ($14.85 in chips) 
Seat 8: KRWTiGM4xH+MkvPtJz4+SA ($24.65 in chips) 
Seat 9: 6NECk10orj8iqgD3pZ2A0Q ($5 in chips) 
g7MXhRmNZxv1lIkKkUKa4w: posts small blind $0.10
4QYM+pWPc3J+6i8Zv8LvLg: posts big blind $0.25
*** HOLE CARDS ***
FVZtQJMz59M6BoiON/88Xg: calls $0.25
ly/lwri2xlF+wmFsvottuQ joins the table at seat #4 
KRWTiGM4xH+MkvPtJz4+SA: calls $0.25
6NECk10orj8iqgD3pZ2A0Q: folds 
qZqVFan2U+GAA/c5LQFbcw said, "nother *** hole"
qZqVFan2U+GAA/c5LQFbcw: folds 
Uq3NSX4cIFaXe7pbXQuU+Q: folds 
g7MXhRmNZxv1lIkKkUKa4w: folds 
4QYM+pWPc3J+6i8Zv8LvLg: checks 
*** FLOP *** [2s 2d 8c]
4QYM+pWPc3J+6i8Zv8LvLg: checks 
FVZtQJMz59M6BoiON/88Xg: bets $0.50
KRWTiGM4xH+MkvPtJz4+SA: folds 
4QYM+pWPc3J+6i8Zv8LvLg: calls $0.50
*** TURN *** [2s 2d 8c] [9d]
4QYM+pWPc3J+6i8Zv8LvLg: checks 
FVZtQJMz59M6BoiON/88Xg: checks 
*** RIVER *** [2s 2d 8c 9d] [5s]
4QYM+pWPc3J+6i8Zv8LvLg: bets $6.25
FVZtQJMz59M6BoiON/88Xg: calls $6.25
*** SHOW DOWN ***
4QYM+pWPc3J+6i8Zv8LvLg: shows [Ah Ac] (two pair, Aces and Deuces)
FVZtQJMz59M6BoiON/88Xg: shows [Jd Js] (two pair, Jacks and Deuces)
4QYM+pWPc3J+6i8Zv8LvLg collected $13.65 from pot
*** SUMMARY ***
Total pot $14.35 | Rake $0.70 
Board [2s 2d 8c 9d 5s]
Seat 1: qZqVFan2U+GAA/c5LQFbcw folded before Flop (didn't bet)
Seat 3: Uq3NSX4cIFaXe7pbXQuU+Q (button) folded before Flop (didn't bet)
Seat 5: g7MXhRmNZxv1lIkKkUKa4w (small blind) folded before Flop
Seat 6: 4QYM+pWPc3J+6i8Zv8LvLg (big blind) showed [Ah Ac] and won ($13.65) with two pair, Aces and Deuces
Seat 7: FVZtQJMz59M6BoiON/88Xg showed [Jd Js] and lost with two pair, Jacks and Deuces
Seat 8: KRWTiGM4xH+MkvPtJz4+SA folded on the Flop
Seat 9: 6NECk10orj8iqgD3pZ2A0Q folded before Flop (didn't bet)




PokerStars Game #59941811738:  Hold'em No Limit ($0.10/$0.25) - 2009/07/01 1:46:55 ET
Table '63h13e5p7cWe02rClZ1CHw' 6-max Seat #6 is the button
Seat 1: pokjbbEcXXPlADXdSGHtZw ($22.45 in chips) 
Seat 2: k9nHZTHt8hYhYRcW8NTb4g ($24.40 in chips) 
Seat 3: mFv3iBCtrw9XfCDRB0d46Q ($4.65 in chips) 
Seat 4: xrf8tAXKQHG99HixCot1Iw ($26.95 in chips) 
Seat 5: iyZxqznXjv3vtvOJymkoLQ ($44.45 in chips) 
Seat 6: mfrkWA3PTeYPkbO6hi98Aw ($39.05 in chips) 
pokjbbEcXXPlADXdSGHtZw: posts small blind $0.10
k9nHZTHt8hYhYRcW8NTb4g: posts big blind $0.25
*** HOLE CARDS ***
mFv3iBCtrw9XfCDRB0d46Q: folds 
xrf8tAXKQHG99HixCot1Iw: raises $0.50 to $0.75
iyZxqznXjv3vtvOJymkoLQ: folds 
mfrkWA3PTeYPkbO6hi98Aw: folds 
pokjbbEcXXPlADXdSGHtZw: calls $0.65
k9nHZTHt8hYhYRcW8NTb4g: calls $0.50
*** FLOP *** [5c As Jc]
pokjbbEcXXPlADXdSGHtZw: checks 
k9nHZTHt8hYhYRcW8NTb4g: checks 
xrf8tAXKQHG99HixCot1Iw: bets $1.25
pokjbbEcXXPlADXdSGHtZw: folds 
k9nHZTHt8hYhYRcW8NTb4g: folds 
Uncalled bet ($1.25) returned to xrf8tAXKQHG99HixCot1Iw
xrf8tAXKQHG99HixCot1Iw collected $2.15 from pot
xrf8tAXKQHG99HixCot1Iw: doesn't show hand 
*** SUMMARY ***
Total pot $2.25 | Rake $0.10 
Board [5c As Jc]
Seat 1: pokjbbEcXXPlADXdSGHtZw (small blind) folded on the Flop
Seat 2: k9nHZTHt8hYhYRcW8NTb4g (big blind) folded on the Flop
Seat 3: mFv3iBCtrw9XfCDRB0d46Q folded before Flop (didn't bet)
Seat 4: xrf8tAXKQHG99HixCot1Iw collected ($2.15)
Seat 5: iyZxqznXjv3vtvOJymkoLQ folded before Flop (didn't bet)
Seat 6: mfrkWA3PTeYPkbO6hi98Aw (button) folded before Flop (didn't bet)




PokerStars Game #59941811600:  Hold'em No Limit ($0.10/$0.25) - 2009/07/01 1:46:55 ET
Table 'ykyWGjhNu7AvZXov27T4ew' 9-max Seat #8 is the button
Seat 1: skUI2T7o4P1rz460mMbAOg ($10.35 in chips) 
Seat 2: MG90wfSJZnOejs/KD3vlQQ ($39.60 in chips) 
Seat 3: NPI9ArW8kwrb6a2IAL6xMQ ($26.40 in chips) 
Seat 4: W6tExOcYX7qiy6Qdp+ZwFA ($5.90 in chips) 
Seat 5: CmngQmkKTp8tkl6GMRTl6w ($8.50 in chips) 
Seat 6: AiXn/9o1EwOPZUHujnh/bA ($20.15 in chips) 
Seat 7: npAYqa85pqnzfOK5ukX+BQ ($21.30 in chips) 
Seat 8: tYsOBqdU1+x+yFI7zHO7hQ ($49.35 in chips) 
wk9M6R3w+aDHpr8WV87RmQ will be allowed to play after the button
skUI2T7o4P1rz460mMbAOg: posts small blind $0.10
MG90wfSJZnOejs/KD3vlQQ: posts big blind $0.25
*** HOLE CARDS ***
NPI9ArW8kwrb6a2IAL6xMQ: raises $0.25 to $0.50
W6tExOcYX7qiy6Qdp+ZwFA: folds 
CmngQmkKTp8tkl6GMRTl6w: folds 
AiXn/9o1EwOPZUHujnh/bA: folds 
npAYqa85pqnzfOK5ukX+BQ: folds 
tYsOBqdU1+x+yFI7zHO7hQ: calls $0.50
skUI2T7o4P1rz460mMbAOg: folds 
MG90wfSJZnOejs/KD3vlQQ: folds 
*** FLOP *** [Jc 4c Ad]
NPI9ArW8kwrb6a2IAL6xMQ: bets $0.50
tYsOBqdU1+x+yFI7zHO7hQ: folds 
Uncalled bet ($0.50) returned to NPI9ArW8kwrb6a2IAL6xMQ
NPI9ArW8kwrb6a2IAL6xMQ collected $1.30 from pot
*** SUMMARY ***
Total pot $1.35 | Rake $0.05 
Board [Jc 4c Ad]
Seat 1: skUI2T7o4P1rz460mMbAOg (small blind) folded before Flop
Seat 2: MG90wfSJZnOejs/KD3vlQQ (big blind) folded before Flop
Seat 3: NPI9ArW8kwrb6a2IAL6xMQ collected ($1.30)
Seat 4: W6tExOcYX7qiy6Qdp+ZwFA folded before Flop (didn't bet)
Seat 5: CmngQmkKTp8tkl6GMRTl6w folded before Flop (didn't bet)
Seat 6: AiXn/9o1EwOPZUHujnh/bA folded before Flop (didn't bet)
Seat 7: npAYqa85pqnzfOK5ukX+BQ folded before Flop (didn't bet)
Seat 8: tYsOBqdU1+x+yFI7zHO7hQ (button) folded on the Flop




PokerStars Game #59941811696:  Hold'em No Limit ($0.10/$0.25) - 2009/07/01 1:46:55 ET
Table 'mk323gviqdkOY5Aek/1EWg' 6-max Seat #4 is the button
Seat 2: GC/9yVD59DUCX7hUI7gcLw ($55.65 in chips) 
Seat 3: NuqYPwTLZYQhxOoVK3Yqlw ($25 in chips) 
Seat 4: +baiVgI/ETnBARLe5mARCw ($11.55 in chips) 
Seat 5: kjYRzIfvZNNflYMYRkkSVA ($35.70 in chips) 
Seat 6: KkXSr5xFjxLSD3wtAvT+WQ ($9 in chips) 
kjYRzIfvZNNflYMYRkkSVA: posts small blind $0.10
KkXSr5xFjxLSD3wtAvT+WQ: posts big blind $0.25
7cx44/slbeTw+Cy7QB8Trg: sits out 
*** HOLE CARDS ***
GC/9yVD59DUCX7hUI7gcLw: folds 
NuqYPwTLZYQhxOoVK3Yqlw: folds 
+baiVgI/ETnBARLe5mARCw: folds 
kjYRzIfvZNNflYMYRkkSVA: calls $0.15
KkXSr5xFjxLSD3wtAvT+WQ: checks 
*** FLOP *** [Ac Ah 3s]
kjYRzIfvZNNflYMYRkkSVA: bets $0.50
KkXSr5xFjxLSD3wtAvT+WQ: folds 
Uncalled bet ($0.50) returned to kjYRzIfvZNNflYMYRkkSVA
kjYRzIfvZNNflYMYRkkSVA collected $0.50 from pot
kjYRzIfvZNNflYMYRkkSVA: doesn't show hand 
*** SUMMARY ***
Total pot $0.50 | Rake $0 
Board [Ac Ah 3s]
Seat 2: GC/9yVD59DUCX7hUI7gcLw folded before Flop (didn't bet)
Seat 3: NuqYPwTLZYQhxOoVK3Yqlw folded before Flop (didn't bet)
Seat 4: +baiVgI/ETnBARLe5mARCw (button) folded before Flop (didn't bet)
Seat 5: kjYRzIfvZNNflYMYRkkSVA (small blind) collected ($0.50)
Seat 6: KkXSr5xFjxLSD3wtAvT+WQ (big blind) folded on the Flop




PokerStars Game #59941811966:  Hold'em No Limit ($0.10/$0.25) - 2009/07/01 1:46:55 ET
Table 'Is9eNmJA1KnBOw0lcVkxUQ' 9-max Seat #3 is the button
Seat 1: 56S3mA6Zs3pGR+0p0vUCtg ($32 in chips) 
Seat 2: VllYilcih0t+gMD4GTRlgQ ($59.05 in chips) 
Seat 3: ubsjZomMWSV0hAiBLa7K1A ($19.15 in chips) 
Seat 4: cZ99hugmLBj9KhTlc8nCSw ($25 in chips) 
Seat 5: Qduu7ikeizo6q6Ei9YvcJA ($25 in chips) 
Seat 6: HapyJHxV6lc3eqoT7yWL2A ($11 in chips) 
Seat 7: aNpwfA31EREwO+ar4XzBCw ($28.30 in chips) 
Seat 8: Th3FldXKQW6hWVVPahaoOQ ($25.50 in chips) 
Seat 9: DdPXdieucQ+n99u1n3A+rQ ($4.90 in chips) 
cZ99hugmLBj9KhTlc8nCSw: posts small blind $0.10
Qduu7ikeizo6q6Ei9YvcJA: posts big blind $0.25
*** HOLE CARDS ***
HapyJHxV6lc3eqoT7yWL2A: calls $0.25
aNpwfA31EREwO+ar4XzBCw: folds 
Th3FldXKQW6hWVVPahaoOQ: folds 
DdPXdieucQ+n99u1n3A+rQ: folds 
56S3mA6Zs3pGR+0p0vUCtg: folds 
VllYilcih0t+gMD4GTRlgQ: folds 
ubsjZomMWSV0hAiBLa7K1A: calls $0.25
cZ99hugmLBj9KhTlc8nCSw: folds 
Qduu7ikeizo6q6Ei9YvcJA: checks 
*** FLOP *** [Jd 5d Ad]
Qduu7ikeizo6q6Ei9YvcJA: checks 
HapyJHxV6lc3eqoT7yWL2A: checks 
ubsjZomMWSV0hAiBLa7K1A: bets $0.50
Qduu7ikeizo6q6Ei9YvcJA: folds 
HapyJHxV6lc3eqoT7yWL2A: calls $0.50
*** TURN *** [Jd 5d Ad] [5s]
HapyJHxV6lc3eqoT7yWL2A: checks 
ubsjZomMWSV0hAiBLa7K1A: checks 
*** RIVER *** [Jd 5d Ad 5s] [Kd]
HapyJHxV6lc3eqoT7yWL2A: checks 
ubsjZomMWSV0hAiBLa7K1A: checks 
*** SHOW DOWN ***
HapyJHxV6lc3eqoT7yWL2A: shows [8d 7c] (a flush, Ace high)
ubsjZomMWSV0hAiBLa7K1A: mucks hand 
HapyJHxV6lc3eqoT7yWL2A collected $1.80 from pot
*** SUMMARY ***
Total pot $1.85 | Rake $0.05 
Board [Jd 5d Ad 5s Kd]
Seat 1: 56S3mA6Zs3pGR+0p0vUCtg folded before Flop (didn't bet)
Seat 2: VllYilcih0t+gMD4GTRlgQ folded before Flop (didn't bet)
Seat 3: ubsjZomMWSV0hAiBLa7K1A (button) mucked
Seat 4: cZ99hugmLBj9KhTlc8nCSw (small blind) folded before Flop
Seat 5: Qduu7ikeizo6q6Ei9YvcJA (big blind) folded on the Flop
Seat 6: HapyJHxV6lc3eqoT7yWL2A showed [8d 7c] and won ($1.80) with a flush, Ace high
Seat 7: aNpwfA31EREwO+ar4XzBCw folded before Flop (didn't bet)
Seat 8: Th3FldXKQW6hWVVPahaoOQ folded before Flop (didn't bet)
Seat 9: DdPXdieucQ+n99u1n3A+rQ folded before Flop (didn't bet)




PokerStars Game #59941812256:  Hold'em No Limit ($0.10/$0.25) - 2009/07/01 1:46:56 ET
Table '0XPo7K54oZIfG0xlNAcDRw' 9-max Seat #7 is the button
Seat 1: 7cv+9Zc9HIQHNvYsMfV3uA ($29.35 in chips) 
Seat 2: Prl9QvWQw/mISF4dSnnQUQ ($10.10 in chips) 
Seat 3: RHqgdFvufLCYe54+qd2gcA ($4.75 in chips) 
Seat 4: RubYqfvGrz2z+5ReNIj9QQ ($31.10 in chips) 
Seat 5: iOmwbUN7u4JFkV6VCA49aA ($15.75 in chips) 
Seat 6: M1nKET7WOTLbVPuAbJa3EA ($14.65 in chips) 
Seat 7: tYsOBqdU1+x+yFI7zHO7hQ ($28.45 in chips) 
Seat 8: v5jnQ1gfh9nLla3kMXG7Yg ($14.70 in chips) 
Seat 9: CmngQmkKTp8tkl6GMRTl6w ($13.60 in chips) 
v5jnQ1gfh9nLla3kMXG7Yg: posts small blind $0.10
CmngQmkKTp8tkl6GMRTl6w: posts big blind $0.25
*** HOLE CARDS ***
7cv+9Zc9HIQHNvYsMfV3uA: folds 
Prl9QvWQw/mISF4dSnnQUQ: folds 
RHqgdFvufLCYe54+qd2gcA: folds 
RubYqfvGrz2z+5ReNIj9QQ: folds 
iOmwbUN7u4JFkV6VCA49aA: calls $0.25
M1nKET7WOTLbVPuAbJa3EA: folds 
tYsOBqdU1+x+yFI7zHO7hQ: folds 
v5jnQ1gfh9nLla3kMXG7Yg: calls $0.15
CmngQmkKTp8tkl6GMRTl6w: checks 
*** FLOP *** [2d 5c 7d]
v5jnQ1gfh9nLla3kMXG7Yg: checks 
CmngQmkKTp8tkl6GMRTl6w: checks 
iOmwbUN7u4JFkV6VCA49aA said, "call this taxi"
iOmwbUN7u4JFkV6VCA49aA: bets $1.50
v5jnQ1gfh9nLla3kMXG7Yg: folds 
CmngQmkKTp8tkl6GMRTl6w: folds 
Uncalled bet ($1.50) returned to iOmwbUN7u4JFkV6VCA49aA
iOmwbUN7u4JFkV6VCA49aA collected $0.75 from pot
*** SUMMARY ***
Total pot $0.75 | Rake $0 
Board [2d 5c 7d]
Seat 1: 7cv+9Zc9HIQHNvYsMfV3uA folded before Flop (didn't bet)
Seat 2: Prl9QvWQw/mISF4dSnnQUQ folded before Flop (didn't bet)
Seat 3: RHqgdFvufLCYe54+qd2gcA folded before Flop (didn't bet)
Seat 4: RubYqfvGrz2z+5ReNIj9QQ folded before Flop (didn't bet)
Seat 5: iOmwbUN7u4JFkV6VCA49aA collected ($0.75)
Seat 6: M1nKET7WOTLbVPuAbJa3EA folded before Flop (didn't bet)
Seat 7: tYsOBqdU1+x+yFI7zHO7hQ (button) folded before Flop (didn't bet)
Seat 8: v5jnQ1gfh9nLla3kMXG7Yg (small blind) folded on the Flop
Seat 9: CmngQmkKTp8tkl6GMRTl6w (big blind) folded on the Flop




PokerStars Game #59941812348:  Hold'em No Limit ($0.10/$0.25) - 2009/07/01 1:46:56 ET
Table 'fRxOyfaHXkWUDLv4eSxFew' 9-max Seat #2 is the button
Seat 1: 6RiVTYll/5D8zICp0MRpKw ($28.80 in chips) 
Seat 2: M2QO2DxB5Wawg2h8HSpnYA ($10 in chips) 
Seat 3: E0iYnEVO2ho7dH3QcCjw7g ($20.10 in chips) 
Seat 4: MtVtHDqIJTyUcXkRBBDIVA ($27.95 in chips) 
Seat 5: dmYlc+1cjwZMJ7wV+Z0rRg ($22.75 in chips) 
Seat 6: arxNSjreDRGFg13EAM2F1w ($27.05 in chips) 
Seat 7: 1/DuWziR8CXhWB71aPQd9Q ($11.80 in chips) 
Seat 8: 5n7e7I+px7c6CQmLpPbtsg ($5.90 in chips) 
Seat 9: H5Se03ZqSX7tbULXur2MAg ($32.65 in chips) 
E0iYnEVO2ho7dH3QcCjw7g: posts small blind $0.10
MtVtHDqIJTyUcXkRBBDIVA: posts big blind $0.25
*** HOLE CARDS ***
dmYlc+1cjwZMJ7wV+Z0rRg: folds 
arxNSjreDRGFg13EAM2F1w: folds 
1/DuWziR8CXhWB71aPQd9Q: calls $0.25
5n7e7I+px7c6CQmLpPbtsg: folds 
H5Se03ZqSX7tbULXur2MAg: folds 
6RiVTYll/5D8zICp0MRpKw: raises $1.25 to $1.50
M2QO2DxB5Wawg2h8HSpnYA: folds 
E0iYnEVO2ho7dH3QcCjw7g: folds 
MtVtHDqIJTyUcXkRBBDIVA: folds 
1/DuWziR8CXhWB71aPQd9Q: folds 
Uncalled bet ($1.25) returned to 6RiVTYll/5D8zICp0MRpKw
6RiVTYll/5D8zICp0MRpKw collected $0.85 from pot
*** SUMMARY ***
Total pot $0.85 | Rake $0 
Seat 1: 6RiVTYll/5D8zICp0MRpKw collected ($0.85)
Seat 2: M2QO2DxB5Wawg2h8HSpnYA (button) folded before Flop (didn't bet)
Seat 3: E0iYnEVO2ho7dH3QcCjw7g (small blind) folded before Flop
Seat 4: MtVtHDqIJTyUcXkRBBDIVA (big blind) folded before Flop
Seat 5: dmYlc+1cjwZMJ7wV+Z0rRg folded before Flop (didn't bet)
Seat 6: arxNSjreDRGFg13EAM2F1w folded before Flop (didn't bet)
Seat 7: 1/DuWziR8CXhWB71aPQd9Q folded before Flop
Seat 8: 5n7e7I+px7c6CQmLpPbtsg folded before Flop (didn't bet)
Seat 9: H5Se03ZqSX7tbULXur2MAg folded before Flop (didn't bet)




PokerStars Game #59941812420:  Hold'em No Limit ($0.10/$0.25) - 2009/07/01 1:46:56 ET
Table 'D1Yq70l0nNCyMV6DA42p+Q' 9-max Seat #9 is the button
Seat 2: zgi+EUykT/pZQpoUG6+oEg ($4.05 in chips) 
Seat 3: 9lvO/qyU+xrU95Teu1fv0g ($5.50 in chips) 
Seat 4: VWUWpMLMj/Q1jRVpF7Aohw ($8.90 in chips) 
Seat 5: gehe91e0IyVT0QU/XBkEyg ($25 in chips) 
Seat 6: wGigCmBR/9XWkPpvYos3aQ ($33.20 in chips) 
Seat 7: Lqytncc1Dsgt654eEBp/uw ($33.15 in chips) 
Seat 8: zDrucyjVn5aeekNEc3cJrA ($24.35 in chips) 
Seat 9: h5wEs8qXrBqfLa9GjaSBzg ($20.75 in chips) 
zgi+EUykT/pZQpoUG6+oEg: posts small blind $0.10
9lvO/qyU+xrU95Teu1fv0g: posts big blind $0.25
zDrucyjVn5aeekNEc3cJrA: posts small & big blinds $0.35
*** HOLE CARDS ***
VWUWpMLMj/Q1jRVpF7Aohw: folds 
gehe91e0IyVT0QU/XBkEyg: folds 
wGigCmBR/9XWkPpvYos3aQ: folds 
Lqytncc1Dsgt654eEBp/uw: calls $0.25
zDrucyjVn5aeekNEc3cJrA: checks 
h5wEs8qXrBqfLa9GjaSBzg: calls $0.25
zgi+EUykT/pZQpoUG6+oEg: folds 
9lvO/qyU+xrU95Teu1fv0g: checks 
*** FLOP *** [3s 8c 6s]
9lvO/qyU+xrU95Teu1fv0g: checks 
Lqytncc1Dsgt654eEBp/uw: bets $1
zDrucyjVn5aeekNEc3cJrA: folds 
h5wEs8qXrBqfLa9GjaSBzg: calls $1
9lvO/qyU+xrU95Teu1fv0g: folds 
*** TURN *** [3s 8c 6s] [2s]
Lqytncc1Dsgt654eEBp/uw: checks 
h5wEs8qXrBqfLa9GjaSBzg: checks 
*** RIVER *** [3s 8c 6s 2s] [3h]
Lqytncc1Dsgt654eEBp/uw: checks 
h5wEs8qXrBqfLa9GjaSBzg: bets $2
Lqytncc1Dsgt654eEBp/uw: calls $2
*** SHOW DOWN ***
h5wEs8qXrBqfLa9GjaSBzg: shows [9d Qc] (a pair of Threes)
Lqytncc1Dsgt654eEBp/uw: shows [7c 7d] (two pair, Sevens and Threes)
Lqytncc1Dsgt654eEBp/uw collected $6.85 from pot
*** SUMMARY ***
Total pot $7.20 | Rake $0.35 
Board [3s 8c 6s 2s 3h]
Seat 2: zgi+EUykT/pZQpoUG6+oEg (small blind) folded before Flop
Seat 3: 9lvO/qyU+xrU95Teu1fv0g (big blind) folded on the Flop
Seat 4: VWUWpMLMj/Q1jRVpF7Aohw folded before Flop (didn't bet)
Seat 5: gehe91e0IyVT0QU/XBkEyg folded before Flop (didn't bet)
Seat 6: wGigCmBR/9XWkPpvYos3aQ folded before Flop (didn't bet)
Seat 7: Lqytncc1Dsgt654eEBp/uw showed [7c 7d] and won ($6.85) with two pair, Sevens and Threes
Seat 8: zDrucyjVn5aeekNEc3cJrA folded on the Flop
Seat 9: h5wEs8qXrBqfLa9GjaSBzg (button) showed [9d Qc] and lost with a pair of Threes




PokerStars Game #59941812504:  Hold'em No Limit ($0.10/$0.25) - 2009/07/01 1:46:56 ET
Table 'zW+7jPbOLCvlPu+dUGY5WQ' 6-max Seat #4 is the button
Seat 1: eL3+wCBjFGfQ5FMdIZihwA ($26.50 in chips) 
Seat 2: cEMJmfAUQZmMChZe6aacKw ($10.20 in chips) 
Seat 4: i48129QFpEQQ+UN4aNtmww ($18.55 in chips) 
Seat 5: Hsvkc0/G2VV78oVmWYXecw ($5 in chips) 
Seat 6: qGHGf/553gQnDoklMRe3tg ($25 in chips) 
Hsvkc0/G2VV78oVmWYXecw: posts small blind $0.10
qGHGf/553gQnDoklMRe3tg: posts big blind $0.25
*** HOLE CARDS ***
eL3+wCBjFGfQ5FMdIZihwA: folds 
cEMJmfAUQZmMChZe6aacKw: folds 
i48129QFpEQQ+UN4aNtmww: folds 
Hsvkc0/G2VV78oVmWYXecw: folds 
Uncalled bet ($0.15) returned to qGHGf/553gQnDoklMRe3tg
qGHGf/553gQnDoklMRe3tg collected $0.20 from pot
qGHGf/553gQnDoklMRe3tg: doesn't show hand 
*** SUMMARY ***
Total pot $0.20 | Rake $0 
Seat 1: eL3+wCBjFGfQ5FMdIZihwA folded before Flop (didn't bet)
Seat 2: cEMJmfAUQZmMChZe6aacKw folded before Flop (didn't bet)
Seat 4: i48129QFpEQQ+UN4aNtmww (button) folded before Flop (didn't bet)
Seat 5: Hsvkc0/G2VV78oVmWYXecw (small blind) folded before Flop
Seat 6: qGHGf/553gQnDoklMRe3tg (big blind) collected ($0.20)




PokerStars Game #59941812296:  Hold'em No Limit ($0.10/$0.25) - 2009/07/01 1:46:56 ET
Table '9iHhO6FyZVM8XpSc23TIgg' 6-max Seat #3 is the button
Seat 1: NhUN/JpAprdJeamFBgJH1w ($37.30 in chips) 
Seat 2: bJFzs6QmEEnz4miMfSDtcg ($39.25 in chips) 
Seat 3: TSmua8tGK3sTbwi0ynrW9Q ($25.25 in chips) 
Seat 4: cfJccEfyn6IkquPN08hFsA ($18.10 in chips) 
Seat 5: OMGl+YMGogf2JWIRfT2/Yg ($5 in chips) 
Seat 6: iyZxqznXjv3vtvOJymkoLQ ($34.20 in chips) 
cfJccEfyn6IkquPN08hFsA: posts small blind $0.10
OMGl+YMGogf2JWIRfT2/Yg: posts big blind $0.25
*** HOLE CARDS ***
iyZxqznXjv3vtvOJymkoLQ: folds 
NhUN/JpAprdJeamFBgJH1w: folds 
bJFzs6QmEEnz4miMfSDtcg: raises $0.50 to $0.75
TSmua8tGK3sTbwi0ynrW9Q: folds 
cfJccEfyn6IkquPN08hFsA: calls $0.65
OMGl+YMGogf2JWIRfT2/Yg: calls $0.50
*** FLOP *** [Jd 9d 2h]
cfJccEfyn6IkquPN08hFsA: checks 
OMGl+YMGogf2JWIRfT2/Yg: bets $0.50
bJFzs6QmEEnz4miMfSDtcg: raises $1.25 to $1.75
cfJccEfyn6IkquPN08hFsA: folds 
OMGl+YMGogf2JWIRfT2/Yg: raises $2.50 to $4.25 and is all-in
bJFzs6QmEEnz4miMfSDtcg: calls $2.50
*** TURN *** [Jd 9d 2h] [Ts]
*** RIVER *** [Jd 9d 2h Ts] [7d]
*** SHOW DOWN ***
OMGl+YMGogf2JWIRfT2/Yg: shows [2d 5d] (a flush, Jack high)
bJFzs6QmEEnz4miMfSDtcg: mucks hand 
OMGl+YMGogf2JWIRfT2/Yg collected $10.25 from pot
bJFzs6QmEEnz4miMfSDtcg said, "donk"
*** SUMMARY ***
Total pot $10.75 | Rake $0.50 
Board [Jd 9d 2h Ts 7d]
Seat 1: NhUN/JpAprdJeamFBgJH1w folded before Flop (didn't bet)
Seat 2: bJFzs6QmEEnz4miMfSDtcg mucked
Seat 3: TSmua8tGK3sTbwi0ynrW9Q (button) folded before Flop (didn't bet)
Seat 4: cfJccEfyn6IkquPN08hFsA (small blind) folded on the Flop
Seat 5: OMGl+YMGogf2JWIRfT2/Yg (big blind) showed [2d 5d] and won ($10.25) with a flush, Jack high
Seat 6: iyZxqznXjv3vtvOJymkoLQ folded before Flop (didn't bet)




PokerStars Game #59941812452:  Hold'em No Limit ($0.10/$0.25) - 2009/07/01 1:46:56 ET
Table 'nlpa8xI95gAflovnFxB2yg' 6-max Seat #3 is the button
Seat 1: fZQg9veL7Dd/Z04ZTjC+wQ ($61.80 in chips) 
Seat 2: Yuyy/pDz3yAO3EbHYRYnKw ($24.40 in chips) 
Seat 3: DihMHaz4WNETH1bPDe13kA ($25 in chips) 
Seat 4: if4dh6jhJXeN3/qd3qCp9g ($52.10 in chips) 
Seat 5: FDWzjQgBA5K04jOIY/j22w ($6.15 in chips) 
Seat 6: ATNFxN8fYVfSZMQW8dvbvw ($5.65 in chips) 
if4dh6jhJXeN3/qd3qCp9g: posts small blind $0.10
FDWzjQgBA5K04jOIY/j22w: posts big blind $0.25
*** HOLE CARDS ***
ATNFxN8fYVfSZMQW8dvbvw: folds 
fZQg9veL7Dd/Z04ZTjC+wQ: folds 
Yuyy/pDz3yAO3EbHYRYnKw: calls $0.25
DihMHaz4WNETH1bPDe13kA: folds 
if4dh6jhJXeN3/qd3qCp9g: folds 
FDWzjQgBA5K04jOIY/j22w: checks 
*** FLOP *** [Js 7d 4c]
FDWzjQgBA5K04jOIY/j22w: bets $0.50
Yuyy/pDz3yAO3EbHYRYnKw: folds 
Uncalled bet ($0.50) returned to FDWzjQgBA5K04jOIY/j22w
FDWzjQgBA5K04jOIY/j22w collected $0.60 from pot
FDWzjQgBA5K04jOIY/j22w: doesn't show hand 
*** SUMMARY ***
Total pot $0.60 | Rake $0 
Board [Js 7d 4c]
Seat 1: fZQg9veL7Dd/Z04ZTjC+wQ folded before Flop (didn't bet)
Seat 2: Yuyy/pDz3yAO3EbHYRYnKw folded on the Flop
Seat 3: DihMHaz4WNETH1bPDe13kA (button) folded before Flop (didn't bet)
Seat 4: if4dh6jhJXeN3/qd3qCp9g (small blind) folded before Flop
Seat 5: FDWzjQgBA5K04jOIY/j22w (big blind) collected ($0.60)
Seat 6: ATNFxN8fYVfSZMQW8dvbvw folded before Flop (didn't bet)




PokerStars Game #59941812706:  Hold'em No Limit ($0.10/$0.25) - 2009/07/01 1:46:57 ET
Table '84TjTrgbsYZladOc4PWf4Q' 6-max Seat #4 is the button
Seat 1: /kW0t5kKllzd8HO2uEapHQ ($20.45 in chips) 
Seat 2: RpaEX9P7BCvyfPRLiRNg0A ($44.80 in chips) 
Seat 3: Ar4vsUIUfJ7gbYh1c1m59g ($10.85 in chips) 
Seat 4: SxIIgwXYLkwd6m3wLyPTCw ($25 in chips) 
Seat 5: cezpHJ8FB07dj0xG+LhOvw ($27.20 in chips) 
Seat 6: wCUaomJ6Nq5zomVGdUHP+w ($18 in chips) 
cezpHJ8FB07dj0xG+LhOvw: posts small blind $0.10
wCUaomJ6Nq5zomVGdUHP+w: posts big blind $0.25
*** HOLE CARDS ***
/kW0t5kKllzd8HO2uEapHQ: calls $0.25
RpaEX9P7BCvyfPRLiRNg0A: raises $0.75 to $1
Ar4vsUIUfJ7gbYh1c1m59g: folds 
SxIIgwXYLkwd6m3wLyPTCw: folds 
cezpHJ8FB07dj0xG+LhOvw: folds 
wCUaomJ6Nq5zomVGdUHP+w: calls $0.75
/kW0t5kKllzd8HO2uEapHQ: calls $0.75
*** FLOP *** [2d 5c Jc]
wCUaomJ6Nq5zomVGdUHP+w: bets $0.75
/kW0t5kKllzd8HO2uEapHQ: folds 
RpaEX9P7BCvyfPRLiRNg0A: calls $0.75
*** TURN *** [2d 5c Jc] [3h]
wCUaomJ6Nq5zomVGdUHP+w: checks 
RpaEX9P7BCvyfPRLiRNg0A: checks 
*** RIVER *** [2d 5c Jc 3h] [5s]
wCUaomJ6Nq5zomVGdUHP+w: bets $1
RpaEX9P7BCvyfPRLiRNg0A: calls $1
*** SHOW DOWN ***
wCUaomJ6Nq5zomVGdUHP+w: shows [Tc Kc] (a pair of Fives)
RpaEX9P7BCvyfPRLiRNg0A: shows [Kd Ad] (a pair of Fives - Ace kicker)
RpaEX9P7BCvyfPRLiRNg0A collected $6.30 from pot
*** SUMMARY ***
Total pot $6.60 | Rake $0.30 
Board [2d 5c Jc 3h 5s]
Seat 1: /kW0t5kKllzd8HO2uEapHQ folded on the Flop
Seat 2: RpaEX9P7BCvyfPRLiRNg0A showed [Kd Ad] and won ($6.30) with a pair of Fives
Seat 3: Ar4vsUIUfJ7gbYh1c1m59g folded before Flop (didn't bet)
Seat 4: SxIIgwXYLkwd6m3wLyPTCw (button) folded before Flop (didn't bet)
Seat 5: cezpHJ8FB07dj0xG+LhOvw (small blind) folded before Flop
Seat 6: wCUaomJ6Nq5zomVGdUHP+w (big blind) showed [Tc Kc] and lost with a pair of Fives




PokerStars Game #59941813016:  Hold'em No Limit ($0.10/$0.25) - 2009/07/01 1:46:57 ET
Table 'QzXakDK7ZHNjgIpoUFGSKQ' 9-max Seat #3 is the button
Seat 1: w1ukf8uPa4+WH561TtVRxA ($25 in chips) 
Seat 2: QEbIGci+itdw+re8RM5fZA ($25 in chips) 
Seat 3: eK8qa6EPcH2zhtbmWSvc9g ($25.30 in chips) 
Seat 4: 12pxJGeALcKLTBryE6kFxA ($14.35 in chips) 
Seat 5: MtVtHDqIJTyUcXkRBBDIVA ($32.30 in chips) 
Seat 6: gehe91e0IyVT0QU/XBkEyg ($25 in chips) 
Seat 7: wGigCmBR/9XWkPpvYos3aQ ($29.90 in chips) 
Seat 9: lwrOE80tuooHfIBx/4LUSw ($24.15 in chips) 
12pxJGeALcKLTBryE6kFxA: posts small blind $0.10
MtVtHDqIJTyUcXkRBBDIVA: posts big blind $0.25
Z9W7+g1WMhhZDi7DwGbCFA: sits out 
*** HOLE CARDS ***
gehe91e0IyVT0QU/XBkEyg: folds 
wGigCmBR/9XWkPpvYos3aQ: folds 
lwrOE80tuooHfIBx/4LUSw: raises $0.75 to $1
w1ukf8uPa4+WH561TtVRxA: folds 
QEbIGci+itdw+re8RM5fZA: folds 
eK8qa6EPcH2zhtbmWSvc9g: folds 
12pxJGeALcKLTBryE6kFxA: calls $0.90
MtVtHDqIJTyUcXkRBBDIVA: calls $0.75
*** FLOP *** [7d 6d Js]
12pxJGeALcKLTBryE6kFxA: checks 
MtVtHDqIJTyUcXkRBBDIVA: checks 
lwrOE80tuooHfIBx/4LUSw: bets $1.50
12pxJGeALcKLTBryE6kFxA: calls $1.50
MtVtHDqIJTyUcXkRBBDIVA: folds 
*** TURN *** [7d 6d Js] [5h]
12pxJGeALcKLTBryE6kFxA: checks 
lwrOE80tuooHfIBx/4LUSw: checks 
*** RIVER *** [7d 6d Js 5h] [8c]
12pxJGeALcKLTBryE6kFxA: bets $3.50
lwrOE80tuooHfIBx/4LUSw: raises $4.50 to $8
12pxJGeALcKLTBryE6kFxA: raises $3.85 to $11.85 and is all-in
lwrOE80tuooHfIBx/4LUSw: calls $3.85
*** SHOW DOWN ***
12pxJGeALcKLTBryE6kFxA: shows [Ad 9d] (a straight, Five to Nine)
lwrOE80tuooHfIBx/4LUSw: shows [9s 9h] (a straight, Five to Nine)
12pxJGeALcKLTBryE6kFxA collected $14.15 from pot
lwrOE80tuooHfIBx/4LUSw collected $14.10 from pot
*** SUMMARY ***
Total pot $29.70 | Rake $1.45 
Board [7d 6d Js 5h 8c]
Seat 1: w1ukf8uPa4+WH561TtVRxA folded before Flop (didn't bet)
Seat 2: QEbIGci+itdw+re8RM5fZA folded before Flop (didn't bet)
Seat 3: eK8qa6EPcH2zhtbmWSvc9g (button) folded before Flop (didn't bet)
Seat 4: 12pxJGeALcKLTBryE6kFxA (small blind) showed [Ad 9d] and won ($14.15) with a straight, Five to Nine
Seat 5: MtVtHDqIJTyUcXkRBBDIVA (big blind) folded on the Flop
Seat 6: gehe91e0IyVT0QU/XBkEyg folded before Flop (didn't bet)
Seat 7: wGigCmBR/9XWkPpvYos3aQ folded before Flop (didn't bet)
Seat 9: lwrOE80tuooHfIBx/4LUSw showed [9s 9h] and won ($14.10) with a straight, Five to Nine




PokerStars Game #59941812798:  Hold'em No Limit ($0.10/$0.25) - 2009/07/01 1:46:57 ET
Table '/JJyyIstHfkT7t/bW+WXgg' 6-max Seat #3 is the button
Seat 2: obJgSnVgWWWaAUtVILo77Q ($18 in chips) 
Seat 3: DR0nVIhVP77oEBlO9J8vlg ($36.75 in chips) 
Seat 4: JFIAqU8lCZ0vWwEl4bdGsg ($35.90 in chips) 
Seat 5: +ZlnqPoP3Hg4BIUxDfKd/A ($46.20 in chips) 
Seat 6: UmcUp27+PbgBItv3ZNlAWQ ($25 in chips) 
JFIAqU8lCZ0vWwEl4bdGsg: posts small blind $0.10
+ZlnqPoP3Hg4BIUxDfKd/A: posts big blind $0.25
xC0kaiDYM6YTlgODL83O5A: sits out 
*** HOLE CARDS ***
UmcUp27+PbgBItv3ZNlAWQ: folds 
obJgSnVgWWWaAUtVILo77Q: folds 
DR0nVIhVP77oEBlO9J8vlg: raises $0.50 to $0.75
JFIAqU8lCZ0vWwEl4bdGsg: folds 
+ZlnqPoP3Hg4BIUxDfKd/A: folds 
Uncalled bet ($0.50) returned to DR0nVIhVP77oEBlO9J8vlg
DR0nVIhVP77oEBlO9J8vlg collected $0.60 from pot
DR0nVIhVP77oEBlO9J8vlg: doesn't show hand 
*** SUMMARY ***
Total pot $0.60 | Rake $0 
Seat 2: obJgSnVgWWWaAUtVILo77Q folded before Flop (didn't bet)
Seat 3: DR0nVIhVP77oEBlO9J8vlg (button) collected ($0.60)
Seat 4: JFIAqU8lCZ0vWwEl4bdGsg (small blind) folded before Flop
Seat 5: +ZlnqPoP3Hg4BIUxDfKd/A (big blind) folded before Flop
Seat 6: UmcUp27+PbgBItv3ZNlAWQ folded before Flop (didn't bet)




PokerStars Game #59941813434:  Hold'em No Limit ($0.10/$0.25) - 2009/07/01 1:46:58 ET
Table 'O5NgMYt6EWbLBozZb3kseg' 6-max Seat #3 is the button
Seat 3: nEezgRkm8mxa3J5ySz1mJQ ($9.60 in chips) 
Seat 4: ItRgvLhXTZHvtZowz+dbIw ($13.25 in chips) 
nEezgRkm8mxa3J5ySz1mJQ: posts small blind $0.10
ItRgvLhXTZHvtZowz+dbIw: posts big blind $0.25
*** HOLE CARDS ***
nEezgRkm8mxa3J5ySz1mJQ: raises $0.50 to $0.75
ItRgvLhXTZHvtZowz+dbIw: folds 
Uncalled bet ($0.50) returned to nEezgRkm8mxa3J5ySz1mJQ
nEezgRkm8mxa3J5ySz1mJQ collected $0.50 from pot
nEezgRkm8mxa3J5ySz1mJQ: doesn't show hand 
*** SUMMARY ***
Total pot $0.50 | Rake $0 
Seat 3: nEezgRkm8mxa3J5ySz1mJQ (button) (small blind) collected ($0.50)
Seat 4: ItRgvLhXTZHvtZowz+dbIw (big blind) folded before Flop




PokerStars Game #59941813066:  Hold'em No Limit ($0.10/$0.25) - 2009/07/01 1:46:58 ET
Table 'edvgY2YQ1I34euq4EVqGnA' 6-max Seat #4 is the button
Seat 1: mvFHK3pE7tCxJEqLjKC70Q ($25 in chips) 
Seat 2: Hsvkc0/G2VV78oVmWYXecw ($5 in chips) 
Seat 3: mFv3iBCtrw9XfCDRB0d46Q ($3.20 in chips) 
Seat 4: TI/C5Q+DEl4fLR3AofwYdg ($23.40 in chips) 
Seat 5: EE16Ua5b1HSsYej5zeXOlA ($56.85 in chips) 
Seat 6: kG34n23qFQA3nzdOJTQ1dA ($71.35 in chips) 
EE16Ua5b1HSsYej5zeXOlA: posts small blind $0.10
kG34n23qFQA3nzdOJTQ1dA: posts big blind $0.25
*** HOLE CARDS ***
mvFHK3pE7tCxJEqLjKC70Q: folds 
Hsvkc0/G2VV78oVmWYXecw: folds 
mFv3iBCtrw9XfCDRB0d46Q: raises $2.95 to $3.20 and is all-in
TI/C5Q+DEl4fLR3AofwYdg: folds 
EE16Ua5b1HSsYej5zeXOlA: folds 
kG34n23qFQA3nzdOJTQ1dA: folds 
Uncalled bet ($2.95) returned to mFv3iBCtrw9XfCDRB0d46Q
mFv3iBCtrw9XfCDRB0d46Q collected $0.60 from pot
mFv3iBCtrw9XfCDRB0d46Q: doesn't show hand 
*** SUMMARY ***
Total pot $0.60 | Rake $0 
Seat 1: mvFHK3pE7tCxJEqLjKC70Q folded before Flop (didn't bet)
Seat 2: Hsvkc0/G2VV78oVmWYXecw folded before Flop (didn't bet)
Seat 3: mFv3iBCtrw9XfCDRB0d46Q collected ($0.60)
Seat 4: TI/C5Q+DEl4fLR3AofwYdg (button) folded before Flop (didn't bet)
Seat 5: EE16Ua5b1HSsYej5zeXOlA (small blind) folded before Flop
Seat 6: kG34n23qFQA3nzdOJTQ1dA (big blind) folded before Flop




PokerStars Game #59941813324:  Hold'em No Limit ($0.10/$0.25) - 2009/07/01 1:46:58 ET
Table 'NtEQAxCeIK2io1CGtW658g' 6-max Seat #5 is the button
Seat 1: X437kMQ7AujoaDgjguhU9w ($12.20 in chips) 
Seat 2: DgyznDqq/mLiCqQGMzc+Aw ($9.20 in chips) 
Seat 3: 5nwDw10uIM0XEyLhla0oGA ($23.75 in chips) 
Seat 4: 8296 ($9.45 in chips) 
Seat 5: Hsvkc0/G2VV78oVmWYXecw ($6.85 in chips) 
Seat 6: /gJNBeCkWL4o85/jvlZ4BA ($64.45 in chips) 
/gJNBeCkWL4o85/jvlZ4BA: posts small blind $0.10
X437kMQ7AujoaDgjguhU9w: posts big blind $0.25
*** HOLE CARDS ***
DgyznDqq/mLiCqQGMzc+Aw: raises $0.25 to $0.50
5nwDw10uIM0XEyLhla0oGA: folds 
8296: folds 
Hsvkc0/G2VV78oVmWYXecw: folds 
/gJNBeCkWL4o85/jvlZ4BA: folds 
X437kMQ7AujoaDgjguhU9w: calls $0.25
*** FLOP *** [5c 8c Kh]
X437kMQ7AujoaDgjguhU9w: checks 
DgyznDqq/mLiCqQGMzc+Aw: checks 
*** TURN *** [5c 8c Kh] [7c]
X437kMQ7AujoaDgjguhU9w: bets $0.25
DgyznDqq/mLiCqQGMzc+Aw: calls $0.25
*** RIVER *** [5c 8c Kh 7c] [Kc]
X437kMQ7AujoaDgjguhU9w: checks 
DgyznDqq/mLiCqQGMzc+Aw: bets $0.75
X437kMQ7AujoaDgjguhU9w: folds 
Uncalled bet ($0.75) returned to DgyznDqq/mLiCqQGMzc+Aw
DgyznDqq/mLiCqQGMzc+Aw collected $1.55 from pot
*** SUMMARY ***
Total pot $1.60 | Rake $0.05 
Board [5c 8c Kh 7c Kc]
Seat 1: X437kMQ7AujoaDgjguhU9w (big blind) folded on the River
Seat 2: DgyznDqq/mLiCqQGMzc+Aw collected ($1.55)
Seat 3: 5nwDw10uIM0XEyLhla0oGA folded before Flop (didn't bet)
Seat 4: 8296 folded before Flop (didn't bet)
Seat 5: Hsvkc0/G2VV78oVmWYXecw (button) folded before Flop (didn't bet)
Seat 6: /gJNBeCkWL4o85/jvlZ4BA (small blind) folded before Flop




PokerStars Game #59941813480:  Hold'em No Limit ($0.10/$0.25) - 2009/07/01 1:46:58 ET
Table '3Ns9nuTkynfwbBfBXzg6ww' 6-max Seat #2 is the button
Seat 1: epAUIB7h2FJXzUPRIvSkRA ($25.35 in chips) 
Seat 2: zxeVQGaMKDsDzmSY+AInjA ($31.65 in chips) 
Seat 3: eL3+wCBjFGfQ5FMdIZihwA ($24.05 in chips) 
Seat 4: qGHGf/553gQnDoklMRe3tg ($30.60 in chips) 
Seat 5: wqphQtauX5Qn7WRJZS1flA ($24.05 in chips) 
Seat 6: DE9hRlt14g+JdsRQ4wT7hg ($39.10 in chips) 
eL3+wCBjFGfQ5FMdIZihwA: posts small blind $0.10
qGHGf/553gQnDoklMRe3tg: posts big blind $0.25
*** HOLE CARDS ***
wqphQtauX5Qn7WRJZS1flA: folds 
DE9hRlt14g+JdsRQ4wT7hg: folds 
epAUIB7h2FJXzUPRIvSkRA: raises $0.75 to $1
zxeVQGaMKDsDzmSY+AInjA: folds 
eL3+wCBjFGfQ5FMdIZihwA: folds 
qGHGf/553gQnDoklMRe3tg: folds 
Uncalled bet ($0.75) returned to epAUIB7h2FJXzUPRIvSkRA
epAUIB7h2FJXzUPRIvSkRA collected $0.60 from pot
epAUIB7h2FJXzUPRIvSkRA: doesn't show hand 
*** SUMMARY ***
Total pot $0.60 | Rake $0 
Seat 1: epAUIB7h2FJXzUPRIvSkRA collected ($0.60)
Seat 2: zxeVQGaMKDsDzmSY+AInjA (button) folded before Flop (didn't bet)
Seat 3: eL3+wCBjFGfQ5FMdIZihwA (small blind) folded before Flop
Seat 4: qGHGf/553gQnDoklMRe3tg (big blind) folded before Flop
Seat 5: wqphQtauX5Qn7WRJZS1flA folded before Flop (didn't bet)
Seat 6: DE9hRlt14g+JdsRQ4wT7hg folded before Flop (didn't bet)




PokerStars Game #59941813756:  Hold'em No Limit ($0.10/$0.25) - 2009/07/01 1:46:59 ET
Table 'Ez9TB43XM4QgMDQkIW9DYw' 9-max Seat #2 is the button
Seat 1: ShCS62CJp4MKfKLKvGKQbA ($9.95 in chips) 
Seat 2: PFNLAvMkr8qKc7xCiH0wTA ($17 in chips) 
Seat 3: PdIasPkzm2sqZnN41ZRXOg ($4.75 in chips) 
Seat 4: ubsjZomMWSV0hAiBLa7K1A ($20 in chips) 
Seat 5: qpG9m8I+cPw8VhB0mnGjYw ($33.15 in chips) 
Seat 6: 76o85YBHJ9veRYp2LPuluQ ($19.45 in chips) 
Seat 7: Bb42QRQMhg5/Y0vHP8/2Xw ($55.95 in chips) 
Seat 8: +2kMBNpY4nF1qNCRd8SJLA ($28.75 in chips) 
Seat 9: QEbIGci+itdw+re8RM5fZA ($25 in chips) 
PdIasPkzm2sqZnN41ZRXOg: posts small blind $0.10
ubsjZomMWSV0hAiBLa7K1A: posts big blind $0.25
*** HOLE CARDS ***
qpG9m8I+cPw8VhB0mnGjYw: folds 
qpG9m8I+cPw8VhB0mnGjYw leaves the table
76o85YBHJ9veRYp2LPuluQ: calls $0.25
Bb42QRQMhg5/Y0vHP8/2Xw: folds 
+2kMBNpY4nF1qNCRd8SJLA: folds 
bXpVeaSTPBFSPJmeXxO7nw joins the table at seat #5 
QEbIGci+itdw+re8RM5fZA: folds 
ShCS62CJp4MKfKLKvGKQbA: folds 
PFNLAvMkr8qKc7xCiH0wTA: folds 
PdIasPkzm2sqZnN41ZRXOg: folds 
ubsjZomMWSV0hAiBLa7K1A: checks 
*** FLOP *** [3c Th Ks]
ubsjZomMWSV0hAiBLa7K1A: checks 
76o85YBHJ9veRYp2LPuluQ: checks 
*** TURN *** [3c Th Ks] [6s]
ubsjZomMWSV0hAiBLa7K1A: bets $0.25
76o85YBHJ9veRYp2LPuluQ: calls $0.25
*** RIVER *** [3c Th Ks 6s] [2s]
ubsjZomMWSV0hAiBLa7K1A: bets $0.50
76o85YBHJ9veRYp2LPuluQ: folds 
Uncalled bet ($0.50) returned to ubsjZomMWSV0hAiBLa7K1A
ubsjZomMWSV0hAiBLa7K1A collected $1.05 from pot
*** SUMMARY ***
Total pot $1.10 | Rake $0.05 
Board [3c Th Ks 6s 2s]
Seat 1: ShCS62CJp4MKfKLKvGKQbA folded before Flop (didn't bet)
Seat 2: PFNLAvMkr8qKc7xCiH0wTA (button) folded before Flop (didn't bet)
Seat 3: PdIasPkzm2sqZnN41ZRXOg (small blind) folded before Flop
Seat 4: ubsjZomMWSV0hAiBLa7K1A (big blind) collected ($1.05)
Seat 5: qpG9m8I+cPw8VhB0mnGjYw folded before Flop (didn't bet)
Seat 6: 76o85YBHJ9veRYp2LPuluQ folded on the River
Seat 7: Bb42QRQMhg5/Y0vHP8/2Xw folded before Flop (didn't bet)
Seat 8: +2kMBNpY4nF1qNCRd8SJLA folded before Flop (didn't bet)
Seat 9: QEbIGci+itdw+re8RM5fZA folded before Flop (didn't bet)




PokerStars Game #59941814126:  Hold'em No Limit ($0.10/$0.25) - 2009/07/01 1:46:59 ET
Table 'YYMg5qzxK1m9eGRo4SbxtQ' 9-max Seat #3 is the button
Seat 1: 3PmVnC/15cl4oyI1TKIt4g ($5 in chips) 
Seat 2: f/H6PsHRl4W1JyNsEDvPtg ($13.85 in chips) 
Seat 3: eK8qa6EPcH2zhtbmWSvc9g ($25.25 in chips) 
Seat 4: ROxrieegd9WYtWcUKJAlbg ($13.50 in chips) 
Seat 5: 4awUyiDYTgylQKXZ9faBVA ($25 in chips) 
Seat 6: S5VeQLgBIiHrfs9AB2vBwA ($3.30 in chips) 
Seat 8: xoBFd/5k+L/pFn9VW1VyWg ($14.20 in chips) 
Seat 9: +sbyWwIcFp9kP0bDtMegfQ ($31.60 in chips) 
ROxrieegd9WYtWcUKJAlbg: posts small blind $0.10
4awUyiDYTgylQKXZ9faBVA: posts big blind $0.25
S5VeQLgBIiHrfs9AB2vBwA: posts small blind $0.10
eebse2009: sits out 
*** HOLE CARDS ***
S5VeQLgBIiHrfs9AB2vBwA: raises $0.75 to $1
xoBFd/5k+L/pFn9VW1VyWg: folds 
+sbyWwIcFp9kP0bDtMegfQ: folds 
3PmVnC/15cl4oyI1TKIt4g: folds 
f/H6PsHRl4W1JyNsEDvPtg: folds 
eK8qa6EPcH2zhtbmWSvc9g: folds 
ROxrieegd9WYtWcUKJAlbg: calls $0.90
4awUyiDYTgylQKXZ9faBVA: folds 
*** FLOP *** [Qs 6c 4d]
ROxrieegd9WYtWcUKJAlbg: checks 
S5VeQLgBIiHrfs9AB2vBwA: bets $0.75
ROxrieegd9WYtWcUKJAlbg: folds 
Uncalled bet ($0.75) returned to S5VeQLgBIiHrfs9AB2vBwA
S5VeQLgBIiHrfs9AB2vBwA collected $2.25 from pot
S5VeQLgBIiHrfs9AB2vBwA: doesn't show hand 
*** SUMMARY ***
Total pot $2.35 | Rake $0.10 
Board [Qs 6c 4d]
Seat 1: 3PmVnC/15cl4oyI1TKIt4g folded before Flop (didn't bet)
Seat 2: f/H6PsHRl4W1JyNsEDvPtg folded before Flop (didn't bet)
Seat 3: eK8qa6EPcH2zhtbmWSvc9g (button) folded before Flop (didn't bet)
Seat 4: ROxrieegd9WYtWcUKJAlbg (small blind) folded on the Flop
Seat 5: 4awUyiDYTgylQKXZ9faBVA (big blind) folded before Flop
Seat 6: S5VeQLgBIiHrfs9AB2vBwA collected ($2.25)
Seat 8: xoBFd/5k+L/pFn9VW1VyWg folded before Flop (didn't bet)
Seat 9: +sbyWwIcFp9kP0bDtMegfQ folded before Flop (didn't bet)




PokerStars Game #59941813886:  Hold'em No Limit ($0.10/$0.25) - 2009/07/01 1:46:59 ET
Table 'ktio12Pyq06LsrFhIorSqA' 9-max Seat #2 is the button
Seat 1: OneeONzF0MoH0pEdcBndwA ($37.80 in chips) 
Seat 2: tGsFgUKjSctVaAXabrlZxw ($4.95 in chips) 
Seat 3: Z9W7+g1WMhhZDi7DwGbCFA ($5.10 in chips) 
Seat 4: 0QdZrkFD7aGKeBXPGbIomA ($5 in chips) 
Seat 5: e0pV1oisCAilWiG0FCxY6A ($16.75 in chips) 
Seat 6: jQL6XIewylQ8MmZhhq2YFg ($42.20 in chips) 
Seat 7: XGCfQsxa6PfAg3kJtzUmww ($22.10 in chips) 
Seat 9: H5Se03ZqSX7tbULXur2MAg ($26.30 in chips) 
Z9W7+g1WMhhZDi7DwGbCFA: posts small blind $0.10
0QdZrkFD7aGKeBXPGbIomA: posts big blind $0.25
*** HOLE CARDS ***
e0pV1oisCAilWiG0FCxY6A: folds 
jQL6XIewylQ8MmZhhq2YFg: folds 
XGCfQsxa6PfAg3kJtzUmww: folds 
H5Se03ZqSX7tbULXur2MAg: folds 
OneeONzF0MoH0pEdcBndwA: folds 
tGsFgUKjSctVaAXabrlZxw: folds 
Z9W7+g1WMhhZDi7DwGbCFA: folds 
Uncalled bet ($0.15) returned to 0QdZrkFD7aGKeBXPGbIomA
0QdZrkFD7aGKeBXPGbIomA collected $0.20 from pot
0QdZrkFD7aGKeBXPGbIomA: doesn't show hand 
*** SUMMARY ***
Total pot $0.20 | Rake $0 
Seat 1: OneeONzF0MoH0pEdcBndwA folded before Flop (didn't bet)
Seat 2: tGsFgUKjSctVaAXabrlZxw (button) folded before Flop (didn't bet)
Seat 3: Z9W7+g1WMhhZDi7DwGbCFA (small blind) folded before Flop
Seat 4: 0QdZrkFD7aGKeBXPGbIomA (big blind) collected ($0.20)
Seat 5: e0pV1oisCAilWiG0FCxY6A folded before Flop (didn't bet)
Seat 6: jQL6XIewylQ8MmZhhq2YFg folded before Flop (didn't bet)
Seat 7: XGCfQsxa6PfAg3kJtzUmww folded before Flop (didn't bet)
Seat 9: H5Se03ZqSX7tbULXur2MAg folded before Flop (didn't bet)




PokerStars Game #59941814108:  Hold'em No Limit ($0.10/$0.25) - 2009/07/01 1:46:59 ET
Table 'KAnP7XvDtlku47YfJwdOVw' 9-max Seat #9 is the button
Seat 1: cH3q40adP+kFogl+2MtbkQ ($14.10 in chips) 
Seat 2: E0iYnEVO2ho7dH3QcCjw7g ($20 in chips) 
Seat 3: W6tExOcYX7qiy6Qdp+ZwFA ($7.60 in chips) 
Seat 4: OiV1PWZ3IkN29JlmCcnTwQ ($4.65 in chips) 
Seat 5: MG90wfSJZnOejs/KD3vlQQ ($34 in chips) 
Seat 7: Lro4e37x4FUa5P3yzDjskw ($6.80 in chips) 
Seat 8: OneeONzF0MoH0pEdcBndwA ($22.45 in chips) 
Seat 9: HDDm1BkZtdsRyw2DJdqq6A ($23.55 in chips) 
cH3q40adP+kFogl+2MtbkQ: posts small blind $0.10
E0iYnEVO2ho7dH3QcCjw7g: posts big blind $0.25
*** HOLE CARDS ***
W6tExOcYX7qiy6Qdp+ZwFA: folds 
OiV1PWZ3IkN29JlmCcnTwQ: folds 
MG90wfSJZnOejs/KD3vlQQ: folds 
Lro4e37x4FUa5P3yzDjskw: folds 
OneeONzF0MoH0pEdcBndwA: folds 
HDDm1BkZtdsRyw2DJdqq6A: folds 
cH3q40adP+kFogl+2MtbkQ: calls $0.15
E0iYnEVO2ho7dH3QcCjw7g: raises $0.75 to $1
cH3q40adP+kFogl+2MtbkQ: calls $0.75
*** FLOP *** [9s Kd Ks]
cH3q40adP+kFogl+2MtbkQ: checks 
E0iYnEVO2ho7dH3QcCjw7g: bets $0.75
cH3q40adP+kFogl+2MtbkQ: calls $0.75
*** TURN *** [9s Kd Ks] [6d]
cH3q40adP+kFogl+2MtbkQ: checks 
E0iYnEVO2ho7dH3QcCjw7g: bets $1
cH3q40adP+kFogl+2MtbkQ: folds 
Uncalled bet ($1) returned to E0iYnEVO2ho7dH3QcCjw7g
E0iYnEVO2ho7dH3QcCjw7g collected $3.35 from pot
*** SUMMARY ***
Total pot $3.50 | Rake $0.15 
Board [9s Kd Ks 6d]
Seat 1: cH3q40adP+kFogl+2MtbkQ (small blind) folded on the Turn
Seat 2: E0iYnEVO2ho7dH3QcCjw7g (big blind) collected ($3.35)
Seat 3: W6tExOcYX7qiy6Qdp+ZwFA folded before Flop (didn't bet)
Seat 4: OiV1PWZ3IkN29JlmCcnTwQ folded before Flop (didn't bet)
Seat 5: MG90wfSJZnOejs/KD3vlQQ folded before Flop (didn't bet)
Seat 7: Lro4e37x4FUa5P3yzDjskw folded before Flop (didn't bet)
Seat 8: OneeONzF0MoH0pEdcBndwA folded before Flop (didn't bet)
Seat 9: HDDm1BkZtdsRyw2DJdqq6A (button) folded before Flop (didn't bet)




PokerStars Game #59941813718:  Hold'em No Limit ($0.10/$0.25) - 2009/07/01 1:46:59 ET
Table 'dVzscin98UhGisTmV9BDcw' 9-max Seat #9 is the button
Seat 1: sBAwXpkpgyhyWbHIQcIJKA ($17.05 in chips) 
Seat 2: dfNim92Z6XK1/h5SFW5vDg ($28.35 in chips) 
Seat 3: cZ99hugmLBj9KhTlc8nCSw ($25 in chips) 
Seat 4: aNpwfA31EREwO+ar4XzBCw ($42.25 in chips) 
Seat 6: A/OkFabqdcrG3ozpiYMiNQ ($25 in chips) 
Seat 7: cKlmpQMahVsmOaxFQDcoOg ($25.25 in chips) 
Seat 8: /vn2Qu2dvc9AMMq46Ae0jA ($46.75 in chips) 
Seat 9: arxNSjreDRGFg13EAM2F1w ($25 in chips) 
sBAwXpkpgyhyWbHIQcIJKA: posts small blind $0.10
dfNim92Z6XK1/h5SFW5vDg: posts big blind $0.25
E0iYnEVO2ho7dH3QcCjw7g: sits out 
A/OkFabqdcrG3ozpiYMiNQ: posts big blind $0.25
*** HOLE CARDS ***
cZ99hugmLBj9KhTlc8nCSw: folds 
aNpwfA31EREwO+ar4XzBCw: folds 
A/OkFabqdcrG3ozpiYMiNQ: checks 
cKlmpQMahVsmOaxFQDcoOg: folds 
/vn2Qu2dvc9AMMq46Ae0jA: folds 
arxNSjreDRGFg13EAM2F1w: folds 
sBAwXpkpgyhyWbHIQcIJKA: calls $0.15
dfNim92Z6XK1/h5SFW5vDg: checks 
*** FLOP *** [4c 4h Td]
sBAwXpkpgyhyWbHIQcIJKA: checks 
dfNim92Z6XK1/h5SFW5vDg: checks 
A/OkFabqdcrG3ozpiYMiNQ: bets $0.50
sBAwXpkpgyhyWbHIQcIJKA: folds 
dfNim92Z6XK1/h5SFW5vDg: folds 
Uncalled bet ($0.50) returned to A/OkFabqdcrG3ozpiYMiNQ
A/OkFabqdcrG3ozpiYMiNQ collected $0.75 from pot
A/OkFabqdcrG3ozpiYMiNQ: doesn't show hand 
*** SUMMARY ***
Total pot $0.75 | Rake $0 
Board [4c 4h Td]
Seat 1: sBAwXpkpgyhyWbHIQcIJKA (small blind) folded on the Flop
Seat 2: dfNim92Z6XK1/h5SFW5vDg (big blind) folded on the Flop
Seat 3: cZ99hugmLBj9KhTlc8nCSw folded before Flop (didn't bet)
Seat 4: aNpwfA31EREwO+ar4XzBCw folded before Flop (didn't bet)
Seat 6: A/OkFabqdcrG3ozpiYMiNQ collected ($0.75)
Seat 7: cKlmpQMahVsmOaxFQDcoOg folded before Flop (didn't bet)
Seat 8: /vn2Qu2dvc9AMMq46Ae0jA folded before Flop (didn't bet)
Seat 9: arxNSjreDRGFg13EAM2F1w (button) folded before Flop (didn't bet)




PokerStars Game #59941813816:  Hold'em No Limit ($0.10/$0.25) - 2009/07/01 1:46:59 ET
Table 'ggwTHpIC5qhhHJSYjK1XCw' 6-max Seat #5 is the button
Seat 1: MqMK8OWPSY1V4stf1Hy5Jw ($80.25 in chips) 
Seat 2: /gJNBeCkWL4o85/jvlZ4BA ($25.95 in chips) 
Seat 3: SxIIgwXYLkwd6m3wLyPTCw ($69.35 in chips) 
Seat 4: JFIAqU8lCZ0vWwEl4bdGsg ($25 in chips) 
Seat 5: BvqhBa7W/To51LhEiIU/lw ($6.30 in chips) 
MqMK8OWPSY1V4stf1Hy5Jw: posts small blind $0.10
/gJNBeCkWL4o85/jvlZ4BA: posts big blind $0.25
*** HOLE CARDS ***
SxIIgwXYLkwd6m3wLyPTCw: folds 
SxIIgwXYLkwd6m3wLyPTCw leaves the table
JFIAqU8lCZ0vWwEl4bdGsg: folds 
BvqhBa7W/To51LhEiIU/lw: calls $0.25
7cx44/slbeTw+Cy7QB8Trg joins the table at seat #3 
MqMK8OWPSY1V4stf1Hy5Jw: folds 
/gJNBeCkWL4o85/jvlZ4BA: raises $1 to $1.25
BvqhBa7W/To51LhEiIU/lw: folds 
Uncalled bet ($1) returned to /gJNBeCkWL4o85/jvlZ4BA
/gJNBeCkWL4o85/jvlZ4BA collected $0.60 from pot
*** SUMMARY ***
Total pot $0.60 | Rake $0 
Seat 1: MqMK8OWPSY1V4stf1Hy5Jw (small blind) folded before Flop
Seat 2: /gJNBeCkWL4o85/jvlZ4BA (big blind) collected ($0.60)
Seat 3: SxIIgwXYLkwd6m3wLyPTCw folded before Flop (didn't bet)
Seat 4: JFIAqU8lCZ0vWwEl4bdGsg folded before Flop (didn't bet)
Seat 5: BvqhBa7W/To51LhEiIU/lw (button) folded before Flop




PokerStars Game #59941814180:  Hold'em No Limit ($0.10/$0.25) - 2009/07/01 1:46:59 ET
Table 'JJzUs04lHpXg6nboT1/jeg' 6-max Seat #1 is the button
Seat 1: MqMK8OWPSY1V4stf1Hy5Jw ($38.20 in chips) 
Seat 2: jxfR29d+dK/7h7s3SvCk+g ($7.10 in chips) 
Seat 3: 4zXbHDe39qNX46dAo81b4w ($9.85 in chips) 
Seat 4: 7VfhiFY533nbUKvyEthASw ($29.50 in chips) 
Seat 5: QvTX2yGq3uKJiKPmns4TKQ ($18.60 in chips) 
jxfR29d+dK/7h7s3SvCk+g: posts small blind $0.10
4zXbHDe39qNX46dAo81b4w: posts big blind $0.25
*** HOLE CARDS ***
7VfhiFY533nbUKvyEthASw: folds 
QvTX2yGq3uKJiKPmns4TKQ: folds 
7VfhiFY533nbUKvyEthASw leaves the table
MqMK8OWPSY1V4stf1Hy5Jw: raises $0.50 to $0.75
jxfR29d+dK/7h7s3SvCk+g: folds 
4zXbHDe39qNX46dAo81b4w: calls $0.50
*** FLOP *** [Jc 9s 7d]
4zXbHDe39qNX46dAo81b4w: checks 
7cx44/slbeTw+Cy7QB8Trg joins the table at seat #4 
MqMK8OWPSY1V4stf1Hy5Jw: checks 
*** TURN *** [Jc 9s 7d] [Qc]
4zXbHDe39qNX46dAo81b4w: bets $0.25
MqMK8OWPSY1V4stf1Hy5Jw: folds 
Uncalled bet ($0.25) returned to 4zXbHDe39qNX46dAo81b4w
4zXbHDe39qNX46dAo81b4w collected $1.55 from pot
*** SUMMARY ***
Total pot $1.60 | Rake $0.05 
Board [Jc 9s 7d Qc]
Seat 1: MqMK8OWPSY1V4stf1Hy5Jw (button) folded on the Turn
Seat 2: jxfR29d+dK/7h7s3SvCk+g (small blind) folded before Flop
Seat 3: 4zXbHDe39qNX46dAo81b4w (big blind) collected ($1.55)
Seat 4: 7VfhiFY533nbUKvyEthASw folded before Flop (didn't bet)
Seat 5: QvTX2yGq3uKJiKPmns4TKQ folded before Flop (didn't bet)




PokerStars Game #59941814386:  Hold'em No Limit ($0.10/$0.25) - 2009/07/01 1:47:00 ET
Table 'O6cwjhrMn9pfzx1Ngn5zkQ' 6-max Seat #1 is the button
Seat 1: LJI7A1YgDM7hgh7o56+ReQ ($27.45 in chips) 
Seat 3: EE16Ua5b1HSsYej5zeXOlA ($25.20 in chips) 
Seat 4: mfrkWA3PTeYPkbO6hi98Aw ($25 in chips) 
Seat 5: niLn0xUVlqh8If80xRjzCA ($28.40 in chips) 
Seat 6: 4TM16KVgEiQpLi4bVVWbVQ ($33.05 in chips) 
asianthug90 will be allowed to play after the button
EE16Ua5b1HSsYej5zeXOlA: posts small blind $0.10
mfrkWA3PTeYPkbO6hi98Aw: posts big blind $0.25
*** HOLE CARDS ***
niLn0xUVlqh8If80xRjzCA: calls $0.25
4TM16KVgEiQpLi4bVVWbVQ: calls $0.25
LJI7A1YgDM7hgh7o56+ReQ: folds 
EE16Ua5b1HSsYej5zeXOlA: calls $0.15
mfrkWA3PTeYPkbO6hi98Aw: checks 
*** FLOP *** [9s Ad 4d]
EE16Ua5b1HSsYej5zeXOlA: checks 
mfrkWA3PTeYPkbO6hi98Aw: checks 
niLn0xUVlqh8If80xRjzCA: checks 
4TM16KVgEiQpLi4bVVWbVQ: checks 
*** TURN *** [9s Ad 4d] [Qs]
EE16Ua5b1HSsYej5zeXOlA: checks 
mfrkWA3PTeYPkbO6hi98Aw: checks 
niLn0xUVlqh8If80xRjzCA: checks 
4TM16KVgEiQpLi4bVVWbVQ: checks 
*** RIVER *** [9s Ad 4d Qs] [Jd]
EE16Ua5b1HSsYej5zeXOlA: checks 
mfrkWA3PTeYPkbO6hi98Aw: checks 
niLn0xUVlqh8If80xRjzCA: bets $0.25
4TM16KVgEiQpLi4bVVWbVQ: folds 
EE16Ua5b1HSsYej5zeXOlA: raises $0.75 to $1
mfrkWA3PTeYPkbO6hi98Aw: folds 
niLn0xUVlqh8If80xRjzCA: folds 
Uncalled bet ($0.75) returned to EE16Ua5b1HSsYej5zeXOlA
EE16Ua5b1HSsYej5zeXOlA collected $1.45 from pot
EE16Ua5b1HSsYej5zeXOlA: doesn't show hand 
*** SUMMARY ***
Total pot $1.50 | Rake $0.05 
Board [9s Ad 4d Qs Jd]
Seat 1: LJI7A1YgDM7hgh7o56+ReQ (button) folded before Flop (didn't bet)
Seat 3: EE16Ua5b1HSsYej5zeXOlA (small blind) collected ($1.45)
Seat 4: mfrkWA3PTeYPkbO6hi98Aw (big blind) folded on the River
Seat 5: niLn0xUVlqh8If80xRjzCA folded on the River
Seat 6: 4TM16KVgEiQpLi4bVVWbVQ folded on the River




PokerStars Game #59941814362:  Hold'em No Limit ($0.10/$0.25) - 2009/07/01 1:47:00 ET
Table '972HGIb0tQN/zRIK4TABEw' 9-max Seat #5 is the button
Seat 1: fHr2+mGa0RFK3qrpZcVUAQ ($6.85 in chips) 
Seat 3: aNpwfA31EREwO+ar4XzBCw ($25.35 in chips) 
Seat 4: Bb42QRQMhg5/Y0vHP8/2Xw ($25 in chips) 
Seat 5: swK30YlQuxRQO7QFr4ZxCA ($45.70 in chips) 
Seat 7: qS+jfnNoG75bT+uQ8CKhQA ($14.50 in chips) 
qS+jfnNoG75bT+uQ8CKhQA: posts small blind $0.10
sGFnnRCa1YAHAUmWgsW6Qg: is sitting out 
sGFnnRCa1YAHAUmWgsW6Qg leaves the table
3PmVnC/15cl4oyI1TKIt4g: is sitting out 
3PmVnC/15cl4oyI1TKIt4g leaves the table
fHr2+mGa0RFK3qrpZcVUAQ: posts big blind $0.25
*** HOLE CARDS ***
aNpwfA31EREwO+ar4XzBCw: raises $0.75 to $1
Bb42QRQMhg5/Y0vHP8/2Xw: folds 
Bb42QRQMhg5/Y0vHP8/2Xw leaves the table
swK30YlQuxRQO7QFr4ZxCA: folds 
qS+jfnNoG75bT+uQ8CKhQA: folds 
fHr2+mGa0RFK3qrpZcVUAQ: folds 
Uncalled bet ($0.75) returned to aNpwfA31EREwO+ar4XzBCw
aNpwfA31EREwO+ar4XzBCw collected $0.60 from pot
aNpwfA31EREwO+ar4XzBCw: doesn't show hand 
A_Bit_Hasty joins the table at seat #8 
aSrj4lVmn2owyQ1RbbOqxQ joins the table at seat #4 
*** SUMMARY ***
Total pot $0.60 | Rake $0 
Seat 1: fHr2+mGa0RFK3qrpZcVUAQ (big blind) folded before Flop
Seat 3: aNpwfA31EREwO+ar4XzBCw collected ($0.60)
Seat 4: Bb42QRQMhg5/Y0vHP8/2Xw folded before Flop (didn't bet)
Seat 5: swK30YlQuxRQO7QFr4ZxCA (button) folded before Flop (didn't bet)
Seat 7: qS+jfnNoG75bT+uQ8CKhQA (small blind) folded before Flop




PokerStars Game #59941814472:  Hold'em No Limit ($0.10/$0.25) - 2009/07/01 1:47:00 ET
Table '9lYs7ljXi6AgFAxYHlKLJw' 9-max Seat #7 is the button
Seat 1: K0b5wNInj6hUGRr6yzKFtw ($37.15 in chips) 
Seat 2: 0XACOSNrAWmqNv9k1nF8rw ($16.70 in chips) 
Seat 3: arxNSjreDRGFg13EAM2F1w ($33.45 in chips) 
Seat 4: UANt6y/SmDCY/jIxkBixcw ($33 in chips) 
Seat 5: dfNim92Z6XK1/h5SFW5vDg ($51.60 in chips) 
Seat 6: tYsOBqdU1+x+yFI7zHO7hQ ($25 in chips) 
Seat 7: ghNKXUBl/H+t83JF079ZBA ($27.70 in chips) 
Seat 8: 9YN2IkT2JYYKFErZtZvCtA ($18.70 in chips) 
Seat 9: cKlmpQMahVsmOaxFQDcoOg ($19 in chips) 
9YN2IkT2JYYKFErZtZvCtA: posts small blind $0.10
cKlmpQMahVsmOaxFQDcoOg: posts big blind $0.25
*** HOLE CARDS ***
K0b5wNInj6hUGRr6yzKFtw: folds 
0XACOSNrAWmqNv9k1nF8rw: folds 
arxNSjreDRGFg13EAM2F1w: folds 
UANt6y/SmDCY/jIxkBixcw: folds 
dfNim92Z6XK1/h5SFW5vDg: folds 
tYsOBqdU1+x+yFI7zHO7hQ: folds 
ghNKXUBl/H+t83JF079ZBA: raises $0.75 to $1
9YN2IkT2JYYKFErZtZvCtA: folds 
cKlmpQMahVsmOaxFQDcoOg: folds 
Uncalled bet ($0.75) returned to ghNKXUBl/H+t83JF079ZBA
ghNKXUBl/H+t83JF079ZBA collected $0.60 from pot
ghNKXUBl/H+t83JF079ZBA: doesn't show hand 
*** SUMMARY ***
Total pot $0.60 | Rake $0 
Seat 1: K0b5wNInj6hUGRr6yzKFtw folded before Flop (didn't bet)
Seat 2: 0XACOSNrAWmqNv9k1nF8rw folded before Flop (didn't bet)
Seat 3: arxNSjreDRGFg13EAM2F1w folded before Flop (didn't bet)
Seat 4: UANt6y/SmDCY/jIxkBixcw folded before Flop (didn't bet)
Seat 5: dfNim92Z6XK1/h5SFW5vDg folded before Flop (didn't bet)
Seat 6: tYsOBqdU1+x+yFI7zHO7hQ folded before Flop (didn't bet)
Seat 7: ghNKXUBl/H+t83JF079ZBA (button) collected ($0.60)
Seat 8: 9YN2IkT2JYYKFErZtZvCtA (small blind) folded before Flop
Seat 9: cKlmpQMahVsmOaxFQDcoOg (big blind) folded before Flop




PokerStars Game #59941814244:  Hold'em No Limit ($0.10/$0.25) - 2009/07/01 1:47:00 ET
Table 'LXz5SsUCyWcm+4JDJh466A' 9-max Seat #2 is the button
Seat 1: MG90wfSJZnOejs/KD3vlQQ ($24.65 in chips) 
Seat 2: H5Se03ZqSX7tbULXur2MAg ($23.35 in chips) 
Seat 3: dfNim92Z6XK1/h5SFW5vDg ($25.25 in chips) 
Seat 4: K0b5wNInj6hUGRr6yzKFtw ($27.60 in chips) 
Seat 5: CGZe30OcuMyA3kN5MnfQcQ ($5 in chips) 
Seat 6: 6RiVTYll/5D8zICp0MRpKw ($24.75 in chips) 
Seat 7: J2a/QHAWUgo6beDRoEyg2g ($11.85 in chips) 
Seat 8: zOHElTcFiTsexeDCkAPYkQ ($34.45 in chips) 
Seat 9: dtZ84flFEi4Q+SGrHMJRDQ ($25 in chips) 
dfNim92Z6XK1/h5SFW5vDg: posts small blind $0.10
K0b5wNInj6hUGRr6yzKFtw: posts big blind $0.25
CGZe30OcuMyA3kN5MnfQcQ: posts big blind $0.25
*** HOLE CARDS ***
CGZe30OcuMyA3kN5MnfQcQ: checks 
6RiVTYll/5D8zICp0MRpKw: folds 
J2a/QHAWUgo6beDRoEyg2g: raises $0.25 to $0.50
zOHElTcFiTsexeDCkAPYkQ: raises $0.25 to $0.75
dtZ84flFEi4Q+SGrHMJRDQ: folds 
MG90wfSJZnOejs/KD3vlQQ: folds 
H5Se03ZqSX7tbULXur2MAg: calls $0.75
dfNim92Z6XK1/h5SFW5vDg: calls $0.65
K0b5wNInj6hUGRr6yzKFtw: folds 
CGZe30OcuMyA3kN5MnfQcQ: calls $0.50
J2a/QHAWUgo6beDRoEyg2g: calls $0.25
*** FLOP *** [4h 6h 6d]
dfNim92Z6XK1/h5SFW5vDg: checks 
CGZe30OcuMyA3kN5MnfQcQ: checks 
J2a/QHAWUgo6beDRoEyg2g: bets $1
zOHElTcFiTsexeDCkAPYkQ: raises $1 to $2
H5Se03ZqSX7tbULXur2MAg: folds 
dfNim92Z6XK1/h5SFW5vDg: folds 
CGZe30OcuMyA3kN5MnfQcQ: calls $2
J2a/QHAWUgo6beDRoEyg2g: raises $9.10 to $11.10 and is all-in
zOHElTcFiTsexeDCkAPYkQ: calls $9.10
CGZe30OcuMyA3kN5MnfQcQ: calls $2.25 and is all-in
*** TURN *** [4h 6h 6d] [9s]
*** RIVER *** [4h 6h 6d 9s] [Ts]
*** SHOW DOWN ***
J2a/QHAWUgo6beDRoEyg2g: shows [Kh Th] (two pair, Tens and Sixes)
zOHElTcFiTsexeDCkAPYkQ: shows [Ad Ah] (two pair, Aces and Sixes)
zOHElTcFiTsexeDCkAPYkQ collected $13 from side pot
CGZe30OcuMyA3kN5MnfQcQ: shows [3c 6c] (three of a kind, Sixes)
CGZe30OcuMyA3kN5MnfQcQ collected $15.95 from main pot
*** SUMMARY ***
Total pot $30.45 Main pot $15.95. Side pot $13. | Rake $1.50 
Board [4h 6h 6d 9s Ts]
Seat 1: MG90wfSJZnOejs/KD3vlQQ folded before Flop (didn't bet)
Seat 2: H5Se03ZqSX7tbULXur2MAg (button) folded on the Flop
Seat 3: dfNim92Z6XK1/h5SFW5vDg (small blind) folded on the Flop
Seat 4: K0b5wNInj6hUGRr6yzKFtw (big blind) folded before Flop
Seat 5: CGZe30OcuMyA3kN5MnfQcQ showed [3c 6c] and won ($15.95) with three of a kind, Sixes
Seat 6: 6RiVTYll/5D8zICp0MRpKw folded before Flop (didn't bet)
Seat 7: J2a/QHAWUgo6beDRoEyg2g showed [Kh Th] and lost with two pair, Tens and Sixes
Seat 8: zOHElTcFiTsexeDCkAPYkQ showed [Ad Ah] and won ($13) with two pair, Aces and Sixes
Seat 9: dtZ84flFEi4Q+SGrHMJRDQ folded before Flop (didn't bet)




PokerStars Game #59941814286:  Hold'em No Limit ($0.10/$0.25) - 2009/07/01 1:47:00 ET
Table 'G26g8jde1eR+mmabeFeSlw' 9-max Seat #8 is the button
Seat 1: wnerYvSRWT9Sm4X3ip/c8w ($25 in chips) 
Seat 2: BFYwQ0J4xWUQvouudojivA ($14.60 in chips) 
Seat 3: WKL8nUFr7TumC4EjLyqYzw ($6.50 in chips) 
Seat 4: 8EbrQ/EvFWt2cr0GaU82gQ ($5.75 in chips) 
Seat 5: hJ4uYjNmSZdjrKA8cjZqCA ($30.45 in chips) 
Seat 6: AHGkesF/mi4sDMpqrxBUoA ($8.55 in chips) 
Seat 7: nm4Dj/f+jJEwKVsUnKh73g ($40.25 in chips) 
Seat 8: CvL9Ch1HYCVbTsfpNucitg ($5.50 in chips) 
Seat 9: VWUWpMLMj/Q1jRVpF7Aohw ($13.40 in chips) 
VWUWpMLMj/Q1jRVpF7Aohw: posts small blind $0.10
wnerYvSRWT9Sm4X3ip/c8w: posts big blind $0.25
*** HOLE CARDS ***
BFYwQ0J4xWUQvouudojivA: raises $0.50 to $0.75
WKL8nUFr7TumC4EjLyqYzw: folds 
8EbrQ/EvFWt2cr0GaU82gQ: folds 
hJ4uYjNmSZdjrKA8cjZqCA: folds 
AHGkesF/mi4sDMpqrxBUoA: folds 
nm4Dj/f+jJEwKVsUnKh73g: calls $0.75
CvL9Ch1HYCVbTsfpNucitg: folds 
VWUWpMLMj/Q1jRVpF7Aohw: folds 
wnerYvSRWT9Sm4X3ip/c8w: folds 
*** FLOP *** [Qc 9h 5s]
BFYwQ0J4xWUQvouudojivA: bets $0.75
nm4Dj/f+jJEwKVsUnKh73g: calls $0.75
*** TURN *** [Qc 9h 5s] [8s]
BFYwQ0J4xWUQvouudojivA: bets $1.25
nm4Dj/f+jJEwKVsUnKh73g: calls $1.25
*** RIVER *** [Qc 9h 5s 8s] [8h]
BFYwQ0J4xWUQvouudojivA: bets $1.25
nm4Dj/f+jJEwKVsUnKh73g: folds 
Uncalled bet ($1.25) returned to BFYwQ0J4xWUQvouudojivA
BFYwQ0J4xWUQvouudojivA collected $5.60 from pot
*** SUMMARY ***
Total pot $5.85 | Rake $0.25 
Board [Qc 9h 5s 8s 8h]
Seat 1: wnerYvSRWT9Sm4X3ip/c8w (big blind) folded before Flop
Seat 2: BFYwQ0J4xWUQvouudojivA collected ($5.60)
Seat 3: WKL8nUFr7TumC4EjLyqYzw folded before Flop (didn't bet)
Seat 4: 8EbrQ/EvFWt2cr0GaU82gQ folded before Flop (didn't bet)
Seat 5: hJ4uYjNmSZdjrKA8cjZqCA folded before Flop (didn't bet)
Seat 6: AHGkesF/mi4sDMpqrxBUoA folded before Flop (didn't bet)
Seat 7: nm4Dj/f+jJEwKVsUnKh73g folded on the River
Seat 8: CvL9Ch1HYCVbTsfpNucitg (button) folded before Flop (didn't bet)
Seat 9: VWUWpMLMj/Q1jRVpF7Aohw (small blind) folded before Flop




PokerStars Game #59941814440:  Hold'em No Limit ($0.10/$0.25) - 2009/07/01 1:47:00 ET
Table 'ZEXL6Wh4qA4Afx8NnoBBAA' 6-max Seat #2 is the button
Seat 1: v8m8XHovI5tqEA9mvplDSw ($27.45 in chips) 
Seat 2: 6DwBRH+xZ12AAZmeAg+aXw ($23.50 in chips) 
Seat 3: +ZlnqPoP3Hg4BIUxDfKd/A ($32.80 in chips) 
Seat 4: FpN4KbLjlyRRKiVaQcoLqA ($29.10 in chips) 
Seat 5: if4dh6jhJXeN3/qd3qCp9g ($36.50 in chips) 
Seat 6: Lh8SlCq3OSDKWLUgAI/Lxw ($1.75 in chips) 
+ZlnqPoP3Hg4BIUxDfKd/A: posts small blind $0.10
FpN4KbLjlyRRKiVaQcoLqA: posts big blind $0.25
*** HOLE CARDS ***
if4dh6jhJXeN3/qd3qCp9g: raises $0.75 to $1
Lh8SlCq3OSDKWLUgAI/Lxw: folds 
v8m8XHovI5tqEA9mvplDSw: folds 
6DwBRH+xZ12AAZmeAg+aXw: folds 
+ZlnqPoP3Hg4BIUxDfKd/A: folds 
FpN4KbLjlyRRKiVaQcoLqA: folds 
Uncalled bet ($0.75) returned to if4dh6jhJXeN3/qd3qCp9g
if4dh6jhJXeN3/qd3qCp9g collected $0.60 from pot
if4dh6jhJXeN3/qd3qCp9g: doesn't show hand 
*** SUMMARY ***
Total pot $0.60 | Rake $0 
Seat 1: v8m8XHovI5tqEA9mvplDSw folded before Flop (didn't bet)
Seat 2: 6DwBRH+xZ12AAZmeAg+aXw (button) folded before Flop (didn't bet)
Seat 3: +ZlnqPoP3Hg4BIUxDfKd/A (small blind) folded before Flop
Seat 4: FpN4KbLjlyRRKiVaQcoLqA (big blind) folded before Flop
Seat 5: if4dh6jhJXeN3/qd3qCp9g collected ($0.60)
Seat 6: Lh8SlCq3OSDKWLUgAI/Lxw folded before Flop (didn't bet)




PokerStars Game #59941814480:  Hold'em No Limit ($0.10/$0.25) - 2009/07/01 1:47:00 ET
Table '5NipxzzFB2DffzDpddyQoQ' 6-max Seat #1 is the button
Seat 1: W87HPwOk1KtWaYyshBe1gA ($20.90 in chips) 
Seat 2: iauW7L/+7qzAuHow7CD75Q ($6.45 in chips) 
Seat 3: QvTX2yGq3uKJiKPmns4TKQ ($11.55 in chips) 
Seat 4: NTamLAiMZ86c5yM04t96LA ($31 in chips) 
Seat 5: faP2NVl/cFTZ1nE4pXzg8Q ($28.15 in chips) 
Seat 6: 7JqTFMyeNSVWsmp/yW35Tw ($27.30 in chips) 
iauW7L/+7qzAuHow7CD75Q: posts small blind $0.10
QvTX2yGq3uKJiKPmns4TKQ: posts big blind $0.25
*** HOLE CARDS ***
NTamLAiMZ86c5yM04t96LA: calls $0.25
faP2NVl/cFTZ1nE4pXzg8Q: calls $0.25
7JqTFMyeNSVWsmp/yW35Tw: folds 
W87HPwOk1KtWaYyshBe1gA: calls $0.25
iauW7L/+7qzAuHow7CD75Q: calls $0.15
QvTX2yGq3uKJiKPmns4TKQ: checks 
*** FLOP *** [6h Ac 7h]
iauW7L/+7qzAuHow7CD75Q: checks 
QvTX2yGq3uKJiKPmns4TKQ: bets $1
NTamLAiMZ86c5yM04t96LA: calls $1
faP2NVl/cFTZ1nE4pXzg8Q: folds 
W87HPwOk1KtWaYyshBe1gA: folds 
iauW7L/+7qzAuHow7CD75Q: folds 
*** TURN *** [6h Ac 7h] [Ad]
QvTX2yGq3uKJiKPmns4TKQ: bets $1.50
NTamLAiMZ86c5yM04t96LA: calls $1.50
*** RIVER *** [6h Ac 7h Ad] [6c]
QvTX2yGq3uKJiKPmns4TKQ: bets $2.50
NTamLAiMZ86c5yM04t96LA: calls $2.50
*** SHOW DOWN ***
QvTX2yGq3uKJiKPmns4TKQ: shows [Th Qh] (two pair, Aces and Sixes)
NTamLAiMZ86c5yM04t96LA: shows [Kc As] (a full house, Aces full of Sixes)
NTamLAiMZ86c5yM04t96LA collected $10.75 from pot
*** SUMMARY ***
Total pot $11.25 | Rake $0.50 
Board [6h Ac 7h Ad 6c]
Seat 1: W87HPwOk1KtWaYyshBe1gA (button) folded on the Flop
Seat 2: iauW7L/+7qzAuHow7CD75Q (small blind) folded on the Flop
Seat 3: QvTX2yGq3uKJiKPmns4TKQ (big blind) showed [Th Qh] and lost with two pair, Aces and Sixes
Seat 4: NTamLAiMZ86c5yM04t96LA showed [Kc As] and won ($10.75) with a full house, Aces full of Sixes
Seat 5: faP2NVl/cFTZ1nE4pXzg8Q folded on the Flop
Seat 6: 7JqTFMyeNSVWsmp/yW35Tw folded before Flop (didn't bet)




PokerStars Game #59941814268:  Hold'em No Limit ($0.10/$0.25) - 2009/07/01 1:47:00 ET
Table 'rO1I30HnuCPB0M8qEX1TCQ' 9-max Seat #2 is the button
Seat 2: z1hPotrGOZjUjyoopZ7Ulg ($26.15 in chips) 
Seat 3: 2wcFsZsqEP5w1StUTVzJCg ($12.90 in chips) 
Seat 4: yyG4svzOpC1A+sUP/scg6w ($10.40 in chips) 
Seat 5: W6tExOcYX7qiy6Qdp+ZwFA ($7.20 in chips) 
Seat 6: 5n7e7I+px7c6CQmLpPbtsg ($4.65 in chips) 
Seat 7: bXpVeaSTPBFSPJmeXxO7nw ($5 in chips) 
Seat 9: wnerYvSRWT9Sm4X3ip/c8w ($24.75 in chips) 
2wcFsZsqEP5w1StUTVzJCg: posts small blind $0.10
yyG4svzOpC1A+sUP/scg6w: posts big blind $0.25
*** HOLE CARDS ***
W6tExOcYX7qiy6Qdp+ZwFA: folds 
W6tExOcYX7qiy6Qdp+ZwFA leaves the table
5n7e7I+px7c6CQmLpPbtsg: folds 
WQe4GbiYBiPsb5WKFKkijQ joins the table at seat #5 
bXpVeaSTPBFSPJmeXxO7nw: folds 
wnerYvSRWT9Sm4X3ip/c8w: raises $0.50 to $0.75
z1hPotrGOZjUjyoopZ7Ulg: calls $0.75
2wcFsZsqEP5w1StUTVzJCg: folds 
yyG4svzOpC1A+sUP/scg6w: folds 
*** FLOP *** [Ad 3d 9s]
wnerYvSRWT9Sm4X3ip/c8w: bets $1
z1hPotrGOZjUjyoopZ7Ulg: folds 
Uncalled bet ($1) returned to wnerYvSRWT9Sm4X3ip/c8w
nAWaA+gDUSWOad+I9mKUEg joins the table at seat #1 
wnerYvSRWT9Sm4X3ip/c8w collected $1.80 from pot
wnerYvSRWT9Sm4X3ip/c8w: doesn't show hand 
*** SUMMARY ***
Total pot $1.85 | Rake $0.05 
Board [Ad 3d 9s]
Seat 2: z1hPotrGOZjUjyoopZ7Ulg (button) folded on the Flop
Seat 3: 2wcFsZsqEP5w1StUTVzJCg (small blind) folded before Flop
Seat 4: yyG4svzOpC1A+sUP/scg6w (big blind) folded before Flop
Seat 5: W6tExOcYX7qiy6Qdp+ZwFA folded before Flop (didn't bet)
Seat 6: 5n7e7I+px7c6CQmLpPbtsg folded before Flop (didn't bet)
Seat 7: bXpVeaSTPBFSPJmeXxO7nw folded before Flop (didn't bet)
Seat 9: wnerYvSRWT9Sm4X3ip/c8w collected ($1.80)




PokerStars Game #59941815088:  Hold'em No Limit ($0.10/$0.25) - 2009/07/01 1:47:01 ET
Table 'SHi8+hK6i7E2dJ/3Agbyig' 6-max Seat #4 is the button
Seat 1: gPEN9Zp33YTm/mu9/SYP1w ($26.25 in chips) 
Seat 2: LJI7A1YgDM7hgh7o56+ReQ ($28.45 in chips) 
Seat 3: P1Z7LWu+VU+WmJsI4mr0wA ($22.50 in chips) 
Seat 4: u0ikXOhAPSCLmg+l17oGRw ($10.95 in chips) 
Seat 5: v8m8XHovI5tqEA9mvplDSw ($52.45 in chips) 
Seat 6: cWc85bEzdRzpUMhRKm8pwQ ($32.30 in chips) 
v8m8XHovI5tqEA9mvplDSw: posts small blind $0.10
cWc85bEzdRzpUMhRKm8pwQ: posts big blind $0.25
*** HOLE CARDS ***
gPEN9Zp33YTm/mu9/SYP1w: folds 
LJI7A1YgDM7hgh7o56+ReQ: raises $0.75 to $1
P1Z7LWu+VU+WmJsI4mr0wA: folds 
P1Z7LWu+VU+WmJsI4mr0wA leaves the table
u0ikXOhAPSCLmg+l17oGRw: calls $1
v8m8XHovI5tqEA9mvplDSw: calls $0.90
cWc85bEzdRzpUMhRKm8pwQ: folds 
*** FLOP *** [5h 5d 3h]
v8m8XHovI5tqEA9mvplDSw: bets $0.25
LJI7A1YgDM7hgh7o56+ReQ: raises $2.25 to $2.50
u0ikXOhAPSCLmg+l17oGRw: calls $2.50
v8m8XHovI5tqEA9mvplDSw: calls $2.25
*** TURN *** [5h 5d 3h] [Ah]
-=klx=- joins the table at seat #3 
v8m8XHovI5tqEA9mvplDSw: checks 
LJI7A1YgDM7hgh7o56+ReQ: bets $7.50
u0ikXOhAPSCLmg+l17oGRw: calls $7.45 and is all-in
v8m8XHovI5tqEA9mvplDSw: folds 
Uncalled bet ($0.05) returned to LJI7A1YgDM7hgh7o56+ReQ
*** RIVER *** [5h 5d 3h Ah] [Qs]
*** SHOW DOWN ***
LJI7A1YgDM7hgh7o56+ReQ: shows [Jh Qh] (a flush, Ace high)
u0ikXOhAPSCLmg+l17oGRw: shows [4h Kh] (a flush, Ace high - King higher)
u0ikXOhAPSCLmg+l17oGRw collected $24.40 from pot
*** SUMMARY ***
Total pot $25.65 | Rake $1.25 
Board [5h 5d 3h Ah Qs]
Seat 1: gPEN9Zp33YTm/mu9/SYP1w folded before Flop (didn't bet)
Seat 2: LJI7A1YgDM7hgh7o56+ReQ showed [Jh Qh] and lost with a flush, Ace high
Seat 3: P1Z7LWu+VU+WmJsI4mr0wA folded before Flop (didn't bet)
Seat 4: u0ikXOhAPSCLmg+l17oGRw (button) showed [4h Kh] and won ($24.40) with a flush, Ace high
Seat 5: v8m8XHovI5tqEA9mvplDSw (small blind) folded on the Turn
Seat 6: cWc85bEzdRzpUMhRKm8pwQ (big blind) folded before Flop




PokerStars Game #59941814964:  Hold'em No Limit ($0.10/$0.25) - 2009/07/01 1:47:01 ET
Table '+giHa6FUL6U5/AZnCJEGvQ' 9-max Seat #6 is the button
Seat 4: 10f7J+bM02ZfDHx0PgkNSg ($14.50 in chips) 
Seat 6: GTMnTen6sQSoCpS9sggLbg ($25.05 in chips) 
GTMnTen6sQSoCpS9sggLbg: posts small blind $0.10
10f7J+bM02ZfDHx0PgkNSg: posts big blind $0.25
*** HOLE CARDS ***
GTMnTen6sQSoCpS9sggLbg: calls $0.15
10f7J+bM02ZfDHx0PgkNSg: raises $0.50 to $0.75
GTMnTen6sQSoCpS9sggLbg: calls $0.50
*** FLOP *** [6d Ks 2h]
zDrucyjVn5aeekNEc3cJrA has returned
10f7J+bM02ZfDHx0PgkNSg: bets $1
clkou joins the table at seat #7 
GTMnTen6sQSoCpS9sggLbg: folds 
Uncalled bet ($1) returned to 10f7J+bM02ZfDHx0PgkNSg
10f7J+bM02ZfDHx0PgkNSg collected $1.45 from pot
10f7J+bM02ZfDHx0PgkNSg: doesn't show hand 
*** SUMMARY ***
Total pot $1.50 | Rake $0.05 
Board [6d Ks 2h]
Seat 4: 10f7J+bM02ZfDHx0PgkNSg (big blind) collected ($1.45)
Seat 6: GTMnTen6sQSoCpS9sggLbg (button) (small blind) folded on the Flop




PokerStars Game #59941814716:  Hold'em No Limit ($0.10/$0.25) - 2009/07/01 1:47:01 ET
Table 'uFgIyfWPagvEVGEb86da7A' 9-max Seat #4 is the button
Seat 1: CT7Xj/V/O5rBlhtt+RZeFQ ($25.75 in chips) 
Seat 2: o3zvoO+PsqGti+1NZGNRrQ ($1.25 in chips) 
Seat 3: eGAnPT3w+iltM7HF59dzIg ($5.65 in chips) 
Seat 4: IGRfskE1v9H9Bn+fz8AgNQ ($26.90 in chips) 
Seat 5: X78b5v/uhqeXXoAijbw/yg ($28.65 in chips) 
Seat 6: zDrucyjVn5aeekNEc3cJrA ($28.25 in chips) 
Seat 7: 9zx7Mlww974uHUqoiq2eXA ($11.85 in chips) 
Seat 8: uLP/lYn7oKq9xCChBXsXxw ($24.30 in chips) 
Seat 9: sL5EaDXc90Iyxlm8ERXRQw ($18.35 in chips) 
X78b5v/uhqeXXoAijbw/yg: posts small blind $0.10
zDrucyjVn5aeekNEc3cJrA: posts big blind $0.25
*** HOLE CARDS ***
9zx7Mlww974uHUqoiq2eXA: folds 
uLP/lYn7oKq9xCChBXsXxw: calls $0.25
sL5EaDXc90Iyxlm8ERXRQw: folds 
CT7Xj/V/O5rBlhtt+RZeFQ: folds 
o3zvoO+PsqGti+1NZGNRrQ: folds 
eGAnPT3w+iltM7HF59dzIg: folds 
IGRfskE1v9H9Bn+fz8AgNQ: folds 
X78b5v/uhqeXXoAijbw/yg: folds 
zDrucyjVn5aeekNEc3cJrA: checks 
*** FLOP *** [Tc 8d 9c]
zDrucyjVn5aeekNEc3cJrA: checks 
uLP/lYn7oKq9xCChBXsXxw: bets $0.50
zDrucyjVn5aeekNEc3cJrA: calls $0.50
*** TURN *** [Tc 8d 9c] [7h]
zDrucyjVn5aeekNEc3cJrA: checks 
uLP/lYn7oKq9xCChBXsXxw: checks 
*** RIVER *** [Tc 8d 9c 7h] [Ah]
zDrucyjVn5aeekNEc3cJrA: checks 
uLP/lYn7oKq9xCChBXsXxw: bets $0.50
zDrucyjVn5aeekNEc3cJrA: calls $0.50
*** SHOW DOWN ***
uLP/lYn7oKq9xCChBXsXxw: shows [9d 9s] (three of a kind, Nines)
zDrucyjVn5aeekNEc3cJrA: mucks hand 
uLP/lYn7oKq9xCChBXsXxw collected $2.50 from pot
*** SUMMARY ***
Total pot $2.60 | Rake $0.10 
Board [Tc 8d 9c 7h Ah]
Seat 1: CT7Xj/V/O5rBlhtt+RZeFQ folded before Flop (didn't bet)
Seat 2: o3zvoO+PsqGti+1NZGNRrQ folded before Flop (didn't bet)
Seat 3: eGAnPT3w+iltM7HF59dzIg folded before Flop (didn't bet)
Seat 4: IGRfskE1v9H9Bn+fz8AgNQ (button) folded before Flop (didn't bet)
Seat 5: X78b5v/uhqeXXoAijbw/yg (small blind) folded before Flop
Seat 6: zDrucyjVn5aeekNEc3cJrA (big blind) mucked
Seat 7: 9zx7Mlww974uHUqoiq2eXA folded before Flop (didn't bet)
Seat 8: uLP/lYn7oKq9xCChBXsXxw showed [9d 9s] and won ($2.50) with three of a kind, Nines
Seat 9: sL5EaDXc90Iyxlm8ERXRQw folded before Flop (didn't bet)




PokerStars Game #59941814758:  Hold'em No Limit ($0.10/$0.25) - 2009/07/01 1:47:01 ET
Table 'vud0GB/ZlDCvUFhBFIaTlg' 9-max Seat #1 is the button
Seat 1: DiSvPC2iudwL5j9u6Huyww ($29.50 in chips) 
Seat 2: tLcDklc2rBORNfixyRfVfw ($26.05 in chips) 
Seat 3: W2YYHvqjaEpRrO7stZkClQ ($4.30 in chips) 
Seat 4: dWgEDExmVO0d+rRmUYCU5w ($15.10 in chips) 
Seat 5: eK8qa6EPcH2zhtbmWSvc9g ($25 in chips) 
Seat 6: gehe91e0IyVT0QU/XBkEyg ($25 in chips) 
Seat 7: iG7VeTyBWf6wYNvZpbTcbw ($20.05 in chips) 
Seat 8: E0iYnEVO2ho7dH3QcCjw7g ($20 in chips) 
Seat 9: PdIasPkzm2sqZnN41ZRXOg ($5.20 in chips) 
tLcDklc2rBORNfixyRfVfw: posts small blind $0.10
W2YYHvqjaEpRrO7stZkClQ: posts big blind $0.25
E0iYnEVO2ho7dH3QcCjw7g: posts big blind $0.25
*** HOLE CARDS ***
dWgEDExmVO0d+rRmUYCU5w: calls $0.25
eK8qa6EPcH2zhtbmWSvc9g: folds 
gehe91e0IyVT0QU/XBkEyg: folds 
iG7VeTyBWf6wYNvZpbTcbw: folds 
E0iYnEVO2ho7dH3QcCjw7g: checks 
PdIasPkzm2sqZnN41ZRXOg: folds 
DiSvPC2iudwL5j9u6Huyww: folds 
tLcDklc2rBORNfixyRfVfw: calls $0.15
W2YYHvqjaEpRrO7stZkClQ: checks 
*** FLOP *** [Kc Qs Jd]
tLcDklc2rBORNfixyRfVfw: checks 
W2YYHvqjaEpRrO7stZkClQ: checks 
dWgEDExmVO0d+rRmUYCU5w: bets $0.50
E0iYnEVO2ho7dH3QcCjw7g: folds 
tLcDklc2rBORNfixyRfVfw: folds 
W2YYHvqjaEpRrO7stZkClQ: folds 
Uncalled bet ($0.50) returned to dWgEDExmVO0d+rRmUYCU5w
dWgEDExmVO0d+rRmUYCU5w collected $0.95 from pot
*** SUMMARY ***
Total pot $1 | Rake $0.05 
Board [Kc Qs Jd]
Seat 1: DiSvPC2iudwL5j9u6Huyww (button) folded before Flop (didn't bet)
Seat 2: tLcDklc2rBORNfixyRfVfw (small blind) folded on the Flop
Seat 3: W2YYHvqjaEpRrO7stZkClQ (big blind) folded on the Flop
Seat 4: dWgEDExmVO0d+rRmUYCU5w collected ($0.95)
Seat 5: eK8qa6EPcH2zhtbmWSvc9g folded before Flop (didn't bet)
Seat 6: gehe91e0IyVT0QU/XBkEyg folded before Flop (didn't bet)
Seat 7: iG7VeTyBWf6wYNvZpbTcbw folded before Flop (didn't bet)
Seat 8: E0iYnEVO2ho7dH3QcCjw7g folded on the Flop
Seat 9: PdIasPkzm2sqZnN41ZRXOg folded before Flop (didn't bet)




PokerStars Game #59941814738:  Hold'em No Limit ($0.10/$0.25) - 2009/07/01 1:47:01 ET
Table 'KKk6y4pAXeymxYcd0uZLqg' 9-max Seat #4 is the button
Seat 1: HPEB+AtKw1+C/cxU0o1ciw ($24.90 in chips) 
Seat 3: tLcDklc2rBORNfixyRfVfw ($25 in chips) 
Seat 4: YciNm3fUXAQaJeXG1rhrbw ($8.20 in chips) 
Seat 5: wGigCmBR/9XWkPpvYos3aQ ($38.60 in chips) 
Seat 6: QEbIGci+itdw+re8RM5fZA ($25 in chips) 
Seat 7: JjOuv8Vf56aiQjWi/rTPFA ($23.25 in chips) 
Seat 8: +2kMBNpY4nF1qNCRd8SJLA ($36.05 in chips) 
Seat 9: oLa/tXLfSLLB28mcLGrxcg ($25.45 in chips) 
wGigCmBR/9XWkPpvYos3aQ: posts small blind $0.10
QEbIGci+itdw+re8RM5fZA: posts big blind $0.25
*** HOLE CARDS ***
JjOuv8Vf56aiQjWi/rTPFA: folds 
+2kMBNpY4nF1qNCRd8SJLA: folds 
oLa/tXLfSLLB28mcLGrxcg: folds 
HPEB+AtKw1+C/cxU0o1ciw: folds 
tLcDklc2rBORNfixyRfVfw: folds 
YciNm3fUXAQaJeXG1rhrbw: folds 
wGigCmBR/9XWkPpvYos3aQ: raises $0.65 to $0.90
QEbIGci+itdw+re8RM5fZA: folds 
Uncalled bet ($0.65) returned to wGigCmBR/9XWkPpvYos3aQ
wGigCmBR/9XWkPpvYos3aQ collected $0.50 from pot
wGigCmBR/9XWkPpvYos3aQ: doesn't show hand 
*** SUMMARY ***
Total pot $0.50 | Rake $0 
Seat 1: HPEB+AtKw1+C/cxU0o1ciw folded before Flop (didn't bet)
Seat 3: tLcDklc2rBORNfixyRfVfw folded before Flop (didn't bet)
Seat 4: YciNm3fUXAQaJeXG1rhrbw (button) folded before Flop (didn't bet)
Seat 5: wGigCmBR/9XWkPpvYos3aQ (small blind) collected ($0.50)
Seat 6: QEbIGci+itdw+re8RM5fZA (big blind) folded before Flop
Seat 7: JjOuv8Vf56aiQjWi/rTPFA folded before Flop (didn't bet)
Seat 8: +2kMBNpY4nF1qNCRd8SJLA folded before Flop (didn't bet)
Seat 9: oLa/tXLfSLLB28mcLGrxcg folded before Flop (didn't bet)




PokerStars Game #59941814812:  Hold'em No Limit ($0.10/$0.25) - 2009/07/01 1:47:01 ET
Table 'g6ryG70feTw9nNm+XJLuXw' 6-max Seat #3 is the button
Seat 1: v+QfkGiuj9bgtuNoVnDO8w ($35.25 in chips) 
Seat 2: SxIIgwXYLkwd6m3wLyPTCw ($33.55 in chips) 
Seat 3: cezpHJ8FB07dj0xG+LhOvw ($25 in chips) 
Seat 4: GC/9yVD59DUCX7hUI7gcLw ($45.10 in chips) 
Seat 5: EE16Ua5b1HSsYej5zeXOlA ($25.35 in chips) 
GC/9yVD59DUCX7hUI7gcLw: posts small blind $0.10
EE16Ua5b1HSsYej5zeXOlA: posts big blind $0.25
Mhj3q7cxev+XjXZxEE6/Cw: sits out 
*** HOLE CARDS ***
v+QfkGiuj9bgtuNoVnDO8w: raises $0.75 to $1
SxIIgwXYLkwd6m3wLyPTCw: folds 
cezpHJ8FB07dj0xG+LhOvw: folds 
GC/9yVD59DUCX7hUI7gcLw: folds 
EE16Ua5b1HSsYej5zeXOlA: folds 
Uncalled bet ($0.75) returned to v+QfkGiuj9bgtuNoVnDO8w
v+QfkGiuj9bgtuNoVnDO8w collected $0.60 from pot
v+QfkGiuj9bgtuNoVnDO8w: doesn't show hand 
*** SUMMARY ***
Total pot $0.60 | Rake $0 
Seat 1: v+QfkGiuj9bgtuNoVnDO8w collected ($0.60)
Seat 2: SxIIgwXYLkwd6m3wLyPTCw folded before Flop (didn't bet)
Seat 3: cezpHJ8FB07dj0xG+LhOvw (button) folded before Flop (didn't bet)
Seat 4: GC/9yVD59DUCX7hUI7gcLw (small blind) folded before Flop
Seat 5: EE16Ua5b1HSsYej5zeXOlA (big blind) folded before Flop




PokerStars Game #59941815524:  Hold'em No Limit ($0.10/$0.25) - 2009/07/01 1:47:02 ET
Table 'i93c3z9RLowvuJTKA2F4Jg' 6-max Seat #1 is the button
Seat 1: tbSZq5LHglyHk61mH9eDBw ($30.10 in chips) 
Seat 2: TSmua8tGK3sTbwi0ynrW9Q ($26.05 in chips) 
Seat 3: v8m8XHovI5tqEA9mvplDSw ($28.30 in chips) 
Seat 4: o86X2Q5GEDU3uP9oj1iFZA ($35.45 in chips) 
Seat 6: FpN4KbLjlyRRKiVaQcoLqA ($18.25 in chips) 
TSmua8tGK3sTbwi0ynrW9Q: posts small blind $0.10
v8m8XHovI5tqEA9mvplDSw: posts big blind $0.25
TI/C5Q+DEl4fLR3AofwYdg: sits out 
*** HOLE CARDS ***
o86X2Q5GEDU3uP9oj1iFZA: raises $0.50 to $0.75
FpN4KbLjlyRRKiVaQcoLqA: folds 
tbSZq5LHglyHk61mH9eDBw: folds 
TSmua8tGK3sTbwi0ynrW9Q: folds 
v8m8XHovI5tqEA9mvplDSw: calls $0.50
*** FLOP *** [5c Kd 2s]
v8m8XHovI5tqEA9mvplDSw: checks 
o86X2Q5GEDU3uP9oj1iFZA: checks 
*** TURN *** [5c Kd 2s] [5d]
v8m8XHovI5tqEA9mvplDSw: checks 
o86X2Q5GEDU3uP9oj1iFZA: bets $1
v8m8XHovI5tqEA9mvplDSw: calls $1
*** RIVER *** [5c Kd 2s 5d] [Jc]
v8m8XHovI5tqEA9mvplDSw: checks 
o86X2Q5GEDU3uP9oj1iFZA: bets $1.50
v8m8XHovI5tqEA9mvplDSw: folds 
Uncalled bet ($1.50) returned to o86X2Q5GEDU3uP9oj1iFZA
o86X2Q5GEDU3uP9oj1iFZA collected $3.45 from pot
o86X2Q5GEDU3uP9oj1iFZA: doesn't show hand 
*** SUMMARY ***
Total pot $3.60 | Rake $0.15 
Board [5c Kd 2s 5d Jc]
Seat 1: tbSZq5LHglyHk61mH9eDBw (button) folded before Flop (didn't bet)
Seat 2: TSmua8tGK3sTbwi0ynrW9Q (small blind) folded before Flop
Seat 3: v8m8XHovI5tqEA9mvplDSw (big blind) folded on the River
Seat 4: o86X2Q5GEDU3uP9oj1iFZA collected ($3.45)
Seat 6: FpN4KbLjlyRRKiVaQcoLqA folded before Flop (didn't bet)




PokerStars Game #59941815554:  Hold'em No Limit ($0.10/$0.25) - 2009/07/01 1:47:02 ET
Table 'ER5H84HUgJx7HyDLnELLeA' 6-max Seat #4 is the button
Seat 1: LJI7A1YgDM7hgh7o56+ReQ ($27.50 in chips) 
Seat 2: buyjetgNT1McXtdaP4zynA ($19.75 in chips) 
Seat 4: vqWjZmdQu/Hxw96/IJTWdQ ($25 in chips) 
Seat 5: mfrkWA3PTeYPkbO6hi98Aw ($26.45 in chips) 
Seat 6: 3zD3qLXT1bEffAoWGnc7wg ($51 in chips) 
mfrkWA3PTeYPkbO6hi98Aw: posts small blind $0.10
3zD3qLXT1bEffAoWGnc7wg: posts big blind $0.25
cS21pIxRHx5Gt42o7hPZzw: sits out 
*** HOLE CARDS ***
LJI7A1YgDM7hgh7o56+ReQ: folds 
buyjetgNT1McXtdaP4zynA: raises $0.75 to $1
vqWjZmdQu/Hxw96/IJTWdQ: folds 
mfrkWA3PTeYPkbO6hi98Aw: folds 
3zD3qLXT1bEffAoWGnc7wg: folds 
Uncalled bet ($0.75) returned to buyjetgNT1McXtdaP4zynA
buyjetgNT1McXtdaP4zynA collected $0.60 from pot
*** SUMMARY ***
Total pot $0.60 | Rake $0 
Seat 1: LJI7A1YgDM7hgh7o56+ReQ folded before Flop (didn't bet)
Seat 2: buyjetgNT1McXtdaP4zynA collected ($0.60)
Seat 4: vqWjZmdQu/Hxw96/IJTWdQ (button) folded before Flop (didn't bet)
Seat 5: mfrkWA3PTeYPkbO6hi98Aw (small blind) folded before Flop
Seat 6: 3zD3qLXT1bEffAoWGnc7wg (big blind) folded before Flop




PokerStars Game #59941815622:  Hold'em No Limit ($0.10/$0.25) - 2009/07/01 1:47:02 ET
Table '2clPgY3+dETPD/8zjXZdFw' 6-max Seat #2 is the button
Seat 2: cWc85bEzdRzpUMhRKm8pwQ ($25.30 in chips) 
Seat 3: FL1UWpN6oReBdznWDOy9Gg ($15.70 in chips) 
Seat 4: ljjhtb6FVPTx9AT9HNdtqg ($24.75 in chips) 
Seat 5: LJI7A1YgDM7hgh7o56+ReQ ($29.55 in chips) 
FL1UWpN6oReBdznWDOy9Gg: posts small blind $0.10
ljjhtb6FVPTx9AT9HNdtqg: posts big blind $0.25
7cx44/slbeTw+Cy7QB8Trg: sits out 
*** HOLE CARDS ***
LJI7A1YgDM7hgh7o56+ReQ: folds 
cWc85bEzdRzpUMhRKm8pwQ: folds 
FL1UWpN6oReBdznWDOy9Gg: folds 
Uncalled bet ($0.15) returned to ljjhtb6FVPTx9AT9HNdtqg
ljjhtb6FVPTx9AT9HNdtqg collected $0.20 from pot
*** SUMMARY ***
Total pot $0.20 | Rake $0 
Seat 2: cWc85bEzdRzpUMhRKm8pwQ (button) folded before Flop (didn't bet)
Seat 3: FL1UWpN6oReBdznWDOy9Gg (small blind) folded before Flop
Seat 4: ljjhtb6FVPTx9AT9HNdtqg (big blind) collected ($0.20)
Seat 5: LJI7A1YgDM7hgh7o56+ReQ folded before Flop (didn't bet)




PokerStars Game #59941815236:  Hold'em No Limit ($0.10/$0.25) - 2009/07/01 1:47:02 ET
Table 'gnrUwXkIPE0C8xl6cB4Hyw' 9-max Seat #5 is the button
Seat 1: EQXHDnIzAsORnIXRNtXRlA ($22.60 in chips) 
Seat 2: 7je+LC5Mfs6nL8YBVh4frQ ($5 in chips) 
Seat 3: PdIasPkzm2sqZnN41ZRXOg ($5 in chips) 
Seat 4: wGigCmBR/9XWkPpvYos3aQ ($25 in chips) 
Seat 5: gehe91e0IyVT0QU/XBkEyg ($26.90 in chips) 
Seat 6: dtZ84flFEi4Q+SGrHMJRDQ ($25.90 in chips) 
Seat 7: OXPkK84/qv92EMwXPiG5rQ ($9.95 in chips) 
Seat 8: 4awUyiDYTgylQKXZ9faBVA ($60.65 in chips) 
Seat 9: F7pnn6czNpHvRM55XcA2EA ($25.50 in chips) 
dtZ84flFEi4Q+SGrHMJRDQ: posts small blind $0.10
OXPkK84/qv92EMwXPiG5rQ: posts big blind $0.25
*** HOLE CARDS ***
4awUyiDYTgylQKXZ9faBVA: folds 
F7pnn6czNpHvRM55XcA2EA: folds 
EQXHDnIzAsORnIXRNtXRlA: folds 
7je+LC5Mfs6nL8YBVh4frQ: folds 
PdIasPkzm2sqZnN41ZRXOg: folds 
wGigCmBR/9XWkPpvYos3aQ: raises $0.65 to $0.90
gehe91e0IyVT0QU/XBkEyg: raises $1.10 to $2
dtZ84flFEi4Q+SGrHMJRDQ: folds 
OXPkK84/qv92EMwXPiG5rQ: folds 
wGigCmBR/9XWkPpvYos3aQ: calls $1.10
*** FLOP *** [As 2h Js]
wGigCmBR/9XWkPpvYos3aQ: checks 
gehe91e0IyVT0QU/XBkEyg: bets $2.75
wGigCmBR/9XWkPpvYos3aQ: calls $2.75
*** TURN *** [As 2h Js] [5h]
wGigCmBR/9XWkPpvYos3aQ: checks 
gehe91e0IyVT0QU/XBkEyg: bets $6
wGigCmBR/9XWkPpvYos3aQ: folds 
Uncalled bet ($6) returned to gehe91e0IyVT0QU/XBkEyg
gehe91e0IyVT0QU/XBkEyg collected $9.40 from pot
*** SUMMARY ***
Total pot $9.85 | Rake $0.45 
Board [As 2h Js 5h]
Seat 1: EQXHDnIzAsORnIXRNtXRlA folded before Flop (didn't bet)
Seat 2: 7je+LC5Mfs6nL8YBVh4frQ folded before Flop (didn't bet)
Seat 3: PdIasPkzm2sqZnN41ZRXOg folded before Flop (didn't bet)
Seat 4: wGigCmBR/9XWkPpvYos3aQ folded on the Turn
Seat 5: gehe91e0IyVT0QU/XBkEyg (button) collected ($9.40)
Seat 6: dtZ84flFEi4Q+SGrHMJRDQ (small blind) folded before Flop
Seat 7: OXPkK84/qv92EMwXPiG5rQ (big blind) folded before Flop
Seat 8: 4awUyiDYTgylQKXZ9faBVA folded before Flop (didn't bet)
Seat 9: F7pnn6czNpHvRM55XcA2EA folded before Flop (didn't bet)




PokerStars Game #59941815430:  Hold'em No Limit ($0.10/$0.25) - 2009/07/01 1:47:02 ET
Table 'aaXqTKUnxrX9DYXtxhWXxA' 6-max Seat #4 is the button
Seat 1: aSrj4lVmn2owyQ1RbbOqxQ ($27.15 in chips) 
Seat 2: DE9hRlt14g+JdsRQ4wT7hg ($33.35 in chips) 
Seat 3: uUXdcVMNa05rfbntdvplfw ($8.15 in chips) 
Seat 4: 48oT5xFI+5CHUJlfoGrE4w ($8.80 in chips) 
Seat 5: kyRaCIljYA6l33lSKQfNsg ($24.70 in chips) 
Seat 6: buyjetgNT1McXtdaP4zynA ($50.15 in chips) 
kyRaCIljYA6l33lSKQfNsg: posts small blind $0.10
buyjetgNT1McXtdaP4zynA: posts big blind $0.25
*** HOLE CARDS ***
aSrj4lVmn2owyQ1RbbOqxQ: folds 
DE9hRlt14g+JdsRQ4wT7hg: folds 
uUXdcVMNa05rfbntdvplfw: calls $0.25
48oT5xFI+5CHUJlfoGrE4w: folds 
kyRaCIljYA6l33lSKQfNsg: folds 
buyjetgNT1McXtdaP4zynA: checks 
*** FLOP *** [9h 4s Jc]
buyjetgNT1McXtdaP4zynA: bets $1
uUXdcVMNa05rfbntdvplfw: folds 
Uncalled bet ($1) returned to buyjetgNT1McXtdaP4zynA
buyjetgNT1McXtdaP4zynA collected $0.60 from pot
*** SUMMARY ***
Total pot $0.60 | Rake $0 
Board [9h 4s Jc]
Seat 1: aSrj4lVmn2owyQ1RbbOqxQ folded before Flop (didn't bet)
Seat 2: DE9hRlt14g+JdsRQ4wT7hg folded before Flop (didn't bet)
Seat 3: uUXdcVMNa05rfbntdvplfw folded on the Flop
Seat 4: 48oT5xFI+5CHUJlfoGrE4w (button) folded before Flop (didn't bet)
Seat 5: kyRaCIljYA6l33lSKQfNsg (small blind) folded before Flop
Seat 6: buyjetgNT1McXtdaP4zynA (big blind) collected ($0.60)




PokerStars Game #59941815368:  Hold'em No Limit ($0.10/$0.25) - 2009/07/01 1:47:02 ET
Table 'YONIZZNvg4uZ4xNUO1deeA' 6-max Seat #2 is the button
Seat 1: GbCVUNssQ7mqsPWr7J4d3w ($4.65 in chips) 
Seat 2: evMMX/0gSDH791KdSAOaSg ($17.20 in chips) 
Seat 3: Eksrep3hySi2jeDHuaWiOQ ($10.75 in chips) 
Seat 4: w43JQj2oYPpKQVG4Yzlq1w ($25.35 in chips) 
Seat 5: if4dh6jhJXeN3/qd3qCp9g ($25 in chips) 
Seat 6: eL3+wCBjFGfQ5FMdIZihwA ($27 in chips) 
Eksrep3hySi2jeDHuaWiOQ: posts small blind $0.10
w43JQj2oYPpKQVG4Yzlq1w: posts big blind $0.25
*** HOLE CARDS ***
if4dh6jhJXeN3/qd3qCp9g: folds 
eL3+wCBjFGfQ5FMdIZihwA: folds 
GbCVUNssQ7mqsPWr7J4d3w: folds 
evMMX/0gSDH791KdSAOaSg: folds 
Eksrep3hySi2jeDHuaWiOQ: calls $0.15
w43JQj2oYPpKQVG4Yzlq1w: checks 
*** FLOP *** [7d 9s 4s]
Eksrep3hySi2jeDHuaWiOQ: bets $0.75
w43JQj2oYPpKQVG4Yzlq1w: folds 
Uncalled bet ($0.75) returned to Eksrep3hySi2jeDHuaWiOQ
Eksrep3hySi2jeDHuaWiOQ collected $0.50 from pot
*** SUMMARY ***
Total pot $0.50 | Rake $0 
Board [7d 9s 4s]
Seat 1: GbCVUNssQ7mqsPWr7J4d3w folded before Flop (didn't bet)
Seat 2: evMMX/0gSDH791KdSAOaSg (button) folded before Flop (didn't bet)
Seat 3: Eksrep3hySi2jeDHuaWiOQ (small blind) collected ($0.50)
Seat 4: w43JQj2oYPpKQVG4Yzlq1w (big blind) folded on the Flop
Seat 5: if4dh6jhJXeN3/qd3qCp9g folded before Flop (didn't bet)
Seat 6: eL3+wCBjFGfQ5FMdIZihwA folded before Flop (didn't bet)




PokerStars Game #59941815450:  Hold'em No Limit ($0.10/$0.25) - 2009/07/01 1:47:02 ET
Table 'QegsWX65l3n/K0A8XB78yg' 6-max Seat #6 is the button
Seat 1: p6adJRMXMBLr+xtQzqazIQ ($15.55 in chips) 
Seat 2: GC/9yVD59DUCX7hUI7gcLw ($57.85 in chips) 
Seat 3: iIgNoBh+3/Ix1/fLsg+HuA ($6 in chips) 
Seat 4: epAUIB7h2FJXzUPRIvSkRA ($25 in chips) 
Seat 5: QqiZLFrN8iOUT/GHw7ztOA ($24.65 in chips) 
Seat 6: 5PWs02z65jSO5pr/M6wx/w ($6.45 in chips) 
p6adJRMXMBLr+xtQzqazIQ: posts small blind $0.10
GC/9yVD59DUCX7hUI7gcLw: posts big blind $0.25
*** HOLE CARDS ***
iIgNoBh+3/Ix1/fLsg+HuA: folds 
epAUIB7h2FJXzUPRIvSkRA: folds 
QqiZLFrN8iOUT/GHw7ztOA: folds 
5PWs02z65jSO5pr/M6wx/w: folds 
p6adJRMXMBLr+xtQzqazIQ: raises $0.50 to $0.75
GC/9yVD59DUCX7hUI7gcLw: calls $0.50
*** FLOP *** [9s 8h 7c]
p6adJRMXMBLr+xtQzqazIQ: bets $1.75
GC/9yVD59DUCX7hUI7gcLw: folds 
Uncalled bet ($1.75) returned to p6adJRMXMBLr+xtQzqazIQ
p6adJRMXMBLr+xtQzqazIQ collected $1.45 from pot
*** SUMMARY ***
Total pot $1.50 | Rake $0.05 
Board [9s 8h 7c]
Seat 1: p6adJRMXMBLr+xtQzqazIQ (small blind) collected ($1.45)
Seat 2: GC/9yVD59DUCX7hUI7gcLw (big blind) folded on the Flop
Seat 3: iIgNoBh+3/Ix1/fLsg+HuA folded before Flop (didn't bet)
Seat 4: epAUIB7h2FJXzUPRIvSkRA folded before Flop (didn't bet)
Seat 5: QqiZLFrN8iOUT/GHw7ztOA folded before Flop (didn't bet)
Seat 6: 5PWs02z65jSO5pr/M6wx/w (button) folded before Flop (didn't bet)




PokerStars Game #59941815618:  Hold'em No Limit ($0.10/$0.25) - 2009/07/01 1:47:02 ET
Table 'dZNBGqFYSwfOVZvDJ4VjIQ' 6-max Seat #5 is the button
Seat 1: v+QfkGiuj9bgtuNoVnDO8w ($37.45 in chips) 
Seat 2: 3zD3qLXT1bEffAoWGnc7wg ($28.95 in chips) 
Seat 3: kyRaCIljYA6l33lSKQfNsg ($28.30 in chips) 
Seat 4: mFv3iBCtrw9XfCDRB0d46Q ($5.80 in chips) 
Seat 5: +ZlnqPoP3Hg4BIUxDfKd/A ($29.25 in chips) 
Seat 6: ypmjhffk/YHGc51wgVXUTw ($29.50 in chips) 
ypmjhffk/YHGc51wgVXUTw: posts small blind $0.10
v+QfkGiuj9bgtuNoVnDO8w: posts big blind $0.25
*** HOLE CARDS ***
3zD3qLXT1bEffAoWGnc7wg: raises $0.75 to $1
kyRaCIljYA6l33lSKQfNsg: folds 
mFv3iBCtrw9XfCDRB0d46Q: folds 
+ZlnqPoP3Hg4BIUxDfKd/A: folds 
ypmjhffk/YHGc51wgVXUTw: folds 
v+QfkGiuj9bgtuNoVnDO8w: folds 
Uncalled bet ($0.75) returned to 3zD3qLXT1bEffAoWGnc7wg
3zD3qLXT1bEffAoWGnc7wg collected $0.60 from pot
3zD3qLXT1bEffAoWGnc7wg: doesn't show hand 
*** SUMMARY ***
Total pot $0.60 | Rake $0 
Seat 1: v+QfkGiuj9bgtuNoVnDO8w (big blind) folded before Flop
Seat 2: 3zD3qLXT1bEffAoWGnc7wg collected ($0.60)
Seat 3: kyRaCIljYA6l33lSKQfNsg folded before Flop (didn't bet)
Seat 4: mFv3iBCtrw9XfCDRB0d46Q folded before Flop (didn't bet)
Seat 5: +ZlnqPoP3Hg4BIUxDfKd/A (button) folded before Flop (didn't bet)
Seat 6: ypmjhffk/YHGc51wgVXUTw (small blind) folded before Flop




PokerStars Game #59941815746:  Hold'em No Limit ($0.10/$0.25) - 2009/07/01 1:47:03 ET
Table 'KU/HrxqxwDz8HKEhYTZ6uw' 6-max Seat #2 is the button
Seat 1: 7LKoiQHXpTQXJvWQrw907g ($37.70 in chips) 
Seat 2: kG34n23qFQA3nzdOJTQ1dA ($24.65 in chips) 
Seat 3: SFmT9ZsVopnukjvAzrxTRg ($25.35 in chips) 
Seat 4: AGwMM0FUhYZf81+oXvYQMg ($26.95 in chips) 
Seat 5: iyZxqznXjv3vtvOJymkoLQ ($50.90 in chips) 
Seat 6: qWxkCeqApAWdAA0evrfDvQ ($11.25 in chips) 
SFmT9ZsVopnukjvAzrxTRg: posts small blind $0.10
AGwMM0FUhYZf81+oXvYQMg: posts big blind $0.25
*** HOLE CARDS ***
iyZxqznXjv3vtvOJymkoLQ: folds 
qWxkCeqApAWdAA0evrfDvQ: folds 
7LKoiQHXpTQXJvWQrw907g: calls $0.25
kG34n23qFQA3nzdOJTQ1dA: folds 
SFmT9ZsVopnukjvAzrxTRg: folds 
AGwMM0FUhYZf81+oXvYQMg: checks 
*** FLOP *** [2d 3s Ah]
AGwMM0FUhYZf81+oXvYQMg: checks 
7LKoiQHXpTQXJvWQrw907g: checks 
*** TURN *** [2d 3s Ah] [2c]
AGwMM0FUhYZf81+oXvYQMg: checks 
7LKoiQHXpTQXJvWQrw907g: bets $0.50
AGwMM0FUhYZf81+oXvYQMg: folds 
Uncalled bet ($0.50) returned to 7LKoiQHXpTQXJvWQrw907g
7LKoiQHXpTQXJvWQrw907g collected $0.60 from pot
*** SUMMARY ***
Total pot $0.60 | Rake $0 
Board [2d 3s Ah 2c]
Seat 1: 7LKoiQHXpTQXJvWQrw907g collected ($0.60)
Seat 2: kG34n23qFQA3nzdOJTQ1dA (button) folded before Flop (didn't bet)
Seat 3: SFmT9ZsVopnukjvAzrxTRg (small blind) folded before Flop
Seat 4: AGwMM0FUhYZf81+oXvYQMg (big blind) folded on the Turn
Seat 5: iyZxqznXjv3vtvOJymkoLQ folded before Flop (didn't bet)
Seat 6: qWxkCeqApAWdAA0evrfDvQ folded before Flop (didn't bet)




PokerStars Game #59941815736:  Hold'em No Limit ($0.10/$0.25) - 2009/07/01 1:47:03 ET
Table 'fHv1Mk7ZbLjprZTGWKPiEQ' 6-max Seat #1 is the button
Seat 1: OIjOiBfQstWrK/RuXx7zcw ($3.20 in chips) 
Seat 2: 9U3ZKjCsarN0DjR6mSE8Ug ($14.30 in chips) 
Seat 3: /gJNBeCkWL4o85/jvlZ4BA ($25 in chips) 
Seat 4: TSmua8tGK3sTbwi0ynrW9Q ($58.80 in chips) 
Seat 5: LJI7A1YgDM7hgh7o56+ReQ ($26.30 in chips) 
Seat 6: AjG0X+rNtc2W08eph8oqpw ($53.40 in chips) 
9U3ZKjCsarN0DjR6mSE8Ug: posts small blind $0.10
/gJNBeCkWL4o85/jvlZ4BA: posts big blind $0.25
*** HOLE CARDS ***
TSmua8tGK3sTbwi0ynrW9Q: folds 
LJI7A1YgDM7hgh7o56+ReQ: folds 
AjG0X+rNtc2W08eph8oqpw: folds 
OIjOiBfQstWrK/RuXx7zcw: calls $0.25
9U3ZKjCsarN0DjR6mSE8Ug: calls $0.15
/gJNBeCkWL4o85/jvlZ4BA: checks 
*** FLOP *** [8s Kc Th]
9U3ZKjCsarN0DjR6mSE8Ug: checks 
/gJNBeCkWL4o85/jvlZ4BA: checks 
OIjOiBfQstWrK/RuXx7zcw: bets $0.25
9U3ZKjCsarN0DjR6mSE8Ug: folds 
/gJNBeCkWL4o85/jvlZ4BA: folds 
Uncalled bet ($0.25) returned to OIjOiBfQstWrK/RuXx7zcw
OIjOiBfQstWrK/RuXx7zcw collected $0.75 from pot
OIjOiBfQstWrK/RuXx7zcw: doesn't show hand 
*** SUMMARY ***
Total pot $0.75 | Rake $0 
Board [8s Kc Th]
Seat 1: OIjOiBfQstWrK/RuXx7zcw (button) collected ($0.75)
Seat 2: 9U3ZKjCsarN0DjR6mSE8Ug (small blind) folded on the Flop
Seat 3: /gJNBeCkWL4o85/jvlZ4BA (big blind) folded on the Flop
Seat 4: TSmua8tGK3sTbwi0ynrW9Q folded before Flop (didn't bet)
Seat 5: LJI7A1YgDM7hgh7o56+ReQ folded before Flop (didn't bet)
Seat 6: AjG0X+rNtc2W08eph8oqpw folded before Flop (didn't bet)




PokerStars Game #59941815998:  Hold'em No Limit ($0.10/$0.25) - 2009/07/01 1:47:03 ET
Table 'AHkg4ChqzcMauBx6Qvz8Nw' 6-max Seat #6 is the button
Seat 1: +RDf7SmUjY2kK0PzdBEYqg ($6.40 in chips) 
Seat 2: Vi0JMrTI2BGrPL7UIulJtA ($5.30 in chips) 
Seat 3: 9dToMv2GJLfi00HcpfMnIw ($27.50 in chips) 
Seat 4: Eznneya0vB6S+eXJdVleHA ($16.95 in chips) 
Seat 5: Bada343Si4xKu3fNXY99AA ($4.20 in chips) 
Seat 6: Hsvkc0/G2VV78oVmWYXecw ($5 in chips) 
+RDf7SmUjY2kK0PzdBEYqg: posts small blind $0.10
Vi0JMrTI2BGrPL7UIulJtA: posts big blind $0.25
*** HOLE CARDS ***
9dToMv2GJLfi00HcpfMnIw: folds 
Eznneya0vB6S+eXJdVleHA: calls $0.25
Bada343Si4xKu3fNXY99AA: folds 
Hsvkc0/G2VV78oVmWYXecw: raises $0.50 to $0.75
+RDf7SmUjY2kK0PzdBEYqg: folds 
Vi0JMrTI2BGrPL7UIulJtA: folds 
Eznneya0vB6S+eXJdVleHA: calls $0.50
*** FLOP *** [Kh Ad Kc]
Eznneya0vB6S+eXJdVleHA: checks 
Hsvkc0/G2VV78oVmWYXecw: checks 
*** TURN *** [Kh Ad Kc] [8s]
Eznneya0vB6S+eXJdVleHA: checks 
Hsvkc0/G2VV78oVmWYXecw: bets $1
Eznneya0vB6S+eXJdVleHA: calls $1
*** RIVER *** [Kh Ad Kc 8s] [3h]
Eznneya0vB6S+eXJdVleHA: checks 
Hsvkc0/G2VV78oVmWYXecw: checks 
*** SHOW DOWN ***
Eznneya0vB6S+eXJdVleHA: shows [3c As] (two pair, Aces and Kings)
Hsvkc0/G2VV78oVmWYXecw: mucks hand 
Eznneya0vB6S+eXJdVleHA collected $3.70 from pot
*** SUMMARY ***
Total pot $3.85 | Rake $0.15 
Board [Kh Ad Kc 8s 3h]
Seat 1: +RDf7SmUjY2kK0PzdBEYqg (small blind) folded before Flop
Seat 2: Vi0JMrTI2BGrPL7UIulJtA (big blind) folded before Flop
Seat 3: 9dToMv2GJLfi00HcpfMnIw folded before Flop (didn't bet)
Seat 4: Eznneya0vB6S+eXJdVleHA showed [3c As] and won ($3.70) with two pair, Aces and Kings
Seat 5: Bada343Si4xKu3fNXY99AA folded before Flop (didn't bet)
Seat 6: Hsvkc0/G2VV78oVmWYXecw (button) mucked




PokerStars Game #59941815874:  Hold'em No Limit ($0.10/$0.25) - 2009/07/01 1:47:03 ET
Table 'n8mNkPYbe1AIQEkioNesZA' 9-max Seat #9 is the button
Seat 1: 9lvO/qyU+xrU95Teu1fv0g ($5.30 in chips) 
Seat 2: QEbIGci+itdw+re8RM5fZA ($29.30 in chips) 
Seat 3: zDrucyjVn5aeekNEc3cJrA ($19 in chips) 
Seat 4: zgi+EUykT/pZQpoUG6+oEg ($5 in chips) 
Seat 5: wGigCmBR/9XWkPpvYos3aQ ($28.40 in chips) 
Seat 6: HPEB+AtKw1+C/cxU0o1ciw ($46.55 in chips) 
Seat 7: vNfw/x/HNt0WgQC8SveThg ($4 in chips) 
Seat 8: aNpwfA31EREwO+ar4XzBCw ($28.25 in chips) 
Seat 9: gehe91e0IyVT0QU/XBkEyg ($27.90 in chips) 
9lvO/qyU+xrU95Teu1fv0g: posts small blind $0.10
QEbIGci+itdw+re8RM5fZA: posts big blind $0.25
*** HOLE CARDS ***
zDrucyjVn5aeekNEc3cJrA: folds 
zgi+EUykT/pZQpoUG6+oEg: folds 
wGigCmBR/9XWkPpvYos3aQ: folds 
HPEB+AtKw1+C/cxU0o1ciw: folds 
vNfw/x/HNt0WgQC8SveThg: raises $0.25 to $0.50
aNpwfA31EREwO+ar4XzBCw: raises $1.50 to $2
gehe91e0IyVT0QU/XBkEyg: folds 
9lvO/qyU+xrU95Teu1fv0g: folds 
QEbIGci+itdw+re8RM5fZA: folds 
vNfw/x/HNt0WgQC8SveThg: calls $1.50
*** FLOP *** [Ts Jd Kh]
vNfw/x/HNt0WgQC8SveThg: checks 
aNpwfA31EREwO+ar4XzBCw: checks 
*** TURN *** [Ts Jd Kh] [Ks]
vNfw/x/HNt0WgQC8SveThg: bets $2 and is all-in
aNpwfA31EREwO+ar4XzBCw: calls $2
*** RIVER *** [Ts Jd Kh Ks] [2c]
*** SHOW DOWN ***
vNfw/x/HNt0WgQC8SveThg: shows [9s As] (a pair of Kings)
aNpwfA31EREwO+ar4XzBCw: shows [Qh Ah] (a straight, Ten to Ace)
aNpwfA31EREwO+ar4XzBCw collected $7.95 from pot
*** SUMMARY ***
Total pot $8.35 | Rake $0.40 
Board [Ts Jd Kh Ks 2c]
Seat 1: 9lvO/qyU+xrU95Teu1fv0g (small blind) folded before Flop
Seat 2: QEbIGci+itdw+re8RM5fZA (big blind) folded before Flop
Seat 3: zDrucyjVn5aeekNEc3cJrA folded before Flop (didn't bet)
Seat 4: zgi+EUykT/pZQpoUG6+oEg folded before Flop (didn't bet)
Seat 5: wGigCmBR/9XWkPpvYos3aQ folded before Flop (didn't bet)
Seat 6: HPEB+AtKw1+C/cxU0o1ciw folded before Flop (didn't bet)
Seat 7: vNfw/x/HNt0WgQC8SveThg showed [9s As] and lost with a pair of Kings
Seat 8: aNpwfA31EREwO+ar4XzBCw showed [Qh Ah] and won ($7.95) with a straight, Ten to Ace
Seat 9: gehe91e0IyVT0QU/XBkEyg (button) folded before Flop (didn't bet)




PokerStars Game #59941815994:  Hold'em No Limit ($0.10/$0.25) - 2009/07/01 1:47:03 ET
Table 'IfRHUn9gQQA9I/Z4tn+BoA' 9-max Seat #6 is the button
Seat 1: imHPFFqvfHGzsBBWeGuy4w ($24.35 in chips) 
Seat 2: VWUWpMLMj/Q1jRVpF7Aohw ($16.95 in chips) 
Seat 3: ModuIAhh03puxW6XFxQ3Nw ($17.50 in chips) 
Seat 4: QEbIGci+itdw+re8RM5fZA ($33.55 in chips) 
Seat 5: DdPXdieucQ+n99u1n3A+rQ ($4.65 in chips) 
Seat 6: UOjoGGQ58/uDS7V0xkjOrQ ($9.95 in chips) 
Seat 7: YzqSxP03XxZPbgPifgt69g ($28.85 in chips) 
Seat 8: cZ99hugmLBj9KhTlc8nCSw ($28.10 in chips) 
Seat 9: 7cv+9Zc9HIQHNvYsMfV3uA ($47.75 in chips) 
YzqSxP03XxZPbgPifgt69g: posts small blind $0.10
cZ99hugmLBj9KhTlc8nCSw: posts big blind $0.25
*** HOLE CARDS ***
7cv+9Zc9HIQHNvYsMfV3uA: folds 
imHPFFqvfHGzsBBWeGuy4w: calls $0.25
VWUWpMLMj/Q1jRVpF7Aohw: folds 
ModuIAhh03puxW6XFxQ3Nw: calls $0.25
QEbIGci+itdw+re8RM5fZA: raises $1 to $1.25
DdPXdieucQ+n99u1n3A+rQ: folds 
UOjoGGQ58/uDS7V0xkjOrQ: folds 
YzqSxP03XxZPbgPifgt69g: folds 
cZ99hugmLBj9KhTlc8nCSw: folds 
imHPFFqvfHGzsBBWeGuy4w: folds 
ModuIAhh03puxW6XFxQ3Nw: calls $1
*** FLOP *** [As 9c 6c]
ModuIAhh03puxW6XFxQ3Nw: bets $0.25
QEbIGci+itdw+re8RM5fZA: raises $2 to $2.25
ModuIAhh03puxW6XFxQ3Nw: folds 
Uncalled bet ($2) returned to QEbIGci+itdw+re8RM5fZA
QEbIGci+itdw+re8RM5fZA collected $3.45 from pot
QEbIGci+itdw+re8RM5fZA: doesn't show hand 
*** SUMMARY ***
Total pot $3.60 | Rake $0.15 
Board [As 9c 6c]
Seat 1: imHPFFqvfHGzsBBWeGuy4w folded before Flop
Seat 2: VWUWpMLMj/Q1jRVpF7Aohw folded before Flop (didn't bet)
Seat 3: ModuIAhh03puxW6XFxQ3Nw folded on the Flop
Seat 4: QEbIGci+itdw+re8RM5fZA collected ($3.45)
Seat 5: DdPXdieucQ+n99u1n3A+rQ folded before Flop (didn't bet)
Seat 6: UOjoGGQ58/uDS7V0xkjOrQ (button) folded before Flop (didn't bet)
Seat 7: YzqSxP03XxZPbgPifgt69g (small blind) folded before Flop
Seat 8: cZ99hugmLBj9KhTlc8nCSw (big blind) folded before Flop
Seat 9: 7cv+9Zc9HIQHNvYsMfV3uA folded before Flop (didn't bet)




PokerStars Game #59941815720:  Hold'em No Limit ($0.10/$0.25) - 2009/07/01 1:47:03 ET
Table 'ROYvQOMwUrvL3SOiHYcrWg' 9-max Seat #1 is the button
Seat 1: 22dIObOuor/A+IKWkNoAlA ($5.40 in chips) 
Seat 2: gehe91e0IyVT0QU/XBkEyg ($25.25 in chips) 
Seat 3: 8EbrQ/EvFWt2cr0GaU82gQ ($4.65 in chips) 
Seat 4: SHegmCn8B0InbWE/zFlvOw ($21.70 in chips) 
Seat 5: 7je+LC5Mfs6nL8YBVh4frQ ($5 in chips) 
Seat 6: P+9ymZQ3ktpQu1bn7HIjew ($20.50 in chips) 
Seat 7: tYsOBqdU1+x+yFI7zHO7hQ ($25 in chips) 
Seat 8: biJWLZ27fafNeBI2oT1KJw ($28.15 in chips) 
Seat 9: uhrboV251dcgYniYTdFIcA ($25 in chips) 
gehe91e0IyVT0QU/XBkEyg: posts small blind $0.10
8EbrQ/EvFWt2cr0GaU82gQ: posts big blind $0.25
*** HOLE CARDS ***
SHegmCn8B0InbWE/zFlvOw: folds 
7je+LC5Mfs6nL8YBVh4frQ: folds 
P+9ymZQ3ktpQu1bn7HIjew: folds 
tYsOBqdU1+x+yFI7zHO7hQ: folds 
biJWLZ27fafNeBI2oT1KJw: folds 
uhrboV251dcgYniYTdFIcA: raises $0.75 to $1
22dIObOuor/A+IKWkNoAlA: folds 
gehe91e0IyVT0QU/XBkEyg: folds 
8EbrQ/EvFWt2cr0GaU82gQ: folds 
Uncalled bet ($0.75) returned to uhrboV251dcgYniYTdFIcA
uhrboV251dcgYniYTdFIcA collected $0.60 from pot
uhrboV251dcgYniYTdFIcA: doesn't show hand 
*** SUMMARY ***
Total pot $0.60 | Rake $0 
Seat 1: 22dIObOuor/A+IKWkNoAlA (button) folded before Flop (didn't bet)
Seat 2: gehe91e0IyVT0QU/XBkEyg (small blind) folded before Flop
Seat 3: 8EbrQ/EvFWt2cr0GaU82gQ (big blind) folded before Flop
Seat 4: SHegmCn8B0InbWE/zFlvOw folded before Flop (didn't bet)
Seat 5: 7je+LC5Mfs6nL8YBVh4frQ folded before Flop (didn't bet)
Seat 6: P+9ymZQ3ktpQu1bn7HIjew folded before Flop (didn't bet)
Seat 7: tYsOBqdU1+x+yFI7zHO7hQ folded before Flop (didn't bet)
Seat 8: biJWLZ27fafNeBI2oT1KJw folded before Flop (didn't bet)
Seat 9: uhrboV251dcgYniYTdFIcA collected ($0.60)




PokerStars Game #59941816072:  Hold'em No Limit ($0.10/$0.25) - 2009/07/01 1:47:03 ET
Table '+VTTYgQLH1awDHk+IAxqGg' 9-max Seat #3 is the button
Seat 1: arxNSjreDRGFg13EAM2F1w ($26.90 in chips) 
Seat 2: 2wcFsZsqEP5w1StUTVzJCg ($5.85 in chips) 
Seat 3: AiXn/9o1EwOPZUHujnh/bA ($11.65 in chips) 
Seat 4: gE5rN2TDY1aXcZn/TOPeZw ($10.40 in chips) 
Seat 5: sD+TKtt36XiiN6jqHiLwDA ($25.15 in chips) 
Seat 7: ljemhp25Zg+nlA9DLCIiUw ($24.25 in chips) 
Seat 8: 10vzP4r6ldwGLbYHKd9www ($18.15 in chips) 
Seat 9: S7Ki0P+0AIGPuIfGJjW0gg ($61 in chips) 
gE5rN2TDY1aXcZn/TOPeZw: posts small blind $0.10
sD+TKtt36XiiN6jqHiLwDA: posts big blind $0.25
*** HOLE CARDS ***
ljemhp25Zg+nlA9DLCIiUw: folds 
10vzP4r6ldwGLbYHKd9www: raises $0.25 to $0.50
S7Ki0P+0AIGPuIfGJjW0gg: folds 
arxNSjreDRGFg13EAM2F1w: folds 
2wcFsZsqEP5w1StUTVzJCg: folds 
AiXn/9o1EwOPZUHujnh/bA: folds 
gE5rN2TDY1aXcZn/TOPeZw: calls $0.40
sD+TKtt36XiiN6jqHiLwDA: folds 
*** FLOP *** [3d 6s Ac]
gE5rN2TDY1aXcZn/TOPeZw: checks 
10vzP4r6ldwGLbYHKd9www: bets $0.50
gE5rN2TDY1aXcZn/TOPeZw: folds 
Uncalled bet ($0.50) returned to 10vzP4r6ldwGLbYHKd9www
10vzP4r6ldwGLbYHKd9www collected $1.20 from pot
*** SUMMARY ***
Total pot $1.25 | Rake $0.05 
Board [3d 6s Ac]
Seat 1: arxNSjreDRGFg13EAM2F1w folded before Flop (didn't bet)
Seat 2: 2wcFsZsqEP5w1StUTVzJCg folded before Flop (didn't bet)
Seat 3: AiXn/9o1EwOPZUHujnh/bA (button) folded before Flop (didn't bet)
Seat 4: gE5rN2TDY1aXcZn/TOPeZw (small blind) folded on the Flop
Seat 5: sD+TKtt36XiiN6jqHiLwDA (big blind) folded before Flop
Seat 7: ljemhp25Zg+nlA9DLCIiUw folded before Flop (didn't bet)
Seat 8: 10vzP4r6ldwGLbYHKd9www collected ($1.20)
Seat 9: S7Ki0P+0AIGPuIfGJjW0gg folded before Flop (didn't bet)




PokerStars Game #59941816030:  Hold'em No Limit ($0.10/$0.25) - 2009/07/01 1:47:03 ET
Table 'emoxgHTxg9Uqeu06oLzLyg' 6-max Seat #1 is the button
Seat 1: epAUIB7h2FJXzUPRIvSkRA ($25.40 in chips) 
Seat 2: wIFhgE1PVdX6Xf6aVlSTPg ($28.30 in chips) 
Seat 3: uD5epdBxuyc30pF1dO958Q ($11.90 in chips) 
Seat 4: 3VAbqAWh8ncE2SJOYIx2ZQ ($11 in chips) 
Seat 5: OIjOiBfQstWrK/RuXx7zcw ($4.05 in chips) 
iHZrkhpIO/3+tKuAoPx8HQ leaves the table
wIFhgE1PVdX6Xf6aVlSTPg: posts small blind $0.10
uD5epdBxuyc30pF1dO958Q: posts big blind $0.25
*** HOLE CARDS ***
3VAbqAWh8ncE2SJOYIx2ZQ: folds 
OIjOiBfQstWrK/RuXx7zcw: calls $0.25
epAUIB7h2FJXzUPRIvSkRA: raises $1 to $1.25
wIFhgE1PVdX6Xf6aVlSTPg: folds 
u3Ol7kv1LmvszuHNm9rc6w joins the table at seat #6 
uD5epdBxuyc30pF1dO958Q: calls $1
OIjOiBfQstWrK/RuXx7zcw: calls $1
*** FLOP *** [7c 7d Qh]
uD5epdBxuyc30pF1dO958Q: checks 
OIjOiBfQstWrK/RuXx7zcw: bets $0.25
epAUIB7h2FJXzUPRIvSkRA: folds 
uD5epdBxuyc30pF1dO958Q: calls $0.25
*** TURN *** [7c 7d Qh] [Qd]
uD5epdBxuyc30pF1dO958Q: checks 
OIjOiBfQstWrK/RuXx7zcw: checks 
*** RIVER *** [7c 7d Qh Qd] [Ad]
uD5epdBxuyc30pF1dO958Q: bets $0.25
OIjOiBfQstWrK/RuXx7zcw: raises $1.50 to $1.75
uD5epdBxuyc30pF1dO958Q: folds 
Uncalled bet ($1.50) returned to OIjOiBfQstWrK/RuXx7zcw
OIjOiBfQstWrK/RuXx7zcw collected $4.65 from pot
OIjOiBfQstWrK/RuXx7zcw: doesn't show hand 
*** SUMMARY ***
Total pot $4.85 | Rake $0.20 
Board [7c 7d Qh Qd Ad]
Seat 1: epAUIB7h2FJXzUPRIvSkRA (button) folded on the Flop
Seat 2: wIFhgE1PVdX6Xf6aVlSTPg (small blind) folded before Flop
Seat 3: uD5epdBxuyc30pF1dO958Q (big blind) folded on the River
Seat 4: 3VAbqAWh8ncE2SJOYIx2ZQ folded before Flop (didn't bet)
Seat 5: OIjOiBfQstWrK/RuXx7zcw collected ($4.65)




PokerStars Game #59941816532:  Hold'em No Limit ($0.10/$0.25) - 2009/07/01 1:47:04 ET
Table 'P2yJ+jwfNsBdF12fLKA6DQ' 9-max Seat #9 is the button
Seat 1: zDrucyjVn5aeekNEc3cJrA ($21.35 in chips) 
Seat 2: uQwmfH5LEVA5eyghJdyPUg ($15.40 in chips) 
Seat 4: 6NLAWFPZZfqlVkY8n9RULA ($14 in chips) 
Seat 5: B7VAFAMs/PYlYABlV+EkSA ($7.45 in chips) 
Seat 6: mUoFJKqCzIUABvOFbiINlQ ($14.25 in chips) 
Seat 7: yQc5nLaNmByxI15Jegu61w ($18.15 in chips) 
Seat 8: LMd3gq2uNfbWTfXTnSeQRw ($9.30 in chips) 
Seat 9: dN5zq7QdZCUe7NZFM6cECg ($19.15 in chips) 
zDrucyjVn5aeekNEc3cJrA: posts small blind $0.10
uQwmfH5LEVA5eyghJdyPUg: posts big blind $0.25
8EbrQ/EvFWt2cr0GaU82gQ: sits out 
*** HOLE CARDS ***
6NLAWFPZZfqlVkY8n9RULA: folds 
B7VAFAMs/PYlYABlV+EkSA: raises $1 to $1.25
mUoFJKqCzIUABvOFbiINlQ: folds 
yQc5nLaNmByxI15Jegu61w: folds 
LMd3gq2uNfbWTfXTnSeQRw: folds 
dN5zq7QdZCUe7NZFM6cECg: folds 
zDrucyjVn5aeekNEc3cJrA: folds 
uQwmfH5LEVA5eyghJdyPUg: folds 
Uncalled bet ($1) returned to B7VAFAMs/PYlYABlV+EkSA
B7VAFAMs/PYlYABlV+EkSA collected $0.60 from pot
B7VAFAMs/PYlYABlV+EkSA: doesn't show hand 
*** SUMMARY ***
Total pot $0.60 | Rake $0 
Seat 1: zDrucyjVn5aeekNEc3cJrA (small blind) folded before Flop
Seat 2: uQwmfH5LEVA5eyghJdyPUg (big blind) folded before Flop
Seat 4: 6NLAWFPZZfqlVkY8n9RULA folded before Flop (didn't bet)
Seat 5: B7VAFAMs/PYlYABlV+EkSA collected ($0.60)
Seat 6: mUoFJKqCzIUABvOFbiINlQ folded before Flop (didn't bet)
Seat 7: yQc5nLaNmByxI15Jegu61w folded before Flop (didn't bet)
Seat 8: LMd3gq2uNfbWTfXTnSeQRw folded before Flop (didn't bet)
Seat 9: dN5zq7QdZCUe7NZFM6cECg (button) folded before Flop (didn't bet)




PokerStars Game #59941816356:  Hold'em No Limit ($0.10/$0.25) - 2009/07/01 1:47:04 ET
Table 'VQNfcI8vTBCTvRfd3veTLQ' 6-max Seat #5 is the button
Seat 1: QiL+lEgEWwy21jk/ltaRLg ($13.85 in chips) 
Seat 2: 79ID/ub1Pt/mDpCprVmOoA ($30.55 in chips) 
Seat 3: LtASJ9OlkqGrrUKGQlpGAw ($11.25 in chips) 
Seat 4: QIWnfLSqfMcoFfdDe5LZPg ($38.90 in chips) 
Seat 5: gX2vbKwS/8zZPENAWB7hxQ ($27.65 in chips) 
Seat 6: LJI7A1YgDM7hgh7o56+ReQ ($27.45 in chips) 
LJI7A1YgDM7hgh7o56+ReQ: posts small blind $0.10
QiL+lEgEWwy21jk/ltaRLg: posts big blind $0.25
*** HOLE CARDS ***
79ID/ub1Pt/mDpCprVmOoA: raises $0.50 to $0.75
LtASJ9OlkqGrrUKGQlpGAw: folds 
QIWnfLSqfMcoFfdDe5LZPg: calls $0.75
gX2vbKwS/8zZPENAWB7hxQ: folds 
LJI7A1YgDM7hgh7o56+ReQ: folds 
QiL+lEgEWwy21jk/ltaRLg: folds 
*** FLOP *** [Qs 9h Qd]
79ID/ub1Pt/mDpCprVmOoA: bets $1.50
QIWnfLSqfMcoFfdDe5LZPg: folds 
Uncalled bet ($1.50) returned to 79ID/ub1Pt/mDpCprVmOoA
79ID/ub1Pt/mDpCprVmOoA collected $1.80 from pot
79ID/ub1Pt/mDpCprVmOoA: doesn't show hand 
*** SUMMARY ***
Total pot $1.85 | Rake $0.05 
Board [Qs 9h Qd]
Seat 1: QiL+lEgEWwy21jk/ltaRLg (big blind) folded before Flop
Seat 2: 79ID/ub1Pt/mDpCprVmOoA collected ($1.80)
Seat 3: LtASJ9OlkqGrrUKGQlpGAw folded before Flop (didn't bet)
Seat 4: QIWnfLSqfMcoFfdDe5LZPg folded on the Flop
Seat 5: gX2vbKwS/8zZPENAWB7hxQ (button) folded before Flop (didn't bet)
Seat 6: LJI7A1YgDM7hgh7o56+ReQ (small blind) folded before Flop




PokerStars Game #59941816614:  Hold'em No Limit ($0.10/$0.25) - 2009/07/01 1:47:04 ET
Table 'AchTjdLS1zBUbH3ZIx6f0w' 6-max Seat #2 is the button
Seat 1: rZ0bUtoerhFGDUSRQMnFog ($29.95 in chips) 
Seat 2: kG34n23qFQA3nzdOJTQ1dA ($65.90 in chips) 
Seat 3: k9vn40MOqqb+xF+7GZ6v2g ($30 in chips) 
Seat 4: q6WfTUAD9mowIP63ASq2Dg ($30.55 in chips) 
Seat 5: 0av6tRNdi0Ui4f15L7gsVg ($24.25 in chips) 
Seat 6: epAUIB7h2FJXzUPRIvSkRA ($25.35 in chips) 
k9vn40MOqqb+xF+7GZ6v2g: posts small blind $0.10
q6WfTUAD9mowIP63ASq2Dg: posts big blind $0.25
*** HOLE CARDS ***
0av6tRNdi0Ui4f15L7gsVg: folds 
epAUIB7h2FJXzUPRIvSkRA: folds 
rZ0bUtoerhFGDUSRQMnFog: folds 
kG34n23qFQA3nzdOJTQ1dA: folds 
k9vn40MOqqb+xF+7GZ6v2g: raises $0.75 to $1
q6WfTUAD9mowIP63ASq2Dg: calls $0.75
*** FLOP *** [4s 5h 8d]
k9vn40MOqqb+xF+7GZ6v2g: checks 
q6WfTUAD9mowIP63ASq2Dg: bets $1
k9vn40MOqqb+xF+7GZ6v2g: folds 
Uncalled bet ($1) returned to q6WfTUAD9mowIP63ASq2Dg
q6WfTUAD9mowIP63ASq2Dg collected $1.90 from pot
*** SUMMARY ***
Total pot $2 | Rake $0.10 
Board [4s 5h 8d]
Seat 1: rZ0bUtoerhFGDUSRQMnFog folded before Flop (didn't bet)
Seat 2: kG34n23qFQA3nzdOJTQ1dA (button) folded before Flop (didn't bet)
Seat 3: k9vn40MOqqb+xF+7GZ6v2g (small blind) folded on the Flop
Seat 4: q6WfTUAD9mowIP63ASq2Dg (big blind) collected ($1.90)
Seat 5: 0av6tRNdi0Ui4f15L7gsVg folded before Flop (didn't bet)
Seat 6: epAUIB7h2FJXzUPRIvSkRA folded before Flop (didn't bet)




PokerStars Game #59941816894:  Hold'em No Limit ($0.10/$0.25) - 2009/07/01 1:47:05 ET
Table 'nc6OeGk/wtaWV+6N+kgnZQ' 6-max Seat #1 is the button
Seat 1: tSR4329m40dZsN7YOpI9Kw ($36.90 in chips) 
Seat 2: 8ClCHtFXGNplITm+63KB+Q ($38.05 in chips) 
Seat 3: y8wpMWGSX2zHZijurx21mg ($4.35 in chips) 
Seat 4: 3zD3qLXT1bEffAoWGnc7wg ($31.55 in chips) 
Seat 5: HCS0lMAAPmZE2Tl8J/SuKw ($9.85 in chips) 
Seat 6: mFv3iBCtrw9XfCDRB0d46Q ($3.80 in chips) 
8ClCHtFXGNplITm+63KB+Q: posts small blind $0.10
y8wpMWGSX2zHZijurx21mg: posts big blind $0.25
*** HOLE CARDS ***
3zD3qLXT1bEffAoWGnc7wg: raises $0.50 to $0.75
HCS0lMAAPmZE2Tl8J/SuKw: folds 
mFv3iBCtrw9XfCDRB0d46Q: folds 
tSR4329m40dZsN7YOpI9Kw has timed out
tSR4329m40dZsN7YOpI9Kw: folds 
tSR4329m40dZsN7YOpI9Kw is sitting out
8ClCHtFXGNplITm+63KB+Q: folds 
y8wpMWGSX2zHZijurx21mg: folds 
Uncalled bet ($0.50) returned to 3zD3qLXT1bEffAoWGnc7wg
3zD3qLXT1bEffAoWGnc7wg collected $0.60 from pot
3zD3qLXT1bEffAoWGnc7wg: doesn't show hand 
*** SUMMARY ***
Total pot $0.60 | Rake $0 
Seat 1: tSR4329m40dZsN7YOpI9Kw (button) folded before Flop (didn't bet)
Seat 2: 8ClCHtFXGNplITm+63KB+Q (small blind) folded before Flop
Seat 3: y8wpMWGSX2zHZijurx21mg (big blind) folded before Flop
Seat 4: 3zD3qLXT1bEffAoWGnc7wg collected ($0.60)
Seat 5: HCS0lMAAPmZE2Tl8J/SuKw folded before Flop (didn't bet)
Seat 6: mFv3iBCtrw9XfCDRB0d46Q folded before Flop (didn't bet)




PokerStars Game #59941817000:  Hold'em No Limit ($0.10/$0.25) - 2009/07/01 1:47:05 ET
Table '63uh7ZsO7Tnt+E8b/2bu3A' 6-max Seat #4 is the button
Seat 1: 0av6tRNdi0Ui4f15L7gsVg ($30.20 in chips) 
Seat 2: SFmT9ZsVopnukjvAzrxTRg ($30.30 in chips) 
Seat 3: yVP7GLZBzx47OPi6jzUxMw ($7.35 in chips) 
Seat 4: rnpAao581IcvQglpkpnkoQ ($11.25 in chips) 
Seat 5: GbCVUNssQ7mqsPWr7J4d3w ($5 in chips) 
Seat 6: qGHGf/553gQnDoklMRe3tg ($29.50 in chips) 
GbCVUNssQ7mqsPWr7J4d3w: posts small blind $0.10
qGHGf/553gQnDoklMRe3tg: posts big blind $0.25
*** HOLE CARDS ***
0av6tRNdi0Ui4f15L7gsVg: folds 
SFmT9ZsVopnukjvAzrxTRg: folds 
yVP7GLZBzx47OPi6jzUxMw: raises $0.50 to $0.75
rnpAao581IcvQglpkpnkoQ: folds 
GbCVUNssQ7mqsPWr7J4d3w: raises $1.25 to $2
qGHGf/553gQnDoklMRe3tg: folds 
yVP7GLZBzx47OPi6jzUxMw: calls $1.25
*** FLOP *** [2s 9c 4h]
GbCVUNssQ7mqsPWr7J4d3w: bets $3 and is all-in
yVP7GLZBzx47OPi6jzUxMw: calls $3
*** TURN *** [2s 9c 4h] [Ks]
*** RIVER *** [2s 9c 4h Ks] [5h]
*** SHOW DOWN ***
GbCVUNssQ7mqsPWr7J4d3w: shows [Ts Td] (a pair of Tens)
yVP7GLZBzx47OPi6jzUxMw: mucks hand 
GbCVUNssQ7mqsPWr7J4d3w collected $9.75 from pot
*** SUMMARY ***
Total pot $10.25 | Rake $0.50 
Board [2s 9c 4h Ks 5h]
Seat 1: 0av6tRNdi0Ui4f15L7gsVg folded before Flop (didn't bet)
Seat 2: SFmT9ZsVopnukjvAzrxTRg folded before Flop (didn't bet)
Seat 3: yVP7GLZBzx47OPi6jzUxMw mucked
Seat 4: rnpAao581IcvQglpkpnkoQ (button) folded before Flop (didn't bet)
Seat 5: GbCVUNssQ7mqsPWr7J4d3w (small blind) showed [Ts Td] and won ($9.75) with a pair of Tens
Seat 6: qGHGf/553gQnDoklMRe3tg (big blind) folded before Flop




PokerStars Game #59941817012:  Hold'em No Limit ($0.10/$0.25) - 2009/07/01 1:47:05 ET
Table '2vH5RcmkT0F4XNS/EmmyMA' 6-max Seat #1 is the button
Seat 1: hOaWAImn5/MZDAWAPlYHCw ($8.10 in chips) 
Seat 2: W6Y6au0wf7gRAlqJYgOezw ($11.60 in chips) 
Seat 3: t8P79jKZYh/Wpx2V73pSqg ($30.35 in chips) 
Seat 4: FC6tJ9EOiutXO8hnpR4VgQ ($5.65 in chips) 
Seat 5: Hsvkc0/G2VV78oVmWYXecw ($5.15 in chips) 
Seat 6: if4dh6jhJXeN3/qd3qCp9g ($25 in chips) 
W6Y6au0wf7gRAlqJYgOezw: posts small blind $0.10
t8P79jKZYh/Wpx2V73pSqg: posts big blind $0.25
*** HOLE CARDS ***
FC6tJ9EOiutXO8hnpR4VgQ: raises $0.50 to $0.75
Hsvkc0/G2VV78oVmWYXecw: folds 
if4dh6jhJXeN3/qd3qCp9g: folds 
hOaWAImn5/MZDAWAPlYHCw: folds 
W6Y6au0wf7gRAlqJYgOezw: folds 
t8P79jKZYh/Wpx2V73pSqg: raises $1.25 to $2
FC6tJ9EOiutXO8hnpR4VgQ: raises $1.50 to $3.50
t8P79jKZYh/Wpx2V73pSqg: calls $1.50
*** FLOP *** [6h 6s 9h]
t8P79jKZYh/Wpx2V73pSqg: bets $2.25
FC6tJ9EOiutXO8hnpR4VgQ said, "AA"
FC6tJ9EOiutXO8hnpR4VgQ: calls $2.15 and is all-in
Uncalled bet ($0.10) returned to t8P79jKZYh/Wpx2V73pSqg
*** TURN *** [6h 6s 9h] [5c]
*** RIVER *** [6h 6s 9h 5c] [8c]
*** SHOW DOWN ***
t8P79jKZYh/Wpx2V73pSqg: shows [As Kh] (a pair of Sixes)
FC6tJ9EOiutXO8hnpR4VgQ: shows [Ac Ad] (two pair, Aces and Sixes)
FC6tJ9EOiutXO8hnpR4VgQ collected $10.85 from pot
*** SUMMARY ***
Total pot $11.40 | Rake $0.55 
Board [6h 6s 9h 5c 8c]
Seat 1: hOaWAImn5/MZDAWAPlYHCw (button) folded before Flop (didn't bet)
Seat 2: W6Y6au0wf7gRAlqJYgOezw (small blind) folded before Flop
Seat 3: t8P79jKZYh/Wpx2V73pSqg (big blind) showed [As Kh] and lost with a pair of Sixes
Seat 4: FC6tJ9EOiutXO8hnpR4VgQ showed [Ac Ad] and won ($10.85) with two pair, Aces and Sixes
Seat 5: Hsvkc0/G2VV78oVmWYXecw folded before Flop (didn't bet)
Seat 6: if4dh6jhJXeN3/qd3qCp9g folded before Flop (didn't bet)




PokerStars Game #59941817024:  Hold'em No Limit ($0.10/$0.25) - 2009/07/01 1:47:05 ET
Table 'BabJGL6tfXQp3leBGbYe8A' 9-max Seat #4 is the button
Seat 1: qwr38jl5txoR36M7G5qi4A ($10 in chips) 
Seat 2: dtZ84flFEi4Q+SGrHMJRDQ ($40.50 in chips) 
Seat 3: sD+TKtt36XiiN6jqHiLwDA ($28.80 in chips) 
Seat 4: gehe91e0IyVT0QU/XBkEyg ($28.10 in chips) 
Seat 5: GrNTWMdwy+jC6Lred1eDng ($9.75 in chips) 
Seat 6: egvg3mTBBVzMHnJPIQiKcA ($13.90 in chips) 
Seat 7: eK8qa6EPcH2zhtbmWSvc9g ($27.85 in chips) 
Seat 8: OXPkK84/qv92EMwXPiG5rQ ($9.75 in chips) 
Seat 9: P+9ymZQ3ktpQu1bn7HIjew ($9.50 in chips) 
GrNTWMdwy+jC6Lred1eDng: posts small blind $0.10
egvg3mTBBVzMHnJPIQiKcA: posts big blind $0.25
*** HOLE CARDS ***
eK8qa6EPcH2zhtbmWSvc9g: folds 
GrNTWMdwy+jC6Lred1eDng said, "crap jokerstars"
OXPkK84/qv92EMwXPiG5rQ: folds 
P+9ymZQ3ktpQu1bn7HIjew: folds 
qwr38jl5txoR36M7G5qi4A: folds 
dtZ84flFEi4Q+SGrHMJRDQ: folds 
sD+TKtt36XiiN6jqHiLwDA: folds 
gehe91e0IyVT0QU/XBkEyg: folds 
GrNTWMdwy+jC6Lred1eDng: calls $0.15
egvg3mTBBVzMHnJPIQiKcA: checks 
*** FLOP *** [8c Jh Jc]
GrNTWMdwy+jC6Lred1eDng: bets $1
egvg3mTBBVzMHnJPIQiKcA: folds 
Uncalled bet ($1) returned to GrNTWMdwy+jC6Lred1eDng
GrNTWMdwy+jC6Lred1eDng collected $0.50 from pot
*** SUMMARY ***
Total pot $0.50 | Rake $0 
Board [8c Jh Jc]
Seat 1: qwr38jl5txoR36M7G5qi4A folded before Flop (didn't bet)
Seat 2: dtZ84flFEi4Q+SGrHMJRDQ folded before Flop (didn't bet)
Seat 3: sD+TKtt36XiiN6jqHiLwDA folded before Flop (didn't bet)
Seat 4: gehe91e0IyVT0QU/XBkEyg (button) folded before Flop (didn't bet)
Seat 5: GrNTWMdwy+jC6Lred1eDng (small blind) collected ($0.50)
Seat 6: egvg3mTBBVzMHnJPIQiKcA (big blind) folded on the Flop
Seat 7: eK8qa6EPcH2zhtbmWSvc9g folded before Flop (didn't bet)
Seat 8: OXPkK84/qv92EMwXPiG5rQ folded before Flop (didn't bet)
Seat 9: P+9ymZQ3ktpQu1bn7HIjew folded before Flop (didn't bet)




PokerStars Game #59941816792:  Hold'em No Limit ($0.10/$0.25) - 2009/07/01 1:47:05 ET
Table '3lL16FBjWXTx3AjK5lMRww' 9-max Seat #2 is the button
Seat 1: fDGyaQz0cs2s4FOYxkbIHA ($16.55 in chips) 
Seat 2: c/9X4zftzphFxYtxp5kp9w ($21.55 in chips) 
Seat 3: QEbIGci+itdw+re8RM5fZA ($27.20 in chips) 
Seat 4: Z3a37Ry74FVl+CBZtAONiA ($7.05 in chips) 
Seat 5: M/9j4wkHH9i1JM51vgi1VA ($37.30 in chips) 
Seat 6: zUXhymECc2C9W9ZNw6qppA ($9.15 in chips) 
Seat 7: 6RiVTYll/5D8zICp0MRpKw ($24.95 in chips) 
Seat 8: ljemhp25Zg+nlA9DLCIiUw ($25 in chips) 
Seat 9: 00Ybni1cxfHtqmdWwh31Xg ($10.30 in chips) 
QEbIGci+itdw+re8RM5fZA: posts small blind $0.10
Z3a37Ry74FVl+CBZtAONiA: posts big blind $0.25
*** HOLE CARDS ***
M/9j4wkHH9i1JM51vgi1VA: folds 
zUXhymECc2C9W9ZNw6qppA is disconnected 
zUXhymECc2C9W9ZNw6qppA is connected 
zUXhymECc2C9W9ZNw6qppA: folds 
6RiVTYll/5D8zICp0MRpKw: folds 
ljemhp25Zg+nlA9DLCIiUw: calls $0.25
00Ybni1cxfHtqmdWwh31Xg: folds 
fDGyaQz0cs2s4FOYxkbIHA: folds 
c/9X4zftzphFxYtxp5kp9w: folds 
QEbIGci+itdw+re8RM5fZA: folds 
Z3a37Ry74FVl+CBZtAONiA: checks 
*** FLOP *** [6s Qh 8s]
Z3a37Ry74FVl+CBZtAONiA: bets $0.50
ljemhp25Zg+nlA9DLCIiUw: folds 
Uncalled bet ($0.50) returned to Z3a37Ry74FVl+CBZtAONiA
Z3a37Ry74FVl+CBZtAONiA collected $0.60 from pot
Z3a37Ry74FVl+CBZtAONiA: doesn't show hand 
*** SUMMARY ***
Total pot $0.60 | Rake $0 
Board [6s Qh 8s]
Seat 1: fDGyaQz0cs2s4FOYxkbIHA folded before Flop (didn't bet)
Seat 2: c/9X4zftzphFxYtxp5kp9w (button) folded before Flop (didn't bet)
Seat 3: QEbIGci+itdw+re8RM5fZA (small blind) folded before Flop
Seat 4: Z3a37Ry74FVl+CBZtAONiA (big blind) collected ($0.60)
Seat 5: M/9j4wkHH9i1JM51vgi1VA folded before Flop (didn't bet)
Seat 6: zUXhymECc2C9W9ZNw6qppA folded before Flop (didn't bet)
Seat 7: 6RiVTYll/5D8zICp0MRpKw folded before Flop (didn't bet)
Seat 8: ljemhp25Zg+nlA9DLCIiUw folded on the Flop
Seat 9: 00Ybni1cxfHtqmdWwh31Xg folded before Flop (didn't bet)




PokerStars Game #59941817752:  Hold'em No Limit ($0.10/$0.25) - 2009/07/01 1:47:06 ET
Table 'r562aMIMs5kgo28FEU6lkA' 9-max Seat #7 is the button
Seat 1: H5Se03ZqSX7tbULXur2MAg ($14.80 in chips) 
Seat 2: N8muFAHrFHW6elSMGuyVLQ ($25.35 in chips) 
Seat 3: xoBFd/5k+L/pFn9VW1VyWg ($10.10 in chips) 
Seat 4: V6p0jQ/RhUsqpHLmXvEX4Q ($19.75 in chips) 
Seat 5: zDrucyjVn5aeekNEc3cJrA ($34.85 in chips) 
Seat 6: RCqMONFrSPSArZh2Jsar/w ($20 in chips) 
Seat 7: Bb42QRQMhg5/Y0vHP8/2Xw ($25 in chips) 
Seat 8: B6xHiX1SJkS0CUNCKDVwuQ ($21 in chips) 
Seat 9: yyG4svzOpC1A+sUP/scg6w ($7.50 in chips) 
B6xHiX1SJkS0CUNCKDVwuQ: posts small blind $0.10
yyG4svzOpC1A+sUP/scg6w: posts big blind $0.25
zDrucyjVn5aeekNEc3cJrA: posts small & big blinds $0.35
*** HOLE CARDS ***
H5Se03ZqSX7tbULXur2MAg: folds 
N8muFAHrFHW6elSMGuyVLQ: folds 
xoBFd/5k+L/pFn9VW1VyWg: folds 
V6p0jQ/RhUsqpHLmXvEX4Q: folds 
zDrucyjVn5aeekNEc3cJrA: checks 
RCqMONFrSPSArZh2Jsar/w: folds 
Bb42QRQMhg5/Y0vHP8/2Xw: folds 
B6xHiX1SJkS0CUNCKDVwuQ: folds 
yyG4svzOpC1A+sUP/scg6w: checks 
*** FLOP *** [6c 6s Qh]
yyG4svzOpC1A+sUP/scg6w: checks 
zDrucyjVn5aeekNEc3cJrA: checks 
*** TURN *** [6c 6s Qh] [5c]
yyG4svzOpC1A+sUP/scg6w: checks 
zDrucyjVn5aeekNEc3cJrA: checks 
*** RIVER *** [6c 6s Qh 5c] [Ad]
yyG4svzOpC1A+sUP/scg6w: checks 
zDrucyjVn5aeekNEc3cJrA: checks 
*** SHOW DOWN ***
yyG4svzOpC1A+sUP/scg6w: shows [4d 9c] (a pair of Sixes)
zDrucyjVn5aeekNEc3cJrA: shows [Qs 7h] (two pair, Queens and Sixes)
zDrucyjVn5aeekNEc3cJrA collected $0.70 from pot
*** SUMMARY ***
Total pot $0.70 | Rake $0 
Board [6c 6s Qh 5c Ad]
Seat 1: H5Se03ZqSX7tbULXur2MAg folded before Flop (didn't bet)
Seat 2: N8muFAHrFHW6elSMGuyVLQ folded before Flop (didn't bet)
Seat 3: xoBFd/5k+L/pFn9VW1VyWg folded before Flop (didn't bet)
Seat 4: V6p0jQ/RhUsqpHLmXvEX4Q folded before Flop (didn't bet)
Seat 5: zDrucyjVn5aeekNEc3cJrA showed [Qs 7h] and won ($0.70) with two pair, Queens and Sixes
Seat 6: RCqMONFrSPSArZh2Jsar/w folded before Flop (didn't bet)
Seat 7: Bb42QRQMhg5/Y0vHP8/2Xw (button) folded before Flop (didn't bet)
Seat 8: B6xHiX1SJkS0CUNCKDVwuQ (small blind) folded before Flop
Seat 9: yyG4svzOpC1A+sUP/scg6w (big blind) showed [4d 9c] and lost with a pair of Sixes




PokerStars Game #59941817486:  Hold'em No Limit ($0.10/$0.25) - 2009/07/01 1:47:06 ET
Table '0mmHveGuaIfIMQlNE1eqMg' 9-max Seat #9 is the button
Seat 1: ydoFOVgzvZv9ZhuWu9rXAw ($5 in chips) 
Seat 2: rQhYIYXSyH/IivYM1dlV5A ($68.85 in chips) 
Seat 3: ghNKXUBl/H+t83JF079ZBA ($25 in chips) 
Seat 4: DnDcAdn9P0zGovMERigpFA ($36.10 in chips) 
Seat 5: Pt637jKksB5MzP0UNJAAkw ($9.20 in chips) 
Seat 6: 6RiVTYll/5D8zICp0MRpKw ($23.70 in chips) 
Seat 7: 5n7e7I+px7c6CQmLpPbtsg ($5.75 in chips) 
Seat 8: 0XACOSNrAWmqNv9k1nF8rw ($14.65 in chips) 
Seat 9: UNw/UrAelsQeSS17Rro/BA ($10.90 in chips) 
ydoFOVgzvZv9ZhuWu9rXAw: posts small blind $0.10
rQhYIYXSyH/IivYM1dlV5A: posts big blind $0.25
*** HOLE CARDS ***
ghNKXUBl/H+t83JF079ZBA: folds 
DnDcAdn9P0zGovMERigpFA: folds 
Pt637jKksB5MzP0UNJAAkw: raises $0.50 to $0.75
6RiVTYll/5D8zICp0MRpKw: folds 
5n7e7I+px7c6CQmLpPbtsg: raises $1.50 to $2.25
0XACOSNrAWmqNv9k1nF8rw: folds 
UNw/UrAelsQeSS17Rro/BA: folds 
ydoFOVgzvZv9ZhuWu9rXAw: folds 
rQhYIYXSyH/IivYM1dlV5A: folds 
Pt637jKksB5MzP0UNJAAkw: raises $6 to $8.25
5n7e7I+px7c6CQmLpPbtsg: calls $3.50 and is all-in
Uncalled bet ($2.50) returned to Pt637jKksB5MzP0UNJAAkw
*** FLOP *** [4h Kh Kd]
*** TURN *** [4h Kh Kd] [Js]
*** RIVER *** [4h Kh Kd Js] [8c]
*** SHOW DOWN ***
Pt637jKksB5MzP0UNJAAkw: shows [As 5s] (a pair of Kings)
5n7e7I+px7c6CQmLpPbtsg: shows [Qd Qc] (two pair, Kings and Queens)
5n7e7I+px7c6CQmLpPbtsg collected $11.30 from pot
*** SUMMARY ***
Total pot $11.85 | Rake $0.55 
Board [4h Kh Kd Js 8c]
Seat 1: ydoFOVgzvZv9ZhuWu9rXAw (small blind) folded before Flop
Seat 2: rQhYIYXSyH/IivYM1dlV5A (big blind) folded before Flop
Seat 3: ghNKXUBl/H+t83JF079ZBA folded before Flop (didn't bet)
Seat 4: DnDcAdn9P0zGovMERigpFA folded before Flop (didn't bet)
Seat 5: Pt637jKksB5MzP0UNJAAkw showed [As 5s] and lost with a pair of Kings
Seat 6: 6RiVTYll/5D8zICp0MRpKw folded before Flop (didn't bet)
Seat 7: 5n7e7I+px7c6CQmLpPbtsg showed [Qd Qc] and won ($11.30) with two pair, Kings and Queens
Seat 8: 0XACOSNrAWmqNv9k1nF8rw folded before Flop (didn't bet)
Seat 9: UNw/UrAelsQeSS17Rro/BA (button) folded before Flop (didn't bet)




PokerStars Game #59941817694:  Hold'em No Limit ($0.10/$0.25) - 2009/07/01 1:47:06 ET
Table 'sSe6q4YTb/iS19t2eCFdsA' 9-max Seat #6 is the button
Seat 1: hJ4uYjNmSZdjrKA8cjZqCA ($18.75 in chips) 
Seat 2: 3l+i+xMeyDndSXMF2A5CDA ($6.25 in chips) 
Seat 3: OXPkK84/qv92EMwXPiG5rQ ($9.75 in chips) 
Seat 4: 22dIObOuor/A+IKWkNoAlA ($8.50 in chips) 
Seat 5: qS+jfnNoG75bT+uQ8CKhQA ($9.70 in chips) 
Seat 6: tYsOBqdU1+x+yFI7zHO7hQ ($27 in chips) 
Seat 7: t70KGeRtR3naHSqKDixsUg ($4.30 in chips) 
Seat 8: hvXZ0zFPZFP8Hf6dS36YEw ($16 in chips) 
Seat 9: Z9W7+g1WMhhZDi7DwGbCFA ($5 in chips) 
t70KGeRtR3naHSqKDixsUg: posts small blind $0.10
hvXZ0zFPZFP8Hf6dS36YEw: posts big blind $0.25
*** HOLE CARDS ***
Z9W7+g1WMhhZDi7DwGbCFA: calls $0.25
hJ4uYjNmSZdjrKA8cjZqCA: folds 
3l+i+xMeyDndSXMF2A5CDA: folds 
OXPkK84/qv92EMwXPiG5rQ: folds 
22dIObOuor/A+IKWkNoAlA: raises $1 to $1.25
qS+jfnNoG75bT+uQ8CKhQA: folds 
tYsOBqdU1+x+yFI7zHO7hQ: folds 
t70KGeRtR3naHSqKDixsUg: folds 
hvXZ0zFPZFP8Hf6dS36YEw: folds 
Z9W7+g1WMhhZDi7DwGbCFA: folds 
Uncalled bet ($1) returned to 22dIObOuor/A+IKWkNoAlA
22dIObOuor/A+IKWkNoAlA collected $0.85 from pot
22dIObOuor/A+IKWkNoAlA: doesn't show hand 
*** SUMMARY ***
Total pot $0.85 | Rake $0 
Seat 1: hJ4uYjNmSZdjrKA8cjZqCA folded before Flop (didn't bet)
Seat 2: 3l+i+xMeyDndSXMF2A5CDA folded before Flop (didn't bet)
Seat 3: OXPkK84/qv92EMwXPiG5rQ folded before Flop (didn't bet)
Seat 4: 22dIObOuor/A+IKWkNoAlA collected ($0.85)
Seat 5: qS+jfnNoG75bT+uQ8CKhQA folded before Flop (didn't bet)
Seat 6: tYsOBqdU1+x+yFI7zHO7hQ (button) folded before Flop (didn't bet)
Seat 7: t70KGeRtR3naHSqKDixsUg (small blind) folded before Flop
Seat 8: hvXZ0zFPZFP8Hf6dS36YEw (big blind) folded before Flop
Seat 9: Z9W7+g1WMhhZDi7DwGbCFA folded before Flop




PokerStars Game #59941817472:  Hold'em No Limit ($0.10/$0.25) - 2009/07/01 1:47:06 ET
Table 'zKwHJD0cmKNUure9qQTfFg' 6-max Seat #2 is the button
Seat 1: Hzrn9DZJegEZICufTNYkrg ($19.10 in chips) 
Seat 2: xrf8tAXKQHG99HixCot1Iw ($25 in chips) 
Seat 3: m9aw7LBAB5YX2ZqMtMkhqA ($14.35 in chips) 
Seat 4: v+QfkGiuj9bgtuNoVnDO8w ($25.45 in chips) 
Seat 6: edio/rLJ06xeZOfLhoL3UA ($9.25 in chips) 
m9aw7LBAB5YX2ZqMtMkhqA: posts small blind $0.10
v+QfkGiuj9bgtuNoVnDO8w: posts big blind $0.25
E4AqQ1egsnu0oH2RqsbCmQ: sits out 
*** HOLE CARDS ***
edio/rLJ06xeZOfLhoL3UA: calls $0.25
Hzrn9DZJegEZICufTNYkrg: folds 
xrf8tAXKQHG99HixCot1Iw: folds 
m9aw7LBAB5YX2ZqMtMkhqA: folds 
v+QfkGiuj9bgtuNoVnDO8w: checks 
*** FLOP *** [Ks 9h Ad]
v+QfkGiuj9bgtuNoVnDO8w: checks 
edio/rLJ06xeZOfLhoL3UA: bets $0.75
v+QfkGiuj9bgtuNoVnDO8w: folds 
Uncalled bet ($0.75) returned to edio/rLJ06xeZOfLhoL3UA
edio/rLJ06xeZOfLhoL3UA collected $0.60 from pot
edio/rLJ06xeZOfLhoL3UA: doesn't show hand 
*** SUMMARY ***
Total pot $0.60 | Rake $0 
Board [Ks 9h Ad]
Seat 1: Hzrn9DZJegEZICufTNYkrg folded before Flop (didn't bet)
Seat 2: xrf8tAXKQHG99HixCot1Iw (button) folded before Flop (didn't bet)
Seat 3: m9aw7LBAB5YX2ZqMtMkhqA (small blind) folded before Flop
Seat 4: v+QfkGiuj9bgtuNoVnDO8w (big blind) folded on the Flop
Seat 6: edio/rLJ06xeZOfLhoL3UA collected ($0.60)




PokerStars Game #59941817626:  Hold'em No Limit ($0.10/$0.25) - 2009/07/01 1:47:06 ET
Table 'FE/j6VqBY4j9Uq+VHURQCQ' 6-max Seat #4 is the button
Seat 1: ypmjhffk/YHGc51wgVXUTw ($41.75 in chips) 
Seat 2: 3zD3qLXT1bEffAoWGnc7wg ($37.10 in chips) 
Seat 3: lBoEwOFgzcERLIRUkUoRTw ($27 in chips) 
Seat 4: 7JyPCA0J2grhXQYxe1h3+A ($7 in chips) 
bJFzs6QmEEnz4miMfSDtcg will be allowed to play after the button
ypmjhffk/YHGc51wgVXUTw: posts small blind $0.10
3zD3qLXT1bEffAoWGnc7wg: posts big blind $0.25
*** HOLE CARDS ***
lBoEwOFgzcERLIRUkUoRTw: folds 
Q1uciOZPBR/WkAlqa6cL4A joins the table at seat #6 
7JyPCA0J2grhXQYxe1h3+A: raises $0.75 to $1
ypmjhffk/YHGc51wgVXUTw: folds 
3zD3qLXT1bEffAoWGnc7wg: folds 
Uncalled bet ($0.75) returned to 7JyPCA0J2grhXQYxe1h3+A
7JyPCA0J2grhXQYxe1h3+A collected $0.60 from pot
7JyPCA0J2grhXQYxe1h3+A: doesn't show hand 
*** SUMMARY ***
Total pot $0.60 | Rake $0 
Seat 1: ypmjhffk/YHGc51wgVXUTw (small blind) folded before Flop
Seat 2: 3zD3qLXT1bEffAoWGnc7wg (big blind) folded before Flop
Seat 3: lBoEwOFgzcERLIRUkUoRTw folded before Flop (didn't bet)
Seat 4: 7JyPCA0J2grhXQYxe1h3+A (button) collected ($0.60)




PokerStars Game #59941817500:  Hold'em No Limit ($0.10/$0.25) - 2009/07/01 1:47:06 ET
Table 'S6s+TmTlAjLHclBRvN5/fw' 9-max Seat #4 is the button
Seat 2: lQXp8ud1KwKUS+00XK0YEQ ($5 in chips) 
Seat 3: z2SmIaQ3+5n/eY1BN5HgPg ($7.60 in chips) 
Seat 4: RSal7+azPhXeqQO5L8XPfg ($14.55 in chips) 
Seat 5: 8hSJOE8UscCqt6t47gp0/g ($6.50 in chips) 
8hSJOE8UscCqt6t47gp0/g: posts small blind $0.10
lQXp8ud1KwKUS+00XK0YEQ: posts big blind $0.25
*** HOLE CARDS ***
kockar222 joins the table at seat #6 
z2SmIaQ3+5n/eY1BN5HgPg: raises $0.50 to $0.75
RSal7+azPhXeqQO5L8XPfg: calls $0.75
8hSJOE8UscCqt6t47gp0/g: folds 
lQXp8ud1KwKUS+00XK0YEQ: folds 
*** FLOP *** [7h 2c 8h]
z2SmIaQ3+5n/eY1BN5HgPg: checks 
RSal7+azPhXeqQO5L8XPfg: checks 
*** TURN *** [7h 2c 8h] [Ks]
z2SmIaQ3+5n/eY1BN5HgPg: bets $1.50
RSal7+azPhXeqQO5L8XPfg: calls $1.50
*** RIVER *** [7h 2c 8h Ks] [3s]
z2SmIaQ3+5n/eY1BN5HgPg: checks 
RSal7+azPhXeqQO5L8XPfg: checks 
*** SHOW DOWN ***
z2SmIaQ3+5n/eY1BN5HgPg: shows [As 4s] (high card Ace)
RSal7+azPhXeqQO5L8XPfg: shows [7s 9h] (a pair of Sevens)
RSal7+azPhXeqQO5L8XPfg collected $4.65 from pot
*** SUMMARY ***
Total pot $4.85 | Rake $0.20 
Board [7h 2c 8h Ks 3s]
Seat 2: lQXp8ud1KwKUS+00XK0YEQ (big blind) folded before Flop
Seat 3: z2SmIaQ3+5n/eY1BN5HgPg showed [As 4s] and lost with high card Ace
Seat 4: RSal7+azPhXeqQO5L8XPfg (button) showed [7s 9h] and won ($4.65) with a pair of Sevens
Seat 5: 8hSJOE8UscCqt6t47gp0/g (small blind) folded before Flop




PokerStars Game #59941817758:  Hold'em No Limit ($0.10/$0.25) - 2009/07/01 1:47:06 ET
Table 'gZetDqJh6q9A3mLO3ThCsAnc6OeGk/wtaWV+6N+kgnZQSeat #1 is the button
Seat 1: DihMHaz4WNETH1bPDe13kA ($25 in chips) 
Seat 2: JFIAqU8lCZ0vWwEl4bdGsg ($34.95 in chips) 
Seat 3: jp34e617tIzV8tKIWmfAbA ($33.80 in chips) 
Seat 4: BV+K0Phf5VBHr7aZPKqbUQ ($29.35 in chips) 
Seat 5: EKTLAV1bAterT0Mc1G6lBg5hAPbqNrvJb8PtLiceXtlg4.75 in chips) 
Seat 6: Mhj3q7cxev+XjXZxEE6/Cw ($25 in chips) 
JFIAqU8lCZ0vWwEl4bdGsg: posts small blind $0.10
jp34e617tIzV8tKIWmfAbA: posts big blind $0.25
*** HOLE CARDS ***
BV+K0Phf5VBHr7aZPKqbUQ: folds 
EKTLAV1bAterT0Mc1G6lBg5hAPbqNrvJb8PtLiceXtlglds 
Mhj3q7cxev+XjXZxEE6/Cw: folds 
DihMHaz4WNETH1bPDe13kA: folds 
JFIAqU8lCZ0vWwEl4bdGsg: folds 
Uncalled bet ($0.15) returned to jp34e617tIzV8tKIWmfAbA
jp34e617tIzV8tKIWmfAbA collected $0.20 from pot
jp34e617tIzV8tKIWmfAbA: doesn't show hand 
*** SUMMARY ***
Total pot $0.20 | Rake $0 
Seat 1: DihMHaz4WNETH1bPDe13kA (button) folded before Flop (didn't bet)
Seat 2: JFIAqU8lCZ0vWwEl4bdGsg (small blind) folded before Flop
Seat 3: jp34e617tIzV8tKIWmfAbA (big blind) collected ($0.20)
Seat 4: BV+K0Phf5VBHr7aZPKqbUQ folded before Flop (didn't bet)
Seat 5: EKTLAV1bAterT0Mc1G6lBg5hAPbqNrvJb8PtLiceXtlgded before Flop (didn't bet)
Seat 6: Mhj3q7cxev+XjXZxEE6/Cw folded before Flop (didn't bet)




PokerStars Game #59941817554:  Hold'em No Limit ($0.10/$0.25) - 2009/07/01 1:47:06 ET
Table '5SUMWYuPsGiOD0FY0QbgOw' 6-max Seat #1 is the button
Seat 1: SFmT9ZsVopnukjvAzrxTRg ($25 in chips) 
Seat 2: xrf8tAXKQHG99HixCot1Iw ($38.60 in chips) 
Seat 3: MqMK8OWPSY1V4stf1Hy5Jw ($38.45 in chips) 
Seat 4: BV+K0Phf5VBHr7aZPKqbUQ ($25 in chips) 
Seat 5: v+QfkGiuj9bgtuNoVnDO8w ($40.80 in chips) 
Seat 6: jA7YMtfNUnAaebB7Lj74EA ($25.05 in chips) 
xrf8tAXKQHG99HixCot1Iw: posts small blind $0.10
MqMK8OWPSY1V4stf1Hy5Jw: posts big blind $0.25
*** HOLE CARDS ***
BV+K0Phf5VBHr7aZPKqbUQ: folds 
v+QfkGiuj9bgtuNoVnDO8w: folds 
jA7YMtfNUnAaebB7Lj74EA: calls $0.25
SFmT9ZsVopnukjvAzrxTRg: folds 
xrf8tAXKQHG99HixCot1Iw: folds 
MqMK8OWPSY1V4stf1Hy5Jw: checks 
*** FLOP *** [4d 5d Kd]
MqMK8OWPSY1V4stf1Hy5Jw: checks 
jA7YMtfNUnAaebB7Lj74EA: checks 
*** TURN *** [4d 5d Kd] [2c]
MqMK8OWPSY1V4stf1Hy5Jw: checks 
jA7YMtfNUnAaebB7Lj74EA: checks 
*** RIVER *** [4d 5d Kd 2c] [3s]
MqMK8OWPSY1V4stf1Hy5Jw: checks 
jA7YMtfNUnAaebB7Lj74EA: checks 
*** SHOW DOWN ***
MqMK8OWPSY1V4stf1Hy5Jw: shows [8d 6c] (a straight, Deuce to Six)
jA7YMtfNUnAaebB7Lj74EA: mucks hand 
MqMK8OWPSY1V4stf1Hy5Jw collected $0.60 from pot
*** SUMMARY ***
Total pot $0.60 | Rake $0 
Board [4d 5d Kd 2c 3s]
Seat 1: SFmT9ZsVopnukjvAzrxTRg (button) folded before Flop (didn't bet)
Seat 2: xrf8tAXKQHG99HixCot1Iw (small blind) folded before Flop
Seat 3: MqMK8OWPSY1V4stf1Hy5Jw (big blind) showed [8d 6c] and won ($0.60) with a straight, Deuce to Six
Seat 4: BV+K0Phf5VBHr7aZPKqbUQ folded before Flop (didn't bet)
Seat 5: v+QfkGiuj9bgtuNoVnDO8w folded before Flop (didn't bet)
Seat 6: jA7YMtfNUnAaebB7Lj74EA mucked




PokerStars Game #59941817390:  Hold'em No Limit ($0.10/$0.25) - 2009/07/01 1:47:06 ET
Table 'Loy/olZ5qoDOSvX4UTujGg' 6-max Seat #3 is the button
Seat 1: HipgaJhkN4ie/tTw4dK3Ug ($12.55 in chips) 
Seat 2: 4z7mPbMLNp4TezHXin63Vw ($15.30 in chips) 
Seat 3: 32YL2ZEp8NT4JB2RVM9euQ ($15.35 in chips) 
Seat 4: /gJNBeCkWL4o85/jvlZ4BA ($30.85 in chips) 
Seat 5: Ar4vsUIUfJ7gbYh1c1m59g ($14.75 in chips) 
Seat 6: qGHGf/553gQnDoklMRe3tg ($26.15 in chips) 
/gJNBeCkWL4o85/jvlZ4BA: posts small blind $0.10
Ar4vsUIUfJ7gbYh1c1m59g: posts big blind $0.25
*** HOLE CARDS ***
qGHGf/553gQnDoklMRe3tg: raises $0.75 to $1
HipgaJhkN4ie/tTw4dK3Ug: calls $1
4z7mPbMLNp4TezHXin63Vw: folds 
/gJNBeCkWL4o85/jvlZ4BA said, "had u beat"
32YL2ZEp8NT4JB2RVM9euQ: folds 
/gJNBeCkWL4o85/jvlZ4BA: folds 
Ar4vsUIUfJ7gbYh1c1m59g: raises $1.50 to $2.50
qGHGf/553gQnDoklMRe3tg: folds 
HipgaJhkN4ie/tTw4dK3Ug: calls $1.50
*** FLOP *** [6d 2h 7s]
Ar4vsUIUfJ7gbYh1c1m59g: checks 
HipgaJhkN4ie/tTw4dK3Ug: bets $1
Ar4vsUIUfJ7gbYh1c1m59g: raises $3 to $4
HipgaJhkN4ie/tTw4dK3Ug: folds 
Uncalled bet ($3) returned to Ar4vsUIUfJ7gbYh1c1m59g
Ar4vsUIUfJ7gbYh1c1m59g collected $7.75 from pot
Ar4vsUIUfJ7gbYh1c1m59g: doesn't show hand 
*** SUMMARY ***
Total pot $8.10 | Rake $0.35 
Board [6d 2h 7s]
Seat 1: HipgaJhkN4ie/tTw4dK3Ug folded on the Flop
Seat 2: 4z7mPbMLNp4TezHXin63Vw folded before Flop (didn't bet)
Seat 3: 32YL2ZEp8NT4JB2RVM9euQ (button) folded before Flop (didn't bet)
Seat 4: /gJNBeCkWL4o85/jvlZ4BA (small blind) folded before Flop
Seat 5: Ar4vsUIUfJ7gbYh1c1m59g (big blind) collected ($7.75)
Seat 6: qGHGf/553gQnDoklMRe3tg folded before Flop




PokerStars Game #59941817496:  Hold'em No Limit ($0.10/$0.25) - 2009/07/01 1:47:06 ET
Table 'oJpFwZj9+FUGHX90Un8s9Q' 6-max Seat #5 is the button
Seat 1: 6DwBRH+xZ12AAZmeAg+aXw ($23.90 in chips) 
Seat 2: NtrVQ9UIql0rDCnKDKZ5FQ ($15.70 in chips) 
Seat 3: kyRaCIljYA6l33lSKQfNsg ($25.90 in chips) 
Seat 4: 6elpmfyt4Zw0yvd8lePSMQ ($21.55 in chips) 
Seat 5: kG34n23qFQA3nzdOJTQ1dA ($55.45 in chips) 
Seat 6: 7LpHJVeM6k1mQdC6HXYzww ($25.10 in chips) 
7LpHJVeM6k1mQdC6HXYzww: posts small blind $0.10
6DwBRH+xZ12AAZmeAg+aXw: posts big blind $0.25
*** HOLE CARDS ***
NtrVQ9UIql0rDCnKDKZ5FQ: calls $0.25
kyRaCIljYA6l33lSKQfNsg: raises $0.75 to $1
6elpmfyt4Zw0yvd8lePSMQ: calls $1
kG34n23qFQA3nzdOJTQ1dA: folds 
7LpHJVeM6k1mQdC6HXYzww: folds 
6DwBRH+xZ12AAZmeAg+aXw: folds 
NtrVQ9UIql0rDCnKDKZ5FQ: calls $0.75
*** FLOP *** [Td Ks 4h]
NtrVQ9UIql0rDCnKDKZ5FQ: checks 
kyRaCIljYA6l33lSKQfNsg: bets $2
6elpmfyt4Zw0yvd8lePSMQ: folds 
NtrVQ9UIql0rDCnKDKZ5FQ: calls $2
*** TURN *** [Td Ks 4h] [Ah]
NtrVQ9UIql0rDCnKDKZ5FQ: checks 
kyRaCIljYA6l33lSKQfNsg: checks 
*** RIVER *** [Td Ks 4h Ah] [6c]
NtrVQ9UIql0rDCnKDKZ5FQ: checks 
kyRaCIljYA6l33lSKQfNsg: checks 
*** SHOW DOWN ***
NtrVQ9UIql0rDCnKDKZ5FQ: shows [Ac Js] (a pair of Aces)
kyRaCIljYA6l33lSKQfNsg: mucks hand 
NtrVQ9UIql0rDCnKDKZ5FQ collected $7 from pot
*** SUMMARY ***
Total pot $7.35 | Rake $0.35 
Board [Td Ks 4h Ah 6c]
Seat 1: 6DwBRH+xZ12AAZmeAg+aXw (big blind) folded before Flop
Seat 2: NtrVQ9UIql0rDCnKDKZ5FQ showed [Ac Js] and won ($7) with a pair of Aces
Seat 3: kyRaCIljYA6l33lSKQfNsg mucked
Seat 4: 6elpmfyt4Zw0yvd8lePSMQ folded on the Flop
Seat 5: kG34n23qFQA3nzdOJTQ1dA (button) folded before Flop (didn't bet)
Seat 6: 7LpHJVeM6k1mQdC6HXYzww (small blind) folded before Flop




PokerStars Game #59941817414:  Hold'em No Limit ($0.10/$0.25) - 2009/07/01 1:47:06 ET
Table 'tErGGDyESv/0llKumVeZuQ' 9-max Seat #5 is the button
Seat 1: 3PmVnC/15cl4oyI1TKIt4g ($5 in chips) 
Seat 2: pN3IHvAKm2fz+sTRARTcrg ($28.85 in chips) 
Seat 4: yqkowiRWZ6NvRN9UUkYIlA ($5 in chips) 
Seat 5: 6RQUxA3jk+ePxB/+Hc0IKw ($12 in chips) 
Seat 7: uhrboV251dcgYniYTdFIcA ($28.90 in chips) 
Seat 8: clJsV3v77RS07bDKY+705w ($5 in chips) 
Seat 9: d6n762oPkegG086ZJyV5MA ($18.95 in chips) 
uhrboV251dcgYniYTdFIcA: posts small blind $0.10
clJsV3v77RS07bDKY+705w: posts big blind $0.25
qwr38jl5txoR36M7G5qi4A: sits out 
*** HOLE CARDS ***
d6n762oPkegG086ZJyV5MA: calls $0.25
3PmVnC/15cl4oyI1TKIt4g: raises $1 to $1.25
pN3IHvAKm2fz+sTRARTcrg: folds 
yqkowiRWZ6NvRN9UUkYIlA: folds 
6RQUxA3jk+ePxB/+Hc0IKw: calls $1.25
uhrboV251dcgYniYTdFIcA: folds 
clJsV3v77RS07bDKY+705w: folds 
d6n762oPkegG086ZJyV5MA: calls $1
*** FLOP *** [6d 4s 3c]
d6n762oPkegG086ZJyV5MA: checks 
3PmVnC/15cl4oyI1TKIt4g: bets $0.75
6RQUxA3jk+ePxB/+Hc0IKw: calls $0.75
d6n762oPkegG086ZJyV5MA: folds 
*** TURN *** [6d 4s 3c] [3h]
3PmVnC/15cl4oyI1TKIt4g: bets $0.75
6RQUxA3jk+ePxB/+Hc0IKw: raises $1.50 to $2.25
3PmVnC/15cl4oyI1TKIt4g: folds 
Uncalled bet ($1.50) returned to 6RQUxA3jk+ePxB/+Hc0IKw
6RQUxA3jk+ePxB/+Hc0IKw collected $6.80 from pot
*** SUMMARY ***
Total pot $7.10 | Rake $0.30 
Board [6d 4s 3c 3h]
Seat 1: 3PmVnC/15cl4oyI1TKIt4g folded on the Turn
Seat 2: pN3IHvAKm2fz+sTRARTcrg folded before Flop (didn't bet)
Seat 4: yqkowiRWZ6NvRN9UUkYIlA folded before Flop (didn't bet)
Seat 5: 6RQUxA3jk+ePxB/+Hc0IKw (button) collected ($6.80)
Seat 7: uhrboV251dcgYniYTdFIcA (small blind) folded before Flop
Seat 8: clJsV3v77RS07bDKY+705w (big blind) folded before Flop
Seat 9: d6n762oPkegG086ZJyV5MA folded on the Flop




PokerStars Game #59941818336:  Hold'em No Limit ($0.10/$0.25) - 2009/07/01 1:47:07 ET
Table 'UVjmXTtsmlX1HxwwZ59akg' 9-max Seat #9 is the button
Seat 2: q+Qdg0Hoir+SyL7haBrUnw ($7.90 in chips) 
Seat 3: GmzfAfxcxu1kGbPC+9LkVg ($24.65 in chips) 
Seat 4: X78b5v/uhqeXXoAijbw/yg ($25 in chips) 
Seat 5: Bb42QRQMhg5/Y0vHP8/2Xw ($39.95 in chips) 
Seat 6: st9jtdNbm1W5GfBwRaCVqQ ($27.60 in chips) 
Seat 7: d7YasxuGLPiL7pj8IcGThw ($5 in chips) 
Seat 9: ljemhp25Zg+nlA9DLCIiUw ($24.65 in chips) 
zDrucyjVn5aeekNEc3cJrA will be allowed to play after the button
q+Qdg0Hoir+SyL7haBrUnw: posts small blind $0.10
GmzfAfxcxu1kGbPC+9LkVg: posts big blind $0.25
d7YasxuGLPiL7pj8IcGThw: posts big blind $0.25
*** HOLE CARDS ***
X78b5v/uhqeXXoAijbw/yg: folds 
Bb42QRQMhg5/Y0vHP8/2Xw: folds 
st9jtdNbm1W5GfBwRaCVqQ: folds 
d7YasxuGLPiL7pj8IcGThw: checks 
ljemhp25Zg+nlA9DLCIiUw: raises $0.75 to $1
q+Qdg0Hoir+SyL7haBrUnw: folds 
GmzfAfxcxu1kGbPC+9LkVg: folds 
d7YasxuGLPiL7pj8IcGThw: folds 
Uncalled bet ($0.75) returned to ljemhp25Zg+nlA9DLCIiUw
ljemhp25Zg+nlA9DLCIiUw collected $0.85 from pot
ljemhp25Zg+nlA9DLCIiUw: doesn't show hand 
*** SUMMARY ***
Total pot $0.85 | Rake $0 
Seat 2: q+Qdg0Hoir+SyL7haBrUnw (small blind) folded before Flop
Seat 3: GmzfAfxcxu1kGbPC+9LkVg (big blind) folded before Flop
Seat 4: X78b5v/uhqeXXoAijbw/yg folded before Flop (didn't bet)
Seat 5: Bb42QRQMhg5/Y0vHP8/2Xw folded before Flop (didn't bet)
Seat 6: st9jtdNbm1W5GfBwRaCVqQ folded before Flop (didn't bet)
Seat 7: d7YasxuGLPiL7pj8IcGThw folded before Flop
Seat 9: ljemhp25Zg+nlA9DLCIiUw (button) collected ($0.85)




PokerStars Game #59941817928:  Hold'em No Limit ($0.10/$0.25) - 2009/07/01 1:47:07 ET
Table 'M7d9IrgQUUFFy/SZ3ksLYg' 6-max Seat #4 is the button
Seat 1: ypmjhffk/YHGc51wgVXUTw ($49.25 in chips) 
Seat 4: 8ClCHtFXGNplITm+63KB+Q ($24.20 in chips) 
Seat 5: kMa8BltUcBQVxnHfqdCfXg ($8.35 in chips) 
kMa8BltUcBQVxnHfqdCfXg: posts small blind $0.10
ypmjhffk/YHGc51wgVXUTw: posts big blind $0.25
epAUIB7h2FJXzUPRIvSkRA: sits out 
*** HOLE CARDS ***
8ClCHtFXGNplITm+63KB+Q: raises $0.75 to $1
kMa8BltUcBQVxnHfqdCfXg: folds 
ypmjhffk/YHGc51wgVXUTw: calls $0.75
*** FLOP *** [Kd 7s Jc]
ypmjhffk/YHGc51wgVXUTw: bets $1.50
8ClCHtFXGNplITm+63KB+Q: folds 
Uncalled bet ($1.50) returned to ypmjhffk/YHGc51wgVXUTw
ypmjhffk/YHGc51wgVXUTw collected $2 from pot
ypmjhffk/YHGc51wgVXUTw: doesn't show hand 
*** SUMMARY ***
Total pot $2.10 | Rake $0.10 
Board [Kd 7s Jc]
Seat 1: ypmjhffk/YHGc51wgVXUTw (big blind) collected ($2)
Seat 4: 8ClCHtFXGNplITm+63KB+Q (button) folded on the Flop
Seat 5: kMa8BltUcBQVxnHfqdCfXg (small blind) folded before Flop




PokerStars Game #59941817996:  Hold'em No Limit ($0.10/$0.25) - 2009/07/01 1:47:07 ET
Table 'm+FQg/QP0VP1ZA3V62WtOg' 9-max Seat #6 is the button
Seat 3: +KblIivb6tainScpwm14RQ ($6.50 in chips) 
Seat 5: wf5j8xvJtko6ZXyCbzzlVQ ($8.65 in chips) 
Seat 6: CT7Xj/V/O5rBlhtt+RZeFQ ($38.60 in chips) 
Seat 7: TPAF9YkMsjQFq978RNWZEQ ($26 in chips) 
Seat 8: E0iYnEVO2ho7dH3QcCjw7g ($20 in chips) 
Seat 9: zUXhymECc2C9W9ZNw6qppA ($4.05 in chips) 
TPAF9YkMsjQFq978RNWZEQ: posts small blind $0.10
E0iYnEVO2ho7dH3QcCjw7g: posts big blind $0.25
qwr38jl5txoR36M7G5qi4A: sits out 
yqkowiRWZ6NvRN9UUkYIlA: sits out 
dubÃ©705: sits out 
*** HOLE CARDS ***
zUXhymECc2C9W9ZNw6qppA is disconnected 
zUXhymECc2C9W9ZNw6qppA is connected 
zUXhymECc2C9W9ZNw6qppA: folds 
+KblIivb6tainScpwm14RQ: folds 
wf5j8xvJtko6ZXyCbzzlVQ: folds 
CT7Xj/V/O5rBlhtt+RZeFQ: folds 
TPAF9YkMsjQFq978RNWZEQ: calls $0.15
E0iYnEVO2ho7dH3QcCjw7g: checks 
*** FLOP *** [Kc 8s As]
TPAF9YkMsjQFq978RNWZEQ: checks 
E0iYnEVO2ho7dH3QcCjw7g: checks 
*** TURN *** [Kc 8s As] [Ah]
TPAF9YkMsjQFq978RNWZEQ: checks 
E0iYnEVO2ho7dH3QcCjw7g: checks 
*** RIVER *** [Kc 8s As Ah] [Ts]
TPAF9YkMsjQFq978RNWZEQ: bets $0.25
E0iYnEVO2ho7dH3QcCjw7g: folds 
Uncalled bet ($0.25) returned to TPAF9YkMsjQFq978RNWZEQ
TPAF9YkMsjQFq978RNWZEQ collected $0.50 from pot
*** SUMMARY ***
Total pot $0.50 | Rake $0 
Board [Kc 8s As Ah Ts]
Seat 3: +KblIivb6tainScpwm14RQ folded before Flop (didn't bet)
Seat 5: wf5j8xvJtko6ZXyCbzzlVQ folded before Flop (didn't bet)
Seat 6: CT7Xj/V/O5rBlhtt+RZeFQ (button) folded before Flop (didn't bet)
Seat 7: TPAF9YkMsjQFq978RNWZEQ (small blind) collected ($0.50)
Seat 8: E0iYnEVO2ho7dH3QcCjw7g (big blind) folded on the River
Seat 9: zUXhymECc2C9W9ZNw6qppA folded before Flop (didn't bet)




PokerStars Game #59941818116:  Hold'em No Limit ($0.10/$0.25) - 2009/07/01 1:47:07 ET
Table 'Do4nrTNDYpK3sQjwFxX+Og' 6-max Seat #4 is the button
Seat 1: 7JrQNOR9wRBxq9ijFhWieg ($37.65 in chips) 
Seat 2: tzMoGl9F0PUr5NibYueeSw ($67.70 in chips) 
Seat 3: TSmua8tGK3sTbwi0ynrW9Q ($26.40 in chips) 
Seat 4: cWc85bEzdRzpUMhRKm8pwQ ($33.05 in chips) 
Seat 6: lBoEwOFgzcERLIRUkUoRTw ($23.30 in chips) 
aogAb4Eienxztk8p2v9VVw will be allowed to play after the button
lBoEwOFgzcERLIRUkUoRTw: posts small blind $0.10
7JrQNOR9wRBxq9ijFhWieg: posts big blind $0.25
*** HOLE CARDS ***
tzMoGl9F0PUr5NibYueeSw: folds 
TSmua8tGK3sTbwi0ynrW9Q: folds 
tzMoGl9F0PUr5NibYueeSw said, "well I suppose it is time for bed gentlemen"
cWc85bEzdRzpUMhRKm8pwQ: folds 
lBoEwOFgzcERLIRUkUoRTw: folds 
Uncalled bet ($0.15) returned to 7JrQNOR9wRBxq9ijFhWieg
7JrQNOR9wRBxq9ijFhWieg collected $0.20 from pot
7JrQNOR9wRBxq9ijFhWieg: doesn't show hand 
*** SUMMARY ***
Total pot $0.20 | Rake $0 
Seat 1: 7JrQNOR9wRBxq9ijFhWieg (big blind) collected ($0.20)
Seat 2: tzMoGl9F0PUr5NibYueeSw folded before Flop (didn't bet)
Seat 3: TSmua8tGK3sTbwi0ynrW9Q folded before Flop (didn't bet)
Seat 4: cWc85bEzdRzpUMhRKm8pwQ (button) folded before Flop (didn't bet)
Seat 6: lBoEwOFgzcERLIRUkUoRTw (small blind) folded before Flop




PokerStars Game #59941818276:  Hold'em No Limit ($0.10/$0.25) - 2009/07/01 1:47:07 ET
Table 'fIMYcWwN4/aXFJvH5Z8Ymg' 6-max Seat #5 is the button
Seat 1: DihMHaz4WNETH1bPDe13kA ($25 in chips) 
Seat 2: Mhj3q7cxev+XjXZxEE6/Cw ($25.60 in chips) 
Seat 3: 9bpVv1/Qh9IYtXuCtl5VtQ ($24.65 in chips) 
Seat 5: lquriepNQBhDV5P1SWHhnA ($25.35 in chips) 
Seat 6: jp34e617tIzV8tKIWmfAbA ($28.80 in chips) 
jp34e617tIzV8tKIWmfAbA: posts small blind $0.10
DihMHaz4WNETH1bPDe13kA: posts big blind $0.25
7cx44/slbeTw+Cy7QB8Trg: sits out 
*** HOLE CARDS ***
Mhj3q7cxev+XjXZxEE6/Cw: folds 
9bpVv1/Qh9IYtXuCtl5VtQ: folds 
lquriepNQBhDV5P1SWHhnA: folds 
jp34e617tIzV8tKIWmfAbA: folds 
Uncalled bet ($0.15) returned to DihMHaz4WNETH1bPDe13kA
DihMHaz4WNETH1bPDe13kA collected $0.20 from pot
*** SUMMARY ***
Total pot $0.20 | Rake $0 
Seat 1: DihMHaz4WNETH1bPDe13kA (big blind) collected ($0.20)
Seat 2: Mhj3q7cxev+XjXZxEE6/Cw folded before Flop (didn't bet)
Seat 3: 9bpVv1/Qh9IYtXuCtl5VtQ folded before Flop (didn't bet)
Seat 5: lquriepNQBhDV5P1SWHhnA (button) folded before Flop (didn't bet)
Seat 6: jp34e617tIzV8tKIWmfAbA (small blind) folded before Flop




PokerStars Game #59941818724:  Hold'em No Limit ($0.10/$0.25) - 2009/07/01 1:47:08 ET
Table 'jItkp2PNTbH9Cf7gqsAF7g' 9-max Seat #6 is the button
Seat 1: wGigCmBR/9XWkPpvYos3aQ ($26.85 in chips) 
Seat 2: qwr38jl5txoR36M7G5qi4A ($7.95 in chips) 
Seat 3: 0YaJElQVLqWThIZnqq3w1g ($12.60 in chips) 
Seat 4: oJOvZw/Iayou0f0k6dkBhg ($4.35 in chips) 
Seat 5: NO6qGDOw12lhu3zh1xW3Bg ($21.15 in chips) 
Seat 6: cZ99hugmLBj9KhTlc8nCSw ($54 in chips) 
Seat 8: cq6LACCDFivk2+PeoiB2sw ($6.40 in chips) 
Seat 9: dtZ84flFEi4Q+SGrHMJRDQ ($25.15 in chips) 
cq6LACCDFivk2+PeoiB2sw: posts small blind $0.10
dtZ84flFEi4Q+SGrHMJRDQ: posts big blind $0.25
*** HOLE CARDS ***
wGigCmBR/9XWkPpvYos3aQ: folds 
qwr38jl5txoR36M7G5qi4A: folds 
0YaJElQVLqWThIZnqq3w1g: calls $0.25
oJOvZw/Iayou0f0k6dkBhg: raises $0.25 to $0.50
NO6qGDOw12lhu3zh1xW3Bg: calls $0.50
cZ99hugmLBj9KhTlc8nCSw: folds 
cq6LACCDFivk2+PeoiB2sw: calls $0.40
dtZ84flFEi4Q+SGrHMJRDQ: folds 
0YaJElQVLqWThIZnqq3w1g: calls $0.25
*** FLOP *** [5s Ts 9s]
cq6LACCDFivk2+PeoiB2sw: checks 
0YaJElQVLqWThIZnqq3w1g: checks 
oJOvZw/Iayou0f0k6dkBhg: checks 
NO6qGDOw12lhu3zh1xW3Bg: checks 
*** TURN *** [5s Ts 9s] [5h]
cq6LACCDFivk2+PeoiB2sw: bets $5.75
0YaJElQVLqWThIZnqq3w1g: folds 
oJOvZw/Iayou0f0k6dkBhg: folds 
NO6qGDOw12lhu3zh1xW3Bg: folds 
Uncalled bet ($5.75) returned to cq6LACCDFivk2+PeoiB2sw
cq6LACCDFivk2+PeoiB2sw collected $2.15 from pot
*** SUMMARY ***
Total pot $2.25 | Rake $0.10 
Board [5s Ts 9s 5h]
Seat 1: wGigCmBR/9XWkPpvYos3aQ folded before Flop (didn't bet)
Seat 2: qwr38jl5txoR36M7G5qi4A folded before Flop (didn't bet)
Seat 3: 0YaJElQVLqWThIZnqq3w1g folded on the Turn
Seat 4: oJOvZw/Iayou0f0k6dkBhg folded on the Turn
Seat 5: NO6qGDOw12lhu3zh1xW3Bg folded on the Turn
Seat 6: cZ99hugmLBj9KhTlc8nCSw (button) folded before Flop (didn't bet)
Seat 8: cq6LACCDFivk2+PeoiB2sw (small blind) collected ($2.15)
Seat 9: dtZ84flFEi4Q+SGrHMJRDQ (big blind) folded before Flop




PokerStars Game #59941818950:  Hold'em No Limit ($0.10/$0.25) - 2009/07/01 1:47:08 ET
Table '52Meibn9NOL4XtVi1p2Upw' 9-max Seat #6 is the button
Seat 1: W6tExOcYX7qiy6Qdp+ZwFA ($6.80 in chips) 
Seat 3: Bb42QRQMhg5/Y0vHP8/2Xw ($25 in chips) 
Seat 4: oLa/tXLfSLLB28mcLGrxcg ($31.65 in chips) 
Seat 5: MXCztnYJ58KLHMztZvKrxA ($3.60 in chips) 
Seat 6: N5sUK8M0br9djLrW97V9pQ ($29.50 in chips) 
Seat 7: Qduu7ikeizo6q6Ei9YvcJA ($25.10 in chips) 
Seat 8: w7VrLGwaVQzOQXfRqJitMQ ($22.60 in chips) 
Seat 9: RCqMONFrSPSArZh2Jsar/w ($19.65 in chips) 
Qduu7ikeizo6q6Ei9YvcJA: posts small blind $0.10
w7VrLGwaVQzOQXfRqJitMQ: posts big blind $0.25
Yslaketh: sits out 
*** HOLE CARDS ***
RCqMONFrSPSArZh2Jsar/w: folds 
W6tExOcYX7qiy6Qdp+ZwFA: calls $0.25
Bb42QRQMhg5/Y0vHP8/2Xw: raises $0.75 to $1
oLa/tXLfSLLB28mcLGrxcg: folds 
MXCztnYJ58KLHMztZvKrxA: folds 
N5sUK8M0br9djLrW97V9pQ: folds 
Qduu7ikeizo6q6Ei9YvcJA: folds 
w7VrLGwaVQzOQXfRqJitMQ: calls $0.75
W6tExOcYX7qiy6Qdp+ZwFA: folds 
*** FLOP *** [Jd 5d 6h]
w7VrLGwaVQzOQXfRqJitMQ: checks 
Bb42QRQMhg5/Y0vHP8/2Xw: checks 
*** TURN *** [Jd 5d 6h] [Kd]
w7VrLGwaVQzOQXfRqJitMQ: checks 
Bb42QRQMhg5/Y0vHP8/2Xw: checks 
*** RIVER *** [Jd 5d 6h Kd] [Ts]
w7VrLGwaVQzOQXfRqJitMQ: checks 
Bb42QRQMhg5/Y0vHP8/2Xw: bets $1
w7VrLGwaVQzOQXfRqJitMQ: folds 
Uncalled bet ($1) returned to Bb42QRQMhg5/Y0vHP8/2Xw
Bb42QRQMhg5/Y0vHP8/2Xw collected $2.25 from pot
*** SUMMARY ***
Total pot $2.35 | Rake $0.10 
Board [Jd 5d 6h Kd Ts]
Seat 1: W6tExOcYX7qiy6Qdp+ZwFA folded before Flop
Seat 3: Bb42QRQMhg5/Y0vHP8/2Xw collected ($2.25)
Seat 4: oLa/tXLfSLLB28mcLGrxcg folded before Flop (didn't bet)
Seat 5: MXCztnYJ58KLHMztZvKrxA folded before Flop (didn't bet)
Seat 6: N5sUK8M0br9djLrW97V9pQ (button) folded before Flop (didn't bet)
Seat 7: Qduu7ikeizo6q6Ei9YvcJA (small blind) folded before Flop
Seat 8: w7VrLGwaVQzOQXfRqJitMQ (big blind) folded on the River
Seat 9: RCqMONFrSPSArZh2Jsar/w folded before Flop (didn't bet)




PokerStars Game #59941818684:  Hold'em No Limit ($0.10/$0.25) - 2009/07/01 1:47:08 ET
Table 'srBTB98reCdD1TffxE6o7g' 6-max Seat #6 is the button
Seat 1: SFmT9ZsVopnukjvAzrxTRg ($33.70 in chips) 
Seat 2: mfrkWA3PTeYPkbO6hi98Aw ($25.35 in chips) 
Seat 4: 6DwBRH+xZ12AAZmeAg+aXw ($16.20 in chips) 
Seat 5: K1zv48sQUGQiaLk5VWWDqw ($25 in chips) 
Seat 6: BV+K0Phf5VBHr7aZPKqbUQ ($34.60 in chips) 
SFmT9ZsVopnukjvAzrxTRg: posts small blind $0.10
mfrkWA3PTeYPkbO6hi98Aw: posts big blind $0.25
K1zv48sQUGQiaLk5VWWDqw: posts big blind $0.25
*** HOLE CARDS ***
6DwBRH+xZ12AAZmeAg+aXw: folds 
K1zv48sQUGQiaLk5VWWDqw: checks 
BV+K0Phf5VBHr7aZPKqbUQ: raises $1 to $1.25
SFmT9ZsVopnukjvAzrxTRg: calls $1.15
mfrkWA3PTeYPkbO6hi98Aw: folds 
K1zv48sQUGQiaLk5VWWDqw: folds 
*** FLOP *** [Kc 6s Qc]
SFmT9ZsVopnukjvAzrxTRg: checks 
BV+K0Phf5VBHr7aZPKqbUQ: bets $1.75
SFmT9ZsVopnukjvAzrxTRg: raises $3.25 to $5
BV+K0Phf5VBHr7aZPKqbUQ: folds 
Uncalled bet ($3.25) returned to SFmT9ZsVopnukjvAzrxTRg
SFmT9ZsVopnukjvAzrxTRg collected $6.20 from pot
SFmT9ZsVopnukjvAzrxTRg: doesn't show hand 
*** SUMMARY ***
Total pot $6.50 | Rake $0.30 
Board [Kc 6s Qc]
Seat 1: SFmT9ZsVopnukjvAzrxTRg (small blind) collected ($6.20)
Seat 2: mfrkWA3PTeYPkbO6hi98Aw (big blind) folded before Flop
Seat 4: 6DwBRH+xZ12AAZmeAg+aXw folded before Flop (didn't bet)
Seat 5: K1zv48sQUGQiaLk5VWWDqw folded before Flop
Seat 6: BV+K0Phf5VBHr7aZPKqbUQ (button) folded on the Flop




PokerStars Game #59941818676:  Hold'em No Limit ($0.10/$0.25) - 2009/07/01 1:47:08 ET
Table 'WEMI3Mtn7dGARDbgNrKibgQvLFJzpzymuOsaaRYi+8fgx Seat #3 is the button
Seat 1: cZ99hugmLBj9KhTlc8nCSw ($26.70 in chips) 
Seat 2: PdIasPkzm2sqZnN41ZRXOg ($5 in chips) 
Seat 3: Qduu7ikeizo6q6Ei9YvcJA ($24.65 in chips) 
Seat 4: tLcDklc2rBORNfixyRfVfw ($25.35 in chips) 
Seat 5: MG90wfSJZnOejs/KD3vlQQ ($36.75 in chips) 
Seat 6: vKdukiQ4ktU4yJ0Xx3MKnA ($8.60 in chips) 
Seat 7: rQhYIYXSyH/IivYM1dlV5A ($11.20 in chips) 
Seat 8: gehe91e0IyVT0QU/XBkEyg ($27.35 in chips) 
Seat 9: BWzInv8o0kN1pJybv/VjpQ ($43.75 in chips) 
tLcDklc2rBORNfixyRfVfw: posts small blind $0.10
MG90wfSJZnOejs/KD3vlQQ: posts big blind $0.25
*** HOLE CARDS ***
vKdukiQ4ktU4yJ0Xx3MKnA: raises $0.25 to $0.50
rQhYIYXSyH/IivYM1dlV5A: folds 
gehe91e0IyVT0QU/XBkEyg: folds 
BWzInv8o0kN1pJybv/VjpQ: calls $0.50
cZ99hugmLBj9KhTlc8nCSw: folds 
PdIasPkzm2sqZnN41ZRXOg: folds 
Qduu7ikeizo6q6Ei9YvcJA: folds 
tLcDklc2rBORNfixyRfVfw: folds 
MG90wfSJZnOejs/KD3vlQQ: calls $0.25
*** FLOP *** [Qh Ad 2h]
MG90wfSJZnOejs/KD3vlQQ: checks 
vKdukiQ4ktU4yJ0Xx3MKnA: checks 
BWzInv8o0kN1pJybv/VjpQ: bets $1
MG90wfSJZnOejs/KD3vlQQ: folds 
vKdukiQ4ktU4yJ0Xx3MKnA: folds 
Uncalled bet ($1) returned to BWzInv8o0kN1pJybv/VjpQ
BWzInv8o0kN1pJybv/VjpQ collected $1.55 from pot
*** SUMMARY ***
Total pot $1.60 | Rake $0.05 
Board [Qh Ad 2h]
Seat 1: cZ99hugmLBj9KhTlc8nCSw folded before Flop (didn't bet)
Seat 2: PdIasPkzm2sqZnN41ZRXOg folded before Flop (didn't bet)
Seat 3: Qduu7ikeizo6q6Ei9YvcJA (button) folded before Flop (didn't bet)
Seat 4: tLcDklc2rBORNfixyRfVfw (small blind) folded before Flop
Seat 5: MG90wfSJZnOejs/KD3vlQQ (big blind) folded on the Flop
Seat 6: vKdukiQ4ktU4yJ0Xx3MKnA folded on the Flop
Seat 7: rQhYIYXSyH/IivYM1dlV5A folded before Flop (didn't bet)
Seat 8: gehe91e0IyVT0QU/XBkEyg folded before Flop (didn't bet)
Seat 9: BWzInv8o0kN1pJybv/VjpQ collected ($1.55)




PokerStars Game #59941819122:  Hold'em No Limit ($0.10/$0.25) - 2009/07/01 1:47:09 ET
Table 'KTZXQ4LREPjpS54R3DFTsw' 9-max Seat #3 is the button
Seat 1: dSjkBIV7Bv+ZCIWNBguf7w ($40.85 in chips) 
Seat 2: OlPJsgR4xypSg/w1z7Gyvw ($19.50 in chips) 
Seat 3: H5Se03ZqSX7tbULXur2MAg ($23.30 in chips) 
Seat 4: K0b5wNInj6hUGRr6yzKFtw ($64.10 in chips) 
Seat 5: HPEB+AtKw1+C/cxU0o1ciw ($29.95 in chips) 
Seat 6: Mh2r9hTeTEDnh19sRZtW3g ($5.70 in chips) 
Seat 7: yyG4svzOpC1A+sUP/scg6w ($10.95 in chips) 
Seat 9: V6p0jQ/RhUsqpHLmXvEX4Q ($13.45 in chips) 
K0b5wNInj6hUGRr6yzKFtw: posts small blind $0.10
HPEB+AtKw1+C/cxU0o1ciw: posts big blind $0.25
*** HOLE CARDS ***
Mh2r9hTeTEDnh19sRZtW3g: folds 
yyG4svzOpC1A+sUP/scg6w: folds 
V6p0jQ/RhUsqpHLmXvEX4Q: raises $0.75 to $1
mMd8CDS/but3UC+Zp7Up2w joins the table at seat #8 
dSjkBIV7Bv+ZCIWNBguf7w: folds 
OlPJsgR4xypSg/w1z7Gyvw: calls $1
H5Se03ZqSX7tbULXur2MAg: calls $1
K0b5wNInj6hUGRr6yzKFtw: folds 
HPEB+AtKw1+C/cxU0o1ciw: calls $0.75
*** FLOP *** [Th 7s 8h]
HPEB+AtKw1+C/cxU0o1ciw: checks 
V6p0jQ/RhUsqpHLmXvEX4Q: checks 
OlPJsgR4xypSg/w1z7Gyvw: bets $2.50
H5Se03ZqSX7tbULXur2MAg: raises $6 to $8.50
HPEB+AtKw1+C/cxU0o1ciw: folds 
V6p0jQ/RhUsqpHLmXvEX4Q: folds 
OlPJsgR4xypSg/w1z7Gyvw: folds 
Uncalled bet ($6) returned to H5Se03ZqSX7tbULXur2MAg
H5Se03ZqSX7tbULXur2MAg collected $8.70 from pot
*** SUMMARY ***
Total pot $9.10 | Rake $0.40 
Board [Th 7s 8h]
Seat 1: dSjkBIV7Bv+ZCIWNBguf7w folded before Flop (didn't bet)
Seat 2: OlPJsgR4xypSg/w1z7Gyvw folded on the Flop
Seat 3: H5Se03ZqSX7tbULXur2MAg (button) collected ($8.70)
Seat 4: K0b5wNInj6hUGRr6yzKFtw (small blind) folded before Flop
Seat 5: HPEB+AtKw1+C/cxU0o1ciw (big blind) folded on the Flop
Seat 6: Mh2r9hTeTEDnh19sRZtW3g folded before Flop (didn't bet)
Seat 7: yyG4svzOpC1A+sUP/scg6w folded before Flop (didn't bet)
Seat 9: V6p0jQ/RhUsqpHLmXvEX4Q folded on the Flop




PokerStars Game #59941819276:  Hold'em No Limit ($0.10/$0.25) - 2009/07/01 1:47:09 ET
Table '4hfTdIVT/qPsJNfWXLsVIw' 9-max Seat #9 is the button
Seat 1: GbHFBbLqLGz0Pwn6CJeAuw ($36.30 in chips) 
Seat 2: Pt637jKksB5MzP0UNJAAkw ($40.20 in chips) 
Seat 3: xnVwSkROfRtOw4eSoDANtw ($4.70 in chips) 
Seat 5: dtZ84flFEi4Q+SGrHMJRDQ ($25.10 in chips) 
Seat 6: VWUWpMLMj/Q1jRVpF7Aohw ($12.90 in chips) 
Seat 7: d7YasxuGLPiL7pj8IcGThw ($5 in chips) 
Seat 8: 7cv+9Zc9HIQHNvYsMfV3uA ($33.30 in chips) 
Seat 9: 9njEKzpOKC62MllUFUBWrA ($24 in chips) 
GbHFBbLqLGz0Pwn6CJeAuw: posts small blind $0.10
Pt637jKksB5MzP0UNJAAkw: posts big blind $0.25
3PmVnC/15cl4oyI1TKIt4g: sits out 
d7YasxuGLPiL7pj8IcGThw: posts big blind $0.25
*** HOLE CARDS ***
xnVwSkROfRtOw4eSoDANtw: calls $0.25
dtZ84flFEi4Q+SGrHMJRDQ: folds 
VWUWpMLMj/Q1jRVpF7Aohw: folds 
d7YasxuGLPiL7pj8IcGThw: checks 
7cv+9Zc9HIQHNvYsMfV3uA: folds 
9njEKzpOKC62MllUFUBWrA: folds 
GbHFBbLqLGz0Pwn6CJeAuw: calls $0.15
Pt637jKksB5MzP0UNJAAkw: checks 
*** FLOP *** [8h Kh Js]
GbHFBbLqLGz0Pwn6CJeAuw: checks 
Pt637jKksB5MzP0UNJAAkw: checks 
xnVwSkROfRtOw4eSoDANtw: checks 
d7YasxuGLPiL7pj8IcGThw: checks 
*** TURN *** [8h Kh Js] [Ts]
GbHFBbLqLGz0Pwn6CJeAuw: checks 
Pt637jKksB5MzP0UNJAAkw: checks 
xnVwSkROfRtOw4eSoDANtw: checks 
d7YasxuGLPiL7pj8IcGThw: checks 
*** RIVER *** [8h Kh Js Ts] [8s]
GbHFBbLqLGz0Pwn6CJeAuw: checks 
Pt637jKksB5MzP0UNJAAkw: checks 
xnVwSkROfRtOw4eSoDANtw: checks 
d7YasxuGLPiL7pj8IcGThw: checks 
*** SHOW DOWN ***
GbHFBbLqLGz0Pwn6CJeAuw: shows [7d 5d] (a pair of Eights)
Pt637jKksB5MzP0UNJAAkw: shows [Qc 4h] (a pair of Eights - King+Queen kicker)
xnVwSkROfRtOw4eSoDANtw: mucks hand 
d7YasxuGLPiL7pj8IcGThw: shows [3h As] (a pair of Eights - Ace kicker)
d7YasxuGLPiL7pj8IcGThw collected $0.95 from pot
*** SUMMARY ***
Total pot $1 | Rake $0.05 
Board [8h Kh Js Ts 8s]
Seat 1: GbHFBbLqLGz0Pwn6CJeAuw (small blind) showed [7d 5d] and lost with a pair of Eights
Seat 2: Pt637jKksB5MzP0UNJAAkw (big blind) showed [Qc 4h] and lost with a pair of Eights
Seat 3: xnVwSkROfRtOw4eSoDANtw mucked
Seat 5: dtZ84flFEi4Q+SGrHMJRDQ folded before Flop (didn't bet)
Seat 6: VWUWpMLMj/Q1jRVpF7Aohw folded before Flop (didn't bet)
Seat 7: d7YasxuGLPiL7pj8IcGThw showed [3h As] and won ($0.95) with a pair of Eights
Seat 8: 7cv+9Zc9HIQHNvYsMfV3uA folded before Flop (didn't bet)
Seat 9: 9njEKzpOKC62MllUFUBWrA (button) folded before Flop (didn't bet)




PokerStars Game #59941819510:  Hold'em No Limit ($0.10/$0.25) - 2009/07/01 1:47:09 ET
Table 'IdXp6nyeW4FYaEK4qKCnwQ' 9-max Seat #6 is the button
Seat 1: tLcDklc2rBORNfixyRfVfw ($25 in chips) 
Seat 2: HPEB+AtKw1+C/cxU0o1ciw ($30.85 in chips) 
Seat 3: eK8qa6EPcH2zhtbmWSvc9g ($33.05 in chips) 
Seat 4: j4q3p0lesp63b1gZDwLBZw ($5.35 in chips) 
Seat 6: arxNSjreDRGFg13EAM2F1w ($30.50 in chips) 
Seat 7: w1ukf8uPa4+WH561TtVRxA ($37 in chips) 
Seat 8: dtZ84flFEi4Q+SGrHMJRDQ ($31.10 in chips) 
Seat 9: s2xLPOl/vhl/26apJ3vsOQ ($29.25 in chips) 
w1ukf8uPa4+WH561TtVRxA: posts small blind $0.10
dtZ84flFEi4Q+SGrHMJRDQ: posts big blind $0.25
*** HOLE CARDS ***
s2xLPOl/vhl/26apJ3vsOQ: folds 
tLcDklc2rBORNfixyRfVfw: folds 
HPEB+AtKw1+C/cxU0o1ciw: folds 
eK8qa6EPcH2zhtbmWSvc9g: calls $0.25
j4q3p0lesp63b1gZDwLBZw: folds 
arxNSjreDRGFg13EAM2F1w: folds 
w1ukf8uPa4+WH561TtVRxA: folds 
dtZ84flFEi4Q+SGrHMJRDQ: checks 
*** FLOP *** [Tc 9c 2c]
dtZ84flFEi4Q+SGrHMJRDQ: checks 
eK8qa6EPcH2zhtbmWSvc9g: bets $0.35
dtZ84flFEi4Q+SGrHMJRDQ: calls $0.35
*** TURN *** [Tc 9c 2c] [4d]
dtZ84flFEi4Q+SGrHMJRDQ: checks 
eK8qa6EPcH2zhtbmWSvc9g: bets $0.65
dtZ84flFEi4Q+SGrHMJRDQ: calls $0.65
*** RIVER *** [Tc 9c 2c 4d] [Qc]
dtZ84flFEi4Q+SGrHMJRDQ: checks 
eK8qa6EPcH2zhtbmWSvc9g: checks 
*** SHOW DOWN ***
dtZ84flFEi4Q+SGrHMJRDQ: shows [3d Th] (a pair of Tens)
eK8qa6EPcH2zhtbmWSvc9g: shows [4h 4c] (a flush, Queen high)
eK8qa6EPcH2zhtbmWSvc9g collected $2.50 from pot
*** SUMMARY ***
Total pot $2.60 | Rake $0.10 
Board [Tc 9c 2c 4d Qc]
Seat 1: tLcDklc2rBORNfixyRfVfw folded before Flop (didn't bet)
Seat 2: HPEB+AtKw1+C/cxU0o1ciw folded before Flop (didn't bet)
Seat 3: eK8qa6EPcH2zhtbmWSvc9g showed [4h 4c] and won ($2.50) with a flush, Queen high
Seat 4: j4q3p0lesp63b1gZDwLBZw folded before Flop (didn't bet)
Seat 6: arxNSjreDRGFg13EAM2F1w (button) folded before Flop (didn't bet)
Seat 7: w1ukf8uPa4+WH561TtVRxA (small blind) folded before Flop
Seat 8: dtZ84flFEi4Q+SGrHMJRDQ (big blind) showed [3d Th] and lost with a pair of Tens
Seat 9: s2xLPOl/vhl/26apJ3vsOQ folded before Flop (didn't bet)




PokerStars Game #59941819450:  Hold'em No Limit ($0.10/$0.25) - 2009/07/01 1:47:09 ET
Table 'KEoOIegxPF91KooL2AelUA' 6-max Seat #6 is the button
Seat 2: 0Bg59Tnte1Tc7C4i9Jd9cQ ($5.15 in chips) 
Seat 3: zxeVQGaMKDsDzmSY+AInjA ($13.45 in chips) 
Seat 4: Wo60l2GQnSEc3bxPVyvIUw ($9.10 in chips) 
Seat 5: 08V++DOqzaNrRNsHIwi25w ($51.75 in chips) 
Seat 6: AMrBn4Vx9aAo/vv6WHLk6w ($2.65 in chips) 
32YL2ZEp8NT4JB2RVM9euQ will be allowed to play after the button
0Bg59Tnte1Tc7C4i9Jd9cQ: posts small blind $0.10
zxeVQGaMKDsDzmSY+AInjA: posts big blind $0.25
*** HOLE CARDS ***
Wo60l2GQnSEc3bxPVyvIUw has timed out
Wo60l2GQnSEc3bxPVyvIUw: folds 
Wo60l2GQnSEc3bxPVyvIUw is sitting out
08V++DOqzaNrRNsHIwi25w: folds 
AMrBn4Vx9aAo/vv6WHLk6w: folds 
Wo60l2GQnSEc3bxPVyvIUw has returned
0Bg59Tnte1Tc7C4i9Jd9cQ: calls $0.15
zxeVQGaMKDsDzmSY+AInjA: checks 
*** FLOP *** [7h 7d Qd]
0Bg59Tnte1Tc7C4i9Jd9cQ: bets $0.50
zxeVQGaMKDsDzmSY+AInjA: folds 
Uncalled bet ($0.50) returned to 0Bg59Tnte1Tc7C4i9Jd9cQ
0Bg59Tnte1Tc7C4i9Jd9cQ collected $0.50 from pot
*** SUMMARY ***
Total pot $0.50 | Rake $0 
Board [7h 7d Qd]
Seat 2: 0Bg59Tnte1Tc7C4i9Jd9cQ (small blind) collected ($0.50)
Seat 3: zxeVQGaMKDsDzmSY+AInjA (big blind) folded on the Flop
Seat 4: Wo60l2GQnSEc3bxPVyvIUw folded before Flop (didn't bet)
Seat 5: 08V++DOqzaNrRNsHIwi25w folded before Flop (didn't bet)
Seat 6: AMrBn4Vx9aAo/vv6WHLk6w (button) folded before Flop (didn't bet)




PokerStars Game #59941819242:  Hold'em No Limit ($0.10/$0.25) - 2009/07/01 1:47:09 ET
Table 'Ok3oDLIsTc2+KxPcI0bAOA' 6-max Seat #6 is the button
Seat 1: agQm3ugZ3qSVYNgNu1ddeA ($39.25 in chips) 
Seat 2: wPSNSp4HYtytRMXTu3oPSQ ($29.40 in chips) 
Seat 3: lquriepNQBhDV5P1SWHhnA ($36.45 in chips) 
Seat 4: LJI7A1YgDM7hgh7o56+ReQ ($34.05 in chips) 
Seat 5: DFi/Lzkjsfv8QswS80JX9Q ($30.10 in chips) 
Seat 6: Hsvkc0/G2VV78oVmWYXecw ($5 in chips) 
agQm3ugZ3qSVYNgNu1ddeA: posts small blind $0.10
wPSNSp4HYtytRMXTu3oPSQ: posts big blind $0.25
*** HOLE CARDS ***
lquriepNQBhDV5P1SWHhnA: folds 
LJI7A1YgDM7hgh7o56+ReQ: folds 
DFi/Lzkjsfv8QswS80JX9Q: folds 
Hsvkc0/G2VV78oVmWYXecw: raises $0.50 to $0.75
agQm3ugZ3qSVYNgNu1ddeA: folds 
wPSNSp4HYtytRMXTu3oPSQ: calls $0.50
*** FLOP *** [8c Kd 9d]
wPSNSp4HYtytRMXTu3oPSQ: checks 
Hsvkc0/G2VV78oVmWYXecw: bets $1
wPSNSp4HYtytRMXTu3oPSQ: folds 
Uncalled bet ($1) returned to Hsvkc0/G2VV78oVmWYXecw
Hsvkc0/G2VV78oVmWYXecw collected $1.55 from pot
Hsvkc0/G2VV78oVmWYXecw: doesn't show hand 
*** SUMMARY ***
Total pot $1.60 | Rake $0.05 
Board [8c Kd 9d]
Seat 1: agQm3ugZ3qSVYNgNu1ddeA (small blind) folded before Flop
Seat 2: wPSNSp4HYtytRMXTu3oPSQ (big blind) folded on the Flop
Seat 3: lquriepNQBhDV5P1SWHhnA folded before Flop (didn't bet)
Seat 4: LJI7A1YgDM7hgh7o56+ReQ folded before Flop (didn't bet)
Seat 5: DFi/Lzkjsfv8QswS80JX9Q folded before Flop (didn't bet)
Seat 6: Hsvkc0/G2VV78oVmWYXecw (button) collected ($1.55)




PokerStars Game #59941819768:  Hold'em No Limit ($0.10/$0.25) - 2009/07/01 1:47:10 ET
Table 'oZuNsbNJuUyQLGKzQ/4JFg' 6-max Seat #2 is the button
Seat 1: vqWjZmdQu/Hxw96/IJTWdQ ($25.35 in chips) 
Seat 2: UA5OsKS3VPaxa7uC8La/kA ($34.15 in chips) 
Seat 3: 8ClCHtFXGNplITm+63KB+Q ($50.75 in chips) 
Seat 4: 9bpVv1/Qh9IYtXuCtl5VtQ ($25.80 in chips) 
Seat 5: oBUDUfeUyCbZBsjxHZgSiw ($26.60 in chips) 
Seat 6: fwg6dK1+r4jy/y+JqenYYQ ($13.80 in chips) 
8ClCHtFXGNplITm+63KB+Q: posts small blind $0.10
9bpVv1/Qh9IYtXuCtl5VtQ: posts big blind $0.25
*** HOLE CARDS ***
oBUDUfeUyCbZBsjxHZgSiw: folds 
fwg6dK1+r4jy/y+JqenYYQ: folds 
vqWjZmdQu/Hxw96/IJTWdQ: raises $0.75 to $1
UA5OsKS3VPaxa7uC8La/kA: calls $1
8ClCHtFXGNplITm+63KB+Q: folds 
9bpVv1/Qh9IYtXuCtl5VtQ: folds 
*** FLOP *** [7d Jc Jh]
vqWjZmdQu/Hxw96/IJTWdQ: checks 
UA5OsKS3VPaxa7uC8La/kA: bets $1.75
vqWjZmdQu/Hxw96/IJTWdQ: folds 
Uncalled bet ($1.75) returned to UA5OsKS3VPaxa7uC8La/kA
UA5OsKS3VPaxa7uC8La/kA collected $2.25 from pot
*** SUMMARY ***
Total pot $2.35 | Rake $0.10 
Board [7d Jc Jh]
Seat 1: vqWjZmdQu/Hxw96/IJTWdQ folded on the Flop
Seat 2: UA5OsKS3VPaxa7uC8La/kA (button) collected ($2.25)
Seat 3: 8ClCHtFXGNplITm+63KB+Q (small blind) folded before Flop
Seat 4: 9bpVv1/Qh9IYtXuCtl5VtQ (big blind) folded before Flop
Seat 5: oBUDUfeUyCbZBsjxHZgSiw folded before Flop (didn't bet)
Seat 6: fwg6dK1+r4jy/y+JqenYYQ folded before Flop (didn't bet)




PokerStars Game #59941819674:  Hold'em No Limit ($0.10/$0.25) - 2009/07/01 1:47:10 ET
Table 'vZfV/Uj0q8joA1du9sRJSg' 6-max Seat #3 is the button
Seat 1: Hsvkc0/G2VV78oVmWYXecw ($6.05 in chips) 
Seat 2: wMiE3yTbDJGOLOF9th7KPA ($3.90 in chips) 
Seat 3: cWc85bEzdRzpUMhRKm8pwQ ($25 in chips) 
Seat 4: v+QfkGiuj9bgtuNoVnDO8w ($43.60 in chips) 
Seat 5: kyRaCIljYA6l33lSKQfNsg ($30.05 in chips) 
Seat 6: 8ClCHtFXGNplITm+63KB+Q ($49.05 in chips) 
v+QfkGiuj9bgtuNoVnDO8w: posts small blind $0.10
kyRaCIljYA6l33lSKQfNsg: posts big blind $0.25
*** HOLE CARDS ***
8ClCHtFXGNplITm+63KB+Q: folds 
Hsvkc0/G2VV78oVmWYXecw: folds 
wMiE3yTbDJGOLOF9th7KPA: raises $0.25 to $0.50
cWc85bEzdRzpUMhRKm8pwQ: folds 
v+QfkGiuj9bgtuNoVnDO8w: folds 
kyRaCIljYA6l33lSKQfNsg: folds 
Uncalled bet ($0.25) returned to wMiE3yTbDJGOLOF9th7KPA
wMiE3yTbDJGOLOF9th7KPA collected $0.60 from pot
wMiE3yTbDJGOLOF9th7KPA: doesn't show hand 
*** SUMMARY ***
Total pot $0.60 | Rake $0 
Seat 1: Hsvkc0/G2VV78oVmWYXecw folded before Flop (didn't bet)
Seat 2: wMiE3yTbDJGOLOF9th7KPA collected ($0.60)
Seat 3: cWc85bEzdRzpUMhRKm8pwQ (button) folded before Flop (didn't bet)
Seat 4: v+QfkGiuj9bgtuNoVnDO8w (small blind) folded before Flop
Seat 5: kyRaCIljYA6l33lSKQfNsg (big blind) folded before Flop
Seat 6: 8ClCHtFXGNplITm+63KB+Q folded before Flop (didn't bet)




PokerStars Game #59941820062:  Hold'em No Limit ($0.10/$0.25) - 2009/07/01 1:47:10 ET
Table '9o8Yb3JpUqurD4pNVmOikQ' 6-max Seat #3 is the button
Seat 1: SFmT9ZsVopnukjvAzrxTRg ($27.20 in chips) 
Seat 2: /gJNBeCkWL4o85/jvlZ4BA ($25.25 in chips) 
Seat 3: JgRqo1/2phbf7pab7N3BIQ ($23.50 in chips) 
Seat 4: j5NZbEJHsERuXjPHWqc1Nw ($11.45 in chips) 
Seat 5: QqiZLFrN8iOUT/GHw7ztOA ($24.15 in chips) 
Seat 6: LyDHtw3/yniNHW+DvLXbog ($25.70 in chips) 
j5NZbEJHsERuXjPHWqc1Nw: posts small blind $0.10
QqiZLFrN8iOUT/GHw7ztOA: posts big blind $0.25
*** HOLE CARDS ***
LyDHtw3/yniNHW+DvLXbog: folds 
SFmT9ZsVopnukjvAzrxTRg: raises $0.75 to $1
/gJNBeCkWL4o85/jvlZ4BA: folds 
JgRqo1/2phbf7pab7N3BIQ: folds 
j5NZbEJHsERuXjPHWqc1Nw: folds 
QqiZLFrN8iOUT/GHw7ztOA: folds 
Uncalled bet ($0.75) returned to SFmT9ZsVopnukjvAzrxTRg
SFmT9ZsVopnukjvAzrxTRg collected $0.60 from pot
SFmT9ZsVopnukjvAzrxTRg: doesn't show hand 
*** SUMMARY ***
Total pot $0.60 | Rake $0 
Seat 1: SFmT9ZsVopnukjvAzrxTRg collected ($0.60)
Seat 2: /gJNBeCkWL4o85/jvlZ4BA folded before Flop (didn't bet)
Seat 3: JgRqo1/2phbf7pab7N3BIQ (button) folded before Flop (didn't bet)
Seat 4: j5NZbEJHsERuXjPHWqc1Nw (small blind) folded before Flop
Seat 5: QqiZLFrN8iOUT/GHw7ztOA (big blind) folded before Flop
Seat 6: LyDHtw3/yniNHW+DvLXbog folded before Flop (didn't bet)




PokerStars Game #59941819954:  Hold'em No Limit ($0.10/$0.25) - 2009/07/01 1:47:10 ET
Table '6wawJ+MkkvuC3coG6r+YhgZiwAqg4o02gNro+JOAaFNgSeat #1 is the button
Seat 1: 6RiVTYll/5D8zICp0MRpKw ($29.85 in chips) 
Seat 3: aNpwfA31EREwO+ar4XzBCw ($28.75 in chips) 
Seat 4: RHqgdFvufLCYe54+qd2gcA ($5 in chips) 
Seat 5: 5hAPbqNrvJb8PtLiceXtlg6HoFYfVGBefsR5Vrz62qIw8.15 in chips) 
Seat 6: 5n7e7I+px7c6CQmLpPbtsg ($5 in chips) 
Seat 7: yyG4svzOpC1A+sUP/scg6w ($7.20 in chips) 
Seat 8: VLIsy+xjx3olLSYO3JLS6g ($8.95 in chips) 
Seat 9: ljemhp25Zg+nlA9DLCIiUw ($24.90 in chips) 
lewis+fi will be allowed to play after the button
aNpwfA31EREwO+ar4XzBCw: posts small blind $0.10
RHqgdFvufLCYe54+qd2gcA: posts big blind $0.25
*** HOLE CARDS ***
5hAPbqNrvJb8PtLiceXtlg6HoFYfVGBefsR5Vrz62qIwlls $0.25
5n7e7I+px7c6CQmLpPbtsg: folds 
yyG4svzOpC1A+sUP/scg6w: folds 
VLIsy+xjx3olLSYO3JLS6g: raises $1 to $1.25
ljemhp25Zg+nlA9DLCIiUw: folds 
6RiVTYll/5D8zICp0MRpKw: folds 
aNpwfA31EREwO+ar4XzBCw: folds 
RHqgdFvufLCYe54+qd2gcA: folds 
5hAPbqNrvJb8PtLiceXtlg6HoFYfVGBefsR5Vrz62qIwlls $1
*** FLOP *** [Ad Js 3s]
5hAPbqNrvJb8PtLiceXtlg6HoFYfVGBefsR5Vrz62qIwecks 
VLIsy+xjx3olLSYO3JLS6g: bets $0.50
5hAPbqNrvJb8PtLiceXtlg6HoFYfVGBefsR5Vrz62qIwlls $0.50
*** TURN *** [Ad Js 3s] [Qc]
5hAPbqNrvJb8PtLiceXtlg6HoFYfVGBefsR5Vrz62qIwecks 
VLIsy+xjx3olLSYO3JLS6g: bets $1.75
5hAPbqNrvJb8PtLiceXtlg6HoFYfVGBefsR5Vrz62qIwlls $1.75
*** RIVER *** [Ad Js 3s Qc] [Ah]
5hAPbqNrvJb8PtLiceXtlg6HoFYfVGBefsR5Vrz62qIwecks 
VLIsy+xjx3olLSYO3JLS6g: bets $2.50
5hAPbqNrvJb8PtLiceXtlg6HoFYfVGBefsR5Vrz62qIwlls $2.50
*** SHOW DOWN ***
VLIsy+xjx3olLSYO3JLS6g: shows [3c As] (a full house, Aces full of Threes)
5hAPbqNrvJb8PtLiceXtlg6HoFYfVGBefsR5Vrz62qIwcks hand 
VLIsy+xjx3olLSYO3JLS6g collected $11.75 from pot
*** SUMMARY ***
Total pot $12.35 | Rake $0.60 
Board [Ad Js 3s Qc Ah]
Seat 1: 6RiVTYll/5D8zICp0MRpKw (button) folded before Flop (didn't bet)
Seat 3: aNpwfA31EREwO+ar4XzBCw (small blind) folded before Flop
Seat 4: RHqgdFvufLCYe54+qd2gcA (big blind) folded before Flop
Seat 5: 5hAPbqNrvJb8PtLiceXtlg6HoFYfVGBefsR5Vrz62qIwked
Seat 6: 5n7e7I+px7c6CQmLpPbtsg folded before Flop (didn't bet)
Seat 7: yyG4svzOpC1A+sUP/scg6w folded before Flop (didn't bet)
Seat 8: VLIsy+xjx3olLSYO3JLS6g showed [3c As] and won ($11.75) with a full house, Aces full of Threes
Seat 9: ljemhp25Zg+nlA9DLCIiUw folded before Flop (didn't bet)




PokerStars Game #59941819810:  Hold'em No Limit ($0.10/$0.25) - 2009/07/01 1:47:10 ET
Table '3760QYRYyCWeXf0rLZ5S2g' 9-max Seat #7 is the button
Seat 1: CT7Xj/V/O5rBlhtt+RZeFQ ($27.90 in chips) 
Seat 2: zDrucyjVn5aeekNEc3cJrA ($27.45 in chips) 
Seat 3: X78b5v/uhqeXXoAijbw/yg ($25.60 in chips) 
Seat 4: ziFpkH3wCzqB/qXeq/Hy7g ($25 in chips) 
Seat 5: Bb42QRQMhg5/Y0vHP8/2Xw ($28.70 in chips) 
Seat 6: q+Qdg0Hoir+SyL7haBrUnw ($13.25 in chips) 
Seat 7: 6C2DoQ+GZHBOpb+qyrSnqA ($5.75 in chips) 
Seat 8: clJsV3v77RS07bDKY+705w ($5.35 in chips) 
clJsV3v77RS07bDKY+705w: posts small blind $0.10
sGFnnRCa1YAHAUmWgsW6Qg: is sitting out 
sGFnnRCa1YAHAUmWgsW6Qg leaves the table
CT7Xj/V/O5rBlhtt+RZeFQ: posts big blind $0.25
*** HOLE CARDS ***
zDrucyjVn5aeekNEc3cJrA: folds 
X78b5v/uhqeXXoAijbw/yg: folds 
ziFpkH3wCzqB/qXeq/Hy7g: folds 
Bb42QRQMhg5/Y0vHP8/2Xw: folds 
q+Qdg0Hoir+SyL7haBrUnw: raises $0.50 to $0.75
6C2DoQ+GZHBOpb+qyrSnqA: folds 
clJsV3v77RS07bDKY+705w: folds 
CT7Xj/V/O5rBlhtt+RZeFQ: folds 
Uncalled bet ($0.50) returned to q+Qdg0Hoir+SyL7haBrUnw
q+Qdg0Hoir+SyL7haBrUnw collected $0.60 from pot
*** SUMMARY ***
Total pot $0.60 | Rake $0 
Seat 1: CT7Xj/V/O5rBlhtt+RZeFQ (big blind) folded before Flop
Seat 2: zDrucyjVn5aeekNEc3cJrA folded before Flop (didn't bet)
Seat 3: X78b5v/uhqeXXoAijbw/yg folded before Flop (didn't bet)
Seat 4: ziFpkH3wCzqB/qXeq/Hy7g folded before Flop (didn't bet)
Seat 5: Bb42QRQMhg5/Y0vHP8/2Xw folded before Flop (didn't bet)
Seat 6: q+Qdg0Hoir+SyL7haBrUnw collected ($0.60)
Seat 7: 6C2DoQ+GZHBOpb+qyrSnqA (button) folded before Flop (didn't bet)
Seat 8: clJsV3v77RS07bDKY+705w (small blind) folded before Flop




PokerStars Game #59941819924:  Hold'em No Limit ($0.10/$0.25) - 2009/07/01 1:47:10 ET
Table 'nQC9LRg01NEuKFHF1nrDEw0XPo7K54oZIfG0xlNAcDRw-max Seat #6 is the button
Seat 1: qf+LMbROj8/qY878wkFHbQ ($14.55 in chips) 
Seat 2: ZhV6dUX9NQhT4zf7t+ZLJg ($20.60 in chips) 
Seat 3: 6+g0Lb6vfRDZkElV8ieHyQ ($26.45 in chips) 
Seat 5: kG34n23qFQA3nzdOJTQ1dA ($28.70 in chips) 
Seat 6: xQVFeVUDopz+akuEo2wXpQ ($55.80 in chips) 
qf+LMbROj8/qY878wkFHbQ: posts small blind $0.10
ZhV6dUX9NQhT4zf7t+ZLJg: posts big blind $0.25
u3Ol7kv1LmvszuHNm9rc6w: sits out 
*** HOLE CARDS ***
6+g0Lb6vfRDZkElV8ieHyQ: folds 
kG34n23qFQA3nzdOJTQ1dA: folds 
xQVFeVUDopz+akuEo2wXpQ: calls $0.25
qf+LMbROj8/qY878wkFHbQ: calls $0.15
ZhV6dUX9NQhT4zf7t+ZLJg: checks 
*** FLOP *** [5s 4h Qh]
qf+LMbROj8/qY878wkFHbQ: checks 
ZhV6dUX9NQhT4zf7t+ZLJg: bets $0.75
xQVFeVUDopz+akuEo2wXpQ: folds 
qf+LMbROj8/qY878wkFHbQ: folds 
Uncalled bet ($0.75) returned to ZhV6dUX9NQhT4zf7t+ZLJg
ZhV6dUX9NQhT4zf7t+ZLJg collected $0.75 from pot
*** SUMMARY ***
Total pot $0.75 | Rake $0 
Board [5s 4h Qh]
Seat 1: qf+LMbROj8/qY878wkFHbQ (small blind) folded on the Flop
Seat 2: ZhV6dUX9NQhT4zf7t+ZLJg (big blind) collected ($0.75)
Seat 3: 6+g0Lb6vfRDZkElV8ieHyQ folded before Flop (didn't bet)
Seat 5: kG34n23qFQA3nzdOJTQ1dA folded before Flop (didn't bet)
Seat 6: xQVFeVUDopz+akuEo2wXpQ (button) folded on the Flop




PokerStars Game #59941819766:  Hold'em No Limit ($0.10/$0.25) - 2009/07/01 1:47:10 ET
Table 'tANpk8z1C5o0Pq/hpYShHw' 9-max Seat #6 is the button
Seat 1: rQhYIYXSyH/IivYM1dlV5A ($16.90 in chips) 
Seat 2: og4yH4sZUZdC8jjgW8zPJQ ($8.60 in chips) 
Seat 3: zDrucyjVn5aeekNEc3cJrA ($18.55 in chips) 
Seat 4: j4q3p0lesp63b1gZDwLBZw ($5 in chips) 
Seat 5: X6+pSIPfovPcE87t+LmUKQ ($8.55 in chips) 
Seat 6: kN0AWJG6biW8tHtuF+wTjA ($10.30 in chips) 
Seat 7: aNpwfA31EREwO+ar4XzBCw ($27.05 in chips) 
Seat 8: Z9W7+g1WMhhZDi7DwGbCFA ($5 in chips) 
Seat 9: gE5rN2TDY1aXcZn/TOPeZw ($7.95 in chips) 
aNpwfA31EREwO+ar4XzBCw: posts small blind $0.10
Z9W7+g1WMhhZDi7DwGbCFA: posts big blind $0.25
*** HOLE CARDS ***
gE5rN2TDY1aXcZn/TOPeZw: calls $0.25
rQhYIYXSyH/IivYM1dlV5A: raises $0.75 to $1
og4yH4sZUZdC8jjgW8zPJQ: folds 
zDrucyjVn5aeekNEc3cJrA: folds 
j4q3p0lesp63b1gZDwLBZw: folds 
X6+pSIPfovPcE87t+LmUKQ: folds 
kN0AWJG6biW8tHtuF+wTjA: folds 
aNpwfA31EREwO+ar4XzBCw: folds 
Z9W7+g1WMhhZDi7DwGbCFA: folds 
gE5rN2TDY1aXcZn/TOPeZw: folds 
Uncalled bet ($0.75) returned to rQhYIYXSyH/IivYM1dlV5A
rQhYIYXSyH/IivYM1dlV5A collected $0.85 from pot
*** SUMMARY ***
Total pot $0.85 | Rake $0 
Seat 1: rQhYIYXSyH/IivYM1dlV5A collected ($0.85)
Seat 2: og4yH4sZUZdC8jjgW8zPJQ folded before Flop (didn't bet)
Seat 3: zDrucyjVn5aeekNEc3cJrA folded before Flop (didn't bet)
Seat 4: j4q3p0lesp63b1gZDwLBZw folded before Flop (didn't bet)
Seat 5: X6+pSIPfovPcE87t+LmUKQ folded before Flop (didn't bet)
Seat 6: kN0AWJG6biW8tHtuF+wTjA (button) folded before Flop (didn't bet)
Seat 7: aNpwfA31EREwO+ar4XzBCw (small blind) folded before Flop
Seat 8: Z9W7+g1WMhhZDi7DwGbCFA (big blind) folded before Flop
Seat 9: gE5rN2TDY1aXcZn/TOPeZw folded before Flop




PokerStars Game #59941819796:  Hold'em No Limit ($0.10/$0.25) - 2009/07/01 1:47:10 ET
Table 'l8hUTjBTXBorNUR/tyvSLw' 9-max Seat #7 is the button
Seat 1: cZ99hugmLBj9KhTlc8nCSw ($27.85 in chips) 
Seat 2: B6xHiX1SJkS0CUNCKDVwuQ ($21.50 in chips) 
Seat 3: ShCS62CJp4MKfKLKvGKQbA ($9.10 in chips) 
Seat 4: vPtFvcPtn/Afz0sucO1cmQ ($36.70 in chips) 
Seat 5: yyG4svzOpC1A+sUP/scg6w ($6.50 in chips) 
Seat 6: EVqHvqty1ZsuvDFiSXlSqQ ($23.95 in chips) 
Seat 7: F7pnn6czNpHvRM55XcA2EA ($33.90 in chips) 
Seat 8: Mh2r9hTeTEDnh19sRZtW3g ($4.75 in chips) 
Seat 9: zDrucyjVn5aeekNEc3cJrA ($32.70 in chips) 
Mh2r9hTeTEDnh19sRZtW3g: posts small blind $0.10
zDrucyjVn5aeekNEc3cJrA: posts big blind $0.25
*** HOLE CARDS ***
cZ99hugmLBj9KhTlc8nCSw: raises $0.50 to $0.75
B6xHiX1SJkS0CUNCKDVwuQ: folds 
ShCS62CJp4MKfKLKvGKQbA: folds 
vPtFvcPtn/Afz0sucO1cmQ: folds 
yyG4svzOpC1A+sUP/scg6w: folds 
EVqHvqty1ZsuvDFiSXlSqQ: folds 
F7pnn6czNpHvRM55XcA2EA: folds 
Mh2r9hTeTEDnh19sRZtW3g: folds 
zDrucyjVn5aeekNEc3cJrA: folds 
Uncalled bet ($0.50) returned to cZ99hugmLBj9KhTlc8nCSw
cZ99hugmLBj9KhTlc8nCSw collected $0.60 from pot
*** SUMMARY ***
Total pot $0.60 | Rake $0 
Seat 1: cZ99hugmLBj9KhTlc8nCSw collected ($0.60)
Seat 2: B6xHiX1SJkS0CUNCKDVwuQ folded before Flop (didn't bet)
Seat 3: ShCS62CJp4MKfKLKvGKQbA folded before Flop (didn't bet)
Seat 4: vPtFvcPtn/Afz0sucO1cmQ folded before Flop (didn't bet)
Seat 5: yyG4svzOpC1A+sUP/scg6w folded before Flop (didn't bet)
Seat 6: EVqHvqty1ZsuvDFiSXlSqQ folded before Flop (didn't bet)
Seat 7: F7pnn6czNpHvRM55XcA2EA (button) folded before Flop (didn't bet)
Seat 8: Mh2r9hTeTEDnh19sRZtW3g (small blind) folded before Flop
Seat 9: zDrucyjVn5aeekNEc3cJrA (big blind) folded before Flop




PokerStars Game #59941820430:  Hold'em No Limit ($0.10/$0.25) - 2009/07/01 1:47:11 ET
Table 'aisAlB9GIV21BwfUW3+Nbg' 9-max Seat #4 is the button
Seat 1: SqibpGx+lf+brY0fJVvD0w ($24.30 in chips) 
Seat 2: Z9AeOQX3yzuSvKAm/xyovg ($10 in chips) 
Seat 3: CvL9Ch1HYCVbTsfpNucitg ($4.55 in chips) 
Seat 4: sD+TKtt36XiiN6jqHiLwDA ($25.10 in chips) 
Seat 5: ghNKXUBl/H+t83JF079ZBA ($26 in chips) 
Seat 6: 9gmYYQesalMrUjaF7nKfrQ ($16.20 in chips) 
Seat 7: jGjM+5lCSe6f2MEwxQGOAg ($23.60 in chips) 
Seat 8: VWUWpMLMj/Q1jRVpF7Aohw ($26.30 in chips) 
Seat 9: N0hGpTAEAj9k5msS6LPLAw ($22.10 in chips) 
ghNKXUBl/H+t83JF079ZBA: posts small blind $0.10
9gmYYQesalMrUjaF7nKfrQ: posts big blind $0.25
Z9AeOQX3yzuSvKAm/xyovg: posts big blind $0.25
*** HOLE CARDS ***
jGjM+5lCSe6f2MEwxQGOAg: raises $0.25 to $0.50
VWUWpMLMj/Q1jRVpF7Aohw: folds 
N0hGpTAEAj9k5msS6LPLAw: calls $0.50
SqibpGx+lf+brY0fJVvD0w: folds 
Z9AeOQX3yzuSvKAm/xyovg: raises $1 to $1.50
CvL9Ch1HYCVbTsfpNucitg: folds 
sD+TKtt36XiiN6jqHiLwDA: folds 
ghNKXUBl/H+t83JF079ZBA: folds 
9gmYYQesalMrUjaF7nKfrQ: folds 
jGjM+5lCSe6f2MEwxQGOAg: folds 
N0hGpTAEAj9k5msS6LPLAw: calls $1
*** FLOP *** [Qs 6s 6d]
N0hGpTAEAj9k5msS6LPLAw: checks 
Z9AeOQX3yzuSvKAm/xyovg: bets $3.50
N0hGpTAEAj9k5msS6LPLAw: folds 
Uncalled bet ($3.50) returned to Z9AeOQX3yzuSvKAm/xyovg
Z9AeOQX3yzuSvKAm/xyovg collected $3.70 from pot
*** SUMMARY ***
Total pot $3.85 | Rake $0.15 
Board [Qs 6s 6d]
Seat 1: SqibpGx+lf+brY0fJVvD0w folded before Flop (didn't bet)
Seat 2: Z9AeOQX3yzuSvKAm/xyovg collected ($3.70)
Seat 3: CvL9Ch1HYCVbTsfpNucitg folded before Flop (didn't bet)
Seat 4: sD+TKtt36XiiN6jqHiLwDA (button) folded before Flop (didn't bet)
Seat 5: ghNKXUBl/H+t83JF079ZBA (small blind) folded before Flop
Seat 6: 9gmYYQesalMrUjaF7nKfrQ (big blind) folded before Flop
Seat 7: jGjM+5lCSe6f2MEwxQGOAg folded before Flop
Seat 8: VWUWpMLMj/Q1jRVpF7Aohw folded before Flop (didn't bet)
Seat 9: N0hGpTAEAj9k5msS6LPLAw folded on the Flop




PokerStars Game #59941820532:  Hold'em No Limit ($0.10/$0.25) - 2009/07/01 1:47:11 ET
Table 'x7YStLKc8hpt/pTgSetPKA' 9-max Seat #3 is the button
Seat 1: tYsOBqdU1+x+yFI7zHO7hQ ($25.90 in chips) 
Seat 3: S7Ki0P+0AIGPuIfGJjW0gg ($11.60 in chips) 
Seat 4: ydoFOVgzvZv9ZhuWu9rXAw ($4.90 in chips) 
Seat 5: tLcDklc2rBORNfixyRfVfw ($25 in chips) 
Seat 6: 9YN2IkT2JYYKFErZtZvCtA ($49.25 in chips) 
Seat 7: dtZ84flFEi4Q+SGrHMJRDQ ($26 in chips) 
Seat 8: j4q3p0lesp63b1gZDwLBZw ($5 in chips) 
Seat 9: nm4Dj/f+jJEwKVsUnKh73g ($35.95 in chips) 
ydoFOVgzvZv9ZhuWu9rXAw: posts small blind $0.10
tLcDklc2rBORNfixyRfVfw: posts big blind $0.25
*** HOLE CARDS ***
9YN2IkT2JYYKFErZtZvCtA: folds 
dtZ84flFEi4Q+SGrHMJRDQ: folds 
j4q3p0lesp63b1gZDwLBZw: folds 
nm4Dj/f+jJEwKVsUnKh73g: raises $0.75 to $1
tYsOBqdU1+x+yFI7zHO7hQ: folds 
S7Ki0P+0AIGPuIfGJjW0gg: calls $1
ydoFOVgzvZv9ZhuWu9rXAw: folds 
tLcDklc2rBORNfixyRfVfw: folds 
*** FLOP *** [Kh 4c Qs]
nm4Dj/f+jJEwKVsUnKh73g: bets $1
S7Ki0P+0AIGPuIfGJjW0gg: folds 
Uncalled bet ($1) returned to nm4Dj/f+jJEwKVsUnKh73g
nm4Dj/f+jJEwKVsUnKh73g collected $2.25 from pot
nm4Dj/f+jJEwKVsUnKh73g: doesn't show hand 
*** SUMMARY ***
Total pot $2.35 | Rake $0.10 
Board [Kh 4c Qs]
Seat 1: tYsOBqdU1+x+yFI7zHO7hQ folded before Flop (didn't bet)
Seat 3: S7Ki0P+0AIGPuIfGJjW0gg (button) folded on the Flop
Seat 4: ydoFOVgzvZv9ZhuWu9rXAw (small blind) folded before Flop
Seat 5: tLcDklc2rBORNfixyRfVfw (big blind) folded before Flop
Seat 6: 9YN2IkT2JYYKFErZtZvCtA folded before Flop (didn't bet)
Seat 7: dtZ84flFEi4Q+SGrHMJRDQ folded before Flop (didn't bet)
Seat 8: j4q3p0lesp63b1gZDwLBZw folded before Flop (didn't bet)
Seat 9: nm4Dj/f+jJEwKVsUnKh73g collected ($2.25)




PokerStars Game #59941820514:  Hold'em No Limit ($0.10/$0.25) - 2009/07/01 1:47:11 ET
Table '+68ihX5Br1xgGorX6zsCBg' 9-max Seat #2 is the button
Seat 1: IFB2mhulUVYIbb+KWwDC9w ($3.95 in chips) 
Seat 2: TeAfhXG1R60d8yPEHN3JiA ($27.90 in chips) 
Seat 3: PdIasPkzm2sqZnN41ZRXOg ($4.75 in chips) 
Seat 4: Oi0EiPIjriUb/6zT65YeWA ($26.95 in chips) 
Seat 5: ghNKXUBl/H+t83JF079ZBA ($29 in chips) 
Seat 6: X78b5v/uhqeXXoAijbw/yg ($26.40 in chips) 
Seat 7: V6p0jQ/RhUsqpHLmXvEX4Q ($16.45 in chips) 
Seat 9: DiSvPC2iudwL5j9u6Huyww ($32.75 in chips) 
PdIasPkzm2sqZnN41ZRXOg: posts small blind $0.10
Oi0EiPIjriUb/6zT65YeWA: posts big blind $0.25
*** HOLE CARDS ***
ghNKXUBl/H+t83JF079ZBA: folds 
X78b5v/uhqeXXoAijbw/yg: folds 
V6p0jQ/RhUsqpHLmXvEX4Q: folds 
DiSvPC2iudwL5j9u6Huyww: folds 
IFB2mhulUVYIbb+KWwDC9w: folds 
TeAfhXG1R60d8yPEHN3JiA: folds 
PdIasPkzm2sqZnN41ZRXOg: folds 
Uncalled bet ($0.15) returned to Oi0EiPIjriUb/6zT65YeWA
Oi0EiPIjriUb/6zT65YeWA collected $0.20 from pot
Oi0EiPIjriUb/6zT65YeWA: doesn't show hand 
*** SUMMARY ***
Total pot $0.20 | Rake $0 
Seat 1: IFB2mhulUVYIbb+KWwDC9w folded before Flop (didn't bet)
Seat 2: TeAfhXG1R60d8yPEHN3JiA (button) folded before Flop (didn't bet)
Seat 3: PdIasPkzm2sqZnN41ZRXOg (small blind) folded before Flop
Seat 4: Oi0EiPIjriUb/6zT65YeWA (big blind) collected ($0.20)
Seat 5: ghNKXUBl/H+t83JF079ZBA folded before Flop (didn't bet)
Seat 6: X78b5v/uhqeXXoAijbw/yg folded before Flop (didn't bet)
Seat 7: V6p0jQ/RhUsqpHLmXvEX4Q folded before Flop (didn't bet)
Seat 9: DiSvPC2iudwL5j9u6Huyww folded before Flop (didn't bet)




PokerStars Game #59941820434:  Hold'em No Limit ($0.10/$0.25) - 2009/07/01 1:47:11 ET
Table 'zW+7jPbOLCvlPu+dUGY5WQ' 6-max Seat #5 is the button
Seat 1: eL3+wCBjFGfQ5FMdIZihwA ($26.50 in chips) 
Seat 2: cEMJmfAUQZmMChZe6aacKw ($10.20 in chips) 
Seat 4: i48129QFpEQQ+UN4aNtmww ($18.55 in chips) 
Seat 5: Hsvkc0/G2VV78oVmWYXecw ($5 in chips) 
Seat 6: qGHGf/553gQnDoklMRe3tg ($25.10 in chips) 
qGHGf/553gQnDoklMRe3tg: posts small blind $0.10
eL3+wCBjFGfQ5FMdIZihwA: posts big blind $0.25
*** HOLE CARDS ***
cEMJmfAUQZmMChZe6aacKw: folds 
i48129QFpEQQ+UN4aNtmww: folds 
Hsvkc0/G2VV78oVmWYXecw: raises $0.50 to $0.75
qGHGf/553gQnDoklMRe3tg: folds 
eL3+wCBjFGfQ5FMdIZihwA: folds 
Uncalled bet ($0.50) returned to Hsvkc0/G2VV78oVmWYXecw
Hsvkc0/G2VV78oVmWYXecw collected $0.60 from pot
Hsvkc0/G2VV78oVmWYXecw: doesn't show hand 
*** SUMMARY ***
Total pot $0.60 | Rake $0 
Seat 1: eL3+wCBjFGfQ5FMdIZihwA (big blind) folded before Flop
Seat 2: cEMJmfAUQZmMChZe6aacKw folded before Flop (didn't bet)
Seat 4: i48129QFpEQQ+UN4aNtmww folded before Flop (didn't bet)
Seat 5: Hsvkc0/G2VV78oVmWYXecw (button) collected ($0.60)
Seat 6: qGHGf/553gQnDoklMRe3tg (small blind) folded before Flop




PokerStars Game #59941820226:  Hold'em No Limit ($0.10/$0.25) - 2009/07/01 1:47:11 ET
Table 'HzFR0rxmDAPu5GzYR0AlYg' 6-max Seat #4 is the button
Seat 1: v+QfkGiuj9bgtuNoVnDO8w ($32.05 in chips) 
Seat 2: UA5OsKS3VPaxa7uC8La/kA ($51.25 in chips) 
Seat 3: kG34n23qFQA3nzdOJTQ1dA ($24.90 in chips) 
Seat 4: Mhj3q7cxev+XjXZxEE6/Cw ($25 in chips) 
Seat 5: lquriepNQBhDV5P1SWHhnA ($29.60 in chips) 
Seat 6: jp34e617tIzV8tKIWmfAbA ($35.90 in chips) 
lquriepNQBhDV5P1SWHhnA: posts small blind $0.10
jp34e617tIzV8tKIWmfAbA: posts big blind $0.25
*** HOLE CARDS ***
v+QfkGiuj9bgtuNoVnDO8w: folds 
UA5OsKS3VPaxa7uC8La/kA: folds 
kG34n23qFQA3nzdOJTQ1dA: folds 
Mhj3q7cxev+XjXZxEE6/Cw: raises $0.50 to $0.75
lquriepNQBhDV5P1SWHhnA: folds 
jp34e617tIzV8tKIWmfAbA: folds 
Uncalled bet ($0.50) returned to Mhj3q7cxev+XjXZxEE6/Cw
Mhj3q7cxev+XjXZxEE6/Cw collected $0.60 from pot
Mhj3q7cxev+XjXZxEE6/Cw: doesn't show hand 
*** SUMMARY ***
Total pot $0.60 | Rake $0 
Seat 1: v+QfkGiuj9bgtuNoVnDO8w folded before Flop (didn't bet)
Seat 2: UA5OsKS3VPaxa7uC8La/kA folded before Flop (didn't bet)
Seat 3: kG34n23qFQA3nzdOJTQ1dA folded before Flop (didn't bet)
Seat 4: Mhj3q7cxev+XjXZxEE6/Cw (button) collected ($0.60)
Seat 5: lquriepNQBhDV5P1SWHhnA (small blind) folded before Flop
Seat 6: jp34e617tIzV8tKIWmfAbA (big blind) folded before Flop




PokerStars Game #59941820444:  Hold'em No Limit ($0.10/$0.25) - 2009/07/01 1:47:11 ET
Table 'jdhJTJjFq2KTttwJcd+7nQ' 6-max Seat #5 is the button
Seat 1: LtASJ9OlkqGrrUKGQlpGAw ($26.85 in chips) 
Seat 2: Hsvkc0/G2VV78oVmWYXecw ($5 in chips) 
Seat 3: vqWjZmdQu/Hxw96/IJTWdQ ($25 in chips) 
Seat 4: vx7FwRcelVSsvNYAdp/z0A ($6.50 in chips) 
Seat 5: BV+K0Phf5VBHr7aZPKqbUQ ($25.75 in chips) 
Seat 6: yb6rnd48JuBccThV68VHAQ ($20.05 in chips) 
yb6rnd48JuBccThV68VHAQ: posts small blind $0.10
LtASJ9OlkqGrrUKGQlpGAw: posts big blind $0.25
*** HOLE CARDS ***
Hsvkc0/G2VV78oVmWYXecw: folds 
vqWjZmdQu/Hxw96/IJTWdQ: raises $0.50 to $0.75
vx7FwRcelVSsvNYAdp/z0A: folds 
BV+K0Phf5VBHr7aZPKqbUQ: folds 
yb6rnd48JuBccThV68VHAQ: calls $0.65
LtASJ9OlkqGrrUKGQlpGAw: folds 
*** FLOP *** [Kd 8s 5d]
yb6rnd48JuBccThV68VHAQ: checks 
vqWjZmdQu/Hxw96/IJTWdQ: bets $1
yb6rnd48JuBccThV68VHAQ: calls $1
*** TURN *** [Kd 8s 5d] [6s]
yb6rnd48JuBccThV68VHAQ: checks 
vqWjZmdQu/Hxw96/IJTWdQ: checks 
*** RIVER *** [Kd 8s 5d 6s] [Th]
yb6rnd48JuBccThV68VHAQ: bets $1
vqWjZmdQu/Hxw96/IJTWdQ: raises $1.75 to $2.75
yb6rnd48JuBccThV68VHAQ: calls $1.75
*** SHOW DOWN ***
vqWjZmdQu/Hxw96/IJTWdQ: shows [Ad As] (a pair of Aces)
yb6rnd48JuBccThV68VHAQ: mucks hand 
vqWjZmdQu/Hxw96/IJTWdQ collected $8.80 from pot
*** SUMMARY ***
Total pot $9.25 | Rake $0.45 
Board [Kd 8s 5d 6s Th]
Seat 1: LtASJ9OlkqGrrUKGQlpGAw (big blind) folded before Flop
Seat 2: Hsvkc0/G2VV78oVmWYXecw folded before Flop (didn't bet)
Seat 3: vqWjZmdQu/Hxw96/IJTWdQ showed [Ad As] and won ($8.80) with a pair of Aces
Seat 4: vx7FwRcelVSsvNYAdp/z0A folded before Flop (didn't bet)
Seat 5: BV+K0Phf5VBHr7aZPKqbUQ (button) folded before Flop (didn't bet)
Seat 6: yb6rnd48JuBccThV68VHAQ (small blind) mucked




PokerStars Game #59941820384:  Hold'em No Limit ($0.10/$0.25) - 2009/07/01 1:47:11 ET
Table 'biAgO3TKQBU8XcrVAoU5TA' 6-max Seat #3 is the button
Seat 1: jhDPlkir8wBYAddboBuF7Q ($16.55 in chips) 
Seat 2: GbCVUNssQ7mqsPWr7J4d3w ($7.15 in chips) 
Seat 3: mfrkWA3PTeYPkbO6hi98Aw ($31.65 in chips) 
Seat 4: Hsvkc0/G2VV78oVmWYXecw ($5 in chips) 
Seat 5: n6UPMnVR4v8LFP0rWP73Fg ($10.85 in chips) 
Seat 6: wMiE3yTbDJGOLOF9th7KPA ($8.60 in chips) 
Hsvkc0/G2VV78oVmWYXecw: posts small blind $0.10
n6UPMnVR4v8LFP0rWP73Fg: posts big blind $0.25
*** HOLE CARDS ***
wMiE3yTbDJGOLOF9th7KPA: folds 
jhDPlkir8wBYAddboBuF7Q: folds 
GbCVUNssQ7mqsPWr7J4d3w: folds 
mfrkWA3PTeYPkbO6hi98Aw: folds 
Hsvkc0/G2VV78oVmWYXecw: folds 
Uncalled bet ($0.15) returned to n6UPMnVR4v8LFP0rWP73Fg
n6UPMnVR4v8LFP0rWP73Fg collected $0.20 from pot
*** SUMMARY ***
Total pot $0.20 | Rake $0 
Seat 1: jhDPlkir8wBYAddboBuF7Q folded before Flop (didn't bet)
Seat 2: GbCVUNssQ7mqsPWr7J4d3w folded before Flop (didn't bet)
Seat 3: mfrkWA3PTeYPkbO6hi98Aw (button) folded before Flop (didn't bet)
Seat 4: Hsvkc0/G2VV78oVmWYXecw (small blind) folded before Flop
Seat 5: n6UPMnVR4v8LFP0rWP73Fg (big blind) collected ($0.20)
Seat 6: wMiE3yTbDJGOLOF9th7KPA folded before Flop (didn't bet)




PokerStars Game #59941820400:  Hold'em No Limit ($0.10/$0.25) - 2009/07/01 1:47:11 ET
Table 'qryc9C/ELyQ3lubOaELNAQ' 6-max Seat #4 is the button
Seat 1: OZc6kkoTwtITj1ZfreJK1A ($65.85 in chips) 
Seat 2: LtASJ9OlkqGrrUKGQlpGAw ($30.30 in chips) 
Seat 3: wvIIdlbCgePONQwXjx9xzQ ($4.20 in chips) 
Seat 4: v+QfkGiuj9bgtuNoVnDO8w ($25 in chips) 
Seat 5: 9StOHp+Y1T0K13JdgS2oQQ ($37.15 in chips) 
Seat 6: xmdItDBraeGrrs3wzz1J3w ($20 in chips) 
9StOHp+Y1T0K13JdgS2oQQ: posts small blind $0.10
xmdItDBraeGrrs3wzz1J3w: posts big blind $0.25
*** HOLE CARDS ***
OZc6kkoTwtITj1ZfreJK1A: raises $0.75 to $1
LtASJ9OlkqGrrUKGQlpGAw: folds 
wvIIdlbCgePONQwXjx9xzQ: folds 
v+QfkGiuj9bgtuNoVnDO8w: folds 
9StOHp+Y1T0K13JdgS2oQQ: folds 
xmdItDBraeGrrs3wzz1J3w: folds 
Uncalled bet ($0.75) returned to OZc6kkoTwtITj1ZfreJK1A
OZc6kkoTwtITj1ZfreJK1A collected $0.60 from pot
OZc6kkoTwtITj1ZfreJK1A: doesn't show hand 
*** SUMMARY ***
Total pot $0.60 | Rake $0 
Seat 1: OZc6kkoTwtITj1ZfreJK1A collected ($0.60)
Seat 2: LtASJ9OlkqGrrUKGQlpGAw folded before Flop (didn't bet)
Seat 3: wvIIdlbCgePONQwXjx9xzQ folded before Flop (didn't bet)
Seat 4: v+QfkGiuj9bgtuNoVnDO8w (button) folded before Flop (didn't bet)
Seat 5: 9StOHp+Y1T0K13JdgS2oQQ (small blind) folded before Flop
Seat 6: xmdItDBraeGrrs3wzz1J3w (big blind) folded before Flop




PokerStars Game #59941820576:  Hold'em No Limit ($0.10/$0.25) - 2009/07/01 1:47:11 ET
Table '7/qMNloI0nSXWiX5Y1watA' 9-max Seat #3 is the button
Seat 1: /LyhaB3V6jkgOfXORidqRQ ($6.75 in chips) 
Seat 2: wGigCmBR/9XWkPpvYos3aQ ($25.10 in chips) 
Seat 3: W2YYHvqjaEpRrO7stZkClQ ($4 in chips) 
Seat 4: K0LdhPeU31rviEPo6Sv3TA ($8.40 in chips) 
Seat 6: Y3DZ6qQlLeBhixDj4M9vmg ($16.35 in chips) 
Seat 8: ljemhp25Zg+nlA9DLCIiUw ($26.40 in chips) 
Seat 9: dmYlc+1cjwZMJ7wV+Z0rRg ($27.05 in chips) 
K0LdhPeU31rviEPo6Sv3TA: posts small blind $0.10
Y3DZ6qQlLeBhixDj4M9vmg: posts big blind $0.25
*** HOLE CARDS ***
ljemhp25Zg+nlA9DLCIiUw: folds 
dmYlc+1cjwZMJ7wV+Z0rRg: folds 
/LyhaB3V6jkgOfXORidqRQ: raises $0.25 to $0.50
wGigCmBR/9XWkPpvYos3aQ: folds 
W2YYHvqjaEpRrO7stZkClQ: folds 
K0LdhPeU31rviEPo6Sv3TA: folds 
Y3DZ6qQlLeBhixDj4M9vmg: calls $0.25
*** FLOP *** [2d Kh Ts]
Y3DZ6qQlLeBhixDj4M9vmg: checks 
/LyhaB3V6jkgOfXORidqRQ: bets $0.50
Y3DZ6qQlLeBhixDj4M9vmg: calls $0.50
*** TURN *** [2d Kh Ts] [Kc]
Y3DZ6qQlLeBhixDj4M9vmg: checks 
/LyhaB3V6jkgOfXORidqRQ: bets $0.50
Y3DZ6qQlLeBhixDj4M9vmg: calls $0.50
*** RIVER *** [2d Kh Ts Kc] [9s]
Y3DZ6qQlLeBhixDj4M9vmg: checks 
/LyhaB3V6jkgOfXORidqRQ: bets $0.75
Y3DZ6qQlLeBhixDj4M9vmg: folds 
Uncalled bet ($0.75) returned to /LyhaB3V6jkgOfXORidqRQ
/LyhaB3V6jkgOfXORidqRQ collected $2.95 from pot
*** SUMMARY ***
Total pot $3.10 | Rake $0.15 
Board [2d Kh Ts Kc 9s]
Seat 1: /LyhaB3V6jkgOfXORidqRQ collected ($2.95)
Seat 2: wGigCmBR/9XWkPpvYos3aQ folded before Flop (didn't bet)
Seat 3: W2YYHvqjaEpRrO7stZkClQ (button) folded before Flop (didn't bet)
Seat 4: K0LdhPeU31rviEPo6Sv3TA (small blind) folded before Flop
Seat 6: Y3DZ6qQlLeBhixDj4M9vmg (big blind) folded on the River
Seat 8: ljemhp25Zg+nlA9DLCIiUw folded before Flop (didn't bet)
Seat 9: dmYlc+1cjwZMJ7wV+Z0rRg folded before Flop (didn't bet)




PokerStars Game #59941820962:  Hold'em No Limit ($0.10/$0.25) - 2009/07/01 1:47:12 ET
Table 'TJS4XvvOjO3k7mH74HJw5g' 9-max Seat #9 is the button
Seat 1: K8I2mpRME07ZlOsT2x75Lg ($8.05 in chips) 
Seat 2: yqkowiRWZ6NvRN9UUkYIlA ($5 in chips) 
Seat 5: UlMB386Cfzy3EwurQoBjcA ($9.70 in chips) 
Seat 6: SRik8xyC/rVIBoX7VaOoMA ($13.90 in chips) 
Seat 7: B9u+i1s5aZZkmLTLUopTBg ($14.65 in chips) 
Seat 8: Qv4VzEkN09uD11sjKv02Ig ($17.95 in chips) 
Seat 9: +sbyWwIcFp9kP0bDtMegfQ ($42.30 in chips) 
K8I2mpRME07ZlOsT2x75Lg: posts small blind $0.10
yqkowiRWZ6NvRN9UUkYIlA: posts big blind $0.25
8EbrQ/EvFWt2cr0GaU82gQ: sits out 
clJsV3v77RS07bDKY+705w: sits out 
*** HOLE CARDS ***
UlMB386Cfzy3EwurQoBjcA: folds 
SRik8xyC/rVIBoX7VaOoMA: calls $0.25
B9u+i1s5aZZkmLTLUopTBg: calls $0.25
Qv4VzEkN09uD11sjKv02Ig: folds 
+sbyWwIcFp9kP0bDtMegfQ: folds 
K8I2mpRME07ZlOsT2x75Lg: folds 
yqkowiRWZ6NvRN9UUkYIlA: raises $1 to $1.25
SRik8xyC/rVIBoX7VaOoMA: calls $1
B9u+i1s5aZZkmLTLUopTBg: folds 
*** FLOP *** [8h Jc 6c]
yqkowiRWZ6NvRN9UUkYIlA: bets $1.75
SRik8xyC/rVIBoX7VaOoMA: raises $1.75 to $3.50
yqkowiRWZ6NvRN9UUkYIlA: raises $0.25 to $3.75 and is all-in
SRik8xyC/rVIBoX7VaOoMA: calls $0.25
*** TURN *** [8h Jc 6c] [Jd]
*** RIVER *** [8h Jc 6c Jd] [5s]
*** SHOW DOWN ***
yqkowiRWZ6NvRN9UUkYIlA: shows [Ac Ah] (two pair, Aces and Jacks)
SRik8xyC/rVIBoX7VaOoMA: mucks hand 
yqkowiRWZ6NvRN9UUkYIlA collected $9.85 from pot
*** SUMMARY ***
Total pot $10.35 | Rake $0.50 
Board [8h Jc 6c Jd 5s]
Seat 1: K8I2mpRME07ZlOsT2x75Lg (small blind) folded before Flop
Seat 2: yqkowiRWZ6NvRN9UUkYIlA (big blind) showed [Ac Ah] and won ($9.85) with two pair, Aces and Jacks
Seat 5: UlMB386Cfzy3EwurQoBjcA folded before Flop (didn't bet)
Seat 6: SRik8xyC/rVIBoX7VaOoMA mucked
Seat 7: B9u+i1s5aZZkmLTLUopTBg folded before Flop
Seat 8: Qv4VzEkN09uD11sjKv02Ig folded before Flop (didn't bet)
Seat 9: +sbyWwIcFp9kP0bDtMegfQ (button) folded before Flop (didn't bet)




PokerStars Game #59941820882:  Hold'em No Limit ($0.10/$0.25) - 2009/07/01 1:47:12 ET
Table 'IUwZ/e0bDHZPgsIWx0RnNg' 6-max Seat #6 is the button
Seat 1: V66QiVCQPofyl3a+dpPHQQ ($4.80 in chips) 
Seat 2: mvFHK3pE7tCxJEqLjKC70Q ($55.95 in chips) 
Seat 3: dOX4wnYV2sEqvDbF+8KSCw ($27.25 in chips) 
Seat 4: OIjOiBfQstWrK/RuXx7zcw ($4.45 in chips) 
Seat 5: 9bpVv1/Qh9IYtXuCtl5VtQ ($24.65 in chips) 
Seat 6: NhUN/JpAprdJeamFBgJH1w ($38.90 in chips) 
V66QiVCQPofyl3a+dpPHQQ: posts small blind $0.10
mvFHK3pE7tCxJEqLjKC70Q: posts big blind $0.25
*** HOLE CARDS ***
dOX4wnYV2sEqvDbF+8KSCw: raises $0.75 to $1
OIjOiBfQstWrK/RuXx7zcw: folds 
9bpVv1/Qh9IYtXuCtl5VtQ: folds 
NhUN/JpAprdJeamFBgJH1w: folds 
V66QiVCQPofyl3a+dpPHQQ: calls $0.90
mvFHK3pE7tCxJEqLjKC70Q: folds 
*** FLOP *** [2h 4h Td]
V66QiVCQPofyl3a+dpPHQQ: checks 
dOX4wnYV2sEqvDbF+8KSCw: checks 
*** TURN *** [2h 4h Td] [2d]
V66QiVCQPofyl3a+dpPHQQ: checks 
dOX4wnYV2sEqvDbF+8KSCw: checks 
*** RIVER *** [2h 4h Td 2d] [7s]
V66QiVCQPofyl3a+dpPHQQ: bets $3.80 and is all-in
dOX4wnYV2sEqvDbF+8KSCw: folds 
Uncalled bet ($3.80) returned to V66QiVCQPofyl3a+dpPHQQ
V66QiVCQPofyl3a+dpPHQQ collected $2.15 from pot
*** SUMMARY ***
Total pot $2.25 | Rake $0.10 
Board [2h 4h Td 2d 7s]
Seat 1: V66QiVCQPofyl3a+dpPHQQ (small blind) collected ($2.15)
Seat 2: mvFHK3pE7tCxJEqLjKC70Q (big blind) folded before Flop
Seat 3: dOX4wnYV2sEqvDbF+8KSCw folded on the River
Seat 4: OIjOiBfQstWrK/RuXx7zcw folded before Flop (didn't bet)
Seat 5: 9bpVv1/Qh9IYtXuCtl5VtQ folded before Flop (didn't bet)
Seat 6: NhUN/JpAprdJeamFBgJH1w (button) folded before Flop (didn't bet)




PokerStars Game #59941820770:  Hold'em No Limit ($0.10/$0.25) - 2009/07/01 1:47:12 ET
Table 'O5NgMYt6EWbLBozZb3kseg' 6-max Seat #3 is the button
Seat 1: AxhCSFlGEh+FAc+VUD31JQ ($15 in chips) 
Seat 2: ZZm/rg8aThjE+A2LiItuzA ($10 in chips) 
Seat 3: nEezgRkm8mxa3J5ySz1mJQ ($9.85 in chips) 
Seat 4: ItRgvLhXTZHvtZowz+dbIw ($13 in chips) 
Seat 5: u3Ol7kv1LmvszuHNm9rc6w ($25 in chips) 
Seat 6: 3m6VfX7io8SA31qh1zCkgQ ($6 in chips) 
ItRgvLhXTZHvtZowz+dbIw: posts small blind $0.10
u3Ol7kv1LmvszuHNm9rc6w: posts big blind $0.25
3m6VfX7io8SA31qh1zCkgQ: posts big blind $0.25
AxhCSFlGEh+FAc+VUD31JQ: posts big blind $0.25
ZZm/rg8aThjE+A2LiItuzA: posts big blind $0.25
*** HOLE CARDS ***
3m6VfX7io8SA31qh1zCkgQ: checks 
AxhCSFlGEh+FAc+VUD31JQ: checks 
ZZm/rg8aThjE+A2LiItuzA: checks 
nEezgRkm8mxa3J5ySz1mJQ: raises $0.50 to $0.75
ItRgvLhXTZHvtZowz+dbIw: folds 
u3Ol7kv1LmvszuHNm9rc6w: folds 
3m6VfX7io8SA31qh1zCkgQ: calls $0.50
AxhCSFlGEh+FAc+VUD31JQ: calls $0.50
ZZm/rg8aThjE+A2LiItuzA: folds 
*** FLOP *** [7h 4h 7d]
3m6VfX7io8SA31qh1zCkgQ: checks 
AxhCSFlGEh+FAc+VUD31JQ: bets $1.50
nEezgRkm8mxa3J5ySz1mJQ: calls $1.50
3m6VfX7io8SA31qh1zCkgQ: calls $1.50
*** TURN *** [7h 4h 7d] [6s]
3m6VfX7io8SA31qh1zCkgQ: checks 
AxhCSFlGEh+FAc+VUD31JQ: checks 
nEezgRkm8mxa3J5ySz1mJQ: bets $1
3m6VfX7io8SA31qh1zCkgQ: raises $2.75 to $3.75 and is all-in
AxhCSFlGEh+FAc+VUD31JQ: folds 
nEezgRkm8mxa3J5ySz1mJQ: calls $2.75
*** RIVER *** [7h 4h 7d 6s] [Tc]
*** SHOW DOWN ***
3m6VfX7io8SA31qh1zCkgQ: shows [9h 8h] (a straight, Six to Ten)
nEezgRkm8mxa3J5ySz1mJQ: mucks hand 
3m6VfX7io8SA31qh1zCkgQ collected $14.15 from pot
*** SUMMARY ***
Total pot $14.85 | Rake $0.70 
Board [7h 4h 7d 6s Tc]
Seat 1: AxhCSFlGEh+FAc+VUD31JQ folded on the Turn
Seat 2: ZZm/rg8aThjE+A2LiItuzA folded before Flop
Seat 3: nEezgRkm8mxa3J5ySz1mJQ (button) mucked
Seat 4: ItRgvLhXTZHvtZowz+dbIw (small blind) folded before Flop
Seat 5: u3Ol7kv1LmvszuHNm9rc6w (big blind) folded before Flop
Seat 6: 3m6VfX7io8SA31qh1zCkgQ showed [9h 8h] and won ($14.15) with a straight, Six to Ten




PokerStars Game #59941820864:  Hold'em No Limit ($0.10/$0.25) - 2009/07/01 1:47:12 ET
Table '1HT8bEDpLPhOXxmqMtzF8w' 9-max Seat #1 is the button
Seat 1: YkkKQUDI0iWatY4h0WWaAQ ($12.90 in chips) 
Seat 2: r6hsffOo1iKmaPYKwAZmFw ($29.10 in chips) 
Seat 3: oLa/tXLfSLLB28mcLGrxcg ($24.75 in chips) 
Seat 4: aNpwfA31EREwO+ar4XzBCw ($25 in chips) 
Seat 6: bXpVeaSTPBFSPJmeXxO7nw ($5.25 in chips) 
Seat 7: PMhmqYBPHOAXjH25lRz69g ($16.80 in chips) 
Seat 8: ghNKXUBl/H+t83JF079ZBA ($33.15 in chips) 
Seat 9: Z9W7+g1WMhhZDi7DwGbCFA ($5 in chips) 
r6hsffOo1iKmaPYKwAZmFw: posts small blind $0.10
oLa/tXLfSLLB28mcLGrxcg: posts big blind $0.25
*** HOLE CARDS ***
aNpwfA31EREwO+ar4XzBCw: raises $0.75 to $1
bXpVeaSTPBFSPJmeXxO7nw: folds 
PMhmqYBPHOAXjH25lRz69g: folds 
ghNKXUBl/H+t83JF079ZBA: folds 
Z9W7+g1WMhhZDi7DwGbCFA: folds 
YkkKQUDI0iWatY4h0WWaAQ: folds 
r6hsffOo1iKmaPYKwAZmFw: folds 
oLa/tXLfSLLB28mcLGrxcg: calls $0.75
*** FLOP *** [8s 5c Ah]
oLa/tXLfSLLB28mcLGrxcg: checks 
aNpwfA31EREwO+ar4XzBCw: bets $1.50
oLa/tXLfSLLB28mcLGrxcg: folds 
Uncalled bet ($1.50) returned to aNpwfA31EREwO+ar4XzBCw
aNpwfA31EREwO+ar4XzBCw collected $2 from pot
aNpwfA31EREwO+ar4XzBCw: doesn't show hand 
*** SUMMARY ***
Total pot $2.10 | Rake $0.10 
Board [8s 5c Ah]
Seat 1: YkkKQUDI0iWatY4h0WWaAQ (button) folded before Flop (didn't bet)
Seat 2: r6hsffOo1iKmaPYKwAZmFw (small blind) folded before Flop
Seat 3: oLa/tXLfSLLB28mcLGrxcg (big blind) folded on the Flop
Seat 4: aNpwfA31EREwO+ar4XzBCw collected ($2)
Seat 6: bXpVeaSTPBFSPJmeXxO7nw folded before Flop (didn't bet)
Seat 7: PMhmqYBPHOAXjH25lRz69g folded before Flop (didn't bet)
Seat 8: ghNKXUBl/H+t83JF079ZBA folded before Flop (didn't bet)
Seat 9: Z9W7+g1WMhhZDi7DwGbCFA folded before Flop (didn't bet)




PokerStars Game #59941820752:  Hold'em No Limit ($0.10/$0.25) - 2009/07/01 1:47:12 ET
Table 'ORSZkZqq+7Ja2PdeCFAytA' 9-max Seat #5 is the button
Seat 1: 3FkcXBaxKqxYVagfYUZlmw ($17.35 in chips) 
Seat 3: s9a4d23HFxaL70yUWQ0/tQ ($19.10 in chips) 
Seat 4: tbgfV2Egwn85xEt865GWQQ ($18.05 in chips) 
Seat 5: +lWbsq4dTcA70SX/+hnmpg ($5.40 in chips) 
Seat 6: gMF+EMhmwpnaM5TFQquf2A ($5 in chips) 
Seat 7: clJsV3v77RS07bDKY+705w ($5 in chips) 
Seat 8: npAYqa85pqnzfOK5ukX+BQ ($19.40 in chips) 
Seat 9: cMTFs4oCtNInkpDIecxT/w ($20.95 in chips) 
gMF+EMhmwpnaM5TFQquf2A: posts small blind $0.10
clJsV3v77RS07bDKY+705w: posts big blind $0.25
j4q3p0lesp63b1gZDwLBZw: sits out 
*** HOLE CARDS ***
npAYqa85pqnzfOK5ukX+BQ: folds 
cMTFs4oCtNInkpDIecxT/w: calls $0.25
3FkcXBaxKqxYVagfYUZlmw: calls $0.25
s9a4d23HFxaL70yUWQ0/tQ: folds 
tbgfV2Egwn85xEt865GWQQ: calls $0.25
+lWbsq4dTcA70SX/+hnmpg: folds 
gMF+EMhmwpnaM5TFQquf2A has timed out
gMF+EMhmwpnaM5TFQquf2A: folds 
gMF+EMhmwpnaM5TFQquf2A is sitting out
clJsV3v77RS07bDKY+705w: checks 
*** FLOP *** [2s 5c As]
gMF+EMhmwpnaM5TFQquf2A has returned
clJsV3v77RS07bDKY+705w: bets $0.75
cMTFs4oCtNInkpDIecxT/w: calls $0.75
3FkcXBaxKqxYVagfYUZlmw: calls $0.75
tbgfV2Egwn85xEt865GWQQ: folds 
*** TURN *** [2s 5c As] [Ad]
clJsV3v77RS07bDKY+705w: bets $2
gMF+EMhmwpnaM5TFQquf2A is sitting out
cMTFs4oCtNInkpDIecxT/w: calls $2
3FkcXBaxKqxYVagfYUZlmw: folds 
*** RIVER *** [2s 5c As Ad] [5s]
clJsV3v77RS07bDKY+705w: bets $2 and is all-in
cMTFs4oCtNInkpDIecxT/w: calls $2
*** SHOW DOWN ***
clJsV3v77RS07bDKY+705w: shows [5d 5h] (four of a kind, Fives)
cMTFs4oCtNInkpDIecxT/w: mucks hand 
clJsV3v77RS07bDKY+705w collected $10.80 from pot
*** SUMMARY ***
Total pot $11.35 | Rake $0.55 
Board [2s 5c As Ad 5s]
Seat 1: 3FkcXBaxKqxYVagfYUZlmw folded on the Turn
Seat 3: s9a4d23HFxaL70yUWQ0/tQ folded before Flop (didn't bet)
Seat 4: tbgfV2Egwn85xEt865GWQQ folded on the Flop
Seat 5: +lWbsq4dTcA70SX/+hnmpg (button) folded before Flop (didn't bet)
Seat 6: gMF+EMhmwpnaM5TFQquf2A (small blind) folded before Flop
Seat 7: clJsV3v77RS07bDKY+705w (big blind) showed [5d 5h] and won ($10.80) with four of a kind, Fives
Seat 8: npAYqa85pqnzfOK5ukX+BQ folded before Flop (didn't bet)
Seat 9: cMTFs4oCtNInkpDIecxT/w mucked




PokerStars Game #59941821680:  Hold'em No Limit ($0.10/$0.25) - 2009/07/01 1:47:13 ET
Table 'jxoHy9yJy0bbH/Qx73FoPA' 9-max Seat #9 is the button
Seat 1: j4q3p0lesp63b1gZDwLBZw ($6.35 in chips) 
Seat 2: F7pnn6czNpHvRM55XcA2EA ($45.50 in chips) 
Seat 3: CVqCt93Mk0MhKMaZ4LZDSQ ($9.30 in chips) 
Seat 5: rzZ3wFcwoPyKlQ0mB5JLRQ ($7.75 in chips) 
Seat 6: tYsOBqdU1+x+yFI7zHO7hQ ($62.55 in chips) 
Seat 7: wGigCmBR/9XWkPpvYos3aQ ($26.40 in chips) 
Seat 8: Z9W7+g1WMhhZDi7DwGbCFA ($5 in chips) 
Seat 9: CvL9Ch1HYCVbTsfpNucitg ($4.55 in chips) 
j4q3p0lesp63b1gZDwLBZw: posts small blind $0.10
F7pnn6czNpHvRM55XcA2EA: posts big blind $0.25
bXpVeaSTPBFSPJmeXxO7nw: sits out 
*** HOLE CARDS ***
CVqCt93Mk0MhKMaZ4LZDSQ: folds 
rzZ3wFcwoPyKlQ0mB5JLRQ: folds 
tYsOBqdU1+x+yFI7zHO7hQ: folds 
wGigCmBR/9XWkPpvYos3aQ: folds 
Z9W7+g1WMhhZDi7DwGbCFA: folds 
CvL9Ch1HYCVbTsfpNucitg: folds 
j4q3p0lesp63b1gZDwLBZw: raises $0.75 to $1
F7pnn6czNpHvRM55XcA2EA: folds 
Uncalled bet ($0.75) returned to j4q3p0lesp63b1gZDwLBZw
j4q3p0lesp63b1gZDwLBZw collected $0.50 from pot
j4q3p0lesp63b1gZDwLBZw: doesn't show hand 
*** SUMMARY ***
Total pot $0.50 | Rake $0 
Seat 1: j4q3p0lesp63b1gZDwLBZw (small blind) collected ($0.50)
Seat 2: F7pnn6czNpHvRM55XcA2EA (big blind) folded before Flop
Seat 3: CVqCt93Mk0MhKMaZ4LZDSQ folded before Flop (didn't bet)
Seat 5: rzZ3wFcwoPyKlQ0mB5JLRQ folded before Flop (didn't bet)
Seat 6: tYsOBqdU1+x+yFI7zHO7hQ folded before Flop (didn't bet)
Seat 7: wGigCmBR/9XWkPpvYos3aQ folded before Flop (didn't bet)
Seat 8: Z9W7+g1WMhhZDi7DwGbCFA folded before Flop (didn't bet)
Seat 9: CvL9Ch1HYCVbTsfpNucitg (button) folded before Flop (didn't bet)




PokerStars Game #59941821540:  Hold'em No Limit ($0.10/$0.25) - 2009/07/01 1:47:13 ET
Table 'sgdCtiuCu2BDZhyDi6RzTA' 6-max Seat #6 is the button
Seat 1: 3zD3qLXT1bEffAoWGnc7wg ($35.50 in chips) 
Seat 2: XD1i5m5PvBDnRzJaG/vINw ($24.05 in chips) 
Seat 3: eL3+wCBjFGfQ5FMdIZihwA ($25.50 in chips) 
Seat 4: rVKEgilmMX+EkKzDVvhmxA ($7.35 in chips) 
Seat 5: 0tQitW75xfmVWKldYHjmOQ ($3.05 in chips) 
Seat 6: KODslGU8ikCYS0/29dUkhg ($34.45 in chips) 
3zD3qLXT1bEffAoWGnc7wg: posts small blind $0.10
XD1i5m5PvBDnRzJaG/vINw: posts big blind $0.25
*** HOLE CARDS ***
eL3+wCBjFGfQ5FMdIZihwA: folds 
rVKEgilmMX+EkKzDVvhmxA: calls $0.25
0tQitW75xfmVWKldYHjmOQ: folds 
KODslGU8ikCYS0/29dUkhg: calls $0.25
3zD3qLXT1bEffAoWGnc7wg: folds 
XD1i5m5PvBDnRzJaG/vINw: checks 
*** FLOP *** [Ah 9c 5d]
XD1i5m5PvBDnRzJaG/vINw: checks 
rVKEgilmMX+EkKzDVvhmxA: checks 
KODslGU8ikCYS0/29dUkhg: bets $0.75
XD1i5m5PvBDnRzJaG/vINw: folds 
rVKEgilmMX+EkKzDVvhmxA: folds 
Uncalled bet ($0.75) returned to KODslGU8ikCYS0/29dUkhg
KODslGU8ikCYS0/29dUkhg collected $0.85 from pot
KODslGU8ikCYS0/29dUkhg: doesn't show hand 
*** SUMMARY ***
Total pot $0.85 | Rake $0 
Board [Ah 9c 5d]
Seat 1: 3zD3qLXT1bEffAoWGnc7wg (small blind) folded before Flop
Seat 2: XD1i5m5PvBDnRzJaG/vINw (big blind) folded on the Flop
Seat 3: eL3+wCBjFGfQ5FMdIZihwA folded before Flop (didn't bet)
Seat 4: rVKEgilmMX+EkKzDVvhmxA folded on the Flop
Seat 5: 0tQitW75xfmVWKldYHjmOQ folded before Flop (didn't bet)
Seat 6: KODslGU8ikCYS0/29dUkhg (button) collected ($0.85)




PokerStars Game #59941821912:  Hold'em No Limit ($0.10/$0.25) - 2009/07/01 1:47:14 ET
Table 'rjcb+nlE+0GuJ6lBhuCkkA' 6-max Seat #2 is the button
Seat 1: lBoEwOFgzcERLIRUkUoRTw ($13.25 in chips) 
Seat 2: lJphax9e7/+O/3YCKPJ0yQ ($7.35 in chips) 
Seat 3: 8ClCHtFXGNplITm+63KB+Q ($66.30 in chips) 
Seat 4: BV+K0Phf5VBHr7aZPKqbUQ ($35.15 in chips) 
Seat 5: GC/9yVD59DUCX7hUI7gcLw ($29 in chips) 
Seat 6: 32YL2ZEp8NT4JB2RVM9euQ ($16.05 in chips) 
8ClCHtFXGNplITm+63KB+Q: posts small blind $0.10
BV+K0Phf5VBHr7aZPKqbUQ: posts big blind $0.25
*** HOLE CARDS ***
GC/9yVD59DUCX7hUI7gcLw: folds 
32YL2ZEp8NT4JB2RVM9euQ: folds 
lBoEwOFgzcERLIRUkUoRTw: folds 
lJphax9e7/+O/3YCKPJ0yQ: folds 
8ClCHtFXGNplITm+63KB+Q: folds 
Uncalled bet ($0.15) returned to BV+K0Phf5VBHr7aZPKqbUQ
BV+K0Phf5VBHr7aZPKqbUQ collected $0.20 from pot
BV+K0Phf5VBHr7aZPKqbUQ: doesn't show hand 
*** SUMMARY ***
Total pot $0.20 | Rake $0 
Seat 1: lBoEwOFgzcERLIRUkUoRTw folded before Flop (didn't bet)
Seat 2: lJphax9e7/+O/3YCKPJ0yQ (button) folded before Flop (didn't bet)
Seat 3: 8ClCHtFXGNplITm+63KB+Q (small blind) folded before Flop
Seat 4: BV+K0Phf5VBHr7aZPKqbUQ (big blind) collected ($0.20)
Seat 5: GC/9yVD59DUCX7hUI7gcLw folded before Flop (didn't bet)
Seat 6: 32YL2ZEp8NT4JB2RVM9euQ folded before Flop (didn't bet)




PokerStars Game #59941821902:  Hold'em No Limit ($0.10/$0.25) - 2009/07/01 1:47:14 ET
Table 'Pz8SfAzhP5nvWTsJRAxoDg' 6-max Seat #2 is the button
Seat 1: QiL+lEgEWwy21jk/ltaRLg ($47.15 in chips) 
Seat 2: k021eD5in2AjaloW5PalMg ($19.05 in chips) 
Seat 3: mfrkWA3PTeYPkbO6hi98Aw ($24.35 in chips) 
Seat 4: 4lJto+Qj0K4JrFKvHaPTLw ($67.40 in chips) 
Seat 5: FYepjhAvF8ZdVCmqHIy+eQ ($27.05 in chips) 
Seat 6: QvTX2yGq3uKJiKPmns4TKQ ($18.05 in chips) 
mfrkWA3PTeYPkbO6hi98Aw: posts small blind $0.10
4lJto+Qj0K4JrFKvHaPTLw: posts big blind $0.25
*** HOLE CARDS ***
FYepjhAvF8ZdVCmqHIy+eQ: folds 
QvTX2yGq3uKJiKPmns4TKQ: folds 
QiL+lEgEWwy21jk/ltaRLg: folds 
k021eD5in2AjaloW5PalMg: calls $0.25
mfrkWA3PTeYPkbO6hi98Aw: folds 
4lJto+Qj0K4JrFKvHaPTLw: raises $2 to $2.25
k021eD5in2AjaloW5PalMg: folds 
Uncalled bet ($2) returned to 4lJto+Qj0K4JrFKvHaPTLw
4lJto+Qj0K4JrFKvHaPTLw collected $0.60 from pot
4lJto+Qj0K4JrFKvHaPTLw: shows [3d 7d] (high card Seven)
*** SUMMARY ***
Total pot $0.60 | Rake $0 
Seat 1: QiL+lEgEWwy21jk/ltaRLg folded before Flop (didn't bet)
Seat 2: k021eD5in2AjaloW5PalMg (button) folded before Flop
Seat 3: mfrkWA3PTeYPkbO6hi98Aw (small blind) folded before Flop
Seat 4: 4lJto+Qj0K4JrFKvHaPTLw (big blind) collected ($0.60)
Seat 5: FYepjhAvF8ZdVCmqHIy+eQ folded before Flop (didn't bet)
Seat 6: QvTX2yGq3uKJiKPmns4TKQ folded before Flop (didn't bet)




PokerStars Game #59941822746:  Hold'em No Limit ($0.10/$0.25) - 2009/07/01 1:47:15 ET
Table 'wixGE3Zge1qBdnpWijIl/w' 9-max Seat #7 is the button
Seat 1: 4GJMmHGKzu+gVtalqRy7dA ($27.20 in chips) 
Seat 2: DnDcAdn9P0zGovMERigpFA ($78.60 in chips) 
Seat 3: Bb42QRQMhg5/Y0vHP8/2Xw ($25 in chips) 
Seat 5: H5Se03ZqSX7tbULXur2MAg ($22.70 in chips) 
Seat 6: AP/rNvbsacTb4XtaAgKPiQ ($14.20 in chips) 
Seat 7: mMd8CDS/but3UC+Zp7Up2w ($20.70 in chips) 
Seat 8: ShCS62CJp4MKfKLKvGKQbA ($14.90 in chips) 
Seat 9: r6hsffOo1iKmaPYKwAZmFw ($29.15 in chips) 
ShCS62CJp4MKfKLKvGKQbA: posts small blind $0.10
r6hsffOo1iKmaPYKwAZmFw: posts big blind $0.25
X6+pSIPfovPcE87t+LmUKQ: sits out 
*** HOLE CARDS ***
4GJMmHGKzu+gVtalqRy7dA: folds 
DnDcAdn9P0zGovMERigpFA: raises $0.75 to $1
Bb42QRQMhg5/Y0vHP8/2Xw: folds 
H5Se03ZqSX7tbULXur2MAg: folds 
AP/rNvbsacTb4XtaAgKPiQ: calls $1
mMd8CDS/but3UC+Zp7Up2w: folds 
ShCS62CJp4MKfKLKvGKQbA: folds 
r6hsffOo1iKmaPYKwAZmFw: folds 
*** FLOP *** [Ad 9c 4h]
DnDcAdn9P0zGovMERigpFA: checks 
AP/rNvbsacTb4XtaAgKPiQ: checks 
*** TURN *** [Ad 9c 4h] [6c]
DnDcAdn9P0zGovMERigpFA: checks 
AP/rNvbsacTb4XtaAgKPiQ: bets $0.50
DnDcAdn9P0zGovMERigpFA: folds 
Uncalled bet ($0.50) returned to AP/rNvbsacTb4XtaAgKPiQ
AP/rNvbsacTb4XtaAgKPiQ collected $2.25 from pot
AP/rNvbsacTb4XtaAgKPiQ: doesn't show hand 
*** SUMMARY ***
Total pot $2.35 | Rake $0.10 
Board [Ad 9c 4h 6c]
Seat 1: 4GJMmHGKzu+gVtalqRy7dA folded before Flop (didn't bet)
Seat 2: DnDcAdn9P0zGovMERigpFA folded on the Turn
Seat 3: Bb42QRQMhg5/Y0vHP8/2Xw folded before Flop (didn't bet)
Seat 5: H5Se03ZqSX7tbULXur2MAg folded before Flop (didn't bet)
Seat 6: AP/rNvbsacTb4XtaAgKPiQ collected ($2.25)
Seat 7: mMd8CDS/but3UC+Zp7Up2w (button) folded before Flop (didn't bet)
Seat 8: ShCS62CJp4MKfKLKvGKQbA (small blind) folded before Flop
Seat 9: r6hsffOo1iKmaPYKwAZmFw (big blind) folded before Flop




PokerStars Game #59941822652:  Hold'em No Limit ($0.10/$0.25) - 2009/07/01 1:47:15 ET
Table 'C8mMnVmvkagwolEzTvh07A' 9-max Seat #9 is the button
Seat 1: PqvgxdSg9z5VmrWpbYuz+g ($27.25 in chips) 
Seat 2: Bb42QRQMhg5/Y0vHP8/2Xw ($25 in chips) 
Seat 3: Th3FldXKQW6hWVVPahaoOQ ($35.35 in chips) 
Seat 4: dfNim92Z6XK1/h5SFW5vDg ($25 in chips) 
Seat 5: iGMlK+EhUflPB6jKQd95Cg ($25 in chips) 
Seat 6: AiXn/9o1EwOPZUHujnh/bA ($18.50 in chips) 
Seat 7: qmEgnPhQt24xdw/ZRVPLbA ($36.75 in chips) 
Seat 9: 4awUyiDYTgylQKXZ9faBVA ($37.40 in chips) 
PqvgxdSg9z5VmrWpbYuz+g: posts small blind $0.10
Bb42QRQMhg5/Y0vHP8/2Xw: posts big blind $0.25
*** HOLE CARDS ***
Th3FldXKQW6hWVVPahaoOQ: folds 
dfNim92Z6XK1/h5SFW5vDg: folds 
iGMlK+EhUflPB6jKQd95Cg: raises $0.50 to $0.75
AiXn/9o1EwOPZUHujnh/bA: folds 
qmEgnPhQt24xdw/ZRVPLbA: folds 
qmEgnPhQt24xdw/ZRVPLbA is sitting out
4awUyiDYTgylQKXZ9faBVA: folds 
PqvgxdSg9z5VmrWpbYuz+g: folds 
Bb42QRQMhg5/Y0vHP8/2Xw: folds 
Uncalled bet ($0.50) returned to iGMlK+EhUflPB6jKQd95Cg
iGMlK+EhUflPB6jKQd95Cg collected $0.60 from pot
iGMlK+EhUflPB6jKQd95Cg: doesn't show hand 
*** SUMMARY ***
Total pot $0.60 | Rake $0 
Seat 1: PqvgxdSg9z5VmrWpbYuz+g (small blind) folded before Flop
Seat 2: Bb42QRQMhg5/Y0vHP8/2Xw (big blind) folded before Flop
Seat 3: Th3FldXKQW6hWVVPahaoOQ folded before Flop (didn't bet)
Seat 4: dfNim92Z6XK1/h5SFW5vDg folded before Flop (didn't bet)
Seat 5: iGMlK+EhUflPB6jKQd95Cg collected ($0.60)
Seat 6: AiXn/9o1EwOPZUHujnh/bA folded before Flop (didn't bet)
Seat 7: qmEgnPhQt24xdw/ZRVPLbA folded before Flop (didn't bet)
Seat 9: 4awUyiDYTgylQKXZ9faBVA (button) folded before Flop (didn't bet)




PokerStars Game #59941822680:  Hold'em No Limit ($0.10/$0.25) - 2009/07/01 1:47:15 ET
Table 'sCop8wmj9zlSS2KJqk1QKQ' 9-max Seat #8 is the button
Seat 1: dtZ84flFEi4Q+SGrHMJRDQ ($40.85 in chips) 
Seat 2: YZaC69gFrepA6oCGtu7E0w ($40.05 in chips) 
Seat 3: M/9j4wkHH9i1JM51vgi1VA ($24.75 in chips) 
Seat 4: msUzkZl2RntUnTl6E8WaNA ($15.90 in chips) 
Seat 5: RHqgdFvufLCYe54+qd2gcA ($8.95 in chips) 
Seat 6: hZuGwtYmFKPmQ+v1wlmdfA ($37.45 in chips) 
Seat 8: xnVwSkROfRtOw4eSoDANtw ($20.30 in chips) 
Seat 9: tLcDklc2rBORNfixyRfVfw ($25 in chips) 
tLcDklc2rBORNfixyRfVfw: posts small blind $0.10
dtZ84flFEi4Q+SGrHMJRDQ: posts big blind $0.25
18G4P1XstjNvItdGUITxgw: sits out 
*** HOLE CARDS ***
YZaC69gFrepA6oCGtu7E0w: calls $0.25
M/9j4wkHH9i1JM51vgi1VA: calls $0.25
msUzkZl2RntUnTl6E8WaNA: folds 
RHqgdFvufLCYe54+qd2gcA: folds 
hZuGwtYmFKPmQ+v1wlmdfA: folds 
xnVwSkROfRtOw4eSoDANtw: folds 
tLcDklc2rBORNfixyRfVfw: folds 
dtZ84flFEi4Q+SGrHMJRDQ: checks 
*** FLOP *** [8d 6h 7c]
dtZ84flFEi4Q+SGrHMJRDQ: checks 
YZaC69gFrepA6oCGtu7E0w: bets $0.50
M/9j4wkHH9i1JM51vgi1VA: calls $0.50
dtZ84flFEi4Q+SGrHMJRDQ: folds 
*** TURN *** [8d 6h 7c] [5d]
YZaC69gFrepA6oCGtu7E0w: bets $1.20
M/9j4wkHH9i1JM51vgi1VA: calls $1.20
*** RIVER *** [8d 6h 7c 5d] [6c]
YZaC69gFrepA6oCGtu7E0w: bets $4
M/9j4wkHH9i1JM51vgi1VA: calls $4
*** SHOW DOWN ***
YZaC69gFrepA6oCGtu7E0w: shows [Qh 9h] (a straight, Five to Nine)
M/9j4wkHH9i1JM51vgi1VA: shows [8c 9c] (a straight, Five to Nine)
YZaC69gFrepA6oCGtu7E0w collected $5.85 from pot
M/9j4wkHH9i1JM51vgi1VA collected $5.80 from pot
*** SUMMARY ***
Total pot $12.25 | Rake $0.60 
Board [8d 6h 7c 5d 6c]
Seat 1: dtZ84flFEi4Q+SGrHMJRDQ (big blind) folded on the Flop
Seat 2: YZaC69gFrepA6oCGtu7E0w showed [Qh 9h] and won ($5.85) with a straight, Five to Nine
Seat 3: M/9j4wkHH9i1JM51vgi1VA showed [8c 9c] and won ($5.80) with a straight, Five to Nine
Seat 4: msUzkZl2RntUnTl6E8WaNA folded before Flop (didn't bet)
Seat 5: RHqgdFvufLCYe54+qd2gcA folded before Flop (didn't bet)
Seat 6: hZuGwtYmFKPmQ+v1wlmdfA folded before Flop (didn't bet)
Seat 8: xnVwSkROfRtOw4eSoDANtw (button) folded before Flop (didn't bet)
Seat 9: tLcDklc2rBORNfixyRfVfw (small blind) folded before Flop




PokerStars Game #59941822720:  Hold'em No Limit ($0.10/$0.25) - 2009/07/01 1:47:15 ET
Table '0w9m+UkNlGMNoPyQqzWk6A' 9-max Seat #9 is the button
Seat 3: VWwtMkIjXloiX/RKh7RGWQ ($12.05 in chips) 
Seat 5: HPEB+AtKw1+C/cxU0o1ciw ($48.30 in chips) 
Seat 6: CgIo2ItZqi4o3ayVG6HanQ ($29.65 in chips) 
Seat 7: 57qrNGHDvf6GhB8zVLsAtQ ($4.45 in chips) 
Seat 9: KqS/lY/fNB9qUxokm9QfeA ($7.25 in chips) 
18G4P1XstjNvItdGUITxgw will be allowed to play after the button
tYsOBqdU1+x+yFI7zHO7hQ: is sitting out 
VWwtMkIjXloiX/RKh7RGWQ: posts small blind $0.10
HPEB+AtKw1+C/cxU0o1ciw: posts big blind $0.25
cZ99hugmLBj9KhTlc8nCSw: sits out 
*** HOLE CARDS ***
tYsOBqdU1+x+yFI7zHO7hQ leaves the table
CgIo2ItZqi4o3ayVG6HanQ: calls $0.25
57qrNGHDvf6GhB8zVLsAtQ: folds 
M1nKET7WOTLbVPuAbJa3EA joins the table at seat #2 
KqS/lY/fNB9qUxokm9QfeA: calls $0.25
VWwtMkIjXloiX/RKh7RGWQ: calls $0.15
HPEB+AtKw1+C/cxU0o1ciw: checks 
*** FLOP *** [Tc 9d Qs]
VWwtMkIjXloiX/RKh7RGWQ: checks 
HPEB+AtKw1+C/cxU0o1ciw: checks 
CgIo2ItZqi4o3ayVG6HanQ: bets $0.75
KqS/lY/fNB9qUxokm9QfeA: calls $0.75
VWwtMkIjXloiX/RKh7RGWQ: folds 
HPEB+AtKw1+C/cxU0o1ciw: folds 
*** TURN *** [Tc 9d Qs] [8d]
CgIo2ItZqi4o3ayVG6HanQ: checks 
KqS/lY/fNB9qUxokm9QfeA: checks 
*** RIVER *** [Tc 9d Qs 8d] [Ac]
CgIo2ItZqi4o3ayVG6HanQ: bets $1
KqS/lY/fNB9qUxokm9QfeA: raises $2.25 to $3.25
CgIo2ItZqi4o3ayVG6HanQ: calls $2.25
*** SHOW DOWN ***
KqS/lY/fNB9qUxokm9QfeA: shows [5h Jh] (a straight, Eight to Queen)
CgIo2ItZqi4o3ayVG6HanQ: mucks hand 
KqS/lY/fNB9qUxokm9QfeA collected $8.60 from pot
*** SUMMARY ***
Total pot $9 | Rake $0.40 
Board [Tc 9d Qs 8d Ac]
Seat 3: VWwtMkIjXloiX/RKh7RGWQ (small blind) folded on the Flop
Seat 5: HPEB+AtKw1+C/cxU0o1ciw (big blind) folded on the Flop
Seat 6: CgIo2ItZqi4o3ayVG6HanQ mucked
Seat 7: 57qrNGHDvf6GhB8zVLsAtQ folded before Flop (didn't bet)
Seat 9: KqS/lY/fNB9qUxokm9QfeA (button) showed [5h Jh] and won ($8.60) with a straight, Eight to Queen




PokerStars Game #59941822446:  Hold'em No Limit ($0.10/$0.25) - 2009/07/01 1:47:15 ET
Table 'DhkrdW2UOy2PfjSW28Kq8w' 6-max Seat #3 is the button
Seat 2: v+QfkGiuj9bgtuNoVnDO8w ($26.15 in chips) 
Seat 3: B3X187C0tXFUfQpCu8pe8A ($19.90 in chips) 
Seat 5: SxIIgwXYLkwd6m3wLyPTCw ($50.75 in chips) 
Seat 6: DihMHaz4WNETH1bPDe13kA ($27.35 in chips) 
moondyne1124 will be allowed to play after the button
SxIIgwXYLkwd6m3wLyPTCw: posts small blind $0.10
DihMHaz4WNETH1bPDe13kA: posts big blind $0.25
Mhj3q7cxev+XjXZxEE6/Cw: sits out 
*** HOLE CARDS ***
v+QfkGiuj9bgtuNoVnDO8w: raises $0.75 to $1
B3X187C0tXFUfQpCu8pe8A: calls $1
SxIIgwXYLkwd6m3wLyPTCw: folds 
DihMHaz4WNETH1bPDe13kA: folds 
*** FLOP *** [Qd Js Kd]
SxIIgwXYLkwd6m3wLyPTCw leaves the table
v+QfkGiuj9bgtuNoVnDO8w: checks 
B3X187C0tXFUfQpCu8pe8A: checks 
*** TURN *** [Qd Js Kd] [6h]
cS21pIxRHx5Gt42o7hPZzw joins the table at seat #5 
v+QfkGiuj9bgtuNoVnDO8w: checks 
B3X187C0tXFUfQpCu8pe8A: checks 
*** RIVER *** [Qd Js Kd 6h] [Ac]
v+QfkGiuj9bgtuNoVnDO8w: checks 
B3X187C0tXFUfQpCu8pe8A: checks 
*** SHOW DOWN ***
v+QfkGiuj9bgtuNoVnDO8w: shows [8s 8d] (a pair of Eights)
B3X187C0tXFUfQpCu8pe8A: mucks hand 
v+QfkGiuj9bgtuNoVnDO8w collected $2.25 from pot
*** SUMMARY ***
Total pot $2.35 | Rake $0.10 
Board [Qd Js Kd 6h Ac]
Seat 2: v+QfkGiuj9bgtuNoVnDO8w showed [8s 8d] and won ($2.25) with a pair of Eights
Seat 3: B3X187C0tXFUfQpCu8pe8A (button) mucked
Seat 5: SxIIgwXYLkwd6m3wLyPTCw (small blind) folded before Flop
Seat 6: DihMHaz4WNETH1bPDe13kA (big blind) folded before Flop




PokerStars Game #59941823182:  Hold'em No Limit ($0.10/$0.25) - 2009/07/01 1:47:16 ET
Table '3lS+sU5k6mwJCS2nFMmQ6Q' 9-max Seat #9 is the button
Seat 1: VWUWpMLMj/Q1jRVpF7Aohw ($13.80 in chips) 
Seat 2: PdIasPkzm2sqZnN41ZRXOg ($5 in chips) 
Seat 3: 1DXccE2UUK5DIRVGlOKnTA ($11.95 in chips) 
Seat 4: ydoFOVgzvZv9ZhuWu9rXAw ($10.70 in chips) 
Seat 5: NcPAt5YjVvDFEJTTgAVj8g ($5.25 in chips) 
Seat 6: hJ4uYjNmSZdjrKA8cjZqCA ($35.75 in chips) 
Seat 7: Th3FldXKQW6hWVVPahaoOQ ($31.55 in chips) 
Seat 8: 9lvO/qyU+xrU95Teu1fv0g ($5.25 in chips) 
Seat 9: 4awUyiDYTgylQKXZ9faBVA ($48.85 in chips) 
VWUWpMLMj/Q1jRVpF7Aohw: posts small blind $0.10
PdIasPkzm2sqZnN41ZRXOg: posts big blind $0.25
*** HOLE CARDS ***
1DXccE2UUK5DIRVGlOKnTA: calls $0.25
ydoFOVgzvZv9ZhuWu9rXAw: folds 
NcPAt5YjVvDFEJTTgAVj8g: folds 
hJ4uYjNmSZdjrKA8cjZqCA: folds 
Th3FldXKQW6hWVVPahaoOQ: folds 
9lvO/qyU+xrU95Teu1fv0g: folds 
4awUyiDYTgylQKXZ9faBVA: folds 
VWUWpMLMj/Q1jRVpF7Aohw: calls $0.15
PdIasPkzm2sqZnN41ZRXOg: checks 
*** FLOP *** [Jh 5d 2d]
VWUWpMLMj/Q1jRVpF7Aohw: checks 
PdIasPkzm2sqZnN41ZRXOg: checks 
1DXccE2UUK5DIRVGlOKnTA: bets $0.25
VWUWpMLMj/Q1jRVpF7Aohw: folds 
PdIasPkzm2sqZnN41ZRXOg: folds 
Uncalled bet ($0.25) returned to 1DXccE2UUK5DIRVGlOKnTA
1DXccE2UUK5DIRVGlOKnTA collected $0.75 from pot
1DXccE2UUK5DIRVGlOKnTA: doesn't show hand 
*** SUMMARY ***
Total pot $0.75 | Rake $0 
Board [Jh 5d 2d]
Seat 1: VWUWpMLMj/Q1jRVpF7Aohw (small blind) folded on the Flop
Seat 2: PdIasPkzm2sqZnN41ZRXOg (big blind) folded on the Flop
Seat 3: 1DXccE2UUK5DIRVGlOKnTA collected ($0.75)
Seat 4: ydoFOVgzvZv9ZhuWu9rXAw folded before Flop (didn't bet)
Seat 5: NcPAt5YjVvDFEJTTgAVj8g folded before Flop (didn't bet)
Seat 6: hJ4uYjNmSZdjrKA8cjZqCA folded before Flop (didn't bet)
Seat 7: Th3FldXKQW6hWVVPahaoOQ folded before Flop (didn't bet)
Seat 8: 9lvO/qyU+xrU95Teu1fv0g folded before Flop (didn't bet)
Seat 9: 4awUyiDYTgylQKXZ9faBVA (button) folded before Flop (didn't bet)




PokerStars Game #59941822854:  Hold'em No Limit ($0.10/$0.25) - 2009/07/01 1:47:16 ET
Table '2O5CgfSkSwrr4PDrlZ1RLQ' 6-max Seat #4 is the button
Seat 1: 3skmHD9EOATKdUzzyHh1KA ($29.45 in chips) 
Seat 2: wqphQtauX5Qn7WRJZS1flA ($26.50 in chips) 
Seat 3: oBUDUfeUyCbZBsjxHZgSiw ($21.25 in chips) 
Seat 4: epAUIB7h2FJXzUPRIvSkRA ($25 in chips) 
Seat 5: 0av6tRNdi0Ui4f15L7gsVg ($24 in chips) 
Seat 6: tj9xqoqQaDaFw7u1oyZrtA ($56.75 in chips) 
0av6tRNdi0Ui4f15L7gsVg: posts small blind $0.10
tj9xqoqQaDaFw7u1oyZrtA: posts big blind $0.25
*** HOLE CARDS ***
3skmHD9EOATKdUzzyHh1KA: raises $0.75 to $1
wqphQtauX5Qn7WRJZS1flA: folds 
oBUDUfeUyCbZBsjxHZgSiw: folds 
epAUIB7h2FJXzUPRIvSkRA: folds 
0av6tRNdi0Ui4f15L7gsVg: folds 
tj9xqoqQaDaFw7u1oyZrtA: folds 
Uncalled bet ($0.75) returned to 3skmHD9EOATKdUzzyHh1KA
3skmHD9EOATKdUzzyHh1KA collected $0.60 from pot
3skmHD9EOATKdUzzyHh1KA: doesn't show hand 
*** SUMMARY ***
Total pot $0.60 | Rake $0 
Seat 1: 3skmHD9EOATKdUzzyHh1KA collected ($0.60)
Seat 2: wqphQtauX5Qn7WRJZS1flA folded before Flop (didn't bet)
Seat 3: oBUDUfeUyCbZBsjxHZgSiw folded before Flop (didn't bet)
Seat 4: epAUIB7h2FJXzUPRIvSkRA (button) folded before Flop (didn't bet)
Seat 5: 0av6tRNdi0Ui4f15L7gsVg (small blind) folded before Flop
Seat 6: tj9xqoqQaDaFw7u1oyZrtA (big blind) folded before Flop




PokerStars Game #59941823240:  Hold'em No Limit ($0.10/$0.25) - 2009/07/01 1:47:16 ET
Table 'ZEXL6Wh4qA4Afx8NnoBBAA' 6-max Seat #3 is the button
Seat 1: v8m8XHovI5tqEA9mvplDSw ($27.45 in chips) 
Seat 2: 6DwBRH+xZ12AAZmeAg+aXw ($23.50 in chips) 
Seat 3: +ZlnqPoP3Hg4BIUxDfKd/A ($32.70 in chips) 
Seat 4: FpN4KbLjlyRRKiVaQcoLqA ($28.85 in chips) 
Seat 5: if4dh6jhJXeN3/qd3qCp9g ($36.85 in chips) 
Seat 6: Lh8SlCq3OSDKWLUgAI/Lxw ($1.75 in chips) 
FpN4KbLjlyRRKiVaQcoLqA: posts small blind $0.10
if4dh6jhJXeN3/qd3qCp9g: posts big blind $0.25
*** HOLE CARDS ***
Lh8SlCq3OSDKWLUgAI/Lxw: folds 
v8m8XHovI5tqEA9mvplDSw: folds 
6DwBRH+xZ12AAZmeAg+aXw: folds 
+ZlnqPoP3Hg4BIUxDfKd/A: raises $0.75 to $1
FpN4KbLjlyRRKiVaQcoLqA: calls $0.90
if4dh6jhJXeN3/qd3qCp9g: calls $0.75
*** FLOP *** [Kh 2s Ad]
FpN4KbLjlyRRKiVaQcoLqA: checks 
if4dh6jhJXeN3/qd3qCp9g: checks 
+ZlnqPoP3Hg4BIUxDfKd/A: checks 
*** TURN *** [Kh 2s Ad] [7d]
FpN4KbLjlyRRKiVaQcoLqA: checks 
if4dh6jhJXeN3/qd3qCp9g: bets $1
+ZlnqPoP3Hg4BIUxDfKd/A: folds 
FpN4KbLjlyRRKiVaQcoLqA: calls $1
*** RIVER *** [Kh 2s Ad 7d] [5d]
FpN4KbLjlyRRKiVaQcoLqA: checks 
if4dh6jhJXeN3/qd3qCp9g: checks 
*** SHOW DOWN ***
FpN4KbLjlyRRKiVaQcoLqA: shows [Th Td] (a pair of Tens)
if4dh6jhJXeN3/qd3qCp9g: shows [Jd As] (a pair of Aces)
if4dh6jhJXeN3/qd3qCp9g collected $4.80 from pot
*** SUMMARY ***
Total pot $5 | Rake $0.20 
Board [Kh 2s Ad 7d 5d]
Seat 1: v8m8XHovI5tqEA9mvplDSw folded before Flop (didn't bet)
Seat 2: 6DwBRH+xZ12AAZmeAg+aXw folded before Flop (didn't bet)
Seat 3: +ZlnqPoP3Hg4BIUxDfKd/A (button) folded on the Turn
Seat 4: FpN4KbLjlyRRKiVaQcoLqA (small blind) showed [Th Td] and lost with a pair of Tens
Seat 5: if4dh6jhJXeN3/qd3qCp9g (big blind) showed [Jd As] and won ($4.80) with a pair of Aces
Seat 6: Lh8SlCq3OSDKWLUgAI/Lxw folded before Flop (didn't bet)




PokerStars Game #59941823128:  Hold'em No Limit ($0.10/$0.25) - 2009/07/01 1:47:16 ET
Table 'isKy4XK8wJM0x735/D4hWA' 6-max Seat #5 is the button
Seat 1: kwsRmpZ1ZaLooISs+zfyKg ($24.40 in chips) 
Seat 2: 6elpmfyt4Zw0yvd8lePSMQ ($39.25 in chips) 
Seat 3: jp34e617tIzV8tKIWmfAbA ($26.05 in chips) 
Seat 4: DFi/Lzkjsfv8QswS80JX9Q ($31.10 in chips) 
Seat 5: lquriepNQBhDV5P1SWHhnA ($25.60 in chips) 
Seat 6: GbCVUNssQ7mqsPWr7J4d3w ($4.05 in chips) 
GbCVUNssQ7mqsPWr7J4d3w: posts small blind $0.10
kwsRmpZ1ZaLooISs+zfyKg: posts big blind $0.25
*** HOLE CARDS ***
6elpmfyt4Zw0yvd8lePSMQ: folds 
jp34e617tIzV8tKIWmfAbA: folds 
DFi/Lzkjsfv8QswS80JX9Q: raises $0.75 to $1
lquriepNQBhDV5P1SWHhnA: folds 
GbCVUNssQ7mqsPWr7J4d3w: folds 
kwsRmpZ1ZaLooISs+zfyKg: folds 
Uncalled bet ($0.75) returned to DFi/Lzkjsfv8QswS80JX9Q
DFi/Lzkjsfv8QswS80JX9Q collected $0.60 from pot
DFi/Lzkjsfv8QswS80JX9Q: doesn't show hand 
*** SUMMARY ***
Total pot $0.60 | Rake $0 
Seat 1: kwsRmpZ1ZaLooISs+zfyKg (big blind) folded before Flop
Seat 2: 6elpmfyt4Zw0yvd8lePSMQ folded before Flop (didn't bet)
Seat 3: jp34e617tIzV8tKIWmfAbA folded before Flop (didn't bet)
Seat 4: DFi/Lzkjsfv8QswS80JX9Q collected ($0.60)
Seat 5: lquriepNQBhDV5P1SWHhnA (button) folded before Flop (didn't bet)
Seat 6: GbCVUNssQ7mqsPWr7J4d3w (small blind) folded before Flop




PokerStars Game #59941823390:  Hold'em No Limit ($0.10/$0.25) - 2009/07/01 1:47:17 ET
Table 'FuFyQHmlO/QqQp//rDRrPg' 6-max Seat #5 is the button
Seat 1: jp34e617tIzV8tKIWmfAbA ($27.40 in chips) 
Seat 2: G3h3THGB1j3qdHDVHpnJWg ($31.10 in chips) 
Seat 3: EeUZtMU058v2ObUACOF4Og ($29.85 in chips) 
Seat 4: Ahsa9Yk5NPmCqQstq1EoQA ($21.80 in chips) 
Seat 5: xrf8tAXKQHG99HixCot1Iw ($25.25 in chips) 
Seat 6: 6DwBRH+xZ12AAZmeAg+aXw ($51.35 in chips) 
6DwBRH+xZ12AAZmeAg+aXw: posts small blind $0.10
jp34e617tIzV8tKIWmfAbA: posts big blind $0.25
*** HOLE CARDS ***
G3h3THGB1j3qdHDVHpnJWg has timed out
G3h3THGB1j3qdHDVHpnJWg: folds 
G3h3THGB1j3qdHDVHpnJWg is sitting out
EeUZtMU058v2ObUACOF4Og: calls $0.25
Ahsa9Yk5NPmCqQstq1EoQA: folds 
xrf8tAXKQHG99HixCot1Iw: folds 
G3h3THGB1j3qdHDVHpnJWg has returned
6DwBRH+xZ12AAZmeAg+aXw: calls $0.15
jp34e617tIzV8tKIWmfAbA: checks 
*** FLOP *** [8s Kh 3s]
6DwBRH+xZ12AAZmeAg+aXw: checks 
jp34e617tIzV8tKIWmfAbA: bets $0.50
EeUZtMU058v2ObUACOF4Og: folds 
6DwBRH+xZ12AAZmeAg+aXw: folds 
Uncalled bet ($0.50) returned to jp34e617tIzV8tKIWmfAbA
jp34e617tIzV8tKIWmfAbA collected $0.75 from pot
*** SUMMARY ***
Total pot $0.75 | Rake $0 
Board [8s Kh 3s]
Seat 1: jp34e617tIzV8tKIWmfAbA (big blind) collected ($0.75)
Seat 2: G3h3THGB1j3qdHDVHpnJWg folded before Flop (didn't bet)
Seat 3: EeUZtMU058v2ObUACOF4Og folded on the Flop
Seat 4: Ahsa9Yk5NPmCqQstq1EoQA folded before Flop (didn't bet)
Seat 5: xrf8tAXKQHG99HixCot1Iw (button) folded before Flop (didn't bet)
Seat 6: 6DwBRH+xZ12AAZmeAg+aXw (small blind) folded on the Flop




PokerStars Game #59941823534:  Hold'em No Limit ($0.10/$0.25) - 2009/07/01 1:47:17 ET
Table '+2VxGVfkEqJ1AYfQy/JH2w' 6-max Seat #4 is the button
Seat 1: if4dh6jhJXeN3/qd3qCp9g ($28.25 in chips) 
Seat 2: qllppsCmUqovlriIWCeM/g ($5.15 in chips) 
Seat 3: epAUIB7h2FJXzUPRIvSkRA ($25 in chips) 
Seat 4: y+a/yGW/Jy4bPJFnaeTz5w ($16.60 in chips) 
Seat 5: XD1i5m5PvBDnRzJaG/vINw ($24.75 in chips) 
Seat 6: YQNVDzvw3TmGaFiq9MhRgA ($5 in chips) 
XD1i5m5PvBDnRzJaG/vINw: posts small blind $0.10
YQNVDzvw3TmGaFiq9MhRgA: posts big blind $0.25
*** HOLE CARDS ***
if4dh6jhJXeN3/qd3qCp9g: folds 
qllppsCmUqovlriIWCeM/g: folds 
epAUIB7h2FJXzUPRIvSkRA: folds 
y+a/yGW/Jy4bPJFnaeTz5w: folds 
XD1i5m5PvBDnRzJaG/vINw: folds 
Uncalled bet ($0.15) returned to YQNVDzvw3TmGaFiq9MhRgA
YQNVDzvw3TmGaFiq9MhRgA collected $0.20 from pot
YQNVDzvw3TmGaFiq9MhRgA: doesn't show hand 
*** SUMMARY ***
Total pot $0.20 | Rake $0 
Seat 1: if4dh6jhJXeN3/qd3qCp9g folded before Flop (didn't bet)
Seat 2: qllppsCmUqovlriIWCeM/g folded before Flop (didn't bet)
Seat 3: epAUIB7h2FJXzUPRIvSkRA folded before Flop (didn't bet)
Seat 4: y+a/yGW/Jy4bPJFnaeTz5w (button) folded before Flop (didn't bet)
Seat 5: XD1i5m5PvBDnRzJaG/vINw (small blind) folded before Flop
Seat 6: YQNVDzvw3TmGaFiq9MhRgA (big blind) collected ($0.20)




PokerStars Game #59941823770:  Hold'em No Limit ($0.10/$0.25) - 2009/07/01 1:47:17 ET
Table 'VuY5ej47Cy8nOI3Wogmhzw' 6-max Seat #2 is the button
Seat 1: EeUZtMU058v2ObUACOF4Og ($41.35 in chips) 
Seat 2: AM6Yl+3esmhhMBlSnQhWbg ($13.60 in chips) 
Seat 3: v+QfkGiuj9bgtuNoVnDO8w ($41.20 in chips) 
Seat 4: QqiZLFrN8iOUT/GHw7ztOA ($25 in chips) 
Seat 5: j0aDOn9Nft1HLTQvGu1UwA ($5 in chips) 
Seat 6: +KblIivb6tainScpwm14RQ ($6.75 in chips) 
v+QfkGiuj9bgtuNoVnDO8w: posts small blind $0.10
QqiZLFrN8iOUT/GHw7ztOA: posts big blind $0.25
j0aDOn9Nft1HLTQvGu1UwA: posts big blind $0.25
*** HOLE CARDS ***
j0aDOn9Nft1HLTQvGu1UwA: checks 
+KblIivb6tainScpwm14RQ: calls $0.25
EeUZtMU058v2ObUACOF4Og: folds 
AM6Yl+3esmhhMBlSnQhWbg: folds 
v+QfkGiuj9bgtuNoVnDO8w: folds 
QqiZLFrN8iOUT/GHw7ztOA: raises $0.75 to $1
j0aDOn9Nft1HLTQvGu1UwA: folds 
+KblIivb6tainScpwm14RQ: calls $0.75
*** FLOP *** [3h 4c Jh]
j0aDOn9Nft1HLTQvGu1UwA leaves the table
QqiZLFrN8iOUT/GHw7ztOA: bets $1.50
+KblIivb6tainScpwm14RQ: folds 
Uncalled bet ($1.50) returned to QqiZLFrN8iOUT/GHw7ztOA
QqiZLFrN8iOUT/GHw7ztOA collected $2.25 from pot
*** SUMMARY ***
Total pot $2.35 | Rake $0.10 
Board [3h 4c Jh]
Seat 1: EeUZtMU058v2ObUACOF4Og folded before Flop (didn't bet)
Seat 2: AM6Yl+3esmhhMBlSnQhWbg (button) folded before Flop (didn't bet)
Seat 3: v+QfkGiuj9bgtuNoVnDO8w (small blind) folded before Flop
Seat 4: QqiZLFrN8iOUT/GHw7ztOA (big blind) collected ($2.25)
Seat 5: j0aDOn9Nft1HLTQvGu1UwA folded before Flop
Seat 6: +KblIivb6tainScpwm14RQ folded on the Flop




PokerStars Game #59941823778:  Hold'em No Limit ($0.10/$0.25) - 2009/07/01 1:47:17 ET
Table 'WY+lMaAoIdBZmwk27/RJCA' 6-max Seat #5 is the button
Seat 1: zHHLkD2sRljslKKeQv/ZQw ($26.95 in chips) 
Seat 2: NhUN/JpAprdJeamFBgJH1w ($26.90 in chips) 
Seat 3: QqiZLFrN8iOUT/GHw7ztOA ($26.60 in chips) 
Seat 4: 0av6tRNdi0Ui4f15L7gsVg ($25 in chips) 
Seat 5: vqWjZmdQu/Hxw96/IJTWdQ ($27.60 in chips) 
Seat 6: cWc85bEzdRzpUMhRKm8pwQ ($25.85 in chips) 
cWc85bEzdRzpUMhRKm8pwQ: posts small blind $0.10
zHHLkD2sRljslKKeQv/ZQw: posts big blind $0.25
*** HOLE CARDS ***
NhUN/JpAprdJeamFBgJH1w: folds 
QqiZLFrN8iOUT/GHw7ztOA: raises $0.75 to $1
0av6tRNdi0Ui4f15L7gsVg: folds 
vqWjZmdQu/Hxw96/IJTWdQ: folds 
cWc85bEzdRzpUMhRKm8pwQ: folds 
zHHLkD2sRljslKKeQv/ZQw: folds 
Uncalled bet ($0.75) returned to QqiZLFrN8iOUT/GHw7ztOA
QqiZLFrN8iOUT/GHw7ztOA collected $0.60 from pot
*** SUMMARY ***
Total pot $0.60 | Rake $0 
Seat 1: zHHLkD2sRljslKKeQv/ZQw (big blind) folded before Flop
Seat 2: NhUN/JpAprdJeamFBgJH1w folded before Flop (didn't bet)
Seat 3: QqiZLFrN8iOUT/GHw7ztOA collected ($0.60)
Seat 4: 0av6tRNdi0Ui4f15L7gsVg folded before Flop (didn't bet)
Seat 5: vqWjZmdQu/Hxw96/IJTWdQ (button) folded before Flop (didn't bet)
Seat 6: cWc85bEzdRzpUMhRKm8pwQ (small blind) folded before Flop




PokerStars Game #59941823636:  Hold'em No Limit ($0.10/$0.25) - 2009/07/01 1:47:17 ET
Table '50f2Xa1b1jp6cfdTAgXFIg' 9-max Seat #1 is the button
Seat 1: E0iYnEVO2ho7dH3QcCjw7g ($19.65 in chips) 
Seat 3: RSojRXQHk0IRANbJYopT9g ($21.40 in chips) 
Seat 4: ghNKXUBl/H+t83JF079ZBA ($28.10 in chips) 
Seat 5: C1w4aCCgQVVSgNijoEahAg ($17.75 in chips) 
Seat 6: tLcDklc2rBORNfixyRfVfw ($27.50 in chips) 
Seat 7: w1ukf8uPa4+WH561TtVRxA ($25 in chips) 
Seat 8: x+W5+3qsdY4Iszf0hoH+Aw ($14.55 in chips) 
Seat 9: gehe91e0IyVT0QU/XBkEyg ($25 in chips) 
RSojRXQHk0IRANbJYopT9g: posts small blind $0.10
ghNKXUBl/H+t83JF079ZBA: posts big blind $0.25
*** HOLE CARDS ***
C1w4aCCgQVVSgNijoEahAg: raises $0.25 to $0.50
tLcDklc2rBORNfixyRfVfw: folds 
w1ukf8uPa4+WH561TtVRxA: calls $0.50
x+W5+3qsdY4Iszf0hoH+Aw: folds 
gehe91e0IyVT0QU/XBkEyg: folds 
E0iYnEVO2ho7dH3QcCjw7g: folds 
RSojRXQHk0IRANbJYopT9g: calls $0.40
ghNKXUBl/H+t83JF079ZBA: calls $0.25
*** FLOP *** [Ac 3s 5s]
RSojRXQHk0IRANbJYopT9g: bets $0.25
ghNKXUBl/H+t83JF079ZBA: calls $0.25
C1w4aCCgQVVSgNijoEahAg: calls $0.25
w1ukf8uPa4+WH561TtVRxA: folds 
*** TURN *** [Ac 3s 5s] [Qd]
RSojRXQHk0IRANbJYopT9g: bets $0.25
ghNKXUBl/H+t83JF079ZBA: calls $0.25
C1w4aCCgQVVSgNijoEahAg: calls $0.25
*** RIVER *** [Ac 3s 5s Qd] [Qh]
RSojRXQHk0IRANbJYopT9g: checks 
ghNKXUBl/H+t83JF079ZBA: checks 
C1w4aCCgQVVSgNijoEahAg: checks 
*** SHOW DOWN ***
RSojRXQHk0IRANbJYopT9g: shows [8c Ks] (a pair of Queens)
ghNKXUBl/H+t83JF079ZBA: mucks hand 
C1w4aCCgQVVSgNijoEahAg: mucks hand 
RSojRXQHk0IRANbJYopT9g collected $3.35 from pot
*** SUMMARY ***
Total pot $3.50 | Rake $0.15 
Board [Ac 3s 5s Qd Qh]
Seat 1: E0iYnEVO2ho7dH3QcCjw7g (button) folded before Flop (didn't bet)
Seat 3: RSojRXQHk0IRANbJYopT9g (small blind) showed [8c Ks] and won ($3.35) with a pair of Queens
Seat 4: ghNKXUBl/H+t83JF079ZBA (big blind) mucked
Seat 5: C1w4aCCgQVVSgNijoEahAg mucked
Seat 6: tLcDklc2rBORNfixyRfVfw folded before Flop (didn't bet)
Seat 7: w1ukf8uPa4+WH561TtVRxA folded on the Flop
Seat 8: x+W5+3qsdY4Iszf0hoH+Aw folded before Flop (didn't bet)
Seat 9: gehe91e0IyVT0QU/XBkEyg folded before Flop (didn't bet)




PokerStars Game #59941824368:  Hold'em No Limit ($0.10/$0.25) - 2009/07/01 1:47:18 ET
Table 'v+LTGPWbrLum+Ggd4ef6lg' 9-max Seat #1 is the button
Seat 1: zUXhymECc2C9W9ZNw6qppA ($9.30 in chips) 
Seat 2: r/xYbgD9yVdKFWRgSQD/+Q ($10.95 in chips) 
Seat 3: 7ovWM9c1nQLTFritEGRG/A ($3.10 in chips) 
Seat 4: bXpVeaSTPBFSPJmeXxO7nw ($9.05 in chips) 
Seat 5: +8OkYWUhGfkDbAtQl/ovYQ ($22.90 in chips) 
Seat 7: kUxTO3D2eQcx4oJIpJAK4Q ($7.35 in chips) 
Seat 8: +sbyWwIcFp9kP0bDtMegfQ ($41.20 in chips) 
Seat 9: cZ99hugmLBj9KhTlc8nCSw ($25 in chips) 
r/xYbgD9yVdKFWRgSQD/+Q: posts small blind $0.10
7ovWM9c1nQLTFritEGRG/A: posts big blind $0.25
+qc/EYCgLC65SpGvr35eNg: sits out 
*** HOLE CARDS ***
bXpVeaSTPBFSPJmeXxO7nw: folds 
+8OkYWUhGfkDbAtQl/ovYQ: folds 
kUxTO3D2eQcx4oJIpJAK4Q: folds 
+sbyWwIcFp9kP0bDtMegfQ: folds 
cZ99hugmLBj9KhTlc8nCSw: folds 
zUXhymECc2C9W9ZNw6qppA: folds 
r/xYbgD9yVdKFWRgSQD/+Q: calls $0.15
7ovWM9c1nQLTFritEGRG/A: checks 
*** FLOP *** [Td 8s 9h]
r/xYbgD9yVdKFWRgSQD/+Q: bets $1.50
7ovWM9c1nQLTFritEGRG/A: folds 
Uncalled bet ($1.50) returned to r/xYbgD9yVdKFWRgSQD/+Q
r/xYbgD9yVdKFWRgSQD/+Q collected $0.50 from pot
r/xYbgD9yVdKFWRgSQD/+Q: doesn't show hand 
*** SUMMARY ***
Total pot $0.50 | Rake $0 
Board [Td 8s 9h]
Seat 1: zUXhymECc2C9W9ZNw6qppA (button) folded before Flop (didn't bet)
Seat 2: r/xYbgD9yVdKFWRgSQD/+Q (small blind) collected ($0.50)
Seat 3: 7ovWM9c1nQLTFritEGRG/A (big blind) folded on the Flop
Seat 4: bXpVeaSTPBFSPJmeXxO7nw folded before Flop (didn't bet)
Seat 5: +8OkYWUhGfkDbAtQl/ovYQ folded before Flop (didn't bet)
Seat 7: kUxTO3D2eQcx4oJIpJAK4Q folded before Flop (didn't bet)
Seat 8: +sbyWwIcFp9kP0bDtMegfQ folded before Flop (didn't bet)
Seat 9: cZ99hugmLBj9KhTlc8nCSw folded before Flop (didn't bet)




PokerStars Game #59941823926:  Hold'em No Limit ($0.10/$0.25) - 2009/07/01 1:47:18 ET
Table 'Dun24l/X8kjpUHWBhkVOFw' 6-max Seat #3 is the button
Seat 1: u3Ol7kv1LmvszuHNm9rc6w ($23.15 in chips) 
Seat 2: 6hUmfDYq+83kvxWoTBQmfw ($24 in chips) 
Seat 3: +E5iJKkKVfaTgTqzuXXv0g ($13.15 in chips) 
Seat 4: 7/ROHX4tuLekJ2diYIlMkw ($8.55 in chips) 
Seat 5: KYBwVA7jgmSrbIEbEGElVg ($23.30 in chips) 
7/ROHX4tuLekJ2diYIlMkw: posts small blind $0.10
KYBwVA7jgmSrbIEbEGElVg: posts big blind $0.25
xrf8tAXKQHG99HixCot1Iw: sits out 
*** HOLE CARDS ***
u3Ol7kv1LmvszuHNm9rc6w: calls $0.25
6hUmfDYq+83kvxWoTBQmfw: raises $0.25 to $0.50
+E5iJKkKVfaTgTqzuXXv0g: folds 
7/ROHX4tuLekJ2diYIlMkw: calls $0.40
KYBwVA7jgmSrbIEbEGElVg: raises $0.25 to $0.75
u3Ol7kv1LmvszuHNm9rc6w: calls $0.50
6hUmfDYq+83kvxWoTBQmfw: calls $0.25
7/ROHX4tuLekJ2diYIlMkw: calls $0.25
*** FLOP *** [Ks 9c Jc]
7/ROHX4tuLekJ2diYIlMkw: bets $0.75
KYBwVA7jgmSrbIEbEGElVg: folds 
u3Ol7kv1LmvszuHNm9rc6w: folds 
6hUmfDYq+83kvxWoTBQmfw: calls $0.75
*** TURN *** [Ks 9c Jc] [2s]
7/ROHX4tuLekJ2diYIlMkw: bets $1.25
6hUmfDYq+83kvxWoTBQmfw: calls $1.25
*** RIVER *** [Ks 9c Jc 2s] [6d]
7/ROHX4tuLekJ2diYIlMkw: bets $2.75
6hUmfDYq+83kvxWoTBQmfw: calls $2.75
*** SHOW DOWN ***
7/ROHX4tuLekJ2diYIlMkw: shows [8d Td] (high card King)
6hUmfDYq+83kvxWoTBQmfw: shows [Js Tc] (a pair of Jacks)
6hUmfDYq+83kvxWoTBQmfw collected $11.90 from pot
*** SUMMARY ***
Total pot $12.50 | Rake $0.60 
Board [Ks 9c Jc 2s 6d]
Seat 1: u3Ol7kv1LmvszuHNm9rc6w folded on the Flop
Seat 2: 6hUmfDYq+83kvxWoTBQmfw showed [Js Tc] and won ($11.90) with a pair of Jacks
Seat 3: +E5iJKkKVfaTgTqzuXXv0g (button) folded before Flop (didn't bet)
Seat 4: 7/ROHX4tuLekJ2diYIlMkw (small blind) showed [8d Td] and lost with high card King
Seat 5: KYBwVA7jgmSrbIEbEGElVg (big blind) folded on the Flop




PokerStars Game #59941824322:  Hold'em No Limit ($0.10/$0.25) - 2009/07/01 1:47:18 ET
Table '+198VWQSWBhYQOcizzuBkw' 6-max Seat #2 is the button
Seat 1: 34ttqW62uIRrqINCCmLcsw ($19.65 in chips) 
Seat 2: iauW7L/+7qzAuHow7CD75Q ($10.35 in chips) 
Seat 3: vw7gefupgmOJJN8lUemdWg ($18.30 in chips) 
Seat 4: TgDsTeCdLQt8kWbL00ByRA ($14.75 in chips) 
Seat 5: LtASJ9OlkqGrrUKGQlpGAw ($25.35 in chips) 
Seat 6: leEQ84f6wJYu5SB/vj27wg ($3.80 in chips) 
vw7gefupgmOJJN8lUemdWg: posts small blind $0.10
TgDsTeCdLQt8kWbL00ByRA: posts big blind $0.25
*** HOLE CARDS ***
LtASJ9OlkqGrrUKGQlpGAw: folds 
leEQ84f6wJYu5SB/vj27wg: folds 
34ttqW62uIRrqINCCmLcsw: folds 
iauW7L/+7qzAuHow7CD75Q: folds 
vw7gefupgmOJJN8lUemdWg: calls $0.15
TgDsTeCdLQt8kWbL00ByRA: checks 
*** FLOP *** [Jd 4d 9h]
vw7gefupgmOJJN8lUemdWg: checks 
TgDsTeCdLQt8kWbL00ByRA: bets $0.75
vw7gefupgmOJJN8lUemdWg: folds 
Uncalled bet ($0.75) returned to TgDsTeCdLQt8kWbL00ByRA
TgDsTeCdLQt8kWbL00ByRA collected $0.50 from pot
*** SUMMARY ***
Total pot $0.50 | Rake $0 
Board [Jd 4d 9h]
Seat 1: 34ttqW62uIRrqINCCmLcsw folded before Flop (didn't bet)
Seat 2: iauW7L/+7qzAuHow7CD75Q (button) folded before Flop (didn't bet)
Seat 3: vw7gefupgmOJJN8lUemdWg (small blind) folded on the Flop
Seat 4: TgDsTeCdLQt8kWbL00ByRA (big blind) collected ($0.50)
Seat 5: LtASJ9OlkqGrrUKGQlpGAw folded before Flop (didn't bet)
Seat 6: leEQ84f6wJYu5SB/vj27wg folded before Flop (didn't bet)




PokerStars Game #59941824264:  Hold'em No Limit ($0.10/$0.25) - 2009/07/01 1:47:18 ET
Table 'NgexmgEDEzICBeSO7YCrKQ' 6-max Seat #5 is the button
Seat 1: cezpHJ8FB07dj0xG+LhOvw ($29.45 in chips) 
Seat 2: 32YL2ZEp8NT4JB2RVM9euQ ($21.55 in chips) 
Seat 3: JFIAqU8lCZ0vWwEl4bdGsg ($27.55 in chips) 
Seat 4: xx+iYCDJhHJmNzrfeloyEg ($22.30 in chips) 
Seat 5: /MXkdT8TTs8Qp2LVTQNw6w ($42.45 in chips) 
Seat 6: k9nHZTHt8hYhYRcW8NTb4g ($11.05 in chips) 
k9nHZTHt8hYhYRcW8NTb4g: posts small blind $0.10
cezpHJ8FB07dj0xG+LhOvw: posts big blind $0.25
*** HOLE CARDS ***
32YL2ZEp8NT4JB2RVM9euQ: folds 
JFIAqU8lCZ0vWwEl4bdGsg: folds 
xx+iYCDJhHJmNzrfeloyEg: folds 
/MXkdT8TTs8Qp2LVTQNw6w: folds 
k9nHZTHt8hYhYRcW8NTb4g: raises $0.50 to $0.75
cezpHJ8FB07dj0xG+LhOvw: folds 
Uncalled bet ($0.50) returned to k9nHZTHt8hYhYRcW8NTb4g
k9nHZTHt8hYhYRcW8NTb4g collected $0.50 from pot
k9nHZTHt8hYhYRcW8NTb4g: doesn't show hand 
*** SUMMARY ***
Total pot $0.50 | Rake $0 
Seat 1: cezpHJ8FB07dj0xG+LhOvw (big blind) folded before Flop
Seat 2: 32YL2ZEp8NT4JB2RVM9euQ folded before Flop (didn't bet)
Seat 3: JFIAqU8lCZ0vWwEl4bdGsg folded before Flop (didn't bet)
Seat 4: xx+iYCDJhHJmNzrfeloyEg folded before Flop (didn't bet)
Seat 5: /MXkdT8TTs8Qp2LVTQNw6w (button) folded before Flop (didn't bet)
Seat 6: k9nHZTHt8hYhYRcW8NTb4g (small blind) collected ($0.50)




PokerStars Game #59941824168:  Hold'em No Limit ($0.10/$0.25) - 2009/07/01 1:47:18 ET
Table 'mVdLgAdN9rGe6mMwSrDdGQ' 6-max Seat #6 is the button
Seat 1: OyJ0KTHA5cwh0/yCo1/rdA ($9.75 in chips) 
Seat 2: n9QqWD4tpbongUBX2Oi58w ($5.95 in chips) 
Seat 3: +baiVgI/ETnBARLe5mARCw ($13.95 in chips) 
Seat 4: scNSjC6yyKvvfklSkuzLrw ($18.30 in chips) 
Seat 5: +TMG/MBWpiEnc9t7i07eTA ($26.40 in chips) 
Seat 6: DihMHaz4WNETH1bPDe13kA ($47.45 in chips) 
OyJ0KTHA5cwh0/yCo1/rdA: posts small blind $0.10
n9QqWD4tpbongUBX2Oi58w: posts big blind $0.25
*** HOLE CARDS ***
+baiVgI/ETnBARLe5mARCw: folds 
scNSjC6yyKvvfklSkuzLrw: calls $0.25
+TMG/MBWpiEnc9t7i07eTA: calls $0.25
DihMHaz4WNETH1bPDe13kA: folds 
OyJ0KTHA5cwh0/yCo1/rdA: raises $1 to $1.25
n9QqWD4tpbongUBX2Oi58w: folds 
scNSjC6yyKvvfklSkuzLrw: folds 
+TMG/MBWpiEnc9t7i07eTA: calls $1
*** FLOP *** [7h 6c Qc]
OyJ0KTHA5cwh0/yCo1/rdA: checks 
+TMG/MBWpiEnc9t7i07eTA: checks 
*** TURN *** [7h 6c Qc] [Kc]
OyJ0KTHA5cwh0/yCo1/rdA: bets $0.50
+TMG/MBWpiEnc9t7i07eTA: calls $0.50
*** RIVER *** [7h 6c Qc Kc] [3d]
OyJ0KTHA5cwh0/yCo1/rdA: bets $2
+TMG/MBWpiEnc9t7i07eTA: folds 
Uncalled bet ($2) returned to OyJ0KTHA5cwh0/yCo1/rdA
OyJ0KTHA5cwh0/yCo1/rdA collected $3.85 from pot
OyJ0KTHA5cwh0/yCo1/rdA: doesn't show hand 
*** SUMMARY ***
Total pot $4 | Rake $0.15 
Board [7h 6c Qc Kc 3d]
Seat 1: OyJ0KTHA5cwh0/yCo1/rdA (small blind) collected ($3.85)
Seat 2: n9QqWD4tpbongUBX2Oi58w (big blind) folded before Flop
Seat 3: +baiVgI/ETnBARLe5mARCw folded before Flop (didn't bet)
Seat 4: scNSjC6yyKvvfklSkuzLrw folded before Flop
Seat 5: +TMG/MBWpiEnc9t7i07eTA folded on the River
Seat 6: DihMHaz4WNETH1bPDe13kA (button) folded before Flop (didn't bet)




PokerStars Game #59941824288:  Hold'em No Limit ($0.10/$0.25) - 2009/07/01 1:47:18 ET
Table '4XGDnEByOol5up4aB2KbJw' 6-max Seat #6 is the button
Seat 1: kyRaCIljYA6l33lSKQfNsg ($26.25 in chips) 
Seat 2: SFmT9ZsVopnukjvAzrxTRg ($46.45 in chips) 
Seat 3: LtASJ9OlkqGrrUKGQlpGAw ($20.90 in chips) 
Seat 4: BV+K0Phf5VBHr7aZPKqbUQ ($25 in chips) 
Seat 5: Dh01+rohD2p9pXLYeBlC5Q ($16.65 in chips) 
Seat 6: a7Ux7aERFGCbT/L3ojVfAg ($10.90 in chips) 
kyRaCIljYA6l33lSKQfNsg: posts small blind $0.10
SFmT9ZsVopnukjvAzrxTRg: posts big blind $0.25
*** HOLE CARDS ***
LtASJ9OlkqGrrUKGQlpGAw: folds 
BV+K0Phf5VBHr7aZPKqbUQ: folds 
Dh01+rohD2p9pXLYeBlC5Q: calls $0.25
a7Ux7aERFGCbT/L3ojVfAg: calls $0.25
kyRaCIljYA6l33lSKQfNsg: folds 
SFmT9ZsVopnukjvAzrxTRg: checks 
*** FLOP *** [4h 5h Ks]
SFmT9ZsVopnukjvAzrxTRg: checks 
Dh01+rohD2p9pXLYeBlC5Q: checks 
a7Ux7aERFGCbT/L3ojVfAg: checks 
*** TURN *** [4h 5h Ks] [4s]
SFmT9ZsVopnukjvAzrxTRg: checks 
Dh01+rohD2p9pXLYeBlC5Q: checks 
a7Ux7aERFGCbT/L3ojVfAg: checks 
*** RIVER *** [4h 5h Ks 4s] [7c]
SFmT9ZsVopnukjvAzrxTRg: checks 
Dh01+rohD2p9pXLYeBlC5Q: checks 
a7Ux7aERFGCbT/L3ojVfAg: checks 
*** SHOW DOWN ***
SFmT9ZsVopnukjvAzrxTRg: shows [Ah 9c] (a pair of Fours)
Dh01+rohD2p9pXLYeBlC5Q: shows [7d Th] (two pair, Sevens and Fours)
a7Ux7aERFGCbT/L3ojVfAg: mucks hand 
Dh01+rohD2p9pXLYeBlC5Q collected $0.85 from pot
*** SUMMARY ***
Total pot $0.85 | Rake $0 
Board [4h 5h Ks 4s 7c]
Seat 1: kyRaCIljYA6l33lSKQfNsg (small blind) folded before Flop
Seat 2: SFmT9ZsVopnukjvAzrxTRg (big blind) showed [Ah 9c] and lost with a pair of Fours
Seat 3: LtASJ9OlkqGrrUKGQlpGAw folded before Flop (didn't bet)
Seat 4: BV+K0Phf5VBHr7aZPKqbUQ folded before Flop (didn't bet)
Seat 5: Dh01+rohD2p9pXLYeBlC5Q showed [7d Th] and won ($0.85) with two pair, Sevens and Fours
Seat 6: a7Ux7aERFGCbT/L3ojVfAg (button) mucked




PokerStars Game #59941824108:  Hold'em No Limit ($0.10/$0.25) - 2009/07/01 1:47:18 ET
Table 'MJ1SB76A4qJrlEa+C5e/8w' 6-max Seat #4 is the button
Seat 1: 0KDZiuXQg6UI9cqBR/AUnQ ($26 in chips) 
Seat 2: UA5OsKS3VPaxa7uC8La/kA ($37.40 in chips) 
Seat 3: DihMHaz4WNETH1bPDe13kA ($32.55 in chips) 
Seat 4: SFmT9ZsVopnukjvAzrxTRg ($27.80 in chips) 
Seat 5: Hsvkc0/G2VV78oVmWYXecw ($5 in chips) 
Seat 6: JFIAqU8lCZ0vWwEl4bdGsg ($30.30 in chips) 
Hsvkc0/G2VV78oVmWYXecw: posts small blind $0.10
JFIAqU8lCZ0vWwEl4bdGsg: posts big blind $0.25
*** HOLE CARDS ***
0KDZiuXQg6UI9cqBR/AUnQ is disconnected 
0KDZiuXQg6UI9cqBR/AUnQ is connected 
0KDZiuXQg6UI9cqBR/AUnQ: folds 
UA5OsKS3VPaxa7uC8La/kA: folds 
DihMHaz4WNETH1bPDe13kA: folds 
SFmT9ZsVopnukjvAzrxTRg: folds 
Hsvkc0/G2VV78oVmWYXecw: raises $0.50 to $0.75
JFIAqU8lCZ0vWwEl4bdGsg: folds 
Uncalled bet ($0.50) returned to Hsvkc0/G2VV78oVmWYXecw
Hsvkc0/G2VV78oVmWYXecw collected $0.50 from pot
Hsvkc0/G2VV78oVmWYXecw: doesn't show hand 
*** SUMMARY ***
Total pot $0.50 | Rake $0 
Seat 1: 0KDZiuXQg6UI9cqBR/AUnQ folded before Flop (didn't bet)
Seat 2: UA5OsKS3VPaxa7uC8La/kA folded before Flop (didn't bet)
Seat 3: DihMHaz4WNETH1bPDe13kA folded before Flop (didn't bet)
Seat 4: SFmT9ZsVopnukjvAzrxTRg (button) folded before Flop (didn't bet)
Seat 5: Hsvkc0/G2VV78oVmWYXecw (small blind) collected ($0.50)
Seat 6: JFIAqU8lCZ0vWwEl4bdGsg (big blind) folded before Flop




PokerStars Game #59941824268:  Hold'em No Limit ($0.10/$0.25) - 2009/07/01 1:47:18 ET
Table 'yAHDCs33TIgw3ra63xuU2Q' 9-max Seat #5 is the button
Seat 1: ydoFOVgzvZv9ZhuWu9rXAw ($9.85 in chips) 
Seat 3: g6UPjSyxNLffCi+EqqIlEg ($21.05 in chips) 
Seat 4: j5spkbnOCRiLGiH6iqBaqw ($8.80 in chips) 
Seat 5: 4awUyiDYTgylQKXZ9faBVA ($37.25 in chips) 
Seat 6: DnDcAdn9P0zGovMERigpFA ($26.05 in chips) 
Seat 9: MtVtHDqIJTyUcXkRBBDIVA ($25 in chips) 
DnDcAdn9P0zGovMERigpFA: posts small blind $0.10
tYsOBqdU1+x+yFI7zHO7hQ: is sitting out 
MtVtHDqIJTyUcXkRBBDIVA: posts big blind $0.25
j4q3p0lesp63b1gZDwLBZw: sits out 
*** HOLE CARDS ***
ydoFOVgzvZv9ZhuWu9rXAw: folds 
tYsOBqdU1+x+yFI7zHO7hQ leaves the table
ydoFOVgzvZv9ZhuWu9rXAw leaves the table
g6UPjSyxNLffCi+EqqIlEg: raises $0.50 to $0.75
j5spkbnOCRiLGiH6iqBaqw: folds 
4awUyiDYTgylQKXZ9faBVA: raises $2 to $2.75
DnDcAdn9P0zGovMERigpFA: folds 
MtVtHDqIJTyUcXkRBBDIVA: folds 
g6UPjSyxNLffCi+EqqIlEg: folds 
Uncalled bet ($2) returned to 4awUyiDYTgylQKXZ9faBVA
4awUyiDYTgylQKXZ9faBVA collected $1.85 from pot
4awUyiDYTgylQKXZ9faBVA: doesn't show hand 
*** SUMMARY ***
Total pot $1.85 | Rake $0 
Seat 1: ydoFOVgzvZv9ZhuWu9rXAw folded before Flop (didn't bet)
Seat 3: g6UPjSyxNLffCi+EqqIlEg folded before Flop
Seat 4: j5spkbnOCRiLGiH6iqBaqw folded before Flop (didn't bet)
Seat 5: 4awUyiDYTgylQKXZ9faBVA (button) collected ($1.85)
Seat 6: DnDcAdn9P0zGovMERigpFA (small blind) folded before Flop
Seat 9: MtVtHDqIJTyUcXkRBBDIVA (big blind) folded before Flop




PokerStars Game #59941824624:  Hold'em No Limit ($0.10/$0.25) - 2009/07/01 1:47:19 ET
Table 'xPn6TS/y/OWkX7Qa+MUuKA' 6-max Seat #2 is the button
Seat 1: JFIAqU8lCZ0vWwEl4bdGsg ($42.70 in chips) 
Seat 2: buyjetgNT1McXtdaP4zynA ($27.60 in chips) 
Seat 3: q6WfTUAD9mowIP63ASq2Dg ($24.25 in chips) 
Seat 4: SS/yfeArhULzIcOPe8MdPg ($28.65 in chips) 
Seat 5: lquriepNQBhDV5P1SWHhnA ($28.60 in chips) 
Seat 6: DihMHaz4WNETH1bPDe13kA ($25 in chips) 
q6WfTUAD9mowIP63ASq2Dg: posts small blind $0.10
SS/yfeArhULzIcOPe8MdPg: posts big blind $0.25
*** HOLE CARDS ***
lquriepNQBhDV5P1SWHhnA: folds 
DihMHaz4WNETH1bPDe13kA: folds 
JFIAqU8lCZ0vWwEl4bdGsg: folds 
buyjetgNT1McXtdaP4zynA: raises $0.75 to $1
q6WfTUAD9mowIP63ASq2Dg: folds 
SS/yfeArhULzIcOPe8MdPg: folds 
Uncalled bet ($0.75) returned to buyjetgNT1McXtdaP4zynA
buyjetgNT1McXtdaP4zynA collected $0.60 from pot
*** SUMMARY ***
Total pot $0.60 | Rake $0 
Seat 1: JFIAqU8lCZ0vWwEl4bdGsg folded before Flop (didn't bet)
Seat 2: buyjetgNT1McXtdaP4zynA (button) collected ($0.60)
Seat 3: q6WfTUAD9mowIP63ASq2Dg (small blind) folded before Flop
Seat 4: SS/yfeArhULzIcOPe8MdPg (big blind) folded before Flop
Seat 5: lquriepNQBhDV5P1SWHhnA folded before Flop (didn't bet)
Seat 6: DihMHaz4WNETH1bPDe13kA folded before Flop (didn't bet)




PokerStars Game #59941824662:  Hold'em No Limit ($0.10/$0.25) - 2009/07/01 1:47:19 ET
Table 'M8kYidAX3ib7pLKW7edFLw' 6-max Seat #2 is the button
Seat 1: jp34e617tIzV8tKIWmfAbA ($25 in chips) 
Seat 2: ypmjhffk/YHGc51wgVXUTw ($25 in chips) 
Seat 3: cezpHJ8FB07dj0xG+LhOvw ($26.85 in chips) 
Seat 4: Hsvkc0/G2VV78oVmWYXecw ($5.30 in chips) 
Seat 5: bDKopKTvPi3W+PEnYUX3tg ($46.35 in chips) 
Seat 6: NqFoyDgzLwu4dOmSRXnFBA ($25.25 in chips) 
cezpHJ8FB07dj0xG+LhOvw: posts small blind $0.10
Hsvkc0/G2VV78oVmWYXecw: posts big blind $0.25
*** HOLE CARDS ***
bDKopKTvPi3W+PEnYUX3tg: calls $0.25
NqFoyDgzLwu4dOmSRXnFBA: folds 
jp34e617tIzV8tKIWmfAbA: raises $1 to $1.25
ypmjhffk/YHGc51wgVXUTw: folds 
cezpHJ8FB07dj0xG+LhOvw: folds 
Hsvkc0/G2VV78oVmWYXecw: folds 
bDKopKTvPi3W+PEnYUX3tg: calls $1
*** FLOP *** [Js Tc Td]
bDKopKTvPi3W+PEnYUX3tg: checks 
jp34e617tIzV8tKIWmfAbA: checks 
*** TURN *** [Js Tc Td] [6d]
bDKopKTvPi3W+PEnYUX3tg: bets $1.75
jp34e617tIzV8tKIWmfAbA: folds 
Uncalled bet ($1.75) returned to bDKopKTvPi3W+PEnYUX3tg
bDKopKTvPi3W+PEnYUX3tg collected $2.75 from pot
bDKopKTvPi3W+PEnYUX3tg: doesn't show hand 
*** SUMMARY ***
Total pot $2.85 | Rake $0.10 
Board [Js Tc Td 6d]
Seat 1: jp34e617tIzV8tKIWmfAbA folded on the Turn
Seat 2: ypmjhffk/YHGc51wgVXUTw (button) folded before Flop (didn't bet)
Seat 3: cezpHJ8FB07dj0xG+LhOvw (small blind) folded before Flop
Seat 4: Hsvkc0/G2VV78oVmWYXecw (big blind) folded before Flop
Seat 5: bDKopKTvPi3W+PEnYUX3tg collected ($2.75)
Seat 6: NqFoyDgzLwu4dOmSRXnFBA folded before Flop (didn't bet)




PokerStars Game #59941824564:  Hold'em No Limit ($0.10/$0.25) - 2009/07/01 1:47:19 ET
Table 'dZNBGqFYSwfOVZvDJ4VjIQ' 6-max Seat #6 is the button
Seat 1: v+QfkGiuj9bgtuNoVnDO8w ($37.20 in chips) 
Seat 2: 3zD3qLXT1bEffAoWGnc7wg ($29.30 in chips) 
Seat 3: kyRaCIljYA6l33lSKQfNsg ($28.30 in chips) 
Seat 4: mFv3iBCtrw9XfCDRB0d46Q ($5.80 in chips) 
Seat 5: +ZlnqPoP3Hg4BIUxDfKd/A ($29.25 in chips) 
Seat 6: ypmjhffk/YHGc51wgVXUTw ($29.40 in chips) 
v+QfkGiuj9bgtuNoVnDO8w: posts small blind $0.10
3zD3qLXT1bEffAoWGnc7wg: posts big blind $0.25
*** HOLE CARDS ***
kyRaCIljYA6l33lSKQfNsg: folds 
mFv3iBCtrw9XfCDRB0d46Q: folds 
+ZlnqPoP3Hg4BIUxDfKd/A: folds 
ypmjhffk/YHGc51wgVXUTw: folds 
v+QfkGiuj9bgtuNoVnDO8w: folds 
Uncalled bet ($0.15) returned to 3zD3qLXT1bEffAoWGnc7wg
3zD3qLXT1bEffAoWGnc7wg collected $0.20 from pot
3zD3qLXT1bEffAoWGnc7wg: doesn't show hand 
*** SUMMARY ***
Total pot $0.20 | Rake $0 
Seat 1: v+QfkGiuj9bgtuNoVnDO8w (small blind) folded before Flop
Seat 2: 3zD3qLXT1bEffAoWGnc7wg (big blind) collected ($0.20)
Seat 3: kyRaCIljYA6l33lSKQfNsg folded before Flop (didn't bet)
Seat 4: mFv3iBCtrw9XfCDRB0d46Q folded before Flop (didn't bet)
Seat 5: +ZlnqPoP3Hg4BIUxDfKd/A folded before Flop (didn't bet)
Seat 6: ypmjhffk/YHGc51wgVXUTw (button) folded before Flop (didn't bet)




PokerStars Game #59941824688:  Hold'em No Limit ($0.10/$0.25) - 2009/07/01 1:47:19 ET
Table 'ukli1Y7ieC5JQMTEFxM2Nw' 6-max Seat #2 is the button
Seat 1: N162H80ZIQevUf2EzGahCA ($8.80 in chips) 
Seat 2: u/yN5P9f3KlATg6WLWNkBQ ($42.20 in chips) 
Seat 3: ExeoJ1G/rSmWa3tRz7TlCA ($23.20 in chips) 
Seat 4: if4dh6jhJXeN3/qd3qCp9g ($27.35 in chips) 
Seat 5: Se+H4Z4PDr6+eIUDJX1rpg ($17.65 in chips) 
Seat 6: 32YL2ZEp8NT4JB2RVM9euQ ($30.15 in chips) 
ExeoJ1G/rSmWa3tRz7TlCA: posts small blind $0.10
if4dh6jhJXeN3/qd3qCp9g: posts big blind $0.25
*** HOLE CARDS ***
Se+H4Z4PDr6+eIUDJX1rpg: folds 
32YL2ZEp8NT4JB2RVM9euQ: folds 
N162H80ZIQevUf2EzGahCA: folds 
u/yN5P9f3KlATg6WLWNkBQ: raises $1 to $1.25
ExeoJ1G/rSmWa3tRz7TlCA: folds 
if4dh6jhJXeN3/qd3qCp9g: folds 
Uncalled bet ($1) returned to u/yN5P9f3KlATg6WLWNkBQ
u/yN5P9f3KlATg6WLWNkBQ collected $0.60 from pot
u/yN5P9f3KlATg6WLWNkBQ: doesn't show hand 
*** SUMMARY ***
Total pot $0.60 | Rake $0 
Seat 1: N162H80ZIQevUf2EzGahCA folded before Flop (didn't bet)
Seat 2: u/yN5P9f3KlATg6WLWNkBQ (button) collected ($0.60)
Seat 3: ExeoJ1G/rSmWa3tRz7TlCA (small blind) folded before Flop
Seat 4: if4dh6jhJXeN3/qd3qCp9g (big blind) folded before Flop
Seat 5: Se+H4Z4PDr6+eIUDJX1rpg folded before Flop (didn't bet)
Seat 6: 32YL2ZEp8NT4JB2RVM9euQ folded before Flop (didn't bet)




PokerStars Game #59941824826:  Hold'em No Limit ($0.10/$0.25) - 2009/07/01 1:47:19 ET
Table '60nA7av6bws9VnNmVwculA' 6-max Seat #2 is the button
Seat 1: if4dh6jhJXeN3/qd3qCp9g ($24.65 in chips) 
Seat 2: Bada343Si4xKu3fNXY99AA ($3.50 in chips) 
Seat 3: mnuJq+Q1IXKm/pCy+OzxmQ ($20.70 in chips) 
Seat 4: +baiVgI/ETnBARLe5mARCw ($18.60 in chips) 
Seat 5: zXh+lOT41Q2iWgCNj+OcRw ($12.35 in chips) 
Seat 6: mfrkWA3PTeYPkbO6hi98Aw ($24.75 in chips) 
mnuJq+Q1IXKm/pCy+OzxmQ: posts small blind $0.10
+baiVgI/ETnBARLe5mARCw: posts big blind $0.25
*** HOLE CARDS ***
zXh+lOT41Q2iWgCNj+OcRw: folds 
mfrkWA3PTeYPkbO6hi98Aw: folds 
if4dh6jhJXeN3/qd3qCp9g: folds 
Bada343Si4xKu3fNXY99AA: raises $0.50 to $0.75
mnuJq+Q1IXKm/pCy+OzxmQ: calls $0.65
+baiVgI/ETnBARLe5mARCw: folds 
*** FLOP *** [2c 8h Jd]
mnuJq+Q1IXKm/pCy+OzxmQ: bets $0.75
Bada343Si4xKu3fNXY99AA: folds 
Uncalled bet ($0.75) returned to mnuJq+Q1IXKm/pCy+OzxmQ
mnuJq+Q1IXKm/pCy+OzxmQ collected $1.70 from pot
mnuJq+Q1IXKm/pCy+OzxmQ: doesn't show hand 
*** SUMMARY ***
Total pot $1.75 | Rake $0.05 
Board [2c 8h Jd]
Seat 1: if4dh6jhJXeN3/qd3qCp9g folded before Flop (didn't bet)
Seat 2: Bada343Si4xKu3fNXY99AA (button) folded on the Flop
Seat 3: mnuJq+Q1IXKm/pCy+OzxmQ (small blind) collected ($1.70)
Seat 4: +baiVgI/ETnBARLe5mARCw (big blind) folded before Flop
Seat 5: zXh+lOT41Q2iWgCNj+OcRw folded before Flop (didn't bet)
Seat 6: mfrkWA3PTeYPkbO6hi98Aw folded before Flop (didn't bet)




PokerStars Game #59941824612:  Hold'em No Limit ($0.10/$0.25) - 2009/07/01 1:47:19 ET
Table 'SbSV5tlgLp0+/Z+13PW3Hg' 9-max Seat #1 is the button
Seat 1: x+W5+3qsdY4Iszf0hoH+Aw ($19.05 in chips) 
Seat 3: CT7Xj/V/O5rBlhtt+RZeFQ ($25.70 in chips) 
Seat 4: puj3K/wrNjEj86ZL/MyfLA ($8.90 in chips) 
Seat 5: aNpwfA31EREwO+ar4XzBCw ($25 in chips) 
Seat 6: pN3IHvAKm2fz+sTRARTcrg ($25.40 in chips) 
Seat 8: qBdqLaJhO+1itcMk70bsfA ($7.65 in chips) 
Seat 9: X78b5v/uhqeXXoAijbw/yg ($25 in chips) 
CT7Xj/V/O5rBlhtt+RZeFQ: posts small blind $0.10
puj3K/wrNjEj86ZL/MyfLA: posts big blind $0.25
3PmVnC/15cl4oyI1TKIt4g: sits out 
*** HOLE CARDS ***
aNpwfA31EREwO+ar4XzBCw: folds 
pN3IHvAKm2fz+sTRARTcrg: folds 
qBdqLaJhO+1itcMk70bsfA: folds 
X78b5v/uhqeXXoAijbw/yg: folds 
x+W5+3qsdY4Iszf0hoH+Aw: calls $0.25
CT7Xj/V/O5rBlhtt+RZeFQ: folds 
puj3K/wrNjEj86ZL/MyfLA: checks 
*** FLOP *** [7h 6h Jh]
puj3K/wrNjEj86ZL/MyfLA: checks 
x+W5+3qsdY4Iszf0hoH+Aw: checks 
*** TURN *** [7h 6h Jh] [Jd]
puj3K/wrNjEj86ZL/MyfLA: checks 
x+W5+3qsdY4Iszf0hoH+Aw: checks 
*** RIVER *** [7h 6h Jh Jd] [8h]
puj3K/wrNjEj86ZL/MyfLA: checks 
x+W5+3qsdY4Iszf0hoH+Aw: checks 
*** SHOW DOWN ***
puj3K/wrNjEj86ZL/MyfLA: shows [Tc 3s] (a pair of Jacks)
x+W5+3qsdY4Iszf0hoH+Aw: mucks hand 
puj3K/wrNjEj86ZL/MyfLA collected $0.60 from pot
*** SUMMARY ***
Total pot $0.60 | Rake $0 
Board [7h 6h Jh Jd 8h]
Seat 1: x+W5+3qsdY4Iszf0hoH+Aw (button) mucked
Seat 3: CT7Xj/V/O5rBlhtt+RZeFQ (small blind) folded before Flop
Seat 4: puj3K/wrNjEj86ZL/MyfLA (big blind) showed [Tc 3s] and won ($0.60) with a pair of Jacks
Seat 5: aNpwfA31EREwO+ar4XzBCw folded before Flop (didn't bet)
Seat 6: pN3IHvAKm2fz+sTRARTcrg folded before Flop (didn't bet)
Seat 8: qBdqLaJhO+1itcMk70bsfA folded before Flop (didn't bet)
Seat 9: X78b5v/uhqeXXoAijbw/yg folded before Flop (didn't bet)




PokerStars Game #59941824910:  Hold'em No Limit ($0.10/$0.25) - 2009/07/01 1:47:19 ET
Table 'BmUMTVcNATeov2rAGYU0Qg' 9-max Seat #4 is the button
Seat 1: QEbIGci+itdw+re8RM5fZA ($33.60 in chips) 
Seat 2: jJnMGXoBXye+afMd0k0rUw ($11.65 in chips) 
Seat 3: ir5Jy8ck6DrdqgJ/3chcWw ($9.80 in chips) 
Seat 4: aNpwfA31EREwO+ar4XzBCw ($37.35 in chips) 
Seat 5: QBNcj9fHxkh/+s/oVw+JmQ ($24.10 in chips) 
Seat 6: w1ukf8uPa4+WH561TtVRxA ($25 in chips) 
Seat 7: CmngQmkKTp8tkl6GMRTl6w ($8.50 in chips) 
Seat 9: /artgaAtyUtUtD8FZo6puA ($9.35 in chips) 
QBNcj9fHxkh/+s/oVw+JmQ: posts small blind $0.10
w1ukf8uPa4+WH561TtVRxA: posts big blind $0.25
razor365: sits out 
*** HOLE CARDS ***
CmngQmkKTp8tkl6GMRTl6w: folds 
/artgaAtyUtUtD8FZo6puA: calls $0.25
QEbIGci+itdw+re8RM5fZA: folds 
jJnMGXoBXye+afMd0k0rUw: folds 
ir5Jy8ck6DrdqgJ/3chcWw: calls $0.25
aNpwfA31EREwO+ar4XzBCw: folds 
QBNcj9fHxkh/+s/oVw+JmQ: folds 
w1ukf8uPa4+WH561TtVRxA: checks 
*** FLOP *** [6c 3h Ac]
w1ukf8uPa4+WH561TtVRxA: checks 
/artgaAtyUtUtD8FZo6puA: checks 
ir5Jy8ck6DrdqgJ/3chcWw: bets $0.25
w1ukf8uPa4+WH561TtVRxA: folds 
/artgaAtyUtUtD8FZo6puA: folds 
Uncalled bet ($0.25) returned to ir5Jy8ck6DrdqgJ/3chcWw
ir5Jy8ck6DrdqgJ/3chcWw collected $0.85 from pot
*** SUMMARY ***
Total pot $0.85 | Rake $0 
Board [6c 3h Ac]
Seat 1: QEbIGci+itdw+re8RM5fZA folded before Flop (didn't bet)
Seat 2: jJnMGXoBXye+afMd0k0rUw folded before Flop (didn't bet)
Seat 3: ir5Jy8ck6DrdqgJ/3chcWw collected ($0.85)
Seat 4: aNpwfA31EREwO+ar4XzBCw (button) folded before Flop (didn't bet)
Seat 5: QBNcj9fHxkh/+s/oVw+JmQ (small blind) folded before Flop
Seat 6: w1ukf8uPa4+WH561TtVRxA (big blind) folded on the Flop
Seat 7: CmngQmkKTp8tkl6GMRTl6w folded before Flop (didn't bet)
Seat 9: /artgaAtyUtUtD8FZo6puA folded on the Flop




PokerStars Game #59941824626:  Hold'em No Limit ($0.10/$0.25) - 2009/07/01 1:47:19 ET
Table 'qInMnOOn7vKcj4bU7zju7g' 9-max Seat #6 is the button
Seat 1: CT7Xj/V/O5rBlhtt+RZeFQ ($38.40 in chips) 
Seat 2: HgIyqrvSG8TRRZl5mlzfHA ($67.85 in chips) 
Seat 3: zDrucyjVn5aeekNEc3cJrA ($25.80 in chips) 
Seat 4: ScCuCTbi71/EWsLKZXaZeg ($17.45 in chips) 
Seat 5: KlccfkOygm1GJZoSZYEgBw ($13.65 in chips) 
Seat 6: 4awUyiDYTgylQKXZ9faBVA ($25 in chips) 
Seat 8: Mh2r9hTeTEDnh19sRZtW3g ($5.45 in chips) 
Seat 9: sbArFaUiGjfmf5dg1O4ffg ($3.70 in chips) 
st9jtdNbm1W5GfBwRaCVqQ will be allowed to play after the button
Mh2r9hTeTEDnh19sRZtW3g: posts small blind $0.10
sbArFaUiGjfmf5dg1O4ffg: posts big blind $0.25
*** HOLE CARDS ***
CT7Xj/V/O5rBlhtt+RZeFQ: folds 
HgIyqrvSG8TRRZl5mlzfHA: calls $0.25
zDrucyjVn5aeekNEc3cJrA: folds 
ScCuCTbi71/EWsLKZXaZeg: raises $0.25 to $0.50
KlccfkOygm1GJZoSZYEgBw: calls $0.50
4awUyiDYTgylQKXZ9faBVA: folds 
Mh2r9hTeTEDnh19sRZtW3g: raises $4.95 to $5.45 and is all-in
sbArFaUiGjfmf5dg1O4ffg: folds 
HgIyqrvSG8TRRZl5mlzfHA: folds 
ScCuCTbi71/EWsLKZXaZeg: calls $4.95
KlccfkOygm1GJZoSZYEgBw: folds 
*** FLOP *** [2s Ad 6h]
*** TURN *** [2s Ad 6h] [Qh]
*** RIVER *** [2s Ad 6h Qh] [3c]
*** SHOW DOWN ***
Mh2r9hTeTEDnh19sRZtW3g: shows [Tc Ac] (a pair of Aces)
ScCuCTbi71/EWsLKZXaZeg: mucks hand 
Mh2r9hTeTEDnh19sRZtW3g collected $11.35 from pot
*** SUMMARY ***
Total pot $11.90 | Rake $0.55 
Board [2s Ad 6h Qh 3c]
Seat 1: CT7Xj/V/O5rBlhtt+RZeFQ folded before Flop (didn't bet)
Seat 2: HgIyqrvSG8TRRZl5mlzfHA folded before Flop
Seat 3: zDrucyjVn5aeekNEc3cJrA folded before Flop (didn't bet)
Seat 4: ScCuCTbi71/EWsLKZXaZeg mucked
Seat 5: KlccfkOygm1GJZoSZYEgBw folded before Flop
Seat 6: 4awUyiDYTgylQKXZ9faBVA (button) folded before Flop (didn't bet)
Seat 8: Mh2r9hTeTEDnh19sRZtW3g (small blind) showed [Tc Ac] and won ($11.35) with a pair of Aces
Seat 9: sbArFaUiGjfmf5dg1O4ffg (big blind) folded before Flop




PokerStars Game #59941824874:  Hold'em No Limit ($0.10/$0.25) - 2009/07/01 1:47:19 ET
Table 'oG007Tb0LYbfANo6QWd16wWEMI3Mtn7dGARDbgNrKibgx Seat #7 is the button
Seat 1: DiSvPC2iudwL5j9u6Huyww ($46.65 in chips) 
Seat 2: zDrucyjVn5aeekNEc3cJrA ($15.10 in chips) 
Seat 4: zgi+EUykT/pZQpoUG6+oEg ($5 in chips) 
Seat 5: 8f0dtuUGqDbgE6up1lQAlg ($5.50 in chips) 
Seat 6: yqkowiRWZ6NvRN9UUkYIlA ($5 in chips) 
Seat 7: Mh2r9hTeTEDnh19sRZtW3g ($4.90 in chips) 
Seat 8: q4cNXFZGNhLfrTyVrIy6Mg ($14.40 in chips) 
Seat 9: EVqHvqty1ZsuvDFiSXlSqQ ($24.25 in chips) 
q4cNXFZGNhLfrTyVrIy6Mg: posts small blind $0.10
EVqHvqty1ZsuvDFiSXlSqQ: posts big blind $0.25
zDrucyjVn5aeekNEc3cJrA: posts small blind $0.10
pN3IHvAKm2fz+sTRARTcrg: sits out 
*** HOLE CARDS ***
DiSvPC2iudwL5j9u6Huyww: folds 
zDrucyjVn5aeekNEc3cJrA: folds 
zgi+EUykT/pZQpoUG6+oEg: folds 
8f0dtuUGqDbgE6up1lQAlg: calls $0.25
yqkowiRWZ6NvRN9UUkYIlA: folds 
Mh2r9hTeTEDnh19sRZtW3g: raises $0.75 to $1
q4cNXFZGNhLfrTyVrIy6Mg: folds 
EVqHvqty1ZsuvDFiSXlSqQ: raises $23.25 to $24.25 and is all-in
8f0dtuUGqDbgE6up1lQAlg: folds 
Mh2r9hTeTEDnh19sRZtW3g: calls $3.90 and is all-in
Uncalled bet ($19.35) returned to EVqHvqty1ZsuvDFiSXlSqQ
*** FLOP *** [6c Qh 7c]
*** TURN *** [6c Qh 7c] [4d]
*** RIVER *** [6c Qh 7c 4d] [6h]
*** SHOW DOWN ***
EVqHvqty1ZsuvDFiSXlSqQ: shows [8s 8h] (two pair, Eights and Sixes)
Mh2r9hTeTEDnh19sRZtW3g: mucks hand 
EVqHvqty1ZsuvDFiSXlSqQ collected $9.75 from pot
*** SUMMARY ***
Total pot $10.25 | Rake $0.50 
Board [6c Qh 7c 4d 6h]
Seat 1: DiSvPC2iudwL5j9u6Huyww folded before Flop (didn't bet)
Seat 2: zDrucyjVn5aeekNEc3cJrA folded before Flop
Seat 4: zgi+EUykT/pZQpoUG6+oEg folded before Flop (didn't bet)
Seat 5: 8f0dtuUGqDbgE6up1lQAlg folded before Flop
Seat 6: yqkowiRWZ6NvRN9UUkYIlA folded before Flop (didn't bet)
Seat 7: Mh2r9hTeTEDnh19sRZtW3g (button) mucked
Seat 8: q4cNXFZGNhLfrTyVrIy6Mg (small blind) folded before Flop
Seat 9: EVqHvqty1ZsuvDFiSXlSqQ (big blind) showed [8s 8h] and won ($9.75) with two pair, Eights and Sixes




PokerStars Game #59941824482:  Hold'em No Limit ($0.10/$0.25) - 2009/07/01 1:47:19 ET
Table 'L5GvbdQO5aCZJSE6pyQ8OA' 6-max Seat #3 is the button
Seat 2: DihMHaz4WNETH1bPDe13kA ($31.05 in chips) 
Seat 3: JFIAqU8lCZ0vWwEl4bdGsg ($25.70 in chips) 
Seat 4: trN/oHqTTbPw5MNuKrOpLw ($28.40 in chips) 
Seat 5: LyDHtw3/yniNHW+DvLXbog ($27 in chips) 
Seat 6: v+QfkGiuj9bgtuNoVnDO8w ($39.05 in chips) 
trN/oHqTTbPw5MNuKrOpLw: posts small blind $0.10
LyDHtw3/yniNHW+DvLXbog: posts big blind $0.25
*** HOLE CARDS ***
v+QfkGiuj9bgtuNoVnDO8w: folds 
DihMHaz4WNETH1bPDe13kA: raises $0.50 to $0.75
JFIAqU8lCZ0vWwEl4bdGsg: folds 
trN/oHqTTbPw5MNuKrOpLw: folds 
LyDHtw3/yniNHW+DvLXbog: folds 
Uncalled bet ($0.50) returned to DihMHaz4WNETH1bPDe13kA
DihMHaz4WNETH1bPDe13kA collected $0.60 from pot
*** SUMMARY ***
Total pot $0.60 | Rake $0 
Seat 2: DihMHaz4WNETH1bPDe13kA collected ($0.60)
Seat 3: JFIAqU8lCZ0vWwEl4bdGsg (button) folded before Flop (didn't bet)
Seat 4: trN/oHqTTbPw5MNuKrOpLw (small blind) folded before Flop
Seat 5: LyDHtw3/yniNHW+DvLXbog (big blind) folded before Flop
Seat 6: v+QfkGiuj9bgtuNoVnDO8w folded before Flop (didn't bet)




PokerStars Game #59941825166:  Hold'em No Limit ($0.10/$0.25) - 2009/07/01 1:47:20 ET
Table 'gYBWJG3hEuJg6kphY0yhMg' 9-max Seat #2 is the button
Seat 1: AcL/hxc9eT0dCr2TYk/0Dg ($25.80 in chips) 
Seat 2: RCqMONFrSPSArZh2Jsar/w ($19.65 in chips) 
Seat 3: wGigCmBR/9XWkPpvYos3aQ ($25.10 in chips) 
Seat 4: V6p0jQ/RhUsqpHLmXvEX4Q ($11.15 in chips) 
Seat 5: +sbyWwIcFp9kP0bDtMegfQ ($28.75 in chips) 
Seat 7: aIEQGxUJwm61WfazSNFCdA ($10.55 in chips) 
Seat 8: 7je+LC5Mfs6nL8YBVh4frQ ($4.75 in chips) 
Seat 9: Bb42QRQMhg5/Y0vHP8/2Xw ($28.05 in chips) 
wGigCmBR/9XWkPpvYos3aQ: posts small blind $0.10
V6p0jQ/RhUsqpHLmXvEX4Q: posts big blind $0.25
Z9W7+g1WMhhZDi7DwGbCFA: sits out 
*** HOLE CARDS ***
+sbyWwIcFp9kP0bDtMegfQ: folds 
aIEQGxUJwm61WfazSNFCdA: folds 
7je+LC5Mfs6nL8YBVh4frQ: folds 
Bb42QRQMhg5/Y0vHP8/2Xw: folds 
AcL/hxc9eT0dCr2TYk/0Dg: folds 
RCqMONFrSPSArZh2Jsar/w: raises $0.75 to $1
wGigCmBR/9XWkPpvYos3aQ: folds 
V6p0jQ/RhUsqpHLmXvEX4Q: folds 
Uncalled bet ($0.75) returned to RCqMONFrSPSArZh2Jsar/w
RCqMONFrSPSArZh2Jsar/w collected $0.60 from pot
RCqMONFrSPSArZh2Jsar/w: doesn't show hand 
*** SUMMARY ***
Total pot $0.60 | Rake $0 
Seat 1: AcL/hxc9eT0dCr2TYk/0Dg folded before Flop (didn't bet)
Seat 2: RCqMONFrSPSArZh2Jsar/w (button) collected ($0.60)
Seat 3: wGigCmBR/9XWkPpvYos3aQ (small blind) folded before Flop
Seat 4: V6p0jQ/RhUsqpHLmXvEX4Q (big blind) folded before Flop
Seat 5: +sbyWwIcFp9kP0bDtMegfQ folded before Flop (didn't bet)
Seat 7: aIEQGxUJwm61WfazSNFCdA folded before Flop (didn't bet)
Seat 8: 7je+LC5Mfs6nL8YBVh4frQ folded before Flop (didn't bet)
Seat 9: Bb42QRQMhg5/Y0vHP8/2Xw folded before Flop (didn't bet)




PokerStars Game #59941825326:  Hold'em No Limit ($0.10/$0.25) - 2009/07/01 1:47:20 ET
Table '/AhP8uWRzEEhOATYIdmn0A' 9-max Seat #8 is the button
Seat 1: +sbyWwIcFp9kP0bDtMegfQ ($37.80 in chips) 
Seat 2: nx5EoCNZFR03YUOXyT22wQ ($17.30 in chips) 
Seat 3: jx6dnobNHstDG0tabsbKHQ ($3.30 in chips) 
Seat 4: bXpVeaSTPBFSPJmeXxO7nw ($6 in chips) 
Seat 6: 8EbrQ/EvFWt2cr0GaU82gQ ($5 in chips) 
Seat 7: cZ99hugmLBj9KhTlc8nCSw ($25 in chips) 
Seat 8: K86cg2ifCMFAlmzsfTDjig ($26.20 in chips) 
Seat 9: OfGfQFPcghysTDljS9GQSQ ($10.70 in chips) 
OfGfQFPcghysTDljS9GQSQ: posts small blind $0.10
+sbyWwIcFp9kP0bDtMegfQ: posts big blind $0.25
iZ1f67Ok/207yzIQOu1Kdg: sits out 
*** HOLE CARDS ***
nx5EoCNZFR03YUOXyT22wQ: folds 
jx6dnobNHstDG0tabsbKHQ: folds 
bXpVeaSTPBFSPJmeXxO7nw: folds 
8EbrQ/EvFWt2cr0GaU82gQ: folds 
cZ99hugmLBj9KhTlc8nCSw: folds 
K86cg2ifCMFAlmzsfTDjig: raises $25.95 to $26.20 and is all-in
OfGfQFPcghysTDljS9GQSQ: folds 
+sbyWwIcFp9kP0bDtMegfQ: folds 
Uncalled bet ($25.95) returned to K86cg2ifCMFAlmzsfTDjig
K86cg2ifCMFAlmzsfTDjig collected $0.60 from pot
K86cg2ifCMFAlmzsfTDjig: doesn't show hand 
*** SUMMARY ***
Total pot $0.60 | Rake $0 
Seat 1: +sbyWwIcFp9kP0bDtMegfQ (big blind) folded before Flop
Seat 2: nx5EoCNZFR03YUOXyT22wQ folded before Flop (didn't bet)
Seat 3: jx6dnobNHstDG0tabsbKHQ folded before Flop (didn't bet)
Seat 4: bXpVeaSTPBFSPJmeXxO7nw folded before Flop (didn't bet)
Seat 6: 8EbrQ/EvFWt2cr0GaU82gQ folded before Flop (didn't bet)
Seat 7: cZ99hugmLBj9KhTlc8nCSw folded before Flop (didn't bet)
Seat 8: K86cg2ifCMFAlmzsfTDjig (button) collected ($0.60)
Seat 9: OfGfQFPcghysTDljS9GQSQ (small blind) folded before Flop




PokerStars Game #59941825274:  Hold'em No Limit ($0.10/$0.25) - 2009/07/01 1:47:20 ET
Table 'hOE09W281uSob0XeJmUcRg' 6-max Seat #1 is the button
Seat 1: mfrkWA3PTeYPkbO6hi98Aw ($26.95 in chips) 
Seat 2: lRKJ8o/CnOPFwfHHm6ioMw ($12.10 in chips) 
Seat 3: y+a/yGW/Jy4bPJFnaeTz5w ($13.60 in chips) 
Seat 5: JFIAqU8lCZ0vWwEl4bdGsg ($26.15 in chips) 
Seat 6: x4ZJ8E/TUrtoB7WiHcv8WA ($16.60 in chips) 
lRKJ8o/CnOPFwfHHm6ioMw: posts small blind $0.10
y+a/yGW/Jy4bPJFnaeTz5w: posts big blind $0.25
*** HOLE CARDS ***
JFIAqU8lCZ0vWwEl4bdGsg: folds 
x4ZJ8E/TUrtoB7WiHcv8WA: calls $0.25
mfrkWA3PTeYPkbO6hi98Aw: folds 
lRKJ8o/CnOPFwfHHm6ioMw: raises $0.25 to $0.50
y+a/yGW/Jy4bPJFnaeTz5w: folds 
x4ZJ8E/TUrtoB7WiHcv8WA: calls $0.25
*** FLOP *** [9d Qh 4d]
lRKJ8o/CnOPFwfHHm6ioMw: bets $1.25
x4ZJ8E/TUrtoB7WiHcv8WA: folds 
Uncalled bet ($1.25) returned to lRKJ8o/CnOPFwfHHm6ioMw
lRKJ8o/CnOPFwfHHm6ioMw collected $1.20 from pot
lRKJ8o/CnOPFwfHHm6ioMw: doesn't show hand 
*** SUMMARY ***
Total pot $1.25 | Rake $0.05 
Board [9d Qh 4d]
Seat 1: mfrkWA3PTeYPkbO6hi98Aw (button) folded before Flop (didn't bet)
Seat 2: lRKJ8o/CnOPFwfHHm6ioMw (small blind) collected ($1.20)
Seat 3: y+a/yGW/Jy4bPJFnaeTz5w (big blind) folded before Flop
Seat 5: JFIAqU8lCZ0vWwEl4bdGsg folded before Flop (didn't bet)
Seat 6: x4ZJ8E/TUrtoB7WiHcv8WA folded on the Flop




PokerStars Game #59941825256:  Hold'em No Limit ($0.10/$0.25) - 2009/07/01 1:47:20 ET
Table 'mF3KHGMaTpaBZbtBoyfTeg' 6-max Seat #4 is the button
Seat 1: 0HAB2GdCAM7p7V00xueAVQ ($23.15 in chips) 
Seat 3: 9kUKGKkblnIx3m8rlVol6Q ($11.10 in chips) 
Seat 4: FYepjhAvF8ZdVCmqHIy+eQ ($25 in chips) 
Seat 5: 8ClCHtFXGNplITm+63KB+Q ($45.10 in chips) 
Seat 6: kG34n23qFQA3nzdOJTQ1dA ($27.15 in chips) 
8ClCHtFXGNplITm+63KB+Q: posts small blind $0.10
kG34n23qFQA3nzdOJTQ1dA: posts big blind $0.25
xrf8tAXKQHG99HixCot1Iw: sits out 
*** HOLE CARDS ***
0HAB2GdCAM7p7V00xueAVQ: folds 
9kUKGKkblnIx3m8rlVol6Q: folds 
FYepjhAvF8ZdVCmqHIy+eQ: folds 
8ClCHtFXGNplITm+63KB+Q: raises $0.75 to $1
kG34n23qFQA3nzdOJTQ1dA: folds 
Uncalled bet ($0.75) returned to 8ClCHtFXGNplITm+63KB+Q
8ClCHtFXGNplITm+63KB+Q collected $0.50 from pot
8ClCHtFXGNplITm+63KB+Q: doesn't show hand 
*** SUMMARY ***
Total pot $0.50 | Rake $0 
Seat 1: 0HAB2GdCAM7p7V00xueAVQ folded before Flop (didn't bet)
Seat 3: 9kUKGKkblnIx3m8rlVol6Q folded before Flop (didn't bet)
Seat 4: FYepjhAvF8ZdVCmqHIy+eQ (button) folded before Flop (didn't bet)
Seat 5: 8ClCHtFXGNplITm+63KB+Q (small blind) collected ($0.50)
Seat 6: kG34n23qFQA3nzdOJTQ1dA (big blind) folded before Flop




PokerStars Game #59941825222:  Hold'em No Limit ($0.10/$0.25) - 2009/07/01 1:47:20 ET
Table 'IRgQPZVA4+IaZZIQshgwyg' 6-max Seat #4 is the button
Seat 1: cezpHJ8FB07dj0xG+LhOvw ($27.55 in chips) 
Seat 2: lquriepNQBhDV5P1SWHhnA ($28.70 in chips) 
Seat 3: DihMHaz4WNETH1bPDe13kA ($27.80 in chips) 
Seat 4: DE9hRlt14g+JdsRQ4wT7hg ($25 in chips) 
Seat 6: x9/USY6PsmgUGQeluFLKDw ($21.40 in chips) 
w43JQj2oYPpKQVG4Yzlq1w will be allowed to play after the button
x9/USY6PsmgUGQeluFLKDw: posts small blind $0.10
cezpHJ8FB07dj0xG+LhOvw: posts big blind $0.25
*** HOLE CARDS ***
lquriepNQBhDV5P1SWHhnA: raises $0.50 to $0.75
DihMHaz4WNETH1bPDe13kA: folds 
DE9hRlt14g+JdsRQ4wT7hg: folds 
x9/USY6PsmgUGQeluFLKDw: folds 
cezpHJ8FB07dj0xG+LhOvw: folds 
Uncalled bet ($0.50) returned to lquriepNQBhDV5P1SWHhnA
lquriepNQBhDV5P1SWHhnA collected $0.60 from pot
lquriepNQBhDV5P1SWHhnA: doesn't show hand 
*** SUMMARY ***
Total pot $0.60 | Rake $0 
Seat 1: cezpHJ8FB07dj0xG+LhOvw (big blind) folded before Flop
Seat 2: lquriepNQBhDV5P1SWHhnA collected ($0.60)
Seat 3: DihMHaz4WNETH1bPDe13kA folded before Flop (didn't bet)
Seat 4: DE9hRlt14g+JdsRQ4wT7hg (button) folded before Flop (didn't bet)
Seat 6: x9/USY6PsmgUGQeluFLKDw (small blind) folded before Flop




PokerStars Game #59941825436:  Hold'em No Limit ($0.10/$0.25) - 2009/07/01 1:47:20 ET
Table 'xmJKTGBeWCwutccj3YfupQ' 6-max Seat #5 is the button
Seat 1: sVbkVl4OznxBCfi66UB9vw ($40.95 in chips) 
Seat 3: T5wrp/d5jarm+SxNy8OQAg ($25.50 in chips) 
Seat 4: uWjhTVMpuIroxXcmD3Okug ($8.80 in chips) 
Seat 5: DE9hRlt14g+JdsRQ4wT7hg ($29.60 in chips) 
Seat 6: 9bpVv1/Qh9IYtXuCtl5VtQ ($24.40 in chips) 
9bpVv1/Qh9IYtXuCtl5VtQ: posts small blind $0.10
sVbkVl4OznxBCfi66UB9vw: posts big blind $0.25
QqiZLFrN8iOUT/GHw7ztOA: sits out 
*** HOLE CARDS ***
T5wrp/d5jarm+SxNy8OQAg: folds 
T5wrp/d5jarm+SxNy8OQAg said, "comeon now aces"
uWjhTVMpuIroxXcmD3Okug: calls $0.25
DE9hRlt14g+JdsRQ4wT7hg: folds 
9bpVv1/Qh9IYtXuCtl5VtQ: raises $1 to $1.25
sVbkVl4OznxBCfi66UB9vw: folds 
uWjhTVMpuIroxXcmD3Okug: calls $1
*** FLOP *** [7d 6s 3d]
9bpVv1/Qh9IYtXuCtl5VtQ: bets $2.50
uWjhTVMpuIroxXcmD3Okug: raises $5.05 to $7.55 and is all-in
9bpVv1/Qh9IYtXuCtl5VtQ: calls $5.05
*** TURN *** [7d 6s 3d] [Ad]
*** RIVER *** [7d 6s 3d Ad] [Tc]
*** SHOW DOWN ***
9bpVv1/Qh9IYtXuCtl5VtQ: shows [Ah Qd] (a pair of Aces)
uWjhTVMpuIroxXcmD3Okug: shows [Jd 8d] (a flush, Ace high)
uWjhTVMpuIroxXcmD3Okug collected $17 from pot
*** SUMMARY ***
Total pot $17.85 | Rake $0.85 
Board [7d 6s 3d Ad Tc]
Seat 1: sVbkVl4OznxBCfi66UB9vw (big blind) folded before Flop
Seat 3: T5wrp/d5jarm+SxNy8OQAg folded before Flop (didn't bet)
Seat 4: uWjhTVMpuIroxXcmD3Okug showed [Jd 8d] and won ($17) with a flush, Ace high
Seat 5: DE9hRlt14g+JdsRQ4wT7hg (button) folded before Flop (didn't bet)
Seat 6: 9bpVv1/Qh9IYtXuCtl5VtQ (small blind) showed [Ah Qd] and lost with a pair of Aces




PokerStars Game #59941825246:  Hold'em No Limit ($0.10/$0.25) - 2009/07/01 1:47:20 ET
Table '8QBBaev+cI2i/r2H6ml/lg' 9-max Seat #8 is the button
Seat 1: s2xLPOl/vhl/26apJ3vsOQ ($35.80 in chips) 
Seat 2: y7tkvDmwKjURBkr73SZPXw ($12.25 in chips) 
Seat 3: zgi+EUykT/pZQpoUG6+oEg ($4.30 in chips) 
Seat 4: ytpGB2nr/CLVHnyKMRiEFQ ($16 in chips) 
Seat 5: 0QdZrkFD7aGKeBXPGbIomA ($11.45 in chips) 
Seat 6: X6+pSIPfovPcE87t+LmUKQ ($5.25 in chips) 
Seat 7: eK8qa6EPcH2zhtbmWSvc9g ($30.70 in chips) 
Seat 8: vr1IK/Q4HXm8s8V0/dePzQ ($11.60 in chips) 
Seat 9: EUMLvzDkECHBit+xa+uGjg ($24.50 in chips) 
EUMLvzDkECHBit+xa+uGjg: posts small blind $0.10
s2xLPOl/vhl/26apJ3vsOQ: posts big blind $0.25
*** HOLE CARDS ***
y7tkvDmwKjURBkr73SZPXw: folds 
zgi+EUykT/pZQpoUG6+oEg: folds 
ytpGB2nr/CLVHnyKMRiEFQ: folds 
0QdZrkFD7aGKeBXPGbIomA: folds 
X6+pSIPfovPcE87t+LmUKQ: folds 
eK8qa6EPcH2zhtbmWSvc9g: folds 
vr1IK/Q4HXm8s8V0/dePzQ: folds 
EUMLvzDkECHBit+xa+uGjg: raises $0.50 to $0.75
s2xLPOl/vhl/26apJ3vsOQ: raises $2.25 to $3
EUMLvzDkECHBit+xa+uGjg: folds 
Uncalled bet ($2.25) returned to s2xLPOl/vhl/26apJ3vsOQ
s2xLPOl/vhl/26apJ3vsOQ collected $1.50 from pot
*** SUMMARY ***
Total pot $1.50 | Rake $0 
Seat 1: s2xLPOl/vhl/26apJ3vsOQ (big blind) collected ($1.50)
Seat 2: y7tkvDmwKjURBkr73SZPXw folded before Flop (didn't bet)
Seat 3: zgi+EUykT/pZQpoUG6+oEg folded before Flop (didn't bet)
Seat 4: ytpGB2nr/CLVHnyKMRiEFQ folded before Flop (didn't bet)
Seat 5: 0QdZrkFD7aGKeBXPGbIomA folded before Flop (didn't bet)
Seat 6: X6+pSIPfovPcE87t+LmUKQ folded before Flop (didn't bet)
Seat 7: eK8qa6EPcH2zhtbmWSvc9g folded before Flop (didn't bet)
Seat 8: vr1IK/Q4HXm8s8V0/dePzQ (button) folded before Flop (didn't bet)
Seat 9: EUMLvzDkECHBit+xa+uGjg (small blind) folded before Flop




PokerStars Game #59941825886:  Hold'em No Limit ($0.10/$0.25) - 2009/07/01 1:47:21 ET
Table 'sDHjMRwfSiz7+NDdZLUiyA' 9-max Seat #7 is the button
Seat 1: VGwr1eqhvdUtMfBFCvBnmg ($10.35 in chips) 
Seat 2: ljemhp25Zg+nlA9DLCIiUw ($25.70 in chips) 
Seat 3: SGA1WpAnQxFdFAYyt362gQ ($18.05 in chips) 
Seat 4: eK8qa6EPcH2zhtbmWSvc9g ($26.05 in chips) 
Seat 5: IGRfskE1v9H9Bn+fz8AgNQ ($37.85 in chips) 
Seat 6: 1qa0qHOCKZM3Uipx9DxYtQ ($15.80 in chips) 
Seat 7: K0b5wNInj6hUGRr6yzKFtw ($37.30 in chips) 
Seat 8: 3hMkm4U5yTRrkGJkxfijaQ ($1.90 in chips) 
Seat 9: 3PmVnC/15cl4oyI1TKIt4g ($4.05 in chips) 
3hMkm4U5yTRrkGJkxfijaQ: posts small blind $0.10
3PmVnC/15cl4oyI1TKIt4g: posts big blind $0.25
*** HOLE CARDS ***
VGwr1eqhvdUtMfBFCvBnmg: calls $0.25
ljemhp25Zg+nlA9DLCIiUw: calls $0.25
SGA1WpAnQxFdFAYyt362gQ: folds 
eK8qa6EPcH2zhtbmWSvc9g: calls $0.25
IGRfskE1v9H9Bn+fz8AgNQ: calls $0.25
1qa0qHOCKZM3Uipx9DxYtQ: folds 
K0b5wNInj6hUGRr6yzKFtw: folds 
3hMkm4U5yTRrkGJkxfijaQ: calls $0.15
3PmVnC/15cl4oyI1TKIt4g: checks 
*** FLOP *** [8d 4s Kd]
3hMkm4U5yTRrkGJkxfijaQ: checks 
3PmVnC/15cl4oyI1TKIt4g: checks 
VGwr1eqhvdUtMfBFCvBnmg: bets $0.50
ljemhp25Zg+nlA9DLCIiUw: folds 
eK8qa6EPcH2zhtbmWSvc9g: folds 
IGRfskE1v9H9Bn+fz8AgNQ: calls $0.50
3hMkm4U5yTRrkGJkxfijaQ: folds 
3PmVnC/15cl4oyI1TKIt4g: folds 
*** TURN *** [8d 4s Kd] [9c]
VGwr1eqhvdUtMfBFCvBnmg: bets $1
IGRfskE1v9H9Bn+fz8AgNQ: calls $1
*** RIVER *** [8d 4s Kd 9c] [5s]
VGwr1eqhvdUtMfBFCvBnmg: bets $1.50
IGRfskE1v9H9Bn+fz8AgNQ: folds 
Uncalled bet ($1.50) returned to VGwr1eqhvdUtMfBFCvBnmg
VGwr1eqhvdUtMfBFCvBnmg collected $4.30 from pot
VGwr1eqhvdUtMfBFCvBnmg: doesn't show hand 
*** SUMMARY ***
Total pot $4.50 | Rake $0.20 
Board [8d 4s Kd 9c 5s]
Seat 1: VGwr1eqhvdUtMfBFCvBnmg collected ($4.30)
Seat 2: ljemhp25Zg+nlA9DLCIiUw folded on the Flop
Seat 3: SGA1WpAnQxFdFAYyt362gQ folded before Flop (didn't bet)
Seat 4: eK8qa6EPcH2zhtbmWSvc9g folded on the Flop
Seat 5: IGRfskE1v9H9Bn+fz8AgNQ folded on the River
Seat 6: 1qa0qHOCKZM3Uipx9DxYtQ folded before Flop (didn't bet)
Seat 7: K0b5wNInj6hUGRr6yzKFtw (button) folded before Flop (didn't bet)
Seat 8: 3hMkm4U5yTRrkGJkxfijaQ (small blind) folded on the Flop
Seat 9: 3PmVnC/15cl4oyI1TKIt4g (big blind) folded on the Flop




PokerStars Game #59941825770:  Hold'em No Limit ($0.10/$0.25) - 2009/07/01 1:47:21 ET
Table 'YlRA05h9BJ1EhOUSNUjJdg' 9-max Seat #1 is the button
Seat 1: dtZ84flFEi4Q+SGrHMJRDQ ($25.25 in chips) 
Seat 2: Y2GFAe+PT7xnUUtgqCNDFw ($9.05 in chips) 
Seat 3: Z5ZtGOON8kmSdSCll9Z3XA ($13.20 in chips) 
Seat 4: HPEB+AtKw1+C/cxU0o1ciw ($33.95 in chips) 
Seat 5: sx0lGrkT9fd4yFR+3cXUQg ($11.65 in chips) 
Seat 6: QEbIGci+itdw+re8RM5fZA ($44 in chips) 
Seat 7: dfNim92Z6XK1/h5SFW5vDg ($25 in chips) 
Seat 8: dmYlc+1cjwZMJ7wV+Z0rRg ($32.55 in chips) 
Seat 9: Z9AeOQX3yzuSvKAm/xyovg ($10.10 in chips) 
Y2GFAe+PT7xnUUtgqCNDFw: posts small blind $0.10
Z5ZtGOON8kmSdSCll9Z3XA: posts big blind $0.25
*** HOLE CARDS ***
HPEB+AtKw1+C/cxU0o1ciw: folds 
sx0lGrkT9fd4yFR+3cXUQg: folds 
QEbIGci+itdw+re8RM5fZA: folds 
dfNim92Z6XK1/h5SFW5vDg: folds 
dmYlc+1cjwZMJ7wV+Z0rRg: raises $0.50 to $0.75
Z9AeOQX3yzuSvKAm/xyovg: folds 
dtZ84flFEi4Q+SGrHMJRDQ: folds 
Y2GFAe+PT7xnUUtgqCNDFw: folds 
Z5ZtGOON8kmSdSCll9Z3XA: folds 
Uncalled bet ($0.50) returned to dmYlc+1cjwZMJ7wV+Z0rRg
dmYlc+1cjwZMJ7wV+Z0rRg collected $0.60 from pot
dmYlc+1cjwZMJ7wV+Z0rRg: doesn't show hand 
*** SUMMARY ***
Total pot $0.60 | Rake $0 
Seat 1: dtZ84flFEi4Q+SGrHMJRDQ (button) folded before Flop (didn't bet)
Seat 2: Y2GFAe+PT7xnUUtgqCNDFw (small blind) folded before Flop
Seat 3: Z5ZtGOON8kmSdSCll9Z3XA (big blind) folded before Flop
Seat 4: HPEB+AtKw1+C/cxU0o1ciw folded before Flop (didn't bet)
Seat 5: sx0lGrkT9fd4yFR+3cXUQg folded before Flop (didn't bet)
Seat 6: QEbIGci+itdw+re8RM5fZA folded before Flop (didn't bet)
Seat 7: dfNim92Z6XK1/h5SFW5vDg folded before Flop (didn't bet)
Seat 8: dmYlc+1cjwZMJ7wV+Z0rRg collected ($0.60)
Seat 9: Z9AeOQX3yzuSvKAm/xyovg folded before Flop (didn't bet)




PokerStars Game #59941825674:  Hold'em No Limit ($0.10/$0.25) - 2009/07/01 1:47:21 ET
Table 'ER5H84HUgJx7HyDLnELLeA' 6-max Seat #5 is the button
Seat 1: LJI7A1YgDM7hgh7o56+ReQ ($27.50 in chips) 
Seat 2: buyjetgNT1McXtdaP4zynA ($20.10 in chips) 
Seat 4: vqWjZmdQu/Hxw96/IJTWdQ ($25 in chips) 
Seat 5: mfrkWA3PTeYPkbO6hi98Aw ($26.35 in chips) 
Seat 6: 3zD3qLXT1bEffAoWGnc7wg ($50.75 in chips) 
3zD3qLXT1bEffAoWGnc7wg: posts small blind $0.10
LJI7A1YgDM7hgh7o56+ReQ: posts big blind $0.25
cS21pIxRHx5Gt42o7hPZzw: sits out 
*** HOLE CARDS ***
buyjetgNT1McXtdaP4zynA: folds 
vqWjZmdQu/Hxw96/IJTWdQ: folds 
mfrkWA3PTeYPkbO6hi98Aw: folds 
3zD3qLXT1bEffAoWGnc7wg: raises $0.50 to $0.75
LJI7A1YgDM7hgh7o56+ReQ: folds 
Uncalled bet ($0.50) returned to 3zD3qLXT1bEffAoWGnc7wg
3zD3qLXT1bEffAoWGnc7wg collected $0.50 from pot
3zD3qLXT1bEffAoWGnc7wg: doesn't show hand 
*** SUMMARY ***
Total pot $0.50 | Rake $0 
Seat 1: LJI7A1YgDM7hgh7o56+ReQ (big blind) folded before Flop
Seat 2: buyjetgNT1McXtdaP4zynA folded before Flop (didn't bet)
Seat 4: vqWjZmdQu/Hxw96/IJTWdQ folded before Flop (didn't bet)
Seat 5: mfrkWA3PTeYPkbO6hi98Aw (button) folded before Flop (didn't bet)
Seat 6: 3zD3qLXT1bEffAoWGnc7wg (small blind) collected ($0.50)




PokerStars Game #59941825912:  Hold'em No Limit ($0.10/$0.25) - 2009/07/01 1:47:21 ET
Table 'edvgY2YQ1I34euq4EVqGnA' 6-max Seat #5 is the button
Seat 1: mvFHK3pE7tCxJEqLjKC70Q ($25 in chips) 
Seat 2: Hsvkc0/G2VV78oVmWYXecw ($5 in chips) 
Seat 3: mFv3iBCtrw9XfCDRB0d46Q ($3.55 in chips) 
Seat 4: TI/C5Q+DEl4fLR3AofwYdg ($23.40 in chips) 
Seat 5: EE16Ua5b1HSsYej5zeXOlA ($56.75 in chips) 
Seat 6: kG34n23qFQA3nzdOJTQ1dA ($71.10 in chips) 
kG34n23qFQA3nzdOJTQ1dA: posts small blind $0.10
mvFHK3pE7tCxJEqLjKC70Q: posts big blind $0.25
*** HOLE CARDS ***
Hsvkc0/G2VV78oVmWYXecw: folds 
mFv3iBCtrw9XfCDRB0d46Q: folds 
TI/C5Q+DEl4fLR3AofwYdg: folds 
EE16Ua5b1HSsYej5zeXOlA: folds 
kG34n23qFQA3nzdOJTQ1dA: folds 
Uncalled bet ($0.15) returned to mvFHK3pE7tCxJEqLjKC70Q
mvFHK3pE7tCxJEqLjKC70Q collected $0.20 from pot
mvFHK3pE7tCxJEqLjKC70Q: doesn't show hand 
*** SUMMARY ***
Total pot $0.20 | Rake $0 
Seat 1: mvFHK3pE7tCxJEqLjKC70Q (big blind) collected ($0.20)
Seat 2: Hsvkc0/G2VV78oVmWYXecw folded before Flop (didn't bet)
Seat 3: mFv3iBCtrw9XfCDRB0d46Q folded before Flop (didn't bet)
Seat 4: TI/C5Q+DEl4fLR3AofwYdg folded before Flop (didn't bet)
Seat 5: EE16Ua5b1HSsYej5zeXOlA (button) folded before Flop (didn't bet)
Seat 6: kG34n23qFQA3nzdOJTQ1dA (small blind) folded before Flop




PokerStars Game #59941826296:  Hold'em No Limit ($0.10/$0.25) - 2009/07/01 1:47:22 ET
Table 'rpIHGyt2QpgQc5bvptAvDQ' 9-max Seat #3 is the button
Seat 1: E0iYnEVO2ho7dH3QcCjw7g ($20 in chips) 
Seat 2: FX0yWp7Ul3dMebXB0cFjEw ($2.85 in chips) 
Seat 3: N6a/f6AW8S8G3JFw9IFxAg ($18.50 in chips) 
Seat 4: ASXDkj9tmvF/T2AsNuxg7g ($5.95 in chips) 
Seat 5: XhSvfX1gy0yx/qeW+SOeTw ($8.30 in chips) 
Seat 6: Mq1ESwxx3LEsA4HjKKjU3Q ($19.25 in chips) 
Seat 7: GHgIdzlzMAmRmmX7jgXtuQ ($3.75 in chips) 
Seat 8: oUgIL46CfA9GCdIuN1TVSw ($8.95 in chips) 
ASXDkj9tmvF/T2AsNuxg7g: posts small blind $0.10
XhSvfX1gy0yx/qeW+SOeTw: posts big blind $0.25
eebse2009: sits out 
E0iYnEVO2ho7dH3QcCjw7g: posts big blind $0.25
*** HOLE CARDS ***
Mq1ESwxx3LEsA4HjKKjU3Q: folds 
GHgIdzlzMAmRmmX7jgXtuQ: calls $0.25
oUgIL46CfA9GCdIuN1TVSw: folds 
E0iYnEVO2ho7dH3QcCjw7g: raises $1 to $1.25
FX0yWp7Ul3dMebXB0cFjEw: calls $1.25
N6a/f6AW8S8G3JFw9IFxAg: folds 
ASXDkj9tmvF/T2AsNuxg7g: folds 
XhSvfX1gy0yx/qeW+SOeTw: folds 
GHgIdzlzMAmRmmX7jgXtuQ: calls $1
*** FLOP *** [Qh 2s 4s]
GHgIdzlzMAmRmmX7jgXtuQ: checks 
E0iYnEVO2ho7dH3QcCjw7g: bets $2.75
FX0yWp7Ul3dMebXB0cFjEw: calls $1.60 and is all-in
GHgIdzlzMAmRmmX7jgXtuQ: folds 
Uncalled bet ($1.15) returned to E0iYnEVO2ho7dH3QcCjw7g
*** TURN *** [Qh 2s 4s] [Jc]
*** RIVER *** [Qh 2s 4s Jc] [Ah]
*** SHOW DOWN ***
E0iYnEVO2ho7dH3QcCjw7g: shows [Qs As] (two pair, Aces and Queens)
FX0yWp7Ul3dMebXB0cFjEw: mucks hand 
E0iYnEVO2ho7dH3QcCjw7g collected $6.95 from pot
*** SUMMARY ***
Total pot $7.30 | Rake $0.35 
Board [Qh 2s 4s Jc Ah]
Seat 1: E0iYnEVO2ho7dH3QcCjw7g showed [Qs As] and won ($6.95) with two pair, Aces and Queens
Seat 2: FX0yWp7Ul3dMebXB0cFjEw mucked
Seat 3: N6a/f6AW8S8G3JFw9IFxAg (button) folded before Flop (didn't bet)
Seat 4: ASXDkj9tmvF/T2AsNuxg7g (small blind) folded before Flop
Seat 5: XhSvfX1gy0yx/qeW+SOeTw (big blind) folded before Flop
Seat 6: Mq1ESwxx3LEsA4HjKKjU3Q folded before Flop (didn't bet)
Seat 7: GHgIdzlzMAmRmmX7jgXtuQ folded on the Flop
Seat 8: oUgIL46CfA9GCdIuN1TVSw folded before Flop (didn't bet)




PokerStars Game #59941826138:  Hold'em No Limit ($0.10/$0.25) - 2009/07/01 1:47:22 ET
Table 'LwnjzXstPtSrqrV/oDpnXQ' 9-max Seat #5 is the button
Seat 1: 9YN2IkT2JYYKFErZtZvCtA ($17.45 in chips) 
Seat 2: uLP/lYn7oKq9xCChBXsXxw ($26.65 in chips) 
Seat 3: 7je+LC5Mfs6nL8YBVh4frQ ($3.80 in chips) 
Seat 4: CmngQmkKTp8tkl6GMRTl6w ($8.75 in chips) 
Seat 5: Th3FldXKQW6hWVVPahaoOQ ($25.90 in chips) 
Seat 6: ljemhp25Zg+nlA9DLCIiUw ($39.60 in chips) 
Seat 7: c/Dw/6HyqldTzIRodAIZmg ($13.75 in chips) 
Seat 8: ShXPHWfjhfmAwLgDdm6bRQ ($13.30 in chips) 
Seat 9: q6WfTUAD9mowIP63ASq2Dgz/khFDKGihQjwgoiKKPOeg40 in chips) 
ljemhp25Zg+nlA9DLCIiUw: posts small blind $0.10
c/Dw/6HyqldTzIRodAIZmg: posts big blind $0.25
*** HOLE CARDS ***
ShXPHWfjhfmAwLgDdm6bRQ: folds 
q6WfTUAD9mowIP63ASq2Dgz/khFDKGihQjwgoiKKPOeges $0.25 to $0.50
9YN2IkT2JYYKFErZtZvCtA: raises $1 to $1.50
uLP/lYn7oKq9xCChBXsXxw: folds 
7je+LC5Mfs6nL8YBVh4frQ: folds 
CmngQmkKTp8tkl6GMRTl6w: folds 
Th3FldXKQW6hWVVPahaoOQ: folds 
ljemhp25Zg+nlA9DLCIiUw: folds 
c/Dw/6HyqldTzIRodAIZmg: folds 
q6WfTUAD9mowIP63ASq2Dgz/khFDKGihQjwgoiKKPOegs $1
*** FLOP *** [9c 9s 4h]
q6WfTUAD9mowIP63ASq2Dgz/khFDKGihQjwgoiKKPOeg $0.75
9YN2IkT2JYYKFErZtZvCtA: calls $0.75
*** TURN *** [9c 9s 4h] [As]
q6WfTUAD9mowIP63ASq2Dgz/khFDKGihQjwgoiKKPOeg $0.75
9YN2IkT2JYYKFErZtZvCtA: calls $0.75
*** RIVER *** [9c 9s 4h As] [2h]
q6WfTUAD9mowIP63ASq2Dgz/khFDKGihQjwgoiKKPOeg $0.75
9YN2IkT2JYYKFErZtZvCtA: calls $0.75
*** SHOW DOWN ***
q6WfTUAD9mowIP63ASq2Dgz/khFDKGihQjwgoiKKPOegs [Qd Kc] (a pair of Nines)
9YN2IkT2JYYKFErZtZvCtA: shows [Ad Td] (two pair, Aces and Nines)
9YN2IkT2JYYKFErZtZvCtA collected $7.50 from pot
*** SUMMARY ***
Total pot $7.85 | Rake $0.35 
Board [9c 9s 4h As 2h]
Seat 1: 9YN2IkT2JYYKFErZtZvCtA showed [Ad Td] and won ($7.50) with two pair, Aces and Nines
Seat 2: uLP/lYn7oKq9xCChBXsXxw folded before Flop (didn't bet)
Seat 3: 7je+LC5Mfs6nL8YBVh4frQ folded before Flop (didn't bet)
Seat 4: CmngQmkKTp8tkl6GMRTl6w folded before Flop (didn't bet)
Seat 5: Th3FldXKQW6hWVVPahaoOQ (button) folded before Flop (didn't bet)
Seat 6: ljemhp25Zg+nlA9DLCIiUw (small blind) folded before Flop
Seat 7: c/Dw/6HyqldTzIRodAIZmg (big blind) folded before Flop
Seat 8: ShXPHWfjhfmAwLgDdm6bRQ folded before Flop (didn't bet)
Seat 9: q6WfTUAD9mowIP63ASq2Dgz/khFDKGihQjwgoiKKPOegd [Qd Kc] and lost with a pair of Nines




PokerStars Game #59941826056:  Hold'em No Limit ($0.10/$0.25) - 2009/07/01 1:47:22 ET
Table 'dNYnr4D4id1jwnEU66Yowg' 9-max Seat #5 is the button
Seat 1: 9lvO/qyU+xrU95Teu1fv0g ($4.40 in chips) 
Seat 2: Qduu7ikeizo6q6Ei9YvcJA ($24.65 in chips) 
Seat 3: IOx4EH8+y3jYZJc/LTRvOw ($25.75 in chips) 
Seat 4: VBHxUExRAMrbxUq/cVx9Gw ($5 in chips) 
Seat 5: 7cv+9Zc9HIQHNvYsMfV3uA ($27.05 in chips) 
Seat 6: 8EbrQ/EvFWt2cr0GaU82gQ ($4.40 in chips) 
Seat 7: DiSvPC2iudwL5j9u6Huyww ($25 in chips) 
Seat 8: RCqMONFrSPSArZh2Jsar/w ($34.10 in chips) 
Seat 9: /FE4MKSoQhXaDp4PBoLM2g ($12.85 in chips) 
8EbrQ/EvFWt2cr0GaU82gQ: posts small blind $0.10
DiSvPC2iudwL5j9u6Huyww: posts big blind $0.25
*** HOLE CARDS ***
RCqMONFrSPSArZh2Jsar/w: folds 
/FE4MKSoQhXaDp4PBoLM2g: calls $0.25
9lvO/qyU+xrU95Teu1fv0g: folds 
Qduu7ikeizo6q6Ei9YvcJA: calls $0.25
IOx4EH8+y3jYZJc/LTRvOw: folds 
VBHxUExRAMrbxUq/cVx9Gw: folds 
7cv+9Zc9HIQHNvYsMfV3uA: folds 
8EbrQ/EvFWt2cr0GaU82gQ: calls $0.15
DiSvPC2iudwL5j9u6Huyww: checks 
*** FLOP *** [Kd Kc Js]
8EbrQ/EvFWt2cr0GaU82gQ: checks 
DiSvPC2iudwL5j9u6Huyww: checks 
/FE4MKSoQhXaDp4PBoLM2g: checks 
Qduu7ikeizo6q6Ei9YvcJA: checks 
*** TURN *** [Kd Kc Js] [7c]
8EbrQ/EvFWt2cr0GaU82gQ: checks 
DiSvPC2iudwL5j9u6Huyww: checks 
/FE4MKSoQhXaDp4PBoLM2g: checks 
Qduu7ikeizo6q6Ei9YvcJA: bets $0.75
8EbrQ/EvFWt2cr0GaU82gQ: folds 
DiSvPC2iudwL5j9u6Huyww: folds 
/FE4MKSoQhXaDp4PBoLM2g: calls $0.75
*** RIVER *** [Kd Kc Js 7c] [5c]
/FE4MKSoQhXaDp4PBoLM2g: checks 
Qduu7ikeizo6q6Ei9YvcJA: bets $2.25
/FE4MKSoQhXaDp4PBoLM2g: folds 
Uncalled bet ($2.25) returned to Qduu7ikeizo6q6Ei9YvcJA
Qduu7ikeizo6q6Ei9YvcJA collected $2.40 from pot
Qduu7ikeizo6q6Ei9YvcJA: doesn't show hand 
*** SUMMARY ***
Total pot $2.50 | Rake $0.10 
Board [Kd Kc Js 7c 5c]
Seat 1: 9lvO/qyU+xrU95Teu1fv0g folded before Flop (didn't bet)
Seat 2: Qduu7ikeizo6q6Ei9YvcJA collected ($2.40)
Seat 3: IOx4EH8+y3jYZJc/LTRvOw folded before Flop (didn't bet)
Seat 4: VBHxUExRAMrbxUq/cVx9Gw folded before Flop (didn't bet)
Seat 5: 7cv+9Zc9HIQHNvYsMfV3uA (button) folded before Flop (didn't bet)
Seat 6: 8EbrQ/EvFWt2cr0GaU82gQ (small blind) folded on the Turn
Seat 7: DiSvPC2iudwL5j9u6Huyww (big blind) folded on the Turn
Seat 8: RCqMONFrSPSArZh2Jsar/w folded before Flop (didn't bet)
Seat 9: /FE4MKSoQhXaDp4PBoLM2g folded on the River




PokerStars Game #59941826816:  Hold'em No Limit ($0.10/$0.25) - 2009/07/01 1:47:23 ET
Table 'mk323gviqdkOY5Aek/1EWg' 6-max Seat #5 is the button
Seat 1: 7cx44/slbeTw+Cy7QB8Trg ($25 in chips) 
Seat 2: GC/9yVD59DUCX7hUI7gcLw ($55.65 in chips) 
Seat 3: NuqYPwTLZYQhxOoVK3Yqlw ($25 in chips) 
Seat 4: +baiVgI/ETnBARLe5mARCw ($11.55 in chips) 
Seat 5: kjYRzIfvZNNflYMYRkkSVA ($35.95 in chips) 
Seat 6: KkXSr5xFjxLSD3wtAvT+WQ ($8.75 in chips) 
KkXSr5xFjxLSD3wtAvT+WQ: posts small blind $0.10
7cx44/slbeTw+Cy7QB8Trg: posts big blind $0.25
*** HOLE CARDS ***
GC/9yVD59DUCX7hUI7gcLw: folds 
NuqYPwTLZYQhxOoVK3Yqlw: folds 
+baiVgI/ETnBARLe5mARCw: folds 
kjYRzIfvZNNflYMYRkkSVA: raises $0.50 to $0.75
KkXSr5xFjxLSD3wtAvT+WQ: folds 
7cx44/slbeTw+Cy7QB8Trg: folds 
Uncalled bet ($0.50) returned to kjYRzIfvZNNflYMYRkkSVA
kjYRzIfvZNNflYMYRkkSVA collected $0.60 from pot
kjYRzIfvZNNflYMYRkkSVA: doesn't show hand 
*** SUMMARY ***
Total pot $0.60 | Rake $0 
Seat 1: 7cx44/slbeTw+Cy7QB8Trg (big blind) folded before Flop
Seat 2: GC/9yVD59DUCX7hUI7gcLw folded before Flop (didn't bet)
Seat 3: NuqYPwTLZYQhxOoVK3Yqlw folded before Flop (didn't bet)
Seat 4: +baiVgI/ETnBARLe5mARCw folded before Flop (didn't bet)
Seat 5: kjYRzIfvZNNflYMYRkkSVA (button) collected ($0.60)
Seat 6: KkXSr5xFjxLSD3wtAvT+WQ (small blind) folded before Flop




PokerStars Game #59941827218:  Hold'em No Limit ($0.10/$0.25) - 2009/07/01 1:47:24 ET
Table 'Mef6A0EMopL6WaFO5/KO9g' 6-max Seat #2 is the button
Seat 1: GbCVUNssQ7mqsPWr7J4d3w ($5 in chips) 
Seat 2: 8ClCHtFXGNplITm+63KB+Q ($29.90 in chips) 
Seat 3: Wq26opBLDGJe91GRJn2epg ($17.95 in chips) 
Seat 4: lquriepNQBhDV5P1SWHhnA ($25 in chips) 
Seat 5: DihMHaz4WNETH1bPDe13kA ($25 in chips) 
Seat 6: jp34e617tIzV8tKIWmfAbA ($37.55 in chips) 
Wq26opBLDGJe91GRJn2epg: posts small blind $0.10
lquriepNQBhDV5P1SWHhnA: posts big blind $0.25
*** HOLE CARDS ***
DihMHaz4WNETH1bPDe13kA: folds 
jp34e617tIzV8tKIWmfAbA: folds 
GbCVUNssQ7mqsPWr7J4d3w: folds 
8ClCHtFXGNplITm+63KB+Q: raises $0.75 to $1
Wq26opBLDGJe91GRJn2epg: calls $0.90
lquriepNQBhDV5P1SWHhnA: folds 
*** FLOP *** [4s Kc 8d]
Wq26opBLDGJe91GRJn2epg: bets $0.75
8ClCHtFXGNplITm+63KB+Q: raises $1.25 to $2
Wq26opBLDGJe91GRJn2epg: calls $1.25
*** TURN *** [4s Kc 8d] [2h]
Wq26opBLDGJe91GRJn2epg: bets $1.25
8ClCHtFXGNplITm+63KB+Q: calls $1.25
*** RIVER *** [4s Kc 8d 2h] [2s]
Wq26opBLDGJe91GRJn2epg: bets $2.25
8ClCHtFXGNplITm+63KB+Q: calls $2.25
*** SHOW DOWN ***
Wq26opBLDGJe91GRJn2epg: shows [Qh Kh] (two pair, Kings and Deuces)
8ClCHtFXGNplITm+63KB+Q: shows [Qs Kd] (two pair, Kings and Deuces)
Wq26opBLDGJe91GRJn2epg collected $6.35 from pot
8ClCHtFXGNplITm+63KB+Q collected $6.30 from pot
*** SUMMARY ***
Total pot $13.25 | Rake $0.60 
Board [4s Kc 8d 2h 2s]
Seat 1: GbCVUNssQ7mqsPWr7J4d3w folded before Flop (didn't bet)
Seat 2: 8ClCHtFXGNplITm+63KB+Q (button) showed [Qs Kd] and won ($6.30) with two pair, Kings and Deuces
Seat 3: Wq26opBLDGJe91GRJn2epg (small blind) showed [Qh Kh] and won ($6.35) with two pair, Kings and Deuces
Seat 4: lquriepNQBhDV5P1SWHhnA (big blind) folded before Flop
Seat 5: DihMHaz4WNETH1bPDe13kA folded before Flop (didn't bet)
Seat 6: jp34e617tIzV8tKIWmfAbA folded before Flop (didn't bet)




PokerStars Game #59941827270:  Hold'em No Limit ($0.10/$0.25) - 2009/07/01 1:47:24 ET
Table 'z2yOdY2zyGWG1gh9WV9XtQ' 9-max Seat #3 is the button
Seat 1: 8iyfEWL3auLDt9HEV3U5Vg ($25 in chips) 
Seat 3: X78b5v/uhqeXXoAijbw/yg ($26.30 in chips) 
Seat 4: Bb42QRQMhg5/Y0vHP8/2Xw ($25.10 in chips) 
Seat 6: NBYmTySMtIicyMj5Vjzqhw ($31.90 in chips) 
Seat 7: zDrucyjVn5aeekNEc3cJrA ($22 in chips) 
Seat 9: wGigCmBR/9XWkPpvYos3aQ ($34.65 in chips) 
Bb42QRQMhg5/Y0vHP8/2Xw: posts small blind $0.10
NBYmTySMtIicyMj5Vjzqhw: posts big blind $0.25
8iyfEWL3auLDt9HEV3U5Vg: posts big blind $0.25
*** HOLE CARDS ***
zDrucyjVn5aeekNEc3cJrA: folds 
wGigCmBR/9XWkPpvYos3aQ: folds 
u+J1MTXS2qhNVMbsBemNLg joins the table at seat #8 
8iyfEWL3auLDt9HEV3U5Vg: checks 
X78b5v/uhqeXXoAijbw/yg: raises $1 to $1.25
Bb42QRQMhg5/Y0vHP8/2Xw: folds 
NBYmTySMtIicyMj5Vjzqhw: folds 
8iyfEWL3auLDt9HEV3U5Vg: folds 
Uncalled bet ($1) returned to X78b5v/uhqeXXoAijbw/yg
X78b5v/uhqeXXoAijbw/yg collected $0.85 from pot
*** SUMMARY ***
Total pot $0.85 | Rake $0 
Seat 1: 8iyfEWL3auLDt9HEV3U5Vg folded before Flop
Seat 3: X78b5v/uhqeXXoAijbw/yg (button) collected ($0.85)
Seat 4: Bb42QRQMhg5/Y0vHP8/2Xw (small blind) folded before Flop
Seat 6: NBYmTySMtIicyMj5Vjzqhw (big blind) folded before Flop
Seat 7: zDrucyjVn5aeekNEc3cJrA folded before Flop (didn't bet)
Seat 9: wGigCmBR/9XWkPpvYos3aQ folded before Flop (didn't bet)




PokerStars Game #59941827488:  Hold'em No Limit ($0.10/$0.25) - 2009/07/01 1:47:24 ET
Table '6aL2C8IFwHHr6SG6RgXaow' 9-max Seat #6 is the button
Seat 1: bXpVeaSTPBFSPJmeXxO7nw ($5.50 in chips) 
Seat 3: clJsV3v77RS07bDKY+705w ($5 in chips) 
Seat 4: BT6Oal0iO4P6kDuT7HFQDw ($19.05 in chips) 
Seat 5: wre31HfyzQGpIvID1istxw ($20.95 in chips) 
Seat 6: gehe91e0IyVT0QU/XBkEyg ($26.75 in chips) 
Seat 8: rQhYIYXSyH/IivYM1dlV5A ($22.20 in chips) 
Seat 9: CgIo2ItZqi4o3ayVG6HanQ ($23.50 in chips) 
E0iYnEVO2ho7dH3QcCjw7g will be allowed to play after the button
rQhYIYXSyH/IivYM1dlV5A: posts small blind $0.10
CgIo2ItZqi4o3ayVG6HanQ: posts big blind $0.25
*** HOLE CARDS ***
bXpVeaSTPBFSPJmeXxO7nw: folds 
clJsV3v77RS07bDKY+705w: folds 
BT6Oal0iO4P6kDuT7HFQDw: folds 
wre31HfyzQGpIvID1istxw: calls $0.25
gehe91e0IyVT0QU/XBkEyg: folds 
rQhYIYXSyH/IivYM1dlV5A: calls $0.15
CgIo2ItZqi4o3ayVG6HanQ: checks 
*** FLOP *** [6c 8s 8d]
rQhYIYXSyH/IivYM1dlV5A: checks 
CgIo2ItZqi4o3ayVG6HanQ: checks 
wre31HfyzQGpIvID1istxw: checks 
*** TURN *** [6c 8s 8d] [7d]
rQhYIYXSyH/IivYM1dlV5A: checks 
CgIo2ItZqi4o3ayVG6HanQ: checks 
wre31HfyzQGpIvID1istxw: bets $1
rQhYIYXSyH/IivYM1dlV5A: folds 
CgIo2ItZqi4o3ayVG6HanQ: folds 
Uncalled bet ($1) returned to wre31HfyzQGpIvID1istxw
wre31HfyzQGpIvID1istxw collected $0.75 from pot
wre31HfyzQGpIvID1istxw: doesn't show hand 
*** SUMMARY ***
Total pot $0.75 | Rake $0 
Board [6c 8s 8d 7d]
Seat 1: bXpVeaSTPBFSPJmeXxO7nw folded before Flop (didn't bet)
Seat 3: clJsV3v77RS07bDKY+705w folded before Flop (didn't bet)
Seat 4: BT6Oal0iO4P6kDuT7HFQDw folded before Flop (didn't bet)
Seat 5: wre31HfyzQGpIvID1istxw collected ($0.75)
Seat 6: gehe91e0IyVT0QU/XBkEyg (button) folded before Flop (didn't bet)
Seat 8: rQhYIYXSyH/IivYM1dlV5A (small blind) folded on the Turn
Seat 9: CgIo2ItZqi4o3ayVG6HanQ (big blind) folded on the Turn




PokerStars Game #59941827228:  Hold'em No Limit ($0.10/$0.25) - 2009/07/01 1:47:24 ET
Table 'JPFXJXa5xBkjZ/W15BKqeQ' 9-max Seat #6 is the button
Seat 1: mNQH7Afv3tbDKl2tAb9BOg ($19.60 in chips) 
Seat 2: XMSS6mD5B42I8wasdOMipQ ($13.10 in chips) 
Seat 3: 56S3mA6Zs3pGR+0p0vUCtg ($19.20 in chips) 
Seat 4: wGigCmBR/9XWkPpvYos3aQ ($26.40 in chips) 
Seat 5: cZ99hugmLBj9KhTlc8nCSw ($25.60 in chips) 
Seat 6: tLcDklc2rBORNfixyRfVfw ($25 in chips) 
Seat 7: PdIasPkzm2sqZnN41ZRXOg ($4.75 in chips) 
Seat 9: V6p0jQ/RhUsqpHLmXvEX4Q ($12.35 in chips) 
PdIasPkzm2sqZnN41ZRXOg: posts small blind $0.10
V6p0jQ/RhUsqpHLmXvEX4Q: posts big blind $0.25
*** HOLE CARDS ***
mNQH7Afv3tbDKl2tAb9BOg: folds 
XMSS6mD5B42I8wasdOMipQ: folds 
56S3mA6Zs3pGR+0p0vUCtg: folds 
wGigCmBR/9XWkPpvYos3aQ: raises $0.65 to $0.90
cZ99hugmLBj9KhTlc8nCSw: folds 
tLcDklc2rBORNfixyRfVfw: folds 
PdIasPkzm2sqZnN41ZRXOg: folds 
V6p0jQ/RhUsqpHLmXvEX4Q: calls $0.65
*** FLOP *** [5c Td 6d]
V6p0jQ/RhUsqpHLmXvEX4Q: checks 
wGigCmBR/9XWkPpvYos3aQ: bets $1.50
V6p0jQ/RhUsqpHLmXvEX4Q: calls $1.50
*** TURN *** [5c Td 6d] [Qh]
V6p0jQ/RhUsqpHLmXvEX4Q: checks 
wGigCmBR/9XWkPpvYos3aQ: checks 
*** RIVER *** [5c Td 6d Qh] [Th]
V6p0jQ/RhUsqpHLmXvEX4Q: bets $4
wGigCmBR/9XWkPpvYos3aQ: calls $4
*** SHOW DOWN ***
V6p0jQ/RhUsqpHLmXvEX4Q: shows [Kd Jd] (a pair of Tens)
wGigCmBR/9XWkPpvYos3aQ: shows [9d 9h] (two pair, Tens and Nines)
wGigCmBR/9XWkPpvYos3aQ collected $12.30 from pot
*** SUMMARY ***
Total pot $12.90 | Rake $0.60 
Board [5c Td 6d Qh Th]
Seat 1: mNQH7Afv3tbDKl2tAb9BOg folded before Flop (didn't bet)
Seat 2: XMSS6mD5B42I8wasdOMipQ folded before Flop (didn't bet)
Seat 3: 56S3mA6Zs3pGR+0p0vUCtg folded before Flop (didn't bet)
Seat 4: wGigCmBR/9XWkPpvYos3aQ showed [9d 9h] and won ($12.30) with two pair, Tens and Nines
Seat 5: cZ99hugmLBj9KhTlc8nCSw folded before Flop (didn't bet)
Seat 6: tLcDklc2rBORNfixyRfVfw (button) folded before Flop (didn't bet)
Seat 7: PdIasPkzm2sqZnN41ZRXOg (small blind) folded before Flop
Seat 9: V6p0jQ/RhUsqpHLmXvEX4Q (big blind) showed [Kd Jd] and lost with a pair of Tens




PokerStars Game #59941827276:  Hold'em No Limit ($0.10/$0.25) - 2009/07/01 1:47:24 ET
Table 'hfHe8uKeSJMyWAjSdM7ROQMRfAiS/4JSfnUDlCcZo0wAx Seat #2 is the button
Seat 1: 48oT5xFI+5CHUJlfoGrE4w ($30.15 in chips) 
Seat 2: /gJNBeCkWL4o85/jvlZ4BA ($28.85 in chips) 
Seat 3: FYepjhAvF8ZdVCmqHIy+eQ ($38.95 in chips) 
Seat 4: b4wRQV3APH8irVk6bUFe2Q ($36.95 in chips) 
Seat 6: df01R5ThvHspD8FgKmaDvQ ($25 in chips) 
FYepjhAvF8ZdVCmqHIy+eQ: posts small blind $0.10
b4wRQV3APH8irVk6bUFe2Q: posts big blind $0.25
Q1uciOZPBR/WkAlqa6cL4A: sits out 
df01R5ThvHspD8FgKmaDvQ: posts big blind $0.25
*** HOLE CARDS ***
df01R5ThvHspD8FgKmaDvQ: raises $0.50 to $0.75
48oT5xFI+5CHUJlfoGrE4w: folds 
/gJNBeCkWL4o85/jvlZ4BA: folds 
FYepjhAvF8ZdVCmqHIy+eQ: folds 
b4wRQV3APH8irVk6bUFe2Q: folds 
Uncalled bet ($0.50) returned to df01R5ThvHspD8FgKmaDvQ
df01R5ThvHspD8FgKmaDvQ collected $0.60 from pot
*** SUMMARY ***
Total pot $0.60 | Rake $0 
Seat 1: 48oT5xFI+5CHUJlfoGrE4w folded before Flop (didn't bet)
Seat 2: /gJNBeCkWL4o85/jvlZ4BA (button) folded before Flop (didn't bet)
Seat 3: FYepjhAvF8ZdVCmqHIy+eQ (small blind) folded before Flop
Seat 4: b4wRQV3APH8irVk6bUFe2Q (big blind) folded before Flop
Seat 6: df01R5ThvHspD8FgKmaDvQ collected ($0.60)




PokerStars Game #59941827706:  Hold'em No Limit ($0.10/$0.25) - 2009/07/01 1:47:25 ET
Table 'T/iCKJXGphRN3xcdwfE/JQ' 6-max Seat #5 is the button
Seat 1: wAKC8C/zN0c8V5v13dm9mA ($25.35 in chips) 
Seat 2: EeUZtMU058v2ObUACOF4Og ($32 in chips) 
Seat 3: IWAjoCPXtc1XUaZdp+pCpA ($22.10 in chips) 
Seat 5: gaPMxLGp9SOj4Lq6t+/0Ig ($8.85 in chips) 
Seat 6: Ey4Kn6PlnYb2srYYBJHvzg ($13.80 in chips) 
Ey4Kn6PlnYb2srYYBJHvzg: posts small blind $0.10
wAKC8C/zN0c8V5v13dm9mA: posts big blind $0.25
m2yWOKfAxqHoy5DDN87Ttw: sits out 
*** HOLE CARDS ***
EeUZtMU058v2ObUACOF4Og: folds 
IWAjoCPXtc1XUaZdp+pCpA: folds 
gaPMxLGp9SOj4Lq6t+/0Ig: folds 
Ey4Kn6PlnYb2srYYBJHvzg: calls $0.15
wAKC8C/zN0c8V5v13dm9mA: raises $0.75 to $1
Ey4Kn6PlnYb2srYYBJHvzg: calls $0.75
*** FLOP *** [7h Ah 9c]
Ey4Kn6PlnYb2srYYBJHvzg: checks 
wAKC8C/zN0c8V5v13dm9mA: bets $1.25
Ey4Kn6PlnYb2srYYBJHvzg: folds 
Uncalled bet ($1.25) returned to wAKC8C/zN0c8V5v13dm9mA
wAKC8C/zN0c8V5v13dm9mA collected $1.90 from pot
*** SUMMARY ***
Total pot $2 | Rake $0.10 
Board [7h Ah 9c]
Seat 1: wAKC8C/zN0c8V5v13dm9mA (big blind) collected ($1.90)
Seat 2: EeUZtMU058v2ObUACOF4Og folded before Flop (didn't bet)
Seat 3: IWAjoCPXtc1XUaZdp+pCpA folded before Flop (didn't bet)
Seat 5: gaPMxLGp9SOj4Lq6t+/0Ig (button) folded before Flop (didn't bet)
Seat 6: Ey4Kn6PlnYb2srYYBJHvzg (small blind) folded on the Flop




PokerStars Game #59941827808:  Hold'em No Limit ($0.10/$0.25) - 2009/07/01 1:47:25 ET
Table 'b64Z+5XI1xkQzNfq4QHr3A' 6-max Seat #6 is the button
Seat 2: A6SjYLoKeIpFjPq0BK/2WA ($4.50 in chips) 
Seat 3: 7cx44/slbeTw+Cy7QB8Trg ($25 in chips) 
Seat 4: 564zqq2DUHXR3tdsOJU6JA ($15.35 in chips) 
Seat 5: JFIAqU8lCZ0vWwEl4bdGsg ($58.10 in chips) 
Seat 6: 8ClCHtFXGNplITm+63KB+Q ($33 in chips) 
A6SjYLoKeIpFjPq0BK/2WA: posts small blind $0.10
7cx44/slbeTw+Cy7QB8Trg: posts big blind $0.25
*** HOLE CARDS ***
564zqq2DUHXR3tdsOJU6JA: calls $0.25
JFIAqU8lCZ0vWwEl4bdGsg: folds 
8ClCHtFXGNplITm+63KB+Q: folds 
A6SjYLoKeIpFjPq0BK/2WA: raises $1.25 to $1.50
7cx44/slbeTw+Cy7QB8Trg: folds 
564zqq2DUHXR3tdsOJU6JA: calls $1.25
*** FLOP *** [Jh As Qd]
A6SjYLoKeIpFjPq0BK/2WA: bets $3 and is all-in
564zqq2DUHXR3tdsOJU6JA: calls $3
*** TURN *** [Jh As Qd] [5d]
*** RIVER *** [Jh As Qd 5d] [Kc]
*** SHOW DOWN ***
A6SjYLoKeIpFjPq0BK/2WA: shows [4h 4c] (a pair of Fours)
564zqq2DUHXR3tdsOJU6JA: shows [Ts 7d] (a straight, Ten to Ace)
564zqq2DUHXR3tdsOJU6JA collected $8.80 from pot
*** SUMMARY ***
Total pot $9.25 | Rake $0.45 
Board [Jh As Qd 5d Kc]
Seat 2: A6SjYLoKeIpFjPq0BK/2WA (small blind) showed [4h 4c] and lost with a pair of Fours
Seat 3: 7cx44/slbeTw+Cy7QB8Trg (big blind) folded before Flop
Seat 4: 564zqq2DUHXR3tdsOJU6JA showed [Ts 7d] and won ($8.80) with a straight, Ten to Ace
Seat 5: JFIAqU8lCZ0vWwEl4bdGsg folded before Flop (didn't bet)
Seat 6: 8ClCHtFXGNplITm+63KB+Q (button) folded before Flop (didn't bet)




PokerStars Game #59941827628:  Hold'em No Limit ($0.10/$0.25) - 2009/07/01 1:47:25 ET
Table 'FE/j6VqBY4j9Uq+VHURQCQ' 6-max Seat #1 is the button
Seat 1: ypmjhffk/YHGc51wgVXUTw ($41.65 in chips) 
Seat 2: 3zD3qLXT1bEffAoWGnc7wg ($36.85 in chips) 
Seat 3: lBoEwOFgzcERLIRUkUoRTw ($27 in chips) 
Seat 4: 7JyPCA0J2grhXQYxe1h3+A ($7.35 in chips) 
Seat 5: bJFzs6QmEEnz4miMfSDtcg ($15 in chips) 
3zD3qLXT1bEffAoWGnc7wg: posts small blind $0.10
lBoEwOFgzcERLIRUkUoRTw: posts big blind $0.25
bJFzs6QmEEnz4miMfSDtcg: posts big blind $0.25
Q1uciOZPBR/WkAlqa6cL4A: sits out 
*** HOLE CARDS ***
7JyPCA0J2grhXQYxe1h3+A: calls $0.25
bJFzs6QmEEnz4miMfSDtcg: checks 
ypmjhffk/YHGc51wgVXUTw: folds 
3zD3qLXT1bEffAoWGnc7wg: folds 
lBoEwOFgzcERLIRUkUoRTw: checks 
*** FLOP *** [Qh 6s 5d]
lBoEwOFgzcERLIRUkUoRTw: checks 
7JyPCA0J2grhXQYxe1h3+A: checks 
bJFzs6QmEEnz4miMfSDtcg: checks 
*** TURN *** [Qh 6s 5d] [5c]
lBoEwOFgzcERLIRUkUoRTw: checks 
7JyPCA0J2grhXQYxe1h3+A: checks 
bJFzs6QmEEnz4miMfSDtcg: checks 
*** RIVER *** [Qh 6s 5d 5c] [Ah]
lBoEwOFgzcERLIRUkUoRTw: checks 
7JyPCA0J2grhXQYxe1h3+A: checks 
bJFzs6QmEEnz4miMfSDtcg: checks 
*** SHOW DOWN ***
lBoEwOFgzcERLIRUkUoRTw: shows [Kh 2s] (a pair of Fives)
7JyPCA0J2grhXQYxe1h3+A: mucks hand 
bJFzs6QmEEnz4miMfSDtcg: mucks hand 
lBoEwOFgzcERLIRUkUoRTw collected $0.85 from pot
*** SUMMARY ***
Total pot $0.85 | Rake $0 
Board [Qh 6s 5d 5c Ah]
Seat 1: ypmjhffk/YHGc51wgVXUTw (button) folded before Flop (didn't bet)
Seat 2: 3zD3qLXT1bEffAoWGnc7wg (small blind) folded before Flop
Seat 3: lBoEwOFgzcERLIRUkUoRTw (big blind) showed [Kh 2s] and won ($0.85) with a pair of Fives
Seat 4: 7JyPCA0J2grhXQYxe1h3+A mucked
Seat 5: bJFzs6QmEEnz4miMfSDtcg mucked




PokerStars Game #59941827910:  Hold'em No Limit ($0.10/$0.25) - 2009/07/01 1:47:25 ET
Table '2clPgY3+dETPD/8zjXZdFw' 6-max Seat #3 is the button
Seat 2: cWc85bEzdRzpUMhRKm8pwQ ($25.30 in chips) 
Seat 3: FL1UWpN6oReBdznWDOy9Gg ($15.60 in chips) 
Seat 4: ljjhtb6FVPTx9AT9HNdtqg ($24.85 in chips) 
Seat 5: LJI7A1YgDM7hgh7o56+ReQ ($29.55 in chips) 
ljjhtb6FVPTx9AT9HNdtqg: posts small blind $0.10
LJI7A1YgDM7hgh7o56+ReQ: posts big blind $0.25
7cx44/slbeTw+Cy7QB8Trg: sits out 
*** HOLE CARDS ***
cWc85bEzdRzpUMhRKm8pwQ: folds 
FL1UWpN6oReBdznWDOy9Gg: folds 
ljjhtb6FVPTx9AT9HNdtqg: folds 
Uncalled bet ($0.15) returned to LJI7A1YgDM7hgh7o56+ReQ
LJI7A1YgDM7hgh7o56+ReQ collected $0.20 from pot
LJI7A1YgDM7hgh7o56+ReQ: doesn't show hand 
*** SUMMARY ***
Total pot $0.20 | Rake $0 
Seat 2: cWc85bEzdRzpUMhRKm8pwQ folded before Flop (didn't bet)
Seat 3: FL1UWpN6oReBdznWDOy9Gg (button) folded before Flop (didn't bet)
Seat 4: ljjhtb6FVPTx9AT9HNdtqg (small blind) folded before Flop
Seat 5: LJI7A1YgDM7hgh7o56+ReQ (big blind) collected ($0.20)




PokerStars Game #59941828386:  Hold'em No Limit ($0.10/$0.25) - 2009/07/01 1:47:26 ET
Table 'Yb2CyZosw7N3yRRVLhKnKg' 9-max Seat #4 is the button
Seat 1: c/9X4zftzphFxYtxp5kp9w ($11.55 in chips) 
Seat 2: dtZ84flFEi4Q+SGrHMJRDQ ($26.15 in chips) 
Seat 3: wUanlt/hhheMA+jOrJk2Tg ($9.65 in chips) 
Seat 4: FG10kumpruEJ3PQJ7oGglQ ($13.70 in chips) 
Seat 6: CgIo2ItZqi4o3ayVG6HanQ ($48.25 in chips) 
Seat 7: ljemhp25Zg+nlA9DLCIiUw ($26.10 in chips) 
Seat 8: HxDF4QSxC4z39D7teZpprQ ($10.75 in chips) 
Seat 9: 6DVf3fwEGECnjQ4Yp9AsFw ($16.55 in chips) 
CgIo2ItZqi4o3ayVG6HanQ: posts small blind $0.10
ljemhp25Zg+nlA9DLCIiUw: posts big blind $0.25
*** HOLE CARDS ***
HxDF4QSxC4z39D7teZpprQ: calls $0.25
6DVf3fwEGECnjQ4Yp9AsFw: folds 
c/9X4zftzphFxYtxp5kp9w: folds 
dtZ84flFEi4Q+SGrHMJRDQ: folds 
wUanlt/hhheMA+jOrJk2Tg: calls $0.25
FG10kumpruEJ3PQJ7oGglQ: calls $0.25
CgIo2ItZqi4o3ayVG6HanQ: calls $0.15
T5Hk9oiIr+JDDMnEqwFCrw leaves the table
ljemhp25Zg+nlA9DLCIiUw: checks 
*** FLOP *** [9c Jd 6c]
CgIo2ItZqi4o3ayVG6HanQ: checks 
ljemhp25Zg+nlA9DLCIiUw: checks 
HxDF4QSxC4z39D7teZpprQ: bets $1
wUanlt/hhheMA+jOrJk2Tg: folds 
FG10kumpruEJ3PQJ7oGglQ: calls $1
CgIo2ItZqi4o3ayVG6HanQ: folds 
ljemhp25Zg+nlA9DLCIiUw: calls $1
*** TURN *** [9c Jd 6c] [4d]
ljemhp25Zg+nlA9DLCIiUw: checks 
HxDF4QSxC4z39D7teZpprQ: bets $2.75
FG10kumpruEJ3PQJ7oGglQ: folds 
ljemhp25Zg+nlA9DLCIiUw: folds 
Uncalled bet ($2.75) returned to HxDF4QSxC4z39D7teZpprQ
HxDF4QSxC4z39D7teZpprQ collected $4.05 from pot
*** SUMMARY ***
Total pot $4.25 | Rake $0.20 
Board [9c Jd 6c 4d]
Seat 1: c/9X4zftzphFxYtxp5kp9w folded before Flop (didn't bet)
Seat 2: dtZ84flFEi4Q+SGrHMJRDQ folded before Flop (didn't bet)
Seat 3: wUanlt/hhheMA+jOrJk2Tg folded on the Flop
Seat 4: FG10kumpruEJ3PQJ7oGglQ (button) folded on the Turn
Seat 6: CgIo2ItZqi4o3ayVG6HanQ (small blind) folded on the Flop
Seat 7: ljemhp25Zg+nlA9DLCIiUw (big blind) folded on the Turn
Seat 8: HxDF4QSxC4z39D7teZpprQ collected ($4.05)
Seat 9: 6DVf3fwEGECnjQ4Yp9AsFw folded before Flop (didn't bet)




PokerStars Game #59941828530:  Hold'em No Limit ($0.10/$0.25) - 2009/07/01 1:47:26 ET
Table '+fuYjvJy9okLr23QyZtanA' 9-max Seat #4 is the button
Seat 2: tLcDklc2rBORNfixyRfVfw ($25 in chips) 
Seat 3: eK8qa6EPcH2zhtbmWSvc9g ($52.30 in chips) 
Seat 4: Bb42QRQMhg5/Y0vHP8/2Xw ($30.15 in chips) 
Seat 5: bXpVeaSTPBFSPJmeXxO7nw ($4.40 in chips) 
Seat 6: wGigCmBR/9XWkPpvYos3aQ ($30.20 in chips) 
Seat 7: dfNim92Z6XK1/h5SFW5vDg ($37.50 in chips) 
Seat 8: KqS/lY/fNB9qUxokm9QfeA ($9.25 in chips) 
Seat 9: OMhlmt2waO3z43ZSFNMmog ($29.95 in chips) 
bXpVeaSTPBFSPJmeXxO7nw: posts small blind $0.10
wGigCmBR/9XWkPpvYos3aQ: posts big blind $0.25
*** HOLE CARDS ***
dfNim92Z6XK1/h5SFW5vDg: folds 
KqS/lY/fNB9qUxokm9QfeA: calls $0.25
OMhlmt2waO3z43ZSFNMmog: folds 
tLcDklc2rBORNfixyRfVfw: folds 
eK8qa6EPcH2zhtbmWSvc9g: folds 
Bb42QRQMhg5/Y0vHP8/2Xw: folds 
bXpVeaSTPBFSPJmeXxO7nw: folds 
wGigCmBR/9XWkPpvYos3aQ: checks 
*** FLOP *** [8s Jd 9d]
wGigCmBR/9XWkPpvYos3aQ: checks 
KqS/lY/fNB9qUxokm9QfeA: checks 
*** TURN *** [8s Jd 9d] [Kh]
wGigCmBR/9XWkPpvYos3aQ: bets $0.30
KqS/lY/fNB9qUxokm9QfeA: calls $0.30
*** RIVER *** [8s Jd 9d Kh] [Ks]
wGigCmBR/9XWkPpvYos3aQ: bets $0.80
KqS/lY/fNB9qUxokm9QfeA: folds 
Uncalled bet ($0.80) returned to wGigCmBR/9XWkPpvYos3aQ
wGigCmBR/9XWkPpvYos3aQ collected $1.15 from pot
wGigCmBR/9XWkPpvYos3aQ: doesn't show hand 
*** SUMMARY ***
Total pot $1.20 | Rake $0.05 
Board [8s Jd 9d Kh Ks]
Seat 2: tLcDklc2rBORNfixyRfVfw folded before Flop (didn't bet)
Seat 3: eK8qa6EPcH2zhtbmWSvc9g folded before Flop (didn't bet)
Seat 4: Bb42QRQMhg5/Y0vHP8/2Xw (button) folded before Flop (didn't bet)
Seat 5: bXpVeaSTPBFSPJmeXxO7nw (small blind) folded before Flop
Seat 6: wGigCmBR/9XWkPpvYos3aQ (big blind) collected ($1.15)
Seat 7: dfNim92Z6XK1/h5SFW5vDg folded before Flop (didn't bet)
Seat 8: KqS/lY/fNB9qUxokm9QfeA folded on the River
Seat 9: OMhlmt2waO3z43ZSFNMmog folded before Flop (didn't bet)




PokerStars Game #59941828268:  Hold'em No Limit ($0.10/$0.25) - 2009/07/01 1:47:26 ET
Table 'sm5gqEvXgLbkkE4dryW/5g' 6-max Seat #1 is the button
Seat 1: v8m8XHovI5tqEA9mvplDSw ($39.85 in chips) 
Seat 2: 5xs5/u2z1CO9zkRvH72MQg ($17.75 in chips) 
Seat 3: UT5XpwOH1ipkOF7n1MqDJA ($21.90 in chips) 
Seat 4: cWc85bEzdRzpUMhRKm8pwQ ($26.15 in chips) 
Seat 6: aogAb4Eienxztk8p2v9VVw ($22.15 in chips) 
5xs5/u2z1CO9zkRvH72MQg: posts small blind $0.10
UT5XpwOH1ipkOF7n1MqDJA: posts big blind $0.25
*** HOLE CARDS ***
cWc85bEzdRzpUMhRKm8pwQ: folds 
aogAb4Eienxztk8p2v9VVw: raises $0.50 to $0.75
v8m8XHovI5tqEA9mvplDSw: folds 
5xs5/u2z1CO9zkRvH72MQg: folds 
UT5XpwOH1ipkOF7n1MqDJA: folds 
Uncalled bet ($0.50) returned to aogAb4Eienxztk8p2v9VVw
aogAb4Eienxztk8p2v9VVw collected $0.60 from pot
aogAb4Eienxztk8p2v9VVw: doesn't show hand 
*** SUMMARY ***
Total pot $0.60 | Rake $0 
Seat 1: v8m8XHovI5tqEA9mvplDSw (button) folded before Flop (didn't bet)
Seat 2: 5xs5/u2z1CO9zkRvH72MQg (small blind) folded before Flop
Seat 3: UT5XpwOH1ipkOF7n1MqDJA (big blind) folded before Flop
Seat 4: cWc85bEzdRzpUMhRKm8pwQ folded before Flop (didn't bet)
Seat 6: aogAb4Eienxztk8p2v9VVw collected ($0.60)




PokerStars Game #59941828528:  Hold'em No Limit ($0.10/$0.25) - 2009/07/01 1:47:26 ET
Table 'hfHe8uKeSJMyWAjSdM7ROQ' 6-max Seat #4 is the button
Seat 1: eHsmIvAb2JREg4O6hNPnXg ($44.90 in chips) 
Seat 2: QvTX2yGq3uKJiKPmns4TKQ ($29.55 in chips) 
Seat 3: oAzQdB2jFOH1NxFUPjYUGg ($22 in chips) 
Seat 4: b4wRQV3APH8irVk6bUFe2Q ($26.25 in chips) 
Seat 5: euswrBD1XG0Q5hB1iGJBKQ ($61.30 in chips) 
Seat 6: eL3+wCBjFGfQ5FMdIZihwA ($25 in chips) 
euswrBD1XG0Q5hB1iGJBKQ: posts small blind $0.10
eL3+wCBjFGfQ5FMdIZihwA: posts big blind $0.25
*** HOLE CARDS ***
eHsmIvAb2JREg4O6hNPnXg: folds 
QvTX2yGq3uKJiKPmns4TKQ: folds 
oAzQdB2jFOH1NxFUPjYUGg: calls $0.25
b4wRQV3APH8irVk6bUFe2Q: raises $0.25 to $0.50
euswrBD1XG0Q5hB1iGJBKQ: calls $0.40
eL3+wCBjFGfQ5FMdIZihwA: folds 
oAzQdB2jFOH1NxFUPjYUGg: calls $0.25
*** FLOP *** [7s 3s Kc]
euswrBD1XG0Q5hB1iGJBKQ: checks 
oAzQdB2jFOH1NxFUPjYUGg: checks 
b4wRQV3APH8irVk6bUFe2Q: bets $1.25
euswrBD1XG0Q5hB1iGJBKQ: folds 
oAzQdB2jFOH1NxFUPjYUGg: folds 
Uncalled bet ($1.25) returned to b4wRQV3APH8irVk6bUFe2Q
b4wRQV3APH8irVk6bUFe2Q collected $1.70 from pot
*** SUMMARY ***
Total pot $1.75 | Rake $0.05 
Board [7s 3s Kc]
Seat 1: eHsmIvAb2JREg4O6hNPnXg folded before Flop (didn't bet)
Seat 2: QvTX2yGq3uKJiKPmns4TKQ folded before Flop (didn't bet)
Seat 3: oAzQdB2jFOH1NxFUPjYUGg folded on the Flop
Seat 4: b4wRQV3APH8irVk6bUFe2Q (button) collected ($1.70)
Seat 5: euswrBD1XG0Q5hB1iGJBKQ (small blind) folded on the Flop
Seat 6: eL3+wCBjFGfQ5FMdIZihwA (big blind) folded before Flop




PokerStars Game #59941829008:  Hold'em No Limit ($0.10/$0.25) - 2009/07/01 1:47:27 ET
Table 'biAgO3TKQBU8XcrVAoU5TA' 6-max Seat #4 is the button
Seat 1: jhDPlkir8wBYAddboBuF7Q ($16.55 in chips) 
Seat 2: GbCVUNssQ7mqsPWr7J4d3w ($7.15 in chips) 
Seat 3: mfrkWA3PTeYPkbO6hi98Aw ($31.65 in chips) 
Seat 4: Hsvkc0/G2VV78oVmWYXecw ($5 in chips) 
Seat 5: n6UPMnVR4v8LFP0rWP73Fg ($10.95 in chips) 
Seat 6: wMiE3yTbDJGOLOF9th7KPA ($8.60 in chips) 
n6UPMnVR4v8LFP0rWP73Fg: posts small blind $0.10
wMiE3yTbDJGOLOF9th7KPA: posts big blind $0.25
*** HOLE CARDS ***
jhDPlkir8wBYAddboBuF7Q: calls $0.25
GbCVUNssQ7mqsPWr7J4d3w: folds 
mfrkWA3PTeYPkbO6hi98Aw: raises $1 to $1.25
Hsvkc0/G2VV78oVmWYXecw: folds 
n6UPMnVR4v8LFP0rWP73Fg: raises $1 to $2.25
wMiE3yTbDJGOLOF9th7KPA: folds 
jhDPlkir8wBYAddboBuF7Q: calls $2
mfrkWA3PTeYPkbO6hi98Aw: calls $1
*** FLOP *** [Th Ts 2s]
n6UPMnVR4v8LFP0rWP73Fg: bets $8.70 and is all-in
jhDPlkir8wBYAddboBuF7Q: folds 
mfrkWA3PTeYPkbO6hi98Aw: folds 
Uncalled bet ($8.70) returned to n6UPMnVR4v8LFP0rWP73Fg
n6UPMnVR4v8LFP0rWP73Fg collected $6.65 from pot
n6UPMnVR4v8LFP0rWP73Fg: doesn't show hand 
*** SUMMARY ***
Total pot $7 | Rake $0.35 
Board [Th Ts 2s]
Seat 1: jhDPlkir8wBYAddboBuF7Q folded on the Flop
Seat 2: GbCVUNssQ7mqsPWr7J4d3w folded before Flop (didn't bet)
Seat 3: mfrkWA3PTeYPkbO6hi98Aw folded on the Flop
Seat 4: Hsvkc0/G2VV78oVmWYXecw (button) folded before Flop (didn't bet)
Seat 5: n6UPMnVR4v8LFP0rWP73Fg (small blind) collected ($6.65)
Seat 6: wMiE3yTbDJGOLOF9th7KPA (big blind) folded before Flop




PokerStars Game #59941828980:  Hold'em No Limit ($0.10/$0.25) - 2009/07/01 1:47:27 ET
Table '+giHa6FUL6U5/AZnCJEGvQ' 9-max Seat #6 is the button
Seat 4: 10f7J+bM02ZfDHx0PgkNSg ($15.20 in chips) 
Seat 5: zDrucyjVn5aeekNEc3cJrA ($44.90 in chips) 
Seat 6: GTMnTen6sQSoCpS9sggLbg ($24.30 in chips) 
clkou will be allowed to play after the button
10f7J+bM02ZfDHx0PgkNSg: posts small blind $0.10
zDrucyjVn5aeekNEc3cJrA: posts big blind $0.25
*** HOLE CARDS ***
GTMnTen6sQSoCpS9sggLbg: folds 
10f7J+bM02ZfDHx0PgkNSg: calls $0.15
zDrucyjVn5aeekNEc3cJrA: checks 
*** FLOP *** [9d 2h 9c]
10f7J+bM02ZfDHx0PgkNSg: checks 
zDrucyjVn5aeekNEc3cJrA: checks 
*** TURN *** [9d 2h 9c] [8h]
10f7J+bM02ZfDHx0PgkNSg: checks 
zDrucyjVn5aeekNEc3cJrA: checks 
*** RIVER *** [9d 2h 9c 8h] [6s]
10f7J+bM02ZfDHx0PgkNSg: checks 
zDrucyjVn5aeekNEc3cJrA: checks 
*** SHOW DOWN ***
10f7J+bM02ZfDHx0PgkNSg: shows [Ac 4c] (a pair of Nines)
zDrucyjVn5aeekNEc3cJrA: shows [4h 6c] (two pair, Nines and Sixes)
zDrucyjVn5aeekNEc3cJrA collected $0.50 from pot
*** SUMMARY ***
Total pot $0.50 | Rake $0 
Board [9d 2h 9c 8h 6s]
Seat 4: 10f7J+bM02ZfDHx0PgkNSg (small blind) showed [Ac 4c] and lost with a pair of Nines
Seat 5: zDrucyjVn5aeekNEc3cJrA (big blind) showed [4h 6c] and won ($0.50) with two pair, Nines and Sixes
Seat 6: GTMnTen6sQSoCpS9sggLbg (button) folded before Flop (didn't bet)




PokerStars Game #59941828926:  Hold'em No Limit ($0.10/$0.25) - 2009/07/01 1:47:27 ET
Table 'jz4TpuH+ag+0iNe2ZcxckQ' 9-max Seat #8 is the button
Seat 2: clJsV3v77RS07bDKY+705w ($5 in chips) 
Seat 3: egvg3mTBBVzMHnJPIQiKcA ($15.80 in chips) 
Seat 4: k+2r6di6GXjNpAdrRkW9bA ($58.15 in chips) 
Seat 5: v1BVHNGLbP/nx7QO6K7+Jw ($37.50 in chips) 
Seat 6: gO1uiTGTzn5Cd3PECuws1g ($13.65 in chips) 
Seat 7: tLcDklc2rBORNfixyRfVfw ($43.05 in chips) 
Seat 8: uhrboV251dcgYniYTdFIcA ($25 in chips) 
Seat 9: W2YYHvqjaEpRrO7stZkClQ ($5.55 in chips) 
W2YYHvqjaEpRrO7stZkClQ: posts small blind $0.10
+C3eP/ysyROWbEXJFPswVA: is sitting out 
+C3eP/ysyROWbEXJFPswVA leaves the table
clJsV3v77RS07bDKY+705w: posts big blind $0.25
*** HOLE CARDS ***
egvg3mTBBVzMHnJPIQiKcA: calls $0.25
k+2r6di6GXjNpAdrRkW9bA: folds 
v1BVHNGLbP/nx7QO6K7+Jw: folds 
gO1uiTGTzn5Cd3PECuws1g: folds 
4awUyiDYTgylQKXZ9faBVA joins the table at seat #1 
tLcDklc2rBORNfixyRfVfw: folds 
uhrboV251dcgYniYTdFIcA: calls $0.25
W2YYHvqjaEpRrO7stZkClQ: calls $0.15
clJsV3v77RS07bDKY+705w: checks 
*** FLOP *** [9s Qc 6s]
W2YYHvqjaEpRrO7stZkClQ: checks 
clJsV3v77RS07bDKY+705w: bets $0.50
egvg3mTBBVzMHnJPIQiKcA: folds 
uhrboV251dcgYniYTdFIcA: calls $0.50
W2YYHvqjaEpRrO7stZkClQ: folds 
*** TURN *** [9s Qc 6s] [3h]
clJsV3v77RS07bDKY+705w: bets $1.25
uhrboV251dcgYniYTdFIcA: folds 
Uncalled bet ($1.25) returned to clJsV3v77RS07bDKY+705w
clJsV3v77RS07bDKY+705w collected $1.95 from pot
clJsV3v77RS07bDKY+705w: doesn't show hand 
*** SUMMARY ***
Total pot $2 | Rake $0.05 
Board [9s Qc 6s 3h]
Seat 2: clJsV3v77RS07bDKY+705w (big blind) collected ($1.95)
Seat 3: egvg3mTBBVzMHnJPIQiKcA folded on the Flop
Seat 4: k+2r6di6GXjNpAdrRkW9bA folded before Flop (didn't bet)
Seat 5: v1BVHNGLbP/nx7QO6K7+Jw folded before Flop (didn't bet)
Seat 6: gO1uiTGTzn5Cd3PECuws1g folded before Flop (didn't bet)
Seat 7: tLcDklc2rBORNfixyRfVfw folded before Flop (didn't bet)
Seat 8: uhrboV251dcgYniYTdFIcA (button) folded on the Turn
Seat 9: W2YYHvqjaEpRrO7stZkClQ (small blind) folded on the Flop




PokerStars Game #59941828686:  Hold'em No Limit ($0.10/$0.25) - 2009/07/01 1:47:27 ET
Table 'vFZR6Kf2Th5xBXT9brGW6A' 6-max Seat #4 is the button
Seat 2: QiL+lEgEWwy21jk/ltaRLg ($21.30 in chips) 
Seat 3: SH1WjKVUjPiyXySjWSdazw ($40.50 in chips) 
Seat 4: 79ID/ub1Pt/mDpCprVmOoA ($34.85 in chips) 
Seat 5: SS/yfeArhULzIcOPe8MdPg ($27.10 in chips) 
Seat 6: 4x9jCqgSw4272dnaIqnanw ($10.90 in chips) 
SS/yfeArhULzIcOPe8MdPg: posts small blind $0.10
4x9jCqgSw4272dnaIqnanw: posts big blind $0.25
Q1uciOZPBR/WkAlqa6cL4A: sits out 
*** HOLE CARDS ***
QiL+lEgEWwy21jk/ltaRLg: folds 
SH1WjKVUjPiyXySjWSdazw: raises $0.50 to $0.75
79ID/ub1Pt/mDpCprVmOoA: folds 
SS/yfeArhULzIcOPe8MdPg: folds 
4x9jCqgSw4272dnaIqnanw: folds 
Uncalled bet ($0.50) returned to SH1WjKVUjPiyXySjWSdazw
SH1WjKVUjPiyXySjWSdazw collected $0.60 from pot
SH1WjKVUjPiyXySjWSdazw: doesn't show hand 
*** SUMMARY ***
Total pot $0.60 | Rake $0 
Seat 2: QiL+lEgEWwy21jk/ltaRLg folded before Flop (didn't bet)
Seat 3: SH1WjKVUjPiyXySjWSdazw collected ($0.60)
Seat 4: 79ID/ub1Pt/mDpCprVmOoA (button) folded before Flop (didn't bet)
Seat 5: SS/yfeArhULzIcOPe8MdPg (small blind) folded before Flop
Seat 6: 4x9jCqgSw4272dnaIqnanw (big blind) folded before Flop




PokerStars Game #59941829640:  Hold'em No Limit ($0.10/$0.25) - 2009/07/01 1:47:28 ET
Table 'Zi9/NqNs3XoL1eWhMCyZyg' 9-max Seat #8 is the button
Seat 1: X6+pSIPfovPcE87t+LmUKQ ($4.75 in chips) 
Seat 2: 1wKfgJ8xXIiuc8C6qjkxhg ($4.50 in chips) 
Seat 3: ETC7YyRJTa2Ovhln64Ni5Q ($27.75 in chips) 
Seat 4: dmYlc+1cjwZMJ7wV+Z0rRg ($23.75 in chips) 
Seat 5: JTINtdu/1/EQCVfalLD/xQ ($10.80 in chips) 
Seat 6: YQhfmYhgnDDlWCAFmBb36Q ($16.25 in chips) 
Seat 7: 0QdZrkFD7aGKeBXPGbIomA ($2.20 in chips) 
Seat 8: nm4Dj/f+jJEwKVsUnKh73g ($35.40 in chips) 
X6+pSIPfovPcE87t+LmUKQ: posts small blind $0.10
1wKfgJ8xXIiuc8C6qjkxhg: posts big blind $0.25
*** HOLE CARDS ***
ETC7YyRJTa2Ovhln64Ni5Q: folds 
dmYlc+1cjwZMJ7wV+Z0rRg: folds 
JTINtdu/1/EQCVfalLD/xQ: calls $0.25
YQhfmYhgnDDlWCAFmBb36Q: folds 
0QdZrkFD7aGKeBXPGbIomA: folds 
nm4Dj/f+jJEwKVsUnKh73g: folds 
X6+pSIPfovPcE87t+LmUKQ: calls $0.15
1wKfgJ8xXIiuc8C6qjkxhg: checks 
*** FLOP *** [As 5s 2s]
X6+pSIPfovPcE87t+LmUKQ: checks 
1wKfgJ8xXIiuc8C6qjkxhg: checks 
JTINtdu/1/EQCVfalLD/xQ: checks 
*** TURN *** [As 5s 2s] [2c]
X6+pSIPfovPcE87t+LmUKQ: checks 
1wKfgJ8xXIiuc8C6qjkxhg: bets $0.25
JTINtdu/1/EQCVfalLD/xQ: calls $0.25
X6+pSIPfovPcE87t+LmUKQ: folds 
*** RIVER *** [As 5s 2s 2c] [6c]
1wKfgJ8xXIiuc8C6qjkxhg: bets $0.50
JTINtdu/1/EQCVfalLD/xQ: folds 
Uncalled bet ($0.50) returned to 1wKfgJ8xXIiuc8C6qjkxhg
1wKfgJ8xXIiuc8C6qjkxhg collected $1.20 from pot
*** SUMMARY ***
Total pot $1.25 | Rake $0.05 
Board [As 5s 2s 2c 6c]
Seat 1: X6+pSIPfovPcE87t+LmUKQ (small blind) folded on the Turn
Seat 2: 1wKfgJ8xXIiuc8C6qjkxhg (big blind) collected ($1.20)
Seat 3: ETC7YyRJTa2Ovhln64Ni5Q folded before Flop (didn't bet)
Seat 4: dmYlc+1cjwZMJ7wV+Z0rRg folded before Flop (didn't bet)
Seat 5: JTINtdu/1/EQCVfalLD/xQ folded on the River
Seat 6: YQhfmYhgnDDlWCAFmBb36Q folded before Flop (didn't bet)
Seat 7: 0QdZrkFD7aGKeBXPGbIomA folded before Flop (didn't bet)
Seat 8: nm4Dj/f+jJEwKVsUnKh73g (button) folded before Flop (didn't bet)




PokerStars Game #59941829564:  Hold'em No Limit ($0.10/$0.25) - 2009/07/01 1:47:28 ET
Table 'nyTW9cVtYentc5V7xU/0jA' 6-max Seat #5 is the button
Seat 1: HI20pVxSHPZ29u9IDkmICg ($12.90 in chips) 
Seat 2: v6mkGzCBCCXcgWQNSYVtKg ($8.55 in chips) 
Seat 3: kG34n23qFQA3nzdOJTQ1dA ($35.75 in chips) 
Seat 4: NkB3D4eVHHXvB9Edaugc1Q ($32.20 in chips) 
Seat 5: zZAcuQ0EvirdEuiIbeaocQ ($3.60 in chips) 
thomefan251 will be allowed to play after the button
HI20pVxSHPZ29u9IDkmICg: posts small blind $0.10
v6mkGzCBCCXcgWQNSYVtKg: posts big blind $0.25
*** HOLE CARDS ***
kG34n23qFQA3nzdOJTQ1dA: folds 
NkB3D4eVHHXvB9Edaugc1Q: raises $0.50 to $0.75
zZAcuQ0EvirdEuiIbeaocQ: folds 
HI20pVxSHPZ29u9IDkmICg: calls $0.65
v6mkGzCBCCXcgWQNSYVtKg: folds 
*** FLOP *** [5c 6h Ah]
HI20pVxSHPZ29u9IDkmICg: checks 
NkB3D4eVHHXvB9Edaugc1Q: bets $0.75
HI20pVxSHPZ29u9IDkmICg: folds 
Uncalled bet ($0.75) returned to NkB3D4eVHHXvB9Edaugc1Q
NkB3D4eVHHXvB9Edaugc1Q collected $1.70 from pot
NkB3D4eVHHXvB9Edaugc1Q: doesn't show hand 
*** SUMMARY ***
Total pot $1.75 | Rake $0.05 
Board [5c 6h Ah]
Seat 1: HI20pVxSHPZ29u9IDkmICg (small blind) folded on the Flop
Seat 2: v6mkGzCBCCXcgWQNSYVtKg (big blind) folded before Flop
Seat 3: kG34n23qFQA3nzdOJTQ1dA folded before Flop (didn't bet)
Seat 4: NkB3D4eVHHXvB9Edaugc1Q collected ($1.70)
Seat 5: zZAcuQ0EvirdEuiIbeaocQ (button) folded before Flop (didn't bet)




PokerStars Game #59941829314:  Hold'em No Limit ($0.10/$0.25) - 2009/07/01 1:47:28 ET
Table 'AJGgX1ZYM8d68SWMvaLttg' 6-max Seat #4 is the button
Seat 1: Q1uciOZPBR/WkAlqa6cL4A ($25 in chips) 
Seat 2: zHHLkD2sRljslKKeQv/ZQw ($17.70 in chips) 
Seat 3: 8ClCHtFXGNplITm+63KB+Q ($38.70 in chips) 
Seat 4: e30C3DfdG5TfPnR16/oMmA ($19.80 in chips) 
Seat 5: Hsvkc0/G2VV78oVmWYXecw ($5 in chips) 
Hsvkc0/G2VV78oVmWYXecw: posts small blind $0.10
Q1uciOZPBR/WkAlqa6cL4A: posts big blind $0.25
*** HOLE CARDS ***
zHHLkD2sRljslKKeQv/ZQw: folds 
UA5OsKS3VPaxa7uC8La/kA has returned
8ClCHtFXGNplITm+63KB+Q: folds 
e30C3DfdG5TfPnR16/oMmA: raises $0.25 to $0.50
Hsvkc0/G2VV78oVmWYXecw: folds 
Q1uciOZPBR/WkAlqa6cL4A: calls $0.25
*** FLOP *** [Td Jh Ks]
Q1uciOZPBR/WkAlqa6cL4A: checks 
e30C3DfdG5TfPnR16/oMmA: bets $0.75
Q1uciOZPBR/WkAlqa6cL4A: folds 
Uncalled bet ($0.75) returned to e30C3DfdG5TfPnR16/oMmA
e30C3DfdG5TfPnR16/oMmA collected $1.05 from pot
*** SUMMARY ***
Total pot $1.10 | Rake $0.05 
Board [Td Jh Ks]
Seat 1: Q1uciOZPBR/WkAlqa6cL4A (big blind) folded on the Flop
Seat 2: zHHLkD2sRljslKKeQv/ZQw folded before Flop (didn't bet)
Seat 3: 8ClCHtFXGNplITm+63KB+Q folded before Flop (didn't bet)
Seat 4: e30C3DfdG5TfPnR16/oMmA (button) collected ($1.05)
Seat 5: Hsvkc0/G2VV78oVmWYXecw (small blind) folded before Flop




PokerStars Game #59941829478:  Hold'em No Limit ($0.10/$0.25) - 2009/07/01 1:47:28 ET
Table 'nXVbUw6/HYwA6x21+IZ3XQ' 9-max Seat #4 is the button
Seat 1: zDrucyjVn5aeekNEc3cJrA ($16.75 in chips) 
Seat 2: 9lvO/qyU+xrU95Teu1fv0g ($10.25 in chips) 
Seat 3: MB0wa15P+9QHcBApEdgQFw ($9.65 in chips) 
Seat 4: SpiiQQAzy4MUgV3I5W8giw ($24.65 in chips) 
Seat 5: M/9j4wkHH9i1JM51vgi1VA ($31.70 in chips) 
Seat 6: ljemhp25Zg+nlA9DLCIiUw ($27.20 in chips) 
Seat 7: ShCS62CJp4MKfKLKvGKQbA ($11.60 in chips) 
Seat 8: dfNim92Z6XK1/h5SFW5vDg ($25 in chips) 
Seat 9: OTCjTlu92MEBtX/i9Gm7yA ($11.60 in chips) 
M/9j4wkHH9i1JM51vgi1VA: posts small blind $0.10
ljemhp25Zg+nlA9DLCIiUw: posts big blind $0.25
*** HOLE CARDS ***
ShCS62CJp4MKfKLKvGKQbA: folds 
dfNim92Z6XK1/h5SFW5vDg: folds 
OTCjTlu92MEBtX/i9Gm7yA: calls $0.25
zDrucyjVn5aeekNEc3cJrA: folds 
9lvO/qyU+xrU95Teu1fv0g: folds 
MB0wa15P+9QHcBApEdgQFw: raises $0.50 to $0.75
SpiiQQAzy4MUgV3I5W8giw: folds 
M/9j4wkHH9i1JM51vgi1VA: folds 
ljemhp25Zg+nlA9DLCIiUw: folds 
OTCjTlu92MEBtX/i9Gm7yA: calls $0.50
*** FLOP *** [Kh 5s Ah]
OTCjTlu92MEBtX/i9Gm7yA: checks 
MB0wa15P+9QHcBApEdgQFw: bets $1
OTCjTlu92MEBtX/i9Gm7yA: calls $1
*** TURN *** [Kh 5s Ah] [Qc]
OTCjTlu92MEBtX/i9Gm7yA: checks 
MB0wa15P+9QHcBApEdgQFw: bets $1.75
OTCjTlu92MEBtX/i9Gm7yA: folds 
Uncalled bet ($1.75) returned to MB0wa15P+9QHcBApEdgQFw
MB0wa15P+9QHcBApEdgQFw collected $3.70 from pot
MB0wa15P+9QHcBApEdgQFw: doesn't show hand 
*** SUMMARY ***
Total pot $3.85 | Rake $0.15 
Board [Kh 5s Ah Qc]
Seat 1: zDrucyjVn5aeekNEc3cJrA folded before Flop (didn't bet)
Seat 2: 9lvO/qyU+xrU95Teu1fv0g folded before Flop (didn't bet)
Seat 3: MB0wa15P+9QHcBApEdgQFw collected ($3.70)
Seat 4: SpiiQQAzy4MUgV3I5W8giw (button) folded before Flop (didn't bet)
Seat 5: M/9j4wkHH9i1JM51vgi1VA (small blind) folded before Flop
Seat 6: ljemhp25Zg+nlA9DLCIiUw (big blind) folded before Flop
Seat 7: ShCS62CJp4MKfKLKvGKQbA folded before Flop (didn't bet)
Seat 8: dfNim92Z6XK1/h5SFW5vDg folded before Flop (didn't bet)
Seat 9: OTCjTlu92MEBtX/i9Gm7yA folded on the Turn




PokerStars Game #59941829324:  Hold'em No Limit ($0.10/$0.25) - 2009/07/01 1:47:28 ET
Table 'CM/C/FZf3VHIp50RjmBucQ' 9-max Seat #5 is the button
Seat 1: P8h+GtgJJRwRh2YdssBtbg ($4.75 in chips) 
Seat 2: +aNWwNic2LVhXcMqH+ezrA ($15.40 in chips) 
Seat 3: HPEB+AtKw1+C/cxU0o1ciw ($54.45 in chips) 
Seat 4: FYIiLXWy4mKC5ZGa/fnS0g ($15.65 in chips) 
Seat 5: t3m1RlE+8m1yb0ojo8ikCw ($13.90 in chips) 
Seat 6: FqpibuVWLNsAN/Z7ROZLnA ($5.15 in chips) 
Seat 7: +T7KwHtNiHQt6JhQegSH/w ($5 in chips) 
FqpibuVWLNsAN/Z7ROZLnA: posts small blind $0.10
+T7KwHtNiHQt6JhQegSH/w: posts big blind $0.25
SlimQuinn: sits out 
*** HOLE CARDS ***
P8h+GtgJJRwRh2YdssBtbg: folds 
W6tExOcYX7qiy6Qdp+ZwFA joins the table at seat #9 
+aNWwNic2LVhXcMqH+ezrA: calls $0.25
HPEB+AtKw1+C/cxU0o1ciw: folds 
FYIiLXWy4mKC5ZGa/fnS0g: folds 
t3m1RlE+8m1yb0ojo8ikCw: calls $0.25
FqpibuVWLNsAN/Z7ROZLnA: raises $0.25 to $0.50
+T7KwHtNiHQt6JhQegSH/w: calls $0.25
+aNWwNic2LVhXcMqH+ezrA: calls $0.25
t3m1RlE+8m1yb0ojo8ikCw: calls $0.25
*** FLOP *** [4h 9s 7c]
FqpibuVWLNsAN/Z7ROZLnA: bets $4.65 and is all-in
+T7KwHtNiHQt6JhQegSH/w: folds 
+aNWwNic2LVhXcMqH+ezrA: folds 
t3m1RlE+8m1yb0ojo8ikCw: folds 
Uncalled bet ($4.65) returned to FqpibuVWLNsAN/Z7ROZLnA
FqpibuVWLNsAN/Z7ROZLnA collected $1.90 from pot
FqpibuVWLNsAN/Z7ROZLnA: doesn't show hand 
*** SUMMARY ***
Total pot $2 | Rake $0.10 
Board [4h 9s 7c]
Seat 1: P8h+GtgJJRwRh2YdssBtbg folded before Flop (didn't bet)
Seat 2: +aNWwNic2LVhXcMqH+ezrA folded on the Flop
Seat 3: HPEB+AtKw1+C/cxU0o1ciw folded before Flop (didn't bet)
Seat 4: FYIiLXWy4mKC5ZGa/fnS0g folded before Flop (didn't bet)
Seat 5: t3m1RlE+8m1yb0ojo8ikCw (button) folded on the Flop
Seat 6: FqpibuVWLNsAN/Z7ROZLnA (small blind) collected ($1.90)
Seat 7: +T7KwHtNiHQt6JhQegSH/w (big blind) folded on the Flop




PokerStars Game #59941829270:  Hold'em No Limit ($0.10/$0.25) - 2009/07/01 1:47:28 ET
Table 'XX2OuOsa8/8AC+/mR/Az6g' 9-max Seat #8 is the button
Seat 1: 56S3mA6Zs3pGR+0p0vUCtg ($24.40 in chips) 
Seat 2: Bb42QRQMhg5/Y0vHP8/2Xw ($26.85 in chips) 
Seat 3: oLa/tXLfSLLB28mcLGrxcg ($24.60 in chips) 
Seat 5: SpiiQQAzy4MUgV3I5W8giw ($21.15 in chips) 
Seat 6: RCqMONFrSPSArZh2Jsar/w ($20.20 in chips) 
Seat 8: qwr38jl5txoR36M7G5qi4A ($10 in chips) 
Seat 9: V6p0jQ/RhUsqpHLmXvEX4Q ($12.10 in chips) 
V6p0jQ/RhUsqpHLmXvEX4Q: posts small blind $0.10
56S3mA6Zs3pGR+0p0vUCtg: posts big blind $0.25
*** HOLE CARDS ***
Bb42QRQMhg5/Y0vHP8/2Xw: folds 
oLa/tXLfSLLB28mcLGrxcg: folds 
SpiiQQAzy4MUgV3I5W8giw: folds 
RCqMONFrSPSArZh2Jsar/w: folds 
qwr38jl5txoR36M7G5qi4A: folds 
V6p0jQ/RhUsqpHLmXvEX4Q: folds 
Uncalled bet ($0.15) returned to 56S3mA6Zs3pGR+0p0vUCtg
56S3mA6Zs3pGR+0p0vUCtg collected $0.20 from pot
56S3mA6Zs3pGR+0p0vUCtg: doesn't show hand 
*** SUMMARY ***
Total pot $0.20 | Rake $0 
Seat 1: 56S3mA6Zs3pGR+0p0vUCtg (big blind) collected ($0.20)
Seat 2: Bb42QRQMhg5/Y0vHP8/2Xw folded before Flop (didn't bet)
Seat 3: oLa/tXLfSLLB28mcLGrxcg folded before Flop (didn't bet)
Seat 5: SpiiQQAzy4MUgV3I5W8giw folded before Flop (didn't bet)
Seat 6: RCqMONFrSPSArZh2Jsar/w folded before Flop (didn't bet)
Seat 8: qwr38jl5txoR36M7G5qi4A (button) folded before Flop (didn't bet)
Seat 9: V6p0jQ/RhUsqpHLmXvEX4Q (small blind) folded before Flop




PokerStars Game #59941829482:  Hold'em No Limit ($0.10/$0.25) - 2009/07/01 1:47:28 ET
Table '8PD/MTROSMd6Y8mZeykbpg' 6-max Seat #3 is the button
Seat 1: fxNpaToxECtD2Goelmg9vA ($28.85 in chips) 
Seat 2: 4TM16KVgEiQpLi4bVVWbVQ ($24.80 in chips) 
Seat 3: vqWjZmdQu/Hxw96/IJTWdQ ($25 in chips) 
Seat 4: DFi/Lzkjsfv8QswS80JX9Q ($53.45 in chips) 
Seat 5: z3tQwy28dp5FykDJC/wzQw ($26.55 in chips) 
Seat 6: trN/oHqTTbPw5MNuKrOpLw ($25 in chips) 
DFi/Lzkjsfv8QswS80JX9Q: posts small blind $0.10
z3tQwy28dp5FykDJC/wzQw: posts big blind $0.25
*** HOLE CARDS ***
trN/oHqTTbPw5MNuKrOpLw: folds 
fxNpaToxECtD2Goelmg9vA: folds 
4TM16KVgEiQpLi4bVVWbVQ: raises $0.75 to $1
vqWjZmdQu/Hxw96/IJTWdQ: folds 
DFi/Lzkjsfv8QswS80JX9Q: folds 
z3tQwy28dp5FykDJC/wzQw: folds 
Uncalled bet ($0.75) returned to 4TM16KVgEiQpLi4bVVWbVQ
4TM16KVgEiQpLi4bVVWbVQ collected $0.60 from pot
*** SUMMARY ***
Total pot $0.60 | Rake $0 
Seat 1: fxNpaToxECtD2Goelmg9vA folded before Flop (didn't bet)
Seat 2: 4TM16KVgEiQpLi4bVVWbVQ collected ($0.60)
Seat 3: vqWjZmdQu/Hxw96/IJTWdQ (button) folded before Flop (didn't bet)
Seat 4: DFi/Lzkjsfv8QswS80JX9Q (small blind) folded before Flop
Seat 5: z3tQwy28dp5FykDJC/wzQw (big blind) folded before Flop
Seat 6: trN/oHqTTbPw5MNuKrOpLw folded before Flop (didn't bet)




PokerStars Game #59941829616:  Hold'em No Limit ($0.10/$0.25) - 2009/07/01 1:47:28 ET
Table 'QegsWX65l3n/K0A8XB78yg' 6-max Seat #1 is the button
Seat 1: p6adJRMXMBLr+xtQzqazIQ ($16.25 in chips) 
Seat 2: GC/9yVD59DUCX7hUI7gcLw ($57.10 in chips) 
Seat 3: iIgNoBh+3/Ix1/fLsg+HuA ($6 in chips) 
Seat 4: epAUIB7h2FJXzUPRIvSkRA ($25 in chips) 
Seat 5: QqiZLFrN8iOUT/GHw7ztOA ($24.65 in chips) 
Seat 6: 5PWs02z65jSO5pr/M6wx/w ($6.45 in chips) 
GC/9yVD59DUCX7hUI7gcLw: posts small blind $0.10
iIgNoBh+3/Ix1/fLsg+HuA: posts big blind $0.25
*** HOLE CARDS ***
epAUIB7h2FJXzUPRIvSkRA: folds 
QqiZLFrN8iOUT/GHw7ztOA: raises $0.50 to $0.75
5PWs02z65jSO5pr/M6wx/w: folds 
p6adJRMXMBLr+xtQzqazIQ: calls $0.75
GC/9yVD59DUCX7hUI7gcLw: folds 
iIgNoBh+3/Ix1/fLsg+HuA: folds 
*** FLOP *** [9c Kh 4c]
QqiZLFrN8iOUT/GHw7ztOA: bets $1.50
p6adJRMXMBLr+xtQzqazIQ: calls $1.50
*** TURN *** [9c Kh 4c] [Kd]
QqiZLFrN8iOUT/GHw7ztOA: checks 
p6adJRMXMBLr+xtQzqazIQ: bets $2.50
QqiZLFrN8iOUT/GHw7ztOA: calls $2.50
*** RIVER *** [9c Kh 4c Kd] [2h]
QqiZLFrN8iOUT/GHw7ztOA: checks 
p6adJRMXMBLr+xtQzqazIQ: checks 
*** SHOW DOWN ***
QqiZLFrN8iOUT/GHw7ztOA: shows [Kc Jc] (three of a kind, Kings)
p6adJRMXMBLr+xtQzqazIQ: mucks hand 
QqiZLFrN8iOUT/GHw7ztOA collected $9.40 from pot
*** SUMMARY ***
Total pot $9.85 | Rake $0.45 
Board [9c Kh 4c Kd 2h]
Seat 1: p6adJRMXMBLr+xtQzqazIQ (button) mucked
Seat 2: GC/9yVD59DUCX7hUI7gcLw (small blind) folded before Flop
Seat 3: iIgNoBh+3/Ix1/fLsg+HuA (big blind) folded before Flop
Seat 4: epAUIB7h2FJXzUPRIvSkRA folded before Flop (didn't bet)
Seat 5: QqiZLFrN8iOUT/GHw7ztOA showed [Kc Jc] and won ($9.40) with three of a kind, Kings
Seat 6: 5PWs02z65jSO5pr/M6wx/w folded before Flop (didn't bet)




PokerStars Game #59941829452:  Hold'em No Limit ($0.10/$0.25) - 2009/07/01 1:47:28 ET
Table '9o8Yb3JpUqurD4pNVmOikQ' 6-max Seat #4 is the button
Seat 1: SFmT9ZsVopnukjvAzrxTRg ($27.55 in chips) 
Seat 2: /gJNBeCkWL4o85/jvlZ4BA ($25.25 in chips) 
Seat 3: JgRqo1/2phbf7pab7N3BIQ ($23.50 in chips) 
Seat 4: j5NZbEJHsERuXjPHWqc1Nw ($11.35 in chips) 
Seat 5: QqiZLFrN8iOUT/GHw7ztOA ($23.90 in chips) 
Seat 6: LyDHtw3/yniNHW+DvLXbog ($25.70 in chips) 
QqiZLFrN8iOUT/GHw7ztOA: posts small blind $0.10
LyDHtw3/yniNHW+DvLXbog: posts big blind $0.25
*** HOLE CARDS ***
SFmT9ZsVopnukjvAzrxTRg: folds 
/gJNBeCkWL4o85/jvlZ4BA: raises $0.75 to $1
JgRqo1/2phbf7pab7N3BIQ: folds 
j5NZbEJHsERuXjPHWqc1Nw: calls $1
QqiZLFrN8iOUT/GHw7ztOA: folds 
LyDHtw3/yniNHW+DvLXbog: folds 
*** FLOP *** [Qh 2h 4d]
/gJNBeCkWL4o85/jvlZ4BA: bets $1.75
j5NZbEJHsERuXjPHWqc1Nw: folds 
Uncalled bet ($1.75) returned to /gJNBeCkWL4o85/jvlZ4BA
/gJNBeCkWL4o85/jvlZ4BA collected $2.25 from pot
*** SUMMARY ***
Total pot $2.35 | Rake $0.10 
Board [Qh 2h 4d]
Seat 1: SFmT9ZsVopnukjvAzrxTRg folded before Flop (didn't bet)
Seat 2: /gJNBeCkWL4o85/jvlZ4BA collected ($2.25)
Seat 3: JgRqo1/2phbf7pab7N3BIQ folded before Flop (didn't bet)
Seat 4: j5NZbEJHsERuXjPHWqc1Nw (button) folded on the Flop
Seat 5: QqiZLFrN8iOUT/GHw7ztOA (small blind) folded before Flop
Seat 6: LyDHtw3/yniNHW+DvLXbog (big blind) folded before Flop




PokerStars Game #59941829732:  Hold'em No Limit ($0.10/$0.25) - 2009/07/01 1:47:29 ET
Table 'nlpa8xI95gAflovnFxB2yg' 6-max Seat #4 is the button
Seat 1: fZQg9veL7Dd/Z04ZTjC+wQ ($61.80 in chips) 
Seat 2: Yuyy/pDz3yAO3EbHYRYnKw ($24.15 in chips) 
Seat 3: DihMHaz4WNETH1bPDe13kA ($25 in chips) 
Seat 4: if4dh6jhJXeN3/qd3qCp9g ($52 in chips) 
Seat 5: FDWzjQgBA5K04jOIY/j22w ($6.50 in chips) 
Seat 6: ATNFxN8fYVfSZMQW8dvbvw ($5.65 in chips) 
FDWzjQgBA5K04jOIY/j22w: posts small blind $0.10
ATNFxN8fYVfSZMQW8dvbvw: posts big blind $0.25
*** HOLE CARDS ***
fZQg9veL7Dd/Z04ZTjC+wQ: folds 
Yuyy/pDz3yAO3EbHYRYnKw: folds 
DihMHaz4WNETH1bPDe13kA: folds 
if4dh6jhJXeN3/qd3qCp9g: folds 
FDWzjQgBA5K04jOIY/j22w: folds 
Uncalled bet ($0.15) returned to ATNFxN8fYVfSZMQW8dvbvw
ATNFxN8fYVfSZMQW8dvbvw collected $0.20 from pot
ATNFxN8fYVfSZMQW8dvbvw: doesn't show hand 
*** SUMMARY ***
Total pot $0.20 | Rake $0 
Seat 1: fZQg9veL7Dd/Z04ZTjC+wQ folded before Flop (didn't bet)
Seat 2: Yuyy/pDz3yAO3EbHYRYnKw folded before Flop (didn't bet)
Seat 3: DihMHaz4WNETH1bPDe13kA folded before Flop (didn't bet)
Seat 4: if4dh6jhJXeN3/qd3qCp9g (button) folded before Flop (didn't bet)
Seat 5: FDWzjQgBA5K04jOIY/j22w (small blind) folded before Flop
Seat 6: ATNFxN8fYVfSZMQW8dvbvw (big blind) collected ($0.20)




PokerStars Game #59941829856:  Hold'em No Limit ($0.10/$0.25) - 2009/07/01 1:47:29 ET
Table 'zKwHJD0cmKNUure9qQTfFg' 6-max Seat #3 is the button
Seat 1: Hzrn9DZJegEZICufTNYkrg ($19.10 in chips) 
Seat 2: xrf8tAXKQHG99HixCot1Iw ($25 in chips) 
Seat 3: m9aw7LBAB5YX2ZqMtMkhqA ($14.25 in chips) 
Seat 4: v+QfkGiuj9bgtuNoVnDO8w ($25.20 in chips) 
Seat 5: E4AqQ1egsnu0oH2RqsbCmQ ($5 in chips) 
Seat 6: edio/rLJ06xeZOfLhoL3UA ($9.60 in chips) 
v+QfkGiuj9bgtuNoVnDO8w: posts small blind $0.10
E4AqQ1egsnu0oH2RqsbCmQ: posts big blind $0.25
*** HOLE CARDS ***
edio/rLJ06xeZOfLhoL3UA: raises $0.75 to $1
Hzrn9DZJegEZICufTNYkrg: folds 
xrf8tAXKQHG99HixCot1Iw: folds 
m9aw7LBAB5YX2ZqMtMkhqA: folds 
v+QfkGiuj9bgtuNoVnDO8w: calls $0.90
E4AqQ1egsnu0oH2RqsbCmQ: folds 
*** FLOP *** [Jh 4h 6d]
v+QfkGiuj9bgtuNoVnDO8w: checks 
edio/rLJ06xeZOfLhoL3UA: bets $1.25
v+QfkGiuj9bgtuNoVnDO8w: folds 
Uncalled bet ($1.25) returned to edio/rLJ06xeZOfLhoL3UA
edio/rLJ06xeZOfLhoL3UA collected $2.15 from pot
edio/rLJ06xeZOfLhoL3UA: doesn't show hand 
*** SUMMARY ***
Total pot $2.25 | Rake $0.10 
Board [Jh 4h 6d]
Seat 1: Hzrn9DZJegEZICufTNYkrg folded before Flop (didn't bet)
Seat 2: xrf8tAXKQHG99HixCot1Iw folded before Flop (didn't bet)
Seat 3: m9aw7LBAB5YX2ZqMtMkhqA (button) folded before Flop (didn't bet)
Seat 4: v+QfkGiuj9bgtuNoVnDO8w (small blind) folded on the Flop
Seat 5: E4AqQ1egsnu0oH2RqsbCmQ (big blind) folded before Flop
Seat 6: edio/rLJ06xeZOfLhoL3UA collected ($2.15)




PokerStars Game #59941829718:  Hold'em No Limit ($0.10/$0.25) - 2009/07/01 1:47:29 ET
Table 'vZfV/Uj0q8joA1du9sRJSg' 6-max Seat #4 is the button
Seat 1: Hsvkc0/G2VV78oVmWYXecw ($6.05 in chips) 
Seat 2: wMiE3yTbDJGOLOF9th7KPA ($4.25 in chips) 
Seat 3: cWc85bEzdRzpUMhRKm8pwQ ($25 in chips) 
Seat 4: v+QfkGiuj9bgtuNoVnDO8w ($43.50 in chips) 
Seat 5: kyRaCIljYA6l33lSKQfNsg ($29.80 in chips) 
Seat 6: 8ClCHtFXGNplITm+63KB+Q ($49.05 in chips) 
kyRaCIljYA6l33lSKQfNsg: posts small blind $0.10
8ClCHtFXGNplITm+63KB+Q: posts big blind $0.25
*** HOLE CARDS ***
Hsvkc0/G2VV78oVmWYXecw: folds 
wMiE3yTbDJGOLOF9th7KPA: calls $0.25
cWc85bEzdRzpUMhRKm8pwQ: folds 
v+QfkGiuj9bgtuNoVnDO8w: folds 
kyRaCIljYA6l33lSKQfNsg: calls $0.15
8ClCHtFXGNplITm+63KB+Q: checks 
*** FLOP *** [4h Td 9d]
kyRaCIljYA6l33lSKQfNsg: checks 
8ClCHtFXGNplITm+63KB+Q: checks 
wMiE3yTbDJGOLOF9th7KPA: bets $0.25
kyRaCIljYA6l33lSKQfNsg: calls $0.25
8ClCHtFXGNplITm+63KB+Q: folds 
*** TURN *** [4h Td 9d] [3c]
kyRaCIljYA6l33lSKQfNsg: checks 
wMiE3yTbDJGOLOF9th7KPA: checks 
*** RIVER *** [4h Td 9d 3c] [6s]
kyRaCIljYA6l33lSKQfNsg: checks 
wMiE3yTbDJGOLOF9th7KPA: bets $0.25
kyRaCIljYA6l33lSKQfNsg: folds 
Uncalled bet ($0.25) returned to wMiE3yTbDJGOLOF9th7KPA
wMiE3yTbDJGOLOF9th7KPA collected $1.20 from pot
wMiE3yTbDJGOLOF9th7KPA: doesn't show hand 
*** SUMMARY ***
Total pot $1.25 | Rake $0.05 
Board [4h Td 9d 3c 6s]
Seat 1: Hsvkc0/G2VV78oVmWYXecw folded before Flop (didn't bet)
Seat 2: wMiE3yTbDJGOLOF9th7KPA collected ($1.20)
Seat 3: cWc85bEzdRzpUMhRKm8pwQ folded before Flop (didn't bet)
Seat 4: v+QfkGiuj9bgtuNoVnDO8w (button) folded before Flop (didn't bet)
Seat 5: kyRaCIljYA6l33lSKQfNsg (small blind) folded on the River
Seat 6: 8ClCHtFXGNplITm+63KB+Q (big blind) folded on the Flop




PokerStars Game #59941829814:  Hold'em No Limit ($0.10/$0.25) - 2009/07/01 1:47:29 ET
Table 'Of/T60zpXg1GcjrZ7Lm//Q' 9-max Seat #8 is the button
Seat 1: Lro4e37x4FUa5P3yzDjskw ($18.20 in chips) 
Seat 2: qwr38jl5txoR36M7G5qi4A ($9.90 in chips) 
Seat 3: 6RiVTYll/5D8zICp0MRpKw ($25 in chips) 
Seat 4: Czut6V7acIqUJrrobjKAZg ($6.40 in chips) 
Seat 5: IiLkthQMEje9LS79rCFQ1Q ($21.50 in chips) 
Seat 6: tYsOBqdU1+x+yFI7zHO7hQ ($31.45 in chips) 
Seat 7: PVxvfRTRvkgZf9WtquEkwQ ($25 in chips) 
Seat 8: ghNKXUBl/H+t83JF079ZBA ($26.15 in chips) 
Seat 9: egvg3mTBBVzMHnJPIQiKcA ($15.15 in chips) 
egvg3mTBBVzMHnJPIQiKcA: posts small blind $0.10
Lro4e37x4FUa5P3yzDjskw: posts big blind $0.25
*** HOLE CARDS ***
qwr38jl5txoR36M7G5qi4A: folds 
6RiVTYll/5D8zICp0MRpKw: folds 
Czut6V7acIqUJrrobjKAZg: raises $0.75 to $1
IiLkthQMEje9LS79rCFQ1Q: calls $1
tYsOBqdU1+x+yFI7zHO7hQ: folds 
PVxvfRTRvkgZf9WtquEkwQ: folds 
ghNKXUBl/H+t83JF079ZBA: folds 
egvg3mTBBVzMHnJPIQiKcA: folds 
Lro4e37x4FUa5P3yzDjskw: folds 
*** FLOP *** [5h Jc Ad]
Czut6V7acIqUJrrobjKAZg: checks 
IiLkthQMEje9LS79rCFQ1Q: checks 
*** TURN *** [5h Jc Ad] [4d]
Czut6V7acIqUJrrobjKAZg: checks 
IiLkthQMEje9LS79rCFQ1Q: bets $1.50
Czut6V7acIqUJrrobjKAZg: folds 
Uncalled bet ($1.50) returned to IiLkthQMEje9LS79rCFQ1Q
IiLkthQMEje9LS79rCFQ1Q collected $2.25 from pot
IiLkthQMEje9LS79rCFQ1Q: shows [Ah Kd] (a pair of Aces)
*** SUMMARY ***
Total pot $2.35 | Rake $0.10 
Board [5h Jc Ad 4d]
Seat 1: Lro4e37x4FUa5P3yzDjskw (big blind) folded before Flop
Seat 2: qwr38jl5txoR36M7G5qi4A folded before Flop (didn't bet)
Seat 3: 6RiVTYll/5D8zICp0MRpKw folded before Flop (didn't bet)
Seat 4: Czut6V7acIqUJrrobjKAZg folded on the Turn
Seat 5: IiLkthQMEje9LS79rCFQ1Q collected ($2.25)
Seat 6: tYsOBqdU1+x+yFI7zHO7hQ folded before Flop (didn't bet)
Seat 7: PVxvfRTRvkgZf9WtquEkwQ folded before Flop (didn't bet)
Seat 8: ghNKXUBl/H+t83JF079ZBA (button) folded before Flop (didn't bet)
Seat 9: egvg3mTBBVzMHnJPIQiKcA (small blind) folded before Flop




PokerStars Game #59941829724:  Hold'em No Limit ($0.10/$0.25) - 2009/07/01 1:47:29 ET
Table '9SExUHslNkrPJ4XsrePaVw' 9-max Seat #4 is the button
Seat 1: RHqgdFvufLCYe54+qd2gcA ($4.50 in chips) 
Seat 2: cZ99hugmLBj9KhTlc8nCSw ($43.75 in chips) 
Seat 3: EP17SQz/iWcuYdNOGeBgkw ($13.80 in chips) 
Seat 4: 4awUyiDYTgylQKXZ9faBVA ($25 in chips) 
Seat 5: L+eJnUyhY8bMNYw755K8XQ ($15.50 in chips) 
Seat 6: YPJ90cgNXDABdYJcqmwB0A ($20.95 in chips) 
Seat 7: 7cv+9Zc9HIQHNvYsMfV3uA ($28.20 in chips) 
Seat 8: tLcDklc2rBORNfixyRfVfw ($25.35 in chips) 
Seat 9: /THNzAxdv2lBxcf4XTj/0g ($9.35 in chips) 
L+eJnUyhY8bMNYw755K8XQ: posts small blind $0.10
YPJ90cgNXDABdYJcqmwB0A: posts big blind $0.25
*** HOLE CARDS ***
7cv+9Zc9HIQHNvYsMfV3uA: folds 
7cv+9Zc9HIQHNvYsMfV3uA leaves the table
tLcDklc2rBORNfixyRfVfw: folds 
/THNzAxdv2lBxcf4XTj/0g: folds 
RHqgdFvufLCYe54+qd2gcA: folds 
cZ99hugmLBj9KhTlc8nCSw: raises $0.50 to $0.75
EP17SQz/iWcuYdNOGeBgkw: folds 
4awUyiDYTgylQKXZ9faBVA: folds 
L+eJnUyhY8bMNYw755K8XQ: folds 
YPJ90cgNXDABdYJcqmwB0A: folds 
Uncalled bet ($0.50) returned to cZ99hugmLBj9KhTlc8nCSw
cZ99hugmLBj9KhTlc8nCSw collected $0.60 from pot
*** SUMMARY ***
Total pot $0.60 | Rake $0 
Seat 1: RHqgdFvufLCYe54+qd2gcA folded before Flop (didn't bet)
Seat 2: cZ99hugmLBj9KhTlc8nCSw collected ($0.60)
Seat 3: EP17SQz/iWcuYdNOGeBgkw folded before Flop (didn't bet)
Seat 4: 4awUyiDYTgylQKXZ9faBVA (button) folded before Flop (didn't bet)
Seat 5: L+eJnUyhY8bMNYw755K8XQ (small blind) folded before Flop
Seat 6: YPJ90cgNXDABdYJcqmwB0A (big blind) folded before Flop
Seat 7: 7cv+9Zc9HIQHNvYsMfV3uA folded before Flop (didn't bet)
Seat 8: tLcDklc2rBORNfixyRfVfw folded before Flop (didn't bet)
Seat 9: /THNzAxdv2lBxcf4XTj/0g folded before Flop (didn't bet)




PokerStars Game #59941829820:  Hold'em No Limit ($0.10/$0.25) - 2009/07/01 1:47:29 ET
Table 'h02LhQ7B/Zk4ETRxxHhGYA' 9-max Seat #2 is the button
Seat 1: sD+TKtt36XiiN6jqHiLwDA ($25 in chips) 
Seat 2: 9lvO/qyU+xrU95Teu1fv0g ($7.05 in chips) 
Seat 3: arxNSjreDRGFg13EAM2F1w ($30.65 in chips) 
Seat 5: cUxk0Jk4lrUQv9CJl0LPlg ($27.75 in chips) 
Seat 6: UvM6sxFT7el5hVDehvWvTA ($31.20 in chips) 
Seat 7: y7w8+Oqq4SkI1dkRDCx2Zg ($3.50 in chips) 
Seat 8: mUoFJKqCzIUABvOFbiINlQ ($14.25 in chips) 
Seat 9: HcU1ud5gMXGuhN1QChAhfQ ($24.75 in chips) 
arxNSjreDRGFg13EAM2F1w: posts small blind $0.10
tYsOBqdU1+x+yFI7zHO7hQ: is sitting out 
cUxk0Jk4lrUQv9CJl0LPlg: posts big blind $0.25
*** HOLE CARDS ***
tYsOBqdU1+x+yFI7zHO7hQ leaves the table
UvM6sxFT7el5hVDehvWvTA: folds 
y7w8+Oqq4SkI1dkRDCx2Zg: folds 
mUoFJKqCzIUABvOFbiINlQ: folds 
HcU1ud5gMXGuhN1QChAhfQ: folds 
sD+TKtt36XiiN6jqHiLwDA: calls $0.25
9lvO/qyU+xrU95Teu1fv0g: folds 
arxNSjreDRGFg13EAM2F1w: calls $0.15
cUxk0Jk4lrUQv9CJl0LPlg: checks 
*** FLOP *** [Th 5c 4c]
arxNSjreDRGFg13EAM2F1w: checks 
cUxk0Jk4lrUQv9CJl0LPlg: checks 
sD+TKtt36XiiN6jqHiLwDA: checks 
*** TURN *** [Th 5c 4c] [7d]
arxNSjreDRGFg13EAM2F1w: checks 
cUxk0Jk4lrUQv9CJl0LPlg: checks 
sD+TKtt36XiiN6jqHiLwDA: checks 
*** RIVER *** [Th 5c 4c 7d] [2h]
arxNSjreDRGFg13EAM2F1w: checks 
cUxk0Jk4lrUQv9CJl0LPlg: checks 
sD+TKtt36XiiN6jqHiLwDA: checks 
*** SHOW DOWN ***
arxNSjreDRGFg13EAM2F1w: shows [Js Ah] (high card Ace)
cUxk0Jk4lrUQv9CJl0LPlg: shows [8s 2s] (a pair of Deuces)
sD+TKtt36XiiN6jqHiLwDA: mucks hand 
cUxk0Jk4lrUQv9CJl0LPlg collected $0.75 from pot
*** SUMMARY ***
Total pot $0.75 | Rake $0 
Board [Th 5c 4c 7d 2h]
Seat 1: sD+TKtt36XiiN6jqHiLwDA mucked
Seat 2: 9lvO/qyU+xrU95Teu1fv0g (button) folded before Flop (didn't bet)
Seat 3: arxNSjreDRGFg13EAM2F1w (small blind) showed [Js Ah] and lost with high card Ace
Seat 5: cUxk0Jk4lrUQv9CJl0LPlg (big blind) showed [8s 2s] and won ($0.75) with a pair of Deuces
Seat 6: UvM6sxFT7el5hVDehvWvTA folded before Flop (didn't bet)
Seat 7: y7w8+Oqq4SkI1dkRDCx2Zg folded before Flop (didn't bet)
Seat 8: mUoFJKqCzIUABvOFbiINlQ folded before Flop (didn't bet)
Seat 9: HcU1ud5gMXGuhN1QChAhfQ folded before Flop (didn't bet)




PokerStars Game #59941829736:  Hold'em No Limit ($0.10/$0.25) - 2009/07/01 1:47:29 ET
Table 'CBnRhp0d6E2+/NtM7Vbruw' 9-max Seat #8 is the button
Seat 1: 18G4P1XstjNvItdGUITxgw ($25 in chips) 
Seat 2: cZ99hugmLBj9KhTlc8nCSw ($26.85 in chips) 
Seat 3: aNpwfA31EREwO+ar4XzBCw ($33.70 in chips) 
Seat 5: CT7Xj/V/O5rBlhtt+RZeFQ ($25 in chips) 
Seat 6: CvL9Ch1HYCVbTsfpNucitg ($4.30 in chips) 
Seat 7: j4q3p0lesp63b1gZDwLBZw ($5 in chips) 
Seat 8: MG90wfSJZnOejs/KD3vlQQ ($25.35 in chips) 
Seat 9: xHZZRLAaFUIC8WWI8ljOJA ($29.65 in chips) 
xHZZRLAaFUIC8WWI8ljOJA: posts small blind $0.10
18G4P1XstjNvItdGUITxgw: posts big blind $0.25
*** HOLE CARDS ***
cZ99hugmLBj9KhTlc8nCSw: folds 
aNpwfA31EREwO+ar4XzBCw: raises $0.75 to $1
CT7Xj/V/O5rBlhtt+RZeFQ: folds 
CvL9Ch1HYCVbTsfpNucitg: folds 
j4q3p0lesp63b1gZDwLBZw: folds 
MG90wfSJZnOejs/KD3vlQQ: folds 
xHZZRLAaFUIC8WWI8ljOJA: folds 
18G4P1XstjNvItdGUITxgw: folds 
Uncalled bet ($0.75) returned to aNpwfA31EREwO+ar4XzBCw
aNpwfA31EREwO+ar4XzBCw collected $0.60 from pot
aNpwfA31EREwO+ar4XzBCw: doesn't show hand 
*** SUMMARY ***
Total pot $0.60 | Rake $0 
Seat 1: 18G4P1XstjNvItdGUITxgw (big blind) folded before Flop
Seat 2: cZ99hugmLBj9KhTlc8nCSw folded before Flop (didn't bet)
Seat 3: aNpwfA31EREwO+ar4XzBCw collected ($0.60)
Seat 5: CT7Xj/V/O5rBlhtt+RZeFQ folded before Flop (didn't bet)
Seat 6: CvL9Ch1HYCVbTsfpNucitg folded before Flop (didn't bet)
Seat 7: j4q3p0lesp63b1gZDwLBZw folded before Flop (didn't bet)
Seat 8: MG90wfSJZnOejs/KD3vlQQ (button) folded before Flop (didn't bet)
Seat 9: xHZZRLAaFUIC8WWI8ljOJA (small blind) folded before Flop




PokerStars Game #59941830052:  Hold'em No Limit ($0.10/$0.25) - 2009/07/01 1:47:29 ET
Table 'tq5CvS0RUqGkuBK0XTzqqg' 6-max Seat #5 is the button
Seat 1: +ZlnqPoP3Hg4BIUxDfKd/A ($30.10 in chips) 
Seat 2: 2m6ZFAdj01UZd4WtEySXXQ ($4.50 in chips) 
Seat 4: UT5XpwOH1ipkOF7n1MqDJA ($34.55 in chips) 
Seat 5: qGHGf/553gQnDoklMRe3tg ($37.65 in chips) 
Seat 6: QqiZLFrN8iOUT/GHw7ztOA ($24.75 in chips) 
QqiZLFrN8iOUT/GHw7ztOA: posts small blind $0.10
+ZlnqPoP3Hg4BIUxDfKd/A: posts big blind $0.25
08V++DOqzaNrRNsHIwi25w: sits out 
*** HOLE CARDS ***
2m6ZFAdj01UZd4WtEySXXQ: folds 
UT5XpwOH1ipkOF7n1MqDJA: folds 
qGHGf/553gQnDoklMRe3tg: folds 
QqiZLFrN8iOUT/GHw7ztOA: folds 
Uncalled bet ($0.15) returned to +ZlnqPoP3Hg4BIUxDfKd/A
+ZlnqPoP3Hg4BIUxDfKd/A collected $0.20 from pot
+ZlnqPoP3Hg4BIUxDfKd/A: doesn't show hand 
*** SUMMARY ***
Total pot $0.20 | Rake $0 
Seat 1: +ZlnqPoP3Hg4BIUxDfKd/A (big blind) collected ($0.20)
Seat 2: 2m6ZFAdj01UZd4WtEySXXQ folded before Flop (didn't bet)
Seat 4: UT5XpwOH1ipkOF7n1MqDJA folded before Flop (didn't bet)
Seat 5: qGHGf/553gQnDoklMRe3tg (button) folded before Flop (didn't bet)
Seat 6: QqiZLFrN8iOUT/GHw7ztOA (small blind) folded before Flop




PokerStars Game #59941829956:  Hold'em No Limit ($0.10/$0.25) - 2009/07/01 1:47:29 ET
Table 'fIMYcWwN4/aXFJvH5Z8Ymg' 6-max Seat #6 is the button
Seat 1: DihMHaz4WNETH1bPDe13kA ($25.10 in chips) 
Seat 2: Mhj3q7cxev+XjXZxEE6/Cw ($25.60 in chips) 
Seat 3: 9bpVv1/Qh9IYtXuCtl5VtQ ($24.65 in chips) 
Seat 5: lquriepNQBhDV5P1SWHhnA ($25.35 in chips) 
Seat 6: jp34e617tIzV8tKIWmfAbA ($28.70 in chips) 
DihMHaz4WNETH1bPDe13kA: posts small blind $0.10
Mhj3q7cxev+XjXZxEE6/Cw: posts big blind $0.25
7cx44/slbeTw+Cy7QB8Trg: sits out 
*** HOLE CARDS ***
9bpVv1/Qh9IYtXuCtl5VtQ: folds 
lquriepNQBhDV5P1SWHhnA: folds 
jp34e617tIzV8tKIWmfAbA: folds 
DihMHaz4WNETH1bPDe13kA: folds 
Uncalled bet ($0.15) returned to Mhj3q7cxev+XjXZxEE6/Cw
Mhj3q7cxev+XjXZxEE6/Cw collected $0.20 from pot
Mhj3q7cxev+XjXZxEE6/Cw: doesn't show hand 
*** SUMMARY ***
Total pot $0.20 | Rake $0 
Seat 1: DihMHaz4WNETH1bPDe13kA (small blind) folded before Flop
Seat 2: Mhj3q7cxev+XjXZxEE6/Cw (big blind) collected ($0.20)
Seat 3: 9bpVv1/Qh9IYtXuCtl5VtQ folded before Flop (didn't bet)
Seat 5: lquriepNQBhDV5P1SWHhnA folded before Flop (didn't bet)
Seat 6: jp34e617tIzV8tKIWmfAbA (button) folded before Flop (didn't bet)




PokerStars Game #59941830356:  Hold'em No Limit ($0.10/$0.25) - 2009/07/01 1:47:30 ET
Table 'KYX9dFNuOA9l2PV46IebqQ' 9-max Seat #5 is the button
Seat 1: qZqVFan2U+GAA/c5LQFbcw ($15.30 in chips) 
Seat 3: Uq3NSX4cIFaXe7pbXQuU+Q ($7.35 in chips) 
Seat 4: ly/lwri2xlF+wmFsvottuQ ($5 in chips) 
Seat 5: g7MXhRmNZxv1lIkKkUKa4w ($12.90 in chips) 
Seat 6: 4QYM+pWPc3J+6i8Zv8LvLg ($22.80 in chips) 
Seat 7: FVZtQJMz59M6BoiON/88Xg ($7.85 in chips) 
Seat 8: KRWTiGM4xH+MkvPtJz4+SA ($24.40 in chips) 
Seat 9: 6NECk10orj8iqgD3pZ2A0Q ($5 in chips) 
4QYM+pWPc3J+6i8Zv8LvLg: posts small blind $0.10
FVZtQJMz59M6BoiON/88Xg: posts big blind $0.25
ly/lwri2xlF+wmFsvottuQ: posts big blind $0.25
*** HOLE CARDS ***
KRWTiGM4xH+MkvPtJz4+SA: folds 
6NECk10orj8iqgD3pZ2A0Q: calls $0.25
qZqVFan2U+GAA/c5LQFbcw: folds 
Uq3NSX4cIFaXe7pbXQuU+Q: folds 
ly/lwri2xlF+wmFsvottuQ: checks 
g7MXhRmNZxv1lIkKkUKa4w: folds 
4QYM+pWPc3J+6i8Zv8LvLg: calls $0.15
FVZtQJMz59M6BoiON/88Xg: checks 
*** FLOP *** [Th 4c 9d]
4QYM+pWPc3J+6i8Zv8LvLg: checks 
FVZtQJMz59M6BoiON/88Xg: checks 
6NECk10orj8iqgD3pZ2A0Q: bets $0.25
ly/lwri2xlF+wmFsvottuQ: folds 
4QYM+pWPc3J+6i8Zv8LvLg: calls $0.25
FVZtQJMz59M6BoiON/88Xg: calls $0.25
*** TURN *** [Th 4c 9d] [9s]
4QYM+pWPc3J+6i8Zv8LvLg: checks 
FVZtQJMz59M6BoiON/88Xg: checks 
6NECk10orj8iqgD3pZ2A0Q: bets $0.50
4QYM+pWPc3J+6i8Zv8LvLg: folds 
FVZtQJMz59M6BoiON/88Xg: calls $0.50
*** RIVER *** [Th 4c 9d 9s] [Qd]
FVZtQJMz59M6BoiON/88Xg: checks 
6NECk10orj8iqgD3pZ2A0Q: bets $1
FVZtQJMz59M6BoiON/88Xg: folds 
Uncalled bet ($1) returned to 6NECk10orj8iqgD3pZ2A0Q
flatfoot12 joins the table at seat #2 
6NECk10orj8iqgD3pZ2A0Q collected $2.65 from pot
6NECk10orj8iqgD3pZ2A0Q: doesn't show hand 
*** SUMMARY ***
Total pot $2.75 | Rake $0.10 
Board [Th 4c 9d 9s Qd]
Seat 1: qZqVFan2U+GAA/c5LQFbcw folded before Flop (didn't bet)
Seat 3: Uq3NSX4cIFaXe7pbXQuU+Q folded before Flop (didn't bet)
Seat 4: ly/lwri2xlF+wmFsvottuQ folded on the Flop
Seat 5: g7MXhRmNZxv1lIkKkUKa4w (button) folded before Flop (didn't bet)
Seat 6: 4QYM+pWPc3J+6i8Zv8LvLg (small blind) folded on the Turn
Seat 7: FVZtQJMz59M6BoiON/88Xg (big blind) folded on the River
Seat 8: KRWTiGM4xH+MkvPtJz4+SA folded before Flop (didn't bet)
Seat 9: 6NECk10orj8iqgD3pZ2A0Q collected ($2.65)




PokerStars Game #59941830128:  Hold'em No Limit ($0.10/$0.25) - 2009/07/01 1:47:30 ET
Table 'JJzUs04lHpXg6nboT1/jeg' 6-max Seat #2 is the button
Seat 1: MqMK8OWPSY1V4stf1Hy5Jw ($37.45 in chips) 
Seat 2: jxfR29d+dK/7h7s3SvCk+g ($7 in chips) 
Seat 3: 4zXbHDe39qNX46dAo81b4w ($10.65 in chips) 
Seat 4: 7cx44/slbeTw+Cy7QB8Trg ($25 in chips) 
Seat 5: QvTX2yGq3uKJiKPmns4TKQ ($18.60 in chips) 
4zXbHDe39qNX46dAo81b4w: posts small blind $0.10
7cx44/slbeTw+Cy7QB8Trg: posts big blind $0.25
*** HOLE CARDS ***
QvTX2yGq3uKJiKPmns4TKQ: folds 
MqMK8OWPSY1V4stf1Hy5Jw: raises $0.50 to $0.75
jxfR29d+dK/7h7s3SvCk+g: raises $1 to $1.75
4zXbHDe39qNX46dAo81b4w: folds 
7cx44/slbeTw+Cy7QB8Trg: folds 
MqMK8OWPSY1V4stf1Hy5Jw: folds 
Uncalled bet ($1) returned to jxfR29d+dK/7h7s3SvCk+g
jxfR29d+dK/7h7s3SvCk+g collected $1.85 from pot
*** SUMMARY ***
Total pot $1.85 | Rake $0 
Seat 1: MqMK8OWPSY1V4stf1Hy5Jw folded before Flop
Seat 2: jxfR29d+dK/7h7s3SvCk+g (button) collected ($1.85)
Seat 3: 4zXbHDe39qNX46dAo81b4w (small blind) folded before Flop
Seat 4: 7cx44/slbeTw+Cy7QB8Trg (big blind) folded before Flop
Seat 5: QvTX2yGq3uKJiKPmns4TKQ folded before Flop (didn't bet)




PokerStars Game #59941830112:  Hold'em No Limit ($0.10/$0.25) - 2009/07/01 1:47:30 ET
Table '0M5QEJGOThqZwQ/sjbjXYw' 6-max Seat #2 is the button
Seat 2: /gJNBeCkWL4o85/jvlZ4BA ($34.25 in chips) 
Seat 3: 3zD3qLXT1bEffAoWGnc7wg ($25 in chips) 
Seat 4: oBUDUfeUyCbZBsjxHZgSiw ($22.25 in chips) 
Seat 5: cWc85bEzdRzpUMhRKm8pwQ ($33.50 in chips) 
Seat 6: bb63I02U6p9a5MNFa1gCiw ($21 in chips) 
3zD3qLXT1bEffAoWGnc7wg: posts small blind $0.10
oBUDUfeUyCbZBsjxHZgSiw: posts big blind $0.25
*** HOLE CARDS ***
cWc85bEzdRzpUMhRKm8pwQ: folds 
bb63I02U6p9a5MNFa1gCiw: folds 
/gJNBeCkWL4o85/jvlZ4BA: raises $0.75 to $1
3zD3qLXT1bEffAoWGnc7wg: folds 
oBUDUfeUyCbZBsjxHZgSiw: folds 
Uncalled bet ($0.75) returned to /gJNBeCkWL4o85/jvlZ4BA
/gJNBeCkWL4o85/jvlZ4BA collected $0.60 from pot
*** SUMMARY ***
Total pot $0.60 | Rake $0 
Seat 2: /gJNBeCkWL4o85/jvlZ4BA (button) collected ($0.60)
Seat 3: 3zD3qLXT1bEffAoWGnc7wg (small blind) folded before Flop
Seat 4: oBUDUfeUyCbZBsjxHZgSiw (big blind) folded before Flop
Seat 5: cWc85bEzdRzpUMhRKm8pwQ folded before Flop (didn't bet)
Seat 6: bb63I02U6p9a5MNFa1gCiw folded before Flop (didn't bet)




PokerStars Game #59941830218:  Hold'em No Limit ($0.10/$0.25) - 2009/07/01 1:47:30 ET
Table 'M7d9IrgQUUFFy/SZ3ksLYg' 6-max Seat #5 is the button
Seat 1: ypmjhffk/YHGc51wgVXUTw ($50.25 in chips) 
Seat 3: epAUIB7h2FJXzUPRIvSkRA ($25 in chips) 
Seat 4: 8ClCHtFXGNplITm+63KB+Q ($23.20 in chips) 
Seat 5: kMa8BltUcBQVxnHfqdCfXg ($8.25 in chips) 
ypmjhffk/YHGc51wgVXUTw: posts small blind $0.10
epAUIB7h2FJXzUPRIvSkRA: posts big blind $0.25
*** HOLE CARDS ***
8ClCHtFXGNplITm+63KB+Q: folds 
kMa8BltUcBQVxnHfqdCfXg: folds 
ypmjhffk/YHGc51wgVXUTw: folds 
Uncalled bet ($0.15) returned to epAUIB7h2FJXzUPRIvSkRA
asianthug90 joins the table at seat #2 
epAUIB7h2FJXzUPRIvSkRA collected $0.20 from pot
epAUIB7h2FJXzUPRIvSkRA: doesn't show hand 
*** SUMMARY ***
Total pot $0.20 | Rake $0 
Seat 1: ypmjhffk/YHGc51wgVXUTw (small blind) folded before Flop
Seat 3: epAUIB7h2FJXzUPRIvSkRA (big blind) collected ($0.20)
Seat 4: 8ClCHtFXGNplITm+63KB+Q folded before Flop (didn't bet)
Seat 5: kMa8BltUcBQVxnHfqdCfXg (button) folded before Flop (didn't bet)




PokerStars Game #59941830280:  Hold'em No Limit ($0.10/$0.25) - 2009/07/01 1:47:30 ET
Table '9lYs7ljXi6AgFAxYHlKLJw' 9-max Seat #8 is the button
Seat 1: K0b5wNInj6hUGRr6yzKFtw ($37.15 in chips) 
Seat 2: 0XACOSNrAWmqNv9k1nF8rw ($16.70 in chips) 
Seat 3: arxNSjreDRGFg13EAM2F1w ($33.45 in chips) 
Seat 4: UANt6y/SmDCY/jIxkBixcw ($33 in chips) 
Seat 5: dfNim92Z6XK1/h5SFW5vDg ($51.60 in chips) 
Seat 6: tYsOBqdU1+x+yFI7zHO7hQ ($25 in chips) 
Seat 7: ghNKXUBl/H+t83JF079ZBA ($28.05 in chips) 
Seat 8: 9YN2IkT2JYYKFErZtZvCtA ($18.60 in chips) 
Seat 9: cKlmpQMahVsmOaxFQDcoOg ($18.75 in chips) 
cKlmpQMahVsmOaxFQDcoOg: posts small blind $0.10
K0b5wNInj6hUGRr6yzKFtw: posts big blind $0.25
*** HOLE CARDS ***
0XACOSNrAWmqNv9k1nF8rw: folds 
arxNSjreDRGFg13EAM2F1w: folds 
UANt6y/SmDCY/jIxkBixcw: folds 
dfNim92Z6XK1/h5SFW5vDg: raises $0.75 to $1
tYsOBqdU1+x+yFI7zHO7hQ: folds 
ghNKXUBl/H+t83JF079ZBA: folds 
9YN2IkT2JYYKFErZtZvCtA: folds 
cKlmpQMahVsmOaxFQDcoOg: folds 
K0b5wNInj6hUGRr6yzKFtw: folds 
Uncalled bet ($0.75) returned to dfNim92Z6XK1/h5SFW5vDg
dfNim92Z6XK1/h5SFW5vDg collected $0.60 from pot
dfNim92Z6XK1/h5SFW5vDg: doesn't show hand 
*** SUMMARY ***
Total pot $0.60 | Rake $0 
Seat 1: K0b5wNInj6hUGRr6yzKFtw (big blind) folded before Flop
Seat 2: 0XACOSNrAWmqNv9k1nF8rw folded before Flop (didn't bet)
Seat 3: arxNSjreDRGFg13EAM2F1w folded before Flop (didn't bet)
Seat 4: UANt6y/SmDCY/jIxkBixcw folded before Flop (didn't bet)
Seat 5: dfNim92Z6XK1/h5SFW5vDg collected ($0.60)
Seat 6: tYsOBqdU1+x+yFI7zHO7hQ folded before Flop (didn't bet)
Seat 7: ghNKXUBl/H+t83JF079ZBA folded before Flop (didn't bet)
Seat 8: 9YN2IkT2JYYKFErZtZvCtA (button) folded before Flop (didn't bet)
Seat 9: cKlmpQMahVsmOaxFQDcoOg (small blind) folded before Flop




PokerStars Game #59941830632:  Hold'em No Limit ($0.10/$0.25) - 2009/07/01 1:47:30 ET
Table 'IrJPyZ3JW2iIa+krdoSbJQ' 9-max Seat #8 is the button
Seat 1: Bb42QRQMhg5/Y0vHP8/2Xw ($26.25 in chips) 
Seat 2: X78b5v/uhqeXXoAijbw/yg ($42.95 in chips) 
Seat 3: CT7Xj/V/O5rBlhtt+RZeFQ ($25 in chips) 
Seat 4: bXpVeaSTPBFSPJmeXxO7nw ($4.65 in chips) 
Seat 5: tLcDklc2rBORNfixyRfVfw ($30.30 in chips) 
Seat 6: +sbyWwIcFp9kP0bDtMegfQ ($24.60 in chips) 
Seat 7: ozqb9Z1ZOsDwxxq9IKmjUA ($10 in chips) 
Seat 8: zZqOSFjPK4R4cwx0dONetw ($14.40 in chips) 
Seat 9: Mh2r9hTeTEDnh19sRZtW3g ($9.65 in chips) 
Mh2r9hTeTEDnh19sRZtW3g: posts small blind $0.10
Bb42QRQMhg5/Y0vHP8/2Xw: posts big blind $0.25
ozqb9Z1ZOsDwxxq9IKmjUA: posts big blind $0.25
*** HOLE CARDS ***
X78b5v/uhqeXXoAijbw/yg: folds 
CT7Xj/V/O5rBlhtt+RZeFQ: folds 
bXpVeaSTPBFSPJmeXxO7nw: folds 
tLcDklc2rBORNfixyRfVfw: folds 
+sbyWwIcFp9kP0bDtMegfQ: folds 
ozqb9Z1ZOsDwxxq9IKmjUA: checks 
zZqOSFjPK4R4cwx0dONetw: calls $0.25
Mh2r9hTeTEDnh19sRZtW3g: folds 
Bb42QRQMhg5/Y0vHP8/2Xw: checks 
*** FLOP *** [3s Js Ts]
Bb42QRQMhg5/Y0vHP8/2Xw: checks 
ozqb9Z1ZOsDwxxq9IKmjUA: checks 
zZqOSFjPK4R4cwx0dONetw: bets $0.25
Bb42QRQMhg5/Y0vHP8/2Xw: folds 
ozqb9Z1ZOsDwxxq9IKmjUA: folds 
Uncalled bet ($0.25) returned to zZqOSFjPK4R4cwx0dONetw
zZqOSFjPK4R4cwx0dONetw collected $0.85 from pot
*** SUMMARY ***
Total pot $0.85 | Rake $0 
Board [3s Js Ts]
Seat 1: Bb42QRQMhg5/Y0vHP8/2Xw (big blind) folded on the Flop
Seat 2: X78b5v/uhqeXXoAijbw/yg folded before Flop (didn't bet)
Seat 3: CT7Xj/V/O5rBlhtt+RZeFQ folded before Flop (didn't bet)
Seat 4: bXpVeaSTPBFSPJmeXxO7nw folded before Flop (didn't bet)
Seat 5: tLcDklc2rBORNfixyRfVfw folded before Flop (didn't bet)
Seat 6: +sbyWwIcFp9kP0bDtMegfQ folded before Flop (didn't bet)
Seat 7: ozqb9Z1ZOsDwxxq9IKmjUA folded on the Flop
Seat 8: zZqOSFjPK4R4cwx0dONetw (button) collected ($0.85)
Seat 9: Mh2r9hTeTEDnh19sRZtW3g (small blind) folded before Flop




PokerStars Game #59941830448:  Hold'em No Limit ($0.10/$0.25) - 2009/07/01 1:47:30 ET
Table 'IuqVbFI+pwnJjvwBCGSGAw' 6-max Seat #1 is the button
Seat 1: LyDHtw3/yniNHW+DvLXbog ($28.10 in chips) 
Seat 2: w43JQj2oYPpKQVG4Yzlq1w ($25 in chips) 
Seat 3: QiL+lEgEWwy21jk/ltaRLg ($21.40 in chips) 
Seat 4: DE9hRlt14g+JdsRQ4wT7hg ($26.70 in chips) 
Seat 5: if4dh6jhJXeN3/qd3qCp9g ($24.60 in chips) 
Seat 6: xC0kaiDYM6YTlgODL83O5A ($13.15 in chips) 
w43JQj2oYPpKQVG4Yzlq1w: posts small blind $0.10
QiL+lEgEWwy21jk/ltaRLg: posts big blind $0.25
*** HOLE CARDS ***
DE9hRlt14g+JdsRQ4wT7hg: raises $0.75 to $1
if4dh6jhJXeN3/qd3qCp9g: folds 
xC0kaiDYM6YTlgODL83O5A: folds 
LyDHtw3/yniNHW+DvLXbog: folds 
w43JQj2oYPpKQVG4Yzlq1w: folds 
QiL+lEgEWwy21jk/ltaRLg: folds 
Uncalled bet ($0.75) returned to DE9hRlt14g+JdsRQ4wT7hg
DE9hRlt14g+JdsRQ4wT7hg collected $0.60 from pot
DE9hRlt14g+JdsRQ4wT7hg: doesn't show hand 
*** SUMMARY ***
Total pot $0.60 | Rake $0 
Seat 1: LyDHtw3/yniNHW+DvLXbog (button) folded before Flop (didn't bet)
Seat 2: w43JQj2oYPpKQVG4Yzlq1w (small blind) folded before Flop
Seat 3: QiL+lEgEWwy21jk/ltaRLg (big blind) folded before Flop
Seat 4: DE9hRlt14g+JdsRQ4wT7hg collected ($0.60)
Seat 5: if4dh6jhJXeN3/qd3qCp9g folded before Flop (didn't bet)
Seat 6: xC0kaiDYM6YTlgODL83O5A folded before Flop (didn't bet)




PokerStars Game #59941830462:  Hold'em No Limit ($0.10/$0.25) - 2009/07/01 1:47:30 ET
Table 'SgI2Cobdjtkh0Fd0/eTTDg' 9-max Seat #6 is the button
Seat 2: uUc5QTI8+ZdC95UnznCsqg ($14.25 in chips) 
Seat 3: OiV1PWZ3IkN29JlmCcnTwQ ($5 in chips) 
Seat 4: s1y+qfkBnhgc67+X3ThjeA ($8.40 in chips) 
Seat 5: RHqgdFvufLCYe54+qd2gcA ($6.25 in chips) 
Seat 6: 6RiVTYll/5D8zICp0MRpKw ($27.85 in chips) 
Seat 9: cZ99hugmLBj9KhTlc8nCSw ($30.70 in chips) 
M. Catalig will be allowed to play after the button
cZ99hugmLBj9KhTlc8nCSw: posts small blind $0.10
uUc5QTI8+ZdC95UnznCsqg: posts big blind $0.25
*** HOLE CARDS ***
OiV1PWZ3IkN29JlmCcnTwQ: folds 
s1y+qfkBnhgc67+X3ThjeA: calls $0.25
OiV1PWZ3IkN29JlmCcnTwQ leaves the table
Ravens247 joins the table at seat #8 
RHqgdFvufLCYe54+qd2gcA: folds 
Drama4mama joins the table at seat #1 
6RiVTYll/5D8zICp0MRpKw: folds 
cZ99hugmLBj9KhTlc8nCSw: folds 
uUc5QTI8+ZdC95UnznCsqg: raises $0.75 to $1
s1y+qfkBnhgc67+X3ThjeA: folds 
Uncalled bet ($0.75) returned to uUc5QTI8+ZdC95UnznCsqg
uUc5QTI8+ZdC95UnznCsqg collected $0.60 from pot
uUc5QTI8+ZdC95UnznCsqg: doesn't show hand 
flatfoot12 joins the table at seat #3 
*** SUMMARY ***
Total pot $0.60 | Rake $0 
Seat 2: uUc5QTI8+ZdC95UnznCsqg (big blind) collected ($0.60)
Seat 3: OiV1PWZ3IkN29JlmCcnTwQ folded before Flop (didn't bet)
Seat 4: s1y+qfkBnhgc67+X3ThjeA folded before Flop
Seat 5: RHqgdFvufLCYe54+qd2gcA folded before Flop (didn't bet)
Seat 6: 6RiVTYll/5D8zICp0MRpKw (button) folded before Flop (didn't bet)
Seat 9: cZ99hugmLBj9KhTlc8nCSw (small blind) folded before Flop




PokerStars Game #59941830860:  Hold'em No Limit ($0.10/$0.25) - 2009/07/01 1:47:31 ET
Table 'Jz+kWRxWNGk9w24fdQEveA' 9-max Seat #2 is the button
Seat 1: Z9W7+g1WMhhZDi7DwGbCFA ($5 in chips) 
Seat 2: ljemhp25Zg+nlA9DLCIiUw ($37.75 in chips) 
Seat 3: N5sUK8M0br9djLrW97V9pQ ($24.75 in chips) 
Seat 4: HPEB+AtKw1+C/cxU0o1ciw ($29 in chips) 
Seat 5: d6eSA7wOH5mRaSyVDVRBLw ($12.50 in chips) 
Seat 6: BXkjaKe7T/rw37TNNtBVwQ ($5.35 in chips) 
Seat 7: wGigCmBR/9XWkPpvYos3aQ ($27.35 in chips) 
Seat 8: j4q3p0lesp63b1gZDwLBZw ($5 in chips) 
Seat 9: V6p0jQ/RhUsqpHLmXvEX4Q ($17.35 in chips) 
N5sUK8M0br9djLrW97V9pQ: posts small blind $0.10
HPEB+AtKw1+C/cxU0o1ciw: posts big blind $0.25
*** HOLE CARDS ***
d6eSA7wOH5mRaSyVDVRBLw: calls $0.25
BXkjaKe7T/rw37TNNtBVwQ: folds 
wGigCmBR/9XWkPpvYos3aQ: folds 
j4q3p0lesp63b1gZDwLBZw: folds 
V6p0jQ/RhUsqpHLmXvEX4Q: folds 
Z9W7+g1WMhhZDi7DwGbCFA: folds 
ljemhp25Zg+nlA9DLCIiUw: folds 
N5sUK8M0br9djLrW97V9pQ: calls $0.15
HPEB+AtKw1+C/cxU0o1ciw: checks 
*** FLOP *** [Th 5s 8d]
N5sUK8M0br9djLrW97V9pQ: bets $0.50
HPEB+AtKw1+C/cxU0o1ciw: folds 
d6eSA7wOH5mRaSyVDVRBLw: calls $0.50
*** TURN *** [Th 5s 8d] [6d]
N5sUK8M0br9djLrW97V9pQ: bets $1.25
d6eSA7wOH5mRaSyVDVRBLw: folds 
Uncalled bet ($1.25) returned to N5sUK8M0br9djLrW97V9pQ
N5sUK8M0br9djLrW97V9pQ collected $1.70 from pot
N5sUK8M0br9djLrW97V9pQ: doesn't show hand 
*** SUMMARY ***
Total pot $1.75 | Rake $0.05 
Board [Th 5s 8d 6d]
Seat 1: Z9W7+g1WMhhZDi7DwGbCFA folded before Flop (didn't bet)
Seat 2: ljemhp25Zg+nlA9DLCIiUw (button) folded before Flop (didn't bet)
Seat 3: N5sUK8M0br9djLrW97V9pQ (small blind) collected ($1.70)
Seat 4: HPEB+AtKw1+C/cxU0o1ciw (big blind) folded on the Flop
Seat 5: d6eSA7wOH5mRaSyVDVRBLw folded on the Turn
Seat 6: BXkjaKe7T/rw37TNNtBVwQ folded before Flop (didn't bet)
Seat 7: wGigCmBR/9XWkPpvYos3aQ folded before Flop (didn't bet)
Seat 8: j4q3p0lesp63b1gZDwLBZw folded before Flop (didn't bet)
Seat 9: V6p0jQ/RhUsqpHLmXvEX4Q folded before Flop (didn't bet)




PokerStars Game #59941830678:  Hold'em No Limit ($0.10/$0.25) - 2009/07/01 1:47:31 ET
Table 'PCxB2W9H6ma8SwsZlImuOw' 9-max Seat #1 is the button
Seat 1: SqibpGx+lf+brY0fJVvD0w ($24.75 in chips) 
Seat 2: bXpVeaSTPBFSPJmeXxO7nw ($4.75 in chips) 
Seat 3: J2a/QHAWUgo6beDRoEyg2g ($6.95 in chips) 
Seat 4: RsPwA2DnzOke3hD/Of/DUg ($2.55 in chips) 
Seat 5: GZO7tOXatVoX17M2DqPcUQ ($21.40 in chips) 
Seat 6: 5/6dWEBUHldD7iGXa2LwsQ ($16.20 in chips) 
Seat 7: c/9X4zftzphFxYtxp5kp9w ($27.40 in chips) 
Seat 8: Pt637jKksB5MzP0UNJAAkw ($25.60 in chips) 
Seat 9: COwSH15MvHaRF7en6/TRZQ ($6.70 in chips) 
bXpVeaSTPBFSPJmeXxO7nw: posts small blind $0.10
J2a/QHAWUgo6beDRoEyg2g: posts big blind $0.25
*** HOLE CARDS ***
RsPwA2DnzOke3hD/Of/DUg: folds 
GZO7tOXatVoX17M2DqPcUQ: folds 
5/6dWEBUHldD7iGXa2LwsQ: folds 
c/9X4zftzphFxYtxp5kp9w: raises $0.75 to $1
Pt637jKksB5MzP0UNJAAkw: folds 
COwSH15MvHaRF7en6/TRZQ: folds 
SqibpGx+lf+brY0fJVvD0w: folds 
bXpVeaSTPBFSPJmeXxO7nw: folds 
J2a/QHAWUgo6beDRoEyg2g: folds 
Uncalled bet ($0.75) returned to c/9X4zftzphFxYtxp5kp9w
c/9X4zftzphFxYtxp5kp9w collected $0.60 from pot
*** SUMMARY ***
Total pot $0.60 | Rake $0 
Seat 1: SqibpGx+lf+brY0fJVvD0w (button) folded before Flop (didn't bet)
Seat 2: bXpVeaSTPBFSPJmeXxO7nw (small blind) folded before Flop
Seat 3: J2a/QHAWUgo6beDRoEyg2g (big blind) folded before Flop
Seat 4: RsPwA2DnzOke3hD/Of/DUg folded before Flop (didn't bet)
Seat 5: GZO7tOXatVoX17M2DqPcUQ folded before Flop (didn't bet)
Seat 6: 5/6dWEBUHldD7iGXa2LwsQ folded before Flop (didn't bet)
Seat 7: c/9X4zftzphFxYtxp5kp9w collected ($0.60)
Seat 8: Pt637jKksB5MzP0UNJAAkw folded before Flop (didn't bet)
Seat 9: COwSH15MvHaRF7en6/TRZQ folded before Flop (didn't bet)




PokerStars Game #59941830702:  Hold'em No Limit ($0.10/$0.25) - 2009/07/01 1:47:31 ET
Table 'ktio12Pyq06LsrFhIorSqA' 9-max Seat #3 is the button
Seat 1: OneeONzF0MoH0pEdcBndwA ($37.80 in chips) 
Seat 2: tGsFgUKjSctVaAXabrlZxw ($4.95 in chips) 
Seat 3: Z9W7+g1WMhhZDi7DwGbCFA ($5 in chips) 
Seat 4: 0QdZrkFD7aGKeBXPGbIomA ($5.10 in chips) 
Seat 5: e0pV1oisCAilWiG0FCxY6A ($16.75 in chips) 
Seat 6: jQL6XIewylQ8MmZhhq2YFg ($42.20 in chips) 
Seat 7: XGCfQsxa6PfAg3kJtzUmww ($22.10 in chips) 
Seat 9: H5Se03ZqSX7tbULXur2MAg ($26.30 in chips) 
0QdZrkFD7aGKeBXPGbIomA: posts small blind $0.10
e0pV1oisCAilWiG0FCxY6A: posts big blind $0.25
*** HOLE CARDS ***
jQL6XIewylQ8MmZhhq2YFg: raises $0.50 to $0.75
XGCfQsxa6PfAg3kJtzUmww: folds 
Z5y2J55JmfLYR6/DPAGHwQ has returned
H5Se03ZqSX7tbULXur2MAg: calls $0.75
OneeONzF0MoH0pEdcBndwA: folds 
tGsFgUKjSctVaAXabrlZxw: folds 
Z9W7+g1WMhhZDi7DwGbCFA: folds 
0QdZrkFD7aGKeBXPGbIomA: calls $0.65
e0pV1oisCAilWiG0FCxY6A: calls $0.50
*** FLOP *** [8c 5c 2s]
0QdZrkFD7aGKeBXPGbIomA: checks 
e0pV1oisCAilWiG0FCxY6A: checks 
jQL6XIewylQ8MmZhhq2YFg: bets $1
H5Se03ZqSX7tbULXur2MAg: folds 
0QdZrkFD7aGKeBXPGbIomA: calls $1
e0pV1oisCAilWiG0FCxY6A: folds 
*** TURN *** [8c 5c 2s] [8d]
0QdZrkFD7aGKeBXPGbIomA: bets $0.75
jQL6XIewylQ8MmZhhq2YFg: raises $0.75 to $1.50
0QdZrkFD7aGKeBXPGbIomA: raises $0.75 to $2.25
jQL6XIewylQ8MmZhhq2YFg: raises $1.75 to $4
0QdZrkFD7aGKeBXPGbIomA: calls $1.10 and is all-in
Uncalled bet ($0.65) returned to jQL6XIewylQ8MmZhhq2YFg
*** RIVER *** [8c 5c 2s 8d] [7d]
*** SHOW DOWN ***
0QdZrkFD7aGKeBXPGbIomA: shows [7h 7s] (a full house, Sevens full of Eights)
jQL6XIewylQ8MmZhhq2YFg: mucks hand 
0QdZrkFD7aGKeBXPGbIomA collected $11.15 from pot
*** SUMMARY ***
Total pot $11.70 | Rake $0.55 
Board [8c 5c 2s 8d 7d]
Seat 1: OneeONzF0MoH0pEdcBndwA folded before Flop (didn't bet)
Seat 2: tGsFgUKjSctVaAXabrlZxw folded before Flop (didn't bet)
Seat 3: Z9W7+g1WMhhZDi7DwGbCFA (button) folded before Flop (didn't bet)
Seat 4: 0QdZrkFD7aGKeBXPGbIomA (small blind) showed [7h 7s] and won ($11.15) with a full house, Sevens full of Eights
Seat 5: e0pV1oisCAilWiG0FCxY6A (big blind) folded on the Flop
Seat 6: jQL6XIewylQ8MmZhhq2YFg mucked
Seat 7: XGCfQsxa6PfAg3kJtzUmww folded before Flop (didn't bet)
Seat 9: H5Se03ZqSX7tbULXur2MAg folded on the Flop




PokerStars Game #59941830776:  Hold'em No Limit ($0.10/$0.25) - 2009/07/01 1:47:31 ET
Table 'zW+7jPbOLCvlPu+dUGY5WQ' 6-max Seat #6 is the button
Seat 1: eL3+wCBjFGfQ5FMdIZihwA ($26.25 in chips) 
Seat 2: cEMJmfAUQZmMChZe6aacKw ($10.20 in chips) 
Seat 4: i48129QFpEQQ+UN4aNtmww ($18.55 in chips) 
Seat 5: Hsvkc0/G2VV78oVmWYXecw ($5.35 in chips) 
Seat 6: qGHGf/553gQnDoklMRe3tg ($25 in chips) 
eL3+wCBjFGfQ5FMdIZihwA: posts small blind $0.10
cEMJmfAUQZmMChZe6aacKw: posts big blind $0.25
*** HOLE CARDS ***
i48129QFpEQQ+UN4aNtmww: calls $0.25
Hsvkc0/G2VV78oVmWYXecw: raises $0.75 to $1
qGHGf/553gQnDoklMRe3tg: folds 
eL3+wCBjFGfQ5FMdIZihwA: folds 
cEMJmfAUQZmMChZe6aacKw: folds 
i48129QFpEQQ+UN4aNtmww: calls $0.75
*** FLOP *** [2s 4h Tc]
i48129QFpEQQ+UN4aNtmww: bets $1
Hsvkc0/G2VV78oVmWYXecw: raises $2.25 to $3.25
i48129QFpEQQ+UN4aNtmww: folds 
Uncalled bet ($2.25) returned to Hsvkc0/G2VV78oVmWYXecw
Hsvkc0/G2VV78oVmWYXecw collected $4.15 from pot
Hsvkc0/G2VV78oVmWYXecw: doesn't show hand 
*** SUMMARY ***
Total pot $4.35 | Rake $0.20 
Board [2s 4h Tc]
Seat 1: eL3+wCBjFGfQ5FMdIZihwA (small blind) folded before Flop
Seat 2: cEMJmfAUQZmMChZe6aacKw (big blind) folded before Flop
Seat 4: i48129QFpEQQ+UN4aNtmww folded on the Flop
Seat 5: Hsvkc0/G2VV78oVmWYXecw collected ($4.15)
Seat 6: qGHGf/553gQnDoklMRe3tg (button) folded before Flop (didn't bet)




PokerStars Game #59941831390:  Hold'em No Limit ($0.10/$0.25) - 2009/07/01 1:47:32 ET
Table 'Jj2eLzVCUVAGBmM+Og79iQ' 9-max Seat #6 is the button
Seat 1: ShXPHWfjhfmAwLgDdm6bRQ ($7.25 in chips) 
Seat 2: oMxwMC7+uAsJudeUN6aP0A ($14.60 in chips) 
Seat 3: HPEB+AtKw1+C/cxU0o1ciw ($24.40 in chips) 
Seat 4: aNpwfA31EREwO+ar4XzBCw ($44.60 in chips) 
Seat 5: UkF1eqqUN0CCiimXAuN7og ($4.65 in chips) 
Seat 6: jZURAM/dgGCX+5lATlZugw ($17.35 in chips) 
Seat 7: K0b5wNInj6hUGRr6yzKFtw ($59.25 in chips) 
Seat 8: H5Se03ZqSX7tbULXur2MAg ($20.60 in chips) 
K0b5wNInj6hUGRr6yzKFtw: posts small blind $0.10
H5Se03ZqSX7tbULXur2MAg: posts big blind $0.25
vSkQm2EelzwRGDDQQk0Fqw: sits out 
*** HOLE CARDS ***
ShXPHWfjhfmAwLgDdm6bRQ: folds 
oMxwMC7+uAsJudeUN6aP0A: raises $0.50 to $0.75
HPEB+AtKw1+C/cxU0o1ciw: folds 
aNpwfA31EREwO+ar4XzBCw: folds 
UkF1eqqUN0CCiimXAuN7og: folds 
jZURAM/dgGCX+5lATlZugw: folds 
K0b5wNInj6hUGRr6yzKFtw: folds 
H5Se03ZqSX7tbULXur2MAg: raises $2.25 to $3
oMxwMC7+uAsJudeUN6aP0A: calls $2.25
*** FLOP *** [8s 7s Ad]
H5Se03ZqSX7tbULXur2MAg: bets $3.50
oMxwMC7+uAsJudeUN6aP0A: calls $3.50
*** TURN *** [8s 7s Ad] [Tc]
H5Se03ZqSX7tbULXur2MAg: bets $4.75
oMxwMC7+uAsJudeUN6aP0A: raises $3.35 to $8.10 and is all-in
H5Se03ZqSX7tbULXur2MAg: calls $3.35
*** RIVER *** [8s 7s Ad Tc] [Js]
*** SHOW DOWN ***
H5Se03ZqSX7tbULXur2MAg: shows [Ah Ac] (three of a kind, Aces)
oMxwMC7+uAsJudeUN6aP0A: mucks hand 
H5Se03ZqSX7tbULXur2MAg collected $27.90 from pot
*** SUMMARY ***
Total pot $29.30 | Rake $1.40 
Board [8s 7s Ad Tc Js]
Seat 1: ShXPHWfjhfmAwLgDdm6bRQ folded before Flop (didn't bet)
Seat 2: oMxwMC7+uAsJudeUN6aP0A mucked
Seat 3: HPEB+AtKw1+C/cxU0o1ciw folded before Flop (didn't bet)
Seat 4: aNpwfA31EREwO+ar4XzBCw folded before Flop (didn't bet)
Seat 5: UkF1eqqUN0CCiimXAuN7og folded before Flop (didn't bet)
Seat 6: jZURAM/dgGCX+5lATlZugw (button) folded before Flop (didn't bet)
Seat 7: K0b5wNInj6hUGRr6yzKFtw (small blind) folded before Flop
Seat 8: H5Se03ZqSX7tbULXur2MAg (big blind) showed [Ah Ac] and won ($27.90) with three of a kind, Aces




PokerStars Game #59941831236:  Hold'em No Limit ($0.10/$0.25) - 2009/07/01 1:47:32 ET
Table 'mdub7rJf3Z5tCT9s/+1+Wg' 9-max Seat #3 is the button
Seat 1: cZ99hugmLBj9KhTlc8nCSw ($28.90 in chips) 
Seat 2: 539MC3AwKLWVFwzABc644Q ($10.90 in chips) 
Seat 3: PdIasPkzm2sqZnN41ZRXOg ($5.60 in chips) 
Seat 4: fDGyaQz0cs2s4FOYxkbIHA ($14.60 in chips) 
Seat 5: dfNim92Z6XK1/h5SFW5vDg ($26.25 in chips) 
Seat 6: T/CCwAWe2yhO0c4oHNwicw ($23.25 in chips) 
Seat 7: woe+9KKk+L3pZgMTuHcmog ($15.20 in chips) 
Seat 9: tYsOBqdU1+x+yFI7zHO7hQ ($36.05 in chips) 
fDGyaQz0cs2s4FOYxkbIHA: posts small blind $0.10
dfNim92Z6XK1/h5SFW5vDg: posts big blind $0.25
bXpVeaSTPBFSPJmeXxO7nw: sits out 
*** HOLE CARDS ***
T/CCwAWe2yhO0c4oHNwicw: folds 
woe+9KKk+L3pZgMTuHcmog: raises $0.75 to $1
tYsOBqdU1+x+yFI7zHO7hQ: folds 
cZ99hugmLBj9KhTlc8nCSw: folds 
539MC3AwKLWVFwzABc644Q: folds 
PdIasPkzm2sqZnN41ZRXOg: folds 
fDGyaQz0cs2s4FOYxkbIHA: folds 
dfNim92Z6XK1/h5SFW5vDg: folds 
Uncalled bet ($0.75) returned to woe+9KKk+L3pZgMTuHcmog
woe+9KKk+L3pZgMTuHcmog collected $0.60 from pot
*** SUMMARY ***
Total pot $0.60 | Rake $0 
Seat 1: cZ99hugmLBj9KhTlc8nCSw folded before Flop (didn't bet)
Seat 2: 539MC3AwKLWVFwzABc644Q folded before Flop (didn't bet)
Seat 3: PdIasPkzm2sqZnN41ZRXOg (button) folded before Flop (didn't bet)
Seat 4: fDGyaQz0cs2s4FOYxkbIHA (small blind) folded before Flop
Seat 5: dfNim92Z6XK1/h5SFW5vDg (big blind) folded before Flop
Seat 6: T/CCwAWe2yhO0c4oHNwicw folded before Flop (didn't bet)
Seat 7: woe+9KKk+L3pZgMTuHcmog collected ($0.60)
Seat 9: tYsOBqdU1+x+yFI7zHO7hQ folded before Flop (didn't bet)




PokerStars Game #59941831230:  Hold'em No Limit ($0.10/$0.25) - 2009/07/01 1:47:32 ET
Table 'gZetDqJh6q9A3mLO3ThCsAnc6OeGk/wtaWV+6N+kgnZQSeat #2 is the button
Seat 1: DihMHaz4WNETH1bPDe13kA ($25 in chips) 
Seat 2: JFIAqU8lCZ0vWwEl4bdGsg ($34.85 in chips) 
Seat 3: jp34e617tIzV8tKIWmfAbA ($33.90 in chips) 
Seat 4: BV+K0Phf5VBHr7aZPKqbUQ ($29.35 in chips) 
Seat 5: EKTLAV1bAterT0Mc1G6lBg5hAPbqNrvJb8PtLiceXtlg4.75 in chips) 
Seat 6: Mhj3q7cxev+XjXZxEE6/Cw ($25 in chips) 
jp34e617tIzV8tKIWmfAbA: posts small blind $0.10
BV+K0Phf5VBHr7aZPKqbUQ: posts big blind $0.25
*** HOLE CARDS ***
EKTLAV1bAterT0Mc1G6lBg5hAPbqNrvJb8PtLiceXtlglls $0.25
Mhj3q7cxev+XjXZxEE6/Cw: folds 
DihMHaz4WNETH1bPDe13kA: folds 
JFIAqU8lCZ0vWwEl4bdGsg: folds 
jp34e617tIzV8tKIWmfAbA: folds 
BV+K0Phf5VBHr7aZPKqbUQ: checks 
*** FLOP *** [Kh 5c 2h]
BV+K0Phf5VBHr7aZPKqbUQ: bets $0.50
EKTLAV1bAterT0Mc1G6lBg5hAPbqNrvJb8PtLiceXtlglds 
Uncalled bet ($0.50) returned to BV+K0Phf5VBHr7aZPKqbUQ
BV+K0Phf5VBHr7aZPKqbUQ collected $0.60 from pot
BV+K0Phf5VBHr7aZPKqbUQ: doesn't show hand 
*** SUMMARY ***
Total pot $0.60 | Rake $0 
Board [Kh 5c 2h]
Seat 1: DihMHaz4WNETH1bPDe13kA folded before Flop (didn't bet)
Seat 2: JFIAqU8lCZ0vWwEl4bdGsg (button) folded before Flop (didn't bet)
Seat 3: jp34e617tIzV8tKIWmfAbA (small blind) folded before Flop
Seat 4: BV+K0Phf5VBHr7aZPKqbUQ (big blind) collected ($0.60)
Seat 5: EKTLAV1bAterT0Mc1G6lBg5hAPbqNrvJb8PtLiceXtlgded on the Flop
Seat 6: Mhj3q7cxev+XjXZxEE6/Cw folded before Flop (didn't bet)




PokerStars Game #59941832058:  Hold'em No Limit ($0.10/$0.25) - 2009/07/01 1:47:33 ET
Table 'KU/HrxqxwDz8HKEhYTZ6uw' 6-max Seat #3 is the button
Seat 1: 7LKoiQHXpTQXJvWQrw907g ($38.05 in chips) 
Seat 2: kG34n23qFQA3nzdOJTQ1dA ($24.65 in chips) 
Seat 3: SFmT9ZsVopnukjvAzrxTRg ($25.25 in chips) 
Seat 4: AGwMM0FUhYZf81+oXvYQMg ($26.70 in chips) 
Seat 5: iyZxqznXjv3vtvOJymkoLQ ($50.90 in chips) 
Seat 6: qWxkCeqApAWdAA0evrfDvQ ($11.25 in chips) 
AGwMM0FUhYZf81+oXvYQMg: posts small blind $0.10
iyZxqznXjv3vtvOJymkoLQ: posts big blind $0.25
*** HOLE CARDS ***
qWxkCeqApAWdAA0evrfDvQ: folds 
7LKoiQHXpTQXJvWQrw907g: folds 
kG34n23qFQA3nzdOJTQ1dA: folds 
SFmT9ZsVopnukjvAzrxTRg: raises $0.75 to $1
AGwMM0FUhYZf81+oXvYQMg: folds 
iyZxqznXjv3vtvOJymkoLQ: folds 
Uncalled bet ($0.75) returned to SFmT9ZsVopnukjvAzrxTRg
SFmT9ZsVopnukjvAzrxTRg collected $0.60 from pot
SFmT9ZsVopnukjvAzrxTRg: doesn't show hand 
*** SUMMARY ***
Total pot $0.60 | Rake $0 
Seat 1: 7LKoiQHXpTQXJvWQrw907g folded before Flop (didn't bet)
Seat 2: kG34n23qFQA3nzdOJTQ1dA folded before Flop (didn't bet)
Seat 3: SFmT9ZsVopnukjvAzrxTRg (button) collected ($0.60)
Seat 4: AGwMM0FUhYZf81+oXvYQMg (small blind) folded before Flop
Seat 5: iyZxqznXjv3vtvOJymkoLQ (big blind) folded before Flop
Seat 6: qWxkCeqApAWdAA0evrfDvQ folded before Flop (didn't bet)




PokerStars Game #59941831974:  Hold'em No Limit ($0.10/$0.25) - 2009/07/01 1:47:33 ET
Table 'g6ryG70feTw9nNm+XJLuXw' 6-max Seat #4 is the button
Seat 1: v+QfkGiuj9bgtuNoVnDO8w ($35.60 in chips) 
Seat 2: SxIIgwXYLkwd6m3wLyPTCw ($33.55 in chips) 
Seat 3: cezpHJ8FB07dj0xG+LhOvw ($25 in chips) 
Seat 4: GC/9yVD59DUCX7hUI7gcLw ($45 in chips) 
Seat 5: EE16Ua5b1HSsYej5zeXOlA ($25.10 in chips) 
Seat 6: Mhj3q7cxev+XjXZxEE6/Cw ($25 in chips) 
EE16Ua5b1HSsYej5zeXOlA: posts small blind $0.10
Mhj3q7cxev+XjXZxEE6/Cw: posts big blind $0.25
*** HOLE CARDS ***
v+QfkGiuj9bgtuNoVnDO8w: folds 
SxIIgwXYLkwd6m3wLyPTCw: raises $0.50 to $0.75
cezpHJ8FB07dj0xG+LhOvw: folds 
GC/9yVD59DUCX7hUI7gcLw: folds 
EE16Ua5b1HSsYej5zeXOlA: folds 
Mhj3q7cxev+XjXZxEE6/Cw: folds 
Uncalled bet ($0.50) returned to SxIIgwXYLkwd6m3wLyPTCw
SxIIgwXYLkwd6m3wLyPTCw collected $0.60 from pot
SxIIgwXYLkwd6m3wLyPTCw: doesn't show hand 
*** SUMMARY ***
Total pot $0.60 | Rake $0 
Seat 1: v+QfkGiuj9bgtuNoVnDO8w folded before Flop (didn't bet)
Seat 2: SxIIgwXYLkwd6m3wLyPTCw collected ($0.60)
Seat 3: cezpHJ8FB07dj0xG+LhOvw folded before Flop (didn't bet)
Seat 4: GC/9yVD59DUCX7hUI7gcLw (button) folded before Flop (didn't bet)
Seat 5: EE16Ua5b1HSsYej5zeXOlA (small blind) folded before Flop
Seat 6: Mhj3q7cxev+XjXZxEE6/Cw (big blind) folded before Flop




PokerStars Game #59941831674:  Hold'em No Limit ($0.10/$0.25) - 2009/07/01 1:47:33 ET
Table 'dZNBGqFYSwfOVZvDJ4VjIQ' 6-max Seat #1 is the button
Seat 1: v+QfkGiuj9bgtuNoVnDO8w ($37.10 in chips) 
Seat 2: 3zD3qLXT1bEffAoWGnc7wg ($29.40 in chips) 
Seat 3: kyRaCIljYA6l33lSKQfNsg ($28.30 in chips) 
Seat 4: mFv3iBCtrw9XfCDRB0d46Q ($5.80 in chips) 
Seat 5: +ZlnqPoP3Hg4BIUxDfKd/A ($29.25 in chips) 
Seat 6: ypmjhffk/YHGc51wgVXUTw ($29.40 in chips) 
3zD3qLXT1bEffAoWGnc7wg: posts small blind $0.10
kyRaCIljYA6l33lSKQfNsg: posts big blind $0.25
*** HOLE CARDS ***
mFv3iBCtrw9XfCDRB0d46Q: folds 
+ZlnqPoP3Hg4BIUxDfKd/A: raises $0.75 to $1
ypmjhffk/YHGc51wgVXUTw: folds 
v+QfkGiuj9bgtuNoVnDO8w: folds 
3zD3qLXT1bEffAoWGnc7wg: folds 
kyRaCIljYA6l33lSKQfNsg: folds 
Uncalled bet ($0.75) returned to +ZlnqPoP3Hg4BIUxDfKd/A
+ZlnqPoP3Hg4BIUxDfKd/A collected $0.60 from pot
+ZlnqPoP3Hg4BIUxDfKd/A: doesn't show hand 
*** SUMMARY ***
Total pot $0.60 | Rake $0 
Seat 1: v+QfkGiuj9bgtuNoVnDO8w (button) folded before Flop (didn't bet)
Seat 2: 3zD3qLXT1bEffAoWGnc7wg (small blind) folded before Flop
Seat 3: kyRaCIljYA6l33lSKQfNsg (big blind) folded before Flop
Seat 4: mFv3iBCtrw9XfCDRB0d46Q folded before Flop (didn't bet)
Seat 5: +ZlnqPoP3Hg4BIUxDfKd/A collected ($0.60)
Seat 6: ypmjhffk/YHGc51wgVXUTw folded before Flop (didn't bet)




PokerStars Game #59941832100:  Hold'em No Limit ($0.10/$0.25) - 2009/07/01 1:47:33 ET
Table 'wGizWOswEL6P5QrvVkno/g' 6-max Seat #1 is the button
Seat 1: Qbfkn+ucISvbd1Xh32zAGA ($32 in chips) 
Seat 2: mfrkWA3PTeYPkbO6hi98Aw ($27.85 in chips) 
Seat 6: BuAE7g7dRfuqGPmQDlGyGg ($18.35 in chips) 
mfrkWA3PTeYPkbO6hi98Aw: posts small blind $0.10
w43JQj2oYPpKQVG4Yzlq1w joins the table at seat #5 
32YL2ZEp8NT4JB2RVM9euQ: is sitting out 
BuAE7g7dRfuqGPmQDlGyGg: posts big blind $0.25
*** HOLE CARDS ***
Qbfkn+ucISvbd1Xh32zAGA: folds 
32YL2ZEp8NT4JB2RVM9euQ leaves the table
mfrkWA3PTeYPkbO6hi98Aw: raises $0.75 to $1
BuAE7g7dRfuqGPmQDlGyGg: calls $0.75
*** FLOP *** [Jd 6s Kh]
bhopk431 joins the table at seat #4 
bJFzs6QmEEnz4miMfSDtcg leaves the table
mfrkWA3PTeYPkbO6hi98Aw: bets $1.25
BuAE7g7dRfuqGPmQDlGyGg: folds 
Uncalled bet ($1.25) returned to mfrkWA3PTeYPkbO6hi98Aw
mfrkWA3PTeYPkbO6hi98Aw collected $1.90 from pot
mfrkWA3PTeYPkbO6hi98Aw: doesn't show hand 
the3bigO joins the table at seat #3 
*** SUMMARY ***
Total pot $2 | Rake $0.10 
Board [Jd 6s Kh]
Seat 1: Qbfkn+ucISvbd1Xh32zAGA (button) folded before Flop (didn't bet)
Seat 2: mfrkWA3PTeYPkbO6hi98Aw (small blind) collected ($1.90)
Seat 6: BuAE7g7dRfuqGPmQDlGyGg (big blind) folded on the Flop




PokerStars Game #59941831684:  Hold'em No Limit ($0.10/$0.25) - 2009/07/01 1:47:33 ET
Table '5VWnrlxdjwVfMWkVS2WE7A' 6-max Seat #4 is the button
Seat 1: 82p+w3EmUaFFHuwpSeGY1w ($14.50 in chips) 
Seat 2: LJI7A1YgDM7hgh7o56+ReQ ($42.45 in chips) 
Seat 3: SFmT9ZsVopnukjvAzrxTRg ($37.35 in chips) 
Seat 4: Pb/gJ3OxOZx57fFp0MDgkg ($34.85 in chips) 
Seat 6: LtASJ9OlkqGrrUKGQlpGAw ($5.25 in chips) 
LtASJ9OlkqGrrUKGQlpGAw: posts small blind $0.10
82p+w3EmUaFFHuwpSeGY1w: posts big blind $0.25
*** HOLE CARDS ***
LJI7A1YgDM7hgh7o56+ReQ: folds 
SFmT9ZsVopnukjvAzrxTRg: folds 
SgMFmwYtNvq9Y+2ZxPSiWQ leaves the table
Pb/gJ3OxOZx57fFp0MDgkg: raises $0.50 to $0.75
LtASJ9OlkqGrrUKGQlpGAw: folds 
82p+w3EmUaFFHuwpSeGY1w: folds 
Uncalled bet ($0.50) returned to Pb/gJ3OxOZx57fFp0MDgkg
Pb/gJ3OxOZx57fFp0MDgkg collected $0.60 from pot
*** SUMMARY ***
Total pot $0.60 | Rake $0 
Seat 1: 82p+w3EmUaFFHuwpSeGY1w (big blind) folded before Flop
Seat 2: LJI7A1YgDM7hgh7o56+ReQ folded before Flop (didn't bet)
Seat 3: SFmT9ZsVopnukjvAzrxTRg folded before Flop (didn't bet)
Seat 4: Pb/gJ3OxOZx57fFp0MDgkg (button) collected ($0.60)
Seat 6: LtASJ9OlkqGrrUKGQlpGAw (small blind) folded before Flop




PokerStars Game #59941832562:  Hold'em No Limit ($0.10/$0.25) - 2009/07/01 1:47:34 ET
Table 'Do4nrTNDYpK3sQjwFxX+Og' 6-max Seat #6 is the button
Seat 1: 7JrQNOR9wRBxq9ijFhWieg ($37.75 in chips) 
Seat 2: tzMoGl9F0PUr5NibYueeSw ($67.70 in chips) 
Seat 3: TSmua8tGK3sTbwi0ynrW9Q ($26.40 in chips) 
Seat 4: cWc85bEzdRzpUMhRKm8pwQ ($33.05 in chips) 
Seat 6: lBoEwOFgzcERLIRUkUoRTw ($23.20 in chips) 
7JrQNOR9wRBxq9ijFhWieg: posts small blind $0.10
tzMoGl9F0PUr5NibYueeSw: posts big blind $0.25
aogAb4Eienxztk8p2v9VVw: sits out 
*** HOLE CARDS ***
7JrQNOR9wRBxq9ijFhWieg said, "very close"
tzMoGl9F0PUr5NibYueeSw said, "next blind I am out"
TSmua8tGK3sTbwi0ynrW9Q: raises $0.75 to $1
cWc85bEzdRzpUMhRKm8pwQ: folds 
lBoEwOFgzcERLIRUkUoRTw: folds 
7JrQNOR9wRBxq9ijFhWieg: folds 
tzMoGl9F0PUr5NibYueeSw: folds 
Uncalled bet ($0.75) returned to TSmua8tGK3sTbwi0ynrW9Q
TSmua8tGK3sTbwi0ynrW9Q collected $0.60 from pot
TSmua8tGK3sTbwi0ynrW9Q: doesn't show hand 
*** SUMMARY ***
Total pot $0.60 | Rake $0 
Seat 1: 7JrQNOR9wRBxq9ijFhWieg (small blind) folded before Flop
Seat 2: tzMoGl9F0PUr5NibYueeSw (big blind) folded before Flop
Seat 3: TSmua8tGK3sTbwi0ynrW9Q collected ($0.60)
Seat 4: cWc85bEzdRzpUMhRKm8pwQ folded before Flop (didn't bet)
Seat 6: lBoEwOFgzcERLIRUkUoRTw (button) folded before Flop (didn't bet)




PokerStars Game #59941832280:  Hold'em No Limit ($0.10/$0.25) - 2009/07/01 1:47:34 ET
Table 'mF3KHGMaTpaBZbtBoyfTeg' 6-max Seat #5 is the button
Seat 1: 0HAB2GdCAM7p7V00xueAVQ ($23.15 in chips) 
Seat 3: 9kUKGKkblnIx3m8rlVol6Q ($11.10 in chips) 
Seat 4: FYepjhAvF8ZdVCmqHIy+eQ ($25 in chips) 
Seat 5: 8ClCHtFXGNplITm+63KB+Q ($45.35 in chips) 
Seat 6: kG34n23qFQA3nzdOJTQ1dA ($26.90 in chips) 
kG34n23qFQA3nzdOJTQ1dA: posts small blind $0.10
0HAB2GdCAM7p7V00xueAVQ: posts big blind $0.25
xrf8tAXKQHG99HixCot1Iw: sits out 
*** HOLE CARDS ***
9kUKGKkblnIx3m8rlVol6Q: folds 
FYepjhAvF8ZdVCmqHIy+eQ: folds 
8ClCHtFXGNplITm+63KB+Q: folds 
kG34n23qFQA3nzdOJTQ1dA: folds 
Uncalled bet ($0.15) returned to 0HAB2GdCAM7p7V00xueAVQ
0HAB2GdCAM7p7V00xueAVQ collected $0.20 from pot
*** SUMMARY ***
Total pot $0.20 | Rake $0 
Seat 1: 0HAB2GdCAM7p7V00xueAVQ (big blind) collected ($0.20)
Seat 3: 9kUKGKkblnIx3m8rlVol6Q folded before Flop (didn't bet)
Seat 4: FYepjhAvF8ZdVCmqHIy+eQ folded before Flop (didn't bet)
Seat 5: 8ClCHtFXGNplITm+63KB+Q (button) folded before Flop (didn't bet)
Seat 6: kG34n23qFQA3nzdOJTQ1dA (small blind) folded before Flop




PokerStars Game #59941832390:  Hold'em No Limit ($0.10/$0.25) - 2009/07/01 1:47:34 ET
Table 'WEMI3Mtn7dGARDbgNrKibg' 9-max Seat #4 is the button
Seat 1: Th3FldXKQW6hWVVPahaoOQ ($30.50 in chips) 
Seat 2: tYsOBqdU1+x+yFI7zHO7hQ ($49.20 in chips) 
Seat 3: qwr38jl5txoR36M7G5qi4A ($10 in chips) 
Seat 4: Z5NNIVvnhb2IJbLcI79WYQ ($10.55 in chips) 
Seat 5: yzPZQFeaQTNf1YK3a0zRIw ($9.05 in chips) 
Seat 6: arxNSjreDRGFg13EAM2F1w ($25.45 in chips) 
Seat 7: DnDcAdn9P0zGovMERigpFA ($54.90 in chips) 
Seat 8: ghNKXUBl/H+t83JF079ZBA ($29.60 in chips) 
Seat 9: 2wcFsZsqEP5w1StUTVzJCg ($4.50 in chips) 
yzPZQFeaQTNf1YK3a0zRIw: posts small blind $0.10
arxNSjreDRGFg13EAM2F1w: posts big blind $0.25
*** HOLE CARDS ***
DnDcAdn9P0zGovMERigpFA: folds 
ghNKXUBl/H+t83JF079ZBA: folds 
2wcFsZsqEP5w1StUTVzJCg: folds 
Th3FldXKQW6hWVVPahaoOQ: folds 
tYsOBqdU1+x+yFI7zHO7hQ: raises $0.75 to $1
qwr38jl5txoR36M7G5qi4A: folds 
Z5NNIVvnhb2IJbLcI79WYQ: folds 
yzPZQFeaQTNf1YK3a0zRIw: folds 
arxNSjreDRGFg13EAM2F1w: folds 
Uncalled bet ($0.75) returned to tYsOBqdU1+x+yFI7zHO7hQ
tYsOBqdU1+x+yFI7zHO7hQ collected $0.60 from pot
tYsOBqdU1+x+yFI7zHO7hQ: doesn't show hand 
*** SUMMARY ***
Total pot $0.60 | Rake $0 
Seat 1: Th3FldXKQW6hWVVPahaoOQ folded before Flop (didn't bet)
Seat 2: tYsOBqdU1+x+yFI7zHO7hQ collected ($0.60)
Seat 3: qwr38jl5txoR36M7G5qi4A folded before Flop (didn't bet)
Seat 4: Z5NNIVvnhb2IJbLcI79WYQ (button) folded before Flop (didn't bet)
Seat 5: yzPZQFeaQTNf1YK3a0zRIw (small blind) folded before Flop
Seat 6: arxNSjreDRGFg13EAM2F1w (big blind) folded before Flop
Seat 7: DnDcAdn9P0zGovMERigpFA folded before Flop (didn't bet)
Seat 8: ghNKXUBl/H+t83JF079ZBA folded before Flop (didn't bet)
Seat 9: 2wcFsZsqEP5w1StUTVzJCg folded before Flop (didn't bet)




PokerStars Game #59941832560:  Hold'em No Limit ($0.10/$0.25) - 2009/07/01 1:47:34 ET
Table 'djcjiEGabFQO0MNG6jEeJQ' 9-max Seat #6 is the button
Seat 1: Bb42QRQMhg5/Y0vHP8/2Xw ($25.60 in chips) 
Seat 2: WKL8nUFr7TumC4EjLyqYzw ($5.25 in chips) 
Seat 3: zgi+EUykT/pZQpoUG6+oEg ($4.65 in chips) 
Seat 4: 2wcFsZsqEP5w1StUTVzJCg ($9.55 in chips) 
Seat 6: aNpwfA31EREwO+ar4XzBCw ($78.50 in chips) 
Seat 8: +sbyWwIcFp9kP0bDtMegfQ ($46 in chips) 
Seat 9: HPEB+AtKw1+C/cxU0o1ciw ($46.85 in chips) 
+sbyWwIcFp9kP0bDtMegfQ: posts small blind $0.10
HPEB+AtKw1+C/cxU0o1ciw: posts big blind $0.25
*** HOLE CARDS ***
Bb42QRQMhg5/Y0vHP8/2Xw: folds 
WKL8nUFr7TumC4EjLyqYzw: folds 
zgi+EUykT/pZQpoUG6+oEg: folds 
2wcFsZsqEP5w1StUTVzJCg: folds 
aNpwfA31EREwO+ar4XzBCw: folds 
+sbyWwIcFp9kP0bDtMegfQ: raises $0.75 to $1
HPEB+AtKw1+C/cxU0o1ciw: folds 
Uncalled bet ($0.75) returned to +sbyWwIcFp9kP0bDtMegfQ
+sbyWwIcFp9kP0bDtMegfQ collected $0.50 from pot
+sbyWwIcFp9kP0bDtMegfQ: doesn't show hand 
*** SUMMARY ***
Total pot $0.50 | Rake $0 
Seat 1: Bb42QRQMhg5/Y0vHP8/2Xw folded before Flop (didn't bet)
Seat 2: WKL8nUFr7TumC4EjLyqYzw folded before Flop (didn't bet)
Seat 3: zgi+EUykT/pZQpoUG6+oEg folded before Flop (didn't bet)
Seat 4: 2wcFsZsqEP5w1StUTVzJCg folded before Flop (didn't bet)
Seat 6: aNpwfA31EREwO+ar4XzBCw (button) folded before Flop (didn't bet)
Seat 8: +sbyWwIcFp9kP0bDtMegfQ (small blind) collected ($0.50)
Seat 9: HPEB+AtKw1+C/cxU0o1ciw (big blind) folded before Flop




PokerStars Game #59941832304:  Hold'em No Limit ($0.10/$0.25) - 2009/07/01 1:47:34 ET
Table '4UJB/UOZ5aepyF2v+hIoUg' 6-max Seat #2 is the button
Seat 1: 08V++DOqzaNrRNsHIwi25w ($27 in chips) 
Seat 2: mFv3iBCtrw9XfCDRB0d46Q ($4.20 in chips) 
Seat 3: zlYHXTtJ5tcx9kwK2h5n9A ($44.15 in chips) 
Seat 4: R6AGToFJQOYVZAjC2jXEKw ($21.60 in chips) 
Seat 5: 3zD3qLXT1bEffAoWGnc7wg ($26.15 in chips) 
Seat 6: 2aphcinkTZT0B0Uoah6cvQ ($12.85 in chips) 
zlYHXTtJ5tcx9kwK2h5n9A: posts small blind $0.10
R6AGToFJQOYVZAjC2jXEKw: posts big blind $0.25
*** HOLE CARDS ***
3zD3qLXT1bEffAoWGnc7wg: folds 
2aphcinkTZT0B0Uoah6cvQ: folds 
08V++DOqzaNrRNsHIwi25w: folds 
mFv3iBCtrw9XfCDRB0d46Q: raises $0.25 to $0.50
zlYHXTtJ5tcx9kwK2h5n9A: folds 
R6AGToFJQOYVZAjC2jXEKw: raises $0.75 to $1.25
mFv3iBCtrw9XfCDRB0d46Q: folds 
Uncalled bet ($0.75) returned to R6AGToFJQOYVZAjC2jXEKw
R6AGToFJQOYVZAjC2jXEKw collected $1.10 from pot
R6AGToFJQOYVZAjC2jXEKw: doesn't show hand 
*** SUMMARY ***
Total pot $1.10 | Rake $0 
Seat 1: 08V++DOqzaNrRNsHIwi25w folded before Flop (didn't bet)
Seat 2: mFv3iBCtrw9XfCDRB0d46Q (button) folded before Flop
Seat 3: zlYHXTtJ5tcx9kwK2h5n9A (small blind) folded before Flop
Seat 4: R6AGToFJQOYVZAjC2jXEKw (big blind) collected ($1.10)
Seat 5: 3zD3qLXT1bEffAoWGnc7wg folded before Flop (didn't bet)
Seat 6: 2aphcinkTZT0B0Uoah6cvQ folded before Flop (didn't bet)




PokerStars Game #59941832298:  Hold'em No Limit ($0.10/$0.25) - 2009/07/01 1:47:34 ET
Table 'l57rayEpPtZotP9nqgSWBg' 6-max Seat #2 is the button
Seat 1: DihMHaz4WNETH1bPDe13kA ($58.70 in chips) 
Seat 2: p6adJRMXMBLr+xtQzqazIQ ($15.05 in chips) 
Seat 3: xC0kaiDYM6YTlgODL83O5A ($14.25 in chips) 
Seat 4: OqkdGXy1SCzuN5Q0wNlFSg ($22.35 in chips) 
Seat 5: WKJHaZPUgrpTVyLOEjLYmg ($12.20 in chips) 
Seat 6: IGRfskE1v9H9Bn+fz8AgNQ ($15.55 in chips) 
xC0kaiDYM6YTlgODL83O5A: posts small blind $0.10
OqkdGXy1SCzuN5Q0wNlFSg: posts big blind $0.25
*** HOLE CARDS ***
WKJHaZPUgrpTVyLOEjLYmg: folds 
IGRfskE1v9H9Bn+fz8AgNQ: folds 
DihMHaz4WNETH1bPDe13kA: raises $0.50 to $0.75
p6adJRMXMBLr+xtQzqazIQ: folds 
xC0kaiDYM6YTlgODL83O5A: calls $0.65
OqkdGXy1SCzuN5Q0wNlFSg: calls $0.50
*** FLOP *** [4s Qc 7d]
xC0kaiDYM6YTlgODL83O5A: checks 
OqkdGXy1SCzuN5Q0wNlFSg: checks 
DihMHaz4WNETH1bPDe13kA: bets $1.45
xC0kaiDYM6YTlgODL83O5A: calls $1.45
OqkdGXy1SCzuN5Q0wNlFSg: folds 
*** TURN *** [4s Qc 7d] [5h]
xC0kaiDYM6YTlgODL83O5A: bets $2.50
DihMHaz4WNETH1bPDe13kA: folds 
Uncalled bet ($2.50) returned to xC0kaiDYM6YTlgODL83O5A
xC0kaiDYM6YTlgODL83O5A collected $4.90 from pot
*** SUMMARY ***
Total pot $5.15 | Rake $0.25 
Board [4s Qc 7d 5h]
Seat 1: DihMHaz4WNETH1bPDe13kA folded on the Turn
Seat 2: p6adJRMXMBLr+xtQzqazIQ (button) folded before Flop (didn't bet)
Seat 3: xC0kaiDYM6YTlgODL83O5A (small blind) collected ($4.90)
Seat 4: OqkdGXy1SCzuN5Q0wNlFSg (big blind) folded on the Flop
Seat 5: WKJHaZPUgrpTVyLOEjLYmg folded before Flop (didn't bet)
Seat 6: IGRfskE1v9H9Bn+fz8AgNQ folded before Flop (didn't bet)




PokerStars Game #59941832688:  Hold'em No Limit ($0.10/$0.25) - 2009/07/01 1:47:35 ET
Table 'HzFR0rxmDAPu5GzYR0AlYg' 6-max Seat #5 is the button
Seat 1: v+QfkGiuj9bgtuNoVnDO8w ($32.05 in chips) 
Seat 2: UA5OsKS3VPaxa7uC8La/kA ($51.25 in chips) 
Seat 3: kG34n23qFQA3nzdOJTQ1dA ($24.90 in chips) 
Seat 4: Mhj3q7cxev+XjXZxEE6/Cw ($25.35 in chips) 
Seat 5: lquriepNQBhDV5P1SWHhnA ($29.50 in chips) 
Seat 6: jp34e617tIzV8tKIWmfAbA ($35.65 in chips) 
jp34e617tIzV8tKIWmfAbA: posts small blind $0.10
v+QfkGiuj9bgtuNoVnDO8w: posts big blind $0.25
*** HOLE CARDS ***
UA5OsKS3VPaxa7uC8La/kA: raises $0.75 to $1
kG34n23qFQA3nzdOJTQ1dA: folds 
Mhj3q7cxev+XjXZxEE6/Cw: folds 
lquriepNQBhDV5P1SWHhnA: folds 
jp34e617tIzV8tKIWmfAbA: folds 
v+QfkGiuj9bgtuNoVnDO8w: folds 
Uncalled bet ($0.75) returned to UA5OsKS3VPaxa7uC8La/kA
UA5OsKS3VPaxa7uC8La/kA collected $0.60 from pot
*** SUMMARY ***
Total pot $0.60 | Rake $0 
Seat 1: v+QfkGiuj9bgtuNoVnDO8w (big blind) folded before Flop
Seat 2: UA5OsKS3VPaxa7uC8La/kA collected ($0.60)
Seat 3: kG34n23qFQA3nzdOJTQ1dA folded before Flop (didn't bet)
Seat 4: Mhj3q7cxev+XjXZxEE6/Cw folded before Flop (didn't bet)
Seat 5: lquriepNQBhDV5P1SWHhnA (button) folded before Flop (didn't bet)
Seat 6: jp34e617tIzV8tKIWmfAbA (small blind) folded before Flop




PokerStars Game #59941832892:  Hold'em No Limit ($0.10/$0.25) - 2009/07/01 1:47:35 ET
Table 'AHkg4ChqzcMauBx6Qvz8Nw' 6-max Seat #1 is the button
Seat 1: +RDf7SmUjY2kK0PzdBEYqg ($6.30 in chips) 
Seat 2: Vi0JMrTI2BGrPL7UIulJtA ($5.05 in chips) 
Seat 3: 9dToMv2GJLfi00HcpfMnIw ($27.50 in chips) 
Seat 4: Eznneya0vB6S+eXJdVleHA ($18.90 in chips) 
Seat 5: Bada343Si4xKu3fNXY99AA ($4.20 in chips) 
Seat 6: Hsvkc0/G2VV78oVmWYXecw ($5 in chips) 
Vi0JMrTI2BGrPL7UIulJtA: posts small blind $0.10
9dToMv2GJLfi00HcpfMnIw: posts big blind $0.25
*** HOLE CARDS ***
Eznneya0vB6S+eXJdVleHA: calls $0.25
Bada343Si4xKu3fNXY99AA: folds 
Hsvkc0/G2VV78oVmWYXecw: folds 
+RDf7SmUjY2kK0PzdBEYqg: calls $0.25
Vi0JMrTI2BGrPL7UIulJtA: calls $0.15
9dToMv2GJLfi00HcpfMnIw: checks 
*** FLOP *** [Qs 2c 3c]
Vi0JMrTI2BGrPL7UIulJtA: bets $0.25
9dToMv2GJLfi00HcpfMnIw: calls $0.25
Eznneya0vB6S+eXJdVleHA: calls $0.25
+RDf7SmUjY2kK0PzdBEYqg: folds 
*** TURN *** [Qs 2c 3c] [5h]
Vi0JMrTI2BGrPL7UIulJtA: bets $0.25
9dToMv2GJLfi00HcpfMnIw: calls $0.25
Eznneya0vB6S+eXJdVleHA: raises $0.25 to $0.50
Vi0JMrTI2BGrPL7UIulJtA: calls $0.25
9dToMv2GJLfi00HcpfMnIw: calls $0.25
*** RIVER *** [Qs 2c 3c 5h] [5s]
Vi0JMrTI2BGrPL7UIulJtA: checks 
9dToMv2GJLfi00HcpfMnIw: bets $1
Eznneya0vB6S+eXJdVleHA: calls $1
Vi0JMrTI2BGrPL7UIulJtA: folds 
*** SHOW DOWN ***
9dToMv2GJLfi00HcpfMnIw: shows [9s Qc] (two pair, Queens and Fives)
Eznneya0vB6S+eXJdVleHA: shows [Ts Qd] (two pair, Queens and Fives - Ten kicker)
Eznneya0vB6S+eXJdVleHA collected $5 from pot
*** SUMMARY ***
Total pot $5.25 | Rake $0.25 
Board [Qs 2c 3c 5h 5s]
Seat 1: +RDf7SmUjY2kK0PzdBEYqg (button) folded on the Flop
Seat 2: Vi0JMrTI2BGrPL7UIulJtA (small blind) folded on the River
Seat 3: 9dToMv2GJLfi00HcpfMnIw (big blind) showed [9s Qc] and lost with two pair, Queens and Fives
Seat 4: Eznneya0vB6S+eXJdVleHA showed [Ts Qd] and won ($5) with two pair, Queens and Fives
Seat 5: Bada343Si4xKu3fNXY99AA folded before Flop (didn't bet)
Seat 6: Hsvkc0/G2VV78oVmWYXecw folded before Flop (didn't bet)




PokerStars Game #59941832752:  Hold'em No Limit ($0.10/$0.25) - 2009/07/01 1:47:35 ET
Table 'Pz8SfAzhP5nvWTsJRAxoDg' 6-max Seat #3 is the button
Seat 1: QiL+lEgEWwy21jk/ltaRLg ($47.15 in chips) 
Seat 2: k021eD5in2AjaloW5PalMg ($18.80 in chips) 
Seat 3: mfrkWA3PTeYPkbO6hi98Aw ($24.25 in chips) 
Seat 4: 4lJto+Qj0K4JrFKvHaPTLw ($67.75 in chips) 
Seat 5: FYepjhAvF8ZdVCmqHIy+eQ ($27.05 in chips) 
Seat 6: QvTX2yGq3uKJiKPmns4TKQ ($18.05 in chips) 
4lJto+Qj0K4JrFKvHaPTLw: posts small blind $0.10
FYepjhAvF8ZdVCmqHIy+eQ: posts big blind $0.25
*** HOLE CARDS ***
QvTX2yGq3uKJiKPmns4TKQ: folds 
QiL+lEgEWwy21jk/ltaRLg: folds 
k021eD5in2AjaloW5PalMg: folds 
mfrkWA3PTeYPkbO6hi98Aw: raises $0.75 to $1
4lJto+Qj0K4JrFKvHaPTLw: folds 
FYepjhAvF8ZdVCmqHIy+eQ: calls $0.75
*** FLOP *** [Jd 2s Js]
FYepjhAvF8ZdVCmqHIy+eQ: checks 
mfrkWA3PTeYPkbO6hi98Aw: bets $1.50
FYepjhAvF8ZdVCmqHIy+eQ: calls $1.50
*** TURN *** [Jd 2s Js] [7s]
FYepjhAvF8ZdVCmqHIy+eQ: checks 
mfrkWA3PTeYPkbO6hi98Aw: checks 
*** RIVER *** [Jd 2s Js 7s] [2c]
FYepjhAvF8ZdVCmqHIy+eQ: checks 
mfrkWA3PTeYPkbO6hi98Aw: checks 
*** SHOW DOWN ***
FYepjhAvF8ZdVCmqHIy+eQ: shows [9d Ad] (two pair, Jacks and Deuces)
mfrkWA3PTeYPkbO6hi98Aw: shows [9h 7h] (two pair, Jacks and Sevens)
mfrkWA3PTeYPkbO6hi98Aw collected $4.85 from pot
*** SUMMARY ***
Total pot $5.10 | Rake $0.25 
Board [Jd 2s Js 7s 2c]
Seat 1: QiL+lEgEWwy21jk/ltaRLg folded before Flop (didn't bet)
Seat 2: k021eD5in2AjaloW5PalMg folded before Flop (didn't bet)
Seat 3: mfrkWA3PTeYPkbO6hi98Aw (button) showed [9h 7h] and won ($4.85) with two pair, Jacks and Sevens
Seat 4: 4lJto+Qj0K4JrFKvHaPTLw (small blind) folded before Flop
Seat 5: FYepjhAvF8ZdVCmqHIy+eQ (big blind) showed [9d Ad] and lost with two pair, Jacks and Deuces
Seat 6: QvTX2yGq3uKJiKPmns4TKQ folded before Flop (didn't bet)




PokerStars Game #59941832972:  Hold'em No Limit ($0.10/$0.25) - 2009/07/01 1:47:35 ET
Table 'hg+KpirwreMnBAFQr/SEUA' 9-max Seat #9 is the button
Seat 1: H5Se03ZqSX7tbULXur2MAg ($34.30 in chips) 
Seat 2: cpnBzHjFACn5zAY56UIvNA ($20.60 in chips) 
Seat 3: DdyXKuBx0HAOC7dWZmGxWg ($24.25 in chips) 
Seat 5: +2kMBNpY4nF1qNCRd8SJLA ($25 in chips) 
Seat 6: Bb42QRQMhg5/Y0vHP8/2Xw ($25.35 in chips) 
Seat 7: 5LSuZS4qvcUri/Byfkln7w ($7.25 in chips) 
Seat 8: HPEB+AtKw1+C/cxU0o1ciw ($23.40 in chips) 
Seat 9: xbecloQJYmBOSkzT9lZ+rg ($20 in chips) 
H5Se03ZqSX7tbULXur2MAg: posts small blind $0.10
cpnBzHjFACn5zAY56UIvNA: posts big blind $0.25
Z9W7+g1WMhhZDi7DwGbCFA: sits out 
*** HOLE CARDS ***
DdyXKuBx0HAOC7dWZmGxWg: raises $0.25 to $0.50
+2kMBNpY4nF1qNCRd8SJLA: folds 
Bb42QRQMhg5/Y0vHP8/2Xw: folds 
5LSuZS4qvcUri/Byfkln7w: folds 
HPEB+AtKw1+C/cxU0o1ciw: calls $0.50
xbecloQJYmBOSkzT9lZ+rg: folds 
H5Se03ZqSX7tbULXur2MAg: raises $1.75 to $2.25
cpnBzHjFACn5zAY56UIvNA: folds 
DdyXKuBx0HAOC7dWZmGxWg: calls $1.75
HPEB+AtKw1+C/cxU0o1ciw: folds 
*** FLOP *** [7c Tc 5h]
H5Se03ZqSX7tbULXur2MAg: bets $3.25
DdyXKuBx0HAOC7dWZmGxWg: folds 
Uncalled bet ($3.25) returned to H5Se03ZqSX7tbULXur2MAg
H5Se03ZqSX7tbULXur2MAg collected $5 from pot
*** SUMMARY ***
Total pot $5.25 | Rake $0.25 
Board [7c Tc 5h]
Seat 1: H5Se03ZqSX7tbULXur2MAg (small blind) collected ($5)
Seat 2: cpnBzHjFACn5zAY56UIvNA (big blind) folded before Flop
Seat 3: DdyXKuBx0HAOC7dWZmGxWg folded on the Flop
Seat 5: +2kMBNpY4nF1qNCRd8SJLA folded before Flop (didn't bet)
Seat 6: Bb42QRQMhg5/Y0vHP8/2Xw folded before Flop (didn't bet)
Seat 7: 5LSuZS4qvcUri/Byfkln7w folded before Flop (didn't bet)
Seat 8: HPEB+AtKw1+C/cxU0o1ciw folded before Flop
Seat 9: xbecloQJYmBOSkzT9lZ+rg (button) folded before Flop (didn't bet)




PokerStars Game #59941832844:  Hold'em No Limit ($0.10/$0.25) - 2009/07/01 1:47:35 ET
Table 'K/f0NNaoGuhSz5DrzgVw7Q' 9-max Seat #9 is the button
Seat 1: sD+TKtt36XiiN6jqHiLwDA ($25.80 in chips) 
Seat 2: zgi+EUykT/pZQpoUG6+oEg ($5 in chips) 
Seat 4: 9bCz0uv2nUmznwuI0OjVGw ($13.80 in chips) 
Seat 5: DnDcAdn9P0zGovMERigpFA ($40.60 in chips) 
Seat 6: 3PVK0IdMlq2fElkVzzr4bg ($7.95 in chips) 
Seat 7: egvg3mTBBVzMHnJPIQiKcA ($12.15 in chips) 
Seat 8: RCqMONFrSPSArZh2Jsar/w ($24.65 in chips) 
Seat 9: tLcDklc2rBORNfixyRfVfw ($25 in chips) 
sD+TKtt36XiiN6jqHiLwDA: posts small blind $0.10
zgi+EUykT/pZQpoUG6+oEg: posts big blind $0.25
3PVK0IdMlq2fElkVzzr4bg: posts small & big blinds $0.35
*** HOLE CARDS ***
9bCz0uv2nUmznwuI0OjVGw: calls $0.25
DnDcAdn9P0zGovMERigpFA: folds 
3PVK0IdMlq2fElkVzzr4bg: checks 
egvg3mTBBVzMHnJPIQiKcA: raises $0.50 to $0.75
RCqMONFrSPSArZh2Jsar/w: folds 
tLcDklc2rBORNfixyRfVfw: folds 
sD+TKtt36XiiN6jqHiLwDA: folds 
zgi+EUykT/pZQpoUG6+oEg: folds 
9bCz0uv2nUmznwuI0OjVGw: calls $0.50
3PVK0IdMlq2fElkVzzr4bg: folds 
*** FLOP *** [8d Jh 9h]
9bCz0uv2nUmznwuI0OjVGw: bets $0.25
egvg3mTBBVzMHnJPIQiKcA: raises $0.50 to $0.75
9bCz0uv2nUmznwuI0OjVGw: calls $0.50
*** TURN *** [8d Jh 9h] [9s]
9bCz0uv2nUmznwuI0OjVGw: bets $0.25
egvg3mTBBVzMHnJPIQiKcA: calls $0.25
*** RIVER *** [8d Jh 9h 9s] [5s]
9bCz0uv2nUmznwuI0OjVGw: bets $0.25
egvg3mTBBVzMHnJPIQiKcA: calls $0.25
*** SHOW DOWN ***
9bCz0uv2nUmznwuI0OjVGw: shows [Kc Qs] (a pair of Nines)
egvg3mTBBVzMHnJPIQiKcA: shows [Qc Js] (two pair, Jacks and Nines)
egvg3mTBBVzMHnJPIQiKcA collected $4.50 from pot
*** SUMMARY ***
Total pot $4.70 | Rake $0.20 
Board [8d Jh 9h 9s 5s]
Seat 1: sD+TKtt36XiiN6jqHiLwDA (small blind) folded before Flop
Seat 2: zgi+EUykT/pZQpoUG6+oEg (big blind) folded before Flop
Seat 4: 9bCz0uv2nUmznwuI0OjVGw showed [Kc Qs] and lost with a pair of Nines
Seat 5: DnDcAdn9P0zGovMERigpFA folded before Flop (didn't bet)
Seat 6: 3PVK0IdMlq2fElkVzzr4bg folded before Flop
Seat 7: egvg3mTBBVzMHnJPIQiKcA showed [Qc Js] and won ($4.50) with two pair, Jacks and Nines
Seat 8: RCqMONFrSPSArZh2Jsar/w folded before Flop (didn't bet)
Seat 9: tLcDklc2rBORNfixyRfVfw (button) folded before Flop (didn't bet)




PokerStars Game #59941833578:  Hold'em No Limit ($0.10/$0.25) - 2009/07/01 1:47:36 ET
Table '4mnXP0EWt9mMZYzTIVDQ0w' 9-max Seat #8 is the button
Seat 1: Z5y2J55JmfLYR6/DPAGHwQ ($21.10 in chips) 
Seat 2: BLEU2x2bnGRovIelAY6slA ($25.15 in chips) 
Seat 4: 9lvO/qyU+xrU95Teu1fv0g ($6.50 in chips) 
Seat 5: sSN8Y0AlsBeidZXPKmwXSw ($25.10 in chips) 
Seat 6: 5yjzPss7Y4kAWNDat3e0yQ ($35.65 in chips) 
Seat 7: TtioUKOdJQDGtQyRAYC5Xg ($6 in chips) 
Seat 8: 9YN2IkT2JYYKFErZtZvCtA ($13.10 in chips) 
Seat 9: N/O9ADKpmqB2ASZuqgodlw ($9.15 in chips) 
N/O9ADKpmqB2ASZuqgodlw: posts small blind $0.10
Z5y2J55JmfLYR6/DPAGHwQ: posts big blind $0.25
ompa52: sits out 
TtioUKOdJQDGtQyRAYC5Xg: posts big blind $0.25
*** HOLE CARDS ***
BLEU2x2bnGRovIelAY6slA: calls $0.25
9lvO/qyU+xrU95Teu1fv0g: folds 
sSN8Y0AlsBeidZXPKmwXSw: folds 
5yjzPss7Y4kAWNDat3e0yQ: folds 
TtioUKOdJQDGtQyRAYC5Xg: checks 
9YN2IkT2JYYKFErZtZvCtA: calls $0.25
N/O9ADKpmqB2ASZuqgodlw: calls $0.15
Z5y2J55JmfLYR6/DPAGHwQ: checks 
*** FLOP *** [3h 9d 4c]
N/O9ADKpmqB2ASZuqgodlw: checks 
Z5y2J55JmfLYR6/DPAGHwQ: checks 
BLEU2x2bnGRovIelAY6slA: checks 
TtioUKOdJQDGtQyRAYC5Xg: checks 
9YN2IkT2JYYKFErZtZvCtA: bets $1
N/O9ADKpmqB2ASZuqgodlw: folds 
Z5y2J55JmfLYR6/DPAGHwQ: folds 
BLEU2x2bnGRovIelAY6slA: folds 
TtioUKOdJQDGtQyRAYC5Xg: folds 
Uncalled bet ($1) returned to 9YN2IkT2JYYKFErZtZvCtA
9YN2IkT2JYYKFErZtZvCtA collected $1.20 from pot
9YN2IkT2JYYKFErZtZvCtA: doesn't show hand 
*** SUMMARY ***
Total pot $1.25 | Rake $0.05 
Board [3h 9d 4c]
Seat 1: Z5y2J55JmfLYR6/DPAGHwQ (big blind) folded on the Flop
Seat 2: BLEU2x2bnGRovIelAY6slA folded on the Flop
Seat 4: 9lvO/qyU+xrU95Teu1fv0g folded before Flop (didn't bet)
Seat 5: sSN8Y0AlsBeidZXPKmwXSw folded before Flop (didn't bet)
Seat 6: 5yjzPss7Y4kAWNDat3e0yQ folded before Flop (didn't bet)
Seat 7: TtioUKOdJQDGtQyRAYC5Xg folded on the Flop
Seat 8: 9YN2IkT2JYYKFErZtZvCtA (button) collected ($1.20)
Seat 9: N/O9ADKpmqB2ASZuqgodlw (small blind) folded on the Flop




PokerStars Game #59941833244:  Hold'em No Limit ($0.10/$0.25) - 2009/07/01 1:47:36 ET
Table 'GrYi0DZOHD1EvB+qiLExNw' 9-max Seat #5 is the button
Seat 2: Th3FldXKQW6hWVVPahaoOQ ($46.70 in chips) 
Seat 3: RHqgdFvufLCYe54+qd2gcA ($4.75 in chips) 
Seat 4: 8x95tVlB4uFBVHp71KihMA ($35.40 in chips) 
Seat 5: cZ99hugmLBj9KhTlc8nCSw ($25 in chips) 
Seat 6: arxNSjreDRGFg13EAM2F1w ($25.35 in chips) 
Seat 7: 9lvO/qyU+xrU95Teu1fv0g ($23.55 in chips) 
Seat 8: MtVtHDqIJTyUcXkRBBDIVA ($25 in chips) 
Seat 9: 5hAPbqNrvJb8PtLiceXtlg ($13.40 in chips) 
arxNSjreDRGFg13EAM2F1w: posts small blind $0.10
9lvO/qyU+xrU95Teu1fv0g: posts big blind $0.25
7je+LC5Mfs6nL8YBVh4frQ: sits out 
*** HOLE CARDS ***
MtVtHDqIJTyUcXkRBBDIVA: folds 
5hAPbqNrvJb8PtLiceXtlg: calls $0.25
Th3FldXKQW6hWVVPahaoOQ: folds 
RHqgdFvufLCYe54+qd2gcA: folds 
8x95tVlB4uFBVHp71KihMA: folds 
cZ99hugmLBj9KhTlc8nCSw: folds 
arxNSjreDRGFg13EAM2F1w: folds 
9lvO/qyU+xrU95Teu1fv0g: checks 
*** FLOP *** [Kc 7s 9c]
9lvO/qyU+xrU95Teu1fv0g: checks 
5hAPbqNrvJb8PtLiceXtlg: bets $0.25
9lvO/qyU+xrU95Teu1fv0g: folds 
Uncalled bet ($0.25) returned to 5hAPbqNrvJb8PtLiceXtlg
5hAPbqNrvJb8PtLiceXtlg collected $0.60 from pot
*** SUMMARY ***
Total pot $0.60 | Rake $0 
Board [Kc 7s 9c]
Seat 2: Th3FldXKQW6hWVVPahaoOQ folded before Flop (didn't bet)
Seat 3: RHqgdFvufLCYe54+qd2gcA folded before Flop (didn't bet)
Seat 4: 8x95tVlB4uFBVHp71KihMA folded before Flop (didn't bet)
Seat 5: cZ99hugmLBj9KhTlc8nCSw (button) folded before Flop (didn't bet)
Seat 6: arxNSjreDRGFg13EAM2F1w (small blind) folded before Flop
Seat 7: 9lvO/qyU+xrU95Teu1fv0g (big blind) folded on the Flop
Seat 8: MtVtHDqIJTyUcXkRBBDIVA folded before Flop (didn't bet)
Seat 9: 5hAPbqNrvJb8PtLiceXtlg collected ($0.60)




PokerStars Game #59941833182:  Hold'em No Limit ($0.10/$0.25) - 2009/07/01 1:47:36 ET
Table 'GgmUtmhrYPRnhkqEEjD/Kw' 9-max Seat #6 is the button
Seat 2: ghNKXUBl/H+t83JF079ZBA ($25.15 in chips) 
Seat 3: dYvYZ723QlKIPiDa0pkedQ ($8.25 in chips) 
Seat 4: dfNim92Z6XK1/h5SFW5vDg ($25 in chips) 
Seat 5: ljemhp25Zg+nlA9DLCIiUw ($26.50 in chips) 
Seat 6: 4Ax0vobe1rLVIGZmkFINGA ($19.25 in chips) 
Seat 7: YwDw9cMqkbMznFK77rru4A ($4.65 in chips) 
Seat 8: DdPXdieucQ+n99u1n3A+rQ ($4.65 in chips) 
Seat 9: V6p0jQ/RhUsqpHLmXvEX4Q ($15.55 in chips) 
YwDw9cMqkbMznFK77rru4A: posts small blind $0.10
DdPXdieucQ+n99u1n3A+rQ: posts big blind $0.25
bXpVeaSTPBFSPJmeXxO7nw: sits out 
*** HOLE CARDS ***
V6p0jQ/RhUsqpHLmXvEX4Q: folds 
ghNKXUBl/H+t83JF079ZBA: folds 
dYvYZ723QlKIPiDa0pkedQ: folds 
dfNim92Z6XK1/h5SFW5vDg: folds 
ljemhp25Zg+nlA9DLCIiUw: raises $0.50 to $0.75
4Ax0vobe1rLVIGZmkFINGA: folds 
YwDw9cMqkbMznFK77rru4A: folds 
DdPXdieucQ+n99u1n3A+rQ: folds 
Uncalled bet ($0.50) returned to ljemhp25Zg+nlA9DLCIiUw
ljemhp25Zg+nlA9DLCIiUw collected $0.60 from pot
ljemhp25Zg+nlA9DLCIiUw: doesn't show hand 
*** SUMMARY ***
Total pot $0.60 | Rake $0 
Seat 2: ghNKXUBl/H+t83JF079ZBA folded before Flop (didn't bet)
Seat 3: dYvYZ723QlKIPiDa0pkedQ folded before Flop (didn't bet)
Seat 4: dfNim92Z6XK1/h5SFW5vDg folded before Flop (didn't bet)
Seat 5: ljemhp25Zg+nlA9DLCIiUw collected ($0.60)
Seat 6: 4Ax0vobe1rLVIGZmkFINGA (button) folded before Flop (didn't bet)
Seat 7: YwDw9cMqkbMznFK77rru4A (small blind) folded before Flop
Seat 8: DdPXdieucQ+n99u1n3A+rQ (big blind) folded before Flop
Seat 9: V6p0jQ/RhUsqpHLmXvEX4Q folded before Flop (didn't bet)




PokerStars Game #59941833284:  Hold'em No Limit ($0.10/$0.25) - 2009/07/01 1:47:36 ET
Table 'ER5H84HUgJx7HyDLnELLeA' 6-max Seat #6 is the button
Seat 1: LJI7A1YgDM7hgh7o56+ReQ ($27.25 in chips) 
Seat 2: buyjetgNT1McXtdaP4zynA ($20.10 in chips) 
Seat 4: vqWjZmdQu/Hxw96/IJTWdQ ($25 in chips) 
Seat 5: mfrkWA3PTeYPkbO6hi98Aw ($26.35 in chips) 
Seat 6: 3zD3qLXT1bEffAoWGnc7wg ($51 in chips) 
LJI7A1YgDM7hgh7o56+ReQ: posts small blind $0.10
buyjetgNT1McXtdaP4zynA: posts big blind $0.25
cS21pIxRHx5Gt42o7hPZzw: sits out 
*** HOLE CARDS ***
vqWjZmdQu/Hxw96/IJTWdQ: folds 
mfrkWA3PTeYPkbO6hi98Aw: folds 
3zD3qLXT1bEffAoWGnc7wg: folds 
LJI7A1YgDM7hgh7o56+ReQ: raises $0.75 to $1
buyjetgNT1McXtdaP4zynA: calls $0.75
*** FLOP *** [3c Jd Th]
LJI7A1YgDM7hgh7o56+ReQ: checks 
buyjetgNT1McXtdaP4zynA: bets $1
LJI7A1YgDM7hgh7o56+ReQ: folds 
Uncalled bet ($1) returned to buyjetgNT1McXtdaP4zynA
buyjetgNT1McXtdaP4zynA collected $1.90 from pot
*** SUMMARY ***
Total pot $2 | Rake $0.10 
Board [3c Jd Th]
Seat 1: LJI7A1YgDM7hgh7o56+ReQ (small blind) folded on the Flop
Seat 2: buyjetgNT1McXtdaP4zynA (big blind) collected ($1.90)
Seat 4: vqWjZmdQu/Hxw96/IJTWdQ folded before Flop (didn't bet)
Seat 5: mfrkWA3PTeYPkbO6hi98Aw folded before Flop (didn't bet)
Seat 6: 3zD3qLXT1bEffAoWGnc7wg (button) folded before Flop (didn't bet)




PokerStars Game #59941833624:  Hold'em No Limit ($0.10/$0.25) - 2009/07/01 1:47:36 ET
Table 'pPgW4R3kdH26lLi1MnE92w' 9-max Seat #3 is the button
Seat 1: F4P6SxCNY4vxdb318G9RwA ($18.60 in chips) 
Seat 2: cZ99hugmLBj9KhTlc8nCSw ($27.15 in chips) 
Seat 3: WaS7+xnv4bIVHoru6nxczA ($13.25 in chips) 
Seat 4: iZ1f67Ok/207yzIQOu1Kdg ($4.75 in chips) 
Seat 5: HPEB+AtKw1+C/cxU0o1ciw ($22.25 in chips) 
Seat 6: VllYilcih0t+gMD4GTRlgQ ($25.40 in chips) 
Seat 7: sD+TKtt36XiiN6jqHiLwDA ($29.05 in chips) 
Seat 8: clJsV3v77RS07bDKY+705w ($5 in chips) 
Seat 9: tcbEu7VzyHQ+0lh+skbQhQ ($65.40 in chips) 
iZ1f67Ok/207yzIQOu1Kdg: posts small blind $0.10
HPEB+AtKw1+C/cxU0o1ciw: posts big blind $0.25
*** HOLE CARDS ***
VllYilcih0t+gMD4GTRlgQ: folds 
sD+TKtt36XiiN6jqHiLwDA: folds 
clJsV3v77RS07bDKY+705w: folds 
VllYilcih0t+gMD4GTRlgQ leaves the table
tcbEu7VzyHQ+0lh+skbQhQ: folds 
F4P6SxCNY4vxdb318G9RwA: folds 
+qc/EYCgLC65SpGvr35eNg joins the table at seat #6 
cZ99hugmLBj9KhTlc8nCSw: folds 
WaS7+xnv4bIVHoru6nxczA: calls $0.25
iZ1f67Ok/207yzIQOu1Kdg: folds 
HPEB+AtKw1+C/cxU0o1ciw: checks 
*** FLOP *** [2s 4d 3h]
HPEB+AtKw1+C/cxU0o1ciw: checks 
WaS7+xnv4bIVHoru6nxczA: bets $0.50
HPEB+AtKw1+C/cxU0o1ciw: calls $0.50
*** TURN *** [2s 4d 3h] [2d]
HPEB+AtKw1+C/cxU0o1ciw: checks 
WaS7+xnv4bIVHoru6nxczA: bets $0.25
HPEB+AtKw1+C/cxU0o1ciw: calls $0.25
*** RIVER *** [2s 4d 3h 2d] [2h]
HPEB+AtKw1+C/cxU0o1ciw: checks 
WaS7+xnv4bIVHoru6nxczA: checks 
*** SHOW DOWN ***
HPEB+AtKw1+C/cxU0o1ciw: shows [5s 7s] (three of a kind, Deuces)
WaS7+xnv4bIVHoru6nxczA: shows [Qh Ks] (three of a kind, Deuces - King kicker)
WaS7+xnv4bIVHoru6nxczA collected $2 from pot
*** SUMMARY ***
Total pot $2.10 | Rake $0.10 
Board [2s 4d 3h 2d 2h]
Seat 1: F4P6SxCNY4vxdb318G9RwA folded before Flop (didn't bet)
Seat 2: cZ99hugmLBj9KhTlc8nCSw folded before Flop (didn't bet)
Seat 3: WaS7+xnv4bIVHoru6nxczA (button) showed [Qh Ks] and won ($2) with three of a kind, Deuces
Seat 4: iZ1f67Ok/207yzIQOu1Kdg (small blind) folded before Flop
Seat 5: HPEB+AtKw1+C/cxU0o1ciw (big blind) showed [5s 7s] and lost with three of a kind, Deuces
Seat 6: VllYilcih0t+gMD4GTRlgQ folded before Flop (didn't bet)
Seat 7: sD+TKtt36XiiN6jqHiLwDA folded before Flop (didn't bet)
Seat 8: clJsV3v77RS07bDKY+705w folded before Flop (didn't bet)
Seat 9: tcbEu7VzyHQ+0lh+skbQhQ folded before Flop (didn't bet)




PokerStars Game #59941833272:  Hold'em No Limit ($0.10/$0.25) - 2009/07/01 1:47:36 ET
Table 'RUOqTfzbAVGS5x+J9aZMHA' 9-max Seat #5 is the button
Seat 1: DnDcAdn9P0zGovMERigpFA ($26.15 in chips) 
Seat 2: Z5ZtGOON8kmSdSCll9Z3XA ($8 in chips) 
Seat 3: Th3FldXKQW6hWVVPahaoOQ ($25 in chips) 
Seat 4: K9Az8li/CO2TicltVWKamA ($33.50 in chips) 
Seat 5: MtVtHDqIJTyUcXkRBBDIVA ($26.30 in chips) 
Seat 6: ljemhp25Zg+nlA9DLCIiUw ($48.10 in chips) 
Seat 7: zgi+EUykT/pZQpoUG6+oEg ($4.30 in chips) 
Seat 8: dfNim92Z6XK1/h5SFW5vDg ($29.20 in chips) 
Seat 9: cZ99hugmLBj9KhTlc8nCSw ($25 in chips) 
ljemhp25Zg+nlA9DLCIiUw: posts small blind $0.10
zgi+EUykT/pZQpoUG6+oEg: posts big blind $0.25
*** HOLE CARDS ***
dfNim92Z6XK1/h5SFW5vDg: folds 
cZ99hugmLBj9KhTlc8nCSw: folds 
DnDcAdn9P0zGovMERigpFA: folds 
Z5ZtGOON8kmSdSCll9Z3XA: folds 
Th3FldXKQW6hWVVPahaoOQ: folds 
K9Az8li/CO2TicltVWKamA: raises $1 to $1.25
MtVtHDqIJTyUcXkRBBDIVA: calls $1.25
ljemhp25Zg+nlA9DLCIiUw: folds 
zgi+EUykT/pZQpoUG6+oEg: folds 
*** FLOP *** [5d Ts 4d]
K9Az8li/CO2TicltVWKamA: checks 
MtVtHDqIJTyUcXkRBBDIVA: checks 
*** TURN *** [5d Ts 4d] [Jc]
K9Az8li/CO2TicltVWKamA: checks 
MtVtHDqIJTyUcXkRBBDIVA: bets $2
K9Az8li/CO2TicltVWKamA: calls $2
*** RIVER *** [5d Ts 4d Jc] [Kc]
K9Az8li/CO2TicltVWKamA: checks 
MtVtHDqIJTyUcXkRBBDIVA: bets $3.50
K9Az8li/CO2TicltVWKamA: calls $3.50
*** SHOW DOWN ***
MtVtHDqIJTyUcXkRBBDIVA: shows [5s 5h] (three of a kind, Fives)
K9Az8li/CO2TicltVWKamA: mucks hand 
MtVtHDqIJTyUcXkRBBDIVA collected $13.20 from pot
*** SUMMARY ***
Total pot $13.85 | Rake $0.65 
Board [5d Ts 4d Jc Kc]
Seat 1: DnDcAdn9P0zGovMERigpFA folded before Flop (didn't bet)
Seat 2: Z5ZtGOON8kmSdSCll9Z3XA folded before Flop (didn't bet)
Seat 3: Th3FldXKQW6hWVVPahaoOQ folded before Flop (didn't bet)
Seat 4: K9Az8li/CO2TicltVWKamA mucked
Seat 5: MtVtHDqIJTyUcXkRBBDIVA (button) showed [5s 5h] and won ($13.20) with three of a kind, Fives
Seat 6: ljemhp25Zg+nlA9DLCIiUw (small blind) folded before Flop
Seat 7: zgi+EUykT/pZQpoUG6+oEg (big blind) folded before Flop
Seat 8: dfNim92Z6XK1/h5SFW5vDg folded before Flop (didn't bet)
Seat 9: cZ99hugmLBj9KhTlc8nCSw folded before Flop (didn't bet)




PokerStars Game #59941833598:  Hold'em No Limit ($0.10/$0.25) - 2009/07/01 1:47:36 ET
Table 'iMiAw/kTZXopgYX4HI7sHg' 9-max Seat #5 is the button
Seat 1: PdIasPkzm2sqZnN41ZRXOg ($5 in chips) 
Seat 2: qwr38jl5txoR36M7G5qi4A ($8.25 in chips) 
Seat 3: HPEB+AtKw1+C/cxU0o1ciw ($27.90 in chips) 
Seat 4: Z9W7+g1WMhhZDi7DwGbCFA ($5 in chips) 
Seat 5: 22dIObOuor/A+IKWkNoAlA ($5.35 in chips) 
Seat 6: Bb42QRQMhg5/Y0vHP8/2Xw ($29.15 in chips) 
Seat 7: ipLwYjdAXnvG54zETKPvbQ ($15 in chips) 
Seat 8: tLcDklc2rBORNfixyRfVfw ($29.90 in chips) 
Seat 9: 7cv+9Zc9HIQHNvYsMfV3uA ($25 in chips) 
Bb42QRQMhg5/Y0vHP8/2Xw: posts small blind $0.10
ipLwYjdAXnvG54zETKPvbQ: posts big blind $0.25
*** HOLE CARDS ***
tLcDklc2rBORNfixyRfVfw: folds 
7cv+9Zc9HIQHNvYsMfV3uA: folds 
PdIasPkzm2sqZnN41ZRXOg: folds 
qwr38jl5txoR36M7G5qi4A: folds 
HPEB+AtKw1+C/cxU0o1ciw: folds 
Z9W7+g1WMhhZDi7DwGbCFA: folds 
22dIObOuor/A+IKWkNoAlA: raises $0.75 to $1
Bb42QRQMhg5/Y0vHP8/2Xw: folds 
ipLwYjdAXnvG54zETKPvbQ: folds 
Uncalled bet ($0.75) returned to 22dIObOuor/A+IKWkNoAlA
22dIObOuor/A+IKWkNoAlA collected $0.60 from pot
22dIObOuor/A+IKWkNoAlA: doesn't show hand 
*** SUMMARY ***
Total pot $0.60 | Rake $0 
Seat 1: PdIasPkzm2sqZnN41ZRXOg folded before Flop (didn't bet)
Seat 2: qwr38jl5txoR36M7G5qi4A folded before Flop (didn't bet)
Seat 3: HPEB+AtKw1+C/cxU0o1ciw folded before Flop (didn't bet)
Seat 4: Z9W7+g1WMhhZDi7DwGbCFA folded before Flop (didn't bet)
Seat 5: 22dIObOuor/A+IKWkNoAlA (button) collected ($0.60)
Seat 6: Bb42QRQMhg5/Y0vHP8/2Xw (small blind) folded before Flop
Seat 7: ipLwYjdAXnvG54zETKPvbQ (big blind) folded before Flop
Seat 8: tLcDklc2rBORNfixyRfVfw folded before Flop (didn't bet)
Seat 9: 7cv+9Zc9HIQHNvYsMfV3uA folded before Flop (didn't bet)




PokerStars Game #59941833432:  Hold'em No Limit ($0.10/$0.25) - 2009/07/01 1:47:36 ET
Table 'rjcb+nlE+0GuJ6lBhuCkkA' 6-max Seat #3 is the button
Seat 1: lBoEwOFgzcERLIRUkUoRTw ($13.25 in chips) 
Seat 2: lJphax9e7/+O/3YCKPJ0yQ ($7.35 in chips) 
Seat 3: 8ClCHtFXGNplITm+63KB+Q ($66.20 in chips) 
Seat 4: BV+K0Phf5VBHr7aZPKqbUQ ($35.25 in chips) 
Seat 5: GC/9yVD59DUCX7hUI7gcLw ($29 in chips) 
Seat 6: 32YL2ZEp8NT4JB2RVM9euQ ($16.05 in chips) 
BV+K0Phf5VBHr7aZPKqbUQ: posts small blind $0.10
GC/9yVD59DUCX7hUI7gcLw: posts big blind $0.25
*** HOLE CARDS ***
32YL2ZEp8NT4JB2RVM9euQ: folds 
lBoEwOFgzcERLIRUkUoRTw: folds 
lJphax9e7/+O/3YCKPJ0yQ: calls $0.25
8ClCHtFXGNplITm+63KB+Q: folds 
BV+K0Phf5VBHr7aZPKqbUQ: folds 
GC/9yVD59DUCX7hUI7gcLw: checks 
*** FLOP *** [5s 6d 9h]
GC/9yVD59DUCX7hUI7gcLw: checks 
lJphax9e7/+O/3YCKPJ0yQ: bets $0.50
GC/9yVD59DUCX7hUI7gcLw: folds 
Uncalled bet ($0.50) returned to lJphax9e7/+O/3YCKPJ0yQ
lJphax9e7/+O/3YCKPJ0yQ collected $0.60 from pot
*** SUMMARY ***
Total pot $0.60 | Rake $0 
Board [5s 6d 9h]
Seat 1: lBoEwOFgzcERLIRUkUoRTw folded before Flop (didn't bet)
Seat 2: lJphax9e7/+O/3YCKPJ0yQ collected ($0.60)
Seat 3: 8ClCHtFXGNplITm+63KB+Q (button) folded before Flop (didn't bet)
Seat 4: BV+K0Phf5VBHr7aZPKqbUQ (small blind) folded before Flop
Seat 5: GC/9yVD59DUCX7hUI7gcLw (big blind) folded on the Flop
Seat 6: 32YL2ZEp8NT4JB2RVM9euQ folded before Flop (didn't bet)




PokerStars Game #59941833522:  Hold'em No Limit ($0.10/$0.25) - 2009/07/01 1:47:36 ET
Table 'NtEQAxCeIK2io1CGtW658g' 6-max Seat #6 is the button
Seat 1: X437kMQ7AujoaDgjguhU9w ($11.45 in chips) 
Seat 2: DgyznDqq/mLiCqQGMzc+Aw ($10 in chips) 
Seat 3: 5nwDw10uIM0XEyLhla0oGA ($23.75 in chips) 
Seat 4: 8296 ($9.45 in chips) 
Seat 5: Hsvkc0/G2VV78oVmWYXecw ($6.85 in chips) 
Seat 6: /gJNBeCkWL4o85/jvlZ4BA ($64.35 in chips) 
X437kMQ7AujoaDgjguhU9w: posts small blind $0.10
DgyznDqq/mLiCqQGMzc+Aw: posts big blind $0.25
*** HOLE CARDS ***
5nwDw10uIM0XEyLhla0oGA: raises $0.25 to $0.50
8296: folds 
Hsvkc0/G2VV78oVmWYXecw: folds 
/gJNBeCkWL4o85/jvlZ4BA: folds 
X437kMQ7AujoaDgjguhU9w: calls $0.40
DgyznDqq/mLiCqQGMzc+Aw: folds 
*** FLOP *** [6c Qh Qd]
X437kMQ7AujoaDgjguhU9w: checks 
5nwDw10uIM0XEyLhla0oGA: bets $1.25
X437kMQ7AujoaDgjguhU9w: folds 
Uncalled bet ($1.25) returned to 5nwDw10uIM0XEyLhla0oGA
5nwDw10uIM0XEyLhla0oGA collected $1.20 from pot
*** SUMMARY ***
Total pot $1.25 | Rake $0.05 
Board [6c Qh Qd]
Seat 1: X437kMQ7AujoaDgjguhU9w (small blind) folded on the Flop
Seat 2: DgyznDqq/mLiCqQGMzc+Aw (big blind) folded before Flop
Seat 3: 5nwDw10uIM0XEyLhla0oGA collected ($1.20)
Seat 4: 8296 folded before Flop (didn't bet)
Seat 5: Hsvkc0/G2VV78oVmWYXecw folded before Flop (didn't bet)
Seat 6: /gJNBeCkWL4o85/jvlZ4BA (button) folded before Flop (didn't bet)




PokerStars Game #59941833192:  Hold'em No Limit ($0.10/$0.25) - 2009/07/01 1:47:36 ET
Table 'rtxA1Y01Nrq5VoyzTAuusQ' 9-max Seat #9 is the button
Seat 1: w1ukf8uPa4+WH561TtVRxA ($26.65 in chips) 
Seat 2: Th3FldXKQW6hWVVPahaoOQ ($25 in chips) 
Seat 3: K9fS1IUr5GpiJG7VkJ7IbA ($8.05 in chips) 
Seat 4: RHqgdFvufLCYe54+qd2gcA ($4.65 in chips) 
Seat 5: MtVtHDqIJTyUcXkRBBDIVA ($29.90 in chips) 
Seat 8: DnDcAdn9P0zGovMERigpFA ($25 in chips) 
Seat 9: HPEB+AtKw1+C/cxU0o1ciw ($22.35 in chips) 
w1ukf8uPa4+WH561TtVRxA: posts small blind $0.10
Th3FldXKQW6hWVVPahaoOQ: posts big blind $0.25
W6tExOcYX7qiy6Qdp+ZwFA: sits out 
*** HOLE CARDS ***
K9fS1IUr5GpiJG7VkJ7IbA: raises $0.25 to $0.50
RHqgdFvufLCYe54+qd2gcA: folds 
MtVtHDqIJTyUcXkRBBDIVA: calls $0.50
DnDcAdn9P0zGovMERigpFA: folds 
HPEB+AtKw1+C/cxU0o1ciw: folds 
w1ukf8uPa4+WH561TtVRxA: folds 
Th3FldXKQW6hWVVPahaoOQ: folds 
*** FLOP *** [3c 8d 3s]
K9fS1IUr5GpiJG7VkJ7IbA: checks 
MtVtHDqIJTyUcXkRBBDIVA: checks 
*** TURN *** [3c 8d 3s] [2s]
K9fS1IUr5GpiJG7VkJ7IbA: checks 
MtVtHDqIJTyUcXkRBBDIVA: bets $0.50
K9fS1IUr5GpiJG7VkJ7IbA: folds 
Uncalled bet ($0.50) returned to MtVtHDqIJTyUcXkRBBDIVA
MtVtHDqIJTyUcXkRBBDIVA collected $1.30 from pot
MtVtHDqIJTyUcXkRBBDIVA: doesn't show hand 
*** SUMMARY ***
Total pot $1.35 | Rake $0.05 
Board [3c 8d 3s 2s]
Seat 1: w1ukf8uPa4+WH561TtVRxA (small blind) folded before Flop
Seat 2: Th3FldXKQW6hWVVPahaoOQ (big blind) folded before Flop
Seat 3: K9fS1IUr5GpiJG7VkJ7IbA folded on the Turn
Seat 4: RHqgdFvufLCYe54+qd2gcA folded before Flop (didn't bet)
Seat 5: MtVtHDqIJTyUcXkRBBDIVA collected ($1.30)
Seat 8: DnDcAdn9P0zGovMERigpFA folded before Flop (didn't bet)
Seat 9: HPEB+AtKw1+C/cxU0o1ciw (button) folded before Flop (didn't bet)




PokerStars Game #59941833716:  Hold'em No Limit ($0.10/$0.25) - 2009/07/01 1:47:37 ET
Table '3Ns9nuTkynfwbBfBXzg6ww' 6-max Seat #3 is the button
Seat 1: epAUIB7h2FJXzUPRIvSkRA ($25.70 in chips) 
Seat 2: zxeVQGaMKDsDzmSY+AInjA ($31.65 in chips) 
Seat 3: eL3+wCBjFGfQ5FMdIZihwA ($23.95 in chips) 
Seat 4: qGHGf/553gQnDoklMRe3tg ($30.35 in chips) 
Seat 5: wqphQtauX5Qn7WRJZS1flA ($24.05 in chips) 
Seat 6: DE9hRlt14g+JdsRQ4wT7hg ($39.10 in chips) 
qGHGf/553gQnDoklMRe3tg: posts small blind $0.10
wqphQtauX5Qn7WRJZS1flA: posts big blind $0.25
*** HOLE CARDS ***
DE9hRlt14g+JdsRQ4wT7hg: folds 
epAUIB7h2FJXzUPRIvSkRA: folds 
zxeVQGaMKDsDzmSY+AInjA: folds 
eL3+wCBjFGfQ5FMdIZihwA: folds 
qGHGf/553gQnDoklMRe3tg: folds 
Uncalled bet ($0.15) returned to wqphQtauX5Qn7WRJZS1flA
wqphQtauX5Qn7WRJZS1flA collected $0.20 from pot
wqphQtauX5Qn7WRJZS1flA: doesn't show hand 
*** SUMMARY ***
Total pot $0.20 | Rake $0 
Seat 1: epAUIB7h2FJXzUPRIvSkRA folded before Flop (didn't bet)
Seat 2: zxeVQGaMKDsDzmSY+AInjA folded before Flop (didn't bet)
Seat 3: eL3+wCBjFGfQ5FMdIZihwA (button) folded before Flop (didn't bet)
Seat 4: qGHGf/553gQnDoklMRe3tg (small blind) folded before Flop
Seat 5: wqphQtauX5Qn7WRJZS1flA (big blind) collected ($0.20)
Seat 6: DE9hRlt14g+JdsRQ4wT7hg folded before Flop (didn't bet)




PokerStars Game #59941834104:  Hold'em No Limit ($0.10/$0.25) - 2009/07/01 1:47:37 ET
Table 'ROYvQOMwUrvL3SOiHYcrWg' 9-max Seat #2 is the button
Seat 1: 22dIObOuor/A+IKWkNoAlA ($5.40 in chips) 
Seat 2: gehe91e0IyVT0QU/XBkEyg ($25.15 in chips) 
Seat 3: 8EbrQ/EvFWt2cr0GaU82gQ ($4.40 in chips) 
Seat 4: SHegmCn8B0InbWE/zFlvOw ($21.70 in chips) 
Seat 5: 7je+LC5Mfs6nL8YBVh4frQ ($5 in chips) 
Seat 6: P+9ymZQ3ktpQu1bn7HIjew ($20.50 in chips) 
Seat 7: tYsOBqdU1+x+yFI7zHO7hQ ($25 in chips) 
Seat 8: biJWLZ27fafNeBI2oT1KJw ($28.15 in chips) 
Seat 9: uhrboV251dcgYniYTdFIcA ($25.35 in chips) 
8EbrQ/EvFWt2cr0GaU82gQ: posts small blind $0.10
SHegmCn8B0InbWE/zFlvOw: posts big blind $0.25
*** HOLE CARDS ***
7je+LC5Mfs6nL8YBVh4frQ: folds 
P+9ymZQ3ktpQu1bn7HIjew: folds 
tYsOBqdU1+x+yFI7zHO7hQ: folds 
biJWLZ27fafNeBI2oT1KJw: folds 
uhrboV251dcgYniYTdFIcA: folds 
22dIObOuor/A+IKWkNoAlA: folds 
gehe91e0IyVT0QU/XBkEyg: folds 
8EbrQ/EvFWt2cr0GaU82gQ: folds 
Uncalled bet ($0.15) returned to SHegmCn8B0InbWE/zFlvOw
SHegmCn8B0InbWE/zFlvOw collected $0.20 from pot
*** SUMMARY ***
Total pot $0.20 | Rake $0 
Seat 1: 22dIObOuor/A+IKWkNoAlA folded before Flop (didn't bet)
Seat 2: gehe91e0IyVT0QU/XBkEyg (button) folded before Flop (didn't bet)
Seat 3: 8EbrQ/EvFWt2cr0GaU82gQ (small blind) folded before Flop
Seat 4: SHegmCn8B0InbWE/zFlvOw (big blind) collected ($0.20)
Seat 5: 7je+LC5Mfs6nL8YBVh4frQ folded before Flop (didn't bet)
Seat 6: P+9ymZQ3ktpQu1bn7HIjew folded before Flop (didn't bet)
Seat 7: tYsOBqdU1+x+yFI7zHO7hQ folded before Flop (didn't bet)
Seat 8: biJWLZ27fafNeBI2oT1KJw folded before Flop (didn't bet)
Seat 9: uhrboV251dcgYniYTdFIcA folded before Flop (didn't bet)




PokerStars Game #59941834032:  Hold'em No Limit ($0.10/$0.25) - 2009/07/01 1:47:37 ET
Table 'z2yOdY2zyGWG1gh9WV9XtQdYNvO8G5kw5SRxb1Dljhog Seat #3 is the button
Seat 1: vSkQm2EelzwRGDDQQk0Fqw ($17.30 in chips) 
Seat 2: PkBmevN3LdXkPj1LHOoTnQ ($1.35 in chips) 
Seat 3: 1Cs1GyQcoM1omwY7XZ3uRg ($12.25 in chips) 
Seat 4: sD+TKtt36XiiN6jqHiLwDA ($28.35 in chips) 
Seat 5: W7XGvw6ngGVq2hFwXk8Myg ($25.60 in chips) 
Seat 6: 22dIObOuor/A+IKWkNoAlA ($7.80 in chips) 
Seat 7: DiSvPC2iudwL5j9u6Huyww ($39.75 in chips) 
Seat 8: 5hAPbqNrvJb8PtLiceXtlg6HoFYfVGBefsR5Vrz62qIw0 in chips) 
Seat 9: PdIasPkzm2sqZnN41ZRXOg ($5 in chips) 
sD+TKtt36XiiN6jqHiLwDA: posts small blind $0.10
W7XGvw6ngGVq2hFwXk8Myg: posts big blind $0.25
*** HOLE CARDS ***
22dIObOuor/A+IKWkNoAlA: folds 
DiSvPC2iudwL5j9u6Huyww: folds 
5hAPbqNrvJb8PtLiceXtlg6HoFYfVGBefsR5Vrz62qIwlds 
PdIasPkzm2sqZnN41ZRXOg: folds 
vSkQm2EelzwRGDDQQk0Fqw: folds 
PkBmevN3LdXkPj1LHOoTnQ: folds 
1Cs1GyQcoM1omwY7XZ3uRg: calls $0.25
sD+TKtt36XiiN6jqHiLwDA: calls $0.15
W7XGvw6ngGVq2hFwXk8Myg: raises $0.25 to $0.50
1Cs1GyQcoM1omwY7XZ3uRg: folds 
sD+TKtt36XiiN6jqHiLwDA: folds 
Uncalled bet ($0.25) returned to W7XGvw6ngGVq2hFwXk8Myg
W7XGvw6ngGVq2hFwXk8Myg collected $0.75 from pot
*** SUMMARY ***
Total pot $0.75 | Rake $0 
Seat 1: vSkQm2EelzwRGDDQQk0Fqw folded before Flop (didn't bet)
Seat 2: PkBmevN3LdXkPj1LHOoTnQ folded before Flop (didn't bet)
Seat 3: 1Cs1GyQcoM1omwY7XZ3uRg (button) folded before Flop
Seat 4: sD+TKtt36XiiN6jqHiLwDA (small blind) folded before Flop
Seat 5: W7XGvw6ngGVq2hFwXk8Myg (big blind) collected ($0.75)
Seat 6: 22dIObOuor/A+IKWkNoAlA folded before Flop (didn't bet)
Seat 7: DiSvPC2iudwL5j9u6Huyww folded before Flop (didn't bet)
Seat 8: 5hAPbqNrvJb8PtLiceXtlg6HoFYfVGBefsR5Vrz62qIwded before Flop (didn't bet)
Seat 9: PdIasPkzm2sqZnN41ZRXOg folded before Flop (didn't bet)




PokerStars Game #59941833928:  Hold'em No Limit ($0.10/$0.25) - 2009/07/01 1:47:37 ET
Table 'yZgGBnUGXVCcEJdcqes8tw' 9-max Seat #9 is the button
Seat 1: 6RiVTYll/5D8zICp0MRpKw ($28.45 in chips) 
Seat 2: MG90wfSJZnOejs/KD3vlQQ ($25 in chips) 
Seat 4: M2QO2DxB5Wawg2h8HSpnYA ($10 in chips) 
Seat 5: dfNim92Z6XK1/h5SFW5vDg ($25.85 in chips) 
Seat 6: RHqgdFvufLCYe54+qd2gcA ($5 in chips) 
Seat 7: eC8Pn1D6Y2pct8o62nQfvQ ($31.20 in chips) 
Seat 8: dtZ84flFEi4Q+SGrHMJRDQ ($31.55 in chips) 
Seat 9: M/9j4wkHH9i1JM51vgi1VA ($23.40 in chips) 
6RiVTYll/5D8zICp0MRpKw: posts small blind $0.10
MG90wfSJZnOejs/KD3vlQQ: posts big blind $0.25
*** HOLE CARDS ***
M2QO2DxB5Wawg2h8HSpnYA: folds 
dfNim92Z6XK1/h5SFW5vDg: folds 
RHqgdFvufLCYe54+qd2gcA: folds 
eC8Pn1D6Y2pct8o62nQfvQ: folds 
dtZ84flFEi4Q+SGrHMJRDQ: calls $0.25
M/9j4wkHH9i1JM51vgi1VA: folds 
6RiVTYll/5D8zICp0MRpKw: calls $0.15
MG90wfSJZnOejs/KD3vlQQ: checks 
*** FLOP *** [4h 2d 7h]
6RiVTYll/5D8zICp0MRpKw: checks 
MG90wfSJZnOejs/KD3vlQQ: checks 
dtZ84flFEi4Q+SGrHMJRDQ: checks 
*** TURN *** [4h 2d 7h] [Jh]
6RiVTYll/5D8zICp0MRpKw: checks 
MG90wfSJZnOejs/KD3vlQQ: checks 
dtZ84flFEi4Q+SGrHMJRDQ: bets $0.50
6RiVTYll/5D8zICp0MRpKw: raises $1 to $1.50
MG90wfSJZnOejs/KD3vlQQ: folds 
dtZ84flFEi4Q+SGrHMJRDQ: calls $1
*** RIVER *** [4h 2d 7h Jh] [Ks]
6RiVTYll/5D8zICp0MRpKw: bets $2.75
dtZ84flFEi4Q+SGrHMJRDQ: folds 
Uncalled bet ($2.75) returned to 6RiVTYll/5D8zICp0MRpKw
6RiVTYll/5D8zICp0MRpKw collected $3.60 from pot
*** SUMMARY ***
Total pot $3.75 | Rake $0.15 
Board [4h 2d 7h Jh Ks]
Seat 1: 6RiVTYll/5D8zICp0MRpKw (small blind) collected ($3.60)
Seat 2: MG90wfSJZnOejs/KD3vlQQ (big blind) folded on the Turn
Seat 4: M2QO2DxB5Wawg2h8HSpnYA folded before Flop (didn't bet)
Seat 5: dfNim92Z6XK1/h5SFW5vDg folded before Flop (didn't bet)
Seat 6: RHqgdFvufLCYe54+qd2gcA folded before Flop (didn't bet)
Seat 7: eC8Pn1D6Y2pct8o62nQfvQ folded before Flop (didn't bet)
Seat 8: dtZ84flFEi4Q+SGrHMJRDQ folded on the River
Seat 9: M/9j4wkHH9i1JM51vgi1VA (button) folded before Flop (didn't bet)




PokerStars Game #59941834086:  Hold'em No Limit ($0.10/$0.25) - 2009/07/01 1:47:37 ET
Table 'nQC9LRg01NEuKFHF1nrDEw0XPo7K54oZIfG0xlNAcDRw-max Seat #1 is the button
Seat 1: qf+LMbROj8/qY878wkFHbQ ($14.30 in chips) 
Seat 2: ZhV6dUX9NQhT4zf7t+ZLJg ($21.10 in chips) 
Seat 3: 6+g0Lb6vfRDZkElV8ieHyQ ($26.45 in chips) 
Seat 5: kG34n23qFQA3nzdOJTQ1dA ($28.70 in chips) 
Seat 6: xQVFeVUDopz+akuEo2wXpQ ($55.55 in chips) 
ZhV6dUX9NQhT4zf7t+ZLJg: posts small blind $0.10
6+g0Lb6vfRDZkElV8ieHyQ: posts big blind $0.25
u3Ol7kv1LmvszuHNm9rc6w: sits out 
*** HOLE CARDS ***
kG34n23qFQA3nzdOJTQ1dA: calls $0.25
xQVFeVUDopz+akuEo2wXpQ: calls $0.25
qf+LMbROj8/qY878wkFHbQ: folds 
ZhV6dUX9NQhT4zf7t+ZLJg: calls $0.15
6+g0Lb6vfRDZkElV8ieHyQ: checks 
*** FLOP *** [3c Ah 6c]
ZhV6dUX9NQhT4zf7t+ZLJg: checks 
6+g0Lb6vfRDZkElV8ieHyQ: checks 
kG34n23qFQA3nzdOJTQ1dA: checks 
xQVFeVUDopz+akuEo2wXpQ: checks 
*** TURN *** [3c Ah 6c] [Ad]
ZhV6dUX9NQhT4zf7t+ZLJg: bets $0.75
6+g0Lb6vfRDZkElV8ieHyQ: folds 
kG34n23qFQA3nzdOJTQ1dA: folds 
xQVFeVUDopz+akuEo2wXpQ: folds 
Uncalled bet ($0.75) returned to ZhV6dUX9NQhT4zf7t+ZLJg
ZhV6dUX9NQhT4zf7t+ZLJg collected $0.95 from pot
ZhV6dUX9NQhT4zf7t+ZLJg: doesn't show hand 
*** SUMMARY ***
Total pot $1 | Rake $0.05 
Board [3c Ah 6c Ad]
Seat 1: qf+LMbROj8/qY878wkFHbQ (button) folded before Flop (didn't bet)
Seat 2: ZhV6dUX9NQhT4zf7t+ZLJg (small blind) collected ($0.95)
Seat 3: 6+g0Lb6vfRDZkElV8ieHyQ (big blind) folded on the Turn
Seat 5: kG34n23qFQA3nzdOJTQ1dA folded on the Turn
Seat 6: xQVFeVUDopz+akuEo2wXpQ folded on the Turn




PokerStars Game #59941834610:  Hold'em No Limit ($0.10/$0.25) - 2009/07/01 1:47:38 ET
Table 'sJ4KpS2GE5Qrsu1/cFjJUw' 9-max Seat #9 is the button
Seat 1: eDlQ+S+6L4e6gM1dkZhGgQ ($19.50 in chips) 
Seat 3: eK8qa6EPcH2zhtbmWSvc9g ($25 in chips) 
Seat 4: npAYqa85pqnzfOK5ukX+BQ ($24 in chips) 
Seat 5: Q/gZC63lfOMr7YhWKPCxoQ ($8.10 in chips) 
Seat 6: OefE+Csvj5KR7ClGf3Hc2g ($3.85 in chips) 
Seat 7: Wi8djHgewBlVhpKWfp7isQ ($8.60 in chips) 
Seat 8: S7Ki0P+0AIGPuIfGJjW0gg ($30.60 in chips) 
Seat 9: 3PmVnC/15cl4oyI1TKIt4g ($4.40 in chips) 
eDlQ+S+6L4e6gM1dkZhGgQ: posts small blind $0.10
tYsOBqdU1+x+yFI7zHO7hQ: is sitting out 
eK8qa6EPcH2zhtbmWSvc9g: posts big blind $0.25
*** HOLE CARDS ***
npAYqa85pqnzfOK5ukX+BQ: folds 
tYsOBqdU1+x+yFI7zHO7hQ leaves the table
Q/gZC63lfOMr7YhWKPCxoQ: folds 
OefE+Csvj5KR7ClGf3Hc2g: folds 
Wi8djHgewBlVhpKWfp7isQ: folds 
S7Ki0P+0AIGPuIfGJjW0gg: raises $0.50 to $0.75
3PmVnC/15cl4oyI1TKIt4g: folds 
eDlQ+S+6L4e6gM1dkZhGgQ: folds 
eK8qa6EPcH2zhtbmWSvc9g: folds 
Uncalled bet ($0.50) returned to S7Ki0P+0AIGPuIfGJjW0gg
S7Ki0P+0AIGPuIfGJjW0gg collected $0.60 from pot
S7Ki0P+0AIGPuIfGJjW0gg: doesn't show hand 
*** SUMMARY ***
Total pot $0.60 | Rake $0 
Seat 1: eDlQ+S+6L4e6gM1dkZhGgQ (small blind) folded before Flop
Seat 3: eK8qa6EPcH2zhtbmWSvc9g (big blind) folded before Flop
Seat 4: npAYqa85pqnzfOK5ukX+BQ folded before Flop (didn't bet)
Seat 5: Q/gZC63lfOMr7YhWKPCxoQ folded before Flop (didn't bet)
Seat 6: OefE+Csvj5KR7ClGf3Hc2g folded before Flop (didn't bet)
Seat 7: Wi8djHgewBlVhpKWfp7isQ folded before Flop (didn't bet)
Seat 8: S7Ki0P+0AIGPuIfGJjW0gg collected ($0.60)
Seat 9: 3PmVnC/15cl4oyI1TKIt4g (button) folded before Flop (didn't bet)




PokerStars Game #59941834714:  Hold'em No Limit ($0.10/$0.25) - 2009/07/01 1:47:38 ET
Table '/JJyyIstHfkT7t/bW+WXgg' 6-max Seat #4 is the button
Seat 2: obJgSnVgWWWaAUtVILo77Q ($18 in chips) 
Seat 3: DR0nVIhVP77oEBlO9J8vlg ($37.10 in chips) 
Seat 4: JFIAqU8lCZ0vWwEl4bdGsg ($35.80 in chips) 
Seat 5: +ZlnqPoP3Hg4BIUxDfKd/A ($45.95 in chips) 
Seat 6: UmcUp27+PbgBItv3ZNlAWQ ($25 in chips) 
+ZlnqPoP3Hg4BIUxDfKd/A: posts small blind $0.10
UmcUp27+PbgBItv3ZNlAWQ: posts big blind $0.25
xC0kaiDYM6YTlgODL83O5A: sits out 
*** HOLE CARDS ***
obJgSnVgWWWaAUtVILo77Q: folds 
DR0nVIhVP77oEBlO9J8vlg: folds 
JFIAqU8lCZ0vWwEl4bdGsg: folds 
+ZlnqPoP3Hg4BIUxDfKd/A: calls $0.15
UmcUp27+PbgBItv3ZNlAWQ: checks 
*** FLOP *** [Kc 4c Kd]
+ZlnqPoP3Hg4BIUxDfKd/A: checks 
UmcUp27+PbgBItv3ZNlAWQ: bets $0.25
+ZlnqPoP3Hg4BIUxDfKd/A: folds 
Uncalled bet ($0.25) returned to UmcUp27+PbgBItv3ZNlAWQ
UmcUp27+PbgBItv3ZNlAWQ collected $0.50 from pot
UmcUp27+PbgBItv3ZNlAWQ: doesn't show hand 
*** SUMMARY ***
Total pot $0.50 | Rake $0 
Board [Kc 4c Kd]
Seat 2: obJgSnVgWWWaAUtVILo77Q folded before Flop (didn't bet)
Seat 3: DR0nVIhVP77oEBlO9J8vlg folded before Flop (didn't bet)
Seat 4: JFIAqU8lCZ0vWwEl4bdGsg (button) folded before Flop (didn't bet)
Seat 5: +ZlnqPoP3Hg4BIUxDfKd/A (small blind) folded on the Flop
Seat 6: UmcUp27+PbgBItv3ZNlAWQ (big blind) collected ($0.50)




PokerStars Game #59941834552:  Hold'em No Limit ($0.10/$0.25) - 2009/07/01 1:47:38 ET
Table 'wRXcD9iXgBbdvKhWmfnBnw' 6-max Seat #5 is the button
Seat 1: Mhj3q7cxev+XjXZxEE6/Cw ($25 in chips) 
Seat 2: vUr8qM1UsCElsCI9B/McdQ ($23.10 in chips) 
Seat 4: mnuJq+Q1IXKm/pCy+OzxmQ ($19.25 in chips) 
Seat 5: EE16Ua5b1HSsYej5zeXOlA ($47.10 in chips) 
Seat 6: JFIAqU8lCZ0vWwEl4bdGsg ($34.10 in chips) 
JFIAqU8lCZ0vWwEl4bdGsg: posts small blind $0.10
Mhj3q7cxev+XjXZxEE6/Cw: posts big blind $0.25
*** HOLE CARDS ***
vUr8qM1UsCElsCI9B/McdQ: folds 
mnuJq+Q1IXKm/pCy+OzxmQ: folds 
EE16Ua5b1HSsYej5zeXOlA: raises $0.50 to $0.75
SxIIgwXYLkwd6m3wLyPTCw joins the table at seat #3 
JFIAqU8lCZ0vWwEl4bdGsg: folds 
Mhj3q7cxev+XjXZxEE6/Cw: folds 
Uncalled bet ($0.50) returned to EE16Ua5b1HSsYej5zeXOlA
EE16Ua5b1HSsYej5zeXOlA collected $0.60 from pot
EE16Ua5b1HSsYej5zeXOlA: doesn't show hand 
*** SUMMARY ***
Total pot $0.60 | Rake $0 
Seat 1: Mhj3q7cxev+XjXZxEE6/Cw (big blind) folded before Flop
Seat 2: vUr8qM1UsCElsCI9B/McdQ folded before Flop (didn't bet)
Seat 4: mnuJq+Q1IXKm/pCy+OzxmQ folded before Flop (didn't bet)
Seat 5: EE16Ua5b1HSsYej5zeXOlA (button) collected ($0.60)
Seat 6: JFIAqU8lCZ0vWwEl4bdGsg (small blind) folded before Flop




PokerStars Game #59941834576:  Hold'em No Limit ($0.10/$0.25) - 2009/07/01 1:47:38 ET
Table '2clPgY3+dETPD/8zjXZdFw' 6-max Seat #4 is the button
Seat 1: 7cx44/slbeTw+Cy7QB8Trg ($25 in chips) 
Seat 2: cWc85bEzdRzpUMhRKm8pwQ ($25.30 in chips) 
Seat 3: FL1UWpN6oReBdznWDOy9Gg ($15.60 in chips) 
Seat 4: ljjhtb6FVPTx9AT9HNdtqg ($24.75 in chips) 
Seat 5: LJI7A1YgDM7hgh7o56+ReQ ($29.65 in chips) 
LJI7A1YgDM7hgh7o56+ReQ: posts small blind $0.10
7cx44/slbeTw+Cy7QB8Trg: posts big blind $0.25
*** HOLE CARDS ***
cWc85bEzdRzpUMhRKm8pwQ: folds 
FL1UWpN6oReBdznWDOy9Gg: calls $0.25
ljjhtb6FVPTx9AT9HNdtqg: folds 
LJI7A1YgDM7hgh7o56+ReQ: folds 
7cx44/slbeTw+Cy7QB8Trg: checks 
*** FLOP *** [Tc Js 2d]
7cx44/slbeTw+Cy7QB8Trg: checks 
FL1UWpN6oReBdznWDOy9Gg: bets $0.25
7cx44/slbeTw+Cy7QB8Trg: folds 
Uncalled bet ($0.25) returned to FL1UWpN6oReBdznWDOy9Gg
FL1UWpN6oReBdznWDOy9Gg collected $0.60 from pot
FL1UWpN6oReBdznWDOy9Gg: doesn't show hand 
*** SUMMARY ***
Total pot $0.60 | Rake $0 
Board [Tc Js 2d]
Seat 1: 7cx44/slbeTw+Cy7QB8Trg (big blind) folded on the Flop
Seat 2: cWc85bEzdRzpUMhRKm8pwQ folded before Flop (didn't bet)
Seat 3: FL1UWpN6oReBdznWDOy9Gg collected ($0.60)
Seat 4: ljjhtb6FVPTx9AT9HNdtqg (button) folded before Flop (didn't bet)
Seat 5: LJI7A1YgDM7hgh7o56+ReQ (small blind) folded before Flop




