PokerStars Game #59941648948:  Hold'em No Limit ($0.10/$0.25) - 2009/07/01 1:41:48 ET
Table 'WEMI3Mtn7dGARDbgNrKibg' 9-max Seat #7 is the button
Seat 1: Th3FldXKQW6hWVVPahaoOQ ($30.50 in chips) 
Seat 2: tYsOBqdU1+x+yFI7zHO7hQ ($49.55 in chips) 
Seat 3: qwr38jl5txoR36M7G5qi4A ($7.75 in chips) 
Seat 4: Z5NNIVvnhb2IJbLcI79WYQ ($5.25 in chips) 
Seat 5: yzPZQFeaQTNf1YK3a0zRIw ($14.20 in chips) 
Seat 6: arxNSjreDRGFg13EAM2F1w ($25.35 in chips) 
Seat 7: DnDcAdn9P0zGovMERigpFA ($54.90 in chips) 
Seat 8: ghNKXUBl/H+t83JF079ZBA ($28.75 in chips) 
Seat 9: 2wcFsZsqEP5w1StUTVzJCg ($5.50 in chips) 
ghNKXUBl/H+t83JF079ZBA: posts small blind $0.10
2wcFsZsqEP5w1StUTVzJCg: posts big blind $0.25
*** HOLE CARDS ***
Th3FldXKQW6hWVVPahaoOQ: folds 
tYsOBqdU1+x+yFI7zHO7hQ: folds 
qwr38jl5txoR36M7G5qi4A: folds 
Z5NNIVvnhb2IJbLcI79WYQ: folds 
yzPZQFeaQTNf1YK3a0zRIw: calls $0.25
arxNSjreDRGFg13EAM2F1w: calls $0.25
DnDcAdn9P0zGovMERigpFA: folds 
ghNKXUBl/H+t83JF079ZBA: folds 
2wcFsZsqEP5w1StUTVzJCg: checks 
*** FLOP *** [6d Qd Th]
2wcFsZsqEP5w1StUTVzJCg: checks 
yzPZQFeaQTNf1YK3a0zRIw: checks 
arxNSjreDRGFg13EAM2F1w: checks 
*** TURN *** [6d Qd Th] [9c]
2wcFsZsqEP5w1StUTVzJCg: checks 
yzPZQFeaQTNf1YK3a0zRIw: checks 
arxNSjreDRGFg13EAM2F1w: checks 
*** RIVER *** [6d Qd Th 9c] [9s]
2wcFsZsqEP5w1StUTVzJCg: checks 
yzPZQFeaQTNf1YK3a0zRIw: bets $0.25
arxNSjreDRGFg13EAM2F1w: folds 
2wcFsZsqEP5w1StUTVzJCg: folds 
Uncalled bet ($0.25) returned to yzPZQFeaQTNf1YK3a0zRIw
yzPZQFeaQTNf1YK3a0zRIw collected $0.85 from pot
yzPZQFeaQTNf1YK3a0zRIw: doesn't show hand 
*** SUMMARY ***
Total pot $0.85 | Rake $0 
Board [6d Qd Th 9c 9s]
Seat 1: Th3FldXKQW6hWVVPahaoOQ folded before Flop (didn't bet)
Seat 2: tYsOBqdU1+x+yFI7zHO7hQ folded before Flop (didn't bet)
Seat 3: qwr38jl5txoR36M7G5qi4A folded before Flop (didn't bet)
Seat 4: Z5NNIVvnhb2IJbLcI79WYQ folded before Flop (didn't bet)
Seat 5: yzPZQFeaQTNf1YK3a0zRIw collected ($0.85)
Seat 6: arxNSjreDRGFg13EAM2F1w folded on the River
Seat 7: DnDcAdn9P0zGovMERigpFA (button) folded before Flop (didn't bet)
Seat 8: ghNKXUBl/H+t83JF079ZBA (small blind) folded before Flop
Seat 9: 2wcFsZsqEP5w1StUTVzJCg (big blind) folded on the River




PokerStars Game #59941649206:  Hold'em No Limit ($0.10/$0.25) - 2009/07/01 1:41:49 ET
Table '+VTTYgQLH1awDHk+IAxqGg' 9-max Seat #7 is the button
Seat 1: arxNSjreDRGFg13EAM2F1w ($25.75 in chips) 
Seat 2: 2wcFsZsqEP5w1StUTVzJCg ($5.40 in chips) 
Seat 3: AiXn/9o1EwOPZUHujnh/bA ($18.65 in chips) 
Seat 4: gE5rN2TDY1aXcZn/TOPeZw ($10.90 in chips) 
Seat 5: sD+TKtt36XiiN6jqHiLwDA ($25.15 in chips) 
Seat 7: ljemhp25Zg+nlA9DLCIiUw ($25 in chips) 
Seat 8: 10vzP4r6ldwGLbYHKd9www ($16.95 in chips) 
Seat 9: S7Ki0P+0AIGPuIfGJjW0gg ($56.15 in chips) 
10vzP4r6ldwGLbYHKd9www: posts small blind $0.10
S7Ki0P+0AIGPuIfGJjW0gg: posts big blind $0.25
*** HOLE CARDS ***
arxNSjreDRGFg13EAM2F1w: folds 
2wcFsZsqEP5w1StUTVzJCg: folds 
AiXn/9o1EwOPZUHujnh/bA: raises $0.25 to $0.50
gE5rN2TDY1aXcZn/TOPeZw: folds 
sD+TKtt36XiiN6jqHiLwDA: folds 
ljemhp25Zg+nlA9DLCIiUw: folds 
10vzP4r6ldwGLbYHKd9www: folds 
S7Ki0P+0AIGPuIfGJjW0gg: calls $0.25
*** FLOP *** [Jc 7s 9d]
S7Ki0P+0AIGPuIfGJjW0gg: bets $0.25
AiXn/9o1EwOPZUHujnh/bA: raises $0.75 to $1
S7Ki0P+0AIGPuIfGJjW0gg: raises $2 to $3
AiXn/9o1EwOPZUHujnh/bA: calls $2
*** TURN *** [Jc 7s 9d] [7d]
S7Ki0P+0AIGPuIfGJjW0gg: checks 
AiXn/9o1EwOPZUHujnh/bA: checks 
*** RIVER *** [Jc 7s 9d 7d] [4d]
S7Ki0P+0AIGPuIfGJjW0gg: bets $2
AiXn/9o1EwOPZUHujnh/bA: calls $2
*** SHOW DOWN ***
S7Ki0P+0AIGPuIfGJjW0gg: shows [Jd 7h] (a full house, Sevens full of Jacks)
AiXn/9o1EwOPZUHujnh/bA: mucks hand 
S7Ki0P+0AIGPuIfGJjW0gg collected $10.60 from pot
*** SUMMARY ***
Total pot $11.10 | Rake $0.50 
Board [Jc 7s 9d 7d 4d]
Seat 1: arxNSjreDRGFg13EAM2F1w folded before Flop (didn't bet)
Seat 2: 2wcFsZsqEP5w1StUTVzJCg folded before Flop (didn't bet)
Seat 3: AiXn/9o1EwOPZUHujnh/bA mucked
Seat 4: gE5rN2TDY1aXcZn/TOPeZw folded before Flop (didn't bet)
Seat 5: sD+TKtt36XiiN6jqHiLwDA folded before Flop (didn't bet)
Seat 7: ljemhp25Zg+nlA9DLCIiUw (button) folded before Flop (didn't bet)
Seat 8: 10vzP4r6ldwGLbYHKd9www (small blind) folded before Flop
Seat 9: S7Ki0P+0AIGPuIfGJjW0gg (big blind) showed [Jd 7h] and won ($10.60) with a full house, Sevens full of Jacks




PokerStars Game #59941649016:  Hold'em No Limit ($0.10/$0.25) - 2009/07/01 1:41:49 ET
Table 'wPWRBZPJl1HAnysw7qRR0A' 6-max Seat #4 is the button
Seat 1: m7ne1MOFTQXlsXT7/R/rug ($9.15 in chips) 
Seat 3: 1ZpoLWO2nm2w1Nd1v9Sr3g ($5.65 in chips) 
Seat 4: epAUIB7h2FJXzUPRIvSkRA ($25.60 in chips) 
Seat 5: y0B+UpYpOUJz3JWtlJQBSA ($16.45 in chips) 
Seat 6: Hsvkc0/G2VV78oVmWYXecw ($9.65 in chips) 
y0B+UpYpOUJz3JWtlJQBSA: posts small blind $0.10
Hsvkc0/G2VV78oVmWYXecw: posts big blind $0.25
xC0kaiDYM6YTlgODL83O5A: sits out 
*** HOLE CARDS ***
m7ne1MOFTQXlsXT7/R/rug: folds 
1ZpoLWO2nm2w1Nd1v9Sr3g: folds 
epAUIB7h2FJXzUPRIvSkRA: raises $0.75 to $1
y0B+UpYpOUJz3JWtlJQBSA: folds 
Hsvkc0/G2VV78oVmWYXecw: folds 
Uncalled bet ($0.75) returned to epAUIB7h2FJXzUPRIvSkRA
epAUIB7h2FJXzUPRIvSkRA collected $0.60 from pot
epAUIB7h2FJXzUPRIvSkRA: doesn't show hand 
*** SUMMARY ***
Total pot $0.60 | Rake $0 
Seat 1: m7ne1MOFTQXlsXT7/R/rug folded before Flop (didn't bet)
Seat 3: 1ZpoLWO2nm2w1Nd1v9Sr3g folded before Flop (didn't bet)
Seat 4: epAUIB7h2FJXzUPRIvSkRA (button) collected ($0.60)
Seat 5: y0B+UpYpOUJz3JWtlJQBSA (small blind) folded before Flop
Seat 6: Hsvkc0/G2VV78oVmWYXecw (big blind) folded before Flop




PokerStars Game #59941649134:  Hold'em No Limit ($0.10/$0.25) - 2009/07/01 1:41:49 ET
Table 'qryc9C/ELyQ3lubOaELNAQ' 6-max Seat #5 is the button
Seat 1: OZc6kkoTwtITj1ZfreJK1A ($64.80 in chips) 
Seat 2: LtASJ9OlkqGrrUKGQlpGAw ($30.80 in chips) 
Seat 4: v+QfkGiuj9bgtuNoVnDO8w ($25.05 in chips) 
Seat 5: 9StOHp+Y1T0K13JdgS2oQQ ($33.55 in chips) 
Seat 6: u+J1MTXS2qhNVMbsBemNLg ($4.15 in chips) 
u+J1MTXS2qhNVMbsBemNLg: posts small blind $0.10
OZc6kkoTwtITj1ZfreJK1A: posts big blind $0.25
wvIIdlbCgePONQwXjx9xzQ: sits out 
*** HOLE CARDS ***
LtASJ9OlkqGrrUKGQlpGAw: folds 
v+QfkGiuj9bgtuNoVnDO8w: folds 
9StOHp+Y1T0K13JdgS2oQQ: raises $0.50 to $0.75
u+J1MTXS2qhNVMbsBemNLg: folds 
OZc6kkoTwtITj1ZfreJK1A: calls $0.50
*** FLOP *** [Ts 7c Kc]
OZc6kkoTwtITj1ZfreJK1A: checks 
9StOHp+Y1T0K13JdgS2oQQ: bets $0.75
OZc6kkoTwtITj1ZfreJK1A: calls $0.75
*** TURN *** [Ts 7c Kc] [8d]
OZc6kkoTwtITj1ZfreJK1A: checks 
9StOHp+Y1T0K13JdgS2oQQ: bets $1.75
OZc6kkoTwtITj1ZfreJK1A: calls $1.75
*** RIVER *** [Ts 7c Kc 8d] [Ad]
OZc6kkoTwtITj1ZfreJK1A: checks 
9StOHp+Y1T0K13JdgS2oQQ: bets $8.25
OZc6kkoTwtITj1ZfreJK1A: folds 
Uncalled bet ($8.25) returned to 9StOHp+Y1T0K13JdgS2oQQ
9StOHp+Y1T0K13JdgS2oQQ collected $6.30 from pot
9StOHp+Y1T0K13JdgS2oQQ: doesn't show hand 
*** SUMMARY ***
Total pot $6.60 | Rake $0.30 
Board [Ts 7c Kc 8d Ad]
Seat 1: OZc6kkoTwtITj1ZfreJK1A (big blind) folded on the River
Seat 2: LtASJ9OlkqGrrUKGQlpGAw folded before Flop (didn't bet)
Seat 4: v+QfkGiuj9bgtuNoVnDO8w folded before Flop (didn't bet)
Seat 5: 9StOHp+Y1T0K13JdgS2oQQ (button) collected ($6.30)
Seat 6: u+J1MTXS2qhNVMbsBemNLg (small blind) folded before Flop




PokerStars Game #59941649442:  Hold'em No Limit ($0.10/$0.25) - 2009/07/01 1:41:49 ET
Table 'wGizWOswEL6P5QrvVkno/g' 6-max Seat #1 is the button
Seat 1: Qbfkn+ucISvbd1Xh32zAGA ($24.65 in chips) 
Seat 2: mfrkWA3PTeYPkbO6hi98Aw ($24.75 in chips) 
Seat 3: bJFzs6QmEEnz4miMfSDtcg ($14.75 in chips) 
Seat 4: 32YL2ZEp8NT4JB2RVM9euQ ($16.65 in chips) 
Seat 5: wsP46AGpqDjHZQmlRHKa9g ($39.40 in chips) 
Seat 6: rfSnsAuAfXTb8w/obc9OVQ ($7.90 in chips) 
mfrkWA3PTeYPkbO6hi98Aw: posts small blind $0.10
bJFzs6QmEEnz4miMfSDtcg: posts big blind $0.25
*** HOLE CARDS ***
32YL2ZEp8NT4JB2RVM9euQ: folds 
wsP46AGpqDjHZQmlRHKa9g: folds 
rfSnsAuAfXTb8w/obc9OVQ: folds 
Qbfkn+ucISvbd1Xh32zAGA: folds 
mfrkWA3PTeYPkbO6hi98Aw: raises $0.75 to $1
bJFzs6QmEEnz4miMfSDtcg: folds 
Uncalled bet ($0.75) returned to mfrkWA3PTeYPkbO6hi98Aw
mfrkWA3PTeYPkbO6hi98Aw collected $0.50 from pot
mfrkWA3PTeYPkbO6hi98Aw: doesn't show hand 
*** SUMMARY ***
Total pot $0.50 | Rake $0 
Seat 1: Qbfkn+ucISvbd1Xh32zAGA (button) folded before Flop (didn't bet)
Seat 2: mfrkWA3PTeYPkbO6hi98Aw (small blind) collected ($0.50)
Seat 3: bJFzs6QmEEnz4miMfSDtcg (big blind) folded before Flop
Seat 4: 32YL2ZEp8NT4JB2RVM9euQ folded before Flop (didn't bet)
Seat 5: wsP46AGpqDjHZQmlRHKa9g folded before Flop (didn't bet)
Seat 6: rfSnsAuAfXTb8w/obc9OVQ folded before Flop (didn't bet)




PokerStars Game #59941649268:  Hold'em No Limit ($0.10/$0.25) - 2009/07/01 1:41:49 ET
Table 'tq5CvS0RUqGkuBK0XTzqqg' 6-max Seat #2 is the button
Seat 1: +ZlnqPoP3Hg4BIUxDfKd/A ($31.20 in chips) 
Seat 2: 2m6ZFAdj01UZd4WtEySXXQ ($5.50 in chips) 
Seat 3: PbMzPZIePKifKQZfKDkbIw ($48.60 in chips) 
Seat 4: UT5XpwOH1ipkOF7n1MqDJA ($25 in chips) 
Seat 5: qGHGf/553gQnDoklMRe3tg ($32.30 in chips) 
Seat 6: L3/N/gliETan8N5Gim5h4Q ($25 in chips) 
PbMzPZIePKifKQZfKDkbIw: posts small blind $0.10
UT5XpwOH1ipkOF7n1MqDJA: posts big blind $0.25
*** HOLE CARDS ***
qGHGf/553gQnDoklMRe3tg: folds 
L3/N/gliETan8N5Gim5h4Q: raises $0.50 to $0.75
+ZlnqPoP3Hg4BIUxDfKd/A: calls $0.75
2m6ZFAdj01UZd4WtEySXXQ: folds 
PbMzPZIePKifKQZfKDkbIw: folds 
UT5XpwOH1ipkOF7n1MqDJA: folds 
*** FLOP *** [2c 3d 7h]
L3/N/gliETan8N5Gim5h4Q: bets $1.25
+ZlnqPoP3Hg4BIUxDfKd/A: folds 
Uncalled bet ($1.25) returned to L3/N/gliETan8N5Gim5h4Q
L3/N/gliETan8N5Gim5h4Q collected $1.80 from pot
L3/N/gliETan8N5Gim5h4Q: doesn't show hand 
*** SUMMARY ***
Total pot $1.85 | Rake $0.05 
Board [2c 3d 7h]
Seat 1: +ZlnqPoP3Hg4BIUxDfKd/A folded on the Flop
Seat 2: 2m6ZFAdj01UZd4WtEySXXQ (button) folded before Flop (didn't bet)
Seat 3: PbMzPZIePKifKQZfKDkbIw (small blind) folded before Flop
Seat 4: UT5XpwOH1ipkOF7n1MqDJA (big blind) folded before Flop
Seat 5: qGHGf/553gQnDoklMRe3tg folded before Flop (didn't bet)
Seat 6: L3/N/gliETan8N5Gim5h4Q collected ($1.80)




PokerStars Game #59941649492:  Hold'em No Limit ($0.10/$0.25) - 2009/07/01 1:41:49 ET
Table '/AhP8uWRzEEhOATYIdmn0A' 9-max Seat #4 is the button
Seat 1: +sbyWwIcFp9kP0bDtMegfQ ($37.80 in chips) 
Seat 2: nx5EoCNZFR03YUOXyT22wQ ($17.30 in chips) 
Seat 3: jx6dnobNHstDG0tabsbKHQ ($3.30 in chips) 
Seat 4: bXpVeaSTPBFSPJmeXxO7nw ($6 in chips) 
Seat 6: 8EbrQ/EvFWt2cr0GaU82gQ ($5.10 in chips) 
Seat 7: cZ99hugmLBj9KhTlc8nCSw ($25 in chips) 
Seat 8: K86cg2ifCMFAlmzsfTDjig ($25 in chips) 
8EbrQ/EvFWt2cr0GaU82gQ: posts small blind $0.10
cZ99hugmLBj9KhTlc8nCSw: posts big blind $0.25
TidusNexus: sits out 
*** HOLE CARDS ***
K86cg2ifCMFAlmzsfTDjig: raises $24.75 to $25 and is all-in
+sbyWwIcFp9kP0bDtMegfQ: folds 
nx5EoCNZFR03YUOXyT22wQ: folds 
jx6dnobNHstDG0tabsbKHQ: folds 
bXpVeaSTPBFSPJmeXxO7nw: folds 
8EbrQ/EvFWt2cr0GaU82gQ: folds 
cZ99hugmLBj9KhTlc8nCSw: folds 
Uncalled bet ($24.75) returned to K86cg2ifCMFAlmzsfTDjig
K86cg2ifCMFAlmzsfTDjig collected $0.60 from pot
K86cg2ifCMFAlmzsfTDjig: doesn't show hand 
*** SUMMARY ***
Total pot $0.60 | Rake $0 
Seat 1: +sbyWwIcFp9kP0bDtMegfQ folded before Flop (didn't bet)
Seat 2: nx5EoCNZFR03YUOXyT22wQ folded before Flop (didn't bet)
Seat 3: jx6dnobNHstDG0tabsbKHQ folded before Flop (didn't bet)
Seat 4: bXpVeaSTPBFSPJmeXxO7nw (button) folded before Flop (didn't bet)
Seat 6: 8EbrQ/EvFWt2cr0GaU82gQ (small blind) folded before Flop
Seat 7: cZ99hugmLBj9KhTlc8nCSw (big blind) folded before Flop
Seat 8: K86cg2ifCMFAlmzsfTDjig collected ($0.60)




PokerStars Game #59941650064:  Hold'em No Limit ($0.10/$0.25) - 2009/07/01 1:41:50 ET
Table '52Meibn9NOL4XtVi1p2Upw' 9-max Seat #8 is the button
Seat 1: W6tExOcYX7qiy6Qdp+ZwFA ($5 in chips) 
Seat 3: Bb42QRQMhg5/Y0vHP8/2Xw ($25 in chips) 
Seat 4: oLa/tXLfSLLB28mcLGrxcg ($31.65 in chips) 
Seat 5: MXCztnYJ58KLHMztZvKrxA ($4.75 in chips) 
Seat 6: 1wKfgJ8xXIiuc8C6qjkxhg ($1.35 in chips) 
Seat 8: PFv56Q1PTkDC084eXIAYmw ($23.75 in chips) 
Seat 9: RCqMONFrSPSArZh2Jsar/w ($19.75 in chips) 
RCqMONFrSPSArZh2Jsar/w: posts small blind $0.10
W6tExOcYX7qiy6Qdp+ZwFA: posts big blind $0.25
Qduu7ikeizo6q6Ei9YvcJA: sits out 
*** HOLE CARDS ***
Bb42QRQMhg5/Y0vHP8/2Xw: raises $0.75 to $1
oLa/tXLfSLLB28mcLGrxcg: folds 
MXCztnYJ58KLHMztZvKrxA: folds 
1wKfgJ8xXIiuc8C6qjkxhg: calls $1
PFv56Q1PTkDC084eXIAYmw: folds 
RCqMONFrSPSArZh2Jsar/w: folds 
W6tExOcYX7qiy6Qdp+ZwFA: folds 
*** FLOP *** [9s 7d Ac]
Bb42QRQMhg5/Y0vHP8/2Xw: bets $1.75
1wKfgJ8xXIiuc8C6qjkxhg: calls $0.35 and is all-in
Uncalled bet ($1.40) returned to Bb42QRQMhg5/Y0vHP8/2Xw
*** TURN *** [9s 7d Ac] [Ad]
*** RIVER *** [9s 7d Ac Ad] [7s]
*** SHOW DOWN ***
Bb42QRQMhg5/Y0vHP8/2Xw: shows [Qd Ah] (a full house, Aces full of Sevens)
1wKfgJ8xXIiuc8C6qjkxhg: mucks hand 
1wKfgJ8xXIiuc8C6qjkxhg leaves the table
Bb42QRQMhg5/Y0vHP8/2Xw collected $2.95 from pot
*** SUMMARY ***
Total pot $3.05 | Rake $0.10 
Board [9s 7d Ac Ad 7s]
Seat 1: W6tExOcYX7qiy6Qdp+ZwFA (big blind) folded before Flop
Seat 3: Bb42QRQMhg5/Y0vHP8/2Xw showed [Qd Ah] and won ($2.95) with a full house, Aces full of Sevens
Seat 4: oLa/tXLfSLLB28mcLGrxcg folded before Flop (didn't bet)
Seat 5: MXCztnYJ58KLHMztZvKrxA folded before Flop (didn't bet)
Seat 6: 1wKfgJ8xXIiuc8C6qjkxhg mucked
Seat 8: PFv56Q1PTkDC084eXIAYmw (button) folded before Flop (didn't bet)
Seat 9: RCqMONFrSPSArZh2Jsar/w (small blind) folded before Flop




PokerStars Game #59941649686:  Hold'em No Limit ($0.10/$0.25) - 2009/07/01 1:41:50 ET
Table 'Jz+kWRxWNGk9w24fdQEveA' 9-max Seat #4 is the button
Seat 2: ljemhp25Zg+nlA9DLCIiUw ($38.85 in chips) 
Seat 4: HPEB+AtKw1+C/cxU0o1ciw ($28.65 in chips) 
Seat 5: d6eSA7wOH5mRaSyVDVRBLw ($10.35 in chips) 
Seat 6: c/6hFCyfLNRn3VFvCeQ1ng ($4.45 in chips) 
Seat 7: wGigCmBR/9XWkPpvYos3aQ ($27 in chips) 
Seat 8: j4q3p0lesp63b1gZDwLBZw ($5 in chips) 
Seat 9: V6p0jQ/RhUsqpHLmXvEX4Q ($17.35 in chips) 
d6eSA7wOH5mRaSyVDVRBLw: posts small blind $0.10
c/6hFCyfLNRn3VFvCeQ1ng: posts big blind $0.25
Z9W7+g1WMhhZDi7DwGbCFA: sits out 
*** HOLE CARDS ***
wGigCmBR/9XWkPpvYos3aQ: folds 
j4q3p0lesp63b1gZDwLBZw: folds 
V6p0jQ/RhUsqpHLmXvEX4Q: folds 
ljemhp25Zg+nlA9DLCIiUw: folds 
HPEB+AtKw1+C/cxU0o1ciw: folds 
d6eSA7wOH5mRaSyVDVRBLw: calls $0.15
WPT_Champ111 joins the table at seat #3 
c/6hFCyfLNRn3VFvCeQ1ng: checks 
*** FLOP *** [8h Jh Jc]
d6eSA7wOH5mRaSyVDVRBLw: checks 
c/6hFCyfLNRn3VFvCeQ1ng: bets $0.25
d6eSA7wOH5mRaSyVDVRBLw: calls $0.25
*** TURN *** [8h Jh Jc] [Tc]
d6eSA7wOH5mRaSyVDVRBLw: checks 
c/6hFCyfLNRn3VFvCeQ1ng: checks 
*** RIVER *** [8h Jh Jc Tc] [5d]
d6eSA7wOH5mRaSyVDVRBLw: bets $1
c/6hFCyfLNRn3VFvCeQ1ng: calls $1
*** SHOW DOWN ***
d6eSA7wOH5mRaSyVDVRBLw: shows [6h Js] (three of a kind, Jacks)
c/6hFCyfLNRn3VFvCeQ1ng: mucks hand 
d6eSA7wOH5mRaSyVDVRBLw collected $2.90 from pot
*** SUMMARY ***
Total pot $3 | Rake $0.10 
Board [8h Jh Jc Tc 5d]
Seat 2: ljemhp25Zg+nlA9DLCIiUw folded before Flop (didn't bet)
Seat 4: HPEB+AtKw1+C/cxU0o1ciw (button) folded before Flop (didn't bet)
Seat 5: d6eSA7wOH5mRaSyVDVRBLw (small blind) showed [6h Js] and won ($2.90) with three of a kind, Jacks
Seat 6: c/6hFCyfLNRn3VFvCeQ1ng (big blind) mucked
Seat 7: wGigCmBR/9XWkPpvYos3aQ folded before Flop (didn't bet)
Seat 8: j4q3p0lesp63b1gZDwLBZw folded before Flop (didn't bet)
Seat 9: V6p0jQ/RhUsqpHLmXvEX4Q folded before Flop (didn't bet)




PokerStars Game #59941649536:  Hold'em No Limit ($0.10/$0.25) - 2009/07/01 1:41:50 ET
Table 'dNYnr4D4id1jwnEU66Yowg' 9-max Seat #7 is the button
Seat 1: 9lvO/qyU+xrU95Teu1fv0g ($4.65 in chips) 
Seat 4: VBHxUExRAMrbxUq/cVx9Gw ($4.95 in chips) 
Seat 5: 7cv+9Zc9HIQHNvYsMfV3uA ($26.05 in chips) 
Seat 6: 8EbrQ/EvFWt2cr0GaU82gQ ($4.65 in chips) 
Seat 7: DiSvPC2iudwL5j9u6Huyww ($25.45 in chips) 
Seat 8: RCqMONFrSPSArZh2Jsar/w ($22.55 in chips) 
RCqMONFrSPSArZh2Jsar/w: posts small blind $0.10
9lvO/qyU+xrU95Teu1fv0g: posts big blind $0.25
Qduu7ikeizo6q6Ei9YvcJA: sits out 
*** HOLE CARDS ***
VBHxUExRAMrbxUq/cVx9Gw: folds 
7cv+9Zc9HIQHNvYsMfV3uA: folds 
8EbrQ/EvFWt2cr0GaU82gQ: folds 
IOx4EH8+y3jYZJc/LTRvOw joins the table at seat #3 
DiSvPC2iudwL5j9u6Huyww: folds 
RCqMONFrSPSArZh2Jsar/w: folds 
Uncalled bet ($0.15) returned to 9lvO/qyU+xrU95Teu1fv0g
/FE4MKSoQhXaDp4PBoLM2g joins the table at seat #9 
9lvO/qyU+xrU95Teu1fv0g collected $0.20 from pot
*** SUMMARY ***
Total pot $0.20 | Rake $0 
Seat 1: 9lvO/qyU+xrU95Teu1fv0g (big blind) collected ($0.20)
Seat 4: VBHxUExRAMrbxUq/cVx9Gw folded before Flop (didn't bet)
Seat 5: 7cv+9Zc9HIQHNvYsMfV3uA folded before Flop (didn't bet)
Seat 6: 8EbrQ/EvFWt2cr0GaU82gQ folded before Flop (didn't bet)
Seat 7: DiSvPC2iudwL5j9u6Huyww (button) folded before Flop (didn't bet)
Seat 8: RCqMONFrSPSArZh2Jsar/w (small blind) folded before Flop




PokerStars Game #59941649684:  Hold'em No Limit ($0.10/$0.25) - 2009/07/01 1:41:50 ET
Table 'Is9eNmJA1KnBOw0lcVkxUQ' 9-max Seat #7 is the button
Seat 1: 56S3mA6Zs3pGR+0p0vUCtg ($32 in chips) 
Seat 2: VllYilcih0t+gMD4GTRlgQ ($38.10 in chips) 
Seat 3: ubsjZomMWSV0hAiBLa7K1A ($19.75 in chips) 
Seat 4: cZ99hugmLBj9KhTlc8nCSw ($25 in chips) 
Seat 6: HapyJHxV6lc3eqoT7yWL2A ($29.10 in chips) 
Seat 7: aNpwfA31EREwO+ar4XzBCw ($29.05 in chips) 
Seat 8: Th3FldXKQW6hWVVPahaoOQ ($25.60 in chips) 
Seat 9: DdPXdieucQ+n99u1n3A+rQ ($4.90 in chips) 
Th3FldXKQW6hWVVPahaoOQ: posts small blind $0.10
DdPXdieucQ+n99u1n3A+rQ: posts big blind $0.25
Qduu7ikeizo6q6Ei9YvcJA: sits out 
*** HOLE CARDS ***
56S3mA6Zs3pGR+0p0vUCtg: folds 
VllYilcih0t+gMD4GTRlgQ: calls $0.25
ubsjZomMWSV0hAiBLa7K1A: folds 
cZ99hugmLBj9KhTlc8nCSw: folds 
HapyJHxV6lc3eqoT7yWL2A: calls $0.25
aNpwfA31EREwO+ar4XzBCw: folds 
Th3FldXKQW6hWVVPahaoOQ: folds 
DdPXdieucQ+n99u1n3A+rQ: checks 
*** FLOP *** [2s 3s Ac]
DdPXdieucQ+n99u1n3A+rQ: checks 
VllYilcih0t+gMD4GTRlgQ: checks 
HapyJHxV6lc3eqoT7yWL2A: checks 
*** TURN *** [2s 3s Ac] [8s]
DdPXdieucQ+n99u1n3A+rQ: bets $0.50
VllYilcih0t+gMD4GTRlgQ: folds 
HapyJHxV6lc3eqoT7yWL2A: calls $0.50
*** RIVER *** [2s 3s Ac 8s] [7c]
DdPXdieucQ+n99u1n3A+rQ: bets $1
HapyJHxV6lc3eqoT7yWL2A: raises $2 to $3
DdPXdieucQ+n99u1n3A+rQ: calls $2
*** SHOW DOWN ***
HapyJHxV6lc3eqoT7yWL2A: shows [5h 4c] (a straight, Ace to Five)
DdPXdieucQ+n99u1n3A+rQ: mucks hand 
HapyJHxV6lc3eqoT7yWL2A collected $7.50 from pot
*** SUMMARY ***
Total pot $7.85 | Rake $0.35 
Board [2s 3s Ac 8s 7c]
Seat 1: 56S3mA6Zs3pGR+0p0vUCtg folded before Flop (didn't bet)
Seat 2: VllYilcih0t+gMD4GTRlgQ folded on the Turn
Seat 3: ubsjZomMWSV0hAiBLa7K1A folded before Flop (didn't bet)
Seat 4: cZ99hugmLBj9KhTlc8nCSw folded before Flop (didn't bet)
Seat 6: HapyJHxV6lc3eqoT7yWL2A showed [5h 4c] and won ($7.50) with a straight, Ace to Five
Seat 7: aNpwfA31EREwO+ar4XzBCw (button) folded before Flop (didn't bet)
Seat 8: Th3FldXKQW6hWVVPahaoOQ (small blind) folded before Flop
Seat 9: DdPXdieucQ+n99u1n3A+rQ (big blind) mucked




PokerStars Game #59941649640:  Hold'em No Limit ($0.10/$0.25) - 2009/07/01 1:41:50 ET
Table 'IIO2q2znuuAXmiZ2qFTcmg' 6-max Seat #2 is the button
Seat 1: 2G0C7dp4wlPpE21FHjjElQ ($25 in chips) 
Seat 2: cS21pIxRHx5Gt42o7hPZzw ($24.80 in chips) 
Seat 3: L3/N/gliETan8N5Gim5h4Q ($25 in chips) 
Seat 4: tSR4329m40dZsN7YOpI9Kw ($59.60 in chips) 
Seat 6: aogAb4Eienxztk8p2v9VVw ($35.65 in chips) 
L3/N/gliETan8N5Gim5h4Q: posts small blind $0.10
tSR4329m40dZsN7YOpI9Kw: posts big blind $0.25
9U3ZKjCsarN0DjR6mSE8Ug: sits out 
aogAb4Eienxztk8p2v9VVw: posts small & big blinds $0.35
*** HOLE CARDS ***
aogAb4Eienxztk8p2v9VVw: checks 
2G0C7dp4wlPpE21FHjjElQ: folds 
cS21pIxRHx5Gt42o7hPZzw: folds 
L3/N/gliETan8N5Gim5h4Q: folds 
tSR4329m40dZsN7YOpI9Kw: checks 
*** FLOP *** [Qs 6h 2c]
tSR4329m40dZsN7YOpI9Kw: checks 
aogAb4Eienxztk8p2v9VVw: bets $0.50
tSR4329m40dZsN7YOpI9Kw: folds 
Uncalled bet ($0.50) returned to aogAb4Eienxztk8p2v9VVw
aogAb4Eienxztk8p2v9VVw collected $0.70 from pot
aogAb4Eienxztk8p2v9VVw: doesn't show hand 
*** SUMMARY ***
Total pot $0.70 | Rake $0 
Board [Qs 6h 2c]
Seat 1: 2G0C7dp4wlPpE21FHjjElQ folded before Flop (didn't bet)
Seat 2: cS21pIxRHx5Gt42o7hPZzw (button) folded before Flop (didn't bet)
Seat 3: L3/N/gliETan8N5Gim5h4Q (small blind) folded before Flop
Seat 4: tSR4329m40dZsN7YOpI9Kw (big blind) folded on the Flop
Seat 6: aogAb4Eienxztk8p2v9VVw collected ($0.70)




PokerStars Game #59941650062:  Hold'em No Limit ($0.10/$0.25) - 2009/07/01 1:41:50 ET
Table 'mVdLgAdN9rGe6mMwSrDdGQ' 6-max Seat #5 is the button
Seat 2: n9QqWD4tpbongUBX2Oi58w ($5.15 in chips) 
Seat 3: +baiVgI/ETnBARLe5mARCw ($11.35 in chips) 
Seat 4: scNSjC6yyKvvfklSkuzLrw ($17.20 in chips) 
Seat 5: +TMG/MBWpiEnc9t7i07eTA ($30.75 in chips) 
Seat 6: DihMHaz4WNETH1bPDe13kA ($47.30 in chips) 
DihMHaz4WNETH1bPDe13kA: posts small blind $0.10
OyJ0KTHA5cwh0/yCo1/rdA has returned
n9QqWD4tpbongUBX2Oi58w: posts big blind $0.25
*** HOLE CARDS ***
+baiVgI/ETnBARLe5mARCw: folds 
scNSjC6yyKvvfklSkuzLrw: folds 
+TMG/MBWpiEnc9t7i07eTA: calls $0.25
DihMHaz4WNETH1bPDe13kA: raises $0.90 to $1.15
n9QqWD4tpbongUBX2Oi58w: folds 
+TMG/MBWpiEnc9t7i07eTA: folds 
Uncalled bet ($0.90) returned to DihMHaz4WNETH1bPDe13kA
DihMHaz4WNETH1bPDe13kA collected $0.75 from pot
*** SUMMARY ***
Total pot $0.75 | Rake $0 
Seat 2: n9QqWD4tpbongUBX2Oi58w (big blind) folded before Flop
Seat 3: +baiVgI/ETnBARLe5mARCw folded before Flop (didn't bet)
Seat 4: scNSjC6yyKvvfklSkuzLrw folded before Flop (didn't bet)
Seat 5: +TMG/MBWpiEnc9t7i07eTA (button) folded before Flop
Seat 6: DihMHaz4WNETH1bPDe13kA (small blind) collected ($0.75)




PokerStars Game #59941649918:  Hold'em No Limit ($0.10/$0.25) - 2009/07/01 1:41:50 ET
Table 'n8mNkPYbe1AIQEkioNesZA' 9-max Seat #3 is the button
Seat 1: 9lvO/qyU+xrU95Teu1fv0g ($5.55 in chips) 
Seat 2: QEbIGci+itdw+re8RM5fZA ($30.05 in chips) 
Seat 3: zDrucyjVn5aeekNEc3cJrA ($19 in chips) 
Seat 4: zgi+EUykT/pZQpoUG6+oEg ($5.10 in chips) 
Seat 5: wGigCmBR/9XWkPpvYos3aQ ($29.15 in chips) 
Seat 6: HPEB+AtKw1+C/cxU0o1ciw ($46.90 in chips) 
Seat 7: sGFnnRCa1YAHAUmWgsW6Qg ($10 in chips) 
Seat 8: aNpwfA31EREwO+ar4XzBCw ($25.35 in chips) 
Seat 9: gehe91e0IyVT0QU/XBkEyg ($27.90 in chips) 
zgi+EUykT/pZQpoUG6+oEg: posts small blind $0.10
wGigCmBR/9XWkPpvYos3aQ: posts big blind $0.25
*** HOLE CARDS ***
HPEB+AtKw1+C/cxU0o1ciw: folds 
sGFnnRCa1YAHAUmWgsW6Qg: folds 
aNpwfA31EREwO+ar4XzBCw: raises $0.75 to $1
gehe91e0IyVT0QU/XBkEyg: folds 
9lvO/qyU+xrU95Teu1fv0g: folds 
QEbIGci+itdw+re8RM5fZA: folds 
zDrucyjVn5aeekNEc3cJrA: folds 
zDrucyjVn5aeekNEc3cJrA is sitting out
zgi+EUykT/pZQpoUG6+oEg: folds 
wGigCmBR/9XWkPpvYos3aQ: folds 
Uncalled bet ($0.75) returned to aNpwfA31EREwO+ar4XzBCw
aNpwfA31EREwO+ar4XzBCw collected $0.60 from pot
aNpwfA31EREwO+ar4XzBCw: doesn't show hand 
*** SUMMARY ***
Total pot $0.60 | Rake $0 
Seat 1: 9lvO/qyU+xrU95Teu1fv0g folded before Flop (didn't bet)
Seat 2: QEbIGci+itdw+re8RM5fZA folded before Flop (didn't bet)
Seat 3: zDrucyjVn5aeekNEc3cJrA (button) folded before Flop (didn't bet)
Seat 4: zgi+EUykT/pZQpoUG6+oEg (small blind) folded before Flop
Seat 5: wGigCmBR/9XWkPpvYos3aQ (big blind) folded before Flop
Seat 6: HPEB+AtKw1+C/cxU0o1ciw folded before Flop (didn't bet)
Seat 7: sGFnnRCa1YAHAUmWgsW6Qg folded before Flop (didn't bet)
Seat 8: aNpwfA31EREwO+ar4XzBCw collected ($0.60)
Seat 9: gehe91e0IyVT0QU/XBkEyg folded before Flop (didn't bet)




PokerStars Game #59941649608:  Hold'em No Limit ($0.10/$0.25) - 2009/07/01 1:41:50 ET
Table 'YlRA05h9BJ1EhOUSNUjJdg' 9-max Seat #1 is the button
Seat 1: dtZ84flFEi4Q+SGrHMJRDQ ($25 in chips) 
Seat 2: Y2GFAe+PT7xnUUtgqCNDFw ($12.40 in chips) 
Seat 3: Z5ZtGOON8kmSdSCll9Z3XA ($12.10 in chips) 
Seat 4: HPEB+AtKw1+C/cxU0o1ciw ($31.35 in chips) 
Seat 5: sx0lGrkT9fd4yFR+3cXUQg ($11.05 in chips) 
Seat 6: QEbIGci+itdw+re8RM5fZA ($44.35 in chips) 
Seat 7: dfNim92Z6XK1/h5SFW5vDg ($25 in chips) 
Seat 8: dmYlc+1cjwZMJ7wV+Z0rRg ($32.10 in chips) 
Seat 9: Z9AeOQX3yzuSvKAm/xyovg ($9.75 in chips) 
Y2GFAe+PT7xnUUtgqCNDFw: posts small blind $0.10
Z5ZtGOON8kmSdSCll9Z3XA: posts big blind $0.25
*** HOLE CARDS ***
HPEB+AtKw1+C/cxU0o1ciw: folds 
sx0lGrkT9fd4yFR+3cXUQg: folds 
QEbIGci+itdw+re8RM5fZA: folds 
dfNim92Z6XK1/h5SFW5vDg: folds 
dmYlc+1cjwZMJ7wV+Z0rRg: raises $0.50 to $0.75
Z9AeOQX3yzuSvKAm/xyovg: folds 
dtZ84flFEi4Q+SGrHMJRDQ: folds 
Y2GFAe+PT7xnUUtgqCNDFw: folds 
Z5ZtGOON8kmSdSCll9Z3XA: calls $0.50
*** FLOP *** [9s Qc 6s]
Z5ZtGOON8kmSdSCll9Z3XA: checks 
dmYlc+1cjwZMJ7wV+Z0rRg: bets $1
Z5ZtGOON8kmSdSCll9Z3XA: folds 
Uncalled bet ($1) returned to dmYlc+1cjwZMJ7wV+Z0rRg
dmYlc+1cjwZMJ7wV+Z0rRg collected $1.55 from pot
dmYlc+1cjwZMJ7wV+Z0rRg: doesn't show hand 
*** SUMMARY ***
Total pot $1.60 | Rake $0.05 
Board [9s Qc 6s]
Seat 1: dtZ84flFEi4Q+SGrHMJRDQ (button) folded before Flop (didn't bet)
Seat 2: Y2GFAe+PT7xnUUtgqCNDFw (small blind) folded before Flop
Seat 3: Z5ZtGOON8kmSdSCll9Z3XA (big blind) folded on the Flop
Seat 4: HPEB+AtKw1+C/cxU0o1ciw folded before Flop (didn't bet)
Seat 5: sx0lGrkT9fd4yFR+3cXUQg folded before Flop (didn't bet)
Seat 6: QEbIGci+itdw+re8RM5fZA folded before Flop (didn't bet)
Seat 7: dfNim92Z6XK1/h5SFW5vDg folded before Flop (didn't bet)
Seat 8: dmYlc+1cjwZMJ7wV+Z0rRg collected ($1.55)
Seat 9: Z9AeOQX3yzuSvKAm/xyovg folded before Flop (didn't bet)




PokerStars Game #59941649578:  Hold'em No Limit ($0.10/$0.25) - 2009/07/01 1:41:50 ET
Table '1zj0+miaIL9cvwnT/50pOA' 9-max Seat #9 is the button
Seat 1: PVxvfRTRvkgZf9WtquEkwQ ($25.45 in chips) 
Seat 2: HPEB+AtKw1+C/cxU0o1ciw ($43.30 in chips) 
Seat 3: dtZ84flFEi4Q+SGrHMJRDQ ($28.60 in chips) 
Seat 4: PdIasPkzm2sqZnN41ZRXOg ($5 in chips) 
Seat 5: 57qrNGHDvf6GhB8zVLsAtQ ($4.35 in chips) 
Seat 6: YZaC69gFrepA6oCGtu7E0w ($29.20 in chips) 
Seat 7: 6RiVTYll/5D8zICp0MRpKw ($23.90 in chips) 
Seat 8: Ihhh49x48fayPIyvl2Rsmg ($28.30 in chips) 
Seat 9: AyqFvLFzJDE7yMbXP362BA ($33.65 in chips) 
PVxvfRTRvkgZf9WtquEkwQ: posts small blind $0.10
HPEB+AtKw1+C/cxU0o1ciw: posts big blind $0.25
*** HOLE CARDS ***
dtZ84flFEi4Q+SGrHMJRDQ: folds 
PdIasPkzm2sqZnN41ZRXOg: folds 
57qrNGHDvf6GhB8zVLsAtQ: folds 
YZaC69gFrepA6oCGtu7E0w: folds 
6RiVTYll/5D8zICp0MRpKw: folds 
Ihhh49x48fayPIyvl2Rsmg: calls $0.25
AyqFvLFzJDE7yMbXP362BA: raises $1 to $1.25
PVxvfRTRvkgZf9WtquEkwQ: folds 
HPEB+AtKw1+C/cxU0o1ciw: folds 
Ihhh49x48fayPIyvl2Rsmg: calls $1
*** FLOP *** [5h Qd Qh]
Ihhh49x48fayPIyvl2Rsmg: checks 
AyqFvLFzJDE7yMbXP362BA: bets $2.25
Ihhh49x48fayPIyvl2Rsmg: calls $2.25
*** TURN *** [5h Qd Qh] [2h]
Ihhh49x48fayPIyvl2Rsmg: checks 
AyqFvLFzJDE7yMbXP362BA: bets $2.25
Ihhh49x48fayPIyvl2Rsmg: raises $5.25 to $7.50
AyqFvLFzJDE7yMbXP362BA: folds 
Uncalled bet ($5.25) returned to Ihhh49x48fayPIyvl2Rsmg
Ihhh49x48fayPIyvl2Rsmg collected $11.30 from pot
*** SUMMARY ***
Total pot $11.85 | Rake $0.55 
Board [5h Qd Qh 2h]
Seat 1: PVxvfRTRvkgZf9WtquEkwQ (small blind) folded before Flop
Seat 2: HPEB+AtKw1+C/cxU0o1ciw (big blind) folded before Flop
Seat 3: dtZ84flFEi4Q+SGrHMJRDQ folded before Flop (didn't bet)
Seat 4: PdIasPkzm2sqZnN41ZRXOg folded before Flop (didn't bet)
Seat 5: 57qrNGHDvf6GhB8zVLsAtQ folded before Flop (didn't bet)
Seat 6: YZaC69gFrepA6oCGtu7E0w folded before Flop (didn't bet)
Seat 7: 6RiVTYll/5D8zICp0MRpKw folded before Flop (didn't bet)
Seat 8: Ihhh49x48fayPIyvl2Rsmg collected ($11.30)
Seat 9: AyqFvLFzJDE7yMbXP362BA (button) folded on the Turn




PokerStars Game #59941650216:  Hold'em No Limit ($0.10/$0.25) - 2009/07/01 1:41:51 ET
Table '3EebBlzq5yHSY2444L4zlg' 9-max Seat #1 is the button
Seat 1: XMSS6mD5B42I8wasdOMipQ ($29.15 in chips) 
Seat 2: b9UnopCOpq2MWP1DwqSO3Q ($18.05 in chips) 
Seat 3: IGbD5vKNhHe60dkdbjg/mw ($43.95 in chips) 
Seat 4: 1S/fpm+f42V/6MNZre+ccg ($25 in chips) 
Seat 5: PFNLAvMkr8qKc7xCiH0wTA ($26.30 in chips) 
Seat 6: QEbIGci+itdw+re8RM5fZA ($50.35 in chips) 
Seat 7: DiSvPC2iudwL5j9u6Huyww ($49.10 in chips) 
Seat 8: dtZ84flFEi4Q+SGrHMJRDQ ($26.90 in chips) 
Seat 9: iZmSlSzYu5fJ67tDdQzymQ ($24.50 in chips) 
b9UnopCOpq2MWP1DwqSO3Q: posts small blind $0.10
IGbD5vKNhHe60dkdbjg/mw: posts big blind $0.25
*** HOLE CARDS ***
1S/fpm+f42V/6MNZre+ccg: raises $0.50 to $0.75
PFNLAvMkr8qKc7xCiH0wTA: folds 
QEbIGci+itdw+re8RM5fZA: folds 
DiSvPC2iudwL5j9u6Huyww: folds 
dtZ84flFEi4Q+SGrHMJRDQ: folds 
iZmSlSzYu5fJ67tDdQzymQ: folds 
XMSS6mD5B42I8wasdOMipQ: folds 
b9UnopCOpq2MWP1DwqSO3Q: folds 
IGbD5vKNhHe60dkdbjg/mw: calls $0.50
*** FLOP *** [7d 6d 3c]
IGbD5vKNhHe60dkdbjg/mw: checks 
1S/fpm+f42V/6MNZre+ccg: bets $1
IGbD5vKNhHe60dkdbjg/mw: calls $1
*** TURN *** [7d 6d 3c] [3h]
IGbD5vKNhHe60dkdbjg/mw: checks 
1S/fpm+f42V/6MNZre+ccg: checks 
*** RIVER *** [7d 6d 3c 3h] [5d]
IGbD5vKNhHe60dkdbjg/mw: checks 
1S/fpm+f42V/6MNZre+ccg: checks 
*** SHOW DOWN ***
IGbD5vKNhHe60dkdbjg/mw: shows [Ad 5s] (two pair, Fives and Threes)
1S/fpm+f42V/6MNZre+ccg: shows [Td Ts] (two pair, Tens and Threes)
1S/fpm+f42V/6MNZre+ccg collected $3.45 from pot
*** SUMMARY ***
Total pot $3.60 | Rake $0.15 
Board [7d 6d 3c 3h 5d]
Seat 1: XMSS6mD5B42I8wasdOMipQ (button) folded before Flop (didn't bet)
Seat 2: b9UnopCOpq2MWP1DwqSO3Q (small blind) folded before Flop
Seat 3: IGbD5vKNhHe60dkdbjg/mw (big blind) showed [Ad 5s] and lost with two pair, Fives and Threes
Seat 4: 1S/fpm+f42V/6MNZre+ccg showed [Td Ts] and won ($3.45) with two pair, Tens and Threes
Seat 5: PFNLAvMkr8qKc7xCiH0wTA folded before Flop (didn't bet)
Seat 6: QEbIGci+itdw+re8RM5fZA folded before Flop (didn't bet)
Seat 7: DiSvPC2iudwL5j9u6Huyww folded before Flop (didn't bet)
Seat 8: dtZ84flFEi4Q+SGrHMJRDQ folded before Flop (didn't bet)
Seat 9: iZmSlSzYu5fJ67tDdQzymQ folded before Flop (didn't bet)




PokerStars Game #59941650196:  Hold'em No Limit ($0.10/$0.25) - 2009/07/01 1:41:51 ET
Table 'NtCSSONEf1zaJo3042tQug' 6-max Seat #2 is the button
Seat 1: KXtdqb+rIMkjc0RvHDksGQ ($35.45 in chips) 
Seat 2: vqWjZmdQu/Hxw96/IJTWdQ ($26.35 in chips) 
Seat 3: 9kUKGKkblnIx3m8rlVol6Q ($15.75 in chips) 
Seat 4: HxD1kB8zCmalQSdWAkKmlg ($29.20 in chips) 
Seat 5: tOAk1Og4mVObMBOfvdDYOw ($28.15 in chips) 
Seat 6: LxehwDpTQ19ph4Qmc78+Pw ($31.75 in chips) 
9kUKGKkblnIx3m8rlVol6Q: posts small blind $0.10
HxD1kB8zCmalQSdWAkKmlg: posts big blind $0.25
*** HOLE CARDS ***
tOAk1Og4mVObMBOfvdDYOw: folds 
LxehwDpTQ19ph4Qmc78+Pw: calls $0.25
KXtdqb+rIMkjc0RvHDksGQ: folds 
vqWjZmdQu/Hxw96/IJTWdQ: raises $1 to $1.25
9kUKGKkblnIx3m8rlVol6Q: folds 
HxD1kB8zCmalQSdWAkKmlg: folds 
LxehwDpTQ19ph4Qmc78+Pw: folds 
Uncalled bet ($1) returned to vqWjZmdQu/Hxw96/IJTWdQ
vqWjZmdQu/Hxw96/IJTWdQ collected $0.85 from pot
vqWjZmdQu/Hxw96/IJTWdQ: doesn't show hand 
*** SUMMARY ***
Total pot $0.85 | Rake $0 
Seat 1: KXtdqb+rIMkjc0RvHDksGQ folded before Flop (didn't bet)
Seat 2: vqWjZmdQu/Hxw96/IJTWdQ (button) collected ($0.85)
Seat 3: 9kUKGKkblnIx3m8rlVol6Q (small blind) folded before Flop
Seat 4: HxD1kB8zCmalQSdWAkKmlg (big blind) folded before Flop
Seat 5: tOAk1Og4mVObMBOfvdDYOw folded before Flop (didn't bet)
Seat 6: LxehwDpTQ19ph4Qmc78+Pw folded before Flop




PokerStars Game #59941650094:  Hold'em No Limit ($0.10/$0.25) - 2009/07/01 1:41:51 ET
Table 'nlpa8xI95gAflovnFxB2yg' 6-max Seat #3 is the button
Seat 1: fZQg9veL7Dd/Z04ZTjC+wQ ($64.05 in chips) 
Seat 2: Yuyy/pDz3yAO3EbHYRYnKw ($25.15 in chips) 
Seat 3: DihMHaz4WNETH1bPDe13kA ($25.45 in chips) 
Seat 4: if4dh6jhJXeN3/qd3qCp9g ($24.75 in chips) 
Seat 5: FDWzjQgBA5K04jOIY/j22w ($9.30 in chips) 
Seat 6: ATNFxN8fYVfSZMQW8dvbvw ($6.15 in chips) 
if4dh6jhJXeN3/qd3qCp9g: posts small blind $0.10
FDWzjQgBA5K04jOIY/j22w: posts big blind $0.25
*** HOLE CARDS ***
ATNFxN8fYVfSZMQW8dvbvw: folds 
fZQg9veL7Dd/Z04ZTjC+wQ: raises $0.50 to $0.75
Yuyy/pDz3yAO3EbHYRYnKw: folds 
DihMHaz4WNETH1bPDe13kA: calls $0.75
if4dh6jhJXeN3/qd3qCp9g: folds 
FDWzjQgBA5K04jOIY/j22w: folds 
*** FLOP *** [5d 8d 4s]
fZQg9veL7Dd/Z04ZTjC+wQ: checks 
DihMHaz4WNETH1bPDe13kA: checks 
*** TURN *** [5d 8d 4s] [5c]
fZQg9veL7Dd/Z04ZTjC+wQ: checks 
DihMHaz4WNETH1bPDe13kA: bets $1.15
fZQg9veL7Dd/Z04ZTjC+wQ: calls $1.15
*** RIVER *** [5d 8d 4s 5c] [Js]
fZQg9veL7Dd/Z04ZTjC+wQ: checks 
DihMHaz4WNETH1bPDe13kA: checks 
*** SHOW DOWN ***
fZQg9veL7Dd/Z04ZTjC+wQ: shows [Qd As] (a pair of Fives)
DihMHaz4WNETH1bPDe13kA: shows [Tc 8c] (two pair, Eights and Fives)
DihMHaz4WNETH1bPDe13kA collected $3.95 from pot
*** SUMMARY ***
Total pot $4.15 | Rake $0.20 
Board [5d 8d 4s 5c Js]
Seat 1: fZQg9veL7Dd/Z04ZTjC+wQ showed [Qd As] and lost with a pair of Fives
Seat 2: Yuyy/pDz3yAO3EbHYRYnKw folded before Flop (didn't bet)
Seat 3: DihMHaz4WNETH1bPDe13kA (button) showed [Tc 8c] and won ($3.95) with two pair, Eights and Fives
Seat 4: if4dh6jhJXeN3/qd3qCp9g (small blind) folded before Flop
Seat 5: FDWzjQgBA5K04jOIY/j22w (big blind) folded before Flop
Seat 6: ATNFxN8fYVfSZMQW8dvbvw folded before Flop (didn't bet)




PokerStars Game #59941650294:  Hold'em No Limit ($0.10/$0.25) - 2009/07/01 1:41:51 ET
Table 'g+mPuNJBCHKE9ents7ZGtg' 6-max Seat #2 is the button
Seat 1: cezpHJ8FB07dj0xG+LhOvw ($59.45 in chips) 
Seat 2: fZQg9veL7Dd/Z04ZTjC+wQ ($65.70 in chips) 
Seat 3: FYepjhAvF8ZdVCmqHIy+eQ ($25.35 in chips) 
Seat 4: yVrjRIW0SMxgpvqSIPSe/w ($13.95 in chips) 
Seat 5: D3ikCR8c/o9jB5irZ3uGlw ($12.90 in chips) 
Seat 6: Mn2V28t5aGq2d09z+/o6Fw ($7.80 in chips) 
FYepjhAvF8ZdVCmqHIy+eQ: posts small blind $0.10
yVrjRIW0SMxgpvqSIPSe/w: posts big blind $0.25
*** HOLE CARDS ***
D3ikCR8c/o9jB5irZ3uGlw: calls $0.25
Mn2V28t5aGq2d09z+/o6Fw: raises $0.75 to $1
cezpHJ8FB07dj0xG+LhOvw: folds 
fZQg9veL7Dd/Z04ZTjC+wQ: folds 
FYepjhAvF8ZdVCmqHIy+eQ: raises $2 to $3
yVrjRIW0SMxgpvqSIPSe/w: folds 
D3ikCR8c/o9jB5irZ3uGlw: folds 
Mn2V28t5aGq2d09z+/o6Fw: calls $2
*** FLOP *** [5d 6s 3c]
FYepjhAvF8ZdVCmqHIy+eQ: checks 
Mn2V28t5aGq2d09z+/o6Fw: checks 
*** TURN *** [5d 6s 3c] [Qd]
FYepjhAvF8ZdVCmqHIy+eQ: bets $6.20
Mn2V28t5aGq2d09z+/o6Fw: folds 
Uncalled bet ($6.20) returned to FYepjhAvF8ZdVCmqHIy+eQ
FYepjhAvF8ZdVCmqHIy+eQ collected $6.20 from pot
FYepjhAvF8ZdVCmqHIy+eQ: doesn't show hand 
*** SUMMARY ***
Total pot $6.50 | Rake $0.30 
Board [5d 6s 3c Qd]
Seat 1: cezpHJ8FB07dj0xG+LhOvw folded before Flop (didn't bet)
Seat 2: fZQg9veL7Dd/Z04ZTjC+wQ (button) folded before Flop (didn't bet)
Seat 3: FYepjhAvF8ZdVCmqHIy+eQ (small blind) collected ($6.20)
Seat 4: yVrjRIW0SMxgpvqSIPSe/w (big blind) folded before Flop
Seat 5: D3ikCR8c/o9jB5irZ3uGlw folded before Flop
Seat 6: Mn2V28t5aGq2d09z+/o6Fw folded on the Turn




PokerStars Game #59941650860:  Hold'em No Limit ($0.10/$0.25) - 2009/07/01 1:41:52 ET
Table 'rhQuIjJo0UQ7RRUlF9umHg' 6-max Seat #2 is the button
Seat 1: 5O3Hj9Qg0SqOyKEXoLpjPg ($123.85 in chips) 
Seat 2: Ew/TYPQIsbQ2X8nm5iAJBg ($24.90 in chips) 
Seat 3: if4dh6jhJXeN3/qd3qCp9g ($27.50 in chips) 
Seat 4: buyjetgNT1McXtdaP4zynA ($21.50 in chips) 
Seat 5: dOX4wnYV2sEqvDbF+8KSCw ($52 in chips) 
Seat 6: /gJNBeCkWL4o85/jvlZ4BA ($52.40 in chips) 
if4dh6jhJXeN3/qd3qCp9g: posts small blind $0.10
buyjetgNT1McXtdaP4zynA: posts big blind $0.25
*** HOLE CARDS ***
dOX4wnYV2sEqvDbF+8KSCw: raises $0.75 to $1
/gJNBeCkWL4o85/jvlZ4BA: folds 
5O3Hj9Qg0SqOyKEXoLpjPg: folds 
Ew/TYPQIsbQ2X8nm5iAJBg: calls $1
if4dh6jhJXeN3/qd3qCp9g: folds 
buyjetgNT1McXtdaP4zynA: calls $0.75
*** FLOP *** [Tc 9h 7d]
buyjetgNT1McXtdaP4zynA: checks 
dOX4wnYV2sEqvDbF+8KSCw: bets $1.50
Ew/TYPQIsbQ2X8nm5iAJBg: calls $1.50
buyjetgNT1McXtdaP4zynA: raises $19 to $20.50 and is all-in
dOX4wnYV2sEqvDbF+8KSCw: folds 
Ew/TYPQIsbQ2X8nm5iAJBg: calls $19
*** TURN *** [Tc 9h 7d] [6d]
*** RIVER *** [Tc 9h 7d 6d] [6s]
*** SHOW DOWN ***
buyjetgNT1McXtdaP4zynA: shows [9c Ts] (two pair, Tens and Nines)
Ew/TYPQIsbQ2X8nm5iAJBg: mucks hand 
buyjetgNT1McXtdaP4zynA collected $43.35 from pot
*** SUMMARY ***
Total pot $45.60 | Rake $2.25 
Board [Tc 9h 7d 6d 6s]
Seat 1: 5O3Hj9Qg0SqOyKEXoLpjPg folded before Flop (didn't bet)
Seat 2: Ew/TYPQIsbQ2X8nm5iAJBg (button) mucked
Seat 3: if4dh6jhJXeN3/qd3qCp9g (small blind) folded before Flop
Seat 4: buyjetgNT1McXtdaP4zynA (big blind) showed [9c Ts] and won ($43.35) with two pair, Tens and Nines
Seat 5: dOX4wnYV2sEqvDbF+8KSCw folded on the Flop
Seat 6: /gJNBeCkWL4o85/jvlZ4BA folded before Flop (didn't bet)




PokerStars Game #59941650996:  Hold'em No Limit ($0.10/$0.25) - 2009/07/01 1:41:52 ET
Table 'KKk6y4pAXeymxYcd0uZLqg' 9-max Seat #7 is the button
Seat 1: HPEB+AtKw1+C/cxU0o1ciw ($24.90 in chips) 
Seat 2: k55YB7uP2TAZEba6pnHYiA ($20.45 in chips) 
Seat 4: YciNm3fUXAQaJeXG1rhrbw ($17.45 in chips) 
Seat 5: wGigCmBR/9XWkPpvYos3aQ ($32.90 in chips) 
Seat 6: QEbIGci+itdw+re8RM5fZA ($25 in chips) 
Seat 7: JjOuv8Vf56aiQjWi/rTPFA ($22.65 in chips) 
Seat 8: +2kMBNpY4nF1qNCRd8SJLA ($33.35 in chips) 
Seat 9: oLa/tXLfSLLB28mcLGrxcg ($25 in chips) 
+2kMBNpY4nF1qNCRd8SJLA: posts small blind $0.10
oLa/tXLfSLLB28mcLGrxcg: posts big blind $0.25
tLcDklc2rBORNfixyRfVfw: sits out 
*** HOLE CARDS ***
HPEB+AtKw1+C/cxU0o1ciw: folds 
k55YB7uP2TAZEba6pnHYiA: raises $0.50 to $0.75
YciNm3fUXAQaJeXG1rhrbw: calls $0.75
wGigCmBR/9XWkPpvYos3aQ: raises $2.65 to $3.40
QEbIGci+itdw+re8RM5fZA: folds 
JjOuv8Vf56aiQjWi/rTPFA: folds 
+2kMBNpY4nF1qNCRd8SJLA: folds 
oLa/tXLfSLLB28mcLGrxcg: folds 
k55YB7uP2TAZEba6pnHYiA: folds 
YciNm3fUXAQaJeXG1rhrbw: calls $2.65
*** FLOP *** [6s 7d 2c]
YciNm3fUXAQaJeXG1rhrbw: bets $2
wGigCmBR/9XWkPpvYos3aQ: raises $5.25 to $7.25
YciNm3fUXAQaJeXG1rhrbw: folds 
Uncalled bet ($5.25) returned to wGigCmBR/9XWkPpvYos3aQ
wGigCmBR/9XWkPpvYos3aQ collected $11.35 from pot
wGigCmBR/9XWkPpvYos3aQ: doesn't show hand 
*** SUMMARY ***
Total pot $11.90 | Rake $0.55 
Board [6s 7d 2c]
Seat 1: HPEB+AtKw1+C/cxU0o1ciw folded before Flop (didn't bet)
Seat 2: k55YB7uP2TAZEba6pnHYiA folded before Flop
Seat 4: YciNm3fUXAQaJeXG1rhrbw folded on the Flop
Seat 5: wGigCmBR/9XWkPpvYos3aQ collected ($11.35)
Seat 6: QEbIGci+itdw+re8RM5fZA folded before Flop (didn't bet)
Seat 7: JjOuv8Vf56aiQjWi/rTPFA (button) folded before Flop (didn't bet)
Seat 8: +2kMBNpY4nF1qNCRd8SJLA (small blind) folded before Flop
Seat 9: oLa/tXLfSLLB28mcLGrxcg (big blind) folded before Flop




PokerStars Game #59941650934:  Hold'em No Limit ($0.10/$0.25) - 2009/07/01 1:41:52 ET
Table '+198VWQSWBhYQOcizzuBkw' 6-max Seat #5 is the button
Seat 1: 34ttqW62uIRrqINCCmLcsw ($12.20 in chips) 
Seat 3: vw7gefupgmOJJN8lUemdWg ($23.90 in chips) 
Seat 4: TgDsTeCdLQt8kWbL00ByRA ($16.25 in chips) 
Seat 5: LtASJ9OlkqGrrUKGQlpGAw ($26.45 in chips) 
Seat 6: leEQ84f6wJYu5SB/vj27wg ($10.35 in chips) 
leEQ84f6wJYu5SB/vj27wg: posts small blind $0.10
34ttqW62uIRrqINCCmLcsw: posts big blind $0.25
iauW7L/+7qzAuHow7CD75Q: sits out 
*** HOLE CARDS ***
vw7gefupgmOJJN8lUemdWg: calls $0.25
TgDsTeCdLQt8kWbL00ByRA: folds 
LtASJ9OlkqGrrUKGQlpGAw: folds 
leEQ84f6wJYu5SB/vj27wg: calls $0.15
34ttqW62uIRrqINCCmLcsw: checks 
*** FLOP *** [8c 4s 6d]
leEQ84f6wJYu5SB/vj27wg: checks 
34ttqW62uIRrqINCCmLcsw: checks 
vw7gefupgmOJJN8lUemdWg: bets $0.50
leEQ84f6wJYu5SB/vj27wg: folds 
34ttqW62uIRrqINCCmLcsw: folds 
Uncalled bet ($0.50) returned to vw7gefupgmOJJN8lUemdWg
vw7gefupgmOJJN8lUemdWg collected $0.75 from pot
vw7gefupgmOJJN8lUemdWg: shows [3c 3s] (a pair of Threes)
*** SUMMARY ***
Total pot $0.75 | Rake $0 
Board [8c 4s 6d]
Seat 1: 34ttqW62uIRrqINCCmLcsw (big blind) folded on the Flop
Seat 3: vw7gefupgmOJJN8lUemdWg collected ($0.75)
Seat 4: TgDsTeCdLQt8kWbL00ByRA folded before Flop (didn't bet)
Seat 5: LtASJ9OlkqGrrUKGQlpGAw (button) folded before Flop (didn't bet)
Seat 6: leEQ84f6wJYu5SB/vj27wg (small blind) folded on the Flop




PokerStars Game #59941651070:  Hold'em No Limit ($0.10/$0.25) - 2009/07/01 1:41:52 ET
Table 'nyTW9cVtYentc5V7xU/0jA' 6-max Seat #1 is the button
Seat 1: HI20pVxSHPZ29u9IDkmICg ($10.15 in chips) 
Seat 2: v6mkGzCBCCXcgWQNSYVtKg ($6.25 in chips) 
Seat 3: kG34n23qFQA3nzdOJTQ1dA ($36.45 in chips) 
Seat 4: NkB3D4eVHHXvB9Edaugc1Q ($20.80 in chips) 
Seat 5: zZAcuQ0EvirdEuiIbeaocQ ($14.45 in chips) 
v6mkGzCBCCXcgWQNSYVtKg: posts small blind $0.10
kG34n23qFQA3nzdOJTQ1dA: posts big blind $0.25
*** HOLE CARDS ***
NkB3D4eVHHXvB9Edaugc1Q: calls $0.25
zZAcuQ0EvirdEuiIbeaocQ: folds 
HI20pVxSHPZ29u9IDkmICg: raises $0.50 to $0.75
v6mkGzCBCCXcgWQNSYVtKg: folds 
kG34n23qFQA3nzdOJTQ1dA: folds 
NkB3D4eVHHXvB9Edaugc1Q: calls $0.50
*** FLOP *** [8h 5d 5h]
NkB3D4eVHHXvB9Edaugc1Q: bets $0.25
HI20pVxSHPZ29u9IDkmICg: raises $0.75 to $1
NkB3D4eVHHXvB9Edaugc1Q: folds 
Uncalled bet ($0.75) returned to HI20pVxSHPZ29u9IDkmICg
HI20pVxSHPZ29u9IDkmICg collected $2.25 from pot
*** SUMMARY ***
Total pot $2.35 | Rake $0.10 
Board [8h 5d 5h]
Seat 1: HI20pVxSHPZ29u9IDkmICg (button) collected ($2.25)
Seat 2: v6mkGzCBCCXcgWQNSYVtKg (small blind) folded before Flop
Seat 3: kG34n23qFQA3nzdOJTQ1dA (big blind) folded before Flop
Seat 4: NkB3D4eVHHXvB9Edaugc1Q folded on the Flop
Seat 5: zZAcuQ0EvirdEuiIbeaocQ folded before Flop (didn't bet)




PokerStars Game #59941650886:  Hold'em No Limit ($0.10/$0.25) - 2009/07/01 1:41:52 ET
Table 'AJGgX1ZYM8d68SWMvaLttg' 6-max Seat #6 is the button
Seat 2: zHHLkD2sRljslKKeQv/ZQw ($28.50 in chips) 
Seat 3: 8ClCHtFXGNplITm+63KB+Q ($36.70 in chips) 
Seat 4: Lz/GjRDgmgepqTR7qmS86w ($25.40 in chips) 
Seat 5: Hsvkc0/G2VV78oVmWYXecw ($5.35 in chips) 
Seat 6: UA5OsKS3VPaxa7uC8La/kA ($64.40 in chips) 
zHHLkD2sRljslKKeQv/ZQw: posts small blind $0.10
8ClCHtFXGNplITm+63KB+Q: posts big blind $0.25
*** HOLE CARDS ***
Lz/GjRDgmgepqTR7qmS86w: folds 
Hsvkc0/G2VV78oVmWYXecw: folds 
UA5OsKS3VPaxa7uC8La/kA has timed out while being disconnected
UA5OsKS3VPaxa7uC8La/kA: folds 
UA5OsKS3VPaxa7uC8La/kA is sitting out
zHHLkD2sRljslKKeQv/ZQw: calls $0.15
8ClCHtFXGNplITm+63KB+Q: checks 
*** FLOP *** [9d 7s 5c]
zHHLkD2sRljslKKeQv/ZQw: checks 
8ClCHtFXGNplITm+63KB+Q: checks 
*** TURN *** [9d 7s 5c] [Qh]
UA5OsKS3VPaxa7uC8La/kA has returned
zHHLkD2sRljslKKeQv/ZQw: checks 
8ClCHtFXGNplITm+63KB+Q: checks 
*** RIVER *** [9d 7s 5c Qh] [Qs]
zHHLkD2sRljslKKeQv/ZQw: checks 
8ClCHtFXGNplITm+63KB+Q: checks 
*** SHOW DOWN ***
zHHLkD2sRljslKKeQv/ZQw: shows [2c 4c] (a pair of Queens)
8ClCHtFXGNplITm+63KB+Q: shows [5d Jh] (two pair, Queens and Fives)
8ClCHtFXGNplITm+63KB+Q collected $0.50 from pot
*** SUMMARY ***
Total pot $0.50 | Rake $0 
Board [9d 7s 5c Qh Qs]
Seat 2: zHHLkD2sRljslKKeQv/ZQw (small blind) showed [2c 4c] and lost with a pair of Queens
Seat 3: 8ClCHtFXGNplITm+63KB+Q (big blind) showed [5d Jh] and won ($0.50) with two pair, Queens and Fives
Seat 4: Lz/GjRDgmgepqTR7qmS86w folded before Flop (didn't bet)
Seat 5: Hsvkc0/G2VV78oVmWYXecw folded before Flop (didn't bet)
Seat 6: UA5OsKS3VPaxa7uC8La/kA (button) folded before Flop (didn't bet)




PokerStars Game #59941650736:  Hold'em No Limit ($0.10/$0.25) - 2009/07/01 1:41:52 ET
Table 'AchTjdLS1zBUbH3ZIx6f0w' 6-max Seat #1 is the button
Seat 1: rZ0bUtoerhFGDUSRQMnFog ($28.50 in chips) 
Seat 2: kG34n23qFQA3nzdOJTQ1dA ($66 in chips) 
Seat 3: k9vn40MOqqb+xF+7GZ6v2g ($28.20 in chips) 
Seat 4: q6WfTUAD9mowIP63ASq2Dg ($30.90 in chips) 
Seat 5: 0av6tRNdi0Ui4f15L7gsVg ($26.35 in chips) 
kG34n23qFQA3nzdOJTQ1dA: posts small blind $0.10
k9vn40MOqqb+xF+7GZ6v2g: posts big blind $0.25
*** HOLE CARDS ***
q6WfTUAD9mowIP63ASq2Dg: folds 
epAUIB7h2FJXzUPRIvSkRA joins the table at seat #6 
0av6tRNdi0Ui4f15L7gsVg: folds 
rZ0bUtoerhFGDUSRQMnFog: calls $0.25
kG34n23qFQA3nzdOJTQ1dA: folds 
k9vn40MOqqb+xF+7GZ6v2g: checks 
*** FLOP *** [7d 7h 4s]
k9vn40MOqqb+xF+7GZ6v2g: checks 
rZ0bUtoerhFGDUSRQMnFog: bets $0.25
k9vn40MOqqb+xF+7GZ6v2g: calls $0.25
*** TURN *** [7d 7h 4s] [6h]
k9vn40MOqqb+xF+7GZ6v2g: bets $1.25
rZ0bUtoerhFGDUSRQMnFog: folds 
Uncalled bet ($1.25) returned to k9vn40MOqqb+xF+7GZ6v2g
k9vn40MOqqb+xF+7GZ6v2g collected $1.05 from pot
*** SUMMARY ***
Total pot $1.10 | Rake $0.05 
Board [7d 7h 4s 6h]
Seat 1: rZ0bUtoerhFGDUSRQMnFog (button) folded on the Turn
Seat 2: kG34n23qFQA3nzdOJTQ1dA (small blind) folded before Flop
Seat 3: k9vn40MOqqb+xF+7GZ6v2g (big blind) collected ($1.05)
Seat 4: q6WfTUAD9mowIP63ASq2Dg folded before Flop (didn't bet)
Seat 5: 0av6tRNdi0Ui4f15L7gsVg folded before Flop (didn't bet)




PokerStars Game #59941650730:  Hold'em No Limit ($0.10/$0.25) - 2009/07/01 1:41:52 ET
Table 'xmJKTGBeWCwutccj3YfupQ' 6-max Seat #2 is the button
Seat 1: sVbkVl4OznxBCfi66UB9vw ($27.55 in chips) 
Seat 2: AxhCSFlGEh+FAc+VUD31JQ ($23.20 in chips) 
Seat 3: T5wrp/d5jarm+SxNy8OQAg ($20.20 in chips) 
Seat 4: uWjhTVMpuIroxXcmD3Okug ($11.10 in chips) 
Seat 5: DE9hRlt14g+JdsRQ4wT7hg ($25 in chips) 
T5wrp/d5jarm+SxNy8OQAg: posts small blind $0.10
uWjhTVMpuIroxXcmD3Okug: posts big blind $0.25
9bpVv1/Qh9IYtXuCtl5VtQ: sits out 
*** HOLE CARDS ***
DE9hRlt14g+JdsRQ4wT7hg: raises $0.75 to $1
sVbkVl4OznxBCfi66UB9vw: folds 
AxhCSFlGEh+FAc+VUD31JQ: folds 
T5wrp/d5jarm+SxNy8OQAg: calls $0.90
uWjhTVMpuIroxXcmD3Okug: calls $0.75
*** FLOP *** [Kh 2s Jd]
T5wrp/d5jarm+SxNy8OQAg: checks 
uWjhTVMpuIroxXcmD3Okug: checks 
DE9hRlt14g+JdsRQ4wT7hg: checks 
*** TURN *** [Kh 2s Jd] [Kd]
T5wrp/d5jarm+SxNy8OQAg: checks 
uWjhTVMpuIroxXcmD3Okug: checks 
DE9hRlt14g+JdsRQ4wT7hg: bets $1.50
T5wrp/d5jarm+SxNy8OQAg: calls $1.50
uWjhTVMpuIroxXcmD3Okug: folds 
*** RIVER *** [Kh 2s Jd Kd] [3c]
T5wrp/d5jarm+SxNy8OQAg: checks 
DE9hRlt14g+JdsRQ4wT7hg: checks 
*** SHOW DOWN ***
T5wrp/d5jarm+SxNy8OQAg: shows [9h Tc] (a pair of Kings)
DE9hRlt14g+JdsRQ4wT7hg: shows [Js Ac] (two pair, Kings and Jacks)
DE9hRlt14g+JdsRQ4wT7hg collected $5.75 from pot
*** SUMMARY ***
Total pot $6 | Rake $0.25 
Board [Kh 2s Jd Kd 3c]
Seat 1: sVbkVl4OznxBCfi66UB9vw folded before Flop (didn't bet)
Seat 2: AxhCSFlGEh+FAc+VUD31JQ (button) folded before Flop (didn't bet)
Seat 3: T5wrp/d5jarm+SxNy8OQAg (small blind) showed [9h Tc] and lost with a pair of Kings
Seat 4: uWjhTVMpuIroxXcmD3Okug (big blind) folded on the Turn
Seat 5: DE9hRlt14g+JdsRQ4wT7hg showed [Js Ac] and won ($5.75) with two pair, Kings and Jacks




PokerStars Game #59941651358:  Hold'em No Limit ($0.10/$0.25) - 2009/07/01 1:41:53 ET
Table '4mnXP0EWt9mMZYzTIVDQ0w' 9-max Seat #8 is the button
Seat 1: Z5y2J55JmfLYR6/DPAGHwQ ($24 in chips) 
Seat 2: BLEU2x2bnGRovIelAY6slA ($26.25 in chips) 
Seat 4: 9lvO/qyU+xrU95Teu1fv0g ($7 in chips) 
Seat 5: sSN8Y0AlsBeidZXPKmwXSw ($25.95 in chips) 
Seat 6: 5yjzPss7Y4kAWNDat3e0yQ ($29.10 in chips) 
Seat 7: OiV1PWZ3IkN29JlmCcnTwQ ($5.85 in chips) 
Seat 8: 9YN2IkT2JYYKFErZtZvCtA ($20 in chips) 
Seat 9: N/O9ADKpmqB2ASZuqgodlw ($5.10 in chips) 
N/O9ADKpmqB2ASZuqgodlw: posts small blind $0.10
Z5y2J55JmfLYR6/DPAGHwQ: posts big blind $0.25
*** HOLE CARDS ***
BLEU2x2bnGRovIelAY6slA: folds 
9lvO/qyU+xrU95Teu1fv0g: folds 
sSN8Y0AlsBeidZXPKmwXSw: folds 
5yjzPss7Y4kAWNDat3e0yQ: folds 
OiV1PWZ3IkN29JlmCcnTwQ: raises $0.75 to $1
9YN2IkT2JYYKFErZtZvCtA: folds 
N/O9ADKpmqB2ASZuqgodlw: folds 
Z5y2J55JmfLYR6/DPAGHwQ: folds 
Uncalled bet ($0.75) returned to OiV1PWZ3IkN29JlmCcnTwQ
OiV1PWZ3IkN29JlmCcnTwQ collected $0.60 from pot
OiV1PWZ3IkN29JlmCcnTwQ: doesn't show hand 
*** SUMMARY ***
Total pot $0.60 | Rake $0 
Seat 1: Z5y2J55JmfLYR6/DPAGHwQ (big blind) folded before Flop
Seat 2: BLEU2x2bnGRovIelAY6slA folded before Flop (didn't bet)
Seat 4: 9lvO/qyU+xrU95Teu1fv0g folded before Flop (didn't bet)
Seat 5: sSN8Y0AlsBeidZXPKmwXSw folded before Flop (didn't bet)
Seat 6: 5yjzPss7Y4kAWNDat3e0yQ folded before Flop (didn't bet)
Seat 7: OiV1PWZ3IkN29JlmCcnTwQ collected ($0.60)
Seat 8: 9YN2IkT2JYYKFErZtZvCtA (button) folded before Flop (didn't bet)
Seat 9: N/O9ADKpmqB2ASZuqgodlw (small blind) folded before Flop




PokerStars Game #59941651214:  Hold'em No Limit ($0.10/$0.25) - 2009/07/01 1:41:53 ET
Table '2VkNDXXsBj4bSZw/uK5atw' 6-max Seat #5 is the button
Seat 1: xrf8tAXKQHG99HixCot1Iw ($20.60 in chips) 
Seat 2: v6mkGzCBCCXcgWQNSYVtKg ($6.50 in chips) 
Seat 3: 8D0jr3B4e++Q/cTSnpHdzg ($36.40 in chips) 
Seat 5: 7f0OkhFEOf3T+rVOFHRLnw ($22.05 in chips) 
Seat 6: n6UPMnVR4v8LFP0rWP73Fg ($10.70 in chips) 
n6UPMnVR4v8LFP0rWP73Fg: posts small blind $0.10
xrf8tAXKQHG99HixCot1Iw: posts big blind $0.25
*** HOLE CARDS ***
v6mkGzCBCCXcgWQNSYVtKg: folds 
8D0jr3B4e++Q/cTSnpHdzg: raises $0.75 to $1
7f0OkhFEOf3T+rVOFHRLnw: folds 
n6UPMnVR4v8LFP0rWP73Fg: folds 
xrf8tAXKQHG99HixCot1Iw: folds 
Uncalled bet ($0.75) returned to 8D0jr3B4e++Q/cTSnpHdzg
8D0jr3B4e++Q/cTSnpHdzg collected $0.60 from pot
*** SUMMARY ***
Total pot $0.60 | Rake $0 
Seat 1: xrf8tAXKQHG99HixCot1Iw (big blind) folded before Flop
Seat 2: v6mkGzCBCCXcgWQNSYVtKg folded before Flop (didn't bet)
Seat 3: 8D0jr3B4e++Q/cTSnpHdzg collected ($0.60)
Seat 5: 7f0OkhFEOf3T+rVOFHRLnw (button) folded before Flop (didn't bet)
Seat 6: n6UPMnVR4v8LFP0rWP73Fg (small blind) folded before Flop




PokerStars Game #59941651204:  Hold'em No Limit ($0.10/$0.25) - 2009/07/01 1:41:53 ET
Table 'djcjiEGabFQO0MNG6jEeJQ' 9-max Seat #7 is the button
Seat 1: Bb42QRQMhg5/Y0vHP8/2Xw ($25 in chips) 
Seat 2: WKL8nUFr7TumC4EjLyqYzw ($4.75 in chips) 
Seat 3: zgi+EUykT/pZQpoUG6+oEg ($5 in chips) 
Seat 4: 2wcFsZsqEP5w1StUTVzJCg ($9.55 in chips) 
Seat 5: cZ99hugmLBj9KhTlc8nCSw ($42 in chips) 
Seat 6: aNpwfA31EREwO+ar4XzBCw ($74 in chips) 
Seat 7: 56S3mA6Zs3pGR+0p0vUCtg ($34.95 in chips) 
Seat 8: +sbyWwIcFp9kP0bDtMegfQ ($51.50 in chips) 
Seat 9: HPEB+AtKw1+C/cxU0o1ciw ($47.20 in chips) 
+sbyWwIcFp9kP0bDtMegfQ: posts small blind $0.10
HPEB+AtKw1+C/cxU0o1ciw: posts big blind $0.25
*** HOLE CARDS ***
Bb42QRQMhg5/Y0vHP8/2Xw: folds 
WKL8nUFr7TumC4EjLyqYzw: calls $0.25
zgi+EUykT/pZQpoUG6+oEg: folds 
2wcFsZsqEP5w1StUTVzJCg: folds 
cZ99hugmLBj9KhTlc8nCSw: folds 
aNpwfA31EREwO+ar4XzBCw: folds 
56S3mA6Zs3pGR+0p0vUCtg: folds 
+sbyWwIcFp9kP0bDtMegfQ: calls $0.15
HPEB+AtKw1+C/cxU0o1ciw: checks 
*** FLOP *** [5c Kd 5h]
+sbyWwIcFp9kP0bDtMegfQ: checks 
HPEB+AtKw1+C/cxU0o1ciw: checks 
WKL8nUFr7TumC4EjLyqYzw: bets $0.25
+sbyWwIcFp9kP0bDtMegfQ: folds 
HPEB+AtKw1+C/cxU0o1ciw: folds 
Uncalled bet ($0.25) returned to WKL8nUFr7TumC4EjLyqYzw
WKL8nUFr7TumC4EjLyqYzw collected $0.75 from pot
WKL8nUFr7TumC4EjLyqYzw: doesn't show hand 
*** SUMMARY ***
Total pot $0.75 | Rake $0 
Board [5c Kd 5h]
Seat 1: Bb42QRQMhg5/Y0vHP8/2Xw folded before Flop (didn't bet)
Seat 2: WKL8nUFr7TumC4EjLyqYzw collected ($0.75)
Seat 3: zgi+EUykT/pZQpoUG6+oEg folded before Flop (didn't bet)
Seat 4: 2wcFsZsqEP5w1StUTVzJCg folded before Flop (didn't bet)
Seat 5: cZ99hugmLBj9KhTlc8nCSw folded before Flop (didn't bet)
Seat 6: aNpwfA31EREwO+ar4XzBCw folded before Flop (didn't bet)
Seat 7: 56S3mA6Zs3pGR+0p0vUCtg (button) folded before Flop (didn't bet)
Seat 8: +sbyWwIcFp9kP0bDtMegfQ (small blind) folded on the Flop
Seat 9: HPEB+AtKw1+C/cxU0o1ciw (big blind) folded on the Flop




PokerStars Game #59941651268:  Hold'em No Limit ($0.10/$0.25) - 2009/07/01 1:41:53 ET
Table 'x7YStLKc8hpt/pTgSetPKA' 9-max Seat #8 is the button
Seat 1: tYsOBqdU1+x+yFI7zHO7hQ ($26.60 in chips) 
Seat 2: z5GxcHlYz/GSz6W2uFiTtg ($23.70 in chips) 
Seat 3: S7Ki0P+0AIGPuIfGJjW0gg ($12 in chips) 
Seat 4: ydoFOVgzvZv9ZhuWu9rXAw ($5.25 in chips) 
Seat 5: OiV1PWZ3IkN29JlmCcnTwQ ($5.90 in chips) 
Seat 6: 9YN2IkT2JYYKFErZtZvCtA ($47.70 in chips) 
Seat 7: dtZ84flFEi4Q+SGrHMJRDQ ($26.35 in chips) 
Seat 8: j4q3p0lesp63b1gZDwLBZw ($5 in chips) 
Seat 9: nm4Dj/f+jJEwKVsUnKh73g ($21.65 in chips) 
nm4Dj/f+jJEwKVsUnKh73g: posts small blind $0.10
tYsOBqdU1+x+yFI7zHO7hQ: posts big blind $0.25
*** HOLE CARDS ***
z5GxcHlYz/GSz6W2uFiTtg: folds 
S7Ki0P+0AIGPuIfGJjW0gg: folds 
ydoFOVgzvZv9ZhuWu9rXAw: folds 
OiV1PWZ3IkN29JlmCcnTwQ: raises $0.75 to $1
9YN2IkT2JYYKFErZtZvCtA: folds 
dtZ84flFEi4Q+SGrHMJRDQ: folds 
j4q3p0lesp63b1gZDwLBZw: folds 
nm4Dj/f+jJEwKVsUnKh73g: folds 
tYsOBqdU1+x+yFI7zHO7hQ: folds 
Uncalled bet ($0.75) returned to OiV1PWZ3IkN29JlmCcnTwQ
OiV1PWZ3IkN29JlmCcnTwQ collected $0.60 from pot
OiV1PWZ3IkN29JlmCcnTwQ: doesn't show hand 
*** SUMMARY ***
Total pot $0.60 | Rake $0 
Seat 1: tYsOBqdU1+x+yFI7zHO7hQ (big blind) folded before Flop
Seat 2: z5GxcHlYz/GSz6W2uFiTtg folded before Flop (didn't bet)
Seat 3: S7Ki0P+0AIGPuIfGJjW0gg folded before Flop (didn't bet)
Seat 4: ydoFOVgzvZv9ZhuWu9rXAw folded before Flop (didn't bet)
Seat 5: OiV1PWZ3IkN29JlmCcnTwQ collected ($0.60)
Seat 6: 9YN2IkT2JYYKFErZtZvCtA folded before Flop (didn't bet)
Seat 7: dtZ84flFEi4Q+SGrHMJRDQ folded before Flop (didn't bet)
Seat 8: j4q3p0lesp63b1gZDwLBZw (button) folded before Flop (didn't bet)
Seat 9: nm4Dj/f+jJEwKVsUnKh73g (small blind) folded before Flop




PokerStars Game #59941651426:  Hold'em No Limit ($0.10/$0.25) - 2009/07/01 1:41:53 ET
Table 'RPdw09/gGCIP4xFhDWJgXQ' 9-max Seat #2 is the button
Seat 1: aNpwfA31EREwO+ar4XzBCw ($27.50 in chips) 
Seat 2: Sd1tfhUq/M96GhXGv1hwFQ ($12.95 in chips) 
Seat 3: g5LAv1J/3Thw1zs/SEyfzw ($18 in chips) 
Seat 4: z5GxcHlYz/GSz6W2uFiTtg ($10.80 in chips) 
Seat 5: gehe91e0IyVT0QU/XBkEyg ($30.60 in chips) 
Seat 6: monZeAwXUmIA1l84cUd2hw ($14.60 in chips) 
Seat 7: EP17SQz/iWcuYdNOGeBgkw ($14.25 in chips) 
Seat 8: MG90wfSJZnOejs/KD3vlQQ ($25.15 in chips) 
Seat 9: O02ScVDnDZwH6KjZNJZMzA ($3.40 in chips) 
g5LAv1J/3Thw1zs/SEyfzw: posts small blind $0.10
z5GxcHlYz/GSz6W2uFiTtg: posts big blind $0.25
*** HOLE CARDS ***
gehe91e0IyVT0QU/XBkEyg: folds 
monZeAwXUmIA1l84cUd2hw: folds 
EP17SQz/iWcuYdNOGeBgkw: folds 
MG90wfSJZnOejs/KD3vlQQ: raises $0.50 to $0.75
O02ScVDnDZwH6KjZNJZMzA: folds 
aNpwfA31EREwO+ar4XzBCw: folds 
Sd1tfhUq/M96GhXGv1hwFQ: calls $0.75
g5LAv1J/3Thw1zs/SEyfzw: folds 
z5GxcHlYz/GSz6W2uFiTtg: folds 
*** FLOP *** [3h Ks 5h]
MG90wfSJZnOejs/KD3vlQQ: bets $1.40
Sd1tfhUq/M96GhXGv1hwFQ: raises $1.85 to $3.25
MG90wfSJZnOejs/KD3vlQQ: raises $6.55 to $9.80
Sd1tfhUq/M96GhXGv1hwFQ: folds 
Uncalled bet ($6.55) returned to MG90wfSJZnOejs/KD3vlQQ
MG90wfSJZnOejs/KD3vlQQ collected $7.95 from pot
MG90wfSJZnOejs/KD3vlQQ: doesn't show hand 
*** SUMMARY ***
Total pot $8.35 | Rake $0.40 
Board [3h Ks 5h]
Seat 1: aNpwfA31EREwO+ar4XzBCw folded before Flop (didn't bet)
Seat 2: Sd1tfhUq/M96GhXGv1hwFQ (button) folded on the Flop
Seat 3: g5LAv1J/3Thw1zs/SEyfzw (small blind) folded before Flop
Seat 4: z5GxcHlYz/GSz6W2uFiTtg (big blind) folded before Flop
Seat 5: gehe91e0IyVT0QU/XBkEyg folded before Flop (didn't bet)
Seat 6: monZeAwXUmIA1l84cUd2hw folded before Flop (didn't bet)
Seat 7: EP17SQz/iWcuYdNOGeBgkw folded before Flop (didn't bet)
Seat 8: MG90wfSJZnOejs/KD3vlQQ collected ($7.95)
Seat 9: O02ScVDnDZwH6KjZNJZMzA folded before Flop (didn't bet)




PokerStars Game #59941651590:  Hold'em No Limit ($0.10/$0.25) - 2009/07/01 1:41:53 ET
Table '2AUmC2Rslg+QUbLfdgNdfg' 6-max Seat #1 is the button
Seat 1: YDXAegrCnzc0l6TSDNboXQ ($24 in chips) 
Seat 2: PLksyNlTVRVZwxJVC2/1eA ($23.60 in chips) 
Seat 3: JFIAqU8lCZ0vWwEl4bdGsg ($25.70 in chips) 
Seat 4: lquriepNQBhDV5P1SWHhnA ($26.60 in chips) 
Seat 5: AMc4cCwUJhokdGRYIaVPhQ ($22.60 in chips) 
Seat 6: xBWc54v+UTSJOiKpbAbJWg ($11.85 in chips) 
PLksyNlTVRVZwxJVC2/1eA: posts small blind $0.10
JFIAqU8lCZ0vWwEl4bdGsg: posts big blind $0.25
*** HOLE CARDS ***
lquriepNQBhDV5P1SWHhnA: folds 
AMc4cCwUJhokdGRYIaVPhQ: folds 
xBWc54v+UTSJOiKpbAbJWg: calls $0.25
YDXAegrCnzc0l6TSDNboXQ: raises $0.75 to $1
PLksyNlTVRVZwxJVC2/1eA: folds 
JFIAqU8lCZ0vWwEl4bdGsg: folds 
xBWc54v+UTSJOiKpbAbJWg: calls $0.75
*** FLOP *** [7d 4c 7c]
xBWc54v+UTSJOiKpbAbJWg: checks 
YDXAegrCnzc0l6TSDNboXQ: bets $1.50
xBWc54v+UTSJOiKpbAbJWg: folds 
Uncalled bet ($1.50) returned to YDXAegrCnzc0l6TSDNboXQ
YDXAegrCnzc0l6TSDNboXQ collected $2.25 from pot
*** SUMMARY ***
Total pot $2.35 | Rake $0.10 
Board [7d 4c 7c]
Seat 1: YDXAegrCnzc0l6TSDNboXQ (button) collected ($2.25)
Seat 2: PLksyNlTVRVZwxJVC2/1eA (small blind) folded before Flop
Seat 3: JFIAqU8lCZ0vWwEl4bdGsg (big blind) folded before Flop
Seat 4: lquriepNQBhDV5P1SWHhnA folded before Flop (didn't bet)
Seat 5: AMc4cCwUJhokdGRYIaVPhQ folded before Flop (didn't bet)
Seat 6: xBWc54v+UTSJOiKpbAbJWg folded on the Flop




PokerStars Game #59941651308:  Hold'em No Limit ($0.10/$0.25) - 2009/07/01 1:41:53 ET
Table 'xPn6TS/y/OWkX7Qa+MUuKA' 6-max Seat #1 is the button
Seat 1: JFIAqU8lCZ0vWwEl4bdGsg ($43.05 in chips) 
Seat 2: buyjetgNT1McXtdaP4zynA ($30.85 in chips) 
Seat 3: q6WfTUAD9mowIP63ASq2Dg ($25.90 in chips) 
Seat 4: SS/yfeArhULzIcOPe8MdPg ($26.90 in chips) 
Seat 5: lquriepNQBhDV5P1SWHhnA ($25.45 in chips) 
Seat 6: DihMHaz4WNETH1bPDe13kA ($25 in chips) 
buyjetgNT1McXtdaP4zynA: posts small blind $0.10
q6WfTUAD9mowIP63ASq2Dg: posts big blind $0.25
*** HOLE CARDS ***
SS/yfeArhULzIcOPe8MdPg: folds 
lquriepNQBhDV5P1SWHhnA: raises $0.50 to $0.75
DihMHaz4WNETH1bPDe13kA: folds 
JFIAqU8lCZ0vWwEl4bdGsg: folds 
buyjetgNT1McXtdaP4zynA: calls $0.65
q6WfTUAD9mowIP63ASq2Dg: calls $0.50
*** FLOP *** [3d 9h Kc]
buyjetgNT1McXtdaP4zynA: checks 
q6WfTUAD9mowIP63ASq2Dg: checks 
lquriepNQBhDV5P1SWHhnA: bets $1.50
buyjetgNT1McXtdaP4zynA: folds 
q6WfTUAD9mowIP63ASq2Dg: folds 
Uncalled bet ($1.50) returned to lquriepNQBhDV5P1SWHhnA
lquriepNQBhDV5P1SWHhnA collected $2.15 from pot
lquriepNQBhDV5P1SWHhnA: doesn't show hand 
*** SUMMARY ***
Total pot $2.25 | Rake $0.10 
Board [3d 9h Kc]
Seat 1: JFIAqU8lCZ0vWwEl4bdGsg (button) folded before Flop (didn't bet)
Seat 2: buyjetgNT1McXtdaP4zynA (small blind) folded on the Flop
Seat 3: q6WfTUAD9mowIP63ASq2Dg (big blind) folded on the Flop
Seat 4: SS/yfeArhULzIcOPe8MdPg folded before Flop (didn't bet)
Seat 5: lquriepNQBhDV5P1SWHhnA collected ($2.15)
Seat 6: DihMHaz4WNETH1bPDe13kA folded before Flop (didn't bet)




PokerStars Game #59941651532:  Hold'em No Limit ($0.10/$0.25) - 2009/07/01 1:41:53 ET
Table 'MJ1SB76A4qJrlEa+C5e/8w' 6-max Seat #3 is the button
Seat 1: 0KDZiuXQg6UI9cqBR/AUnQ ($26 in chips) 
Seat 2: UA5OsKS3VPaxa7uC8La/kA ($36.70 in chips) 
Seat 3: DihMHaz4WNETH1bPDe13kA ($32.90 in chips) 
Seat 4: SFmT9ZsVopnukjvAzrxTRg ($27.90 in chips) 
Seat 5: Hsvkc0/G2VV78oVmWYXecw ($5 in chips) 
Seat 6: JFIAqU8lCZ0vWwEl4bdGsg ($30.30 in chips) 
SFmT9ZsVopnukjvAzrxTRg: posts small blind $0.10
Hsvkc0/G2VV78oVmWYXecw: posts big blind $0.25
*** HOLE CARDS ***
JFIAqU8lCZ0vWwEl4bdGsg: folds 
0KDZiuXQg6UI9cqBR/AUnQ is disconnected 
0KDZiuXQg6UI9cqBR/AUnQ is connected 
0KDZiuXQg6UI9cqBR/AUnQ: folds 
UA5OsKS3VPaxa7uC8La/kA: folds 
DihMHaz4WNETH1bPDe13kA: folds 
SFmT9ZsVopnukjvAzrxTRg: folds 
Uncalled bet ($0.15) returned to Hsvkc0/G2VV78oVmWYXecw
Hsvkc0/G2VV78oVmWYXecw collected $0.20 from pot
Hsvkc0/G2VV78oVmWYXecw: doesn't show hand 
*** SUMMARY ***
Total pot $0.20 | Rake $0 
Seat 1: 0KDZiuXQg6UI9cqBR/AUnQ folded before Flop (didn't bet)
Seat 2: UA5OsKS3VPaxa7uC8La/kA folded before Flop (didn't bet)
Seat 3: DihMHaz4WNETH1bPDe13kA (button) folded before Flop (didn't bet)
Seat 4: SFmT9ZsVopnukjvAzrxTRg (small blind) folded before Flop
Seat 5: Hsvkc0/G2VV78oVmWYXecw (big blind) collected ($0.20)
Seat 6: JFIAqU8lCZ0vWwEl4bdGsg folded before Flop (didn't bet)




PokerStars Game #59941651670:  Hold'em No Limit ($0.10/$0.25) - 2009/07/01 1:41:54 ET
Table 'AHkg4ChqzcMauBx6Qvz8Nw' 6-max Seat #5 is the button
Seat 1: +RDf7SmUjY2kK0PzdBEYqg ($5.50 in chips) 
Seat 2: Vi0JMrTI2BGrPL7UIulJtA ($5.90 in chips) 
Seat 3: 9dToMv2GJLfi00HcpfMnIw ($24.65 in chips) 
Seat 4: Eznneya0vB6S+eXJdVleHA ($18.65 in chips) 
Seat 5: Bada343Si4xKu3fNXY99AA ($5.70 in chips) 
Seat 6: Hsvkc0/G2VV78oVmWYXecw ($5 in chips) 
Hsvkc0/G2VV78oVmWYXecw: posts small blind $0.10
+RDf7SmUjY2kK0PzdBEYqg: posts big blind $0.25
*** HOLE CARDS ***
Vi0JMrTI2BGrPL7UIulJtA: folds 
Eznneya0vB6S+eXJdVleHA said, "you hit the ace u little fish"
9dToMv2GJLfi00HcpfMnIw: folds 
Eznneya0vB6S+eXJdVleHA: calls $0.25
Bada343Si4xKu3fNXY99AA: raises $0.50 to $0.75
Hsvkc0/G2VV78oVmWYXecw: folds 
Eznneya0vB6S+eXJdVleHA said, "even tho i flopped a pair"
+RDf7SmUjY2kK0PzdBEYqg: folds 
Eznneya0vB6S+eXJdVleHA: calls $0.50
*** FLOP *** [Td Ks 5d]
Eznneya0vB6S+eXJdVleHA: checks 
Bada343Si4xKu3fNXY99AA: checks 
*** TURN *** [Td Ks 5d] [6s]
Eznneya0vB6S+eXJdVleHA: checks 
Bada343Si4xKu3fNXY99AA: bets $0.75
Eznneya0vB6S+eXJdVleHA: calls $0.75
*** RIVER *** [Td Ks 5d 6s] [8c]
Eznneya0vB6S+eXJdVleHA: checks 
Bada343Si4xKu3fNXY99AA: checks 
*** SHOW DOWN ***
Eznneya0vB6S+eXJdVleHA: shows [9d Kc] (a pair of Kings)
Bada343Si4xKu3fNXY99AA: mucks hand 
Eznneya0vB6S+eXJdVleHA collected $3.20 from pot
*** SUMMARY ***
Total pot $3.35 | Rake $0.15 
Board [Td Ks 5d 6s 8c]
Seat 1: +RDf7SmUjY2kK0PzdBEYqg (big blind) folded before Flop
Seat 2: Vi0JMrTI2BGrPL7UIulJtA folded before Flop (didn't bet)
Seat 3: 9dToMv2GJLfi00HcpfMnIw folded before Flop (didn't bet)
Seat 4: Eznneya0vB6S+eXJdVleHA showed [9d Kc] and won ($3.20) with a pair of Kings
Seat 5: Bada343Si4xKu3fNXY99AA (button) mucked
Seat 6: Hsvkc0/G2VV78oVmWYXecw (small blind) folded before Flop




PokerStars Game #59941652150:  Hold'em No Limit ($0.10/$0.25) - 2009/07/01 1:41:54 ET
Table 'Qr+t8WGovMECkBv+cV1lrg' 6-max Seat #5 is the button
Seat 1: EeUZtMU058v2ObUACOF4Og ($51.60 in chips) 
Seat 2: GJsS3gwVwlbyroaWrnjqJg ($41.40 in chips) 
Seat 3: uZKkrGByYgd4/ZBX2d4z+w ($22.35 in chips) 
Seat 4: 1NNFfYMd5Hsphl/FYz9fNA ($60.20 in chips) 
Seat 5: 9q7YGTKe9k5fYb4fmZc3Ww ($32.35 in chips) 
Seat 6: xRkU4+naLuz7dEZFbOn9cw ($24.75 in chips) 
xRkU4+naLuz7dEZFbOn9cw: posts small blind $0.10
EeUZtMU058v2ObUACOF4Og: posts big blind $0.25
*** HOLE CARDS ***
GJsS3gwVwlbyroaWrnjqJg: raises $0.75 to $1
uZKkrGByYgd4/ZBX2d4z+w: folds 
1NNFfYMd5Hsphl/FYz9fNA: folds 
9q7YGTKe9k5fYb4fmZc3Ww: folds 
xRkU4+naLuz7dEZFbOn9cw: folds 
EeUZtMU058v2ObUACOF4Og: folds 
Uncalled bet ($0.75) returned to GJsS3gwVwlbyroaWrnjqJg
GJsS3gwVwlbyroaWrnjqJg collected $0.60 from pot
*** SUMMARY ***
Total pot $0.60 | Rake $0 
Seat 1: EeUZtMU058v2ObUACOF4Og (big blind) folded before Flop
Seat 2: GJsS3gwVwlbyroaWrnjqJg collected ($0.60)
Seat 3: uZKkrGByYgd4/ZBX2d4z+w folded before Flop (didn't bet)
Seat 4: 1NNFfYMd5Hsphl/FYz9fNA folded before Flop (didn't bet)
Seat 5: 9q7YGTKe9k5fYb4fmZc3Ww (button) folded before Flop (didn't bet)
Seat 6: xRkU4+naLuz7dEZFbOn9cw (small blind) folded before Flop




PokerStars Game #59941652156:  Hold'em No Limit ($0.10/$0.25) - 2009/07/01 1:41:54 ET
Table 'APEHQjIcZHDZUA4iOjju2g' 6-max Seat #4 is the button
Seat 1: DE9hRlt14g+JdsRQ4wT7hg ($25.35 in chips) 
Seat 2: 3zD3qLXT1bEffAoWGnc7wg ($36.60 in chips) 
Seat 3: 3e/idKqDuPE10t6Zvr//SQ ($24.65 in chips) 
Seat 4: w2mQ4VsGljGwWXydz8tw2A ($37.40 in chips) 
Seat 5: /xN6gc9+8Hew0HxaB6VIVg ($43.65 in chips) 
Seat 6: KXtdqb+rIMkjc0RvHDksGQ ($25.95 in chips) 
/xN6gc9+8Hew0HxaB6VIVg: posts small blind $0.10
KXtdqb+rIMkjc0RvHDksGQ: posts big blind $0.25
*** HOLE CARDS ***
DE9hRlt14g+JdsRQ4wT7hg: folds 
3zD3qLXT1bEffAoWGnc7wg: folds 
3e/idKqDuPE10t6Zvr//SQ: folds 
w2mQ4VsGljGwWXydz8tw2A: folds 
/xN6gc9+8Hew0HxaB6VIVg: folds 
Uncalled bet ($0.15) returned to KXtdqb+rIMkjc0RvHDksGQ
KXtdqb+rIMkjc0RvHDksGQ collected $0.20 from pot
KXtdqb+rIMkjc0RvHDksGQ: doesn't show hand 
*** SUMMARY ***
Total pot $0.20 | Rake $0 
Seat 1: DE9hRlt14g+JdsRQ4wT7hg folded before Flop (didn't bet)
Seat 2: 3zD3qLXT1bEffAoWGnc7wg folded before Flop (didn't bet)
Seat 3: 3e/idKqDuPE10t6Zvr//SQ folded before Flop (didn't bet)
Seat 4: w2mQ4VsGljGwWXydz8tw2A (button) folded before Flop (didn't bet)
Seat 5: /xN6gc9+8Hew0HxaB6VIVg (small blind) folded before Flop
Seat 6: KXtdqb+rIMkjc0RvHDksGQ (big blind) collected ($0.20)




PokerStars Game #59941651730:  Hold'em No Limit ($0.10/$0.25) - 2009/07/01 1:41:54 ET
Table '+giHa6FUL6U5/AZnCJEGvQ' 9-max Seat #5 is the button
Seat 4: 10f7J+bM02ZfDHx0PgkNSg ($15 in chips) 
Seat 5: zDrucyjVn5aeekNEc3cJrA ($44.65 in chips) 
zDrucyjVn5aeekNEc3cJrA: posts small blind $0.10
10f7J+bM02ZfDHx0PgkNSg: posts big blind $0.25
*** HOLE CARDS ***
zDrucyjVn5aeekNEc3cJrA: calls $0.15
10f7J+bM02ZfDHx0PgkNSg: checks 
*** FLOP *** [9h 3d 5c]
10f7J+bM02ZfDHx0PgkNSg: checks 
zDrucyjVn5aeekNEc3cJrA: checks 
*** TURN *** [9h 3d 5c] [Ac]
10f7J+bM02ZfDHx0PgkNSg: checks 
zDrucyjVn5aeekNEc3cJrA: checks 
*** RIVER *** [9h 3d 5c Ac] [9s]
GTMnTen6sQSoCpS9sggLbg joins the table at seat #6 
10f7J+bM02ZfDHx0PgkNSg: checks 
zDrucyjVn5aeekNEc3cJrA: checks 
*** SHOW DOWN ***
10f7J+bM02ZfDHx0PgkNSg: shows [Qd 2d] (a pair of Nines)
zDrucyjVn5aeekNEc3cJrA: shows [Kd Jc] (a pair of Nines - Ace+King kicker)
zDrucyjVn5aeekNEc3cJrA collected $0.50 from pot
zDrucyjVn5aeekNEc3cJrA is sitting out
*** SUMMARY ***
Total pot $0.50 | Rake $0 
Board [9h 3d 5c Ac 9s]
Seat 4: 10f7J+bM02ZfDHx0PgkNSg (big blind) showed [Qd 2d] and lost with a pair of Nines
Seat 5: zDrucyjVn5aeekNEc3cJrA (button) (small blind) showed [Kd Jc] and won ($0.50) with a pair of Nines




PokerStars Game #59941652148:  Hold'em No Limit ($0.10/$0.25) - 2009/07/01 1:41:54 ET
Table 'BmUMTVcNATeov2rAGYU0Qg' 9-max Seat #8 is the button
Seat 1: QEbIGci+itdw+re8RM5fZA ($36.20 in chips) 
Seat 2: jJnMGXoBXye+afMd0k0rUw ($9.95 in chips) 
Seat 3: ir5Jy8ck6DrdqgJ/3chcWw ($7.95 in chips) 
Seat 4: aNpwfA31EREwO+ar4XzBCw ($37.85 in chips) 
Seat 5: QBNcj9fHxkh/+s/oVw+JmQ ($23.60 in chips) 
Seat 6: w1ukf8uPa4+WH561TtVRxA ($25 in chips) 
Seat 7: CmngQmkKTp8tkl6GMRTl6w ($8.40 in chips) 
Seat 8: f/H6PsHRl4W1JyNsEDvPtg ($33.55 in chips) 
Seat 9: /artgaAtyUtUtD8FZo6puA ($11.35 in chips) 
/artgaAtyUtUtD8FZo6puA: posts small blind $0.10
QEbIGci+itdw+re8RM5fZA: posts big blind $0.25
*** HOLE CARDS ***
jJnMGXoBXye+afMd0k0rUw: folds 
ir5Jy8ck6DrdqgJ/3chcWw: folds 
aNpwfA31EREwO+ar4XzBCw: folds 
QBNcj9fHxkh/+s/oVw+JmQ: folds 
w1ukf8uPa4+WH561TtVRxA: folds 
CmngQmkKTp8tkl6GMRTl6w: folds 
f/H6PsHRl4W1JyNsEDvPtg: calls $0.25
/artgaAtyUtUtD8FZo6puA: calls $0.15
QEbIGci+itdw+re8RM5fZA: checks 
*** FLOP *** [Ad 6c 5c]
/artgaAtyUtUtD8FZo6puA: checks 
QEbIGci+itdw+re8RM5fZA: checks 
f/H6PsHRl4W1JyNsEDvPtg: checks 
*** TURN *** [Ad 6c 5c] [Ac]
/artgaAtyUtUtD8FZo6puA: checks 
QEbIGci+itdw+re8RM5fZA: bets $0.75
f/H6PsHRl4W1JyNsEDvPtg: calls $0.75
/artgaAtyUtUtD8FZo6puA: folds 
*** RIVER *** [Ad 6c 5c Ac] [9c]
QEbIGci+itdw+re8RM5fZA: bets $1.50
f/H6PsHRl4W1JyNsEDvPtg: calls $1.50
*** SHOW DOWN ***
QEbIGci+itdw+re8RM5fZA: shows [Jc 6h] (a flush, Ace high)
f/H6PsHRl4W1JyNsEDvPtg: shows [Qc 4c] (a flush, Ace high - Queen higher)
f/H6PsHRl4W1JyNsEDvPtg collected $5 from pot
*** SUMMARY ***
Total pot $5.25 | Rake $0.25 
Board [Ad 6c 5c Ac 9c]
Seat 1: QEbIGci+itdw+re8RM5fZA (big blind) showed [Jc 6h] and lost with a flush, Ace high
Seat 2: jJnMGXoBXye+afMd0k0rUw folded before Flop (didn't bet)
Seat 3: ir5Jy8ck6DrdqgJ/3chcWw folded before Flop (didn't bet)
Seat 4: aNpwfA31EREwO+ar4XzBCw folded before Flop (didn't bet)
Seat 5: QBNcj9fHxkh/+s/oVw+JmQ folded before Flop (didn't bet)
Seat 6: w1ukf8uPa4+WH561TtVRxA folded before Flop (didn't bet)
Seat 7: CmngQmkKTp8tkl6GMRTl6w folded before Flop (didn't bet)
Seat 8: f/H6PsHRl4W1JyNsEDvPtg (button) showed [Qc 4c] and won ($5) with a flush, Ace high
Seat 9: /artgaAtyUtUtD8FZo6puA (small blind) folded on the Turn




PokerStars Game #59941651820:  Hold'em No Limit ($0.10/$0.25) - 2009/07/01 1:41:54 ET
Table 'KAnP7XvDtlku47YfJwdOVw' 9-max Seat #3 is the button
Seat 1: cH3q40adP+kFogl+2MtbkQ ($14.50 in chips) 
Seat 2: VFTQG1/RfAKeMXRBv1ewsg ($28 in chips) 
Seat 3: W6tExOcYX7qiy6Qdp+ZwFA ($5.95 in chips) 
Seat 4: OiV1PWZ3IkN29JlmCcnTwQ ($4.75 in chips) 
Seat 5: MG90wfSJZnOejs/KD3vlQQ ($33.40 in chips) 
Seat 6: z5GxcHlYz/GSz6W2uFiTtg ($21.55 in chips) 
Seat 7: Lro4e37x4FUa5P3yzDjskw ($8.05 in chips) 
Seat 8: OneeONzF0MoH0pEdcBndwA ($22.80 in chips) 
Seat 9: HDDm1BkZtdsRyw2DJdqq6A ($24.30 in chips) 
OiV1PWZ3IkN29JlmCcnTwQ: posts small blind $0.10
MG90wfSJZnOejs/KD3vlQQ: posts big blind $0.25
*** HOLE CARDS ***
z5GxcHlYz/GSz6W2uFiTtg: calls $0.25
Lro4e37x4FUa5P3yzDjskw: folds 
OneeONzF0MoH0pEdcBndwA: folds 
HDDm1BkZtdsRyw2DJdqq6A: folds 
cH3q40adP+kFogl+2MtbkQ: folds 
VFTQG1/RfAKeMXRBv1ewsg: folds 
W6tExOcYX7qiy6Qdp+ZwFA: folds 
OiV1PWZ3IkN29JlmCcnTwQ: folds 
MG90wfSJZnOejs/KD3vlQQ: checks 
*** FLOP *** [Ac 3s 2d]
MG90wfSJZnOejs/KD3vlQQ: checks 
z5GxcHlYz/GSz6W2uFiTtg: bets $0.75
MG90wfSJZnOejs/KD3vlQQ: folds 
Uncalled bet ($0.75) returned to z5GxcHlYz/GSz6W2uFiTtg
z5GxcHlYz/GSz6W2uFiTtg collected $0.60 from pot
*** SUMMARY ***
Total pot $0.60 | Rake $0 
Board [Ac 3s 2d]
Seat 1: cH3q40adP+kFogl+2MtbkQ folded before Flop (didn't bet)
Seat 2: VFTQG1/RfAKeMXRBv1ewsg folded before Flop (didn't bet)
Seat 3: W6tExOcYX7qiy6Qdp+ZwFA (button) folded before Flop (didn't bet)
Seat 4: OiV1PWZ3IkN29JlmCcnTwQ (small blind) folded before Flop
Seat 5: MG90wfSJZnOejs/KD3vlQQ (big blind) folded on the Flop
Seat 6: z5GxcHlYz/GSz6W2uFiTtg collected ($0.60)
Seat 7: Lro4e37x4FUa5P3yzDjskw folded before Flop (didn't bet)
Seat 8: OneeONzF0MoH0pEdcBndwA folded before Flop (didn't bet)
Seat 9: HDDm1BkZtdsRyw2DJdqq6A folded before Flop (didn't bet)




PokerStars Game #59941651900:  Hold'em No Limit ($0.10/$0.25) - 2009/07/01 1:41:54 ET
Table '52Meibn9NOL4XtVi1p2UpwpyZQRcpxhWj2y2cT/ydvwwx Seat #1 is the button
Seat 1: egvg3mTBBVzMHnJPIQiKcA ($16.30 in chips) 
Seat 2: Th3FldXKQW6hWVVPahaoOQ ($98.20 in chips) 
Seat 3: zgi+EUykT/pZQpoUG6+oEg ($4.65 in chips) 
Seat 4: NjesyqE7PJi4nEOa0oOq9w ($16.10 in chips) 
Seat 5: 5n7e7I+px7c6CQmLpPbtsg ($4.70 in chips) 
Seat 6: 4awUyiDYTgylQKXZ9faBVA ($31.45 in chips) 
Seat 7: sGFnnRCa1YAHAUmWgsW6Qg ($9.50 in chips) 
Seat 8: ipgcO7Pa6LC8XWpVttZfnA ($5 in chips) 
Seat 9: bC+Wg1ntzw3N48OwuR1eag ($7.70 in chips) 
Th3FldXKQW6hWVVPahaoOQ: posts small blind $0.10
zgi+EUykT/pZQpoUG6+oEg: posts big blind $0.25
*** HOLE CARDS ***
NjesyqE7PJi4nEOa0oOq9w: folds 
5n7e7I+px7c6CQmLpPbtsg: folds 
4awUyiDYTgylQKXZ9faBVA: folds 
sGFnnRCa1YAHAUmWgsW6Qg: folds 
ipgcO7Pa6LC8XWpVttZfnA: folds 
bC+Wg1ntzw3N48OwuR1eag: raises $0.25 to $0.50
egvg3mTBBVzMHnJPIQiKcA: folds 
Th3FldXKQW6hWVVPahaoOQ: folds 
zgi+EUykT/pZQpoUG6+oEg: folds 
Uncalled bet ($0.25) returned to bC+Wg1ntzw3N48OwuR1eag
bC+Wg1ntzw3N48OwuR1eag collected $0.60 from pot
bC+Wg1ntzw3N48OwuR1eag: doesn't show hand 
*** SUMMARY ***
Total pot $0.60 | Rake $0 
Seat 1: egvg3mTBBVzMHnJPIQiKcA (button) folded before Flop (didn't bet)
Seat 2: Th3FldXKQW6hWVVPahaoOQ (small blind) folded before Flop
Seat 3: zgi+EUykT/pZQpoUG6+oEg (big blind) folded before Flop
Seat 4: NjesyqE7PJi4nEOa0oOq9w folded before Flop (didn't bet)
Seat 5: 5n7e7I+px7c6CQmLpPbtsg folded before Flop (didn't bet)
Seat 6: 4awUyiDYTgylQKXZ9faBVA folded before Flop (didn't bet)
Seat 7: sGFnnRCa1YAHAUmWgsW6Qg folded before Flop (didn't bet)
Seat 8: ipgcO7Pa6LC8XWpVttZfnA folded before Flop (didn't bet)
Seat 9: bC+Wg1ntzw3N48OwuR1eag collected ($0.60)




PokerStars Game #59941651976:  Hold'em No Limit ($0.10/$0.25) - 2009/07/01 1:41:54 ET
Table 'l8hUTjBTXBorNUR/tyvSLw' 9-max Seat #1 is the button
Seat 1: cZ99hugmLBj9KhTlc8nCSw ($27.50 in chips) 
Seat 2: B6xHiX1SJkS0CUNCKDVwuQ ($21 in chips) 
Seat 3: ShCS62CJp4MKfKLKvGKQbA ($10 in chips) 
Seat 4: vPtFvcPtn/Afz0sucO1cmQ ($36.10 in chips) 
Seat 6: EVqHvqty1ZsuvDFiSXlSqQ ($23.85 in chips) 
Seat 7: F7pnn6czNpHvRM55XcA2EA ($33.40 in chips) 
Seat 8: Mh2r9hTeTEDnh19sRZtW3g ($5 in chips) 
Seat 9: zDrucyjVn5aeekNEc3cJrA ($32.70 in chips) 
B6xHiX1SJkS0CUNCKDVwuQ: posts small blind $0.10
ShCS62CJp4MKfKLKvGKQbA: posts big blind $0.25
yyG4svzOpC1A+sUP/scg6w: sits out 
*** HOLE CARDS ***
vPtFvcPtn/Afz0sucO1cmQ: folds 
EVqHvqty1ZsuvDFiSXlSqQ: folds 
F7pnn6czNpHvRM55XcA2EA: folds 
Mh2r9hTeTEDnh19sRZtW3g: folds 
zDrucyjVn5aeekNEc3cJrA: folds 
zDrucyjVn5aeekNEc3cJrA is sitting out
cZ99hugmLBj9KhTlc8nCSw: folds 
B6xHiX1SJkS0CUNCKDVwuQ: folds 
Uncalled bet ($0.15) returned to ShCS62CJp4MKfKLKvGKQbA
ShCS62CJp4MKfKLKvGKQbA collected $0.20 from pot
ShCS62CJp4MKfKLKvGKQbA: doesn't show hand 
*** SUMMARY ***
Total pot $0.20 | Rake $0 
Seat 1: cZ99hugmLBj9KhTlc8nCSw (button) folded before Flop (didn't bet)
Seat 2: B6xHiX1SJkS0CUNCKDVwuQ (small blind) folded before Flop
Seat 3: ShCS62CJp4MKfKLKvGKQbA (big blind) collected ($0.20)
Seat 4: vPtFvcPtn/Afz0sucO1cmQ folded before Flop (didn't bet)
Seat 6: EVqHvqty1ZsuvDFiSXlSqQ folded before Flop (didn't bet)
Seat 7: F7pnn6czNpHvRM55XcA2EA folded before Flop (didn't bet)
Seat 8: Mh2r9hTeTEDnh19sRZtW3g folded before Flop (didn't bet)
Seat 9: zDrucyjVn5aeekNEc3cJrA folded before Flop (didn't bet)




PokerStars Game #59941652178:  Hold'em No Limit ($0.10/$0.25) - 2009/07/01 1:41:54 ET
Table 'IUwZ/e0bDHZPgsIWx0RnNg' 6-max Seat #6 is the button
Seat 1: V66QiVCQPofyl3a+dpPHQQ ($5.45 in chips) 
Seat 2: mvFHK3pE7tCxJEqLjKC70Q ($54.65 in chips) 
Seat 3: dOX4wnYV2sEqvDbF+8KSCw ($25.35 in chips) 
Seat 4: OIjOiBfQstWrK/RuXx7zcw ($5 in chips) 
Seat 6: NhUN/JpAprdJeamFBgJH1w ($40.25 in chips) 
V66QiVCQPofyl3a+dpPHQQ: posts small blind $0.10
mvFHK3pE7tCxJEqLjKC70Q: posts big blind $0.25
OIjOiBfQstWrK/RuXx7zcw: posts big blind $0.25
9bpVv1/Qh9IYtXuCtl5VtQ: sits out 
*** HOLE CARDS ***
dOX4wnYV2sEqvDbF+8KSCw: folds 
OIjOiBfQstWrK/RuXx7zcw: checks 
NhUN/JpAprdJeamFBgJH1w: folds 
V66QiVCQPofyl3a+dpPHQQ: calls $0.15
mvFHK3pE7tCxJEqLjKC70Q: checks 
*** FLOP *** [5s Ts 9h]
V66QiVCQPofyl3a+dpPHQQ: checks 
mvFHK3pE7tCxJEqLjKC70Q: checks 
OIjOiBfQstWrK/RuXx7zcw: bets $0.25
V66QiVCQPofyl3a+dpPHQQ: calls $0.25
mvFHK3pE7tCxJEqLjKC70Q: folds 
*** TURN *** [5s Ts 9h] [3c]
V66QiVCQPofyl3a+dpPHQQ: checks 
OIjOiBfQstWrK/RuXx7zcw: checks 
*** RIVER *** [5s Ts 9h 3c] [2h]
V66QiVCQPofyl3a+dpPHQQ: checks 
OIjOiBfQstWrK/RuXx7zcw: bets $0.50
V66QiVCQPofyl3a+dpPHQQ: folds 
Uncalled bet ($0.50) returned to OIjOiBfQstWrK/RuXx7zcw
OIjOiBfQstWrK/RuXx7zcw collected $1.20 from pot
OIjOiBfQstWrK/RuXx7zcw: doesn't show hand 
*** SUMMARY ***
Total pot $1.25 | Rake $0.05 
Board [5s Ts 9h 3c 2h]
Seat 1: V66QiVCQPofyl3a+dpPHQQ (small blind) folded on the River
Seat 2: mvFHK3pE7tCxJEqLjKC70Q (big blind) folded on the Flop
Seat 3: dOX4wnYV2sEqvDbF+8KSCw folded before Flop (didn't bet)
Seat 4: OIjOiBfQstWrK/RuXx7zcw collected ($1.20)
Seat 6: NhUN/JpAprdJeamFBgJH1w (button) folded before Flop (didn't bet)




PokerStars Game #59941651954:  Hold'em No Limit ($0.10/$0.25) - 2009/07/01 1:41:54 ET
Table 'fIMYcWwN4/aXFJvH5Z8Ymg' 6-max Seat #4 is the button
Seat 1: DihMHaz4WNETH1bPDe13kA ($25.35 in chips) 
Seat 2: vu2kzHaDtgr6NM7rdq0chA ($26.45 in chips) 
Seat 4: 32YL2ZEp8NT4JB2RVM9euQ ($42.40 in chips) 
Seat 5: lquriepNQBhDV5P1SWHhnA ($25 in chips) 
Seat 6: jp34e617tIzV8tKIWmfAbA ($28.35 in chips) 
lquriepNQBhDV5P1SWHhnA: posts small blind $0.10
jp34e617tIzV8tKIWmfAbA: posts big blind $0.25
9bpVv1/Qh9IYtXuCtl5VtQ: sits out 
*** HOLE CARDS ***
DihMHaz4WNETH1bPDe13kA: folds 
vu2kzHaDtgr6NM7rdq0chA: folds 
32YL2ZEp8NT4JB2RVM9euQ: raises $0.75 to $1
lquriepNQBhDV5P1SWHhnA: folds 
jp34e617tIzV8tKIWmfAbA: folds 
Uncalled bet ($0.75) returned to 32YL2ZEp8NT4JB2RVM9euQ
32YL2ZEp8NT4JB2RVM9euQ collected $0.60 from pot
32YL2ZEp8NT4JB2RVM9euQ: doesn't show hand 
*** SUMMARY ***
Total pot $0.60 | Rake $0 
Seat 1: DihMHaz4WNETH1bPDe13kA folded before Flop (didn't bet)
Seat 2: vu2kzHaDtgr6NM7rdq0chA folded before Flop (didn't bet)
Seat 4: 32YL2ZEp8NT4JB2RVM9euQ (button) collected ($0.60)
Seat 5: lquriepNQBhDV5P1SWHhnA (small blind) folded before Flop
Seat 6: jp34e617tIzV8tKIWmfAbA (big blind) folded before Flop




PokerStars Game #59941652676:  Hold'em No Limit ($0.10/$0.25) - 2009/07/01 1:41:55 ET
Table 'eOXPe2c6mG7DOFKvMsZZfA' 6-max Seat #2 is the button
Seat 1: s21kVGMLPAoHdWR+muSonw ($25.40 in chips) 
Seat 2: gaPMxLGp9SOj4Lq6t+/0Ig ($7.10 in chips) 
Seat 3: kReyZ6g6Fu3tQ0nyjDf9kA ($20.80 in chips) 
Seat 4: zHHLkD2sRljslKKeQv/ZQw ($40.60 in chips) 
Seat 5: NhUN/JpAprdJeamFBgJH1w ($32.15 in chips) 
Seat 6: Qpv/hb5ak7LeaDig1L5L8w ($15.10 in chips) 
kReyZ6g6Fu3tQ0nyjDf9kA: posts small blind $0.10
zHHLkD2sRljslKKeQv/ZQw: posts big blind $0.25
*** HOLE CARDS ***
NhUN/JpAprdJeamFBgJH1w: folds 
Qpv/hb5ak7LeaDig1L5L8w: raises $0.50 to $0.75
s21kVGMLPAoHdWR+muSonw: folds 
gaPMxLGp9SOj4Lq6t+/0Ig: folds 
kReyZ6g6Fu3tQ0nyjDf9kA: calls $0.65
zHHLkD2sRljslKKeQv/ZQw: calls $0.50
*** FLOP *** [Th 4s Ks]
kReyZ6g6Fu3tQ0nyjDf9kA: checks 
zHHLkD2sRljslKKeQv/ZQw: bets $0.75
Qpv/hb5ak7LeaDig1L5L8w: calls $0.75
kReyZ6g6Fu3tQ0nyjDf9kA: calls $0.75
*** TURN *** [Th 4s Ks] [7d]
kReyZ6g6Fu3tQ0nyjDf9kA: checks 
zHHLkD2sRljslKKeQv/ZQw: bets $2.50
Qpv/hb5ak7LeaDig1L5L8w: folds 
kReyZ6g6Fu3tQ0nyjDf9kA: calls $2.50
*** RIVER *** [Th 4s Ks 7d] [Kc]
kReyZ6g6Fu3tQ0nyjDf9kA: checks 
zHHLkD2sRljslKKeQv/ZQw: checks 
*** SHOW DOWN ***
kReyZ6g6Fu3tQ0nyjDf9kA: shows [Kd Qh] (three of a kind, Kings)
zHHLkD2sRljslKKeQv/ZQw: mucks hand 
kReyZ6g6Fu3tQ0nyjDf9kA collected $9.05 from pot
*** SUMMARY ***
Total pot $9.50 | Rake $0.45 
Board [Th 4s Ks 7d Kc]
Seat 1: s21kVGMLPAoHdWR+muSonw folded before Flop (didn't bet)
Seat 2: gaPMxLGp9SOj4Lq6t+/0Ig (button) folded before Flop (didn't bet)
Seat 3: kReyZ6g6Fu3tQ0nyjDf9kA (small blind) showed [Kd Qh] and won ($9.05) with three of a kind, Kings
Seat 4: zHHLkD2sRljslKKeQv/ZQw (big blind) mucked
Seat 5: NhUN/JpAprdJeamFBgJH1w folded before Flop (didn't bet)
Seat 6: Qpv/hb5ak7LeaDig1L5L8w folded on the Turn




PokerStars Game #59941652692:  Hold'em No Limit ($0.10/$0.25) - 2009/07/01 1:41:55 ET
Table 'T/iCKJXGphRN3xcdwfE/JQ' 6-max Seat #5 is the button
Seat 1: wAKC8C/zN0c8V5v13dm9mA ($25 in chips) 
Seat 2: EeUZtMU058v2ObUACOF4Og ($33.75 in chips) 
Seat 3: IWAjoCPXtc1XUaZdp+pCpA ($21.75 in chips) 
Seat 4: tSR4329m40dZsN7YOpI9Kw ($54.20 in chips) 
Seat 5: gaPMxLGp9SOj4Lq6t+/0Ig ($4.20 in chips) 
Seat 6: Ey4Kn6PlnYb2srYYBJHvzg ($16.20 in chips) 
Ey4Kn6PlnYb2srYYBJHvzg: posts small blind $0.10
wAKC8C/zN0c8V5v13dm9mA: posts big blind $0.25
*** HOLE CARDS ***
EeUZtMU058v2ObUACOF4Og: calls $0.25
IWAjoCPXtc1XUaZdp+pCpA: folds 
tSR4329m40dZsN7YOpI9Kw: raises $1 to $1.25
gaPMxLGp9SOj4Lq6t+/0Ig: folds 
Ey4Kn6PlnYb2srYYBJHvzg: calls $1.15
wAKC8C/zN0c8V5v13dm9mA: folds 
EeUZtMU058v2ObUACOF4Og: calls $1
*** FLOP *** [6h 6d Qs]
Ey4Kn6PlnYb2srYYBJHvzg: checks 
EeUZtMU058v2ObUACOF4Og: bets $1.50
tSR4329m40dZsN7YOpI9Kw: folds 
Ey4Kn6PlnYb2srYYBJHvzg: folds 
Uncalled bet ($1.50) returned to EeUZtMU058v2ObUACOF4Og
EeUZtMU058v2ObUACOF4Og collected $3.80 from pot
EeUZtMU058v2ObUACOF4Og: doesn't show hand 
*** SUMMARY ***
Total pot $4 | Rake $0.20 
Board [6h 6d Qs]
Seat 1: wAKC8C/zN0c8V5v13dm9mA (big blind) folded before Flop
Seat 2: EeUZtMU058v2ObUACOF4Og collected ($3.80)
Seat 3: IWAjoCPXtc1XUaZdp+pCpA folded before Flop (didn't bet)
Seat 4: tSR4329m40dZsN7YOpI9Kw folded on the Flop
Seat 5: gaPMxLGp9SOj4Lq6t+/0Ig (button) folded before Flop (didn't bet)
Seat 6: Ey4Kn6PlnYb2srYYBJHvzg (small blind) folded on the Flop




PokerStars Game #59941652496:  Hold'em No Limit ($0.10/$0.25) - 2009/07/01 1:41:55 ET
Table 'ggwTHpIC5qhhHJSYjK1XCw' 6-max Seat #4 is the button
Seat 1: MqMK8OWPSY1V4stf1Hy5Jw ($79.20 in chips) 
Seat 2: /gJNBeCkWL4o85/jvlZ4BA ($26.85 in chips) 
Seat 3: SxIIgwXYLkwd6m3wLyPTCw ($66.15 in chips) 
Seat 4: JFIAqU8lCZ0vWwEl4bdGsg ($25.60 in chips) 
Seat 5: BvqhBa7W/To51LhEiIU/lw ($4.75 in chips) 
Seat 6: 732E3Iz0geWMK40ej+U9HA ($14.75 in chips) 
BvqhBa7W/To51LhEiIU/lw: posts small blind $0.10
732E3Iz0geWMK40ej+U9HA: posts big blind $0.25
*** HOLE CARDS ***
MqMK8OWPSY1V4stf1Hy5Jw: folds 
/gJNBeCkWL4o85/jvlZ4BA: folds 
SxIIgwXYLkwd6m3wLyPTCw: folds 
JFIAqU8lCZ0vWwEl4bdGsg: folds 
BvqhBa7W/To51LhEiIU/lw: calls $0.15
732E3Iz0geWMK40ej+U9HA: checks 
*** FLOP *** [3d 3h 6d]
BvqhBa7W/To51LhEiIU/lw: bets $0.25
732E3Iz0geWMK40ej+U9HA: raises $0.50 to $0.75
BvqhBa7W/To51LhEiIU/lw: calls $0.50
*** TURN *** [3d 3h 6d] [Ts]
BvqhBa7W/To51LhEiIU/lw: checks 
732E3Iz0geWMK40ej+U9HA: checks 
*** RIVER *** [3d 3h 6d Ts] [8s]
BvqhBa7W/To51LhEiIU/lw: bets $0.50
732E3Iz0geWMK40ej+U9HA: calls $0.50
*** SHOW DOWN ***
BvqhBa7W/To51LhEiIU/lw: shows [Ac 8c] (two pair, Eights and Threes)
732E3Iz0geWMK40ej+U9HA: mucks hand 
BvqhBa7W/To51LhEiIU/lw collected $2.90 from pot
*** SUMMARY ***
Total pot $3 | Rake $0.10 
Board [3d 3h 6d Ts 8s]
Seat 1: MqMK8OWPSY1V4stf1Hy5Jw folded before Flop (didn't bet)
Seat 2: /gJNBeCkWL4o85/jvlZ4BA folded before Flop (didn't bet)
Seat 3: SxIIgwXYLkwd6m3wLyPTCw folded before Flop (didn't bet)
Seat 4: JFIAqU8lCZ0vWwEl4bdGsg (button) folded before Flop (didn't bet)
Seat 5: BvqhBa7W/To51LhEiIU/lw (small blind) showed [Ac 8c] and won ($2.90) with two pair, Eights and Threes
Seat 6: 732E3Iz0geWMK40ej+U9HA (big blind) mucked




PokerStars Game #59941652494:  Hold'em No Limit ($0.10/$0.25) - 2009/07/01 1:41:55 ET
Table 'mF3KHGMaTpaBZbtBoyfTeg' 6-max Seat #6 is the button
Seat 1: 0HAB2GdCAM7p7V00xueAVQ ($25.35 in chips) 
Seat 2: 6qsh9pnysDKJNhfFhFmKRQ ($9.15 in chips) 
Seat 3: 9kUKGKkblnIx3m8rlVol6Q ($14.65 in chips) 
Seat 4: FYepjhAvF8ZdVCmqHIy+eQ ($25 in chips) 
Seat 5: 8ClCHtFXGNplITm+63KB+Q ($43.40 in chips) 
Seat 6: kG34n23qFQA3nzdOJTQ1dA ($27.75 in chips) 
0HAB2GdCAM7p7V00xueAVQ: posts small blind $0.10
6qsh9pnysDKJNhfFhFmKRQ: posts big blind $0.25
*** HOLE CARDS ***
9kUKGKkblnIx3m8rlVol6Q: calls $0.25
FYepjhAvF8ZdVCmqHIy+eQ: folds 
8ClCHtFXGNplITm+63KB+Q: folds 
kG34n23qFQA3nzdOJTQ1dA: folds 
0HAB2GdCAM7p7V00xueAVQ: calls $0.15
6qsh9pnysDKJNhfFhFmKRQ: checks 
*** FLOP *** [Qc 5d Ks]
0HAB2GdCAM7p7V00xueAVQ: bets $0.25
6qsh9pnysDKJNhfFhFmKRQ: calls $0.25
9kUKGKkblnIx3m8rlVol6Q: calls $0.25
*** TURN *** [Qc 5d Ks] [6h]
0HAB2GdCAM7p7V00xueAVQ: checks 
6qsh9pnysDKJNhfFhFmKRQ: bets $0.50
9kUKGKkblnIx3m8rlVol6Q: calls $0.50
0HAB2GdCAM7p7V00xueAVQ: calls $0.50
*** RIVER *** [Qc 5d Ks 6h] [Jc]
0HAB2GdCAM7p7V00xueAVQ: checks 
6qsh9pnysDKJNhfFhFmKRQ: bets $0.75
9kUKGKkblnIx3m8rlVol6Q: raises $1.25 to $2
0HAB2GdCAM7p7V00xueAVQ: folds 
6qsh9pnysDKJNhfFhFmKRQ: folds 
Uncalled bet ($1.25) returned to 9kUKGKkblnIx3m8rlVol6Q
9kUKGKkblnIx3m8rlVol6Q collected $4.30 from pot
9kUKGKkblnIx3m8rlVol6Q: doesn't show hand 
*** SUMMARY ***
Total pot $4.50 | Rake $0.20 
Board [Qc 5d Ks 6h Jc]
Seat 1: 0HAB2GdCAM7p7V00xueAVQ (small blind) folded on the River
Seat 2: 6qsh9pnysDKJNhfFhFmKRQ (big blind) folded on the River
Seat 3: 9kUKGKkblnIx3m8rlVol6Q collected ($4.30)
Seat 4: FYepjhAvF8ZdVCmqHIy+eQ folded before Flop (didn't bet)
Seat 5: 8ClCHtFXGNplITm+63KB+Q folded before Flop (didn't bet)
Seat 6: kG34n23qFQA3nzdOJTQ1dA (button) folded before Flop (didn't bet)




PokerStars Game #59941652382:  Hold'em No Limit ($0.10/$0.25) - 2009/07/01 1:41:55 ET
Table '6wawJ+MkkvuC3coG6r+Yhg' 6-max Seat #1 is the button
Seat 1: JQZew0FjzS19kTjeNtrE+A ($27.90 in chips) 
Seat 2: LtASJ9OlkqGrrUKGQlpGAw ($33.70 in chips) 
Seat 3: 3zD3qLXT1bEffAoWGnc7wg ($59.85 in chips) 
Seat 4: yxmjNFGiKI3b+XQGJzJVIg ($28.30 in chips) 
Seat 5: FZrgDbxAanC1xwZxXHJKVA ($2.85 in chips) 
Seat 6: B3X187C0tXFUfQpCu8pe8A ($27.10 in chips) 
LtASJ9OlkqGrrUKGQlpGAw: posts small blind $0.10
3zD3qLXT1bEffAoWGnc7wg: posts big blind $0.25
*** HOLE CARDS ***
yxmjNFGiKI3b+XQGJzJVIg: folds 
FZrgDbxAanC1xwZxXHJKVA: folds 
B3X187C0tXFUfQpCu8pe8A has timed out
B3X187C0tXFUfQpCu8pe8A: folds 
B3X187C0tXFUfQpCu8pe8A is sitting out
JQZew0FjzS19kTjeNtrE+A: raises $0.75 to $1
B3X187C0tXFUfQpCu8pe8A has returned
LtASJ9OlkqGrrUKGQlpGAw: folds 
3zD3qLXT1bEffAoWGnc7wg: folds 
Uncalled bet ($0.75) returned to JQZew0FjzS19kTjeNtrE+A
JQZew0FjzS19kTjeNtrE+A collected $0.60 from pot
*** SUMMARY ***
Total pot $0.60 | Rake $0 
Seat 1: JQZew0FjzS19kTjeNtrE+A (button) collected ($0.60)
Seat 2: LtASJ9OlkqGrrUKGQlpGAw (small blind) folded before Flop
Seat 3: 3zD3qLXT1bEffAoWGnc7wg (big blind) folded before Flop
Seat 4: yxmjNFGiKI3b+XQGJzJVIg folded before Flop (didn't bet)
Seat 5: FZrgDbxAanC1xwZxXHJKVA folded before Flop (didn't bet)
Seat 6: B3X187C0tXFUfQpCu8pe8A folded before Flop (didn't bet)




PokerStars Game #59941652648:  Hold'em No Limit ($0.10/$0.25) - 2009/07/01 1:41:55 ET
Table '/JJyyIstHfkT7t/bW+WXgg' 6-max Seat #4 is the button
Seat 1: wsP46AGpqDjHZQmlRHKa9g ($25.85 in chips) 
Seat 2: obJgSnVgWWWaAUtVILo77Q ($7.75 in chips) 
Seat 3: DR0nVIhVP77oEBlO9J8vlg ($46 in chips) 
Seat 4: JFIAqU8lCZ0vWwEl4bdGsg ($35.40 in chips) 
Seat 5: +ZlnqPoP3Hg4BIUxDfKd/A ($48.25 in chips) 
Seat 6: UmcUp27+PbgBItv3ZNlAWQ ($25 in chips) 
+ZlnqPoP3Hg4BIUxDfKd/A: posts small blind $0.10
UmcUp27+PbgBItv3ZNlAWQ: posts big blind $0.25
*** HOLE CARDS ***
wsP46AGpqDjHZQmlRHKa9g: folds 
obJgSnVgWWWaAUtVILo77Q: raises $0.50 to $0.75
DR0nVIhVP77oEBlO9J8vlg: calls $0.75
JFIAqU8lCZ0vWwEl4bdGsg: folds 
+ZlnqPoP3Hg4BIUxDfKd/A: folds 
UmcUp27+PbgBItv3ZNlAWQ: folds 
*** FLOP *** [4c 4d Qs]
obJgSnVgWWWaAUtVILo77Q: checks 
DR0nVIhVP77oEBlO9J8vlg: bets $0.75
obJgSnVgWWWaAUtVILo77Q: calls $0.75
*** TURN *** [4c 4d Qs] [7d]
obJgSnVgWWWaAUtVILo77Q: checks 
DR0nVIhVP77oEBlO9J8vlg: bets $1.25
obJgSnVgWWWaAUtVILo77Q: calls $1.25
*** RIVER *** [4c 4d Qs 7d] [2s]
obJgSnVgWWWaAUtVILo77Q: checks 
DR0nVIhVP77oEBlO9J8vlg: bets $5
obJgSnVgWWWaAUtVILo77Q: calls $5 and is all-in
*** SHOW DOWN ***
DR0nVIhVP77oEBlO9J8vlg: shows [Jc Qc] (two pair, Queens and Fours)
obJgSnVgWWWaAUtVILo77Q: shows [Ac 4s] (three of a kind, Fours)
obJgSnVgWWWaAUtVILo77Q collected $15.10 from pot
*** SUMMARY ***
Total pot $15.85 | Rake $0.75 
Board [4c 4d Qs 7d 2s]
Seat 1: wsP46AGpqDjHZQmlRHKa9g folded before Flop (didn't bet)
Seat 2: obJgSnVgWWWaAUtVILo77Q showed [Ac 4s] and won ($15.10) with three of a kind, Fours
Seat 3: DR0nVIhVP77oEBlO9J8vlg showed [Jc Qc] and lost with two pair, Queens and Fours
Seat 4: JFIAqU8lCZ0vWwEl4bdGsg (button) folded before Flop (didn't bet)
Seat 5: +ZlnqPoP3Hg4BIUxDfKd/A (small blind) folded before Flop
Seat 6: UmcUp27+PbgBItv3ZNlAWQ (big blind) folded before Flop




PokerStars Game #59941652420:  Hold'em No Limit ($0.10/$0.25) - 2009/07/01 1:41:55 ET
Table 'C47I7CmrmFr8Oo7wOovVwQ' 6-max Seat #2 is the button
Seat 1: v6mkGzCBCCXcgWQNSYVtKg ($7 in chips) 
Seat 2: hOaWAImn5/MZDAWAPlYHCw ($3.95 in chips) 
Seat 3: H+8eOP3XJHXjACRDTiIHTQ ($16.15 in chips) 
Seat 4: yY5JuFtDfXWRaZlVby4LLw ($10.75 in chips) 
Seat 5: or309yYY9Y9bfFWtrB0yUg ($12.40 in chips) 
Seat 6: pD7ri5wL3vsa6S1ulMYQmQ ($25 in chips) 
H+8eOP3XJHXjACRDTiIHTQ: posts small blind $0.10
yY5JuFtDfXWRaZlVby4LLw: posts big blind $0.25
v6mkGzCBCCXcgWQNSYVtKg: posts big blind $0.25
*** HOLE CARDS ***
or309yYY9Y9bfFWtrB0yUg: folds 
pD7ri5wL3vsa6S1ulMYQmQ: folds 
v6mkGzCBCCXcgWQNSYVtKg: checks 
hOaWAImn5/MZDAWAPlYHCw: raises $0.25 to $0.50
H+8eOP3XJHXjACRDTiIHTQ: calls $0.40
yY5JuFtDfXWRaZlVby4LLw: calls $0.25
v6mkGzCBCCXcgWQNSYVtKg: folds 
*** FLOP *** [Qc Ad Kc]
H+8eOP3XJHXjACRDTiIHTQ: checks 
yY5JuFtDfXWRaZlVby4LLw: checks 
hOaWAImn5/MZDAWAPlYHCw: checks 
*** TURN *** [Qc Ad Kc] [8c]
H+8eOP3XJHXjACRDTiIHTQ: checks 
yY5JuFtDfXWRaZlVby4LLw: checks 
hOaWAImn5/MZDAWAPlYHCw: checks 
*** RIVER *** [Qc Ad Kc 8c] [Js]
H+8eOP3XJHXjACRDTiIHTQ: checks 
yY5JuFtDfXWRaZlVby4LLw: checks 
hOaWAImn5/MZDAWAPlYHCw: bets $1
H+8eOP3XJHXjACRDTiIHTQ: folds 
yY5JuFtDfXWRaZlVby4LLw: folds 
Uncalled bet ($1) returned to hOaWAImn5/MZDAWAPlYHCw
hOaWAImn5/MZDAWAPlYHCw collected $1.70 from pot
*** SUMMARY ***
Total pot $1.75 | Rake $0.05 
Board [Qc Ad Kc 8c Js]
Seat 1: v6mkGzCBCCXcgWQNSYVtKg folded before Flop
Seat 2: hOaWAImn5/MZDAWAPlYHCw (button) collected ($1.70)
Seat 3: H+8eOP3XJHXjACRDTiIHTQ (small blind) folded on the River
Seat 4: yY5JuFtDfXWRaZlVby4LLw (big blind) folded on the River
Seat 5: or309yYY9Y9bfFWtrB0yUg folded before Flop (didn't bet)
Seat 6: pD7ri5wL3vsa6S1ulMYQmQ folded before Flop (didn't bet)




PokerStars Game #59941653128:  Hold'em No Limit ($0.10/$0.25) - 2009/07/01 1:41:56 ET
Table '9iHhO6FyZVM8XpSc23TIgg' 6-max Seat #6 is the button
Seat 1: NhUN/JpAprdJeamFBgJH1w ($37.50 in chips) 
Seat 2: bJFzs6QmEEnz4miMfSDtcg ($38.30 in chips) 
Seat 3: TSmua8tGK3sTbwi0ynrW9Q ($26.85 in chips) 
Seat 4: cfJccEfyn6IkquPN08hFsA ($63.85 in chips) 
Seat 5: xrf8tAXKQHG99HixCot1Iw ($21.80 in chips) 
Seat 6: iyZxqznXjv3vtvOJymkoLQ ($34.10 in chips) 
NhUN/JpAprdJeamFBgJH1w: posts small blind $0.10
bJFzs6QmEEnz4miMfSDtcg: posts big blind $0.25
*** HOLE CARDS ***
TSmua8tGK3sTbwi0ynrW9Q: folds 
cfJccEfyn6IkquPN08hFsA: raises $0.75 to $1
xrf8tAXKQHG99HixCot1Iw: folds 
iyZxqznXjv3vtvOJymkoLQ: folds 
NhUN/JpAprdJeamFBgJH1w: folds 
bJFzs6QmEEnz4miMfSDtcg: calls $0.75
*** FLOP *** [2s 8h 8c]
bJFzs6QmEEnz4miMfSDtcg: checks 
cfJccEfyn6IkquPN08hFsA: bets $1.75
bJFzs6QmEEnz4miMfSDtcg: calls $1.75
*** TURN *** [2s 8h 8c] [9s]
bJFzs6QmEEnz4miMfSDtcg: checks 
cfJccEfyn6IkquPN08hFsA: checks 
*** RIVER *** [2s 8h 8c 9s] [5c]
bJFzs6QmEEnz4miMfSDtcg: bets $5.25
cfJccEfyn6IkquPN08hFsA: folds 
Uncalled bet ($5.25) returned to bJFzs6QmEEnz4miMfSDtcg
bJFzs6QmEEnz4miMfSDtcg collected $5.35 from pot
bJFzs6QmEEnz4miMfSDtcg: shows [9c 9h] (a full house, Nines full of Eights)
*** SUMMARY ***
Total pot $5.60 | Rake $0.25 
Board [2s 8h 8c 9s 5c]
Seat 1: NhUN/JpAprdJeamFBgJH1w (small blind) folded before Flop
Seat 2: bJFzs6QmEEnz4miMfSDtcg (big blind) collected ($5.35)
Seat 3: TSmua8tGK3sTbwi0ynrW9Q folded before Flop (didn't bet)
Seat 4: cfJccEfyn6IkquPN08hFsA folded on the River
Seat 5: xrf8tAXKQHG99HixCot1Iw folded before Flop (didn't bet)
Seat 6: iyZxqznXjv3vtvOJymkoLQ (button) folded before Flop (didn't bet)




PokerStars Game #59941652918:  Hold'em No Limit ($0.10/$0.25) - 2009/07/01 1:41:56 ET
Table '3LMlz3V4AziGlU+ikmyU8w' 6-max Seat #2 is the button
Seat 1: Wxq4Qyj0DnDXj2+taEOJFQ ($29.15 in chips) 
Seat 2: uR3AbFJLoOX86DOTtTgGcg ($24.70 in chips) 
Seat 3: Hzy03WtPHMYwLYM7hTTxQw ($24.75 in chips) 
Seat 4: 6DwBRH+xZ12AAZmeAg+aXw ($20.25 in chips) 
Seat 5: tOAk1Og4mVObMBOfvdDYOw ($26.10 in chips) 
Seat 6: ZZm/rg8aThjE+A2LiItuzA ($1.10 in chips) 
Hzy03WtPHMYwLYM7hTTxQw: posts small blind $0.10
6DwBRH+xZ12AAZmeAg+aXw: posts big blind $0.25
*** HOLE CARDS ***
tOAk1Og4mVObMBOfvdDYOw: folds 
ZZm/rg8aThjE+A2LiItuzA: folds 
Wxq4Qyj0DnDXj2+taEOJFQ: folds 
uR3AbFJLoOX86DOTtTgGcg: raises $1.25 to $1.50
Hzy03WtPHMYwLYM7hTTxQw: raises $2.50 to $4
6DwBRH+xZ12AAZmeAg+aXw: folds 
uR3AbFJLoOX86DOTtTgGcg: calls $2.50
*** FLOP *** [Qc 5s 2d]
Hzy03WtPHMYwLYM7hTTxQw: bets $6.75
uR3AbFJLoOX86DOTtTgGcg: folds 
Uncalled bet ($6.75) returned to Hzy03WtPHMYwLYM7hTTxQw
Hzy03WtPHMYwLYM7hTTxQw collected $7.85 from pot
*** SUMMARY ***
Total pot $8.25 | Rake $0.40 
Board [Qc 5s 2d]
Seat 1: Wxq4Qyj0DnDXj2+taEOJFQ folded before Flop (didn't bet)
Seat 2: uR3AbFJLoOX86DOTtTgGcg (button) folded on the Flop
Seat 3: Hzy03WtPHMYwLYM7hTTxQw (small blind) collected ($7.85)
Seat 4: 6DwBRH+xZ12AAZmeAg+aXw (big blind) folded before Flop
Seat 5: tOAk1Og4mVObMBOfvdDYOw folded before Flop (didn't bet)
Seat 6: ZZm/rg8aThjE+A2LiItuzA folded before Flop (didn't bet)




PokerStars Game #59941653006:  Hold'em No Limit ($0.10/$0.25) - 2009/07/01 1:41:56 ET
Table 'yAHDCs33TIgw3ra63xuU2Q' 9-max Seat #5 is the button
Seat 1: ydoFOVgzvZv9ZhuWu9rXAw ($4.90 in chips) 
Seat 3: g6UPjSyxNLffCi+EqqIlEg ($21 in chips) 
Seat 4: j5spkbnOCRiLGiH6iqBaqw ($8.25 in chips) 
Seat 5: 4awUyiDYTgylQKXZ9faBVA ($37.60 in chips) 
Seat 6: DnDcAdn9P0zGovMERigpFA ($26.40 in chips) 
Seat 7: qxWFg3MZuVyidB0SJh5ywg ($27.40 in chips) 
Seat 8: tYsOBqdU1+x+yFI7zHO7hQ ($25 in chips) 
Seat 9: MtVtHDqIJTyUcXkRBBDIVA ($25.05 in chips) 
DnDcAdn9P0zGovMERigpFA: posts small blind $0.10
qxWFg3MZuVyidB0SJh5ywg: posts big blind $0.25
*** HOLE CARDS ***
tYsOBqdU1+x+yFI7zHO7hQ: folds 
MtVtHDqIJTyUcXkRBBDIVA: folds 
ydoFOVgzvZv9ZhuWu9rXAw: folds 
g6UPjSyxNLffCi+EqqIlEg: folds 
j5spkbnOCRiLGiH6iqBaqw: folds 
4awUyiDYTgylQKXZ9faBVA: folds 
DnDcAdn9P0zGovMERigpFA: folds 
Uncalled bet ($0.15) returned to qxWFg3MZuVyidB0SJh5ywg
qxWFg3MZuVyidB0SJh5ywg collected $0.20 from pot
*** SUMMARY ***
Total pot $0.20 | Rake $0 
Seat 1: ydoFOVgzvZv9ZhuWu9rXAw folded before Flop (didn't bet)
Seat 3: g6UPjSyxNLffCi+EqqIlEg folded before Flop (didn't bet)
Seat 4: j5spkbnOCRiLGiH6iqBaqw folded before Flop (didn't bet)
Seat 5: 4awUyiDYTgylQKXZ9faBVA (button) folded before Flop (didn't bet)
Seat 6: DnDcAdn9P0zGovMERigpFA (small blind) folded before Flop
Seat 7: qxWFg3MZuVyidB0SJh5ywg (big blind) collected ($0.20)
Seat 8: tYsOBqdU1+x+yFI7zHO7hQ folded before Flop (didn't bet)
Seat 9: MtVtHDqIJTyUcXkRBBDIVA folded before Flop (didn't bet)




PokerStars Game #59941653116:  Hold'em No Limit ($0.10/$0.25) - 2009/07/01 1:41:56 ET
Table '+UzantPJ4smVdrh+4GTu1w' 6-max Seat #5 is the button
Seat 1: TSmua8tGK3sTbwi0ynrW9Q ($27.70 in chips) 
Seat 3: SS/yfeArhULzIcOPe8MdPg ($34.55 in chips) 
Seat 4: UmcUp27+PbgBItv3ZNlAWQ ($25.50 in chips) 
Seat 5: cj4VBQya7HtVL2zCGd5jLQ ($55.20 in chips) 
Seat 6: fZQg9veL7Dd/Z04ZTjC+wQ ($25 in chips) 
fZQg9veL7Dd/Z04ZTjC+wQ: posts small blind $0.10
TSmua8tGK3sTbwi0ynrW9Q: posts big blind $0.25
tcbEu7VzyHQ+0lh+skbQhQ: sits out 
*** HOLE CARDS ***
SS/yfeArhULzIcOPe8MdPg: folds 
UmcUp27+PbgBItv3ZNlAWQ: folds 
cj4VBQya7HtVL2zCGd5jLQ: folds 
fZQg9veL7Dd/Z04ZTjC+wQ: calls $0.15
TSmua8tGK3sTbwi0ynrW9Q: raises $0.75 to $1
fZQg9veL7Dd/Z04ZTjC+wQ: folds 
Uncalled bet ($0.75) returned to TSmua8tGK3sTbwi0ynrW9Q
TSmua8tGK3sTbwi0ynrW9Q collected $0.50 from pot
*** SUMMARY ***
Total pot $0.50 | Rake $0 
Seat 1: TSmua8tGK3sTbwi0ynrW9Q (big blind) collected ($0.50)
Seat 3: SS/yfeArhULzIcOPe8MdPg folded before Flop (didn't bet)
Seat 4: UmcUp27+PbgBItv3ZNlAWQ folded before Flop (didn't bet)
Seat 5: cj4VBQya7HtVL2zCGd5jLQ (button) folded before Flop (didn't bet)
Seat 6: fZQg9veL7Dd/Z04ZTjC+wQ (small blind) folded before Flop




PokerStars Game #59941652806:  Hold'em No Limit ($0.10/$0.25) - 2009/07/01 1:41:56 ET
Table 'KYX9dFNuOA9l2PV46IebqQ' 9-max Seat #5 is the button
Seat 2: z2SmIaQ3+5n/eY1BN5HgPg ($5.95 in chips) 
Seat 5: g7MXhRmNZxv1lIkKkUKa4w ($15.10 in chips) 
g7MXhRmNZxv1lIkKkUKa4w: posts small blind $0.10
z2SmIaQ3+5n/eY1BN5HgPg: posts big blind $0.25
*** HOLE CARDS ***
g7MXhRmNZxv1lIkKkUKa4w: raises $0.25 to $0.50
z2SmIaQ3+5n/eY1BN5HgPg: calls $0.25
*** FLOP *** [2d As Ac]
z2SmIaQ3+5n/eY1BN5HgPg: checks 
g7MXhRmNZxv1lIkKkUKa4w: bets $0.25
KRWTiGM4xH+MkvPtJz4+SA joins the table at seat #8 
z2SmIaQ3+5n/eY1BN5HgPg: raises $1 to $1.25
rPXwQUVloUl+qZm3CCtaJw joins the table at seat #4 
g7MXhRmNZxv1lIkKkUKa4w: folds 
Uncalled bet ($1) returned to z2SmIaQ3+5n/eY1BN5HgPg
z2SmIaQ3+5n/eY1BN5HgPg collected $1.45 from pot
*** SUMMARY ***
Total pot $1.50 | Rake $0.05 
Board [2d As Ac]
Seat 2: z2SmIaQ3+5n/eY1BN5HgPg (big blind) collected ($1.45)
Seat 5: g7MXhRmNZxv1lIkKkUKa4w (button) (small blind) folded on the Flop




PokerStars Game #59941652734:  Hold'em No Limit ($0.10/$0.25) - 2009/07/01 1:41:56 ET
Table 'ouLhepGYovxB2x0QxH7cVg' 9-max Seat #1 is the button
Seat 1: ghNKXUBl/H+t83JF079ZBA ($25 in chips) 
Seat 2: r1Z5m4PwSI5ANp7qCE1OJw ($18.75 in chips) 
Seat 3: bXpVeaSTPBFSPJmeXxO7nw ($5.60 in chips) 
Seat 4: a0Sx6GHY7ln2Ns2C97eXeA ($38.30 in chips) 
Seat 5: LxRIJ6NkqjCD5zmzlF+y4w ($14.45 in chips) 
Seat 6: lSeLm4BdnSMLtIli62qjAQ ($7.50 in chips) 
Seat 7: JRV2PblFtPFz51l0Fwyz8g ($23.65 in chips) 
Seat 8: tLcDklc2rBORNfixyRfVfw ($25 in chips) 
Seat 9: ljemhp25Zg+nlA9DLCIiUw ($25.35 in chips) 
r1Z5m4PwSI5ANp7qCE1OJw: posts small blind $0.10
bXpVeaSTPBFSPJmeXxO7nw: posts big blind $0.25
*** HOLE CARDS ***
a0Sx6GHY7ln2Ns2C97eXeA: calls $0.25
LxRIJ6NkqjCD5zmzlF+y4w: folds 
lSeLm4BdnSMLtIli62qjAQ: folds 
JRV2PblFtPFz51l0Fwyz8g: calls $0.25
LxRIJ6NkqjCD5zmzlF+y4w leaves the table
tLcDklc2rBORNfixyRfVfw: folds 
ljemhp25Zg+nlA9DLCIiUw: folds 
ghNKXUBl/H+t83JF079ZBA: folds 
v60REj6f8jzMYT0VsZvaPQ joins the table at seat #5 
r1Z5m4PwSI5ANp7qCE1OJw: calls $0.15
bXpVeaSTPBFSPJmeXxO7nw: checks 
*** FLOP *** [Qd 3h Ad]
r1Z5m4PwSI5ANp7qCE1OJw: checks 
bXpVeaSTPBFSPJmeXxO7nw: checks 
a0Sx6GHY7ln2Ns2C97eXeA: bets $0.50
JRV2PblFtPFz51l0Fwyz8g: raises $1.50 to $2
r1Z5m4PwSI5ANp7qCE1OJw: folds 
bXpVeaSTPBFSPJmeXxO7nw: folds 
a0Sx6GHY7ln2Ns2C97eXeA: folds 
Uncalled bet ($1.50) returned to JRV2PblFtPFz51l0Fwyz8g
JRV2PblFtPFz51l0Fwyz8g collected $1.95 from pot
*** SUMMARY ***
Total pot $2 | Rake $0.05 
Board [Qd 3h Ad]
Seat 1: ghNKXUBl/H+t83JF079ZBA (button) folded before Flop (didn't bet)
Seat 2: r1Z5m4PwSI5ANp7qCE1OJw (small blind) folded on the Flop
Seat 3: bXpVeaSTPBFSPJmeXxO7nw (big blind) folded on the Flop
Seat 4: a0Sx6GHY7ln2Ns2C97eXeA folded on the Flop
Seat 5: LxRIJ6NkqjCD5zmzlF+y4w folded before Flop (didn't bet)
Seat 6: lSeLm4BdnSMLtIli62qjAQ folded before Flop (didn't bet)
Seat 7: JRV2PblFtPFz51l0Fwyz8g collected ($1.95)
Seat 8: tLcDklc2rBORNfixyRfVfw folded before Flop (didn't bet)
Seat 9: ljemhp25Zg+nlA9DLCIiUw folded before Flop (didn't bet)




PokerStars Game #59941653680:  Hold'em No Limit ($0.10/$0.25) - 2009/07/01 1:41:57 ET
Table 'ThBZ355rqvsb8UGb6ajbig' 9-max Seat #7 is the button
Seat 1: cZ99hugmLBj9KhTlc8nCSw ($38.15 in chips) 
Seat 2: 4awUyiDYTgylQKXZ9faBVA ($25.95 in chips) 
Seat 3: H5Se03ZqSX7tbULXur2MAg ($29.40 in chips) 
Seat 4: zgi+EUykT/pZQpoUG6+oEg ($4.65 in chips) 
Seat 5: cKlmpQMahVsmOaxFQDcoOg ($24.60 in chips) 
Seat 6: qwr38jl5txoR36M7G5qi4A ($9.65 in chips) 
Seat 7: zUXhymECc2C9W9ZNw6qppA ($16.85 in chips) 
Seat 8: PdIasPkzm2sqZnN41ZRXOg ($5 in chips) 
Seat 9: sD+TKtt36XiiN6jqHiLwDA ($23.85 in chips) 
PdIasPkzm2sqZnN41ZRXOg: posts small blind $0.10
sD+TKtt36XiiN6jqHiLwDA: posts big blind $0.25
*** HOLE CARDS ***
cZ99hugmLBj9KhTlc8nCSw: folds 
cZ99hugmLBj9KhTlc8nCSw leaves the table
4awUyiDYTgylQKXZ9faBVA: folds 
Z9W7+g1WMhhZDi7DwGbCFA joins the table at seat #1 
H5Se03ZqSX7tbULXur2MAg: folds 
zgi+EUykT/pZQpoUG6+oEg: folds 
cKlmpQMahVsmOaxFQDcoOg: folds 
qwr38jl5txoR36M7G5qi4A: folds 
zUXhymECc2C9W9ZNw6qppA: folds 
PdIasPkzm2sqZnN41ZRXOg: folds 
Uncalled bet ($0.15) returned to sD+TKtt36XiiN6jqHiLwDA
sD+TKtt36XiiN6jqHiLwDA collected $0.20 from pot
sD+TKtt36XiiN6jqHiLwDA: doesn't show hand 
*** SUMMARY ***
Total pot $0.20 | Rake $0 
Seat 1: cZ99hugmLBj9KhTlc8nCSw folded before Flop (didn't bet)
Seat 2: 4awUyiDYTgylQKXZ9faBVA folded before Flop (didn't bet)
Seat 3: H5Se03ZqSX7tbULXur2MAg folded before Flop (didn't bet)
Seat 4: zgi+EUykT/pZQpoUG6+oEg folded before Flop (didn't bet)
Seat 5: cKlmpQMahVsmOaxFQDcoOg folded before Flop (didn't bet)
Seat 6: qwr38jl5txoR36M7G5qi4A folded before Flop (didn't bet)
Seat 7: zUXhymECc2C9W9ZNw6qppA (button) folded before Flop (didn't bet)
Seat 8: PdIasPkzm2sqZnN41ZRXOg (small blind) folded before Flop
Seat 9: sD+TKtt36XiiN6jqHiLwDA (big blind) collected ($0.20)




PokerStars Game #59941653240:  Hold'em No Limit ($0.10/$0.25) - 2009/07/01 1:41:57 ET
Table 'L5GvbdQO5aCZJSE6pyQ8OA' 6-max Seat #5 is the button
Seat 1: eFj4lr1nuXLyCWNTShr1bg ($11.10 in chips) 
Seat 2: DihMHaz4WNETH1bPDe13kA ($29.05 in chips) 
Seat 3: JFIAqU8lCZ0vWwEl4bdGsg ($28.30 in chips) 
Seat 5: LyDHtw3/yniNHW+DvLXbog ($25.95 in chips) 
Seat 6: v+QfkGiuj9bgtuNoVnDO8w ($39.50 in chips) 
v+QfkGiuj9bgtuNoVnDO8w: posts small blind $0.10
eFj4lr1nuXLyCWNTShr1bg: posts big blind $0.25
*** HOLE CARDS ***
DihMHaz4WNETH1bPDe13kA: folds 
JFIAqU8lCZ0vWwEl4bdGsg: folds 
LyDHtw3/yniNHW+DvLXbog: raises $0.75 to $1
v+QfkGiuj9bgtuNoVnDO8w: folds 
eFj4lr1nuXLyCWNTShr1bg: folds 
Uncalled bet ($0.75) returned to LyDHtw3/yniNHW+DvLXbog
LyDHtw3/yniNHW+DvLXbog collected $0.60 from pot
LyDHtw3/yniNHW+DvLXbog: doesn't show hand 
*** SUMMARY ***
Total pot $0.60 | Rake $0 
Seat 1: eFj4lr1nuXLyCWNTShr1bg (big blind) folded before Flop
Seat 2: DihMHaz4WNETH1bPDe13kA folded before Flop (didn't bet)
Seat 3: JFIAqU8lCZ0vWwEl4bdGsg folded before Flop (didn't bet)
Seat 5: LyDHtw3/yniNHW+DvLXbog (button) collected ($0.60)
Seat 6: v+QfkGiuj9bgtuNoVnDO8w (small blind) folded before Flop




PokerStars Game #59941653262:  Hold'em No Limit ($0.10/$0.25) - 2009/07/01 1:41:57 ET
Table '0M5QEJGOThqZwQ/sjbjXYw' 6-max Seat #6 is the button
Seat 2: /gJNBeCkWL4o85/jvlZ4BA ($36.70 in chips) 
Seat 3: 3zD3qLXT1bEffAoWGnc7wg ($25 in chips) 
Seat 4: oBUDUfeUyCbZBsjxHZgSiw ($17.50 in chips) 
Seat 5: cWc85bEzdRzpUMhRKm8pwQ ($28.05 in chips) 
Seat 6: mYz11CHiw5KsDCRD5T7/jg ($48.45 in chips) 
2G0C7dp4wlPpE21FHjjElQ: is sitting out 
/gJNBeCkWL4o85/jvlZ4BA: posts small blind $0.10
3zD3qLXT1bEffAoWGnc7wg: posts big blind $0.25
*** HOLE CARDS ***
oBUDUfeUyCbZBsjxHZgSiw: raises $0.75 to $1
cWc85bEzdRzpUMhRKm8pwQ: folds 
mYz11CHiw5KsDCRD5T7/jg: calls $1
/gJNBeCkWL4o85/jvlZ4BA: folds 
3zD3qLXT1bEffAoWGnc7wg: calls $0.75
*** FLOP *** [3h 9h 3d]
3zD3qLXT1bEffAoWGnc7wg: checks 
oBUDUfeUyCbZBsjxHZgSiw: bets $2
mYz11CHiw5KsDCRD5T7/jg: folds 
3zD3qLXT1bEffAoWGnc7wg: folds 
Uncalled bet ($2) returned to oBUDUfeUyCbZBsjxHZgSiw
oBUDUfeUyCbZBsjxHZgSiw collected $2.95 from pot
*** SUMMARY ***
Total pot $3.10 | Rake $0.15 
Board [3h 9h 3d]
Seat 2: /gJNBeCkWL4o85/jvlZ4BA (small blind) folded before Flop
Seat 3: 3zD3qLXT1bEffAoWGnc7wg (big blind) folded on the Flop
Seat 4: oBUDUfeUyCbZBsjxHZgSiw collected ($2.95)
Seat 5: cWc85bEzdRzpUMhRKm8pwQ folded before Flop (didn't bet)
Seat 6: mYz11CHiw5KsDCRD5T7/jg (button) folded on the Flop




PokerStars Game #59941653600:  Hold'em No Limit ($0.10/$0.25) - 2009/07/01 1:41:57 ET
Table 'b64Z+5XI1xkQzNfq4QHr3A' 6-max Seat #4 is the button
Seat 1: qccGLncfUaN00Few5HsgYg ($71.20 in chips) 
Seat 2: SS/yfeArhULzIcOPe8MdPg ($25 in chips) 
Seat 3: u/yN5P9f3KlATg6WLWNkBQ ($31.90 in chips) 
Seat 4: SxIIgwXYLkwd6m3wLyPTCw ($19.15 in chips) 
Seat 5: JFIAqU8lCZ0vWwEl4bdGsg ($58.70 in chips) 
Seat 6: 8ClCHtFXGNplITm+63KB+Q ($35.50 in chips) 
JFIAqU8lCZ0vWwEl4bdGsg: posts small blind $0.10
8ClCHtFXGNplITm+63KB+Q: posts big blind $0.25
*** HOLE CARDS ***
qccGLncfUaN00Few5HsgYg: folds 
SS/yfeArhULzIcOPe8MdPg: folds 
qccGLncfUaN00Few5HsgYg is sitting out
u/yN5P9f3KlATg6WLWNkBQ: folds 
SS/yfeArhULzIcOPe8MdPg said, "you're too good"
SxIIgwXYLkwd6m3wLyPTCw: folds 
JFIAqU8lCZ0vWwEl4bdGsg: folds 
Uncalled bet ($0.15) returned to 8ClCHtFXGNplITm+63KB+Q
8ClCHtFXGNplITm+63KB+Q collected $0.20 from pot
8ClCHtFXGNplITm+63KB+Q: doesn't show hand 
*** SUMMARY ***
Total pot $0.20 | Rake $0 
Seat 1: qccGLncfUaN00Few5HsgYg folded before Flop (didn't bet)
Seat 2: SS/yfeArhULzIcOPe8MdPg folded before Flop (didn't bet)
Seat 3: u/yN5P9f3KlATg6WLWNkBQ folded before Flop (didn't bet)
Seat 4: SxIIgwXYLkwd6m3wLyPTCw (button) folded before Flop (didn't bet)
Seat 5: JFIAqU8lCZ0vWwEl4bdGsg (small blind) folded before Flop
Seat 6: 8ClCHtFXGNplITm+63KB+Q (big blind) collected ($0.20)




PokerStars Game #59941653468:  Hold'em No Limit ($0.10/$0.25) - 2009/07/01 1:41:57 ET
Table 'dZNBGqFYSwfOVZvDJ4VjIQ' 6-max Seat #1 is the button
Seat 1: v+QfkGiuj9bgtuNoVnDO8w ($32.85 in chips) 
Seat 2: 3zD3qLXT1bEffAoWGnc7wg ($25 in chips) 
Seat 3: kyRaCIljYA6l33lSKQfNsg ($28.65 in chips) 
Seat 4: mFv3iBCtrw9XfCDRB0d46Q ($6.15 in chips) 
Seat 5: +ZlnqPoP3Hg4BIUxDfKd/A ($36.50 in chips) 
Seat 6: ypmjhffk/YHGc51wgVXUTw ($30.75 in chips) 
3zD3qLXT1bEffAoWGnc7wg: posts small blind $0.10
kyRaCIljYA6l33lSKQfNsg: posts big blind $0.25
*** HOLE CARDS ***
mFv3iBCtrw9XfCDRB0d46Q: folds 
+ZlnqPoP3Hg4BIUxDfKd/A: folds 
ypmjhffk/YHGc51wgVXUTw: folds 
v+QfkGiuj9bgtuNoVnDO8w: raises $0.75 to $1
3zD3qLXT1bEffAoWGnc7wg: folds 
kyRaCIljYA6l33lSKQfNsg: folds 
Uncalled bet ($0.75) returned to v+QfkGiuj9bgtuNoVnDO8w
v+QfkGiuj9bgtuNoVnDO8w collected $0.60 from pot
v+QfkGiuj9bgtuNoVnDO8w: doesn't show hand 
*** SUMMARY ***
Total pot $0.60 | Rake $0 
Seat 1: v+QfkGiuj9bgtuNoVnDO8w (button) collected ($0.60)
Seat 2: 3zD3qLXT1bEffAoWGnc7wg (small blind) folded before Flop
Seat 3: kyRaCIljYA6l33lSKQfNsg (big blind) folded before Flop
Seat 4: mFv3iBCtrw9XfCDRB0d46Q folded before Flop (didn't bet)
Seat 5: +ZlnqPoP3Hg4BIUxDfKd/A folded before Flop (didn't bet)
Seat 6: ypmjhffk/YHGc51wgVXUTw folded before Flop (didn't bet)




PokerStars Game #59941653556:  Hold'em No Limit ($0.10/$0.25) - 2009/07/01 1:41:57 ET
Table 'oJpFwZj9+FUGHX90Un8s9Q' 6-max Seat #5 is the button
Seat 1: 6DwBRH+xZ12AAZmeAg+aXw ($22.95 in chips) 
Seat 2: NtrVQ9UIql0rDCnKDKZ5FQ ($8.30 in chips) 
Seat 3: kyRaCIljYA6l33lSKQfNsg ($24.65 in chips) 
Seat 4: 6elpmfyt4Zw0yvd8lePSMQ ($23.10 in chips) 
Seat 5: kG34n23qFQA3nzdOJTQ1dA ($56.10 in chips) 
Seat 6: edio/rLJ06xeZOfLhoL3UA ($8.75 in chips) 
edio/rLJ06xeZOfLhoL3UA: posts small blind $0.10
6DwBRH+xZ12AAZmeAg+aXw: posts big blind $0.25
*** HOLE CARDS ***
NtrVQ9UIql0rDCnKDKZ5FQ: calls $0.25
kyRaCIljYA6l33lSKQfNsg: folds 
6elpmfyt4Zw0yvd8lePSMQ: folds 
kG34n23qFQA3nzdOJTQ1dA: folds 
edio/rLJ06xeZOfLhoL3UA: raises $1 to $1.25
6DwBRH+xZ12AAZmeAg+aXw: folds 
NtrVQ9UIql0rDCnKDKZ5FQ: calls $1
*** FLOP *** [3h 5h Ts]
edio/rLJ06xeZOfLhoL3UA: checks 
NtrVQ9UIql0rDCnKDKZ5FQ: bets $1.25
edio/rLJ06xeZOfLhoL3UA: calls $1.25
*** TURN *** [3h 5h Ts] [Kd]
edio/rLJ06xeZOfLhoL3UA: checks 
NtrVQ9UIql0rDCnKDKZ5FQ: bets $2.75
edio/rLJ06xeZOfLhoL3UA: calls $2.75
*** RIVER *** [3h 5h Ts Kd] [Qd]
edio/rLJ06xeZOfLhoL3UA: bets $3.50 and is all-in
NtrVQ9UIql0rDCnKDKZ5FQ: calls $3.05 and is all-in
Uncalled bet ($0.45) returned to edio/rLJ06xeZOfLhoL3UA
*** SHOW DOWN ***
edio/rLJ06xeZOfLhoL3UA: shows [Ah 2h] (high card Ace)
NtrVQ9UIql0rDCnKDKZ5FQ: shows [Th Kh] (two pair, Kings and Tens)
NtrVQ9UIql0rDCnKDKZ5FQ collected $16.05 from pot
*** SUMMARY ***
Total pot $16.85 | Rake $0.80 
Board [3h 5h Ts Kd Qd]
Seat 1: 6DwBRH+xZ12AAZmeAg+aXw (big blind) folded before Flop
Seat 2: NtrVQ9UIql0rDCnKDKZ5FQ showed [Th Kh] and won ($16.05) with two pair, Kings and Tens
Seat 3: kyRaCIljYA6l33lSKQfNsg folded before Flop (didn't bet)
Seat 4: 6elpmfyt4Zw0yvd8lePSMQ folded before Flop (didn't bet)
Seat 5: kG34n23qFQA3nzdOJTQ1dA (button) folded before Flop (didn't bet)
Seat 6: edio/rLJ06xeZOfLhoL3UA (small blind) showed [Ah 2h] and lost with high card Ace




PokerStars Game #59941653336:  Hold'em No Limit ($0.10/$0.25) - 2009/07/01 1:41:57 ET
Table 'Mef6A0EMopL6WaFO5/KO9g' 6-max Seat #5 is the button
Seat 1: GbCVUNssQ7mqsPWr7J4d3w ($4.65 in chips) 
Seat 2: 8ClCHtFXGNplITm+63KB+Q ($32.65 in chips) 
Seat 3: Wq26opBLDGJe91GRJn2epg ($12.65 in chips) 
Seat 4: lquriepNQBhDV5P1SWHhnA ($25 in chips) 
Seat 5: DihMHaz4WNETH1bPDe13kA ($25 in chips) 
Seat 6: jp34e617tIzV8tKIWmfAbA ($33.40 in chips) 
jp34e617tIzV8tKIWmfAbA: posts small blind $0.10
GbCVUNssQ7mqsPWr7J4d3w: posts big blind $0.25
*** HOLE CARDS ***
8ClCHtFXGNplITm+63KB+Q: raises $0.75 to $1
Wq26opBLDGJe91GRJn2epg: calls $1
lquriepNQBhDV5P1SWHhnA: calls $1
DihMHaz4WNETH1bPDe13kA: folds 
jp34e617tIzV8tKIWmfAbA: folds 
GbCVUNssQ7mqsPWr7J4d3w: folds 
*** FLOP *** [8d 3d Kd]
8ClCHtFXGNplITm+63KB+Q: checks 
Wq26opBLDGJe91GRJn2epg: checks 
lquriepNQBhDV5P1SWHhnA: checks 
*** TURN *** [8d 3d Kd] [Ts]
8ClCHtFXGNplITm+63KB+Q: checks 
Wq26opBLDGJe91GRJn2epg: bets $0.75
lquriepNQBhDV5P1SWHhnA: folds 
8ClCHtFXGNplITm+63KB+Q: calls $0.75
*** RIVER *** [8d 3d Kd Ts] [9d]
8ClCHtFXGNplITm+63KB+Q: checks 
Wq26opBLDGJe91GRJn2epg: bets $1.50
8ClCHtFXGNplITm+63KB+Q: folds 
Uncalled bet ($1.50) returned to Wq26opBLDGJe91GRJn2epg
Wq26opBLDGJe91GRJn2epg collected $4.65 from pot
Wq26opBLDGJe91GRJn2epg: doesn't show hand 
*** SUMMARY ***
Total pot $4.85 | Rake $0.20 
Board [8d 3d Kd Ts 9d]
Seat 1: GbCVUNssQ7mqsPWr7J4d3w (big blind) folded before Flop
Seat 2: 8ClCHtFXGNplITm+63KB+Q folded on the River
Seat 3: Wq26opBLDGJe91GRJn2epg collected ($4.65)
Seat 4: lquriepNQBhDV5P1SWHhnA folded on the Turn
Seat 5: DihMHaz4WNETH1bPDe13kA (button) folded before Flop (didn't bet)
Seat 6: jp34e617tIzV8tKIWmfAbA (small blind) folded before Flop




PokerStars Game #59941653976:  Hold'em No Limit ($0.10/$0.25) - 2009/07/01 1:41:58 ET
Table '2clPgY3+dETPD/8zjXZdFw' 6-max Seat #3 is the button
Seat 1: 4WFKzsjLSGnvHbVxKabsvQ ($29.45 in chips) 
Seat 2: cWc85bEzdRzpUMhRKm8pwQ ($25.35 in chips) 
Seat 3: SFmT9ZsVopnukjvAzrxTRg ($25 in chips) 
Seat 4: ljjhtb6FVPTx9AT9HNdtqg ($18.40 in chips) 
Seat 5: LJI7A1YgDM7hgh7o56+ReQ ($25 in chips) 
Seat 6: 2G0C7dp4wlPpE21FHjjElQ ($27.25 in chips) 
ljjhtb6FVPTx9AT9HNdtqg: posts small blind $0.10
LJI7A1YgDM7hgh7o56+ReQ: posts big blind $0.25
*** HOLE CARDS ***
2G0C7dp4wlPpE21FHjjElQ: folds 
4WFKzsjLSGnvHbVxKabsvQ: folds 
cWc85bEzdRzpUMhRKm8pwQ: raises $0.75 to $1
SFmT9ZsVopnukjvAzrxTRg: folds 
ljjhtb6FVPTx9AT9HNdtqg: folds 
LJI7A1YgDM7hgh7o56+ReQ: folds 
Uncalled bet ($0.75) returned to cWc85bEzdRzpUMhRKm8pwQ
cWc85bEzdRzpUMhRKm8pwQ collected $0.60 from pot
*** SUMMARY ***
Total pot $0.60 | Rake $0 
Seat 1: 4WFKzsjLSGnvHbVxKabsvQ folded before Flop (didn't bet)
Seat 2: cWc85bEzdRzpUMhRKm8pwQ collected ($0.60)
Seat 3: SFmT9ZsVopnukjvAzrxTRg (button) folded before Flop (didn't bet)
Seat 4: ljjhtb6FVPTx9AT9HNdtqg (small blind) folded before Flop
Seat 5: LJI7A1YgDM7hgh7o56+ReQ (big blind) folded before Flop
Seat 6: 2G0C7dp4wlPpE21FHjjElQ folded before Flop (didn't bet)




PokerStars Game #59941654006:  Hold'em No Limit ($0.10/$0.25) - 2009/07/01 1:41:58 ET
Table 'Zi9/NqNs3XoL1eWhMCyZyg' 9-max Seat #9 is the button
Seat 3: ETC7YyRJTa2Ovhln64Ni5Q ($24.75 in chips) 
Seat 4: dmYlc+1cjwZMJ7wV+Z0rRg ($23.15 in chips) 
Seat 5: OiV1PWZ3IkN29JlmCcnTwQ ($4.90 in chips) 
Seat 7: 0QdZrkFD7aGKeBXPGbIomA ($6.60 in chips) 
Seat 8: nm4Dj/f+jJEwKVsUnKh73g ($37.80 in chips) 
Seat 9: tYsOBqdU1+x+yFI7zHO7hQ ($31.65 in chips) 
ETC7YyRJTa2Ovhln64Ni5Q: posts small blind $0.10
dmYlc+1cjwZMJ7wV+Z0rRg: posts big blind $0.25
*** HOLE CARDS ***
OiV1PWZ3IkN29JlmCcnTwQ: folds 
OiV1PWZ3IkN29JlmCcnTwQ leaves the table
0QdZrkFD7aGKeBXPGbIomA: calls $0.25
nm4Dj/f+jJEwKVsUnKh73g: calls $0.25
tYsOBqdU1+x+yFI7zHO7hQ: folds 
ETC7YyRJTa2Ovhln64Ni5Q: calls $0.15
dmYlc+1cjwZMJ7wV+Z0rRg: checks 
*** FLOP *** [6h 5c Kd]
ETC7YyRJTa2Ovhln64Ni5Q: bets $0.25
JTINtdu/1/EQCVfalLD/xQ joins the table at seat #5 
dmYlc+1cjwZMJ7wV+Z0rRg: folds 
0QdZrkFD7aGKeBXPGbIomA: folds 
nm4Dj/f+jJEwKVsUnKh73g: raises $0.25 to $0.50
ETC7YyRJTa2Ovhln64Ni5Q: raises $0.25 to $0.75
nm4Dj/f+jJEwKVsUnKh73g: calls $0.25
*** TURN *** [6h 5c Kd] [3d]
ETC7YyRJTa2Ovhln64Ni5Q: bets $0.50
nm4Dj/f+jJEwKVsUnKh73g: calls $0.50
*** RIVER *** [6h 5c Kd 3d] [6d]
ETC7YyRJTa2Ovhln64Ni5Q: bets $1.25
nm4Dj/f+jJEwKVsUnKh73g: calls $1.25
*** SHOW DOWN ***
ETC7YyRJTa2Ovhln64Ni5Q: shows [6c Kc] (a full house, Sixes full of Kings)
nm4Dj/f+jJEwKVsUnKh73g: mucks hand 
ETC7YyRJTa2Ovhln64Ni5Q collected $5.75 from pot
*** SUMMARY ***
Total pot $6 | Rake $0.25 
Board [6h 5c Kd 3d 6d]
Seat 3: ETC7YyRJTa2Ovhln64Ni5Q (small blind) showed [6c Kc] and won ($5.75) with a full house, Sixes full of Kings
Seat 4: dmYlc+1cjwZMJ7wV+Z0rRg (big blind) folded on the Flop
Seat 5: OiV1PWZ3IkN29JlmCcnTwQ folded before Flop (didn't bet)
Seat 7: 0QdZrkFD7aGKeBXPGbIomA folded on the Flop
Seat 8: nm4Dj/f+jJEwKVsUnKh73g mucked
Seat 9: tYsOBqdU1+x+yFI7zHO7hQ (button) folded before Flop (didn't bet)




PokerStars Game #59941654124:  Hold'em No Limit ($0.10/$0.25) - 2009/07/01 1:41:58 ET
Table 'QegsWX65l3n/K0A8XB78yg' 6-max Seat #3 is the button
Seat 1: p6adJRMXMBLr+xtQzqazIQ ($12.35 in chips) 
Seat 2: GC/9yVD59DUCX7hUI7gcLw ($48.85 in chips) 
Seat 3: 1lxYIAoJdZwAbzIkzWmSkw ($1.40 in chips) 
Seat 5: OMGl+YMGogf2JWIRfT2/Yg ($11.90 in chips) 
Seat 6: 5PWs02z65jSO5pr/M6wx/w ($4.85 in chips) 
mFv3iBCtrw9XfCDRB0d46Q will be allowed to play after the button
OMGl+YMGogf2JWIRfT2/Yg: posts small blind $0.10
mFv3iBCtrw9XfCDRB0d46Q leaves the table
5PWs02z65jSO5pr/M6wx/w: posts big blind $0.25
*** HOLE CARDS ***
p6adJRMXMBLr+xtQzqazIQ: folds 
epAUIB7h2FJXzUPRIvSkRA joins the table at seat #4 
GC/9yVD59DUCX7hUI7gcLw: raises $0.75 to $1
1lxYIAoJdZwAbzIkzWmSkw: folds 
OMGl+YMGogf2JWIRfT2/Yg: calls $0.90
5PWs02z65jSO5pr/M6wx/w: folds 
*** FLOP *** [Ah Qd 5c]
OMGl+YMGogf2JWIRfT2/Yg: checks 
GC/9yVD59DUCX7hUI7gcLw: checks 
*** TURN *** [Ah Qd 5c] [Jh]
OMGl+YMGogf2JWIRfT2/Yg: bets $0.50
GC/9yVD59DUCX7hUI7gcLw: calls $0.50
*** RIVER *** [Ah Qd 5c Jh] [9d]
OMGl+YMGogf2JWIRfT2/Yg: bets $0.50
GC/9yVD59DUCX7hUI7gcLw: calls $0.50
*** SHOW DOWN ***
OMGl+YMGogf2JWIRfT2/Yg: shows [Th Ts] (a pair of Tens)
GC/9yVD59DUCX7hUI7gcLw: shows [Ad 4d] (a pair of Aces)
GC/9yVD59DUCX7hUI7gcLw collected $4.05 from pot
*** SUMMARY ***
Total pot $4.25 | Rake $0.20 
Board [Ah Qd 5c Jh 9d]
Seat 1: p6adJRMXMBLr+xtQzqazIQ folded before Flop (didn't bet)
Seat 2: GC/9yVD59DUCX7hUI7gcLw showed [Ad 4d] and won ($4.05) with a pair of Aces
Seat 3: 1lxYIAoJdZwAbzIkzWmSkw (button) folded before Flop (didn't bet)
Seat 5: OMGl+YMGogf2JWIRfT2/Yg (small blind) showed [Th Ts] and lost with a pair of Tens
Seat 6: 5PWs02z65jSO5pr/M6wx/w (big blind) folded before Flop




PokerStars Game #59941653824:  Hold'em No Limit ($0.10/$0.25) - 2009/07/01 1:41:58 ET
Table 'HbNAGS1OJWQKyfk7UfrYyw' 9-max Seat #7 is the button
Seat 2: fjwM06E3HzjUrynPRQi31Q ($4.75 in chips) 
Seat 7: n+stbTneifqFNME+tpoGrw ($25.25 in chips) 
n+stbTneifqFNME+tpoGrw: posts small blind $0.10
z2SmIaQ3+5n/eY1BN5HgPg joins the table at seat #5 
fjwM06E3HzjUrynPRQi31Q: posts big blind $0.25
*** HOLE CARDS ***
n+stbTneifqFNME+tpoGrw: raises $0.75 to $1
fjwM06E3HzjUrynPRQi31Q: folds 
Uncalled bet ($0.75) returned to n+stbTneifqFNME+tpoGrw
jntAuOS+eFQDYNiDN8dzag joins the table at seat #6 
n+stbTneifqFNME+tpoGrw collected $0.50 from pot
n+stbTneifqFNME+tpoGrw: shows [7h 4d] (high card Seven)
*** SUMMARY ***
Total pot $0.50 | Rake $0 
Seat 2: fjwM06E3HzjUrynPRQi31Q (big blind) folded before Flop
Seat 7: n+stbTneifqFNME+tpoGrw (button) (small blind) collected ($0.50)




PokerStars Game #59941654320:  Hold'em No Limit ($0.10/$0.25) - 2009/07/01 1:41:59 ET
Table 'K/f0NNaoGuhSz5DrzgVw7Q' 9-max Seat #2 is the button
Seat 1: sD+TKtt36XiiN6jqHiLwDA ($25.05 in chips) 
Seat 2: N7idMbhmEVNGZavVF2tgKg ($26.65 in chips) 
Seat 3: z5GxcHlYz/GSz6W2uFiTtg ($24.35 in chips) 
Seat 4: 9bCz0uv2nUmznwuI0OjVGw ($17.60 in chips) 
Seat 5: DnDcAdn9P0zGovMERigpFA ($37.80 in chips) 
Seat 6: 3PVK0IdMlq2fElkVzzr4bg ($2.60 in chips) 
Seat 7: egvg3mTBBVzMHnJPIQiKcA ($14.65 in chips) 
Seat 8: RCqMONFrSPSArZh2Jsar/w ($19.65 in chips) 
Seat 9: tLcDklc2rBORNfixyRfVfw ($25 in chips) 
z5GxcHlYz/GSz6W2uFiTtg: posts small blind $0.10
9bCz0uv2nUmznwuI0OjVGw: posts big blind $0.25
*** HOLE CARDS ***
DnDcAdn9P0zGovMERigpFA: folds 
3PVK0IdMlq2fElkVzzr4bg: raises $2.35 to $2.60 and is all-in
egvg3mTBBVzMHnJPIQiKcA has timed out
egvg3mTBBVzMHnJPIQiKcA: folds 
egvg3mTBBVzMHnJPIQiKcA is sitting out
RCqMONFrSPSArZh2Jsar/w: folds 
tLcDklc2rBORNfixyRfVfw: folds 
sD+TKtt36XiiN6jqHiLwDA: folds 
N7idMbhmEVNGZavVF2tgKg: folds 
z5GxcHlYz/GSz6W2uFiTtg: folds 
9bCz0uv2nUmznwuI0OjVGw: folds 
Uncalled bet ($2.35) returned to 3PVK0IdMlq2fElkVzzr4bg
3PVK0IdMlq2fElkVzzr4bg collected $0.60 from pot
*** SUMMARY ***
Total pot $0.60 | Rake $0 
Seat 1: sD+TKtt36XiiN6jqHiLwDA folded before Flop (didn't bet)
Seat 2: N7idMbhmEVNGZavVF2tgKg (button) folded before Flop (didn't bet)
Seat 3: z5GxcHlYz/GSz6W2uFiTtg (small blind) folded before Flop
Seat 4: 9bCz0uv2nUmznwuI0OjVGw (big blind) folded before Flop
Seat 5: DnDcAdn9P0zGovMERigpFA folded before Flop (didn't bet)
Seat 6: 3PVK0IdMlq2fElkVzzr4bg collected ($0.60)
Seat 7: egvg3mTBBVzMHnJPIQiKcA folded before Flop (didn't bet)
Seat 8: RCqMONFrSPSArZh2Jsar/w folded before Flop (didn't bet)
Seat 9: tLcDklc2rBORNfixyRfVfw folded before Flop (didn't bet)




PokerStars Game #59941654794:  Hold'em No Limit ($0.10/$0.25) - 2009/07/01 1:41:59 ET
Table 'mdub7rJf3Z5tCT9s/+1+Wg' 9-max Seat #5 is the button
Seat 1: cZ99hugmLBj9KhTlc8nCSw ($29.25 in chips) 
Seat 2: 539MC3AwKLWVFwzABc644Q ($9.60 in chips) 
Seat 3: PdIasPkzm2sqZnN41ZRXOg ($5.35 in chips) 
Seat 4: fDGyaQz0cs2s4FOYxkbIHA ($14.85 in chips) 
Seat 5: dfNim92Z6XK1/h5SFW5vDg ($25.25 in chips) 
Seat 6: T/CCwAWe2yhO0c4oHNwicw ($22.55 in chips) 
Seat 7: woe+9KKk+L3pZgMTuHcmog ($16.45 in chips) 
Seat 8: Z9AeOQX3yzuSvKAm/xyovg ($6.75 in chips) 
Seat 9: tYsOBqdU1+x+yFI7zHO7hQ ($36.80 in chips) 
T/CCwAWe2yhO0c4oHNwicw: posts small blind $0.10
woe+9KKk+L3pZgMTuHcmog: posts big blind $0.25
*** HOLE CARDS ***
Z9AeOQX3yzuSvKAm/xyovg: folds 
tYsOBqdU1+x+yFI7zHO7hQ: folds 
cZ99hugmLBj9KhTlc8nCSw: folds 
539MC3AwKLWVFwzABc644Q: folds 
PdIasPkzm2sqZnN41ZRXOg: folds 
fDGyaQz0cs2s4FOYxkbIHA: folds 
dfNim92Z6XK1/h5SFW5vDg: raises $0.75 to $1
T/CCwAWe2yhO0c4oHNwicw: folds 
woe+9KKk+L3pZgMTuHcmog: calls $0.75
*** FLOP *** [4c 6s Qh]
woe+9KKk+L3pZgMTuHcmog: checks 
dfNim92Z6XK1/h5SFW5vDg: bets $1.50
woe+9KKk+L3pZgMTuHcmog: folds 
Uncalled bet ($1.50) returned to dfNim92Z6XK1/h5SFW5vDg
dfNim92Z6XK1/h5SFW5vDg collected $2 from pot
dfNim92Z6XK1/h5SFW5vDg: doesn't show hand 
*** SUMMARY ***
Total pot $2.10 | Rake $0.10 
Board [4c 6s Qh]
Seat 1: cZ99hugmLBj9KhTlc8nCSw folded before Flop (didn't bet)
Seat 2: 539MC3AwKLWVFwzABc644Q folded before Flop (didn't bet)
Seat 3: PdIasPkzm2sqZnN41ZRXOg folded before Flop (didn't bet)
Seat 4: fDGyaQz0cs2s4FOYxkbIHA folded before Flop (didn't bet)
Seat 5: dfNim92Z6XK1/h5SFW5vDg (button) collected ($2)
Seat 6: T/CCwAWe2yhO0c4oHNwicw (small blind) folded before Flop
Seat 7: woe+9KKk+L3pZgMTuHcmog (big blind) folded on the Flop
Seat 8: Z9AeOQX3yzuSvKAm/xyovg folded before Flop (didn't bet)
Seat 9: tYsOBqdU1+x+yFI7zHO7hQ folded before Flop (didn't bet)




PokerStars Game #59941654248:  Hold'em No Limit ($0.10/$0.25) - 2009/07/01 1:41:59 ET
Table 'o0CDOvKO/bn1WjeymDrXfA' 6-max Seat #6 is the button
Seat 1: if4dh6jhJXeN3/qd3qCp9g ($24.75 in chips) 
Seat 2: uAJL+E2git8iAiFyAvVOnw ($18.85 in chips) 
Seat 3: OtVWmpxX2/9L8bb1GSKTuA ($18 in chips) 
Seat 5: dOIoLBxmpLHSXBN9LZnf0Q ($28.45 in chips) 
Seat 6: SS/yfeArhULzIcOPe8MdPg ($25 in chips) 
if4dh6jhJXeN3/qd3qCp9g: posts small blind $0.10
uAJL+E2git8iAiFyAvVOnw: posts big blind $0.25
L3/N/gliETan8N5Gim5h4Q: sits out 
*** HOLE CARDS ***
OtVWmpxX2/9L8bb1GSKTuA: folds 
dOIoLBxmpLHSXBN9LZnf0Q: calls $0.25
SS/yfeArhULzIcOPe8MdPg: folds 
if4dh6jhJXeN3/qd3qCp9g: folds 
uAJL+E2git8iAiFyAvVOnw: checks 
*** FLOP *** [5d 2d Jd]
uAJL+E2git8iAiFyAvVOnw: bets $0.75
dOIoLBxmpLHSXBN9LZnf0Q: calls $0.75
*** TURN *** [5d 2d Jd] [3s]
uAJL+E2git8iAiFyAvVOnw: checks 
dOIoLBxmpLHSXBN9LZnf0Q: checks 
*** RIVER *** [5d 2d Jd 3s] [8d]
uAJL+E2git8iAiFyAvVOnw: checks 
dOIoLBxmpLHSXBN9LZnf0Q: checks 
*** SHOW DOWN ***
uAJL+E2git8iAiFyAvVOnw: shows [Ts 5c] (a pair of Fives)
dOIoLBxmpLHSXBN9LZnf0Q: shows [4d 3d] (a flush, Jack high)
dOIoLBxmpLHSXBN9LZnf0Q collected $2 from pot
*** SUMMARY ***
Total pot $2.10 | Rake $0.10 
Board [5d 2d Jd 3s 8d]
Seat 1: if4dh6jhJXeN3/qd3qCp9g (small blind) folded before Flop
Seat 2: uAJL+E2git8iAiFyAvVOnw (big blind) showed [Ts 5c] and lost with a pair of Fives
Seat 3: OtVWmpxX2/9L8bb1GSKTuA folded before Flop (didn't bet)
Seat 5: dOIoLBxmpLHSXBN9LZnf0Q showed [4d 3d] and won ($2) with a flush, Jack high
Seat 6: SS/yfeArhULzIcOPe8MdPg (button) folded before Flop (didn't bet)




PokerStars Game #59941654376:  Hold'em No Limit ($0.10/$0.25) - 2009/07/01 1:41:59 ET
Table 'FE/j6VqBY4j9Uq+VHURQCQ' 6-max Seat #6 is the button
Seat 1: ypmjhffk/YHGc51wgVXUTw ($41.55 in chips) 
Seat 2: 3zD3qLXT1bEffAoWGnc7wg ($39.75 in chips) 
Seat 3: lBoEwOFgzcERLIRUkUoRTw ($27.70 in chips) 
Seat 4: 7JyPCA0J2grhXQYxe1h3+A ($22.65 in chips) 
Seat 5: 4x9jCqgSw4272dnaIqnanw ($7.20 in chips) 
Seat 6: rpJ2ie+vculq8yrHlngRHQ ($18.60 in chips) 
ypmjhffk/YHGc51wgVXUTw: posts small blind $0.10
3zD3qLXT1bEffAoWGnc7wg: posts big blind $0.25
*** HOLE CARDS ***
lBoEwOFgzcERLIRUkUoRTw: folds 
7JyPCA0J2grhXQYxe1h3+A: folds 
4x9jCqgSw4272dnaIqnanw: folds 
rpJ2ie+vculq8yrHlngRHQ: folds 
ypmjhffk/YHGc51wgVXUTw: folds 
Uncalled bet ($0.15) returned to 3zD3qLXT1bEffAoWGnc7wg
3zD3qLXT1bEffAoWGnc7wg collected $0.20 from pot
3zD3qLXT1bEffAoWGnc7wg: doesn't show hand 
*** SUMMARY ***
Total pot $0.20 | Rake $0 
Seat 1: ypmjhffk/YHGc51wgVXUTw (small blind) folded before Flop
Seat 2: 3zD3qLXT1bEffAoWGnc7wg (big blind) collected ($0.20)
Seat 3: lBoEwOFgzcERLIRUkUoRTw folded before Flop (didn't bet)
Seat 4: 7JyPCA0J2grhXQYxe1h3+A folded before Flop (didn't bet)
Seat 5: 4x9jCqgSw4272dnaIqnanw folded before Flop (didn't bet)
Seat 6: rpJ2ie+vculq8yrHlngRHQ (button) folded before Flop (didn't bet)




PokerStars Game #59941654562:  Hold'em No Limit ($0.10/$0.25) - 2009/07/01 1:41:59 ET
Table 'M8kYidAX3ib7pLKW7edFLw' 6-max Seat #1 is the button
Seat 1: jp34e617tIzV8tKIWmfAbA ($25.35 in chips) 
Seat 2: ypmjhffk/YHGc51wgVXUTw ($28.55 in chips) 
Seat 3: cezpHJ8FB07dj0xG+LhOvw ($27.45 in chips) 
Seat 4: Hsvkc0/G2VV78oVmWYXecw ($5.35 in chips) 
Seat 5: bDKopKTvPi3W+PEnYUX3tg ($44.85 in chips) 
Seat 6: NqFoyDgzLwu4dOmSRXnFBA ($19.65 in chips) 
ypmjhffk/YHGc51wgVXUTw: posts small blind $0.10
cezpHJ8FB07dj0xG+LhOvw: posts big blind $0.25
*** HOLE CARDS ***
Hsvkc0/G2VV78oVmWYXecw: folds 
bDKopKTvPi3W+PEnYUX3tg: folds 
NqFoyDgzLwu4dOmSRXnFBA: raises $0.75 to $1
jp34e617tIzV8tKIWmfAbA: folds 
ypmjhffk/YHGc51wgVXUTw: folds 
cezpHJ8FB07dj0xG+LhOvw: folds 
Uncalled bet ($0.75) returned to NqFoyDgzLwu4dOmSRXnFBA
NqFoyDgzLwu4dOmSRXnFBA collected $0.60 from pot
*** SUMMARY ***
Total pot $0.60 | Rake $0 
Seat 1: jp34e617tIzV8tKIWmfAbA (button) folded before Flop (didn't bet)
Seat 2: ypmjhffk/YHGc51wgVXUTw (small blind) folded before Flop
Seat 3: cezpHJ8FB07dj0xG+LhOvw (big blind) folded before Flop
Seat 4: Hsvkc0/G2VV78oVmWYXecw folded before Flop (didn't bet)
Seat 5: bDKopKTvPi3W+PEnYUX3tg folded before Flop (didn't bet)
Seat 6: NqFoyDgzLwu4dOmSRXnFBA collected ($0.60)




PokerStars Game #59941654546:  Hold'em No Limit ($0.10/$0.25) - 2009/07/01 1:41:59 ET
Table '5NipxzzFB2DffzDpddyQoQ' 6-max Seat #5 is the button
Seat 1: W87HPwOk1KtWaYyshBe1gA ($22.60 in chips) 
Seat 2: iauW7L/+7qzAuHow7CD75Q ($10.10 in chips) 
Seat 3: QvTX2yGq3uKJiKPmns4TKQ ($18.90 in chips) 
Seat 4: NTamLAiMZ86c5yM04t96LA ($12.90 in chips) 
Seat 5: faP2NVl/cFTZ1nE4pXzg8Q ($38.75 in chips) 
Seat 6: 7JqTFMyeNSVWsmp/yW35Tw ($13.20 in chips) 
7JqTFMyeNSVWsmp/yW35Tw: posts small blind $0.10
W87HPwOk1KtWaYyshBe1gA: posts big blind $0.25
*** HOLE CARDS ***
iauW7L/+7qzAuHow7CD75Q: calls $0.25
QvTX2yGq3uKJiKPmns4TKQ: folds 
NTamLAiMZ86c5yM04t96LA: calls $0.25
faP2NVl/cFTZ1nE4pXzg8Q: calls $0.25
7JqTFMyeNSVWsmp/yW35Tw: calls $0.15
W87HPwOk1KtWaYyshBe1gA: checks 
*** FLOP *** [Th 4d 6h]
7JqTFMyeNSVWsmp/yW35Tw: checks 
W87HPwOk1KtWaYyshBe1gA: bets $0.25
iauW7L/+7qzAuHow7CD75Q: folds 
NTamLAiMZ86c5yM04t96LA: raises $0.75 to $1
faP2NVl/cFTZ1nE4pXzg8Q: calls $1
7JqTFMyeNSVWsmp/yW35Tw: folds 
W87HPwOk1KtWaYyshBe1gA: calls $0.75
*** TURN *** [Th 4d 6h] [8d]
W87HPwOk1KtWaYyshBe1gA: checks 
NTamLAiMZ86c5yM04t96LA: bets $1
faP2NVl/cFTZ1nE4pXzg8Q: calls $1
W87HPwOk1KtWaYyshBe1gA: folds 
*** RIVER *** [Th 4d 6h 8d] [Ad]
NTamLAiMZ86c5yM04t96LA: checks 
faP2NVl/cFTZ1nE4pXzg8Q: checks 
*** SHOW DOWN ***
NTamLAiMZ86c5yM04t96LA: shows [Tc Js] (a pair of Tens)
faP2NVl/cFTZ1nE4pXzg8Q: shows [5s 5h] (a pair of Fives)
NTamLAiMZ86c5yM04t96LA collected $5.95 from pot
*** SUMMARY ***
Total pot $6.25 | Rake $0.30 
Board [Th 4d 6h 8d Ad]
Seat 1: W87HPwOk1KtWaYyshBe1gA (big blind) folded on the Turn
Seat 2: iauW7L/+7qzAuHow7CD75Q folded on the Flop
Seat 3: QvTX2yGq3uKJiKPmns4TKQ folded before Flop (didn't bet)
Seat 4: NTamLAiMZ86c5yM04t96LA showed [Tc Js] and won ($5.95) with a pair of Tens
Seat 5: faP2NVl/cFTZ1nE4pXzg8Q (button) showed [5s 5h] and lost with a pair of Fives
Seat 6: 7JqTFMyeNSVWsmp/yW35Tw (small blind) folded on the Flop




PokerStars Game #59941654246:  Hold'em No Limit ($0.10/$0.25) - 2009/07/01 1:41:59 ET
Table 'hfHe8uKeSJMyWAjSdM7ROQ' 6-max Seat #2 is the button
Seat 1: eHsmIvAb2JREg4O6hNPnXg ($25 in chips) 
Seat 2: QvTX2yGq3uKJiKPmns4TKQ ($30.40 in chips) 
Seat 3: oAzQdB2jFOH1NxFUPjYUGg ($27.40 in chips) 
Seat 4: b4wRQV3APH8irVk6bUFe2Q ($25 in chips) 
Seat 5: euswrBD1XG0Q5hB1iGJBKQ ($61.10 in chips) 
Seat 6: MTQON5nWq0PsufZ7u/4rMA ($17.25 in chips) 
oAzQdB2jFOH1NxFUPjYUGg: posts small blind $0.10
b4wRQV3APH8irVk6bUFe2Q: posts big blind $0.25
*** HOLE CARDS ***
euswrBD1XG0Q5hB1iGJBKQ: folds 
MTQON5nWq0PsufZ7u/4rMA: folds 
eHsmIvAb2JREg4O6hNPnXg: folds 
QvTX2yGq3uKJiKPmns4TKQ: folds 
oAzQdB2jFOH1NxFUPjYUGg: raises $0.25 to $0.50
b4wRQV3APH8irVk6bUFe2Q: calls $0.25
*** FLOP *** [2h Th 4s]
oAzQdB2jFOH1NxFUPjYUGg: bets $0.50
b4wRQV3APH8irVk6bUFe2Q: raises $0.50 to $1
oAzQdB2jFOH1NxFUPjYUGg: folds 
Uncalled bet ($0.50) returned to b4wRQV3APH8irVk6bUFe2Q
b4wRQV3APH8irVk6bUFe2Q collected $1.95 from pot
*** SUMMARY ***
Total pot $2 | Rake $0.05 
Board [2h Th 4s]
Seat 1: eHsmIvAb2JREg4O6hNPnXg folded before Flop (didn't bet)
Seat 2: QvTX2yGq3uKJiKPmns4TKQ (button) folded before Flop (didn't bet)
Seat 3: oAzQdB2jFOH1NxFUPjYUGg (small blind) folded on the Flop
Seat 4: b4wRQV3APH8irVk6bUFe2Q (big blind) collected ($1.95)
Seat 5: euswrBD1XG0Q5hB1iGJBKQ folded before Flop (didn't bet)
Seat 6: MTQON5nWq0PsufZ7u/4rMA folded before Flop (didn't bet)




PokerStars Game #59941654282:  Hold'em No Limit ($0.10/$0.25) - 2009/07/01 1:41:59 ET
Table 'Pz8SfAzhP5nvWTsJRAxoDg' 6-max Seat #4 is the button
Seat 1: QiL+lEgEWwy21jk/ltaRLg ($25.95 in chips) 
Seat 2: xrf8tAXKQHG99HixCot1Iw ($25.15 in chips) 
Seat 3: mfrkWA3PTeYPkbO6hi98Aw ($27.85 in chips) 
Seat 4: 4lJto+Qj0K4JrFKvHaPTLw ($66.15 in chips) 
Seat 5: FYepjhAvF8ZdVCmqHIy+eQ ($28.50 in chips) 
Seat 6: QvTX2yGq3uKJiKPmns4TKQ ($25 in chips) 
FYepjhAvF8ZdVCmqHIy+eQ: posts small blind $0.10
QvTX2yGq3uKJiKPmns4TKQ: posts big blind $0.25
*** HOLE CARDS ***
QiL+lEgEWwy21jk/ltaRLg: folds 
xrf8tAXKQHG99HixCot1Iw: folds 
mfrkWA3PTeYPkbO6hi98Aw: raises $0.75 to $1
4lJto+Qj0K4JrFKvHaPTLw: folds 
FYepjhAvF8ZdVCmqHIy+eQ: folds 
QvTX2yGq3uKJiKPmns4TKQ: folds 
Uncalled bet ($0.75) returned to mfrkWA3PTeYPkbO6hi98Aw
mfrkWA3PTeYPkbO6hi98Aw collected $0.60 from pot
mfrkWA3PTeYPkbO6hi98Aw: doesn't show hand 
*** SUMMARY ***
Total pot $0.60 | Rake $0 
Seat 1: QiL+lEgEWwy21jk/ltaRLg folded before Flop (didn't bet)
Seat 2: xrf8tAXKQHG99HixCot1Iw folded before Flop (didn't bet)
Seat 3: mfrkWA3PTeYPkbO6hi98Aw collected ($0.60)
Seat 4: 4lJto+Qj0K4JrFKvHaPTLw (button) folded before Flop (didn't bet)
Seat 5: FYepjhAvF8ZdVCmqHIy+eQ (small blind) folded before Flop
Seat 6: QvTX2yGq3uKJiKPmns4TKQ (big blind) folded before Flop




PokerStars Game #59941655168:  Hold'em No Limit ($0.10/$0.25) - 2009/07/01 1:42:00 ET
Table '63h13e5p7cWe02rClZ1CHw' 6-max Seat #3 is the button
Seat 1: pokjbbEcXXPlADXdSGHtZw ($21 in chips) 
Seat 2: k9nHZTHt8hYhYRcW8NTb4g ($27.65 in chips) 
Seat 3: mFv3iBCtrw9XfCDRB0d46Q ($5 in chips) 
Seat 4: xrf8tAXKQHG99HixCot1Iw ($23.80 in chips) 
Seat 5: iyZxqznXjv3vtvOJymkoLQ ($45.15 in chips) 
Seat 6: mfrkWA3PTeYPkbO6hi98Aw ($38.45 in chips) 
xrf8tAXKQHG99HixCot1Iw: posts small blind $0.10
iyZxqznXjv3vtvOJymkoLQ: posts big blind $0.25
*** HOLE CARDS ***
mfrkWA3PTeYPkbO6hi98Aw: raises $0.75 to $1
pokjbbEcXXPlADXdSGHtZw: folds 
k9nHZTHt8hYhYRcW8NTb4g: folds 
mFv3iBCtrw9XfCDRB0d46Q: folds 
xrf8tAXKQHG99HixCot1Iw: folds 
iyZxqznXjv3vtvOJymkoLQ: folds 
Uncalled bet ($0.75) returned to mfrkWA3PTeYPkbO6hi98Aw
mfrkWA3PTeYPkbO6hi98Aw collected $0.60 from pot
mfrkWA3PTeYPkbO6hi98Aw: doesn't show hand 
*** SUMMARY ***
Total pot $0.60 | Rake $0 
Seat 1: pokjbbEcXXPlADXdSGHtZw folded before Flop (didn't bet)
Seat 2: k9nHZTHt8hYhYRcW8NTb4g folded before Flop (didn't bet)
Seat 3: mFv3iBCtrw9XfCDRB0d46Q (button) folded before Flop (didn't bet)
Seat 4: xrf8tAXKQHG99HixCot1Iw (small blind) folded before Flop
Seat 5: iyZxqznXjv3vtvOJymkoLQ (big blind) folded before Flop
Seat 6: mfrkWA3PTeYPkbO6hi98Aw collected ($0.60)




PokerStars Game #59941655146:  Hold'em No Limit ($0.10/$0.25) - 2009/07/01 1:42:00 ET
Table 'IRgQPZVA4+IaZZIQshgwyg' 6-max Seat #3 is the button
Seat 1: cezpHJ8FB07dj0xG+LhOvw ($27.90 in chips) 
Seat 2: lquriepNQBhDV5P1SWHhnA ($25 in chips) 
Seat 3: DihMHaz4WNETH1bPDe13kA ($28.45 in chips) 
Seat 4: DE9hRlt14g+JdsRQ4wT7hg ($27.25 in chips) 
Seat 5: PbMzPZIePKifKQZfKDkbIw ($29.20 in chips) 
Seat 6: XbIIdTtuN1xO7zurECHBTg ($11.95 in chips) 
DE9hRlt14g+JdsRQ4wT7hg: posts small blind $0.10
PbMzPZIePKifKQZfKDkbIw: posts big blind $0.25
*** HOLE CARDS ***
XbIIdTtuN1xO7zurECHBTg: calls $0.25
cezpHJ8FB07dj0xG+LhOvw: folds 
lquriepNQBhDV5P1SWHhnA: folds 
DihMHaz4WNETH1bPDe13kA: calls $0.25
DE9hRlt14g+JdsRQ4wT7hg: folds 
PbMzPZIePKifKQZfKDkbIw: checks 
*** FLOP *** [Qs 6s 7s]
PbMzPZIePKifKQZfKDkbIw: checks 
XbIIdTtuN1xO7zurECHBTg: bets $0.75
DihMHaz4WNETH1bPDe13kA: calls $0.75
PbMzPZIePKifKQZfKDkbIw: calls $0.75
*** TURN *** [Qs 6s 7s] [2s]
PbMzPZIePKifKQZfKDkbIw: checks 
XbIIdTtuN1xO7zurECHBTg: bets $1.50
DihMHaz4WNETH1bPDe13kA: folds 
PbMzPZIePKifKQZfKDkbIw: raises $1.50 to $3
XbIIdTtuN1xO7zurECHBTg: calls $1.50
*** RIVER *** [Qs 6s 7s 2s] [3h]
PbMzPZIePKifKQZfKDkbIw: bets $4.50
XbIIdTtuN1xO7zurECHBTg: calls $4.50
*** SHOW DOWN ***
PbMzPZIePKifKQZfKDkbIw: shows [As 5c] (a flush, Ace high)
XbIIdTtuN1xO7zurECHBTg: mucks hand 
PbMzPZIePKifKQZfKDkbIw collected $17.25 from pot
*** SUMMARY ***
Total pot $18.10 | Rake $0.85 
Board [Qs 6s 7s 2s 3h]
Seat 1: cezpHJ8FB07dj0xG+LhOvw folded before Flop (didn't bet)
Seat 2: lquriepNQBhDV5P1SWHhnA folded before Flop (didn't bet)
Seat 3: DihMHaz4WNETH1bPDe13kA (button) folded on the Turn
Seat 4: DE9hRlt14g+JdsRQ4wT7hg (small blind) folded before Flop
Seat 5: PbMzPZIePKifKQZfKDkbIw (big blind) showed [As 5c] and won ($17.25) with a flush, Ace high
Seat 6: XbIIdTtuN1xO7zurECHBTg mucked




PokerStars Game #59941655106:  Hold'em No Limit ($0.10/$0.25) - 2009/07/01 1:42:00 ET
Table 'WY+lMaAoIdBZmwk27/RJCA' 6-max Seat #1 is the button
Seat 1: zHHLkD2sRljslKKeQv/ZQw ($24.85 in chips) 
Seat 2: NhUN/JpAprdJeamFBgJH1w ($26.65 in chips) 
Seat 3: 79Q62AM0VB++TQYiBlOYsA ($82.15 in chips) 
Seat 4: 0av6tRNdi0Ui4f15L7gsVg ($22.15 in chips) 
Seat 5: vqWjZmdQu/Hxw96/IJTWdQ ($29.45 in chips) 
Seat 6: cWc85bEzdRzpUMhRKm8pwQ ($25.85 in chips) 
NhUN/JpAprdJeamFBgJH1w: posts small blind $0.10
79Q62AM0VB++TQYiBlOYsA: posts big blind $0.25
*** HOLE CARDS ***
0av6tRNdi0Ui4f15L7gsVg: folds 
vqWjZmdQu/Hxw96/IJTWdQ: folds 
cWc85bEzdRzpUMhRKm8pwQ: folds 
zHHLkD2sRljslKKeQv/ZQw: raises $1 to $1.25
NhUN/JpAprdJeamFBgJH1w: folds 
79Q62AM0VB++TQYiBlOYsA: calls $1
*** FLOP *** [9h 8d Qc]
79Q62AM0VB++TQYiBlOYsA: checks 
zHHLkD2sRljslKKeQv/ZQw: bets $1.50
79Q62AM0VB++TQYiBlOYsA: folds 
Uncalled bet ($1.50) returned to zHHLkD2sRljslKKeQv/ZQw
zHHLkD2sRljslKKeQv/ZQw collected $2.50 from pot
*** SUMMARY ***
Total pot $2.60 | Rake $0.10 
Board [9h 8d Qc]
Seat 1: zHHLkD2sRljslKKeQv/ZQw (button) collected ($2.50)
Seat 2: NhUN/JpAprdJeamFBgJH1w (small blind) folded before Flop
Seat 3: 79Q62AM0VB++TQYiBlOYsA (big blind) folded on the Flop
Seat 4: 0av6tRNdi0Ui4f15L7gsVg folded before Flop (didn't bet)
Seat 5: vqWjZmdQu/Hxw96/IJTWdQ folded before Flop (didn't bet)
Seat 6: cWc85bEzdRzpUMhRKm8pwQ folded before Flop (didn't bet)




PokerStars Game #59941655262:  Hold'em No Limit ($0.10/$0.25) - 2009/07/01 1:42:00 ET
Table 'YYMg5qzxK1m9eGRo4SbxtQ' 9-max Seat #2 is the button
Seat 2: f/H6PsHRl4W1JyNsEDvPtg ($8.60 in chips) 
Seat 8: xoBFd/5k+L/pFn9VW1VyWg ($13.35 in chips) 
Seat 9: +sbyWwIcFp9kP0bDtMegfQ ($31.75 in chips) 
eebse2009 joins the table at seat #7 
cFmpjvcjNoVAEAIQIxWkYg has timed out
cFmpjvcjNoVAEAIQIxWkYg: is sitting out 
ROxrieegd9WYtWcUKJAlbg will be allowed to play after the button
eebse2009 will be allowed to play after the button
xoBFd/5k+L/pFn9VW1VyWg: posts small blind $0.10
+sbyWwIcFp9kP0bDtMegfQ: posts big blind $0.25
YQhfmYhgnDDlWCAFmBb36Q: is sitting out 
YQhfmYhgnDDlWCAFmBb36Q leaves the table
*** HOLE CARDS ***
3PmVnC/15cl4oyI1TKIt4g joins the table at seat #1 
f/H6PsHRl4W1JyNsEDvPtg: folds 
xoBFd/5k+L/pFn9VW1VyWg: folds 
Uncalled bet ($0.15) returned to +sbyWwIcFp9kP0bDtMegfQ
+sbyWwIcFp9kP0bDtMegfQ collected $0.20 from pot
+sbyWwIcFp9kP0bDtMegfQ: doesn't show hand 
*** SUMMARY ***
Total pot $0.20 | Rake $0 
Seat 2: f/H6PsHRl4W1JyNsEDvPtg (button) folded before Flop (didn't bet)
Seat 8: xoBFd/5k+L/pFn9VW1VyWg (small blind) folded before Flop
Seat 9: +sbyWwIcFp9kP0bDtMegfQ (big blind) collected ($0.20)




PokerStars Game #59941655414:  Hold'em No Limit ($0.10/$0.25) - 2009/07/01 1:42:01 ET
Table 'iMiAw/kTZXopgYX4HI7sHg' 9-max Seat #7 is the button
Seat 1: PdIasPkzm2sqZnN41ZRXOg ($4.90 in chips) 
Seat 2: qwr38jl5txoR36M7G5qi4A ($8.25 in chips) 
Seat 3: HPEB+AtKw1+C/cxU0o1ciw ($28.25 in chips) 
Seat 5: 22dIObOuor/A+IKWkNoAlA ($5.10 in chips) 
Seat 6: Bb42QRQMhg5/Y0vHP8/2Xw ($28.70 in chips) 
Seat 7: ljkBp5cvgbHARUIwY5vUuA ($4.65 in chips) 
Seat 8: tLcDklc2rBORNfixyRfVfw ($25.10 in chips) 
tLcDklc2rBORNfixyRfVfw: posts small blind $0.10
XCD4152: is sitting out 
XCD4152 leaves the table
PdIasPkzm2sqZnN41ZRXOg: posts big blind $0.25
*** HOLE CARDS ***
Z9W7+g1WMhhZDi7DwGbCFA joins the table at seat #4 
qwr38jl5txoR36M7G5qi4A: folds 
HPEB+AtKw1+C/cxU0o1ciw: folds 
22dIObOuor/A+IKWkNoAlA: folds 
Bb42QRQMhg5/Y0vHP8/2Xw: folds 
ljkBp5cvgbHARUIwY5vUuA: calls $0.25
tLcDklc2rBORNfixyRfVfw: raises $1.25 to $1.50
PdIasPkzm2sqZnN41ZRXOg: folds 
ljkBp5cvgbHARUIwY5vUuA: calls $1.25
*** FLOP *** [3s 9s 3c]
tLcDklc2rBORNfixyRfVfw: checks 
7cv+9Zc9HIQHNvYsMfV3uA joins the table at seat #9 
ljkBp5cvgbHARUIwY5vUuA: checks 
*** TURN *** [3s 9s 3c] [6d]
tLcDklc2rBORNfixyRfVfw: bets $1.75
ljkBp5cvgbHARUIwY5vUuA: calls $1.75
*** RIVER *** [3s 9s 3c 6d] [8h]
tLcDklc2rBORNfixyRfVfw: bets $1.50
ljkBp5cvgbHARUIwY5vUuA: calls $1.40 and is all-in
Uncalled bet ($0.10) returned to tLcDklc2rBORNfixyRfVfw
*** SHOW DOWN ***
tLcDklc2rBORNfixyRfVfw: shows [Kh Ks] (two pair, Kings and Threes)
ljkBp5cvgbHARUIwY5vUuA: mucks hand 
tLcDklc2rBORNfixyRfVfw collected $9.10 from pot
ljkBp5cvgbHARUIwY5vUuA leaves the table
*** SUMMARY ***
Total pot $9.55 | Rake $0.45 
Board [3s 9s 3c 6d 8h]
Seat 1: PdIasPkzm2sqZnN41ZRXOg (big blind) folded before Flop
Seat 2: qwr38jl5txoR36M7G5qi4A folded before Flop (didn't bet)
Seat 3: HPEB+AtKw1+C/cxU0o1ciw folded before Flop (didn't bet)
Seat 5: 22dIObOuor/A+IKWkNoAlA folded before Flop (didn't bet)
Seat 6: Bb42QRQMhg5/Y0vHP8/2Xw folded before Flop (didn't bet)
Seat 7: ljkBp5cvgbHARUIwY5vUuA (button) mucked
Seat 8: tLcDklc2rBORNfixyRfVfw (small blind) showed [Kh Ks] and won ($9.10) with two pair, Kings and Threes




PokerStars Game #59941655416:  Hold'em No Limit ($0.10/$0.25) - 2009/07/01 1:42:01 ET
Table 'O6cwjhrMn9pfzx1Ngn5zkQ' 6-max Seat #6 is the button
Seat 1: LJI7A1YgDM7hgh7o56+ReQ ($30.65 in chips) 
Seat 2: tSR4329m40dZsN7YOpI9Kw ($29.70 in chips) 
Seat 3: EE16Ua5b1HSsYej5zeXOlA ($25.80 in chips) 
Seat 4: mfrkWA3PTeYPkbO6hi98Aw ($24.30 in chips) 
Seat 5: niLn0xUVlqh8If80xRjzCA ($25.65 in chips) 
Seat 6: 4TM16KVgEiQpLi4bVVWbVQ ($31.65 in chips) 
LJI7A1YgDM7hgh7o56+ReQ: posts small blind $0.10
tSR4329m40dZsN7YOpI9Kw: posts big blind $0.25
*** HOLE CARDS ***
EE16Ua5b1HSsYej5zeXOlA: folds 
mfrkWA3PTeYPkbO6hi98Aw: folds 
niLn0xUVlqh8If80xRjzCA: calls $0.25
4TM16KVgEiQpLi4bVVWbVQ: folds 
LJI7A1YgDM7hgh7o56+ReQ: folds 
tSR4329m40dZsN7YOpI9Kw: checks 
*** FLOP *** [Ad 7h 2c]
tSR4329m40dZsN7YOpI9Kw: checks 
niLn0xUVlqh8If80xRjzCA: checks 
*** TURN *** [Ad 7h 2c] [Kc]
tSR4329m40dZsN7YOpI9Kw: checks 
niLn0xUVlqh8If80xRjzCA: checks 
*** RIVER *** [Ad 7h 2c Kc] [Qh]
tSR4329m40dZsN7YOpI9Kw: checks 
niLn0xUVlqh8If80xRjzCA: bets $0.25
tSR4329m40dZsN7YOpI9Kw: folds 
Uncalled bet ($0.25) returned to niLn0xUVlqh8If80xRjzCA
niLn0xUVlqh8If80xRjzCA collected $0.60 from pot
niLn0xUVlqh8If80xRjzCA: doesn't show hand 
*** SUMMARY ***
Total pot $0.60 | Rake $0 
Board [Ad 7h 2c Kc Qh]
Seat 1: LJI7A1YgDM7hgh7o56+ReQ (small blind) folded before Flop
Seat 2: tSR4329m40dZsN7YOpI9Kw (big blind) folded on the River
Seat 3: EE16Ua5b1HSsYej5zeXOlA folded before Flop (didn't bet)
Seat 4: mfrkWA3PTeYPkbO6hi98Aw folded before Flop (didn't bet)
Seat 5: niLn0xUVlqh8If80xRjzCA collected ($0.60)
Seat 6: 4TM16KVgEiQpLi4bVVWbVQ (button) folded before Flop (didn't bet)




PokerStars Game #59941655470:  Hold'em No Limit ($0.10/$0.25) - 2009/07/01 1:42:01 ET
Table 'jxoHy9yJy0bbH/Qx73FoPA' 9-max Seat #2 is the button
Seat 1: j4q3p0lesp63b1gZDwLBZw ($6.60 in chips) 
Seat 2: F7pnn6czNpHvRM55XcA2EA ($38.40 in chips) 
Seat 3: CVqCt93Mk0MhKMaZ4LZDSQ ($11.30 in chips) 
Seat 4: A1M0JIGHzqMXp7L2MdcxXw ($26.65 in chips) 
Seat 5: cZ99hugmLBj9KhTlc8nCSw ($25.10 in chips) 
Seat 6: tYsOBqdU1+x+yFI7zHO7hQ ($46.35 in chips) 
Seat 7: wGigCmBR/9XWkPpvYos3aQ ($26.40 in chips) 
Seat 9: CvL9Ch1HYCVbTsfpNucitg ($4.90 in chips) 
CVqCt93Mk0MhKMaZ4LZDSQ: posts small blind $0.10
A1M0JIGHzqMXp7L2MdcxXw: posts big blind $0.25
Z9W7+g1WMhhZDi7DwGbCFA: sits out 
*** HOLE CARDS ***
cZ99hugmLBj9KhTlc8nCSw: folds 
cZ99hugmLBj9KhTlc8nCSw leaves the table
tYsOBqdU1+x+yFI7zHO7hQ: raises $0.75 to $1
wGigCmBR/9XWkPpvYos3aQ: folds 
CvL9Ch1HYCVbTsfpNucitg: folds 
j4q3p0lesp63b1gZDwLBZw: folds 
F7pnn6czNpHvRM55XcA2EA: raises $2.50 to $3.50
CVqCt93Mk0MhKMaZ4LZDSQ: folds 
A1M0JIGHzqMXp7L2MdcxXw: folds 
tYsOBqdU1+x+yFI7zHO7hQ: calls $2.50
*** FLOP *** [5d 6h 3s]
tYsOBqdU1+x+yFI7zHO7hQ: checks 
F7pnn6czNpHvRM55XcA2EA: checks 
*** TURN *** [5d 6h 3s] [2c]
tYsOBqdU1+x+yFI7zHO7hQ: checks 
F7pnn6czNpHvRM55XcA2EA: bets $4
tYsOBqdU1+x+yFI7zHO7hQ: calls $4
*** RIVER *** [5d 6h 3s 2c] [6d]
tYsOBqdU1+x+yFI7zHO7hQ: checks 
rzZ3wFcwoPyKlQ0mB5JLRQ joins the table at seat #5 
F7pnn6czNpHvRM55XcA2EA: bets $6.50
tYsOBqdU1+x+yFI7zHO7hQ: folds 
Uncalled bet ($6.50) returned to F7pnn6czNpHvRM55XcA2EA
F7pnn6czNpHvRM55XcA2EA collected $14.60 from pot
F7pnn6czNpHvRM55XcA2EA: doesn't show hand 
*** SUMMARY ***
Total pot $15.35 | Rake $0.75 
Board [5d 6h 3s 2c 6d]
Seat 1: j4q3p0lesp63b1gZDwLBZw folded before Flop (didn't bet)
Seat 2: F7pnn6czNpHvRM55XcA2EA (button) collected ($14.60)
Seat 3: CVqCt93Mk0MhKMaZ4LZDSQ (small blind) folded before Flop
Seat 4: A1M0JIGHzqMXp7L2MdcxXw (big blind) folded before Flop
Seat 5: cZ99hugmLBj9KhTlc8nCSw folded before Flop (didn't bet)
Seat 6: tYsOBqdU1+x+yFI7zHO7hQ folded on the River
Seat 7: wGigCmBR/9XWkPpvYos3aQ folded before Flop (didn't bet)
Seat 9: CvL9Ch1HYCVbTsfpNucitg folded before Flop (didn't bet)




PokerStars Game #59941655826:  Hold'em No Limit ($0.10/$0.25) - 2009/07/01 1:42:01 ET
Table 'nFlmVztKq1HJEWfxmdl15w' 9-max Seat #9 is the button
Seat 1: cZ99hugmLBj9KhTlc8nCSw ($25 in chips) 
Seat 2: Th3FldXKQW6hWVVPahaoOQ ($38.75 in chips) 
Seat 4: +5dSUwD+/k2ktlnutSMivw ($9.40 in chips) 
Seat 5: Tx6zQdk5Ozt9ObEBlU7jeg ($32.45 in chips) 
Seat 6: 4awUyiDYTgylQKXZ9faBVA ($36 in chips) 
Seat 7: dfNim92Z6XK1/h5SFW5vDg ($26.50 in chips) 
Seat 8: +2kMBNpY4nF1qNCRd8SJLA ($33.90 in chips) 
Seat 9: DnDcAdn9P0zGovMERigpFA ($25 in chips) 
cZ99hugmLBj9KhTlc8nCSw: posts small blind $0.10
Th3FldXKQW6hWVVPahaoOQ: posts big blind $0.25
DdPXdieucQ+n99u1n3A+rQ: sits out 
*** HOLE CARDS ***
+5dSUwD+/k2ktlnutSMivw: calls $0.25
Tx6zQdk5Ozt9ObEBlU7jeg: folds 
4awUyiDYTgylQKXZ9faBVA: folds 
dfNim92Z6XK1/h5SFW5vDg: raises $1 to $1.25
+2kMBNpY4nF1qNCRd8SJLA: folds 
DnDcAdn9P0zGovMERigpFA: folds 
cZ99hugmLBj9KhTlc8nCSw: folds 
Th3FldXKQW6hWVVPahaoOQ: folds 
+5dSUwD+/k2ktlnutSMivw: calls $1
*** FLOP *** [9c 2d 6d]
+5dSUwD+/k2ktlnutSMivw: checks 
dfNim92Z6XK1/h5SFW5vDg: bets $1.75
+5dSUwD+/k2ktlnutSMivw: raises $6.40 to $8.15 and is all-in
dfNim92Z6XK1/h5SFW5vDg: calls $6.40
*** TURN *** [9c 2d 6d] [7h]
*** RIVER *** [9c 2d 6d 7h] [3c]
*** SHOW DOWN ***
+5dSUwD+/k2ktlnutSMivw: shows [9s Jh] (a pair of Nines)
dfNim92Z6XK1/h5SFW5vDg: shows [Ad Ah] (a pair of Aces)
dfNim92Z6XK1/h5SFW5vDg collected $18.20 from pot
*** SUMMARY ***
Total pot $19.15 | Rake $0.95 
Board [9c 2d 6d 7h 3c]
Seat 1: cZ99hugmLBj9KhTlc8nCSw (small blind) folded before Flop
Seat 2: Th3FldXKQW6hWVVPahaoOQ (big blind) folded before Flop
Seat 4: +5dSUwD+/k2ktlnutSMivw showed [9s Jh] and lost with a pair of Nines
Seat 5: Tx6zQdk5Ozt9ObEBlU7jeg folded before Flop (didn't bet)
Seat 6: 4awUyiDYTgylQKXZ9faBVA folded before Flop (didn't bet)
Seat 7: dfNim92Z6XK1/h5SFW5vDg showed [Ad Ah] and won ($18.20) with a pair of Aces
Seat 8: +2kMBNpY4nF1qNCRd8SJLA folded before Flop (didn't bet)
Seat 9: DnDcAdn9P0zGovMERigpFA (button) folded before Flop (didn't bet)




PokerStars Game #59941655392:  Hold'em No Limit ($0.10/$0.25) - 2009/07/01 1:42:01 ET
Table 'pAhiNHs/spaABQia+7gWNQ' 9-max Seat #1 is the button
Seat 1: ipgcO7Pa6LC8XWpVttZfnA ($4.65 in chips) 
Seat 2: dfNim92Z6XK1/h5SFW5vDg ($25.35 in chips) 
Seat 3: xEQxarad8/T4jJdpZy5LGw ($35.40 in chips) 
Seat 5: OlPJsgR4xypSg/w1z7Gyvw ($32.90 in chips) 
Seat 6: oLa/tXLfSLLB28mcLGrxcg ($24.25 in chips) 
Seat 7: +WTkVY3GeLxqGQBbMZQiWQ ($5.90 in chips) 
Seat 8: PskTLlFIRHSp61inskRzVg ($15.15 in chips) 
Seat 9: zgi+EUykT/pZQpoUG6+oEg ($4.65 in chips) 
dfNim92Z6XK1/h5SFW5vDg: posts small blind $0.10
xEQxarad8/T4jJdpZy5LGw: posts big blind $0.25
Qduu7ikeizo6q6Ei9YvcJA: sits out 
PskTLlFIRHSp61inskRzVg: posts big blind $0.25
*** HOLE CARDS ***
OlPJsgR4xypSg/w1z7Gyvw: folds 
oLa/tXLfSLLB28mcLGrxcg: calls $0.25
+WTkVY3GeLxqGQBbMZQiWQ: folds 
PskTLlFIRHSp61inskRzVg: checks 
zgi+EUykT/pZQpoUG6+oEg: folds 
ipgcO7Pa6LC8XWpVttZfnA: folds 
dfNim92Z6XK1/h5SFW5vDg: folds 
xEQxarad8/T4jJdpZy5LGw: checks 
*** FLOP *** [6c Ad 8d]
xEQxarad8/T4jJdpZy5LGw: checks 
oLa/tXLfSLLB28mcLGrxcg: bets $1
PskTLlFIRHSp61inskRzVg: folds 
xEQxarad8/T4jJdpZy5LGw: folds 
Uncalled bet ($1) returned to oLa/tXLfSLLB28mcLGrxcg
oLa/tXLfSLLB28mcLGrxcg collected $0.85 from pot
oLa/tXLfSLLB28mcLGrxcg: doesn't show hand 
*** SUMMARY ***
Total pot $0.85 | Rake $0 
Board [6c Ad 8d]
Seat 1: ipgcO7Pa6LC8XWpVttZfnA (button) folded before Flop (didn't bet)
Seat 2: dfNim92Z6XK1/h5SFW5vDg (small blind) folded before Flop
Seat 3: xEQxarad8/T4jJdpZy5LGw (big blind) folded on the Flop
Seat 5: OlPJsgR4xypSg/w1z7Gyvw folded before Flop (didn't bet)
Seat 6: oLa/tXLfSLLB28mcLGrxcg collected ($0.85)
Seat 7: +WTkVY3GeLxqGQBbMZQiWQ folded before Flop (didn't bet)
Seat 8: PskTLlFIRHSp61inskRzVg folded on the Flop
Seat 9: zgi+EUykT/pZQpoUG6+oEg folded before Flop (didn't bet)




PokerStars Game #59941655424:  Hold'em No Limit ($0.10/$0.25) - 2009/07/01 1:42:01 ET
Table '6aL2C8IFwHHr6SG6RgXaow' 9-max Seat #5 is the button
Seat 1: AKrlhR3s97+cfTtZj3tKjw ($3.65 in chips) 
Seat 3: aCVg6cCxQcqClhB9nq/p1w ($12.35 in chips) 
Seat 4: BT6Oal0iO4P6kDuT7HFQDw ($19.35 in chips) 
Seat 5: wre31HfyzQGpIvID1istxw ($21.20 in chips) 
Seat 6: gehe91e0IyVT0QU/XBkEyg ($27.20 in chips) 
Seat 7: QJxYAPJ6uPZZcpdN+RvWcQ ($25 in chips) 
Seat 8: rQhYIYXSyH/IivYM1dlV5A ($21.65 in chips) 
Seat 9: CgIo2ItZqi4o3ayVG6HanQ ($23.75 in chips) 
gehe91e0IyVT0QU/XBkEyg: posts small blind $0.10
QJxYAPJ6uPZZcpdN+RvWcQ: posts big blind $0.25
*** HOLE CARDS ***
rQhYIYXSyH/IivYM1dlV5A: folds 
CgIo2ItZqi4o3ayVG6HanQ: calls $0.25
AKrlhR3s97+cfTtZj3tKjw: folds 
aCVg6cCxQcqClhB9nq/p1w: folds 
BT6Oal0iO4P6kDuT7HFQDw: calls $0.25
wre31HfyzQGpIvID1istxw: folds 
gehe91e0IyVT0QU/XBkEyg: folds 
QJxYAPJ6uPZZcpdN+RvWcQ: checks 
*** FLOP *** [5s 2d Qc]
QJxYAPJ6uPZZcpdN+RvWcQ: checks 
AKrlhR3s97+cfTtZj3tKjw leaves the table
CgIo2ItZqi4o3ayVG6HanQ: bets $0.50
BT6Oal0iO4P6kDuT7HFQDw: folds 
bXpVeaSTPBFSPJmeXxO7nw joins the table at seat #1 
QJxYAPJ6uPZZcpdN+RvWcQ: folds 
Uncalled bet ($0.50) returned to CgIo2ItZqi4o3ayVG6HanQ
CgIo2ItZqi4o3ayVG6HanQ collected $0.85 from pot
*** SUMMARY ***
Total pot $0.85 | Rake $0 
Board [5s 2d Qc]
Seat 1: AKrlhR3s97+cfTtZj3tKjw folded before Flop (didn't bet)
Seat 3: aCVg6cCxQcqClhB9nq/p1w folded before Flop (didn't bet)
Seat 4: BT6Oal0iO4P6kDuT7HFQDw folded on the Flop
Seat 5: wre31HfyzQGpIvID1istxw (button) folded before Flop (didn't bet)
Seat 6: gehe91e0IyVT0QU/XBkEyg (small blind) folded before Flop
Seat 7: QJxYAPJ6uPZZcpdN+RvWcQ (big blind) folded on the Flop
Seat 8: rQhYIYXSyH/IivYM1dlV5A folded before Flop (didn't bet)
Seat 9: CgIo2ItZqi4o3ayVG6HanQ collected ($0.85)




PokerStars Game #59941655612:  Hold'em No Limit ($0.10/$0.25) - 2009/07/01 1:42:01 ET
Table 'VuY5ej47Cy8nOI3Wogmhzw' 6-max Seat #1 is the button
Seat 1: EeUZtMU058v2ObUACOF4Og ($37.85 in chips) 
Seat 2: AM6Yl+3esmhhMBlSnQhWbg ($17.40 in chips) 
Seat 3: v+QfkGiuj9bgtuNoVnDO8w ($31.50 in chips) 
Seat 5: iK/41//HmnLiIn0CVNNfyA ($11.30 in chips) 
AM6Yl+3esmhhMBlSnQhWbg: posts small blind $0.10
v+QfkGiuj9bgtuNoVnDO8w: posts big blind $0.25
bj4ouH72+hnabFw65V/TLg: sits out 
*** HOLE CARDS ***
iK/41//HmnLiIn0CVNNfyA: folds 
EeUZtMU058v2ObUACOF4Og: folds 
AM6Yl+3esmhhMBlSnQhWbg: calls $0.15
v+QfkGiuj9bgtuNoVnDO8w: checks 
*** FLOP *** [Ad Kc 8h]
AM6Yl+3esmhhMBlSnQhWbg: checks 
v+QfkGiuj9bgtuNoVnDO8w: checks 
*** TURN *** [Ad Kc 8h] [Qd]
AM6Yl+3esmhhMBlSnQhWbg: bets $0.50
v+QfkGiuj9bgtuNoVnDO8w: calls $0.50
*** RIVER *** [Ad Kc 8h Qd] [4c]
AM6Yl+3esmhhMBlSnQhWbg: bets $1
v+QfkGiuj9bgtuNoVnDO8w: calls $1
*** SHOW DOWN ***
AM6Yl+3esmhhMBlSnQhWbg: shows [Qc 4s] (two pair, Queens and Fours)
v+QfkGiuj9bgtuNoVnDO8w: mucks hand 
AM6Yl+3esmhhMBlSnQhWbg collected $3.35 from pot
*** SUMMARY ***
Total pot $3.50 | Rake $0.15 
Board [Ad Kc 8h Qd 4c]
Seat 1: EeUZtMU058v2ObUACOF4Og (button) folded before Flop (didn't bet)
Seat 2: AM6Yl+3esmhhMBlSnQhWbg (small blind) showed [Qc 4s] and won ($3.35) with two pair, Queens and Fours
Seat 3: v+QfkGiuj9bgtuNoVnDO8w (big blind) mucked
Seat 5: iK/41//HmnLiIn0CVNNfyA folded before Flop (didn't bet)




PokerStars Game #59941655686:  Hold'em No Limit ($0.10/$0.25) - 2009/07/01 1:42:01 ET
Table 'dYNvO8G5kw5SRxb1Dljhogz2yOdY2zyGWG1gh9WV9XtQ Seat #7 is the button
Seat 1: vSkQm2EelzwRGDDQQk0Fqw ($4.90 in chips) 
Seat 2: PkBmevN3LdXkPj1LHOoTnQ ($14.05 in chips) 
Seat 3: 1Cs1GyQcoM1omwY7XZ3uRg ($13.25 in chips) 
Seat 4: sD+TKtt36XiiN6jqHiLwDA ($28.10 in chips) 
Seat 5: W7XGvw6ngGVq2hFwXk8Myg ($25.85 in chips) 
Seat 6: 22dIObOuor/A+IKWkNoAlA ($7.20 in chips) 
Seat 7: DiSvPC2iudwL5j9u6Huyww ($40 in chips) 
Seat 8: 6HoFYfVGBefsR5Vrz62qIw5hAPbqNrvJb8PtLiceXtlg0.10 in chips) 
Seat 9: PdIasPkzm2sqZnN41ZRXOg ($5 in chips) 
6HoFYfVGBefsR5Vrz62qIw5hAPbqNrvJb8PtLiceXtlgsts small blind $0.10
PdIasPkzm2sqZnN41ZRXOg: posts big blind $0.25
*** HOLE CARDS ***
vSkQm2EelzwRGDDQQk0Fqw: folds 
PkBmevN3LdXkPj1LHOoTnQ: calls $0.25
1Cs1GyQcoM1omwY7XZ3uRg: calls $0.25
sD+TKtt36XiiN6jqHiLwDA: folds 
W7XGvw6ngGVq2hFwXk8Myg: calls $0.25
22dIObOuor/A+IKWkNoAlA: folds 
DiSvPC2iudwL5j9u6Huyww: calls $0.25
6HoFYfVGBefsR5Vrz62qIw5hAPbqNrvJb8PtLiceXtlglds 
PdIasPkzm2sqZnN41ZRXOg: checks 
*** FLOP *** [3d 4c 9s]
PdIasPkzm2sqZnN41ZRXOg: checks 
PkBmevN3LdXkPj1LHOoTnQ: bets $0.75
1Cs1GyQcoM1omwY7XZ3uRg: folds 
W7XGvw6ngGVq2hFwXk8Myg: folds 
DiSvPC2iudwL5j9u6Huyww: folds 
PdIasPkzm2sqZnN41ZRXOg: folds 
Uncalled bet ($0.75) returned to PkBmevN3LdXkPj1LHOoTnQ
PkBmevN3LdXkPj1LHOoTnQ collected $1.30 from pot
*** SUMMARY ***
Total pot $1.35 | Rake $0.05 
Board [3d 4c 9s]
Seat 1: vSkQm2EelzwRGDDQQk0Fqw folded before Flop (didn't bet)
Seat 2: PkBmevN3LdXkPj1LHOoTnQ collected ($1.30)
Seat 3: 1Cs1GyQcoM1omwY7XZ3uRg folded on the Flop
Seat 4: sD+TKtt36XiiN6jqHiLwDA folded before Flop (didn't bet)
Seat 5: W7XGvw6ngGVq2hFwXk8Myg folded on the Flop
Seat 6: 22dIObOuor/A+IKWkNoAlA folded before Flop (didn't bet)
Seat 7: DiSvPC2iudwL5j9u6Huyww (button) folded on the Flop
Seat 8: 6HoFYfVGBefsR5Vrz62qIw5hAPbqNrvJb8PtLiceXtlgall blind) folded before Flop
Seat 9: PdIasPkzm2sqZnN41ZRXOg (big blind) folded on the Flop




PokerStars Game #59941656226:  Hold'em No Limit ($0.10/$0.25) - 2009/07/01 1:42:02 ET
Table 'WjNvuuSgTjm8jh0j9vcCgQ' 9-max Seat #5 is the button
Seat 1: q+Qdg0Hoir+SyL7haBrUnw ($8.05 in chips) 
Seat 2: ghNKXUBl/H+t83JF079ZBA ($23.40 in chips) 
Seat 3: pSKReiGBNW9NsF2jAZnlwg ($21.40 in chips) 
Seat 4: X78b5v/uhqeXXoAijbw/yg ($31.35 in chips) 
Seat 5: ziFpkH3wCzqB/qXeq/Hy7g ($25 in chips) 
Seat 6: ubsjZomMWSV0hAiBLa7K1A ($21.35 in chips) 
Seat 7: NSX8YOj+RznxoL+rO1YU4w ($13.25 in chips) 
Seat 8: hZuGwtYmFKPmQ+v1wlmdfA ($17.75 in chips) 
Seat 9: CT7Xj/V/O5rBlhtt+RZeFQ ($25.60 in chips) 
ubsjZomMWSV0hAiBLa7K1A: posts small blind $0.10
NSX8YOj+RznxoL+rO1YU4w: posts big blind $0.25
*** HOLE CARDS ***
hZuGwtYmFKPmQ+v1wlmdfA: folds 
CT7Xj/V/O5rBlhtt+RZeFQ: folds 
q+Qdg0Hoir+SyL7haBrUnw: folds 
ghNKXUBl/H+t83JF079ZBA: folds 
pSKReiGBNW9NsF2jAZnlwg: calls $0.25
X78b5v/uhqeXXoAijbw/yg: folds 
ziFpkH3wCzqB/qXeq/Hy7g: calls $0.25
ubsjZomMWSV0hAiBLa7K1A: folds 
NSX8YOj+RznxoL+rO1YU4w: checks 
*** FLOP *** [9c 5c Ts]
NSX8YOj+RznxoL+rO1YU4w: checks 
pSKReiGBNW9NsF2jAZnlwg: checks 
ziFpkH3wCzqB/qXeq/Hy7g: checks 
*** TURN *** [9c 5c Ts] [Ks]
NSX8YOj+RznxoL+rO1YU4w: checks 
pSKReiGBNW9NsF2jAZnlwg: checks 
ziFpkH3wCzqB/qXeq/Hy7g: checks 
*** RIVER *** [9c 5c Ts Ks] [Ad]
NSX8YOj+RznxoL+rO1YU4w: checks 
pSKReiGBNW9NsF2jAZnlwg: bets $0.50
ziFpkH3wCzqB/qXeq/Hy7g: folds 
NSX8YOj+RznxoL+rO1YU4w: folds 
Uncalled bet ($0.50) returned to pSKReiGBNW9NsF2jAZnlwg
pSKReiGBNW9NsF2jAZnlwg collected $0.85 from pot
*** SUMMARY ***
Total pot $0.85 | Rake $0 
Board [9c 5c Ts Ks Ad]
Seat 1: q+Qdg0Hoir+SyL7haBrUnw folded before Flop (didn't bet)
Seat 2: ghNKXUBl/H+t83JF079ZBA folded before Flop (didn't bet)
Seat 3: pSKReiGBNW9NsF2jAZnlwg collected ($0.85)
Seat 4: X78b5v/uhqeXXoAijbw/yg folded before Flop (didn't bet)
Seat 5: ziFpkH3wCzqB/qXeq/Hy7g (button) folded on the River
Seat 6: ubsjZomMWSV0hAiBLa7K1A (small blind) folded before Flop
Seat 7: NSX8YOj+RznxoL+rO1YU4w (big blind) folded on the River
Seat 8: hZuGwtYmFKPmQ+v1wlmdfA folded before Flop (didn't bet)
Seat 9: CT7Xj/V/O5rBlhtt+RZeFQ folded before Flop (didn't bet)




PokerStars Game #59941655838:  Hold'em No Limit ($0.10/$0.25) - 2009/07/01 1:42:02 ET
Table 'aisAlB9GIV21BwfUW3+Nbg' 9-max Seat #6 is the button
Seat 1: SqibpGx+lf+brY0fJVvD0w ($24.65 in chips) 
Seat 2: +7GnIVpCmyuij3NJfOgsTw ($13.40 in chips) 
Seat 3: CvL9Ch1HYCVbTsfpNucitg ($4.80 in chips) 
Seat 4: sD+TKtt36XiiN6jqHiLwDA ($26.20 in chips) 
Seat 5: ghNKXUBl/H+t83JF079ZBA ($27.40 in chips) 
Seat 6: 9gmYYQesalMrUjaF7nKfrQ ($16.20 in chips) 
Seat 7: jGjM+5lCSe6f2MEwxQGOAg ($37.70 in chips) 
Seat 8: VWUWpMLMj/Q1jRVpF7Aohw ($12.50 in chips) 
Seat 9: N0hGpTAEAj9k5msS6LPLAw ($10.75 in chips) 
jGjM+5lCSe6f2MEwxQGOAg: posts small blind $0.10
VWUWpMLMj/Q1jRVpF7Aohw: posts big blind $0.25
*** HOLE CARDS ***
N0hGpTAEAj9k5msS6LPLAw: raises $0.50 to $0.75
SqibpGx+lf+brY0fJVvD0w: folds 
+7GnIVpCmyuij3NJfOgsTw: folds 
CvL9Ch1HYCVbTsfpNucitg: folds 
sD+TKtt36XiiN6jqHiLwDA: folds 
ghNKXUBl/H+t83JF079ZBA: folds 
9gmYYQesalMrUjaF7nKfrQ: folds 
jGjM+5lCSe6f2MEwxQGOAg: folds 
VWUWpMLMj/Q1jRVpF7Aohw: folds 
Uncalled bet ($0.50) returned to N0hGpTAEAj9k5msS6LPLAw
N0hGpTAEAj9k5msS6LPLAw collected $0.60 from pot
*** SUMMARY ***
Total pot $0.60 | Rake $0 
Seat 1: SqibpGx+lf+brY0fJVvD0w folded before Flop (didn't bet)
Seat 2: +7GnIVpCmyuij3NJfOgsTw folded before Flop (didn't bet)
Seat 3: CvL9Ch1HYCVbTsfpNucitg folded before Flop (didn't bet)
Seat 4: sD+TKtt36XiiN6jqHiLwDA folded before Flop (didn't bet)
Seat 5: ghNKXUBl/H+t83JF079ZBA folded before Flop (didn't bet)
Seat 6: 9gmYYQesalMrUjaF7nKfrQ (button) folded before Flop (didn't bet)
Seat 7: jGjM+5lCSe6f2MEwxQGOAg (small blind) folded before Flop
Seat 8: VWUWpMLMj/Q1jRVpF7Aohw (big blind) folded before Flop
Seat 9: N0hGpTAEAj9k5msS6LPLAw collected ($0.60)




PokerStars Game #59941655940:  Hold'em No Limit ($0.10/$0.25) - 2009/07/01 1:42:02 ET
Table '8PD/MTROSMd6Y8mZeykbpg' 6-max Seat #5 is the button
Seat 1: fxNpaToxECtD2Goelmg9vA ($24.85 in chips) 
Seat 3: vqWjZmdQu/Hxw96/IJTWdQ ($25.60 in chips) 
Seat 4: DFi/Lzkjsfv8QswS80JX9Q ($53.70 in chips) 
Seat 5: z3tQwy28dp5FykDJC/wzQw ($25.60 in chips) 
fxNpaToxECtD2Goelmg9vA: posts small blind $0.10
vqWjZmdQu/Hxw96/IJTWdQ: posts big blind $0.25
*** HOLE CARDS ***
DFi/Lzkjsfv8QswS80JX9Q: folds 
z3tQwy28dp5FykDJC/wzQw: raises $0.25 to $0.50
fxNpaToxECtD2Goelmg9vA: folds 
vqWjZmdQu/Hxw96/IJTWdQ: folds 
Uncalled bet ($0.25) returned to z3tQwy28dp5FykDJC/wzQw
z3tQwy28dp5FykDJC/wzQw collected $0.60 from pot
*** SUMMARY ***
Total pot $0.60 | Rake $0 
Seat 1: fxNpaToxECtD2Goelmg9vA (small blind) folded before Flop
Seat 3: vqWjZmdQu/Hxw96/IJTWdQ (big blind) folded before Flop
Seat 4: DFi/Lzkjsfv8QswS80JX9Q folded before Flop (didn't bet)
Seat 5: z3tQwy28dp5FykDJC/wzQw (button) collected ($0.60)




PokerStars Game #59941656002:  Hold'em No Limit ($0.10/$0.25) - 2009/07/01 1:42:02 ET
Table 'FuFyQHmlO/QqQp//rDRrPg' 6-max Seat #3 is the button
Seat 1: jp34e617tIzV8tKIWmfAbA ($27.40 in chips) 
Seat 2: G3h3THGB1j3qdHDVHpnJWg ($22.80 in chips) 
Seat 3: EeUZtMU058v2ObUACOF4Og ($30.25 in chips) 
Seat 5: xrf8tAXKQHG99HixCot1Iw ($25.70 in chips) 
Seat 6: 6DwBRH+xZ12AAZmeAg+aXw ($57.90 in chips) 
xrf8tAXKQHG99HixCot1Iw: posts small blind $0.10
6DwBRH+xZ12AAZmeAg+aXw: posts big blind $0.25
*** HOLE CARDS ***
jp34e617tIzV8tKIWmfAbA: folds 
OMGl+YMGogf2JWIRfT2/Yg leaves the table
G3h3THGB1j3qdHDVHpnJWg has timed out
G3h3THGB1j3qdHDVHpnJWg: folds 
G3h3THGB1j3qdHDVHpnJWg is sitting out
EeUZtMU058v2ObUACOF4Og: raises $0.75 to $1
Ahsa9Yk5NPmCqQstq1EoQA joins the table at seat #4 
xrf8tAXKQHG99HixCot1Iw: folds 
6DwBRH+xZ12AAZmeAg+aXw: folds 
Uncalled bet ($0.75) returned to EeUZtMU058v2ObUACOF4Og
EeUZtMU058v2ObUACOF4Og collected $0.60 from pot
EeUZtMU058v2ObUACOF4Og: doesn't show hand 
*** SUMMARY ***
Total pot $0.60 | Rake $0 
Seat 1: jp34e617tIzV8tKIWmfAbA folded before Flop (didn't bet)
Seat 2: G3h3THGB1j3qdHDVHpnJWg folded before Flop (didn't bet)
Seat 3: EeUZtMU058v2ObUACOF4Og (button) collected ($0.60)
Seat 5: xrf8tAXKQHG99HixCot1Iw (small blind) folded before Flop
Seat 6: 6DwBRH+xZ12AAZmeAg+aXw (big blind) folded before Flop




PokerStars Game #59941656224:  Hold'em No Limit ($0.10/$0.25) - 2009/07/01 1:42:02 ET
Table 'wPWRBZPJl1HAnysw7qRR0A' 6-max Seat #5 is the button
Seat 1: m7ne1MOFTQXlsXT7/R/rug ($9.15 in chips) 
Seat 3: 1ZpoLWO2nm2w1Nd1v9Sr3g ($5.65 in chips) 
Seat 4: epAUIB7h2FJXzUPRIvSkRA ($25.95 in chips) 
Seat 5: y0B+UpYpOUJz3JWtlJQBSA ($16.35 in chips) 
Seat 6: Hsvkc0/G2VV78oVmWYXecw ($9.40 in chips) 
Hsvkc0/G2VV78oVmWYXecw: posts small blind $0.10
m7ne1MOFTQXlsXT7/R/rug: posts big blind $0.25
xC0kaiDYM6YTlgODL83O5A: sits out 
*** HOLE CARDS ***
1ZpoLWO2nm2w1Nd1v9Sr3g: calls $0.25
epAUIB7h2FJXzUPRIvSkRA: folds 
y0B+UpYpOUJz3JWtlJQBSA: folds 
Hsvkc0/G2VV78oVmWYXecw: folds 
m7ne1MOFTQXlsXT7/R/rug: checks 
*** FLOP *** [3c Qc Qs]
m7ne1MOFTQXlsXT7/R/rug: checks 
1ZpoLWO2nm2w1Nd1v9Sr3g: checks 
*** TURN *** [3c Qc Qs] [2c]
m7ne1MOFTQXlsXT7/R/rug: checks 
1ZpoLWO2nm2w1Nd1v9Sr3g: bets $0.50
m7ne1MOFTQXlsXT7/R/rug: calls $0.50
*** RIVER *** [3c Qc Qs 2c] [Ts]
m7ne1MOFTQXlsXT7/R/rug: checks 
1ZpoLWO2nm2w1Nd1v9Sr3g: bets $1.50
m7ne1MOFTQXlsXT7/R/rug: raises $1.50 to $3
1ZpoLWO2nm2w1Nd1v9Sr3g: raises $1.90 to $4.90 and is all-in
m7ne1MOFTQXlsXT7/R/rug: calls $1.90
*** SHOW DOWN ***
1ZpoLWO2nm2w1Nd1v9Sr3g: shows [4c Kc] (a flush, King high)
m7ne1MOFTQXlsXT7/R/rug: shows [7s Qd] (three of a kind, Queens)
1ZpoLWO2nm2w1Nd1v9Sr3g collected $10.85 from pot
*** SUMMARY ***
Total pot $11.40 | Rake $0.55 
Board [3c Qc Qs 2c Ts]
Seat 1: m7ne1MOFTQXlsXT7/R/rug (big blind) showed [7s Qd] and lost with three of a kind, Queens
Seat 3: 1ZpoLWO2nm2w1Nd1v9Sr3g showed [4c Kc] and won ($10.85) with a flush, King high
Seat 4: epAUIB7h2FJXzUPRIvSkRA folded before Flop (didn't bet)
Seat 5: y0B+UpYpOUJz3JWtlJQBSA (button) folded before Flop (didn't bet)
Seat 6: Hsvkc0/G2VV78oVmWYXecw (small blind) folded before Flop




PokerStars Game #59941656242:  Hold'em No Limit ($0.10/$0.25) - 2009/07/01 1:42:02 ET
Table '63uh7ZsO7Tnt+E8b/2bu3A' 6-max Seat #3 is the button
Seat 1: 0av6tRNdi0Ui4f15L7gsVg ($30.90 in chips) 
Seat 2: SFmT9ZsVopnukjvAzrxTRg ($30.95 in chips) 
Seat 3: yVP7GLZBzx47OPi6jzUxMw ($14.35 in chips) 
Seat 4: 2tYgzzRRW/D2GWb2A7f1jw ($6.35 in chips) 
Seat 5: GbCVUNssQ7mqsPWr7J4d3w ($4.75 in chips) 
Seat 6: qGHGf/553gQnDoklMRe3tg ($29 in chips) 
2tYgzzRRW/D2GWb2A7f1jw: posts small blind $0.10
GbCVUNssQ7mqsPWr7J4d3w: posts big blind $0.25
*** HOLE CARDS ***
qGHGf/553gQnDoklMRe3tg: folds 
0av6tRNdi0Ui4f15L7gsVg: folds 
SFmT9ZsVopnukjvAzrxTRg: folds 
yVP7GLZBzx47OPi6jzUxMw: folds 
2tYgzzRRW/D2GWb2A7f1jw: calls $0.15
GbCVUNssQ7mqsPWr7J4d3w: checks 
*** FLOP *** [Ad Jd 9c]
2tYgzzRRW/D2GWb2A7f1jw: checks 
GbCVUNssQ7mqsPWr7J4d3w: checks 
*** TURN *** [Ad Jd 9c] [Th]
2tYgzzRRW/D2GWb2A7f1jw: checks 
GbCVUNssQ7mqsPWr7J4d3w: checks 
*** RIVER *** [Ad Jd 9c Th] [7d]
2tYgzzRRW/D2GWb2A7f1jw: bets $0.75
GbCVUNssQ7mqsPWr7J4d3w: folds 
Uncalled bet ($0.75) returned to 2tYgzzRRW/D2GWb2A7f1jw
2tYgzzRRW/D2GWb2A7f1jw collected $0.50 from pot
2tYgzzRRW/D2GWb2A7f1jw: doesn't show hand 
*** SUMMARY ***
Total pot $0.50 | Rake $0 
Board [Ad Jd 9c Th 7d]
Seat 1: 0av6tRNdi0Ui4f15L7gsVg folded before Flop (didn't bet)
Seat 2: SFmT9ZsVopnukjvAzrxTRg folded before Flop (didn't bet)
Seat 3: yVP7GLZBzx47OPi6jzUxMw (button) folded before Flop (didn't bet)
Seat 4: 2tYgzzRRW/D2GWb2A7f1jw (small blind) collected ($0.50)
Seat 5: GbCVUNssQ7mqsPWr7J4d3w (big blind) folded on the River
Seat 6: qGHGf/553gQnDoklMRe3tg folded before Flop (didn't bet)




PokerStars Game #59941655990:  Hold'em No Limit ($0.10/$0.25) - 2009/07/01 1:42:02 ET
Table 'vFZR6Kf2Th5xBXT9brGW6A' 6-max Seat #6 is the button
Seat 1: Q3EMN7b0ie81AFWkDrhCjw ($20.35 in chips) 
Seat 2: QiL+lEgEWwy21jk/ltaRLg ($23.40 in chips) 
Seat 3: SH1WjKVUjPiyXySjWSdazw ($24.10 in chips) 
Seat 4: 79ID/ub1Pt/mDpCprVmOoA ($35.55 in chips) 
Seat 5: SS/yfeArhULzIcOPe8MdPg ($26.65 in chips) 
Seat 6: 4x9jCqgSw4272dnaIqnanw ($3.25 in chips) 
Q3EMN7b0ie81AFWkDrhCjw: posts small blind $0.10
QiL+lEgEWwy21jk/ltaRLg: posts big blind $0.25
*** HOLE CARDS ***
SH1WjKVUjPiyXySjWSdazw: calls $0.25
79ID/ub1Pt/mDpCprVmOoA: folds 
SS/yfeArhULzIcOPe8MdPg: folds 
4x9jCqgSw4272dnaIqnanw: folds 
Q3EMN7b0ie81AFWkDrhCjw: calls $0.15
QiL+lEgEWwy21jk/ltaRLg: checks 
*** FLOP *** [5h Kc Jh]
Q3EMN7b0ie81AFWkDrhCjw: checks 
QiL+lEgEWwy21jk/ltaRLg: checks 
SH1WjKVUjPiyXySjWSdazw: bets $0.75
Q3EMN7b0ie81AFWkDrhCjw: folds 
QiL+lEgEWwy21jk/ltaRLg: folds 
Uncalled bet ($0.75) returned to SH1WjKVUjPiyXySjWSdazw
SH1WjKVUjPiyXySjWSdazw collected $0.75 from pot
SH1WjKVUjPiyXySjWSdazw: doesn't show hand 
*** SUMMARY ***
Total pot $0.75 | Rake $0 
Board [5h Kc Jh]
Seat 1: Q3EMN7b0ie81AFWkDrhCjw (small blind) folded on the Flop
Seat 2: QiL+lEgEWwy21jk/ltaRLg (big blind) folded on the Flop
Seat 3: SH1WjKVUjPiyXySjWSdazw collected ($0.75)
Seat 4: 79ID/ub1Pt/mDpCprVmOoA folded before Flop (didn't bet)
Seat 5: SS/yfeArhULzIcOPe8MdPg folded before Flop (didn't bet)
Seat 6: 4x9jCqgSw4272dnaIqnanw (button) folded before Flop (didn't bet)




PokerStars Game #59941656558:  Hold'em No Limit ($0.10/$0.25) - 2009/07/01 1:42:03 ET
Table 'l57rayEpPtZotP9nqgSWBg' 6-max Seat #1 is the button
Seat 1: DihMHaz4WNETH1bPDe13kA ($55.75 in chips) 
Seat 2: p6adJRMXMBLr+xtQzqazIQ ($15.65 in chips) 
Seat 3: L3/N/gliETan8N5Gim5h4Q ($25 in chips) 
Seat 4: OqkdGXy1SCzuN5Q0wNlFSg ($22.95 in chips) 
Seat 5: WKJHaZPUgrpTVyLOEjLYmg ($10.65 in chips) 
Seat 6: IGRfskE1v9H9Bn+fz8AgNQ ($17.30 in chips) 
p6adJRMXMBLr+xtQzqazIQ: posts small blind $0.10
L3/N/gliETan8N5Gim5h4Q: posts big blind $0.25
*** HOLE CARDS ***
OqkdGXy1SCzuN5Q0wNlFSg: folds 
WKJHaZPUgrpTVyLOEjLYmg: folds 
IGRfskE1v9H9Bn+fz8AgNQ: folds 
DihMHaz4WNETH1bPDe13kA: raises $0.50 to $0.75
p6adJRMXMBLr+xtQzqazIQ: folds 
L3/N/gliETan8N5Gim5h4Q: folds 
Uncalled bet ($0.50) returned to DihMHaz4WNETH1bPDe13kA
DihMHaz4WNETH1bPDe13kA collected $0.60 from pot
*** SUMMARY ***
Total pot $0.60 | Rake $0 
Seat 1: DihMHaz4WNETH1bPDe13kA (button) collected ($0.60)
Seat 2: p6adJRMXMBLr+xtQzqazIQ (small blind) folded before Flop
Seat 3: L3/N/gliETan8N5Gim5h4Q (big blind) folded before Flop
Seat 4: OqkdGXy1SCzuN5Q0wNlFSg folded before Flop (didn't bet)
Seat 5: WKJHaZPUgrpTVyLOEjLYmg folded before Flop (didn't bet)
Seat 6: IGRfskE1v9H9Bn+fz8AgNQ folded before Flop (didn't bet)




PokerStars Game #59941656436:  Hold'em No Limit ($0.10/$0.25) - 2009/07/01 1:42:03 ET
Table 'tErGGDyESv/0llKumVeZuQ' 9-max Seat #7 is the button
Seat 2: pN3IHvAKm2fz+sTRARTcrg ($24.65 in chips) 
Seat 3: cFmpjvcjNoVAEAIQIxWkYg ($25 in chips) 
Seat 5: 6RQUxA3jk+ePxB/+Hc0IKw ($13.85 in chips) 
Seat 7: uhrboV251dcgYniYTdFIcA ($26.70 in chips) 
Seat 8: UD63hhjq5lMoGqYLFTcH1A ($2.40 in chips) 
Seat 9: d6n762oPkegG086ZJyV5MA ($18 in chips) 
UD63hhjq5lMoGqYLFTcH1A: posts small blind $0.10
d6n762oPkegG086ZJyV5MA: posts big blind $0.25
3PmVnC/15cl4oyI1TKIt4g: sits out 
yqkowiRWZ6NvRN9UUkYIlA: sits out 
*** HOLE CARDS ***
pN3IHvAKm2fz+sTRARTcrg: folds 
cFmpjvcjNoVAEAIQIxWkYg: folds 
6RQUxA3jk+ePxB/+Hc0IKw: folds 
uhrboV251dcgYniYTdFIcA: raises $0.75 to $1
UD63hhjq5lMoGqYLFTcH1A: calls $0.90
d6n762oPkegG086ZJyV5MA: calls $0.75
*** FLOP *** [7s As 2h]
UD63hhjq5lMoGqYLFTcH1A: checks 
d6n762oPkegG086ZJyV5MA: checks 
uhrboV251dcgYniYTdFIcA: bets $1.25
UD63hhjq5lMoGqYLFTcH1A: folds 
d6n762oPkegG086ZJyV5MA: folds 
Uncalled bet ($1.25) returned to uhrboV251dcgYniYTdFIcA
uhrboV251dcgYniYTdFIcA collected $2.85 from pot
uhrboV251dcgYniYTdFIcA: doesn't show hand 
*** SUMMARY ***
Total pot $3 | Rake $0.15 
Board [7s As 2h]
Seat 2: pN3IHvAKm2fz+sTRARTcrg folded before Flop (didn't bet)
Seat 3: cFmpjvcjNoVAEAIQIxWkYg folded before Flop (didn't bet)
Seat 5: 6RQUxA3jk+ePxB/+Hc0IKw folded before Flop (didn't bet)
Seat 7: uhrboV251dcgYniYTdFIcA (button) collected ($2.85)
Seat 8: UD63hhjq5lMoGqYLFTcH1A (small blind) folded on the Flop
Seat 9: d6n762oPkegG086ZJyV5MA (big blind) folded on the Flop




PokerStars Game #59941656570:  Hold'em No Limit ($0.10/$0.25) - 2009/07/01 1:42:03 ET
Table 'a6FCGVBMPcT7J7BDN9q1zQ' 9-max Seat #8 is the button
Seat 2: M2QO2DxB5Wawg2h8HSpnYA ($10 in chips) 
Seat 3: tLcDklc2rBORNfixyRfVfw ($26.15 in chips) 
Seat 4: 8CoKLhwk8Ja6X+O9fxTEDg ($10.80 in chips) 
Seat 5: dtZ84flFEi4Q+SGrHMJRDQ ($27.05 in chips) 
Seat 6: dfNim92Z6XK1/h5SFW5vDg ($25 in chips) 
Seat 7: V0Yo5zRBVM8DYspLKafebg ($4.20 in chips) 
Seat 8: r6hsffOo1iKmaPYKwAZmFw ($69.40 in chips) 
Seat 9: wGigCmBR/9XWkPpvYos3aQ ($28.45 in chips) 
wGigCmBR/9XWkPpvYos3aQ: posts small blind $0.10
zgi+EUykT/pZQpoUG6+oEg: is sitting out 
M2QO2DxB5Wawg2h8HSpnYA: posts big blind $0.25
*** HOLE CARDS ***
tLcDklc2rBORNfixyRfVfw: folds 
8CoKLhwk8Ja6X+O9fxTEDg: folds 
zgi+EUykT/pZQpoUG6+oEg leaves the table
dtZ84flFEi4Q+SGrHMJRDQ: folds 
dfNim92Z6XK1/h5SFW5vDg: folds 
V0Yo5zRBVM8DYspLKafebg: calls $0.25
r6hsffOo1iKmaPYKwAZmFw: folds 
wGigCmBR/9XWkPpvYos3aQ: folds 
bXpVeaSTPBFSPJmeXxO7nw joins the table at seat #1 
M2QO2DxB5Wawg2h8HSpnYA: checks 
*** FLOP *** [Ts 9s 7c]
M2QO2DxB5Wawg2h8HSpnYA: checks 
V0Yo5zRBVM8DYspLKafebg: bets $3.95 and is all-in
M2QO2DxB5Wawg2h8HSpnYA said, "lol nice pot!"
M2QO2DxB5Wawg2h8HSpnYA: folds 
Uncalled bet ($3.95) returned to V0Yo5zRBVM8DYspLKafebg
V0Yo5zRBVM8DYspLKafebg collected $0.60 from pot
*** SUMMARY ***
Total pot $0.60 | Rake $0 
Board [Ts 9s 7c]
Seat 2: M2QO2DxB5Wawg2h8HSpnYA (big blind) folded on the Flop
Seat 3: tLcDklc2rBORNfixyRfVfw folded before Flop (didn't bet)
Seat 4: 8CoKLhwk8Ja6X+O9fxTEDg folded before Flop (didn't bet)
Seat 5: dtZ84flFEi4Q+SGrHMJRDQ folded before Flop (didn't bet)
Seat 6: dfNim92Z6XK1/h5SFW5vDg folded before Flop (didn't bet)
Seat 7: V0Yo5zRBVM8DYspLKafebg collected ($0.60)
Seat 8: r6hsffOo1iKmaPYKwAZmFw (button) folded before Flop (didn't bet)
Seat 9: wGigCmBR/9XWkPpvYos3aQ (small blind) folded before Flop




PokerStars Game #59941656352:  Hold'em No Limit ($0.10/$0.25) - 2009/07/01 1:42:03 ET
Table 'dVzscin98UhGisTmV9BDcw' 9-max Seat #7 is the button
Seat 1: sBAwXpkpgyhyWbHIQcIJKA ($17.90 in chips) 
Seat 2: dfNim92Z6XK1/h5SFW5vDg ($28.25 in chips) 
Seat 4: aNpwfA31EREwO+ar4XzBCw ($42.25 in chips) 
Seat 5: 22dIObOuor/A+IKWkNoAlA ($10.10 in chips) 
Seat 6: bXpVeaSTPBFSPJmeXxO7nw ($8.30 in chips) 
Seat 7: cKlmpQMahVsmOaxFQDcoOg ($24.65 in chips) 
Seat 8: /vn2Qu2dvc9AMMq46Ae0jA ($43.80 in chips) 
Seat 9: arxNSjreDRGFg13EAM2F1w ($25 in chips) 
/vn2Qu2dvc9AMMq46Ae0jA: posts small blind $0.10
arxNSjreDRGFg13EAM2F1w: posts big blind $0.25
*** HOLE CARDS ***
sBAwXpkpgyhyWbHIQcIJKA: folds 
dfNim92Z6XK1/h5SFW5vDg: folds 
aNpwfA31EREwO+ar4XzBCw: folds 
22dIObOuor/A+IKWkNoAlA: folds 
bXpVeaSTPBFSPJmeXxO7nw: folds 
cKlmpQMahVsmOaxFQDcoOg: folds 
cZ99hugmLBj9KhTlc8nCSw joins the table at seat #3 
/vn2Qu2dvc9AMMq46Ae0jA: calls $0.15
arxNSjreDRGFg13EAM2F1w: checks 
*** FLOP *** [9s Qc 4h]
/vn2Qu2dvc9AMMq46Ae0jA: bets $0.75
arxNSjreDRGFg13EAM2F1w: folds 
Uncalled bet ($0.75) returned to /vn2Qu2dvc9AMMq46Ae0jA
/vn2Qu2dvc9AMMq46Ae0jA collected $0.50 from pot
*** SUMMARY ***
Total pot $0.50 | Rake $0 
Board [9s Qc 4h]
Seat 1: sBAwXpkpgyhyWbHIQcIJKA folded before Flop (didn't bet)
Seat 2: dfNim92Z6XK1/h5SFW5vDg folded before Flop (didn't bet)
Seat 4: aNpwfA31EREwO+ar4XzBCw folded before Flop (didn't bet)
Seat 5: 22dIObOuor/A+IKWkNoAlA folded before Flop (didn't bet)
Seat 6: bXpVeaSTPBFSPJmeXxO7nw folded before Flop (didn't bet)
Seat 7: cKlmpQMahVsmOaxFQDcoOg (button) folded before Flop (didn't bet)
Seat 8: /vn2Qu2dvc9AMMq46Ae0jA (small blind) collected ($0.50)
Seat 9: arxNSjreDRGFg13EAM2F1w (big blind) folded on the Flop




PokerStars Game #59941656526:  Hold'em No Limit ($0.10/$0.25) - 2009/07/01 1:42:03 ET
Table 'CM/C/FZf3VHIp50RjmBucQ' 9-max Seat #6 is the button
Seat 3: HPEB+AtKw1+C/cxU0o1ciw ($51.40 in chips) 
Seat 4: FYIiLXWy4mKC5ZGa/fnS0g ($10.05 in chips) 
Seat 5: oLa/tXLfSLLB28mcLGrxcg ($24.55 in chips) 
Seat 6: Bb42QRQMhg5/Y0vHP8/2Xw ($25 in chips) 
Seat 7: j4q3p0lesp63b1gZDwLBZw ($5 in chips) 
j4q3p0lesp63b1gZDwLBZw: posts small blind $0.10
cZ99hugmLBj9KhTlc8nCSw: is sitting out 
cZ99hugmLBj9KhTlc8nCSw leaves the table
USA Cobra: is sitting out 
USA Cobra leaves the table
HPEB+AtKw1+C/cxU0o1ciw: posts big blind $0.25
*** HOLE CARDS ***
FYIiLXWy4mKC5ZGa/fnS0g: calls $0.25
oLa/tXLfSLLB28mcLGrxcg: folds 
Bb42QRQMhg5/Y0vHP8/2Xw: folds 
j4q3p0lesp63b1gZDwLBZw: folds 
HPEB+AtKw1+C/cxU0o1ciw: checks 
*** FLOP *** [7d 6s 3h]
HPEB+AtKw1+C/cxU0o1ciw: checks 
FYIiLXWy4mKC5ZGa/fnS0g: checks 
*** TURN *** [7d 6s 3h] [9s]
HPEB+AtKw1+C/cxU0o1ciw: checks 
xUw035gj8xeH3frcgPyCVw joins the table at seat #2 
FYIiLXWy4mKC5ZGa/fnS0g: checks 
*** RIVER *** [7d 6s 3h 9s] [Kh]
HPEB+AtKw1+C/cxU0o1ciw: checks 
FYIiLXWy4mKC5ZGa/fnS0g: bets $0.75
HPEB+AtKw1+C/cxU0o1ciw: folds 
Uncalled bet ($0.75) returned to FYIiLXWy4mKC5ZGa/fnS0g
FYIiLXWy4mKC5ZGa/fnS0g collected $0.60 from pot
FYIiLXWy4mKC5ZGa/fnS0g: doesn't show hand 
*** SUMMARY ***
Total pot $0.60 | Rake $0 
Board [7d 6s 3h 9s Kh]
Seat 3: HPEB+AtKw1+C/cxU0o1ciw (big blind) folded on the River
Seat 4: FYIiLXWy4mKC5ZGa/fnS0g collected ($0.60)
Seat 5: oLa/tXLfSLLB28mcLGrxcg folded before Flop (didn't bet)
Seat 6: Bb42QRQMhg5/Y0vHP8/2Xw (button) folded before Flop (didn't bet)
Seat 7: j4q3p0lesp63b1gZDwLBZw (small blind) folded before Flop




PokerStars Game #59941656622:  Hold'em No Limit ($0.10/$0.25) - 2009/07/01 1:42:03 ET
Table 'gnrUwXkIPE0C8xl6cB4Hyw' 9-max Seat #6 is the button
Seat 1: EQXHDnIzAsORnIXRNtXRlA ($22.60 in chips) 
Seat 2: 7je+LC5Mfs6nL8YBVh4frQ ($5 in chips) 
Seat 3: PdIasPkzm2sqZnN41ZRXOg ($5 in chips) 
Seat 4: wGigCmBR/9XWkPpvYos3aQ ($25.35 in chips) 
Seat 5: gehe91e0IyVT0QU/XBkEyg ($27.15 in chips) 
Seat 6: dtZ84flFEi4Q+SGrHMJRDQ ($25.80 in chips) 
Seat 7: OXPkK84/qv92EMwXPiG5rQ ($10.20 in chips) 
Seat 8: 4awUyiDYTgylQKXZ9faBVA ($56.55 in chips) 
Seat 9: F7pnn6czNpHvRM55XcA2EA ($28.10 in chips) 
OXPkK84/qv92EMwXPiG5rQ: posts small blind $0.10
4awUyiDYTgylQKXZ9faBVA: posts big blind $0.25
*** HOLE CARDS ***
F7pnn6czNpHvRM55XcA2EA: folds 
EQXHDnIzAsORnIXRNtXRlA: folds 
7je+LC5Mfs6nL8YBVh4frQ: folds 
PdIasPkzm2sqZnN41ZRXOg: folds 
wGigCmBR/9XWkPpvYos3aQ: folds 
gehe91e0IyVT0QU/XBkEyg: folds 
dtZ84flFEi4Q+SGrHMJRDQ: folds 
OXPkK84/qv92EMwXPiG5rQ: calls $0.15
4awUyiDYTgylQKXZ9faBVA: checks 
*** FLOP *** [8h 8c Jc]
OXPkK84/qv92EMwXPiG5rQ: checks 
4awUyiDYTgylQKXZ9faBVA: checks 
*** TURN *** [8h 8c Jc] [4d]
OXPkK84/qv92EMwXPiG5rQ: checks 
4awUyiDYTgylQKXZ9faBVA: checks 
*** RIVER *** [8h 8c Jc 4d] [Ah]
OXPkK84/qv92EMwXPiG5rQ: checks 
4awUyiDYTgylQKXZ9faBVA: bets $0.25
OXPkK84/qv92EMwXPiG5rQ: folds 
Uncalled bet ($0.25) returned to 4awUyiDYTgylQKXZ9faBVA
4awUyiDYTgylQKXZ9faBVA collected $0.50 from pot
4awUyiDYTgylQKXZ9faBVA: doesn't show hand 
*** SUMMARY ***
Total pot $0.50 | Rake $0 
Board [8h 8c Jc 4d Ah]
Seat 1: EQXHDnIzAsORnIXRNtXRlA folded before Flop (didn't bet)
Seat 2: 7je+LC5Mfs6nL8YBVh4frQ folded before Flop (didn't bet)
Seat 3: PdIasPkzm2sqZnN41ZRXOg folded before Flop (didn't bet)
Seat 4: wGigCmBR/9XWkPpvYos3aQ folded before Flop (didn't bet)
Seat 5: gehe91e0IyVT0QU/XBkEyg folded before Flop (didn't bet)
Seat 6: dtZ84flFEi4Q+SGrHMJRDQ (button) folded before Flop (didn't bet)
Seat 7: OXPkK84/qv92EMwXPiG5rQ (small blind) folded on the River
Seat 8: 4awUyiDYTgylQKXZ9faBVA (big blind) collected ($0.50)
Seat 9: F7pnn6czNpHvRM55XcA2EA folded before Flop (didn't bet)




PokerStars Game #59941657138:  Hold'em No Limit ($0.10/$0.25) - 2009/07/01 1:42:04 ET
Table 'fRxOyfaHXkWUDLv4eSxFew' 9-max Seat #4 is the button
Seat 1: 6RiVTYll/5D8zICp0MRpKw ($29.15 in chips) 
Seat 2: M2QO2DxB5Wawg2h8HSpnYA ($10 in chips) 
Seat 3: j4q3p0lesp63b1gZDwLBZw ($5 in chips) 
Seat 4: MtVtHDqIJTyUcXkRBBDIVA ($27.25 in chips) 
Seat 5: dmYlc+1cjwZMJ7wV+Z0rRg ($22.85 in chips) 
Seat 6: arxNSjreDRGFg13EAM2F1w ($27.40 in chips) 
Seat 7: 1/DuWziR8CXhWB71aPQd9Q ($18.15 in chips) 
Seat 8: 5n7e7I+px7c6CQmLpPbtsg ($4.65 in chips) 
Seat 9: H5Se03ZqSX7tbULXur2MAg ($33 in chips) 
dmYlc+1cjwZMJ7wV+Z0rRg: posts small blind $0.10
arxNSjreDRGFg13EAM2F1w: posts big blind $0.25
*** HOLE CARDS ***
1/DuWziR8CXhWB71aPQd9Q: folds 
5n7e7I+px7c6CQmLpPbtsg: folds 
H5Se03ZqSX7tbULXur2MAg: folds 
6RiVTYll/5D8zICp0MRpKw: folds 
M2QO2DxB5Wawg2h8HSpnYA: raises $0.50 to $0.75
j4q3p0lesp63b1gZDwLBZw: folds 
MtVtHDqIJTyUcXkRBBDIVA: folds 
dmYlc+1cjwZMJ7wV+Z0rRg: folds 
arxNSjreDRGFg13EAM2F1w: folds 
Uncalled bet ($0.50) returned to M2QO2DxB5Wawg2h8HSpnYA
M2QO2DxB5Wawg2h8HSpnYA collected $0.60 from pot
M2QO2DxB5Wawg2h8HSpnYA: doesn't show hand 
*** SUMMARY ***
Total pot $0.60 | Rake $0 
Seat 1: 6RiVTYll/5D8zICp0MRpKw folded before Flop (didn't bet)
Seat 2: M2QO2DxB5Wawg2h8HSpnYA collected ($0.60)
Seat 3: j4q3p0lesp63b1gZDwLBZw folded before Flop (didn't bet)
Seat 4: MtVtHDqIJTyUcXkRBBDIVA (button) folded before Flop (didn't bet)
Seat 5: dmYlc+1cjwZMJ7wV+Z0rRg (small blind) folded before Flop
Seat 6: arxNSjreDRGFg13EAM2F1w (big blind) folded before Flop
Seat 7: 1/DuWziR8CXhWB71aPQd9Q folded before Flop (didn't bet)
Seat 8: 5n7e7I+px7c6CQmLpPbtsg folded before Flop (didn't bet)
Seat 9: H5Se03ZqSX7tbULXur2MAg folded before Flop (didn't bet)




PokerStars Game #59941657220:  Hold'em No Limit ($0.10/$0.25) - 2009/07/01 1:42:04 ET
Table 'PCxB2W9H6ma8SwsZlImuOw' 9-max Seat #4 is the button
Seat 1: SqibpGx+lf+brY0fJVvD0w ($25.10 in chips) 
Seat 2: wjH6l1gQaEfv+C45sAOwIQ ($38.20 in chips) 
Seat 3: J2a/QHAWUgo6beDRoEyg2g ($9.10 in chips) 
Seat 4: RsPwA2DnzOke3hD/Of/DUg ($2.55 in chips) 
Seat 5: GZO7tOXatVoX17M2DqPcUQ ($21.15 in chips) 
Seat 6: 5/6dWEBUHldD7iGXa2LwsQ ($17.25 in chips) 
Seat 7: c/9X4zftzphFxYtxp5kp9w ($26.80 in chips) 
Seat 8: Pt637jKksB5MzP0UNJAAkw ($25 in chips) 
Seat 9: COwSH15MvHaRF7en6/TRZQ ($4.65 in chips) 
GZO7tOXatVoX17M2DqPcUQ: posts small blind $0.10
5/6dWEBUHldD7iGXa2LwsQ: posts big blind $0.25
*** HOLE CARDS ***
c/9X4zftzphFxYtxp5kp9w: folds 
Pt637jKksB5MzP0UNJAAkw: folds 
COwSH15MvHaRF7en6/TRZQ: folds 
SqibpGx+lf+brY0fJVvD0w: folds 
wjH6l1gQaEfv+C45sAOwIQ: folds 
J2a/QHAWUgo6beDRoEyg2g: folds 
RsPwA2DnzOke3hD/Of/DUg: folds 
GZO7tOXatVoX17M2DqPcUQ: calls $0.15
5/6dWEBUHldD7iGXa2LwsQ: checks 
*** FLOP *** [2d 5d Ac]
GZO7tOXatVoX17M2DqPcUQ: bets $0.25
5/6dWEBUHldD7iGXa2LwsQ: folds 
Uncalled bet ($0.25) returned to GZO7tOXatVoX17M2DqPcUQ
RsPwA2DnzOke3hD/Of/DUg said, "`"
GZO7tOXatVoX17M2DqPcUQ collected $0.50 from pot
*** SUMMARY ***
Total pot $0.50 | Rake $0 
Board [2d 5d Ac]
Seat 1: SqibpGx+lf+brY0fJVvD0w folded before Flop (didn't bet)
Seat 2: wjH6l1gQaEfv+C45sAOwIQ folded before Flop (didn't bet)
Seat 3: J2a/QHAWUgo6beDRoEyg2g folded before Flop (didn't bet)
Seat 4: RsPwA2DnzOke3hD/Of/DUg (button) folded before Flop (didn't bet)
Seat 5: GZO7tOXatVoX17M2DqPcUQ (small blind) collected ($0.50)
Seat 6: 5/6dWEBUHldD7iGXa2LwsQ (big blind) folded on the Flop
Seat 7: c/9X4zftzphFxYtxp5kp9w folded before Flop (didn't bet)
Seat 8: Pt637jKksB5MzP0UNJAAkw folded before Flop (didn't bet)
Seat 9: COwSH15MvHaRF7en6/TRZQ folded before Flop (didn't bet)




PokerStars Game #59941657242:  Hold'em No Limit ($0.10/$0.25) - 2009/07/01 1:42:04 ET
Table 'SbSV5tlgLp0+/Z+13PW3Hg' 9-max Seat #4 is the button
Seat 1: x+W5+3qsdY4Iszf0hoH+Aw ($14.85 in chips) 
Seat 3: CT7Xj/V/O5rBlhtt+RZeFQ ($25.35 in chips) 
Seat 4: puj3K/wrNjEj86ZL/MyfLA ($10.85 in chips) 
Seat 5: aNpwfA31EREwO+ar4XzBCw ($25 in chips) 
Seat 6: pN3IHvAKm2fz+sTRARTcrg ($25 in chips) 
Seat 7: ruosoLPCzPyA3nfXoPVY3Q ($1.35 in chips) 
Seat 8: qBdqLaJhO+1itcMk70bsfA ($8.90 in chips) 
Seat 9: X78b5v/uhqeXXoAijbw/yg ($25 in chips) 
aNpwfA31EREwO+ar4XzBCw: posts small blind $0.10
pN3IHvAKm2fz+sTRARTcrg: posts big blind $0.25
*** HOLE CARDS ***
ruosoLPCzPyA3nfXoPVY3Q: calls $0.25
qBdqLaJhO+1itcMk70bsfA: folds 
X78b5v/uhqeXXoAijbw/yg: folds 
x+W5+3qsdY4Iszf0hoH+Aw: folds 
CT7Xj/V/O5rBlhtt+RZeFQ: folds 
puj3K/wrNjEj86ZL/MyfLA: folds 
aNpwfA31EREwO+ar4XzBCw: calls $0.15
pN3IHvAKm2fz+sTRARTcrg: checks 
*** FLOP *** [4h Jh 6d]
aNpwfA31EREwO+ar4XzBCw: checks 
pN3IHvAKm2fz+sTRARTcrg: bets $0.50
ruosoLPCzPyA3nfXoPVY3Q: folds 
aNpwfA31EREwO+ar4XzBCw: folds 
Uncalled bet ($0.50) returned to pN3IHvAKm2fz+sTRARTcrg
pN3IHvAKm2fz+sTRARTcrg collected $0.75 from pot
*** SUMMARY ***
Total pot $0.75 | Rake $0 
Board [4h Jh 6d]
Seat 1: x+W5+3qsdY4Iszf0hoH+Aw folded before Flop (didn't bet)
Seat 3: CT7Xj/V/O5rBlhtt+RZeFQ folded before Flop (didn't bet)
Seat 4: puj3K/wrNjEj86ZL/MyfLA (button) folded before Flop (didn't bet)
Seat 5: aNpwfA31EREwO+ar4XzBCw (small blind) folded on the Flop
Seat 6: pN3IHvAKm2fz+sTRARTcrg (big blind) collected ($0.75)
Seat 7: ruosoLPCzPyA3nfXoPVY3Q folded on the Flop
Seat 8: qBdqLaJhO+1itcMk70bsfA folded before Flop (didn't bet)
Seat 9: X78b5v/uhqeXXoAijbw/yg folded before Flop (didn't bet)




PokerStars Game #59941657118:  Hold'em No Limit ($0.10/$0.25) - 2009/07/01 1:42:04 ET
Table '29D3eoQzK5kOAT0OIDS2uQ' 6-max Seat #1 is the button
Seat 1: kG34n23qFQA3nzdOJTQ1dA ($46.15 in chips) 
Seat 3: z3tQwy28dp5FykDJC/wzQw ($17.90 in chips) 
Seat 4: MqMK8OWPSY1V4stf1Hy5Jw ($32.30 in chips) 
Seat 5: Q3EMN7b0ie81AFWkDrhCjw ($28.40 in chips) 
Seat 6: bWbV4MVB/vVpiES1Ut4hew ($29.20 in chips) 
z3tQwy28dp5FykDJC/wzQw: posts small blind $0.10
MqMK8OWPSY1V4stf1Hy5Jw: posts big blind $0.25
*** HOLE CARDS ***
FyE+TQ5JcCqI/tCCHf0jGA has returned
Q3EMN7b0ie81AFWkDrhCjw: calls $0.25
bWbV4MVB/vVpiES1Ut4hew: folds 
kG34n23qFQA3nzdOJTQ1dA: folds 
z3tQwy28dp5FykDJC/wzQw: folds 
MqMK8OWPSY1V4stf1Hy5Jw: checks 
*** FLOP *** [4h Qh 4s]
MqMK8OWPSY1V4stf1Hy5Jw: bets $0.50
Q3EMN7b0ie81AFWkDrhCjw: calls $0.50
*** TURN *** [4h Qh 4s] [Tc]
MqMK8OWPSY1V4stf1Hy5Jw: checks 
Q3EMN7b0ie81AFWkDrhCjw: bets $0.75
MqMK8OWPSY1V4stf1Hy5Jw: raises $2.50 to $3.25
Q3EMN7b0ie81AFWkDrhCjw: calls $2.50
*** RIVER *** [4h Qh 4s Tc] [2s]
MqMK8OWPSY1V4stf1Hy5Jw: bets $7
Q3EMN7b0ie81AFWkDrhCjw: folds 
Uncalled bet ($7) returned to MqMK8OWPSY1V4stf1Hy5Jw
MqMK8OWPSY1V4stf1Hy5Jw collected $7.70 from pot
MqMK8OWPSY1V4stf1Hy5Jw: doesn't show hand 
*** SUMMARY ***
Total pot $8.10 | Rake $0.40 
Board [4h Qh 4s Tc 2s]
Seat 1: kG34n23qFQA3nzdOJTQ1dA (button) folded before Flop (didn't bet)
Seat 3: z3tQwy28dp5FykDJC/wzQw (small blind) folded before Flop
Seat 4: MqMK8OWPSY1V4stf1Hy5Jw (big blind) collected ($7.70)
Seat 5: Q3EMN7b0ie81AFWkDrhCjw folded on the River
Seat 6: bWbV4MVB/vVpiES1Ut4hew folded before Flop (didn't bet)




PokerStars Game #59941656914:  Hold'em No Limit ($0.10/$0.25) - 2009/07/01 1:42:04 ET
Table '0mmHveGuaIfIMQlNE1eqMg' 9-max Seat #3 is the button
Seat 1: ydoFOVgzvZv9ZhuWu9rXAw ($5 in chips) 
Seat 2: rQhYIYXSyH/IivYM1dlV5A ($68.50 in chips) 
Seat 3: ghNKXUBl/H+t83JF079ZBA ($25 in chips) 
Seat 4: DnDcAdn9P0zGovMERigpFA ($35.10 in chips) 
Seat 5: Pt637jKksB5MzP0UNJAAkw ($9.20 in chips) 
Seat 6: 6RiVTYll/5D8zICp0MRpKw ($24.20 in chips) 
Seat 9: UNw/UrAelsQeSS17Rro/BA ($11.15 in chips) 
DnDcAdn9P0zGovMERigpFA: posts small blind $0.10
Pt637jKksB5MzP0UNJAAkw: posts big blind $0.25
5n7e7I+px7c6CQmLpPbtsg: sits out 
0XACOSNrAWmqNv9k1nF8rw: sits out 
*** HOLE CARDS ***
6RiVTYll/5D8zICp0MRpKw: folds 
UNw/UrAelsQeSS17Rro/BA: folds 
ydoFOVgzvZv9ZhuWu9rXAw: folds 
rQhYIYXSyH/IivYM1dlV5A: calls $0.25
ghNKXUBl/H+t83JF079ZBA: folds 
DnDcAdn9P0zGovMERigpFA: folds 
Pt637jKksB5MzP0UNJAAkw: checks 
*** FLOP *** [2d Ah Jc]
Pt637jKksB5MzP0UNJAAkw: checks 
rQhYIYXSyH/IivYM1dlV5A: checks 
*** TURN *** [2d Ah Jc] [5d]
Pt637jKksB5MzP0UNJAAkw: checks 
rQhYIYXSyH/IivYM1dlV5A: checks 
*** RIVER *** [2d Ah Jc 5d] [9h]
Pt637jKksB5MzP0UNJAAkw: checks 
rQhYIYXSyH/IivYM1dlV5A: checks 
*** SHOW DOWN ***
Pt637jKksB5MzP0UNJAAkw: shows [Qd 6h] (high card Ace)
rQhYIYXSyH/IivYM1dlV5A: shows [Qs Tc] (high card Ace - Queen+Jack+Ten kicker)
rQhYIYXSyH/IivYM1dlV5A collected $0.60 from pot
*** SUMMARY ***
Total pot $0.60 | Rake $0 
Board [2d Ah Jc 5d 9h]
Seat 1: ydoFOVgzvZv9ZhuWu9rXAw folded before Flop (didn't bet)
Seat 2: rQhYIYXSyH/IivYM1dlV5A showed [Qs Tc] and won ($0.60) with high card Ace
Seat 3: ghNKXUBl/H+t83JF079ZBA (button) folded before Flop (didn't bet)
Seat 4: DnDcAdn9P0zGovMERigpFA (small blind) folded before Flop
Seat 5: Pt637jKksB5MzP0UNJAAkw (big blind) showed [Qd 6h] and lost with high card Ace
Seat 6: 6RiVTYll/5D8zICp0MRpKw folded before Flop (didn't bet)
Seat 9: UNw/UrAelsQeSS17Rro/BA folded before Flop (didn't bet)




PokerStars Game #59941657774:  Hold'em No Limit ($0.10/$0.25) - 2009/07/01 1:42:05 ET
Table 'NgexmgEDEzICBeSO7YCrKQ' 6-max Seat #3 is the button
Seat 1: cezpHJ8FB07dj0xG+LhOvw ($29.80 in chips) 
Seat 2: 32YL2ZEp8NT4JB2RVM9euQ ($21.55 in chips) 
Seat 3: JFIAqU8lCZ0vWwEl4bdGsg ($26.85 in chips) 
Seat 4: xx+iYCDJhHJmNzrfeloyEg ($27.90 in chips) 
Seat 5: /MXkdT8TTs8Qp2LVTQNw6w ($37.80 in chips) 
Seat 6: k9nHZTHt8hYhYRcW8NTb4g ($10.95 in chips) 
xx+iYCDJhHJmNzrfeloyEg: posts small blind $0.10
/MXkdT8TTs8Qp2LVTQNw6w: posts big blind $0.25
*** HOLE CARDS ***
k9nHZTHt8hYhYRcW8NTb4g: folds 
cezpHJ8FB07dj0xG+LhOvw: folds 
32YL2ZEp8NT4JB2RVM9euQ: folds 
JFIAqU8lCZ0vWwEl4bdGsg: folds 
xx+iYCDJhHJmNzrfeloyEg: folds 
Uncalled bet ($0.15) returned to /MXkdT8TTs8Qp2LVTQNw6w
/MXkdT8TTs8Qp2LVTQNw6w collected $0.20 from pot
/MXkdT8TTs8Qp2LVTQNw6w: doesn't show hand 
/MXkdT8TTs8Qp2LVTQNw6w said, "lol, big slick"
*** SUMMARY ***
Total pot $0.20 | Rake $0 
Seat 1: cezpHJ8FB07dj0xG+LhOvw folded before Flop (didn't bet)
Seat 2: 32YL2ZEp8NT4JB2RVM9euQ folded before Flop (didn't bet)
Seat 3: JFIAqU8lCZ0vWwEl4bdGsg (button) folded before Flop (didn't bet)
Seat 4: xx+iYCDJhHJmNzrfeloyEg (small blind) folded before Flop
Seat 5: /MXkdT8TTs8Qp2LVTQNw6w (big blind) collected ($0.20)
Seat 6: k9nHZTHt8hYhYRcW8NTb4g folded before Flop (didn't bet)




PokerStars Game #59941657782:  Hold'em No Limit ($0.10/$0.25) - 2009/07/01 1:42:05 ET
Table 'g6ryG70feTw9nNm+XJLuXw' 6-max Seat #6 is the button
Seat 1: v+QfkGiuj9bgtuNoVnDO8w ($35.70 in chips) 
Seat 2: SxIIgwXYLkwd6m3wLyPTCw ($33.45 in chips) 
Seat 3: cezpHJ8FB07dj0xG+LhOvw ($25 in chips) 
Seat 4: GC/9yVD59DUCX7hUI7gcLw ($44.35 in chips) 
Seat 5: EE16Ua5b1HSsYej5zeXOlA ($25 in chips) 
Seat 6: tSR4329m40dZsN7YOpI9Kw ($36.60 in chips) 
v+QfkGiuj9bgtuNoVnDO8w: posts small blind $0.10
SxIIgwXYLkwd6m3wLyPTCw: posts big blind $0.25
*** HOLE CARDS ***
cezpHJ8FB07dj0xG+LhOvw: folds 
GC/9yVD59DUCX7hUI7gcLw: folds 
EE16Ua5b1HSsYej5zeXOlA: raises $0.50 to $0.75
tSR4329m40dZsN7YOpI9Kw: folds 
v+QfkGiuj9bgtuNoVnDO8w: folds 
SxIIgwXYLkwd6m3wLyPTCw: folds 
Uncalled bet ($0.50) returned to EE16Ua5b1HSsYej5zeXOlA
EE16Ua5b1HSsYej5zeXOlA collected $0.60 from pot
EE16Ua5b1HSsYej5zeXOlA: doesn't show hand 
*** SUMMARY ***
Total pot $0.60 | Rake $0 
Seat 1: v+QfkGiuj9bgtuNoVnDO8w (small blind) folded before Flop
Seat 2: SxIIgwXYLkwd6m3wLyPTCw (big blind) folded before Flop
Seat 3: cezpHJ8FB07dj0xG+LhOvw folded before Flop (didn't bet)
Seat 4: GC/9yVD59DUCX7hUI7gcLw folded before Flop (didn't bet)
Seat 5: EE16Ua5b1HSsYej5zeXOlA collected ($0.60)
Seat 6: tSR4329m40dZsN7YOpI9Kw (button) folded before Flop (didn't bet)




PokerStars Game #59941657880:  Hold'em No Limit ($0.10/$0.25) - 2009/07/01 1:42:05 ET
Table 'O5NgMYt6EWbLBozZb3kseg' 6-max Seat #5 is the button
Seat 1: MCCWc70bl051s/EF6nHRcA ($32.25 in chips) 
Seat 2: /gJNBeCkWL4o85/jvlZ4BA ($34.50 in chips) 
Seat 3: tLM9aw7T3kBEIhQEh1roOg ($6.50 in chips) 
Seat 4: txiWmlZ/sfM8Td16RHH/cA ($3.10 in chips) 
Seat 5: vu2kzHaDtgr6NM7rdq0chA ($85.20 in chips) 
Seat 6: k9vn40MOqqb+xF+7GZ6v2g ($112.75 in chips) 
k9vn40MOqqb+xF+7GZ6v2g: posts small blind $0.10
MCCWc70bl051s/EF6nHRcA: posts big blind $0.25
*** HOLE CARDS ***
/gJNBeCkWL4o85/jvlZ4BA: folds 
tLM9aw7T3kBEIhQEh1roOg: calls $0.25
txiWmlZ/sfM8Td16RHH/cA: calls $0.25
vu2kzHaDtgr6NM7rdq0chA: folds 
k9vn40MOqqb+xF+7GZ6v2g: folds 
MCCWc70bl051s/EF6nHRcA: checks 
*** FLOP *** [Qs 2c 2s]
MCCWc70bl051s/EF6nHRcA: checks 
tLM9aw7T3kBEIhQEh1roOg: checks 
txiWmlZ/sfM8Td16RHH/cA: checks 
*** TURN *** [Qs 2c 2s] [Ks]
MCCWc70bl051s/EF6nHRcA: checks 
tLM9aw7T3kBEIhQEh1roOg: checks 
txiWmlZ/sfM8Td16RHH/cA: bets $1
MCCWc70bl051s/EF6nHRcA: folds 
tLM9aw7T3kBEIhQEh1roOg: folds 
Uncalled bet ($1) returned to txiWmlZ/sfM8Td16RHH/cA
txiWmlZ/sfM8Td16RHH/cA collected $0.85 from pot
*** SUMMARY ***
Total pot $0.85 | Rake $0 
Board [Qs 2c 2s Ks]
Seat 1: MCCWc70bl051s/EF6nHRcA (big blind) folded on the Turn
Seat 2: /gJNBeCkWL4o85/jvlZ4BA folded before Flop (didn't bet)
Seat 3: tLM9aw7T3kBEIhQEh1roOg folded on the Turn
Seat 4: txiWmlZ/sfM8Td16RHH/cA collected ($0.85)
Seat 5: vu2kzHaDtgr6NM7rdq0chA (button) folded before Flop (didn't bet)
Seat 6: k9vn40MOqqb+xF+7GZ6v2g (small blind) folded before Flop




PokerStars Game #59941657678:  Hold'em No Limit ($0.10/$0.25) - 2009/07/01 1:42:05 ET
Table 'nQC9LRg01NEuKFHF1nrDEw0XPo7K54oZIfG0xlNAcDRw-max Seat #6 is the button
Seat 1: qf+LMbROj8/qY878wkFHbQ ($14.75 in chips) 
Seat 3: 6+g0Lb6vfRDZkElV8ieHyQ ($23.70 in chips) 
Seat 5: kG34n23qFQA3nzdOJTQ1dA ($29.05 in chips) 
Seat 6: xQVFeVUDopz+akuEo2wXpQ ($54.15 in chips) 
qf+LMbROj8/qY878wkFHbQ: posts small blind $0.10
lYjWCpfCxX2kgcHY3v4Yow: is sitting out 
6+g0Lb6vfRDZkElV8ieHyQ: posts big blind $0.25
*** HOLE CARDS ***
kG34n23qFQA3nzdOJTQ1dA: calls $0.25
lYjWCpfCxX2kgcHY3v4Yow leaves the table
xQVFeVUDopz+akuEo2wXpQ: calls $0.25
qf+LMbROj8/qY878wkFHbQ: folds 
6+g0Lb6vfRDZkElV8ieHyQ: checks 
*** FLOP *** [2c 5s 5d]
6+g0Lb6vfRDZkElV8ieHyQ: checks 
kG34n23qFQA3nzdOJTQ1dA: bets $0.50
xQVFeVUDopz+akuEo2wXpQ: folds 
6+g0Lb6vfRDZkElV8ieHyQ: folds 
Uncalled bet ($0.50) returned to kG34n23qFQA3nzdOJTQ1dA
kG34n23qFQA3nzdOJTQ1dA collected $0.85 from pot
*** SUMMARY ***
Total pot $0.85 | Rake $0 
Board [2c 5s 5d]
Seat 1: qf+LMbROj8/qY878wkFHbQ (small blind) folded before Flop
Seat 3: 6+g0Lb6vfRDZkElV8ieHyQ (big blind) folded on the Flop
Seat 5: kG34n23qFQA3nzdOJTQ1dA collected ($0.85)
Seat 6: xQVFeVUDopz+akuEo2wXpQ (button) folded on the Flop




PokerStars Game #59941657498:  Hold'em No Limit ($0.10/$0.25) - 2009/07/01 1:42:05 ET
Table 'KTZXQ4LREPjpS54R3DFTsw' 9-max Seat #8 is the button
Seat 1: dSjkBIV7Bv+ZCIWNBguf7w ($40.50 in chips) 
Seat 2: 6LFELL8V3NTpb0xg7AOyEg ($11.30 in chips) 
Seat 3: H5Se03ZqSX7tbULXur2MAg ($23.65 in chips) 
Seat 4: K0b5wNInj6hUGRr6yzKFtw ($64 in chips) 
Seat 5: HPEB+AtKw1+C/cxU0o1ciw ($30.20 in chips) 
Seat 6: Mh2r9hTeTEDnh19sRZtW3g ($5.70 in chips) 
Seat 7: yyG4svzOpC1A+sUP/scg6w ($10.95 in chips) 
Seat 8: X1ucS3BHyBPongKl1Q+eEQ ($19.10 in chips) 
Seat 9: V6p0jQ/RhUsqpHLmXvEX4Q ($12.35 in chips) 
V6p0jQ/RhUsqpHLmXvEX4Q: posts small blind $0.10
dSjkBIV7Bv+ZCIWNBguf7w: posts big blind $0.25
*** HOLE CARDS ***
6LFELL8V3NTpb0xg7AOyEg: folds 
6LFELL8V3NTpb0xg7AOyEg leaves the table
H5Se03ZqSX7tbULXur2MAg: folds 
K0b5wNInj6hUGRr6yzKFtw: folds 
HPEB+AtKw1+C/cxU0o1ciw: calls $0.25
OlPJsgR4xypSg/w1z7Gyvw joins the table at seat #2 
Mh2r9hTeTEDnh19sRZtW3g: folds 
yyG4svzOpC1A+sUP/scg6w: folds 
X1ucS3BHyBPongKl1Q+eEQ: calls $0.25
V6p0jQ/RhUsqpHLmXvEX4Q: raises $1 to $1.25
dSjkBIV7Bv+ZCIWNBguf7w: folds 
HPEB+AtKw1+C/cxU0o1ciw: folds 
X1ucS3BHyBPongKl1Q+eEQ: folds 
Uncalled bet ($1) returned to V6p0jQ/RhUsqpHLmXvEX4Q
V6p0jQ/RhUsqpHLmXvEX4Q collected $1 from pot
*** SUMMARY ***
Total pot $1 | Rake $0 
Seat 1: dSjkBIV7Bv+ZCIWNBguf7w (big blind) folded before Flop
Seat 2: 6LFELL8V3NTpb0xg7AOyEg folded before Flop (didn't bet)
Seat 3: H5Se03ZqSX7tbULXur2MAg folded before Flop (didn't bet)
Seat 4: K0b5wNInj6hUGRr6yzKFtw folded before Flop (didn't bet)
Seat 5: HPEB+AtKw1+C/cxU0o1ciw folded before Flop
Seat 6: Mh2r9hTeTEDnh19sRZtW3g folded before Flop (didn't bet)
Seat 7: yyG4svzOpC1A+sUP/scg6w folded before Flop (didn't bet)
Seat 8: X1ucS3BHyBPongKl1Q+eEQ (button) folded before Flop
Seat 9: V6p0jQ/RhUsqpHLmXvEX4Q (small blind) collected ($1)




PokerStars Game #59941658430:  Hold'em No Limit ($0.10/$0.25) - 2009/07/01 1:42:06 ET
Table '0w9m+UkNlGMNoPyQqzWk6A' 9-max Seat #4 is the button
Seat 1: yoL2UPRJrmSO7wXIS4Ak4g ($27.85 in chips) 
Seat 2: tYsOBqdU1+x+yFI7zHO7hQ ($50.05 in chips) 
Seat 3: VWwtMkIjXloiX/RKh7RGWQ ($7.40 in chips) 
Seat 4: z5GxcHlYz/GSz6W2uFiTtg ($23.15 in chips) 
Seat 5: HPEB+AtKw1+C/cxU0o1ciw ($48.80 in chips) 
Seat 6: CgIo2ItZqi4o3ayVG6HanQ ($30.65 in chips) 
Seat 7: 57qrNGHDvf6GhB8zVLsAtQ ($4.80 in chips) 
Seat 8: I+ARcuQBEroNUEjIZ2pprg ($14.35 in chips) 
Seat 9: KqS/lY/fNB9qUxokm9QfeA ($16 in chips) 
HPEB+AtKw1+C/cxU0o1ciw: posts small blind $0.10
CgIo2ItZqi4o3ayVG6HanQ: posts big blind $0.25
*** HOLE CARDS ***
57qrNGHDvf6GhB8zVLsAtQ: folds 
I+ARcuQBEroNUEjIZ2pprg: folds 
KqS/lY/fNB9qUxokm9QfeA: calls $0.25
yoL2UPRJrmSO7wXIS4Ak4g: folds 
tYsOBqdU1+x+yFI7zHO7hQ: folds 
VWwtMkIjXloiX/RKh7RGWQ: calls $0.25
z5GxcHlYz/GSz6W2uFiTtg: folds 
HPEB+AtKw1+C/cxU0o1ciw: calls $0.15
CgIo2ItZqi4o3ayVG6HanQ: checks 
*** FLOP *** [6s Kd 8c]
HPEB+AtKw1+C/cxU0o1ciw: checks 
CgIo2ItZqi4o3ayVG6HanQ: checks 
KqS/lY/fNB9qUxokm9QfeA: bets $0.75
VWwtMkIjXloiX/RKh7RGWQ: calls $0.75
HPEB+AtKw1+C/cxU0o1ciw: folds 
CgIo2ItZqi4o3ayVG6HanQ: folds 
*** TURN *** [6s Kd 8c] [2d]
KqS/lY/fNB9qUxokm9QfeA: bets $2
VWwtMkIjXloiX/RKh7RGWQ: calls $2
*** RIVER *** [6s Kd 8c 2d] [4h]
KqS/lY/fNB9qUxokm9QfeA: bets $3
VWwtMkIjXloiX/RKh7RGWQ: raises $1.40 to $4.40 and is all-in
KqS/lY/fNB9qUxokm9QfeA: calls $1.40
*** SHOW DOWN ***
VWwtMkIjXloiX/RKh7RGWQ: shows [7c 5s] (a straight, Four to Eight)
KqS/lY/fNB9qUxokm9QfeA: shows [6d 8h] (two pair, Eights and Sixes)
VWwtMkIjXloiX/RKh7RGWQ collected $14.55 from pot
*** SUMMARY ***
Total pot $15.30 | Rake $0.75 
Board [6s Kd 8c 2d 4h]
Seat 1: yoL2UPRJrmSO7wXIS4Ak4g folded before Flop (didn't bet)
Seat 2: tYsOBqdU1+x+yFI7zHO7hQ folded before Flop (didn't bet)
Seat 3: VWwtMkIjXloiX/RKh7RGWQ showed [7c 5s] and won ($14.55) with a straight, Four to Eight
Seat 4: z5GxcHlYz/GSz6W2uFiTtg (button) folded before Flop (didn't bet)
Seat 5: HPEB+AtKw1+C/cxU0o1ciw (small blind) folded on the Flop
Seat 6: CgIo2ItZqi4o3ayVG6HanQ (big blind) folded on the Flop
Seat 7: 57qrNGHDvf6GhB8zVLsAtQ folded before Flop (didn't bet)
Seat 8: I+ARcuQBEroNUEjIZ2pprg folded before Flop (didn't bet)
Seat 9: KqS/lY/fNB9qUxokm9QfeA showed [6d 8h] and lost with two pair, Eights and Sixes




PokerStars Game #59941657998:  Hold'em No Limit ($0.10/$0.25) - 2009/07/01 1:42:06 ET
Table 'tANpk8z1C5o0Pq/hpYShHw' 9-max Seat #7 is the button
Seat 1: rQhYIYXSyH/IivYM1dlV5A ($17.05 in chips) 
Seat 2: og4yH4sZUZdC8jjgW8zPJQ ($8.65 in chips) 
Seat 6: kN0AWJG6biW8tHtuF+wTjA ($14.50 in chips) 
Seat 7: aNpwfA31EREwO+ar4XzBCw ($27.30 in chips) 
Seat 9: gE5rN2TDY1aXcZn/TOPeZw ($7.55 in chips) 
Z9W7+g1WMhhZDi7DwGbCFA will be allowed to play after the button
gE5rN2TDY1aXcZn/TOPeZw: posts small blind $0.10
rQhYIYXSyH/IivYM1dlV5A: posts big blind $0.25
j4q3p0lesp63b1gZDwLBZw: sits out 
X6+pSIPfovPcE87t+LmUKQ: sits out 
*** HOLE CARDS ***
og4yH4sZUZdC8jjgW8zPJQ: calls $0.25
kN0AWJG6biW8tHtuF+wTjA: folds 
aNpwfA31EREwO+ar4XzBCw: folds 
gE5rN2TDY1aXcZn/TOPeZw: folds 
rQhYIYXSyH/IivYM1dlV5A: checks 
*** FLOP *** [Qd 8h Ks]
rQhYIYXSyH/IivYM1dlV5A: bets $0.25
og4yH4sZUZdC8jjgW8zPJQ: folds 
Uncalled bet ($0.25) returned to rQhYIYXSyH/IivYM1dlV5A
rQhYIYXSyH/IivYM1dlV5A collected $0.60 from pot
*** SUMMARY ***
Total pot $0.60 | Rake $0 
Board [Qd 8h Ks]
Seat 1: rQhYIYXSyH/IivYM1dlV5A (big blind) collected ($0.60)
Seat 2: og4yH4sZUZdC8jjgW8zPJQ folded on the Flop
Seat 6: kN0AWJG6biW8tHtuF+wTjA folded before Flop (didn't bet)
Seat 7: aNpwfA31EREwO+ar4XzBCw (button) folded before Flop (didn't bet)
Seat 9: gE5rN2TDY1aXcZn/TOPeZw (small blind) folded before Flop




PokerStars Game #59941657962:  Hold'em No Limit ($0.10/$0.25) - 2009/07/01 1:42:06 ET
Table '4UJB/UOZ5aepyF2v+hIoUg' 6-max Seat #6 is the button
Seat 1: 08V++DOqzaNrRNsHIwi25w ($26.85 in chips) 
Seat 2: mFv3iBCtrw9XfCDRB0d46Q ($3.95 in chips) 
Seat 3: zlYHXTtJ5tcx9kwK2h5n9A ($38.90 in chips) 
Seat 4: R6AGToFJQOYVZAjC2jXEKw ($23.15 in chips) 
Seat 5: 3zD3qLXT1bEffAoWGnc7wg ($25.90 in chips) 
Seat 6: 2aphcinkTZT0B0Uoah6cvQ ($17.85 in chips) 
08V++DOqzaNrRNsHIwi25w: posts small blind $0.10
mFv3iBCtrw9XfCDRB0d46Q: posts big blind $0.25
*** HOLE CARDS ***
zlYHXTtJ5tcx9kwK2h5n9A: calls $0.25
R6AGToFJQOYVZAjC2jXEKw: folds 
3zD3qLXT1bEffAoWGnc7wg: folds 
2aphcinkTZT0B0Uoah6cvQ: calls $0.25
08V++DOqzaNrRNsHIwi25w: calls $0.15
mFv3iBCtrw9XfCDRB0d46Q: checks 
*** FLOP *** [8h 4d 3h]
08V++DOqzaNrRNsHIwi25w: checks 
mFv3iBCtrw9XfCDRB0d46Q: checks 
zlYHXTtJ5tcx9kwK2h5n9A: checks 
2aphcinkTZT0B0Uoah6cvQ: checks 
*** TURN *** [8h 4d 3h] [Qd]
08V++DOqzaNrRNsHIwi25w: checks 
mFv3iBCtrw9XfCDRB0d46Q: bets $0.50
zlYHXTtJ5tcx9kwK2h5n9A: folds 
2aphcinkTZT0B0Uoah6cvQ: folds 
08V++DOqzaNrRNsHIwi25w: folds 
Uncalled bet ($0.50) returned to mFv3iBCtrw9XfCDRB0d46Q
mFv3iBCtrw9XfCDRB0d46Q collected $0.95 from pot
mFv3iBCtrw9XfCDRB0d46Q: doesn't show hand 
*** SUMMARY ***
Total pot $1 | Rake $0.05 
Board [8h 4d 3h Qd]
Seat 1: 08V++DOqzaNrRNsHIwi25w (small blind) folded on the Turn
Seat 2: mFv3iBCtrw9XfCDRB0d46Q (big blind) collected ($0.95)
Seat 3: zlYHXTtJ5tcx9kwK2h5n9A folded on the Turn
Seat 4: R6AGToFJQOYVZAjC2jXEKw folded before Flop (didn't bet)
Seat 5: 3zD3qLXT1bEffAoWGnc7wg folded before Flop (didn't bet)
Seat 6: 2aphcinkTZT0B0Uoah6cvQ (button) folded on the Turn




PokerStars Game #59941658240:  Hold'em No Limit ($0.10/$0.25) - 2009/07/01 1:42:06 ET
Table '3Ns9nuTkynfwbBfBXzg6ww' 6-max Seat #5 is the button
Seat 1: epAUIB7h2FJXzUPRIvSkRA ($25 in chips) 
Seat 2: zxeVQGaMKDsDzmSY+AInjA ($33.35 in chips) 
Seat 3: eL3+wCBjFGfQ5FMdIZihwA ($24.65 in chips) 
Seat 4: qGHGf/553gQnDoklMRe3tg ($30.95 in chips) 
Seat 5: wqphQtauX5Qn7WRJZS1flA ($25.65 in chips) 
Seat 6: DE9hRlt14g+JdsRQ4wT7hg ($35.80 in chips) 
DE9hRlt14g+JdsRQ4wT7hg: posts small blind $0.10
epAUIB7h2FJXzUPRIvSkRA: posts big blind $0.25
*** HOLE CARDS ***
zxeVQGaMKDsDzmSY+AInjA: raises $0.75 to $1
eL3+wCBjFGfQ5FMdIZihwA: folds 
qGHGf/553gQnDoklMRe3tg: folds 
wqphQtauX5Qn7WRJZS1flA: folds 
DE9hRlt14g+JdsRQ4wT7hg: folds 
epAUIB7h2FJXzUPRIvSkRA: folds 
Uncalled bet ($0.75) returned to zxeVQGaMKDsDzmSY+AInjA
zxeVQGaMKDsDzmSY+AInjA collected $0.60 from pot
zxeVQGaMKDsDzmSY+AInjA: doesn't show hand 
*** SUMMARY ***
Total pot $0.60 | Rake $0 
Seat 1: epAUIB7h2FJXzUPRIvSkRA (big blind) folded before Flop
Seat 2: zxeVQGaMKDsDzmSY+AInjA collected ($0.60)
Seat 3: eL3+wCBjFGfQ5FMdIZihwA folded before Flop (didn't bet)
Seat 4: qGHGf/553gQnDoklMRe3tg folded before Flop (didn't bet)
Seat 5: wqphQtauX5Qn7WRJZS1flA (button) folded before Flop (didn't bet)
Seat 6: DE9hRlt14g+JdsRQ4wT7hg (small blind) folded before Flop




PokerStars Game #59941658028:  Hold'em No Limit ($0.10/$0.25) - 2009/07/01 1:42:06 ET
Table 'APEHQjIcZHDZUA4iOjju2g' 6-max Seat #5 is the button
Seat 1: DE9hRlt14g+JdsRQ4wT7hg ($25.35 in chips) 
Seat 2: 3zD3qLXT1bEffAoWGnc7wg ($36.60 in chips) 
Seat 3: 3e/idKqDuPE10t6Zvr//SQ ($24.65 in chips) 
Seat 4: w2mQ4VsGljGwWXydz8tw2A ($37.40 in chips) 
Seat 5: /xN6gc9+8Hew0HxaB6VIVg ($43.55 in chips) 
Seat 6: KXtdqb+rIMkjc0RvHDksGQ ($26.05 in chips) 
KXtdqb+rIMkjc0RvHDksGQ: posts small blind $0.10
DE9hRlt14g+JdsRQ4wT7hg: posts big blind $0.25
*** HOLE CARDS ***
3zD3qLXT1bEffAoWGnc7wg: folds 
3e/idKqDuPE10t6Zvr//SQ: folds 
w2mQ4VsGljGwWXydz8tw2A: calls $0.25
/xN6gc9+8Hew0HxaB6VIVg: folds 
KXtdqb+rIMkjc0RvHDksGQ: folds 
DE9hRlt14g+JdsRQ4wT7hg: checks 
*** FLOP *** [8h Ks 6h]
DE9hRlt14g+JdsRQ4wT7hg: checks 
w2mQ4VsGljGwWXydz8tw2A: bets $0.75
DE9hRlt14g+JdsRQ4wT7hg: folds 
Uncalled bet ($0.75) returned to w2mQ4VsGljGwWXydz8tw2A
w2mQ4VsGljGwWXydz8tw2A collected $0.60 from pot
*** SUMMARY ***
Total pot $0.60 | Rake $0 
Board [8h Ks 6h]
Seat 1: DE9hRlt14g+JdsRQ4wT7hg (big blind) folded on the Flop
Seat 2: 3zD3qLXT1bEffAoWGnc7wg folded before Flop (didn't bet)
Seat 3: 3e/idKqDuPE10t6Zvr//SQ folded before Flop (didn't bet)
Seat 4: w2mQ4VsGljGwWXydz8tw2A collected ($0.60)
Seat 5: /xN6gc9+8Hew0HxaB6VIVg (button) folded before Flop (didn't bet)
Seat 6: KXtdqb+rIMkjc0RvHDksGQ (small blind) folded before Flop




PokerStars Game #59941658968:  Hold'em No Limit ($0.10/$0.25) - 2009/07/01 1:42:07 ET
Table 'nc6OeGk/wtaWV+6N+kgnZQ' 6-max Seat #5 is the button
Seat 1: tSR4329m40dZsN7YOpI9Kw ($39.15 in chips) 
Seat 2: 8ClCHtFXGNplITm+63KB+Q ($35.10 in chips) 
Seat 3: y8wpMWGSX2zHZijurx21mg ($6.60 in chips) 
Seat 4: 3zD3qLXT1bEffAoWGnc7wg ($29.95 in chips) 
Seat 5: HCS0lMAAPmZE2Tl8J/SuKw ($11.70 in chips) 
Seat 6: mFv3iBCtrw9XfCDRB0d46Q ($2.70 in chips) 
mFv3iBCtrw9XfCDRB0d46Q: posts small blind $0.10
tSR4329m40dZsN7YOpI9Kw: posts big blind $0.25
*** HOLE CARDS ***
8ClCHtFXGNplITm+63KB+Q: folds 
y8wpMWGSX2zHZijurx21mg: folds 
3zD3qLXT1bEffAoWGnc7wg: folds 
HCS0lMAAPmZE2Tl8J/SuKw: calls $0.25
mFv3iBCtrw9XfCDRB0d46Q: raises $2.45 to $2.70 and is all-in
tSR4329m40dZsN7YOpI9Kw: folds 
HCS0lMAAPmZE2Tl8J/SuKw: folds 
Uncalled bet ($2.45) returned to mFv3iBCtrw9XfCDRB0d46Q
mFv3iBCtrw9XfCDRB0d46Q collected $0.75 from pot
mFv3iBCtrw9XfCDRB0d46Q: doesn't show hand 
*** SUMMARY ***
Total pot $0.75 | Rake $0 
Seat 1: tSR4329m40dZsN7YOpI9Kw (big blind) folded before Flop
Seat 2: 8ClCHtFXGNplITm+63KB+Q folded before Flop (didn't bet)
Seat 3: y8wpMWGSX2zHZijurx21mg folded before Flop (didn't bet)
Seat 4: 3zD3qLXT1bEffAoWGnc7wg folded before Flop (didn't bet)
Seat 5: HCS0lMAAPmZE2Tl8J/SuKw (button) folded before Flop
Seat 6: mFv3iBCtrw9XfCDRB0d46Q (small blind) collected ($0.75)




PokerStars Game #59941658668:  Hold'em No Limit ($0.10/$0.25) - 2009/07/01 1:42:07 ET
Table 'edvgY2YQ1I34euq4EVqGnA' 6-max Seat #2 is the button
Seat 1: mvFHK3pE7tCxJEqLjKC70Q ($25.25 in chips) 
Seat 2: SxIIgwXYLkwd6m3wLyPTCw ($15.90 in chips) 
Seat 3: mFv3iBCtrw9XfCDRB0d46Q ($3.65 in chips) 
Seat 4: TI/C5Q+DEl4fLR3AofwYdg ($19.15 in chips) 
Seat 5: EE16Ua5b1HSsYej5zeXOlA ($56.45 in chips) 
Seat 6: kG34n23qFQA3nzdOJTQ1dA ($72.35 in chips) 
mFv3iBCtrw9XfCDRB0d46Q: posts small blind $0.10
TI/C5Q+DEl4fLR3AofwYdg: posts big blind $0.25
*** HOLE CARDS ***
EE16Ua5b1HSsYej5zeXOlA: folds 
kG34n23qFQA3nzdOJTQ1dA: folds 
mvFHK3pE7tCxJEqLjKC70Q: folds 
SxIIgwXYLkwd6m3wLyPTCw: folds 
mFv3iBCtrw9XfCDRB0d46Q: folds 
Uncalled bet ($0.15) returned to TI/C5Q+DEl4fLR3AofwYdg
TI/C5Q+DEl4fLR3AofwYdg collected $0.20 from pot
TI/C5Q+DEl4fLR3AofwYdg: doesn't show hand 
*** SUMMARY ***
Total pot $0.20 | Rake $0 
Seat 1: mvFHK3pE7tCxJEqLjKC70Q folded before Flop (didn't bet)
Seat 2: SxIIgwXYLkwd6m3wLyPTCw (button) folded before Flop (didn't bet)
Seat 3: mFv3iBCtrw9XfCDRB0d46Q (small blind) folded before Flop
Seat 4: TI/C5Q+DEl4fLR3AofwYdg (big blind) collected ($0.20)
Seat 5: EE16Ua5b1HSsYej5zeXOlA folded before Flop (didn't bet)
Seat 6: kG34n23qFQA3nzdOJTQ1dA folded before Flop (didn't bet)




PokerStars Game #59941658788:  Hold'em No Limit ($0.10/$0.25) - 2009/07/01 1:42:07 ET
Table 'biAgO3TKQBU8XcrVAoU5TA' 6-max Seat #2 is the button
Seat 1: jhDPlkir8wBYAddboBuF7Q ($17.30 in chips) 
Seat 2: GbCVUNssQ7mqsPWr7J4d3w ($5.30 in chips) 
Seat 3: mfrkWA3PTeYPkbO6hi98Aw ($30.40 in chips) 
Seat 4: Hsvkc0/G2VV78oVmWYXecw ($5 in chips) 
Seat 5: n6UPMnVR4v8LFP0rWP73Fg ($12.20 in chips) 
Seat 6: wMiE3yTbDJGOLOF9th7KPA ($9.35 in chips) 
mfrkWA3PTeYPkbO6hi98Aw: posts small blind $0.10
Hsvkc0/G2VV78oVmWYXecw: posts big blind $0.25
*** HOLE CARDS ***
n6UPMnVR4v8LFP0rWP73Fg: folds 
wMiE3yTbDJGOLOF9th7KPA: calls $0.25
jhDPlkir8wBYAddboBuF7Q: calls $0.25
GbCVUNssQ7mqsPWr7J4d3w: folds 
mfrkWA3PTeYPkbO6hi98Aw: calls $0.15
Hsvkc0/G2VV78oVmWYXecw: checks 
*** FLOP *** [4d 2c 8c]
mfrkWA3PTeYPkbO6hi98Aw: bets $0.75
Hsvkc0/G2VV78oVmWYXecw: folds 
wMiE3yTbDJGOLOF9th7KPA: calls $0.75
jhDPlkir8wBYAddboBuF7Q: folds 
*** TURN *** [4d 2c 8c] [4c]
mfrkWA3PTeYPkbO6hi98Aw: bets $2
wMiE3yTbDJGOLOF9th7KPA: folds 
Uncalled bet ($2) returned to mfrkWA3PTeYPkbO6hi98Aw
mfrkWA3PTeYPkbO6hi98Aw collected $2.40 from pot
mfrkWA3PTeYPkbO6hi98Aw: doesn't show hand 
*** SUMMARY ***
Total pot $2.50 | Rake $0.10 
Board [4d 2c 8c 4c]
Seat 1: jhDPlkir8wBYAddboBuF7Q folded on the Flop
Seat 2: GbCVUNssQ7mqsPWr7J4d3w (button) folded before Flop (didn't bet)
Seat 3: mfrkWA3PTeYPkbO6hi98Aw (small blind) collected ($2.40)
Seat 4: Hsvkc0/G2VV78oVmWYXecw (big blind) folded on the Flop
Seat 5: n6UPMnVR4v8LFP0rWP73Fg folded before Flop (didn't bet)
Seat 6: wMiE3yTbDJGOLOF9th7KPA folded on the Turn




PokerStars Game #59941658656:  Hold'em No Limit ($0.10/$0.25) - 2009/07/01 1:42:07 ET
Table '2vH5RcmkT0F4XNS/EmmyMA' 6-max Seat #1 is the button
Seat 1: hOaWAImn5/MZDAWAPlYHCw ($6.50 in chips) 
Seat 2: W6Y6au0wf7gRAlqJYgOezw ($12.85 in chips) 
Seat 3: t8P79jKZYh/Wpx2V73pSqg ($30.25 in chips) 
Seat 4: FC6tJ9EOiutXO8hnpR4VgQ ($5 in chips) 
Seat 5: Hsvkc0/G2VV78oVmWYXecw ($5 in chips) 
Seat 6: if4dh6jhJXeN3/qd3qCp9g ($25 in chips) 
W6Y6au0wf7gRAlqJYgOezw: posts small blind $0.10
t8P79jKZYh/Wpx2V73pSqg: posts big blind $0.25
*** HOLE CARDS ***
FC6tJ9EOiutXO8hnpR4VgQ: raises $0.75 to $1
Hsvkc0/G2VV78oVmWYXecw: folds 
if4dh6jhJXeN3/qd3qCp9g: folds 
hOaWAImn5/MZDAWAPlYHCw: folds 
W6Y6au0wf7gRAlqJYgOezw: calls $0.90
t8P79jKZYh/Wpx2V73pSqg: folds 
*** FLOP *** [Kd 9d 7h]
W6Y6au0wf7gRAlqJYgOezw: checks 
FC6tJ9EOiutXO8hnpR4VgQ: checks 
*** TURN *** [Kd 9d 7h] [Tc]
W6Y6au0wf7gRAlqJYgOezw: checks 
FC6tJ9EOiutXO8hnpR4VgQ: checks 
*** RIVER *** [Kd 9d 7h Tc] [Kh]
W6Y6au0wf7gRAlqJYgOezw: checks 
FC6tJ9EOiutXO8hnpR4VgQ: checks 
*** SHOW DOWN ***
W6Y6au0wf7gRAlqJYgOezw: shows [5d Jd] (a pair of Kings)
FC6tJ9EOiutXO8hnpR4VgQ: shows [Ah Js] (a pair of Kings - Ace kicker)
FC6tJ9EOiutXO8hnpR4VgQ collected $2.15 from pot
*** SUMMARY ***
Total pot $2.25 | Rake $0.10 
Board [Kd 9d 7h Tc Kh]
Seat 1: hOaWAImn5/MZDAWAPlYHCw (button) folded before Flop (didn't bet)
Seat 2: W6Y6au0wf7gRAlqJYgOezw (small blind) showed [5d Jd] and lost with a pair of Kings
Seat 3: t8P79jKZYh/Wpx2V73pSqg (big blind) folded before Flop
Seat 4: FC6tJ9EOiutXO8hnpR4VgQ showed [Ah Js] and won ($2.15) with a pair of Kings
Seat 5: Hsvkc0/G2VV78oVmWYXecw folded before Flop (didn't bet)
Seat 6: if4dh6jhJXeN3/qd3qCp9g folded before Flop (didn't bet)




PokerStars Game #59941658814:  Hold'em No Limit ($0.10/$0.25) - 2009/07/01 1:42:07 ET
Table 'dNYnr4D4id1jwnEU66Yowg' 9-max Seat #8 is the button
Seat 1: 9lvO/qyU+xrU95Teu1fv0g ($4.75 in chips) 
Seat 2: Qduu7ikeizo6q6Ei9YvcJA ($25 in chips) 
Seat 4: VBHxUExRAMrbxUq/cVx9Gw ($4.95 in chips) 
Seat 5: 7cv+9Zc9HIQHNvYsMfV3uA ($26.05 in chips) 
Seat 6: 8EbrQ/EvFWt2cr0GaU82gQ ($4.65 in chips) 
Seat 7: DiSvPC2iudwL5j9u6Huyww ($25.45 in chips) 
Seat 8: RCqMONFrSPSArZh2Jsar/w ($22.45 in chips) 
/FE4MKSoQhXaDp4PBoLM2g will be allowed to play after the button
9lvO/qyU+xrU95Teu1fv0g: posts small blind $0.10
Qduu7ikeizo6q6Ei9YvcJA: posts big blind $0.25
IOx4EH8+y3jYZJc/LTRvOw: sits out 
*** HOLE CARDS ***
VBHxUExRAMrbxUq/cVx9Gw: folds 
7cv+9Zc9HIQHNvYsMfV3uA: raises $0.75 to $1
8EbrQ/EvFWt2cr0GaU82gQ: folds 
DiSvPC2iudwL5j9u6Huyww: folds 
RCqMONFrSPSArZh2Jsar/w: calls $1
9lvO/qyU+xrU95Teu1fv0g: folds 
Qduu7ikeizo6q6Ei9YvcJA: folds 
*** FLOP *** [6d 2s 4h]
7cv+9Zc9HIQHNvYsMfV3uA: bets $1.50
RCqMONFrSPSArZh2Jsar/w: calls $1.50
*** TURN *** [6d 2s 4h] [5s]
7cv+9Zc9HIQHNvYsMfV3uA: bets $4
RCqMONFrSPSArZh2Jsar/w: calls $4
*** RIVER *** [6d 2s 4h 5s] [4s]
7cv+9Zc9HIQHNvYsMfV3uA: checks 
RCqMONFrSPSArZh2Jsar/w: bets $6
7cv+9Zc9HIQHNvYsMfV3uA: calls $6
*** SHOW DOWN ***
RCqMONFrSPSArZh2Jsar/w: shows [As Qs] (a flush, Ace high)
7cv+9Zc9HIQHNvYsMfV3uA: mucks hand 
RCqMONFrSPSArZh2Jsar/w collected $24.15 from pot
*** SUMMARY ***
Total pot $25.35 | Rake $1.20 
Board [6d 2s 4h 5s 4s]
Seat 1: 9lvO/qyU+xrU95Teu1fv0g (small blind) folded before Flop
Seat 2: Qduu7ikeizo6q6Ei9YvcJA (big blind) folded before Flop
Seat 4: VBHxUExRAMrbxUq/cVx9Gw folded before Flop (didn't bet)
Seat 5: 7cv+9Zc9HIQHNvYsMfV3uA mucked
Seat 6: 8EbrQ/EvFWt2cr0GaU82gQ folded before Flop (didn't bet)
Seat 7: DiSvPC2iudwL5j9u6Huyww folded before Flop (didn't bet)
Seat 8: RCqMONFrSPSArZh2Jsar/w (button) showed [As Qs] and won ($24.15) with a flush, Ace high




PokerStars Game #59941658760:  Hold'em No Limit ($0.10/$0.25) - 2009/07/01 1:42:07 ET
Table '+fuYjvJy9okLr23QyZtanA' 9-max Seat #7 is the button
Seat 1: l9hUFnOCgg4TPYga9bvxhw ($10.70 in chips) 
Seat 2: tLcDklc2rBORNfixyRfVfw ($25.10 in chips) 
Seat 3: eK8qa6EPcH2zhtbmWSvc9g ($52.65 in chips) 
Seat 4: Bb42QRQMhg5/Y0vHP8/2Xw ($30.50 in chips) 
Seat 5: bXpVeaSTPBFSPJmeXxO7nw ($4.65 in chips) 
Seat 6: wGigCmBR/9XWkPpvYos3aQ ($26.15 in chips) 
Seat 7: dfNim92Z6XK1/h5SFW5vDg ($26.55 in chips) 
Seat 9: OMhlmt2waO3z43ZSFNMmog ($28.90 in chips) 
KqS/lY/fNB9qUxokm9QfeA will be allowed to play after the button
OMhlmt2waO3z43ZSFNMmog: posts small blind $0.10
l9hUFnOCgg4TPYga9bvxhw: posts big blind $0.25
*** HOLE CARDS ***
tLcDklc2rBORNfixyRfVfw: folds 
eK8qa6EPcH2zhtbmWSvc9g: folds 
Bb42QRQMhg5/Y0vHP8/2Xw: folds 
bXpVeaSTPBFSPJmeXxO7nw: folds 
wGigCmBR/9XWkPpvYos3aQ: folds 
dfNim92Z6XK1/h5SFW5vDg: folds 
OMhlmt2waO3z43ZSFNMmog: folds 
Uncalled bet ($0.15) returned to l9hUFnOCgg4TPYga9bvxhw
l9hUFnOCgg4TPYga9bvxhw collected $0.20 from pot
l9hUFnOCgg4TPYga9bvxhw: doesn't show hand 
*** SUMMARY ***
Total pot $0.20 | Rake $0 
Seat 1: l9hUFnOCgg4TPYga9bvxhw (big blind) collected ($0.20)
Seat 2: tLcDklc2rBORNfixyRfVfw folded before Flop (didn't bet)
Seat 3: eK8qa6EPcH2zhtbmWSvc9g folded before Flop (didn't bet)
Seat 4: Bb42QRQMhg5/Y0vHP8/2Xw folded before Flop (didn't bet)
Seat 5: bXpVeaSTPBFSPJmeXxO7nw folded before Flop (didn't bet)
Seat 6: wGigCmBR/9XWkPpvYos3aQ folded before Flop (didn't bet)
Seat 7: dfNim92Z6XK1/h5SFW5vDg (button) folded before Flop (didn't bet)
Seat 9: OMhlmt2waO3z43ZSFNMmog (small blind) folded before Flop




PokerStars Game #59941658870:  Hold'em No Limit ($0.10/$0.25) - 2009/07/01 1:42:07 ET
Table 'hOE09W281uSob0XeJmUcRg' 6-max Seat #3 is the button
Seat 1: mfrkWA3PTeYPkbO6hi98Aw ($27.65 in chips) 
Seat 2: lYjWCpfCxX2kgcHY3v4Yow ($28.50 in chips) 
Seat 3: y+a/yGW/Jy4bPJFnaeTz5w ($14.10 in chips) 
Seat 5: JFIAqU8lCZ0vWwEl4bdGsg ($25 in chips) 
Seat 6: x4ZJ8E/TUrtoB7WiHcv8WA ($14.25 in chips) 
JFIAqU8lCZ0vWwEl4bdGsg: posts small blind $0.10
x4ZJ8E/TUrtoB7WiHcv8WA: posts big blind $0.25
*** HOLE CARDS ***
mfrkWA3PTeYPkbO6hi98Aw: folds 
lYjWCpfCxX2kgcHY3v4Yow: raises $0.75 to $1
y+a/yGW/Jy4bPJFnaeTz5w: folds 
JFIAqU8lCZ0vWwEl4bdGsg: folds 
x4ZJ8E/TUrtoB7WiHcv8WA: folds 
Uncalled bet ($0.75) returned to lYjWCpfCxX2kgcHY3v4Yow
lYjWCpfCxX2kgcHY3v4Yow collected $0.60 from pot
lYjWCpfCxX2kgcHY3v4Yow: doesn't show hand 
*** SUMMARY ***
Total pot $0.60 | Rake $0 
Seat 1: mfrkWA3PTeYPkbO6hi98Aw folded before Flop (didn't bet)
Seat 2: lYjWCpfCxX2kgcHY3v4Yow collected ($0.60)
Seat 3: y+a/yGW/Jy4bPJFnaeTz5w (button) folded before Flop (didn't bet)
Seat 5: JFIAqU8lCZ0vWwEl4bdGsg (small blind) folded before Flop
Seat 6: x4ZJ8E/TUrtoB7WiHcv8WA (big blind) folded before Flop




PokerStars Game #59941658966:  Hold'em No Limit ($0.10/$0.25) - 2009/07/01 1:42:07 ET
Table 'h02LhQ7B/Zk4ETRxxHhGYA' 9-max Seat #5 is the button
Seat 1: sD+TKtt36XiiN6jqHiLwDA ($25.25 in chips) 
Seat 2: 9lvO/qyU+xrU95Teu1fv0g ($6.30 in chips) 
Seat 3: arxNSjreDRGFg13EAM2F1w ($25 in chips) 
Seat 4: tYsOBqdU1+x+yFI7zHO7hQ ($38.10 in chips) 
Seat 5: cUxk0Jk4lrUQv9CJl0LPlg ($28 in chips) 
Seat 6: UvM6sxFT7el5hVDehvWvTA ($33.15 in chips) 
Seat 7: y7w8+Oqq4SkI1dkRDCx2Zg ($3.85 in chips) 
Seat 8: mUoFJKqCzIUABvOFbiINlQ ($14.50 in chips) 
Seat 9: MgzS9dEPzsGYQW57RteFhw ($7.40 in chips) 
UvM6sxFT7el5hVDehvWvTA: posts small blind $0.10
y7w8+Oqq4SkI1dkRDCx2Zg: posts big blind $0.25
*** HOLE CARDS ***
mUoFJKqCzIUABvOFbiINlQ: calls $0.25
MgzS9dEPzsGYQW57RteFhw: folds 
sD+TKtt36XiiN6jqHiLwDA: folds 
9lvO/qyU+xrU95Teu1fv0g: folds 
arxNSjreDRGFg13EAM2F1w: calls $0.25
tYsOBqdU1+x+yFI7zHO7hQ: folds 
cUxk0Jk4lrUQv9CJl0LPlg: folds 
UvM6sxFT7el5hVDehvWvTA: calls $0.15
y7w8+Oqq4SkI1dkRDCx2Zg: checks 
*** FLOP *** [Ts Ad 8h]
UvM6sxFT7el5hVDehvWvTA: checks 
y7w8+Oqq4SkI1dkRDCx2Zg: checks 
mUoFJKqCzIUABvOFbiINlQ: checks 
arxNSjreDRGFg13EAM2F1w: checks 
*** TURN *** [Ts Ad 8h] [Tc]
UvM6sxFT7el5hVDehvWvTA: checks 
y7w8+Oqq4SkI1dkRDCx2Zg: checks 
mUoFJKqCzIUABvOFbiINlQ: checks 
arxNSjreDRGFg13EAM2F1w: checks 
*** RIVER *** [Ts Ad 8h Tc] [2h]
UvM6sxFT7el5hVDehvWvTA: bets $1
y7w8+Oqq4SkI1dkRDCx2Zg: folds 
mUoFJKqCzIUABvOFbiINlQ: folds 
arxNSjreDRGFg13EAM2F1w: folds 
Uncalled bet ($1) returned to UvM6sxFT7el5hVDehvWvTA
UvM6sxFT7el5hVDehvWvTA collected $0.95 from pot
UvM6sxFT7el5hVDehvWvTA: doesn't show hand 
*** SUMMARY ***
Total pot $1 | Rake $0.05 
Board [Ts Ad 8h Tc 2h]
Seat 1: sD+TKtt36XiiN6jqHiLwDA folded before Flop (didn't bet)
Seat 2: 9lvO/qyU+xrU95Teu1fv0g folded before Flop (didn't bet)
Seat 3: arxNSjreDRGFg13EAM2F1w folded on the River
Seat 4: tYsOBqdU1+x+yFI7zHO7hQ folded before Flop (didn't bet)
Seat 5: cUxk0Jk4lrUQv9CJl0LPlg (button) folded before Flop (didn't bet)
Seat 6: UvM6sxFT7el5hVDehvWvTA (small blind) collected ($0.95)
Seat 7: y7w8+Oqq4SkI1dkRDCx2Zg (big blind) folded on the River
Seat 8: mUoFJKqCzIUABvOFbiINlQ folded on the River
Seat 9: MgzS9dEPzsGYQW57RteFhw folded before Flop (didn't bet)




PokerStars Game #59941658452:  Hold'em No Limit ($0.10/$0.25) - 2009/07/01 1:42:07 ET
Table '3eK1r4Q4BSYFvsKkuTLpIA' 9-max Seat #9 is the button
Seat 1: vSkQm2EelzwRGDDQQk0Fqw ($4.40 in chips) 
Seat 2: aNpwfA31EREwO+ar4XzBCw ($27.75 in chips) 
Seat 3: 56S3mA6Zs3pGR+0p0vUCtg ($31.55 in chips) 
Seat 4: +2kMBNpY4nF1qNCRd8SJLA ($25 in chips) 
Seat 5: 775TiRJajPtN/ucpTmHrXA ($14.75 in chips) 
Seat 6: +HvCCmsGSQeatf+GZ9zk8Q ($39.20 in chips) 
Seat 7: ljemhp25Zg+nlA9DLCIiUw ($25 in chips) 
Seat 8: /29aHLC+Q6KCDcNv2bPfAg ($12.80 in chips) 
Seat 9: +sbyWwIcFp9kP0bDtMegfQ ($60.40 in chips) 
vSkQm2EelzwRGDDQQk0Fqw: posts small blind $0.10
aNpwfA31EREwO+ar4XzBCw: posts big blind $0.25
*** HOLE CARDS ***
56S3mA6Zs3pGR+0p0vUCtg: raises $1 to $1.25
+2kMBNpY4nF1qNCRd8SJLA: folds 
775TiRJajPtN/ucpTmHrXA: folds 
+HvCCmsGSQeatf+GZ9zk8Q: calls $1.25
ljemhp25Zg+nlA9DLCIiUw: folds 
/29aHLC+Q6KCDcNv2bPfAg: folds 
+sbyWwIcFp9kP0bDtMegfQ: folds 
vSkQm2EelzwRGDDQQk0Fqw: folds 
aNpwfA31EREwO+ar4XzBCw: folds 
*** FLOP *** [Ts 3d 7s]
56S3mA6Zs3pGR+0p0vUCtg: bets $1.25
+HvCCmsGSQeatf+GZ9zk8Q: calls $1.25
*** TURN *** [Ts 3d 7s] [5c]
56S3mA6Zs3pGR+0p0vUCtg: checks 
+HvCCmsGSQeatf+GZ9zk8Q: bets $2.25
56S3mA6Zs3pGR+0p0vUCtg: raises $4 to $6.25
+HvCCmsGSQeatf+GZ9zk8Q: folds 
Uncalled bet ($4) returned to 56S3mA6Zs3pGR+0p0vUCtg
+HvCCmsGSQeatf+GZ9zk8Q said, "show"
56S3mA6Zs3pGR+0p0vUCtg collected $9.40 from pot
56S3mA6Zs3pGR+0p0vUCtg: doesn't show hand 
*** SUMMARY ***
Total pot $9.85 | Rake $0.45 
Board [Ts 3d 7s 5c]
Seat 1: vSkQm2EelzwRGDDQQk0Fqw (small blind) folded before Flop
Seat 2: aNpwfA31EREwO+ar4XzBCw (big blind) folded before Flop
Seat 3: 56S3mA6Zs3pGR+0p0vUCtg collected ($9.40)
Seat 4: +2kMBNpY4nF1qNCRd8SJLA folded before Flop (didn't bet)
Seat 5: 775TiRJajPtN/ucpTmHrXA folded before Flop (didn't bet)
Seat 6: +HvCCmsGSQeatf+GZ9zk8Q folded on the Turn
Seat 7: ljemhp25Zg+nlA9DLCIiUw folded before Flop (didn't bet)
Seat 8: /29aHLC+Q6KCDcNv2bPfAg folded before Flop (didn't bet)
Seat 9: +sbyWwIcFp9kP0bDtMegfQ (button) folded before Flop (didn't bet)




PokerStars Game #59941658794:  Hold'em No Limit ($0.10/$0.25) - 2009/07/01 1:42:07 ET
Table '50f2Xa1b1jp6cfdTAgXFIg' 9-max Seat #4 is the button
Seat 1: pplNliE3WonjkPRf+GZq2A ($28.05 in chips) 
Seat 2: qxWFg3MZuVyidB0SJh5ywg ($29.95 in chips) 
Seat 3: RSojRXQHk0IRANbJYopT9g ($23.65 in chips) 
Seat 4: ghNKXUBl/H+t83JF079ZBA ($28.10 in chips) 
Seat 5: C1w4aCCgQVVSgNijoEahAg ($10.25 in chips) 
Seat 6: tLcDklc2rBORNfixyRfVfw ($25 in chips) 
Seat 7: w1ukf8uPa4+WH561TtVRxA ($25 in chips) 
Seat 8: x+W5+3qsdY4Iszf0hoH+Aw ($14.90 in chips) 
Seat 9: gehe91e0IyVT0QU/XBkEyg ($25.15 in chips) 
C1w4aCCgQVVSgNijoEahAg: posts small blind $0.10
tLcDklc2rBORNfixyRfVfw: posts big blind $0.25
*** HOLE CARDS ***
w1ukf8uPa4+WH561TtVRxA: folds 
x+W5+3qsdY4Iszf0hoH+Aw: folds 
gehe91e0IyVT0QU/XBkEyg: folds 
pplNliE3WonjkPRf+GZq2A: folds 
qxWFg3MZuVyidB0SJh5ywg: folds 
RSojRXQHk0IRANbJYopT9g: raises $0.50 to $0.75
ghNKXUBl/H+t83JF079ZBA: folds 
C1w4aCCgQVVSgNijoEahAg: calls $0.65
tLcDklc2rBORNfixyRfVfw: folds 
*** FLOP *** [3h 5h Jc]
C1w4aCCgQVVSgNijoEahAg: checks 
RSojRXQHk0IRANbJYopT9g: bets $0.50
C1w4aCCgQVVSgNijoEahAg: calls $0.50
*** TURN *** [3h 5h Jc] [Th]
C1w4aCCgQVVSgNijoEahAg: checks 
RSojRXQHk0IRANbJYopT9g: checks 
*** RIVER *** [3h 5h Jc Th] [7s]
C1w4aCCgQVVSgNijoEahAg: checks 
RSojRXQHk0IRANbJYopT9g: checks 
*** SHOW DOWN ***
C1w4aCCgQVVSgNijoEahAg: shows [5d Qs] (a pair of Fives)
RSojRXQHk0IRANbJYopT9g: mucks hand 
C1w4aCCgQVVSgNijoEahAg collected $2.65 from pot
*** SUMMARY ***
Total pot $2.75 | Rake $0.10 
Board [3h 5h Jc Th 7s]
Seat 1: pplNliE3WonjkPRf+GZq2A folded before Flop (didn't bet)
Seat 2: qxWFg3MZuVyidB0SJh5ywg folded before Flop (didn't bet)
Seat 3: RSojRXQHk0IRANbJYopT9g mucked
Seat 4: ghNKXUBl/H+t83JF079ZBA (button) folded before Flop (didn't bet)
Seat 5: C1w4aCCgQVVSgNijoEahAg (small blind) showed [5d Qs] and won ($2.65) with a pair of Fives
Seat 6: tLcDklc2rBORNfixyRfVfw (big blind) folded before Flop
Seat 7: w1ukf8uPa4+WH561TtVRxA folded before Flop (didn't bet)
Seat 8: x+W5+3qsdY4Iszf0hoH+Aw folded before Flop (didn't bet)
Seat 9: gehe91e0IyVT0QU/XBkEyg folded before Flop (didn't bet)




PokerStars Game #59941658554:  Hold'em No Limit ($0.10/$0.25) - 2009/07/01 1:42:07 ET
Table 'P1IJQ2p3ACFySC35W1qwQw' 9-max Seat #8 is the button
Seat 1: bXpVeaSTPBFSPJmeXxO7nw ($4.65 in chips) 
Seat 2: vO3QVRovWemcGMkm7ijAIA ($5.70 in chips) 
Seat 3: PVxvfRTRvkgZf9WtquEkwQ ($25.35 in chips) 
Seat 4: c/9X4zftzphFxYtxp5kp9w ($28.15 in chips) 
Seat 5: ghNKXUBl/H+t83JF079ZBA ($56.45 in chips) 
Seat 6: ljemhp25Zg+nlA9DLCIiUw ($64.45 in chips) 
Seat 7: 7je+LC5Mfs6nL8YBVh4frQ ($5.10 in chips) 
Seat 8: tLcDklc2rBORNfixyRfVfw ($25.90 in chips) 
Seat 9: XXajyXkgbSGJKxQP3mal/Q ($15 in chips) 
XXajyXkgbSGJKxQP3mal/Q: posts small blind $0.10
bXpVeaSTPBFSPJmeXxO7nw: posts big blind $0.25
*** HOLE CARDS ***
vO3QVRovWemcGMkm7ijAIA: folds 
PVxvfRTRvkgZf9WtquEkwQ: folds 
c/9X4zftzphFxYtxp5kp9w: calls $0.25
ghNKXUBl/H+t83JF079ZBA: folds 
ljemhp25Zg+nlA9DLCIiUw: folds 
7je+LC5Mfs6nL8YBVh4frQ: folds 
tLcDklc2rBORNfixyRfVfw: folds 
XXajyXkgbSGJKxQP3mal/Q: folds 
bXpVeaSTPBFSPJmeXxO7nw: checks 
*** FLOP *** [Qs As 4h]
bXpVeaSTPBFSPJmeXxO7nw: checks 
c/9X4zftzphFxYtxp5kp9w: checks 
*** TURN *** [Qs As 4h] [3d]
bXpVeaSTPBFSPJmeXxO7nw: checks 
c/9X4zftzphFxYtxp5kp9w: checks 
*** RIVER *** [Qs As 4h 3d] [Qh]
bXpVeaSTPBFSPJmeXxO7nw: checks 
c/9X4zftzphFxYtxp5kp9w: checks 
*** SHOW DOWN ***
bXpVeaSTPBFSPJmeXxO7nw: shows [9s Ac] (two pair, Aces and Queens)
c/9X4zftzphFxYtxp5kp9w: mucks hand 
bXpVeaSTPBFSPJmeXxO7nw collected $0.60 from pot
*** SUMMARY ***
Total pot $0.60 | Rake $0 
Board [Qs As 4h 3d Qh]
Seat 1: bXpVeaSTPBFSPJmeXxO7nw (big blind) showed [9s Ac] and won ($0.60) with two pair, Aces and Queens
Seat 2: vO3QVRovWemcGMkm7ijAIA folded before Flop (didn't bet)
Seat 3: PVxvfRTRvkgZf9WtquEkwQ folded before Flop (didn't bet)
Seat 4: c/9X4zftzphFxYtxp5kp9w mucked
Seat 5: ghNKXUBl/H+t83JF079ZBA folded before Flop (didn't bet)
Seat 6: ljemhp25Zg+nlA9DLCIiUw folded before Flop (didn't bet)
Seat 7: 7je+LC5Mfs6nL8YBVh4frQ folded before Flop (didn't bet)
Seat 8: tLcDklc2rBORNfixyRfVfw (button) folded before Flop (didn't bet)
Seat 9: XXajyXkgbSGJKxQP3mal/Q (small blind) folded before Flop




PokerStars Game #59941659050:  Hold'em No Limit ($0.10/$0.25) - 2009/07/01 1:42:08 ET
Table 'LwnjzXstPtSrqrV/oDpnXQ' 9-max Seat #7 is the button
Seat 1: 9YN2IkT2JYYKFErZtZvCtA ($20.30 in chips) 
Seat 2: uLP/lYn7oKq9xCChBXsXxw ($27 in chips) 
Seat 3: 7je+LC5Mfs6nL8YBVh4frQ ($4.30 in chips) 
Seat 4: CmngQmkKTp8tkl6GMRTl6w ($9.60 in chips) 
Seat 5: Th3FldXKQW6hWVVPahaoOQ ($25 in chips) 
Seat 6: ljemhp25Zg+nlA9DLCIiUw ($40.60 in chips) 
Seat 7: c/Dw/6HyqldTzIRodAIZmg ($12.80 in chips) 
Seat 8: ShXPHWfjhfmAwLgDdm6bRQ ($12.45 in chips) 
Seat 9: q6WfTUAD9mowIP63ASq2Dgz/khFDKGihQjwgoiKKPOeg95 in chips) 
ShXPHWfjhfmAwLgDdm6bRQ: posts small blind $0.10
q6WfTUAD9mowIP63ASq2Dgz/khFDKGihQjwgoiKKPOegs big blind $0.25
*** HOLE CARDS ***
9YN2IkT2JYYKFErZtZvCtA said, "nice river donk"
9YN2IkT2JYYKFErZtZvCtA: folds 
uLP/lYn7oKq9xCChBXsXxw: folds 
7je+LC5Mfs6nL8YBVh4frQ: folds 
CmngQmkKTp8tkl6GMRTl6w: folds 
Th3FldXKQW6hWVVPahaoOQ: folds 
ljemhp25Zg+nlA9DLCIiUw: raises $0.50 to $0.75
c/Dw/6HyqldTzIRodAIZmg: calls $0.75
ShXPHWfjhfmAwLgDdm6bRQ: folds 
q6WfTUAD9mowIP63ASq2Dgz/khFDKGihQjwgoiKKPOegs $0.50
*** FLOP *** [6c 2s 6h]
q6WfTUAD9mowIP63ASq2Dgz/khFDKGihQjwgoiKKPOeg $0.75
ljemhp25Zg+nlA9DLCIiUw: folds 
c/Dw/6HyqldTzIRodAIZmg: folds 
Uncalled bet ($0.75) returned to q6WfTUAD9mowIP63ASq2Dgz/khFDKGihQjwgoiKKPOegq6WfTUAD9mowIP63ASq2Dgt collected $2.25 from pot
q6WfTUAD9mowIP63ASq2Dgz/khFDKGihQjwgoiKKPOegn't show hand 
*** SUMMARY ***
Total pot $2.35 | Rake $0.10 
Board [6c 2s 6h]
Seat 1: 9YN2IkT2JYYKFErZtZvCtA folded before Flop (didn't bet)
Seat 2: uLP/lYn7oKq9xCChBXsXxw folded before Flop (didn't bet)
Seat 3: 7je+LC5Mfs6nL8YBVh4frQ folded before Flop (didn't bet)
Seat 4: CmngQmkKTp8tkl6GMRTl6w folded before Flop (didn't bet)
Seat 5: Th3FldXKQW6hWVVPahaoOQ folded before Flop (didn't bet)
Seat 6: ljemhp25Zg+nlA9DLCIiUw folded on the Flop
Seat 7: c/Dw/6HyqldTzIRodAIZmg (button) folded on the Flop
Seat 8: ShXPHWfjhfmAwLgDdm6bRQ (small blind) folded before Flop
Seat 9: q6WfTUAD9mowIP63ASq2Dgz/khFDKGihQjwgoiKKPOegblind) collected ($2.25)




PokerStars Game #59941659414:  Hold'em No Limit ($0.10/$0.25) - 2009/07/01 1:42:08 ET
Table 'sJ4KpS2GE5Qrsu1/cFjJUw' 9-max Seat #3 is the button
Seat 1: eDlQ+S+6L4e6gM1dkZhGgQ ($15 in chips) 
Seat 2: tYsOBqdU1+x+yFI7zHO7hQ ($31.75 in chips) 
Seat 3: eK8qa6EPcH2zhtbmWSvc9g ($25 in chips) 
Seat 4: npAYqa85pqnzfOK5ukX+BQ ($24.65 in chips) 
Seat 5: Q/gZC63lfOMr7YhWKPCxoQ ($9.60 in chips) 
Seat 6: OefE+Csvj5KR7ClGf3Hc2g ($2.85 in chips) 
Seat 7: Wi8djHgewBlVhpKWfp7isQ ($7.50 in chips) 
Seat 8: S7Ki0P+0AIGPuIfGJjW0gg ($29.70 in chips) 
Seat 9: 3PmVnC/15cl4oyI1TKIt4g ($4.75 in chips) 
npAYqa85pqnzfOK5ukX+BQ: posts small blind $0.10
Q/gZC63lfOMr7YhWKPCxoQ: posts big blind $0.25
eDlQ+S+6L4e6gM1dkZhGgQ: posts big blind $0.25
*** HOLE CARDS ***
OefE+Csvj5KR7ClGf3Hc2g: folds 
Wi8djHgewBlVhpKWfp7isQ: folds 
S7Ki0P+0AIGPuIfGJjW0gg: folds 
3PmVnC/15cl4oyI1TKIt4g: folds 
eDlQ+S+6L4e6gM1dkZhGgQ: checks 
tYsOBqdU1+x+yFI7zHO7hQ: folds 
eK8qa6EPcH2zhtbmWSvc9g: folds 
npAYqa85pqnzfOK5ukX+BQ: calls $0.15
Q/gZC63lfOMr7YhWKPCxoQ: checks 
*** FLOP *** [Ts Ks 9s]
npAYqa85pqnzfOK5ukX+BQ: bets $0.75
Q/gZC63lfOMr7YhWKPCxoQ: folds 
eDlQ+S+6L4e6gM1dkZhGgQ: raises $0.75 to $1.50
npAYqa85pqnzfOK5ukX+BQ: calls $0.75
*** TURN *** [Ts Ks 9s] [5d]
npAYqa85pqnzfOK5ukX+BQ: checks 
eDlQ+S+6L4e6gM1dkZhGgQ: bets $0.75
npAYqa85pqnzfOK5ukX+BQ: calls $0.75
*** RIVER *** [Ts Ks 9s 5d] [6s]
npAYqa85pqnzfOK5ukX+BQ: checks 
eDlQ+S+6L4e6gM1dkZhGgQ: bets $3
npAYqa85pqnzfOK5ukX+BQ: calls $3
*** SHOW DOWN ***
eDlQ+S+6L4e6gM1dkZhGgQ: shows [Js As] (a flush, Ace high)
npAYqa85pqnzfOK5ukX+BQ: mucks hand 
eDlQ+S+6L4e6gM1dkZhGgQ collected $10.70 from pot
*** SUMMARY ***
Total pot $11.25 | Rake $0.55 
Board [Ts Ks 9s 5d 6s]
Seat 1: eDlQ+S+6L4e6gM1dkZhGgQ showed [Js As] and won ($10.70) with a flush, Ace high
Seat 2: tYsOBqdU1+x+yFI7zHO7hQ folded before Flop (didn't bet)
Seat 3: eK8qa6EPcH2zhtbmWSvc9g (button) folded before Flop (didn't bet)
Seat 4: npAYqa85pqnzfOK5ukX+BQ (small blind) mucked
Seat 5: Q/gZC63lfOMr7YhWKPCxoQ (big blind) folded on the Flop
Seat 6: OefE+Csvj5KR7ClGf3Hc2g folded before Flop (didn't bet)
Seat 7: Wi8djHgewBlVhpKWfp7isQ folded before Flop (didn't bet)
Seat 8: S7Ki0P+0AIGPuIfGJjW0gg folded before Flop (didn't bet)
Seat 9: 3PmVnC/15cl4oyI1TKIt4g folded before Flop (didn't bet)




PokerStars Game #59941659076:  Hold'em No Limit ($0.10/$0.25) - 2009/07/01 1:42:08 ET
Table 'ROYvQOMwUrvL3SOiHYcrWg' 9-max Seat #4 is the button
Seat 1: 22dIObOuor/A+IKWkNoAlA ($5 in chips) 
Seat 2: gehe91e0IyVT0QU/XBkEyg ($24.90 in chips) 
Seat 3: 8EbrQ/EvFWt2cr0GaU82gQ ($4.65 in chips) 
Seat 4: SHegmCn8B0InbWE/zFlvOw ($31.70 in chips) 
Seat 5: 7je+LC5Mfs6nL8YBVh4frQ ($4.75 in chips) 
Seat 6: P+9ymZQ3ktpQu1bn7HIjew ($10 in chips) 
Seat 7: tYsOBqdU1+x+yFI7zHO7hQ ($26.15 in chips) 
Seat 8: biJWLZ27fafNeBI2oT1KJw ($27.80 in chips) 
Seat 9: uhrboV251dcgYniYTdFIcA ($25.35 in chips) 
7je+LC5Mfs6nL8YBVh4frQ: posts small blind $0.10
P+9ymZQ3ktpQu1bn7HIjew: posts big blind $0.25
*** HOLE CARDS ***
tYsOBqdU1+x+yFI7zHO7hQ: folds 
biJWLZ27fafNeBI2oT1KJw: raises $0.50 to $0.75
uhrboV251dcgYniYTdFIcA: folds 
22dIObOuor/A+IKWkNoAlA: folds 
gehe91e0IyVT0QU/XBkEyg: folds 
8EbrQ/EvFWt2cr0GaU82gQ: folds 
SHegmCn8B0InbWE/zFlvOw: folds 
7je+LC5Mfs6nL8YBVh4frQ: folds 
P+9ymZQ3ktpQu1bn7HIjew: folds 
Uncalled bet ($0.50) returned to biJWLZ27fafNeBI2oT1KJw
biJWLZ27fafNeBI2oT1KJw collected $0.60 from pot
biJWLZ27fafNeBI2oT1KJw: doesn't show hand 
*** SUMMARY ***
Total pot $0.60 | Rake $0 
Seat 1: 22dIObOuor/A+IKWkNoAlA folded before Flop (didn't bet)
Seat 2: gehe91e0IyVT0QU/XBkEyg folded before Flop (didn't bet)
Seat 3: 8EbrQ/EvFWt2cr0GaU82gQ folded before Flop (didn't bet)
Seat 4: SHegmCn8B0InbWE/zFlvOw (button) folded before Flop (didn't bet)
Seat 5: 7je+LC5Mfs6nL8YBVh4frQ (small blind) folded before Flop
Seat 6: P+9ymZQ3ktpQu1bn7HIjew (big blind) folded before Flop
Seat 7: tYsOBqdU1+x+yFI7zHO7hQ folded before Flop (didn't bet)
Seat 8: biJWLZ27fafNeBI2oT1KJw collected ($0.60)
Seat 9: uhrboV251dcgYniYTdFIcA folded before Flop (didn't bet)




PokerStars Game #59941659214:  Hold'em No Limit ($0.10/$0.25) - 2009/07/01 1:42:08 ET
Table '9SExUHslNkrPJ4XsrePaVw' 9-max Seat #7 is the button
Seat 2: cZ99hugmLBj9KhTlc8nCSw ($44.85 in chips) 
Seat 3: EP17SQz/iWcuYdNOGeBgkw ($14.40 in chips) 
Seat 4: 4awUyiDYTgylQKXZ9faBVA ($25 in chips) 
Seat 5: L+eJnUyhY8bMNYw755K8XQ ($14.50 in chips) 
Seat 6: YPJ90cgNXDABdYJcqmwB0A ($17.20 in chips) 
Seat 7: 7cv+9Zc9HIQHNvYsMfV3uA ($29.70 in chips) 
Seat 8: tLcDklc2rBORNfixyRfVfw ($25 in chips) 
Seat 9: /THNzAxdv2lBxcf4XTj/0g ($10.85 in chips) 
tLcDklc2rBORNfixyRfVfw: posts small blind $0.10
/THNzAxdv2lBxcf4XTj/0g: posts big blind $0.25
*** HOLE CARDS ***
RHqgdFvufLCYe54+qd2gcA joins the table at seat #1 
cZ99hugmLBj9KhTlc8nCSw: folds 
EP17SQz/iWcuYdNOGeBgkw: folds 
4awUyiDYTgylQKXZ9faBVA: folds 
L+eJnUyhY8bMNYw755K8XQ: folds 
YPJ90cgNXDABdYJcqmwB0A: raises $0.25 to $0.50
7cv+9Zc9HIQHNvYsMfV3uA: calls $0.50
tLcDklc2rBORNfixyRfVfw: folds 
/THNzAxdv2lBxcf4XTj/0g: calls $0.25
*** FLOP *** [4d Kd Ac]
/THNzAxdv2lBxcf4XTj/0g: checks 
YPJ90cgNXDABdYJcqmwB0A: bets $0.25
7cv+9Zc9HIQHNvYsMfV3uA: folds 
/THNzAxdv2lBxcf4XTj/0g: calls $0.25
*** TURN *** [4d Kd Ac] [Ah]
/THNzAxdv2lBxcf4XTj/0g: checks 
YPJ90cgNXDABdYJcqmwB0A: bets $0.25
/THNzAxdv2lBxcf4XTj/0g: calls $0.25
*** RIVER *** [4d Kd Ac Ah] [Tc]
/THNzAxdv2lBxcf4XTj/0g: checks 
YPJ90cgNXDABdYJcqmwB0A: bets $2.50
/THNzAxdv2lBxcf4XTj/0g: calls $2.50
*** SHOW DOWN ***
YPJ90cgNXDABdYJcqmwB0A: shows [Qd Ad] (three of a kind, Aces)
/THNzAxdv2lBxcf4XTj/0g: mucks hand 
YPJ90cgNXDABdYJcqmwB0A collected $7.25 from pot
*** SUMMARY ***
Total pot $7.60 | Rake $0.35 
Board [4d Kd Ac Ah Tc]
Seat 2: cZ99hugmLBj9KhTlc8nCSw folded before Flop (didn't bet)
Seat 3: EP17SQz/iWcuYdNOGeBgkw folded before Flop (didn't bet)
Seat 4: 4awUyiDYTgylQKXZ9faBVA folded before Flop (didn't bet)
Seat 5: L+eJnUyhY8bMNYw755K8XQ folded before Flop (didn't bet)
Seat 6: YPJ90cgNXDABdYJcqmwB0A showed [Qd Ad] and won ($7.25) with three of a kind, Aces
Seat 7: 7cv+9Zc9HIQHNvYsMfV3uA (button) folded on the Flop
Seat 8: tLcDklc2rBORNfixyRfVfw (small blind) folded before Flop
Seat 9: /THNzAxdv2lBxcf4XTj/0g (big blind) mucked




PokerStars Game #59941658980:  Hold'em No Limit ($0.10/$0.25) - 2009/07/01 1:42:08 ET
Table 'axb9RsG8Zj1A0LEukTeFrQ' 9-max Seat #9 is the button
Seat 1: qwr38jl5txoR36M7G5qi4A ($8.60 in chips) 
Seat 3: H5Se03ZqSX7tbULXur2MAg ($24.35 in chips) 
Seat 4: tLcDklc2rBORNfixyRfVfw ($27.45 in chips) 
Seat 5: rLSSHKOHnb6yzVfDoQM/RA ($15.10 in chips) 
Seat 6: Iu9xjReQYvxYiqQm8n6MXQ ($5 in chips) 
Seat 7: PdIasPkzm2sqZnN41ZRXOg ($5 in chips) 
Seat 8: VBHxUExRAMrbxUq/cVx9Gw ($4.30 in chips) 
Seat 9: qbQE8CifKB4+OEvNF/61Rw ($56.90 in chips) 
qwr38jl5txoR36M7G5qi4A: posts small blind $0.10
H5Se03ZqSX7tbULXur2MAg: posts big blind $0.25
Iu9xjReQYvxYiqQm8n6MXQ: posts big blind $0.25
*** HOLE CARDS ***
tLcDklc2rBORNfixyRfVfw: folds 
rLSSHKOHnb6yzVfDoQM/RA: folds 
Iu9xjReQYvxYiqQm8n6MXQ: checks 
PdIasPkzm2sqZnN41ZRXOg: folds 
VBHxUExRAMrbxUq/cVx9Gw: folds 
qbQE8CifKB4+OEvNF/61Rw: folds 
qwr38jl5txoR36M7G5qi4A: folds 
H5Se03ZqSX7tbULXur2MAg: checks 
*** FLOP *** [Ad Qc 9d]
H5Se03ZqSX7tbULXur2MAg: checks 
Iu9xjReQYvxYiqQm8n6MXQ: bets $0.25
H5Se03ZqSX7tbULXur2MAg: folds 
Uncalled bet ($0.25) returned to Iu9xjReQYvxYiqQm8n6MXQ
Iu9xjReQYvxYiqQm8n6MXQ collected $0.60 from pot
Iu9xjReQYvxYiqQm8n6MXQ: doesn't show hand 
*** SUMMARY ***
Total pot $0.60 | Rake $0 
Board [Ad Qc 9d]
Seat 1: qwr38jl5txoR36M7G5qi4A (small blind) folded before Flop
Seat 3: H5Se03ZqSX7tbULXur2MAg (big blind) folded on the Flop
Seat 4: tLcDklc2rBORNfixyRfVfw folded before Flop (didn't bet)
Seat 5: rLSSHKOHnb6yzVfDoQM/RA folded before Flop (didn't bet)
Seat 6: Iu9xjReQYvxYiqQm8n6MXQ collected ($0.60)
Seat 7: PdIasPkzm2sqZnN41ZRXOg folded before Flop (didn't bet)
Seat 8: VBHxUExRAMrbxUq/cVx9Gw folded before Flop (didn't bet)
Seat 9: qbQE8CifKB4+OEvNF/61Rw (button) folded before Flop (didn't bet)




PokerStars Game #59941659242:  Hold'em No Limit ($0.10/$0.25) - 2009/07/01 1:42:08 ET
Table 'C8mMnVmvkagwolEzTvh07A' 9-max Seat #3 is the button
Seat 1: PqvgxdSg9z5VmrWpbYuz+g ($25.70 in chips) 
Seat 2: Bb42QRQMhg5/Y0vHP8/2Xw ($25 in chips) 
Seat 3: Th3FldXKQW6hWVVPahaoOQ ($35.35 in chips) 
Seat 4: dfNim92Z6XK1/h5SFW5vDg ($25 in chips) 
Seat 5: iGMlK+EhUflPB6jKQd95Cg ($27.85 in chips) 
Seat 7: qmEgnPhQt24xdw/ZRVPLbA ($47.30 in chips) 
Seat 9: 4awUyiDYTgylQKXZ9faBVA ($25 in chips) 
dfNim92Z6XK1/h5SFW5vDg: posts small blind $0.10
iGMlK+EhUflPB6jKQd95Cg: posts big blind $0.25
AiXn/9o1EwOPZUHujnh/bA: sits out 
*** HOLE CARDS ***
qmEgnPhQt24xdw/ZRVPLbA: raises $0.75 to $1
4awUyiDYTgylQKXZ9faBVA: folds 
PqvgxdSg9z5VmrWpbYuz+g: folds 
Bb42QRQMhg5/Y0vHP8/2Xw: folds 
Th3FldXKQW6hWVVPahaoOQ: folds 
dfNim92Z6XK1/h5SFW5vDg: folds 
iGMlK+EhUflPB6jKQd95Cg: folds 
Uncalled bet ($0.75) returned to qmEgnPhQt24xdw/ZRVPLbA
qmEgnPhQt24xdw/ZRVPLbA collected $0.60 from pot
qmEgnPhQt24xdw/ZRVPLbA: doesn't show hand 
*** SUMMARY ***
Total pot $0.60 | Rake $0 
Seat 1: PqvgxdSg9z5VmrWpbYuz+g folded before Flop (didn't bet)
Seat 2: Bb42QRQMhg5/Y0vHP8/2Xw folded before Flop (didn't bet)
Seat 3: Th3FldXKQW6hWVVPahaoOQ (button) folded before Flop (didn't bet)
Seat 4: dfNim92Z6XK1/h5SFW5vDg (small blind) folded before Flop
Seat 5: iGMlK+EhUflPB6jKQd95Cg (big blind) folded before Flop
Seat 7: qmEgnPhQt24xdw/ZRVPLbA collected ($0.60)
Seat 9: 4awUyiDYTgylQKXZ9faBVA folded before Flop (didn't bet)




PokerStars Game #59941659078:  Hold'em No Limit ($0.10/$0.25) - 2009/07/01 1:42:08 ET
Table 'P2yJ+jwfNsBdF12fLKA6DQ' 9-max Seat #4 is the button
Seat 2: uQwmfH5LEVA5eyghJdyPUg ($11.40 in chips) 
Seat 4: 6NLAWFPZZfqlVkY8n9RULA ($14 in chips) 
Seat 5: B7VAFAMs/PYlYABlV+EkSA ($17.25 in chips) 
Seat 6: mUoFJKqCzIUABvOFbiINlQ ($13.25 in chips) 
Seat 7: yQc5nLaNmByxI15Jegu61w ($9 in chips) 
Seat 8: LMd3gq2uNfbWTfXTnSeQRw ($10.15 in chips) 
Seat 9: dN5zq7QdZCUe7NZFM6cECg ($18.75 in chips) 
B7VAFAMs/PYlYABlV+EkSA: posts small blind $0.10
mUoFJKqCzIUABvOFbiINlQ: posts big blind $0.25
8EbrQ/EvFWt2cr0GaU82gQ: sits out 
*** HOLE CARDS ***
yQc5nLaNmByxI15Jegu61w: calls $0.25
LMd3gq2uNfbWTfXTnSeQRw: folds 
dN5zq7QdZCUe7NZFM6cECg: folds 
uQwmfH5LEVA5eyghJdyPUg: folds 
6NLAWFPZZfqlVkY8n9RULA: folds 
B7VAFAMs/PYlYABlV+EkSA: calls $0.15
mUoFJKqCzIUABvOFbiINlQ: checks 
*** FLOP *** [4s Jd 2d]
B7VAFAMs/PYlYABlV+EkSA: checks 
mUoFJKqCzIUABvOFbiINlQ: checks 
yQc5nLaNmByxI15Jegu61w: bets $0.50
B7VAFAMs/PYlYABlV+EkSA: folds 
mUoFJKqCzIUABvOFbiINlQ: folds 
Uncalled bet ($0.50) returned to yQc5nLaNmByxI15Jegu61w
yQc5nLaNmByxI15Jegu61w collected $0.75 from pot
yQc5nLaNmByxI15Jegu61w: doesn't show hand 
*** SUMMARY ***
Total pot $0.75 | Rake $0 
Board [4s Jd 2d]
Seat 2: uQwmfH5LEVA5eyghJdyPUg folded before Flop (didn't bet)
Seat 4: 6NLAWFPZZfqlVkY8n9RULA (button) folded before Flop (didn't bet)
Seat 5: B7VAFAMs/PYlYABlV+EkSA (small blind) folded on the Flop
Seat 6: mUoFJKqCzIUABvOFbiINlQ (big blind) folded on the Flop
Seat 7: yQc5nLaNmByxI15Jegu61w collected ($0.75)
Seat 8: LMd3gq2uNfbWTfXTnSeQRw folded before Flop (didn't bet)
Seat 9: dN5zq7QdZCUe7NZFM6cECg folded before Flop (didn't bet)




PokerStars Game #59941659406:  Hold'em No Limit ($0.10/$0.25) - 2009/07/01 1:42:08 ET
Table 'Loy/olZ5qoDOSvX4UTujGg' 6-max Seat #3 is the button
Seat 1: HipgaJhkN4ie/tTw4dK3Ug ($11.30 in chips) 
Seat 2: 4z7mPbMLNp4TezHXin63Vw ($17.80 in chips) 
Seat 3: 32YL2ZEp8NT4JB2RVM9euQ ($15.70 in chips) 
Seat 4: /gJNBeCkWL4o85/jvlZ4BA ($28.65 in chips) 
Seat 5: tSR4329m40dZsN7YOpI9Kw ($28.70 in chips) 
Seat 6: qGHGf/553gQnDoklMRe3tg ($26.55 in chips) 
/gJNBeCkWL4o85/jvlZ4BA: posts small blind $0.10
tSR4329m40dZsN7YOpI9Kw: posts big blind $0.25
*** HOLE CARDS ***
qGHGf/553gQnDoklMRe3tg: folds 
HipgaJhkN4ie/tTw4dK3Ug: folds 
4z7mPbMLNp4TezHXin63Vw: folds 
32YL2ZEp8NT4JB2RVM9euQ: raises $0.75 to $1
/gJNBeCkWL4o85/jvlZ4BA: folds 
tSR4329m40dZsN7YOpI9Kw: folds 
Uncalled bet ($0.75) returned to 32YL2ZEp8NT4JB2RVM9euQ
32YL2ZEp8NT4JB2RVM9euQ collected $0.60 from pot
32YL2ZEp8NT4JB2RVM9euQ: doesn't show hand 
*** SUMMARY ***
Total pot $0.60 | Rake $0 
Seat 1: HipgaJhkN4ie/tTw4dK3Ug folded before Flop (didn't bet)
Seat 2: 4z7mPbMLNp4TezHXin63Vw folded before Flop (didn't bet)
Seat 3: 32YL2ZEp8NT4JB2RVM9euQ (button) collected ($0.60)
Seat 4: /gJNBeCkWL4o85/jvlZ4BA (small blind) folded before Flop
Seat 5: tSR4329m40dZsN7YOpI9Kw (big blind) folded before Flop
Seat 6: qGHGf/553gQnDoklMRe3tg folded before Flop (didn't bet)




PokerStars Game #59941659040:  Hold'em No Limit ($0.10/$0.25) - 2009/07/01 1:42:08 ET
Table 'ZEXL6Wh4qA4Afx8NnoBBAA' 6-max Seat #2 is the button
Seat 1: v8m8XHovI5tqEA9mvplDSw ($27.60 in chips) 
Seat 2: 6DwBRH+xZ12AAZmeAg+aXw ($34.80 in chips) 
Seat 3: +ZlnqPoP3Hg4BIUxDfKd/A ($31 in chips) 
Seat 4: FpN4KbLjlyRRKiVaQcoLqA ($30.85 in chips) 
Seat 5: if4dh6jhJXeN3/qd3qCp9g ($27 in chips) 
Seat 6: Lh8SlCq3OSDKWLUgAI/Lxw ($1.05 in chips) 
+ZlnqPoP3Hg4BIUxDfKd/A: posts small blind $0.10
FpN4KbLjlyRRKiVaQcoLqA: posts big blind $0.25
*** HOLE CARDS ***
if4dh6jhJXeN3/qd3qCp9g: folds 
Lh8SlCq3OSDKWLUgAI/Lxw: raises $0.80 to $1.05 and is all-in
v8m8XHovI5tqEA9mvplDSw: folds 
6DwBRH+xZ12AAZmeAg+aXw: calls $1.05
+ZlnqPoP3Hg4BIUxDfKd/A: folds 
FpN4KbLjlyRRKiVaQcoLqA: folds 
*** FLOP *** [5d As 6c]
*** TURN *** [5d As 6c] [Jd]
*** RIVER *** [5d As 6c Jd] [7d]
*** SHOW DOWN ***
Lh8SlCq3OSDKWLUgAI/Lxw: shows [Kd Ac] (a pair of Aces)
6DwBRH+xZ12AAZmeAg+aXw: mucks hand 
Lh8SlCq3OSDKWLUgAI/Lxw collected $2.35 from pot
*** SUMMARY ***
Total pot $2.45 | Rake $0.10 
Board [5d As 6c Jd 7d]
Seat 1: v8m8XHovI5tqEA9mvplDSw folded before Flop (didn't bet)
Seat 2: 6DwBRH+xZ12AAZmeAg+aXw (button) mucked
Seat 3: +ZlnqPoP3Hg4BIUxDfKd/A (small blind) folded before Flop
Seat 4: FpN4KbLjlyRRKiVaQcoLqA (big blind) folded before Flop
Seat 5: if4dh6jhJXeN3/qd3qCp9g folded before Flop (didn't bet)
Seat 6: Lh8SlCq3OSDKWLUgAI/Lxw showed [Kd Ac] and won ($2.35) with a pair of Aces




PokerStars Game #59941659068:  Hold'em No Limit ($0.10/$0.25) - 2009/07/01 1:42:08 ET
Table 'srBTB98reCdD1TffxE6o7g' 6-max Seat #3 is the button
Seat 1: SFmT9ZsVopnukjvAzrxTRg ($34.30 in chips) 
Seat 2: mfrkWA3PTeYPkbO6hi98Aw ($25 in chips) 
Seat 3: VOmI0x4dDPnTESZd5B4d1Q ($47.85 in chips) 
Seat 4: 6DwBRH+xZ12AAZmeAg+aXw ($21.05 in chips) 
Seat 5: 8zUCJvLYLFM8AG6K5zjIvg ($12.30 in chips) 
Seat 6: BV+K0Phf5VBHr7aZPKqbUQ ($34.95 in chips) 
6DwBRH+xZ12AAZmeAg+aXw: posts small blind $0.10
8zUCJvLYLFM8AG6K5zjIvg: posts big blind $0.25
*** HOLE CARDS ***
BV+K0Phf5VBHr7aZPKqbUQ: folds 
SFmT9ZsVopnukjvAzrxTRg: folds 
mfrkWA3PTeYPkbO6hi98Aw: folds 
VOmI0x4dDPnTESZd5B4d1Q: folds 
6DwBRH+xZ12AAZmeAg+aXw: raises $0.50 to $0.75
8zUCJvLYLFM8AG6K5zjIvg: folds 
Uncalled bet ($0.50) returned to 6DwBRH+xZ12AAZmeAg+aXw
6DwBRH+xZ12AAZmeAg+aXw collected $0.50 from pot
6DwBRH+xZ12AAZmeAg+aXw: doesn't show hand 
*** SUMMARY ***
Total pot $0.50 | Rake $0 
Seat 1: SFmT9ZsVopnukjvAzrxTRg folded before Flop (didn't bet)
Seat 2: mfrkWA3PTeYPkbO6hi98Aw folded before Flop (didn't bet)
Seat 3: VOmI0x4dDPnTESZd5B4d1Q (button) folded before Flop (didn't bet)
Seat 4: 6DwBRH+xZ12AAZmeAg+aXw (small blind) collected ($0.50)
Seat 5: 8zUCJvLYLFM8AG6K5zjIvg (big blind) folded before Flop
Seat 6: BV+K0Phf5VBHr7aZPKqbUQ folded before Flop (didn't bet)




PokerStars Game #59941659608:  Hold'em No Limit ($0.10/$0.25) - 2009/07/01 1:42:09 ET
Table 'JJzUs04lHpXg6nboT1/jeg' 6-max Seat #6 is the button
Seat 1: MqMK8OWPSY1V4stf1Hy5Jw ($39.05 in chips) 
Seat 2: jxfR29d+dK/7h7s3SvCk+g ($5.20 in chips) 
Seat 3: 4zXbHDe39qNX46dAo81b4w ($6.95 in chips) 
Seat 4: 7VfhiFY533nbUKvyEthASw ($29.85 in chips) 
Seat 5: QvTX2yGq3uKJiKPmns4TKQ ($20.75 in chips) 
Seat 6: wqphQtauX5Qn7WRJZS1flA ($31.05 in chips) 
MqMK8OWPSY1V4stf1Hy5Jw: posts small blind $0.10
jxfR29d+dK/7h7s3SvCk+g: posts big blind $0.25
*** HOLE CARDS ***
4zXbHDe39qNX46dAo81b4w: calls $0.25
7VfhiFY533nbUKvyEthASw: folds 
QvTX2yGq3uKJiKPmns4TKQ: folds 
wqphQtauX5Qn7WRJZS1flA: raises $0.75 to $1
MqMK8OWPSY1V4stf1Hy5Jw: folds 
jxfR29d+dK/7h7s3SvCk+g: folds 
4zXbHDe39qNX46dAo81b4w: calls $0.75
*** FLOP *** [4s Kh 6h]
4zXbHDe39qNX46dAo81b4w: bets $0.75
wqphQtauX5Qn7WRJZS1flA: calls $0.75
*** TURN *** [4s Kh 6h] [Td]
4zXbHDe39qNX46dAo81b4w: bets $1
wqphQtauX5Qn7WRJZS1flA: folds 
Uncalled bet ($1) returned to 4zXbHDe39qNX46dAo81b4w
4zXbHDe39qNX46dAo81b4w collected $3.70 from pot
*** SUMMARY ***
Total pot $3.85 | Rake $0.15 
Board [4s Kh 6h Td]
Seat 1: MqMK8OWPSY1V4stf1Hy5Jw (small blind) folded before Flop
Seat 2: jxfR29d+dK/7h7s3SvCk+g (big blind) folded before Flop
Seat 3: 4zXbHDe39qNX46dAo81b4w collected ($3.70)
Seat 4: 7VfhiFY533nbUKvyEthASw folded before Flop (didn't bet)
Seat 5: QvTX2yGq3uKJiKPmns4TKQ folded before Flop (didn't bet)
Seat 6: wqphQtauX5Qn7WRJZS1flA (button) folded on the Turn




PokerStars Game #59941659674:  Hold'em No Limit ($0.10/$0.25) - 2009/07/01 1:42:09 ET
Table 'KEoOIegxPF91KooL2AelUA' 6-max Seat #6 is the button
Seat 1: wsP46AGpqDjHZQmlRHKa9g ($42.35 in chips) 
Seat 2: 0Bg59Tnte1Tc7C4i9Jd9cQ ($3.45 in chips) 
Seat 3: zxeVQGaMKDsDzmSY+AInjA ($12.05 in chips) 
Seat 4: Wo60l2GQnSEc3bxPVyvIUw ($19.95 in chips) 
Seat 5: 08V++DOqzaNrRNsHIwi25w ($44.70 in chips) 
Seat 6: AMrBn4Vx9aAo/vv6WHLk6w ($3.15 in chips) 
wsP46AGpqDjHZQmlRHKa9g: posts small blind $0.10
0Bg59Tnte1Tc7C4i9Jd9cQ: posts big blind $0.25
*** HOLE CARDS ***
zxeVQGaMKDsDzmSY+AInjA: raises $0.75 to $1
Wo60l2GQnSEc3bxPVyvIUw: calls $1
08V++DOqzaNrRNsHIwi25w: folds 
AMrBn4Vx9aAo/vv6WHLk6w: folds 
wsP46AGpqDjHZQmlRHKa9g: folds 
0Bg59Tnte1Tc7C4i9Jd9cQ: calls $0.75
*** FLOP *** [5h 2c Jh]
0Bg59Tnte1Tc7C4i9Jd9cQ: checks 
zxeVQGaMKDsDzmSY+AInjA: checks 
Wo60l2GQnSEc3bxPVyvIUw: bets $2.50
0Bg59Tnte1Tc7C4i9Jd9cQ is connected 
0Bg59Tnte1Tc7C4i9Jd9cQ: calls $2.45 and is all-in
zxeVQGaMKDsDzmSY+AInjA: folds 
Uncalled bet ($0.05) returned to Wo60l2GQnSEc3bxPVyvIUw
*** TURN *** [5h 2c Jh] [Jd]
*** RIVER *** [5h 2c Jh Jd] [Jc]
*** SHOW DOWN ***
0Bg59Tnte1Tc7C4i9Jd9cQ: shows [3d 5d] (a full house, Jacks full of Fives)
Wo60l2GQnSEc3bxPVyvIUw: mucks hand 
0Bg59Tnte1Tc7C4i9Jd9cQ collected $7.65 from pot
*** SUMMARY ***
Total pot $8 | Rake $0.35 
Board [5h 2c Jh Jd Jc]
Seat 1: wsP46AGpqDjHZQmlRHKa9g (small blind) folded before Flop
Seat 2: 0Bg59Tnte1Tc7C4i9Jd9cQ (big blind) showed [3d 5d] and won ($7.65) with a full house, Jacks full of Fives
Seat 3: zxeVQGaMKDsDzmSY+AInjA folded on the Flop
Seat 4: Wo60l2GQnSEc3bxPVyvIUw mucked
Seat 5: 08V++DOqzaNrRNsHIwi25w folded before Flop (didn't bet)
Seat 6: AMrBn4Vx9aAo/vv6WHLk6w (button) folded before Flop (didn't bet)




PokerStars Game #59941659552:  Hold'em No Limit ($0.10/$0.25) - 2009/07/01 1:42:09 ET
Table '/asc7VQ/OpF/oVJ3erB80w' 9-max Seat #7 is the button
Seat 2: +LseQ4csMghI3KY4cLSGMQ ($23.25 in chips) 
Seat 3: WEb58GPxGJGcxGh34AFZRQ ($2.45 in chips) 
Seat 4: Rjy74A2wdEiDWplMcUbA+w ($19.60 in chips) 
Seat 5: QB9VESHry/CRTDKMGwKwsQ ($42.45 in chips) 
Seat 6: XwQK8xvCADxp0bUmji+Zyg ($11.95 in chips) 
Seat 7: 7Qlge5BZqMQvXxiy4HU3Hw ($6.40 in chips) 
Seat 8: jB7U2KxE3pjvDhvZHXK2Ag ($10.05 in chips) 
Seat 9: zUXhymECc2C9W9ZNw6qppA ($19.40 in chips) 
jB7U2KxE3pjvDhvZHXK2Ag: posts small blind $0.10
zUXhymECc2C9W9ZNw6qppA: posts big blind $0.25
*** HOLE CARDS ***
+LseQ4csMghI3KY4cLSGMQ: calls $0.25
WEb58GPxGJGcxGh34AFZRQ: folds 
Rjy74A2wdEiDWplMcUbA+w: calls $0.25
QB9VESHry/CRTDKMGwKwsQ has timed out
QB9VESHry/CRTDKMGwKwsQ: folds 
QB9VESHry/CRTDKMGwKwsQ is sitting out
XwQK8xvCADxp0bUmji+Zyg: folds 
7Qlge5BZqMQvXxiy4HU3Hw: folds 
jB7U2KxE3pjvDhvZHXK2Ag: raises $1.25 to $1.50
QB9VESHry/CRTDKMGwKwsQ has returned
zUXhymECc2C9W9ZNw6qppA: folds 
+LseQ4csMghI3KY4cLSGMQ: calls $1.25
Rjy74A2wdEiDWplMcUbA+w: folds 
*** FLOP *** [3h 2d 5s]
jB7U2KxE3pjvDhvZHXK2Ag: bets $3.50
+LseQ4csMghI3KY4cLSGMQ: calls $3.50
*** TURN *** [3h 2d 5s] [Js]
jB7U2KxE3pjvDhvZHXK2Ag: bets $5.05 and is all-in
+LseQ4csMghI3KY4cLSGMQ: calls $5.05
*** RIVER *** [3h 2d 5s Js] [8h]
*** SHOW DOWN ***
jB7U2KxE3pjvDhvZHXK2Ag: shows [9d 9c] (a pair of Nines)
+LseQ4csMghI3KY4cLSGMQ: mucks hand 
jB7U2KxE3pjvDhvZHXK2Ag collected $19.60 from pot
*** SUMMARY ***
Total pot $20.60 | Rake $1 
Board [3h 2d 5s Js 8h]
Seat 2: +LseQ4csMghI3KY4cLSGMQ mucked
Seat 3: WEb58GPxGJGcxGh34AFZRQ folded before Flop (didn't bet)
Seat 4: Rjy74A2wdEiDWplMcUbA+w folded before Flop
Seat 5: QB9VESHry/CRTDKMGwKwsQ folded before Flop (didn't bet)
Seat 6: XwQK8xvCADxp0bUmji+Zyg folded before Flop (didn't bet)
Seat 7: 7Qlge5BZqMQvXxiy4HU3Hw (button) folded before Flop (didn't bet)
Seat 8: jB7U2KxE3pjvDhvZHXK2Ag (small blind) showed [9d 9c] and won ($19.60) with a pair of Nines
Seat 9: zUXhymECc2C9W9ZNw6qppA (big blind) folded before Flop




PokerStars Game #59941659902:  Hold'em No Limit ($0.10/$0.25) - 2009/07/01 1:42:09 ET
Table '/VaaaFnlEJoYVomG9uxHkA' 9-max Seat #7 is the button
Seat 1: Th3FldXKQW6hWVVPahaoOQ ($26 in chips) 
Seat 2: DIkeSkosO/tsUp9d2JVyTA ($58.55 in chips) 
Seat 3: MtVtHDqIJTyUcXkRBBDIVA ($26.50 in chips) 
Seat 4: j4q3p0lesp63b1gZDwLBZw ($5 in chips) 
Seat 5: cZ99hugmLBj9KhTlc8nCSw ($25.50 in chips) 
Seat 6: qxWFg3MZuVyidB0SJh5ywg ($33.95 in chips) 
Seat 7: F7pnn6czNpHvRM55XcA2EA ($25.50 in chips) 
Seat 8: dfNim92Z6XK1/h5SFW5vDg ($46 in chips) 
dfNim92Z6XK1/h5SFW5vDg: posts small blind $0.10
qpG9m8I+cPw8VhB0mnGjYw: is sitting out 
Th3FldXKQW6hWVVPahaoOQ: posts big blind $0.25
*** HOLE CARDS ***
qpG9m8I+cPw8VhB0mnGjYw leaves the table
DIkeSkosO/tsUp9d2JVyTA: calls $0.25
MtVtHDqIJTyUcXkRBBDIVA: folds 
j4q3p0lesp63b1gZDwLBZw: folds 
DdPXdieucQ+n99u1n3A+rQ joins the table at seat #9 
cZ99hugmLBj9KhTlc8nCSw: folds 
qxWFg3MZuVyidB0SJh5ywg: calls $0.25
F7pnn6czNpHvRM55XcA2EA: folds 
dfNim92Z6XK1/h5SFW5vDg: calls $0.15
Th3FldXKQW6hWVVPahaoOQ: checks 
*** FLOP *** [Th 5h 7c]
dfNim92Z6XK1/h5SFW5vDg: checks 
Th3FldXKQW6hWVVPahaoOQ: checks 
DIkeSkosO/tsUp9d2JVyTA: checks 
qxWFg3MZuVyidB0SJh5ywg: checks 
*** TURN *** [Th 5h 7c] [7s]
dfNim92Z6XK1/h5SFW5vDg: checks 
Th3FldXKQW6hWVVPahaoOQ: bets $0.50
DIkeSkosO/tsUp9d2JVyTA: folds 
qxWFg3MZuVyidB0SJh5ywg: calls $0.50
dfNim92Z6XK1/h5SFW5vDg: folds 
*** RIVER *** [Th 5h 7c 7s] [5c]
Th3FldXKQW6hWVVPahaoOQ: bets $1
qxWFg3MZuVyidB0SJh5ywg: folds 
Uncalled bet ($1) returned to Th3FldXKQW6hWVVPahaoOQ
Th3FldXKQW6hWVVPahaoOQ collected $1.95 from pot
Th3FldXKQW6hWVVPahaoOQ: doesn't show hand 
*** SUMMARY ***
Total pot $2 | Rake $0.05 
Board [Th 5h 7c 7s 5c]
Seat 1: Th3FldXKQW6hWVVPahaoOQ (big blind) collected ($1.95)
Seat 2: DIkeSkosO/tsUp9d2JVyTA folded on the Turn
Seat 3: MtVtHDqIJTyUcXkRBBDIVA folded before Flop (didn't bet)
Seat 4: j4q3p0lesp63b1gZDwLBZw folded before Flop (didn't bet)
Seat 5: cZ99hugmLBj9KhTlc8nCSw folded before Flop (didn't bet)
Seat 6: qxWFg3MZuVyidB0SJh5ywg folded on the River
Seat 7: F7pnn6czNpHvRM55XcA2EA (button) folded before Flop (didn't bet)
Seat 8: dfNim92Z6XK1/h5SFW5vDg (small blind) folded on the Turn




PokerStars Game #59941659594:  Hold'em No Limit ($0.10/$0.25) - 2009/07/01 1:42:09 ET
Table 'pPgW4R3kdH26lLi1MnE92w' 9-max Seat #7 is the button
Seat 1: F4P6SxCNY4vxdb318G9RwA ($19.60 in chips) 
Seat 2: cZ99hugmLBj9KhTlc8nCSw ($27.50 in chips) 
Seat 3: WaS7+xnv4bIVHoru6nxczA ($13.75 in chips) 
Seat 4: 68iMVGMbYGvnpcCiPOVbbw ($4.65 in chips) 
Seat 5: HPEB+AtKw1+C/cxU0o1ciw ($21.55 in chips) 
Seat 6: VllYilcih0t+gMD4GTRlgQ ($25.65 in chips) 
Seat 7: sD+TKtt36XiiN6jqHiLwDA ($28.45 in chips) 
Seat 8: aCVg6cCxQcqClhB9nq/p1w ($30.95 in chips) 
Seat 9: tcbEu7VzyHQ+0lh+skbQhQ ($63.30 in chips) 
aCVg6cCxQcqClhB9nq/p1w: posts small blind $0.10
tcbEu7VzyHQ+0lh+skbQhQ: posts big blind $0.25
*** HOLE CARDS ***
F4P6SxCNY4vxdb318G9RwA: folds 
cZ99hugmLBj9KhTlc8nCSw: folds 
WaS7+xnv4bIVHoru6nxczA: folds 
68iMVGMbYGvnpcCiPOVbbw: folds 
HPEB+AtKw1+C/cxU0o1ciw: folds 
VllYilcih0t+gMD4GTRlgQ: folds 
sD+TKtt36XiiN6jqHiLwDA: folds 
aCVg6cCxQcqClhB9nq/p1w: calls $0.15
tcbEu7VzyHQ+0lh+skbQhQ: checks 
*** FLOP *** [Kc 8h 5c]
aCVg6cCxQcqClhB9nq/p1w: bets $0.25
tcbEu7VzyHQ+0lh+skbQhQ: calls $0.25
*** TURN *** [Kc 8h 5c] [Qs]
aCVg6cCxQcqClhB9nq/p1w: bets $0.25
tcbEu7VzyHQ+0lh+skbQhQ: calls $0.25
*** RIVER *** [Kc 8h 5c Qs] [3c]
aCVg6cCxQcqClhB9nq/p1w: bets $0.25
tcbEu7VzyHQ+0lh+skbQhQ: calls $0.25
*** SHOW DOWN ***
aCVg6cCxQcqClhB9nq/p1w: shows [2d Js] (high card King)
tcbEu7VzyHQ+0lh+skbQhQ: shows [5s 4h] (a pair of Fives)
tcbEu7VzyHQ+0lh+skbQhQ collected $1.95 from pot
*** SUMMARY ***
Total pot $2 | Rake $0.05 
Board [Kc 8h 5c Qs 3c]
Seat 1: F4P6SxCNY4vxdb318G9RwA folded before Flop (didn't bet)
Seat 2: cZ99hugmLBj9KhTlc8nCSw folded before Flop (didn't bet)
Seat 3: WaS7+xnv4bIVHoru6nxczA folded before Flop (didn't bet)
Seat 4: 68iMVGMbYGvnpcCiPOVbbw folded before Flop (didn't bet)
Seat 5: HPEB+AtKw1+C/cxU0o1ciw folded before Flop (didn't bet)
Seat 6: VllYilcih0t+gMD4GTRlgQ folded before Flop (didn't bet)
Seat 7: sD+TKtt36XiiN6jqHiLwDA (button) folded before Flop (didn't bet)
Seat 8: aCVg6cCxQcqClhB9nq/p1w (small blind) showed [2d Js] and lost with high card King
Seat 9: tcbEu7VzyHQ+0lh+skbQhQ (big blind) showed [5s 4h] and won ($1.95) with a pair of Fives




PokerStars Game #59941659760:  Hold'em No Limit ($0.10/$0.25) - 2009/07/01 1:42:09 ET
Table 'RUOqTfzbAVGS5x+J9aZMHA' 9-max Seat #9 is the button
Seat 1: DnDcAdn9P0zGovMERigpFA ($25 in chips) 
Seat 2: Z5ZtGOON8kmSdSCll9Z3XA ($8.35 in chips) 
Seat 3: Th3FldXKQW6hWVVPahaoOQ ($25 in chips) 
Seat 4: K9Az8li/CO2TicltVWKamA ($40.55 in chips) 
Seat 5: MtVtHDqIJTyUcXkRBBDIVA ($30.90 in chips) 
Seat 6: ljemhp25Zg+nlA9DLCIiUw ($40.05 in chips) 
Seat 7: zgi+EUykT/pZQpoUG6+oEg ($4.30 in chips) 
Seat 8: dfNim92Z6XK1/h5SFW5vDg ($25 in chips) 
Seat 9: cZ99hugmLBj9KhTlc8nCSw ($25 in chips) 
DnDcAdn9P0zGovMERigpFA: posts small blind $0.10
Z5ZtGOON8kmSdSCll9Z3XA: posts big blind $0.25
*** HOLE CARDS ***
Th3FldXKQW6hWVVPahaoOQ: folds 
K9Az8li/CO2TicltVWKamA: folds 
MtVtHDqIJTyUcXkRBBDIVA: raises $0.50 to $0.75
ljemhp25Zg+nlA9DLCIiUw: folds 
zgi+EUykT/pZQpoUG6+oEg: folds 
dfNim92Z6XK1/h5SFW5vDg: raises $1.50 to $2.25
cZ99hugmLBj9KhTlc8nCSw: folds 
DnDcAdn9P0zGovMERigpFA: folds 
Z5ZtGOON8kmSdSCll9Z3XA: folds 
MtVtHDqIJTyUcXkRBBDIVA: calls $1.50
*** FLOP *** [8d 7h Qh]
MtVtHDqIJTyUcXkRBBDIVA: checks 
dfNim92Z6XK1/h5SFW5vDg: checks 
*** TURN *** [8d 7h Qh] [6d]
MtVtHDqIJTyUcXkRBBDIVA: checks 
dfNim92Z6XK1/h5SFW5vDg: checks 
*** RIVER *** [8d 7h Qh 6d] [Qd]
MtVtHDqIJTyUcXkRBBDIVA: checks 
dfNim92Z6XK1/h5SFW5vDg: bets $2
MtVtHDqIJTyUcXkRBBDIVA: calls $2
*** SHOW DOWN ***
dfNim92Z6XK1/h5SFW5vDg: shows [Js Jh] (two pair, Queens and Jacks)
MtVtHDqIJTyUcXkRBBDIVA: mucks hand 
dfNim92Z6XK1/h5SFW5vDg collected $8.45 from pot
*** SUMMARY ***
Total pot $8.85 | Rake $0.40 
Board [8d 7h Qh 6d Qd]
Seat 1: DnDcAdn9P0zGovMERigpFA (small blind) folded before Flop
Seat 2: Z5ZtGOON8kmSdSCll9Z3XA (big blind) folded before Flop
Seat 3: Th3FldXKQW6hWVVPahaoOQ folded before Flop (didn't bet)
Seat 4: K9Az8li/CO2TicltVWKamA folded before Flop (didn't bet)
Seat 5: MtVtHDqIJTyUcXkRBBDIVA mucked
Seat 6: ljemhp25Zg+nlA9DLCIiUw folded before Flop (didn't bet)
Seat 7: zgi+EUykT/pZQpoUG6+oEg folded before Flop (didn't bet)
Seat 8: dfNim92Z6XK1/h5SFW5vDg showed [Js Jh] and won ($8.45) with two pair, Queens and Jacks
Seat 9: cZ99hugmLBj9KhTlc8nCSw (button) folded before Flop (didn't bet)




PokerStars Game #59941660322:  Hold'em No Limit ($0.10/$0.25) - 2009/07/01 1:42:10 ET
Table 'nc6OeGk/wtaWV+6N+kgnZQgZetDqJh6q9A3mLO3ThCsASeat #4 is the button
Seat 1: DihMHaz4WNETH1bPDe13kA ($26.40 in chips) 
Seat 2: JFIAqU8lCZ0vWwEl4bdGsg ($33.40 in chips) 
Seat 3: jp34e617tIzV8tKIWmfAbA ($32.80 in chips) 
Seat 4: BV+K0Phf5VBHr7aZPKqbUQ ($29 in chips) 
5hAPbqNrvJb8PtLiceXtlgEKTLAV1bAterT0Mc1G6lBgl be allowed to play after the button
DihMHaz4WNETH1bPDe13kA: posts small blind $0.10
JFIAqU8lCZ0vWwEl4bdGsg: posts big blind $0.25
*** HOLE CARDS ***
jp34e617tIzV8tKIWmfAbA: folds 
BV+K0Phf5VBHr7aZPKqbUQ: raises $0.50 to $0.75
DihMHaz4WNETH1bPDe13kA: folds 
JFIAqU8lCZ0vWwEl4bdGsg: folds 
Uncalled bet ($0.50) returned to BV+K0Phf5VBHr7aZPKqbUQ
BV+K0Phf5VBHr7aZPKqbUQ collected $0.60 from pot
BV+K0Phf5VBHr7aZPKqbUQ: doesn't show hand 
*** SUMMARY ***
Total pot $0.60 | Rake $0 
Seat 1: DihMHaz4WNETH1bPDe13kA (small blind) folded before Flop
Seat 2: JFIAqU8lCZ0vWwEl4bdGsg (big blind) folded before Flop
Seat 3: jp34e617tIzV8tKIWmfAbA folded before Flop (didn't bet)
Seat 4: BV+K0Phf5VBHr7aZPKqbUQ (button) collected ($0.60)




PokerStars Game #59941660080:  Hold'em No Limit ($0.10/$0.25) - 2009/07/01 1:42:10 ET
Table 'rjcb+nlE+0GuJ6lBhuCkkA' 6-max Seat #5 is the button
Seat 1: lBoEwOFgzcERLIRUkUoRTw ($13.95 in chips) 
Seat 2: lJphax9e7/+O/3YCKPJ0yQ ($5.65 in chips) 
Seat 3: 8ClCHtFXGNplITm+63KB+Q ($66.50 in chips) 
Seat 4: BV+K0Phf5VBHr7aZPKqbUQ ($25 in chips) 
Seat 5: GC/9yVD59DUCX7hUI7gcLw ($41.75 in chips) 
Seat 6: 32YL2ZEp8NT4JB2RVM9euQ ($15.75 in chips) 
32YL2ZEp8NT4JB2RVM9euQ: posts small blind $0.10
lBoEwOFgzcERLIRUkUoRTw: posts big blind $0.25
*** HOLE CARDS ***
lJphax9e7/+O/3YCKPJ0yQ: raises $0.25 to $0.50
8ClCHtFXGNplITm+63KB+Q: folds 
BV+K0Phf5VBHr7aZPKqbUQ: folds 
GC/9yVD59DUCX7hUI7gcLw: folds 
32YL2ZEp8NT4JB2RVM9euQ: folds 
lBoEwOFgzcERLIRUkUoRTw: folds 
Uncalled bet ($0.25) returned to lJphax9e7/+O/3YCKPJ0yQ
lJphax9e7/+O/3YCKPJ0yQ collected $0.60 from pot
*** SUMMARY ***
Total pot $0.60 | Rake $0 
Seat 1: lBoEwOFgzcERLIRUkUoRTw (big blind) folded before Flop
Seat 2: lJphax9e7/+O/3YCKPJ0yQ collected ($0.60)
Seat 3: 8ClCHtFXGNplITm+63KB+Q folded before Flop (didn't bet)
Seat 4: BV+K0Phf5VBHr7aZPKqbUQ folded before Flop (didn't bet)
Seat 5: GC/9yVD59DUCX7hUI7gcLw (button) folded before Flop (didn't bet)
Seat 6: 32YL2ZEp8NT4JB2RVM9euQ (small blind) folded before Flop




PokerStars Game #59941661132:  Hold'em No Limit ($0.10/$0.25) - 2009/07/01 1:42:11 ET
Table 'NtCSSONEf1zaJo3042tQug' 6-max Seat #3 is the button
Seat 1: KXtdqb+rIMkjc0RvHDksGQ ($35.45 in chips) 
Seat 2: vqWjZmdQu/Hxw96/IJTWdQ ($26.95 in chips) 
Seat 3: 9kUKGKkblnIx3m8rlVol6Q ($15.65 in chips) 
Seat 4: HxD1kB8zCmalQSdWAkKmlg ($28.95 in chips) 
Seat 5: tOAk1Og4mVObMBOfvdDYOw ($28.15 in chips) 
Seat 6: LxehwDpTQ19ph4Qmc78+Pw ($31.50 in chips) 
HxD1kB8zCmalQSdWAkKmlg: posts small blind $0.10
tOAk1Og4mVObMBOfvdDYOw: posts big blind $0.25
*** HOLE CARDS ***
LxehwDpTQ19ph4Qmc78+Pw: folds 
KXtdqb+rIMkjc0RvHDksGQ: folds 
vqWjZmdQu/Hxw96/IJTWdQ: raises $0.75 to $1
9kUKGKkblnIx3m8rlVol6Q: folds 
HxD1kB8zCmalQSdWAkKmlg: folds 
tOAk1Og4mVObMBOfvdDYOw: folds 
Uncalled bet ($0.75) returned to vqWjZmdQu/Hxw96/IJTWdQ
vqWjZmdQu/Hxw96/IJTWdQ collected $0.60 from pot
vqWjZmdQu/Hxw96/IJTWdQ: doesn't show hand 
*** SUMMARY ***
Total pot $0.60 | Rake $0 
Seat 1: KXtdqb+rIMkjc0RvHDksGQ folded before Flop (didn't bet)
Seat 2: vqWjZmdQu/Hxw96/IJTWdQ collected ($0.60)
Seat 3: 9kUKGKkblnIx3m8rlVol6Q (button) folded before Flop (didn't bet)
Seat 4: HxD1kB8zCmalQSdWAkKmlg (small blind) folded before Flop
Seat 5: tOAk1Og4mVObMBOfvdDYOw (big blind) folded before Flop
Seat 6: LxehwDpTQ19ph4Qmc78+Pw folded before Flop (didn't bet)




PokerStars Game #59941660692:  Hold'em No Limit ($0.10/$0.25) - 2009/07/01 1:42:11 ET
Table 'IIO2q2znuuAXmiZ2qFTcmg' 6-max Seat #3 is the button
Seat 1: 2G0C7dp4wlPpE21FHjjElQ ($25 in chips) 
Seat 2: cS21pIxRHx5Gt42o7hPZzw ($24.80 in chips) 
Seat 3: L3/N/gliETan8N5Gim5h4Q ($25 in chips) 
Seat 4: tSR4329m40dZsN7YOpI9Kw ($59.35 in chips) 
Seat 5: 9U3ZKjCsarN0DjR6mSE8Ug ($14 in chips) 
Seat 6: aogAb4Eienxztk8p2v9VVw ($36 in chips) 
tSR4329m40dZsN7YOpI9Kw: posts small blind $0.10
9U3ZKjCsarN0DjR6mSE8Ug: posts big blind $0.25
*** HOLE CARDS ***
aogAb4Eienxztk8p2v9VVw: folds 
2G0C7dp4wlPpE21FHjjElQ: folds 
cS21pIxRHx5Gt42o7hPZzw: folds 
L3/N/gliETan8N5Gim5h4Q: folds 
tSR4329m40dZsN7YOpI9Kw: folds 
Uncalled bet ($0.15) returned to 9U3ZKjCsarN0DjR6mSE8Ug
9U3ZKjCsarN0DjR6mSE8Ug collected $0.20 from pot
9U3ZKjCsarN0DjR6mSE8Ug: doesn't show hand 
*** SUMMARY ***
Total pot $0.20 | Rake $0 
Seat 1: 2G0C7dp4wlPpE21FHjjElQ folded before Flop (didn't bet)
Seat 2: cS21pIxRHx5Gt42o7hPZzw folded before Flop (didn't bet)
Seat 3: L3/N/gliETan8N5Gim5h4Q (button) folded before Flop (didn't bet)
Seat 4: tSR4329m40dZsN7YOpI9Kw (small blind) folded before Flop
Seat 5: 9U3ZKjCsarN0DjR6mSE8Ug (big blind) collected ($0.20)
Seat 6: aogAb4Eienxztk8p2v9VVw folded before Flop (didn't bet)




PokerStars Game #59941660954:  Hold'em No Limit ($0.10/$0.25) - 2009/07/01 1:42:11 ET
Table 'MiquQrQZJJq9ZtgRIp9HFQ' 6-max Seat #6 is the button
Seat 1: c3J/KYZ4cNsUEuz8v57I5A ($26 in chips) 
Seat 2: XaIzillDPjW0HcNtCRrgsQ ($4.45 in chips) 
Seat 3: Hsvkc0/G2VV78oVmWYXecw ($6.05 in chips) 
Seat 4: wAKC8C/zN0c8V5v13dm9mA ($57.75 in chips) 
Seat 5: iyZxqznXjv3vtvOJymkoLQ ($27.10 in chips) 
Seat 6: GbCVUNssQ7mqsPWr7J4d3w ($5 in chips) 
c3J/KYZ4cNsUEuz8v57I5A: posts small blind $0.10
XaIzillDPjW0HcNtCRrgsQ: posts big blind $0.25
*** HOLE CARDS ***
Hsvkc0/G2VV78oVmWYXecw: raises $0.50 to $0.75
wAKC8C/zN0c8V5v13dm9mA: folds 
iyZxqznXjv3vtvOJymkoLQ: folds 
GbCVUNssQ7mqsPWr7J4d3w: folds 
c3J/KYZ4cNsUEuz8v57I5A: raises $24.50 to $25.25
XaIzillDPjW0HcNtCRrgsQ: calls $4.20 and is all-in
Hsvkc0/G2VV78oVmWYXecw: calls $5.30 and is all-in
Uncalled bet ($19.20) returned to c3J/KYZ4cNsUEuz8v57I5A
*** FLOP *** [7h Qd 9s]
*** TURN *** [7h Qd 9s] [8d]
*** RIVER *** [7h Qd 9s 8d] [8s]
*** SHOW DOWN ***
c3J/KYZ4cNsUEuz8v57I5A: shows [Jd As] (a pair of Eights)
Hsvkc0/G2VV78oVmWYXecw: shows [Ks Kc] (two pair, Kings and Eights)
Hsvkc0/G2VV78oVmWYXecw collected $3.05 from side pot
XaIzillDPjW0HcNtCRrgsQ: mucks hand 
XaIzillDPjW0HcNtCRrgsQ leaves the table
Hsvkc0/G2VV78oVmWYXecw collected $12.70 from main pot
*** SUMMARY ***
Total pot $16.55 Main pot $12.70. Side pot $3.05. | Rake $0.80 
Board [7h Qd 9s 8d 8s]
Seat 1: c3J/KYZ4cNsUEuz8v57I5A (small blind) showed [Jd As] and lost with a pair of Eights
Seat 2: XaIzillDPjW0HcNtCRrgsQ (big blind) mucked
Seat 3: Hsvkc0/G2VV78oVmWYXecw showed [Ks Kc] and won ($15.75) with two pair, Kings and Eights
Seat 4: wAKC8C/zN0c8V5v13dm9mA folded before Flop (didn't bet)
Seat 5: iyZxqznXjv3vtvOJymkoLQ folded before Flop (didn't bet)
Seat 6: GbCVUNssQ7mqsPWr7J4d3w (button) folded before Flop (didn't bet)




PokerStars Game #59941660824:  Hold'em No Limit ($0.10/$0.25) - 2009/07/01 1:42:11 ET
Table 'XX2OuOsa8/8AC+/mR/Az6g' 9-max Seat #2 is the button
Seat 1: 56S3mA6Zs3pGR+0p0vUCtg ($26.15 in chips) 
Seat 2: Bb42QRQMhg5/Y0vHP8/2Xw ($26.15 in chips) 
Seat 3: oLa/tXLfSLLB28mcLGrxcg ($24.75 in chips) 
Seat 4: 52uIvr1a/mxEYD1W0ESvdQ ($25.70 in chips) 
Seat 5: SpiiQQAzy4MUgV3I5W8giw ($21.50 in chips) 
Seat 8: qwr38jl5txoR36M7G5qi4A ($10.35 in chips) 
Seat 9: V6p0jQ/RhUsqpHLmXvEX4Q ($11.15 in chips) 
oLa/tXLfSLLB28mcLGrxcg: posts small blind $0.10
52uIvr1a/mxEYD1W0ESvdQ: posts big blind $0.25
RCqMONFrSPSArZh2Jsar/w: sits out 
*** HOLE CARDS ***
SpiiQQAzy4MUgV3I5W8giw: folds 
qwr38jl5txoR36M7G5qi4A: folds 
V6p0jQ/RhUsqpHLmXvEX4Q: folds 
56S3mA6Zs3pGR+0p0vUCtg: folds 
Bb42QRQMhg5/Y0vHP8/2Xw: calls $0.25
oLa/tXLfSLLB28mcLGrxcg: calls $0.15
52uIvr1a/mxEYD1W0ESvdQ: checks 
*** FLOP *** [Jh 2d Th]
oLa/tXLfSLLB28mcLGrxcg: bets $0.25
52uIvr1a/mxEYD1W0ESvdQ: calls $0.25
Bb42QRQMhg5/Y0vHP8/2Xw: raises $1 to $1.25
oLa/tXLfSLLB28mcLGrxcg: folds 
52uIvr1a/mxEYD1W0ESvdQ: folds 
Uncalled bet ($1) returned to Bb42QRQMhg5/Y0vHP8/2Xw
Bb42QRQMhg5/Y0vHP8/2Xw collected $1.45 from pot
*** SUMMARY ***
Total pot $1.50 | Rake $0.05 
Board [Jh 2d Th]
Seat 1: 56S3mA6Zs3pGR+0p0vUCtg folded before Flop (didn't bet)
Seat 2: Bb42QRQMhg5/Y0vHP8/2Xw (button) collected ($1.45)
Seat 3: oLa/tXLfSLLB28mcLGrxcg (small blind) folded on the Flop
Seat 4: 52uIvr1a/mxEYD1W0ESvdQ (big blind) folded on the Flop
Seat 5: SpiiQQAzy4MUgV3I5W8giw folded before Flop (didn't bet)
Seat 8: qwr38jl5txoR36M7G5qi4A folded before Flop (didn't bet)
Seat 9: V6p0jQ/RhUsqpHLmXvEX4Q folded before Flop (didn't bet)




PokerStars Game #59941661062:  Hold'em No Limit ($0.10/$0.25) - 2009/07/01 1:42:11 ET
Table 'Y9EhDWuqWWQFM9SelXAj5g' 9-max Seat #7 is the button
Seat 2: W+njF1UnarGN2q2zP+R+cg ($10 in chips) 
Seat 3: zgi+EUykT/pZQpoUG6+oEg ($7.40 in chips) 
Seat 4: V6p0jQ/RhUsqpHLmXvEX4Q ($13.35 in chips) 
Seat 5: CvL9Ch1HYCVbTsfpNucitg ($5.45 in chips) 
Seat 6: egvg3mTBBVzMHnJPIQiKcA ($14 in chips) 
Seat 7: aNpwfA31EREwO+ar4XzBCw ($26.60 in chips) 
Seat 8: XDxyajtqmdag0QPvwcOG7Q ($13.10 in chips) 
Seat 9: bOrfviVhRBpaOfMqUc74Tw ($18.90 in chips) 
XDxyajtqmdag0QPvwcOG7Q: posts small blind $0.10
bOrfviVhRBpaOfMqUc74Tw: posts big blind $0.25
W+njF1UnarGN2q2zP+R+cg: posts big blind $0.25
*** HOLE CARDS ***
W+njF1UnarGN2q2zP+R+cg: checks 
zgi+EUykT/pZQpoUG6+oEg: folds 
V6p0jQ/RhUsqpHLmXvEX4Q: folds 
CvL9Ch1HYCVbTsfpNucitg: folds 
egvg3mTBBVzMHnJPIQiKcA: folds 
aNpwfA31EREwO+ar4XzBCw: folds 
W+njF1UnarGN2q2zP+R+cg said, "zzzzzzzz"
XDxyajtqmdag0QPvwcOG7Q: raises $0.75 to $1
bOrfviVhRBpaOfMqUc74Tw: calls $0.75
W+njF1UnarGN2q2zP+R+cg: calls $0.75
*** FLOP *** [Jc 3c 3s]
XDxyajtqmdag0QPvwcOG7Q: bets $1
bOrfviVhRBpaOfMqUc74Tw: calls $1
W+njF1UnarGN2q2zP+R+cg: folds 
*** TURN *** [Jc 3c 3s] [Jh]
XDxyajtqmdag0QPvwcOG7Q: checks 
bOrfviVhRBpaOfMqUc74Tw: bets $2
XDxyajtqmdag0QPvwcOG7Q: folds 
Uncalled bet ($2) returned to bOrfviVhRBpaOfMqUc74Tw
bOrfviVhRBpaOfMqUc74Tw collected $4.80 from pot
bOrfviVhRBpaOfMqUc74Tw: doesn't show hand 
*** SUMMARY ***
Total pot $5 | Rake $0.20 
Board [Jc 3c 3s Jh]
Seat 2: W+njF1UnarGN2q2zP+R+cg folded on the Flop
Seat 3: zgi+EUykT/pZQpoUG6+oEg folded before Flop (didn't bet)
Seat 4: V6p0jQ/RhUsqpHLmXvEX4Q folded before Flop (didn't bet)
Seat 5: CvL9Ch1HYCVbTsfpNucitg folded before Flop (didn't bet)
Seat 6: egvg3mTBBVzMHnJPIQiKcA folded before Flop (didn't bet)
Seat 7: aNpwfA31EREwO+ar4XzBCw (button) folded before Flop (didn't bet)
Seat 8: XDxyajtqmdag0QPvwcOG7Q (small blind) folded on the Turn
Seat 9: bOrfviVhRBpaOfMqUc74Tw (big blind) collected ($4.80)




PokerStars Game #59941660648:  Hold'em No Limit ($0.10/$0.25) - 2009/07/01 1:42:11 ET
Table 'BabJGL6tfXQp3leBGbYe8A' 9-max Seat #8 is the button
Seat 1: qwr38jl5txoR36M7G5qi4A ($8 in chips) 
Seat 2: dtZ84flFEi4Q+SGrHMJRDQ ($36 in chips) 
Seat 3: sD+TKtt36XiiN6jqHiLwDA ($25.20 in chips) 
Seat 4: gehe91e0IyVT0QU/XBkEyg ($28.45 in chips) 
Seat 5: GrNTWMdwy+jC6Lred1eDng ($15 in chips) 
Seat 6: egvg3mTBBVzMHnJPIQiKcA ($14.15 in chips) 
Seat 7: eK8qa6EPcH2zhtbmWSvc9g ($27.85 in chips) 
Seat 8: OgISYvc5hA85YuDnsXCH+Q ($21.90 in chips) 
Seat 9: P+9ymZQ3ktpQu1bn7HIjew ($9.75 in chips) 
P+9ymZQ3ktpQu1bn7HIjew: posts small blind $0.10
qwr38jl5txoR36M7G5qi4A: posts big blind $0.25
*** HOLE CARDS ***
dtZ84flFEi4Q+SGrHMJRDQ: folds 
sD+TKtt36XiiN6jqHiLwDA: calls $0.25
gehe91e0IyVT0QU/XBkEyg: folds 
GrNTWMdwy+jC6Lred1eDng: folds 
egvg3mTBBVzMHnJPIQiKcA: folds 
eK8qa6EPcH2zhtbmWSvc9g: folds 
OgISYvc5hA85YuDnsXCH+Q: folds 
P+9ymZQ3ktpQu1bn7HIjew: calls $0.15
qwr38jl5txoR36M7G5qi4A: checks 
*** FLOP *** [Qh 3d 6s]
P+9ymZQ3ktpQu1bn7HIjew: checks 
qwr38jl5txoR36M7G5qi4A: checks 
sD+TKtt36XiiN6jqHiLwDA: bets $1
P+9ymZQ3ktpQu1bn7HIjew: folds 
OgISYvc5hA85YuDnsXCH+Q leaves the table
qwr38jl5txoR36M7G5qi4A: folds 
Uncalled bet ($1) returned to sD+TKtt36XiiN6jqHiLwDA
sD+TKtt36XiiN6jqHiLwDA collected $0.75 from pot
sD+TKtt36XiiN6jqHiLwDA: doesn't show hand 
*** SUMMARY ***
Total pot $0.75 | Rake $0 
Board [Qh 3d 6s]
Seat 1: qwr38jl5txoR36M7G5qi4A (big blind) folded on the Flop
Seat 2: dtZ84flFEi4Q+SGrHMJRDQ folded before Flop (didn't bet)
Seat 3: sD+TKtt36XiiN6jqHiLwDA collected ($0.75)
Seat 4: gehe91e0IyVT0QU/XBkEyg folded before Flop (didn't bet)
Seat 5: GrNTWMdwy+jC6Lred1eDng folded before Flop (didn't bet)
Seat 6: egvg3mTBBVzMHnJPIQiKcA folded before Flop (didn't bet)
Seat 7: eK8qa6EPcH2zhtbmWSvc9g folded before Flop (didn't bet)
Seat 8: OgISYvc5hA85YuDnsXCH+Q (button) folded before Flop (didn't bet)
Seat 9: P+9ymZQ3ktpQu1bn7HIjew (small blind) folded on the Flop




PokerStars Game #59941661278:  Hold'em No Limit ($0.10/$0.25) - 2009/07/01 1:42:12 ET
Table 'Yb2CyZosw7N3yRRVLhKnKg' 9-max Seat #7 is the button
Seat 1: c/9X4zftzphFxYtxp5kp9w ($13.65 in chips) 
Seat 2: dtZ84flFEi4Q+SGrHMJRDQ ($26.65 in chips) 
Seat 3: I8/fpJ2v6LsVf0kxqaVdMQ ($16.50 in chips) 
Seat 4: FG10kumpruEJ3PQJ7oGglQ ($11.35 in chips) 
Seat 5: T5Hk9oiIr+JDDMnEqwFCrw ($3.25 in chips) 
Seat 6: CgIo2ItZqi4o3ayVG6HanQ ($44.95 in chips) 
Seat 7: ljemhp25Zg+nlA9DLCIiUw ($26.85 in chips) 
Seat 8: HxDF4QSxC4z39D7teZpprQ ($10.85 in chips) 
Seat 9: 6DVf3fwEGECnjQ4Yp9AsFw ($15.85 in chips) 
HxDF4QSxC4z39D7teZpprQ: posts small blind $0.10
6DVf3fwEGECnjQ4Yp9AsFw: posts big blind $0.25
*** HOLE CARDS ***
c/9X4zftzphFxYtxp5kp9w: raises $0.75 to $1
dtZ84flFEi4Q+SGrHMJRDQ: folds 
I8/fpJ2v6LsVf0kxqaVdMQ: folds 
FG10kumpruEJ3PQJ7oGglQ: folds 
T5Hk9oiIr+JDDMnEqwFCrw: calls $1
CgIo2ItZqi4o3ayVG6HanQ: folds 
ljemhp25Zg+nlA9DLCIiUw: folds 
HxDF4QSxC4z39D7teZpprQ: folds 
6DVf3fwEGECnjQ4Yp9AsFw: folds 
*** FLOP *** [Jh Kc Jc]
c/9X4zftzphFxYtxp5kp9w: checks 
T5Hk9oiIr+JDDMnEqwFCrw: checks 
*** TURN *** [Jh Kc Jc] [Kh]
c/9X4zftzphFxYtxp5kp9w: checks 
T5Hk9oiIr+JDDMnEqwFCrw: checks 
*** RIVER *** [Jh Kc Jc Kh] [3h]
c/9X4zftzphFxYtxp5kp9w: bets $2
T5Hk9oiIr+JDDMnEqwFCrw: folds 
Uncalled bet ($2) returned to c/9X4zftzphFxYtxp5kp9w
c/9X4zftzphFxYtxp5kp9w collected $2.25 from pot
*** SUMMARY ***
Total pot $2.35 | Rake $0.10 
Board [Jh Kc Jc Kh 3h]
Seat 1: c/9X4zftzphFxYtxp5kp9w collected ($2.25)
Seat 2: dtZ84flFEi4Q+SGrHMJRDQ folded before Flop (didn't bet)
Seat 3: I8/fpJ2v6LsVf0kxqaVdMQ folded before Flop (didn't bet)
Seat 4: FG10kumpruEJ3PQJ7oGglQ folded before Flop (didn't bet)
Seat 5: T5Hk9oiIr+JDDMnEqwFCrw folded on the River
Seat 6: CgIo2ItZqi4o3ayVG6HanQ folded before Flop (didn't bet)
Seat 7: ljemhp25Zg+nlA9DLCIiUw (button) folded before Flop (didn't bet)
Seat 8: HxDF4QSxC4z39D7teZpprQ (small blind) folded before Flop
Seat 9: 6DVf3fwEGECnjQ4Yp9AsFw (big blind) folded before Flop




PokerStars Game #59941661480:  Hold'em No Limit ($0.10/$0.25) - 2009/07/01 1:42:12 ET
Table 'QzXakDK7ZHNjgIpoUFGSKQ' 9-max Seat #9 is the button
Seat 1: w1ukf8uPa4+WH561TtVRxA ($28.80 in chips) 
Seat 2: QEbIGci+itdw+re8RM5fZA ($25 in chips) 
Seat 3: eK8qa6EPcH2zhtbmWSvc9g ($25.65 in chips) 
Seat 4: 12pxJGeALcKLTBryE6kFxA ($12.95 in chips) 
Seat 5: MtVtHDqIJTyUcXkRBBDIVA ($25 in chips) 
Seat 6: gehe91e0IyVT0QU/XBkEyg ($25 in chips) 
Seat 7: wGigCmBR/9XWkPpvYos3aQ ($29.90 in chips) 
Seat 9: lwrOE80tuooHfIBx/4LUSw ($25.90 in chips) 
w1ukf8uPa4+WH561TtVRxA: posts small blind $0.10
QEbIGci+itdw+re8RM5fZA: posts big blind $0.25
Z9W7+g1WMhhZDi7DwGbCFA: sits out 
*** HOLE CARDS ***
eK8qa6EPcH2zhtbmWSvc9g: folds 
12pxJGeALcKLTBryE6kFxA: raises $0.25 to $0.50
MtVtHDqIJTyUcXkRBBDIVA: calls $0.50
gehe91e0IyVT0QU/XBkEyg: calls $0.50
wGigCmBR/9XWkPpvYos3aQ: folds 
lwrOE80tuooHfIBx/4LUSw: calls $0.50
w1ukf8uPa4+WH561TtVRxA: folds 
QEbIGci+itdw+re8RM5fZA: folds 
*** FLOP *** [2h Ac 2c]
12pxJGeALcKLTBryE6kFxA: checks 
MtVtHDqIJTyUcXkRBBDIVA: checks 
gehe91e0IyVT0QU/XBkEyg: checks 
lwrOE80tuooHfIBx/4LUSw: bets $1.25
12pxJGeALcKLTBryE6kFxA: folds 
MtVtHDqIJTyUcXkRBBDIVA: calls $1.25
gehe91e0IyVT0QU/XBkEyg: folds 
*** TURN *** [2h Ac 2c] [Th]
MtVtHDqIJTyUcXkRBBDIVA: checks 
lwrOE80tuooHfIBx/4LUSw: checks 
*** RIVER *** [2h Ac 2c Th] [7d]
MtVtHDqIJTyUcXkRBBDIVA: checks 
lwrOE80tuooHfIBx/4LUSw: checks 
*** SHOW DOWN ***
MtVtHDqIJTyUcXkRBBDIVA: shows [5d Ad] (two pair, Aces and Deuces)
lwrOE80tuooHfIBx/4LUSw: mucks hand 
MtVtHDqIJTyUcXkRBBDIVA collected $4.65 from pot
*** SUMMARY ***
Total pot $4.85 | Rake $0.20 
Board [2h Ac 2c Th 7d]
Seat 1: w1ukf8uPa4+WH561TtVRxA (small blind) folded before Flop
Seat 2: QEbIGci+itdw+re8RM5fZA (big blind) folded before Flop
Seat 3: eK8qa6EPcH2zhtbmWSvc9g folded before Flop (didn't bet)
Seat 4: 12pxJGeALcKLTBryE6kFxA folded on the Flop
Seat 5: MtVtHDqIJTyUcXkRBBDIVA showed [5d Ad] and won ($4.65) with two pair, Aces and Deuces
Seat 6: gehe91e0IyVT0QU/XBkEyg folded on the Flop
Seat 7: wGigCmBR/9XWkPpvYos3aQ folded before Flop (didn't bet)
Seat 9: lwrOE80tuooHfIBx/4LUSw (button) mucked




PokerStars Game #59941661618:  Hold'em No Limit ($0.10/$0.25) - 2009/07/01 1:42:12 ET
Table 'yAHDCs33TIgw3ra63xuU2Q' 9-max Seat #6 is the button
Seat 1: ydoFOVgzvZv9ZhuWu9rXAw ($4.90 in chips) 
Seat 3: g6UPjSyxNLffCi+EqqIlEg ($21 in chips) 
Seat 4: j5spkbnOCRiLGiH6iqBaqw ($8.25 in chips) 
Seat 5: 4awUyiDYTgylQKXZ9faBVA ($37.60 in chips) 
Seat 6: DnDcAdn9P0zGovMERigpFA ($26.30 in chips) 
Seat 7: qxWFg3MZuVyidB0SJh5ywg ($27.50 in chips) 
Seat 8: tYsOBqdU1+x+yFI7zHO7hQ ($25 in chips) 
Seat 9: MtVtHDqIJTyUcXkRBBDIVA ($25.05 in chips) 
qxWFg3MZuVyidB0SJh5ywg: posts small blind $0.10
tYsOBqdU1+x+yFI7zHO7hQ: posts big blind $0.25
*** HOLE CARDS ***
MtVtHDqIJTyUcXkRBBDIVA: folds 
ydoFOVgzvZv9ZhuWu9rXAw: folds 
g6UPjSyxNLffCi+EqqIlEg: folds 
j5spkbnOCRiLGiH6iqBaqw: folds 
4awUyiDYTgylQKXZ9faBVA: folds 
DnDcAdn9P0zGovMERigpFA: folds 
qxWFg3MZuVyidB0SJh5ywg: raises $0.75 to $1
tYsOBqdU1+x+yFI7zHO7hQ: folds 
Uncalled bet ($0.75) returned to qxWFg3MZuVyidB0SJh5ywg
qxWFg3MZuVyidB0SJh5ywg collected $0.50 from pot
*** SUMMARY ***
Total pot $0.50 | Rake $0 
Seat 1: ydoFOVgzvZv9ZhuWu9rXAw folded before Flop (didn't bet)
Seat 3: g6UPjSyxNLffCi+EqqIlEg folded before Flop (didn't bet)
Seat 4: j5spkbnOCRiLGiH6iqBaqw folded before Flop (didn't bet)
Seat 5: 4awUyiDYTgylQKXZ9faBVA folded before Flop (didn't bet)
Seat 6: DnDcAdn9P0zGovMERigpFA (button) folded before Flop (didn't bet)
Seat 7: qxWFg3MZuVyidB0SJh5ywg (small blind) collected ($0.50)
Seat 8: tYsOBqdU1+x+yFI7zHO7hQ (big blind) folded before Flop
Seat 9: MtVtHDqIJTyUcXkRBBDIVA folded before Flop (didn't bet)




PokerStars Game #59941661622:  Hold'em No Limit ($0.10/$0.25) - 2009/07/01 1:42:12 ET
Table 'aaXqTKUnxrX9DYXtxhWXxA' 6-max Seat #6 is the button
Seat 1: rnpAao581IcvQglpkpnkoQ ($8.10 in chips) 
Seat 2: DE9hRlt14g+JdsRQ4wT7hg ($34.05 in chips) 
Seat 4: 48oT5xFI+5CHUJlfoGrE4w ($10.55 in chips) 
Seat 5: kyRaCIljYA6l33lSKQfNsg ($25 in chips) 
Seat 6: buyjetgNT1McXtdaP4zynA ($48.20 in chips) 
rnpAao581IcvQglpkpnkoQ: posts small blind $0.10
DE9hRlt14g+JdsRQ4wT7hg: posts big blind $0.25
uUXdcVMNa05rfbntdvplfw: sits out 
*** HOLE CARDS ***
48oT5xFI+5CHUJlfoGrE4w: raises $0.25 to $0.50
kyRaCIljYA6l33lSKQfNsg: folds 
buyjetgNT1McXtdaP4zynA: folds 
rnpAao581IcvQglpkpnkoQ: folds 
DE9hRlt14g+JdsRQ4wT7hg: folds 
Uncalled bet ($0.25) returned to 48oT5xFI+5CHUJlfoGrE4w
48oT5xFI+5CHUJlfoGrE4w collected $0.60 from pot
48oT5xFI+5CHUJlfoGrE4w: doesn't show hand 
*** SUMMARY ***
Total pot $0.60 | Rake $0 
Seat 1: rnpAao581IcvQglpkpnkoQ (small blind) folded before Flop
Seat 2: DE9hRlt14g+JdsRQ4wT7hg (big blind) folded before Flop
Seat 4: 48oT5xFI+5CHUJlfoGrE4w collected ($0.60)
Seat 5: kyRaCIljYA6l33lSKQfNsg folded before Flop (didn't bet)
Seat 6: buyjetgNT1McXtdaP4zynA (button) folded before Flop (didn't bet)




PokerStars Game #59941661214:  Hold'em No Limit ($0.10/$0.25) - 2009/07/01 1:42:12 ET
Table 'HzFR0rxmDAPu5GzYR0AlYg' 6-max Seat #2 is the button
Seat 1: v+QfkGiuj9bgtuNoVnDO8w ($30.30 in chips) 
Seat 2: UA5OsKS3VPaxa7uC8La/kA ($53 in chips) 
Seat 3: kG34n23qFQA3nzdOJTQ1dA ($24.75 in chips) 
Seat 5: lquriepNQBhDV5P1SWHhnA ($30.20 in chips) 
Seat 6: jp34e617tIzV8tKIWmfAbA ($34.50 in chips) 
kG34n23qFQA3nzdOJTQ1dA: posts small blind $0.10
lquriepNQBhDV5P1SWHhnA: posts big blind $0.25
*** HOLE CARDS ***
jp34e617tIzV8tKIWmfAbA: raises $0.50 to $0.75
v+QfkGiuj9bgtuNoVnDO8w: folds 
UA5OsKS3VPaxa7uC8La/kA: folds 
kG34n23qFQA3nzdOJTQ1dA: folds 
lquriepNQBhDV5P1SWHhnA: folds 
Uncalled bet ($0.50) returned to jp34e617tIzV8tKIWmfAbA
jp34e617tIzV8tKIWmfAbA collected $0.60 from pot
jp34e617tIzV8tKIWmfAbA: doesn't show hand 
StevenWu joins the table at seat #4 
*** SUMMARY ***
Total pot $0.60 | Rake $0 
Seat 1: v+QfkGiuj9bgtuNoVnDO8w folded before Flop (didn't bet)
Seat 2: UA5OsKS3VPaxa7uC8La/kA (button) folded before Flop (didn't bet)
Seat 3: kG34n23qFQA3nzdOJTQ1dA (small blind) folded before Flop
Seat 5: lquriepNQBhDV5P1SWHhnA (big blind) folded before Flop
Seat 6: jp34e617tIzV8tKIWmfAbA collected ($0.60)




PokerStars Game #59941661452:  Hold'em No Limit ($0.10/$0.25) - 2009/07/01 1:42:12 ET
Table 'Qr+t8WGovMECkBv+cV1lrg' 6-max Seat #6 is the button
Seat 1: EeUZtMU058v2ObUACOF4Og ($51.35 in chips) 
Seat 3: uZKkrGByYgd4/ZBX2d4z+w ($22.35 in chips) 
Seat 4: 1NNFfYMd5Hsphl/FYz9fNA ($60.20 in chips) 
Seat 5: 9q7YGTKe9k5fYb4fmZc3Ww ($32.35 in chips) 
Seat 6: xRkU4+naLuz7dEZFbOn9cw ($24.65 in chips) 
EeUZtMU058v2ObUACOF4Og: posts small blind $0.10
GJsS3gwVwlbyroaWrnjqJg: is sitting out 
uZKkrGByYgd4/ZBX2d4z+w: posts big blind $0.25
*** HOLE CARDS ***
1NNFfYMd5Hsphl/FYz9fNA: folds 
9q7YGTKe9k5fYb4fmZc3Ww: raises $0.50 to $0.75
xRkU4+naLuz7dEZFbOn9cw: folds 
GJsS3gwVwlbyroaWrnjqJg leaves the table
EeUZtMU058v2ObUACOF4Og: folds 
uZKkrGByYgd4/ZBX2d4z+w: folds 
Uncalled bet ($0.50) returned to 9q7YGTKe9k5fYb4fmZc3Ww
9q7YGTKe9k5fYb4fmZc3Ww collected $0.60 from pot
*** SUMMARY ***
Total pot $0.60 | Rake $0 
Seat 1: EeUZtMU058v2ObUACOF4Og (small blind) folded before Flop
Seat 3: uZKkrGByYgd4/ZBX2d4z+w (big blind) folded before Flop
Seat 4: 1NNFfYMd5Hsphl/FYz9fNA folded before Flop (didn't bet)
Seat 5: 9q7YGTKe9k5fYb4fmZc3Ww collected ($0.60)
Seat 6: xRkU4+naLuz7dEZFbOn9cw (button) folded before Flop (didn't bet)




PokerStars Game #59941661258:  Hold'em No Limit ($0.10/$0.25) - 2009/07/01 1:42:12 ET
Table 'S6s+TmTlAjLHclBRvN5/fw' 9-max Seat #6 is the button
Seat 3: z2SmIaQ3+5n/eY1BN5HgPg ($5.95 in chips) 
Seat 4: hO0e1+SO2lX0hqBn3Z/9KQ ($5 in chips) 
Seat 5: z5GxcHlYz/GSz6W2uFiTtg ($39.55 in chips) 
Seat 6: aNpwfA31EREwO+ar4XzBCw ($28.30 in chips) 
Seat 8: OlPJsgR4xypSg/w1z7Gyvw ($23 in chips) 
OlPJsgR4xypSg/w1z7Gyvw: posts small blind $0.10
z2SmIaQ3+5n/eY1BN5HgPg: posts big blind $0.25
hO0e1+SO2lX0hqBn3Z/9KQ: posts big blind $0.25
*** HOLE CARDS ***
hO0e1+SO2lX0hqBn3Z/9KQ: checks 
X6+pSIPfovPcE87t+LmUKQ joins the table at seat #7 
z5GxcHlYz/GSz6W2uFiTtg: folds 
aNpwfA31EREwO+ar4XzBCw: raises $1 to $1.25
OlPJsgR4xypSg/w1z7Gyvw: folds 
z2SmIaQ3+5n/eY1BN5HgPg: calls $1
hO0e1+SO2lX0hqBn3Z/9KQ: raises $3.75 to $5 and is all-in
aNpwfA31EREwO+ar4XzBCw: raises $3.75 to $8.75
z2SmIaQ3+5n/eY1BN5HgPg: folds 
Uncalled bet ($3.75) returned to aNpwfA31EREwO+ar4XzBCw
*** FLOP *** [Qd 5s Qh]
*** TURN *** [Qd 5s Qh] [Jh]
*** RIVER *** [Qd 5s Qh Jh] [6h]
*** SHOW DOWN ***
hO0e1+SO2lX0hqBn3Z/9KQ: shows [7c 5h] (two pair, Queens and Fives)
aNpwfA31EREwO+ar4XzBCw: shows [Ad As] (two pair, Aces and Queens)
aNpwfA31EREwO+ar4XzBCw collected $10.80 from pot
*** SUMMARY ***
Total pot $11.35 | Rake $0.55 
Board [Qd 5s Qh Jh 6h]
Seat 3: z2SmIaQ3+5n/eY1BN5HgPg (big blind) folded before Flop
Seat 4: hO0e1+SO2lX0hqBn3Z/9KQ showed [7c 5h] and lost with two pair, Queens and Fives
Seat 5: z5GxcHlYz/GSz6W2uFiTtg folded before Flop (didn't bet)
Seat 6: aNpwfA31EREwO+ar4XzBCw (button) showed [Ad As] and won ($10.80) with two pair, Aces and Queens
Seat 8: OlPJsgR4xypSg/w1z7Gyvw (small blind) folded before Flop




PokerStars Game #59941661654:  Hold'em No Limit ($0.10/$0.25) - 2009/07/01 1:42:12 ET
Table 'wGizWOswEL6P5QrvVkno/g' 6-max Seat #2 is the button
Seat 1: Qbfkn+ucISvbd1Xh32zAGA ($24.65 in chips) 
Seat 2: mfrkWA3PTeYPkbO6hi98Aw ($25 in chips) 
Seat 3: bJFzs6QmEEnz4miMfSDtcg ($14.50 in chips) 
Seat 4: 32YL2ZEp8NT4JB2RVM9euQ ($16.65 in chips) 
Seat 5: wsP46AGpqDjHZQmlRHKa9g ($39.40 in chips) 
Seat 6: rfSnsAuAfXTb8w/obc9OVQ ($7.90 in chips) 
bJFzs6QmEEnz4miMfSDtcg: posts small blind $0.10
32YL2ZEp8NT4JB2RVM9euQ: posts big blind $0.25
*** HOLE CARDS ***
wsP46AGpqDjHZQmlRHKa9g: folds 
rfSnsAuAfXTb8w/obc9OVQ: calls $0.25
Qbfkn+ucISvbd1Xh32zAGA: folds 
mfrkWA3PTeYPkbO6hi98Aw: folds 
bJFzs6QmEEnz4miMfSDtcg: folds 
32YL2ZEp8NT4JB2RVM9euQ: checks 
*** FLOP *** [5s Ad 9c]
32YL2ZEp8NT4JB2RVM9euQ: checks 
rfSnsAuAfXTb8w/obc9OVQ: bets $0.75
32YL2ZEp8NT4JB2RVM9euQ: folds 
Uncalled bet ($0.75) returned to rfSnsAuAfXTb8w/obc9OVQ
rfSnsAuAfXTb8w/obc9OVQ collected $0.60 from pot
rfSnsAuAfXTb8w/obc9OVQ: doesn't show hand 
*** SUMMARY ***
Total pot $0.60 | Rake $0 
Board [5s Ad 9c]
Seat 1: Qbfkn+ucISvbd1Xh32zAGA folded before Flop (didn't bet)
Seat 2: mfrkWA3PTeYPkbO6hi98Aw (button) folded before Flop (didn't bet)
Seat 3: bJFzs6QmEEnz4miMfSDtcg (small blind) folded before Flop
Seat 4: 32YL2ZEp8NT4JB2RVM9euQ (big blind) folded on the Flop
Seat 5: wsP46AGpqDjHZQmlRHKa9g folded before Flop (didn't bet)
Seat 6: rfSnsAuAfXTb8w/obc9OVQ collected ($0.60)




PokerStars Game #59941661626:  Hold'em No Limit ($0.10/$0.25) - 2009/07/01 1:42:12 ET
Table 'BpNkESDX1ip9c0K1hb5h7A' 6-max Seat #5 is the button
Seat 1: 5YZdVjBPZVEdubN4xEMPEg ($33.75 in chips) 
Seat 2: g+5jEA4Xq9vcMOfdFYNuFA ($10.70 in chips) 
Seat 3: fZQg9veL7Dd/Z04ZTjC+wQ ($25.60 in chips) 
Seat 4: kG34n23qFQA3nzdOJTQ1dA ($25.90 in chips) 
Seat 5: L3/N/gliETan8N5Gim5h4Q ($25.75 in chips) 
Seat 6: 8EEqTTh7T1q48sYDqbI2Xg ($21.40 in chips) 
8EEqTTh7T1q48sYDqbI2Xg: posts small blind $0.10
5YZdVjBPZVEdubN4xEMPEg: posts big blind $0.25
*** HOLE CARDS ***
g+5jEA4Xq9vcMOfdFYNuFA: calls $0.25
fZQg9veL7Dd/Z04ZTjC+wQ: calls $0.25
kG34n23qFQA3nzdOJTQ1dA: folds 
L3/N/gliETan8N5Gim5h4Q: folds 
8EEqTTh7T1q48sYDqbI2Xg: calls $0.15
5YZdVjBPZVEdubN4xEMPEg: checks 
*** FLOP *** [8s 6h 2d]
8EEqTTh7T1q48sYDqbI2Xg: checks 
5YZdVjBPZVEdubN4xEMPEg: checks 
g+5jEA4Xq9vcMOfdFYNuFA: bets $0.50
fZQg9veL7Dd/Z04ZTjC+wQ: raises $1.50 to $2
8EEqTTh7T1q48sYDqbI2Xg: folds 
5YZdVjBPZVEdubN4xEMPEg: folds 
g+5jEA4Xq9vcMOfdFYNuFA: calls $1.50
*** TURN *** [8s 6h 2d] [Jh]
g+5jEA4Xq9vcMOfdFYNuFA: checks 
fZQg9veL7Dd/Z04ZTjC+wQ: checks 
*** RIVER *** [8s 6h 2d Jh] [Jc]
g+5jEA4Xq9vcMOfdFYNuFA: checks 
fZQg9veL7Dd/Z04ZTjC+wQ: bets $0.25
g+5jEA4Xq9vcMOfdFYNuFA: calls $0.25
*** SHOW DOWN ***
fZQg9veL7Dd/Z04ZTjC+wQ: shows [8h 7h] (two pair, Jacks and Eights)
g+5jEA4Xq9vcMOfdFYNuFA: shows [8c 7c] (two pair, Jacks and Eights)
g+5jEA4Xq9vcMOfdFYNuFA collected $2.65 from pot
fZQg9veL7Dd/Z04ZTjC+wQ collected $2.60 from pot
*** SUMMARY ***
Total pot $5.50 | Rake $0.25 
Board [8s 6h 2d Jh Jc]
Seat 1: 5YZdVjBPZVEdubN4xEMPEg (big blind) folded on the Flop
Seat 2: g+5jEA4Xq9vcMOfdFYNuFA showed [8c 7c] and won ($2.65) with two pair, Jacks and Eights
Seat 3: fZQg9veL7Dd/Z04ZTjC+wQ showed [8h 7h] and won ($2.60) with two pair, Jacks and Eights
Seat 4: kG34n23qFQA3nzdOJTQ1dA folded before Flop (didn't bet)
Seat 5: L3/N/gliETan8N5Gim5h4Q (button) folded before Flop (didn't bet)
Seat 6: 8EEqTTh7T1q48sYDqbI2Xg (small blind) folded on the Flop




PokerStars Game #59941661924:  Hold'em No Limit ($0.10/$0.25) - 2009/07/01 1:42:13 ET
Table 'YONIZZNvg4uZ4xNUO1deeA' 6-max Seat #1 is the button
Seat 1: GbCVUNssQ7mqsPWr7J4d3w ($4.65 in chips) 
Seat 2: evMMX/0gSDH791KdSAOaSg ($4.85 in chips) 
Seat 3: Eksrep3hySi2jeDHuaWiOQ ($11 in chips) 
Seat 4: oNAHfBJOUelvVhf0IDMJUA ($25.90 in chips) 
Seat 5: if4dh6jhJXeN3/qd3qCp9g ($25.35 in chips) 
Seat 6: eL3+wCBjFGfQ5FMdIZihwA ($25 in chips) 
evMMX/0gSDH791KdSAOaSg: posts small blind $0.10
Eksrep3hySi2jeDHuaWiOQ: posts big blind $0.25
*** HOLE CARDS ***
oNAHfBJOUelvVhf0IDMJUA: raises $1.25 to $1.50
if4dh6jhJXeN3/qd3qCp9g: folds 
eL3+wCBjFGfQ5FMdIZihwA: folds 
GbCVUNssQ7mqsPWr7J4d3w: folds 
evMMX/0gSDH791KdSAOaSg: calls $1.40
Eksrep3hySi2jeDHuaWiOQ: folds 
*** FLOP *** [4h 6h 9d]
evMMX/0gSDH791KdSAOaSg: bets $3.35 and is all-in
oNAHfBJOUelvVhf0IDMJUA: calls $3.35
*** TURN *** [4h 6h 9d] [7d]
*** RIVER *** [4h 6h 9d 7d] [2h]
*** SHOW DOWN ***
evMMX/0gSDH791KdSAOaSg: shows [9c 9h] (three of a kind, Nines)
oNAHfBJOUelvVhf0IDMJUA: mucks hand 
evMMX/0gSDH791KdSAOaSg collected $9.50 from pot
*** SUMMARY ***
Total pot $9.95 | Rake $0.45 
Board [4h 6h 9d 7d 2h]
Seat 1: GbCVUNssQ7mqsPWr7J4d3w (button) folded before Flop (didn't bet)
Seat 2: evMMX/0gSDH791KdSAOaSg (small blind) showed [9c 9h] and won ($9.50) with three of a kind, Nines
Seat 3: Eksrep3hySi2jeDHuaWiOQ (big blind) folded before Flop
Seat 4: oNAHfBJOUelvVhf0IDMJUA mucked
Seat 5: if4dh6jhJXeN3/qd3qCp9g folded before Flop (didn't bet)
Seat 6: eL3+wCBjFGfQ5FMdIZihwA folded before Flop (didn't bet)




PokerStars Game #59941661780:  Hold'em No Limit ($0.10/$0.25) - 2009/07/01 1:42:13 ET
Table '0XPo7K54oZIfG0xlNAcDRw' 9-max Seat #9 is the button
Seat 1: 7cv+9Zc9HIQHNvYsMfV3uA ($28.15 in chips) 
Seat 2: Prl9QvWQw/mISF4dSnnQUQ ($10 in chips) 
Seat 4: RubYqfvGrz2z+5ReNIj9QQ ($32.55 in chips) 
Seat 5: iOmwbUN7u4JFkV6VCA49aA ($24.65 in chips) 
Seat 6: 9gmYYQesalMrUjaF7nKfrQ ($12.05 in chips) 
Seat 7: tYsOBqdU1+x+yFI7zHO7hQ ($28.80 in chips) 
Seat 8: v5jnQ1gfh9nLla3kMXG7Yg ($8 in chips) 
Seat 9: CmngQmkKTp8tkl6GMRTl6w ($13.60 in chips) 
7cv+9Zc9HIQHNvYsMfV3uA: posts small blind $0.10
Prl9QvWQw/mISF4dSnnQUQ: posts big blind $0.25
*** HOLE CARDS ***
RubYqfvGrz2z+5ReNIj9QQ: calls $0.25
iOmwbUN7u4JFkV6VCA49aA: calls $0.25
9gmYYQesalMrUjaF7nKfrQ: calls $0.25
tYsOBqdU1+x+yFI7zHO7hQ: folds 
v5jnQ1gfh9nLla3kMXG7Yg: folds 
CmngQmkKTp8tkl6GMRTl6w: folds 
Stamp57 leaves the table
7cv+9Zc9HIQHNvYsMfV3uA: folds 
Prl9QvWQw/mISF4dSnnQUQ: checks 
*** FLOP *** [2h 7h 8d]
RHqgdFvufLCYe54+qd2gcA joins the table at seat #3 
Prl9QvWQw/mISF4dSnnQUQ: checks 
RubYqfvGrz2z+5ReNIj9QQ: bets $1
iOmwbUN7u4JFkV6VCA49aA: calls $1
9gmYYQesalMrUjaF7nKfrQ: raises $2 to $3
Prl9QvWQw/mISF4dSnnQUQ: calls $3
RubYqfvGrz2z+5ReNIj9QQ: folds 
iOmwbUN7u4JFkV6VCA49aA: folds 
*** TURN *** [2h 7h 8d] [Jd]
Prl9QvWQw/mISF4dSnnQUQ: bets $4
9gmYYQesalMrUjaF7nKfrQ: raises $4.80 to $8.80 and is all-in
Prl9QvWQw/mISF4dSnnQUQ: calls $2.75 and is all-in
Uncalled bet ($2.05) returned to 9gmYYQesalMrUjaF7nKfrQ
*** RIVER *** [2h 7h 8d Jd] [Qh]
*** SHOW DOWN ***
Prl9QvWQw/mISF4dSnnQUQ: shows [6d 5s] (high card Queen)
9gmYYQesalMrUjaF7nKfrQ: shows [7c 7d] (three of a kind, Sevens)
9gmYYQesalMrUjaF7nKfrQ collected $21.50 from pot
*** SUMMARY ***
Total pot $22.60 | Rake $1.10 
Board [2h 7h 8d Jd Qh]
Seat 1: 7cv+9Zc9HIQHNvYsMfV3uA (small blind) folded before Flop
Seat 2: Prl9QvWQw/mISF4dSnnQUQ (big blind) showed [6d 5s] and lost with high card Queen
Seat 4: RubYqfvGrz2z+5ReNIj9QQ folded on the Flop
Seat 5: iOmwbUN7u4JFkV6VCA49aA folded on the Flop
Seat 6: 9gmYYQesalMrUjaF7nKfrQ showed [7c 7d] and won ($21.50) with three of a kind, Sevens
Seat 7: tYsOBqdU1+x+yFI7zHO7hQ folded before Flop (didn't bet)
Seat 8: v5jnQ1gfh9nLla3kMXG7Yg folded before Flop (didn't bet)
Seat 9: CmngQmkKTp8tkl6GMRTl6w (button) folded before Flop (didn't bet)




PokerStars Game #59941661936:  Hold'em No Limit ($0.10/$0.25) - 2009/07/01 1:42:13 ET
Table 'pgrBYaOEx/BuqK5iAtlFzw' 9-max Seat #8 is the button
Seat 1: 6O+8t5ikoK+pNiFXnN/Fyw ($15.90 in chips) 
Seat 2: 2Xwi447v1rBHM+92U0CduA ($4.75 in chips) 
Seat 3: Bb42QRQMhg5/Y0vHP8/2Xw ($25.60 in chips) 
Seat 4: oLa/tXLfSLLB28mcLGrxcg ($24.40 in chips) 
Seat 5: BWzInv8o0kN1pJybv/VjpQ ($27.15 in chips) 
Seat 6: eubS00Znk+qsx0B0+7/Zow ($21.85 in chips) 
Seat 7: eK8qa6EPcH2zhtbmWSvc9g ($25 in chips) 
Seat 8: tLcDklc2rBORNfixyRfVfw ($25 in chips) 
Z9W7+g1WMhhZDi7DwGbCFA will be allowed to play after the button
6O+8t5ikoK+pNiFXnN/Fyw: posts small blind $0.10
2Xwi447v1rBHM+92U0CduA: posts big blind $0.25
*** HOLE CARDS ***
Bb42QRQMhg5/Y0vHP8/2Xw: folds 
oLa/tXLfSLLB28mcLGrxcg: folds 
BWzInv8o0kN1pJybv/VjpQ: raises $0.75 to $1
eubS00Znk+qsx0B0+7/Zow: folds 
eK8qa6EPcH2zhtbmWSvc9g: folds 
tLcDklc2rBORNfixyRfVfw: folds 
6O+8t5ikoK+pNiFXnN/Fyw: calls $0.90
2Xwi447v1rBHM+92U0CduA: calls $0.75
*** FLOP *** [5d 2s 6s]
6O+8t5ikoK+pNiFXnN/Fyw: checks 
2Xwi447v1rBHM+92U0CduA: checks 
BWzInv8o0kN1pJybv/VjpQ: bets $1.50
6O+8t5ikoK+pNiFXnN/Fyw: folds 
2Xwi447v1rBHM+92U0CduA: folds 
Uncalled bet ($1.50) returned to BWzInv8o0kN1pJybv/VjpQ
BWzInv8o0kN1pJybv/VjpQ collected $2.85 from pot
BWzInv8o0kN1pJybv/VjpQ: shows [9d 9s] (a pair of Nines)
*** SUMMARY ***
Total pot $3 | Rake $0.15 
Board [5d 2s 6s]
Seat 1: 6O+8t5ikoK+pNiFXnN/Fyw (small blind) folded on the Flop
Seat 2: 2Xwi447v1rBHM+92U0CduA (big blind) folded on the Flop
Seat 3: Bb42QRQMhg5/Y0vHP8/2Xw folded before Flop (didn't bet)
Seat 4: oLa/tXLfSLLB28mcLGrxcg folded before Flop (didn't bet)
Seat 5: BWzInv8o0kN1pJybv/VjpQ collected ($2.85)
Seat 6: eubS00Znk+qsx0B0+7/Zow folded before Flop (didn't bet)
Seat 7: eK8qa6EPcH2zhtbmWSvc9g folded before Flop (didn't bet)
Seat 8: tLcDklc2rBORNfixyRfVfw (button) folded before Flop (didn't bet)




PokerStars Game #59941661834:  Hold'em No Limit ($0.10/$0.25) - 2009/07/01 1:42:13 ET
Table 'sSe6q4YTb/iS19t2eCFdsA' 9-max Seat #7 is the button
Seat 1: hJ4uYjNmSZdjrKA8cjZqCA ($19.50 in chips) 
Seat 3: bXpVeaSTPBFSPJmeXxO7nw ($5.65 in chips) 
Seat 4: 22dIObOuor/A+IKWkNoAlA ($8.85 in chips) 
Seat 5: qS+jfnNoG75bT+uQ8CKhQA ($10.05 in chips) 
Seat 6: tYsOBqdU1+x+yFI7zHO7hQ ($28 in chips) 
Seat 7: t70KGeRtR3naHSqKDixsUg ($4 in chips) 
Seat 8: hvXZ0zFPZFP8Hf6dS36YEw ($14.15 in chips) 
Seat 9: Z9W7+g1WMhhZDi7DwGbCFA ($5 in chips) 
hvXZ0zFPZFP8Hf6dS36YEw: posts small blind $0.10
Z9W7+g1WMhhZDi7DwGbCFA: posts big blind $0.25
3l+i+xMeyDndSXMF2A5CDA: sits out 
*** HOLE CARDS ***
hJ4uYjNmSZdjrKA8cjZqCA: folds 
bXpVeaSTPBFSPJmeXxO7nw: folds 
22dIObOuor/A+IKWkNoAlA: folds 
qS+jfnNoG75bT+uQ8CKhQA: folds 
tYsOBqdU1+x+yFI7zHO7hQ: raises $0.50 to $0.75
t70KGeRtR3naHSqKDixsUg: folds 
hvXZ0zFPZFP8Hf6dS36YEw: folds 
Z9W7+g1WMhhZDi7DwGbCFA: folds 
Uncalled bet ($0.50) returned to tYsOBqdU1+x+yFI7zHO7hQ
tYsOBqdU1+x+yFI7zHO7hQ collected $0.60 from pot
tYsOBqdU1+x+yFI7zHO7hQ: doesn't show hand 
*** SUMMARY ***
Total pot $0.60 | Rake $0 
Seat 1: hJ4uYjNmSZdjrKA8cjZqCA folded before Flop (didn't bet)
Seat 3: bXpVeaSTPBFSPJmeXxO7nw folded before Flop (didn't bet)
Seat 4: 22dIObOuor/A+IKWkNoAlA folded before Flop (didn't bet)
Seat 5: qS+jfnNoG75bT+uQ8CKhQA folded before Flop (didn't bet)
Seat 6: tYsOBqdU1+x+yFI7zHO7hQ collected ($0.60)
Seat 7: t70KGeRtR3naHSqKDixsUg (button) folded before Flop (didn't bet)
Seat 8: hvXZ0zFPZFP8Hf6dS36YEw (small blind) folded before Flop
Seat 9: Z9W7+g1WMhhZDi7DwGbCFA (big blind) folded before Flop




PokerStars Game #59941661768:  Hold'em No Limit ($0.10/$0.25) - 2009/07/01 1:42:13 ET
Table 'zKwHJD0cmKNUure9qQTfFg' 6-max Seat #3 is the button
Seat 2: xrf8tAXKQHG99HixCot1Iw ($26.55 in chips) 
Seat 3: 60PLIlpucQhA08L3YbNmag ($14.15 in chips) 
Seat 4: v+QfkGiuj9bgtuNoVnDO8w ($25.90 in chips) 
Seat 5: E4AqQ1egsnu0oH2RqsbCmQ ($4.45 in chips) 
Seat 6: edio/rLJ06xeZOfLhoL3UA ($6.20 in chips) 
v+QfkGiuj9bgtuNoVnDO8w: posts small blind $0.10
E4AqQ1egsnu0oH2RqsbCmQ: posts big blind $0.25
*** HOLE CARDS ***
edio/rLJ06xeZOfLhoL3UA: folds 
xrf8tAXKQHG99HixCot1Iw: folds 
60PLIlpucQhA08L3YbNmag: folds 
piak297 leaves the table
v+QfkGiuj9bgtuNoVnDO8w: folds 
Uncalled bet ($0.15) returned to E4AqQ1egsnu0oH2RqsbCmQ
E4AqQ1egsnu0oH2RqsbCmQ collected $0.20 from pot
E4AqQ1egsnu0oH2RqsbCmQ: doesn't show hand 
*** SUMMARY ***
Total pot $0.20 | Rake $0 
Seat 2: xrf8tAXKQHG99HixCot1Iw folded before Flop (didn't bet)
Seat 3: 60PLIlpucQhA08L3YbNmag (button) folded before Flop (didn't bet)
Seat 4: v+QfkGiuj9bgtuNoVnDO8w (small blind) folded before Flop
Seat 5: E4AqQ1egsnu0oH2RqsbCmQ (big blind) collected ($0.20)
Seat 6: edio/rLJ06xeZOfLhoL3UA folded before Flop (didn't bet)




PokerStars Game #59941662448:  Hold'em No Limit ($0.10/$0.25) - 2009/07/01 1:42:14 ET
Table 'oxYpQNT8OHNCvpMIFi7UoA' 9-max Seat #7 is the button
Seat 1: EVqHvqty1ZsuvDFiSXlSqQ ($29.80 in chips) 
Seat 2: 8+iP8mvFyeAviW/yUH1CJg ($30.20 in chips) 
Seat 3: ubsjZomMWSV0hAiBLa7K1A ($19.65 in chips) 
Seat 4: eK8qa6EPcH2zhtbmWSvc9g ($25 in chips) 
Seat 5: ZoqLw33zTU6EsjOkfv/cGw ($19.90 in chips) 
Seat 6: VBHxUExRAMrbxUq/cVx9Gw ($5.40 in chips) 
Seat 7: X78b5v/uhqeXXoAijbw/yg ($25 in chips) 
Seat 9: pN3IHvAKm2fz+sTRARTcrg ($24.75 in chips) 
pN3IHvAKm2fz+sTRARTcrg: posts small blind $0.10
EVqHvqty1ZsuvDFiSXlSqQ: posts big blind $0.25
*** HOLE CARDS ***
8+iP8mvFyeAviW/yUH1CJg: folds 
ubsjZomMWSV0hAiBLa7K1A: folds 
eK8qa6EPcH2zhtbmWSvc9g: raises $0.50 to $0.75
ZoqLw33zTU6EsjOkfv/cGw: folds 
VBHxUExRAMrbxUq/cVx9Gw: folds 
X78b5v/uhqeXXoAijbw/yg: folds 
pN3IHvAKm2fz+sTRARTcrg: folds 
EVqHvqty1ZsuvDFiSXlSqQ: calls $0.50
*** FLOP *** [Qs 8s 5d]
EVqHvqty1ZsuvDFiSXlSqQ: bets $1
eK8qa6EPcH2zhtbmWSvc9g: calls $1
*** TURN *** [Qs 8s 5d] [Qd]
EVqHvqty1ZsuvDFiSXlSqQ: bets $1
eK8qa6EPcH2zhtbmWSvc9g: calls $1
*** RIVER *** [Qs 8s 5d Qd] [Th]
EVqHvqty1ZsuvDFiSXlSqQ: bets $1
eK8qa6EPcH2zhtbmWSvc9g: calls $1
*** SHOW DOWN ***
EVqHvqty1ZsuvDFiSXlSqQ: shows [Tc 8c] (two pair, Queens and Tens)
eK8qa6EPcH2zhtbmWSvc9g: mucks hand 
EVqHvqty1ZsuvDFiSXlSqQ collected $7.25 from pot
*** SUMMARY ***
Total pot $7.60 | Rake $0.35 
Board [Qs 8s 5d Qd Th]
Seat 1: EVqHvqty1ZsuvDFiSXlSqQ (big blind) showed [Tc 8c] and won ($7.25) with two pair, Queens and Tens
Seat 2: 8+iP8mvFyeAviW/yUH1CJg folded before Flop (didn't bet)
Seat 3: ubsjZomMWSV0hAiBLa7K1A folded before Flop (didn't bet)
Seat 4: eK8qa6EPcH2zhtbmWSvc9g mucked
Seat 5: ZoqLw33zTU6EsjOkfv/cGw folded before Flop (didn't bet)
Seat 6: VBHxUExRAMrbxUq/cVx9Gw folded before Flop (didn't bet)
Seat 7: X78b5v/uhqeXXoAijbw/yg (button) folded before Flop (didn't bet)
Seat 9: pN3IHvAKm2fz+sTRARTcrg (small blind) folded before Flop




PokerStars Game #59941662604:  Hold'em No Limit ($0.10/$0.25) - 2009/07/01 1:42:14 ET
Table '2O5CgfSkSwrr4PDrlZ1RLQ' 6-max Seat #2 is the button
Seat 1: 3skmHD9EOATKdUzzyHh1KA ($29.40 in chips) 
Seat 2: wqphQtauX5Qn7WRJZS1flA ($25 in chips) 
Seat 3: oBUDUfeUyCbZBsjxHZgSiw ($29.75 in chips) 
Seat 5: 0av6tRNdi0Ui4f15L7gsVg ($21.90 in chips) 
Seat 6: tj9xqoqQaDaFw7u1oyZrtA ($48.50 in chips) 
oBUDUfeUyCbZBsjxHZgSiw: posts small blind $0.10
CHILI CHEE5E: is sitting out 
0av6tRNdi0Ui4f15L7gsVg: posts big blind $0.25
*** HOLE CARDS ***
tj9xqoqQaDaFw7u1oyZrtA: folds 
CHILI CHEE5E leaves the table
3skmHD9EOATKdUzzyHh1KA: raises $0.75 to $1
wqphQtauX5Qn7WRJZS1flA: folds 
oBUDUfeUyCbZBsjxHZgSiw: calls $0.90
0av6tRNdi0Ui4f15L7gsVg: folds 
*** FLOP *** [Qd Ks Tc]
oBUDUfeUyCbZBsjxHZgSiw: checks 
3skmHD9EOATKdUzzyHh1KA: bets $1.25
oBUDUfeUyCbZBsjxHZgSiw: folds 
Uncalled bet ($1.25) returned to 3skmHD9EOATKdUzzyHh1KA
3skmHD9EOATKdUzzyHh1KA collected $2.15 from pot
3skmHD9EOATKdUzzyHh1KA: doesn't show hand 
*** SUMMARY ***
Total pot $2.25 | Rake $0.10 
Board [Qd Ks Tc]
Seat 1: 3skmHD9EOATKdUzzyHh1KA collected ($2.15)
Seat 2: wqphQtauX5Qn7WRJZS1flA (button) folded before Flop (didn't bet)
Seat 3: oBUDUfeUyCbZBsjxHZgSiw (small blind) folded on the Flop
Seat 5: 0av6tRNdi0Ui4f15L7gsVg (big blind) folded before Flop
Seat 6: tj9xqoqQaDaFw7u1oyZrtA folded before Flop (didn't bet)




PokerStars Game #59941662212:  Hold'em No Limit ($0.10/$0.25) - 2009/07/01 1:42:14 ET
Table '+2VxGVfkEqJ1AYfQy/JH2w' 6-max Seat #1 is the button
Seat 1: if4dh6jhJXeN3/qd3qCp9g ($24.65 in chips) 
Seat 2: qllppsCmUqovlriIWCeM/g ($5.55 in chips) 
Seat 4: y+a/yGW/Jy4bPJFnaeTz5w ($16.95 in chips) 
Seat 5: XD1i5m5PvBDnRzJaG/vINw ($23.10 in chips) 
Seat 6: L3/N/gliETan8N5Gim5h4Q ($25 in chips) 
qllppsCmUqovlriIWCeM/g: posts small blind $0.10
y+a/yGW/Jy4bPJFnaeTz5w: posts big blind $0.25
*** HOLE CARDS ***
XD1i5m5PvBDnRzJaG/vINw: folds 
epAUIB7h2FJXzUPRIvSkRA joins the table at seat #3 
L3/N/gliETan8N5Gim5h4Q: folds 
if4dh6jhJXeN3/qd3qCp9g: folds 
qllppsCmUqovlriIWCeM/g: calls $0.15
y+a/yGW/Jy4bPJFnaeTz5w: checks 
*** FLOP *** [3d Jc Ac]
qllppsCmUqovlriIWCeM/g: bets $1
y+a/yGW/Jy4bPJFnaeTz5w: folds 
Uncalled bet ($1) returned to qllppsCmUqovlriIWCeM/g
qllppsCmUqovlriIWCeM/g collected $0.50 from pot
*** SUMMARY ***
Total pot $0.50 | Rake $0 
Board [3d Jc Ac]
Seat 1: if4dh6jhJXeN3/qd3qCp9g (button) folded before Flop (didn't bet)
Seat 2: qllppsCmUqovlriIWCeM/g (small blind) collected ($0.50)
Seat 4: y+a/yGW/Jy4bPJFnaeTz5w (big blind) folded on the Flop
Seat 5: XD1i5m5PvBDnRzJaG/vINw folded before Flop (didn't bet)
Seat 6: L3/N/gliETan8N5Gim5h4Q folded before Flop (didn't bet)




PokerStars Game #59941662680:  Hold'em No Limit ($0.10/$0.25) - 2009/07/01 1:42:14 ET
Table 'FE/j6VqBY4j9Uq+VHURQCQ' 6-max Seat #1 is the button
Seat 1: ypmjhffk/YHGc51wgVXUTw ($41.45 in chips) 
Seat 2: 3zD3qLXT1bEffAoWGnc7wg ($39.85 in chips) 
Seat 3: lBoEwOFgzcERLIRUkUoRTw ($27.70 in chips) 
Seat 4: 7JyPCA0J2grhXQYxe1h3+A ($22.65 in chips) 
Seat 5: 4x9jCqgSw4272dnaIqnanw ($7.20 in chips) 
Seat 6: rpJ2ie+vculq8yrHlngRHQ ($18.60 in chips) 
3zD3qLXT1bEffAoWGnc7wg: posts small blind $0.10
lBoEwOFgzcERLIRUkUoRTw: posts big blind $0.25
*** HOLE CARDS ***
7JyPCA0J2grhXQYxe1h3+A: calls $0.25
4x9jCqgSw4272dnaIqnanw: folds 
rpJ2ie+vculq8yrHlngRHQ: raises $2.25 to $2.50
ypmjhffk/YHGc51wgVXUTw: folds 
3zD3qLXT1bEffAoWGnc7wg: folds 
lBoEwOFgzcERLIRUkUoRTw: folds 
7JyPCA0J2grhXQYxe1h3+A: folds 
Uncalled bet ($2.25) returned to rpJ2ie+vculq8yrHlngRHQ
rpJ2ie+vculq8yrHlngRHQ collected $0.85 from pot
*** SUMMARY ***
Total pot $0.85 | Rake $0 
Seat 1: ypmjhffk/YHGc51wgVXUTw (button) folded before Flop (didn't bet)
Seat 2: 3zD3qLXT1bEffAoWGnc7wg (small blind) folded before Flop
Seat 3: lBoEwOFgzcERLIRUkUoRTw (big blind) folded before Flop
Seat 4: 7JyPCA0J2grhXQYxe1h3+A folded before Flop
Seat 5: 4x9jCqgSw4272dnaIqnanw folded before Flop (didn't bet)
Seat 6: rpJ2ie+vculq8yrHlngRHQ collected ($0.85)




PokerStars Game #59941663000:  Hold'em No Limit ($0.10/$0.25) - 2009/07/01 1:42:15 ET
Table 'luMgmRPIo47e7iXDlheIwA' 6-max Seat #6 is the button
Seat 1: EQ3WxdGe/KZrM6Lx4T02sg ($16.05 in chips) 
Seat 2: NhUN/JpAprdJeamFBgJH1w ($25 in chips) 
Seat 3: W6Y6au0wf7gRAlqJYgOezw ($20.85 in chips) 
Seat 4: xrf8tAXKQHG99HixCot1Iw ($24 in chips) 
Seat 5: cWc85bEzdRzpUMhRKm8pwQ ($43.75 in chips) 
Seat 6: qGHGf/553gQnDoklMRe3tg ($24.90 in chips) 
EQ3WxdGe/KZrM6Lx4T02sg: posts small blind $0.10
NhUN/JpAprdJeamFBgJH1w: posts big blind $0.25
*** HOLE CARDS ***
W6Y6au0wf7gRAlqJYgOezw: folds 
xrf8tAXKQHG99HixCot1Iw: folds 
cWc85bEzdRzpUMhRKm8pwQ: folds 
qGHGf/553gQnDoklMRe3tg: folds 
EQ3WxdGe/KZrM6Lx4T02sg: calls $0.15
NhUN/JpAprdJeamFBgJH1w: checks 
*** FLOP *** [2c Kd Kc]
EQ3WxdGe/KZrM6Lx4T02sg: checks 
NhUN/JpAprdJeamFBgJH1w: checks 
*** TURN *** [2c Kd Kc] [Ah]
EQ3WxdGe/KZrM6Lx4T02sg: bets $0.25
NhUN/JpAprdJeamFBgJH1w: folds 
Uncalled bet ($0.25) returned to EQ3WxdGe/KZrM6Lx4T02sg
EQ3WxdGe/KZrM6Lx4T02sg collected $0.50 from pot
*** SUMMARY ***
Total pot $0.50 | Rake $0 
Board [2c Kd Kc Ah]
Seat 1: EQ3WxdGe/KZrM6Lx4T02sg (small blind) collected ($0.50)
Seat 2: NhUN/JpAprdJeamFBgJH1w (big blind) folded on the Turn
Seat 3: W6Y6au0wf7gRAlqJYgOezw folded before Flop (didn't bet)
Seat 4: xrf8tAXKQHG99HixCot1Iw folded before Flop (didn't bet)
Seat 5: cWc85bEzdRzpUMhRKm8pwQ folded before Flop (didn't bet)
Seat 6: qGHGf/553gQnDoklMRe3tg (button) folded before Flop (didn't bet)




PokerStars Game #59941662912:  Hold'em No Limit ($0.10/$0.25) - 2009/07/01 1:42:15 ET
Table 'yZgGBnUGXVCcEJdcqes8tw' 9-max Seat #4 is the button
Seat 1: 6RiVTYll/5D8zICp0MRpKw ($29.20 in chips) 
Seat 2: MG90wfSJZnOejs/KD3vlQQ ($25 in chips) 
Seat 3: z5GxcHlYz/GSz6W2uFiTtg ($23.30 in chips) 
Seat 4: M2QO2DxB5Wawg2h8HSpnYA ($10 in chips) 
Seat 5: dfNim92Z6XK1/h5SFW5vDg ($25.15 in chips) 
Seat 6: pRZytPRoJmxE0dmcJwYvfw ($5.95 in chips) 
Seat 7: eC8Pn1D6Y2pct8o62nQfvQ ($25.15 in chips) 
Seat 8: dtZ84flFEi4Q+SGrHMJRDQ ($31.65 in chips) 
dfNim92Z6XK1/h5SFW5vDg: posts small blind $0.10
pRZytPRoJmxE0dmcJwYvfw: posts big blind $0.25
*** HOLE CARDS ***
eC8Pn1D6Y2pct8o62nQfvQ: calls $0.25
dtZ84flFEi4Q+SGrHMJRDQ: folds 
6RiVTYll/5D8zICp0MRpKw: folds 
MG90wfSJZnOejs/KD3vlQQ: folds 
z5GxcHlYz/GSz6W2uFiTtg: folds 
M2QO2DxB5Wawg2h8HSpnYA: folds 
dfNim92Z6XK1/h5SFW5vDg: folds 
pRZytPRoJmxE0dmcJwYvfw: checks 
*** FLOP *** [Jh Ah Jc]
pRZytPRoJmxE0dmcJwYvfw: checks 
eC8Pn1D6Y2pct8o62nQfvQ: checks 
*** TURN *** [Jh Ah Jc] [3s]
pRZytPRoJmxE0dmcJwYvfw: checks 
eC8Pn1D6Y2pct8o62nQfvQ: checks 
*** RIVER *** [Jh Ah Jc 3s] [As]
pRZytPRoJmxE0dmcJwYvfw: checks 
eC8Pn1D6Y2pct8o62nQfvQ: checks 
*** SHOW DOWN ***
pRZytPRoJmxE0dmcJwYvfw: shows [6h 7s] (two pair, Aces and Jacks)
eC8Pn1D6Y2pct8o62nQfvQ: shows [8d 8h] (two pair, Aces and Jacks - Eight kicker)
eC8Pn1D6Y2pct8o62nQfvQ collected $0.60 from pot
*** SUMMARY ***
Total pot $0.60 | Rake $0 
Board [Jh Ah Jc 3s As]
Seat 1: 6RiVTYll/5D8zICp0MRpKw folded before Flop (didn't bet)
Seat 2: MG90wfSJZnOejs/KD3vlQQ folded before Flop (didn't bet)
Seat 3: z5GxcHlYz/GSz6W2uFiTtg folded before Flop (didn't bet)
Seat 4: M2QO2DxB5Wawg2h8HSpnYA (button) folded before Flop (didn't bet)
Seat 5: dfNim92Z6XK1/h5SFW5vDg (small blind) folded before Flop
Seat 6: pRZytPRoJmxE0dmcJwYvfw (big blind) showed [6h 7s] and lost with two pair, Aces and Jacks
Seat 7: eC8Pn1D6Y2pct8o62nQfvQ showed [8d 8h] and won ($0.60) with two pair, Aces and Jacks
Seat 8: dtZ84flFEi4Q+SGrHMJRDQ folded before Flop (didn't bet)




PokerStars Game #59941663026:  Hold'em No Limit ($0.10/$0.25) - 2009/07/01 1:42:15 ET
Table 'v+LTGPWbrLum+Ggd4ef6lg' 9-max Seat #5 is the button
Seat 1: zUXhymECc2C9W9ZNw6qppA ($9.65 in chips) 
Seat 2: r/xYbgD9yVdKFWRgSQD/+Q ($20.70 in chips) 
Seat 3: 7ovWM9c1nQLTFritEGRG/A ($2.90 in chips) 
Seat 4: bXpVeaSTPBFSPJmeXxO7nw ($9.05 in chips) 
Seat 5: +8OkYWUhGfkDbAtQl/ovYQ ($31.55 in chips) 
Seat 6: T+MjFnaPZsOyKbE9LYG2Qg ($14 in chips) 
Seat 7: kUxTO3D2eQcx4oJIpJAK4Q ($7.70 in chips) 
Seat 8: +sbyWwIcFp9kP0bDtMegfQ ($32.60 in chips) 
T+MjFnaPZsOyKbE9LYG2Qg: posts small blind $0.10
kUxTO3D2eQcx4oJIpJAK4Q: posts big blind $0.25
cZ99hugmLBj9KhTlc8nCSw: sits out 
*** HOLE CARDS ***
+sbyWwIcFp9kP0bDtMegfQ: folds 
zUXhymECc2C9W9ZNw6qppA: folds 
r/xYbgD9yVdKFWRgSQD/+Q: folds 
7ovWM9c1nQLTFritEGRG/A: raises $2.65 to $2.90 and is all-in
bXpVeaSTPBFSPJmeXxO7nw: folds 
+8OkYWUhGfkDbAtQl/ovYQ: folds 
T+MjFnaPZsOyKbE9LYG2Qg: folds 
kUxTO3D2eQcx4oJIpJAK4Q: folds 
Uncalled bet ($2.65) returned to 7ovWM9c1nQLTFritEGRG/A
7ovWM9c1nQLTFritEGRG/A collected $0.60 from pot
7ovWM9c1nQLTFritEGRG/A: doesn't show hand 
*** SUMMARY ***
Total pot $0.60 | Rake $0 
Seat 1: zUXhymECc2C9W9ZNw6qppA folded before Flop (didn't bet)
Seat 2: r/xYbgD9yVdKFWRgSQD/+Q folded before Flop (didn't bet)
Seat 3: 7ovWM9c1nQLTFritEGRG/A collected ($0.60)
Seat 4: bXpVeaSTPBFSPJmeXxO7nw folded before Flop (didn't bet)
Seat 5: +8OkYWUhGfkDbAtQl/ovYQ (button) folded before Flop (didn't bet)
Seat 6: T+MjFnaPZsOyKbE9LYG2Qg (small blind) folded before Flop
Seat 7: kUxTO3D2eQcx4oJIpJAK4Q (big blind) folded before Flop
Seat 8: +sbyWwIcFp9kP0bDtMegfQ folded before Flop (didn't bet)




PokerStars Game #59941663110:  Hold'em No Limit ($0.10/$0.25) - 2009/07/01 1:42:15 ET
Table '2VkNDXXsBj4bSZw/uK5atw' 6-max Seat #6 is the button
Seat 1: xrf8tAXKQHG99HixCot1Iw ($20.35 in chips) 
Seat 2: v6mkGzCBCCXcgWQNSYVtKg ($6.50 in chips) 
Seat 3: 8D0jr3B4e++Q/cTSnpHdzg ($36.75 in chips) 
Seat 5: 7f0OkhFEOf3T+rVOFHRLnw ($22.05 in chips) 
Seat 6: n6UPMnVR4v8LFP0rWP73Fg ($10.60 in chips) 
xrf8tAXKQHG99HixCot1Iw: posts small blind $0.10
v6mkGzCBCCXcgWQNSYVtKg: posts big blind $0.25
*** HOLE CARDS ***
8D0jr3B4e++Q/cTSnpHdzg: raises $0.50 to $0.75
7f0OkhFEOf3T+rVOFHRLnw: folds 
n6UPMnVR4v8LFP0rWP73Fg: calls $0.75
xrf8tAXKQHG99HixCot1Iw: calls $0.65
v6mkGzCBCCXcgWQNSYVtKg: raises $2.25 to $3
8D0jr3B4e++Q/cTSnpHdzg: folds 
n6UPMnVR4v8LFP0rWP73Fg: folds 
xrf8tAXKQHG99HixCot1Iw: folds 
Uncalled bet ($2.25) returned to v6mkGzCBCCXcgWQNSYVtKg
8D0jr3B4e++Q/cTSnpHdzg is sitting out
v6mkGzCBCCXcgWQNSYVtKg collected $3 from pot
*** SUMMARY ***
Total pot $3 | Rake $0 
Seat 1: xrf8tAXKQHG99HixCot1Iw (small blind) folded before Flop
Seat 2: v6mkGzCBCCXcgWQNSYVtKg (big blind) collected ($3)
Seat 3: 8D0jr3B4e++Q/cTSnpHdzg folded before Flop
Seat 5: 7f0OkhFEOf3T+rVOFHRLnw folded before Flop (didn't bet)
Seat 6: n6UPMnVR4v8LFP0rWP73Fg (button) folded before Flop




PokerStars Game #59941663512:  Hold'em No Limit ($0.10/$0.25) - 2009/07/01 1:42:16 ET
Table 'vud0GB/ZlDCvUFhBFIaTlg' 9-max Seat #2 is the button
Seat 1: DiSvPC2iudwL5j9u6Huyww ($28.50 in chips) 
Seat 2: tLcDklc2rBORNfixyRfVfw ($25 in chips) 
Seat 3: W2YYHvqjaEpRrO7stZkClQ ($4.40 in chips) 
Seat 5: eK8qa6EPcH2zhtbmWSvc9g ($25 in chips) 
Seat 6: gehe91e0IyVT0QU/XBkEyg ($24.90 in chips) 
Seat 7: iG7VeTyBWf6wYNvZpbTcbw ($17.10 in chips) 
Seat 8: Am29qRe4OYkVWs70NjNDBw ($16.10 in chips) 
Seat 9: PdIasPkzm2sqZnN41ZRXOg ($5.70 in chips) 
W2YYHvqjaEpRrO7stZkClQ: posts small blind $0.10
eK8qa6EPcH2zhtbmWSvc9g: posts big blind $0.25
*** HOLE CARDS ***
dWgEDExmVO0d+rRmUYCU5w has returned
gehe91e0IyVT0QU/XBkEyg: folds 
iG7VeTyBWf6wYNvZpbTcbw: folds 
Am29qRe4OYkVWs70NjNDBw: calls $0.25
PdIasPkzm2sqZnN41ZRXOg: folds 
DiSvPC2iudwL5j9u6Huyww: folds 
tLcDklc2rBORNfixyRfVfw: raises $1 to $1.25
W2YYHvqjaEpRrO7stZkClQ: folds 
eK8qa6EPcH2zhtbmWSvc9g: folds 
Am29qRe4OYkVWs70NjNDBw: folds 
Uncalled bet ($1) returned to tLcDklc2rBORNfixyRfVfw
tLcDklc2rBORNfixyRfVfw collected $0.85 from pot
tLcDklc2rBORNfixyRfVfw: doesn't show hand 
*** SUMMARY ***
Total pot $0.85 | Rake $0 
Seat 1: DiSvPC2iudwL5j9u6Huyww folded before Flop (didn't bet)
Seat 2: tLcDklc2rBORNfixyRfVfw (button) collected ($0.85)
Seat 3: W2YYHvqjaEpRrO7stZkClQ (small blind) folded before Flop
Seat 5: eK8qa6EPcH2zhtbmWSvc9g (big blind) folded before Flop
Seat 6: gehe91e0IyVT0QU/XBkEyg folded before Flop (didn't bet)
Seat 7: iG7VeTyBWf6wYNvZpbTcbw folded before Flop (didn't bet)
Seat 8: Am29qRe4OYkVWs70NjNDBw folded before Flop
Seat 9: PdIasPkzm2sqZnN41ZRXOg folded before Flop (didn't bet)




PokerStars Game #59941663520:  Hold'em No Limit ($0.10/$0.25) - 2009/07/01 1:42:16 ET
Table 'oZuNsbNJuUyQLGKzQ/4JFg' 6-max Seat #5 is the button
Seat 1: vqWjZmdQu/Hxw96/IJTWdQ ($25.35 in chips) 
Seat 2: UA5OsKS3VPaxa7uC8La/kA ($34.50 in chips) 
Seat 3: 8ClCHtFXGNplITm+63KB+Q ($51 in chips) 
Seat 5: oBUDUfeUyCbZBsjxHZgSiw ($26.80 in chips) 
Seat 6: fwg6dK1+r4jy/y+JqenYYQ ($13.90 in chips) 
fwg6dK1+r4jy/y+JqenYYQ: posts small blind $0.10
vqWjZmdQu/Hxw96/IJTWdQ: posts big blind $0.25
9bpVv1/Qh9IYtXuCtl5VtQ: sits out 
*** HOLE CARDS ***
UA5OsKS3VPaxa7uC8La/kA has timed out
UA5OsKS3VPaxa7uC8La/kA: folds 
UA5OsKS3VPaxa7uC8La/kA is sitting out
UA5OsKS3VPaxa7uC8La/kA has returned
8ClCHtFXGNplITm+63KB+Q: folds 
oBUDUfeUyCbZBsjxHZgSiw: folds 
fwg6dK1+r4jy/y+JqenYYQ: calls $0.15
vqWjZmdQu/Hxw96/IJTWdQ: checks 
*** FLOP *** [Ac Jc 6h]
fwg6dK1+r4jy/y+JqenYYQ: checks 
vqWjZmdQu/Hxw96/IJTWdQ: checks 
*** TURN *** [Ac Jc 6h] [Td]
fwg6dK1+r4jy/y+JqenYYQ: checks 
vqWjZmdQu/Hxw96/IJTWdQ: checks 
*** RIVER *** [Ac Jc 6h Td] [7c]
fwg6dK1+r4jy/y+JqenYYQ: bets $0.75
vqWjZmdQu/Hxw96/IJTWdQ: folds 
Uncalled bet ($0.75) returned to fwg6dK1+r4jy/y+JqenYYQ
fwg6dK1+r4jy/y+JqenYYQ collected $0.50 from pot
fwg6dK1+r4jy/y+JqenYYQ: doesn't show hand 
*** SUMMARY ***
Total pot $0.50 | Rake $0 
Board [Ac Jc 6h Td 7c]
Seat 1: vqWjZmdQu/Hxw96/IJTWdQ (big blind) folded on the River
Seat 2: UA5OsKS3VPaxa7uC8La/kA folded before Flop (didn't bet)
Seat 3: 8ClCHtFXGNplITm+63KB+Q folded before Flop (didn't bet)
Seat 5: oBUDUfeUyCbZBsjxHZgSiw (button) folded before Flop (didn't bet)
Seat 6: fwg6dK1+r4jy/y+JqenYYQ (small blind) collected ($0.50)




PokerStars Game #59941663360:  Hold'em No Limit ($0.10/$0.25) - 2009/07/01 1:42:16 ET
Table 'VQNfcI8vTBCTvRfd3veTLQ' 6-max Seat #2 is the button
Seat 2: 79ID/ub1Pt/mDpCprVmOoA ($31.90 in chips) 
Seat 3: LtASJ9OlkqGrrUKGQlpGAw ($11.85 in chips) 
Seat 4: QIWnfLSqfMcoFfdDe5LZPg ($41.05 in chips) 
Seat 5: gX2vbKwS/8zZPENAWB7hxQ ($20.75 in chips) 
Seat 6: LJI7A1YgDM7hgh7o56+ReQ ($27.35 in chips) 
LtASJ9OlkqGrrUKGQlpGAw: posts small blind $0.10
QIWnfLSqfMcoFfdDe5LZPg: posts big blind $0.25
QiL+lEgEWwy21jk/ltaRLg: sits out 
*** HOLE CARDS ***
gX2vbKwS/8zZPENAWB7hxQ: calls $0.25
LJI7A1YgDM7hgh7o56+ReQ: folds 
79ID/ub1Pt/mDpCprVmOoA: folds 
LtASJ9OlkqGrrUKGQlpGAw: folds 
QIWnfLSqfMcoFfdDe5LZPg: checks 
*** FLOP *** [4h 7d Ac]
QIWnfLSqfMcoFfdDe5LZPg: checks 
gX2vbKwS/8zZPENAWB7hxQ: checks 
*** TURN *** [4h 7d Ac] [Qs]
QIWnfLSqfMcoFfdDe5LZPg: checks 
gX2vbKwS/8zZPENAWB7hxQ: checks 
*** RIVER *** [4h 7d Ac Qs] [Jc]
QIWnfLSqfMcoFfdDe5LZPg: checks 
gX2vbKwS/8zZPENAWB7hxQ: checks 
*** SHOW DOWN ***
QIWnfLSqfMcoFfdDe5LZPg: shows [8c 2c] (high card Ace)
gX2vbKwS/8zZPENAWB7hxQ: shows [4d 6d] (a pair of Fours)
gX2vbKwS/8zZPENAWB7hxQ collected $0.60 from pot
*** SUMMARY ***
Total pot $0.60 | Rake $0 
Board [4h 7d Ac Qs Jc]
Seat 2: 79ID/ub1Pt/mDpCprVmOoA (button) folded before Flop (didn't bet)
Seat 3: LtASJ9OlkqGrrUKGQlpGAw (small blind) folded before Flop
Seat 4: QIWnfLSqfMcoFfdDe5LZPg (big blind) showed [8c 2c] and lost with high card Ace
Seat 5: gX2vbKwS/8zZPENAWB7hxQ showed [4d 6d] and won ($0.60) with a pair of Fours
Seat 6: LJI7A1YgDM7hgh7o56+ReQ folded before Flop (didn't bet)




PokerStars Game #59941663346:  Hold'em No Limit ($0.10/$0.25) - 2009/07/01 1:42:16 ET
Table '2clPgY3+dETPD/8zjXZdFw' 6-max Seat #4 is the button
Seat 1: 4WFKzsjLSGnvHbVxKabsvQ ($29.45 in chips) 
Seat 2: cWc85bEzdRzpUMhRKm8pwQ ($25.70 in chips) 
Seat 3: SFmT9ZsVopnukjvAzrxTRg ($25 in chips) 
Seat 4: ljjhtb6FVPTx9AT9HNdtqg ($18.30 in chips) 
Seat 5: LJI7A1YgDM7hgh7o56+ReQ ($25 in chips) 
LJI7A1YgDM7hgh7o56+ReQ: posts small blind $0.10
2G0C7dp4wlPpE21FHjjElQ: is sitting out 
4WFKzsjLSGnvHbVxKabsvQ: posts big blind $0.25
*** HOLE CARDS ***
cWc85bEzdRzpUMhRKm8pwQ: folds 
SFmT9ZsVopnukjvAzrxTRg: folds 
ljjhtb6FVPTx9AT9HNdtqg: raises $0.50 to $0.75
LJI7A1YgDM7hgh7o56+ReQ: folds 
4WFKzsjLSGnvHbVxKabsvQ: calls $0.50
*** FLOP *** [2h 2s Ad]
4WFKzsjLSGnvHbVxKabsvQ: checks 
ljjhtb6FVPTx9AT9HNdtqg: bets $1
4WFKzsjLSGnvHbVxKabsvQ: raises $1 to $2
ljjhtb6FVPTx9AT9HNdtqg: folds 
Uncalled bet ($1) returned to 4WFKzsjLSGnvHbVxKabsvQ
4WFKzsjLSGnvHbVxKabsvQ collected $3.45 from pot
*** SUMMARY ***
Total pot $3.60 | Rake $0.15 
Board [2h 2s Ad]
Seat 1: 4WFKzsjLSGnvHbVxKabsvQ (big blind) collected ($3.45)
Seat 2: cWc85bEzdRzpUMhRKm8pwQ folded before Flop (didn't bet)
Seat 3: SFmT9ZsVopnukjvAzrxTRg folded before Flop (didn't bet)
Seat 4: ljjhtb6FVPTx9AT9HNdtqg (button) folded on the Flop
Seat 5: LJI7A1YgDM7hgh7o56+ReQ (small blind) folded before Flop




PokerStars Game #59941663502:  Hold'em No Limit ($0.10/$0.25) - 2009/07/01 1:42:16 ET
Table 'M7d9IrgQUUFFy/SZ3ksLYg' 6-max Seat #2 is the button
Seat 1: ypmjhffk/YHGc51wgVXUTw ($49.60 in chips) 
Seat 2: gqrr7lSWrQ1N8zKx8zZzvA ($9.05 in chips) 
Seat 3: 8JTm/CXBn3+kuQgcUOgPkw ($22.80 in chips) 
Seat 4: 8ClCHtFXGNplITm+63KB+Q ($24.90 in chips) 
Seat 5: kMa8BltUcBQVxnHfqdCfXg ($5.10 in chips) 
Seat 6: 7S16WhQHiAVLWwRuqPrpnw ($11.15 in chips) 
8JTm/CXBn3+kuQgcUOgPkw: posts small blind $0.10
8ClCHtFXGNplITm+63KB+Q: posts big blind $0.25
*** HOLE CARDS ***
kMa8BltUcBQVxnHfqdCfXg: calls $0.25
7S16WhQHiAVLWwRuqPrpnw: folds 
ypmjhffk/YHGc51wgVXUTw: folds 
gqrr7lSWrQ1N8zKx8zZzvA: folds 
8JTm/CXBn3+kuQgcUOgPkw: folds 
8ClCHtFXGNplITm+63KB+Q: checks 
*** FLOP *** [Ts 8d 8c]
8ClCHtFXGNplITm+63KB+Q: checks 
kMa8BltUcBQVxnHfqdCfXg: bets $0.25
8ClCHtFXGNplITm+63KB+Q: folds 
Uncalled bet ($0.25) returned to kMa8BltUcBQVxnHfqdCfXg
kMa8BltUcBQVxnHfqdCfXg collected $0.60 from pot
*** SUMMARY ***
Total pot $0.60 | Rake $0 
Board [Ts 8d 8c]
Seat 1: ypmjhffk/YHGc51wgVXUTw folded before Flop (didn't bet)
Seat 2: gqrr7lSWrQ1N8zKx8zZzvA (button) folded before Flop (didn't bet)
Seat 3: 8JTm/CXBn3+kuQgcUOgPkw (small blind) folded before Flop
Seat 4: 8ClCHtFXGNplITm+63KB+Q (big blind) folded on the Flop
Seat 5: kMa8BltUcBQVxnHfqdCfXg collected ($0.60)
Seat 6: 7S16WhQHiAVLWwRuqPrpnw folded before Flop (didn't bet)




PokerStars Game #59941663348:  Hold'em No Limit ($0.10/$0.25) - 2009/07/01 1:42:16 ET
Table 'nXVbUw6/HYwA6x21+IZ3XQ' 9-max Seat #6 is the button
Seat 2: 9lvO/qyU+xrU95Teu1fv0g ($4.65 in chips) 
Seat 3: 7je+LC5Mfs6nL8YBVh4frQ ($6.40 in chips) 
Seat 6: ljemhp25Zg+nlA9DLCIiUw ($26.85 in chips) 
Seat 7: ShCS62CJp4MKfKLKvGKQbA ($12.50 in chips) 
Seat 8: dfNim92Z6XK1/h5SFW5vDg ($27.15 in chips) 
Seat 9: OTCjTlu92MEBtX/i9Gm7yA ($12.80 in chips) 
ShCS62CJp4MKfKLKvGKQbA: posts small blind $0.10
dfNim92Z6XK1/h5SFW5vDg: posts big blind $0.25
*** HOLE CARDS ***
OTCjTlu92MEBtX/i9Gm7yA: calls $0.25
9lvO/qyU+xrU95Teu1fv0g: calls $0.25
SpiiQQAzy4MUgV3I5W8giw joins the table at seat #4 
7je+LC5Mfs6nL8YBVh4frQ: folds 
ljemhp25Zg+nlA9DLCIiUw: folds 
ShCS62CJp4MKfKLKvGKQbA: folds 
dfNim92Z6XK1/h5SFW5vDg: checks 
*** FLOP *** [As Qc 2h]
dfNim92Z6XK1/h5SFW5vDg: checks 
OTCjTlu92MEBtX/i9Gm7yA: checks 
9lvO/qyU+xrU95Teu1fv0g: bets $0.75
dfNim92Z6XK1/h5SFW5vDg: folds 
OTCjTlu92MEBtX/i9Gm7yA: folds 
Uncalled bet ($0.75) returned to 9lvO/qyU+xrU95Teu1fv0g
9lvO/qyU+xrU95Teu1fv0g collected $0.85 from pot
*** SUMMARY ***
Total pot $0.85 | Rake $0 
Board [As Qc 2h]
Seat 2: 9lvO/qyU+xrU95Teu1fv0g collected ($0.85)
Seat 3: 7je+LC5Mfs6nL8YBVh4frQ folded before Flop (didn't bet)
Seat 6: ljemhp25Zg+nlA9DLCIiUw (button) folded before Flop (didn't bet)
Seat 7: ShCS62CJp4MKfKLKvGKQbA (small blind) folded before Flop
Seat 8: dfNim92Z6XK1/h5SFW5vDg (big blind) folded on the Flop
Seat 9: OTCjTlu92MEBtX/i9Gm7yA folded on the Flop




PokerStars Game #59941664020:  Hold'em No Limit ($0.10/$0.25) - 2009/07/01 1:42:17 ET
Table 'M8kYidAX3ib7pLKW7edFLw' 6-max Seat #2 is the button
Seat 1: jp34e617tIzV8tKIWmfAbA ($25.35 in chips) 
Seat 2: ypmjhffk/YHGc51wgVXUTw ($28.45 in chips) 
Seat 3: cezpHJ8FB07dj0xG+LhOvw ($27.20 in chips) 
Seat 4: Hsvkc0/G2VV78oVmWYXecw ($5.35 in chips) 
Seat 5: bDKopKTvPi3W+PEnYUX3tg ($44.85 in chips) 
Seat 6: NqFoyDgzLwu4dOmSRXnFBA ($20 in chips) 
cezpHJ8FB07dj0xG+LhOvw: posts small blind $0.10
Hsvkc0/G2VV78oVmWYXecw: posts big blind $0.25
*** HOLE CARDS ***
bDKopKTvPi3W+PEnYUX3tg: folds 
NqFoyDgzLwu4dOmSRXnFBA: calls $0.25
jp34e617tIzV8tKIWmfAbA: folds 
ypmjhffk/YHGc51wgVXUTw: raises $0.75 to $1
cezpHJ8FB07dj0xG+LhOvw: folds 
Hsvkc0/G2VV78oVmWYXecw: folds 
NqFoyDgzLwu4dOmSRXnFBA: folds 
Uncalled bet ($0.75) returned to ypmjhffk/YHGc51wgVXUTw
ypmjhffk/YHGc51wgVXUTw collected $0.85 from pot
ypmjhffk/YHGc51wgVXUTw: doesn't show hand 
*** SUMMARY ***
Total pot $0.85 | Rake $0 
Seat 1: jp34e617tIzV8tKIWmfAbA folded before Flop (didn't bet)
Seat 2: ypmjhffk/YHGc51wgVXUTw (button) collected ($0.85)
Seat 3: cezpHJ8FB07dj0xG+LhOvw (small blind) folded before Flop
Seat 4: Hsvkc0/G2VV78oVmWYXecw (big blind) folded before Flop
Seat 5: bDKopKTvPi3W+PEnYUX3tg folded before Flop (didn't bet)
Seat 6: NqFoyDgzLwu4dOmSRXnFBA folded before Flop




PokerStars Game #59941664134:  Hold'em No Limit ($0.10/$0.25) - 2009/07/01 1:42:17 ET
Table '+UzantPJ4smVdrh+4GTu1w' 6-max Seat #6 is the button
Seat 1: TSmua8tGK3sTbwi0ynrW9Q ($27.95 in chips) 
Seat 2: tcbEu7VzyHQ+0lh+skbQhQ ($42.75 in chips) 
Seat 3: SS/yfeArhULzIcOPe8MdPg ($34.55 in chips) 
Seat 4: UmcUp27+PbgBItv3ZNlAWQ ($25.50 in chips) 
Seat 5: cj4VBQya7HtVL2zCGd5jLQ ($55.20 in chips) 
Seat 6: fZQg9veL7Dd/Z04ZTjC+wQ ($25 in chips) 
TSmua8tGK3sTbwi0ynrW9Q: posts small blind $0.10
tcbEu7VzyHQ+0lh+skbQhQ: posts big blind $0.25
*** HOLE CARDS ***
SS/yfeArhULzIcOPe8MdPg: folds 
UmcUp27+PbgBItv3ZNlAWQ: folds 
cj4VBQya7HtVL2zCGd5jLQ: calls $0.25
fZQg9veL7Dd/Z04ZTjC+wQ: calls $0.25
TSmua8tGK3sTbwi0ynrW9Q: calls $0.15
tcbEu7VzyHQ+0lh+skbQhQ: checks 
*** FLOP *** [8c 5d 9d]
TSmua8tGK3sTbwi0ynrW9Q: checks 
tcbEu7VzyHQ+0lh+skbQhQ: bets $0.75
cj4VBQya7HtVL2zCGd5jLQ: calls $0.75
fZQg9veL7Dd/Z04ZTjC+wQ: folds 
TSmua8tGK3sTbwi0ynrW9Q: calls $0.75
*** TURN *** [8c 5d 9d] [As]
TSmua8tGK3sTbwi0ynrW9Q: checks 
tcbEu7VzyHQ+0lh+skbQhQ: checks 
cj4VBQya7HtVL2zCGd5jLQ: checks 
*** RIVER *** [8c 5d 9d As] [Qh]
TSmua8tGK3sTbwi0ynrW9Q: checks 
tcbEu7VzyHQ+0lh+skbQhQ: checks 
cj4VBQya7HtVL2zCGd5jLQ: checks 
*** SHOW DOWN ***
TSmua8tGK3sTbwi0ynrW9Q: shows [6s 6h] (a pair of Sixes)
tcbEu7VzyHQ+0lh+skbQhQ: shows [2c 9h] (a pair of Nines)
cj4VBQya7HtVL2zCGd5jLQ: shows [Ks Kh] (a pair of Kings)
cj4VBQya7HtVL2zCGd5jLQ collected $3.10 from pot
*** SUMMARY ***
Total pot $3.25 | Rake $0.15 
Board [8c 5d 9d As Qh]
Seat 1: TSmua8tGK3sTbwi0ynrW9Q (small blind) showed [6s 6h] and lost with a pair of Sixes
Seat 2: tcbEu7VzyHQ+0lh+skbQhQ (big blind) showed [2c 9h] and lost with a pair of Nines
Seat 3: SS/yfeArhULzIcOPe8MdPg folded before Flop (didn't bet)
Seat 4: UmcUp27+PbgBItv3ZNlAWQ folded before Flop (didn't bet)
Seat 5: cj4VBQya7HtVL2zCGd5jLQ showed [Ks Kh] and won ($3.10) with a pair of Kings
Seat 6: fZQg9veL7Dd/Z04ZTjC+wQ (button) folded on the Flop




PokerStars Game #59941664298:  Hold'em No Limit ($0.10/$0.25) - 2009/07/01 1:42:17 ET
Table 'Xi38lWH8L2JHRAsKYVX8Qg' 6-max Seat #3 is the button
Seat 1: shP7DFAtX7gXcgMJX/OmRQ ($20.15 in chips) 
Seat 2: VOmI0x4dDPnTESZd5B4d1Q ($9.60 in chips) 
Seat 3: 6DwBRH+xZ12AAZmeAg+aXw ($30.25 in chips) 
Seat 4: kG34n23qFQA3nzdOJTQ1dA ($27.20 in chips) 
Seat 5: 79ID/ub1Pt/mDpCprVmOoA ($78.80 in chips) 
Seat 6: kyRaCIljYA6l33lSKQfNsg ($29.40 in chips) 
kG34n23qFQA3nzdOJTQ1dA: posts small blind $0.10
79ID/ub1Pt/mDpCprVmOoA: posts big blind $0.25
*** HOLE CARDS ***
kyRaCIljYA6l33lSKQfNsg: folds 
shP7DFAtX7gXcgMJX/OmRQ: calls $0.25
VOmI0x4dDPnTESZd5B4d1Q: folds 
6DwBRH+xZ12AAZmeAg+aXw: folds 
kG34n23qFQA3nzdOJTQ1dA: folds 
79ID/ub1Pt/mDpCprVmOoA: checks 
*** FLOP *** [Td 3c Ks]
79ID/ub1Pt/mDpCprVmOoA: bets $0.50
shP7DFAtX7gXcgMJX/OmRQ: calls $0.50
*** TURN *** [Td 3c Ks] [Js]
79ID/ub1Pt/mDpCprVmOoA: checks 
shP7DFAtX7gXcgMJX/OmRQ: checks 
*** RIVER *** [Td 3c Ks Js] [Ts]
79ID/ub1Pt/mDpCprVmOoA: checks 
shP7DFAtX7gXcgMJX/OmRQ: bets $1
79ID/ub1Pt/mDpCprVmOoA: folds 
Uncalled bet ($1) returned to shP7DFAtX7gXcgMJX/OmRQ
shP7DFAtX7gXcgMJX/OmRQ collected $1.55 from pot
shP7DFAtX7gXcgMJX/OmRQ: doesn't show hand 
*** SUMMARY ***
Total pot $1.60 | Rake $0.05 
Board [Td 3c Ks Js Ts]
Seat 1: shP7DFAtX7gXcgMJX/OmRQ collected ($1.55)
Seat 2: VOmI0x4dDPnTESZd5B4d1Q folded before Flop (didn't bet)
Seat 3: 6DwBRH+xZ12AAZmeAg+aXw (button) folded before Flop (didn't bet)
Seat 4: kG34n23qFQA3nzdOJTQ1dA (small blind) folded before Flop
Seat 5: 79ID/ub1Pt/mDpCprVmOoA (big blind) folded on the River
Seat 6: kyRaCIljYA6l33lSKQfNsg folded before Flop (didn't bet)




PokerStars Game #59941664182:  Hold'em No Limit ($0.10/$0.25) - 2009/07/01 1:42:17 ET
Table 'SHi8+hK6i7E2dJ/3Agbyig' 6-max Seat #5 is the button
Seat 1: gPEN9Zp33YTm/mu9/SYP1w ($30.70 in chips) 
Seat 2: LJI7A1YgDM7hgh7o56+ReQ ($28.80 in chips) 
Seat 3: P1Z7LWu+VU+WmJsI4mr0wA ($24.25 in chips) 
Seat 4: u0ikXOhAPSCLmg+l17oGRw ($11.65 in chips) 
Seat 5: v8m8XHovI5tqEA9mvplDSw ($53.45 in chips) 
Seat 6: cWc85bEzdRzpUMhRKm8pwQ ($25 in chips) 
cWc85bEzdRzpUMhRKm8pwQ: posts small blind $0.10
gPEN9Zp33YTm/mu9/SYP1w: posts big blind $0.25
*** HOLE CARDS ***
LJI7A1YgDM7hgh7o56+ReQ: folds 
P1Z7LWu+VU+WmJsI4mr0wA: folds 
u0ikXOhAPSCLmg+l17oGRw: calls $0.25
v8m8XHovI5tqEA9mvplDSw: folds 
cWc85bEzdRzpUMhRKm8pwQ: raises $1 to $1.25
gPEN9Zp33YTm/mu9/SYP1w: calls $1
u0ikXOhAPSCLmg+l17oGRw: calls $1
*** FLOP *** [Ts 4d 2h]
cWc85bEzdRzpUMhRKm8pwQ: bets $2.50
gPEN9Zp33YTm/mu9/SYP1w: calls $2.50
u0ikXOhAPSCLmg+l17oGRw: folds 
*** TURN *** [Ts 4d 2h] [6h]
cWc85bEzdRzpUMhRKm8pwQ: checks 
gPEN9Zp33YTm/mu9/SYP1w: checks 
*** RIVER *** [Ts 4d 2h 6h] [9h]
cWc85bEzdRzpUMhRKm8pwQ: bets $3
gPEN9Zp33YTm/mu9/SYP1w: calls $3
*** SHOW DOWN ***
cWc85bEzdRzpUMhRKm8pwQ: shows [Tc Kc] (a pair of Tens)
gPEN9Zp33YTm/mu9/SYP1w: shows [Ad Qh] (high card Ace)
cWc85bEzdRzpUMhRKm8pwQ collected $14.05 from pot
*** SUMMARY ***
Total pot $14.75 | Rake $0.70 
Board [Ts 4d 2h 6h 9h]
Seat 1: gPEN9Zp33YTm/mu9/SYP1w (big blind) showed [Ad Qh] and lost with high card Ace
Seat 2: LJI7A1YgDM7hgh7o56+ReQ folded before Flop (didn't bet)
Seat 3: P1Z7LWu+VU+WmJsI4mr0wA folded before Flop (didn't bet)
Seat 4: u0ikXOhAPSCLmg+l17oGRw folded on the Flop
Seat 5: v8m8XHovI5tqEA9mvplDSw (button) folded before Flop (didn't bet)
Seat 6: cWc85bEzdRzpUMhRKm8pwQ (small blind) showed [Tc Kc] and won ($14.05) with a pair of Tens




PokerStars Game #59941663914:  Hold'em No Limit ($0.10/$0.25) - 2009/07/01 1:42:17 ET
Table 'm+FQg/QP0VP1ZA3V62WtOg' 9-max Seat #6 is the button
Seat 5: wf5j8xvJtko6ZXyCbzzlVQ ($13.75 in chips) 
Seat 6: CT7Xj/V/O5rBlhtt+RZeFQ ($25.10 in chips) 
Seat 7: TPAF9YkMsjQFq978RNWZEQ ($15.35 in chips) 
Seat 9: zUXhymECc2C9W9ZNw6qppA ($10.55 in chips) 
TPAF9YkMsjQFq978RNWZEQ: posts small blind $0.10
zUXhymECc2C9W9ZNw6qppA: posts big blind $0.25
+KblIivb6tainScpwm14RQ: sits out 
wf5j8xvJtko6ZXyCbzzlVQ: posts big blind $0.25
*** HOLE CARDS ***
wf5j8xvJtko6ZXyCbzzlVQ: checks 
CT7Xj/V/O5rBlhtt+RZeFQ: folds 
TPAF9YkMsjQFq978RNWZEQ: calls $0.15
zUXhymECc2C9W9ZNw6qppA: checks 
*** FLOP *** [Qd 5d 8s]
f/e5w8nN3RjdX9H1eRlDdA joins the table at seat #4 
TPAF9YkMsjQFq978RNWZEQ: checks 
zUXhymECc2C9W9ZNw6qppA: checks 
wf5j8xvJtko6ZXyCbzzlVQ: bets $0.25
TPAF9YkMsjQFq978RNWZEQ: calls $0.25
f/e5w8nN3RjdX9H1eRlDdA leaves the table
L2sCMFMB88ntwrAVYva+kQ joins the table at seat #2 
zUXhymECc2C9W9ZNw6qppA: folds 
*** TURN *** [Qd 5d 8s] [Ks]
TPAF9YkMsjQFq978RNWZEQ: checks 
wf5j8xvJtko6ZXyCbzzlVQ: checks 
*** RIVER *** [Qd 5d 8s Ks] [5c]
TPAF9YkMsjQFq978RNWZEQ: bets $0.75
qwr38jl5txoR36M7G5qi4A was removed from the table for failing to post
dubÃ©705 joins the table at seat #4 
wf5j8xvJtko6ZXyCbzzlVQ: folds 
Uncalled bet ($0.75) returned to TPAF9YkMsjQFq978RNWZEQ
VegasVas joins the table at seat #8 
TPAF9YkMsjQFq978RNWZEQ collected $1.20 from pot
*** SUMMARY ***
Total pot $1.25 | Rake $0.05 
Board [Qd 5d 8s Ks 5c]
Seat 5: wf5j8xvJtko6ZXyCbzzlVQ folded on the River
Seat 6: CT7Xj/V/O5rBlhtt+RZeFQ (button) folded before Flop (didn't bet)
Seat 7: TPAF9YkMsjQFq978RNWZEQ (small blind) collected ($1.20)
Seat 9: zUXhymECc2C9W9ZNw6qppA (big blind) folded on the Flop




PokerStars Game #59941664192:  Hold'em No Limit ($0.10/$0.25) - 2009/07/01 1:42:17 ET
Table 'IdXp6nyeW4FYaEK4qKCnwQ' 9-max Seat #8 is the button
Seat 1: tLcDklc2rBORNfixyRfVfw ($25 in chips) 
Seat 2: HPEB+AtKw1+C/cxU0o1ciw ($32.50 in chips) 
Seat 3: eK8qa6EPcH2zhtbmWSvc9g ($33.05 in chips) 
Seat 4: j4q3p0lesp63b1gZDwLBZw ($5.35 in chips) 
Seat 5: U41wNf6XauAiBOQaKu2ZIA ($25.65 in chips) 
Seat 6: arxNSjreDRGFg13EAM2F1w ($25.85 in chips) 
Seat 7: w1ukf8uPa4+WH561TtVRxA ($37 in chips) 
Seat 8: dtZ84flFEi4Q+SGrHMJRDQ ($31.10 in chips) 
Seat 9: s2xLPOl/vhl/26apJ3vsOQ ($29 in chips) 
s2xLPOl/vhl/26apJ3vsOQ: posts small blind $0.10
tLcDklc2rBORNfixyRfVfw: posts big blind $0.25
*** HOLE CARDS ***
HPEB+AtKw1+C/cxU0o1ciw: folds 
eK8qa6EPcH2zhtbmWSvc9g: calls $0.25
j4q3p0lesp63b1gZDwLBZw: folds 
U41wNf6XauAiBOQaKu2ZIA: folds 
arxNSjreDRGFg13EAM2F1w: folds 
w1ukf8uPa4+WH561TtVRxA: folds 
dtZ84flFEi4Q+SGrHMJRDQ: folds 
s2xLPOl/vhl/26apJ3vsOQ: folds 
tLcDklc2rBORNfixyRfVfw: checks 
*** FLOP *** [2c 3c As]
tLcDklc2rBORNfixyRfVfw: checks 
eK8qa6EPcH2zhtbmWSvc9g: bets $0.35
tLcDklc2rBORNfixyRfVfw: folds 
Uncalled bet ($0.35) returned to eK8qa6EPcH2zhtbmWSvc9g
eK8qa6EPcH2zhtbmWSvc9g collected $0.60 from pot
eK8qa6EPcH2zhtbmWSvc9g: doesn't show hand 
*** SUMMARY ***
Total pot $0.60 | Rake $0 
Board [2c 3c As]
Seat 1: tLcDklc2rBORNfixyRfVfw (big blind) folded on the Flop
Seat 2: HPEB+AtKw1+C/cxU0o1ciw folded before Flop (didn't bet)
Seat 3: eK8qa6EPcH2zhtbmWSvc9g collected ($0.60)
Seat 4: j4q3p0lesp63b1gZDwLBZw folded before Flop (didn't bet)
Seat 5: U41wNf6XauAiBOQaKu2ZIA folded before Flop (didn't bet)
Seat 6: arxNSjreDRGFg13EAM2F1w folded before Flop (didn't bet)
Seat 7: w1ukf8uPa4+WH561TtVRxA folded before Flop (didn't bet)
Seat 8: dtZ84flFEi4Q+SGrHMJRDQ (button) folded before Flop (didn't bet)
Seat 9: s2xLPOl/vhl/26apJ3vsOQ (small blind) folded before Flop




PokerStars Game #59941664582:  Hold'em No Limit ($0.10/$0.25) - 2009/07/01 1:42:18 ET
Table 'ohAuixfiLOYDylNUG5mNUw' 9-max Seat #7 is the button
Seat 1: W6tExOcYX7qiy6Qdp+ZwFA ($10 in chips) 
Seat 2: Th3FldXKQW6hWVVPahaoOQ ($27.15 in chips) 
Seat 3: gSakoFAgDDzXSb2eNBWKcg ($14.65 in chips) 
Seat 4: AiXn/9o1EwOPZUHujnh/bA ($18.65 in chips) 
Seat 5: wub1jsnHlpWmOX4uczVADA ($7.40 in chips) 
Seat 6: MtVtHDqIJTyUcXkRBBDIVA ($25 in chips) 
Seat 7: +qc/EYCgLC65SpGvr35eNg ($24.65 in chips) 
Seat 8: ppMlNkhYgErlt4fuJO7ADA ($2.60 in chips) 
Seat 9: CT7Xj/V/O5rBlhtt+RZeFQ ($25.35 in chips) 
ppMlNkhYgErlt4fuJO7ADA: posts small blind $0.10
CT7Xj/V/O5rBlhtt+RZeFQ: posts big blind $0.25
*** HOLE CARDS ***
W6tExOcYX7qiy6Qdp+ZwFA: folds 
Th3FldXKQW6hWVVPahaoOQ: folds 
gSakoFAgDDzXSb2eNBWKcg: raises $0.75 to $1
AiXn/9o1EwOPZUHujnh/bA: folds 
wub1jsnHlpWmOX4uczVADA: folds 
MtVtHDqIJTyUcXkRBBDIVA: folds 
+qc/EYCgLC65SpGvr35eNg: folds 
ppMlNkhYgErlt4fuJO7ADA: folds 
CT7Xj/V/O5rBlhtt+RZeFQ: folds 
Uncalled bet ($0.75) returned to gSakoFAgDDzXSb2eNBWKcg
gSakoFAgDDzXSb2eNBWKcg collected $0.60 from pot
*** SUMMARY ***
Total pot $0.60 | Rake $0 
Seat 1: W6tExOcYX7qiy6Qdp+ZwFA folded before Flop (didn't bet)
Seat 2: Th3FldXKQW6hWVVPahaoOQ folded before Flop (didn't bet)
Seat 3: gSakoFAgDDzXSb2eNBWKcg collected ($0.60)
Seat 4: AiXn/9o1EwOPZUHujnh/bA folded before Flop (didn't bet)
Seat 5: wub1jsnHlpWmOX4uczVADA folded before Flop (didn't bet)
Seat 6: MtVtHDqIJTyUcXkRBBDIVA folded before Flop (didn't bet)
Seat 7: +qc/EYCgLC65SpGvr35eNg (button) folded before Flop (didn't bet)
Seat 8: ppMlNkhYgErlt4fuJO7ADA (small blind) folded before Flop
Seat 9: CT7Xj/V/O5rBlhtt+RZeFQ (big blind) folded before Flop




PokerStars Game #59941664394:  Hold'em No Limit ($0.10/$0.25) - 2009/07/01 1:42:18 ET
Table '8PD/MTROSMd6Y8mZeykbpg' 6-max Seat #1 is the button
Seat 1: fxNpaToxECtD2Goelmg9vA ($24.75 in chips) 
Seat 3: vqWjZmdQu/Hxw96/IJTWdQ ($25.35 in chips) 
Seat 4: DFi/Lzkjsfv8QswS80JX9Q ($53.70 in chips) 
Seat 5: z3tQwy28dp5FykDJC/wzQw ($25.95 in chips) 
vqWjZmdQu/Hxw96/IJTWdQ: posts small blind $0.10
DFi/Lzkjsfv8QswS80JX9Q: posts big blind $0.25
*** HOLE CARDS ***
z3tQwy28dp5FykDJC/wzQw: folds 
fxNpaToxECtD2Goelmg9vA: folds 
vqWjZmdQu/Hxw96/IJTWdQ: folds 
Uncalled bet ($0.15) returned to DFi/Lzkjsfv8QswS80JX9Q
DFi/Lzkjsfv8QswS80JX9Q collected $0.20 from pot
DFi/Lzkjsfv8QswS80JX9Q: doesn't show hand 
trN/oHqTTbPw5MNuKrOpLw has returned
*** SUMMARY ***
Total pot $0.20 | Rake $0 
Seat 1: fxNpaToxECtD2Goelmg9vA (button) folded before Flop (didn't bet)
Seat 3: vqWjZmdQu/Hxw96/IJTWdQ (small blind) folded before Flop
Seat 4: DFi/Lzkjsfv8QswS80JX9Q (big blind) collected ($0.20)
Seat 5: z3tQwy28dp5FykDJC/wzQw folded before Flop (didn't bet)




PokerStars Game #59941664576:  Hold'em No Limit ($0.10/$0.25) - 2009/07/01 1:42:18 ET
Table '+198VWQSWBhYQOcizzuBkw' 6-max Seat #6 is the button
Seat 1: 34ttqW62uIRrqINCCmLcsw ($11.95 in chips) 
Seat 2: iauW7L/+7qzAuHow7CD75Q ($5 in chips) 
Seat 3: vw7gefupgmOJJN8lUemdWg ($24.40 in chips) 
Seat 4: TgDsTeCdLQt8kWbL00ByRA ($16.25 in chips) 
Seat 5: LtASJ9OlkqGrrUKGQlpGAw ($26.45 in chips) 
Seat 6: leEQ84f6wJYu5SB/vj27wg ($10.10 in chips) 
34ttqW62uIRrqINCCmLcsw: posts small blind $0.10
iauW7L/+7qzAuHow7CD75Q: posts big blind $0.25
*** HOLE CARDS ***
vw7gefupgmOJJN8lUemdWg: folds 
TgDsTeCdLQt8kWbL00ByRA: folds 
LtASJ9OlkqGrrUKGQlpGAw: raises $0.50 to $0.75
leEQ84f6wJYu5SB/vj27wg: calls $0.75
34ttqW62uIRrqINCCmLcsw: calls $0.65
iauW7L/+7qzAuHow7CD75Q: calls $0.50
*** FLOP *** [4s 3h 5h]
34ttqW62uIRrqINCCmLcsw: checks 
iauW7L/+7qzAuHow7CD75Q: bets $3
LtASJ9OlkqGrrUKGQlpGAw: folds 
leEQ84f6wJYu5SB/vj27wg: folds 
34ttqW62uIRrqINCCmLcsw: raises $3 to $6
iauW7L/+7qzAuHow7CD75Q: calls $1.25 and is all-in
Uncalled bet ($1.75) returned to 34ttqW62uIRrqINCCmLcsw
*** TURN *** [4s 3h 5h] [6d]
*** RIVER *** [4s 3h 5h 6d] [Jc]
*** SHOW DOWN ***
34ttqW62uIRrqINCCmLcsw: shows [Ts Tc] (a pair of Tens)
iauW7L/+7qzAuHow7CD75Q: shows [7h 5s] (a straight, Three to Seven)
iauW7L/+7qzAuHow7CD75Q collected $10.95 from pot
*** SUMMARY ***
Total pot $11.50 | Rake $0.55 
Board [4s 3h 5h 6d Jc]
Seat 1: 34ttqW62uIRrqINCCmLcsw (small blind) showed [Ts Tc] and lost with a pair of Tens
Seat 2: iauW7L/+7qzAuHow7CD75Q (big blind) showed [7h 5s] and won ($10.95) with a straight, Three to Seven
Seat 3: vw7gefupgmOJJN8lUemdWg folded before Flop (didn't bet)
Seat 4: TgDsTeCdLQt8kWbL00ByRA folded before Flop (didn't bet)
Seat 5: LtASJ9OlkqGrrUKGQlpGAw folded on the Flop
Seat 6: leEQ84f6wJYu5SB/vj27wg (button) folded on the Flop




PokerStars Game #59941664714:  Hold'em No Limit ($0.10/$0.25) - 2009/07/01 1:42:18 ET
Table 'Do4nrTNDYpK3sQjwFxX+Og' 6-max Seat #4 is the button
Seat 1: 7JrQNOR9wRBxq9ijFhWieg ($38.90 in chips) 
Seat 2: tzMoGl9F0PUr5NibYueeSw ($68.45 in chips) 
Seat 3: TSmua8tGK3sTbwi0ynrW9Q ($25 in chips) 
Seat 4: cWc85bEzdRzpUMhRKm8pwQ ($33.40 in chips) 
Seat 5: Ew/TYPQIsbQ2X8nm5iAJBg ($34.95 in chips) 
Seat 6: lBoEwOFgzcERLIRUkUoRTw ($23.90 in chips) 
Ew/TYPQIsbQ2X8nm5iAJBg: posts small blind $0.10
lBoEwOFgzcERLIRUkUoRTw: posts big blind $0.25
*** HOLE CARDS ***
7JrQNOR9wRBxq9ijFhWieg: folds 
tzMoGl9F0PUr5NibYueeSw: folds 
TSmua8tGK3sTbwi0ynrW9Q: folds 
cWc85bEzdRzpUMhRKm8pwQ: folds 
Ew/TYPQIsbQ2X8nm5iAJBg: raises $0.75 to $1
lBoEwOFgzcERLIRUkUoRTw: folds 
Uncalled bet ($0.75) returned to Ew/TYPQIsbQ2X8nm5iAJBg
Ew/TYPQIsbQ2X8nm5iAJBg collected $0.50 from pot
Ew/TYPQIsbQ2X8nm5iAJBg: doesn't show hand 
*** SUMMARY ***
Total pot $0.50 | Rake $0 
Seat 1: 7JrQNOR9wRBxq9ijFhWieg folded before Flop (didn't bet)
Seat 2: tzMoGl9F0PUr5NibYueeSw folded before Flop (didn't bet)
Seat 3: TSmua8tGK3sTbwi0ynrW9Q folded before Flop (didn't bet)
Seat 4: cWc85bEzdRzpUMhRKm8pwQ (button) folded before Flop (didn't bet)
Seat 5: Ew/TYPQIsbQ2X8nm5iAJBg (small blind) collected ($0.50)
Seat 6: lBoEwOFgzcERLIRUkUoRTw (big blind) folded before Flop




PokerStars Game #59941664902:  Hold'em No Limit ($0.10/$0.25) - 2009/07/01 1:42:18 ET
Table 'Pz8SfAzhP5nvWTsJRAxoDg' 6-max Seat #5 is the button
Seat 1: QiL+lEgEWwy21jk/ltaRLg ($25.95 in chips) 
Seat 2: xrf8tAXKQHG99HixCot1Iw ($25.15 in chips) 
Seat 3: mfrkWA3PTeYPkbO6hi98Aw ($28.20 in chips) 
Seat 4: 4lJto+Qj0K4JrFKvHaPTLw ($66.15 in chips) 
Seat 5: FYepjhAvF8ZdVCmqHIy+eQ ($28.40 in chips) 
Seat 6: QvTX2yGq3uKJiKPmns4TKQ ($24.75 in chips) 
QvTX2yGq3uKJiKPmns4TKQ: posts small blind $0.10
QiL+lEgEWwy21jk/ltaRLg: posts big blind $0.25
*** HOLE CARDS ***
xrf8tAXKQHG99HixCot1Iw: folds 
mfrkWA3PTeYPkbO6hi98Aw: folds 
4lJto+Qj0K4JrFKvHaPTLw: folds 
FYepjhAvF8ZdVCmqHIy+eQ: folds 
QvTX2yGq3uKJiKPmns4TKQ: folds 
Uncalled bet ($0.15) returned to QiL+lEgEWwy21jk/ltaRLg
QiL+lEgEWwy21jk/ltaRLg collected $0.20 from pot
*** SUMMARY ***
Total pot $0.20 | Rake $0 
Seat 1: QiL+lEgEWwy21jk/ltaRLg (big blind) collected ($0.20)
Seat 2: xrf8tAXKQHG99HixCot1Iw folded before Flop (didn't bet)
Seat 3: mfrkWA3PTeYPkbO6hi98Aw folded before Flop (didn't bet)
Seat 4: 4lJto+Qj0K4JrFKvHaPTLw folded before Flop (didn't bet)
Seat 5: FYepjhAvF8ZdVCmqHIy+eQ (button) folded before Flop (didn't bet)
Seat 6: QvTX2yGq3uKJiKPmns4TKQ (small blind) folded before Flop




PokerStars Game #59941664586:  Hold'em No Limit ($0.10/$0.25) - 2009/07/01 1:42:18 ET
Table 'mk323gviqdkOY5Aek/1EWg' 6-max Seat #5 is the button
Seat 1: L3/N/gliETan8N5Gim5h4Q ($25.75 in chips) 
Seat 2: GC/9yVD59DUCX7hUI7gcLw ($56.40 in chips) 
Seat 3: NuqYPwTLZYQhxOoVK3Yqlw ($23.65 in chips) 
Seat 4: +baiVgI/ETnBARLe5mARCw ($11.80 in chips) 
Seat 5: kjYRzIfvZNNflYMYRkkSVA ($28 in chips) 
Seat 6: KkXSr5xFjxLSD3wtAvT+WQ ($8.55 in chips) 
KkXSr5xFjxLSD3wtAvT+WQ: posts small blind $0.10
L3/N/gliETan8N5Gim5h4Q: posts big blind $0.25
*** HOLE CARDS ***
GC/9yVD59DUCX7hUI7gcLw: folds 
NuqYPwTLZYQhxOoVK3Yqlw: folds 
+baiVgI/ETnBARLe5mARCw: raises $0.75 to $1
kjYRzIfvZNNflYMYRkkSVA: folds 
KkXSr5xFjxLSD3wtAvT+WQ: folds 
L3/N/gliETan8N5Gim5h4Q: folds 
Uncalled bet ($0.75) returned to +baiVgI/ETnBARLe5mARCw
+baiVgI/ETnBARLe5mARCw collected $0.60 from pot
+baiVgI/ETnBARLe5mARCw: doesn't show hand 
*** SUMMARY ***
Total pot $0.60 | Rake $0 
Seat 1: L3/N/gliETan8N5Gim5h4Q (big blind) folded before Flop
Seat 2: GC/9yVD59DUCX7hUI7gcLw folded before Flop (didn't bet)
Seat 3: NuqYPwTLZYQhxOoVK3Yqlw folded before Flop (didn't bet)
Seat 4: +baiVgI/ETnBARLe5mARCw collected ($0.60)
Seat 5: kjYRzIfvZNNflYMYRkkSVA (button) folded before Flop (didn't bet)
Seat 6: KkXSr5xFjxLSD3wtAvT+WQ (small blind) folded before Flop




PokerStars Game #59941664670:  Hold'em No Limit ($0.10/$0.25) - 2009/07/01 1:42:18 ET
Table 'JPFXJXa5xBkjZ/W15BKqeQ' 9-max Seat #1 is the button
Seat 1: mNQH7Afv3tbDKl2tAb9BOg ($19.25 in chips) 
Seat 2: XMSS6mD5B42I8wasdOMipQ ($10.70 in chips) 
Seat 3: 56S3mA6Zs3pGR+0p0vUCtg ($22.05 in chips) 
Seat 4: wGigCmBR/9XWkPpvYos3aQ ($26.75 in chips) 
Seat 5: cZ99hugmLBj9KhTlc8nCSw ($25 in chips) 
Seat 6: tLcDklc2rBORNfixyRfVfw ($25.35 in chips) 
Seat 9: PVqNFEFMoGtpTPGnpm4LTQ ($25.90 in chips) 
XMSS6mD5B42I8wasdOMipQ: posts small blind $0.10
56S3mA6Zs3pGR+0p0vUCtg: posts big blind $0.25
PdIasPkzm2sqZnN41ZRXOg: sits out 
*** HOLE CARDS ***
wGigCmBR/9XWkPpvYos3aQ: folds 
cZ99hugmLBj9KhTlc8nCSw: raises $0.50 to $0.75
tLcDklc2rBORNfixyRfVfw: folds 
PVqNFEFMoGtpTPGnpm4LTQ: folds 
mNQH7Afv3tbDKl2tAb9BOg: folds 
PVqNFEFMoGtpTPGnpm4LTQ leaves the table
XMSS6mD5B42I8wasdOMipQ: folds 
V6p0jQ/RhUsqpHLmXvEX4Q joins the table at seat #9 
56S3mA6Zs3pGR+0p0vUCtg: calls $0.50
*** FLOP *** [2h 8h 9h]
56S3mA6Zs3pGR+0p0vUCtg: bets $0.50
cZ99hugmLBj9KhTlc8nCSw: raises $1.50 to $2
56S3mA6Zs3pGR+0p0vUCtg: calls $1.50
*** TURN *** [2h 8h 9h] [4c]
56S3mA6Zs3pGR+0p0vUCtg: checks 
cZ99hugmLBj9KhTlc8nCSw: bets $5
56S3mA6Zs3pGR+0p0vUCtg: folds 
Uncalled bet ($5) returned to cZ99hugmLBj9KhTlc8nCSw
cZ99hugmLBj9KhTlc8nCSw collected $5.35 from pot
cZ99hugmLBj9KhTlc8nCSw: doesn't show hand 
*** SUMMARY ***
Total pot $5.60 | Rake $0.25 
Board [2h 8h 9h 4c]
Seat 1: mNQH7Afv3tbDKl2tAb9BOg (button) folded before Flop (didn't bet)
Seat 2: XMSS6mD5B42I8wasdOMipQ (small blind) folded before Flop
Seat 3: 56S3mA6Zs3pGR+0p0vUCtg (big blind) folded on the Turn
Seat 4: wGigCmBR/9XWkPpvYos3aQ folded before Flop (didn't bet)
Seat 5: cZ99hugmLBj9KhTlc8nCSw collected ($5.35)
Seat 6: tLcDklc2rBORNfixyRfVfw folded before Flop (didn't bet)
Seat 9: PVqNFEFMoGtpTPGnpm4LTQ folded before Flop (didn't bet)




PokerStars Game #59941665324:  Hold'em No Limit ($0.10/$0.25) - 2009/07/01 1:42:19 ET
Table '4ZbiE0ZYjzqmgu6+sO1prg' 9-max Seat #8 is the button
Seat 2: 9lvO/qyU+xrU95Teu1fv0g ($5.55 in chips) 
Seat 3: HPEB+AtKw1+C/cxU0o1ciw ($25.55 in chips) 
Seat 4: w1ukf8uPa4+WH561TtVRxA ($25 in chips) 
Seat 5: +2kMBNpY4nF1qNCRd8SJLA ($43.95 in chips) 
Seat 7: aNpwfA31EREwO+ar4XzBCw ($25.95 in chips) 
Seat 8: cZ99hugmLBj9KhTlc8nCSw ($29.60 in chips) 
Seat 9: RCqMONFrSPSArZh2Jsar/w ($20.10 in chips) 
RCqMONFrSPSArZh2Jsar/w: posts small blind $0.10
eXiRSFoUjkV5taBc4N8rMQ: is sitting out 
9lvO/qyU+xrU95Teu1fv0g: posts big blind $0.25
*** HOLE CARDS ***
HPEB+AtKw1+C/cxU0o1ciw: folds 
w1ukf8uPa4+WH561TtVRxA: folds 
+2kMBNpY4nF1qNCRd8SJLA: folds 
aNpwfA31EREwO+ar4XzBCw: folds 
cZ99hugmLBj9KhTlc8nCSw: folds 
RCqMONFrSPSArZh2Jsar/w: raises $0.75 to $1
eXiRSFoUjkV5taBc4N8rMQ has returned
9lvO/qyU+xrU95Teu1fv0g: folds 
Uncalled bet ($0.75) returned to RCqMONFrSPSArZh2Jsar/w
RCqMONFrSPSArZh2Jsar/w collected $0.50 from pot
RCqMONFrSPSArZh2Jsar/w: doesn't show hand 
*** SUMMARY ***
Total pot $0.50 | Rake $0 
Seat 2: 9lvO/qyU+xrU95Teu1fv0g (big blind) folded before Flop
Seat 3: HPEB+AtKw1+C/cxU0o1ciw folded before Flop (didn't bet)
Seat 4: w1ukf8uPa4+WH561TtVRxA folded before Flop (didn't bet)
Seat 5: +2kMBNpY4nF1qNCRd8SJLA folded before Flop (didn't bet)
Seat 7: aNpwfA31EREwO+ar4XzBCw folded before Flop (didn't bet)
Seat 8: cZ99hugmLBj9KhTlc8nCSw (button) folded before Flop (didn't bet)
Seat 9: RCqMONFrSPSArZh2Jsar/w (small blind) collected ($0.50)




PokerStars Game #59941664942:  Hold'em No Limit ($0.10/$0.25) - 2009/07/01 1:42:19 ET
Table 'rtxA1Y01Nrq5VoyzTAuusQ' 9-max Seat #8 is the button
Seat 1: w1ukf8uPa4+WH561TtVRxA ($26.90 in chips) 
Seat 3: K9fS1IUr5GpiJG7VkJ7IbA ($4.90 in chips) 
Seat 4: lTfGgdGMRH+DZcKby2m9Nw ($13.95 in chips) 
Seat 5: MtVtHDqIJTyUcXkRBBDIVA ($27.55 in chips) 
Seat 7: 3PmVnC/15cl4oyI1TKIt4g ($9.65 in chips) 
Seat 8: DnDcAdn9P0zGovMERigpFA ($25 in chips) 
Seat 9: HPEB+AtKw1+C/cxU0o1ciw ($22.70 in chips) 
HPEB+AtKw1+C/cxU0o1ciw: posts small blind $0.10
w1ukf8uPa4+WH561TtVRxA: posts big blind $0.25
Th3FldXKQW6hWVVPahaoOQ: sits out 
*** HOLE CARDS ***
K9fS1IUr5GpiJG7VkJ7IbA: calls $0.25
lTfGgdGMRH+DZcKby2m9Nw: folds 
lTfGgdGMRH+DZcKby2m9Nw leaves the table
MtVtHDqIJTyUcXkRBBDIVA: folds 
3PmVnC/15cl4oyI1TKIt4g: folds 
w1ukf8uPa4+WH561TtVRxA said, "AKQ"
RHqgdFvufLCYe54+qd2gcA joins the table at seat #4 
DnDcAdn9P0zGovMERigpFA: folds 
HPEB+AtKw1+C/cxU0o1ciw: folds 
w1ukf8uPa4+WH561TtVRxA: checks 
*** FLOP *** [9s Ad Ah]
w1ukf8uPa4+WH561TtVRxA: checks 
K9fS1IUr5GpiJG7VkJ7IbA: checks 
*** TURN *** [9s Ad Ah] [Ac]
w1ukf8uPa4+WH561TtVRxA: checks 
K9fS1IUr5GpiJG7VkJ7IbA: bets $0.25
w1ukf8uPa4+WH561TtVRxA: folds 
Uncalled bet ($0.25) returned to K9fS1IUr5GpiJG7VkJ7IbA
K9fS1IUr5GpiJG7VkJ7IbA collected $0.60 from pot
K9fS1IUr5GpiJG7VkJ7IbA: doesn't show hand 
*** SUMMARY ***
Total pot $0.60 | Rake $0 
Board [9s Ad Ah Ac]
Seat 1: w1ukf8uPa4+WH561TtVRxA (big blind) folded on the Turn
Seat 3: K9fS1IUr5GpiJG7VkJ7IbA collected ($0.60)
Seat 4: lTfGgdGMRH+DZcKby2m9Nw folded before Flop (didn't bet)
Seat 5: MtVtHDqIJTyUcXkRBBDIVA folded before Flop (didn't bet)
Seat 7: 3PmVnC/15cl4oyI1TKIt4g folded before Flop (didn't bet)
Seat 8: DnDcAdn9P0zGovMERigpFA (button) folded before Flop (didn't bet)
Seat 9: HPEB+AtKw1+C/cxU0o1ciw (small blind) folded before Flop




PokerStars Game #59941665366:  Hold'em No Limit ($0.10/$0.25) - 2009/07/01 1:42:19 ET
Table '5SUMWYuPsGiOD0FY0QbgOw' 6-max Seat #3 is the button
Seat 1: SFmT9ZsVopnukjvAzrxTRg ($25 in chips) 
Seat 2: xrf8tAXKQHG99HixCot1Iw ($36.55 in chips) 
Seat 3: MqMK8OWPSY1V4stf1Hy5Jw ($38.80 in chips) 
Seat 4: BV+K0Phf5VBHr7aZPKqbUQ ($25.10 in chips) 
Seat 5: v+QfkGiuj9bgtuNoVnDO8w ($40.75 in chips) 
Seat 6: jA7YMtfNUnAaebB7Lj74EA ($25.95 in chips) 
BV+K0Phf5VBHr7aZPKqbUQ: posts small blind $0.10
v+QfkGiuj9bgtuNoVnDO8w: posts big blind $0.25
*** HOLE CARDS ***
jA7YMtfNUnAaebB7Lj74EA: calls $0.25
SFmT9ZsVopnukjvAzrxTRg: folds 
xrf8tAXKQHG99HixCot1Iw: folds 
MqMK8OWPSY1V4stf1Hy5Jw: folds 
BV+K0Phf5VBHr7aZPKqbUQ: calls $0.15
v+QfkGiuj9bgtuNoVnDO8w: checks 
*** FLOP *** [4h Ac 4c]
BV+K0Phf5VBHr7aZPKqbUQ: checks 
v+QfkGiuj9bgtuNoVnDO8w: checks 
jA7YMtfNUnAaebB7Lj74EA: checks 
*** TURN *** [4h Ac 4c] [Qh]
BV+K0Phf5VBHr7aZPKqbUQ: checks 
v+QfkGiuj9bgtuNoVnDO8w: checks 
jA7YMtfNUnAaebB7Lj74EA: bets $1
BV+K0Phf5VBHr7aZPKqbUQ: folds 
v+QfkGiuj9bgtuNoVnDO8w: folds 
Uncalled bet ($1) returned to jA7YMtfNUnAaebB7Lj74EA
jA7YMtfNUnAaebB7Lj74EA collected $0.75 from pot
jA7YMtfNUnAaebB7Lj74EA: doesn't show hand 
*** SUMMARY ***
Total pot $0.75 | Rake $0 
Board [4h Ac 4c Qh]
Seat 1: SFmT9ZsVopnukjvAzrxTRg folded before Flop (didn't bet)
Seat 2: xrf8tAXKQHG99HixCot1Iw folded before Flop (didn't bet)
Seat 3: MqMK8OWPSY1V4stf1Hy5Jw (button) folded before Flop (didn't bet)
Seat 4: BV+K0Phf5VBHr7aZPKqbUQ (small blind) folded on the Turn
Seat 5: v+QfkGiuj9bgtuNoVnDO8w (big blind) folded on the Turn
Seat 6: jA7YMtfNUnAaebB7Lj74EA collected ($0.75)




PokerStars Game #59941665058:  Hold'em No Limit ($0.10/$0.25) - 2009/07/01 1:42:19 ET
Table 'jdhJTJjFq2KTttwJcd+7nQ' 6-max Seat #2 is the button
Seat 1: LtASJ9OlkqGrrUKGQlpGAw ($27.20 in chips) 
Seat 2: Hsvkc0/G2VV78oVmWYXecw ($5 in chips) 
Seat 3: vqWjZmdQu/Hxw96/IJTWdQ ($26.05 in chips) 
Seat 4: vx7FwRcelVSsvNYAdp/z0A ($3.50 in chips) 
Seat 5: BV+K0Phf5VBHr7aZPKqbUQ ($26 in chips) 
Seat 6: yb6rnd48JuBccThV68VHAQ ($19.65 in chips) 
vqWjZmdQu/Hxw96/IJTWdQ: posts small blind $0.10
vx7FwRcelVSsvNYAdp/z0A: posts big blind $0.25
*** HOLE CARDS ***
BV+K0Phf5VBHr7aZPKqbUQ: folds 
yb6rnd48JuBccThV68VHAQ: calls $0.25
LtASJ9OlkqGrrUKGQlpGAw: folds 
Hsvkc0/G2VV78oVmWYXecw: folds 
vqWjZmdQu/Hxw96/IJTWdQ: folds 
vx7FwRcelVSsvNYAdp/z0A: checks 
*** FLOP *** [As Jd 8h]
vx7FwRcelVSsvNYAdp/z0A: checks 
yb6rnd48JuBccThV68VHAQ: checks 
*** TURN *** [As Jd 8h] [Jc]
vx7FwRcelVSsvNYAdp/z0A: checks 
yb6rnd48JuBccThV68VHAQ: checks 
*** RIVER *** [As Jd 8h Jc] [Js]
vx7FwRcelVSsvNYAdp/z0A: checks 
yb6rnd48JuBccThV68VHAQ: checks 
*** SHOW DOWN ***
vx7FwRcelVSsvNYAdp/z0A: shows [7s 6c] (three of a kind, Jacks)
yb6rnd48JuBccThV68VHAQ: shows [2d Td] (three of a kind, Jacks - Ace+Ten kicker)
yb6rnd48JuBccThV68VHAQ collected $0.60 from pot
*** SUMMARY ***
Total pot $0.60 | Rake $0 
Board [As Jd 8h Jc Js]
Seat 1: LtASJ9OlkqGrrUKGQlpGAw folded before Flop (didn't bet)
Seat 2: Hsvkc0/G2VV78oVmWYXecw (button) folded before Flop (didn't bet)
Seat 3: vqWjZmdQu/Hxw96/IJTWdQ (small blind) folded before Flop
Seat 4: vx7FwRcelVSsvNYAdp/z0A (big blind) showed [7s 6c] and lost with three of a kind, Jacks
Seat 5: BV+K0Phf5VBHr7aZPKqbUQ folded before Flop (didn't bet)
Seat 6: yb6rnd48JuBccThV68VHAQ showed [2d Td] and won ($0.60) with three of a kind, Jacks




PokerStars Game #59941665292:  Hold'em No Limit ($0.10/$0.25) - 2009/07/01 1:42:19 ET
Table 'rO1I30HnuCPB0M8qEX1TCQ' 9-max Seat #4 is the button
Seat 1: dfsOFy2nKDeSF9SjtdIyVA ($12.50 in chips) 
Seat 2: z1hPotrGOZjUjyoopZ7Ulg ($20.65 in chips) 
Seat 3: 2wcFsZsqEP5w1StUTVzJCg ($13.15 in chips) 
Seat 4: yyG4svzOpC1A+sUP/scg6w ($10.40 in chips) 
Seat 5: W6tExOcYX7qiy6Qdp+ZwFA ($5.20 in chips) 
Seat 6: 5n7e7I+px7c6CQmLpPbtsg ($5 in chips) 
Seat 8: 6mStmDUknIn/RyBEoiIyoQ ($3.20 in chips) 
Seat 9: AiXn/9o1EwOPZUHujnh/bA ($21.90 in chips) 
W6tExOcYX7qiy6Qdp+ZwFA: posts small blind $0.10
5n7e7I+px7c6CQmLpPbtsg: posts big blind $0.25
bXpVeaSTPBFSPJmeXxO7nw: sits out 
*** HOLE CARDS ***
6mStmDUknIn/RyBEoiIyoQ: folds 
AiXn/9o1EwOPZUHujnh/bA: folds 
dfsOFy2nKDeSF9SjtdIyVA: raises $0.25 to $0.50
z1hPotrGOZjUjyoopZ7Ulg: calls $0.50
2wcFsZsqEP5w1StUTVzJCg: folds 
yyG4svzOpC1A+sUP/scg6w: folds 
W6tExOcYX7qiy6Qdp+ZwFA: folds 
5n7e7I+px7c6CQmLpPbtsg: folds 
*** FLOP *** [7c 4d 8s]
dfsOFy2nKDeSF9SjtdIyVA: bets $0.25
z1hPotrGOZjUjyoopZ7Ulg: calls $0.25
*** TURN *** [7c 4d 8s] [3h]
dfsOFy2nKDeSF9SjtdIyVA: checks 
z1hPotrGOZjUjyoopZ7Ulg: checks 
*** RIVER *** [7c 4d 8s 3h] [9h]
dfsOFy2nKDeSF9SjtdIyVA: checks 
z1hPotrGOZjUjyoopZ7Ulg: checks 
*** SHOW DOWN ***
dfsOFy2nKDeSF9SjtdIyVA: shows [Qc As] (high card Ace)
z1hPotrGOZjUjyoopZ7Ulg: shows [7h Qs] (a pair of Sevens)
z1hPotrGOZjUjyoopZ7Ulg collected $1.80 from pot
*** SUMMARY ***
Total pot $1.85 | Rake $0.05 
Board [7c 4d 8s 3h 9h]
Seat 1: dfsOFy2nKDeSF9SjtdIyVA showed [Qc As] and lost with high card Ace
Seat 2: z1hPotrGOZjUjyoopZ7Ulg showed [7h Qs] and won ($1.80) with a pair of Sevens
Seat 3: 2wcFsZsqEP5w1StUTVzJCg folded before Flop (didn't bet)
Seat 4: yyG4svzOpC1A+sUP/scg6w (button) folded before Flop (didn't bet)
Seat 5: W6tExOcYX7qiy6Qdp+ZwFA (small blind) folded before Flop
Seat 6: 5n7e7I+px7c6CQmLpPbtsg (big blind) folded before Flop
Seat 8: 6mStmDUknIn/RyBEoiIyoQ folded before Flop (didn't bet)
Seat 9: AiXn/9o1EwOPZUHujnh/bA folded before Flop (didn't bet)




PokerStars Game #59941665248:  Hold'em No Limit ($0.10/$0.25) - 2009/07/01 1:42:19 ET
Table 'qInMnOOn7vKcj4bU7zju7g' 9-max Seat #3 is the button
Seat 1: CT7Xj/V/O5rBlhtt+RZeFQ ($25 in chips) 
Seat 2: HgIyqrvSG8TRRZl5mlzfHA ($76.35 in chips) 
Seat 3: zDrucyjVn5aeekNEc3cJrA ($26.05 in chips) 
Seat 4: ScCuCTbi71/EWsLKZXaZeg ($20.65 in chips) 
Seat 5: KlccfkOygm1GJZoSZYEgBw ($14.50 in chips) 
Seat 6: 4awUyiDYTgylQKXZ9faBVA ($25 in chips) 
Seat 7: DdPXdieucQ+n99u1n3A+rQ ($7.10 in chips) 
Seat 8: Mh2r9hTeTEDnh19sRZtW3g ($5.70 in chips) 
Seat 9: sbArFaUiGjfmf5dg1O4ffg ($5.20 in chips) 
ScCuCTbi71/EWsLKZXaZeg: posts small blind $0.10
KlccfkOygm1GJZoSZYEgBw: posts big blind $0.25
*** HOLE CARDS ***
4awUyiDYTgylQKXZ9faBVA: folds 
DdPXdieucQ+n99u1n3A+rQ: folds 
Mh2r9hTeTEDnh19sRZtW3g: folds 
sbArFaUiGjfmf5dg1O4ffg: calls $0.25
CT7Xj/V/O5rBlhtt+RZeFQ: raises $1 to $1.25
HgIyqrvSG8TRRZl5mlzfHA: calls $1.25
zDrucyjVn5aeekNEc3cJrA: folds 
zDrucyjVn5aeekNEc3cJrA is sitting out
ScCuCTbi71/EWsLKZXaZeg: raises $1 to $2.25
KlccfkOygm1GJZoSZYEgBw: folds 
sbArFaUiGjfmf5dg1O4ffg: folds 
CT7Xj/V/O5rBlhtt+RZeFQ: calls $1
HgIyqrvSG8TRRZl5mlzfHA: calls $1
*** FLOP *** [6c 4s Ks]
ScCuCTbi71/EWsLKZXaZeg: checks 
CT7Xj/V/O5rBlhtt+RZeFQ: bets $2.75
HgIyqrvSG8TRRZl5mlzfHA: calls $2.75
ScCuCTbi71/EWsLKZXaZeg: calls $2.75
*** TURN *** [6c 4s Ks] [Th]
ScCuCTbi71/EWsLKZXaZeg: checks 
CT7Xj/V/O5rBlhtt+RZeFQ: bets $4
HgIyqrvSG8TRRZl5mlzfHA: folds 
ScCuCTbi71/EWsLKZXaZeg: calls $4
*** RIVER *** [6c 4s Ks Th] [9h]
ScCuCTbi71/EWsLKZXaZeg: checks 
CT7Xj/V/O5rBlhtt+RZeFQ: bets $16 and is all-in
ScCuCTbi71/EWsLKZXaZeg: folds 
Uncalled bet ($16) returned to CT7Xj/V/O5rBlhtt+RZeFQ
CT7Xj/V/O5rBlhtt+RZeFQ collected $22.40 from pot
CT7Xj/V/O5rBlhtt+RZeFQ: doesn't show hand 
*** SUMMARY ***
Total pot $23.50 | Rake $1.10 
Board [6c 4s Ks Th 9h]
Seat 1: CT7Xj/V/O5rBlhtt+RZeFQ collected ($22.40)
Seat 2: HgIyqrvSG8TRRZl5mlzfHA folded on the Turn
Seat 3: zDrucyjVn5aeekNEc3cJrA (button) folded before Flop (didn't bet)
Seat 4: ScCuCTbi71/EWsLKZXaZeg (small blind) folded on the River
Seat 5: KlccfkOygm1GJZoSZYEgBw (big blind) folded before Flop
Seat 6: 4awUyiDYTgylQKXZ9faBVA folded before Flop (didn't bet)
Seat 7: DdPXdieucQ+n99u1n3A+rQ folded before Flop (didn't bet)
Seat 8: Mh2r9hTeTEDnh19sRZtW3g folded before Flop (didn't bet)
Seat 9: sbArFaUiGjfmf5dg1O4ffg folded before Flop




PokerStars Game #59941664976:  Hold'em No Limit ($0.10/$0.25) - 2009/07/01 1:42:19 ET
Table 'IfRHUn9gQQA9I/Z4tn+BoA' 9-max Seat #2 is the button
Seat 1: imHPFFqvfHGzsBBWeGuy4w ($20 in chips) 
Seat 2: VWUWpMLMj/Q1jRVpF7Aohw ($16.95 in chips) 
Seat 3: ModuIAhh03puxW6XFxQ3Nw ($17.90 in chips) 
Seat 4: QEbIGci+itdw+re8RM5fZA ($30.65 in chips) 
Seat 5: DdPXdieucQ+n99u1n3A+rQ ($5 in chips) 
Seat 6: UOjoGGQ58/uDS7V0xkjOrQ ($17.95 in chips) 
Seat 7: YzqSxP03XxZPbgPifgt69g ($29.10 in chips) 
Seat 8: cZ99hugmLBj9KhTlc8nCSw ($27.75 in chips) 
Seat 9: 7cv+9Zc9HIQHNvYsMfV3uA ($47.75 in chips) 
ModuIAhh03puxW6XFxQ3Nw: posts small blind $0.10
QEbIGci+itdw+re8RM5fZA: posts big blind $0.25
imHPFFqvfHGzsBBWeGuy4w: posts big blind $0.25
*** HOLE CARDS ***
DdPXdieucQ+n99u1n3A+rQ: folds 
UOjoGGQ58/uDS7V0xkjOrQ: folds 
YzqSxP03XxZPbgPifgt69g: folds 
cZ99hugmLBj9KhTlc8nCSw: folds 
7cv+9Zc9HIQHNvYsMfV3uA: folds 
imHPFFqvfHGzsBBWeGuy4w: checks 
VWUWpMLMj/Q1jRVpF7Aohw: folds 
ModuIAhh03puxW6XFxQ3Nw: calls $0.15
QEbIGci+itdw+re8RM5fZA: checks 
*** FLOP *** [Kd 6d 2d]
ModuIAhh03puxW6XFxQ3Nw: bets $0.75
QEbIGci+itdw+re8RM5fZA: calls $0.75
imHPFFqvfHGzsBBWeGuy4w: calls $0.75
*** TURN *** [Kd 6d 2d] [Qd]
ModuIAhh03puxW6XFxQ3Nw: bets $0.25
QEbIGci+itdw+re8RM5fZA: calls $0.25
imHPFFqvfHGzsBBWeGuy4w: calls $0.25
*** RIVER *** [Kd 6d 2d Qd] [Jh]
ModuIAhh03puxW6XFxQ3Nw: bets $0.75
QEbIGci+itdw+re8RM5fZA: calls $0.75
imHPFFqvfHGzsBBWeGuy4w: folds 
*** SHOW DOWN ***
ModuIAhh03puxW6XFxQ3Nw: shows [5d 3d] (a flush, King high)
QEbIGci+itdw+re8RM5fZA: shows [Jd 2h] (a flush, King high - Jack higher)
QEbIGci+itdw+re8RM5fZA collected $5 from pot
*** SUMMARY ***
Total pot $5.25 | Rake $0.25 
Board [Kd 6d 2d Qd Jh]
Seat 1: imHPFFqvfHGzsBBWeGuy4w folded on the River
Seat 2: VWUWpMLMj/Q1jRVpF7Aohw (button) folded before Flop (didn't bet)
Seat 3: ModuIAhh03puxW6XFxQ3Nw (small blind) showed [5d 3d] and lost with a flush, King high
Seat 4: QEbIGci+itdw+re8RM5fZA (big blind) showed [Jd 2h] and won ($5) with a flush, King high
Seat 5: DdPXdieucQ+n99u1n3A+rQ folded before Flop (didn't bet)
Seat 6: UOjoGGQ58/uDS7V0xkjOrQ folded before Flop (didn't bet)
Seat 7: YzqSxP03XxZPbgPifgt69g folded before Flop (didn't bet)
Seat 8: cZ99hugmLBj9KhTlc8nCSw folded before Flop (didn't bet)
Seat 9: 7cv+9Zc9HIQHNvYsMfV3uA folded before Flop (didn't bet)




PokerStars Game #59941665636:  Hold'em No Limit ($0.10/$0.25) - 2009/07/01 1:42:20 ET
Table 'NfXsh0UQA+o/kO9acV3WxA' 9-max Seat #9 is the button
Seat 1: pN3IHvAKm2fz+sTRARTcrg ($24.75 in chips) 
Seat 2: mhpFs2SZupy4zLRb62FLFA ($25 in chips) 
Seat 3: wCUaomJ6Nq5zomVGdUHP+w ($19.85 in chips) 
Seat 4: r6hsffOo1iKmaPYKwAZmFw ($30.05 in chips) 
Seat 6: cFmpjvcjNoVAEAIQIxWkYg ($25.35 in chips) 
Seat 7: yqkowiRWZ6NvRN9UUkYIlA ($5 in chips) 
Seat 8: +sbyWwIcFp9kP0bDtMegfQ ($41.75 in chips) 
Seat 9: uhrboV251dcgYniYTdFIcA ($25 in chips) 
pN3IHvAKm2fz+sTRARTcrg: posts small blind $0.10
mhpFs2SZupy4zLRb62FLFA: posts big blind $0.25
zgi+EUykT/pZQpoUG6+oEg: sits out 
*** HOLE CARDS ***
wCUaomJ6Nq5zomVGdUHP+w: folds 
r6hsffOo1iKmaPYKwAZmFw: folds 
cFmpjvcjNoVAEAIQIxWkYg: folds 
yqkowiRWZ6NvRN9UUkYIlA: folds 
+sbyWwIcFp9kP0bDtMegfQ: folds 
uhrboV251dcgYniYTdFIcA: folds 
pN3IHvAKm2fz+sTRARTcrg: folds 
Uncalled bet ($0.15) returned to mhpFs2SZupy4zLRb62FLFA
mhpFs2SZupy4zLRb62FLFA collected $0.20 from pot
mhpFs2SZupy4zLRb62FLFA: doesn't show hand 
*** SUMMARY ***
Total pot $0.20 | Rake $0 
Seat 1: pN3IHvAKm2fz+sTRARTcrg (small blind) folded before Flop
Seat 2: mhpFs2SZupy4zLRb62FLFA (big blind) collected ($0.20)
Seat 3: wCUaomJ6Nq5zomVGdUHP+w folded before Flop (didn't bet)
Seat 4: r6hsffOo1iKmaPYKwAZmFw folded before Flop (didn't bet)
Seat 6: cFmpjvcjNoVAEAIQIxWkYg folded before Flop (didn't bet)
Seat 7: yqkowiRWZ6NvRN9UUkYIlA folded before Flop (didn't bet)
Seat 8: +sbyWwIcFp9kP0bDtMegfQ folded before Flop (didn't bet)
Seat 9: uhrboV251dcgYniYTdFIcA (button) folded before Flop (didn't bet)




PokerStars Game #59941665516:  Hold'em No Limit ($0.10/$0.25) - 2009/07/01 1:42:20 ET
Table 'ktio12Pyq06LsrFhIorSqA' 9-max Seat #5 is the button
Seat 1: OneeONzF0MoH0pEdcBndwA ($33.60 in chips) 
Seat 2: tGsFgUKjSctVaAXabrlZxw ($4.40 in chips) 
Seat 4: 0QdZrkFD7aGKeBXPGbIomA ($5.30 in chips) 
Seat 5: e0pV1oisCAilWiG0FCxY6A ($16.75 in chips) 
Seat 6: jQL6XIewylQ8MmZhhq2YFg ($42.30 in chips) 
Seat 7: XGCfQsxa6PfAg3kJtzUmww ($23.95 in chips) 
Seat 8: Z5y2J55JmfLYR6/DPAGHwQ ($10.50 in chips) 
Seat 9: H5Se03ZqSX7tbULXur2MAg ($26.65 in chips) 
jQL6XIewylQ8MmZhhq2YFg: posts small blind $0.10
XGCfQsxa6PfAg3kJtzUmww: posts big blind $0.25
Z9W7+g1WMhhZDi7DwGbCFA: sits out 
*** HOLE CARDS ***
Z5y2J55JmfLYR6/DPAGHwQ: calls $0.25
H5Se03ZqSX7tbULXur2MAg: folds 
OneeONzF0MoH0pEdcBndwA: folds 
tGsFgUKjSctVaAXabrlZxw: folds 
0QdZrkFD7aGKeBXPGbIomA: folds 
e0pV1oisCAilWiG0FCxY6A: folds 
jQL6XIewylQ8MmZhhq2YFg: folds 
XGCfQsxa6PfAg3kJtzUmww: checks 
*** FLOP *** [2s Qs 5c]
XGCfQsxa6PfAg3kJtzUmww: checks 
Z5y2J55JmfLYR6/DPAGHwQ: bets $0.50
XGCfQsxa6PfAg3kJtzUmww: calls $0.50
*** TURN *** [2s Qs 5c] [Jc]
XGCfQsxa6PfAg3kJtzUmww: bets $1
Z5y2J55JmfLYR6/DPAGHwQ: raises $2 to $3
XGCfQsxa6PfAg3kJtzUmww: folds 
Uncalled bet ($2) returned to Z5y2J55JmfLYR6/DPAGHwQ
Z5y2J55JmfLYR6/DPAGHwQ collected $3.45 from pot
Z5y2J55JmfLYR6/DPAGHwQ: doesn't show hand 
*** SUMMARY ***
Total pot $3.60 | Rake $0.15 
Board [2s Qs 5c Jc]
Seat 1: OneeONzF0MoH0pEdcBndwA folded before Flop (didn't bet)
Seat 2: tGsFgUKjSctVaAXabrlZxw folded before Flop (didn't bet)
Seat 4: 0QdZrkFD7aGKeBXPGbIomA folded before Flop (didn't bet)
Seat 5: e0pV1oisCAilWiG0FCxY6A (button) folded before Flop (didn't bet)
Seat 6: jQL6XIewylQ8MmZhhq2YFg (small blind) folded before Flop
Seat 7: XGCfQsxa6PfAg3kJtzUmww (big blind) folded on the Turn
Seat 8: Z5y2J55JmfLYR6/DPAGHwQ collected ($3.45)
Seat 9: H5Se03ZqSX7tbULXur2MAg folded before Flop (didn't bet)




PokerStars Game #59941665632:  Hold'em No Limit ($0.10/$0.25) - 2009/07/01 1:42:20 ET
Table 'fHv1Mk7ZbLjprZTGWKPiEQ' 6-max Seat #5 is the button
Seat 2: 9U3ZKjCsarN0DjR6mSE8Ug ($14 in chips) 
Seat 3: /gJNBeCkWL4o85/jvlZ4BA ($25 in chips) 
Seat 4: TSmua8tGK3sTbwi0ynrW9Q ($58.80 in chips) 
Seat 5: LJI7A1YgDM7hgh7o56+ReQ ($27.40 in chips) 
Seat 6: AjG0X+rNtc2W08eph8oqpw ($35.95 in chips) 
AjG0X+rNtc2W08eph8oqpw: posts small blind $0.10
9U3ZKjCsarN0DjR6mSE8Ug: posts big blind $0.25
*** HOLE CARDS ***
/gJNBeCkWL4o85/jvlZ4BA: folds 
TSmua8tGK3sTbwi0ynrW9Q: folds 
LJI7A1YgDM7hgh7o56+ReQ: raises $0.50 to $0.75
AjG0X+rNtc2W08eph8oqpw: folds 
9U3ZKjCsarN0DjR6mSE8Ug: calls $0.50
*** FLOP *** [5h 2h Qs]
9U3ZKjCsarN0DjR6mSE8Ug: bets $1
LJI7A1YgDM7hgh7o56+ReQ: folds 
Uncalled bet ($1) returned to 9U3ZKjCsarN0DjR6mSE8Ug
9U3ZKjCsarN0DjR6mSE8Ug collected $1.55 from pot
9U3ZKjCsarN0DjR6mSE8Ug: doesn't show hand 
*** SUMMARY ***
Total pot $1.60 | Rake $0.05 
Board [5h 2h Qs]
Seat 2: 9U3ZKjCsarN0DjR6mSE8Ug (big blind) collected ($1.55)
Seat 3: /gJNBeCkWL4o85/jvlZ4BA folded before Flop (didn't bet)
Seat 4: TSmua8tGK3sTbwi0ynrW9Q folded before Flop (didn't bet)
Seat 5: LJI7A1YgDM7hgh7o56+ReQ (button) folded on the Flop
Seat 6: AjG0X+rNtc2W08eph8oqpw (small blind) folded before Flop




PokerStars Game #59941665488:  Hold'em No Limit ($0.10/$0.25) - 2009/07/01 1:42:20 ET
Table 'LG9H161ZAHDkOww+ih3Ptg' 6-max Seat #5 is the button
Seat 1: avl8CO/tc0F6eVSiB/KNRA ($25.60 in chips) 
Seat 2: kwsRmpZ1ZaLooISs+zfyKg ($25.45 in chips) 
Seat 3: 5Evvx7UYqXTBuvIc/9s/hA ($16.70 in chips) 
Seat 4: 0C28L4/59aRNtHoBhqTcLg ($59.05 in chips) 
Seat 5: lYjWCpfCxX2kgcHY3v4Yow ($29.30 in chips) 
Seat 6: v8m8XHovI5tqEA9mvplDSw ($27.25 in chips) 
v8m8XHovI5tqEA9mvplDSw: posts small blind $0.10
avl8CO/tc0F6eVSiB/KNRA: posts big blind $0.25
*** HOLE CARDS ***
kwsRmpZ1ZaLooISs+zfyKg: folds 
5Evvx7UYqXTBuvIc/9s/hA: folds 
0C28L4/59aRNtHoBhqTcLg: folds 
lYjWCpfCxX2kgcHY3v4Yow: raises $0.50 to $0.75
v8m8XHovI5tqEA9mvplDSw: folds 
avl8CO/tc0F6eVSiB/KNRA: calls $0.50
*** FLOP *** [Js 3c 2h]
avl8CO/tc0F6eVSiB/KNRA: checks 
lYjWCpfCxX2kgcHY3v4Yow: bets $1
avl8CO/tc0F6eVSiB/KNRA: folds 
Uncalled bet ($1) returned to lYjWCpfCxX2kgcHY3v4Yow
lYjWCpfCxX2kgcHY3v4Yow collected $1.55 from pot
lYjWCpfCxX2kgcHY3v4Yow: doesn't show hand 
*** SUMMARY ***
Total pot $1.60 | Rake $0.05 
Board [Js 3c 2h]
Seat 1: avl8CO/tc0F6eVSiB/KNRA (big blind) folded on the Flop
Seat 2: kwsRmpZ1ZaLooISs+zfyKg folded before Flop (didn't bet)
Seat 3: 5Evvx7UYqXTBuvIc/9s/hA folded before Flop (didn't bet)
Seat 4: 0C28L4/59aRNtHoBhqTcLg folded before Flop (didn't bet)
Seat 5: lYjWCpfCxX2kgcHY3v4Yow (button) collected ($1.55)
Seat 6: v8m8XHovI5tqEA9mvplDSw (small blind) folded before Flop




PokerStars Game #59941665696:  Hold'em No Limit ($0.10/$0.25) - 2009/07/01 1:42:20 ET
Table 'DhkrdW2UOy2PfjSW28Kq8w' 6-max Seat #4 is the button
Seat 1: vu2kzHaDtgr6NM7rdq0chA ($26.40 in chips) 
Seat 2: v+QfkGiuj9bgtuNoVnDO8w ($25 in chips) 
Seat 3: B3X187C0tXFUfQpCu8pe8A ($22.90 in chips) 
Seat 4: 59HJSCM1X37BkMpI9N0mEw ($27 in chips) 
Seat 5: SxIIgwXYLkwd6m3wLyPTCw ($48.95 in chips) 
Seat 6: DihMHaz4WNETH1bPDe13kA ($25.40 in chips) 
SxIIgwXYLkwd6m3wLyPTCw: posts small blind $0.10
DihMHaz4WNETH1bPDe13kA: posts big blind $0.25
*** HOLE CARDS ***
vu2kzHaDtgr6NM7rdq0chA: folds 
v+QfkGiuj9bgtuNoVnDO8w: folds 
B3X187C0tXFUfQpCu8pe8A: folds 
59HJSCM1X37BkMpI9N0mEw: raises $0.50 to $0.75
SxIIgwXYLkwd6m3wLyPTCw: calls $0.65
DihMHaz4WNETH1bPDe13kA: folds 
*** FLOP *** [9s Qs 9d]
SxIIgwXYLkwd6m3wLyPTCw: checks 
59HJSCM1X37BkMpI9N0mEw: checks 
*** TURN *** [9s Qs 9d] [4h]
SxIIgwXYLkwd6m3wLyPTCw: bets $1.25
59HJSCM1X37BkMpI9N0mEw: calls $1.25
*** RIVER *** [9s Qs 9d 4h] [Qd]
SxIIgwXYLkwd6m3wLyPTCw: checks 
59HJSCM1X37BkMpI9N0mEw: checks 
*** SHOW DOWN ***
SxIIgwXYLkwd6m3wLyPTCw: shows [8h 8d] (two pair, Queens and Nines)
59HJSCM1X37BkMpI9N0mEw: mucks hand 
SxIIgwXYLkwd6m3wLyPTCw collected $4.05 from pot
*** SUMMARY ***
Total pot $4.25 | Rake $0.20 
Board [9s Qs 9d 4h Qd]
Seat 1: vu2kzHaDtgr6NM7rdq0chA folded before Flop (didn't bet)
Seat 2: v+QfkGiuj9bgtuNoVnDO8w folded before Flop (didn't bet)
Seat 3: B3X187C0tXFUfQpCu8pe8A folded before Flop (didn't bet)
Seat 4: 59HJSCM1X37BkMpI9N0mEw (button) mucked
Seat 5: SxIIgwXYLkwd6m3wLyPTCw (small blind) showed [8h 8d] and won ($4.05) with two pair, Queens and Nines
Seat 6: DihMHaz4WNETH1bPDe13kA (big blind) folded before Flop




PokerStars Game #59941665862:  Hold'em No Limit ($0.10/$0.25) - 2009/07/01 1:42:20 ET
Table 'sgdCtiuCu2BDZhyDi6RzTA' 6-max Seat #1 is the button
Seat 1: 3zD3qLXT1bEffAoWGnc7wg ($31.20 in chips) 
Seat 2: XD1i5m5PvBDnRzJaG/vINw ($24.15 in chips) 
Seat 3: eL3+wCBjFGfQ5FMdIZihwA ($26.35 in chips) 
Seat 4: rVKEgilmMX+EkKzDVvhmxA ($9.45 in chips) 
Seat 5: 0tQitW75xfmVWKldYHjmOQ ($3.65 in chips) 
Seat 6: KODslGU8ikCYS0/29dUkhg ($35.70 in chips) 
XD1i5m5PvBDnRzJaG/vINw: posts small blind $0.10
eL3+wCBjFGfQ5FMdIZihwA: posts big blind $0.25
*** HOLE CARDS ***
rVKEgilmMX+EkKzDVvhmxA: calls $0.25
0tQitW75xfmVWKldYHjmOQ: folds 
KODslGU8ikCYS0/29dUkhg: calls $0.25
3zD3qLXT1bEffAoWGnc7wg: folds 
XD1i5m5PvBDnRzJaG/vINw: folds 
eL3+wCBjFGfQ5FMdIZihwA: checks 
*** FLOP *** [9h 6h Jc]
eL3+wCBjFGfQ5FMdIZihwA: checks 
rVKEgilmMX+EkKzDVvhmxA: bets $0.50
KODslGU8ikCYS0/29dUkhg: calls $0.50
eL3+wCBjFGfQ5FMdIZihwA: calls $0.50
*** TURN *** [9h 6h Jc] [5s]
eL3+wCBjFGfQ5FMdIZihwA: checks 
rVKEgilmMX+EkKzDVvhmxA: checks 
KODslGU8ikCYS0/29dUkhg: checks 
*** RIVER *** [9h 6h Jc 5s] [9c]
eL3+wCBjFGfQ5FMdIZihwA: checks 
rVKEgilmMX+EkKzDVvhmxA: checks 
KODslGU8ikCYS0/29dUkhg: bets $2.75
eL3+wCBjFGfQ5FMdIZihwA: folds 
rVKEgilmMX+EkKzDVvhmxA: folds 
Uncalled bet ($2.75) returned to KODslGU8ikCYS0/29dUkhg
KODslGU8ikCYS0/29dUkhg collected $2.25 from pot
*** SUMMARY ***
Total pot $2.35 | Rake $0.10 
Board [9h 6h Jc 5s 9c]
Seat 1: 3zD3qLXT1bEffAoWGnc7wg (button) folded before Flop (didn't bet)
Seat 2: XD1i5m5PvBDnRzJaG/vINw (small blind) folded before Flop
Seat 3: eL3+wCBjFGfQ5FMdIZihwA (big blind) folded on the River
Seat 4: rVKEgilmMX+EkKzDVvhmxA folded on the River
Seat 5: 0tQitW75xfmVWKldYHjmOQ folded before Flop (didn't bet)
Seat 6: KODslGU8ikCYS0/29dUkhg collected ($2.25)




PokerStars Game #59941666174:  Hold'em No Limit ($0.10/$0.25) - 2009/07/01 1:42:21 ET
Table '63h13e5p7cWe02rClZ1CHw' 6-max Seat #4 is the button
Seat 1: pokjbbEcXXPlADXdSGHtZw ($21 in chips) 
Seat 2: k9nHZTHt8hYhYRcW8NTb4g ($27.65 in chips) 
Seat 3: mFv3iBCtrw9XfCDRB0d46Q ($5 in chips) 
Seat 4: xrf8tAXKQHG99HixCot1Iw ($23.70 in chips) 
Seat 5: iyZxqznXjv3vtvOJymkoLQ ($44.90 in chips) 
Seat 6: mfrkWA3PTeYPkbO6hi98Aw ($38.80 in chips) 
iyZxqznXjv3vtvOJymkoLQ: posts small blind $0.10
mfrkWA3PTeYPkbO6hi98Aw: posts big blind $0.25
*** HOLE CARDS ***
pokjbbEcXXPlADXdSGHtZw: raises $0.50 to $0.75
k9nHZTHt8hYhYRcW8NTb4g: raises $1.50 to $2.25
mFv3iBCtrw9XfCDRB0d46Q: folds 
xrf8tAXKQHG99HixCot1Iw: folds 
iyZxqznXjv3vtvOJymkoLQ: folds 
mfrkWA3PTeYPkbO6hi98Aw: folds 
pokjbbEcXXPlADXdSGHtZw: calls $1.50
*** FLOP *** [3c Ad 4s]
pokjbbEcXXPlADXdSGHtZw: checks 
k9nHZTHt8hYhYRcW8NTb4g: bets $2.25
pokjbbEcXXPlADXdSGHtZw: folds 
Uncalled bet ($2.25) returned to k9nHZTHt8hYhYRcW8NTb4g
k9nHZTHt8hYhYRcW8NTb4g collected $4.65 from pot
k9nHZTHt8hYhYRcW8NTb4g: doesn't show hand 
*** SUMMARY ***
Total pot $4.85 | Rake $0.20 
Board [3c Ad 4s]
Seat 1: pokjbbEcXXPlADXdSGHtZw folded on the Flop
Seat 2: k9nHZTHt8hYhYRcW8NTb4g collected ($4.65)
Seat 3: mFv3iBCtrw9XfCDRB0d46Q folded before Flop (didn't bet)
Seat 4: xrf8tAXKQHG99HixCot1Iw (button) folded before Flop (didn't bet)
Seat 5: iyZxqznXjv3vtvOJymkoLQ (small blind) folded before Flop
Seat 6: mfrkWA3PTeYPkbO6hi98Aw (big blind) folded before Flop




PokerStars Game #59941666192:  Hold'em No Limit ($0.10/$0.25) - 2009/07/01 1:42:21 ET
Table 'WEMI3Mtn7dGARDbgNrKibgQvLFJzpzymuOsaaRYi+8fgx Seat #7 is the button
Seat 2: PdIasPkzm2sqZnN41ZRXOg ($5 in chips) 
Seat 4: tLcDklc2rBORNfixyRfVfw ($25.60 in chips) 
Seat 5: MG90wfSJZnOejs/KD3vlQQ ($36.75 in chips) 
Seat 7: rQhYIYXSyH/IivYM1dlV5A ($11.95 in chips) 
Seat 8: gehe91e0IyVT0QU/XBkEyg ($25 in chips) 
Seat 9: BWzInv8o0kN1pJybv/VjpQ ($44.60 in chips) 
gehe91e0IyVT0QU/XBkEyg: posts small blind $0.10
BWzInv8o0kN1pJybv/VjpQ: posts big blind $0.25
cZ99hugmLBj9KhTlc8nCSw: sits out 
Qduu7ikeizo6q6Ei9YvcJA: sits out 
*** HOLE CARDS ***
PdIasPkzm2sqZnN41ZRXOg: folds 
tLcDklc2rBORNfixyRfVfw: folds 
MG90wfSJZnOejs/KD3vlQQ: folds 
rQhYIYXSyH/IivYM1dlV5A: raises $0.50 to $0.75
gehe91e0IyVT0QU/XBkEyg: calls $0.65
BWzInv8o0kN1pJybv/VjpQ: calls $0.50
*** FLOP *** [3d 9h Td]
gehe91e0IyVT0QU/XBkEyg: checks 
BWzInv8o0kN1pJybv/VjpQ: checks 
rQhYIYXSyH/IivYM1dlV5A: checks 
*** TURN *** [3d 9h Td] [4s]
gehe91e0IyVT0QU/XBkEyg: bets $1
BWzInv8o0kN1pJybv/VjpQ: folds 
rQhYIYXSyH/IivYM1dlV5A: folds 
Uncalled bet ($1) returned to gehe91e0IyVT0QU/XBkEyg
1S/fpm+f42V/6MNZre+ccg leaves the table
gehe91e0IyVT0QU/XBkEyg collected $2.15 from pot
*** SUMMARY ***
Total pot $2.25 | Rake $0.10 
Board [3d 9h Td 4s]
Seat 2: PdIasPkzm2sqZnN41ZRXOg folded before Flop (didn't bet)
Seat 4: tLcDklc2rBORNfixyRfVfw folded before Flop (didn't bet)
Seat 5: MG90wfSJZnOejs/KD3vlQQ folded before Flop (didn't bet)
Seat 7: rQhYIYXSyH/IivYM1dlV5A (button) folded on the Turn
Seat 8: gehe91e0IyVT0QU/XBkEyg (small blind) collected ($2.15)
Seat 9: BWzInv8o0kN1pJybv/VjpQ (big blind) folded on the Turn




PokerStars Game #59941666024:  Hold'em No Limit ($0.10/$0.25) - 2009/07/01 1:42:21 ET
Table 'uFgIyfWPagvEVGEb86da7A' 9-max Seat #8 is the button
Seat 1: CT7Xj/V/O5rBlhtt+RZeFQ ($26.25 in chips) 
Seat 2: o3zvoO+PsqGti+1NZGNRrQ ($1.10 in chips) 
Seat 3: eGAnPT3w+iltM7HF59dzIg ($6.25 in chips) 
Seat 4: IGRfskE1v9H9Bn+fz8AgNQ ($26.90 in chips) 
Seat 5: X78b5v/uhqeXXoAijbw/yg ($28.30 in chips) 
Seat 7: 9zx7Mlww974uHUqoiq2eXA ($11.85 in chips) 
Seat 8: uLP/lYn7oKq9xCChBXsXxw ($23.80 in chips) 
Seat 9: sL5EaDXc90Iyxlm8ERXRQw ($18.25 in chips) 
sL5EaDXc90Iyxlm8ERXRQw: posts small blind $0.10
CT7Xj/V/O5rBlhtt+RZeFQ: posts big blind $0.25
*** HOLE CARDS ***
o3zvoO+PsqGti+1NZGNRrQ: folds 
eGAnPT3w+iltM7HF59dzIg: folds 
IGRfskE1v9H9Bn+fz8AgNQ: folds 
X78b5v/uhqeXXoAijbw/yg: folds 
9zx7Mlww974uHUqoiq2eXA: folds 
uLP/lYn7oKq9xCChBXsXxw: calls $0.25
sL5EaDXc90Iyxlm8ERXRQw: calls $0.15
CT7Xj/V/O5rBlhtt+RZeFQ: checks 
*** FLOP *** [9c Ad Ah]
sL5EaDXc90Iyxlm8ERXRQw: checks 
CT7Xj/V/O5rBlhtt+RZeFQ: checks 
uLP/lYn7oKq9xCChBXsXxw: checks 
*** TURN *** [9c Ad Ah] [Jc]
sL5EaDXc90Iyxlm8ERXRQw: checks 
CT7Xj/V/O5rBlhtt+RZeFQ: checks 
uLP/lYn7oKq9xCChBXsXxw: bets $0.50
sL5EaDXc90Iyxlm8ERXRQw: folds 
CT7Xj/V/O5rBlhtt+RZeFQ: folds 
Uncalled bet ($0.50) returned to uLP/lYn7oKq9xCChBXsXxw
uLP/lYn7oKq9xCChBXsXxw collected $0.75 from pot
uLP/lYn7oKq9xCChBXsXxw: doesn't show hand 
*** SUMMARY ***
Total pot $0.75 | Rake $0 
Board [9c Ad Ah Jc]
Seat 1: CT7Xj/V/O5rBlhtt+RZeFQ (big blind) folded on the Turn
Seat 2: o3zvoO+PsqGti+1NZGNRrQ folded before Flop (didn't bet)
Seat 3: eGAnPT3w+iltM7HF59dzIg folded before Flop (didn't bet)
Seat 4: IGRfskE1v9H9Bn+fz8AgNQ folded before Flop (didn't bet)
Seat 5: X78b5v/uhqeXXoAijbw/yg folded before Flop (didn't bet)
Seat 7: 9zx7Mlww974uHUqoiq2eXA folded before Flop (didn't bet)
Seat 8: uLP/lYn7oKq9xCChBXsXxw (button) collected ($0.75)
Seat 9: sL5EaDXc90Iyxlm8ERXRQw (small blind) folded on the Turn




PokerStars Game #59941666170:  Hold'em No Limit ($0.10/$0.25) - 2009/07/01 1:42:21 ET
Table 'NtEQAxCeIK2io1CGtW658g' 6-max Seat #5 is the button
Seat 1: X437kMQ7AujoaDgjguhU9w ($11.80 in chips) 
Seat 3: m2yWOKfAxqHoy5DDN87Ttw ($38 in chips) 
Seat 4: 8296 ($11.90 in chips) 
Seat 5: Hsvkc0/G2VV78oVmWYXecw ($5 in chips) 
Seat 6: /gJNBeCkWL4o85/jvlZ4BA ($64.85 in chips) 
/gJNBeCkWL4o85/jvlZ4BA: posts small blind $0.10
X437kMQ7AujoaDgjguhU9w: posts big blind $0.25
*** HOLE CARDS ***
m2yWOKfAxqHoy5DDN87Ttw: folds 
8296: folds 
Hsvkc0/G2VV78oVmWYXecw: folds 
/gJNBeCkWL4o85/jvlZ4BA: folds 
Uncalled bet ($0.15) returned to X437kMQ7AujoaDgjguhU9w
X437kMQ7AujoaDgjguhU9w collected $0.20 from pot
X437kMQ7AujoaDgjguhU9w: doesn't show hand 
*** SUMMARY ***
Total pot $0.20 | Rake $0 
Seat 1: X437kMQ7AujoaDgjguhU9w (big blind) collected ($0.20)
Seat 3: m2yWOKfAxqHoy5DDN87Ttw folded before Flop (didn't bet)
Seat 4: 8296 folded before Flop (didn't bet)
Seat 5: Hsvkc0/G2VV78oVmWYXecw (button) folded before Flop (didn't bet)
Seat 6: /gJNBeCkWL4o85/jvlZ4BA (small blind) folded before Flop




PokerStars Game #59941666278:  Hold'em No Limit ($0.10/$0.25) - 2009/07/01 1:42:21 ET
Table 'Utmw+yX+E/wdhNDIim90lQ' 9-max Seat #1 is the button
Seat 1: cZ99hugmLBj9KhTlc8nCSw ($31.70 in chips) 
Seat 2: iGMlK+EhUflPB6jKQd95Cg ($25 in chips) 
Seat 3: dfNim92Z6XK1/h5SFW5vDg ($25.30 in chips) 
Seat 4: ifYGvZDHQQ0aam4awTtHwA ($26.85 in chips) 
Seat 5: ghNKXUBl/H+t83JF079ZBA ($25 in chips) 
Seat 6: OlPJsgR4xypSg/w1z7Gyvw ($34.40 in chips) 
Seat 7: CImUHesK+ZER4v/VCA9IUg ($49.80 in chips) 
Seat 8: Mh2r9hTeTEDnh19sRZtW3g ($5 in chips) 
Seat 9: Th3FldXKQW6hWVVPahaoOQ ($28.50 in chips) 
iGMlK+EhUflPB6jKQd95Cg: posts small blind $0.10
dfNim92Z6XK1/h5SFW5vDg: posts big blind $0.25
*** HOLE CARDS ***
ifYGvZDHQQ0aam4awTtHwA: raises $0.75 to $1
ghNKXUBl/H+t83JF079ZBA: folds 
OlPJsgR4xypSg/w1z7Gyvw: folds 
CImUHesK+ZER4v/VCA9IUg: folds 
Mh2r9hTeTEDnh19sRZtW3g: folds 
Th3FldXKQW6hWVVPahaoOQ: folds 
cZ99hugmLBj9KhTlc8nCSw: calls $1
iGMlK+EhUflPB6jKQd95Cg: folds 
dfNim92Z6XK1/h5SFW5vDg: folds 
*** FLOP *** [Tc 7h 8d]
ifYGvZDHQQ0aam4awTtHwA: bets $1.50
cZ99hugmLBj9KhTlc8nCSw: folds 
Uncalled bet ($1.50) returned to ifYGvZDHQQ0aam4awTtHwA
ifYGvZDHQQ0aam4awTtHwA collected $2.25 from pot
*** SUMMARY ***
Total pot $2.35 | Rake $0.10 
Board [Tc 7h 8d]
Seat 1: cZ99hugmLBj9KhTlc8nCSw (button) folded on the Flop
Seat 2: iGMlK+EhUflPB6jKQd95Cg (small blind) folded before Flop
Seat 3: dfNim92Z6XK1/h5SFW5vDg (big blind) folded before Flop
Seat 4: ifYGvZDHQQ0aam4awTtHwA collected ($2.25)
Seat 5: ghNKXUBl/H+t83JF079ZBA folded before Flop (didn't bet)
Seat 6: OlPJsgR4xypSg/w1z7Gyvw folded before Flop (didn't bet)
Seat 7: CImUHesK+ZER4v/VCA9IUg folded before Flop (didn't bet)
Seat 8: Mh2r9hTeTEDnh19sRZtW3g folded before Flop (didn't bet)
Seat 9: Th3FldXKQW6hWVVPahaoOQ folded before Flop (didn't bet)




PokerStars Game #59941666888:  Hold'em No Limit ($0.10/$0.25) - 2009/07/01 1:42:22 ET
Table 'G+4ZdyRoPjgaJY/jxSlZzQ' 9-max Seat #5 is the button
Seat 1: ghNKXUBl/H+t83JF079ZBA ($23.40 in chips) 
Seat 2: CT7Xj/V/O5rBlhtt+RZeFQ ($25 in chips) 
Seat 3: FaGtAm5QUVcixGhAKIvbLg ($15.25 in chips) 
Seat 4: lSeLm4BdnSMLtIli62qjAQ ($10.65 in chips) 
Seat 5: BT6Oal0iO4P6kDuT7HFQDw ($16.50 in chips) 
Seat 6: oFwaTjy3ok/+qFghsrcGvg ($23.40 in chips) 
Seat 7: IK3/w7XV7rd8mVIsuasjYA ($2.35 in chips) 
Seat 9: tLcDklc2rBORNfixyRfVfw ($25 in chips) 
oFwaTjy3ok/+qFghsrcGvg: posts small blind $0.10
IK3/w7XV7rd8mVIsuasjYA: posts big blind $0.25
bXpVeaSTPBFSPJmeXxO7nw: sits out 
*** HOLE CARDS ***
tLcDklc2rBORNfixyRfVfw: folds 
ghNKXUBl/H+t83JF079ZBA: folds 
CT7Xj/V/O5rBlhtt+RZeFQ: folds 
FaGtAm5QUVcixGhAKIvbLg: calls $0.25
lSeLm4BdnSMLtIli62qjAQ: folds 
BT6Oal0iO4P6kDuT7HFQDw: folds 
oFwaTjy3ok/+qFghsrcGvg: folds 
IK3/w7XV7rd8mVIsuasjYA: checks 
*** FLOP *** [4h 4c 2c]
IK3/w7XV7rd8mVIsuasjYA: checks 
FaGtAm5QUVcixGhAKIvbLg: checks 
*** TURN *** [4h 4c 2c] [Ac]
IK3/w7XV7rd8mVIsuasjYA: checks 
FaGtAm5QUVcixGhAKIvbLg: bets $0.50
IK3/w7XV7rd8mVIsuasjYA: folds 
Uncalled bet ($0.50) returned to FaGtAm5QUVcixGhAKIvbLg
FaGtAm5QUVcixGhAKIvbLg collected $0.60 from pot
*** SUMMARY ***
Total pot $0.60 | Rake $0 
Board [4h 4c 2c Ac]
Seat 1: ghNKXUBl/H+t83JF079ZBA folded before Flop (didn't bet)
Seat 2: CT7Xj/V/O5rBlhtt+RZeFQ folded before Flop (didn't bet)
Seat 3: FaGtAm5QUVcixGhAKIvbLg collected ($0.60)
Seat 4: lSeLm4BdnSMLtIli62qjAQ folded before Flop (didn't bet)
Seat 5: BT6Oal0iO4P6kDuT7HFQDw (button) folded before Flop (didn't bet)
Seat 6: oFwaTjy3ok/+qFghsrcGvg (small blind) folded before Flop
Seat 7: IK3/w7XV7rd8mVIsuasjYA (big blind) folded on the Turn
Seat 9: tLcDklc2rBORNfixyRfVfw folded before Flop (didn't bet)




PokerStars Game #59941667304:  Hold'em No Limit ($0.10/$0.25) - 2009/07/01 1:42:23 ET
Table 'b64Z+5XI1xkQzNfq4QHr3A' 6-max Seat #5 is the button
Seat 2: SS/yfeArhULzIcOPe8MdPg ($25 in chips) 
Seat 3: u/yN5P9f3KlATg6WLWNkBQ ($31.90 in chips) 
Seat 4: SxIIgwXYLkwd6m3wLyPTCw ($19.15 in chips) 
Seat 5: JFIAqU8lCZ0vWwEl4bdGsg ($58.60 in chips) 
Seat 6: 8ClCHtFXGNplITm+63KB+Q ($35.60 in chips) 
8ClCHtFXGNplITm+63KB+Q: posts small blind $0.10
SS/yfeArhULzIcOPe8MdPg: posts big blind $0.25
*** HOLE CARDS ***
u/yN5P9f3KlATg6WLWNkBQ: calls $0.25
SxIIgwXYLkwd6m3wLyPTCw: raises $0.75 to $1
JFIAqU8lCZ0vWwEl4bdGsg: folds 
8ClCHtFXGNplITm+63KB+Q: folds 
SS/yfeArhULzIcOPe8MdPg: folds 
u/yN5P9f3KlATg6WLWNkBQ: calls $0.75
*** FLOP *** [5d 9s Ts]
u/yN5P9f3KlATg6WLWNkBQ: checks 
SxIIgwXYLkwd6m3wLyPTCw: bets $1.50
u/yN5P9f3KlATg6WLWNkBQ: calls $1.50
*** TURN *** [5d 9s Ts] [7d]
u/yN5P9f3KlATg6WLWNkBQ: checks 
SxIIgwXYLkwd6m3wLyPTCw: bets $4
SS/yfeArhULzIcOPe8MdPg said, "i shud fold flop there lmao"
u/yN5P9f3KlATg6WLWNkBQ: calls $4
*** RIVER *** [5d 9s Ts 7d] [7s]
SS/yfeArhULzIcOPe8MdPg said, "god im a real donkey"
u/yN5P9f3KlATg6WLWNkBQ: bets $13
SxIIgwXYLkwd6m3wLyPTCw: folds 
Uncalled bet ($13) returned to u/yN5P9f3KlATg6WLWNkBQ
u/yN5P9f3KlATg6WLWNkBQ collected $12.70 from pot
u/yN5P9f3KlATg6WLWNkBQ: doesn't show hand 
*** SUMMARY ***
Total pot $13.35 | Rake $0.65 
Board [5d 9s Ts 7d 7s]
Seat 2: SS/yfeArhULzIcOPe8MdPg (big blind) folded before Flop
Seat 3: u/yN5P9f3KlATg6WLWNkBQ collected ($12.70)
Seat 4: SxIIgwXYLkwd6m3wLyPTCw folded on the River
Seat 5: JFIAqU8lCZ0vWwEl4bdGsg (button) folded before Flop (didn't bet)
Seat 6: 8ClCHtFXGNplITm+63KB+Q (small blind) folded before Flop




PokerStars Game #59941667464:  Hold'em No Limit ($0.10/$0.25) - 2009/07/01 1:42:23 ET
Table 'Qr+t8WGovMECkBv+cV1lrg' 6-max Seat #1 is the button
Seat 1: EeUZtMU058v2ObUACOF4Og ($51.25 in chips) 
Seat 3: uZKkrGByYgd4/ZBX2d4z+w ($22.10 in chips) 
Seat 4: 1NNFfYMd5Hsphl/FYz9fNA ($60.20 in chips) 
Seat 5: 9q7YGTKe9k5fYb4fmZc3Ww ($32.70 in chips) 
Seat 6: xRkU4+naLuz7dEZFbOn9cw ($24.65 in chips) 
uZKkrGByYgd4/ZBX2d4z+w: posts small blind $0.10
1NNFfYMd5Hsphl/FYz9fNA: posts big blind $0.25
*** HOLE CARDS ***
9q7YGTKe9k5fYb4fmZc3Ww: folds 
xRkU4+naLuz7dEZFbOn9cw: folds 
EeUZtMU058v2ObUACOF4Og: folds 
uZKkrGByYgd4/ZBX2d4z+w: folds 
Uncalled bet ($0.15) returned to 1NNFfYMd5Hsphl/FYz9fNA
vqWjZmdQu/Hxw96/IJTWdQ joins the table at seat #2 
1NNFfYMd5Hsphl/FYz9fNA collected $0.20 from pot
*** SUMMARY ***
Total pot $0.20 | Rake $0 
Seat 1: EeUZtMU058v2ObUACOF4Og (button) folded before Flop (didn't bet)
Seat 3: uZKkrGByYgd4/ZBX2d4z+w (small blind) folded before Flop
Seat 4: 1NNFfYMd5Hsphl/FYz9fNA (big blind) collected ($0.20)
Seat 5: 9q7YGTKe9k5fYb4fmZc3Ww folded before Flop (didn't bet)
Seat 6: xRkU4+naLuz7dEZFbOn9cw folded before Flop (didn't bet)




PokerStars Game #59941667214:  Hold'em No Limit ($0.10/$0.25) - 2009/07/01 1:42:23 ET
Table 'jz4TpuH+ag+0iNe2ZcxckQ' 9-max Seat #2 is the button
Seat 1: +C3eP/ysyROWbEXJFPswVA ($15.70 in chips) 
Seat 2: OXPkK84/qv92EMwXPiG5rQ ($13.70 in chips) 
Seat 3: egvg3mTBBVzMHnJPIQiKcA ($13.50 in chips) 
Seat 4: k+2r6di6GXjNpAdrRkW9bA ($60.25 in chips) 
Seat 5: v1BVHNGLbP/nx7QO6K7+Jw ($26.50 in chips) 
Seat 6: gO1uiTGTzn5Cd3PECuws1g ($14 in chips) 
Seat 7: tLcDklc2rBORNfixyRfVfw ($32 in chips) 
Seat 8: uhrboV251dcgYniYTdFIcA ($25 in chips) 
Seat 9: W2YYHvqjaEpRrO7stZkClQ ($5.80 in chips) 
egvg3mTBBVzMHnJPIQiKcA: posts small blind $0.10
k+2r6di6GXjNpAdrRkW9bA: posts big blind $0.25
*** HOLE CARDS ***
v1BVHNGLbP/nx7QO6K7+Jw: raises $0.25 to $0.50
gO1uiTGTzn5Cd3PECuws1g: folds 
tLcDklc2rBORNfixyRfVfw: folds 
uhrboV251dcgYniYTdFIcA: folds 
W2YYHvqjaEpRrO7stZkClQ: folds 
+C3eP/ysyROWbEXJFPswVA: calls $0.50
OXPkK84/qv92EMwXPiG5rQ: folds 
egvg3mTBBVzMHnJPIQiKcA: folds 
k+2r6di6GXjNpAdrRkW9bA: calls $0.25
*** FLOP *** [8c 9c 7c]
k+2r6di6GXjNpAdrRkW9bA: checks 
v1BVHNGLbP/nx7QO6K7+Jw: bets $0.25
+C3eP/ysyROWbEXJFPswVA: raises $0.75 to $1
k+2r6di6GXjNpAdrRkW9bA: folds 
v1BVHNGLbP/nx7QO6K7+Jw: calls $0.75
*** TURN *** [8c 9c 7c] [Kd]
v1BVHNGLbP/nx7QO6K7+Jw: checks 
+C3eP/ysyROWbEXJFPswVA: checks 
*** RIVER *** [8c 9c 7c Kd] [3c]
v1BVHNGLbP/nx7QO6K7+Jw: checks 
+C3eP/ysyROWbEXJFPswVA: checks 
*** SHOW DOWN ***
v1BVHNGLbP/nx7QO6K7+Jw: shows [3s 3d] (three of a kind, Threes)
+C3eP/ysyROWbEXJFPswVA: mucks hand 
v1BVHNGLbP/nx7QO6K7+Jw collected $3.45 from pot
*** SUMMARY ***
Total pot $3.60 | Rake $0.15 
Board [8c 9c 7c Kd 3c]
Seat 1: +C3eP/ysyROWbEXJFPswVA mucked
Seat 2: OXPkK84/qv92EMwXPiG5rQ (button) folded before Flop (didn't bet)
Seat 3: egvg3mTBBVzMHnJPIQiKcA (small blind) folded before Flop
Seat 4: k+2r6di6GXjNpAdrRkW9bA (big blind) folded on the Flop
Seat 5: v1BVHNGLbP/nx7QO6K7+Jw showed [3s 3d] and won ($3.45) with three of a kind, Threes
Seat 6: gO1uiTGTzn5Cd3PECuws1g folded before Flop (didn't bet)
Seat 7: tLcDklc2rBORNfixyRfVfw folded before Flop (didn't bet)
Seat 8: uhrboV251dcgYniYTdFIcA folded before Flop (didn't bet)
Seat 9: W2YYHvqjaEpRrO7stZkClQ folded before Flop (didn't bet)




PokerStars Game #59941667200:  Hold'em No Limit ($0.10/$0.25) - 2009/07/01 1:42:23 ET
Table 'tq5CvS0RUqGkuBK0XTzqqg' 6-max Seat #3 is the button
Seat 1: +ZlnqPoP3Hg4BIUxDfKd/A ($30.45 in chips) 
Seat 2: 2m6ZFAdj01UZd4WtEySXXQ ($5.50 in chips) 
Seat 3: PbMzPZIePKifKQZfKDkbIw ($48.50 in chips) 
Seat 4: UT5XpwOH1ipkOF7n1MqDJA ($24.75 in chips) 
Seat 5: qGHGf/553gQnDoklMRe3tg ($32.30 in chips) 
Seat 6: L3/N/gliETan8N5Gim5h4Q ($26.05 in chips) 
UT5XpwOH1ipkOF7n1MqDJA: posts small blind $0.10
qGHGf/553gQnDoklMRe3tg: posts big blind $0.25
*** HOLE CARDS ***
L3/N/gliETan8N5Gim5h4Q: folds 
+ZlnqPoP3Hg4BIUxDfKd/A: folds 
2m6ZFAdj01UZd4WtEySXXQ: raises $0.50 to $0.75
PbMzPZIePKifKQZfKDkbIw: folds 
UT5XpwOH1ipkOF7n1MqDJA: folds 
qGHGf/553gQnDoklMRe3tg: raises $2.25 to $3
2m6ZFAdj01UZd4WtEySXXQ: folds 
Uncalled bet ($2.25) returned to qGHGf/553gQnDoklMRe3tg
qGHGf/553gQnDoklMRe3tg collected $1.60 from pot
qGHGf/553gQnDoklMRe3tg: doesn't show hand 
*** SUMMARY ***
Total pot $1.60 | Rake $0 
Seat 1: +ZlnqPoP3Hg4BIUxDfKd/A folded before Flop (didn't bet)
Seat 2: 2m6ZFAdj01UZd4WtEySXXQ folded before Flop
Seat 3: PbMzPZIePKifKQZfKDkbIw (button) folded before Flop (didn't bet)
Seat 4: UT5XpwOH1ipkOF7n1MqDJA (small blind) folded before Flop
Seat 5: qGHGf/553gQnDoklMRe3tg (big blind) collected ($1.60)
Seat 6: L3/N/gliETan8N5Gim5h4Q folded before Flop (didn't bet)




PokerStars Game #59941667234:  Hold'em No Limit ($0.10/$0.25) - 2009/07/01 1:42:23 ET
Table 'R5qKG21jwFDYRcOht9qwqQ' 9-max Seat #8 is the button
Seat 1: 3wjccGPzilKjAvTdTrc78g ($4.50 in chips) 
Seat 3: M2QO2DxB5Wawg2h8HSpnYA ($13.10 in chips) 
Seat 4: z5GxcHlYz/GSz6W2uFiTtg ($40.85 in chips) 
Seat 5: zUXhymECc2C9W9ZNw6qppA ($9.65 in chips) 
Seat 6: EP17SQz/iWcuYdNOGeBgkw ($15.65 in chips) 
Seat 8: tYsOBqdU1+x+yFI7zHO7hQ ($35.05 in chips) 
Seat 9: MG90wfSJZnOejs/KD3vlQQ ($31.10 in chips) 
MG90wfSJZnOejs/KD3vlQQ: posts small blind $0.10
3wjccGPzilKjAvTdTrc78g: posts big blind $0.25
N6foVRyErHqcNmshkqextQ: sits out 
*** HOLE CARDS ***
M2QO2DxB5Wawg2h8HSpnYA: folds 
z5GxcHlYz/GSz6W2uFiTtg: folds 
zUXhymECc2C9W9ZNw6qppA: folds 
Wooglen leaves the table
EP17SQz/iWcuYdNOGeBgkw: raises $1 to $1.25
tYsOBqdU1+x+yFI7zHO7hQ: folds 
zgi+EUykT/pZQpoUG6+oEg joins the table at seat #7 
MG90wfSJZnOejs/KD3vlQQ: folds 
3wjccGPzilKjAvTdTrc78g: folds 
Uncalled bet ($1) returned to EP17SQz/iWcuYdNOGeBgkw
3wjccGPzilKjAvTdTrc78g is sitting out
EP17SQz/iWcuYdNOGeBgkw collected $0.60 from pot
EP17SQz/iWcuYdNOGeBgkw: doesn't show hand 
3wjccGPzilKjAvTdTrc78g leaves the table
*** SUMMARY ***
Total pot $0.60 | Rake $0 
Seat 1: 3wjccGPzilKjAvTdTrc78g (big blind) folded before Flop
Seat 3: M2QO2DxB5Wawg2h8HSpnYA folded before Flop (didn't bet)
Seat 4: z5GxcHlYz/GSz6W2uFiTtg folded before Flop (didn't bet)
Seat 5: zUXhymECc2C9W9ZNw6qppA folded before Flop (didn't bet)
Seat 6: EP17SQz/iWcuYdNOGeBgkw collected ($0.60)
Seat 8: tYsOBqdU1+x+yFI7zHO7hQ (button) folded before Flop (didn't bet)
Seat 9: MG90wfSJZnOejs/KD3vlQQ (small blind) folded before Flop




PokerStars Game #59941667906:  Hold'em No Limit ($0.10/$0.25) - 2009/07/01 1:42:24 ET
Table 'GxdLtCpYxqT4aAbYqkEEpw' 6-max Seat #5 is the button
Seat 1: 2d/PU00mMdO9azAaXqcSbw ($14.25 in chips) 
Seat 2: 3iomNWHjIokoWh6JNWCUJQ ($3.40 in chips) 
Seat 3: LpmZGzLpOmfZUF7EV4ZlrQ ($16.25 in chips) 
Seat 4: 6wzJiRvp8HY6t+MQGnSIzA ($3.80 in chips) 
Seat 5: q6WfTUAD9mowIP63ASq2Dg ($36.85 in chips) 
Seat 6: DFi/Lzkjsfv8QswS80JX9Q ($25 in chips) 
DFi/Lzkjsfv8QswS80JX9Q: posts small blind $0.10
2d/PU00mMdO9azAaXqcSbw: posts big blind $0.25
*** HOLE CARDS ***
3iomNWHjIokoWh6JNWCUJQ: calls $0.25
LpmZGzLpOmfZUF7EV4ZlrQ: folds 
6wzJiRvp8HY6t+MQGnSIzA: raises $3.55 to $3.80 and is all-in
q6WfTUAD9mowIP63ASq2Dg: folds 
DFi/Lzkjsfv8QswS80JX9Q: folds 
2d/PU00mMdO9azAaXqcSbw: calls $3.55
3iomNWHjIokoWh6JNWCUJQ: calls $3.15 and is all-in
*** FLOP *** [5h Ad 6d]
*** TURN *** [5h Ad 6d] [Kh]
*** RIVER *** [5h Ad 6d Kh] [8d]
*** SHOW DOWN ***
2d/PU00mMdO9azAaXqcSbw: shows [7c 7d] (a pair of Sevens)
6wzJiRvp8HY6t+MQGnSIzA: shows [Jc Ks] (a pair of Kings)
6wzJiRvp8HY6t+MQGnSIzA collected $0.75 from side pot
3iomNWHjIokoWh6JNWCUJQ: shows [9h 9s] (a pair of Nines)
6wzJiRvp8HY6t+MQGnSIzA collected $9.80 from main pot
*** SUMMARY ***
Total pot $11.10 Main pot $9.80. Side pot $0.75. | Rake $0.55 
Board [5h Ad 6d Kh 8d]
Seat 1: 2d/PU00mMdO9azAaXqcSbw (big blind) showed [7c 7d] and lost with a pair of Sevens
Seat 2: 3iomNWHjIokoWh6JNWCUJQ showed [9h 9s] and lost with a pair of Nines
Seat 3: LpmZGzLpOmfZUF7EV4ZlrQ folded before Flop (didn't bet)
Seat 4: 6wzJiRvp8HY6t+MQGnSIzA showed [Jc Ks] and won ($10.55) with a pair of Kings
Seat 5: q6WfTUAD9mowIP63ASq2Dg (button) folded before Flop (didn't bet)
Seat 6: DFi/Lzkjsfv8QswS80JX9Q (small blind) folded before Flop




PokerStars Game #59941668026:  Hold'em No Limit ($0.10/$0.25) - 2009/07/01 1:42:24 ET
Table 'LXz5SsUCyWcm+4JDJh466A' 9-max Seat #8 is the button
Seat 1: MG90wfSJZnOejs/KD3vlQQ ($25 in chips) 
Seat 2: H5Se03ZqSX7tbULXur2MAg ($23.70 in chips) 
Seat 3: dfNim92Z6XK1/h5SFW5vDg ($25.50 in chips) 
Seat 4: K0b5wNInj6hUGRr6yzKFtw ($28.60 in chips) 
Seat 5: O02ScVDnDZwH6KjZNJZMzA ($4.40 in chips) 
Seat 6: 6RiVTYll/5D8zICp0MRpKw ($24.75 in chips) 
Seat 7: J2a/QHAWUgo6beDRoEyg2g ($10.25 in chips) 
Seat 8: zOHElTcFiTsexeDCkAPYkQ ($30.45 in chips) 
Seat 9: dtZ84flFEi4Q+SGrHMJRDQ ($25 in chips) 
dtZ84flFEi4Q+SGrHMJRDQ: posts small blind $0.10
MG90wfSJZnOejs/KD3vlQQ: posts big blind $0.25
*** HOLE CARDS ***
H5Se03ZqSX7tbULXur2MAg: folds 
dfNim92Z6XK1/h5SFW5vDg: folds 
K0b5wNInj6hUGRr6yzKFtw: folds 
O02ScVDnDZwH6KjZNJZMzA: folds 
6RiVTYll/5D8zICp0MRpKw: folds 
J2a/QHAWUgo6beDRoEyg2g: calls $0.25
zOHElTcFiTsexeDCkAPYkQ: raises $0.25 to $0.50
dtZ84flFEi4Q+SGrHMJRDQ: folds 
MG90wfSJZnOejs/KD3vlQQ: folds 
J2a/QHAWUgo6beDRoEyg2g: calls $0.25
*** FLOP *** [3d 9h 3s]
J2a/QHAWUgo6beDRoEyg2g: bets $0.50
zOHElTcFiTsexeDCkAPYkQ: raises $0.50 to $1
J2a/QHAWUgo6beDRoEyg2g: calls $0.50
*** TURN *** [3d 9h 3s] [Ac]
J2a/QHAWUgo6beDRoEyg2g: checks 
zOHElTcFiTsexeDCkAPYkQ: bets $28.95 and is all-in
J2a/QHAWUgo6beDRoEyg2g: folds 
Uncalled bet ($28.95) returned to zOHElTcFiTsexeDCkAPYkQ
zOHElTcFiTsexeDCkAPYkQ collected $3.20 from pot
zOHElTcFiTsexeDCkAPYkQ: doesn't show hand 
*** SUMMARY ***
Total pot $3.35 | Rake $0.15 
Board [3d 9h 3s Ac]
Seat 1: MG90wfSJZnOejs/KD3vlQQ (big blind) folded before Flop
Seat 2: H5Se03ZqSX7tbULXur2MAg folded before Flop (didn't bet)
Seat 3: dfNim92Z6XK1/h5SFW5vDg folded before Flop (didn't bet)
Seat 4: K0b5wNInj6hUGRr6yzKFtw folded before Flop (didn't bet)
Seat 5: O02ScVDnDZwH6KjZNJZMzA folded before Flop (didn't bet)
Seat 6: 6RiVTYll/5D8zICp0MRpKw folded before Flop (didn't bet)
Seat 7: J2a/QHAWUgo6beDRoEyg2g folded on the Turn
Seat 8: zOHElTcFiTsexeDCkAPYkQ (button) collected ($3.20)
Seat 9: dtZ84flFEi4Q+SGrHMJRDQ (small blind) folded before Flop




PokerStars Game #59941667736:  Hold'em No Limit ($0.10/$0.25) - 2009/07/01 1:42:24 ET
Table 'YlRA05h9BJ1EhOUSNUjJdg' 9-max Seat #2 is the button
Seat 1: dtZ84flFEi4Q+SGrHMJRDQ ($25 in chips) 
Seat 2: Y2GFAe+PT7xnUUtgqCNDFw ($12.30 in chips) 
Seat 3: Z5ZtGOON8kmSdSCll9Z3XA ($11.35 in chips) 
Seat 4: HPEB+AtKw1+C/cxU0o1ciw ($31.35 in chips) 
Seat 5: sx0lGrkT9fd4yFR+3cXUQg ($11.05 in chips) 
Seat 6: QEbIGci+itdw+re8RM5fZA ($44.35 in chips) 
Seat 7: dfNim92Z6XK1/h5SFW5vDg ($25 in chips) 
Seat 8: dmYlc+1cjwZMJ7wV+Z0rRg ($32.90 in chips) 
Seat 9: Z9AeOQX3yzuSvKAm/xyovg ($9.75 in chips) 
Z5ZtGOON8kmSdSCll9Z3XA: posts small blind $0.10
HPEB+AtKw1+C/cxU0o1ciw: posts big blind $0.25
*** HOLE CARDS ***
sx0lGrkT9fd4yFR+3cXUQg: folds 
QEbIGci+itdw+re8RM5fZA: folds 
dfNim92Z6XK1/h5SFW5vDg: folds 
dmYlc+1cjwZMJ7wV+Z0rRg: folds 
Z9AeOQX3yzuSvKAm/xyovg: folds 
dtZ84flFEi4Q+SGrHMJRDQ: calls $0.25
Y2GFAe+PT7xnUUtgqCNDFw: calls $0.25
Z5ZtGOON8kmSdSCll9Z3XA: calls $0.15
HPEB+AtKw1+C/cxU0o1ciw: checks 
*** FLOP *** [5d Tc Jd]
Z5ZtGOON8kmSdSCll9Z3XA: bets $0.50
HPEB+AtKw1+C/cxU0o1ciw: folds 
dtZ84flFEi4Q+SGrHMJRDQ: calls $0.50
Y2GFAe+PT7xnUUtgqCNDFw: folds 
*** TURN *** [5d Tc Jd] [3h]
Z5ZtGOON8kmSdSCll9Z3XA: bets $0.75
dtZ84flFEi4Q+SGrHMJRDQ: calls $0.75
*** RIVER *** [5d Tc Jd 3h] [Ah]
Z5ZtGOON8kmSdSCll9Z3XA: bets $1.25
dtZ84flFEi4Q+SGrHMJRDQ: folds 
Uncalled bet ($1.25) returned to Z5ZtGOON8kmSdSCll9Z3XA
Z5ZtGOON8kmSdSCll9Z3XA collected $3.35 from pot
Z5ZtGOON8kmSdSCll9Z3XA: doesn't show hand 
*** SUMMARY ***
Total pot $3.50 | Rake $0.15 
Board [5d Tc Jd 3h Ah]
Seat 1: dtZ84flFEi4Q+SGrHMJRDQ folded on the River
Seat 2: Y2GFAe+PT7xnUUtgqCNDFw (button) folded on the Flop
Seat 3: Z5ZtGOON8kmSdSCll9Z3XA (small blind) collected ($3.35)
Seat 4: HPEB+AtKw1+C/cxU0o1ciw (big blind) folded on the Flop
Seat 5: sx0lGrkT9fd4yFR+3cXUQg folded before Flop (didn't bet)
Seat 6: QEbIGci+itdw+re8RM5fZA folded before Flop (didn't bet)
Seat 7: dfNim92Z6XK1/h5SFW5vDg folded before Flop (didn't bet)
Seat 8: dmYlc+1cjwZMJ7wV+Z0rRg folded before Flop (didn't bet)
Seat 9: Z9AeOQX3yzuSvKAm/xyovg folded before Flop (didn't bet)




PokerStars Game #59941668394:  Hold'em No Limit ($0.10/$0.25) - 2009/07/01 1:42:25 ET
Table 'bIGKmJgZehWJ+FAo8b85iw' 9-max Seat #8 is the button
Seat 1: yyG4svzOpC1A+sUP/scg6w ($14.70 in chips) 
Seat 2: cCjRCvseA9rZn7Xr+GCCHg ($21.70 in chips) 
Seat 3: /FyMUX+W/tpNFcRWbUTJxQ ($10.80 in chips) 
Seat 4: LGxBRjCRn6KlQ/6B4eoXbA ($19.35 in chips) 
Seat 5: uLP/lYn7oKq9xCChBXsXxw ($25.25 in chips) 
Seat 6: PFNLAvMkr8qKc7xCiH0wTA ($18.85 in chips) 
Seat 7: HDDm1BkZtdsRyw2DJdqq6A ($21.50 in chips) 
Seat 8: +2kMBNpY4nF1qNCRd8SJLA ($54.95 in chips) 
Seat 9: aNpwfA31EREwO+ar4XzBCw ($31.85 in chips) 
aNpwfA31EREwO+ar4XzBCw: posts small blind $0.10
yyG4svzOpC1A+sUP/scg6w: posts big blind $0.25
*** HOLE CARDS ***
cCjRCvseA9rZn7Xr+GCCHg: folds 
/FyMUX+W/tpNFcRWbUTJxQ: raises $0.75 to $1
LGxBRjCRn6KlQ/6B4eoXbA: folds 
uLP/lYn7oKq9xCChBXsXxw: folds 
PFNLAvMkr8qKc7xCiH0wTA: folds 
HDDm1BkZtdsRyw2DJdqq6A: folds 
+2kMBNpY4nF1qNCRd8SJLA: folds 
aNpwfA31EREwO+ar4XzBCw: folds 
yyG4svzOpC1A+sUP/scg6w: folds 
Uncalled bet ($0.75) returned to /FyMUX+W/tpNFcRWbUTJxQ
/FyMUX+W/tpNFcRWbUTJxQ collected $0.60 from pot
/FyMUX+W/tpNFcRWbUTJxQ: doesn't show hand 
*** SUMMARY ***
Total pot $0.60 | Rake $0 
Seat 1: yyG4svzOpC1A+sUP/scg6w (big blind) folded before Flop
Seat 2: cCjRCvseA9rZn7Xr+GCCHg folded before Flop (didn't bet)
Seat 3: /FyMUX+W/tpNFcRWbUTJxQ collected ($0.60)
Seat 4: LGxBRjCRn6KlQ/6B4eoXbA folded before Flop (didn't bet)
Seat 5: uLP/lYn7oKq9xCChBXsXxw folded before Flop (didn't bet)
Seat 6: PFNLAvMkr8qKc7xCiH0wTA folded before Flop (didn't bet)
Seat 7: HDDm1BkZtdsRyw2DJdqq6A folded before Flop (didn't bet)
Seat 8: +2kMBNpY4nF1qNCRd8SJLA (button) folded before Flop (didn't bet)
Seat 9: aNpwfA31EREwO+ar4XzBCw (small blind) folded before Flop




PokerStars Game #59941668464:  Hold'em No Limit ($0.10/$0.25) - 2009/07/01 1:42:25 ET
Table 'FBhJjLqab11/gKu8nyB/tw' 9-max Seat #4 is the button
Seat 1: +sbyWwIcFp9kP0bDtMegfQ ($18.10 in chips) 
Seat 2: 1pwQJV/Xr0GWPRefx/78VQ ($24.40 in chips) 
Seat 3: V6p0jQ/RhUsqpHLmXvEX4Q ($12.60 in chips) 
Seat 4: CvL9Ch1HYCVbTsfpNucitg ($5.50 in chips) 
Seat 5: Mh2r9hTeTEDnh19sRZtW3g ($4.75 in chips) 
Seat 6: cZ99hugmLBj9KhTlc8nCSw ($25 in chips) 
Seat 7: CT7Xj/V/O5rBlhtt+RZeFQ ($25 in chips) 
Seat 8: Th3FldXKQW6hWVVPahaoOQ ($25 in chips) 
Mh2r9hTeTEDnh19sRZtW3g: posts small blind $0.10
cZ99hugmLBj9KhTlc8nCSw: posts big blind $0.25
*** HOLE CARDS ***
CT7Xj/V/O5rBlhtt+RZeFQ: folds 
Th3FldXKQW6hWVVPahaoOQ: folds 
+sbyWwIcFp9kP0bDtMegfQ: folds 
1pwQJV/Xr0GWPRefx/78VQ: calls $0.25
V6p0jQ/RhUsqpHLmXvEX4Q: folds 
CvL9Ch1HYCVbTsfpNucitg: folds 
Mh2r9hTeTEDnh19sRZtW3g: folds 
cZ99hugmLBj9KhTlc8nCSw: checks 
*** FLOP *** [3s 9h Th]
cZ99hugmLBj9KhTlc8nCSw: checks 
1pwQJV/Xr0GWPRefx/78VQ: checks 
*** TURN *** [3s 9h Th] [Jh]
cZ99hugmLBj9KhTlc8nCSw: bets $0.50
1pwQJV/Xr0GWPRefx/78VQ: calls $0.50
*** RIVER *** [3s 9h Th Jh] [Qc]
cZ99hugmLBj9KhTlc8nCSw: checks 
1pwQJV/Xr0GWPRefx/78VQ: bets $1.75
cZ99hugmLBj9KhTlc8nCSw: folds 
Uncalled bet ($1.75) returned to 1pwQJV/Xr0GWPRefx/78VQ
1pwQJV/Xr0GWPRefx/78VQ collected $1.55 from pot
1pwQJV/Xr0GWPRefx/78VQ: doesn't show hand 
*** SUMMARY ***
Total pot $1.60 | Rake $0.05 
Board [3s 9h Th Jh Qc]
Seat 1: +sbyWwIcFp9kP0bDtMegfQ folded before Flop (didn't bet)
Seat 2: 1pwQJV/Xr0GWPRefx/78VQ collected ($1.55)
Seat 3: V6p0jQ/RhUsqpHLmXvEX4Q folded before Flop (didn't bet)
Seat 4: CvL9Ch1HYCVbTsfpNucitg (button) folded before Flop (didn't bet)
Seat 5: Mh2r9hTeTEDnh19sRZtW3g (small blind) folded before Flop
Seat 6: cZ99hugmLBj9KhTlc8nCSw (big blind) folded on the River
Seat 7: CT7Xj/V/O5rBlhtt+RZeFQ folded before Flop (didn't bet)
Seat 8: Th3FldXKQW6hWVVPahaoOQ folded before Flop (didn't bet)




PokerStars Game #59941668202:  Hold'em No Limit ($0.10/$0.25) - 2009/07/01 1:42:25 ET
Table 'xro+BVoe2Zuw1TYmz/McJQ' 9-max Seat #5 is the button
Seat 1: xEQxarad8/T4jJdpZy5LGw ($8.80 in chips) 
Seat 2: vSkQm2EelzwRGDDQQk0Fqw ($4.65 in chips) 
Seat 4: N2LVj3iImgnOoHVf8g0rIw ($47.90 in chips) 
Seat 5: w48D7DZIjuBit2n4FRDJ5Q ($12.95 in chips) 
Seat 6: HPEB+AtKw1+C/cxU0o1ciw ($26.60 in chips) 
Seat 7: QEbIGci+itdw+re8RM5fZA ($31.15 in chips) 
Seat 8: ljemhp25Zg+nlA9DLCIiUw ($23 in chips) 
Seat 9: H5Se03ZqSX7tbULXur2MAg ($13.65 in chips) 
HPEB+AtKw1+C/cxU0o1ciw: posts small blind $0.10
QEbIGci+itdw+re8RM5fZA: posts big blind $0.25
PdIasPkzm2sqZnN41ZRXOg: sits out 
*** HOLE CARDS ***
ljemhp25Zg+nlA9DLCIiUw: folds 
H5Se03ZqSX7tbULXur2MAg: folds 
xEQxarad8/T4jJdpZy5LGw: folds 
vSkQm2EelzwRGDDQQk0Fqw: folds 
N2LVj3iImgnOoHVf8g0rIw: raises $0.50 to $0.75
w48D7DZIjuBit2n4FRDJ5Q: calls $0.75
HPEB+AtKw1+C/cxU0o1ciw: folds 
QEbIGci+itdw+re8RM5fZA: folds 
*** FLOP *** [Th 2s Qh]
N2LVj3iImgnOoHVf8g0rIw: bets $1
w48D7DZIjuBit2n4FRDJ5Q: calls $1
*** TURN *** [Th 2s Qh] [8d]
N2LVj3iImgnOoHVf8g0rIw: bets $0.25
w48D7DZIjuBit2n4FRDJ5Q: calls $0.25
*** RIVER *** [Th 2s Qh 8d] [2d]
N2LVj3iImgnOoHVf8g0rIw: checks 
w48D7DZIjuBit2n4FRDJ5Q: bets $4
N2LVj3iImgnOoHVf8g0rIw: folds 
Uncalled bet ($4) returned to w48D7DZIjuBit2n4FRDJ5Q
w48D7DZIjuBit2n4FRDJ5Q collected $4.15 from pot
w48D7DZIjuBit2n4FRDJ5Q: doesn't show hand 
*** SUMMARY ***
Total pot $4.35 | Rake $0.20 
Board [Th 2s Qh 8d 2d]
Seat 1: xEQxarad8/T4jJdpZy5LGw folded before Flop (didn't bet)
Seat 2: vSkQm2EelzwRGDDQQk0Fqw folded before Flop (didn't bet)
Seat 4: N2LVj3iImgnOoHVf8g0rIw folded on the River
Seat 5: w48D7DZIjuBit2n4FRDJ5Q (button) collected ($4.15)
Seat 6: HPEB+AtKw1+C/cxU0o1ciw (small blind) folded before Flop
Seat 7: QEbIGci+itdw+re8RM5fZA (big blind) folded before Flop
Seat 8: ljemhp25Zg+nlA9DLCIiUw folded before Flop (didn't bet)
Seat 9: H5Se03ZqSX7tbULXur2MAg folded before Flop (didn't bet)




PokerStars Game #59941668494:  Hold'em No Limit ($0.10/$0.25) - 2009/07/01 1:42:25 ET
Table 'ORSZkZqq+7Ja2PdeCFAytA' 9-max Seat #9 is the button
Seat 1: 3FkcXBaxKqxYVagfYUZlmw ($12.25 in chips) 
Seat 2: FzknuThd6oNi5WfR7ciTfA ($18 in chips) 
Seat 3: s9a4d23HFxaL70yUWQ0/tQ ($17.65 in chips) 
Seat 4: tbgfV2Egwn85xEt865GWQQ ($15.15 in chips) 
Seat 5: +lWbsq4dTcA70SX/+hnmpg ($4.40 in chips) 
Seat 6: gMF+EMhmwpnaM5TFQquf2A ($9.25 in chips) 
Seat 8: npAYqa85pqnzfOK5ukX+BQ ($19.90 in chips) 
Seat 9: cMTFs4oCtNInkpDIecxT/w ($22.75 in chips) 
3FkcXBaxKqxYVagfYUZlmw: posts small blind $0.10
FzknuThd6oNi5WfR7ciTfA: posts big blind $0.25
*** HOLE CARDS ***
s9a4d23HFxaL70yUWQ0/tQ: calls $0.25
tbgfV2Egwn85xEt865GWQQ: folds 
+lWbsq4dTcA70SX/+hnmpg: raises $0.75 to $1
gMF+EMhmwpnaM5TFQquf2A: calls $1
gdpheroin has returned
npAYqa85pqnzfOK5ukX+BQ: folds 
gdpheroin leaves the table
cMTFs4oCtNInkpDIecxT/w: folds 
3FkcXBaxKqxYVagfYUZlmw: calls $0.90
FzknuThd6oNi5WfR7ciTfA: folds 
s9a4d23HFxaL70yUWQ0/tQ: calls $0.75
*** FLOP *** [Th 9d 9c]
clJsV3v77RS07bDKY+705w joins the table at seat #7 
3FkcXBaxKqxYVagfYUZlmw: bets $1
s9a4d23HFxaL70yUWQ0/tQ: folds 
+lWbsq4dTcA70SX/+hnmpg: folds 
gMF+EMhmwpnaM5TFQquf2A: calls $1
*** TURN *** [Th 9d 9c] [Jh]
3FkcXBaxKqxYVagfYUZlmw: checks 
gMF+EMhmwpnaM5TFQquf2A: bets $1.25
3FkcXBaxKqxYVagfYUZlmw: calls $1.25
*** RIVER *** [Th 9d 9c Jh] [8h]
3FkcXBaxKqxYVagfYUZlmw: bets $5
gMF+EMhmwpnaM5TFQquf2A: folds 
Uncalled bet ($5) returned to 3FkcXBaxKqxYVagfYUZlmw
3FkcXBaxKqxYVagfYUZlmw collected $8.35 from pot
*** SUMMARY ***
Total pot $8.75 | Rake $0.40 
Board [Th 9d 9c Jh 8h]
Seat 1: 3FkcXBaxKqxYVagfYUZlmw (small blind) collected ($8.35)
Seat 2: FzknuThd6oNi5WfR7ciTfA (big blind) folded before Flop
Seat 3: s9a4d23HFxaL70yUWQ0/tQ folded on the Flop
Seat 4: tbgfV2Egwn85xEt865GWQQ folded before Flop (didn't bet)
Seat 5: +lWbsq4dTcA70SX/+hnmpg folded on the Flop
Seat 6: gMF+EMhmwpnaM5TFQquf2A folded on the River
Seat 8: npAYqa85pqnzfOK5ukX+BQ folded before Flop (didn't bet)
Seat 9: cMTFs4oCtNInkpDIecxT/w (button) folded before Flop (didn't bet)




PokerStars Game #59941668498:  Hold'em No Limit ($0.10/$0.25) - 2009/07/01 1:42:25 ET
Table 'L5GvbdQO5aCZJSE6pyQ8OA' 6-max Seat #6 is the button
Seat 1: eFj4lr1nuXLyCWNTShr1bg ($10.85 in chips) 
Seat 2: DihMHaz4WNETH1bPDe13kA ($29.05 in chips) 
Seat 3: JFIAqU8lCZ0vWwEl4bdGsg ($28.30 in chips) 
Seat 5: LyDHtw3/yniNHW+DvLXbog ($26.30 in chips) 
Seat 6: v+QfkGiuj9bgtuNoVnDO8w ($39.40 in chips) 
eFj4lr1nuXLyCWNTShr1bg: posts small blind $0.10
DihMHaz4WNETH1bPDe13kA: posts big blind $0.25
*** HOLE CARDS ***
JFIAqU8lCZ0vWwEl4bdGsg: folds 
LyDHtw3/yniNHW+DvLXbog: raises $0.75 to $1
trN/oHqTTbPw5MNuKrOpLw has returned
v+QfkGiuj9bgtuNoVnDO8w: folds 
eFj4lr1nuXLyCWNTShr1bg: folds 
DihMHaz4WNETH1bPDe13kA: folds 
Uncalled bet ($0.75) returned to LyDHtw3/yniNHW+DvLXbog
LyDHtw3/yniNHW+DvLXbog collected $0.60 from pot
LyDHtw3/yniNHW+DvLXbog: doesn't show hand 
*** SUMMARY ***
Total pot $0.60 | Rake $0 
Seat 1: eFj4lr1nuXLyCWNTShr1bg (small blind) folded before Flop
Seat 2: DihMHaz4WNETH1bPDe13kA (big blind) folded before Flop
Seat 3: JFIAqU8lCZ0vWwEl4bdGsg folded before Flop (didn't bet)
Seat 5: LyDHtw3/yniNHW+DvLXbog collected ($0.60)
Seat 6: v+QfkGiuj9bgtuNoVnDO8w (button) folded before Flop (didn't bet)




PokerStars Game #59941668578:  Hold'em No Limit ($0.10/$0.25) - 2009/07/01 1:42:25 ET
Table 'IIO2q2znuuAXmiZ2qFTcmg' 6-max Seat #4 is the button
Seat 1: 2G0C7dp4wlPpE21FHjjElQ ($25 in chips) 
Seat 2: cS21pIxRHx5Gt42o7hPZzw ($24.80 in chips) 
Seat 3: L3/N/gliETan8N5Gim5h4Q ($25 in chips) 
Seat 4: tSR4329m40dZsN7YOpI9Kw ($59.25 in chips) 
Seat 5: 9U3ZKjCsarN0DjR6mSE8Ug ($14.10 in chips) 
Seat 6: aogAb4Eienxztk8p2v9VVw ($36 in chips) 
9U3ZKjCsarN0DjR6mSE8Ug: posts small blind $0.10
aogAb4Eienxztk8p2v9VVw: posts big blind $0.25
*** HOLE CARDS ***
2G0C7dp4wlPpE21FHjjElQ: folds 
cS21pIxRHx5Gt42o7hPZzw: folds 
L3/N/gliETan8N5Gim5h4Q: folds 
tSR4329m40dZsN7YOpI9Kw: raises $0.50 to $0.75
9U3ZKjCsarN0DjR6mSE8Ug: folds 
aogAb4Eienxztk8p2v9VVw: raises $1.75 to $2.50
tSR4329m40dZsN7YOpI9Kw: folds 
Uncalled bet ($1.75) returned to aogAb4Eienxztk8p2v9VVw
aogAb4Eienxztk8p2v9VVw collected $1.60 from pot
aogAb4Eienxztk8p2v9VVw: doesn't show hand 
*** SUMMARY ***
Total pot $1.60 | Rake $0 
Seat 1: 2G0C7dp4wlPpE21FHjjElQ folded before Flop (didn't bet)
Seat 2: cS21pIxRHx5Gt42o7hPZzw folded before Flop (didn't bet)
Seat 3: L3/N/gliETan8N5Gim5h4Q folded before Flop (didn't bet)
Seat 4: tSR4329m40dZsN7YOpI9Kw (button) folded before Flop
Seat 5: 9U3ZKjCsarN0DjR6mSE8Ug (small blind) folded before Flop
Seat 6: aogAb4Eienxztk8p2v9VVw (big blind) collected ($1.60)




PokerStars Game #59941668582:  Hold'em No Limit ($0.10/$0.25) - 2009/07/01 1:42:25 ET
Table '84TjTrgbsYZladOc4PWf4Q' 6-max Seat #6 is the button
Seat 1: /kW0t5kKllzd8HO2uEapHQ ($23.70 in chips) 
Seat 2: RpaEX9P7BCvyfPRLiRNg0A ($39.95 in chips) 
Seat 3: Ar4vsUIUfJ7gbYh1c1m59g ($12.35 in chips) 
Seat 4: SxIIgwXYLkwd6m3wLyPTCw ($21.95 in chips) 
Seat 5: cezpHJ8FB07dj0xG+LhOvw ($26.85 in chips) 
Seat 6: wCUaomJ6Nq5zomVGdUHP+w ($18.50 in chips) 
/kW0t5kKllzd8HO2uEapHQ: posts small blind $0.10
RpaEX9P7BCvyfPRLiRNg0A: posts big blind $0.25
*** HOLE CARDS ***
Ar4vsUIUfJ7gbYh1c1m59g: folds 
SxIIgwXYLkwd6m3wLyPTCw: folds 
cezpHJ8FB07dj0xG+LhOvw: folds 
wCUaomJ6Nq5zomVGdUHP+w: folds 
/kW0t5kKllzd8HO2uEapHQ: calls $0.15
RpaEX9P7BCvyfPRLiRNg0A: checks 
*** FLOP *** [Qd Kc 9c]
/kW0t5kKllzd8HO2uEapHQ: bets $0.50
RpaEX9P7BCvyfPRLiRNg0A: calls $0.50
*** TURN *** [Qd Kc 9c] [6s]
/kW0t5kKllzd8HO2uEapHQ: bets $0.50
RpaEX9P7BCvyfPRLiRNg0A: calls $0.50
*** RIVER *** [Qd Kc 9c 6s] [4s]
/kW0t5kKllzd8HO2uEapHQ: checks 
RpaEX9P7BCvyfPRLiRNg0A: bets $0.75
/kW0t5kKllzd8HO2uEapHQ: calls $0.75
*** SHOW DOWN ***
RpaEX9P7BCvyfPRLiRNg0A: shows [Th Kd] (a pair of Kings)
/kW0t5kKllzd8HO2uEapHQ: mucks hand 
RpaEX9P7BCvyfPRLiRNg0A collected $3.85 from pot
*** SUMMARY ***
Total pot $4 | Rake $0.15 
Board [Qd Kc 9c 6s 4s]
Seat 1: /kW0t5kKllzd8HO2uEapHQ (small blind) mucked
Seat 2: RpaEX9P7BCvyfPRLiRNg0A (big blind) showed [Th Kd] and won ($3.85) with a pair of Kings
Seat 3: Ar4vsUIUfJ7gbYh1c1m59g folded before Flop (didn't bet)
Seat 4: SxIIgwXYLkwd6m3wLyPTCw folded before Flop (didn't bet)
Seat 5: cezpHJ8FB07dj0xG+LhOvw folded before Flop (didn't bet)
Seat 6: wCUaomJ6Nq5zomVGdUHP+w (button) folded before Flop (didn't bet)




PokerStars Game #59941668220:  Hold'em No Limit ($0.10/$0.25) - 2009/07/01 1:42:25 ET
Table '3Ns9nuTkynfwbBfBXzg6ww' 6-max Seat #6 is the button
Seat 1: epAUIB7h2FJXzUPRIvSkRA ($25 in chips) 
Seat 2: zxeVQGaMKDsDzmSY+AInjA ($33.70 in chips) 
Seat 3: eL3+wCBjFGfQ5FMdIZihwA ($24.65 in chips) 
Seat 4: qGHGf/553gQnDoklMRe3tg ($30.95 in chips) 
Seat 5: wqphQtauX5Qn7WRJZS1flA ($25.65 in chips) 
Seat 6: DE9hRlt14g+JdsRQ4wT7hg ($35.70 in chips) 
epAUIB7h2FJXzUPRIvSkRA: posts small blind $0.10
zxeVQGaMKDsDzmSY+AInjA: posts big blind $0.25
*** HOLE CARDS ***
eL3+wCBjFGfQ5FMdIZihwA: folds 
qGHGf/553gQnDoklMRe3tg: folds 
wqphQtauX5Qn7WRJZS1flA: folds 
DE9hRlt14g+JdsRQ4wT7hg: raises $0.75 to $1
epAUIB7h2FJXzUPRIvSkRA: folds 
zxeVQGaMKDsDzmSY+AInjA: folds 
Uncalled bet ($0.75) returned to DE9hRlt14g+JdsRQ4wT7hg
DE9hRlt14g+JdsRQ4wT7hg collected $0.60 from pot
DE9hRlt14g+JdsRQ4wT7hg: doesn't show hand 
*** SUMMARY ***
Total pot $0.60 | Rake $0 
Seat 1: epAUIB7h2FJXzUPRIvSkRA (small blind) folded before Flop
Seat 2: zxeVQGaMKDsDzmSY+AInjA (big blind) folded before Flop
Seat 3: eL3+wCBjFGfQ5FMdIZihwA folded before Flop (didn't bet)
Seat 4: qGHGf/553gQnDoklMRe3tg folded before Flop (didn't bet)
Seat 5: wqphQtauX5Qn7WRJZS1flA folded before Flop (didn't bet)
Seat 6: DE9hRlt14g+JdsRQ4wT7hg (button) collected ($0.60)




PokerStars Game #59941668408:  Hold'em No Limit ($0.10/$0.25) - 2009/07/01 1:42:25 ET
Table '7/qMNloI0nSXWiX5Y1watA' 9-max Seat #2 is the button
Seat 1: /LyhaB3V6jkgOfXORidqRQ ($7.10 in chips) 
Seat 2: wGigCmBR/9XWkPpvYos3aQ ($25.15 in chips) 
Seat 3: W2YYHvqjaEpRrO7stZkClQ ($4.45 in chips) 
Seat 6: Y3DZ6qQlLeBhixDj4M9vmg ($17.85 in chips) 
Seat 7: z5GxcHlYz/GSz6W2uFiTtg ($20.55 in chips) 
Seat 8: ljemhp25Zg+nlA9DLCIiUw ($24 in chips) 
Seat 9: dmYlc+1cjwZMJ7wV+Z0rRg ($26.50 in chips) 
W2YYHvqjaEpRrO7stZkClQ: posts small blind $0.10
Y3DZ6qQlLeBhixDj4M9vmg: posts big blind $0.25
*** HOLE CARDS ***
z5GxcHlYz/GSz6W2uFiTtg: folds 
ljemhp25Zg+nlA9DLCIiUw: folds 
dmYlc+1cjwZMJ7wV+Z0rRg: raises $0.50 to $0.75
/LyhaB3V6jkgOfXORidqRQ: folds 
wGigCmBR/9XWkPpvYos3aQ: calls $0.75
W2YYHvqjaEpRrO7stZkClQ: folds 
Y3DZ6qQlLeBhixDj4M9vmg: folds 
*** FLOP *** [7c 9s 3d]
K0LdhPeU31rviEPo6Sv3TA has returned
dmYlc+1cjwZMJ7wV+Z0rRg: checks 
wGigCmBR/9XWkPpvYos3aQ: bets $1.40
dmYlc+1cjwZMJ7wV+Z0rRg: folds 
Uncalled bet ($1.40) returned to wGigCmBR/9XWkPpvYos3aQ
wGigCmBR/9XWkPpvYos3aQ collected $1.80 from pot
wGigCmBR/9XWkPpvYos3aQ: doesn't show hand 
*** SUMMARY ***
Total pot $1.85 | Rake $0.05 
Board [7c 9s 3d]
Seat 1: /LyhaB3V6jkgOfXORidqRQ folded before Flop (didn't bet)
Seat 2: wGigCmBR/9XWkPpvYos3aQ (button) collected ($1.80)
Seat 3: W2YYHvqjaEpRrO7stZkClQ (small blind) folded before Flop
Seat 6: Y3DZ6qQlLeBhixDj4M9vmg (big blind) folded before Flop
Seat 7: z5GxcHlYz/GSz6W2uFiTtg folded before Flop (didn't bet)
Seat 8: ljemhp25Zg+nlA9DLCIiUw folded before Flop (didn't bet)
Seat 9: dmYlc+1cjwZMJ7wV+Z0rRg folded on the Flop




PokerStars Game #59941669034:  Hold'em No Limit ($0.10/$0.25) - 2009/07/01 1:42:26 ET
Table 'T/iCKJXGphRN3xcdwfE/JQ' 6-max Seat #6 is the button
Seat 1: wAKC8C/zN0c8V5v13dm9mA ($25 in chips) 
Seat 2: EeUZtMU058v2ObUACOF4Og ($36.30 in chips) 
Seat 3: IWAjoCPXtc1XUaZdp+pCpA ($21.75 in chips) 
Seat 4: tSR4329m40dZsN7YOpI9Kw ($52.95 in chips) 
Seat 5: gaPMxLGp9SOj4Lq6t+/0Ig ($4.20 in chips) 
Seat 6: Ey4Kn6PlnYb2srYYBJHvzg ($14.95 in chips) 
wAKC8C/zN0c8V5v13dm9mA: posts small blind $0.10
EeUZtMU058v2ObUACOF4Og: posts big blind $0.25
*** HOLE CARDS ***
IWAjoCPXtc1XUaZdp+pCpA: folds 
tSR4329m40dZsN7YOpI9Kw: folds 
gaPMxLGp9SOj4Lq6t+/0Ig: folds 
Ey4Kn6PlnYb2srYYBJHvzg: folds 
wAKC8C/zN0c8V5v13dm9mA: folds 
Uncalled bet ($0.15) returned to EeUZtMU058v2ObUACOF4Og
EeUZtMU058v2ObUACOF4Og collected $0.20 from pot
EeUZtMU058v2ObUACOF4Og: doesn't show hand 
*** SUMMARY ***
Total pot $0.20 | Rake $0 
Seat 1: wAKC8C/zN0c8V5v13dm9mA (small blind) folded before Flop
Seat 2: EeUZtMU058v2ObUACOF4Og (big blind) collected ($0.20)
Seat 3: IWAjoCPXtc1XUaZdp+pCpA folded before Flop (didn't bet)
Seat 4: tSR4329m40dZsN7YOpI9Kw folded before Flop (didn't bet)
Seat 5: gaPMxLGp9SOj4Lq6t+/0Ig folded before Flop (didn't bet)
Seat 6: Ey4Kn6PlnYb2srYYBJHvzg (button) folded before Flop (didn't bet)




PokerStars Game #59941669022:  Hold'em No Limit ($0.10/$0.25) - 2009/07/01 1:42:26 ET
Table 'NgexmgEDEzICBeSO7YCrKQ' 6-max Seat #4 is the button
Seat 1: cezpHJ8FB07dj0xG+LhOvw ($29.80 in chips) 
Seat 2: 32YL2ZEp8NT4JB2RVM9euQ ($21.55 in chips) 
Seat 3: JFIAqU8lCZ0vWwEl4bdGsg ($26.85 in chips) 
Seat 4: xx+iYCDJhHJmNzrfeloyEg ($27.80 in chips) 
Seat 5: /MXkdT8TTs8Qp2LVTQNw6w ($37.90 in chips) 
Seat 6: k9nHZTHt8hYhYRcW8NTb4g ($10.95 in chips) 
/MXkdT8TTs8Qp2LVTQNw6w: posts small blind $0.10
k9nHZTHt8hYhYRcW8NTb4g: posts big blind $0.25
*** HOLE CARDS ***
cezpHJ8FB07dj0xG+LhOvw: folds 
32YL2ZEp8NT4JB2RVM9euQ: raises $0.75 to $1
JFIAqU8lCZ0vWwEl4bdGsg: folds 
xx+iYCDJhHJmNzrfeloyEg: folds 
/MXkdT8TTs8Qp2LVTQNw6w: folds 
k9nHZTHt8hYhYRcW8NTb4g: folds 
Uncalled bet ($0.75) returned to 32YL2ZEp8NT4JB2RVM9euQ
32YL2ZEp8NT4JB2RVM9euQ collected $0.60 from pot
32YL2ZEp8NT4JB2RVM9euQ: doesn't show hand 
*** SUMMARY ***
Total pot $0.60 | Rake $0 
Seat 1: cezpHJ8FB07dj0xG+LhOvw folded before Flop (didn't bet)
Seat 2: 32YL2ZEp8NT4JB2RVM9euQ collected ($0.60)
Seat 3: JFIAqU8lCZ0vWwEl4bdGsg folded before Flop (didn't bet)
Seat 4: xx+iYCDJhHJmNzrfeloyEg (button) folded before Flop (didn't bet)
Seat 5: /MXkdT8TTs8Qp2LVTQNw6w (small blind) folded before Flop
Seat 6: k9nHZTHt8hYhYRcW8NTb4g (big blind) folded before Flop




PokerStars Game #59941669074:  Hold'em No Limit ($0.10/$0.25) - 2009/07/01 1:42:26 ET
Table 'Loy/olZ5qoDOSvX4UTujGg' 6-max Seat #4 is the button
Seat 1: HipgaJhkN4ie/tTw4dK3Ug ($11.30 in chips) 
Seat 2: 4z7mPbMLNp4TezHXin63Vw ($17.80 in chips) 
Seat 3: 32YL2ZEp8NT4JB2RVM9euQ ($16.05 in chips) 
Seat 4: /gJNBeCkWL4o85/jvlZ4BA ($28.55 in chips) 
Seat 5: tSR4329m40dZsN7YOpI9Kw ($28.45 in chips) 
Seat 6: qGHGf/553gQnDoklMRe3tg ($26.55 in chips) 
tSR4329m40dZsN7YOpI9Kw: posts small blind $0.10
qGHGf/553gQnDoklMRe3tg: posts big blind $0.25
*** HOLE CARDS ***
HipgaJhkN4ie/tTw4dK3Ug: raises $0.50 to $0.75
4z7mPbMLNp4TezHXin63Vw: raises $0.50 to $1.25
32YL2ZEp8NT4JB2RVM9euQ: folds 
/gJNBeCkWL4o85/jvlZ4BA: folds 
tSR4329m40dZsN7YOpI9Kw: folds 
qGHGf/553gQnDoklMRe3tg: folds 
HipgaJhkN4ie/tTw4dK3Ug: calls $0.50
*** FLOP *** [Ac 4c Jc]
HipgaJhkN4ie/tTw4dK3Ug: bets $0.50
4z7mPbMLNp4TezHXin63Vw: folds 
Uncalled bet ($0.50) returned to HipgaJhkN4ie/tTw4dK3Ug
HipgaJhkN4ie/tTw4dK3Ug collected $2.75 from pot
*** SUMMARY ***
Total pot $2.85 | Rake $0.10 
Board [Ac 4c Jc]
Seat 1: HipgaJhkN4ie/tTw4dK3Ug collected ($2.75)
Seat 2: 4z7mPbMLNp4TezHXin63Vw folded on the Flop
Seat 3: 32YL2ZEp8NT4JB2RVM9euQ folded before Flop (didn't bet)
Seat 4: /gJNBeCkWL4o85/jvlZ4BA (button) folded before Flop (didn't bet)
Seat 5: tSR4329m40dZsN7YOpI9Kw (small blind) folded before Flop
Seat 6: qGHGf/553gQnDoklMRe3tg (big blind) folded before Flop




PokerStars Game #59941669036:  Hold'em No Limit ($0.10/$0.25) - 2009/07/01 1:42:26 ET
Table 'IuqVbFI+pwnJjvwBCGSGAw' 6-max Seat #2 is the button
Seat 1: LyDHtw3/yniNHW+DvLXbog ($26.25 in chips) 
Seat 2: wsP46AGpqDjHZQmlRHKa9g ($25.45 in chips) 
Seat 3: QiL+lEgEWwy21jk/ltaRLg ($22.35 in chips) 
Seat 4: DE9hRlt14g+JdsRQ4wT7hg ($25 in chips) 
Seat 5: if4dh6jhJXeN3/qd3qCp9g ($25 in chips) 
Seat 6: SJ5z7oeRzpbFT7jU55Mbag ($36.40 in chips) 
QiL+lEgEWwy21jk/ltaRLg: posts small blind $0.10
DE9hRlt14g+JdsRQ4wT7hg: posts big blind $0.25
*** HOLE CARDS ***
if4dh6jhJXeN3/qd3qCp9g: raises $0.75 to $1
SJ5z7oeRzpbFT7jU55Mbag: folds 
LyDHtw3/yniNHW+DvLXbog: folds 
wsP46AGpqDjHZQmlRHKa9g: folds 
QiL+lEgEWwy21jk/ltaRLg: folds 
DE9hRlt14g+JdsRQ4wT7hg: folds 
Uncalled bet ($0.75) returned to if4dh6jhJXeN3/qd3qCp9g
if4dh6jhJXeN3/qd3qCp9g collected $0.60 from pot
if4dh6jhJXeN3/qd3qCp9g: doesn't show hand 
*** SUMMARY ***
Total pot $0.60 | Rake $0 
Seat 1: LyDHtw3/yniNHW+DvLXbog folded before Flop (didn't bet)
Seat 2: wsP46AGpqDjHZQmlRHKa9g (button) folded before Flop (didn't bet)
Seat 3: QiL+lEgEWwy21jk/ltaRLg (small blind) folded before Flop
Seat 4: DE9hRlt14g+JdsRQ4wT7hg (big blind) folded before Flop
Seat 5: if4dh6jhJXeN3/qd3qCp9g collected ($0.60)
Seat 6: SJ5z7oeRzpbFT7jU55Mbag folded before Flop (didn't bet)




PokerStars Game #59941668926:  Hold'em No Limit ($0.10/$0.25) - 2009/07/01 1:42:26 ET
Table 'ykyWGjhNu7AvZXov27T4ew' 9-max Seat #2 is the button
Seat 2: MG90wfSJZnOejs/KD3vlQQ ($39.60 in chips) 
Seat 3: NPI9ArW8kwrb6a2IAL6xMQ ($25.45 in chips) 
Seat 4: W6tExOcYX7qiy6Qdp+ZwFA ($6.05 in chips) 
Seat 5: CmngQmkKTp8tkl6GMRTl6w ($8.50 in chips) 
Seat 6: AiXn/9o1EwOPZUHujnh/bA ($20.40 in chips) 
Seat 7: npAYqa85pqnzfOK5ukX+BQ ($21.90 in chips) 
Seat 8: tYsOBqdU1+x+yFI7zHO7hQ ($49.35 in chips) 
Seat 9: wk9M6R3w+aDHpr8WV87RmQ ($11.25 in chips) 
NPI9ArW8kwrb6a2IAL6xMQ: posts small blind $0.10
W6tExOcYX7qiy6Qdp+ZwFA: posts big blind $0.25
Team Rsf: sits out 
*** HOLE CARDS ***
CmngQmkKTp8tkl6GMRTl6w: folds 
AiXn/9o1EwOPZUHujnh/bA: calls $0.25
npAYqa85pqnzfOK5ukX+BQ: calls $0.25
tYsOBqdU1+x+yFI7zHO7hQ: folds 
wk9M6R3w+aDHpr8WV87RmQ: folds 
MG90wfSJZnOejs/KD3vlQQ: folds 
NPI9ArW8kwrb6a2IAL6xMQ: calls $0.15
W6tExOcYX7qiy6Qdp+ZwFA: checks 
*** FLOP *** [5s 7h Ts]
NPI9ArW8kwrb6a2IAL6xMQ: bets $0.25
W6tExOcYX7qiy6Qdp+ZwFA: calls $0.25
AiXn/9o1EwOPZUHujnh/bA: folds 
npAYqa85pqnzfOK5ukX+BQ: folds 
*** TURN *** [5s 7h Ts] [As]
NPI9ArW8kwrb6a2IAL6xMQ: bets $0.25
W6tExOcYX7qiy6Qdp+ZwFA: calls $0.25
*** RIVER *** [5s 7h Ts As] [Ac]
NPI9ArW8kwrb6a2IAL6xMQ: bets $0.25
W6tExOcYX7qiy6Qdp+ZwFA: folds 
Uncalled bet ($0.25) returned to NPI9ArW8kwrb6a2IAL6xMQ
NPI9ArW8kwrb6a2IAL6xMQ collected $1.95 from pot
*** SUMMARY ***
Total pot $2 | Rake $0.05 
Board [5s 7h Ts As Ac]
Seat 2: MG90wfSJZnOejs/KD3vlQQ (button) folded before Flop (didn't bet)
Seat 3: NPI9ArW8kwrb6a2IAL6xMQ (small blind) collected ($1.95)
Seat 4: W6tExOcYX7qiy6Qdp+ZwFA (big blind) folded on the River
Seat 5: CmngQmkKTp8tkl6GMRTl6w folded before Flop (didn't bet)
Seat 6: AiXn/9o1EwOPZUHujnh/bA folded on the Flop
Seat 7: npAYqa85pqnzfOK5ukX+BQ folded on the Flop
Seat 8: tYsOBqdU1+x+yFI7zHO7hQ folded before Flop (didn't bet)
Seat 9: wk9M6R3w+aDHpr8WV87RmQ folded before Flop (didn't bet)




PokerStars Game #59941668912:  Hold'em No Limit ($0.10/$0.25) - 2009/07/01 1:42:26 ET
Table '3lL16FBjWXTx3AjK5lMRww' 9-max Seat #7 is the button
Seat 1: fDGyaQz0cs2s4FOYxkbIHA ($16.55 in chips) 
Seat 2: c/9X4zftzphFxYtxp5kp9w ($19.15 in chips) 
Seat 3: QEbIGci+itdw+re8RM5fZA ($27.95 in chips) 
Seat 4: Z3a37Ry74FVl+CBZtAONiA ($6.55 in chips) 
Seat 6: zUXhymECc2C9W9ZNw6qppA ($9.65 in chips) 
Seat 7: 6RiVTYll/5D8zICp0MRpKw ($25.70 in chips) 
Seat 8: ljemhp25Zg+nlA9DLCIiUw ($23.75 in chips) 
Seat 9: 00Ybni1cxfHtqmdWwh31Xg ($11.40 in chips) 
ljemhp25Zg+nlA9DLCIiUw: posts small blind $0.10
00Ybni1cxfHtqmdWwh31Xg: posts big blind $0.25
*** HOLE CARDS ***
fDGyaQz0cs2s4FOYxkbIHA: folds 
c/9X4zftzphFxYtxp5kp9w: raises $0.75 to $1
QEbIGci+itdw+re8RM5fZA: folds 
Z3a37Ry74FVl+CBZtAONiA: folds 
zUXhymECc2C9W9ZNw6qppA: folds 
6RiVTYll/5D8zICp0MRpKw: folds 
ljemhp25Zg+nlA9DLCIiUw: folds 
00Ybni1cxfHtqmdWwh31Xg: calls $0.75
*** FLOP *** [4s Ac Qc]
00Ybni1cxfHtqmdWwh31Xg: checks 
c/9X4zftzphFxYtxp5kp9w: bets $1.50
00Ybni1cxfHtqmdWwh31Xg: folds 
Uncalled bet ($1.50) returned to c/9X4zftzphFxYtxp5kp9w
c/9X4zftzphFxYtxp5kp9w collected $2 from pot
*** SUMMARY ***
Total pot $2.10 | Rake $0.10 
Board [4s Ac Qc]
Seat 1: fDGyaQz0cs2s4FOYxkbIHA folded before Flop (didn't bet)
Seat 2: c/9X4zftzphFxYtxp5kp9w collected ($2)
Seat 3: QEbIGci+itdw+re8RM5fZA folded before Flop (didn't bet)
Seat 4: Z3a37Ry74FVl+CBZtAONiA folded before Flop (didn't bet)
Seat 6: zUXhymECc2C9W9ZNw6qppA folded before Flop (didn't bet)
Seat 7: 6RiVTYll/5D8zICp0MRpKw (button) folded before Flop (didn't bet)
Seat 8: ljemhp25Zg+nlA9DLCIiUw (small blind) folded before Flop
Seat 9: 00Ybni1cxfHtqmdWwh31Xg (big blind) folded on the Flop




PokerStars Game #59941668846:  Hold'em No Limit ($0.10/$0.25) - 2009/07/01 1:42:26 ET
Table 'aisAlB9GIV21BwfUW3+Nbg' 9-max Seat #7 is the button
Seat 1: SqibpGx+lf+brY0fJVvD0w ($24.65 in chips) 
Seat 2: +7GnIVpCmyuij3NJfOgsTw ($13.40 in chips) 
Seat 3: CvL9Ch1HYCVbTsfpNucitg ($4.80 in chips) 
Seat 4: sD+TKtt36XiiN6jqHiLwDA ($26.20 in chips) 
Seat 5: ghNKXUBl/H+t83JF079ZBA ($27.40 in chips) 
Seat 6: 9gmYYQesalMrUjaF7nKfrQ ($16.20 in chips) 
Seat 7: jGjM+5lCSe6f2MEwxQGOAg ($37.60 in chips) 
Seat 8: VWUWpMLMj/Q1jRVpF7Aohw ($12.25 in chips) 
Seat 9: N0hGpTAEAj9k5msS6LPLAw ($11.10 in chips) 
VWUWpMLMj/Q1jRVpF7Aohw: posts small blind $0.10
N0hGpTAEAj9k5msS6LPLAw: posts big blind $0.25
*** HOLE CARDS ***
SqibpGx+lf+brY0fJVvD0w: folds 
+7GnIVpCmyuij3NJfOgsTw: folds 
CvL9Ch1HYCVbTsfpNucitg: folds 
sD+TKtt36XiiN6jqHiLwDA: raises $0.75 to $1
ghNKXUBl/H+t83JF079ZBA: folds 
9gmYYQesalMrUjaF7nKfrQ: folds 
jGjM+5lCSe6f2MEwxQGOAg: calls $1
VWUWpMLMj/Q1jRVpF7Aohw: folds 
N0hGpTAEAj9k5msS6LPLAw: calls $0.75
*** FLOP *** [Ac Kd Kc]
N0hGpTAEAj9k5msS6LPLAw: checks 
sD+TKtt36XiiN6jqHiLwDA: checks 
jGjM+5lCSe6f2MEwxQGOAg: bets $3
N0hGpTAEAj9k5msS6LPLAw: calls $3
sD+TKtt36XiiN6jqHiLwDA: folds 
*** TURN *** [Ac Kd Kc] [5s]
N0hGpTAEAj9k5msS6LPLAw: checks 
jGjM+5lCSe6f2MEwxQGOAg: checks 
*** RIVER *** [Ac Kd Kc 5s] [4h]
N0hGpTAEAj9k5msS6LPLAw: bets $2.50
jGjM+5lCSe6f2MEwxQGOAg: raises $2.50 to $5
N0hGpTAEAj9k5msS6LPLAw: raises $2.10 to $7.10 and is all-in
jGjM+5lCSe6f2MEwxQGOAg: calls $2.10
*** SHOW DOWN ***
N0hGpTAEAj9k5msS6LPLAw: shows [Qs Ks] (three of a kind, Kings)
jGjM+5lCSe6f2MEwxQGOAg: mucks hand 
N0hGpTAEAj9k5msS6LPLAw collected $22.20 from pot
*** SUMMARY ***
Total pot $23.30 | Rake $1.10 
Board [Ac Kd Kc 5s 4h]
Seat 1: SqibpGx+lf+brY0fJVvD0w folded before Flop (didn't bet)
Seat 2: +7GnIVpCmyuij3NJfOgsTw folded before Flop (didn't bet)
Seat 3: CvL9Ch1HYCVbTsfpNucitg folded before Flop (didn't bet)
Seat 4: sD+TKtt36XiiN6jqHiLwDA folded on the Flop
Seat 5: ghNKXUBl/H+t83JF079ZBA folded before Flop (didn't bet)
Seat 6: 9gmYYQesalMrUjaF7nKfrQ folded before Flop (didn't bet)
Seat 7: jGjM+5lCSe6f2MEwxQGOAg (button) mucked
Seat 8: VWUWpMLMj/Q1jRVpF7Aohw (small blind) folded before Flop
Seat 9: N0hGpTAEAj9k5msS6LPLAw (big blind) showed [Qs Ks] and won ($22.20) with three of a kind, Kings




PokerStars Game #59941669570:  Hold'em No Limit ($0.10/$0.25) - 2009/07/01 1:42:27 ET
Table 'rjcb+nlE+0GuJ6lBhuCkkA' 6-max Seat #6 is the button
Seat 1: lBoEwOFgzcERLIRUkUoRTw ($13.70 in chips) 
Seat 2: lJphax9e7/+O/3YCKPJ0yQ ($6 in chips) 
Seat 3: 8ClCHtFXGNplITm+63KB+Q ($66.50 in chips) 
Seat 4: BV+K0Phf5VBHr7aZPKqbUQ ($25 in chips) 
Seat 5: GC/9yVD59DUCX7hUI7gcLw ($41.75 in chips) 
Seat 6: 32YL2ZEp8NT4JB2RVM9euQ ($15.65 in chips) 
lBoEwOFgzcERLIRUkUoRTw: posts small blind $0.10
lJphax9e7/+O/3YCKPJ0yQ: posts big blind $0.25
*** HOLE CARDS ***
8ClCHtFXGNplITm+63KB+Q: folds 
BV+K0Phf5VBHr7aZPKqbUQ: folds 
GC/9yVD59DUCX7hUI7gcLw: folds 
32YL2ZEp8NT4JB2RVM9euQ: folds 
lBoEwOFgzcERLIRUkUoRTw: folds 
Uncalled bet ($0.15) returned to lJphax9e7/+O/3YCKPJ0yQ
lJphax9e7/+O/3YCKPJ0yQ collected $0.20 from pot
*** SUMMARY ***
Total pot $0.20 | Rake $0 
Seat 1: lBoEwOFgzcERLIRUkUoRTw (small blind) folded before Flop
Seat 2: lJphax9e7/+O/3YCKPJ0yQ (big blind) collected ($0.20)
Seat 3: 8ClCHtFXGNplITm+63KB+Q folded before Flop (didn't bet)
Seat 4: BV+K0Phf5VBHr7aZPKqbUQ folded before Flop (didn't bet)
Seat 5: GC/9yVD59DUCX7hUI7gcLw folded before Flop (didn't bet)
Seat 6: 32YL2ZEp8NT4JB2RVM9euQ (button) folded before Flop (didn't bet)




PokerStars Game #59941670178:  Hold'em No Limit ($0.10/$0.25) - 2009/07/01 1:42:28 ET
Table 'aaXqTKUnxrX9DYXtxhWXxA' 6-max Seat #1 is the button
Seat 1: rnpAao581IcvQglpkpnkoQ ($8 in chips) 
Seat 2: DE9hRlt14g+JdsRQ4wT7hg ($33.80 in chips) 
Seat 3: uUXdcVMNa05rfbntdvplfw ($10 in chips) 
Seat 4: 48oT5xFI+5CHUJlfoGrE4w ($10.90 in chips) 
Seat 5: kyRaCIljYA6l33lSKQfNsg ($25 in chips) 
Seat 6: buyjetgNT1McXtdaP4zynA ($48.20 in chips) 
DE9hRlt14g+JdsRQ4wT7hg: posts small blind $0.10
uUXdcVMNa05rfbntdvplfw: posts big blind $0.25
*** HOLE CARDS ***
48oT5xFI+5CHUJlfoGrE4w: folds 
kyRaCIljYA6l33lSKQfNsg: raises $0.50 to $0.75
buyjetgNT1McXtdaP4zynA: calls $0.75
rnpAao581IcvQglpkpnkoQ: folds 
DE9hRlt14g+JdsRQ4wT7hg: folds 
uUXdcVMNa05rfbntdvplfw: calls $0.50
*** FLOP *** [6d 2h As]
uUXdcVMNa05rfbntdvplfw: checks 
kyRaCIljYA6l33lSKQfNsg: checks 
buyjetgNT1McXtdaP4zynA: checks 
*** TURN *** [6d 2h As] [6s]
uUXdcVMNa05rfbntdvplfw: bets $0.50
kyRaCIljYA6l33lSKQfNsg: calls $0.50
buyjetgNT1McXtdaP4zynA: folds 
*** RIVER *** [6d 2h As 6s] [Th]
uUXdcVMNa05rfbntdvplfw: checks 
kyRaCIljYA6l33lSKQfNsg: checks 
*** SHOW DOWN ***
uUXdcVMNa05rfbntdvplfw: shows [2c 5c] (two pair, Sixes and Deuces)
kyRaCIljYA6l33lSKQfNsg: shows [7c 7h] (two pair, Sevens and Sixes)
kyRaCIljYA6l33lSKQfNsg collected $3.20 from pot
*** SUMMARY ***
Total pot $3.35 | Rake $0.15 
Board [6d 2h As 6s Th]
Seat 1: rnpAao581IcvQglpkpnkoQ (button) folded before Flop (didn't bet)
Seat 2: DE9hRlt14g+JdsRQ4wT7hg (small blind) folded before Flop
Seat 3: uUXdcVMNa05rfbntdvplfw (big blind) showed [2c 5c] and lost with two pair, Sixes and Deuces
Seat 4: 48oT5xFI+5CHUJlfoGrE4w folded before Flop (didn't bet)
Seat 5: kyRaCIljYA6l33lSKQfNsg showed [7c 7h] and won ($3.20) with two pair, Sevens and Sixes
Seat 6: buyjetgNT1McXtdaP4zynA folded on the Turn




PokerStars Game #59941669792:  Hold'em No Limit ($0.10/$0.25) - 2009/07/01 1:42:28 ET
Table '9L7XfAwuM7XsXE8LIg2o5Q' 6-max Seat #1 is the button
Seat 1: dOIoLBxmpLHSXBN9LZnf0Q ($25.95 in chips) 
Seat 2: LJI7A1YgDM7hgh7o56+ReQ ($25.60 in chips) 
Seat 3: mFv3iBCtrw9XfCDRB0d46Q ($5 in chips) 
Seat 4: jp34e617tIzV8tKIWmfAbA ($39.95 in chips) 
Seat 5: OUv909q/YxsJgxpSlZxLJQ ($33.85 in chips) 
Seat 6: k9nHZTHt8hYhYRcW8NTb4g ($37 in chips) 
LJI7A1YgDM7hgh7o56+ReQ: posts small blind $0.10
mFv3iBCtrw9XfCDRB0d46Q: posts big blind $0.25
*** HOLE CARDS ***
jp34e617tIzV8tKIWmfAbA: folds 
OUv909q/YxsJgxpSlZxLJQ: folds 
k9nHZTHt8hYhYRcW8NTb4g: raises $0.50 to $0.75
dOIoLBxmpLHSXBN9LZnf0Q: calls $0.75
LJI7A1YgDM7hgh7o56+ReQ: folds 
mFv3iBCtrw9XfCDRB0d46Q: folds 
*** FLOP *** [Tc 9s Ac]
k9nHZTHt8hYhYRcW8NTb4g: bets $1
dOIoLBxmpLHSXBN9LZnf0Q: folds 
Uncalled bet ($1) returned to k9nHZTHt8hYhYRcW8NTb4g
k9nHZTHt8hYhYRcW8NTb4g collected $1.80 from pot
k9nHZTHt8hYhYRcW8NTb4g: doesn't show hand 
*** SUMMARY ***
Total pot $1.85 | Rake $0.05 
Board [Tc 9s Ac]
Seat 1: dOIoLBxmpLHSXBN9LZnf0Q (button) folded on the Flop
Seat 2: LJI7A1YgDM7hgh7o56+ReQ (small blind) folded before Flop
Seat 3: mFv3iBCtrw9XfCDRB0d46Q (big blind) folded before Flop
Seat 4: jp34e617tIzV8tKIWmfAbA folded before Flop (didn't bet)
Seat 5: OUv909q/YxsJgxpSlZxLJQ folded before Flop (didn't bet)
Seat 6: k9nHZTHt8hYhYRcW8NTb4g collected ($1.80)




PokerStars Game #59941670068:  Hold'em No Limit ($0.10/$0.25) - 2009/07/01 1:42:28 ET
Table 'mVdLgAdN9rGe6mMwSrDdGQ' 6-max Seat #6 is the button
Seat 2: n9QqWD4tpbongUBX2Oi58w ($4.90 in chips) 
Seat 3: +baiVgI/ETnBARLe5mARCw ($11.35 in chips) 
Seat 4: scNSjC6yyKvvfklSkuzLrw ($17.20 in chips) 
Seat 5: +TMG/MBWpiEnc9t7i07eTA ($30.50 in chips) 
Seat 6: DihMHaz4WNETH1bPDe13kA ($47.80 in chips) 
OyJ0KTHA5cwh0/yCo1/rdA will be allowed to play after the button
n9QqWD4tpbongUBX2Oi58w said, "guese"
n9QqWD4tpbongUBX2Oi58w: posts small blind $0.10
+baiVgI/ETnBARLe5mARCw: posts big blind $0.25
*** HOLE CARDS ***
scNSjC6yyKvvfklSkuzLrw: folds 
+TMG/MBWpiEnc9t7i07eTA: calls $0.25
DihMHaz4WNETH1bPDe13kA: folds 
n9QqWD4tpbongUBX2Oi58w: folds 
+baiVgI/ETnBARLe5mARCw: checks 
*** FLOP *** [Th 9h 9d]
+baiVgI/ETnBARLe5mARCw: bets $0.25
+TMG/MBWpiEnc9t7i07eTA: calls $0.25
*** TURN *** [Th 9h 9d] [5s]
+baiVgI/ETnBARLe5mARCw: bets $1
+TMG/MBWpiEnc9t7i07eTA: calls $1
*** RIVER *** [Th 9h 9d 5s] [3d]
+baiVgI/ETnBARLe5mARCw: bets $1.50
+TMG/MBWpiEnc9t7i07eTA: calls $1.50
*** SHOW DOWN ***
+baiVgI/ETnBARLe5mARCw: shows [Ts 9s] (a full house, Nines full of Tens)
+TMG/MBWpiEnc9t7i07eTA: mucks hand 
+baiVgI/ETnBARLe5mARCw collected $5.85 from pot
*** SUMMARY ***
Total pot $6.10 | Rake $0.25 
Board [Th 9h 9d 5s 3d]
Seat 2: n9QqWD4tpbongUBX2Oi58w (small blind) folded before Flop
Seat 3: +baiVgI/ETnBARLe5mARCw (big blind) showed [Ts 9s] and won ($5.85) with a full house, Nines full of Tens
Seat 4: scNSjC6yyKvvfklSkuzLrw folded before Flop (didn't bet)
Seat 5: +TMG/MBWpiEnc9t7i07eTA mucked
Seat 6: DihMHaz4WNETH1bPDe13kA (button) folded before Flop (didn't bet)




PokerStars Game #59941669872:  Hold'em No Limit ($0.10/$0.25) - 2009/07/01 1:42:28 ET
Table 'hfHe8uKeSJMyWAjSdM7ROQMRfAiS/4JSfnUDlCcZo0wAx Seat #3 is the button
Seat 1: 48oT5xFI+5CHUJlfoGrE4w ($30.50 in chips) 
Seat 2: /gJNBeCkWL4o85/jvlZ4BA ($29.35 in chips) 
Seat 3: FYepjhAvF8ZdVCmqHIy+eQ ($39.05 in chips) 
Seat 4: b4wRQV3APH8irVk6bUFe2Q ($29.65 in chips) 
Seat 6: L3/N/gliETan8N5Gim5h4Q ($25 in chips) 
b4wRQV3APH8irVk6bUFe2Q: posts small blind $0.10
L3/N/gliETan8N5Gim5h4Q: posts big blind $0.25
*** HOLE CARDS ***
48oT5xFI+5CHUJlfoGrE4w: folds 
/gJNBeCkWL4o85/jvlZ4BA: folds 
FYepjhAvF8ZdVCmqHIy+eQ: folds 
b4wRQV3APH8irVk6bUFe2Q: raises $0.50 to $0.75
L3/N/gliETan8N5Gim5h4Q: calls $0.50
*** FLOP *** [4d 8d Kc]
b4wRQV3APH8irVk6bUFe2Q: bets $1
L3/N/gliETan8N5Gim5h4Q: folds 
Uncalled bet ($1) returned to b4wRQV3APH8irVk6bUFe2Q
b4wRQV3APH8irVk6bUFe2Q collected $1.45 from pot
*** SUMMARY ***
Total pot $1.50 | Rake $0.05 
Board [4d 8d Kc]
Seat 1: 48oT5xFI+5CHUJlfoGrE4w folded before Flop (didn't bet)
Seat 2: /gJNBeCkWL4o85/jvlZ4BA folded before Flop (didn't bet)
Seat 3: FYepjhAvF8ZdVCmqHIy+eQ (button) folded before Flop (didn't bet)
Seat 4: b4wRQV3APH8irVk6bUFe2Q (small blind) collected ($1.45)
Seat 6: L3/N/gliETan8N5Gim5h4Q (big blind) folded on the Flop




PokerStars Game #59941670366:  Hold'em No Limit ($0.10/$0.25) - 2009/07/01 1:42:29 ET
Table '4mnXP0EWt9mMZYzTIVDQ0w' 9-max Seat #9 is the button
Seat 1: Z5y2J55JmfLYR6/DPAGHwQ ($23.75 in chips) 
Seat 2: BLEU2x2bnGRovIelAY6slA ($26.25 in chips) 
Seat 4: 9lvO/qyU+xrU95Teu1fv0g ($7 in chips) 
Seat 5: sSN8Y0AlsBeidZXPKmwXSw ($25.95 in chips) 
Seat 6: 5yjzPss7Y4kAWNDat3e0yQ ($29.10 in chips) 
Seat 7: OiV1PWZ3IkN29JlmCcnTwQ ($6.20 in chips) 
Seat 8: 9YN2IkT2JYYKFErZtZvCtA ($20 in chips) 
Seat 9: N/O9ADKpmqB2ASZuqgodlw ($5 in chips) 
Z5y2J55JmfLYR6/DPAGHwQ: posts small blind $0.10
BLEU2x2bnGRovIelAY6slA: posts big blind $0.25
*** HOLE CARDS ***
9lvO/qyU+xrU95Teu1fv0g: folds 
sSN8Y0AlsBeidZXPKmwXSw: calls $0.25
5yjzPss7Y4kAWNDat3e0yQ: folds 
OiV1PWZ3IkN29JlmCcnTwQ: folds 
9YN2IkT2JYYKFErZtZvCtA: folds 
N/O9ADKpmqB2ASZuqgodlw: calls $0.25
Z5y2J55JmfLYR6/DPAGHwQ: calls $0.15
BLEU2x2bnGRovIelAY6slA: checks 
*** FLOP *** [Qh 5d 9h]
Z5y2J55JmfLYR6/DPAGHwQ: checks 
BLEU2x2bnGRovIelAY6slA: checks 
sSN8Y0AlsBeidZXPKmwXSw: bets $0.75
N/O9ADKpmqB2ASZuqgodlw: folds 
Z5y2J55JmfLYR6/DPAGHwQ: calls $0.75
BLEU2x2bnGRovIelAY6slA: calls $0.75
*** TURN *** [Qh 5d 9h] [Kh]
Z5y2J55JmfLYR6/DPAGHwQ: checks 
BLEU2x2bnGRovIelAY6slA: checks 
sSN8Y0AlsBeidZXPKmwXSw: checks 
*** RIVER *** [Qh 5d 9h Kh] [2c]
Z5y2J55JmfLYR6/DPAGHwQ: bets $2
BLEU2x2bnGRovIelAY6slA: folds 
sSN8Y0AlsBeidZXPKmwXSw: folds 
Uncalled bet ($2) returned to Z5y2J55JmfLYR6/DPAGHwQ
Z5y2J55JmfLYR6/DPAGHwQ collected $3.10 from pot
Z5y2J55JmfLYR6/DPAGHwQ: doesn't show hand 
*** SUMMARY ***
Total pot $3.25 | Rake $0.15 
Board [Qh 5d 9h Kh 2c]
Seat 1: Z5y2J55JmfLYR6/DPAGHwQ (small blind) collected ($3.10)
Seat 2: BLEU2x2bnGRovIelAY6slA (big blind) folded on the River
Seat 4: 9lvO/qyU+xrU95Teu1fv0g folded before Flop (didn't bet)
Seat 5: sSN8Y0AlsBeidZXPKmwXSw folded on the River
Seat 6: 5yjzPss7Y4kAWNDat3e0yQ folded before Flop (didn't bet)
Seat 7: OiV1PWZ3IkN29JlmCcnTwQ folded before Flop (didn't bet)
Seat 8: 9YN2IkT2JYYKFErZtZvCtA folded before Flop (didn't bet)
Seat 9: N/O9ADKpmqB2ASZuqgodlw (button) folded on the Flop




PokerStars Game #59941670434:  Hold'em No Limit ($0.10/$0.25) - 2009/07/01 1:42:29 ET
Table '4hfTdIVT/qPsJNfWXLsVIw' 9-max Seat #1 is the button
Seat 1: GbHFBbLqLGz0Pwn6CJeAuw ($30.35 in chips) 
Seat 2: Pt637jKksB5MzP0UNJAAkw ($38.45 in chips) 
Seat 3: xnVwSkROfRtOw4eSoDANtw ($7.85 in chips) 
Seat 4: 3PmVnC/15cl4oyI1TKIt4g ($5.85 in chips) 
Seat 5: dtZ84flFEi4Q+SGrHMJRDQ ($25.45 in chips) 
Seat 6: VWUWpMLMj/Q1jRVpF7Aohw ($12.90 in chips) 
Seat 8: 7cv+9Zc9HIQHNvYsMfV3uA ($29 in chips) 
Seat 9: 9njEKzpOKC62MllUFUBWrA ($10.05 in chips) 
Pt637jKksB5MzP0UNJAAkw: posts small blind $0.10
xnVwSkROfRtOw4eSoDANtw: posts big blind $0.25
*** HOLE CARDS ***
3PmVnC/15cl4oyI1TKIt4g: folds 
dtZ84flFEi4Q+SGrHMJRDQ: folds 
VWUWpMLMj/Q1jRVpF7Aohw: folds 
7cv+9Zc9HIQHNvYsMfV3uA: folds 
9njEKzpOKC62MllUFUBWrA: folds 
GbHFBbLqLGz0Pwn6CJeAuw: folds 
Pt637jKksB5MzP0UNJAAkw: calls $0.15
xnVwSkROfRtOw4eSoDANtw: checks 
*** FLOP *** [6s Qd 4c]
Pt637jKksB5MzP0UNJAAkw: checks 
xnVwSkROfRtOw4eSoDANtw: bets $0.25
Pt637jKksB5MzP0UNJAAkw: calls $0.25
*** TURN *** [6s Qd 4c] [Ts]
Pt637jKksB5MzP0UNJAAkw: checks 
xnVwSkROfRtOw4eSoDANtw: checks 
*** RIVER *** [6s Qd 4c Ts] [4s]
Pt637jKksB5MzP0UNJAAkw: checks 
xnVwSkROfRtOw4eSoDANtw: checks 
*** SHOW DOWN ***
Pt637jKksB5MzP0UNJAAkw: shows [5d 3h] (a pair of Fours)
xnVwSkROfRtOw4eSoDANtw: shows [Js 5c] (a pair of Fours - Queen+Jack kicker)
xnVwSkROfRtOw4eSoDANtw collected $0.95 from pot
*** SUMMARY ***
Total pot $1 | Rake $0.05 
Board [6s Qd 4c Ts 4s]
Seat 1: GbHFBbLqLGz0Pwn6CJeAuw (button) folded before Flop (didn't bet)
Seat 2: Pt637jKksB5MzP0UNJAAkw (small blind) showed [5d 3h] and lost with a pair of Fours
Seat 3: xnVwSkROfRtOw4eSoDANtw (big blind) showed [Js 5c] and won ($0.95) with a pair of Fours
Seat 4: 3PmVnC/15cl4oyI1TKIt4g folded before Flop (didn't bet)
Seat 5: dtZ84flFEi4Q+SGrHMJRDQ folded before Flop (didn't bet)
Seat 6: VWUWpMLMj/Q1jRVpF7Aohw folded before Flop (didn't bet)
Seat 8: 7cv+9Zc9HIQHNvYsMfV3uA folded before Flop (didn't bet)
Seat 9: 9njEKzpOKC62MllUFUBWrA folded before Flop (didn't bet)




PokerStars Game #59941670494:  Hold'em No Limit ($0.10/$0.25) - 2009/07/01 1:42:29 ET
Table '1HT8bEDpLPhOXxmqMtzF8w' 9-max Seat #4 is the button
Seat 1: YkkKQUDI0iWatY4h0WWaAQ ($11.20 in chips) 
Seat 2: r6hsffOo1iKmaPYKwAZmFw ($29 in chips) 
Seat 3: oLa/tXLfSLLB28mcLGrxcg ($24.75 in chips) 
Seat 4: aNpwfA31EREwO+ar4XzBCw ($25 in chips) 
Seat 5: CT2YIt3dXaE9eOIkS7FwNw ($24.40 in chips) 
Seat 6: bXpVeaSTPBFSPJmeXxO7nw ($5 in chips) 
Seat 7: PMhmqYBPHOAXjH25lRz69g ($18.30 in chips) 
Seat 8: ghNKXUBl/H+t83JF079ZBA ($32.10 in chips) 
CT2YIt3dXaE9eOIkS7FwNw: posts small blind $0.10
bXpVeaSTPBFSPJmeXxO7nw: posts big blind $0.25
Z9W7+g1WMhhZDi7DwGbCFA: sits out 
*** HOLE CARDS ***
PMhmqYBPHOAXjH25lRz69g: folds 
ghNKXUBl/H+t83JF079ZBA: folds 
YkkKQUDI0iWatY4h0WWaAQ: calls $0.25
r6hsffOo1iKmaPYKwAZmFw: folds 
oLa/tXLfSLLB28mcLGrxcg: folds 
aNpwfA31EREwO+ar4XzBCw: folds 
CT2YIt3dXaE9eOIkS7FwNw: folds 
bXpVeaSTPBFSPJmeXxO7nw: raises $4.75 to $5 and is all-in
YkkKQUDI0iWatY4h0WWaAQ: folds 
Uncalled bet ($4.75) returned to bXpVeaSTPBFSPJmeXxO7nw
bXpVeaSTPBFSPJmeXxO7nw collected $0.60 from pot
bXpVeaSTPBFSPJmeXxO7nw: doesn't show hand 
*** SUMMARY ***
Total pot $0.60 | Rake $0 
Seat 1: YkkKQUDI0iWatY4h0WWaAQ folded before Flop
Seat 2: r6hsffOo1iKmaPYKwAZmFw folded before Flop (didn't bet)
Seat 3: oLa/tXLfSLLB28mcLGrxcg folded before Flop (didn't bet)
Seat 4: aNpwfA31EREwO+ar4XzBCw (button) folded before Flop (didn't bet)
Seat 5: CT2YIt3dXaE9eOIkS7FwNw (small blind) folded before Flop
Seat 6: bXpVeaSTPBFSPJmeXxO7nw (big blind) collected ($0.60)
Seat 7: PMhmqYBPHOAXjH25lRz69g folded before Flop (didn't bet)
Seat 8: ghNKXUBl/H+t83JF079ZBA folded before Flop (didn't bet)




PokerStars Game #59941670438:  Hold'em No Limit ($0.10/$0.25) - 2009/07/01 1:42:29 ET
Table '9lYs7ljXi6AgFAxYHlKLJw' 9-max Seat #1 is the button
Seat 1: K0b5wNInj6hUGRr6yzKFtw ($34.15 in chips) 
Seat 2: 0XACOSNrAWmqNv9k1nF8rw ($18.30 in chips) 
Seat 3: arxNSjreDRGFg13EAM2F1w ($31.30 in chips) 
Seat 4: UANt6y/SmDCY/jIxkBixcw ($33.85 in chips) 
Seat 5: dfNim92Z6XK1/h5SFW5vDg ($52.70 in chips) 
Seat 6: tYsOBqdU1+x+yFI7zHO7hQ ($25.95 in chips) 
Seat 7: ghNKXUBl/H+t83JF079ZBA ($27.05 in chips) 
Seat 8: 9YN2IkT2JYYKFErZtZvCtA ($19.10 in chips) 
Seat 9: cKlmpQMahVsmOaxFQDcoOg ($20 in chips) 
0XACOSNrAWmqNv9k1nF8rw: posts small blind $0.10
arxNSjreDRGFg13EAM2F1w: posts big blind $0.25
*** HOLE CARDS ***
UANt6y/SmDCY/jIxkBixcw: folds 
dfNim92Z6XK1/h5SFW5vDg: folds 
tYsOBqdU1+x+yFI7zHO7hQ: raises $0.75 to $1
ghNKXUBl/H+t83JF079ZBA: folds 
9YN2IkT2JYYKFErZtZvCtA: folds 
cKlmpQMahVsmOaxFQDcoOg: calls $1
K0b5wNInj6hUGRr6yzKFtw: calls $1
0XACOSNrAWmqNv9k1nF8rw: folds 
arxNSjreDRGFg13EAM2F1w: folds 
*** FLOP *** [3c Qs Ad]
tYsOBqdU1+x+yFI7zHO7hQ: checks 
cKlmpQMahVsmOaxFQDcoOg: checks 
K0b5wNInj6hUGRr6yzKFtw: bets $2.50
tYsOBqdU1+x+yFI7zHO7hQ: folds 
cKlmpQMahVsmOaxFQDcoOg: folds 
Uncalled bet ($2.50) returned to K0b5wNInj6hUGRr6yzKFtw
K0b5wNInj6hUGRr6yzKFtw collected $3.20 from pot
K0b5wNInj6hUGRr6yzKFtw: doesn't show hand 
*** SUMMARY ***
Total pot $3.35 | Rake $0.15 
Board [3c Qs Ad]
Seat 1: K0b5wNInj6hUGRr6yzKFtw (button) collected ($3.20)
Seat 2: 0XACOSNrAWmqNv9k1nF8rw (small blind) folded before Flop
Seat 3: arxNSjreDRGFg13EAM2F1w (big blind) folded before Flop
Seat 4: UANt6y/SmDCY/jIxkBixcw folded before Flop (didn't bet)
Seat 5: dfNim92Z6XK1/h5SFW5vDg folded before Flop (didn't bet)
Seat 6: tYsOBqdU1+x+yFI7zHO7hQ folded on the Flop
Seat 7: ghNKXUBl/H+t83JF079ZBA folded before Flop (didn't bet)
Seat 8: 9YN2IkT2JYYKFErZtZvCtA folded before Flop (didn't bet)
Seat 9: cKlmpQMahVsmOaxFQDcoOg folded on the Flop




PokerStars Game #59941670794:  Hold'em No Limit ($0.10/$0.25) - 2009/07/01 1:42:29 ET
Table 'x7YStLKc8hpt/pTgSetPKA' 9-max Seat #9 is the button
Seat 1: tYsOBqdU1+x+yFI7zHO7hQ ($26.35 in chips) 
Seat 2: z5GxcHlYz/GSz6W2uFiTtg ($23.70 in chips) 
Seat 3: S7Ki0P+0AIGPuIfGJjW0gg ($12 in chips) 
Seat 4: ydoFOVgzvZv9ZhuWu9rXAw ($5.25 in chips) 
Seat 5: OiV1PWZ3IkN29JlmCcnTwQ ($6.25 in chips) 
Seat 6: 9YN2IkT2JYYKFErZtZvCtA ($47.70 in chips) 
Seat 7: dtZ84flFEi4Q+SGrHMJRDQ ($26.35 in chips) 
Seat 8: j4q3p0lesp63b1gZDwLBZw ($5 in chips) 
Seat 9: nm4Dj/f+jJEwKVsUnKh73g ($21.55 in chips) 
tYsOBqdU1+x+yFI7zHO7hQ: posts small blind $0.10
z5GxcHlYz/GSz6W2uFiTtg: posts big blind $0.25
*** HOLE CARDS ***
S7Ki0P+0AIGPuIfGJjW0gg: raises $1 to $1.25
ydoFOVgzvZv9ZhuWu9rXAw: folds 
OiV1PWZ3IkN29JlmCcnTwQ: folds 
9YN2IkT2JYYKFErZtZvCtA: folds 
dtZ84flFEi4Q+SGrHMJRDQ: folds 
j4q3p0lesp63b1gZDwLBZw: folds 
nm4Dj/f+jJEwKVsUnKh73g: folds 
tYsOBqdU1+x+yFI7zHO7hQ: folds 
z5GxcHlYz/GSz6W2uFiTtg: folds 
Uncalled bet ($1) returned to S7Ki0P+0AIGPuIfGJjW0gg
S7Ki0P+0AIGPuIfGJjW0gg collected $0.60 from pot
S7Ki0P+0AIGPuIfGJjW0gg: doesn't show hand 
*** SUMMARY ***
Total pot $0.60 | Rake $0 
Seat 1: tYsOBqdU1+x+yFI7zHO7hQ (small blind) folded before Flop
Seat 2: z5GxcHlYz/GSz6W2uFiTtg (big blind) folded before Flop
Seat 3: S7Ki0P+0AIGPuIfGJjW0gg collected ($0.60)
Seat 4: ydoFOVgzvZv9ZhuWu9rXAw folded before Flop (didn't bet)
Seat 5: OiV1PWZ3IkN29JlmCcnTwQ folded before Flop (didn't bet)
Seat 6: 9YN2IkT2JYYKFErZtZvCtA folded before Flop (didn't bet)
Seat 7: dtZ84flFEi4Q+SGrHMJRDQ folded before Flop (didn't bet)
Seat 8: j4q3p0lesp63b1gZDwLBZw folded before Flop (didn't bet)
Seat 9: nm4Dj/f+jJEwKVsUnKh73g (button) folded before Flop (didn't bet)




PokerStars Game #59941670360:  Hold'em No Limit ($0.10/$0.25) - 2009/07/01 1:42:29 ET
Table 'fRxOyfaHXkWUDLv4eSxFew' 9-max Seat #5 is the button
Seat 1: 6RiVTYll/5D8zICp0MRpKw ($29.15 in chips) 
Seat 2: M2QO2DxB5Wawg2h8HSpnYA ($10.35 in chips) 
Seat 3: j4q3p0lesp63b1gZDwLBZw ($5 in chips) 
Seat 4: MtVtHDqIJTyUcXkRBBDIVA ($27.25 in chips) 
Seat 5: dmYlc+1cjwZMJ7wV+Z0rRg ($22.75 in chips) 
Seat 6: arxNSjreDRGFg13EAM2F1w ($27.15 in chips) 
Seat 7: 1/DuWziR8CXhWB71aPQd9Q ($18.15 in chips) 
Seat 8: 5n7e7I+px7c6CQmLpPbtsg ($4.65 in chips) 
Seat 9: H5Se03ZqSX7tbULXur2MAg ($33 in chips) 
arxNSjreDRGFg13EAM2F1w: posts small blind $0.10
1/DuWziR8CXhWB71aPQd9Q: posts big blind $0.25
*** HOLE CARDS ***
5n7e7I+px7c6CQmLpPbtsg: folds 
H5Se03ZqSX7tbULXur2MAg: folds 
6RiVTYll/5D8zICp0MRpKw: folds 
M2QO2DxB5Wawg2h8HSpnYA: folds 
j4q3p0lesp63b1gZDwLBZw: folds 
MtVtHDqIJTyUcXkRBBDIVA: raises $0.75 to $1
dmYlc+1cjwZMJ7wV+Z0rRg: folds 
arxNSjreDRGFg13EAM2F1w: folds 
1/DuWziR8CXhWB71aPQd9Q: folds 
Uncalled bet ($0.75) returned to MtVtHDqIJTyUcXkRBBDIVA
MtVtHDqIJTyUcXkRBBDIVA collected $0.60 from pot
MtVtHDqIJTyUcXkRBBDIVA: doesn't show hand 
*** SUMMARY ***
Total pot $0.60 | Rake $0 
Seat 1: 6RiVTYll/5D8zICp0MRpKw folded before Flop (didn't bet)
Seat 2: M2QO2DxB5Wawg2h8HSpnYA folded before Flop (didn't bet)
Seat 3: j4q3p0lesp63b1gZDwLBZw folded before Flop (didn't bet)
Seat 4: MtVtHDqIJTyUcXkRBBDIVA collected ($0.60)
Seat 5: dmYlc+1cjwZMJ7wV+Z0rRg (button) folded before Flop (didn't bet)
Seat 6: arxNSjreDRGFg13EAM2F1w (small blind) folded before Flop
Seat 7: 1/DuWziR8CXhWB71aPQd9Q (big blind) folded before Flop
Seat 8: 5n7e7I+px7c6CQmLpPbtsg folded before Flop (didn't bet)
Seat 9: H5Se03ZqSX7tbULXur2MAg folded before Flop (didn't bet)




PokerStars Game #59941670338:  Hold'em No Limit ($0.10/$0.25) - 2009/07/01 1:42:29 ET
Table '5VWnrlxdjwVfMWkVS2WE7A' 6-max Seat #2 is the button
Seat 1: 82p+w3EmUaFFHuwpSeGY1w ($12.50 in chips) 
Seat 2: LJI7A1YgDM7hgh7o56+ReQ ($26 in chips) 
Seat 3: SFmT9ZsVopnukjvAzrxTRg ($36.05 in chips) 
Seat 4: Pb/gJ3OxOZx57fFp0MDgkg ($35.35 in chips) 
Seat 5: SgMFmwYtNvq9Y+2ZxPSiWQ ($21.10 in chips) 
Seat 6: LtASJ9OlkqGrrUKGQlpGAw ($5.60 in chips) 
SFmT9ZsVopnukjvAzrxTRg: posts small blind $0.10
Pb/gJ3OxOZx57fFp0MDgkg: posts big blind $0.25
*** HOLE CARDS ***
SgMFmwYtNvq9Y+2ZxPSiWQ: folds 
LtASJ9OlkqGrrUKGQlpGAw: folds 
82p+w3EmUaFFHuwpSeGY1w: folds 
LJI7A1YgDM7hgh7o56+ReQ: folds 
SFmT9ZsVopnukjvAzrxTRg: folds 
Uncalled bet ($0.15) returned to Pb/gJ3OxOZx57fFp0MDgkg
Pb/gJ3OxOZx57fFp0MDgkg collected $0.20 from pot
*** SUMMARY ***
Total pot $0.20 | Rake $0 
Seat 1: 82p+w3EmUaFFHuwpSeGY1w folded before Flop (didn't bet)
Seat 2: LJI7A1YgDM7hgh7o56+ReQ (button) folded before Flop (didn't bet)
Seat 3: SFmT9ZsVopnukjvAzrxTRg (small blind) folded before Flop
Seat 4: Pb/gJ3OxOZx57fFp0MDgkg (big blind) collected ($0.20)
Seat 5: SgMFmwYtNvq9Y+2ZxPSiWQ folded before Flop (didn't bet)
Seat 6: LtASJ9OlkqGrrUKGQlpGAw folded before Flop (didn't bet)




PokerStars Game #59941671168:  Hold'em No Limit ($0.10/$0.25) - 2009/07/01 1:42:30 ET
Table 'dZNBGqFYSwfOVZvDJ4VjIQ' 6-max Seat #2 is the button
Seat 1: v+QfkGiuj9bgtuNoVnDO8w ($33.20 in chips) 
Seat 2: 3zD3qLXT1bEffAoWGnc7wg ($25 in chips) 
Seat 3: kyRaCIljYA6l33lSKQfNsg ($28.40 in chips) 
Seat 4: mFv3iBCtrw9XfCDRB0d46Q ($6.15 in chips) 
Seat 5: +ZlnqPoP3Hg4BIUxDfKd/A ($36.50 in chips) 
Seat 6: ypmjhffk/YHGc51wgVXUTw ($30.75 in chips) 
kyRaCIljYA6l33lSKQfNsg: posts small blind $0.10
mFv3iBCtrw9XfCDRB0d46Q: posts big blind $0.25
*** HOLE CARDS ***
+ZlnqPoP3Hg4BIUxDfKd/A: folds 
ypmjhffk/YHGc51wgVXUTw: folds 
v+QfkGiuj9bgtuNoVnDO8w: folds 
3zD3qLXT1bEffAoWGnc7wg: folds 
kyRaCIljYA6l33lSKQfNsg: folds 
Uncalled bet ($0.15) returned to mFv3iBCtrw9XfCDRB0d46Q
mFv3iBCtrw9XfCDRB0d46Q collected $0.20 from pot
mFv3iBCtrw9XfCDRB0d46Q: doesn't show hand 
*** SUMMARY ***
Total pot $0.20 | Rake $0 
Seat 1: v+QfkGiuj9bgtuNoVnDO8w folded before Flop (didn't bet)
Seat 2: 3zD3qLXT1bEffAoWGnc7wg (button) folded before Flop (didn't bet)
Seat 3: kyRaCIljYA6l33lSKQfNsg (small blind) folded before Flop
Seat 4: mFv3iBCtrw9XfCDRB0d46Q (big blind) collected ($0.20)
Seat 5: +ZlnqPoP3Hg4BIUxDfKd/A folded before Flop (didn't bet)
Seat 6: ypmjhffk/YHGc51wgVXUTw folded before Flop (didn't bet)




PokerStars Game #59941670984:  Hold'em No Limit ($0.10/$0.25) - 2009/07/01 1:42:30 ET
Table 'hOE09W281uSob0XeJmUcRg' 6-max Seat #5 is the button
Seat 1: mfrkWA3PTeYPkbO6hi98Aw ($27.65 in chips) 
Seat 2: lYjWCpfCxX2kgcHY3v4Yow ($28.85 in chips) 
Seat 3: y+a/yGW/Jy4bPJFnaeTz5w ($14.10 in chips) 
Seat 5: JFIAqU8lCZ0vWwEl4bdGsg ($25 in chips) 
Seat 6: x4ZJ8E/TUrtoB7WiHcv8WA ($14 in chips) 
x4ZJ8E/TUrtoB7WiHcv8WA: posts small blind $0.10
mfrkWA3PTeYPkbO6hi98Aw: posts big blind $0.25
*** HOLE CARDS ***
lYjWCpfCxX2kgcHY3v4Yow: folds 
y+a/yGW/Jy4bPJFnaeTz5w: folds 
JFIAqU8lCZ0vWwEl4bdGsg: raises $0.60 to $0.85
x4ZJ8E/TUrtoB7WiHcv8WA: folds 
mfrkWA3PTeYPkbO6hi98Aw: folds 
Uncalled bet ($0.60) returned to JFIAqU8lCZ0vWwEl4bdGsg
JFIAqU8lCZ0vWwEl4bdGsg collected $0.60 from pot
JFIAqU8lCZ0vWwEl4bdGsg: doesn't show hand 
*** SUMMARY ***
Total pot $0.60 | Rake $0 
Seat 1: mfrkWA3PTeYPkbO6hi98Aw (big blind) folded before Flop
Seat 2: lYjWCpfCxX2kgcHY3v4Yow folded before Flop (didn't bet)
Seat 3: y+a/yGW/Jy4bPJFnaeTz5w folded before Flop (didn't bet)
Seat 5: JFIAqU8lCZ0vWwEl4bdGsg (button) collected ($0.60)
Seat 6: x4ZJ8E/TUrtoB7WiHcv8WA (small blind) folded before Flop




PokerStars Game #59941671120:  Hold'em No Limit ($0.10/$0.25) - 2009/07/01 1:42:30 ET
Table 'AchTjdLS1zBUbH3ZIx6f0w' 6-max Seat #2 is the button
Seat 1: rZ0bUtoerhFGDUSRQMnFog ($28 in chips) 
Seat 2: kG34n23qFQA3nzdOJTQ1dA ($65.90 in chips) 
Seat 3: k9vn40MOqqb+xF+7GZ6v2g ($28.75 in chips) 
Seat 4: q6WfTUAD9mowIP63ASq2Dg ($30.90 in chips) 
Seat 5: 0av6tRNdi0Ui4f15L7gsVg ($26.35 in chips) 
k9vn40MOqqb+xF+7GZ6v2g: posts small blind $0.10
q6WfTUAD9mowIP63ASq2Dg: posts big blind $0.25
epAUIB7h2FJXzUPRIvSkRA: sits out 
*** HOLE CARDS ***
0av6tRNdi0Ui4f15L7gsVg: folds 
rZ0bUtoerhFGDUSRQMnFog: folds 
kG34n23qFQA3nzdOJTQ1dA: calls $0.25
k9vn40MOqqb+xF+7GZ6v2g: folds 
q6WfTUAD9mowIP63ASq2Dg: checks 
*** FLOP *** [2d 3d 2s]
q6WfTUAD9mowIP63ASq2Dg: checks 
kG34n23qFQA3nzdOJTQ1dA: bets $0.50
q6WfTUAD9mowIP63ASq2Dg: folds 
Uncalled bet ($0.50) returned to kG34n23qFQA3nzdOJTQ1dA
kG34n23qFQA3nzdOJTQ1dA collected $0.60 from pot
*** SUMMARY ***
Total pot $0.60 | Rake $0 
Board [2d 3d 2s]
Seat 1: rZ0bUtoerhFGDUSRQMnFog folded before Flop (didn't bet)
Seat 2: kG34n23qFQA3nzdOJTQ1dA (button) collected ($0.60)
Seat 3: k9vn40MOqqb+xF+7GZ6v2g (small blind) folded before Flop
Seat 4: q6WfTUAD9mowIP63ASq2Dg (big blind) folded on the Flop
Seat 5: 0av6tRNdi0Ui4f15L7gsVg folded before Flop (didn't bet)




PokerStars Game #59941671716:  Hold'em No Limit ($0.10/$0.25) - 2009/07/01 1:42:31 ET
Table '3760QYRYyCWeXf0rLZ5S2g' 9-max Seat #1 is the button
Seat 1: CT7Xj/V/O5rBlhtt+RZeFQ ($27.90 in chips) 
Seat 3: X78b5v/uhqeXXoAijbw/yg ($25.35 in chips) 
Seat 4: ziFpkH3wCzqB/qXeq/Hy7g ($25 in chips) 
Seat 5: Bb42QRQMhg5/Y0vHP8/2Xw ($28.70 in chips) 
Seat 6: q+Qdg0Hoir+SyL7haBrUnw ($13.40 in chips) 
Seat 7: 6C2DoQ+GZHBOpb+qyrSnqA ($5.75 in chips) 
Seat 8: pB8IyCfDFZaVpov3NHEVJg ($24.30 in chips) 
Seat 9: sGFnnRCa1YAHAUmWgsW6Qg ($5.95 in chips) 
X78b5v/uhqeXXoAijbw/yg: posts small blind $0.10
ziFpkH3wCzqB/qXeq/Hy7g: posts big blind $0.25
*** HOLE CARDS ***
Bb42QRQMhg5/Y0vHP8/2Xw: raises $0.75 to $1
q+Qdg0Hoir+SyL7haBrUnw: folds 
6C2DoQ+GZHBOpb+qyrSnqA: folds 
pB8IyCfDFZaVpov3NHEVJg: folds 
sGFnnRCa1YAHAUmWgsW6Qg: folds 
CT7Xj/V/O5rBlhtt+RZeFQ: folds 
X78b5v/uhqeXXoAijbw/yg: folds 
ziFpkH3wCzqB/qXeq/Hy7g: folds 
Uncalled bet ($0.75) returned to Bb42QRQMhg5/Y0vHP8/2Xw
Bb42QRQMhg5/Y0vHP8/2Xw collected $0.60 from pot
*** SUMMARY ***
Total pot $0.60 | Rake $0 
Seat 1: CT7Xj/V/O5rBlhtt+RZeFQ (button) folded before Flop (didn't bet)
Seat 3: X78b5v/uhqeXXoAijbw/yg (small blind) folded before Flop
Seat 4: ziFpkH3wCzqB/qXeq/Hy7g (big blind) folded before Flop
Seat 5: Bb42QRQMhg5/Y0vHP8/2Xw collected ($0.60)
Seat 6: q+Qdg0Hoir+SyL7haBrUnw folded before Flop (didn't bet)
Seat 7: 6C2DoQ+GZHBOpb+qyrSnqA folded before Flop (didn't bet)
Seat 8: pB8IyCfDFZaVpov3NHEVJg folded before Flop (didn't bet)
Seat 9: sGFnnRCa1YAHAUmWgsW6Qg folded before Flop (didn't bet)




PokerStars Game #59941671824:  Hold'em No Limit ($0.10/$0.25) - 2009/07/01 1:42:31 ET
Table 'z2yOdY2zyGWG1gh9WV9XtQ' 9-max Seat #1 is the button
Seat 1: 7je+LC5Mfs6nL8YBVh4frQ ($4.65 in chips) 
Seat 2: bXpVeaSTPBFSPJmeXxO7nw ($4.75 in chips) 
Seat 3: X78b5v/uhqeXXoAijbw/yg ($27.75 in chips) 
Seat 4: 4awUyiDYTgylQKXZ9faBVA ($39.80 in chips) 
Seat 5: W6tExOcYX7qiy6Qdp+ZwFA ($10.55 in chips) 
Seat 6: NBYmTySMtIicyMj5Vjzqhw ($21.80 in chips) 
Seat 8: Mh2r9hTeTEDnh19sRZtW3g ($7.50 in chips) 
Seat 9: wGigCmBR/9XWkPpvYos3aQ ($34.05 in chips) 
bXpVeaSTPBFSPJmeXxO7nw: posts small blind $0.10
X78b5v/uhqeXXoAijbw/yg: posts big blind $0.25
*** HOLE CARDS ***
4awUyiDYTgylQKXZ9faBVA: folds 
W6tExOcYX7qiy6Qdp+ZwFA: folds 
NBYmTySMtIicyMj5Vjzqhw: folds 
Mh2r9hTeTEDnh19sRZtW3g: folds 
wGigCmBR/9XWkPpvYos3aQ: raises $0.65 to $0.90
7je+LC5Mfs6nL8YBVh4frQ: folds 
bXpVeaSTPBFSPJmeXxO7nw: folds 
X78b5v/uhqeXXoAijbw/yg: folds 
Uncalled bet ($0.65) returned to wGigCmBR/9XWkPpvYos3aQ
wGigCmBR/9XWkPpvYos3aQ collected $0.60 from pot
wGigCmBR/9XWkPpvYos3aQ: doesn't show hand 
*** SUMMARY ***
Total pot $0.60 | Rake $0 
Seat 1: 7je+LC5Mfs6nL8YBVh4frQ (button) folded before Flop (didn't bet)
Seat 2: bXpVeaSTPBFSPJmeXxO7nw (small blind) folded before Flop
Seat 3: X78b5v/uhqeXXoAijbw/yg (big blind) folded before Flop
Seat 4: 4awUyiDYTgylQKXZ9faBVA folded before Flop (didn't bet)
Seat 5: W6tExOcYX7qiy6Qdp+ZwFA folded before Flop (didn't bet)
Seat 6: NBYmTySMtIicyMj5Vjzqhw folded before Flop (didn't bet)
Seat 8: Mh2r9hTeTEDnh19sRZtW3g folded before Flop (didn't bet)
Seat 9: wGigCmBR/9XWkPpvYos3aQ collected ($0.60)




PokerStars Game #59941671770:  Hold'em No Limit ($0.10/$0.25) - 2009/07/01 1:42:31 ET
Table 'nc6OeGk/wtaWV+6N+kgnZQ' 6-max Seat #6 is the button
Seat 1: tSR4329m40dZsN7YOpI9Kw ($38.90 in chips) 
Seat 2: 8ClCHtFXGNplITm+63KB+Q ($35.10 in chips) 
Seat 3: y8wpMWGSX2zHZijurx21mg ($6.60 in chips) 
Seat 4: 3zD3qLXT1bEffAoWGnc7wg ($29.95 in chips) 
Seat 5: HCS0lMAAPmZE2Tl8J/SuKw ($11.45 in chips) 
Seat 6: mFv3iBCtrw9XfCDRB0d46Q ($3.20 in chips) 
tSR4329m40dZsN7YOpI9Kw: posts small blind $0.10
8ClCHtFXGNplITm+63KB+Q: posts big blind $0.25
*** HOLE CARDS ***
y8wpMWGSX2zHZijurx21mg: folds 
3zD3qLXT1bEffAoWGnc7wg: folds 
HCS0lMAAPmZE2Tl8J/SuKw: folds 
mFv3iBCtrw9XfCDRB0d46Q: raises $2.95 to $3.20 and is all-in
tSR4329m40dZsN7YOpI9Kw: folds 
8ClCHtFXGNplITm+63KB+Q: folds 
Uncalled bet ($2.95) returned to mFv3iBCtrw9XfCDRB0d46Q
mFv3iBCtrw9XfCDRB0d46Q collected $0.60 from pot
mFv3iBCtrw9XfCDRB0d46Q: doesn't show hand 
*** SUMMARY ***
Total pot $0.60 | Rake $0 
Seat 1: tSR4329m40dZsN7YOpI9Kw (small blind) folded before Flop
Seat 2: 8ClCHtFXGNplITm+63KB+Q (big blind) folded before Flop
Seat 3: y8wpMWGSX2zHZijurx21mg folded before Flop (didn't bet)
Seat 4: 3zD3qLXT1bEffAoWGnc7wg folded before Flop (didn't bet)
Seat 5: HCS0lMAAPmZE2Tl8J/SuKw folded before Flop (didn't bet)
Seat 6: mFv3iBCtrw9XfCDRB0d46Q (button) collected ($0.60)




PokerStars Game #59941671678:  Hold'em No Limit ($0.10/$0.25) - 2009/07/01 1:42:31 ET
Table 'NtCSSONEf1zaJo3042tQug' 6-max Seat #4 is the button
Seat 1: KXtdqb+rIMkjc0RvHDksGQ ($35.45 in chips) 
Seat 2: vqWjZmdQu/Hxw96/IJTWdQ ($27.30 in chips) 
Seat 3: 9kUKGKkblnIx3m8rlVol6Q ($15.65 in chips) 
Seat 4: HxD1kB8zCmalQSdWAkKmlg ($28.85 in chips) 
Seat 5: tOAk1Og4mVObMBOfvdDYOw ($27.90 in chips) 
Seat 6: LxehwDpTQ19ph4Qmc78+Pw ($31.50 in chips) 
tOAk1Og4mVObMBOfvdDYOw: posts small blind $0.10
LxehwDpTQ19ph4Qmc78+Pw: posts big blind $0.25
*** HOLE CARDS ***
KXtdqb+rIMkjc0RvHDksGQ: folds 
vqWjZmdQu/Hxw96/IJTWdQ: folds 
9kUKGKkblnIx3m8rlVol6Q: folds 
HxD1kB8zCmalQSdWAkKmlg: folds 
tOAk1Og4mVObMBOfvdDYOw: raises $0.75 to $1
LxehwDpTQ19ph4Qmc78+Pw: calls $0.75
*** FLOP *** [4h 8c 9s]
tOAk1Og4mVObMBOfvdDYOw: bets $1.75
LxehwDpTQ19ph4Qmc78+Pw: calls $1.75
*** TURN *** [4h 8c 9s] [6c]
tOAk1Og4mVObMBOfvdDYOw: bets $3.50
LxehwDpTQ19ph4Qmc78+Pw: folds 
Uncalled bet ($3.50) returned to tOAk1Og4mVObMBOfvdDYOw
tOAk1Og4mVObMBOfvdDYOw collected $5.25 from pot
tOAk1Og4mVObMBOfvdDYOw: doesn't show hand 
*** SUMMARY ***
Total pot $5.50 | Rake $0.25 
Board [4h 8c 9s 6c]
Seat 1: KXtdqb+rIMkjc0RvHDksGQ folded before Flop (didn't bet)
Seat 2: vqWjZmdQu/Hxw96/IJTWdQ folded before Flop (didn't bet)
Seat 3: 9kUKGKkblnIx3m8rlVol6Q folded before Flop (didn't bet)
Seat 4: HxD1kB8zCmalQSdWAkKmlg (button) folded before Flop (didn't bet)
Seat 5: tOAk1Og4mVObMBOfvdDYOw (small blind) collected ($5.25)
Seat 6: LxehwDpTQ19ph4Qmc78+Pw (big blind) folded on the Turn




PokerStars Game #59941671772:  Hold'em No Limit ($0.10/$0.25) - 2009/07/01 1:42:31 ET
Table 'KYX9dFNuOA9l2PV46IebqQ' 9-max Seat #5 is the button
Seat 2: z2SmIaQ3+5n/eY1BN5HgPg ($6.65 in chips) 
Seat 4: rPXwQUVloUl+qZm3CCtaJw ($8 in chips) 
Seat 5: g7MXhRmNZxv1lIkKkUKa4w ($14.35 in chips) 
KRWTiGM4xH+MkvPtJz4+SA will be allowed to play after the button
z2SmIaQ3+5n/eY1BN5HgPg: posts small blind $0.10
rPXwQUVloUl+qZm3CCtaJw: posts big blind $0.25
*** HOLE CARDS ***
g7MXhRmNZxv1lIkKkUKa4w: calls $0.25
z2SmIaQ3+5n/eY1BN5HgPg: calls $0.15
rPXwQUVloUl+qZm3CCtaJw: raises $0.50 to $0.75
g7MXhRmNZxv1lIkKkUKa4w: calls $0.50
z2SmIaQ3+5n/eY1BN5HgPg: calls $0.50
*** FLOP *** [Ad 3h 3d]
z2SmIaQ3+5n/eY1BN5HgPg: checks 
rPXwQUVloUl+qZm3CCtaJw: bets $0.75
g7MXhRmNZxv1lIkKkUKa4w: folds 
z2SmIaQ3+5n/eY1BN5HgPg: folds 
Uncalled bet ($0.75) returned to rPXwQUVloUl+qZm3CCtaJw
rPXwQUVloUl+qZm3CCtaJw collected $2.15 from pot
*** SUMMARY ***
Total pot $2.25 | Rake $0.10 
Board [Ad 3h 3d]
Seat 2: z2SmIaQ3+5n/eY1BN5HgPg (small blind) folded on the Flop
Seat 4: rPXwQUVloUl+qZm3CCtaJw (big blind) collected ($2.15)
Seat 5: g7MXhRmNZxv1lIkKkUKa4w (button) folded on the Flop




PokerStars Game #59941672056:  Hold'em No Limit ($0.10/$0.25) - 2009/07/01 1:42:32 ET
Table '63uh7ZsO7Tnt+E8b/2bu3A' 6-max Seat #4 is the button
Seat 1: 0av6tRNdi0Ui4f15L7gsVg ($30.90 in chips) 
Seat 2: SFmT9ZsVopnukjvAzrxTRg ($30.95 in chips) 
Seat 3: yVP7GLZBzx47OPi6jzUxMw ($14.35 in chips) 
Seat 4: 2tYgzzRRW/D2GWb2A7f1jw ($6.60 in chips) 
Seat 5: GbCVUNssQ7mqsPWr7J4d3w ($4.50 in chips) 
Seat 6: qGHGf/553gQnDoklMRe3tg ($29 in chips) 
GbCVUNssQ7mqsPWr7J4d3w: posts small blind $0.10
qGHGf/553gQnDoklMRe3tg: posts big blind $0.25
*** HOLE CARDS ***
0av6tRNdi0Ui4f15L7gsVg has timed out
0av6tRNdi0Ui4f15L7gsVg: folds 
0av6tRNdi0Ui4f15L7gsVg is sitting out
SFmT9ZsVopnukjvAzrxTRg: raises $0.75 to $1
yVP7GLZBzx47OPi6jzUxMw: raises $1.25 to $2.25
2tYgzzRRW/D2GWb2A7f1jw: calls $2.25
GbCVUNssQ7mqsPWr7J4d3w: folds 
qGHGf/553gQnDoklMRe3tg: folds 
SFmT9ZsVopnukjvAzrxTRg: calls $1.25
*** FLOP *** [6h 4d 4s]
SFmT9ZsVopnukjvAzrxTRg: checks 
yVP7GLZBzx47OPi6jzUxMw: bets $2.50
2tYgzzRRW/D2GWb2A7f1jw: raises $1.85 to $4.35 and is all-in
SFmT9ZsVopnukjvAzrxTRg: folds 
0av6tRNdi0Ui4f15L7gsVg has returned
yVP7GLZBzx47OPi6jzUxMw: calls $1.85
*** TURN *** [6h 4d 4s] [2d]
*** RIVER *** [6h 4d 4s 2d] [5c]
*** SHOW DOWN ***
yVP7GLZBzx47OPi6jzUxMw: shows [Jh Jd] (two pair, Jacks and Fours)
2tYgzzRRW/D2GWb2A7f1jw: shows [Qh Qs] (two pair, Queens and Fours)
2tYgzzRRW/D2GWb2A7f1jw collected $15.05 from pot
*** SUMMARY ***
Total pot $15.80 | Rake $0.75 
Board [6h 4d 4s 2d 5c]
Seat 1: 0av6tRNdi0Ui4f15L7gsVg folded before Flop (didn't bet)
Seat 2: SFmT9ZsVopnukjvAzrxTRg folded on the Flop
Seat 3: yVP7GLZBzx47OPi6jzUxMw showed [Jh Jd] and lost with two pair, Jacks and Fours
Seat 4: 2tYgzzRRW/D2GWb2A7f1jw (button) showed [Qh Qs] and won ($15.05) with two pair, Queens and Fours
Seat 5: GbCVUNssQ7mqsPWr7J4d3w (small blind) folded before Flop
Seat 6: qGHGf/553gQnDoklMRe3tg (big blind) folded before Flop




PokerStars Game #59941672448:  Hold'em No Limit ($0.10/$0.25) - 2009/07/01 1:42:32 ET
Table 'FE/j6VqBY4j9Uq+VHURQCQ' 6-max Seat #2 is the button
Seat 1: ypmjhffk/YHGc51wgVXUTw ($41.45 in chips) 
Seat 2: 3zD3qLXT1bEffAoWGnc7wg ($39.75 in chips) 
Seat 3: lBoEwOFgzcERLIRUkUoRTw ($27.45 in chips) 
Seat 4: 7JyPCA0J2grhXQYxe1h3+A ($22.40 in chips) 
Seat 5: 4x9jCqgSw4272dnaIqnanw ($7.20 in chips) 
Seat 6: rpJ2ie+vculq8yrHlngRHQ ($19.20 in chips) 
lBoEwOFgzcERLIRUkUoRTw: posts small blind $0.10
7JyPCA0J2grhXQYxe1h3+A: posts big blind $0.25
*** HOLE CARDS ***
4x9jCqgSw4272dnaIqnanw: folds 
rpJ2ie+vculq8yrHlngRHQ: raises $1.75 to $2
ypmjhffk/YHGc51wgVXUTw: folds 
3zD3qLXT1bEffAoWGnc7wg: folds 
lBoEwOFgzcERLIRUkUoRTw: folds 
7JyPCA0J2grhXQYxe1h3+A: folds 
Uncalled bet ($1.75) returned to rpJ2ie+vculq8yrHlngRHQ
rpJ2ie+vculq8yrHlngRHQ collected $0.60 from pot
*** SUMMARY ***
Total pot $0.60 | Rake $0 
Seat 1: ypmjhffk/YHGc51wgVXUTw folded before Flop (didn't bet)
Seat 2: 3zD3qLXT1bEffAoWGnc7wg (button) folded before Flop (didn't bet)
Seat 3: lBoEwOFgzcERLIRUkUoRTw (small blind) folded before Flop
Seat 4: 7JyPCA0J2grhXQYxe1h3+A (big blind) folded before Flop
Seat 5: 4x9jCqgSw4272dnaIqnanw folded before Flop (didn't bet)
Seat 6: rpJ2ie+vculq8yrHlngRHQ collected ($0.60)




PokerStars Game #59941672446:  Hold'em No Limit ($0.10/$0.25) - 2009/07/01 1:42:32 ET
Table 'Jj2eLzVCUVAGBmM+Og79iQ' 9-max Seat #8 is the button
Seat 2: oMxwMC7+uAsJudeUN6aP0A ($14.30 in chips) 
Seat 3: HPEB+AtKw1+C/cxU0o1ciw ($25 in chips) 
Seat 4: aNpwfA31EREwO+ar4XzBCw ($45.25 in chips) 
Seat 5: UOx+/JnFB2Or6ZU9oasIlQ ($22.25 in chips) 
Seat 6: jZURAM/dgGCX+5lATlZugw ($14.55 in chips) 
Seat 7: K0b5wNInj6hUGRr6yzKFtw ($59.50 in chips) 
Seat 8: H5Se03ZqSX7tbULXur2MAg ($20.60 in chips) 
Seat 9: wU1LtrccnZo6PYKhlJ6ElQ ($3.05 in chips) 
wU1LtrccnZo6PYKhlJ6ElQ: posts small blind $0.10
branloo: is sitting out 
oMxwMC7+uAsJudeUN6aP0A: posts big blind $0.25
*** HOLE CARDS ***
HPEB+AtKw1+C/cxU0o1ciw: folds 
aNpwfA31EREwO+ar4XzBCw: folds 
UOx+/JnFB2Or6ZU9oasIlQ: calls $0.25
jZURAM/dgGCX+5lATlZugw: folds 
K0b5wNInj6hUGRr6yzKFtw: folds 
H5Se03ZqSX7tbULXur2MAg: folds 
wU1LtrccnZo6PYKhlJ6ElQ: folds 
oMxwMC7+uAsJudeUN6aP0A: checks 
*** FLOP *** [Tc 2c Ah]
oMxwMC7+uAsJudeUN6aP0A: bets $0.50
UOx+/JnFB2Or6ZU9oasIlQ: folds 
Uncalled bet ($0.50) returned to oMxwMC7+uAsJudeUN6aP0A
oMxwMC7+uAsJudeUN6aP0A collected $0.60 from pot
oMxwMC7+uAsJudeUN6aP0A: doesn't show hand 
*** SUMMARY ***
Total pot $0.60 | Rake $0 
Board [Tc 2c Ah]
Seat 2: oMxwMC7+uAsJudeUN6aP0A (big blind) collected ($0.60)
Seat 3: HPEB+AtKw1+C/cxU0o1ciw folded before Flop (didn't bet)
Seat 4: aNpwfA31EREwO+ar4XzBCw folded before Flop (didn't bet)
Seat 5: UOx+/JnFB2Or6ZU9oasIlQ folded on the Flop
Seat 6: jZURAM/dgGCX+5lATlZugw folded before Flop (didn't bet)
Seat 7: K0b5wNInj6hUGRr6yzKFtw folded before Flop (didn't bet)
Seat 8: H5Se03ZqSX7tbULXur2MAg (button) folded before Flop (didn't bet)
Seat 9: wU1LtrccnZo6PYKhlJ6ElQ (small blind) folded before Flop




PokerStars Game #59941672122:  Hold'em No Limit ($0.10/$0.25) - 2009/07/01 1:42:32 ET
Table 'GgmUtmhrYPRnhkqEEjD/Kw' 9-max Seat #2 is the button
Seat 2: ghNKXUBl/H+t83JF079ZBA ($25.15 in chips) 
Seat 3: dYvYZ723QlKIPiDa0pkedQ ($7.40 in chips) 
Seat 4: dfNim92Z6XK1/h5SFW5vDg ($25 in chips) 
Seat 5: ljemhp25Zg+nlA9DLCIiUw ($27 in chips) 
Seat 6: 4Ax0vobe1rLVIGZmkFINGA ($20.50 in chips) 
Seat 7: YwDw9cMqkbMznFK77rru4A ($5.15 in chips) 
Seat 8: DdPXdieucQ+n99u1n3A+rQ ($4.65 in chips) 
Seat 9: V6p0jQ/RhUsqpHLmXvEX4Q ($13.95 in chips) 
dYvYZ723QlKIPiDa0pkedQ: posts small blind $0.10
dfNim92Z6XK1/h5SFW5vDg: posts big blind $0.25
bXpVeaSTPBFSPJmeXxO7nw: sits out 
*** HOLE CARDS ***
ljemhp25Zg+nlA9DLCIiUw: folds 
4Ax0vobe1rLVIGZmkFINGA: calls $0.25
YwDw9cMqkbMznFK77rru4A: folds 
DdPXdieucQ+n99u1n3A+rQ: folds 
V6p0jQ/RhUsqpHLmXvEX4Q: folds 
ghNKXUBl/H+t83JF079ZBA: folds 
dYvYZ723QlKIPiDa0pkedQ: calls $0.15
dfNim92Z6XK1/h5SFW5vDg: checks 
*** FLOP *** [6s 6c 8d]
dYvYZ723QlKIPiDa0pkedQ: bets $0.50
dfNim92Z6XK1/h5SFW5vDg: folds 
4Ax0vobe1rLVIGZmkFINGA: folds 
Uncalled bet ($0.50) returned to dYvYZ723QlKIPiDa0pkedQ
dYvYZ723QlKIPiDa0pkedQ collected $0.75 from pot
dYvYZ723QlKIPiDa0pkedQ: doesn't show hand 
*** SUMMARY ***
Total pot $0.75 | Rake $0 
Board [6s 6c 8d]
Seat 2: ghNKXUBl/H+t83JF079ZBA (button) folded before Flop (didn't bet)
Seat 3: dYvYZ723QlKIPiDa0pkedQ (small blind) collected ($0.75)
Seat 4: dfNim92Z6XK1/h5SFW5vDg (big blind) folded on the Flop
Seat 5: ljemhp25Zg+nlA9DLCIiUw folded before Flop (didn't bet)
Seat 6: 4Ax0vobe1rLVIGZmkFINGA folded on the Flop
Seat 7: YwDw9cMqkbMznFK77rru4A folded before Flop (didn't bet)
Seat 8: DdPXdieucQ+n99u1n3A+rQ folded before Flop (didn't bet)
Seat 9: V6p0jQ/RhUsqpHLmXvEX4Q folded before Flop (didn't bet)




PokerStars Game #59941672466:  Hold'em No Limit ($0.10/$0.25) - 2009/07/01 1:42:32 ET
Table 'sSe6q4YTb/iS19t2eCFdsA' 9-max Seat #8 is the button
Seat 1: hJ4uYjNmSZdjrKA8cjZqCA ($19.50 in chips) 
Seat 3: bXpVeaSTPBFSPJmeXxO7nw ($5.65 in chips) 
Seat 4: 22dIObOuor/A+IKWkNoAlA ($8.85 in chips) 
Seat 5: qS+jfnNoG75bT+uQ8CKhQA ($10.05 in chips) 
Seat 6: tYsOBqdU1+x+yFI7zHO7hQ ($28.35 in chips) 
Seat 7: t70KGeRtR3naHSqKDixsUg ($4 in chips) 
Seat 8: hvXZ0zFPZFP8Hf6dS36YEw ($14.05 in chips) 
Seat 9: Z9W7+g1WMhhZDi7DwGbCFA ($5 in chips) 
Z9W7+g1WMhhZDi7DwGbCFA: posts small blind $0.10
hJ4uYjNmSZdjrKA8cjZqCA: posts big blind $0.25
3l+i+xMeyDndSXMF2A5CDA: sits out 
*** HOLE CARDS ***
bXpVeaSTPBFSPJmeXxO7nw: folds 
22dIObOuor/A+IKWkNoAlA: folds 
qS+jfnNoG75bT+uQ8CKhQA: folds 
tYsOBqdU1+x+yFI7zHO7hQ: raises $0.75 to $1
t70KGeRtR3naHSqKDixsUg: folds 
hvXZ0zFPZFP8Hf6dS36YEw: raises $6.25 to $7.25
Z9W7+g1WMhhZDi7DwGbCFA: folds 
hJ4uYjNmSZdjrKA8cjZqCA: folds 
tYsOBqdU1+x+yFI7zHO7hQ: folds 
Uncalled bet ($6.25) returned to hvXZ0zFPZFP8Hf6dS36YEw
hvXZ0zFPZFP8Hf6dS36YEw collected $2.35 from pot
*** SUMMARY ***
Total pot $2.35 | Rake $0 
Seat 1: hJ4uYjNmSZdjrKA8cjZqCA (big blind) folded before Flop
Seat 3: bXpVeaSTPBFSPJmeXxO7nw folded before Flop (didn't bet)
Seat 4: 22dIObOuor/A+IKWkNoAlA folded before Flop (didn't bet)
Seat 5: qS+jfnNoG75bT+uQ8CKhQA folded before Flop (didn't bet)
Seat 6: tYsOBqdU1+x+yFI7zHO7hQ folded before Flop
Seat 7: t70KGeRtR3naHSqKDixsUg folded before Flop (didn't bet)
Seat 8: hvXZ0zFPZFP8Hf6dS36YEw (button) collected ($2.35)
Seat 9: Z9W7+g1WMhhZDi7DwGbCFA (small blind) folded before Flop




PokerStars Game #59941672018:  Hold'em No Limit ($0.10/$0.25) - 2009/07/01 1:42:32 ET
Table 'zKwHJD0cmKNUure9qQTfFg' 6-max Seat #4 is the button
Seat 2: xrf8tAXKQHG99HixCot1Iw ($26.55 in chips) 
Seat 3: 60PLIlpucQhA08L3YbNmag ($14.15 in chips) 
Seat 4: v+QfkGiuj9bgtuNoVnDO8w ($25.80 in chips) 
Seat 5: E4AqQ1egsnu0oH2RqsbCmQ ($4.55 in chips) 
Seat 6: edio/rLJ06xeZOfLhoL3UA ($6.20 in chips) 
E4AqQ1egsnu0oH2RqsbCmQ: posts small blind $0.10
edio/rLJ06xeZOfLhoL3UA: posts big blind $0.25
*** HOLE CARDS ***
xrf8tAXKQHG99HixCot1Iw: raises $0.50 to $0.75
60PLIlpucQhA08L3YbNmag: folds 
v+QfkGiuj9bgtuNoVnDO8w: folds 
E4AqQ1egsnu0oH2RqsbCmQ: calls $0.65
edio/rLJ06xeZOfLhoL3UA: raises $5.45 to $6.20 and is all-in
Hzrn9DZJegEZICufTNYkrg joins the table at seat #1 
xrf8tAXKQHG99HixCot1Iw: folds 
E4AqQ1egsnu0oH2RqsbCmQ: folds 
Uncalled bet ($5.45) returned to edio/rLJ06xeZOfLhoL3UA
edio/rLJ06xeZOfLhoL3UA collected $2.25 from pot
edio/rLJ06xeZOfLhoL3UA: doesn't show hand 
*** SUMMARY ***
Total pot $2.25 | Rake $0 
Seat 2: xrf8tAXKQHG99HixCot1Iw folded before Flop
Seat 3: 60PLIlpucQhA08L3YbNmag folded before Flop (didn't bet)
Seat 4: v+QfkGiuj9bgtuNoVnDO8w (button) folded before Flop (didn't bet)
Seat 5: E4AqQ1egsnu0oH2RqsbCmQ (small blind) folded before Flop
Seat 6: edio/rLJ06xeZOfLhoL3UA (big blind) collected ($2.25)




PokerStars Game #59941672322:  Hold'em No Limit ($0.10/$0.25) - 2009/07/01 1:42:32 ET
Table 'Qr+t8WGovMECkBv+cV1lrg' 6-max Seat #3 is the button
Seat 1: EeUZtMU058v2ObUACOF4Og ($51.25 in chips) 
Seat 3: uZKkrGByYgd4/ZBX2d4z+w ($22 in chips) 
Seat 4: 1NNFfYMd5Hsphl/FYz9fNA ($60.30 in chips) 
Seat 5: 9q7YGTKe9k5fYb4fmZc3Ww ($32.70 in chips) 
Seat 6: xRkU4+naLuz7dEZFbOn9cw ($24.65 in chips) 
1NNFfYMd5Hsphl/FYz9fNA: posts small blind $0.10
9q7YGTKe9k5fYb4fmZc3Ww: posts big blind $0.25
vqWjZmdQu/Hxw96/IJTWdQ: sits out 
*** HOLE CARDS ***
xRkU4+naLuz7dEZFbOn9cw: folds 
EeUZtMU058v2ObUACOF4Og: folds 
uZKkrGByYgd4/ZBX2d4z+w: folds 
xRkU4+naLuz7dEZFbOn9cw leaves the table
1NNFfYMd5Hsphl/FYz9fNA: raises $0.50 to $0.75
9q7YGTKe9k5fYb4fmZc3Ww: folds 
Uncalled bet ($0.50) returned to 1NNFfYMd5Hsphl/FYz9fNA
1NNFfYMd5Hsphl/FYz9fNA collected $0.50 from pot
1NNFfYMd5Hsphl/FYz9fNA: doesn't show hand 
*** SUMMARY ***
Total pot $0.50 | Rake $0 
Seat 1: EeUZtMU058v2ObUACOF4Og folded before Flop (didn't bet)
Seat 3: uZKkrGByYgd4/ZBX2d4z+w (button) folded before Flop (didn't bet)
Seat 4: 1NNFfYMd5Hsphl/FYz9fNA (small blind) collected ($0.50)
Seat 5: 9q7YGTKe9k5fYb4fmZc3Ww (big blind) folded before Flop
Seat 6: xRkU4+naLuz7dEZFbOn9cw folded before Flop (didn't bet)




PokerStars Game #59941672954:  Hold'em No Limit ($0.10/$0.25) - 2009/07/01 1:42:33 ET
Table 'nB7Q7zfNfy6ig6DB+rsgWQ' 6-max Seat #2 is the button
Seat 1: Hzy03WtPHMYwLYM7hTTxQw ($24 in chips) 
Seat 2: 4BHo0wlX9INjkj2727qE0w ($25 in chips) 
Seat 3: p3NYOxYhkL7txPRSeXHDeg ($30.55 in chips) 
Seat 4: DihMHaz4WNETH1bPDe13kA ($77.65 in chips) 
Seat 6: MEGIwX0eHRUj63lwYaNhVg ($9.70 in chips) 
p3NYOxYhkL7txPRSeXHDeg: posts small blind $0.10
DihMHaz4WNETH1bPDe13kA: posts big blind $0.25
xC0kaiDYM6YTlgODL83O5A: sits out 
*** HOLE CARDS ***
MEGIwX0eHRUj63lwYaNhVg: calls $0.25
Hzy03WtPHMYwLYM7hTTxQw: folds 
4BHo0wlX9INjkj2727qE0w: raises $0.25 to $0.50
p3NYOxYhkL7txPRSeXHDeg: folds 
DihMHaz4WNETH1bPDe13kA: raises $1.45 to $1.95
MEGIwX0eHRUj63lwYaNhVg: folds 
4BHo0wlX9INjkj2727qE0w: calls $1.45
*** FLOP *** [6d 6c 4s]
DihMHaz4WNETH1bPDe13kA: checks 
4BHo0wlX9INjkj2727qE0w: bets $0.75
DihMHaz4WNETH1bPDe13kA: raises $4.20 to $4.95
4BHo0wlX9INjkj2727qE0w: folds 
Uncalled bet ($4.20) returned to DihMHaz4WNETH1bPDe13kA
DihMHaz4WNETH1bPDe13kA collected $5.50 from pot
*** SUMMARY ***
Total pot $5.75 | Rake $0.25 
Board [6d 6c 4s]
Seat 1: Hzy03WtPHMYwLYM7hTTxQw folded before Flop (didn't bet)
Seat 2: 4BHo0wlX9INjkj2727qE0w (button) folded on the Flop
Seat 3: p3NYOxYhkL7txPRSeXHDeg (small blind) folded before Flop
Seat 4: DihMHaz4WNETH1bPDe13kA (big blind) collected ($5.50)
Seat 6: MEGIwX0eHRUj63lwYaNhVg folded before Flop




PokerStars Game #59941672930:  Hold'em No Limit ($0.10/$0.25) - 2009/07/01 1:42:33 ET
Table '0M5QEJGOThqZwQ/sjbjXYw' 6-max Seat #2 is the button
Seat 2: /gJNBeCkWL4o85/jvlZ4BA ($36.60 in chips) 
Seat 3: 3zD3qLXT1bEffAoWGnc7wg ($25 in chips) 
Seat 4: oBUDUfeUyCbZBsjxHZgSiw ($23.35 in chips) 
Seat 5: cWc85bEzdRzpUMhRKm8pwQ ($28.05 in chips) 
Seat 6: mYz11CHiw5KsDCRD5T7/jg ($47.45 in chips) 
3zD3qLXT1bEffAoWGnc7wg: posts small blind $0.10
oBUDUfeUyCbZBsjxHZgSiw: posts big blind $0.25
*** HOLE CARDS ***
cWc85bEzdRzpUMhRKm8pwQ: folds 
mYz11CHiw5KsDCRD5T7/jg: calls $0.25
/gJNBeCkWL4o85/jvlZ4BA: raises $0.75 to $1
3zD3qLXT1bEffAoWGnc7wg: folds 
oBUDUfeUyCbZBsjxHZgSiw: folds 
mYz11CHiw5KsDCRD5T7/jg: calls $0.75
*** FLOP *** [6s Jc Ad]
mYz11CHiw5KsDCRD5T7/jg: checks 
/gJNBeCkWL4o85/jvlZ4BA: bets $1
mYz11CHiw5KsDCRD5T7/jg: calls $1
*** TURN *** [6s Jc Ad] [6c]
mYz11CHiw5KsDCRD5T7/jg: bets $1
/gJNBeCkWL4o85/jvlZ4BA: folds 
Uncalled bet ($1) returned to mYz11CHiw5KsDCRD5T7/jg
mYz11CHiw5KsDCRD5T7/jg collected $4.15 from pot
*** SUMMARY ***
Total pot $4.35 | Rake $0.20 
Board [6s Jc Ad 6c]
Seat 2: /gJNBeCkWL4o85/jvlZ4BA (button) folded on the Turn
Seat 3: 3zD3qLXT1bEffAoWGnc7wg (small blind) folded before Flop
Seat 4: oBUDUfeUyCbZBsjxHZgSiw (big blind) folded before Flop
Seat 5: cWc85bEzdRzpUMhRKm8pwQ folded before Flop (didn't bet)
Seat 6: mYz11CHiw5KsDCRD5T7/jg collected ($4.15)




PokerStars Game #59941672860:  Hold'em No Limit ($0.10/$0.25) - 2009/07/01 1:42:33 ET
Table 'NtEQAxCeIK2io1CGtW658g' 6-max Seat #6 is the button
Seat 1: X437kMQ7AujoaDgjguhU9w ($11.90 in chips) 
Seat 3: m2yWOKfAxqHoy5DDN87Ttw ($38 in chips) 
Seat 4: 8296 ($11.90 in chips) 
Seat 5: Hsvkc0/G2VV78oVmWYXecw ($5 in chips) 
Seat 6: /gJNBeCkWL4o85/jvlZ4BA ($64.75 in chips) 
X437kMQ7AujoaDgjguhU9w: posts small blind $0.10
m2yWOKfAxqHoy5DDN87Ttw: posts big blind $0.25
*** HOLE CARDS ***
8296: folds 
Hsvkc0/G2VV78oVmWYXecw: folds 
/gJNBeCkWL4o85/jvlZ4BA: folds 
X437kMQ7AujoaDgjguhU9w: raises $0.25 to $0.50
m2yWOKfAxqHoy5DDN87Ttw: calls $0.25
*** FLOP *** [Jc Th Ac]
X437kMQ7AujoaDgjguhU9w: bets $1.50
m2yWOKfAxqHoy5DDN87Ttw: calls $1.50
*** TURN *** [Jc Th Ac] [3h]
X437kMQ7AujoaDgjguhU9w: checks 
m2yWOKfAxqHoy5DDN87Ttw: bets $2.50
X437kMQ7AujoaDgjguhU9w: folds 
Uncalled bet ($2.50) returned to m2yWOKfAxqHoy5DDN87Ttw
m2yWOKfAxqHoy5DDN87Ttw collected $3.85 from pot
m2yWOKfAxqHoy5DDN87Ttw: doesn't show hand 
*** SUMMARY ***
Total pot $4 | Rake $0.15 
Board [Jc Th Ac 3h]
Seat 1: X437kMQ7AujoaDgjguhU9w (small blind) folded on the Turn
Seat 3: m2yWOKfAxqHoy5DDN87Ttw (big blind) collected ($3.85)
Seat 4: 8296 folded before Flop (didn't bet)
Seat 5: Hsvkc0/G2VV78oVmWYXecw folded before Flop (didn't bet)
Seat 6: /gJNBeCkWL4o85/jvlZ4BA (button) folded before Flop (didn't bet)




PokerStars Game #59941672706:  Hold'em No Limit ($0.10/$0.25) - 2009/07/01 1:42:33 ET
Table 'HbNAGS1OJWQKyfk7UfrYyw' 9-max Seat #7 is the button
Seat 2: fjwM06E3HzjUrynPRQi31Q ($4.50 in chips) 
Seat 5: z2SmIaQ3+5n/eY1BN5HgPg ($5.95 in chips) 
Seat 6: jntAuOS+eFQDYNiDN8dzag ($15 in chips) 
Seat 7: n+stbTneifqFNME+tpoGrw ($25.50 in chips) 
fjwM06E3HzjUrynPRQi31Q: posts small blind $0.10
z2SmIaQ3+5n/eY1BN5HgPg: posts big blind $0.25
jntAuOS+eFQDYNiDN8dzag: posts big blind $0.25
*** HOLE CARDS ***
jntAuOS+eFQDYNiDN8dzag: checks 
n+stbTneifqFNME+tpoGrw: folds 
fjwM06E3HzjUrynPRQi31Q: raises $0.50 to $0.75
z2SmIaQ3+5n/eY1BN5HgPg: folds 
n+stbTneifqFNME+tpoGrw leaves the table
jntAuOS+eFQDYNiDN8dzag: calls $0.50
*** FLOP *** [7s Tc 7h]
fjwM06E3HzjUrynPRQi31Q: bets $0.25
jntAuOS+eFQDYNiDN8dzag: calls $0.25
*** TURN *** [7s Tc 7h] [4h]
fjwM06E3HzjUrynPRQi31Q: bets $0.50
jntAuOS+eFQDYNiDN8dzag: calls $0.50
*** RIVER *** [7s Tc 7h 4h] [2h]
XwQK8xvCADxp0bUmji+Zyg joins the table at seat #4 
fjwM06E3HzjUrynPRQi31Q: bets $3 and is all-in
jntAuOS+eFQDYNiDN8dzag: folds 
Uncalled bet ($3) returned to fjwM06E3HzjUrynPRQi31Q
fjwM06E3HzjUrynPRQi31Q collected $3.10 from pot
fjwM06E3HzjUrynPRQi31Q: doesn't show hand 
*** SUMMARY ***
Total pot $3.25 | Rake $0.15 
Board [7s Tc 7h 4h 2h]
Seat 2: fjwM06E3HzjUrynPRQi31Q (small blind) collected ($3.10)
Seat 5: z2SmIaQ3+5n/eY1BN5HgPg (big blind) folded before Flop
Seat 6: jntAuOS+eFQDYNiDN8dzag folded on the River
Seat 7: n+stbTneifqFNME+tpoGrw (button) folded before Flop (didn't bet)




PokerStars Game #59941672582:  Hold'em No Limit ($0.10/$0.25) - 2009/07/01 1:42:33 ET
Table 'vFZR6Kf2Th5xBXT9brGW6A' 6-max Seat #1 is the button
Seat 1: Q3EMN7b0ie81AFWkDrhCjw ($20.10 in chips) 
Seat 2: QiL+lEgEWwy21jk/ltaRLg ($23.15 in chips) 
Seat 3: SH1WjKVUjPiyXySjWSdazw ($24.60 in chips) 
Seat 4: 79ID/ub1Pt/mDpCprVmOoA ($35.55 in chips) 
Seat 5: SS/yfeArhULzIcOPe8MdPg ($26.65 in chips) 
Seat 6: 4x9jCqgSw4272dnaIqnanw ($3.25 in chips) 
QiL+lEgEWwy21jk/ltaRLg: posts small blind $0.10
SH1WjKVUjPiyXySjWSdazw: posts big blind $0.25
*** HOLE CARDS ***
79ID/ub1Pt/mDpCprVmOoA: folds 
SS/yfeArhULzIcOPe8MdPg: folds 
4x9jCqgSw4272dnaIqnanw: raises $0.50 to $0.75
Q3EMN7b0ie81AFWkDrhCjw: calls $0.75
QiL+lEgEWwy21jk/ltaRLg: calls $0.65
SH1WjKVUjPiyXySjWSdazw: calls $0.50
*** FLOP *** [Qc 2d 2c]
QiL+lEgEWwy21jk/ltaRLg: checks 
SH1WjKVUjPiyXySjWSdazw: checks 
4x9jCqgSw4272dnaIqnanw: checks 
Q3EMN7b0ie81AFWkDrhCjw: bets $1.50
QiL+lEgEWwy21jk/ltaRLg: folds 
SH1WjKVUjPiyXySjWSdazw: folds 
4x9jCqgSw4272dnaIqnanw: folds 
Uncalled bet ($1.50) returned to Q3EMN7b0ie81AFWkDrhCjw
Q3EMN7b0ie81AFWkDrhCjw collected $2.85 from pot
*** SUMMARY ***
Total pot $3 | Rake $0.15 
Board [Qc 2d 2c]
Seat 1: Q3EMN7b0ie81AFWkDrhCjw (button) collected ($2.85)
Seat 2: QiL+lEgEWwy21jk/ltaRLg (small blind) folded on the Flop
Seat 3: SH1WjKVUjPiyXySjWSdazw (big blind) folded on the Flop
Seat 4: 79ID/ub1Pt/mDpCprVmOoA folded before Flop (didn't bet)
Seat 5: SS/yfeArhULzIcOPe8MdPg folded before Flop (didn't bet)
Seat 6: 4x9jCqgSw4272dnaIqnanw folded on the Flop




PokerStars Game #59941672878:  Hold'em No Limit ($0.10/$0.25) - 2009/07/01 1:42:33 ET
Table 'Pz8SfAzhP5nvWTsJRAxoDg' 6-max Seat #6 is the button
Seat 1: QiL+lEgEWwy21jk/ltaRLg ($26.05 in chips) 
Seat 2: xrf8tAXKQHG99HixCot1Iw ($25.15 in chips) 
Seat 3: mfrkWA3PTeYPkbO6hi98Aw ($28.20 in chips) 
Seat 4: 4lJto+Qj0K4JrFKvHaPTLw ($66.15 in chips) 
Seat 5: FYepjhAvF8ZdVCmqHIy+eQ ($28.40 in chips) 
Seat 6: QvTX2yGq3uKJiKPmns4TKQ ($24.65 in chips) 
QiL+lEgEWwy21jk/ltaRLg: posts small blind $0.10
xrf8tAXKQHG99HixCot1Iw: posts big blind $0.25
*** HOLE CARDS ***
mfrkWA3PTeYPkbO6hi98Aw: folds 
4lJto+Qj0K4JrFKvHaPTLw: folds 
FYepjhAvF8ZdVCmqHIy+eQ: folds 
QvTX2yGq3uKJiKPmns4TKQ: folds 
QiL+lEgEWwy21jk/ltaRLg: calls $0.15
xrf8tAXKQHG99HixCot1Iw: checks 
*** FLOP *** [6c 4h 2d]
QiL+lEgEWwy21jk/ltaRLg: bets $0.25
xrf8tAXKQHG99HixCot1Iw: raises $1 to $1.25
QiL+lEgEWwy21jk/ltaRLg: folds 
Uncalled bet ($1) returned to xrf8tAXKQHG99HixCot1Iw
xrf8tAXKQHG99HixCot1Iw collected $0.95 from pot
xrf8tAXKQHG99HixCot1Iw: doesn't show hand 
*** SUMMARY ***
Total pot $1 | Rake $0.05 
Board [6c 4h 2d]
Seat 1: QiL+lEgEWwy21jk/ltaRLg (small blind) folded on the Flop
Seat 2: xrf8tAXKQHG99HixCot1Iw (big blind) collected ($0.95)
Seat 3: mfrkWA3PTeYPkbO6hi98Aw folded before Flop (didn't bet)
Seat 4: 4lJto+Qj0K4JrFKvHaPTLw folded before Flop (didn't bet)
Seat 5: FYepjhAvF8ZdVCmqHIy+eQ folded before Flop (didn't bet)
Seat 6: QvTX2yGq3uKJiKPmns4TKQ (button) folded before Flop (didn't bet)




PokerStars Game #59941673588:  Hold'em No Limit ($0.10/$0.25) - 2009/07/01 1:42:34 ET
Table 'l57rayEpPtZotP9nqgSWBg' 6-max Seat #2 is the button
Seat 1: DihMHaz4WNETH1bPDe13kA ($56.10 in chips) 
Seat 2: p6adJRMXMBLr+xtQzqazIQ ($15.55 in chips) 
Seat 3: L3/N/gliETan8N5Gim5h4Q ($25 in chips) 
Seat 4: OqkdGXy1SCzuN5Q0wNlFSg ($22.95 in chips) 
Seat 5: WKJHaZPUgrpTVyLOEjLYmg ($10.65 in chips) 
Seat 6: IGRfskE1v9H9Bn+fz8AgNQ ($17.30 in chips) 
L3/N/gliETan8N5Gim5h4Q: posts small blind $0.10
OqkdGXy1SCzuN5Q0wNlFSg: posts big blind $0.25
*** HOLE CARDS ***
WKJHaZPUgrpTVyLOEjLYmg: calls $0.25
IGRfskE1v9H9Bn+fz8AgNQ: calls $0.25
DihMHaz4WNETH1bPDe13kA: folds 
p6adJRMXMBLr+xtQzqazIQ: folds 
L3/N/gliETan8N5Gim5h4Q: folds 
OqkdGXy1SCzuN5Q0wNlFSg: checks 
*** FLOP *** [7c Ah 7h]
OqkdGXy1SCzuN5Q0wNlFSg: checks 
WKJHaZPUgrpTVyLOEjLYmg: bets $0.75
IGRfskE1v9H9Bn+fz8AgNQ: folds 
OqkdGXy1SCzuN5Q0wNlFSg: folds 
Uncalled bet ($0.75) returned to WKJHaZPUgrpTVyLOEjLYmg
WKJHaZPUgrpTVyLOEjLYmg collected $0.85 from pot
*** SUMMARY ***
Total pot $0.85 | Rake $0 
Board [7c Ah 7h]
Seat 1: DihMHaz4WNETH1bPDe13kA folded before Flop (didn't bet)
Seat 2: p6adJRMXMBLr+xtQzqazIQ (button) folded before Flop (didn't bet)
Seat 3: L3/N/gliETan8N5Gim5h4Q (small blind) folded before Flop
Seat 4: OqkdGXy1SCzuN5Q0wNlFSg (big blind) folded on the Flop
Seat 5: WKJHaZPUgrpTVyLOEjLYmg collected ($0.85)
Seat 6: IGRfskE1v9H9Bn+fz8AgNQ folded on the Flop




PokerStars Game #59941673090:  Hold'em No Limit ($0.10/$0.25) - 2009/07/01 1:42:34 ET
Table 'gYBWJG3hEuJg6kphY0yhMg' 9-max Seat #7 is the button
Seat 1: AcL/hxc9eT0dCr2TYk/0Dg ($25.20 in chips) 
Seat 3: wGigCmBR/9XWkPpvYos3aQ ($25.35 in chips) 
Seat 4: V6p0jQ/RhUsqpHLmXvEX4Q ($13 in chips) 
Seat 5: +sbyWwIcFp9kP0bDtMegfQ ($27.95 in chips) 
Seat 7: EQXHDnIzAsORnIXRNtXRlA ($19.30 in chips) 
Seat 8: VCKtuATyvAq9H2JSAQxPbA ($13.70 in chips) 
Seat 9: Bb42QRQMhg5/Y0vHP8/2Xw ($25.60 in chips) 
VCKtuATyvAq9H2JSAQxPbA: posts small blind $0.10
Bb42QRQMhg5/Y0vHP8/2Xw: posts big blind $0.25
RCqMONFrSPSArZh2Jsar/w: sits out 
*** HOLE CARDS ***
AcL/hxc9eT0dCr2TYk/0Dg: calls $0.25
wGigCmBR/9XWkPpvYos3aQ: folds 
Z9W7+g1WMhhZDi7DwGbCFA joins the table at seat #6 
V6p0jQ/RhUsqpHLmXvEX4Q: folds 
+sbyWwIcFp9kP0bDtMegfQ: folds 
EQXHDnIzAsORnIXRNtXRlA: calls $0.25
VCKtuATyvAq9H2JSAQxPbA: calls $0.15
Bb42QRQMhg5/Y0vHP8/2Xw: raises $1.25 to $1.50
AcL/hxc9eT0dCr2TYk/0Dg: calls $1.25
EQXHDnIzAsORnIXRNtXRlA: calls $1.25
VCKtuATyvAq9H2JSAQxPbA: folds 
*** FLOP *** [As 8s Qs]
Bb42QRQMhg5/Y0vHP8/2Xw: bets $2.25
AcL/hxc9eT0dCr2TYk/0Dg: folds 
EQXHDnIzAsORnIXRNtXRlA: folds 
Uncalled bet ($2.25) returned to Bb42QRQMhg5/Y0vHP8/2Xw
EQXHDnIzAsORnIXRNtXRlA is sitting out
EQXHDnIzAsORnIXRNtXRlA leaves the table
Bb42QRQMhg5/Y0vHP8/2Xw collected $4.55 from pot
*** SUMMARY ***
Total pot $4.75 | Rake $0.20 
Board [As 8s Qs]
Seat 1: AcL/hxc9eT0dCr2TYk/0Dg folded on the Flop
Seat 3: wGigCmBR/9XWkPpvYos3aQ folded before Flop (didn't bet)
Seat 4: V6p0jQ/RhUsqpHLmXvEX4Q folded before Flop (didn't bet)
Seat 5: +sbyWwIcFp9kP0bDtMegfQ folded before Flop (didn't bet)
Seat 7: EQXHDnIzAsORnIXRNtXRlA (button) folded on the Flop
Seat 8: VCKtuATyvAq9H2JSAQxPbA (small blind) folded before Flop
Seat 9: Bb42QRQMhg5/Y0vHP8/2Xw (big blind) collected ($4.55)




PokerStars Game #59941673554:  Hold'em No Limit ($0.10/$0.25) - 2009/07/01 1:42:34 ET
Table 'sCop8wmj9zlSS2KJqk1QKQ' 9-max Seat #2 is the button
Seat 1: dtZ84flFEi4Q+SGrHMJRDQ ($40.85 in chips) 
Seat 2: YZaC69gFrepA6oCGtu7E0w ($39 in chips) 
Seat 4: msUzkZl2RntUnTl6E8WaNA ($10.65 in chips) 
Seat 5: RHqgdFvufLCYe54+qd2gcA ($5 in chips) 
Seat 6: hZuGwtYmFKPmQ+v1wlmdfA ($43.05 in chips) 
Seat 7: sx0lGrkT9fd4yFR+3cXUQg ($11.85 in chips) 
Seat 8: xnVwSkROfRtOw4eSoDANtw ($20.30 in chips) 
Seat 9: tLcDklc2rBORNfixyRfVfw ($25 in chips) 
msUzkZl2RntUnTl6E8WaNA: posts small blind $0.10
RHqgdFvufLCYe54+qd2gcA: posts big blind $0.25
*** HOLE CARDS ***
hZuGwtYmFKPmQ+v1wlmdfA: folds 
sx0lGrkT9fd4yFR+3cXUQg: folds 
xnVwSkROfRtOw4eSoDANtw: calls $0.25
101stupid leaves the table
tLcDklc2rBORNfixyRfVfw: folds 
dtZ84flFEi4Q+SGrHMJRDQ: folds 
YZaC69gFrepA6oCGtu7E0w: folds 
msUzkZl2RntUnTl6E8WaNA: folds 
RHqgdFvufLCYe54+qd2gcA: checks 
*** FLOP *** [8s 6s Ac]
UkF1eqqUN0CCiimXAuN7og joins the table at seat #3 
RHqgdFvufLCYe54+qd2gcA: checks 
xnVwSkROfRtOw4eSoDANtw: bets $0.25
RHqgdFvufLCYe54+qd2gcA: folds 
Uncalled bet ($0.25) returned to xnVwSkROfRtOw4eSoDANtw
xnVwSkROfRtOw4eSoDANtw collected $0.60 from pot
*** SUMMARY ***
Total pot $0.60 | Rake $0 
Board [8s 6s Ac]
Seat 1: dtZ84flFEi4Q+SGrHMJRDQ folded before Flop (didn't bet)
Seat 2: YZaC69gFrepA6oCGtu7E0w (button) folded before Flop (didn't bet)
Seat 4: msUzkZl2RntUnTl6E8WaNA (small blind) folded before Flop
Seat 5: RHqgdFvufLCYe54+qd2gcA (big blind) folded on the Flop
Seat 6: hZuGwtYmFKPmQ+v1wlmdfA folded before Flop (didn't bet)
Seat 7: sx0lGrkT9fd4yFR+3cXUQg folded before Flop (didn't bet)
Seat 8: xnVwSkROfRtOw4eSoDANtw collected ($0.60)
Seat 9: tLcDklc2rBORNfixyRfVfw folded before Flop (didn't bet)




PokerStars Game #59941673242:  Hold'em No Limit ($0.10/$0.25) - 2009/07/01 1:42:34 ET
Table 'nQC9LRg01NEuKFHF1nrDEw0XPo7K54oZIfG0xlNAcDRw-max Seat #1 is the button
Seat 1: qf+LMbROj8/qY878wkFHbQ ($14.65 in chips) 
Seat 3: 6+g0Lb6vfRDZkElV8ieHyQ ($23.45 in chips) 
Seat 5: kG34n23qFQA3nzdOJTQ1dA ($29.65 in chips) 
Seat 6: xQVFeVUDopz+akuEo2wXpQ ($53.90 in chips) 
6+g0Lb6vfRDZkElV8ieHyQ: posts small blind $0.10
ZhV6dUX9NQhT4zf7t+ZLJg joins the table at seat #2 
kG34n23qFQA3nzdOJTQ1dA: posts big blind $0.25
*** HOLE CARDS ***
xQVFeVUDopz+akuEo2wXpQ: calls $0.25
qf+LMbROj8/qY878wkFHbQ: calls $0.25
6+g0Lb6vfRDZkElV8ieHyQ: folds 
kG34n23qFQA3nzdOJTQ1dA: checks 
*** FLOP *** [Td 9s 4s]
kG34n23qFQA3nzdOJTQ1dA: checks 
xQVFeVUDopz+akuEo2wXpQ: bets $0.25
qf+LMbROj8/qY878wkFHbQ: folds 
kG34n23qFQA3nzdOJTQ1dA: folds 
Uncalled bet ($0.25) returned to xQVFeVUDopz+akuEo2wXpQ
xQVFeVUDopz+akuEo2wXpQ collected $0.85 from pot
*** SUMMARY ***
Total pot $0.85 | Rake $0 
Board [Td 9s 4s]
Seat 1: qf+LMbROj8/qY878wkFHbQ (button) folded on the Flop
Seat 3: 6+g0Lb6vfRDZkElV8ieHyQ (small blind) folded before Flop
Seat 5: kG34n23qFQA3nzdOJTQ1dA (big blind) folded on the Flop
Seat 6: xQVFeVUDopz+akuEo2wXpQ collected ($0.85)




PokerStars Game #59941673198:  Hold'em No Limit ($0.10/$0.25) - 2009/07/01 1:42:34 ET
Table 'rpIHGyt2QpgQc5bvptAvDQ' 9-max Seat #2 is the button
Seat 2: FX0yWp7Ul3dMebXB0cFjEw ($5.70 in chips) 
Seat 4: ASXDkj9tmvF/T2AsNuxg7g ($6.20 in chips) 
Seat 6: Mq1ESwxx3LEsA4HjKKjU3Q ($20.25 in chips) 
Seat 7: GHgIdzlzMAmRmmX7jgXtuQ ($5 in chips) 
ASXDkj9tmvF/T2AsNuxg7g: posts small blind $0.10
Mq1ESwxx3LEsA4HjKKjU3Q: posts big blind $0.25
*** HOLE CARDS ***
XhSvfX1gy0yx/qeW+SOeTw joins the table at seat #5 
GHgIdzlzMAmRmmX7jgXtuQ: calls $0.25
FX0yWp7Ul3dMebXB0cFjEw: calls $0.25
ASXDkj9tmvF/T2AsNuxg7g: calls $0.15
Mq1ESwxx3LEsA4HjKKjU3Q: checks 
*** FLOP *** [As Td 9c]
ASXDkj9tmvF/T2AsNuxg7g: checks 
Mq1ESwxx3LEsA4HjKKjU3Q: checks 
GHgIdzlzMAmRmmX7jgXtuQ: checks 
FX0yWp7Ul3dMebXB0cFjEw: checks 
*** TURN *** [As Td 9c] [3d]
ASXDkj9tmvF/T2AsNuxg7g: checks 
Mq1ESwxx3LEsA4HjKKjU3Q: checks 
N6a/f6AW8S8G3JFw9IFxAg joins the table at seat #3 
GHgIdzlzMAmRmmX7jgXtuQ: bets $0.25
FX0yWp7Ul3dMebXB0cFjEw: calls $0.25
ASXDkj9tmvF/T2AsNuxg7g: calls $0.25
oUgIL46CfA9GCdIuN1TVSw joins the table at seat #8 
Mq1ESwxx3LEsA4HjKKjU3Q: calls $0.25
*** RIVER *** [As Td 9c 3d] [Jd]
b33tl3 joins the table at seat #9 
ASXDkj9tmvF/T2AsNuxg7g: checks 
Mq1ESwxx3LEsA4HjKKjU3Q: checks 
GHgIdzlzMAmRmmX7jgXtuQ: bets $0.50
FX0yWp7Ul3dMebXB0cFjEw: folds 
ASXDkj9tmvF/T2AsNuxg7g: calls $0.50
Mq1ESwxx3LEsA4HjKKjU3Q: calls $0.50
*** SHOW DOWN ***
GHgIdzlzMAmRmmX7jgXtuQ: shows [Ad 5d] (a flush, Ace high)
ASXDkj9tmvF/T2AsNuxg7g: mucks hand 
Mq1ESwxx3LEsA4HjKKjU3Q: mucks hand 
GHgIdzlzMAmRmmX7jgXtuQ collected $3.35 from pot
N6a/f6AW8S8G3JFw9IFxAg is disconnected 
*** SUMMARY ***
Total pot $3.50 | Rake $0.15 
Board [As Td 9c 3d Jd]
Seat 2: FX0yWp7Ul3dMebXB0cFjEw (button) folded on the River
Seat 4: ASXDkj9tmvF/T2AsNuxg7g (small blind) mucked
Seat 6: Mq1ESwxx3LEsA4HjKKjU3Q (big blind) mucked
Seat 7: GHgIdzlzMAmRmmX7jgXtuQ showed [Ad 5d] and won ($3.35) with a flush, Ace high




PokerStars Game #59941673510:  Hold'em No Limit ($0.10/$0.25) - 2009/07/01 1:42:34 ET
Table 'xmJKTGBeWCwutccj3YfupQ' 6-max Seat #3 is the button
Seat 1: sVbkVl4OznxBCfi66UB9vw ($27.55 in chips) 
Seat 2: AxhCSFlGEh+FAc+VUD31JQ ($23.20 in chips) 
Seat 3: T5wrp/d5jarm+SxNy8OQAg ($17.70 in chips) 
Seat 4: uWjhTVMpuIroxXcmD3Okug ($10.10 in chips) 
Seat 5: DE9hRlt14g+JdsRQ4wT7hg ($28.25 in chips) 
uWjhTVMpuIroxXcmD3Okug: posts small blind $0.10
DE9hRlt14g+JdsRQ4wT7hg: posts big blind $0.25
9bpVv1/Qh9IYtXuCtl5VtQ: sits out 
*** HOLE CARDS ***
sVbkVl4OznxBCfi66UB9vw: folds 
AxhCSFlGEh+FAc+VUD31JQ: folds 
T5wrp/d5jarm+SxNy8OQAg: folds 
uWjhTVMpuIroxXcmD3Okug: folds 
Uncalled bet ($0.15) returned to DE9hRlt14g+JdsRQ4wT7hg
DE9hRlt14g+JdsRQ4wT7hg collected $0.20 from pot
DE9hRlt14g+JdsRQ4wT7hg: doesn't show hand 
*** SUMMARY ***
Total pot $0.20 | Rake $0 
Seat 1: sVbkVl4OznxBCfi66UB9vw folded before Flop (didn't bet)
Seat 2: AxhCSFlGEh+FAc+VUD31JQ folded before Flop (didn't bet)
Seat 3: T5wrp/d5jarm+SxNy8OQAg (button) folded before Flop (didn't bet)
Seat 4: uWjhTVMpuIroxXcmD3Okug (small blind) folded before Flop
Seat 5: DE9hRlt14g+JdsRQ4wT7hg (big blind) collected ($0.20)




PokerStars Game #59941673928:  Hold'em No Limit ($0.10/$0.25) - 2009/07/01 1:42:35 ET
Table 'jItkp2PNTbH9Cf7gqsAF7g' 9-max Seat #1 is the button
Seat 1: wGigCmBR/9XWkPpvYos3aQ ($25.70 in chips) 
Seat 2: qwr38jl5txoR36M7G5qi4A ($8.20 in chips) 
Seat 3: 0YaJElQVLqWThIZnqq3w1g ($15 in chips) 
Seat 5: NO6qGDOw12lhu3zh1xW3Bg ($19.55 in chips) 
Seat 6: cZ99hugmLBj9KhTlc8nCSw ($53 in chips) 
Seat 7: z5GxcHlYz/GSz6W2uFiTtg ($17.95 in chips) 
Seat 8: cq6LACCDFivk2+PeoiB2sw ($6.65 in chips) 
Seat 9: dtZ84flFEi4Q+SGrHMJRDQ ($25.40 in chips) 
qwr38jl5txoR36M7G5qi4A: posts small blind $0.10
0YaJElQVLqWThIZnqq3w1g: posts big blind $0.25
oJOvZw/Iayou0f0k6dkBhg: sits out 
*** HOLE CARDS ***
NO6qGDOw12lhu3zh1xW3Bg: folds 
cZ99hugmLBj9KhTlc8nCSw: folds 
z5GxcHlYz/GSz6W2uFiTtg: calls $0.25
cq6LACCDFivk2+PeoiB2sw: folds 
dtZ84flFEi4Q+SGrHMJRDQ: folds 
wGigCmBR/9XWkPpvYos3aQ: folds 
qwr38jl5txoR36M7G5qi4A: calls $0.15
0YaJElQVLqWThIZnqq3w1g: checks 
*** FLOP *** [Ts 5c 9s]
qwr38jl5txoR36M7G5qi4A: checks 
0YaJElQVLqWThIZnqq3w1g: bets $0.50
z5GxcHlYz/GSz6W2uFiTtg: folds 
z5GxcHlYz/GSz6W2uFiTtg is sitting out
qwr38jl5txoR36M7G5qi4A: folds 
Uncalled bet ($0.50) returned to 0YaJElQVLqWThIZnqq3w1g
0YaJElQVLqWThIZnqq3w1g collected $0.75 from pot
0YaJElQVLqWThIZnqq3w1g: doesn't show hand 
*** SUMMARY ***
Total pot $0.75 | Rake $0 
Board [Ts 5c 9s]
Seat 1: wGigCmBR/9XWkPpvYos3aQ (button) folded before Flop (didn't bet)
Seat 2: qwr38jl5txoR36M7G5qi4A (small blind) folded on the Flop
Seat 3: 0YaJElQVLqWThIZnqq3w1g (big blind) collected ($0.75)
Seat 5: NO6qGDOw12lhu3zh1xW3Bg folded before Flop (didn't bet)
Seat 6: cZ99hugmLBj9KhTlc8nCSw folded before Flop (didn't bet)
Seat 7: z5GxcHlYz/GSz6W2uFiTtg folded on the Flop
Seat 8: cq6LACCDFivk2+PeoiB2sw folded before Flop (didn't bet)
Seat 9: dtZ84flFEi4Q+SGrHMJRDQ folded before Flop (didn't bet)




PokerStars Game #59941673864:  Hold'em No Limit ($0.10/$0.25) - 2009/07/01 1:42:35 ET
Table 'FuFyQHmlO/QqQp//rDRrPg' 6-max Seat #5 is the button
Seat 1: jp34e617tIzV8tKIWmfAbA ($27.40 in chips) 
Seat 3: EeUZtMU058v2ObUACOF4Og ($30.60 in chips) 
Seat 5: xrf8tAXKQHG99HixCot1Iw ($25.60 in chips) 
Seat 6: 6DwBRH+xZ12AAZmeAg+aXw ($57.65 in chips) 
6DwBRH+xZ12AAZmeAg+aXw: posts small blind $0.10
jp34e617tIzV8tKIWmfAbA: posts big blind $0.25
Ahsa9Yk5NPmCqQstq1EoQA: sits out 
*** HOLE CARDS ***
EeUZtMU058v2ObUACOF4Og: folds 
xrf8tAXKQHG99HixCot1Iw: folds 
6DwBRH+xZ12AAZmeAg+aXw: folds 
Uncalled bet ($0.15) returned to jp34e617tIzV8tKIWmfAbA
G3h3THGB1j3qdHDVHpnJWg has returned
jp34e617tIzV8tKIWmfAbA collected $0.20 from pot
*** SUMMARY ***
Total pot $0.20 | Rake $0 
Seat 1: jp34e617tIzV8tKIWmfAbA (big blind) collected ($0.20)
Seat 3: EeUZtMU058v2ObUACOF4Og folded before Flop (didn't bet)
Seat 5: xrf8tAXKQHG99HixCot1Iw (button) folded before Flop (didn't bet)
Seat 6: 6DwBRH+xZ12AAZmeAg+aXw (small blind) folded before Flop




PokerStars Game #59941674268:  Hold'em No Limit ($0.10/$0.25) - 2009/07/01 1:42:36 ET
Table 'aT31tt16YvQM/Ue69HPLpA' 9-max Seat #5 is the button
Seat 1: fIgGw0jPUR7labvJPaPbeg ($11.45 in chips) 
Seat 2: PdIasPkzm2sqZnN41ZRXOg ($4.90 in chips) 
Seat 3: tYsOBqdU1+x+yFI7zHO7hQ ($26.15 in chips) 
Seat 4: wGigCmBR/9XWkPpvYos3aQ ($25 in chips) 
Seat 5: s2xLPOl/vhl/26apJ3vsOQ ($37.65 in chips) 
Seat 6: 7cv+9Zc9HIQHNvYsMfV3uA ($58.55 in chips) 
Seat 7: W8cIfrCR+zA8pCNyIuHu8g ($32.30 in chips) 
Seat 9: TvIuLx9zUCE+9Li58iImOQ ($16.95 in chips) 
7cv+9Zc9HIQHNvYsMfV3uA: posts small blind $0.10
W8cIfrCR+zA8pCNyIuHu8g: posts big blind $0.25
W6tExOcYX7qiy6Qdp+ZwFA: sits out 
*** HOLE CARDS ***
TvIuLx9zUCE+9Li58iImOQ: folds 
fIgGw0jPUR7labvJPaPbeg: folds 
PdIasPkzm2sqZnN41ZRXOg: folds 
tYsOBqdU1+x+yFI7zHO7hQ: raises $0.75 to $1
wGigCmBR/9XWkPpvYos3aQ: raises $2.40 to $3.40
s2xLPOl/vhl/26apJ3vsOQ: folds 
7cv+9Zc9HIQHNvYsMfV3uA: folds 
W8cIfrCR+zA8pCNyIuHu8g: folds 
tYsOBqdU1+x+yFI7zHO7hQ: folds 
Uncalled bet ($2.40) returned to wGigCmBR/9XWkPpvYos3aQ
wGigCmBR/9XWkPpvYos3aQ collected $2.35 from pot
wGigCmBR/9XWkPpvYos3aQ: doesn't show hand 
*** SUMMARY ***
Total pot $2.35 | Rake $0 
Seat 1: fIgGw0jPUR7labvJPaPbeg folded before Flop (didn't bet)
Seat 2: PdIasPkzm2sqZnN41ZRXOg folded before Flop (didn't bet)
Seat 3: tYsOBqdU1+x+yFI7zHO7hQ folded before Flop
Seat 4: wGigCmBR/9XWkPpvYos3aQ collected ($2.35)
Seat 5: s2xLPOl/vhl/26apJ3vsOQ (button) folded before Flop (didn't bet)
Seat 6: 7cv+9Zc9HIQHNvYsMfV3uA (small blind) folded before Flop
Seat 7: W8cIfrCR+zA8pCNyIuHu8g (big blind) folded before Flop
Seat 9: TvIuLx9zUCE+9Li58iImOQ folded before Flop (didn't bet)




PokerStars Game #59941674354:  Hold'em No Limit ($0.10/$0.25) - 2009/07/01 1:42:36 ET
Table 'zhqgUUprOJ14VxKxPHcT/Q' 9-max Seat #9 is the button
Seat 1: 22dIObOuor/A+IKWkNoAlA ($5 in chips) 
Seat 2: GY095KWhBevJ1Ttvl8WseA ($8.10 in chips) 
Seat 3: 4XHsdGnQ76EBdBvsrSs8bA ($30.90 in chips) 
Seat 4: wGigCmBR/9XWkPpvYos3aQ ($33.45 in chips) 
Seat 5: +sbyWwIcFp9kP0bDtMegfQ ($33.60 in chips) 
Seat 7: sGFnnRCa1YAHAUmWgsW6Qg ($11 in chips) 
Seat 8: EQXHDnIzAsORnIXRNtXRlA ($24.35 in chips) 
Seat 9: 4awUyiDYTgylQKXZ9faBVA ($26.80 in chips) 
22dIObOuor/A+IKWkNoAlA: posts small blind $0.10
GY095KWhBevJ1Ttvl8WseA: posts big blind $0.25
PdIasPkzm2sqZnN41ZRXOg: sits out 
*** HOLE CARDS ***
4XHsdGnQ76EBdBvsrSs8bA: folds 
wGigCmBR/9XWkPpvYos3aQ: folds 
+sbyWwIcFp9kP0bDtMegfQ: folds 
sGFnnRCa1YAHAUmWgsW6Qg: folds 
EQXHDnIzAsORnIXRNtXRlA: calls $0.25
4awUyiDYTgylQKXZ9faBVA: folds 
22dIObOuor/A+IKWkNoAlA: calls $0.15
GY095KWhBevJ1Ttvl8WseA: checks 
*** FLOP *** [Qh Qd 6h]
22dIObOuor/A+IKWkNoAlA: bets $0.25
GY095KWhBevJ1Ttvl8WseA: folds 
EQXHDnIzAsORnIXRNtXRlA: folds 
Uncalled bet ($0.25) returned to 22dIObOuor/A+IKWkNoAlA
22dIObOuor/A+IKWkNoAlA collected $0.75 from pot
22dIObOuor/A+IKWkNoAlA: doesn't show hand 
*** SUMMARY ***
Total pot $0.75 | Rake $0 
Board [Qh Qd 6h]
Seat 1: 22dIObOuor/A+IKWkNoAlA (small blind) collected ($0.75)
Seat 2: GY095KWhBevJ1Ttvl8WseA (big blind) folded on the Flop
Seat 3: 4XHsdGnQ76EBdBvsrSs8bA folded before Flop (didn't bet)
Seat 4: wGigCmBR/9XWkPpvYos3aQ folded before Flop (didn't bet)
Seat 5: +sbyWwIcFp9kP0bDtMegfQ folded before Flop (didn't bet)
Seat 7: sGFnnRCa1YAHAUmWgsW6Qg folded before Flop (didn't bet)
Seat 8: EQXHDnIzAsORnIXRNtXRlA folded on the Flop
Seat 9: 4awUyiDYTgylQKXZ9faBVA (button) folded before Flop (didn't bet)




PokerStars Game #59941674600:  Hold'em No Limit ($0.10/$0.25) - 2009/07/01 1:42:36 ET
Table '8PD/MTROSMd6Y8mZeykbpg' 6-max Seat #3 is the button
Seat 1: fxNpaToxECtD2Goelmg9vA ($24.75 in chips) 
Seat 3: vqWjZmdQu/Hxw96/IJTWdQ ($25.25 in chips) 
Seat 4: DFi/Lzkjsfv8QswS80JX9Q ($53.80 in chips) 
Seat 5: z3tQwy28dp5FykDJC/wzQw ($25.95 in chips) 
DFi/Lzkjsfv8QswS80JX9Q: posts small blind $0.10
z3tQwy28dp5FykDJC/wzQw: posts big blind $0.25
trN/oHqTTbPw5MNuKrOpLw: sits out 
*** HOLE CARDS ***
4TM16KVgEiQpLi4bVVWbVQ joins the table at seat #2 
fxNpaToxECtD2Goelmg9vA: raises $0.50 to $0.75
vqWjZmdQu/Hxw96/IJTWdQ: folds 
DFi/Lzkjsfv8QswS80JX9Q: folds 
z3tQwy28dp5FykDJC/wzQw: folds 
Uncalled bet ($0.50) returned to fxNpaToxECtD2Goelmg9vA
fxNpaToxECtD2Goelmg9vA collected $0.60 from pot
fxNpaToxECtD2Goelmg9vA: doesn't show hand 
*** SUMMARY ***
Total pot $0.60 | Rake $0 
Seat 1: fxNpaToxECtD2Goelmg9vA collected ($0.60)
Seat 3: vqWjZmdQu/Hxw96/IJTWdQ (button) folded before Flop (didn't bet)
Seat 4: DFi/Lzkjsfv8QswS80JX9Q (small blind) folded before Flop
Seat 5: z3tQwy28dp5FykDJC/wzQw (big blind) folded before Flop




PokerStars Game #59941674254:  Hold'em No Limit ($0.10/$0.25) - 2009/07/01 1:42:36 ET
Table 'fIMYcWwN4/aXFJvH5Z8Ymg' 6-max Seat #5 is the button
Seat 1: DihMHaz4WNETH1bPDe13kA ($25.35 in chips) 
Seat 2: vu2kzHaDtgr6NM7rdq0chA ($26.45 in chips) 
Seat 4: 32YL2ZEp8NT4JB2RVM9euQ ($42.75 in chips) 
Seat 5: lquriepNQBhDV5P1SWHhnA ($25 in chips) 
Seat 6: jp34e617tIzV8tKIWmfAbA ($28.10 in chips) 
jp34e617tIzV8tKIWmfAbA: posts small blind $0.10
DihMHaz4WNETH1bPDe13kA: posts big blind $0.25
9bpVv1/Qh9IYtXuCtl5VtQ: sits out 
*** HOLE CARDS ***
vu2kzHaDtgr6NM7rdq0chA: folds 
32YL2ZEp8NT4JB2RVM9euQ: folds 
lquriepNQBhDV5P1SWHhnA: raises $0.50 to $0.75
jp34e617tIzV8tKIWmfAbA: folds 
DihMHaz4WNETH1bPDe13kA: folds 
Uncalled bet ($0.50) returned to lquriepNQBhDV5P1SWHhnA
lquriepNQBhDV5P1SWHhnA collected $0.60 from pot
lquriepNQBhDV5P1SWHhnA: doesn't show hand 
*** SUMMARY ***
Total pot $0.60 | Rake $0 
Seat 1: DihMHaz4WNETH1bPDe13kA (big blind) folded before Flop
Seat 2: vu2kzHaDtgr6NM7rdq0chA folded before Flop (didn't bet)
Seat 4: 32YL2ZEp8NT4JB2RVM9euQ folded before Flop (didn't bet)
Seat 5: lquriepNQBhDV5P1SWHhnA (button) collected ($0.60)
Seat 6: jp34e617tIzV8tKIWmfAbA (small blind) folded before Flop




PokerStars Game #59941674250:  Hold'em No Limit ($0.10/$0.25) - 2009/07/01 1:42:36 ET
Table 'sDHjMRwfSiz7+NDdZLUiyA' 9-max Seat #3 is the button
Seat 1: VGwr1eqhvdUtMfBFCvBnmg ($8.50 in chips) 
Seat 2: ljemhp25Zg+nlA9DLCIiUw ($26.75 in chips) 
Seat 3: SGA1WpAnQxFdFAYyt362gQ ($18.05 in chips) 
Seat 4: eK8qa6EPcH2zhtbmWSvc9g ($25 in chips) 
Seat 5: IGRfskE1v9H9Bn+fz8AgNQ ($37.40 in chips) 
Seat 6: 1qa0qHOCKZM3Uipx9DxYtQ ($16.40 in chips) 
Seat 7: K0b5wNInj6hUGRr6yzKFtw ($37.65 in chips) 
Seat 8: 3hMkm4U5yTRrkGJkxfijaQ ($3.15 in chips) 
Seat 9: 3PmVnC/15cl4oyI1TKIt4g ($4.30 in chips) 
eK8qa6EPcH2zhtbmWSvc9g: posts small blind $0.10
IGRfskE1v9H9Bn+fz8AgNQ: posts big blind $0.25
*** HOLE CARDS ***
1qa0qHOCKZM3Uipx9DxYtQ: calls $0.25
K0b5wNInj6hUGRr6yzKFtw: folds 
3hMkm4U5yTRrkGJkxfijaQ: calls $0.25
3PmVnC/15cl4oyI1TKIt4g: calls $0.25
VGwr1eqhvdUtMfBFCvBnmg: calls $0.25
ljemhp25Zg+nlA9DLCIiUw: calls $0.25
SGA1WpAnQxFdFAYyt362gQ: folds 
eK8qa6EPcH2zhtbmWSvc9g: calls $0.15
IGRfskE1v9H9Bn+fz8AgNQ: checks 
*** FLOP *** [9c Jh 4d]
eK8qa6EPcH2zhtbmWSvc9g: checks 
IGRfskE1v9H9Bn+fz8AgNQ: checks 
1qa0qHOCKZM3Uipx9DxYtQ: checks 
3hMkm4U5yTRrkGJkxfijaQ: checks 
3PmVnC/15cl4oyI1TKIt4g: checks 
VGwr1eqhvdUtMfBFCvBnmg: checks 
ljemhp25Zg+nlA9DLCIiUw: bets $1.25
eK8qa6EPcH2zhtbmWSvc9g: folds 
IGRfskE1v9H9Bn+fz8AgNQ: folds 
1qa0qHOCKZM3Uipx9DxYtQ: folds 
3hMkm4U5yTRrkGJkxfijaQ: folds 
3PmVnC/15cl4oyI1TKIt4g: folds 
VGwr1eqhvdUtMfBFCvBnmg: folds 
Uncalled bet ($1.25) returned to ljemhp25Zg+nlA9DLCIiUw
ljemhp25Zg+nlA9DLCIiUw collected $1.70 from pot
ljemhp25Zg+nlA9DLCIiUw: doesn't show hand 
*** SUMMARY ***
Total pot $1.75 | Rake $0.05 
Board [9c Jh 4d]
Seat 1: VGwr1eqhvdUtMfBFCvBnmg folded on the Flop
Seat 2: ljemhp25Zg+nlA9DLCIiUw collected ($1.70)
Seat 3: SGA1WpAnQxFdFAYyt362gQ (button) folded before Flop (didn't bet)
Seat 4: eK8qa6EPcH2zhtbmWSvc9g (small blind) folded on the Flop
Seat 5: IGRfskE1v9H9Bn+fz8AgNQ (big blind) folded on the Flop
Seat 6: 1qa0qHOCKZM3Uipx9DxYtQ folded on the Flop
Seat 7: K0b5wNInj6hUGRr6yzKFtw folded before Flop (didn't bet)
Seat 8: 3hMkm4U5yTRrkGJkxfijaQ folded on the Flop
Seat 9: 3PmVnC/15cl4oyI1TKIt4g folded on the Flop




PokerStars Game #59941674458:  Hold'em No Limit ($0.10/$0.25) - 2009/07/01 1:42:36 ET
Table '3KDMdm1sfxFsNKkjc/PnBg' 9-max Seat #7 is the button
Seat 1: JvrJoga8hK8pnB3KGQHl1g ($8.25 in chips) 
Seat 2: 5WLo/V8l3QfpUdK9JPp99w ($24.45 in chips) 
Seat 3: OXPkK84/qv92EMwXPiG5rQ ($9.25 in chips) 
Seat 4: F7pnn6czNpHvRM55XcA2EA ($37.85 in chips) 
Seat 5: +2kMBNpY4nF1qNCRd8SJLA ($31.45 in chips) 
Seat 6: sGFnnRCa1YAHAUmWgsW6Qg ($9.85 in chips) 
Seat 7: gehe91e0IyVT0QU/XBkEyg ($31.80 in chips) 
Seat 8: LFnLiiWho1pLiR1Xvp5d/w ($9.30 in chips) 
Seat 9: K0b5wNInj6hUGRr6yzKFtw ($31.75 in chips) 
LFnLiiWho1pLiR1Xvp5d/w: posts small blind $0.10
K0b5wNInj6hUGRr6yzKFtw: posts big blind $0.25
*** HOLE CARDS ***
JvrJoga8hK8pnB3KGQHl1g: folds 
5WLo/V8l3QfpUdK9JPp99w: calls $0.25
OXPkK84/qv92EMwXPiG5rQ: folds 
F7pnn6czNpHvRM55XcA2EA: folds 
+2kMBNpY4nF1qNCRd8SJLA: folds 
sGFnnRCa1YAHAUmWgsW6Qg: folds 
gehe91e0IyVT0QU/XBkEyg: folds 
LFnLiiWho1pLiR1Xvp5d/w: calls $0.15
K0b5wNInj6hUGRr6yzKFtw: checks 
*** FLOP *** [2h 3s 6c]
LFnLiiWho1pLiR1Xvp5d/w: checks 
K0b5wNInj6hUGRr6yzKFtw: bets $0.50
5WLo/V8l3QfpUdK9JPp99w: folds 
LFnLiiWho1pLiR1Xvp5d/w: calls $0.50
*** TURN *** [2h 3s 6c] [As]
LFnLiiWho1pLiR1Xvp5d/w: checks 
K0b5wNInj6hUGRr6yzKFtw: checks 
*** RIVER *** [2h 3s 6c As] [Js]
LFnLiiWho1pLiR1Xvp5d/w: checks 
K0b5wNInj6hUGRr6yzKFtw: checks 
*** SHOW DOWN ***
LFnLiiWho1pLiR1Xvp5d/w: shows [5s Th] (high card Ace)
K0b5wNInj6hUGRr6yzKFtw: shows [3d 7h] (a pair of Threes)
K0b5wNInj6hUGRr6yzKFtw collected $1.70 from pot
*** SUMMARY ***
Total pot $1.75 | Rake $0.05 
Board [2h 3s 6c As Js]
Seat 1: JvrJoga8hK8pnB3KGQHl1g folded before Flop (didn't bet)
Seat 2: 5WLo/V8l3QfpUdK9JPp99w folded on the Flop
Seat 3: OXPkK84/qv92EMwXPiG5rQ folded before Flop (didn't bet)
Seat 4: F7pnn6czNpHvRM55XcA2EA folded before Flop (didn't bet)
Seat 5: +2kMBNpY4nF1qNCRd8SJLA folded before Flop (didn't bet)
Seat 6: sGFnnRCa1YAHAUmWgsW6Qg folded before Flop (didn't bet)
Seat 7: gehe91e0IyVT0QU/XBkEyg (button) folded before Flop (didn't bet)
Seat 8: LFnLiiWho1pLiR1Xvp5d/w (small blind) showed [5s Th] and lost with high card Ace
Seat 9: K0b5wNInj6hUGRr6yzKFtw (big blind) showed [3d 7h] and won ($1.70) with a pair of Threes




PokerStars Game #59941674178:  Hold'em No Limit ($0.10/$0.25) - 2009/07/01 1:42:36 ET
Table 'KAnP7XvDtlku47YfJwdOVw' 9-max Seat #4 is the button
Seat 1: cH3q40adP+kFogl+2MtbkQ ($14.50 in chips) 
Seat 2: VFTQG1/RfAKeMXRBv1ewsg ($28 in chips) 
Seat 3: W6tExOcYX7qiy6Qdp+ZwFA ($5.95 in chips) 
Seat 4: OiV1PWZ3IkN29JlmCcnTwQ ($4.65 in chips) 
Seat 5: MG90wfSJZnOejs/KD3vlQQ ($33.15 in chips) 
Seat 6: z5GxcHlYz/GSz6W2uFiTtg ($21.90 in chips) 
Seat 7: Lro4e37x4FUa5P3yzDjskw ($8.05 in chips) 
Seat 8: OneeONzF0MoH0pEdcBndwA ($22.80 in chips) 
Seat 9: HDDm1BkZtdsRyw2DJdqq6A ($24.30 in chips) 
MG90wfSJZnOejs/KD3vlQQ: posts small blind $0.10
z5GxcHlYz/GSz6W2uFiTtg: posts big blind $0.25
*** HOLE CARDS ***
Lro4e37x4FUa5P3yzDjskw: folds 
OneeONzF0MoH0pEdcBndwA: folds 
HDDm1BkZtdsRyw2DJdqq6A: calls $0.25
cH3q40adP+kFogl+2MtbkQ: folds 
VFTQG1/RfAKeMXRBv1ewsg: folds 
W6tExOcYX7qiy6Qdp+ZwFA: folds 
OiV1PWZ3IkN29JlmCcnTwQ: folds 
MG90wfSJZnOejs/KD3vlQQ: folds 
z5GxcHlYz/GSz6W2uFiTtg: checks 
*** FLOP *** [8c 9s 9c]
z5GxcHlYz/GSz6W2uFiTtg: checks 
HDDm1BkZtdsRyw2DJdqq6A: checks 
*** TURN *** [8c 9s 9c] [Jc]
z5GxcHlYz/GSz6W2uFiTtg: checks 
HDDm1BkZtdsRyw2DJdqq6A: checks 
*** RIVER *** [8c 9s 9c Jc] [Ad]
z5GxcHlYz/GSz6W2uFiTtg: checks 
HDDm1BkZtdsRyw2DJdqq6A: bets $0.50
z5GxcHlYz/GSz6W2uFiTtg: folds 
Uncalled bet ($0.50) returned to HDDm1BkZtdsRyw2DJdqq6A
z5GxcHlYz/GSz6W2uFiTtg is sitting out
HDDm1BkZtdsRyw2DJdqq6A collected $0.60 from pot
*** SUMMARY ***
Total pot $0.60 | Rake $0 
Board [8c 9s 9c Jc Ad]
Seat 1: cH3q40adP+kFogl+2MtbkQ folded before Flop (didn't bet)
Seat 2: VFTQG1/RfAKeMXRBv1ewsg folded before Flop (didn't bet)
Seat 3: W6tExOcYX7qiy6Qdp+ZwFA folded before Flop (didn't bet)
Seat 4: OiV1PWZ3IkN29JlmCcnTwQ (button) folded before Flop (didn't bet)
Seat 5: MG90wfSJZnOejs/KD3vlQQ (small blind) folded before Flop
Seat 6: z5GxcHlYz/GSz6W2uFiTtg (big blind) folded on the River
Seat 7: Lro4e37x4FUa5P3yzDjskw folded before Flop (didn't bet)
Seat 8: OneeONzF0MoH0pEdcBndwA folded before Flop (didn't bet)
Seat 9: HDDm1BkZtdsRyw2DJdqq6A collected ($0.60)




PokerStars Game #59941674168:  Hold'em No Limit ($0.10/$0.25) - 2009/07/01 1:42:36 ET
Table 'SgI2Cobdjtkh0Fd0/eTTDg' 9-max Seat #1 is the button
Seat 1: NcPAt5YjVvDFEJTTgAVj8g ($6.20 in chips) 
Seat 2: uUc5QTI8+ZdC95UnznCsqg ($13.40 in chips) 
Seat 3: OiV1PWZ3IkN29JlmCcnTwQ ($4.90 in chips) 
Seat 4: s1y+qfkBnhgc67+X3ThjeA ($10.25 in chips) 
Seat 5: w/RUHfVzKTf7Bc19nucLpQ ($23.70 in chips) 
Seat 6: 6RiVTYll/5D8zICp0MRpKw ($25.90 in chips) 
Seat 7: lOuxRXNpa9V2VxLMNpxUOg ($20.20 in chips) 
Seat 8: 8GJHzzxiotOqC5gdtgpLoA ($9.65 in chips) 
Seat 9: cZ99hugmLBj9KhTlc8nCSw ($30.95 in chips) 
uUc5QTI8+ZdC95UnznCsqg: posts small blind $0.10
OiV1PWZ3IkN29JlmCcnTwQ: posts big blind $0.25
*** HOLE CARDS ***
s1y+qfkBnhgc67+X3ThjeA: folds 
w/RUHfVzKTf7Bc19nucLpQ: folds 
6RiVTYll/5D8zICp0MRpKw: raises $0.50 to $0.75
lOuxRXNpa9V2VxLMNpxUOg: folds 
8GJHzzxiotOqC5gdtgpLoA: folds 
cZ99hugmLBj9KhTlc8nCSw: folds 
NcPAt5YjVvDFEJTTgAVj8g: folds 
uUc5QTI8+ZdC95UnznCsqg: folds 
OiV1PWZ3IkN29JlmCcnTwQ: folds 
Uncalled bet ($0.50) returned to 6RiVTYll/5D8zICp0MRpKw
6RiVTYll/5D8zICp0MRpKw collected $0.60 from pot
*** SUMMARY ***
Total pot $0.60 | Rake $0 
Seat 1: NcPAt5YjVvDFEJTTgAVj8g (button) folded before Flop (didn't bet)
Seat 2: uUc5QTI8+ZdC95UnznCsqg (small blind) folded before Flop
Seat 3: OiV1PWZ3IkN29JlmCcnTwQ (big blind) folded before Flop
Seat 4: s1y+qfkBnhgc67+X3ThjeA folded before Flop (didn't bet)
Seat 5: w/RUHfVzKTf7Bc19nucLpQ folded before Flop (didn't bet)
Seat 6: 6RiVTYll/5D8zICp0MRpKw collected ($0.60)
Seat 7: lOuxRXNpa9V2VxLMNpxUOg folded before Flop (didn't bet)
Seat 8: 8GJHzzxiotOqC5gdtgpLoA folded before Flop (didn't bet)
Seat 9: cZ99hugmLBj9KhTlc8nCSw folded before Flop (didn't bet)




PokerStars Game #59941674482:  Hold'em No Limit ($0.10/$0.25) - 2009/07/01 1:42:36 ET
Table 'xPn6TS/y/OWkX7Qa+MUuKA' 6-max Seat #2 is the button
Seat 1: JFIAqU8lCZ0vWwEl4bdGsg ($43.05 in chips) 
Seat 2: buyjetgNT1McXtdaP4zynA ($30.10 in chips) 
Seat 3: q6WfTUAD9mowIP63ASq2Dg ($25.15 in chips) 
Seat 4: SS/yfeArhULzIcOPe8MdPg ($26.90 in chips) 
Seat 5: lquriepNQBhDV5P1SWHhnA ($26.85 in chips) 
Seat 6: DihMHaz4WNETH1bPDe13kA ($25 in chips) 
q6WfTUAD9mowIP63ASq2Dg: posts small blind $0.10
SS/yfeArhULzIcOPe8MdPg: posts big blind $0.25
*** HOLE CARDS ***
lquriepNQBhDV5P1SWHhnA: folds 
DihMHaz4WNETH1bPDe13kA: folds 
JFIAqU8lCZ0vWwEl4bdGsg: folds 
buyjetgNT1McXtdaP4zynA: calls $0.25
q6WfTUAD9mowIP63ASq2Dg: calls $0.15
SS/yfeArhULzIcOPe8MdPg: checks 
*** FLOP *** [4c 4d Qs]
q6WfTUAD9mowIP63ASq2Dg: checks 
SS/yfeArhULzIcOPe8MdPg: bets $0.50
buyjetgNT1McXtdaP4zynA: calls $0.50
q6WfTUAD9mowIP63ASq2Dg: folds 
*** TURN *** [4c 4d Qs] [9s]
SS/yfeArhULzIcOPe8MdPg: checks 
buyjetgNT1McXtdaP4zynA: bets $1
SS/yfeArhULzIcOPe8MdPg: calls $1
*** RIVER *** [4c 4d Qs 9s] [Qc]
SS/yfeArhULzIcOPe8MdPg: bets $2
buyjetgNT1McXtdaP4zynA: folds 
Uncalled bet ($2) returned to SS/yfeArhULzIcOPe8MdPg
SS/yfeArhULzIcOPe8MdPg collected $3.60 from pot
SS/yfeArhULzIcOPe8MdPg: doesn't show hand 
*** SUMMARY ***
Total pot $3.75 | Rake $0.15 
Board [4c 4d Qs 9s Qc]
Seat 1: JFIAqU8lCZ0vWwEl4bdGsg folded before Flop (didn't bet)
Seat 2: buyjetgNT1McXtdaP4zynA (button) folded on the River
Seat 3: q6WfTUAD9mowIP63ASq2Dg (small blind) folded on the Flop
Seat 4: SS/yfeArhULzIcOPe8MdPg (big blind) collected ($3.60)
Seat 5: lquriepNQBhDV5P1SWHhnA folded before Flop (didn't bet)
Seat 6: DihMHaz4WNETH1bPDe13kA folded before Flop (didn't bet)




PokerStars Game #59941675154:  Hold'em No Limit ($0.10/$0.25) - 2009/07/01 1:42:37 ET
Table 'edvgY2YQ1I34euq4EVqGnA' 6-max Seat #3 is the button
Seat 1: mvFHK3pE7tCxJEqLjKC70Q ($25.25 in chips) 
Seat 2: SxIIgwXYLkwd6m3wLyPTCw ($15.90 in chips) 
Seat 3: mFv3iBCtrw9XfCDRB0d46Q ($3.55 in chips) 
Seat 4: TI/C5Q+DEl4fLR3AofwYdg ($19.25 in chips) 
Seat 5: EE16Ua5b1HSsYej5zeXOlA ($56.45 in chips) 
Seat 6: kG34n23qFQA3nzdOJTQ1dA ($72.35 in chips) 
TI/C5Q+DEl4fLR3AofwYdg: posts small blind $0.10
EE16Ua5b1HSsYej5zeXOlA: posts big blind $0.25
*** HOLE CARDS ***
kG34n23qFQA3nzdOJTQ1dA: folds 
mvFHK3pE7tCxJEqLjKC70Q: folds 
SxIIgwXYLkwd6m3wLyPTCw: folds 
mFv3iBCtrw9XfCDRB0d46Q: folds 
TI/C5Q+DEl4fLR3AofwYdg: folds 
Uncalled bet ($0.15) returned to EE16Ua5b1HSsYej5zeXOlA
EE16Ua5b1HSsYej5zeXOlA collected $0.20 from pot
EE16Ua5b1HSsYej5zeXOlA: doesn't show hand 
*** SUMMARY ***
Total pot $0.20 | Rake $0 
Seat 1: mvFHK3pE7tCxJEqLjKC70Q folded before Flop (didn't bet)
Seat 2: SxIIgwXYLkwd6m3wLyPTCw folded before Flop (didn't bet)
Seat 3: mFv3iBCtrw9XfCDRB0d46Q (button) folded before Flop (didn't bet)
Seat 4: TI/C5Q+DEl4fLR3AofwYdg (small blind) folded before Flop
Seat 5: EE16Ua5b1HSsYej5zeXOlA (big blind) collected ($0.20)
Seat 6: kG34n23qFQA3nzdOJTQ1dA folded before Flop (didn't bet)




PokerStars Game #59941674704:  Hold'em No Limit ($0.10/$0.25) - 2009/07/01 1:42:37 ET
Table '5NipxzzFB2DffzDpddyQoQ' 6-max Seat #6 is the button
Seat 1: W87HPwOk1KtWaYyshBe1gA ($21.35 in chips) 
Seat 2: iauW7L/+7qzAuHow7CD75Q ($9.85 in chips) 
Seat 3: QvTX2yGq3uKJiKPmns4TKQ ($18.90 in chips) 
Seat 4: NTamLAiMZ86c5yM04t96LA ($16.60 in chips) 
Seat 5: faP2NVl/cFTZ1nE4pXzg8Q ($36.50 in chips) 
Seat 6: 7JqTFMyeNSVWsmp/yW35Tw ($12.95 in chips) 
W87HPwOk1KtWaYyshBe1gA: posts small blind $0.10
iauW7L/+7qzAuHow7CD75Q: posts big blind $0.25
*** HOLE CARDS ***
QvTX2yGq3uKJiKPmns4TKQ: folds 
NTamLAiMZ86c5yM04t96LA said, "55 again"
NTamLAiMZ86c5yM04t96LA: calls $0.25
faP2NVl/cFTZ1nE4pXzg8Q: calls $0.25
7JqTFMyeNSVWsmp/yW35Tw: folds 
W87HPwOk1KtWaYyshBe1gA: folds 
iauW7L/+7qzAuHow7CD75Q: checks 
*** FLOP *** [2s Jd Tc]
iauW7L/+7qzAuHow7CD75Q: checks 
NTamLAiMZ86c5yM04t96LA: checks 
faP2NVl/cFTZ1nE4pXzg8Q: checks 
*** TURN *** [2s Jd Tc] [Kh]
iauW7L/+7qzAuHow7CD75Q: checks 
NTamLAiMZ86c5yM04t96LA: checks 
faP2NVl/cFTZ1nE4pXzg8Q: bets $1.25
iauW7L/+7qzAuHow7CD75Q: folds 
NTamLAiMZ86c5yM04t96LA: folds 
Uncalled bet ($1.25) returned to faP2NVl/cFTZ1nE4pXzg8Q
faP2NVl/cFTZ1nE4pXzg8Q collected $0.85 from pot
faP2NVl/cFTZ1nE4pXzg8Q: shows [As Kd] (a pair of Kings)
*** SUMMARY ***
Total pot $0.85 | Rake $0 
Board [2s Jd Tc Kh]
Seat 1: W87HPwOk1KtWaYyshBe1gA (small blind) folded before Flop
Seat 2: iauW7L/+7qzAuHow7CD75Q (big blind) folded on the Turn
Seat 3: QvTX2yGq3uKJiKPmns4TKQ folded before Flop (didn't bet)
Seat 4: NTamLAiMZ86c5yM04t96LA folded on the Turn
Seat 5: faP2NVl/cFTZ1nE4pXzg8Q collected ($0.85)
Seat 6: 7JqTFMyeNSVWsmp/yW35Tw (button) folded before Flop (didn't bet)




PokerStars Game #59941674980:  Hold'em No Limit ($0.10/$0.25) - 2009/07/01 1:42:37 ET
Table 'rjcb+nlE+0GuJ6lBhuCkkA' 6-max Seat #1 is the button
Seat 1: lBoEwOFgzcERLIRUkUoRTw ($13.60 in chips) 
Seat 2: lJphax9e7/+O/3YCKPJ0yQ ($6.10 in chips) 
Seat 3: 8ClCHtFXGNplITm+63KB+Q ($66.50 in chips) 
Seat 4: BV+K0Phf5VBHr7aZPKqbUQ ($25 in chips) 
Seat 5: GC/9yVD59DUCX7hUI7gcLw ($41.75 in chips) 
Seat 6: 32YL2ZEp8NT4JB2RVM9euQ ($15.65 in chips) 
lJphax9e7/+O/3YCKPJ0yQ: posts small blind $0.10
8ClCHtFXGNplITm+63KB+Q: posts big blind $0.25
*** HOLE CARDS ***
BV+K0Phf5VBHr7aZPKqbUQ: folds 
GC/9yVD59DUCX7hUI7gcLw: folds 
32YL2ZEp8NT4JB2RVM9euQ: folds 
lBoEwOFgzcERLIRUkUoRTw: folds 
lJphax9e7/+O/3YCKPJ0yQ: calls $0.15
8ClCHtFXGNplITm+63KB+Q: checks 
*** FLOP *** [Jh 8h 3d]
lJphax9e7/+O/3YCKPJ0yQ: bets $0.25
8ClCHtFXGNplITm+63KB+Q: folds 
Uncalled bet ($0.25) returned to lJphax9e7/+O/3YCKPJ0yQ
lJphax9e7/+O/3YCKPJ0yQ collected $0.50 from pot
*** SUMMARY ***
Total pot $0.50 | Rake $0 
Board [Jh 8h 3d]
Seat 1: lBoEwOFgzcERLIRUkUoRTw (button) folded before Flop (didn't bet)
Seat 2: lJphax9e7/+O/3YCKPJ0yQ (small blind) collected ($0.50)
Seat 3: 8ClCHtFXGNplITm+63KB+Q (big blind) folded on the Flop
Seat 4: BV+K0Phf5VBHr7aZPKqbUQ folded before Flop (didn't bet)
Seat 5: GC/9yVD59DUCX7hUI7gcLw folded before Flop (didn't bet)
Seat 6: 32YL2ZEp8NT4JB2RVM9euQ folded before Flop (didn't bet)




PokerStars Game #59941675268:  Hold'em No Limit ($0.10/$0.25) - 2009/07/01 1:42:37 ET
Table 'Ez9TB43XM4QgMDQkIW9DYw' 9-max Seat #8 is the button
Seat 1: ShCS62CJp4MKfKLKvGKQbA ($5.05 in chips) 
Seat 2: PFNLAvMkr8qKc7xCiH0wTA ($14.85 in chips) 
Seat 5: qpG9m8I+cPw8VhB0mnGjYw ($32.80 in chips) 
Seat 6: 76o85YBHJ9veRYp2LPuluQ ($3.50 in chips) 
Seat 7: Bb42QRQMhg5/Y0vHP8/2Xw ($58.45 in chips) 
Seat 8: +2kMBNpY4nF1qNCRd8SJLA ($28.75 in chips) 
Seat 9: QEbIGci+itdw+re8RM5fZA ($25 in chips) 
QEbIGci+itdw+re8RM5fZA: posts small blind $0.10
ShCS62CJp4MKfKLKvGKQbA: posts big blind $0.25
PdIasPkzm2sqZnN41ZRXOg: sits out 
ubsjZomMWSV0hAiBLa7K1A: sits out 
*** HOLE CARDS ***
PFNLAvMkr8qKc7xCiH0wTA: folds 
qpG9m8I+cPw8VhB0mnGjYw: calls $0.25
76o85YBHJ9veRYp2LPuluQ: folds 
Bb42QRQMhg5/Y0vHP8/2Xw: folds 
+2kMBNpY4nF1qNCRd8SJLA: folds 
QEbIGci+itdw+re8RM5fZA: folds 
ShCS62CJp4MKfKLKvGKQbA: checks 
*** FLOP *** [3h 9c Ad]
ShCS62CJp4MKfKLKvGKQbA: checks 
qpG9m8I+cPw8VhB0mnGjYw: checks 
*** TURN *** [3h 9c Ad] [8h]
ShCS62CJp4MKfKLKvGKQbA: checks 
qpG9m8I+cPw8VhB0mnGjYw: bets $0.50
ShCS62CJp4MKfKLKvGKQbA: folds 
Uncalled bet ($0.50) returned to qpG9m8I+cPw8VhB0mnGjYw
qpG9m8I+cPw8VhB0mnGjYw collected $0.60 from pot
qpG9m8I+cPw8VhB0mnGjYw: doesn't show hand 
*** SUMMARY ***
Total pot $0.60 | Rake $0 
Board [3h 9c Ad 8h]
Seat 1: ShCS62CJp4MKfKLKvGKQbA (big blind) folded on the Turn
Seat 2: PFNLAvMkr8qKc7xCiH0wTA folded before Flop (didn't bet)
Seat 5: qpG9m8I+cPw8VhB0mnGjYw collected ($0.60)
Seat 6: 76o85YBHJ9veRYp2LPuluQ folded before Flop (didn't bet)
Seat 7: Bb42QRQMhg5/Y0vHP8/2Xw folded before Flop (didn't bet)
Seat 8: +2kMBNpY4nF1qNCRd8SJLA (button) folded before Flop (didn't bet)
Seat 9: QEbIGci+itdw+re8RM5fZA (small blind) folded before Flop




PokerStars Game #59941674792:  Hold'em No Limit ($0.10/$0.25) - 2009/07/01 1:42:37 ET
Table 'GrYi0DZOHD1EvB+qiLExNw' 9-max Seat #1 is the button
Seat 1: sk7OEPqYdQE7GJKyQHkssg ($13 in chips) 
Seat 2: Th3FldXKQW6hWVVPahaoOQ ($46.80 in chips) 
Seat 4: 8x95tVlB4uFBVHp71KihMA ($25.90 in chips) 
Seat 5: cZ99hugmLBj9KhTlc8nCSw ($25.30 in chips) 
Seat 6: arxNSjreDRGFg13EAM2F1w ($25.25 in chips) 
Seat 7: 9lvO/qyU+xrU95Teu1fv0g ($19.35 in chips) 
Seat 8: MtVtHDqIJTyUcXkRBBDIVA ($25 in chips) 
Seat 9: 5hAPbqNrvJb8PtLiceXtlg ($13.40 in chips) 
Th3FldXKQW6hWVVPahaoOQ: posts small blind $0.10
TFFS: is sitting out 
8x95tVlB4uFBVHp71KihMA: posts big blind $0.25
*** HOLE CARDS ***
TFFS leaves the table
cZ99hugmLBj9KhTlc8nCSw: folds 
arxNSjreDRGFg13EAM2F1w: folds 
9lvO/qyU+xrU95Teu1fv0g: folds 
MtVtHDqIJTyUcXkRBBDIVA: raises $0.75 to $1
5hAPbqNrvJb8PtLiceXtlg: folds 
sk7OEPqYdQE7GJKyQHkssg: folds 
Th3FldXKQW6hWVVPahaoOQ: folds 
RHqgdFvufLCYe54+qd2gcA joins the table at seat #3 
8x95tVlB4uFBVHp71KihMA: calls $0.75
*** FLOP *** [2d 9d 5d]
8x95tVlB4uFBVHp71KihMA: checks 
MtVtHDqIJTyUcXkRBBDIVA: bets $1.75
8x95tVlB4uFBVHp71KihMA: calls $1.75
*** TURN *** [2d 9d 5d] [6s]
8x95tVlB4uFBVHp71KihMA: checks 
MtVtHDqIJTyUcXkRBBDIVA: bets $3.75
8x95tVlB4uFBVHp71KihMA: raises $4 to $7.75
MtVtHDqIJTyUcXkRBBDIVA: calls $4
*** RIVER *** [2d 9d 5d 6s] [2s]
8x95tVlB4uFBVHp71KihMA: bets $5.75
MtVtHDqIJTyUcXkRBBDIVA said, "sick"
MtVtHDqIJTyUcXkRBBDIVA: folds 
Uncalled bet ($5.75) returned to 8x95tVlB4uFBVHp71KihMA
8x95tVlB4uFBVHp71KihMA collected $20.10 from pot
*** SUMMARY ***
Total pot $21.10 | Rake $1 
Board [2d 9d 5d 6s 2s]
Seat 1: sk7OEPqYdQE7GJKyQHkssg (button) folded before Flop (didn't bet)
Seat 2: Th3FldXKQW6hWVVPahaoOQ (small blind) folded before Flop
Seat 4: 8x95tVlB4uFBVHp71KihMA (big blind) collected ($20.10)
Seat 5: cZ99hugmLBj9KhTlc8nCSw folded before Flop (didn't bet)
Seat 6: arxNSjreDRGFg13EAM2F1w folded before Flop (didn't bet)
Seat 7: 9lvO/qyU+xrU95Teu1fv0g folded before Flop (didn't bet)
Seat 8: MtVtHDqIJTyUcXkRBBDIVA folded on the River
Seat 9: 5hAPbqNrvJb8PtLiceXtlg folded before Flop (didn't bet)




PokerStars Game #59941675190:  Hold'em No Limit ($0.10/$0.25) - 2009/07/01 1:42:37 ET
Table 'QegsWX65l3n/K0A8XB78yg' 6-max Seat #5 is the button
Seat 1: p6adJRMXMBLr+xtQzqazIQ ($12.35 in chips) 
Seat 2: GC/9yVD59DUCX7hUI7gcLw ($50.90 in chips) 
Seat 3: 1lxYIAoJdZwAbzIkzWmSkw ($1.40 in chips) 
Seat 5: OMGl+YMGogf2JWIRfT2/Yg ($9.90 in chips) 
Seat 6: 5PWs02z65jSO5pr/M6wx/w ($4.60 in chips) 
5PWs02z65jSO5pr/M6wx/w: posts small blind $0.10
p6adJRMXMBLr+xtQzqazIQ: posts big blind $0.25
epAUIB7h2FJXzUPRIvSkRA: sits out 
*** HOLE CARDS ***
GC/9yVD59DUCX7hUI7gcLw: folds 
1lxYIAoJdZwAbzIkzWmSkw: raises $1.15 to $1.40 and is all-in
OMGl+YMGogf2JWIRfT2/Yg: folds 
5PWs02z65jSO5pr/M6wx/w: folds 
p6adJRMXMBLr+xtQzqazIQ: calls $1.15
*** FLOP *** [3h 5d 3c]
*** TURN *** [3h 5d 3c] [8c]
*** RIVER *** [3h 5d 3c 8c] [Qd]
*** SHOW DOWN ***
p6adJRMXMBLr+xtQzqazIQ: shows [Ac 3d] (three of a kind, Threes)
1lxYIAoJdZwAbzIkzWmSkw: mucks hand 
p6adJRMXMBLr+xtQzqazIQ collected $2.80 from pot
*** SUMMARY ***
Total pot $2.90 | Rake $0.10 
Board [3h 5d 3c 8c Qd]
Seat 1: p6adJRMXMBLr+xtQzqazIQ (big blind) showed [Ac 3d] and won ($2.80) with three of a kind, Threes
Seat 2: GC/9yVD59DUCX7hUI7gcLw folded before Flop (didn't bet)
Seat 3: 1lxYIAoJdZwAbzIkzWmSkw mucked
Seat 5: OMGl+YMGogf2JWIRfT2/Yg (button) folded before Flop (didn't bet)
Seat 6: 5PWs02z65jSO5pr/M6wx/w (small blind) folded before Flop




PokerStars Game #59941674798:  Hold'em No Limit ($0.10/$0.25) - 2009/07/01 1:42:37 ET
Table 'VuY5ej47Cy8nOI3Wogmhzw' 6-max Seat #2 is the button
Seat 1: EeUZtMU058v2ObUACOF4Og ($37.85 in chips) 
Seat 2: AM6Yl+3esmhhMBlSnQhWbg ($19 in chips) 
Seat 3: v+QfkGiuj9bgtuNoVnDO8w ($29.75 in chips) 
Seat 4: bj4ouH72+hnabFw65V/TLg ($25 in chips) 
Seat 5: iK/41//HmnLiIn0CVNNfyA ($11.30 in chips) 
v+QfkGiuj9bgtuNoVnDO8w: posts small blind $0.10
bj4ouH72+hnabFw65V/TLg: posts big blind $0.25
*** HOLE CARDS ***
iK/41//HmnLiIn0CVNNfyA: folds 
EeUZtMU058v2ObUACOF4Og: raises $0.75 to $1
AM6Yl+3esmhhMBlSnQhWbg: folds 
v+QfkGiuj9bgtuNoVnDO8w: folds 
bj4ouH72+hnabFw65V/TLg: folds 
Uncalled bet ($0.75) returned to EeUZtMU058v2ObUACOF4Og
bj4ouH72+hnabFw65V/TLg leaves the table
EeUZtMU058v2ObUACOF4Og collected $0.60 from pot
EeUZtMU058v2ObUACOF4Og: doesn't show hand 
*** SUMMARY ***
Total pot $0.60 | Rake $0 
Seat 1: EeUZtMU058v2ObUACOF4Og collected ($0.60)
Seat 2: AM6Yl+3esmhhMBlSnQhWbg (button) folded before Flop (didn't bet)
Seat 3: v+QfkGiuj9bgtuNoVnDO8w (small blind) folded before Flop
Seat 4: bj4ouH72+hnabFw65V/TLg (big blind) folded before Flop
Seat 5: iK/41//HmnLiIn0CVNNfyA folded before Flop (didn't bet)




PokerStars Game #59941675530:  Hold'em No Limit ($0.10/$0.25) - 2009/07/01 1:42:38 ET
Table 'UVjmXTtsmlX1HxwwZ59akg' 9-max Seat #2 is the button
Seat 2: q+Qdg0Hoir+SyL7haBrUnw ($8.05 in chips) 
Seat 3: GmzfAfxcxu1kGbPC+9LkVg ($24.75 in chips) 
Seat 4: X78b5v/uhqeXXoAijbw/yg ($25 in chips) 
Seat 5: Bb42QRQMhg5/Y0vHP8/2Xw ($39.95 in chips) 
Seat 6: st9jtdNbm1W5GfBwRaCVqQ ($24.30 in chips) 
Seat 7: pB8IyCfDFZaVpov3NHEVJg ($25.25 in chips) 
Seat 8: aqxuKnMZWHy08QjWq1+MrQ ($2.40 in chips) 
GmzfAfxcxu1kGbPC+9LkVg: posts small blind $0.10
X78b5v/uhqeXXoAijbw/yg: posts big blind $0.25
ljemhp25Zg+nlA9DLCIiUw: sits out 
*** HOLE CARDS ***
Bb42QRQMhg5/Y0vHP8/2Xw: folds 
st9jtdNbm1W5GfBwRaCVqQ: folds 
pB8IyCfDFZaVpov3NHEVJg: folds 
aqxuKnMZWHy08QjWq1+MrQ: calls $0.25
q+Qdg0Hoir+SyL7haBrUnw: folds 
GmzfAfxcxu1kGbPC+9LkVg: folds 
X78b5v/uhqeXXoAijbw/yg: checks 
*** FLOP *** [9h 3s 4s]
X78b5v/uhqeXXoAijbw/yg: checks 
aqxuKnMZWHy08QjWq1+MrQ: bets $0.25
X78b5v/uhqeXXoAijbw/yg: folds 
Uncalled bet ($0.25) returned to aqxuKnMZWHy08QjWq1+MrQ
aqxuKnMZWHy08QjWq1+MrQ collected $0.60 from pot
*** SUMMARY ***
Total pot $0.60 | Rake $0 
Board [9h 3s 4s]
Seat 2: q+Qdg0Hoir+SyL7haBrUnw (button) folded before Flop (didn't bet)
Seat 3: GmzfAfxcxu1kGbPC+9LkVg (small blind) folded before Flop
Seat 4: X78b5v/uhqeXXoAijbw/yg (big blind) folded on the Flop
Seat 5: Bb42QRQMhg5/Y0vHP8/2Xw folded before Flop (didn't bet)
Seat 6: st9jtdNbm1W5GfBwRaCVqQ folded before Flop (didn't bet)
Seat 7: pB8IyCfDFZaVpov3NHEVJg folded before Flop (didn't bet)
Seat 8: aqxuKnMZWHy08QjWq1+MrQ collected ($0.60)




PokerStars Game #59941675624:  Hold'em No Limit ($0.10/$0.25) - 2009/07/01 1:42:38 ET
Table '4XGDnEByOol5up4aB2KbJw' 6-max Seat #5 is the button
Seat 1: kyRaCIljYA6l33lSKQfNsg ($26.85 in chips) 
Seat 2: SFmT9ZsVopnukjvAzrxTRg ($44.15 in chips) 
Seat 3: LtASJ9OlkqGrrUKGQlpGAw ($20.55 in chips) 
Seat 4: BV+K0Phf5VBHr7aZPKqbUQ ($26.50 in chips) 
Seat 5: Dh01+rohD2p9pXLYeBlC5Q ($16.40 in chips) 
Seat 6: a7Ux7aERFGCbT/L3ojVfAg ($9.10 in chips) 
a7Ux7aERFGCbT/L3ojVfAg: posts small blind $0.10
kyRaCIljYA6l33lSKQfNsg: posts big blind $0.25
*** HOLE CARDS ***
SFmT9ZsVopnukjvAzrxTRg: folds 
LtASJ9OlkqGrrUKGQlpGAw: folds 
BV+K0Phf5VBHr7aZPKqbUQ: folds 
Dh01+rohD2p9pXLYeBlC5Q: calls $0.25
a7Ux7aERFGCbT/L3ojVfAg: folds 
kyRaCIljYA6l33lSKQfNsg: checks 
*** FLOP *** [Jh 2h 5c]
kyRaCIljYA6l33lSKQfNsg: checks 
Dh01+rohD2p9pXLYeBlC5Q: checks 
*** TURN *** [Jh 2h 5c] [As]
kyRaCIljYA6l33lSKQfNsg: checks 
Dh01+rohD2p9pXLYeBlC5Q: checks 
*** RIVER *** [Jh 2h 5c As] [2d]
kyRaCIljYA6l33lSKQfNsg: checks 
Dh01+rohD2p9pXLYeBlC5Q: bets $0.75
kyRaCIljYA6l33lSKQfNsg: folds 
Uncalled bet ($0.75) returned to Dh01+rohD2p9pXLYeBlC5Q
Dh01+rohD2p9pXLYeBlC5Q collected $0.60 from pot
*** SUMMARY ***
Total pot $0.60 | Rake $0 
Board [Jh 2h 5c As 2d]
Seat 1: kyRaCIljYA6l33lSKQfNsg (big blind) folded on the River
Seat 2: SFmT9ZsVopnukjvAzrxTRg folded before Flop (didn't bet)
Seat 3: LtASJ9OlkqGrrUKGQlpGAw folded before Flop (didn't bet)
Seat 4: BV+K0Phf5VBHr7aZPKqbUQ folded before Flop (didn't bet)
Seat 5: Dh01+rohD2p9pXLYeBlC5Q (button) collected ($0.60)
Seat 6: a7Ux7aERFGCbT/L3ojVfAg (small blind) folded before Flop




PokerStars Game #59941675402:  Hold'em No Limit ($0.10/$0.25) - 2009/07/01 1:42:38 ET
Table 'ukli1Y7ieC5JQMTEFxM2Nw' 6-max Seat #3 is the button
Seat 1: N162H80ZIQevUf2EzGahCA ($10.05 in chips) 
Seat 2: u/yN5P9f3KlATg6WLWNkBQ ($43.55 in chips) 
Seat 3: ExeoJ1G/rSmWa3tRz7TlCA ($20.20 in chips) 
Seat 4: if4dh6jhJXeN3/qd3qCp9g ($29.60 in chips) 
Seat 5: Se+H4Z4PDr6+eIUDJX1rpg ($16.85 in chips) 
Seat 6: 32YL2ZEp8NT4JB2RVM9euQ ($29.55 in chips) 
if4dh6jhJXeN3/qd3qCp9g: posts small blind $0.10
Se+H4Z4PDr6+eIUDJX1rpg: posts big blind $0.25
*** HOLE CARDS ***
32YL2ZEp8NT4JB2RVM9euQ: folds 
N162H80ZIQevUf2EzGahCA: calls $0.25
u/yN5P9f3KlATg6WLWNkBQ: folds 
ExeoJ1G/rSmWa3tRz7TlCA: calls $0.25
if4dh6jhJXeN3/qd3qCp9g: raises $1 to $1.25
Se+H4Z4PDr6+eIUDJX1rpg: calls $1
N162H80ZIQevUf2EzGahCA: calls $1
ExeoJ1G/rSmWa3tRz7TlCA: calls $1
*** FLOP *** [9c Td Jc]
if4dh6jhJXeN3/qd3qCp9g: checks 
Se+H4Z4PDr6+eIUDJX1rpg: checks 
N162H80ZIQevUf2EzGahCA: checks 
ExeoJ1G/rSmWa3tRz7TlCA: bets $4
if4dh6jhJXeN3/qd3qCp9g: folds 
Se+H4Z4PDr6+eIUDJX1rpg: folds 
N162H80ZIQevUf2EzGahCA: folds 
Uncalled bet ($4) returned to ExeoJ1G/rSmWa3tRz7TlCA
ExeoJ1G/rSmWa3tRz7TlCA collected $4.75 from pot
*** SUMMARY ***
Total pot $5 | Rake $0.25 
Board [9c Td Jc]
Seat 1: N162H80ZIQevUf2EzGahCA folded on the Flop
Seat 2: u/yN5P9f3KlATg6WLWNkBQ folded before Flop (didn't bet)
Seat 3: ExeoJ1G/rSmWa3tRz7TlCA (button) collected ($4.75)
Seat 4: if4dh6jhJXeN3/qd3qCp9g (small blind) folded on the Flop
Seat 5: Se+H4Z4PDr6+eIUDJX1rpg (big blind) folded on the Flop
Seat 6: 32YL2ZEp8NT4JB2RVM9euQ folded before Flop (didn't bet)




PokerStars Game #59941675764:  Hold'em No Limit ($0.10/$0.25) - 2009/07/01 1:42:38 ET
Table 'wRXcD9iXgBbdvKhWmfnBnw' 6-max Seat #3 is the button
Seat 1: iIgNoBh+3/Ix1/fLsg+HuA ($5.20 in chips) 
Seat 2: vUr8qM1UsCElsCI9B/McdQ ($27.90 in chips) 
Seat 3: l4ToKwb3EVcEuva7hPqMCQ ($8.35 in chips) 
Seat 4: 7NY6Es0O5qlPDxirJ9iU4g ($4.25 in chips) 
Seat 5: EE16Ua5b1HSsYej5zeXOlA ($44 in chips) 
Seat 6: JFIAqU8lCZ0vWwEl4bdGsg ($25 in chips) 
7NY6Es0O5qlPDxirJ9iU4g: posts small blind $0.10
EE16Ua5b1HSsYej5zeXOlA: posts big blind $0.25
iIgNoBh+3/Ix1/fLsg+HuA: posts big blind $0.25
*** HOLE CARDS ***
JFIAqU8lCZ0vWwEl4bdGsg: folds 
iIgNoBh+3/Ix1/fLsg+HuA: raises $0.50 to $0.75
vUr8qM1UsCElsCI9B/McdQ: calls $0.75
l4ToKwb3EVcEuva7hPqMCQ: folds 
7NY6Es0O5qlPDxirJ9iU4g: folds 
EE16Ua5b1HSsYej5zeXOlA: folds 
*** FLOP *** [Qc 7s 6h]
iIgNoBh+3/Ix1/fLsg+HuA: bets $1.25
7NY6Es0O5qlPDxirJ9iU4g leaves the table
vUr8qM1UsCElsCI9B/McdQ: folds 
Uncalled bet ($1.25) returned to iIgNoBh+3/Ix1/fLsg+HuA
iIgNoBh+3/Ix1/fLsg+HuA collected $1.80 from pot
iIgNoBh+3/Ix1/fLsg+HuA: doesn't show hand 
*** SUMMARY ***
Total pot $1.85 | Rake $0.05 
Board [Qc 7s 6h]
Seat 1: iIgNoBh+3/Ix1/fLsg+HuA collected ($1.80)
Seat 2: vUr8qM1UsCElsCI9B/McdQ folded on the Flop
Seat 3: l4ToKwb3EVcEuva7hPqMCQ (button) folded before Flop (didn't bet)
Seat 4: 7NY6Es0O5qlPDxirJ9iU4g (small blind) folded before Flop
Seat 5: EE16Ua5b1HSsYej5zeXOlA (big blind) folded before Flop
Seat 6: JFIAqU8lCZ0vWwEl4bdGsg folded before Flop (didn't bet)




PokerStars Game #59941676094:  Hold'em No Limit ($0.10/$0.25) - 2009/07/01 1:42:39 ET
Table '6wawJ+MkkvuC3coG6r+Yhg' 6-max Seat #2 is the button
Seat 1: JQZew0FjzS19kTjeNtrE+A ($28.25 in chips) 
Seat 2: LtASJ9OlkqGrrUKGQlpGAw ($33.60 in chips) 
Seat 3: 3zD3qLXT1bEffAoWGnc7wg ($59.60 in chips) 
Seat 4: yxmjNFGiKI3b+XQGJzJVIg ($28.30 in chips) 
Seat 5: FZrgDbxAanC1xwZxXHJKVA ($2.85 in chips) 
Seat 6: B3X187C0tXFUfQpCu8pe8A ($27.10 in chips) 
3zD3qLXT1bEffAoWGnc7wg: posts small blind $0.10
yxmjNFGiKI3b+XQGJzJVIg: posts big blind $0.25
*** HOLE CARDS ***
FZrgDbxAanC1xwZxXHJKVA: calls $0.25
B3X187C0tXFUfQpCu8pe8A: folds 
JQZew0FjzS19kTjeNtrE+A: folds 
LtASJ9OlkqGrrUKGQlpGAw: folds 
3zD3qLXT1bEffAoWGnc7wg: folds 
yxmjNFGiKI3b+XQGJzJVIg: checks 
*** FLOP *** [2d 7h 6s]
yxmjNFGiKI3b+XQGJzJVIg: checks 
FZrgDbxAanC1xwZxXHJKVA: checks 
*** TURN *** [2d 7h 6s] [Ac]
yxmjNFGiKI3b+XQGJzJVIg: checks 
FZrgDbxAanC1xwZxXHJKVA: bets $0.50
yxmjNFGiKI3b+XQGJzJVIg: folds 
Uncalled bet ($0.50) returned to FZrgDbxAanC1xwZxXHJKVA
FZrgDbxAanC1xwZxXHJKVA collected $0.60 from pot
*** SUMMARY ***
Total pot $0.60 | Rake $0 
Board [2d 7h 6s Ac]
Seat 1: JQZew0FjzS19kTjeNtrE+A folded before Flop (didn't bet)
Seat 2: LtASJ9OlkqGrrUKGQlpGAw (button) folded before Flop (didn't bet)
Seat 3: 3zD3qLXT1bEffAoWGnc7wg (small blind) folded before Flop
Seat 4: yxmjNFGiKI3b+XQGJzJVIg (big blind) folded on the Turn
Seat 5: FZrgDbxAanC1xwZxXHJKVA collected ($0.60)
Seat 6: B3X187C0tXFUfQpCu8pe8A folded before Flop (didn't bet)




PokerStars Game #59941676164:  Hold'em No Limit ($0.10/$0.25) - 2009/07/01 1:42:39 ET
Table 'C47I7CmrmFr8Oo7wOovVwQ' 6-max Seat #3 is the button
Seat 1: v6mkGzCBCCXcgWQNSYVtKg ($6.75 in chips) 
Seat 2: hOaWAImn5/MZDAWAPlYHCw ($5.15 in chips) 
Seat 3: H+8eOP3XJHXjACRDTiIHTQ ($15.65 in chips) 
Seat 4: yY5JuFtDfXWRaZlVby4LLw ($10.25 in chips) 
Seat 5: or309yYY9Y9bfFWtrB0yUg ($12.40 in chips) 
Seat 6: pD7ri5wL3vsa6S1ulMYQmQ ($25 in chips) 
yY5JuFtDfXWRaZlVby4LLw: posts small blind $0.10
or309yYY9Y9bfFWtrB0yUg: posts big blind $0.25
*** HOLE CARDS ***
pD7ri5wL3vsa6S1ulMYQmQ: folds 
v6mkGzCBCCXcgWQNSYVtKg: folds 
hOaWAImn5/MZDAWAPlYHCw: folds 
H+8eOP3XJHXjACRDTiIHTQ: folds 
yY5JuFtDfXWRaZlVby4LLw: folds 
Uncalled bet ($0.15) returned to or309yYY9Y9bfFWtrB0yUg
or309yYY9Y9bfFWtrB0yUg collected $0.20 from pot
*** SUMMARY ***
Total pot $0.20 | Rake $0 
Seat 1: v6mkGzCBCCXcgWQNSYVtKg folded before Flop (didn't bet)
Seat 2: hOaWAImn5/MZDAWAPlYHCw folded before Flop (didn't bet)
Seat 3: H+8eOP3XJHXjACRDTiIHTQ (button) folded before Flop (didn't bet)
Seat 4: yY5JuFtDfXWRaZlVby4LLw (small blind) folded before Flop
Seat 5: or309yYY9Y9bfFWtrB0yUg (big blind) collected ($0.20)
Seat 6: pD7ri5wL3vsa6S1ulMYQmQ folded before Flop (didn't bet)




PokerStars Game #59941676156:  Hold'em No Limit ($0.10/$0.25) - 2009/07/01 1:42:39 ET
Table 'l8hUTjBTXBorNUR/tyvSLw' 9-max Seat #2 is the button
Seat 1: cZ99hugmLBj9KhTlc8nCSw ($27.50 in chips) 
Seat 2: B6xHiX1SJkS0CUNCKDVwuQ ($20.90 in chips) 
Seat 3: ShCS62CJp4MKfKLKvGKQbA ($10.10 in chips) 
Seat 4: vPtFvcPtn/Afz0sucO1cmQ ($36.10 in chips) 
Seat 6: EVqHvqty1ZsuvDFiSXlSqQ ($23.85 in chips) 
Seat 7: F7pnn6czNpHvRM55XcA2EA ($33.40 in chips) 
Seat 8: Mh2r9hTeTEDnh19sRZtW3g ($5 in chips) 
ShCS62CJp4MKfKLKvGKQbA: posts small blind $0.10
vPtFvcPtn/Afz0sucO1cmQ: posts big blind $0.25
yyG4svzOpC1A+sUP/scg6w: sits out 
*** HOLE CARDS ***
EVqHvqty1ZsuvDFiSXlSqQ: folds 
F7pnn6czNpHvRM55XcA2EA: folds 
Mh2r9hTeTEDnh19sRZtW3g: folds 
cZ99hugmLBj9KhTlc8nCSw: folds 
B6xHiX1SJkS0CUNCKDVwuQ: folds 
ShCS62CJp4MKfKLKvGKQbA: raises $0.25 to $0.50
vPtFvcPtn/Afz0sucO1cmQ: calls $0.25
*** FLOP *** [7s 5c 3s]
ShCS62CJp4MKfKLKvGKQbA: checks 
vPtFvcPtn/Afz0sucO1cmQ: bets $0.50
ShCS62CJp4MKfKLKvGKQbA: calls $0.50
*** TURN *** [7s 5c 3s] [4d]
ShCS62CJp4MKfKLKvGKQbA: checks 
vPtFvcPtn/Afz0sucO1cmQ: bets $0.75
ShCS62CJp4MKfKLKvGKQbA: folds 
Uncalled bet ($0.75) returned to vPtFvcPtn/Afz0sucO1cmQ
vPtFvcPtn/Afz0sucO1cmQ collected $1.95 from pot
vPtFvcPtn/Afz0sucO1cmQ: doesn't show hand 
*** SUMMARY ***
Total pot $2 | Rake $0.05 
Board [7s 5c 3s 4d]
Seat 1: cZ99hugmLBj9KhTlc8nCSw folded before Flop (didn't bet)
Seat 2: B6xHiX1SJkS0CUNCKDVwuQ (button) folded before Flop (didn't bet)
Seat 3: ShCS62CJp4MKfKLKvGKQbA (small blind) folded on the Turn
Seat 4: vPtFvcPtn/Afz0sucO1cmQ (big blind) collected ($1.95)
Seat 6: EVqHvqty1ZsuvDFiSXlSqQ folded before Flop (didn't bet)
Seat 7: F7pnn6czNpHvRM55XcA2EA folded before Flop (didn't bet)
Seat 8: Mh2r9hTeTEDnh19sRZtW3g folded before Flop (didn't bet)




PokerStars Game #59941675790:  Hold'em No Limit ($0.10/$0.25) - 2009/07/01 1:42:39 ET
Table 'sm5gqEvXgLbkkE4dryW/5g' 6-max Seat #4 is the button
Seat 1: v8m8XHovI5tqEA9mvplDSw ($41.55 in chips) 
Seat 2: 5xs5/u2z1CO9zkRvH72MQg ($17.30 in chips) 
Seat 3: UT5XpwOH1ipkOF7n1MqDJA ($23 in chips) 
Seat 4: cWc85bEzdRzpUMhRKm8pwQ ($27 in chips) 
Seat 6: aogAb4Eienxztk8p2v9VVw ($19.30 in chips) 
aogAb4Eienxztk8p2v9VVw: posts small blind $0.10
v8m8XHovI5tqEA9mvplDSw: posts big blind $0.25
*** HOLE CARDS ***
5xs5/u2z1CO9zkRvH72MQg: calls $0.25
UT5XpwOH1ipkOF7n1MqDJA: calls $0.25
cWc85bEzdRzpUMhRKm8pwQ: calls $0.25
aogAb4Eienxztk8p2v9VVw: calls $0.15
v8m8XHovI5tqEA9mvplDSw: checks 
*** FLOP *** [Ah 6d Kd]
aogAb4Eienxztk8p2v9VVw: checks 
v8m8XHovI5tqEA9mvplDSw: checks 
5xs5/u2z1CO9zkRvH72MQg: bets $1.35
UT5XpwOH1ipkOF7n1MqDJA: calls $1.35
cWc85bEzdRzpUMhRKm8pwQ: folds 
aogAb4Eienxztk8p2v9VVw: folds 
v8m8XHovI5tqEA9mvplDSw: folds 
*** TURN *** [Ah 6d Kd] [Td]
5xs5/u2z1CO9zkRvH72MQg: checks 
UT5XpwOH1ipkOF7n1MqDJA: checks 
*** RIVER *** [Ah 6d Kd Td] [9h]
5xs5/u2z1CO9zkRvH72MQg: bets $4
UT5XpwOH1ipkOF7n1MqDJA: folds 
Uncalled bet ($4) returned to 5xs5/u2z1CO9zkRvH72MQg
5xs5/u2z1CO9zkRvH72MQg collected $3.80 from pot
*** SUMMARY ***
Total pot $3.95 | Rake $0.15 
Board [Ah 6d Kd Td 9h]
Seat 1: v8m8XHovI5tqEA9mvplDSw (big blind) folded on the Flop
Seat 2: 5xs5/u2z1CO9zkRvH72MQg collected ($3.80)
Seat 3: UT5XpwOH1ipkOF7n1MqDJA folded on the River
Seat 4: cWc85bEzdRzpUMhRKm8pwQ (button) folded on the Flop
Seat 6: aogAb4Eienxztk8p2v9VVw (small blind) folded on the Flop




PokerStars Game #59941676310:  Hold'em No Limit ($0.10/$0.25) - 2009/07/01 1:42:39 ET
Table '6wawJ+MkkvuC3coG6r+YhgZiwAqg4o02gNro+JOAaFNgSeat #7 is the button
Seat 1: 6RiVTYll/5D8zICp0MRpKw ($25.20 in chips) 
Seat 2: tYsOBqdU1+x+yFI7zHO7hQ ($31.40 in chips) 
Seat 3: aNpwfA31EREwO+ar4XzBCw ($29 in chips) 
Seat 4: j4q3p0lesp63b1gZDwLBZw ($8.45 in chips) 
Seat 5: 6HoFYfVGBefsR5Vrz62qIw5hAPbqNrvJb8PtLiceXtlg0.10 in chips) 
Seat 6: 5n7e7I+px7c6CQmLpPbtsg ($5 in chips) 
Seat 7: yyG4svzOpC1A+sUP/scg6w ($7.95 in chips) 
Seat 8: VLIsy+xjx3olLSYO3JLS6g ($15.35 in chips) 
Seat 9: ljemhp25Zg+nlA9DLCIiUw ($23.40 in chips) 
VLIsy+xjx3olLSYO3JLS6g: posts small blind $0.10
ljemhp25Zg+nlA9DLCIiUw: posts big blind $0.25
*** HOLE CARDS ***
6RiVTYll/5D8zICp0MRpKw: calls $0.25
tYsOBqdU1+x+yFI7zHO7hQ: folds 
aNpwfA31EREwO+ar4XzBCw: folds 
j4q3p0lesp63b1gZDwLBZw: folds 
j4q3p0lesp63b1gZDwLBZw leaves the table
6HoFYfVGBefsR5Vrz62qIw5hAPbqNrvJb8PtLiceXtlglds 
5n7e7I+px7c6CQmLpPbtsg: folds 
yyG4svzOpC1A+sUP/scg6w: folds 
VLIsy+xjx3olLSYO3JLS6g: calls $0.15
ljemhp25Zg+nlA9DLCIiUw: raises $0.75 to $1
6RiVTYll/5D8zICp0MRpKw: calls $0.75
VLIsy+xjx3olLSYO3JLS6g: calls $0.75
*** FLOP *** [Js Qd 6d]
VLIsy+xjx3olLSYO3JLS6g: checks 
RHqgdFvufLCYe54+qd2gcA joins the table at seat #4 
ljemhp25Zg+nlA9DLCIiUw: bets $2
6RiVTYll/5D8zICp0MRpKw: calls $2
VLIsy+xjx3olLSYO3JLS6g: calls $2
*** TURN *** [Js Qd 6d] [8c]
VLIsy+xjx3olLSYO3JLS6g: checks 
ljemhp25Zg+nlA9DLCIiUw: bets $4
6RiVTYll/5D8zICp0MRpKw: calls $4
VLIsy+xjx3olLSYO3JLS6g: calls $4
*** RIVER *** [Js Qd 6d 8c] [Kd]
VLIsy+xjx3olLSYO3JLS6g: checks 
ljemhp25Zg+nlA9DLCIiUw: checks 
6RiVTYll/5D8zICp0MRpKw: bets $8.50
VLIsy+xjx3olLSYO3JLS6g: folds 
ljemhp25Zg+nlA9DLCIiUw: folds 
Uncalled bet ($8.50) returned to 6RiVTYll/5D8zICp0MRpKw
6RiVTYll/5D8zICp0MRpKw collected $20 from pot
*** SUMMARY ***
Total pot $21 | Rake $1 
Board [Js Qd 6d 8c Kd]
Seat 1: 6RiVTYll/5D8zICp0MRpKw collected ($20)
Seat 2: tYsOBqdU1+x+yFI7zHO7hQ folded before Flop (didn't bet)
Seat 3: aNpwfA31EREwO+ar4XzBCw folded before Flop (didn't bet)
Seat 4: j4q3p0lesp63b1gZDwLBZw folded before Flop (didn't bet)
Seat 5: 6HoFYfVGBefsR5Vrz62qIw5hAPbqNrvJb8PtLiceXtlgded before Flop (didn't bet)
Seat 6: 5n7e7I+px7c6CQmLpPbtsg folded before Flop (didn't bet)
Seat 7: yyG4svzOpC1A+sUP/scg6w (button) folded before Flop (didn't bet)
Seat 8: VLIsy+xjx3olLSYO3JLS6g (small blind) folded on the River
Seat 9: ljemhp25Zg+nlA9DLCIiUw (big blind) folded on the River




PokerStars Game #59941675992:  Hold'em No Limit ($0.10/$0.25) - 2009/07/01 1:42:39 ET
Table 'ROYvQOMwUrvL3SOiHYcrWg' 9-max Seat #5 is the button
Seat 1: 22dIObOuor/A+IKWkNoAlA ($5 in chips) 
Seat 2: gehe91e0IyVT0QU/XBkEyg ($24.90 in chips) 
Seat 3: 8EbrQ/EvFWt2cr0GaU82gQ ($4.65 in chips) 
Seat 4: SHegmCn8B0InbWE/zFlvOw ($31.70 in chips) 
Seat 5: 7je+LC5Mfs6nL8YBVh4frQ ($4.65 in chips) 
Seat 6: P+9ymZQ3ktpQu1bn7HIjew ($9.75 in chips) 
Seat 7: tYsOBqdU1+x+yFI7zHO7hQ ($26.15 in chips) 
Seat 8: biJWLZ27fafNeBI2oT1KJw ($28.15 in chips) 
Seat 9: uhrboV251dcgYniYTdFIcA ($25.35 in chips) 
P+9ymZQ3ktpQu1bn7HIjew: posts small blind $0.10
tYsOBqdU1+x+yFI7zHO7hQ: posts big blind $0.25
*** HOLE CARDS ***
biJWLZ27fafNeBI2oT1KJw: folds 
uhrboV251dcgYniYTdFIcA: folds 
22dIObOuor/A+IKWkNoAlA: folds 
gehe91e0IyVT0QU/XBkEyg: folds 
8EbrQ/EvFWt2cr0GaU82gQ: folds 
SHegmCn8B0InbWE/zFlvOw: calls $0.25
7je+LC5Mfs6nL8YBVh4frQ: folds 
P+9ymZQ3ktpQu1bn7HIjew: calls $0.15
tYsOBqdU1+x+yFI7zHO7hQ: checks 
*** FLOP *** [6d Th 9h]
P+9ymZQ3ktpQu1bn7HIjew: checks 
tYsOBqdU1+x+yFI7zHO7hQ: checks 
SHegmCn8B0InbWE/zFlvOw: checks 
*** TURN *** [6d Th 9h] [Kc]
P+9ymZQ3ktpQu1bn7HIjew: bets $0.50
tYsOBqdU1+x+yFI7zHO7hQ: raises $1.25 to $1.75
SHegmCn8B0InbWE/zFlvOw: raises $2.25 to $4
P+9ymZQ3ktpQu1bn7HIjew: raises $3.50 to $7.50
tYsOBqdU1+x+yFI7zHO7hQ: folds 
SHegmCn8B0InbWE/zFlvOw: calls $3.50
*** RIVER *** [6d Th 9h Kc] [2s]
P+9ymZQ3ktpQu1bn7HIjew: bets $2 and is all-in
SHegmCn8B0InbWE/zFlvOw: calls $2
*** SHOW DOWN ***
P+9ymZQ3ktpQu1bn7HIjew: shows [Qc Jh] (a straight, Nine to King)
SHegmCn8B0InbWE/zFlvOw: mucks hand 
P+9ymZQ3ktpQu1bn7HIjew collected $20.50 from pot
*** SUMMARY ***
Total pot $21.50 | Rake $1 
Board [6d Th 9h Kc 2s]
Seat 1: 22dIObOuor/A+IKWkNoAlA folded before Flop (didn't bet)
Seat 2: gehe91e0IyVT0QU/XBkEyg folded before Flop (didn't bet)
Seat 3: 8EbrQ/EvFWt2cr0GaU82gQ folded before Flop (didn't bet)
Seat 4: SHegmCn8B0InbWE/zFlvOw mucked
Seat 5: 7je+LC5Mfs6nL8YBVh4frQ (button) folded before Flop (didn't bet)
Seat 6: P+9ymZQ3ktpQu1bn7HIjew (small blind) showed [Qc Jh] and won ($20.50) with a straight, Nine to King
Seat 7: tYsOBqdU1+x+yFI7zHO7hQ (big blind) folded on the Turn
Seat 8: biJWLZ27fafNeBI2oT1KJw folded before Flop (didn't bet)
Seat 9: uhrboV251dcgYniYTdFIcA folded before Flop (didn't bet)




PokerStars Game #59941676134:  Hold'em No Limit ($0.10/$0.25) - 2009/07/01 1:42:39 ET
Table '+fuYjvJy9okLr23QyZtanA' 9-max Seat #9 is the button
Seat 1: l9hUFnOCgg4TPYga9bvxhw ($10.80 in chips) 
Seat 2: tLcDklc2rBORNfixyRfVfw ($25.10 in chips) 
Seat 3: eK8qa6EPcH2zhtbmWSvc9g ($52.65 in chips) 
Seat 4: Bb42QRQMhg5/Y0vHP8/2Xw ($30.50 in chips) 
Seat 5: bXpVeaSTPBFSPJmeXxO7nw ($4.65 in chips) 
Seat 6: wGigCmBR/9XWkPpvYos3aQ ($26.15 in chips) 
Seat 7: dfNim92Z6XK1/h5SFW5vDg ($26.55 in chips) 
Seat 8: KqS/lY/fNB9qUxokm9QfeA ($15 in chips) 
Seat 9: OMhlmt2waO3z43ZSFNMmog ($28.80 in chips) 
l9hUFnOCgg4TPYga9bvxhw: posts small blind $0.10
tLcDklc2rBORNfixyRfVfw: posts big blind $0.25
KqS/lY/fNB9qUxokm9QfeA: posts big blind $0.25
*** HOLE CARDS ***
eK8qa6EPcH2zhtbmWSvc9g: folds 
Bb42QRQMhg5/Y0vHP8/2Xw: folds 
bXpVeaSTPBFSPJmeXxO7nw: folds 
wGigCmBR/9XWkPpvYos3aQ: raises $1 to $1.25
dfNim92Z6XK1/h5SFW5vDg: folds 
KqS/lY/fNB9qUxokm9QfeA: calls $1
OMhlmt2waO3z43ZSFNMmog: calls $1.25
l9hUFnOCgg4TPYga9bvxhw: folds 
tLcDklc2rBORNfixyRfVfw: folds 
*** FLOP *** [6h 4s 6s]
wGigCmBR/9XWkPpvYos3aQ: checks 
KqS/lY/fNB9qUxokm9QfeA: checks 
OMhlmt2waO3z43ZSFNMmog: checks 
*** TURN *** [6h 4s 6s] [6c]
wGigCmBR/9XWkPpvYos3aQ: checks 
KqS/lY/fNB9qUxokm9QfeA: checks 
OMhlmt2waO3z43ZSFNMmog: checks 
*** RIVER *** [6h 4s 6s 6c] [3d]
wGigCmBR/9XWkPpvYos3aQ: checks 
KqS/lY/fNB9qUxokm9QfeA: bets $1.50
OMhlmt2waO3z43ZSFNMmog: folds 
wGigCmBR/9XWkPpvYos3aQ: calls $1.50
*** SHOW DOWN ***
KqS/lY/fNB9qUxokm9QfeA: shows [Qc Ts] (three of a kind, Sixes)
wGigCmBR/9XWkPpvYos3aQ: shows [Kd Ac] (three of a kind, Sixes - Ace kicker)
wGigCmBR/9XWkPpvYos3aQ collected $6.80 from pot
*** SUMMARY ***
Total pot $7.10 | Rake $0.30 
Board [6h 4s 6s 6c 3d]
Seat 1: l9hUFnOCgg4TPYga9bvxhw (small blind) folded before Flop
Seat 2: tLcDklc2rBORNfixyRfVfw (big blind) folded before Flop
Seat 3: eK8qa6EPcH2zhtbmWSvc9g folded before Flop (didn't bet)
Seat 4: Bb42QRQMhg5/Y0vHP8/2Xw folded before Flop (didn't bet)
Seat 5: bXpVeaSTPBFSPJmeXxO7nw folded before Flop (didn't bet)
Seat 6: wGigCmBR/9XWkPpvYos3aQ showed [Kd Ac] and won ($6.80) with three of a kind, Sixes
Seat 7: dfNim92Z6XK1/h5SFW5vDg folded before Flop (didn't bet)
Seat 8: KqS/lY/fNB9qUxokm9QfeA showed [Qc Ts] and lost with three of a kind, Sixes
Seat 9: OMhlmt2waO3z43ZSFNMmog (button) folded on the River




PokerStars Game #59941676832:  Hold'em No Limit ($0.10/$0.25) - 2009/07/01 1:42:40 ET
Table 'C8mMnVmvkagwolEzTvh07A' 9-max Seat #4 is the button
Seat 1: PqvgxdSg9z5VmrWpbYuz+g ($25.70 in chips) 
Seat 2: Bb42QRQMhg5/Y0vHP8/2Xw ($25 in chips) 
Seat 3: Th3FldXKQW6hWVVPahaoOQ ($35.35 in chips) 
Seat 4: dfNim92Z6XK1/h5SFW5vDg ($25 in chips) 
Seat 5: iGMlK+EhUflPB6jKQd95Cg ($27.60 in chips) 
Seat 6: AiXn/9o1EwOPZUHujnh/bA ($19 in chips) 
Seat 7: qmEgnPhQt24xdw/ZRVPLbA ($47.65 in chips) 
Seat 9: 4awUyiDYTgylQKXZ9faBVA ($25 in chips) 
iGMlK+EhUflPB6jKQd95Cg: posts small blind $0.10
AiXn/9o1EwOPZUHujnh/bA: posts big blind $0.25
*** HOLE CARDS ***
qmEgnPhQt24xdw/ZRVPLbA: raises $0.40 to $0.65
4awUyiDYTgylQKXZ9faBVA: folds 
PqvgxdSg9z5VmrWpbYuz+g: folds 
Bb42QRQMhg5/Y0vHP8/2Xw: folds 
Th3FldXKQW6hWVVPahaoOQ: folds 
dfNim92Z6XK1/h5SFW5vDg: folds 
iGMlK+EhUflPB6jKQd95Cg: folds 
AiXn/9o1EwOPZUHujnh/bA: folds 
Uncalled bet ($0.40) returned to qmEgnPhQt24xdw/ZRVPLbA
qmEgnPhQt24xdw/ZRVPLbA collected $0.60 from pot
*** SUMMARY ***
Total pot $0.60 | Rake $0 
Seat 1: PqvgxdSg9z5VmrWpbYuz+g folded before Flop (didn't bet)
Seat 2: Bb42QRQMhg5/Y0vHP8/2Xw folded before Flop (didn't bet)
Seat 3: Th3FldXKQW6hWVVPahaoOQ folded before Flop (didn't bet)
Seat 4: dfNim92Z6XK1/h5SFW5vDg (button) folded before Flop (didn't bet)
Seat 5: iGMlK+EhUflPB6jKQd95Cg (small blind) folded before Flop
Seat 6: AiXn/9o1EwOPZUHujnh/bA (big blind) folded before Flop
Seat 7: qmEgnPhQt24xdw/ZRVPLbA collected ($0.60)
Seat 9: 4awUyiDYTgylQKXZ9faBVA folded before Flop (didn't bet)




PokerStars Game #59941676698:  Hold'em No Limit ($0.10/$0.25) - 2009/07/01 1:42:40 ET
Table 'ouLhepGYovxB2x0QxH7cVg' 9-max Seat #2 is the button
Seat 1: ghNKXUBl/H+t83JF079ZBA ($25 in chips) 
Seat 2: r1Z5m4PwSI5ANp7qCE1OJw ($18.50 in chips) 
Seat 3: bXpVeaSTPBFSPJmeXxO7nw ($5.35 in chips) 
Seat 4: a0Sx6GHY7ln2Ns2C97eXeA ($37.55 in chips) 
Seat 6: lSeLm4BdnSMLtIli62qjAQ ($7.50 in chips) 
Seat 7: JRV2PblFtPFz51l0Fwyz8g ($24.85 in chips) 
Seat 8: tLcDklc2rBORNfixyRfVfw ($25 in chips) 
Seat 9: ljemhp25Zg+nlA9DLCIiUw ($25.35 in chips) 
bXpVeaSTPBFSPJmeXxO7nw: posts small blind $0.10
a0Sx6GHY7ln2Ns2C97eXeA: posts big blind $0.25
v60REj6f8jzMYT0VsZvaPQ: sits out 
*** HOLE CARDS ***
lSeLm4BdnSMLtIli62qjAQ: folds 
JRV2PblFtPFz51l0Fwyz8g: folds 
tLcDklc2rBORNfixyRfVfw: folds 
ljemhp25Zg+nlA9DLCIiUw: folds 
ghNKXUBl/H+t83JF079ZBA: folds 
r1Z5m4PwSI5ANp7qCE1OJw: folds 
bXpVeaSTPBFSPJmeXxO7nw: folds 
Uncalled bet ($0.15) returned to a0Sx6GHY7ln2Ns2C97eXeA
a0Sx6GHY7ln2Ns2C97eXeA collected $0.20 from pot
*** SUMMARY ***
Total pot $0.20 | Rake $0 
Seat 1: ghNKXUBl/H+t83JF079ZBA folded before Flop (didn't bet)
Seat 2: r1Z5m4PwSI5ANp7qCE1OJw (button) folded before Flop (didn't bet)
Seat 3: bXpVeaSTPBFSPJmeXxO7nw (small blind) folded before Flop
Seat 4: a0Sx6GHY7ln2Ns2C97eXeA (big blind) collected ($0.20)
Seat 6: lSeLm4BdnSMLtIli62qjAQ folded before Flop (didn't bet)
Seat 7: JRV2PblFtPFz51l0Fwyz8g folded before Flop (didn't bet)
Seat 8: tLcDklc2rBORNfixyRfVfw folded before Flop (didn't bet)
Seat 9: ljemhp25Zg+nlA9DLCIiUw folded before Flop (didn't bet)




PokerStars Game #59941676472:  Hold'em No Limit ($0.10/$0.25) - 2009/07/01 1:42:40 ET
Table '2O5CgfSkSwrr4PDrlZ1RLQ' 6-max Seat #3 is the button
Seat 1: 3skmHD9EOATKdUzzyHh1KA ($30.55 in chips) 
Seat 2: wqphQtauX5Qn7WRJZS1flA ($25 in chips) 
Seat 3: oBUDUfeUyCbZBsjxHZgSiw ($28.75 in chips) 
Seat 5: 0av6tRNdi0Ui4f15L7gsVg ($21.65 in chips) 
Seat 6: tj9xqoqQaDaFw7u1oyZrtA ($48.50 in chips) 
0av6tRNdi0Ui4f15L7gsVg: posts small blind $0.10
epAUIB7h2FJXzUPRIvSkRA joins the table at seat #4 
tj9xqoqQaDaFw7u1oyZrtA: posts big blind $0.25
*** HOLE CARDS ***
3skmHD9EOATKdUzzyHh1KA: folds 
wqphQtauX5Qn7WRJZS1flA: folds 
oBUDUfeUyCbZBsjxHZgSiw: raises $0.75 to $1
0av6tRNdi0Ui4f15L7gsVg: folds 
tj9xqoqQaDaFw7u1oyZrtA: folds 
Uncalled bet ($0.75) returned to oBUDUfeUyCbZBsjxHZgSiw
oBUDUfeUyCbZBsjxHZgSiw collected $0.60 from pot
*** SUMMARY ***
Total pot $0.60 | Rake $0 
Seat 1: 3skmHD9EOATKdUzzyHh1KA folded before Flop (didn't bet)
Seat 2: wqphQtauX5Qn7WRJZS1flA folded before Flop (didn't bet)
Seat 3: oBUDUfeUyCbZBsjxHZgSiw (button) collected ($0.60)
Seat 5: 0av6tRNdi0Ui4f15L7gsVg (small blind) folded before Flop
Seat 6: tj9xqoqQaDaFw7u1oyZrtA (big blind) folded before Flop




PokerStars Game #59941676354:  Hold'em No Limit ($0.10/$0.25) - 2009/07/01 1:42:40 ET
Table '+2VxGVfkEqJ1AYfQy/JH2w' 6-max Seat #2 is the button
Seat 1: if4dh6jhJXeN3/qd3qCp9g ($24.65 in chips) 
Seat 2: qllppsCmUqovlriIWCeM/g ($5.80 in chips) 
Seat 4: y+a/yGW/Jy4bPJFnaeTz5w ($16.70 in chips) 
Seat 5: XD1i5m5PvBDnRzJaG/vINw ($23.10 in chips) 
Seat 6: L3/N/gliETan8N5Gim5h4Q ($25 in chips) 
epAUIB7h2FJXzUPRIvSkRA will be allowed to play after the button
y+a/yGW/Jy4bPJFnaeTz5w: posts small blind $0.10
XD1i5m5PvBDnRzJaG/vINw: posts big blind $0.25
*** HOLE CARDS ***
L3/N/gliETan8N5Gim5h4Q: folds 
if4dh6jhJXeN3/qd3qCp9g: folds 
qllppsCmUqovlriIWCeM/g: folds 
y+a/yGW/Jy4bPJFnaeTz5w: folds 
Uncalled bet ($0.15) returned to XD1i5m5PvBDnRzJaG/vINw
XD1i5m5PvBDnRzJaG/vINw collected $0.20 from pot
XD1i5m5PvBDnRzJaG/vINw: doesn't show hand 
*** SUMMARY ***
Total pot $0.20 | Rake $0 
Seat 1: if4dh6jhJXeN3/qd3qCp9g folded before Flop (didn't bet)
Seat 2: qllppsCmUqovlriIWCeM/g (button) folded before Flop (didn't bet)
Seat 4: y+a/yGW/Jy4bPJFnaeTz5w (small blind) folded before Flop
Seat 5: XD1i5m5PvBDnRzJaG/vINw (big blind) collected ($0.20)
Seat 6: L3/N/gliETan8N5Gim5h4Q folded before Flop (didn't bet)




PokerStars Game #59941676338:  Hold'em No Limit ($0.10/$0.25) - 2009/07/01 1:42:40 ET
Table 'wixGE3Zge1qBdnpWijIl/w' 9-max Seat #2 is the button
Seat 1: 4GJMmHGKzu+gVtalqRy7dA ($19.10 in chips) 
Seat 2: DnDcAdn9P0zGovMERigpFA ($79.60 in chips) 
Seat 3: Bb42QRQMhg5/Y0vHP8/2Xw ($25 in chips) 
Seat 5: H5Se03ZqSX7tbULXur2MAg ($24.45 in chips) 
Seat 6: AP/rNvbsacTb4XtaAgKPiQ ($21.05 in chips) 
Seat 8: ShCS62CJp4MKfKLKvGKQbA ($15.15 in chips) 
Seat 9: r6hsffOo1iKmaPYKwAZmFw ($28.80 in chips) 
Bb42QRQMhg5/Y0vHP8/2Xw: posts small blind $0.10
elpellofa leaves the table
TFFS: is sitting out 
TFFS leaves the table
H5Se03ZqSX7tbULXur2MAg: posts big blind $0.25
*** HOLE CARDS ***
AP/rNvbsacTb4XtaAgKPiQ: folds 
ShCS62CJp4MKfKLKvGKQbA: folds 
4GJMmHGKzu+gVtalqRy7dA said, "nh"
r6hsffOo1iKmaPYKwAZmFw: raises $0.50 to $0.75
4GJMmHGKzu+gVtalqRy7dA: folds 
DnDcAdn9P0zGovMERigpFA: folds 
Bb42QRQMhg5/Y0vHP8/2Xw: folds 
H5Se03ZqSX7tbULXur2MAg: folds 
Uncalled bet ($0.50) returned to r6hsffOo1iKmaPYKwAZmFw
mMd8CDS/but3UC+Zp7Up2w joins the table at seat #7 
r6hsffOo1iKmaPYKwAZmFw collected $0.60 from pot
r6hsffOo1iKmaPYKwAZmFw: doesn't show hand 
X6+pSIPfovPcE87t+LmUKQ joins the table at seat #4 
*** SUMMARY ***
Total pot $0.60 | Rake $0 
Seat 1: 4GJMmHGKzu+gVtalqRy7dA folded before Flop (didn't bet)
Seat 2: DnDcAdn9P0zGovMERigpFA (button) folded before Flop (didn't bet)
Seat 3: Bb42QRQMhg5/Y0vHP8/2Xw (small blind) folded before Flop
Seat 5: H5Se03ZqSX7tbULXur2MAg (big blind) folded before Flop
Seat 6: AP/rNvbsacTb4XtaAgKPiQ folded before Flop (didn't bet)
Seat 8: ShCS62CJp4MKfKLKvGKQbA folded before Flop (didn't bet)
Seat 9: r6hsffOo1iKmaPYKwAZmFw collected ($0.60)




PokerStars Game #59941676356:  Hold'em No Limit ($0.10/$0.25) - 2009/07/01 1:42:40 ET
Table 'ZEXL6Wh4qA4Afx8NnoBBAA' 6-max Seat #3 is the button
Seat 1: v8m8XHovI5tqEA9mvplDSw ($27.60 in chips) 
Seat 2: 6DwBRH+xZ12AAZmeAg+aXw ($33.75 in chips) 
Seat 3: +ZlnqPoP3Hg4BIUxDfKd/A ($30.90 in chips) 
Seat 4: FpN4KbLjlyRRKiVaQcoLqA ($30.60 in chips) 
Seat 5: if4dh6jhJXeN3/qd3qCp9g ($27 in chips) 
Seat 6: Lh8SlCq3OSDKWLUgAI/Lxw ($2.35 in chips) 
FpN4KbLjlyRRKiVaQcoLqA: posts small blind $0.10
if4dh6jhJXeN3/qd3qCp9g: posts big blind $0.25
*** HOLE CARDS ***
Lh8SlCq3OSDKWLUgAI/Lxw: folds 
v8m8XHovI5tqEA9mvplDSw: folds 
6DwBRH+xZ12AAZmeAg+aXw: folds 
+ZlnqPoP3Hg4BIUxDfKd/A: raises $0.75 to $1
FpN4KbLjlyRRKiVaQcoLqA: calls $0.90
if4dh6jhJXeN3/qd3qCp9g: folds 
*** FLOP *** [6h Jc 3c]
FpN4KbLjlyRRKiVaQcoLqA: checks 
+ZlnqPoP3Hg4BIUxDfKd/A: bets $1.50
FpN4KbLjlyRRKiVaQcoLqA: folds 
Uncalled bet ($1.50) returned to +ZlnqPoP3Hg4BIUxDfKd/A
+ZlnqPoP3Hg4BIUxDfKd/A collected $2.15 from pot
+ZlnqPoP3Hg4BIUxDfKd/A: doesn't show hand 
*** SUMMARY ***
Total pot $2.25 | Rake $0.10 
Board [6h Jc 3c]
Seat 1: v8m8XHovI5tqEA9mvplDSw folded before Flop (didn't bet)
Seat 2: 6DwBRH+xZ12AAZmeAg+aXw folded before Flop (didn't bet)
Seat 3: +ZlnqPoP3Hg4BIUxDfKd/A (button) collected ($2.15)
Seat 4: FpN4KbLjlyRRKiVaQcoLqA (small blind) folded on the Flop
Seat 5: if4dh6jhJXeN3/qd3qCp9g (big blind) folded before Flop
Seat 6: Lh8SlCq3OSDKWLUgAI/Lxw folded before Flop (didn't bet)




PokerStars Game #59941676398:  Hold'em No Limit ($0.10/$0.25) - 2009/07/01 1:42:40 ET
Table 'Ok3oDLIsTc2+KxPcI0bAOA' 6-max Seat #5 is the button
Seat 1: agQm3ugZ3qSVYNgNu1ddeA ($42.10 in chips) 
Seat 2: wPSNSp4HYtytRMXTu3oPSQ ($14.50 in chips) 
Seat 3: lquriepNQBhDV5P1SWHhnA ($36.45 in chips) 
Seat 4: LJI7A1YgDM7hgh7o56+ReQ ($38.15 in chips) 
Seat 5: DFi/Lzkjsfv8QswS80JX9Q ($28.25 in chips) 
Seat 6: Hsvkc0/G2VV78oVmWYXecw ($5.05 in chips) 
Hsvkc0/G2VV78oVmWYXecw: posts small blind $0.10
agQm3ugZ3qSVYNgNu1ddeA: posts big blind $0.25
*** HOLE CARDS ***
wPSNSp4HYtytRMXTu3oPSQ: calls $0.25
lquriepNQBhDV5P1SWHhnA: folds 
LJI7A1YgDM7hgh7o56+ReQ: raises $1 to $1.25
DFi/Lzkjsfv8QswS80JX9Q: folds 
Hsvkc0/G2VV78oVmWYXecw: folds 
agQm3ugZ3qSVYNgNu1ddeA: calls $1
wPSNSp4HYtytRMXTu3oPSQ: calls $1
*** FLOP *** [3d Td 8d]
agQm3ugZ3qSVYNgNu1ddeA: checks 
wPSNSp4HYtytRMXTu3oPSQ: bets $2.50
LJI7A1YgDM7hgh7o56+ReQ: folds 
agQm3ugZ3qSVYNgNu1ddeA: folds 
Uncalled bet ($2.50) returned to wPSNSp4HYtytRMXTu3oPSQ
wPSNSp4HYtytRMXTu3oPSQ collected $3.70 from pot
wPSNSp4HYtytRMXTu3oPSQ: doesn't show hand 
*** SUMMARY ***
Total pot $3.85 | Rake $0.15 
Board [3d Td 8d]
Seat 1: agQm3ugZ3qSVYNgNu1ddeA (big blind) folded on the Flop
Seat 2: wPSNSp4HYtytRMXTu3oPSQ collected ($3.70)
Seat 3: lquriepNQBhDV5P1SWHhnA folded before Flop (didn't bet)
Seat 4: LJI7A1YgDM7hgh7o56+ReQ folded on the Flop
Seat 5: DFi/Lzkjsfv8QswS80JX9Q (button) folded before Flop (didn't bet)
Seat 6: Hsvkc0/G2VV78oVmWYXecw (small blind) folded before Flop




PokerStars Game #59941676804:  Hold'em No Limit ($0.10/$0.25) - 2009/07/01 1:42:40 ET
Table 'oJpFwZj9+FUGHX90Un8s9Q' 6-max Seat #6 is the button
Seat 1: 6DwBRH+xZ12AAZmeAg+aXw ($22.70 in chips) 
Seat 2: NtrVQ9UIql0rDCnKDKZ5FQ ($16.05 in chips) 
Seat 3: kyRaCIljYA6l33lSKQfNsg ($24.65 in chips) 
Seat 4: 6elpmfyt4Zw0yvd8lePSMQ ($23.10 in chips) 
Seat 5: kG34n23qFQA3nzdOJTQ1dA ($56.10 in chips) 
Seat 6: edio/rLJ06xeZOfLhoL3UA ($0.45 in chips) 
6DwBRH+xZ12AAZmeAg+aXw: posts small blind $0.10
NtrVQ9UIql0rDCnKDKZ5FQ: posts big blind $0.25
*** HOLE CARDS ***
kyRaCIljYA6l33lSKQfNsg: folds 
6elpmfyt4Zw0yvd8lePSMQ: calls $0.25
kG34n23qFQA3nzdOJTQ1dA: folds 
edio/rLJ06xeZOfLhoL3UA: raises $0.20 to $0.45 and is all-in
6DwBRH+xZ12AAZmeAg+aXw: folds 
NtrVQ9UIql0rDCnKDKZ5FQ: folds 
6elpmfyt4Zw0yvd8lePSMQ: calls $0.20
*** FLOP *** [5c 8h 5d]
*** TURN *** [5c 8h 5d] [2h]
*** RIVER *** [5c 8h 5d 2h] [6c]
*** SHOW DOWN ***
6elpmfyt4Zw0yvd8lePSMQ: shows [Kh 3h] (a pair of Fives)
edio/rLJ06xeZOfLhoL3UA: shows [2d 2c] (a full house, Deuces full of Fives)
edio/rLJ06xeZOfLhoL3UA collected $1.20 from pot
*** SUMMARY ***
Total pot $1.25 | Rake $0.05 
Board [5c 8h 5d 2h 6c]
Seat 1: 6DwBRH+xZ12AAZmeAg+aXw (small blind) folded before Flop
Seat 2: NtrVQ9UIql0rDCnKDKZ5FQ (big blind) folded before Flop
Seat 3: kyRaCIljYA6l33lSKQfNsg folded before Flop (didn't bet)
Seat 4: 6elpmfyt4Zw0yvd8lePSMQ showed [Kh 3h] and lost with a pair of Fives
Seat 5: kG34n23qFQA3nzdOJTQ1dA folded before Flop (didn't bet)
Seat 6: edio/rLJ06xeZOfLhoL3UA (button) showed [2d 2c] and won ($1.20) with a full house, Deuces full of Fives




PokerStars Game #59941677218:  Hold'em No Limit ($0.10/$0.25) - 2009/07/01 1:42:41 ET
Table 'ggwTHpIC5qhhHJSYjK1XCw' 6-max Seat #5 is the button
Seat 1: MqMK8OWPSY1V4stf1Hy5Jw ($79.20 in chips) 
Seat 2: /gJNBeCkWL4o85/jvlZ4BA ($26.85 in chips) 
Seat 3: SxIIgwXYLkwd6m3wLyPTCw ($66.15 in chips) 
Seat 4: JFIAqU8lCZ0vWwEl4bdGsg ($25.60 in chips) 
Seat 5: BvqhBa7W/To51LhEiIU/lw ($6.15 in chips) 
Seat 6: 732E3Iz0geWMK40ej+U9HA ($13.25 in chips) 
732E3Iz0geWMK40ej+U9HA: posts small blind $0.10
MqMK8OWPSY1V4stf1Hy5Jw: posts big blind $0.25
*** HOLE CARDS ***
/gJNBeCkWL4o85/jvlZ4BA: raises $0.75 to $1
SxIIgwXYLkwd6m3wLyPTCw: folds 
JFIAqU8lCZ0vWwEl4bdGsg: folds 
BvqhBa7W/To51LhEiIU/lw: folds 
732E3Iz0geWMK40ej+U9HA: folds 
MqMK8OWPSY1V4stf1Hy5Jw: folds 
Uncalled bet ($0.75) returned to /gJNBeCkWL4o85/jvlZ4BA
/gJNBeCkWL4o85/jvlZ4BA collected $0.60 from pot
*** SUMMARY ***
Total pot $0.60 | Rake $0 
Seat 1: MqMK8OWPSY1V4stf1Hy5Jw (big blind) folded before Flop
Seat 2: /gJNBeCkWL4o85/jvlZ4BA collected ($0.60)
Seat 3: SxIIgwXYLkwd6m3wLyPTCw folded before Flop (didn't bet)
Seat 4: JFIAqU8lCZ0vWwEl4bdGsg folded before Flop (didn't bet)
Seat 5: BvqhBa7W/To51LhEiIU/lw (button) folded before Flop (didn't bet)
Seat 6: 732E3Iz0geWMK40ej+U9HA (small blind) folded before Flop




PokerStars Game #59941677044:  Hold'em No Limit ($0.10/$0.25) - 2009/07/01 1:42:41 ET
Table 'M7d9IrgQUUFFy/SZ3ksLYg' 6-max Seat #3 is the button
Seat 1: ypmjhffk/YHGc51wgVXUTw ($49.60 in chips) 
Seat 2: gqrr7lSWrQ1N8zKx8zZzvA ($9.05 in chips) 
Seat 3: 8JTm/CXBn3+kuQgcUOgPkw ($22.70 in chips) 
Seat 4: 8ClCHtFXGNplITm+63KB+Q ($24.65 in chips) 
Seat 5: kMa8BltUcBQVxnHfqdCfXg ($5.45 in chips) 
Seat 6: 7S16WhQHiAVLWwRuqPrpnw ($11.15 in chips) 
8ClCHtFXGNplITm+63KB+Q: posts small blind $0.10
kMa8BltUcBQVxnHfqdCfXg: posts big blind $0.25
*** HOLE CARDS ***
7S16WhQHiAVLWwRuqPrpnw: raises $0.75 to $1
ypmjhffk/YHGc51wgVXUTw: folds 
gqrr7lSWrQ1N8zKx8zZzvA: folds 
8JTm/CXBn3+kuQgcUOgPkw: folds 
8ClCHtFXGNplITm+63KB+Q: folds 
kMa8BltUcBQVxnHfqdCfXg: calls $0.75
*** FLOP *** [7s 7c Kc]
kMa8BltUcBQVxnHfqdCfXg: checks 
7S16WhQHiAVLWwRuqPrpnw: bets $0.75
kMa8BltUcBQVxnHfqdCfXg: folds 
Uncalled bet ($0.75) returned to 7S16WhQHiAVLWwRuqPrpnw
7S16WhQHiAVLWwRuqPrpnw collected $2 from pot
*** SUMMARY ***
Total pot $2.10 | Rake $0.10 
Board [7s 7c Kc]
Seat 1: ypmjhffk/YHGc51wgVXUTw folded before Flop (didn't bet)
Seat 2: gqrr7lSWrQ1N8zKx8zZzvA folded before Flop (didn't bet)
Seat 3: 8JTm/CXBn3+kuQgcUOgPkw (button) folded before Flop (didn't bet)
Seat 4: 8ClCHtFXGNplITm+63KB+Q (small blind) folded before Flop
Seat 5: kMa8BltUcBQVxnHfqdCfXg (big blind) folded on the Flop
Seat 6: 7S16WhQHiAVLWwRuqPrpnw collected ($2)




PokerStars Game #59941676900:  Hold'em No Limit ($0.10/$0.25) - 2009/07/01 1:42:41 ET
Table '3LMlz3V4AziGlU+ikmyU8w' 6-max Seat #3 is the button
Seat 1: Wxq4Qyj0DnDXj2+taEOJFQ ($29.15 in chips) 
Seat 2: uR3AbFJLoOX86DOTtTgGcg ($20.70 in chips) 
Seat 3: Hzy03WtPHMYwLYM7hTTxQw ($28.60 in chips) 
Seat 4: 6DwBRH+xZ12AAZmeAg+aXw ($20 in chips) 
Seat 5: tOAk1Og4mVObMBOfvdDYOw ($26.10 in chips) 
Seat 6: ZZm/rg8aThjE+A2LiItuzA ($1.10 in chips) 
6DwBRH+xZ12AAZmeAg+aXw: posts small blind $0.10
tOAk1Og4mVObMBOfvdDYOw: posts big blind $0.25
*** HOLE CARDS ***
ZZm/rg8aThjE+A2LiItuzA: folds 
Wxq4Qyj0DnDXj2+taEOJFQ: folds 
uR3AbFJLoOX86DOTtTgGcg: folds 
Hzy03WtPHMYwLYM7hTTxQw: raises $0.75 to $1
6DwBRH+xZ12AAZmeAg+aXw: folds 
tOAk1Og4mVObMBOfvdDYOw: calls $0.75
*** FLOP *** [2c Kc Ks]
tOAk1Og4mVObMBOfvdDYOw: checks 
Hzy03WtPHMYwLYM7hTTxQw: bets $1.50
tOAk1Og4mVObMBOfvdDYOw: folds 
Uncalled bet ($1.50) returned to Hzy03WtPHMYwLYM7hTTxQw
Hzy03WtPHMYwLYM7hTTxQw collected $2 from pot
*** SUMMARY ***
Total pot $2.10 | Rake $0.10 
Board [2c Kc Ks]
Seat 1: Wxq4Qyj0DnDXj2+taEOJFQ folded before Flop (didn't bet)
Seat 2: uR3AbFJLoOX86DOTtTgGcg folded before Flop (didn't bet)
Seat 3: Hzy03WtPHMYwLYM7hTTxQw (button) collected ($2)
Seat 4: 6DwBRH+xZ12AAZmeAg+aXw (small blind) folded before Flop
Seat 5: tOAk1Og4mVObMBOfvdDYOw (big blind) folded on the Flop
Seat 6: ZZm/rg8aThjE+A2LiItuzA folded before Flop (didn't bet)




PokerStars Game #59941676910:  Hold'em No Limit ($0.10/$0.25) - 2009/07/01 1:42:41 ET
Table 'HIOfhT0zga/KonFhIl6O3w' 9-max Seat #7 is the button
Seat 1: oLa/tXLfSLLB28mcLGrxcg ($24.90 in chips) 
Seat 2: er86weqXTpTB6/w2dKlYgA ($17.25 in chips) 
Seat 4: qwr38jl5txoR36M7G5qi4A ($8.65 in chips) 
Seat 5: K1MDeapSEyKyGPNZGOKfEg ($38.10 in chips) 
Seat 6: MThMMgdB293VOucmN9sliQ ($24.65 in chips) 
Seat 7: wvlPJBB0PtYkfeeSRDaIvQ ($13.45 in chips) 
Seat 9: dfNim92Z6XK1/h5SFW5vDg ($28.80 in chips) 
SpiiQQAzy4MUgV3I5W8giw will be allowed to play after the button
dfNim92Z6XK1/h5SFW5vDg: posts small blind $0.10
oLa/tXLfSLLB28mcLGrxcg: posts big blind $0.25
X6+pSIPfovPcE87t+LmUKQ: sits out 
*** HOLE CARDS ***
er86weqXTpTB6/w2dKlYgA: folds 
qwr38jl5txoR36M7G5qi4A: folds 
K1MDeapSEyKyGPNZGOKfEg: folds 
MThMMgdB293VOucmN9sliQ: calls $0.25
wvlPJBB0PtYkfeeSRDaIvQ: folds 
dfNim92Z6XK1/h5SFW5vDg: folds 
oLa/tXLfSLLB28mcLGrxcg: checks 
*** FLOP *** [Kc 4s As]
oLa/tXLfSLLB28mcLGrxcg: bets $0.25
MThMMgdB293VOucmN9sliQ: calls $0.25
*** TURN *** [Kc 4s As] [2h]
oLa/tXLfSLLB28mcLGrxcg: checks 
MThMMgdB293VOucmN9sliQ: bets $0.25
oLa/tXLfSLLB28mcLGrxcg: calls $0.25
*** RIVER *** [Kc 4s As 2h] [8c]
oLa/tXLfSLLB28mcLGrxcg: checks 
MThMMgdB293VOucmN9sliQ: checks 
*** SHOW DOWN ***
oLa/tXLfSLLB28mcLGrxcg: shows [6d 4h] (a pair of Fours)
MThMMgdB293VOucmN9sliQ: shows [Ks Ts] (a pair of Kings)
MThMMgdB293VOucmN9sliQ collected $1.55 from pot
*** SUMMARY ***
Total pot $1.60 | Rake $0.05 
Board [Kc 4s As 2h 8c]
Seat 1: oLa/tXLfSLLB28mcLGrxcg (big blind) showed [6d 4h] and lost with a pair of Fours
Seat 2: er86weqXTpTB6/w2dKlYgA folded before Flop (didn't bet)
Seat 4: qwr38jl5txoR36M7G5qi4A folded before Flop (didn't bet)
Seat 5: K1MDeapSEyKyGPNZGOKfEg folded before Flop (didn't bet)
Seat 6: MThMMgdB293VOucmN9sliQ showed [Ks Ts] and won ($1.55) with a pair of Kings
Seat 7: wvlPJBB0PtYkfeeSRDaIvQ (button) folded before Flop (didn't bet)
Seat 9: dfNim92Z6XK1/h5SFW5vDg (small blind) folded before Flop




PokerStars Game #59941677242:  Hold'em No Limit ($0.10/$0.25) - 2009/07/01 1:42:41 ET
Table 'dVzscin98UhGisTmV9BDcw' 9-max Seat #8 is the button
Seat 1: sBAwXpkpgyhyWbHIQcIJKA ($17.90 in chips) 
Seat 2: dfNim92Z6XK1/h5SFW5vDg ($28.25 in chips) 
Seat 4: aNpwfA31EREwO+ar4XzBCw ($42.25 in chips) 
Seat 5: 22dIObOuor/A+IKWkNoAlA ($10.10 in chips) 
Seat 6: bXpVeaSTPBFSPJmeXxO7nw ($8.30 in chips) 
Seat 7: cKlmpQMahVsmOaxFQDcoOg ($24.65 in chips) 
Seat 8: /vn2Qu2dvc9AMMq46Ae0jA ($44.05 in chips) 
Seat 9: arxNSjreDRGFg13EAM2F1w ($25 in chips) 
arxNSjreDRGFg13EAM2F1w: posts small blind $0.10
sBAwXpkpgyhyWbHIQcIJKA: posts big blind $0.25
cZ99hugmLBj9KhTlc8nCSw: sits out 
*** HOLE CARDS ***
dfNim92Z6XK1/h5SFW5vDg: folds 
aNpwfA31EREwO+ar4XzBCw: folds 
22dIObOuor/A+IKWkNoAlA: folds 
bXpVeaSTPBFSPJmeXxO7nw: folds 
cKlmpQMahVsmOaxFQDcoOg: folds 
/vn2Qu2dvc9AMMq46Ae0jA: raises $0.50 to $0.75
arxNSjreDRGFg13EAM2F1w: folds 
sBAwXpkpgyhyWbHIQcIJKA: folds 
Uncalled bet ($0.50) returned to /vn2Qu2dvc9AMMq46Ae0jA
/vn2Qu2dvc9AMMq46Ae0jA collected $0.60 from pot
*** SUMMARY ***
Total pot $0.60 | Rake $0 
Seat 1: sBAwXpkpgyhyWbHIQcIJKA (big blind) folded before Flop
Seat 2: dfNim92Z6XK1/h5SFW5vDg folded before Flop (didn't bet)
Seat 4: aNpwfA31EREwO+ar4XzBCw folded before Flop (didn't bet)
Seat 5: 22dIObOuor/A+IKWkNoAlA folded before Flop (didn't bet)
Seat 6: bXpVeaSTPBFSPJmeXxO7nw folded before Flop (didn't bet)
Seat 7: cKlmpQMahVsmOaxFQDcoOg folded before Flop (didn't bet)
Seat 8: /vn2Qu2dvc9AMMq46Ae0jA (button) collected ($0.60)
Seat 9: arxNSjreDRGFg13EAM2F1w (small blind) folded before Flop




PokerStars Game #59941677188:  Hold'em No Limit ($0.10/$0.25) - 2009/07/01 1:42:41 ET
Table 'nc6OeGk/wtaWV+6N+kgnZQgZetDqJh6q9A3mLO3ThCsASeat #1 is the button
Seat 1: DihMHaz4WNETH1bPDe13kA ($26.30 in chips) 
Seat 2: JFIAqU8lCZ0vWwEl4bdGsg ($33.15 in chips) 
Seat 3: jp34e617tIzV8tKIWmfAbA ($32.80 in chips) 
Seat 4: BV+K0Phf5VBHr7aZPKqbUQ ($29.35 in chips) 
Seat 5: 5hAPbqNrvJb8PtLiceXtlgEKTLAV1bAterT0Mc1G6lBg5 in chips) 
JFIAqU8lCZ0vWwEl4bdGsg: posts small blind $0.10
jp34e617tIzV8tKIWmfAbA: posts big blind $0.25
5hAPbqNrvJb8PtLiceXtlgEKTLAV1bAterT0Mc1G6lBgsts big blind $0.25
*** HOLE CARDS ***
BV+K0Phf5VBHr7aZPKqbUQ: folds 
5hAPbqNrvJb8PtLiceXtlgEKTLAV1bAterT0Mc1G6lBgecks 
DihMHaz4WNETH1bPDe13kA: calls $0.25
StevenWu joins the table at seat #6 
JFIAqU8lCZ0vWwEl4bdGsg: calls $0.15
jp34e617tIzV8tKIWmfAbA: raises $1 to $1.25
5hAPbqNrvJb8PtLiceXtlgEKTLAV1bAterT0Mc1G6lBglds 
DihMHaz4WNETH1bPDe13kA: folds 
JFIAqU8lCZ0vWwEl4bdGsg: folds 
Uncalled bet ($1) returned to jp34e617tIzV8tKIWmfAbA
jp34e617tIzV8tKIWmfAbA collected $1 from pot
jp34e617tIzV8tKIWmfAbA: doesn't show hand 
*** SUMMARY ***
Total pot $1 | Rake $0 
Seat 1: DihMHaz4WNETH1bPDe13kA (button) folded before Flop
Seat 2: JFIAqU8lCZ0vWwEl4bdGsg (small blind) folded before Flop
Seat 3: jp34e617tIzV8tKIWmfAbA (big blind) collected ($1)
Seat 4: BV+K0Phf5VBHr7aZPKqbUQ folded before Flop (didn't bet)
Seat 5: 5hAPbqNrvJb8PtLiceXtlgEKTLAV1bAterT0Mc1G6lBgded before Flop




PokerStars Game #59941676928:  Hold'em No Limit ($0.10/$0.25) - 2009/07/01 1:42:41 ET
Table 'zW+7jPbOLCvlPu+dUGY5WQ' 6-max Seat #6 is the button
Seat 1: eL3+wCBjFGfQ5FMdIZihwA ($26.35 in chips) 
Seat 2: cEMJmfAUQZmMChZe6aacKw ($8.95 in chips) 
Seat 3: 2G0C7dp4wlPpE21FHjjElQ ($32.85 in chips) 
Seat 4: i48129QFpEQQ+UN4aNtmww ($10.60 in chips) 
Seat 6: qGHGf/553gQnDoklMRe3tg ($24.65 in chips) 
eL3+wCBjFGfQ5FMdIZihwA: posts small blind $0.10
cEMJmfAUQZmMChZe6aacKw: posts big blind $0.25
*** HOLE CARDS ***
2G0C7dp4wlPpE21FHjjElQ: folds 
i48129QFpEQQ+UN4aNtmww: folds 
qGHGf/553gQnDoklMRe3tg: raises $0.75 to $1
eL3+wCBjFGfQ5FMdIZihwA: folds 
cEMJmfAUQZmMChZe6aacKw: folds 
Uncalled bet ($0.75) returned to qGHGf/553gQnDoklMRe3tg
qGHGf/553gQnDoklMRe3tg collected $0.60 from pot
*** SUMMARY ***
Total pot $0.60 | Rake $0 
Seat 1: eL3+wCBjFGfQ5FMdIZihwA (small blind) folded before Flop
Seat 2: cEMJmfAUQZmMChZe6aacKw (big blind) folded before Flop
Seat 3: 2G0C7dp4wlPpE21FHjjElQ folded before Flop (didn't bet)
Seat 4: i48129QFpEQQ+UN4aNtmww folded before Flop (didn't bet)
Seat 6: qGHGf/553gQnDoklMRe3tg (button) collected ($0.60)




PokerStars Game #59941677828:  Hold'em No Limit ($0.10/$0.25) - 2009/07/01 1:42:42 ET
Table 'by7aHYEDnDd144EXOXa/jA' 9-max Seat #8 is the button
Seat 1: j4q3p0lesp63b1gZDwLBZw ($6.60 in chips) 
Seat 2: vSkQm2EelzwRGDDQQk0Fqw ($5 in chips) 
Seat 3: HOEaXncFu2ij+D5/CANAZA ($12.10 in chips) 
Seat 4: 2Xwi447v1rBHM+92U0CduA ($4.50 in chips) 
Seat 5: yyG4svzOpC1A+sUP/scg6w ($3.60 in chips) 
Seat 6: sC4BsflLWW26Qm9m+1AwJQ ($14.90 in chips) 
Seat 8: 7je+LC5Mfs6nL8YBVh4frQ ($3.50 in chips) 
Seat 9: K0b5wNInj6hUGRr6yzKFtw ($26.15 in chips) 
K0b5wNInj6hUGRr6yzKFtw: posts small blind $0.10
j4q3p0lesp63b1gZDwLBZw: posts big blind $0.25
Z9W7+g1WMhhZDi7DwGbCFA: sits out 
*** HOLE CARDS ***
vSkQm2EelzwRGDDQQk0Fqw: folds 
HOEaXncFu2ij+D5/CANAZA: folds 
2Xwi447v1rBHM+92U0CduA: calls $0.25
yyG4svzOpC1A+sUP/scg6w: raises $0.75 to $1
sC4BsflLWW26Qm9m+1AwJQ: folds 
7je+LC5Mfs6nL8YBVh4frQ: folds 
K0b5wNInj6hUGRr6yzKFtw: folds 
j4q3p0lesp63b1gZDwLBZw: folds 
2Xwi447v1rBHM+92U0CduA: folds 
Uncalled bet ($0.75) returned to yyG4svzOpC1A+sUP/scg6w
yyG4svzOpC1A+sUP/scg6w collected $0.85 from pot
*** SUMMARY ***
Total pot $0.85 | Rake $0 
Seat 1: j4q3p0lesp63b1gZDwLBZw (big blind) folded before Flop
Seat 2: vSkQm2EelzwRGDDQQk0Fqw folded before Flop (didn't bet)
Seat 3: HOEaXncFu2ij+D5/CANAZA folded before Flop (didn't bet)
Seat 4: 2Xwi447v1rBHM+92U0CduA folded before Flop
Seat 5: yyG4svzOpC1A+sUP/scg6w collected ($0.85)
Seat 6: sC4BsflLWW26Qm9m+1AwJQ folded before Flop (didn't bet)
Seat 8: 7je+LC5Mfs6nL8YBVh4frQ (button) folded before Flop (didn't bet)
Seat 9: K0b5wNInj6hUGRr6yzKFtw (small blind) folded before Flop




PokerStars Game #59941677388:  Hold'em No Limit ($0.10/$0.25) - 2009/07/01 1:42:42 ET
Table '2clPgY3+dETPD/8zjXZdFw' 6-max Seat #5 is the button
Seat 1: 4WFKzsjLSGnvHbVxKabsvQ ($31.15 in chips) 
Seat 2: cWc85bEzdRzpUMhRKm8pwQ ($25.70 in chips) 
Seat 3: SFmT9ZsVopnukjvAzrxTRg ($25 in chips) 
Seat 4: ljjhtb6FVPTx9AT9HNdtqg ($16.55 in chips) 
Seat 5: LJI7A1YgDM7hgh7o56+ReQ ($25 in chips) 
4WFKzsjLSGnvHbVxKabsvQ: posts small blind $0.10
cWc85bEzdRzpUMhRKm8pwQ: posts big blind $0.25
*** HOLE CARDS ***
SFmT9ZsVopnukjvAzrxTRg: folds 
ljjhtb6FVPTx9AT9HNdtqg: calls $0.25
LJI7A1YgDM7hgh7o56+ReQ: raises $1 to $1.25
4WFKzsjLSGnvHbVxKabsvQ: folds 
cWc85bEzdRzpUMhRKm8pwQ: folds 
ljjhtb6FVPTx9AT9HNdtqg: folds 
Uncalled bet ($1) returned to LJI7A1YgDM7hgh7o56+ReQ
LJI7A1YgDM7hgh7o56+ReQ collected $0.85 from pot
LJI7A1YgDM7hgh7o56+ReQ: doesn't show hand 
*** SUMMARY ***
Total pot $0.85 | Rake $0 
Seat 1: 4WFKzsjLSGnvHbVxKabsvQ (small blind) folded before Flop
Seat 2: cWc85bEzdRzpUMhRKm8pwQ (big blind) folded before Flop
Seat 3: SFmT9ZsVopnukjvAzrxTRg folded before Flop (didn't bet)
Seat 4: ljjhtb6FVPTx9AT9HNdtqg folded before Flop
Seat 5: LJI7A1YgDM7hgh7o56+ReQ (button) collected ($0.85)




PokerStars Game #59941677518:  Hold'em No Limit ($0.10/$0.25) - 2009/07/01 1:42:42 ET
Table 'mdub7rJf3Z5tCT9s/+1+Wg' 9-max Seat #6 is the button
Seat 1: cZ99hugmLBj9KhTlc8nCSw ($29.25 in chips) 
Seat 2: 539MC3AwKLWVFwzABc644Q ($9.60 in chips) 
Seat 3: PdIasPkzm2sqZnN41ZRXOg ($5.35 in chips) 
Seat 4: fDGyaQz0cs2s4FOYxkbIHA ($14.85 in chips) 
Seat 5: dfNim92Z6XK1/h5SFW5vDg ($26.25 in chips) 
Seat 6: T/CCwAWe2yhO0c4oHNwicw ($22.45 in chips) 
Seat 7: woe+9KKk+L3pZgMTuHcmog ($15.45 in chips) 
Seat 8: Z9AeOQX3yzuSvKAm/xyovg ($6.75 in chips) 
Seat 9: tYsOBqdU1+x+yFI7zHO7hQ ($36.80 in chips) 
woe+9KKk+L3pZgMTuHcmog: posts small blind $0.10
Z9AeOQX3yzuSvKAm/xyovg: posts big blind $0.25
*** HOLE CARDS ***
tYsOBqdU1+x+yFI7zHO7hQ: folds 
cZ99hugmLBj9KhTlc8nCSw: folds 
539MC3AwKLWVFwzABc644Q: folds 
PdIasPkzm2sqZnN41ZRXOg: folds 
fDGyaQz0cs2s4FOYxkbIHA: folds 
dfNim92Z6XK1/h5SFW5vDg: folds 
T/CCwAWe2yhO0c4oHNwicw: raises $0.50 to $0.75
woe+9KKk+L3pZgMTuHcmog: folds 
Z9AeOQX3yzuSvKAm/xyovg: calls $0.50
*** FLOP *** [9c 6c 5c]
Z9AeOQX3yzuSvKAm/xyovg: checks 
T/CCwAWe2yhO0c4oHNwicw: checks 
*** TURN *** [9c 6c 5c] [As]
Z9AeOQX3yzuSvKAm/xyovg: checks 
T/CCwAWe2yhO0c4oHNwicw: bets $0.75
Z9AeOQX3yzuSvKAm/xyovg: folds 
Uncalled bet ($0.75) returned to T/CCwAWe2yhO0c4oHNwicw
T/CCwAWe2yhO0c4oHNwicw collected $1.55 from pot
T/CCwAWe2yhO0c4oHNwicw: doesn't show hand 
*** SUMMARY ***
Total pot $1.60 | Rake $0.05 
Board [9c 6c 5c As]
Seat 1: cZ99hugmLBj9KhTlc8nCSw folded before Flop (didn't bet)
Seat 2: 539MC3AwKLWVFwzABc644Q folded before Flop (didn't bet)
Seat 3: PdIasPkzm2sqZnN41ZRXOg folded before Flop (didn't bet)
Seat 4: fDGyaQz0cs2s4FOYxkbIHA folded before Flop (didn't bet)
Seat 5: dfNim92Z6XK1/h5SFW5vDg folded before Flop (didn't bet)
Seat 6: T/CCwAWe2yhO0c4oHNwicw (button) collected ($1.55)
Seat 7: woe+9KKk+L3pZgMTuHcmog (small blind) folded before Flop
Seat 8: Z9AeOQX3yzuSvKAm/xyovg (big blind) folded on the Turn
Seat 9: tYsOBqdU1+x+yFI7zHO7hQ folded before Flop (didn't bet)




PokerStars Game #59941677590:  Hold'em No Limit ($0.10/$0.25) - 2009/07/01 1:42:42 ET
Table '2AUmC2Rslg+QUbLfdgNdfg' 6-max Seat #2 is the button
Seat 1: YDXAegrCnzc0l6TSDNboXQ ($25.25 in chips) 
Seat 2: PLksyNlTVRVZwxJVC2/1eA ($23.50 in chips) 
Seat 3: JFIAqU8lCZ0vWwEl4bdGsg ($25.45 in chips) 
Seat 4: lquriepNQBhDV5P1SWHhnA ($26.60 in chips) 
Seat 5: AMc4cCwUJhokdGRYIaVPhQ ($22.60 in chips) 
Seat 6: xBWc54v+UTSJOiKpbAbJWg ($10.85 in chips) 
JFIAqU8lCZ0vWwEl4bdGsg: posts small blind $0.10
lquriepNQBhDV5P1SWHhnA: posts big blind $0.25
*** HOLE CARDS ***
AMc4cCwUJhokdGRYIaVPhQ: folds 
xBWc54v+UTSJOiKpbAbJWg: folds 
YDXAegrCnzc0l6TSDNboXQ: raises $0.75 to $1
PLksyNlTVRVZwxJVC2/1eA: calls $1
JFIAqU8lCZ0vWwEl4bdGsg: folds 
lquriepNQBhDV5P1SWHhnA: folds 
*** FLOP *** [8c Ks 6h]
YDXAegrCnzc0l6TSDNboXQ: bets $1.75
PLksyNlTVRVZwxJVC2/1eA: folds 
Uncalled bet ($1.75) returned to YDXAegrCnzc0l6TSDNboXQ
YDXAegrCnzc0l6TSDNboXQ collected $2.25 from pot
*** SUMMARY ***
Total pot $2.35 | Rake $0.10 
Board [8c Ks 6h]
Seat 1: YDXAegrCnzc0l6TSDNboXQ collected ($2.25)
Seat 2: PLksyNlTVRVZwxJVC2/1eA (button) folded on the Flop
Seat 3: JFIAqU8lCZ0vWwEl4bdGsg (small blind) folded before Flop
Seat 4: lquriepNQBhDV5P1SWHhnA (big blind) folded before Flop
Seat 5: AMc4cCwUJhokdGRYIaVPhQ folded before Flop (didn't bet)
Seat 6: xBWc54v+UTSJOiKpbAbJWg folded before Flop (didn't bet)




PokerStars Game #59941677726:  Hold'em No Limit ($0.10/$0.25) - 2009/07/01 1:42:42 ET
Table 'WY+lMaAoIdBZmwk27/RJCA' 6-max Seat #2 is the button
Seat 1: zHHLkD2sRljslKKeQv/ZQw ($26.10 in chips) 
Seat 2: NhUN/JpAprdJeamFBgJH1w ($26.55 in chips) 
Seat 3: 79Q62AM0VB++TQYiBlOYsA ($80.90 in chips) 
Seat 4: 0av6tRNdi0Ui4f15L7gsVg ($22.15 in chips) 
Seat 5: vqWjZmdQu/Hxw96/IJTWdQ ($29.45 in chips) 
Seat 6: cWc85bEzdRzpUMhRKm8pwQ ($25.85 in chips) 
79Q62AM0VB++TQYiBlOYsA: posts small blind $0.10
0av6tRNdi0Ui4f15L7gsVg: posts big blind $0.25
*** HOLE CARDS ***
vqWjZmdQu/Hxw96/IJTWdQ: folds 
cWc85bEzdRzpUMhRKm8pwQ: folds 
zHHLkD2sRljslKKeQv/ZQw: folds 
NhUN/JpAprdJeamFBgJH1w: raises $0.75 to $1
79Q62AM0VB++TQYiBlOYsA: folds 
0av6tRNdi0Ui4f15L7gsVg: folds 
Uncalled bet ($0.75) returned to NhUN/JpAprdJeamFBgJH1w
NhUN/JpAprdJeamFBgJH1w collected $0.60 from pot
NhUN/JpAprdJeamFBgJH1w: doesn't show hand 
*** SUMMARY ***
Total pot $0.60 | Rake $0 
Seat 1: zHHLkD2sRljslKKeQv/ZQw folded before Flop (didn't bet)
Seat 2: NhUN/JpAprdJeamFBgJH1w (button) collected ($0.60)
Seat 3: 79Q62AM0VB++TQYiBlOYsA (small blind) folded before Flop
Seat 4: 0av6tRNdi0Ui4f15L7gsVg (big blind) folded before Flop
Seat 5: vqWjZmdQu/Hxw96/IJTWdQ folded before Flop (didn't bet)
Seat 6: cWc85bEzdRzpUMhRKm8pwQ folded before Flop (didn't bet)




PokerStars Game #59941678160:  Hold'em No Limit ($0.10/$0.25) - 2009/07/01 1:42:43 ET
Table 'srBTB98reCdD1TffxE6o7g' 6-max Seat #4 is the button
Seat 1: SFmT9ZsVopnukjvAzrxTRg ($34.30 in chips) 
Seat 2: mfrkWA3PTeYPkbO6hi98Aw ($25 in chips) 
Seat 3: VOmI0x4dDPnTESZd5B4d1Q ($47.85 in chips) 
Seat 4: 6DwBRH+xZ12AAZmeAg+aXw ($21.30 in chips) 
Seat 5: 8zUCJvLYLFM8AG6K5zjIvg ($12.05 in chips) 
Seat 6: BV+K0Phf5VBHr7aZPKqbUQ ($34.95 in chips) 
8zUCJvLYLFM8AG6K5zjIvg: posts small blind $0.10
BV+K0Phf5VBHr7aZPKqbUQ: posts big blind $0.25
*** HOLE CARDS ***
SFmT9ZsVopnukjvAzrxTRg: folds 
mfrkWA3PTeYPkbO6hi98Aw: folds 
VOmI0x4dDPnTESZd5B4d1Q: folds 
6DwBRH+xZ12AAZmeAg+aXw: raises $0.50 to $0.75
8zUCJvLYLFM8AG6K5zjIvg: calls $0.65
BV+K0Phf5VBHr7aZPKqbUQ: folds 
*** FLOP *** [5d 7h 6d]
8zUCJvLYLFM8AG6K5zjIvg: checks 
6DwBRH+xZ12AAZmeAg+aXw: bets $1
8zUCJvLYLFM8AG6K5zjIvg: calls $1
*** TURN *** [5d 7h 6d] [4h]
8zUCJvLYLFM8AG6K5zjIvg: bets $1.50
6DwBRH+xZ12AAZmeAg+aXw: calls $1.50
*** RIVER *** [5d 7h 6d 4h] [9s]
8zUCJvLYLFM8AG6K5zjIvg: bets $1.50
6DwBRH+xZ12AAZmeAg+aXw: calls $1.50
*** SHOW DOWN ***
8zUCJvLYLFM8AG6K5zjIvg: shows [3s Ad] (a straight, Three to Seven)
6DwBRH+xZ12AAZmeAg+aXw: mucks hand 
8zUCJvLYLFM8AG6K5zjIvg collected $9.30 from pot
*** SUMMARY ***
Total pot $9.75 | Rake $0.45 
Board [5d 7h 6d 4h 9s]
Seat 1: SFmT9ZsVopnukjvAzrxTRg folded before Flop (didn't bet)
Seat 2: mfrkWA3PTeYPkbO6hi98Aw folded before Flop (didn't bet)
Seat 3: VOmI0x4dDPnTESZd5B4d1Q folded before Flop (didn't bet)
Seat 4: 6DwBRH+xZ12AAZmeAg+aXw (button) mucked
Seat 5: 8zUCJvLYLFM8AG6K5zjIvg (small blind) showed [3s Ad] and won ($9.30) with a straight, Three to Seven
Seat 6: BV+K0Phf5VBHr7aZPKqbUQ (big blind) folded before Flop




PokerStars Game #59941678432:  Hold'em No Limit ($0.10/$0.25) - 2009/07/01 1:42:43 ET
Table '0mmHveGuaIfIMQlNE1eqMg' 9-max Seat #4 is the button
Seat 1: ydoFOVgzvZv9ZhuWu9rXAw ($5 in chips) 
Seat 2: rQhYIYXSyH/IivYM1dlV5A ($68.85 in chips) 
Seat 3: ghNKXUBl/H+t83JF079ZBA ($25 in chips) 
Seat 4: DnDcAdn9P0zGovMERigpFA ($35 in chips) 
Seat 5: Pt637jKksB5MzP0UNJAAkw ($8.95 in chips) 
Seat 6: 6RiVTYll/5D8zICp0MRpKw ($24.20 in chips) 
Seat 9: UNw/UrAelsQeSS17Rro/BA ($11.15 in chips) 
Pt637jKksB5MzP0UNJAAkw: posts small blind $0.10
6RiVTYll/5D8zICp0MRpKw: posts big blind $0.25
5n7e7I+px7c6CQmLpPbtsg: sits out 
0XACOSNrAWmqNv9k1nF8rw: sits out 
*** HOLE CARDS ***
UNw/UrAelsQeSS17Rro/BA: folds 
ydoFOVgzvZv9ZhuWu9rXAw: folds 
rQhYIYXSyH/IivYM1dlV5A: folds 
ghNKXUBl/H+t83JF079ZBA: raises $0.50 to $0.75
DnDcAdn9P0zGovMERigpFA: raises $2.50 to $3.25
Pt637jKksB5MzP0UNJAAkw: folds 
6RiVTYll/5D8zICp0MRpKw: folds 
ghNKXUBl/H+t83JF079ZBA: folds 
Uncalled bet ($2.50) returned to DnDcAdn9P0zGovMERigpFA
DnDcAdn9P0zGovMERigpFA collected $1.85 from pot
DnDcAdn9P0zGovMERigpFA: doesn't show hand 
*** SUMMARY ***
Total pot $1.85 | Rake $0 
Seat 1: ydoFOVgzvZv9ZhuWu9rXAw folded before Flop (didn't bet)
Seat 2: rQhYIYXSyH/IivYM1dlV5A folded before Flop (didn't bet)
Seat 3: ghNKXUBl/H+t83JF079ZBA folded before Flop
Seat 4: DnDcAdn9P0zGovMERigpFA (button) collected ($1.85)
Seat 5: Pt637jKksB5MzP0UNJAAkw (small blind) folded before Flop
Seat 6: 6RiVTYll/5D8zICp0MRpKw (big blind) folded before Flop
Seat 9: UNw/UrAelsQeSS17Rro/BA folded before Flop (didn't bet)




PokerStars Game #59941678464:  Hold'em No Limit ($0.10/$0.25) - 2009/07/01 1:42:43 ET
Table 'ohAuixfiLOYDylNUG5mNUw' 9-max Seat #8 is the button
Seat 2: Th3FldXKQW6hWVVPahaoOQ ($27.15 in chips) 
Seat 3: gSakoFAgDDzXSb2eNBWKcg ($15 in chips) 
Seat 4: AiXn/9o1EwOPZUHujnh/bA ($18.65 in chips) 
Seat 5: wub1jsnHlpWmOX4uczVADA ($7.40 in chips) 
Seat 6: MtVtHDqIJTyUcXkRBBDIVA ($25 in chips) 
Seat 7: +qc/EYCgLC65SpGvr35eNg ($24.65 in chips) 
Seat 8: ppMlNkhYgErlt4fuJO7ADA ($2.50 in chips) 
Seat 9: CT7Xj/V/O5rBlhtt+RZeFQ ($25.10 in chips) 
CT7Xj/V/O5rBlhtt+RZeFQ: posts small blind $0.10
W6tExOcYX7qiy6Qdp+ZwFA: is sitting out 
Th3FldXKQW6hWVVPahaoOQ: posts big blind $0.25
*** HOLE CARDS ***
W6tExOcYX7qiy6Qdp+ZwFA leaves the table
gSakoFAgDDzXSb2eNBWKcg: folds 
AiXn/9o1EwOPZUHujnh/bA: folds 
wub1jsnHlpWmOX4uczVADA: calls $0.25
MtVtHDqIJTyUcXkRBBDIVA: folds 
+qc/EYCgLC65SpGvr35eNg: folds 
ppMlNkhYgErlt4fuJO7ADA: folds 
CT7Xj/V/O5rBlhtt+RZeFQ: calls $0.15
Th3FldXKQW6hWVVPahaoOQ: checks 
*** FLOP *** [As Jd Tc]
CT7Xj/V/O5rBlhtt+RZeFQ: bets $1
Th3FldXKQW6hWVVPahaoOQ: folds 
wub1jsnHlpWmOX4uczVADA: folds 
Uncalled bet ($1) returned to CT7Xj/V/O5rBlhtt+RZeFQ
qwr38jl5txoR36M7G5qi4A joins the table at seat #1 
CT7Xj/V/O5rBlhtt+RZeFQ collected $0.75 from pot
CT7Xj/V/O5rBlhtt+RZeFQ: doesn't show hand 
*** SUMMARY ***
Total pot $0.75 | Rake $0 
Board [As Jd Tc]
Seat 2: Th3FldXKQW6hWVVPahaoOQ (big blind) folded on the Flop
Seat 3: gSakoFAgDDzXSb2eNBWKcg folded before Flop (didn't bet)
Seat 4: AiXn/9o1EwOPZUHujnh/bA folded before Flop (didn't bet)
Seat 5: wub1jsnHlpWmOX4uczVADA folded on the Flop
Seat 6: MtVtHDqIJTyUcXkRBBDIVA folded before Flop (didn't bet)
Seat 7: +qc/EYCgLC65SpGvr35eNg folded before Flop (didn't bet)
Seat 8: ppMlNkhYgErlt4fuJO7ADA (button) folded before Flop (didn't bet)
Seat 9: CT7Xj/V/O5rBlhtt+RZeFQ (small blind) collected ($0.75)




PokerStars Game #59941677994:  Hold'em No Limit ($0.10/$0.25) - 2009/07/01 1:42:43 ET
Table '3lS+sU5k6mwJCS2nFMmQ6Q' 9-max Seat #3 is the button
Seat 1: VWUWpMLMj/Q1jRVpF7Aohw ($13.45 in chips) 
Seat 3: 1DXccE2UUK5DIRVGlOKnTA ($12.70 in chips) 
Seat 4: ydoFOVgzvZv9ZhuWu9rXAw ($10.45 in chips) 
Seat 5: NcPAt5YjVvDFEJTTgAVj8g ($5.05 in chips) 
Seat 6: hJ4uYjNmSZdjrKA8cjZqCA ($36.50 in chips) 
Seat 7: Th3FldXKQW6hWVVPahaoOQ ($30.85 in chips) 
Seat 8: 9lvO/qyU+xrU95Teu1fv0g ($5 in chips) 
Seat 9: 4awUyiDYTgylQKXZ9faBVA ($49.20 in chips) 
ydoFOVgzvZv9ZhuWu9rXAw: posts small blind $0.10
NcPAt5YjVvDFEJTTgAVj8g: posts big blind $0.25
*** HOLE CARDS ***
hJ4uYjNmSZdjrKA8cjZqCA: folds 
Th3FldXKQW6hWVVPahaoOQ: folds 
9lvO/qyU+xrU95Teu1fv0g: folds 
TFFS leaves the table
4awUyiDYTgylQKXZ9faBVA: folds 
VWUWpMLMj/Q1jRVpF7Aohw: folds 
1DXccE2UUK5DIRVGlOKnTA: folds 
ydoFOVgzvZv9ZhuWu9rXAw: calls $0.15
PdIasPkzm2sqZnN41ZRXOg joins the table at seat #2 
NcPAt5YjVvDFEJTTgAVj8g: checks 
*** FLOP *** [Js Th 3h]
ydoFOVgzvZv9ZhuWu9rXAw: bets $0.50
NcPAt5YjVvDFEJTTgAVj8g: folds 
Uncalled bet ($0.50) returned to ydoFOVgzvZv9ZhuWu9rXAw
ydoFOVgzvZv9ZhuWu9rXAw collected $0.50 from pot
ydoFOVgzvZv9ZhuWu9rXAw: doesn't show hand 
*** SUMMARY ***
Total pot $0.50 | Rake $0 
Board [Js Th 3h]
Seat 1: VWUWpMLMj/Q1jRVpF7Aohw folded before Flop (didn't bet)
Seat 3: 1DXccE2UUK5DIRVGlOKnTA (button) folded before Flop (didn't bet)
Seat 4: ydoFOVgzvZv9ZhuWu9rXAw (small blind) collected ($0.50)
Seat 5: NcPAt5YjVvDFEJTTgAVj8g (big blind) folded on the Flop
Seat 6: hJ4uYjNmSZdjrKA8cjZqCA folded before Flop (didn't bet)
Seat 7: Th3FldXKQW6hWVVPahaoOQ folded before Flop (didn't bet)
Seat 8: 9lvO/qyU+xrU95Teu1fv0g folded before Flop (didn't bet)
Seat 9: 4awUyiDYTgylQKXZ9faBVA folded before Flop (didn't bet)




PokerStars Game #59941677948:  Hold'em No Limit ($0.10/$0.25) - 2009/07/01 1:42:43 ET
Table 'wGizWOswEL6P5QrvVkno/g' 6-max Seat #3 is the button
Seat 1: Qbfkn+ucISvbd1Xh32zAGA ($24.65 in chips) 
Seat 2: mfrkWA3PTeYPkbO6hi98Aw ($25 in chips) 
Seat 3: bJFzs6QmEEnz4miMfSDtcg ($14.40 in chips) 
Seat 4: 32YL2ZEp8NT4JB2RVM9euQ ($16.40 in chips) 
Seat 6: rfSnsAuAfXTb8w/obc9OVQ ($8.25 in chips) 
32YL2ZEp8NT4JB2RVM9euQ: posts small blind $0.10
wsP46AGpqDjHZQmlRHKa9g: is sitting out 
rfSnsAuAfXTb8w/obc9OVQ: posts big blind $0.25
*** HOLE CARDS ***
Qbfkn+ucISvbd1Xh32zAGA: folds 
mfrkWA3PTeYPkbO6hi98Aw: folds 
bJFzs6QmEEnz4miMfSDtcg: calls $0.25
32YL2ZEp8NT4JB2RVM9euQ: folds 
rfSnsAuAfXTb8w/obc9OVQ: checks 
*** FLOP *** [Kh 8s Ks]
rfSnsAuAfXTb8w/obc9OVQ: bets $0.25
bJFzs6QmEEnz4miMfSDtcg: calls $0.25
*** TURN *** [Kh 8s Ks] [4s]
rfSnsAuAfXTb8w/obc9OVQ: bets $0.25
bJFzs6QmEEnz4miMfSDtcg: calls $0.25
*** RIVER *** [Kh 8s Ks 4s] [9h]
rfSnsAuAfXTb8w/obc9OVQ: bets $0.50
bJFzs6QmEEnz4miMfSDtcg: folds 
Uncalled bet ($0.50) returned to rfSnsAuAfXTb8w/obc9OVQ
rfSnsAuAfXTb8w/obc9OVQ collected $1.55 from pot
rfSnsAuAfXTb8w/obc9OVQ: doesn't show hand 
*** SUMMARY ***
Total pot $1.60 | Rake $0.05 
Board [Kh 8s Ks 4s 9h]
Seat 1: Qbfkn+ucISvbd1Xh32zAGA folded before Flop (didn't bet)
Seat 2: mfrkWA3PTeYPkbO6hi98Aw folded before Flop (didn't bet)
Seat 3: bJFzs6QmEEnz4miMfSDtcg (button) folded on the River
Seat 4: 32YL2ZEp8NT4JB2RVM9euQ (small blind) folded before Flop
Seat 6: rfSnsAuAfXTb8w/obc9OVQ (big blind) collected ($1.55)




PokerStars Game #59941678300:  Hold'em No Limit ($0.10/$0.25) - 2009/07/01 1:42:43 ET
Table 'ER5H84HUgJx7HyDLnELLeA' 6-max Seat #6 is the button
Seat 1: LJI7A1YgDM7hgh7o56+ReQ ($27.25 in chips) 
Seat 3: memV5jkoAdGrnRy3Q9PM7w ($19.90 in chips) 
Seat 4: vqWjZmdQu/Hxw96/IJTWdQ ($25 in chips) 
Seat 5: mfrkWA3PTeYPkbO6hi98Aw ($25.55 in chips) 
Seat 6: 3zD3qLXT1bEffAoWGnc7wg ($51 in chips) 
LJI7A1YgDM7hgh7o56+ReQ: posts small blind $0.10
memV5jkoAdGrnRy3Q9PM7w: posts big blind $0.25
*** HOLE CARDS ***
vqWjZmdQu/Hxw96/IJTWdQ: raises $0.75 to $1
mfrkWA3PTeYPkbO6hi98Aw: folds 
3zD3qLXT1bEffAoWGnc7wg: folds 
LJI7A1YgDM7hgh7o56+ReQ: folds 
memV5jkoAdGrnRy3Q9PM7w: folds 
Uncalled bet ($0.75) returned to vqWjZmdQu/Hxw96/IJTWdQ
vqWjZmdQu/Hxw96/IJTWdQ collected $0.60 from pot
vqWjZmdQu/Hxw96/IJTWdQ: doesn't show hand 
*** SUMMARY ***
Total pot $0.60 | Rake $0 
Seat 1: LJI7A1YgDM7hgh7o56+ReQ (small blind) folded before Flop
Seat 3: memV5jkoAdGrnRy3Q9PM7w (big blind) folded before Flop
Seat 4: vqWjZmdQu/Hxw96/IJTWdQ collected ($0.60)
Seat 5: mfrkWA3PTeYPkbO6hi98Aw folded before Flop (didn't bet)
Seat 6: 3zD3qLXT1bEffAoWGnc7wg (button) folded before Flop (didn't bet)




PokerStars Game #59941678562:  Hold'em No Limit ($0.10/$0.25) - 2009/07/01 1:42:44 ET
Table 'yAHDCs33TIgw3ra63xuU2Q' 9-max Seat #7 is the button
Seat 1: ydoFOVgzvZv9ZhuWu9rXAw ($4.90 in chips) 
Seat 3: g6UPjSyxNLffCi+EqqIlEg ($21 in chips) 
Seat 4: j5spkbnOCRiLGiH6iqBaqw ($8.25 in chips) 
Seat 5: 4awUyiDYTgylQKXZ9faBVA ($37.60 in chips) 
Seat 6: DnDcAdn9P0zGovMERigpFA ($26.30 in chips) 
Seat 7: qxWFg3MZuVyidB0SJh5ywg ($27.75 in chips) 
Seat 8: tYsOBqdU1+x+yFI7zHO7hQ ($25 in chips) 
Seat 9: MtVtHDqIJTyUcXkRBBDIVA ($25.05 in chips) 
tYsOBqdU1+x+yFI7zHO7hQ: posts small blind $0.10
MtVtHDqIJTyUcXkRBBDIVA: posts big blind $0.25
*** HOLE CARDS ***
ydoFOVgzvZv9ZhuWu9rXAw: folds 
g6UPjSyxNLffCi+EqqIlEg: folds 
j5spkbnOCRiLGiH6iqBaqw: calls $0.25
4awUyiDYTgylQKXZ9faBVA: folds 
DnDcAdn9P0zGovMERigpFA: folds 
qxWFg3MZuVyidB0SJh5ywg: folds 
tYsOBqdU1+x+yFI7zHO7hQ: folds 
MtVtHDqIJTyUcXkRBBDIVA: checks 
*** FLOP *** [3s 6d Th]
MtVtHDqIJTyUcXkRBBDIVA: checks 
j5spkbnOCRiLGiH6iqBaqw: checks 
*** TURN *** [3s 6d Th] [4d]
MtVtHDqIJTyUcXkRBBDIVA: checks 
j5spkbnOCRiLGiH6iqBaqw: checks 
*** RIVER *** [3s 6d Th 4d] [Js]
MtVtHDqIJTyUcXkRBBDIVA: checks 
j5spkbnOCRiLGiH6iqBaqw: checks 
*** SHOW DOWN ***
MtVtHDqIJTyUcXkRBBDIVA: shows [5d 8c] (high card Jack)
j5spkbnOCRiLGiH6iqBaqw: shows [7h As] (high card Ace)
j5spkbnOCRiLGiH6iqBaqw collected $0.60 from pot
*** SUMMARY ***
Total pot $0.60 | Rake $0 
Board [3s 6d Th 4d Js]
Seat 1: ydoFOVgzvZv9ZhuWu9rXAw folded before Flop (didn't bet)
Seat 3: g6UPjSyxNLffCi+EqqIlEg folded before Flop (didn't bet)
Seat 4: j5spkbnOCRiLGiH6iqBaqw showed [7h As] and won ($0.60) with high card Ace
Seat 5: 4awUyiDYTgylQKXZ9faBVA folded before Flop (didn't bet)
Seat 6: DnDcAdn9P0zGovMERigpFA folded before Flop (didn't bet)
Seat 7: qxWFg3MZuVyidB0SJh5ywg (button) folded before Flop (didn't bet)
Seat 8: tYsOBqdU1+x+yFI7zHO7hQ (small blind) folded before Flop
Seat 9: MtVtHDqIJTyUcXkRBBDIVA (big blind) showed [5d 8c] and lost with high card Jack




PokerStars Game #59941678850:  Hold'em No Limit ($0.10/$0.25) - 2009/07/01 1:42:44 ET
Table 'nyTW9cVtYentc5V7xU/0jA' 6-max Seat #2 is the button
Seat 1: HI20pVxSHPZ29u9IDkmICg ($11.40 in chips) 
Seat 2: v6mkGzCBCCXcgWQNSYVtKg ($6.15 in chips) 
Seat 3: kG34n23qFQA3nzdOJTQ1dA ($36.20 in chips) 
Seat 4: NkB3D4eVHHXvB9Edaugc1Q ($19.80 in chips) 
Seat 5: zZAcuQ0EvirdEuiIbeaocQ ($14.45 in chips) 
kG34n23qFQA3nzdOJTQ1dA: posts small blind $0.10
NkB3D4eVHHXvB9Edaugc1Q: posts big blind $0.25
*** HOLE CARDS ***
zZAcuQ0EvirdEuiIbeaocQ: calls $0.25
HI20pVxSHPZ29u9IDkmICg: folds 
v6mkGzCBCCXcgWQNSYVtKg: folds 
kG34n23qFQA3nzdOJTQ1dA: folds 
NkB3D4eVHHXvB9Edaugc1Q: checks 
*** FLOP *** [5d 5s 5h]
NkB3D4eVHHXvB9Edaugc1Q: checks 
zZAcuQ0EvirdEuiIbeaocQ: bets $0.50
NkB3D4eVHHXvB9Edaugc1Q: calls $0.50
*** TURN *** [5d 5s 5h] [7c]
NkB3D4eVHHXvB9Edaugc1Q: checks 
zZAcuQ0EvirdEuiIbeaocQ: bets $1
NkB3D4eVHHXvB9Edaugc1Q: calls $1
*** RIVER *** [5d 5s 5h 7c] [7h]
NkB3D4eVHHXvB9Edaugc1Q: checks 
zZAcuQ0EvirdEuiIbeaocQ: bets $12.70 and is all-in
NkB3D4eVHHXvB9Edaugc1Q: calls $12.70
*** SHOW DOWN ***
zZAcuQ0EvirdEuiIbeaocQ: shows [6c 4c] (a full house, Fives full of Sevens)
NkB3D4eVHHXvB9Edaugc1Q: shows [5c Js] (four of a kind, Fives)
NkB3D4eVHHXvB9Edaugc1Q collected $27.60 from pot
*** SUMMARY ***
Total pot $29 | Rake $1.40 
Board [5d 5s 5h 7c 7h]
Seat 1: HI20pVxSHPZ29u9IDkmICg folded before Flop (didn't bet)
Seat 2: v6mkGzCBCCXcgWQNSYVtKg (button) folded before Flop (didn't bet)
Seat 3: kG34n23qFQA3nzdOJTQ1dA (small blind) folded before Flop
Seat 4: NkB3D4eVHHXvB9Edaugc1Q (big blind) showed [5c Js] and won ($27.60) with four of a kind, Fives
Seat 5: zZAcuQ0EvirdEuiIbeaocQ showed [6c 4c] and lost with a full house, Fives full of Sevens




PokerStars Game #59941678892:  Hold'em No Limit ($0.10/$0.25) - 2009/07/01 1:42:44 ET
Table 'tANpk8z1C5o0Pq/hpYShHw' 9-max Seat #9 is the button
Seat 1: rQhYIYXSyH/IivYM1dlV5A ($17.40 in chips) 
Seat 2: og4yH4sZUZdC8jjgW8zPJQ ($8.40 in chips) 
Seat 6: kN0AWJG6biW8tHtuF+wTjA ($14.50 in chips) 
Seat 7: aNpwfA31EREwO+ar4XzBCw ($27.30 in chips) 
Seat 9: gE5rN2TDY1aXcZn/TOPeZw ($7.45 in chips) 
rQhYIYXSyH/IivYM1dlV5A: posts small blind $0.10
og4yH4sZUZdC8jjgW8zPJQ: posts big blind $0.25
j4q3p0lesp63b1gZDwLBZw: sits out 
X6+pSIPfovPcE87t+LmUKQ: sits out 
Z9W7+g1WMhhZDi7DwGbCFA: sits out 
*** HOLE CARDS ***
kN0AWJG6biW8tHtuF+wTjA: folds 
aNpwfA31EREwO+ar4XzBCw: folds 
gE5rN2TDY1aXcZn/TOPeZw: folds 
rQhYIYXSyH/IivYM1dlV5A: calls $0.15
og4yH4sZUZdC8jjgW8zPJQ: checks 
*** FLOP *** [Tc 6s Jh]
rQhYIYXSyH/IivYM1dlV5A: checks 
og4yH4sZUZdC8jjgW8zPJQ: checks 
*** TURN *** [Tc 6s Jh] [9c]
rQhYIYXSyH/IivYM1dlV5A: checks 
og4yH4sZUZdC8jjgW8zPJQ: checks 
*** RIVER *** [Tc 6s Jh 9c] [Qd]
rQhYIYXSyH/IivYM1dlV5A: bets $0.25
og4yH4sZUZdC8jjgW8zPJQ: calls $0.25
*** SHOW DOWN ***
rQhYIYXSyH/IivYM1dlV5A: shows [9h Qs] (two pair, Queens and Nines)
og4yH4sZUZdC8jjgW8zPJQ: shows [4h 8d] (a straight, Eight to Queen)
og4yH4sZUZdC8jjgW8zPJQ collected $0.95 from pot
*** SUMMARY ***
Total pot $1 | Rake $0.05 
Board [Tc 6s Jh 9c Qd]
Seat 1: rQhYIYXSyH/IivYM1dlV5A (small blind) showed [9h Qs] and lost with two pair, Queens and Nines
Seat 2: og4yH4sZUZdC8jjgW8zPJQ (big blind) showed [4h 8d] and won ($0.95) with a straight, Eight to Queen
Seat 6: kN0AWJG6biW8tHtuF+wTjA folded before Flop (didn't bet)
Seat 7: aNpwfA31EREwO+ar4XzBCw folded before Flop (didn't bet)
Seat 9: gE5rN2TDY1aXcZn/TOPeZw (button) folded before Flop (didn't bet)




PokerStars Game #59941678730:  Hold'em No Limit ($0.10/$0.25) - 2009/07/01 1:42:44 ET
Table 'eOXPe2c6mG7DOFKvMsZZfA' 6-max Seat #3 is the button
Seat 1: s21kVGMLPAoHdWR+muSonw ($25.40 in chips) 
Seat 2: gaPMxLGp9SOj4Lq6t+/0Ig ($7.10 in chips) 
Seat 3: kReyZ6g6Fu3tQ0nyjDf9kA ($25.85 in chips) 
Seat 4: zHHLkD2sRljslKKeQv/ZQw ($36.60 in chips) 
Seat 5: NhUN/JpAprdJeamFBgJH1w ($32.15 in chips) 
Seat 6: Qpv/hb5ak7LeaDig1L5L8w ($13.60 in chips) 
zHHLkD2sRljslKKeQv/ZQw: posts small blind $0.10
NhUN/JpAprdJeamFBgJH1w: posts big blind $0.25
*** HOLE CARDS ***
Qpv/hb5ak7LeaDig1L5L8w: folds 
s21kVGMLPAoHdWR+muSonw: folds 
gaPMxLGp9SOj4Lq6t+/0Ig: folds 
kReyZ6g6Fu3tQ0nyjDf9kA: folds 
zHHLkD2sRljslKKeQv/ZQw: calls $0.15
NhUN/JpAprdJeamFBgJH1w: checks 
*** FLOP *** [2s Ks 5h]
zHHLkD2sRljslKKeQv/ZQw: checks 
NhUN/JpAprdJeamFBgJH1w: bets $0.50
zHHLkD2sRljslKKeQv/ZQw: folds 
Uncalled bet ($0.50) returned to NhUN/JpAprdJeamFBgJH1w
NhUN/JpAprdJeamFBgJH1w collected $0.50 from pot
NhUN/JpAprdJeamFBgJH1w: doesn't show hand 
*** SUMMARY ***
Total pot $0.50 | Rake $0 
Board [2s Ks 5h]
Seat 1: s21kVGMLPAoHdWR+muSonw folded before Flop (didn't bet)
Seat 2: gaPMxLGp9SOj4Lq6t+/0Ig folded before Flop (didn't bet)
Seat 3: kReyZ6g6Fu3tQ0nyjDf9kA (button) folded before Flop (didn't bet)
Seat 4: zHHLkD2sRljslKKeQv/ZQw (small blind) folded on the Flop
Seat 5: NhUN/JpAprdJeamFBgJH1w (big blind) collected ($0.50)
Seat 6: Qpv/hb5ak7LeaDig1L5L8w folded before Flop (didn't bet)




PokerStars Game #59941678518:  Hold'em No Limit ($0.10/$0.25) - 2009/07/01 1:42:44 ET
Table 'T/iCKJXGphRN3xcdwfE/JQ' 6-max Seat #1 is the button
Seat 1: wAKC8C/zN0c8V5v13dm9mA ($25 in chips) 
Seat 2: EeUZtMU058v2ObUACOF4Og ($36.40 in chips) 
Seat 3: IWAjoCPXtc1XUaZdp+pCpA ($21.75 in chips) 
Seat 4: tSR4329m40dZsN7YOpI9Kw ($52.95 in chips) 
Seat 5: gaPMxLGp9SOj4Lq6t+/0Ig ($4.20 in chips) 
Seat 6: Ey4Kn6PlnYb2srYYBJHvzg ($14.95 in chips) 
EeUZtMU058v2ObUACOF4Og: posts small blind $0.10
IWAjoCPXtc1XUaZdp+pCpA: posts big blind $0.25
*** HOLE CARDS ***
tSR4329m40dZsN7YOpI9Kw: folds 
gaPMxLGp9SOj4Lq6t+/0Ig: folds 
Ey4Kn6PlnYb2srYYBJHvzg: raises $0.50 to $0.75
wAKC8C/zN0c8V5v13dm9mA: folds 
EeUZtMU058v2ObUACOF4Og: folds 
IWAjoCPXtc1XUaZdp+pCpA: calls $0.50
*** FLOP *** [9s 9c Ac]
IWAjoCPXtc1XUaZdp+pCpA: checks 
Ey4Kn6PlnYb2srYYBJHvzg: checks 
*** TURN *** [9s 9c Ac] [4d]
IWAjoCPXtc1XUaZdp+pCpA: bets $1
Ey4Kn6PlnYb2srYYBJHvzg: calls $1
*** RIVER *** [9s 9c Ac 4d] [Ks]
IWAjoCPXtc1XUaZdp+pCpA: bets $2
Ey4Kn6PlnYb2srYYBJHvzg: folds 
Uncalled bet ($2) returned to IWAjoCPXtc1XUaZdp+pCpA
IWAjoCPXtc1XUaZdp+pCpA collected $3.45 from pot
*** SUMMARY ***
Total pot $3.60 | Rake $0.15 
Board [9s 9c Ac 4d Ks]
Seat 1: wAKC8C/zN0c8V5v13dm9mA (button) folded before Flop (didn't bet)
Seat 2: EeUZtMU058v2ObUACOF4Og (small blind) folded before Flop
Seat 3: IWAjoCPXtc1XUaZdp+pCpA (big blind) collected ($3.45)
Seat 4: tSR4329m40dZsN7YOpI9Kw folded before Flop (didn't bet)
Seat 5: gaPMxLGp9SOj4Lq6t+/0Ig folded before Flop (didn't bet)
Seat 6: Ey4Kn6PlnYb2srYYBJHvzg folded on the River




PokerStars Game #59941678582:  Hold'em No Limit ($0.10/$0.25) - 2009/07/01 1:42:44 ET
Table 'O5NgMYt6EWbLBozZb3kseg' 6-max Seat #6 is the button
Seat 1: MCCWc70bl051s/EF6nHRcA ($32 in chips) 
Seat 2: /gJNBeCkWL4o85/jvlZ4BA ($34.50 in chips) 
Seat 3: tLM9aw7T3kBEIhQEh1roOg ($6.25 in chips) 
Seat 4: txiWmlZ/sfM8Td16RHH/cA ($3.70 in chips) 
Seat 5: vu2kzHaDtgr6NM7rdq0chA ($85.20 in chips) 
Seat 6: k9vn40MOqqb+xF+7GZ6v2g ($112.65 in chips) 
MCCWc70bl051s/EF6nHRcA: posts small blind $0.10
/gJNBeCkWL4o85/jvlZ4BA: posts big blind $0.25
*** HOLE CARDS ***
tLM9aw7T3kBEIhQEh1roOg: calls $0.25
txiWmlZ/sfM8Td16RHH/cA: raises $0.25 to $0.50
vu2kzHaDtgr6NM7rdq0chA: folds 
k9vn40MOqqb+xF+7GZ6v2g: calls $0.50
MCCWc70bl051s/EF6nHRcA: folds 
/gJNBeCkWL4o85/jvlZ4BA: folds 
tLM9aw7T3kBEIhQEh1roOg: raises $0.75 to $1.25
txiWmlZ/sfM8Td16RHH/cA: calls $0.75
k9vn40MOqqb+xF+7GZ6v2g: calls $0.75
*** FLOP *** [9c 3d 2d]
tLM9aw7T3kBEIhQEh1roOg: checks 
txiWmlZ/sfM8Td16RHH/cA: checks 
k9vn40MOqqb+xF+7GZ6v2g: checks 
*** TURN *** [9c 3d 2d] [9d]
tLM9aw7T3kBEIhQEh1roOg: bets $0.75
txiWmlZ/sfM8Td16RHH/cA: raises $1.70 to $2.45 and is all-in
k9vn40MOqqb+xF+7GZ6v2g: calls $2.45
tLM9aw7T3kBEIhQEh1roOg: raises $1.70 to $4.15
k9vn40MOqqb+xF+7GZ6v2g: calls $1.70
*** RIVER *** [9c 3d 2d 9d] [Td]
tLM9aw7T3kBEIhQEh1roOg: checks 
k9vn40MOqqb+xF+7GZ6v2g: bets $1
tLM9aw7T3kBEIhQEh1roOg: calls $0.85 and is all-in
Uncalled bet ($0.15) returned to k9vn40MOqqb+xF+7GZ6v2g
*** SHOW DOWN ***
k9vn40MOqqb+xF+7GZ6v2g: shows [Ah Kd] (a flush, King high)
tLM9aw7T3kBEIhQEh1roOg: mucks hand 
k9vn40MOqqb+xF+7GZ6v2g collected $4.90 from side pot
txiWmlZ/sfM8Td16RHH/cA: mucks hand 
k9vn40MOqqb+xF+7GZ6v2g collected $10.90 from main pot
txiWmlZ/sfM8Td16RHH/cA leaves the table
*** SUMMARY ***
Total pot $16.55 Main pot $10.90. Side pot $4.90. | Rake $0.75 
Board [9c 3d 2d 9d Td]
Seat 1: MCCWc70bl051s/EF6nHRcA (small blind) folded before Flop
Seat 2: /gJNBeCkWL4o85/jvlZ4BA (big blind) folded before Flop
Seat 3: tLM9aw7T3kBEIhQEh1roOg mucked
Seat 4: txiWmlZ/sfM8Td16RHH/cA mucked
Seat 5: vu2kzHaDtgr6NM7rdq0chA folded before Flop (didn't bet)
Seat 6: k9vn40MOqqb+xF+7GZ6v2g (button) showed [Ah Kd] and won ($15.80) with a flush, King high




PokerStars Game #59941678726:  Hold'em No Limit ($0.10/$0.25) - 2009/07/01 1:42:44 ET
Table 'dZNBGqFYSwfOVZvDJ4VjIQ' 6-max Seat #3 is the button
Seat 1: v+QfkGiuj9bgtuNoVnDO8w ($33.20 in chips) 
Seat 2: 3zD3qLXT1bEffAoWGnc7wg ($25 in chips) 
Seat 3: kyRaCIljYA6l33lSKQfNsg ($28.30 in chips) 
Seat 4: mFv3iBCtrw9XfCDRB0d46Q ($6.25 in chips) 
Seat 5: +ZlnqPoP3Hg4BIUxDfKd/A ($36.50 in chips) 
Seat 6: ypmjhffk/YHGc51wgVXUTw ($30.75 in chips) 
mFv3iBCtrw9XfCDRB0d46Q: posts small blind $0.10
+ZlnqPoP3Hg4BIUxDfKd/A: posts big blind $0.25
*** HOLE CARDS ***
ypmjhffk/YHGc51wgVXUTw: folds 
v+QfkGiuj9bgtuNoVnDO8w: folds 
3zD3qLXT1bEffAoWGnc7wg: raises $0.50 to $0.75
kyRaCIljYA6l33lSKQfNsg: folds 
mFv3iBCtrw9XfCDRB0d46Q: folds 
+ZlnqPoP3Hg4BIUxDfKd/A: folds 
Uncalled bet ($0.50) returned to 3zD3qLXT1bEffAoWGnc7wg
3zD3qLXT1bEffAoWGnc7wg collected $0.60 from pot
3zD3qLXT1bEffAoWGnc7wg: doesn't show hand 
*** SUMMARY ***
Total pot $0.60 | Rake $0 
Seat 1: v+QfkGiuj9bgtuNoVnDO8w folded before Flop (didn't bet)
Seat 2: 3zD3qLXT1bEffAoWGnc7wg collected ($0.60)
Seat 3: kyRaCIljYA6l33lSKQfNsg (button) folded before Flop (didn't bet)
Seat 4: mFv3iBCtrw9XfCDRB0d46Q (small blind) folded before Flop
Seat 5: +ZlnqPoP3Hg4BIUxDfKd/A (big blind) folded before Flop
Seat 6: ypmjhffk/YHGc51wgVXUTw folded before Flop (didn't bet)




PokerStars Game #599416787568296old'em No Limit ($0.10/$0.25) - 2009/07/01 1:42:44 ET
Table 'mk323gviqdkOY5Aek/1EWg' 6-max Seat #6 is the button
Seat 1: L3/N/gliETan8N5Gim5h4Q ($25.50 in chips) 
Seat 2: GC/9yVD59DUCX7hUI7gcLw ($56.40 in chips) 
Seat 3: NuqYPwTLZYQhxOoVK3Yqlw ($23.65 in chips) 
Seat 4: +baiVgI/ETnBARLe5mARCw ($12.15 in chips) 
Seat 5: kjYRzIfvZNNflYMYRkkSVA ($28 in chips) 
Seat 6: KkXSr5xFjxLSD3wtAvT+WQ ($8.45 in chips) 
L3/N/gliETan8N5Gim5h4Q: posts small blind $0.10
GC/9yVD59DUCX7hUI7gcLw: posts big blind $0.25
*** HOLE CARDS ***
NuqYPwTLZYQhxOoVK3Yqlw: folds 
+baiVgI/ETnBARLe5mARCw: folds 
kjYRzIfvZNNflYMYRkkSVA: folds 
KkXSr5xFjxLSD3wtAvT+WQ: raises $0.25 to $0.50
L3/N/gliETan8N5Gim5h4Q: folds 
GC/9yVD59DUCX7hUI7gcLw: calls $0.25
*** FLOP *** [6c Ac Jd]
GC/9yVD59DUCX7hUI7gcLw: checks 
KkXSr5xFjxLSD3wtAvT+WQ: bets $0.50
GC/9yVD59DUCX7hUI7gcLw: folds 
Uncalled bet ($0.50) returned to KkXSr5xFjxLSD3wtAvT+WQ
KkXSr5xFjxLSD3wtAvT+WQ collected $1.05 from pot
KkXSr5xFjxLSD3wtAvT+WQ: doesn't show hand 
*** SUMMARY ***
Total pot $1.10 | Rake $0.05 
Board [6c Ac Jd]
Seat 1: L3/N/gliETan8N5Gim5h4Q (small blind) folded before Flop
Seat 2: GC/9yVD59DUCX7hUI7gcLw (big blind) folded on the Flop
Seat 3: NuqYPwTLZYQhxOoVK3Yqlw folded before Flop (didn't bet)
Seat 4: +baiVgI/ETnBARLe5mARCw folded before Flop (didn't bet)
Seat 5: kjYRzIfvZNNflYMYRkkSVA folded before Flop (didn't bet)
Seat 6: KkXSr5xFjxLSD3wtAvT+WQ (button) collected ($1.05)




PokerStars Game #59941679248:  Hold'em No Limit ($0.10/$0.25) - 2009/07/01 1:42:45 ET
Table 'Do4nrTNDYpK3sQjwFxX+Og' 6-max Seat #5 is the button
Seat 1: 7JrQNOR9wRBxq9ijFhWieg ($38.90 in chips) 
Seat 2: tzMoGl9F0PUr5NibYueeSw ($68.45 in chips) 
Seat 3: TSmua8tGK3sTbwi0ynrW9Q ($25 in chips) 
Seat 4: cWc85bEzdRzpUMhRKm8pwQ ($33.40 in chips) 
Seat 5: Ew/TYPQIsbQ2X8nm5iAJBg ($35.20 in chips) 
Seat 6: lBoEwOFgzcERLIRUkUoRTw ($23.65 in chips) 
lBoEwOFgzcERLIRUkUoRTw: posts small blind $0.10
7JrQNOR9wRBxq9ijFhWieg: posts big blind $0.25
*** HOLE CARDS ***
tzMoGl9F0PUr5NibYueeSw: calls $0.25
TSmua8tGK3sTbwi0ynrW9Q: folds 
cWc85bEzdRzpUMhRKm8pwQ: folds 
Ew/TYPQIsbQ2X8nm5iAJBg: folds 
lBoEwOFgzcERLIRUkUoRTw: folds 
7JrQNOR9wRBxq9ijFhWieg: raises $0.50 to $0.75
tzMoGl9F0PUr5NibYueeSw: calls $0.50
*** FLOP *** [6c 9d 7s]
7JrQNOR9wRBxq9ijFhWieg: checks 
tzMoGl9F0PUr5NibYueeSw: bets $1
7JrQNOR9wRBxq9ijFhWieg said, "i have no piece of this"
7JrQNOR9wRBxq9ijFhWieg: folds 
Uncalled bet ($1) returned to tzMoGl9F0PUr5NibYueeSw
tzMoGl9F0PUr5NibYueeSw collected $1.55 from pot
tzMoGl9F0PUr5NibYueeSw: doesn't show hand 
*** SUMMARY ***
Total pot $1.60 | Rake $0.05 
Board [6c 9d 7s]
Seat 1: 7JrQNOR9wRBxq9ijFhWieg (big blind) folded on the Flop
Seat 2: tzMoGl9F0PUr5NibYueeSw collected ($1.55)
Seat 3: TSmua8tGK3sTbwi0ynrW9Q folded before Flop (didn't bet)
Seat 4: cWc85bEzdRzpUMhRKm8pwQ folded before Flop (didn't bet)
Seat 5: Ew/TYPQIsbQ2X8nm5iAJBg (button) folded before Flop (didn't bet)
Seat 6: lBoEwOFgzcERLIRUkUoRTw (small blind) folded before Flop




PokerStars Game #59941679208:  Hold'em No Limit ($0.10/$0.25) - 2009/07/01 1:42:45 ET
Table 'xmJKTGBeWCwutccj3YfupQ' 6-max Seat #4 is the button
Seat 1: sVbkVl4OznxBCfi66UB9vw ($27.55 in chips) 
Seat 2: AxhCSFlGEh+FAc+VUD31JQ ($23.20 in chips) 
Seat 3: T5wrp/d5jarm+SxNy8OQAg ($17.70 in chips) 
Seat 4: uWjhTVMpuIroxXcmD3Okug ($10 in chips) 
Seat 5: DE9hRlt14g+JdsRQ4wT7hg ($28.35 in chips) 
Seat 6: 9bpVv1/Qh9IYtXuCtl5VtQ ($25 in chips) 
DE9hRlt14g+JdsRQ4wT7hg: posts small blind $0.10
9bpVv1/Qh9IYtXuCtl5VtQ: posts big blind $0.25
*** HOLE CARDS ***
sVbkVl4OznxBCfi66UB9vw: folds 
AxhCSFlGEh+FAc+VUD31JQ: raises $0.25 to $0.50
T5wrp/d5jarm+SxNy8OQAg: calls $0.50
uWjhTVMpuIroxXcmD3Okug: calls $0.50
DE9hRlt14g+JdsRQ4wT7hg: folds 
9bpVv1/Qh9IYtXuCtl5VtQ: folds 
*** FLOP *** [5c Jc Qh]
AxhCSFlGEh+FAc+VUD31JQ: bets $0.25
T5wrp/d5jarm+SxNy8OQAg: raises $1.25 to $1.50
uWjhTVMpuIroxXcmD3Okug: folds 
AxhCSFlGEh+FAc+VUD31JQ: calls $1.25
*** TURN *** [5c Jc Qh] [7d]
AxhCSFlGEh+FAc+VUD31JQ: checks 
T5wrp/d5jarm+SxNy8OQAg: bets $2.75
AxhCSFlGEh+FAc+VUD31JQ: calls $2.75
*** RIVER *** [5c Jc Qh 7d] [Qd]
AxhCSFlGEh+FAc+VUD31JQ: checks 
T5wrp/d5jarm+SxNy8OQAg: checks 
*** SHOW DOWN ***
AxhCSFlGEh+FAc+VUD31JQ: shows [Ts Js] (two pair, Queens and Jacks)
T5wrp/d5jarm+SxNy8OQAg: shows [3c Qc] (three of a kind, Queens)
T5wrp/d5jarm+SxNy8OQAg collected $9.85 from pot
*** SUMMARY ***
Total pot $10.35 | Rake $0.50 
Board [5c Jc Qh 7d Qd]
Seat 1: sVbkVl4OznxBCfi66UB9vw folded before Flop (didn't bet)
Seat 2: AxhCSFlGEh+FAc+VUD31JQ showed [Ts Js] and lost with two pair, Queens and Jacks
Seat 3: T5wrp/d5jarm+SxNy8OQAg showed [3c Qc] and won ($9.85) with three of a kind, Queens
Seat 4: uWjhTVMpuIroxXcmD3Okug (button) folded on the Flop
Seat 5: DE9hRlt14g+JdsRQ4wT7hg (small blind) folded before Flop
Seat 6: 9bpVv1/Qh9IYtXuCtl5VtQ (big blind) folded before Flop




PokerStars Game #59941679226:  Hold'em No Limit ($0.10/$0.25) - 2009/07/01 1:42:45 ET
Table 'Qk/910N2Yhg8u5vqTJk50Q' 9-max Seat #8 is the button
Seat 2: Th3FldXKQW6hWVVPahaoOQ ($45.65 in chips) 
Seat 3: ghNKXUBl/H+t83JF079ZBA ($26 in chips) 
Seat 5: zReBEigsxqZnag0RZAgpgA ($15.50 in chips) 
Seat 6: nAWaA+gDUSWOad+I9mKUEg ($8.65 in chips) 
Seat 7: aNpwfA31EREwO+ar4XzBCw ($26.35 in chips) 
Seat 8: 9PMD136+PrUsTwnP6fczyA ($13.90 in chips) 
Seat 9: M2QO2DxB5Wawg2h8HSpnYA ($18.20 in chips) 
M2QO2DxB5Wawg2h8HSpnYA: posts small blind $0.10
Th3FldXKQW6hWVVPahaoOQ: posts big blind $0.25
*** HOLE CARDS ***
ghNKXUBl/H+t83JF079ZBA: folds 
zReBEigsxqZnag0RZAgpgA: calls $0.25
nAWaA+gDUSWOad+I9mKUEg: calls $0.25
aNpwfA31EREwO+ar4XzBCw: folds 
9PMD136+PrUsTwnP6fczyA: calls $0.25
M2QO2DxB5Wawg2h8HSpnYA: calls $0.15
Th3FldXKQW6hWVVPahaoOQ: checks 
*** FLOP *** [2c 6c 5h]
M2QO2DxB5Wawg2h8HSpnYA: checks 
Th3FldXKQW6hWVVPahaoOQ: checks 
zReBEigsxqZnag0RZAgpgA: checks 
nAWaA+gDUSWOad+I9mKUEg: bets $0.25
9PMD136+PrUsTwnP6fczyA: calls $0.25
M2QO2DxB5Wawg2h8HSpnYA: calls $0.25
Th3FldXKQW6hWVVPahaoOQ: calls $0.25
zReBEigsxqZnag0RZAgpgA: folds 
*** TURN *** [2c 6c 5h] [9c]
M2QO2DxB5Wawg2h8HSpnYA: checks 
Th3FldXKQW6hWVVPahaoOQ: checks 
nAWaA+gDUSWOad+I9mKUEg: bets $0.75
9PMD136+PrUsTwnP6fczyA: calls $0.75
M2QO2DxB5Wawg2h8HSpnYA: folds 
Th3FldXKQW6hWVVPahaoOQ: folds 
*** RIVER *** [2c 6c 5h 9c] [7d]
nAWaA+gDUSWOad+I9mKUEg: bets $1
9PMD136+PrUsTwnP6fczyA: folds 
Uncalled bet ($1) returned to nAWaA+gDUSWOad+I9mKUEg
nAWaA+gDUSWOad+I9mKUEg collected $3.60 from pot
nAWaA+gDUSWOad+I9mKUEg: doesn't show hand 
*** SUMMARY ***
Total pot $3.75 | Rake $0.15 
Board [2c 6c 5h 9c 7d]
Seat 2: Th3FldXKQW6hWVVPahaoOQ (big blind) folded on the Turn
Seat 3: ghNKXUBl/H+t83JF079ZBA folded before Flop (didn't bet)
Seat 5: zReBEigsxqZnag0RZAgpgA folded on the Flop
Seat 6: nAWaA+gDUSWOad+I9mKUEg collected ($3.60)
Seat 7: aNpwfA31EREwO+ar4XzBCw folded before Flop (didn't bet)
Seat 8: 9PMD136+PrUsTwnP6fczyA (button) folded on the River
Seat 9: M2QO2DxB5Wawg2h8HSpnYA (small blind) folded on the Turn




PokerStars Game #59941679366:  Hold'em No Limit ($0.10/$0.25) - 2009/07/01 1:42:45 ET
Table '/JJyyIstHfkT7t/bW+WXgg' 6-max Seat #5 is the button
Seat 2: obJgSnVgWWWaAUtVILo77Q ($15.10 in chips) 
Seat 3: DR0nVIhVP77oEBlO9J8vlg ($38.25 in chips) 
Seat 4: JFIAqU8lCZ0vWwEl4bdGsg ($35.40 in chips) 
Seat 5: +ZlnqPoP3Hg4BIUxDfKd/A ($48.15 in chips) 
Seat 6: UmcUp27+PbgBItv3ZNlAWQ ($25 in chips) 
UmcUp27+PbgBItv3ZNlAWQ: posts small blind $0.10
wsP46AGpqDjHZQmlRHKa9g: is sitting out 
obJgSnVgWWWaAUtVILo77Q: posts big blind $0.25
*** HOLE CARDS ***
DR0nVIhVP77oEBlO9J8vlg: raises $0.50 to $0.75
JFIAqU8lCZ0vWwEl4bdGsg: folds 
+ZlnqPoP3Hg4BIUxDfKd/A: folds 
UmcUp27+PbgBItv3ZNlAWQ: folds 
obJgSnVgWWWaAUtVILo77Q: calls $0.50
*** FLOP *** [5h 3s 7d]
obJgSnVgWWWaAUtVILo77Q: checks 
DR0nVIhVP77oEBlO9J8vlg: checks 
*** TURN *** [5h 3s 7d] [2d]
obJgSnVgWWWaAUtVILo77Q: checks 
DR0nVIhVP77oEBlO9J8vlg: checks 
*** RIVER *** [5h 3s 7d 2d] [9s]
obJgSnVgWWWaAUtVILo77Q: checks 
DR0nVIhVP77oEBlO9J8vlg: checks 
*** SHOW DOWN ***
obJgSnVgWWWaAUtVILo77Q: shows [As Kd] (high card Ace)
DR0nVIhVP77oEBlO9J8vlg: mucks hand 
obJgSnVgWWWaAUtVILo77Q collected $1.55 from pot
*** SUMMARY ***
Total pot $1.60 | Rake $0.05 
Board [5h 3s 7d 2d 9s]
Seat 2: obJgSnVgWWWaAUtVILo77Q (big blind) showed [As Kd] and won ($1.55) with high card Ace
Seat 3: DR0nVIhVP77oEBlO9J8vlg mucked
Seat 4: JFIAqU8lCZ0vWwEl4bdGsg folded before Flop (didn't bet)
Seat 5: +ZlnqPoP3Hg4BIUxDfKd/A (button) folded before Flop (didn't bet)
Seat 6: UmcUp27+PbgBItv3ZNlAWQ (small blind) folded before Flop




PokerStars Game #59941680096:  Hold'em No Limit ($0.10/$0.25) - 2009/07/01 1:42:46 ET
Table 'n8mNkPYbe1AIQEkioNesZA' 9-max Seat #4 is the button
Seat 1: 9lvO/qyU+xrU95Teu1fv0g ($5.55 in chips) 
Seat 2: QEbIGci+itdw+re8RM5fZA ($30.05 in chips) 
Seat 4: zgi+EUykT/pZQpoUG6+oEg ($5 in chips) 
Seat 5: wGigCmBR/9XWkPpvYos3aQ ($28.90 in chips) 
Seat 6: HPEB+AtKw1+C/cxU0o1ciw ($46.90 in chips) 
Seat 7: sGFnnRCa1YAHAUmWgsW6Qg ($10 in chips) 
Seat 8: aNpwfA31EREwO+ar4XzBCw ($25.70 in chips) 
Seat 9: gehe91e0IyVT0QU/XBkEyg ($27.90 in chips) 
wGigCmBR/9XWkPpvYos3aQ: posts small blind $0.10
HPEB+AtKw1+C/cxU0o1ciw: posts big blind $0.25
*** HOLE CARDS ***
sGFnnRCa1YAHAUmWgsW6Qg: folds 
aNpwfA31EREwO+ar4XzBCw: folds 
gehe91e0IyVT0QU/XBkEyg: folds 
9lvO/qyU+xrU95Teu1fv0g: folds 
QEbIGci+itdw+re8RM5fZA: folds 
zgi+EUykT/pZQpoUG6+oEg: folds 
wGigCmBR/9XWkPpvYos3aQ: raises $0.65 to $0.90
HPEB+AtKw1+C/cxU0o1ciw: folds 
Uncalled bet ($0.65) returned to wGigCmBR/9XWkPpvYos3aQ
wGigCmBR/9XWkPpvYos3aQ collected $0.50 from pot
wGigCmBR/9XWkPpvYos3aQ: doesn't show hand 
*** SUMMARY ***
Total pot $0.50 | Rake $0 
Seat 1: 9lvO/qyU+xrU95Teu1fv0g folded before Flop (didn't bet)
Seat 2: QEbIGci+itdw+re8RM5fZA folded before Flop (didn't bet)
Seat 4: zgi+EUykT/pZQpoUG6+oEg (button) folded before Flop (didn't bet)
Seat 5: wGigCmBR/9XWkPpvYos3aQ (small blind) collected ($0.50)
Seat 6: HPEB+AtKw1+C/cxU0o1ciw (big blind) folded before Flop
Seat 7: sGFnnRCa1YAHAUmWgsW6Qg folded before Flop (didn't bet)
Seat 8: aNpwfA31EREwO+ar4XzBCw folded before Flop (didn't bet)
Seat 9: gehe91e0IyVT0QU/XBkEyg folded before Flop (didn't bet)




PokerStars Game #59941679820:  Hold'em No Limit ($0.10/$0.25) - 2009/07/01 1:42:46 ET
Table 'FuFyQHmlO/QqQp//rDRrPg' 6-max Seat #6 is the button
Seat 1: jp34e617tIzV8tKIWmfAbA ($27.50 in chips) 
Seat 2: G3h3THGB1j3qdHDVHpnJWg ($22.80 in chips) 
Seat 3: EeUZtMU058v2ObUACOF4Og ($30.60 in chips) 
Seat 5: xrf8tAXKQHG99HixCot1Iw ($25.60 in chips) 
Seat 6: 6DwBRH+xZ12AAZmeAg+aXw ($57.55 in chips) 
jp34e617tIzV8tKIWmfAbA: posts small blind $0.10
G3h3THGB1j3qdHDVHpnJWg: posts big blind $0.25
Ahsa9Yk5NPmCqQstq1EoQA: sits out 
*** HOLE CARDS ***
EeUZtMU058v2ObUACOF4Og: folds 
xrf8tAXKQHG99HixCot1Iw: folds 
6DwBRH+xZ12AAZmeAg+aXw: folds 
jp34e617tIzV8tKIWmfAbA: folds 
Uncalled bet ($0.15) returned to G3h3THGB1j3qdHDVHpnJWg
G3h3THGB1j3qdHDVHpnJWg collected $0.20 from pot
*** SUMMARY ***
Total pot $0.20 | Rake $0 
Seat 1: jp34e617tIzV8tKIWmfAbA (small blind) folded before Flop
Seat 2: G3h3THGB1j3qdHDVHpnJWg (big blind) collected ($0.20)
Seat 3: EeUZtMU058v2ObUACOF4Og folded before Flop (didn't bet)
Seat 5: xrf8tAXKQHG99HixCot1Iw folded before Flop (didn't bet)
Seat 6: 6DwBRH+xZ12AAZmeAg+aXw (button) folded before Flop (didn't bet)




PokerStars Game #59941679966:  Hold'em No Limit ($0.10/$0.25) - 2009/07/01 1:42:46 ET
Table 'fHv1Mk7ZbLjprZTGWKPiEQ' 6-max Seat #6 is the button
Seat 2: 9U3ZKjCsarN0DjR6mSE8Ug ($14.80 in chips) 
Seat 3: /gJNBeCkWL4o85/jvlZ4BA ($25 in chips) 
Seat 4: TSmua8tGK3sTbwi0ynrW9Q ($58.80 in chips) 
Seat 5: LJI7A1YgDM7hgh7o56+ReQ ($26.65 in chips) 
Seat 6: AjG0X+rNtc2W08eph8oqpw ($35.85 in chips) 
JoeyB1234 was removed from the table for failing to post
9U3ZKjCsarN0DjR6mSE8Ug: posts small blind $0.10
/gJNBeCkWL4o85/jvlZ4BA: posts big blind $0.25
*** HOLE CARDS ***
TSmua8tGK3sTbwi0ynrW9Q: raises $0.50 to $0.75
LJI7A1YgDM7hgh7o56+ReQ: folds 
AjG0X+rNtc2W08eph8oqpw: folds 
9U3ZKjCsarN0DjR6mSE8Ug: folds 
/gJNBeCkWL4o85/jvlZ4BA: folds 
Uncalled bet ($0.50) returned to TSmua8tGK3sTbwi0ynrW9Q
TSmua8tGK3sTbwi0ynrW9Q collected $0.60 from pot
OIjOiBfQstWrK/RuXx7zcw joins the table at seat #1 
*** SUMMARY ***
Total pot $0.60 | Rake $0 
Seat 2: 9U3ZKjCsarN0DjR6mSE8Ug (small blind) folded before Flop
Seat 3: /gJNBeCkWL4o85/jvlZ4BA (big blind) folded before Flop
Seat 4: TSmua8tGK3sTbwi0ynrW9Q collected ($0.60)
Seat 5: LJI7A1YgDM7hgh7o56+ReQ folded before Flop (didn't bet)
Seat 6: AjG0X+rNtc2W08eph8oqpw (button) folded before Flop (didn't bet)




PokerStars Game #59941679752:  Hold'em No Limit ($0.10/$0.25) - 2009/07/01 1:42:46 ET
Table 'Qr+t8WGovMECkBv+cV1lrg' 6-max Seat #4 is the button
Seat 1: EeUZtMU058v2ObUACOF4Og ($51.25 in chips) 
Seat 3: uZKkrGByYgd4/ZBX2d4z+w ($22 in chips) 
Seat 4: 1NNFfYMd5Hsphl/FYz9fNA ($60.55 in chips) 
Seat 5: 9q7YGTKe9k5fYb4fmZc3Ww ($32.45 in chips) 
9q7YGTKe9k5fYb4fmZc3Ww: posts small blind $0.10
EeUZtMU058v2ObUACOF4Og: posts big blind $0.25
vqWjZmdQu/Hxw96/IJTWdQ: sits out 
*** HOLE CARDS ***
uZKkrGByYgd4/ZBX2d4z+w: calls $0.25
1NNFfYMd5Hsphl/FYz9fNA: raises $0.50 to $0.75
9q7YGTKe9k5fYb4fmZc3Ww: folds 
EeUZtMU058v2ObUACOF4Og: folds 
uZKkrGByYgd4/ZBX2d4z+w: calls $0.50
*** FLOP *** [5d 2d 5c]
uZKkrGByYgd4/ZBX2d4z+w: checks 
1NNFfYMd5Hsphl/FYz9fNA: checks 
*** TURN *** [5d 2d 5c] [Td]
9U3ZKjCsarN0DjR6mSE8Ug joins the table at seat #6 
uZKkrGByYgd4/ZBX2d4z+w: checks 
1NNFfYMd5Hsphl/FYz9fNA: checks 
*** RIVER *** [5d 2d 5c Td] [9d]
uZKkrGByYgd4/ZBX2d4z+w: checks 
1NNFfYMd5Hsphl/FYz9fNA: checks 
*** SHOW DOWN ***
uZKkrGByYgd4/ZBX2d4z+w: shows [9s 8s] (two pair, Nines and Fives)
1NNFfYMd5Hsphl/FYz9fNA: shows [9h Jh] (two pair, Nines and Fives - Jack kicker)
1NNFfYMd5Hsphl/FYz9fNA collected $1.80 from pot
*** SUMMARY ***
Total pot $1.85 | Rake $0.05 
Board [5d 2d 5c Td 9d]
Seat 1: EeUZtMU058v2ObUACOF4Og (big blind) folded before Flop
Seat 3: uZKkrGByYgd4/ZBX2d4z+w showed [9s 8s] and lost with two pair, Nines and Fives
Seat 4: 1NNFfYMd5Hsphl/FYz9fNA (button) showed [9h Jh] and won ($1.80) with two pair, Nines and Fives
Seat 5: 9q7YGTKe9k5fYb4fmZc3Ww (small blind) folded before Flop




PokerStars Game #59941679578:  Hold'em No Limit ($0.10/$0.25) - 2009/07/01 1:42:46 ET
Table 'FE/j6VqBY4j9Uq+VHURQCQ' 6-max Seat #3 is the button
Seat 1: ypmjhffk/YHGc51wgVXUTw ($41.45 in chips) 
Seat 2: 3zD3qLXT1bEffAoWGnc7wg ($39.75 in chips) 
Seat 3: lBoEwOFgzcERLIRUkUoRTw ($27.35 in chips) 
Seat 4: 7JyPCA0J2grhXQYxe1h3+A ($22.15 in chips) 
Seat 5: 4x9jCqgSw4272dnaIqnanw ($7.20 in chips) 
Seat 6: rpJ2ie+vculq8yrHlngRHQ ($19.55 in chips) 
7JyPCA0J2grhXQYxe1h3+A: posts small blind $0.10
4x9jCqgSw4272dnaIqnanw: posts big blind $0.25
*** HOLE CARDS ***
rpJ2ie+vculq8yrHlngRHQ: calls $0.25
ypmjhffk/YHGc51wgVXUTw: raises $0.75 to $1
3zD3qLXT1bEffAoWGnc7wg: folds 
lBoEwOFgzcERLIRUkUoRTw: folds 
7JyPCA0J2grhXQYxe1h3+A: folds 
4x9jCqgSw4272dnaIqnanw: folds 
rpJ2ie+vculq8yrHlngRHQ: calls $0.75
*** FLOP *** [3c Qs 5c]
rpJ2ie+vculq8yrHlngRHQ: bets $0.25
ypmjhffk/YHGc51wgVXUTw: raises $2 to $2.25
rpJ2ie+vculq8yrHlngRHQ: folds 
Uncalled bet ($2) returned to ypmjhffk/YHGc51wgVXUTw
ypmjhffk/YHGc51wgVXUTw collected $2.75 from pot
ypmjhffk/YHGc51wgVXUTw: doesn't show hand 
*** SUMMARY ***
Total pot $2.85 | Rake $0.10 
Board [3c Qs 5c]
Seat 1: ypmjhffk/YHGc51wgVXUTw collected ($2.75)
Seat 2: 3zD3qLXT1bEffAoWGnc7wg folded before Flop (didn't bet)
Seat 3: lBoEwOFgzcERLIRUkUoRTw (button) folded before Flop (didn't bet)
Seat 4: 7JyPCA0J2grhXQYxe1h3+A (small blind) folded before Flop
Seat 5: 4x9jCqgSw4272dnaIqnanw (big blind) folded before Flop
Seat 6: rpJ2ie+vculq8yrHlngRHQ folded on the Flop




PokerStars Game #59941679768:  Hold'em No Limit ($0.10/$0.25) - 2009/07/01 1:42:46 ET
Table '5VWnrlxdjwVfMWkVS2WE7A' 6-max Seat #3 is the button
Seat 1: 82p+w3EmUaFFHuwpSeGY1w ($12.50 in chips) 
Seat 2: LJI7A1YgDM7hgh7o56+ReQ ($26 in chips) 
Seat 3: SFmT9ZsVopnukjvAzrxTRg ($35.95 in chips) 
Seat 4: Pb/gJ3OxOZx57fFp0MDgkg ($35.45 in chips) 
Seat 5: SgMFmwYtNvq9Y+2ZxPSiWQ ($21.10 in chips) 
Seat 6: LtASJ9OlkqGrrUKGQlpGAw ($5.60 in chips) 
Pb/gJ3OxOZx57fFp0MDgkg: posts small blind $0.10
SgMFmwYtNvq9Y+2ZxPSiWQ: posts big blind $0.25
*** HOLE CARDS ***
LtASJ9OlkqGrrUKGQlpGAw: folds 
82p+w3EmUaFFHuwpSeGY1w: calls $0.25
LJI7A1YgDM7hgh7o56+ReQ: folds 
SFmT9ZsVopnukjvAzrxTRg: folds 
Pb/gJ3OxOZx57fFp0MDgkg: folds 
SgMFmwYtNvq9Y+2ZxPSiWQ: raises $0.50 to $0.75
82p+w3EmUaFFHuwpSeGY1w: calls $0.50
*** FLOP *** [Qd As 6s]
SgMFmwYtNvq9Y+2ZxPSiWQ: checks 
82p+w3EmUaFFHuwpSeGY1w: bets $0.50
SgMFmwYtNvq9Y+2ZxPSiWQ: calls $0.50
*** TURN *** [Qd As 6s] [7c]
SgMFmwYtNvq9Y+2ZxPSiWQ: checks 
82p+w3EmUaFFHuwpSeGY1w: bets $0.75
SgMFmwYtNvq9Y+2ZxPSiWQ: calls $0.75
*** RIVER *** [Qd As 6s 7c] [Qs]
SgMFmwYtNvq9Y+2ZxPSiWQ: checks 
82p+w3EmUaFFHuwpSeGY1w: checks 
*** SHOW DOWN ***
SgMFmwYtNvq9Y+2ZxPSiWQ: shows [Kh Jh] (a pair of Queens)
82p+w3EmUaFFHuwpSeGY1w: shows [6d Ah] (two pair, Aces and Queens)
82p+w3EmUaFFHuwpSeGY1w collected $3.90 from pot
*** SUMMARY ***
Total pot $4.10 | Rake $0.20 
Board [Qd As 6s 7c Qs]
Seat 1: 82p+w3EmUaFFHuwpSeGY1w showed [6d Ah] and won ($3.90) with two pair, Aces and Queens
Seat 2: LJI7A1YgDM7hgh7o56+ReQ folded before Flop (didn't bet)
Seat 3: SFmT9ZsVopnukjvAzrxTRg (button) folded before Flop (didn't bet)
Seat 4: Pb/gJ3OxOZx57fFp0MDgkg (small blind) folded before Flop
Seat 5: SgMFmwYtNvq9Y+2ZxPSiWQ (big blind) showed [Kh Jh] and lost with a pair of Queens
Seat 6: LtASJ9OlkqGrrUKGQlpGAw folded before Flop (didn't bet)




PokerStars Game #59941679702:  Hold'em No Limit ($0.10/$0.25) - 2009/07/01 1:42:46 ET
Table '60nA7av6bws9VnNmVwculA' 6-max Seat #6 is the button
Seat 1: if4dh6jhJXeN3/qd3qCp9g ($24.75 in chips) 
Seat 2: Bada343Si4xKu3fNXY99AA ($3.85 in chips) 
Seat 3: OUv909q/YxsJgxpSlZxLJQ ($30.50 in chips) 
Seat 4: +baiVgI/ETnBARLe5mARCw ($18.85 in chips) 
Seat 5: zXh+lOT41Q2iWgCNj+OcRw ($12.95 in chips) 
Seat 6: mfrkWA3PTeYPkbO6hi98Aw ($24.15 in chips) 
if4dh6jhJXeN3/qd3qCp9g: posts small blind $0.10
Bada343Si4xKu3fNXY99AA: posts big blind $0.25
*** HOLE CARDS ***
OUv909q/YxsJgxpSlZxLJQ: folds 
OUv909q/YxsJgxpSlZxLJQ leaves the table
+baiVgI/ETnBARLe5mARCw: folds 
zXh+lOT41Q2iWgCNj+OcRw: folds 
mfrkWA3PTeYPkbO6hi98Aw: raises $0.75 to $1
if4dh6jhJXeN3/qd3qCp9g: folds 
Bada343Si4xKu3fNXY99AA: folds 
Uncalled bet ($0.75) returned to mfrkWA3PTeYPkbO6hi98Aw
mfrkWA3PTeYPkbO6hi98Aw collected $0.60 from pot
mfrkWA3PTeYPkbO6hi98Aw: doesn't show hand 
*** SUMMARY ***
Total pot $0.60 | Rake $0 
Seat 1: if4dh6jhJXeN3/qd3qCp9g (small blind) folded before Flop
Seat 2: Bada343Si4xKu3fNXY99AA (big blind) folded before Flop
Seat 3: OUv909q/YxsJgxpSlZxLJQ folded before Flop (didn't bet)
Seat 4: +baiVgI/ETnBARLe5mARCw folded before Flop (didn't bet)
Seat 5: zXh+lOT41Q2iWgCNj+OcRw folded before Flop (didn't bet)
Seat 6: mfrkWA3PTeYPkbO6hi98Aw (button) collected ($0.60)




PokerStars Game #59941680484:  Hold'em No Limit ($0.10/$0.25) - 2009/07/01 1:42:47 ET
Table '+68ihX5Br1xgGorX6zsCBg' 9-max Seat #8 is the button
Seat 1: IFB2mhulUVYIbb+KWwDC9w ($4.45 in chips) 
Seat 2: TeAfhXG1R60d8yPEHN3JiA ($27.05 in chips) 
Seat 3: PdIasPkzm2sqZnN41ZRXOg ($5 in chips) 
Seat 4: Oi0EiPIjriUb/6zT65YeWA ($27.70 in chips) 
Seat 5: ghNKXUBl/H+t83JF079ZBA ($25.45 in chips) 
Seat 6: X78b5v/uhqeXXoAijbw/yg ($26.40 in chips) 
Seat 7: V6p0jQ/RhUsqpHLmXvEX4Q ($14.35 in chips) 
Seat 8: Ut3g/kEEdCCbe/gbWrHnDg ($11.30 in chips) 
Seat 9: DiSvPC2iudwL5j9u6Huyww ($32.85 in chips) 
DiSvPC2iudwL5j9u6Huyww: posts small blind $0.10
IFB2mhulUVYIbb+KWwDC9w: posts big blind $0.25
*** HOLE CARDS ***
TeAfhXG1R60d8yPEHN3JiA: folds 
PdIasPkzm2sqZnN41ZRXOg: folds 
Oi0EiPIjriUb/6zT65YeWA: raises $0.50 to $0.75
ghNKXUBl/H+t83JF079ZBA: raises $2 to $2.75
X78b5v/uhqeXXoAijbw/yg: folds 
V6p0jQ/RhUsqpHLmXvEX4Q: folds 
Ut3g/kEEdCCbe/gbWrHnDg: calls $2.75
DiSvPC2iudwL5j9u6Huyww: folds 
IFB2mhulUVYIbb+KWwDC9w: folds 
Oi0EiPIjriUb/6zT65YeWA: folds 
*** FLOP *** [Kc 9s Th]
ghNKXUBl/H+t83JF079ZBA: bets $4.25
Ut3g/kEEdCCbe/gbWrHnDg: folds 
Uncalled bet ($4.25) returned to ghNKXUBl/H+t83JF079ZBA
ghNKXUBl/H+t83JF079ZBA collected $6.30 from pot
ghNKXUBl/H+t83JF079ZBA: doesn't show hand 
*** SUMMARY ***
Total pot $6.60 | Rake $0.30 
Board [Kc 9s Th]
Seat 1: IFB2mhulUVYIbb+KWwDC9w (big blind) folded before Flop
Seat 2: TeAfhXG1R60d8yPEHN3JiA folded before Flop (didn't bet)
Seat 3: PdIasPkzm2sqZnN41ZRXOg folded before Flop (didn't bet)
Seat 4: Oi0EiPIjriUb/6zT65YeWA folded before Flop
Seat 5: ghNKXUBl/H+t83JF079ZBA collected ($6.30)
Seat 6: X78b5v/uhqeXXoAijbw/yg folded before Flop (didn't bet)
Seat 7: V6p0jQ/RhUsqpHLmXvEX4Q folded before Flop (didn't bet)
Seat 8: Ut3g/kEEdCCbe/gbWrHnDg (button) folded on the Flop
Seat 9: DiSvPC2iudwL5j9u6Huyww (small blind) folded before Flop




PokerStars Game #59941681080:  Hold'em No Limit ($0.10/$0.25) - 2009/07/01 1:42:48 ET
Table 'U0hCzoS0KCJL+eoE054K4Q' 9-max Seat #7 is the button
Seat 1: XVEauYThJRhSTUAMxB/2ow ($38.45 in chips) 
Seat 2: MG90wfSJZnOejs/KD3vlQQ ($25 in chips) 
Seat 3: 8Cp1H3sSs8+jTTwLfeYKcw ($27.20 in chips) 
Seat 4: Bb42QRQMhg5/Y0vHP8/2Xw ($25 in chips) 
Seat 5: zgi+EUykT/pZQpoUG6+oEg ($6 in chips) 
Seat 6: V6p0jQ/RhUsqpHLmXvEX4Q ($11.90 in chips) 
Seat 7: uetHVityNsFnyX2bBnKe2A ($18.35 in chips) 
Seat 8: K0b5wNInj6hUGRr6yzKFtw ($28.55 in chips) 
Seat 9: wGigCmBR/9XWkPpvYos3aQ ($33.10 in chips) 
K0b5wNInj6hUGRr6yzKFtw: posts small blind $0.10
wGigCmBR/9XWkPpvYos3aQ: posts big blind $0.25
*** HOLE CARDS ***
XVEauYThJRhSTUAMxB/2ow: folds 
MG90wfSJZnOejs/KD3vlQQ: folds 
8Cp1H3sSs8+jTTwLfeYKcw: folds 
Bb42QRQMhg5/Y0vHP8/2Xw: folds 
zgi+EUykT/pZQpoUG6+oEg: folds 
V6p0jQ/RhUsqpHLmXvEX4Q: folds 
uetHVityNsFnyX2bBnKe2A: folds 
K0b5wNInj6hUGRr6yzKFtw: folds 
Uncalled bet ($0.15) returned to wGigCmBR/9XWkPpvYos3aQ
wGigCmBR/9XWkPpvYos3aQ collected $0.20 from pot
wGigCmBR/9XWkPpvYos3aQ: doesn't show hand 
*** SUMMARY ***
Total pot $0.20 | Rake $0 
Seat 1: XVEauYThJRhSTUAMxB/2ow folded before Flop (didn't bet)
Seat 2: MG90wfSJZnOejs/KD3vlQQ folded before Flop (didn't bet)
Seat 3: 8Cp1H3sSs8+jTTwLfeYKcw folded before Flop (didn't bet)
Seat 4: Bb42QRQMhg5/Y0vHP8/2Xw folded before Flop (didn't bet)
Seat 5: zgi+EUykT/pZQpoUG6+oEg folded before Flop (didn't bet)
Seat 6: V6p0jQ/RhUsqpHLmXvEX4Q folded before Flop (didn't bet)
Seat 7: uetHVityNsFnyX2bBnKe2A (button) folded before Flop (didn't bet)
Seat 8: K0b5wNInj6hUGRr6yzKFtw (small blind) folded before Flop
Seat 9: wGigCmBR/9XWkPpvYos3aQ (big blind) collected ($0.20)




PokerStars Game #59941680900:  Hold'em No Limit ($0.10/$0.25) - 2009/07/01 1:42:48 ET
Table 'NfXsh0UQA+o/kO9acV3WxA' 9-max Seat #1 is the button
Seat 1: pN3IHvAKm2fz+sTRARTcrg ($24.65 in chips) 
Seat 2: mhpFs2SZupy4zLRb62FLFA ($25.10 in chips) 
Seat 3: wCUaomJ6Nq5zomVGdUHP+w ($19.85 in chips) 
Seat 4: r6hsffOo1iKmaPYKwAZmFw ($30.05 in chips) 
Seat 6: cFmpjvcjNoVAEAIQIxWkYg ($25.35 in chips) 
Seat 7: yqkowiRWZ6NvRN9UUkYIlA ($5 in chips) 
Seat 8: +sbyWwIcFp9kP0bDtMegfQ ($41.75 in chips) 
Seat 9: uhrboV251dcgYniYTdFIcA ($25 in chips) 
mhpFs2SZupy4zLRb62FLFA: posts small blind $0.10
wCUaomJ6Nq5zomVGdUHP+w: posts big blind $0.25
zgi+EUykT/pZQpoUG6+oEg: sits out 
*** HOLE CARDS ***
r6hsffOo1iKmaPYKwAZmFw: folds 
cFmpjvcjNoVAEAIQIxWkYg: raises $0.25 to $0.50
yqkowiRWZ6NvRN9UUkYIlA: folds 
+sbyWwIcFp9kP0bDtMegfQ: folds 
uhrboV251dcgYniYTdFIcA: calls $0.50
pN3IHvAKm2fz+sTRARTcrg: folds 
mhpFs2SZupy4zLRb62FLFA: folds 
wCUaomJ6Nq5zomVGdUHP+w: folds 
*** FLOP *** [Qd 6h Qh]
cFmpjvcjNoVAEAIQIxWkYg: checks 
uhrboV251dcgYniYTdFIcA: checks 
*** TURN *** [Qd 6h Qh] [2d]
cFmpjvcjNoVAEAIQIxWkYg: bets $0.75
uhrboV251dcgYniYTdFIcA: folds 
Uncalled bet ($0.75) returned to cFmpjvcjNoVAEAIQIxWkYg
cFmpjvcjNoVAEAIQIxWkYg collected $1.30 from pot
cFmpjvcjNoVAEAIQIxWkYg: doesn't show hand 
*** SUMMARY ***
Total pot $1.35 | Rake $0.05 
Board [Qd 6h Qh 2d]
Seat 1: pN3IHvAKm2fz+sTRARTcrg (button) folded before Flop (didn't bet)
Seat 2: mhpFs2SZupy4zLRb62FLFA (small blind) folded before Flop
Seat 3: wCUaomJ6Nq5zomVGdUHP+w (big blind) folded before Flop
Seat 4: r6hsffOo1iKmaPYKwAZmFw folded before Flop (didn't bet)
Seat 6: cFmpjvcjNoVAEAIQIxWkYg collected ($1.30)
Seat 7: yqkowiRWZ6NvRN9UUkYIlA folded before Flop (didn't bet)
Seat 8: +sbyWwIcFp9kP0bDtMegfQ folded before Flop (didn't bet)
Seat 9: uhrboV251dcgYniYTdFIcA folded on the Turn




PokerStars Game #59941680698:  Hold'em No Limit ($0.10/$0.25) - 2009/07/01 1:42:48 ET
Table 'MiquQrQZJJq9ZtgRIp9HFQ' 6-max Seat #1 is the button
Seat 1: c3J/KYZ4cNsUEuz8v57I5A ($25 in chips) 
Seat 3: Hsvkc0/G2VV78oVmWYXecw ($15.75 in chips) 
Seat 4: wAKC8C/zN0c8V5v13dm9mA ($57.75 in chips) 
Seat 5: iyZxqznXjv3vtvOJymkoLQ ($27.10 in chips) 
Seat 6: GbCVUNssQ7mqsPWr7J4d3w ($5 in chips) 
Hsvkc0/G2VV78oVmWYXecw: posts small blind $0.10
wAKC8C/zN0c8V5v13dm9mA: posts big blind $0.25
*** HOLE CARDS ***
iyZxqznXjv3vtvOJymkoLQ: folds 
Hsvkc0/G2VV78oVmWYXecw said, "cool"
GbCVUNssQ7mqsPWr7J4d3w: folds 
c3J/KYZ4cNsUEuz8v57I5A: folds 
Hsvkc0/G2VV78oVmWYXecw: folds 
Uncalled bet ($0.15) returned to wAKC8C/zN0c8V5v13dm9mA
2+6voGl1T1DO63JePptI3g joins the table at seat #2 
wAKC8C/zN0c8V5v13dm9mA collected $0.20 from pot
*** SUMMARY ***
Total pot $0.20 | Rake $0 
Seat 1: c3J/KYZ4cNsUEuz8v57I5A (button) folded before Flop (didn't bet)
Seat 3: Hsvkc0/G2VV78oVmWYXecw (small blind) folded before Flop
Seat 4: wAKC8C/zN0c8V5v13dm9mA (big blind) collected ($0.20)
Seat 5: iyZxqznXjv3vtvOJymkoLQ folded before Flop (didn't bet)
Seat 6: GbCVUNssQ7mqsPWr7J4d3w folded before Flop (didn't bet)




PokerStars Game #59941680882:  Hold'em No Limit ($0.10/$0.25) - 2009/07/01 1:42:48 ET
Table 'IuqVbFI+pwnJjvwBCGSGAw' 6-max Seat #3 is the button
Seat 1: LyDHtw3/yniNHW+DvLXbog ($26.25 in chips) 
Seat 2: wsP46AGpqDjHZQmlRHKa9g ($25.45 in chips) 
Seat 3: QiL+lEgEWwy21jk/ltaRLg ($22.25 in chips) 
Seat 4: DE9hRlt14g+JdsRQ4wT7hg ($25 in chips) 
Seat 5: if4dh6jhJXeN3/qd3qCp9g ($25.35 in chips) 
Seat 6: SJ5z7oeRzpbFT7jU55Mbag ($36.40 in chips) 
DE9hRlt14g+JdsRQ4wT7hg: posts small blind $0.10
if4dh6jhJXeN3/qd3qCp9g: posts big blind $0.25
*** HOLE CARDS ***
SJ5z7oeRzpbFT7jU55Mbag: folds 
LyDHtw3/yniNHW+DvLXbog: folds 
SJ5z7oeRzpbFT7jU55Mbag leaves the table
wsP46AGpqDjHZQmlRHKa9g: folds 
QiL+lEgEWwy21jk/ltaRLg: folds 
DE9hRlt14g+JdsRQ4wT7hg: folds 
Uncalled bet ($0.15) returned to if4dh6jhJXeN3/qd3qCp9g
if4dh6jhJXeN3/qd3qCp9g collected $0.20 from pot
if4dh6jhJXeN3/qd3qCp9g: doesn't show hand 
*** SUMMARY ***
Total pot $0.20 | Rake $0 
Seat 1: LyDHtw3/yniNHW+DvLXbog folded before Flop (didn't bet)
Seat 2: wsP46AGpqDjHZQmlRHKa9g folded before Flop (didn't bet)
Seat 3: QiL+lEgEWwy21jk/ltaRLg (button) folded before Flop (didn't bet)
Seat 4: DE9hRlt14g+JdsRQ4wT7hg (small blind) folded before Flop
Seat 5: if4dh6jhJXeN3/qd3qCp9g (big blind) collected ($0.20)
Seat 6: SJ5z7oeRzpbFT7jU55Mbag folded before Flop (didn't bet)




PokerStars Game #59941681464:  Hold'em No Limit ($0.10/$0.25) - 2009/07/01 1:42:49 ET
Table 'M8kYidAX3ib7pLKW7edFLw' 6-max Seat #3 is the button
Seat 1: jp34e617tIzV8tKIWmfAbA ($25.35 in chips) 
Seat 2: ypmjhffk/YHGc51wgVXUTw ($29.05 in chips) 
Seat 3: cezpHJ8FB07dj0xG+LhOvw ($27.10 in chips) 
Seat 4: Hsvkc0/G2VV78oVmWYXecw ($5.10 in chips) 
Seat 5: bDKopKTvPi3W+PEnYUX3tg ($44.85 in chips) 
Seat 6: NqFoyDgzLwu4dOmSRXnFBA ($19.75 in chips) 
Hsvkc0/G2VV78oVmWYXecw: posts small blind $0.10
bDKopKTvPi3W+PEnYUX3tg: posts big blind $0.25
*** HOLE CARDS ***
NqFoyDgzLwu4dOmSRXnFBA: calls $0.25
jp34e617tIzV8tKIWmfAbA: folds 
ypmjhffk/YHGc51wgVXUTw: folds 
cezpHJ8FB07dj0xG+LhOvw: folds 
Hsvkc0/G2VV78oVmWYXecw: raises $0.50 to $0.75
bDKopKTvPi3W+PEnYUX3tg: folds 
NqFoyDgzLwu4dOmSRXnFBA: calls $0.50
*** FLOP *** [Jc 4s Qh]
Hsvkc0/G2VV78oVmWYXecw: bets $1.25
NqFoyDgzLwu4dOmSRXnFBA: folds 
Uncalled bet ($1.25) returned to Hsvkc0/G2VV78oVmWYXecw
Hsvkc0/G2VV78oVmWYXecw collected $1.70 from pot
Hsvkc0/G2VV78oVmWYXecw: doesn't show hand 
*** SUMMARY ***
Total pot $1.75 | Rake $0.05 
Board [Jc 4s Qh]
Seat 1: jp34e617tIzV8tKIWmfAbA folded before Flop (didn't bet)
Seat 2: ypmjhffk/YHGc51wgVXUTw folded before Flop (didn't bet)
Seat 3: cezpHJ8FB07dj0xG+LhOvw (button) folded before Flop (didn't bet)
Seat 4: Hsvkc0/G2VV78oVmWYXecw (small blind) collected ($1.70)
Seat 5: bDKopKTvPi3W+PEnYUX3tg (big blind) folded before Flop
Seat 6: NqFoyDgzLwu4dOmSRXnFBA folded on the Flop




PokerStars Game #59941681282:  Hold'em No Limit ($0.10/$0.25) - 2009/07/01 1:42:49 ET
Table 'Zi9/NqNs3XoL1eWhMCyZyg' 9-max Seat #3 is the button
Seat 3: ETC7YyRJTa2Ovhln64Ni5Q ($27.75 in chips) 
Seat 4: dmYlc+1cjwZMJ7wV+Z0rRg ($22.90 in chips) 
Seat 5: JTINtdu/1/EQCVfalLD/xQ ($9 in chips) 
Seat 7: 0QdZrkFD7aGKeBXPGbIomA ($6.35 in chips) 
Seat 8: nm4Dj/f+jJEwKVsUnKh73g ($35.05 in chips) 
Seat 9: tYsOBqdU1+x+yFI7zHO7hQ ($31.65 in chips) 
dmYlc+1cjwZMJ7wV+Z0rRg: posts small blind $0.10
JTINtdu/1/EQCVfalLD/xQ: posts big blind $0.25
*** HOLE CARDS ***
YQhfmYhgnDDlWCAFmBb36Q joins the table at seat #6 
0QdZrkFD7aGKeBXPGbIomA: raises $0.50 to $0.75
nm4Dj/f+jJEwKVsUnKh73g: folds 
X6+pSIPfovPcE87t+LmUKQ joins the table at seat #1 
tYsOBqdU1+x+yFI7zHO7hQ: folds 
ETC7YyRJTa2Ovhln64Ni5Q: folds 
dmYlc+1cjwZMJ7wV+Z0rRg: folds 
JTINtdu/1/EQCVfalLD/xQ: calls $0.50
*** FLOP *** [9d 7d 8c]
JTINtdu/1/EQCVfalLD/xQ: checks 
0QdZrkFD7aGKeBXPGbIomA: bets $0.75
JTINtdu/1/EQCVfalLD/xQ: calls $0.75
*** TURN *** [9d 7d 8c] [3s]
JTINtdu/1/EQCVfalLD/xQ: checks 
0QdZrkFD7aGKeBXPGbIomA: bets $0.75
JTINtdu/1/EQCVfalLD/xQ: raises $1.75 to $2.50
1wKfgJ8xXIiuc8C6qjkxhg joins the table at seat #2 
0QdZrkFD7aGKeBXPGbIomA has timed out
0QdZrkFD7aGKeBXPGbIomA: folds 
Uncalled bet ($1.75) returned to JTINtdu/1/EQCVfalLD/xQ
0QdZrkFD7aGKeBXPGbIomA is sitting out
0QdZrkFD7aGKeBXPGbIomA has returned
JTINtdu/1/EQCVfalLD/xQ collected $4.40 from pot
*** SUMMARY ***
Total pot $4.60 | Rake $0.20 
Board [9d 7d 8c 3s]
Seat 3: ETC7YyRJTa2Ovhln64Ni5Q (button) folded before Flop (didn't bet)
Seat 4: dmYlc+1cjwZMJ7wV+Z0rRg (small blind) folded before Flop
Seat 5: JTINtdu/1/EQCVfalLD/xQ (big blind) collected ($4.40)
Seat 7: 0QdZrkFD7aGKeBXPGbIomA folded on the Turn
Seat 8: nm4Dj/f+jJEwKVsUnKh73g folded before Flop (didn't bet)
Seat 9: tYsOBqdU1+x+yFI7zHO7hQ folded before Flop (didn't bet)




PokerStars Game #59941681142:  Hold'em No Limit ($0.10/$0.25) - 2009/07/01 1:42:49 ET
Table '52Meibn9NOL4XtVi1p2UpwpyZQRcpxhWj2y2cT/ydvwwx Seat #2 is the button
Seat 1: egvg3mTBBVzMHnJPIQiKcA ($16.30 in chips) 
Seat 2: Th3FldXKQW6hWVVPahaoOQ ($98.10 in chips) 
Seat 3: zgi+EUykT/pZQpoUG6+oEg ($4.40 in chips) 
Seat 4: NjesyqE7PJi4nEOa0oOq9w ($16.10 in chips) 
Seat 5: 5n7e7I+px7c6CQmLpPbtsg ($4.70 in chips) 
Seat 6: 4awUyiDYTgylQKXZ9faBVA ($31.45 in chips) 
Seat 7: sGFnnRCa1YAHAUmWgsW6Qg ($9.50 in chips) 
Seat 8: ipgcO7Pa6LC8XWpVttZfnA ($5 in chips) 
Seat 9: bC+Wg1ntzw3N48OwuR1eag ($8.05 in chips) 
zgi+EUykT/pZQpoUG6+oEg: posts small blind $0.10
NjesyqE7PJi4nEOa0oOq9w: posts big blind $0.25
*** HOLE CARDS ***
5n7e7I+px7c6CQmLpPbtsg: folds 
4awUyiDYTgylQKXZ9faBVA: folds 
4awUyiDYTgylQKXZ9faBVA leaves the table
sGFnnRCa1YAHAUmWgsW6Qg: folds 
ipgcO7Pa6LC8XWpVttZfnA: folds 
bC+Wg1ntzw3N48OwuR1eag: calls $0.25
egvg3mTBBVzMHnJPIQiKcA: folds 
Th3FldXKQW6hWVVPahaoOQ: folds 
zgi+EUykT/pZQpoUG6+oEg: folds 
Ernst5200 joins the table at seat #6 
NjesyqE7PJi4nEOa0oOq9w: checks 
*** FLOP *** [Tc 5h 2c]
NjesyqE7PJi4nEOa0oOq9w: checks 
bC+Wg1ntzw3N48OwuR1eag is disconnected 
bC+Wg1ntzw3N48OwuR1eag has timed out while disconnected
bC+Wg1ntzw3N48OwuR1eag: checks 
*** TURN *** [Tc 5h 2c] [3d]
NjesyqE7PJi4nEOa0oOq9w: checks 
bC+Wg1ntzw3N48OwuR1eag is connected 
bC+Wg1ntzw3N48OwuR1eag: checks 
*** RIVER *** [Tc 5h 2c 3d] [6c]
NjesyqE7PJi4nEOa0oOq9w: checks 
bC+Wg1ntzw3N48OwuR1eag is disconnected 
bC+Wg1ntzw3N48OwuR1eag is connected 
bC+Wg1ntzw3N48OwuR1eag: bets $0.50
NjesyqE7PJi4nEOa0oOq9w: folds 
Uncalled bet ($0.50) returned to bC+Wg1ntzw3N48OwuR1eag
bC+Wg1ntzw3N48OwuR1eag collected $0.60 from pot
bC+Wg1ntzw3N48OwuR1eag: doesn't show hand 
*** SUMMARY ***
Total pot $0.60 | Rake $0 
Board [Tc 5h 2c 3d 6c]
Seat 1: egvg3mTBBVzMHnJPIQiKcA folded before Flop (didn't bet)
Seat 2: Th3FldXKQW6hWVVPahaoOQ (button) folded before Flop (didn't bet)
Seat 3: zgi+EUykT/pZQpoUG6+oEg (small blind) folded before Flop
Seat 4: NjesyqE7PJi4nEOa0oOq9w (big blind) folded on the River
Seat 5: 5n7e7I+px7c6CQmLpPbtsg folded before Flop (didn't bet)
Seat 6: 4awUyiDYTgylQKXZ9faBVA folded before Flop (didn't bet)
Seat 7: sGFnnRCa1YAHAUmWgsW6Qg folded before Flop (didn't bet)
Seat 8: ipgcO7Pa6LC8XWpVttZfnA folded before Flop (didn't bet)
Seat 9: bC+Wg1ntzw3N48OwuR1eag collected ($0.60)




PokerStars Game #59941681872:  Hold'em No Limit ($0.10/$0.25) - 2009/07/01 1:42:50 ET
Table 'K/f0NNaoGuhSz5DrzgVw7Q' 9-max Seat #3 is the button
Seat 1: sD+TKtt36XiiN6jqHiLwDA ($25.05 in chips) 
Seat 2: N7idMbhmEVNGZavVF2tgKg ($26.65 in chips) 
Seat 3: z5GxcHlYz/GSz6W2uFiTtg ($24.25 in chips) 
Seat 4: 9bCz0uv2nUmznwuI0OjVGw ($17.35 in chips) 
Seat 5: DnDcAdn9P0zGovMERigpFA ($37.80 in chips) 
Seat 6: 3PVK0IdMlq2fElkVzzr4bg ($2.95 in chips) 
Seat 8: RCqMONFrSPSArZh2Jsar/w ($19.65 in chips) 
Seat 9: tLcDklc2rBORNfixyRfVfw ($25 in chips) 
9bCz0uv2nUmznwuI0OjVGw: posts small blind $0.10
DnDcAdn9P0zGovMERigpFA: posts big blind $0.25
*** HOLE CARDS ***
3PVK0IdMlq2fElkVzzr4bg: calls $0.25
RCqMONFrSPSArZh2Jsar/w: folds 
tLcDklc2rBORNfixyRfVfw: folds 
sD+TKtt36XiiN6jqHiLwDA: folds 
N7idMbhmEVNGZavVF2tgKg: folds 
z5GxcHlYz/GSz6W2uFiTtg: folds 
z5GxcHlYz/GSz6W2uFiTtg is sitting out
9bCz0uv2nUmznwuI0OjVGw: calls $0.15
DnDcAdn9P0zGovMERigpFA: raises $0.25 to $0.50
3PVK0IdMlq2fElkVzzr4bg: calls $0.25
9bCz0uv2nUmznwuI0OjVGw: calls $0.25
*** FLOP *** [7s 6h Js]
9bCz0uv2nUmznwuI0OjVGw: checks 
egvg3mTBBVzMHnJPIQiKcA has returned
DnDcAdn9P0zGovMERigpFA: checks 
3PVK0IdMlq2fElkVzzr4bg: bets $0.50
9bCz0uv2nUmznwuI0OjVGw: folds 
DnDcAdn9P0zGovMERigpFA: calls $0.50
*** TURN *** [7s 6h Js] [9s]
DnDcAdn9P0zGovMERigpFA: bets $12
3PVK0IdMlq2fElkVzzr4bg: calls $1.95 and is all-in
Uncalled bet ($10.05) returned to DnDcAdn9P0zGovMERigpFA
*** RIVER *** [7s 6h Js 9s] [9c]
*** SHOW DOWN ***
DnDcAdn9P0zGovMERigpFA: shows [5c 8d] (a straight, Five to Nine)
3PVK0IdMlq2fElkVzzr4bg: mucks hand 
DnDcAdn9P0zGovMERigpFA collected $6.10 from pot
*** SUMMARY ***
Total pot $6.40 | Rake $0.30 
Board [7s 6h Js 9s 9c]
Seat 1: sD+TKtt36XiiN6jqHiLwDA folded before Flop (didn't bet)
Seat 2: N7idMbhmEVNGZavVF2tgKg folded before Flop (didn't bet)
Seat 3: z5GxcHlYz/GSz6W2uFiTtg (button) folded before Flop (didn't bet)
Seat 4: 9bCz0uv2nUmznwuI0OjVGw (small blind) folded on the Flop
Seat 5: DnDcAdn9P0zGovMERigpFA (big blind) showed [5c 8d] and won ($6.10) with a straight, Five to Nine
Seat 6: 3PVK0IdMlq2fElkVzzr4bg mucked
Seat 8: RCqMONFrSPSArZh2Jsar/w folded before Flop (didn't bet)
Seat 9: tLcDklc2rBORNfixyRfVfw folded before Flop (didn't bet)




PokerStars Game #59941681902:  Hold'em No Limit ($0.10/$0.25) - 2009/07/01 1:42:50 ET
Table 'L5GvbdQO5aCZJSE6pyQ8OA' 6-max Seat #1 is the button
Seat 1: eFj4lr1nuXLyCWNTShr1bg ($10.75 in chips) 
Seat 2: DihMHaz4WNETH1bPDe13kA ($28.80 in chips) 
Seat 3: JFIAqU8lCZ0vWwEl4bdGsg ($28.30 in chips) 
Seat 5: LyDHtw3/yniNHW+DvLXbog ($26.65 in chips) 
Seat 6: v+QfkGiuj9bgtuNoVnDO8w ($39.40 in chips) 
DihMHaz4WNETH1bPDe13kA: posts small blind $0.10
JFIAqU8lCZ0vWwEl4bdGsg: posts big blind $0.25
trN/oHqTTbPw5MNuKrOpLw: sits out 
*** HOLE CARDS ***
LyDHtw3/yniNHW+DvLXbog: raises $0.75 to $1
v+QfkGiuj9bgtuNoVnDO8w: folds 
eFj4lr1nuXLyCWNTShr1bg: folds 
DihMHaz4WNETH1bPDe13kA: folds 
JFIAqU8lCZ0vWwEl4bdGsg: folds 
Uncalled bet ($0.75) returned to LyDHtw3/yniNHW+DvLXbog
LyDHtw3/yniNHW+DvLXbog collected $0.60 from pot
LyDHtw3/yniNHW+DvLXbog: doesn't show hand 
*** SUMMARY ***
Total pot $0.60 | Rake $0 
Seat 1: eFj4lr1nuXLyCWNTShr1bg (button) folded before Flop (didn't bet)
Seat 2: DihMHaz4WNETH1bPDe13kA (small blind) folded before Flop
Seat 3: JFIAqU8lCZ0vWwEl4bdGsg (big blind) folded before Flop
Seat 5: LyDHtw3/yniNHW+DvLXbog collected ($0.60)
Seat 6: v+QfkGiuj9bgtuNoVnDO8w folded before Flop (didn't bet)




PokerStars Game #59941681814:  Hold'em No Limit ($0.10/$0.25) - 2009/07/01 1:42:50 ET
Table 'VQNfcI8vTBCTvRfd3veTLQ' 6-max Seat #3 is the button
Seat 2: 79ID/ub1Pt/mDpCprVmOoA ($31.90 in chips) 
Seat 3: LtASJ9OlkqGrrUKGQlpGAw ($11.75 in chips) 
Seat 4: QIWnfLSqfMcoFfdDe5LZPg ($40.80 in chips) 
Seat 5: gX2vbKwS/8zZPENAWB7hxQ ($21.10 in chips) 
Seat 6: LJI7A1YgDM7hgh7o56+ReQ ($27.35 in chips) 
QIWnfLSqfMcoFfdDe5LZPg: posts small blind $0.10
gX2vbKwS/8zZPENAWB7hxQ: posts big blind $0.25
QiL+lEgEWwy21jk/ltaRLg: sits out 
*** HOLE CARDS ***
LJI7A1YgDM7hgh7o56+ReQ: folds 
79ID/ub1Pt/mDpCprVmOoA: folds 
LtASJ9OlkqGrrUKGQlpGAw: folds 
QIWnfLSqfMcoFfdDe5LZPg: calls $0.15
gX2vbKwS/8zZPENAWB7hxQ: checks 
*** FLOP *** [8s 6c 9h]
QIWnfLSqfMcoFfdDe5LZPg: checks 
gX2vbKwS/8zZPENAWB7hxQ: checks 
*** TURN *** [8s 6c 9h] [6h]
QIWnfLSqfMcoFfdDe5LZPg: checks 
gX2vbKwS/8zZPENAWB7hxQ: checks 
*** RIVER *** [8s 6c 9h 6h] [Ks]
QIWnfLSqfMcoFfdDe5LZPg: checks 
gX2vbKwS/8zZPENAWB7hxQ: checks 
*** SHOW DOWN ***
QIWnfLSqfMcoFfdDe5LZPg: shows [Qh 5h] (a pair of Sixes)
gX2vbKwS/8zZPENAWB7hxQ: shows [Qc Js] (a pair of Sixes - King+Queen+Jack kicker)
gX2vbKwS/8zZPENAWB7hxQ collected $0.50 from pot
*** SUMMARY ***
Total pot $0.50 | Rake $0 
Board [8s 6c 9h 6h Ks]
Seat 2: 79ID/ub1Pt/mDpCprVmOoA folded before Flop (didn't bet)
Seat 3: LtASJ9OlkqGrrUKGQlpGAw (button) folded before Flop (didn't bet)
Seat 4: QIWnfLSqfMcoFfdDe5LZPg (small blind) showed [Qh 5h] and lost with a pair of Sixes
Seat 5: gX2vbKwS/8zZPENAWB7hxQ (big blind) showed [Qc Js] and won ($0.50) with a pair of Sixes
Seat 6: LJI7A1YgDM7hgh7o56+ReQ folded before Flop (didn't bet)




PokerStars Game #59941681648:  Hold'em No Limit ($0.10/$0.25) - 2009/07/01 1:42:50 ET
Table 'C47I7CmrmFr8Oo7wOovVwQ' 6-max Seat #4 is the button
Seat 1: v6mkGzCBCCXcgWQNSYVtKg ($6.75 in chips) 
Seat 2: hOaWAImn5/MZDAWAPlYHCw ($5.15 in chips) 
Seat 3: H+8eOP3XJHXjACRDTiIHTQ ($15.65 in chips) 
Seat 4: yY5JuFtDfXWRaZlVby4LLw ($10.15 in chips) 
Seat 5: or309yYY9Y9bfFWtrB0yUg ($12.50 in chips) 
Seat 6: pD7ri5wL3vsa6S1ulMYQmQ ($25 in chips) 
or309yYY9Y9bfFWtrB0yUg: posts small blind $0.10
pD7ri5wL3vsa6S1ulMYQmQ: posts big blind $0.25
*** HOLE CARDS ***
v6mkGzCBCCXcgWQNSYVtKg: folds 
hOaWAImn5/MZDAWAPlYHCw: folds 
H+8eOP3XJHXjACRDTiIHTQ: calls $0.25
yY5JuFtDfXWRaZlVby4LLw: calls $0.25
or309yYY9Y9bfFWtrB0yUg: folds 
pD7ri5wL3vsa6S1ulMYQmQ: checks 
*** FLOP *** [9d Js Qc]
pD7ri5wL3vsa6S1ulMYQmQ: checks 
H+8eOP3XJHXjACRDTiIHTQ: bets $0.25
yY5JuFtDfXWRaZlVby4LLw: calls $0.25
pD7ri5wL3vsa6S1ulMYQmQ: folds 
*** TURN *** [9d Js Qc] [Ts]
H+8eOP3XJHXjACRDTiIHTQ: checks 
yY5JuFtDfXWRaZlVby4LLw: bets $0.75
H+8eOP3XJHXjACRDTiIHTQ: calls $0.75
*** RIVER *** [9d Js Qc Ts] [5c]
H+8eOP3XJHXjACRDTiIHTQ: checks 
yY5JuFtDfXWRaZlVby4LLw: checks 
*** SHOW DOWN ***
H+8eOP3XJHXjACRDTiIHTQ: shows [Jc Td] (two pair, Jacks and Tens)
yY5JuFtDfXWRaZlVby4LLw: mucks hand 
H+8eOP3XJHXjACRDTiIHTQ collected $2.75 from pot
*** SUMMARY ***
Total pot $2.85 | Rake $0.10 
Board [9d Js Qc Ts 5c]
Seat 1: v6mkGzCBCCXcgWQNSYVtKg folded before Flop (didn't bet)
Seat 2: hOaWAImn5/MZDAWAPlYHCw folded before Flop (didn't bet)
Seat 3: H+8eOP3XJHXjACRDTiIHTQ showed [Jc Td] and won ($2.75) with two pair, Jacks and Tens
Seat 4: yY5JuFtDfXWRaZlVby4LLw (button) mucked
Seat 5: or309yYY9Y9bfFWtrB0yUg (small blind) folded before Flop
Seat 6: pD7ri5wL3vsa6S1ulMYQmQ (big blind) folded on the Flop




PokerStars Game #59941681744:  Hold'em No Limit ($0.10/$0.25) - 2009/07/01 1:42:50 ET
Table 'APEHQjIcZHDZUA4iOjju2g' 6-max Seat #6 is the button
Seat 1: DE9hRlt14g+JdsRQ4wT7hg ($25.10 in chips) 
Seat 2: 3zD3qLXT1bEffAoWGnc7wg ($36.60 in chips) 
Seat 3: 3e/idKqDuPE10t6Zvr//SQ ($24.65 in chips) 
Seat 4: w2mQ4VsGljGwWXydz8tw2A ($37.75 in chips) 
Seat 5: /xN6gc9+8Hew0HxaB6VIVg ($43.55 in chips) 
Seat 6: KXtdqb+rIMkjc0RvHDksGQ ($25.95 in chips) 
DE9hRlt14g+JdsRQ4wT7hg: posts small blind $0.10
3zD3qLXT1bEffAoWGnc7wg: posts big blind $0.25
*** HOLE CARDS ***
3e/idKqDuPE10t6Zvr//SQ: folds 
w2mQ4VsGljGwWXydz8tw2A: folds 
/xN6gc9+8Hew0HxaB6VIVg: calls $0.25
KXtdqb+rIMkjc0RvHDksGQ: folds 
DE9hRlt14g+JdsRQ4wT7hg: folds 
3zD3qLXT1bEffAoWGnc7wg: checks 
*** FLOP *** [3d 5h 6d]
3zD3qLXT1bEffAoWGnc7wg: checks 
/xN6gc9+8Hew0HxaB6VIVg: bets $0.25
3zD3qLXT1bEffAoWGnc7wg: folds 
Uncalled bet ($0.25) returned to /xN6gc9+8Hew0HxaB6VIVg
/xN6gc9+8Hew0HxaB6VIVg collected $0.60 from pot
/xN6gc9+8Hew0HxaB6VIVg: doesn't show hand 
*** SUMMARY ***
Total pot $0.60 | Rake $0 
Board [3d 5h 6d]
Seat 1: DE9hRlt14g+JdsRQ4wT7hg (small blind) folded before Flop
Seat 2: 3zD3qLXT1bEffAoWGnc7wg (big blind) folded on the Flop
Seat 3: 3e/idKqDuPE10t6Zvr//SQ folded before Flop (didn't bet)
Seat 4: w2mQ4VsGljGwWXydz8tw2A folded before Flop (didn't bet)
Seat 5: /xN6gc9+8Hew0HxaB6VIVg collected ($0.60)
Seat 6: KXtdqb+rIMkjc0RvHDksGQ (button) folded before Flop (didn't bet)




PokerStars Game #59941681988:  Hold'em No Limit ($0.10/$0.25) - 2009/07/01 1:42:50 ET
Table '52Meibn9NOL4XtVi1p2Upw' 9-max Seat #9 is the button
Seat 1: W6tExOcYX7qiy6Qdp+ZwFA ($4.75 in chips) 
Seat 3: Bb42QRQMhg5/Y0vHP8/2Xw ($26.60 in chips) 
Seat 4: oLa/tXLfSLLB28mcLGrxcg ($31.65 in chips) 
Seat 5: MXCztnYJ58KLHMztZvKrxA ($4.75 in chips) 
Seat 8: PFv56Q1PTkDC084eXIAYmw ($23.75 in chips) 
Seat 9: RCqMONFrSPSArZh2Jsar/w ($19.65 in chips) 
W6tExOcYX7qiy6Qdp+ZwFA: posts small blind $0.10
Bb42QRQMhg5/Y0vHP8/2Xw: posts big blind $0.25
Qduu7ikeizo6q6Ei9YvcJA: sits out 
*** HOLE CARDS ***
oLa/tXLfSLLB28mcLGrxcg: folds 
MXCztnYJ58KLHMztZvKrxA: folds 
PFv56Q1PTkDC084eXIAYmw: folds 
WPT_Champ111 joins the table at seat #6 
RCqMONFrSPSArZh2Jsar/w: folds 
W6tExOcYX7qiy6Qdp+ZwFA: raises $0.50 to $0.75
Bb42QRQMhg5/Y0vHP8/2Xw: calls $0.50
*** FLOP *** [4h Qd Qh]
W6tExOcYX7qiy6Qdp+ZwFA: bets $1.50
Bb42QRQMhg5/Y0vHP8/2Xw: calls $1.50
*** TURN *** [4h Qd Qh] [Ks]
W6tExOcYX7qiy6Qdp+ZwFA: checks 
Bb42QRQMhg5/Y0vHP8/2Xw: checks 
*** RIVER *** [4h Qd Qh Ks] [8d]
W6tExOcYX7qiy6Qdp+ZwFA: bets $2.50 and is all-in
Bb42QRQMhg5/Y0vHP8/2Xw: folds 
Uncalled bet ($2.50) returned to W6tExOcYX7qiy6Qdp+ZwFA
W6tExOcYX7qiy6Qdp+ZwFA collected $4.30 from pot
W6tExOcYX7qiy6Qdp+ZwFA: doesn't show hand 
*** SUMMARY ***
Total pot $4.50 | Rake $0.20 
Board [4h Qd Qh Ks 8d]
Seat 1: W6tExOcYX7qiy6Qdp+ZwFA (small blind) collected ($4.30)
Seat 3: Bb42QRQMhg5/Y0vHP8/2Xw (big blind) folded on the River
Seat 4: oLa/tXLfSLLB28mcLGrxcg folded before Flop (didn't bet)
Seat 5: MXCztnYJ58KLHMztZvKrxA folded before Flop (didn't bet)
Seat 8: PFv56Q1PTkDC084eXIAYmw folded before Flop (didn't bet)
Seat 9: RCqMONFrSPSArZh2Jsar/w (button) folded before Flop (didn't bet)




PokerStars Game #59941682110:  Hold'em No Limit ($0.10/$0.25) - 2009/07/01 1:42:50 ET
Table 'TJS4XvvOjO3k7mH74HJw5g' 9-max Seat #4 is the button
Seat 1: K8I2mpRME07ZlOsT2x75Lg ($5.95 in chips) 
Seat 4: f/e5w8nN3RjdX9H1eRlDdA ($0.80 in chips) 
Seat 5: UlMB386Cfzy3EwurQoBjcA ($9.95 in chips) 
Seat 6: SRik8xyC/rVIBoX7VaOoMA ($14.40 in chips) 
Seat 7: B9u+i1s5aZZkmLTLUopTBg ($14.50 in chips) 
Seat 8: Qv4VzEkN09uD11sjKv02Ig ($18.70 in chips) 
Seat 9: +sbyWwIcFp9kP0bDtMegfQ ($42.65 in chips) 
UlMB386Cfzy3EwurQoBjcA: posts small blind $0.10
SRik8xyC/rVIBoX7VaOoMA: posts big blind $0.25
yqkowiRWZ6NvRN9UUkYIlA: sits out 
8EbrQ/EvFWt2cr0GaU82gQ: sits out 
*** HOLE CARDS ***
B9u+i1s5aZZkmLTLUopTBg: folds 
Qv4VzEkN09uD11sjKv02Ig: raises $0.50 to $0.75
+sbyWwIcFp9kP0bDtMegfQ: folds 
K8I2mpRME07ZlOsT2x75Lg: folds 
f/e5w8nN3RjdX9H1eRlDdA: folds 
UlMB386Cfzy3EwurQoBjcA: raises $1.25 to $2
SRik8xyC/rVIBoX7VaOoMA: folds 
Qv4VzEkN09uD11sjKv02Ig: folds 
Uncalled bet ($1.25) returned to UlMB386Cfzy3EwurQoBjcA
UlMB386Cfzy3EwurQoBjcA collected $1.75 from pot
*** SUMMARY ***
Total pot $1.75 | Rake $0 
Seat 1: K8I2mpRME07ZlOsT2x75Lg folded before Flop (didn't bet)
Seat 4: f/e5w8nN3RjdX9H1eRlDdA (button) folded before Flop (didn't bet)
Seat 5: UlMB386Cfzy3EwurQoBjcA (small blind) collected ($1.75)
Seat 6: SRik8xyC/rVIBoX7VaOoMA (big blind) folded before Flop
Seat 7: B9u+i1s5aZZkmLTLUopTBg folded before Flop (didn't bet)
Seat 8: Qv4VzEkN09uD11sjKv02Ig folded before Flop
Seat 9: +sbyWwIcFp9kP0bDtMegfQ folded before Flop (didn't bet)




PokerStars Game #59941682338:  Hold'em No Limit ($0.10/$0.25) - 2009/07/01 1:42:51 ET
Table 'tErGGDyESv/0llKumVeZuQ' 9-max Seat #8 is the button
Seat 1: 3PmVnC/15cl4oyI1TKIt4g ($5 in chips) 
Seat 2: pN3IHvAKm2fz+sTRARTcrg ($24.65 in chips) 
Seat 3: cFmpjvcjNoVAEAIQIxWkYg ($25 in chips) 
Seat 5: 6RQUxA3jk+ePxB/+Hc0IKw ($13.85 in chips) 
Seat 7: uhrboV251dcgYniYTdFIcA ($28.55 in chips) 
Seat 8: UD63hhjq5lMoGqYLFTcH1A ($1.40 in chips) 
Seat 9: d6n762oPkegG086ZJyV5MA ($17 in chips) 
d6n762oPkegG086ZJyV5MA: posts small blind $0.10
3PmVnC/15cl4oyI1TKIt4g: posts big blind $0.25
yqkowiRWZ6NvRN9UUkYIlA: sits out 
*** HOLE CARDS ***
pN3IHvAKm2fz+sTRARTcrg: folds 
cFmpjvcjNoVAEAIQIxWkYg: folds 
6RQUxA3jk+ePxB/+Hc0IKw: folds 
uhrboV251dcgYniYTdFIcA: folds 
UD63hhjq5lMoGqYLFTcH1A: calls $0.25
d6n762oPkegG086ZJyV5MA: folds 
3PmVnC/15cl4oyI1TKIt4g: checks 
*** FLOP *** [Th 7h As]
3PmVnC/15cl4oyI1TKIt4g: checks 
UD63hhjq5lMoGqYLFTcH1A: checks 
*** TURN *** [Th 7h As] [2c]
3PmVnC/15cl4oyI1TKIt4g: bets $0.25
UD63hhjq5lMoGqYLFTcH1A: calls $0.25
*** RIVER *** [Th 7h As 2c] [Qd]
3PmVnC/15cl4oyI1TKIt4g: checks 
UD63hhjq5lMoGqYLFTcH1A: checks 
*** SHOW DOWN ***
3PmVnC/15cl4oyI1TKIt4g: shows [3h 4h] (high card Ace)
UD63hhjq5lMoGqYLFTcH1A: shows [Ks 2d] (a pair of Deuces)
UD63hhjq5lMoGqYLFTcH1A collected $1.05 from pot
*** SUMMARY ***
Total pot $1.10 | Rake $0.05 
Board [Th 7h As 2c Qd]
Seat 1: 3PmVnC/15cl4oyI1TKIt4g (big blind) showed [3h 4h] and lost with high card Ace
Seat 2: pN3IHvAKm2fz+sTRARTcrg folded before Flop (didn't bet)
Seat 3: cFmpjvcjNoVAEAIQIxWkYg folded before Flop (didn't bet)
Seat 5: 6RQUxA3jk+ePxB/+Hc0IKw folded before Flop (didn't bet)
Seat 7: uhrboV251dcgYniYTdFIcA folded before Flop (didn't bet)
Seat 8: UD63hhjq5lMoGqYLFTcH1A (button) showed [Ks 2d] and won ($1.05) with a pair of Deuces
Seat 9: d6n762oPkegG086ZJyV5MA (small blind) folded before Flop




PokerStars Game #59941682648:  Hold'em No Limit ($0.10/$0.25) - 2009/07/01 1:42:51 ET
Table 'O6cwjhrMn9pfzx1Ngn5zkQ' 6-max Seat #1 is the button
Seat 1: LJI7A1YgDM7hgh7o56+ReQ ($30.55 in chips) 
Seat 2: tSR4329m40dZsN7YOpI9Kw ($29.45 in chips) 
Seat 3: EE16Ua5b1HSsYej5zeXOlA ($25.80 in chips) 
Seat 4: mfrkWA3PTeYPkbO6hi98Aw ($24.30 in chips) 
Seat 5: niLn0xUVlqh8If80xRjzCA ($26 in chips) 
Seat 6: 4TM16KVgEiQpLi4bVVWbVQ ($31.65 in chips) 
tSR4329m40dZsN7YOpI9Kw: posts small blind $0.10
EE16Ua5b1HSsYej5zeXOlA: posts big blind $0.25
*** HOLE CARDS ***
mfrkWA3PTeYPkbO6hi98Aw: folds 
niLn0xUVlqh8If80xRjzCA: raises $0.25 to $0.50
4TM16KVgEiQpLi4bVVWbVQ: folds 
LJI7A1YgDM7hgh7o56+ReQ: folds 
tSR4329m40dZsN7YOpI9Kw: folds 
EE16Ua5b1HSsYej5zeXOlA: folds 
Uncalled bet ($0.25) returned to niLn0xUVlqh8If80xRjzCA
niLn0xUVlqh8If80xRjzCA collected $0.60 from pot
niLn0xUVlqh8If80xRjzCA: doesn't show hand 
*** SUMMARY ***
Total pot $0.60 | Rake $0 
Seat 1: LJI7A1YgDM7hgh7o56+ReQ (button) folded before Flop (didn't bet)
Seat 2: tSR4329m40dZsN7YOpI9Kw (small blind) folded before Flop
Seat 3: EE16Ua5b1HSsYej5zeXOlA (big blind) folded before Flop
Seat 4: mfrkWA3PTeYPkbO6hi98Aw folded before Flop (didn't bet)
Seat 5: niLn0xUVlqh8If80xRjzCA collected ($0.60)
Seat 6: 4TM16KVgEiQpLi4bVVWbVQ folded before Flop (didn't bet)




PokerStars Game #59941682662:  Hold'em No Limit ($0.10/$0.25) - 2009/07/01 1:42:51 ET
Table '3Ns9nuTkynfwbBfBXzg6ww' 6-max Seat #1 is the button
Seat 1: epAUIB7h2FJXzUPRIvSkRA ($25 in chips) 
Seat 2: zxeVQGaMKDsDzmSY+AInjA ($33.45 in chips) 
Seat 3: eL3+wCBjFGfQ5FMdIZihwA ($24.65 in chips) 
Seat 4: qGHGf/553gQnDoklMRe3tg ($30.95 in chips) 
Seat 5: wqphQtauX5Qn7WRJZS1flA ($25.65 in chips) 
Seat 6: DE9hRlt14g+JdsRQ4wT7hg ($36.05 in chips) 
zxeVQGaMKDsDzmSY+AInjA: posts small blind $0.10
eL3+wCBjFGfQ5FMdIZihwA: posts big blind $0.25
*** HOLE CARDS ***
qGHGf/553gQnDoklMRe3tg: folds 
wqphQtauX5Qn7WRJZS1flA: folds 
DE9hRlt14g+JdsRQ4wT7hg: folds 
epAUIB7h2FJXzUPRIvSkRA: raises $0.75 to $1
zxeVQGaMKDsDzmSY+AInjA: folds 
eL3+wCBjFGfQ5FMdIZihwA: folds 
Uncalled bet ($0.75) returned to epAUIB7h2FJXzUPRIvSkRA
epAUIB7h2FJXzUPRIvSkRA collected $0.60 from pot
epAUIB7h2FJXzUPRIvSkRA: doesn't show hand 
*** SUMMARY ***
Total pot $0.60 | Rake $0 
Seat 1: epAUIB7h2FJXzUPRIvSkRA (button) collected ($0.60)
Seat 2: zxeVQGaMKDsDzmSY+AInjA (small blind) folded before Flop
Seat 3: eL3+wCBjFGfQ5FMdIZihwA (big blind) folded before Flop
Seat 4: qGHGf/553gQnDoklMRe3tg folded before Flop (didn't bet)
Seat 5: wqphQtauX5Qn7WRJZS1flA folded before Flop (didn't bet)
Seat 6: DE9hRlt14g+JdsRQ4wT7hg folded before Flop (didn't bet)




PokerStars Game #59941683018:  Hold'em No Limit ($0.10/$0.25) - 2009/07/01 1:42:52 ET
Table 'djcjiEGabFQO0MNG6jEeJQ' 9-max Seat #8 is the button
Seat 1: Bb42QRQMhg5/Y0vHP8/2Xw ($25 in chips) 
Seat 2: WKL8nUFr7TumC4EjLyqYzw ($5.25 in chips) 
Seat 3: zgi+EUykT/pZQpoUG6+oEg ($5 in chips) 
Seat 4: 2wcFsZsqEP5w1StUTVzJCg ($9.55 in chips) 
Seat 5: cZ99hugmLBj9KhTlc8nCSw ($42 in chips) 
Seat 6: aNpwfA31EREwO+ar4XzBCw ($74 in chips) 
Seat 7: 56S3mA6Zs3pGR+0p0vUCtg ($34.95 in chips) 
Seat 8: +sbyWwIcFp9kP0bDtMegfQ ($51.25 in chips) 
Seat 9: HPEB+AtKw1+C/cxU0o1ciw ($46.95 in chips) 
HPEB+AtKw1+C/cxU0o1ciw: posts small blind $0.10
Bb42QRQMhg5/Y0vHP8/2Xw: posts big blind $0.25
*** HOLE CARDS ***
WKL8nUFr7TumC4EjLyqYzw: folds 
zgi+EUykT/pZQpoUG6+oEg: folds 
2wcFsZsqEP5w1StUTVzJCg: folds 
cZ99hugmLBj9KhTlc8nCSw: folds 
aNpwfA31EREwO+ar4XzBCw: folds 
56S3mA6Zs3pGR+0p0vUCtg: raises $1 to $1.25
+sbyWwIcFp9kP0bDtMegfQ: folds 
HPEB+AtKw1+C/cxU0o1ciw: folds 
Bb42QRQMhg5/Y0vHP8/2Xw: folds 
Uncalled bet ($1) returned to 56S3mA6Zs3pGR+0p0vUCtg
56S3mA6Zs3pGR+0p0vUCtg collected $0.60 from pot
56S3mA6Zs3pGR+0p0vUCtg: doesn't show hand 
*** SUMMARY ***
Total pot $0.60 | Rake $0 
Seat 1: Bb42QRQMhg5/Y0vHP8/2Xw (big blind) folded before Flop
Seat 2: WKL8nUFr7TumC4EjLyqYzw folded before Flop (didn't bet)
Seat 3: zgi+EUykT/pZQpoUG6+oEg folded before Flop (didn't bet)
Seat 4: 2wcFsZsqEP5w1StUTVzJCg folded before Flop (didn't bet)
Seat 5: cZ99hugmLBj9KhTlc8nCSw folded before Flop (didn't bet)
Seat 6: aNpwfA31EREwO+ar4XzBCw folded before Flop (didn't bet)
Seat 7: 56S3mA6Zs3pGR+0p0vUCtg collected ($0.60)
Seat 8: +sbyWwIcFp9kP0bDtMegfQ (button) folded before Flop (didn't bet)
Seat 9: HPEB+AtKw1+C/cxU0o1ciw (small blind) folded before Flop




PokerStars Game #59941683164:  Hold'em No Limit ($0.10/$0.25) - 2009/07/01 1:42:52 ET
Table 'WEMI3Mtn7dGARDbgNrKibg' 9-max Seat #8 is the button
Seat 1: Th3FldXKQW6hWVVPahaoOQ ($30.50 in chips) 
Seat 2: tYsOBqdU1+x+yFI7zHO7hQ ($49.55 in chips) 
Seat 3: qwr38jl5txoR36M7G5qi4A ($7.75 in chips) 
Seat 4: Z5NNIVvnhb2IJbLcI79WYQ ($5.25 in chips) 
Seat 5: yzPZQFeaQTNf1YK3a0zRIw ($14.80 in chips) 
Seat 6: arxNSjreDRGFg13EAM2F1w ($25.10 in chips) 
Seat 7: DnDcAdn9P0zGovMERigpFA ($54.90 in chips) 
Seat 8: ghNKXUBl/H+t83JF079ZBA ($28.65 in chips) 
Seat 9: 2wcFsZsqEP5w1StUTVzJCg ($5.25 in chips) 
2wcFsZsqEP5w1StUTVzJCg: posts small blind $0.10
Th3FldXKQW6hWVVPahaoOQ: posts big blind $0.25
*** HOLE CARDS ***
tYsOBqdU1+x+yFI7zHO7hQ: folds 
qwr38jl5txoR36M7G5qi4A: folds 
Z5NNIVvnhb2IJbLcI79WYQ: folds 
yzPZQFeaQTNf1YK3a0zRIw: folds 
arxNSjreDRGFg13EAM2F1w: folds 
DnDcAdn9P0zGovMERigpFA: folds 
ghNKXUBl/H+t83JF079ZBA: raises $0.50 to $0.75
2wcFsZsqEP5w1StUTVzJCg: calls $0.65
Th3FldXKQW6hWVVPahaoOQ: folds 
*** FLOP *** [9s 2h 3c]
2wcFsZsqEP5w1StUTVzJCg: checks 
ghNKXUBl/H+t83JF079ZBA: bets $1.25
2wcFsZsqEP5w1StUTVzJCg: folds 
Uncalled bet ($1.25) returned to ghNKXUBl/H+t83JF079ZBA
ghNKXUBl/H+t83JF079ZBA collected $1.70 from pot
ghNKXUBl/H+t83JF079ZBA: doesn't show hand 
*** SUMMARY ***
Total pot $1.75 | Rake $0.05 
Board [9s 2h 3c]
Seat 1: Th3FldXKQW6hWVVPahaoOQ (big blind) folded before Flop
Seat 2: tYsOBqdU1+x+yFI7zHO7hQ folded before Flop (didn't bet)
Seat 3: qwr38jl5txoR36M7G5qi4A folded before Flop (didn't bet)
Seat 4: Z5NNIVvnhb2IJbLcI79WYQ folded before Flop (didn't bet)
Seat 5: yzPZQFeaQTNf1YK3a0zRIw folded before Flop (didn't bet)
Seat 6: arxNSjreDRGFg13EAM2F1w folded before Flop (didn't bet)
Seat 7: DnDcAdn9P0zGovMERigpFA folded before Flop (didn't bet)
Seat 8: ghNKXUBl/H+t83JF079ZBA (button) collected ($1.70)
Seat 9: 2wcFsZsqEP5w1StUTVzJCg (small blind) folded on the Flop




PokerStars Game #59941683386:  Hold'em No Limit ($0.10/$0.25) - 2009/07/01 1:42:53 ET
Table 'G+4ZdyRoPjgaJY/jxSlZzQ' 9-max Seat #6 is the button
Seat 1: ghNKXUBl/H+t83JF079ZBA ($23.40 in chips) 
Seat 2: CT7Xj/V/O5rBlhtt+RZeFQ ($25 in chips) 
Seat 3: FaGtAm5QUVcixGhAKIvbLg ($15.60 in chips) 
Seat 4: lSeLm4BdnSMLtIli62qjAQ ($10.65 in chips) 
Seat 5: BT6Oal0iO4P6kDuT7HFQDw ($16.50 in chips) 
Seat 6: oFwaTjy3ok/+qFghsrcGvg ($23.30 in chips) 
Seat 7: IK3/w7XV7rd8mVIsuasjYA ($2.10 in chips) 
Seat 8: bXpVeaSTPBFSPJmeXxO7nw ($5 in chips) 
Seat 9: tLcDklc2rBORNfixyRfVfw ($25 in chips) 
IK3/w7XV7rd8mVIsuasjYA: posts small blind $0.10
bXpVeaSTPBFSPJmeXxO7nw: posts big blind $0.25
*** HOLE CARDS ***
tLcDklc2rBORNfixyRfVfw: folds 
ghNKXUBl/H+t83JF079ZBA: folds 
CT7Xj/V/O5rBlhtt+RZeFQ: calls $0.25
FaGtAm5QUVcixGhAKIvbLg: folds 
lSeLm4BdnSMLtIli62qjAQ: folds 
BT6Oal0iO4P6kDuT7HFQDw: raises $0.50 to $0.75
oFwaTjy3ok/+qFghsrcGvg: folds 
IK3/w7XV7rd8mVIsuasjYA: folds 
bXpVeaSTPBFSPJmeXxO7nw: folds 
CT7Xj/V/O5rBlhtt+RZeFQ: folds 
Uncalled bet ($0.50) returned to BT6Oal0iO4P6kDuT7HFQDw
BT6Oal0iO4P6kDuT7HFQDw collected $0.85 from pot
BT6Oal0iO4P6kDuT7HFQDw: doesn't show hand 
*** SUMMARY ***
Total pot $0.85 | Rake $0 
Seat 1: ghNKXUBl/H+t83JF079ZBA folded before Flop (didn't bet)
Seat 2: CT7Xj/V/O5rBlhtt+RZeFQ folded before Flop
Seat 3: FaGtAm5QUVcixGhAKIvbLg folded before Flop (didn't bet)
Seat 4: lSeLm4BdnSMLtIli62qjAQ folded before Flop (didn't bet)
Seat 5: BT6Oal0iO4P6kDuT7HFQDw collected ($0.85)
Seat 6: oFwaTjy3ok/+qFghsrcGvg (button) folded before Flop (didn't bet)
Seat 7: IK3/w7XV7rd8mVIsuasjYA (small blind) folded before Flop
Seat 8: bXpVeaSTPBFSPJmeXxO7nw (big blind) folded before Flop
Seat 9: tLcDklc2rBORNfixyRfVfw folded before Flop (didn't bet)




PokerStars Game #59941683654:  Hold'em No Limit ($0.10/$0.25) - 2009/07/01 1:42:53 ET
Table 'YONIZZNvg4uZ4xNUO1deeA' 6-max Seat #2 is the button
Seat 1: GbCVUNssQ7mqsPWr7J4d3w ($4.65 in chips) 
Seat 2: evMMX/0gSDH791KdSAOaSg ($9.50 in chips) 
Seat 3: Eksrep3hySi2jeDHuaWiOQ ($10.75 in chips) 
Seat 4: oNAHfBJOUelvVhf0IDMJUA ($21.05 in chips) 
Seat 5: if4dh6jhJXeN3/qd3qCp9g ($25.35 in chips) 
Seat 6: eL3+wCBjFGfQ5FMdIZihwA ($25 in chips) 
Eksrep3hySi2jeDHuaWiOQ: posts small blind $0.10
oNAHfBJOUelvVhf0IDMJUA: posts big blind $0.25
*** HOLE CARDS ***
if4dh6jhJXeN3/qd3qCp9g: folds 
eL3+wCBjFGfQ5FMdIZihwA: folds 
GbCVUNssQ7mqsPWr7J4d3w: folds 
evMMX/0gSDH791KdSAOaSg: raises $0.50 to $0.75
Eksrep3hySi2jeDHuaWiOQ: folds 
oNAHfBJOUelvVhf0IDMJUA: calls $0.50
*** FLOP *** [2h 5d 9c]
oNAHfBJOUelvVhf0IDMJUA: checks 
evMMX/0gSDH791KdSAOaSg: bets $1.25
oNAHfBJOUelvVhf0IDMJUA: calls $1.25
*** TURN *** [2h 5d 9c] [2s]
oNAHfBJOUelvVhf0IDMJUA: checks 
evMMX/0gSDH791KdSAOaSg: bets $2.50
oNAHfBJOUelvVhf0IDMJUA: calls $2.50
*** RIVER *** [2h 5d 9c 2s] [9d]
oNAHfBJOUelvVhf0IDMJUA: bets $3.50
evMMX/0gSDH791KdSAOaSg: raises $1.50 to $5 and is all-in
oNAHfBJOUelvVhf0IDMJUA: calls $1.50
*** SHOW DOWN ***
evMMX/0gSDH791KdSAOaSg: shows [9s Ks] (a full house, Nines full of Deuces)
oNAHfBJOUelvVhf0IDMJUA: mucks hand 
evMMX/0gSDH791KdSAOaSg collected $18.20 from pot
*** SUMMARY ***
Total pot $19.10 | Rake $0.90 
Board [2h 5d 9c 2s 9d]
Seat 1: GbCVUNssQ7mqsPWr7J4d3w folded before Flop (didn't bet)
Seat 2: evMMX/0gSDH791KdSAOaSg (button) showed [9s Ks] and won ($18.20) with a full house, Nines full of Deuces
Seat 3: Eksrep3hySi2jeDHuaWiOQ (small blind) folded before Flop
Seat 4: oNAHfBJOUelvVhf0IDMJUA (big blind) mucked
Seat 5: if4dh6jhJXeN3/qd3qCp9g folded before Flop (didn't bet)
Seat 6: eL3+wCBjFGfQ5FMdIZihwA folded before Flop (didn't bet)




PokerStars Game #59941683354:  Hold'em No Limit ($0.10/$0.25) - 2009/07/01 1:42:53 ET
Table 'jdhJTJjFq2KTttwJcd+7nQ' 6-max Seat #3 is the button
Seat 1: LtASJ9OlkqGrrUKGQlpGAw ($27.20 in chips) 
Seat 2: Hsvkc0/G2VV78oVmWYXecw ($5 in chips) 
Seat 3: vqWjZmdQu/Hxw96/IJTWdQ ($25.95 in chips) 
Seat 4: vx7FwRcelVSsvNYAdp/z0A ($3.25 in chips) 
Seat 5: BV+K0Phf5VBHr7aZPKqbUQ ($26 in chips) 
Seat 6: yb6rnd48JuBccThV68VHAQ ($20 in chips) 
vx7FwRcelVSsvNYAdp/z0A: posts small blind $0.10
BV+K0Phf5VBHr7aZPKqbUQ: posts big blind $0.25
*** HOLE CARDS ***
yb6rnd48JuBccThV68VHAQ: calls $0.25
LtASJ9OlkqGrrUKGQlpGAw: calls $0.25
Hsvkc0/G2VV78oVmWYXecw: folds 
vqWjZmdQu/Hxw96/IJTWdQ: folds 
vx7FwRcelVSsvNYAdp/z0A: raises $0.25 to $0.50
BV+K0Phf5VBHr7aZPKqbUQ: calls $0.25
yb6rnd48JuBccThV68VHAQ: calls $0.25
LtASJ9OlkqGrrUKGQlpGAw: calls $0.25
*** FLOP *** [2c Qd Kd]
vx7FwRcelVSsvNYAdp/z0A: bets $0.25
BV+K0Phf5VBHr7aZPKqbUQ: folds 
yb6rnd48JuBccThV68VHAQ: raises $1 to $1.25
LtASJ9OlkqGrrUKGQlpGAw: folds 
vx7FwRcelVSsvNYAdp/z0A: raises $1 to $2.25
yb6rnd48JuBccThV68VHAQ: calls $1
*** TURN *** [2c Qd Kd] [Js]
vx7FwRcelVSsvNYAdp/z0A: bets $0.50 and is all-in
yb6rnd48JuBccThV68VHAQ: calls $0.50
*** RIVER *** [2c Qd Kd Js] [Ks]
*** SHOW DOWN ***
vx7FwRcelVSsvNYAdp/z0A: shows [Kc Jc] (a full house, Kings full of Jacks)
yb6rnd48JuBccThV68VHAQ: mucks hand 
vx7FwRcelVSsvNYAdp/z0A collected $7.15 from pot
*** SUMMARY ***
Total pot $7.50 | Rake $0.35 
Board [2c Qd Kd Js Ks]
Seat 1: LtASJ9OlkqGrrUKGQlpGAw folded on the Flop
Seat 2: Hsvkc0/G2VV78oVmWYXecw folded before Flop (didn't bet)
Seat 3: vqWjZmdQu/Hxw96/IJTWdQ (button) folded before Flop (didn't bet)
Seat 4: vx7FwRcelVSsvNYAdp/z0A (small blind) showed [Kc Jc] and won ($7.15) with a full house, Kings full of Jacks
Seat 5: BV+K0Phf5VBHr7aZPKqbUQ (big blind) folded on the Flop
Seat 6: yb6rnd48JuBccThV68VHAQ mucked




PokerStars Game #59941683856:  Hold'em No Limit ($0.10/$0.25) - 2009/07/01 1:42:54 ET
Table 'nc6OeGk/wtaWV+6N+kgnZQ' 6-max Seat #1 is the button
Seat 1: tSR4329m40dZsN7YOpI9Kw ($38.80 in chips) 
Seat 2: 8ClCHtFXGNplITm+63KB+Q ($34.85 in chips) 
Seat 3: y8wpMWGSX2zHZijurx21mg ($6.60 in chips) 
Seat 4: 3zD3qLXT1bEffAoWGnc7wg ($29.95 in chips) 
Seat 5: HCS0lMAAPmZE2Tl8J/SuKw ($11.45 in chips) 
Seat 6: mFv3iBCtrw9XfCDRB0d46Q ($3.55 in chips) 
8ClCHtFXGNplITm+63KB+Q: posts small blind $0.10
y8wpMWGSX2zHZijurx21mg: posts big blind $0.25
*** HOLE CARDS ***
3zD3qLXT1bEffAoWGnc7wg: folds 
HCS0lMAAPmZE2Tl8J/SuKw: folds 
mFv3iBCtrw9XfCDRB0d46Q: folds 
tSR4329m40dZsN7YOpI9Kw: raises $0.50 to $0.75
8ClCHtFXGNplITm+63KB+Q: folds 
y8wpMWGSX2zHZijurx21mg: calls $0.50
*** FLOP *** [Js Ks 7h]
y8wpMWGSX2zHZijurx21mg: checks 
tSR4329m40dZsN7YOpI9Kw: bets $0.75
y8wpMWGSX2zHZijurx21mg: calls $0.75
*** TURN *** [Js Ks 7h] [8h]
y8wpMWGSX2zHZijurx21mg: checks 
tSR4329m40dZsN7YOpI9Kw: checks 
*** RIVER *** [Js Ks 7h 8h] [4c]
y8wpMWGSX2zHZijurx21mg: checks 
tSR4329m40dZsN7YOpI9Kw: checks 
*** SHOW DOWN ***
y8wpMWGSX2zHZijurx21mg: shows [As 3s] (high card Ace)
tSR4329m40dZsN7YOpI9Kw: shows [3c 3d] (a pair of Threes)
tSR4329m40dZsN7YOpI9Kw collected $2.95 from pot
*** SUMMARY ***
Total pot $3.10 | Rake $0.15 
Board [Js Ks 7h 8h 4c]
Seat 1: tSR4329m40dZsN7YOpI9Kw (button) showed [3c 3d] and won ($2.95) with a pair of Threes
Seat 2: 8ClCHtFXGNplITm+63KB+Q (small blind) folded before Flop
Seat 3: y8wpMWGSX2zHZijurx21mg (big blind) showed [As 3s] and lost with high card Ace
Seat 4: 3zD3qLXT1bEffAoWGnc7wg folded before Flop (didn't bet)
Seat 5: HCS0lMAAPmZE2Tl8J/SuKw folded before Flop (didn't bet)
Seat 6: mFv3iBCtrw9XfCDRB0d46Q folded before Flop (didn't bet)




PokerStars Game #59941684216:  Hold'em No Limit ($0.10/$0.25) - 2009/07/01 1:42:54 ET
Table '2vH5RcmkT0F4XNS/EmmyMA' 6-max Seat #2 is the button
Seat 1: hOaWAImn5/MZDAWAPlYHCw ($6.50 in chips) 
Seat 2: W6Y6au0wf7gRAlqJYgOezw ($11.85 in chips) 
Seat 3: t8P79jKZYh/Wpx2V73pSqg ($30 in chips) 
Seat 4: FC6tJ9EOiutXO8hnpR4VgQ ($6.15 in chips) 
Seat 5: Hsvkc0/G2VV78oVmWYXecw ($5 in chips) 
Seat 6: if4dh6jhJXeN3/qd3qCp9g ($25 in chips) 
t8P79jKZYh/Wpx2V73pSqg: posts small blind $0.10
FC6tJ9EOiutXO8hnpR4VgQ said, "nice call there preflop"
FC6tJ9EOiutXO8hnpR4VgQ: posts big blind $0.25
*** HOLE CARDS ***
Hsvkc0/G2VV78oVmWYXecw: raises $0.50 to $0.75
if4dh6jhJXeN3/qd3qCp9g: raises $2.25 to $3
hOaWAImn5/MZDAWAPlYHCw: folds 
W6Y6au0wf7gRAlqJYgOezw: folds 
t8P79jKZYh/Wpx2V73pSqg: folds 
FC6tJ9EOiutXO8hnpR4VgQ: folds 
Hsvkc0/G2VV78oVmWYXecw: folds 
Uncalled bet ($2.25) returned to if4dh6jhJXeN3/qd3qCp9g
if4dh6jhJXeN3/qd3qCp9g collected $1.85 from pot
if4dh6jhJXeN3/qd3qCp9g: doesn't show hand 
*** SUMMARY ***
Total pot $1.85 | Rake $0 
Seat 1: hOaWAImn5/MZDAWAPlYHCw folded before Flop (didn't bet)
Seat 2: W6Y6au0wf7gRAlqJYgOezw (button) folded before Flop (didn't bet)
Seat 3: t8P79jKZYh/Wpx2V73pSqg (small blind) folded before Flop
Seat 4: FC6tJ9EOiutXO8hnpR4VgQ (big blind) folded before Flop
Seat 5: Hsvkc0/G2VV78oVmWYXecw folded before Flop
Seat 6: if4dh6jhJXeN3/qd3qCp9g collected ($1.85)




PokerStars Game #59941684100:  Hold'em No Limit ($0.10/$0.25) - 2009/07/01 1:42:54 ET
Table 'zKwHJD0cmKNUure9qQTfFg' 6-max Seat #5 is the button
Seat 1: Hzrn9DZJegEZICufTNYkrg ($15 in chips) 
Seat 2: xrf8tAXKQHG99HixCot1Iw ($25.80 in chips) 
Seat 3: 60PLIlpucQhA08L3YbNmag ($14.15 in chips) 
Seat 4: v+QfkGiuj9bgtuNoVnDO8w ($25.80 in chips) 
Seat 5: E4AqQ1egsnu0oH2RqsbCmQ ($3.80 in chips) 
Seat 6: edio/rLJ06xeZOfLhoL3UA ($7.70 in chips) 
edio/rLJ06xeZOfLhoL3UA: posts small blind $0.10
Hzrn9DZJegEZICufTNYkrg: posts big blind $0.25
*** HOLE CARDS ***
xrf8tAXKQHG99HixCot1Iw: folds 
60PLIlpucQhA08L3YbNmag: folds 
v+QfkGiuj9bgtuNoVnDO8w: folds 
E4AqQ1egsnu0oH2RqsbCmQ: folds 
60PLIlpucQhA08L3YbNmag leaves the table
edio/rLJ06xeZOfLhoL3UA: folds 
Uncalled bet ($0.15) returned to Hzrn9DZJegEZICufTNYkrg
Hzrn9DZJegEZICufTNYkrg collected $0.20 from pot
Hzrn9DZJegEZICufTNYkrg: doesn't show hand 
*** SUMMARY ***
Total pot $0.20 | Rake $0 
Seat 1: Hzrn9DZJegEZICufTNYkrg (big blind) collected ($0.20)
Seat 2: xrf8tAXKQHG99HixCot1Iw folded before Flop (didn't bet)
Seat 3: 60PLIlpucQhA08L3YbNmag folded before Flop (didn't bet)
Seat 4: v+QfkGiuj9bgtuNoVnDO8w folded before Flop (didn't bet)
Seat 5: E4AqQ1egsnu0oH2RqsbCmQ (button) folded before Flop (didn't bet)
Seat 6: edio/rLJ06xeZOfLhoL3UA (small blind) folded before Flop




PokerStars Game #59941683916:  Hold'em No Limit ($0.10/$0.25) - 2009/07/01 1:42:54 ET
Table 'gnrUwXkIPE0C8xl6cB4Hyw' 9-max Seat #7 is the button
Seat 1: EQXHDnIzAsORnIXRNtXRlA ($22.60 in chips) 
Seat 2: 7je+LC5Mfs6nL8YBVh4frQ ($5 in chips) 
Seat 3: PdIasPkzm2sqZnN41ZRXOg ($5 in chips) 
Seat 4: wGigCmBR/9XWkPpvYos3aQ ($25.35 in chips) 
Seat 5: gehe91e0IyVT0QU/XBkEyg ($27.15 in chips) 
Seat 6: dtZ84flFEi4Q+SGrHMJRDQ ($25.80 in chips) 
Seat 7: OXPkK84/qv92EMwXPiG5rQ ($9.95 in chips) 
Seat 8: 4awUyiDYTgylQKXZ9faBVA ($56.80 in chips) 
Seat 9: F7pnn6czNpHvRM55XcA2EA ($28.10 in chips) 
4awUyiDYTgylQKXZ9faBVA: posts small blind $0.10
F7pnn6czNpHvRM55XcA2EA: posts big blind $0.25
*** HOLE CARDS ***
EQXHDnIzAsORnIXRNtXRlA: folds 
7je+LC5Mfs6nL8YBVh4frQ: folds 
PdIasPkzm2sqZnN41ZRXOg: folds 
wGigCmBR/9XWkPpvYos3aQ: folds 
gehe91e0IyVT0QU/XBkEyg: folds 
dtZ84flFEi4Q+SGrHMJRDQ: folds 
OXPkK84/qv92EMwXPiG5rQ: folds 
4awUyiDYTgylQKXZ9faBVA: raises $0.75 to $1
F7pnn6czNpHvRM55XcA2EA: calls $0.75
*** FLOP *** [Jc 5c 9s]
4awUyiDYTgylQKXZ9faBVA: bets $1
F7pnn6czNpHvRM55XcA2EA: raises $2.25 to $3.25
4awUyiDYTgylQKXZ9faBVA: calls $2.25
*** TURN *** [Jc 5c 9s] [4d]
4awUyiDYTgylQKXZ9faBVA: checks 
F7pnn6czNpHvRM55XcA2EA: checks 
*** RIVER *** [Jc 5c 9s 4d] [Ad]
4awUyiDYTgylQKXZ9faBVA: bets $5
F7pnn6czNpHvRM55XcA2EA: folds 
Uncalled bet ($5) returned to 4awUyiDYTgylQKXZ9faBVA
4awUyiDYTgylQKXZ9faBVA collected $8.10 from pot
4awUyiDYTgylQKXZ9faBVA: doesn't show hand 
*** SUMMARY ***
Total pot $8.50 | Rake $0.40 
Board [Jc 5c 9s 4d Ad]
Seat 1: EQXHDnIzAsORnIXRNtXRlA folded before Flop (didn't bet)
Seat 2: 7je+LC5Mfs6nL8YBVh4frQ folded before Flop (didn't bet)
Seat 3: PdIasPkzm2sqZnN41ZRXOg folded before Flop (didn't bet)
Seat 4: wGigCmBR/9XWkPpvYos3aQ folded before Flop (didn't bet)
Seat 5: gehe91e0IyVT0QU/XBkEyg folded before Flop (didn't bet)
Seat 6: dtZ84flFEi4Q+SGrHMJRDQ folded before Flop (didn't bet)
Seat 7: OXPkK84/qv92EMwXPiG5rQ (button) folded before Flop (didn't bet)
Seat 8: 4awUyiDYTgylQKXZ9faBVA (small blind) collected ($8.10)
Seat 9: F7pnn6czNpHvRM55XcA2EA (big blind) folded on the River




PokerStars Game #59941683828:  Hold'em No Limit ($0.10/$0.25) - 2009/07/01 1:42:54 ET
Table 'hg+KpirwreMnBAFQr/SEUA' 9-max Seat #5 is the button
Seat 1: H5Se03ZqSX7tbULXur2MAg ($33.80 in chips) 
Seat 2: cpnBzHjFACn5zAY56UIvNA ($19.45 in chips) 
Seat 3: DdyXKuBx0HAOC7dWZmGxWg ($23.90 in chips) 
Seat 5: +2kMBNpY4nF1qNCRd8SJLA ($25 in chips) 
Seat 6: Bb42QRQMhg5/Y0vHP8/2Xw ($25 in chips) 
Seat 7: 5LSuZS4qvcUri/Byfkln7w ($8.75 in chips) 
Seat 8: HPEB+AtKw1+C/cxU0o1ciw ($23.75 in chips) 
Seat 9: xbecloQJYmBOSkzT9lZ+rg ($20.50 in chips) 
Bb42QRQMhg5/Y0vHP8/2Xw: posts small blind $0.10
5LSuZS4qvcUri/Byfkln7w: posts big blind $0.25
Z9W7+g1WMhhZDi7DwGbCFA: sits out 
*** HOLE CARDS ***
HPEB+AtKw1+C/cxU0o1ciw: folds 
xbecloQJYmBOSkzT9lZ+rg: folds 
H5Se03ZqSX7tbULXur2MAg: folds 
cpnBzHjFACn5zAY56UIvNA: folds 
DdyXKuBx0HAOC7dWZmGxWg: calls $0.25
+2kMBNpY4nF1qNCRd8SJLA: folds 
Bb42QRQMhg5/Y0vHP8/2Xw: folds 
5LSuZS4qvcUri/Byfkln7w: checks 
*** FLOP *** [9c Ad Qs]
5LSuZS4qvcUri/Byfkln7w: checks 
DdyXKuBx0HAOC7dWZmGxWg: bets $0.25
5LSuZS4qvcUri/Byfkln7w: folds 
Uncalled bet ($0.25) returned to DdyXKuBx0HAOC7dWZmGxWg
DdyXKuBx0HAOC7dWZmGxWg collected $0.60 from pot
DdyXKuBx0HAOC7dWZmGxWg: doesn't show hand 
*** SUMMARY ***
Total pot $0.60 | Rake $0 
Board [9c Ad Qs]
Seat 1: H5Se03ZqSX7tbULXur2MAg folded before Flop (didn't bet)
Seat 2: cpnBzHjFACn5zAY56UIvNA folded before Flop (didn't bet)
Seat 3: DdyXKuBx0HAOC7dWZmGxWg collected ($0.60)
Seat 5: +2kMBNpY4nF1qNCRd8SJLA (button) folded before Flop (didn't bet)
Seat 6: Bb42QRQMhg5/Y0vHP8/2Xw (small blind) folded before Flop
Seat 7: 5LSuZS4qvcUri/Byfkln7w (big blind) folded on the Flop
Seat 8: HPEB+AtKw1+C/cxU0o1ciw folded before Flop (didn't bet)
Seat 9: xbecloQJYmBOSkzT9lZ+rg folded before Flop (didn't bet)




PokerStars Game #59941683986:  Hold'em No Limit ($0.10/$0.25) - 2009/07/01 1:42:54 ET
Table 'xkqAWQFDrFt4p81M8UsoNw' 9-max Seat #3 is the button
Seat 1: tLcDklc2rBORNfixyRfVfw ($26.75 in chips) 
Seat 2: z5GxcHlYz/GSz6W2uFiTtg ($40.15 in chips) 
Seat 3: xHZZRLAaFUIC8WWI8ljOJA ($24 in chips) 
Seat 4: wGigCmBR/9XWkPpvYos3aQ ($25.20 in chips) 
Seat 6: 6RiVTYll/5D8zICp0MRpKw ($25 in chips) 
Seat 7: MG90wfSJZnOejs/KD3vlQQ ($43.05 in chips) 
Seat 8: MaqsqnOOkbNuPf4oWvOtnA ($42.95 in chips) 
Seat 9: Z9AeOQX3yzuSvKAm/xyovg ($9.65 in chips) 
wGigCmBR/9XWkPpvYos3aQ: posts small blind $0.10
OiV1PWZ3IkN29JlmCcnTwQ: is sitting out 
6RiVTYll/5D8zICp0MRpKw: posts big blind $0.25
*** HOLE CARDS ***
MG90wfSJZnOejs/KD3vlQQ: folds 
OiV1PWZ3IkN29JlmCcnTwQ leaves the table
MaqsqnOOkbNuPf4oWvOtnA: calls $0.25
Z9AeOQX3yzuSvKAm/xyovg: folds 
tLcDklc2rBORNfixyRfVfw: raises $1 to $1.25
z5GxcHlYz/GSz6W2uFiTtg: folds 
z5GxcHlYz/GSz6W2uFiTtg is sitting out
xHZZRLAaFUIC8WWI8ljOJA: folds 
wGigCmBR/9XWkPpvYos3aQ: folds 
6RiVTYll/5D8zICp0MRpKw: folds 
MaqsqnOOkbNuPf4oWvOtnA: calls $1
*** FLOP *** [Ad Qd 4c]
MaqsqnOOkbNuPf4oWvOtnA: checks 
tLcDklc2rBORNfixyRfVfw: bets $1.50
MaqsqnOOkbNuPf4oWvOtnA: folds 
Uncalled bet ($1.50) returned to tLcDklc2rBORNfixyRfVfw
tLcDklc2rBORNfixyRfVfw collected $2.75 from pot
tLcDklc2rBORNfixyRfVfw: doesn't show hand 
*** SUMMARY ***
Total pot $2.85 | Rake $0.10 
Board [Ad Qd 4c]
Seat 1: tLcDklc2rBORNfixyRfVfw collected ($2.75)
Seat 2: z5GxcHlYz/GSz6W2uFiTtg folded before Flop (didn't bet)
Seat 3: xHZZRLAaFUIC8WWI8ljOJA (button) folded before Flop (didn't bet)
Seat 4: wGigCmBR/9XWkPpvYos3aQ (small blind) folded before Flop
Seat 6: 6RiVTYll/5D8zICp0MRpKw (big blind) folded before Flop
Seat 7: MG90wfSJZnOejs/KD3vlQQ folded before Flop (didn't bet)
Seat 8: MaqsqnOOkbNuPf4oWvOtnA folded on the Flop
Seat 9: Z9AeOQX3yzuSvKAm/xyovg folded before Flop (didn't bet)




PokerStars Game #59941684102:  Hold'em No Limit ($0.10/$0.25) - 2009/07/01 1:42:54 ET
Table 'VuY5ej47Cy8nOI3Wogmhzw' 6-max Seat #3 is the button
Seat 1: EeUZtMU058v2ObUACOF4Og ($38.20 in chips) 
Seat 2: AM6Yl+3esmhhMBlSnQhWbg ($19 in chips) 
Seat 3: v+QfkGiuj9bgtuNoVnDO8w ($29.65 in chips) 
Seat 5: iK/41//HmnLiIn0CVNNfyA ($11.30 in chips) 
iK/41//HmnLiIn0CVNNfyA: posts small blind $0.10
EeUZtMU058v2ObUACOF4Og: posts big blind $0.25
*** HOLE CARDS ***
AM6Yl+3esmhhMBlSnQhWbg: folds 
v+QfkGiuj9bgtuNoVnDO8w: folds 
QqiZLFrN8iOUT/GHw7ztOA joins the table at seat #4 
iK/41//HmnLiIn0CVNNfyA: raises $0.75 to $1
EeUZtMU058v2ObUACOF4Og: folds 
Uncalled bet ($0.75) returned to iK/41//HmnLiIn0CVNNfyA
iK/41//HmnLiIn0CVNNfyA collected $0.50 from pot
iK/41//HmnLiIn0CVNNfyA: doesn't show hand 
*** SUMMARY ***
Total pot $0.50 | Rake $0 
Seat 1: EeUZtMU058v2ObUACOF4Og (big blind) folded before Flop
Seat 2: AM6Yl+3esmhhMBlSnQhWbg folded before Flop (didn't bet)
Seat 3: v+QfkGiuj9bgtuNoVnDO8w (button) folded before Flop (didn't bet)
Seat 5: iK/41//HmnLiIn0CVNNfyA (small blind) collected ($0.50)




PokerStars Game #59941684824:  Hold'em No Limit ($0.10/$0.25) - 2009/07/01 1:42:55 ET
Table 'emoxgHTxg9Uqeu06oLzLyg' 6-max Seat #6 is the button
Seat 2: wIFhgE1PVdX6Xf6aVlSTPg ($25.35 in chips) 
Seat 3: uD5epdBxuyc30pF1dO958Q ($11.25 in chips) 
Seat 4: 3VAbqAWh8ncE2SJOYIx2ZQ ($12 in chips) 
Seat 5: OIjOiBfQstWrK/RuXx7zcw ($5 in chips) 
Seat 6: iHZrkhpIO/3+tKuAoPx8HQ ($2.65 in chips) 
epAUIB7h2FJXzUPRIvSkRA will be allowed to play after the button
wIFhgE1PVdX6Xf6aVlSTPg: posts small blind $0.10
uD5epdBxuyc30pF1dO958Q: posts big blind $0.25
OIjOiBfQstWrK/RuXx7zcw: posts big blind $0.25
*** HOLE CARDS ***
3VAbqAWh8ncE2SJOYIx2ZQ: folds 
OIjOiBfQstWrK/RuXx7zcw: raises $0.25 to $0.50
iHZrkhpIO/3+tKuAoPx8HQ: folds 
wIFhgE1PVdX6Xf6aVlSTPg: folds 
uD5epdBxuyc30pF1dO958Q: calls $0.25
*** FLOP *** [7h 5c As]
uD5epdBxuyc30pF1dO958Q: checks 
OIjOiBfQstWrK/RuXx7zcw: bets $0.25
uD5epdBxuyc30pF1dO958Q: folds 
Uncalled bet ($0.25) returned to OIjOiBfQstWrK/RuXx7zcw
OIjOiBfQstWrK/RuXx7zcw collected $1.05 from pot
OIjOiBfQstWrK/RuXx7zcw: doesn't show hand 
*** SUMMARY ***
Total pot $1.10 | Rake $0.05 
Board [7h 5c As]
Seat 2: wIFhgE1PVdX6Xf6aVlSTPg (small blind) folded before Flop
Seat 3: uD5epdBxuyc30pF1dO958Q (big blind) folded on the Flop
Seat 4: 3VAbqAWh8ncE2SJOYIx2ZQ folded before Flop (didn't bet)
Seat 5: OIjOiBfQstWrK/RuXx7zcw collected ($1.05)
Seat 6: iHZrkhpIO/3+tKuAoPx8HQ (button) folded before Flop (didn't bet)




PokerStars Game #59941684748:  Hold'em No Limit ($0.10/$0.25) - 2009/07/01 1:42:55 ET
Table 'HzFR0rxmDAPu5GzYR0AlYg' 6-max Seat #3 is the button
Seat 1: v+QfkGiuj9bgtuNoVnDO8w ($30.30 in chips) 
Seat 2: UA5OsKS3VPaxa7uC8La/kA ($53 in chips) 
Seat 3: kG34n23qFQA3nzdOJTQ1dA ($24.65 in chips) 
Seat 5: lquriepNQBhDV5P1SWHhnA ($29.95 in chips) 
Seat 6: jp34e617tIzV8tKIWmfAbA ($34.85 in chips) 
StevenWu will be allowed to play after the button
lquriepNQBhDV5P1SWHhnA: posts small blind $0.10
jp34e617tIzV8tKIWmfAbA: posts big blind $0.25
*** HOLE CARDS ***
v+QfkGiuj9bgtuNoVnDO8w: folds 
UA5OsKS3VPaxa7uC8La/kA: raises $0.50 to $0.75
kG34n23qFQA3nzdOJTQ1dA: folds 
lquriepNQBhDV5P1SWHhnA: folds 
jp34e617tIzV8tKIWmfAbA: calls $0.50
*** FLOP *** [Jd 7h 5c]
jp34e617tIzV8tKIWmfAbA: checks 
UA5OsKS3VPaxa7uC8La/kA: bets $1
jp34e617tIzV8tKIWmfAbA: raises $2 to $3
UA5OsKS3VPaxa7uC8La/kA: folds 
Uncalled bet ($2) returned to jp34e617tIzV8tKIWmfAbA
jp34e617tIzV8tKIWmfAbA collected $3.45 from pot
*** SUMMARY ***
Total pot $3.60 | Rake $0.15 
Board [Jd 7h 5c]
Seat 1: v+QfkGiuj9bgtuNoVnDO8w folded before Flop (didn't bet)
Seat 2: UA5OsKS3VPaxa7uC8La/kA folded on the Flop
Seat 3: kG34n23qFQA3nzdOJTQ1dA (button) folded before Flop (didn't bet)
Seat 5: lquriepNQBhDV5P1SWHhnA (small blind) folded before Flop
Seat 6: jp34e617tIzV8tKIWmfAbA (big blind) collected ($3.45)




PokerStars Game #59941684374:  Hold'em No Limit ($0.10/$0.25) - 2009/07/01 1:42:55 ET
Table 'hfHe8uKeSJMyWAjSdM7ROQMRfAiS/4JSfnUDlCcZo0wAx Seat #4 is the button
Seat 1: 48oT5xFI+5CHUJlfoGrE4w ($30.50 in chips) 
Seat 2: /gJNBeCkWL4o85/jvlZ4BA ($29.35 in chips) 
Seat 3: FYepjhAvF8ZdVCmqHIy+eQ ($39.05 in chips) 
Seat 4: b4wRQV3APH8irVk6bUFe2Q ($30.35 in chips) 
Seat 6: L3/N/gliETan8N5Gim5h4Q ($25 in chips) 
L3/N/gliETan8N5Gim5h4Q: posts small blind $0.10
48oT5xFI+5CHUJlfoGrE4w: posts big blind $0.25
*** HOLE CARDS ***
/gJNBeCkWL4o85/jvlZ4BA: folds 
FYepjhAvF8ZdVCmqHIy+eQ: folds 
b4wRQV3APH8irVk6bUFe2Q: folds 
L3/N/gliETan8N5Gim5h4Q: raises $0.50 to $0.75
48oT5xFI+5CHUJlfoGrE4w: folds 
Uncalled bet ($0.50) returned to L3/N/gliETan8N5Gim5h4Q
L3/N/gliETan8N5Gim5h4Q collected $0.50 from pot
L3/N/gliETan8N5Gim5h4Q: doesn't show hand 
*** SUMMARY ***
Total pot $0.50 | Rake $0 
Seat 1: 48oT5xFI+5CHUJlfoGrE4w (big blind) folded before Flop
Seat 2: /gJNBeCkWL4o85/jvlZ4BA folded before Flop (didn't bet)
Seat 3: FYepjhAvF8ZdVCmqHIy+eQ folded before Flop (didn't bet)
Seat 4: b4wRQV3APH8irVk6bUFe2Q (button) folded before Flop (didn't bet)
Seat 6: L3/N/gliETan8N5Gim5h4Q (small blind) collected ($0.50)




PokerStars Game #59941684306:  Hold'em No Limit ($0.10/$0.25) - 2009/07/01 1:42:55 ET
Table 'LwnjzXstPtSrqrV/oDpnXQ' 9-max Seat #8 is the button
Seat 1: 9YN2IkT2JYYKFErZtZvCtA ($20.30 in chips) 
Seat 2: uLP/lYn7oKq9xCChBXsXxw ($27 in chips) 
Seat 3: 7je+LC5Mfs6nL8YBVh4frQ ($4.30 in chips) 
Seat 4: CmngQmkKTp8tkl6GMRTl6w ($9.60 in chips) 
Seat 5: Th3FldXKQW6hWVVPahaoOQ ($25 in chips) 
Seat 6: ljemhp25Zg+nlA9DLCIiUw ($39.85 in chips) 
Seat 7: c/Dw/6HyqldTzIRodAIZmg ($12.05 in chips) 
Seat 8: ShXPHWfjhfmAwLgDdm6bRQ ($12.35 in chips) 
Seat 9: q6WfTUAD9mowIP63ASq2Dgz/khFDKGihQjwgoiKKPOeg45 in chips) 
q6WfTUAD9mowIP63ASq2Dgz/khFDKGihQjwgoiKKPOegs small blind $0.10
9YN2IkT2JYYKFErZtZvCtA: posts big blind $0.25
*** HOLE CARDS ***
uLP/lYn7oKq9xCChBXsXxw: folds 
7je+LC5Mfs6nL8YBVh4frQ: folds 
CmngQmkKTp8tkl6GMRTl6w: folds 
Th3FldXKQW6hWVVPahaoOQ: folds 
ljemhp25Zg+nlA9DLCIiUw: folds 
c/Dw/6HyqldTzIRodAIZmg: raises $0.50 to $0.75
ShXPHWfjhfmAwLgDdm6bRQ: folds 
q6WfTUAD9mowIP63ASq2Dgz/khFDKGihQjwgoiKKPOegs 
9YN2IkT2JYYKFErZtZvCtA: calls $0.50
*** FLOP *** [4c Kc Jc]
9YN2IkT2JYYKFErZtZvCtA: bets $1
c/Dw/6HyqldTzIRodAIZmg: raises $2 to $3
9YN2IkT2JYYKFErZtZvCtA: folds 
Uncalled bet ($2) returned to c/Dw/6HyqldTzIRodAIZmg
c/Dw/6HyqldTzIRodAIZmg collected $3.45 from pot
c/Dw/6HyqldTzIRodAIZmg: doesn't show hand 
*** SUMMARY ***
Total pot $3.60 | Rake $0.15 
Board [4c Kc Jc]
Seat 1: 9YN2IkT2JYYKFErZtZvCtA (big blind) folded on the Flop
Seat 2: uLP/lYn7oKq9xCChBXsXxw folded before Flop (didn't bet)
Seat 3: 7je+LC5Mfs6nL8YBVh4frQ folded before Flop (didn't bet)
Seat 4: CmngQmkKTp8tkl6GMRTl6w folded before Flop (didn't bet)
Seat 5: Th3FldXKQW6hWVVPahaoOQ folded before Flop (didn't bet)
Seat 6: ljemhp25Zg+nlA9DLCIiUw folded before Flop (didn't bet)
Seat 7: c/Dw/6HyqldTzIRodAIZmg collected ($3.45)
Seat 8: ShXPHWfjhfmAwLgDdm6bRQ (button) folded before Flop (didn't bet)
Seat 9: q6WfTUAD9mowIP63ASq2Dgz/khFDKGihQjwgoiKKPOegl blind) folded before Flop




PokerStars Game #59941684416:  Hold'em No Limit ($0.10/$0.25) - 2009/07/01 1:42:55 ET
Table 'fRxOyfaHXkWUDLv4eSxFew' 9-max Seat #6 is the button
Seat 1: 6RiVTYll/5D8zICp0MRpKw ($29.15 in chips) 
Seat 2: M2QO2DxB5Wawg2h8HSpnYA ($10.35 in chips) 
Seat 3: j4q3p0lesp63b1gZDwLBZw ($5 in chips) 
Seat 4: MtVtHDqIJTyUcXkRBBDIVA ($27.60 in chips) 
Seat 5: dmYlc+1cjwZMJ7wV+Z0rRg ($22.75 in chips) 
Seat 6: arxNSjreDRGFg13EAM2F1w ($27.05 in chips) 
Seat 7: 1/DuWziR8CXhWB71aPQd9Q ($17.90 in chips) 
Seat 8: 5n7e7I+px7c6CQmLpPbtsg ($4.65 in chips) 
Seat 9: H5Se03ZqSX7tbULXur2MAg ($33 in chips) 
1/DuWziR8CXhWB71aPQd9Q: posts small blind $0.10
5n7e7I+px7c6CQmLpPbtsg: posts big blind $0.25
*** HOLE CARDS ***
H5Se03ZqSX7tbULXur2MAg: folds 
6RiVTYll/5D8zICp0MRpKw: folds 
M2QO2DxB5Wawg2h8HSpnYA: folds 
j4q3p0lesp63b1gZDwLBZw: folds 
MtVtHDqIJTyUcXkRBBDIVA: folds 
dmYlc+1cjwZMJ7wV+Z0rRg: folds 
arxNSjreDRGFg13EAM2F1w: folds 
1/DuWziR8CXhWB71aPQd9Q: folds 
Uncalled bet ($0.15) returned to 5n7e7I+px7c6CQmLpPbtsg
5n7e7I+px7c6CQmLpPbtsg collected $0.20 from pot
5n7e7I+px7c6CQmLpPbtsg: doesn't show hand 
*** SUMMARY ***
Total pot $0.20 | Rake $0 
Seat 1: 6RiVTYll/5D8zICp0MRpKw folded before Flop (didn't bet)
Seat 2: M2QO2DxB5Wawg2h8HSpnYA folded before Flop (didn't bet)
Seat 3: j4q3p0lesp63b1gZDwLBZw folded before Flop (didn't bet)
Seat 4: MtVtHDqIJTyUcXkRBBDIVA folded before Flop (didn't bet)
Seat 5: dmYlc+1cjwZMJ7wV+Z0rRg folded before Flop (didn't bet)
Seat 6: arxNSjreDRGFg13EAM2F1w (button) folded before Flop (didn't bet)
Seat 7: 1/DuWziR8CXhWB71aPQd9Q (small blind) folded before Flop
Seat 8: 5n7e7I+px7c6CQmLpPbtsg (big blind) collected ($0.20)
Seat 9: H5Se03ZqSX7tbULXur2MAg folded before Flop (didn't bet)




PokerStars Game #59941684498:  Hold'em No Limit ($0.10/$0.25) - 2009/07/01 1:42:55 ET
Table 'luMgmRPIo47e7iXDlheIwA' 6-max Seat #1 is the button
Seat 1: EQ3WxdGe/KZrM6Lx4T02sg ($16.30 in chips) 
Seat 2: NhUN/JpAprdJeamFBgJH1w ($25 in chips) 
Seat 3: W6Y6au0wf7gRAlqJYgOezw ($20.85 in chips) 
Seat 4: xrf8tAXKQHG99HixCot1Iw ($24 in chips) 
Seat 5: cWc85bEzdRzpUMhRKm8pwQ ($43.75 in chips) 
Seat 6: qGHGf/553gQnDoklMRe3tg ($24.90 in chips) 
NhUN/JpAprdJeamFBgJH1w: posts small blind $0.10
W6Y6au0wf7gRAlqJYgOezw: posts big blind $0.25
*** HOLE CARDS ***
xrf8tAXKQHG99HixCot1Iw: folds 
cWc85bEzdRzpUMhRKm8pwQ: folds 
qGHGf/553gQnDoklMRe3tg: folds 
EQ3WxdGe/KZrM6Lx4T02sg: calls $0.25
W6Y6au0wf7gRAlqJYgOezw said, "big fish"
NhUN/JpAprdJeamFBgJH1w: calls $0.15
W6Y6au0wf7gRAlqJYgOezw: checks 
*** FLOP *** [Qc Tc 6c]
NhUN/JpAprdJeamFBgJH1w: checks 
W6Y6au0wf7gRAlqJYgOezw: bets $0.50
EQ3WxdGe/KZrM6Lx4T02sg: raises $0.50 to $1
NhUN/JpAprdJeamFBgJH1w: folds 
W6Y6au0wf7gRAlqJYgOezw: calls $0.50
*** TURN *** [Qc Tc 6c] [2c]
W6Y6au0wf7gRAlqJYgOezw: checks 
EQ3WxdGe/KZrM6Lx4T02sg: bets $1.25
W6Y6au0wf7gRAlqJYgOezw: calls $1.25
*** RIVER *** [Qc Tc 6c 2c] [7s]
W6Y6au0wf7gRAlqJYgOezw: checks 
EQ3WxdGe/KZrM6Lx4T02sg: checks 
*** SHOW DOWN ***
W6Y6au0wf7gRAlqJYgOezw: shows [5c 3h] (a flush, Queen high)
EQ3WxdGe/KZrM6Lx4T02sg: shows [3c 7c] (a flush, Queen high - Seven higher)
EQ3WxdGe/KZrM6Lx4T02sg collected $5 from pot
*** SUMMARY ***
Total pot $5.25 | Rake $0.25 
Board [Qc Tc 6c 2c 7s]
Seat 1: EQ3WxdGe/KZrM6Lx4T02sg (button) showed [3c 7c] and won ($5) with a flush, Queen high
Seat 2: NhUN/JpAprdJeamFBgJH1w (small blind) folded on the Flop
Seat 3: W6Y6au0wf7gRAlqJYgOezw (big blind) showed [5c 3h] and lost with a flush, Queen high
Seat 4: xrf8tAXKQHG99HixCot1Iw folded before Flop (didn't bet)
Seat 5: cWc85bEzdRzpUMhRKm8pwQ folded before Flop (didn't bet)
Seat 6: qGHGf/553gQnDoklMRe3tg folded before Flop (didn't bet)




PokerStars Game #59941684580:  Hold'em No Limit ($0.10/$0.25) - 2009/07/01 1:42:55 ET
Table 'g6ryG70feTw9nNm+XJLuXw' 6-max Seat #2 is the button
Seat 1: v+QfkGiuj9bgtuNoVnDO8w ($35.60 in chips) 
Seat 2: SxIIgwXYLkwd6m3wLyPTCw ($33.10 in chips) 
Seat 3: cezpHJ8FB07dj0xG+LhOvw ($25.10 in chips) 
Seat 4: GC/9yVD59DUCX7hUI7gcLw ($44.35 in chips) 
Seat 5: EE16Ua5b1HSsYej5zeXOlA ($25.35 in chips) 
Seat 6: tSR4329m40dZsN7YOpI9Kw ($36.60 in chips) 
cezpHJ8FB07dj0xG+LhOvw: posts small blind $0.10
GC/9yVD59DUCX7hUI7gcLw: posts big blind $0.25
*** HOLE CARDS ***
EE16Ua5b1HSsYej5zeXOlA: folds 
tSR4329m40dZsN7YOpI9Kw: folds 
v+QfkGiuj9bgtuNoVnDO8w: folds 
SxIIgwXYLkwd6m3wLyPTCw: folds 
cezpHJ8FB07dj0xG+LhOvw: folds 
Uncalled bet ($0.15) returned to GC/9yVD59DUCX7hUI7gcLw
GC/9yVD59DUCX7hUI7gcLw collected $0.20 from pot
*** SUMMARY ***
Total pot $0.20 | Rake $0 
Seat 1: v+QfkGiuj9bgtuNoVnDO8w folded before Flop (didn't bet)
Seat 2: SxIIgwXYLkwd6m3wLyPTCw (button) folded before Flop (didn't bet)
Seat 3: cezpHJ8FB07dj0xG+LhOvw (small blind) folded before Flop
Seat 4: GC/9yVD59DUCX7hUI7gcLw (big blind) collected ($0.20)
Seat 5: EE16Ua5b1HSsYej5zeXOlA folded before Flop (didn't bet)
Seat 6: tSR4329m40dZsN7YOpI9Kw folded before Flop (didn't bet)




PokerStars Game #59941684788:  Hold'em No Limit ($0.10/$0.25) - 2009/07/01 1:42:55 ET
Table 'tq5CvS0RUqGkuBK0XTzqqg' 6-max Seat #4 is the button
Seat 1: +ZlnqPoP3Hg4BIUxDfKd/A ($30.45 in chips) 
Seat 2: 2m6ZFAdj01UZd4WtEySXXQ ($4.75 in chips) 
Seat 3: PbMzPZIePKifKQZfKDkbIw ($48.50 in chips) 
Seat 4: UT5XpwOH1ipkOF7n1MqDJA ($24.65 in chips) 
Seat 5: qGHGf/553gQnDoklMRe3tg ($33.15 in chips) 
Seat 6: L3/N/gliETan8N5Gim5h4Q ($26.05 in chips) 
qGHGf/553gQnDoklMRe3tg: posts small blind $0.10
L3/N/gliETan8N5Gim5h4Q: posts big blind $0.25
*** HOLE CARDS ***
+ZlnqPoP3Hg4BIUxDfKd/A: folds 
2m6ZFAdj01UZd4WtEySXXQ: folds 
PbMzPZIePKifKQZfKDkbIw: raises $0.50 to $0.75
UT5XpwOH1ipkOF7n1MqDJA: calls $0.75
qGHGf/553gQnDoklMRe3tg: folds 
L3/N/gliETan8N5Gim5h4Q: folds 
*** FLOP *** [7c Td Qd]
PbMzPZIePKifKQZfKDkbIw: bets $1.25
UT5XpwOH1ipkOF7n1MqDJA: calls $1.25
*** TURN *** [7c Td Qd] [Tc]
PbMzPZIePKifKQZfKDkbIw: bets $3.25
UT5XpwOH1ipkOF7n1MqDJA: calls $3.25
*** RIVER *** [7c Td Qd Tc] [3c]
PbMzPZIePKifKQZfKDkbIw: bets $5
UT5XpwOH1ipkOF7n1MqDJA: folds 
Uncalled bet ($5) returned to PbMzPZIePKifKQZfKDkbIw
PbMzPZIePKifKQZfKDkbIw collected $10.35 from pot
*** SUMMARY ***
Total pot $10.85 | Rake $0.50 
Board [7c Td Qd Tc 3c]
Seat 1: +ZlnqPoP3Hg4BIUxDfKd/A folded before Flop (didn't bet)
Seat 2: 2m6ZFAdj01UZd4WtEySXXQ folded before Flop (didn't bet)
Seat 3: PbMzPZIePKifKQZfKDkbIw collected ($10.35)
Seat 4: UT5XpwOH1ipkOF7n1MqDJA (button) folded on the River
Seat 5: qGHGf/553gQnDoklMRe3tg (small blind) folded before Flop
Seat 6: L3/N/gliETan8N5Gim5h4Q (big blind) folded before Flop




PokerStars Game #59941685040:  Hold'em No Limit ($0.10/$0.25) - 2009/07/01 1:42:56 ET
Table '+198VWQSWBhYQOcizzuBkw' 6-max Seat #1 is the button
Seat 1: 34ttqW62uIRrqINCCmLcsw ($6.95 in chips) 
Seat 2: iauW7L/+7qzAuHow7CD75Q ($10.95 in chips) 
Seat 3: vw7gefupgmOJJN8lUemdWg ($24.40 in chips) 
Seat 4: TgDsTeCdLQt8kWbL00ByRA ($16.25 in chips) 
Seat 5: LtASJ9OlkqGrrUKGQlpGAw ($25.70 in chips) 
Seat 6: leEQ84f6wJYu5SB/vj27wg ($9.35 in chips) 
iauW7L/+7qzAuHow7CD75Q: posts small blind $0.10
vw7gefupgmOJJN8lUemdWg: posts big blind $0.25
*** HOLE CARDS ***
TgDsTeCdLQt8kWbL00ByRA: calls $0.25
LtASJ9OlkqGrrUKGQlpGAw: folds 
leEQ84f6wJYu5SB/vj27wg: folds 
34ttqW62uIRrqINCCmLcsw: folds 
iauW7L/+7qzAuHow7CD75Q said, "skill baby"
iauW7L/+7qzAuHow7CD75Q: calls $0.15
vw7gefupgmOJJN8lUemdWg: raises $0.75 to $1
34ttqW62uIRrqINCCmLcsw said, "luck."
iauW7L/+7qzAuHow7CD75Q said, "all skill"
TgDsTeCdLQt8kWbL00ByRA: calls $0.75
iauW7L/+7qzAuHow7CD75Q: folds 
*** FLOP *** [Ts 5s 6h]
vw7gefupgmOJJN8lUemdWg: bets $1.25
TgDsTeCdLQt8kWbL00ByRA: folds 
Uncalled bet ($1.25) returned to vw7gefupgmOJJN8lUemdWg
vw7gefupgmOJJN8lUemdWg collected $2.15 from pot
vw7gefupgmOJJN8lUemdWg: doesn't show hand 
*** SUMMARY ***
Total pot $2.25 | Rake $0.10 
Board [Ts 5s 6h]
Seat 1: 34ttqW62uIRrqINCCmLcsw (button) folded before Flop (didn't bet)
Seat 2: iauW7L/+7qzAuHow7CD75Q (small blind) folded before Flop
Seat 3: vw7gefupgmOJJN8lUemdWg (big blind) collected ($2.15)
Seat 4: TgDsTeCdLQt8kWbL00ByRA folded on the Flop
Seat 5: LtASJ9OlkqGrrUKGQlpGAw folded before Flop (didn't bet)
Seat 6: leEQ84f6wJYu5SB/vj27wg folded before Flop (didn't bet)




PokerStars Game #59941684954:  Hold'em No Limit ($0.10/$0.25) - 2009/07/01 1:42:56 ET
Table 'mF3KHGMaTpaBZbtBoyfTeg' 6-max Seat #1 is the button
Seat 1: 0HAB2GdCAM7p7V00xueAVQ ($24.35 in chips) 
Seat 2: 6qsh9pnysDKJNhfFhFmKRQ ($7.40 in chips) 
Seat 3: 9kUKGKkblnIx3m8rlVol6Q ($17.20 in chips) 
Seat 4: FYepjhAvF8ZdVCmqHIy+eQ ($25 in chips) 
Seat 5: 8ClCHtFXGNplITm+63KB+Q ($43.40 in chips) 
Seat 6: kG34n23qFQA3nzdOJTQ1dA ($27.75 in chips) 
6qsh9pnysDKJNhfFhFmKRQ: posts small blind $0.10
9kUKGKkblnIx3m8rlVol6Q: posts big blind $0.25
*** HOLE CARDS ***
FYepjhAvF8ZdVCmqHIy+eQ: folds 
8ClCHtFXGNplITm+63KB+Q: folds 
kG34n23qFQA3nzdOJTQ1dA: folds 
0HAB2GdCAM7p7V00xueAVQ: folds 
6qsh9pnysDKJNhfFhFmKRQ: raises $0.75 to $1
9kUKGKkblnIx3m8rlVol6Q: calls $0.75
*** FLOP *** [8d 7s 6h]
6qsh9pnysDKJNhfFhFmKRQ: bets $1
9kUKGKkblnIx3m8rlVol6Q: raises $2 to $3
6qsh9pnysDKJNhfFhFmKRQ: calls $2
*** TURN *** [8d 7s 6h] [7c]
6qsh9pnysDKJNhfFhFmKRQ: bets $3.40 and is all-in
9kUKGKkblnIx3m8rlVol6Q: calls $3.40
*** RIVER *** [8d 7s 6h 7c] [Jh]
*** SHOW DOWN ***
6qsh9pnysDKJNhfFhFmKRQ: shows [8c As] (two pair, Eights and Sevens)
9kUKGKkblnIx3m8rlVol6Q: mucks hand 
6qsh9pnysDKJNhfFhFmKRQ collected $14.10 from pot
*** SUMMARY ***
Total pot $14.80 | Rake $0.70 
Board [8d 7s 6h 7c Jh]
Seat 1: 0HAB2GdCAM7p7V00xueAVQ (button) folded before Flop (didn't bet)
Seat 2: 6qsh9pnysDKJNhfFhFmKRQ (small blind) showed [8c As] and won ($14.10) with two pair, Eights and Sevens
Seat 3: 9kUKGKkblnIx3m8rlVol6Q (big blind) mucked
Seat 4: FYepjhAvF8ZdVCmqHIy+eQ folded before Flop (didn't bet)
Seat 5: 8ClCHtFXGNplITm+63KB+Q folded before Flop (didn't bet)
Seat 6: kG34n23qFQA3nzdOJTQ1dA folded before Flop (didn't bet)




PokerStars Game #59941685020:  Hold'em No Limit ($0.10/$0.25) - 2009/07/01 1:42:56 ET
Table 'AHkg4ChqzcMauBx6Qvz8Nw' 6-max Seat #6 is the button
Seat 1: +RDf7SmUjY2kK0PzdBEYqg ($5.25 in chips) 
Seat 2: Vi0JMrTI2BGrPL7UIulJtA ($5.90 in chips) 
Seat 3: 9dToMv2GJLfi00HcpfMnIw ($24.65 in chips) 
Seat 4: Eznneya0vB6S+eXJdVleHA ($20.35 in chips) 
Seat 5: Bada343Si4xKu3fNXY99AA ($4.20 in chips) 
Seat 6: Hsvkc0/G2VV78oVmWYXecw ($5 in chips) 
+RDf7SmUjY2kK0PzdBEYqg: posts small blind $0.10
Vi0JMrTI2BGrPL7UIulJtA: posts big blind $0.25
*** HOLE CARDS ***
9dToMv2GJLfi00HcpfMnIw: folds 
Eznneya0vB6S+eXJdVleHA: folds 
Bada343Si4xKu3fNXY99AA: folds 
Hsvkc0/G2VV78oVmWYXecw: folds 
+RDf7SmUjY2kK0PzdBEYqg: calls $0.15
Vi0JMrTI2BGrPL7UIulJtA: checks 
*** FLOP *** [Ts Jh Jc]
+RDf7SmUjY2kK0PzdBEYqg: checks 
Vi0JMrTI2BGrPL7UIulJtA: checks 
*** TURN *** [Ts Jh Jc] [Kh]
+RDf7SmUjY2kK0PzdBEYqg: checks 
Vi0JMrTI2BGrPL7UIulJtA: checks 
*** RIVER *** [Ts Jh Jc Kh] [3c]
+RDf7SmUjY2kK0PzdBEYqg: bets $0.25
Vi0JMrTI2BGrPL7UIulJtA: folds 
Uncalled bet ($0.25) returned to +RDf7SmUjY2kK0PzdBEYqg
+RDf7SmUjY2kK0PzdBEYqg collected $0.50 from pot
*** SUMMARY ***
Total pot $0.50 | Rake $0 
Board [Ts Jh Jc Kh 3c]
Seat 1: +RDf7SmUjY2kK0PzdBEYqg (small blind) collected ($0.50)
Seat 2: Vi0JMrTI2BGrPL7UIulJtA (big blind) folded on the River
Seat 3: 9dToMv2GJLfi00HcpfMnIw folded before Flop (didn't bet)
Seat 4: Eznneya0vB6S+eXJdVleHA folded before Flop (didn't bet)
Seat 5: Bada343Si4xKu3fNXY99AA folded before Flop (didn't bet)
Seat 6: Hsvkc0/G2VV78oVmWYXecw (button) folded before Flop (didn't bet)




PokerStars Game #59941685314:  Hold'em No Limit ($0.10/$0.25) - 2009/07/01 1:42:56 ET
Table 'Xi38lWH8L2JHRAsKYVX8Qg' 6-max Seat #4 is the button
Seat 1: shP7DFAtX7gXcgMJX/OmRQ ($20.95 in chips) 
Seat 2: VOmI0x4dDPnTESZd5B4d1Q ($9.60 in chips) 
Seat 3: 6DwBRH+xZ12AAZmeAg+aXw ($30.25 in chips) 
Seat 4: kG34n23qFQA3nzdOJTQ1dA ($27.10 in chips) 
Seat 5: 79ID/ub1Pt/mDpCprVmOoA ($78.05 in chips) 
Seat 6: kyRaCIljYA6l33lSKQfNsg ($29.40 in chips) 
79ID/ub1Pt/mDpCprVmOoA: posts small blind $0.10
kyRaCIljYA6l33lSKQfNsg: posts big blind $0.25
*** HOLE CARDS ***
shP7DFAtX7gXcgMJX/OmRQ: folds 
VOmI0x4dDPnTESZd5B4d1Q: folds 
6DwBRH+xZ12AAZmeAg+aXw: folds 
kG34n23qFQA3nzdOJTQ1dA: folds 
79ID/ub1Pt/mDpCprVmOoA: folds 
Uncalled bet ($0.15) returned to kyRaCIljYA6l33lSKQfNsg
kyRaCIljYA6l33lSKQfNsg collected $0.20 from pot
*** SUMMARY ***
Total pot $0.20 | Rake $0 
Seat 1: shP7DFAtX7gXcgMJX/OmRQ folded before Flop (didn't bet)
Seat 2: VOmI0x4dDPnTESZd5B4d1Q folded before Flop (didn't bet)
Seat 3: 6DwBRH+xZ12AAZmeAg+aXw folded before Flop (didn't bet)
Seat 4: kG34n23qFQA3nzdOJTQ1dA (button) folded before Flop (didn't bet)
Seat 5: 79ID/ub1Pt/mDpCprVmOoA (small blind) folded before Flop
Seat 6: kyRaCIljYA6l33lSKQfNsg (big blind) collected ($0.20)




PokerStars Game #59941685042:  Hold'em No Limit ($0.10/$0.25) - 2009/07/01 1:42:56 ET
Table 'P2yJ+jwfNsBdF12fLKA6DQ' 9-max Seat #5 is the button
Seat 2: uQwmfH5LEVA5eyghJdyPUg ($11.40 in chips) 
Seat 4: 6NLAWFPZZfqlVkY8n9RULA ($14 in chips) 
Seat 5: B7VAFAMs/PYlYABlV+EkSA ($17 in chips) 
Seat 6: mUoFJKqCzIUABvOFbiINlQ ($13 in chips) 
Seat 7: yQc5nLaNmByxI15Jegu61w ($9.50 in chips) 
Seat 8: LMd3gq2uNfbWTfXTnSeQRw ($10.15 in chips) 
Seat 9: dN5zq7QdZCUe7NZFM6cECg ($18.75 in chips) 
mUoFJKqCzIUABvOFbiINlQ: posts small blind $0.10
yQc5nLaNmByxI15Jegu61w: posts big blind $0.25
8EbrQ/EvFWt2cr0GaU82gQ: sits out 
*** HOLE CARDS ***
LMd3gq2uNfbWTfXTnSeQRw: folds 
dN5zq7QdZCUe7NZFM6cECg: folds 
uQwmfH5LEVA5eyghJdyPUg: folds 
6NLAWFPZZfqlVkY8n9RULA: folds 
B7VAFAMs/PYlYABlV+EkSA: folds 
mUoFJKqCzIUABvOFbiINlQ: raises $0.75 to $1
yQc5nLaNmByxI15Jegu61w: calls $0.75
*** FLOP *** [Kc 5c 9d]
mUoFJKqCzIUABvOFbiINlQ: bets $12 and is all-in
yQc5nLaNmByxI15Jegu61w: calls $8.50 and is all-in
Uncalled bet ($3.50) returned to mUoFJKqCzIUABvOFbiINlQ
dN5zq7QdZCUe7NZFM6cECg said, "america makes it so the world goes around"
*** TURN *** [Kc 5c 9d] [9h]
*** RIVER *** [Kc 5c 9d 9h] [9c]
*** SHOW DOWN ***
mUoFJKqCzIUABvOFbiINlQ: shows [Ac Kh] (a full house, Nines full of Kings)
yQc5nLaNmByxI15Jegu61w: shows [Ks Jc] (a full house, Nines full of Kings)
mUoFJKqCzIUABvOFbiINlQ collected $9.05 from pot
yQc5nLaNmByxI15Jegu61w collected $9.05 from pot
*** SUMMARY ***
Total pot $19 | Rake $0.90 
Board [Kc 5c 9d 9h 9c]
Seat 2: uQwmfH5LEVA5eyghJdyPUg folded before Flop (didn't bet)
Seat 4: 6NLAWFPZZfqlVkY8n9RULA folded before Flop (didn't bet)
Seat 5: B7VAFAMs/PYlYABlV+EkSA (button) folded before Flop (didn't bet)
Seat 6: mUoFJKqCzIUABvOFbiINlQ (small blind) showed [Ac Kh] and won ($9.05) with a full house, Nines full of Kings
Seat 7: yQc5nLaNmByxI15Jegu61w (big blind) showed [Ks Jc] and won ($9.05) with a full house, Nines full of Kings
Seat 8: LMd3gq2uNfbWTfXTnSeQRw folded before Flop (didn't bet)
Seat 9: dN5zq7QdZCUe7NZFM6cECg folded before Flop (didn't bet)




PokerStars Game #59941685268:  Hold'em No Limit ($0.10/$0.25) - 2009/07/01 1:42:56 ET
Table 'D1Yq70l0nNCyMV6DA42p+Q' 9-max Seat #5 is the button
Seat 1: z5GxcHlYz/GSz6W2uFiTtg ($19.05 in chips) 
Seat 2: zgi+EUykT/pZQpoUG6+oEg ($4.30 in chips) 
Seat 3: 9lvO/qyU+xrU95Teu1fv0g ($5.50 in chips) 
Seat 4: VWUWpMLMj/Q1jRVpF7Aohw ($11.15 in chips) 
Seat 5: gehe91e0IyVT0QU/XBkEyg ($25 in chips) 
Seat 6: wGigCmBR/9XWkPpvYos3aQ ($33.30 in chips) 
Seat 7: Lqytncc1Dsgt654eEBp/uw ($27.55 in chips) 
Seat 8: zDrucyjVn5aeekNEc3cJrA ($24.35 in chips) 
Seat 9: h5wEs8qXrBqfLa9GjaSBzg ($24.25 in chips) 
wGigCmBR/9XWkPpvYos3aQ: posts small blind $0.10
Lqytncc1Dsgt654eEBp/uw: posts big blind $0.25
*** HOLE CARDS ***
zDrucyjVn5aeekNEc3cJrA has timed out
zDrucyjVn5aeekNEc3cJrA: folds 
zDrucyjVn5aeekNEc3cJrA is sitting out
h5wEs8qXrBqfLa9GjaSBzg: folds 
z5GxcHlYz/GSz6W2uFiTtg: folds 
z5GxcHlYz/GSz6W2uFiTtg is sitting out
zgi+EUykT/pZQpoUG6+oEg: folds 
9lvO/qyU+xrU95Teu1fv0g: folds 
VWUWpMLMj/Q1jRVpF7Aohw: raises $0.75 to $1
gehe91e0IyVT0QU/XBkEyg: folds 
wGigCmBR/9XWkPpvYos3aQ: folds 
Lqytncc1Dsgt654eEBp/uw: calls $0.75
*** FLOP *** [9h 8d 6c]
Lqytncc1Dsgt654eEBp/uw: checks 
VWUWpMLMj/Q1jRVpF7Aohw: bets $1.25
Lqytncc1Dsgt654eEBp/uw: calls $1.25
*** TURN *** [9h 8d 6c] [4h]
Lqytncc1Dsgt654eEBp/uw: checks 
VWUWpMLMj/Q1jRVpF7Aohw: checks 
*** RIVER *** [9h 8d 6c 4h] [3h]
Lqytncc1Dsgt654eEBp/uw: checks 
VWUWpMLMj/Q1jRVpF7Aohw: checks 
*** SHOW DOWN ***
Lqytncc1Dsgt654eEBp/uw: shows [5c 5h] (a pair of Fives)
VWUWpMLMj/Q1jRVpF7Aohw: mucks hand 
Lqytncc1Dsgt654eEBp/uw collected $4.40 from pot
*** SUMMARY ***
Total pot $4.60 | Rake $0.20 
Board [9h 8d 6c 4h 3h]
Seat 1: z5GxcHlYz/GSz6W2uFiTtg folded before Flop (didn't bet)
Seat 2: zgi+EUykT/pZQpoUG6+oEg folded before Flop (didn't bet)
Seat 3: 9lvO/qyU+xrU95Teu1fv0g folded before Flop (didn't bet)
Seat 4: VWUWpMLMj/Q1jRVpF7Aohw mucked
Seat 5: gehe91e0IyVT0QU/XBkEyg (button) folded before Flop (didn't bet)
Seat 6: wGigCmBR/9XWkPpvYos3aQ (small blind) folded before Flop
Seat 7: Lqytncc1Dsgt654eEBp/uw (big blind) showed [5c 5h] and won ($4.40) with a pair of Fives
Seat 8: zDrucyjVn5aeekNEc3cJrA folded before Flop (didn't bet)
Seat 9: h5wEs8qXrBqfLa9GjaSBzg folded before Flop (didn't bet)




PokerStars Game #59941685024:  Hold'em No Limit ($0.10/$0.25) - 2009/07/01 1:42:56 ET
Table 'IrJPyZ3JW2iIa+krdoSbJQ' 9-max Seat #3 is the button
Seat 1: Bb42QRQMhg5/Y0vHP8/2Xw ($26.25 in chips) 
Seat 2: X78b5v/uhqeXXoAijbw/yg ($26.20 in chips) 
Seat 3: CT7Xj/V/O5rBlhtt+RZeFQ ($25 in chips) 
Seat 4: bXpVeaSTPBFSPJmeXxO7nw ($4.75 in chips) 
Seat 5: tLcDklc2rBORNfixyRfVfw ($28.40 in chips) 
Seat 6: +sbyWwIcFp9kP0bDtMegfQ ($24.95 in chips) 
Seat 7: k7BTUnQVz23IhJmLKrwx8A ($18.20 in chips) 
Seat 8: zZqOSFjPK4R4cwx0dONetw ($20.65 in chips) 
Seat 9: Mh2r9hTeTEDnh19sRZtW3g ($5.80 in chips) 
bXpVeaSTPBFSPJmeXxO7nw: posts small blind $0.10
tLcDklc2rBORNfixyRfVfw: posts big blind $0.25
*** HOLE CARDS ***
+sbyWwIcFp9kP0bDtMegfQ: folds 
k7BTUnQVz23IhJmLKrwx8A: folds 
zZqOSFjPK4R4cwx0dONetw: folds 
Mh2r9hTeTEDnh19sRZtW3g: folds 
Bb42QRQMhg5/Y0vHP8/2Xw: folds 
X78b5v/uhqeXXoAijbw/yg: folds 
CT7Xj/V/O5rBlhtt+RZeFQ: folds 
bXpVeaSTPBFSPJmeXxO7nw: folds 
Uncalled bet ($0.15) returned to tLcDklc2rBORNfixyRfVfw
tLcDklc2rBORNfixyRfVfw collected $0.20 from pot
tLcDklc2rBORNfixyRfVfw: doesn't show hand 
*** SUMMARY ***
Total pot $0.20 | Rake $0 
Seat 1: Bb42QRQMhg5/Y0vHP8/2Xw folded before Flop (didn't bet)
Seat 2: X78b5v/uhqeXXoAijbw/yg folded before Flop (didn't bet)
Seat 3: CT7Xj/V/O5rBlhtt+RZeFQ (button) folded before Flop (didn't bet)
Seat 4: bXpVeaSTPBFSPJmeXxO7nw (small blind) folded before Flop
Seat 5: tLcDklc2rBORNfixyRfVfw (big blind) collected ($0.20)
Seat 6: +sbyWwIcFp9kP0bDtMegfQ folded before Flop (didn't bet)
Seat 7: k7BTUnQVz23IhJmLKrwx8A folded before Flop (didn't bet)
Seat 8: zZqOSFjPK4R4cwx0dONetw folded before Flop (didn't bet)
Seat 9: Mh2r9hTeTEDnh19sRZtW3g folded before Flop (didn't bet)




PokerStars Game #59941685180:  Hold'em No Limit ($0.10/$0.25) - 2009/07/01 1:42:56 ET
Table '+VTTYgQLH1awDHk+IAxqGg' 9-max Seat #8 is the button
Seat 1: arxNSjreDRGFg13EAM2F1w ($25.75 in chips) 
Seat 2: 2wcFsZsqEP5w1StUTVzJCg ($5.40 in chips) 
Seat 3: AiXn/9o1EwOPZUHujnh/bA ($13.15 in chips) 
Seat 4: gE5rN2TDY1aXcZn/TOPeZw ($10.90 in chips) 
Seat 5: sD+TKtt36XiiN6jqHiLwDA ($25.15 in chips) 
Seat 7: ljemhp25Zg+nlA9DLCIiUw ($25 in chips) 
Seat 8: 10vzP4r6ldwGLbYHKd9www ($16.85 in chips) 
Seat 9: S7Ki0P+0AIGPuIfGJjW0gg ($61.25 in chips) 
S7Ki0P+0AIGPuIfGJjW0gg: posts small blind $0.10
arxNSjreDRGFg13EAM2F1w: posts big blind $0.25
*** HOLE CARDS ***
2wcFsZsqEP5w1StUTVzJCg: calls $0.25
AiXn/9o1EwOPZUHujnh/bA: calls $0.25
gE5rN2TDY1aXcZn/TOPeZw: calls $0.25
sD+TKtt36XiiN6jqHiLwDA: folds 
ljemhp25Zg+nlA9DLCIiUw: folds 
10vzP4r6ldwGLbYHKd9www: calls $0.25
S7Ki0P+0AIGPuIfGJjW0gg: calls $0.15
arxNSjreDRGFg13EAM2F1w: raises $1.50 to $1.75
2wcFsZsqEP5w1StUTVzJCg: folds 
AiXn/9o1EwOPZUHujnh/bA: folds 
gE5rN2TDY1aXcZn/TOPeZw: folds 
10vzP4r6ldwGLbYHKd9www: folds 
S7Ki0P+0AIGPuIfGJjW0gg: folds 
Uncalled bet ($1.50) returned to arxNSjreDRGFg13EAM2F1w
arxNSjreDRGFg13EAM2F1w collected $1.50 from pot
arxNSjreDRGFg13EAM2F1w: doesn't show hand 
*** SUMMARY ***
Total pot $1.50 | Rake $0 
Seat 1: arxNSjreDRGFg13EAM2F1w (big blind) collected ($1.50)
Seat 2: 2wcFsZsqEP5w1StUTVzJCg folded before Flop
Seat 3: AiXn/9o1EwOPZUHujnh/bA folded before Flop
Seat 4: gE5rN2TDY1aXcZn/TOPeZw folded before Flop
Seat 5: sD+TKtt36XiiN6jqHiLwDA folded before Flop (didn't bet)
Seat 7: ljemhp25Zg+nlA9DLCIiUw folded before Flop (didn't bet)
Seat 8: 10vzP4r6ldwGLbYHKd9www (button) folded before Flop
Seat 9: S7Ki0P+0AIGPuIfGJjW0gg (small blind) folded before Flop




PokerStars Game #59941685036:  Hold'em No Limit ($0.10/$0.25) - 2009/07/01 1:42:56 ET
Table '8Z6T3ssCpo3VV849U4RgBw' 9-max Seat #8 is the button
Seat 1: Z9W7+g1WMhhZDi7DwGbCFA ($5 in chips) 
Seat 2: SpiiQQAzy4MUgV3I5W8giw ($25.35 in chips) 
Seat 3: tLcDklc2rBORNfixyRfVfw ($41.50 in chips) 
Seat 4: RCqMONFrSPSArZh2Jsar/w ($18.90 in chips) 
Seat 6: sGFnnRCa1YAHAUmWgsW6Qg ($9.15 in chips) 
Seat 7: oLa/tXLfSLLB28mcLGrxcg ($24.05 in chips) 
Seat 8: PdIasPkzm2sqZnN41ZRXOg ($5.25 in chips) 
Seat 9: HDDm1BkZtdsRyw2DJdqq6A ($21.55 in chips) 
HDDm1BkZtdsRyw2DJdqq6A: posts small blind $0.10
Z9W7+g1WMhhZDi7DwGbCFA: posts big blind $0.25
*** HOLE CARDS ***
SpiiQQAzy4MUgV3I5W8giw: folds 
tLcDklc2rBORNfixyRfVfw: folds 
RCqMONFrSPSArZh2Jsar/w: folds 
sGFnnRCa1YAHAUmWgsW6Qg: calls $0.25
oLa/tXLfSLLB28mcLGrxcg: folds 
PdIasPkzm2sqZnN41ZRXOg: folds 
HDDm1BkZtdsRyw2DJdqq6A: folds 
Z9W7+g1WMhhZDi7DwGbCFA: checks 
*** FLOP *** [Jc 4s 3c]
Z9W7+g1WMhhZDi7DwGbCFA: bets $0.50
sGFnnRCa1YAHAUmWgsW6Qg: raises $0.50 to $1
Z9W7+g1WMhhZDi7DwGbCFA: raises $3.75 to $4.75 and is all-in
sGFnnRCa1YAHAUmWgsW6Qg: folds 
Uncalled bet ($3.75) returned to Z9W7+g1WMhhZDi7DwGbCFA
Z9W7+g1WMhhZDi7DwGbCFA collected $2.50 from pot
Z9W7+g1WMhhZDi7DwGbCFA: doesn't show hand 
*** SUMMARY ***
Total pot $2.60 | Rake $0.10 
Board [Jc 4s 3c]
Seat 1: Z9W7+g1WMhhZDi7DwGbCFA (big blind) collected ($2.50)
Seat 2: SpiiQQAzy4MUgV3I5W8giw folded before Flop (didn't bet)
Seat 3: tLcDklc2rBORNfixyRfVfw folded before Flop (didn't bet)
Seat 4: RCqMONFrSPSArZh2Jsar/w folded before Flop (didn't bet)
Seat 6: sGFnnRCa1YAHAUmWgsW6Qg folded on the Flop
Seat 7: oLa/tXLfSLLB28mcLGrxcg folded before Flop (didn't bet)
Seat 8: PdIasPkzm2sqZnN41ZRXOg (button) folded before Flop (didn't bet)
Seat 9: HDDm1BkZtdsRyw2DJdqq6A (small blind) folded before Flop




PokerStars Game #59941685208:  Hold'em No Limit ($0.10/$0.25) - 2009/07/01 1:42:56 ET
Table '2clPgY3+dETPD/8zjXZdFw' 6-max Seat #1 is the button
Seat 1: 4WFKzsjLSGnvHbVxKabsvQ ($31.05 in chips) 
Seat 2: cWc85bEzdRzpUMhRKm8pwQ ($25.45 in chips) 
Seat 3: SFmT9ZsVopnukjvAzrxTRg ($25 in chips) 
Seat 4: ljjhtb6FVPTx9AT9HNdtqg ($16.30 in chips) 
Seat 5: LJI7A1YgDM7hgh7o56+ReQ ($25.60 in chips) 
cWc85bEzdRzpUMhRKm8pwQ: posts small blind $0.10
SFmT9ZsVopnukjvAzrxTRg: posts big blind $0.25
*** HOLE CARDS ***
ljjhtb6FVPTx9AT9HNdtqg: folds 
LJI7A1YgDM7hgh7o56+ReQ: folds 
4WFKzsjLSGnvHbVxKabsvQ: folds 
cWc85bEzdRzpUMhRKm8pwQ: raises $0.75 to $1
SFmT9ZsVopnukjvAzrxTRg: folds 
Uncalled bet ($0.75) returned to cWc85bEzdRzpUMhRKm8pwQ
cWc85bEzdRzpUMhRKm8pwQ collected $0.50 from pot
*** SUMMARY ***
Total pot $0.50 | Rake $0 
Seat 1: 4WFKzsjLSGnvHbVxKabsvQ (button) folded before Flop (didn't bet)
Seat 2: cWc85bEzdRzpUMhRKm8pwQ (small blind) collected ($0.50)
Seat 3: SFmT9ZsVopnukjvAzrxTRg (big blind) folded before Flop
Seat 4: ljjhtb6FVPTx9AT9HNdtqg folded before Flop (didn't bet)
Seat 5: LJI7A1YgDM7hgh7o56+ReQ folded before Flop (didn't bet)




PokerStars Game #59941684948:  Hold'em No Limit ($0.10/$0.25) - 2009/07/01 1:42:56 ET
Table 'zW+7jPbOLCvlPu+dUGY5WQ' 6-max Seat #1 is the button
Seat 1: eL3+wCBjFGfQ5FMdIZihwA ($26.25 in chips) 
Seat 2: cEMJmfAUQZmMChZe6aacKw ($8.70 in chips) 
Seat 4: i48129QFpEQQ+UN4aNtmww ($10.60 in chips) 
Seat 6: qGHGf/553gQnDoklMRe3tg ($25 in chips) 
cEMJmfAUQZmMChZe6aacKw: posts small blind $0.10
2G0C7dp4wlPpE21FHjjElQ: is sitting out 
i48129QFpEQQ+UN4aNtmww: posts big blind $0.25
*** HOLE CARDS ***
Tallarico leaves the table
qGHGf/553gQnDoklMRe3tg: raises $0.75 to $1
eL3+wCBjFGfQ5FMdIZihwA: folds 
cEMJmfAUQZmMChZe6aacKw: folds 
i48129QFpEQQ+UN4aNtmww: calls $0.75
*** FLOP *** [Tc 9h 9d]
i48129QFpEQQ+UN4aNtmww: checks 
qGHGf/553gQnDoklMRe3tg: bets $1.50
i48129QFpEQQ+UN4aNtmww: calls $1.50
*** TURN *** [Tc 9h 9d] [Kd]
i48129QFpEQQ+UN4aNtmww: bets $1.50
qGHGf/553gQnDoklMRe3tg: calls $1.50
*** RIVER *** [Tc 9h 9d Kd] [2s]
i48129QFpEQQ+UN4aNtmww: bets $6.60 and is all-in
qGHGf/553gQnDoklMRe3tg: calls $6.60
*** SHOW DOWN ***
i48129QFpEQQ+UN4aNtmww: shows [Qh 9s] (three of a kind, Nines)
qGHGf/553gQnDoklMRe3tg: mucks hand 
i48129QFpEQQ+UN4aNtmww collected $20.30 from pot
*** SUMMARY ***
Total pot $21.30 | Rake $1 
Board [Tc 9h 9d Kd 2s]
Seat 1: eL3+wCBjFGfQ5FMdIZihwA (button) folded before Flop (didn't bet)
Seat 2: cEMJmfAUQZmMChZe6aacKw (small blind) folded before Flop
Seat 4: i48129QFpEQQ+UN4aNtmww (big blind) showed [Qh 9s] and won ($20.30) with three of a kind, Nines
Seat 6: qGHGf/553gQnDoklMRe3tg mucked




PokerStars Game #59941685090:  Hold'em No Limit ($0.10/$0.25) - 2009/07/01 1:42:56 ET
Table '2VkNDXXsBj4bSZw/uK5atw' 6-max Seat #1 is the button
Seat 1: xrf8tAXKQHG99HixCot1Iw ($19.60 in chips) 
Seat 2: v6mkGzCBCCXcgWQNSYVtKg ($8.75 in chips) 
Seat 5: 7f0OkhFEOf3T+rVOFHRLnw ($22.05 in chips) 
Seat 6: n6UPMnVR4v8LFP0rWP73Fg ($9.85 in chips) 
v6mkGzCBCCXcgWQNSYVtKg: posts small blind $0.10
8D0jr3B4e++Q/cTSnpHdzg leaves the table
7f0OkhFEOf3T+rVOFHRLnw: posts big blind $0.25
*** HOLE CARDS ***
n6UPMnVR4v8LFP0rWP73Fg: folds 
xrf8tAXKQHG99HixCot1Iw: raises $0.50 to $0.75
v6mkGzCBCCXcgWQNSYVtKg: calls $0.65
7f0OkhFEOf3T+rVOFHRLnw: calls $0.50
*** FLOP *** [3c 2h Qh]
v6mkGzCBCCXcgWQNSYVtKg: checks 
7f0OkhFEOf3T+rVOFHRLnw: checks 
xrf8tAXKQHG99HixCot1Iw: bets $1.25
v6mkGzCBCCXcgWQNSYVtKg: calls $1.25
7f0OkhFEOf3T+rVOFHRLnw: folds 
*** TURN *** [3c 2h Qh] [Qc]
v6mkGzCBCCXcgWQNSYVtKg: checks 
xrf8tAXKQHG99HixCot1Iw: bets $2.25
v6mkGzCBCCXcgWQNSYVtKg: calls $2.25
*** RIVER *** [3c 2h Qh Qc] [Th]
v6mkGzCBCCXcgWQNSYVtKg: bets $4.50 and is all-in
xrf8tAXKQHG99HixCot1Iw: folds 
Uncalled bet ($4.50) returned to v6mkGzCBCCXcgWQNSYVtKg
v6mkGzCBCCXcgWQNSYVtKg collected $8.80 from pot
*** SUMMARY ***
Total pot $9.25 | Rake $0.45 
Board [3c 2h Qh Qc Th]
Seat 1: xrf8tAXKQHG99HixCot1Iw (button) folded on the River
Seat 2: v6mkGzCBCCXcgWQNSYVtKg (small blind) collected ($8.80)
Seat 5: 7f0OkhFEOf3T+rVOFHRLnw (big blind) folded on the Flop
Seat 6: n6UPMnVR4v8LFP0rWP73Fg folded before Flop (didn't bet)




PokerStars Game #59941685682:  Hold'em No Limit ($0.10/$0.25) - 2009/07/01 1:42:57 ET
Table 'nQC9LRg01NEuKFHF1nrDEw0XPo7K54oZIfG0xlNAcDRw-max Seat #3 is the button
Seat 1: qf+LMbROj8/qY878wkFHbQ ($14.40 in chips) 
Seat 2: ZhV6dUX9NQhT4zf7t+ZLJg ($25 in chips) 
Seat 3: 6+g0Lb6vfRDZkElV8ieHyQ ($23.35 in chips) 
Seat 5: kG34n23qFQA3nzdOJTQ1dA ($29.40 in chips) 
Seat 6: xQVFeVUDopz+akuEo2wXpQ ($54.50 in chips) 
kG34n23qFQA3nzdOJTQ1dA: posts small blind $0.10
xQVFeVUDopz+akuEo2wXpQ: posts big blind $0.25
ZhV6dUX9NQhT4zf7t+ZLJg: posts big blind $0.25
*** HOLE CARDS ***
qf+LMbROj8/qY878wkFHbQ: folds 
ZhV6dUX9NQhT4zf7t+ZLJg: checks 
6+g0Lb6vfRDZkElV8ieHyQ: raises $0.25 to $0.50
kG34n23qFQA3nzdOJTQ1dA: folds 
xQVFeVUDopz+akuEo2wXpQ: calls $0.25
ZhV6dUX9NQhT4zf7t+ZLJg: folds 
*** FLOP *** [9s 4h Tc]
xQVFeVUDopz+akuEo2wXpQ: bets $0.25
6+g0Lb6vfRDZkElV8ieHyQ: raises $0.25 to $0.50
xQVFeVUDopz+akuEo2wXpQ: calls $0.25
*** TURN *** [9s 4h Tc] [Ah]
xQVFeVUDopz+akuEo2wXpQ: checks 
6+g0Lb6vfRDZkElV8ieHyQ: bets $0.25
xQVFeVUDopz+akuEo2wXpQ: calls $0.25
*** RIVER *** [9s 4h Tc Ah] [8h]
xQVFeVUDopz+akuEo2wXpQ: checks 
6+g0Lb6vfRDZkElV8ieHyQ: bets $1.75
xQVFeVUDopz+akuEo2wXpQ: folds 
Uncalled bet ($1.75) returned to 6+g0Lb6vfRDZkElV8ieHyQ
6+g0Lb6vfRDZkElV8ieHyQ collected $2.75 from pot
*** SUMMARY ***
Total pot $2.85 | Rake $0.10 
Board [9s 4h Tc Ah 8h]
Seat 1: qf+LMbROj8/qY878wkFHbQ folded before Flop (didn't bet)
Seat 2: ZhV6dUX9NQhT4zf7t+ZLJg folded before Flop
Seat 3: 6+g0Lb6vfRDZkElV8ieHyQ (button) collected ($2.75)
Seat 5: kG34n23qFQA3nzdOJTQ1dA (small blind) folded before Flop
Seat 6: xQVFeVUDopz+akuEo2wXpQ (big blind) folded on the River




PokerStars Game #59941685500:  Hold'em No Limit ($0.10/$0.25) - 2009/07/01 1:42:57 ET
Table '+giHa6FUL6U5/AZnCJEGvQ' 9-max Seat #4 is the button
Seat 4: 10f7J+bM02ZfDHx0PgkNSg ($14.75 in chips) 
Seat 6: GTMnTen6sQSoCpS9sggLbg ($25 in chips) 
10f7J+bM02ZfDHx0PgkNSg: posts small blind $0.10
GTMnTen6sQSoCpS9sggLbg: posts big blind $0.25
*** HOLE CARDS ***
10f7J+bM02ZfDHx0PgkNSg: calls $0.15
GTMnTen6sQSoCpS9sggLbg: checks 
*** FLOP *** [9h 9s Tc]
GTMnTen6sQSoCpS9sggLbg: checks 
10f7J+bM02ZfDHx0PgkNSg: checks 
*** TURN *** [9h 9s Tc] [Ks]
GTMnTen6sQSoCpS9sggLbg: checks 
10f7J+bM02ZfDHx0PgkNSg: checks 
*** RIVER *** [9h 9s Tc Ks] [7d]
GTMnTen6sQSoCpS9sggLbg: bets $0.50
10f7J+bM02ZfDHx0PgkNSg: calls $0.50
*** SHOW DOWN ***
GTMnTen6sQSoCpS9sggLbg: shows [Qd Kd] (two pair, Kings and Nines)
10f7J+bM02ZfDHx0PgkNSg: mucks hand 
GTMnTen6sQSoCpS9sggLbg collected $1.45 from pot
*** SUMMARY ***
Total pot $1.50 | Rake $0.05 
Board [9h 9s Tc Ks 7d]
Seat 4: 10f7J+bM02ZfDHx0PgkNSg (button) (small blind) mucked
Seat 6: GTMnTen6sQSoCpS9sggLbg (big blind) showed [Qd Kd] and won ($1.45) with two pair, Kings and Nines




PokerStars Game #59941685582:  Hold'em No Limit ($0.10/$0.25) - 2009/07/01 1:42:57 ET
Table 'XX2OuOsa8/8AC+/mR/Az6g' 9-max Seat #3 is the button
Seat 1: 56S3mA6Zs3pGR+0p0vUCtg ($26.15 in chips) 
Seat 2: Bb42QRQMhg5/Y0vHP8/2Xw ($27.10 in chips) 
Seat 3: oLa/tXLfSLLB28mcLGrxcg ($24.25 in chips) 
Seat 4: 52uIvr1a/mxEYD1W0ESvdQ ($25.20 in chips) 
Seat 5: SpiiQQAzy4MUgV3I5W8giw ($21.50 in chips) 
Seat 8: qwr38jl5txoR36M7G5qi4A ($10.35 in chips) 
Seat 9: V6p0jQ/RhUsqpHLmXvEX4Q ($11.15 in chips) 
52uIvr1a/mxEYD1W0ESvdQ: posts small blind $0.10
SpiiQQAzy4MUgV3I5W8giw: posts big blind $0.25
RCqMONFrSPSArZh2Jsar/w: sits out 
*** HOLE CARDS ***
qwr38jl5txoR36M7G5qi4A: folds 
V6p0jQ/RhUsqpHLmXvEX4Q: folds 
56S3mA6Zs3pGR+0p0vUCtg: folds 
Bb42QRQMhg5/Y0vHP8/2Xw: folds 
oLa/tXLfSLLB28mcLGrxcg: raises $0.75 to $1
52uIvr1a/mxEYD1W0ESvdQ: folds 
SpiiQQAzy4MUgV3I5W8giw: folds 
Uncalled bet ($0.75) returned to oLa/tXLfSLLB28mcLGrxcg
oLa/tXLfSLLB28mcLGrxcg collected $0.60 from pot
oLa/tXLfSLLB28mcLGrxcg: doesn't show hand 
*** SUMMARY ***
Total pot $0.60 | Rake $0 
Seat 1: 56S3mA6Zs3pGR+0p0vUCtg folded before Flop (didn't bet)
Seat 2: Bb42QRQMhg5/Y0vHP8/2Xw folded before Flop (didn't bet)
Seat 3: oLa/tXLfSLLB28mcLGrxcg (button) collected ($0.60)
Seat 4: 52uIvr1a/mxEYD1W0ESvdQ (small blind) folded before Flop
Seat 5: SpiiQQAzy4MUgV3I5W8giw (big blind) folded before Flop
Seat 8: qwr38jl5txoR36M7G5qi4A folded before Flop (didn't bet)
Seat 9: V6p0jQ/RhUsqpHLmXvEX4Q folded before Flop (didn't bet)




PokerStars Game #59941685620:  Hold'em No Limit ($0.10/$0.25) - 2009/07/01 1:42:57 ET
Table '7/qMNloI0nSXWiX5Y1watA' 9-max Seat #3 is the button
Seat 1: /LyhaB3V6jkgOfXORidqRQ ($7.10 in chips) 
Seat 2: wGigCmBR/9XWkPpvYos3aQ ($26.20 in chips) 
Seat 3: W2YYHvqjaEpRrO7stZkClQ ($4.35 in chips) 
Seat 6: Y3DZ6qQlLeBhixDj4M9vmg ($17.60 in chips) 
Seat 7: z5GxcHlYz/GSz6W2uFiTtg ($20.55 in chips) 
Seat 8: ljemhp25Zg+nlA9DLCIiUw ($24 in chips) 
Seat 9: dmYlc+1cjwZMJ7wV+Z0rRg ($25.75 in chips) 
K0LdhPeU31rviEPo6Sv3TA will be allowed to play after the button
Y3DZ6qQlLeBhixDj4M9vmg: posts small blind $0.10
z5GxcHlYz/GSz6W2uFiTtg: posts big blind $0.25
*** HOLE CARDS ***
ljemhp25Zg+nlA9DLCIiUw: calls $0.25
dmYlc+1cjwZMJ7wV+Z0rRg: raises $0.75 to $1
/LyhaB3V6jkgOfXORidqRQ: folds 
wGigCmBR/9XWkPpvYos3aQ: folds 
W2YYHvqjaEpRrO7stZkClQ: folds 
Y3DZ6qQlLeBhixDj4M9vmg: folds 
z5GxcHlYz/GSz6W2uFiTtg: folds 
z5GxcHlYz/GSz6W2uFiTtg is sitting out
ljemhp25Zg+nlA9DLCIiUw: folds 
Uncalled bet ($0.75) returned to dmYlc+1cjwZMJ7wV+Z0rRg
dmYlc+1cjwZMJ7wV+Z0rRg collected $0.85 from pot
dmYlc+1cjwZMJ7wV+Z0rRg: doesn't show hand 
*** SUMMARY ***
Total pot $0.85 | Rake $0 
Seat 1: /LyhaB3V6jkgOfXORidqRQ folded before Flop (didn't bet)
Seat 2: wGigCmBR/9XWkPpvYos3aQ folded before Flop (didn't bet)
Seat 3: W2YYHvqjaEpRrO7stZkClQ (button) folded before Flop (didn't bet)
Seat 6: Y3DZ6qQlLeBhixDj4M9vmg (small blind) folded before Flop
Seat 7: z5GxcHlYz/GSz6W2uFiTtg (big blind) folded before Flop
Seat 8: ljemhp25Zg+nlA9DLCIiUw folded before Flop
Seat 9: dmYlc+1cjwZMJ7wV+Z0rRg collected ($0.85)




PokerStars Game #59941685816:  Hold'em No Limit ($0.10/$0.25) - 2009/07/01 1:42:57 ET
Table '6aL2C8IFwHHr6SG6RgXaow' 9-max Seat #6 is the button
Seat 3: aCVg6cCxQcqClhB9nq/p1w ($12.35 in chips) 
Seat 4: BT6Oal0iO4P6kDuT7HFQDw ($19.10 in chips) 
Seat 5: wre31HfyzQGpIvID1istxw ($21.20 in chips) 
Seat 6: gehe91e0IyVT0QU/XBkEyg ($27.10 in chips) 
Seat 7: QJxYAPJ6uPZZcpdN+RvWcQ ($25 in chips) 
Seat 8: rQhYIYXSyH/IivYM1dlV5A ($21.65 in chips) 
Seat 9: CgIo2ItZqi4o3ayVG6HanQ ($24.35 in chips) 
QJxYAPJ6uPZZcpdN+RvWcQ: posts small blind $0.10
rQhYIYXSyH/IivYM1dlV5A: posts big blind $0.25
bXpVeaSTPBFSPJmeXxO7nw: sits out 
*** HOLE CARDS ***
CgIo2ItZqi4o3ayVG6HanQ: folds 
aCVg6cCxQcqClhB9nq/p1w: raises $0.25 to $0.50
BT6Oal0iO4P6kDuT7HFQDw: folds 
wre31HfyzQGpIvID1istxw: folds 
gehe91e0IyVT0QU/XBkEyg: folds 
QJxYAPJ6uPZZcpdN+RvWcQ: folds 
rQhYIYXSyH/IivYM1dlV5A: calls $0.25
*** FLOP *** [3c 8c 3d]
rQhYIYXSyH/IivYM1dlV5A: checks 
aCVg6cCxQcqClhB9nq/p1w: bets $0.25
rQhYIYXSyH/IivYM1dlV5A: folds 
Uncalled bet ($0.25) returned to aCVg6cCxQcqClhB9nq/p1w
aCVg6cCxQcqClhB9nq/p1w collected $1.05 from pot
*** SUMMARY ***
Total pot $1.10 | Rake $0.05 
Board [3c 8c 3d]
Seat 3: aCVg6cCxQcqClhB9nq/p1w collected ($1.05)
Seat 4: BT6Oal0iO4P6kDuT7HFQDw folded before Flop (didn't bet)
Seat 5: wre31HfyzQGpIvID1istxw folded before Flop (didn't bet)
Seat 6: gehe91e0IyVT0QU/XBkEyg (button) folded before Flop (didn't bet)
Seat 7: QJxYAPJ6uPZZcpdN+RvWcQ (small blind) folded before Flop
Seat 8: rQhYIYXSyH/IivYM1dlV5A (big blind) folded on the Flop
Seat 9: CgIo2ItZqi4o3ayVG6HanQ folded before Flop (didn't bet)




PokerStars Game #59941685580:  Hold'em No Limit ($0.10/$0.25) - 2009/07/01 1:42:57 ET
Table 'rhQuIjJo0UQ7RRUlF9umHg' 6-max Seat #3 is the button
Seat 1: 5O3Hj9Qg0SqOyKEXoLpjPg ($123.85 in chips) 
Seat 2: Ew/TYPQIsbQ2X8nm5iAJBg ($25 in chips) 
Seat 3: if4dh6jhJXeN3/qd3qCp9g ($27.40 in chips) 
Seat 4: buyjetgNT1McXtdaP4zynA ($43.35 in chips) 
Seat 5: dOX4wnYV2sEqvDbF+8KSCw ($49.50 in chips) 
Seat 6: /gJNBeCkWL4o85/jvlZ4BA ($52.40 in chips) 
buyjetgNT1McXtdaP4zynA: posts small blind $0.10
dOX4wnYV2sEqvDbF+8KSCw: posts big blind $0.25
*** HOLE CARDS ***
/gJNBeCkWL4o85/jvlZ4BA: folds 
5O3Hj9Qg0SqOyKEXoLpjPg: raises $0.25 to $0.50
Ew/TYPQIsbQ2X8nm5iAJBg: raises $1.50 to $2
if4dh6jhJXeN3/qd3qCp9g: folds 
buyjetgNT1McXtdaP4zynA: folds 
dOX4wnYV2sEqvDbF+8KSCw: folds 
5O3Hj9Qg0SqOyKEXoLpjPg: calls $1.50
*** FLOP *** [Ac As Kh]
5O3Hj9Qg0SqOyKEXoLpjPg: checks 
Ew/TYPQIsbQ2X8nm5iAJBg: bets $2
5O3Hj9Qg0SqOyKEXoLpjPg: raises $2.25 to $4.25
Ew/TYPQIsbQ2X8nm5iAJBg: calls $2.25
*** TURN *** [Ac As Kh] [2h]
5O3Hj9Qg0SqOyKEXoLpjPg: bets $5.75
Ew/TYPQIsbQ2X8nm5iAJBg: calls $5.75
*** RIVER *** [Ac As Kh 2h] [Jd]
5O3Hj9Qg0SqOyKEXoLpjPg: bets $106.50
Ew/TYPQIsbQ2X8nm5iAJBg: calls $13 and is all-in
Uncalled bet ($93.50) returned to 5O3Hj9Qg0SqOyKEXoLpjPg
*** SHOW DOWN ***
5O3Hj9Qg0SqOyKEXoLpjPg: shows [Ah 8d] (three of a kind, Aces)
Ew/TYPQIsbQ2X8nm5iAJBg: mucks hand 
5O3Hj9Qg0SqOyKEXoLpjPg collected $47.90 from pot
*** SUMMARY ***
Total pot $50.35 | Rake $2.45 
Board [Ac As Kh 2h Jd]
Seat 1: 5O3Hj9Qg0SqOyKEXoLpjPg showed [Ah 8d] and won ($47.90) with three of a kind, Aces
Seat 2: Ew/TYPQIsbQ2X8nm5iAJBg mucked
Seat 3: if4dh6jhJXeN3/qd3qCp9g (button) folded before Flop (didn't bet)
Seat 4: buyjetgNT1McXtdaP4zynA (small blind) folded before Flop
Seat 5: dOX4wnYV2sEqvDbF+8KSCw (big blind) folded before Flop
Seat 6: /gJNBeCkWL4o85/jvlZ4BA folded before Flop (didn't bet)




PokerStars Game #59941685838:  Hold'em No Limit ($0.10/$0.25) - 2009/07/01 1:42:57 ET
Table 'NgexmgEDEzICBeSO7YCrKQ' 6-max Seat #5 is the button
Seat 1: cezpHJ8FB07dj0xG+LhOvw ($29.80 in chips) 
Seat 2: 32YL2ZEp8NT4JB2RVM9euQ ($21.90 in chips) 
Seat 3: JFIAqU8lCZ0vWwEl4bdGsg ($26.85 in chips) 
Seat 4: xx+iYCDJhHJmNzrfeloyEg ($27.80 in chips) 
Seat 5: /MXkdT8TTs8Qp2LVTQNw6w ($37.80 in chips) 
Seat 6: k9nHZTHt8hYhYRcW8NTb4g ($10.70 in chips) 
k9nHZTHt8hYhYRcW8NTb4g: posts small blind $0.10
cezpHJ8FB07dj0xG+LhOvw: posts big blind $0.25
*** HOLE CARDS ***
32YL2ZEp8NT4JB2RVM9euQ: folds 
JFIAqU8lCZ0vWwEl4bdGsg: folds 
xx+iYCDJhHJmNzrfeloyEg said, "    I lost $25 with mine."
xx+iYCDJhHJmNzrfeloyEg: raises $0.75 to $1
/MXkdT8TTs8Qp2LVTQNw6w: folds 
k9nHZTHt8hYhYRcW8NTb4g: folds 
cezpHJ8FB07dj0xG+LhOvw: folds 
Uncalled bet ($0.75) returned to xx+iYCDJhHJmNzrfeloyEg
xx+iYCDJhHJmNzrfeloyEg collected $0.60 from pot
xx+iYCDJhHJmNzrfeloyEg: doesn't show hand 
*** SUMMARY ***
Total pot $0.60 | Rake $0 
Seat 1: cezpHJ8FB07dj0xG+LhOvw (big blind) folded before Flop
Seat 2: 32YL2ZEp8NT4JB2RVM9euQ folded before Flop (didn't bet)
Seat 3: JFIAqU8lCZ0vWwEl4bdGsg folded before Flop (didn't bet)
Seat 4: xx+iYCDJhHJmNzrfeloyEg collected ($0.60)
Seat 5: /MXkdT8TTs8Qp2LVTQNw6w (button) folded before Flop (didn't bet)
Seat 6: k9nHZTHt8hYhYRcW8NTb4g (small blind) folded before Flop




PokerStars Game #59941685568:  Hold'em No Limit ($0.10/$0.25) - 2009/07/01 1:42:57 ET
Table 'isKy4XK8wJM0x735/D4hWA' 6-max Seat #3 is the button
Seat 1: kwsRmpZ1ZaLooISs+zfyKg ($24.40 in chips) 
Seat 2: 6elpmfyt4Zw0yvd8lePSMQ ($20.45 in chips) 
Seat 3: jp34e617tIzV8tKIWmfAbA ($46.50 in chips) 
Seat 4: DFi/Lzkjsfv8QswS80JX9Q ($30.85 in chips) 
Seat 5: lquriepNQBhDV5P1SWHhnA ($25.60 in chips) 
Seat 6: GbCVUNssQ7mqsPWr7J4d3w ($4.65 in chips) 
DFi/Lzkjsfv8QswS80JX9Q: posts small blind $0.10
lquriepNQBhDV5P1SWHhnA: posts big blind $0.25
*** HOLE CARDS ***
GbCVUNssQ7mqsPWr7J4d3w: folds 
kwsRmpZ1ZaLooISs+zfyKg: folds 
6elpmfyt4Zw0yvd8lePSMQ: folds 
jp34e617tIzV8tKIWmfAbA: folds 
DFi/Lzkjsfv8QswS80JX9Q: raises $0.75 to $1
lquriepNQBhDV5P1SWHhnA: folds 
Uncalled bet ($0.75) returned to DFi/Lzkjsfv8QswS80JX9Q
DFi/Lzkjsfv8QswS80JX9Q collected $0.50 from pot
DFi/Lzkjsfv8QswS80JX9Q: doesn't show hand 
*** SUMMARY ***
Total pot $0.50 | Rake $0 
Seat 1: kwsRmpZ1ZaLooISs+zfyKg folded before Flop (didn't bet)
Seat 2: 6elpmfyt4Zw0yvd8lePSMQ folded before Flop (didn't bet)
Seat 3: jp34e617tIzV8tKIWmfAbA (button) folded before Flop (didn't bet)
Seat 4: DFi/Lzkjsfv8QswS80JX9Q (small blind) collected ($0.50)
Seat 5: lquriepNQBhDV5P1SWHhnA (big blind) folded before Flop
Seat 6: GbCVUNssQ7mqsPWr7J4d3w folded before Flop (didn't bet)




PokerStars Game #59941686202:  Hold'em No Limit ($0.10/$0.25) - 2009/07/01 1:42:58 ET
Table 'g+mPuNJBCHKE9ents7ZGtg' 6-max Seat #4 is the button
Seat 1: cezpHJ8FB07dj0xG+LhOvw ($58.65 in chips) 
Seat 2: fZQg9veL7Dd/Z04ZTjC+wQ ($65.70 in chips) 
Seat 3: FYepjhAvF8ZdVCmqHIy+eQ ($28.55 in chips) 
Seat 4: yVrjRIW0SMxgpvqSIPSe/w ($14.70 in chips) 
Seat 5: D3ikCR8c/o9jB5irZ3uGlw ($12.40 in chips) 
Seat 6: Mn2V28t5aGq2d09z+/o6Fw ($25 in chips) 
D3ikCR8c/o9jB5irZ3uGlw: posts small blind $0.10
Mn2V28t5aGq2d09z+/o6Fw: posts big blind $0.25
*** HOLE CARDS ***
cezpHJ8FB07dj0xG+LhOvw: folds 
fZQg9veL7Dd/Z04ZTjC+wQ: raises $0.50 to $0.75
FYepjhAvF8ZdVCmqHIy+eQ: folds 
yVrjRIW0SMxgpvqSIPSe/w: folds 
D3ikCR8c/o9jB5irZ3uGlw: folds 
Mn2V28t5aGq2d09z+/o6Fw: folds 
Uncalled bet ($0.50) returned to fZQg9veL7Dd/Z04ZTjC+wQ
fZQg9veL7Dd/Z04ZTjC+wQ collected $0.60 from pot
fZQg9veL7Dd/Z04ZTjC+wQ: doesn't show hand 
*** SUMMARY ***
Total pot $0.60 | Rake $0 
Seat 1: cezpHJ8FB07dj0xG+LhOvw folded before Flop (didn't bet)
Seat 2: fZQg9veL7Dd/Z04ZTjC+wQ collected ($0.60)
Seat 3: FYepjhAvF8ZdVCmqHIy+eQ folded before Flop (didn't bet)
Seat 4: yVrjRIW0SMxgpvqSIPSe/w (button) folded before Flop (didn't bet)
Seat 5: D3ikCR8c/o9jB5irZ3uGlw (small blind) folded before Flop
Seat 6: Mn2V28t5aGq2d09z+/o6Fw (big blind) folded before Flop




PokerStars Game #59941686238:  Hold'em No Limit ($0.10/$0.25) - 2009/07/01 1:42:58 ET
Table 'rtxA1Y01Nrq5VoyzTAuusQ' 9-max Seat #9 is the button
Seat 1: w1ukf8uPa4+WH561TtVRxA ($26.65 in chips) 
Seat 2: Th3FldXKQW6hWVVPahaoOQ ($25 in chips) 
Seat 3: K9fS1IUr5GpiJG7VkJ7IbA ($5.25 in chips) 
Seat 5: MtVtHDqIJTyUcXkRBBDIVA ($27.55 in chips) 
Seat 7: 3PmVnC/15cl4oyI1TKIt4g ($9.65 in chips) 
Seat 8: DnDcAdn9P0zGovMERigpFA ($25 in chips) 
Seat 9: HPEB+AtKw1+C/cxU0o1ciw ($22.60 in chips) 
w1ukf8uPa4+WH561TtVRxA: posts small blind $0.10
Th3FldXKQW6hWVVPahaoOQ: posts big blind $0.25
RHqgdFvufLCYe54+qd2gcA: sits out 
*** HOLE CARDS ***
K9fS1IUr5GpiJG7VkJ7IbA: folds 
MtVtHDqIJTyUcXkRBBDIVA: folds 
3PmVnC/15cl4oyI1TKIt4g: folds 
DnDcAdn9P0zGovMERigpFA: folds 
HPEB+AtKw1+C/cxU0o1ciw: raises $0.75 to $1
w1ukf8uPa4+WH561TtVRxA: folds 
Th3FldXKQW6hWVVPahaoOQ: folds 
Uncalled bet ($0.75) returned to HPEB+AtKw1+C/cxU0o1ciw
HPEB+AtKw1+C/cxU0o1ciw collected $0.60 from pot
HPEB+AtKw1+C/cxU0o1ciw: doesn't show hand 
*** SUMMARY ***
Total pot $0.60 | Rake $0 
Seat 1: w1ukf8uPa4+WH561TtVRxA (small blind) folded before Flop
Seat 2: Th3FldXKQW6hWVVPahaoOQ (big blind) folded before Flop
Seat 3: K9fS1IUr5GpiJG7VkJ7IbA folded before Flop (didn't bet)
Seat 5: MtVtHDqIJTyUcXkRBBDIVA folded before Flop (didn't bet)
Seat 7: 3PmVnC/15cl4oyI1TKIt4g folded before Flop (didn't bet)
Seat 8: DnDcAdn9P0zGovMERigpFA folded before Flop (didn't bet)
Seat 9: HPEB+AtKw1+C/cxU0o1ciw (button) collected ($0.60)




PokerStars Game #59941686176:  Hold'em No Limit ($0.10/$0.25) - 2009/07/01 1:42:58 ET
Table 'RPdw09/gGCIP4xFhDWJgXQ' 9-max Seat #3 is the button
Seat 1: aNpwfA31EREwO+ar4XzBCw ($27.50 in chips) 
Seat 2: Sd1tfhUq/M96GhXGv1hwFQ ($8.95 in chips) 
Seat 3: g5LAv1J/3Thw1zs/SEyfzw ($17.90 in chips) 
Seat 4: z5GxcHlYz/GSz6W2uFiTtg ($10.55 in chips) 
Seat 5: gehe91e0IyVT0QU/XBkEyg ($30.60 in chips) 
Seat 6: monZeAwXUmIA1l84cUd2hw ($14.60 in chips) 
Seat 7: EP17SQz/iWcuYdNOGeBgkw ($14.25 in chips) 
Seat 8: MG90wfSJZnOejs/KD3vlQQ ($29.10 in chips) 
Seat 9: O02ScVDnDZwH6KjZNJZMzA ($5 in chips) 
z5GxcHlYz/GSz6W2uFiTtg: posts small blind $0.10
gehe91e0IyVT0QU/XBkEyg: posts big blind $0.25
*** HOLE CARDS ***
monZeAwXUmIA1l84cUd2hw: folds 
EP17SQz/iWcuYdNOGeBgkw: folds 
MG90wfSJZnOejs/KD3vlQQ: raises $0.50 to $0.75
O02ScVDnDZwH6KjZNJZMzA: folds 
aNpwfA31EREwO+ar4XzBCw: folds 
Sd1tfhUq/M96GhXGv1hwFQ: calls $0.75
g5LAv1J/3Thw1zs/SEyfzw: folds 
z5GxcHlYz/GSz6W2uFiTtg: folds 
z5GxcHlYz/GSz6W2uFiTtg is sitting out
gehe91e0IyVT0QU/XBkEyg: folds 
*** FLOP *** [Tc Ah 3h]
MG90wfSJZnOejs/KD3vlQQ: bets $1.40
Sd1tfhUq/M96GhXGv1hwFQ: folds 
Uncalled bet ($1.40) returned to MG90wfSJZnOejs/KD3vlQQ
MG90wfSJZnOejs/KD3vlQQ collected $1.80 from pot
MG90wfSJZnOejs/KD3vlQQ: doesn't show hand 
*** SUMMARY ***
Total pot $1.85 | Rake $0.05 
Board [Tc Ah 3h]
Seat 1: aNpwfA31EREwO+ar4XzBCw folded before Flop (didn't bet)
Seat 2: Sd1tfhUq/M96GhXGv1hwFQ folded on the Flop
Seat 3: g5LAv1J/3Thw1zs/SEyfzw (button) folded before Flop (didn't bet)
Seat 4: z5GxcHlYz/GSz6W2uFiTtg (small blind) folded before Flop
Seat 5: gehe91e0IyVT0QU/XBkEyg (big blind) folded before Flop
Seat 6: monZeAwXUmIA1l84cUd2hw folded before Flop (didn't bet)
Seat 7: EP17SQz/iWcuYdNOGeBgkw folded before Flop (didn't bet)
Seat 8: MG90wfSJZnOejs/KD3vlQQ collected ($1.80)
Seat 9: O02ScVDnDZwH6KjZNJZMzA folded before Flop (didn't bet)




PokerStars Game #59941686092:  Hold'em No Limit ($0.10/$0.25) - 2009/07/01 1:42:58 ET
Table '1zj0+miaIL9cvwnT/50pOA' 9-max Seat #1 is the button
Seat 1: PVxvfRTRvkgZf9WtquEkwQ ($25.35 in chips) 
Seat 2: HPEB+AtKw1+C/cxU0o1ciw ($43.05 in chips) 
Seat 3: dtZ84flFEi4Q+SGrHMJRDQ ($28.60 in chips) 
Seat 4: PdIasPkzm2sqZnN41ZRXOg ($5 in chips) 
Seat 5: 57qrNGHDvf6GhB8zVLsAtQ ($4.35 in chips) 
Seat 6: YZaC69gFrepA6oCGtu7E0w ($29.20 in chips) 
Seat 7: 6RiVTYll/5D8zICp0MRpKw ($23.90 in chips) 
Seat 8: Ihhh49x48fayPIyvl2Rsmg ($33.85 in chips) 
Seat 9: AyqFvLFzJDE7yMbXP362BA ($27.90 in chips) 
HPEB+AtKw1+C/cxU0o1ciw: posts small blind $0.10
dtZ84flFEi4Q+SGrHMJRDQ: posts big blind $0.25
*** HOLE CARDS ***
PdIasPkzm2sqZnN41ZRXOg: folds 
57qrNGHDvf6GhB8zVLsAtQ: folds 
YZaC69gFrepA6oCGtu7E0w: folds 
6RiVTYll/5D8zICp0MRpKw: folds 
Ihhh49x48fayPIyvl2Rsmg: calls $0.25
AyqFvLFzJDE7yMbXP362BA: calls $0.25
PVxvfRTRvkgZf9WtquEkwQ: folds 
HPEB+AtKw1+C/cxU0o1ciw: folds 
dtZ84flFEi4Q+SGrHMJRDQ: checks 
*** FLOP *** [9h Ks Tc]
dtZ84flFEi4Q+SGrHMJRDQ: checks 
Ihhh49x48fayPIyvl2Rsmg: bets $0.75
AyqFvLFzJDE7yMbXP362BA: calls $0.75
dtZ84flFEi4Q+SGrHMJRDQ: folds 
*** TURN *** [9h Ks Tc] [Th]
Ihhh49x48fayPIyvl2Rsmg: checks 
AyqFvLFzJDE7yMbXP362BA: checks 
*** RIVER *** [9h Ks Tc Th] [3d]
Ihhh49x48fayPIyvl2Rsmg: checks 
AyqFvLFzJDE7yMbXP362BA: checks 
*** SHOW DOWN ***
Ihhh49x48fayPIyvl2Rsmg: shows [Kd 5d] (two pair, Kings and Tens)
AyqFvLFzJDE7yMbXP362BA: mucks hand 
Ihhh49x48fayPIyvl2Rsmg collected $2.25 from pot
*** SUMMARY ***
Total pot $2.35 | Rake $0.10 
Board [9h Ks Tc Th 3d]
Seat 1: PVxvfRTRvkgZf9WtquEkwQ (button) folded before Flop (didn't bet)
Seat 2: HPEB+AtKw1+C/cxU0o1ciw (small blind) folded before Flop
Seat 3: dtZ84flFEi4Q+SGrHMJRDQ (big blind) folded on the Flop
Seat 4: PdIasPkzm2sqZnN41ZRXOg folded before Flop (didn't bet)
Seat 5: 57qrNGHDvf6GhB8zVLsAtQ folded before Flop (didn't bet)
Seat 6: YZaC69gFrepA6oCGtu7E0w folded before Flop (didn't bet)
Seat 7: 6RiVTYll/5D8zICp0MRpKw folded before Flop (didn't bet)
Seat 8: Ihhh49x48fayPIyvl2Rsmg showed [Kd 5d] and won ($2.25) with two pair, Kings and Tens
Seat 9: AyqFvLFzJDE7yMbXP362BA mucked




PokerStars Game #59941686180:  Hold'em No Limit ($0.10/$0.25) - 2009/07/01 1:42:58 ET
Table 'PCxB2W9H6ma8SwsZlImuOw' 9-max Seat #5 is the button
Seat 1: SqibpGx+lf+brY0fJVvD0w ($25.10 in chips) 
Seat 2: wjH6l1gQaEfv+C45sAOwIQ ($38.20 in chips) 
Seat 3: J2a/QHAWUgo6beDRoEyg2g ($9.10 in chips) 
Seat 4: RsPwA2DnzOke3hD/Of/DUg ($2.55 in chips) 
Seat 5: GZO7tOXatVoX17M2DqPcUQ ($21.40 in chips) 
Seat 6: 5/6dWEBUHldD7iGXa2LwsQ ($17 in chips) 
Seat 7: c/9X4zftzphFxYtxp5kp9w ($26.80 in chips) 
Seat 8: Pt637jKksB5MzP0UNJAAkw ($25 in chips) 
Seat 9: COwSH15MvHaRF7en6/TRZQ ($4.65 in chips) 
5/6dWEBUHldD7iGXa2LwsQ: posts small blind $0.10
c/9X4zftzphFxYtxp5kp9w: posts big blind $0.25
*** HOLE CARDS ***
Pt637jKksB5MzP0UNJAAkw: folds 
COwSH15MvHaRF7en6/TRZQ: folds 
SqibpGx+lf+brY0fJVvD0w: folds 
wjH6l1gQaEfv+C45sAOwIQ: folds 
J2a/QHAWUgo6beDRoEyg2g: folds 
RsPwA2DnzOke3hD/Of/DUg: folds 
GZO7tOXatVoX17M2DqPcUQ: folds 
5/6dWEBUHldD7iGXa2LwsQ: calls $0.15
c/9X4zftzphFxYtxp5kp9w: checks 
*** FLOP *** [Qd Td As]
5/6dWEBUHldD7iGXa2LwsQ: bets $0.50
c/9X4zftzphFxYtxp5kp9w: calls $0.50
*** TURN *** [Qd Td As] [6c]
5/6dWEBUHldD7iGXa2LwsQ: checks 
c/9X4zftzphFxYtxp5kp9w: checks 
*** RIVER *** [Qd Td As 6c] [3s]
5/6dWEBUHldD7iGXa2LwsQ: checks 
c/9X4zftzphFxYtxp5kp9w: bets $0.50
5/6dWEBUHldD7iGXa2LwsQ: folds 
Uncalled bet ($0.50) returned to c/9X4zftzphFxYtxp5kp9w
c/9X4zftzphFxYtxp5kp9w collected $1.45 from pot
*** SUMMARY ***
Total pot $1.50 | Rake $0.05 
Board [Qd Td As 6c 3s]
Seat 1: SqibpGx+lf+brY0fJVvD0w folded before Flop (didn't bet)
Seat 2: wjH6l1gQaEfv+C45sAOwIQ folded before Flop (didn't bet)
Seat 3: J2a/QHAWUgo6beDRoEyg2g folded before Flop (didn't bet)
Seat 4: RsPwA2DnzOke3hD/Of/DUg folded before Flop (didn't bet)
Seat 5: GZO7tOXatVoX17M2DqPcUQ (button) folded before Flop (didn't bet)
Seat 6: 5/6dWEBUHldD7iGXa2LwsQ (small blind) folded on the River
Seat 7: c/9X4zftzphFxYtxp5kp9w (big blind) collected ($1.45)
Seat 8: Pt637jKksB5MzP0UNJAAkw folded before Flop (didn't bet)
Seat 9: COwSH15MvHaRF7en6/TRZQ folded before Flop (didn't bet)




PokerStars Game #59941686104:  Hold'em No Limit ($0.10/$0.25) - 2009/07/01 1:42:58 ET
Table 'AUM6O+mgQAaLDZKMQ/5/gA' 9-max Seat #2 is the button
Seat 1: EIObtVVE4WXRXvLGJA6NHw ($15.30 in chips) 
Seat 2: OXPkK84/qv92EMwXPiG5rQ ($12.95 in chips) 
Seat 3: CvL9Ch1HYCVbTsfpNucitg ($3.50 in chips) 
Seat 4: 4awUyiDYTgylQKXZ9faBVA ($28.05 in chips) 
Seat 5: +2kMBNpY4nF1qNCRd8SJLA ($25.65 in chips) 
Seat 6: v5jnQ1gfh9nLla3kMXG7Yg ($7.45 in chips) 
Seat 7: Bb42QRQMhg5/Y0vHP8/2Xw ($30.60 in chips) 
Seat 9: eK8qa6EPcH2zhtbmWSvc9g ($25.30 in chips) 
CvL9Ch1HYCVbTsfpNucitg: posts small blind $0.10
4awUyiDYTgylQKXZ9faBVA: posts big blind $0.25
*** HOLE CARDS ***
+2kMBNpY4nF1qNCRd8SJLA: folds 
v5jnQ1gfh9nLla3kMXG7Yg: calls $0.25
Bb42QRQMhg5/Y0vHP8/2Xw: folds 
eK8qa6EPcH2zhtbmWSvc9g: folds 
EIObtVVE4WXRXvLGJA6NHw: calls $0.25
OXPkK84/qv92EMwXPiG5rQ: folds 
CvL9Ch1HYCVbTsfpNucitg: folds 
4awUyiDYTgylQKXZ9faBVA: checks 
*** FLOP *** [5s 7c Jh]
4awUyiDYTgylQKXZ9faBVA: checks 
v5jnQ1gfh9nLla3kMXG7Yg: checks 
OXPkK84/qv92EMwXPiG5rQ leaves the table
EIObtVVE4WXRXvLGJA6NHw: bets $0.50
4awUyiDYTgylQKXZ9faBVA: folds 
v5jnQ1gfh9nLla3kMXG7Yg: folds 
Uncalled bet ($0.50) returned to EIObtVVE4WXRXvLGJA6NHw
EIObtVVE4WXRXvLGJA6NHw collected $0.85 from pot
EIObtVVE4WXRXvLGJA6NHw: doesn't show hand 
*** SUMMARY ***
Total pot $0.85 | Rake $0 
Board [5s 7c Jh]
Seat 1: EIObtVVE4WXRXvLGJA6NHw collected ($0.85)
Seat 2: OXPkK84/qv92EMwXPiG5rQ (button) folded before Flop (didn't bet)
Seat 3: CvL9Ch1HYCVbTsfpNucitg (small blind) folded before Flop
Seat 4: 4awUyiDYTgylQKXZ9faBVA (big blind) folded on the Flop
Seat 5: +2kMBNpY4nF1qNCRd8SJLA folded before Flop (didn't bet)
Seat 6: v5jnQ1gfh9nLla3kMXG7Yg folded on the Flop
Seat 7: Bb42QRQMhg5/Y0vHP8/2Xw folded before Flop (didn't bet)
Seat 9: eK8qa6EPcH2zhtbmWSvc9g folded before Flop (didn't bet)




PokerStars Game #59941686112:  Hold'em No Limit ($0.10/$0.25) - 2009/07/01 1:42:58 ET
Table 'v+LTGPWbrLum+Ggd4ef6lg' 9-max Seat #6 is the button
Seat 1: zUXhymECc2C9W9ZNw6qppA ($9.65 in chips) 
Seat 2: r/xYbgD9yVdKFWRgSQD/+Q ($20.70 in chips) 
Seat 3: 7ovWM9c1nQLTFritEGRG/A ($3.25 in chips) 
Seat 4: bXpVeaSTPBFSPJmeXxO7nw ($9.05 in chips) 
Seat 5: +8OkYWUhGfkDbAtQl/ovYQ ($31.55 in chips) 
Seat 6: T+MjFnaPZsOyKbE9LYG2Qg ($13.90 in chips) 
Seat 7: kUxTO3D2eQcx4oJIpJAK4Q ($7.45 in chips) 
Seat 8: +sbyWwIcFp9kP0bDtMegfQ ($32.60 in chips) 
kUxTO3D2eQcx4oJIpJAK4Q: posts small blind $0.10
+sbyWwIcFp9kP0bDtMegfQ: posts big blind $0.25
cZ99hugmLBj9KhTlc8nCSw: sits out 
*** HOLE CARDS ***
+8OkYWUhGfkDbAtQl/ovYQ said, "any one playing wsop"
zUXhymECc2C9W9ZNw6qppA: folds 
r/xYbgD9yVdKFWRgSQD/+Q: raises $1 to $1.25
7ovWM9c1nQLTFritEGRG/A: folds 
bXpVeaSTPBFSPJmeXxO7nw: folds 
+8OkYWUhGfkDbAtQl/ovYQ said, "i qualifiet"
+8OkYWUhGfkDbAtQl/ovYQ: folds 
T+MjFnaPZsOyKbE9LYG2Qg: calls $1.25
kUxTO3D2eQcx4oJIpJAK4Q: folds 
+sbyWwIcFp9kP0bDtMegfQ: folds 
*** FLOP *** [Td 2d Ad]
r/xYbgD9yVdKFWRgSQD/+Q: bets $2.75
T+MjFnaPZsOyKbE9LYG2Qg: calls $2.75
*** TURN *** [Td 2d Ad] [Jd]
r/xYbgD9yVdKFWRgSQD/+Q: bets $0.25
T+MjFnaPZsOyKbE9LYG2Qg: raises $2.50 to $2.75
r/xYbgD9yVdKFWRgSQD/+Q: raises $2.50 to $5.25
T+MjFnaPZsOyKbE9LYG2Qg: calls $2.50
*** RIVER *** [Td 2d Ad Jd] [8c]
r/xYbgD9yVdKFWRgSQD/+Q: bets $0.25
T+MjFnaPZsOyKbE9LYG2Qg: calls $0.25
*** SHOW DOWN ***
r/xYbgD9yVdKFWRgSQD/+Q: shows [Ah Th] (two pair, Aces and Tens)
T+MjFnaPZsOyKbE9LYG2Qg: shows [3d As] (a flush, Ace high)
T+MjFnaPZsOyKbE9LYG2Qg collected $18.45 from pot
*** SUMMARY ***
Total pot $19.35 | Rake $0.90 
Board [Td 2d Ad Jd 8c]
Seat 1: zUXhymECc2C9W9ZNw6qppA folded before Flop (didn't bet)
Seat 2: r/xYbgD9yVdKFWRgSQD/+Q showed [Ah Th] and lost with two pair, Aces and Tens
Seat 3: 7ovWM9c1nQLTFritEGRG/A folded before Flop (didn't bet)
Seat 4: bXpVeaSTPBFSPJmeXxO7nw folded before Flop (didn't bet)
Seat 5: +8OkYWUhGfkDbAtQl/ovYQ folded before Flop (didn't bet)
Seat 6: T+MjFnaPZsOyKbE9LYG2Qg (button) showed [3d As] and won ($18.45) with a flush, Ace high
Seat 7: kUxTO3D2eQcx4oJIpJAK4Q (small blind) folded before Flop
Seat 8: +sbyWwIcFp9kP0bDtMegfQ (big blind) folded before Flop




PokerStars Game #59941686418:  Hold'em No Limit ($0.10/$0.25) - 2009/07/01 1:42:58 ET
Table 'GxdLtCpYxqT4aAbYqkEEpw' 6-max Seat #6 is the button
Seat 1: 2d/PU00mMdO9azAaXqcSbw ($10.45 in chips) 
Seat 3: LpmZGzLpOmfZUF7EV4ZlrQ ($16.25 in chips) 
Seat 4: 6wzJiRvp8HY6t+MQGnSIzA ($10.55 in chips) 
Seat 5: q6WfTUAD9mowIP63ASq2Dg ($36.85 in chips) 
Seat 6: DFi/Lzkjsfv8QswS80JX9Q ($25 in chips) 
2d/PU00mMdO9azAaXqcSbw: posts small blind $0.10
LpmZGzLpOmfZUF7EV4ZlrQ: posts big blind $0.25
*** HOLE CARDS ***
6wzJiRvp8HY6t+MQGnSIzA: folds 
q6WfTUAD9mowIP63ASq2Dg: folds 
DFi/Lzkjsfv8QswS80JX9Q: folds 
2d/PU00mMdO9azAaXqcSbw: folds 
Uncalled bet ($0.15) returned to LpmZGzLpOmfZUF7EV4ZlrQ
LpmZGzLpOmfZUF7EV4ZlrQ collected $0.20 from pot
3iomNWHjIokoWh6JNWCUJQ leaves the table
*** SUMMARY ***
Total pot $0.20 | Rake $0 
Seat 1: 2d/PU00mMdO9azAaXqcSbw (small blind) folded before Flop
Seat 3: LpmZGzLpOmfZUF7EV4ZlrQ (big blind) collected ($0.20)
Seat 4: 6wzJiRvp8HY6t+MQGnSIzA folded before Flop (didn't bet)
Seat 5: q6WfTUAD9mowIP63ASq2Dg folded before Flop (didn't bet)
Seat 6: DFi/Lzkjsfv8QswS80JX9Q (button) folded before Flop (didn't bet)




PokerStars Game #59941686208:  Hold'em No Limit ($0.10/$0.25) - 2009/07/01 1:42:58 ET
Table 'AchTjdLS1zBUbH3ZIx6f0w' 6-max Seat #3 is the button
Seat 1: rZ0bUtoerhFGDUSRQMnFog ($28 in chips) 
Seat 2: kG34n23qFQA3nzdOJTQ1dA ($66.25 in chips) 
Seat 3: k9vn40MOqqb+xF+7GZ6v2g ($28.65 in chips) 
Seat 4: q6WfTUAD9mowIP63ASq2Dg ($30.65 in chips) 
Seat 5: 0av6tRNdi0Ui4f15L7gsVg ($26.35 in chips) 
q6WfTUAD9mowIP63ASq2Dg: posts small blind $0.10
0av6tRNdi0Ui4f15L7gsVg: posts big blind $0.25
epAUIB7h2FJXzUPRIvSkRA: sits out 
*** HOLE CARDS ***
rZ0bUtoerhFGDUSRQMnFog: calls $0.25
kG34n23qFQA3nzdOJTQ1dA: folds 
k9vn40MOqqb+xF+7GZ6v2g: folds 
q6WfTUAD9mowIP63ASq2Dg: folds 
0av6tRNdi0Ui4f15L7gsVg: checks 
*** FLOP *** [8h Qs 5s]
0av6tRNdi0Ui4f15L7gsVg: checks 
rZ0bUtoerhFGDUSRQMnFog: bets $0.25
0av6tRNdi0Ui4f15L7gsVg: folds 
Uncalled bet ($0.25) returned to rZ0bUtoerhFGDUSRQMnFog
rZ0bUtoerhFGDUSRQMnFog collected $0.60 from pot
rZ0bUtoerhFGDUSRQMnFog: doesn't show hand 
*** SUMMARY ***
Total pot $0.60 | Rake $0 
Board [8h Qs 5s]
Seat 1: rZ0bUtoerhFGDUSRQMnFog collected ($0.60)
Seat 2: kG34n23qFQA3nzdOJTQ1dA folded before Flop (didn't bet)
Seat 3: k9vn40MOqqb+xF+7GZ6v2g (button) folded before Flop (didn't bet)
Seat 4: q6WfTUAD9mowIP63ASq2Dg (small blind) folded before Flop
Seat 5: 0av6tRNdi0Ui4f15L7gsVg (big blind) folded on the Flop




PokerStars Game #59941686272:  Hold'em No Limit ($0.10/$0.25) - 2009/07/01 1:42:58 ET
Table 'o0CDOvKO/bn1WjeymDrXfA' 6-max Seat #1 is the button
Seat 1: if4dh6jhJXeN3/qd3qCp9g ($24.65 in chips) 
Seat 2: uAJL+E2git8iAiFyAvVOnw ($17.85 in chips) 
Seat 3: OtVWmpxX2/9L8bb1GSKTuA ($18 in chips) 
Seat 5: dOIoLBxmpLHSXBN9LZnf0Q ($29.45 in chips) 
Seat 6: SS/yfeArhULzIcOPe8MdPg ($25 in chips) 
uAJL+E2git8iAiFyAvVOnw: posts small blind $0.10
OtVWmpxX2/9L8bb1GSKTuA: posts big blind $0.25
L3/N/gliETan8N5Gim5h4Q: sits out 
*** HOLE CARDS ***
dOIoLBxmpLHSXBN9LZnf0Q: calls $0.25
SS/yfeArhULzIcOPe8MdPg: folds 
if4dh6jhJXeN3/qd3qCp9g: folds 
uAJL+E2git8iAiFyAvVOnw: raises $0.75 to $1
OtVWmpxX2/9L8bb1GSKTuA: calls $0.75
dOIoLBxmpLHSXBN9LZnf0Q: calls $0.75
*** FLOP *** [Ah 4c 5s]
uAJL+E2git8iAiFyAvVOnw: checks 
OtVWmpxX2/9L8bb1GSKTuA: checks 
dOIoLBxmpLHSXBN9LZnf0Q: bets $1
uAJL+E2git8iAiFyAvVOnw: calls $1
OtVWmpxX2/9L8bb1GSKTuA: folds 
*** TURN *** [Ah 4c 5s] [5h]
uAJL+E2git8iAiFyAvVOnw: bets $3
dOIoLBxmpLHSXBN9LZnf0Q: calls $3
*** RIVER *** [Ah 4c 5s 5h] [5d]
uAJL+E2git8iAiFyAvVOnw: bets $7
dOIoLBxmpLHSXBN9LZnf0Q: calls $7
*** SHOW DOWN ***
uAJL+E2git8iAiFyAvVOnw: shows [Js 9d] (three of a kind, Fives)
dOIoLBxmpLHSXBN9LZnf0Q: shows [3d Ac] (a full house, Fives full of Aces)
dOIoLBxmpLHSXBN9LZnf0Q collected $23.80 from pot
*** SUMMARY ***
Total pot $25 | Rake $1.20 
Board [Ah 4c 5s 5h 5d]
Seat 1: if4dh6jhJXeN3/qd3qCp9g (button) folded before Flop (didn't bet)
Seat 2: uAJL+E2git8iAiFyAvVOnw (small blind) showed [Js 9d] and lost with three of a kind, Fives
Seat 3: OtVWmpxX2/9L8bb1GSKTuA (big blind) folded on the Flop
Seat 5: dOIoLBxmpLHSXBN9LZnf0Q showed [3d Ac] and won ($23.80) with a full house, Fives full of Aces
Seat 6: SS/yfeArhULzIcOPe8MdPg folded before Flop (didn't bet)




PokerStars Game #59941686720:  Hold'em No Limit ($0.10/$0.25) - 2009/07/01 1:42:59 ET
Table 'hOE09W281uSob0XeJmUcRg' 6-max Seat #6 is the button
Seat 1: mfrkWA3PTeYPkbO6hi98Aw ($27.40 in chips) 
Seat 3: y+a/yGW/Jy4bPJFnaeTz5w ($14.10 in chips) 
Seat 5: JFIAqU8lCZ0vWwEl4bdGsg ($25.35 in chips) 
Seat 6: x4ZJ8E/TUrtoB7WiHcv8WA ($13.90 in chips) 
mfrkWA3PTeYPkbO6hi98Aw: posts small blind $0.10
lYjWCpfCxX2kgcHY3v4Yow: is sitting out 
lYjWCpfCxX2kgcHY3v4Yow leaves the table
y+a/yGW/Jy4bPJFnaeTz5w: posts big blind $0.25
*** HOLE CARDS ***
JFIAqU8lCZ0vWwEl4bdGsg: folds 
x4ZJ8E/TUrtoB7WiHcv8WA: raises $0.75 to $1
mfrkWA3PTeYPkbO6hi98Aw: folds 
lRKJ8o/CnOPFwfHHm6ioMw joins the table at seat #2 
y+a/yGW/Jy4bPJFnaeTz5w: folds 
Uncalled bet ($0.75) returned to x4ZJ8E/TUrtoB7WiHcv8WA
x4ZJ8E/TUrtoB7WiHcv8WA collected $0.60 from pot
x4ZJ8E/TUrtoB7WiHcv8WA: doesn't show hand 
*** SUMMARY ***
Total pot $0.60 | Rake $0 
Seat 1: mfrkWA3PTeYPkbO6hi98Aw (small blind) folded before Flop
Seat 3: y+a/yGW/Jy4bPJFnaeTz5w (big blind) folded before Flop
Seat 5: JFIAqU8lCZ0vWwEl4bdGsg folded before Flop (didn't bet)
Seat 6: x4ZJ8E/TUrtoB7WiHcv8WA (button) collected ($0.60)




PokerStars Game #59941686868:  Hold'em No Limit ($0.10/$0.25) - 2009/07/01 1:42:59 ET
Table 'Of/T60zpXg1GcjrZ7Lm//Q' 9-max Seat #3 is the button
Seat 1: Lro4e37x4FUa5P3yzDjskw ($18.20 in chips) 
Seat 2: qwr38jl5txoR36M7G5qi4A ($9.90 in chips) 
Seat 3: 6RiVTYll/5D8zICp0MRpKw ($22.90 in chips) 
Seat 4: Czut6V7acIqUJrrobjKAZg ($17 in chips) 
Seat 5: IiLkthQMEje9LS79rCFQ1Q ($9.45 in chips) 
Seat 6: tYsOBqdU1+x+yFI7zHO7hQ ($31.05 in chips) 
Seat 7: PVxvfRTRvkgZf9WtquEkwQ ($25 in chips) 
Seat 8: ghNKXUBl/H+t83JF079ZBA ($26.50 in chips) 
Seat 9: egvg3mTBBVzMHnJPIQiKcA ($14 in chips) 
Czut6V7acIqUJrrobjKAZg: posts small blind $0.10
IiLkthQMEje9LS79rCFQ1Q: posts big blind $0.25
*** HOLE CARDS ***
tYsOBqdU1+x+yFI7zHO7hQ: folds 
PVxvfRTRvkgZf9WtquEkwQ: raises $0.75 to $1
ghNKXUBl/H+t83JF079ZBA: folds 
egvg3mTBBVzMHnJPIQiKcA: calls $1
Lro4e37x4FUa5P3yzDjskw: folds 
qwr38jl5txoR36M7G5qi4A: folds 
6RiVTYll/5D8zICp0MRpKw: folds 
Czut6V7acIqUJrrobjKAZg: folds 
IiLkthQMEje9LS79rCFQ1Q: folds 
*** FLOP *** [Js Qh 6h]
PVxvfRTRvkgZf9WtquEkwQ: bets $1.25
egvg3mTBBVzMHnJPIQiKcA: calls $1.25
*** TURN *** [Js Qh 6h] [Qd]
PVxvfRTRvkgZf9WtquEkwQ: checks 
egvg3mTBBVzMHnJPIQiKcA: checks 
*** RIVER *** [Js Qh 6h Qd] [7d]
PVxvfRTRvkgZf9WtquEkwQ: checks 
egvg3mTBBVzMHnJPIQiKcA: bets $2
PVxvfRTRvkgZf9WtquEkwQ: folds 
Uncalled bet ($2) returned to egvg3mTBBVzMHnJPIQiKcA
egvg3mTBBVzMHnJPIQiKcA collected $4.65 from pot
*** SUMMARY ***
Total pot $4.85 | Rake $0.20 
Board [Js Qh 6h Qd 7d]
Seat 1: Lro4e37x4FUa5P3yzDjskw folded before Flop (didn't bet)
Seat 2: qwr38jl5txoR36M7G5qi4A folded before Flop (didn't bet)
Seat 3: 6RiVTYll/5D8zICp0MRpKw (button) folded before Flop (didn't bet)
Seat 4: Czut6V7acIqUJrrobjKAZg (small blind) folded before Flop
Seat 5: IiLkthQMEje9LS79rCFQ1Q (big blind) folded before Flop
Seat 6: tYsOBqdU1+x+yFI7zHO7hQ folded before Flop (didn't bet)
Seat 7: PVxvfRTRvkgZf9WtquEkwQ folded on the River
Seat 8: ghNKXUBl/H+t83JF079ZBA folded before Flop (didn't bet)
Seat 9: egvg3mTBBVzMHnJPIQiKcA collected ($4.65)




PokerStars Game #59941686926:  Hold'em No Limit ($0.10/$0.25) - 2009/07/01 1:42:59 ET
Table 'x7YStLKc8hpt/pTgSetPKA' 9-max Seat #1 is the button
Seat 1: tYsOBqdU1+x+yFI7zHO7hQ ($26.25 in chips) 
Seat 2: z5GxcHlYz/GSz6W2uFiTtg ($23.45 in chips) 
Seat 3: S7Ki0P+0AIGPuIfGJjW0gg ($12.35 in chips) 
Seat 4: ydoFOVgzvZv9ZhuWu9rXAw ($5.25 in chips) 
Seat 5: OiV1PWZ3IkN29JlmCcnTwQ ($6.25 in chips) 
Seat 6: 9YN2IkT2JYYKFErZtZvCtA ($47.70 in chips) 
Seat 7: dtZ84flFEi4Q+SGrHMJRDQ ($26.35 in chips) 
Seat 8: j4q3p0lesp63b1gZDwLBZw ($5 in chips) 
Seat 9: nm4Dj/f+jJEwKVsUnKh73g ($21.55 in chips) 
z5GxcHlYz/GSz6W2uFiTtg: posts small blind $0.10
S7Ki0P+0AIGPuIfGJjW0gg: posts big blind $0.25
*** HOLE CARDS ***
ydoFOVgzvZv9ZhuWu9rXAw: folds 
OiV1PWZ3IkN29JlmCcnTwQ: folds 
9YN2IkT2JYYKFErZtZvCtA: folds 
dtZ84flFEi4Q+SGrHMJRDQ: folds 
j4q3p0lesp63b1gZDwLBZw: folds 
nm4Dj/f+jJEwKVsUnKh73g: calls $0.25
tYsOBqdU1+x+yFI7zHO7hQ: raises $1 to $1.25
z5GxcHlYz/GSz6W2uFiTtg: folds 
z5GxcHlYz/GSz6W2uFiTtg is sitting out
S7Ki0P+0AIGPuIfGJjW0gg: folds 
nm4Dj/f+jJEwKVsUnKh73g: raises $1.75 to $3
tYsOBqdU1+x+yFI7zHO7hQ: calls $1.75
*** FLOP *** [7s 4d 2d]
nm4Dj/f+jJEwKVsUnKh73g: checks 
tYsOBqdU1+x+yFI7zHO7hQ: checks 
*** TURN *** [7s 4d 2d] [2h]
nm4Dj/f+jJEwKVsUnKh73g: bets $7
tYsOBqdU1+x+yFI7zHO7hQ: calls $7
*** RIVER *** [7s 4d 2d 2h] [Kh]
nm4Dj/f+jJEwKVsUnKh73g: bets $6.75
tYsOBqdU1+x+yFI7zHO7hQ: calls $6.75
*** SHOW DOWN ***
nm4Dj/f+jJEwKVsUnKh73g: shows [Ad Ah] (two pair, Aces and Deuces)
tYsOBqdU1+x+yFI7zHO7hQ: mucks hand 
nm4Dj/f+jJEwKVsUnKh73g collected $32.25 from pot
*** SUMMARY ***
Total pot $33.85 | Rake $1.60 
Board [7s 4d 2d 2h Kh]
Seat 1: tYsOBqdU1+x+yFI7zHO7hQ (button) mucked
Seat 2: z5GxcHlYz/GSz6W2uFiTtg (small blind) folded before Flop
Seat 3: S7Ki0P+0AIGPuIfGJjW0gg (big blind) folded before Flop
Seat 4: ydoFOVgzvZv9ZhuWu9rXAw folded before Flop (didn't bet)
Seat 5: OiV1PWZ3IkN29JlmCcnTwQ folded before Flop (didn't bet)
Seat 6: 9YN2IkT2JYYKFErZtZvCtA folded before Flop (didn't bet)
Seat 7: dtZ84flFEi4Q+SGrHMJRDQ folded before Flop (didn't bet)
Seat 8: j4q3p0lesp63b1gZDwLBZw folded before Flop (didn't bet)
Seat 9: nm4Dj/f+jJEwKVsUnKh73g showed [Ad Ah] and won ($32.25) with two pair, Aces and Deuces




PokerStars Game #59941687430:  Hold'em No Limit ($0.10/$0.25) - 2009/07/01 1:43:00 ET
Table 'bIGKmJgZehWJ+FAo8b85iw' 9-max Seat #9 is the button
Seat 1: yyG4svzOpC1A+sUP/scg6w ($14.45 in chips) 
Seat 2: cCjRCvseA9rZn7Xr+GCCHg ($21.70 in chips) 
Seat 3: /FyMUX+W/tpNFcRWbUTJxQ ($11.15 in chips) 
Seat 4: LGxBRjCRn6KlQ/6B4eoXbA ($19.35 in chips) 
Seat 5: uLP/lYn7oKq9xCChBXsXxw ($25.25 in chips) 
Seat 6: PFNLAvMkr8qKc7xCiH0wTA ($18.85 in chips) 
Seat 7: HDDm1BkZtdsRyw2DJdqq6A ($21.50 in chips) 
Seat 8: +2kMBNpY4nF1qNCRd8SJLA ($54.95 in chips) 
Seat 9: aNpwfA31EREwO+ar4XzBCw ($31.75 in chips) 
yyG4svzOpC1A+sUP/scg6w: posts small blind $0.10
cCjRCvseA9rZn7Xr+GCCHg: posts big blind $0.25
*** HOLE CARDS ***
/FyMUX+W/tpNFcRWbUTJxQ: folds 
LGxBRjCRn6KlQ/6B4eoXbA: raises $0.50 to $0.75
uLP/lYn7oKq9xCChBXsXxw: folds 
PFNLAvMkr8qKc7xCiH0wTA: calls $0.75
HDDm1BkZtdsRyw2DJdqq6A: calls $0.75
+2kMBNpY4nF1qNCRd8SJLA: calls $0.75
aNpwfA31EREwO+ar4XzBCw: folds 
yyG4svzOpC1A+sUP/scg6w: folds 
cCjRCvseA9rZn7Xr+GCCHg: folds 
*** FLOP *** [5c 3c Ah]
LGxBRjCRn6KlQ/6B4eoXbA: bets $1
PFNLAvMkr8qKc7xCiH0wTA: folds 
HDDm1BkZtdsRyw2DJdqq6A: calls $1
+2kMBNpY4nF1qNCRd8SJLA: folds 
*** TURN *** [5c 3c Ah] [5d]
LGxBRjCRn6KlQ/6B4eoXbA: bets $1.50
HDDm1BkZtdsRyw2DJdqq6A: calls $1.50
*** RIVER *** [5c 3c Ah 5d] [Ks]
LGxBRjCRn6KlQ/6B4eoXbA: bets $16.10 and is all-in
HDDm1BkZtdsRyw2DJdqq6A: calls $16.10
*** SHOW DOWN ***
LGxBRjCRn6KlQ/6B4eoXbA: shows [5h 9s] (three of a kind, Fives)
HDDm1BkZtdsRyw2DJdqq6A: mucks hand 
LGxBRjCRn6KlQ/6B4eoXbA collected $38.55 from pot
LGxBRjCRn6KlQ/6B4eoXbA said, "lol"
*** SUMMARY ***
Total pot $40.55 | Rake $2 
Board [5c 3c Ah 5d Ks]
Seat 1: yyG4svzOpC1A+sUP/scg6w (small blind) folded before Flop
Seat 2: cCjRCvseA9rZn7Xr+GCCHg (big blind) folded before Flop
Seat 3: /FyMUX+W/tpNFcRWbUTJxQ folded before Flop (didn't bet)
Seat 4: LGxBRjCRn6KlQ/6B4eoXbA showed [5h 9s] and won ($38.55) with three of a kind, Fives
Seat 5: uLP/lYn7oKq9xCChBXsXxw folded before Flop (didn't bet)
Seat 6: PFNLAvMkr8qKc7xCiH0wTA folded on the Flop
Seat 7: HDDm1BkZtdsRyw2DJdqq6A mucked
Seat 8: +2kMBNpY4nF1qNCRd8SJLA folded on the Flop
Seat 9: aNpwfA31EREwO+ar4XzBCw (button) folded before Flop (didn't bet)




PokerStars Game #59941687262:  Hold'em No Limit ($0.10/$0.25) - 2009/07/01 1:43:00 ET
Table '50f2Xa1b1jp6cfdTAgXFIg' 9-max Seat #5 is the button
Seat 1: pplNliE3WonjkPRf+GZq2A ($28.05 in chips) 
Seat 2: qxWFg3MZuVyidB0SJh5ywg ($29.95 in chips) 
Seat 3: RSojRXQHk0IRANbJYopT9g ($22.40 in chips) 
Seat 4: ghNKXUBl/H+t83JF079ZBA ($28.10 in chips) 
Seat 5: C1w4aCCgQVVSgNijoEahAg ($11.65 in chips) 
Seat 6: tLcDklc2rBORNfixyRfVfw ($25 in chips) 
Seat 7: w1ukf8uPa4+WH561TtVRxA ($25 in chips) 
Seat 8: x+W5+3qsdY4Iszf0hoH+Aw ($14.90 in chips) 
Seat 9: gehe91e0IyVT0QU/XBkEyg ($25.15 in chips) 
tLcDklc2rBORNfixyRfVfw: posts small blind $0.10
w1ukf8uPa4+WH561TtVRxA: posts big blind $0.25
*** HOLE CARDS ***
x+W5+3qsdY4Iszf0hoH+Aw: folds 
gehe91e0IyVT0QU/XBkEyg: folds 
pplNliE3WonjkPRf+GZq2A: folds 
qxWFg3MZuVyidB0SJh5ywg: folds 
RSojRXQHk0IRANbJYopT9g: folds 
ghNKXUBl/H+t83JF079ZBA: folds 
C1w4aCCgQVVSgNijoEahAg: raises $0.25 to $0.50
tLcDklc2rBORNfixyRfVfw: folds 
w1ukf8uPa4+WH561TtVRxA: raises $0.50 to $1
C1w4aCCgQVVSgNijoEahAg: calls $0.50
*** FLOP *** [5c Th 2h]
w1ukf8uPa4+WH561TtVRxA: bets $1.50
C1w4aCCgQVVSgNijoEahAg: calls $1.50
*** TURN *** [5c Th 2h] [Td]
w1ukf8uPa4+WH561TtVRxA: checks 
C1w4aCCgQVVSgNijoEahAg: bets $0.75
w1ukf8uPa4+WH561TtVRxA: calls $0.75
*** RIVER *** [5c Th 2h Td] [7c]
w1ukf8uPa4+WH561TtVRxA: checks 
C1w4aCCgQVVSgNijoEahAg: bets $1.50
w1ukf8uPa4+WH561TtVRxA: calls $1.50
*** SHOW DOWN ***
C1w4aCCgQVVSgNijoEahAg: shows [Tc Kd] (three of a kind, Tens)
w1ukf8uPa4+WH561TtVRxA: mucks hand 
C1w4aCCgQVVSgNijoEahAg collected $9.15 from pot
*** SUMMARY ***
Total pot $9.60 | Rake $0.45 
Board [5c Th 2h Td 7c]
Seat 1: pplNliE3WonjkPRf+GZq2A folded before Flop (didn't bet)
Seat 2: qxWFg3MZuVyidB0SJh5ywg folded before Flop (didn't bet)
Seat 3: RSojRXQHk0IRANbJYopT9g folded before Flop (didn't bet)
Seat 4: ghNKXUBl/H+t83JF079ZBA folded before Flop (didn't bet)
Seat 5: C1w4aCCgQVVSgNijoEahAg (button) showed [Tc Kd] and won ($9.15) with three of a kind, Tens
Seat 6: tLcDklc2rBORNfixyRfVfw (small blind) folded before Flop
Seat 7: w1ukf8uPa4+WH561TtVRxA (big blind) mucked
Seat 8: x+W5+3qsdY4Iszf0hoH+Aw folded before Flop (didn't bet)
Seat 9: gehe91e0IyVT0QU/XBkEyg folded before Flop (didn't bet)




PokerStars Game #59941687516:  Hold'em No Limit ($0.10/$0.25) - 2009/07/01 1:43:00 ET
Table 'Is9eNmJA1KnBOw0lcVkxUQ' 9-max Seat #8 is the button
Seat 1: 56S3mA6Zs3pGR+0p0vUCtg ($32 in chips) 
Seat 2: VllYilcih0t+gMD4GTRlgQ ($37.85 in chips) 
Seat 3: ubsjZomMWSV0hAiBLa7K1A ($19.75 in chips) 
Seat 4: cZ99hugmLBj9KhTlc8nCSw ($25 in chips) 
Seat 6: HapyJHxV6lc3eqoT7yWL2A ($32.85 in chips) 
Seat 7: aNpwfA31EREwO+ar4XzBCw ($29.05 in chips) 
Seat 8: Th3FldXKQW6hWVVPahaoOQ ($25.50 in chips) 
Seat 9: DdPXdieucQ+n99u1n3A+rQ ($5 in chips) 
DdPXdieucQ+n99u1n3A+rQ: posts small blind $0.10
56S3mA6Zs3pGR+0p0vUCtg: posts big blind $0.25
Qduu7ikeizo6q6Ei9YvcJA: sits out 
*** HOLE CARDS ***
VllYilcih0t+gMD4GTRlgQ: folds 
ubsjZomMWSV0hAiBLa7K1A: folds 
cZ99hugmLBj9KhTlc8nCSw: folds 
HapyJHxV6lc3eqoT7yWL2A: folds 
aNpwfA31EREwO+ar4XzBCw: folds 
Th3FldXKQW6hWVVPahaoOQ: folds 
DdPXdieucQ+n99u1n3A+rQ: folds 
Uncalled bet ($0.15) returned to 56S3mA6Zs3pGR+0p0vUCtg
56S3mA6Zs3pGR+0p0vUCtg collected $0.20 from pot
56S3mA6Zs3pGR+0p0vUCtg: doesn't show hand 
*** SUMMARY ***
Total pot $0.20 | Rake $0 
Seat 1: 56S3mA6Zs3pGR+0p0vUCtg (big blind) collected ($0.20)
Seat 2: VllYilcih0t+gMD4GTRlgQ folded before Flop (didn't bet)
Seat 3: ubsjZomMWSV0hAiBLa7K1A folded before Flop (didn't bet)
Seat 4: cZ99hugmLBj9KhTlc8nCSw folded before Flop (didn't bet)
Seat 6: HapyJHxV6lc3eqoT7yWL2A folded before Flop (didn't bet)
Seat 7: aNpwfA31EREwO+ar4XzBCw folded before Flop (didn't bet)
Seat 8: Th3FldXKQW6hWVVPahaoOQ (button) folded before Flop (didn't bet)
Seat 9: DdPXdieucQ+n99u1n3A+rQ (small blind) folded before Flop




PokerStars Game #59941687056:  Hold'em No Limit ($0.10/$0.25) - 2009/07/01 1:43:00 ET
Table 'QegsWX65l3n/K0A8XB78yg' 6-max Seat #6 is the button
Seat 1: p6adJRMXMBLr+xtQzqazIQ ($13.75 in chips) 
Seat 2: GC/9yVD59DUCX7hUI7gcLw ($50.90 in chips) 
Seat 5: OMGl+YMGogf2JWIRfT2/Yg ($9.90 in chips) 
Seat 6: 5PWs02z65jSO5pr/M6wx/w ($4.50 in chips) 
p6adJRMXMBLr+xtQzqazIQ: posts small blind $0.10
GC/9yVD59DUCX7hUI7gcLw: posts big blind $0.25
epAUIB7h2FJXzUPRIvSkRA: sits out 
*** HOLE CARDS ***
1lxYIAoJdZwAbzIkzWmSkw leaves the table
OMGl+YMGogf2JWIRfT2/Yg: raises $0.25 to $0.50
5PWs02z65jSO5pr/M6wx/w: raises $0.25 to $0.75
p6adJRMXMBLr+xtQzqazIQ: folds 
GC/9yVD59DUCX7hUI7gcLw: folds 
OMGl+YMGogf2JWIRfT2/Yg: calls $0.25
*** FLOP *** [Kh Ac 9h]
OMGl+YMGogf2JWIRfT2/Yg: bets $0.50
5PWs02z65jSO5pr/M6wx/w: calls $0.50
*** TURN *** [Kh Ac 9h] [7h]
OMGl+YMGogf2JWIRfT2/Yg: bets $0.50
5PWs02z65jSO5pr/M6wx/w: calls $0.50
*** RIVER *** [Kh Ac 9h 7h] [5c]
OMGl+YMGogf2JWIRfT2/Yg: checks 
5PWs02z65jSO5pr/M6wx/w: checks 
*** SHOW DOWN ***
OMGl+YMGogf2JWIRfT2/Yg: shows [8c As] (a pair of Aces)
5PWs02z65jSO5pr/M6wx/w: mucks hand 
OMGl+YMGogf2JWIRfT2/Yg collected $3.70 from pot
iIgNoBh+3/Ix1/fLsg+HuA joins the table at seat #3 
*** SUMMARY ***
Total pot $3.85 | Rake $0.15 
Board [Kh Ac 9h 7h 5c]
Seat 1: p6adJRMXMBLr+xtQzqazIQ (small blind) folded before Flop
Seat 2: GC/9yVD59DUCX7hUI7gcLw (big blind) folded before Flop
Seat 5: OMGl+YMGogf2JWIRfT2/Yg showed [8c As] and won ($3.70) with a pair of Aces
Seat 6: 5PWs02z65jSO5pr/M6wx/w (button) mucked




PokerStars Game #59941687506:  Hold'em No Limit ($0.10/$0.25) - 2009/07/01 1:43:00 ET
Table 'FuFyQHmlO/QqQp//rDRrPg' 6-max Seat #1 is the button
Seat 1: jp34e617tIzV8tKIWmfAbA ($27.40 in chips) 
Seat 2: G3h3THGB1j3qdHDVHpnJWg ($22.90 in chips) 
Seat 3: EeUZtMU058v2ObUACOF4Og ($30.60 in chips) 
Seat 5: xrf8tAXKQHG99HixCot1Iw ($25.60 in chips) 
Seat 6: 6DwBRH+xZ12AAZmeAg+aXw ($57.55 in chips) 
G3h3THGB1j3qdHDVHpnJWg: posts small blind $0.10
EeUZtMU058v2ObUACOF4Og: posts big blind $0.25
Ahsa9Yk5NPmCqQstq1EoQA: sits out 
*** HOLE CARDS ***
xrf8tAXKQHG99HixCot1Iw: folds 
6DwBRH+xZ12AAZmeAg+aXw: raises $0.50 to $0.75
jp34e617tIzV8tKIWmfAbA: folds 
G3h3THGB1j3qdHDVHpnJWg: calls $0.65
EeUZtMU058v2ObUACOF4Og: folds 
*** FLOP *** [Ac Ts Qc]
G3h3THGB1j3qdHDVHpnJWg: bets $0.75
6DwBRH+xZ12AAZmeAg+aXw: raises $1.50 to $2.25
G3h3THGB1j3qdHDVHpnJWg: calls $1.50
*** TURN *** [Ac Ts Qc] [9d]
G3h3THGB1j3qdHDVHpnJWg: bets $0.75
6DwBRH+xZ12AAZmeAg+aXw: raises $4.25 to $5
G3h3THGB1j3qdHDVHpnJWg: calls $4.25
*** RIVER *** [Ac Ts Qc 9d] [Ad]
G3h3THGB1j3qdHDVHpnJWg: bets $2.25
6DwBRH+xZ12AAZmeAg+aXw: folds 
Uncalled bet ($2.25) returned to G3h3THGB1j3qdHDVHpnJWg
G3h3THGB1j3qdHDVHpnJWg collected $15.50 from pot
*** SUMMARY ***
Total pot $16.25 | Rake $0.75 
Board [Ac Ts Qc 9d Ad]
Seat 1: jp34e617tIzV8tKIWmfAbA (button) folded before Flop (didn't bet)
Seat 2: G3h3THGB1j3qdHDVHpnJWg (small blind) collected ($15.50)
Seat 3: EeUZtMU058v2ObUACOF4Og (big blind) folded before Flop
Seat 5: xrf8tAXKQHG99HixCot1Iw folded before Flop (didn't bet)
Seat 6: 6DwBRH+xZ12AAZmeAg+aXw folded on the River




PokerStars Game #59941687354:  Hold'em No Limit ($0.10/$0.25) - 2009/07/01 1:43:00 ET
Table 'AJGgX1ZYM8d68SWMvaLttg' 6-max Seat #2 is the button
Seat 2: zHHLkD2sRljslKKeQv/ZQw ($28.25 in chips) 
Seat 3: 8ClCHtFXGNplITm+63KB+Q ($36.95 in chips) 
Seat 4: Lz/GjRDgmgepqTR7qmS86w ($25.40 in chips) 
Seat 5: Hsvkc0/G2VV78oVmWYXecw ($5.35 in chips) 
Seat 6: UA5OsKS3VPaxa7uC8La/kA ($64.40 in chips) 
8ClCHtFXGNplITm+63KB+Q: posts small blind $0.10
Lz/GjRDgmgepqTR7qmS86w: posts big blind $0.25
*** HOLE CARDS ***
Hsvkc0/G2VV78oVmWYXecw: folds 
UA5OsKS3VPaxa7uC8La/kA: folds 
zHHLkD2sRljslKKeQv/ZQw: raises $0.50 to $0.75
8ClCHtFXGNplITm+63KB+Q: folds 
Lz/GjRDgmgepqTR7qmS86w: folds 
Uncalled bet ($0.50) returned to zHHLkD2sRljslKKeQv/ZQw
zHHLkD2sRljslKKeQv/ZQw collected $0.60 from pot
*** SUMMARY ***
Total pot $0.60 | Rake $0 
Seat 2: zHHLkD2sRljslKKeQv/ZQw (button) collected ($0.60)
Seat 3: 8ClCHtFXGNplITm+63KB+Q (small blind) folded before Flop
Seat 4: Lz/GjRDgmgepqTR7qmS86w (big blind) folded before Flop
Seat 5: Hsvkc0/G2VV78oVmWYXecw folded before Flop (didn't bet)
Seat 6: UA5OsKS3VPaxa7uC8La/kA folded before Flop (didn't bet)




PokerStars Game #59941687438:  Hold'em No Limit ($0.10/$0.25) - 2009/07/01 1:43:00 ET
Table '9iHhO6FyZVM8XpSc23TIgg' 6-max Seat #1 is the button
Seat 1: NhUN/JpAprdJeamFBgJH1w ($37.40 in chips) 
Seat 2: bJFzs6QmEEnz4miMfSDtcg ($40.90 in chips) 
Seat 3: TSmua8tGK3sTbwi0ynrW9Q ($26.85 in chips) 
Seat 4: cfJccEfyn6IkquPN08hFsA ($61.10 in chips) 
Seat 5: xrf8tAXKQHG99HixCot1Iw ($21.80 in chips) 
Seat 6: iyZxqznXjv3vtvOJymkoLQ ($34.10 in chips) 
bJFzs6QmEEnz4miMfSDtcg: posts small blind $0.10
TSmua8tGK3sTbwi0ynrW9Q: posts big blind $0.25
*** HOLE CARDS ***
cfJccEfyn6IkquPN08hFsA: calls $0.25
xrf8tAXKQHG99HixCot1Iw: raises $0.75 to $1
iyZxqznXjv3vtvOJymkoLQ: folds 
NhUN/JpAprdJeamFBgJH1w: folds 
bJFzs6QmEEnz4miMfSDtcg: folds 
TSmua8tGK3sTbwi0ynrW9Q: folds 
cfJccEfyn6IkquPN08hFsA: raises $2 to $3
xrf8tAXKQHG99HixCot1Iw: raises $5 to $8
cfJccEfyn6IkquPN08hFsA: calls $5
*** FLOP *** [9s 7h Qc]
cfJccEfyn6IkquPN08hFsA: bets $10.25
xrf8tAXKQHG99HixCot1Iw: raises $3.55 to $13.80 and is all-in
cfJccEfyn6IkquPN08hFsA: calls $3.55
*** TURN *** [9s 7h Qc] [6s]
*** RIVER *** [9s 7h Qc 6s] [2d]
*** SHOW DOWN ***
cfJccEfyn6IkquPN08hFsA: shows [Td Tc] (a pair of Tens)
xrf8tAXKQHG99HixCot1Iw: shows [Jh Jd] (a pair of Jacks)
xrf8tAXKQHG99HixCot1Iw collected $41.80 from pot
*** SUMMARY ***
Total pot $43.95 | Rake $2.15 
Board [9s 7h Qc 6s 2d]
Seat 1: NhUN/JpAprdJeamFBgJH1w (button) folded before Flop (didn't bet)
Seat 2: bJFzs6QmEEnz4miMfSDtcg (small blind) folded before Flop
Seat 3: TSmua8tGK3sTbwi0ynrW9Q (big blind) folded before Flop
Seat 4: cfJccEfyn6IkquPN08hFsA showed [Td Tc] and lost with a pair of Tens
Seat 5: xrf8tAXKQHG99HixCot1Iw showed [Jh Jd] and won ($41.80) with a pair of Jacks
Seat 6: iyZxqznXjv3vtvOJymkoLQ folded before Flop (didn't bet)




PokerStars Game #59941687404:  Hold'em No Limit ($0.10/$0.25) - 2009/07/01 1:43:00 ET
Table 'JJzUs04lHpXg6nboT1/jeg' 6-max Seat #1 is the button
Seat 1: MqMK8OWPSY1V4stf1Hy5Jw ($38.95 in chips) 
Seat 2: jxfR29d+dK/7h7s3SvCk+g ($4.95 in chips) 
Seat 3: 4zXbHDe39qNX46dAo81b4w ($8.90 in chips) 
Seat 4: 7VfhiFY533nbUKvyEthASw ($29.85 in chips) 
Seat 5: QvTX2yGq3uKJiKPmns4TKQ ($20.75 in chips) 
Seat 6: wqphQtauX5Qn7WRJZS1flA ($29.30 in chips) 
jxfR29d+dK/7h7s3SvCk+g: posts small blind $0.10
4zXbHDe39qNX46dAo81b4w: posts big blind $0.25
*** HOLE CARDS ***
7VfhiFY533nbUKvyEthASw: folds 
QvTX2yGq3uKJiKPmns4TKQ: folds 
wqphQtauX5Qn7WRJZS1flA: folds 
MqMK8OWPSY1V4stf1Hy5Jw: folds 
jxfR29d+dK/7h7s3SvCk+g: raises $0.50 to $0.75
4zXbHDe39qNX46dAo81b4w: calls $0.50
*** FLOP *** [6s Js Ts]
jxfR29d+dK/7h7s3SvCk+g: checks 
4zXbHDe39qNX46dAo81b4w: bets $0.75
jxfR29d+dK/7h7s3SvCk+g: calls $0.75
*** TURN *** [6s Js Ts] [Qd]
jxfR29d+dK/7h7s3SvCk+g: bets $1.25
4zXbHDe39qNX46dAo81b4w: folds 
Uncalled bet ($1.25) returned to jxfR29d+dK/7h7s3SvCk+g
jxfR29d+dK/7h7s3SvCk+g collected $2.90 from pot
*** SUMMARY ***
Total pot $3 | Rake $0.10 
Board [6s Js Ts Qd]
Seat 1: MqMK8OWPSY1V4stf1Hy5Jw (button) folded before Flop (didn't bet)
Seat 2: jxfR29d+dK/7h7s3SvCk+g (small blind) collected ($2.90)
Seat 3: 4zXbHDe39qNX46dAo81b4w (big blind) folded on the Turn
Seat 4: 7VfhiFY533nbUKvyEthASw folded before Flop (didn't bet)
Seat 5: QvTX2yGq3uKJiKPmns4TKQ folded before Flop (didn't bet)
Seat 6: wqphQtauX5Qn7WRJZS1flA folded before Flop (didn't bet)




PokerStars Game #59941687082:  Hold'em No Limit ($0.10/$0.25) - 2009/07/01 1:43:00 ET
Table 'LG9H161ZAHDkOww+ih3Ptg' 6-max Seat #6 is the button
Seat 1: avl8CO/tc0F6eVSiB/KNRA ($24.85 in chips) 
Seat 2: kwsRmpZ1ZaLooISs+zfyKg ($25.45 in chips) 
Seat 3: 5Evvx7UYqXTBuvIc/9s/hA ($16.70 in chips) 
Seat 4: 0C28L4/59aRNtHoBhqTcLg ($59.05 in chips) 
Seat 5: lYjWCpfCxX2kgcHY3v4Yow ($30.10 in chips) 
Seat 6: v8m8XHovI5tqEA9mvplDSw ($27.15 in chips) 
avl8CO/tc0F6eVSiB/KNRA: posts small blind $0.10
kwsRmpZ1ZaLooISs+zfyKg: posts big blind $0.25
*** HOLE CARDS ***
5Evvx7UYqXTBuvIc/9s/hA: raises $0.50 to $0.75
0C28L4/59aRNtHoBhqTcLg: calls $0.75
lYjWCpfCxX2kgcHY3v4Yow: folds 
v8m8XHovI5tqEA9mvplDSw: calls $0.75
avl8CO/tc0F6eVSiB/KNRA: folds 
kwsRmpZ1ZaLooISs+zfyKg: folds 
*** FLOP *** [4s 2s Ad]
5Evvx7UYqXTBuvIc/9s/hA: checks 
0C28L4/59aRNtHoBhqTcLg: bets $0.85
v8m8XHovI5tqEA9mvplDSw: folds 
5Evvx7UYqXTBuvIc/9s/hA: folds 
Uncalled bet ($0.85) returned to 0C28L4/59aRNtHoBhqTcLg
0C28L4/59aRNtHoBhqTcLg collected $2.50 from pot
*** SUMMARY ***
Total pot $2.60 | Rake $0.10 
Board [4s 2s Ad]
Seat 1: avl8CO/tc0F6eVSiB/KNRA (small blind) folded before Flop
Seat 2: kwsRmpZ1ZaLooISs+zfyKg (big blind) folded before Flop
Seat 3: 5Evvx7UYqXTBuvIc/9s/hA folded on the Flop
Seat 4: 0C28L4/59aRNtHoBhqTcLg collected ($2.50)
Seat 5: lYjWCpfCxX2kgcHY3v4Yow folded before Flop (didn't bet)
Seat 6: v8m8XHovI5tqEA9mvplDSw (button) folded on the Flop




PokerStars Game #59941687098:  Hold'em No Limit ($0.10/$0.25) - 2009/07/01 1:43:00 ET
Table '29D3eoQzK5kOAT0OIDS2uQ' 6-max Seat #3 is the button
Seat 1: kG34n23qFQA3nzdOJTQ1dA ($46.15 in chips) 
Seat 2: FyE+TQ5JcCqI/tCCHf0jGA ($16.65 in chips) 
Seat 3: z3tQwy28dp5FykDJC/wzQw ($17.80 in chips) 
Seat 4: MqMK8OWPSY1V4stf1Hy5Jw ($36 in chips) 
Seat 5: Q3EMN7b0ie81AFWkDrhCjw ($24.40 in chips) 
Seat 6: bWbV4MVB/vVpiES1Ut4hew ($29.20 in chips) 
MqMK8OWPSY1V4stf1Hy5Jw: posts small blind $0.10
Q3EMN7b0ie81AFWkDrhCjw: posts big blind $0.25
FyE+TQ5JcCqI/tCCHf0jGA: posts small & big blinds $0.35
*** HOLE CARDS ***
bWbV4MVB/vVpiES1Ut4hew: raises $1.25 to $1.50
kG34n23qFQA3nzdOJTQ1dA: folds 
FyE+TQ5JcCqI/tCCHf0jGA: folds 
z3tQwy28dp5FykDJC/wzQw: folds 
MqMK8OWPSY1V4stf1Hy5Jw: folds 
Q3EMN7b0ie81AFWkDrhCjw: folds 
Uncalled bet ($1.25) returned to bWbV4MVB/vVpiES1Ut4hew
bWbV4MVB/vVpiES1Ut4hew collected $0.95 from pot
bWbV4MVB/vVpiES1Ut4hew: doesn't show hand 
*** SUMMARY ***
Total pot $0.95 | Rake $0 
Seat 1: kG34n23qFQA3nzdOJTQ1dA folded before Flop (didn't bet)
Seat 2: FyE+TQ5JcCqI/tCCHf0jGA folded before Flop
Seat 3: z3tQwy28dp5FykDJC/wzQw (button) folded before Flop (didn't bet)
Seat 4: MqMK8OWPSY1V4stf1Hy5Jw (small blind) folded before Flop
Seat 5: Q3EMN7b0ie81AFWkDrhCjw (big blind) folded before Flop
Seat 6: bWbV4MVB/vVpiES1Ut4hew collected ($0.95)




PokerStars Game #59941687198:  Hold'em No Limit ($0.10/$0.25) - 2009/07/01 1:43:00 ET
Table 'R5qKG21jwFDYRcOht9qwqQ' 9-max Seat #9 is the button
Seat 3: M2QO2DxB5Wawg2h8HSpnYA ($13.10 in chips) 
Seat 4: z5GxcHlYz/GSz6W2uFiTtg ($40.85 in chips) 
Seat 5: zUXhymECc2C9W9ZNw6qppA ($9.65 in chips) 
Seat 6: EP17SQz/iWcuYdNOGeBgkw ($16 in chips) 
Seat 8: tYsOBqdU1+x+yFI7zHO7hQ ($35.05 in chips) 
Seat 9: MG90wfSJZnOejs/KD3vlQQ ($31 in chips) 
N6foVRyErHqcNmshkqextQ will be allowed to play after the button
M2QO2DxB5Wawg2h8HSpnYA: posts small blind $0.10
z5GxcHlYz/GSz6W2uFiTtg: posts big blind $0.25
zgi+EUykT/pZQpoUG6+oEg: sits out 
*** HOLE CARDS ***
zUXhymECc2C9W9ZNw6qppA: folds 
EP17SQz/iWcuYdNOGeBgkw: calls $0.25
tYsOBqdU1+x+yFI7zHO7hQ: folds 
MG90wfSJZnOejs/KD3vlQQ: folds 
N6foVRyErHqcNmshkqextQ was removed from the table for failing to post
M2QO2DxB5Wawg2h8HSpnYA: folds 
WPT_Champ111 joins the table at seat #1 
z5GxcHlYz/GSz6W2uFiTtg: checks 
*** FLOP *** [Tc 8d Ks]
N6foVRyErHqcNmshkqextQ joins the table at seat #2 
z5GxcHlYz/GSz6W2uFiTtg: checks 
EP17SQz/iWcuYdNOGeBgkw: checks 
*** TURN *** [Tc 8d Ks] [Jd]
z5GxcHlYz/GSz6W2uFiTtg: bets $0.50
EP17SQz/iWcuYdNOGeBgkw: folds 
Uncalled bet ($0.50) returned to z5GxcHlYz/GSz6W2uFiTtg
z5GxcHlYz/GSz6W2uFiTtg collected $0.60 from pot
z5GxcHlYz/GSz6W2uFiTtg is sitting out
*** SUMMARY ***
Total pot $0.60 | Rake $0 
Board [Tc 8d Ks Jd]
Seat 3: M2QO2DxB5Wawg2h8HSpnYA (small blind) folded before Flop
Seat 4: z5GxcHlYz/GSz6W2uFiTtg (big blind) collected ($0.60)
Seat 5: zUXhymECc2C9W9ZNw6qppA folded before Flop (didn't bet)
Seat 6: EP17SQz/iWcuYdNOGeBgkw folded on the Turn
Seat 8: tYsOBqdU1+x+yFI7zHO7hQ folded before Flop (didn't bet)
Seat 9: MG90wfSJZnOejs/KD3vlQQ (button) folded before Flop (didn't bet)




PokerStars Game #59941688022:  Hold'em No Limit ($0.10/$0.25) - 2009/07/01 1:43:01 ET
Table 'rjcb+nlE+0GuJ6lBhuCkkA' 6-max Seat #2 is the button
Seat 1: lBoEwOFgzcERLIRUkUoRTw ($13.60 in chips) 
Seat 2: lJphax9e7/+O/3YCKPJ0yQ ($6.35 in chips) 
Seat 3: 8ClCHtFXGNplITm+63KB+Q ($66.25 in chips) 
Seat 4: BV+K0Phf5VBHr7aZPKqbUQ ($25 in chips) 
Seat 5: GC/9yVD59DUCX7hUI7gcLw ($41.75 in chips) 
Seat 6: 32YL2ZEp8NT4JB2RVM9euQ ($15.65 in chips) 
8ClCHtFXGNplITm+63KB+Q: posts small blind $0.10
BV+K0Phf5VBHr7aZPKqbUQ: posts big blind $0.25
*** HOLE CARDS ***
GC/9yVD59DUCX7hUI7gcLw: folds 
32YL2ZEp8NT4JB2RVM9euQ: folds 
lBoEwOFgzcERLIRUkUoRTw: folds 
lJphax9e7/+O/3YCKPJ0yQ: folds 
8ClCHtFXGNplITm+63KB+Q: folds 
Uncalled bet ($0.15) returned to BV+K0Phf5VBHr7aZPKqbUQ
BV+K0Phf5VBHr7aZPKqbUQ collected $0.20 from pot
BV+K0Phf5VBHr7aZPKqbUQ: doesn't show hand 
*** SUMMARY ***
Total pot $0.20 | Rake $0 
Seat 1: lBoEwOFgzcERLIRUkUoRTw folded before Flop (didn't bet)
Seat 2: lJphax9e7/+O/3YCKPJ0yQ (button) folded before Flop (didn't bet)
Seat 3: 8ClCHtFXGNplITm+63KB+Q (small blind) folded before Flop
Seat 4: BV+K0Phf5VBHr7aZPKqbUQ (big blind) collected ($0.20)
Seat 5: GC/9yVD59DUCX7hUI7gcLw folded before Flop (didn't bet)
Seat 6: 32YL2ZEp8NT4JB2RVM9euQ folded before Flop (didn't bet)




PokerStars Game #59941687602:  Hold'em No Limit ($0.10/$0.25) - 2009/07/01 1:43:01 ET
Table 'Mef6A0EMopL6WaFO5/KO9g' 6-max Seat #6 is the button
Seat 1: GbCVUNssQ7mqsPWr7J4d3w ($4.40 in chips) 
Seat 2: 8ClCHtFXGNplITm+63KB+Q ($30.90 in chips) 
Seat 3: Wq26opBLDGJe91GRJn2epg ($15.55 in chips) 
Seat 4: lquriepNQBhDV5P1SWHhnA ($25 in chips) 
Seat 5: DihMHaz4WNETH1bPDe13kA ($25 in chips) 
Seat 6: jp34e617tIzV8tKIWmfAbA ($33.30 in chips) 
GbCVUNssQ7mqsPWr7J4d3w: posts small blind $0.10
8ClCHtFXGNplITm+63KB+Q: posts big blind $0.25
*** HOLE CARDS ***
Wq26opBLDGJe91GRJn2epg: folds 
lquriepNQBhDV5P1SWHhnA: folds 
DihMHaz4WNETH1bPDe13kA: folds 
jp34e617tIzV8tKIWmfAbA: folds 
GbCVUNssQ7mqsPWr7J4d3w: folds 
Uncalled bet ($0.15) returned to 8ClCHtFXGNplITm+63KB+Q
8ClCHtFXGNplITm+63KB+Q collected $0.20 from pot
8ClCHtFXGNplITm+63KB+Q: doesn't show hand 
*** SUMMARY ***
Total pot $0.20 | Rake $0 
Seat 1: GbCVUNssQ7mqsPWr7J4d3w (small blind) folded before Flop
Seat 2: 8ClCHtFXGNplITm+63KB+Q (big blind) collected ($0.20)
Seat 3: Wq26opBLDGJe91GRJn2epg folded before Flop (didn't bet)
Seat 4: lquriepNQBhDV5P1SWHhnA folded before Flop (didn't bet)
Seat 5: DihMHaz4WNETH1bPDe13kA folded before Flop (didn't bet)
Seat 6: jp34e617tIzV8tKIWmfAbA (button) folded before Flop (didn't bet)




PokerStars Game #59941688008:  Hold'em No Limit ($0.10/$0.25) - 2009/07/01 1:43:01 ET
Table '4ZbiE0ZYjzqmgu6+sO1prg' 9-max Seat #9 is the button
Seat 2: 9lvO/qyU+xrU95Teu1fv0g ($5.30 in chips) 
Seat 3: HPEB+AtKw1+C/cxU0o1ciw ($25.55 in chips) 
Seat 4: w1ukf8uPa4+WH561TtVRxA ($25 in chips) 
Seat 5: +2kMBNpY4nF1qNCRd8SJLA ($43.95 in chips) 
Seat 7: aNpwfA31EREwO+ar4XzBCw ($25.95 in chips) 
Seat 8: cZ99hugmLBj9KhTlc8nCSw ($29.60 in chips) 
Seat 9: RCqMONFrSPSArZh2Jsar/w ($20.35 in chips) 
eXiRSFoUjkV5taBc4N8rMQ will be allowed to play after the button
9lvO/qyU+xrU95Teu1fv0g: posts small blind $0.10
HPEB+AtKw1+C/cxU0o1ciw: posts big blind $0.25
*** HOLE CARDS ***
w1ukf8uPa4+WH561TtVRxA: folds 
+2kMBNpY4nF1qNCRd8SJLA: folds 
aNpwfA31EREwO+ar4XzBCw: raises $0.75 to $1
cZ99hugmLBj9KhTlc8nCSw: folds 
RCqMONFrSPSArZh2Jsar/w: folds 
9lvO/qyU+xrU95Teu1fv0g: folds 
HPEB+AtKw1+C/cxU0o1ciw: folds 
Uncalled bet ($0.75) returned to aNpwfA31EREwO+ar4XzBCw
aNpwfA31EREwO+ar4XzBCw collected $0.60 from pot
aNpwfA31EREwO+ar4XzBCw: doesn't show hand 
*** SUMMARY ***
Total pot $0.60 | Rake $0 
Seat 2: 9lvO/qyU+xrU95Teu1fv0g (small blind) folded before Flop
Seat 3: HPEB+AtKw1+C/cxU0o1ciw (big blind) folded before Flop
Seat 4: w1ukf8uPa4+WH561TtVRxA folded before Flop (didn't bet)
Seat 5: +2kMBNpY4nF1qNCRd8SJLA folded before Flop (didn't bet)
Seat 7: aNpwfA31EREwO+ar4XzBCw collected ($0.60)
Seat 8: cZ99hugmLBj9KhTlc8nCSw folded before Flop (didn't bet)
Seat 9: RCqMONFrSPSArZh2Jsar/w (button) folded before Flop (didn't bet)




PokerStars Game #59941687964:  Hold'em No Limit ($0.10/$0.25) - 2009/07/01 1:43:01 ET
Table 'IIO2q2znuuAXmiZ2qFTcmg' 6-max Seat #5 is the button
Seat 2: cS21pIxRHx5Gt42o7hPZzw ($24.80 in chips) 
Seat 3: L3/N/gliETan8N5Gim5h4Q ($25 in chips) 
Seat 4: tSR4329m40dZsN7YOpI9Kw ($58.50 in chips) 
Seat 5: 9U3ZKjCsarN0DjR6mSE8Ug ($14 in chips) 
Seat 6: aogAb4Eienxztk8p2v9VVw ($36.85 in chips) 
aogAb4Eienxztk8p2v9VVw: posts small blind $0.10
2G0C7dp4wlPpE21FHjjElQ: is sitting out 
cS21pIxRHx5Gt42o7hPZzw: posts big blind $0.25
*** HOLE CARDS ***
L3/N/gliETan8N5Gim5h4Q: folds 
tSR4329m40dZsN7YOpI9Kw: folds 
9U3ZKjCsarN0DjR6mSE8Ug: folds 
aogAb4Eienxztk8p2v9VVw: raises $0.75 to $1
cS21pIxRHx5Gt42o7hPZzw: folds 
Uncalled bet ($0.75) returned to aogAb4Eienxztk8p2v9VVw
aogAb4Eienxztk8p2v9VVw collected $0.50 from pot
aogAb4Eienxztk8p2v9VVw: doesn't show hand 
*** SUMMARY ***
Total pot $0.50 | Rake $0 
Seat 2: cS21pIxRHx5Gt42o7hPZzw (big blind) folded before Flop
Seat 3: L3/N/gliETan8N5Gim5h4Q folded before Flop (didn't bet)
Seat 4: tSR4329m40dZsN7YOpI9Kw folded before Flop (didn't bet)
Seat 5: 9U3ZKjCsarN0DjR6mSE8Ug (button) folded before Flop (didn't bet)
Seat 6: aogAb4Eienxztk8p2v9VVw (small blind) collected ($0.50)




PokerStars Game #59941688012:  Hold'em No Limit ($0.10/$0.25) - 2009/07/01 1:43:01 ET
Table 'YYMg5qzxK1m9eGRo4SbxtQ' 9-max Seat #8 is the button
Seat 1: 3PmVnC/15cl4oyI1TKIt4g ($5 in chips) 
Seat 2: f/H6PsHRl4W1JyNsEDvPtg ($8.60 in chips) 
Seat 4: ROxrieegd9WYtWcUKJAlbg ($15 in chips) 
Seat 8: xoBFd/5k+L/pFn9VW1VyWg ($13.25 in chips) 
Seat 9: +sbyWwIcFp9kP0bDtMegfQ ($31.85 in chips) 
+sbyWwIcFp9kP0bDtMegfQ: posts small blind $0.10
3PmVnC/15cl4oyI1TKIt4g: posts big blind $0.25
ROxrieegd9WYtWcUKJAlbg: posts big blind $0.25
eebse2009: sits out 
*** HOLE CARDS ***
f/H6PsHRl4W1JyNsEDvPtg: calls $0.25
ROxrieegd9WYtWcUKJAlbg: checks 
xoBFd/5k+L/pFn9VW1VyWg: calls $0.25
+sbyWwIcFp9kP0bDtMegfQ: calls $0.15
3PmVnC/15cl4oyI1TKIt4g: checks 
*** FLOP *** [2h Ac 6s]
+sbyWwIcFp9kP0bDtMegfQ: checks 
3PmVnC/15cl4oyI1TKIt4g: checks 
f/H6PsHRl4W1JyNsEDvPtg: checks 
ROxrieegd9WYtWcUKJAlbg: checks 
xoBFd/5k+L/pFn9VW1VyWg: bets $0.75
+sbyWwIcFp9kP0bDtMegfQ: folds 
3PmVnC/15cl4oyI1TKIt4g: folds 
f/H6PsHRl4W1JyNsEDvPtg: folds 
ROxrieegd9WYtWcUKJAlbg: folds 
Uncalled bet ($0.75) returned to xoBFd/5k+L/pFn9VW1VyWg
xoBFd/5k+L/pFn9VW1VyWg collected $1.20 from pot
*** SUMMARY ***
Total pot $1.25 | Rake $0.05 
Board [2h Ac 6s]
Seat 1: 3PmVnC/15cl4oyI1TKIt4g (big blind) folded on the Flop
Seat 2: f/H6PsHRl4W1JyNsEDvPtg folded on the Flop
Seat 4: ROxrieegd9WYtWcUKJAlbg folded on the Flop
Seat 8: xoBFd/5k+L/pFn9VW1VyWg (button) collected ($1.20)
Seat 9: +sbyWwIcFp9kP0bDtMegfQ (small blind) folded on the Flop




PokerStars Game #59941687882:  Hold'em No Limit ($0.10/$0.25) - 2009/07/01 1:43:01 ET
Table 'ThBZ355rqvsb8UGb6ajbig' 9-max Seat #8 is the button
Seat 1: Z9W7+g1WMhhZDi7DwGbCFA ($5 in chips) 
Seat 2: 4awUyiDYTgylQKXZ9faBVA ($25.95 in chips) 
Seat 3: H5Se03ZqSX7tbULXur2MAg ($29.40 in chips) 
Seat 4: zgi+EUykT/pZQpoUG6+oEg ($4.65 in chips) 
Seat 5: cKlmpQMahVsmOaxFQDcoOg ($24.60 in chips) 
Seat 6: qwr38jl5txoR36M7G5qi4A ($9.65 in chips) 
Seat 7: zUXhymECc2C9W9ZNw6qppA ($16.85 in chips) 
Seat 8: PdIasPkzm2sqZnN41ZRXOg ($4.90 in chips) 
Seat 9: sD+TKtt36XiiN6jqHiLwDA ($23.95 in chips) 
sD+TKtt36XiiN6jqHiLwDA: posts small blind $0.10
Z9W7+g1WMhhZDi7DwGbCFA: posts big blind $0.25
*** HOLE CARDS ***
4awUyiDYTgylQKXZ9faBVA: folds 
H5Se03ZqSX7tbULXur2MAg: folds 
zgi+EUykT/pZQpoUG6+oEg: folds 
cKlmpQMahVsmOaxFQDcoOg: raises $0.50 to $0.75
qwr38jl5txoR36M7G5qi4A: folds 
zUXhymECc2C9W9ZNw6qppA: folds 
PdIasPkzm2sqZnN41ZRXOg: folds 
sD+TKtt36XiiN6jqHiLwDA: folds 
Z9W7+g1WMhhZDi7DwGbCFA: folds 
Uncalled bet ($0.50) returned to cKlmpQMahVsmOaxFQDcoOg
cKlmpQMahVsmOaxFQDcoOg collected $0.60 from pot
*** SUMMARY ***
Total pot $0.60 | Rake $0 
Seat 1: Z9W7+g1WMhhZDi7DwGbCFA (big blind) folded before Flop
Seat 2: 4awUyiDYTgylQKXZ9faBVA folded before Flop (didn't bet)
Seat 3: H5Se03ZqSX7tbULXur2MAg folded before Flop (didn't bet)
Seat 4: zgi+EUykT/pZQpoUG6+oEg folded before Flop (didn't bet)
Seat 5: cKlmpQMahVsmOaxFQDcoOg collected ($0.60)
Seat 6: qwr38jl5txoR36M7G5qi4A folded before Flop (didn't bet)
Seat 7: zUXhymECc2C9W9ZNw6qppA folded before Flop (didn't bet)
Seat 8: PdIasPkzm2sqZnN41ZRXOg (button) folded before Flop (didn't bet)
Seat 9: sD+TKtt36XiiN6jqHiLwDA (small blind) folded before Flop




PokerStars Game #59941688138:  Hold'em No Limit ($0.10/$0.25) - 2009/07/01 1:43:02 ET
Table 'KTZXQ4LREPjpS54R3DFTsw' 9-max Seat #9 is the button
Seat 1: dSjkBIV7Bv+ZCIWNBguf7w ($40.25 in chips) 
Seat 2: OlPJsgR4xypSg/w1z7Gyvw ($20 in chips) 
Seat 3: H5Se03ZqSX7tbULXur2MAg ($23.65 in chips) 
Seat 4: K0b5wNInj6hUGRr6yzKFtw ($64 in chips) 
Seat 5: HPEB+AtKw1+C/cxU0o1ciw ($29.95 in chips) 
Seat 6: Mh2r9hTeTEDnh19sRZtW3g ($5.70 in chips) 
Seat 7: yyG4svzOpC1A+sUP/scg6w ($10.95 in chips) 
Seat 8: X1ucS3BHyBPongKl1Q+eEQ ($18.85 in chips) 
Seat 9: V6p0jQ/RhUsqpHLmXvEX4Q ($13.10 in chips) 
dSjkBIV7Bv+ZCIWNBguf7w: posts small blind $0.10
OlPJsgR4xypSg/w1z7Gyvw: posts big blind $0.25
*** HOLE CARDS ***
H5Se03ZqSX7tbULXur2MAg: folds 
K0b5wNInj6hUGRr6yzKFtw: folds 
HPEB+AtKw1+C/cxU0o1ciw: folds 
Mh2r9hTeTEDnh19sRZtW3g: folds 
yyG4svzOpC1A+sUP/scg6w: folds 
X1ucS3BHyBPongKl1Q+eEQ: folds 
V6p0jQ/RhUsqpHLmXvEX4Q: raises $0.50 to $0.75
dSjkBIV7Bv+ZCIWNBguf7w: folds 
OlPJsgR4xypSg/w1z7Gyvw: folds 
Uncalled bet ($0.50) returned to V6p0jQ/RhUsqpHLmXvEX4Q
V6p0jQ/RhUsqpHLmXvEX4Q collected $0.60 from pot
*** SUMMARY ***
Total pot $0.60 | Rake $0 
Seat 1: dSjkBIV7Bv+ZCIWNBguf7w (small blind) folded before Flop
Seat 2: OlPJsgR4xypSg/w1z7Gyvw (big blind) folded before Flop
Seat 3: H5Se03ZqSX7tbULXur2MAg folded before Flop (didn't bet)
Seat 4: K0b5wNInj6hUGRr6yzKFtw folded before Flop (didn't bet)
Seat 5: HPEB+AtKw1+C/cxU0o1ciw folded before Flop (didn't bet)
Seat 6: Mh2r9hTeTEDnh19sRZtW3g folded before Flop (didn't bet)
Seat 7: yyG4svzOpC1A+sUP/scg6w folded before Flop (didn't bet)
Seat 8: X1ucS3BHyBPongKl1Q+eEQ folded before Flop (didn't bet)
Seat 9: V6p0jQ/RhUsqpHLmXvEX4Q (button) collected ($0.60)




PokerStars Game #59941688472:  Hold'em No Limit ($0.10/$0.25) - 2009/07/01 1:43:02 ET
Table 'pAhiNHs/spaABQia+7gWNQ' 9-max Seat #2 is the button
Seat 1: ipgcO7Pa6LC8XWpVttZfnA ($4.65 in chips) 
Seat 2: dfNim92Z6XK1/h5SFW5vDg ($25.25 in chips) 
Seat 3: xEQxarad8/T4jJdpZy5LGw ($35.15 in chips) 
Seat 4: Qduu7ikeizo6q6Ei9YvcJA ($25 in chips) 
Seat 5: OlPJsgR4xypSg/w1z7Gyvw ($32.90 in chips) 
Seat 6: oLa/tXLfSLLB28mcLGrxcg ($24.85 in chips) 
Seat 7: +WTkVY3GeLxqGQBbMZQiWQ ($5.90 in chips) 
Seat 8: PskTLlFIRHSp61inskRzVg ($14.90 in chips) 
Seat 9: zgi+EUykT/pZQpoUG6+oEg ($4.65 in chips) 
xEQxarad8/T4jJdpZy5LGw: posts small blind $0.10
Qduu7ikeizo6q6Ei9YvcJA: posts big blind $0.25
*** HOLE CARDS ***
OlPJsgR4xypSg/w1z7Gyvw: folds 
oLa/tXLfSLLB28mcLGrxcg: folds 
+WTkVY3GeLxqGQBbMZQiWQ: folds 
PskTLlFIRHSp61inskRzVg: calls $0.25
zgi+EUykT/pZQpoUG6+oEg: raises $1 to $1.25
ipgcO7Pa6LC8XWpVttZfnA: folds 
dfNim92Z6XK1/h5SFW5vDg: folds 
xEQxarad8/T4jJdpZy5LGw: folds 
Qduu7ikeizo6q6Ei9YvcJA: folds 
PskTLlFIRHSp61inskRzVg: calls $1
*** FLOP *** [8s 5c 3d]
PskTLlFIRHSp61inskRzVg: checks 
zgi+EUykT/pZQpoUG6+oEg: bets $1.75
PskTLlFIRHSp61inskRzVg: folds 
Uncalled bet ($1.75) returned to zgi+EUykT/pZQpoUG6+oEg
zgi+EUykT/pZQpoUG6+oEg collected $2.75 from pot
zgi+EUykT/pZQpoUG6+oEg: doesn't show hand 
*** SUMMARY ***
Total pot $2.85 | Rake $0.10 
Board [8s 5c 3d]
Seat 1: ipgcO7Pa6LC8XWpVttZfnA folded before Flop (didn't bet)
Seat 2: dfNim92Z6XK1/h5SFW5vDg (button) folded before Flop (didn't bet)
Seat 3: xEQxarad8/T4jJdpZy5LGw (small blind) folded before Flop
Seat 4: Qduu7ikeizo6q6Ei9YvcJA (big blind) folded before Flop
Seat 5: OlPJsgR4xypSg/w1z7Gyvw folded before Flop (didn't bet)
Seat 6: oLa/tXLfSLLB28mcLGrxcg folded before Flop (didn't bet)
Seat 7: +WTkVY3GeLxqGQBbMZQiWQ folded before Flop (didn't bet)
Seat 8: PskTLlFIRHSp61inskRzVg folded on the Flop
Seat 9: zgi+EUykT/pZQpoUG6+oEg collected ($2.75)




PokerStars Game #59941688582:  Hold'em No Limit ($0.10/$0.25) - 2009/07/01 1:43:02 ET
Table '3EebBlzq5yHSY2444L4zlg' 9-max Seat #2 is the button
Seat 1: XMSS6mD5B42I8wasdOMipQ ($29.15 in chips) 
Seat 2: b9UnopCOpq2MWP1DwqSO3Q ($17.95 in chips) 
Seat 3: IGbD5vKNhHe60dkdbjg/mw ($42.20 in chips) 
Seat 5: PFNLAvMkr8qKc7xCiH0wTA ($26.30 in chips) 
Seat 6: QEbIGci+itdw+re8RM5fZA ($50.35 in chips) 
Seat 7: DiSvPC2iudwL5j9u6Huyww ($49.10 in chips) 
Seat 8: dtZ84flFEi4Q+SGrHMJRDQ ($26.90 in chips) 
Seat 9: iZmSlSzYu5fJ67tDdQzymQ ($24.50 in chips) 
IGbD5vKNhHe60dkdbjg/mw: posts small blind $0.10
1S/fpm+f42V/6MNZre+ccg: is sitting out 
PFNLAvMkr8qKc7xCiH0wTA: posts big blind $0.25
*** HOLE CARDS ***
QEbIGci+itdw+re8RM5fZA: folds 
DiSvPC2iudwL5j9u6Huyww: calls $0.25
dtZ84flFEi4Q+SGrHMJRDQ: folds 
iZmSlSzYu5fJ67tDdQzymQ: calls $0.25
1S/fpm+f42V/6MNZre+ccg leaves the table
XMSS6mD5B42I8wasdOMipQ: folds 
b9UnopCOpq2MWP1DwqSO3Q: folds 
PdIasPkzm2sqZnN41ZRXOg joins the table at seat #4 
IGbD5vKNhHe60dkdbjg/mw: calls $0.15
PFNLAvMkr8qKc7xCiH0wTA: raises $0.50 to $0.75
DiSvPC2iudwL5j9u6Huyww: folds 
iZmSlSzYu5fJ67tDdQzymQ: calls $0.50
IGbD5vKNhHe60dkdbjg/mw: calls $0.50
*** FLOP *** [7c Kc 8d]
IGbD5vKNhHe60dkdbjg/mw: checks 
PFNLAvMkr8qKc7xCiH0wTA: bets $2
iZmSlSzYu5fJ67tDdQzymQ: raises $4 to $6
IGbD5vKNhHe60dkdbjg/mw: folds 
PFNLAvMkr8qKc7xCiH0wTA: folds 
Uncalled bet ($4) returned to iZmSlSzYu5fJ67tDdQzymQ
iZmSlSzYu5fJ67tDdQzymQ collected $6.20 from pot
iZmSlSzYu5fJ67tDdQzymQ: doesn't show hand 
*** SUMMARY ***
Total pot $6.50 | Rake $0.30 
Board [7c Kc 8d]
Seat 1: XMSS6mD5B42I8wasdOMipQ folded before Flop (didn't bet)
Seat 2: b9UnopCOpq2MWP1DwqSO3Q (button) folded before Flop (didn't bet)
Seat 3: IGbD5vKNhHe60dkdbjg/mw (small blind) folded on the Flop
Seat 5: PFNLAvMkr8qKc7xCiH0wTA (big blind) folded on the Flop
Seat 6: QEbIGci+itdw+re8RM5fZA folded before Flop (didn't bet)
Seat 7: DiSvPC2iudwL5j9u6Huyww folded before Flop
Seat 8: dtZ84flFEi4Q+SGrHMJRDQ folded before Flop (didn't bet)
Seat 9: iZmSlSzYu5fJ67tDdQzymQ collected ($6.20)




PokerStars Game #59941688584:  Hold'em No Limit ($0.10/$0.25) - 2009/07/01 1:43:02 ET
Table '+2VxGVfkEqJ1AYfQy/JH2w' 6-max Seat #4 is the button
Seat 1: if4dh6jhJXeN3/qd3qCp9g ($24.65 in chips) 
Seat 2: qllppsCmUqovlriIWCeM/g ($5.80 in chips) 
Seat 4: y+a/yGW/Jy4bPJFnaeTz5w ($16.60 in chips) 
Seat 5: XD1i5m5PvBDnRzJaG/vINw ($23.20 in chips) 
Seat 6: L3/N/gliETan8N5Gim5h4Q ($25 in chips) 
XD1i5m5PvBDnRzJaG/vINw: posts small blind $0.10
L3/N/gliETan8N5Gim5h4Q: posts big blind $0.25
epAUIB7h2FJXzUPRIvSkRA: sits out 
*** HOLE CARDS ***
if4dh6jhJXeN3/qd3qCp9g: folds 
qllppsCmUqovlriIWCeM/g: folds 
y+a/yGW/Jy4bPJFnaeTz5w: folds 
XD1i5m5PvBDnRzJaG/vINw: folds 
Uncalled bet ($0.15) returned to L3/N/gliETan8N5Gim5h4Q
L3/N/gliETan8N5Gim5h4Q collected $0.20 from pot
L3/N/gliETan8N5Gim5h4Q: doesn't show hand 
*** SUMMARY ***
Total pot $0.20 | Rake $0 
Seat 1: if4dh6jhJXeN3/qd3qCp9g folded before Flop (didn't bet)
Seat 2: qllppsCmUqovlriIWCeM/g folded before Flop (didn't bet)
Seat 4: y+a/yGW/Jy4bPJFnaeTz5w (button) folded before Flop (didn't bet)
Seat 5: XD1i5m5PvBDnRzJaG/vINw (small blind) folded before Flop
Seat 6: L3/N/gliETan8N5Gim5h4Q (big blind) collected ($0.20)




PokerStars Game #59941688210:  Hold'em No Limit ($0.10/$0.25) - 2009/07/01 1:43:02 ET
Table '63h13e5p7cWe02rClZ1CHw' 6-max Seat #5 is the button
Seat 1: pokjbbEcXXPlADXdSGHtZw ($18.75 in chips) 
Seat 2: k9nHZTHt8hYhYRcW8NTb4g ($30.05 in chips) 
Seat 3: mFv3iBCtrw9XfCDRB0d46Q ($5 in chips) 
Seat 4: xrf8tAXKQHG99HixCot1Iw ($23.70 in chips) 
Seat 5: iyZxqznXjv3vtvOJymkoLQ ($44.80 in chips) 
Seat 6: mfrkWA3PTeYPkbO6hi98Aw ($38.55 in chips) 
mfrkWA3PTeYPkbO6hi98Aw: posts small blind $0.10
pokjbbEcXXPlADXdSGHtZw: posts big blind $0.25
*** HOLE CARDS ***
k9nHZTHt8hYhYRcW8NTb4g: calls $0.25
mFv3iBCtrw9XfCDRB0d46Q: folds 
xrf8tAXKQHG99HixCot1Iw: folds 
iyZxqznXjv3vtvOJymkoLQ: folds 
mfrkWA3PTeYPkbO6hi98Aw: calls $0.15
pokjbbEcXXPlADXdSGHtZw: checks 
*** FLOP *** [Qd 3c Kh]
mfrkWA3PTeYPkbO6hi98Aw: checks 
pokjbbEcXXPlADXdSGHtZw: checks 
k9nHZTHt8hYhYRcW8NTb4g: checks 
*** TURN *** [Qd 3c Kh] [Jh]
mfrkWA3PTeYPkbO6hi98Aw: checks 
pokjbbEcXXPlADXdSGHtZw: checks 
k9nHZTHt8hYhYRcW8NTb4g: checks 
*** RIVER *** [Qd 3c Kh Jh] [3s]
mfrkWA3PTeYPkbO6hi98Aw: checks 
pokjbbEcXXPlADXdSGHtZw: checks 
k9nHZTHt8hYhYRcW8NTb4g: checks 
*** SHOW DOWN ***
mfrkWA3PTeYPkbO6hi98Aw: shows [6h Ah] (a pair of Threes)
pokjbbEcXXPlADXdSGHtZw: mucks hand 
k9nHZTHt8hYhYRcW8NTb4g: shows [As 7c] (a pair of Threes)
mfrkWA3PTeYPkbO6hi98Aw collected $0.40 from pot
k9nHZTHt8hYhYRcW8NTb4g collected $0.35 from pot
*** SUMMARY ***
Total pot $0.75 | Rake $0 
Board [Qd 3c Kh Jh 3s]
Seat 1: pokjbbEcXXPlADXdSGHtZw (big blind) mucked
Seat 2: k9nHZTHt8hYhYRcW8NTb4g showed [As 7c] and won ($0.35) with a pair of Threes
Seat 3: mFv3iBCtrw9XfCDRB0d46Q folded before Flop (didn't bet)
Seat 4: xrf8tAXKQHG99HixCot1Iw folded before Flop (didn't bet)
Seat 5: iyZxqznXjv3vtvOJymkoLQ (button) folded before Flop (didn't bet)
Seat 6: mfrkWA3PTeYPkbO6hi98Aw (small blind) showed [6h Ah] and won ($0.40) with a pair of Threes




PokerStars Game #59941688294:  Hold'em No Limit ($0.10/$0.25) - 2009/07/01 1:43:02 ET
Table 'ggwTHpIC5qhhHJSYjK1XCw' 6-max Seat #6 is the button
Seat 1: MqMK8OWPSY1V4stf1Hy5Jw ($78.95 in chips) 
Seat 2: /gJNBeCkWL4o85/jvlZ4BA ($27.20 in chips) 
Seat 3: SxIIgwXYLkwd6m3wLyPTCw ($66.15 in chips) 
Seat 4: JFIAqU8lCZ0vWwEl4bdGsg ($25.60 in chips) 
Seat 5: BvqhBa7W/To51LhEiIU/lw ($6.15 in chips) 
Seat 6: 732E3Iz0geWMK40ej+U9HA ($13.15 in chips) 
MqMK8OWPSY1V4stf1Hy5Jw: posts small blind $0.10
/gJNBeCkWL4o85/jvlZ4BA: posts big blind $0.25
*** HOLE CARDS ***
SxIIgwXYLkwd6m3wLyPTCw: raises $0.50 to $0.75
JFIAqU8lCZ0vWwEl4bdGsg: folds 
BvqhBa7W/To51LhEiIU/lw: calls $0.75
732E3Iz0geWMK40ej+U9HA: calls $0.75
MqMK8OWPSY1V4stf1Hy5Jw: folds 
/gJNBeCkWL4o85/jvlZ4BA: folds 
*** FLOP *** [Tc 9s Kh]
SxIIgwXYLkwd6m3wLyPTCw: bets $2
BvqhBa7W/To51LhEiIU/lw: folds 
732E3Iz0geWMK40ej+U9HA: calls $2
*** TURN *** [Tc 9s Kh] [3c]
SxIIgwXYLkwd6m3wLyPTCw: bets $3.50
732E3Iz0geWMK40ej+U9HA: folds 
Uncalled bet ($3.50) returned to SxIIgwXYLkwd6m3wLyPTCw
SxIIgwXYLkwd6m3wLyPTCw collected $6.30 from pot
SxIIgwXYLkwd6m3wLyPTCw: doesn't show hand 
*** SUMMARY ***
Total pot $6.60 | Rake $0.30 
Board [Tc 9s Kh 3c]
Seat 1: MqMK8OWPSY1V4stf1Hy5Jw (small blind) folded before Flop
Seat 2: /gJNBeCkWL4o85/jvlZ4BA (big blind) folded before Flop
Seat 3: SxIIgwXYLkwd6m3wLyPTCw collected ($6.30)
Seat 4: JFIAqU8lCZ0vWwEl4bdGsg folded before Flop (didn't bet)
Seat 5: BvqhBa7W/To51LhEiIU/lw folded on the Flop
Seat 6: 732E3Iz0geWMK40ej+U9HA (button) folded on the Turn




PokerStars Game #59941688378:  Hold'em No Limit ($0.10/$0.25) - 2009/07/01 1:43:02 ET
Table '6wawJ+MkkvuC3coG6r+Yhg' 6-max Seat #3 is the button
Seat 1: JQZew0FjzS19kTjeNtrE+A ($28.25 in chips) 
Seat 2: LtASJ9OlkqGrrUKGQlpGAw ($33.60 in chips) 
Seat 3: 3zD3qLXT1bEffAoWGnc7wg ($59.50 in chips) 
Seat 4: yxmjNFGiKI3b+XQGJzJVIg ($28.05 in chips) 
Seat 5: FZrgDbxAanC1xwZxXHJKVA ($3.20 in chips) 
Seat 6: B3X187C0tXFUfQpCu8pe8A ($27.10 in chips) 
yxmjNFGiKI3b+XQGJzJVIg: posts small blind $0.10
FZrgDbxAanC1xwZxXHJKVA: posts big blind $0.25
*** HOLE CARDS ***
B3X187C0tXFUfQpCu8pe8A: folds 
JQZew0FjzS19kTjeNtrE+A: folds 
LtASJ9OlkqGrrUKGQlpGAw: folds 
3zD3qLXT1bEffAoWGnc7wg: folds 
yxmjNFGiKI3b+XQGJzJVIg: raises $0.50 to $0.75
FZrgDbxAanC1xwZxXHJKVA: folds 
Uncalled bet ($0.50) returned to yxmjNFGiKI3b+XQGJzJVIg
yxmjNFGiKI3b+XQGJzJVIg collected $0.50 from pot
yxmjNFGiKI3b+XQGJzJVIg: doesn't show hand 
*** SUMMARY ***
Total pot $0.50 | Rake $0 
Seat 1: JQZew0FjzS19kTjeNtrE+A folded before Flop (didn't bet)
Seat 2: LtASJ9OlkqGrrUKGQlpGAw folded before Flop (didn't bet)
Seat 3: 3zD3qLXT1bEffAoWGnc7wg (button) folded before Flop (didn't bet)
Seat 4: yxmjNFGiKI3b+XQGJzJVIg (small blind) collected ($0.50)
Seat 5: FZrgDbxAanC1xwZxXHJKVA (big blind) folded before Flop
Seat 6: B3X187C0tXFUfQpCu8pe8A folded before Flop (didn't bet)




PokerStars Game #59941688374:  Hold'em No Limit ($0.10/$0.25) - 2009/07/01 1:43:02 ET
Table 'Pz8SfAzhP5nvWTsJRAxoDg' 6-max Seat #1 is the button
Seat 1: QiL+lEgEWwy21jk/ltaRLg ($25.55 in chips) 
Seat 2: xrf8tAXKQHG99HixCot1Iw ($25.60 in chips) 
Seat 3: mfrkWA3PTeYPkbO6hi98Aw ($28.20 in chips) 
Seat 4: 4lJto+Qj0K4JrFKvHaPTLw ($66.15 in chips) 
Seat 5: FYepjhAvF8ZdVCmqHIy+eQ ($28.40 in chips) 
Seat 6: QvTX2yGq3uKJiKPmns4TKQ ($24.65 in chips) 
xrf8tAXKQHG99HixCot1Iw: posts small blind $0.10
mfrkWA3PTeYPkbO6hi98Aw: posts big blind $0.25
*** HOLE CARDS ***
4lJto+Qj0K4JrFKvHaPTLw: folds 
FYepjhAvF8ZdVCmqHIy+eQ: folds 
QvTX2yGq3uKJiKPmns4TKQ: folds 
QiL+lEgEWwy21jk/ltaRLg: raises $0.50 to $0.75
xrf8tAXKQHG99HixCot1Iw: raises $2.25 to $3
mfrkWA3PTeYPkbO6hi98Aw: folds 
QiL+lEgEWwy21jk/ltaRLg: folds 
Uncalled bet ($2.25) returned to xrf8tAXKQHG99HixCot1Iw
xrf8tAXKQHG99HixCot1Iw collected $1.75 from pot
xrf8tAXKQHG99HixCot1Iw: doesn't show hand 
*** SUMMARY ***
Total pot $1.75 | Rake $0 
Seat 1: QiL+lEgEWwy21jk/ltaRLg (button) folded before Flop
Seat 2: xrf8tAXKQHG99HixCot1Iw (small blind) collected ($1.75)
Seat 3: mfrkWA3PTeYPkbO6hi98Aw (big blind) folded before Flop
Seat 4: 4lJto+Qj0K4JrFKvHaPTLw folded before Flop (didn't bet)
Seat 5: FYepjhAvF8ZdVCmqHIy+eQ folded before Flop (didn't bet)
Seat 6: QvTX2yGq3uKJiKPmns4TKQ folded before Flop (didn't bet)




PokerStars Game #59941689164:  Hold'em No Limit ($0.10/$0.25) - 2009/07/01 1:43:03 ET
Table '5SUMWYuPsGiOD0FY0QbgOw' 6-max Seat #4 is the button
Seat 1: SFmT9ZsVopnukjvAzrxTRg ($25 in chips) 
Seat 2: xrf8tAXKQHG99HixCot1Iw ($36.55 in chips) 
Seat 3: MqMK8OWPSY1V4stf1Hy5Jw ($38.80 in chips) 
Seat 4: BV+K0Phf5VBHr7aZPKqbUQ ($25 in chips) 
Seat 5: v+QfkGiuj9bgtuNoVnDO8w ($40.50 in chips) 
Seat 6: jA7YMtfNUnAaebB7Lj74EA ($26.45 in chips) 
v+QfkGiuj9bgtuNoVnDO8w: posts small blind $0.10
jA7YMtfNUnAaebB7Lj74EA: posts big blind $0.25
*** HOLE CARDS ***
SFmT9ZsVopnukjvAzrxTRg: folds 
xrf8tAXKQHG99HixCot1Iw: folds 
MqMK8OWPSY1V4stf1Hy5Jw: folds 
BV+K0Phf5VBHr7aZPKqbUQ: folds 
v+QfkGiuj9bgtuNoVnDO8w: folds 
Uncalled bet ($0.15) returned to jA7YMtfNUnAaebB7Lj74EA
jA7YMtfNUnAaebB7Lj74EA collected $0.20 from pot
*** SUMMARY ***
Total pot $0.20 | Rake $0 
Seat 1: SFmT9ZsVopnukjvAzrxTRg folded before Flop (didn't bet)
Seat 2: xrf8tAXKQHG99HixCot1Iw folded before Flop (didn't bet)
Seat 3: MqMK8OWPSY1V4stf1Hy5Jw folded before Flop (didn't bet)
Seat 4: BV+K0Phf5VBHr7aZPKqbUQ (button) folded before Flop (didn't bet)
Seat 5: v+QfkGiuj9bgtuNoVnDO8w (small blind) folded before Flop
Seat 6: jA7YMtfNUnAaebB7Lj74EA (big blind) collected ($0.20)




PokerStars Game #59941689070:  Hold'em No Limit ($0.10/$0.25) - 2009/07/01 1:43:03 ET
Table 'MiquQrQZJJq9ZtgRIp9HFQ' 6-max Seat #3 is the button
Seat 1: c3J/KYZ4cNsUEuz8v57I5A ($25 in chips) 
Seat 3: Hsvkc0/G2VV78oVmWYXecw ($15.65 in chips) 
Seat 4: wAKC8C/zN0c8V5v13dm9mA ($57.85 in chips) 
Seat 5: iyZxqznXjv3vtvOJymkoLQ ($27.10 in chips) 
Seat 6: GbCVUNssQ7mqsPWr7J4d3w ($5 in chips) 
wAKC8C/zN0c8V5v13dm9mA: posts small blind $0.10
iyZxqznXjv3vtvOJymkoLQ: posts big blind $0.25
2+6voGl1T1DO63JePptI3g: sits out 
*** HOLE CARDS ***
GbCVUNssQ7mqsPWr7J4d3w: folds 
c3J/KYZ4cNsUEuz8v57I5A: raises $0.75 to $1
Hsvkc0/G2VV78oVmWYXecw: folds 
wAKC8C/zN0c8V5v13dm9mA: calls $0.90
iyZxqznXjv3vtvOJymkoLQ: folds 
*** FLOP *** [7d 2d Th]
wAKC8C/zN0c8V5v13dm9mA: checks 
c3J/KYZ4cNsUEuz8v57I5A: checks 
*** TURN *** [7d 2d Th] [8c]
wAKC8C/zN0c8V5v13dm9mA: checks 
c3J/KYZ4cNsUEuz8v57I5A: checks 
*** RIVER *** [7d 2d Th 8c] [5h]
wAKC8C/zN0c8V5v13dm9mA: checks 
c3J/KYZ4cNsUEuz8v57I5A: checks 
*** SHOW DOWN ***
wAKC8C/zN0c8V5v13dm9mA: shows [Jc Ac] (high card Ace)
c3J/KYZ4cNsUEuz8v57I5A: shows [Js As] (high card Ace)
wAKC8C/zN0c8V5v13dm9mA collected $1.10 from pot
c3J/KYZ4cNsUEuz8v57I5A collected $1.05 from pot
*** SUMMARY ***
Total pot $2.25 | Rake $0.10 
Board [7d 2d Th 8c 5h]
Seat 1: c3J/KYZ4cNsUEuz8v57I5A showed [Js As] and won ($1.05) with high card Ace
Seat 3: Hsvkc0/G2VV78oVmWYXecw (button) folded before Flop (didn't bet)
Seat 4: wAKC8C/zN0c8V5v13dm9mA (small blind) showed [Jc Ac] and won ($1.10) with high card Ace
Seat 5: iyZxqznXjv3vtvOJymkoLQ (big blind) folded before Flop
Seat 6: GbCVUNssQ7mqsPWr7J4d3w folded before Flop (didn't bet)




PokerStars Game #59941688956:  Hold'em No Limit ($0.10/$0.25) - 2009/07/01 1:43:03 ET
Table 'CM/C/FZf3VHIp50RjmBucQ' 9-max Seat #7 is the button
Seat 3: HPEB+AtKw1+C/cxU0o1ciw ($51.15 in chips) 
Seat 4: FYIiLXWy4mKC5ZGa/fnS0g ($10.40 in chips) 
Seat 5: oLa/tXLfSLLB28mcLGrxcg ($24.55 in chips) 
Seat 6: Bb42QRQMhg5/Y0vHP8/2Xw ($25 in chips) 
Seat 7: j4q3p0lesp63b1gZDwLBZw ($5 in chips) 
xUw035gj8xeH3frcgPyCVw will be allowed to play after the button
HPEB+AtKw1+C/cxU0o1ciw: posts small blind $0.10
FYIiLXWy4mKC5ZGa/fnS0g: posts big blind $0.25
*** HOLE CARDS ***
oLa/tXLfSLLB28mcLGrxcg: folds 
Bb42QRQMhg5/Y0vHP8/2Xw: folds 
j4q3p0lesp63b1gZDwLBZw: folds 
j4q3p0lesp63b1gZDwLBZw leaves the table
HPEB+AtKw1+C/cxU0o1ciw: folds 
Uncalled bet ($0.15) returned to FYIiLXWy4mKC5ZGa/fnS0g
FYIiLXWy4mKC5ZGa/fnS0g collected $0.20 from pot
FYIiLXWy4mKC5ZGa/fnS0g: doesn't show hand 
*** SUMMARY ***
Total pot $0.20 | Rake $0 
Seat 3: HPEB+AtKw1+C/cxU0o1ciw (small blind) folded before Flop
Seat 4: FYIiLXWy4mKC5ZGa/fnS0g (big blind) collected ($0.20)
Seat 5: oLa/tXLfSLLB28mcLGrxcg folded before Flop (didn't bet)
Seat 6: Bb42QRQMhg5/Y0vHP8/2Xw folded before Flop (didn't bet)
Seat 7: j4q3p0lesp63b1gZDwLBZw (button) folded before Flop (didn't bet)




PokerStars Game #59941688770:  Hold'em No Limit ($0.10/$0.25) - 2009/07/01 1:43:03 ET
Table '3eK1r4Q4BSYFvsKkuTLpIA' 9-max Seat #1 is the button
Seat 1: vSkQm2EelzwRGDDQQk0Fqw ($4.30 in chips) 
Seat 2: aNpwfA31EREwO+ar4XzBCw ($27.50 in chips) 
Seat 3: 56S3mA6Zs3pGR+0p0vUCtg ($36.20 in chips) 
Seat 4: +2kMBNpY4nF1qNCRd8SJLA ($25 in chips) 
Seat 5: 775TiRJajPtN/ucpTmHrXA ($14.75 in chips) 
Seat 6: +HvCCmsGSQeatf+GZ9zk8Q ($34.45 in chips) 
Seat 7: ljemhp25Zg+nlA9DLCIiUw ($25 in chips) 
Seat 8: /29aHLC+Q6KCDcNv2bPfAg ($12.80 in chips) 
Seat 9: +sbyWwIcFp9kP0bDtMegfQ ($60.40 in chips) 
aNpwfA31EREwO+ar4XzBCw: posts small blind $0.10
56S3mA6Zs3pGR+0p0vUCtg: posts big blind $0.25
*** HOLE CARDS ***
+2kMBNpY4nF1qNCRd8SJLA: folds 
775TiRJajPtN/ucpTmHrXA: folds 
+HvCCmsGSQeatf+GZ9zk8Q: folds 
ljemhp25Zg+nlA9DLCIiUw: folds 
/29aHLC+Q6KCDcNv2bPfAg: folds 
+sbyWwIcFp9kP0bDtMegfQ: folds 
vSkQm2EelzwRGDDQQk0Fqw: folds 
aNpwfA31EREwO+ar4XzBCw: raises $0.75 to $1
56S3mA6Zs3pGR+0p0vUCtg: folds 
Uncalled bet ($0.75) returned to aNpwfA31EREwO+ar4XzBCw
aNpwfA31EREwO+ar4XzBCw collected $0.50 from pot
aNpwfA31EREwO+ar4XzBCw: doesn't show hand 
*** SUMMARY ***
Total pot $0.50 | Rake $0 
Seat 1: vSkQm2EelzwRGDDQQk0Fqw (button) folded before Flop (didn't bet)
Seat 2: aNpwfA31EREwO+ar4XzBCw (small blind) collected ($0.50)
Seat 3: 56S3mA6Zs3pGR+0p0vUCtg (big blind) folded before Flop
Seat 4: +2kMBNpY4nF1qNCRd8SJLA folded before Flop (didn't bet)
Seat 5: 775TiRJajPtN/ucpTmHrXA folded before Flop (didn't bet)
Seat 6: +HvCCmsGSQeatf+GZ9zk8Q folded before Flop (didn't bet)
Seat 7: ljemhp25Zg+nlA9DLCIiUw folded before Flop (didn't bet)
Seat 8: /29aHLC+Q6KCDcNv2bPfAg folded before Flop (didn't bet)
Seat 9: +sbyWwIcFp9kP0bDtMegfQ folded before Flop (didn't bet)




PokerStars Game #59941689528:  Hold'em No Limit ($0.10/$0.25) - 2009/07/01 1:43:04 ET
Table 'ouLhepGYovxB2x0QxH7cVg' 9-max Seat #3 is the button
Seat 1: ghNKXUBl/H+t83JF079ZBA ($25 in chips) 
Seat 2: r1Z5m4PwSI5ANp7qCE1OJw ($18.50 in chips) 
Seat 3: bXpVeaSTPBFSPJmeXxO7nw ($5.25 in chips) 
Seat 4: a0Sx6GHY7ln2Ns2C97eXeA ($37.65 in chips) 
Seat 5: v60REj6f8jzMYT0VsZvaPQ ($10 in chips) 
Seat 6: lSeLm4BdnSMLtIli62qjAQ ($7.50 in chips) 
Seat 7: JRV2PblFtPFz51l0Fwyz8g ($24.85 in chips) 
Seat 8: tLcDklc2rBORNfixyRfVfw ($25 in chips) 
Seat 9: ljemhp25Zg+nlA9DLCIiUw ($25.35 in chips) 
a0Sx6GHY7ln2Ns2C97eXeA: posts small blind $0.10
v60REj6f8jzMYT0VsZvaPQ: posts big blind $0.25
*** HOLE CARDS ***
lSeLm4BdnSMLtIli62qjAQ: folds 
lSeLm4BdnSMLtIli62qjAQ is sitting out
JRV2PblFtPFz51l0Fwyz8g: folds 
tLcDklc2rBORNfixyRfVfw: folds 
ljemhp25Zg+nlA9DLCIiUw: folds 
ghNKXUBl/H+t83JF079ZBA: folds 
r1Z5m4PwSI5ANp7qCE1OJw: raises $1.50 to $1.75
bXpVeaSTPBFSPJmeXxO7nw: folds 
a0Sx6GHY7ln2Ns2C97eXeA: folds 
v60REj6f8jzMYT0VsZvaPQ: folds 
Uncalled bet ($1.50) returned to r1Z5m4PwSI5ANp7qCE1OJw
r1Z5m4PwSI5ANp7qCE1OJw collected $0.60 from pot
r1Z5m4PwSI5ANp7qCE1OJw: doesn't show hand 
*** SUMMARY ***
Total pot $0.60 | Rake $0 
Seat 1: ghNKXUBl/H+t83JF079ZBA folded before Flop (didn't bet)
Seat 2: r1Z5m4PwSI5ANp7qCE1OJw collected ($0.60)
Seat 3: bXpVeaSTPBFSPJmeXxO7nw (button) folded before Flop (didn't bet)
Seat 4: a0Sx6GHY7ln2Ns2C97eXeA (small blind) folded before Flop
Seat 5: v60REj6f8jzMYT0VsZvaPQ (big blind) folded before Flop
Seat 6: lSeLm4BdnSMLtIli62qjAQ folded before Flop (didn't bet)
Seat 7: JRV2PblFtPFz51l0Fwyz8g folded before Flop (didn't bet)
Seat 8: tLcDklc2rBORNfixyRfVfw folded before Flop (didn't bet)
Seat 9: ljemhp25Zg+nlA9DLCIiUw folded before Flop (didn't bet)




PokerStars Game #59941689446:  Hold'em No Limit ($0.10/$0.25) - 2009/07/01 1:43:04 ET
Table 'nFlmVztKq1HJEWfxmdl15w' 9-max Seat #1 is the button
Seat 1: cZ99hugmLBj9KhTlc8nCSw ($25 in chips) 
Seat 2: Th3FldXKQW6hWVVPahaoOQ ($38.50 in chips) 
Seat 3: DdPXdieucQ+n99u1n3A+rQ ($5 in chips) 
Seat 5: Tx6zQdk5Ozt9ObEBlU7jeg ($32.45 in chips) 
Seat 6: 4awUyiDYTgylQKXZ9faBVA ($36 in chips) 
Seat 7: dfNim92Z6XK1/h5SFW5vDg ($35.30 in chips) 
Seat 8: +2kMBNpY4nF1qNCRd8SJLA ($33.90 in chips) 
Seat 9: DnDcAdn9P0zGovMERigpFA ($25 in chips) 
Th3FldXKQW6hWVVPahaoOQ: posts small blind $0.10
DdPXdieucQ+n99u1n3A+rQ: posts big blind $0.25
*** HOLE CARDS ***
+5dSUwD+/k2ktlnutSMivw has returned
Tx6zQdk5Ozt9ObEBlU7jeg: calls $0.25
4awUyiDYTgylQKXZ9faBVA: folds 
dfNim92Z6XK1/h5SFW5vDg: folds 
+2kMBNpY4nF1qNCRd8SJLA: folds 
DnDcAdn9P0zGovMERigpFA: folds 
cZ99hugmLBj9KhTlc8nCSw: folds 
Th3FldXKQW6hWVVPahaoOQ: folds 
DdPXdieucQ+n99u1n3A+rQ: checks 
*** FLOP *** [Tc 3s Kh]
DdPXdieucQ+n99u1n3A+rQ: checks 
Tx6zQdk5Ozt9ObEBlU7jeg: bets $0.50
DdPXdieucQ+n99u1n3A+rQ: folds 
Uncalled bet ($0.50) returned to Tx6zQdk5Ozt9ObEBlU7jeg
Tx6zQdk5Ozt9ObEBlU7jeg collected $0.60 from pot
Tx6zQdk5Ozt9ObEBlU7jeg: doesn't show hand 
*** SUMMARY ***
Total pot $0.60 | Rake $0 
Board [Tc 3s Kh]
Seat 1: cZ99hugmLBj9KhTlc8nCSw (button) folded before Flop (didn't bet)
Seat 2: Th3FldXKQW6hWVVPahaoOQ (small blind) folded before Flop
Seat 3: DdPXdieucQ+n99u1n3A+rQ (big blind) folded on the Flop
Seat 5: Tx6zQdk5Ozt9ObEBlU7jeg collected ($0.60)
Seat 6: 4awUyiDYTgylQKXZ9faBVA folded before Flop (didn't bet)
Seat 7: dfNim92Z6XK1/h5SFW5vDg folded before Flop (didn't bet)
Seat 8: +2kMBNpY4nF1qNCRd8SJLA folded before Flop (didn't bet)
Seat 9: DnDcAdn9P0zGovMERigpFA folded before Flop (didn't bet)




PokerStars Game #59941689454:  Hold'em No Limit ($0.10/$0.25) - 2009/07/01 1:43:04 ET
Table 'hfHe8uKeSJMyWAjSdM7ROQ' 6-max Seat #3 is the button
Seat 1: eHsmIvAb2JREg4O6hNPnXg ($25 in chips) 
Seat 2: QvTX2yGq3uKJiKPmns4TKQ ($30.40 in chips) 
Seat 3: oAzQdB2jFOH1NxFUPjYUGg ($26.40 in chips) 
Seat 4: b4wRQV3APH8irVk6bUFe2Q ($25.95 in chips) 
Seat 5: euswrBD1XG0Q5hB1iGJBKQ ($61.10 in chips) 
Seat 6: MTQON5nWq0PsufZ7u/4rMA ($17.25 in chips) 
b4wRQV3APH8irVk6bUFe2Q: posts small blind $0.10
euswrBD1XG0Q5hB1iGJBKQ: posts big blind $0.25
*** HOLE CARDS ***
MTQON5nWq0PsufZ7u/4rMA: raises $0.75 to $1
eHsmIvAb2JREg4O6hNPnXg: raises $0.75 to $1.75
QvTX2yGq3uKJiKPmns4TKQ: folds 
oAzQdB2jFOH1NxFUPjYUGg: folds 
b4wRQV3APH8irVk6bUFe2Q: folds 
euswrBD1XG0Q5hB1iGJBKQ: folds 
MTQON5nWq0PsufZ7u/4rMA: calls $0.75
*** FLOP *** [9s Jh 4h]
MTQON5nWq0PsufZ7u/4rMA: bets $1.75
eHsmIvAb2JREg4O6hNPnXg: raises $3.25 to $5
MTQON5nWq0PsufZ7u/4rMA: calls $3.25
*** TURN *** [9s Jh 4h] [9c]
MTQON5nWq0PsufZ7u/4rMA: checks 
eHsmIvAb2JREg4O6hNPnXg: bets $6
MTQON5nWq0PsufZ7u/4rMA: calls $6
*** RIVER *** [9s Jh 4h 9c] [Qc]
MTQON5nWq0PsufZ7u/4rMA: checks 
eHsmIvAb2JREg4O6hNPnXg: bets $12.25 and is all-in
MTQON5nWq0PsufZ7u/4rMA: calls $4.50 and is all-in
Uncalled bet ($7.75) returned to eHsmIvAb2JREg4O6hNPnXg
*** SHOW DOWN ***
eHsmIvAb2JREg4O6hNPnXg: shows [Ks Kh] (two pair, Kings and Nines)
MTQON5nWq0PsufZ7u/4rMA: mucks hand 
eHsmIvAb2JREg4O6hNPnXg collected $33.20 from pot
MTQON5nWq0PsufZ7u/4rMA leaves the table
*** SUMMARY ***
Total pot $34.85 | Rake $1.65 
Board [9s Jh 4h 9c Qc]
Seat 1: eHsmIvAb2JREg4O6hNPnXg showed [Ks Kh] and won ($33.20) with two pair, Kings and Nines
Seat 2: QvTX2yGq3uKJiKPmns4TKQ folded before Flop (didn't bet)
Seat 3: oAzQdB2jFOH1NxFUPjYUGg (button) folded before Flop (didn't bet)
Seat 4: b4wRQV3APH8irVk6bUFe2Q (small blind) folded before Flop
Seat 5: euswrBD1XG0Q5hB1iGJBKQ (big blind) folded before Flop
Seat 6: MTQON5nWq0PsufZ7u/4rMA mucked




PokerStars Game #59941689406:  Hold'em No Limit ($0.10/$0.25) - 2009/07/01 1:43:04 ET
Table 'MJ1SB76A4qJrlEa+C5e/8w' 6-max Seat #4 is the button
Seat 1: 0KDZiuXQg6UI9cqBR/AUnQ ($26 in chips) 
Seat 2: UA5OsKS3VPaxa7uC8La/kA ($36.70 in chips) 
Seat 3: DihMHaz4WNETH1bPDe13kA ($32.90 in chips) 
Seat 4: SFmT9ZsVopnukjvAzrxTRg ($27.80 in chips) 
Seat 5: Hsvkc0/G2VV78oVmWYXecw ($5.10 in chips) 
Seat 6: JFIAqU8lCZ0vWwEl4bdGsg ($30.30 in chips) 
Hsvkc0/G2VV78oVmWYXecw: posts small blind $0.10
JFIAqU8lCZ0vWwEl4bdGsg: posts big blind $0.25
*** HOLE CARDS ***
0KDZiuXQg6UI9cqBR/AUnQ: folds 
UA5OsKS3VPaxa7uC8La/kA: folds 
DihMHaz4WNETH1bPDe13kA: folds 
SFmT9ZsVopnukjvAzrxTRg: folds 
Hsvkc0/G2VV78oVmWYXecw: folds 
Uncalled bet ($0.15) returned to JFIAqU8lCZ0vWwEl4bdGsg
JFIAqU8lCZ0vWwEl4bdGsg collected $0.20 from pot
JFIAqU8lCZ0vWwEl4bdGsg: doesn't show hand 
*** SUMMARY ***
Total pot $0.20 | Rake $0 
Seat 1: 0KDZiuXQg6UI9cqBR/AUnQ folded before Flop (didn't bet)
Seat 2: UA5OsKS3VPaxa7uC8La/kA folded before Flop (didn't bet)
Seat 3: DihMHaz4WNETH1bPDe13kA folded before Flop (didn't bet)
Seat 4: SFmT9ZsVopnukjvAzrxTRg (button) folded before Flop (didn't bet)
Seat 5: Hsvkc0/G2VV78oVmWYXecw (small blind) folded before Flop
Seat 6: JFIAqU8lCZ0vWwEl4bdGsg (big blind) collected ($0.20)




PokerStars Game #59941690070:  Hold'em No Limit ($0.10/$0.25) - 2009/07/01 1:43:05 ET
Table 'nlpa8xI95gAflovnFxB2yg' 6-max Seat #4 is the button
Seat 1: fZQg9veL7Dd/Z04ZTjC+wQ ($62.15 in chips) 
Seat 2: Yuyy/pDz3yAO3EbHYRYnKw ($25.15 in chips) 
Seat 3: DihMHaz4WNETH1bPDe13kA ($27.50 in chips) 
Seat 4: if4dh6jhJXeN3/qd3qCp9g ($25 in chips) 
Seat 5: FDWzjQgBA5K04jOIY/j22w ($9.05 in chips) 
Seat 6: ATNFxN8fYVfSZMQW8dvbvw ($6.15 in chips) 
FDWzjQgBA5K04jOIY/j22w: posts small blind $0.10
ATNFxN8fYVfSZMQW8dvbvw: posts big blind $0.25
*** HOLE CARDS ***
fZQg9veL7Dd/Z04ZTjC+wQ: folds 
Yuyy/pDz3yAO3EbHYRYnKw: raises $0.50 to $0.75
DihMHaz4WNETH1bPDe13kA: calls $0.75
if4dh6jhJXeN3/qd3qCp9g: calls $0.75
FDWzjQgBA5K04jOIY/j22w: calls $0.65
ATNFxN8fYVfSZMQW8dvbvw: calls $0.50
*** FLOP *** [6s Ts Tc]
FDWzjQgBA5K04jOIY/j22w: bets $0.25
ATNFxN8fYVfSZMQW8dvbvw: folds 
Yuyy/pDz3yAO3EbHYRYnKw: folds 
DihMHaz4WNETH1bPDe13kA: calls $0.25
if4dh6jhJXeN3/qd3qCp9g: calls $0.25
*** TURN *** [6s Ts Tc] [Js]
FDWzjQgBA5K04jOIY/j22w: bets $0.50
DihMHaz4WNETH1bPDe13kA: raises $3.25 to $3.75
if4dh6jhJXeN3/qd3qCp9g: calls $3.75
FDWzjQgBA5K04jOIY/j22w: folds 
*** RIVER *** [6s Ts Tc Js] [3s]
DihMHaz4WNETH1bPDe13kA: bets $22.75 and is all-in
if4dh6jhJXeN3/qd3qCp9g: calls $20.25 and is all-in
Uncalled bet ($2.50) returned to DihMHaz4WNETH1bPDe13kA
*** SHOW DOWN ***
DihMHaz4WNETH1bPDe13kA: shows [6c 6h] (a full house, Sixes full of Tens)
if4dh6jhJXeN3/qd3qCp9g: shows [Td Th] (four of a kind, Tens)
if4dh6jhJXeN3/qd3qCp9g collected $50.40 from pot
FDWzjQgBA5K04jOIY/j22w said, "nh"
*** SUMMARY ***
Total pot $53 | Rake $2.60 
Board [6s Ts Tc Js 3s]
Seat 1: fZQg9veL7Dd/Z04ZTjC+wQ folded before Flop (didn't bet)
Seat 2: Yuyy/pDz3yAO3EbHYRYnKw folded on the Flop
Seat 3: DihMHaz4WNETH1bPDe13kA showed [6c 6h] and lost with a full house, Sixes full of Tens
Seat 4: if4dh6jhJXeN3/qd3qCp9g (button) showed [Td Th] and won ($50.40) with four of a kind, Tens
Seat 5: FDWzjQgBA5K04jOIY/j22w (small blind) folded on the Turn
Seat 6: ATNFxN8fYVfSZMQW8dvbvw (big blind) folded on the Flop




PokerStars Game #59941689828:  Hold'em No Limit ($0.10/$0.25) - 2009/07/01 1:43:05 ET
Table 'WEMI3Mtn7dGARDbgNrKibgoG007Tb0LYbfANo6QWd16wx Seat #1 is the button
Seat 1: DiSvPC2iudwL5j9u6Huyww ($46.65 in chips) 
Seat 4: zgi+EUykT/pZQpoUG6+oEg ($4.40 in chips) 
Seat 5: 8f0dtuUGqDbgE6up1lQAlg ($6.10 in chips) 
Seat 7: Mh2r9hTeTEDnh19sRZtW3g ($4.75 in chips) 
Seat 8: q4cNXFZGNhLfrTyVrIy6Mg ($10.80 in chips) 
Seat 9: EVqHvqty1ZsuvDFiSXlSqQ ($20.10 in chips) 
pN3IHvAKm2fz+sTRARTcrg will be allowed to play after the button
zgi+EUykT/pZQpoUG6+oEg: posts small blind $0.10
8f0dtuUGqDbgE6up1lQAlg: posts big blind $0.25
yqkowiRWZ6NvRN9UUkYIlA: sits out 
*** HOLE CARDS ***
Mh2r9hTeTEDnh19sRZtW3g: folds 
q4cNXFZGNhLfrTyVrIy6Mg: calls $0.25
EVqHvqty1ZsuvDFiSXlSqQ: raises $0.75 to $1
DiSvPC2iudwL5j9u6Huyww: folds 
zgi+EUykT/pZQpoUG6+oEg: folds 
8f0dtuUGqDbgE6up1lQAlg: folds 
q4cNXFZGNhLfrTyVrIy6Mg: calls $0.75
*** FLOP *** [Jh 3h 3s]
q4cNXFZGNhLfrTyVrIy6Mg: checks 
EVqHvqty1ZsuvDFiSXlSqQ: checks 
*** TURN *** [Jh 3h 3s] [5s]
q4cNXFZGNhLfrTyVrIy6Mg: bets $0.25
EVqHvqty1ZsuvDFiSXlSqQ: calls $0.25
*** RIVER *** [Jh 3h 3s 5s] [8d]
q4cNXFZGNhLfrTyVrIy6Mg: bets $0.25
EVqHvqty1ZsuvDFiSXlSqQ: folds 
Uncalled bet ($0.25) returned to q4cNXFZGNhLfrTyVrIy6Mg
q4cNXFZGNhLfrTyVrIy6Mg collected $2.75 from pot
q4cNXFZGNhLfrTyVrIy6Mg: doesn't show hand 
*** SUMMARY ***
Total pot $2.85 | Rake $0.10 
Board [Jh 3h 3s 5s 8d]
Seat 1: DiSvPC2iudwL5j9u6Huyww (button) folded before Flop (didn't bet)
Seat 4: zgi+EUykT/pZQpoUG6+oEg (small blind) folded before Flop
Seat 5: 8f0dtuUGqDbgE6up1lQAlg (big blind) folded before Flop
Seat 7: Mh2r9hTeTEDnh19sRZtW3g folded before Flop (didn't bet)
Seat 8: q4cNXFZGNhLfrTyVrIy6Mg collected ($2.75)
Seat 9: EVqHvqty1ZsuvDFiSXlSqQ folded on the River




PokerStars Game #59941690048:  Hold'em No Limit ($0.10/$0.25) - 2009/07/01 1:43:05 ET
Table 'IuqVbFI+pwnJjvwBCGSGAw' 6-max Seat #4 is the button
Seat 1: LyDHtw3/yniNHW+DvLXbog ($26.25 in chips) 
Seat 2: wsP46AGpqDjHZQmlRHKa9g ($25.45 in chips) 
Seat 3: QiL+lEgEWwy21jk/ltaRLg ($22.25 in chips) 
Seat 4: DE9hRlt14g+JdsRQ4wT7hg ($25 in chips) 
Seat 5: if4dh6jhJXeN3/qd3qCp9g ($25.45 in chips) 
if4dh6jhJXeN3/qd3qCp9g: posts small blind $0.10
LyDHtw3/yniNHW+DvLXbog: posts big blind $0.25
*** HOLE CARDS ***
xC0kaiDYM6YTlgODL83O5A joins the table at seat #6 
wsP46AGpqDjHZQmlRHKa9g: folds 
QiL+lEgEWwy21jk/ltaRLg: calls $0.25
DE9hRlt14g+JdsRQ4wT7hg: folds 
if4dh6jhJXeN3/qd3qCp9g: folds 
LyDHtw3/yniNHW+DvLXbog: checks 
*** FLOP *** [7s Jh 2h]
LyDHtw3/yniNHW+DvLXbog: checks 
QiL+lEgEWwy21jk/ltaRLg: bets $0.25
LyDHtw3/yniNHW+DvLXbog: calls $0.25
*** TURN *** [7s Jh 2h] [6h]
LyDHtw3/yniNHW+DvLXbog: checks 
QiL+lEgEWwy21jk/ltaRLg: checks 
*** RIVER *** [7s Jh 2h 6h] [Ks]
LyDHtw3/yniNHW+DvLXbog: checks 
QiL+lEgEWwy21jk/ltaRLg: checks 
*** SHOW DOWN ***
LyDHtw3/yniNHW+DvLXbog: shows [7h Qd] (a pair of Sevens)
QiL+lEgEWwy21jk/ltaRLg: mucks hand 
LyDHtw3/yniNHW+DvLXbog collected $1.05 from pot
*** SUMMARY ***
Total pot $1.10 | Rake $0.05 
Board [7s Jh 2h 6h Ks]
Seat 1: LyDHtw3/yniNHW+DvLXbog (big blind) showed [7h Qd] and won ($1.05) with a pair of Sevens
Seat 2: wsP46AGpqDjHZQmlRHKa9g folded before Flop (didn't bet)
Seat 3: QiL+lEgEWwy21jk/ltaRLg mucked
Seat 4: DE9hRlt14g+JdsRQ4wT7hg (button) folded before Flop (didn't bet)
Seat 5: if4dh6jhJXeN3/qd3qCp9g (small blind) folded before Flop




PokerStars Game #59941689930:  Hold'em No Limit ($0.10/$0.25) - 2009/07/01 1:43:05 ET
Table 'BmUMTVcNATeov2rAGYU0Qg' 9-max Seat #9 is the button
Seat 1: QEbIGci+itdw+re8RM5fZA ($33.70 in chips) 
Seat 2: jJnMGXoBXye+afMd0k0rUw ($9.95 in chips) 
Seat 3: ir5Jy8ck6DrdqgJ/3chcWw ($7.95 in chips) 
Seat 4: aNpwfA31EREwO+ar4XzBCw ($37.85 in chips) 
Seat 5: QBNcj9fHxkh/+s/oVw+JmQ ($23.60 in chips) 
Seat 6: w1ukf8uPa4+WH561TtVRxA ($25 in chips) 
Seat 7: CmngQmkKTp8tkl6GMRTl6w ($8.50 in chips) 
Seat 8: f/H6PsHRl4W1JyNsEDvPtg ($36.05 in chips) 
Seat 9: /artgaAtyUtUtD8FZo6puA ($11.10 in chips) 
QEbIGci+itdw+re8RM5fZA: posts small blind $0.10
jJnMGXoBXye+afMd0k0rUw: posts big blind $0.25
*** HOLE CARDS ***
ir5Jy8ck6DrdqgJ/3chcWw: folds 
aNpwfA31EREwO+ar4XzBCw: folds 
QBNcj9fHxkh/+s/oVw+JmQ: folds 
w1ukf8uPa4+WH561TtVRxA: raises $0.50 to $0.75
CmngQmkKTp8tkl6GMRTl6w: folds 
f/H6PsHRl4W1JyNsEDvPtg: calls $0.75
/artgaAtyUtUtD8FZo6puA: folds 
QEbIGci+itdw+re8RM5fZA: folds 
jJnMGXoBXye+afMd0k0rUw: calls $0.50
*** FLOP *** [Tc 6d 5h]
jJnMGXoBXye+afMd0k0rUw: checks 
w1ukf8uPa4+WH561TtVRxA: checks 
f/H6PsHRl4W1JyNsEDvPtg: bets $0.50
jJnMGXoBXye+afMd0k0rUw: calls $0.50
w1ukf8uPa4+WH561TtVRxA: folds 
*** TURN *** [Tc 6d 5h] [Jc]
jJnMGXoBXye+afMd0k0rUw: checks 
f/H6PsHRl4W1JyNsEDvPtg: checks 
*** RIVER *** [Tc 6d 5h Jc] [6s]
jJnMGXoBXye+afMd0k0rUw: bets $1.50
f/H6PsHRl4W1JyNsEDvPtg: folds 
Uncalled bet ($1.50) returned to jJnMGXoBXye+afMd0k0rUw
jJnMGXoBXye+afMd0k0rUw collected $3.20 from pot
jJnMGXoBXye+afMd0k0rUw: doesn't show hand 
*** SUMMARY ***
Total pot $3.35 | Rake $0.15 
Board [Tc 6d 5h Jc 6s]
Seat 1: QEbIGci+itdw+re8RM5fZA (small blind) folded before Flop
Seat 2: jJnMGXoBXye+afMd0k0rUw (big blind) collected ($3.20)
Seat 3: ir5Jy8ck6DrdqgJ/3chcWw folded before Flop (didn't bet)
Seat 4: aNpwfA31EREwO+ar4XzBCw folded before Flop (didn't bet)
Seat 5: QBNcj9fHxkh/+s/oVw+JmQ folded before Flop (didn't bet)
Seat 6: w1ukf8uPa4+WH561TtVRxA folded on the Flop
Seat 7: CmngQmkKTp8tkl6GMRTl6w folded before Flop (didn't bet)
Seat 8: f/H6PsHRl4W1JyNsEDvPtg folded on the River
Seat 9: /artgaAtyUtUtD8FZo6puA (button) folded before Flop (didn't bet)




PokerStars Game #59941690620:  Hold'em No Limit ($0.10/$0.25) - 2009/07/01 1:43:06 ET
Table '8QBBaev+cI2i/r2H6ml/lg' 9-max Seat #3 is the button
Seat 1: s2xLPOl/vhl/26apJ3vsOQ ($32.70 in chips) 
Seat 2: y7tkvDmwKjURBkr73SZPXw ($15 in chips) 
Seat 3: zgi+EUykT/pZQpoUG6+oEg ($4.30 in chips) 
Seat 4: ytpGB2nr/CLVHnyKMRiEFQ ($16.05 in chips) 
Seat 5: 0QdZrkFD7aGKeBXPGbIomA ($11.70 in chips) 
Seat 6: X6+pSIPfovPcE87t+LmUKQ ($4.75 in chips) 
Seat 7: eK8qa6EPcH2zhtbmWSvc9g ($31.05 in chips) 
Seat 8: vr1IK/Q4HXm8s8V0/dePzQ ($12.05 in chips) 
Seat 9: EUMLvzDkECHBit+xa+uGjg ($24.75 in chips) 
ytpGB2nr/CLVHnyKMRiEFQ: posts small blind $0.10
0QdZrkFD7aGKeBXPGbIomA: posts big blind $0.25
y7tkvDmwKjURBkr73SZPXw: posts big blind $0.25
*** HOLE CARDS ***
X6+pSIPfovPcE87t+LmUKQ: folds 
eK8qa6EPcH2zhtbmWSvc9g: folds 
vr1IK/Q4HXm8s8V0/dePzQ: calls $0.25
EUMLvzDkECHBit+xa+uGjg: folds 
s2xLPOl/vhl/26apJ3vsOQ: raises $1 to $1.25
y7tkvDmwKjURBkr73SZPXw: calls $1
zgi+EUykT/pZQpoUG6+oEg: folds 
ytpGB2nr/CLVHnyKMRiEFQ: folds 
0QdZrkFD7aGKeBXPGbIomA: folds 
vr1IK/Q4HXm8s8V0/dePzQ: folds 
*** FLOP *** [Td 3d Kc]
s2xLPOl/vhl/26apJ3vsOQ: bets $1.50
y7tkvDmwKjURBkr73SZPXw: calls $1.50
*** TURN *** [Td 3d Kc] [2s]
s2xLPOl/vhl/26apJ3vsOQ: bets $4
y7tkvDmwKjURBkr73SZPXw: folds 
Uncalled bet ($4) returned to s2xLPOl/vhl/26apJ3vsOQ
s2xLPOl/vhl/26apJ3vsOQ collected $5.85 from pot
*** SUMMARY ***
Total pot $6.10 | Rake $0.25 
Board [Td 3d Kc 2s]
Seat 1: s2xLPOl/vhl/26apJ3vsOQ collected ($5.85)
Seat 2: y7tkvDmwKjURBkr73SZPXw folded on the Turn
Seat 3: zgi+EUykT/pZQpoUG6+oEg (button) folded before Flop (didn't bet)
Seat 4: ytpGB2nr/CLVHnyKMRiEFQ (small blind) folded before Flop
Seat 5: 0QdZrkFD7aGKeBXPGbIomA (big blind) folded before Flop
Seat 6: X6+pSIPfovPcE87t+LmUKQ folded before Flop (didn't bet)
Seat 7: eK8qa6EPcH2zhtbmWSvc9g folded before Flop (didn't bet)
Seat 8: vr1IK/Q4HXm8s8V0/dePzQ folded before Flop
Seat 9: EUMLvzDkECHBit+xa+uGjg folded before Flop (didn't bet)




PokerStars Game #59941690328:  Hold'em No Limit ($0.10/$0.25) - 2009/07/01 1:43:06 ET
Table 'sCop8wmj9zlSS2KJqk1QKQ' 9-max Seat #4 is the button
Seat 1: dtZ84flFEi4Q+SGrHMJRDQ ($40.85 in chips) 
Seat 2: YZaC69gFrepA6oCGtu7E0w ($39 in chips) 
Seat 4: msUzkZl2RntUnTl6E8WaNA ($10.55 in chips) 
Seat 5: RHqgdFvufLCYe54+qd2gcA ($4.75 in chips) 
Seat 6: hZuGwtYmFKPmQ+v1wlmdfA ($43.05 in chips) 
Seat 7: sx0lGrkT9fd4yFR+3cXUQg ($11.85 in chips) 
Seat 8: xnVwSkROfRtOw4eSoDANtw ($20.65 in chips) 
Seat 9: tLcDklc2rBORNfixyRfVfw ($25 in chips) 
RHqgdFvufLCYe54+qd2gcA: posts small blind $0.10
hZuGwtYmFKPmQ+v1wlmdfA: posts big blind $0.25
UkF1eqqUN0CCiimXAuN7og: sits out 
*** HOLE CARDS ***
sx0lGrkT9fd4yFR+3cXUQg: folds 
sx0lGrkT9fd4yFR+3cXUQg leaves the table
xnVwSkROfRtOw4eSoDANtw: folds 
tLcDklc2rBORNfixyRfVfw: folds 
dtZ84flFEi4Q+SGrHMJRDQ: folds 
YZaC69gFrepA6oCGtu7E0w: raises $0.50 to $0.75
msUzkZl2RntUnTl6E8WaNA: folds 
1gbA06IVB5XVZNlkqj7zJw joins the table at seat #7 
RHqgdFvufLCYe54+qd2gcA: folds 
hZuGwtYmFKPmQ+v1wlmdfA: folds 
Uncalled bet ($0.50) returned to YZaC69gFrepA6oCGtu7E0w
YZaC69gFrepA6oCGtu7E0w collected $0.60 from pot
*** SUMMARY ***
Total pot $0.60 | Rake $0 
Seat 1: dtZ84flFEi4Q+SGrHMJRDQ folded before Flop (didn't bet)
Seat 2: YZaC69gFrepA6oCGtu7E0w collected ($0.60)
Seat 4: msUzkZl2RntUnTl6E8WaNA (button) folded before Flop (didn't bet)
Seat 5: RHqgdFvufLCYe54+qd2gcA (small blind) folded before Flop
Seat 6: hZuGwtYmFKPmQ+v1wlmdfA (big blind) folded before Flop
Seat 7: sx0lGrkT9fd4yFR+3cXUQg folded before Flop (didn't bet)
Seat 8: xnVwSkROfRtOw4eSoDANtw folded before Flop (didn't bet)
Seat 9: tLcDklc2rBORNfixyRfVfw folded before Flop (didn't bet)




PokerStars Game #59941690654:  Hold'em No Limit ($0.10/$0.25) - 2009/07/01 1:43:06 ET
Table 'axb9RsG8Zj1A0LEukTeFrQ' 9-max Seat #1 is the button
Seat 1: qwr38jl5txoR36M7G5qi4A ($8.50 in chips) 
Seat 3: H5Se03ZqSX7tbULXur2MAg ($24.10 in chips) 
Seat 4: tLcDklc2rBORNfixyRfVfw ($27.45 in chips) 
Seat 5: rLSSHKOHnb6yzVfDoQM/RA ($15.10 in chips) 
Seat 6: Iu9xjReQYvxYiqQm8n6MXQ ($5.35 in chips) 
Seat 7: PdIasPkzm2sqZnN41ZRXOg ($5 in chips) 
Seat 8: VBHxUExRAMrbxUq/cVx9Gw ($4.30 in chips) 
Seat 9: qbQE8CifKB4+OEvNF/61Rw ($56.90 in chips) 
H5Se03ZqSX7tbULXur2MAg: posts small blind $0.10
tLcDklc2rBORNfixyRfVfw: posts big blind $0.25
*** HOLE CARDS ***
rLSSHKOHnb6yzVfDoQM/RA: folds 
Iu9xjReQYvxYiqQm8n6MXQ: folds 
PdIasPkzm2sqZnN41ZRXOg: folds 
VBHxUExRAMrbxUq/cVx9Gw: folds 
qbQE8CifKB4+OEvNF/61Rw: calls $0.25
qwr38jl5txoR36M7G5qi4A: folds 
H5Se03ZqSX7tbULXur2MAg: calls $0.15
tLcDklc2rBORNfixyRfVfw: checks 
*** FLOP *** [Kh 6s 8d]
H5Se03ZqSX7tbULXur2MAg: checks 
tLcDklc2rBORNfixyRfVfw: checks 
qbQE8CifKB4+OEvNF/61Rw: bets $0.25
H5Se03ZqSX7tbULXur2MAg: folds 
tLcDklc2rBORNfixyRfVfw: folds 
Uncalled bet ($0.25) returned to qbQE8CifKB4+OEvNF/61Rw
qbQE8CifKB4+OEvNF/61Rw collected $0.75 from pot
qbQE8CifKB4+OEvNF/61Rw: doesn't show hand 
*** SUMMARY ***
Total pot $0.75 | Rake $0 
Board [Kh 6s 8d]
Seat 1: qwr38jl5txoR36M7G5qi4A (button) folded before Flop (didn't bet)
Seat 3: H5Se03ZqSX7tbULXur2MAg (small blind) folded on the Flop
Seat 4: tLcDklc2rBORNfixyRfVfw (big blind) folded on the Flop
Seat 5: rLSSHKOHnb6yzVfDoQM/RA folded before Flop (didn't bet)
Seat 6: Iu9xjReQYvxYiqQm8n6MXQ folded before Flop (didn't bet)
Seat 7: PdIasPkzm2sqZnN41ZRXOg folded before Flop (didn't bet)
Seat 8: VBHxUExRAMrbxUq/cVx9Gw folded before Flop (didn't bet)
Seat 9: qbQE8CifKB4+OEvNF/61Rw collected ($0.75)




PokerStars Game #59941690500:  Hold'em No Limit ($0.10/$0.25) - 2009/07/01 1:43:06 ET
Table 'a6FCGVBMPcT7J7BDN9q1zQ' 9-max Seat #9 is the button
Seat 2: M2QO2DxB5Wawg2h8HSpnYA ($10 in chips) 
Seat 3: tLcDklc2rBORNfixyRfVfw ($26.15 in chips) 
Seat 4: 8CoKLhwk8Ja6X+O9fxTEDg ($10.80 in chips) 
Seat 5: dtZ84flFEi4Q+SGrHMJRDQ ($27.05 in chips) 
Seat 6: dfNim92Z6XK1/h5SFW5vDg ($25 in chips) 
Seat 7: V0Yo5zRBVM8DYspLKafebg ($4.55 in chips) 
Seat 8: r6hsffOo1iKmaPYKwAZmFw ($69.40 in chips) 
Seat 9: wGigCmBR/9XWkPpvYos3aQ ($28.35 in chips) 
bXpVeaSTPBFSPJmeXxO7nw will be allowed to play after the button
M2QO2DxB5Wawg2h8HSpnYA: posts small blind $0.10
tLcDklc2rBORNfixyRfVfw: posts big blind $0.25
*** HOLE CARDS ***
8CoKLhwk8Ja6X+O9fxTEDg: folds 
dtZ84flFEi4Q+SGrHMJRDQ: folds 
M2QO2DxB5Wawg2h8HSpnYA said, "0.60 cent!"
dfNim92Z6XK1/h5SFW5vDg: folds 
V0Yo5zRBVM8DYspLKafebg: calls $0.25
r6hsffOo1iKmaPYKwAZmFw: raises $4.30 to $4.55
wGigCmBR/9XWkPpvYos3aQ: folds 
M2QO2DxB5Wawg2h8HSpnYA: folds 
tLcDklc2rBORNfixyRfVfw: folds 
V0Yo5zRBVM8DYspLKafebg: folds 
Uncalled bet ($4.30) returned to r6hsffOo1iKmaPYKwAZmFw
r6hsffOo1iKmaPYKwAZmFw collected $0.85 from pot
r6hsffOo1iKmaPYKwAZmFw: doesn't show hand 
*** SUMMARY ***
Total pot $0.85 | Rake $0 
Seat 2: M2QO2DxB5Wawg2h8HSpnYA (small blind) folded before Flop
Seat 3: tLcDklc2rBORNfixyRfVfw (big blind) folded before Flop
Seat 4: 8CoKLhwk8Ja6X+O9fxTEDg folded before Flop (didn't bet)
Seat 5: dtZ84flFEi4Q+SGrHMJRDQ folded before Flop (didn't bet)
Seat 6: dfNim92Z6XK1/h5SFW5vDg folded before Flop (didn't bet)
Seat 7: V0Yo5zRBVM8DYspLKafebg folded before Flop
Seat 8: r6hsffOo1iKmaPYKwAZmFw collected ($0.85)
Seat 9: wGigCmBR/9XWkPpvYos3aQ (button) folded before Flop (didn't bet)




PokerStars Game #59941690496:  Hold'em No Limit ($0.10/$0.25) - 2009/07/01 1:43:06 ET
Table 'oZuNsbNJuUyQLGKzQ/4JFg' 6-max Seat #6 is the button
Seat 1: vqWjZmdQu/Hxw96/IJTWdQ ($25.10 in chips) 
Seat 2: UA5OsKS3VPaxa7uC8La/kA ($34.50 in chips) 
Seat 3: 8ClCHtFXGNplITm+63KB+Q ($51 in chips) 
Seat 5: oBUDUfeUyCbZBsjxHZgSiw ($26.80 in chips) 
Seat 6: fwg6dK1+r4jy/y+JqenYYQ ($14.15 in chips) 
vqWjZmdQu/Hxw96/IJTWdQ: posts small blind $0.10
UA5OsKS3VPaxa7uC8La/kA: posts big blind $0.25
9bpVv1/Qh9IYtXuCtl5VtQ: sits out 
*** HOLE CARDS ***
8ClCHtFXGNplITm+63KB+Q: folds 
oBUDUfeUyCbZBsjxHZgSiw: folds 
fwg6dK1+r4jy/y+JqenYYQ: folds 
vqWjZmdQu/Hxw96/IJTWdQ: folds 
Uncalled bet ($0.15) returned to UA5OsKS3VPaxa7uC8La/kA
UA5OsKS3VPaxa7uC8La/kA collected $0.20 from pot
*** SUMMARY ***
Total pot $0.20 | Rake $0 
Seat 1: vqWjZmdQu/Hxw96/IJTWdQ (small blind) folded before Flop
Seat 2: UA5OsKS3VPaxa7uC8La/kA (big blind) collected ($0.20)
Seat 3: 8ClCHtFXGNplITm+63KB+Q folded before Flop (didn't bet)
Seat 5: oBUDUfeUyCbZBsjxHZgSiw folded before Flop (didn't bet)
Seat 6: fwg6dK1+r4jy/y+JqenYYQ (button) folded before Flop (didn't bet)




PokerStars Game #59941690374:  Hold'em No Limit ($0.10/$0.25) - 2009/07/01 1:43:06 ET
Table 'oJpFwZj9+FUGHX90Un8s9Q' 6-max Seat #1 is the button
Seat 1: 6DwBRH+xZ12AAZmeAg+aXw ($22.60 in chips) 
Seat 2: NtrVQ9UIql0rDCnKDKZ5FQ ($15.80 in chips) 
Seat 3: kyRaCIljYA6l33lSKQfNsg ($24.65 in chips) 
Seat 4: 6elpmfyt4Zw0yvd8lePSMQ ($22.65 in chips) 
Seat 5: kG34n23qFQA3nzdOJTQ1dA ($56.10 in chips) 
Seat 6: edio/rLJ06xeZOfLhoL3UA ($1.20 in chips) 
NtrVQ9UIql0rDCnKDKZ5FQ: posts small blind $0.10
kyRaCIljYA6l33lSKQfNsg: posts big blind $0.25
*** HOLE CARDS ***
6elpmfyt4Zw0yvd8lePSMQ: folds 
kG34n23qFQA3nzdOJTQ1dA: folds 
edio/rLJ06xeZOfLhoL3UA: folds 
6DwBRH+xZ12AAZmeAg+aXw: folds 
NtrVQ9UIql0rDCnKDKZ5FQ: calls $0.15
kyRaCIljYA6l33lSKQfNsg: raises $0.75 to $1
NtrVQ9UIql0rDCnKDKZ5FQ: folds 
Uncalled bet ($0.75) returned to kyRaCIljYA6l33lSKQfNsg
kyRaCIljYA6l33lSKQfNsg collected $0.50 from pot
*** SUMMARY ***
Total pot $0.50 | Rake $0 
Seat 1: 6DwBRH+xZ12AAZmeAg+aXw (button) folded before Flop (didn't bet)
Seat 2: NtrVQ9UIql0rDCnKDKZ5FQ (small blind) folded before Flop
Seat 3: kyRaCIljYA6l33lSKQfNsg (big blind) collected ($0.50)
Seat 4: 6elpmfyt4Zw0yvd8lePSMQ folded before Flop (didn't bet)
Seat 5: kG34n23qFQA3nzdOJTQ1dA folded before Flop (didn't bet)
Seat 6: edio/rLJ06xeZOfLhoL3UA folded before Flop (didn't bet)




PokerStars Game #59941691198:  Hold'em No Limit ($0.10/$0.25) - 2009/07/01 1:43:07 ET
Table 'edvgY2YQ1I34euq4EVqGnA' 6-max Seat #4 is the button
Seat 1: mvFHK3pE7tCxJEqLjKC70Q ($25.25 in chips) 
Seat 2: SxIIgwXYLkwd6m3wLyPTCw ($15.90 in chips) 
Seat 3: mFv3iBCtrw9XfCDRB0d46Q ($3.55 in chips) 
Seat 4: TI/C5Q+DEl4fLR3AofwYdg ($19.15 in chips) 
Seat 5: EE16Ua5b1HSsYej5zeXOlA ($56.55 in chips) 
Seat 6: kG34n23qFQA3nzdOJTQ1dA ($72.35 in chips) 
EE16Ua5b1HSsYej5zeXOlA: posts small blind $0.10
kG34n23qFQA3nzdOJTQ1dA: posts big blind $0.25
*** HOLE CARDS ***
mvFHK3pE7tCxJEqLjKC70Q: folds 
SxIIgwXYLkwd6m3wLyPTCw: raises $0.50 to $0.75
mFv3iBCtrw9XfCDRB0d46Q: folds 
TI/C5Q+DEl4fLR3AofwYdg: calls $0.75
EE16Ua5b1HSsYej5zeXOlA: calls $0.65
kG34n23qFQA3nzdOJTQ1dA: folds 
*** FLOP *** [Jd 4c 5c]
EE16Ua5b1HSsYej5zeXOlA: checks 
SxIIgwXYLkwd6m3wLyPTCw: bets $1.50
TI/C5Q+DEl4fLR3AofwYdg: raises $4.25 to $5.75
EE16Ua5b1HSsYej5zeXOlA: folds 
SxIIgwXYLkwd6m3wLyPTCw: folds 
Uncalled bet ($4.25) returned to TI/C5Q+DEl4fLR3AofwYdg
TI/C5Q+DEl4fLR3AofwYdg collected $5.25 from pot
TI/C5Q+DEl4fLR3AofwYdg: doesn't show hand 
SxIIgwXYLkwd6m3wLyPTCw leaves the table
*** SUMMARY ***
Total pot $5.50 | Rake $0.25 
Board [Jd 4c 5c]
Seat 1: mvFHK3pE7tCxJEqLjKC70Q folded before Flop (didn't bet)
Seat 2: SxIIgwXYLkwd6m3wLyPTCw folded on the Flop
Seat 3: mFv3iBCtrw9XfCDRB0d46Q folded before Flop (didn't bet)
Seat 4: TI/C5Q+DEl4fLR3AofwYdg (button) collected ($5.25)
Seat 5: EE16Ua5b1HSsYej5zeXOlA (small blind) folded on the Flop
Seat 6: kG34n23qFQA3nzdOJTQ1dA (big blind) folded before Flop




PokerStars Game #59941690908:  Hold'em No Limit ($0.10/$0.25) - 2009/07/01 1:43:07 ET
Table 'wPWRBZPJl1HAnysw7qRR0A' 6-max Seat #6 is the button
Seat 1: m7ne1MOFTQXlsXT7/R/rug ($3.50 in chips) 
Seat 2: xC0kaiDYM6YTlgODL83O5A ($15 in chips) 
Seat 3: 1ZpoLWO2nm2w1Nd1v9Sr3g ($10.85 in chips) 
Seat 4: epAUIB7h2FJXzUPRIvSkRA ($25.95 in chips) 
Seat 5: y0B+UpYpOUJz3JWtlJQBSA ($16.35 in chips) 
Seat 6: Hsvkc0/G2VV78oVmWYXecw ($9.30 in chips) 
m7ne1MOFTQXlsXT7/R/rug: posts small blind $0.10
xC0kaiDYM6YTlgODL83O5A: posts big blind $0.25
*** HOLE CARDS ***
1ZpoLWO2nm2w1Nd1v9Sr3g: raises $0.50 to $0.75
epAUIB7h2FJXzUPRIvSkRA: folds 
y0B+UpYpOUJz3JWtlJQBSA: folds 
Hsvkc0/G2VV78oVmWYXecw: folds 
m7ne1MOFTQXlsXT7/R/rug: raises $2.75 to $3.50 and is all-in
xC0kaiDYM6YTlgODL83O5A: folds 
1ZpoLWO2nm2w1Nd1v9Sr3g: calls $2.75
*** FLOP *** [5h 6c 8c]
*** TURN *** [5h 6c 8c] [5c]
*** RIVER *** [5h 6c 8c 5c] [Js]
*** SHOW DOWN ***
m7ne1MOFTQXlsXT7/R/rug: shows [Td Ad] (a pair of Fives)
1ZpoLWO2nm2w1Nd1v9Sr3g: mucks hand 
m7ne1MOFTQXlsXT7/R/rug collected $6.90 from pot
*** SUMMARY ***
Total pot $7.25 | Rake $0.35 
Board [5h 6c 8c 5c Js]
Seat 1: m7ne1MOFTQXlsXT7/R/rug (small blind) showed [Td Ad] and won ($6.90) with a pair of Fives
Seat 2: xC0kaiDYM6YTlgODL83O5A (big blind) folded before Flop
Seat 3: 1ZpoLWO2nm2w1Nd1v9Sr3g mucked
Seat 4: epAUIB7h2FJXzUPRIvSkRA folded before Flop (didn't bet)
Seat 5: y0B+UpYpOUJz3JWtlJQBSA folded before Flop (didn't bet)
Seat 6: Hsvkc0/G2VV78oVmWYXecw (button) folded before Flop (didn't bet)




PokerStars Game #59941690892:  Hold'em No Limit ($0.10/$0.25) - 2009/07/01 1:43:07 ET
Table '9o8Yb3JpUqurD4pNVmOikQ' 6-max Seat #3 is the button
Seat 1: SFmT9ZsVopnukjvAzrxTRg ($27.55 in chips) 
Seat 2: /gJNBeCkWL4o85/jvlZ4BA ($25 in chips) 
Seat 3: JgRqo1/2phbf7pab7N3BIQ ($21.80 in chips) 
Seat 4: j5NZbEJHsERuXjPHWqc1Nw ($12 in chips) 
Seat 5: QqiZLFrN8iOUT/GHw7ztOA ($25 in chips) 
Seat 6: LyDHtw3/yniNHW+DvLXbog ($26.05 in chips) 
j5NZbEJHsERuXjPHWqc1Nw: posts small blind $0.10
QqiZLFrN8iOUT/GHw7ztOA: posts big blind $0.25
*** HOLE CARDS ***
LyDHtw3/yniNHW+DvLXbog: folds 
SFmT9ZsVopnukjvAzrxTRg: folds 
/gJNBeCkWL4o85/jvlZ4BA: folds 
JgRqo1/2phbf7pab7N3BIQ: calls $0.25
j5NZbEJHsERuXjPHWqc1Nw: folds 
QqiZLFrN8iOUT/GHw7ztOA: checks 
*** FLOP *** [Th As Jd]
QqiZLFrN8iOUT/GHw7ztOA: checks 
JgRqo1/2phbf7pab7N3BIQ: checks 
*** TURN *** [Th As Jd] [3c]
QqiZLFrN8iOUT/GHw7ztOA: bets $0.50
JgRqo1/2phbf7pab7N3BIQ: calls $0.50
*** RIVER *** [Th As Jd 3c] [Jc]
QqiZLFrN8iOUT/GHw7ztOA: checks 
JgRqo1/2phbf7pab7N3BIQ: checks 
*** SHOW DOWN ***
QqiZLFrN8iOUT/GHw7ztOA: shows [8d 5h] (a pair of Jacks)
JgRqo1/2phbf7pab7N3BIQ: shows [6h 6s] (two pair, Jacks and Sixes)
JgRqo1/2phbf7pab7N3BIQ collected $1.55 from pot
*** SUMMARY ***
Total pot $1.60 | Rake $0.05 
Board [Th As Jd 3c Jc]
Seat 1: SFmT9ZsVopnukjvAzrxTRg folded before Flop (didn't bet)
Seat 2: /gJNBeCkWL4o85/jvlZ4BA folded before Flop (didn't bet)
Seat 3: JgRqo1/2phbf7pab7N3BIQ (button) showed [6h 6s] and won ($1.55) with two pair, Jacks and Sixes
Seat 4: j5NZbEJHsERuXjPHWqc1Nw (small blind) folded before Flop
Seat 5: QqiZLFrN8iOUT/GHw7ztOA (big blind) showed [8d 5h] and lost with a pair of Jacks
Seat 6: LyDHtw3/yniNHW+DvLXbog folded before Flop (didn't bet)




PokerStars Game #59941690856:  Hold'em No Limit ($0.10/$0.25) - 2009/07/01 1:43:07 ET
Table 'wRXcD9iXgBbdvKhWmfnBnw' 6-max Seat #5 is the button
Seat 1: iIgNoBh+3/Ix1/fLsg+HuA ($6.25 in chips) 
Seat 2: vUr8qM1UsCElsCI9B/McdQ ($27.15 in chips) 
Seat 3: l4ToKwb3EVcEuva7hPqMCQ ($8.35 in chips) 
Seat 5: EE16Ua5b1HSsYej5zeXOlA ($43.75 in chips) 
Seat 6: JFIAqU8lCZ0vWwEl4bdGsg ($25 in chips) 
JFIAqU8lCZ0vWwEl4bdGsg: posts small blind $0.10
iIgNoBh+3/Ix1/fLsg+HuA: posts big blind $0.25
*** HOLE CARDS ***
mnuJq+Q1IXKm/pCy+OzxmQ joins the table at seat #4 
vUr8qM1UsCElsCI9B/McdQ: calls $0.25
l4ToKwb3EVcEuva7hPqMCQ: folds 
EE16Ua5b1HSsYej5zeXOlA: folds 
JFIAqU8lCZ0vWwEl4bdGsg: calls $0.15
iIgNoBh+3/Ix1/fLsg+HuA: checks 
*** FLOP *** [2s 8d 4c]
JFIAqU8lCZ0vWwEl4bdGsg: checks 
iIgNoBh+3/Ix1/fLsg+HuA: checks 
vUr8qM1UsCElsCI9B/McdQ: bets $0.25
JFIAqU8lCZ0vWwEl4bdGsg: calls $0.25
iIgNoBh+3/Ix1/fLsg+HuA: folds 
*** TURN *** [2s 8d 4c] [9c]
iIgNoBh+3/Ix1/fLsg+HuA leaves the table
JFIAqU8lCZ0vWwEl4bdGsg: checks 
vUr8qM1UsCElsCI9B/McdQ: bets $0.25
JFIAqU8lCZ0vWwEl4bdGsg: folds 
Uncalled bet ($0.25) returned to vUr8qM1UsCElsCI9B/McdQ
vUr8qM1UsCElsCI9B/McdQ collected $1.20 from pot
vUr8qM1UsCElsCI9B/McdQ: doesn't show hand 
*** SUMMARY ***
Total pot $1.25 | Rake $0.05 
Board [2s 8d 4c 9c]
Seat 1: iIgNoBh+3/Ix1/fLsg+HuA (big blind) folded on the Flop
Seat 2: vUr8qM1UsCElsCI9B/McdQ collected ($1.20)
Seat 3: l4ToKwb3EVcEuva7hPqMCQ folded before Flop (didn't bet)
Seat 5: EE16Ua5b1HSsYej5zeXOlA (button) folded before Flop (didn't bet)
Seat 6: JFIAqU8lCZ0vWwEl4bdGsg (small blind) folded on the Turn




PokerStars Game #59941690966:  Hold'em No Limit ($0.10/$0.25) - 2009/07/01 1:43:07 ET
Table 'pPgW4R3kdH26lLi1MnE92w' 9-max Seat #8 is the button
Seat 1: F4P6SxCNY4vxdb318G9RwA ($19.60 in chips) 
Seat 2: cZ99hugmLBj9KhTlc8nCSw ($27.50 in chips) 
Seat 3: WaS7+xnv4bIVHoru6nxczA ($13.75 in chips) 
Seat 4: 68iMVGMbYGvnpcCiPOVbbw ($4.65 in chips) 
Seat 5: HPEB+AtKw1+C/cxU0o1ciw ($21.55 in chips) 
Seat 6: VllYilcih0t+gMD4GTRlgQ ($25.65 in chips) 
Seat 7: sD+TKtt36XiiN6jqHiLwDA ($28.45 in chips) 
Seat 8: aCVg6cCxQcqClhB9nq/p1w ($29.95 in chips) 
Seat 9: tcbEu7VzyHQ+0lh+skbQhQ ($64.25 in chips) 
tcbEu7VzyHQ+0lh+skbQhQ: posts small blind $0.10
F4P6SxCNY4vxdb318G9RwA: posts big blind $0.25
*** HOLE CARDS ***
cZ99hugmLBj9KhTlc8nCSw: folds 
WaS7+xnv4bIVHoru6nxczA: folds 
68iMVGMbYGvnpcCiPOVbbw: folds 
HPEB+AtKw1+C/cxU0o1ciw: calls $0.25
VllYilcih0t+gMD4GTRlgQ: calls $0.25
sD+TKtt36XiiN6jqHiLwDA: folds 
aCVg6cCxQcqClhB9nq/p1w: folds 
tcbEu7VzyHQ+0lh+skbQhQ: calls $0.15
F4P6SxCNY4vxdb318G9RwA: checks 
*** FLOP *** [4c Kh Ah]
tcbEu7VzyHQ+0lh+skbQhQ: checks 
F4P6SxCNY4vxdb318G9RwA: checks 
HPEB+AtKw1+C/cxU0o1ciw: checks 
VllYilcih0t+gMD4GTRlgQ: checks 
*** TURN *** [4c Kh Ah] [Ts]
tcbEu7VzyHQ+0lh+skbQhQ: checks 
F4P6SxCNY4vxdb318G9RwA: checks 
HPEB+AtKw1+C/cxU0o1ciw: bets $1
VllYilcih0t+gMD4GTRlgQ: folds 
tcbEu7VzyHQ+0lh+skbQhQ: folds 
F4P6SxCNY4vxdb318G9RwA: folds 
Uncalled bet ($1) returned to HPEB+AtKw1+C/cxU0o1ciw
HPEB+AtKw1+C/cxU0o1ciw collected $0.95 from pot
HPEB+AtKw1+C/cxU0o1ciw: doesn't show hand 
*** SUMMARY ***
Total pot $1 | Rake $0.05 
Board [4c Kh Ah Ts]
Seat 1: F4P6SxCNY4vxdb318G9RwA (big blind) folded on the Turn
Seat 2: cZ99hugmLBj9KhTlc8nCSw folded before Flop (didn't bet)
Seat 3: WaS7+xnv4bIVHoru6nxczA folded before Flop (didn't bet)
Seat 4: 68iMVGMbYGvnpcCiPOVbbw folded before Flop (didn't bet)
Seat 5: HPEB+AtKw1+C/cxU0o1ciw collected ($0.95)
Seat 6: VllYilcih0t+gMD4GTRlgQ folded on the Turn
Seat 7: sD+TKtt36XiiN6jqHiLwDA folded before Flop (didn't bet)
Seat 8: aCVg6cCxQcqClhB9nq/p1w (button) folded before Flop (didn't bet)
Seat 9: tcbEu7VzyHQ+0lh+skbQhQ (small blind) folded on the Turn




PokerStars Game #59941691190:  Hold'em No Limit ($0.10/$0.25) - 2009/07/01 1:43:07 ET
Table 'SgI2Cobdjtkh0Fd0/eTTDg' 9-max Seat #2 is the button
Seat 1: NcPAt5YjVvDFEJTTgAVj8g ($6.20 in chips) 
Seat 2: uUc5QTI8+ZdC95UnznCsqg ($13.30 in chips) 
Seat 3: OiV1PWZ3IkN29JlmCcnTwQ ($4.65 in chips) 
Seat 4: s1y+qfkBnhgc67+X3ThjeA ($10.25 in chips) 
Seat 5: w/RUHfVzKTf7Bc19nucLpQ ($23.70 in chips) 
Seat 6: 6RiVTYll/5D8zICp0MRpKw ($26.25 in chips) 
Seat 7: lOuxRXNpa9V2VxLMNpxUOg ($20.20 in chips) 
Seat 8: 8GJHzzxiotOqC5gdtgpLoA ($9.65 in chips) 
Seat 9: cZ99hugmLBj9KhTlc8nCSw ($30.95 in chips) 
OiV1PWZ3IkN29JlmCcnTwQ: posts small blind $0.10
s1y+qfkBnhgc67+X3ThjeA: posts big blind $0.25
*** HOLE CARDS ***
w/RUHfVzKTf7Bc19nucLpQ: folds 
6RiVTYll/5D8zICp0MRpKw: folds 
w/RUHfVzKTf7Bc19nucLpQ leaves the table
lOuxRXNpa9V2VxLMNpxUOg: calls $0.25
8GJHzzxiotOqC5gdtgpLoA: folds 
cZ99hugmLBj9KhTlc8nCSw: folds 
NcPAt5YjVvDFEJTTgAVj8g: calls $0.25
uUc5QTI8+ZdC95UnznCsqg: calls $0.25
OiV1PWZ3IkN29JlmCcnTwQ: calls $0.15
s1y+qfkBnhgc67+X3ThjeA: checks 
*** FLOP *** [7s Th Kh]
OiV1PWZ3IkN29JlmCcnTwQ: checks 
s1y+qfkBnhgc67+X3ThjeA: checks 
RHqgdFvufLCYe54+qd2gcA joins the table at seat #5 
lOuxRXNpa9V2VxLMNpxUOg: checks 
NcPAt5YjVvDFEJTTgAVj8g: checks 
uUc5QTI8+ZdC95UnznCsqg: bets $1
OiV1PWZ3IkN29JlmCcnTwQ: folds 
s1y+qfkBnhgc67+X3ThjeA: folds 
lOuxRXNpa9V2VxLMNpxUOg: folds 
NcPAt5YjVvDFEJTTgAVj8g: folds 
Uncalled bet ($1) returned to uUc5QTI8+ZdC95UnznCsqg
uUc5QTI8+ZdC95UnznCsqg collected $1.20 from pot
uUc5QTI8+ZdC95UnznCsqg: doesn't show hand 
*** SUMMARY ***
Total pot $1.25 | Rake $0.05 
Board [7s Th Kh]
Seat 1: NcPAt5YjVvDFEJTTgAVj8g folded on the Flop
Seat 2: uUc5QTI8+ZdC95UnznCsqg (button) collected ($1.20)
Seat 3: OiV1PWZ3IkN29JlmCcnTwQ (small blind) folded on the Flop
Seat 4: s1y+qfkBnhgc67+X3ThjeA (big blind) folded on the Flop
Seat 5: w/RUHfVzKTf7Bc19nucLpQ folded before Flop (didn't bet)
Seat 6: 6RiVTYll/5D8zICp0MRpKw folded before Flop (didn't bet)
Seat 7: lOuxRXNpa9V2VxLMNpxUOg folded on the Flop
Seat 8: 8GJHzzxiotOqC5gdtgpLoA folded before Flop (didn't bet)
Seat 9: cZ99hugmLBj9KhTlc8nCSw folded before Flop (didn't bet)




PokerStars Game #59941691380:  Hold'em No Limit ($0.10/$0.25) - 2009/07/01 1:43:08 ET
Table 'IdXp6nyeW4FYaEK4qKCnwQ' 9-max Seat #9 is the button
Seat 1: tLcDklc2rBORNfixyRfVfw ($25 in chips) 
Seat 2: HPEB+AtKw1+C/cxU0o1ciw ($32.50 in chips) 
Seat 3: eK8qa6EPcH2zhtbmWSvc9g ($33.40 in chips) 
Seat 4: j4q3p0lesp63b1gZDwLBZw ($5.35 in chips) 
Seat 5: U41wNf6XauAiBOQaKu2ZIA ($25.65 in chips) 
Seat 6: arxNSjreDRGFg13EAM2F1w ($25.85 in chips) 
Seat 7: w1ukf8uPa4+WH561TtVRxA ($37 in chips) 
Seat 8: dtZ84flFEi4Q+SGrHMJRDQ ($31.10 in chips) 
Seat 9: s2xLPOl/vhl/26apJ3vsOQ ($28.90 in chips) 
tLcDklc2rBORNfixyRfVfw: posts small blind $0.10
HPEB+AtKw1+C/cxU0o1ciw: posts big blind $0.25
*** HOLE CARDS ***
eK8qa6EPcH2zhtbmWSvc9g: folds 
j4q3p0lesp63b1gZDwLBZw: folds 
U41wNf6XauAiBOQaKu2ZIA: folds 
arxNSjreDRGFg13EAM2F1w: folds 
w1ukf8uPa4+WH561TtVRxA: folds 
dtZ84flFEi4Q+SGrHMJRDQ: folds 
s2xLPOl/vhl/26apJ3vsOQ: folds 
tLcDklc2rBORNfixyRfVfw: folds 
Uncalled bet ($0.15) returned to HPEB+AtKw1+C/cxU0o1ciw
HPEB+AtKw1+C/cxU0o1ciw collected $0.20 from pot
HPEB+AtKw1+C/cxU0o1ciw: doesn't show hand 
*** SUMMARY ***
Total pot $0.20 | Rake $0 
Seat 1: tLcDklc2rBORNfixyRfVfw (small blind) folded before Flop
Seat 2: HPEB+AtKw1+C/cxU0o1ciw (big blind) collected ($0.20)
Seat 3: eK8qa6EPcH2zhtbmWSvc9g folded before Flop (didn't bet)
Seat 4: j4q3p0lesp63b1gZDwLBZw folded before Flop (didn't bet)
Seat 5: U41wNf6XauAiBOQaKu2ZIA folded before Flop (didn't bet)
Seat 6: arxNSjreDRGFg13EAM2F1w folded before Flop (didn't bet)
Seat 7: w1ukf8uPa4+WH561TtVRxA folded before Flop (didn't bet)
Seat 8: dtZ84flFEi4Q+SGrHMJRDQ folded before Flop (didn't bet)
Seat 9: s2xLPOl/vhl/26apJ3vsOQ (button) folded before Flop (didn't bet)




PokerStars Game #59941691316:  Hold'em No Limit ($0.10/$0.25) - 2009/07/01 1:43:08 ET
Table 'IUwZ/e0bDHZPgsIWx0RnNg' 6-max Seat #1 is the button
Seat 1: V66QiVCQPofyl3a+dpPHQQ ($4.95 in chips) 
Seat 2: mvFHK3pE7tCxJEqLjKC70Q ($54.40 in chips) 
Seat 3: dOX4wnYV2sEqvDbF+8KSCw ($25.35 in chips) 
Seat 4: OIjOiBfQstWrK/RuXx7zcw ($5.70 in chips) 
Seat 6: NhUN/JpAprdJeamFBgJH1w ($40.25 in chips) 
mvFHK3pE7tCxJEqLjKC70Q: posts small blind $0.10
dOX4wnYV2sEqvDbF+8KSCw: posts big blind $0.25
9bpVv1/Qh9IYtXuCtl5VtQ: sits out 
*** HOLE CARDS ***
OIjOiBfQstWrK/RuXx7zcw: folds 
NhUN/JpAprdJeamFBgJH1w: raises $0.75 to $1
V66QiVCQPofyl3a+dpPHQQ: raises $3.95 to $4.95 and is all-in
mvFHK3pE7tCxJEqLjKC70Q: folds 
dOX4wnYV2sEqvDbF+8KSCw: folds 
NhUN/JpAprdJeamFBgJH1w: folds 
Uncalled bet ($3.95) returned to V66QiVCQPofyl3a+dpPHQQ
V66QiVCQPofyl3a+dpPHQQ collected $2.35 from pot
*** SUMMARY ***
Total pot $2.35 | Rake $0 
Seat 1: V66QiVCQPofyl3a+dpPHQQ (button) collected ($2.35)
Seat 2: mvFHK3pE7tCxJEqLjKC70Q (small blind) folded before Flop
Seat 3: dOX4wnYV2sEqvDbF+8KSCw (big blind) folded before Flop
Seat 4: OIjOiBfQstWrK/RuXx7zcw folded before Flop (didn't bet)
Seat 6: NhUN/JpAprdJeamFBgJH1w folded before Flop




PokerStars Game #59941691546:  Hold'em No Limit ($0.10/$0.25) - 2009/07/01 1:43:08 ET
Table 'zKwHJD0cmKNUure9qQTfFg' 6-max Seat #6 is the button
Seat 1: Hzrn9DZJegEZICufTNYkrg ($15.10 in chips) 
Seat 2: xrf8tAXKQHG99HixCot1Iw ($25.80 in chips) 
Seat 4: v+QfkGiuj9bgtuNoVnDO8w ($25.80 in chips) 
Seat 5: E4AqQ1egsnu0oH2RqsbCmQ ($3.80 in chips) 
Seat 6: edio/rLJ06xeZOfLhoL3UA ($7.60 in chips) 
Hzrn9DZJegEZICufTNYkrg: posts small blind $0.10
xrf8tAXKQHG99HixCot1Iw: posts big blind $0.25
*** HOLE CARDS ***
v+QfkGiuj9bgtuNoVnDO8w: folds 
E4AqQ1egsnu0oH2RqsbCmQ: folds 
m9aw7LBAB5YX2ZqMtMkhqA joins the table at seat #3 
edio/rLJ06xeZOfLhoL3UA: raises $0.75 to $1
Hzrn9DZJegEZICufTNYkrg: calls $0.90
xrf8tAXKQHG99HixCot1Iw: calls $0.75
*** FLOP *** [Kh 7d 4c]
Hzrn9DZJegEZICufTNYkrg: checks 
xrf8tAXKQHG99HixCot1Iw: checks 
edio/rLJ06xeZOfLhoL3UA: bets $1.25
Hzrn9DZJegEZICufTNYkrg: calls $1.25
xrf8tAXKQHG99HixCot1Iw: folds 
*** TURN *** [Kh 7d 4c] [Ac]
Hzrn9DZJegEZICufTNYkrg: checks 
edio/rLJ06xeZOfLhoL3UA: bets $1.50
Hzrn9DZJegEZICufTNYkrg: raises $1.50 to $3
edio/rLJ06xeZOfLhoL3UA: folds 
Uncalled bet ($1.50) returned to Hzrn9DZJegEZICufTNYkrg
Hzrn9DZJegEZICufTNYkrg collected $8.10 from pot
Hzrn9DZJegEZICufTNYkrg: doesn't show hand 
*** SUMMARY ***
Total pot $8.50 | Rake $0.40 
Board [Kh 7d 4c Ac]
Seat 1: Hzrn9DZJegEZICufTNYkrg (small blind) collected ($8.10)
Seat 2: xrf8tAXKQHG99HixCot1Iw (big blind) folded on the Flop
Seat 4: v+QfkGiuj9bgtuNoVnDO8w folded before Flop (didn't bet)
Seat 5: E4AqQ1egsnu0oH2RqsbCmQ folded before Flop (didn't bet)
Seat 6: edio/rLJ06xeZOfLhoL3UA (button) folded on the Turn




PokerStars Game #59941691792:  Hold'em No Limit ($0.10/$0.25) - 2009/07/01 1:43:08 ET
Table 'M7d9IrgQUUFFy/SZ3ksLYg' 6-max Seat #4 is the button
Seat 1: ypmjhffk/YHGc51wgVXUTw ($49.60 in chips) 
Seat 2: gqrr7lSWrQ1N8zKx8zZzvA ($9.05 in chips) 
Seat 3: 8JTm/CXBn3+kuQgcUOgPkw ($22.70 in chips) 
Seat 4: 8ClCHtFXGNplITm+63KB+Q ($24.55 in chips) 
Seat 5: kMa8BltUcBQVxnHfqdCfXg ($4.45 in chips) 
Seat 6: 7S16WhQHiAVLWwRuqPrpnw ($12.15 in chips) 
kMa8BltUcBQVxnHfqdCfXg: posts small blind $0.10
7S16WhQHiAVLWwRuqPrpnw: posts big blind $0.25
*** HOLE CARDS ***
ypmjhffk/YHGc51wgVXUTw: folds 
gqrr7lSWrQ1N8zKx8zZzvA: folds 
8JTm/CXBn3+kuQgcUOgPkw: folds 
8ClCHtFXGNplITm+63KB+Q: folds 
kMa8BltUcBQVxnHfqdCfXg: raises $0.25 to $0.50
7S16WhQHiAVLWwRuqPrpnw: calls $0.25
*** FLOP *** [5s Kc 9s]
kMa8BltUcBQVxnHfqdCfXg: bets $0.25
7S16WhQHiAVLWwRuqPrpnw: calls $0.25
*** TURN *** [5s Kc 9s] [Kd]
kMa8BltUcBQVxnHfqdCfXg: bets $0.25
7S16WhQHiAVLWwRuqPrpnw: calls $0.25
*** RIVER *** [5s Kc 9s Kd] [2s]
kMa8BltUcBQVxnHfqdCfXg: bets $0.25
7S16WhQHiAVLWwRuqPrpnw: calls $0.25
*** SHOW DOWN ***
kMa8BltUcBQVxnHfqdCfXg: shows [Jh Th] (a pair of Kings)
7S16WhQHiAVLWwRuqPrpnw: shows [Ts Ac] (a pair of Kings - Ace kicker)
7S16WhQHiAVLWwRuqPrpnw collected $2.40 from pot
*** SUMMARY ***
Total pot $2.50 | Rake $0.10 
Board [5s Kc 9s Kd 2s]
Seat 1: ypmjhffk/YHGc51wgVXUTw folded before Flop (didn't bet)
Seat 2: gqrr7lSWrQ1N8zKx8zZzvA folded before Flop (didn't bet)
Seat 3: 8JTm/CXBn3+kuQgcUOgPkw folded before Flop (didn't bet)
Seat 4: 8ClCHtFXGNplITm+63KB+Q (button) folded before Flop (didn't bet)
Seat 5: kMa8BltUcBQVxnHfqdCfXg (small blind) showed [Jh Th] and lost with a pair of Kings
Seat 6: 7S16WhQHiAVLWwRuqPrpnw (big blind) showed [Ts Ac] and won ($2.40) with a pair of Kings




PokerStars Game #59941691836:  Hold'em No Limit ($0.10/$0.25) - 2009/07/01 1:43:08 ET
Table '8PD/MTROSMd6Y8mZeykbpg' 6-max Seat #4 is the button
Seat 1: fxNpaToxECtD2Goelmg9vA ($25.10 in chips) 
Seat 2: 4TM16KVgEiQpLi4bVVWbVQ ($25 in chips) 
Seat 3: vqWjZmdQu/Hxw96/IJTWdQ ($25.25 in chips) 
Seat 4: DFi/Lzkjsfv8QswS80JX9Q ($53.70 in chips) 
Seat 5: z3tQwy28dp5FykDJC/wzQw ($25.70 in chips) 
Seat 6: trN/oHqTTbPw5MNuKrOpLw ($25 in chips) 
z3tQwy28dp5FykDJC/wzQw: posts small blind $0.10
trN/oHqTTbPw5MNuKrOpLw: posts big blind $0.25
4TM16KVgEiQpLi4bVVWbVQ: posts big blind $0.25
*** HOLE CARDS ***
fxNpaToxECtD2Goelmg9vA: folds 
4TM16KVgEiQpLi4bVVWbVQ: checks 
vqWjZmdQu/Hxw96/IJTWdQ: folds 
DFi/Lzkjsfv8QswS80JX9Q: folds 
z3tQwy28dp5FykDJC/wzQw: folds 
trN/oHqTTbPw5MNuKrOpLw: checks 
*** FLOP *** [4s 6s Qh]
trN/oHqTTbPw5MNuKrOpLw: checks 
4TM16KVgEiQpLi4bVVWbVQ: checks 
*** TURN *** [4s 6s Qh] [7c]
trN/oHqTTbPw5MNuKrOpLw: bets $0.50
4TM16KVgEiQpLi4bVVWbVQ: calls $0.50
*** RIVER *** [4s 6s Qh 7c] [6d]
trN/oHqTTbPw5MNuKrOpLw: checks 
4TM16KVgEiQpLi4bVVWbVQ: checks 
*** SHOW DOWN ***
trN/oHqTTbPw5MNuKrOpLw: shows [7h 8d] (two pair, Sevens and Sixes)
4TM16KVgEiQpLi4bVVWbVQ: mucks hand 
trN/oHqTTbPw5MNuKrOpLw collected $1.55 from pot
*** SUMMARY ***
Total pot $1.60 | Rake $0.05 
Board [4s 6s Qh 7c 6d]
Seat 1: fxNpaToxECtD2Goelmg9vA folded before Flop (didn't bet)
Seat 2: 4TM16KVgEiQpLi4bVVWbVQ mucked
Seat 3: vqWjZmdQu/Hxw96/IJTWdQ folded before Flop (didn't bet)
Seat 4: DFi/Lzkjsfv8QswS80JX9Q (button) folded before Flop (didn't bet)
Seat 5: z3tQwy28dp5FykDJC/wzQw (small blind) folded before Flop
Seat 6: trN/oHqTTbPw5MNuKrOpLw (big blind) showed [7h 8d] and won ($1.55) with two pair, Sevens and Sixes




PokerStars Game #59941691330:  Hold'em No Limit ($0.10/$0.25) - 2009/07/01 1:43:08 ET
Table 'nXVbUw6/HYwA6x21+IZ3XQ' 9-max Seat #7 is the button
Seat 2: 9lvO/qyU+xrU95Teu1fv0g ($5.25 in chips) 
Seat 3: 7je+LC5Mfs6nL8YBVh4frQ ($6.40 in chips) 
Seat 6: ljemhp25Zg+nlA9DLCIiUw ($26.85 in chips) 
Seat 7: ShCS62CJp4MKfKLKvGKQbA ($12.40 in chips) 
Seat 8: dfNim92Z6XK1/h5SFW5vDg ($26.90 in chips) 
Seat 9: OTCjTlu92MEBtX/i9Gm7yA ($12.55 in chips) 
dfNim92Z6XK1/h5SFW5vDg: posts small blind $0.10
OTCjTlu92MEBtX/i9Gm7yA: posts big blind $0.25
SpiiQQAzy4MUgV3I5W8giw: sits out 
*** HOLE CARDS ***
9lvO/qyU+xrU95Teu1fv0g: folds 
7je+LC5Mfs6nL8YBVh4frQ: folds 
ljemhp25Zg+nlA9DLCIiUw: raises $0.50 to $0.75
ShCS62CJp4MKfKLKvGKQbA: folds 
dfNim92Z6XK1/h5SFW5vDg: folds 
OTCjTlu92MEBtX/i9Gm7yA: folds 
Uncalled bet ($0.50) returned to ljemhp25Zg+nlA9DLCIiUw
ljemhp25Zg+nlA9DLCIiUw collected $0.60 from pot
ljemhp25Zg+nlA9DLCIiUw: doesn't show hand 
*** SUMMARY ***
Total pot $0.60 | Rake $0 
Seat 2: 9lvO/qyU+xrU95Teu1fv0g folded before Flop (didn't bet)
Seat 3: 7je+LC5Mfs6nL8YBVh4frQ folded before Flop (didn't bet)
Seat 6: ljemhp25Zg+nlA9DLCIiUw collected ($0.60)
Seat 7: ShCS62CJp4MKfKLKvGKQbA (button) folded before Flop (didn't bet)
Seat 8: dfNim92Z6XK1/h5SFW5vDg (small blind) folded before Flop
Seat 9: OTCjTlu92MEBtX/i9Gm7yA (big blind) folded before Flop




PokerStars Game #59941691806:  Hold'em No Limit ($0.10/$0.25) - 2009/07/01 1:43:08 ET
Table '/AhP8uWRzEEhOATYIdmn0A' 9-max Seat #6 is the button
Seat 1: +sbyWwIcFp9kP0bDtMegfQ ($37.80 in chips) 
Seat 2: nx5EoCNZFR03YUOXyT22wQ ($17.30 in chips) 
Seat 3: jx6dnobNHstDG0tabsbKHQ ($3.30 in chips) 
Seat 4: bXpVeaSTPBFSPJmeXxO7nw ($6 in chips) 
Seat 6: 8EbrQ/EvFWt2cr0GaU82gQ ($5 in chips) 
Seat 7: cZ99hugmLBj9KhTlc8nCSw ($25 in chips) 
Seat 8: K86cg2ifCMFAlmzsfTDjig ($25.35 in chips) 
cZ99hugmLBj9KhTlc8nCSw: posts small blind $0.10
K86cg2ifCMFAlmzsfTDjig: posts big blind $0.25
TidusNexus: sits out 
*** HOLE CARDS ***
+sbyWwIcFp9kP0bDtMegfQ: folds 
nx5EoCNZFR03YUOXyT22wQ: folds 
TidusNexus leaves the table
jx6dnobNHstDG0tabsbKHQ: folds 
nickygao2002 joins the table at seat #9 
bXpVeaSTPBFSPJmeXxO7nw: folds 
8EbrQ/EvFWt2cr0GaU82gQ: folds 
cZ99hugmLBj9KhTlc8nCSw: raises $0.50 to $0.75
K86cg2ifCMFAlmzsfTDjig: calls $0.50
*** FLOP *** [2d 6c 7c]
cZ99hugmLBj9KhTlc8nCSw: bets $1
K86cg2ifCMFAlmzsfTDjig: calls $1
*** TURN *** [2d 6c 7c] [5c]
cZ99hugmLBj9KhTlc8nCSw: checks 
K86cg2ifCMFAlmzsfTDjig: bets $2.50
cZ99hugmLBj9KhTlc8nCSw: folds 
Uncalled bet ($2.50) returned to K86cg2ifCMFAlmzsfTDjig
K86cg2ifCMFAlmzsfTDjig collected $3.35 from pot
K86cg2ifCMFAlmzsfTDjig: doesn't show hand 
*** SUMMARY ***
Total pot $3.50 | Rake $0.15 
Board [2d 6c 7c 5c]
Seat 1: +sbyWwIcFp9kP0bDtMegfQ folded before Flop (didn't bet)
Seat 2: nx5EoCNZFR03YUOXyT22wQ folded before Flop (didn't bet)
Seat 3: jx6dnobNHstDG0tabsbKHQ folded before Flop (didn't bet)
Seat 4: bXpVeaSTPBFSPJmeXxO7nw folded before Flop (didn't bet)
Seat 6: 8EbrQ/EvFWt2cr0GaU82gQ (button) folded before Flop (didn't bet)
Seat 7: cZ99hugmLBj9KhTlc8nCSw (small blind) folded on the Turn
Seat 8: K86cg2ifCMFAlmzsfTDjig (big blind) collected ($3.35)




PokerStars Game #59941692272:  Hold'em No Limit ($0.10/$0.25) - 2009/07/01 1:43:09 ET
Table 'z2yOdY2zyGWG1gh9WV9XtQ' 9-max Seat #2 is the button
Seat 1: 7je+LC5Mfs6nL8YBVh4frQ ($4.65 in chips) 
Seat 2: bXpVeaSTPBFSPJmeXxO7nw ($4.65 in chips) 
Seat 3: X78b5v/uhqeXXoAijbw/yg ($27.50 in chips) 
Seat 5: W6tExOcYX7qiy6Qdp+ZwFA ($10.55 in chips) 
Seat 6: NBYmTySMtIicyMj5Vjzqhw ($21.80 in chips) 
Seat 8: Mh2r9hTeTEDnh19sRZtW3g ($7.50 in chips) 
Seat 9: wGigCmBR/9XWkPpvYos3aQ ($34.40 in chips) 
X78b5v/uhqeXXoAijbw/yg: posts small blind $0.10
4awUyiDYTgylQKXZ9faBVA: is sitting out 
4awUyiDYTgylQKXZ9faBVA leaves the table
W6tExOcYX7qiy6Qdp+ZwFA: posts big blind $0.25
*** HOLE CARDS ***
NBYmTySMtIicyMj5Vjzqhw: folds 
Mh2r9hTeTEDnh19sRZtW3g: folds 
wGigCmBR/9XWkPpvYos3aQ: folds 
7je+LC5Mfs6nL8YBVh4frQ: folds 
bXpVeaSTPBFSPJmeXxO7nw: folds 
X78b5v/uhqeXXoAijbw/yg: folds 
Uncalled bet ($0.15) returned to W6tExOcYX7qiy6Qdp+ZwFA
W6tExOcYX7qiy6Qdp+ZwFA collected $0.20 from pot
W6tExOcYX7qiy6Qdp+ZwFA: doesn't show hand 
*** SUMMARY ***
Total pot $0.20 | Rake $0 
Seat 1: 7je+LC5Mfs6nL8YBVh4frQ folded before Flop (didn't bet)
Seat 2: bXpVeaSTPBFSPJmeXxO7nw (button) folded before Flop (didn't bet)
Seat 3: X78b5v/uhqeXXoAijbw/yg (small blind) folded before Flop
Seat 5: W6tExOcYX7qiy6Qdp+ZwFA (big blind) collected ($0.20)
Seat 6: NBYmTySMtIicyMj5Vjzqhw folded before Flop (didn't bet)
Seat 8: Mh2r9hTeTEDnh19sRZtW3g folded before Flop (didn't bet)
Seat 9: wGigCmBR/9XWkPpvYos3aQ folded before Flop (didn't bet)




PokerStars Game #59941692290:  Hold'em No Limit ($0.10/$0.25) - 2009/07/01 1:43:09 ET
Table 'aaXqTKUnxrX9DYXtxhWXxA' 6-max Seat #2 is the button
Seat 1: rnpAao581IcvQglpkpnkoQ ($8 in chips) 
Seat 2: DE9hRlt14g+JdsRQ4wT7hg ($33.70 in chips) 
Seat 3: uUXdcVMNa05rfbntdvplfw ($8.75 in chips) 
Seat 4: 48oT5xFI+5CHUJlfoGrE4w ($10.90 in chips) 
Seat 5: kyRaCIljYA6l33lSKQfNsg ($26.95 in chips) 
Seat 6: buyjetgNT1McXtdaP4zynA ($47.45 in chips) 
uUXdcVMNa05rfbntdvplfw: posts small blind $0.10
48oT5xFI+5CHUJlfoGrE4w: posts big blind $0.25
*** HOLE CARDS ***
kyRaCIljYA6l33lSKQfNsg: folds 
buyjetgNT1McXtdaP4zynA: folds 
rnpAao581IcvQglpkpnkoQ: folds 
rnpAao581IcvQglpkpnkoQ leaves the table
DE9hRlt14g+JdsRQ4wT7hg: folds 
uUXdcVMNa05rfbntdvplfw: raises $0.50 to $0.75
48oT5xFI+5CHUJlfoGrE4w: folds 
Uncalled bet ($0.50) returned to uUXdcVMNa05rfbntdvplfw
uUXdcVMNa05rfbntdvplfw collected $0.50 from pot
*** SUMMARY ***
Total pot $0.50 | Rake $0 
Seat 1: rnpAao581IcvQglpkpnkoQ folded before Flop (didn't bet)
Seat 2: DE9hRlt14g+JdsRQ4wT7hg (button) folded before Flop (didn't bet)
Seat 3: uUXdcVMNa05rfbntdvplfw (small blind) collected ($0.50)
Seat 4: 48oT5xFI+5CHUJlfoGrE4w (big blind) folded before Flop
Seat 5: kyRaCIljYA6l33lSKQfNsg folded before Flop (didn't bet)
Seat 6: buyjetgNT1McXtdaP4zynA folded before Flop (didn't bet)




PokerStars Game #59941692196:  Hold'em No Limit ($0.10/$0.25) - 2009/07/01 1:43:09 ET
Table '3Ns9nuTkynfwbBfBXzg6ww' 6-max Seat #2 is the button
Seat 1: epAUIB7h2FJXzUPRIvSkRA ($25.35 in chips) 
Seat 2: zxeVQGaMKDsDzmSY+AInjA ($33.35 in chips) 
Seat 3: eL3+wCBjFGfQ5FMdIZihwA ($24.40 in chips) 
Seat 4: qGHGf/553gQnDoklMRe3tg ($30.95 in chips) 
Seat 5: wqphQtauX5Qn7WRJZS1flA ($25.65 in chips) 
Seat 6: DE9hRlt14g+JdsRQ4wT7hg ($36.05 in chips) 
eL3+wCBjFGfQ5FMdIZihwA: posts small blind $0.10
qGHGf/553gQnDoklMRe3tg: posts big blind $0.25
*** HOLE CARDS ***
wqphQtauX5Qn7WRJZS1flA: folds 
DE9hRlt14g+JdsRQ4wT7hg: folds 
epAUIB7h2FJXzUPRIvSkRA: folds 
zxeVQGaMKDsDzmSY+AInjA: raises $0.50 to $0.75
eL3+wCBjFGfQ5FMdIZihwA: folds 
qGHGf/553gQnDoklMRe3tg: folds 
Uncalled bet ($0.50) returned to zxeVQGaMKDsDzmSY+AInjA
zxeVQGaMKDsDzmSY+AInjA collected $0.60 from pot
*** SUMMARY ***
Total pot $0.60 | Rake $0 
Seat 1: epAUIB7h2FJXzUPRIvSkRA folded before Flop (didn't bet)
Seat 2: zxeVQGaMKDsDzmSY+AInjA (button) collected ($0.60)
Seat 3: eL3+wCBjFGfQ5FMdIZihwA (small blind) folded before Flop
Seat 4: qGHGf/553gQnDoklMRe3tg (big blind) folded before Flop
Seat 5: wqphQtauX5Qn7WRJZS1flA folded before Flop (didn't bet)
Seat 6: DE9hRlt14g+JdsRQ4wT7hg folded before Flop (didn't bet)




PokerStars Game #59941692422:  Hold'em No Limit ($0.10/$0.25) - 2009/07/01 1:43:09 ET
Table 'SbSV5tlgLp0+/Z+13PW3Hg' 9-max Seat #5 is the button
Seat 1: x+W5+3qsdY4Iszf0hoH+Aw ($14.85 in chips) 
Seat 3: CT7Xj/V/O5rBlhtt+RZeFQ ($25.35 in chips) 
Seat 4: puj3K/wrNjEj86ZL/MyfLA ($10.85 in chips) 
Seat 5: aNpwfA31EREwO+ar4XzBCw ($25 in chips) 
Seat 6: pN3IHvAKm2fz+sTRARTcrg ($25.50 in chips) 
Seat 7: ruosoLPCzPyA3nfXoPVY3Q ($1.10 in chips) 
Seat 8: qBdqLaJhO+1itcMk70bsfA ($8.90 in chips) 
Seat 9: X78b5v/uhqeXXoAijbw/yg ($25 in chips) 
pN3IHvAKm2fz+sTRARTcrg: posts small blind $0.10
ruosoLPCzPyA3nfXoPVY3Q: posts big blind $0.25
*** HOLE CARDS ***
qBdqLaJhO+1itcMk70bsfA: folds 
X78b5v/uhqeXXoAijbw/yg: folds 
x+W5+3qsdY4Iszf0hoH+Aw: folds 
CT7Xj/V/O5rBlhtt+RZeFQ: folds 
puj3K/wrNjEj86ZL/MyfLA: folds 
aNpwfA31EREwO+ar4XzBCw: folds 
pN3IHvAKm2fz+sTRARTcrg: folds 
Uncalled bet ($0.15) returned to ruosoLPCzPyA3nfXoPVY3Q
ruosoLPCzPyA3nfXoPVY3Q collected $0.20 from pot
ruosoLPCzPyA3nfXoPVY3Q: doesn't show hand 
*** SUMMARY ***
Total pot $0.20 | Rake $0 
Seat 1: x+W5+3qsdY4Iszf0hoH+Aw folded before Flop (didn't bet)
Seat 3: CT7Xj/V/O5rBlhtt+RZeFQ folded before Flop (didn't bet)
Seat 4: puj3K/wrNjEj86ZL/MyfLA folded before Flop (didn't bet)
Seat 5: aNpwfA31EREwO+ar4XzBCw (button) folded before Flop (didn't bet)
Seat 6: pN3IHvAKm2fz+sTRARTcrg (small blind) folded before Flop
Seat 7: ruosoLPCzPyA3nfXoPVY3Q (big blind) collected ($0.20)
Seat 8: qBdqLaJhO+1itcMk70bsfA folded before Flop (didn't bet)
Seat 9: X78b5v/uhqeXXoAijbw/yg folded before Flop (didn't bet)




PokerStars Game #59941691926:  Hold'em No Limit ($0.10/$0.25) - 2009/07/01 1:43:09 ET
Table '0w9m+UkNlGMNoPyQqzWk6A' 9-max Seat #5 is the button
Seat 1: yoL2UPRJrmSO7wXIS4Ak4g ($27.85 in chips) 
Seat 2: tYsOBqdU1+x+yFI7zHO7hQ ($50.05 in chips) 
Seat 3: VWwtMkIjXloiX/RKh7RGWQ ($14.55 in chips) 
Seat 4: z5GxcHlYz/GSz6W2uFiTtg ($23.15 in chips) 
Seat 5: HPEB+AtKw1+C/cxU0o1ciw ($48.55 in chips) 
Seat 6: CgIo2ItZqi4o3ayVG6HanQ ($30.40 in chips) 
Seat 7: 57qrNGHDvf6GhB8zVLsAtQ ($4.80 in chips) 
Seat 8: I+ARcuQBEroNUEjIZ2pprg ($14.35 in chips) 
Seat 9: KqS/lY/fNB9qUxokm9QfeA ($8.60 in chips) 
CgIo2ItZqi4o3ayVG6HanQ: posts small blind $0.10
57qrNGHDvf6GhB8zVLsAtQ: posts big blind $0.25
*** HOLE CARDS ***
I+ARcuQBEroNUEjIZ2pprg: calls $0.25
KqS/lY/fNB9qUxokm9QfeA: calls $0.25
yoL2UPRJrmSO7wXIS4Ak4g: folds 
VWwtMkIjXloiX/RKh7RGWQ said, "nh sry"
tYsOBqdU1+x+yFI7zHO7hQ: folds 
VWwtMkIjXloiX/RKh7RGWQ: calls $0.25
KqS/lY/fNB9qUxokm9QfeA said, "its all good"
z5GxcHlYz/GSz6W2uFiTtg: folds 
z5GxcHlYz/GSz6W2uFiTtg is sitting out
HPEB+AtKw1+C/cxU0o1ciw: calls $0.25
CgIo2ItZqi4o3ayVG6HanQ: calls $0.15
57qrNGHDvf6GhB8zVLsAtQ: checks 
*** FLOP *** [2h Jc 4s]
CgIo2ItZqi4o3ayVG6HanQ: checks 
57qrNGHDvf6GhB8zVLsAtQ: checks 
I+ARcuQBEroNUEjIZ2pprg: checks 
KqS/lY/fNB9qUxokm9QfeA: checks 
VWwtMkIjXloiX/RKh7RGWQ: checks 
HPEB+AtKw1+C/cxU0o1ciw: checks 
*** TURN *** [2h Jc 4s] [6h]
CgIo2ItZqi4o3ayVG6HanQ: bets $0.50
57qrNGHDvf6GhB8zVLsAtQ: folds 
I+ARcuQBEroNUEjIZ2pprg: folds 
KqS/lY/fNB9qUxokm9QfeA: calls $0.50
VWwtMkIjXloiX/RKh7RGWQ: folds 
I+ARcuQBEroNUEjIZ2pprg leaves the table
HPEB+AtKw1+C/cxU0o1ciw: folds 
*** RIVER *** [2h Jc 4s 6h] [6d]
CgIo2ItZqi4o3ayVG6HanQ: checks 
KqS/lY/fNB9qUxokm9QfeA: bets $1.25
CgIo2ItZqi4o3ayVG6HanQ: folds 
Uncalled bet ($1.25) returned to KqS/lY/fNB9qUxokm9QfeA
KqS/lY/fNB9qUxokm9QfeA collected $2.40 from pot
KqS/lY/fNB9qUxokm9QfeA: doesn't show hand 
*** SUMMARY ***
Total pot $2.50 | Rake $0.10 
Board [2h Jc 4s 6h 6d]
Seat 1: yoL2UPRJrmSO7wXIS4Ak4g folded before Flop (didn't bet)
Seat 2: tYsOBqdU1+x+yFI7zHO7hQ folded before Flop (didn't bet)
Seat 3: VWwtMkIjXloiX/RKh7RGWQ folded on the Turn
Seat 4: z5GxcHlYz/GSz6W2uFiTtg folded before Flop (didn't bet)
Seat 5: HPEB+AtKw1+C/cxU0o1ciw (button) folded on the Turn
Seat 6: CgIo2ItZqi4o3ayVG6HanQ (small blind) folded on the River
Seat 7: 57qrNGHDvf6GhB8zVLsAtQ (big blind) folded on the Turn
Seat 8: I+ARcuQBEroNUEjIZ2pprg folded on the Turn
Seat 9: KqS/lY/fNB9qUxokm9QfeA collected ($2.40)




PokerStars Game #59941692928:  Hold'em No Limit ($0.10/$0.25) - 2009/07/01 1:43:10 ET
Table 'aT31tt16YvQM/Ue69HPLpA' 9-max Seat #6 is the button
Seat 1: fIgGw0jPUR7labvJPaPbeg ($11.45 in chips) 
Seat 2: PdIasPkzm2sqZnN41ZRXOg ($4.90 in chips) 
Seat 3: tYsOBqdU1+x+yFI7zHO7hQ ($25.15 in chips) 
Seat 4: wGigCmBR/9XWkPpvYos3aQ ($26.35 in chips) 
Seat 5: s2xLPOl/vhl/26apJ3vsOQ ($37.65 in chips) 
Seat 6: 7cv+9Zc9HIQHNvYsMfV3uA ($58.45 in chips) 
Seat 7: W8cIfrCR+zA8pCNyIuHu8g ($32.05 in chips) 
Seat 8: W6tExOcYX7qiy6Qdp+ZwFA ($5 in chips) 
Seat 9: TvIuLx9zUCE+9Li58iImOQ ($16.95 in chips) 
W8cIfrCR+zA8pCNyIuHu8g: posts small blind $0.10
W6tExOcYX7qiy6Qdp+ZwFA: posts big blind $0.25
*** HOLE CARDS ***
TvIuLx9zUCE+9Li58iImOQ: folds 
fIgGw0jPUR7labvJPaPbeg: folds 
PdIasPkzm2sqZnN41ZRXOg: folds 
tYsOBqdU1+x+yFI7zHO7hQ: folds 
wGigCmBR/9XWkPpvYos3aQ: folds 
s2xLPOl/vhl/26apJ3vsOQ: folds 
7cv+9Zc9HIQHNvYsMfV3uA: raises $0.75 to $1
W8cIfrCR+zA8pCNyIuHu8g: calls $0.90
W6tExOcYX7qiy6Qdp+ZwFA: folds 
*** FLOP *** [3s 9h Ac]
W8cIfrCR+zA8pCNyIuHu8g: bets $0.50
7cv+9Zc9HIQHNvYsMfV3uA: folds 
Uncalled bet ($0.50) returned to W8cIfrCR+zA8pCNyIuHu8g
W8cIfrCR+zA8pCNyIuHu8g collected $2.15 from pot
W8cIfrCR+zA8pCNyIuHu8g: doesn't show hand 
*** SUMMARY ***
Total pot $2.25 | Rake $0.10 
Board [3s 9h Ac]
Seat 1: fIgGw0jPUR7labvJPaPbeg folded before Flop (didn't bet)
Seat 2: PdIasPkzm2sqZnN41ZRXOg folded before Flop (didn't bet)
Seat 3: tYsOBqdU1+x+yFI7zHO7hQ folded before Flop (didn't bet)
Seat 4: wGigCmBR/9XWkPpvYos3aQ folded before Flop (didn't bet)
Seat 5: s2xLPOl/vhl/26apJ3vsOQ folded before Flop (didn't bet)
Seat 6: 7cv+9Zc9HIQHNvYsMfV3uA (button) folded on the Flop
Seat 7: W8cIfrCR+zA8pCNyIuHu8g (small blind) collected ($2.15)
Seat 8: W6tExOcYX7qiy6Qdp+ZwFA (big blind) folded before Flop
Seat 9: TvIuLx9zUCE+9Li58iImOQ folded before Flop (didn't bet)




PokerStars Game #59941692468:  Hold'em No Limit ($0.10/$0.25) - 2009/07/01 1:43:10 ET
Table 'dYNvO8G5kw5SRxb1Dljhogz2yOdY2zyGWG1gh9WV9XtQ Seat #8 is the button
Seat 1: vSkQm2EelzwRGDDQQk0Fqw ($4.90 in chips) 
Seat 2: PkBmevN3LdXkPj1LHOoTnQ ($15.10 in chips) 
Seat 3: 1Cs1GyQcoM1omwY7XZ3uRg ($13 in chips) 
Seat 4: sD+TKtt36XiiN6jqHiLwDA ($28.10 in chips) 
Seat 5: W7XGvw6ngGVq2hFwXk8Myg ($25.60 in chips) 
Seat 6: 22dIObOuor/A+IKWkNoAlA ($7.20 in chips) 
Seat 7: DiSvPC2iudwL5j9u6Huyww ($39.75 in chips) 
Seat 8: 6HoFYfVGBefsR5Vrz62qIw5hAPbqNrvJb8PtLiceXtlg0 in chips) 
Seat 9: PdIasPkzm2sqZnN41ZRXOg ($4.75 in chips) 
PdIasPkzm2sqZnN41ZRXOg: posts small blind $0.10
vSkQm2EelzwRGDDQQk0Fqw: posts big blind $0.25
*** HOLE CARDS ***
PkBmevN3LdXkPj1LHOoTnQ: calls $0.25
1Cs1GyQcoM1omwY7XZ3uRg: calls $0.25
sD+TKtt36XiiN6jqHiLwDA: folds 
W7XGvw6ngGVq2hFwXk8Myg: folds 
22dIObOuor/A+IKWkNoAlA: raises $1.25 to $1.50
DiSvPC2iudwL5j9u6Huyww: folds 
6HoFYfVGBefsR5Vrz62qIw5hAPbqNrvJb8PtLiceXtlglds 
PdIasPkzm2sqZnN41ZRXOg: folds 
vSkQm2EelzwRGDDQQk0Fqw: folds 
PkBmevN3LdXkPj1LHOoTnQ: folds 
1Cs1GyQcoM1omwY7XZ3uRg: folds 
Uncalled bet ($1.25) returned to 22dIObOuor/A+IKWkNoAlA
22dIObOuor/A+IKWkNoAlA collected $1.10 from pot
22dIObOuor/A+IKWkNoAlA: doesn't show hand 
*** SUMMARY ***
Total pot $1.10 | Rake $0 
Seat 1: vSkQm2EelzwRGDDQQk0Fqw (big blind) folded before Flop
Seat 2: PkBmevN3LdXkPj1LHOoTnQ folded before Flop
Seat 3: 1Cs1GyQcoM1omwY7XZ3uRg folded before Flop
Seat 4: sD+TKtt36XiiN6jqHiLwDA folded before Flop (didn't bet)
Seat 5: W7XGvw6ngGVq2hFwXk8Myg folded before Flop (didn't bet)
Seat 6: 22dIObOuor/A+IKWkNoAlA collected ($1.10)
Seat 7: DiSvPC2iudwL5j9u6Huyww folded before Flop (didn't bet)
Seat 8: 6HoFYfVGBefsR5Vrz62qIw5hAPbqNrvJb8PtLiceXtlgtton) folded before Flop (didn't bet)
Seat 9: PdIasPkzm2sqZnN41ZRXOg (small blind) folded before Flop




PokerStars Game #59941692944:  Hold'em No Limit ($0.10/$0.25) - 2009/07/01 1:43:10 ET
Table 'Jj2eLzVCUVAGBmM+Og79iQ' 9-max Seat #9 is the button
Seat 2: oMxwMC7+uAsJudeUN6aP0A ($14.65 in chips) 
Seat 3: HPEB+AtKw1+C/cxU0o1ciw ($25 in chips) 
Seat 4: aNpwfA31EREwO+ar4XzBCw ($45.25 in chips) 
Seat 5: UOx+/JnFB2Or6ZU9oasIlQ ($22 in chips) 
Seat 6: jZURAM/dgGCX+5lATlZugw ($14.55 in chips) 
Seat 7: K0b5wNInj6hUGRr6yzKFtw ($59.50 in chips) 
Seat 8: H5Se03ZqSX7tbULXur2MAg ($20.60 in chips) 
Seat 9: wU1LtrccnZo6PYKhlJ6ElQ ($25 in chips) 
oMxwMC7+uAsJudeUN6aP0A: posts small blind $0.10
HPEB+AtKw1+C/cxU0o1ciw: posts big blind $0.25
*** HOLE CARDS ***
aNpwfA31EREwO+ar4XzBCw: folds 
UOx+/JnFB2Or6ZU9oasIlQ: raises $0.50 to $0.75
jZURAM/dgGCX+5lATlZugw: folds 
K0b5wNInj6hUGRr6yzKFtw: folds 
H5Se03ZqSX7tbULXur2MAg: folds 
wU1LtrccnZo6PYKhlJ6ElQ: folds 
oMxwMC7+uAsJudeUN6aP0A: folds 
HPEB+AtKw1+C/cxU0o1ciw: folds 
Uncalled bet ($0.50) returned to UOx+/JnFB2Or6ZU9oasIlQ
UOx+/JnFB2Or6ZU9oasIlQ collected $0.60 from pot
*** SUMMARY ***
Total pot $0.60 | Rake $0 
Seat 2: oMxwMC7+uAsJudeUN6aP0A (small blind) folded before Flop
Seat 3: HPEB+AtKw1+C/cxU0o1ciw (big blind) folded before Flop
Seat 4: aNpwfA31EREwO+ar4XzBCw folded before Flop (didn't bet)
Seat 5: UOx+/JnFB2Or6ZU9oasIlQ collected ($0.60)
Seat 6: jZURAM/dgGCX+5lATlZugw folded before Flop (didn't bet)
Seat 7: K0b5wNInj6hUGRr6yzKFtw folded before Flop (didn't bet)
Seat 8: H5Se03ZqSX7tbULXur2MAg folded before Flop (didn't bet)
Seat 9: wU1LtrccnZo6PYKhlJ6ElQ (button) folded before Flop (didn't bet)




PokerStars Game #59941692838:  Hold'em No Limit ($0.10/$0.25) - 2009/07/01 1:43:10 ET
Table 'm+FQg/QP0VP1ZA3V62WtOg' 9-max Seat #7 is the button
Seat 2: L2sCMFMB88ntwrAVYva+kQ ($15.05 in chips) 
Seat 5: wf5j8xvJtko6ZXyCbzzlVQ ($13.25 in chips) 
Seat 6: CT7Xj/V/O5rBlhtt+RZeFQ ($25.10 in chips) 
Seat 7: TPAF9YkMsjQFq978RNWZEQ ($16.05 in chips) 
Seat 9: zUXhymECc2C9W9ZNw6qppA ($10.30 in chips) 
VegasVas will be allowed to play after the button
zUXhymECc2C9W9ZNw6qppA: posts small blind $0.10
L2sCMFMB88ntwrAVYva+kQ: posts big blind $0.25
+KblIivb6tainScpwm14RQ: sits out 
dubÃ©705: sits out 
*** HOLE CARDS ***
qwr38jl5txoR36M7G5qi4A joins the table at seat #1 
wf5j8xvJtko6ZXyCbzzlVQ: folds 
CT7Xj/V/O5rBlhtt+RZeFQ: folds 
TPAF9YkMsjQFq978RNWZEQ: raises $0.50 to $0.75
zUXhymECc2C9W9ZNw6qppA: folds 
L2sCMFMB88ntwrAVYva+kQ: calls $0.50
*** FLOP *** [4h 9h 6s]
L2sCMFMB88ntwrAVYva+kQ: checks 
TPAF9YkMsjQFq978RNWZEQ: checks 
*** TURN *** [4h 9h 6s] [4c]
L2sCMFMB88ntwrAVYva+kQ: checks 
TPAF9YkMsjQFq978RNWZEQ: checks 
*** RIVER *** [4h 9h 6s 4c] [Jh]
L2sCMFMB88ntwrAVYva+kQ: bets $0.75
TPAF9YkMsjQFq978RNWZEQ: raises $0.75 to $1.50
L2sCMFMB88ntwrAVYva+kQ: calls $0.75
*** SHOW DOWN ***
TPAF9YkMsjQFq978RNWZEQ: shows [Qh Th] (a flush, Queen high)
L2sCMFMB88ntwrAVYva+kQ: mucks hand 
TPAF9YkMsjQFq978RNWZEQ collected $4.40 from pot
*** SUMMARY ***
Total pot $4.60 | Rake $0.20 
Board [4h 9h 6s 4c Jh]
Seat 2: L2sCMFMB88ntwrAVYva+kQ (big blind) mucked
Seat 5: wf5j8xvJtko6ZXyCbzzlVQ folded before Flop (didn't bet)
Seat 6: CT7Xj/V/O5rBlhtt+RZeFQ folded before Flop (didn't bet)
Seat 7: TPAF9YkMsjQFq978RNWZEQ (button) showed [Qh Th] and won ($4.40) with a flush, Queen high
Seat 9: zUXhymECc2C9W9ZNw6qppA (small blind) folded before Flop




PokerStars Game #59941692758:  Hold'em No Limit ($0.10/$0.25) - 2009/07/01 1:43:10 ET
Table 'biAgO3TKQBU8XcrVAoU5TA' 6-max Seat #3 is the button
Seat 1: jhDPlkir8wBYAddboBuF7Q ($17.05 in chips) 
Seat 2: GbCVUNssQ7mqsPWr7J4d3w ($5.30 in chips) 
Seat 3: mfrkWA3PTeYPkbO6hi98Aw ($31.80 in chips) 
Seat 4: Hsvkc0/G2VV78oVmWYXecw ($5 in chips) 
Seat 5: n6UPMnVR4v8LFP0rWP73Fg ($12.20 in chips) 
Seat 6: wMiE3yTbDJGOLOF9th7KPA ($8.35 in chips) 
Hsvkc0/G2VV78oVmWYXecw: posts small blind $0.10
n6UPMnVR4v8LFP0rWP73Fg: posts big blind $0.25
*** HOLE CARDS ***
wMiE3yTbDJGOLOF9th7KPA: calls $0.25
jhDPlkir8wBYAddboBuF7Q: folds 
GbCVUNssQ7mqsPWr7J4d3w: folds 
mfrkWA3PTeYPkbO6hi98Aw: raises $1 to $1.25
Hsvkc0/G2VV78oVmWYXecw: folds 
n6UPMnVR4v8LFP0rWP73Fg: folds 
wMiE3yTbDJGOLOF9th7KPA: folds 
Uncalled bet ($1) returned to mfrkWA3PTeYPkbO6hi98Aw
mfrkWA3PTeYPkbO6hi98Aw collected $0.85 from pot
mfrkWA3PTeYPkbO6hi98Aw: doesn't show hand 
*** SUMMARY ***
Total pot $0.85 | Rake $0 
Seat 1: jhDPlkir8wBYAddboBuF7Q folded before Flop (didn't bet)
Seat 2: GbCVUNssQ7mqsPWr7J4d3w folded before Flop (didn't bet)
Seat 3: mfrkWA3PTeYPkbO6hi98Aw (button) collected ($0.85)
Seat 4: Hsvkc0/G2VV78oVmWYXecw (small blind) folded before Flop
Seat 5: n6UPMnVR4v8LFP0rWP73Fg (big blind) folded before Flop
Seat 6: wMiE3yTbDJGOLOF9th7KPA folded before Flop




PokerStars Game #59941693482:  Hold'em No Limit ($0.10/$0.25) - 2009/07/01 1:43:11 ET
Table 'eOXPe2c6mG7DOFKvMsZZfA' 6-max Seat #4 is the button
Seat 1: s21kVGMLPAoHdWR+muSonw ($25.40 in chips) 
Seat 2: gaPMxLGp9SOj4Lq6t+/0Ig ($7.10 in chips) 
Seat 3: kReyZ6g6Fu3tQ0nyjDf9kA ($25.85 in chips) 
Seat 4: zHHLkD2sRljslKKeQv/ZQw ($36.35 in chips) 
Seat 5: NhUN/JpAprdJeamFBgJH1w ($32.40 in chips) 
Seat 6: Qpv/hb5ak7LeaDig1L5L8w ($13.60 in chips) 
NhUN/JpAprdJeamFBgJH1w: posts small blind $0.10
Qpv/hb5ak7LeaDig1L5L8w: posts big blind $0.25
*** HOLE CARDS ***
s21kVGMLPAoHdWR+muSonw: folds 
gaPMxLGp9SOj4Lq6t+/0Ig: folds 
kReyZ6g6Fu3tQ0nyjDf9kA: calls $0.25
zHHLkD2sRljslKKeQv/ZQw: calls $0.25
NhUN/JpAprdJeamFBgJH1w: folds 
Qpv/hb5ak7LeaDig1L5L8w: checks 
*** FLOP *** [8s 7s Ad]
Qpv/hb5ak7LeaDig1L5L8w: checks 
kReyZ6g6Fu3tQ0nyjDf9kA: checks 
zHHLkD2sRljslKKeQv/ZQw: checks 
*** TURN *** [8s 7s Ad] [Qc]
Qpv/hb5ak7LeaDig1L5L8w: checks 
kReyZ6g6Fu3tQ0nyjDf9kA: bets $0.75
zHHLkD2sRljslKKeQv/ZQw: calls $0.75
Qpv/hb5ak7LeaDig1L5L8w: folds 
*** RIVER *** [8s 7s Ad Qc] [Kh]
kReyZ6g6Fu3tQ0nyjDf9kA: bets $1.25
zHHLkD2sRljslKKeQv/ZQw: folds 
Uncalled bet ($1.25) returned to kReyZ6g6Fu3tQ0nyjDf9kA
kReyZ6g6Fu3tQ0nyjDf9kA collected $2.25 from pot
kReyZ6g6Fu3tQ0nyjDf9kA: doesn't show hand 
*** SUMMARY ***
Total pot $2.35 | Rake $0.10 
Board [8s 7s Ad Qc Kh]
Seat 1: s21kVGMLPAoHdWR+muSonw folded before Flop (didn't bet)
Seat 2: gaPMxLGp9SOj4Lq6t+/0Ig folded before Flop (didn't bet)
Seat 3: kReyZ6g6Fu3tQ0nyjDf9kA collected ($2.25)
Seat 4: zHHLkD2sRljslKKeQv/ZQw (button) folded on the River
Seat 5: NhUN/JpAprdJeamFBgJH1w (small blind) folded before Flop
Seat 6: Qpv/hb5ak7LeaDig1L5L8w (big blind) folded on the Turn




PokerStars Game #59941693408:  Hold'em No Limit ($0.10/$0.25) - 2009/07/01 1:43:11 ET
Table '4UJB/UOZ5aepyF2v+hIoUg' 6-max Seat #1 is the button
Seat 1: 08V++DOqzaNrRNsHIwi25w ($26.60 in chips) 
Seat 2: mFv3iBCtrw9XfCDRB0d46Q ($4.65 in chips) 
Seat 3: zlYHXTtJ5tcx9kwK2h5n9A ($38.65 in chips) 
Seat 4: R6AGToFJQOYVZAjC2jXEKw ($23.15 in chips) 
Seat 5: 3zD3qLXT1bEffAoWGnc7wg ($25.90 in chips) 
Seat 6: 2aphcinkTZT0B0Uoah6cvQ ($17.60 in chips) 
mFv3iBCtrw9XfCDRB0d46Q: posts small blind $0.10
zlYHXTtJ5tcx9kwK2h5n9A: posts big blind $0.25
*** HOLE CARDS ***
R6AGToFJQOYVZAjC2jXEKw: raises $0.50 to $0.75
3zD3qLXT1bEffAoWGnc7wg: folds 
2aphcinkTZT0B0Uoah6cvQ: calls $0.75
08V++DOqzaNrRNsHIwi25w: folds 
mFv3iBCtrw9XfCDRB0d46Q: folds 
zlYHXTtJ5tcx9kwK2h5n9A: folds 
*** FLOP *** [9h 6s Ad]
R6AGToFJQOYVZAjC2jXEKw: checks 
2aphcinkTZT0B0Uoah6cvQ: checks 
*** TURN *** [9h 6s Ad] [2d]
R6AGToFJQOYVZAjC2jXEKw: checks 
2aphcinkTZT0B0Uoah6cvQ: checks 
*** RIVER *** [9h 6s Ad 2d] [Qh]
R6AGToFJQOYVZAjC2jXEKw: bets $1
2aphcinkTZT0B0Uoah6cvQ: folds 
Uncalled bet ($1) returned to R6AGToFJQOYVZAjC2jXEKw
R6AGToFJQOYVZAjC2jXEKw collected $1.80 from pot
R6AGToFJQOYVZAjC2jXEKw: doesn't show hand 
*** SUMMARY ***
Total pot $1.85 | Rake $0.05 
Board [9h 6s Ad 2d Qh]
Seat 1: 08V++DOqzaNrRNsHIwi25w (button) folded before Flop (didn't bet)
Seat 2: mFv3iBCtrw9XfCDRB0d46Q (small blind) folded before Flop
Seat 3: zlYHXTtJ5tcx9kwK2h5n9A (big blind) folded before Flop
Seat 4: R6AGToFJQOYVZAjC2jXEKw collected ($1.80)
Seat 5: 3zD3qLXT1bEffAoWGnc7wg folded before Flop (didn't bet)
Seat 6: 2aphcinkTZT0B0Uoah6cvQ folded on the River




PokerStars Game #59941693328:  Hold'em No Limit ($0.10/$0.25) - 2009/07/01 1:43:11 ET
Table 'vud0GB/ZlDCvUFhBFIaTlg' 9-max Seat #3 is the button
Seat 1: DiSvPC2iudwL5j9u6Huyww ($28.50 in chips) 
Seat 2: tLcDklc2rBORNfixyRfVfw ($25.60 in chips) 
Seat 3: W2YYHvqjaEpRrO7stZkClQ ($4.30 in chips) 
Seat 5: eK8qa6EPcH2zhtbmWSvc9g ($25 in chips) 
Seat 6: gehe91e0IyVT0QU/XBkEyg ($24.90 in chips) 
Seat 7: iG7VeTyBWf6wYNvZpbTcbw ($17.10 in chips) 
Seat 8: Am29qRe4OYkVWs70NjNDBw ($15.85 in chips) 
Seat 9: PdIasPkzm2sqZnN41ZRXOg ($5.70 in chips) 
dWgEDExmVO0d+rRmUYCU5w will be allowed to play after the button
eK8qa6EPcH2zhtbmWSvc9g: posts small blind $0.10
gehe91e0IyVT0QU/XBkEyg: posts big blind $0.25
*** HOLE CARDS ***
iG7VeTyBWf6wYNvZpbTcbw: folds 
Am29qRe4OYkVWs70NjNDBw: raises $0.75 to $1
PdIasPkzm2sqZnN41ZRXOg: folds 
DiSvPC2iudwL5j9u6Huyww: folds 
tLcDklc2rBORNfixyRfVfw: folds 
W2YYHvqjaEpRrO7stZkClQ: folds 
eK8qa6EPcH2zhtbmWSvc9g: folds 
gehe91e0IyVT0QU/XBkEyg: folds 
Uncalled bet ($0.75) returned to Am29qRe4OYkVWs70NjNDBw
Am29qRe4OYkVWs70NjNDBw collected $0.60 from pot
Am29qRe4OYkVWs70NjNDBw: doesn't show hand 
*** SUMMARY ***
Total pot $0.60 | Rake $0 
Seat 1: DiSvPC2iudwL5j9u6Huyww folded before Flop (didn't bet)
Seat 2: tLcDklc2rBORNfixyRfVfw folded before Flop (didn't bet)
Seat 3: W2YYHvqjaEpRrO7stZkClQ (button) folded before Flop (didn't bet)
Seat 5: eK8qa6EPcH2zhtbmWSvc9g (small blind) folded before Flop
Seat 6: gehe91e0IyVT0QU/XBkEyg (big blind) folded before Flop
Seat 7: iG7VeTyBWf6wYNvZpbTcbw folded before Flop (didn't bet)
Seat 8: Am29qRe4OYkVWs70NjNDBw collected ($0.60)
Seat 9: PdIasPkzm2sqZnN41ZRXOg folded before Flop (didn't bet)




PokerStars Game #59941693054:  Hold'em No Limit ($0.10/$0.25) - 2009/07/01 1:43:11 ET
Table 'dVzscin98UhGisTmV9BDcw' 9-max Seat #9 is the button
Seat 1: sBAwXpkpgyhyWbHIQcIJKA ($17.65 in chips) 
Seat 2: dfNim92Z6XK1/h5SFW5vDg ($28.25 in chips) 
Seat 4: aNpwfA31EREwO+ar4XzBCw ($42.25 in chips) 
Seat 5: 22dIObOuor/A+IKWkNoAlA ($10.10 in chips) 
Seat 6: bXpVeaSTPBFSPJmeXxO7nw ($8.30 in chips) 
Seat 7: cKlmpQMahVsmOaxFQDcoOg ($24.65 in chips) 
Seat 8: /vn2Qu2dvc9AMMq46Ae0jA ($44.40 in chips) 
Seat 9: arxNSjreDRGFg13EAM2F1w ($25 in chips) 
sBAwXpkpgyhyWbHIQcIJKA: posts small blind $0.10
dfNim92Z6XK1/h5SFW5vDg: posts big blind $0.25
cZ99hugmLBj9KhTlc8nCSw: sits out 
*** HOLE CARDS ***
aNpwfA31EREwO+ar4XzBCw: folds 
22dIObOuor/A+IKWkNoAlA: folds 
bXpVeaSTPBFSPJmeXxO7nw: folds 
cKlmpQMahVsmOaxFQDcoOg: folds 
/vn2Qu2dvc9AMMq46Ae0jA: folds 
arxNSjreDRGFg13EAM2F1w: folds 
sBAwXpkpgyhyWbHIQcIJKA: folds 
Uncalled bet ($0.15) returned to dfNim92Z6XK1/h5SFW5vDg
dfNim92Z6XK1/h5SFW5vDg collected $0.20 from pot
dfNim92Z6XK1/h5SFW5vDg: doesn't show hand 
*** SUMMARY ***
Total pot $0.20 | Rake $0 
Seat 1: sBAwXpkpgyhyWbHIQcIJKA (small blind) folded before Flop
Seat 2: dfNim92Z6XK1/h5SFW5vDg (big blind) collected ($0.20)
Seat 4: aNpwfA31EREwO+ar4XzBCw folded before Flop (didn't bet)
Seat 5: 22dIObOuor/A+IKWkNoAlA folded before Flop (didn't bet)
Seat 6: bXpVeaSTPBFSPJmeXxO7nw folded before Flop (didn't bet)
Seat 7: cKlmpQMahVsmOaxFQDcoOg folded before Flop (didn't bet)
Seat 8: /vn2Qu2dvc9AMMq46Ae0jA folded before Flop (didn't bet)
Seat 9: arxNSjreDRGFg13EAM2F1w (button) folded before Flop (didn't bet)




PokerStars Game #59941693042:  Hold'em No Limit ($0.10/$0.25) - 2009/07/01 1:43:11 ET
Table 'GxdLtCpYxqT4aAbYqkEEpw' 6-max Seat #1 is the button
Seat 1: 2d/PU00mMdO9azAaXqcSbw ($10.35 in chips) 
Seat 3: LpmZGzLpOmfZUF7EV4ZlrQ ($16.35 in chips) 
Seat 4: 6wzJiRvp8HY6t+MQGnSIzA ($10.55 in chips) 
Seat 5: q6WfTUAD9mowIP63ASq2Dg ($36.85 in chips) 
Seat 6: DFi/Lzkjsfv8QswS80JX9Q ($25 in chips) 
LpmZGzLpOmfZUF7EV4ZlrQ: posts small blind $0.10
6wzJiRvp8HY6t+MQGnSIzA: posts big blind $0.25
*** HOLE CARDS ***
dvm1UvZWx2FWbqFj2ihadg joins the table at seat #2 
q6WfTUAD9mowIP63ASq2Dg: folds 
DFi/Lzkjsfv8QswS80JX9Q: folds 
2d/PU00mMdO9azAaXqcSbw: folds 
LpmZGzLpOmfZUF7EV4ZlrQ: folds 
Uncalled bet ($0.15) returned to 6wzJiRvp8HY6t+MQGnSIzA
6wzJiRvp8HY6t+MQGnSIzA collected $0.20 from pot
6wzJiRvp8HY6t+MQGnSIzA: doesn't show hand 
*** SUMMARY ***
Total pot $0.20 | Rake $0 
Seat 1: 2d/PU00mMdO9azAaXqcSbw (button) folded before Flop (didn't bet)
Seat 3: LpmZGzLpOmfZUF7EV4ZlrQ (small blind) folded before Flop
Seat 4: 6wzJiRvp8HY6t+MQGnSIzA (big blind) collected ($0.20)
Seat 5: q6WfTUAD9mowIP63ASq2Dg folded before Flop (didn't bet)
Seat 6: DFi/Lzkjsfv8QswS80JX9Q folded before Flop (didn't bet)




PokerStars Game #59941694018:  Hold'em No Limit ($0.10/$0.25) - 2009/07/01 1:43:12 ET
Table 'VQNfcI8vTBCTvRfd3veTLQ' 6-max Seat #4 is the button
Seat 2: 79ID/ub1Pt/mDpCprVmOoA ($31.90 in chips) 
Seat 3: LtASJ9OlkqGrrUKGQlpGAw ($11.75 in chips) 
Seat 4: QIWnfLSqfMcoFfdDe5LZPg ($40.55 in chips) 
Seat 5: gX2vbKwS/8zZPENAWB7hxQ ($21.35 in chips) 
Seat 6: LJI7A1YgDM7hgh7o56+ReQ ($27.35 in chips) 
gX2vbKwS/8zZPENAWB7hxQ: posts small blind $0.10
LJI7A1YgDM7hgh7o56+ReQ: posts big blind $0.25
QiL+lEgEWwy21jk/ltaRLg: sits out 
*** HOLE CARDS ***
79ID/ub1Pt/mDpCprVmOoA: folds 
LtASJ9OlkqGrrUKGQlpGAw: folds 
QIWnfLSqfMcoFfdDe5LZPg: folds 
gX2vbKwS/8zZPENAWB7hxQ: folds 
Uncalled bet ($0.15) returned to LJI7A1YgDM7hgh7o56+ReQ
LJI7A1YgDM7hgh7o56+ReQ collected $0.20 from pot
LJI7A1YgDM7hgh7o56+ReQ: doesn't show hand 
*** SUMMARY ***
Total pot $0.20 | Rake $0 
Seat 2: 79ID/ub1Pt/mDpCprVmOoA folded before Flop (didn't bet)
Seat 3: LtASJ9OlkqGrrUKGQlpGAw folded before Flop (didn't bet)
Seat 4: QIWnfLSqfMcoFfdDe5LZPg (button) folded before Flop (didn't bet)
Seat 5: gX2vbKwS/8zZPENAWB7hxQ (small blind) folded before Flop
Seat 6: LJI7A1YgDM7hgh7o56+ReQ (big blind) collected ($0.20)




PokerStars Game #59941693676:  Hold'em No Limit ($0.10/$0.25) - 2009/07/01 1:43:12 ET
Table 'fIMYcWwN4/aXFJvH5Z8Ymg' 6-max Seat #6 is the button
Seat 1: DihMHaz4WNETH1bPDe13kA ($25.10 in chips) 
Seat 3: 9bpVv1/Qh9IYtXuCtl5VtQ ($25 in chips) 
Seat 4: 32YL2ZEp8NT4JB2RVM9euQ ($42.75 in chips) 
Seat 5: lquriepNQBhDV5P1SWHhnA ($25.35 in chips) 
Seat 6: jp34e617tIzV8tKIWmfAbA ($28 in chips) 
DihMHaz4WNETH1bPDe13kA: posts small blind $0.10
vu2kzHaDtgr6NM7rdq0chA: is sitting out 
vu2kzHaDtgr6NM7rdq0chA leaves the table
9bpVv1/Qh9IYtXuCtl5VtQ: posts big blind $0.25
*** HOLE CARDS ***
32YL2ZEp8NT4JB2RVM9euQ: folds 
lquriepNQBhDV5P1SWHhnA: folds 
jp34e617tIzV8tKIWmfAbA: folds 
StevenWu joins the table at seat #2 
DihMHaz4WNETH1bPDe13kA: folds 
Uncalled bet ($0.15) returned to 9bpVv1/Qh9IYtXuCtl5VtQ
9bpVv1/Qh9IYtXuCtl5VtQ collected $0.20 from pot
9bpVv1/Qh9IYtXuCtl5VtQ: doesn't show hand 
*** SUMMARY ***
Total pot $0.20 | Rake $0 
Seat 1: DihMHaz4WNETH1bPDe13kA (small blind) folded before Flop
Seat 3: 9bpVv1/Qh9IYtXuCtl5VtQ (big blind) collected ($0.20)
Seat 4: 32YL2ZEp8NT4JB2RVM9euQ folded before Flop (didn't bet)
Seat 5: lquriepNQBhDV5P1SWHhnA folded before Flop (didn't bet)
Seat 6: jp34e617tIzV8tKIWmfAbA (button) folded before Flop (didn't bet)




PokerStars Game #59941693936:  Hold'em No Limit ($0.10/$0.25) - 2009/07/01 1:43:12 ET
Table '9L7XfAwuM7XsXE8LIg2o5Q' 6-max Seat #2 is the button
Seat 1: dOIoLBxmpLHSXBN9LZnf0Q ($25.20 in chips) 
Seat 2: LJI7A1YgDM7hgh7o56+ReQ ($25.50 in chips) 
Seat 3: mFv3iBCtrw9XfCDRB0d46Q ($4.75 in chips) 
Seat 4: jp34e617tIzV8tKIWmfAbA ($39.95 in chips) 
Seat 5: OUv909q/YxsJgxpSlZxLJQ ($33.85 in chips) 
Seat 6: k9nHZTHt8hYhYRcW8NTb4g ($38.05 in chips) 
mFv3iBCtrw9XfCDRB0d46Q: posts small blind $0.10
jp34e617tIzV8tKIWmfAbA: posts big blind $0.25
*** HOLE CARDS ***
OUv909q/YxsJgxpSlZxLJQ: folds 
OUv909q/YxsJgxpSlZxLJQ leaves the table
k9nHZTHt8hYhYRcW8NTb4g: folds 
dOIoLBxmpLHSXBN9LZnf0Q: folds 
LJI7A1YgDM7hgh7o56+ReQ: raises $0.50 to $0.75
mFv3iBCtrw9XfCDRB0d46Q: folds 
jp34e617tIzV8tKIWmfAbA: folds 
Uncalled bet ($0.50) returned to LJI7A1YgDM7hgh7o56+ReQ
LJI7A1YgDM7hgh7o56+ReQ collected $0.60 from pot
LJI7A1YgDM7hgh7o56+ReQ: doesn't show hand 
*** SUMMARY ***
Total pot $0.60 | Rake $0 
Seat 1: dOIoLBxmpLHSXBN9LZnf0Q folded before Flop (didn't bet)
Seat 2: LJI7A1YgDM7hgh7o56+ReQ (button) collected ($0.60)
Seat 3: mFv3iBCtrw9XfCDRB0d46Q (small blind) folded before Flop
Seat 4: jp34e617tIzV8tKIWmfAbA (big blind) folded before Flop
Seat 5: OUv909q/YxsJgxpSlZxLJQ folded before Flop (didn't bet)
Seat 6: k9nHZTHt8hYhYRcW8NTb4g folded before Flop (didn't bet)




PokerStars Game #59941693996:  Hold'em No Limit ($0.10/$0.25) - 2009/07/01 1:43:12 ET
Table 'vFZR6Kf2Th5xBXT9brGW6A' 6-max Seat #2 is the button
Seat 1: Q3EMN7b0ie81AFWkDrhCjw ($22.20 in chips) 
Seat 2: QiL+lEgEWwy21jk/ltaRLg ($22.40 in chips) 
Seat 3: SH1WjKVUjPiyXySjWSdazw ($23.85 in chips) 
Seat 4: 79ID/ub1Pt/mDpCprVmOoA ($35.55 in chips) 
Seat 5: SS/yfeArhULzIcOPe8MdPg ($26.65 in chips) 
Seat 6: 4x9jCqgSw4272dnaIqnanw ($2.50 in chips) 
SH1WjKVUjPiyXySjWSdazw: posts small blind $0.10
79ID/ub1Pt/mDpCprVmOoA: posts big blind $0.25
*** HOLE CARDS ***
SS/yfeArhULzIcOPe8MdPg: folds 
4x9jCqgSw4272dnaIqnanw: raises $2.25 to $2.50 and is all-in
Q3EMN7b0ie81AFWkDrhCjw: folds 
QiL+lEgEWwy21jk/ltaRLg: folds 
SH1WjKVUjPiyXySjWSdazw: calls $2.40
79ID/ub1Pt/mDpCprVmOoA: folds 
*** FLOP *** [Ad Kd 3d]
*** TURN *** [Ad Kd 3d] [8d]
*** RIVER *** [Ad Kd 3d 8d] [Th]
*** SHOW DOWN ***
SH1WjKVUjPiyXySjWSdazw: shows [Js Ac] (a pair of Aces)
4x9jCqgSw4272dnaIqnanw: shows [Qc Jd] (a flush, Ace high)
4x9jCqgSw4272dnaIqnanw collected $5 from pot
*** SUMMARY ***
Total pot $5.25 | Rake $0.25 
Board [Ad Kd 3d 8d Th]
Seat 1: Q3EMN7b0ie81AFWkDrhCjw folded before Flop (didn't bet)
Seat 2: QiL+lEgEWwy21jk/ltaRLg (button) folded before Flop (didn't bet)
Seat 3: SH1WjKVUjPiyXySjWSdazw (small blind) showed [Js Ac] and lost with a pair of Aces
Seat 4: 79ID/ub1Pt/mDpCprVmOoA (big blind) folded before Flop
Seat 5: SS/yfeArhULzIcOPe8MdPg folded before Flop (didn't bet)
Seat 6: 4x9jCqgSw4272dnaIqnanw showed [Qc Jd] and won ($5) with a flush, Ace high




PokerStars Game #59941693598:  Hold'em No Limit ($0.10/$0.25) - 2009/07/01 1:43:12 ET
Table 'WY+lMaAoIdBZmwk27/RJCA' 6-max Seat #3 is the button
Seat 1: zHHLkD2sRljslKKeQv/ZQw ($26.10 in chips) 
Seat 2: NhUN/JpAprdJeamFBgJH1w ($26.90 in chips) 
Seat 3: 79Q62AM0VB++TQYiBlOYsA ($80.80 in chips) 
Seat 4: 0av6tRNdi0Ui4f15L7gsVg ($21.90 in chips) 
Seat 5: vqWjZmdQu/Hxw96/IJTWdQ ($29.45 in chips) 
Seat 6: cWc85bEzdRzpUMhRKm8pwQ ($25.85 in chips) 
0av6tRNdi0Ui4f15L7gsVg: posts small blind $0.10
vqWjZmdQu/Hxw96/IJTWdQ: posts big blind $0.25
*** HOLE CARDS ***
cWc85bEzdRzpUMhRKm8pwQ: folds 
zHHLkD2sRljslKKeQv/ZQw: folds 
NhUN/JpAprdJeamFBgJH1w: folds 
79Q62AM0VB++TQYiBlOYsA: folds 
0av6tRNdi0Ui4f15L7gsVg: raises $0.50 to $0.75
vqWjZmdQu/Hxw96/IJTWdQ: raises $1.25 to $2
0av6tRNdi0Ui4f15L7gsVg: folds 
Uncalled bet ($1.25) returned to vqWjZmdQu/Hxw96/IJTWdQ
vqWjZmdQu/Hxw96/IJTWdQ collected $1.50 from pot
vqWjZmdQu/Hxw96/IJTWdQ: doesn't show hand 
*** SUMMARY ***
Total pot $1.50 | Rake $0 
Seat 1: zHHLkD2sRljslKKeQv/ZQw folded before Flop (didn't bet)
Seat 2: NhUN/JpAprdJeamFBgJH1w folded before Flop (didn't bet)
Seat 3: 79Q62AM0VB++TQYiBlOYsA (button) folded before Flop (didn't bet)
Seat 4: 0av6tRNdi0Ui4f15L7gsVg (small blind) folded before Flop
Seat 5: vqWjZmdQu/Hxw96/IJTWdQ (big blind) collected ($1.50)
Seat 6: cWc85bEzdRzpUMhRKm8pwQ folded before Flop (didn't bet)




PokerStars Game #59941694198:  Hold'em No Limit ($0.10/$0.25) - 2009/07/01 1:43:13 ET
Table 'g+mPuNJBCHKE9ents7ZGtg' 6-max Seat #5 is the button
Seat 1: cezpHJ8FB07dj0xG+LhOvw ($58.65 in chips) 
Seat 2: fZQg9veL7Dd/Z04ZTjC+wQ ($66.05 in chips) 
Seat 3: FYepjhAvF8ZdVCmqHIy+eQ ($28.55 in chips) 
Seat 4: yVrjRIW0SMxgpvqSIPSe/w ($14.70 in chips) 
Seat 5: D3ikCR8c/o9jB5irZ3uGlw ($12.30 in chips) 
Seat 6: Mn2V28t5aGq2d09z+/o6Fw ($24.75 in chips) 
Mn2V28t5aGq2d09z+/o6Fw: posts small blind $0.10
cezpHJ8FB07dj0xG+LhOvw: posts big blind $0.25
*** HOLE CARDS ***
fZQg9veL7Dd/Z04ZTjC+wQ: folds 
FYepjhAvF8ZdVCmqHIy+eQ: raises $0.75 to $1
yVrjRIW0SMxgpvqSIPSe/w: calls $1
D3ikCR8c/o9jB5irZ3uGlw: folds 
Mn2V28t5aGq2d09z+/o6Fw: folds 
cezpHJ8FB07dj0xG+LhOvw: folds 
*** FLOP *** [7h Jc 4h]
FYepjhAvF8ZdVCmqHIy+eQ: checks 
yVrjRIW0SMxgpvqSIPSe/w: bets $0.50
FYepjhAvF8ZdVCmqHIy+eQ: calls $0.50
*** TURN *** [7h Jc 4h] [Qd]
FYepjhAvF8ZdVCmqHIy+eQ: bets $1.65
yVrjRIW0SMxgpvqSIPSe/w: folds 
Uncalled bet ($1.65) returned to FYepjhAvF8ZdVCmqHIy+eQ
FYepjhAvF8ZdVCmqHIy+eQ collected $3.20 from pot
FYepjhAvF8ZdVCmqHIy+eQ: doesn't show hand 
*** SUMMARY ***
Total pot $3.35 | Rake $0.15 
Board [7h Jc 4h Qd]
Seat 1: cezpHJ8FB07dj0xG+LhOvw (big blind) folded before Flop
Seat 2: fZQg9veL7Dd/Z04ZTjC+wQ folded before Flop (didn't bet)
Seat 3: FYepjhAvF8ZdVCmqHIy+eQ collected ($3.20)
Seat 4: yVrjRIW0SMxgpvqSIPSe/w folded on the Turn
Seat 5: D3ikCR8c/o9jB5irZ3uGlw (button) folded before Flop (didn't bet)
Seat 6: Mn2V28t5aGq2d09z+/o6Fw (small blind) folded before Flop




PokerStars Game #59941694400:  Hold'em No Limit ($0.10/$0.25) - 2009/07/01 1:43:13 ET
Table 'SHi8+hK6i7E2dJ/3Agbyig' 6-max Seat #6 is the button
Seat 1: gPEN9Zp33YTm/mu9/SYP1w ($23.95 in chips) 
Seat 2: LJI7A1YgDM7hgh7o56+ReQ ($28.80 in chips) 
Seat 3: P1Z7LWu+VU+WmJsI4mr0wA ($24.25 in chips) 
Seat 4: u0ikXOhAPSCLmg+l17oGRw ($10.40 in chips) 
Seat 5: v8m8XHovI5tqEA9mvplDSw ($53.45 in chips) 
Seat 6: cWc85bEzdRzpUMhRKm8pwQ ($32.30 in chips) 
gPEN9Zp33YTm/mu9/SYP1w: posts small blind $0.10
LJI7A1YgDM7hgh7o56+ReQ: posts big blind $0.25
*** HOLE CARDS ***
P1Z7LWu+VU+WmJsI4mr0wA: calls $0.25
u0ikXOhAPSCLmg+l17oGRw: calls $0.25
v8m8XHovI5tqEA9mvplDSw: folds 
cWc85bEzdRzpUMhRKm8pwQ: folds 
gPEN9Zp33YTm/mu9/SYP1w: calls $0.15
LJI7A1YgDM7hgh7o56+ReQ: checks 
*** FLOP *** [6d 7c Ad]
gPEN9Zp33YTm/mu9/SYP1w: checks 
LJI7A1YgDM7hgh7o56+ReQ: checks 
P1Z7LWu+VU+WmJsI4mr0wA: checks 
u0ikXOhAPSCLmg+l17oGRw: checks 
*** TURN *** [6d 7c Ad] [Qs]
gPEN9Zp33YTm/mu9/SYP1w: bets $0.75
LJI7A1YgDM7hgh7o56+ReQ: folds 
P1Z7LWu+VU+WmJsI4mr0wA: folds 
u0ikXOhAPSCLmg+l17oGRw: folds 
Uncalled bet ($0.75) returned to gPEN9Zp33YTm/mu9/SYP1w
gPEN9Zp33YTm/mu9/SYP1w collected $0.95 from pot
*** SUMMARY ***
Total pot $1 | Rake $0.05 
Board [6d 7c Ad Qs]
Seat 1: gPEN9Zp33YTm/mu9/SYP1w (small blind) collected ($0.95)
Seat 2: LJI7A1YgDM7hgh7o56+ReQ (big blind) folded on the Turn
Seat 3: P1Z7LWu+VU+WmJsI4mr0wA folded on the Turn
Seat 4: u0ikXOhAPSCLmg+l17oGRw folded on the Turn
Seat 5: v8m8XHovI5tqEA9mvplDSw folded before Flop (didn't bet)
Seat 6: cWc85bEzdRzpUMhRKm8pwQ (button) folded before Flop (didn't bet)




PokerStars Game #59941694570:  Hold'em No Limit ($0.10/$0.25) - 2009/07/01 1:43:13 ET
Table '4hfTdIVT/qPsJNfWXLsVIw' 9-max Seat #2 is the button
Seat 1: GbHFBbLqLGz0Pwn6CJeAuw ($30.35 in chips) 
Seat 2: Pt637jKksB5MzP0UNJAAkw ($37.95 in chips) 
Seat 3: xnVwSkROfRtOw4eSoDANtw ($8.30 in chips) 
Seat 5: dtZ84flFEi4Q+SGrHMJRDQ ($25.45 in chips) 
Seat 6: VWUWpMLMj/Q1jRVpF7Aohw ($12.90 in chips) 
Seat 8: 7cv+9Zc9HIQHNvYsMfV3uA ($29 in chips) 
Seat 9: 9njEKzpOKC62MllUFUBWrA ($10.05 in chips) 
xnVwSkROfRtOw4eSoDANtw: posts small blind $0.10
3PmVnC/15cl4oyI1TKIt4g: is sitting out 
dtZ84flFEi4Q+SGrHMJRDQ: posts big blind $0.25
*** HOLE CARDS ***
VWUWpMLMj/Q1jRVpF7Aohw: folds 
3PmVnC/15cl4oyI1TKIt4g has returned
7cv+9Zc9HIQHNvYsMfV3uA: folds 
9njEKzpOKC62MllUFUBWrA: calls $0.25
GbHFBbLqLGz0Pwn6CJeAuw: calls $0.25
Pt637jKksB5MzP0UNJAAkw: folds 
xnVwSkROfRtOw4eSoDANtw: folds 
dtZ84flFEi4Q+SGrHMJRDQ: checks 
*** FLOP *** [4s 4c Qc]
dtZ84flFEi4Q+SGrHMJRDQ: checks 
9njEKzpOKC62MllUFUBWrA: bets $1.25
GbHFBbLqLGz0Pwn6CJeAuw: calls $1.25
dtZ84flFEi4Q+SGrHMJRDQ: folds 
*** TURN *** [4s 4c Qc] [Th]
9njEKzpOKC62MllUFUBWrA: checks 
GbHFBbLqLGz0Pwn6CJeAuw: bets $1
9njEKzpOKC62MllUFUBWrA: calls $1
*** RIVER *** [4s 4c Qc Th] [Ts]
9njEKzpOKC62MllUFUBWrA: bets $1.25
GbHFBbLqLGz0Pwn6CJeAuw: raises $1.25 to $2.50
9njEKzpOKC62MllUFUBWrA: calls $1.25
*** SHOW DOWN ***
GbHFBbLqLGz0Pwn6CJeAuw: shows [Tc Qs] (a full house, Tens full of Queens)
9njEKzpOKC62MllUFUBWrA: mucks hand 
GbHFBbLqLGz0Pwn6CJeAuw collected $9.85 from pot
*** SUMMARY ***
Total pot $10.35 | Rake $0.50 
Board [4s 4c Qc Th Ts]
Seat 1: GbHFBbLqLGz0Pwn6CJeAuw showed [Tc Qs] and won ($9.85) with a full house, Tens full of Queens
Seat 2: Pt637jKksB5MzP0UNJAAkw (button) folded before Flop (didn't bet)
Seat 3: xnVwSkROfRtOw4eSoDANtw (small blind) folded before Flop
Seat 5: dtZ84flFEi4Q+SGrHMJRDQ (big blind) folded on the Flop
Seat 6: VWUWpMLMj/Q1jRVpF7Aohw folded before Flop (didn't bet)
Seat 8: 7cv+9Zc9HIQHNvYsMfV3uA folded before Flop (didn't bet)
Seat 9: 9njEKzpOKC62MllUFUBWrA mucked




PokerStars Game #59941694096:  Hold'em No Limit ($0.10/$0.25) - 2009/07/01 1:43:13 ET
Table '3760QYRYyCWeXf0rLZ5S2g' 9-max Seat #3 is the button
Seat 1: CT7Xj/V/O5rBlhtt+RZeFQ ($27.90 in chips) 
Seat 3: X78b5v/uhqeXXoAijbw/yg ($25.25 in chips) 
Seat 4: ziFpkH3wCzqB/qXeq/Hy7g ($25 in chips) 
Seat 5: Bb42QRQMhg5/Y0vHP8/2Xw ($29.05 in chips) 
Seat 6: q+Qdg0Hoir+SyL7haBrUnw ($13.40 in chips) 
Seat 7: 6C2DoQ+GZHBOpb+qyrSnqA ($5.75 in chips) 
Seat 8: pB8IyCfDFZaVpov3NHEVJg ($24.30 in chips) 
Seat 9: sGFnnRCa1YAHAUmWgsW6Qg ($5.95 in chips) 
ziFpkH3wCzqB/qXeq/Hy7g: posts small blind $0.10
Bb42QRQMhg5/Y0vHP8/2Xw: posts big blind $0.25
*** HOLE CARDS ***
q+Qdg0Hoir+SyL7haBrUnw: folds 
6C2DoQ+GZHBOpb+qyrSnqA: folds 
pB8IyCfDFZaVpov3NHEVJg: folds 
sGFnnRCa1YAHAUmWgsW6Qg: folds 
CT7Xj/V/O5rBlhtt+RZeFQ: folds 
X78b5v/uhqeXXoAijbw/yg: raises $0.75 to $1
ziFpkH3wCzqB/qXeq/Hy7g: folds 
Bb42QRQMhg5/Y0vHP8/2Xw: folds 
Uncalled bet ($0.75) returned to X78b5v/uhqeXXoAijbw/yg
X78b5v/uhqeXXoAijbw/yg collected $0.60 from pot
*** SUMMARY ***
Total pot $0.60 | Rake $0 
Seat 1: CT7Xj/V/O5rBlhtt+RZeFQ folded before Flop (didn't bet)
Seat 3: X78b5v/uhqeXXoAijbw/yg (button) collected ($0.60)
Seat 4: ziFpkH3wCzqB/qXeq/Hy7g (small blind) folded before Flop
Seat 5: Bb42QRQMhg5/Y0vHP8/2Xw (big blind) folded before Flop
Seat 6: q+Qdg0Hoir+SyL7haBrUnw folded before Flop (didn't bet)
Seat 7: 6C2DoQ+GZHBOpb+qyrSnqA folded before Flop (didn't bet)
Seat 8: pB8IyCfDFZaVpov3NHEVJg folded before Flop (didn't bet)
Seat 9: sGFnnRCa1YAHAUmWgsW6Qg folded before Flop (didn't bet)




PokerStars Game #59941694640:  Hold'em No Limit ($0.10/$0.25) - 2009/07/01 1:43:13 ET
Table 'hfHe8uKeSJMyWAjSdM7ROQMRfAiS/4JSfnUDlCcZo0wAx Seat #6 is the button
Seat 1: 48oT5xFI+5CHUJlfoGrE4w ($30.25 in chips) 
Seat 2: /gJNBeCkWL4o85/jvlZ4BA ($29.35 in chips) 
Seat 3: FYepjhAvF8ZdVCmqHIy+eQ ($39.05 in chips) 
Seat 4: b4wRQV3APH8irVk6bUFe2Q ($30.35 in chips) 
Seat 6: L3/N/gliETan8N5Gim5h4Q ($25.25 in chips) 
48oT5xFI+5CHUJlfoGrE4w: posts small blind $0.10
/gJNBeCkWL4o85/jvlZ4BA: posts big blind $0.25
*** HOLE CARDS ***
FYepjhAvF8ZdVCmqHIy+eQ: folds 
b4wRQV3APH8irVk6bUFe2Q: folds 
L3/N/gliETan8N5Gim5h4Q: folds 
48oT5xFI+5CHUJlfoGrE4w: folds 
Uncalled bet ($0.15) returned to /gJNBeCkWL4o85/jvlZ4BA
/gJNBeCkWL4o85/jvlZ4BA collected $0.20 from pot
*** SUMMARY ***
Total pot $0.20 | Rake $0 
Seat 1: 48oT5xFI+5CHUJlfoGrE4w (small blind) folded before Flop
Seat 2: /gJNBeCkWL4o85/jvlZ4BA (big blind) collected ($0.20)
Seat 3: FYepjhAvF8ZdVCmqHIy+eQ folded before Flop (didn't bet)
Seat 4: b4wRQV3APH8irVk6bUFe2Q folded before Flop (didn't bet)
Seat 6: L3/N/gliETan8N5Gim5h4Q (button) folded before Flop (didn't bet)




PokerStars Game #59941694382:  Hold'em No Limit ($0.10/$0.25) - 2009/07/01 1:43:13 ET
Table 'YlRA05h9BJ1EhOUSNUjJdg' 9-max Seat #3 is the button
Seat 1: dtZ84flFEi4Q+SGrHMJRDQ ($25 in chips) 
Seat 2: Y2GFAe+PT7xnUUtgqCNDFw ($12.05 in chips) 
Seat 3: Z5ZtGOON8kmSdSCll9Z3XA ($13.20 in chips) 
Seat 4: HPEB+AtKw1+C/cxU0o1ciw ($31.10 in chips) 
Seat 5: sx0lGrkT9fd4yFR+3cXUQg ($11.05 in chips) 
Seat 6: QEbIGci+itdw+re8RM5fZA ($44.35 in chips) 
Seat 7: dfNim92Z6XK1/h5SFW5vDg ($25 in chips) 
Seat 8: dmYlc+1cjwZMJ7wV+Z0rRg ($32.90 in chips) 
Seat 9: Z9AeOQX3yzuSvKAm/xyovg ($9.75 in chips) 
HPEB+AtKw1+C/cxU0o1ciw: posts small blind $0.10
sx0lGrkT9fd4yFR+3cXUQg: posts big blind $0.25
*** HOLE CARDS ***
QEbIGci+itdw+re8RM5fZA: folds 
dfNim92Z6XK1/h5SFW5vDg: folds 
dmYlc+1cjwZMJ7wV+Z0rRg: folds 
Z9AeOQX3yzuSvKAm/xyovg: folds 
dtZ84flFEi4Q+SGrHMJRDQ: folds 
Y2GFAe+PT7xnUUtgqCNDFw: folds 
Z5ZtGOON8kmSdSCll9Z3XA: folds 
HPEB+AtKw1+C/cxU0o1ciw: folds 
Uncalled bet ($0.15) returned to sx0lGrkT9fd4yFR+3cXUQg
sx0lGrkT9fd4yFR+3cXUQg collected $0.20 from pot
sx0lGrkT9fd4yFR+3cXUQg: doesn't show hand 
*** SUMMARY ***
Total pot $0.20 | Rake $0 
Seat 1: dtZ84flFEi4Q+SGrHMJRDQ folded before Flop (didn't bet)
Seat 2: Y2GFAe+PT7xnUUtgqCNDFw folded before Flop (didn't bet)
Seat 3: Z5ZtGOON8kmSdSCll9Z3XA (button) folded before Flop (didn't bet)
Seat 4: HPEB+AtKw1+C/cxU0o1ciw (small blind) folded before Flop
Seat 5: sx0lGrkT9fd4yFR+3cXUQg (big blind) collected ($0.20)
Seat 6: QEbIGci+itdw+re8RM5fZA folded before Flop (didn't bet)
Seat 7: dfNim92Z6XK1/h5SFW5vDg folded before Flop (didn't bet)
Seat 8: dmYlc+1cjwZMJ7wV+Z0rRg folded before Flop (didn't bet)
Seat 9: Z9AeOQX3yzuSvKAm/xyovg folded before Flop (didn't bet)




PokerStars Game #59941694760:  Hold'em No Limit ($0.10/$0.25) - 2009/07/01 1:43:14 ET
Table 'oxYpQNT8OHNCvpMIFi7UoA' 9-max Seat #9 is the button
Seat 1: EVqHvqty1ZsuvDFiSXlSqQ ($33.30 in chips) 
Seat 2: 8+iP8mvFyeAviW/yUH1CJg ($30.20 in chips) 
Seat 3: ubsjZomMWSV0hAiBLa7K1A ($19.65 in chips) 
Seat 4: eK8qa6EPcH2zhtbmWSvc9g ($25 in chips) 
Seat 5: ZoqLw33zTU6EsjOkfv/cGw ($19.90 in chips) 
Seat 6: VBHxUExRAMrbxUq/cVx9Gw ($5.40 in chips) 
Seat 7: X78b5v/uhqeXXoAijbw/yg ($25 in chips) 
Seat 9: pN3IHvAKm2fz+sTRARTcrg ($24.65 in chips) 
EVqHvqty1ZsuvDFiSXlSqQ: posts small blind $0.10
8+iP8mvFyeAviW/yUH1CJg: posts big blind $0.25
*** HOLE CARDS ***
ubsjZomMWSV0hAiBLa7K1A: folds 
eK8qa6EPcH2zhtbmWSvc9g: folds 
ZoqLw33zTU6EsjOkfv/cGw: folds 
VBHxUExRAMrbxUq/cVx9Gw: folds 
X78b5v/uhqeXXoAijbw/yg: raises $0.75 to $1
pN3IHvAKm2fz+sTRARTcrg: calls $1
EVqHvqty1ZsuvDFiSXlSqQ: folds 
8+iP8mvFyeAviW/yUH1CJg: folds 
*** FLOP *** [As 5d 5s]
X78b5v/uhqeXXoAijbw/yg: bets $1.50
pN3IHvAKm2fz+sTRARTcrg: calls $1.50
*** TURN *** [As 5d 5s] [6d]
X78b5v/uhqeXXoAijbw/yg: checks 
pN3IHvAKm2fz+sTRARTcrg: bets $1.75
X78b5v/uhqeXXoAijbw/yg: calls $1.75
*** RIVER *** [As 5d 5s 6d] [8c]
X78b5v/uhqeXXoAijbw/yg: checks 
pN3IHvAKm2fz+sTRARTcrg: bets $1.75
X78b5v/uhqeXXoAijbw/yg: raises $6.50 to $8.25
pN3IHvAKm2fz+sTRARTcrg: calls $6.50
*** SHOW DOWN ***
X78b5v/uhqeXXoAijbw/yg: shows [6h 6c] (a full house, Sixes full of Fives)
pN3IHvAKm2fz+sTRARTcrg: mucks hand 
X78b5v/uhqeXXoAijbw/yg collected $24.15 from pot
*** SUMMARY ***
Total pot $25.35 | Rake $1.20 
Board [As 5d 5s 6d 8c]
Seat 1: EVqHvqty1ZsuvDFiSXlSqQ (small blind) folded before Flop
Seat 2: 8+iP8mvFyeAviW/yUH1CJg (big blind) folded before Flop
Seat 3: ubsjZomMWSV0hAiBLa7K1A folded before Flop (didn't bet)
Seat 4: eK8qa6EPcH2zhtbmWSvc9g folded before Flop (didn't bet)
Seat 5: ZoqLw33zTU6EsjOkfv/cGw folded before Flop (didn't bet)
Seat 6: VBHxUExRAMrbxUq/cVx9Gw folded before Flop (didn't bet)
Seat 7: X78b5v/uhqeXXoAijbw/yg showed [6h 6c] and won ($24.15) with a full house, Sixes full of Fives
Seat 9: pN3IHvAKm2fz+sTRARTcrg (button) mucked




PokerStars Game #59941695134:  Hold'em No Limit ($0.10/$0.25) - 2009/07/01 1:43:14 ET
Table '2O5CgfSkSwrr4PDrlZ1RLQ' 6-max Seat #5 is the button
Seat 1: 3skmHD9EOATKdUzzyHh1KA ($30.55 in chips) 
Seat 2: wqphQtauX5Qn7WRJZS1flA ($25 in chips) 
Seat 3: oBUDUfeUyCbZBsjxHZgSiw ($29.10 in chips) 
Seat 5: 0av6tRNdi0Ui4f15L7gsVg ($21.55 in chips) 
Seat 6: tj9xqoqQaDaFw7u1oyZrtA ($48.25 in chips) 
tj9xqoqQaDaFw7u1oyZrtA: posts small blind $0.10
3skmHD9EOATKdUzzyHh1KA: posts big blind $0.25
epAUIB7h2FJXzUPRIvSkRA: sits out 
*** HOLE CARDS ***
wqphQtauX5Qn7WRJZS1flA: folds 
oBUDUfeUyCbZBsjxHZgSiw: folds 
0av6tRNdi0Ui4f15L7gsVg: raises $0.50 to $0.75
tj9xqoqQaDaFw7u1oyZrtA: folds 
3skmHD9EOATKdUzzyHh1KA: folds 
Uncalled bet ($0.50) returned to 0av6tRNdi0Ui4f15L7gsVg
0av6tRNdi0Ui4f15L7gsVg collected $0.60 from pot
0av6tRNdi0Ui4f15L7gsVg: doesn't show hand 
*** SUMMARY ***
Total pot $0.60 | Rake $0 
Seat 1: 3skmHD9EOATKdUzzyHh1KA (big blind) folded before Flop
Seat 2: wqphQtauX5Qn7WRJZS1flA folded before Flop (didn't bet)
Seat 3: oBUDUfeUyCbZBsjxHZgSiw folded before Flop (didn't bet)
Seat 5: 0av6tRNdi0Ui4f15L7gsVg (button) collected ($0.60)
Seat 6: tj9xqoqQaDaFw7u1oyZrtA (small blind) folded before Flop




PokerStars Game #59941694984:  Hold'em No Limit ($0.10/$0.25) - 2009/07/01 1:43:14 ET
Table 'i93c3z9RLowvuJTKA2F4Jg' 6-max Seat #3 is the button
Seat 1: tbSZq5LHglyHk61mH9eDBw ($29.25 in chips) 
Seat 2: TSmua8tGK3sTbwi0ynrW9Q ($27.20 in chips) 
Seat 3: v8m8XHovI5tqEA9mvplDSw ($31.30 in chips) 
Seat 4: o86X2Q5GEDU3uP9oj1iFZA ($32.05 in chips) 
Seat 6: FpN4KbLjlyRRKiVaQcoLqA ($19 in chips) 
o86X2Q5GEDU3uP9oj1iFZA: posts small blind $0.10
lYjWCpfCxX2kgcHY3v4Yow: is sitting out 
lYjWCpfCxX2kgcHY3v4Yow leaves the table
FpN4KbLjlyRRKiVaQcoLqA: posts big blind $0.25
*** HOLE CARDS ***
TI/C5Q+DEl4fLR3AofwYdg joins the table at seat #5 
tbSZq5LHglyHk61mH9eDBw: folds 
TSmua8tGK3sTbwi0ynrW9Q: raises $0.50 to $0.75
v8m8XHovI5tqEA9mvplDSw: folds 
o86X2Q5GEDU3uP9oj1iFZA: calls $0.65
FpN4KbLjlyRRKiVaQcoLqA: folds 
*** FLOP *** [5c 5s 2s]
o86X2Q5GEDU3uP9oj1iFZA: checks 
TSmua8tGK3sTbwi0ynrW9Q: checks 
*** TURN *** [5c 5s 2s] [9d]
o86X2Q5GEDU3uP9oj1iFZA: bets $1
TSmua8tGK3sTbwi0ynrW9Q: raises $1.50 to $2.50
o86X2Q5GEDU3uP9oj1iFZA: folds 
Uncalled bet ($1.50) returned to TSmua8tGK3sTbwi0ynrW9Q
TSmua8tGK3sTbwi0ynrW9Q collected $3.60 from pot
*** SUMMARY ***
Total pot $3.75 | Rake $0.15 
Board [5c 5s 2s 9d]
Seat 1: tbSZq5LHglyHk61mH9eDBw folded before Flop (didn't bet)
Seat 2: TSmua8tGK3sTbwi0ynrW9Q collected ($3.60)
Seat 3: v8m8XHovI5tqEA9mvplDSw (button) folded before Flop (didn't bet)
Seat 4: o86X2Q5GEDU3uP9oj1iFZA (small blind) folded on the Turn
Seat 6: FpN4KbLjlyRRKiVaQcoLqA (big blind) folded before Flop




PokerStars Game #59941694738:  Hold'em No Limit ($0.10/$0.25) - 2009/07/01 1:43:14 ET
Table '0M5QEJGOThqZwQ/sjbjXYw' 6-max Seat #3 is the button
Seat 2: /gJNBeCkWL4o85/jvlZ4BA ($34.60 in chips) 
Seat 3: 3zD3qLXT1bEffAoWGnc7wg ($25 in chips) 
Seat 4: oBUDUfeUyCbZBsjxHZgSiw ($23.10 in chips) 
Seat 5: cWc85bEzdRzpUMhRKm8pwQ ($28.05 in chips) 
Seat 6: mYz11CHiw5KsDCRD5T7/jg ($49.60 in chips) 
oBUDUfeUyCbZBsjxHZgSiw: posts small blind $0.10
cWc85bEzdRzpUMhRKm8pwQ: posts big blind $0.25
*** HOLE CARDS ***
mYz11CHiw5KsDCRD5T7/jg: folds 
/gJNBeCkWL4o85/jvlZ4BA: folds 
3zD3qLXT1bEffAoWGnc7wg: folds 
mYz11CHiw5KsDCRD5T7/jg is sitting out
oBUDUfeUyCbZBsjxHZgSiw: raises $0.75 to $1
cWc85bEzdRzpUMhRKm8pwQ: folds 
Uncalled bet ($0.75) returned to oBUDUfeUyCbZBsjxHZgSiw
oBUDUfeUyCbZBsjxHZgSiw collected $0.50 from pot
mYz11CHiw5KsDCRD5T7/jg leaves the table
*** SUMMARY ***
Total pot $0.50 | Rake $0 
Seat 2: /gJNBeCkWL4o85/jvlZ4BA folded before Flop (didn't bet)
Seat 3: 3zD3qLXT1bEffAoWGnc7wg (button) folded before Flop (didn't bet)
Seat 4: oBUDUfeUyCbZBsjxHZgSiw (small blind) collected ($0.50)
Seat 5: cWc85bEzdRzpUMhRKm8pwQ (big blind) folded before Flop
Seat 6: mYz11CHiw5KsDCRD5T7/jg folded before Flop (didn't bet)




PokerStars Game #59941694944:  Hold'em No Limit ($0.10/$0.25) - 2009/07/01 1:43:14 ET
Table 'Qr+t8WGovMECkBv+cV1lrg' 6-max Seat #5 is the button
Seat 1: EeUZtMU058v2ObUACOF4Og ($51 in chips) 
Seat 2: vqWjZmdQu/Hxw96/IJTWdQ ($25 in chips) 
Seat 3: uZKkrGByYgd4/ZBX2d4z+w ($21.25 in chips) 
Seat 4: 1NNFfYMd5Hsphl/FYz9fNA ($61.60 in chips) 
Seat 5: 9q7YGTKe9k5fYb4fmZc3Ww ($32.35 in chips) 
9U3ZKjCsarN0DjR6mSE8Ug will be allowed to play after the button
EeUZtMU058v2ObUACOF4Og: posts small blind $0.10
vqWjZmdQu/Hxw96/IJTWdQ: posts big blind $0.25
*** HOLE CARDS ***
uZKkrGByYgd4/ZBX2d4z+w: calls $0.25
1NNFfYMd5Hsphl/FYz9fNA: folds 
9q7YGTKe9k5fYb4fmZc3Ww: folds 
EeUZtMU058v2ObUACOF4Og: calls $0.15
vqWjZmdQu/Hxw96/IJTWdQ: checks 
*** FLOP *** [5s 3c Qs]
EeUZtMU058v2ObUACOF4Og: checks 
vqWjZmdQu/Hxw96/IJTWdQ: checks 
uZKkrGByYgd4/ZBX2d4z+w: bets $1
EeUZtMU058v2ObUACOF4Og: calls $1
vqWjZmdQu/Hxw96/IJTWdQ: folds 
*** TURN *** [5s 3c Qs] [7d]
EeUZtMU058v2ObUACOF4Og: checks 
uZKkrGByYgd4/ZBX2d4z+w: bets $1
EeUZtMU058v2ObUACOF4Og: raises $1 to $2
uZKkrGByYgd4/ZBX2d4z+w: calls $1
*** RIVER *** [5s 3c Qs 7d] [9c]
EeUZtMU058v2ObUACOF4Og: bets $3
uZKkrGByYgd4/ZBX2d4z+w: calls $3
*** SHOW DOWN ***
EeUZtMU058v2ObUACOF4Og: shows [3s As] (a pair of Threes)
uZKkrGByYgd4/ZBX2d4z+w: shows [Jc Qd] (a pair of Queens)
uZKkrGByYgd4/ZBX2d4z+w collected $12.15 from pot
*** SUMMARY ***
Total pot $12.75 | Rake $0.60 
Board [5s 3c Qs 7d 9c]
Seat 1: EeUZtMU058v2ObUACOF4Og (small blind) showed [3s As] and lost with a pair of Threes
Seat 2: vqWjZmdQu/Hxw96/IJTWdQ (big blind) folded on the Flop
Seat 3: uZKkrGByYgd4/ZBX2d4z+w showed [Jc Qd] and won ($12.15) with a pair of Queens
Seat 4: 1NNFfYMd5Hsphl/FYz9fNA folded before Flop (didn't bet)
Seat 5: 9q7YGTKe9k5fYb4fmZc3Ww (button) folded before Flop (didn't bet)




PokerStars Game #59941695006:  Hold'em No Limit ($0.10/$0.25) - 2009/07/01 1:43:14 ET
Table '60nA7av6bws9VnNmVwculA' 6-max Seat #1 is the button
Seat 1: if4dh6jhJXeN3/qd3qCp9g ($24.65 in chips) 
Seat 2: Bada343Si4xKu3fNXY99AA ($3.60 in chips) 
Seat 4: +baiVgI/ETnBARLe5mARCw ($18.85 in chips) 
Seat 5: zXh+lOT41Q2iWgCNj+OcRw ($12.95 in chips) 
Seat 6: mfrkWA3PTeYPkbO6hi98Aw ($24.50 in chips) 
Bada343Si4xKu3fNXY99AA: posts small blind $0.10
+baiVgI/ETnBARLe5mARCw: posts big blind $0.25
*** HOLE CARDS ***
zXh+lOT41Q2iWgCNj+OcRw: calls $0.25
mnuJq+Q1IXKm/pCy+OzxmQ joins the table at seat #3 
mfrkWA3PTeYPkbO6hi98Aw: raises $1 to $1.25
if4dh6jhJXeN3/qd3qCp9g: folds 
Bada343Si4xKu3fNXY99AA: folds 
+baiVgI/ETnBARLe5mARCw: folds 
zXh+lOT41Q2iWgCNj+OcRw: folds 
Uncalled bet ($1) returned to mfrkWA3PTeYPkbO6hi98Aw
mfrkWA3PTeYPkbO6hi98Aw collected $0.85 from pot
mfrkWA3PTeYPkbO6hi98Aw: doesn't show hand 
*** SUMMARY ***
Total pot $0.85 | Rake $0 
Seat 1: if4dh6jhJXeN3/qd3qCp9g (button) folded before Flop (didn't bet)
Seat 2: Bada343Si4xKu3fNXY99AA (small blind) folded before Flop
Seat 4: +baiVgI/ETnBARLe5mARCw (big blind) folded before Flop
Seat 5: zXh+lOT41Q2iWgCNj+OcRw folded before Flop
Seat 6: mfrkWA3PTeYPkbO6hi98Aw collected ($0.85)




PokerStars Game #59941695152:  Hold'em No Limit ($0.10/$0.25) - 2009/07/01 1:43:14 ET
Table 'VuY5ej47Cy8nOI3Wogmhzw' 6-max Seat #5 is the button
Seat 1: EeUZtMU058v2ObUACOF4Og ($37.95 in chips) 
Seat 2: AM6Yl+3esmhhMBlSnQhWbg ($19 in chips) 
Seat 3: v+QfkGiuj9bgtuNoVnDO8w ($29.65 in chips) 
Seat 5: iK/41//HmnLiIn0CVNNfyA ($11.55 in chips) 
EeUZtMU058v2ObUACOF4Og: posts small blind $0.10
AM6Yl+3esmhhMBlSnQhWbg: posts big blind $0.25
QqiZLFrN8iOUT/GHw7ztOA: sits out 
*** HOLE CARDS ***
v+QfkGiuj9bgtuNoVnDO8w: folds 
iK/41//HmnLiIn0CVNNfyA: folds 
EeUZtMU058v2ObUACOF4Og: folds 
Uncalled bet ($0.15) returned to AM6Yl+3esmhhMBlSnQhWbg
AM6Yl+3esmhhMBlSnQhWbg collected $0.20 from pot
AM6Yl+3esmhhMBlSnQhWbg: doesn't show hand 
*** SUMMARY ***
Total pot $0.20 | Rake $0 
Seat 1: EeUZtMU058v2ObUACOF4Og (small blind) folded before Flop
Seat 2: AM6Yl+3esmhhMBlSnQhWbg (big blind) collected ($0.20)
Seat 3: v+QfkGiuj9bgtuNoVnDO8w folded before Flop (didn't bet)
Seat 5: iK/41//HmnLiIn0CVNNfyA (button) folded before Flop (didn't bet)




PokerStars Game #59941694978:  Hold'em No Limit ($0.10/$0.25) - 2009/07/01 1:43:14 ET
Table 'Jz+kWRxWNGk9w24fdQEveA' 9-max Seat #5 is the button
Seat 2: ljemhp25Zg+nlA9DLCIiUw ($38.85 in chips) 
Seat 4: HPEB+AtKw1+C/cxU0o1ciw ($28.65 in chips) 
Seat 5: d6eSA7wOH5mRaSyVDVRBLw ($11.75 in chips) 
Seat 6: c/6hFCyfLNRn3VFvCeQ1ng ($2.95 in chips) 
Seat 7: wGigCmBR/9XWkPpvYos3aQ ($27 in chips) 
Seat 8: j4q3p0lesp63b1gZDwLBZw ($5 in chips) 
Seat 9: V6p0jQ/RhUsqpHLmXvEX4Q ($17.35 in chips) 
c/6hFCyfLNRn3VFvCeQ1ng: posts small blind $0.10
wGigCmBR/9XWkPpvYos3aQ: posts big blind $0.25
Z9W7+g1WMhhZDi7DwGbCFA: sits out 
WPT_Champ111: sits out 
*** HOLE CARDS ***
j4q3p0lesp63b1gZDwLBZw: folds 
V6p0jQ/RhUsqpHLmXvEX4Q: raises $0.75 to $1
ljemhp25Zg+nlA9DLCIiUw: folds 
HPEB+AtKw1+C/cxU0o1ciw: folds 
d6eSA7wOH5mRaSyVDVRBLw: folds 
c/6hFCyfLNRn3VFvCeQ1ng: folds 
wGigCmBR/9XWkPpvYos3aQ: folds 
Uncalled bet ($0.75) returned to V6p0jQ/RhUsqpHLmXvEX4Q
c/6hFCyfLNRn3VFvCeQ1ng leaves the table
V6p0jQ/RhUsqpHLmXvEX4Q collected $0.60 from pot
*** SUMMARY ***
Total pot $0.60 | Rake $0 
Seat 2: ljemhp25Zg+nlA9DLCIiUw folded before Flop (didn't bet)
Seat 4: HPEB+AtKw1+C/cxU0o1ciw folded before Flop (didn't bet)
Seat 5: d6eSA7wOH5mRaSyVDVRBLw (button) folded before Flop (didn't bet)
Seat 6: c/6hFCyfLNRn3VFvCeQ1ng (small blind) folded before Flop
Seat 7: wGigCmBR/9XWkPpvYos3aQ (big blind) folded before Flop
Seat 8: j4q3p0lesp63b1gZDwLBZw folded before Flop (didn't bet)
Seat 9: V6p0jQ/RhUsqpHLmXvEX4Q collected ($0.60)




PokerStars Game #59941694990:  Hold'em No Limit ($0.10/$0.25) - 2009/07/01 1:43:14 ET
Table 'Xi38lWH8L2JHRAsKYVX8Qg' 6-max Seat #5 is the button
Seat 1: shP7DFAtX7gXcgMJX/OmRQ ($20.95 in chips) 
Seat 2: VOmI0x4dDPnTESZd5B4d1Q ($9.60 in chips) 
Seat 3: 6DwBRH+xZ12AAZmeAg+aXw ($30.25 in chips) 
Seat 4: kG34n23qFQA3nzdOJTQ1dA ($27.10 in chips) 
Seat 5: 79ID/ub1Pt/mDpCprVmOoA ($77.95 in chips) 
Seat 6: kyRaCIljYA6l33lSKQfNsg ($29.50 in chips) 
kyRaCIljYA6l33lSKQfNsg: posts small blind $0.10
shP7DFAtX7gXcgMJX/OmRQ: posts big blind $0.25
*** HOLE CARDS ***
VOmI0x4dDPnTESZd5B4d1Q: folds 
6DwBRH+xZ12AAZmeAg+aXw: raises $0.50 to $0.75
kG34n23qFQA3nzdOJTQ1dA: folds 
79ID/ub1Pt/mDpCprVmOoA: folds 
kyRaCIljYA6l33lSKQfNsg: folds 
shP7DFAtX7gXcgMJX/OmRQ: folds 
Uncalled bet ($0.50) returned to 6DwBRH+xZ12AAZmeAg+aXw
6DwBRH+xZ12AAZmeAg+aXw collected $0.60 from pot
6DwBRH+xZ12AAZmeAg+aXw: doesn't show hand 
*** SUMMARY ***
Total pot $0.60 | Rake $0 
Seat 1: shP7DFAtX7gXcgMJX/OmRQ (big blind) folded before Flop
Seat 2: VOmI0x4dDPnTESZd5B4d1Q folded before Flop (didn't bet)
Seat 3: 6DwBRH+xZ12AAZmeAg+aXw collected ($0.60)
Seat 4: kG34n23qFQA3nzdOJTQ1dA folded before Flop (didn't bet)
Seat 5: 79ID/ub1Pt/mDpCprVmOoA (button) folded before Flop (didn't bet)
Seat 6: kyRaCIljYA6l33lSKQfNsg (small blind) folded before Flop




PokerStars Game #59941695220:  Hold'em No Limit ($0.10/$0.25) - 2009/07/01 1:43:15 ET
Table 'dZNBGqFYSwfOVZvDJ4VjIQ' 6-max Seat #4 is the button
Seat 1: v+QfkGiuj9bgtuNoVnDO8w ($33.20 in chips) 
Seat 2: 3zD3qLXT1bEffAoWGnc7wg ($25.35 in chips) 
Seat 3: kyRaCIljYA6l33lSKQfNsg ($28.30 in chips) 
Seat 4: mFv3iBCtrw9XfCDRB0d46Q ($6.15 in chips) 
Seat 5: +ZlnqPoP3Hg4BIUxDfKd/A ($36.25 in chips) 
Seat 6: ypmjhffk/YHGc51wgVXUTw ($30.75 in chips) 
+ZlnqPoP3Hg4BIUxDfKd/A: posts small blind $0.10
ypmjhffk/YHGc51wgVXUTw: posts big blind $0.25
*** HOLE CARDS ***
v+QfkGiuj9bgtuNoVnDO8w: folds 
3zD3qLXT1bEffAoWGnc7wg: folds 
kyRaCIljYA6l33lSKQfNsg: folds 
mFv3iBCtrw9XfCDRB0d46Q: folds 
+ZlnqPoP3Hg4BIUxDfKd/A: raises $0.75 to $1
ypmjhffk/YHGc51wgVXUTw: folds 
Uncalled bet ($0.75) returned to +ZlnqPoP3Hg4BIUxDfKd/A
+ZlnqPoP3Hg4BIUxDfKd/A collected $0.50 from pot
+ZlnqPoP3Hg4BIUxDfKd/A: doesn't show hand 
*** SUMMARY ***
Total pot $0.50 | Rake $0 
Seat 1: v+QfkGiuj9bgtuNoVnDO8w folded before Flop (didn't bet)
Seat 2: 3zD3qLXT1bEffAoWGnc7wg folded before Flop (didn't bet)
Seat 3: kyRaCIljYA6l33lSKQfNsg folded before Flop (didn't bet)
Seat 4: mFv3iBCtrw9XfCDRB0d46Q (button) folded before Flop (didn't bet)
Seat 5: +ZlnqPoP3Hg4BIUxDfKd/A (small blind) collected ($0.50)
Seat 6: ypmjhffk/YHGc51wgVXUTw (big blind) folded before Flop




PokerStars Game #59941695728:  Hold'em No Limit ($0.10/$0.25) - 2009/07/01 1:43:15 ET
Table '0mmHveGuaIfIMQlNE1eqMg' 9-max Seat #5 is the button
Seat 1: ydoFOVgzvZv9ZhuWu9rXAw ($5 in chips) 
Seat 2: rQhYIYXSyH/IivYM1dlV5A ($68.85 in chips) 
Seat 3: ghNKXUBl/H+t83JF079ZBA ($25 in chips) 
Seat 4: DnDcAdn9P0zGovMERigpFA ($36.10 in chips) 
Seat 5: Pt637jKksB5MzP0UNJAAkw ($8.85 in chips) 
Seat 6: 6RiVTYll/5D8zICp0MRpKw ($23.95 in chips) 
Seat 7: 5n7e7I+px7c6CQmLpPbtsg ($5 in chips) 
Seat 9: UNw/UrAelsQeSS17Rro/BA ($11.15 in chips) 
6RiVTYll/5D8zICp0MRpKw: posts small blind $0.10
5n7e7I+px7c6CQmLpPbtsg: posts big blind $0.25
0XACOSNrAWmqNv9k1nF8rw: sits out 
*** HOLE CARDS ***
UNw/UrAelsQeSS17Rro/BA: calls $0.25
ydoFOVgzvZv9ZhuWu9rXAw: folds 
rQhYIYXSyH/IivYM1dlV5A: folds 
ghNKXUBl/H+t83JF079ZBA: folds 
DnDcAdn9P0zGovMERigpFA: folds 
Pt637jKksB5MzP0UNJAAkw: folds 
6RiVTYll/5D8zICp0MRpKw: calls $0.15
5n7e7I+px7c6CQmLpPbtsg: checks 
*** FLOP *** [Jh 5c 6d]
6RiVTYll/5D8zICp0MRpKw: checks 
5n7e7I+px7c6CQmLpPbtsg: bets $0.50
UNw/UrAelsQeSS17Rro/BA: folds 
6RiVTYll/5D8zICp0MRpKw: folds 
Uncalled bet ($0.50) returned to 5n7e7I+px7c6CQmLpPbtsg
5n7e7I+px7c6CQmLpPbtsg collected $0.75 from pot
5n7e7I+px7c6CQmLpPbtsg: doesn't show hand 
*** SUMMARY ***
Total pot $0.75 | Rake $0 
Board [Jh 5c 6d]
Seat 1: ydoFOVgzvZv9ZhuWu9rXAw folded before Flop (didn't bet)
Seat 2: rQhYIYXSyH/IivYM1dlV5A folded before Flop (didn't bet)
Seat 3: ghNKXUBl/H+t83JF079ZBA folded before Flop (didn't bet)
Seat 4: DnDcAdn9P0zGovMERigpFA folded before Flop (didn't bet)
Seat 5: Pt637jKksB5MzP0UNJAAkw (button) folded before Flop (didn't bet)
Seat 6: 6RiVTYll/5D8zICp0MRpKw (small blind) folded on the Flop
Seat 7: 5n7e7I+px7c6CQmLpPbtsg (big blind) collected ($0.75)
Seat 9: UNw/UrAelsQeSS17Rro/BA folded on the Flop




PokerStars Game #59941695408:  Hold'em No Limit ($0.10/$0.25) - 2009/07/01 1:43:15 ET
Table 'yZgGBnUGXVCcEJdcqes8tw' 9-max Seat #5 is the button
Seat 1: 6RiVTYll/5D8zICp0MRpKw ($29.20 in chips) 
Seat 2: MG90wfSJZnOejs/KD3vlQQ ($25 in chips) 
Seat 3: z5GxcHlYz/GSz6W2uFiTtg ($23.30 in chips) 
Seat 4: M2QO2DxB5Wawg2h8HSpnYA ($10 in chips) 
Seat 5: dfNim92Z6XK1/h5SFW5vDg ($25.05 in chips) 
Seat 6: pRZytPRoJmxE0dmcJwYvfw ($5.70 in chips) 
Seat 7: eC8Pn1D6Y2pct8o62nQfvQ ($25.50 in chips) 
Seat 8: dtZ84flFEi4Q+SGrHMJRDQ ($31.65 in chips) 
pRZytPRoJmxE0dmcJwYvfw: posts small blind $0.10
eC8Pn1D6Y2pct8o62nQfvQ: posts big blind $0.25
*** HOLE CARDS ***
dtZ84flFEi4Q+SGrHMJRDQ: folds 
6RiVTYll/5D8zICp0MRpKw: calls $0.25
MG90wfSJZnOejs/KD3vlQQ: folds 
z5GxcHlYz/GSz6W2uFiTtg: calls $0.25
M2QO2DxB5Wawg2h8HSpnYA: folds 
dfNim92Z6XK1/h5SFW5vDg: folds 
pRZytPRoJmxE0dmcJwYvfw: folds 
M/9j4wkHH9i1JM51vgi1VA has returned
eC8Pn1D6Y2pct8o62nQfvQ: checks 
*** FLOP *** [6s Ac 6d]
pRZytPRoJmxE0dmcJwYvfw leaves the table
eC8Pn1D6Y2pct8o62nQfvQ: checks 
6RiVTYll/5D8zICp0MRpKw: checks 
z5GxcHlYz/GSz6W2uFiTtg: bets $0.50
eC8Pn1D6Y2pct8o62nQfvQ: calls $0.50
RHqgdFvufLCYe54+qd2gcA joins the table at seat #6 
6RiVTYll/5D8zICp0MRpKw: folds 
*** TURN *** [6s Ac 6d] [Ks]
eC8Pn1D6Y2pct8o62nQfvQ: checks 
z5GxcHlYz/GSz6W2uFiTtg: checks 
*** RIVER *** [6s Ac 6d Ks] [2h]
eC8Pn1D6Y2pct8o62nQfvQ: checks 
z5GxcHlYz/GSz6W2uFiTtg: checks 
*** SHOW DOWN ***
eC8Pn1D6Y2pct8o62nQfvQ: shows [Ad 5s] (two pair, Aces and Sixes)
z5GxcHlYz/GSz6W2uFiTtg: mucks hand 
z5GxcHlYz/GSz6W2uFiTtg is sitting out
eC8Pn1D6Y2pct8o62nQfvQ collected $1.80 from pot
*** SUMMARY ***
Total pot $1.85 | Rake $0.05 
Board [6s Ac 6d Ks 2h]
Seat 1: 6RiVTYll/5D8zICp0MRpKw folded on the Flop
Seat 2: MG90wfSJZnOejs/KD3vlQQ folded before Flop (didn't bet)
Seat 3: z5GxcHlYz/GSz6W2uFiTtg mucked
Seat 4: M2QO2DxB5Wawg2h8HSpnYA folded before Flop (didn't bet)
Seat 5: dfNim92Z6XK1/h5SFW5vDg (button) folded before Flop (didn't bet)
Seat 6: pRZytPRoJmxE0dmcJwYvfw (small blind) folded before Flop
Seat 7: eC8Pn1D6Y2pct8o62nQfvQ (big blind) showed [Ad 5s] and won ($1.80) with two pair, Aces and Sixes
Seat 8: dtZ84flFEi4Q+SGrHMJRDQ folded before Flop (didn't bet)




PokerStars Game #59941695692:  Hold'em No Limit ($0.10/$0.25) - 2009/07/01 1:43:15 ET
Table 'ER5H84HUgJx7HyDLnELLeA' 6-max Seat #1 is the button
Seat 1: LJI7A1YgDM7hgh7o56+ReQ ($27.15 in chips) 
Seat 4: vqWjZmdQu/Hxw96/IJTWdQ ($25.35 in chips) 
Seat 5: mfrkWA3PTeYPkbO6hi98Aw ($25.55 in chips) 
Seat 6: 3zD3qLXT1bEffAoWGnc7wg ($51 in chips) 
buyjetgNT1McXtdaP4zynA has returned
memV5jkoAdGrnRy3Q9PM7w said, "lagg"
memV5jkoAdGrnRy3Q9PM7w has timed out while being disconnected
memV5jkoAdGrnRy3Q9PM7w: is sitting out 
vqWjZmdQu/Hxw96/IJTWdQ: posts small blind $0.10
mfrkWA3PTeYPkbO6hi98Aw: posts big blind $0.25
*** HOLE CARDS ***
memV5jkoAdGrnRy3Q9PM7w is disconnected 
3zD3qLXT1bEffAoWGnc7wg: folds 
LJI7A1YgDM7hgh7o56+ReQ: raises $0.50 to $0.75
vqWjZmdQu/Hxw96/IJTWdQ: folds 
mfrkWA3PTeYPkbO6hi98Aw: folds 
Uncalled bet ($0.50) returned to LJI7A1YgDM7hgh7o56+ReQ
LJI7A1YgDM7hgh7o56+ReQ collected $0.60 from pot
LJI7A1YgDM7hgh7o56+ReQ: doesn't show hand 
*** SUMMARY ***
Total pot $0.60 | Rake $0 
Seat 1: LJI7A1YgDM7hgh7o56+ReQ (button) collected ($0.60)
Seat 4: vqWjZmdQu/Hxw96/IJTWdQ (small blind) folded before Flop
Seat 5: mfrkWA3PTeYPkbO6hi98Aw (big blind) folded before Flop
Seat 6: 3zD3qLXT1bEffAoWGnc7wg folded before Flop (didn't bet)




PokerStars Game #59941695354:  Hold'em No Limit ($0.10/$0.25) - 2009/07/01 1:43:15 ET
Table 'fHv1Mk7ZbLjprZTGWKPiEQ' 6-max Seat #2 is the button
Seat 2: 9U3ZKjCsarN0DjR6mSE8Ug ($14.70 in chips) 
Seat 3: /gJNBeCkWL4o85/jvlZ4BA ($25 in chips) 
Seat 4: TSmua8tGK3sTbwi0ynrW9Q ($59.15 in chips) 
Seat 5: LJI7A1YgDM7hgh7o56+ReQ ($26.65 in chips) 
Seat 6: AjG0X+rNtc2W08eph8oqpw ($35.85 in chips) 
/gJNBeCkWL4o85/jvlZ4BA: posts small blind $0.10
TSmua8tGK3sTbwi0ynrW9Q: posts big blind $0.25
OIjOiBfQstWrK/RuXx7zcw: sits out 
*** HOLE CARDS ***
LJI7A1YgDM7hgh7o56+ReQ: folds 
AjG0X+rNtc2W08eph8oqpw: folds 
9U3ZKjCsarN0DjR6mSE8Ug: raises $0.50 to $0.75
/gJNBeCkWL4o85/jvlZ4BA: folds 
TSmua8tGK3sTbwi0ynrW9Q: folds 
Uncalled bet ($0.50) returned to 9U3ZKjCsarN0DjR6mSE8Ug
9U3ZKjCsarN0DjR6mSE8Ug collected $0.60 from pot
9U3ZKjCsarN0DjR6mSE8Ug: doesn't show hand 
*** SUMMARY ***
Total pot $0.60 | Rake $0 
Seat 2: 9U3ZKjCsarN0DjR6mSE8Ug (button) collected ($0.60)
Seat 3: /gJNBeCkWL4o85/jvlZ4BA (small blind) folded before Flop
Seat 4: TSmua8tGK3sTbwi0ynrW9Q (big blind) folded before Flop
Seat 5: LJI7A1YgDM7hgh7o56+ReQ folded before Flop (didn't bet)
Seat 6: AjG0X+rNtc2W08eph8oqpw folded before Flop (didn't bet)




PokerStars Game #59941695504:  Hold'em No Limit ($0.10/$0.25) - 2009/07/01 1:43:15 ET
Table 'WjNvuuSgTjm8jh0j9vcCgQ' 9-max Seat #6 is the button
Seat 1: q+Qdg0Hoir+SyL7haBrUnw ($8.05 in chips) 
Seat 2: ghNKXUBl/H+t83JF079ZBA ($23.40 in chips) 
Seat 3: pSKReiGBNW9NsF2jAZnlwg ($22 in chips) 
Seat 4: X78b5v/uhqeXXoAijbw/yg ($31.35 in chips) 
Seat 5: ziFpkH3wCzqB/qXeq/Hy7g ($25 in chips) 
Seat 6: ubsjZomMWSV0hAiBLa7K1A ($21.25 in chips) 
Seat 7: NSX8YOj+RznxoL+rO1YU4w ($13 in chips) 
Seat 8: hZuGwtYmFKPmQ+v1wlmdfA ($17.75 in chips) 
Seat 9: CT7Xj/V/O5rBlhtt+RZeFQ ($25.60 in chips) 
NSX8YOj+RznxoL+rO1YU4w: posts small blind $0.10
hZuGwtYmFKPmQ+v1wlmdfA: posts big blind $0.25
*** HOLE CARDS ***
CT7Xj/V/O5rBlhtt+RZeFQ: folds 
q+Qdg0Hoir+SyL7haBrUnw: folds 
ghNKXUBl/H+t83JF079ZBA: folds 
pSKReiGBNW9NsF2jAZnlwg: raises $0.50 to $0.75
X78b5v/uhqeXXoAijbw/yg: folds 
ziFpkH3wCzqB/qXeq/Hy7g: folds 
ubsjZomMWSV0hAiBLa7K1A: folds 
NSX8YOj+RznxoL+rO1YU4w: folds 
hZuGwtYmFKPmQ+v1wlmdfA: folds 
Uncalled bet ($0.50) returned to pSKReiGBNW9NsF2jAZnlwg
pSKReiGBNW9NsF2jAZnlwg collected $0.60 from pot
*** SUMMARY ***
Total pot $0.60 | Rake $0 
Seat 1: q+Qdg0Hoir+SyL7haBrUnw folded before Flop (didn't bet)
Seat 2: ghNKXUBl/H+t83JF079ZBA folded before Flop (didn't bet)
Seat 3: pSKReiGBNW9NsF2jAZnlwg collected ($0.60)
Seat 4: X78b5v/uhqeXXoAijbw/yg folded before Flop (didn't bet)
Seat 5: ziFpkH3wCzqB/qXeq/Hy7g folded before Flop (didn't bet)
Seat 6: ubsjZomMWSV0hAiBLa7K1A (button) folded before Flop (didn't bet)
Seat 7: NSX8YOj+RznxoL+rO1YU4w (small blind) folded before Flop
Seat 8: hZuGwtYmFKPmQ+v1wlmdfA (big blind) folded before Flop
Seat 9: CT7Xj/V/O5rBlhtt+RZeFQ folded before Flop (didn't bet)




PokerStars Game #59941695998:  Hold'em No Limit ($0.10/$0.25) - 2009/07/01 1:43:16 ET
Table 'Yb2CyZosw7N3yRRVLhKnKg' 9-max Seat #8 is the button
Seat 1: c/9X4zftzphFxYtxp5kp9w ($14.90 in chips) 
Seat 2: dtZ84flFEi4Q+SGrHMJRDQ ($26.65 in chips) 
Seat 3: I8/fpJ2v6LsVf0kxqaVdMQ ($16.50 in chips) 
Seat 4: FG10kumpruEJ3PQJ7oGglQ ($11.35 in chips) 
Seat 5: T5Hk9oiIr+JDDMnEqwFCrw ($2.25 in chips) 
Seat 6: CgIo2ItZqi4o3ayVG6HanQ ($44.95 in chips) 
Seat 7: ljemhp25Zg+nlA9DLCIiUw ($26.85 in chips) 
Seat 8: HxDF4QSxC4z39D7teZpprQ ($10.75 in chips) 
Seat 9: 6DVf3fwEGECnjQ4Yp9AsFw ($15.60 in chips) 
6DVf3fwEGECnjQ4Yp9AsFw: posts small blind $0.10
c/9X4zftzphFxYtxp5kp9w: posts big blind $0.25
*** HOLE CARDS ***
dtZ84flFEi4Q+SGrHMJRDQ: raises $0.75 to $1
I8/fpJ2v6LsVf0kxqaVdMQ: folds 
FG10kumpruEJ3PQJ7oGglQ: folds 
T5Hk9oiIr+JDDMnEqwFCrw: folds 
CgIo2ItZqi4o3ayVG6HanQ: calls $1
ljemhp25Zg+nlA9DLCIiUw: folds 
HxDF4QSxC4z39D7teZpprQ: folds 
6DVf3fwEGECnjQ4Yp9AsFw: folds 
c/9X4zftzphFxYtxp5kp9w: folds 
*** FLOP *** [Js Qc Kd]
dtZ84flFEi4Q+SGrHMJRDQ: checks 
CgIo2ItZqi4o3ayVG6HanQ: checks 
*** TURN *** [Js Qc Kd] [2s]
dtZ84flFEi4Q+SGrHMJRDQ: bets $1.25
CgIo2ItZqi4o3ayVG6HanQ: folds 
Uncalled bet ($1.25) returned to dtZ84flFEi4Q+SGrHMJRDQ
dtZ84flFEi4Q+SGrHMJRDQ collected $2.25 from pot
dtZ84flFEi4Q+SGrHMJRDQ: doesn't show hand 
*** SUMMARY ***
Total pot $2.35 | Rake $0.10 
Board [Js Qc Kd 2s]
Seat 1: c/9X4zftzphFxYtxp5kp9w (big blind) folded before Flop
Seat 2: dtZ84flFEi4Q+SGrHMJRDQ collected ($2.25)
Seat 3: I8/fpJ2v6LsVf0kxqaVdMQ folded before Flop (didn't bet)
Seat 4: FG10kumpruEJ3PQJ7oGglQ folded before Flop (didn't bet)
Seat 5: T5Hk9oiIr+JDDMnEqwFCrw folded before Flop (didn't bet)
Seat 6: CgIo2ItZqi4o3ayVG6HanQ folded on the Turn
Seat 7: ljemhp25Zg+nlA9DLCIiUw folded before Flop (didn't bet)
Seat 8: HxDF4QSxC4z39D7teZpprQ (button) folded before Flop (didn't bet)
Seat 9: 6DVf3fwEGECnjQ4Yp9AsFw (small blind) folded before Flop




PokerStars Game #59941696042:  Hold'em No Limit ($0.10/$0.25) - 2009/07/01 1:43:16 ET
Table 'fRxOyfaHXkWUDLv4eSxFew' 9-max Seat #7 is the button
Seat 1: 6RiVTYll/5D8zICp0MRpKw ($29.15 in chips) 
Seat 2: M2QO2DxB5Wawg2h8HSpnYA ($10.35 in chips) 
Seat 3: j4q3p0lesp63b1gZDwLBZw ($5 in chips) 
Seat 4: MtVtHDqIJTyUcXkRBBDIVA ($27.60 in chips) 
Seat 5: dmYlc+1cjwZMJ7wV+Z0rRg ($22.75 in chips) 
Seat 6: arxNSjreDRGFg13EAM2F1w ($27.05 in chips) 
Seat 7: 1/DuWziR8CXhWB71aPQd9Q ($17.80 in chips) 
Seat 8: 5n7e7I+px7c6CQmLpPbtsg ($4.75 in chips) 
Seat 9: H5Se03ZqSX7tbULXur2MAg ($33 in chips) 
5n7e7I+px7c6CQmLpPbtsg: posts small blind $0.10
H5Se03ZqSX7tbULXur2MAg: posts big blind $0.25
*** HOLE CARDS ***
6RiVTYll/5D8zICp0MRpKw: folds 
M2QO2DxB5Wawg2h8HSpnYA: folds 
j4q3p0lesp63b1gZDwLBZw: raises $0.75 to $1
MtVtHDqIJTyUcXkRBBDIVA: folds 
dmYlc+1cjwZMJ7wV+Z0rRg: folds 
arxNSjreDRGFg13EAM2F1w: folds 
1/DuWziR8CXhWB71aPQd9Q: calls $1
5n7e7I+px7c6CQmLpPbtsg: folds 
H5Se03ZqSX7tbULXur2MAg: folds 
*** FLOP *** [3d 4d 5d]
j4q3p0lesp63b1gZDwLBZw: bets $1.75
1/DuWziR8CXhWB71aPQd9Q: calls $1.75
*** TURN *** [3d 4d 5d] [3h]
j4q3p0lesp63b1gZDwLBZw: bets $2.25 and is all-in
1/DuWziR8CXhWB71aPQd9Q: calls $2.25
*** RIVER *** [3d 4d 5d 3h] [Jd]
*** SHOW DOWN ***
j4q3p0lesp63b1gZDwLBZw: shows [As Kd] (a flush, King high)
1/DuWziR8CXhWB71aPQd9Q: mucks hand 
j4q3p0lesp63b1gZDwLBZw collected $9.85 from pot
*** SUMMARY ***
Total pot $10.35 | Rake $0.50 
Board [3d 4d 5d 3h Jd]
Seat 1: 6RiVTYll/5D8zICp0MRpKw folded before Flop (didn't bet)
Seat 2: M2QO2DxB5Wawg2h8HSpnYA folded before Flop (didn't bet)
Seat 3: j4q3p0lesp63b1gZDwLBZw showed [As Kd] and won ($9.85) with a flush, King high
Seat 4: MtVtHDqIJTyUcXkRBBDIVA folded before Flop (didn't bet)
Seat 5: dmYlc+1cjwZMJ7wV+Z0rRg folded before Flop (didn't bet)
Seat 6: arxNSjreDRGFg13EAM2F1w folded before Flop (didn't bet)
Seat 7: 1/DuWziR8CXhWB71aPQd9Q (button) mucked
Seat 8: 5n7e7I+px7c6CQmLpPbtsg (small blind) folded before Flop
Seat 9: H5Se03ZqSX7tbULXur2MAg (big blind) folded before Flop




PokerStars Game #59941695804:  Hold'em No Limit ($0.10/$0.25) - 2009/07/01 1:43:16 ET
Table 'jz4TpuH+ag+0iNe2ZcxckQ' 9-max Seat #3 is the button
Seat 1: +C3eP/ysyROWbEXJFPswVA ($14.20 in chips) 
Seat 2: OXPkK84/qv92EMwXPiG5rQ ($13.70 in chips) 
Seat 3: egvg3mTBBVzMHnJPIQiKcA ($13.40 in chips) 
Seat 4: k+2r6di6GXjNpAdrRkW9bA ($59.75 in chips) 
Seat 5: v1BVHNGLbP/nx7QO6K7+Jw ($28.45 in chips) 
Seat 6: gO1uiTGTzn5Cd3PECuws1g ($14 in chips) 
Seat 7: tLcDklc2rBORNfixyRfVfw ($32 in chips) 
Seat 8: uhrboV251dcgYniYTdFIcA ($25 in chips) 
Seat 9: W2YYHvqjaEpRrO7stZkClQ ($5.80 in chips) 
k+2r6di6GXjNpAdrRkW9bA: posts small blind $0.10
v1BVHNGLbP/nx7QO6K7+Jw: posts big blind $0.25
*** HOLE CARDS ***
gO1uiTGTzn5Cd3PECuws1g: folds 
tLcDklc2rBORNfixyRfVfw: folds 
uhrboV251dcgYniYTdFIcA: folds 
W2YYHvqjaEpRrO7stZkClQ: folds 
+C3eP/ysyROWbEXJFPswVA: raises $0.75 to $1
OXPkK84/qv92EMwXPiG5rQ: folds 
egvg3mTBBVzMHnJPIQiKcA: folds 
k+2r6di6GXjNpAdrRkW9bA: folds 
v1BVHNGLbP/nx7QO6K7+Jw: raises $0.75 to $1.75
OXPkK84/qv92EMwXPiG5rQ leaves the table
+C3eP/ysyROWbEXJFPswVA said, "nice catch"
+C3eP/ysyROWbEXJFPswVA: calls $0.75
*** FLOP *** [5d 2h 9s]
v1BVHNGLbP/nx7QO6K7+Jw: bets $3.25
clJsV3v77RS07bDKY+705w joins the table at seat #2 
+C3eP/ysyROWbEXJFPswVA: folds 
Uncalled bet ($3.25) returned to v1BVHNGLbP/nx7QO6K7+Jw
v1BVHNGLbP/nx7QO6K7+Jw collected $3.45 from pot
v1BVHNGLbP/nx7QO6K7+Jw: doesn't show hand 
*** SUMMARY ***
Total pot $3.60 | Rake $0.15 
Board [5d 2h 9s]
Seat 1: +C3eP/ysyROWbEXJFPswVA folded on the Flop
Seat 2: OXPkK84/qv92EMwXPiG5rQ folded before Flop (didn't bet)
Seat 3: egvg3mTBBVzMHnJPIQiKcA (button) folded before Flop (didn't bet)
Seat 4: k+2r6di6GXjNpAdrRkW9bA (small blind) folded before Flop
Seat 5: v1BVHNGLbP/nx7QO6K7+Jw (big blind) collected ($3.45)
Seat 6: gO1uiTGTzn5Cd3PECuws1g folded before Flop (didn't bet)
Seat 7: tLcDklc2rBORNfixyRfVfw folded before Flop (didn't bet)
Seat 8: uhrboV251dcgYniYTdFIcA folded before Flop (didn't bet)
Seat 9: W2YYHvqjaEpRrO7stZkClQ folded before Flop (didn't bet)




PokerStars Game #59941696038:  Hold'em No Limit ($0.10/$0.25) - 2009/07/01 1:43:16 ET
Table 'KKk6y4pAXeymxYcd0uZLqg' 9-max Seat #8 is the button
Seat 1: HPEB+AtKw1+C/cxU0o1ciw ($24.90 in chips) 
Seat 2: k55YB7uP2TAZEba6pnHYiA ($19.70 in chips) 
Seat 4: YciNm3fUXAQaJeXG1rhrbw ($12.05 in chips) 
Seat 5: wGigCmBR/9XWkPpvYos3aQ ($38.85 in chips) 
Seat 6: QEbIGci+itdw+re8RM5fZA ($25 in chips) 
Seat 7: JjOuv8Vf56aiQjWi/rTPFA ($22.65 in chips) 
Seat 8: +2kMBNpY4nF1qNCRd8SJLA ($33.25 in chips) 
Seat 9: oLa/tXLfSLLB28mcLGrxcg ($24.75 in chips) 
oLa/tXLfSLLB28mcLGrxcg: posts small blind $0.10
HPEB+AtKw1+C/cxU0o1ciw: posts big blind $0.25
tLcDklc2rBORNfixyRfVfw: sits out 
*** HOLE CARDS ***
k55YB7uP2TAZEba6pnHYiA: folds 
YciNm3fUXAQaJeXG1rhrbw: calls $0.25
k55YB7uP2TAZEba6pnHYiA is sitting out
wGigCmBR/9XWkPpvYos3aQ: folds 
QEbIGci+itdw+re8RM5fZA: folds 
JjOuv8Vf56aiQjWi/rTPFA: folds 
+2kMBNpY4nF1qNCRd8SJLA: calls $0.25
oLa/tXLfSLLB28mcLGrxcg: calls $0.15
HPEB+AtKw1+C/cxU0o1ciw: checks 
*** FLOP *** [Ts As Ks]
oLa/tXLfSLLB28mcLGrxcg: bets $0.25
HPEB+AtKw1+C/cxU0o1ciw: folds 
YciNm3fUXAQaJeXG1rhrbw: folds 
+2kMBNpY4nF1qNCRd8SJLA: folds 
Uncalled bet ($0.25) returned to oLa/tXLfSLLB28mcLGrxcg
oLa/tXLfSLLB28mcLGrxcg collected $0.95 from pot
oLa/tXLfSLLB28mcLGrxcg: doesn't show hand 
*** SUMMARY ***
Total pot $1 | Rake $0.05 
Board [Ts As Ks]
Seat 1: HPEB+AtKw1+C/cxU0o1ciw (big blind) folded on the Flop
Seat 2: k55YB7uP2TAZEba6pnHYiA folded before Flop (didn't bet)
Seat 4: YciNm3fUXAQaJeXG1rhrbw folded on the Flop
Seat 5: wGigCmBR/9XWkPpvYos3aQ folded before Flop (didn't bet)
Seat 6: QEbIGci+itdw+re8RM5fZA folded before Flop (didn't bet)
Seat 7: JjOuv8Vf56aiQjWi/rTPFA folded before Flop (didn't bet)
Seat 8: +2kMBNpY4nF1qNCRd8SJLA (button) folded on the Flop
Seat 9: oLa/tXLfSLLB28mcLGrxcg (small blind) collected ($0.95)




PokerStars Game #59941696140:  Hold'em No Limit ($0.10/$0.25) - 2009/07/01 1:43:16 ET
Table 'Loy/olZ5qoDOSvX4UTujGg' 6-max Seat #5 is the button
Seat 1: HipgaJhkN4ie/tTw4dK3Ug ($12.80 in chips) 
Seat 2: 4z7mPbMLNp4TezHXin63Vw ($16.55 in chips) 
Seat 3: 32YL2ZEp8NT4JB2RVM9euQ ($16.05 in chips) 
Seat 4: /gJNBeCkWL4o85/jvlZ4BA ($28.55 in chips) 
Seat 5: tSR4329m40dZsN7YOpI9Kw ($28.35 in chips) 
Seat 6: qGHGf/553gQnDoklMRe3tg ($26.30 in chips) 
qGHGf/553gQnDoklMRe3tg: posts small blind $0.10
HipgaJhkN4ie/tTw4dK3Ug: posts big blind $0.25
*** HOLE CARDS ***
4z7mPbMLNp4TezHXin63Vw: folds 
32YL2ZEp8NT4JB2RVM9euQ: folds 
/gJNBeCkWL4o85/jvlZ4BA: folds 
tSR4329m40dZsN7YOpI9Kw: folds 
qGHGf/553gQnDoklMRe3tg: folds 
Uncalled bet ($0.15) returned to HipgaJhkN4ie/tTw4dK3Ug
HipgaJhkN4ie/tTw4dK3Ug collected $0.20 from pot
*** SUMMARY ***
Total pot $0.20 | Rake $0 
Seat 1: HipgaJhkN4ie/tTw4dK3Ug (big blind) collected ($0.20)
Seat 2: 4z7mPbMLNp4TezHXin63Vw folded before Flop (didn't bet)
Seat 3: 32YL2ZEp8NT4JB2RVM9euQ folded before Flop (didn't bet)
Seat 4: /gJNBeCkWL4o85/jvlZ4BA folded before Flop (didn't bet)
Seat 5: tSR4329m40dZsN7YOpI9Kw (button) folded before Flop (didn't bet)
Seat 6: qGHGf/553gQnDoklMRe3tg (small blind) folded before Flop




PokerStars Game #59941695890:  Hold'em No Limit ($0.10/$0.25) - 2009/07/01 1:43:16 ET
Table '5NipxzzFB2DffzDpddyQoQ' 6-max Seat #1 is the button
Seat 1: W87HPwOk1KtWaYyshBe1gA ($21.25 in chips) 
Seat 2: iauW7L/+7qzAuHow7CD75Q ($9.60 in chips) 
Seat 3: QvTX2yGq3uKJiKPmns4TKQ ($18.90 in chips) 
Seat 4: NTamLAiMZ86c5yM04t96LA ($16.35 in chips) 
Seat 5: faP2NVl/cFTZ1nE4pXzg8Q ($37.10 in chips) 
Seat 6: 7JqTFMyeNSVWsmp/yW35Tw ($25 in chips) 
iauW7L/+7qzAuHow7CD75Q: posts small blind $0.10
QvTX2yGq3uKJiKPmns4TKQ: posts big blind $0.25
*** HOLE CARDS ***
NTamLAiMZ86c5yM04t96LA: calls $0.25
faP2NVl/cFTZ1nE4pXzg8Q: calls $0.25
7JqTFMyeNSVWsmp/yW35Tw: raises $2 to $2.25
W87HPwOk1KtWaYyshBe1gA: folds 
iauW7L/+7qzAuHow7CD75Q: folds 
QvTX2yGq3uKJiKPmns4TKQ: folds 
NTamLAiMZ86c5yM04t96LA: folds 
faP2NVl/cFTZ1nE4pXzg8Q: calls $2
*** FLOP *** [3h Js Jh]
faP2NVl/cFTZ1nE4pXzg8Q: bets $1
7JqTFMyeNSVWsmp/yW35Tw: raises $21.75 to $22.75 and is all-in
NTamLAiMZ86c5yM04t96LA said, "hahahahahha'"
NTamLAiMZ86c5yM04t96LA said, "wus"
iauW7L/+7qzAuHow7CD75Q said, "i folded j3"
NTamLAiMZ86c5yM04t96LA said, "u had nouthing"
iauW7L/+7qzAuHow7CD75Q said, "j/k"
faP2NVl/cFTZ1nE4pXzg8Q: folds 
Uncalled bet ($21.75) returned to 7JqTFMyeNSVWsmp/yW35Tw
NTamLAiMZ86c5yM04t96LA said, "shhhh"
7JqTFMyeNSVWsmp/yW35Tw collected $6.80 from pot
*** SUMMARY ***
Total pot $7.10 | Rake $0.30 
Board [3h Js Jh]
Seat 1: W87HPwOk1KtWaYyshBe1gA (button) folded before Flop (didn't bet)
Seat 2: iauW7L/+7qzAuHow7CD75Q (small blind) folded before Flop
Seat 3: QvTX2yGq3uKJiKPmns4TKQ (big blind) folded before Flop
Seat 4: NTamLAiMZ86c5yM04t96LA folded before Flop
Seat 5: faP2NVl/cFTZ1nE4pXzg8Q folded on the Flop
Seat 6: 7JqTFMyeNSVWsmp/yW35Tw collected ($6.80)




PokerStars Game #59941696122:  Hold'em No Limit ($0.10/$0.25) - 2009/07/01 1:43:16 ET
Table 'wixGE3Zge1qBdnpWijIl/w' 9-max Seat #3 is the button
Seat 1: 4GJMmHGKzu+gVtalqRy7dA ($19.10 in chips) 
Seat 2: DnDcAdn9P0zGovMERigpFA ($79.60 in chips) 
Seat 3: Bb42QRQMhg5/Y0vHP8/2Xw ($25 in chips) 
Seat 5: H5Se03ZqSX7tbULXur2MAg ($24.20 in chips) 
Seat 6: AP/rNvbsacTb4XtaAgKPiQ ($21.05 in chips) 
Seat 8: ShCS62CJp4MKfKLKvGKQbA ($15.15 in chips) 
Seat 9: r6hsffOo1iKmaPYKwAZmFw ($29.15 in chips) 
X6+pSIPfovPcE87t+LmUKQ will be allowed to play after the button
H5Se03ZqSX7tbULXur2MAg: posts small blind $0.10
AP/rNvbsacTb4XtaAgKPiQ: posts big blind $0.25
mMd8CDS/but3UC+Zp7Up2w has timed out
mMd8CDS/but3UC+Zp7Up2w: is sitting out 
*** HOLE CARDS ***
ShCS62CJp4MKfKLKvGKQbA: folds 
r6hsffOo1iKmaPYKwAZmFw: folds 
4GJMmHGKzu+gVtalqRy7dA: folds 
DnDcAdn9P0zGovMERigpFA: folds 
Bb42QRQMhg5/Y0vHP8/2Xw: folds 
H5Se03ZqSX7tbULXur2MAg: raises $0.50 to $0.75
AP/rNvbsacTb4XtaAgKPiQ: folds 
Uncalled bet ($0.50) returned to H5Se03ZqSX7tbULXur2MAg
mMd8CDS/but3UC+Zp7Up2w has returned
H5Se03ZqSX7tbULXur2MAg collected $0.50 from pot
*** SUMMARY ***
Total pot $0.50 | Rake $0 
Seat 1: 4GJMmHGKzu+gVtalqRy7dA folded before Flop (didn't bet)
Seat 2: DnDcAdn9P0zGovMERigpFA folded before Flop (didn't bet)
Seat 3: Bb42QRQMhg5/Y0vHP8/2Xw (button) folded before Flop (didn't bet)
Seat 5: H5Se03ZqSX7tbULXur2MAg (small blind) collected ($0.50)
Seat 6: AP/rNvbsacTb4XtaAgKPiQ (big blind) folded before Flop
Seat 8: ShCS62CJp4MKfKLKvGKQbA folded before Flop (didn't bet)
Seat 9: r6hsffOo1iKmaPYKwAZmFw folded before Flop (didn't bet)




PokerStars Game #59941696366:  Hold'em No Limit ($0.10/$0.25) - 2009/07/01 1:43:17 ET
Table 'ohAuixfiLOYDylNUG5mNUw' 9-max Seat #9 is the button
Seat 2: Th3FldXKQW6hWVVPahaoOQ ($26.90 in chips) 
Seat 3: gSakoFAgDDzXSb2eNBWKcg ($15 in chips) 
Seat 4: AiXn/9o1EwOPZUHujnh/bA ($18.65 in chips) 
Seat 5: wub1jsnHlpWmOX4uczVADA ($7.15 in chips) 
Seat 6: MtVtHDqIJTyUcXkRBBDIVA ($25 in chips) 
Seat 7: +qc/EYCgLC65SpGvr35eNg ($24.65 in chips) 
Seat 8: ppMlNkhYgErlt4fuJO7ADA ($2.50 in chips) 
Seat 9: CT7Xj/V/O5rBlhtt+RZeFQ ($25.60 in chips) 
qwr38jl5txoR36M7G5qi4A will be allowed to play after the button
Th3FldXKQW6hWVVPahaoOQ: posts small blind $0.10
gSakoFAgDDzXSb2eNBWKcg: posts big blind $0.25
*** HOLE CARDS ***
AiXn/9o1EwOPZUHujnh/bA: folds 
wub1jsnHlpWmOX4uczVADA: folds 
MtVtHDqIJTyUcXkRBBDIVA: calls $0.25
+qc/EYCgLC65SpGvr35eNg: folds 
ppMlNkhYgErlt4fuJO7ADA: folds 
CT7Xj/V/O5rBlhtt+RZeFQ: folds 
Th3FldXKQW6hWVVPahaoOQ: calls $0.15
gSakoFAgDDzXSb2eNBWKcg: checks 
*** FLOP *** [6c Ad 2h]
Th3FldXKQW6hWVVPahaoOQ: checks 
gSakoFAgDDzXSb2eNBWKcg: checks 
MtVtHDqIJTyUcXkRBBDIVA: checks 
*** TURN *** [6c Ad 2h] [7s]
Th3FldXKQW6hWVVPahaoOQ: checks 
gSakoFAgDDzXSb2eNBWKcg: checks 
MtVtHDqIJTyUcXkRBBDIVA: checks 
*** RIVER *** [6c Ad 2h 7s] [Tc]
Th3FldXKQW6hWVVPahaoOQ: checks 
gSakoFAgDDzXSb2eNBWKcg: checks 
MtVtHDqIJTyUcXkRBBDIVA: checks 
*** SHOW DOWN ***
Th3FldXKQW6hWVVPahaoOQ: shows [3c 3d] (a pair of Threes)
gSakoFAgDDzXSb2eNBWKcg: mucks hand 
MtVtHDqIJTyUcXkRBBDIVA: mucks hand 
Th3FldXKQW6hWVVPahaoOQ collected $0.75 from pot
*** SUMMARY ***
Total pot $0.75 | Rake $0 
Board [6c Ad 2h 7s Tc]
Seat 2: Th3FldXKQW6hWVVPahaoOQ (small blind) showed [3c 3d] and won ($0.75) with a pair of Threes
Seat 3: gSakoFAgDDzXSb2eNBWKcg (big blind) mucked
Seat 4: AiXn/9o1EwOPZUHujnh/bA folded before Flop (didn't bet)
Seat 5: wub1jsnHlpWmOX4uczVADA folded before Flop (didn't bet)
Seat 6: MtVtHDqIJTyUcXkRBBDIVA mucked
Seat 7: +qc/EYCgLC65SpGvr35eNg folded before Flop (didn't bet)
Seat 8: ppMlNkhYgErlt4fuJO7ADA folded before Flop (didn't bet)
Seat 9: CT7Xj/V/O5rBlhtt+RZeFQ (button) folded before Flop (didn't bet)




PokerStars Game #59941696922:  Hold'em No Limit ($0.10/$0.25) - 2009/07/01 1:43:18 ET
Table 'NtEQAxCeIK2io1CGtW658g' 6-max Seat #1 is the button
Seat 1: X437kMQ7AujoaDgjguhU9w ($9.90 in chips) 
Seat 3: m2yWOKfAxqHoy5DDN87Ttw ($39.85 in chips) 
Seat 4: 8296 ($11.90 in chips) 
Seat 5: Hsvkc0/G2VV78oVmWYXecw ($5 in chips) 
Seat 6: /gJNBeCkWL4o85/jvlZ4BA ($64.75 in chips) 
Satvaldiev was removed from the table for failing to post
m2yWOKfAxqHoy5DDN87Ttw: posts small blind $0.10
8296: posts big blind $0.25
*** HOLE CARDS ***
Hsvkc0/G2VV78oVmWYXecw: folds 
/gJNBeCkWL4o85/jvlZ4BA: raises $0.75 to $1
X437kMQ7AujoaDgjguhU9w: folds 
m2yWOKfAxqHoy5DDN87Ttw: folds 
8296: folds 
Uncalled bet ($0.75) returned to /gJNBeCkWL4o85/jvlZ4BA
/gJNBeCkWL4o85/jvlZ4BA collected $0.60 from pot
*** SUMMARY ***
Total pot $0.60 | Rake $0 
Seat 1: X437kMQ7AujoaDgjguhU9w (button) folded before Flop (didn't bet)
Seat 3: m2yWOKfAxqHoy5DDN87Ttw (small blind) folded before Flop
Seat 4: 8296 (big blind) folded before Flop
Seat 5: Hsvkc0/G2VV78oVmWYXecw folded before Flop (didn't bet)
Seat 6: /gJNBeCkWL4o85/jvlZ4BA collected ($0.60)




PokerStars Game #59941697104:  Hold'em No Limit ($0.10/$0.25) - 2009/07/01 1:43:18 ET
Table 'LXz5SsUCyWcm+4JDJh466A' 9-max Seat #9 is the button
Seat 1: MG90wfSJZnOejs/KD3vlQQ ($24.75 in chips) 
Seat 2: H5Se03ZqSX7tbULXur2MAg ($23.70 in chips) 
Seat 3: dfNim92Z6XK1/h5SFW5vDg ($25.50 in chips) 
Seat 4: K0b5wNInj6hUGRr6yzKFtw ($28.60 in chips) 
Seat 5: O02ScVDnDZwH6KjZNJZMzA ($4.40 in chips) 
Seat 6: 6RiVTYll/5D8zICp0MRpKw ($24.75 in chips) 
Seat 7: J2a/QHAWUgo6beDRoEyg2g ($8.75 in chips) 
Seat 8: zOHElTcFiTsexeDCkAPYkQ ($32.15 in chips) 
Seat 9: dtZ84flFEi4Q+SGrHMJRDQ ($25 in chips) 
MG90wfSJZnOejs/KD3vlQQ: posts small blind $0.10
H5Se03ZqSX7tbULXur2MAg: posts big blind $0.25
*** HOLE CARDS ***
dfNim92Z6XK1/h5SFW5vDg: folds 
K0b5wNInj6hUGRr6yzKFtw: folds 
O02ScVDnDZwH6KjZNJZMzA: raises $0.25 to $0.50
6RiVTYll/5D8zICp0MRpKw: folds 
J2a/QHAWUgo6beDRoEyg2g: folds 
zOHElTcFiTsexeDCkAPYkQ: raises $0.25 to $0.75
dtZ84flFEi4Q+SGrHMJRDQ: folds 
MG90wfSJZnOejs/KD3vlQQ: folds 
H5Se03ZqSX7tbULXur2MAg: folds 
O02ScVDnDZwH6KjZNJZMzA: calls $0.25
*** FLOP *** [6s Qd Tc]
O02ScVDnDZwH6KjZNJZMzA: checks 
zOHElTcFiTsexeDCkAPYkQ: bets $1
O02ScVDnDZwH6KjZNJZMzA: calls $1
*** TURN *** [6s Qd Tc] [7s]
O02ScVDnDZwH6KjZNJZMzA: bets $2.65 and is all-in
zOHElTcFiTsexeDCkAPYkQ: calls $2.65
*** RIVER *** [6s Qd Tc 7s] [Ts]
*** SHOW DOWN ***
O02ScVDnDZwH6KjZNJZMzA: shows [8h 8c] (two pair, Tens and Eights)
zOHElTcFiTsexeDCkAPYkQ: shows [Qc 5s] (two pair, Queens and Tens)
zOHElTcFiTsexeDCkAPYkQ collected $8.70 from pot
*** SUMMARY ***
Total pot $9.15 | Rake $0.45 
Board [6s Qd Tc 7s Ts]
Seat 1: MG90wfSJZnOejs/KD3vlQQ (small blind) folded before Flop
Seat 2: H5Se03ZqSX7tbULXur2MAg (big blind) folded before Flop
Seat 3: dfNim92Z6XK1/h5SFW5vDg folded before Flop (didn't bet)
Seat 4: K0b5wNInj6hUGRr6yzKFtw folded before Flop (didn't bet)
Seat 5: O02ScVDnDZwH6KjZNJZMzA showed [8h 8c] and lost with two pair, Tens and Eights
Seat 6: 6RiVTYll/5D8zICp0MRpKw folded before Flop (didn't bet)
Seat 7: J2a/QHAWUgo6beDRoEyg2g folded before Flop (didn't bet)
Seat 8: zOHElTcFiTsexeDCkAPYkQ showed [Qc 5s] and won ($8.70) with two pair, Queens and Tens
Seat 9: dtZ84flFEi4Q+SGrHMJRDQ (button) folded before Flop (didn't bet)




PokerStars Game #59941696938:  Hold'em No Limit ($0.10/$0.25) - 2009/07/01 1:43:18 ET
Table 'dNYnr4D4id1jwnEU66Yowg' 9-max Seat #1 is the button
Seat 1: 9lvO/qyU+xrU95Teu1fv0g ($4.65 in chips) 
Seat 2: Qduu7ikeizo6q6Ei9YvcJA ($24.75 in chips) 
Seat 3: IOx4EH8+y3jYZJc/LTRvOw ($22.40 in chips) 
Seat 4: VBHxUExRAMrbxUq/cVx9Gw ($4.95 in chips) 
Seat 5: 7cv+9Zc9HIQHNvYsMfV3uA ($25 in chips) 
Seat 6: 8EbrQ/EvFWt2cr0GaU82gQ ($4.65 in chips) 
Seat 7: DiSvPC2iudwL5j9u6Huyww ($25.45 in chips) 
Seat 8: RCqMONFrSPSArZh2Jsar/w ($34.10 in chips) 
Seat 9: /FE4MKSoQhXaDp4PBoLM2g ($15 in chips) 
Qduu7ikeizo6q6Ei9YvcJA: posts small blind $0.10
IOx4EH8+y3jYZJc/LTRvOw: posts big blind $0.25
/FE4MKSoQhXaDp4PBoLM2g: posts big blind $0.25
*** HOLE CARDS ***
7cv+9Zc9HIQHNvYsMfV3uA said, "nh"
VBHxUExRAMrbxUq/cVx9Gw: folds 
7cv+9Zc9HIQHNvYsMfV3uA: folds 
8EbrQ/EvFWt2cr0GaU82gQ: folds 
DiSvPC2iudwL5j9u6Huyww: calls $0.25
RCqMONFrSPSArZh2Jsar/w: folds 
/FE4MKSoQhXaDp4PBoLM2g: checks 
9lvO/qyU+xrU95Teu1fv0g: calls $0.25
Qduu7ikeizo6q6Ei9YvcJA: folds 
IOx4EH8+y3jYZJc/LTRvOw: raises $0.75 to $1
DiSvPC2iudwL5j9u6Huyww: calls $0.75
/FE4MKSoQhXaDp4PBoLM2g: folds 
9lvO/qyU+xrU95Teu1fv0g: folds 
*** FLOP *** [3d 5s 4h]
IOx4EH8+y3jYZJc/LTRvOw: bets $1.50
DiSvPC2iudwL5j9u6Huyww: calls $1.50
*** TURN *** [3d 5s 4h] [2s]
IOx4EH8+y3jYZJc/LTRvOw: bets $1.25
DiSvPC2iudwL5j9u6Huyww: folds 
Uncalled bet ($1.25) returned to IOx4EH8+y3jYZJc/LTRvOw
IOx4EH8+y3jYZJc/LTRvOw collected $5.35 from pot
*** SUMMARY ***
Total pot $5.60 | Rake $0.25 
Board [3d 5s 4h 2s]
Seat 1: 9lvO/qyU+xrU95Teu1fv0g (button) folded before Flop
Seat 2: Qduu7ikeizo6q6Ei9YvcJA (small blind) folded before Flop
Seat 3: IOx4EH8+y3jYZJc/LTRvOw (big blind) collected ($5.35)
Seat 4: VBHxUExRAMrbxUq/cVx9Gw folded before Flop (didn't bet)
Seat 5: 7cv+9Zc9HIQHNvYsMfV3uA folded before Flop (didn't bet)
Seat 6: 8EbrQ/EvFWt2cr0GaU82gQ folded before Flop (didn't bet)
Seat 7: DiSvPC2iudwL5j9u6Huyww folded on the Turn
Seat 8: RCqMONFrSPSArZh2Jsar/w folded before Flop (didn't bet)
Seat 9: /FE4MKSoQhXaDp4PBoLM2g folded before Flop




PokerStars Game #59941697010:  Hold'em No Limit ($0.10/$0.25) - 2009/07/01 1:43:18 ET
Table '9SExUHslNkrPJ4XsrePaVw' 9-max Seat #8 is the button
Seat 1: RHqgdFvufLCYe54+qd2gcA ($5 in chips) 
Seat 2: cZ99hugmLBj9KhTlc8nCSw ($44.85 in chips) 
Seat 3: EP17SQz/iWcuYdNOGeBgkw ($14.40 in chips) 
Seat 4: 4awUyiDYTgylQKXZ9faBVA ($25 in chips) 
Seat 5: L+eJnUyhY8bMNYw755K8XQ ($14.50 in chips) 
Seat 6: YPJ90cgNXDABdYJcqmwB0A ($20.95 in chips) 
Seat 7: 7cv+9Zc9HIQHNvYsMfV3uA ($29.20 in chips) 
Seat 8: tLcDklc2rBORNfixyRfVfw ($25 in chips) 
Seat 9: /THNzAxdv2lBxcf4XTj/0g ($7.35 in chips) 
/THNzAxdv2lBxcf4XTj/0g: posts small blind $0.10
RHqgdFvufLCYe54+qd2gcA: posts big blind $0.25
*** HOLE CARDS ***
cZ99hugmLBj9KhTlc8nCSw: folds 
EP17SQz/iWcuYdNOGeBgkw: folds 
4awUyiDYTgylQKXZ9faBVA: folds 
L+eJnUyhY8bMNYw755K8XQ: folds 
YPJ90cgNXDABdYJcqmwB0A: folds 
7cv+9Zc9HIQHNvYsMfV3uA: folds 
tLcDklc2rBORNfixyRfVfw: raises $0.50 to $0.75
/THNzAxdv2lBxcf4XTj/0g: folds 
RHqgdFvufLCYe54+qd2gcA: folds 
Uncalled bet ($0.50) returned to tLcDklc2rBORNfixyRfVfw
tLcDklc2rBORNfixyRfVfw collected $0.60 from pot
tLcDklc2rBORNfixyRfVfw: doesn't show hand 
*** SUMMARY ***
Total pot $0.60 | Rake $0 
Seat 1: RHqgdFvufLCYe54+qd2gcA (big blind) folded before Flop
Seat 2: cZ99hugmLBj9KhTlc8nCSw folded before Flop (didn't bet)
Seat 3: EP17SQz/iWcuYdNOGeBgkw folded before Flop (didn't bet)
Seat 4: 4awUyiDYTgylQKXZ9faBVA folded before Flop (didn't bet)
Seat 5: L+eJnUyhY8bMNYw755K8XQ folded before Flop (didn't bet)
Seat 6: YPJ90cgNXDABdYJcqmwB0A folded before Flop (didn't bet)
Seat 7: 7cv+9Zc9HIQHNvYsMfV3uA folded before Flop (didn't bet)
Seat 8: tLcDklc2rBORNfixyRfVfw (button) collected ($0.60)
Seat 9: /THNzAxdv2lBxcf4XTj/0g (small blind) folded before Flop




PokerStars Game #59941696936:  Hold'em No Limit ($0.10/$0.25) - 2009/07/01 1:43:18 ET
Table 'L5GvbdQO5aCZJSE6pyQ8OA' 6-max Seat #2 is the button
Seat 1: eFj4lr1nuXLyCWNTShr1bg ($10.75 in chips) 
Seat 2: DihMHaz4WNETH1bPDe13kA ($28.70 in chips) 
Seat 3: JFIAqU8lCZ0vWwEl4bdGsg ($28.05 in chips) 
Seat 4: trN/oHqTTbPw5MNuKrOpLw ($28.65 in chips) 
Seat 5: LyDHtw3/yniNHW+DvLXbog ($27 in chips) 
Seat 6: v+QfkGiuj9bgtuNoVnDO8w ($39.40 in chips) 
JFIAqU8lCZ0vWwEl4bdGsg: posts small blind $0.10
trN/oHqTTbPw5MNuKrOpLw: posts big blind $0.25
*** HOLE CARDS ***
LyDHtw3/yniNHW+DvLXbog: folds 
v+QfkGiuj9bgtuNoVnDO8w: folds 
eFj4lr1nuXLyCWNTShr1bg: raises $0.50 to $0.75
DihMHaz4WNETH1bPDe13kA: folds 
JFIAqU8lCZ0vWwEl4bdGsg: folds 
trN/oHqTTbPw5MNuKrOpLw: folds 
Uncalled bet ($0.50) returned to eFj4lr1nuXLyCWNTShr1bg
eFj4lr1nuXLyCWNTShr1bg collected $0.60 from pot
eFj4lr1nuXLyCWNTShr1bg: doesn't show hand 
*** SUMMARY ***
Total pot $0.60 | Rake $0 
Seat 1: eFj4lr1nuXLyCWNTShr1bg collected ($0.60)
Seat 2: DihMHaz4WNETH1bPDe13kA (button) folded before Flop (didn't bet)
Seat 3: JFIAqU8lCZ0vWwEl4bdGsg (small blind) folded before Flop
Seat 4: trN/oHqTTbPw5MNuKrOpLw (big blind) folded before Flop
Seat 5: LyDHtw3/yniNHW+DvLXbog folded before Flop (didn't bet)
Seat 6: v+QfkGiuj9bgtuNoVnDO8w folded before Flop (didn't bet)




PokerStars Game #59941697024:  Hold'em No Limit ($0.10/$0.25) - 2009/07/01 1:43:18 ET
Table 'l57rayEpPtZotP9nqgSWBg' 6-max Seat #3 is the button
Seat 1: DihMHaz4WNETH1bPDe13kA ($56.10 in chips) 
Seat 2: p6adJRMXMBLr+xtQzqazIQ ($15.55 in chips) 
Seat 3: L3/N/gliETan8N5Gim5h4Q ($25 in chips) 
Seat 4: OqkdGXy1SCzuN5Q0wNlFSg ($22.70 in chips) 
Seat 5: WKJHaZPUgrpTVyLOEjLYmg ($11.25 in chips) 
Seat 6: IGRfskE1v9H9Bn+fz8AgNQ ($17.05 in chips) 
OqkdGXy1SCzuN5Q0wNlFSg: posts small blind $0.10
WKJHaZPUgrpTVyLOEjLYmg: posts big blind $0.25
*** HOLE CARDS ***
IGRfskE1v9H9Bn+fz8AgNQ: folds 
DihMHaz4WNETH1bPDe13kA: folds 
p6adJRMXMBLr+xtQzqazIQ: folds 
L3/N/gliETan8N5Gim5h4Q: folds 
OqkdGXy1SCzuN5Q0wNlFSg: folds 
Uncalled bet ($0.15) returned to WKJHaZPUgrpTVyLOEjLYmg
WKJHaZPUgrpTVyLOEjLYmg collected $0.20 from pot
*** SUMMARY ***
Total pot $0.20 | Rake $0 
Seat 1: DihMHaz4WNETH1bPDe13kA folded before Flop (didn't bet)
Seat 2: p6adJRMXMBLr+xtQzqazIQ folded before Flop (didn't bet)
Seat 3: L3/N/gliETan8N5Gim5h4Q (button) folded before Flop (didn't bet)
Seat 4: OqkdGXy1SCzuN5Q0wNlFSg (small blind) folded before Flop
Seat 5: WKJHaZPUgrpTVyLOEjLYmg (big blind) collected ($0.20)
Seat 6: IGRfskE1v9H9Bn+fz8AgNQ folded before Flop (didn't bet)




PokerStars Game #59941697456:  Hold'em No Limit ($0.10/$0.25) - 2009/07/01 1:43:19 ET
Table 'ZEXL6Wh4qA4Afx8NnoBBAA' 6-max Seat #4 is the button
Seat 1: v8m8XHovI5tqEA9mvplDSw ($27.60 in chips) 
Seat 2: 6DwBRH+xZ12AAZmeAg+aXw ($33.75 in chips) 
Seat 3: +ZlnqPoP3Hg4BIUxDfKd/A ($32.05 in chips) 
Seat 4: FpN4KbLjlyRRKiVaQcoLqA ($29.60 in chips) 
Seat 5: if4dh6jhJXeN3/qd3qCp9g ($26.75 in chips) 
Seat 6: Lh8SlCq3OSDKWLUgAI/Lxw ($2.35 in chips) 
if4dh6jhJXeN3/qd3qCp9g: posts small blind $0.10
Lh8SlCq3OSDKWLUgAI/Lxw: posts big blind $0.25
*** HOLE CARDS ***
v8m8XHovI5tqEA9mvplDSw: folds 
6DwBRH+xZ12AAZmeAg+aXw: raises $0.50 to $0.75
+ZlnqPoP3Hg4BIUxDfKd/A: folds 
FpN4KbLjlyRRKiVaQcoLqA: folds 
if4dh6jhJXeN3/qd3qCp9g: calls $0.65
Lh8SlCq3OSDKWLUgAI/Lxw: folds 
*** FLOP *** [2c 3c 8d]
if4dh6jhJXeN3/qd3qCp9g: bets $1
6DwBRH+xZ12AAZmeAg+aXw: raises $2 to $3
if4dh6jhJXeN3/qd3qCp9g: calls $2
*** TURN *** [2c 3c 8d] [Js]
if4dh6jhJXeN3/qd3qCp9g: checks 
6DwBRH+xZ12AAZmeAg+aXw: checks 
*** RIVER *** [2c 3c 8d Js] [5s]
if4dh6jhJXeN3/qd3qCp9g: bets $6
6DwBRH+xZ12AAZmeAg+aXw: calls $6
*** SHOW DOWN ***
if4dh6jhJXeN3/qd3qCp9g: shows [3h 3d] (three of a kind, Threes)
6DwBRH+xZ12AAZmeAg+aXw: mucks hand 
if4dh6jhJXeN3/qd3qCp9g collected $18.80 from pot
*** SUMMARY ***
Total pot $19.75 | Rake $0.95 
Board [2c 3c 8d Js 5s]
Seat 1: v8m8XHovI5tqEA9mvplDSw folded before Flop (didn't bet)
Seat 2: 6DwBRH+xZ12AAZmeAg+aXw mucked
Seat 3: +ZlnqPoP3Hg4BIUxDfKd/A folded before Flop (didn't bet)
Seat 4: FpN4KbLjlyRRKiVaQcoLqA (button) folded before Flop (didn't bet)
Seat 5: if4dh6jhJXeN3/qd3qCp9g (small blind) showed [3h 3d] and won ($18.80) with three of a kind, Threes
Seat 6: Lh8SlCq3OSDKWLUgAI/Lxw (big blind) folded before Flop




PokerStars Game #59941697834:  Hold'em No Limit ($0.10/$0.25) - 2009/07/01 1:43:19 ET
Table 'WEMI3Mtn7dGARDbgNrKibgQvLFJzpzymuOsaaRYi+8fgx Seat #8 is the button
Seat 1: cZ99hugmLBj9KhTlc8nCSw ($25 in chips) 
Seat 2: PdIasPkzm2sqZnN41ZRXOg ($5 in chips) 
Seat 4: tLcDklc2rBORNfixyRfVfw ($25.60 in chips) 
Seat 5: MG90wfSJZnOejs/KD3vlQQ ($36.75 in chips) 
Seat 7: rQhYIYXSyH/IivYM1dlV5A ($11.20 in chips) 
Seat 8: gehe91e0IyVT0QU/XBkEyg ($26.40 in chips) 
Seat 9: BWzInv8o0kN1pJybv/VjpQ ($43.85 in chips) 
BWzInv8o0kN1pJybv/VjpQ: posts small blind $0.10
cZ99hugmLBj9KhTlc8nCSw: posts big blind $0.25
Qduu7ikeizo6q6Ei9YvcJA: sits out 
*** HOLE CARDS ***
PdIasPkzm2sqZnN41ZRXOg: folds 
tLcDklc2rBORNfixyRfVfw: folds 
MG90wfSJZnOejs/KD3vlQQ: folds 
vKdukiQ4ktU4yJ0Xx3MKnA joins the table at seat #6 
rQhYIYXSyH/IivYM1dlV5A: folds 
gehe91e0IyVT0QU/XBkEyg: raises $0.75 to $1
BWzInv8o0kN1pJybv/VjpQ: folds 
cZ99hugmLBj9KhTlc8nCSw: folds 
Uncalled bet ($0.75) returned to gehe91e0IyVT0QU/XBkEyg
gehe91e0IyVT0QU/XBkEyg collected $0.60 from pot
*** SUMMARY ***
Total pot $0.60 | Rake $0 
Seat 1: cZ99hugmLBj9KhTlc8nCSw (big blind) folded before Flop
Seat 2: PdIasPkzm2sqZnN41ZRXOg folded before Flop (didn't bet)
Seat 4: tLcDklc2rBORNfixyRfVfw folded before Flop (didn't bet)
Seat 5: MG90wfSJZnOejs/KD3vlQQ folded before Flop (didn't bet)
Seat 7: rQhYIYXSyH/IivYM1dlV5A folded before Flop (didn't bet)
Seat 8: gehe91e0IyVT0QU/XBkEyg (button) collected ($0.60)
Seat 9: BWzInv8o0kN1pJybv/VjpQ (small blind) folded before Flop




PokerStars Game #59941697702:  Hold'em No Limit ($0.10/$0.25) - 2009/07/01 1:43:19 ET
Table 'KYX9dFNuOA9l2PV46IebqQ' 9-max Seat #2 is the button
Seat 2: z2SmIaQ3+5n/eY1BN5HgPg ($5.90 in chips) 
Seat 4: rPXwQUVloUl+qZm3CCtaJw ($9.40 in chips) 
Seat 5: g7MXhRmNZxv1lIkKkUKa4w ($13.60 in chips) 
rPXwQUVloUl+qZm3CCtaJw: posts small blind $0.10
g7MXhRmNZxv1lIkKkUKa4w: posts big blind $0.25
KRWTiGM4xH+MkvPtJz4+SA: sits out 
*** HOLE CARDS ***
Uq3NSX4cIFaXe7pbXQuU+Q joins the table at seat #3 
z2SmIaQ3+5n/eY1BN5HgPg: raises $0.75 to $1
rPXwQUVloUl+qZm3CCtaJw: folds 
g7MXhRmNZxv1lIkKkUKa4w: folds 
Uncalled bet ($0.75) returned to z2SmIaQ3+5n/eY1BN5HgPg
z2SmIaQ3+5n/eY1BN5HgPg collected $0.60 from pot
*** SUMMARY ***
Total pot $0.60 | Rake $0 
Seat 2: z2SmIaQ3+5n/eY1BN5HgPg (button) collected ($0.60)
Seat 4: rPXwQUVloUl+qZm3CCtaJw (small blind) folded before Flop
Seat 5: g7MXhRmNZxv1lIkKkUKa4w (big blind) folded before Flop




PokerStars Game #59941697494:  Hold'em No Limit ($0.10/$0.25) - 2009/07/01 1:43:19 ET
Table 'i8VqsSY3xDtJ63IHleN8+A' 9-max Seat #3 is the button
Seat 3: 4awUyiDYTgylQKXZ9faBVA ($29.25 in chips) 
Seat 5: +E5iJKkKVfaTgTqzuXXv0g ($15 in chips) 
4awUyiDYTgylQKXZ9faBVA: posts small blind $0.10
+E5iJKkKVfaTgTqzuXXv0g: posts big blind $0.25
*** HOLE CARDS ***
4awUyiDYTgylQKXZ9faBVA: raises $0.75 to $1
+E5iJKkKVfaTgTqzuXXv0g: folds 
Uncalled bet ($0.75) returned to 4awUyiDYTgylQKXZ9faBVA
4awUyiDYTgylQKXZ9faBVA collected $0.50 from pot
4awUyiDYTgylQKXZ9faBVA: doesn't show hand 
*** SUMMARY ***
Total pot $0.50 | Rake $0 
Seat 3: 4awUyiDYTgylQKXZ9faBVA (button) (small blind) collected ($0.50)
Seat 5: +E5iJKkKVfaTgTqzuXXv0g (big blind) folded before Flop




PokerStars Game #59941697608:  Hold'em No Limit ($0.10/$0.25) - 2009/07/01 1:43:19 ET
Table 'C8mMnVmvkagwolEzTvh07A' 9-max Seat #5 is the button
Seat 1: PqvgxdSg9z5VmrWpbYuz+g ($25.70 in chips) 
Seat 2: Bb42QRQMhg5/Y0vHP8/2Xw ($25 in chips) 
Seat 3: Th3FldXKQW6hWVVPahaoOQ ($35.35 in chips) 
Seat 4: dfNim92Z6XK1/h5SFW5vDg ($25 in chips) 
Seat 5: iGMlK+EhUflPB6jKQd95Cg ($27.50 in chips) 
Seat 6: AiXn/9o1EwOPZUHujnh/bA ($18.75 in chips) 
Seat 7: qmEgnPhQt24xdw/ZRVPLbA ($48 in chips) 
Seat 9: 4awUyiDYTgylQKXZ9faBVA ($25 in chips) 
AiXn/9o1EwOPZUHujnh/bA: posts small blind $0.10
qmEgnPhQt24xdw/ZRVPLbA: posts big blind $0.25
*** HOLE CARDS ***
4awUyiDYTgylQKXZ9faBVA: folds 
PqvgxdSg9z5VmrWpbYuz+g: calls $0.25
Bb42QRQMhg5/Y0vHP8/2Xw: folds 
Th3FldXKQW6hWVVPahaoOQ: folds 
dfNim92Z6XK1/h5SFW5vDg: folds 
iGMlK+EhUflPB6jKQd95Cg: folds 
AiXn/9o1EwOPZUHujnh/bA: calls $0.15
qmEgnPhQt24xdw/ZRVPLbA: checks 
*** FLOP *** [7s Jh 3c]
AiXn/9o1EwOPZUHujnh/bA: checks 
qmEgnPhQt24xdw/ZRVPLbA: checks 
PqvgxdSg9z5VmrWpbYuz+g: bets $0.75
AiXn/9o1EwOPZUHujnh/bA: folds 
qmEgnPhQt24xdw/ZRVPLbA: calls $0.75
*** TURN *** [7s Jh 3c] [Ts]
qmEgnPhQt24xdw/ZRVPLbA: checks 
PqvgxdSg9z5VmrWpbYuz+g: bets $1
qmEgnPhQt24xdw/ZRVPLbA: calls $1
*** RIVER *** [7s Jh 3c Ts] [Qh]
qmEgnPhQt24xdw/ZRVPLbA: checks 
PqvgxdSg9z5VmrWpbYuz+g: checks 
*** SHOW DOWN ***
qmEgnPhQt24xdw/ZRVPLbA: shows [7d 8s] (a pair of Sevens)
PqvgxdSg9z5VmrWpbYuz+g: shows [Jd 9c] (a pair of Jacks)
PqvgxdSg9z5VmrWpbYuz+g collected $4.05 from pot
*** SUMMARY ***
Total pot $4.25 | Rake $0.20 
Board [7s Jh 3c Ts Qh]
Seat 1: PqvgxdSg9z5VmrWpbYuz+g showed [Jd 9c] and won ($4.05) with a pair of Jacks
Seat 2: Bb42QRQMhg5/Y0vHP8/2Xw folded before Flop (didn't bet)
Seat 3: Th3FldXKQW6hWVVPahaoOQ folded before Flop (didn't bet)
Seat 4: dfNim92Z6XK1/h5SFW5vDg folded before Flop (didn't bet)
Seat 5: iGMlK+EhUflPB6jKQd95Cg (button) folded before Flop (didn't bet)
Seat 6: AiXn/9o1EwOPZUHujnh/bA (small blind) folded on the Flop
Seat 7: qmEgnPhQt24xdw/ZRVPLbA (big blind) showed [7d 8s] and lost with a pair of Sevens
Seat 9: 4awUyiDYTgylQKXZ9faBVA folded before Flop (didn't bet)




PokerStars Game #59941697664:  Hold'em No Limit ($0.10/$0.25) - 2009/07/01 1:43:19 ET
Table '2AUmC2Rslg+QUbLfdgNdfg' 6-max Seat #3 is the button
Seat 1: YDXAegrCnzc0l6TSDNboXQ ($26.50 in chips) 
Seat 2: PLksyNlTVRVZwxJVC2/1eA ($22.50 in chips) 
Seat 3: JFIAqU8lCZ0vWwEl4bdGsg ($25.35 in chips) 
Seat 4: lquriepNQBhDV5P1SWHhnA ($26.35 in chips) 
Seat 6: xBWc54v+UTSJOiKpbAbJWg ($10.85 in chips) 
lquriepNQBhDV5P1SWHhnA: posts small blind $0.10
AMc4cCwUJhokdGRYIaVPhQ has timed out
AMc4cCwUJhokdGRYIaVPhQ: is sitting out 
xBWc54v+UTSJOiKpbAbJWg: posts big blind $0.25
*** HOLE CARDS ***
YDXAegrCnzc0l6TSDNboXQ: folds 
PLksyNlTVRVZwxJVC2/1eA: folds 
JFIAqU8lCZ0vWwEl4bdGsg: raises $0.60 to $0.85
lquriepNQBhDV5P1SWHhnA: folds 
xBWc54v+UTSJOiKpbAbJWg: folds 
Uncalled bet ($0.60) returned to JFIAqU8lCZ0vWwEl4bdGsg
JFIAqU8lCZ0vWwEl4bdGsg collected $0.60 from pot
JFIAqU8lCZ0vWwEl4bdGsg: doesn't show hand 
*** SUMMARY ***
Total pot $0.60 | Rake $0 
Seat 1: YDXAegrCnzc0l6TSDNboXQ folded before Flop (didn't bet)
Seat 2: PLksyNlTVRVZwxJVC2/1eA folded before Flop (didn't bet)
Seat 3: JFIAqU8lCZ0vWwEl4bdGsg (button) collected ($0.60)
Seat 4: lquriepNQBhDV5P1SWHhnA (small blind) folded before Flop
Seat 6: xBWc54v+UTSJOiKpbAbJWg (big blind) folded before Flop




PokerStars Game #59941697476:  Hold'em No Limit ($0.10/$0.25) - 2009/07/01 1:43:19 ET
Table '/JJyyIstHfkT7t/bW+WXgg' 6-max Seat #6 is the button
Seat 2: obJgSnVgWWWaAUtVILo77Q ($15.90 in chips) 
Seat 3: DR0nVIhVP77oEBlO9J8vlg ($37.50 in chips) 
Seat 4: JFIAqU8lCZ0vWwEl4bdGsg ($35.40 in chips) 
Seat 5: +ZlnqPoP3Hg4BIUxDfKd/A ($48.15 in chips) 
Seat 6: UmcUp27+PbgBItv3ZNlAWQ ($25 in chips) 
obJgSnVgWWWaAUtVILo77Q: posts small blind $0.10
DR0nVIhVP77oEBlO9J8vlg: posts big blind $0.25
*** HOLE CARDS ***
JFIAqU8lCZ0vWwEl4bdGsg: folds 
+ZlnqPoP3Hg4BIUxDfKd/A: folds 
UmcUp27+PbgBItv3ZNlAWQ: folds 
obJgSnVgWWWaAUtVILo77Q: raises $0.75 to $1
DR0nVIhVP77oEBlO9J8vlg: calls $0.75
*** FLOP *** [7s Ad Td]
obJgSnVgWWWaAUtVILo77Q: checks 
DR0nVIhVP77oEBlO9J8vlg: checks 
*** TURN *** [7s Ad Td] [8h]
obJgSnVgWWWaAUtVILo77Q: bets $0.75
DR0nVIhVP77oEBlO9J8vlg: calls $0.75
*** RIVER *** [7s Ad Td 8h] [6d]
obJgSnVgWWWaAUtVILo77Q: checks 
DR0nVIhVP77oEBlO9J8vlg: bets $1
obJgSnVgWWWaAUtVILo77Q: calls $1
*** SHOW DOWN ***
DR0nVIhVP77oEBlO9J8vlg: shows [Ts Qs] (a pair of Tens)
obJgSnVgWWWaAUtVILo77Q: shows [Qh Qd] (a pair of Queens)
obJgSnVgWWWaAUtVILo77Q collected $5.25 from pot
*** SUMMARY ***
Total pot $5.50 | Rake $0.25 
Board [7s Ad Td 8h 6d]
Seat 2: obJgSnVgWWWaAUtVILo77Q (small blind) showed [Qh Qd] and won ($5.25) with a pair of Queens
Seat 3: DR0nVIhVP77oEBlO9J8vlg (big blind) showed [Ts Qs] and lost with a pair of Tens
Seat 4: JFIAqU8lCZ0vWwEl4bdGsg folded before Flop (didn't bet)
Seat 5: +ZlnqPoP3Hg4BIUxDfKd/A folded before Flop (didn't bet)
Seat 6: UmcUp27+PbgBItv3ZNlAWQ (button) folded before Flop (didn't bet)




PokerStars Game #59941697454:  Hold'em No Limit ($0.10/$0.25) - 2009/07/01 1:43:19 ET
Table '2clPgY3+dETPD/8zjXZdFw' 6-max Seat #2 is the button
Seat 1: 4WFKzsjLSGnvHbVxKabsvQ ($31.05 in chips) 
Seat 2: cWc85bEzdRzpUMhRKm8pwQ ($25.70 in chips) 
Seat 3: SFmT9ZsVopnukjvAzrxTRg ($25 in chips) 
Seat 4: ljjhtb6FVPTx9AT9HNdtqg ($25 in chips) 
Seat 5: LJI7A1YgDM7hgh7o56+ReQ ($25.60 in chips) 
SFmT9ZsVopnukjvAzrxTRg: posts small blind $0.10
ljjhtb6FVPTx9AT9HNdtqg: posts big blind $0.25
*** HOLE CARDS ***
LJI7A1YgDM7hgh7o56+ReQ: folds 
4WFKzsjLSGnvHbVxKabsvQ: folds 
cWc85bEzdRzpUMhRKm8pwQ: folds 
SFmT9ZsVopnukjvAzrxTRg: folds 
Uncalled bet ($0.15) returned to ljjhtb6FVPTx9AT9HNdtqg
ljjhtb6FVPTx9AT9HNdtqg collected $0.20 from pot
*** SUMMARY ***
Total pot $0.20 | Rake $0 
Seat 1: 4WFKzsjLSGnvHbVxKabsvQ folded before Flop (didn't bet)
Seat 2: cWc85bEzdRzpUMhRKm8pwQ (button) folded before Flop (didn't bet)
Seat 3: SFmT9ZsVopnukjvAzrxTRg (small blind) folded before Flop
Seat 4: ljjhtb6FVPTx9AT9HNdtqg (big blind) collected ($0.20)
Seat 5: LJI7A1YgDM7hgh7o56+ReQ folded before Flop (didn't bet)




PokerStars Game #59941698230:  Hold'em No Limit ($0.10/$0.25) - 2009/07/01 1:43:20 ET
Table '1HT8bEDpLPhOXxmqMtzF8w' 9-max Seat #5 is the button
Seat 1: YkkKQUDI0iWatY4h0WWaAQ ($10.95 in chips) 
Seat 2: r6hsffOo1iKmaPYKwAZmFw ($29 in chips) 
Seat 3: oLa/tXLfSLLB28mcLGrxcg ($24.75 in chips) 
Seat 4: aNpwfA31EREwO+ar4XzBCw ($25 in chips) 
Seat 5: CT2YIt3dXaE9eOIkS7FwNw ($24.30 in chips) 
Seat 6: bXpVeaSTPBFSPJmeXxO7nw ($5.35 in chips) 
Seat 7: PMhmqYBPHOAXjH25lRz69g ($18.30 in chips) 
Seat 8: ghNKXUBl/H+t83JF079ZBA ($32.10 in chips) 
bXpVeaSTPBFSPJmeXxO7nw: posts small blind $0.10
PMhmqYBPHOAXjH25lRz69g: posts big blind $0.25
Z9W7+g1WMhhZDi7DwGbCFA: sits out 
*** HOLE CARDS ***
ghNKXUBl/H+t83JF079ZBA: folds 
YkkKQUDI0iWatY4h0WWaAQ: calls $0.25
r6hsffOo1iKmaPYKwAZmFw: folds 
oLa/tXLfSLLB28mcLGrxcg: folds 
aNpwfA31EREwO+ar4XzBCw: folds 
CT2YIt3dXaE9eOIkS7FwNw: raises $0.50 to $0.75
bXpVeaSTPBFSPJmeXxO7nw: folds 
PMhmqYBPHOAXjH25lRz69g: folds 
YkkKQUDI0iWatY4h0WWaAQ: calls $0.50
*** FLOP *** [9d 7h Js]
YkkKQUDI0iWatY4h0WWaAQ: checks 
CT2YIt3dXaE9eOIkS7FwNw: bets $1
YkkKQUDI0iWatY4h0WWaAQ: calls $1
*** TURN *** [9d 7h Js] [As]
YkkKQUDI0iWatY4h0WWaAQ: checks 
CT2YIt3dXaE9eOIkS7FwNw: checks 
*** RIVER *** [9d 7h Js As] [5c]
YkkKQUDI0iWatY4h0WWaAQ: checks 
CT2YIt3dXaE9eOIkS7FwNw: checks 
*** SHOW DOWN ***
YkkKQUDI0iWatY4h0WWaAQ: shows [Kc Jc] (a pair of Jacks)
CT2YIt3dXaE9eOIkS7FwNw: mucks hand 
YkkKQUDI0iWatY4h0WWaAQ collected $3.70 from pot
*** SUMMARY ***
Total pot $3.85 | Rake $0.15 
Board [9d 7h Js As 5c]
Seat 1: YkkKQUDI0iWatY4h0WWaAQ showed [Kc Jc] and won ($3.70) with a pair of Jacks
Seat 2: r6hsffOo1iKmaPYKwAZmFw folded before Flop (didn't bet)
Seat 3: oLa/tXLfSLLB28mcLGrxcg folded before Flop (didn't bet)
Seat 4: aNpwfA31EREwO+ar4XzBCw folded before Flop (didn't bet)
Seat 5: CT2YIt3dXaE9eOIkS7FwNw (button) mucked
Seat 6: bXpVeaSTPBFSPJmeXxO7nw (small blind) folded before Flop
Seat 7: PMhmqYBPHOAXjH25lRz69g (big blind) folded before Flop
Seat 8: ghNKXUBl/H+t83JF079ZBA folded before Flop (didn't bet)




PokerStars Game #59941698018:  Hold'em No Limit ($0.10/$0.25) - 2009/07/01 1:43:20 ET
Table 'qryc9C/ELyQ3lubOaELNAQ' 6-max Seat #6 is the button
Seat 1: OZc6kkoTwtITj1ZfreJK1A ($61.55 in chips) 
Seat 2: LtASJ9OlkqGrrUKGQlpGAw ($30.80 in chips) 
Seat 4: v+QfkGiuj9bgtuNoVnDO8w ($25.05 in chips) 
Seat 5: 9StOHp+Y1T0K13JdgS2oQQ ($36.60 in chips) 
Seat 6: u+J1MTXS2qhNVMbsBemNLg ($4.05 in chips) 
OZc6kkoTwtITj1ZfreJK1A: posts small blind $0.10
LtASJ9OlkqGrrUKGQlpGAw: posts big blind $0.25
wvIIdlbCgePONQwXjx9xzQ: sits out 
*** HOLE CARDS ***
v+QfkGiuj9bgtuNoVnDO8w: folds 
9StOHp+Y1T0K13JdgS2oQQ: folds 
u+J1MTXS2qhNVMbsBemNLg: calls $0.25
OZc6kkoTwtITj1ZfreJK1A: calls $0.15
LtASJ9OlkqGrrUKGQlpGAw: checks 
*** FLOP *** [6c 9h 7h]
OZc6kkoTwtITj1ZfreJK1A: checks 
LtASJ9OlkqGrrUKGQlpGAw: checks 
u+J1MTXS2qhNVMbsBemNLg: checks 
*** TURN *** [6c 9h 7h] [Jc]
OZc6kkoTwtITj1ZfreJK1A: bets $0.25
LtASJ9OlkqGrrUKGQlpGAw: calls $0.25
u+J1MTXS2qhNVMbsBemNLg: raises $0.25 to $0.50
OZc6kkoTwtITj1ZfreJK1A: calls $0.25
LtASJ9OlkqGrrUKGQlpGAw: calls $0.25
*** RIVER *** [6c 9h 7h Jc] [6d]
OZc6kkoTwtITj1ZfreJK1A: bets $5.75
LtASJ9OlkqGrrUKGQlpGAw: folds 
u+J1MTXS2qhNVMbsBemNLg: calls $3.30 and is all-in
Uncalled bet ($2.45) returned to OZc6kkoTwtITj1ZfreJK1A
*** SHOW DOWN ***
OZc6kkoTwtITj1ZfreJK1A: shows [8d 5h] (a straight, Five to Nine)
u+J1MTXS2qhNVMbsBemNLg: mucks hand 
OZc6kkoTwtITj1ZfreJK1A collected $8.45 from pot
*** SUMMARY ***
Total pot $8.85 | Rake $0.40 
Board [6c 9h 7h Jc 6d]
Seat 1: OZc6kkoTwtITj1ZfreJK1A (small blind) showed [8d 5h] and won ($8.45) with a straight, Five to Nine
Seat 2: LtASJ9OlkqGrrUKGQlpGAw (big blind) folded on the River
Seat 4: v+QfkGiuj9bgtuNoVnDO8w folded before Flop (didn't bet)
Seat 5: 9StOHp+Y1T0K13JdgS2oQQ folded before Flop (didn't bet)
Seat 6: u+J1MTXS2qhNVMbsBemNLg (button) mucked




PokerStars Game #59941697974:  Hold'em No Limit ($0.10/$0.25) - 2009/07/01 1:43:20 ET
Table 'G+4ZdyRoPjgaJY/jxSlZzQ' 9-max Seat #7 is the button
Seat 1: ghNKXUBl/H+t83JF079ZBA ($23.40 in chips) 
Seat 2: CT7Xj/V/O5rBlhtt+RZeFQ ($25 in chips) 
Seat 3: FaGtAm5QUVcixGhAKIvbLg ($15.60 in chips) 
Seat 4: lSeLm4BdnSMLtIli62qjAQ ($10.65 in chips) 
Seat 5: BT6Oal0iO4P6kDuT7HFQDw ($17.10 in chips) 
Seat 6: oFwaTjy3ok/+qFghsrcGvg ($23.30 in chips) 
Seat 7: IK3/w7XV7rd8mVIsuasjYA ($2 in chips) 
Seat 8: bXpVeaSTPBFSPJmeXxO7nw ($4.75 in chips) 
Seat 9: tLcDklc2rBORNfixyRfVfw ($25 in chips) 
bXpVeaSTPBFSPJmeXxO7nw: posts small blind $0.10
tLcDklc2rBORNfixyRfVfw: posts big blind $0.25
*** HOLE CARDS ***
ghNKXUBl/H+t83JF079ZBA: folds 
CT7Xj/V/O5rBlhtt+RZeFQ: folds 
FaGtAm5QUVcixGhAKIvbLg: folds 
lSeLm4BdnSMLtIli62qjAQ: folds 
BT6Oal0iO4P6kDuT7HFQDw: raises $0.50 to $0.75
oFwaTjy3ok/+qFghsrcGvg: folds 
IK3/w7XV7rd8mVIsuasjYA: folds 
bXpVeaSTPBFSPJmeXxO7nw: folds 
tLcDklc2rBORNfixyRfVfw: folds 
Uncalled bet ($0.50) returned to BT6Oal0iO4P6kDuT7HFQDw
BT6Oal0iO4P6kDuT7HFQDw collected $0.60 from pot
BT6Oal0iO4P6kDuT7HFQDw: doesn't show hand 
*** SUMMARY ***
Total pot $0.60 | Rake $0 
Seat 1: ghNKXUBl/H+t83JF079ZBA folded before Flop (didn't bet)
Seat 2: CT7Xj/V/O5rBlhtt+RZeFQ folded before Flop (didn't bet)
Seat 3: FaGtAm5QUVcixGhAKIvbLg folded before Flop (didn't bet)
Seat 4: lSeLm4BdnSMLtIli62qjAQ folded before Flop (didn't bet)
Seat 5: BT6Oal0iO4P6kDuT7HFQDw collected ($0.60)
Seat 6: oFwaTjy3ok/+qFghsrcGvg folded before Flop (didn't bet)
Seat 7: IK3/w7XV7rd8mVIsuasjYA (button) folded before Flop (didn't bet)
Seat 8: bXpVeaSTPBFSPJmeXxO7nw (small blind) folded before Flop
Seat 9: tLcDklc2rBORNfixyRfVfw (big blind) folded before Flop




PokerStars Game #59941698148:  Hold'em No Limit ($0.10/$0.25) - 2009/07/01 1:43:20 ET
Table 'sSe6q4YTb/iS19t2eCFdsA' 9-max Seat #9 is the button
Seat 1: hJ4uYjNmSZdjrKA8cjZqCA ($19.25 in chips) 
Seat 2: 3l+i+xMeyDndSXMF2A5CDA ($5 in chips) 
Seat 3: bXpVeaSTPBFSPJmeXxO7nw ($5.65 in chips) 
Seat 4: 22dIObOuor/A+IKWkNoAlA ($8.85 in chips) 
Seat 5: qS+jfnNoG75bT+uQ8CKhQA ($10.05 in chips) 
Seat 6: tYsOBqdU1+x+yFI7zHO7hQ ($27.35 in chips) 
Seat 7: t70KGeRtR3naHSqKDixsUg ($4 in chips) 
Seat 8: hvXZ0zFPZFP8Hf6dS36YEw ($15.40 in chips) 
Seat 9: Z9W7+g1WMhhZDi7DwGbCFA ($5 in chips) 
hJ4uYjNmSZdjrKA8cjZqCA: posts small blind $0.10
3l+i+xMeyDndSXMF2A5CDA: posts big blind $0.25
*** HOLE CARDS ***
bXpVeaSTPBFSPJmeXxO7nw: folds 
22dIObOuor/A+IKWkNoAlA: folds 
qS+jfnNoG75bT+uQ8CKhQA: folds 
tYsOBqdU1+x+yFI7zHO7hQ: folds 
t70KGeRtR3naHSqKDixsUg: folds 
hvXZ0zFPZFP8Hf6dS36YEw: folds 
Z9W7+g1WMhhZDi7DwGbCFA: folds 
hJ4uYjNmSZdjrKA8cjZqCA: calls $0.15
3l+i+xMeyDndSXMF2A5CDA: checks 
*** FLOP *** [Td 8c 6d]
hJ4uYjNmSZdjrKA8cjZqCA: checks 
3l+i+xMeyDndSXMF2A5CDA: checks 
*** TURN *** [Td 8c 6d] [5c]
hJ4uYjNmSZdjrKA8cjZqCA: bets $0.50
3l+i+xMeyDndSXMF2A5CDA: folds 
Uncalled bet ($0.50) returned to hJ4uYjNmSZdjrKA8cjZqCA
hJ4uYjNmSZdjrKA8cjZqCA collected $0.50 from pot
*** SUMMARY ***
Total pot $0.50 | Rake $0 
Board [Td 8c 6d 5c]
Seat 1: hJ4uYjNmSZdjrKA8cjZqCA (small blind) collected ($0.50)
Seat 2: 3l+i+xMeyDndSXMF2A5CDA (big blind) folded on the Turn
Seat 3: bXpVeaSTPBFSPJmeXxO7nw folded before Flop (didn't bet)
Seat 4: 22dIObOuor/A+IKWkNoAlA folded before Flop (didn't bet)
Seat 5: qS+jfnNoG75bT+uQ8CKhQA folded before Flop (didn't bet)
Seat 6: tYsOBqdU1+x+yFI7zHO7hQ folded before Flop (didn't bet)
Seat 7: t70KGeRtR3naHSqKDixsUg folded before Flop (didn't bet)
Seat 8: hvXZ0zFPZFP8Hf6dS36YEw folded before Flop (didn't bet)
Seat 9: Z9W7+g1WMhhZDi7DwGbCFA (button) folded before Flop (didn't bet)




PokerStars Game #59941698320:  Hold'em No Limit ($0.10/$0.25) - 2009/07/01 1:43:20 ET
Table 'UVjmXTtsmlX1HxwwZ59akg' 9-max Seat #3 is the button
Seat 2: q+Qdg0Hoir+SyL7haBrUnw ($8.05 in chips) 
Seat 3: GmzfAfxcxu1kGbPC+9LkVg ($24.65 in chips) 
Seat 4: X78b5v/uhqeXXoAijbw/yg ($25 in chips) 
Seat 5: Bb42QRQMhg5/Y0vHP8/2Xw ($39.95 in chips) 
Seat 6: st9jtdNbm1W5GfBwRaCVqQ ($24.30 in chips) 
Seat 7: pB8IyCfDFZaVpov3NHEVJg ($25.25 in chips) 
Seat 8: aqxuKnMZWHy08QjWq1+MrQ ($2.75 in chips) 
X78b5v/uhqeXXoAijbw/yg: posts small blind $0.10
Bb42QRQMhg5/Y0vHP8/2Xw: posts big blind $0.25
ljemhp25Zg+nlA9DLCIiUw: sits out 
*** HOLE CARDS ***
st9jtdNbm1W5GfBwRaCVqQ: folds 
pB8IyCfDFZaVpov3NHEVJg: folds 
aqxuKnMZWHy08QjWq1+MrQ: folds 
q+Qdg0Hoir+SyL7haBrUnw: folds 
GmzfAfxcxu1kGbPC+9LkVg: folds 
X78b5v/uhqeXXoAijbw/yg: folds 
Uncalled bet ($0.15) returned to Bb42QRQMhg5/Y0vHP8/2Xw
Bb42QRQMhg5/Y0vHP8/2Xw collected $0.20 from pot
*** SUMMARY ***
Total pot $0.20 | Rake $0 
Seat 2: q+Qdg0Hoir+SyL7haBrUnw folded before Flop (didn't bet)
Seat 3: GmzfAfxcxu1kGbPC+9LkVg (button) folded before Flop (didn't bet)
Seat 4: X78b5v/uhqeXXoAijbw/yg (small blind) folded before Flop
Seat 5: Bb42QRQMhg5/Y0vHP8/2Xw (big blind) collected ($0.20)
Seat 6: st9jtdNbm1W5GfBwRaCVqQ folded before Flop (didn't bet)
Seat 7: pB8IyCfDFZaVpov3NHEVJg folded before Flop (didn't bet)
Seat 8: aqxuKnMZWHy08QjWq1+MrQ folded before Flop (didn't bet)




PokerStars Game #59941698004:  Hold'em No Limit ($0.10/$0.25) - 2009/07/01 1:43:20 ET
Table 'O6cwjhrMn9pfzx1Ngn5zkQ' 6-max Seat #2 is the button
Seat 1: LJI7A1YgDM7hgh7o56+ReQ ($30.55 in chips) 
Seat 2: tSR4329m40dZsN7YOpI9Kw ($29.35 in chips) 
Seat 3: EE16Ua5b1HSsYej5zeXOlA ($25.55 in chips) 
Seat 4: mfrkWA3PTeYPkbO6hi98Aw ($24.30 in chips) 
Seat 5: niLn0xUVlqh8If80xRjzCA ($26.35 in chips) 
Seat 6: 4TM16KVgEiQpLi4bVVWbVQ ($31.65 in chips) 
EE16Ua5b1HSsYej5zeXOlA: posts small blind $0.10
mfrkWA3PTeYPkbO6hi98Aw: posts big blind $0.25
*** HOLE CARDS ***
niLn0xUVlqh8If80xRjzCA: calls $0.25
4TM16KVgEiQpLi4bVVWbVQ: raises $0.50 to $0.75
LJI7A1YgDM7hgh7o56+ReQ: folds 
tSR4329m40dZsN7YOpI9Kw: folds 
EE16Ua5b1HSsYej5zeXOlA: folds 
mfrkWA3PTeYPkbO6hi98Aw: folds 
niLn0xUVlqh8If80xRjzCA: calls $0.50
*** FLOP *** [Jd Qd 9c]
niLn0xUVlqh8If80xRjzCA: checks 
4TM16KVgEiQpLi4bVVWbVQ: bets $1
niLn0xUVlqh8If80xRjzCA: folds 
Uncalled bet ($1) returned to 4TM16KVgEiQpLi4bVVWbVQ
4TM16KVgEiQpLi4bVVWbVQ collected $1.80 from pot
*** SUMMARY ***
Total pot $1.85 | Rake $0.05 
Board [Jd Qd 9c]
Seat 1: LJI7A1YgDM7hgh7o56+ReQ folded before Flop (didn't bet)
Seat 2: tSR4329m40dZsN7YOpI9Kw (button) folded before Flop (didn't bet)
Seat 3: EE16Ua5b1HSsYej5zeXOlA (small blind) folded before Flop
Seat 4: mfrkWA3PTeYPkbO6hi98Aw (big blind) folded before Flop
Seat 5: niLn0xUVlqh8If80xRjzCA folded on the Flop
Seat 6: 4TM16KVgEiQpLi4bVVWbVQ collected ($1.80)




PokerStars Game #59941698488:  Hold'em No Limit ($0.10/$0.25) - 2009/07/01 1:43:21 ET
Table 'by7aHYEDnDd144EXOXa/jA' 9-max Seat #9 is the button
Seat 1: j4q3p0lesp63b1gZDwLBZw ($6.35 in chips) 
Seat 2: vSkQm2EelzwRGDDQQk0Fqw ($5 in chips) 
Seat 3: HOEaXncFu2ij+D5/CANAZA ($12.10 in chips) 
Seat 4: 2Xwi447v1rBHM+92U0CduA ($4.25 in chips) 
Seat 5: yyG4svzOpC1A+sUP/scg6w ($4.20 in chips) 
Seat 6: sC4BsflLWW26Qm9m+1AwJQ ($14.90 in chips) 
Seat 8: 7je+LC5Mfs6nL8YBVh4frQ ($3.50 in chips) 
Seat 9: K0b5wNInj6hUGRr6yzKFtw ($26.05 in chips) 
j4q3p0lesp63b1gZDwLBZw: posts small blind $0.10
vSkQm2EelzwRGDDQQk0Fqw: posts big blind $0.25
Z9W7+g1WMhhZDi7DwGbCFA: sits out 
*** HOLE CARDS ***
HOEaXncFu2ij+D5/CANAZA: folds 
2Xwi447v1rBHM+92U0CduA: folds 
yyG4svzOpC1A+sUP/scg6w: folds 
sC4BsflLWW26Qm9m+1AwJQ: folds 
7je+LC5Mfs6nL8YBVh4frQ: folds 
K0b5wNInj6hUGRr6yzKFtw: raises $0.75 to $1
j4q3p0lesp63b1gZDwLBZw: folds 
vSkQm2EelzwRGDDQQk0Fqw: raises $4 to $5 and is all-in
K0b5wNInj6hUGRr6yzKFtw: folds 
Uncalled bet ($4) returned to vSkQm2EelzwRGDDQQk0Fqw
vSkQm2EelzwRGDDQQk0Fqw collected $2.10 from pot
vSkQm2EelzwRGDDQQk0Fqw: doesn't show hand 
*** SUMMARY ***
Total pot $2.10 | Rake $0 
Seat 1: j4q3p0lesp63b1gZDwLBZw (small blind) folded before Flop
Seat 2: vSkQm2EelzwRGDDQQk0Fqw (big blind) collected ($2.10)
Seat 3: HOEaXncFu2ij+D5/CANAZA folded before Flop (didn't bet)
Seat 4: 2Xwi447v1rBHM+92U0CduA folded before Flop (didn't bet)
Seat 5: yyG4svzOpC1A+sUP/scg6w folded before Flop (didn't bet)
Seat 6: sC4BsflLWW26Qm9m+1AwJQ folded before Flop (didn't bet)
Seat 8: 7je+LC5Mfs6nL8YBVh4frQ folded before Flop (didn't bet)
Seat 9: K0b5wNInj6hUGRr6yzKFtw (button) folded before Flop




PokerStars Game #59941698778:  Hold'em No Limit ($0.10/$0.25) - 2009/07/01 1:43:21 ET
Table 'oZuNsbNJuUyQLGKzQ/4JFg' 6-max Seat #1 is the button
Seat 1: vqWjZmdQu/Hxw96/IJTWdQ ($25 in chips) 
Seat 2: UA5OsKS3VPaxa7uC8La/kA ($34.60 in chips) 
Seat 3: 8ClCHtFXGNplITm+63KB+Q ($51 in chips) 
Seat 5: oBUDUfeUyCbZBsjxHZgSiw ($26.80 in chips) 
Seat 6: fwg6dK1+r4jy/y+JqenYYQ ($14.15 in chips) 
UA5OsKS3VPaxa7uC8La/kA: posts small blind $0.10
8ClCHtFXGNplITm+63KB+Q: posts big blind $0.25
9bpVv1/Qh9IYtXuCtl5VtQ: sits out 
*** HOLE CARDS ***
oBUDUfeUyCbZBsjxHZgSiw: folds 
fwg6dK1+r4jy/y+JqenYYQ: folds 
vqWjZmdQu/Hxw96/IJTWdQ: folds 
UA5OsKS3VPaxa7uC8La/kA: folds 
Uncalled bet ($0.15) returned to 8ClCHtFXGNplITm+63KB+Q
8ClCHtFXGNplITm+63KB+Q collected $0.20 from pot
8ClCHtFXGNplITm+63KB+Q: doesn't show hand 
*** SUMMARY ***
Total pot $0.20 | Rake $0 
Seat 1: vqWjZmdQu/Hxw96/IJTWdQ (button) folded before Flop (didn't bet)
Seat 2: UA5OsKS3VPaxa7uC8La/kA (small blind) folded before Flop
Seat 3: 8ClCHtFXGNplITm+63KB+Q (big blind) collected ($0.20)
Seat 5: oBUDUfeUyCbZBsjxHZgSiw folded before Flop (didn't bet)
Seat 6: fwg6dK1+r4jy/y+JqenYYQ folded before Flop (didn't bet)




PokerStars Game #59941699132:  Hold'em No Limit ($0.10/$0.25) - 2009/07/01 1:43:22 ET
Table 'JUMeG5SzDyo9HufhgemQeA' 9-max Seat #6 is the button
Seat 1: oLa/tXLfSLLB28mcLGrxcg ($24.55 in chips) 
Seat 2: Jve2LRs9vtGL7NdiNeXY/A ($13.75 in chips) 
Seat 3: IEvLSTIxhlti3EjZDarYnA ($32.50 in chips) 
Seat 4: 9+Um1wMtYNWnmPLUEU4viQ ($17.65 in chips) 
Seat 5: Ne5zBB6oEKrbigKRh6d6Xg ($11.25 in chips) 
Seat 6: wFCwdYKUXoQHhz8qeZuuAw ($25.10 in chips) 
Seat 7: aNpwfA31EREwO+ar4XzBCw ($32.25 in chips) 
Seat 9: V6p0jQ/RhUsqpHLmXvEX4Q ($13.80 in chips) 
aNpwfA31EREwO+ar4XzBCw: posts small blind $0.10
V6p0jQ/RhUsqpHLmXvEX4Q: posts big blind $0.25
*** HOLE CARDS ***
oLa/tXLfSLLB28mcLGrxcg: folds 
Jve2LRs9vtGL7NdiNeXY/A: raises $0.25 to $0.50
IEvLSTIxhlti3EjZDarYnA: folds 
9+Um1wMtYNWnmPLUEU4viQ: folds 
Ne5zBB6oEKrbigKRh6d6Xg: calls $0.50
wFCwdYKUXoQHhz8qeZuuAw: calls $0.50
aNpwfA31EREwO+ar4XzBCw: folds 
V6p0jQ/RhUsqpHLmXvEX4Q: folds 
*** FLOP *** [4h 6d 9h]
Jve2LRs9vtGL7NdiNeXY/A: bets $0.50
Ne5zBB6oEKrbigKRh6d6Xg: calls $0.50
wFCwdYKUXoQHhz8qeZuuAw: folds 
*** TURN *** [4h 6d 9h] [3d]
Jve2LRs9vtGL7NdiNeXY/A: bets $0.75
Ne5zBB6oEKrbigKRh6d6Xg: folds 
Uncalled bet ($0.75) returned to Jve2LRs9vtGL7NdiNeXY/A
Jve2LRs9vtGL7NdiNeXY/A collected $2.75 from pot
Jve2LRs9vtGL7NdiNeXY/A: doesn't show hand 
*** SUMMARY ***
Total pot $2.85 | Rake $0.10 
Board [4h 6d 9h 3d]
Seat 1: oLa/tXLfSLLB28mcLGrxcg folded before Flop (didn't bet)
Seat 2: Jve2LRs9vtGL7NdiNeXY/A collected ($2.75)
Seat 3: IEvLSTIxhlti3EjZDarYnA folded before Flop (didn't bet)
Seat 4: 9+Um1wMtYNWnmPLUEU4viQ folded before Flop (didn't bet)
Seat 5: Ne5zBB6oEKrbigKRh6d6Xg folded on the Turn
Seat 6: wFCwdYKUXoQHhz8qeZuuAw (button) folded on the Flop
Seat 7: aNpwfA31EREwO+ar4XzBCw (small blind) folded before Flop
Seat 9: V6p0jQ/RhUsqpHLmXvEX4Q (big blind) folded before Flop




PokerStars Game #59941698964:  Hold'em No Limit ($0.10/$0.25) - 2009/07/01 1:43:22 ET
Table 'BpNkESDX1ip9c0K1hb5h7A' 6-max Seat #6 is the button
Seat 1: 5YZdVjBPZVEdubN4xEMPEg ($33.50 in chips) 
Seat 3: fZQg9veL7Dd/Z04ZTjC+wQ ($25.70 in chips) 
Seat 4: kG34n23qFQA3nzdOJTQ1dA ($25.90 in chips) 
Seat 5: L3/N/gliETan8N5Gim5h4Q ($25.75 in chips) 
Seat 6: 8EEqTTh7T1q48sYDqbI2Xg ($21.15 in chips) 
5YZdVjBPZVEdubN4xEMPEg: posts small blind $0.10
g+5jEA4Xq9vcMOfdFYNuFA: is sitting out 
fZQg9veL7Dd/Z04ZTjC+wQ: posts big blind $0.25
*** HOLE CARDS ***
g+5jEA4Xq9vcMOfdFYNuFA leaves the table
kG34n23qFQA3nzdOJTQ1dA: folds 
L3/N/gliETan8N5Gim5h4Q: folds 
8EEqTTh7T1q48sYDqbI2Xg: folds 
5YZdVjBPZVEdubN4xEMPEg: raises $0.50 to $0.75
fZQg9veL7Dd/Z04ZTjC+wQ: calls $0.50
*** FLOP *** [7d Jd Qd]
9U3ZKjCsarN0DjR6mSE8Ug joins the table at seat #2 
5YZdVjBPZVEdubN4xEMPEg: bets $1
fZQg9veL7Dd/Z04ZTjC+wQ: raises $2.50 to $3.50
5YZdVjBPZVEdubN4xEMPEg: folds 
Uncalled bet ($2.50) returned to fZQg9veL7Dd/Z04ZTjC+wQ
fZQg9veL7Dd/Z04ZTjC+wQ collected $3.35 from pot
fZQg9veL7Dd/Z04ZTjC+wQ: doesn't show hand 
*** SUMMARY ***
Total pot $3.50 | Rake $0.15 
Board [7d Jd Qd]
Seat 1: 5YZdVjBPZVEdubN4xEMPEg (small blind) folded on the Flop
Seat 3: fZQg9veL7Dd/Z04ZTjC+wQ (big blind) collected ($3.35)
Seat 4: kG34n23qFQA3nzdOJTQ1dA folded before Flop (didn't bet)
Seat 5: L3/N/gliETan8N5Gim5h4Q folded before Flop (didn't bet)
Seat 6: 8EEqTTh7T1q48sYDqbI2Xg (button) folded before Flop (didn't bet)




PokerStars Game #59941699010:  Hold'em No Limit ($0.10/$0.25) - 2009/07/01 1:43:22 ET
Table 'VuY5ej47Cy8nOI3Wogmhzw' 6-max Seat #1 is the button
Seat 1: EeUZtMU058v2ObUACOF4Og ($37.85 in chips) 
Seat 2: AM6Yl+3esmhhMBlSnQhWbg ($19.10 in chips) 
Seat 3: v+QfkGiuj9bgtuNoVnDO8w ($29.65 in chips) 
Seat 5: iK/41//HmnLiIn0CVNNfyA ($11.55 in chips) 
AM6Yl+3esmhhMBlSnQhWbg: posts small blind $0.10
v+QfkGiuj9bgtuNoVnDO8w: posts big blind $0.25
QqiZLFrN8iOUT/GHw7ztOA: sits out 
*** HOLE CARDS ***
iK/41//HmnLiIn0CVNNfyA: raises $0.75 to $1
EeUZtMU058v2ObUACOF4Og: folds 
AM6Yl+3esmhhMBlSnQhWbg: calls $0.90
v+QfkGiuj9bgtuNoVnDO8w: folds 
*** FLOP *** [4c Qc 9d]
AM6Yl+3esmhhMBlSnQhWbg: checks 
iK/41//HmnLiIn0CVNNfyA: bets $1
AM6Yl+3esmhhMBlSnQhWbg: folds 
Uncalled bet ($1) returned to iK/41//HmnLiIn0CVNNfyA
iK/41//HmnLiIn0CVNNfyA collected $2.15 from pot
iK/41//HmnLiIn0CVNNfyA: doesn't show hand 
*** SUMMARY ***
Total pot $2.25 | Rake $0.10 
Board [4c Qc 9d]
Seat 1: EeUZtMU058v2ObUACOF4Og (button) folded before Flop (didn't bet)
Seat 2: AM6Yl+3esmhhMBlSnQhWbg (small blind) folded on the Flop
Seat 3: v+QfkGiuj9bgtuNoVnDO8w (big blind) folded before Flop
Seat 5: iK/41//HmnLiIn0CVNNfyA collected ($2.15)




PokerStars Game #59941699334:  Hold'em No Limit ($0.10/$0.25) - 2009/07/01 1:43:22 ET
Table '9lYs7ljXi6AgFAxYHlKLJw' 9-max Seat #2 is the button
Seat 1: K0b5wNInj6hUGRr6yzKFtw ($36.35 in chips) 
Seat 2: 0XACOSNrAWmqNv9k1nF8rw ($18.20 in chips) 
Seat 3: arxNSjreDRGFg13EAM2F1w ($31.05 in chips) 
Seat 4: UANt6y/SmDCY/jIxkBixcw ($33.85 in chips) 
Seat 5: dfNim92Z6XK1/h5SFW5vDg ($52.70 in chips) 
Seat 6: tYsOBqdU1+x+yFI7zHO7hQ ($25 in chips) 
Seat 7: ghNKXUBl/H+t83JF079ZBA ($27.05 in chips) 
Seat 8: 9YN2IkT2JYYKFErZtZvCtA ($19.10 in chips) 
Seat 9: cKlmpQMahVsmOaxFQDcoOg ($19 in chips) 
arxNSjreDRGFg13EAM2F1w: posts small blind $0.10
UANt6y/SmDCY/jIxkBixcw: posts big blind $0.25
*** HOLE CARDS ***
dfNim92Z6XK1/h5SFW5vDg: folds 
tYsOBqdU1+x+yFI7zHO7hQ: folds 
ghNKXUBl/H+t83JF079ZBA: folds 
9YN2IkT2JYYKFErZtZvCtA: folds 
cKlmpQMahVsmOaxFQDcoOg: folds 
K0b5wNInj6hUGRr6yzKFtw: raises $0.50 to $0.75
0XACOSNrAWmqNv9k1nF8rw: folds 
arxNSjreDRGFg13EAM2F1w: folds 
UANt6y/SmDCY/jIxkBixcw: calls $0.50
*** FLOP *** [4h 2h 8c]
UANt6y/SmDCY/jIxkBixcw: checks 
K0b5wNInj6hUGRr6yzKFtw: bets $1.25
UANt6y/SmDCY/jIxkBixcw: folds 
Uncalled bet ($1.25) returned to K0b5wNInj6hUGRr6yzKFtw
K0b5wNInj6hUGRr6yzKFtw collected $1.55 from pot
K0b5wNInj6hUGRr6yzKFtw: doesn't show hand 
*** SUMMARY ***
Total pot $1.60 | Rake $0.05 
Board [4h 2h 8c]
Seat 1: K0b5wNInj6hUGRr6yzKFtw collected ($1.55)
Seat 2: 0XACOSNrAWmqNv9k1nF8rw (button) folded before Flop (didn't bet)
Seat 3: arxNSjreDRGFg13EAM2F1w (small blind) folded before Flop
Seat 4: UANt6y/SmDCY/jIxkBixcw (big blind) folded on the Flop
Seat 5: dfNim92Z6XK1/h5SFW5vDg folded before Flop (didn't bet)
Seat 6: tYsOBqdU1+x+yFI7zHO7hQ folded before Flop (didn't bet)
Seat 7: ghNKXUBl/H+t83JF079ZBA folded before Flop (didn't bet)
Seat 8: 9YN2IkT2JYYKFErZtZvCtA folded before Flop (didn't bet)
Seat 9: cKlmpQMahVsmOaxFQDcoOg folded before Flop (didn't bet)




PokerStars Game #59941699160:  Hold'em No Limit ($0.10/$0.25) - 2009/07/01 1:43:22 ET
Table 'h02LhQ7B/Zk4ETRxxHhGYA' 9-max Seat #6 is the button
Seat 1: sD+TKtt36XiiN6jqHiLwDA ($25.25 in chips) 
Seat 2: 9lvO/qyU+xrU95Teu1fv0g ($6.30 in chips) 
Seat 3: arxNSjreDRGFg13EAM2F1w ($25 in chips) 
Seat 4: tYsOBqdU1+x+yFI7zHO7hQ ($38.10 in chips) 
Seat 5: cUxk0Jk4lrUQv9CJl0LPlg ($28 in chips) 
Seat 6: UvM6sxFT7el5hVDehvWvTA ($33.85 in chips) 
Seat 7: y7w8+Oqq4SkI1dkRDCx2Zg ($3.60 in chips) 
Seat 8: mUoFJKqCzIUABvOFbiINlQ ($14.25 in chips) 
Seat 9: MgzS9dEPzsGYQW57RteFhw ($7.40 in chips) 
y7w8+Oqq4SkI1dkRDCx2Zg: posts small blind $0.10
mUoFJKqCzIUABvOFbiINlQ: posts big blind $0.25
*** HOLE CARDS ***
MgzS9dEPzsGYQW57RteFhw: calls $0.25
sD+TKtt36XiiN6jqHiLwDA: folds 
9lvO/qyU+xrU95Teu1fv0g: folds 
arxNSjreDRGFg13EAM2F1w: folds 
tYsOBqdU1+x+yFI7zHO7hQ: folds 
cUxk0Jk4lrUQv9CJl0LPlg: folds 
UvM6sxFT7el5hVDehvWvTA: folds 
y7w8+Oqq4SkI1dkRDCx2Zg: folds 
mUoFJKqCzIUABvOFbiINlQ: checks 
*** FLOP *** [Ts Js 4c]
mUoFJKqCzIUABvOFbiINlQ: checks 
MgzS9dEPzsGYQW57RteFhw: checks 
*** TURN *** [Ts Js 4c] [9d]
mUoFJKqCzIUABvOFbiINlQ: bets $0.50
MgzS9dEPzsGYQW57RteFhw: folds 
Uncalled bet ($0.50) returned to mUoFJKqCzIUABvOFbiINlQ
mUoFJKqCzIUABvOFbiINlQ collected $0.60 from pot
*** SUMMARY ***
Total pot $0.60 | Rake $0 
Board [Ts Js 4c 9d]
Seat 1: sD+TKtt36XiiN6jqHiLwDA folded before Flop (didn't bet)
Seat 2: 9lvO/qyU+xrU95Teu1fv0g folded before Flop (didn't bet)
Seat 3: arxNSjreDRGFg13EAM2F1w folded before Flop (didn't bet)
Seat 4: tYsOBqdU1+x+yFI7zHO7hQ folded before Flop (didn't bet)
Seat 5: cUxk0Jk4lrUQv9CJl0LPlg folded before Flop (didn't bet)
Seat 6: UvM6sxFT7el5hVDehvWvTA (button) folded before Flop (didn't bet)
Seat 7: y7w8+Oqq4SkI1dkRDCx2Zg (small blind) folded before Flop
Seat 8: mUoFJKqCzIUABvOFbiINlQ (big blind) collected ($0.60)
Seat 9: MgzS9dEPzsGYQW57RteFhw folded on the Turn




PokerStars Game #59941699262:  Hold'em No Limit ($0.10/$0.25) - 2009/07/01 1:43:22 ET
Table 'rtxA1Y01Nrq5VoyzTAuusQ' 9-max Seat #1 is the button
Seat 1: w1ukf8uPa4+WH561TtVRxA ($26.55 in chips) 
Seat 2: Th3FldXKQW6hWVVPahaoOQ ($25 in chips) 
Seat 3: K9fS1IUr5GpiJG7VkJ7IbA ($5.25 in chips) 
Seat 5: MtVtHDqIJTyUcXkRBBDIVA ($27.55 in chips) 
Seat 7: 3PmVnC/15cl4oyI1TKIt4g ($9.65 in chips) 
Seat 8: DnDcAdn9P0zGovMERigpFA ($25 in chips) 
Seat 9: HPEB+AtKw1+C/cxU0o1ciw ($22.95 in chips) 
Th3FldXKQW6hWVVPahaoOQ: posts small blind $0.10
K9fS1IUr5GpiJG7VkJ7IbA: posts big blind $0.25
RHqgdFvufLCYe54+qd2gcA: sits out 
*** HOLE CARDS ***
MtVtHDqIJTyUcXkRBBDIVA: raises $0.50 to $0.75
3PmVnC/15cl4oyI1TKIt4g: folds 
DnDcAdn9P0zGovMERigpFA: folds 
HPEB+AtKw1+C/cxU0o1ciw: folds 
w1ukf8uPa4+WH561TtVRxA: folds 
Th3FldXKQW6hWVVPahaoOQ: folds 
K9fS1IUr5GpiJG7VkJ7IbA: calls $0.50
*** FLOP *** [Jh Jc 9h]
K9fS1IUr5GpiJG7VkJ7IbA: checks 
MtVtHDqIJTyUcXkRBBDIVA: bets $1
K9fS1IUr5GpiJG7VkJ7IbA: calls $1
*** TURN *** [Jh Jc 9h] [Qh]
K9fS1IUr5GpiJG7VkJ7IbA: checks 
MtVtHDqIJTyUcXkRBBDIVA: bets $1.25
K9fS1IUr5GpiJG7VkJ7IbA: raises $2.25 to $3.50 and is all-in
MtVtHDqIJTyUcXkRBBDIVA: calls $2.25
*** RIVER *** [Jh Jc 9h Qh] [Kc]
*** SHOW DOWN ***
K9fS1IUr5GpiJG7VkJ7IbA: shows [9d 6d] (two pair, Jacks and Nines)
MtVtHDqIJTyUcXkRBBDIVA: shows [Th 8h] (a straight flush, Eight to Queen)
MtVtHDqIJTyUcXkRBBDIVA collected $10.10 from pot
*** SUMMARY ***
Total pot $10.60 | Rake $0.50 
Board [Jh Jc 9h Qh Kc]
Seat 1: w1ukf8uPa4+WH561TtVRxA (button) folded before Flop (didn't bet)
Seat 2: Th3FldXKQW6hWVVPahaoOQ (small blind) folded before Flop
Seat 3: K9fS1IUr5GpiJG7VkJ7IbA (big blind) showed [9d 6d] and lost with two pair, Jacks and Nines
Seat 5: MtVtHDqIJTyUcXkRBBDIVA showed [Th 8h] and won ($10.10) with a straight flush, Eight to Queen
Seat 7: 3PmVnC/15cl4oyI1TKIt4g folded before Flop (didn't bet)
Seat 8: DnDcAdn9P0zGovMERigpFA folded before Flop (didn't bet)
Seat 9: HPEB+AtKw1+C/cxU0o1ciw folded before Flop (didn't bet)




PokerStars Game #59941699906:  Hold'em No Limit ($0.10/$0.25) - 2009/07/01 1:43:23 ET
Table '+198VWQSWBhYQOcizzuBkw' 6-max Seat #2 is the button
Seat 1: 34ttqW62uIRrqINCCmLcsw ($6.95 in chips) 
Seat 2: iauW7L/+7qzAuHow7CD75Q ($10.70 in chips) 
Seat 3: vw7gefupgmOJJN8lUemdWg ($25.55 in chips) 
Seat 4: TgDsTeCdLQt8kWbL00ByRA ($15.25 in chips) 
Seat 5: LtASJ9OlkqGrrUKGQlpGAw ($25.70 in chips) 
Seat 6: leEQ84f6wJYu5SB/vj27wg ($9.35 in chips) 
vw7gefupgmOJJN8lUemdWg: posts small blind $0.10
TgDsTeCdLQt8kWbL00ByRA: posts big blind $0.25
*** HOLE CARDS ***
vw7gefupgmOJJN8lUemdWg said, "lol"
LtASJ9OlkqGrrUKGQlpGAw: folds 
leEQ84f6wJYu5SB/vj27wg: calls $0.25
34ttqW62uIRrqINCCmLcsw: folds 
iauW7L/+7qzAuHow7CD75Q: folds 
vw7gefupgmOJJN8lUemdWg: calls $0.15
TgDsTeCdLQt8kWbL00ByRA: checks 
*** FLOP *** [Ad Ah 4c]
vw7gefupgmOJJN8lUemdWg: checks 
TgDsTeCdLQt8kWbL00ByRA: checks 
leEQ84f6wJYu5SB/vj27wg: checks 
*** TURN *** [Ad Ah 4c] [6d]
vw7gefupgmOJJN8lUemdWg: checks 
TgDsTeCdLQt8kWbL00ByRA: checks 
leEQ84f6wJYu5SB/vj27wg: checks 
*** RIVER *** [Ad Ah 4c 6d] [Js]
vw7gefupgmOJJN8lUemdWg: checks 
TgDsTeCdLQt8kWbL00ByRA: checks 
leEQ84f6wJYu5SB/vj27wg: bets $0.75
vw7gefupgmOJJN8lUemdWg: folds 
TgDsTeCdLQt8kWbL00ByRA: folds 
Uncalled bet ($0.75) returned to leEQ84f6wJYu5SB/vj27wg
leEQ84f6wJYu5SB/vj27wg collected $0.75 from pot
*** SUMMARY ***
Total pot $0.75 | Rake $0 
Board [Ad Ah 4c 6d Js]
Seat 1: 34ttqW62uIRrqINCCmLcsw folded before Flop (didn't bet)
Seat 2: iauW7L/+7qzAuHow7CD75Q (button) folded before Flop (didn't bet)
Seat 3: vw7gefupgmOJJN8lUemdWg (small blind) folded on the River
Seat 4: TgDsTeCdLQt8kWbL00ByRA (big blind) folded on the River
Seat 5: LtASJ9OlkqGrrUKGQlpGAw folded before Flop (didn't bet)
Seat 6: leEQ84f6wJYu5SB/vj27wg collected ($0.75)




PokerStars Game #59941699500:  Hold'em No Limit ($0.10/$0.25) - 2009/07/01 1:43:23 ET
Table 'oJpFwZj9+FUGHX90Un8s9Q' 6-max Seat #2 is the button
Seat 1: 6DwBRH+xZ12AAZmeAg+aXw ($22.60 in chips) 
Seat 2: NtrVQ9UIql0rDCnKDKZ5FQ ($15.55 in chips) 
Seat 3: kyRaCIljYA6l33lSKQfNsg ($24.90 in chips) 
Seat 4: 6elpmfyt4Zw0yvd8lePSMQ ($22.65 in chips) 
Seat 5: kG34n23qFQA3nzdOJTQ1dA ($56.10 in chips) 
Seat 6: edio/rLJ06xeZOfLhoL3UA ($1.20 in chips) 
kyRaCIljYA6l33lSKQfNsg: posts small blind $0.10
6elpmfyt4Zw0yvd8lePSMQ: posts big blind $0.25
*** HOLE CARDS ***
kG34n23qFQA3nzdOJTQ1dA: folds 
edio/rLJ06xeZOfLhoL3UA: folds 
6DwBRH+xZ12AAZmeAg+aXw: raises $0.50 to $0.75
NtrVQ9UIql0rDCnKDKZ5FQ: calls $0.75
kyRaCIljYA6l33lSKQfNsg: calls $0.65
6elpmfyt4Zw0yvd8lePSMQ: calls $0.50
*** FLOP *** [2h Kh 5s]
kyRaCIljYA6l33lSKQfNsg: checks 
6elpmfyt4Zw0yvd8lePSMQ: checks 
6DwBRH+xZ12AAZmeAg+aXw: checks 
NtrVQ9UIql0rDCnKDKZ5FQ: checks 
*** TURN *** [2h Kh 5s] [8c]
kyRaCIljYA6l33lSKQfNsg: checks 
6elpmfyt4Zw0yvd8lePSMQ: checks 
6DwBRH+xZ12AAZmeAg+aXw: checks 
NtrVQ9UIql0rDCnKDKZ5FQ: checks 
*** RIVER *** [2h Kh 5s 8c] [8d]
kyRaCIljYA6l33lSKQfNsg: checks 
6elpmfyt4Zw0yvd8lePSMQ: checks 
6DwBRH+xZ12AAZmeAg+aXw: checks 
NtrVQ9UIql0rDCnKDKZ5FQ: checks 
*** SHOW DOWN ***
kyRaCIljYA6l33lSKQfNsg: shows [4h 4d] (two pair, Eights and Fours)
6elpmfyt4Zw0yvd8lePSMQ: mucks hand 
6DwBRH+xZ12AAZmeAg+aXw: mucks hand 
NtrVQ9UIql0rDCnKDKZ5FQ: mucks hand 
kyRaCIljYA6l33lSKQfNsg collected $2.85 from pot
*** SUMMARY ***
Total pot $3 | Rake $0.15 
Board [2h Kh 5s 8c 8d]
Seat 1: 6DwBRH+xZ12AAZmeAg+aXw mucked
Seat 2: NtrVQ9UIql0rDCnKDKZ5FQ (button) mucked
Seat 3: kyRaCIljYA6l33lSKQfNsg (small blind) showed [4h 4d] and won ($2.85) with two pair, Eights and Fours
Seat 4: 6elpmfyt4Zw0yvd8lePSMQ (big blind) mucked
Seat 5: kG34n23qFQA3nzdOJTQ1dA folded before Flop (didn't bet)
Seat 6: edio/rLJ06xeZOfLhoL3UA folded before Flop (didn't bet)




PokerStars Game #59941699822:  Hold'em No Limit ($0.10/$0.25) - 2009/07/01 1:43:23 ET
Table 'RUOqTfzbAVGS5x+J9aZMHA' 9-max Seat #1 is the button
Seat 1: DnDcAdn9P0zGovMERigpFA ($25 in chips) 
Seat 2: Z5ZtGOON8kmSdSCll9Z3XA ($8.10 in chips) 
Seat 3: Th3FldXKQW6hWVVPahaoOQ ($25 in chips) 
Seat 4: K9Az8li/CO2TicltVWKamA ($40.55 in chips) 
Seat 5: MtVtHDqIJTyUcXkRBBDIVA ($26.65 in chips) 
Seat 6: ljemhp25Zg+nlA9DLCIiUw ($40.05 in chips) 
Seat 7: zgi+EUykT/pZQpoUG6+oEg ($4.30 in chips) 
Seat 8: dfNim92Z6XK1/h5SFW5vDg ($29.20 in chips) 
Seat 9: cZ99hugmLBj9KhTlc8nCSw ($25 in chips) 
Z5ZtGOON8kmSdSCll9Z3XA: posts small blind $0.10
Th3FldXKQW6hWVVPahaoOQ: posts big blind $0.25
*** HOLE CARDS ***
K9Az8li/CO2TicltVWKamA: folds 
MtVtHDqIJTyUcXkRBBDIVA: folds 
ljemhp25Zg+nlA9DLCIiUw: raises $0.75 to $1
zgi+EUykT/pZQpoUG6+oEg: folds 
dfNim92Z6XK1/h5SFW5vDg: folds 
cZ99hugmLBj9KhTlc8nCSw: folds 
DnDcAdn9P0zGovMERigpFA: folds 
Z5ZtGOON8kmSdSCll9Z3XA: folds 
Th3FldXKQW6hWVVPahaoOQ: folds 
Uncalled bet ($0.75) returned to ljemhp25Zg+nlA9DLCIiUw
ljemhp25Zg+nlA9DLCIiUw collected $0.60 from pot
ljemhp25Zg+nlA9DLCIiUw: doesn't show hand 
*** SUMMARY ***
Total pot $0.60 | Rake $0 
Seat 1: DnDcAdn9P0zGovMERigpFA (button) folded before Flop (didn't bet)
Seat 2: Z5ZtGOON8kmSdSCll9Z3XA (small blind) folded before Flop
Seat 3: Th3FldXKQW6hWVVPahaoOQ (big blind) folded before Flop
Seat 4: K9Az8li/CO2TicltVWKamA folded before Flop (didn't bet)
Seat 5: MtVtHDqIJTyUcXkRBBDIVA folded before Flop (didn't bet)
Seat 6: ljemhp25Zg+nlA9DLCIiUw collected ($0.60)
Seat 7: zgi+EUykT/pZQpoUG6+oEg folded before Flop (didn't bet)
Seat 8: dfNim92Z6XK1/h5SFW5vDg folded before Flop (didn't bet)
Seat 9: cZ99hugmLBj9KhTlc8nCSw folded before Flop (didn't bet)




PokerStars Game #59941700102:  Hold'em No Limit ($0.10/$0.25) - 2009/07/01 1:43:24 ET
Table '972HGIb0tQN/zRIK4TABEw' 9-max Seat #2 is the button
Seat 1: fHr2+mGa0RFK3qrpZcVUAQ ($6.25 in chips) 
Seat 2: lc6GpYOW7MM4G+/65wMxXA ($11.75 in chips) 
Seat 3: aNpwfA31EREwO+ar4XzBCw ($25 in chips) 
Seat 4: Bb42QRQMhg5/Y0vHP8/2Xw ($25 in chips) 
Seat 5: swK30YlQuxRQO7QFr4ZxCA ($19.30 in chips) 
Seat 6: aLYacoAY3e5d/M5ToF8Ujw ($17.15 in chips) 
Seat 7: qS+jfnNoG75bT+uQ8CKhQA ($14.75 in chips) 
Seat 8: sGFnnRCa1YAHAUmWgsW6Qg ($8.80 in chips) 
Seat 9: 3PmVnC/15cl4oyI1TKIt4g ($3.95 in chips) 
aNpwfA31EREwO+ar4XzBCw: posts small blind $0.10
Bb42QRQMhg5/Y0vHP8/2Xw: posts big blind $0.25
fHr2+mGa0RFK3qrpZcVUAQ: posts small blind $0.10
*** HOLE CARDS ***
swK30YlQuxRQO7QFr4ZxCA: folds 
aLYacoAY3e5d/M5ToF8Ujw: calls $0.25
qS+jfnNoG75bT+uQ8CKhQA: folds 
sGFnnRCa1YAHAUmWgsW6Qg: folds 
3PmVnC/15cl4oyI1TKIt4g: folds 
fHr2+mGa0RFK3qrpZcVUAQ: raises $1 to $1.25
lc6GpYOW7MM4G+/65wMxXA: folds 
aNpwfA31EREwO+ar4XzBCw: folds 
Bb42QRQMhg5/Y0vHP8/2Xw: folds 
aLYacoAY3e5d/M5ToF8Ujw: folds 
Uncalled bet ($1) returned to fHr2+mGa0RFK3qrpZcVUAQ
fHr2+mGa0RFK3qrpZcVUAQ collected $0.95 from pot
*** SUMMARY ***
Total pot $0.95 | Rake $0 
Seat 1: fHr2+mGa0RFK3qrpZcVUAQ collected ($0.95)
Seat 2: lc6GpYOW7MM4G+/65wMxXA (button) folded before Flop (didn't bet)
Seat 3: aNpwfA31EREwO+ar4XzBCw (small blind) folded before Flop
Seat 4: Bb42QRQMhg5/Y0vHP8/2Xw (big blind) folded before Flop
Seat 5: swK30YlQuxRQO7QFr4ZxCA folded before Flop (didn't bet)
Seat 6: aLYacoAY3e5d/M5ToF8Ujw folded before Flop
Seat 7: qS+jfnNoG75bT+uQ8CKhQA folded before Flop (didn't bet)
Seat 8: sGFnnRCa1YAHAUmWgsW6Qg folded before Flop (didn't bet)
Seat 9: 3PmVnC/15cl4oyI1TKIt4g folded before Flop (didn't bet)




PokerStars Game #59941700370:  Hold'em No Limit ($0.10/$0.25) - 2009/07/01 1:43:24 ET
Table 'U0hCzoS0KCJL+eoE054K4Q' 9-max Seat #8 is the button
Seat 1: XVEauYThJRhSTUAMxB/2ow ($38.45 in chips) 
Seat 2: MG90wfSJZnOejs/KD3vlQQ ($25 in chips) 
Seat 3: 8Cp1H3sSs8+jTTwLfeYKcw ($27.20 in chips) 
Seat 4: Bb42QRQMhg5/Y0vHP8/2Xw ($25 in chips) 
Seat 5: zgi+EUykT/pZQpoUG6+oEg ($6 in chips) 
Seat 6: V6p0jQ/RhUsqpHLmXvEX4Q ($11.90 in chips) 
Seat 7: uetHVityNsFnyX2bBnKe2A ($18.35 in chips) 
Seat 8: K0b5wNInj6hUGRr6yzKFtw ($28.45 in chips) 
Seat 9: wGigCmBR/9XWkPpvYos3aQ ($33.20 in chips) 
wGigCmBR/9XWkPpvYos3aQ: posts small blind $0.10
XVEauYThJRhSTUAMxB/2ow: posts big blind $0.25
*** HOLE CARDS ***
MG90wfSJZnOejs/KD3vlQQ: folds 
8Cp1H3sSs8+jTTwLfeYKcw: folds 
Bb42QRQMhg5/Y0vHP8/2Xw: folds 
zgi+EUykT/pZQpoUG6+oEg: folds 
V6p0jQ/RhUsqpHLmXvEX4Q: folds 
uetHVityNsFnyX2bBnKe2A: folds 
K0b5wNInj6hUGRr6yzKFtw: raises $0.75 to $1
wGigCmBR/9XWkPpvYos3aQ: raises $2.40 to $3.40
XVEauYThJRhSTUAMxB/2ow: folds 
K0b5wNInj6hUGRr6yzKFtw: folds 
Uncalled bet ($2.40) returned to wGigCmBR/9XWkPpvYos3aQ
wGigCmBR/9XWkPpvYos3aQ collected $2.25 from pot
wGigCmBR/9XWkPpvYos3aQ: doesn't show hand 
*** SUMMARY ***
Total pot $2.25 | Rake $0 
Seat 1: XVEauYThJRhSTUAMxB/2ow (big blind) folded before Flop
Seat 2: MG90wfSJZnOejs/KD3vlQQ folded before Flop (didn't bet)
Seat 3: 8Cp1H3sSs8+jTTwLfeYKcw folded before Flop (didn't bet)
Seat 4: Bb42QRQMhg5/Y0vHP8/2Xw folded before Flop (didn't bet)
Seat 5: zgi+EUykT/pZQpoUG6+oEg folded before Flop (didn't bet)
Seat 6: V6p0jQ/RhUsqpHLmXvEX4Q folded before Flop (didn't bet)
Seat 7: uetHVityNsFnyX2bBnKe2A folded before Flop (didn't bet)
Seat 8: K0b5wNInj6hUGRr6yzKFtw (button) folded before Flop
Seat 9: wGigCmBR/9XWkPpvYos3aQ (small blind) collected ($2.25)




PokerStars Game #59941700304:  Hold'em No Limit ($0.10/$0.25) - 2009/07/01 1:43:24 ET
Table 'CBnRhp0d6E2+/NtM7Vbruw' 9-max Seat #2 is the button
Seat 1: WQe4GbiYBiPsb5WKFKkijQ ($10.05 in chips) 
Seat 2: cZ99hugmLBj9KhTlc8nCSw ($26.85 in chips) 
Seat 3: aNpwfA31EREwO+ar4XzBCw ($33.80 in chips) 
Seat 5: CT7Xj/V/O5rBlhtt+RZeFQ ($25 in chips) 
Seat 6: CvL9Ch1HYCVbTsfpNucitg ($4.65 in chips) 
Seat 7: j4q3p0lesp63b1gZDwLBZw ($5 in chips) 
Seat 8: MG90wfSJZnOejs/KD3vlQQ ($25 in chips) 
Seat 9: xHZZRLAaFUIC8WWI8ljOJA ($29.90 in chips) 
aNpwfA31EREwO+ar4XzBCw: posts small blind $0.10
CT7Xj/V/O5rBlhtt+RZeFQ: posts big blind $0.25
*** HOLE CARDS ***
CvL9Ch1HYCVbTsfpNucitg: folds 
j4q3p0lesp63b1gZDwLBZw: folds 
MG90wfSJZnOejs/KD3vlQQ: folds 
xHZZRLAaFUIC8WWI8ljOJA: folds 
WQe4GbiYBiPsb5WKFKkijQ: folds 
cZ99hugmLBj9KhTlc8nCSw: folds 
aNpwfA31EREwO+ar4XzBCw: folds 
Uncalled bet ($0.15) returned to CT7Xj/V/O5rBlhtt+RZeFQ
CT7Xj/V/O5rBlhtt+RZeFQ collected $0.20 from pot
CT7Xj/V/O5rBlhtt+RZeFQ: doesn't show hand 
*** SUMMARY ***
Total pot $0.20 | Rake $0 
Seat 1: WQe4GbiYBiPsb5WKFKkijQ folded before Flop (didn't bet)
Seat 2: cZ99hugmLBj9KhTlc8nCSw (button) folded before Flop (didn't bet)
Seat 3: aNpwfA31EREwO+ar4XzBCw (small blind) folded before Flop
Seat 5: CT7Xj/V/O5rBlhtt+RZeFQ (big blind) collected ($0.20)
Seat 6: CvL9Ch1HYCVbTsfpNucitg folded before Flop (didn't bet)
Seat 7: j4q3p0lesp63b1gZDwLBZw folded before Flop (didn't bet)
Seat 8: MG90wfSJZnOejs/KD3vlQQ folded before Flop (didn't bet)
Seat 9: xHZZRLAaFUIC8WWI8ljOJA folded before Flop (didn't bet)




PokerStars Game #59941700306:  Hold'em No Limit ($0.10/$0.25) - 2009/07/01 1:43:24 ET
Table '5SUMWYuPsGiOD0FY0QbgOw' 6-max Seat #5 is the button
Seat 1: SFmT9ZsVopnukjvAzrxTRg ($25 in chips) 
Seat 2: xrf8tAXKQHG99HixCot1Iw ($36.55 in chips) 
Seat 3: MqMK8OWPSY1V4stf1Hy5Jw ($38.80 in chips) 
Seat 4: BV+K0Phf5VBHr7aZPKqbUQ ($25 in chips) 
Seat 5: v+QfkGiuj9bgtuNoVnDO8w ($40.40 in chips) 
Seat 6: jA7YMtfNUnAaebB7Lj74EA ($26.55 in chips) 
jA7YMtfNUnAaebB7Lj74EA: posts small blind $0.10
SFmT9ZsVopnukjvAzrxTRg: posts big blind $0.25
*** HOLE CARDS ***
xrf8tAXKQHG99HixCot1Iw: raises $0.50 to $0.75
MqMK8OWPSY1V4stf1Hy5Jw: folds 
BV+K0Phf5VBHr7aZPKqbUQ: folds 
v+QfkGiuj9bgtuNoVnDO8w: folds 
jA7YMtfNUnAaebB7Lj74EA: folds 
SFmT9ZsVopnukjvAzrxTRg: folds 
Uncalled bet ($0.50) returned to xrf8tAXKQHG99HixCot1Iw
xrf8tAXKQHG99HixCot1Iw collected $0.60 from pot
xrf8tAXKQHG99HixCot1Iw: doesn't show hand 
*** SUMMARY ***
Total pot $0.60 | Rake $0 
Seat 1: SFmT9ZsVopnukjvAzrxTRg (big blind) folded before Flop
Seat 2: xrf8tAXKQHG99HixCot1Iw collected ($0.60)
Seat 3: MqMK8OWPSY1V4stf1Hy5Jw folded before Flop (didn't bet)
Seat 4: BV+K0Phf5VBHr7aZPKqbUQ folded before Flop (didn't bet)
Seat 5: v+QfkGiuj9bgtuNoVnDO8w (button) folded before Flop (didn't bet)
Seat 6: jA7YMtfNUnAaebB7Lj74EA (small blind) folded before Flop




PokerStars Game #59941700408:  Hold'em No Limit ($0.10/$0.25) - 2009/07/01 1:43:24 ET
Table '84TjTrgbsYZladOc4PWf4Q' 6-max Seat #1 is the button
Seat 1: /kW0t5kKllzd8HO2uEapHQ ($21.70 in chips) 
Seat 2: RpaEX9P7BCvyfPRLiRNg0A ($41.80 in chips) 
Seat 3: Ar4vsUIUfJ7gbYh1c1m59g ($12.35 in chips) 
Seat 4: SxIIgwXYLkwd6m3wLyPTCw ($21.95 in chips) 
Seat 5: cezpHJ8FB07dj0xG+LhOvw ($26.85 in chips) 
Seat 6: wCUaomJ6Nq5zomVGdUHP+w ($18.50 in chips) 
RpaEX9P7BCvyfPRLiRNg0A: posts small blind $0.10
Ar4vsUIUfJ7gbYh1c1m59g: posts big blind $0.25
*** HOLE CARDS ***
SxIIgwXYLkwd6m3wLyPTCw: folds 
cezpHJ8FB07dj0xG+LhOvw: folds 
wCUaomJ6Nq5zomVGdUHP+w: folds 
/kW0t5kKllzd8HO2uEapHQ: calls $0.25
RpaEX9P7BCvyfPRLiRNg0A: calls $0.15
Ar4vsUIUfJ7gbYh1c1m59g: checks 
*** FLOP *** [7s 6s 3c]
RpaEX9P7BCvyfPRLiRNg0A: checks 
Ar4vsUIUfJ7gbYh1c1m59g: checks 
/kW0t5kKllzd8HO2uEapHQ: bets $0.25
RpaEX9P7BCvyfPRLiRNg0A: calls $0.25
Ar4vsUIUfJ7gbYh1c1m59g: folds 
*** TURN *** [7s 6s 3c] [8h]
RpaEX9P7BCvyfPRLiRNg0A: checks 
/kW0t5kKllzd8HO2uEapHQ: bets $0.50
RpaEX9P7BCvyfPRLiRNg0A: calls $0.50
*** RIVER *** [7s 6s 3c 8h] [Qs]
RpaEX9P7BCvyfPRLiRNg0A: checks 
/kW0t5kKllzd8HO2uEapHQ: checks 
*** SHOW DOWN ***
RpaEX9P7BCvyfPRLiRNg0A: shows [8d 9d] (a pair of Eights)
/kW0t5kKllzd8HO2uEapHQ: mucks hand 
RpaEX9P7BCvyfPRLiRNg0A collected $2.15 from pot
*** SUMMARY ***
Total pot $2.25 | Rake $0.10 
Board [7s 6s 3c 8h Qs]
Seat 1: /kW0t5kKllzd8HO2uEapHQ (button) mucked
Seat 2: RpaEX9P7BCvyfPRLiRNg0A (small blind) showed [8d 9d] and won ($2.15) with a pair of Eights
Seat 3: Ar4vsUIUfJ7gbYh1c1m59g (big blind) folded on the Flop
Seat 4: SxIIgwXYLkwd6m3wLyPTCw folded before Flop (didn't bet)
Seat 5: cezpHJ8FB07dj0xG+LhOvw folded before Flop (didn't bet)
Seat 6: wCUaomJ6Nq5zomVGdUHP+w folded before Flop (didn't bet)




PokerStars Game #59941699992:  Hold'em No Limit ($0.10/$0.25) - 2009/07/01 1:43:24 ET
Table 'ukli1Y7ieC5JQMTEFxM2Nw' 6-max Seat #4 is the button
Seat 1: N162H80ZIQevUf2EzGahCA ($8.80 in chips) 
Seat 2: u/yN5P9f3KlATg6WLWNkBQ ($43.55 in chips) 
Seat 3: ExeoJ1G/rSmWa3tRz7TlCA ($23.70 in chips) 
Seat 4: if4dh6jhJXeN3/qd3qCp9g ($28.35 in chips) 
Seat 5: Se+H4Z4PDr6+eIUDJX1rpg ($15.60 in chips) 
Seat 6: 32YL2ZEp8NT4JB2RVM9euQ ($29.55 in chips) 
Se+H4Z4PDr6+eIUDJX1rpg: posts small blind $0.10
32YL2ZEp8NT4JB2RVM9euQ: posts big blind $0.25
*** HOLE CARDS ***
N162H80ZIQevUf2EzGahCA: calls $0.25
u/yN5P9f3KlATg6WLWNkBQ: folds 
ExeoJ1G/rSmWa3tRz7TlCA: calls $0.25
if4dh6jhJXeN3/qd3qCp9g: folds 
Se+H4Z4PDr6+eIUDJX1rpg: calls $0.15
32YL2ZEp8NT4JB2RVM9euQ: checks 
*** FLOP *** [2d 8h 5s]
Se+H4Z4PDr6+eIUDJX1rpg: checks 
32YL2ZEp8NT4JB2RVM9euQ: checks 
N162H80ZIQevUf2EzGahCA: checks 
ExeoJ1G/rSmWa3tRz7TlCA: checks 
*** TURN *** [2d 8h 5s] [5d]
Se+H4Z4PDr6+eIUDJX1rpg: checks 
32YL2ZEp8NT4JB2RVM9euQ: bets $0.50
N162H80ZIQevUf2EzGahCA: folds 
ExeoJ1G/rSmWa3tRz7TlCA: folds 
Se+H4Z4PDr6+eIUDJX1rpg: folds 
Uncalled bet ($0.50) returned to 32YL2ZEp8NT4JB2RVM9euQ
32YL2ZEp8NT4JB2RVM9euQ collected $0.95 from pot
32YL2ZEp8NT4JB2RVM9euQ: doesn't show hand 
*** SUMMARY ***
Total pot $1 | Rake $0.05 
Board [2d 8h 5s 5d]
Seat 1: N162H80ZIQevUf2EzGahCA folded on the Turn
Seat 2: u/yN5P9f3KlATg6WLWNkBQ folded before Flop (didn't bet)
Seat 3: ExeoJ1G/rSmWa3tRz7TlCA folded on the Turn
Seat 4: if4dh6jhJXeN3/qd3qCp9g (button) folded before Flop (didn't bet)
Seat 5: Se+H4Z4PDr6+eIUDJX1rpg (small blind) folded on the Turn
Seat 6: 32YL2ZEp8NT4JB2RVM9euQ (big blind) collected ($0.95)




PokerStars Game #59941700148:  Hold'em No Limit ($0.10/$0.25) - 2009/07/01 1:43:24 ET
Table 'isKy4XK8wJM0x735/D4hWA' 6-max Seat #4 is the button
Seat 1: kwsRmpZ1ZaLooISs+zfyKg ($24.40 in chips) 
Seat 2: 6elpmfyt4Zw0yvd8lePSMQ ($20.45 in chips) 
Seat 3: jp34e617tIzV8tKIWmfAbA ($46.50 in chips) 
Seat 4: DFi/Lzkjsfv8QswS80JX9Q ($31.10 in chips) 
Seat 5: lquriepNQBhDV5P1SWHhnA ($25.35 in chips) 
Seat 6: GbCVUNssQ7mqsPWr7J4d3w ($4.65 in chips) 
lquriepNQBhDV5P1SWHhnA: posts small blind $0.10
GbCVUNssQ7mqsPWr7J4d3w: posts big blind $0.25
*** HOLE CARDS ***
kwsRmpZ1ZaLooISs+zfyKg: folds 
6elpmfyt4Zw0yvd8lePSMQ: raises $0.50 to $0.75
jp34e617tIzV8tKIWmfAbA: calls $0.75
DFi/Lzkjsfv8QswS80JX9Q: folds 
lquriepNQBhDV5P1SWHhnA: folds 
GbCVUNssQ7mqsPWr7J4d3w: folds 
*** FLOP *** [8c 4c 8d]
6elpmfyt4Zw0yvd8lePSMQ: bets $1
jp34e617tIzV8tKIWmfAbA: raises $2 to $3
6elpmfyt4Zw0yvd8lePSMQ: calls $2
*** TURN *** [8c 4c 8d] [Jh]
6elpmfyt4Zw0yvd8lePSMQ: checks 
jp34e617tIzV8tKIWmfAbA: bets $4
6elpmfyt4Zw0yvd8lePSMQ: calls $4
*** RIVER *** [8c 4c 8d Jh] [Th]
6elpmfyt4Zw0yvd8lePSMQ: bets $12.70 and is all-in
jp34e617tIzV8tKIWmfAbA: calls $12.70
*** SHOW DOWN ***
6elpmfyt4Zw0yvd8lePSMQ: shows [Jc Js] (a full house, Jacks full of Eights)
jp34e617tIzV8tKIWmfAbA: mucks hand 
6elpmfyt4Zw0yvd8lePSMQ collected $39.25 from pot
*** SUMMARY ***
Total pot $41.25 | Rake $2 
Board [8c 4c 8d Jh Th]
Seat 1: kwsRmpZ1ZaLooISs+zfyKg folded before Flop (didn't bet)
Seat 2: 6elpmfyt4Zw0yvd8lePSMQ showed [Jc Js] and won ($39.25) with a full house, Jacks full of Eights
Seat 3: jp34e617tIzV8tKIWmfAbA mucked
Seat 4: DFi/Lzkjsfv8QswS80JX9Q (button) folded before Flop (didn't bet)
Seat 5: lquriepNQBhDV5P1SWHhnA (small blind) folded before Flop
Seat 6: GbCVUNssQ7mqsPWr7J4d3w (big blind) folded before Flop




PokerStars Game #59941700242:  Hold'em No Limit ($0.10/$0.25) - 2009/07/01 1:43:24 ET
Table 'AchTjdLS1zBUbH3ZIx6f0w' 6-max Seat #4 is the button
Seat 1: rZ0bUtoerhFGDUSRQMnFog ($28.35 in chips) 
Seat 2: kG34n23qFQA3nzdOJTQ1dA ($66.25 in chips) 
Seat 3: k9vn40MOqqb+xF+7GZ6v2g ($28.65 in chips) 
Seat 4: q6WfTUAD9mowIP63ASq2Dg ($30.55 in chips) 
Seat 5: 0av6tRNdi0Ui4f15L7gsVg ($26.10 in chips) 
Seat 6: epAUIB7h2FJXzUPRIvSkRA ($25 in chips) 
0av6tRNdi0Ui4f15L7gsVg: posts small blind $0.10
epAUIB7h2FJXzUPRIvSkRA: posts big blind $0.25
*** HOLE CARDS ***
rZ0bUtoerhFGDUSRQMnFog: folds 
kG34n23qFQA3nzdOJTQ1dA: folds 
k9vn40MOqqb+xF+7GZ6v2g: calls $0.25
q6WfTUAD9mowIP63ASq2Dg has timed out
q6WfTUAD9mowIP63ASq2Dg: folds 
q6WfTUAD9mowIP63ASq2Dg is sitting out
q6WfTUAD9mowIP63ASq2Dg has returned
0av6tRNdi0Ui4f15L7gsVg: folds 
epAUIB7h2FJXzUPRIvSkRA: checks 
*** FLOP *** [3d 4c 4h]
epAUIB7h2FJXzUPRIvSkRA: bets $0.50
k9vn40MOqqb+xF+7GZ6v2g: folds 
Uncalled bet ($0.50) returned to epAUIB7h2FJXzUPRIvSkRA
epAUIB7h2FJXzUPRIvSkRA collected $0.60 from pot
epAUIB7h2FJXzUPRIvSkRA: doesn't show hand 
*** SUMMARY ***
Total pot $0.60 | Rake $0 
Board [3d 4c 4h]
Seat 1: rZ0bUtoerhFGDUSRQMnFog folded before Flop (didn't bet)
Seat 2: kG34n23qFQA3nzdOJTQ1dA folded before Flop (didn't bet)
Seat 3: k9vn40MOqqb+xF+7GZ6v2g folded on the Flop
Seat 4: q6WfTUAD9mowIP63ASq2Dg (button) folded before Flop (didn't bet)
Seat 5: 0av6tRNdi0Ui4f15L7gsVg (small blind) folded before Flop
Seat 6: epAUIB7h2FJXzUPRIvSkRA (big blind) collected ($0.60)




PokerStars Game #59941700404:  Hold'em No Limit ($0.10/$0.25) - 2009/07/01 1:43:24 ET
Table 'xmJKTGBeWCwutccj3YfupQ' 6-max Seat #5 is the button
Seat 1: sVbkVl4OznxBCfi66UB9vw ($27.55 in chips) 
Seat 2: AxhCSFlGEh+FAc+VUD31JQ ($18.45 in chips) 
Seat 3: T5wrp/d5jarm+SxNy8OQAg ($22.80 in chips) 
Seat 4: uWjhTVMpuIroxXcmD3Okug ($9.50 in chips) 
Seat 5: DE9hRlt14g+JdsRQ4wT7hg ($28.25 in chips) 
Seat 6: 9bpVv1/Qh9IYtXuCtl5VtQ ($24.75 in chips) 
9bpVv1/Qh9IYtXuCtl5VtQ: posts small blind $0.10
sVbkVl4OznxBCfi66UB9vw: posts big blind $0.25
*** HOLE CARDS ***
AxhCSFlGEh+FAc+VUD31JQ: folds 
T5wrp/d5jarm+SxNy8OQAg: folds 
uWjhTVMpuIroxXcmD3Okug: folds 
DE9hRlt14g+JdsRQ4wT7hg: folds 
9bpVv1/Qh9IYtXuCtl5VtQ: folds 
Uncalled bet ($0.15) returned to sVbkVl4OznxBCfi66UB9vw
sVbkVl4OznxBCfi66UB9vw collected $0.20 from pot
sVbkVl4OznxBCfi66UB9vw: doesn't show hand 
*** SUMMARY ***
Total pot $0.20 | Rake $0 
Seat 1: sVbkVl4OznxBCfi66UB9vw (big blind) collected ($0.20)
Seat 2: AxhCSFlGEh+FAc+VUD31JQ folded before Flop (didn't bet)
Seat 3: T5wrp/d5jarm+SxNy8OQAg folded before Flop (didn't bet)
Seat 4: uWjhTVMpuIroxXcmD3Okug folded before Flop (didn't bet)
Seat 5: DE9hRlt14g+JdsRQ4wT7hg (button) folded before Flop (didn't bet)
Seat 6: 9bpVv1/Qh9IYtXuCtl5VtQ (small blind) folded before Flop




PokerStars Game #59941700604:  Hold'em No Limit ($0.10/$0.25) - 2009/07/01 1:43:25 ET
Table 'VQNfcI8vTBCTvRfd3veTLQ' 6-max Seat #5 is the button
Seat 1: QiL+lEgEWwy21jk/ltaRLg ($17.45 in chips) 
Seat 2: 79ID/ub1Pt/mDpCprVmOoA ($31.90 in chips) 
Seat 3: LtASJ9OlkqGrrUKGQlpGAw ($11.75 in chips) 
Seat 4: QIWnfLSqfMcoFfdDe5LZPg ($40.55 in chips) 
Seat 5: gX2vbKwS/8zZPENAWB7hxQ ($21.25 in chips) 
Seat 6: LJI7A1YgDM7hgh7o56+ReQ ($27.45 in chips) 
LJI7A1YgDM7hgh7o56+ReQ: posts small blind $0.10
QiL+lEgEWwy21jk/ltaRLg: posts big blind $0.25
*** HOLE CARDS ***
79ID/ub1Pt/mDpCprVmOoA: folds 
LtASJ9OlkqGrrUKGQlpGAw: folds 
QIWnfLSqfMcoFfdDe5LZPg: folds 
gX2vbKwS/8zZPENAWB7hxQ: calls $0.25
LJI7A1YgDM7hgh7o56+ReQ: folds 
QiL+lEgEWwy21jk/ltaRLg: checks 
*** FLOP *** [2c 7h Ah]
QiL+lEgEWwy21jk/ltaRLg: checks 
gX2vbKwS/8zZPENAWB7hxQ: bets $0.75
QiL+lEgEWwy21jk/ltaRLg: folds 
Uncalled bet ($0.75) returned to gX2vbKwS/8zZPENAWB7hxQ
gX2vbKwS/8zZPENAWB7hxQ collected $0.60 from pot
*** SUMMARY ***
Total pot $0.60 | Rake $0 
Board [2c 7h Ah]
Seat 1: QiL+lEgEWwy21jk/ltaRLg (big blind) folded on the Flop
Seat 2: 79ID/ub1Pt/mDpCprVmOoA folded before Flop (didn't bet)
Seat 3: LtASJ9OlkqGrrUKGQlpGAw folded before Flop (didn't bet)
Seat 4: QIWnfLSqfMcoFfdDe5LZPg folded before Flop (didn't bet)
Seat 5: gX2vbKwS/8zZPENAWB7hxQ (button) collected ($0.60)
Seat 6: LJI7A1YgDM7hgh7o56+ReQ (small blind) folded before Flop




PokerStars Game #59941700522:  Hold'em No Limit ($0.10/$0.25) - 2009/07/01 1:43:25 ET
Table '29D3eoQzK5kOAT0OIDS2uQ' 6-max Seat #4 is the button
Seat 1: kG34n23qFQA3nzdOJTQ1dA ($46.15 in chips) 
Seat 2: FyE+TQ5JcCqI/tCCHf0jGA ($16.30 in chips) 
Seat 3: z3tQwy28dp5FykDJC/wzQw ($17.80 in chips) 
Seat 4: MqMK8OWPSY1V4stf1Hy5Jw ($35.90 in chips) 
Seat 5: Q3EMN7b0ie81AFWkDrhCjw ($24.15 in chips) 
Seat 6: bWbV4MVB/vVpiES1Ut4hew ($29.90 in chips) 
Q3EMN7b0ie81AFWkDrhCjw: posts small blind $0.10
bWbV4MVB/vVpiES1Ut4hew: posts big blind $0.25
*** HOLE CARDS ***
kG34n23qFQA3nzdOJTQ1dA: folds 
FyE+TQ5JcCqI/tCCHf0jGA: folds 
z3tQwy28dp5FykDJC/wzQw: folds 
MqMK8OWPSY1V4stf1Hy5Jw: folds 
Q3EMN7b0ie81AFWkDrhCjw: calls $0.15
bWbV4MVB/vVpiES1Ut4hew: raises $1 to $1.25
Q3EMN7b0ie81AFWkDrhCjw: folds 
Uncalled bet ($1) returned to bWbV4MVB/vVpiES1Ut4hew
bWbV4MVB/vVpiES1Ut4hew collected $0.50 from pot
bWbV4MVB/vVpiES1Ut4hew: doesn't show hand 
*** SUMMARY ***
Total pot $0.50 | Rake $0 
Seat 1: kG34n23qFQA3nzdOJTQ1dA folded before Flop (didn't bet)
Seat 2: FyE+TQ5JcCqI/tCCHf0jGA folded before Flop (didn't bet)
Seat 3: z3tQwy28dp5FykDJC/wzQw folded before Flop (didn't bet)
Seat 4: MqMK8OWPSY1V4stf1Hy5Jw (button) folded before Flop (didn't bet)
Seat 5: Q3EMN7b0ie81AFWkDrhCjw (small blind) folded before Flop
Seat 6: bWbV4MVB/vVpiES1Ut4hew (big blind) collected ($0.50)




PokerStars Game #59941700758:  Hold'em No Limit ($0.10/$0.25) - 2009/07/01 1:43:25 ET
Table 'MJ1SB76A4qJrlEa+C5e/8w' 6-max Seat #5 is the button
Seat 1: 0KDZiuXQg6UI9cqBR/AUnQ ($26 in chips) 
Seat 2: UA5OsKS3VPaxa7uC8La/kA ($36.70 in chips) 
Seat 3: DihMHaz4WNETH1bPDe13kA ($32.90 in chips) 
Seat 4: SFmT9ZsVopnukjvAzrxTRg ($27.80 in chips) 
Seat 5: Hsvkc0/G2VV78oVmWYXecw ($5 in chips) 
Seat 6: JFIAqU8lCZ0vWwEl4bdGsg ($30.40 in chips) 
JFIAqU8lCZ0vWwEl4bdGsg: posts small blind $0.10
0KDZiuXQg6UI9cqBR/AUnQ: posts big blind $0.25
*** HOLE CARDS ***
UA5OsKS3VPaxa7uC8La/kA: raises $0.75 to $1
DihMHaz4WNETH1bPDe13kA: folds 
SFmT9ZsVopnukjvAzrxTRg: folds 
Hsvkc0/G2VV78oVmWYXecw: folds 
JFIAqU8lCZ0vWwEl4bdGsg: folds 
0KDZiuXQg6UI9cqBR/AUnQ: folds 
Uncalled bet ($0.75) returned to UA5OsKS3VPaxa7uC8La/kA
UA5OsKS3VPaxa7uC8La/kA collected $0.60 from pot
*** SUMMARY ***
Total pot $0.60 | Rake $0 
Seat 1: 0KDZiuXQg6UI9cqBR/AUnQ (big blind) folded before Flop
Seat 2: UA5OsKS3VPaxa7uC8La/kA collected ($0.60)
Seat 3: DihMHaz4WNETH1bPDe13kA folded before Flop (didn't bet)
Seat 4: SFmT9ZsVopnukjvAzrxTRg folded before Flop (didn't bet)
Seat 5: Hsvkc0/G2VV78oVmWYXecw (button) folded before Flop (didn't bet)
Seat 6: JFIAqU8lCZ0vWwEl4bdGsg (small blind) folded before Flop




PokerStars Game #59941700570:  Hold'em No Limit ($0.10/$0.25) - 2009/07/01 1:43:25 ET
Table 'Pz8SfAzhP5nvWTsJRAxoDg' 6-max Seat #2 is the button
Seat 1: QiL+lEgEWwy21jk/ltaRLg ($24.80 in chips) 
Seat 2: xrf8tAXKQHG99HixCot1Iw ($26.60 in chips) 
Seat 3: mfrkWA3PTeYPkbO6hi98Aw ($27.95 in chips) 
Seat 4: 4lJto+Qj0K4JrFKvHaPTLw ($66.15 in chips) 
Seat 5: FYepjhAvF8ZdVCmqHIy+eQ ($28.40 in chips) 
Seat 6: QvTX2yGq3uKJiKPmns4TKQ ($24.65 in chips) 
mfrkWA3PTeYPkbO6hi98Aw: posts small blind $0.10
4lJto+Qj0K4JrFKvHaPTLw: posts big blind $0.25
*** HOLE CARDS ***
FYepjhAvF8ZdVCmqHIy+eQ: folds 
QvTX2yGq3uKJiKPmns4TKQ: folds 
QiL+lEgEWwy21jk/ltaRLg: calls $0.25
xrf8tAXKQHG99HixCot1Iw: raises $0.75 to $1
mfrkWA3PTeYPkbO6hi98Aw: folds 
4lJto+Qj0K4JrFKvHaPTLw: folds 
QiL+lEgEWwy21jk/ltaRLg: raises $0.75 to $1.75
xrf8tAXKQHG99HixCot1Iw: calls $0.75
*** FLOP *** [8d Qd Qc]
QiL+lEgEWwy21jk/ltaRLg: checks 
xrf8tAXKQHG99HixCot1Iw: bets $3
QiL+lEgEWwy21jk/ltaRLg: calls $3
*** TURN *** [8d Qd Qc] [9c]
QiL+lEgEWwy21jk/ltaRLg: checks 
xrf8tAXKQHG99HixCot1Iw: bets $4.75
QiL+lEgEWwy21jk/ltaRLg: raises $4.75 to $9.50
xrf8tAXKQHG99HixCot1Iw: raises $12.35 to $21.85 and is all-in
QiL+lEgEWwy21jk/ltaRLg: calls $10.55 and is all-in
Uncalled bet ($1.80) returned to xrf8tAXKQHG99HixCot1Iw
*** RIVER *** [8d Qd Qc 9c] [Tc]
*** SHOW DOWN ***
QiL+lEgEWwy21jk/ltaRLg: shows [Th Ts] (a full house, Tens full of Queens)
xrf8tAXKQHG99HixCot1Iw: mucks hand 
QiL+lEgEWwy21jk/ltaRLg collected $47.50 from pot
*** SUMMARY ***
Total pot $49.95 | Rake $2.45 
Board [8d Qd Qc 9c Tc]
Seat 1: QiL+lEgEWwy21jk/ltaRLg showed [Th Ts] and won ($47.50) with a full house, Tens full of Queens
Seat 2: xrf8tAXKQHG99HixCot1Iw (button) mucked
Seat 3: mfrkWA3PTeYPkbO6hi98Aw (small blind) folded before Flop
Seat 4: 4lJto+Qj0K4JrFKvHaPTLw (big blind) folded before Flop
Seat 5: FYepjhAvF8ZdVCmqHIy+eQ folded before Flop (didn't bet)
Seat 6: QvTX2yGq3uKJiKPmns4TKQ folded before Flop (didn't bet)




PokerStars Game #59941700574:  Hold'em No Limit ($0.10/$0.25) - 2009/07/01 1:43:25 ET
Table 'Mef6A0EMopL6WaFO5/KO9g' 6-max Seat #1 is the button
Seat 1: GbCVUNssQ7mqsPWr7J4d3w ($4.30 in chips) 
Seat 2: 8ClCHtFXGNplITm+63KB+Q ($31 in chips) 
Seat 3: Wq26opBLDGJe91GRJn2epg ($15.55 in chips) 
Seat 4: lquriepNQBhDV5P1SWHhnA ($25 in chips) 
Seat 5: DihMHaz4WNETH1bPDe13kA ($25 in chips) 
Seat 6: jp34e617tIzV8tKIWmfAbA ($33.30 in chips) 
8ClCHtFXGNplITm+63KB+Q: posts small blind $0.10
Wq26opBLDGJe91GRJn2epg: posts big blind $0.25
*** HOLE CARDS ***
lquriepNQBhDV5P1SWHhnA: raises $0.50 to $0.75
DihMHaz4WNETH1bPDe13kA: folds 
jp34e617tIzV8tKIWmfAbA: folds 
GbCVUNssQ7mqsPWr7J4d3w: folds 
8ClCHtFXGNplITm+63KB+Q: folds 
Wq26opBLDGJe91GRJn2epg: folds 
Uncalled bet ($0.50) returned to lquriepNQBhDV5P1SWHhnA
lquriepNQBhDV5P1SWHhnA collected $0.60 from pot
lquriepNQBhDV5P1SWHhnA: doesn't show hand 
*** SUMMARY ***
Total pot $0.60 | Rake $0 
Seat 1: GbCVUNssQ7mqsPWr7J4d3w (button) folded before Flop (didn't bet)
Seat 2: 8ClCHtFXGNplITm+63KB+Q (small blind) folded before Flop
Seat 3: Wq26opBLDGJe91GRJn2epg (big blind) folded before Flop
Seat 4: lquriepNQBhDV5P1SWHhnA collected ($0.60)
Seat 5: DihMHaz4WNETH1bPDe13kA folded before Flop (didn't bet)
Seat 6: jp34e617tIzV8tKIWmfAbA folded before Flop (didn't bet)




PokerStars Game #59941700486:  Hold'em No Limit ($0.10/$0.25) - 2009/07/01 1:43:25 ET
Table 'iMiAw/kTZXopgYX4HI7sHg' 9-max Seat #8 is the button
Seat 1: PdIasPkzm2sqZnN41ZRXOg ($4.65 in chips) 
Seat 2: qwr38jl5txoR36M7G5qi4A ($8.25 in chips) 
Seat 3: HPEB+AtKw1+C/cxU0o1ciw ($28.25 in chips) 
Seat 5: 22dIObOuor/A+IKWkNoAlA ($5.10 in chips) 
Seat 6: Bb42QRQMhg5/Y0vHP8/2Xw ($28.70 in chips) 
Seat 8: tLcDklc2rBORNfixyRfVfw ($29.55 in chips) 
7cv+9Zc9HIQHNvYsMfV3uA will be allowed to play after the button
PdIasPkzm2sqZnN41ZRXOg: posts small blind $0.10
qwr38jl5txoR36M7G5qi4A: posts big blind $0.25
Z9W7+g1WMhhZDi7DwGbCFA: sits out 
*** HOLE CARDS ***
HPEB+AtKw1+C/cxU0o1ciw: folds 
22dIObOuor/A+IKWkNoAlA: folds 
Bb42QRQMhg5/Y0vHP8/2Xw: folds 
tLcDklc2rBORNfixyRfVfw: folds 
flatform joins the table at seat #7 
PdIasPkzm2sqZnN41ZRXOg: folds 
Uncalled bet ($0.15) returned to qwr38jl5txoR36M7G5qi4A
qwr38jl5txoR36M7G5qi4A collected $0.20 from pot
qwr38jl5txoR36M7G5qi4A: doesn't show hand 
*** SUMMARY ***
Total pot $0.20 | Rake $0 
Seat 1: PdIasPkzm2sqZnN41ZRXOg (small blind) folded before Flop
Seat 2: qwr38jl5txoR36M7G5qi4A (big blind) collected ($0.20)
Seat 3: HPEB+AtKw1+C/cxU0o1ciw folded before Flop (didn't bet)
Seat 5: 22dIObOuor/A+IKWkNoAlA folded before Flop (didn't bet)
Seat 6: Bb42QRQMhg5/Y0vHP8/2Xw folded before Flop (didn't bet)
Seat 8: tLcDklc2rBORNfixyRfVfw (button) folded before Flop (didn't bet)




PokerStars Game #59941700730:  Hold'em No Limit ($0.10/$0.25) - 2009/07/01 1:43:25 ET
Table '3lS+sU5k6mwJCS2nFMmQ6Q' 9-max Seat #4 is the button
Seat 1: VWUWpMLMj/Q1jRVpF7Aohw ($13.45 in chips) 
Seat 3: 1DXccE2UUK5DIRVGlOKnTA ($12.70 in chips) 
Seat 4: ydoFOVgzvZv9ZhuWu9rXAw ($10.70 in chips) 
Seat 5: NcPAt5YjVvDFEJTTgAVj8g ($4.80 in chips) 
Seat 6: hJ4uYjNmSZdjrKA8cjZqCA ($36.50 in chips) 
Seat 7: Th3FldXKQW6hWVVPahaoOQ ($30.85 in chips) 
Seat 8: 9lvO/qyU+xrU95Teu1fv0g ($5 in chips) 
Seat 9: 4awUyiDYTgylQKXZ9faBVA ($49.20 in chips) 
NcPAt5YjVvDFEJTTgAVj8g: posts small blind $0.10
hJ4uYjNmSZdjrKA8cjZqCA: posts big blind $0.25
PdIasPkzm2sqZnN41ZRXOg: sits out 
*** HOLE CARDS ***
Th3FldXKQW6hWVVPahaoOQ: folds 
9lvO/qyU+xrU95Teu1fv0g: folds 
4awUyiDYTgylQKXZ9faBVA: folds 
VWUWpMLMj/Q1jRVpF7Aohw: folds 
1DXccE2UUK5DIRVGlOKnTA: calls $0.25
ydoFOVgzvZv9ZhuWu9rXAw: folds 
NcPAt5YjVvDFEJTTgAVj8g: calls $0.15
hJ4uYjNmSZdjrKA8cjZqCA: checks 
*** FLOP *** [Kc 7d 9c]
NcPAt5YjVvDFEJTTgAVj8g: checks 
hJ4uYjNmSZdjrKA8cjZqCA: checks 
1DXccE2UUK5DIRVGlOKnTA: checks 
*** TURN *** [Kc 7d 9c] [8s]
NcPAt5YjVvDFEJTTgAVj8g: bets $0.25
hJ4uYjNmSZdjrKA8cjZqCA: folds 
1DXccE2UUK5DIRVGlOKnTA: calls $0.25
*** RIVER *** [Kc 7d 9c 8s] [9h]
NcPAt5YjVvDFEJTTgAVj8g: bets $0.25
1DXccE2UUK5DIRVGlOKnTA: calls $0.25
*** SHOW DOWN ***
NcPAt5YjVvDFEJTTgAVj8g: shows [Kh 5d] (two pair, Kings and Nines)
1DXccE2UUK5DIRVGlOKnTA: mucks hand 
NcPAt5YjVvDFEJTTgAVj8g collected $1.70 from pot
*** SUMMARY ***
Total pot $1.75 | Rake $0.05 
Board [Kc 7d 9c 8s 9h]
Seat 1: VWUWpMLMj/Q1jRVpF7Aohw folded before Flop (didn't bet)
Seat 3: 1DXccE2UUK5DIRVGlOKnTA mucked
Seat 4: ydoFOVgzvZv9ZhuWu9rXAw (button) folded before Flop (didn't bet)
Seat 5: NcPAt5YjVvDFEJTTgAVj8g (small blind) showed [Kh 5d] and won ($1.70) with two pair, Kings and Nines
Seat 6: hJ4uYjNmSZdjrKA8cjZqCA (big blind) folded on the Turn
Seat 7: Th3FldXKQW6hWVVPahaoOQ folded before Flop (didn't bet)
Seat 8: 9lvO/qyU+xrU95Teu1fv0g folded before Flop (didn't bet)
Seat 9: 4awUyiDYTgylQKXZ9faBVA folded before Flop (didn't bet)




PokerStars Game #59941700670:  Hold'em No Limit ($0.10/$0.25) - 2009/07/01 1:43:25 ET
Table '+2VxGVfkEqJ1AYfQy/JH2w' 6-max Seat #5 is the button
Seat 1: if4dh6jhJXeN3/qd3qCp9g ($24.65 in chips) 
Seat 2: qllppsCmUqovlriIWCeM/g ($5.80 in chips) 
Seat 4: y+a/yGW/Jy4bPJFnaeTz5w ($16.60 in chips) 
Seat 5: XD1i5m5PvBDnRzJaG/vINw ($23.10 in chips) 
Seat 6: L3/N/gliETan8N5Gim5h4Q ($25.10 in chips) 
L3/N/gliETan8N5Gim5h4Q: posts small blind $0.10
if4dh6jhJXeN3/qd3qCp9g: posts big blind $0.25
epAUIB7h2FJXzUPRIvSkRA: sits out 
*** HOLE CARDS ***
qllppsCmUqovlriIWCeM/g: folds 
y+a/yGW/Jy4bPJFnaeTz5w: folds 
XD1i5m5PvBDnRzJaG/vINw: raises $0.50 to $0.75
L3/N/gliETan8N5Gim5h4Q: folds 
if4dh6jhJXeN3/qd3qCp9g: calls $0.50
*** FLOP *** [Qc 8d 4d]
if4dh6jhJXeN3/qd3qCp9g: checks 
XD1i5m5PvBDnRzJaG/vINw: checks 
*** TURN *** [Qc 8d 4d] [8s]
if4dh6jhJXeN3/qd3qCp9g: bets $1
XD1i5m5PvBDnRzJaG/vINw: folds 
Uncalled bet ($1) returned to if4dh6jhJXeN3/qd3qCp9g
if4dh6jhJXeN3/qd3qCp9g collected $1.55 from pot
if4dh6jhJXeN3/qd3qCp9g: doesn't show hand 
*** SUMMARY ***
Total pot $1.60 | Rake $0.05 
Board [Qc 8d 4d 8s]
Seat 1: if4dh6jhJXeN3/qd3qCp9g (big blind) collected ($1.55)
Seat 2: qllppsCmUqovlriIWCeM/g folded before Flop (didn't bet)
Seat 4: y+a/yGW/Jy4bPJFnaeTz5w folded before Flop (didn't bet)
Seat 5: XD1i5m5PvBDnRzJaG/vINw (button) folded on the Turn
Seat 6: L3/N/gliETan8N5Gim5h4Q (small blind) folded before Flop




PokerStars Game #59941700572:  Hold'em No Limit ($0.10/$0.25) - 2009/07/01 1:43:25 ET
Table 'emoxgHTxg9Uqeu06oLzLyg' 6-max Seat #2 is the button
Seat 2: wIFhgE1PVdX6Xf6aVlSTPg ($25.25 in chips) 
Seat 3: uD5epdBxuyc30pF1dO958Q ($10.75 in chips) 
Seat 4: 3VAbqAWh8ncE2SJOYIx2ZQ ($12 in chips) 
Seat 5: OIjOiBfQstWrK/RuXx7zcw ($5.55 in chips) 
Seat 6: iHZrkhpIO/3+tKuAoPx8HQ ($2.65 in chips) 
uD5epdBxuyc30pF1dO958Q: posts small blind $0.10
3VAbqAWh8ncE2SJOYIx2ZQ: posts big blind $0.25
epAUIB7h2FJXzUPRIvSkRA: sits out 
*** HOLE CARDS ***
OIjOiBfQstWrK/RuXx7zcw: raises $0.25 to $0.50
iHZrkhpIO/3+tKuAoPx8HQ: folds 
wIFhgE1PVdX6Xf6aVlSTPg: raises $0.40 to $0.90
uD5epdBxuyc30pF1dO958Q: calls $0.80
3VAbqAWh8ncE2SJOYIx2ZQ: folds 
OIjOiBfQstWrK/RuXx7zcw: calls $0.40
*** FLOP *** [2s 2d Th]
uD5epdBxuyc30pF1dO958Q: bets $0.25
OIjOiBfQstWrK/RuXx7zcw: raises $1 to $1.25
wIFhgE1PVdX6Xf6aVlSTPg: calls $1.25
uD5epdBxuyc30pF1dO958Q: folds 
*** TURN *** [2s 2d Th] [Kh]
OIjOiBfQstWrK/RuXx7zcw: checks 
wIFhgE1PVdX6Xf6aVlSTPg: checks 
*** RIVER *** [2s 2d Th Kh] [7h]
OIjOiBfQstWrK/RuXx7zcw: checks 
wIFhgE1PVdX6Xf6aVlSTPg: bets $2.85
OIjOiBfQstWrK/RuXx7zcw: folds 
Uncalled bet ($2.85) returned to wIFhgE1PVdX6Xf6aVlSTPg
wIFhgE1PVdX6Xf6aVlSTPg collected $5.45 from pot
wIFhgE1PVdX6Xf6aVlSTPg: doesn't show hand 
*** SUMMARY ***
Total pot $5.70 | Rake $0.25 
Board [2s 2d Th Kh 7h]
Seat 2: wIFhgE1PVdX6Xf6aVlSTPg (button) collected ($5.45)
Seat 3: uD5epdBxuyc30pF1dO958Q (small blind) folded on the Flop
Seat 4: 3VAbqAWh8ncE2SJOYIx2ZQ (big blind) folded before Flop
Seat 5: OIjOiBfQstWrK/RuXx7zcw folded on the River
Seat 6: iHZrkhpIO/3+tKuAoPx8HQ folded before Flop (didn't bet)




PokerStars Game #59941700880:  Hold'em No Limit ($0.10/$0.25) - 2009/07/01 1:43:25 ET
Table 'Utmw+yX+E/wdhNDIim90lQ' 9-max Seat #2 is the button
Seat 1: cZ99hugmLBj9KhTlc8nCSw ($30.70 in chips) 
Seat 2: iGMlK+EhUflPB6jKQd95Cg ($25 in chips) 
Seat 3: dfNim92Z6XK1/h5SFW5vDg ($25.05 in chips) 
Seat 4: ifYGvZDHQQ0aam4awTtHwA ($28.10 in chips) 
Seat 5: ghNKXUBl/H+t83JF079ZBA ($25 in chips) 
Seat 6: OlPJsgR4xypSg/w1z7Gyvw ($34.40 in chips) 
Seat 7: CImUHesK+ZER4v/VCA9IUg ($49.80 in chips) 
Seat 8: Mh2r9hTeTEDnh19sRZtW3g ($5 in chips) 
Seat 9: Th3FldXKQW6hWVVPahaoOQ ($28.50 in chips) 
dfNim92Z6XK1/h5SFW5vDg: posts small blind $0.10
ifYGvZDHQQ0aam4awTtHwA: posts big blind $0.25
*** HOLE CARDS ***
ghNKXUBl/H+t83JF079ZBA: folds 
OlPJsgR4xypSg/w1z7Gyvw: folds 
CImUHesK+ZER4v/VCA9IUg is disconnected 
CImUHesK+ZER4v/VCA9IUg is connected 
CImUHesK+ZER4v/VCA9IUg has timed out
CImUHesK+ZER4v/VCA9IUg: folds 
CImUHesK+ZER4v/VCA9IUg is sitting out
Mh2r9hTeTEDnh19sRZtW3g: folds 
Th3FldXKQW6hWVVPahaoOQ: folds 
cZ99hugmLBj9KhTlc8nCSw: folds 
iGMlK+EhUflPB6jKQd95Cg: raises $0.50 to $0.75
dfNim92Z6XK1/h5SFW5vDg: folds 
ifYGvZDHQQ0aam4awTtHwA: calls $0.50
*** FLOP *** [Tc As Kc]
ifYGvZDHQQ0aam4awTtHwA: bets $0.50
iGMlK+EhUflPB6jKQd95Cg: raises $1.25 to $1.75
ifYGvZDHQQ0aam4awTtHwA: calls $1.25
*** TURN *** [Tc As Kc] [9h]
ifYGvZDHQQ0aam4awTtHwA: checks 
iGMlK+EhUflPB6jKQd95Cg: bets $3.50
ifYGvZDHQQ0aam4awTtHwA: folds 
Uncalled bet ($3.50) returned to iGMlK+EhUflPB6jKQd95Cg
iGMlK+EhUflPB6jKQd95Cg collected $4.85 from pot
iGMlK+EhUflPB6jKQd95Cg: doesn't show hand 
*** SUMMARY ***
Total pot $5.10 | Rake $0.25 
Board [Tc As Kc 9h]
Seat 1: cZ99hugmLBj9KhTlc8nCSw folded before Flop (didn't bet)
Seat 2: iGMlK+EhUflPB6jKQd95Cg (button) collected ($4.85)
Seat 3: dfNim92Z6XK1/h5SFW5vDg (small blind) folded before Flop
Seat 4: ifYGvZDHQQ0aam4awTtHwA (big blind) folded on the Turn
Seat 5: ghNKXUBl/H+t83JF079ZBA folded before Flop (didn't bet)
Seat 6: OlPJsgR4xypSg/w1z7Gyvw folded before Flop (didn't bet)
Seat 7: CImUHesK+ZER4v/VCA9IUg folded before Flop (didn't bet)
Seat 8: Mh2r9hTeTEDnh19sRZtW3g folded before Flop (didn't bet)
Seat 9: Th3FldXKQW6hWVVPahaoOQ folded before Flop (didn't bet)




PokerStars Game #59941701180:  Hold'em No Limit ($0.10/$0.25) - 2009/07/01 1:43:26 ET
Table 'sJ4KpS2GE5Qrsu1/cFjJUw' 9-max Seat #4 is the button
Seat 1: eDlQ+S+6L4e6gM1dkZhGgQ ($20.20 in chips) 
Seat 2: tYsOBqdU1+x+yFI7zHO7hQ ($31.75 in chips) 
Seat 3: eK8qa6EPcH2zhtbmWSvc9g ($25 in chips) 
Seat 4: npAYqa85pqnzfOK5ukX+BQ ($19.15 in chips) 
Seat 5: Q/gZC63lfOMr7YhWKPCxoQ ($9.35 in chips) 
Seat 6: OefE+Csvj5KR7ClGf3Hc2g ($2.85 in chips) 
Seat 7: Wi8djHgewBlVhpKWfp7isQ ($7.50 in chips) 
Seat 8: S7Ki0P+0AIGPuIfGJjW0gg ($29.70 in chips) 
Seat 9: 3PmVnC/15cl4oyI1TKIt4g ($4.75 in chips) 
Q/gZC63lfOMr7YhWKPCxoQ: posts small blind $0.10
OefE+Csvj5KR7ClGf3Hc2g: posts big blind $0.25
*** HOLE CARDS ***
Wi8djHgewBlVhpKWfp7isQ: folds 
S7Ki0P+0AIGPuIfGJjW0gg: folds 
3PmVnC/15cl4oyI1TKIt4g: folds 
eDlQ+S+6L4e6gM1dkZhGgQ: calls $0.25
tYsOBqdU1+x+yFI7zHO7hQ: folds 
eK8qa6EPcH2zhtbmWSvc9g: folds 
npAYqa85pqnzfOK5ukX+BQ: folds 
Q/gZC63lfOMr7YhWKPCxoQ: calls $0.15
OefE+Csvj5KR7ClGf3Hc2g: checks 
*** FLOP *** [5c 8h 6s]
Q/gZC63lfOMr7YhWKPCxoQ: checks 
OefE+Csvj5KR7ClGf3Hc2g: checks 
eDlQ+S+6L4e6gM1dkZhGgQ: checks 
*** TURN *** [5c 8h 6s] [Ks]
Q/gZC63lfOMr7YhWKPCxoQ: checks 
OefE+Csvj5KR7ClGf3Hc2g: bets $0.50
eDlQ+S+6L4e6gM1dkZhGgQ: calls $0.50
Q/gZC63lfOMr7YhWKPCxoQ: folds 
*** RIVER *** [5c 8h 6s Ks] [Qd]
OefE+Csvj5KR7ClGf3Hc2g: bets $0.75
eDlQ+S+6L4e6gM1dkZhGgQ: calls $0.75
*** SHOW DOWN ***
OefE+Csvj5KR7ClGf3Hc2g: shows [Kh Qc] (two pair, Kings and Queens)
eDlQ+S+6L4e6gM1dkZhGgQ: mucks hand 
OefE+Csvj5KR7ClGf3Hc2g collected $3.10 from pot
*** SUMMARY ***
Total pot $3.25 | Rake $0.15 
Board [5c 8h 6s Ks Qd]
Seat 1: eDlQ+S+6L4e6gM1dkZhGgQ mucked
Seat 2: tYsOBqdU1+x+yFI7zHO7hQ folded before Flop (didn't bet)
Seat 3: eK8qa6EPcH2zhtbmWSvc9g folded before Flop (didn't bet)
Seat 4: npAYqa85pqnzfOK5ukX+BQ (button) folded before Flop (didn't bet)
Seat 5: Q/gZC63lfOMr7YhWKPCxoQ (small blind) folded on the Turn
Seat 6: OefE+Csvj5KR7ClGf3Hc2g (big blind) showed [Kh Qc] and won ($3.10) with two pair, Kings and Queens
Seat 7: Wi8djHgewBlVhpKWfp7isQ folded before Flop (didn't bet)
Seat 8: S7Ki0P+0AIGPuIfGJjW0gg folded before Flop (didn't bet)
Seat 9: 3PmVnC/15cl4oyI1TKIt4g folded before Flop (didn't bet)




PokerStars Game #59941701084:  Hold'em No Limit ($0.10/$0.25) - 2009/07/01 1:43:26 ET
Table 'rO1I30HnuCPB0M8qEX1TCQ' 9-max Seat #5 is the button
Seat 1: dfsOFy2nKDeSF9SjtdIyVA ($11.75 in chips) 
Seat 2: z1hPotrGOZjUjyoopZ7Ulg ($21.70 in chips) 
Seat 3: 2wcFsZsqEP5w1StUTVzJCg ($13.15 in chips) 
Seat 4: yyG4svzOpC1A+sUP/scg6w ($10.40 in chips) 
Seat 5: W6tExOcYX7qiy6Qdp+ZwFA ($5.10 in chips) 
Seat 6: 5n7e7I+px7c6CQmLpPbtsg ($4.75 in chips) 
Seat 7: bXpVeaSTPBFSPJmeXxO7nw ($5 in chips) 
Seat 8: 6mStmDUknIn/RyBEoiIyoQ ($3.20 in chips) 
Seat 9: AiXn/9o1EwOPZUHujnh/bA ($21.90 in chips) 
5n7e7I+px7c6CQmLpPbtsg: posts small blind $0.10
bXpVeaSTPBFSPJmeXxO7nw: posts big blind $0.25
*** HOLE CARDS ***
6mStmDUknIn/RyBEoiIyoQ: raises $0.50 to $0.75
AiXn/9o1EwOPZUHujnh/bA: folds 
AiXn/9o1EwOPZUHujnh/bA leaves the table
dfsOFy2nKDeSF9SjtdIyVA: calls $0.75
z1hPotrGOZjUjyoopZ7Ulg: folds 
ValerbI4_K joins the table at seat #9 
2wcFsZsqEP5w1StUTVzJCg: folds 
yyG4svzOpC1A+sUP/scg6w: folds 
W6tExOcYX7qiy6Qdp+ZwFA: folds 
5n7e7I+px7c6CQmLpPbtsg: folds 
bXpVeaSTPBFSPJmeXxO7nw: folds 
*** FLOP *** [Ts Tc Qd]
6mStmDUknIn/RyBEoiIyoQ: checks 
dfsOFy2nKDeSF9SjtdIyVA: bets $0.25
6mStmDUknIn/RyBEoiIyoQ: raises $0.25 to $0.50
dfsOFy2nKDeSF9SjtdIyVA: calls $0.25
*** TURN *** [Ts Tc Qd] [2d]
6mStmDUknIn/RyBEoiIyoQ: checks 
dfsOFy2nKDeSF9SjtdIyVA: checks 
*** RIVER *** [Ts Tc Qd 2d] [5s]
6mStmDUknIn/RyBEoiIyoQ: checks 
dfsOFy2nKDeSF9SjtdIyVA: bets $0.25
6mStmDUknIn/RyBEoiIyoQ: calls $0.25
*** SHOW DOWN ***
dfsOFy2nKDeSF9SjtdIyVA: shows [Qh 9c] (two pair, Queens and Tens)
6mStmDUknIn/RyBEoiIyoQ: mucks hand 
dfsOFy2nKDeSF9SjtdIyVA collected $3.20 from pot
*** SUMMARY ***
Total pot $3.35 | Rake $0.15 
Board [Ts Tc Qd 2d 5s]
Seat 1: dfsOFy2nKDeSF9SjtdIyVA showed [Qh 9c] and won ($3.20) with two pair, Queens and Tens
Seat 2: z1hPotrGOZjUjyoopZ7Ulg folded before Flop (didn't bet)
Seat 3: 2wcFsZsqEP5w1StUTVzJCg folded before Flop (didn't bet)
Seat 4: yyG4svzOpC1A+sUP/scg6w folded before Flop (didn't bet)
Seat 5: W6tExOcYX7qiy6Qdp+ZwFA (button) folded before Flop (didn't bet)
Seat 6: 5n7e7I+px7c6CQmLpPbtsg (small blind) folded before Flop
Seat 7: bXpVeaSTPBFSPJmeXxO7nw (big blind) folded before Flop
Seat 8: 6mStmDUknIn/RyBEoiIyoQ mucked
Seat 9: AiXn/9o1EwOPZUHujnh/bA folded before Flop (didn't bet)




PokerStars Game #59941701262:  Hold'em No Limit ($0.10/$0.25) - 2009/07/01 1:43:26 ET
Table 'jxoHy9yJy0bbH/Qx73FoPA' 9-max Seat #3 is the button
Seat 1: j4q3p0lesp63b1gZDwLBZw ($6.60 in chips) 
Seat 2: F7pnn6czNpHvRM55XcA2EA ($45.50 in chips) 
Seat 3: CVqCt93Mk0MhKMaZ4LZDSQ ($11.20 in chips) 
Seat 4: A1M0JIGHzqMXp7L2MdcxXw ($26.40 in chips) 
Seat 5: rzZ3wFcwoPyKlQ0mB5JLRQ ($5 in chips) 
Seat 6: tYsOBqdU1+x+yFI7zHO7hQ ($38.85 in chips) 
Seat 7: wGigCmBR/9XWkPpvYos3aQ ($26.40 in chips) 
Seat 9: CvL9Ch1HYCVbTsfpNucitg ($4.90 in chips) 
A1M0JIGHzqMXp7L2MdcxXw: posts small blind $0.10
rzZ3wFcwoPyKlQ0mB5JLRQ: posts big blind $0.25
Z9W7+g1WMhhZDi7DwGbCFA: sits out 
*** HOLE CARDS ***
tYsOBqdU1+x+yFI7zHO7hQ: folds 
wGigCmBR/9XWkPpvYos3aQ: folds 
CvL9Ch1HYCVbTsfpNucitg: folds 
j4q3p0lesp63b1gZDwLBZw: folds 
F7pnn6czNpHvRM55XcA2EA: folds 
CVqCt93Mk0MhKMaZ4LZDSQ: folds 
A1M0JIGHzqMXp7L2MdcxXw: folds 
Uncalled bet ($0.15) returned to rzZ3wFcwoPyKlQ0mB5JLRQ
rzZ3wFcwoPyKlQ0mB5JLRQ collected $0.20 from pot
*** SUMMARY ***
Total pot $0.20 | Rake $0 
Seat 1: j4q3p0lesp63b1gZDwLBZw folded before Flop (didn't bet)
Seat 2: F7pnn6czNpHvRM55XcA2EA folded before Flop (didn't bet)
Seat 3: CVqCt93Mk0MhKMaZ4LZDSQ (button) folded before Flop (didn't bet)
Seat 4: A1M0JIGHzqMXp7L2MdcxXw (small blind) folded before Flop
Seat 5: rzZ3wFcwoPyKlQ0mB5JLRQ (big blind) collected ($0.20)
Seat 6: tYsOBqdU1+x+yFI7zHO7hQ folded before Flop (didn't bet)
Seat 7: wGigCmBR/9XWkPpvYos3aQ folded before Flop (didn't bet)
Seat 9: CvL9Ch1HYCVbTsfpNucitg folded before Flop (didn't bet)




PokerStars Game #59941701148:  Hold'em No Limit ($0.10/$0.25) - 2009/07/01 1:43:26 ET
Table 'NfXsh0UQA+o/kO9acV3WxA' 9-max Seat #2 is the button
Seat 1: pN3IHvAKm2fz+sTRARTcrg ($24.65 in chips) 
Seat 2: mhpFs2SZupy4zLRb62FLFA ($25 in chips) 
Seat 3: wCUaomJ6Nq5zomVGdUHP+w ($19.60 in chips) 
Seat 4: r6hsffOo1iKmaPYKwAZmFw ($30.05 in chips) 
Seat 6: cFmpjvcjNoVAEAIQIxWkYg ($26.15 in chips) 
Seat 7: yqkowiRWZ6NvRN9UUkYIlA ($5 in chips) 
Seat 8: +sbyWwIcFp9kP0bDtMegfQ ($41.75 in chips) 
Seat 9: uhrboV251dcgYniYTdFIcA ($25 in chips) 
wCUaomJ6Nq5zomVGdUHP+w: posts small blind $0.10
r6hsffOo1iKmaPYKwAZmFw: posts big blind $0.25
zgi+EUykT/pZQpoUG6+oEg: sits out 
*** HOLE CARDS ***
cFmpjvcjNoVAEAIQIxWkYg: folds 
yqkowiRWZ6NvRN9UUkYIlA: folds 
+sbyWwIcFp9kP0bDtMegfQ: folds 
uhrboV251dcgYniYTdFIcA: raises $0.75 to $1
pN3IHvAKm2fz+sTRARTcrg: folds 
mhpFs2SZupy4zLRb62FLFA: folds 
wCUaomJ6Nq5zomVGdUHP+w: folds 
r6hsffOo1iKmaPYKwAZmFw: folds 
Uncalled bet ($0.75) returned to uhrboV251dcgYniYTdFIcA
uhrboV251dcgYniYTdFIcA collected $0.60 from pot
uhrboV251dcgYniYTdFIcA: doesn't show hand 
*** SUMMARY ***
Total pot $0.60 | Rake $0 
Seat 1: pN3IHvAKm2fz+sTRARTcrg folded before Flop (didn't bet)
Seat 2: mhpFs2SZupy4zLRb62FLFA (button) folded before Flop (didn't bet)
Seat 3: wCUaomJ6Nq5zomVGdUHP+w (small blind) folded before Flop
Seat 4: r6hsffOo1iKmaPYKwAZmFw (big blind) folded before Flop
Seat 6: cFmpjvcjNoVAEAIQIxWkYg folded before Flop (didn't bet)
Seat 7: yqkowiRWZ6NvRN9UUkYIlA folded before Flop (didn't bet)
Seat 8: +sbyWwIcFp9kP0bDtMegfQ folded before Flop (didn't bet)
Seat 9: uhrboV251dcgYniYTdFIcA collected ($0.60)




PokerStars Game #59941701178:  Hold'em No Limit ($0.10/$0.25) - 2009/07/01 1:43:26 ET
Table 'NgexmgEDEzICBeSO7YCrKQ' 6-max Seat #6 is the button
Seat 1: cezpHJ8FB07dj0xG+LhOvw ($29.55 in chips) 
Seat 2: 32YL2ZEp8NT4JB2RVM9euQ ($21.90 in chips) 
Seat 3: JFIAqU8lCZ0vWwEl4bdGsg ($26.85 in chips) 
Seat 4: xx+iYCDJhHJmNzrfeloyEg ($28.15 in chips) 
Seat 5: /MXkdT8TTs8Qp2LVTQNw6w ($37.80 in chips) 
Seat 6: k9nHZTHt8hYhYRcW8NTb4g ($10.60 in chips) 
cezpHJ8FB07dj0xG+LhOvw: posts small blind $0.10
32YL2ZEp8NT4JB2RVM9euQ: posts big blind $0.25
*** HOLE CARDS ***
JFIAqU8lCZ0vWwEl4bdGsg: folds 
xx+iYCDJhHJmNzrfeloyEg: folds 
/MXkdT8TTs8Qp2LVTQNw6w: folds 
k9nHZTHt8hYhYRcW8NTb4g: raises $0.50 to $0.75
cezpHJ8FB07dj0xG+LhOvw: folds 
32YL2ZEp8NT4JB2RVM9euQ: folds 
Uncalled bet ($0.50) returned to k9nHZTHt8hYhYRcW8NTb4g
k9nHZTHt8hYhYRcW8NTb4g collected $0.60 from pot
k9nHZTHt8hYhYRcW8NTb4g: doesn't show hand 
/MXkdT8TTs8Qp2LVTQNw6w said, "i won ten cents with mine ;)"
*** SUMMARY ***
Total pot $0.60 | Rake $0 
Seat 1: cezpHJ8FB07dj0xG+LhOvw (small blind) folded before Flop
Seat 2: 32YL2ZEp8NT4JB2RVM9euQ (big blind) folded before Flop
Seat 3: JFIAqU8lCZ0vWwEl4bdGsg folded before Flop (didn't bet)
Seat 4: xx+iYCDJhHJmNzrfeloyEg folded before Flop (didn't bet)
Seat 5: /MXkdT8TTs8Qp2LVTQNw6w folded before Flop (didn't bet)
Seat 6: k9nHZTHt8hYhYRcW8NTb4g (button) collected ($0.60)




PokerStars Game #59941701426:  Hold'em No Limit ($0.10/$0.25) - 2009/07/01 1:43:26 ET
Table '4XGDnEByOol5up4aB2KbJw' 6-max Seat #6 is the button
Seat 1: kyRaCIljYA6l33lSKQfNsg ($26.60 in chips) 
Seat 2: SFmT9ZsVopnukjvAzrxTRg ($44.15 in chips) 
Seat 3: LtASJ9OlkqGrrUKGQlpGAw ($20.55 in chips) 
Seat 4: BV+K0Phf5VBHr7aZPKqbUQ ($26.50 in chips) 
Seat 5: Dh01+rohD2p9pXLYeBlC5Q ($16.75 in chips) 
Seat 6: a7Ux7aERFGCbT/L3ojVfAg ($9 in chips) 
kyRaCIljYA6l33lSKQfNsg: posts small blind $0.10
SFmT9ZsVopnukjvAzrxTRg: posts big blind $0.25
*** HOLE CARDS ***
LtASJ9OlkqGrrUKGQlpGAw: folds 
BV+K0Phf5VBHr7aZPKqbUQ: raises $0.50 to $0.75
Dh01+rohD2p9pXLYeBlC5Q: folds 
a7Ux7aERFGCbT/L3ojVfAg: folds 
kyRaCIljYA6l33lSKQfNsg: folds 
SFmT9ZsVopnukjvAzrxTRg: calls $0.50
*** FLOP *** [9s Jd 4d]
SFmT9ZsVopnukjvAzrxTRg: bets $1
BV+K0Phf5VBHr7aZPKqbUQ: folds 
Uncalled bet ($1) returned to SFmT9ZsVopnukjvAzrxTRg
SFmT9ZsVopnukjvAzrxTRg collected $1.55 from pot
SFmT9ZsVopnukjvAzrxTRg: doesn't show hand 
*** SUMMARY ***
Total pot $1.60 | Rake $0.05 
Board [9s Jd 4d]
Seat 1: kyRaCIljYA6l33lSKQfNsg (small blind) folded before Flop
Seat 2: SFmT9ZsVopnukjvAzrxTRg (big blind) collected ($1.55)
Seat 3: LtASJ9OlkqGrrUKGQlpGAw folded before Flop (didn't bet)
Seat 4: BV+K0Phf5VBHr7aZPKqbUQ folded on the Flop
Seat 5: Dh01+rohD2p9pXLYeBlC5Q folded before Flop (didn't bet)
Seat 6: a7Ux7aERFGCbT/L3ojVfAg (button) folded before Flop (didn't bet)




PokerStars Game #59941701114:  Hold'em No Limit ($0.10/$0.25) - 2009/07/01 1:43:26 ET
Table 'rjcb+nlE+0GuJ6lBhuCkkA' 6-max Seat #3 is the button
Seat 1: lBoEwOFgzcERLIRUkUoRTw ($13.60 in chips) 
Seat 2: lJphax9e7/+O/3YCKPJ0yQ ($6.35 in chips) 
Seat 3: 8ClCHtFXGNplITm+63KB+Q ($66.15 in chips) 
Seat 4: BV+K0Phf5VBHr7aZPKqbUQ ($25.10 in chips) 
Seat 5: GC/9yVD59DUCX7hUI7gcLw ($41.75 in chips) 
Seat 6: 32YL2ZEp8NT4JB2RVM9euQ ($15.65 in chips) 
BV+K0Phf5VBHr7aZPKqbUQ: posts small blind $0.10
GC/9yVD59DUCX7hUI7gcLw: posts big blind $0.25
*** HOLE CARDS ***
32YL2ZEp8NT4JB2RVM9euQ: folds 
lBoEwOFgzcERLIRUkUoRTw: folds 
lJphax9e7/+O/3YCKPJ0yQ has timed out
lJphax9e7/+O/3YCKPJ0yQ: folds 
lJphax9e7/+O/3YCKPJ0yQ is sitting out
8ClCHtFXGNplITm+63KB+Q: folds 
lJphax9e7/+O/3YCKPJ0yQ has returned
BV+K0Phf5VBHr7aZPKqbUQ: calls $0.15
GC/9yVD59DUCX7hUI7gcLw: raises $0.75 to $1
BV+K0Phf5VBHr7aZPKqbUQ: calls $0.75
*** FLOP *** [Jd 4d Qd]
BV+K0Phf5VBHr7aZPKqbUQ: checks 
GC/9yVD59DUCX7hUI7gcLw: bets $1.25
BV+K0Phf5VBHr7aZPKqbUQ: calls $1.25
*** TURN *** [Jd 4d Qd] [Ad]
BV+K0Phf5VBHr7aZPKqbUQ: checks 
GC/9yVD59DUCX7hUI7gcLw: bets $3
BV+K0Phf5VBHr7aZPKqbUQ: calls $3
*** RIVER *** [Jd 4d Qd Ad] [3c]
BV+K0Phf5VBHr7aZPKqbUQ: checks 
GC/9yVD59DUCX7hUI7gcLw: bets $7.25
BV+K0Phf5VBHr7aZPKqbUQ: calls $7.25
*** SHOW DOWN ***
GC/9yVD59DUCX7hUI7gcLw: shows [Qs 9s] (a pair of Queens)
BV+K0Phf5VBHr7aZPKqbUQ: shows [Th Kh] (a straight, Ten to Ace)
BV+K0Phf5VBHr7aZPKqbUQ collected $23.80 from pot
*** SUMMARY ***
Total pot $25 | Rake $1.20 
Board [Jd 4d Qd Ad 3c]
Seat 1: lBoEwOFgzcERLIRUkUoRTw folded before Flop (didn't bet)
Seat 2: lJphax9e7/+O/3YCKPJ0yQ folded before Flop (didn't bet)
Seat 3: 8ClCHtFXGNplITm+63KB+Q (button) folded before Flop (didn't bet)
Seat 4: BV+K0Phf5VBHr7aZPKqbUQ (small blind) showed [Th Kh] and won ($23.80) with a straight, Ten to Ace
Seat 5: GC/9yVD59DUCX7hUI7gcLw (big blind) showed [Qs 9s] and lost with a pair of Queens
Seat 6: 32YL2ZEp8NT4JB2RVM9euQ folded before Flop (didn't bet)




PokerStars Game #59941701500:  Hold'em No Limit ($0.10/$0.25) - 2009/07/01 1:43:26 ET
Table 'APEHQjIcZHDZUA4iOjju2g' 6-max Seat #1 is the button
Seat 1: DE9hRlt14g+JdsRQ4wT7hg ($25 in chips) 
Seat 2: 3zD3qLXT1bEffAoWGnc7wg ($36.35 in chips) 
Seat 3: 3e/idKqDuPE10t6Zvr//SQ ($24.65 in chips) 
Seat 4: w2mQ4VsGljGwWXydz8tw2A ($37.75 in chips) 
Seat 5: /xN6gc9+8Hew0HxaB6VIVg ($43.90 in chips) 
Seat 6: KXtdqb+rIMkjc0RvHDksGQ ($25.95 in chips) 
3zD3qLXT1bEffAoWGnc7wg: posts small blind $0.10
3e/idKqDuPE10t6Zvr//SQ: posts big blind $0.25
*** HOLE CARDS ***
w2mQ4VsGljGwWXydz8tw2A: folds 
/xN6gc9+8Hew0HxaB6VIVg: raises $0.25 to $0.50
KXtdqb+rIMkjc0RvHDksGQ: folds 
DE9hRlt14g+JdsRQ4wT7hg: folds 
3zD3qLXT1bEffAoWGnc7wg: folds 
3e/idKqDuPE10t6Zvr//SQ: calls $0.25
*** FLOP *** [8h Ah 6h]
3e/idKqDuPE10t6Zvr//SQ: checks 
/xN6gc9+8Hew0HxaB6VIVg: bets $1
3e/idKqDuPE10t6Zvr//SQ: folds 
Uncalled bet ($1) returned to /xN6gc9+8Hew0HxaB6VIVg
/xN6gc9+8Hew0HxaB6VIVg collected $1.05 from pot
/xN6gc9+8Hew0HxaB6VIVg: doesn't show hand 
*** SUMMARY ***
Total pot $1.10 | Rake $0.05 
Board [8h Ah 6h]
Seat 1: DE9hRlt14g+JdsRQ4wT7hg (button) folded before Flop (didn't bet)
Seat 2: 3zD3qLXT1bEffAoWGnc7wg (small blind) folded before Flop
Seat 3: 3e/idKqDuPE10t6Zvr//SQ (big blind) folded on the Flop
Seat 4: w2mQ4VsGljGwWXydz8tw2A folded before Flop (didn't bet)
Seat 5: /xN6gc9+8Hew0HxaB6VIVg collected ($1.05)
Seat 6: KXtdqb+rIMkjc0RvHDksGQ folded before Flop (didn't bet)




PokerStars Game #59941702026:  Hold'em No Limit ($0.10/$0.25) - 2009/07/01 1:43:27 ET
Table 'Is9eNmJA1KnBOw0lcVkxUQ' 9-max Seat #9 is the button
Seat 1: 56S3mA6Zs3pGR+0p0vUCtg ($32.10 in chips) 
Seat 2: VllYilcih0t+gMD4GTRlgQ ($37.85 in chips) 
Seat 3: ubsjZomMWSV0hAiBLa7K1A ($19.75 in chips) 
Seat 4: cZ99hugmLBj9KhTlc8nCSw ($25 in chips) 
Seat 6: HapyJHxV6lc3eqoT7yWL2A ($32.85 in chips) 
Seat 7: aNpwfA31EREwO+ar4XzBCw ($29.05 in chips) 
Seat 8: Th3FldXKQW6hWVVPahaoOQ ($25.50 in chips) 
Seat 9: DdPXdieucQ+n99u1n3A+rQ ($4.90 in chips) 
56S3mA6Zs3pGR+0p0vUCtg: posts small blind $0.10
VllYilcih0t+gMD4GTRlgQ: posts big blind $0.25
Qduu7ikeizo6q6Ei9YvcJA: sits out 
*** HOLE CARDS ***
ubsjZomMWSV0hAiBLa7K1A: calls $0.25
cZ99hugmLBj9KhTlc8nCSw: folds 
HapyJHxV6lc3eqoT7yWL2A: calls $0.25
aNpwfA31EREwO+ar4XzBCw: folds 
Th3FldXKQW6hWVVPahaoOQ: folds 
DdPXdieucQ+n99u1n3A+rQ: folds 
56S3mA6Zs3pGR+0p0vUCtg: folds 
VllYilcih0t+gMD4GTRlgQ: checks 
*** FLOP *** [Kh Js 5c]
VllYilcih0t+gMD4GTRlgQ: checks 
ubsjZomMWSV0hAiBLa7K1A: checks 
HapyJHxV6lc3eqoT7yWL2A: bets $0.50
VllYilcih0t+gMD4GTRlgQ: folds 
ubsjZomMWSV0hAiBLa7K1A: folds 
Uncalled bet ($0.50) returned to HapyJHxV6lc3eqoT7yWL2A
HapyJHxV6lc3eqoT7yWL2A collected $0.85 from pot
HapyJHxV6lc3eqoT7yWL2A: doesn't show hand 
*** SUMMARY ***
Total pot $0.85 | Rake $0 
Board [Kh Js 5c]
Seat 1: 56S3mA6Zs3pGR+0p0vUCtg (small blind) folded before Flop
Seat 2: VllYilcih0t+gMD4GTRlgQ (big blind) folded on the Flop
Seat 3: ubsjZomMWSV0hAiBLa7K1A folded on the Flop
Seat 4: cZ99hugmLBj9KhTlc8nCSw folded before Flop (didn't bet)
Seat 6: HapyJHxV6lc3eqoT7yWL2A collected ($0.85)
Seat 7: aNpwfA31EREwO+ar4XzBCw folded before Flop (didn't bet)
Seat 8: Th3FldXKQW6hWVVPahaoOQ folded before Flop (didn't bet)
Seat 9: DdPXdieucQ+n99u1n3A+rQ (button) folded before Flop (didn't bet)




PokerStars Game #59941702092:  Hold'em No Limit ($0.10/$0.25) - 2009/07/01 1:43:27 ET
Table 'aaXqTKUnxrX9DYXtxhWXxA' 6-max Seat #3 is the button
Seat 2: DE9hRlt14g+JdsRQ4wT7hg ($33.70 in chips) 
Seat 3: uUXdcVMNa05rfbntdvplfw ($9 in chips) 
Seat 4: 48oT5xFI+5CHUJlfoGrE4w ($10.65 in chips) 
Seat 5: kyRaCIljYA6l33lSKQfNsg ($26.95 in chips) 
Seat 6: buyjetgNT1McXtdaP4zynA ($47.45 in chips) 
48oT5xFI+5CHUJlfoGrE4w: posts small blind $0.10
kyRaCIljYA6l33lSKQfNsg: posts big blind $0.25
*** HOLE CARDS ***
buyjetgNT1McXtdaP4zynA: calls $0.25
DE9hRlt14g+JdsRQ4wT7hg: folds 
uUXdcVMNa05rfbntdvplfw: raises $0.75 to $1
48oT5xFI+5CHUJlfoGrE4w: calls $0.90
kyRaCIljYA6l33lSKQfNsg: folds 
buyjetgNT1McXtdaP4zynA: calls $0.75
*** FLOP *** [Js 9d 7h]
48oT5xFI+5CHUJlfoGrE4w: checks 
buyjetgNT1McXtdaP4zynA: bets $2
uUXdcVMNa05rfbntdvplfw: folds 
aSrj4lVmn2owyQ1RbbOqxQ joins the table at seat #1 
48oT5xFI+5CHUJlfoGrE4w: folds 
Uncalled bet ($2) returned to buyjetgNT1McXtdaP4zynA
buyjetgNT1McXtdaP4zynA collected $3.10 from pot
*** SUMMARY ***
Total pot $3.25 | Rake $0.15 
Board [Js 9d 7h]
Seat 2: DE9hRlt14g+JdsRQ4wT7hg folded before Flop (didn't bet)
Seat 3: uUXdcVMNa05rfbntdvplfw (button) folded on the Flop
Seat 4: 48oT5xFI+5CHUJlfoGrE4w (small blind) folded on the Flop
Seat 5: kyRaCIljYA6l33lSKQfNsg (big blind) folded before Flop
Seat 6: buyjetgNT1McXtdaP4zynA collected ($3.10)




PokerStars Game #59941702228:  Hold'em No Limit ($0.10/$0.25) - 2009/07/01 1:43:28 ET
Table 'IIO2q2znuuAXmiZ2qFTcmg' 6-max Seat #6 is the button
Seat 2: cS21pIxRHx5Gt42o7hPZzw ($24.55 in chips) 
Seat 3: L3/N/gliETan8N5Gim5h4Q ($25 in chips) 
Seat 4: tSR4329m40dZsN7YOpI9Kw ($58.50 in chips) 
Seat 5: 9U3ZKjCsarN0DjR6mSE8Ug ($14 in chips) 
Seat 6: aogAb4Eienxztk8p2v9VVw ($37.10 in chips) 
cS21pIxRHx5Gt42o7hPZzw: posts small blind $0.10
L3/N/gliETan8N5Gim5h4Q: posts big blind $0.25
*** HOLE CARDS ***
tSR4329m40dZsN7YOpI9Kw: folds 
9U3ZKjCsarN0DjR6mSE8Ug: folds 
aogAb4Eienxztk8p2v9VVw: folds 
cS21pIxRHx5Gt42o7hPZzw: folds 
Uncalled bet ($0.15) returned to L3/N/gliETan8N5Gim5h4Q
L3/N/gliETan8N5Gim5h4Q collected $0.20 from pot
L3/N/gliETan8N5Gim5h4Q: doesn't show hand 
*** SUMMARY ***
Total pot $0.20 | Rake $0 
Seat 2: cS21pIxRHx5Gt42o7hPZzw (small blind) folded before Flop
Seat 3: L3/N/gliETan8N5Gim5h4Q (big blind) collected ($0.20)
Seat 4: tSR4329m40dZsN7YOpI9Kw folded before Flop (didn't bet)
Seat 5: 9U3ZKjCsarN0DjR6mSE8Ug folded before Flop (didn't bet)
Seat 6: aogAb4Eienxztk8p2v9VVw (button) folded before Flop (didn't bet)




PokerStars Game #59941702468:  Hold'em No Limit ($0.10/$0.25) - 2009/07/01 1:43:28 ET
Table 'AJGgX1ZYM8d68SWMvaLttg' 6-max Seat #3 is the button
Seat 2: zHHLkD2sRljslKKeQv/ZQw ($28.60 in chips) 
Seat 3: 8ClCHtFXGNplITm+63KB+Q ($36.85 in chips) 
Seat 4: Lz/GjRDgmgepqTR7qmS86w ($25.15 in chips) 
Seat 5: Hsvkc0/G2VV78oVmWYXecw ($5.35 in chips) 
Seat 6: UA5OsKS3VPaxa7uC8La/kA ($64.40 in chips) 
Lz/GjRDgmgepqTR7qmS86w: posts small blind $0.10
Hsvkc0/G2VV78oVmWYXecw: posts big blind $0.25
*** HOLE CARDS ***
UA5OsKS3VPaxa7uC8La/kA: calls $0.25
zHHLkD2sRljslKKeQv/ZQw: raises $0.75 to $1
8ClCHtFXGNplITm+63KB+Q: folds 
Lz/GjRDgmgepqTR7qmS86w: folds 
Hsvkc0/G2VV78oVmWYXecw: folds 
UA5OsKS3VPaxa7uC8La/kA: calls $0.75
*** FLOP *** [4d Qd Jc]
UA5OsKS3VPaxa7uC8La/kA: checks 
zHHLkD2sRljslKKeQv/ZQw: bets $1.25
UA5OsKS3VPaxa7uC8La/kA: folds 
Uncalled bet ($1.25) returned to zHHLkD2sRljslKKeQv/ZQw
zHHLkD2sRljslKKeQv/ZQw collected $2.25 from pot
*** SUMMARY ***
Total pot $2.35 | Rake $0.10 
Board [4d Qd Jc]
Seat 2: zHHLkD2sRljslKKeQv/ZQw collected ($2.25)
Seat 3: 8ClCHtFXGNplITm+63KB+Q (button) folded before Flop (didn't bet)
Seat 4: Lz/GjRDgmgepqTR7qmS86w (small blind) folded before Flop
Seat 5: Hsvkc0/G2VV78oVmWYXecw (big blind) folded before Flop
Seat 6: UA5OsKS3VPaxa7uC8La/kA folded on the Flop




PokerStars Game #59941702352:  Hold'em No Limit ($0.10/$0.25) - 2009/07/01 1:43:28 ET
Table '2clPgY3+dETPD/8zjXZdFw' 6-max Seat #3 is the button
Seat 1: 4WFKzsjLSGnvHbVxKabsvQ ($31.05 in chips) 
Seat 2: cWc85bEzdRzpUMhRKm8pwQ ($25.70 in chips) 
Seat 3: SFmT9ZsVopnukjvAzrxTRg ($25 in chips) 
Seat 4: ljjhtb6FVPTx9AT9HNdtqg ($25.10 in chips) 
Seat 5: LJI7A1YgDM7hgh7o56+ReQ ($25.60 in chips) 
ljjhtb6FVPTx9AT9HNdtqg: posts small blind $0.10
LJI7A1YgDM7hgh7o56+ReQ: posts big blind $0.25
*** HOLE CARDS ***
4WFKzsjLSGnvHbVxKabsvQ: folds 
cWc85bEzdRzpUMhRKm8pwQ: calls $0.25
SFmT9ZsVopnukjvAzrxTRg: raises $0.75 to $1
ljjhtb6FVPTx9AT9HNdtqg: folds 
LJI7A1YgDM7hgh7o56+ReQ: raises $2.50 to $3.50
cWc85bEzdRzpUMhRKm8pwQ: folds 
SFmT9ZsVopnukjvAzrxTRg: folds 
Uncalled bet ($2.50) returned to LJI7A1YgDM7hgh7o56+ReQ
LJI7A1YgDM7hgh7o56+ReQ collected $2.35 from pot
LJI7A1YgDM7hgh7o56+ReQ: doesn't show hand 
*** SUMMARY ***
Total pot $2.35 | Rake $0 
Seat 1: 4WFKzsjLSGnvHbVxKabsvQ folded before Flop (didn't bet)
Seat 2: cWc85bEzdRzpUMhRKm8pwQ folded before Flop
Seat 3: SFmT9ZsVopnukjvAzrxTRg (button) folded before Flop
Seat 4: ljjhtb6FVPTx9AT9HNdtqg (small blind) folded before Flop
Seat 5: LJI7A1YgDM7hgh7o56+ReQ (big blind) collected ($2.35)




PokerStars Game #59941702230:  Hold'em No Limit ($0.10/$0.25) - 2009/07/01 1:43:28 ET
Table 'CM/C/FZf3VHIp50RjmBucQ' 9-max Seat #3 is the button
Seat 2: xUw035gj8xeH3frcgPyCVw ($5 in chips) 
Seat 3: HPEB+AtKw1+C/cxU0o1ciw ($51.05 in chips) 
Seat 4: FYIiLXWy4mKC5ZGa/fnS0g ($10.50 in chips) 
Seat 5: oLa/tXLfSLLB28mcLGrxcg ($24.55 in chips) 
Seat 6: Bb42QRQMhg5/Y0vHP8/2Xw ($25 in chips) 
FYIiLXWy4mKC5ZGa/fnS0g: posts small blind $0.10
oLa/tXLfSLLB28mcLGrxcg: posts big blind $0.25
xUw035gj8xeH3frcgPyCVw: posts big blind $0.25
*** HOLE CARDS ***
Bb42QRQMhg5/Y0vHP8/2Xw: folds 
Bb42QRQMhg5/Y0vHP8/2Xw leaves the table
xUw035gj8xeH3frcgPyCVw: checks 
HPEB+AtKw1+C/cxU0o1ciw: calls $0.25
FYIiLXWy4mKC5ZGa/fnS0g: calls $0.15
oLa/tXLfSLLB28mcLGrxcg: checks 
*** FLOP *** [Ad Ks 5c]
FYIiLXWy4mKC5ZGa/fnS0g: checks 
oLa/tXLfSLLB28mcLGrxcg: checks 
xUw035gj8xeH3frcgPyCVw: bets $1.25
HPEB+AtKw1+C/cxU0o1ciw: folds 
FYIiLXWy4mKC5ZGa/fnS0g: folds 
oLa/tXLfSLLB28mcLGrxcg: folds 
Uncalled bet ($1.25) returned to xUw035gj8xeH3frcgPyCVw
xUw035gj8xeH3frcgPyCVw collected $0.95 from pot
*** SUMMARY ***
Total pot $1 | Rake $0.05 
Board [Ad Ks 5c]
Seat 2: xUw035gj8xeH3frcgPyCVw collected ($0.95)
Seat 3: HPEB+AtKw1+C/cxU0o1ciw (button) folded on the Flop
Seat 4: FYIiLXWy4mKC5ZGa/fnS0g (small blind) folded on the Flop
Seat 5: oLa/tXLfSLLB28mcLGrxcg (big blind) folded on the Flop
Seat 6: Bb42QRQMhg5/Y0vHP8/2Xw folded before Flop (didn't bet)




PokerStars Game #59941702376:  Hold'em No Limit ($0.10/$0.25) - 2009/07/01 1:43:28 ET
Table '6wawJ+MkkvuC3coG6r+Yhg' 6-max Seat #4 is the button
Seat 1: JQZew0FjzS19kTjeNtrE+A ($28.25 in chips) 
Seat 2: LtASJ9OlkqGrrUKGQlpGAw ($33.60 in chips) 
Seat 3: 3zD3qLXT1bEffAoWGnc7wg ($59.50 in chips) 
Seat 4: yxmjNFGiKI3b+XQGJzJVIg ($28.30 in chips) 
Seat 5: FZrgDbxAanC1xwZxXHJKVA ($2.95 in chips) 
Seat 6: B3X187C0tXFUfQpCu8pe8A ($27.10 in chips) 
FZrgDbxAanC1xwZxXHJKVA: posts small blind $0.10
B3X187C0tXFUfQpCu8pe8A: posts big blind $0.25
*** HOLE CARDS ***
JQZew0FjzS19kTjeNtrE+A: folds 
LtASJ9OlkqGrrUKGQlpGAw: raises $0.50 to $0.75
3zD3qLXT1bEffAoWGnc7wg: calls $0.75
yxmjNFGiKI3b+XQGJzJVIg: folds 
FZrgDbxAanC1xwZxXHJKVA: folds 
B3X187C0tXFUfQpCu8pe8A: folds 
*** FLOP *** [Td 8d 9c]
LtASJ9OlkqGrrUKGQlpGAw: bets $1.50
3zD3qLXT1bEffAoWGnc7wg: folds 
Uncalled bet ($1.50) returned to LtASJ9OlkqGrrUKGQlpGAw
LtASJ9OlkqGrrUKGQlpGAw collected $1.80 from pot
LtASJ9OlkqGrrUKGQlpGAw: doesn't show hand 
*** SUMMARY ***
Total pot $1.85 | Rake $0.05 
Board [Td 8d 9c]
Seat 1: JQZew0FjzS19kTjeNtrE+A folded before Flop (didn't bet)
Seat 2: LtASJ9OlkqGrrUKGQlpGAw collected ($1.80)
Seat 3: 3zD3qLXT1bEffAoWGnc7wg folded on the Flop
Seat 4: yxmjNFGiKI3b+XQGJzJVIg (button) folded before Flop (didn't bet)
Seat 5: FZrgDbxAanC1xwZxXHJKVA (small blind) folded before Flop
Seat 6: B3X187C0tXFUfQpCu8pe8A (big blind) folded before Flop




PokerStars Game #59941702302:  Hold'em No Limit ($0.10/$0.25) - 2009/07/01 1:43:28 ET
Table 'srBTB98reCdD1TffxE6o7g' 6-max Seat #5 is the button
Seat 1: SFmT9ZsVopnukjvAzrxTRg ($34.30 in chips) 
Seat 2: mfrkWA3PTeYPkbO6hi98Aw ($25 in chips) 
Seat 3: VOmI0x4dDPnTESZd5B4d1Q ($47.85 in chips) 
Seat 4: 6DwBRH+xZ12AAZmeAg+aXw ($16.55 in chips) 
Seat 5: 8zUCJvLYLFM8AG6K5zjIvg ($16.60 in chips) 
Seat 6: BV+K0Phf5VBHr7aZPKqbUQ ($34.70 in chips) 
BV+K0Phf5VBHr7aZPKqbUQ: posts small blind $0.10
SFmT9ZsVopnukjvAzrxTRg: posts big blind $0.25
*** HOLE CARDS ***
mfrkWA3PTeYPkbO6hi98Aw: folds 
VOmI0x4dDPnTESZd5B4d1Q: calls $0.25
6DwBRH+xZ12AAZmeAg+aXw: folds 
8zUCJvLYLFM8AG6K5zjIvg: folds 
BV+K0Phf5VBHr7aZPKqbUQ: folds 
SFmT9ZsVopnukjvAzrxTRg: checks 
*** FLOP *** [Ks 8s Tc]
SFmT9ZsVopnukjvAzrxTRg: checks 
VOmI0x4dDPnTESZd5B4d1Q: bets $0.25
SFmT9ZsVopnukjvAzrxTRg: folds 
Uncalled bet ($0.25) returned to VOmI0x4dDPnTESZd5B4d1Q
VOmI0x4dDPnTESZd5B4d1Q collected $0.60 from pot
VOmI0x4dDPnTESZd5B4d1Q: doesn't show hand 
*** SUMMARY ***
Total pot $0.60 | Rake $0 
Board [Ks 8s Tc]
Seat 1: SFmT9ZsVopnukjvAzrxTRg (big blind) folded on the Flop
Seat 2: mfrkWA3PTeYPkbO6hi98Aw folded before Flop (didn't bet)
Seat 3: VOmI0x4dDPnTESZd5B4d1Q collected ($0.60)
Seat 4: 6DwBRH+xZ12AAZmeAg+aXw folded before Flop (didn't bet)
Seat 5: 8zUCJvLYLFM8AG6K5zjIvg (button) folded before Flop (didn't bet)
Seat 6: BV+K0Phf5VBHr7aZPKqbUQ (small blind) folded before Flop




PokerStars Game #59941702196:  Hold'em No Limit ($0.10/$0.25) - 2009/07/01 1:43:28 ET
Table '2vH5RcmkT0F4XNS/EmmyMA' 6-max Seat #3 is the button
Seat 1: hOaWAImn5/MZDAWAPlYHCw ($6.50 in chips) 
Seat 2: W6Y6au0wf7gRAlqJYgOezw ($11.85 in chips) 
Seat 3: t8P79jKZYh/Wpx2V73pSqg ($29.90 in chips) 
Seat 4: FC6tJ9EOiutXO8hnpR4VgQ ($5.90 in chips) 
Seat 5: Hsvkc0/G2VV78oVmWYXecw ($5 in chips) 
Seat 6: if4dh6jhJXeN3/qd3qCp9g ($26.10 in chips) 
FC6tJ9EOiutXO8hnpR4VgQ: posts small blind $0.10
Hsvkc0/G2VV78oVmWYXecw: posts big blind $0.25
*** HOLE CARDS ***
if4dh6jhJXeN3/qd3qCp9g: folds 
hOaWAImn5/MZDAWAPlYHCw: folds 
W6Y6au0wf7gRAlqJYgOezw: folds 
t8P79jKZYh/Wpx2V73pSqg: folds 
FC6tJ9EOiutXO8hnpR4VgQ: calls $0.15
Hsvkc0/G2VV78oVmWYXecw: checks 
*** FLOP *** [7h 9s 8d]
FC6tJ9EOiutXO8hnpR4VgQ: checks 
Hsvkc0/G2VV78oVmWYXecw: bets $1
FC6tJ9EOiutXO8hnpR4VgQ: folds 
Uncalled bet ($1) returned to Hsvkc0/G2VV78oVmWYXecw
Hsvkc0/G2VV78oVmWYXecw collected $0.50 from pot
Hsvkc0/G2VV78oVmWYXecw: doesn't show hand 
*** SUMMARY ***
Total pot $0.50 | Rake $0 
Board [7h 9s 8d]
Seat 1: hOaWAImn5/MZDAWAPlYHCw folded before Flop (didn't bet)
Seat 2: W6Y6au0wf7gRAlqJYgOezw folded before Flop (didn't bet)
Seat 3: t8P79jKZYh/Wpx2V73pSqg (button) folded before Flop (didn't bet)
Seat 4: FC6tJ9EOiutXO8hnpR4VgQ (small blind) folded on the Flop
Seat 5: Hsvkc0/G2VV78oVmWYXecw (big blind) collected ($0.50)
Seat 6: if4dh6jhJXeN3/qd3qCp9g folded before Flop (didn't bet)




PokerStars Game #59941702138:  Hold'em No Limit ($0.10/$0.25) - 2009/07/01 1:43:28 ET
Table '3LMlz3V4AziGlU+ikmyU8w' 6-max Seat #4 is the button
Seat 1: Wxq4Qyj0DnDXj2+taEOJFQ ($29.15 in chips) 
Seat 2: uR3AbFJLoOX86DOTtTgGcg ($25 in chips) 
Seat 3: Hzy03WtPHMYwLYM7hTTxQw ($29.60 in chips) 
Seat 4: 6DwBRH+xZ12AAZmeAg+aXw ($19.90 in chips) 
Seat 5: tOAk1Og4mVObMBOfvdDYOw ($25.10 in chips) 
Seat 6: ZZm/rg8aThjE+A2LiItuzA ($1.10 in chips) 
tOAk1Og4mVObMBOfvdDYOw: posts small blind $0.10
ZZm/rg8aThjE+A2LiItuzA: posts big blind $0.25
*** HOLE CARDS ***
Wxq4Qyj0DnDXj2+taEOJFQ: calls $0.25
uR3AbFJLoOX86DOTtTgGcg: raises $1.25 to $1.50
Hzy03WtPHMYwLYM7hTTxQw: folds 
6DwBRH+xZ12AAZmeAg+aXw: folds 
tOAk1Og4mVObMBOfvdDYOw: folds 
ZZm/rg8aThjE+A2LiItuzA: calls $0.85 and is all-in
Wxq4Qyj0DnDXj2+taEOJFQ: calls $1.25
*** FLOP *** [3h 3s Kd]
Wxq4Qyj0DnDXj2+taEOJFQ: checks 
uR3AbFJLoOX86DOTtTgGcg: bets $2.25
Wxq4Qyj0DnDXj2+taEOJFQ: folds 
Uncalled bet ($2.25) returned to uR3AbFJLoOX86DOTtTgGcg
*** TURN *** [3h 3s Kd] [Ts]
*** RIVER *** [3h 3s Kd Ts] [Ac]
*** SHOW DOWN ***
uR3AbFJLoOX86DOTtTgGcg: shows [Kc Jc] (two pair, Kings and Threes)
uR3AbFJLoOX86DOTtTgGcg collected $0.75 from side pot
ZZm/rg8aThjE+A2LiItuzA: mucks hand 
uR3AbFJLoOX86DOTtTgGcg collected $3.25 from main pot
*** SUMMARY ***
Total pot $4.20 Main pot $3.25. Side pot $0.75. | Rake $0.20 
Board [3h 3s Kd Ts Ac]
Seat 1: Wxq4Qyj0DnDXj2+taEOJFQ folded on the Flop
Seat 2: uR3AbFJLoOX86DOTtTgGcg showed [Kc Jc] and won ($4) with two pair, Kings and Threes
Seat 3: Hzy03WtPHMYwLYM7hTTxQw folded before Flop (didn't bet)
Seat 4: 6DwBRH+xZ12AAZmeAg+aXw (button) folded before Flop (didn't bet)
Seat 5: tOAk1Og4mVObMBOfvdDYOw (small blind) folded before Flop
Seat 6: ZZm/rg8aThjE+A2LiItuzA (big blind) mucked




PokerStars Game #59941702416:  Hold'em No Limit ($0.10/$0.25) - 2009/07/01 1:43:28 ET
Table 'ktio12Pyq06LsrFhIorSqA' 9-max Seat #6 is the button
Seat 1: OneeONzF0MoH0pEdcBndwA ($33.60 in chips) 
Seat 2: tGsFgUKjSctVaAXabrlZxw ($4.40 in chips) 
Seat 4: 0QdZrkFD7aGKeBXPGbIomA ($5.30 in chips) 
Seat 5: e0pV1oisCAilWiG0FCxY6A ($16.75 in chips) 
Seat 6: jQL6XIewylQ8MmZhhq2YFg ($42.20 in chips) 
Seat 7: XGCfQsxa6PfAg3kJtzUmww ($22.20 in chips) 
Seat 9: H5Se03ZqSX7tbULXur2MAg ($26.65 in chips) 
XGCfQsxa6PfAg3kJtzUmww: posts small blind $0.10
Z5y2J55JmfLYR6/DPAGHwQ: is sitting out 
H5Se03ZqSX7tbULXur2MAg: posts big blind $0.25
Z9W7+g1WMhhZDi7DwGbCFA: sits out 
*** HOLE CARDS ***
OneeONzF0MoH0pEdcBndwA: calls $0.25
tGsFgUKjSctVaAXabrlZxw: folds 
0QdZrkFD7aGKeBXPGbIomA: raises $0.75 to $1
e0pV1oisCAilWiG0FCxY6A: folds 
jQL6XIewylQ8MmZhhq2YFg: folds 
XGCfQsxa6PfAg3kJtzUmww: folds 
H5Se03ZqSX7tbULXur2MAg: folds 
OneeONzF0MoH0pEdcBndwA: calls $0.75
*** FLOP *** [4s 2s 5s]
OneeONzF0MoH0pEdcBndwA: checks 
0QdZrkFD7aGKeBXPGbIomA: bets $1.25
OneeONzF0MoH0pEdcBndwA: calls $1.25
*** TURN *** [4s 2s 5s] [3c]
OneeONzF0MoH0pEdcBndwA: checks 
0QdZrkFD7aGKeBXPGbIomA: bets $1.75
OneeONzF0MoH0pEdcBndwA: raises $1.75 to $3.50
0QdZrkFD7aGKeBXPGbIomA: calls $1.30 and is all-in
Uncalled bet ($0.45) returned to OneeONzF0MoH0pEdcBndwA
*** RIVER *** [4s 2s 5s 3c] [Qh]
*** SHOW DOWN ***
OneeONzF0MoH0pEdcBndwA: shows [Ks Ts] (a flush, King high)
0QdZrkFD7aGKeBXPGbIomA: mucks hand 
OneeONzF0MoH0pEdcBndwA collected $10.45 from pot
*** SUMMARY ***
Total pot $10.95 | Rake $0.50 
Board [4s 2s 5s 3c Qh]
Seat 1: OneeONzF0MoH0pEdcBndwA showed [Ks Ts] and won ($10.45) with a flush, King high
Seat 2: tGsFgUKjSctVaAXabrlZxw folded before Flop (didn't bet)
Seat 4: 0QdZrkFD7aGKeBXPGbIomA mucked
Seat 5: e0pV1oisCAilWiG0FCxY6A folded before Flop (didn't bet)
Seat 6: jQL6XIewylQ8MmZhhq2YFg (button) folded before Flop (didn't bet)
Seat 7: XGCfQsxa6PfAg3kJtzUmww (small blind) folded before Flop
Seat 9: H5Se03ZqSX7tbULXur2MAg (big blind) folded before Flop




PokerStars Game #59941702552:  Hold'em No Limit ($0.10/$0.25) - 2009/07/01 1:43:28 ET
Table 'tErGGDyESv/0llKumVeZuQ' 9-max Seat #9 is the button
Seat 1: 3PmVnC/15cl4oyI1TKIt4g ($4.50 in chips) 
Seat 2: pN3IHvAKm2fz+sTRARTcrg ($24.65 in chips) 
Seat 3: cFmpjvcjNoVAEAIQIxWkYg ($25 in chips) 
Seat 5: 6RQUxA3jk+ePxB/+Hc0IKw ($13.85 in chips) 
Seat 7: uhrboV251dcgYniYTdFIcA ($28.55 in chips) 
Seat 8: UD63hhjq5lMoGqYLFTcH1A ($1.95 in chips) 
Seat 9: d6n762oPkegG086ZJyV5MA ($16.90 in chips) 
3PmVnC/15cl4oyI1TKIt4g: posts small blind $0.10
pN3IHvAKm2fz+sTRARTcrg: posts big blind $0.25
yqkowiRWZ6NvRN9UUkYIlA: sits out 
*** HOLE CARDS ***
cFmpjvcjNoVAEAIQIxWkYg: folds 
6RQUxA3jk+ePxB/+Hc0IKw: folds 
uhrboV251dcgYniYTdFIcA: calls $0.25
UD63hhjq5lMoGqYLFTcH1A: calls $0.25
d6n762oPkegG086ZJyV5MA: folds 
3PmVnC/15cl4oyI1TKIt4g: folds 
pN3IHvAKm2fz+sTRARTcrg: checks 
*** FLOP *** [4s 4h Ts]
pN3IHvAKm2fz+sTRARTcrg: checks 
uhrboV251dcgYniYTdFIcA: bets $1.25
UD63hhjq5lMoGqYLFTcH1A: folds 
pN3IHvAKm2fz+sTRARTcrg: folds 
Uncalled bet ($1.25) returned to uhrboV251dcgYniYTdFIcA
uhrboV251dcgYniYTdFIcA collected $0.85 from pot
uhrboV251dcgYniYTdFIcA: doesn't show hand 
*** SUMMARY ***
Total pot $0.85 | Rake $0 
Board [4s 4h Ts]
Seat 1: 3PmVnC/15cl4oyI1TKIt4g (small blind) folded before Flop
Seat 2: pN3IHvAKm2fz+sTRARTcrg (big blind) folded on the Flop
Seat 3: cFmpjvcjNoVAEAIQIxWkYg folded before Flop (didn't bet)
Seat 5: 6RQUxA3jk+ePxB/+Hc0IKw folded before Flop (didn't bet)
Seat 7: uhrboV251dcgYniYTdFIcA collected ($0.85)
Seat 8: UD63hhjq5lMoGqYLFTcH1A folded on the Flop
Seat 9: d6n762oPkegG086ZJyV5MA (button) folded before Flop (didn't bet)




PokerStars Game #59941702680:  Hold'em No Limit ($0.10/$0.25) - 2009/07/01 1:43:29 ET
Table 'fHv1Mk7ZbLjprZTGWKPiEQ' 6-max Seat #3 is the button
Seat 1: OIjOiBfQstWrK/RuXx7zcw ($5 in chips) 
Seat 2: 9U3ZKjCsarN0DjR6mSE8Ug ($15.05 in chips) 
Seat 3: /gJNBeCkWL4o85/jvlZ4BA ($25 in chips) 
Seat 4: TSmua8tGK3sTbwi0ynrW9Q ($58.90 in chips) 
Seat 5: LJI7A1YgDM7hgh7o56+ReQ ($26.65 in chips) 
Seat 6: AjG0X+rNtc2W08eph8oqpw ($35.85 in chips) 
TSmua8tGK3sTbwi0ynrW9Q: posts small blind $0.10
LJI7A1YgDM7hgh7o56+ReQ: posts big blind $0.25
OIjOiBfQstWrK/RuXx7zcw: posts big blind $0.25
*** HOLE CARDS ***
AjG0X+rNtc2W08eph8oqpw: folds 
OIjOiBfQstWrK/RuXx7zcw: raises $0.25 to $0.50
9U3ZKjCsarN0DjR6mSE8Ug: folds 
/gJNBeCkWL4o85/jvlZ4BA: raises $1.50 to $2
TSmua8tGK3sTbwi0ynrW9Q: folds 
LJI7A1YgDM7hgh7o56+ReQ: folds 
OIjOiBfQstWrK/RuXx7zcw: calls $1.50
*** FLOP *** [3c Ac Kc]
OIjOiBfQstWrK/RuXx7zcw: checks 
/gJNBeCkWL4o85/jvlZ4BA: bets $3
OIjOiBfQstWrK/RuXx7zcw: folds 
Uncalled bet ($3) returned to /gJNBeCkWL4o85/jvlZ4BA
/gJNBeCkWL4o85/jvlZ4BA collected $4.15 from pot
*** SUMMARY ***
Total pot $4.35 | Rake $0.20 
Board [3c Ac Kc]
Seat 1: OIjOiBfQstWrK/RuXx7zcw folded on the Flop
Seat 2: 9U3ZKjCsarN0DjR6mSE8Ug folded before Flop (didn't bet)
Seat 3: /gJNBeCkWL4o85/jvlZ4BA (button) collected ($4.15)
Seat 4: TSmua8tGK3sTbwi0ynrW9Q (small blind) folded before Flop
Seat 5: LJI7A1YgDM7hgh7o56+ReQ (big blind) folded before Flop
Seat 6: AjG0X+rNtc2W08eph8oqpw folded before Flop (didn't bet)




PokerStars Game #59941702662:  Hold'em No Limit ($0.10/$0.25) - 2009/07/01 1:43:29 ET
Table 'hfHe8uKeSJMyWAjSdM7ROQMRfAiS/4JSfnUDlCcZo0wAx Seat #1 is the button
Seat 1: 48oT5xFI+5CHUJlfoGrE4w ($30.15 in chips) 
Seat 2: /gJNBeCkWL4o85/jvlZ4BA ($29.45 in chips) 
Seat 3: FYepjhAvF8ZdVCmqHIy+eQ ($39.05 in chips) 
Seat 4: b4wRQV3APH8irVk6bUFe2Q ($30.35 in chips) 
Seat 6: L3/N/gliETan8N5Gim5h4Q ($25.25 in chips) 
/gJNBeCkWL4o85/jvlZ4BA: posts small blind $0.10
FYepjhAvF8ZdVCmqHIy+eQ: posts big blind $0.25
*** HOLE CARDS ***
b4wRQV3APH8irVk6bUFe2Q: raises $0.50 to $0.75
L3/N/gliETan8N5Gim5h4Q: calls $0.75
48oT5xFI+5CHUJlfoGrE4w: folds 
/gJNBeCkWL4o85/jvlZ4BA: folds 
FYepjhAvF8ZdVCmqHIy+eQ: folds 
*** FLOP *** [5h Qh Qd]
b4wRQV3APH8irVk6bUFe2Q: bets $1.25
L3/N/gliETan8N5Gim5h4Q: calls $1.25
*** TURN *** [5h Qh Qd] [8d]
b4wRQV3APH8irVk6bUFe2Q: checks 
L3/N/gliETan8N5Gim5h4Q: checks 
*** RIVER *** [5h Qh Qd 8d] [Kd]
b4wRQV3APH8irVk6bUFe2Q: bets $2.25
L3/N/gliETan8N5Gim5h4Q: folds 
Uncalled bet ($2.25) returned to b4wRQV3APH8irVk6bUFe2Q
b4wRQV3APH8irVk6bUFe2Q collected $4.15 from pot
*** SUMMARY ***
Total pot $4.35 | Rake $0.20 
Board [5h Qh Qd 8d Kd]
Seat 1: 48oT5xFI+5CHUJlfoGrE4w (button) folded before Flop (didn't bet)
Seat 2: /gJNBeCkWL4o85/jvlZ4BA (small blind) folded before Flop
Seat 3: FYepjhAvF8ZdVCmqHIy+eQ (big blind) folded before Flop
Seat 4: b4wRQV3APH8irVk6bUFe2Q collected ($4.15)
Seat 6: L3/N/gliETan8N5Gim5h4Q folded on the River




PokerStars Game #59941702678:  Hold'em No Limit ($0.10/$0.25) - 2009/07/01 1:43:29 ET
Table 'S6s+TmTlAjLHclBRvN5/fw' 9-max Seat #8 is the button
Seat 3: z2SmIaQ3+5n/eY1BN5HgPg ($4.70 in chips) 
Seat 5: z5GxcHlYz/GSz6W2uFiTtg ($39.55 in chips) 
Seat 6: aNpwfA31EREwO+ar4XzBCw ($34.10 in chips) 
Seat 8: OlPJsgR4xypSg/w1z7Gyvw ($22.90 in chips) 
z2SmIaQ3+5n/eY1BN5HgPg said, "lol"
z2SmIaQ3+5n/eY1BN5HgPg: posts small blind $0.10
z5GxcHlYz/GSz6W2uFiTtg: posts big blind $0.25
hO0e1+SO2lX0hqBn3Z/9KQ leaves the table
X6+pSIPfovPcE87t+LmUKQ: sits out 
*** HOLE CARDS ***
aNpwfA31EREwO+ar4XzBCw: folds 
aNpwfA31EREwO+ar4XzBCw leaves the table
OlPJsgR4xypSg/w1z7Gyvw: folds 
z2SmIaQ3+5n/eY1BN5HgPg: raises $0.75 to $1
z5GxcHlYz/GSz6W2uFiTtg: folds 
Uncalled bet ($0.75) returned to z2SmIaQ3+5n/eY1BN5HgPg
z5GxcHlYz/GSz6W2uFiTtg leaves the table
z2SmIaQ3+5n/eY1BN5HgPg collected $0.50 from pot
z2SmIaQ3+5n/eY1BN5HgPg: doesn't show hand 
*** SUMMARY ***
Total pot $0.50 | Rake $0 
Seat 3: z2SmIaQ3+5n/eY1BN5HgPg (small blind) collected ($0.50)
Seat 5: z5GxcHlYz/GSz6W2uFiTtg (big blind) folded before Flop
Seat 6: aNpwfA31EREwO+ar4XzBCw folded before Flop (didn't bet)
Seat 8: OlPJsgR4xypSg/w1z7Gyvw (button) folded before Flop (didn't bet)




PokerStars Game #59941703336:  Hold'em No Limit ($0.10/$0.25) - 2009/07/01 1:43:30 ET
Table 'NtEQAxCeIK2io1CGtW658g' 6-max Seat #3 is the button
Seat 1: X437kMQ7AujoaDgjguhU9w ($9.90 in chips) 
Seat 3: m2yWOKfAxqHoy5DDN87Ttw ($39.75 in chips) 
Seat 4: 8296 ($11.65 in chips) 
Seat 5: Hsvkc0/G2VV78oVmWYXecw ($5 in chips) 
Seat 6: /gJNBeCkWL4o85/jvlZ4BA ($65.10 in chips) 
8296: posts small blind $0.10
Hsvkc0/G2VV78oVmWYXecw: posts big blind $0.25
*** HOLE CARDS ***
/gJNBeCkWL4o85/jvlZ4BA: folds 
X437kMQ7AujoaDgjguhU9w: folds 
m2yWOKfAxqHoy5DDN87Ttw: folds 
8296: folds 
Uncalled bet ($0.15) returned to Hsvkc0/G2VV78oVmWYXecw
Hsvkc0/G2VV78oVmWYXecw collected $0.20 from pot
Hsvkc0/G2VV78oVmWYXecw: doesn't show hand 
*** SUMMARY ***
Total pot $0.20 | Rake $0 
Seat 1: X437kMQ7AujoaDgjguhU9w folded before Flop (didn't bet)
Seat 3: m2yWOKfAxqHoy5DDN87Ttw (button) folded before Flop (didn't bet)
Seat 4: 8296 (small blind) folded before Flop
Seat 5: Hsvkc0/G2VV78oVmWYXecw (big blind) collected ($0.20)
Seat 6: /gJNBeCkWL4o85/jvlZ4BA folded before Flop (didn't bet)




PokerStars Game #59941703330:  Hold'em No Limit ($0.10/$0.25) - 2009/07/01 1:43:30 ET
Table 'IrJPyZ3JW2iIa+krdoSbJQ' 9-max Seat #4 is the button
Seat 1: Bb42QRQMhg5/Y0vHP8/2Xw ($26.25 in chips) 
Seat 2: X78b5v/uhqeXXoAijbw/yg ($26.20 in chips) 
Seat 3: CT7Xj/V/O5rBlhtt+RZeFQ ($25 in chips) 
Seat 4: bXpVeaSTPBFSPJmeXxO7nw ($4.65 in chips) 
Seat 5: tLcDklc2rBORNfixyRfVfw ($28.50 in chips) 
Seat 6: +sbyWwIcFp9kP0bDtMegfQ ($24.95 in chips) 
Seat 7: k7BTUnQVz23IhJmLKrwx8A ($18.20 in chips) 
Seat 8: zZqOSFjPK4R4cwx0dONetw ($20.65 in chips) 
Seat 9: Mh2r9hTeTEDnh19sRZtW3g ($5.80 in chips) 
tLcDklc2rBORNfixyRfVfw: posts small blind $0.10
+sbyWwIcFp9kP0bDtMegfQ: posts big blind $0.25
*** HOLE CARDS ***
k7BTUnQVz23IhJmLKrwx8A: raises $0.50 to $0.75
zZqOSFjPK4R4cwx0dONetw: folds 
Mh2r9hTeTEDnh19sRZtW3g: folds 
Bb42QRQMhg5/Y0vHP8/2Xw: folds 
X78b5v/uhqeXXoAijbw/yg: raises $2.50 to $3.25
CT7Xj/V/O5rBlhtt+RZeFQ: folds 
bXpVeaSTPBFSPJmeXxO7nw: folds 
tLcDklc2rBORNfixyRfVfw: folds 
+sbyWwIcFp9kP0bDtMegfQ: folds 
k7BTUnQVz23IhJmLKrwx8A: raises $14.95 to $18.20 and is all-in
X78b5v/uhqeXXoAijbw/yg: calls $14.95
*** FLOP *** [8d Jh Jd]
*** TURN *** [8d Jh Jd] [Qs]
*** RIVER *** [8d Jh Jd Qs] [6s]
*** SHOW DOWN ***
k7BTUnQVz23IhJmLKrwx8A: shows [Ac Kd] (a pair of Jacks)
X78b5v/uhqeXXoAijbw/yg: shows [Qd Qh] (a full house, Queens full of Jacks)
X78b5v/uhqeXXoAijbw/yg collected $34.95 from pot
k7BTUnQVz23IhJmLKrwx8A leaves the table
*** SUMMARY ***
Total pot $36.75 | Rake $1.80 
Board [8d Jh Jd Qs 6s]
Seat 1: Bb42QRQMhg5/Y0vHP8/2Xw folded before Flop (didn't bet)
Seat 2: X78b5v/uhqeXXoAijbw/yg showed [Qd Qh] and won ($34.95) with a full house, Queens full of Jacks
Seat 3: CT7Xj/V/O5rBlhtt+RZeFQ folded before Flop (didn't bet)
Seat 4: bXpVeaSTPBFSPJmeXxO7nw (button) folded before Flop (didn't bet)
Seat 5: tLcDklc2rBORNfixyRfVfw (small blind) folded before Flop
Seat 6: +sbyWwIcFp9kP0bDtMegfQ (big blind) folded before Flop
Seat 7: k7BTUnQVz23IhJmLKrwx8A showed [Ac Kd] and lost with a pair of Jacks
Seat 8: zZqOSFjPK4R4cwx0dONetw folded before Flop (didn't bet)
Seat 9: Mh2r9hTeTEDnh19sRZtW3g folded before Flop (didn't bet)




PokerStars Game #59941703554:  Hold'em No Limit ($0.10/$0.25) - 2009/07/01 1:43:30 ET
Table 'NtCSSONEf1zaJo3042tQug' 6-max Seat #5 is the button
Seat 1: KXtdqb+rIMkjc0RvHDksGQ ($35.45 in chips) 
Seat 2: vqWjZmdQu/Hxw96/IJTWdQ ($27.30 in chips) 
Seat 3: 9kUKGKkblnIx3m8rlVol6Q ($15.65 in chips) 
Seat 4: HxD1kB8zCmalQSdWAkKmlg ($28.85 in chips) 
Seat 5: tOAk1Og4mVObMBOfvdDYOw ($30.40 in chips) 
Seat 6: LxehwDpTQ19ph4Qmc78+Pw ($28.75 in chips) 
LxehwDpTQ19ph4Qmc78+Pw: posts small blind $0.10
KXtdqb+rIMkjc0RvHDksGQ: posts big blind $0.25
*** HOLE CARDS ***
vqWjZmdQu/Hxw96/IJTWdQ: folds 
9kUKGKkblnIx3m8rlVol6Q: folds 
HxD1kB8zCmalQSdWAkKmlg: raises $0.75 to $1
tOAk1Og4mVObMBOfvdDYOw: folds 
LxehwDpTQ19ph4Qmc78+Pw: folds 
KXtdqb+rIMkjc0RvHDksGQ: folds 
Uncalled bet ($0.75) returned to HxD1kB8zCmalQSdWAkKmlg
HxD1kB8zCmalQSdWAkKmlg collected $0.60 from pot
HxD1kB8zCmalQSdWAkKmlg: doesn't show hand 
*** SUMMARY ***
Total pot $0.60 | Rake $0 
Seat 1: KXtdqb+rIMkjc0RvHDksGQ (big blind) folded before Flop
Seat 2: vqWjZmdQu/Hxw96/IJTWdQ folded before Flop (didn't bet)
Seat 3: 9kUKGKkblnIx3m8rlVol6Q folded before Flop (didn't bet)
Seat 4: HxD1kB8zCmalQSdWAkKmlg collected ($0.60)
Seat 5: tOAk1Og4mVObMBOfvdDYOw (button) folded before Flop (didn't bet)
Seat 6: LxehwDpTQ19ph4Qmc78+Pw (small blind) folded before Flop




PokerStars Game #59941703472:  Hold'em No Limit ($0.10/$0.25) - 2009/07/01 1:43:30 ET
Table 'GxdLtCpYxqT4aAbYqkEEpw' 6-max Seat #3 is the button
Seat 1: 2d/PU00mMdO9azAaXqcSbw ($10.35 in chips) 
Seat 2: dvm1UvZWx2FWbqFj2ihadg ($7.80 in chips) 
Seat 3: LpmZGzLpOmfZUF7EV4ZlrQ ($16.25 in chips) 
Seat 4: 6wzJiRvp8HY6t+MQGnSIzA ($10.65 in chips) 
Seat 5: q6WfTUAD9mowIP63ASq2Dg ($36.85 in chips) 
Seat 6: DFi/Lzkjsfv8QswS80JX9Q ($25 in chips) 
6wzJiRvp8HY6t+MQGnSIzA: posts small blind $0.10
q6WfTUAD9mowIP63ASq2Dg: posts big blind $0.25
dvm1UvZWx2FWbqFj2ihadg: posts big blind $0.25
*** HOLE CARDS ***
DFi/Lzkjsfv8QswS80JX9Q: raises $0.75 to $1
2d/PU00mMdO9azAaXqcSbw: folds 
dvm1UvZWx2FWbqFj2ihadg: calls $0.75
LpmZGzLpOmfZUF7EV4ZlrQ: folds 
6wzJiRvp8HY6t+MQGnSIzA: folds 
q6WfTUAD9mowIP63ASq2Dg: raises $1.25 to $2.25
DFi/Lzkjsfv8QswS80JX9Q: folds 
dvm1UvZWx2FWbqFj2ihadg: calls $1.25
*** FLOP *** [9h Ac 4h]
q6WfTUAD9mowIP63ASq2Dg: checks 
dvm1UvZWx2FWbqFj2ihadg: bets $1.75
q6WfTUAD9mowIP63ASq2Dg: raises $32.85 to $34.60 and is all-in
dvm1UvZWx2FWbqFj2ihadg: calls $3.80 and is all-in
Uncalled bet ($29.05) returned to q6WfTUAD9mowIP63ASq2Dg
*** TURN *** [9h Ac 4h] [Jc]
*** RIVER *** [9h Ac 4h Jc] [4s]
*** SHOW DOWN ***
q6WfTUAD9mowIP63ASq2Dg: shows [Ad As] (a full house, Aces full of Fours)
dvm1UvZWx2FWbqFj2ihadg: mucks hand 
q6WfTUAD9mowIP63ASq2Dg collected $15.90 from pot
dvm1UvZWx2FWbqFj2ihadg leaves the table
*** SUMMARY ***
Total pot $16.70 | Rake $0.80 
Board [9h Ac 4h Jc 4s]
Seat 1: 2d/PU00mMdO9azAaXqcSbw folded before Flop (didn't bet)
Seat 2: dvm1UvZWx2FWbqFj2ihadg mucked
Seat 3: LpmZGzLpOmfZUF7EV4ZlrQ (button) folded before Flop (didn't bet)
Seat 4: 6wzJiRvp8HY6t+MQGnSIzA (small blind) folded before Flop
Seat 5: q6WfTUAD9mowIP63ASq2Dg (big blind) showed [Ad As] and won ($15.90) with a full house, Aces full of Fours
Seat 6: DFi/Lzkjsfv8QswS80JX9Q folded before Flop




PokerStars Game #59941703338:  Hold'em No Limit ($0.10/$0.25) - 2009/07/01 1:43:30 ET
Table 'n8mNkPYbe1AIQEkioNesZA' 9-max Seat #5 is the button
Seat 1: 9lvO/qyU+xrU95Teu1fv0g ($5.55 in chips) 
Seat 2: QEbIGci+itdw+re8RM5fZA ($30.05 in chips) 
Seat 4: zgi+EUykT/pZQpoUG6+oEg ($5 in chips) 
Seat 5: wGigCmBR/9XWkPpvYos3aQ ($29.15 in chips) 
Seat 6: HPEB+AtKw1+C/cxU0o1ciw ($46.65 in chips) 
Seat 8: aNpwfA31EREwO+ar4XzBCw ($25.70 in chips) 
Seat 9: gehe91e0IyVT0QU/XBkEyg ($27.90 in chips) 
HPEB+AtKw1+C/cxU0o1ciw: posts small blind $0.10
sGFnnRCa1YAHAUmWgsW6Qg: is sitting out 
sGFnnRCa1YAHAUmWgsW6Qg leaves the table
aNpwfA31EREwO+ar4XzBCw: posts big blind $0.25
*** HOLE CARDS ***
gehe91e0IyVT0QU/XBkEyg: folds 
9lvO/qyU+xrU95Teu1fv0g: folds 
QEbIGci+itdw+re8RM5fZA: raises $0.50 to $0.75
zgi+EUykT/pZQpoUG6+oEg: folds 
ella0715 joins the table at seat #7 
wGigCmBR/9XWkPpvYos3aQ: calls $0.75
HPEB+AtKw1+C/cxU0o1ciw: folds 
aNpwfA31EREwO+ar4XzBCw: calls $0.50
*** FLOP *** [8h Qh Js]
aNpwfA31EREwO+ar4XzBCw: checks 
QEbIGci+itdw+re8RM5fZA: bets $1.25
wGigCmBR/9XWkPpvYos3aQ: folds 
aNpwfA31EREwO+ar4XzBCw: calls $1.25
*** TURN *** [8h Qh Js] [Kd]
aNpwfA31EREwO+ar4XzBCw: checks 
QEbIGci+itdw+re8RM5fZA: checks 
*** RIVER *** [8h Qh Js Kd] [4s]
aNpwfA31EREwO+ar4XzBCw: checks 
QEbIGci+itdw+re8RM5fZA: checks 
*** SHOW DOWN ***
aNpwfA31EREwO+ar4XzBCw: shows [Ts Ks] (a pair of Kings)
QEbIGci+itdw+re8RM5fZA: mucks hand 
aNpwfA31EREwO+ar4XzBCw collected $4.65 from pot
*** SUMMARY ***
Total pot $4.85 | Rake $0.20 
Board [8h Qh Js Kd 4s]
Seat 1: 9lvO/qyU+xrU95Teu1fv0g folded before Flop (didn't bet)
Seat 2: QEbIGci+itdw+re8RM5fZA mucked
Seat 4: zgi+EUykT/pZQpoUG6+oEg folded before Flop (didn't bet)
Seat 5: wGigCmBR/9XWkPpvYos3aQ (button) folded on the Flop
Seat 6: HPEB+AtKw1+C/cxU0o1ciw (small blind) folded before Flop
Seat 8: aNpwfA31EREwO+ar4XzBCw (big blind) showed [Ts Ks] and won ($4.65) with a pair of Kings
Seat 9: gehe91e0IyVT0QU/XBkEyg folded before Flop (didn't bet)




PokerStars Game #59941703778:  Hold'em No Limit ($0.10/$0.25) - 2009/07/01 1:43:31 ET
Table 'IRgQPZVA4+IaZZIQshgwyg' 6-max Seat #4 is the button
Seat 1: cezpHJ8FB07dj0xG+LhOvw ($27.90 in chips) 
Seat 2: lquriepNQBhDV5P1SWHhnA ($25 in chips) 
Seat 3: DihMHaz4WNETH1bPDe13kA ($27.45 in chips) 
Seat 4: DE9hRlt14g+JdsRQ4wT7hg ($27.15 in chips) 
Seat 5: PbMzPZIePKifKQZfKDkbIw ($37.95 in chips) 
Seat 6: XbIIdTtuN1xO7zurECHBTg ($3.45 in chips) 
PbMzPZIePKifKQZfKDkbIw: posts small blind $0.10
XbIIdTtuN1xO7zurECHBTg: posts big blind $0.25
*** HOLE CARDS ***
cezpHJ8FB07dj0xG+LhOvw: folds 
lquriepNQBhDV5P1SWHhnA: raises $0.50 to $0.75
DihMHaz4WNETH1bPDe13kA: folds 
DE9hRlt14g+JdsRQ4wT7hg: folds 
PbMzPZIePKifKQZfKDkbIw: folds 
XbIIdTtuN1xO7zurECHBTg: calls $0.50
*** FLOP *** [Jd 6s Qs]
XbIIdTtuN1xO7zurECHBTg: checks 
lquriepNQBhDV5P1SWHhnA: bets $2
XbIIdTtuN1xO7zurECHBTg: calls $2
*** TURN *** [Jd 6s Qs] [6d]
XbIIdTtuN1xO7zurECHBTg: checks 
lquriepNQBhDV5P1SWHhnA: bets $1
XbIIdTtuN1xO7zurECHBTg: calls $0.70 and is all-in
Uncalled bet ($0.30) returned to lquriepNQBhDV5P1SWHhnA
*** RIVER *** [Jd 6s Qs 6d] [Ks]
*** SHOW DOWN ***
XbIIdTtuN1xO7zurECHBTg: shows [3s 4s] (a flush, King high)
lquriepNQBhDV5P1SWHhnA: mucks hand 
XbIIdTtuN1xO7zurECHBTg collected $6.70 from pot
*** SUMMARY ***
Total pot $7 | Rake $0.30 
Board [Jd 6s Qs 6d Ks]
Seat 1: cezpHJ8FB07dj0xG+LhOvw folded before Flop (didn't bet)
Seat 2: lquriepNQBhDV5P1SWHhnA mucked
Seat 3: DihMHaz4WNETH1bPDe13kA folded before Flop (didn't bet)
Seat 4: DE9hRlt14g+JdsRQ4wT7hg (button) folded before Flop (didn't bet)
Seat 5: PbMzPZIePKifKQZfKDkbIw (small blind) folded before Flop
Seat 6: XbIIdTtuN1xO7zurECHBTg (big blind) showed [3s 4s] and won ($6.70) with a flush, King high




PokerStars Game #59941703674:  Hold'em No Limit ($0.10/$0.25) - 2009/07/01 1:43:31 ET
Table 'Ok3oDLIsTc2+KxPcI0bAOA' 6-max Seat #6 is the button
Seat 1: agQm3ugZ3qSVYNgNu1ddeA ($40.85 in chips) 
Seat 2: wPSNSp4HYtytRMXTu3oPSQ ($25 in chips) 
Seat 3: lquriepNQBhDV5P1SWHhnA ($36.45 in chips) 
Seat 4: LJI7A1YgDM7hgh7o56+ReQ ($36.90 in chips) 
Seat 5: DFi/Lzkjsfv8QswS80JX9Q ($28.25 in chips) 
Seat 6: Hsvkc0/G2VV78oVmWYXecw ($5 in chips) 
agQm3ugZ3qSVYNgNu1ddeA: posts small blind $0.10
wPSNSp4HYtytRMXTu3oPSQ: posts big blind $0.25
*** HOLE CARDS ***
lquriepNQBhDV5P1SWHhnA: folds 
LJI7A1YgDM7hgh7o56+ReQ: folds 
DFi/Lzkjsfv8QswS80JX9Q: folds 
Hsvkc0/G2VV78oVmWYXecw: raises $0.50 to $0.75
agQm3ugZ3qSVYNgNu1ddeA: folds 
wPSNSp4HYtytRMXTu3oPSQ: calls $0.50
*** FLOP *** [2s 8s 2h]
wPSNSp4HYtytRMXTu3oPSQ: checks 
Hsvkc0/G2VV78oVmWYXecw: bets $1
wPSNSp4HYtytRMXTu3oPSQ: calls $1
*** TURN *** [2s 8s 2h] [6c]
wPSNSp4HYtytRMXTu3oPSQ: checks 
Hsvkc0/G2VV78oVmWYXecw: checks 
*** RIVER *** [2s 8s 2h 6c] [5h]
wPSNSp4HYtytRMXTu3oPSQ: bets $2.50
Hsvkc0/G2VV78oVmWYXecw: folds 
Uncalled bet ($2.50) returned to wPSNSp4HYtytRMXTu3oPSQ
wPSNSp4HYtytRMXTu3oPSQ collected $3.45 from pot
wPSNSp4HYtytRMXTu3oPSQ: doesn't show hand 
*** SUMMARY ***
Total pot $3.60 | Rake $0.15 
Board [2s 8s 2h 6c 5h]
Seat 1: agQm3ugZ3qSVYNgNu1ddeA (small blind) folded before Flop
Seat 2: wPSNSp4HYtytRMXTu3oPSQ (big blind) collected ($3.45)
Seat 3: lquriepNQBhDV5P1SWHhnA folded before Flop (didn't bet)
Seat 4: LJI7A1YgDM7hgh7o56+ReQ folded before Flop (didn't bet)
Seat 5: DFi/Lzkjsfv8QswS80JX9Q folded before Flop (didn't bet)
Seat 6: Hsvkc0/G2VV78oVmWYXecw (button) folded on the River




PokerStars Game #59941704028:  Hold'em No Limit ($0.10/$0.25) - 2009/07/01 1:43:31 ET
Table '3Ns9nuTkynfwbBfBXzg6ww' 6-max Seat #3 is the button
Seat 1: epAUIB7h2FJXzUPRIvSkRA ($25.35 in chips) 
Seat 2: zxeVQGaMKDsDzmSY+AInjA ($33.70 in chips) 
Seat 3: eL3+wCBjFGfQ5FMdIZihwA ($24.30 in chips) 
Seat 4: qGHGf/553gQnDoklMRe3tg ($30.70 in chips) 
Seat 5: wqphQtauX5Qn7WRJZS1flA ($25.65 in chips) 
Seat 6: DE9hRlt14g+JdsRQ4wT7hg ($36.05 in chips) 
qGHGf/553gQnDoklMRe3tg: posts small blind $0.10
wqphQtauX5Qn7WRJZS1flA: posts big blind $0.25
*** HOLE CARDS ***
DE9hRlt14g+JdsRQ4wT7hg: raises $0.75 to $1
epAUIB7h2FJXzUPRIvSkRA: folds 
zxeVQGaMKDsDzmSY+AInjA: calls $1
eL3+wCBjFGfQ5FMdIZihwA: folds 
qGHGf/553gQnDoklMRe3tg: folds 
wqphQtauX5Qn7WRJZS1flA: folds 
*** FLOP *** [Qc Tc Qh]
DE9hRlt14g+JdsRQ4wT7hg: bets $1.50
zxeVQGaMKDsDzmSY+AInjA: calls $1.50
*** TURN *** [Qc Tc Qh] [Ac]
DE9hRlt14g+JdsRQ4wT7hg: checks 
zxeVQGaMKDsDzmSY+AInjA: bets $2.25
DE9hRlt14g+JdsRQ4wT7hg: folds 
Uncalled bet ($2.25) returned to zxeVQGaMKDsDzmSY+AInjA
zxeVQGaMKDsDzmSY+AInjA collected $5.10 from pot
*** SUMMARY ***
Total pot $5.35 | Rake $0.25 
Board [Qc Tc Qh Ac]
Seat 1: epAUIB7h2FJXzUPRIvSkRA folded before Flop (didn't bet)
Seat 2: zxeVQGaMKDsDzmSY+AInjA collected ($5.10)
Seat 3: eL3+wCBjFGfQ5FMdIZihwA (button) folded before Flop (didn't bet)
Seat 4: qGHGf/553gQnDoklMRe3tg (small blind) folded before Flop
Seat 5: wqphQtauX5Qn7WRJZS1flA (big blind) folded before Flop
Seat 6: DE9hRlt14g+JdsRQ4wT7hg folded on the Turn




PokerStars Game #59941703758:  Hold'em No Limit ($0.10/$0.25) - 2009/07/01 1:43:31 ET
Table 'gYBWJG3hEuJg6kphY0yhMg' 9-max Seat #8 is the button
Seat 1: AcL/hxc9eT0dCr2TYk/0Dg ($23.70 in chips) 
Seat 3: wGigCmBR/9XWkPpvYos3aQ ($25.35 in chips) 
Seat 4: V6p0jQ/RhUsqpHLmXvEX4Q ($13 in chips) 
Seat 5: +sbyWwIcFp9kP0bDtMegfQ ($27.95 in chips) 
Seat 8: VCKtuATyvAq9H2JSAQxPbA ($13.45 in chips) 
Seat 9: Bb42QRQMhg5/Y0vHP8/2Xw ($28.65 in chips) 
Bb42QRQMhg5/Y0vHP8/2Xw: posts small blind $0.10
AcL/hxc9eT0dCr2TYk/0Dg: posts big blind $0.25
RCqMONFrSPSArZh2Jsar/w: sits out 
Z9W7+g1WMhhZDi7DwGbCFA: sits out 
*** HOLE CARDS ***
wGigCmBR/9XWkPpvYos3aQ: folds 
VCKtuATyvAq9H2JSAQxPbA said, "u guys are idiots im going to a differnet table"
aIEQGxUJwm61WfazSNFCdA joins the table at seat #7 
V6p0jQ/RhUsqpHLmXvEX4Q: raises $0.50 to $0.75
+sbyWwIcFp9kP0bDtMegfQ: folds 
VCKtuATyvAq9H2JSAQxPbA: folds 
VCKtuATyvAq9H2JSAQxPbA leaves the table
Bb42QRQMhg5/Y0vHP8/2Xw: folds 
AcL/hxc9eT0dCr2TYk/0Dg: calls $0.50
*** FLOP *** [Tc 4c 5d]
AcL/hxc9eT0dCr2TYk/0Dg: checks 
7je+LC5Mfs6nL8YBVh4frQ joins the table at seat #8 
V6p0jQ/RhUsqpHLmXvEX4Q: bets $1.50
AcL/hxc9eT0dCr2TYk/0Dg: calls $1.50
*** TURN *** [Tc 4c 5d] [Jd]
AcL/hxc9eT0dCr2TYk/0Dg: checks 
V6p0jQ/RhUsqpHLmXvEX4Q: checks 
*** RIVER *** [Tc 4c 5d Jd] [4d]
AcL/hxc9eT0dCr2TYk/0Dg: checks 
V6p0jQ/RhUsqpHLmXvEX4Q: checks 
*** SHOW DOWN ***
AcL/hxc9eT0dCr2TYk/0Dg: shows [7h 8d] (a pair of Fours)
V6p0jQ/RhUsqpHLmXvEX4Q: shows [9d 9s] (two pair, Nines and Fours)
V6p0jQ/RhUsqpHLmXvEX4Q collected $4.40 from pot
*** SUMMARY ***
Total pot $4.60 | Rake $0.20 
Board [Tc 4c 5d Jd 4d]
Seat 1: AcL/hxc9eT0dCr2TYk/0Dg (big blind) showed [7h 8d] and lost with a pair of Fours
Seat 3: wGigCmBR/9XWkPpvYos3aQ folded before Flop (didn't bet)
Seat 4: V6p0jQ/RhUsqpHLmXvEX4Q showed [9d 9s] and won ($4.40) with two pair, Nines and Fours
Seat 5: +sbyWwIcFp9kP0bDtMegfQ folded before Flop (didn't bet)
Seat 8: VCKtuATyvAq9H2JSAQxPbA (button) folded before Flop (didn't bet)
Seat 9: Bb42QRQMhg5/Y0vHP8/2Xw (small blind) folded before Flop




PokerStars Game #59941703988:  Hold'em No Limit ($0.10/$0.25) - 2009/07/01 1:43:31 ET
Table '4ZbiE0ZYjzqmgu6+sO1prg' 9-max Seat #2 is the button
Seat 1: eXiRSFoUjkV5taBc4N8rMQ ($8.75 in chips) 
Seat 2: 9lvO/qyU+xrU95Teu1fv0g ($5.20 in chips) 
Seat 3: HPEB+AtKw1+C/cxU0o1ciw ($25.30 in chips) 
Seat 4: w1ukf8uPa4+WH561TtVRxA ($25 in chips) 
Seat 5: +2kMBNpY4nF1qNCRd8SJLA ($43.95 in chips) 
Seat 7: aNpwfA31EREwO+ar4XzBCw ($26.30 in chips) 
Seat 8: cZ99hugmLBj9KhTlc8nCSw ($29.60 in chips) 
Seat 9: RCqMONFrSPSArZh2Jsar/w ($20.35 in chips) 
HPEB+AtKw1+C/cxU0o1ciw: posts small blind $0.10
w1ukf8uPa4+WH561TtVRxA: posts big blind $0.25
eXiRSFoUjkV5taBc4N8rMQ: posts small & big blinds $0.35
*** HOLE CARDS ***
+2kMBNpY4nF1qNCRd8SJLA: folds 
aNpwfA31EREwO+ar4XzBCw: folds 
cZ99hugmLBj9KhTlc8nCSw: folds 
RCqMONFrSPSArZh2Jsar/w: folds 
eXiRSFoUjkV5taBc4N8rMQ: checks 
9lvO/qyU+xrU95Teu1fv0g: folds 
HPEB+AtKw1+C/cxU0o1ciw: folds 
w1ukf8uPa4+WH561TtVRxA: checks 
*** FLOP *** [4s 3s Td]
w1ukf8uPa4+WH561TtVRxA: checks 
eXiRSFoUjkV5taBc4N8rMQ: checks 
*** TURN *** [4s 3s Td] [Qc]
w1ukf8uPa4+WH561TtVRxA: checks 
eXiRSFoUjkV5taBc4N8rMQ: bets $0.25
w1ukf8uPa4+WH561TtVRxA: folds 
Uncalled bet ($0.25) returned to eXiRSFoUjkV5taBc4N8rMQ
eXiRSFoUjkV5taBc4N8rMQ collected $0.70 from pot
eXiRSFoUjkV5taBc4N8rMQ: doesn't show hand 
*** SUMMARY ***
Total pot $0.70 | Rake $0 
Board [4s 3s Td Qc]
Seat 1: eXiRSFoUjkV5taBc4N8rMQ collected ($0.70)
Seat 2: 9lvO/qyU+xrU95Teu1fv0g (button) folded before Flop (didn't bet)
Seat 3: HPEB+AtKw1+C/cxU0o1ciw (small blind) folded before Flop
Seat 4: w1ukf8uPa4+WH561TtVRxA (big blind) folded on the Turn
Seat 5: +2kMBNpY4nF1qNCRd8SJLA folded before Flop (didn't bet)
Seat 7: aNpwfA31EREwO+ar4XzBCw folded before Flop (didn't bet)
Seat 8: cZ99hugmLBj9KhTlc8nCSw folded before Flop (didn't bet)
Seat 9: RCqMONFrSPSArZh2Jsar/w folded before Flop (didn't bet)




PokerStars Game #59941704150:  Hold'em No Limit ($0.10/$0.25) - 2009/07/01 1:43:31 ET
Table 'ouLhepGYovxB2x0QxH7cVg' 9-max Seat #4 is the button
Seat 1: ghNKXUBl/H+t83JF079ZBA ($25 in chips) 
Seat 2: r1Z5m4PwSI5ANp7qCE1OJw ($18.85 in chips) 
Seat 3: bXpVeaSTPBFSPJmeXxO7nw ($5.25 in chips) 
Seat 4: a0Sx6GHY7ln2Ns2C97eXeA ($37.55 in chips) 
Seat 5: v60REj6f8jzMYT0VsZvaPQ ($9.75 in chips) 
Seat 7: JRV2PblFtPFz51l0Fwyz8g ($24.85 in chips) 
Seat 8: tLcDklc2rBORNfixyRfVfw ($25 in chips) 
Seat 9: ljemhp25Zg+nlA9DLCIiUw ($25.35 in chips) 
v60REj6f8jzMYT0VsZvaPQ: posts small blind $0.10
JRV2PblFtPFz51l0Fwyz8g: posts big blind $0.25
*** HOLE CARDS ***
tLcDklc2rBORNfixyRfVfw: folds 
ljemhp25Zg+nlA9DLCIiUw: folds 
ghNKXUBl/H+t83JF079ZBA: folds 
r1Z5m4PwSI5ANp7qCE1OJw: folds 
bXpVeaSTPBFSPJmeXxO7nw: folds 
a0Sx6GHY7ln2Ns2C97eXeA: raises $0.25 to $0.50
v60REj6f8jzMYT0VsZvaPQ: folds 
JRV2PblFtPFz51l0Fwyz8g: calls $0.25
*** FLOP *** [4d 9c Ks]
JRV2PblFtPFz51l0Fwyz8g: checks 
a0Sx6GHY7ln2Ns2C97eXeA: bets $0.50
JRV2PblFtPFz51l0Fwyz8g: folds 
Uncalled bet ($0.50) returned to a0Sx6GHY7ln2Ns2C97eXeA
a0Sx6GHY7ln2Ns2C97eXeA collected $1.05 from pot
a0Sx6GHY7ln2Ns2C97eXeA: doesn't show hand 
*** SUMMARY ***
Total pot $1.10 | Rake $0.05 
Board [4d 9c Ks]
Seat 1: ghNKXUBl/H+t83JF079ZBA folded before Flop (didn't bet)
Seat 2: r1Z5m4PwSI5ANp7qCE1OJw folded before Flop (didn't bet)
Seat 3: bXpVeaSTPBFSPJmeXxO7nw folded before Flop (didn't bet)
Seat 4: a0Sx6GHY7ln2Ns2C97eXeA (button) collected ($1.05)
Seat 5: v60REj6f8jzMYT0VsZvaPQ (small blind) folded before Flop
Seat 7: JRV2PblFtPFz51l0Fwyz8g (big blind) folded on the Flop
Seat 8: tLcDklc2rBORNfixyRfVfw folded before Flop (didn't bet)
Seat 9: ljemhp25Zg+nlA9DLCIiUw folded before Flop (didn't bet)




PokerStars Game #59941704350:  Hold'em No Limit ($0.10/$0.25) - 2009/07/01 1:43:32 ET
Table 'hOE09W281uSob0XeJmUcRg' 6-max Seat #1 is the button
Seat 1: mfrkWA3PTeYPkbO6hi98Aw ($27.30 in chips) 
Seat 3: y+a/yGW/Jy4bPJFnaeTz5w ($13.85 in chips) 
Seat 5: JFIAqU8lCZ0vWwEl4bdGsg ($25.35 in chips) 
Seat 6: x4ZJ8E/TUrtoB7WiHcv8WA ($14.25 in chips) 
lRKJ8o/CnOPFwfHHm6ioMw will be allowed to play after the button
y+a/yGW/Jy4bPJFnaeTz5w: posts small blind $0.10
JFIAqU8lCZ0vWwEl4bdGsg: posts big blind $0.25
*** HOLE CARDS ***
x4ZJ8E/TUrtoB7WiHcv8WA: calls $0.25
mfrkWA3PTeYPkbO6hi98Aw: folds 
y+a/yGW/Jy4bPJFnaeTz5w: calls $0.15
JFIAqU8lCZ0vWwEl4bdGsg: checks 
*** FLOP *** [Ad As Jd]
y+a/yGW/Jy4bPJFnaeTz5w: checks 
JFIAqU8lCZ0vWwEl4bdGsg: checks 
x4ZJ8E/TUrtoB7WiHcv8WA: checks 
*** TURN *** [Ad As Jd] [Jh]
y+a/yGW/Jy4bPJFnaeTz5w: checks 
JFIAqU8lCZ0vWwEl4bdGsg: checks 
x4ZJ8E/TUrtoB7WiHcv8WA: checks 
*** RIVER *** [Ad As Jd Jh] [7c]
y+a/yGW/Jy4bPJFnaeTz5w: checks 
JFIAqU8lCZ0vWwEl4bdGsg: checks 
x4ZJ8E/TUrtoB7WiHcv8WA: checks 
*** SHOW DOWN ***
y+a/yGW/Jy4bPJFnaeTz5w: shows [6h 5d] (two pair, Aces and Jacks)
JFIAqU8lCZ0vWwEl4bdGsg: shows [Kc Td] (two pair, Aces and Jacks - King kicker)
x4ZJ8E/TUrtoB7WiHcv8WA: shows [Kh 8d] (two pair, Aces and Jacks)
JFIAqU8lCZ0vWwEl4bdGsg collected $0.40 from pot
x4ZJ8E/TUrtoB7WiHcv8WA collected $0.35 from pot
*** SUMMARY ***
Total pot $0.75 | Rake $0 
Board [Ad As Jd Jh 7c]
Seat 1: mfrkWA3PTeYPkbO6hi98Aw (button) folded before Flop (didn't bet)
Seat 3: y+a/yGW/Jy4bPJFnaeTz5w (small blind) showed [6h 5d] and lost with two pair, Aces and Jacks
Seat 5: JFIAqU8lCZ0vWwEl4bdGsg (big blind) showed [Kc Td] and won ($0.40) with two pair, Aces and Jacks
Seat 6: x4ZJ8E/TUrtoB7WiHcv8WA showed [Kh 8d] and won ($0.35) with two pair, Aces and Jacks




PokerStars Game #59941704518:  Hold'em No Limit ($0.10/$0.25) - 2009/07/01 1:43:32 ET
Table 'IdXp6nyeW4FYaEK4qKCnwQ' 9-max Seat #1 is the button
Seat 1: tLcDklc2rBORNfixyRfVfw ($25 in chips) 
Seat 2: HPEB+AtKw1+C/cxU0o1ciw ($32.60 in chips) 
Seat 3: eK8qa6EPcH2zhtbmWSvc9g ($33.40 in chips) 
Seat 4: j4q3p0lesp63b1gZDwLBZw ($5.35 in chips) 
Seat 5: U41wNf6XauAiBOQaKu2ZIA ($25.65 in chips) 
Seat 6: arxNSjreDRGFg13EAM2F1w ($25.85 in chips) 
Seat 7: w1ukf8uPa4+WH561TtVRxA ($37 in chips) 
Seat 8: dtZ84flFEi4Q+SGrHMJRDQ ($31.10 in chips) 
Seat 9: s2xLPOl/vhl/26apJ3vsOQ ($28.90 in chips) 
HPEB+AtKw1+C/cxU0o1ciw: posts small blind $0.10
eK8qa6EPcH2zhtbmWSvc9g: posts big blind $0.25
*** HOLE CARDS ***
j4q3p0lesp63b1gZDwLBZw: folds 
U41wNf6XauAiBOQaKu2ZIA: raises $0.25 to $0.50
arxNSjreDRGFg13EAM2F1w: calls $0.50
w1ukf8uPa4+WH561TtVRxA: folds 
dtZ84flFEi4Q+SGrHMJRDQ: folds 
s2xLPOl/vhl/26apJ3vsOQ: folds 
tLcDklc2rBORNfixyRfVfw: folds 
HPEB+AtKw1+C/cxU0o1ciw: raises $1.25 to $1.75
eK8qa6EPcH2zhtbmWSvc9g: folds 
U41wNf6XauAiBOQaKu2ZIA: calls $1.25
arxNSjreDRGFg13EAM2F1w: calls $1.25
*** FLOP *** [Td 3d Jd]
HPEB+AtKw1+C/cxU0o1ciw: checks 
U41wNf6XauAiBOQaKu2ZIA: checks 
arxNSjreDRGFg13EAM2F1w: checks 
*** TURN *** [Td 3d Jd] [4s]
HPEB+AtKw1+C/cxU0o1ciw: checks 
U41wNf6XauAiBOQaKu2ZIA: bets $0.75
arxNSjreDRGFg13EAM2F1w: raises $2 to $2.75
HPEB+AtKw1+C/cxU0o1ciw: folds 
U41wNf6XauAiBOQaKu2ZIA: folds 
Uncalled bet ($2) returned to arxNSjreDRGFg13EAM2F1w
arxNSjreDRGFg13EAM2F1w collected $6.70 from pot
arxNSjreDRGFg13EAM2F1w: doesn't show hand 
*** SUMMARY ***
Total pot $7 | Rake $0.30 
Board [Td 3d Jd 4s]
Seat 1: tLcDklc2rBORNfixyRfVfw (button) folded before Flop (didn't bet)
Seat 2: HPEB+AtKw1+C/cxU0o1ciw (small blind) folded on the Turn
Seat 3: eK8qa6EPcH2zhtbmWSvc9g (big blind) folded before Flop
Seat 4: j4q3p0lesp63b1gZDwLBZw folded before Flop (didn't bet)
Seat 5: U41wNf6XauAiBOQaKu2ZIA folded on the Turn
Seat 6: arxNSjreDRGFg13EAM2F1w collected ($6.70)
Seat 7: w1ukf8uPa4+WH561TtVRxA folded before Flop (didn't bet)
Seat 8: dtZ84flFEi4Q+SGrHMJRDQ folded before Flop (didn't bet)
Seat 9: s2xLPOl/vhl/26apJ3vsOQ folded before Flop (didn't bet)




PokerStars Game #59941704674:  Hold'em No Limit ($0.10/$0.25) - 2009/07/01 1:43:32 ET
Table 'Xi38lWH8L2JHRAsKYVX8Qg' 6-max Seat #6 is the button
Seat 1: shP7DFAtX7gXcgMJX/OmRQ ($20.70 in chips) 
Seat 2: VOmI0x4dDPnTESZd5B4d1Q ($9.60 in chips) 
Seat 3: 6DwBRH+xZ12AAZmeAg+aXw ($30.60 in chips) 
Seat 4: kG34n23qFQA3nzdOJTQ1dA ($27.10 in chips) 
Seat 5: 79ID/ub1Pt/mDpCprVmOoA ($77.95 in chips) 
Seat 6: kyRaCIljYA6l33lSKQfNsg ($29.40 in chips) 
shP7DFAtX7gXcgMJX/OmRQ: posts small blind $0.10
VOmI0x4dDPnTESZd5B4d1Q: posts big blind $0.25
*** HOLE CARDS ***
6DwBRH+xZ12AAZmeAg+aXw: raises $0.50 to $0.75
kG34n23qFQA3nzdOJTQ1dA: calls $0.75
79ID/ub1Pt/mDpCprVmOoA: folds 
kyRaCIljYA6l33lSKQfNsg: folds 
shP7DFAtX7gXcgMJX/OmRQ: calls $0.65
VOmI0x4dDPnTESZd5B4d1Q: folds 
*** FLOP *** [4c Ks Kd]
shP7DFAtX7gXcgMJX/OmRQ: checks 
6DwBRH+xZ12AAZmeAg+aXw: checks 
kG34n23qFQA3nzdOJTQ1dA: checks 
*** TURN *** [4c Ks Kd] [Qs]
shP7DFAtX7gXcgMJX/OmRQ: checks 
6DwBRH+xZ12AAZmeAg+aXw: checks 
kG34n23qFQA3nzdOJTQ1dA: bets $1.50
shP7DFAtX7gXcgMJX/OmRQ: calls $1.50
6DwBRH+xZ12AAZmeAg+aXw: calls $1.50
*** RIVER *** [4c Ks Kd Qs] [7c]
shP7DFAtX7gXcgMJX/OmRQ: checks 
6DwBRH+xZ12AAZmeAg+aXw: checks 
kG34n23qFQA3nzdOJTQ1dA: checks 
*** SHOW DOWN ***
shP7DFAtX7gXcgMJX/OmRQ: shows [Tc Th] (two pair, Kings and Tens)
6DwBRH+xZ12AAZmeAg+aXw: shows [Ac Qh] (two pair, Kings and Queens)
kG34n23qFQA3nzdOJTQ1dA: mucks hand 
6DwBRH+xZ12AAZmeAg+aXw collected $6.70 from pot
*** SUMMARY ***
Total pot $7 | Rake $0.30 
Board [4c Ks Kd Qs 7c]
Seat 1: shP7DFAtX7gXcgMJX/OmRQ (small blind) showed [Tc Th] and lost with two pair, Kings and Tens
Seat 2: VOmI0x4dDPnTESZd5B4d1Q (big blind) folded before Flop
Seat 3: 6DwBRH+xZ12AAZmeAg+aXw showed [Ac Qh] and won ($6.70) with two pair, Kings and Queens
Seat 4: kG34n23qFQA3nzdOJTQ1dA mucked
Seat 5: 79ID/ub1Pt/mDpCprVmOoA folded before Flop (didn't bet)
Seat 6: kyRaCIljYA6l33lSKQfNsg (button) folded before Flop (didn't bet)




PokerStars Game #59941705212:  Hold'em No Limit ($0.10/$0.25) - 2009/07/01 1:43:33 ET
Table 'T/iCKJXGphRN3xcdwfE/JQ' 6-max Seat #2 is the button
Seat 1: wAKC8C/zN0c8V5v13dm9mA ($25 in chips) 
Seat 2: EeUZtMU058v2ObUACOF4Og ($36.30 in chips) 
Seat 3: IWAjoCPXtc1XUaZdp+pCpA ($23.45 in chips) 
Seat 4: tSR4329m40dZsN7YOpI9Kw ($52.95 in chips) 
Seat 5: gaPMxLGp9SOj4Lq6t+/0Ig ($4.20 in chips) 
Seat 6: Ey4Kn6PlnYb2srYYBJHvzg ($13.20 in chips) 
IWAjoCPXtc1XUaZdp+pCpA: posts small blind $0.10
tSR4329m40dZsN7YOpI9Kw: posts big blind $0.25
*** HOLE CARDS ***
gaPMxLGp9SOj4Lq6t+/0Ig: folds 
Ey4Kn6PlnYb2srYYBJHvzg: folds 
wAKC8C/zN0c8V5v13dm9mA: folds 
EeUZtMU058v2ObUACOF4Og: folds 
IWAjoCPXtc1XUaZdp+pCpA: folds 
Uncalled bet ($0.15) returned to tSR4329m40dZsN7YOpI9Kw
tSR4329m40dZsN7YOpI9Kw collected $0.20 from pot
*** SUMMARY ***
Total pot $0.20 | Rake $0 
Seat 1: wAKC8C/zN0c8V5v13dm9mA folded before Flop (didn't bet)
Seat 2: EeUZtMU058v2ObUACOF4Og (button) folded before Flop (didn't bet)
Seat 3: IWAjoCPXtc1XUaZdp+pCpA (small blind) folded before Flop
Seat 4: tSR4329m40dZsN7YOpI9Kw (big blind) collected ($0.20)
Seat 5: gaPMxLGp9SOj4Lq6t+/0Ig folded before Flop (didn't bet)
Seat 6: Ey4Kn6PlnYb2srYYBJHvzg folded before Flop (didn't bet)




PokerStars Game #59941705102:  Hold'em No Limit ($0.10/$0.25) - 2009/07/01 1:43:33 ET
Table 'nB7Q7zfNfy6ig6DB+rsgWQ' 6-max Seat #3 is the button
Seat 1: Hzy03WtPHMYwLYM7hTTxQw ($24 in chips) 
Seat 2: 4BHo0wlX9INjkj2727qE0w ($22.30 in chips) 
Seat 3: p3NYOxYhkL7txPRSeXHDeg ($30.45 in chips) 
Seat 4: DihMHaz4WNETH1bPDe13kA ($80.45 in chips) 
Seat 5: xC0kaiDYM6YTlgODL83O5A ($15 in chips) 
Seat 6: MEGIwX0eHRUj63lwYaNhVg ($9.45 in chips) 
DihMHaz4WNETH1bPDe13kA: posts small blind $0.10
xC0kaiDYM6YTlgODL83O5A: posts big blind $0.25
*** HOLE CARDS ***
MEGIwX0eHRUj63lwYaNhVg: calls $0.25
Hzy03WtPHMYwLYM7hTTxQw: folds 
4BHo0wlX9INjkj2727qE0w: folds 
p3NYOxYhkL7txPRSeXHDeg: raises $0.25 to $0.50
DihMHaz4WNETH1bPDe13kA: folds 
xC0kaiDYM6YTlgODL83O5A: folds 
MEGIwX0eHRUj63lwYaNhVg: calls $0.25
*** FLOP *** [7h Qh 4s]
MEGIwX0eHRUj63lwYaNhVg: bets $0.75
p3NYOxYhkL7txPRSeXHDeg: calls $0.75
*** TURN *** [7h Qh 4s] [9s]
MEGIwX0eHRUj63lwYaNhVg: checks 
p3NYOxYhkL7txPRSeXHDeg: bets $0.75
MEGIwX0eHRUj63lwYaNhVg: calls $0.75
*** RIVER *** [7h Qh 4s 9s] [6h]
MEGIwX0eHRUj63lwYaNhVg: checks 
p3NYOxYhkL7txPRSeXHDeg: checks 
*** SHOW DOWN ***
MEGIwX0eHRUj63lwYaNhVg: shows [Js 7s] (a pair of Sevens)
p3NYOxYhkL7txPRSeXHDeg: shows [Td Tc] (a pair of Tens)
p3NYOxYhkL7txPRSeXHDeg collected $4.15 from pot
*** SUMMARY ***
Total pot $4.35 | Rake $0.20 
Board [7h Qh 4s 9s 6h]
Seat 1: Hzy03WtPHMYwLYM7hTTxQw folded before Flop (didn't bet)
Seat 2: 4BHo0wlX9INjkj2727qE0w folded before Flop (didn't bet)
Seat 3: p3NYOxYhkL7txPRSeXHDeg (button) showed [Td Tc] and won ($4.15) with a pair of Tens
Seat 4: DihMHaz4WNETH1bPDe13kA (small blind) folded before Flop
Seat 5: xC0kaiDYM6YTlgODL83O5A (big blind) folded before Flop
Seat 6: MEGIwX0eHRUj63lwYaNhVg showed [Js 7s] and lost with a pair of Sevens




PokerStars Game #59941704766:  Hold'em No Limit ($0.10/$0.25) - 2009/07/01 1:43:33 ET
Table 'Loy/olZ5qoDOSvX4UTujGg' 6-max Seat #6 is the button
Seat 1: HipgaJhkN4ie/tTw4dK3Ug ($12.90 in chips) 
Seat 2: 4z7mPbMLNp4TezHXin63Vw ($16.55 in chips) 
Seat 3: 32YL2ZEp8NT4JB2RVM9euQ ($16.05 in chips) 
Seat 4: /gJNBeCkWL4o85/jvlZ4BA ($28.55 in chips) 
Seat 5: tSR4329m40dZsN7YOpI9Kw ($28.35 in chips) 
Seat 6: qGHGf/553gQnDoklMRe3tg ($26.20 in chips) 
HipgaJhkN4ie/tTw4dK3Ug: posts small blind $0.10
4z7mPbMLNp4TezHXin63Vw: posts big blind $0.25
*** HOLE CARDS ***
32YL2ZEp8NT4JB2RVM9euQ: folds 
/gJNBeCkWL4o85/jvlZ4BA: folds 
tSR4329m40dZsN7YOpI9Kw: folds 
qGHGf/553gQnDoklMRe3tg: folds 
HipgaJhkN4ie/tTw4dK3Ug: folds 
Uncalled bet ($0.15) returned to 4z7mPbMLNp4TezHXin63Vw
4z7mPbMLNp4TezHXin63Vw collected $0.20 from pot
4z7mPbMLNp4TezHXin63Vw: doesn't show hand 
*** SUMMARY ***
Total pot $0.20 | Rake $0 
Seat 1: HipgaJhkN4ie/tTw4dK3Ug (small blind) folded before Flop
Seat 2: 4z7mPbMLNp4TezHXin63Vw (big blind) collected ($0.20)
Seat 3: 32YL2ZEp8NT4JB2RVM9euQ folded before Flop (didn't bet)
Seat 4: /gJNBeCkWL4o85/jvlZ4BA folded before Flop (didn't bet)
Seat 5: tSR4329m40dZsN7YOpI9Kw folded before Flop (didn't bet)
Seat 6: qGHGf/553gQnDoklMRe3tg (button) folded before Flop (didn't bet)




PokerStars Game #59941704824:  Hold'em No Limit ($0.10/$0.25) - 2009/07/01 1:43:33 ET
Table '5VWnrlxdjwVfMWkVS2WE7A' 6-max Seat #4 is the button
Seat 1: 82p+w3EmUaFFHuwpSeGY1w ($14.40 in chips) 
Seat 2: LJI7A1YgDM7hgh7o56+ReQ ($26 in chips) 
Seat 3: SFmT9ZsVopnukjvAzrxTRg ($35.95 in chips) 
Seat 4: Pb/gJ3OxOZx57fFp0MDgkg ($35.35 in chips) 
Seat 5: SgMFmwYtNvq9Y+2ZxPSiWQ ($19.10 in chips) 
Seat 6: LtASJ9OlkqGrrUKGQlpGAw ($5.60 in chips) 
SgMFmwYtNvq9Y+2ZxPSiWQ: posts small blind $0.10
LtASJ9OlkqGrrUKGQlpGAw: posts big blind $0.25
*** HOLE CARDS ***
82p+w3EmUaFFHuwpSeGY1w: calls $0.25
LJI7A1YgDM7hgh7o56+ReQ: folds 
SFmT9ZsVopnukjvAzrxTRg: raises $1 to $1.25
Pb/gJ3OxOZx57fFp0MDgkg: folds 
SgMFmwYtNvq9Y+2ZxPSiWQ: calls $1.15
LtASJ9OlkqGrrUKGQlpGAw: folds 
82p+w3EmUaFFHuwpSeGY1w: folds 
*** FLOP *** [6c Th Kd]
SgMFmwYtNvq9Y+2ZxPSiWQ: checks 
SFmT9ZsVopnukjvAzrxTRg: bets $1.75
SgMFmwYtNvq9Y+2ZxPSiWQ: calls $1.75
*** TURN *** [6c Th Kd] [4h]
SgMFmwYtNvq9Y+2ZxPSiWQ: checks 
SFmT9ZsVopnukjvAzrxTRg: checks 
*** RIVER *** [6c Th Kd 4h] [2s]
SgMFmwYtNvq9Y+2ZxPSiWQ: checks 
SFmT9ZsVopnukjvAzrxTRg: checks 
*** SHOW DOWN ***
SgMFmwYtNvq9Y+2ZxPSiWQ: shows [9s 8s] (high card King)
SFmT9ZsVopnukjvAzrxTRg: shows [As Qc] (high card Ace)
SFmT9ZsVopnukjvAzrxTRg collected $6.20 from pot
*** SUMMARY ***
Total pot $6.50 | Rake $0.30 
Board [6c Th Kd 4h 2s]
Seat 1: 82p+w3EmUaFFHuwpSeGY1w folded before Flop
Seat 2: LJI7A1YgDM7hgh7o56+ReQ folded before Flop (didn't bet)
Seat 3: SFmT9ZsVopnukjvAzrxTRg showed [As Qc] and won ($6.20) with high card Ace
Seat 4: Pb/gJ3OxOZx57fFp0MDgkg (button) folded before Flop (didn't bet)
Seat 5: SgMFmwYtNvq9Y+2ZxPSiWQ (small blind) showed [9s 8s] and lost with high card King
Seat 6: LtASJ9OlkqGrrUKGQlpGAw (big blind) folded before Flop




PokerStars Game #59941704916:  Hold'em No Limit ($0.10/$0.25) - 2009/07/01 1:43:33 ET
Table 'dZNBGqFYSwfOVZvDJ4VjIQ' 6-max Seat #5 is the button
Seat 1: v+QfkGiuj9bgtuNoVnDO8w ($33.20 in chips) 
Seat 2: 3zD3qLXT1bEffAoWGnc7wg ($25.35 in chips) 
Seat 3: kyRaCIljYA6l33lSKQfNsg ($28.30 in chips) 
Seat 4: mFv3iBCtrw9XfCDRB0d46Q ($6.15 in chips) 
Seat 5: +ZlnqPoP3Hg4BIUxDfKd/A ($36.50 in chips) 
Seat 6: ypmjhffk/YHGc51wgVXUTw ($30.50 in chips) 
ypmjhffk/YHGc51wgVXUTw: posts small blind $0.10
v+QfkGiuj9bgtuNoVnDO8w: posts big blind $0.25
*** HOLE CARDS ***
3zD3qLXT1bEffAoWGnc7wg: folds 
kyRaCIljYA6l33lSKQfNsg: folds 
mFv3iBCtrw9XfCDRB0d46Q: folds 
+ZlnqPoP3Hg4BIUxDfKd/A: folds 
ypmjhffk/YHGc51wgVXUTw: folds 
Uncalled bet ($0.15) returned to v+QfkGiuj9bgtuNoVnDO8w
v+QfkGiuj9bgtuNoVnDO8w collected $0.20 from pot
v+QfkGiuj9bgtuNoVnDO8w: doesn't show hand 
*** SUMMARY ***
Total pot $0.20 | Rake $0 
Seat 1: v+QfkGiuj9bgtuNoVnDO8w (big blind) collected ($0.20)
Seat 2: 3zD3qLXT1bEffAoWGnc7wg folded before Flop (didn't bet)
Seat 3: kyRaCIljYA6l33lSKQfNsg folded before Flop (didn't bet)
Seat 4: mFv3iBCtrw9XfCDRB0d46Q folded before Flop (didn't bet)
Seat 5: +ZlnqPoP3Hg4BIUxDfKd/A (button) folded before Flop (didn't bet)
Seat 6: ypmjhffk/YHGc51wgVXUTw (small blind) folded before Flop




PokerStars Game #59941705142:  Hold'em No Limit ($0.10/$0.25) - 2009/07/01 1:43:33 ET
Table 'mk323gviqdkOY5Aek/1EWg' 6-max Seat #1 is the button
Seat 1: L3/N/gliETan8N5Gim5h4Q ($25.40 in chips) 
Seat 2: GC/9yVD59DUCX7hUI7gcLw ($55.90 in chips) 
Seat 3: NuqYPwTLZYQhxOoVK3Yqlw ($23.65 in chips) 
Seat 4: +baiVgI/ETnBARLe5mARCw ($12.15 in chips) 
Seat 5: kjYRzIfvZNNflYMYRkkSVA ($28 in chips) 
Seat 6: KkXSr5xFjxLSD3wtAvT+WQ ($9 in chips) 
GC/9yVD59DUCX7hUI7gcLw: posts small blind $0.10
NuqYPwTLZYQhxOoVK3Yqlw: posts big blind $0.25
*** HOLE CARDS ***
+baiVgI/ETnBARLe5mARCw: calls $0.25
kjYRzIfvZNNflYMYRkkSVA: folds 
KkXSr5xFjxLSD3wtAvT+WQ: folds 
L3/N/gliETan8N5Gim5h4Q: folds 
GC/9yVD59DUCX7hUI7gcLw: calls $0.15
NuqYPwTLZYQhxOoVK3Yqlw: checks 
*** FLOP *** [Td 9d 8s]
GC/9yVD59DUCX7hUI7gcLw: checks 
NuqYPwTLZYQhxOoVK3Yqlw: checks 
+baiVgI/ETnBARLe5mARCw: bets $0.75
GC/9yVD59DUCX7hUI7gcLw: folds 
NuqYPwTLZYQhxOoVK3Yqlw: folds 
Uncalled bet ($0.75) returned to +baiVgI/ETnBARLe5mARCw
+baiVgI/ETnBARLe5mARCw collected $0.75 from pot
+baiVgI/ETnBARLe5mARCw: doesn't show hand 
*** SUMMARY ***
Total pot $0.75 | Rake $0 
Board [Td 9d 8s]
Seat 1: L3/N/gliETan8N5Gim5h4Q (button) folded before Flop (didn't bet)
Seat 2: GC/9yVD59DUCX7hUI7gcLw (small blind) folded on the Flop
Seat 3: NuqYPwTLZYQhxOoVK3Yqlw (big blind) folded on the Flop
Seat 4: +baiVgI/ETnBARLe5mARCw collected ($0.75)
Seat 5: kjYRzIfvZNNflYMYRkkSVA folded before Flop (didn't bet)
Seat 6: KkXSr5xFjxLSD3wtAvT+WQ folded before Flop (didn't bet)




PokerStars Game #59941705072:  Hold'em No Limit ($0.10/$0.25) - 2009/07/01 1:43:33 ET
Table 'YlRA05h9BJ1EhOUSNUjJdg' 9-max Seat #4 is the button
Seat 1: dtZ84flFEi4Q+SGrHMJRDQ ($25 in chips) 
Seat 2: Y2GFAe+PT7xnUUtgqCNDFw ($12.05 in chips) 
Seat 3: Z5ZtGOON8kmSdSCll9Z3XA ($13.20 in chips) 
Seat 4: HPEB+AtKw1+C/cxU0o1ciw ($31 in chips) 
Seat 5: sx0lGrkT9fd4yFR+3cXUQg ($11.15 in chips) 
Seat 6: QEbIGci+itdw+re8RM5fZA ($44.35 in chips) 
Seat 7: dfNim92Z6XK1/h5SFW5vDg ($25 in chips) 
Seat 8: dmYlc+1cjwZMJ7wV+Z0rRg ($32.90 in chips) 
Seat 9: Z9AeOQX3yzuSvKAm/xyovg ($9.75 in chips) 
sx0lGrkT9fd4yFR+3cXUQg: posts small blind $0.10
QEbIGci+itdw+re8RM5fZA: posts big blind $0.25
*** HOLE CARDS ***
dfNim92Z6XK1/h5SFW5vDg: folds 
dmYlc+1cjwZMJ7wV+Z0rRg: folds 
Z9AeOQX3yzuSvKAm/xyovg: folds 
dtZ84flFEi4Q+SGrHMJRDQ: folds 
Y2GFAe+PT7xnUUtgqCNDFw: folds 
Z5ZtGOON8kmSdSCll9Z3XA: folds 
HPEB+AtKw1+C/cxU0o1ciw: raises $0.75 to $1
sx0lGrkT9fd4yFR+3cXUQg: folds 
QEbIGci+itdw+re8RM5fZA: folds 
Uncalled bet ($0.75) returned to HPEB+AtKw1+C/cxU0o1ciw
HPEB+AtKw1+C/cxU0o1ciw collected $0.60 from pot
HPEB+AtKw1+C/cxU0o1ciw: doesn't show hand 
*** SUMMARY ***
Total pot $0.60 | Rake $0 
Seat 1: dtZ84flFEi4Q+SGrHMJRDQ folded before Flop (didn't bet)
Seat 2: Y2GFAe+PT7xnUUtgqCNDFw folded before Flop (didn't bet)
Seat 3: Z5ZtGOON8kmSdSCll9Z3XA folded before Flop (didn't bet)
Seat 4: HPEB+AtKw1+C/cxU0o1ciw (button) collected ($0.60)
Seat 5: sx0lGrkT9fd4yFR+3cXUQg (small blind) folded before Flop
Seat 6: QEbIGci+itdw+re8RM5fZA (big blind) folded before Flop
Seat 7: dfNim92Z6XK1/h5SFW5vDg folded before Flop (didn't bet)
Seat 8: dmYlc+1cjwZMJ7wV+Z0rRg folded before Flop (didn't bet)
Seat 9: Z9AeOQX3yzuSvKAm/xyovg folded before Flop (didn't bet)




PokerStars Game #59941704750:  Hold'em No Limit ($0.10/$0.25) - 2009/07/01 1:43:33 ET
Table 'P1IJQ2p3ACFySC35W1qwQw' 9-max Seat #9 is the button
Seat 1: bXpVeaSTPBFSPJmeXxO7nw ($5 in chips) 
Seat 2: vO3QVRovWemcGMkm7ijAIA ($5.70 in chips) 
Seat 3: PVxvfRTRvkgZf9WtquEkwQ ($25.35 in chips) 
Seat 4: c/9X4zftzphFxYtxp5kp9w ($27.90 in chips) 
Seat 5: ghNKXUBl/H+t83JF079ZBA ($56.45 in chips) 
Seat 6: ljemhp25Zg+nlA9DLCIiUw ($64.45 in chips) 
Seat 7: 7je+LC5Mfs6nL8YBVh4frQ ($5.10 in chips) 
Seat 8: tLcDklc2rBORNfixyRfVfw ($25.90 in chips) 
Seat 9: XXajyXkgbSGJKxQP3mal/Q ($14.90 in chips) 
bXpVeaSTPBFSPJmeXxO7nw: posts small blind $0.10
vO3QVRovWemcGMkm7ijAIA: posts big blind $0.25
*** HOLE CARDS ***
PVxvfRTRvkgZf9WtquEkwQ: folds 
c/9X4zftzphFxYtxp5kp9w: folds 
ghNKXUBl/H+t83JF079ZBA: folds 
ljemhp25Zg+nlA9DLCIiUw: folds 
7je+LC5Mfs6nL8YBVh4frQ: folds 
tLcDklc2rBORNfixyRfVfw: raises $0.50 to $0.75
XXajyXkgbSGJKxQP3mal/Q: folds 
bXpVeaSTPBFSPJmeXxO7nw: folds 
vO3QVRovWemcGMkm7ijAIA: folds 
Uncalled bet ($0.50) returned to tLcDklc2rBORNfixyRfVfw
tLcDklc2rBORNfixyRfVfw collected $0.60 from pot
tLcDklc2rBORNfixyRfVfw: doesn't show hand 
*** SUMMARY ***
Total pot $0.60 | Rake $0 
Seat 1: bXpVeaSTPBFSPJmeXxO7nw (small blind) folded before Flop
Seat 2: vO3QVRovWemcGMkm7ijAIA (big blind) folded before Flop
Seat 3: PVxvfRTRvkgZf9WtquEkwQ folded before Flop (didn't bet)
Seat 4: c/9X4zftzphFxYtxp5kp9w folded before Flop (didn't bet)
Seat 5: ghNKXUBl/H+t83JF079ZBA folded before Flop (didn't bet)
Seat 6: ljemhp25Zg+nlA9DLCIiUw folded before Flop (didn't bet)
Seat 7: 7je+LC5Mfs6nL8YBVh4frQ folded before Flop (didn't bet)
Seat 8: tLcDklc2rBORNfixyRfVfw collected ($0.60)
Seat 9: XXajyXkgbSGJKxQP3mal/Q (button) folded before Flop (didn't bet)




PokerStars Game #59941704888:  Hold'em No Limit ($0.10/$0.25) - 2009/07/01 1:43:33 ET
Table '/asc7VQ/OpF/oVJ3erB80w' 9-max Seat #8 is the button
Seat 2: +LseQ4csMghI3KY4cLSGMQ ($13.20 in chips) 
Seat 3: WEb58GPxGJGcxGh34AFZRQ ($2.45 in chips) 
Seat 4: Rjy74A2wdEiDWplMcUbA+w ($19.35 in chips) 
Seat 5: QB9VESHry/CRTDKMGwKwsQ ($42.45 in chips) 
Seat 6: XwQK8xvCADxp0bUmji+Zyg ($11.95 in chips) 
Seat 7: 7Qlge5BZqMQvXxiy4HU3Hw ($6.40 in chips) 
Seat 8: jB7U2KxE3pjvDhvZHXK2Ag ($19.60 in chips) 
Seat 9: zUXhymECc2C9W9ZNw6qppA ($19.15 in chips) 
zUXhymECc2C9W9ZNw6qppA: posts small blind $0.10
+LseQ4csMghI3KY4cLSGMQ: posts big blind $0.25
*** HOLE CARDS ***
WEb58GPxGJGcxGh34AFZRQ: calls $0.25
Rjy74A2wdEiDWplMcUbA+w: folds 
QB9VESHry/CRTDKMGwKwsQ: folds 
XwQK8xvCADxp0bUmji+Zyg: folds 
7Qlge5BZqMQvXxiy4HU3Hw: raises $0.75 to $1
jB7U2KxE3pjvDhvZHXK2Ag: folds 
zUXhymECc2C9W9ZNw6qppA: folds 
+LseQ4csMghI3KY4cLSGMQ: calls $0.75
WEb58GPxGJGcxGh34AFZRQ: calls $0.75
*** FLOP *** [4c 5d 6c]
+LseQ4csMghI3KY4cLSGMQ: bets $0.50
WEb58GPxGJGcxGh34AFZRQ: calls $0.50
7Qlge5BZqMQvXxiy4HU3Hw: raises $4.90 to $5.40 and is all-in
+LseQ4csMghI3KY4cLSGMQ: calls $4.90
WEb58GPxGJGcxGh34AFZRQ: calls $0.95 and is all-in
*** TURN *** [4c 5d 6c] [As]
*** RIVER *** [4c 5d 6c As] [Ad]
XwQK8xvCADxp0bUmji+Zyg leaves the table
*** SHOW DOWN ***
+LseQ4csMghI3KY4cLSGMQ: shows [6h 7h] (two pair, Aces and Sixes)
7Qlge5BZqMQvXxiy4HU3Hw: shows [Td Th] (two pair, Aces and Tens)
7Qlge5BZqMQvXxiy4HU3Hw collected $7.50 from side pot
WEb58GPxGJGcxGh34AFZRQ: shows [Ac 2d] (three of a kind, Aces)
WEb58GPxGJGcxGh34AFZRQ collected $7.10 from main pot
ValerbI4_K joins the table at seat #6 
*** SUMMARY ***
Total pot $15.35 Main pot $7.10. Side pot $7.50. | Rake $0.75 
Board [4c 5d 6c As Ad]
Seat 2: +LseQ4csMghI3KY4cLSGMQ (big blind) showed [6h 7h] and lost with two pair, Aces and Sixes
Seat 3: WEb58GPxGJGcxGh34AFZRQ showed [Ac 2d] and won ($7.10) with three of a kind, Aces
Seat 4: Rjy74A2wdEiDWplMcUbA+w folded before Flop (didn't bet)
Seat 5: QB9VESHry/CRTDKMGwKwsQ folded before Flop (didn't bet)
Seat 6: XwQK8xvCADxp0bUmji+Zyg folded before Flop (didn't bet)
Seat 7: 7Qlge5BZqMQvXxiy4HU3Hw showed [Td Th] and won ($7.50) with two pair, Aces and Tens
Seat 8: jB7U2KxE3pjvDhvZHXK2Ag (button) folded before Flop (didn't bet)
Seat 9: zUXhymECc2C9W9ZNw6qppA (small blind) folded before Flop




PokerStars Game #59941705684:  Hold'em No Limit ($0.10/$0.25) - 2009/07/01 1:43:34 ET
Table 'sCop8wmj9zlSS2KJqk1QKQ' 9-max Seat #5 is the button
Seat 1: dtZ84flFEi4Q+SGrHMJRDQ ($40.85 in chips) 
Seat 2: YZaC69gFrepA6oCGtu7E0w ($39.35 in chips) 
Seat 4: msUzkZl2RntUnTl6E8WaNA ($10.55 in chips) 
Seat 5: RHqgdFvufLCYe54+qd2gcA ($4.65 in chips) 
Seat 6: hZuGwtYmFKPmQ+v1wlmdfA ($42.80 in chips) 
Seat 7: 1gbA06IVB5XVZNlkqj7zJw ($17.75 in chips) 
Seat 8: xnVwSkROfRtOw4eSoDANtw ($20.65 in chips) 
Seat 9: tLcDklc2rBORNfixyRfVfw ($25 in chips) 
hZuGwtYmFKPmQ+v1wlmdfA: posts small blind $0.10
1gbA06IVB5XVZNlkqj7zJw: posts big blind $0.25
UkF1eqqUN0CCiimXAuN7og: sits out 
*** HOLE CARDS ***
xnVwSkROfRtOw4eSoDANtw: folds 
tLcDklc2rBORNfixyRfVfw: folds 
dtZ84flFEi4Q+SGrHMJRDQ: folds 
YZaC69gFrepA6oCGtu7E0w: folds 
msUzkZl2RntUnTl6E8WaNA: folds 
RHqgdFvufLCYe54+qd2gcA: raises $0.50 to $0.75
hZuGwtYmFKPmQ+v1wlmdfA: folds 
1gbA06IVB5XVZNlkqj7zJw: calls $0.50
*** FLOP *** [5c As Jh]
1gbA06IVB5XVZNlkqj7zJw: checks 
UkF1eqqUN0CCiimXAuN7og leaves the table
RHqgdFvufLCYe54+qd2gcA: bets $1.25
1gbA06IVB5XVZNlkqj7zJw: raises $2.75 to $4
RHqgdFvufLCYe54+qd2gcA: calls $2.65 and is all-in
Uncalled bet ($0.10) returned to 1gbA06IVB5XVZNlkqj7zJw
*** TURN *** [5c As Jh] [Qh]
M/9j4wkHH9i1JM51vgi1VA joins the table at seat #3 
*** RIVER *** [5c As Jh Qh] [Tc]
*** SHOW DOWN ***
1gbA06IVB5XVZNlkqj7zJw: shows [Jc Ac] (two pair, Aces and Jacks)
RHqgdFvufLCYe54+qd2gcA: shows [Ad Qd] (two pair, Aces and Queens)
RHqgdFvufLCYe54+qd2gcA collected $8.95 from pot
*** SUMMARY ***
Total pot $9.40 | Rake $0.45 
Board [5c As Jh Qh Tc]
Seat 1: dtZ84flFEi4Q+SGrHMJRDQ folded before Flop (didn't bet)
Seat 2: YZaC69gFrepA6oCGtu7E0w folded before Flop (didn't bet)
Seat 4: msUzkZl2RntUnTl6E8WaNA folded before Flop (didn't bet)
Seat 5: RHqgdFvufLCYe54+qd2gcA (button) showed [Ad Qd] and won ($8.95) with two pair, Aces and Queens
Seat 6: hZuGwtYmFKPmQ+v1wlmdfA (small blind) folded before Flop
Seat 7: 1gbA06IVB5XVZNlkqj7zJw (big blind) showed [Jc Ac] and lost with two pair, Aces and Jacks
Seat 8: xnVwSkROfRtOw4eSoDANtw folded before Flop (didn't bet)
Seat 9: tLcDklc2rBORNfixyRfVfw folded before Flop (didn't bet)




PokerStars Game #59941705636:  Hold'em No Limit ($0.10/$0.25) - 2009/07/01 1:43:34 ET
Table '3lL16FBjWXTx3AjK5lMRww' 9-max Seat #8 is the button
Seat 1: fDGyaQz0cs2s4FOYxkbIHA ($16.55 in chips) 
Seat 2: c/9X4zftzphFxYtxp5kp9w ($20.15 in chips) 
Seat 3: QEbIGci+itdw+re8RM5fZA ($27.95 in chips) 
Seat 4: Z3a37Ry74FVl+CBZtAONiA ($6.55 in chips) 
Seat 6: zUXhymECc2C9W9ZNw6qppA ($9.65 in chips) 
Seat 7: 6RiVTYll/5D8zICp0MRpKw ($25.70 in chips) 
Seat 8: ljemhp25Zg+nlA9DLCIiUw ($25 in chips) 
Seat 9: 00Ybni1cxfHtqmdWwh31Xg ($10.40 in chips) 
00Ybni1cxfHtqmdWwh31Xg: posts small blind $0.10
fDGyaQz0cs2s4FOYxkbIHA: posts big blind $0.25
*** HOLE CARDS ***
c/9X4zftzphFxYtxp5kp9w: folds 
QEbIGci+itdw+re8RM5fZA: folds 
Z3a37Ry74FVl+CBZtAONiA: folds 
M/9j4wkHH9i1JM51vgi1VA has returned
zUXhymECc2C9W9ZNw6qppA: folds 
6RiVTYll/5D8zICp0MRpKw: folds 
ljemhp25Zg+nlA9DLCIiUw: folds 
00Ybni1cxfHtqmdWwh31Xg: folds 
Uncalled bet ($0.15) returned to fDGyaQz0cs2s4FOYxkbIHA
fDGyaQz0cs2s4FOYxkbIHA collected $0.20 from pot
fDGyaQz0cs2s4FOYxkbIHA: doesn't show hand 
*** SUMMARY ***
Total pot $0.20 | Rake $0 
Seat 1: fDGyaQz0cs2s4FOYxkbIHA (big blind) collected ($0.20)
Seat 2: c/9X4zftzphFxYtxp5kp9w folded before Flop (didn't bet)
Seat 3: QEbIGci+itdw+re8RM5fZA folded before Flop (didn't bet)
Seat 4: Z3a37Ry74FVl+CBZtAONiA folded before Flop (didn't bet)
Seat 6: zUXhymECc2C9W9ZNw6qppA folded before Flop (didn't bet)
Seat 7: 6RiVTYll/5D8zICp0MRpKw folded before Flop (didn't bet)
Seat 8: ljemhp25Zg+nlA9DLCIiUw (button) folded before Flop (didn't bet)
Seat 9: 00Ybni1cxfHtqmdWwh31Xg (small blind) folded before Flop




PokerStars Game #59941705340:  Hold'em No Limit ($0.10/$0.25) - 2009/07/01 1:43:34 ET
Table '2O5CgfSkSwrr4PDrlZ1RLQ' 6-max Seat #6 is the button
Seat 1: 3skmHD9EOATKdUzzyHh1KA ($30.30 in chips) 
Seat 2: wqphQtauX5Qn7WRJZS1flA ($25 in chips) 
Seat 3: oBUDUfeUyCbZBsjxHZgSiw ($29.10 in chips) 
Seat 5: 0av6tRNdi0Ui4f15L7gsVg ($21.90 in chips) 
Seat 6: tj9xqoqQaDaFw7u1oyZrtA ($48.15 in chips) 
3skmHD9EOATKdUzzyHh1KA: posts small blind $0.10
wqphQtauX5Qn7WRJZS1flA: posts big blind $0.25
epAUIB7h2FJXzUPRIvSkRA: sits out 
*** HOLE CARDS ***
oBUDUfeUyCbZBsjxHZgSiw: raises $0.75 to $1
0av6tRNdi0Ui4f15L7gsVg: calls $1
tj9xqoqQaDaFw7u1oyZrtA: calls $1
3skmHD9EOATKdUzzyHh1KA: folds 
wqphQtauX5Qn7WRJZS1flA: folds 
*** FLOP *** [Qd Qs Ks]
oBUDUfeUyCbZBsjxHZgSiw: checks 
0av6tRNdi0Ui4f15L7gsVg: checks 
tj9xqoqQaDaFw7u1oyZrtA: bets $3
oBUDUfeUyCbZBsjxHZgSiw: calls $3
0av6tRNdi0Ui4f15L7gsVg: folds 
*** TURN *** [Qd Qs Ks] [Td]
oBUDUfeUyCbZBsjxHZgSiw: checks 
tj9xqoqQaDaFw7u1oyZrtA: checks 
*** RIVER *** [Qd Qs Ks Td] [8c]
oBUDUfeUyCbZBsjxHZgSiw: checks 
tj9xqoqQaDaFw7u1oyZrtA: bets $1.50
oBUDUfeUyCbZBsjxHZgSiw: calls $1.50
*** SHOW DOWN ***
tj9xqoqQaDaFw7u1oyZrtA: shows [Ad Qh] (three of a kind, Queens)
oBUDUfeUyCbZBsjxHZgSiw: mucks hand 
tj9xqoqQaDaFw7u1oyZrtA collected $11.80 from pot
*** SUMMARY ***
Total pot $12.35 | Rake $0.55 
Board [Qd Qs Ks Td 8c]
Seat 1: 3skmHD9EOATKdUzzyHh1KA (small blind) folded before Flop
Seat 2: wqphQtauX5Qn7WRJZS1flA (big blind) folded before Flop
Seat 3: oBUDUfeUyCbZBsjxHZgSiw mucked
Seat 5: 0av6tRNdi0Ui4f15L7gsVg folded on the Flop
Seat 6: tj9xqoqQaDaFw7u1oyZrtA (button) showed [Ad Qh] and won ($11.80) with three of a kind, Queens




PokerStars Game #59941705718:  Hold'em No Limit ($0.10/$0.25) - 2009/07/01 1:43:34 ET
Table 'HzFR0rxmDAPu5GzYR0AlYg' 6-max Seat #5 is the button
Seat 1: v+QfkGiuj9bgtuNoVnDO8w ($30.30 in chips) 
Seat 2: UA5OsKS3VPaxa7uC8La/kA ($51.25 in chips) 
Seat 3: kG34n23qFQA3nzdOJTQ1dA ($24.65 in chips) 
Seat 5: lquriepNQBhDV5P1SWHhnA ($29.85 in chips) 
Seat 6: jp34e617tIzV8tKIWmfAbA ($36.55 in chips) 
jp34e617tIzV8tKIWmfAbA: posts small blind $0.10
v+QfkGiuj9bgtuNoVnDO8w: posts big blind $0.25
StevenWu: sits out 
*** HOLE CARDS ***
UA5OsKS3VPaxa7uC8La/kA: folds 
kG34n23qFQA3nzdOJTQ1dA: calls $0.25
lquriepNQBhDV5P1SWHhnA: folds 
jp34e617tIzV8tKIWmfAbA: calls $0.15
v+QfkGiuj9bgtuNoVnDO8w: checks 
*** FLOP *** [4c Qc 8c]
jp34e617tIzV8tKIWmfAbA: checks 
v+QfkGiuj9bgtuNoVnDO8w: checks 
kG34n23qFQA3nzdOJTQ1dA: checks 
*** TURN *** [4c Qc 8c] [3c]
jp34e617tIzV8tKIWmfAbA: checks 
v+QfkGiuj9bgtuNoVnDO8w: checks 
kG34n23qFQA3nzdOJTQ1dA: checks 
*** RIVER *** [4c Qc 8c 3c] [9c]
jp34e617tIzV8tKIWmfAbA: checks 
v+QfkGiuj9bgtuNoVnDO8w: checks 
kG34n23qFQA3nzdOJTQ1dA: bets $1
jp34e617tIzV8tKIWmfAbA: folds 
v+QfkGiuj9bgtuNoVnDO8w: folds 
Uncalled bet ($1) returned to kG34n23qFQA3nzdOJTQ1dA
kG34n23qFQA3nzdOJTQ1dA collected $0.75 from pot
*** SUMMARY ***
Total pot $0.75 | Rake $0 
Board [4c Qc 8c 3c 9c]
Seat 1: v+QfkGiuj9bgtuNoVnDO8w (big blind) folded on the River
Seat 2: UA5OsKS3VPaxa7uC8La/kA folded before Flop (didn't bet)
Seat 3: kG34n23qFQA3nzdOJTQ1dA collected ($0.75)
Seat 5: lquriepNQBhDV5P1SWHhnA (button) folded before Flop (didn't bet)
Seat 6: jp34e617tIzV8tKIWmfAbA (small blind) folded on the River




PokerStars Game #59941705658:  Hold'em No Limit ($0.10/$0.25) - 2009/07/01 1:43:34 ET
Table '9L7XfAwuM7XsXE8LIg2o5Q' 6-max Seat #3 is the button
Seat 1: dOIoLBxmpLHSXBN9LZnf0Q ($25.20 in chips) 
Seat 2: LJI7A1YgDM7hgh7o56+ReQ ($25.85 in chips) 
Seat 3: mFv3iBCtrw9XfCDRB0d46Q ($4.65 in chips) 
Seat 4: jp34e617tIzV8tKIWmfAbA ($39.70 in chips) 
Seat 6: k9nHZTHt8hYhYRcW8NTb4g ($38.05 in chips) 
jp34e617tIzV8tKIWmfAbA: posts small blind $0.10
k9nHZTHt8hYhYRcW8NTb4g: posts big blind $0.25
*** HOLE CARDS ***
dOIoLBxmpLHSXBN9LZnf0Q: folds 
LJI7A1YgDM7hgh7o56+ReQ: folds 
mFv3iBCtrw9XfCDRB0d46Q: folds 
jp34e617tIzV8tKIWmfAbA: calls $0.15
texthgr8 joins the table at seat #5 
k9nHZTHt8hYhYRcW8NTb4g: checks 
*** FLOP *** [Ts Jc Td]
jp34e617tIzV8tKIWmfAbA: checks 
k9nHZTHt8hYhYRcW8NTb4g: bets $0.50
jp34e617tIzV8tKIWmfAbA: folds 
Uncalled bet ($0.50) returned to k9nHZTHt8hYhYRcW8NTb4g
k9nHZTHt8hYhYRcW8NTb4g collected $0.50 from pot
k9nHZTHt8hYhYRcW8NTb4g: doesn't show hand 
*** SUMMARY ***
Total pot $0.50 | Rake $0 
Board [Ts Jc Td]
Seat 1: dOIoLBxmpLHSXBN9LZnf0Q folded before Flop (didn't bet)
Seat 2: LJI7A1YgDM7hgh7o56+ReQ folded before Flop (didn't bet)
Seat 3: mFv3iBCtrw9XfCDRB0d46Q (button) folded before Flop (didn't bet)
Seat 4: jp34e617tIzV8tKIWmfAbA (small blind) folded on the Flop
Seat 6: k9nHZTHt8hYhYRcW8NTb4g (big blind) collected ($0.50)




PokerStars Game #59941705306:  Hold'em No Limit ($0.10/$0.25) - 2009/07/01 1:43:34 ET
Table 'wGizWOswEL6P5QrvVkno/g' 6-max Seat #4 is the button
Seat 1: Qbfkn+ucISvbd1Xh32zAGA ($24.65 in chips) 
Seat 2: mfrkWA3PTeYPkbO6hi98Aw ($25 in chips) 
Seat 3: bJFzs6QmEEnz4miMfSDtcg ($13.65 in chips) 
Seat 4: 32YL2ZEp8NT4JB2RVM9euQ ($16.30 in chips) 
Seat 6: rfSnsAuAfXTb8w/obc9OVQ ($9.05 in chips) 
rfSnsAuAfXTb8w/obc9OVQ: posts small blind $0.10
Qbfkn+ucISvbd1Xh32zAGA: posts big blind $0.25
*** HOLE CARDS ***
mfrkWA3PTeYPkbO6hi98Aw: folds 
bJFzs6QmEEnz4miMfSDtcg: folds 
32YL2ZEp8NT4JB2RVM9euQ: folds 
rfSnsAuAfXTb8w/obc9OVQ: raises $0.25 to $0.50
Qbfkn+ucISvbd1Xh32zAGA: folds 
Uncalled bet ($0.25) returned to rfSnsAuAfXTb8w/obc9OVQ
rfSnsAuAfXTb8w/obc9OVQ collected $0.50 from pot
rfSnsAuAfXTb8w/obc9OVQ: doesn't show hand 
*** SUMMARY ***
Total pot $0.50 | Rake $0 
Seat 1: Qbfkn+ucISvbd1Xh32zAGA (big blind) folded before Flop
Seat 2: mfrkWA3PTeYPkbO6hi98Aw folded before Flop (didn't bet)
Seat 3: bJFzs6QmEEnz4miMfSDtcg folded before Flop (didn't bet)
Seat 4: 32YL2ZEp8NT4JB2RVM9euQ (button) folded before Flop (didn't bet)
Seat 6: rfSnsAuAfXTb8w/obc9OVQ (small blind) collected ($0.50)




PokerStars Game #59941705624:  Hold'em No Limit ($0.10/$0.25) - 2009/07/01 1:43:34 ET
Table 'WY+lMaAoIdBZmwk27/RJCA' 6-max Seat #4 is the button
Seat 1: zHHLkD2sRljslKKeQv/ZQw ($26.10 in chips) 
Seat 2: NhUN/JpAprdJeamFBgJH1w ($26.90 in chips) 
Seat 3: 79Q62AM0VB++TQYiBlOYsA ($80.80 in chips) 
Seat 4: 0av6tRNdi0Ui4f15L7gsVg ($25 in chips) 
Seat 5: vqWjZmdQu/Hxw96/IJTWdQ ($30.20 in chips) 
Seat 6: cWc85bEzdRzpUMhRKm8pwQ ($25.85 in chips) 
vqWjZmdQu/Hxw96/IJTWdQ: posts small blind $0.10
cWc85bEzdRzpUMhRKm8pwQ: posts big blind $0.25
*** HOLE CARDS ***
zHHLkD2sRljslKKeQv/ZQw: raises $0.50 to $0.75
NhUN/JpAprdJeamFBgJH1w: folds 
79Q62AM0VB++TQYiBlOYsA has timed out
79Q62AM0VB++TQYiBlOYsA: folds 
79Q62AM0VB++TQYiBlOYsA is sitting out
0av6tRNdi0Ui4f15L7gsVg: folds 
79Q62AM0VB++TQYiBlOYsA leaves the table
vqWjZmdQu/Hxw96/IJTWdQ: folds 
cWc85bEzdRzpUMhRKm8pwQ: folds 
Uncalled bet ($0.50) returned to zHHLkD2sRljslKKeQv/ZQw
QqiZLFrN8iOUT/GHw7ztOA joins the table at seat #3 
zHHLkD2sRljslKKeQv/ZQw collected $0.60 from pot
*** SUMMARY ***
Total pot $0.60 | Rake $0 
Seat 1: zHHLkD2sRljslKKeQv/ZQw collected ($0.60)
Seat 2: NhUN/JpAprdJeamFBgJH1w folded before Flop (didn't bet)
Seat 3: 79Q62AM0VB++TQYiBlOYsA folded before Flop (didn't bet)
Seat 4: 0av6tRNdi0Ui4f15L7gsVg (button) folded before Flop (didn't bet)
Seat 5: vqWjZmdQu/Hxw96/IJTWdQ (small blind) folded before Flop
Seat 6: cWc85bEzdRzpUMhRKm8pwQ (big blind) folded before Flop




PokerStars Game #59941705284:  Hold'em No Limit ($0.10/$0.25) - 2009/07/01 1:43:34 ET
Table 'xkqAWQFDrFt4p81M8UsoNw' 9-max Seat #4 is the button
Seat 1: tLcDklc2rBORNfixyRfVfw ($28.25 in chips) 
Seat 3: xHZZRLAaFUIC8WWI8ljOJA ($24 in chips) 
Seat 4: wGigCmBR/9XWkPpvYos3aQ ($25.10 in chips) 
Seat 6: 6RiVTYll/5D8zICp0MRpKw ($24.75 in chips) 
Seat 7: MG90wfSJZnOejs/KD3vlQQ ($43.05 in chips) 
Seat 8: MaqsqnOOkbNuPf4oWvOtnA ($41.70 in chips) 
Seat 9: Z9AeOQX3yzuSvKAm/xyovg ($9.65 in chips) 
6RiVTYll/5D8zICp0MRpKw: posts small blind $0.10
MG90wfSJZnOejs/KD3vlQQ: posts big blind $0.25
*** HOLE CARDS ***
MaqsqnOOkbNuPf4oWvOtnA: calls $0.25
Z9AeOQX3yzuSvKAm/xyovg: folds 
tLcDklc2rBORNfixyRfVfw: folds 
xHZZRLAaFUIC8WWI8ljOJA: folds 
wGigCmBR/9XWkPpvYos3aQ: folds 
H5Se03ZqSX7tbULXur2MAg joins the table at seat #5 
6RiVTYll/5D8zICp0MRpKw: calls $0.15
MG90wfSJZnOejs/KD3vlQQ: checks 
*** FLOP *** [3c 9s 6c]
6RiVTYll/5D8zICp0MRpKw: bets $0.75
MG90wfSJZnOejs/KD3vlQQ: folds 
MaqsqnOOkbNuPf4oWvOtnA: calls $0.75
*** TURN *** [3c 9s 6c] [4s]
6RiVTYll/5D8zICp0MRpKw: bets $1
MaqsqnOOkbNuPf4oWvOtnA: calls $1
*** RIVER *** [3c 9s 6c 4s] [3h]
6RiVTYll/5D8zICp0MRpKw: checks 
MaqsqnOOkbNuPf4oWvOtnA: bets $2
6RiVTYll/5D8zICp0MRpKw: folds 
Uncalled bet ($2) returned to MaqsqnOOkbNuPf4oWvOtnA
MaqsqnOOkbNuPf4oWvOtnA collected $4.05 from pot
*** SUMMARY ***
Total pot $4.25 | Rake $0.20 
Board [3c 9s 6c 4s 3h]
Seat 1: tLcDklc2rBORNfixyRfVfw folded before Flop (didn't bet)
Seat 3: xHZZRLAaFUIC8WWI8ljOJA folded before Flop (didn't bet)
Seat 4: wGigCmBR/9XWkPpvYos3aQ (button) folded before Flop (didn't bet)
Seat 6: 6RiVTYll/5D8zICp0MRpKw (small blind) folded on the River
Seat 7: MG90wfSJZnOejs/KD3vlQQ (big blind) folded on the Flop
Seat 8: MaqsqnOOkbNuPf4oWvOtnA collected ($4.05)
Seat 9: Z9AeOQX3yzuSvKAm/xyovg folded before Flop (didn't bet)




PokerStars Game #59941705938:  Hold'em No Limit ($0.10/$0.25) - 2009/07/01 1:43:35 ET
Table 'KU/HrxqxwDz8HKEhYTZ6uw' 6-max Seat #3 is the button
Seat 1: 7LKoiQHXpTQXJvWQrw907g ($33.30 in chips) 
Seat 2: kG34n23qFQA3nzdOJTQ1dA ($25 in chips) 
Seat 3: SFmT9ZsVopnukjvAzrxTRg ($25 in chips) 
Seat 4: AGwMM0FUhYZf81+oXvYQMg ($26.15 in chips) 
Seat 5: iyZxqznXjv3vtvOJymkoLQ ($51.25 in chips) 
Seat 6: qWxkCeqApAWdAA0evrfDvQ ($15.80 in chips) 
AGwMM0FUhYZf81+oXvYQMg: posts small blind $0.10
iyZxqznXjv3vtvOJymkoLQ: posts big blind $0.25
*** HOLE CARDS ***
qWxkCeqApAWdAA0evrfDvQ: calls $0.25
7LKoiQHXpTQXJvWQrw907g: calls $0.25
kG34n23qFQA3nzdOJTQ1dA: folds 
SFmT9ZsVopnukjvAzrxTRg: folds 
AGwMM0FUhYZf81+oXvYQMg: calls $0.15
iyZxqznXjv3vtvOJymkoLQ: checks 
*** FLOP *** [Td 9h Ks]
AGwMM0FUhYZf81+oXvYQMg: checks 
iyZxqznXjv3vtvOJymkoLQ: checks 
qWxkCeqApAWdAA0evrfDvQ: checks 
7LKoiQHXpTQXJvWQrw907g: checks 
*** TURN *** [Td 9h Ks] [5c]
AGwMM0FUhYZf81+oXvYQMg: checks 
iyZxqznXjv3vtvOJymkoLQ: checks 
qWxkCeqApAWdAA0evrfDvQ: bets $0.50
7LKoiQHXpTQXJvWQrw907g: calls $0.50
AGwMM0FUhYZf81+oXvYQMg: folds 
iyZxqznXjv3vtvOJymkoLQ: folds 
*** RIVER *** [Td 9h Ks 5c] [Qs]
qWxkCeqApAWdAA0evrfDvQ: bets $0.75
7LKoiQHXpTQXJvWQrw907g: folds 
Uncalled bet ($0.75) returned to qWxkCeqApAWdAA0evrfDvQ
qWxkCeqApAWdAA0evrfDvQ collected $1.95 from pot
*** SUMMARY ***
Total pot $2 | Rake $0.05 
Board [Td 9h Ks 5c Qs]
Seat 1: 7LKoiQHXpTQXJvWQrw907g folded on the River
Seat 2: kG34n23qFQA3nzdOJTQ1dA folded before Flop (didn't bet)
Seat 3: SFmT9ZsVopnukjvAzrxTRg (button) folded before Flop (didn't bet)
Seat 4: AGwMM0FUhYZf81+oXvYQMg (small blind) folded on the Turn
Seat 5: iyZxqznXjv3vtvOJymkoLQ (big blind) folded on the Turn
Seat 6: qWxkCeqApAWdAA0evrfDvQ collected ($1.95)




PokerStars Game #59941706224:  Hold'em No Limit ($0.10/$0.25) - 2009/07/01 1:43:35 ET
Table 'BabJGL6tfXQp3leBGbYe8A' 9-max Seat #9 is the button
Seat 1: qwr38jl5txoR36M7G5qi4A ($7.75 in chips) 
Seat 2: dtZ84flFEi4Q+SGrHMJRDQ ($36 in chips) 
Seat 3: sD+TKtt36XiiN6jqHiLwDA ($25.70 in chips) 
Seat 4: gehe91e0IyVT0QU/XBkEyg ($28.45 in chips) 
Seat 5: GrNTWMdwy+jC6Lred1eDng ($15 in chips) 
Seat 6: egvg3mTBBVzMHnJPIQiKcA ($14.15 in chips) 
Seat 7: eK8qa6EPcH2zhtbmWSvc9g ($27.85 in chips) 
Seat 9: P+9ymZQ3ktpQu1bn7HIjew ($9.50 in chips) 
qwr38jl5txoR36M7G5qi4A: posts small blind $0.10
dtZ84flFEi4Q+SGrHMJRDQ: posts big blind $0.25
*** HOLE CARDS ***
sD+TKtt36XiiN6jqHiLwDA: folds 
gehe91e0IyVT0QU/XBkEyg: folds 
GrNTWMdwy+jC6Lred1eDng: folds 
OXPkK84/qv92EMwXPiG5rQ joins the table at seat #8 
egvg3mTBBVzMHnJPIQiKcA: folds 
eK8qa6EPcH2zhtbmWSvc9g: folds 
P+9ymZQ3ktpQu1bn7HIjew: folds 
qwr38jl5txoR36M7G5qi4A: raises $0.50 to $0.75
dtZ84flFEi4Q+SGrHMJRDQ: folds 
Uncalled bet ($0.50) returned to qwr38jl5txoR36M7G5qi4A
qwr38jl5txoR36M7G5qi4A collected $0.50 from pot
qwr38jl5txoR36M7G5qi4A: doesn't show hand 
*** SUMMARY ***
Total pot $0.50 | Rake $0 
Seat 1: qwr38jl5txoR36M7G5qi4A (small blind) collected ($0.50)
Seat 2: dtZ84flFEi4Q+SGrHMJRDQ (big blind) folded before Flop
Seat 3: sD+TKtt36XiiN6jqHiLwDA folded before Flop (didn't bet)
Seat 4: gehe91e0IyVT0QU/XBkEyg folded before Flop (didn't bet)
Seat 5: GrNTWMdwy+jC6Lred1eDng folded before Flop (didn't bet)
Seat 6: egvg3mTBBVzMHnJPIQiKcA folded before Flop (didn't bet)
Seat 7: eK8qa6EPcH2zhtbmWSvc9g folded before Flop (didn't bet)
Seat 9: P+9ymZQ3ktpQu1bn7HIjew (button) folded before Flop (didn't bet)




PokerStars Game #59941706316:  Hold'em No Limit ($0.10/$0.25) - 2009/07/01 1:43:35 ET
Table 'zhqgUUprOJ14VxKxPHcT/Q' 9-max Seat #1 is the button
Seat 1: 22dIObOuor/A+IKWkNoAlA ($5.50 in chips) 
Seat 2: GY095KWhBevJ1Ttvl8WseA ($7.85 in chips) 
Seat 3: 4XHsdGnQ76EBdBvsrSs8bA ($30.90 in chips) 
Seat 4: wGigCmBR/9XWkPpvYos3aQ ($33.45 in chips) 
Seat 5: +sbyWwIcFp9kP0bDtMegfQ ($33.60 in chips) 
Seat 7: sGFnnRCa1YAHAUmWgsW6Qg ($11 in chips) 
Seat 8: EQXHDnIzAsORnIXRNtXRlA ($24.10 in chips) 
Seat 9: 4awUyiDYTgylQKXZ9faBVA ($26.80 in chips) 
GY095KWhBevJ1Ttvl8WseA: posts small blind $0.10
4XHsdGnQ76EBdBvsrSs8bA: posts big blind $0.25
PdIasPkzm2sqZnN41ZRXOg: sits out 
*** HOLE CARDS ***
wGigCmBR/9XWkPpvYos3aQ: folds 
+sbyWwIcFp9kP0bDtMegfQ: folds 
sGFnnRCa1YAHAUmWgsW6Qg: folds 
EQXHDnIzAsORnIXRNtXRlA: folds 
4awUyiDYTgylQKXZ9faBVA: raises $0.75 to $1
22dIObOuor/A+IKWkNoAlA: folds 
GY095KWhBevJ1Ttvl8WseA: calls $0.90
4XHsdGnQ76EBdBvsrSs8bA: calls $0.75
*** FLOP *** [Qc 5s Tc]
GY095KWhBevJ1Ttvl8WseA: bets $1
4XHsdGnQ76EBdBvsrSs8bA: calls $1
4awUyiDYTgylQKXZ9faBVA: folds 
*** TURN *** [Qc 5s Tc] [Js]
GY095KWhBevJ1Ttvl8WseA: bets $2
4XHsdGnQ76EBdBvsrSs8bA: calls $2
*** RIVER *** [Qc 5s Tc Js] [4d]
GY095KWhBevJ1Ttvl8WseA: bets $2
4XHsdGnQ76EBdBvsrSs8bA: calls $2
*** SHOW DOWN ***
GY095KWhBevJ1Ttvl8WseA: shows [Jc Th] (two pair, Jacks and Tens)
4XHsdGnQ76EBdBvsrSs8bA: mucks hand 
GY095KWhBevJ1Ttvl8WseA collected $12.40 from pot
*** SUMMARY ***
Total pot $13 | Rake $0.60 
Board [Qc 5s Tc Js 4d]
Seat 1: 22dIObOuor/A+IKWkNoAlA (button) folded before Flop (didn't bet)
Seat 2: GY095KWhBevJ1Ttvl8WseA (small blind) showed [Jc Th] and won ($12.40) with two pair, Jacks and Tens
Seat 3: 4XHsdGnQ76EBdBvsrSs8bA (big blind) mucked
Seat 4: wGigCmBR/9XWkPpvYos3aQ folded before Flop (didn't bet)
Seat 5: +sbyWwIcFp9kP0bDtMegfQ folded before Flop (didn't bet)
Seat 7: sGFnnRCa1YAHAUmWgsW6Qg folded before Flop (didn't bet)
Seat 8: EQXHDnIzAsORnIXRNtXRlA folded before Flop (didn't bet)
Seat 9: 4awUyiDYTgylQKXZ9faBVA folded on the Flop




PokerStars Game #59941705890:  Hold'em No Limit ($0.10/$0.25) - 2009/07/01 1:43:35 ET
Table 'KYX9dFNuOA9l2PV46IebqQ' 9-max Seat #4 is the button
Seat 2: z2SmIaQ3+5n/eY1BN5HgPg ($6.25 in chips) 
Seat 3: Uq3NSX4cIFaXe7pbXQuU+Q ($9.20 in chips) 
Seat 4: rPXwQUVloUl+qZm3CCtaJw ($9.30 in chips) 
Seat 5: g7MXhRmNZxv1lIkKkUKa4w ($13.35 in chips) 
Seat 8: KRWTiGM4xH+MkvPtJz4+SA ($25 in chips) 
g7MXhRmNZxv1lIkKkUKa4w: posts small blind $0.10
KRWTiGM4xH+MkvPtJz4+SA: posts big blind $0.25
Uq3NSX4cIFaXe7pbXQuU+Q: posts big blind $0.25
*** HOLE CARDS ***
z2SmIaQ3+5n/eY1BN5HgPg: folds 
6NECk10orj8iqgD3pZ2A0Q joins the table at seat #9 
Uq3NSX4cIFaXe7pbXQuU+Q: checks 
rPXwQUVloUl+qZm3CCtaJw: calls $0.25
g7MXhRmNZxv1lIkKkUKa4w: folds 
KRWTiGM4xH+MkvPtJz4+SA: checks 
*** FLOP *** [Kd 3s 3d]
KRWTiGM4xH+MkvPtJz4+SA: checks 
Uq3NSX4cIFaXe7pbXQuU+Q: checks 
rPXwQUVloUl+qZm3CCtaJw: checks 
*** TURN *** [Kd 3s 3d] [2h]
KRWTiGM4xH+MkvPtJz4+SA: checks 
Uq3NSX4cIFaXe7pbXQuU+Q: checks 
4QYM+pWPc3J+6i8Zv8LvLg joins the table at seat #6 
rPXwQUVloUl+qZm3CCtaJw: checks 
*** RIVER *** [Kd 3s 3d 2h] [7h]
KRWTiGM4xH+MkvPtJz4+SA: checks 
Uq3NSX4cIFaXe7pbXQuU+Q: bets $0.25
qZqVFan2U+GAA/c5LQFbcw joins the table at seat #1 
rPXwQUVloUl+qZm3CCtaJw: folds 
KRWTiGM4xH+MkvPtJz4+SA: folds 
Uncalled bet ($0.25) returned to Uq3NSX4cIFaXe7pbXQuU+Q
Uq3NSX4cIFaXe7pbXQuU+Q collected $0.85 from pot
Uq3NSX4cIFaXe7pbXQuU+Q: doesn't show hand 
*** SUMMARY ***
Total pot $0.85 | Rake $0 
Board [Kd 3s 3d 2h 7h]
Seat 2: z2SmIaQ3+5n/eY1BN5HgPg folded before Flop (didn't bet)
Seat 3: Uq3NSX4cIFaXe7pbXQuU+Q collected ($0.85)
Seat 4: rPXwQUVloUl+qZm3CCtaJw (button) folded on the River
Seat 5: g7MXhRmNZxv1lIkKkUKa4w (small blind) folded before Flop
Seat 8: KRWTiGM4xH+MkvPtJz4+SA (big blind) folded on the River




PokerStars Game #59941705894:  Hold'em No Limit ($0.10/$0.25) - 2009/07/01 1:43:35 ET
Table '0M5QEJGOThqZwQ/sjbjXYw' 6-max Seat #4 is the button
Seat 2: /gJNBeCkWL4o85/jvlZ4BA ($34.60 in chips) 
Seat 3: 3zD3qLXT1bEffAoWGnc7wg ($25 in chips) 
Seat 4: oBUDUfeUyCbZBsjxHZgSiw ($23.35 in chips) 
Seat 5: cWc85bEzdRzpUMhRKm8pwQ ($27.80 in chips) 
cWc85bEzdRzpUMhRKm8pwQ: posts small blind $0.10
/gJNBeCkWL4o85/jvlZ4BA: posts big blind $0.25
*** HOLE CARDS ***
3zD3qLXT1bEffAoWGnc7wg: folds 
oBUDUfeUyCbZBsjxHZgSiw: folds 
cWc85bEzdRzpUMhRKm8pwQ: folds 
Uncalled bet ($0.15) returned to /gJNBeCkWL4o85/jvlZ4BA
/gJNBeCkWL4o85/jvlZ4BA collected $0.20 from pot
*** SUMMARY ***
Total pot $0.20 | Rake $0 
Seat 2: /gJNBeCkWL4o85/jvlZ4BA (big blind) collected ($0.20)
Seat 3: 3zD3qLXT1bEffAoWGnc7wg folded before Flop (didn't bet)
Seat 4: oBUDUfeUyCbZBsjxHZgSiw (button) folded before Flop (didn't bet)
Seat 5: cWc85bEzdRzpUMhRKm8pwQ (small blind) folded before Flop




PokerStars Game #59941706182:  Hold'em No Limit ($0.10/$0.25) - 2009/07/01 1:43:35 ET
Table 'rpIHGyt2QpgQc5bvptAvDQ' 9-max Seat #4 is the button
Seat 2: FX0yWp7Ul3dMebXB0cFjEw ($5.20 in chips) 
Seat 4: ASXDkj9tmvF/T2AsNuxg7g ($5.20 in chips) 
Seat 6: Mq1ESwxx3LEsA4HjKKjU3Q ($19.25 in chips) 
Seat 7: GHgIdzlzMAmRmmX7jgXtuQ ($7.35 in chips) 
XhSvfX1gy0yx/qeW+SOeTw will be allowed to play after the button
Mq1ESwxx3LEsA4HjKKjU3Q: posts small blind $0.10
GHgIdzlzMAmRmmX7jgXtuQ: posts big blind $0.25
oUgIL46CfA9GCdIuN1TVSw: sits out 
b33tl3: sits out 
N6a/f6AW8S8G3JFw9IFxAg is connected 
N6a/f6AW8S8G3JFw9IFxAg: sits out 
*** HOLE CARDS ***
FX0yWp7Ul3dMebXB0cFjEw: folds 
VegasVas joins the table at seat #1 
ASXDkj9tmvF/T2AsNuxg7g: raises $0.75 to $1
Mq1ESwxx3LEsA4HjKKjU3Q: folds 
GHgIdzlzMAmRmmX7jgXtuQ: calls $0.75
*** FLOP *** [Qs 2d 9h]
GHgIdzlzMAmRmmX7jgXtuQ: checks 
ASXDkj9tmvF/T2AsNuxg7g: bets $1
GHgIdzlzMAmRmmX7jgXtuQ: folds 
Uncalled bet ($1) returned to ASXDkj9tmvF/T2AsNuxg7g
ASXDkj9tmvF/T2AsNuxg7g collected $2 from pot
*** SUMMARY ***
Total pot $2.10 | Rake $0.10 
Board [Qs 2d 9h]
Seat 2: FX0yWp7Ul3dMebXB0cFjEw folded before Flop (didn't bet)
Seat 4: ASXDkj9tmvF/T2AsNuxg7g (button) collected ($2)
Seat 6: Mq1ESwxx3LEsA4HjKKjU3Q (small blind) folded before Flop
Seat 7: GHgIdzlzMAmRmmX7jgXtuQ (big blind) folded on the Flop




PokerStars Game #59941706592:  Hold'em No Limit ($0.10/$0.25) - 2009/07/01 1:43:36 ET
Table 'FBhJjLqab11/gKu8nyB/tw' 9-max Seat #5 is the button
Seat 1: +sbyWwIcFp9kP0bDtMegfQ ($18.10 in chips) 
Seat 2: 1pwQJV/Xr0GWPRefx/78VQ ($25.20 in chips) 
Seat 3: V6p0jQ/RhUsqpHLmXvEX4Q ($12.60 in chips) 
Seat 4: CvL9Ch1HYCVbTsfpNucitg ($5.50 in chips) 
Seat 5: Mh2r9hTeTEDnh19sRZtW3g ($4.65 in chips) 
Seat 6: cZ99hugmLBj9KhTlc8nCSw ($25 in chips) 
Seat 7: CT7Xj/V/O5rBlhtt+RZeFQ ($25 in chips) 
Seat 8: Th3FldXKQW6hWVVPahaoOQ ($25 in chips) 
cZ99hugmLBj9KhTlc8nCSw: posts small blind $0.10
CT7Xj/V/O5rBlhtt+RZeFQ: posts big blind $0.25
*** HOLE CARDS ***
Th3FldXKQW6hWVVPahaoOQ: folds 
+sbyWwIcFp9kP0bDtMegfQ: folds 
1pwQJV/Xr0GWPRefx/78VQ: calls $0.25
V6p0jQ/RhUsqpHLmXvEX4Q: raises $1 to $1.25
CvL9Ch1HYCVbTsfpNucitg: folds 
Mh2r9hTeTEDnh19sRZtW3g: folds 
cZ99hugmLBj9KhTlc8nCSw: folds 
CT7Xj/V/O5rBlhtt+RZeFQ: folds 
1pwQJV/Xr0GWPRefx/78VQ: calls $1
*** FLOP *** [Ac Th 9s]
1pwQJV/Xr0GWPRefx/78VQ: checks 
V6p0jQ/RhUsqpHLmXvEX4Q: bets $2
1pwQJV/Xr0GWPRefx/78VQ: calls $2
*** TURN *** [Ac Th 9s] [Jd]
1pwQJV/Xr0GWPRefx/78VQ: checks 
V6p0jQ/RhUsqpHLmXvEX4Q: checks 
*** RIVER *** [Ac Th 9s Jd] [Kh]
1pwQJV/Xr0GWPRefx/78VQ: bets $2
V6p0jQ/RhUsqpHLmXvEX4Q: folds 
Uncalled bet ($2) returned to 1pwQJV/Xr0GWPRefx/78VQ
1pwQJV/Xr0GWPRefx/78VQ collected $6.55 from pot
1pwQJV/Xr0GWPRefx/78VQ: doesn't show hand 
*** SUMMARY ***
Total pot $6.85 | Rake $0.30 
Board [Ac Th 9s Jd Kh]
Seat 1: +sbyWwIcFp9kP0bDtMegfQ folded before Flop (didn't bet)
Seat 2: 1pwQJV/Xr0GWPRefx/78VQ collected ($6.55)
Seat 3: V6p0jQ/RhUsqpHLmXvEX4Q folded on the River
Seat 4: CvL9Ch1HYCVbTsfpNucitg folded before Flop (didn't bet)
Seat 5: Mh2r9hTeTEDnh19sRZtW3g (button) folded before Flop (didn't bet)
Seat 6: cZ99hugmLBj9KhTlc8nCSw (small blind) folded before Flop
Seat 7: CT7Xj/V/O5rBlhtt+RZeFQ (big blind) folded before Flop
Seat 8: Th3FldXKQW6hWVVPahaoOQ folded before Flop (didn't bet)




PokerStars Game #59941706376:  Hold'em No Limit ($0.10/$0.25) - 2009/07/01 1:43:36 ET
Table 'yAHDCs33TIgw3ra63xuU2Q' 9-max Seat #8 is the button
Seat 1: ydoFOVgzvZv9ZhuWu9rXAw ($4.90 in chips) 
Seat 3: g6UPjSyxNLffCi+EqqIlEg ($21 in chips) 
Seat 4: j5spkbnOCRiLGiH6iqBaqw ($8.60 in chips) 
Seat 5: 4awUyiDYTgylQKXZ9faBVA ($37.60 in chips) 
Seat 6: DnDcAdn9P0zGovMERigpFA ($26.30 in chips) 
Seat 7: qxWFg3MZuVyidB0SJh5ywg ($27.75 in chips) 
Seat 8: tYsOBqdU1+x+yFI7zHO7hQ ($25 in chips) 
Seat 9: MtVtHDqIJTyUcXkRBBDIVA ($25 in chips) 
MtVtHDqIJTyUcXkRBBDIVA: posts small blind $0.10
ydoFOVgzvZv9ZhuWu9rXAw: posts big blind $0.25
*** HOLE CARDS ***
g6UPjSyxNLffCi+EqqIlEg: folds 
j5spkbnOCRiLGiH6iqBaqw: folds 
4awUyiDYTgylQKXZ9faBVA: folds 
DnDcAdn9P0zGovMERigpFA: folds 
qxWFg3MZuVyidB0SJh5ywg: folds 
tYsOBqdU1+x+yFI7zHO7hQ: folds 
MtVtHDqIJTyUcXkRBBDIVA: raises $4.75 to $5
ydoFOVgzvZv9ZhuWu9rXAw said, "7 2 suited"
ydoFOVgzvZv9ZhuWu9rXAw: folds 
Uncalled bet ($4.75) returned to MtVtHDqIJTyUcXkRBBDIVA
MtVtHDqIJTyUcXkRBBDIVA collected $0.50 from pot
MtVtHDqIJTyUcXkRBBDIVA: doesn't show hand 
*** SUMMARY ***
Total pot $0.50 | Rake $0 
Seat 1: ydoFOVgzvZv9ZhuWu9rXAw (big blind) folded before Flop
Seat 3: g6UPjSyxNLffCi+EqqIlEg folded before Flop (didn't bet)
Seat 4: j5spkbnOCRiLGiH6iqBaqw folded before Flop (didn't bet)
Seat 5: 4awUyiDYTgylQKXZ9faBVA folded before Flop (didn't bet)
Seat 6: DnDcAdn9P0zGovMERigpFA folded before Flop (didn't bet)
Seat 7: qxWFg3MZuVyidB0SJh5ywg folded before Flop (didn't bet)
Seat 8: tYsOBqdU1+x+yFI7zHO7hQ (button) folded before Flop (didn't bet)
Seat 9: MtVtHDqIJTyUcXkRBBDIVA (small blind) collected ($0.50)




PokerStars Game #59941706702:  Hold'em No Limit ($0.10/$0.25) - 2009/07/01 1:43:36 ET
Table '3eK1r4Q4BSYFvsKkuTLpIA' 9-max Seat #2 is the button
Seat 1: vSkQm2EelzwRGDDQQk0Fqw ($4.30 in chips) 
Seat 2: aNpwfA31EREwO+ar4XzBCw ($27.75 in chips) 
Seat 3: 56S3mA6Zs3pGR+0p0vUCtg ($35.95 in chips) 
Seat 4: +2kMBNpY4nF1qNCRd8SJLA ($25 in chips) 
Seat 5: 775TiRJajPtN/ucpTmHrXA ($14.75 in chips) 
Seat 6: +HvCCmsGSQeatf+GZ9zk8Q ($34.45 in chips) 
Seat 7: ljemhp25Zg+nlA9DLCIiUw ($25 in chips) 
Seat 8: /29aHLC+Q6KCDcNv2bPfAg ($12.80 in chips) 
Seat 9: +sbyWwIcFp9kP0bDtMegfQ ($60.40 in chips) 
56S3mA6Zs3pGR+0p0vUCtg: posts small blind $0.10
+2kMBNpY4nF1qNCRd8SJLA: posts big blind $0.25
*** HOLE CARDS ***
775TiRJajPtN/ucpTmHrXA: folds 
+HvCCmsGSQeatf+GZ9zk8Q: folds 
ljemhp25Zg+nlA9DLCIiUw: folds 
/29aHLC+Q6KCDcNv2bPfAg: folds 
+sbyWwIcFp9kP0bDtMegfQ: folds 
vSkQm2EelzwRGDDQQk0Fqw: folds 
aNpwfA31EREwO+ar4XzBCw: raises $0.75 to $1
56S3mA6Zs3pGR+0p0vUCtg: folds 
+2kMBNpY4nF1qNCRd8SJLA: folds 
Uncalled bet ($0.75) returned to aNpwfA31EREwO+ar4XzBCw
aNpwfA31EREwO+ar4XzBCw collected $0.60 from pot
aNpwfA31EREwO+ar4XzBCw: doesn't show hand 
*** SUMMARY ***
Total pot $0.60 | Rake $0 
Seat 1: vSkQm2EelzwRGDDQQk0Fqw folded before Flop (didn't bet)
Seat 2: aNpwfA31EREwO+ar4XzBCw (button) collected ($0.60)
Seat 3: 56S3mA6Zs3pGR+0p0vUCtg (small blind) folded before Flop
Seat 4: +2kMBNpY4nF1qNCRd8SJLA (big blind) folded before Flop
Seat 5: 775TiRJajPtN/ucpTmHrXA folded before Flop (didn't bet)
Seat 6: +HvCCmsGSQeatf+GZ9zk8Q folded before Flop (didn't bet)
Seat 7: ljemhp25Zg+nlA9DLCIiUw folded before Flop (didn't bet)
Seat 8: /29aHLC+Q6KCDcNv2bPfAg folded before Flop (didn't bet)
Seat 9: +sbyWwIcFp9kP0bDtMegfQ folded before Flop (didn't bet)




PokerStars Game #59941706404:  Hold'em No Limit ($0.10/$0.25) - 2009/07/01 1:43:36 ET
Table 'ThBZ355rqvsb8UGb6ajbig' 9-max Seat #9 is the button
Seat 1: Z9W7+g1WMhhZDi7DwGbCFA ($5 in chips) 
Seat 2: 4awUyiDYTgylQKXZ9faBVA ($25.95 in chips) 
Seat 3: H5Se03ZqSX7tbULXur2MAg ($29.40 in chips) 
Seat 4: zgi+EUykT/pZQpoUG6+oEg ($4.65 in chips) 
Seat 5: cKlmpQMahVsmOaxFQDcoOg ($24.95 in chips) 
Seat 6: qwr38jl5txoR36M7G5qi4A ($9.65 in chips) 
Seat 7: zUXhymECc2C9W9ZNw6qppA ($16.85 in chips) 
Seat 8: PdIasPkzm2sqZnN41ZRXOg ($4.90 in chips) 
Seat 9: sD+TKtt36XiiN6jqHiLwDA ($23.85 in chips) 
Z9W7+g1WMhhZDi7DwGbCFA: posts small blind $0.10
4awUyiDYTgylQKXZ9faBVA: posts big blind $0.25
*** HOLE CARDS ***
H5Se03ZqSX7tbULXur2MAg: folds 
zgi+EUykT/pZQpoUG6+oEg: folds 
cKlmpQMahVsmOaxFQDcoOg: folds 
qwr38jl5txoR36M7G5qi4A: folds 
zUXhymECc2C9W9ZNw6qppA: raises $0.25 to $0.50
PdIasPkzm2sqZnN41ZRXOg: folds 
sD+TKtt36XiiN6jqHiLwDA: folds 
Z9W7+g1WMhhZDi7DwGbCFA: folds 
4awUyiDYTgylQKXZ9faBVA: folds 
Uncalled bet ($0.25) returned to zUXhymECc2C9W9ZNw6qppA
zUXhymECc2C9W9ZNw6qppA collected $0.60 from pot
*** SUMMARY ***
Total pot $0.60 | Rake $0 
Seat 1: Z9W7+g1WMhhZDi7DwGbCFA (small blind) folded before Flop
Seat 2: 4awUyiDYTgylQKXZ9faBVA (big blind) folded before Flop
Seat 3: H5Se03ZqSX7tbULXur2MAg folded before Flop (didn't bet)
Seat 4: zgi+EUykT/pZQpoUG6+oEg folded before Flop (didn't bet)
Seat 5: cKlmpQMahVsmOaxFQDcoOg folded before Flop (didn't bet)
Seat 6: qwr38jl5txoR36M7G5qi4A folded before Flop (didn't bet)
Seat 7: zUXhymECc2C9W9ZNw6qppA collected ($0.60)
Seat 8: PdIasPkzm2sqZnN41ZRXOg folded before Flop (didn't bet)
Seat 9: sD+TKtt36XiiN6jqHiLwDA (button) folded before Flop (didn't bet)




PokerStars Game #59941706720:  Hold'em No Limit ($0.10/$0.25) - 2009/07/01 1:43:36 ET
Table 'mdub7rJf3Z5tCT9s/+1+Wg' 9-max Seat #7 is the button
Seat 1: cZ99hugmLBj9KhTlc8nCSw ($29.25 in chips) 
Seat 2: 539MC3AwKLWVFwzABc644Q ($9.60 in chips) 
Seat 3: PdIasPkzm2sqZnN41ZRXOg ($5.35 in chips) 
Seat 4: fDGyaQz0cs2s4FOYxkbIHA ($14.85 in chips) 
Seat 5: dfNim92Z6XK1/h5SFW5vDg ($26.25 in chips) 
Seat 6: T/CCwAWe2yhO0c4oHNwicw ($23.25 in chips) 
Seat 7: woe+9KKk+L3pZgMTuHcmog ($15.35 in chips) 
Seat 8: Z9AeOQX3yzuSvKAm/xyovg ($6 in chips) 
Seat 9: tYsOBqdU1+x+yFI7zHO7hQ ($36.80 in chips) 
Z9AeOQX3yzuSvKAm/xyovg: posts small blind $0.10
tYsOBqdU1+x+yFI7zHO7hQ: posts big blind $0.25
*** HOLE CARDS ***
cZ99hugmLBj9KhTlc8nCSw: folds 
539MC3AwKLWVFwzABc644Q: folds 
PdIasPkzm2sqZnN41ZRXOg: folds 
fDGyaQz0cs2s4FOYxkbIHA: folds 
dfNim92Z6XK1/h5SFW5vDg: folds 
T/CCwAWe2yhO0c4oHNwicw: folds 
woe+9KKk+L3pZgMTuHcmog: raises $0.75 to $1
Z9AeOQX3yzuSvKAm/xyovg: folds 
tYsOBqdU1+x+yFI7zHO7hQ: folds 
Uncalled bet ($0.75) returned to woe+9KKk+L3pZgMTuHcmog
woe+9KKk+L3pZgMTuHcmog collected $0.60 from pot
*** SUMMARY ***
Total pot $0.60 | Rake $0 
Seat 1: cZ99hugmLBj9KhTlc8nCSw folded before Flop (didn't bet)
Seat 2: 539MC3AwKLWVFwzABc644Q folded before Flop (didn't bet)
Seat 3: PdIasPkzm2sqZnN41ZRXOg folded before Flop (didn't bet)
Seat 4: fDGyaQz0cs2s4FOYxkbIHA folded before Flop (didn't bet)
Seat 5: dfNim92Z6XK1/h5SFW5vDg folded before Flop (didn't bet)
Seat 6: T/CCwAWe2yhO0c4oHNwicw folded before Flop (didn't bet)
Seat 7: woe+9KKk+L3pZgMTuHcmog (button) collected ($0.60)
Seat 8: Z9AeOQX3yzuSvKAm/xyovg (small blind) folded before Flop
Seat 9: tYsOBqdU1+x+yFI7zHO7hQ (big blind) folded before Flop




PokerStars Game #59941706444:  Hold'em No Limit ($0.10/$0.25) - 2009/07/01 1:43:36 ET
Table 'FE/j6VqBY4j9Uq+VHURQCQ' 6-max Seat #4 is the button
Seat 1: ypmjhffk/YHGc51wgVXUTw ($42.95 in chips) 
Seat 2: 3zD3qLXT1bEffAoWGnc7wg ($39.75 in chips) 
Seat 3: lBoEwOFgzcERLIRUkUoRTw ($27.35 in chips) 
Seat 4: 7JyPCA0J2grhXQYxe1h3+A ($22.05 in chips) 
Seat 5: 4x9jCqgSw4272dnaIqnanw ($6.95 in chips) 
Seat 6: rpJ2ie+vculq8yrHlngRHQ ($18.30 in chips) 
4x9jCqgSw4272dnaIqnanw: posts small blind $0.10
rpJ2ie+vculq8yrHlngRHQ: posts big blind $0.25
*** HOLE CARDS ***
ypmjhffk/YHGc51wgVXUTw: folds 
3zD3qLXT1bEffAoWGnc7wg: raises $0.50 to $0.75
lBoEwOFgzcERLIRUkUoRTw: folds 
7JyPCA0J2grhXQYxe1h3+A: folds 
4x9jCqgSw4272dnaIqnanw: folds 
rpJ2ie+vculq8yrHlngRHQ: folds 
Uncalled bet ($0.50) returned to 3zD3qLXT1bEffAoWGnc7wg
3zD3qLXT1bEffAoWGnc7wg collected $0.60 from pot
3zD3qLXT1bEffAoWGnc7wg: doesn't show hand 
*** SUMMARY ***
Total pot $0.60 | Rake $0 
Seat 1: ypmjhffk/YHGc51wgVXUTw folded before Flop (didn't bet)
Seat 2: 3zD3qLXT1bEffAoWGnc7wg collected ($0.60)
Seat 3: lBoEwOFgzcERLIRUkUoRTw folded before Flop (didn't bet)
Seat 4: 7JyPCA0J2grhXQYxe1h3+A (button) folded before Flop (didn't bet)
Seat 5: 4x9jCqgSw4272dnaIqnanw (small blind) folded before Flop
Seat 6: rpJ2ie+vculq8yrHlngRHQ (big blind) folded before Flop




PokerStars Game #59941707386:  Hold'em No Limit ($0.10/$0.25) - 2009/07/01 1:43:37 ET
Table 'nc6OeGk/wtaWV+6N+kgnZQ' 6-max Seat #2 is the button
Seat 1: tSR4329m40dZsN7YOpI9Kw ($40.25 in chips) 
Seat 2: 8ClCHtFXGNplITm+63KB+Q ($34.75 in chips) 
Seat 3: y8wpMWGSX2zHZijurx21mg ($5.10 in chips) 
Seat 4: 3zD3qLXT1bEffAoWGnc7wg ($29.95 in chips) 
Seat 5: HCS0lMAAPmZE2Tl8J/SuKw ($11.45 in chips) 
Seat 6: mFv3iBCtrw9XfCDRB0d46Q ($3.55 in chips) 
y8wpMWGSX2zHZijurx21mg: posts small blind $0.10
3zD3qLXT1bEffAoWGnc7wg: posts big blind $0.25
*** HOLE CARDS ***
HCS0lMAAPmZE2Tl8J/SuKw: calls $0.25
mFv3iBCtrw9XfCDRB0d46Q: folds 
tSR4329m40dZsN7YOpI9Kw: folds 
8ClCHtFXGNplITm+63KB+Q: folds 
y8wpMWGSX2zHZijurx21mg: calls $0.15
3zD3qLXT1bEffAoWGnc7wg: checks 
*** FLOP *** [3c 8d 6d]
y8wpMWGSX2zHZijurx21mg: checks 
3zD3qLXT1bEffAoWGnc7wg: checks 
HCS0lMAAPmZE2Tl8J/SuKw: checks 
*** TURN *** [3c 8d 6d] [Qh]
y8wpMWGSX2zHZijurx21mg: checks 
3zD3qLXT1bEffAoWGnc7wg: checks 
HCS0lMAAPmZE2Tl8J/SuKw: checks 
*** RIVER *** [3c 8d 6d Qh] [9c]
y8wpMWGSX2zHZijurx21mg: checks 
3zD3qLXT1bEffAoWGnc7wg: checks 
HCS0lMAAPmZE2Tl8J/SuKw: checks 
*** SHOW DOWN ***
y8wpMWGSX2zHZijurx21mg: shows [Kc 6h] (a pair of Sixes)
3zD3qLXT1bEffAoWGnc7wg: mucks hand 
HCS0lMAAPmZE2Tl8J/SuKw: mucks hand 
y8wpMWGSX2zHZijurx21mg collected $0.75 from pot
*** SUMMARY ***
Total pot $0.75 | Rake $0 
Board [3c 8d 6d Qh 9c]
Seat 1: tSR4329m40dZsN7YOpI9Kw folded before Flop (didn't bet)
Seat 2: 8ClCHtFXGNplITm+63KB+Q (button) folded before Flop (didn't bet)
Seat 3: y8wpMWGSX2zHZijurx21mg (small blind) showed [Kc 6h] and won ($0.75) with a pair of Sixes
Seat 4: 3zD3qLXT1bEffAoWGnc7wg (big blind) mucked
Seat 5: HCS0lMAAPmZE2Tl8J/SuKw mucked
Seat 6: mFv3iBCtrw9XfCDRB0d46Q folded before Flop (didn't bet)




PokerStars Game #59941707390:  Hold'em No Limit ($0.10/$0.25) - 2009/07/01 1:43:37 ET
Table '5SUMWYuPsGiOD0FY0QbgOw' 6-max Seat #6 is the button
Seat 1: SFmT9ZsVopnukjvAzrxTRg ($25 in chips) 
Seat 2: xrf8tAXKQHG99HixCot1Iw ($36.90 in chips) 
Seat 3: MqMK8OWPSY1V4stf1Hy5Jw ($38.80 in chips) 
Seat 4: BV+K0Phf5VBHr7aZPKqbUQ ($25 in chips) 
Seat 5: v+QfkGiuj9bgtuNoVnDO8w ($40.40 in chips) 
Seat 6: jA7YMtfNUnAaebB7Lj74EA ($26.45 in chips) 
SFmT9ZsVopnukjvAzrxTRg: posts small blind $0.10
xrf8tAXKQHG99HixCot1Iw: posts big blind $0.25
*** HOLE CARDS ***
MqMK8OWPSY1V4stf1Hy5Jw: folds 
BV+K0Phf5VBHr7aZPKqbUQ: folds 
v+QfkGiuj9bgtuNoVnDO8w: folds 
jA7YMtfNUnAaebB7Lj74EA: calls $0.25
SFmT9ZsVopnukjvAzrxTRg: folds 
xrf8tAXKQHG99HixCot1Iw: checks 
*** FLOP *** [Ac 3d 6c]
xrf8tAXKQHG99HixCot1Iw: bets $0.50
jA7YMtfNUnAaebB7Lj74EA: folds 
Uncalled bet ($0.50) returned to xrf8tAXKQHG99HixCot1Iw
xrf8tAXKQHG99HixCot1Iw collected $0.60 from pot
xrf8tAXKQHG99HixCot1Iw: doesn't show hand 
*** SUMMARY ***
Total pot $0.60 | Rake $0 
Board [Ac 3d 6c]
Seat 1: SFmT9ZsVopnukjvAzrxTRg (small blind) folded before Flop
Seat 2: xrf8tAXKQHG99HixCot1Iw (big blind) collected ($0.60)
Seat 3: MqMK8OWPSY1V4stf1Hy5Jw folded before Flop (didn't bet)
Seat 4: BV+K0Phf5VBHr7aZPKqbUQ folded before Flop (didn't bet)
Seat 5: v+QfkGiuj9bgtuNoVnDO8w folded before Flop (didn't bet)
Seat 6: jA7YMtfNUnAaebB7Lj74EA (button) folded on the Flop




PokerStars Game #59941707088:  Hold'em No Limit ($0.10/$0.25) - 2009/07/01 1:43:37 ET
Table 'mVdLgAdN9rGe6mMwSrDdGQ' 6-max Seat #2 is the button
Seat 1: OyJ0KTHA5cwh0/yCo1/rdA ($12 in chips) 
Seat 2: n9QqWD4tpbongUBX2Oi58w ($4.80 in chips) 
Seat 3: +baiVgI/ETnBARLe5mARCw ($14.20 in chips) 
Seat 4: scNSjC6yyKvvfklSkuzLrw ($17.20 in chips) 
Seat 5: +TMG/MBWpiEnc9t7i07eTA ($27.50 in chips) 
Seat 6: DihMHaz4WNETH1bPDe13kA ($47.80 in chips) 
+baiVgI/ETnBARLe5mARCw: posts small blind $0.10
scNSjC6yyKvvfklSkuzLrw: posts big blind $0.25
OyJ0KTHA5cwh0/yCo1/rdA: posts small & big blinds $0.35
*** HOLE CARDS ***
+TMG/MBWpiEnc9t7i07eTA: folds 
DihMHaz4WNETH1bPDe13kA: folds 
OyJ0KTHA5cwh0/yCo1/rdA: checks 
n9QqWD4tpbongUBX2Oi58w: folds 
+baiVgI/ETnBARLe5mARCw: calls $0.15
scNSjC6yyKvvfklSkuzLrw: checks 
*** FLOP *** [4s 6d 7s]
+baiVgI/ETnBARLe5mARCw: checks 
scNSjC6yyKvvfklSkuzLrw: bets $0.75
OyJ0KTHA5cwh0/yCo1/rdA: raises $1.25 to $2
+baiVgI/ETnBARLe5mARCw: folds 
scNSjC6yyKvvfklSkuzLrw: calls $1.25
*** TURN *** [4s 6d 7s] [Ad]
scNSjC6yyKvvfklSkuzLrw: bets $2.25
OyJ0KTHA5cwh0/yCo1/rdA: calls $2.25
*** RIVER *** [4s 6d 7s Ad] [3h]
scNSjC6yyKvvfklSkuzLrw: bets $3
OyJ0KTHA5cwh0/yCo1/rdA: calls $3
*** SHOW DOWN ***
scNSjC6yyKvvfklSkuzLrw: shows [8d 4d] (a pair of Fours)
OyJ0KTHA5cwh0/yCo1/rdA: shows [7c 9s] (a pair of Sevens)
OyJ0KTHA5cwh0/yCo1/rdA collected $14.65 from pot
*** SUMMARY ***
Total pot $15.35 | Rake $0.70 
Board [4s 6d 7s Ad 3h]
Seat 1: OyJ0KTHA5cwh0/yCo1/rdA showed [7c 9s] and won ($14.65) with a pair of Sevens
Seat 2: n9QqWD4tpbongUBX2Oi58w (button) folded before Flop (didn't bet)
Seat 3: +baiVgI/ETnBARLe5mARCw (small blind) folded on the Flop
Seat 4: scNSjC6yyKvvfklSkuzLrw (big blind) showed [8d 4d] and lost with a pair of Fours
Seat 5: +TMG/MBWpiEnc9t7i07eTA folded before Flop (didn't bet)
Seat 6: DihMHaz4WNETH1bPDe13kA folded before Flop (didn't bet)




PokerStars Game #59941707070:  Hold'em No Limit ($0.10/$0.25) - 2009/07/01 1:43:37 ET
Table 'C47I7CmrmFr8Oo7wOovVwQ' 6-max Seat #5 is the button
Seat 1: v6mkGzCBCCXcgWQNSYVtKg ($6.75 in chips) 
Seat 2: hOaWAImn5/MZDAWAPlYHCw ($5.15 in chips) 
Seat 3: H+8eOP3XJHXjACRDTiIHTQ ($17.15 in chips) 
Seat 4: yY5JuFtDfXWRaZlVby4LLw ($8.90 in chips) 
Seat 5: or309yYY9Y9bfFWtrB0yUg ($12.40 in chips) 
Seat 6: pD7ri5wL3vsa6S1ulMYQmQ ($24.75 in chips) 
pD7ri5wL3vsa6S1ulMYQmQ: posts small blind $0.10
v6mkGzCBCCXcgWQNSYVtKg: posts big blind $0.25
*** HOLE CARDS ***
hOaWAImn5/MZDAWAPlYHCw: folds 
H+8eOP3XJHXjACRDTiIHTQ: calls $0.25
yY5JuFtDfXWRaZlVby4LLw: folds 
or309yYY9Y9bfFWtrB0yUg: calls $0.25
pD7ri5wL3vsa6S1ulMYQmQ: calls $0.15
v6mkGzCBCCXcgWQNSYVtKg: checks 
*** FLOP *** [Td 2s 9s]
pD7ri5wL3vsa6S1ulMYQmQ: checks 
v6mkGzCBCCXcgWQNSYVtKg: checks 
H+8eOP3XJHXjACRDTiIHTQ: checks 
or309yYY9Y9bfFWtrB0yUg: checks 
*** TURN *** [Td 2s 9s] [6s]
pD7ri5wL3vsa6S1ulMYQmQ: checks 
v6mkGzCBCCXcgWQNSYVtKg: checks 
H+8eOP3XJHXjACRDTiIHTQ: checks 
or309yYY9Y9bfFWtrB0yUg: checks 
*** RIVER *** [Td 2s 9s 6s] [Qh]
pD7ri5wL3vsa6S1ulMYQmQ: checks 
v6mkGzCBCCXcgWQNSYVtKg: checks 
H+8eOP3XJHXjACRDTiIHTQ: checks 
or309yYY9Y9bfFWtrB0yUg: checks 
*** SHOW DOWN ***
pD7ri5wL3vsa6S1ulMYQmQ: shows [Jc 5h] (high card Queen)
v6mkGzCBCCXcgWQNSYVtKg: shows [Ks 7c] (high card King)
H+8eOP3XJHXjACRDTiIHTQ: shows [5c As] (high card Ace)
or309yYY9Y9bfFWtrB0yUg: shows [4c 4d] (a pair of Fours)
or309yYY9Y9bfFWtrB0yUg collected $0.95 from pot
*** SUMMARY ***
Total pot $1 | Rake $0.05 
Board [Td 2s 9s 6s Qh]
Seat 1: v6mkGzCBCCXcgWQNSYVtKg (big blind) showed [Ks 7c] and lost with high card King
Seat 2: hOaWAImn5/MZDAWAPlYHCw folded before Flop (didn't bet)
Seat 3: H+8eOP3XJHXjACRDTiIHTQ showed [5c As] and lost with high card Ace
Seat 4: yY5JuFtDfXWRaZlVby4LLw folded before Flop (didn't bet)
Seat 5: or309yYY9Y9bfFWtrB0yUg (button) showed [4c 4d] and won ($0.95) with a pair of Fours
Seat 6: pD7ri5wL3vsa6S1ulMYQmQ (small blind) showed [Jc 5h] and lost with high card Queen




PokerStars Game #59941707142:  Hold'em No Limit ($0.10/$0.25) - 2009/07/01 1:43:37 ET
Table '+giHa6FUL6U5/AZnCJEGvQ' 9-max Seat #6 is the button
Seat 4: 10f7J+bM02ZfDHx0PgkNSg ($14 in chips) 
Seat 6: GTMnTen6sQSoCpS9sggLbg ($25.70 in chips) 
GTMnTen6sQSoCpS9sggLbg: posts small blind $0.10
10f7J+bM02ZfDHx0PgkNSg: posts big blind $0.25
*** HOLE CARDS ***
GTMnTen6sQSoCpS9sggLbg: raises $0.50 to $0.75
10f7J+bM02ZfDHx0PgkNSg: folds 
Uncalled bet ($0.50) returned to GTMnTen6sQSoCpS9sggLbg
GTMnTen6sQSoCpS9sggLbg collected $0.50 from pot
GTMnTen6sQSoCpS9sggLbg: doesn't show hand 
*** SUMMARY ***
Total pot $0.50 | Rake $0 
Seat 4: 10f7J+bM02ZfDHx0PgkNSg (big blind) folded before Flop
Seat 6: GTMnTen6sQSoCpS9sggLbg (button) (small blind) collected ($0.50)




PokerStars Game #59941707004:  Hold'em No Limit ($0.10/$0.25) - 2009/07/01 1:43:37 ET
Table 'ykyWGjhNu7AvZXov27T4ew' 9-max Seat #3 is the button
Seat 2: MG90wfSJZnOejs/KD3vlQQ ($39.60 in chips) 
Seat 3: NPI9ArW8kwrb6a2IAL6xMQ ($26.65 in chips) 
Seat 4: W6tExOcYX7qiy6Qdp+ZwFA ($5.30 in chips) 
Seat 5: CmngQmkKTp8tkl6GMRTl6w ($8.50 in chips) 
Seat 6: AiXn/9o1EwOPZUHujnh/bA ($20.15 in chips) 
Seat 7: npAYqa85pqnzfOK5ukX+BQ ($21.65 in chips) 
Seat 8: tYsOBqdU1+x+yFI7zHO7hQ ($49.35 in chips) 
Seat 9: wk9M6R3w+aDHpr8WV87RmQ ($11.25 in chips) 
W6tExOcYX7qiy6Qdp+ZwFA: posts small blind $0.10
CmngQmkKTp8tkl6GMRTl6w: posts big blind $0.25
Team Rsf: sits out 
*** HOLE CARDS ***
AiXn/9o1EwOPZUHujnh/bA: folds 
npAYqa85pqnzfOK5ukX+BQ: folds 
tYsOBqdU1+x+yFI7zHO7hQ: folds 
wk9M6R3w+aDHpr8WV87RmQ: folds 
MG90wfSJZnOejs/KD3vlQQ: folds 
NPI9ArW8kwrb6a2IAL6xMQ: folds 
NPI9ArW8kwrb6a2IAL6xMQ is sitting out
W6tExOcYX7qiy6Qdp+ZwFA: raises $0.50 to $0.75
CmngQmkKTp8tkl6GMRTl6w: folds 
Uncalled bet ($0.50) returned to W6tExOcYX7qiy6Qdp+ZwFA
W6tExOcYX7qiy6Qdp+ZwFA collected $0.50 from pot
W6tExOcYX7qiy6Qdp+ZwFA: doesn't show hand 
*** SUMMARY ***
Total pot $0.50 | Rake $0 
Seat 2: MG90wfSJZnOejs/KD3vlQQ folded before Flop (didn't bet)
Seat 3: NPI9ArW8kwrb6a2IAL6xMQ (button) folded before Flop (didn't bet)
Seat 4: W6tExOcYX7qiy6Qdp+ZwFA (small blind) collected ($0.50)
Seat 5: CmngQmkKTp8tkl6GMRTl6w (big blind) folded before Flop
Seat 6: AiXn/9o1EwOPZUHujnh/bA folded before Flop (didn't bet)
Seat 7: npAYqa85pqnzfOK5ukX+BQ folded before Flop (didn't bet)
Seat 8: tYsOBqdU1+x+yFI7zHO7hQ folded before Flop (didn't bet)
Seat 9: wk9M6R3w+aDHpr8WV87RmQ folded before Flop (didn't bet)




PokerStars Game #59941707724:  Hold'em No Limit ($0.10/$0.25) - 2009/07/01 1:43:38 ET
Table 'jItkp2PNTbH9Cf7gqsAF7g' 9-max Seat #2 is the button
Seat 1: wGigCmBR/9XWkPpvYos3aQ ($25.70 in chips) 
Seat 2: qwr38jl5txoR36M7G5qi4A ($7.95 in chips) 
Seat 3: 0YaJElQVLqWThIZnqq3w1g ($15.50 in chips) 
Seat 4: oJOvZw/Iayou0f0k6dkBhg ($5 in chips) 
Seat 5: NO6qGDOw12lhu3zh1xW3Bg ($19.55 in chips) 
Seat 6: cZ99hugmLBj9KhTlc8nCSw ($53 in chips) 
Seat 8: cq6LACCDFivk2+PeoiB2sw ($6.65 in chips) 
Seat 9: dtZ84flFEi4Q+SGrHMJRDQ ($25.40 in chips) 
0YaJElQVLqWThIZnqq3w1g: posts small blind $0.10
oJOvZw/Iayou0f0k6dkBhg: posts big blind $0.25
*** HOLE CARDS ***
NO6qGDOw12lhu3zh1xW3Bg: folds 
cZ99hugmLBj9KhTlc8nCSw: folds 
cq6LACCDFivk2+PeoiB2sw: folds 
dtZ84flFEi4Q+SGrHMJRDQ: calls $0.25
wGigCmBR/9XWkPpvYos3aQ: folds 
qwr38jl5txoR36M7G5qi4A: folds 
0YaJElQVLqWThIZnqq3w1g: calls $0.15
oJOvZw/Iayou0f0k6dkBhg: checks 
*** FLOP *** [3h Jh 8d]
0YaJElQVLqWThIZnqq3w1g: checks 
oJOvZw/Iayou0f0k6dkBhg: checks 
dtZ84flFEi4Q+SGrHMJRDQ: checks 
*** TURN *** [3h Jh 8d] [6s]
0YaJElQVLqWThIZnqq3w1g: checks 
oJOvZw/Iayou0f0k6dkBhg: bets $0.25
dtZ84flFEi4Q+SGrHMJRDQ: folds 
0YaJElQVLqWThIZnqq3w1g: calls $0.25
*** RIVER *** [3h Jh 8d 6s] [6d]
0YaJElQVLqWThIZnqq3w1g: checks 
oJOvZw/Iayou0f0k6dkBhg: bets $0.75
0YaJElQVLqWThIZnqq3w1g: folds 
Uncalled bet ($0.75) returned to oJOvZw/Iayou0f0k6dkBhg
oJOvZw/Iayou0f0k6dkBhg collected $1.20 from pot
*** SUMMARY ***
Total pot $1.25 | Rake $0.05 
Board [3h Jh 8d 6s 6d]
Seat 1: wGigCmBR/9XWkPpvYos3aQ folded before Flop (didn't bet)
Seat 2: qwr38jl5txoR36M7G5qi4A (button) folded before Flop (didn't bet)
Seat 3: 0YaJElQVLqWThIZnqq3w1g (small blind) folded on the River
Seat 4: oJOvZw/Iayou0f0k6dkBhg (big blind) collected ($1.20)
Seat 5: NO6qGDOw12lhu3zh1xW3Bg folded before Flop (didn't bet)
Seat 6: cZ99hugmLBj9KhTlc8nCSw folded before Flop (didn't bet)
Seat 8: cq6LACCDFivk2+PeoiB2sw folded before Flop (didn't bet)
Seat 9: dtZ84flFEi4Q+SGrHMJRDQ folded on the Turn




PokerStars Game #59941707664:  Hold'em No Limit ($0.10/$0.25) - 2009/07/01 1:43:38 ET
Table 'Jj2eLzVCUVAGBmM+Og79iQ' 9-max Seat #2 is the button
Seat 2: oMxwMC7+uAsJudeUN6aP0A ($14.55 in chips) 
Seat 3: HPEB+AtKw1+C/cxU0o1ciw ($24.75 in chips) 
Seat 4: aNpwfA31EREwO+ar4XzBCw ($45.25 in chips) 
Seat 5: UOx+/JnFB2Or6ZU9oasIlQ ($22.35 in chips) 
Seat 6: jZURAM/dgGCX+5lATlZugw ($14.55 in chips) 
Seat 7: K0b5wNInj6hUGRr6yzKFtw ($59.50 in chips) 
Seat 8: H5Se03ZqSX7tbULXur2MAg ($20.60 in chips) 
Seat 9: wU1LtrccnZo6PYKhlJ6ElQ ($25 in chips) 
HPEB+AtKw1+C/cxU0o1ciw: posts small blind $0.10
aNpwfA31EREwO+ar4XzBCw: posts big blind $0.25
*** HOLE CARDS ***
UOx+/JnFB2Or6ZU9oasIlQ: folds 
jZURAM/dgGCX+5lATlZugw: folds 
UOx+/JnFB2Or6ZU9oasIlQ leaves the table
K0b5wNInj6hUGRr6yzKFtw: folds 
H5Se03ZqSX7tbULXur2MAg: folds 
wU1LtrccnZo6PYKhlJ6ElQ: raises $0.50 to $0.75
oMxwMC7+uAsJudeUN6aP0A: calls $0.75
branloo leaves the table
HPEB+AtKw1+C/cxU0o1ciw: folds 
UkF1eqqUN0CCiimXAuN7og joins the table at seat #5 
aNpwfA31EREwO+ar4XzBCw: folds 
*** FLOP *** [Kc 4s 4c]
wU1LtrccnZo6PYKhlJ6ElQ: checks 
ShXPHWfjhfmAwLgDdm6bRQ joins the table at seat #1 
oMxwMC7+uAsJudeUN6aP0A: bets $1
wU1LtrccnZo6PYKhlJ6ElQ: folds 
Uncalled bet ($1) returned to oMxwMC7+uAsJudeUN6aP0A
oMxwMC7+uAsJudeUN6aP0A collected $1.80 from pot
oMxwMC7+uAsJudeUN6aP0A: doesn't show hand 
*** SUMMARY ***
Total pot $1.85 | Rake $0.05 
Board [Kc 4s 4c]
Seat 2: oMxwMC7+uAsJudeUN6aP0A (button) collected ($1.80)
Seat 3: HPEB+AtKw1+C/cxU0o1ciw (small blind) folded before Flop
Seat 4: aNpwfA31EREwO+ar4XzBCw (big blind) folded before Flop
Seat 5: UOx+/JnFB2Or6ZU9oasIlQ folded before Flop (didn't bet)
Seat 6: jZURAM/dgGCX+5lATlZugw folded before Flop (didn't bet)
Seat 7: K0b5wNInj6hUGRr6yzKFtw folded before Flop (didn't bet)
Seat 8: H5Se03ZqSX7tbULXur2MAg folded before Flop (didn't bet)
Seat 9: wU1LtrccnZo6PYKhlJ6ElQ folded on the Flop




PokerStars Game #59941707960:  Hold'em No Limit ($0.10/$0.25) - 2009/07/01 1:43:38 ET
Table '60nA7av6bws9VnNmVwculA' 6-max Seat #2 is the button
Seat 1: if4dh6jhJXeN3/qd3qCp9g ($24.65 in chips) 
Seat 2: Bada343Si4xKu3fNXY99AA ($3.50 in chips) 
Seat 4: +baiVgI/ETnBARLe5mARCw ($18.60 in chips) 
Seat 5: zXh+lOT41Q2iWgCNj+OcRw ($12.70 in chips) 
Seat 6: mfrkWA3PTeYPkbO6hi98Aw ($25.10 in chips) 
mnuJq+Q1IXKm/pCy+OzxmQ will be allowed to play after the button
+baiVgI/ETnBARLe5mARCw: posts small blind $0.10
zXh+lOT41Q2iWgCNj+OcRw: posts big blind $0.25
*** HOLE CARDS ***
mfrkWA3PTeYPkbO6hi98Aw: folds 
if4dh6jhJXeN3/qd3qCp9g: folds 
Bada343Si4xKu3fNXY99AA: raises $0.50 to $0.75
+baiVgI/ETnBARLe5mARCw: folds 
zXh+lOT41Q2iWgCNj+OcRw: folds 
Uncalled bet ($0.50) returned to Bada343Si4xKu3fNXY99AA
Bada343Si4xKu3fNXY99AA collected $0.60 from pot
Bada343Si4xKu3fNXY99AA: doesn't show hand 
*** SUMMARY ***
Total pot $0.60 | Rake $0 
Seat 1: if4dh6jhJXeN3/qd3qCp9g folded before Flop (didn't bet)
Seat 2: Bada343Si4xKu3fNXY99AA (button) collected ($0.60)
Seat 4: +baiVgI/ETnBARLe5mARCw (small blind) folded before Flop
Seat 5: zXh+lOT41Q2iWgCNj+OcRw (big blind) folded before Flop
Seat 6: mfrkWA3PTeYPkbO6hi98Aw folded before Flop (didn't bet)




PokerStars Game #59941707944:  Hold'em No Limit ($0.10/$0.25) - 2009/07/01 1:43:38 ET
Table 'fIMYcWwN4/aXFJvH5Z8Ymg' 6-max Seat #1 is the button
Seat 1: DihMHaz4WNETH1bPDe13kA ($25 in chips) 
Seat 3: 9bpVv1/Qh9IYtXuCtl5VtQ ($25.10 in chips) 
Seat 4: 32YL2ZEp8NT4JB2RVM9euQ ($42.75 in chips) 
Seat 5: lquriepNQBhDV5P1SWHhnA ($25.35 in chips) 
Seat 6: jp34e617tIzV8tKIWmfAbA ($28 in chips) 
StevenWu will be allowed to play after the button
9bpVv1/Qh9IYtXuCtl5VtQ: posts small blind $0.10
32YL2ZEp8NT4JB2RVM9euQ: posts big blind $0.25
*** HOLE CARDS ***
lquriepNQBhDV5P1SWHhnA: folds 
jp34e617tIzV8tKIWmfAbA: raises $0.50 to $0.75
DihMHaz4WNETH1bPDe13kA: folds 
9bpVv1/Qh9IYtXuCtl5VtQ: folds 
32YL2ZEp8NT4JB2RVM9euQ: folds 
Uncalled bet ($0.50) returned to jp34e617tIzV8tKIWmfAbA
jp34e617tIzV8tKIWmfAbA collected $0.60 from pot
*** SUMMARY ***
Total pot $0.60 | Rake $0 
Seat 1: DihMHaz4WNETH1bPDe13kA (button) folded before Flop (didn't bet)
Seat 3: 9bpVv1/Qh9IYtXuCtl5VtQ (small blind) folded before Flop
Seat 4: 32YL2ZEp8NT4JB2RVM9euQ (big blind) folded before Flop
Seat 5: lquriepNQBhDV5P1SWHhnA folded before Flop (didn't bet)
Seat 6: jp34e617tIzV8tKIWmfAbA collected ($0.60)




PokerStars Game #59941707486:  Hold'em No Limit ($0.10/$0.25) - 2009/07/01 1:43:38 ET
Table 'nXVbUw6/HYwA6x21+IZ3XQ' 9-max Seat #8 is the button
Seat 2: 9lvO/qyU+xrU95Teu1fv0g ($5.25 in chips) 
Seat 3: 7je+LC5Mfs6nL8YBVh4frQ ($6.40 in chips) 
Seat 6: ljemhp25Zg+nlA9DLCIiUw ($27.20 in chips) 
Seat 7: ShCS62CJp4MKfKLKvGKQbA ($12.40 in chips) 
Seat 8: dfNim92Z6XK1/h5SFW5vDg ($26.80 in chips) 
Seat 9: OTCjTlu92MEBtX/i9Gm7yA ($12.30 in chips) 
OTCjTlu92MEBtX/i9Gm7yA: posts small blind $0.10
9lvO/qyU+xrU95Teu1fv0g: posts big blind $0.25
SpiiQQAzy4MUgV3I5W8giw: sits out 
*** HOLE CARDS ***
7je+LC5Mfs6nL8YBVh4frQ: folds 
ljemhp25Zg+nlA9DLCIiUw: folds 
7je+LC5Mfs6nL8YBVh4frQ leaves the table
ShCS62CJp4MKfKLKvGKQbA: calls $0.25
M/9j4wkHH9i1JM51vgi1VA has returned
dfNim92Z6XK1/h5SFW5vDg: raises $1 to $1.25
OTCjTlu92MEBtX/i9Gm7yA: folds 
9lvO/qyU+xrU95Teu1fv0g: calls $1
ShCS62CJp4MKfKLKvGKQbA: folds 
*** FLOP *** [3c Jh 7d]
9lvO/qyU+xrU95Teu1fv0g: checks 
dfNim92Z6XK1/h5SFW5vDg: bets $1.75
9lvO/qyU+xrU95Teu1fv0g: calls $1.75
*** TURN *** [3c Jh 7d] [Kd]
davidandrew7 joins the table at seat #3 
9lvO/qyU+xrU95Teu1fv0g: checks 
dfNim92Z6XK1/h5SFW5vDg: checks 
*** RIVER *** [3c Jh 7d Kd] [Qc]
9lvO/qyU+xrU95Teu1fv0g: bets $2.25 and is all-in
dfNim92Z6XK1/h5SFW5vDg: calls $2.25
*** SHOW DOWN ***
9lvO/qyU+xrU95Teu1fv0g: shows [Jd Js] (three of a kind, Jacks)
dfNim92Z6XK1/h5SFW5vDg: mucks hand 
9lvO/qyU+xrU95Teu1fv0g collected $10.35 from pot
*** SUMMARY ***
Total pot $10.85 | Rake $0.50 
Board [3c Jh 7d Kd Qc]
Seat 2: 9lvO/qyU+xrU95Teu1fv0g (big blind) showed [Jd Js] and won ($10.35) with three of a kind, Jacks
Seat 3: 7je+LC5Mfs6nL8YBVh4frQ folded before Flop (didn't bet)
Seat 6: ljemhp25Zg+nlA9DLCIiUw folded before Flop (didn't bet)
Seat 7: ShCS62CJp4MKfKLKvGKQbA folded before Flop
Seat 8: dfNim92Z6XK1/h5SFW5vDg (button) mucked
Seat 9: OTCjTlu92MEBtX/i9Gm7yA (small blind) folded before Flop




PokerStars Game #59941707748:  Hold'em No Limit ($0.10/$0.25) - 2009/07/01 1:43:38 ET
Table 'tANpk8z1C5o0Pq/hpYShHw' 9-max Seat #1 is the button
Seat 1: rQhYIYXSyH/IivYM1dlV5A ($16.90 in chips) 
Seat 2: og4yH4sZUZdC8jjgW8zPJQ ($8.85 in chips) 
Seat 4: j4q3p0lesp63b1gZDwLBZw ($5 in chips) 
Seat 6: kN0AWJG6biW8tHtuF+wTjA ($14.50 in chips) 
Seat 7: aNpwfA31EREwO+ar4XzBCw ($27.30 in chips) 
Seat 9: gE5rN2TDY1aXcZn/TOPeZw ($7.45 in chips) 
og4yH4sZUZdC8jjgW8zPJQ: posts small blind $0.10
j4q3p0lesp63b1gZDwLBZw: posts big blind $0.25
X6+pSIPfovPcE87t+LmUKQ: sits out 
Z9W7+g1WMhhZDi7DwGbCFA: sits out 
*** HOLE CARDS ***
rQhYIYXSyH/IivYM1dlV5A said, "nh"
kN0AWJG6biW8tHtuF+wTjA: folds 
aNpwfA31EREwO+ar4XzBCw: folds 
gE5rN2TDY1aXcZn/TOPeZw: calls $0.25
og4yH4sZUZdC8jjgW8zPJQ said, "ty"
rQhYIYXSyH/IivYM1dlV5A: folds 
og4yH4sZUZdC8jjgW8zPJQ: calls $0.15
j4q3p0lesp63b1gZDwLBZw: checks 
*** FLOP *** [Ks Kc Ts]
og4yH4sZUZdC8jjgW8zPJQ: checks 
j4q3p0lesp63b1gZDwLBZw: checks 
gE5rN2TDY1aXcZn/TOPeZw: bets $0.50
og4yH4sZUZdC8jjgW8zPJQ: folds 
j4q3p0lesp63b1gZDwLBZw: folds 
Uncalled bet ($0.50) returned to gE5rN2TDY1aXcZn/TOPeZw
gE5rN2TDY1aXcZn/TOPeZw collected $0.75 from pot
gE5rN2TDY1aXcZn/TOPeZw: doesn't show hand 
*** SUMMARY ***
Total pot $0.75 | Rake $0 
Board [Ks Kc Ts]
Seat 1: rQhYIYXSyH/IivYM1dlV5A (button) folded before Flop (didn't bet)
Seat 2: og4yH4sZUZdC8jjgW8zPJQ (small blind) folded on the Flop
Seat 4: j4q3p0lesp63b1gZDwLBZw (big blind) folded on the Flop
Seat 6: kN0AWJG6biW8tHtuF+wTjA folded before Flop (didn't bet)
Seat 7: aNpwfA31EREwO+ar4XzBCw folded before Flop (didn't bet)
Seat 9: gE5rN2TDY1aXcZn/TOPeZw collected ($0.75)




PokerStars Game #59941708426:  Hold'em No Limit ($0.10/$0.25) - 2009/07/01 1:43:39 ET
Table 'YONIZZNvg4uZ4xNUO1deeA' 6-max Seat #3 is the button
Seat 1: GbCVUNssQ7mqsPWr7J4d3w ($4.65 in chips) 
Seat 2: evMMX/0gSDH791KdSAOaSg ($18.20 in chips) 
Seat 3: Eksrep3hySi2jeDHuaWiOQ ($10.65 in chips) 
Seat 4: oNAHfBJOUelvVhf0IDMJUA ($11.55 in chips) 
Seat 5: if4dh6jhJXeN3/qd3qCp9g ($25.35 in chips) 
Seat 6: eL3+wCBjFGfQ5FMdIZihwA ($25 in chips) 
oNAHfBJOUelvVhf0IDMJUA: posts small blind $0.10
if4dh6jhJXeN3/qd3qCp9g: posts big blind $0.25
*** HOLE CARDS ***
eL3+wCBjFGfQ5FMdIZihwA: folds 
GbCVUNssQ7mqsPWr7J4d3w: raises $0.50 to $0.75
evMMX/0gSDH791KdSAOaSg: folds 
Eksrep3hySi2jeDHuaWiOQ: folds 
oNAHfBJOUelvVhf0IDMJUA: raises $8.50 to $9.25
if4dh6jhJXeN3/qd3qCp9g: folds 
GbCVUNssQ7mqsPWr7J4d3w: folds 
Uncalled bet ($8.50) returned to oNAHfBJOUelvVhf0IDMJUA
oNAHfBJOUelvVhf0IDMJUA collected $1.75 from pot
oNAHfBJOUelvVhf0IDMJUA: doesn't show hand 
*** SUMMARY ***
Total pot $1.75 | Rake $0 
Seat 1: GbCVUNssQ7mqsPWr7J4d3w folded before Flop
Seat 2: evMMX/0gSDH791KdSAOaSg folded before Flop (didn't bet)
Seat 3: Eksrep3hySi2jeDHuaWiOQ (button) folded before Flop (didn't bet)
Seat 4: oNAHfBJOUelvVhf0IDMJUA (small blind) collected ($1.75)
Seat 5: if4dh6jhJXeN3/qd3qCp9g (big blind) folded before Flop
Seat 6: eL3+wCBjFGfQ5FMdIZihwA folded before Flop (didn't bet)




PokerStars Game #59941708144:  Hold'em No Limit ($0.10/$0.25) - 2009/07/01 1:43:39 ET
Table 'XX2OuOsa8/8AC+/mR/Az6g' 9-max Seat #4 is the button
Seat 1: 56S3mA6Zs3pGR+0p0vUCtg ($26.15 in chips) 
Seat 2: Bb42QRQMhg5/Y0vHP8/2Xw ($27.10 in chips) 
Seat 3: oLa/tXLfSLLB28mcLGrxcg ($24.60 in chips) 
Seat 4: 52uIvr1a/mxEYD1W0ESvdQ ($25.10 in chips) 
Seat 5: SpiiQQAzy4MUgV3I5W8giw ($21.25 in chips) 
Seat 6: RCqMONFrSPSArZh2Jsar/w ($20 in chips) 
Seat 8: qwr38jl5txoR36M7G5qi4A ($10.35 in chips) 
Seat 9: V6p0jQ/RhUsqpHLmXvEX4Q ($11.15 in chips) 
SpiiQQAzy4MUgV3I5W8giw: posts small blind $0.10
RCqMONFrSPSArZh2Jsar/w: posts big blind $0.25
*** HOLE CARDS ***
qwr38jl5txoR36M7G5qi4A: folds 
V6p0jQ/RhUsqpHLmXvEX4Q: folds 
56S3mA6Zs3pGR+0p0vUCtg: raises $1 to $1.25
Bb42QRQMhg5/Y0vHP8/2Xw: folds 
oLa/tXLfSLLB28mcLGrxcg: folds 
52uIvr1a/mxEYD1W0ESvdQ: calls $1.25
SpiiQQAzy4MUgV3I5W8giw: folds 
RCqMONFrSPSArZh2Jsar/w: folds 
*** FLOP *** [Jc Ad Js]
56S3mA6Zs3pGR+0p0vUCtg: checks 
52uIvr1a/mxEYD1W0ESvdQ: checks 
*** TURN *** [Jc Ad Js] [5h]
56S3mA6Zs3pGR+0p0vUCtg: checks 
52uIvr1a/mxEYD1W0ESvdQ: checks 
*** RIVER *** [Jc Ad Js 5h] [4c]
56S3mA6Zs3pGR+0p0vUCtg: checks 
52uIvr1a/mxEYD1W0ESvdQ: bets $0.50
56S3mA6Zs3pGR+0p0vUCtg: calls $0.50
*** SHOW DOWN ***
52uIvr1a/mxEYD1W0ESvdQ: shows [8h As] (two pair, Aces and Jacks)
56S3mA6Zs3pGR+0p0vUCtg: mucks hand 
52uIvr1a/mxEYD1W0ESvdQ collected $3.70 from pot
*** SUMMARY ***
Total pot $3.85 | Rake $0.15 
Board [Jc Ad Js 5h 4c]
Seat 1: 56S3mA6Zs3pGR+0p0vUCtg mucked
Seat 2: Bb42QRQMhg5/Y0vHP8/2Xw folded before Flop (didn't bet)
Seat 3: oLa/tXLfSLLB28mcLGrxcg folded before Flop (didn't bet)
Seat 4: 52uIvr1a/mxEYD1W0ESvdQ (button) showed [8h As] and won ($3.70) with two pair, Aces and Jacks
Seat 5: SpiiQQAzy4MUgV3I5W8giw (small blind) folded before Flop
Seat 6: RCqMONFrSPSArZh2Jsar/w (big blind) folded before Flop
Seat 8: qwr38jl5txoR36M7G5qi4A folded before Flop (didn't bet)
Seat 9: V6p0jQ/RhUsqpHLmXvEX4Q folded before Flop (didn't bet)




PokerStars Game #59941708066:  Hold'em No Limit ($0.10/$0.25) - 2009/07/01 1:43:39 ET
Table 'l8hUTjBTXBorNUR/tyvSLw' 9-max Seat #3 is the button
Seat 1: cZ99hugmLBj9KhTlc8nCSw ($27.50 in chips) 
Seat 2: B6xHiX1SJkS0CUNCKDVwuQ ($20.90 in chips) 
Seat 3: ShCS62CJp4MKfKLKvGKQbA ($9.10 in chips) 
Seat 4: vPtFvcPtn/Afz0sucO1cmQ ($37.05 in chips) 
Seat 5: yyG4svzOpC1A+sUP/scg6w ($7.50 in chips) 
Seat 6: EVqHvqty1ZsuvDFiSXlSqQ ($23.85 in chips) 
Seat 7: F7pnn6czNpHvRM55XcA2EA ($33.40 in chips) 
Seat 8: Mh2r9hTeTEDnh19sRZtW3g ($5 in chips) 
vPtFvcPtn/Afz0sucO1cmQ: posts small blind $0.10
yyG4svzOpC1A+sUP/scg6w: posts big blind $0.25
*** HOLE CARDS ***
EVqHvqty1ZsuvDFiSXlSqQ: folds 
F7pnn6czNpHvRM55XcA2EA: folds 
Mh2r9hTeTEDnh19sRZtW3g: folds 
cZ99hugmLBj9KhTlc8nCSw: raises $0.50 to $0.75
B6xHiX1SJkS0CUNCKDVwuQ: folds 
ShCS62CJp4MKfKLKvGKQbA: folds 
vPtFvcPtn/Afz0sucO1cmQ: folds 
yyG4svzOpC1A+sUP/scg6w: folds 
Uncalled bet ($0.50) returned to cZ99hugmLBj9KhTlc8nCSw
cZ99hugmLBj9KhTlc8nCSw collected $0.60 from pot
*** SUMMARY ***
Total pot $0.60 | Rake $0 
Seat 1: cZ99hugmLBj9KhTlc8nCSw collected ($0.60)
Seat 2: B6xHiX1SJkS0CUNCKDVwuQ folded before Flop (didn't bet)
Seat 3: ShCS62CJp4MKfKLKvGKQbA (button) folded before Flop (didn't bet)
Seat 4: vPtFvcPtn/Afz0sucO1cmQ (small blind) folded before Flop
Seat 5: yyG4svzOpC1A+sUP/scg6w (big blind) folded before Flop
Seat 6: EVqHvqty1ZsuvDFiSXlSqQ folded before Flop (didn't bet)
Seat 7: F7pnn6czNpHvRM55XcA2EA folded before Flop (didn't bet)
Seat 8: Mh2r9hTeTEDnh19sRZtW3g folded before Flop (didn't bet)




PokerStars Game #59941708044:  Hold'em No Limit ($0.10/$0.25) - 2009/07/01 1:43:39 ET
Table '/VaaaFnlEJoYVomG9uxHkA' 9-max Seat #8 is the button
Seat 1: Th3FldXKQW6hWVVPahaoOQ ($27.20 in chips) 
Seat 2: DIkeSkosO/tsUp9d2JVyTA ($58.30 in chips) 
Seat 3: MtVtHDqIJTyUcXkRBBDIVA ($26.50 in chips) 
Seat 4: j4q3p0lesp63b1gZDwLBZw ($5 in chips) 
Seat 5: cZ99hugmLBj9KhTlc8nCSw ($25.50 in chips) 
Seat 6: qxWFg3MZuVyidB0SJh5ywg ($33.20 in chips) 
Seat 7: F7pnn6czNpHvRM55XcA2EA ($25.50 in chips) 
Seat 8: dfNim92Z6XK1/h5SFW5vDg ($45.75 in chips) 
DdPXdieucQ+n99u1n3A+rQ will be allowed to play after the button
Th3FldXKQW6hWVVPahaoOQ: posts small blind $0.10
DIkeSkosO/tsUp9d2JVyTA: posts big blind $0.25
*** HOLE CARDS ***
MtVtHDqIJTyUcXkRBBDIVA: folds 
j4q3p0lesp63b1gZDwLBZw: folds 
cZ99hugmLBj9KhTlc8nCSw: raises $0.50 to $0.75
qxWFg3MZuVyidB0SJh5ywg: folds 
F7pnn6czNpHvRM55XcA2EA: folds 
dfNim92Z6XK1/h5SFW5vDg: folds 
Th3FldXKQW6hWVVPahaoOQ: calls $0.65
DIkeSkosO/tsUp9d2JVyTA: calls $0.50
*** FLOP *** [5h Ks 5d]
Th3FldXKQW6hWVVPahaoOQ: checks 
DIkeSkosO/tsUp9d2JVyTA: bets $0.50
cZ99hugmLBj9KhTlc8nCSw: raises $1.50 to $2
qxWFg3MZuVyidB0SJh5ywg is sitting out
Th3FldXKQW6hWVVPahaoOQ: raises $4 to $6
DIkeSkosO/tsUp9d2JVyTA: folds 
cZ99hugmLBj9KhTlc8nCSw: folds 
Uncalled bet ($4) returned to Th3FldXKQW6hWVVPahaoOQ
Th3FldXKQW6hWVVPahaoOQ collected $6.45 from pot
Th3FldXKQW6hWVVPahaoOQ: doesn't show hand 
*** SUMMARY ***
Total pot $6.75 | Rake $0.30 
Board [5h Ks 5d]
Seat 1: Th3FldXKQW6hWVVPahaoOQ (small blind) collected ($6.45)
Seat 2: DIkeSkosO/tsUp9d2JVyTA (big blind) folded on the Flop
Seat 3: MtVtHDqIJTyUcXkRBBDIVA folded before Flop (didn't bet)
Seat 4: j4q3p0lesp63b1gZDwLBZw folded before Flop (didn't bet)
Seat 5: cZ99hugmLBj9KhTlc8nCSw folded on the Flop
Seat 6: qxWFg3MZuVyidB0SJh5ywg folded before Flop (didn't bet)
Seat 7: F7pnn6czNpHvRM55XcA2EA folded before Flop (didn't bet)
Seat 8: dfNim92Z6XK1/h5SFW5vDg (button) folded before Flop (didn't bet)




PokerStars Game #59941708160:  Hold'em No Limit ($0.10/$0.25) - 2009/07/01 1:43:39 ET
Table 'nc6OeGk/wtaWV+6N+kgnZQgZetDqJh6q9A3mLO3ThCsASeat #2 is the button
Seat 1: DihMHaz4WNETH1bPDe13kA ($26.05 in chips) 
Seat 2: JFIAqU8lCZ0vWwEl4bdGsg ($32.90 in chips) 
Seat 3: jp34e617tIzV8tKIWmfAbA ($33.55 in chips) 
Seat 4: BV+K0Phf5VBHr7aZPKqbUQ ($29.35 in chips) 
Seat 5: 5hAPbqNrvJb8PtLiceXtlgEKTLAV1bAterT0Mc1G6lBg4.75 in chips) 
jp34e617tIzV8tKIWmfAbA: posts small blind $0.10
BV+K0Phf5VBHr7aZPKqbUQ: posts big blind $0.25
StevenWu: sits out 
*** HOLE CARDS ***
5hAPbqNrvJb8PtLiceXtlgEKTLAV1bAterT0Mc1G6lBglls $0.25
DihMHaz4WNETH1bPDe13kA: folds 
JFIAqU8lCZ0vWwEl4bdGsg: folds 
jp34e617tIzV8tKIWmfAbA: folds 
BV+K0Phf5VBHr7aZPKqbUQ: checks 
*** FLOP *** [6d 7c 6c]
BV+K0Phf5VBHr7aZPKqbUQ: checks 
5hAPbqNrvJb8PtLiceXtlgEKTLAV1bAterT0Mc1G6lBgts $0.75
BV+K0Phf5VBHr7aZPKqbUQ: folds 
Uncalled bet ($0.75) returned to 5hAPbqNrvJb8PtLiceXtlgEKTLAV1bAterT0Mc1G6lBg5hAPbqNrvJb8PtLiceXtlgdph collected $0.60 from pot
5hAPbqNrvJb8PtLiceXtlgEKTLAV1bAterT0Mc1G6lBgesn't show hand 
*** SUMMARY ***
Total pot $0.60 | Rake $0 
Board [6d 7c 6c]
Seat 1: DihMHaz4WNETH1bPDe13kA folded before Flop (didn't bet)
Seat 2: JFIAqU8lCZ0vWwEl4bdGsg (button) folded before Flop (didn't bet)
Seat 3: jp34e617tIzV8tKIWmfAbA (small blind) folded before Flop
Seat 4: BV+K0Phf5VBHr7aZPKqbUQ (big blind) folded on the Flop
Seat 5: 5hAPbqNrvJb8PtLiceXtlgEKTLAV1bAterT0Mc1G6lBglected ($0.60)




PokerStars Game #59941708392:  Hold'em No Limit ($0.10/$0.25) - 2009/07/01 1:43:39 ET
Table 'i8VqsSY3xDtJ63IHleN8+A' 9-max Seat #5 is the button
Seat 5: +E5iJKkKVfaTgTqzuXXv0g ($14.75 in chips) 
+E5iJKkKVfaTgTqzuXXv0g: posts small blind $0.10
4awUyiDYTgylQKXZ9faBVA: is sitting out 
Hand cancelled
*** SUMMARY ***
Seat 5: +E5iJKkKVfaTgTqzuXXv0g (button) collected ($0)




PokerStars Game #59941708462:  Hold'em No Limit ($0.10/$0.25) - 2009/07/01 1:43:39 ET
Table 'djcjiEGabFQO0MNG6jEeJQ' 9-max Seat #9 is the button
Seat 1: Bb42QRQMhg5/Y0vHP8/2Xw ($25 in chips) 
Seat 2: WKL8nUFr7TumC4EjLyqYzw ($5.25 in chips) 
Seat 3: zgi+EUykT/pZQpoUG6+oEg ($5 in chips) 
Seat 4: 2wcFsZsqEP5w1StUTVzJCg ($9.55 in chips) 
Seat 5: cZ99hugmLBj9KhTlc8nCSw ($42 in chips) 
Seat 6: aNpwfA31EREwO+ar4XzBCw ($74 in chips) 
Seat 7: 56S3mA6Zs3pGR+0p0vUCtg ($35.30 in chips) 
Seat 8: +sbyWwIcFp9kP0bDtMegfQ ($51.25 in chips) 
Seat 9: HPEB+AtKw1+C/cxU0o1ciw ($46.85 in chips) 
Bb42QRQMhg5/Y0vHP8/2Xw: posts small blind $0.10
WKL8nUFr7TumC4EjLyqYzw: posts big blind $0.25
*** HOLE CARDS ***
zgi+EUykT/pZQpoUG6+oEg: folds 
2wcFsZsqEP5w1StUTVzJCg: folds 
cZ99hugmLBj9KhTlc8nCSw: folds 
aNpwfA31EREwO+ar4XzBCw: folds 
56S3mA6Zs3pGR+0p0vUCtg: folds 
+sbyWwIcFp9kP0bDtMegfQ: folds 
HPEB+AtKw1+C/cxU0o1ciw: folds 
Bb42QRQMhg5/Y0vHP8/2Xw: folds 
Uncalled bet ($0.15) returned to WKL8nUFr7TumC4EjLyqYzw
WKL8nUFr7TumC4EjLyqYzw collected $0.20 from pot
WKL8nUFr7TumC4EjLyqYzw: doesn't show hand 
*** SUMMARY ***
Total pot $0.20 | Rake $0 
Seat 1: Bb42QRQMhg5/Y0vHP8/2Xw (small blind) folded before Flop
Seat 2: WKL8nUFr7TumC4EjLyqYzw (big blind) collected ($0.20)
Seat 3: zgi+EUykT/pZQpoUG6+oEg folded before Flop (didn't bet)
Seat 4: 2wcFsZsqEP5w1StUTVzJCg folded before Flop (didn't bet)
Seat 5: cZ99hugmLBj9KhTlc8nCSw folded before Flop (didn't bet)
Seat 6: aNpwfA31EREwO+ar4XzBCw folded before Flop (didn't bet)
Seat 7: 56S3mA6Zs3pGR+0p0vUCtg folded before Flop (didn't bet)
Seat 8: +sbyWwIcFp9kP0bDtMegfQ folded before Flop (didn't bet)
Seat 9: HPEB+AtKw1+C/cxU0o1ciw (button) folded before Flop (didn't bet)




PokerStars Game #59941708626:  Hold'em No Limit ($0.10/$0.25) - 2009/07/01 1:43:40 ET
Table 'dVzscin98UhGisTmV9BDcw' 9-max Seat #1 is the button
Seat 1: sBAwXpkpgyhyWbHIQcIJKA ($17.55 in chips) 
Seat 2: dfNim92Z6XK1/h5SFW5vDg ($28.35 in chips) 
Seat 3: cZ99hugmLBj9KhTlc8nCSw ($25 in chips) 
Seat 4: aNpwfA31EREwO+ar4XzBCw ($42.25 in chips) 
Seat 5: 22dIObOuor/A+IKWkNoAlA ($10.10 in chips) 
Seat 6: bXpVeaSTPBFSPJmeXxO7nw ($8.30 in chips) 
Seat 7: cKlmpQMahVsmOaxFQDcoOg ($24.65 in chips) 
Seat 8: /vn2Qu2dvc9AMMq46Ae0jA ($44.40 in chips) 
Seat 9: arxNSjreDRGFg13EAM2F1w ($25 in chips) 
dfNim92Z6XK1/h5SFW5vDg: posts small blind $0.10
cZ99hugmLBj9KhTlc8nCSw: posts big blind $0.25
*** HOLE CARDS ***
aNpwfA31EREwO+ar4XzBCw: folds 
22dIObOuor/A+IKWkNoAlA: folds 
bXpVeaSTPBFSPJmeXxO7nw: folds 
cKlmpQMahVsmOaxFQDcoOg: folds 
/vn2Qu2dvc9AMMq46Ae0jA: folds 
arxNSjreDRGFg13EAM2F1w: raises $0.50 to $0.75
sBAwXpkpgyhyWbHIQcIJKA: folds 
dfNim92Z6XK1/h5SFW5vDg: folds 
cZ99hugmLBj9KhTlc8nCSw: folds 
Uncalled bet ($0.50) returned to arxNSjreDRGFg13EAM2F1w
arxNSjreDRGFg13EAM2F1w collected $0.60 from pot
arxNSjreDRGFg13EAM2F1w: doesn't show hand 
*** SUMMARY ***
Total pot $0.60 | Rake $0 
Seat 1: sBAwXpkpgyhyWbHIQcIJKA (button) folded before Flop (didn't bet)
Seat 2: dfNim92Z6XK1/h5SFW5vDg (small blind) folded before Flop
Seat 3: cZ99hugmLBj9KhTlc8nCSw (big blind) folded before Flop
Seat 4: aNpwfA31EREwO+ar4XzBCw folded before Flop (didn't bet)
Seat 5: 22dIObOuor/A+IKWkNoAlA folded before Flop (didn't bet)
Seat 6: bXpVeaSTPBFSPJmeXxO7nw folded before Flop (didn't bet)
Seat 7: cKlmpQMahVsmOaxFQDcoOg folded before Flop (didn't bet)
Seat 8: /vn2Qu2dvc9AMMq46Ae0jA folded before Flop (didn't bet)
Seat 9: arxNSjreDRGFg13EAM2F1w collected ($0.60)




PokerStars Game #59941708546:  Hold'em No Limit ($0.10/$0.25) - 2009/07/01 1:43:40 ET
Table 'jxoHy9yJy0bbH/Qx73FoPA' 9-max Seat #4 is the button
Seat 1: j4q3p0lesp63b1gZDwLBZw ($6.60 in chips) 
Seat 2: F7pnn6czNpHvRM55XcA2EA ($45.50 in chips) 
Seat 3: CVqCt93Mk0MhKMaZ4LZDSQ ($11.20 in chips) 
Seat 4: A1M0JIGHzqMXp7L2MdcxXw ($26.30 in chips) 
Seat 5: rzZ3wFcwoPyKlQ0mB5JLRQ ($5.10 in chips) 
Seat 6: tYsOBqdU1+x+yFI7zHO7hQ ($38.85 in chips) 
Seat 7: wGigCmBR/9XWkPpvYos3aQ ($26.40 in chips) 
Seat 9: CvL9Ch1HYCVbTsfpNucitg ($4.90 in chips) 
rzZ3wFcwoPyKlQ0mB5JLRQ: posts small blind $0.10
tYsOBqdU1+x+yFI7zHO7hQ: posts big blind $0.25
Z9W7+g1WMhhZDi7DwGbCFA: sits out 
*** HOLE CARDS ***
wGigCmBR/9XWkPpvYos3aQ: folds 
CvL9Ch1HYCVbTsfpNucitg: folds 
j4q3p0lesp63b1gZDwLBZw: folds 
F7pnn6czNpHvRM55XcA2EA: folds 
CVqCt93Mk0MhKMaZ4LZDSQ: folds 
A1M0JIGHzqMXp7L2MdcxXw: calls $0.25
rzZ3wFcwoPyKlQ0mB5JLRQ: folds 
tYsOBqdU1+x+yFI7zHO7hQ: checks 
*** FLOP *** [6s 3s Kc]
tYsOBqdU1+x+yFI7zHO7hQ: checks 
A1M0JIGHzqMXp7L2MdcxXw: checks 
*** TURN *** [6s 3s Kc] [4d]
tYsOBqdU1+x+yFI7zHO7hQ: bets $0.50
A1M0JIGHzqMXp7L2MdcxXw: raises $0.50 to $1
tYsOBqdU1+x+yFI7zHO7hQ: raises $3.50 to $4.50
A1M0JIGHzqMXp7L2MdcxXw: raises $21.55 to $26.05 and is all-in
tYsOBqdU1+x+yFI7zHO7hQ: calls $21.55
*** RIVER *** [6s 3s Kc 4d] [Kd]
*** SHOW DOWN ***
tYsOBqdU1+x+yFI7zHO7hQ: shows [6h 6c] (a full house, Sixes full of Kings)
A1M0JIGHzqMXp7L2MdcxXw: mucks hand 
tYsOBqdU1+x+yFI7zHO7hQ collected $50.10 from pot
*** SUMMARY ***
Total pot $52.70 | Rake $2.60 
Board [6s 3s Kc 4d Kd]
Seat 1: j4q3p0lesp63b1gZDwLBZw folded before Flop (didn't bet)
Seat 2: F7pnn6czNpHvRM55XcA2EA folded before Flop (didn't bet)
Seat 3: CVqCt93Mk0MhKMaZ4LZDSQ folded before Flop (didn't bet)
Seat 4: A1M0JIGHzqMXp7L2MdcxXw (button) mucked
Seat 5: rzZ3wFcwoPyKlQ0mB5JLRQ (small blind) folded before Flop
Seat 6: tYsOBqdU1+x+yFI7zHO7hQ (big blind) showed [6h 6c] and won ($50.10) with a full house, Sixes full of Kings
Seat 7: wGigCmBR/9XWkPpvYos3aQ folded before Flop (didn't bet)
Seat 9: CvL9Ch1HYCVbTsfpNucitg folded before Flop (didn't bet)




PokerStars Game #59941708894:  Hold'em No Limit ($0.10/$0.25) - 2009/07/01 1:43:40 ET
Table 'KAnP7XvDtlku47YfJwdOVw' 9-max Seat #5 is the button
Seat 1: cH3q40adP+kFogl+2MtbkQ ($14.50 in chips) 
Seat 2: VFTQG1/RfAKeMXRBv1ewsg ($28 in chips) 
Seat 3: W6tExOcYX7qiy6Qdp+ZwFA ($5.95 in chips) 
Seat 4: OiV1PWZ3IkN29JlmCcnTwQ ($4.65 in chips) 
Seat 5: MG90wfSJZnOejs/KD3vlQQ ($33.05 in chips) 
Seat 7: Lro4e37x4FUa5P3yzDjskw ($8.05 in chips) 
Seat 8: OneeONzF0MoH0pEdcBndwA ($22.80 in chips) 
Seat 9: HDDm1BkZtdsRyw2DJdqq6A ($24.65 in chips) 
Lro4e37x4FUa5P3yzDjskw: posts small blind $0.10
OneeONzF0MoH0pEdcBndwA: posts big blind $0.25
*** HOLE CARDS ***
HDDm1BkZtdsRyw2DJdqq6A: calls $0.25
cH3q40adP+kFogl+2MtbkQ: folds 
VFTQG1/RfAKeMXRBv1ewsg: folds 
VFTQG1/RfAKeMXRBv1ewsg leaves the table
W6tExOcYX7qiy6Qdp+ZwFA: calls $0.25
OiV1PWZ3IkN29JlmCcnTwQ: folds 
MG90wfSJZnOejs/KD3vlQQ: folds 
Lro4e37x4FUa5P3yzDjskw: calls $0.15
VegasVas joins the table at seat #2 
OneeONzF0MoH0pEdcBndwA: checks 
*** FLOP *** [5s 6c Qd]
Lro4e37x4FUa5P3yzDjskw: bets $0.75
OneeONzF0MoH0pEdcBndwA: folds 
HDDm1BkZtdsRyw2DJdqq6A: folds 
W6tExOcYX7qiy6Qdp+ZwFA: calls $0.75
*** TURN *** [5s 6c Qd] [3h]
Lro4e37x4FUa5P3yzDjskw: bets $0.25
W6tExOcYX7qiy6Qdp+ZwFA: raises $0.75 to $1
Lro4e37x4FUa5P3yzDjskw: folds 
Uncalled bet ($0.75) returned to W6tExOcYX7qiy6Qdp+ZwFA
W6tExOcYX7qiy6Qdp+ZwFA collected $2.90 from pot
W6tExOcYX7qiy6Qdp+ZwFA: doesn't show hand 
*** SUMMARY ***
Total pot $3 | Rake $0.10 
Board [5s 6c Qd 3h]
Seat 1: cH3q40adP+kFogl+2MtbkQ folded before Flop (didn't bet)
Seat 2: VFTQG1/RfAKeMXRBv1ewsg folded before Flop (didn't bet)
Seat 3: W6tExOcYX7qiy6Qdp+ZwFA collected ($2.90)
Seat 4: OiV1PWZ3IkN29JlmCcnTwQ folded before Flop (didn't bet)
Seat 5: MG90wfSJZnOejs/KD3vlQQ (button) folded before Flop (didn't bet)
Seat 7: Lro4e37x4FUa5P3yzDjskw (small blind) folded on the Turn
Seat 8: OneeONzF0MoH0pEdcBndwA (big blind) folded on the Flop
Seat 9: HDDm1BkZtdsRyw2DJdqq6A folded on the Flop




PokerStars Game #59941708788:  Hold'em No Limit ($0.10/$0.25) - 2009/07/01 1:43:40 ET
Table 'GgmUtmhrYPRnhkqEEjD/Kw' 9-max Seat #3 is the button
Seat 2: ghNKXUBl/H+t83JF079ZBA ($25.15 in chips) 
Seat 3: dYvYZ723QlKIPiDa0pkedQ ($7.90 in chips) 
Seat 4: dfNim92Z6XK1/h5SFW5vDg ($25 in chips) 
Seat 5: ljemhp25Zg+nlA9DLCIiUw ($27 in chips) 
Seat 6: 4Ax0vobe1rLVIGZmkFINGA ($20.25 in chips) 
Seat 7: YwDw9cMqkbMznFK77rru4A ($5.15 in chips) 
Seat 8: DdPXdieucQ+n99u1n3A+rQ ($4.65 in chips) 
Seat 9: V6p0jQ/RhUsqpHLmXvEX4Q ($13.95 in chips) 
dfNim92Z6XK1/h5SFW5vDg: posts small blind $0.10
ljemhp25Zg+nlA9DLCIiUw: posts big blind $0.25
bXpVeaSTPBFSPJmeXxO7nw: sits out 
*** HOLE CARDS ***
4Ax0vobe1rLVIGZmkFINGA: folds 
YwDw9cMqkbMznFK77rru4A: folds 
DdPXdieucQ+n99u1n3A+rQ: folds 
V6p0jQ/RhUsqpHLmXvEX4Q: folds 
ghNKXUBl/H+t83JF079ZBA: folds 
dYvYZ723QlKIPiDa0pkedQ: calls $0.25
dfNim92Z6XK1/h5SFW5vDg: folds 
ljemhp25Zg+nlA9DLCIiUw: checks 
*** FLOP *** [6h 9c 3d]
ljemhp25Zg+nlA9DLCIiUw: checks 
dYvYZ723QlKIPiDa0pkedQ: bets $0.25
ljemhp25Zg+nlA9DLCIiUw: folds 
Uncalled bet ($0.25) returned to dYvYZ723QlKIPiDa0pkedQ
dYvYZ723QlKIPiDa0pkedQ collected $0.60 from pot
dYvYZ723QlKIPiDa0pkedQ: doesn't show hand 
*** SUMMARY ***
Total pot $0.60 | Rake $0 
Board [6h 9c 3d]
Seat 2: ghNKXUBl/H+t83JF079ZBA folded before Flop (didn't bet)
Seat 3: dYvYZ723QlKIPiDa0pkedQ (button) collected ($0.60)
Seat 4: dfNim92Z6XK1/h5SFW5vDg (small blind) folded before Flop
Seat 5: ljemhp25Zg+nlA9DLCIiUw (big blind) folded on the Flop
Seat 6: 4Ax0vobe1rLVIGZmkFINGA folded before Flop (didn't bet)
Seat 7: YwDw9cMqkbMznFK77rru4A folded before Flop (didn't bet)
Seat 8: DdPXdieucQ+n99u1n3A+rQ folded before Flop (didn't bet)
Seat 9: V6p0jQ/RhUsqpHLmXvEX4Q folded before Flop (didn't bet)




PokerStars Game #59941708640:  Hold'em No Limit ($0.10/$0.25) - 2009/07/01 1:43:40 ET
Table 'NtEQAxCeIK2io1CGtW658g' 6-max Seat #4 is the button
Seat 1: X437kMQ7AujoaDgjguhU9w ($9.90 in chips) 
Seat 3: m2yWOKfAxqHoy5DDN87Ttw ($39.75 in chips) 
Seat 4: 8296 ($11.55 in chips) 
Seat 5: Hsvkc0/G2VV78oVmWYXecw ($5.10 in chips) 
Seat 6: /gJNBeCkWL4o85/jvlZ4BA ($65.10 in chips) 
Hsvkc0/G2VV78oVmWYXecw: posts small blind $0.10
/gJNBeCkWL4o85/jvlZ4BA: posts big blind $0.25
*** HOLE CARDS ***
X437kMQ7AujoaDgjguhU9w: folds 
m2yWOKfAxqHoy5DDN87Ttw: raises $0.75 to $1
8296: folds 
Hsvkc0/G2VV78oVmWYXecw: folds 
/gJNBeCkWL4o85/jvlZ4BA: folds 
Uncalled bet ($0.75) returned to m2yWOKfAxqHoy5DDN87Ttw
m2yWOKfAxqHoy5DDN87Ttw collected $0.60 from pot
m2yWOKfAxqHoy5DDN87Ttw: doesn't show hand 
*** SUMMARY ***
Total pot $0.60 | Rake $0 
Seat 1: X437kMQ7AujoaDgjguhU9w folded before Flop (didn't bet)
Seat 3: m2yWOKfAxqHoy5DDN87Ttw collected ($0.60)
Seat 4: 8296 (button) folded before Flop (didn't bet)
Seat 5: Hsvkc0/G2VV78oVmWYXecw (small blind) folded before Flop
Seat 6: /gJNBeCkWL4o85/jvlZ4BA (big blind) folded before Flop




PokerStars Game #59941708928:  Hold'em No Limit ($0.10/$0.25) - 2009/07/01 1:43:40 ET
Table 'JJzUs04lHpXg6nboT1/jeg' 6-max Seat #2 is the button
Seat 1: MqMK8OWPSY1V4stf1Hy5Jw ($38.95 in chips) 
Seat 2: jxfR29d+dK/7h7s3SvCk+g ($6.35 in chips) 
Seat 3: 4zXbHDe39qNX46dAo81b4w ($7.40 in chips) 
Seat 4: 7VfhiFY533nbUKvyEthASw ($29.85 in chips) 
Seat 5: QvTX2yGq3uKJiKPmns4TKQ ($20.75 in chips) 
Seat 6: wqphQtauX5Qn7WRJZS1flA ($29.30 in chips) 
4zXbHDe39qNX46dAo81b4w: posts small blind $0.10
7VfhiFY533nbUKvyEthASw: posts big blind $0.25
*** HOLE CARDS ***
QvTX2yGq3uKJiKPmns4TKQ: folds 
wqphQtauX5Qn7WRJZS1flA: folds 
MqMK8OWPSY1V4stf1Hy5Jw: folds 
jxfR29d+dK/7h7s3SvCk+g: raises $0.50 to $0.75
4zXbHDe39qNX46dAo81b4w: folds 
7VfhiFY533nbUKvyEthASw: folds 
Uncalled bet ($0.50) returned to jxfR29d+dK/7h7s3SvCk+g
jxfR29d+dK/7h7s3SvCk+g collected $0.60 from pot
*** SUMMARY ***
Total pot $0.60 | Rake $0 
Seat 1: MqMK8OWPSY1V4stf1Hy5Jw folded before Flop (didn't bet)
Seat 2: jxfR29d+dK/7h7s3SvCk+g (button) collected ($0.60)
Seat 3: 4zXbHDe39qNX46dAo81b4w (small blind) folded before Flop
Seat 4: 7VfhiFY533nbUKvyEthASw (big blind) folded before Flop
Seat 5: QvTX2yGq3uKJiKPmns4TKQ folded before Flop (didn't bet)
Seat 6: wqphQtauX5Qn7WRJZS1flA folded before Flop (didn't bet)




PokerStars Game #59941708826:  Hold'em No Limit ($0.10/$0.25) - 2009/07/01 1:43:40 ET
Table 'wPWRBZPJl1HAnysw7qRR0A' 6-max Seat #1 is the button
Seat 1: m7ne1MOFTQXlsXT7/R/rug ($6.90 in chips) 
Seat 2: xC0kaiDYM6YTlgODL83O5A ($14.75 in chips) 
Seat 3: 1ZpoLWO2nm2w1Nd1v9Sr3g ($7.35 in chips) 
Seat 4: epAUIB7h2FJXzUPRIvSkRA ($25.95 in chips) 
Seat 5: y0B+UpYpOUJz3JWtlJQBSA ($16.35 in chips) 
Seat 6: Hsvkc0/G2VV78oVmWYXecw ($9.30 in chips) 
xC0kaiDYM6YTlgODL83O5A: posts small blind $0.10
1ZpoLWO2nm2w1Nd1v9Sr3g: posts big blind $0.25
*** HOLE CARDS ***
epAUIB7h2FJXzUPRIvSkRA: raises $0.75 to $1
y0B+UpYpOUJz3JWtlJQBSA: folds 
Hsvkc0/G2VV78oVmWYXecw: folds 
m7ne1MOFTQXlsXT7/R/rug: folds 
xC0kaiDYM6YTlgODL83O5A: calls $0.90
1ZpoLWO2nm2w1Nd1v9Sr3g: folds 
*** FLOP *** [Ac 2s Td]
xC0kaiDYM6YTlgODL83O5A: checks 
epAUIB7h2FJXzUPRIvSkRA: bets $1.50
Hsvkc0/G2VV78oVmWYXecw leaves the table
xC0kaiDYM6YTlgODL83O5A: raises $2.25 to $3.75
epAUIB7h2FJXzUPRIvSkRA: calls $2.25
*** TURN *** [Ac 2s Td] [6h]
Voldemort219 joins the table at seat #6 
xC0kaiDYM6YTlgODL83O5A: bets $10 and is all-in
epAUIB7h2FJXzUPRIvSkRA: calls $10
*** RIVER *** [Ac 2s Td 6h] [2c]
*** SHOW DOWN ***
xC0kaiDYM6YTlgODL83O5A: shows [Qh As] (two pair, Aces and Deuces)
epAUIB7h2FJXzUPRIvSkRA: shows [Ah Ks] (two pair, Aces and Deuces - King kicker)
epAUIB7h2FJXzUPRIvSkRA collected $28.30 from pot
*** SUMMARY ***
Total pot $29.75 | Rake $1.45 
Board [Ac 2s Td 6h 2c]
Seat 1: m7ne1MOFTQXlsXT7/R/rug (button) folded before Flop (didn't bet)
Seat 2: xC0kaiDYM6YTlgODL83O5A (small blind) showed [Qh As] and lost with two pair, Aces and Deuces
Seat 3: 1ZpoLWO2nm2w1Nd1v9Sr3g (big blind) folded before Flop
Seat 4: epAUIB7h2FJXzUPRIvSkRA showed [Ah Ks] and won ($28.30) with two pair, Aces and Deuces
Seat 5: y0B+UpYpOUJz3JWtlJQBSA folded before Flop (didn't bet)
Seat 6: Hsvkc0/G2VV78oVmWYXecw folded before Flop (didn't bet)




PokerStars Game #59941708944:  Hold'em No Limit ($0.10/$0.25) - 2009/07/01 1:43:40 ET
Table 'KEoOIegxPF91KooL2AelUA' 6-max Seat #1 is the button
Seat 1: wsP46AGpqDjHZQmlRHKa9g ($42.25 in chips) 
Seat 2: 0Bg59Tnte1Tc7C4i9Jd9cQ ($7.65 in chips) 
Seat 3: zxeVQGaMKDsDzmSY+AInjA ($11.05 in chips) 
Seat 4: Wo60l2GQnSEc3bxPVyvIUw ($16.50 in chips) 
Seat 5: 08V++DOqzaNrRNsHIwi25w ($44.70 in chips) 
Seat 6: AMrBn4Vx9aAo/vv6WHLk6w ($3.15 in chips) 
0Bg59Tnte1Tc7C4i9Jd9cQ: posts small blind $0.10
zxeVQGaMKDsDzmSY+AInjA: posts big blind $0.25
*** HOLE CARDS ***
Wo60l2GQnSEc3bxPVyvIUw: folds 
08V++DOqzaNrRNsHIwi25w: folds 
AMrBn4Vx9aAo/vv6WHLk6w: folds 
wsP46AGpqDjHZQmlRHKa9g: folds 
0Bg59Tnte1Tc7C4i9Jd9cQ: raises $0.75 to $1
zxeVQGaMKDsDzmSY+AInjA: folds 
Uncalled bet ($0.75) returned to 0Bg59Tnte1Tc7C4i9Jd9cQ
0Bg59Tnte1Tc7C4i9Jd9cQ collected $0.50 from pot
0Bg59Tnte1Tc7C4i9Jd9cQ: doesn't show hand 
*** SUMMARY ***
Total pot $0.50 | Rake $0 
Seat 1: wsP46AGpqDjHZQmlRHKa9g (button) folded before Flop (didn't bet)
Seat 2: 0Bg59Tnte1Tc7C4i9Jd9cQ (small blind) collected ($0.50)
Seat 3: zxeVQGaMKDsDzmSY+AInjA (big blind) folded before Flop
Seat 4: Wo60l2GQnSEc3bxPVyvIUw folded before Flop (didn't bet)
Seat 5: 08V++DOqzaNrRNsHIwi25w folded before Flop (didn't bet)
Seat 6: AMrBn4Vx9aAo/vv6WHLk6w folded before Flop (didn't bet)




PokerStars Game #59941708588:  Hold'em No Limit ($0.10/$0.25) - 2009/07/01 1:43:40 ET
Table 'sgdCtiuCu2BDZhyDi6RzTA' 6-max Seat #2 is the button
Seat 1: 3zD3qLXT1bEffAoWGnc7wg ($31.20 in chips) 
Seat 2: XD1i5m5PvBDnRzJaG/vINw ($24.05 in chips) 
Seat 3: eL3+wCBjFGfQ5FMdIZihwA ($25.60 in chips) 
Seat 4: rVKEgilmMX+EkKzDVvhmxA ($8.70 in chips) 
Seat 5: 0tQitW75xfmVWKldYHjmOQ ($3.65 in chips) 
Seat 6: KODslGU8ikCYS0/29dUkhg ($37.20 in chips) 
eL3+wCBjFGfQ5FMdIZihwA: posts small blind $0.10
rVKEgilmMX+EkKzDVvhmxA: posts big blind $0.25
*** HOLE CARDS ***
0tQitW75xfmVWKldYHjmOQ: calls $0.25
KODslGU8ikCYS0/29dUkhg: calls $0.25
3zD3qLXT1bEffAoWGnc7wg: raises $0.75 to $1
XD1i5m5PvBDnRzJaG/vINw: folds 
eL3+wCBjFGfQ5FMdIZihwA: folds 
rVKEgilmMX+EkKzDVvhmxA: folds 
0tQitW75xfmVWKldYHjmOQ: folds 
KODslGU8ikCYS0/29dUkhg: calls $0.75
*** FLOP *** [Qh Kh 7c]
KODslGU8ikCYS0/29dUkhg: checks 
3zD3qLXT1bEffAoWGnc7wg: checks 
*** TURN *** [Qh Kh 7c] [8d]
KODslGU8ikCYS0/29dUkhg: checks 
3zD3qLXT1bEffAoWGnc7wg: checks 
*** RIVER *** [Qh Kh 7c 8d] [Ad]
KODslGU8ikCYS0/29dUkhg: bets $0.75
3zD3qLXT1bEffAoWGnc7wg: raises $1.75 to $2.50
KODslGU8ikCYS0/29dUkhg: folds 
Uncalled bet ($1.75) returned to 3zD3qLXT1bEffAoWGnc7wg
3zD3qLXT1bEffAoWGnc7wg collected $3.90 from pot
3zD3qLXT1bEffAoWGnc7wg: doesn't show hand 
*** SUMMARY ***
Total pot $4.10 | Rake $0.20 
Board [Qh Kh 7c 8d Ad]
Seat 1: 3zD3qLXT1bEffAoWGnc7wg collected ($3.90)
Seat 2: XD1i5m5PvBDnRzJaG/vINw (button) folded before Flop (didn't bet)
Seat 3: eL3+wCBjFGfQ5FMdIZihwA (small blind) folded before Flop
Seat 4: rVKEgilmMX+EkKzDVvhmxA (big blind) folded before Flop
Seat 5: 0tQitW75xfmVWKldYHjmOQ folded before Flop
Seat 6: KODslGU8ikCYS0/29dUkhg folded on the River




PokerStars Game #59941708632:  Hold'em No Limit ($0.10/$0.25) - 2009/07/01 1:43:40 ET
Table '0XPo7K54oZIfG0xlNAcDRw' 9-max Seat #1 is the button
Seat 1: 7cv+9Zc9HIQHNvYsMfV3uA ($28.05 in chips) 
Seat 4: RubYqfvGrz2z+5ReNIj9QQ ($31.30 in chips) 
Seat 5: iOmwbUN7u4JFkV6VCA49aA ($23.40 in chips) 
Seat 6: 9gmYYQesalMrUjaF7nKfrQ ($23.55 in chips) 
Seat 7: tYsOBqdU1+x+yFI7zHO7hQ ($28.80 in chips) 
Seat 8: v5jnQ1gfh9nLla3kMXG7Yg ($8 in chips) 
Seat 9: CmngQmkKTp8tkl6GMRTl6w ($13.60 in chips) 
RHqgdFvufLCYe54+qd2gcA will be allowed to play after the button
RubYqfvGrz2z+5ReNIj9QQ: posts small blind $0.10
iOmwbUN7u4JFkV6VCA49aA: posts big blind $0.25
*** HOLE CARDS ***
9gmYYQesalMrUjaF7nKfrQ: folds 
9gmYYQesalMrUjaF7nKfrQ leaves the table
Prl9QvWQw/mISF4dSnnQUQ has returned
tYsOBqdU1+x+yFI7zHO7hQ: folds 
v5jnQ1gfh9nLla3kMXG7Yg: calls $0.25
CmngQmkKTp8tkl6GMRTl6w: folds 
7cv+9Zc9HIQHNvYsMfV3uA: folds 
M1nKET7WOTLbVPuAbJa3EA joins the table at seat #6 
RubYqfvGrz2z+5ReNIj9QQ: calls $0.15
iOmwbUN7u4JFkV6VCA49aA: checks 
*** FLOP *** [Jh 6h Td]
RubYqfvGrz2z+5ReNIj9QQ: checks 
iOmwbUN7u4JFkV6VCA49aA: checks 
v5jnQ1gfh9nLla3kMXG7Yg: checks 
*** TURN *** [Jh 6h Td] [8c]
RubYqfvGrz2z+5ReNIj9QQ: bets $0.50
iOmwbUN7u4JFkV6VCA49aA: calls $0.50
v5jnQ1gfh9nLla3kMXG7Yg: calls $0.50
*** RIVER *** [Jh 6h Td 8c] [3h]
RubYqfvGrz2z+5ReNIj9QQ: checks 
iOmwbUN7u4JFkV6VCA49aA: checks 
v5jnQ1gfh9nLla3kMXG7Yg: bets $7.25 and is all-in
RubYqfvGrz2z+5ReNIj9QQ: folds 
iOmwbUN7u4JFkV6VCA49aA: calls $7.25
*** SHOW DOWN ***
v5jnQ1gfh9nLla3kMXG7Yg: shows [2h Qh] (a flush, Queen high)
iOmwbUN7u4JFkV6VCA49aA: shows [7d 9c] (a straight, Seven to Jack)
v5jnQ1gfh9nLla3kMXG7Yg collected $15.95 from pot
*** SUMMARY ***
Total pot $16.75 | Rake $0.80 
Board [Jh 6h Td 8c 3h]
Seat 1: 7cv+9Zc9HIQHNvYsMfV3uA (button) folded before Flop (didn't bet)
Seat 4: RubYqfvGrz2z+5ReNIj9QQ (small blind) folded on the River
Seat 5: iOmwbUN7u4JFkV6VCA49aA (big blind) showed [7d 9c] and lost with a straight, Seven to Jack
Seat 6: 9gmYYQesalMrUjaF7nKfrQ folded before Flop (didn't bet)
Seat 7: tYsOBqdU1+x+yFI7zHO7hQ folded before Flop (didn't bet)
Seat 8: v5jnQ1gfh9nLla3kMXG7Yg showed [2h Qh] and won ($15.95) with a flush, Queen high
Seat 9: CmngQmkKTp8tkl6GMRTl6w folded before Flop (didn't bet)




PokerStars Game #59941708660:  Hold'em No Limit ($0.10/$0.25) - 2009/07/01 1:43:40 ET
Table 'r562aMIMs5kgo28FEU6lkA' 9-max Seat #2 is the button
Seat 1: H5Se03ZqSX7tbULXur2MAg ($17.55 in chips) 
Seat 2: N8muFAHrFHW6elSMGuyVLQ ($25.35 in chips) 
Seat 3: xoBFd/5k+L/pFn9VW1VyWg ($10.85 in chips) 
Seat 4: V6p0jQ/RhUsqpHLmXvEX4Q ($17.25 in chips) 
Seat 7: Bb42QRQMhg5/Y0vHP8/2Xw ($25 in chips) 
Seat 8: B6xHiX1SJkS0CUNCKDVwuQ ($19.95 in chips) 
Seat 9: yyG4svzOpC1A+sUP/scg6w ($7.50 in chips) 
xoBFd/5k+L/pFn9VW1VyWg: posts small blind $0.10
V6p0jQ/RhUsqpHLmXvEX4Q: posts big blind $0.25
RCqMONFrSPSArZh2Jsar/w: sits out 
*** HOLE CARDS ***
Bb42QRQMhg5/Y0vHP8/2Xw: folds 
B6xHiX1SJkS0CUNCKDVwuQ: raises $0.50 to $0.75
yyG4svzOpC1A+sUP/scg6w: folds 
H5Se03ZqSX7tbULXur2MAg: folds 
N8muFAHrFHW6elSMGuyVLQ: folds 
xoBFd/5k+L/pFn9VW1VyWg: calls $0.65
V6p0jQ/RhUsqpHLmXvEX4Q: folds 
*** FLOP *** [Kh Qh 8c]
xoBFd/5k+L/pFn9VW1VyWg: checks 
B6xHiX1SJkS0CUNCKDVwuQ: bets $0.50
xoBFd/5k+L/pFn9VW1VyWg: folds 
Uncalled bet ($0.50) returned to B6xHiX1SJkS0CUNCKDVwuQ
B6xHiX1SJkS0CUNCKDVwuQ collected $1.70 from pot
B6xHiX1SJkS0CUNCKDVwuQ: doesn't show hand 
*** SUMMARY ***
Total pot $1.75 | Rake $0.05 
Board [Kh Qh 8c]
Seat 1: H5Se03ZqSX7tbULXur2MAg folded before Flop (didn't bet)
Seat 2: N8muFAHrFHW6elSMGuyVLQ (button) folded before Flop (didn't bet)
Seat 3: xoBFd/5k+L/pFn9VW1VyWg (small blind) folded on the Flop
Seat 4: V6p0jQ/RhUsqpHLmXvEX4Q (big blind) folded before Flop
Seat 7: Bb42QRQMhg5/Y0vHP8/2Xw folded before Flop (didn't bet)
Seat 8: B6xHiX1SJkS0CUNCKDVwuQ collected ($1.70)
Seat 9: yyG4svzOpC1A+sUP/scg6w folded before Flop (didn't bet)




PokerStars Game #59941708654:  Hold'em No Limit ($0.10/$0.25) - 2009/07/01 1:43:40 ET
Table 'P2yJ+jwfNsBdF12fLKA6DQ' 9-max Seat #6 is the button
Seat 2: uQwmfH5LEVA5eyghJdyPUg ($11.40 in chips) 
Seat 4: 6NLAWFPZZfqlVkY8n9RULA ($14 in chips) 
Seat 5: B7VAFAMs/PYlYABlV+EkSA ($17 in chips) 
Seat 6: mUoFJKqCzIUABvOFbiINlQ ($12.55 in chips) 
Seat 7: yQc5nLaNmByxI15Jegu61w ($9.05 in chips) 
Seat 8: LMd3gq2uNfbWTfXTnSeQRw ($10.15 in chips) 
Seat 9: dN5zq7QdZCUe7NZFM6cECg ($18.75 in chips) 
yQc5nLaNmByxI15Jegu61w: posts small blind $0.10
LMd3gq2uNfbWTfXTnSeQRw: posts big blind $0.25
8EbrQ/EvFWt2cr0GaU82gQ: sits out 
*** HOLE CARDS ***
mUoFJKqCzIUABvOFbiINlQ said, "wow u got lucky"
dN5zq7QdZCUe7NZFM6cECg: folds 
uQwmfH5LEVA5eyghJdyPUg: folds 
6NLAWFPZZfqlVkY8n9RULA: folds 
B7VAFAMs/PYlYABlV+EkSA: calls $0.25
mUoFJKqCzIUABvOFbiINlQ: calls $0.25
yQc5nLaNmByxI15Jegu61w: calls $0.15
LMd3gq2uNfbWTfXTnSeQRw: checks 
*** FLOP *** [7h 7s Td]
yQc5nLaNmByxI15Jegu61w: bets $0.50
LMd3gq2uNfbWTfXTnSeQRw: calls $0.50
yQc5nLaNmByxI15Jegu61w said, ""
B7VAFAMs/PYlYABlV+EkSA: raises $1.50 to $2
mUoFJKqCzIUABvOFbiINlQ: folds 
yQc5nLaNmByxI15Jegu61w: raises $6.80 to $8.80 and is all-in
LMd3gq2uNfbWTfXTnSeQRw: folds 
B7VAFAMs/PYlYABlV+EkSA: calls $6.80
*** TURN *** [7h 7s Td] [Tc]
*** RIVER *** [7h 7s Td Tc] [3s]
*** SHOW DOWN ***
yQc5nLaNmByxI15Jegu61w: shows [7c 9d] (a full house, Sevens full of Tens)
mUoFJKqCzIUABvOFbiINlQ said, "y should i always dominate people"
B7VAFAMs/PYlYABlV+EkSA: mucks hand 
mUoFJKqCzIUABvOFbiINlQ said, "and they hit miracles"
yQc5nLaNmByxI15Jegu61w collected $18.15 from pot
*** SUMMARY ***
Total pot $19.10 | Rake $0.95 
Board [7h 7s Td Tc 3s]
Seat 2: uQwmfH5LEVA5eyghJdyPUg folded before Flop (didn't bet)
Seat 4: 6NLAWFPZZfqlVkY8n9RULA folded before Flop (didn't bet)
Seat 5: B7VAFAMs/PYlYABlV+EkSA mucked
Seat 6: mUoFJKqCzIUABvOFbiINlQ (button) folded on the Flop
Seat 7: yQc5nLaNmByxI15Jegu61w (small blind) showed [7c 9d] and won ($18.15) with a full house, Sevens full of Tens
Seat 8: LMd3gq2uNfbWTfXTnSeQRw (big blind) folded on the Flop
Seat 9: dN5zq7QdZCUe7NZFM6cECg folded before Flop (didn't bet)




PokerStars Game #59941709160:  Hold'em No Limit ($0.10/$0.25) - 2009/07/01 1:43:41 ET
Table 'Ez9TB43XM4QgMDQkIW9DYw' 9-max Seat #9 is the button
Seat 1: ShCS62CJp4MKfKLKvGKQbA ($4.80 in chips) 
Seat 2: PFNLAvMkr8qKc7xCiH0wTA ($14.85 in chips) 
Seat 5: qpG9m8I+cPw8VhB0mnGjYw ($33.15 in chips) 
Seat 6: 76o85YBHJ9veRYp2LPuluQ ($23.50 in chips) 
Seat 7: Bb42QRQMhg5/Y0vHP8/2Xw ($58.45 in chips) 
Seat 8: +2kMBNpY4nF1qNCRd8SJLA ($28.75 in chips) 
Seat 9: QEbIGci+itdw+re8RM5fZA ($25 in chips) 
ShCS62CJp4MKfKLKvGKQbA: posts small blind $0.10
PFNLAvMkr8qKc7xCiH0wTA: posts big blind $0.25
PdIasPkzm2sqZnN41ZRXOg: sits out 
ubsjZomMWSV0hAiBLa7K1A: sits out 
*** HOLE CARDS ***
qpG9m8I+cPw8VhB0mnGjYw: folds 
76o85YBHJ9veRYp2LPuluQ: calls $0.25
Bb42QRQMhg5/Y0vHP8/2Xw: folds 
+2kMBNpY4nF1qNCRd8SJLA: folds 
QEbIGci+itdw+re8RM5fZA: raises $0.75 to $1
ShCS62CJp4MKfKLKvGKQbA: calls $0.90
PFNLAvMkr8qKc7xCiH0wTA: raises $13.85 to $14.85 and is all-in
76o85YBHJ9veRYp2LPuluQ: folds 
QEbIGci+itdw+re8RM5fZA: folds 
ShCS62CJp4MKfKLKvGKQbA: folds 
Uncalled bet ($13.85) returned to PFNLAvMkr8qKc7xCiH0wTA
PFNLAvMkr8qKc7xCiH0wTA collected $3.25 from pot
PFNLAvMkr8qKc7xCiH0wTA: doesn't show hand 
*** SUMMARY ***
Total pot $3.25 | Rake $0 
Seat 1: ShCS62CJp4MKfKLKvGKQbA (small blind) folded before Flop
Seat 2: PFNLAvMkr8qKc7xCiH0wTA (big blind) collected ($3.25)
Seat 5: qpG9m8I+cPw8VhB0mnGjYw folded before Flop (didn't bet)
Seat 6: 76o85YBHJ9veRYp2LPuluQ folded before Flop
Seat 7: Bb42QRQMhg5/Y0vHP8/2Xw folded before Flop (didn't bet)
Seat 8: +2kMBNpY4nF1qNCRd8SJLA folded before Flop (didn't bet)
Seat 9: QEbIGci+itdw+re8RM5fZA (button) folded before Flop




PokerStars Game #59941709416:  Hold'em No Limit ($0.10/$0.25) - 2009/07/01 1:43:41 ET
Table '6aL2C8IFwHHr6SG6RgXaow' 9-max Seat #7 is the button
Seat 3: aCVg6cCxQcqClhB9nq/p1w ($12.90 in chips) 
Seat 4: BT6Oal0iO4P6kDuT7HFQDw ($19.10 in chips) 
Seat 5: wre31HfyzQGpIvID1istxw ($21.20 in chips) 
Seat 6: gehe91e0IyVT0QU/XBkEyg ($27.10 in chips) 
Seat 7: QJxYAPJ6uPZZcpdN+RvWcQ ($25 in chips) 
Seat 8: rQhYIYXSyH/IivYM1dlV5A ($21.15 in chips) 
Seat 9: CgIo2ItZqi4o3ayVG6HanQ ($24.35 in chips) 
rQhYIYXSyH/IivYM1dlV5A: posts small blind $0.10
CgIo2ItZqi4o3ayVG6HanQ: posts big blind $0.25
bXpVeaSTPBFSPJmeXxO7nw: sits out 
*** HOLE CARDS ***
aCVg6cCxQcqClhB9nq/p1w: folds 
BT6Oal0iO4P6kDuT7HFQDw: folds 
wre31HfyzQGpIvID1istxw: folds 
gehe91e0IyVT0QU/XBkEyg: folds 
QJxYAPJ6uPZZcpdN+RvWcQ: folds 
rQhYIYXSyH/IivYM1dlV5A: calls $0.15
CgIo2ItZqi4o3ayVG6HanQ: checks 
*** FLOP *** [4s 3d Ac]
rQhYIYXSyH/IivYM1dlV5A: checks 
CgIo2ItZqi4o3ayVG6HanQ: checks 
*** TURN *** [4s 3d Ac] [8d]
rQhYIYXSyH/IivYM1dlV5A: checks 
CgIo2ItZqi4o3ayVG6HanQ: checks 
*** RIVER *** [4s 3d Ac 8d] [Jc]
rQhYIYXSyH/IivYM1dlV5A: checks 
CgIo2ItZqi4o3ayVG6HanQ: checks 
*** SHOW DOWN ***
rQhYIYXSyH/IivYM1dlV5A: shows [Th Kd] (high card Ace)
CgIo2ItZqi4o3ayVG6HanQ: mucks hand 
rQhYIYXSyH/IivYM1dlV5A collected $0.50 from pot
*** SUMMARY ***
Total pot $0.50 | Rake $0 
Board [4s 3d Ac 8d Jc]
Seat 3: aCVg6cCxQcqClhB9nq/p1w folded before Flop (didn't bet)
Seat 4: BT6Oal0iO4P6kDuT7HFQDw folded before Flop (didn't bet)
Seat 5: wre31HfyzQGpIvID1istxw folded before Flop (didn't bet)
Seat 6: gehe91e0IyVT0QU/XBkEyg folded before Flop (didn't bet)
Seat 7: QJxYAPJ6uPZZcpdN+RvWcQ (button) folded before Flop (didn't bet)
Seat 8: rQhYIYXSyH/IivYM1dlV5A (small blind) showed [Th Kd] and won ($0.50) with high card Ace
Seat 9: CgIo2ItZqi4o3ayVG6HanQ (big blind) mucked




PokerStars Game #59941709060:  Hold'em No Limit ($0.10/$0.25) - 2009/07/01 1:43:41 ET
Table 'oZuNsbNJuUyQLGKzQ/4JFg' 6-max Seat #2 is the button
Seat 1: vqWjZmdQu/Hxw96/IJTWdQ ($25 in chips) 
Seat 2: UA5OsKS3VPaxa7uC8La/kA ($34.50 in chips) 
Seat 3: 8ClCHtFXGNplITm+63KB+Q ($51.10 in chips) 
Seat 4: 9bpVv1/Qh9IYtXuCtl5VtQ ($25 in chips) 
Seat 5: oBUDUfeUyCbZBsjxHZgSiw ($26.80 in chips) 
Seat 6: fwg6dK1+r4jy/y+JqenYYQ ($14.15 in chips) 
8ClCHtFXGNplITm+63KB+Q: posts small blind $0.10
9bpVv1/Qh9IYtXuCtl5VtQ: posts big blind $0.25
*** HOLE CARDS ***
oBUDUfeUyCbZBsjxHZgSiw: folds 
fwg6dK1+r4jy/y+JqenYYQ: folds 
vqWjZmdQu/Hxw96/IJTWdQ: raises $0.75 to $1
UA5OsKS3VPaxa7uC8La/kA: folds 
8ClCHtFXGNplITm+63KB+Q: folds 
9bpVv1/Qh9IYtXuCtl5VtQ: folds 
Uncalled bet ($0.75) returned to vqWjZmdQu/Hxw96/IJTWdQ
vqWjZmdQu/Hxw96/IJTWdQ collected $0.60 from pot
vqWjZmdQu/Hxw96/IJTWdQ: doesn't show hand 
*** SUMMARY ***
Total pot $0.60 | Rake $0 
Seat 1: vqWjZmdQu/Hxw96/IJTWdQ collected ($0.60)
Seat 2: UA5OsKS3VPaxa7uC8La/kA (button) folded before Flop (didn't bet)
Seat 3: 8ClCHtFXGNplITm+63KB+Q (small blind) folded before Flop
Seat 4: 9bpVv1/Qh9IYtXuCtl5VtQ (big blind) folded before Flop
Seat 5: oBUDUfeUyCbZBsjxHZgSiw folded before Flop (didn't bet)
Seat 6: fwg6dK1+r4jy/y+JqenYYQ folded before Flop (didn't bet)




PokerStars Game #59941709064:  Hold'em No Limit ($0.10/$0.25) - 2009/07/01 1:43:41 ET
Table 'M8kYidAX3ib7pLKW7edFLw' 6-max Seat #4 is the button
Seat 1: jp34e617tIzV8tKIWmfAbA ($25.35 in chips) 
Seat 2: ypmjhffk/YHGc51wgVXUTw ($29.05 in chips) 
Seat 3: cezpHJ8FB07dj0xG+LhOvw ($27.10 in chips) 
Seat 4: Hsvkc0/G2VV78oVmWYXecw ($6.05 in chips) 
Seat 5: bDKopKTvPi3W+PEnYUX3tg ($44.60 in chips) 
Seat 6: NqFoyDgzLwu4dOmSRXnFBA ($19 in chips) 
bDKopKTvPi3W+PEnYUX3tg: posts small blind $0.10
NqFoyDgzLwu4dOmSRXnFBA: posts big blind $0.25
*** HOLE CARDS ***
jp34e617tIzV8tKIWmfAbA: folds 
ypmjhffk/YHGc51wgVXUTw: raises $0.50 to $0.75
cezpHJ8FB07dj0xG+LhOvw: folds 
Hsvkc0/G2VV78oVmWYXecw: folds 
bDKopKTvPi3W+PEnYUX3tg: folds 
NqFoyDgzLwu4dOmSRXnFBA: calls $0.50
*** FLOP *** [As Qd Kd]
NqFoyDgzLwu4dOmSRXnFBA: bets $0.50
ypmjhffk/YHGc51wgVXUTw: calls $0.50
*** TURN *** [As Qd Kd] [2h]
NqFoyDgzLwu4dOmSRXnFBA: bets $0.50
ypmjhffk/YHGc51wgVXUTw: calls $0.50
*** RIVER *** [As Qd Kd 2h] [2d]
NqFoyDgzLwu4dOmSRXnFBA: bets $2
ypmjhffk/YHGc51wgVXUTw: folds 
Uncalled bet ($2) returned to NqFoyDgzLwu4dOmSRXnFBA
NqFoyDgzLwu4dOmSRXnFBA collected $3.45 from pot
*** SUMMARY ***
Total pot $3.60 | Rake $0.15 
Board [As Qd Kd 2h 2d]
Seat 1: jp34e617tIzV8tKIWmfAbA folded before Flop (didn't bet)
Seat 2: ypmjhffk/YHGc51wgVXUTw folded on the River
Seat 3: cezpHJ8FB07dj0xG+LhOvw folded before Flop (didn't bet)
Seat 4: Hsvkc0/G2VV78oVmWYXecw (button) folded before Flop (didn't bet)
Seat 5: bDKopKTvPi3W+PEnYUX3tg (small blind) folded before Flop
Seat 6: NqFoyDgzLwu4dOmSRXnFBA (big blind) collected ($3.45)




PokerStars Game #59941709514:  Hold'em No Limit ($0.10/$0.25) - 2009/07/01 1:43:41 ET
Table 'biAgO3TKQBU8XcrVAoU5TA' 6-max Seat #4 is the button
Seat 1: jhDPlkir8wBYAddboBuF7Q ($17.05 in chips) 
Seat 2: GbCVUNssQ7mqsPWr7J4d3w ($5.30 in chips) 
Seat 3: mfrkWA3PTeYPkbO6hi98Aw ($32.40 in chips) 
Seat 4: Hsvkc0/G2VV78oVmWYXecw ($5 in chips) 
Seat 5: n6UPMnVR4v8LFP0rWP73Fg ($11.95 in chips) 
Seat 6: wMiE3yTbDJGOLOF9th7KPA ($8.10 in chips) 
n6UPMnVR4v8LFP0rWP73Fg: posts small blind $0.10
wMiE3yTbDJGOLOF9th7KPA: posts big blind $0.25
*** HOLE CARDS ***
jhDPlkir8wBYAddboBuF7Q: folds 
GbCVUNssQ7mqsPWr7J4d3w: folds 
mfrkWA3PTeYPkbO6hi98Aw: folds 
Hsvkc0/G2VV78oVmWYXecw: folds 
n6UPMnVR4v8LFP0rWP73Fg: folds 
Uncalled bet ($0.15) returned to wMiE3yTbDJGOLOF9th7KPA
wMiE3yTbDJGOLOF9th7KPA collected $0.20 from pot
*** SUMMARY ***
Total pot $0.20 | Rake $0 
Seat 1: jhDPlkir8wBYAddboBuF7Q folded before Flop (didn't bet)
Seat 2: GbCVUNssQ7mqsPWr7J4d3w folded before Flop (didn't bet)
Seat 3: mfrkWA3PTeYPkbO6hi98Aw folded before Flop (didn't bet)
Seat 4: Hsvkc0/G2VV78oVmWYXecw (button) folded before Flop (didn't bet)
Seat 5: n6UPMnVR4v8LFP0rWP73Fg (small blind) folded before Flop
Seat 6: wMiE3yTbDJGOLOF9th7KPA (big blind) collected ($0.20)




PokerStars Game #59941709512:  Hold'em No Limit ($0.10/$0.25) - 2009/07/01 1:43:41 ET
Table 'xmJKTGBeWCwutccj3YfupQ' 6-max Seat #6 is the button
Seat 1: sVbkVl4OznxBCfi66UB9vw ($27.65 in chips) 
Seat 2: AxhCSFlGEh+FAc+VUD31JQ ($18.45 in chips) 
Seat 3: T5wrp/d5jarm+SxNy8OQAg ($22.80 in chips) 
Seat 4: uWjhTVMpuIroxXcmD3Okug ($9.50 in chips) 
Seat 5: DE9hRlt14g+JdsRQ4wT7hg ($28.25 in chips) 
Seat 6: 9bpVv1/Qh9IYtXuCtl5VtQ ($24.65 in chips) 
sVbkVl4OznxBCfi66UB9vw: posts small blind $0.10
AxhCSFlGEh+FAc+VUD31JQ: posts big blind $0.25
*** HOLE CARDS ***
T5wrp/d5jarm+SxNy8OQAg: raises $0.50 to $0.75
uWjhTVMpuIroxXcmD3Okug: folds 
DE9hRlt14g+JdsRQ4wT7hg: folds 
9bpVv1/Qh9IYtXuCtl5VtQ: folds 
sVbkVl4OznxBCfi66UB9vw: calls $0.65
AxhCSFlGEh+FAc+VUD31JQ: calls $0.50
*** FLOP *** [9h Qd 4c]
sVbkVl4OznxBCfi66UB9vw: checks 
AxhCSFlGEh+FAc+VUD31JQ: checks 
T5wrp/d5jarm+SxNy8OQAg: bets $1.75
sVbkVl4OznxBCfi66UB9vw: folds 
AxhCSFlGEh+FAc+VUD31JQ: folds 
Uncalled bet ($1.75) returned to T5wrp/d5jarm+SxNy8OQAg
T5wrp/d5jarm+SxNy8OQAg collected $2.15 from pot
T5wrp/d5jarm+SxNy8OQAg: shows [Kd Qc] (a pair of Queens)
*** SUMMARY ***
Total pot $2.25 | Rake $0.10 
Board [9h Qd 4c]
Seat 1: sVbkVl4OznxBCfi66UB9vw (small blind) folded on the Flop
Seat 2: AxhCSFlGEh+FAc+VUD31JQ (big blind) folded on the Flop
Seat 3: T5wrp/d5jarm+SxNy8OQAg collected ($2.15)
Seat 4: uWjhTVMpuIroxXcmD3Okug folded before Flop (didn't bet)
Seat 5: DE9hRlt14g+JdsRQ4wT7hg folded before Flop (didn't bet)
Seat 6: 9bpVv1/Qh9IYtXuCtl5VtQ (button) folded before Flop (didn't bet)




PokerStars Game #59941709298:  Hold'em No Limit ($0.10/$0.25) - 2009/07/01 1:43:41 ET
Table 'ORSZkZqq+7Ja2PdeCFAytA' 9-max Seat #1 is the button
Seat 1: 3FkcXBaxKqxYVagfYUZlmw ($17.35 in chips) 
Seat 2: FzknuThd6oNi5WfR7ciTfA ($17.75 in chips) 
Seat 3: s9a4d23HFxaL70yUWQ0/tQ ($16.65 in chips) 
Seat 4: tbgfV2Egwn85xEt865GWQQ ($15.15 in chips) 
Seat 5: +lWbsq4dTcA70SX/+hnmpg ($3.40 in chips) 
Seat 6: gMF+EMhmwpnaM5TFQquf2A ($6 in chips) 
Seat 7: clJsV3v77RS07bDKY+705w ($5 in chips) 
Seat 8: npAYqa85pqnzfOK5ukX+BQ ($19.90 in chips) 
Seat 9: cMTFs4oCtNInkpDIecxT/w ($22.75 in chips) 
FzknuThd6oNi5WfR7ciTfA: posts small blind $0.10
s9a4d23HFxaL70yUWQ0/tQ: posts big blind $0.25
clJsV3v77RS07bDKY+705w: posts big blind $0.25
*** HOLE CARDS ***
tbgfV2Egwn85xEt865GWQQ: folds 
+lWbsq4dTcA70SX/+hnmpg: folds 
gMF+EMhmwpnaM5TFQquf2A: folds 
clJsV3v77RS07bDKY+705w: checks 
npAYqa85pqnzfOK5ukX+BQ: calls $0.25
cMTFs4oCtNInkpDIecxT/w: folds 
3FkcXBaxKqxYVagfYUZlmw: folds 
FzknuThd6oNi5WfR7ciTfA: calls $0.15
s9a4d23HFxaL70yUWQ0/tQ: checks 
*** FLOP *** [4h Th 8s]
FzknuThd6oNi5WfR7ciTfA: checks 
s9a4d23HFxaL70yUWQ0/tQ: checks 
clJsV3v77RS07bDKY+705w: checks 
npAYqa85pqnzfOK5ukX+BQ: checks 
*** TURN *** [4h Th 8s] [9c]
FzknuThd6oNi5WfR7ciTfA: bets $0.50
s9a4d23HFxaL70yUWQ0/tQ: raises $0.50 to $1
clJsV3v77RS07bDKY+705w: folds 
npAYqa85pqnzfOK5ukX+BQ: folds 
FzknuThd6oNi5WfR7ciTfA: calls $0.50
*** RIVER *** [4h Th 8s 9c] [Qd]
FzknuThd6oNi5WfR7ciTfA: bets $0.50
s9a4d23HFxaL70yUWQ0/tQ: raises $0.50 to $1
FzknuThd6oNi5WfR7ciTfA: calls $0.50
*** SHOW DOWN ***
s9a4d23HFxaL70yUWQ0/tQ: shows [9h Td] (two pair, Tens and Nines)
FzknuThd6oNi5WfR7ciTfA: mucks hand 
s9a4d23HFxaL70yUWQ0/tQ collected $4.80 from pot
*** SUMMARY ***
Total pot $5 | Rake $0.20 
Board [4h Th 8s 9c Qd]
Seat 1: 3FkcXBaxKqxYVagfYUZlmw (button) folded before Flop (didn't bet)
Seat 2: FzknuThd6oNi5WfR7ciTfA (small blind) mucked
Seat 3: s9a4d23HFxaL70yUWQ0/tQ (big blind) showed [9h Td] and won ($4.80) with two pair, Tens and Nines
Seat 4: tbgfV2Egwn85xEt865GWQQ folded before Flop (didn't bet)
Seat 5: +lWbsq4dTcA70SX/+hnmpg folded before Flop (didn't bet)
Seat 6: gMF+EMhmwpnaM5TFQquf2A folded before Flop (didn't bet)
Seat 7: clJsV3v77RS07bDKY+705w folded on the Turn
Seat 8: npAYqa85pqnzfOK5ukX+BQ folded on the Turn
Seat 9: cMTFs4oCtNInkpDIecxT/w folded before Flop (didn't bet)




PokerStars Game #59941709892:  Hold'em No Limit ($0.10/$0.25) - 2009/07/01 1:43:42 ET
Table 'a6FCGVBMPcT7J7BDN9q1zQ' 9-max Seat #2 is the button
Seat 2: M2QO2DxB5Wawg2h8HSpnYA ($10 in chips) 
Seat 3: tLcDklc2rBORNfixyRfVfw ($25.90 in chips) 
Seat 4: 8CoKLhwk8Ja6X+O9fxTEDg ($10.80 in chips) 
Seat 5: dtZ84flFEi4Q+SGrHMJRDQ ($27.05 in chips) 
Seat 6: dfNim92Z6XK1/h5SFW5vDg ($25 in chips) 
Seat 7: V0Yo5zRBVM8DYspLKafebg ($4.30 in chips) 
Seat 8: r6hsffOo1iKmaPYKwAZmFw ($70 in chips) 
Seat 9: wGigCmBR/9XWkPpvYos3aQ ($28.35 in chips) 
tLcDklc2rBORNfixyRfVfw: posts small blind $0.10
8CoKLhwk8Ja6X+O9fxTEDg: posts big blind $0.25
bXpVeaSTPBFSPJmeXxO7nw: sits out 
*** HOLE CARDS ***
dtZ84flFEi4Q+SGrHMJRDQ: folds 
dfNim92Z6XK1/h5SFW5vDg: folds 
V0Yo5zRBVM8DYspLKafebg: calls $0.25
r6hsffOo1iKmaPYKwAZmFw: raises $4.05 to $4.30
wGigCmBR/9XWkPpvYos3aQ: folds 
M2QO2DxB5Wawg2h8HSpnYA: calls $4.30
tLcDklc2rBORNfixyRfVfw: folds 
8CoKLhwk8Ja6X+O9fxTEDg: folds 
V0Yo5zRBVM8DYspLKafebg: folds 
*** FLOP *** [8c Kd 9s]
r6hsffOo1iKmaPYKwAZmFw: checks 
M2QO2DxB5Wawg2h8HSpnYA: bets $5.70 and is all-in
r6hsffOo1iKmaPYKwAZmFw: folds 
Uncalled bet ($5.70) returned to M2QO2DxB5Wawg2h8HSpnYA
M2QO2DxB5Wawg2h8HSpnYA collected $8.75 from pot
M2QO2DxB5Wawg2h8HSpnYA: doesn't show hand 
*** SUMMARY ***
Total pot $9.20 | Rake $0.45 
Board [8c Kd 9s]
Seat 2: M2QO2DxB5Wawg2h8HSpnYA (button) collected ($8.75)
Seat 3: tLcDklc2rBORNfixyRfVfw (small blind) folded before Flop
Seat 4: 8CoKLhwk8Ja6X+O9fxTEDg (big blind) folded before Flop
Seat 5: dtZ84flFEi4Q+SGrHMJRDQ folded before Flop (didn't bet)
Seat 6: dfNim92Z6XK1/h5SFW5vDg folded before Flop (didn't bet)
Seat 7: V0Yo5zRBVM8DYspLKafebg folded before Flop
Seat 8: r6hsffOo1iKmaPYKwAZmFw folded on the Flop
Seat 9: wGigCmBR/9XWkPpvYos3aQ folded before Flop (didn't bet)




PokerStars Game #59941710090:  Hold'em No Limit ($0.10/$0.25) - 2009/07/01 1:43:42 ET
Table 'QegsWX65l3n/K0A8XB78yg' 6-max Seat #1 is the button
Seat 1: p6adJRMXMBLr+xtQzqazIQ ($13.65 in chips) 
Seat 2: GC/9yVD59DUCX7hUI7gcLw ($50.65 in chips) 
Seat 3: iIgNoBh+3/Ix1/fLsg+HuA ($6 in chips) 
Seat 5: OMGl+YMGogf2JWIRfT2/Yg ($11.85 in chips) 
Seat 6: 5PWs02z65jSO5pr/M6wx/w ($2.75 in chips) 
GC/9yVD59DUCX7hUI7gcLw: posts small blind $0.10
iIgNoBh+3/Ix1/fLsg+HuA: posts big blind $0.25
epAUIB7h2FJXzUPRIvSkRA: sits out 
*** HOLE CARDS ***
OMGl+YMGogf2JWIRfT2/Yg: calls $0.25
5PWs02z65jSO5pr/M6wx/w: folds 
p6adJRMXMBLr+xtQzqazIQ: folds 
GC/9yVD59DUCX7hUI7gcLw: calls $0.15
iIgNoBh+3/Ix1/fLsg+HuA: checks 
*** FLOP *** [3c As 4s]
GC/9yVD59DUCX7hUI7gcLw: bets $0.75
iIgNoBh+3/Ix1/fLsg+HuA: folds 
OMGl+YMGogf2JWIRfT2/Yg: calls $0.75
*** TURN *** [3c As 4s] [3s]
GC/9yVD59DUCX7hUI7gcLw: bets $1.50
OMGl+YMGogf2JWIRfT2/Yg: raises $1.50 to $3
GC/9yVD59DUCX7hUI7gcLw: raises $12 to $15
OMGl+YMGogf2JWIRfT2/Yg: calls $7.85 and is all-in
Uncalled bet ($4.15) returned to GC/9yVD59DUCX7hUI7gcLw
*** RIVER *** [3c As 4s 3s] [8h]
*** SHOW DOWN ***
GC/9yVD59DUCX7hUI7gcLw: shows [3h Ac] (a full house, Threes full of Aces)
OMGl+YMGogf2JWIRfT2/Yg: shows [6s Qs] (a flush, Ace high)
GC/9yVD59DUCX7hUI7gcLw collected $22.80 from pot
*** SUMMARY ***
Total pot $23.95 | Rake $1.15 
Board [3c As 4s 3s 8h]
Seat 1: p6adJRMXMBLr+xtQzqazIQ (button) folded before Flop (didn't bet)
Seat 2: GC/9yVD59DUCX7hUI7gcLw (small blind) showed [3h Ac] and won ($22.80) with a full house, Threes full of Aces
Seat 3: iIgNoBh+3/Ix1/fLsg+HuA (big blind) folded on the Flop
Seat 5: OMGl+YMGogf2JWIRfT2/Yg showed [6s Qs] and lost with a flush, Ace high
Seat 6: 5PWs02z65jSO5pr/M6wx/w folded before Flop (didn't bet)




PokerStars Game #59941709564:  Hold'em No Limit ($0.10/$0.25) - 2009/07/01 1:43:42 ET
Table 'IuqVbFI+pwnJjvwBCGSGAw' 6-max Seat #5 is the button
Seat 1: LyDHtw3/yniNHW+DvLXbog ($26.80 in chips) 
Seat 3: QiL+lEgEWwy21jk/ltaRLg ($21.75 in chips) 
Seat 4: DE9hRlt14g+JdsRQ4wT7hg ($25 in chips) 
Seat 5: if4dh6jhJXeN3/qd3qCp9g ($25.35 in chips) 
xC0kaiDYM6YTlgODL83O5A will be allowed to play after the button
LyDHtw3/yniNHW+DvLXbog: posts small blind $0.10
wsP46AGpqDjHZQmlRHKa9g: is sitting out 
QiL+lEgEWwy21jk/ltaRLg: posts big blind $0.25
*** HOLE CARDS ***
DE9hRlt14g+JdsRQ4wT7hg: raises $0.75 to $1
if4dh6jhJXeN3/qd3qCp9g: folds 
LyDHtw3/yniNHW+DvLXbog: folds 
QiL+lEgEWwy21jk/ltaRLg: folds 
Uncalled bet ($0.75) returned to DE9hRlt14g+JdsRQ4wT7hg
DE9hRlt14g+JdsRQ4wT7hg collected $0.60 from pot
DE9hRlt14g+JdsRQ4wT7hg: doesn't show hand 
*** SUMMARY ***
Total pot $0.60 | Rake $0 
Seat 1: LyDHtw3/yniNHW+DvLXbog (small blind) folded before Flop
Seat 3: QiL+lEgEWwy21jk/ltaRLg (big blind) folded before Flop
Seat 4: DE9hRlt14g+JdsRQ4wT7hg collected ($0.60)
Seat 5: if4dh6jhJXeN3/qd3qCp9g (button) folded before Flop (didn't bet)




PokerStars Game #59941710048:  Hold'em No Limit ($0.10/$0.25) - 2009/07/01 1:43:42 ET
Table 'l57rayEpPtZotP9nqgSWBg' 6-max Seat #4 is the button
Seat 1: DihMHaz4WNETH1bPDe13kA ($56.10 in chips) 
Seat 2: p6adJRMXMBLr+xtQzqazIQ ($15.55 in chips) 
Seat 3: L3/N/gliETan8N5Gim5h4Q ($25 in chips) 
Seat 4: OqkdGXy1SCzuN5Q0wNlFSg ($22.60 in chips) 
Seat 5: WKJHaZPUgrpTVyLOEjLYmg ($11.35 in chips) 
Seat 6: IGRfskE1v9H9Bn+fz8AgNQ ($17.05 in chips) 
WKJHaZPUgrpTVyLOEjLYmg: posts small blind $0.10
IGRfskE1v9H9Bn+fz8AgNQ: posts big blind $0.25
*** HOLE CARDS ***
DihMHaz4WNETH1bPDe13kA: folds 
p6adJRMXMBLr+xtQzqazIQ: folds 
L3/N/gliETan8N5Gim5h4Q: raises $0.50 to $0.75
OqkdGXy1SCzuN5Q0wNlFSg: folds 
WKJHaZPUgrpTVyLOEjLYmg: folds 
IGRfskE1v9H9Bn+fz8AgNQ: raises $3 to $3.75
L3/N/gliETan8N5Gim5h4Q: folds 
Uncalled bet ($3) returned to IGRfskE1v9H9Bn+fz8AgNQ
IGRfskE1v9H9Bn+fz8AgNQ collected $1.60 from pot
IGRfskE1v9H9Bn+fz8AgNQ: doesn't show hand 
*** SUMMARY ***
Total pot $1.60 | Rake $0 
Seat 1: DihMHaz4WNETH1bPDe13kA folded before Flop (didn't bet)
Seat 2: p6adJRMXMBLr+xtQzqazIQ folded before Flop (didn't bet)
Seat 3: L3/N/gliETan8N5Gim5h4Q folded before Flop
Seat 4: OqkdGXy1SCzuN5Q0wNlFSg (button) folded before Flop (didn't bet)
Seat 5: WKJHaZPUgrpTVyLOEjLYmg (small blind) folded before Flop
Seat 6: IGRfskE1v9H9Bn+fz8AgNQ (big blind) collected ($1.60)




PokerStars Game #59941709966:  Hold'em No Limit ($0.10/$0.25) - 2009/07/01 1:43:42 ET
Table 'g6ryG70feTw9nNm+XJLuXw' 6-max Seat #3 is the button
Seat 1: v+QfkGiuj9bgtuNoVnDO8w ($35.60 in chips) 
Seat 2: SxIIgwXYLkwd6m3wLyPTCw ($33.10 in chips) 
Seat 3: cezpHJ8FB07dj0xG+LhOvw ($25 in chips) 
Seat 4: GC/9yVD59DUCX7hUI7gcLw ($44.45 in chips) 
Seat 5: EE16Ua5b1HSsYej5zeXOlA ($25.35 in chips) 
Seat 6: tSR4329m40dZsN7YOpI9Kw ($36.60 in chips) 
GC/9yVD59DUCX7hUI7gcLw: posts small blind $0.10
EE16Ua5b1HSsYej5zeXOlA: posts big blind $0.25
*** HOLE CARDS ***
tSR4329m40dZsN7YOpI9Kw: folds 
v+QfkGiuj9bgtuNoVnDO8w: folds 
SxIIgwXYLkwd6m3wLyPTCw: folds 
cezpHJ8FB07dj0xG+LhOvw: folds 
GC/9yVD59DUCX7hUI7gcLw: folds 
Uncalled bet ($0.15) returned to EE16Ua5b1HSsYej5zeXOlA
EE16Ua5b1HSsYej5zeXOlA collected $0.20 from pot
EE16Ua5b1HSsYej5zeXOlA: doesn't show hand 
*** SUMMARY ***
Total pot $0.20 | Rake $0 
Seat 1: v+QfkGiuj9bgtuNoVnDO8w folded before Flop (didn't bet)
Seat 2: SxIIgwXYLkwd6m3wLyPTCw folded before Flop (didn't bet)
Seat 3: cezpHJ8FB07dj0xG+LhOvw (button) folded before Flop (didn't bet)
Seat 4: GC/9yVD59DUCX7hUI7gcLw (small blind) folded before Flop
Seat 5: EE16Ua5b1HSsYej5zeXOlA (big blind) collected ($0.20)
Seat 6: tSR4329m40dZsN7YOpI9Kw folded before Flop (didn't bet)




PokerStars Game #59941709788:  Hold'em No Limit ($0.10/$0.25) - 2009/07/01 1:43:42 ET
Table 'AHkg4ChqzcMauBx6Qvz8Nw' 6-max Seat #1 is the button
Seat 1: +RDf7SmUjY2kK0PzdBEYqg ($5.50 in chips) 
Seat 2: Vi0JMrTI2BGrPL7UIulJtA ($5.65 in chips) 
Seat 3: 9dToMv2GJLfi00HcpfMnIw ($24.65 in chips) 
Seat 4: Eznneya0vB6S+eXJdVleHA ($20.35 in chips) 
Seat 5: Bada343Si4xKu3fNXY99AA ($4.20 in chips) 
Seat 6: Hsvkc0/G2VV78oVmWYXecw ($5 in chips) 
Vi0JMrTI2BGrPL7UIulJtA: posts small blind $0.10
9dToMv2GJLfi00HcpfMnIw: posts big blind $0.25
*** HOLE CARDS ***
Eznneya0vB6S+eXJdVleHA: raises $0.25 to $0.50
Bada343Si4xKu3fNXY99AA: folds 
Hsvkc0/G2VV78oVmWYXecw: folds 
+RDf7SmUjY2kK0PzdBEYqg: folds 
Vi0JMrTI2BGrPL7UIulJtA: folds 
9dToMv2GJLfi00HcpfMnIw: folds 
Uncalled bet ($0.25) returned to Eznneya0vB6S+eXJdVleHA
Eznneya0vB6S+eXJdVleHA collected $0.60 from pot
Eznneya0vB6S+eXJdVleHA: shows [As Ac] (a pair of Aces)
*** SUMMARY ***
Total pot $0.60 | Rake $0 
Seat 1: +RDf7SmUjY2kK0PzdBEYqg (button) folded before Flop (didn't bet)
Seat 2: Vi0JMrTI2BGrPL7UIulJtA (small blind) folded before Flop
Seat 3: 9dToMv2GJLfi00HcpfMnIw (big blind) folded before Flop
Seat 4: Eznneya0vB6S+eXJdVleHA collected ($0.60)
Seat 5: Bada343Si4xKu3fNXY99AA folded before Flop (didn't bet)
Seat 6: Hsvkc0/G2VV78oVmWYXecw folded before Flop (didn't bet)




PokerStars Game #59941710002:  Hold'em No Limit ($0.10/$0.25) - 2009/07/01 1:43:42 ET
Table 'vFZR6Kf2Th5xBXT9brGW6A' 6-max Seat #3 is the button
Seat 1: Q3EMN7b0ie81AFWkDrhCjw ($22.20 in chips) 
Seat 2: QiL+lEgEWwy21jk/ltaRLg ($22.40 in chips) 
Seat 3: SH1WjKVUjPiyXySjWSdazw ($21.35 in chips) 
Seat 4: 79ID/ub1Pt/mDpCprVmOoA ($35.30 in chips) 
Seat 5: SS/yfeArhULzIcOPe8MdPg ($26.65 in chips) 
Seat 6: 4x9jCqgSw4272dnaIqnanw ($5 in chips) 
79ID/ub1Pt/mDpCprVmOoA: posts small blind $0.10
SS/yfeArhULzIcOPe8MdPg: posts big blind $0.25
*** HOLE CARDS ***
4x9jCqgSw4272dnaIqnanw: folds 
Q3EMN7b0ie81AFWkDrhCjw: raises $0.50 to $0.75
QiL+lEgEWwy21jk/ltaRLg: folds 
SH1WjKVUjPiyXySjWSdazw: calls $0.75
79ID/ub1Pt/mDpCprVmOoA: folds 
SS/yfeArhULzIcOPe8MdPg: folds 
*** FLOP *** [Qd Ad Jh]
Q3EMN7b0ie81AFWkDrhCjw: bets $1.50
SH1WjKVUjPiyXySjWSdazw: calls $1.50
*** TURN *** [Qd Ad Jh] [Kc]
Q3EMN7b0ie81AFWkDrhCjw: checks 
SH1WjKVUjPiyXySjWSdazw: bets $0.75
Q3EMN7b0ie81AFWkDrhCjw: calls $0.75
*** RIVER *** [Qd Ad Jh Kc] [6h]
Q3EMN7b0ie81AFWkDrhCjw: checks 
SH1WjKVUjPiyXySjWSdazw: checks 
*** SHOW DOWN ***
Q3EMN7b0ie81AFWkDrhCjw: shows [7s Ah] (a pair of Aces)
SH1WjKVUjPiyXySjWSdazw: shows [Ac 5s] (a pair of Aces)
Q3EMN7b0ie81AFWkDrhCjw collected $3.05 from pot
SH1WjKVUjPiyXySjWSdazw collected $3 from pot
*** SUMMARY ***
Total pot $6.35 | Rake $0.30 
Board [Qd Ad Jh Kc 6h]
Seat 1: Q3EMN7b0ie81AFWkDrhCjw showed [7s Ah] and won ($3.05) with a pair of Aces
Seat 2: QiL+lEgEWwy21jk/ltaRLg folded before Flop (didn't bet)
Seat 3: SH1WjKVUjPiyXySjWSdazw (button) showed [Ac 5s] and won ($3) with a pair of Aces
Seat 4: 79ID/ub1Pt/mDpCprVmOoA (small blind) folded before Flop
Seat 5: SS/yfeArhULzIcOPe8MdPg (big blind) folded before Flop
Seat 6: 4x9jCqgSw4272dnaIqnanw folded before Flop (didn't bet)




PokerStars Game #59941710586:  Hold'em No Limit ($0.10/$0.25) - 2009/07/01 1:43:43 ET
Table '9o8Yb3JpUqurD4pNVmOikQ' 6-max Seat #4 is the button
Seat 1: SFmT9ZsVopnukjvAzrxTRg ($27.55 in chips) 
Seat 2: /gJNBeCkWL4o85/jvlZ4BA ($25 in chips) 
Seat 3: JgRqo1/2phbf7pab7N3BIQ ($22.60 in chips) 
Seat 4: j5NZbEJHsERuXjPHWqc1Nw ($11.90 in chips) 
Seat 5: QqiZLFrN8iOUT/GHw7ztOA ($24.25 in chips) 
Seat 6: LyDHtw3/yniNHW+DvLXbog ($26.05 in chips) 
QqiZLFrN8iOUT/GHw7ztOA: posts small blind $0.10
LyDHtw3/yniNHW+DvLXbog: posts big blind $0.25
*** HOLE CARDS ***
SFmT9ZsVopnukjvAzrxTRg: folds 
/gJNBeCkWL4o85/jvlZ4BA: folds 
JgRqo1/2phbf7pab7N3BIQ: calls $0.25
j5NZbEJHsERuXjPHWqc1Nw: raises $0.75 to $1
QqiZLFrN8iOUT/GHw7ztOA: folds 
LyDHtw3/yniNHW+DvLXbog: folds 
JgRqo1/2phbf7pab7N3BIQ: calls $0.75
*** FLOP *** [5c 4d Qs]
JgRqo1/2phbf7pab7N3BIQ: checks 
j5NZbEJHsERuXjPHWqc1Nw: checks 
*** TURN *** [5c 4d Qs] [9c]
JgRqo1/2phbf7pab7N3BIQ: bets $0.50
j5NZbEJHsERuXjPHWqc1Nw: folds 
Uncalled bet ($0.50) returned to JgRqo1/2phbf7pab7N3BIQ
JgRqo1/2phbf7pab7N3BIQ collected $2.25 from pot
*** SUMMARY ***
Total pot $2.35 | Rake $0.10 
Board [5c 4d Qs 9c]
Seat 1: SFmT9ZsVopnukjvAzrxTRg folded before Flop (didn't bet)
Seat 2: /gJNBeCkWL4o85/jvlZ4BA folded before Flop (didn't bet)
Seat 3: JgRqo1/2phbf7pab7N3BIQ collected ($2.25)
Seat 4: j5NZbEJHsERuXjPHWqc1Nw (button) folded on the Turn
Seat 5: QqiZLFrN8iOUT/GHw7ztOA (small blind) folded before Flop
Seat 6: LyDHtw3/yniNHW+DvLXbog (big blind) folded before Flop




PokerStars Game #59941710462:  Hold'em No Limit ($0.10/$0.25) - 2009/07/01 1:43:43 ET
Table '+VTTYgQLH1awDHk+IAxqGg' 9-max Seat #9 is the button
Seat 1: arxNSjreDRGFg13EAM2F1w ($27 in chips) 
Seat 2: 2wcFsZsqEP5w1StUTVzJCg ($5.15 in chips) 
Seat 3: AiXn/9o1EwOPZUHujnh/bA ($12.90 in chips) 
Seat 4: gE5rN2TDY1aXcZn/TOPeZw ($10.65 in chips) 
Seat 5: sD+TKtt36XiiN6jqHiLwDA ($25.15 in chips) 
Seat 7: ljemhp25Zg+nlA9DLCIiUw ($25 in chips) 
Seat 8: 10vzP4r6ldwGLbYHKd9www ($16.60 in chips) 
Seat 9: S7Ki0P+0AIGPuIfGJjW0gg ($61 in chips) 
arxNSjreDRGFg13EAM2F1w: posts small blind $0.10
2wcFsZsqEP5w1StUTVzJCg: posts big blind $0.25
*** HOLE CARDS ***
AiXn/9o1EwOPZUHujnh/bA: calls $0.25
gE5rN2TDY1aXcZn/TOPeZw: folds 
sD+TKtt36XiiN6jqHiLwDA: folds 
ljemhp25Zg+nlA9DLCIiUw: folds 
10vzP4r6ldwGLbYHKd9www: calls $0.25
S7Ki0P+0AIGPuIfGJjW0gg: folds 
arxNSjreDRGFg13EAM2F1w: folds 
2wcFsZsqEP5w1StUTVzJCg: checks 
*** FLOP *** [5d Ad 3c]
2wcFsZsqEP5w1StUTVzJCg: checks 
AiXn/9o1EwOPZUHujnh/bA: bets $0.50
10vzP4r6ldwGLbYHKd9www: calls $0.50
2wcFsZsqEP5w1StUTVzJCg: folds 
*** TURN *** [5d Ad 3c] [9d]
AiXn/9o1EwOPZUHujnh/bA: checks 
10vzP4r6ldwGLbYHKd9www: bets $1
AiXn/9o1EwOPZUHujnh/bA: folds 
Uncalled bet ($1) returned to 10vzP4r6ldwGLbYHKd9www
10vzP4r6ldwGLbYHKd9www collected $1.80 from pot
*** SUMMARY ***
Total pot $1.85 | Rake $0.05 
Board [5d Ad 3c 9d]
Seat 1: arxNSjreDRGFg13EAM2F1w (small blind) folded before Flop
Seat 2: 2wcFsZsqEP5w1StUTVzJCg (big blind) folded on the Flop
Seat 3: AiXn/9o1EwOPZUHujnh/bA folded on the Turn
Seat 4: gE5rN2TDY1aXcZn/TOPeZw folded before Flop (didn't bet)
Seat 5: sD+TKtt36XiiN6jqHiLwDA folded before Flop (didn't bet)
Seat 7: ljemhp25Zg+nlA9DLCIiUw folded before Flop (didn't bet)
Seat 8: 10vzP4r6ldwGLbYHKd9www collected ($1.80)
Seat 9: S7Ki0P+0AIGPuIfGJjW0gg (button) folded before Flop (didn't bet)




PokerStars Game #59941710554:  Hold'em No Limit ($0.10/$0.25) - 2009/07/01 1:43:43 ET
Table 'IUwZ/e0bDHZPgsIWx0RnNg' 6-max Seat #2 is the button
Seat 1: V66QiVCQPofyl3a+dpPHQQ ($6.30 in chips) 
Seat 2: mvFHK3pE7tCxJEqLjKC70Q ($54.30 in chips) 
Seat 3: dOX4wnYV2sEqvDbF+8KSCw ($25.10 in chips) 
Seat 4: OIjOiBfQstWrK/RuXx7zcw ($5.70 in chips) 
Seat 6: NhUN/JpAprdJeamFBgJH1w ($39.25 in chips) 
dOX4wnYV2sEqvDbF+8KSCw: posts small blind $0.10
OIjOiBfQstWrK/RuXx7zcw: posts big blind $0.25
9bpVv1/Qh9IYtXuCtl5VtQ: sits out 
*** HOLE CARDS ***
NhUN/JpAprdJeamFBgJH1w: folds 
V66QiVCQPofyl3a+dpPHQQ: calls $0.25
mvFHK3pE7tCxJEqLjKC70Q: calls $0.25
dOX4wnYV2sEqvDbF+8KSCw: calls $0.15
OIjOiBfQstWrK/RuXx7zcw: checks 
*** FLOP *** [6c Td Ah]
dOX4wnYV2sEqvDbF+8KSCw: checks 
OIjOiBfQstWrK/RuXx7zcw: bets $0.50
V66QiVCQPofyl3a+dpPHQQ: folds 
mvFHK3pE7tCxJEqLjKC70Q: calls $0.50
dOX4wnYV2sEqvDbF+8KSCw: calls $0.50
*** TURN *** [6c Td Ah] [5d]
dOX4wnYV2sEqvDbF+8KSCw: checks 
OIjOiBfQstWrK/RuXx7zcw: checks 
mvFHK3pE7tCxJEqLjKC70Q: bets $2
dOX4wnYV2sEqvDbF+8KSCw: folds 
OIjOiBfQstWrK/RuXx7zcw: folds 
Uncalled bet ($2) returned to mvFHK3pE7tCxJEqLjKC70Q
mvFHK3pE7tCxJEqLjKC70Q collected $2.40 from pot
mvFHK3pE7tCxJEqLjKC70Q: doesn't show hand 
*** SUMMARY ***
Total pot $2.50 | Rake $0.10 
Board [6c Td Ah 5d]
Seat 1: V66QiVCQPofyl3a+dpPHQQ folded on the Flop
Seat 2: mvFHK3pE7tCxJEqLjKC70Q (button) collected ($2.40)
Seat 3: dOX4wnYV2sEqvDbF+8KSCw (small blind) folded on the Turn
Seat 4: OIjOiBfQstWrK/RuXx7zcw (big blind) folded on the Turn
Seat 6: NhUN/JpAprdJeamFBgJH1w folded before Flop (didn't bet)




PokerStars Game #59941711496:  Hold'em No Limit ($0.10/$0.25) - 2009/07/01 1:43:45 ET
Table 'SbSV5tlgLp0+/Z+13PW3Hg' 9-max Seat #6 is the button
Seat 1: x+W5+3qsdY4Iszf0hoH+Aw ($14.85 in chips) 
Seat 3: CT7Xj/V/O5rBlhtt+RZeFQ ($25.35 in chips) 
Seat 4: puj3K/wrNjEj86ZL/MyfLA ($10.85 in chips) 
Seat 5: aNpwfA31EREwO+ar4XzBCw ($25 in chips) 
Seat 6: pN3IHvAKm2fz+sTRARTcrg ($25.40 in chips) 
Seat 7: ruosoLPCzPyA3nfXoPVY3Q ($1.20 in chips) 
Seat 8: qBdqLaJhO+1itcMk70bsfA ($8.90 in chips) 
Seat 9: X78b5v/uhqeXXoAijbw/yg ($25 in chips) 
ruosoLPCzPyA3nfXoPVY3Q: posts small blind $0.10
qBdqLaJhO+1itcMk70bsfA: posts big blind $0.25
*** HOLE CARDS ***
X78b5v/uhqeXXoAijbw/yg: calls $0.25
x+W5+3qsdY4Iszf0hoH+Aw: calls $0.25
CT7Xj/V/O5rBlhtt+RZeFQ: folds 
puj3K/wrNjEj86ZL/MyfLA: raises $0.50 to $0.75
aNpwfA31EREwO+ar4XzBCw: folds 
pN3IHvAKm2fz+sTRARTcrg: folds 
ruosoLPCzPyA3nfXoPVY3Q: raises $0.45 to $1.20 and is all-in
qBdqLaJhO+1itcMk70bsfA: folds 
X78b5v/uhqeXXoAijbw/yg: folds 
x+W5+3qsdY4Iszf0hoH+Aw: calls $0.95
puj3K/wrNjEj86ZL/MyfLA: calls $0.45
*** FLOP *** [3c Kh 5s]
x+W5+3qsdY4Iszf0hoH+Aw: checks 
puj3K/wrNjEj86ZL/MyfLA: checks 
*** TURN *** [3c Kh 5s] [6h]
x+W5+3qsdY4Iszf0hoH+Aw: checks 
puj3K/wrNjEj86ZL/MyfLA: checks 
*** RIVER *** [3c Kh 5s 6h] [7h]
x+W5+3qsdY4Iszf0hoH+Aw: checks 
puj3K/wrNjEj86ZL/MyfLA: checks 
*** SHOW DOWN ***
ruosoLPCzPyA3nfXoPVY3Q: shows [Td Ad] (high card Ace)
x+W5+3qsdY4Iszf0hoH+Aw: shows [2c 2s] (a pair of Deuces)
puj3K/wrNjEj86ZL/MyfLA: mucks hand 
x+W5+3qsdY4Iszf0hoH+Aw collected $3.90 from pot
*** SUMMARY ***
Total pot $4.10 | Rake $0.20 
Board [3c Kh 5s 6h 7h]
Seat 1: x+W5+3qsdY4Iszf0hoH+Aw showed [2c 2s] and won ($3.90) with a pair of Deuces
Seat 3: CT7Xj/V/O5rBlhtt+RZeFQ folded before Flop (didn't bet)
Seat 4: puj3K/wrNjEj86ZL/MyfLA mucked
Seat 5: aNpwfA31EREwO+ar4XzBCw folded before Flop (didn't bet)
Seat 6: pN3IHvAKm2fz+sTRARTcrg (button) folded before Flop (didn't bet)
Seat 7: ruosoLPCzPyA3nfXoPVY3Q (small blind) showed [Td Ad] and lost with high card Ace
Seat 8: qBdqLaJhO+1itcMk70bsfA (big blind) folded before Flop
Seat 9: X78b5v/uhqeXXoAijbw/yg folded before Flop




PokerStars Game #59941711412:  Hold'em No Limit ($0.10/$0.25) - 2009/07/01 1:43:45 ET
Table '2VkNDXXsBj4bSZw/uK5atw' 6-max Seat #2 is the button
Seat 1: xrf8tAXKQHG99HixCot1Iw ($15.35 in chips) 
Seat 2: v6mkGzCBCCXcgWQNSYVtKg ($13.30 in chips) 
Seat 5: 7f0OkhFEOf3T+rVOFHRLnw ($21.30 in chips) 
Seat 6: n6UPMnVR4v8LFP0rWP73Fg ($9.85 in chips) 
7f0OkhFEOf3T+rVOFHRLnw: posts small blind $0.10
n6UPMnVR4v8LFP0rWP73Fg: posts big blind $0.25
*** HOLE CARDS ***
xrf8tAXKQHG99HixCot1Iw: folds 
v6mkGzCBCCXcgWQNSYVtKg: folds 
7f0OkhFEOf3T+rVOFHRLnw: folds 
Uncalled bet ($0.15) returned to n6UPMnVR4v8LFP0rWP73Fg
n6UPMnVR4v8LFP0rWP73Fg collected $0.20 from pot
n6UPMnVR4v8LFP0rWP73Fg: doesn't show hand 
*** SUMMARY ***
Total pot $0.20 | Rake $0 
Seat 1: xrf8tAXKQHG99HixCot1Iw folded before Flop (didn't bet)
Seat 2: v6mkGzCBCCXcgWQNSYVtKg (button) folded before Flop (didn't bet)
Seat 5: 7f0OkhFEOf3T+rVOFHRLnw (small blind) folded before Flop
Seat 6: n6UPMnVR4v8LFP0rWP73Fg (big blind) collected ($0.20)




PokerStars Game #59941711190:  Hold'em No Limit ($0.10/$0.25) - 2009/07/01 1:43:45 ET
Table 'Loy/olZ5qoDOSvX4UTujGg' 6-max Seat #1 is the button
Seat 1: HipgaJhkN4ie/tTw4dK3Ug ($12.80 in chips) 
Seat 2: 4z7mPbMLNp4TezHXin63Vw ($16.65 in chips) 
Seat 3: 32YL2ZEp8NT4JB2RVM9euQ ($16.05 in chips) 
Seat 4: /gJNBeCkWL4o85/jvlZ4BA ($28.55 in chips) 
Seat 5: tSR4329m40dZsN7YOpI9Kw ($28.35 in chips) 
Seat 6: qGHGf/553gQnDoklMRe3tg ($26.20 in chips) 
4z7mPbMLNp4TezHXin63Vw: posts small blind $0.10
32YL2ZEp8NT4JB2RVM9euQ: posts big blind $0.25
*** HOLE CARDS ***
/gJNBeCkWL4o85/jvlZ4BA: folds 
tSR4329m40dZsN7YOpI9Kw: folds 
qGHGf/553gQnDoklMRe3tg: raises $0.75 to $1
HipgaJhkN4ie/tTw4dK3Ug: folds 
4z7mPbMLNp4TezHXin63Vw: folds 
32YL2ZEp8NT4JB2RVM9euQ: folds 
Uncalled bet ($0.75) returned to qGHGf/553gQnDoklMRe3tg
qGHGf/553gQnDoklMRe3tg collected $0.60 from pot
*** SUMMARY ***
Total pot $0.60 | Rake $0 
Seat 1: HipgaJhkN4ie/tTw4dK3Ug (button) folded before Flop (didn't bet)
Seat 2: 4z7mPbMLNp4TezHXin63Vw (small blind) folded before Flop
Seat 3: 32YL2ZEp8NT4JB2RVM9euQ (big blind) folded before Flop
Seat 4: /gJNBeCkWL4o85/jvlZ4BA folded before Flop (didn't bet)
Seat 5: tSR4329m40dZsN7YOpI9Kw folded before Flop (didn't bet)
Seat 6: qGHGf/553gQnDoklMRe3tg collected ($0.60)




PokerStars Game #59941712172:  Hold'em No Limit ($0.10/$0.25) - 2009/07/01 1:43:46 ET
Table 'dZNBGqFYSwfOVZvDJ4VjIQ' 6-max Seat #6 is the button
Seat 1: v+QfkGiuj9bgtuNoVnDO8w ($33.30 in chips) 
Seat 2: 3zD3qLXT1bEffAoWGnc7wg ($25.35 in chips) 
Seat 3: kyRaCIljYA6l33lSKQfNsg ($28.30 in chips) 
Seat 4: mFv3iBCtrw9XfCDRB0d46Q ($6.15 in chips) 
Seat 5: +ZlnqPoP3Hg4BIUxDfKd/A ($36.50 in chips) 
Seat 6: ypmjhffk/YHGc51wgVXUTw ($30.40 in chips) 
v+QfkGiuj9bgtuNoVnDO8w: posts small blind $0.10
3zD3qLXT1bEffAoWGnc7wg: posts big blind $0.25
*** HOLE CARDS ***
kyRaCIljYA6l33lSKQfNsg: folds 
mFv3iBCtrw9XfCDRB0d46Q: folds 
+ZlnqPoP3Hg4BIUxDfKd/A: raises $0.75 to $1
ypmjhffk/YHGc51wgVXUTw: calls $1
v+QfkGiuj9bgtuNoVnDO8w: calls $0.90
3zD3qLXT1bEffAoWGnc7wg: folds 
*** FLOP *** [2s 6c 3h]
v+QfkGiuj9bgtuNoVnDO8w: checks 
+ZlnqPoP3Hg4BIUxDfKd/A: bets $2.25
ypmjhffk/YHGc51wgVXUTw: folds 
v+QfkGiuj9bgtuNoVnDO8w: raises $5 to $7.25
+ZlnqPoP3Hg4BIUxDfKd/A: folds 
Uncalled bet ($5) returned to v+QfkGiuj9bgtuNoVnDO8w
v+QfkGiuj9bgtuNoVnDO8w collected $7.40 from pot
v+QfkGiuj9bgtuNoVnDO8w: doesn't show hand 
*** SUMMARY ***
Total pot $7.75 | Rake $0.35 
Board [2s 6c 3h]
Seat 1: v+QfkGiuj9bgtuNoVnDO8w (small blind) collected ($7.40)
Seat 2: 3zD3qLXT1bEffAoWGnc7wg (big blind) folded before Flop
Seat 3: kyRaCIljYA6l33lSKQfNsg folded before Flop (didn't bet)
Seat 4: mFv3iBCtrw9XfCDRB0d46Q folded before Flop (didn't bet)
Seat 5: +ZlnqPoP3Hg4BIUxDfKd/A folded on the Flop
Seat 6: ypmjhffk/YHGc51wgVXUTw (button) folded on the Flop




PokerStars Game #59941712126:  Hold'em No Limit ($0.10/$0.25) - 2009/07/01 1:43:46 ET
Table 'jdhJTJjFq2KTttwJcd+7nQ' 6-max Seat #4 is the button
Seat 1: LtASJ9OlkqGrrUKGQlpGAw ($26.70 in chips) 
Seat 2: Hsvkc0/G2VV78oVmWYXecw ($5 in chips) 
Seat 3: vqWjZmdQu/Hxw96/IJTWdQ ($25.95 in chips) 
Seat 4: vx7FwRcelVSsvNYAdp/z0A ($7.15 in chips) 
Seat 5: BV+K0Phf5VBHr7aZPKqbUQ ($25.50 in chips) 
Seat 6: yb6rnd48JuBccThV68VHAQ ($16.75 in chips) 
BV+K0Phf5VBHr7aZPKqbUQ: posts small blind $0.10
yb6rnd48JuBccThV68VHAQ: posts big blind $0.25
*** HOLE CARDS ***
LtASJ9OlkqGrrUKGQlpGAw: folds 
Hsvkc0/G2VV78oVmWYXecw: folds 
vqWjZmdQu/Hxw96/IJTWdQ: folds 
vx7FwRcelVSsvNYAdp/z0A: folds 
BV+K0Phf5VBHr7aZPKqbUQ: raises $0.50 to $0.75
yb6rnd48JuBccThV68VHAQ: folds 
Uncalled bet ($0.50) returned to BV+K0Phf5VBHr7aZPKqbUQ
BV+K0Phf5VBHr7aZPKqbUQ collected $0.50 from pot
BV+K0Phf5VBHr7aZPKqbUQ: doesn't show hand 
*** SUMMARY ***
Total pot $0.50 | Rake $0 
Seat 1: LtASJ9OlkqGrrUKGQlpGAw folded before Flop (didn't bet)
Seat 2: Hsvkc0/G2VV78oVmWYXecw folded before Flop (didn't bet)
Seat 3: vqWjZmdQu/Hxw96/IJTWdQ folded before Flop (didn't bet)
Seat 4: vx7FwRcelVSsvNYAdp/z0A (button) folded before Flop (didn't bet)
Seat 5: BV+K0Phf5VBHr7aZPKqbUQ (small blind) collected ($0.50)
Seat 6: yb6rnd48JuBccThV68VHAQ (big blind) folded before Flop




PokerStars Game #59941712088:  Hold'em No Limit ($0.10/$0.25) - 2009/07/01 1:43:46 ET
Table 'Mef6A0EMopL6WaFO5/KO9g' 6-max Seat #2 is the button
Seat 1: GbCVUNssQ7mqsPWr7J4d3w ($4.30 in chips) 
Seat 2: 8ClCHtFXGNplITm+63KB+Q ($30.90 in chips) 
Seat 3: Wq26opBLDGJe91GRJn2epg ($15.30 in chips) 
Seat 4: lquriepNQBhDV5P1SWHhnA ($25.35 in chips) 
Seat 5: DihMHaz4WNETH1bPDe13kA ($25 in chips) 
Seat 6: jp34e617tIzV8tKIWmfAbA ($33.30 in chips) 
Wq26opBLDGJe91GRJn2epg: posts small blind $0.10
lquriepNQBhDV5P1SWHhnA: posts big blind $0.25
*** HOLE CARDS ***
DihMHaz4WNETH1bPDe13kA: folds 
jp34e617tIzV8tKIWmfAbA: folds 
GbCVUNssQ7mqsPWr7J4d3w: folds 
8ClCHtFXGNplITm+63KB+Q: raises $0.75 to $1
Wq26opBLDGJe91GRJn2epg: calls $0.90
lquriepNQBhDV5P1SWHhnA: calls $0.75
*** FLOP *** [6s 9d 5h]
Wq26opBLDGJe91GRJn2epg: bets $1
lquriepNQBhDV5P1SWHhnA: folds 
8ClCHtFXGNplITm+63KB+Q: folds 
Uncalled bet ($1) returned to Wq26opBLDGJe91GRJn2epg
Wq26opBLDGJe91GRJn2epg collected $2.85 from pot
Wq26opBLDGJe91GRJn2epg: doesn't show hand 
*** SUMMARY ***
Total pot $3 | Rake $0.15 
Board [6s 9d 5h]
Seat 1: GbCVUNssQ7mqsPWr7J4d3w folded before Flop (didn't bet)
Seat 2: 8ClCHtFXGNplITm+63KB+Q (button) folded on the Flop
Seat 3: Wq26opBLDGJe91GRJn2epg (small blind) collected ($2.85)
Seat 4: lquriepNQBhDV5P1SWHhnA (big blind) folded on the Flop
Seat 5: DihMHaz4WNETH1bPDe13kA folded before Flop (didn't bet)
Seat 6: jp34e617tIzV8tKIWmfAbA folded before Flop (didn't bet)




PokerStars Game #59941712116:  Hold'em No Limit ($0.10/$0.25) - 2009/07/01 1:43:46 ET
Table 'Jz+kWRxWNGk9w24fdQEveA' 9-max Seat #7 is the button
Seat 2: ljemhp25Zg+nlA9DLCIiUw ($38.85 in chips) 
Seat 4: HPEB+AtKw1+C/cxU0o1ciw ($28.65 in chips) 
Seat 5: d6eSA7wOH5mRaSyVDVRBLw ($11.75 in chips) 
Seat 7: wGigCmBR/9XWkPpvYos3aQ ($26.75 in chips) 
Seat 8: j4q3p0lesp63b1gZDwLBZw ($5 in chips) 
Seat 9: V6p0jQ/RhUsqpHLmXvEX4Q ($17.70 in chips) 
j4q3p0lesp63b1gZDwLBZw: posts small blind $0.10
V6p0jQ/RhUsqpHLmXvEX4Q: posts big blind $0.25
Z9W7+g1WMhhZDi7DwGbCFA: sits out 
WPT_Champ111: sits out 
*** HOLE CARDS ***
BXkjaKe7T/rw37TNNtBVwQ joins the table at seat #6 
ljemhp25Zg+nlA9DLCIiUw: folds 
HPEB+AtKw1+C/cxU0o1ciw: raises $0.75 to $1
d6eSA7wOH5mRaSyVDVRBLw: folds 
wGigCmBR/9XWkPpvYos3aQ: folds 
j4q3p0lesp63b1gZDwLBZw: folds 
V6p0jQ/RhUsqpHLmXvEX4Q: folds 
Uncalled bet ($0.75) returned to HPEB+AtKw1+C/cxU0o1ciw
HPEB+AtKw1+C/cxU0o1ciw collected $0.60 from pot
HPEB+AtKw1+C/cxU0o1ciw: doesn't show hand 
*** SUMMARY ***
Total pot $0.60 | Rake $0 
Seat 2: ljemhp25Zg+nlA9DLCIiUw folded before Flop (didn't bet)
Seat 4: HPEB+AtKw1+C/cxU0o1ciw collected ($0.60)
Seat 5: d6eSA7wOH5mRaSyVDVRBLw folded before Flop (didn't bet)
Seat 7: wGigCmBR/9XWkPpvYos3aQ (button) folded before Flop (didn't bet)
Seat 8: j4q3p0lesp63b1gZDwLBZw (small blind) folded before Flop
Seat 9: V6p0jQ/RhUsqpHLmXvEX4Q (big blind) folded before Flop




PokerStars Game #59941711852:  Hold'em No Limit ($0.10/$0.25) - 2009/07/01 1:43:46 ET
Table 'z2yOdY2zyGWG1gh9WV9XtQ' 9-max Seat #3 is the button
Seat 1: 7je+LC5Mfs6nL8YBVh4frQ ($4.65 in chips) 
Seat 2: bXpVeaSTPBFSPJmeXxO7nw ($4.65 in chips) 
Seat 3: X78b5v/uhqeXXoAijbw/yg ($27.40 in chips) 
Seat 5: W6tExOcYX7qiy6Qdp+ZwFA ($10.65 in chips) 
Seat 6: NBYmTySMtIicyMj5Vjzqhw ($21.80 in chips) 
Seat 8: Mh2r9hTeTEDnh19sRZtW3g ($7.50 in chips) 
Seat 9: wGigCmBR/9XWkPpvYos3aQ ($34.40 in chips) 
W6tExOcYX7qiy6Qdp+ZwFA: posts small blind $0.10
NBYmTySMtIicyMj5Vjzqhw: posts big blind $0.25
*** HOLE CARDS ***
Mh2r9hTeTEDnh19sRZtW3g: folds 
wGigCmBR/9XWkPpvYos3aQ: folds 
7je+LC5Mfs6nL8YBVh4frQ: raises $0.50 to $0.75
bXpVeaSTPBFSPJmeXxO7nw: folds 
X78b5v/uhqeXXoAijbw/yg: calls $0.75
Bb42QRQMhg5/Y0vHP8/2Xw joins the table at seat #4 
W6tExOcYX7qiy6Qdp+ZwFA: folds 
NBYmTySMtIicyMj5Vjzqhw: calls $0.50
*** FLOP *** [6h Qc 5s]
NBYmTySMtIicyMj5Vjzqhw: checks 
7je+LC5Mfs6nL8YBVh4frQ: bets $1.75
X78b5v/uhqeXXoAijbw/yg: folds 
NBYmTySMtIicyMj5Vjzqhw: raises $1.75 to $3.50
7je+LC5Mfs6nL8YBVh4frQ: folds 
Uncalled bet ($1.75) returned to NBYmTySMtIicyMj5Vjzqhw
NBYmTySMtIicyMj5Vjzqhw collected $5.60 from pot
NBYmTySMtIicyMj5Vjzqhw: doesn't show hand 
*** SUMMARY ***
Total pot $5.85 | Rake $0.25 
Board [6h Qc 5s]
Seat 1: 7je+LC5Mfs6nL8YBVh4frQ folded on the Flop
Seat 2: bXpVeaSTPBFSPJmeXxO7nw folded before Flop (didn't bet)
Seat 3: X78b5v/uhqeXXoAijbw/yg (button) folded on the Flop
Seat 5: W6tExOcYX7qiy6Qdp+ZwFA (small blind) folded before Flop
Seat 6: NBYmTySMtIicyMj5Vjzqhw (big blind) collected ($5.60)
Seat 8: Mh2r9hTeTEDnh19sRZtW3g folded before Flop (didn't bet)
Seat 9: wGigCmBR/9XWkPpvYos3aQ folded before Flop (didn't bet)




PokerStars Game #59941711924:  Hold'em No Limit ($0.10/$0.25) - 2009/07/01 1:43:46 ET
Table 'HbNAGS1OJWQKyfk7UfrYyw' 9-max Seat #2 is the button
Seat 2: fjwM06E3HzjUrynPRQi31Q ($6.10 in chips) 
Seat 5: z2SmIaQ3+5n/eY1BN5HgPg ($5.70 in chips) 
Seat 6: jntAuOS+eFQDYNiDN8dzag ($13.50 in chips) 
XwQK8xvCADxp0bUmji+Zyg will be allowed to play after the button
z2SmIaQ3+5n/eY1BN5HgPg: posts small blind $0.10
jntAuOS+eFQDYNiDN8dzag: posts big blind $0.25
*** HOLE CARDS ***
fjwM06E3HzjUrynPRQi31Q: calls $0.25
z2SmIaQ3+5n/eY1BN5HgPg: calls $0.15
jntAuOS+eFQDYNiDN8dzag: checks 
*** FLOP *** [Js 8s Ah]
z2SmIaQ3+5n/eY1BN5HgPg: checks 
jntAuOS+eFQDYNiDN8dzag: checks 
fjwM06E3HzjUrynPRQi31Q: checks 
*** TURN *** [Js 8s Ah] [7d]
z2SmIaQ3+5n/eY1BN5HgPg: bets $0.50
jntAuOS+eFQDYNiDN8dzag: calls $0.50
fjwM06E3HzjUrynPRQi31Q: folds 
*** RIVER *** [Js 8s Ah 7d] [5d]
z2SmIaQ3+5n/eY1BN5HgPg: bets $3.50
jntAuOS+eFQDYNiDN8dzag: folds 
Uncalled bet ($3.50) returned to z2SmIaQ3+5n/eY1BN5HgPg
z2SmIaQ3+5n/eY1BN5HgPg collected $1.70 from pot
z2SmIaQ3+5n/eY1BN5HgPg: doesn't show hand 
*** SUMMARY ***
Total pot $1.75 | Rake $0.05 
Board [Js 8s Ah 7d 5d]
Seat 2: fjwM06E3HzjUrynPRQi31Q (button) folded on the Turn
Seat 5: z2SmIaQ3+5n/eY1BN5HgPg (small blind) collected ($1.70)
Seat 6: jntAuOS+eFQDYNiDN8dzag (big blind) folded on the River




PokerStars Game #59941712030:  Hold'em No Limit ($0.10/$0.25) - 2009/07/01 1:43:46 ET
Table 'RPdw09/gGCIP4xFhDWJgXQ' 9-max Seat #5 is the button
Seat 1: aNpwfA31EREwO+ar4XzBCw ($27.50 in chips) 
Seat 2: Sd1tfhUq/M96GhXGv1hwFQ ($8.20 in chips) 
Seat 3: g5LAv1J/3Thw1zs/SEyfzw ($17.90 in chips) 
Seat 5: gehe91e0IyVT0QU/XBkEyg ($30.35 in chips) 
Seat 6: monZeAwXUmIA1l84cUd2hw ($14.60 in chips) 
Seat 7: EP17SQz/iWcuYdNOGeBgkw ($14.25 in chips) 
Seat 8: MG90wfSJZnOejs/KD3vlQQ ($30.15 in chips) 
Seat 9: O02ScVDnDZwH6KjZNJZMzA ($5 in chips) 
monZeAwXUmIA1l84cUd2hw: posts small blind $0.10
EP17SQz/iWcuYdNOGeBgkw: posts big blind $0.25
*** HOLE CARDS ***
MG90wfSJZnOejs/KD3vlQQ: folds 
O02ScVDnDZwH6KjZNJZMzA: folds 
aNpwfA31EREwO+ar4XzBCw: folds 
Sd1tfhUq/M96GhXGv1hwFQ: raises $0.75 to $1
g5LAv1J/3Thw1zs/SEyfzw: folds 
gehe91e0IyVT0QU/XBkEyg: folds 
monZeAwXUmIA1l84cUd2hw: folds 
EP17SQz/iWcuYdNOGeBgkw: folds 
Uncalled bet ($0.75) returned to Sd1tfhUq/M96GhXGv1hwFQ
Sd1tfhUq/M96GhXGv1hwFQ collected $0.60 from pot
*** SUMMARY ***
Total pot $0.60 | Rake $0 
Seat 1: aNpwfA31EREwO+ar4XzBCw folded before Flop (didn't bet)
Seat 2: Sd1tfhUq/M96GhXGv1hwFQ collected ($0.60)
Seat 3: g5LAv1J/3Thw1zs/SEyfzw folded before Flop (didn't bet)
Seat 5: gehe91e0IyVT0QU/XBkEyg (button) folded before Flop (didn't bet)
Seat 6: monZeAwXUmIA1l84cUd2hw (small blind) folded before Flop
Seat 7: EP17SQz/iWcuYdNOGeBgkw (big blind) folded before Flop
Seat 8: MG90wfSJZnOejs/KD3vlQQ folded before Flop (didn't bet)
Seat 9: O02ScVDnDZwH6KjZNJZMzA folded before Flop (didn't bet)




PokerStars Game #59941712050:  Hold'em No Limit ($0.10/$0.25) - 2009/07/01 1:43:46 ET
Table 'nIRjSqm6RYUWJlyW2loYKA' 6-max Seat #1 is the button
Seat 1: BqTIZMLF3Kq/dZiALjvUCg ($6.25 in chips) 
Seat 2: NndRCAk4vU5JGDhTyy5LZg ($16.40 in chips) 
Seat 3: HbKNMWUwblC7HKtRCUhBWw ($15 in chips) 
Seat 6: OIjOiBfQstWrK/RuXx7zcw ($4.25 in chips) 
NndRCAk4vU5JGDhTyy5LZg: posts small blind $0.10
HbKNMWUwblC7HKtRCUhBWw: posts big blind $0.25
*** HOLE CARDS ***
OIjOiBfQstWrK/RuXx7zcw: raises $0.75 to $1
/ZSSWvl8im2y38j1uEUAGA joins the table at seat #4 
BqTIZMLF3Kq/dZiALjvUCg: calls $1
NndRCAk4vU5JGDhTyy5LZg: folds 
HbKNMWUwblC7HKtRCUhBWw: folds 
*** FLOP *** [9h 3c 4d]
OIjOiBfQstWrK/RuXx7zcw: checks 
df01R5ThvHspD8FgKmaDvQ joins the table at seat #5 
BqTIZMLF3Kq/dZiALjvUCg: checks 
*** TURN *** [9h 3c 4d] [5h]
OIjOiBfQstWrK/RuXx7zcw: checks 
BqTIZMLF3Kq/dZiALjvUCg: bets $0.50
OIjOiBfQstWrK/RuXx7zcw: calls $0.50
*** RIVER *** [9h 3c 4d 5h] [3h]
OIjOiBfQstWrK/RuXx7zcw: bets $2.75 and is all-in
BqTIZMLF3Kq/dZiALjvUCg: folds 
Uncalled bet ($2.75) returned to OIjOiBfQstWrK/RuXx7zcw
OIjOiBfQstWrK/RuXx7zcw collected $3.20 from pot
OIjOiBfQstWrK/RuXx7zcw: doesn't show hand 
*** SUMMARY ***
Total pot $3.35 | Rake $0.15 
Board [9h 3c 4d 5h 3h]
Seat 1: BqTIZMLF3Kq/dZiALjvUCg (button) folded on the River
Seat 2: NndRCAk4vU5JGDhTyy5LZg (small blind) folded before Flop
Seat 3: HbKNMWUwblC7HKtRCUhBWw (big blind) folded before Flop
Seat 6: OIjOiBfQstWrK/RuXx7zcw collected ($3.20)




PokerStars Game #59941711930:  Hold'em No Limit ($0.10/$0.25) - 2009/07/01 1:43:46 ET
Table 'IIO2q2znuuAXmiZ2qFTcmg' 6-max Seat #2 is the button
Seat 2: cS21pIxRHx5Gt42o7hPZzw ($24.45 in chips) 
Seat 3: L3/N/gliETan8N5Gim5h4Q ($25.10 in chips) 
Seat 4: tSR4329m40dZsN7YOpI9Kw ($58.50 in chips) 
Seat 5: 9U3ZKjCsarN0DjR6mSE8Ug ($14 in chips) 
Seat 6: aogAb4Eienxztk8p2v9VVw ($37.10 in chips) 
L3/N/gliETan8N5Gim5h4Q: posts small blind $0.10
tSR4329m40dZsN7YOpI9Kw: posts big blind $0.25
*** HOLE CARDS ***
9U3ZKjCsarN0DjR6mSE8Ug: folds 
aogAb4Eienxztk8p2v9VVw: folds 
cS21pIxRHx5Gt42o7hPZzw: raises $0.75 to $1
L3/N/gliETan8N5Gim5h4Q: folds 
tSR4329m40dZsN7YOpI9Kw: folds 
Uncalled bet ($0.75) returned to cS21pIxRHx5Gt42o7hPZzw
cS21pIxRHx5Gt42o7hPZzw collected $0.60 from pot
cS21pIxRHx5Gt42o7hPZzw: doesn't show hand 
*** SUMMARY ***
Total pot $0.60 | Rake $0 
Seat 2: cS21pIxRHx5Gt42o7hPZzw (button) collected ($0.60)
Seat 3: L3/N/gliETan8N5Gim5h4Q (small blind) folded before Flop
Seat 4: tSR4329m40dZsN7YOpI9Kw (big blind) folded before Flop
Seat 5: 9U3ZKjCsarN0DjR6mSE8Ug folded before Flop (didn't bet)
Seat 6: aogAb4Eienxztk8p2v9VVw folded before Flop (didn't bet)




PokerStars Game #59941712738:  Hold'em No Limit ($0.10/$0.25) - 2009/07/01 1:43:47 ET
Table 'Zi9/NqNs3XoL1eWhMCyZyg' 9-max Seat #4 is the button
Seat 2: 1wKfgJ8xXIiuc8C6qjkxhg ($5 in chips) 
Seat 3: ETC7YyRJTa2Ovhln64Ni5Q ($27.75 in chips) 
Seat 4: dmYlc+1cjwZMJ7wV+Z0rRg ($22.80 in chips) 
Seat 5: JTINtdu/1/EQCVfalLD/xQ ($11.15 in chips) 
Seat 6: YQhfmYhgnDDlWCAFmBb36Q ($15 in chips) 
Seat 7: 0QdZrkFD7aGKeBXPGbIomA ($4.10 in chips) 
Seat 8: nm4Dj/f+jJEwKVsUnKh73g ($35.05 in chips) 
Seat 9: tYsOBqdU1+x+yFI7zHO7hQ ($31.65 in chips) 
JTINtdu/1/EQCVfalLD/xQ: posts small blind $0.10
YQhfmYhgnDDlWCAFmBb36Q: posts big blind $0.25
X6+pSIPfovPcE87t+LmUKQ: sits out 
1wKfgJ8xXIiuc8C6qjkxhg: posts big blind $0.25
*** HOLE CARDS ***
0QdZrkFD7aGKeBXPGbIomA: folds 
nm4Dj/f+jJEwKVsUnKh73g: raises $1.25 to $1.50
tYsOBqdU1+x+yFI7zHO7hQ: folds 
1wKfgJ8xXIiuc8C6qjkxhg: folds 
ETC7YyRJTa2Ovhln64Ni5Q: folds 
dmYlc+1cjwZMJ7wV+Z0rRg: calls $1.50
JTINtdu/1/EQCVfalLD/xQ: folds 
YQhfmYhgnDDlWCAFmBb36Q: folds 
*** FLOP *** [9h Qd Kc]
nm4Dj/f+jJEwKVsUnKh73g: checks 
dmYlc+1cjwZMJ7wV+Z0rRg: checks 
*** TURN *** [9h Qd Kc] [6c]
nm4Dj/f+jJEwKVsUnKh73g: bets $2
dmYlc+1cjwZMJ7wV+Z0rRg: folds 
Uncalled bet ($2) returned to nm4Dj/f+jJEwKVsUnKh73g
nm4Dj/f+jJEwKVsUnKh73g collected $3.45 from pot
nm4Dj/f+jJEwKVsUnKh73g: doesn't show hand 
*** SUMMARY ***
Total pot $3.60 | Rake $0.15 
Board [9h Qd Kc 6c]
Seat 2: 1wKfgJ8xXIiuc8C6qjkxhg folded before Flop
Seat 3: ETC7YyRJTa2Ovhln64Ni5Q folded before Flop (didn't bet)
Seat 4: dmYlc+1cjwZMJ7wV+Z0rRg (button) folded on the Turn
Seat 5: JTINtdu/1/EQCVfalLD/xQ (small blind) folded before Flop
Seat 6: YQhfmYhgnDDlWCAFmBb36Q (big blind) folded before Flop
Seat 7: 0QdZrkFD7aGKeBXPGbIomA folded before Flop (didn't bet)
Seat 8: nm4Dj/f+jJEwKVsUnKh73g collected ($3.45)
Seat 9: tYsOBqdU1+x+yFI7zHO7hQ folded before Flop (didn't bet)




PokerStars Game #59941712586:  Hold'em No Limit ($0.10/$0.25) - 2009/07/01 1:43:47 ET
Table 'uFgIyfWPagvEVGEb86da7A' 9-max Seat #9 is the button
Seat 1: CT7Xj/V/O5rBlhtt+RZeFQ ($26 in chips) 
Seat 2: o3zvoO+PsqGti+1NZGNRrQ ($1.10 in chips) 
Seat 3: eGAnPT3w+iltM7HF59dzIg ($6.25 in chips) 
Seat 4: IGRfskE1v9H9Bn+fz8AgNQ ($26.90 in chips) 
Seat 5: X78b5v/uhqeXXoAijbw/yg ($28.30 in chips) 
Seat 7: 9zx7Mlww974uHUqoiq2eXA ($11.85 in chips) 
Seat 8: uLP/lYn7oKq9xCChBXsXxw ($24.30 in chips) 
Seat 9: sL5EaDXc90Iyxlm8ERXRQw ($18 in chips) 
CT7Xj/V/O5rBlhtt+RZeFQ: posts small blind $0.10
o3zvoO+PsqGti+1NZGNRrQ: posts big blind $0.25
*** HOLE CARDS ***
eGAnPT3w+iltM7HF59dzIg: folds 
IGRfskE1v9H9Bn+fz8AgNQ: folds 
X78b5v/uhqeXXoAijbw/yg: folds 
9zx7Mlww974uHUqoiq2eXA: folds 
uLP/lYn7oKq9xCChBXsXxw: folds 
sL5EaDXc90Iyxlm8ERXRQw: folds 
CT7Xj/V/O5rBlhtt+RZeFQ: calls $0.15
o3zvoO+PsqGti+1NZGNRrQ: raises $0.85 to $1.10 and is all-in
CT7Xj/V/O5rBlhtt+RZeFQ: folds 
Uncalled bet ($0.85) returned to o3zvoO+PsqGti+1NZGNRrQ
o3zvoO+PsqGti+1NZGNRrQ collected $0.50 from pot
o3zvoO+PsqGti+1NZGNRrQ: doesn't show hand 
*** SUMMARY ***
Total pot $0.50 | Rake $0 
Seat 1: CT7Xj/V/O5rBlhtt+RZeFQ (small blind) folded before Flop
Seat 2: o3zvoO+PsqGti+1NZGNRrQ (big blind) collected ($0.50)
Seat 3: eGAnPT3w+iltM7HF59dzIg folded before Flop (didn't bet)
Seat 4: IGRfskE1v9H9Bn+fz8AgNQ folded before Flop (didn't bet)
Seat 5: X78b5v/uhqeXXoAijbw/yg folded before Flop (didn't bet)
Seat 7: 9zx7Mlww974uHUqoiq2eXA folded before Flop (didn't bet)
Seat 8: uLP/lYn7oKq9xCChBXsXxw folded before Flop (didn't bet)
Seat 9: sL5EaDXc90Iyxlm8ERXRQw (button) folded before Flop (didn't bet)




PokerStars Game #59941712322:  Hold'em No Limit ($0.10/$0.25) - 2009/07/01 1:43:47 ET
Table 'NgexmgEDEzICBeSO7YCrKQ' 6-max Seat #1 is the button
Seat 1: cezpHJ8FB07dj0xG+LhOvw ($29.45 in chips) 
Seat 2: 32YL2ZEp8NT4JB2RVM9euQ ($21.65 in chips) 
Seat 3: JFIAqU8lCZ0vWwEl4bdGsg ($26.85 in chips) 
Seat 4: xx+iYCDJhHJmNzrfeloyEg ($28.15 in chips) 
Seat 5: /MXkdT8TTs8Qp2LVTQNw6w ($37.80 in chips) 
Seat 6: k9nHZTHt8hYhYRcW8NTb4g ($10.95 in chips) 
32YL2ZEp8NT4JB2RVM9euQ: posts small blind $0.10
JFIAqU8lCZ0vWwEl4bdGsg: posts big blind $0.25
*** HOLE CARDS ***
xx+iYCDJhHJmNzrfeloyEg: calls $0.25
/MXkdT8TTs8Qp2LVTQNw6w: raises $0.75 to $1
k9nHZTHt8hYhYRcW8NTb4g: folds 
cezpHJ8FB07dj0xG+LhOvw: folds 
32YL2ZEp8NT4JB2RVM9euQ: folds 
JFIAqU8lCZ0vWwEl4bdGsg: folds 
xx+iYCDJhHJmNzrfeloyEg said, "  That's $25.10 better."
xx+iYCDJhHJmNzrfeloyEg: calls $0.75
*** FLOP *** [Js Th Qd]
xx+iYCDJhHJmNzrfeloyEg: checks 
/MXkdT8TTs8Qp2LVTQNw6w: bets $1
xx+iYCDJhHJmNzrfeloyEg: calls $1
*** TURN *** [Js Th Qd] [5h]
xx+iYCDJhHJmNzrfeloyEg: checks 
/MXkdT8TTs8Qp2LVTQNw6w: checks 
*** RIVER *** [Js Th Qd 5h] [Ts]
xx+iYCDJhHJmNzrfeloyEg: bets $2.50
/MXkdT8TTs8Qp2LVTQNw6w said, "so sick"
/MXkdT8TTs8Qp2LVTQNw6w said, "can you beat AQ?"
/MXkdT8TTs8Qp2LVTQNw6w: calls $2.50
*** SHOW DOWN ***
xx+iYCDJhHJmNzrfeloyEg: shows [5d Ad] (two pair, Tens and Fives)
/MXkdT8TTs8Qp2LVTQNw6w: shows [As Qc] (two pair, Queens and Tens)
/MXkdT8TTs8Qp2LVTQNw6w collected $8.90 from pot
*** SUMMARY ***
Total pot $9.35 | Rake $0.45 
Board [Js Th Qd 5h Ts]
Seat 1: cezpHJ8FB07dj0xG+LhOvw (button) folded before Flop (didn't bet)
Seat 2: 32YL2ZEp8NT4JB2RVM9euQ (small blind) folded before Flop
Seat 3: JFIAqU8lCZ0vWwEl4bdGsg (big blind) folded before Flop
Seat 4: xx+iYCDJhHJmNzrfeloyEg showed [5d Ad] and lost with two pair, Tens and Fives
Seat 5: /MXkdT8TTs8Qp2LVTQNw6w showed [As Qc] and won ($8.90) with two pair, Queens and Tens
Seat 6: k9nHZTHt8hYhYRcW8NTb4g folded before Flop (didn't bet)




PokerStars Game #59941712472:  Hold'em No Limit ($0.10/$0.25) - 2009/07/01 1:43:47 ET
Table '29D3eoQzK5kOAT0OIDS2uQ' 6-max Seat #5 is the button
Seat 1: kG34n23qFQA3nzdOJTQ1dA ($46.15 in chips) 
Seat 2: FyE+TQ5JcCqI/tCCHf0jGA ($16.30 in chips) 
Seat 3: z3tQwy28dp5FykDJC/wzQw ($17.80 in chips) 
Seat 4: MqMK8OWPSY1V4stf1Hy5Jw ($35.90 in chips) 
Seat 5: Q3EMN7b0ie81AFWkDrhCjw ($23.90 in chips) 
Seat 6: bWbV4MVB/vVpiES1Ut4hew ($30.15 in chips) 
bWbV4MVB/vVpiES1Ut4hew: posts small blind $0.10
kG34n23qFQA3nzdOJTQ1dA: posts big blind $0.25
*** HOLE CARDS ***
FyE+TQ5JcCqI/tCCHf0jGA: folds 
z3tQwy28dp5FykDJC/wzQw: folds 
MqMK8OWPSY1V4stf1Hy5Jw: folds 
Q3EMN7b0ie81AFWkDrhCjw: calls $0.25
bWbV4MVB/vVpiES1Ut4hew: folds 
kG34n23qFQA3nzdOJTQ1dA: checks 
*** FLOP *** [3h Kh 4s]
kG34n23qFQA3nzdOJTQ1dA: checks 
Q3EMN7b0ie81AFWkDrhCjw: checks 
*** TURN *** [3h Kh 4s] [Kc]
kG34n23qFQA3nzdOJTQ1dA: checks 
Q3EMN7b0ie81AFWkDrhCjw: checks 
*** RIVER *** [3h Kh 4s Kc] [8c]
kG34n23qFQA3nzdOJTQ1dA: checks 
Q3EMN7b0ie81AFWkDrhCjw: checks 
*** SHOW DOWN ***
kG34n23qFQA3nzdOJTQ1dA: shows [Ad Td] (a pair of Kings)
Q3EMN7b0ie81AFWkDrhCjw: mucks hand 
kG34n23qFQA3nzdOJTQ1dA collected $0.60 from pot
*** SUMMARY ***
Total pot $0.60 | Rake $0 
Board [3h Kh 4s Kc 8c]
Seat 1: kG34n23qFQA3nzdOJTQ1dA (big blind) showed [Ad Td] and won ($0.60) with a pair of Kings
Seat 2: FyE+TQ5JcCqI/tCCHf0jGA folded before Flop (didn't bet)
Seat 3: z3tQwy28dp5FykDJC/wzQw folded before Flop (didn't bet)
Seat 4: MqMK8OWPSY1V4stf1Hy5Jw folded before Flop (didn't bet)
Seat 5: Q3EMN7b0ie81AFWkDrhCjw (button) mucked
Seat 6: bWbV4MVB/vVpiES1Ut4hew (small blind) folded before Flop




PokerStars Game #59941712858:  Hold'em No Limit ($0.10/$0.25) - 2009/07/01 1:43:48 ET
Table 'mF3KHGMaTpaBZbtBoyfTeg' 6-max Seat #2 is the button
Seat 1: 0HAB2GdCAM7p7V00xueAVQ ($24.35 in chips) 
Seat 2: 6qsh9pnysDKJNhfFhFmKRQ ($14.10 in chips) 
Seat 3: 9kUKGKkblnIx3m8rlVol6Q ($9.80 in chips) 
Seat 4: FYepjhAvF8ZdVCmqHIy+eQ ($25 in chips) 
Seat 5: 8ClCHtFXGNplITm+63KB+Q ($43.40 in chips) 
Seat 6: kG34n23qFQA3nzdOJTQ1dA ($27.75 in chips) 
9kUKGKkblnIx3m8rlVol6Q: posts small blind $0.10
FYepjhAvF8ZdVCmqHIy+eQ: posts big blind $0.25
*** HOLE CARDS ***
8ClCHtFXGNplITm+63KB+Q: raises $0.75 to $1
kG34n23qFQA3nzdOJTQ1dA: folds 
0HAB2GdCAM7p7V00xueAVQ: calls $1
6qsh9pnysDKJNhfFhFmKRQ: folds 
9kUKGKkblnIx3m8rlVol6Q: folds 
FYepjhAvF8ZdVCmqHIy+eQ: folds 
*** FLOP *** [Kc 7h Jc]
8ClCHtFXGNplITm+63KB+Q: bets $1.75
0HAB2GdCAM7p7V00xueAVQ: folds 
Uncalled bet ($1.75) returned to 8ClCHtFXGNplITm+63KB+Q
8ClCHtFXGNplITm+63KB+Q collected $2.25 from pot
8ClCHtFXGNplITm+63KB+Q: doesn't show hand 
*** SUMMARY ***
Total pot $2.35 | Rake $0.10 
Board [Kc 7h Jc]
Seat 1: 0HAB2GdCAM7p7V00xueAVQ folded on the Flop
Seat 2: 6qsh9pnysDKJNhfFhFmKRQ (button) folded before Flop (didn't bet)
Seat 3: 9kUKGKkblnIx3m8rlVol6Q (small blind) folded before Flop
Seat 4: FYepjhAvF8ZdVCmqHIy+eQ (big blind) folded before Flop
Seat 5: 8ClCHtFXGNplITm+63KB+Q collected ($2.25)
Seat 6: kG34n23qFQA3nzdOJTQ1dA folded before Flop (didn't bet)




PokerStars Game #59941713108:  Hold'em No Limit ($0.10/$0.25) - 2009/07/01 1:43:48 ET
Table 'm+FQg/QP0VP1ZA3V62WtOg' 9-max Seat #9 is the button
Seat 2: L2sCMFMB88ntwrAVYva+kQ ($12.80 in chips) 
Seat 3: +KblIivb6tainScpwm14RQ ($6.75 in chips) 
Seat 5: wf5j8xvJtko6ZXyCbzzlVQ ($13.25 in chips) 
Seat 6: CT7Xj/V/O5rBlhtt+RZeFQ ($25.10 in chips) 
Seat 7: TPAF9YkMsjQFq978RNWZEQ ($18.20 in chips) 
Seat 9: zUXhymECc2C9W9ZNw6qppA ($10.20 in chips) 
qwr38jl5txoR36M7G5qi4A will be allowed to play after the button
L2sCMFMB88ntwrAVYva+kQ: posts small blind $0.10
+KblIivb6tainScpwm14RQ: posts big blind $0.25
dubÃ©705: sits out 
VegasVas: sits out 
*** HOLE CARDS ***
wf5j8xvJtko6ZXyCbzzlVQ: raises $0.50 to $0.75
CT7Xj/V/O5rBlhtt+RZeFQ: raises $1.50 to $2.25
TPAF9YkMsjQFq978RNWZEQ: folds 
zUXhymECc2C9W9ZNw6qppA: folds 
L2sCMFMB88ntwrAVYva+kQ: calls $2.15
+KblIivb6tainScpwm14RQ: folds 
wf5j8xvJtko6ZXyCbzzlVQ: calls $1.50
*** FLOP *** [5h Jc Th]
L2sCMFMB88ntwrAVYva+kQ: checks 
wf5j8xvJtko6ZXyCbzzlVQ: bets $1
CT7Xj/V/O5rBlhtt+RZeFQ: calls $1
L2sCMFMB88ntwrAVYva+kQ: raises $1.25 to $2.25
wf5j8xvJtko6ZXyCbzzlVQ: calls $1.25
CT7Xj/V/O5rBlhtt+RZeFQ: calls $1.25
*** TURN *** [5h Jc Th] [9h]
L2sCMFMB88ntwrAVYva+kQ: bets $2
wf5j8xvJtko6ZXyCbzzlVQ: folds 
CT7Xj/V/O5rBlhtt+RZeFQ: raises $2 to $4
L2sCMFMB88ntwrAVYva+kQ: calls $2
*** RIVER *** [5h Jc Th 9h] [7c]
L2sCMFMB88ntwrAVYva+kQ: bets $2
CT7Xj/V/O5rBlhtt+RZeFQ: raises $3 to $5
L2sCMFMB88ntwrAVYva+kQ: calls $2.30 and is all-in
Uncalled bet ($0.70) returned to CT7Xj/V/O5rBlhtt+RZeFQ
*** SHOW DOWN ***
CT7Xj/V/O5rBlhtt+RZeFQ: shows [Kh Ah] (a flush, Ace high)
L2sCMFMB88ntwrAVYva+kQ: mucks hand 
CT7Xj/V/O5rBlhtt+RZeFQ collected $28.90 from pot
*** SUMMARY ***
Total pot $30.35 | Rake $1.45 
Board [5h Jc Th 9h 7c]
Seat 2: L2sCMFMB88ntwrAVYva+kQ (small blind) mucked
Seat 3: +KblIivb6tainScpwm14RQ (big blind) folded before Flop
Seat 5: wf5j8xvJtko6ZXyCbzzlVQ folded on the Turn
Seat 6: CT7Xj/V/O5rBlhtt+RZeFQ showed [Kh Ah] and won ($28.90) with a flush, Ace high
Seat 7: TPAF9YkMsjQFq978RNWZEQ folded before Flop (didn't bet)
Seat 9: zUXhymECc2C9W9ZNw6qppA (button) folded before Flop (didn't bet)




PokerStars Game #59941712962:  Hold'em No Limit ($0.10/$0.25) - 2009/07/01 1:43:48 ET
Table 'vud0GB/ZlDCvUFhBFIaTlg' 9-max Seat #5 is the button
Seat 1: DiSvPC2iudwL5j9u6Huyww ($28.50 in chips) 
Seat 2: tLcDklc2rBORNfixyRfVfw ($25.60 in chips) 
Seat 3: W2YYHvqjaEpRrO7stZkClQ ($4.30 in chips) 
Seat 4: dWgEDExmVO0d+rRmUYCU5w ($15.95 in chips) 
Seat 5: eK8qa6EPcH2zhtbmWSvc9g ($25 in chips) 
Seat 6: gehe91e0IyVT0QU/XBkEyg ($25 in chips) 
Seat 7: iG7VeTyBWf6wYNvZpbTcbw ($17.10 in chips) 
Seat 8: Am29qRe4OYkVWs70NjNDBw ($16.20 in chips) 
Seat 9: PdIasPkzm2sqZnN41ZRXOg ($5.70 in chips) 
gehe91e0IyVT0QU/XBkEyg: posts small blind $0.10
iG7VeTyBWf6wYNvZpbTcbw: posts big blind $0.25
dWgEDExmVO0d+rRmUYCU5w: posts small & big blinds $0.35
*** HOLE CARDS ***
Am29qRe4OYkVWs70NjNDBw: folds 
PdIasPkzm2sqZnN41ZRXOg: folds 
DiSvPC2iudwL5j9u6Huyww: folds 
Am29qRe4OYkVWs70NjNDBw is sitting out
tLcDklc2rBORNfixyRfVfw: raises $1.75 to $2
W2YYHvqjaEpRrO7stZkClQ: folds 
dWgEDExmVO0d+rRmUYCU5w: folds 
Am29qRe4OYkVWs70NjNDBw leaves the table
eK8qa6EPcH2zhtbmWSvc9g: folds 
gehe91e0IyVT0QU/XBkEyg: folds 
iG7VeTyBWf6wYNvZpbTcbw: folds 
Uncalled bet ($1.75) returned to tLcDklc2rBORNfixyRfVfw
tLcDklc2rBORNfixyRfVfw collected $0.95 from pot
tLcDklc2rBORNfixyRfVfw: doesn't show hand 
*** SUMMARY ***
Total pot $0.95 | Rake $0 
Seat 1: DiSvPC2iudwL5j9u6Huyww folded before Flop (didn't bet)
Seat 2: tLcDklc2rBORNfixyRfVfw collected ($0.95)
Seat 3: W2YYHvqjaEpRrO7stZkClQ folded before Flop (didn't bet)
Seat 4: dWgEDExmVO0d+rRmUYCU5w folded before Flop
Seat 5: eK8qa6EPcH2zhtbmWSvc9g (button) folded before Flop (didn't bet)
Seat 6: gehe91e0IyVT0QU/XBkEyg (small blind) folded before Flop
Seat 7: iG7VeTyBWf6wYNvZpbTcbw (big blind) folded before Flop
Seat 8: Am29qRe4OYkVWs70NjNDBw folded before Flop (didn't bet)
Seat 9: PdIasPkzm2sqZnN41ZRXOg folded before Flop (didn't bet)




PokerStars Game #59941713680:  Hold'em No Limit ($0.10/$0.25) - 2009/07/01 1:43:49 ET
Table 'IfRHUn9gQQA9I/Z4tn+BoA' 9-max Seat #3 is the button
Seat 1: imHPFFqvfHGzsBBWeGuy4w ($18.75 in chips) 
Seat 2: VWUWpMLMj/Q1jRVpF7Aohw ($16.95 in chips) 
Seat 3: ModuIAhh03puxW6XFxQ3Nw ($15.90 in chips) 
Seat 4: QEbIGci+itdw+re8RM5fZA ($33.65 in chips) 
Seat 5: DdPXdieucQ+n99u1n3A+rQ ($5 in chips) 
Seat 6: UOjoGGQ58/uDS7V0xkjOrQ ($17.95 in chips) 
Seat 7: YzqSxP03XxZPbgPifgt69g ($29.10 in chips) 
Seat 8: cZ99hugmLBj9KhTlc8nCSw ($27.75 in chips) 
Seat 9: 7cv+9Zc9HIQHNvYsMfV3uA ($47.75 in chips) 
QEbIGci+itdw+re8RM5fZA: posts small blind $0.10
DdPXdieucQ+n99u1n3A+rQ: posts big blind $0.25
*** HOLE CARDS ***
UOjoGGQ58/uDS7V0xkjOrQ: calls $0.25
YzqSxP03XxZPbgPifgt69g: folds 
cZ99hugmLBj9KhTlc8nCSw: folds 
7cv+9Zc9HIQHNvYsMfV3uA: folds 
imHPFFqvfHGzsBBWeGuy4w: raises $0.75 to $1
VWUWpMLMj/Q1jRVpF7Aohw: folds 
ModuIAhh03puxW6XFxQ3Nw: calls $1
QEbIGci+itdw+re8RM5fZA: folds 
DdPXdieucQ+n99u1n3A+rQ: folds 
UOjoGGQ58/uDS7V0xkjOrQ: calls $0.75
*** FLOP *** [Qc 2s 5h]
UOjoGGQ58/uDS7V0xkjOrQ: checks 
imHPFFqvfHGzsBBWeGuy4w: bets $1.25
ModuIAhh03puxW6XFxQ3Nw: calls $1.25
UOjoGGQ58/uDS7V0xkjOrQ: folds 
*** TURN *** [Qc 2s 5h] [6d]
imHPFFqvfHGzsBBWeGuy4w: bets $2.50
ModuIAhh03puxW6XFxQ3Nw: calls $2.50
*** RIVER *** [Qc 2s 5h 6d] [Tc]
imHPFFqvfHGzsBBWeGuy4w: checks 
ModuIAhh03puxW6XFxQ3Nw: checks 
*** SHOW DOWN ***
imHPFFqvfHGzsBBWeGuy4w: shows [Qs Kd] (a pair of Queens)
ModuIAhh03puxW6XFxQ3Nw: mucks hand 
imHPFFqvfHGzsBBWeGuy4w collected $10.35 from pot
*** SUMMARY ***
Total pot $10.85 | Rake $0.50 
Board [Qc 2s 5h 6d Tc]
Seat 1: imHPFFqvfHGzsBBWeGuy4w showed [Qs Kd] and won ($10.35) with a pair of Queens
Seat 2: VWUWpMLMj/Q1jRVpF7Aohw folded before Flop (didn't bet)
Seat 3: ModuIAhh03puxW6XFxQ3Nw (button) mucked
Seat 4: QEbIGci+itdw+re8RM5fZA (small blind) folded before Flop
Seat 5: DdPXdieucQ+n99u1n3A+rQ (big blind) folded before Flop
Seat 6: UOjoGGQ58/uDS7V0xkjOrQ folded on the Flop
Seat 7: YzqSxP03XxZPbgPifgt69g folded before Flop (didn't bet)
Seat 8: cZ99hugmLBj9KhTlc8nCSw folded before Flop (didn't bet)
Seat 9: 7cv+9Zc9HIQHNvYsMfV3uA folded before Flop (didn't bet)




PokerStars Game #59941713602:  Hold'em No Limit ($0.10/$0.25) - 2009/07/01 1:43:49 ET
Table 'sSe6q4YTb/iS19t2eCFdsA' 9-max Seat #1 is the button
Seat 1: hJ4uYjNmSZdjrKA8cjZqCA ($19.50 in chips) 
Seat 2: 3l+i+xMeyDndSXMF2A5CDA ($5 in chips) 
Seat 4: 22dIObOuor/A+IKWkNoAlA ($8.85 in chips) 
Seat 5: qS+jfnNoG75bT+uQ8CKhQA ($10.05 in chips) 
Seat 6: tYsOBqdU1+x+yFI7zHO7hQ ($27.35 in chips) 
Seat 7: t70KGeRtR3naHSqKDixsUg ($4 in chips) 
Seat 8: hvXZ0zFPZFP8Hf6dS36YEw ($15.40 in chips) 
Seat 9: Z9W7+g1WMhhZDi7DwGbCFA ($5 in chips) 
3l+i+xMeyDndSXMF2A5CDA: posts small blind $0.10
bXpVeaSTPBFSPJmeXxO7nw: is sitting out 
22dIObOuor/A+IKWkNoAlA: posts big blind $0.25
*** HOLE CARDS ***
bXpVeaSTPBFSPJmeXxO7nw leaves the table
qS+jfnNoG75bT+uQ8CKhQA: folds 
tYsOBqdU1+x+yFI7zHO7hQ: folds 
OXPkK84/qv92EMwXPiG5rQ joins the table at seat #3 
t70KGeRtR3naHSqKDixsUg: calls $0.25
hvXZ0zFPZFP8Hf6dS36YEw: folds 
Z9W7+g1WMhhZDi7DwGbCFA: folds 
hJ4uYjNmSZdjrKA8cjZqCA: folds 
3l+i+xMeyDndSXMF2A5CDA: calls $0.15
22dIObOuor/A+IKWkNoAlA: checks 
*** FLOP *** [Kh 5d 4c]
3l+i+xMeyDndSXMF2A5CDA: checks 
22dIObOuor/A+IKWkNoAlA: checks 
t70KGeRtR3naHSqKDixsUg: checks 
*** TURN *** [Kh 5d 4c] [5c]
3l+i+xMeyDndSXMF2A5CDA: checks 
22dIObOuor/A+IKWkNoAlA: checks 
t70KGeRtR3naHSqKDixsUg: checks 
*** RIVER *** [Kh 5d 4c 5c] [7c]
3l+i+xMeyDndSXMF2A5CDA: checks 
22dIObOuor/A+IKWkNoAlA: checks 
t70KGeRtR3naHSqKDixsUg: checks 
*** SHOW DOWN ***
3l+i+xMeyDndSXMF2A5CDA: shows [7d 9d] (two pair, Sevens and Fives)
22dIObOuor/A+IKWkNoAlA: mucks hand 
t70KGeRtR3naHSqKDixsUg: shows [5s As] (three of a kind, Fives)
t70KGeRtR3naHSqKDixsUg collected $0.75 from pot
*** SUMMARY ***
Total pot $0.75 | Rake $0 
Board [Kh 5d 4c 5c 7c]
Seat 1: hJ4uYjNmSZdjrKA8cjZqCA (button) folded before Flop (didn't bet)
Seat 2: 3l+i+xMeyDndSXMF2A5CDA (small blind) showed [7d 9d] and lost with two pair, Sevens and Fives
Seat 4: 22dIObOuor/A+IKWkNoAlA (big blind) mucked
Seat 5: qS+jfnNoG75bT+uQ8CKhQA folded before Flop (didn't bet)
Seat 6: tYsOBqdU1+x+yFI7zHO7hQ folded before Flop (didn't bet)
Seat 7: t70KGeRtR3naHSqKDixsUg showed [5s As] and won ($0.75) with three of a kind, Fives
Seat 8: hvXZ0zFPZFP8Hf6dS36YEw folded before Flop (didn't bet)
Seat 9: Z9W7+g1WMhhZDi7DwGbCFA folded before Flop (didn't bet)




PokerStars Game #59941713324:  Hold'em No Limit ($0.10/$0.25) - 2009/07/01 1:43:49 ET
Table 'L5GvbdQO5aCZJSE6pyQ8OA' 6-max Seat #3 is the button
Seat 1: eFj4lr1nuXLyCWNTShr1bg ($11.10 in chips) 
Seat 2: DihMHaz4WNETH1bPDe13kA ($28.70 in chips) 
Seat 3: JFIAqU8lCZ0vWwEl4bdGsg ($27.95 in chips) 
Seat 4: trN/oHqTTbPw5MNuKrOpLw ($28.40 in chips) 
Seat 5: LyDHtw3/yniNHW+DvLXbog ($27 in chips) 
Seat 6: v+QfkGiuj9bgtuNoVnDO8w ($39.40 in chips) 
trN/oHqTTbPw5MNuKrOpLw: posts small blind $0.10
LyDHtw3/yniNHW+DvLXbog: posts big blind $0.25
*** HOLE CARDS ***
v+QfkGiuj9bgtuNoVnDO8w: folds 
eFj4lr1nuXLyCWNTShr1bg: folds 
DihMHaz4WNETH1bPDe13kA: raises $0.50 to $0.75
JFIAqU8lCZ0vWwEl4bdGsg: raises $0.50 to $1.25
trN/oHqTTbPw5MNuKrOpLw: folds 
LyDHtw3/yniNHW+DvLXbog: folds 
DihMHaz4WNETH1bPDe13kA: calls $0.50
*** FLOP *** [7h 7d 7c]
DihMHaz4WNETH1bPDe13kA: checks 
JFIAqU8lCZ0vWwEl4bdGsg: bets $1.25
DihMHaz4WNETH1bPDe13kA: calls $1.25
*** TURN *** [7h 7d 7c] [Jd]
DihMHaz4WNETH1bPDe13kA: checks 
JFIAqU8lCZ0vWwEl4bdGsg: checks 
*** RIVER *** [7h 7d 7c Jd] [Ah]
DihMHaz4WNETH1bPDe13kA: checks 
JFIAqU8lCZ0vWwEl4bdGsg: checks 
*** SHOW DOWN ***
DihMHaz4WNETH1bPDe13kA: shows [8s 8c] (a full house, Sevens full of Eights)
JFIAqU8lCZ0vWwEl4bdGsg: mucks hand 
DihMHaz4WNETH1bPDe13kA collected $5.10 from pot
*** SUMMARY ***
Total pot $5.35 | Rake $0.25 
Board [7h 7d 7c Jd Ah]
Seat 1: eFj4lr1nuXLyCWNTShr1bg folded before Flop (didn't bet)
Seat 2: DihMHaz4WNETH1bPDe13kA showed [8s 8c] and won ($5.10) with a full house, Sevens full of Eights
Seat 3: JFIAqU8lCZ0vWwEl4bdGsg (button) mucked
Seat 4: trN/oHqTTbPw5MNuKrOpLw (small blind) folded before Flop
Seat 5: LyDHtw3/yniNHW+DvLXbog (big blind) folded before Flop
Seat 6: v+QfkGiuj9bgtuNoVnDO8w folded before Flop (didn't bet)




PokerStars Game #59941713494:  Hold'em No Limit ($0.10/$0.25) - 2009/07/01 1:43:49 ET
Table 'LG9H161ZAHDkOww+ih3Ptg' 6-max Seat #1 is the button
Seat 1: avl8CO/tc0F6eVSiB/KNRA ($24.75 in chips) 
Seat 2: kwsRmpZ1ZaLooISs+zfyKg ($25.20 in chips) 
Seat 3: 5Evvx7UYqXTBuvIc/9s/hA ($15.95 in chips) 
Seat 4: 0C28L4/59aRNtHoBhqTcLg ($60.80 in chips) 
Seat 5: lYjWCpfCxX2kgcHY3v4Yow ($30.10 in chips) 
Seat 6: v8m8XHovI5tqEA9mvplDSw ($26.40 in chips) 
kwsRmpZ1ZaLooISs+zfyKg: posts small blind $0.10
5Evvx7UYqXTBuvIc/9s/hA: posts big blind $0.25
*** HOLE CARDS ***
0C28L4/59aRNtHoBhqTcLg: calls $0.25
lYjWCpfCxX2kgcHY3v4Yow: folds 
v8m8XHovI5tqEA9mvplDSw: folds 
avl8CO/tc0F6eVSiB/KNRA: folds 
kwsRmpZ1ZaLooISs+zfyKg: calls $0.15
5Evvx7UYqXTBuvIc/9s/hA: checks 
*** FLOP *** [5c 3h 5d]
kwsRmpZ1ZaLooISs+zfyKg: bets $0.75
5Evvx7UYqXTBuvIc/9s/hA: folds 
0C28L4/59aRNtHoBhqTcLg: folds 
Uncalled bet ($0.75) returned to kwsRmpZ1ZaLooISs+zfyKg
kwsRmpZ1ZaLooISs+zfyKg collected $0.75 from pot
*** SUMMARY ***
Total pot $0.75 | Rake $0 
Board [5c 3h 5d]
Seat 1: avl8CO/tc0F6eVSiB/KNRA (button) folded before Flop (didn't bet)
Seat 2: kwsRmpZ1ZaLooISs+zfyKg (small blind) collected ($0.75)
Seat 3: 5Evvx7UYqXTBuvIc/9s/hA (big blind) folded on the Flop
Seat 4: 0C28L4/59aRNtHoBhqTcLg folded on the Flop
Seat 5: lYjWCpfCxX2kgcHY3v4Yow folded before Flop (didn't bet)
Seat 6: v8m8XHovI5tqEA9mvplDSw folded before Flop (didn't bet)




PokerStars Game #59941713674:  Hold'em No Limit ($0.10/$0.25) - 2009/07/01 1:43:49 ET
Table 'UVjmXTtsmlX1HxwwZ59akg' 9-max Seat #4 is the button
Seat 2: q+Qdg0Hoir+SyL7haBrUnw ($8.05 in chips) 
Seat 3: GmzfAfxcxu1kGbPC+9LkVg ($24.65 in chips) 
Seat 4: X78b5v/uhqeXXoAijbw/yg ($25 in chips) 
Seat 5: Bb42QRQMhg5/Y0vHP8/2Xw ($40.05 in chips) 
Seat 6: st9jtdNbm1W5GfBwRaCVqQ ($24.30 in chips) 
Seat 7: pB8IyCfDFZaVpov3NHEVJg ($25.25 in chips) 
Seat 8: aqxuKnMZWHy08QjWq1+MrQ ($2.75 in chips) 
Bb42QRQMhg5/Y0vHP8/2Xw: posts small blind $0.10
st9jtdNbm1W5GfBwRaCVqQ: posts big blind $0.25
ljemhp25Zg+nlA9DLCIiUw: sits out 
*** HOLE CARDS ***
pB8IyCfDFZaVpov3NHEVJg: folds 
aqxuKnMZWHy08QjWq1+MrQ has timed out
aqxuKnMZWHy08QjWq1+MrQ: folds 
aqxuKnMZWHy08QjWq1+MrQ is sitting out
q+Qdg0Hoir+SyL7haBrUnw: calls $0.25
GmzfAfxcxu1kGbPC+9LkVg: folds 
X78b5v/uhqeXXoAijbw/yg: raises $1 to $1.25
Bb42QRQMhg5/Y0vHP8/2Xw: folds 
st9jtdNbm1W5GfBwRaCVqQ: calls $1
q+Qdg0Hoir+SyL7haBrUnw: folds 
*** FLOP *** [8h 7h Kd]
st9jtdNbm1W5GfBwRaCVqQ: checks 
pB8IyCfDFZaVpov3NHEVJg leaves the table
X78b5v/uhqeXXoAijbw/yg: bets $1.75
st9jtdNbm1W5GfBwRaCVqQ: calls $1.75
*** TURN *** [8h 7h Kd] [Jc]
st9jtdNbm1W5GfBwRaCVqQ: bets $3.65
X78b5v/uhqeXXoAijbw/yg: folds 
Uncalled bet ($3.65) returned to st9jtdNbm1W5GfBwRaCVqQ
st9jtdNbm1W5GfBwRaCVqQ collected $6.05 from pot
st9jtdNbm1W5GfBwRaCVqQ: doesn't show hand 
*** SUMMARY ***
Total pot $6.35 | Rake $0.30 
Board [8h 7h Kd Jc]
Seat 2: q+Qdg0Hoir+SyL7haBrUnw folded before Flop
Seat 3: GmzfAfxcxu1kGbPC+9LkVg folded before Flop (didn't bet)
Seat 4: X78b5v/uhqeXXoAijbw/yg (button) folded on the Turn
Seat 5: Bb42QRQMhg5/Y0vHP8/2Xw (small blind) folded before Flop
Seat 6: st9jtdNbm1W5GfBwRaCVqQ (big blind) collected ($6.05)
Seat 7: pB8IyCfDFZaVpov3NHEVJg folded before Flop (didn't bet)
Seat 8: aqxuKnMZWHy08QjWq1+MrQ folded before Flop (didn't bet)




PokerStars Game #59941714276:  Hold'em No Limit ($0.10/$0.25) - 2009/07/01 1:43:50 ET
Table 'TJS4XvvOjO3k7mH74HJw5g' 9-max Seat #5 is the button
Seat 1: K8I2mpRME07ZlOsT2x75Lg ($5.95 in chips) 
Seat 4: f/e5w8nN3RjdX9H1eRlDdA ($0.80 in chips) 
Seat 5: UlMB386Cfzy3EwurQoBjcA ($10.95 in chips) 
Seat 6: SRik8xyC/rVIBoX7VaOoMA ($14.15 in chips) 
Seat 7: B9u+i1s5aZZkmLTLUopTBg ($14.50 in chips) 
Seat 8: Qv4VzEkN09uD11sjKv02Ig ($17.95 in chips) 
Seat 9: +sbyWwIcFp9kP0bDtMegfQ ($42.65 in chips) 
SRik8xyC/rVIBoX7VaOoMA: posts small blind $0.10
B9u+i1s5aZZkmLTLUopTBg: posts big blind $0.25
yqkowiRWZ6NvRN9UUkYIlA: sits out 
8EbrQ/EvFWt2cr0GaU82gQ: sits out 
*** HOLE CARDS ***
Qv4VzEkN09uD11sjKv02Ig: folds 
+sbyWwIcFp9kP0bDtMegfQ: folds 
K8I2mpRME07ZlOsT2x75Lg: folds 
f/e5w8nN3RjdX9H1eRlDdA: folds 
UlMB386Cfzy3EwurQoBjcA: folds 
SRik8xyC/rVIBoX7VaOoMA: calls $0.15
B9u+i1s5aZZkmLTLUopTBg: checks 
*** FLOP *** [6d 7s Th]
SRik8xyC/rVIBoX7VaOoMA: checks 
B9u+i1s5aZZkmLTLUopTBg: bets $0.75
SRik8xyC/rVIBoX7VaOoMA: folds 
Uncalled bet ($0.75) returned to B9u+i1s5aZZkmLTLUopTBg
B9u+i1s5aZZkmLTLUopTBg collected $0.50 from pot
*** SUMMARY ***
Total pot $0.50 | Rake $0 
Board [6d 7s Th]
Seat 1: K8I2mpRME07ZlOsT2x75Lg folded before Flop (didn't bet)
Seat 4: f/e5w8nN3RjdX9H1eRlDdA folded before Flop (didn't bet)
Seat 5: UlMB386Cfzy3EwurQoBjcA (button) folded before Flop (didn't bet)
Seat 6: SRik8xyC/rVIBoX7VaOoMA (small blind) folded on the Flop
Seat 7: B9u+i1s5aZZkmLTLUopTBg (big blind) collected ($0.50)
Seat 8: Qv4VzEkN09uD11sjKv02Ig folded before Flop (didn't bet)
Seat 9: +sbyWwIcFp9kP0bDtMegfQ folded before Flop (didn't bet)




PokerStars Game #59941713782:  Hold'em No Limit ($0.10/$0.25) - 2009/07/01 1:43:50 ET
Table '63h13e5p7cWe02rClZ1CHw' 6-max Seat #6 is the button
Seat 1: pokjbbEcXXPlADXdSGHtZw ($18.50 in chips) 
Seat 2: k9nHZTHt8hYhYRcW8NTb4g ($30.15 in chips) 
Seat 3: mFv3iBCtrw9XfCDRB0d46Q ($5 in chips) 
Seat 4: xrf8tAXKQHG99HixCot1Iw ($23.70 in chips) 
Seat 5: iyZxqznXjv3vtvOJymkoLQ ($44.80 in chips) 
Seat 6: mfrkWA3PTeYPkbO6hi98Aw ($38.70 in chips) 
pokjbbEcXXPlADXdSGHtZw: posts small blind $0.10
k9nHZTHt8hYhYRcW8NTb4g: posts big blind $0.25
*** HOLE CARDS ***
mFv3iBCtrw9XfCDRB0d46Q: folds 
xrf8tAXKQHG99HixCot1Iw: folds 
iyZxqznXjv3vtvOJymkoLQ: folds 
mfrkWA3PTeYPkbO6hi98Aw: raises $0.75 to $1
pokjbbEcXXPlADXdSGHtZw: folds 
k9nHZTHt8hYhYRcW8NTb4g: folds 
Uncalled bet ($0.75) returned to mfrkWA3PTeYPkbO6hi98Aw
mfrkWA3PTeYPkbO6hi98Aw collected $0.60 from pot
mfrkWA3PTeYPkbO6hi98Aw: doesn't show hand 
*** SUMMARY ***
Total pot $0.60 | Rake $0 
Seat 1: pokjbbEcXXPlADXdSGHtZw (small blind) folded before Flop
Seat 2: k9nHZTHt8hYhYRcW8NTb4g (big blind) folded before Flop
Seat 3: mFv3iBCtrw9XfCDRB0d46Q folded before Flop (didn't bet)
Seat 4: xrf8tAXKQHG99HixCot1Iw folded before Flop (didn't bet)
Seat 5: iyZxqznXjv3vtvOJymkoLQ folded before Flop (didn't bet)
Seat 6: mfrkWA3PTeYPkbO6hi98Aw (button) collected ($0.60)




PokerStars Game #59941713930:  Hold'em No Limit ($0.10/$0.25) - 2009/07/01 1:43:50 ET
Table 'Y9EhDWuqWWQFM9SelXAj5g' 9-max Seat #8 is the button
Seat 2: W+njF1UnarGN2q2zP+R+cg ($9 in chips) 
Seat 3: zgi+EUykT/pZQpoUG6+oEg ($7.40 in chips) 
Seat 4: V6p0jQ/RhUsqpHLmXvEX4Q ($13.35 in chips) 
Seat 5: CvL9Ch1HYCVbTsfpNucitg ($5.45 in chips) 
Seat 6: egvg3mTBBVzMHnJPIQiKcA ($14 in chips) 
Seat 7: aNpwfA31EREwO+ar4XzBCw ($26.60 in chips) 
Seat 8: XDxyajtqmdag0QPvwcOG7Q ($11.10 in chips) 
Seat 9: bOrfviVhRBpaOfMqUc74Tw ($21.70 in chips) 
bOrfviVhRBpaOfMqUc74Tw: posts small blind $0.10
W+njF1UnarGN2q2zP+R+cg: posts big blind $0.25
*** HOLE CARDS ***
zgi+EUykT/pZQpoUG6+oEg: folds 
zgi+EUykT/pZQpoUG6+oEg leaves the table
V6p0jQ/RhUsqpHLmXvEX4Q: folds 
CvL9Ch1HYCVbTsfpNucitg: folds 
egvg3mTBBVzMHnJPIQiKcA: folds 
aNpwfA31EREwO+ar4XzBCw: folds 
XDxyajtqmdag0QPvwcOG7Q: folds 
bOrfviVhRBpaOfMqUc74Tw: calls $0.15
W+njF1UnarGN2q2zP+R+cg: checks 
*** FLOP *** [7c 4h 3d]
bOrfviVhRBpaOfMqUc74Tw: bets $0.25
W+njF1UnarGN2q2zP+R+cg: calls $0.25
*** TURN *** [7c 4h 3d] [Qd]
bOrfviVhRBpaOfMqUc74Tw: bets $0.50
W+njF1UnarGN2q2zP+R+cg: folds 
Uncalled bet ($0.50) returned to bOrfviVhRBpaOfMqUc74Tw
bOrfviVhRBpaOfMqUc74Tw collected $0.95 from pot
bOrfviVhRBpaOfMqUc74Tw: doesn't show hand 
*** SUMMARY ***
Total pot $1 | Rake $0.05 
Board [7c 4h 3d Qd]
Seat 2: W+njF1UnarGN2q2zP+R+cg (big blind) folded on the Turn
Seat 3: zgi+EUykT/pZQpoUG6+oEg folded before Flop (didn't bet)
Seat 4: V6p0jQ/RhUsqpHLmXvEX4Q folded before Flop (didn't bet)
Seat 5: CvL9Ch1HYCVbTsfpNucitg folded before Flop (didn't bet)
Seat 6: egvg3mTBBVzMHnJPIQiKcA folded before Flop (didn't bet)
Seat 7: aNpwfA31EREwO+ar4XzBCw folded before Flop (didn't bet)
Seat 8: XDxyajtqmdag0QPvwcOG7Q (button) folded before Flop (didn't bet)
Seat 9: bOrfviVhRBpaOfMqUc74Tw (small blind) collected ($0.95)




PokerStars Game #59941713872:  Hold'em No Limit ($0.10/$0.25) - 2009/07/01 1:43:50 ET
Table 'sm5gqEvXgLbkkE4dryW/5g' 6-max Seat #6 is the button
Seat 1: v8m8XHovI5tqEA9mvplDSw ($41.30 in chips) 
Seat 2: 5xs5/u2z1CO9zkRvH72MQg ($19.50 in chips) 
Seat 3: UT5XpwOH1ipkOF7n1MqDJA ($21.40 in chips) 
Seat 4: cWc85bEzdRzpUMhRKm8pwQ ($26.75 in chips) 
Seat 6: aogAb4Eienxztk8p2v9VVw ($19.05 in chips) 
v8m8XHovI5tqEA9mvplDSw: posts small blind $0.10
5xs5/u2z1CO9zkRvH72MQg: posts big blind $0.25
*** HOLE CARDS ***
UT5XpwOH1ipkOF7n1MqDJA: folds 
cWc85bEzdRzpUMhRKm8pwQ: raises $0.75 to $1
aogAb4Eienxztk8p2v9VVw: raises $1.75 to $2.75
v8m8XHovI5tqEA9mvplDSw: folds 
5xs5/u2z1CO9zkRvH72MQg: folds 
cWc85bEzdRzpUMhRKm8pwQ: folds 
Uncalled bet ($1.75) returned to aogAb4Eienxztk8p2v9VVw
aogAb4Eienxztk8p2v9VVw collected $2.35 from pot
aogAb4Eienxztk8p2v9VVw: doesn't show hand 
*** SUMMARY ***
Total pot $2.35 | Rake $0 
Seat 1: v8m8XHovI5tqEA9mvplDSw (small blind) folded before Flop
Seat 2: 5xs5/u2z1CO9zkRvH72MQg (big blind) folded before Flop
Seat 3: UT5XpwOH1ipkOF7n1MqDJA folded before Flop (didn't bet)
Seat 4: cWc85bEzdRzpUMhRKm8pwQ folded before Flop
Seat 6: aogAb4Eienxztk8p2v9VVw (button) collected ($2.35)




PokerStars Game #59941714078:  Hold'em No Limit ($0.10/$0.25) - 2009/07/01 1:43:50 ET
Table 'VuY5ej47Cy8nOI3Wogmhzw' 6-max Seat #2 is the button
Seat 1: EeUZtMU058v2ObUACOF4Og ($37.85 in chips) 
Seat 2: AM6Yl+3esmhhMBlSnQhWbg ($18.10 in chips) 
Seat 3: v+QfkGiuj9bgtuNoVnDO8w ($29.40 in chips) 
Seat 4: QqiZLFrN8iOUT/GHw7ztOA ($25 in chips) 
Seat 5: iK/41//HmnLiIn0CVNNfyA ($12.70 in chips) 
v+QfkGiuj9bgtuNoVnDO8w: posts small blind $0.10
QqiZLFrN8iOUT/GHw7ztOA: posts big blind $0.25
*** HOLE CARDS ***
iK/41//HmnLiIn0CVNNfyA: folds 
Perse1 leaves the table
EeUZtMU058v2ObUACOF4Og: folds 
AM6Yl+3esmhhMBlSnQhWbg: folds 
v+QfkGiuj9bgtuNoVnDO8w: folds 
Uncalled bet ($0.15) returned to QqiZLFrN8iOUT/GHw7ztOA
+KblIivb6tainScpwm14RQ joins the table at seat #6 
QqiZLFrN8iOUT/GHw7ztOA collected $0.20 from pot
*** SUMMARY ***
Total pot $0.20 | Rake $0 
Seat 1: EeUZtMU058v2ObUACOF4Og folded before Flop (didn't bet)
Seat 2: AM6Yl+3esmhhMBlSnQhWbg (button) folded before Flop (didn't bet)
Seat 3: v+QfkGiuj9bgtuNoVnDO8w (small blind) folded before Flop
Seat 4: QqiZLFrN8iOUT/GHw7ztOA (big blind) collected ($0.20)
Seat 5: iK/41//HmnLiIn0CVNNfyA folded before Flop (didn't bet)




PokerStars Game #59941713874:  Hold'em No Limit ($0.10/$0.25) - 2009/07/01 1:43:50 ET
Table 'MiquQrQZJJq9ZtgRIp9HFQ' 6-max Seat #4 is the button
Seat 1: c3J/KYZ4cNsUEuz8v57I5A ($25.05 in chips) 
Seat 3: Hsvkc0/G2VV78oVmWYXecw ($15.65 in chips) 
Seat 4: wAKC8C/zN0c8V5v13dm9mA ($57.95 in chips) 
Seat 5: iyZxqznXjv3vtvOJymkoLQ ($26.85 in chips) 
Seat 6: GbCVUNssQ7mqsPWr7J4d3w ($5 in chips) 
iyZxqznXjv3vtvOJymkoLQ: posts small blind $0.10
GbCVUNssQ7mqsPWr7J4d3w: posts big blind $0.25
2+6voGl1T1DO63JePptI3g: sits out 
*** HOLE CARDS ***
c3J/KYZ4cNsUEuz8v57I5A: folds 
Hsvkc0/G2VV78oVmWYXecw: folds 
Hsvkc0/G2VV78oVmWYXecw leaves the table
wAKC8C/zN0c8V5v13dm9mA: folds 
iyZxqznXjv3vtvOJymkoLQ: folds 
Uncalled bet ($0.15) returned to GbCVUNssQ7mqsPWr7J4d3w
GbCVUNssQ7mqsPWr7J4d3w collected $0.20 from pot
GbCVUNssQ7mqsPWr7J4d3w: doesn't show hand 
*** SUMMARY ***
Total pot $0.20 | Rake $0 
Seat 1: c3J/KYZ4cNsUEuz8v57I5A folded before Flop (didn't bet)
Seat 3: Hsvkc0/G2VV78oVmWYXecw folded before Flop (didn't bet)
Seat 4: wAKC8C/zN0c8V5v13dm9mA (button) folded before Flop (didn't bet)
Seat 5: iyZxqznXjv3vtvOJymkoLQ (small blind) folded before Flop
Seat 6: GbCVUNssQ7mqsPWr7J4d3w (big blind) collected ($0.20)




PokerStars Game #59941713866:  Hold'em No Limit ($0.10/$0.25) - 2009/07/01 1:43:50 ET
Table 'LwnjzXstPtSrqrV/oDpnXQ' 9-max Seat #9 is the button
Seat 1: 9YN2IkT2JYYKFErZtZvCtA ($18.55 in chips) 
Seat 2: uLP/lYn7oKq9xCChBXsXxw ($27 in chips) 
Seat 3: 7je+LC5Mfs6nL8YBVh4frQ ($4.30 in chips) 
Seat 4: CmngQmkKTp8tkl6GMRTl6w ($9.60 in chips) 
Seat 5: Th3FldXKQW6hWVVPahaoOQ ($25 in chips) 
Seat 6: ljemhp25Zg+nlA9DLCIiUw ($39.85 in chips) 
Seat 7: c/Dw/6HyqldTzIRodAIZmg ($13.75 in chips) 
Seat 8: ShXPHWfjhfmAwLgDdm6bRQ ($12.35 in chips) 
Seat 9: q6WfTUAD9mowIP63ASq2Dgz/khFDKGihQjwgoiKKPOeg35 in chips) 
9YN2IkT2JYYKFErZtZvCtA: posts small blind $0.10
uLP/lYn7oKq9xCChBXsXxw: posts big blind $0.25
*** HOLE CARDS ***
7je+LC5Mfs6nL8YBVh4frQ: folds 
CmngQmkKTp8tkl6GMRTl6w: folds 
Th3FldXKQW6hWVVPahaoOQ: folds 
ljemhp25Zg+nlA9DLCIiUw: folds 
c/Dw/6HyqldTzIRodAIZmg: folds 
ShXPHWfjhfmAwLgDdm6bRQ: folds 
q6WfTUAD9mowIP63ASq2Dgz/khFDKGihQjwgoiKKPOeges $0.50 to $0.75
9YN2IkT2JYYKFErZtZvCtA: folds 
uLP/lYn7oKq9xCChBXsXxw: folds 
Uncalled bet ($0.50) returned to q6WfTUAD9mowIP63ASq2Dgz/khFDKGihQjwgoiKKPOegq6WfTUAD9mowIP63ASq2Dgt collected $0.60 from pot
q6WfTUAD9mowIP63ASq2Dgz/khFDKGihQjwgoiKKPOegn't show hand 
*** SUMMARY ***
Total pot $0.60 | Rake $0 
Seat 1: 9YN2IkT2JYYKFErZtZvCtA (small blind) folded before Flop
Seat 2: uLP/lYn7oKq9xCChBXsXxw (big blind) folded before Flop
Seat 3: 7je+LC5Mfs6nL8YBVh4frQ folded before Flop (didn't bet)
Seat 4: CmngQmkKTp8tkl6GMRTl6w folded before Flop (didn't bet)
Seat 5: Th3FldXKQW6hWVVPahaoOQ folded before Flop (didn't bet)
Seat 6: ljemhp25Zg+nlA9DLCIiUw folded before Flop (didn't bet)
Seat 7: c/Dw/6HyqldTzIRodAIZmg folded before Flop (didn't bet)
Seat 8: ShXPHWfjhfmAwLgDdm6bRQ folded before Flop (didn't bet)
Seat 9: q6WfTUAD9mowIP63ASq2Dgz/khFDKGihQjwgoiKKPOegon) collected ($0.60)




PokerStars Game #59941714226:  Hold'em No Limit ($0.10/$0.25) - 2009/07/01 1:43:50 ET
Table 'Of/T60zpXg1GcjrZ7Lm//Q' 9-max Seat #4 is the button
Seat 1: Lro4e37x4FUa5P3yzDjskw ($18.20 in chips) 
Seat 2: qwr38jl5txoR36M7G5qi4A ($9.90 in chips) 
Seat 3: 6RiVTYll/5D8zICp0MRpKw ($25 in chips) 
Seat 4: Czut6V7acIqUJrrobjKAZg ($16.90 in chips) 
Seat 5: IiLkthQMEje9LS79rCFQ1Q ($9.20 in chips) 
Seat 6: tYsOBqdU1+x+yFI7zHO7hQ ($31.05 in chips) 
Seat 7: PVxvfRTRvkgZf9WtquEkwQ ($25 in chips) 
Seat 8: ghNKXUBl/H+t83JF079ZBA ($26.50 in chips) 
Seat 9: egvg3mTBBVzMHnJPIQiKcA ($16.40 in chips) 
IiLkthQMEje9LS79rCFQ1Q: posts small blind $0.10
tYsOBqdU1+x+yFI7zHO7hQ: posts big blind $0.25
*** HOLE CARDS ***
PVxvfRTRvkgZf9WtquEkwQ: folds 
ghNKXUBl/H+t83JF079ZBA: folds 
egvg3mTBBVzMHnJPIQiKcA: folds 
Lro4e37x4FUa5P3yzDjskw: folds 
qwr38jl5txoR36M7G5qi4A: folds 
6RiVTYll/5D8zICp0MRpKw has timed out
6RiVTYll/5D8zICp0MRpKw: folds 
6RiVTYll/5D8zICp0MRpKw is sitting out
Czut6V7acIqUJrrobjKAZg: calls $0.25
6RiVTYll/5D8zICp0MRpKw has returned
IiLkthQMEje9LS79rCFQ1Q: calls $0.15
tYsOBqdU1+x+yFI7zHO7hQ: raises $1.25 to $1.50
Czut6V7acIqUJrrobjKAZg: folds 
IiLkthQMEje9LS79rCFQ1Q: folds 
Uncalled bet ($1.25) returned to tYsOBqdU1+x+yFI7zHO7hQ
tYsOBqdU1+x+yFI7zHO7hQ collected $0.75 from pot
tYsOBqdU1+x+yFI7zHO7hQ: doesn't show hand 
*** SUMMARY ***
Total pot $0.75 | Rake $0 
Seat 1: Lro4e37x4FUa5P3yzDjskw folded before Flop (didn't bet)
Seat 2: qwr38jl5txoR36M7G5qi4A folded before Flop (didn't bet)
Seat 3: 6RiVTYll/5D8zICp0MRpKw folded before Flop (didn't bet)
Seat 4: Czut6V7acIqUJrrobjKAZg (button) folded before Flop
Seat 5: IiLkthQMEje9LS79rCFQ1Q (small blind) folded before Flop
Seat 6: tYsOBqdU1+x+yFI7zHO7hQ (big blind) collected ($0.75)
Seat 7: PVxvfRTRvkgZf9WtquEkwQ folded before Flop (didn't bet)
Seat 8: ghNKXUBl/H+t83JF079ZBA folded before Flop (didn't bet)
Seat 9: egvg3mTBBVzMHnJPIQiKcA folded before Flop (didn't bet)




PokerStars Game #59941714466:  Hold'em No Limit ($0.10/$0.25) - 2009/07/01 1:43:51 ET
Table '+giHa6FUL6U5/AZnCJEGvQ' 9-max Seat #4 is the button
Seat 4: 10f7J+bM02ZfDHx0PgkNSg ($13.75 in chips) 
Seat 6: GTMnTen6sQSoCpS9sggLbg ($25.95 in chips) 
10f7J+bM02ZfDHx0PgkNSg: posts small blind $0.10
GTMnTen6sQSoCpS9sggLbg: posts big blind $0.25
*** HOLE CARDS ***
10f7J+bM02ZfDHx0PgkNSg: calls $0.15
GTMnTen6sQSoCpS9sggLbg: checks 
*** FLOP *** [2d 7d 5c]
VULTURE187 joins the table at seat #9 
VULTURE187 leaves the table
GTMnTen6sQSoCpS9sggLbg: checks 
10f7J+bM02ZfDHx0PgkNSg: checks 
*** TURN *** [2d 7d 5c] [Jd]
GTMnTen6sQSoCpS9sggLbg: bets $0.50
10f7J+bM02ZfDHx0PgkNSg: calls $0.50
*** RIVER *** [2d 7d 5c Jd] [9s]
GTMnTen6sQSoCpS9sggLbg: checks 
10f7J+bM02ZfDHx0PgkNSg: bets $2
GTMnTen6sQSoCpS9sggLbg: folds 
Uncalled bet ($2) returned to 10f7J+bM02ZfDHx0PgkNSg
10f7J+bM02ZfDHx0PgkNSg collected $1.45 from pot
10f7J+bM02ZfDHx0PgkNSg: doesn't show hand 
*** SUMMARY ***
Total pot $1.50 | Rake $0.05 
Board [2d 7d 5c Jd 9s]
Seat 4: 10f7J+bM02ZfDHx0PgkNSg (button) (small blind) collected ($1.45)
Seat 6: GTMnTen6sQSoCpS9sggLbg (big blind) folded on the River




PokerStars Game #59941714462:  Hold'em No Limit ($0.10/$0.25) - 2009/07/01 1:43:51 ET
Table 'sDHjMRwfSiz7+NDdZLUiyA' 9-max Seat #4 is the button
Seat 1: VGwr1eqhvdUtMfBFCvBnmg ($8.25 in chips) 
Seat 2: ljemhp25Zg+nlA9DLCIiUw ($28.20 in chips) 
Seat 3: SGA1WpAnQxFdFAYyt362gQ ($18.05 in chips) 
Seat 4: eK8qa6EPcH2zhtbmWSvc9g ($25 in chips) 
Seat 5: IGRfskE1v9H9Bn+fz8AgNQ ($37.15 in chips) 
Seat 6: 1qa0qHOCKZM3Uipx9DxYtQ ($16.15 in chips) 
Seat 7: K0b5wNInj6hUGRr6yzKFtw ($37.65 in chips) 
Seat 8: 3hMkm4U5yTRrkGJkxfijaQ ($2.90 in chips) 
Seat 9: 3PmVnC/15cl4oyI1TKIt4g ($4.05 in chips) 
IGRfskE1v9H9Bn+fz8AgNQ: posts small blind $0.10
1qa0qHOCKZM3Uipx9DxYtQ: posts big blind $0.25
*** HOLE CARDS ***
K0b5wNInj6hUGRr6yzKFtw: folds 
3hMkm4U5yTRrkGJkxfijaQ: folds 
3PmVnC/15cl4oyI1TKIt4g: folds 
VGwr1eqhvdUtMfBFCvBnmg: calls $0.25
ljemhp25Zg+nlA9DLCIiUw: raises $0.75 to $1
SGA1WpAnQxFdFAYyt362gQ: folds 
eK8qa6EPcH2zhtbmWSvc9g: folds 
IGRfskE1v9H9Bn+fz8AgNQ: folds 
1qa0qHOCKZM3Uipx9DxYtQ: folds 
VGwr1eqhvdUtMfBFCvBnmg: calls $0.75
*** FLOP *** [6h Tc Qh]
VGwr1eqhvdUtMfBFCvBnmg: checks 
ljemhp25Zg+nlA9DLCIiUw: bets $1.50
VGwr1eqhvdUtMfBFCvBnmg: calls $1.50
*** TURN *** [6h Tc Qh] [Kd]
VGwr1eqhvdUtMfBFCvBnmg: checks 
ljemhp25Zg+nlA9DLCIiUw: checks 
*** RIVER *** [6h Tc Qh Kd] [9h]
VGwr1eqhvdUtMfBFCvBnmg: bets $3.50
ljemhp25Zg+nlA9DLCIiUw: folds 
Uncalled bet ($3.50) returned to VGwr1eqhvdUtMfBFCvBnmg
VGwr1eqhvdUtMfBFCvBnmg collected $5.10 from pot
VGwr1eqhvdUtMfBFCvBnmg: doesn't show hand 
*** SUMMARY ***
Total pot $5.35 | Rake $0.25 
Board [6h Tc Qh Kd 9h]
Seat 1: VGwr1eqhvdUtMfBFCvBnmg collected ($5.10)
Seat 2: ljemhp25Zg+nlA9DLCIiUw folded on the River
Seat 3: SGA1WpAnQxFdFAYyt362gQ folded before Flop (didn't bet)
Seat 4: eK8qa6EPcH2zhtbmWSvc9g (button) folded before Flop (didn't bet)
Seat 5: IGRfskE1v9H9Bn+fz8AgNQ (small blind) folded before Flop
Seat 6: 1qa0qHOCKZM3Uipx9DxYtQ (big blind) folded before Flop
Seat 7: K0b5wNInj6hUGRr6yzKFtw folded before Flop (didn't bet)
Seat 8: 3hMkm4U5yTRrkGJkxfijaQ folded before Flop (didn't bet)
Seat 9: 3PmVnC/15cl4oyI1TKIt4g folded before Flop (didn't bet)




PokerStars Game #59941714470:  Hold'em No Limit ($0.10/$0.25) - 2009/07/01 1:43:51 ET
Table 'WjNvuuSgTjm8jh0j9vcCgQ' 9-max Seat #7 is the button
Seat 1: q+Qdg0Hoir+SyL7haBrUnw ($8.05 in chips) 
Seat 2: ghNKXUBl/H+t83JF079ZBA ($23.40 in chips) 
Seat 3: pSKReiGBNW9NsF2jAZnlwg ($22.35 in chips) 
Seat 4: X78b5v/uhqeXXoAijbw/yg ($31.35 in chips) 
Seat 5: ziFpkH3wCzqB/qXeq/Hy7g ($25 in chips) 
Seat 6: ubsjZomMWSV0hAiBLa7K1A ($21.25 in chips) 
Seat 7: NSX8YOj+RznxoL+rO1YU4w ($12.90 in chips) 
Seat 8: hZuGwtYmFKPmQ+v1wlmdfA ($17.50 in chips) 
Seat 9: CT7Xj/V/O5rBlhtt+RZeFQ ($25.60 in chips) 
hZuGwtYmFKPmQ+v1wlmdfA: posts small blind $0.10
CT7Xj/V/O5rBlhtt+RZeFQ: posts big blind $0.25
*** HOLE CARDS ***
q+Qdg0Hoir+SyL7haBrUnw: folds 
ghNKXUBl/H+t83JF079ZBA: folds 
pSKReiGBNW9NsF2jAZnlwg: folds 
X78b5v/uhqeXXoAijbw/yg: folds 
ziFpkH3wCzqB/qXeq/Hy7g: raises $0.75 to $1
ubsjZomMWSV0hAiBLa7K1A: folds 
NSX8YOj+RznxoL+rO1YU4w: calls $1
hZuGwtYmFKPmQ+v1wlmdfA: folds 
CT7Xj/V/O5rBlhtt+RZeFQ: folds 
*** FLOP *** [7c 8d 4h]
ziFpkH3wCzqB/qXeq/Hy7g: bets $1.25
NSX8YOj+RznxoL+rO1YU4w: calls $1.25
*** TURN *** [7c 8d 4h] [Ks]
ziFpkH3wCzqB/qXeq/Hy7g: bets $2.25
NSX8YOj+RznxoL+rO1YU4w: raises $2.25 to $4.50
ziFpkH3wCzqB/qXeq/Hy7g: folds 
Uncalled bet ($2.25) returned to NSX8YOj+RznxoL+rO1YU4w
NSX8YOj+RznxoL+rO1YU4w collected $8.90 from pot
NSX8YOj+RznxoL+rO1YU4w: doesn't show hand 
*** SUMMARY ***
Total pot $9.35 | Rake $0.45 
Board [7c 8d 4h Ks]
Seat 1: q+Qdg0Hoir+SyL7haBrUnw folded before Flop (didn't bet)
Seat 2: ghNKXUBl/H+t83JF079ZBA folded before Flop (didn't bet)
Seat 3: pSKReiGBNW9NsF2jAZnlwg folded before Flop (didn't bet)
Seat 4: X78b5v/uhqeXXoAijbw/yg folded before Flop (didn't bet)
Seat 5: ziFpkH3wCzqB/qXeq/Hy7g folded on the Turn
Seat 6: ubsjZomMWSV0hAiBLa7K1A folded before Flop (didn't bet)
Seat 7: NSX8YOj+RznxoL+rO1YU4w (button) collected ($8.90)
Seat 8: hZuGwtYmFKPmQ+v1wlmdfA (small blind) folded before Flop
Seat 9: CT7Xj/V/O5rBlhtt+RZeFQ (big blind) folded before Flop




PokerStars Game #59941714880:  Hold'em No Limit ($0.10/$0.25) - 2009/07/01 1:43:51 ET
Table 'jz4TpuH+ag+0iNe2ZcxckQ' 9-max Seat #4 is the button
Seat 1: +C3eP/ysyROWbEXJFPswVA ($12.45 in chips) 
Seat 2: clJsV3v77RS07bDKY+705w ($5 in chips) 
Seat 3: egvg3mTBBVzMHnJPIQiKcA ($13.40 in chips) 
Seat 4: k+2r6di6GXjNpAdrRkW9bA ($59.65 in chips) 
Seat 5: v1BVHNGLbP/nx7QO6K7+Jw ($30.15 in chips) 
Seat 6: gO1uiTGTzn5Cd3PECuws1g ($14 in chips) 
Seat 7: tLcDklc2rBORNfixyRfVfw ($32 in chips) 
Seat 8: uhrboV251dcgYniYTdFIcA ($25 in chips) 
Seat 9: W2YYHvqjaEpRrO7stZkClQ ($5.80 in chips) 
v1BVHNGLbP/nx7QO6K7+Jw: posts small blind $0.10
gO1uiTGTzn5Cd3PECuws1g: posts big blind $0.25
clJsV3v77RS07bDKY+705w: posts big blind $0.25
*** HOLE CARDS ***
+C3eP/ysyROWbEXJFPswVA said, "donkey"
tLcDklc2rBORNfixyRfVfw: folds 
uhrboV251dcgYniYTdFIcA: folds 
W2YYHvqjaEpRrO7stZkClQ: folds 
+C3eP/ysyROWbEXJFPswVA: folds 
clJsV3v77RS07bDKY+705w: checks 
egvg3mTBBVzMHnJPIQiKcA: calls $0.25
k+2r6di6GXjNpAdrRkW9bA: folds 
v1BVHNGLbP/nx7QO6K7+Jw: calls $0.15
gO1uiTGTzn5Cd3PECuws1g: checks 
*** FLOP *** [As Tc 6s]
v1BVHNGLbP/nx7QO6K7+Jw: checks 
gO1uiTGTzn5Cd3PECuws1g: checks 
clJsV3v77RS07bDKY+705w: checks 
egvg3mTBBVzMHnJPIQiKcA: bets $0.75
v1BVHNGLbP/nx7QO6K7+Jw: folds 
gO1uiTGTzn5Cd3PECuws1g: folds 
clJsV3v77RS07bDKY+705w: folds 
Uncalled bet ($0.75) returned to egvg3mTBBVzMHnJPIQiKcA
egvg3mTBBVzMHnJPIQiKcA collected $0.95 from pot
*** SUMMARY ***
Total pot $1 | Rake $0.05 
Board [As Tc 6s]
Seat 1: +C3eP/ysyROWbEXJFPswVA folded before Flop (didn't bet)
Seat 2: clJsV3v77RS07bDKY+705w folded on the Flop
Seat 3: egvg3mTBBVzMHnJPIQiKcA collected ($0.95)
Seat 4: k+2r6di6GXjNpAdrRkW9bA (button) folded before Flop (didn't bet)
Seat 5: v1BVHNGLbP/nx7QO6K7+Jw (small blind) folded on the Flop
Seat 6: gO1uiTGTzn5Cd3PECuws1g (big blind) folded on the Flop
Seat 7: tLcDklc2rBORNfixyRfVfw folded before Flop (didn't bet)
Seat 8: uhrboV251dcgYniYTdFIcA folded before Flop (didn't bet)
Seat 9: W2YYHvqjaEpRrO7stZkClQ folded before Flop (didn't bet)




PokerStars Game #59941714482:  Hold'em No Limit ($0.10/$0.25) - 2009/07/01 1:43:51 ET
Table 'nQC9LRg01NEuKFHF1nrDEw0XPo7K54oZIfG0xlNAcDRw-max Seat #5 is the button
Seat 1: qf+LMbROj8/qY878wkFHbQ ($14.40 in chips) 
Seat 2: ZhV6dUX9NQhT4zf7t+ZLJg ($24.75 in chips) 
Seat 3: 6+g0Lb6vfRDZkElV8ieHyQ ($24.85 in chips) 
Seat 5: kG34n23qFQA3nzdOJTQ1dA ($29.30 in chips) 
Seat 6: xQVFeVUDopz+akuEo2wXpQ ($53.25 in chips) 
xQVFeVUDopz+akuEo2wXpQ: posts small blind $0.10
qf+LMbROj8/qY878wkFHbQ: posts big blind $0.25
*** HOLE CARDS ***
ZhV6dUX9NQhT4zf7t+ZLJg: folds 
6+g0Lb6vfRDZkElV8ieHyQ: folds 
kG34n23qFQA3nzdOJTQ1dA: calls $0.25
xQVFeVUDopz+akuEo2wXpQ: calls $0.15
qf+LMbROj8/qY878wkFHbQ: checks 
*** FLOP *** [4s Th Kd]
xQVFeVUDopz+akuEo2wXpQ: checks 
qf+LMbROj8/qY878wkFHbQ: bets $0.50
kG34n23qFQA3nzdOJTQ1dA: folds 
xQVFeVUDopz+akuEo2wXpQ: folds 
Uncalled bet ($0.50) returned to qf+LMbROj8/qY878wkFHbQ
qf+LMbROj8/qY878wkFHbQ collected $0.75 from pot
qf+LMbROj8/qY878wkFHbQ: doesn't show hand 
*** SUMMARY ***
Total pot $0.75 | Rake $0 
Board [4s Th Kd]
Seat 1: qf+LMbROj8/qY878wkFHbQ (big blind) collected ($0.75)
Seat 2: ZhV6dUX9NQhT4zf7t+ZLJg folded before Flop (didn't bet)
Seat 3: 6+g0Lb6vfRDZkElV8ieHyQ folded before Flop (didn't bet)
Seat 5: kG34n23qFQA3nzdOJTQ1dA (button) folded on the Flop
Seat 6: xQVFeVUDopz+akuEo2wXpQ (small blind) folded on the Flop




PokerStars Game #59941714566:  Hold'em No Limit ($0.10/$0.25) - 2009/07/01 1:43:51 ET
Table 'DhkrdW2UOy2PfjSW28Kq8w' 6-max Seat #5 is the button
Seat 2: v+QfkGiuj9bgtuNoVnDO8w ($25 in chips) 
Seat 3: B3X187C0tXFUfQpCu8pe8A ($22.90 in chips) 
Seat 4: 59HJSCM1X37BkMpI9N0mEw ($25 in chips) 
Seat 5: SxIIgwXYLkwd6m3wLyPTCw ($51 in chips) 
Seat 6: DihMHaz4WNETH1bPDe13kA ($25.15 in chips) 
DihMHaz4WNETH1bPDe13kA: posts small blind $0.10
vu2kzHaDtgr6NM7rdq0chA: is sitting out 
v+QfkGiuj9bgtuNoVnDO8w: posts big blind $0.25
*** HOLE CARDS ***
vu2kzHaDtgr6NM7rdq0chA leaves the table
B3X187C0tXFUfQpCu8pe8A: calls $0.25
59HJSCM1X37BkMpI9N0mEw: folds 
StevenWu joins the table at seat #1 
SxIIgwXYLkwd6m3wLyPTCw: folds 
DihMHaz4WNETH1bPDe13kA: raises $1 to $1.25
v+QfkGiuj9bgtuNoVnDO8w: folds 
B3X187C0tXFUfQpCu8pe8A: calls $1
*** FLOP *** [9d 2d 5c]
DihMHaz4WNETH1bPDe13kA: checks 
B3X187C0tXFUfQpCu8pe8A: checks 
*** TURN *** [9d 2d 5c] [2h]
DihMHaz4WNETH1bPDe13kA: checks 
B3X187C0tXFUfQpCu8pe8A: checks 
*** RIVER *** [9d 2d 5c 2h] [8h]
59HJSCM1X37BkMpI9N0mEw is sitting out
DihMHaz4WNETH1bPDe13kA: checks 
B3X187C0tXFUfQpCu8pe8A: checks 
*** SHOW DOWN ***
DihMHaz4WNETH1bPDe13kA: shows [Ah Qh] (a pair of Deuces)
B3X187C0tXFUfQpCu8pe8A: mucks hand 
DihMHaz4WNETH1bPDe13kA collected $2.65 from pot
*** SUMMARY ***
Total pot $2.75 | Rake $0.10 
Board [9d 2d 5c 2h 8h]
Seat 2: v+QfkGiuj9bgtuNoVnDO8w (big blind) folded before Flop
Seat 3: B3X187C0tXFUfQpCu8pe8A mucked
Seat 4: 59HJSCM1X37BkMpI9N0mEw folded before Flop (didn't bet)
Seat 5: SxIIgwXYLkwd6m3wLyPTCw (button) folded before Flop (didn't bet)
Seat 6: DihMHaz4WNETH1bPDe13kA (small blind) showed [Ah Qh] and won ($2.65) with a pair of Deuces




PokerStars Game #59941714802:  Hold'em No Limit ($0.10/$0.25) - 2009/07/01 1:43:51 ET
Table '63uh7ZsO7Tnt+E8b/2bu3A' 6-max Seat #5 is the button
Seat 1: 0av6tRNdi0Ui4f15L7gsVg ($30.90 in chips) 
Seat 2: SFmT9ZsVopnukjvAzrxTRg ($28.70 in chips) 
Seat 3: yVP7GLZBzx47OPi6jzUxMw ($7.75 in chips) 
Seat 4: 2tYgzzRRW/D2GWb2A7f1jw ($15.05 in chips) 
Seat 5: GbCVUNssQ7mqsPWr7J4d3w ($4.40 in chips) 
Seat 6: qGHGf/553gQnDoklMRe3tg ($28.75 in chips) 
qGHGf/553gQnDoklMRe3tg: posts small blind $0.10
0av6tRNdi0Ui4f15L7gsVg: posts big blind $0.25
*** HOLE CARDS ***
SFmT9ZsVopnukjvAzrxTRg: folds 
yVP7GLZBzx47OPi6jzUxMw: folds 
2tYgzzRRW/D2GWb2A7f1jw: calls $0.25
GbCVUNssQ7mqsPWr7J4d3w: folds 
qGHGf/553gQnDoklMRe3tg: folds 
0av6tRNdi0Ui4f15L7gsVg: checks 
*** FLOP *** [Kd Th As]
0av6tRNdi0Ui4f15L7gsVg: checks 
2tYgzzRRW/D2GWb2A7f1jw: bets $0.50
0av6tRNdi0Ui4f15L7gsVg: folds 
Uncalled bet ($0.50) returned to 2tYgzzRRW/D2GWb2A7f1jw
2tYgzzRRW/D2GWb2A7f1jw collected $0.60 from pot
2tYgzzRRW/D2GWb2A7f1jw: doesn't show hand 
*** SUMMARY ***
Total pot $0.60 | Rake $0 
Board [Kd Th As]
Seat 1: 0av6tRNdi0Ui4f15L7gsVg (big blind) folded on the Flop
Seat 2: SFmT9ZsVopnukjvAzrxTRg folded before Flop (didn't bet)
Seat 3: yVP7GLZBzx47OPi6jzUxMw folded before Flop (didn't bet)
Seat 4: 2tYgzzRRW/D2GWb2A7f1jw collected ($0.60)
Seat 5: GbCVUNssQ7mqsPWr7J4d3w (button) folded before Flop (didn't bet)
Seat 6: qGHGf/553gQnDoklMRe3tg (small blind) folded before Flop




PokerStars Game #59941714418:  Hold'em No Limit ($0.10/$0.25) - 2009/07/01 1:43:51 ET
Table 'FE/j6VqBY4j9Uq+VHURQCQ' 6-max Seat #5 is the button
Seat 1: ypmjhffk/YHGc51wgVXUTw ($42.95 in chips) 
Seat 2: 3zD3qLXT1bEffAoWGnc7wg ($40.10 in chips) 
Seat 3: lBoEwOFgzcERLIRUkUoRTw ($27.35 in chips) 
Seat 4: 7JyPCA0J2grhXQYxe1h3+A ($22.05 in chips) 
Seat 5: 4x9jCqgSw4272dnaIqnanw ($6.85 in chips) 
Seat 6: rpJ2ie+vculq8yrHlngRHQ ($18.05 in chips) 
rpJ2ie+vculq8yrHlngRHQ: posts small blind $0.10
ypmjhffk/YHGc51wgVXUTw: posts big blind $0.25
*** HOLE CARDS ***
3zD3qLXT1bEffAoWGnc7wg: folds 
lBoEwOFgzcERLIRUkUoRTw: folds 
7JyPCA0J2grhXQYxe1h3+A: folds 
4x9jCqgSw4272dnaIqnanw: raises $6.60 to $6.85 and is all-in
rpJ2ie+vculq8yrHlngRHQ: calls $6.75
ypmjhffk/YHGc51wgVXUTw: folds 
*** FLOP *** [Kc 9c 8h]
*** TURN *** [Kc 9c 8h] [As]
*** RIVER *** [Kc 9c 8h As] [Ts]
*** SHOW DOWN ***
rpJ2ie+vculq8yrHlngRHQ: shows [Jh Kd] (a pair of Kings)
4x9jCqgSw4272dnaIqnanw: shows [Ah Ks] (two pair, Aces and Kings)
4x9jCqgSw4272dnaIqnanw collected $13.30 from pot
*** SUMMARY ***
Total pot $13.95 | Rake $0.65 
Board [Kc 9c 8h As Ts]
Seat 1: ypmjhffk/YHGc51wgVXUTw (big blind) folded before Flop
Seat 2: 3zD3qLXT1bEffAoWGnc7wg folded before Flop (didn't bet)
Seat 3: lBoEwOFgzcERLIRUkUoRTw folded before Flop (didn't bet)
Seat 4: 7JyPCA0J2grhXQYxe1h3+A folded before Flop (didn't bet)
Seat 5: 4x9jCqgSw4272dnaIqnanw (button) showed [Ah Ks] and won ($13.30) with two pair, Aces and Kings
Seat 6: rpJ2ie+vculq8yrHlngRHQ (small blind) showed [Jh Kd] and lost with a pair of Kings




PokerStars Game #59941714528:  Hold'em No Limit ($0.10/$0.25) - 2009/07/01 1:43:51 ET
Table '4UJB/UOZ5aepyF2v+hIoUg' 6-max Seat #2 is the button
Seat 1: 08V++DOqzaNrRNsHIwi25w ($26.60 in chips) 
Seat 2: mFv3iBCtrw9XfCDRB0d46Q ($4.55 in chips) 
Seat 3: zlYHXTtJ5tcx9kwK2h5n9A ($38.40 in chips) 
Seat 4: R6AGToFJQOYVZAjC2jXEKw ($24.20 in chips) 
Seat 5: 3zD3qLXT1bEffAoWGnc7wg ($25.90 in chips) 
Seat 6: 2aphcinkTZT0B0Uoah6cvQ ($16.85 in chips) 
zlYHXTtJ5tcx9kwK2h5n9A: posts small blind $0.10
R6AGToFJQOYVZAjC2jXEKw: posts big blind $0.25
*** HOLE CARDS ***
3zD3qLXT1bEffAoWGnc7wg: folds 
2aphcinkTZT0B0Uoah6cvQ: folds 
08V++DOqzaNrRNsHIwi25w: folds 
mFv3iBCtrw9XfCDRB0d46Q: folds 
zlYHXTtJ5tcx9kwK2h5n9A: calls $0.15
R6AGToFJQOYVZAjC2jXEKw: checks 
*** FLOP *** [Th 8s Kh]
zlYHXTtJ5tcx9kwK2h5n9A: checks 
R6AGToFJQOYVZAjC2jXEKw: checks 
*** TURN *** [Th 8s Kh] [6c]
zlYHXTtJ5tcx9kwK2h5n9A: bets $0.25
R6AGToFJQOYVZAjC2jXEKw: folds 
Uncalled bet ($0.25) returned to zlYHXTtJ5tcx9kwK2h5n9A
zlYHXTtJ5tcx9kwK2h5n9A collected $0.50 from pot
*** SUMMARY ***
Total pot $0.50 | Rake $0 
Board [Th 8s Kh 6c]
Seat 1: 08V++DOqzaNrRNsHIwi25w folded before Flop (didn't bet)
Seat 2: mFv3iBCtrw9XfCDRB0d46Q (button) folded before Flop (didn't bet)
Seat 3: zlYHXTtJ5tcx9kwK2h5n9A (small blind) collected ($0.50)
Seat 4: R6AGToFJQOYVZAjC2jXEKw (big blind) folded on the Turn
Seat 5: 3zD3qLXT1bEffAoWGnc7wg folded before Flop (didn't bet)
Seat 6: 2aphcinkTZT0B0Uoah6cvQ folded before Flop (didn't bet)




PokerStars Game #59941714610:  Hold'em No Limit ($0.10/$0.25) - 2009/07/01 1:43:51 ET
Table 'APEHQjIcZHDZUA4iOjju2g' 6-max Seat #2 is the button
Seat 1: DE9hRlt14g+JdsRQ4wT7hg ($25 in chips) 
Seat 2: 3zD3qLXT1bEffAoWGnc7wg ($36.25 in chips) 
Seat 3: 3e/idKqDuPE10t6Zvr//SQ ($24.15 in chips) 
Seat 4: w2mQ4VsGljGwWXydz8tw2A ($37.75 in chips) 
Seat 5: /xN6gc9+8Hew0HxaB6VIVg ($44.45 in chips) 
Seat 6: KXtdqb+rIMkjc0RvHDksGQ ($25.95 in chips) 
3e/idKqDuPE10t6Zvr//SQ: posts small blind $0.10
w2mQ4VsGljGwWXydz8tw2A: posts big blind $0.25
*** HOLE CARDS ***
/xN6gc9+8Hew0HxaB6VIVg: folds 
KXtdqb+rIMkjc0RvHDksGQ: folds 
DE9hRlt14g+JdsRQ4wT7hg: folds 
3zD3qLXT1bEffAoWGnc7wg: folds 
3e/idKqDuPE10t6Zvr//SQ: folds 
Uncalled bet ($0.15) returned to w2mQ4VsGljGwWXydz8tw2A
w2mQ4VsGljGwWXydz8tw2A collected $0.20 from pot
*** SUMMARY ***
Total pot $0.20 | Rake $0 
Seat 1: DE9hRlt14g+JdsRQ4wT7hg folded before Flop (didn't bet)
Seat 2: 3zD3qLXT1bEffAoWGnc7wg (button) folded before Flop (didn't bet)
Seat 3: 3e/idKqDuPE10t6Zvr//SQ (small blind) folded before Flop
Seat 4: w2mQ4VsGljGwWXydz8tw2A (big blind) collected ($0.20)
Seat 5: /xN6gc9+8Hew0HxaB6VIVg folded before Flop (didn't bet)
Seat 6: KXtdqb+rIMkjc0RvHDksGQ folded before Flop (didn't bet)




PokerStars Game #59941715246:  Hold'em No Limit ($0.10/$0.25) - 2009/07/01 1:43:52 ET
Table 'NtCSSONEf1zaJo3042tQug' 6-max Seat #6 is the button
Seat 1: KXtdqb+rIMkjc0RvHDksGQ ($35.20 in chips) 
Seat 2: vqWjZmdQu/Hxw96/IJTWdQ ($27.30 in chips) 
Seat 3: 9kUKGKkblnIx3m8rlVol6Q ($15.65 in chips) 
Seat 4: HxD1kB8zCmalQSdWAkKmlg ($29.20 in chips) 
Seat 5: tOAk1Og4mVObMBOfvdDYOw ($30.40 in chips) 
Seat 6: LxehwDpTQ19ph4Qmc78+Pw ($28.65 in chips) 
KXtdqb+rIMkjc0RvHDksGQ: posts small blind $0.10
vqWjZmdQu/Hxw96/IJTWdQ: posts big blind $0.25
*** HOLE CARDS ***
9kUKGKkblnIx3m8rlVol6Q: folds 
HxD1kB8zCmalQSdWAkKmlg: folds 
tOAk1Og4mVObMBOfvdDYOw: folds 
LxehwDpTQ19ph4Qmc78+Pw: raises $0.75 to $1
KXtdqb+rIMkjc0RvHDksGQ: folds 
vqWjZmdQu/Hxw96/IJTWdQ: folds 
Uncalled bet ($0.75) returned to LxehwDpTQ19ph4Qmc78+Pw
LxehwDpTQ19ph4Qmc78+Pw collected $0.60 from pot
LxehwDpTQ19ph4Qmc78+Pw: doesn't show hand 
*** SUMMARY ***
Total pot $0.60 | Rake $0 
Seat 1: KXtdqb+rIMkjc0RvHDksGQ (small blind) folded before Flop
Seat 2: vqWjZmdQu/Hxw96/IJTWdQ (big blind) folded before Flop
Seat 3: 9kUKGKkblnIx3m8rlVol6Q folded before Flop (didn't bet)
Seat 4: HxD1kB8zCmalQSdWAkKmlg folded before Flop (didn't bet)
Seat 5: tOAk1Og4mVObMBOfvdDYOw folded before Flop (didn't bet)
Seat 6: LxehwDpTQ19ph4Qmc78+Pw (button) collected ($0.60)




PokerStars Game #59941714962:  Hold'em No Limit ($0.10/$0.25) - 2009/07/01 1:43:52 ET
Table '+UzantPJ4smVdrh+4GTu1w' 6-max Seat #1 is the button
Seat 1: TSmua8tGK3sTbwi0ynrW9Q ($26.95 in chips) 
Seat 2: tcbEu7VzyHQ+0lh+skbQhQ ($41.75 in chips) 
Seat 3: SS/yfeArhULzIcOPe8MdPg ($34.55 in chips) 
Seat 4: UmcUp27+PbgBItv3ZNlAWQ ($25.50 in chips) 
Seat 5: cj4VBQya7HtVL2zCGd5jLQ ($57.30 in chips) 
Seat 6: fZQg9veL7Dd/Z04ZTjC+wQ ($25 in chips) 
tcbEu7VzyHQ+0lh+skbQhQ: posts small blind $0.10
SS/yfeArhULzIcOPe8MdPg: posts big blind $0.25
*** HOLE CARDS ***
UmcUp27+PbgBItv3ZNlAWQ: folds 
cj4VBQya7HtVL2zCGd5jLQ: folds 
fZQg9veL7Dd/Z04ZTjC+wQ: folds 
TSmua8tGK3sTbwi0ynrW9Q: raises $0.50 to $0.75
tcbEu7VzyHQ+0lh+skbQhQ: calls $0.65
SS/yfeArhULzIcOPe8MdPg: calls $0.50
*** FLOP *** [Ad Qd 7c]
tcbEu7VzyHQ+0lh+skbQhQ: checks 
SS/yfeArhULzIcOPe8MdPg: checks 
TSmua8tGK3sTbwi0ynrW9Q: bets $1.50
tcbEu7VzyHQ+0lh+skbQhQ: folds 
SS/yfeArhULzIcOPe8MdPg: folds 
Uncalled bet ($1.50) returned to TSmua8tGK3sTbwi0ynrW9Q
TSmua8tGK3sTbwi0ynrW9Q collected $2.15 from pot
*** SUMMARY ***
Total pot $2.25 | Rake $0.10 
Board [Ad Qd 7c]
Seat 1: TSmua8tGK3sTbwi0ynrW9Q (button) collected ($2.15)
Seat 2: tcbEu7VzyHQ+0lh+skbQhQ (small blind) folded on the Flop
Seat 3: SS/yfeArhULzIcOPe8MdPg (big blind) folded on the Flop
Seat 4: UmcUp27+PbgBItv3ZNlAWQ folded before Flop (didn't bet)
Seat 5: cj4VBQya7HtVL2zCGd5jLQ folded before Flop (didn't bet)
Seat 6: fZQg9veL7Dd/Z04ZTjC+wQ folded before Flop (didn't bet)




PokerStars Game #59941714966:  Hold'em No Limit ($0.10/$0.25) - 2009/07/01 1:43:52 ET
Table '9SExUHslNkrPJ4XsrePaVw' 9-max Seat #9 is the button
Seat 1: RHqgdFvufLCYe54+qd2gcA ($4.75 in chips) 
Seat 2: cZ99hugmLBj9KhTlc8nCSw ($44.85 in chips) 
Seat 3: EP17SQz/iWcuYdNOGeBgkw ($14.40 in chips) 
Seat 4: 4awUyiDYTgylQKXZ9faBVA ($25 in chips) 
Seat 5: L+eJnUyhY8bMNYw755K8XQ ($14.50 in chips) 
Seat 6: YPJ90cgNXDABdYJcqmwB0A ($20.95 in chips) 
Seat 7: 7cv+9Zc9HIQHNvYsMfV3uA ($29.20 in chips) 
Seat 8: tLcDklc2rBORNfixyRfVfw ($25.35 in chips) 
Seat 9: /THNzAxdv2lBxcf4XTj/0g ($7.25 in chips) 
RHqgdFvufLCYe54+qd2gcA: posts small blind $0.10
cZ99hugmLBj9KhTlc8nCSw: posts big blind $0.25
*** HOLE CARDS ***
EP17SQz/iWcuYdNOGeBgkw: calls $0.25
4awUyiDYTgylQKXZ9faBVA: folds 
L+eJnUyhY8bMNYw755K8XQ: folds 
YPJ90cgNXDABdYJcqmwB0A: folds 
7cv+9Zc9HIQHNvYsMfV3uA: folds 
tLcDklc2rBORNfixyRfVfw: folds 
/THNzAxdv2lBxcf4XTj/0g: calls $0.25
RHqgdFvufLCYe54+qd2gcA: calls $0.15
cZ99hugmLBj9KhTlc8nCSw: checks 
*** FLOP *** [4h Kd 7d]
RHqgdFvufLCYe54+qd2gcA: checks 
cZ99hugmLBj9KhTlc8nCSw: checks 
EP17SQz/iWcuYdNOGeBgkw: checks 
/THNzAxdv2lBxcf4XTj/0g: checks 
*** TURN *** [4h Kd 7d] [3s]
RHqgdFvufLCYe54+qd2gcA: checks 
cZ99hugmLBj9KhTlc8nCSw: bets $0.75
EP17SQz/iWcuYdNOGeBgkw: folds 
/THNzAxdv2lBxcf4XTj/0g: calls $0.75
RHqgdFvufLCYe54+qd2gcA: folds 
*** RIVER *** [4h Kd 7d 3s] [5c]
cZ99hugmLBj9KhTlc8nCSw: checks 
/THNzAxdv2lBxcf4XTj/0g: checks 
*** SHOW DOWN ***
cZ99hugmLBj9KhTlc8nCSw: shows [8d 9d] (high card King)
/THNzAxdv2lBxcf4XTj/0g: shows [Ks Kc] (three of a kind, Kings)
/THNzAxdv2lBxcf4XTj/0g collected $2.40 from pot
*** SUMMARY ***
Total pot $2.50 | Rake $0.10 
Board [4h Kd 7d 3s 5c]
Seat 1: RHqgdFvufLCYe54+qd2gcA (small blind) folded on the Turn
Seat 2: cZ99hugmLBj9KhTlc8nCSw (big blind) showed [8d 9d] and lost with high card King
Seat 3: EP17SQz/iWcuYdNOGeBgkw folded on the Turn
Seat 4: 4awUyiDYTgylQKXZ9faBVA folded before Flop (didn't bet)
Seat 5: L+eJnUyhY8bMNYw755K8XQ folded before Flop (didn't bet)
Seat 6: YPJ90cgNXDABdYJcqmwB0A folded before Flop (didn't bet)
Seat 7: 7cv+9Zc9HIQHNvYsMfV3uA folded before Flop (didn't bet)
Seat 8: tLcDklc2rBORNfixyRfVfw folded before Flop (didn't bet)
Seat 9: /THNzAxdv2lBxcf4XTj/0g (button) showed [Ks Kc] and won ($2.40) with three of a kind, Kings




PokerStars Game #59941715368:  Hold'em No Limit ($0.10/$0.25) - 2009/07/01 1:43:52 ET
Table 'aisAlB9GIV21BwfUW3+Nbg' 9-max Seat #8 is the button
Seat 1: SqibpGx+lf+brY0fJVvD0w ($24.65 in chips) 
Seat 2: +7GnIVpCmyuij3NJfOgsTw ($13.40 in chips) 
Seat 3: CvL9Ch1HYCVbTsfpNucitg ($4.80 in chips) 
Seat 4: sD+TKtt36XiiN6jqHiLwDA ($25.20 in chips) 
Seat 5: ghNKXUBl/H+t83JF079ZBA ($27.40 in chips) 
Seat 6: 9gmYYQesalMrUjaF7nKfrQ ($16.20 in chips) 
Seat 7: jGjM+5lCSe6f2MEwxQGOAg ($26.50 in chips) 
Seat 8: VWUWpMLMj/Q1jRVpF7Aohw ($12.15 in chips) 
Seat 9: N0hGpTAEAj9k5msS6LPLAw ($22.20 in chips) 
N0hGpTAEAj9k5msS6LPLAw: posts small blind $0.10
SqibpGx+lf+brY0fJVvD0w: posts big blind $0.25
*** HOLE CARDS ***
+7GnIVpCmyuij3NJfOgsTw: calls $0.25
CvL9Ch1HYCVbTsfpNucitg: folds 
sD+TKtt36XiiN6jqHiLwDA: folds 
ghNKXUBl/H+t83JF079ZBA: folds 
9gmYYQesalMrUjaF7nKfrQ: folds 
jGjM+5lCSe6f2MEwxQGOAg: raises $0.25 to $0.50
VWUWpMLMj/Q1jRVpF7Aohw: calls $0.50
N0hGpTAEAj9k5msS6LPLAw: folds 
SqibpGx+lf+brY0fJVvD0w: folds 
+7GnIVpCmyuij3NJfOgsTw: calls $0.25
*** FLOP *** [Qc Ks 8s]
+7GnIVpCmyuij3NJfOgsTw: bets $0.25
jGjM+5lCSe6f2MEwxQGOAg: raises $0.25 to $0.50
VWUWpMLMj/Q1jRVpF7Aohw: folds 
+7GnIVpCmyuij3NJfOgsTw: calls $0.25
*** TURN *** [Qc Ks 8s] [Jd]
+7GnIVpCmyuij3NJfOgsTw: bets $0.25
jGjM+5lCSe6f2MEwxQGOAg: calls $0.25
*** RIVER *** [Qc Ks 8s Jd] [Qs]
+7GnIVpCmyuij3NJfOgsTw: bets $2.50
jGjM+5lCSe6f2MEwxQGOAg: folds 
Uncalled bet ($2.50) returned to +7GnIVpCmyuij3NJfOgsTw
+7GnIVpCmyuij3NJfOgsTw collected $3.20 from pot
+7GnIVpCmyuij3NJfOgsTw: doesn't show hand 
*** SUMMARY ***
Total pot $3.35 | Rake $0.15 
Board [Qc Ks 8s Jd Qs]
Seat 1: SqibpGx+lf+brY0fJVvD0w (big blind) folded before Flop
Seat 2: +7GnIVpCmyuij3NJfOgsTw collected ($3.20)
Seat 3: CvL9Ch1HYCVbTsfpNucitg folded before Flop (didn't bet)
Seat 4: sD+TKtt36XiiN6jqHiLwDA folded before Flop (didn't bet)
Seat 5: ghNKXUBl/H+t83JF079ZBA folded before Flop (didn't bet)
Seat 6: 9gmYYQesalMrUjaF7nKfrQ folded before Flop (didn't bet)
Seat 7: jGjM+5lCSe6f2MEwxQGOAg folded on the River
Seat 8: VWUWpMLMj/Q1jRVpF7Aohw (button) folded on the Flop
Seat 9: N0hGpTAEAj9k5msS6LPLAw (small blind) folded before Flop




PokerStars Game #59941715680:  Hold'em No Limit ($0.10/$0.25) - 2009/07/01 1:43:53 ET
Table '3760QYRYyCWeXf0rLZ5S2g' 9-max Seat #4 is the button
Seat 1: CT7Xj/V/O5rBlhtt+RZeFQ ($27.90 in chips) 
Seat 3: X78b5v/uhqeXXoAijbw/yg ($25.60 in chips) 
Seat 4: ziFpkH3wCzqB/qXeq/Hy7g ($25 in chips) 
Seat 5: Bb42QRQMhg5/Y0vHP8/2Xw ($28.80 in chips) 
Seat 6: q+Qdg0Hoir+SyL7haBrUnw ($13.40 in chips) 
Seat 7: 6C2DoQ+GZHBOpb+qyrSnqA ($5.75 in chips) 
Seat 8: pB8IyCfDFZaVpov3NHEVJg ($24.30 in chips) 
Seat 9: sGFnnRCa1YAHAUmWgsW6Qg ($5.95 in chips) 
Bb42QRQMhg5/Y0vHP8/2Xw: posts small blind $0.10
q+Qdg0Hoir+SyL7haBrUnw: posts big blind $0.25
*** HOLE CARDS ***
6C2DoQ+GZHBOpb+qyrSnqA: folds 
pB8IyCfDFZaVpov3NHEVJg: folds 
sGFnnRCa1YAHAUmWgsW6Qg: folds 
CT7Xj/V/O5rBlhtt+RZeFQ: folds 
X78b5v/uhqeXXoAijbw/yg: folds 
ziFpkH3wCzqB/qXeq/Hy7g: folds 
Bb42QRQMhg5/Y0vHP8/2Xw: folds 
Uncalled bet ($0.15) returned to q+Qdg0Hoir+SyL7haBrUnw
q+Qdg0Hoir+SyL7haBrUnw collected $0.20 from pot
q+Qdg0Hoir+SyL7haBrUnw: doesn't show hand 
*** SUMMARY ***
Total pot $0.20 | Rake $0 
Seat 1: CT7Xj/V/O5rBlhtt+RZeFQ folded before Flop (didn't bet)
Seat 3: X78b5v/uhqeXXoAijbw/yg folded before Flop (didn't bet)
Seat 4: ziFpkH3wCzqB/qXeq/Hy7g (button) folded before Flop (didn't bet)
Seat 5: Bb42QRQMhg5/Y0vHP8/2Xw (small blind) folded before Flop
Seat 6: q+Qdg0Hoir+SyL7haBrUnw (big blind) collected ($0.20)
Seat 7: 6C2DoQ+GZHBOpb+qyrSnqA folded before Flop (didn't bet)
Seat 8: pB8IyCfDFZaVpov3NHEVJg folded before Flop (didn't bet)
Seat 9: sGFnnRCa1YAHAUmWgsW6Qg folded before Flop (didn't bet)




PokerStars Game #59941715678:  Hold'em No Limit ($0.10/$0.25) - 2009/07/01 1:43:53 ET
Table 'wGizWOswEL6P5QrvVkno/g' 6-max Seat #6 is the button
Seat 1: Qbfkn+ucISvbd1Xh32zAGA ($24.40 in chips) 
Seat 2: mfrkWA3PTeYPkbO6hi98Aw ($25 in chips) 
Seat 3: bJFzs6QmEEnz4miMfSDtcg ($13.65 in chips) 
Seat 4: 32YL2ZEp8NT4JB2RVM9euQ ($16.30 in chips) 
Seat 6: rfSnsAuAfXTb8w/obc9OVQ ($9.30 in chips) 
Qbfkn+ucISvbd1Xh32zAGA: posts small blind $0.10
mfrkWA3PTeYPkbO6hi98Aw: posts big blind $0.25
*** HOLE CARDS ***
bJFzs6QmEEnz4miMfSDtcg: calls $0.25
32YL2ZEp8NT4JB2RVM9euQ: folds 
rfSnsAuAfXTb8w/obc9OVQ: folds 
Qbfkn+ucISvbd1Xh32zAGA: calls $0.15
mfrkWA3PTeYPkbO6hi98Aw: checks 
*** FLOP *** [Jd Ac Ts]
Qbfkn+ucISvbd1Xh32zAGA: checks 
mfrkWA3PTeYPkbO6hi98Aw: checks 
bJFzs6QmEEnz4miMfSDtcg: checks 
*** TURN *** [Jd Ac Ts] [2h]
Qbfkn+ucISvbd1Xh32zAGA: checks 
mfrkWA3PTeYPkbO6hi98Aw: bets $0.50
bJFzs6QmEEnz4miMfSDtcg: calls $0.50
Qbfkn+ucISvbd1Xh32zAGA: calls $0.50
*** RIVER *** [Jd Ac Ts 2h] [8d]
Qbfkn+ucISvbd1Xh32zAGA: checks 
mfrkWA3PTeYPkbO6hi98Aw: bets $1
bJFzs6QmEEnz4miMfSDtcg: folds 
Qbfkn+ucISvbd1Xh32zAGA: folds 
Uncalled bet ($1) returned to mfrkWA3PTeYPkbO6hi98Aw
mfrkWA3PTeYPkbO6hi98Aw collected $2.15 from pot
mfrkWA3PTeYPkbO6hi98Aw: doesn't show hand 
*** SUMMARY ***
Total pot $2.25 | Rake $0.10 
Board [Jd Ac Ts 2h 8d]
Seat 1: Qbfkn+ucISvbd1Xh32zAGA (small blind) folded on the River
Seat 2: mfrkWA3PTeYPkbO6hi98Aw (big blind) collected ($2.15)
Seat 3: bJFzs6QmEEnz4miMfSDtcg folded on the River
Seat 4: 32YL2ZEp8NT4JB2RVM9euQ folded before Flop (didn't bet)
Seat 6: rfSnsAuAfXTb8w/obc9OVQ (button) folded before Flop (didn't bet)




PokerStars Game #59941715774:  Hold'em No Limit ($0.10/$0.25) - 2009/07/01 1:43:53 ET
Table '/JJyyIstHfkT7t/bW+WXgg' 6-max Seat #2 is the button
Seat 2: obJgSnVgWWWaAUtVILo77Q ($18.40 in chips) 
Seat 3: DR0nVIhVP77oEBlO9J8vlg ($34.75 in chips) 
Seat 4: JFIAqU8lCZ0vWwEl4bdGsg ($35.40 in chips) 
Seat 5: +ZlnqPoP3Hg4BIUxDfKd/A ($48.15 in chips) 
Seat 6: UmcUp27+PbgBItv3ZNlAWQ ($25 in chips) 
DR0nVIhVP77oEBlO9J8vlg: posts small blind $0.10
JFIAqU8lCZ0vWwEl4bdGsg: posts big blind $0.25
*** HOLE CARDS ***
+ZlnqPoP3Hg4BIUxDfKd/A: folds 
UmcUp27+PbgBItv3ZNlAWQ: folds 
obJgSnVgWWWaAUtVILo77Q: raises $0.50 to $0.75
DR0nVIhVP77oEBlO9J8vlg: folds 
JFIAqU8lCZ0vWwEl4bdGsg: folds 
Uncalled bet ($0.50) returned to obJgSnVgWWWaAUtVILo77Q
obJgSnVgWWWaAUtVILo77Q collected $0.60 from pot
obJgSnVgWWWaAUtVILo77Q: doesn't show hand 
*** SUMMARY ***
Total pot $0.60 | Rake $0 
Seat 2: obJgSnVgWWWaAUtVILo77Q (button) collected ($0.60)
Seat 3: DR0nVIhVP77oEBlO9J8vlg (small blind) folded before Flop
Seat 4: JFIAqU8lCZ0vWwEl4bdGsg (big blind) folded before Flop
Seat 5: +ZlnqPoP3Hg4BIUxDfKd/A folded before Flop (didn't bet)
Seat 6: UmcUp27+PbgBItv3ZNlAWQ folded before Flop (didn't bet)




PokerStars Game #59941715660:  Hold'em No Limit ($0.10/$0.25) - 2009/07/01 1:43:53 ET
Table '6wawJ+MkkvuC3coG6r+Yhg' 6-max Seat #5 is the button
Seat 1: JQZew0FjzS19kTjeNtrE+A ($28.25 in chips) 
Seat 2: LtASJ9OlkqGrrUKGQlpGAw ($34.65 in chips) 
Seat 3: 3zD3qLXT1bEffAoWGnc7wg ($58.75 in chips) 
Seat 4: yxmjNFGiKI3b+XQGJzJVIg ($28.30 in chips) 
Seat 5: FZrgDbxAanC1xwZxXHJKVA ($2.85 in chips) 
Seat 6: B3X187C0tXFUfQpCu8pe8A ($26.85 in chips) 
B3X187C0tXFUfQpCu8pe8A: posts small blind $0.10
JQZew0FjzS19kTjeNtrE+A: posts big blind $0.25
*** HOLE CARDS ***
LtASJ9OlkqGrrUKGQlpGAw: folds 
3zD3qLXT1bEffAoWGnc7wg: folds 
yxmjNFGiKI3b+XQGJzJVIg: folds 
FZrgDbxAanC1xwZxXHJKVA: folds 
B3X187C0tXFUfQpCu8pe8A: folds 
Uncalled bet ($0.15) returned to JQZew0FjzS19kTjeNtrE+A
JQZew0FjzS19kTjeNtrE+A collected $0.20 from pot
*** SUMMARY ***
Total pot $0.20 | Rake $0 
Seat 1: JQZew0FjzS19kTjeNtrE+A (big blind) collected ($0.20)
Seat 2: LtASJ9OlkqGrrUKGQlpGAw folded before Flop (didn't bet)
Seat 3: 3zD3qLXT1bEffAoWGnc7wg folded before Flop (didn't bet)
Seat 4: yxmjNFGiKI3b+XQGJzJVIg folded before Flop (didn't bet)
Seat 5: FZrgDbxAanC1xwZxXHJKVA (button) folded before Flop (didn't bet)
Seat 6: B3X187C0tXFUfQpCu8pe8A (small blind) folded before Flop




PokerStars Game #59941715616:  Hold'em No Limit ($0.10/$0.25) - 2009/07/01 1:43:53 ET
Table 'MJ1SB76A4qJrlEa+C5e/8w' 6-max Seat #6 is the button
Seat 1: 0KDZiuXQg6UI9cqBR/AUnQ ($25.75 in chips) 
Seat 2: UA5OsKS3VPaxa7uC8La/kA ($37.05 in chips) 
Seat 3: DihMHaz4WNETH1bPDe13kA ($32.90 in chips) 
Seat 4: SFmT9ZsVopnukjvAzrxTRg ($27.80 in chips) 
Seat 5: Hsvkc0/G2VV78oVmWYXecw ($5 in chips) 
Seat 6: JFIAqU8lCZ0vWwEl4bdGsg ($30.30 in chips) 
0KDZiuXQg6UI9cqBR/AUnQ: posts small blind $0.10
UA5OsKS3VPaxa7uC8La/kA: posts big blind $0.25
*** HOLE CARDS ***
DihMHaz4WNETH1bPDe13kA: folds 
SFmT9ZsVopnukjvAzrxTRg: folds 
Hsvkc0/G2VV78oVmWYXecw: folds 
JFIAqU8lCZ0vWwEl4bdGsg: folds 
0KDZiuXQg6UI9cqBR/AUnQ: folds 
Uncalled bet ($0.15) returned to UA5OsKS3VPaxa7uC8La/kA
UA5OsKS3VPaxa7uC8La/kA collected $0.20 from pot
*** SUMMARY ***
Total pot $0.20 | Rake $0 
Seat 1: 0KDZiuXQg6UI9cqBR/AUnQ (small blind) folded before Flop
Seat 2: UA5OsKS3VPaxa7uC8La/kA (big blind) collected ($0.20)
Seat 3: DihMHaz4WNETH1bPDe13kA folded before Flop (didn't bet)
Seat 4: SFmT9ZsVopnukjvAzrxTRg folded before Flop (didn't bet)
Seat 5: Hsvkc0/G2VV78oVmWYXecw folded before Flop (didn't bet)
Seat 6: JFIAqU8lCZ0vWwEl4bdGsg (button) folded before Flop (didn't bet)




PokerStars Game #59941715618:  Hold'em No Limit ($0.10/$0.25) - 2009/07/01 1:43:53 ET
Table 'vZfV/Uj0q8joA1du9sRJSg' 6-max Seat #5 is the button
Seat 1: Hsvkc0/G2VV78oVmWYXecw ($6.40 in chips) 
Seat 2: wMiE3yTbDJGOLOF9th7KPA ($8.90 in chips) 
Seat 3: cWc85bEzdRzpUMhRKm8pwQ ($25 in chips) 
Seat 4: v+QfkGiuj9bgtuNoVnDO8w ($44.35 in chips) 
Seat 5: kyRaCIljYA6l33lSKQfNsg ($27.85 in chips) 
Seat 6: 8ClCHtFXGNplITm+63KB+Q ($44.90 in chips) 
8ClCHtFXGNplITm+63KB+Q: posts small blind $0.10
Hsvkc0/G2VV78oVmWYXecw: posts big blind $0.25
*** HOLE CARDS ***
wMiE3yTbDJGOLOF9th7KPA: calls $0.25
cWc85bEzdRzpUMhRKm8pwQ: raises $1 to $1.25
v+QfkGiuj9bgtuNoVnDO8w: folds 
kyRaCIljYA6l33lSKQfNsg: folds 
8ClCHtFXGNplITm+63KB+Q: folds 
Hsvkc0/G2VV78oVmWYXecw: folds 
wMiE3yTbDJGOLOF9th7KPA: folds 
Uncalled bet ($1) returned to cWc85bEzdRzpUMhRKm8pwQ
cWc85bEzdRzpUMhRKm8pwQ collected $0.85 from pot
*** SUMMARY ***
Total pot $0.85 | Rake $0 
Seat 1: Hsvkc0/G2VV78oVmWYXecw (big blind) folded before Flop
Seat 2: wMiE3yTbDJGOLOF9th7KPA folded before Flop
Seat 3: cWc85bEzdRzpUMhRKm8pwQ collected ($0.85)
Seat 4: v+QfkGiuj9bgtuNoVnDO8w folded before Flop (didn't bet)
Seat 5: kyRaCIljYA6l33lSKQfNsg (button) folded before Flop (didn't bet)
Seat 6: 8ClCHtFXGNplITm+63KB+Q (small blind) folded before Flop




PokerStars Game #59941715890:  Hold'em No Limit ($0.10/$0.25) - 2009/07/01 1:43:53 ET
Table 'iMiAw/kTZXopgYX4HI7sHg' 9-max Seat #1 is the button
Seat 1: PdIasPkzm2sqZnN41ZRXOg ($5 in chips) 
Seat 2: qwr38jl5txoR36M7G5qi4A ($8.35 in chips) 
Seat 3: HPEB+AtKw1+C/cxU0o1ciw ($28.25 in chips) 
Seat 5: 22dIObOuor/A+IKWkNoAlA ($5.10 in chips) 
Seat 6: Bb42QRQMhg5/Y0vHP8/2Xw ($28.70 in chips) 
Seat 8: tLcDklc2rBORNfixyRfVfw ($29.55 in chips) 
Seat 9: 7cv+9Zc9HIQHNvYsMfV3uA ($25 in chips) 
qwr38jl5txoR36M7G5qi4A: posts small blind $0.10
HPEB+AtKw1+C/cxU0o1ciw: posts big blind $0.25
Z9W7+g1WMhhZDi7DwGbCFA: sits out 
flatform: sits out 
7cv+9Zc9HIQHNvYsMfV3uA: posts big blind $0.25
*** HOLE CARDS ***
22dIObOuor/A+IKWkNoAlA: folds 
Bb42QRQMhg5/Y0vHP8/2Xw: folds 
tLcDklc2rBORNfixyRfVfw: raises $1 to $1.25
7cv+9Zc9HIQHNvYsMfV3uA: folds 
PdIasPkzm2sqZnN41ZRXOg: folds 
qwr38jl5txoR36M7G5qi4A: folds 
HPEB+AtKw1+C/cxU0o1ciw: folds 
Uncalled bet ($1) returned to tLcDklc2rBORNfixyRfVfw
tLcDklc2rBORNfixyRfVfw collected $0.85 from pot
tLcDklc2rBORNfixyRfVfw: doesn't show hand 
*** SUMMARY ***
Total pot $0.85 | Rake $0 
Seat 1: PdIasPkzm2sqZnN41ZRXOg (button) folded before Flop (didn't bet)
Seat 2: qwr38jl5txoR36M7G5qi4A (small blind) folded before Flop
Seat 3: HPEB+AtKw1+C/cxU0o1ciw (big blind) folded before Flop
Seat 5: 22dIObOuor/A+IKWkNoAlA folded before Flop (didn't bet)
Seat 6: Bb42QRQMhg5/Y0vHP8/2Xw folded before Flop (didn't bet)
Seat 8: tLcDklc2rBORNfixyRfVfw collected ($0.85)
Seat 9: 7cv+9Zc9HIQHNvYsMfV3uA folded before Flop




PokerStars Game #59941716082:  Hold'em No Limit ($0.10/$0.25) - 2009/07/01 1:43:54 ET
Table 'nyTW9cVtYentc5V7xU/0jA' 6-max Seat #3 is the button
Seat 1: HI20pVxSHPZ29u9IDkmICg ($11.40 in chips) 
Seat 2: v6mkGzCBCCXcgWQNSYVtKg ($6.15 in chips) 
Seat 3: kG34n23qFQA3nzdOJTQ1dA ($36.10 in chips) 
Seat 4: NkB3D4eVHHXvB9Edaugc1Q ($32.95 in chips) 
NkB3D4eVHHXvB9Edaugc1Q: posts small blind $0.10
HI20pVxSHPZ29u9IDkmICg: posts big blind $0.25
*** HOLE CARDS ***
v6mkGzCBCCXcgWQNSYVtKg: folds 
kG34n23qFQA3nzdOJTQ1dA: folds 
NkB3D4eVHHXvB9Edaugc1Q: calls $0.15
HI20pVxSHPZ29u9IDkmICg: raises $0.50 to $0.75
NkB3D4eVHHXvB9Edaugc1Q: calls $0.50
*** FLOP *** [Jc 9h Kc]
NkB3D4eVHHXvB9Edaugc1Q: bets $0.25
zZAcuQ0EvirdEuiIbeaocQ has returned
HI20pVxSHPZ29u9IDkmICg: raises $0.75 to $1
zZAcuQ0EvirdEuiIbeaocQ said, "nice five"
NkB3D4eVHHXvB9Edaugc1Q: folds 
Uncalled bet ($0.75) returned to HI20pVxSHPZ29u9IDkmICg
HI20pVxSHPZ29u9IDkmICg collected $1.95 from pot
*** SUMMARY ***
Total pot $2 | Rake $0.05 
Board [Jc 9h Kc]
Seat 1: HI20pVxSHPZ29u9IDkmICg (big blind) collected ($1.95)
Seat 2: v6mkGzCBCCXcgWQNSYVtKg folded before Flop (didn't bet)
Seat 3: kG34n23qFQA3nzdOJTQ1dA (button) folded before Flop (didn't bet)
Seat 4: NkB3D4eVHHXvB9Edaugc1Q (small blind) folded on the Flop




PokerStars Game #59941716670:  Hold'em No Limit ($0.10/$0.25) - 2009/07/01 1:43:55 ET
Table 'zW+7jPbOLCvlPu+dUGY5WQ' 6-max Seat #2 is the button
Seat 1: eL3+wCBjFGfQ5FMdIZihwA ($26.25 in chips) 
Seat 2: cEMJmfAUQZmMChZe6aacKw ($8.60 in chips) 
Seat 4: i48129QFpEQQ+UN4aNtmww ($20.30 in chips) 
Seat 6: qGHGf/553gQnDoklMRe3tg ($25 in chips) 
i48129QFpEQQ+UN4aNtmww: posts small blind $0.10
qGHGf/553gQnDoklMRe3tg: posts big blind $0.25
*** HOLE CARDS ***
eL3+wCBjFGfQ5FMdIZihwA: folds 
cEMJmfAUQZmMChZe6aacKw: folds 
i48129QFpEQQ+UN4aNtmww: calls $0.15
qGHGf/553gQnDoklMRe3tg: checks 
*** FLOP *** [Qh 4h 4c]
i48129QFpEQQ+UN4aNtmww: checks 
qGHGf/553gQnDoklMRe3tg: checks 
*** TURN *** [Qh 4h 4c] [7c]
i48129QFpEQQ+UN4aNtmww: checks 
Hsvkc0/G2VV78oVmWYXecw joins the table at seat #5 
qGHGf/553gQnDoklMRe3tg: checks 
*** RIVER *** [Qh 4h 4c 7c] [5d]
i48129QFpEQQ+UN4aNtmww: checks 
qGHGf/553gQnDoklMRe3tg: checks 
*** SHOW DOWN ***
i48129QFpEQQ+UN4aNtmww: shows [3s Ks] (a pair of Fours)
qGHGf/553gQnDoklMRe3tg: mucks hand 
i48129QFpEQQ+UN4aNtmww collected $0.50 from pot
*** SUMMARY ***
Total pot $0.50 | Rake $0 
Board [Qh 4h 4c 7c 5d]
Seat 1: eL3+wCBjFGfQ5FMdIZihwA folded before Flop (didn't bet)
Seat 2: cEMJmfAUQZmMChZe6aacKw (button) folded before Flop (didn't bet)
Seat 4: i48129QFpEQQ+UN4aNtmww (small blind) showed [3s Ks] and won ($0.50) with a pair of Fours
Seat 6: qGHGf/553gQnDoklMRe3tg (big blind) mucked




PokerStars Game #59941716430:  Hold'em No Limit ($0.10/$0.25) - 2009/07/01 1:43:55 ET
Table 'wRXcD9iXgBbdvKhWmfnBnw' 6-max Seat #6 is the button
Seat 2: vUr8qM1UsCElsCI9B/McdQ ($27.85 in chips) 
Seat 3: l4ToKwb3EVcEuva7hPqMCQ ($8.35 in chips) 
Seat 5: EE16Ua5b1HSsYej5zeXOlA ($43.75 in chips) 
Seat 6: JFIAqU8lCZ0vWwEl4bdGsg ($25 in chips) 
vUr8qM1UsCElsCI9B/McdQ: posts small blind $0.10
StevenWu joins the table at seat #1 
l4ToKwb3EVcEuva7hPqMCQ: posts big blind $0.25
mnuJq+Q1IXKm/pCy+OzxmQ: sits out 
*** HOLE CARDS ***
EE16Ua5b1HSsYej5zeXOlA: folds 
JFIAqU8lCZ0vWwEl4bdGsg: folds 
vUr8qM1UsCElsCI9B/McdQ: raises $0.25 to $0.50
l4ToKwb3EVcEuva7hPqMCQ: raises $1 to $1.50
vUr8qM1UsCElsCI9B/McdQ: calls $1
*** FLOP *** [2d 9c Ks]
vUr8qM1UsCElsCI9B/McdQ: checks 
l4ToKwb3EVcEuva7hPqMCQ: bets $2
vUr8qM1UsCElsCI9B/McdQ: folds 
Uncalled bet ($2) returned to l4ToKwb3EVcEuva7hPqMCQ
l4ToKwb3EVcEuva7hPqMCQ collected $2.85 from pot
*** SUMMARY ***
Total pot $3 | Rake $0.15 
Board [2d 9c Ks]
Seat 2: vUr8qM1UsCElsCI9B/McdQ (small blind) folded on the Flop
Seat 3: l4ToKwb3EVcEuva7hPqMCQ (big blind) collected ($2.85)
Seat 5: EE16Ua5b1HSsYej5zeXOlA folded before Flop (didn't bet)
Seat 6: JFIAqU8lCZ0vWwEl4bdGsg (button) folded before Flop (didn't bet)




PokerStars Game #59941716776:  Hold'em No Limit ($0.10/$0.25) - 2009/07/01 1:43:55 ET
Table 'b64Z+5XI1xkQzNfq4QHr3A' 6-max Seat #6 is the button
Seat 2: SS/yfeArhULzIcOPe8MdPg ($25 in chips) 
Seat 3: u/yN5P9f3KlATg6WLWNkBQ ($38.10 in chips) 
Seat 4: SxIIgwXYLkwd6m3wLyPTCw ($12.65 in chips) 
Seat 5: JFIAqU8lCZ0vWwEl4bdGsg ($58.60 in chips) 
Seat 6: 8ClCHtFXGNplITm+63KB+Q ($35.50 in chips) 
SS/yfeArhULzIcOPe8MdPg: posts small blind $0.10
u/yN5P9f3KlATg6WLWNkBQ: posts big blind $0.25
*** HOLE CARDS ***
SxIIgwXYLkwd6m3wLyPTCw: folds 
JFIAqU8lCZ0vWwEl4bdGsg: folds 
8ClCHtFXGNplITm+63KB+Q: raises $0.75 to $1
SS/yfeArhULzIcOPe8MdPg: folds 
u/yN5P9f3KlATg6WLWNkBQ: folds 
Uncalled bet ($0.75) returned to 8ClCHtFXGNplITm+63KB+Q
8ClCHtFXGNplITm+63KB+Q collected $0.60 from pot
8ClCHtFXGNplITm+63KB+Q: doesn't show hand 
*** SUMMARY ***
Total pot $0.60 | Rake $0 
Seat 2: SS/yfeArhULzIcOPe8MdPg (small blind) folded before Flop
Seat 3: u/yN5P9f3KlATg6WLWNkBQ (big blind) folded before Flop
Seat 4: SxIIgwXYLkwd6m3wLyPTCw folded before Flop (didn't bet)
Seat 5: JFIAqU8lCZ0vWwEl4bdGsg folded before Flop (didn't bet)
Seat 6: 8ClCHtFXGNplITm+63KB+Q (button) collected ($0.60)




PokerStars Game #59941716536:  Hold'em No Limit ($0.10/$0.25) - 2009/07/01 1:43:55 ET
Table 'NtEQAxCeIK2io1CGtW658g' 6-max Seat #5 is the button
Seat 1: X437kMQ7AujoaDgjguhU9w ($9.90 in chips) 
Seat 3: m2yWOKfAxqHoy5DDN87Ttw ($40.10 in chips) 
Seat 4: 8296 ($11.55 in chips) 
Seat 5: Hsvkc0/G2VV78oVmWYXecw ($5 in chips) 
Seat 6: /gJNBeCkWL4o85/jvlZ4BA ($64.85 in chips) 
/gJNBeCkWL4o85/jvlZ4BA: posts small blind $0.10
X437kMQ7AujoaDgjguhU9w: posts big blind $0.25
*** HOLE CARDS ***
m2yWOKfAxqHoy5DDN87Ttw: folds 
8296: calls $0.25
Hsvkc0/G2VV78oVmWYXecw: folds 
/gJNBeCkWL4o85/jvlZ4BA: calls $0.15
X437kMQ7AujoaDgjguhU9w: raises $0.25 to $0.50
8296: calls $0.25
papawfunk joins the table at seat #2 
/gJNBeCkWL4o85/jvlZ4BA: calls $0.25
*** FLOP *** [Qs 2d Ts]
/gJNBeCkWL4o85/jvlZ4BA: checks 
X437kMQ7AujoaDgjguhU9w: checks 
8296: bets $1
/gJNBeCkWL4o85/jvlZ4BA: folds 
X437kMQ7AujoaDgjguhU9w: raises $8.40 to $9.40 and is all-in
8296: folds 
Uncalled bet ($8.40) returned to X437kMQ7AujoaDgjguhU9w
X437kMQ7AujoaDgjguhU9w collected $3.35 from pot
X437kMQ7AujoaDgjguhU9w: doesn't show hand 
*** SUMMARY ***
Total pot $3.50 | Rake $0.15 
Board [Qs 2d Ts]
Seat 1: X437kMQ7AujoaDgjguhU9w (big blind) collected ($3.35)
Seat 3: m2yWOKfAxqHoy5DDN87Ttw folded before Flop (didn't bet)
Seat 4: 8296 folded on the Flop
Seat 5: Hsvkc0/G2VV78oVmWYXecw (button) folded before Flop (didn't bet)
Seat 6: /gJNBeCkWL4o85/jvlZ4BA (small blind) folded on the Flop




PokerStars Game #59941716484:  Hold'em No Limit ($0.10/$0.25) - 2009/07/01 1:43:55 ET
Table 'KTZXQ4LREPjpS54R3DFTsw' 9-max Seat #1 is the button
Seat 1: dSjkBIV7Bv+ZCIWNBguf7w ($40.15 in chips) 
Seat 2: OlPJsgR4xypSg/w1z7Gyvw ($19.75 in chips) 
Seat 3: H5Se03ZqSX7tbULXur2MAg ($23.65 in chips) 
Seat 4: K0b5wNInj6hUGRr6yzKFtw ($64 in chips) 
Seat 5: HPEB+AtKw1+C/cxU0o1ciw ($29.95 in chips) 
Seat 6: Mh2r9hTeTEDnh19sRZtW3g ($5.70 in chips) 
Seat 7: yyG4svzOpC1A+sUP/scg6w ($10.95 in chips) 
Seat 8: X1ucS3BHyBPongKl1Q+eEQ ($18.85 in chips) 
Seat 9: V6p0jQ/RhUsqpHLmXvEX4Q ($13.45 in chips) 
OlPJsgR4xypSg/w1z7Gyvw: posts small blind $0.10
H5Se03ZqSX7tbULXur2MAg: posts big blind $0.25
*** HOLE CARDS ***
K0b5wNInj6hUGRr6yzKFtw: folds 
HPEB+AtKw1+C/cxU0o1ciw: folds 
Mh2r9hTeTEDnh19sRZtW3g: folds 
yyG4svzOpC1A+sUP/scg6w: folds 
X1ucS3BHyBPongKl1Q+eEQ: calls $0.25
V6p0jQ/RhUsqpHLmXvEX4Q: folds 
dSjkBIV7Bv+ZCIWNBguf7w: calls $0.25
OlPJsgR4xypSg/w1z7Gyvw: calls $0.15
H5Se03ZqSX7tbULXur2MAg: checks 
*** FLOP *** [6d 4d Ks]
OlPJsgR4xypSg/w1z7Gyvw: checks 
H5Se03ZqSX7tbULXur2MAg: checks 
X1ucS3BHyBPongKl1Q+eEQ: checks 
dSjkBIV7Bv+ZCIWNBguf7w: bets $0.50
OlPJsgR4xypSg/w1z7Gyvw: folds 
H5Se03ZqSX7tbULXur2MAg: folds 
X1ucS3BHyBPongKl1Q+eEQ: folds 
Uncalled bet ($0.50) returned to dSjkBIV7Bv+ZCIWNBguf7w
dSjkBIV7Bv+ZCIWNBguf7w collected $0.95 from pot
dSjkBIV7Bv+ZCIWNBguf7w: doesn't show hand 
*** SUMMARY ***
Total pot $1 | Rake $0.05 
Board [6d 4d Ks]
Seat 1: dSjkBIV7Bv+ZCIWNBguf7w (button) collected ($0.95)
Seat 2: OlPJsgR4xypSg/w1z7Gyvw (small blind) folded on the Flop
Seat 3: H5Se03ZqSX7tbULXur2MAg (big blind) folded on the Flop
Seat 4: K0b5wNInj6hUGRr6yzKFtw folded before Flop (didn't bet)
Seat 5: HPEB+AtKw1+C/cxU0o1ciw folded before Flop (didn't bet)
Seat 6: Mh2r9hTeTEDnh19sRZtW3g folded before Flop (didn't bet)
Seat 7: yyG4svzOpC1A+sUP/scg6w folded before Flop (didn't bet)
Seat 8: X1ucS3BHyBPongKl1Q+eEQ folded on the Flop
Seat 9: V6p0jQ/RhUsqpHLmXvEX4Q folded before Flop (didn't bet)




PokerStars Game #59941716790:  Hold'em No Limit ($0.10/$0.25) - 2009/07/01 1:43:55 ET
Table 'pAhiNHs/spaABQia+7gWNQ' 9-max Seat #3 is the button
Seat 1: ipgcO7Pa6LC8XWpVttZfnA ($4.65 in chips) 
Seat 2: dfNim92Z6XK1/h5SFW5vDg ($25.25 in chips) 
Seat 3: xEQxarad8/T4jJdpZy5LGw ($35.05 in chips) 
Seat 4: Qduu7ikeizo6q6Ei9YvcJA ($24.75 in chips) 
Seat 5: OlPJsgR4xypSg/w1z7Gyvw ($32.90 in chips) 
Seat 6: oLa/tXLfSLLB28mcLGrxcg ($24.85 in chips) 
Seat 7: +WTkVY3GeLxqGQBbMZQiWQ ($5.90 in chips) 
Seat 8: PskTLlFIRHSp61inskRzVg ($13.65 in chips) 
Seat 9: zgi+EUykT/pZQpoUG6+oEg ($6.15 in chips) 
Qduu7ikeizo6q6Ei9YvcJA: posts small blind $0.10
OlPJsgR4xypSg/w1z7Gyvw: posts big blind $0.25
*** HOLE CARDS ***
oLa/tXLfSLLB28mcLGrxcg: folds 
+WTkVY3GeLxqGQBbMZQiWQ: folds 
PskTLlFIRHSp61inskRzVg: raises $0.75 to $1
zgi+EUykT/pZQpoUG6+oEg: folds 
ipgcO7Pa6LC8XWpVttZfnA: folds 
dfNim92Z6XK1/h5SFW5vDg: folds 
xEQxarad8/T4jJdpZy5LGw: folds 
xEQxarad8/T4jJdpZy5LGw leaves the table
Qduu7ikeizo6q6Ei9YvcJA: folds 
OlPJsgR4xypSg/w1z7Gyvw: folds 
Uncalled bet ($0.75) returned to PskTLlFIRHSp61inskRzVg
bXpVeaSTPBFSPJmeXxO7nw joins the table at seat #3 
PskTLlFIRHSp61inskRzVg collected $0.60 from pot
PskTLlFIRHSp61inskRzVg: doesn't show hand 
*** SUMMARY ***
Total pot $0.60 | Rake $0 
Seat 1: ipgcO7Pa6LC8XWpVttZfnA folded before Flop (didn't bet)
Seat 2: dfNim92Z6XK1/h5SFW5vDg folded before Flop (didn't bet)
Seat 3: xEQxarad8/T4jJdpZy5LGw (button) folded before Flop (didn't bet)
Seat 4: Qduu7ikeizo6q6Ei9YvcJA (small blind) folded before Flop
Seat 5: OlPJsgR4xypSg/w1z7Gyvw (big blind) folded before Flop
Seat 6: oLa/tXLfSLLB28mcLGrxcg folded before Flop (didn't bet)
Seat 7: +WTkVY3GeLxqGQBbMZQiWQ folded before Flop (didn't bet)
Seat 8: PskTLlFIRHSp61inskRzVg collected ($0.60)
Seat 9: zgi+EUykT/pZQpoUG6+oEg folded before Flop (didn't bet)




PokerStars Game #59941716460:  Hold'em No Limit ($0.10/$0.25) - 2009/07/01 1:43:55 ET
Table 'AUM6O+mgQAaLDZKMQ/5/gA' 9-max Seat #3 is the button
Seat 1: EIObtVVE4WXRXvLGJA6NHw ($15.90 in chips) 
Seat 3: CvL9Ch1HYCVbTsfpNucitg ($5 in chips) 
Seat 4: 4awUyiDYTgylQKXZ9faBVA ($27.80 in chips) 
Seat 5: +2kMBNpY4nF1qNCRd8SJLA ($25.65 in chips) 
Seat 6: v5jnQ1gfh9nLla3kMXG7Yg ($7.20 in chips) 
Seat 7: Bb42QRQMhg5/Y0vHP8/2Xw ($30.60 in chips) 
Seat 9: eK8qa6EPcH2zhtbmWSvc9g ($25.30 in chips) 
4awUyiDYTgylQKXZ9faBVA: posts small blind $0.10
+2kMBNpY4nF1qNCRd8SJLA: posts big blind $0.25
*** HOLE CARDS ***
v5jnQ1gfh9nLla3kMXG7Yg: folds 
Bb42QRQMhg5/Y0vHP8/2Xw: folds 
eK8qa6EPcH2zhtbmWSvc9g: folds 
EIObtVVE4WXRXvLGJA6NHw: raises $0.50 to $0.75
CvL9Ch1HYCVbTsfpNucitg: folds 
4awUyiDYTgylQKXZ9faBVA: folds 
+2kMBNpY4nF1qNCRd8SJLA: folds 
Uncalled bet ($0.50) returned to EIObtVVE4WXRXvLGJA6NHw
EIObtVVE4WXRXvLGJA6NHw collected $0.60 from pot
EIObtVVE4WXRXvLGJA6NHw: doesn't show hand 
*** SUMMARY ***
Total pot $0.60 | Rake $0 
Seat 1: EIObtVVE4WXRXvLGJA6NHw collected ($0.60)
Seat 3: CvL9Ch1HYCVbTsfpNucitg (button) folded before Flop (didn't bet)
Seat 4: 4awUyiDYTgylQKXZ9faBVA (small blind) folded before Flop
Seat 5: +2kMBNpY4nF1qNCRd8SJLA (big blind) folded before Flop
Seat 6: v5jnQ1gfh9nLla3kMXG7Yg folded before Flop (didn't bet)
Seat 7: Bb42QRQMhg5/Y0vHP8/2Xw folded before Flop (didn't bet)
Seat 9: eK8qa6EPcH2zhtbmWSvc9g folded before Flop (didn't bet)




PokerStars Game #59941716598:  Hold'em No Limit ($0.10/$0.25) - 2009/07/01 1:43:55 ET
Table 'rhQuIjJo0UQ7RRUlF9umHg' 6-max Seat #4 is the button
Seat 1: 5O3Hj9Qg0SqOyKEXoLpjPg ($146.75 in chips) 
Seat 2: Ew/TYPQIsbQ2X8nm5iAJBg ($25 in chips) 
Seat 3: if4dh6jhJXeN3/qd3qCp9g ($27.40 in chips) 
Seat 4: buyjetgNT1McXtdaP4zynA ($43.25 in chips) 
Seat 5: dOX4wnYV2sEqvDbF+8KSCw ($49.25 in chips) 
Seat 6: /gJNBeCkWL4o85/jvlZ4BA ($52.40 in chips) 
dOX4wnYV2sEqvDbF+8KSCw: posts small blind $0.10
/gJNBeCkWL4o85/jvlZ4BA: posts big blind $0.25
*** HOLE CARDS ***
5O3Hj9Qg0SqOyKEXoLpjPg: calls $0.25
Ew/TYPQIsbQ2X8nm5iAJBg: folds 
if4dh6jhJXeN3/qd3qCp9g: folds 
buyjetgNT1McXtdaP4zynA: raises $0.75 to $1
dOX4wnYV2sEqvDbF+8KSCw: calls $0.90
/gJNBeCkWL4o85/jvlZ4BA: folds 
5O3Hj9Qg0SqOyKEXoLpjPg: calls $0.75
*** FLOP *** [As 9s 9d]
dOX4wnYV2sEqvDbF+8KSCw: checks 
5O3Hj9Qg0SqOyKEXoLpjPg: checks 
buyjetgNT1McXtdaP4zynA: bets $2
dOX4wnYV2sEqvDbF+8KSCw: calls $2
5O3Hj9Qg0SqOyKEXoLpjPg: folds 
*** TURN *** [As 9s 9d] [Ts]
dOX4wnYV2sEqvDbF+8KSCw: checks 
buyjetgNT1McXtdaP4zynA: checks 
*** RIVER *** [As 9s 9d Ts] [3h]
dOX4wnYV2sEqvDbF+8KSCw: bets $4
buyjetgNT1McXtdaP4zynA: folds 
Uncalled bet ($4) returned to dOX4wnYV2sEqvDbF+8KSCw
dOX4wnYV2sEqvDbF+8KSCw collected $6.90 from pot
dOX4wnYV2sEqvDbF+8KSCw: doesn't show hand 
*** SUMMARY ***
Total pot $7.25 | Rake $0.35 
Board [As 9s 9d Ts 3h]
Seat 1: 5O3Hj9Qg0SqOyKEXoLpjPg folded on the Flop
Seat 2: Ew/TYPQIsbQ2X8nm5iAJBg folded before Flop (didn't bet)
Seat 3: if4dh6jhJXeN3/qd3qCp9g folded before Flop (didn't bet)
Seat 4: buyjetgNT1McXtdaP4zynA (button) folded on the River
Seat 5: dOX4wnYV2sEqvDbF+8KSCw (small blind) collected ($6.90)
Seat 6: /gJNBeCkWL4o85/jvlZ4BA (big blind) folded before Flop




PokerStars Game #59941716762:  Hold'em No Limit ($0.10/$0.25) - 2009/07/01 1:43:55 ET
Table 'VQNfcI8vTBCTvRfd3veTLQ' 6-max Seat #6 is the button
Seat 1: QiL+lEgEWwy21jk/ltaRLg ($17.20 in chips) 
Seat 2: 79ID/ub1Pt/mDpCprVmOoA ($31.90 in chips) 
Seat 3: LtASJ9OlkqGrrUKGQlpGAw ($11.75 in chips) 
Seat 4: QIWnfLSqfMcoFfdDe5LZPg ($40.55 in chips) 
Seat 5: gX2vbKwS/8zZPENAWB7hxQ ($21.60 in chips) 
Seat 6: LJI7A1YgDM7hgh7o56+ReQ ($27.35 in chips) 
QiL+lEgEWwy21jk/ltaRLg: posts small blind $0.10
79ID/ub1Pt/mDpCprVmOoA: posts big blind $0.25
*** HOLE CARDS ***
LtASJ9OlkqGrrUKGQlpGAw: folds 
QIWnfLSqfMcoFfdDe5LZPg: raises $0.50 to $0.75
gX2vbKwS/8zZPENAWB7hxQ: calls $0.75
LJI7A1YgDM7hgh7o56+ReQ: folds 
QiL+lEgEWwy21jk/ltaRLg: folds 
79ID/ub1Pt/mDpCprVmOoA: folds 
*** FLOP *** [Jh 3d Qc]
QIWnfLSqfMcoFfdDe5LZPg: bets $0.75
gX2vbKwS/8zZPENAWB7hxQ: calls $0.75
*** TURN *** [Jh 3d Qc] [5d]
QIWnfLSqfMcoFfdDe5LZPg: checks 
gX2vbKwS/8zZPENAWB7hxQ: bets $1.25
QIWnfLSqfMcoFfdDe5LZPg: calls $1.25
*** RIVER *** [Jh 3d Qc 5d] [8c]
QIWnfLSqfMcoFfdDe5LZPg: checks 
gX2vbKwS/8zZPENAWB7hxQ: bets $3.75
QIWnfLSqfMcoFfdDe5LZPg: folds 
Uncalled bet ($3.75) returned to gX2vbKwS/8zZPENAWB7hxQ
gX2vbKwS/8zZPENAWB7hxQ collected $5.60 from pot
gX2vbKwS/8zZPENAWB7hxQ: doesn't show hand 
*** SUMMARY ***
Total pot $5.85 | Rake $0.25 
Board [Jh 3d Qc 5d 8c]
Seat 1: QiL+lEgEWwy21jk/ltaRLg (small blind) folded before Flop
Seat 2: 79ID/ub1Pt/mDpCprVmOoA (big blind) folded before Flop
Seat 3: LtASJ9OlkqGrrUKGQlpGAw folded before Flop (didn't bet)
Seat 4: QIWnfLSqfMcoFfdDe5LZPg folded on the River
Seat 5: gX2vbKwS/8zZPENAWB7hxQ collected ($5.60)
Seat 6: LJI7A1YgDM7hgh7o56+ReQ (button) folded before Flop (didn't bet)




PokerStars Game #59941716780:  Hold'em No Limit ($0.10/$0.25) - 2009/07/01 1:43:55 ET
Table 'biAgO3TKQBU8XcrVAoU5TA' 6-max Seat #5 is the button
Seat 1: jhDPlkir8wBYAddboBuF7Q ($17.05 in chips) 
Seat 2: GbCVUNssQ7mqsPWr7J4d3w ($5.30 in chips) 
Seat 3: mfrkWA3PTeYPkbO6hi98Aw ($32.40 in chips) 
Seat 4: Hsvkc0/G2VV78oVmWYXecw ($5 in chips) 
Seat 5: n6UPMnVR4v8LFP0rWP73Fg ($11.85 in chips) 
Seat 6: wMiE3yTbDJGOLOF9th7KPA ($8.20 in chips) 
wMiE3yTbDJGOLOF9th7KPA: posts small blind $0.10
jhDPlkir8wBYAddboBuF7Q: posts big blind $0.25
*** HOLE CARDS ***
GbCVUNssQ7mqsPWr7J4d3w: folds 
mfrkWA3PTeYPkbO6hi98Aw: folds 
Hsvkc0/G2VV78oVmWYXecw: folds 
n6UPMnVR4v8LFP0rWP73Fg: folds 
wMiE3yTbDJGOLOF9th7KPA: calls $0.15
jhDPlkir8wBYAddboBuF7Q: checks 
*** FLOP *** [Ts 9s 7c]
wMiE3yTbDJGOLOF9th7KPA: bets $0.75
jhDPlkir8wBYAddboBuF7Q: folds 
Uncalled bet ($0.75) returned to wMiE3yTbDJGOLOF9th7KPA
wMiE3yTbDJGOLOF9th7KPA collected $0.50 from pot
*** SUMMARY ***
Total pot $0.50 | Rake $0 
Board [Ts 9s 7c]
Seat 1: jhDPlkir8wBYAddboBuF7Q (big blind) folded on the Flop
Seat 2: GbCVUNssQ7mqsPWr7J4d3w folded before Flop (didn't bet)
Seat 3: mfrkWA3PTeYPkbO6hi98Aw folded before Flop (didn't bet)
Seat 4: Hsvkc0/G2VV78oVmWYXecw folded before Flop (didn't bet)
Seat 5: n6UPMnVR4v8LFP0rWP73Fg (button) folded before Flop (didn't bet)
Seat 6: wMiE3yTbDJGOLOF9th7KPA (small blind) collected ($0.50)




PokerStars Game #59941717114:  Hold'em No Limit ($0.10/$0.25) - 2009/07/01 1:43:56 ET
Table 'xPn6TS/y/OWkX7Qa+MUuKA' 6-max Seat #3 is the button
Seat 1: JFIAqU8lCZ0vWwEl4bdGsg ($43.05 in chips) 
Seat 2: buyjetgNT1McXtdaP4zynA ($28.35 in chips) 
Seat 3: q6WfTUAD9mowIP63ASq2Dg ($24.90 in chips) 
Seat 4: SS/yfeArhULzIcOPe8MdPg ($28.75 in chips) 
Seat 5: lquriepNQBhDV5P1SWHhnA ($26.85 in chips) 
Seat 6: DihMHaz4WNETH1bPDe13kA ($25 in chips) 
SS/yfeArhULzIcOPe8MdPg: posts small blind $0.10
lquriepNQBhDV5P1SWHhnA: posts big blind $0.25
*** HOLE CARDS ***
DihMHaz4WNETH1bPDe13kA: raises $0.50 to $0.75
JFIAqU8lCZ0vWwEl4bdGsg: folds 
buyjetgNT1McXtdaP4zynA: folds 
q6WfTUAD9mowIP63ASq2Dg: folds 
SS/yfeArhULzIcOPe8MdPg: folds 
lquriepNQBhDV5P1SWHhnA: folds 
Uncalled bet ($0.50) returned to DihMHaz4WNETH1bPDe13kA
DihMHaz4WNETH1bPDe13kA collected $0.60 from pot
*** SUMMARY ***
Total pot $0.60 | Rake $0 
Seat 1: JFIAqU8lCZ0vWwEl4bdGsg folded before Flop (didn't bet)
Seat 2: buyjetgNT1McXtdaP4zynA folded before Flop (didn't bet)
Seat 3: q6WfTUAD9mowIP63ASq2Dg (button) folded before Flop (didn't bet)
Seat 4: SS/yfeArhULzIcOPe8MdPg (small blind) folded before Flop
Seat 5: lquriepNQBhDV5P1SWHhnA (big blind) folded before Flop
Seat 6: DihMHaz4WNETH1bPDe13kA collected ($0.60)




PokerStars Game #59941717258:  Hold'em No Limit ($0.10/$0.25) - 2009/07/01 1:43:56 ET
Table '52Meibn9NOL4XtVi1p2Upw' 9-max Seat #1 is the button
Seat 1: W6tExOcYX7qiy6Qdp+ZwFA ($6.80 in chips) 
Seat 3: Bb42QRQMhg5/Y0vHP8/2Xw ($25 in chips) 
Seat 4: oLa/tXLfSLLB28mcLGrxcg ($31.65 in chips) 
Seat 5: MXCztnYJ58KLHMztZvKrxA ($4.75 in chips) 
Seat 8: PFv56Q1PTkDC084eXIAYmw ($23.75 in chips) 
Seat 9: RCqMONFrSPSArZh2Jsar/w ($19.65 in chips) 
Bb42QRQMhg5/Y0vHP8/2Xw: posts small blind $0.10
oLa/tXLfSLLB28mcLGrxcg: posts big blind $0.25
WPT_Champ111: sits out 
Qduu7ikeizo6q6Ei9YvcJA: sits out 
*** HOLE CARDS ***
MXCztnYJ58KLHMztZvKrxA: folds 
PFv56Q1PTkDC084eXIAYmw: folds 
RCqMONFrSPSArZh2Jsar/w: folds 
W6tExOcYX7qiy6Qdp+ZwFA: folds 
Bb42QRQMhg5/Y0vHP8/2Xw: folds 
Uncalled bet ($0.15) returned to oLa/tXLfSLLB28mcLGrxcg
oLa/tXLfSLLB28mcLGrxcg collected $0.20 from pot
oLa/tXLfSLLB28mcLGrxcg: doesn't show hand 
*** SUMMARY ***
Total pot $0.20 | Rake $0 
Seat 1: W6tExOcYX7qiy6Qdp+ZwFA (button) folded before Flop (didn't bet)
Seat 3: Bb42QRQMhg5/Y0vHP8/2Xw (small blind) folded before Flop
Seat 4: oLa/tXLfSLLB28mcLGrxcg (big blind) collected ($0.20)
Seat 5: MXCztnYJ58KLHMztZvKrxA folded before Flop (didn't bet)
Seat 8: PFv56Q1PTkDC084eXIAYmw folded before Flop (didn't bet)
Seat 9: RCqMONFrSPSArZh2Jsar/w folded before Flop (didn't bet)




PokerStars Game #59941717412:  Hold'em No Limit ($0.10/$0.25) - 2009/07/01 1:43:56 ET
Table '7/qMNloI0nSXWiX5Y1watA' 9-max Seat #6 is the button
Seat 1: /LyhaB3V6jkgOfXORidqRQ ($7.10 in chips) 
Seat 2: wGigCmBR/9XWkPpvYos3aQ ($26.20 in chips) 
Seat 3: W2YYHvqjaEpRrO7stZkClQ ($4.35 in chips) 
Seat 4: K0LdhPeU31rviEPo6Sv3TA ($9 in chips) 
Seat 6: Y3DZ6qQlLeBhixDj4M9vmg ($17.50 in chips) 
Seat 8: ljemhp25Zg+nlA9DLCIiUw ($23.75 in chips) 
Seat 9: dmYlc+1cjwZMJ7wV+Z0rRg ($26.35 in chips) 
ljemhp25Zg+nlA9DLCIiUw: posts small blind $0.10
dmYlc+1cjwZMJ7wV+Z0rRg: posts big blind $0.25
K0LdhPeU31rviEPo6Sv3TA: posts small & big blinds $0.35
*** HOLE CARDS ***
/LyhaB3V6jkgOfXORidqRQ: folds 
wGigCmBR/9XWkPpvYos3aQ: folds 
W2YYHvqjaEpRrO7stZkClQ: folds 
K0LdhPeU31rviEPo6Sv3TA: checks 
Y3DZ6qQlLeBhixDj4M9vmg: calls $0.25
ljemhp25Zg+nlA9DLCIiUw: calls $0.15
dmYlc+1cjwZMJ7wV+Z0rRg: checks 
*** FLOP *** [4h Ts Ac]
ljemhp25Zg+nlA9DLCIiUw: checks 
dmYlc+1cjwZMJ7wV+Z0rRg: checks 
K0LdhPeU31rviEPo6Sv3TA: checks 
Y3DZ6qQlLeBhixDj4M9vmg: checks 
*** TURN *** [4h Ts Ac] [5c]
ljemhp25Zg+nlA9DLCIiUw: bets $0.75
dmYlc+1cjwZMJ7wV+Z0rRg: folds 
K0LdhPeU31rviEPo6Sv3TA: folds 
Y3DZ6qQlLeBhixDj4M9vmg: folds 
Uncalled bet ($0.75) returned to ljemhp25Zg+nlA9DLCIiUw
ljemhp25Zg+nlA9DLCIiUw collected $1.05 from pot
ljemhp25Zg+nlA9DLCIiUw: doesn't show hand 
*** SUMMARY ***
Total pot $1.10 | Rake $0.05 
Board [4h Ts Ac 5c]
Seat 1: /LyhaB3V6jkgOfXORidqRQ folded before Flop (didn't bet)
Seat 2: wGigCmBR/9XWkPpvYos3aQ folded before Flop (didn't bet)
Seat 3: W2YYHvqjaEpRrO7stZkClQ folded before Flop (didn't bet)
Seat 4: K0LdhPeU31rviEPo6Sv3TA folded on the Turn
Seat 6: Y3DZ6qQlLeBhixDj4M9vmg (button) folded on the Turn
Seat 8: ljemhp25Zg+nlA9DLCIiUw (small blind) collected ($1.05)
Seat 9: dmYlc+1cjwZMJ7wV+Z0rRg (big blind) folded on the Turn




PokerStars Game #59941717166:  Hold'em No Limit ($0.10/$0.25) - 2009/07/01 1:43:56 ET
Table 'Yb2CyZosw7N3yRRVLhKnKg' 9-max Seat #9 is the button
Seat 1: c/9X4zftzphFxYtxp5kp9w ($14.65 in chips) 
Seat 2: dtZ84flFEi4Q+SGrHMJRDQ ($27.90 in chips) 
Seat 3: I8/fpJ2v6LsVf0kxqaVdMQ ($16.50 in chips) 
Seat 4: FG10kumpruEJ3PQJ7oGglQ ($11.35 in chips) 
Seat 5: T5Hk9oiIr+JDDMnEqwFCrw ($2.25 in chips) 
Seat 6: CgIo2ItZqi4o3ayVG6HanQ ($43.95 in chips) 
Seat 7: ljemhp25Zg+nlA9DLCIiUw ($26.85 in chips) 
Seat 8: HxDF4QSxC4z39D7teZpprQ ($10.75 in chips) 
Seat 9: 6DVf3fwEGECnjQ4Yp9AsFw ($15.50 in chips) 
c/9X4zftzphFxYtxp5kp9w: posts small blind $0.10
dtZ84flFEi4Q+SGrHMJRDQ: posts big blind $0.25
*** HOLE CARDS ***
I8/fpJ2v6LsVf0kxqaVdMQ: folds 
I8/fpJ2v6LsVf0kxqaVdMQ leaves the table
FG10kumpruEJ3PQJ7oGglQ: raises $0.50 to $0.75
T5Hk9oiIr+JDDMnEqwFCrw: folds 
CgIo2ItZqi4o3ayVG6HanQ: folds 
ljemhp25Zg+nlA9DLCIiUw: folds 
HxDF4QSxC4z39D7teZpprQ: folds 
6DVf3fwEGECnjQ4Yp9AsFw: folds 
c/9X4zftzphFxYtxp5kp9w: folds 
wUanlt/hhheMA+jOrJk2Tg joins the table at seat #3 
dtZ84flFEi4Q+SGrHMJRDQ: folds 
Uncalled bet ($0.50) returned to FG10kumpruEJ3PQJ7oGglQ
FG10kumpruEJ3PQJ7oGglQ collected $0.60 from pot
*** SUMMARY ***
Total pot $0.60 | Rake $0 
Seat 1: c/9X4zftzphFxYtxp5kp9w (small blind) folded before Flop
Seat 2: dtZ84flFEi4Q+SGrHMJRDQ (big blind) folded before Flop
Seat 3: I8/fpJ2v6LsVf0kxqaVdMQ folded before Flop (didn't bet)
Seat 4: FG10kumpruEJ3PQJ7oGglQ collected ($0.60)
Seat 5: T5Hk9oiIr+JDDMnEqwFCrw folded before Flop (didn't bet)
Seat 6: CgIo2ItZqi4o3ayVG6HanQ folded before Flop (didn't bet)
Seat 7: ljemhp25Zg+nlA9DLCIiUw folded before Flop (didn't bet)
Seat 8: HxDF4QSxC4z39D7teZpprQ folded before Flop (didn't bet)
Seat 9: 6DVf3fwEGECnjQ4Yp9AsFw (button) folded before Flop (didn't bet)




PokerStars Game #59941717380:  Hold'em No Limit ($0.10/$0.25) - 2009/07/01 1:43:56 ET
Table 'YlRA05h9BJ1EhOUSNUjJdg' 9-max Seat #5 is the button
Seat 1: dtZ84flFEi4Q+SGrHMJRDQ ($25 in chips) 
Seat 2: Y2GFAe+PT7xnUUtgqCNDFw ($12.05 in chips) 
Seat 3: Z5ZtGOON8kmSdSCll9Z3XA ($13.20 in chips) 
Seat 4: HPEB+AtKw1+C/cxU0o1ciw ($31.35 in chips) 
Seat 5: sx0lGrkT9fd4yFR+3cXUQg ($11.05 in chips) 
Seat 6: QEbIGci+itdw+re8RM5fZA ($44.10 in chips) 
Seat 7: dfNim92Z6XK1/h5SFW5vDg ($25 in chips) 
Seat 8: dmYlc+1cjwZMJ7wV+Z0rRg ($32.90 in chips) 
Seat 9: Z9AeOQX3yzuSvKAm/xyovg ($9.75 in chips) 
QEbIGci+itdw+re8RM5fZA: posts small blind $0.10
dfNim92Z6XK1/h5SFW5vDg: posts big blind $0.25
*** HOLE CARDS ***
dmYlc+1cjwZMJ7wV+Z0rRg: folds 
Z9AeOQX3yzuSvKAm/xyovg: calls $0.25
dtZ84flFEi4Q+SGrHMJRDQ: folds 
Y2GFAe+PT7xnUUtgqCNDFw: folds 
Z5ZtGOON8kmSdSCll9Z3XA: folds 
HPEB+AtKw1+C/cxU0o1ciw: folds 
sx0lGrkT9fd4yFR+3cXUQg: raises $1.25 to $1.50
QEbIGci+itdw+re8RM5fZA: folds 
dfNim92Z6XK1/h5SFW5vDg: folds 
Z9AeOQX3yzuSvKAm/xyovg: folds 
Uncalled bet ($1.25) returned to sx0lGrkT9fd4yFR+3cXUQg
sx0lGrkT9fd4yFR+3cXUQg collected $0.85 from pot
sx0lGrkT9fd4yFR+3cXUQg: doesn't show hand 
*** SUMMARY ***
Total pot $0.85 | Rake $0 
Seat 1: dtZ84flFEi4Q+SGrHMJRDQ folded before Flop (didn't bet)
Seat 2: Y2GFAe+PT7xnUUtgqCNDFw folded before Flop (didn't bet)
Seat 3: Z5ZtGOON8kmSdSCll9Z3XA folded before Flop (didn't bet)
Seat 4: HPEB+AtKw1+C/cxU0o1ciw folded before Flop (didn't bet)
Seat 5: sx0lGrkT9fd4yFR+3cXUQg (button) collected ($0.85)
Seat 6: QEbIGci+itdw+re8RM5fZA (small blind) folded before Flop
Seat 7: dfNim92Z6XK1/h5SFW5vDg (big blind) folded before Flop
Seat 8: dmYlc+1cjwZMJ7wV+Z0rRg folded before Flop (didn't bet)
Seat 9: Z9AeOQX3yzuSvKAm/xyovg folded before Flop




PokerStars Game #59941717394:  Hold'em No Limit ($0.10/$0.25) - 2009/07/01 1:43:56 ET
Table '2VkNDXXsBj4bSZw/uK5atw' 6-max Seat #5 is the button
Seat 1: xrf8tAXKQHG99HixCot1Iw ($15.35 in chips) 
Seat 2: v6mkGzCBCCXcgWQNSYVtKg ($13.30 in chips) 
Seat 5: 7f0OkhFEOf3T+rVOFHRLnw ($21.20 in chips) 
Seat 6: n6UPMnVR4v8LFP0rWP73Fg ($9.95 in chips) 
n6UPMnVR4v8LFP0rWP73Fg: posts small blind $0.10
xrf8tAXKQHG99HixCot1Iw: posts big blind $0.25
*** HOLE CARDS ***
v6mkGzCBCCXcgWQNSYVtKg: folds 
7f0OkhFEOf3T+rVOFHRLnw: raises $0.50 to $0.75
n6UPMnVR4v8LFP0rWP73Fg: folds 
xrf8tAXKQHG99HixCot1Iw: folds 
Uncalled bet ($0.50) returned to 7f0OkhFEOf3T+rVOFHRLnw
7f0OkhFEOf3T+rVOFHRLnw collected $0.60 from pot
*** SUMMARY ***
Total pot $0.60 | Rake $0 
Seat 1: xrf8tAXKQHG99HixCot1Iw (big blind) folded before Flop
Seat 2: v6mkGzCBCCXcgWQNSYVtKg folded before Flop (didn't bet)
Seat 5: 7f0OkhFEOf3T+rVOFHRLnw (button) collected ($0.60)
Seat 6: n6UPMnVR4v8LFP0rWP73Fg (small blind) folded before Flop




PokerStars Game #59941717714:  Hold'em No Limit ($0.10/$0.25) - 2009/07/01 1:43:57 ET
Table 'hg+KpirwreMnBAFQr/SEUA' 9-max Seat #6 is the button
Seat 1: H5Se03ZqSX7tbULXur2MAg ($33.80 in chips) 
Seat 2: cpnBzHjFACn5zAY56UIvNA ($19.45 in chips) 
Seat 3: DdyXKuBx0HAOC7dWZmGxWg ($24.25 in chips) 
Seat 5: +2kMBNpY4nF1qNCRd8SJLA ($25 in chips) 
Seat 6: Bb42QRQMhg5/Y0vHP8/2Xw ($25 in chips) 
Seat 7: 5LSuZS4qvcUri/Byfkln7w ($8.50 in chips) 
Seat 8: HPEB+AtKw1+C/cxU0o1ciw ($23.75 in chips) 
Seat 9: xbecloQJYmBOSkzT9lZ+rg ($20.50 in chips) 
5LSuZS4qvcUri/Byfkln7w: posts small blind $0.10
HPEB+AtKw1+C/cxU0o1ciw: posts big blind $0.25
Z9W7+g1WMhhZDi7DwGbCFA: sits out 
*** HOLE CARDS ***
xbecloQJYmBOSkzT9lZ+rg: folds 
H5Se03ZqSX7tbULXur2MAg: folds 
cpnBzHjFACn5zAY56UIvNA: raises $0.75 to $1
DdyXKuBx0HAOC7dWZmGxWg: folds 
+2kMBNpY4nF1qNCRd8SJLA: folds 
Bb42QRQMhg5/Y0vHP8/2Xw: folds 
5LSuZS4qvcUri/Byfkln7w: calls $0.90
HPEB+AtKw1+C/cxU0o1ciw: folds 
*** FLOP *** [2c Qs 7h]
5LSuZS4qvcUri/Byfkln7w: checks 
cpnBzHjFACn5zAY56UIvNA: bets $1.50
5LSuZS4qvcUri/Byfkln7w: folds 
Uncalled bet ($1.50) returned to cpnBzHjFACn5zAY56UIvNA
cpnBzHjFACn5zAY56UIvNA collected $2.15 from pot
cpnBzHjFACn5zAY56UIvNA: doesn't show hand 
*** SUMMARY ***
Total pot $2.25 | Rake $0.10 
Board [2c Qs 7h]
Seat 1: H5Se03ZqSX7tbULXur2MAg folded before Flop (didn't bet)
Seat 2: cpnBzHjFACn5zAY56UIvNA collected ($2.15)
Seat 3: DdyXKuBx0HAOC7dWZmGxWg folded before Flop (didn't bet)
Seat 5: +2kMBNpY4nF1qNCRd8SJLA folded before Flop (didn't bet)
Seat 6: Bb42QRQMhg5/Y0vHP8/2Xw (button) folded before Flop (didn't bet)
Seat 7: 5LSuZS4qvcUri/Byfkln7w (small blind) folded on the Flop
Seat 8: HPEB+AtKw1+C/cxU0o1ciw (big blind) folded before Flop
Seat 9: xbecloQJYmBOSkzT9lZ+rg folded before Flop (didn't bet)




PokerStars Game #59941717570:  Hold'em No Limit ($0.10/$0.25) - 2009/07/01 1:43:57 ET
Table 'Qr+t8WGovMECkBv+cV1lrg' 6-max Seat #1 is the button
Seat 1: EeUZtMU058v2ObUACOF4Og ($44.75 in chips) 
Seat 2: vqWjZmdQu/Hxw96/IJTWdQ ($25 in chips) 
Seat 3: uZKkrGByYgd4/ZBX2d4z+w ($27.15 in chips) 
Seat 4: 1NNFfYMd5Hsphl/FYz9fNA ($61.60 in chips) 
Seat 5: 9q7YGTKe9k5fYb4fmZc3Ww ($32.35 in chips) 
vqWjZmdQu/Hxw96/IJTWdQ: posts small blind $0.10
uZKkrGByYgd4/ZBX2d4z+w: posts big blind $0.25
9U3ZKjCsarN0DjR6mSE8Ug: sits out 
*** HOLE CARDS ***
1NNFfYMd5Hsphl/FYz9fNA: raises $0.50 to $0.75
9q7YGTKe9k5fYb4fmZc3Ww: folds 
EeUZtMU058v2ObUACOF4Og: folds 
uZKkrGByYgd4/ZBX2d4z+w said, "lol"
vqWjZmdQu/Hxw96/IJTWdQ: folds 
uZKkrGByYgd4/ZBX2d4z+w: calls $0.50
*** FLOP *** [9s 3h Th]
uZKkrGByYgd4/ZBX2d4z+w: checks 
1NNFfYMd5Hsphl/FYz9fNA: bets $0.75
uZKkrGByYgd4/ZBX2d4z+w: folds 
Uncalled bet ($0.75) returned to 1NNFfYMd5Hsphl/FYz9fNA
1NNFfYMd5Hsphl/FYz9fNA collected $1.55 from pot
*** SUMMARY ***
Total pot $1.60 | Rake $0.05 
Board [9s 3h Th]
Seat 1: EeUZtMU058v2ObUACOF4Og (button) folded before Flop (didn't bet)
Seat 2: vqWjZmdQu/Hxw96/IJTWdQ (small blind) folded before Flop
Seat 3: uZKkrGByYgd4/ZBX2d4z+w (big blind) folded on the Flop
Seat 4: 1NNFfYMd5Hsphl/FYz9fNA collected ($1.55)
Seat 5: 9q7YGTKe9k5fYb4fmZc3Ww folded before Flop (didn't bet)




PokerStars Game #59941717962:  Hold'em No Limit ($0.10/$0.25) - 2009/07/01 1:43:57 ET
Table '3KDMdm1sfxFsNKkjc/PnBg' 9-max Seat #8 is the button
Seat 1: JvrJoga8hK8pnB3KGQHl1g ($8.25 in chips) 
Seat 2: 5WLo/V8l3QfpUdK9JPp99w ($24.20 in chips) 
Seat 3: OXPkK84/qv92EMwXPiG5rQ ($9.25 in chips) 
Seat 4: F7pnn6czNpHvRM55XcA2EA ($37.85 in chips) 
Seat 5: +2kMBNpY4nF1qNCRd8SJLA ($31.45 in chips) 
Seat 6: sGFnnRCa1YAHAUmWgsW6Qg ($9.85 in chips) 
Seat 7: gehe91e0IyVT0QU/XBkEyg ($31.80 in chips) 
Seat 8: LFnLiiWho1pLiR1Xvp5d/w ($8.55 in chips) 
Seat 9: K0b5wNInj6hUGRr6yzKFtw ($32.70 in chips) 
K0b5wNInj6hUGRr6yzKFtw: posts small blind $0.10
JvrJoga8hK8pnB3KGQHl1g: posts big blind $0.25
*** HOLE CARDS ***
5WLo/V8l3QfpUdK9JPp99w: raises $0.25 to $0.50
OXPkK84/qv92EMwXPiG5rQ: folds 
F7pnn6czNpHvRM55XcA2EA: folds 
+2kMBNpY4nF1qNCRd8SJLA: folds 
sGFnnRCa1YAHAUmWgsW6Qg: folds 
gehe91e0IyVT0QU/XBkEyg: folds 
LFnLiiWho1pLiR1Xvp5d/w: folds 
K0b5wNInj6hUGRr6yzKFtw: folds 
JvrJoga8hK8pnB3KGQHl1g: folds 
Uncalled bet ($0.25) returned to 5WLo/V8l3QfpUdK9JPp99w
5WLo/V8l3QfpUdK9JPp99w collected $0.60 from pot
*** SUMMARY ***
Total pot $0.60 | Rake $0 
Seat 1: JvrJoga8hK8pnB3KGQHl1g (big blind) folded before Flop
Seat 2: 5WLo/V8l3QfpUdK9JPp99w collected ($0.60)
Seat 3: OXPkK84/qv92EMwXPiG5rQ folded before Flop (didn't bet)
Seat 4: F7pnn6czNpHvRM55XcA2EA folded before Flop (didn't bet)
Seat 5: +2kMBNpY4nF1qNCRd8SJLA folded before Flop (didn't bet)
Seat 6: sGFnnRCa1YAHAUmWgsW6Qg folded before Flop (didn't bet)
Seat 7: gehe91e0IyVT0QU/XBkEyg folded before Flop (didn't bet)
Seat 8: LFnLiiWho1pLiR1Xvp5d/w (button) folded before Flop (didn't bet)
Seat 9: K0b5wNInj6hUGRr6yzKFtw (small blind) folded before Flop




PokerStars Game #59941717984:  Hold'em No Limit ($0.10/$0.25) - 2009/07/01 1:43:57 ET
Table '1zj0+miaIL9cvwnT/50pOA' 9-max Seat #2 is the button
Seat 1: PVxvfRTRvkgZf9WtquEkwQ ($25.35 in chips) 
Seat 2: HPEB+AtKw1+C/cxU0o1ciw ($42.95 in chips) 
Seat 3: dtZ84flFEi4Q+SGrHMJRDQ ($28.35 in chips) 
Seat 4: PdIasPkzm2sqZnN41ZRXOg ($5 in chips) 
Seat 5: 57qrNGHDvf6GhB8zVLsAtQ ($4.35 in chips) 
Seat 6: YZaC69gFrepA6oCGtu7E0w ($29.20 in chips) 
Seat 7: 6RiVTYll/5D8zICp0MRpKw ($23.90 in chips) 
Seat 8: Ihhh49x48fayPIyvl2Rsmg ($35.10 in chips) 
Seat 9: AyqFvLFzJDE7yMbXP362BA ($26.90 in chips) 
dtZ84flFEi4Q+SGrHMJRDQ: posts small blind $0.10
PdIasPkzm2sqZnN41ZRXOg: posts big blind $0.25
*** HOLE CARDS ***
57qrNGHDvf6GhB8zVLsAtQ: folds 
YZaC69gFrepA6oCGtu7E0w: calls $0.25
6RiVTYll/5D8zICp0MRpKw has timed out
6RiVTYll/5D8zICp0MRpKw: folds 
6RiVTYll/5D8zICp0MRpKw is sitting out
Ihhh49x48fayPIyvl2Rsmg: folds 
AyqFvLFzJDE7yMbXP362BA: folds 
PVxvfRTRvkgZf9WtquEkwQ: folds 
6RiVTYll/5D8zICp0MRpKw has returned
HPEB+AtKw1+C/cxU0o1ciw: folds 
dtZ84flFEi4Q+SGrHMJRDQ: folds 
PdIasPkzm2sqZnN41ZRXOg: checks 
*** FLOP *** [Jc 7s 4s]
PdIasPkzm2sqZnN41ZRXOg: checks 
YZaC69gFrepA6oCGtu7E0w: bets $0.50
PdIasPkzm2sqZnN41ZRXOg: folds 
Uncalled bet ($0.50) returned to YZaC69gFrepA6oCGtu7E0w
YZaC69gFrepA6oCGtu7E0w collected $0.60 from pot
*** SUMMARY ***
Total pot $0.60 | Rake $0 
Board [Jc 7s 4s]
Seat 1: PVxvfRTRvkgZf9WtquEkwQ folded before Flop (didn't bet)
Seat 2: HPEB+AtKw1+C/cxU0o1ciw (button) folded before Flop (didn't bet)
Seat 3: dtZ84flFEi4Q+SGrHMJRDQ (small blind) folded before Flop
Seat 4: PdIasPkzm2sqZnN41ZRXOg (big blind) folded on the Flop
Seat 5: 57qrNGHDvf6GhB8zVLsAtQ folded before Flop (didn't bet)
Seat 6: YZaC69gFrepA6oCGtu7E0w collected ($0.60)
Seat 7: 6RiVTYll/5D8zICp0MRpKw folded before Flop (didn't bet)
Seat 8: Ihhh49x48fayPIyvl2Rsmg folded before Flop (didn't bet)
Seat 9: AyqFvLFzJDE7yMbXP362BA folded before Flop (didn't bet)




PokerStars Game #59941718062:  Hold'em No Limit ($0.10/$0.25) - 2009/07/01 1:43:57 ET
Table 'T/iCKJXGphRN3xcdwfE/JQ' 6-max Seat #3 is the button
Seat 1: wAKC8C/zN0c8V5v13dm9mA ($25 in chips) 
Seat 2: EeUZtMU058v2ObUACOF4Og ($36.30 in chips) 
Seat 3: IWAjoCPXtc1XUaZdp+pCpA ($23.35 in chips) 
Seat 4: tSR4329m40dZsN7YOpI9Kw ($53.05 in chips) 
Seat 5: gaPMxLGp9SOj4Lq6t+/0Ig ($4.20 in chips) 
Seat 6: Ey4Kn6PlnYb2srYYBJHvzg ($13.20 in chips) 
tSR4329m40dZsN7YOpI9Kw: posts small blind $0.10
gaPMxLGp9SOj4Lq6t+/0Ig: posts big blind $0.25
*** HOLE CARDS ***
Ey4Kn6PlnYb2srYYBJHvzg: raises $0.75 to $1
wAKC8C/zN0c8V5v13dm9mA: folds 
EeUZtMU058v2ObUACOF4Og: folds 
IWAjoCPXtc1XUaZdp+pCpA: folds 
tSR4329m40dZsN7YOpI9Kw: folds 
gaPMxLGp9SOj4Lq6t+/0Ig: folds 
Uncalled bet ($0.75) returned to Ey4Kn6PlnYb2srYYBJHvzg
Ey4Kn6PlnYb2srYYBJHvzg collected $0.60 from pot
*** SUMMARY ***
Total pot $0.60 | Rake $0 
Seat 1: wAKC8C/zN0c8V5v13dm9mA folded before Flop (didn't bet)
Seat 2: EeUZtMU058v2ObUACOF4Og folded before Flop (didn't bet)
Seat 3: IWAjoCPXtc1XUaZdp+pCpA (button) folded before Flop (didn't bet)
Seat 4: tSR4329m40dZsN7YOpI9Kw (small blind) folded before Flop
Seat 5: gaPMxLGp9SOj4Lq6t+/0Ig (big blind) folded before Flop
Seat 6: Ey4Kn6PlnYb2srYYBJHvzg collected ($0.60)




PokerStars Game #59941717554:  Hold'em No Limit ($0.10/$0.25) - 2009/07/01 1:43:57 ET
Table 'Do4nrTNDYpK3sQjwFxX+Og' 6-max Seat #6 is the button
Seat 1: 7JrQNOR9wRBxq9ijFhWieg ($38.15 in chips) 
Seat 2: tzMoGl9F0PUr5NibYueeSw ($69.25 in chips) 
Seat 3: TSmua8tGK3sTbwi0ynrW9Q ($25 in chips) 
Seat 4: cWc85bEzdRzpUMhRKm8pwQ ($33.40 in chips) 
Seat 5: Ew/TYPQIsbQ2X8nm5iAJBg ($35.20 in chips) 
Seat 6: lBoEwOFgzcERLIRUkUoRTw ($23.55 in chips) 
7JrQNOR9wRBxq9ijFhWieg: posts small blind $0.10
tzMoGl9F0PUr5NibYueeSw: posts big blind $0.25
*** HOLE CARDS ***
tzMoGl9F0PUr5NibYueeSw said, "should have floated"
TSmua8tGK3sTbwi0ynrW9Q: raises $0.50 to $0.75
cWc85bEzdRzpUMhRKm8pwQ: folds 
Ew/TYPQIsbQ2X8nm5iAJBg: folds 
lBoEwOFgzcERLIRUkUoRTw: folds 
7JrQNOR9wRBxq9ijFhWieg said, "sinkable"
7JrQNOR9wRBxq9ijFhWieg: folds 
tzMoGl9F0PUr5NibYueeSw: calls $0.50
*** FLOP *** [3d Ac Qs]
tzMoGl9F0PUr5NibYueeSw said, "you would have been sinking yes"
tzMoGl9F0PUr5NibYueeSw: checks 
TSmua8tGK3sTbwi0ynrW9Q: bets $1
tzMoGl9F0PUr5NibYueeSw: calls $1
*** TURN *** [3d Ac Qs] [9h]
tzMoGl9F0PUr5NibYueeSw: checks 
TSmua8tGK3sTbwi0ynrW9Q: bets $2.25
tzMoGl9F0PUr5NibYueeSw: folds 
Uncalled bet ($2.25) returned to TSmua8tGK3sTbwi0ynrW9Q
TSmua8tGK3sTbwi0ynrW9Q collected $3.45 from pot
*** SUMMARY ***
Total pot $3.60 | Rake $0.15 
Board [3d Ac Qs 9h]
Seat 1: 7JrQNOR9wRBxq9ijFhWieg (small blind) folded before Flop
Seat 2: tzMoGl9F0PUr5NibYueeSw (big blind) folded on the Turn
Seat 3: TSmua8tGK3sTbwi0ynrW9Q collected ($3.45)
Seat 4: cWc85bEzdRzpUMhRKm8pwQ folded before Flop (didn't bet)
Seat 5: Ew/TYPQIsbQ2X8nm5iAJBg folded before Flop (didn't bet)
Seat 6: lBoEwOFgzcERLIRUkUoRTw (button) folded before Flop (didn't bet)




PokerStars Game #59941717572:  Hold'em No Limit ($0.10/$0.25) - 2009/07/01 1:43:57 ET
Table 'M7d9IrgQUUFFy/SZ3ksLYg' 6-max Seat #5 is the button
Seat 1: ypmjhffk/YHGc51wgVXUTw ($49.60 in chips) 
Seat 2: gqrr7lSWrQ1N8zKx8zZzvA ($9.05 in chips) 
Seat 3: 8JTm/CXBn3+kuQgcUOgPkw ($22.70 in chips) 
Seat 4: 8ClCHtFXGNplITm+63KB+Q ($24.55 in chips) 
Seat 5: kMa8BltUcBQVxnHfqdCfXg ($3.20 in chips) 
Seat 6: 7S16WhQHiAVLWwRuqPrpnw ($13.30 in chips) 
7S16WhQHiAVLWwRuqPrpnw: posts small blind $0.10
ypmjhffk/YHGc51wgVXUTw: posts big blind $0.25
*** HOLE CARDS ***
gqrr7lSWrQ1N8zKx8zZzvA: calls $0.25
8JTm/CXBn3+kuQgcUOgPkw: folds 
8ClCHtFXGNplITm+63KB+Q: folds 
kMa8BltUcBQVxnHfqdCfXg: calls $0.25
7S16WhQHiAVLWwRuqPrpnw: calls $0.15
ypmjhffk/YHGc51wgVXUTw: checks 
*** FLOP *** [2s 8s 5s]
7S16WhQHiAVLWwRuqPrpnw: checks 
ypmjhffk/YHGc51wgVXUTw: checks 
gqrr7lSWrQ1N8zKx8zZzvA: checks 
kMa8BltUcBQVxnHfqdCfXg: checks 
*** TURN *** [2s 8s 5s] [Ts]
7S16WhQHiAVLWwRuqPrpnw: checks 
ypmjhffk/YHGc51wgVXUTw: checks 
gqrr7lSWrQ1N8zKx8zZzvA: checks 
kMa8BltUcBQVxnHfqdCfXg: checks 
*** RIVER *** [2s 8s 5s Ts] [Ac]
7S16WhQHiAVLWwRuqPrpnw: checks 
ypmjhffk/YHGc51wgVXUTw: checks 
gqrr7lSWrQ1N8zKx8zZzvA: checks 
kMa8BltUcBQVxnHfqdCfXg: bets $0.25
7S16WhQHiAVLWwRuqPrpnw: folds 
ypmjhffk/YHGc51wgVXUTw: folds 
gqrr7lSWrQ1N8zKx8zZzvA: folds 
Uncalled bet ($0.25) returned to kMa8BltUcBQVxnHfqdCfXg
kMa8BltUcBQVxnHfqdCfXg collected $0.95 from pot
*** SUMMARY ***
Total pot $1 | Rake $0.05 
Board [2s 8s 5s Ts Ac]
Seat 1: ypmjhffk/YHGc51wgVXUTw (big blind) folded on the River
Seat 2: gqrr7lSWrQ1N8zKx8zZzvA folded on the River
Seat 3: 8JTm/CXBn3+kuQgcUOgPkw folded before Flop (didn't bet)
Seat 4: 8ClCHtFXGNplITm+63KB+Q folded before Flop (didn't bet)
Seat 5: kMa8BltUcBQVxnHfqdCfXg (button) collected ($0.95)
Seat 6: 7S16WhQHiAVLWwRuqPrpnw (small blind) folded on the River




PokerStars Game #59941717590:  Hold'em No Limit ($0.10/$0.25) - 2009/07/01 1:43:57 ET
Table 'O6cwjhrMn9pfzx1Ngn5zkQ' 6-max Seat #3 is the button
Seat 1: LJI7A1YgDM7hgh7o56+ReQ ($30.55 in chips) 
Seat 2: tSR4329m40dZsN7YOpI9Kw ($29.35 in chips) 
Seat 3: EE16Ua5b1HSsYej5zeXOlA ($25.45 in chips) 
Seat 4: mfrkWA3PTeYPkbO6hi98Aw ($24.05 in chips) 
Seat 5: niLn0xUVlqh8If80xRjzCA ($25.60 in chips) 
Seat 6: 4TM16KVgEiQpLi4bVVWbVQ ($32.70 in chips) 
mfrkWA3PTeYPkbO6hi98Aw: posts small blind $0.10
niLn0xUVlqh8If80xRjzCA: posts big blind $0.25
*** HOLE CARDS ***
4TM16KVgEiQpLi4bVVWbVQ: folds 
LJI7A1YgDM7hgh7o56+ReQ: raises $0.75 to $1
tSR4329m40dZsN7YOpI9Kw: folds 
EE16Ua5b1HSsYej5zeXOlA: folds 
mfrkWA3PTeYPkbO6hi98Aw: folds 
niLn0xUVlqh8If80xRjzCA: calls $0.75
*** FLOP *** [6h 2h Qs]
niLn0xUVlqh8If80xRjzCA: checks 
LJI7A1YgDM7hgh7o56+ReQ: bets $1.75
niLn0xUVlqh8If80xRjzCA: calls $1.75
*** TURN *** [6h 2h Qs] [2c]
niLn0xUVlqh8If80xRjzCA: checks 
LJI7A1YgDM7hgh7o56+ReQ: checks 
*** RIVER *** [6h 2h Qs 2c] [Kh]
niLn0xUVlqh8If80xRjzCA: checks 
LJI7A1YgDM7hgh7o56+ReQ: checks 
*** SHOW DOWN ***
niLn0xUVlqh8If80xRjzCA: shows [As 6d] (two pair, Sixes and Deuces)
LJI7A1YgDM7hgh7o56+ReQ: mucks hand 
niLn0xUVlqh8If80xRjzCA collected $5.35 from pot
*** SUMMARY ***
Total pot $5.60 | Rake $0.25 
Board [6h 2h Qs 2c Kh]
Seat 1: LJI7A1YgDM7hgh7o56+ReQ mucked
Seat 2: tSR4329m40dZsN7YOpI9Kw folded before Flop (didn't bet)
Seat 3: EE16Ua5b1HSsYej5zeXOlA (button) folded before Flop (didn't bet)
Seat 4: mfrkWA3PTeYPkbO6hi98Aw (small blind) folded before Flop
Seat 5: niLn0xUVlqh8If80xRjzCA (big blind) showed [As 6d] and won ($5.35) with two pair, Sixes and Deuces
Seat 6: 4TM16KVgEiQpLi4bVVWbVQ folded before Flop (didn't bet)




PokerStars Game #59941717940:  Hold'em No Limit ($0.10/$0.25) - 2009/07/01 1:43:57 ET
Table 'KEoOIegxPF91KooL2AelUA' 6-max Seat #2 is the button
Seat 1: wsP46AGpqDjHZQmlRHKa9g ($42.25 in chips) 
Seat 2: 0Bg59Tnte1Tc7C4i9Jd9cQ ($7.90 in chips) 
Seat 3: zxeVQGaMKDsDzmSY+AInjA ($10.80 in chips) 
Seat 4: Wo60l2GQnSEc3bxPVyvIUw ($16.50 in chips) 
Seat 5: 08V++DOqzaNrRNsHIwi25w ($44.70 in chips) 
Seat 6: AMrBn4Vx9aAo/vv6WHLk6w ($3.15 in chips) 
zxeVQGaMKDsDzmSY+AInjA: posts small blind $0.10
Wo60l2GQnSEc3bxPVyvIUw: posts big blind $0.25
*** HOLE CARDS ***
08V++DOqzaNrRNsHIwi25w: folds 
AMrBn4Vx9aAo/vv6WHLk6w: folds 
wsP46AGpqDjHZQmlRHKa9g: folds 
0Bg59Tnte1Tc7C4i9Jd9cQ: folds 
zxeVQGaMKDsDzmSY+AInjA: folds 
Uncalled bet ($0.15) returned to Wo60l2GQnSEc3bxPVyvIUw
Wo60l2GQnSEc3bxPVyvIUw collected $0.20 from pot
*** SUMMARY ***
Total pot $0.20 | Rake $0 
Seat 1: wsP46AGpqDjHZQmlRHKa9g folded before Flop (didn't bet)
Seat 2: 0Bg59Tnte1Tc7C4i9Jd9cQ (button) folded before Flop (didn't bet)
Seat 3: zxeVQGaMKDsDzmSY+AInjA (small blind) folded before Flop
Seat 4: Wo60l2GQnSEc3bxPVyvIUw (big blind) collected ($0.20)
Seat 5: 08V++DOqzaNrRNsHIwi25w folded before Flop (didn't bet)
Seat 6: AMrBn4Vx9aAo/vv6WHLk6w folded before Flop (didn't bet)




PokerStars Game #59941718158:  Hold'em No Limit ($0.10/$0.25) - 2009/07/01 1:43:58 ET
Table 'JPFXJXa5xBkjZ/W15BKqeQ' 9-max Seat #2 is the button
Seat 1: mNQH7Afv3tbDKl2tAb9BOg ($19.25 in chips) 
Seat 2: XMSS6mD5B42I8wasdOMipQ ($10.60 in chips) 
Seat 3: 56S3mA6Zs3pGR+0p0vUCtg ($19.30 in chips) 
Seat 4: wGigCmBR/9XWkPpvYos3aQ ($26.75 in chips) 
Seat 5: cZ99hugmLBj9KhTlc8nCSw ($27.60 in chips) 
Seat 6: tLcDklc2rBORNfixyRfVfw ($25.35 in chips) 
56S3mA6Zs3pGR+0p0vUCtg: posts small blind $0.10
wGigCmBR/9XWkPpvYos3aQ: posts big blind $0.25
PdIasPkzm2sqZnN41ZRXOg: sits out 
V6p0jQ/RhUsqpHLmXvEX4Q: sits out 
*** HOLE CARDS ***
cZ99hugmLBj9KhTlc8nCSw: raises $0.50 to $0.75
tLcDklc2rBORNfixyRfVfw: folds 
mNQH7Afv3tbDKl2tAb9BOg: folds 
XMSS6mD5B42I8wasdOMipQ: calls $0.75
56S3mA6Zs3pGR+0p0vUCtg: folds 
wGigCmBR/9XWkPpvYos3aQ: folds 
*** FLOP *** [9h Ks 8c]
cZ99hugmLBj9KhTlc8nCSw: bets $1.25
XMSS6mD5B42I8wasdOMipQ: calls $1.25
*** TURN *** [9h Ks 8c] [Kh]
cZ99hugmLBj9KhTlc8nCSw: checks 
XMSS6mD5B42I8wasdOMipQ: checks 
*** RIVER *** [9h Ks 8c Kh] [9s]
cZ99hugmLBj9KhTlc8nCSw: checks 
XMSS6mD5B42I8wasdOMipQ: bets $1.75
cZ99hugmLBj9KhTlc8nCSw: folds 
Uncalled bet ($1.75) returned to XMSS6mD5B42I8wasdOMipQ
XMSS6mD5B42I8wasdOMipQ collected $4.15 from pot
XMSS6mD5B42I8wasdOMipQ: doesn't show hand 
*** SUMMARY ***
Total pot $4.35 | Rake $0.20 
Board [9h Ks 8c Kh 9s]
Seat 1: mNQH7Afv3tbDKl2tAb9BOg folded before Flop (didn't bet)
Seat 2: XMSS6mD5B42I8wasdOMipQ (button) collected ($4.15)
Seat 3: 56S3mA6Zs3pGR+0p0vUCtg (small blind) folded before Flop
Seat 4: wGigCmBR/9XWkPpvYos3aQ (big blind) folded before Flop
Seat 5: cZ99hugmLBj9KhTlc8nCSw folded on the River
Seat 6: tLcDklc2rBORNfixyRfVfw folded before Flop (didn't bet)




PokerStars Game #59941718396:  Hold'em No Limit ($0.10/$0.25) - 2009/07/01 1:43:58 ET
Table 'K/f0NNaoGuhSz5DrzgVw7Q' 9-max Seat #4 is the button
Seat 1: sD+TKtt36XiiN6jqHiLwDA ($25.05 in chips) 
Seat 2: N7idMbhmEVNGZavVF2tgKg ($26.65 in chips) 
Seat 4: 9bCz0uv2nUmznwuI0OjVGw ($16.85 in chips) 
Seat 5: DnDcAdn9P0zGovMERigpFA ($40.95 in chips) 
Seat 7: egvg3mTBBVzMHnJPIQiKcA ($14.65 in chips) 
Seat 8: RCqMONFrSPSArZh2Jsar/w ($19.65 in chips) 
Seat 9: tLcDklc2rBORNfixyRfVfw ($25 in chips) 
DnDcAdn9P0zGovMERigpFA: posts small blind $0.10
egvg3mTBBVzMHnJPIQiKcA: posts big blind $0.25
*** HOLE CARDS ***
RCqMONFrSPSArZh2Jsar/w: folds 
tLcDklc2rBORNfixyRfVfw: folds 
sD+TKtt36XiiN6jqHiLwDA: calls $0.25
N7idMbhmEVNGZavVF2tgKg: folds 
9bCz0uv2nUmznwuI0OjVGw: calls $0.25
DnDcAdn9P0zGovMERigpFA: folds 
3PVK0IdMlq2fElkVzzr4bg has returned
egvg3mTBBVzMHnJPIQiKcA: checks 
*** FLOP *** [4s 8c Kc]
egvg3mTBBVzMHnJPIQiKcA: checks 
sD+TKtt36XiiN6jqHiLwDA: bets $0.75
9bCz0uv2nUmznwuI0OjVGw: calls $0.75
egvg3mTBBVzMHnJPIQiKcA: folds 
*** TURN *** [4s 8c Kc] [2d]
sD+TKtt36XiiN6jqHiLwDA: checks 
9bCz0uv2nUmznwuI0OjVGw: bets $0.25
sD+TKtt36XiiN6jqHiLwDA: calls $0.25
*** RIVER *** [4s 8c Kc 2d] [7c]
sD+TKtt36XiiN6jqHiLwDA: checks 
9bCz0uv2nUmznwuI0OjVGw: checks 
*** SHOW DOWN ***
sD+TKtt36XiiN6jqHiLwDA: shows [9h 9s] (a pair of Nines)
9bCz0uv2nUmznwuI0OjVGw: mucks hand 
sD+TKtt36XiiN6jqHiLwDA collected $2.75 from pot
*** SUMMARY ***
Total pot $2.85 | Rake $0.10 
Board [4s 8c Kc 2d 7c]
Seat 1: sD+TKtt36XiiN6jqHiLwDA showed [9h 9s] and won ($2.75) with a pair of Nines
Seat 2: N7idMbhmEVNGZavVF2tgKg folded before Flop (didn't bet)
Seat 4: 9bCz0uv2nUmznwuI0OjVGw (button) mucked
Seat 5: DnDcAdn9P0zGovMERigpFA (small blind) folded before Flop
Seat 7: egvg3mTBBVzMHnJPIQiKcA (big blind) folded on the Flop
Seat 8: RCqMONFrSPSArZh2Jsar/w folded before Flop (didn't bet)
Seat 9: tLcDklc2rBORNfixyRfVfw folded before Flop (didn't bet)




PokerStars Game #59941718522:  Hold'em No Limit ($0.10/$0.25) - 2009/07/01 1:43:58 ET
Table '3lL16FBjWXTx3AjK5lMRww' 9-max Seat #9 is the button
Seat 1: fDGyaQz0cs2s4FOYxkbIHA ($16.65 in chips) 
Seat 2: c/9X4zftzphFxYtxp5kp9w ($20.15 in chips) 
Seat 3: QEbIGci+itdw+re8RM5fZA ($27.95 in chips) 
Seat 4: Z3a37Ry74FVl+CBZtAONiA ($6.55 in chips) 
Seat 5: M/9j4wkHH9i1JM51vgi1VA ($37.30 in chips) 
Seat 6: zUXhymECc2C9W9ZNw6qppA ($9.65 in chips) 
Seat 7: 6RiVTYll/5D8zICp0MRpKw ($25.70 in chips) 
Seat 8: ljemhp25Zg+nlA9DLCIiUw ($25 in chips) 
Seat 9: 00Ybni1cxfHtqmdWwh31Xg ($10.30 in chips) 
fDGyaQz0cs2s4FOYxkbIHA: posts small blind $0.10
c/9X4zftzphFxYtxp5kp9w: posts big blind $0.25
*** HOLE CARDS ***
QEbIGci+itdw+re8RM5fZA: folds 
Z3a37Ry74FVl+CBZtAONiA: calls $0.25
M/9j4wkHH9i1JM51vgi1VA: folds 
zUXhymECc2C9W9ZNw6qppA: raises $0.25 to $0.50
6RiVTYll/5D8zICp0MRpKw: folds 
ljemhp25Zg+nlA9DLCIiUw: folds 
00Ybni1cxfHtqmdWwh31Xg: folds 
fDGyaQz0cs2s4FOYxkbIHA: folds 
c/9X4zftzphFxYtxp5kp9w: calls $0.25
Z3a37Ry74FVl+CBZtAONiA: calls $0.25
*** FLOP *** [4c 9d Ks]
c/9X4zftzphFxYtxp5kp9w: checks 
Z3a37Ry74FVl+CBZtAONiA: bets $0.50
zUXhymECc2C9W9ZNw6qppA: folds 
c/9X4zftzphFxYtxp5kp9w: raises $1 to $1.50
Z3a37Ry74FVl+CBZtAONiA: folds 
Uncalled bet ($1) returned to c/9X4zftzphFxYtxp5kp9w
c/9X4zftzphFxYtxp5kp9w collected $2.50 from pot
*** SUMMARY ***
Total pot $2.60 | Rake $0.10 
Board [4c 9d Ks]
Seat 1: fDGyaQz0cs2s4FOYxkbIHA (small blind) folded before Flop
Seat 2: c/9X4zftzphFxYtxp5kp9w (big blind) collected ($2.50)
Seat 3: QEbIGci+itdw+re8RM5fZA folded before Flop (didn't bet)
Seat 4: Z3a37Ry74FVl+CBZtAONiA folded on the Flop
Seat 5: M/9j4wkHH9i1JM51vgi1VA folded before Flop (didn't bet)
Seat 6: zUXhymECc2C9W9ZNw6qppA folded on the Flop
Seat 7: 6RiVTYll/5D8zICp0MRpKw folded before Flop (didn't bet)
Seat 8: ljemhp25Zg+nlA9DLCIiUw folded before Flop (didn't bet)
Seat 9: 00Ybni1cxfHtqmdWwh31Xg (button) folded before Flop (didn't bet)




PokerStars Game #59941718258:  Hold'em No Limit ($0.10/$0.25) - 2009/07/01 1:43:58 ET
Table 'G+4ZdyRoPjgaJY/jxSlZzQ' 9-max Seat #8 is the button
Seat 1: ghNKXUBl/H+t83JF079ZBA ($23.40 in chips) 
Seat 2: CT7Xj/V/O5rBlhtt+RZeFQ ($25 in chips) 
Seat 3: FaGtAm5QUVcixGhAKIvbLg ($15.60 in chips) 
Seat 4: lSeLm4BdnSMLtIli62qjAQ ($10.65 in chips) 
Seat 5: BT6Oal0iO4P6kDuT7HFQDw ($17.45 in chips) 
Seat 6: oFwaTjy3ok/+qFghsrcGvg ($23.30 in chips) 
Seat 7: IK3/w7XV7rd8mVIsuasjYA ($2 in chips) 
Seat 8: bXpVeaSTPBFSPJmeXxO7nw ($4.65 in chips) 
Seat 9: tLcDklc2rBORNfixyRfVfw ($25 in chips) 
tLcDklc2rBORNfixyRfVfw: posts small blind $0.10
ghNKXUBl/H+t83JF079ZBA: posts big blind $0.25
*** HOLE CARDS ***
CT7Xj/V/O5rBlhtt+RZeFQ: folds 
FaGtAm5QUVcixGhAKIvbLg: calls $0.25
lSeLm4BdnSMLtIli62qjAQ: folds 
BT6Oal0iO4P6kDuT7HFQDw: raises $0.75 to $1
oFwaTjy3ok/+qFghsrcGvg: folds 
IK3/w7XV7rd8mVIsuasjYA: raises $0.75 to $1.75
bXpVeaSTPBFSPJmeXxO7nw: folds 
tLcDklc2rBORNfixyRfVfw: folds 
ghNKXUBl/H+t83JF079ZBA: folds 
FaGtAm5QUVcixGhAKIvbLg: folds 
BT6Oal0iO4P6kDuT7HFQDw: raises $1 to $2.75
IK3/w7XV7rd8mVIsuasjYA: calls $0.25 and is all-in
Uncalled bet ($0.75) returned to BT6Oal0iO4P6kDuT7HFQDw
*** FLOP *** [Qd 3s 6h]
*** TURN *** [Qd 3s 6h] [6s]
*** RIVER *** [Qd 3s 6h 6s] [Tc]
*** SHOW DOWN ***
BT6Oal0iO4P6kDuT7HFQDw: shows [Jd Jh] (two pair, Jacks and Sixes)
IK3/w7XV7rd8mVIsuasjYA: shows [Js Qc] (two pair, Queens and Sixes)
IK3/w7XV7rd8mVIsuasjYA collected $4.40 from pot
*** SUMMARY ***
Total pot $4.60 | Rake $0.20 
Board [Qd 3s 6h 6s Tc]
Seat 1: ghNKXUBl/H+t83JF079ZBA (big blind) folded before Flop
Seat 2: CT7Xj/V/O5rBlhtt+RZeFQ folded before Flop (didn't bet)
Seat 3: FaGtAm5QUVcixGhAKIvbLg folded before Flop
Seat 4: lSeLm4BdnSMLtIli62qjAQ folded before Flop (didn't bet)
Seat 5: BT6Oal0iO4P6kDuT7HFQDw showed [Jd Jh] and lost with two pair, Jacks and Sixes
Seat 6: oFwaTjy3ok/+qFghsrcGvg folded before Flop (didn't bet)
Seat 7: IK3/w7XV7rd8mVIsuasjYA showed [Js Qc] and won ($4.40) with two pair, Queens and Sixes
Seat 8: bXpVeaSTPBFSPJmeXxO7nw (button) folded before Flop (didn't bet)
Seat 9: tLcDklc2rBORNfixyRfVfw (small blind) folded before Flop




PokerStars Game #59941718544:  Hold'em No Limit ($0.10/$0.25) - 2009/07/01 1:43:58 ET
Table '0M5QEJGOThqZwQ/sjbjXYw' 6-max Seat #5 is the button
Seat 2: /gJNBeCkWL4o85/jvlZ4BA ($34.70 in chips) 
Seat 3: 3zD3qLXT1bEffAoWGnc7wg ($25 in chips) 
Seat 4: oBUDUfeUyCbZBsjxHZgSiw ($23.35 in chips) 
Seat 5: cWc85bEzdRzpUMhRKm8pwQ ($27.70 in chips) 
/gJNBeCkWL4o85/jvlZ4BA: posts small blind $0.10
3zD3qLXT1bEffAoWGnc7wg: posts big blind $0.25
*** HOLE CARDS ***
oBUDUfeUyCbZBsjxHZgSiw: folds 
bb63I02U6p9a5MNFa1gCiw joins the table at seat #6 
cWc85bEzdRzpUMhRKm8pwQ: raises $0.75 to $1
/gJNBeCkWL4o85/jvlZ4BA: folds 
3zD3qLXT1bEffAoWGnc7wg: folds 
Uncalled bet ($0.75) returned to cWc85bEzdRzpUMhRKm8pwQ
cWc85bEzdRzpUMhRKm8pwQ collected $0.60 from pot
*** SUMMARY ***
Total pot $0.60 | Rake $0 
Seat 2: /gJNBeCkWL4o85/jvlZ4BA (small blind) folded before Flop
Seat 3: 3zD3qLXT1bEffAoWGnc7wg (big blind) folded before Flop
Seat 4: oBUDUfeUyCbZBsjxHZgSiw folded before Flop (didn't bet)
Seat 5: cWc85bEzdRzpUMhRKm8pwQ (button) collected ($0.60)




PokerStars Game #59941718708:  Hold'em No Limit ($0.10/$0.25) - 2009/07/01 1:43:59 ET
Table '2clPgY3+dETPD/8zjXZdFw' 6-max Seat #4 is the button
Seat 1: 4WFKzsjLSGnvHbVxKabsvQ ($31.05 in chips) 
Seat 2: cWc85bEzdRzpUMhRKm8pwQ ($25.45 in chips) 
Seat 3: SFmT9ZsVopnukjvAzrxTRg ($25 in chips) 
Seat 4: ljjhtb6FVPTx9AT9HNdtqg ($25 in chips) 
Seat 5: LJI7A1YgDM7hgh7o56+ReQ ($26.95 in chips) 
LJI7A1YgDM7hgh7o56+ReQ: posts small blind $0.10
4WFKzsjLSGnvHbVxKabsvQ: posts big blind $0.25
*** HOLE CARDS ***
cWc85bEzdRzpUMhRKm8pwQ: folds 
SFmT9ZsVopnukjvAzrxTRg: folds 
ljjhtb6FVPTx9AT9HNdtqg: raises $0.50 to $0.75
LJI7A1YgDM7hgh7o56+ReQ: raises $2.25 to $3
4WFKzsjLSGnvHbVxKabsvQ: folds 
ljjhtb6FVPTx9AT9HNdtqg: calls $2.25
*** FLOP *** [4h 6s 4d]
LJI7A1YgDM7hgh7o56+ReQ: bets $4
ljjhtb6FVPTx9AT9HNdtqg: folds 
Uncalled bet ($4) returned to LJI7A1YgDM7hgh7o56+ReQ
LJI7A1YgDM7hgh7o56+ReQ collected $5.95 from pot
LJI7A1YgDM7hgh7o56+ReQ: doesn't show hand 
*** SUMMARY ***
Total pot $6.25 | Rake $0.30 
Board [4h 6s 4d]
Seat 1: 4WFKzsjLSGnvHbVxKabsvQ (big blind) folded before Flop
Seat 2: cWc85bEzdRzpUMhRKm8pwQ folded before Flop (didn't bet)
Seat 3: SFmT9ZsVopnukjvAzrxTRg folded before Flop (didn't bet)
Seat 4: ljjhtb6FVPTx9AT9HNdtqg (button) folded on the Flop
Seat 5: LJI7A1YgDM7hgh7o56+ReQ (small blind) collected ($5.95)




PokerStars Game #59941718766:  Hold'em No Limit ($0.10/$0.25) - 2009/07/01 1:43:59 ET
Table 'luMgmRPIo47e7iXDlheIwA' 6-max Seat #2 is the button
Seat 1: EQ3WxdGe/KZrM6Lx4T02sg ($18.80 in chips) 
Seat 2: NhUN/JpAprdJeamFBgJH1w ($25 in chips) 
Seat 3: W6Y6au0wf7gRAlqJYgOezw ($18.35 in chips) 
Seat 4: xrf8tAXKQHG99HixCot1Iw ($24 in chips) 
Seat 5: cWc85bEzdRzpUMhRKm8pwQ ($43.75 in chips) 
Seat 6: qGHGf/553gQnDoklMRe3tg ($24.90 in chips) 
W6Y6au0wf7gRAlqJYgOezw: posts small blind $0.10
xrf8tAXKQHG99HixCot1Iw: posts big blind $0.25
*** HOLE CARDS ***
cWc85bEzdRzpUMhRKm8pwQ: folds 
qGHGf/553gQnDoklMRe3tg: folds 
EQ3WxdGe/KZrM6Lx4T02sg: calls $0.25
NhUN/JpAprdJeamFBgJH1w: raises $1 to $1.25
W6Y6au0wf7gRAlqJYgOezw: calls $1.15
xrf8tAXKQHG99HixCot1Iw: folds 
EQ3WxdGe/KZrM6Lx4T02sg: calls $1
*** FLOP *** [Jd Ac Tc]
W6Y6au0wf7gRAlqJYgOezw: checks 
EQ3WxdGe/KZrM6Lx4T02sg: checks 
NhUN/JpAprdJeamFBgJH1w: bets $3
W6Y6au0wf7gRAlqJYgOezw: calls $3
EQ3WxdGe/KZrM6Lx4T02sg: raises $6.50 to $9.50
NhUN/JpAprdJeamFBgJH1w: folds 
W6Y6au0wf7gRAlqJYgOezw: raises $7.60 to $17.10 and is all-in
EQ3WxdGe/KZrM6Lx4T02sg: calls $7.60
*** TURN *** [Jd Ac Tc] [2d]
*** RIVER *** [Jd Ac Tc 2d] [6d]
*** SHOW DOWN ***
W6Y6au0wf7gRAlqJYgOezw: shows [As Qd] (a pair of Aces)
EQ3WxdGe/KZrM6Lx4T02sg: shows [Qc Kd] (a straight, Ten to Ace)
EQ3WxdGe/KZrM6Lx4T02sg collected $39.15 from pot
*** SUMMARY ***
Total pot $41.20 | Rake $2.05 
Board [Jd Ac Tc 2d 6d]
Seat 1: EQ3WxdGe/KZrM6Lx4T02sg showed [Qc Kd] and won ($39.15) with a straight, Ten to Ace
Seat 2: NhUN/JpAprdJeamFBgJH1w (button) folded on the Flop
Seat 3: W6Y6au0wf7gRAlqJYgOezw (small blind) showed [As Qd] and lost with a pair of Aces
Seat 4: xrf8tAXKQHG99HixCot1Iw (big blind) folded before Flop
Seat 5: cWc85bEzdRzpUMhRKm8pwQ folded before Flop (didn't bet)
Seat 6: qGHGf/553gQnDoklMRe3tg folded before Flop (didn't bet)




PokerStars Game #59941718876:  Hold'em No Limit ($0.10/$0.25) - 2009/07/01 1:43:59 ET
Table 'g+mPuNJBCHKE9ents7ZGtg' 6-max Seat #6 is the button
Seat 1: cezpHJ8FB07dj0xG+LhOvw ($58.40 in chips) 
Seat 2: fZQg9veL7Dd/Z04ZTjC+wQ ($66.05 in chips) 
Seat 3: FYepjhAvF8ZdVCmqHIy+eQ ($30.25 in chips) 
Seat 4: yVrjRIW0SMxgpvqSIPSe/w ($13.20 in chips) 
Seat 5: D3ikCR8c/o9jB5irZ3uGlw ($12.30 in chips) 
Seat 6: Mn2V28t5aGq2d09z+/o6Fw ($24.65 in chips) 
cezpHJ8FB07dj0xG+LhOvw: posts small blind $0.10
fZQg9veL7Dd/Z04ZTjC+wQ: posts big blind $0.25
*** HOLE CARDS ***
FYepjhAvF8ZdVCmqHIy+eQ: folds 
yVrjRIW0SMxgpvqSIPSe/w: raises $1 to $1.25
D3ikCR8c/o9jB5irZ3uGlw: folds 
Mn2V28t5aGq2d09z+/o6Fw: folds 
cezpHJ8FB07dj0xG+LhOvw: folds 
fZQg9veL7Dd/Z04ZTjC+wQ: folds 
Uncalled bet ($1) returned to yVrjRIW0SMxgpvqSIPSe/w
yVrjRIW0SMxgpvqSIPSe/w collected $0.60 from pot
*** SUMMARY ***
Total pot $0.60 | Rake $0 
Seat 1: cezpHJ8FB07dj0xG+LhOvw (small blind) folded before Flop
Seat 2: fZQg9veL7Dd/Z04ZTjC+wQ (big blind) folded before Flop
Seat 3: FYepjhAvF8ZdVCmqHIy+eQ folded before Flop (didn't bet)
Seat 4: yVrjRIW0SMxgpvqSIPSe/w collected ($0.60)
Seat 5: D3ikCR8c/o9jB5irZ3uGlw folded before Flop (didn't bet)
Seat 6: Mn2V28t5aGq2d09z+/o6Fw (button) folded before Flop (didn't bet)




PokerStars Game #59941719006:  Hold'em No Limit ($0.10/$0.25) - 2009/07/01 1:43:59 ET
Table '2vH5RcmkT0F4XNS/EmmyMA' 6-max Seat #4 is the button
Seat 1: hOaWAImn5/MZDAWAPlYHCw ($6.50 in chips) 
Seat 2: W6Y6au0wf7gRAlqJYgOezw ($11.85 in chips) 
Seat 3: t8P79jKZYh/Wpx2V73pSqg ($29.90 in chips) 
Seat 4: FC6tJ9EOiutXO8hnpR4VgQ ($5.65 in chips) 
Seat 5: Hsvkc0/G2VV78oVmWYXecw ($5.25 in chips) 
Seat 6: if4dh6jhJXeN3/qd3qCp9g ($26.10 in chips) 
Hsvkc0/G2VV78oVmWYXecw: posts small blind $0.10
if4dh6jhJXeN3/qd3qCp9g: posts big blind $0.25
*** HOLE CARDS ***
hOaWAImn5/MZDAWAPlYHCw: folds 
W6Y6au0wf7gRAlqJYgOezw: folds 
t8P79jKZYh/Wpx2V73pSqg: folds 
FC6tJ9EOiutXO8hnpR4VgQ: folds 
Hsvkc0/G2VV78oVmWYXecw: folds 
Uncalled bet ($0.15) returned to if4dh6jhJXeN3/qd3qCp9g
if4dh6jhJXeN3/qd3qCp9g collected $0.20 from pot
if4dh6jhJXeN3/qd3qCp9g: doesn't show hand 
*** SUMMARY ***
Total pot $0.20 | Rake $0 
Seat 1: hOaWAImn5/MZDAWAPlYHCw folded before Flop (didn't bet)
Seat 2: W6Y6au0wf7gRAlqJYgOezw folded before Flop (didn't bet)
Seat 3: t8P79jKZYh/Wpx2V73pSqg folded before Flop (didn't bet)
Seat 4: FC6tJ9EOiutXO8hnpR4VgQ (button) folded before Flop (didn't bet)
Seat 5: Hsvkc0/G2VV78oVmWYXecw (small blind) folded before Flop
Seat 6: if4dh6jhJXeN3/qd3qCp9g (big blind) collected ($0.20)




PokerStars Game #59941719056:  Hold'em No Limit ($0.10/$0.25) - 2009/07/01 1:43:59 ET
Table '60nA7av6bws9VnNmVwculA' 6-max Seat #4 is the button
Seat 1: if4dh6jhJXeN3/qd3qCp9g ($24.65 in chips) 
Seat 2: Bada343Si4xKu3fNXY99AA ($3.85 in chips) 
Seat 3: mnuJq+Q1IXKm/pCy+OzxmQ ($20 in chips) 
Seat 4: +baiVgI/ETnBARLe5mARCw ($18.50 in chips) 
Seat 5: zXh+lOT41Q2iWgCNj+OcRw ($12.45 in chips) 
Seat 6: mfrkWA3PTeYPkbO6hi98Aw ($25.10 in chips) 
zXh+lOT41Q2iWgCNj+OcRw: posts small blind $0.10
mfrkWA3PTeYPkbO6hi98Aw: posts big blind $0.25
mnuJq+Q1IXKm/pCy+OzxmQ: posts big blind $0.25
*** HOLE CARDS ***
if4dh6jhJXeN3/qd3qCp9g: folds 
Bada343Si4xKu3fNXY99AA: folds 
mnuJq+Q1IXKm/pCy+OzxmQ: checks 
+baiVgI/ETnBARLe5mARCw: folds 
zXh+lOT41Q2iWgCNj+OcRw: folds 
mfrkWA3PTeYPkbO6hi98Aw: checks 
*** FLOP *** [5s 2h Ac]
mfrkWA3PTeYPkbO6hi98Aw: checks 
mnuJq+Q1IXKm/pCy+OzxmQ: checks 
*** TURN *** [5s 2h Ac] [7c]
mfrkWA3PTeYPkbO6hi98Aw: checks 
mnuJq+Q1IXKm/pCy+OzxmQ: checks 
*** RIVER *** [5s 2h Ac 7c] [6s]
mfrkWA3PTeYPkbO6hi98Aw: checks 
mnuJq+Q1IXKm/pCy+OzxmQ: checks 
*** SHOW DOWN ***
mfrkWA3PTeYPkbO6hi98Aw: shows [Jh 4c] (high card Ace)
mnuJq+Q1IXKm/pCy+OzxmQ: shows [Jd 2c] (a pair of Deuces)
mnuJq+Q1IXKm/pCy+OzxmQ collected $0.60 from pot
*** SUMMARY ***
Total pot $0.60 | Rake $0 
Board [5s 2h Ac 7c 6s]
Seat 1: if4dh6jhJXeN3/qd3qCp9g folded before Flop (didn't bet)
Seat 2: Bada343Si4xKu3fNXY99AA folded before Flop (didn't bet)
Seat 3: mnuJq+Q1IXKm/pCy+OzxmQ showed [Jd 2c] and won ($0.60) with a pair of Deuces
Seat 4: +baiVgI/ETnBARLe5mARCw (button) folded before Flop (didn't bet)
Seat 5: zXh+lOT41Q2iWgCNj+OcRw (small blind) folded before Flop
Seat 6: mfrkWA3PTeYPkbO6hi98Aw (big blind) showed [Jh 4c] and lost with high card Ace




PokerStars Game #59941719626:  Hold'em No Limit ($0.10/$0.25) - 2009/07/01 1:44:00 ET
Table '5SUMWYuPsGiOD0FY0QbgOw' 6-max Seat #1 is the button
Seat 1: SFmT9ZsVopnukjvAzrxTRg ($25 in chips) 
Seat 2: xrf8tAXKQHG99HixCot1Iw ($37.25 in chips) 
Seat 3: MqMK8OWPSY1V4stf1Hy5Jw ($38.80 in chips) 
Seat 4: BV+K0Phf5VBHr7aZPKqbUQ ($25 in chips) 
Seat 5: v+QfkGiuj9bgtuNoVnDO8w ($40.40 in chips) 
Seat 6: jA7YMtfNUnAaebB7Lj74EA ($26.20 in chips) 
xrf8tAXKQHG99HixCot1Iw: posts small blind $0.10
MqMK8OWPSY1V4stf1Hy5Jw: posts big blind $0.25
*** HOLE CARDS ***
BV+K0Phf5VBHr7aZPKqbUQ: raises $0.50 to $0.75
v+QfkGiuj9bgtuNoVnDO8w: folds 
jA7YMtfNUnAaebB7Lj74EA: folds 
SFmT9ZsVopnukjvAzrxTRg: folds 
xrf8tAXKQHG99HixCot1Iw: folds 
MqMK8OWPSY1V4stf1Hy5Jw: folds 
Uncalled bet ($0.50) returned to BV+K0Phf5VBHr7aZPKqbUQ
BV+K0Phf5VBHr7aZPKqbUQ collected $0.60 from pot
BV+K0Phf5VBHr7aZPKqbUQ: doesn't show hand 
*** SUMMARY ***
Total pot $0.60 | Rake $0 
Seat 1: SFmT9ZsVopnukjvAzrxTRg (button) folded before Flop (didn't bet)
Seat 2: xrf8tAXKQHG99HixCot1Iw (small blind) folded before Flop
Seat 3: MqMK8OWPSY1V4stf1Hy5Jw (big blind) folded before Flop
Seat 4: BV+K0Phf5VBHr7aZPKqbUQ collected ($0.60)
Seat 5: v+QfkGiuj9bgtuNoVnDO8w folded before Flop (didn't bet)
Seat 6: jA7YMtfNUnAaebB7Lj74EA folded before Flop (didn't bet)




PokerStars Game #59941719174:  Hold'em No Limit ($0.10/$0.25) - 2009/07/01 1:44:00 ET
Table 'CBnRhp0d6E2+/NtM7Vbruw' 9-max Seat #3 is the button
Seat 1: WQe4GbiYBiPsb5WKFKkijQ ($10.05 in chips) 
Seat 2: cZ99hugmLBj9KhTlc8nCSw ($26.85 in chips) 
Seat 3: aNpwfA31EREwO+ar4XzBCw ($33.70 in chips) 
Seat 5: CT7Xj/V/O5rBlhtt+RZeFQ ($25.10 in chips) 
Seat 6: CvL9Ch1HYCVbTsfpNucitg ($4.65 in chips) 
Seat 7: j4q3p0lesp63b1gZDwLBZw ($5 in chips) 
Seat 8: MG90wfSJZnOejs/KD3vlQQ ($25 in chips) 
Seat 9: xHZZRLAaFUIC8WWI8ljOJA ($29.90 in chips) 
CT7Xj/V/O5rBlhtt+RZeFQ: posts small blind $0.10
CvL9Ch1HYCVbTsfpNucitg: posts big blind $0.25
*** HOLE CARDS ***
j4q3p0lesp63b1gZDwLBZw: folds 
MG90wfSJZnOejs/KD3vlQQ: folds 
xHZZRLAaFUIC8WWI8ljOJA: folds 
WQe4GbiYBiPsb5WKFKkijQ: raises $0.25 to $0.50
cZ99hugmLBj9KhTlc8nCSw: folds 
aNpwfA31EREwO+ar4XzBCw: folds 
CT7Xj/V/O5rBlhtt+RZeFQ: calls $0.40
CvL9Ch1HYCVbTsfpNucitg: folds 
*** FLOP *** [6c Jd 6d]
CT7Xj/V/O5rBlhtt+RZeFQ: checks 
WQe4GbiYBiPsb5WKFKkijQ: bets $1
CT7Xj/V/O5rBlhtt+RZeFQ: folds 
Uncalled bet ($1) returned to WQe4GbiYBiPsb5WKFKkijQ
WQe4GbiYBiPsb5WKFKkijQ collected $1.20 from pot
WQe4GbiYBiPsb5WKFKkijQ: doesn't show hand 
*** SUMMARY ***
Total pot $1.25 | Rake $0.05 
Board [6c Jd 6d]
Seat 1: WQe4GbiYBiPsb5WKFKkijQ collected ($1.20)
Seat 2: cZ99hugmLBj9KhTlc8nCSw folded before Flop (didn't bet)
Seat 3: aNpwfA31EREwO+ar4XzBCw (button) folded before Flop (didn't bet)
Seat 5: CT7Xj/V/O5rBlhtt+RZeFQ (small blind) folded on the Flop
Seat 6: CvL9Ch1HYCVbTsfpNucitg (big blind) folded before Flop
Seat 7: j4q3p0lesp63b1gZDwLBZw folded before Flop (didn't bet)
Seat 8: MG90wfSJZnOejs/KD3vlQQ folded before Flop (didn't bet)
Seat 9: xHZZRLAaFUIC8WWI8ljOJA folded before Flop (didn't bet)




PokerStars Game #59941719624:  Hold'em No Limit ($0.10/$0.25) - 2009/07/01 1:44:00 ET
Table 'P1IJQ2p3ACFySC35W1qwQw' 9-max Seat #1 is the button
Seat 1: bXpVeaSTPBFSPJmeXxO7nw ($4.90 in chips) 
Seat 2: vO3QVRovWemcGMkm7ijAIA ($5.45 in chips) 
Seat 3: PVxvfRTRvkgZf9WtquEkwQ ($25.35 in chips) 
Seat 4: c/9X4zftzphFxYtxp5kp9w ($27.90 in chips) 
Seat 5: ghNKXUBl/H+t83JF079ZBA ($56.45 in chips) 
Seat 6: ljemhp25Zg+nlA9DLCIiUw ($64.45 in chips) 
Seat 7: 7je+LC5Mfs6nL8YBVh4frQ ($5.10 in chips) 
Seat 8: tLcDklc2rBORNfixyRfVfw ($26.25 in chips) 
Seat 9: XXajyXkgbSGJKxQP3mal/Q ($14.90 in chips) 
vO3QVRovWemcGMkm7ijAIA: posts small blind $0.10
PVxvfRTRvkgZf9WtquEkwQ: posts big blind $0.25
*** HOLE CARDS ***
c/9X4zftzphFxYtxp5kp9w: folds 
ghNKXUBl/H+t83JF079ZBA: folds 
ljemhp25Zg+nlA9DLCIiUw: folds 
7je+LC5Mfs6nL8YBVh4frQ: raises $0.75 to $1
tLcDklc2rBORNfixyRfVfw: folds 
XXajyXkgbSGJKxQP3mal/Q: folds 
bXpVeaSTPBFSPJmeXxO7nw: folds 
vO3QVRovWemcGMkm7ijAIA: folds 
PVxvfRTRvkgZf9WtquEkwQ: folds 
Uncalled bet ($0.75) returned to 7je+LC5Mfs6nL8YBVh4frQ
7je+LC5Mfs6nL8YBVh4frQ collected $0.60 from pot
*** SUMMARY ***
Total pot $0.60 | Rake $0 
Seat 1: bXpVeaSTPBFSPJmeXxO7nw (button) folded before Flop (didn't bet)
Seat 2: vO3QVRovWemcGMkm7ijAIA (small blind) folded before Flop
Seat 3: PVxvfRTRvkgZf9WtquEkwQ (big blind) folded before Flop
Seat 4: c/9X4zftzphFxYtxp5kp9w folded before Flop (didn't bet)
Seat 5: ghNKXUBl/H+t83JF079ZBA folded before Flop (didn't bet)
Seat 6: ljemhp25Zg+nlA9DLCIiUw folded before Flop (didn't bet)
Seat 7: 7je+LC5Mfs6nL8YBVh4frQ collected ($0.60)
Seat 8: tLcDklc2rBORNfixyRfVfw folded before Flop (didn't bet)
Seat 9: XXajyXkgbSGJKxQP3mal/Q folded before Flop (didn't bet)




PokerStars Game #59941720014:  Hold'em No Limit ($0.10/$0.25) - 2009/07/01 1:44:01 ET
Table 'NfXsh0UQA+o/kO9acV3WxA' 9-max Seat #3 is the button
Seat 1: pN3IHvAKm2fz+sTRARTcrg ($24.65 in chips) 
Seat 2: mhpFs2SZupy4zLRb62FLFA ($25 in chips) 
Seat 3: wCUaomJ6Nq5zomVGdUHP+w ($19.50 in chips) 
Seat 4: r6hsffOo1iKmaPYKwAZmFw ($29.80 in chips) 
Seat 5: zgi+EUykT/pZQpoUG6+oEg ($5 in chips) 
Seat 6: cFmpjvcjNoVAEAIQIxWkYg ($26.15 in chips) 
Seat 7: yqkowiRWZ6NvRN9UUkYIlA ($5 in chips) 
Seat 8: +sbyWwIcFp9kP0bDtMegfQ ($41.75 in chips) 
Seat 9: uhrboV251dcgYniYTdFIcA ($25.35 in chips) 
r6hsffOo1iKmaPYKwAZmFw: posts small blind $0.10
zgi+EUykT/pZQpoUG6+oEg: posts big blind $0.25
*** HOLE CARDS ***
cFmpjvcjNoVAEAIQIxWkYg: folds 
cFmpjvcjNoVAEAIQIxWkYg is sitting out
yqkowiRWZ6NvRN9UUkYIlA: folds 
+sbyWwIcFp9kP0bDtMegfQ: folds 
uhrboV251dcgYniYTdFIcA: folds 
pN3IHvAKm2fz+sTRARTcrg: folds 
mhpFs2SZupy4zLRb62FLFA: folds 
wCUaomJ6Nq5zomVGdUHP+w: folds 
r6hsffOo1iKmaPYKwAZmFw: raises $0.50 to $0.75
zgi+EUykT/pZQpoUG6+oEg: folds 
Uncalled bet ($0.50) returned to r6hsffOo1iKmaPYKwAZmFw
r6hsffOo1iKmaPYKwAZmFw collected $0.50 from pot
r6hsffOo1iKmaPYKwAZmFw: doesn't show hand 
*** SUMMARY ***
Total pot $0.50 | Rake $0 
Seat 1: pN3IHvAKm2fz+sTRARTcrg folded before Flop (didn't bet)
Seat 2: mhpFs2SZupy4zLRb62FLFA folded before Flop (didn't bet)
Seat 3: wCUaomJ6Nq5zomVGdUHP+w (button) folded before Flop (didn't bet)
Seat 4: r6hsffOo1iKmaPYKwAZmFw (small blind) collected ($0.50)
Seat 5: zgi+EUykT/pZQpoUG6+oEg (big blind) folded before Flop
Seat 6: cFmpjvcjNoVAEAIQIxWkYg folded before Flop (didn't bet)
Seat 7: yqkowiRWZ6NvRN9UUkYIlA folded before Flop (didn't bet)
Seat 8: +sbyWwIcFp9kP0bDtMegfQ folded before Flop (didn't bet)
Seat 9: uhrboV251dcgYniYTdFIcA folded before Flop (didn't bet)




PokerStars Game #59941719846:  Hold'em No Limit ($0.10/$0.25) - 2009/07/01 1:44:01 ET
Table 'SgI2Cobdjtkh0Fd0/eTTDg' 9-max Seat #3 is the button
Seat 1: NcPAt5YjVvDFEJTTgAVj8g ($5.95 in chips) 
Seat 2: uUc5QTI8+ZdC95UnznCsqg ($14.25 in chips) 
Seat 3: OiV1PWZ3IkN29JlmCcnTwQ ($5 in chips) 
Seat 4: s1y+qfkBnhgc67+X3ThjeA ($10 in chips) 
Seat 5: RHqgdFvufLCYe54+qd2gcA ($5 in chips) 
Seat 6: 6RiVTYll/5D8zICp0MRpKw ($26.25 in chips) 
Seat 7: lOuxRXNpa9V2VxLMNpxUOg ($19.95 in chips) 
Seat 8: 8GJHzzxiotOqC5gdtgpLoA ($9.65 in chips) 
Seat 9: cZ99hugmLBj9KhTlc8nCSw ($30.95 in chips) 
s1y+qfkBnhgc67+X3ThjeA: posts small blind $0.10
RHqgdFvufLCYe54+qd2gcA: posts big blind $0.25
*** HOLE CARDS ***
6RiVTYll/5D8zICp0MRpKw has timed out
6RiVTYll/5D8zICp0MRpKw: folds 
6RiVTYll/5D8zICp0MRpKw is sitting out
lOuxRXNpa9V2VxLMNpxUOg: folds 
8GJHzzxiotOqC5gdtgpLoA: folds 
6RiVTYll/5D8zICp0MRpKw has returned
cZ99hugmLBj9KhTlc8nCSw: folds 
NcPAt5YjVvDFEJTTgAVj8g: folds 
uUc5QTI8+ZdC95UnznCsqg: folds 
OiV1PWZ3IkN29JlmCcnTwQ: folds 
s1y+qfkBnhgc67+X3ThjeA: folds 
Uncalled bet ($0.15) returned to RHqgdFvufLCYe54+qd2gcA
RHqgdFvufLCYe54+qd2gcA collected $0.20 from pot
RHqgdFvufLCYe54+qd2gcA: doesn't show hand 
*** SUMMARY ***
Total pot $0.20 | Rake $0 
Seat 1: NcPAt5YjVvDFEJTTgAVj8g folded before Flop (didn't bet)
Seat 2: uUc5QTI8+ZdC95UnznCsqg folded before Flop (didn't bet)
Seat 3: OiV1PWZ3IkN29JlmCcnTwQ (button) folded before Flop (didn't bet)
Seat 4: s1y+qfkBnhgc67+X3ThjeA (small blind) folded before Flop
Seat 5: RHqgdFvufLCYe54+qd2gcA (big blind) collected ($0.20)
Seat 6: 6RiVTYll/5D8zICp0MRpKw folded before Flop (didn't bet)
Seat 7: lOuxRXNpa9V2VxLMNpxUOg folded before Flop (didn't bet)
Seat 8: 8GJHzzxiotOqC5gdtgpLoA folded before Flop (didn't bet)
Seat 9: cZ99hugmLBj9KhTlc8nCSw folded before Flop (didn't bet)




PokerStars Game #59941720148:  Hold'em No Limit ($0.10/$0.25) - 2009/07/01 1:44:01 ET
Table 'WEMI3Mtn7dGARDbgNrKibg' 9-max Seat #9 is the button
Seat 1: Th3FldXKQW6hWVVPahaoOQ ($30.25 in chips) 
Seat 2: tYsOBqdU1+x+yFI7zHO7hQ ($49.55 in chips) 
Seat 3: qwr38jl5txoR36M7G5qi4A ($7.75 in chips) 
Seat 4: Z5NNIVvnhb2IJbLcI79WYQ ($5.25 in chips) 
Seat 5: yzPZQFeaQTNf1YK3a0zRIw ($14.80 in chips) 
Seat 6: arxNSjreDRGFg13EAM2F1w ($25.10 in chips) 
Seat 7: DnDcAdn9P0zGovMERigpFA ($54.90 in chips) 
Seat 8: ghNKXUBl/H+t83JF079ZBA ($29.60 in chips) 
Seat 9: 2wcFsZsqEP5w1StUTVzJCg ($4.50 in chips) 
Th3FldXKQW6hWVVPahaoOQ: posts small blind $0.10
tYsOBqdU1+x+yFI7zHO7hQ: posts big blind $0.25
*** HOLE CARDS ***
qwr38jl5txoR36M7G5qi4A: folds 
Z5NNIVvnhb2IJbLcI79WYQ: folds 
yzPZQFeaQTNf1YK3a0zRIw: folds 
arxNSjreDRGFg13EAM2F1w: raises $0.50 to $0.75
DnDcAdn9P0zGovMERigpFA: folds 
ghNKXUBl/H+t83JF079ZBA: folds 
2wcFsZsqEP5w1StUTVzJCg: folds 
Th3FldXKQW6hWVVPahaoOQ: folds 
tYsOBqdU1+x+yFI7zHO7hQ: folds 
Uncalled bet ($0.50) returned to arxNSjreDRGFg13EAM2F1w
arxNSjreDRGFg13EAM2F1w collected $0.60 from pot
arxNSjreDRGFg13EAM2F1w: doesn't show hand 
*** SUMMARY ***
Total pot $0.60 | Rake $0 
Seat 1: Th3FldXKQW6hWVVPahaoOQ (small blind) folded before Flop
Seat 2: tYsOBqdU1+x+yFI7zHO7hQ (big blind) folded before Flop
Seat 3: qwr38jl5txoR36M7G5qi4A folded before Flop (didn't bet)
Seat 4: Z5NNIVvnhb2IJbLcI79WYQ folded before Flop (didn't bet)
Seat 5: yzPZQFeaQTNf1YK3a0zRIw folded before Flop (didn't bet)
Seat 6: arxNSjreDRGFg13EAM2F1w collected ($0.60)
Seat 7: DnDcAdn9P0zGovMERigpFA folded before Flop (didn't bet)
Seat 8: ghNKXUBl/H+t83JF079ZBA folded before Flop (didn't bet)
Seat 9: 2wcFsZsqEP5w1StUTVzJCg (button) folded before Flop (didn't bet)




PokerStars Game #59941719882:  Hold'em No Limit ($0.10/$0.25) - 2009/07/01 1:44:01 ET
Table 'xro+BVoe2Zuw1TYmz/McJQ' 9-max Seat #6 is the button
Seat 1: xEQxarad8/T4jJdpZy5LGw ($8.80 in chips) 
Seat 2: vSkQm2EelzwRGDDQQk0Fqw ($4.65 in chips) 
Seat 4: N2LVj3iImgnOoHVf8g0rIw ($45.90 in chips) 
Seat 5: w48D7DZIjuBit2n4FRDJ5Q ($15.10 in chips) 
Seat 6: HPEB+AtKw1+C/cxU0o1ciw ($26.50 in chips) 
Seat 7: QEbIGci+itdw+re8RM5fZA ($30.90 in chips) 
Seat 8: ljemhp25Zg+nlA9DLCIiUw ($23 in chips) 
Seat 9: H5Se03ZqSX7tbULXur2MAg ($13.65 in chips) 
QEbIGci+itdw+re8RM5fZA: posts small blind $0.10
ljemhp25Zg+nlA9DLCIiUw: posts big blind $0.25
PdIasPkzm2sqZnN41ZRXOg: sits out 
*** HOLE CARDS ***
H5Se03ZqSX7tbULXur2MAg: folds 
xEQxarad8/T4jJdpZy5LGw: calls $0.25
vSkQm2EelzwRGDDQQk0Fqw: folds 
N2LVj3iImgnOoHVf8g0rIw: folds 
w48D7DZIjuBit2n4FRDJ5Q: calls $0.25
HPEB+AtKw1+C/cxU0o1ciw: folds 
QEbIGci+itdw+re8RM5fZA: folds 
ljemhp25Zg+nlA9DLCIiUw: checks 
*** FLOP *** [2d Ad Qd]
ljemhp25Zg+nlA9DLCIiUw: checks 
xEQxarad8/T4jJdpZy5LGw: bets $0.50
w48D7DZIjuBit2n4FRDJ5Q: folds 
ljemhp25Zg+nlA9DLCIiUw: folds 
Uncalled bet ($0.50) returned to xEQxarad8/T4jJdpZy5LGw
xEQxarad8/T4jJdpZy5LGw collected $0.85 from pot
*** SUMMARY ***
Total pot $0.85 | Rake $0 
Board [2d Ad Qd]
Seat 1: xEQxarad8/T4jJdpZy5LGw collected ($0.85)
Seat 2: vSkQm2EelzwRGDDQQk0Fqw folded before Flop (didn't bet)
Seat 4: N2LVj3iImgnOoHVf8g0rIw folded before Flop (didn't bet)
Seat 5: w48D7DZIjuBit2n4FRDJ5Q folded on the Flop
Seat 6: HPEB+AtKw1+C/cxU0o1ciw (button) folded before Flop (didn't bet)
Seat 7: QEbIGci+itdw+re8RM5fZA (small blind) folded before Flop
Seat 8: ljemhp25Zg+nlA9DLCIiUw (big blind) folded on the Flop
Seat 9: H5Se03ZqSX7tbULXur2MAg folded before Flop (didn't bet)




PokerStars Game #59941720238:  Hold'em No Limit ($0.10/$0.25) - 2009/07/01 1:44:01 ET
Table 'oZuNsbNJuUyQLGKzQ/4JFg' 6-max Seat #3 is the button
Seat 1: vqWjZmdQu/Hxw96/IJTWdQ ($25.35 in chips) 
Seat 2: UA5OsKS3VPaxa7uC8La/kA ($34.50 in chips) 
Seat 3: 8ClCHtFXGNplITm+63KB+Q ($51 in chips) 
Seat 4: 9bpVv1/Qh9IYtXuCtl5VtQ ($24.75 in chips) 
Seat 5: oBUDUfeUyCbZBsjxHZgSiw ($26.80 in chips) 
Seat 6: fwg6dK1+r4jy/y+JqenYYQ ($14.15 in chips) 
9bpVv1/Qh9IYtXuCtl5VtQ: posts small blind $0.10
oBUDUfeUyCbZBsjxHZgSiw: posts big blind $0.25
*** HOLE CARDS ***
fwg6dK1+r4jy/y+JqenYYQ: folds 
vqWjZmdQu/Hxw96/IJTWdQ: raises $0.75 to $1
UA5OsKS3VPaxa7uC8La/kA: folds 
8ClCHtFXGNplITm+63KB+Q: folds 
9bpVv1/Qh9IYtXuCtl5VtQ: folds 
oBUDUfeUyCbZBsjxHZgSiw: folds 
Uncalled bet ($0.75) returned to vqWjZmdQu/Hxw96/IJTWdQ
vqWjZmdQu/Hxw96/IJTWdQ collected $0.60 from pot
vqWjZmdQu/Hxw96/IJTWdQ: doesn't show hand 
*** SUMMARY ***
Total pot $0.60 | Rake $0 
Seat 1: vqWjZmdQu/Hxw96/IJTWdQ collected ($0.60)
Seat 2: UA5OsKS3VPaxa7uC8La/kA folded before Flop (didn't bet)
Seat 3: 8ClCHtFXGNplITm+63KB+Q (button) folded before Flop (didn't bet)
Seat 4: 9bpVv1/Qh9IYtXuCtl5VtQ (small blind) folded before Flop
Seat 5: oBUDUfeUyCbZBsjxHZgSiw (big blind) folded before Flop
Seat 6: fwg6dK1+r4jy/y+JqenYYQ folded before Flop (didn't bet)




PokerStars Game #59941720806:  Hold'em No Limit ($0.10/$0.25) - 2009/07/01 1:44:02 ET
Table 'AchTjdLS1zBUbH3ZIx6f0w' 6-max Seat #5 is the button
Seat 1: rZ0bUtoerhFGDUSRQMnFog ($28.35 in chips) 
Seat 2: kG34n23qFQA3nzdOJTQ1dA ($66.25 in chips) 
Seat 3: k9vn40MOqqb+xF+7GZ6v2g ($28.40 in chips) 
Seat 4: q6WfTUAD9mowIP63ASq2Dg ($30.55 in chips) 
Seat 5: 0av6tRNdi0Ui4f15L7gsVg ($26 in chips) 
Seat 6: epAUIB7h2FJXzUPRIvSkRA ($25.35 in chips) 
epAUIB7h2FJXzUPRIvSkRA: posts small blind $0.10
rZ0bUtoerhFGDUSRQMnFog: posts big blind $0.25
*** HOLE CARDS ***
kG34n23qFQA3nzdOJTQ1dA: folds 
k9vn40MOqqb+xF+7GZ6v2g: calls $0.25
q6WfTUAD9mowIP63ASq2Dg has timed out
q6WfTUAD9mowIP63ASq2Dg: folds 
q6WfTUAD9mowIP63ASq2Dg is sitting out
q6WfTUAD9mowIP63ASq2Dg has returned
0av6tRNdi0Ui4f15L7gsVg: folds 
epAUIB7h2FJXzUPRIvSkRA: calls $0.15
rZ0bUtoerhFGDUSRQMnFog: checks 
*** FLOP *** [Qc Th 3d]
epAUIB7h2FJXzUPRIvSkRA: checks 
rZ0bUtoerhFGDUSRQMnFog: checks 
k9vn40MOqqb+xF+7GZ6v2g: checks 
*** TURN *** [Qc Th 3d] [As]
epAUIB7h2FJXzUPRIvSkRA: checks 
rZ0bUtoerhFGDUSRQMnFog: checks 
k9vn40MOqqb+xF+7GZ6v2g: bets $1.50
epAUIB7h2FJXzUPRIvSkRA: calls $1.50
rZ0bUtoerhFGDUSRQMnFog: folds 
*** RIVER *** [Qc Th 3d As] [5c]
epAUIB7h2FJXzUPRIvSkRA: checks 
k9vn40MOqqb+xF+7GZ6v2g: bets $3
epAUIB7h2FJXzUPRIvSkRA: folds 
Uncalled bet ($3) returned to k9vn40MOqqb+xF+7GZ6v2g
k9vn40MOqqb+xF+7GZ6v2g collected $3.60 from pot
*** SUMMARY ***
Total pot $3.75 | Rake $0.15 
Board [Qc Th 3d As 5c]
Seat 1: rZ0bUtoerhFGDUSRQMnFog (big blind) folded on the Turn
Seat 2: kG34n23qFQA3nzdOJTQ1dA folded before Flop (didn't bet)
Seat 3: k9vn40MOqqb+xF+7GZ6v2g collected ($3.60)
Seat 4: q6WfTUAD9mowIP63ASq2Dg folded before Flop (didn't bet)
Seat 5: 0av6tRNdi0Ui4f15L7gsVg (button) folded before Flop (didn't bet)
Seat 6: epAUIB7h2FJXzUPRIvSkRA (small blind) folded on the River




PokerStars Game #59941720768:  Hold'em No Limit ($0.10/$0.25) - 2009/07/01 1:44:02 ET
Table 'rpIHGyt2QpgQc5bvptAvDQ' 9-max Seat #6 is the button
Seat 2: FX0yWp7Ul3dMebXB0cFjEw ($5.20 in chips) 
Seat 3: N6a/f6AW8S8G3JFw9IFxAg ($10 in chips) 
Seat 4: ASXDkj9tmvF/T2AsNuxg7g ($6.20 in chips) 
Seat 5: XhSvfX1gy0yx/qeW+SOeTw ($10 in chips) 
Seat 6: Mq1ESwxx3LEsA4HjKKjU3Q ($19.15 in chips) 
Seat 7: GHgIdzlzMAmRmmX7jgXtuQ ($6.35 in chips) 
Seat 8: oUgIL46CfA9GCdIuN1TVSw ($6.60 in chips) 
GHgIdzlzMAmRmmX7jgXtuQ: posts small blind $0.10
oUgIL46CfA9GCdIuN1TVSw: posts big blind $0.25
b33tl3: sits out 
VegasVas: sits out 
N6a/f6AW8S8G3JFw9IFxAg: posts big blind $0.25
XhSvfX1gy0yx/qeW+SOeTw: posts big blind $0.25
*** HOLE CARDS ***
FX0yWp7Ul3dMebXB0cFjEw: calls $0.25
N6a/f6AW8S8G3JFw9IFxAg: checks 
ASXDkj9tmvF/T2AsNuxg7g: folds 
XhSvfX1gy0yx/qeW+SOeTw: checks 
Mq1ESwxx3LEsA4HjKKjU3Q: calls $0.25
GHgIdzlzMAmRmmX7jgXtuQ: calls $0.15
oUgIL46CfA9GCdIuN1TVSw: checks 
*** FLOP *** [As 9c 2d]
GHgIdzlzMAmRmmX7jgXtuQ: checks 
oUgIL46CfA9GCdIuN1TVSw: bets $0.45
FX0yWp7Ul3dMebXB0cFjEw: folds 
N6a/f6AW8S8G3JFw9IFxAg: folds 
XhSvfX1gy0yx/qeW+SOeTw: calls $0.45
Mq1ESwxx3LEsA4HjKKjU3Q: folds 
GHgIdzlzMAmRmmX7jgXtuQ: calls $0.45
*** TURN *** [As 9c 2d] [8c]
GHgIdzlzMAmRmmX7jgXtuQ: checks 
oUgIL46CfA9GCdIuN1TVSw: checks 
XhSvfX1gy0yx/qeW+SOeTw: checks 
*** RIVER *** [As 9c 2d 8c] [4d]
GHgIdzlzMAmRmmX7jgXtuQ: checks 
oUgIL46CfA9GCdIuN1TVSw: bets $0.90
XhSvfX1gy0yx/qeW+SOeTw: folds 
GHgIdzlzMAmRmmX7jgXtuQ: calls $0.90
*** SHOW DOWN ***
oUgIL46CfA9GCdIuN1TVSw: shows [6h Ad] (a pair of Aces)
GHgIdzlzMAmRmmX7jgXtuQ: mucks hand 
oUgIL46CfA9GCdIuN1TVSw collected $4.45 from pot
*** SUMMARY ***
Total pot $4.65 | Rake $0.20 
Board [As 9c 2d 8c 4d]
Seat 2: FX0yWp7Ul3dMebXB0cFjEw folded on the Flop
Seat 3: N6a/f6AW8S8G3JFw9IFxAg folded on the Flop
Seat 4: ASXDkj9tmvF/T2AsNuxg7g folded before Flop (didn't bet)
Seat 5: XhSvfX1gy0yx/qeW+SOeTw folded on the River
Seat 6: Mq1ESwxx3LEsA4HjKKjU3Q (button) folded on the Flop
Seat 7: GHgIdzlzMAmRmmX7jgXtuQ (small blind) mucked
Seat 8: oUgIL46CfA9GCdIuN1TVSw (big blind) showed [6h Ad] and won ($4.45) with a pair of Aces




PokerStars Game #59941720288:  Hold'em No Limit ($0.10/$0.25) - 2009/07/01 1:44:02 ET
Table 'pgrBYaOEx/BuqK5iAtlFzw' 9-max Seat #1 is the button
Seat 1: 6O+8t5ikoK+pNiFXnN/Fyw ($14.90 in chips) 
Seat 2: 2Xwi447v1rBHM+92U0CduA ($3.75 in chips) 
Seat 3: Bb42QRQMhg5/Y0vHP8/2Xw ($25.60 in chips) 
Seat 4: oLa/tXLfSLLB28mcLGrxcg ($24.40 in chips) 
Seat 5: BWzInv8o0kN1pJybv/VjpQ ($29 in chips) 
Seat 6: eubS00Znk+qsx0B0+7/Zow ($21.85 in chips) 
Seat 7: eK8qa6EPcH2zhtbmWSvc9g ($25 in chips) 
Seat 8: tLcDklc2rBORNfixyRfVfw ($25 in chips) 
2Xwi447v1rBHM+92U0CduA: posts small blind $0.10
Bb42QRQMhg5/Y0vHP8/2Xw: posts big blind $0.25
Z9W7+g1WMhhZDi7DwGbCFA: sits out 
*** HOLE CARDS ***
oLa/tXLfSLLB28mcLGrxcg: folds 
BWzInv8o0kN1pJybv/VjpQ: folds 
eubS00Znk+qsx0B0+7/Zow: folds 
eK8qa6EPcH2zhtbmWSvc9g: calls $0.25
tLcDklc2rBORNfixyRfVfw: raises $1 to $1.25
6O+8t5ikoK+pNiFXnN/Fyw: folds 
2Xwi447v1rBHM+92U0CduA: folds 
Bb42QRQMhg5/Y0vHP8/2Xw: calls $1
eK8qa6EPcH2zhtbmWSvc9g: calls $1
*** FLOP *** [9d 3h 7s]
Bb42QRQMhg5/Y0vHP8/2Xw: checks 
eK8qa6EPcH2zhtbmWSvc9g: checks 
tLcDklc2rBORNfixyRfVfw: checks 
*** TURN *** [9d 3h 7s] [3s]
Bb42QRQMhg5/Y0vHP8/2Xw: checks 
eK8qa6EPcH2zhtbmWSvc9g: checks 
tLcDklc2rBORNfixyRfVfw: checks 
*** RIVER *** [9d 3h 7s 3s] [Tc]
Bb42QRQMhg5/Y0vHP8/2Xw: checks 
eK8qa6EPcH2zhtbmWSvc9g: checks 
tLcDklc2rBORNfixyRfVfw: bets $4.50
Bb42QRQMhg5/Y0vHP8/2Xw: folds 
eK8qa6EPcH2zhtbmWSvc9g: folds 
Uncalled bet ($4.50) returned to tLcDklc2rBORNfixyRfVfw
tLcDklc2rBORNfixyRfVfw collected $3.70 from pot
tLcDklc2rBORNfixyRfVfw: doesn't show hand 
*** SUMMARY ***
Total pot $3.85 | Rake $0.15 
Board [9d 3h 7s 3s Tc]
Seat 1: 6O+8t5ikoK+pNiFXnN/Fyw (button) folded before Flop (didn't bet)
Seat 2: 2Xwi447v1rBHM+92U0CduA (small blind) folded before Flop
Seat 3: Bb42QRQMhg5/Y0vHP8/2Xw (big blind) folded on the River
Seat 4: oLa/tXLfSLLB28mcLGrxcg folded before Flop (didn't bet)
Seat 5: BWzInv8o0kN1pJybv/VjpQ folded before Flop (didn't bet)
Seat 6: eubS00Znk+qsx0B0+7/Zow folded before Flop (didn't bet)
Seat 7: eK8qa6EPcH2zhtbmWSvc9g folded on the River
Seat 8: tLcDklc2rBORNfixyRfVfw collected ($3.70)




PokerStars Game #59941720802:  Hold'em No Limit ($0.10/$0.25) - 2009/07/01 1:44:02 ET
Table '9lYs7ljXi6AgFAxYHlKLJw' 9-max Seat #3 is the button
Seat 1: K0b5wNInj6hUGRr6yzKFtw ($37.15 in chips) 
Seat 2: 0XACOSNrAWmqNv9k1nF8rw ($18.20 in chips) 
Seat 3: arxNSjreDRGFg13EAM2F1w ($30.95 in chips) 
Seat 4: UANt6y/SmDCY/jIxkBixcw ($33.10 in chips) 
Seat 5: dfNim92Z6XK1/h5SFW5vDg ($52.70 in chips) 
Seat 6: tYsOBqdU1+x+yFI7zHO7hQ ($25 in chips) 
Seat 7: ghNKXUBl/H+t83JF079ZBA ($27.05 in chips) 
Seat 8: 9YN2IkT2JYYKFErZtZvCtA ($19.10 in chips) 
Seat 9: cKlmpQMahVsmOaxFQDcoOg ($19 in chips) 
UANt6y/SmDCY/jIxkBixcw: posts small blind $0.10
dfNim92Z6XK1/h5SFW5vDg: posts big blind $0.25
*** HOLE CARDS ***
tYsOBqdU1+x+yFI7zHO7hQ: folds 
ghNKXUBl/H+t83JF079ZBA: raises $0.75 to $1
9YN2IkT2JYYKFErZtZvCtA: folds 
cKlmpQMahVsmOaxFQDcoOg: folds 
K0b5wNInj6hUGRr6yzKFtw: folds 
0XACOSNrAWmqNv9k1nF8rw: folds 
arxNSjreDRGFg13EAM2F1w: folds 
UANt6y/SmDCY/jIxkBixcw: folds 
dfNim92Z6XK1/h5SFW5vDg: calls $0.75
*** FLOP *** [Jh 6d 8h]
dfNim92Z6XK1/h5SFW5vDg: checks 
ghNKXUBl/H+t83JF079ZBA: bets $1.50
dfNim92Z6XK1/h5SFW5vDg: folds 
Uncalled bet ($1.50) returned to ghNKXUBl/H+t83JF079ZBA
ghNKXUBl/H+t83JF079ZBA collected $2 from pot
ghNKXUBl/H+t83JF079ZBA: doesn't show hand 
*** SUMMARY ***
Total pot $2.10 | Rake $0.10 
Board [Jh 6d 8h]
Seat 1: K0b5wNInj6hUGRr6yzKFtw folded before Flop (didn't bet)
Seat 2: 0XACOSNrAWmqNv9k1nF8rw folded before Flop (didn't bet)
Seat 3: arxNSjreDRGFg13EAM2F1w (button) folded before Flop (didn't bet)
Seat 4: UANt6y/SmDCY/jIxkBixcw (small blind) folded before Flop
Seat 5: dfNim92Z6XK1/h5SFW5vDg (big blind) folded on the Flop
Seat 6: tYsOBqdU1+x+yFI7zHO7hQ folded before Flop (didn't bet)
Seat 7: ghNKXUBl/H+t83JF079ZBA collected ($2)
Seat 8: 9YN2IkT2JYYKFErZtZvCtA folded before Flop (didn't bet)
Seat 9: cKlmpQMahVsmOaxFQDcoOg folded before Flop (didn't bet)




PokerStars Game #59941720466:  Hold'em No Limit ($0.10/$0.25) - 2009/07/01 1:44:02 ET
Table 'nFlmVztKq1HJEWfxmdl15w' 9-max Seat #2 is the button
Seat 1: cZ99hugmLBj9KhTlc8nCSw ($25 in chips) 
Seat 2: Th3FldXKQW6hWVVPahaoOQ ($38.40 in chips) 
Seat 3: DdPXdieucQ+n99u1n3A+rQ ($4.75 in chips) 
Seat 4: +5dSUwD+/k2ktlnutSMivw ($15 in chips) 
Seat 5: Tx6zQdk5Ozt9ObEBlU7jeg ($32.80 in chips) 
Seat 6: 4awUyiDYTgylQKXZ9faBVA ($36 in chips) 
Seat 7: dfNim92Z6XK1/h5SFW5vDg ($35.30 in chips) 
Seat 8: +2kMBNpY4nF1qNCRd8SJLA ($33.90 in chips) 
Seat 9: DnDcAdn9P0zGovMERigpFA ($25 in chips) 
DdPXdieucQ+n99u1n3A+rQ: posts small blind $0.10
+5dSUwD+/k2ktlnutSMivw: posts big blind $0.25
*** HOLE CARDS ***
Tx6zQdk5Ozt9ObEBlU7jeg: calls $0.25
4awUyiDYTgylQKXZ9faBVA: folds 
dfNim92Z6XK1/h5SFW5vDg: folds 
+2kMBNpY4nF1qNCRd8SJLA: folds 
DnDcAdn9P0zGovMERigpFA: folds 
cZ99hugmLBj9KhTlc8nCSw: folds 
Th3FldXKQW6hWVVPahaoOQ: folds 
DdPXdieucQ+n99u1n3A+rQ: calls $0.15
+5dSUwD+/k2ktlnutSMivw: checks 
*** FLOP *** [Kc 9h 8s]
DdPXdieucQ+n99u1n3A+rQ: checks 
+5dSUwD+/k2ktlnutSMivw: checks 
Tx6zQdk5Ozt9ObEBlU7jeg: checks 
*** TURN *** [Kc 9h 8s] [9c]
DdPXdieucQ+n99u1n3A+rQ: bets $0.50
+5dSUwD+/k2ktlnutSMivw: calls $0.50
Tx6zQdk5Ozt9ObEBlU7jeg: folds 
*** RIVER *** [Kc 9h 8s 9c] [5d]
DdPXdieucQ+n99u1n3A+rQ: checks 
+5dSUwD+/k2ktlnutSMivw: checks 
*** SHOW DOWN ***
DdPXdieucQ+n99u1n3A+rQ: shows [Kd Td] (two pair, Kings and Nines)
+5dSUwD+/k2ktlnutSMivw: mucks hand 
DdPXdieucQ+n99u1n3A+rQ collected $1.70 from pot
*** SUMMARY ***
Total pot $1.75 | Rake $0.05 
Board [Kc 9h 8s 9c 5d]
Seat 1: cZ99hugmLBj9KhTlc8nCSw folded before Flop (didn't bet)
Seat 2: Th3FldXKQW6hWVVPahaoOQ (button) folded before Flop (didn't bet)
Seat 3: DdPXdieucQ+n99u1n3A+rQ (small blind) showed [Kd Td] and won ($1.70) with two pair, Kings and Nines
Seat 4: +5dSUwD+/k2ktlnutSMivw (big blind) mucked
Seat 5: Tx6zQdk5Ozt9ObEBlU7jeg folded on the Turn
Seat 6: 4awUyiDYTgylQKXZ9faBVA folded before Flop (didn't bet)
Seat 7: dfNim92Z6XK1/h5SFW5vDg folded before Flop (didn't bet)
Seat 8: +2kMBNpY4nF1qNCRd8SJLA folded before Flop (didn't bet)
Seat 9: DnDcAdn9P0zGovMERigpFA folded before Flop (didn't bet)




PokerStars Game #59941720552:  Hold'em No Limit ($0.10/$0.25) - 2009/07/01 1:44:02 ET
Table 'RUOqTfzbAVGS5x+J9aZMHA' 9-max Seat #2 is the button
Seat 1: DnDcAdn9P0zGovMERigpFA ($25 in chips) 
Seat 2: Z5ZtGOON8kmSdSCll9Z3XA ($8 in chips) 
Seat 3: Th3FldXKQW6hWVVPahaoOQ ($25 in chips) 
Seat 4: K9Az8li/CO2TicltVWKamA ($40.55 in chips) 
Seat 5: MtVtHDqIJTyUcXkRBBDIVA ($26.65 in chips) 
Seat 6: ljemhp25Zg+nlA9DLCIiUw ($40.40 in chips) 
Seat 7: zgi+EUykT/pZQpoUG6+oEg ($4.30 in chips) 
Seat 8: dfNim92Z6XK1/h5SFW5vDg ($29.20 in chips) 
Seat 9: cZ99hugmLBj9KhTlc8nCSw ($25 in chips) 
Th3FldXKQW6hWVVPahaoOQ: posts small blind $0.10
K9Az8li/CO2TicltVWKamA: posts big blind $0.25
*** HOLE CARDS ***
MtVtHDqIJTyUcXkRBBDIVA has timed out
MtVtHDqIJTyUcXkRBBDIVA: folds 
MtVtHDqIJTyUcXkRBBDIVA is sitting out
MtVtHDqIJTyUcXkRBBDIVA has returned
ljemhp25Zg+nlA9DLCIiUw: raises $0.50 to $0.75
zgi+EUykT/pZQpoUG6+oEg: folds 
dfNim92Z6XK1/h5SFW5vDg: folds 
cZ99hugmLBj9KhTlc8nCSw: folds 
DnDcAdn9P0zGovMERigpFA: folds 
Z5ZtGOON8kmSdSCll9Z3XA: folds 
Th3FldXKQW6hWVVPahaoOQ: calls $0.65
K9Az8li/CO2TicltVWKamA: raises $2.25 to $3
ljemhp25Zg+nlA9DLCIiUw: calls $2.25
Th3FldXKQW6hWVVPahaoOQ: folds 
*** FLOP *** [7h 6s 5s]
K9Az8li/CO2TicltVWKamA: bets $2
ljemhp25Zg+nlA9DLCIiUw: calls $2
*** TURN *** [7h 6s 5s] [9s]
K9Az8li/CO2TicltVWKamA: checks 
ljemhp25Zg+nlA9DLCIiUw: checks 
*** RIVER *** [7h 6s 5s 9s] [4h]
K9Az8li/CO2TicltVWKamA: bets $3
ljemhp25Zg+nlA9DLCIiUw: calls $3
*** SHOW DOWN ***
K9Az8li/CO2TicltVWKamA: shows [Td Tc] (a pair of Tens)
ljemhp25Zg+nlA9DLCIiUw: shows [Jh Js] (a pair of Jacks)
ljemhp25Zg+nlA9DLCIiUw collected $15.95 from pot
*** SUMMARY ***
Total pot $16.75 | Rake $0.80 
Board [7h 6s 5s 9s 4h]
Seat 1: DnDcAdn9P0zGovMERigpFA folded before Flop (didn't bet)
Seat 2: Z5ZtGOON8kmSdSCll9Z3XA (button) folded before Flop (didn't bet)
Seat 3: Th3FldXKQW6hWVVPahaoOQ (small blind) folded before Flop
Seat 4: K9Az8li/CO2TicltVWKamA (big blind) showed [Td Tc] and lost with a pair of Tens
Seat 5: MtVtHDqIJTyUcXkRBBDIVA folded before Flop (didn't bet)
Seat 6: ljemhp25Zg+nlA9DLCIiUw showed [Jh Js] and won ($15.95) with a pair of Jacks
Seat 7: zgi+EUykT/pZQpoUG6+oEg folded before Flop (didn't bet)
Seat 8: dfNim92Z6XK1/h5SFW5vDg folded before Flop (didn't bet)
Seat 9: cZ99hugmLBj9KhTlc8nCSw folded before Flop (didn't bet)




PokerStars Game #59941720686:  Hold'em No Limit ($0.10/$0.25) - 2009/07/01 1:44:02 ET
Table 'PCxB2W9H6ma8SwsZlImuOw' 9-max Seat #6 is the button
Seat 1: SqibpGx+lf+brY0fJVvD0w ($25.10 in chips) 
Seat 2: wjH6l1gQaEfv+C45sAOwIQ ($38.20 in chips) 
Seat 3: J2a/QHAWUgo6beDRoEyg2g ($9.10 in chips) 
Seat 4: RsPwA2DnzOke3hD/Of/DUg ($2.55 in chips) 
Seat 5: GZO7tOXatVoX17M2DqPcUQ ($21.40 in chips) 
Seat 6: 5/6dWEBUHldD7iGXa2LwsQ ($16.25 in chips) 
Seat 7: c/9X4zftzphFxYtxp5kp9w ($27.50 in chips) 
Seat 8: Pt637jKksB5MzP0UNJAAkw ($25 in chips) 
Seat 9: COwSH15MvHaRF7en6/TRZQ ($4.65 in chips) 
c/9X4zftzphFxYtxp5kp9w: posts small blind $0.10
Pt637jKksB5MzP0UNJAAkw: posts big blind $0.25
*** HOLE CARDS ***
COwSH15MvHaRF7en6/TRZQ: folds 
SqibpGx+lf+brY0fJVvD0w: folds 
wjH6l1gQaEfv+C45sAOwIQ: folds 
J2a/QHAWUgo6beDRoEyg2g: folds 
RsPwA2DnzOke3hD/Of/DUg: folds 
GZO7tOXatVoX17M2DqPcUQ: folds 
5/6dWEBUHldD7iGXa2LwsQ: raises $0.50 to $0.75
c/9X4zftzphFxYtxp5kp9w: folds 
Pt637jKksB5MzP0UNJAAkw: raises $1 to $1.75
5/6dWEBUHldD7iGXa2LwsQ: folds 
Uncalled bet ($1) returned to Pt637jKksB5MzP0UNJAAkw
Pt637jKksB5MzP0UNJAAkw collected $1.60 from pot
Pt637jKksB5MzP0UNJAAkw: shows [6h 9h] (high card Nine)
*** SUMMARY ***
Total pot $1.60 | Rake $0 
Seat 1: SqibpGx+lf+brY0fJVvD0w folded before Flop (didn't bet)
Seat 2: wjH6l1gQaEfv+C45sAOwIQ folded before Flop (didn't bet)
Seat 3: J2a/QHAWUgo6beDRoEyg2g folded before Flop (didn't bet)
Seat 4: RsPwA2DnzOke3hD/Of/DUg folded before Flop (didn't bet)
Seat 5: GZO7tOXatVoX17M2DqPcUQ folded before Flop (didn't bet)
Seat 6: 5/6dWEBUHldD7iGXa2LwsQ (button) folded before Flop
Seat 7: c/9X4zftzphFxYtxp5kp9w (small blind) folded before Flop
Seat 8: Pt637jKksB5MzP0UNJAAkw (big blind) collected ($1.60)
Seat 9: COwSH15MvHaRF7en6/TRZQ folded before Flop (didn't bet)




PokerStars Game #59941720274:  Hold'em No Limit ($0.10/$0.25) - 2009/07/01 1:44:02 ET
Table 'dYNvO8G5kw5SRxb1Dljhogz2yOdY2zyGWG1gh9WV9XtQ Seat #9 is the button
Seat 1: vSkQm2EelzwRGDDQQk0Fqw ($4.65 in chips) 
Seat 2: PkBmevN3LdXkPj1LHOoTnQ ($14.85 in chips) 
Seat 3: 1Cs1GyQcoM1omwY7XZ3uRg ($12.75 in chips) 
Seat 4: sD+TKtt36XiiN6jqHiLwDA ($28.10 in chips) 
Seat 5: W7XGvw6ngGVq2hFwXk8Myg ($25.60 in chips) 
Seat 6: 22dIObOuor/A+IKWkNoAlA ($8.05 in chips) 
Seat 7: DiSvPC2iudwL5j9u6Huyww ($39.75 in chips) 
Seat 8: 6HoFYfVGBefsR5Vrz62qIw5hAPbqNrvJb8PtLiceXtlg0 in chips) 
Seat 9: PdIasPkzm2sqZnN41ZRXOg ($5 in chips) 
vSkQm2EelzwRGDDQQk0Fqw: posts small blind $0.10
PkBmevN3LdXkPj1LHOoTnQ: posts big blind $0.25
*** HOLE CARDS ***
1Cs1GyQcoM1omwY7XZ3uRg: folds 
sD+TKtt36XiiN6jqHiLwDA: folds 
W7XGvw6ngGVq2hFwXk8Myg: folds 
22dIObOuor/A+IKWkNoAlA: folds 
DiSvPC2iudwL5j9u6Huyww: folds 
6HoFYfVGBefsR5Vrz62qIw5hAPbqNrvJb8PtLiceXtlglds 
PdIasPkzm2sqZnN41ZRXOg: folds 
vSkQm2EelzwRGDDQQk0Fqw: raises $0.50 to $0.75
PkBmevN3LdXkPj1LHOoTnQ: calls $0.50
*** FLOP *** [4c Ac Qd]
vSkQm2EelzwRGDDQQk0Fqw: bets $1
PkBmevN3LdXkPj1LHOoTnQ: calls $1
*** TURN *** [4c Ac Qd] [7d]
vSkQm2EelzwRGDDQQk0Fqw: bets $2.90 and is all-in
PkBmevN3LdXkPj1LHOoTnQ: calls $2.90
*** RIVER *** [4c Ac Qd 7d] [6s]
*** SHOW DOWN ***
vSkQm2EelzwRGDDQQk0Fqw: shows [Ad 9h] (a pair of Aces)
PkBmevN3LdXkPj1LHOoTnQ: mucks hand 
vSkQm2EelzwRGDDQQk0Fqw collected $8.85 from pot
*** SUMMARY ***
Total pot $9.30 | Rake $0.45 
Board [4c Ac Qd 7d 6s]
Seat 1: vSkQm2EelzwRGDDQQk0Fqw (small blind) showed [Ad 9h] and won ($8.85) with a pair of Aces
Seat 2: PkBmevN3LdXkPj1LHOoTnQ (big blind) mucked
Seat 3: 1Cs1GyQcoM1omwY7XZ3uRg folded before Flop (didn't bet)
Seat 4: sD+TKtt36XiiN6jqHiLwDA folded before Flop (didn't bet)
Seat 5: W7XGvw6ngGVq2hFwXk8Myg folded before Flop (didn't bet)
Seat 6: 22dIObOuor/A+IKWkNoAlA folded before Flop (didn't bet)
Seat 7: DiSvPC2iudwL5j9u6Huyww folded before Flop (didn't bet)
Seat 8: 6HoFYfVGBefsR5Vrz62qIw5hAPbqNrvJb8PtLiceXtlgded before Flop (didn't bet)
Seat 9: PdIasPkzm2sqZnN41ZRXOg (button) folded before Flop (didn't bet)




PokerStars Game #59941720956:  Hold'em No Limit ($0.10/$0.25) - 2009/07/01 1:44:03 ET
Table 'WEMI3Mtn7dGARDbgNrKibgQvLFJzpzymuOsaaRYi+8fgx Seat #9 is the button
Seat 1: cZ99hugmLBj9KhTlc8nCSw ($25 in chips) 
Seat 2: PdIasPkzm2sqZnN41ZRXOg ($5 in chips) 
Seat 4: tLcDklc2rBORNfixyRfVfw ($25.60 in chips) 
Seat 5: MG90wfSJZnOejs/KD3vlQQ ($36.75 in chips) 
Seat 6: vKdukiQ4ktU4yJ0Xx3MKnA ($10 in chips) 
Seat 7: rQhYIYXSyH/IivYM1dlV5A ($11.20 in chips) 
Seat 8: gehe91e0IyVT0QU/XBkEyg ($26.75 in chips) 
Seat 9: BWzInv8o0kN1pJybv/VjpQ ($43.75 in chips) 
cZ99hugmLBj9KhTlc8nCSw: posts small blind $0.10
PdIasPkzm2sqZnN41ZRXOg: posts big blind $0.25
Qduu7ikeizo6q6Ei9YvcJA: sits out 
vKdukiQ4ktU4yJ0Xx3MKnA: posts big blind $0.25
*** HOLE CARDS ***
tLcDklc2rBORNfixyRfVfw: folds 
MG90wfSJZnOejs/KD3vlQQ: folds 
vKdukiQ4ktU4yJ0Xx3MKnA: checks 
rQhYIYXSyH/IivYM1dlV5A: folds 
gehe91e0IyVT0QU/XBkEyg: calls $0.25
BWzInv8o0kN1pJybv/VjpQ: folds 
cZ99hugmLBj9KhTlc8nCSw: folds 
PdIasPkzm2sqZnN41ZRXOg: checks 
*** FLOP *** [Js Tc Th]
PdIasPkzm2sqZnN41ZRXOg: checks 
vKdukiQ4ktU4yJ0Xx3MKnA: checks 
gehe91e0IyVT0QU/XBkEyg: checks 
*** TURN *** [Js Tc Th] [Ah]
PdIasPkzm2sqZnN41ZRXOg: checks 
vKdukiQ4ktU4yJ0Xx3MKnA: checks 
gehe91e0IyVT0QU/XBkEyg: checks 
*** RIVER *** [Js Tc Th Ah] [3s]
PdIasPkzm2sqZnN41ZRXOg: checks 
vKdukiQ4ktU4yJ0Xx3MKnA: checks 
gehe91e0IyVT0QU/XBkEyg: checks 
*** SHOW DOWN ***
PdIasPkzm2sqZnN41ZRXOg: shows [6d 8d] (a pair of Tens)
vKdukiQ4ktU4yJ0Xx3MKnA: shows [2c Ks] (a pair of Tens - Ace+King kicker)
gehe91e0IyVT0QU/XBkEyg: shows [6s 6h] (two pair, Tens and Sixes)
gehe91e0IyVT0QU/XBkEyg collected $0.85 from pot
*** SUMMARY ***
Total pot $0.85 | Rake $0 
Board [Js Tc Th Ah 3s]
Seat 1: cZ99hugmLBj9KhTlc8nCSw (small blind) folded before Flop
Seat 2: PdIasPkzm2sqZnN41ZRXOg (big blind) showed [6d 8d] and lost with a pair of Tens
Seat 4: tLcDklc2rBORNfixyRfVfw folded before Flop (didn't bet)
Seat 5: MG90wfSJZnOejs/KD3vlQQ folded before Flop (didn't bet)
Seat 6: vKdukiQ4ktU4yJ0Xx3MKnA showed [2c Ks] and lost with a pair of Tens
Seat 7: rQhYIYXSyH/IivYM1dlV5A folded before Flop (didn't bet)
Seat 8: gehe91e0IyVT0QU/XBkEyg showed [6s 6h] and won ($0.85) with two pair, Tens and Sixes
Seat 9: BWzInv8o0kN1pJybv/VjpQ (button) folded before Flop (didn't bet)




PokerStars Game #59941720918:  Hold'em No Limit ($0.10/$0.25) - 2009/07/01 1:44:03 ET
Table 'fIMYcWwN4/aXFJvH5Z8Ymg' 6-max Seat #3 is the button
Seat 1: DihMHaz4WNETH1bPDe13kA ($25 in chips) 
Seat 3: 9bpVv1/Qh9IYtXuCtl5VtQ ($25 in chips) 
Seat 4: 32YL2ZEp8NT4JB2RVM9euQ ($42.50 in chips) 
Seat 5: lquriepNQBhDV5P1SWHhnA ($25.35 in chips) 
Seat 6: jp34e617tIzV8tKIWmfAbA ($28.35 in chips) 
32YL2ZEp8NT4JB2RVM9euQ: posts small blind $0.10
lquriepNQBhDV5P1SWHhnA: posts big blind $0.25
StevenWu: sits out 
*** HOLE CARDS ***
jp34e617tIzV8tKIWmfAbA: folds 
DihMHaz4WNETH1bPDe13kA: folds 
9bpVv1/Qh9IYtXuCtl5VtQ: folds 
32YL2ZEp8NT4JB2RVM9euQ: folds 
Uncalled bet ($0.15) returned to lquriepNQBhDV5P1SWHhnA
lquriepNQBhDV5P1SWHhnA collected $0.20 from pot
lquriepNQBhDV5P1SWHhnA: doesn't show hand 
*** SUMMARY ***
Total pot $0.20 | Rake $0 
Seat 1: DihMHaz4WNETH1bPDe13kA folded before Flop (didn't bet)
Seat 3: 9bpVv1/Qh9IYtXuCtl5VtQ (button) folded before Flop (didn't bet)
Seat 4: 32YL2ZEp8NT4JB2RVM9euQ (small blind) folded before Flop
Seat 5: lquriepNQBhDV5P1SWHhnA (big blind) collected ($0.20)
Seat 6: jp34e617tIzV8tKIWmfAbA folded before Flop (didn't bet)




PokerStars Game #59941720830:  Hold'em No Limit ($0.10/$0.25) - 2009/07/01 1:44:03 ET
Table '9iHhO6FyZVM8XpSc23TIgg' 6-max Seat #2 is the button
Seat 1: NhUN/JpAprdJeamFBgJH1w ($37.40 in chips) 
Seat 2: bJFzs6QmEEnz4miMfSDtcg ($40.80 in chips) 
Seat 3: TSmua8tGK3sTbwi0ynrW9Q ($26.60 in chips) 
Seat 4: cfJccEfyn6IkquPN08hFsA ($39.30 in chips) 
Seat 5: xrf8tAXKQHG99HixCot1Iw ($41.80 in chips) 
Seat 6: iyZxqznXjv3vtvOJymkoLQ ($34.10 in chips) 
TSmua8tGK3sTbwi0ynrW9Q: posts small blind $0.10
cfJccEfyn6IkquPN08hFsA: posts big blind $0.25
*** HOLE CARDS ***
xrf8tAXKQHG99HixCot1Iw: raises $0.50 to $0.75
cfJccEfyn6IkquPN08hFsA said, "nh"
iyZxqznXjv3vtvOJymkoLQ: folds 
NhUN/JpAprdJeamFBgJH1w: folds 
bJFzs6QmEEnz4miMfSDtcg: calls $0.75
TSmua8tGK3sTbwi0ynrW9Q: folds 
bJFzs6QmEEnz4miMfSDtcg said, "nh"
cfJccEfyn6IkquPN08hFsA: raises $38.55 to $39.30 and is all-in
xrf8tAXKQHG99HixCot1Iw: raises $2.50 to $41.80 and is all-in
bJFzs6QmEEnz4miMfSDtcg: folds 
Uncalled bet ($2.50) returned to xrf8tAXKQHG99HixCot1Iw
*** FLOP *** [2c 9c 9h]
*** TURN *** [2c 9c 9h] [Jd]
*** RIVER *** [2c 9c 9h Jd] [8s]
*** SHOW DOWN ***
cfJccEfyn6IkquPN08hFsA: shows [Qc Qd] (two pair, Queens and Nines)
xrf8tAXKQHG99HixCot1Iw: shows [Ad Ah] (two pair, Aces and Nines)
xrf8tAXKQHG99HixCot1Iw collected $76.45 from pot
*** SUMMARY ***
Total pot $79.45 | Rake $3 
Board [2c 9c 9h Jd 8s]
Seat 1: NhUN/JpAprdJeamFBgJH1w folded before Flop (didn't bet)
Seat 2: bJFzs6QmEEnz4miMfSDtcg (button) folded before Flop
Seat 3: TSmua8tGK3sTbwi0ynrW9Q (small blind) folded before Flop
Seat 4: cfJccEfyn6IkquPN08hFsA (big blind) showed [Qc Qd] and lost with two pair, Queens and Nines
Seat 5: xrf8tAXKQHG99HixCot1Iw showed [Ad Ah] and won ($76.45) with two pair, Aces and Nines
Seat 6: iyZxqznXjv3vtvOJymkoLQ folded before Flop (didn't bet)




PokerStars Game #59941721138:  Hold'em No Limit ($0.10/$0.25) - 2009/07/01 1:44:03 ET
Table 'R5qKG21jwFDYRcOht9qwqQ' 9-max Seat #3 is the button
Seat 2: N6foVRyErHqcNmshkqextQ ($14.05 in chips) 
Seat 3: M2QO2DxB5Wawg2h8HSpnYA ($13 in chips) 
Seat 5: zUXhymECc2C9W9ZNw6qppA ($9.65 in chips) 
Seat 6: EP17SQz/iWcuYdNOGeBgkw ($15.75 in chips) 
Seat 8: tYsOBqdU1+x+yFI7zHO7hQ ($35.05 in chips) 
Seat 9: MG90wfSJZnOejs/KD3vlQQ ($31 in chips) 
zUXhymECc2C9W9ZNw6qppA: posts small blind $0.10
EP17SQz/iWcuYdNOGeBgkw: posts big blind $0.25
zgi+EUykT/pZQpoUG6+oEg: sits out 
WPT_Champ111: sits out 
N6foVRyErHqcNmshkqextQ: posts big blind $0.25
*** HOLE CARDS ***
tYsOBqdU1+x+yFI7zHO7hQ: folds 
MG90wfSJZnOejs/KD3vlQQ: raises $0.75 to $1
N6foVRyErHqcNmshkqextQ: folds 
M2QO2DxB5Wawg2h8HSpnYA: folds 
zUXhymECc2C9W9ZNw6qppA: folds 
EP17SQz/iWcuYdNOGeBgkw: calls $0.75
*** FLOP *** [Ks Ah Th]
EP17SQz/iWcuYdNOGeBgkw: checks 
MG90wfSJZnOejs/KD3vlQQ: bets $1.80
EP17SQz/iWcuYdNOGeBgkw: folds 
Uncalled bet ($1.80) returned to MG90wfSJZnOejs/KD3vlQQ
MG90wfSJZnOejs/KD3vlQQ collected $2.25 from pot
*** SUMMARY ***
Total pot $2.35 | Rake $0.10 
Board [Ks Ah Th]
Seat 2: N6foVRyErHqcNmshkqextQ folded before Flop
Seat 3: M2QO2DxB5Wawg2h8HSpnYA (button) folded before Flop (didn't bet)
Seat 5: zUXhymECc2C9W9ZNw6qppA (small blind) folded before Flop
Seat 6: EP17SQz/iWcuYdNOGeBgkw (big blind) folded on the Flop
Seat 8: tYsOBqdU1+x+yFI7zHO7hQ folded before Flop (didn't bet)
Seat 9: MG90wfSJZnOejs/KD3vlQQ collected ($2.25)




PokerStars Game #59941721728:  Hold'em No Limit ($0.10/$0.25) - 2009/07/01 1:44:04 ET
Table 'eOXPe2c6mG7DOFKvMsZZfA' 6-max Seat #5 is the button
Seat 1: s21kVGMLPAoHdWR+muSonw ($25.40 in chips) 
Seat 2: gaPMxLGp9SOj4Lq6t+/0Ig ($7.10 in chips) 
Seat 3: kReyZ6g6Fu3tQ0nyjDf9kA ($27.10 in chips) 
Seat 4: zHHLkD2sRljslKKeQv/ZQw ($35.35 in chips) 
Seat 5: NhUN/JpAprdJeamFBgJH1w ($32.30 in chips) 
Seat 6: Qpv/hb5ak7LeaDig1L5L8w ($13.35 in chips) 
Qpv/hb5ak7LeaDig1L5L8w: posts small blind $0.10
s21kVGMLPAoHdWR+muSonw: posts big blind $0.25
*** HOLE CARDS ***
gaPMxLGp9SOj4Lq6t+/0Ig: folds 
kReyZ6g6Fu3tQ0nyjDf9kA: folds 
zHHLkD2sRljslKKeQv/ZQw: folds 
NhUN/JpAprdJeamFBgJH1w: folds 
Qpv/hb5ak7LeaDig1L5L8w: calls $0.15
s21kVGMLPAoHdWR+muSonw: checks 
*** FLOP *** [Kc 2s Kh]
Qpv/hb5ak7LeaDig1L5L8w: bets $0.50
s21kVGMLPAoHdWR+muSonw: folds 
Uncalled bet ($0.50) returned to Qpv/hb5ak7LeaDig1L5L8w
Qpv/hb5ak7LeaDig1L5L8w collected $0.50 from pot
*** SUMMARY ***
Total pot $0.50 | Rake $0 
Board [Kc 2s Kh]
Seat 1: s21kVGMLPAoHdWR+muSonw (big blind) folded on the Flop
Seat 2: gaPMxLGp9SOj4Lq6t+/0Ig folded before Flop (didn't bet)
Seat 3: kReyZ6g6Fu3tQ0nyjDf9kA folded before Flop (didn't bet)
Seat 4: zHHLkD2sRljslKKeQv/ZQw folded before Flop (didn't bet)
Seat 5: NhUN/JpAprdJeamFBgJH1w (button) folded before Flop (didn't bet)
Seat 6: Qpv/hb5ak7LeaDig1L5L8w (small blind) collected ($0.50)




PokerStars Game #59941721716:  Hold'em No Limit ($0.10/$0.25) - 2009/07/01 1:44:04 ET
Table '+198VWQSWBhYQOcizzuBkw' 6-max Seat #3 is the button
Seat 1: 34ttqW62uIRrqINCCmLcsw ($6.95 in chips) 
Seat 2: iauW7L/+7qzAuHow7CD75Q ($10.70 in chips) 
Seat 3: vw7gefupgmOJJN8lUemdWg ($25.30 in chips) 
Seat 4: TgDsTeCdLQt8kWbL00ByRA ($15 in chips) 
Seat 5: LtASJ9OlkqGrrUKGQlpGAw ($25.70 in chips) 
Seat 6: leEQ84f6wJYu5SB/vj27wg ($9.85 in chips) 
TgDsTeCdLQt8kWbL00ByRA: posts small blind $0.10
LtASJ9OlkqGrrUKGQlpGAw: posts big blind $0.25
*** HOLE CARDS ***
leEQ84f6wJYu5SB/vj27wg: calls $0.25
34ttqW62uIRrqINCCmLcsw: calls $0.25
iauW7L/+7qzAuHow7CD75Q: folds 
vw7gefupgmOJJN8lUemdWg: calls $0.25
TgDsTeCdLQt8kWbL00ByRA: calls $0.15
LtASJ9OlkqGrrUKGQlpGAw: checks 
*** FLOP *** [Js 6h Th]
TgDsTeCdLQt8kWbL00ByRA: checks 
LtASJ9OlkqGrrUKGQlpGAw: checks 
leEQ84f6wJYu5SB/vj27wg: checks 
34ttqW62uIRrqINCCmLcsw: checks 
vw7gefupgmOJJN8lUemdWg: bets $1
TgDsTeCdLQt8kWbL00ByRA: folds 
LtASJ9OlkqGrrUKGQlpGAw: folds 
leEQ84f6wJYu5SB/vj27wg: calls $1
34ttqW62uIRrqINCCmLcsw: raises $3 to $4
vw7gefupgmOJJN8lUemdWg: folds 
leEQ84f6wJYu5SB/vj27wg: raises $3 to $7
34ttqW62uIRrqINCCmLcsw: calls $2.70 and is all-in
Uncalled bet ($0.30) returned to leEQ84f6wJYu5SB/vj27wg
*** TURN *** [Js 6h Th] [3c]
*** RIVER *** [Js 6h Th 3c] [Ah]
*** SHOW DOWN ***
leEQ84f6wJYu5SB/vj27wg: shows [Kc Ts] (a pair of Tens)
34ttqW62uIRrqINCCmLcsw: shows [Jd Td] (two pair, Jacks and Tens)
34ttqW62uIRrqINCCmLcsw collected $14.90 from pot
*** SUMMARY ***
Total pot $15.65 | Rake $0.75 
Board [Js 6h Th 3c Ah]
Seat 1: 34ttqW62uIRrqINCCmLcsw showed [Jd Td] and won ($14.90) with two pair, Jacks and Tens
Seat 2: iauW7L/+7qzAuHow7CD75Q folded before Flop (didn't bet)
Seat 3: vw7gefupgmOJJN8lUemdWg (button) folded on the Flop
Seat 4: TgDsTeCdLQt8kWbL00ByRA (small blind) folded on the Flop
Seat 5: LtASJ9OlkqGrrUKGQlpGAw (big blind) folded on the Flop
Seat 6: leEQ84f6wJYu5SB/vj27wg showed [Kc Ts] and lost with a pair of Tens




PokerStars Game #59941721320:  Hold'em No Limit ($0.10/$0.25) - 2009/07/01 1:44:04 ET
Table 'IRgQPZVA4+IaZZIQshgwyg' 6-max Seat #5 is the button
Seat 1: cezpHJ8FB07dj0xG+LhOvw ($27.90 in chips) 
Seat 2: lquriepNQBhDV5P1SWHhnA ($25 in chips) 
Seat 3: DihMHaz4WNETH1bPDe13kA ($27.45 in chips) 
Seat 4: DE9hRlt14g+JdsRQ4wT7hg ($27.15 in chips) 
Seat 5: PbMzPZIePKifKQZfKDkbIw ($37.85 in chips) 
Seat 6: XbIIdTtuN1xO7zurECHBTg ($6.70 in chips) 
XbIIdTtuN1xO7zurECHBTg: posts small blind $0.10
cezpHJ8FB07dj0xG+LhOvw: posts big blind $0.25
*** HOLE CARDS ***
lquriepNQBhDV5P1SWHhnA said, "always the same"
lquriepNQBhDV5P1SWHhnA: folds 
DihMHaz4WNETH1bPDe13kA: folds 
DE9hRlt14g+JdsRQ4wT7hg: folds 
PbMzPZIePKifKQZfKDkbIw: raises $0.50 to $0.75
XbIIdTtuN1xO7zurECHBTg: calls $0.65
cezpHJ8FB07dj0xG+LhOvw: folds 
*** FLOP *** [Td Qc Jc]
XbIIdTtuN1xO7zurECHBTg: checks 
PbMzPZIePKifKQZfKDkbIw: checks 
*** TURN *** [Td Qc Jc] [4c]
XbIIdTtuN1xO7zurECHBTg: checks 
PbMzPZIePKifKQZfKDkbIw: checks 
*** RIVER *** [Td Qc Jc 4c] [6s]
XbIIdTtuN1xO7zurECHBTg: checks 
PbMzPZIePKifKQZfKDkbIw: checks 
*** SHOW DOWN ***
XbIIdTtuN1xO7zurECHBTg: shows [6h 5c] (a pair of Sixes)
PbMzPZIePKifKQZfKDkbIw: mucks hand 
XbIIdTtuN1xO7zurECHBTg collected $1.70 from pot
XbIIdTtuN1xO7zurECHBTg is sitting out
XbIIdTtuN1xO7zurECHBTg has returned
*** SUMMARY ***
Total pot $1.75 | Rake $0.05 
Board [Td Qc Jc 4c 6s]
Seat 1: cezpHJ8FB07dj0xG+LhOvw (big blind) folded before Flop
Seat 2: lquriepNQBhDV5P1SWHhnA folded before Flop (didn't bet)
Seat 3: DihMHaz4WNETH1bPDe13kA folded before Flop (didn't bet)
Seat 4: DE9hRlt14g+JdsRQ4wT7hg folded before Flop (didn't bet)
Seat 5: PbMzPZIePKifKQZfKDkbIw (button) mucked
Seat 6: XbIIdTtuN1xO7zurECHBTg (small blind) showed [6h 5c] and won ($1.70) with a pair of Sixes




PokerStars Game #59941721776:  Hold'em No Limit ($0.10/$0.25) - 2009/07/01 1:44:04 ET
Table 'tq5CvS0RUqGkuBK0XTzqqg' 6-max Seat #5 is the button
Seat 1: +ZlnqPoP3Hg4BIUxDfKd/A ($30.45 in chips) 
Seat 2: 2m6ZFAdj01UZd4WtEySXXQ ($4.75 in chips) 
Seat 3: PbMzPZIePKifKQZfKDkbIw ($53.60 in chips) 
Seat 4: UT5XpwOH1ipkOF7n1MqDJA ($19.40 in chips) 
Seat 5: qGHGf/553gQnDoklMRe3tg ($33.05 in chips) 
Seat 6: L3/N/gliETan8N5Gim5h4Q ($25.80 in chips) 
L3/N/gliETan8N5Gim5h4Q: posts small blind $0.10
+ZlnqPoP3Hg4BIUxDfKd/A: posts big blind $0.25
*** HOLE CARDS ***
2m6ZFAdj01UZd4WtEySXXQ: calls $0.25
PbMzPZIePKifKQZfKDkbIw: folds 
UT5XpwOH1ipkOF7n1MqDJA: folds 
qGHGf/553gQnDoklMRe3tg: folds 
L3/N/gliETan8N5Gim5h4Q: folds 
+ZlnqPoP3Hg4BIUxDfKd/A: checks 
*** FLOP *** [Ac 7c Qd]
+ZlnqPoP3Hg4BIUxDfKd/A: checks 
2m6ZFAdj01UZd4WtEySXXQ: bets $0.50
+ZlnqPoP3Hg4BIUxDfKd/A: folds 
Uncalled bet ($0.50) returned to 2m6ZFAdj01UZd4WtEySXXQ
2m6ZFAdj01UZd4WtEySXXQ collected $0.60 from pot
*** SUMMARY ***
Total pot $0.60 | Rake $0 
Board [Ac 7c Qd]
Seat 1: +ZlnqPoP3Hg4BIUxDfKd/A (big blind) folded on the Flop
Seat 2: 2m6ZFAdj01UZd4WtEySXXQ collected ($0.60)
Seat 3: PbMzPZIePKifKQZfKDkbIw folded before Flop (didn't bet)
Seat 4: UT5XpwOH1ipkOF7n1MqDJA folded before Flop (didn't bet)
Seat 5: qGHGf/553gQnDoklMRe3tg (button) folded before Flop (didn't bet)
Seat 6: L3/N/gliETan8N5Gim5h4Q (small blind) folded before Flop




PokerStars Game #59941721494:  Hold'em No Limit ($0.10/$0.25) - 2009/07/01 1:44:04 ET
Table 'IuqVbFI+pwnJjvwBCGSGAw' 6-max Seat #1 is the button
Seat 1: LyDHtw3/yniNHW+DvLXbog ($26.70 in chips) 
Seat 3: QiL+lEgEWwy21jk/ltaRLg ($21.50 in chips) 
Seat 4: DE9hRlt14g+JdsRQ4wT7hg ($25.35 in chips) 
Seat 5: if4dh6jhJXeN3/qd3qCp9g ($25.35 in chips) 
QiL+lEgEWwy21jk/ltaRLg: posts small blind $0.10
DE9hRlt14g+JdsRQ4wT7hg: posts big blind $0.25
xC0kaiDYM6YTlgODL83O5A: sits out 
*** HOLE CARDS ***
if4dh6jhJXeN3/qd3qCp9g: folds 
LyDHtw3/yniNHW+DvLXbog: raises $0.75 to $1
QiL+lEgEWwy21jk/ltaRLg: folds 
DE9hRlt14g+JdsRQ4wT7hg: raises $2.25 to $3.25
LyDHtw3/yniNHW+DvLXbog: folds 
Uncalled bet ($2.25) returned to DE9hRlt14g+JdsRQ4wT7hg
DE9hRlt14g+JdsRQ4wT7hg collected $2.10 from pot
DE9hRlt14g+JdsRQ4wT7hg: doesn't show hand 
*** SUMMARY ***
Total pot $2.10 | Rake $0 
Seat 1: LyDHtw3/yniNHW+DvLXbog (button) folded before Flop
Seat 3: QiL+lEgEWwy21jk/ltaRLg (small blind) folded before Flop
Seat 4: DE9hRlt14g+JdsRQ4wT7hg (big blind) collected ($2.10)
Seat 5: if4dh6jhJXeN3/qd3qCp9g folded before Flop (didn't bet)




PokerStars Game #59941721636:  Hold'em No Limit ($0.10/$0.25) - 2009/07/01 1:44:04 ET
Table 'S6s+TmTlAjLHclBRvN5/fw' 9-max Seat #8 is the button
Seat 3: z2SmIaQ3+5n/eY1BN5HgPg ($4.95 in chips) 
Seat 8: OlPJsgR4xypSg/w1z7Gyvw ($22.90 in chips) 
X6+pSIPfovPcE87t+LmUKQ will be allowed to play after the button
OlPJsgR4xypSg/w1z7Gyvw: posts small blind $0.10
z2SmIaQ3+5n/eY1BN5HgPg: posts big blind $0.25
*** HOLE CARDS ***
RSal7+azPhXeqQO5L8XPfg joins the table at seat #4 
X6+pSIPfovPcE87t+LmUKQ leaves the table
OlPJsgR4xypSg/w1z7Gyvw: folds 
Uncalled bet ($0.15) returned to z2SmIaQ3+5n/eY1BN5HgPg
OlPJsgR4xypSg/w1z7Gyvw leaves the table
z2SmIaQ3+5n/eY1BN5HgPg collected $0.20 from pot
z2SmIaQ3+5n/eY1BN5HgPg: doesn't show hand 
*** SUMMARY ***
Total pot $0.20 | Rake $0 
Seat 3: z2SmIaQ3+5n/eY1BN5HgPg (big blind) collected ($0.20)
Seat 8: OlPJsgR4xypSg/w1z7Gyvw (button) (small blind) folded before Flop




PokerStars Game #59941721464:  Hold'em No Limit ($0.10/$0.25) - 2009/07/01 1:44:04 ET
Table 'fRxOyfaHXkWUDLv4eSxFew' 9-max Seat #8 is the button
Seat 1: 6RiVTYll/5D8zICp0MRpKw ($29.15 in chips) 
Seat 2: M2QO2DxB5Wawg2h8HSpnYA ($10.35 in chips) 
Seat 3: j4q3p0lesp63b1gZDwLBZw ($9.85 in chips) 
Seat 4: MtVtHDqIJTyUcXkRBBDIVA ($27.60 in chips) 
Seat 5: dmYlc+1cjwZMJ7wV+Z0rRg ($22.75 in chips) 
Seat 6: arxNSjreDRGFg13EAM2F1w ($27.05 in chips) 
Seat 7: 1/DuWziR8CXhWB71aPQd9Q ($12.80 in chips) 
Seat 8: 5n7e7I+px7c6CQmLpPbtsg ($4.65 in chips) 
Seat 9: H5Se03ZqSX7tbULXur2MAg ($32.75 in chips) 
H5Se03ZqSX7tbULXur2MAg: posts small blind $0.10
6RiVTYll/5D8zICp0MRpKw: posts big blind $0.25
*** HOLE CARDS ***
M2QO2DxB5Wawg2h8HSpnYA: folds 
j4q3p0lesp63b1gZDwLBZw: folds 
j4q3p0lesp63b1gZDwLBZw leaves the table
MtVtHDqIJTyUcXkRBBDIVA: folds 
dmYlc+1cjwZMJ7wV+Z0rRg: folds 
arxNSjreDRGFg13EAM2F1w: folds 
1/DuWziR8CXhWB71aPQd9Q: calls $0.25
5n7e7I+px7c6CQmLpPbtsg: raises $0.75 to $1
VegasVas joins the table at seat #3 
H5Se03ZqSX7tbULXur2MAg: folds 
6RiVTYll/5D8zICp0MRpKw: folds 
1/DuWziR8CXhWB71aPQd9Q: calls $0.75
*** FLOP *** [Ac 3s 6s]
1/DuWziR8CXhWB71aPQd9Q: checks 
5n7e7I+px7c6CQmLpPbtsg: bets $2.30
1/DuWziR8CXhWB71aPQd9Q: folds 
Uncalled bet ($2.30) returned to 5n7e7I+px7c6CQmLpPbtsg
5n7e7I+px7c6CQmLpPbtsg collected $2.25 from pot
5n7e7I+px7c6CQmLpPbtsg: doesn't show hand 
*** SUMMARY ***
Total pot $2.35 | Rake $0.10 
Board [Ac 3s 6s]
Seat 1: 6RiVTYll/5D8zICp0MRpKw (big blind) folded before Flop
Seat 2: M2QO2DxB5Wawg2h8HSpnYA folded before Flop (didn't bet)
Seat 3: j4q3p0lesp63b1gZDwLBZw folded before Flop (didn't bet)
Seat 4: MtVtHDqIJTyUcXkRBBDIVA folded before Flop (didn't bet)
Seat 5: dmYlc+1cjwZMJ7wV+Z0rRg folded before Flop (didn't bet)
Seat 6: arxNSjreDRGFg13EAM2F1w folded before Flop (didn't bet)
Seat 7: 1/DuWziR8CXhWB71aPQd9Q folded on the Flop
Seat 8: 5n7e7I+px7c6CQmLpPbtsg (button) collected ($2.25)
Seat 9: H5Se03ZqSX7tbULXur2MAg (small blind) folded before Flop




PokerStars Game #59941721354:  Hold'em No Limit ($0.10/$0.25) - 2009/07/01 1:44:04 ET
Table 'ThBZ355rqvsb8UGb6ajbig' 9-max Seat #1 is the button
Seat 1: Z9W7+g1WMhhZDi7DwGbCFA ($5 in chips) 
Seat 2: 4awUyiDYTgylQKXZ9faBVA ($25.70 in chips) 
Seat 3: H5Se03ZqSX7tbULXur2MAg ($29.40 in chips) 
Seat 4: zgi+EUykT/pZQpoUG6+oEg ($4.65 in chips) 
Seat 5: cKlmpQMahVsmOaxFQDcoOg ($24.95 in chips) 
Seat 6: qwr38jl5txoR36M7G5qi4A ($9.65 in chips) 
Seat 7: zUXhymECc2C9W9ZNw6qppA ($17.20 in chips) 
Seat 8: PdIasPkzm2sqZnN41ZRXOg ($4.90 in chips) 
Seat 9: sD+TKtt36XiiN6jqHiLwDA ($23.85 in chips) 
4awUyiDYTgylQKXZ9faBVA: posts small blind $0.10
H5Se03ZqSX7tbULXur2MAg: posts big blind $0.25
*** HOLE CARDS ***
zgi+EUykT/pZQpoUG6+oEg: folds 
cKlmpQMahVsmOaxFQDcoOg: folds 
qwr38jl5txoR36M7G5qi4A: folds 
zUXhymECc2C9W9ZNw6qppA: raises $0.75 to $1
PdIasPkzm2sqZnN41ZRXOg: folds 
sD+TKtt36XiiN6jqHiLwDA: folds 
Z9W7+g1WMhhZDi7DwGbCFA: folds 
4awUyiDYTgylQKXZ9faBVA: folds 
H5Se03ZqSX7tbULXur2MAg: folds 
Uncalled bet ($0.75) returned to zUXhymECc2C9W9ZNw6qppA
zUXhymECc2C9W9ZNw6qppA collected $0.60 from pot
*** SUMMARY ***
Total pot $0.60 | Rake $0 
Seat 1: Z9W7+g1WMhhZDi7DwGbCFA (button) folded before Flop (didn't bet)
Seat 2: 4awUyiDYTgylQKXZ9faBVA (small blind) folded before Flop
Seat 3: H5Se03ZqSX7tbULXur2MAg (big blind) folded before Flop
Seat 4: zgi+EUykT/pZQpoUG6+oEg folded before Flop (didn't bet)
Seat 5: cKlmpQMahVsmOaxFQDcoOg folded before Flop (didn't bet)
Seat 6: qwr38jl5txoR36M7G5qi4A folded before Flop (didn't bet)
Seat 7: zUXhymECc2C9W9ZNw6qppA collected ($0.60)
Seat 8: PdIasPkzm2sqZnN41ZRXOg folded before Flop (didn't bet)
Seat 9: sD+TKtt36XiiN6jqHiLwDA folded before Flop (didn't bet)




PokerStars Game #59941722210:  Hold'em No Limit ($0.10/$0.25) - 2009/07/01 1:44:05 ET
Table 'BabJGL6tfXQp3leBGbYe8A' 9-max Seat #1 is the button
Seat 1: qwr38jl5txoR36M7G5qi4A ($8 in chips) 
Seat 2: dtZ84flFEi4Q+SGrHMJRDQ ($35.75 in chips) 
Seat 3: sD+TKtt36XiiN6jqHiLwDA ($25.70 in chips) 
Seat 4: gehe91e0IyVT0QU/XBkEyg ($28.45 in chips) 
Seat 5: GrNTWMdwy+jC6Lred1eDng ($15 in chips) 
Seat 6: egvg3mTBBVzMHnJPIQiKcA ($14.15 in chips) 
Seat 7: eK8qa6EPcH2zhtbmWSvc9g ($27.85 in chips) 
Seat 8: OXPkK84/qv92EMwXPiG5rQ ($10 in chips) 
Seat 9: P+9ymZQ3ktpQu1bn7HIjew ($9.50 in chips) 
dtZ84flFEi4Q+SGrHMJRDQ: posts small blind $0.10
sD+TKtt36XiiN6jqHiLwDA: posts big blind $0.25
OXPkK84/qv92EMwXPiG5rQ: posts big blind $0.25
*** HOLE CARDS ***
gehe91e0IyVT0QU/XBkEyg: folds 
GrNTWMdwy+jC6Lred1eDng: folds 
egvg3mTBBVzMHnJPIQiKcA: calls $0.25
eK8qa6EPcH2zhtbmWSvc9g: folds 
OXPkK84/qv92EMwXPiG5rQ: checks 
P+9ymZQ3ktpQu1bn7HIjew: folds 
qwr38jl5txoR36M7G5qi4A: calls $0.25
dtZ84flFEi4Q+SGrHMJRDQ: folds 
sD+TKtt36XiiN6jqHiLwDA: checks 
*** FLOP *** [Js 8s 3h]
sD+TKtt36XiiN6jqHiLwDA: bets $1
egvg3mTBBVzMHnJPIQiKcA: folds 
OXPkK84/qv92EMwXPiG5rQ: folds 
qwr38jl5txoR36M7G5qi4A: calls $1
*** TURN *** [Js 8s 3h] [7h]
sD+TKtt36XiiN6jqHiLwDA: bets $1.25
qwr38jl5txoR36M7G5qi4A: calls $1.25
*** RIVER *** [Js 8s 3h 7h] [6s]
sD+TKtt36XiiN6jqHiLwDA: checks 
qwr38jl5txoR36M7G5qi4A: checks 
*** SHOW DOWN ***
sD+TKtt36XiiN6jqHiLwDA: shows [6h Jd] (two pair, Jacks and Sixes)
qwr38jl5txoR36M7G5qi4A: mucks hand 
sD+TKtt36XiiN6jqHiLwDA collected $5.35 from pot
*** SUMMARY ***
Total pot $5.60 | Rake $0.25 
Board [Js 8s 3h 7h 6s]
Seat 1: qwr38jl5txoR36M7G5qi4A (button) mucked
Seat 2: dtZ84flFEi4Q+SGrHMJRDQ (small blind) folded before Flop
Seat 3: sD+TKtt36XiiN6jqHiLwDA (big blind) showed [6h Jd] and won ($5.35) with two pair, Jacks and Sixes
Seat 4: gehe91e0IyVT0QU/XBkEyg folded before Flop (didn't bet)
Seat 5: GrNTWMdwy+jC6Lred1eDng folded before Flop (didn't bet)
Seat 6: egvg3mTBBVzMHnJPIQiKcA folded on the Flop
Seat 7: eK8qa6EPcH2zhtbmWSvc9g folded before Flop (didn't bet)
Seat 8: OXPkK84/qv92EMwXPiG5rQ folded on the Flop
Seat 9: P+9ymZQ3ktpQu1bn7HIjew folded before Flop (didn't bet)




PokerStars Game #59941722206:  Hold'em No Limit ($0.10/$0.25) - 2009/07/01 1:44:05 ET
Table 'pPgW4R3kdH26lLi1MnE92w' 9-max Seat #9 is the button
Seat 1: F4P6SxCNY4vxdb318G9RwA ($19.35 in chips) 
Seat 2: cZ99hugmLBj9KhTlc8nCSw ($27.50 in chips) 
Seat 3: WaS7+xnv4bIVHoru6nxczA ($13.75 in chips) 
Seat 4: 68iMVGMbYGvnpcCiPOVbbw ($4.65 in chips) 
Seat 5: HPEB+AtKw1+C/cxU0o1ciw ($22.25 in chips) 
Seat 6: VllYilcih0t+gMD4GTRlgQ ($25.40 in chips) 
Seat 7: sD+TKtt36XiiN6jqHiLwDA ($28.45 in chips) 
Seat 8: aCVg6cCxQcqClhB9nq/p1w ($29.95 in chips) 
Seat 9: tcbEu7VzyHQ+0lh+skbQhQ ($64 in chips) 
F4P6SxCNY4vxdb318G9RwA: posts small blind $0.10
cZ99hugmLBj9KhTlc8nCSw: posts big blind $0.25
*** HOLE CARDS ***
WaS7+xnv4bIVHoru6nxczA: folds 
68iMVGMbYGvnpcCiPOVbbw: folds 
HPEB+AtKw1+C/cxU0o1ciw: folds 
VllYilcih0t+gMD4GTRlgQ: folds 
sD+TKtt36XiiN6jqHiLwDA: calls $0.25
aCVg6cCxQcqClhB9nq/p1w: folds 
tcbEu7VzyHQ+0lh+skbQhQ: calls $0.25
F4P6SxCNY4vxdb318G9RwA: folds 
cZ99hugmLBj9KhTlc8nCSw: checks 
*** FLOP *** [6c Qs Kh]
68iMVGMbYGvnpcCiPOVbbw leaves the table
cZ99hugmLBj9KhTlc8nCSw: checks 
TsunLucky joins the table at seat #4 
sD+TKtt36XiiN6jqHiLwDA: checks 
tcbEu7VzyHQ+0lh+skbQhQ: checks 
*** TURN *** [6c Qs Kh] [5c]
cZ99hugmLBj9KhTlc8nCSw: checks 
sD+TKtt36XiiN6jqHiLwDA: checks 
tcbEu7VzyHQ+0lh+skbQhQ: checks 
*** RIVER *** [6c Qs Kh 5c] [9s]
cZ99hugmLBj9KhTlc8nCSw: checks 
sD+TKtt36XiiN6jqHiLwDA: checks 
tcbEu7VzyHQ+0lh+skbQhQ: checks 
*** SHOW DOWN ***
cZ99hugmLBj9KhTlc8nCSw: shows [7c 3d] (high card King)
sD+TKtt36XiiN6jqHiLwDA: shows [3h 3c] (a pair of Threes)
tcbEu7VzyHQ+0lh+skbQhQ: mucks hand 
sD+TKtt36XiiN6jqHiLwDA collected $0.85 from pot
*** SUMMARY ***
Total pot $0.85 | Rake $0 
Board [6c Qs Kh 5c 9s]
Seat 1: F4P6SxCNY4vxdb318G9RwA (small blind) folded before Flop
Seat 2: cZ99hugmLBj9KhTlc8nCSw (big blind) showed [7c 3d] and lost with high card King
Seat 3: WaS7+xnv4bIVHoru6nxczA folded before Flop (didn't bet)
Seat 4: 68iMVGMbYGvnpcCiPOVbbw folded before Flop (didn't bet)
Seat 5: HPEB+AtKw1+C/cxU0o1ciw folded before Flop (didn't bet)
Seat 6: VllYilcih0t+gMD4GTRlgQ folded before Flop (didn't bet)
Seat 7: sD+TKtt36XiiN6jqHiLwDA showed [3h 3c] and won ($0.85) with a pair of Threes
Seat 8: aCVg6cCxQcqClhB9nq/p1w folded before Flop (didn't bet)
Seat 9: tcbEu7VzyHQ+0lh+skbQhQ (button) mucked




PokerStars Game #59941722008:  Hold'em No Limit ($0.10/$0.25) - 2009/07/01 1:44:05 ET
Table '4mnXP0EWt9mMZYzTIVDQ0w' 9-max Seat #1 is the button
Seat 1: Z5y2J55JmfLYR6/DPAGHwQ ($25.85 in chips) 
Seat 2: BLEU2x2bnGRovIelAY6slA ($25.25 in chips) 
Seat 4: 9lvO/qyU+xrU95Teu1fv0g ($7 in chips) 
Seat 5: sSN8Y0AlsBeidZXPKmwXSw ($24.95 in chips) 
Seat 6: 5yjzPss7Y4kAWNDat3e0yQ ($29.10 in chips) 
Seat 7: OiV1PWZ3IkN29JlmCcnTwQ ($6.20 in chips) 
Seat 8: 9YN2IkT2JYYKFErZtZvCtA ($20 in chips) 
Seat 9: N/O9ADKpmqB2ASZuqgodlw ($4.75 in chips) 
BLEU2x2bnGRovIelAY6slA: posts small blind $0.10
9lvO/qyU+xrU95Teu1fv0g: posts big blind $0.25
*** HOLE CARDS ***
sSN8Y0AlsBeidZXPKmwXSw: folds 
5yjzPss7Y4kAWNDat3e0yQ: folds 
OiV1PWZ3IkN29JlmCcnTwQ: folds 
9YN2IkT2JYYKFErZtZvCtA: folds 
N/O9ADKpmqB2ASZuqgodlw: calls $0.25
Z5y2J55JmfLYR6/DPAGHwQ: raises $0.75 to $1
BLEU2x2bnGRovIelAY6slA: folds 
9lvO/qyU+xrU95Teu1fv0g: folds 
N/O9ADKpmqB2ASZuqgodlw: calls $0.75
*** FLOP *** [6c 6h 8h]
N/O9ADKpmqB2ASZuqgodlw: checks 
Z5y2J55JmfLYR6/DPAGHwQ: bets $2
N/O9ADKpmqB2ASZuqgodlw: calls $2
*** TURN *** [6c 6h 8h] [5s]
N/O9ADKpmqB2ASZuqgodlw: checks 
Z5y2J55JmfLYR6/DPAGHwQ: checks 
*** RIVER *** [6c 6h 8h 5s] [8s]
N/O9ADKpmqB2ASZuqgodlw: bets $1.75 and is all-in
Z5y2J55JmfLYR6/DPAGHwQ: calls $1.75
*** SHOW DOWN ***
N/O9ADKpmqB2ASZuqgodlw: shows [Ts 6s] (a full house, Sixes full of Eights)
Z5y2J55JmfLYR6/DPAGHwQ: mucks hand 
N/O9ADKpmqB2ASZuqgodlw collected $9.40 from pot
*** SUMMARY ***
Total pot $9.85 | Rake $0.45 
Board [6c 6h 8h 5s 8s]
Seat 1: Z5y2J55JmfLYR6/DPAGHwQ (button) mucked
Seat 2: BLEU2x2bnGRovIelAY6slA (small blind) folded before Flop
Seat 4: 9lvO/qyU+xrU95Teu1fv0g (big blind) folded before Flop
Seat 5: sSN8Y0AlsBeidZXPKmwXSw folded before Flop (didn't bet)
Seat 6: 5yjzPss7Y4kAWNDat3e0yQ folded before Flop (didn't bet)
Seat 7: OiV1PWZ3IkN29JlmCcnTwQ folded before Flop (didn't bet)
Seat 8: 9YN2IkT2JYYKFErZtZvCtA folded before Flop (didn't bet)
Seat 9: N/O9ADKpmqB2ASZuqgodlw showed [Ts 6s] and won ($9.40) with a full house, Sixes full of Eights




PokerStars Game #59941722270:  Hold'em No Limit ($0.10/$0.25) - 2009/07/01 1:44:05 ET
Table 'AJGgX1ZYM8d68SWMvaLttg' 6-max Seat #4 is the button
Seat 2: zHHLkD2sRljslKKeQv/ZQw ($29.85 in chips) 
Seat 3: 8ClCHtFXGNplITm+63KB+Q ($36.85 in chips) 
Seat 4: Lz/GjRDgmgepqTR7qmS86w ($25.05 in chips) 
Seat 5: Hsvkc0/G2VV78oVmWYXecw ($5.10 in chips) 
Seat 6: UA5OsKS3VPaxa7uC8La/kA ($63.40 in chips) 
Hsvkc0/G2VV78oVmWYXecw: posts small blind $0.10
UA5OsKS3VPaxa7uC8La/kA: posts big blind $0.25
*** HOLE CARDS ***
zHHLkD2sRljslKKeQv/ZQw: calls $0.25
8ClCHtFXGNplITm+63KB+Q: raises $0.75 to $1
Lz/GjRDgmgepqTR7qmS86w: calls $1
Hsvkc0/G2VV78oVmWYXecw: folds 
UA5OsKS3VPaxa7uC8La/kA: folds 
zHHLkD2sRljslKKeQv/ZQw: calls $0.75
*** FLOP *** [6s 4c Kc]
zHHLkD2sRljslKKeQv/ZQw: checks 
8ClCHtFXGNplITm+63KB+Q: bets $2.50
Lz/GjRDgmgepqTR7qmS86w: folds 
zHHLkD2sRljslKKeQv/ZQw: folds 
Uncalled bet ($2.50) returned to 8ClCHtFXGNplITm+63KB+Q
8ClCHtFXGNplITm+63KB+Q collected $3.20 from pot
8ClCHtFXGNplITm+63KB+Q: doesn't show hand 
*** SUMMARY ***
Total pot $3.35 | Rake $0.15 
Board [6s 4c Kc]
Seat 2: zHHLkD2sRljslKKeQv/ZQw folded on the Flop
Seat 3: 8ClCHtFXGNplITm+63KB+Q collected ($3.20)
Seat 4: Lz/GjRDgmgepqTR7qmS86w (button) folded on the Flop
Seat 5: Hsvkc0/G2VV78oVmWYXecw (small blind) folded before Flop
Seat 6: UA5OsKS3VPaxa7uC8La/kA (big blind) folded before Flop




PokerStars Game #59941721896:  Hold'em No Limit ($0.10/$0.25) - 2009/07/01 1:44:05 ET
Table 'zKwHJD0cmKNUure9qQTfFg' 6-max Seat #1 is the button
Seat 1: Hzrn9DZJegEZICufTNYkrg ($19.45 in chips) 
Seat 2: xrf8tAXKQHG99HixCot1Iw ($24.80 in chips) 
Seat 3: m9aw7LBAB5YX2ZqMtMkhqA ($15 in chips) 
Seat 4: v+QfkGiuj9bgtuNoVnDO8w ($25.80 in chips) 
Seat 5: E4AqQ1egsnu0oH2RqsbCmQ ($3.80 in chips) 
Seat 6: edio/rLJ06xeZOfLhoL3UA ($3.85 in chips) 
xrf8tAXKQHG99HixCot1Iw: posts small blind $0.10
m9aw7LBAB5YX2ZqMtMkhqA: posts big blind $0.25
*** HOLE CARDS ***
v+QfkGiuj9bgtuNoVnDO8w: folds 
E4AqQ1egsnu0oH2RqsbCmQ: folds 
edio/rLJ06xeZOfLhoL3UA: folds 
Hzrn9DZJegEZICufTNYkrg: calls $0.25
xrf8tAXKQHG99HixCot1Iw: calls $0.15
m9aw7LBAB5YX2ZqMtMkhqA: checks 
*** FLOP *** [4h 3c Ks]
xrf8tAXKQHG99HixCot1Iw: checks 
m9aw7LBAB5YX2ZqMtMkhqA: checks 
Hzrn9DZJegEZICufTNYkrg: bets $0.50
xrf8tAXKQHG99HixCot1Iw: folds 
m9aw7LBAB5YX2ZqMtMkhqA: calls $0.50
*** TURN *** [4h 3c Ks] [Ah]
m9aw7LBAB5YX2ZqMtMkhqA: bets $0.75
Hzrn9DZJegEZICufTNYkrg: folds 
Uncalled bet ($0.75) returned to m9aw7LBAB5YX2ZqMtMkhqA
m9aw7LBAB5YX2ZqMtMkhqA collected $1.70 from pot
m9aw7LBAB5YX2ZqMtMkhqA: doesn't show hand 
*** SUMMARY ***
Total pot $1.75 | Rake $0.05 
Board [4h 3c Ks Ah]
Seat 1: Hzrn9DZJegEZICufTNYkrg (button) folded on the Turn
Seat 2: xrf8tAXKQHG99HixCot1Iw (small blind) folded on the Flop
Seat 3: m9aw7LBAB5YX2ZqMtMkhqA (big blind) collected ($1.70)
Seat 4: v+QfkGiuj9bgtuNoVnDO8w folded before Flop (didn't bet)
Seat 5: E4AqQ1egsnu0oH2RqsbCmQ folded before Flop (didn't bet)
Seat 6: edio/rLJ06xeZOfLhoL3UA folded before Flop (didn't bet)




PokerStars Game #59941722872:  Hold'em No Limit ($0.10/$0.25) - 2009/07/01 1:44:06 ET
Table 'FuFyQHmlO/QqQp//rDRrPg' 6-max Seat #2 is the button
Seat 1: jp34e617tIzV8tKIWmfAbA ($27.40 in chips) 
Seat 2: G3h3THGB1j3qdHDVHpnJWg ($30.40 in chips) 
Seat 3: EeUZtMU058v2ObUACOF4Og ($30.35 in chips) 
Seat 4: Ahsa9Yk5NPmCqQstq1EoQA ($23.70 in chips) 
Seat 5: xrf8tAXKQHG99HixCot1Iw ($25.60 in chips) 
Seat 6: 6DwBRH+xZ12AAZmeAg+aXw ($49.55 in chips) 
EeUZtMU058v2ObUACOF4Og: posts small blind $0.10
Ahsa9Yk5NPmCqQstq1EoQA: posts big blind $0.25
*** HOLE CARDS ***
xrf8tAXKQHG99HixCot1Iw: folds 
6DwBRH+xZ12AAZmeAg+aXw: folds 
jp34e617tIzV8tKIWmfAbA: folds 
G3h3THGB1j3qdHDVHpnJWg: calls $0.25
EeUZtMU058v2ObUACOF4Og: calls $0.15
Ahsa9Yk5NPmCqQstq1EoQA: checks 
*** FLOP *** [3h Tc 8c]
EeUZtMU058v2ObUACOF4Og: checks 
Ahsa9Yk5NPmCqQstq1EoQA: bets $0.25
G3h3THGB1j3qdHDVHpnJWg: calls $0.25
EeUZtMU058v2ObUACOF4Og: calls $0.25
*** TURN *** [3h Tc 8c] [Qd]
EeUZtMU058v2ObUACOF4Og: checks 
Ahsa9Yk5NPmCqQstq1EoQA: checks 
G3h3THGB1j3qdHDVHpnJWg: bets $1.50
EeUZtMU058v2ObUACOF4Og: folds 
Ahsa9Yk5NPmCqQstq1EoQA: folds 
Uncalled bet ($1.50) returned to G3h3THGB1j3qdHDVHpnJWg
G3h3THGB1j3qdHDVHpnJWg collected $1.45 from pot
*** SUMMARY ***
Total pot $1.50 | Rake $0.05 
Board [3h Tc 8c Qd]
Seat 1: jp34e617tIzV8tKIWmfAbA folded before Flop (didn't bet)
Seat 2: G3h3THGB1j3qdHDVHpnJWg (button) collected ($1.45)
Seat 3: EeUZtMU058v2ObUACOF4Og (small blind) folded on the Turn
Seat 4: Ahsa9Yk5NPmCqQstq1EoQA (big blind) folded on the Turn
Seat 5: xrf8tAXKQHG99HixCot1Iw folded before Flop (didn't bet)
Seat 6: 6DwBRH+xZ12AAZmeAg+aXw folded before Flop (didn't bet)




PokerStars Game #59941722918:  Hold'em No Limit ($0.10/$0.25) - 2009/07/01 1:44:06 ET
Table '4XGDnEByOol5up4aB2KbJw' 6-max Seat #1 is the button
Seat 1: kyRaCIljYA6l33lSKQfNsg ($26.50 in chips) 
Seat 2: SFmT9ZsVopnukjvAzrxTRg ($44.95 in chips) 
Seat 3: LtASJ9OlkqGrrUKGQlpGAw ($20.55 in chips) 
Seat 4: BV+K0Phf5VBHr7aZPKqbUQ ($25.75 in chips) 
Seat 5: Dh01+rohD2p9pXLYeBlC5Q ($16.75 in chips) 
Seat 6: a7Ux7aERFGCbT/L3ojVfAg ($9 in chips) 
SFmT9ZsVopnukjvAzrxTRg: posts small blind $0.10
LtASJ9OlkqGrrUKGQlpGAw: posts big blind $0.25
*** HOLE CARDS ***
BV+K0Phf5VBHr7aZPKqbUQ: folds 
Dh01+rohD2p9pXLYeBlC5Q: calls $0.25
a7Ux7aERFGCbT/L3ojVfAg: calls $0.25
kyRaCIljYA6l33lSKQfNsg: folds 
SFmT9ZsVopnukjvAzrxTRg: folds 
LtASJ9OlkqGrrUKGQlpGAw: checks 
*** FLOP *** [2c 2s Ts]
LtASJ9OlkqGrrUKGQlpGAw: checks 
Dh01+rohD2p9pXLYeBlC5Q: checks 
a7Ux7aERFGCbT/L3ojVfAg: checks 
*** TURN *** [2c 2s Ts] [Jh]
LtASJ9OlkqGrrUKGQlpGAw: checks 
Dh01+rohD2p9pXLYeBlC5Q: checks 
a7Ux7aERFGCbT/L3ojVfAg: checks 
*** RIVER *** [2c 2s Ts Jh] [3c]
LtASJ9OlkqGrrUKGQlpGAw: checks 
Dh01+rohD2p9pXLYeBlC5Q: checks 
a7Ux7aERFGCbT/L3ojVfAg: checks 
*** SHOW DOWN ***
LtASJ9OlkqGrrUKGQlpGAw: shows [7d As] (a pair of Deuces)
Dh01+rohD2p9pXLYeBlC5Q: mucks hand 
a7Ux7aERFGCbT/L3ojVfAg: mucks hand 
LtASJ9OlkqGrrUKGQlpGAw collected $0.85 from pot
*** SUMMARY ***
Total pot $0.85 | Rake $0 
Board [2c 2s Ts Jh 3c]
Seat 1: kyRaCIljYA6l33lSKQfNsg (button) folded before Flop (didn't bet)
Seat 2: SFmT9ZsVopnukjvAzrxTRg (small blind) folded before Flop
Seat 3: LtASJ9OlkqGrrUKGQlpGAw (big blind) showed [7d As] and won ($0.85) with a pair of Deuces
Seat 4: BV+K0Phf5VBHr7aZPKqbUQ folded before Flop (didn't bet)
Seat 5: Dh01+rohD2p9pXLYeBlC5Q mucked
Seat 6: a7Ux7aERFGCbT/L3ojVfAg mucked




PokerStars Game #59941722494:  Hold'em No Limit ($0.10/$0.25) - 2009/07/01 1:44:06 ET
Table '6wawJ+MkkvuC3coG6r+Yhg' 6-max Seat #6 is the button
Seat 1: JQZew0FjzS19kTjeNtrE+A ($28.35 in chips) 
Seat 2: LtASJ9OlkqGrrUKGQlpGAw ($34.65 in chips) 
Seat 3: 3zD3qLXT1bEffAoWGnc7wg ($58.75 in chips) 
Seat 4: yxmjNFGiKI3b+XQGJzJVIg ($28.30 in chips) 
Seat 5: FZrgDbxAanC1xwZxXHJKVA ($2.85 in chips) 
Seat 6: B3X187C0tXFUfQpCu8pe8A ($26.75 in chips) 
JQZew0FjzS19kTjeNtrE+A: posts small blind $0.10
LtASJ9OlkqGrrUKGQlpGAw: posts big blind $0.25
*** HOLE CARDS ***
3zD3qLXT1bEffAoWGnc7wg: folds 
yxmjNFGiKI3b+XQGJzJVIg: folds 
FZrgDbxAanC1xwZxXHJKVA: raises $0.25 to $0.50
B3X187C0tXFUfQpCu8pe8A: folds 
JQZew0FjzS19kTjeNtrE+A: folds 
LtASJ9OlkqGrrUKGQlpGAw: folds 
Uncalled bet ($0.25) returned to FZrgDbxAanC1xwZxXHJKVA
FZrgDbxAanC1xwZxXHJKVA collected $0.60 from pot
*** SUMMARY ***
Total pot $0.60 | Rake $0 
Seat 1: JQZew0FjzS19kTjeNtrE+A (small blind) folded before Flop
Seat 2: LtASJ9OlkqGrrUKGQlpGAw (big blind) folded before Flop
Seat 3: 3zD3qLXT1bEffAoWGnc7wg folded before Flop (didn't bet)
Seat 4: yxmjNFGiKI3b+XQGJzJVIg folded before Flop (didn't bet)
Seat 5: FZrgDbxAanC1xwZxXHJKVA collected ($0.60)
Seat 6: B3X187C0tXFUfQpCu8pe8A (button) folded before Flop (didn't bet)




PokerStars Game #59941722452:  Hold'em No Limit ($0.10/$0.25) - 2009/07/01 1:44:06 ET
Table '8PD/MTROSMd6Y8mZeykbpg' 6-max Seat #5 is the button
Seat 1: fxNpaToxECtD2Goelmg9vA ($25.10 in chips) 
Seat 2: 4TM16KVgEiQpLi4bVVWbVQ ($24.25 in chips) 
Seat 3: vqWjZmdQu/Hxw96/IJTWdQ ($25.25 in chips) 
Seat 4: DFi/Lzkjsfv8QswS80JX9Q ($53.70 in chips) 
Seat 5: z3tQwy28dp5FykDJC/wzQw ($25.60 in chips) 
Seat 6: trN/oHqTTbPw5MNuKrOpLw ($25.80 in chips) 
trN/oHqTTbPw5MNuKrOpLw: posts small blind $0.10
fxNpaToxECtD2Goelmg9vA: posts big blind $0.25
*** HOLE CARDS ***
4TM16KVgEiQpLi4bVVWbVQ: calls $0.25
vqWjZmdQu/Hxw96/IJTWdQ: raises $0.50 to $0.75
DFi/Lzkjsfv8QswS80JX9Q: folds 
z3tQwy28dp5FykDJC/wzQw: folds 
trN/oHqTTbPw5MNuKrOpLw: folds 
fxNpaToxECtD2Goelmg9vA: calls $0.50
4TM16KVgEiQpLi4bVVWbVQ: calls $0.50
*** FLOP *** [Tc Kc 2s]
fxNpaToxECtD2Goelmg9vA: bets $0.75
4TM16KVgEiQpLi4bVVWbVQ: folds 
vqWjZmdQu/Hxw96/IJTWdQ: calls $0.75
*** TURN *** [Tc Kc 2s] [Js]
fxNpaToxECtD2Goelmg9vA: bets $0.75
vqWjZmdQu/Hxw96/IJTWdQ: calls $0.75
*** RIVER *** [Tc Kc 2s Js] [5d]
fxNpaToxECtD2Goelmg9vA: bets $1.25
vqWjZmdQu/Hxw96/IJTWdQ: calls $1.25
*** SHOW DOWN ***
fxNpaToxECtD2Goelmg9vA: shows [Jd Ks] (two pair, Kings and Jacks)
vqWjZmdQu/Hxw96/IJTWdQ: mucks hand 
fxNpaToxECtD2Goelmg9vA collected $7.50 from pot
*** SUMMARY ***
Total pot $7.85 | Rake $0.35 
Board [Tc Kc 2s Js 5d]
Seat 1: fxNpaToxECtD2Goelmg9vA (big blind) showed [Jd Ks] and won ($7.50) with two pair, Kings and Jacks
Seat 2: 4TM16KVgEiQpLi4bVVWbVQ folded on the Flop
Seat 3: vqWjZmdQu/Hxw96/IJTWdQ mucked
Seat 4: DFi/Lzkjsfv8QswS80JX9Q folded before Flop (didn't bet)
Seat 5: z3tQwy28dp5FykDJC/wzQw (button) folded before Flop (didn't bet)
Seat 6: trN/oHqTTbPw5MNuKrOpLw (small blind) folded before Flop




PokerStars Game #59941722514:  Hold'em No Limit ($0.10/$0.25) - 2009/07/01 1:44:06 ET
Table 'YONIZZNvg4uZ4xNUO1deeA' 6-max Seat #4 is the button
Seat 1: GbCVUNssQ7mqsPWr7J4d3w ($5 in chips) 
Seat 2: evMMX/0gSDH791KdSAOaSg ($18.20 in chips) 
Seat 3: Eksrep3hySi2jeDHuaWiOQ ($10.65 in chips) 
Seat 4: oNAHfBJOUelvVhf0IDMJUA ($12.55 in chips) 
Seat 5: if4dh6jhJXeN3/qd3qCp9g ($25.10 in chips) 
Seat 6: eL3+wCBjFGfQ5FMdIZihwA ($25 in chips) 
if4dh6jhJXeN3/qd3qCp9g: posts small blind $0.10
eL3+wCBjFGfQ5FMdIZihwA: posts big blind $0.25
*** HOLE CARDS ***
GbCVUNssQ7mqsPWr7J4d3w: folds 
evMMX/0gSDH791KdSAOaSg: raises $0.75 to $1
Eksrep3hySi2jeDHuaWiOQ: folds 
oNAHfBJOUelvVhf0IDMJUA: calls $1
if4dh6jhJXeN3/qd3qCp9g: folds 
eL3+wCBjFGfQ5FMdIZihwA: raises $3 to $4
evMMX/0gSDH791KdSAOaSg: folds 
oNAHfBJOUelvVhf0IDMJUA: folds 
Uncalled bet ($3) returned to eL3+wCBjFGfQ5FMdIZihwA
eL3+wCBjFGfQ5FMdIZihwA collected $3.10 from pot
*** SUMMARY ***
Total pot $3.10 | Rake $0 
Seat 1: GbCVUNssQ7mqsPWr7J4d3w folded before Flop (didn't bet)
Seat 2: evMMX/0gSDH791KdSAOaSg folded before Flop
Seat 3: Eksrep3hySi2jeDHuaWiOQ folded before Flop (didn't bet)
Seat 4: oNAHfBJOUelvVhf0IDMJUA (button) folded before Flop
Seat 5: if4dh6jhJXeN3/qd3qCp9g (small blind) folded before Flop
Seat 6: eL3+wCBjFGfQ5FMdIZihwA (big blind) collected ($3.10)




PokerStars Game #59941722598:  Hold'em No Limit ($0.10/$0.25) - 2009/07/01 1:44:06 ET
Table 'o0CDOvKO/bn1WjeymDrXfA' 6-max Seat #2 is the button
Seat 1: if4dh6jhJXeN3/qd3qCp9g ($24.65 in chips) 
Seat 2: uAJL+E2git8iAiFyAvVOnw ($5.85 in chips) 
Seat 3: OtVWmpxX2/9L8bb1GSKTuA ($17 in chips) 
Seat 4: L3/N/gliETan8N5Gim5h4Q ($25 in chips) 
Seat 5: dOIoLBxmpLHSXBN9LZnf0Q ($41.25 in chips) 
Seat 6: SS/yfeArhULzIcOPe8MdPg ($25 in chips) 
OtVWmpxX2/9L8bb1GSKTuA: posts small blind $0.10
L3/N/gliETan8N5Gim5h4Q: posts big blind $0.25
*** HOLE CARDS ***
dOIoLBxmpLHSXBN9LZnf0Q: calls $0.25
SS/yfeArhULzIcOPe8MdPg: folds 
if4dh6jhJXeN3/qd3qCp9g: folds 
uAJL+E2git8iAiFyAvVOnw: folds 
OtVWmpxX2/9L8bb1GSKTuA: raises $1 to $1.25
L3/N/gliETan8N5Gim5h4Q: folds 
dOIoLBxmpLHSXBN9LZnf0Q: calls $1
*** FLOP *** [7h 2h 7c]
OtVWmpxX2/9L8bb1GSKTuA: bets $1.50
dOIoLBxmpLHSXBN9LZnf0Q: folds 
Uncalled bet ($1.50) returned to OtVWmpxX2/9L8bb1GSKTuA
OtVWmpxX2/9L8bb1GSKTuA collected $2.65 from pot
OtVWmpxX2/9L8bb1GSKTuA: doesn't show hand 
*** SUMMARY ***
Total pot $2.75 | Rake $0.10 
Board [7h 2h 7c]
Seat 1: if4dh6jhJXeN3/qd3qCp9g folded before Flop (didn't bet)
Seat 2: uAJL+E2git8iAiFyAvVOnw (button) folded before Flop (didn't bet)
Seat 3: OtVWmpxX2/9L8bb1GSKTuA (small blind) collected ($2.65)
Seat 4: L3/N/gliETan8N5Gim5h4Q (big blind) folded before Flop
Seat 5: dOIoLBxmpLHSXBN9LZnf0Q folded on the Flop
Seat 6: SS/yfeArhULzIcOPe8MdPg folded before Flop (didn't bet)




PokerStars Game #59941722774:  Hold'em No Limit ($0.10/$0.25) - 2009/07/01 1:44:06 ET
Table '8Z6T3ssCpo3VV849U4RgBw' 9-max Seat #9 is the button
Seat 1: Z9W7+g1WMhhZDi7DwGbCFA ($6.25 in chips) 
Seat 2: SpiiQQAzy4MUgV3I5W8giw ($25.35 in chips) 
Seat 3: tLcDklc2rBORNfixyRfVfw ($41.50 in chips) 
Seat 4: RCqMONFrSPSArZh2Jsar/w ($18.90 in chips) 
Seat 6: sGFnnRCa1YAHAUmWgsW6Qg ($10 in chips) 
Seat 7: oLa/tXLfSLLB28mcLGrxcg ($24.05 in chips) 
Seat 8: PdIasPkzm2sqZnN41ZRXOg ($5.25 in chips) 
Seat 9: HDDm1BkZtdsRyw2DJdqq6A ($21.45 in chips) 
Z9W7+g1WMhhZDi7DwGbCFA: posts small blind $0.10
SpiiQQAzy4MUgV3I5W8giw: posts big blind $0.25
*** HOLE CARDS ***
tLcDklc2rBORNfixyRfVfw: folds 
RCqMONFrSPSArZh2Jsar/w: folds 
sGFnnRCa1YAHAUmWgsW6Qg: folds 
oLa/tXLfSLLB28mcLGrxcg: folds 
PdIasPkzm2sqZnN41ZRXOg: folds 
HDDm1BkZtdsRyw2DJdqq6A: calls $0.25
Z9W7+g1WMhhZDi7DwGbCFA: folds 
SpiiQQAzy4MUgV3I5W8giw: checks 
*** FLOP *** [As 7s 3h]
SpiiQQAzy4MUgV3I5W8giw: checks 
HDDm1BkZtdsRyw2DJdqq6A: checks 
*** TURN *** [As 7s 3h] [Td]
SpiiQQAzy4MUgV3I5W8giw: bets $0.50
HDDm1BkZtdsRyw2DJdqq6A: calls $0.50
*** RIVER *** [As 7s 3h Td] [6h]
SpiiQQAzy4MUgV3I5W8giw: checks 
HDDm1BkZtdsRyw2DJdqq6A: bets $0.50
SpiiQQAzy4MUgV3I5W8giw: calls $0.50
*** SHOW DOWN ***
HDDm1BkZtdsRyw2DJdqq6A: shows [Ah Ks] (a pair of Aces)
SpiiQQAzy4MUgV3I5W8giw: mucks hand 
HDDm1BkZtdsRyw2DJdqq6A collected $2.50 from pot
*** SUMMARY ***
Total pot $2.60 | Rake $0.10 
Board [As 7s 3h Td 6h]
Seat 1: Z9W7+g1WMhhZDi7DwGbCFA (small blind) folded before Flop
Seat 2: SpiiQQAzy4MUgV3I5W8giw (big blind) mucked
Seat 3: tLcDklc2rBORNfixyRfVfw folded before Flop (didn't bet)
Seat 4: RCqMONFrSPSArZh2Jsar/w folded before Flop (didn't bet)
Seat 6: sGFnnRCa1YAHAUmWgsW6Qg folded before Flop (didn't bet)
Seat 7: oLa/tXLfSLLB28mcLGrxcg folded before Flop (didn't bet)
Seat 8: PdIasPkzm2sqZnN41ZRXOg folded before Flop (didn't bet)
Seat 9: HDDm1BkZtdsRyw2DJdqq6A (button) showed [Ah Ks] and won ($2.50) with a pair of Aces




PokerStars Game #59941722490:  Hold'em No Limit ($0.10/$0.25) - 2009/07/01 1:44:06 ET
Table 'IIO2q2znuuAXmiZ2qFTcmg' 6-max Seat #3 is the button
Seat 2: cS21pIxRHx5Gt42o7hPZzw ($24.80 in chips) 
Seat 3: L3/N/gliETan8N5Gim5h4Q ($25 in chips) 
Seat 4: tSR4329m40dZsN7YOpI9Kw ($58.25 in chips) 
Seat 5: 9U3ZKjCsarN0DjR6mSE8Ug ($14 in chips) 
Seat 6: aogAb4Eienxztk8p2v9VVw ($37.10 in chips) 
tSR4329m40dZsN7YOpI9Kw: posts small blind $0.10
9U3ZKjCsarN0DjR6mSE8Ug: posts big blind $0.25
*** HOLE CARDS ***
aogAb4Eienxztk8p2v9VVw: folds 
cS21pIxRHx5Gt42o7hPZzw: folds 
L3/N/gliETan8N5Gim5h4Q: folds 
tSR4329m40dZsN7YOpI9Kw: raises $0.50 to $0.75
9U3ZKjCsarN0DjR6mSE8Ug: calls $0.50
*** FLOP *** [Kc 7s Th]
tSR4329m40dZsN7YOpI9Kw: bets $1
9U3ZKjCsarN0DjR6mSE8Ug: calls $1
*** TURN *** [Kc 7s Th] [Ac]
tSR4329m40dZsN7YOpI9Kw: checks 
9U3ZKjCsarN0DjR6mSE8Ug: bets $2
tSR4329m40dZsN7YOpI9Kw: folds 
Uncalled bet ($2) returned to 9U3ZKjCsarN0DjR6mSE8Ug
9U3ZKjCsarN0DjR6mSE8Ug collected $3.35 from pot
9U3ZKjCsarN0DjR6mSE8Ug: doesn't show hand 
*** SUMMARY ***
Total pot $3.50 | Rake $0.15 
Board [Kc 7s Th Ac]
Seat 2: cS21pIxRHx5Gt42o7hPZzw folded before Flop (didn't bet)
Seat 3: L3/N/gliETan8N5Gim5h4Q (button) folded before Flop (didn't bet)
Seat 4: tSR4329m40dZsN7YOpI9Kw (small blind) folded on the Turn
Seat 5: 9U3ZKjCsarN0DjR6mSE8Ug (big blind) collected ($3.35)
Seat 6: aogAb4Eienxztk8p2v9VVw folded before Flop (didn't bet)




PokerStars Game #59941722806:  Hold'em No Limit ($0.10/$0.25) - 2009/07/01 1:44:06 ET
Table 'MiquQrQZJJq9ZtgRIp9HFQ' 6-max Seat #5 is the button
Seat 1: c3J/KYZ4cNsUEuz8v57I5A ($25.05 in chips) 
Seat 4: wAKC8C/zN0c8V5v13dm9mA ($57.95 in chips) 
Seat 5: iyZxqznXjv3vtvOJymkoLQ ($26.75 in chips) 
Seat 6: GbCVUNssQ7mqsPWr7J4d3w ($5.10 in chips) 
GbCVUNssQ7mqsPWr7J4d3w: posts small blind $0.10
c3J/KYZ4cNsUEuz8v57I5A: posts big blind $0.25
2+6voGl1T1DO63JePptI3g: sits out 
*** HOLE CARDS ***
9h7TNZ1TDGRUJXA6rI+ZTw joins the table at seat #3 
wAKC8C/zN0c8V5v13dm9mA: raises $0.75 to $1
iyZxqznXjv3vtvOJymkoLQ: folds 
GbCVUNssQ7mqsPWr7J4d3w: folds 
c3J/KYZ4cNsUEuz8v57I5A: folds 
Uncalled bet ($0.75) returned to wAKC8C/zN0c8V5v13dm9mA
wAKC8C/zN0c8V5v13dm9mA collected $0.60 from pot
*** SUMMARY ***
Total pot $0.60 | Rake $0 
Seat 1: c3J/KYZ4cNsUEuz8v57I5A (big blind) folded before Flop
Seat 4: wAKC8C/zN0c8V5v13dm9mA collected ($0.60)
Seat 5: iyZxqznXjv3vtvOJymkoLQ (button) folded before Flop (didn't bet)
Seat 6: GbCVUNssQ7mqsPWr7J4d3w (small blind) folded before Flop




PokerStars Game #59941722456:  Hold'em No Limit ($0.10/$0.25) - 2009/07/01 1:44:06 ET
Table 'v+LTGPWbrLum+Ggd4ef6lg' 9-max Seat #7 is the button
Seat 1: zUXhymECc2C9W9ZNw6qppA ($9.65 in chips) 
Seat 2: r/xYbgD9yVdKFWRgSQD/+Q ($11.20 in chips) 
Seat 3: 7ovWM9c1nQLTFritEGRG/A ($3.25 in chips) 
Seat 4: bXpVeaSTPBFSPJmeXxO7nw ($9.05 in chips) 
Seat 5: +8OkYWUhGfkDbAtQl/ovYQ ($31.55 in chips) 
Seat 6: T+MjFnaPZsOyKbE9LYG2Qg ($22.85 in chips) 
Seat 7: kUxTO3D2eQcx4oJIpJAK4Q ($7.35 in chips) 
Seat 8: +sbyWwIcFp9kP0bDtMegfQ ($32.35 in chips) 
Seat 9: cZ99hugmLBj9KhTlc8nCSw ($25 in chips) 
+sbyWwIcFp9kP0bDtMegfQ: posts small blind $0.10
cZ99hugmLBj9KhTlc8nCSw: posts big blind $0.25
*** HOLE CARDS ***
zUXhymECc2C9W9ZNw6qppA: folds 
r/xYbgD9yVdKFWRgSQD/+Q: folds 
+8OkYWUhGfkDbAtQl/ovYQ said, "wird call"
cZ99hugmLBj9KhTlc8nCSw said, "contras"
7ovWM9c1nQLTFritEGRG/A: raises $3 to $3.25 and is all-in
bXpVeaSTPBFSPJmeXxO7nw: folds 
+8OkYWUhGfkDbAtQl/ovYQ: folds 
T+MjFnaPZsOyKbE9LYG2Qg: folds 
T+MjFnaPZsOyKbE9LYG2Qg leaves the table
+qc/EYCgLC65SpGvr35eNg joins the table at seat #6 
kUxTO3D2eQcx4oJIpJAK4Q: folds 
+sbyWwIcFp9kP0bDtMegfQ: folds 
cZ99hugmLBj9KhTlc8nCSw: folds 
Uncalled bet ($3) returned to 7ovWM9c1nQLTFritEGRG/A
7ovWM9c1nQLTFritEGRG/A collected $0.60 from pot
7ovWM9c1nQLTFritEGRG/A: doesn't show hand 
*** SUMMARY ***
Total pot $0.60 | Rake $0 
Seat 1: zUXhymECc2C9W9ZNw6qppA folded before Flop (didn't bet)
Seat 2: r/xYbgD9yVdKFWRgSQD/+Q folded before Flop (didn't bet)
Seat 3: 7ovWM9c1nQLTFritEGRG/A collected ($0.60)
Seat 4: bXpVeaSTPBFSPJmeXxO7nw folded before Flop (didn't bet)
Seat 5: +8OkYWUhGfkDbAtQl/ovYQ folded before Flop (didn't bet)
Seat 6: T+MjFnaPZsOyKbE9LYG2Qg folded before Flop (didn't bet)
Seat 7: kUxTO3D2eQcx4oJIpJAK4Q (button) folded before Flop (didn't bet)
Seat 8: +sbyWwIcFp9kP0bDtMegfQ (small blind) folded before Flop
Seat 9: cZ99hugmLBj9KhTlc8nCSw (big blind) folded before Flop




PokerStars Game #59941723280:  Hold'em No Limit ($0.10/$0.25) - 2009/07/01 1:44:07 ET
Table '972HGIb0tQN/zRIK4TABEw' 9-max Seat #3 is the button
Seat 1: fHr2+mGa0RFK3qrpZcVUAQ ($6.85 in chips) 
Seat 2: lc6GpYOW7MM4G+/65wMxXA ($11.75 in chips) 
Seat 3: aNpwfA31EREwO+ar4XzBCw ($25 in chips) 
Seat 4: Bb42QRQMhg5/Y0vHP8/2Xw ($25 in chips) 
Seat 5: swK30YlQuxRQO7QFr4ZxCA ($19.30 in chips) 
Seat 6: aLYacoAY3e5d/M5ToF8Ujw ($16.90 in chips) 
Seat 7: qS+jfnNoG75bT+uQ8CKhQA ($14.75 in chips) 
Seat 8: sGFnnRCa1YAHAUmWgsW6Qg ($8.80 in chips) 
Seat 9: 3PmVnC/15cl4oyI1TKIt4g ($3.95 in chips) 
Bb42QRQMhg5/Y0vHP8/2Xw: posts small blind $0.10
swK30YlQuxRQO7QFr4ZxCA: posts big blind $0.25
*** HOLE CARDS ***
aLYacoAY3e5d/M5ToF8Ujw: raises $0.25 to $0.50
qS+jfnNoG75bT+uQ8CKhQA: folds 
sGFnnRCa1YAHAUmWgsW6Qg: folds 
3PmVnC/15cl4oyI1TKIt4g: folds 
fHr2+mGa0RFK3qrpZcVUAQ: folds 
lc6GpYOW7MM4G+/65wMxXA: calls $0.50
aNpwfA31EREwO+ar4XzBCw: folds 
Bb42QRQMhg5/Y0vHP8/2Xw: folds 
swK30YlQuxRQO7QFr4ZxCA: calls $0.25
*** FLOP *** [Js 6s 7c]
swK30YlQuxRQO7QFr4ZxCA: checks 
aLYacoAY3e5d/M5ToF8Ujw: bets $2
lc6GpYOW7MM4G+/65wMxXA: calls $2
swK30YlQuxRQO7QFr4ZxCA: calls $2
*** TURN *** [Js 6s 7c] [6h]
swK30YlQuxRQO7QFr4ZxCA: checks 
aLYacoAY3e5d/M5ToF8Ujw: checks 
lc6GpYOW7MM4G+/65wMxXA: bets $3.25
swK30YlQuxRQO7QFr4ZxCA: calls $3.25
aLYacoAY3e5d/M5ToF8Ujw: raises $11.15 to $14.40 and is all-in
lc6GpYOW7MM4G+/65wMxXA: calls $6 and is all-in
swK30YlQuxRQO7QFr4ZxCA: calls $11.15
*** RIVER *** [Js 6s 7c 6h] [3c]
*** SHOW DOWN ***
swK30YlQuxRQO7QFr4ZxCA: shows [7s 7h] (a full house, Sevens full of Sixes)
aLYacoAY3e5d/M5ToF8Ujw: mucks hand 
swK30YlQuxRQO7QFr4ZxCA collected $9.80 from side pot
lc6GpYOW7MM4G+/65wMxXA: mucks hand 
swK30YlQuxRQO7QFr4ZxCA collected $33.60 from main pot
*** SUMMARY ***
Total pot $45.65 Main pot $33.60. Side pot $9.80. | Rake $2.25 
Board [Js 6s 7c 6h 3c]
Seat 1: fHr2+mGa0RFK3qrpZcVUAQ folded before Flop (didn't bet)
Seat 2: lc6GpYOW7MM4G+/65wMxXA mucked
Seat 3: aNpwfA31EREwO+ar4XzBCw (button) folded before Flop (didn't bet)
Seat 4: Bb42QRQMhg5/Y0vHP8/2Xw (small blind) folded before Flop
Seat 5: swK30YlQuxRQO7QFr4ZxCA (big blind) showed [7s 7h] and won ($43.40) with a full house, Sevens full of Sixes
Seat 6: aLYacoAY3e5d/M5ToF8Ujw mucked
Seat 7: qS+jfnNoG75bT+uQ8CKhQA folded before Flop (didn't bet)
Seat 8: sGFnnRCa1YAHAUmWgsW6Qg folded before Flop (didn't bet)
Seat 9: 3PmVnC/15cl4oyI1TKIt4g folded before Flop (didn't bet)




PokerStars Game #59941723172:  Hold'em No Limit ($0.10/$0.25) - 2009/07/01 1:44:07 ET
Table 'mdub7rJf3Z5tCT9s/+1+Wg' 9-max Seat #8 is the button
Seat 1: cZ99hugmLBj9KhTlc8nCSw ($29.25 in chips) 
Seat 2: 539MC3AwKLWVFwzABc644Q ($9.60 in chips) 
Seat 3: PdIasPkzm2sqZnN41ZRXOg ($5.35 in chips) 
Seat 4: fDGyaQz0cs2s4FOYxkbIHA ($14.85 in chips) 
Seat 5: dfNim92Z6XK1/h5SFW5vDg ($26.25 in chips) 
Seat 6: T/CCwAWe2yhO0c4oHNwicw ($23.25 in chips) 
Seat 7: woe+9KKk+L3pZgMTuHcmog ($15.70 in chips) 
Seat 8: Z9AeOQX3yzuSvKAm/xyovg ($5.90 in chips) 
Seat 9: tYsOBqdU1+x+yFI7zHO7hQ ($36.55 in chips) 
tYsOBqdU1+x+yFI7zHO7hQ: posts small blind $0.10
cZ99hugmLBj9KhTlc8nCSw: posts big blind $0.25
*** HOLE CARDS ***
539MC3AwKLWVFwzABc644Q: folds 
PdIasPkzm2sqZnN41ZRXOg: folds 
fDGyaQz0cs2s4FOYxkbIHA: folds 
dfNim92Z6XK1/h5SFW5vDg: folds 
T/CCwAWe2yhO0c4oHNwicw: folds 
woe+9KKk+L3pZgMTuHcmog: folds 
Z9AeOQX3yzuSvKAm/xyovg: folds 
tYsOBqdU1+x+yFI7zHO7hQ: raises $0.50 to $0.75
cZ99hugmLBj9KhTlc8nCSw: folds 
Uncalled bet ($0.50) returned to tYsOBqdU1+x+yFI7zHO7hQ
tYsOBqdU1+x+yFI7zHO7hQ collected $0.50 from pot
tYsOBqdU1+x+yFI7zHO7hQ: doesn't show hand 
*** SUMMARY ***
Total pot $0.50 | Rake $0 
Seat 1: cZ99hugmLBj9KhTlc8nCSw (big blind) folded before Flop
Seat 2: 539MC3AwKLWVFwzABc644Q folded before Flop (didn't bet)
Seat 3: PdIasPkzm2sqZnN41ZRXOg folded before Flop (didn't bet)
Seat 4: fDGyaQz0cs2s4FOYxkbIHA folded before Flop (didn't bet)
Seat 5: dfNim92Z6XK1/h5SFW5vDg folded before Flop (didn't bet)
Seat 6: T/CCwAWe2yhO0c4oHNwicw folded before Flop (didn't bet)
Seat 7: woe+9KKk+L3pZgMTuHcmog folded before Flop (didn't bet)
Seat 8: Z9AeOQX3yzuSvKAm/xyovg (button) folded before Flop (didn't bet)
Seat 9: tYsOBqdU1+x+yFI7zHO7hQ (small blind) collected ($0.50)




PokerStars Game #59941722928:  Hold'em No Limit ($0.10/$0.25) - 2009/07/01 1:44:07 ET
Table 'ouLhepGYovxB2x0QxH7cVg' 9-max Seat #5 is the button
Seat 1: ghNKXUBl/H+t83JF079ZBA ($25 in chips) 
Seat 2: r1Z5m4PwSI5ANp7qCE1OJw ($18.85 in chips) 
Seat 3: bXpVeaSTPBFSPJmeXxO7nw ($5.25 in chips) 
Seat 4: a0Sx6GHY7ln2Ns2C97eXeA ($38.10 in chips) 
Seat 5: v60REj6f8jzMYT0VsZvaPQ ($9.65 in chips) 
Seat 7: JRV2PblFtPFz51l0Fwyz8g ($24.35 in chips) 
Seat 8: tLcDklc2rBORNfixyRfVfw ($25 in chips) 
Seat 9: ljemhp25Zg+nlA9DLCIiUw ($25.35 in chips) 
JRV2PblFtPFz51l0Fwyz8g: posts small blind $0.10
tLcDklc2rBORNfixyRfVfw: posts big blind $0.25
*** HOLE CARDS ***
ljemhp25Zg+nlA9DLCIiUw: folds 
ghNKXUBl/H+t83JF079ZBA: raises $1 to $1.25
r1Z5m4PwSI5ANp7qCE1OJw: folds 
bXpVeaSTPBFSPJmeXxO7nw: folds 
a0Sx6GHY7ln2Ns2C97eXeA: folds 
v60REj6f8jzMYT0VsZvaPQ: folds 
JRV2PblFtPFz51l0Fwyz8g: folds 
tLcDklc2rBORNfixyRfVfw: folds 
Uncalled bet ($1) returned to ghNKXUBl/H+t83JF079ZBA
ghNKXUBl/H+t83JF079ZBA collected $0.60 from pot
ghNKXUBl/H+t83JF079ZBA: doesn't show hand 
*** SUMMARY ***
Total pot $0.60 | Rake $0 
Seat 1: ghNKXUBl/H+t83JF079ZBA collected ($0.60)
Seat 2: r1Z5m4PwSI5ANp7qCE1OJw folded before Flop (didn't bet)
Seat 3: bXpVeaSTPBFSPJmeXxO7nw folded before Flop (didn't bet)
Seat 4: a0Sx6GHY7ln2Ns2C97eXeA folded before Flop (didn't bet)
Seat 5: v60REj6f8jzMYT0VsZvaPQ (button) folded before Flop (didn't bet)
Seat 7: JRV2PblFtPFz51l0Fwyz8g (small blind) folded before Flop
Seat 8: tLcDklc2rBORNfixyRfVfw (big blind) folded before Flop
Seat 9: ljemhp25Zg+nlA9DLCIiUw folded before Flop (didn't bet)




PokerStars Game #59941723310:  Hold'em No Limit ($0.10/$0.25) - 2009/07/01 1:44:07 ET
Table '+2VxGVfkEqJ1AYfQy/JH2w' 6-max Seat #6 is the button
Seat 1: if4dh6jhJXeN3/qd3qCp9g ($25.45 in chips) 
Seat 2: qllppsCmUqovlriIWCeM/g ($5.80 in chips) 
Seat 4: y+a/yGW/Jy4bPJFnaeTz5w ($16.60 in chips) 
Seat 5: XD1i5m5PvBDnRzJaG/vINw ($22.35 in chips) 
Seat 6: L3/N/gliETan8N5Gim5h4Q ($25 in chips) 
if4dh6jhJXeN3/qd3qCp9g: posts small blind $0.10
qllppsCmUqovlriIWCeM/g: posts big blind $0.25
epAUIB7h2FJXzUPRIvSkRA: sits out 
*** HOLE CARDS ***
y+a/yGW/Jy4bPJFnaeTz5w: folds 
XD1i5m5PvBDnRzJaG/vINw: folds 
L3/N/gliETan8N5Gim5h4Q: folds 
if4dh6jhJXeN3/qd3qCp9g: folds 
Uncalled bet ($0.15) returned to qllppsCmUqovlriIWCeM/g
qllppsCmUqovlriIWCeM/g collected $0.20 from pot
*** SUMMARY ***
Total pot $0.20 | Rake $0 
Seat 1: if4dh6jhJXeN3/qd3qCp9g (small blind) folded before Flop
Seat 2: qllppsCmUqovlriIWCeM/g (big blind) collected ($0.20)
Seat 4: y+a/yGW/Jy4bPJFnaeTz5w folded before Flop (didn't bet)
Seat 5: XD1i5m5PvBDnRzJaG/vINw folded before Flop (didn't bet)
Seat 6: L3/N/gliETan8N5Gim5h4Q (button) folded before Flop (didn't bet)




PokerStars Game #59941723194:  Hold'em No Limit ($0.10/$0.25) - 2009/07/01 1:44:07 ET
Table 'YYMg5qzxK1m9eGRo4SbxtQ' 9-max Seat #9 is the button
Seat 1: 3PmVnC/15cl4oyI1TKIt4g ($4.75 in chips) 
Seat 2: f/H6PsHRl4W1JyNsEDvPtg ($8.35 in chips) 
Seat 4: ROxrieegd9WYtWcUKJAlbg ($14.75 in chips) 
Seat 8: xoBFd/5k+L/pFn9VW1VyWg ($14.20 in chips) 
Seat 9: +sbyWwIcFp9kP0bDtMegfQ ($31.60 in chips) 
3PmVnC/15cl4oyI1TKIt4g: posts small blind $0.10
f/H6PsHRl4W1JyNsEDvPtg: posts big blind $0.25
eebse2009: sits out 
*** HOLE CARDS ***
cFmpjvcjNoVAEAIQIxWkYg leaves the table
ROxrieegd9WYtWcUKJAlbg: calls $0.25
xoBFd/5k+L/pFn9VW1VyWg: folds 
eK8qa6EPcH2zhtbmWSvc9g joins the table at seat #3 
+sbyWwIcFp9kP0bDtMegfQ: folds 
3PmVnC/15cl4oyI1TKIt4g: calls $0.15
f/H6PsHRl4W1JyNsEDvPtg: checks 
*** FLOP *** [Ts 8d 7s]
3PmVnC/15cl4oyI1TKIt4g: checks 
f/H6PsHRl4W1JyNsEDvPtg: bets $0.50
ROxrieegd9WYtWcUKJAlbg: folds 
3PmVnC/15cl4oyI1TKIt4g: calls $0.50
*** TURN *** [Ts 8d 7s] [Tc]
3PmVnC/15cl4oyI1TKIt4g: checks 
f/H6PsHRl4W1JyNsEDvPtg: bets $0.50
3PmVnC/15cl4oyI1TKIt4g: raises $1 to $1.50
f/H6PsHRl4W1JyNsEDvPtg: raises $2.50 to $4
3PmVnC/15cl4oyI1TKIt4g: calls $2.50 and is all-in
*** RIVER *** [Ts 8d 7s Tc] [7d]
*** SHOW DOWN ***
3PmVnC/15cl4oyI1TKIt4g: shows [8s Qs] (two pair, Tens and Eights)
f/H6PsHRl4W1JyNsEDvPtg: shows [Qh Td] (a full house, Tens full of Sevens)
f/H6PsHRl4W1JyNsEDvPtg collected $9.30 from pot
*** SUMMARY ***
Total pot $9.75 | Rake $0.45 
Board [Ts 8d 7s Tc 7d]
Seat 1: 3PmVnC/15cl4oyI1TKIt4g (small blind) showed [8s Qs] and lost with two pair, Tens and Eights
Seat 2: f/H6PsHRl4W1JyNsEDvPtg (big blind) showed [Qh Td] and won ($9.30) with a full house, Tens full of Sevens
Seat 4: ROxrieegd9WYtWcUKJAlbg folded on the Flop
Seat 8: xoBFd/5k+L/pFn9VW1VyWg folded before Flop (didn't bet)
Seat 9: +sbyWwIcFp9kP0bDtMegfQ (button) folded before Flop (didn't bet)




PokerStars Game #59941723436:  Hold'em No Limit ($0.10/$0.25) - 2009/07/01 1:44:07 ET
Table 'AHkg4ChqzcMauBx6Qvz8Nw' 6-max Seat #2 is the button
Seat 1: +RDf7SmUjY2kK0PzdBEYqg ($5.50 in chips) 
Seat 2: Vi0JMrTI2BGrPL7UIulJtA ($5.55 in chips) 
Seat 3: 9dToMv2GJLfi00HcpfMnIw ($24.40 in chips) 
Seat 4: Eznneya0vB6S+eXJdVleHA ($20.70 in chips) 
Seat 5: Bada343Si4xKu3fNXY99AA ($4.20 in chips) 
Seat 6: Hsvkc0/G2VV78oVmWYXecw ($5 in chips) 
9dToMv2GJLfi00HcpfMnIw: posts small blind $0.10
Eznneya0vB6S+eXJdVleHA: posts big blind $0.25
*** HOLE CARDS ***
Bada343Si4xKu3fNXY99AA: folds 
Hsvkc0/G2VV78oVmWYXecw: folds 
+RDf7SmUjY2kK0PzdBEYqg: calls $0.25
Vi0JMrTI2BGrPL7UIulJtA: folds 
9dToMv2GJLfi00HcpfMnIw: calls $0.15
Eznneya0vB6S+eXJdVleHA: checks 
*** FLOP *** [Js 9c Qh]
9dToMv2GJLfi00HcpfMnIw: checks 
Eznneya0vB6S+eXJdVleHA: checks 
+RDf7SmUjY2kK0PzdBEYqg: bets $0.25
9dToMv2GJLfi00HcpfMnIw: folds 
Eznneya0vB6S+eXJdVleHA: calls $0.25
*** TURN *** [Js 9c Qh] [6h]
Eznneya0vB6S+eXJdVleHA: checks 
+RDf7SmUjY2kK0PzdBEYqg: bets $0.50
Eznneya0vB6S+eXJdVleHA: folds 
Uncalled bet ($0.50) returned to +RDf7SmUjY2kK0PzdBEYqg
+RDf7SmUjY2kK0PzdBEYqg collected $1.20 from pot
*** SUMMARY ***
Total pot $1.25 | Rake $0.05 
Board [Js 9c Qh 6h]
Seat 1: +RDf7SmUjY2kK0PzdBEYqg collected ($1.20)
Seat 2: Vi0JMrTI2BGrPL7UIulJtA (button) folded before Flop (didn't bet)
Seat 3: 9dToMv2GJLfi00HcpfMnIw (small blind) folded on the Flop
Seat 4: Eznneya0vB6S+eXJdVleHA (big blind) folded on the Turn
Seat 5: Bada343Si4xKu3fNXY99AA folded before Flop (didn't bet)
Seat 6: Hsvkc0/G2VV78oVmWYXecw folded before Flop (didn't bet)




PokerStars Game #59941723260:  Hold'em No Limit ($0.10/$0.25) - 2009/07/01 1:44:07 ET
Table 'APEHQjIcZHDZUA4iOjju2g' 6-max Seat #3 is the button
Seat 1: DE9hRlt14g+JdsRQ4wT7hg ($25 in chips) 
Seat 2: 3zD3qLXT1bEffAoWGnc7wg ($36.25 in chips) 
Seat 3: 3e/idKqDuPE10t6Zvr//SQ ($24.05 in chips) 
Seat 4: w2mQ4VsGljGwWXydz8tw2A ($37.85 in chips) 
Seat 5: /xN6gc9+8Hew0HxaB6VIVg ($44.45 in chips) 
Seat 6: KXtdqb+rIMkjc0RvHDksGQ ($25.95 in chips) 
w2mQ4VsGljGwWXydz8tw2A: posts small blind $0.10
/xN6gc9+8Hew0HxaB6VIVg: posts big blind $0.25
*** HOLE CARDS ***
KXtdqb+rIMkjc0RvHDksGQ: folds 
DE9hRlt14g+JdsRQ4wT7hg: folds 
3zD3qLXT1bEffAoWGnc7wg: folds 
3e/idKqDuPE10t6Zvr//SQ: folds 
w2mQ4VsGljGwWXydz8tw2A: calls $0.15
/xN6gc9+8Hew0HxaB6VIVg: raises $0.25 to $0.50
w2mQ4VsGljGwWXydz8tw2A: calls $0.25
*** FLOP *** [Qd 3c Qc]
w2mQ4VsGljGwWXydz8tw2A: checks 
/xN6gc9+8Hew0HxaB6VIVg: bets $0.50
w2mQ4VsGljGwWXydz8tw2A: raises $1.50 to $2
/xN6gc9+8Hew0HxaB6VIVg: calls $1.50
*** TURN *** [Qd 3c Qc] [As]
w2mQ4VsGljGwWXydz8tw2A: checks 
/xN6gc9+8Hew0HxaB6VIVg: checks 
*** RIVER *** [Qd 3c Qc As] [Kc]
w2mQ4VsGljGwWXydz8tw2A: checks 
/xN6gc9+8Hew0HxaB6VIVg: bets $1
w2mQ4VsGljGwWXydz8tw2A said, "why did i call that crap pre flop 7 4"
w2mQ4VsGljGwWXydz8tw2A: folds 
Uncalled bet ($1) returned to /xN6gc9+8Hew0HxaB6VIVg
/xN6gc9+8Hew0HxaB6VIVg collected $4.80 from pot
*** SUMMARY ***
Total pot $5 | Rake $0.20 
Board [Qd 3c Qc As Kc]
Seat 1: DE9hRlt14g+JdsRQ4wT7hg folded before Flop (didn't bet)
Seat 2: 3zD3qLXT1bEffAoWGnc7wg folded before Flop (didn't bet)
Seat 3: 3e/idKqDuPE10t6Zvr//SQ (button) folded before Flop (didn't bet)
Seat 4: w2mQ4VsGljGwWXydz8tw2A (small blind) folded on the River
Seat 5: /xN6gc9+8Hew0HxaB6VIVg (big blind) collected ($4.80)
Seat 6: KXtdqb+rIMkjc0RvHDksGQ folded before Flop (didn't bet)




PokerStars Game #59941723232:  Hold'em No Limit ($0.10/$0.25) - 2009/07/01 1:44:07 ET
Table 'ykyWGjhNu7AvZXov27T4ew' 9-max Seat #4 is the button
Seat 2: MG90wfSJZnOejs/KD3vlQQ ($39.60 in chips) 
Seat 4: W6tExOcYX7qiy6Qdp+ZwFA ($5.55 in chips) 
Seat 5: CmngQmkKTp8tkl6GMRTl6w ($8.25 in chips) 
Seat 6: AiXn/9o1EwOPZUHujnh/bA ($20.15 in chips) 
Seat 7: npAYqa85pqnzfOK5ukX+BQ ($21.65 in chips) 
Seat 8: tYsOBqdU1+x+yFI7zHO7hQ ($49.35 in chips) 
Seat 9: wk9M6R3w+aDHpr8WV87RmQ ($11.25 in chips) 
CmngQmkKTp8tkl6GMRTl6w: posts small blind $0.10
AiXn/9o1EwOPZUHujnh/bA: posts big blind $0.25
Team Rsf: sits out 
*** HOLE CARDS ***
npAYqa85pqnzfOK5ukX+BQ: folds 
tYsOBqdU1+x+yFI7zHO7hQ: folds 
wk9M6R3w+aDHpr8WV87RmQ: folds 
MG90wfSJZnOejs/KD3vlQQ: folds 
W6tExOcYX7qiy6Qdp+ZwFA: raises $0.50 to $0.75
CmngQmkKTp8tkl6GMRTl6w: folds 
AiXn/9o1EwOPZUHujnh/bA: folds 
Uncalled bet ($0.50) returned to W6tExOcYX7qiy6Qdp+ZwFA
W6tExOcYX7qiy6Qdp+ZwFA collected $0.60 from pot
W6tExOcYX7qiy6Qdp+ZwFA: doesn't show hand 
*** SUMMARY ***
Total pot $0.60 | Rake $0 
Seat 2: MG90wfSJZnOejs/KD3vlQQ folded before Flop (didn't bet)
Seat 4: W6tExOcYX7qiy6Qdp+ZwFA (button) collected ($0.60)
Seat 5: CmngQmkKTp8tkl6GMRTl6w (small blind) folded before Flop
Seat 6: AiXn/9o1EwOPZUHujnh/bA (big blind) folded before Flop
Seat 7: npAYqa85pqnzfOK5ukX+BQ folded before Flop (didn't bet)
Seat 8: tYsOBqdU1+x+yFI7zHO7hQ folded before Flop (didn't bet)
Seat 9: wk9M6R3w+aDHpr8WV87RmQ folded before Flop (didn't bet)




PokerStars Game #59941723938:  Hold'em No Limit ($0.10/$0.25) - 2009/07/01 1:44:08 ET
Table '63h13e5p7cWe02rClZ1CHw' 6-max Seat #1 is the button
Seat 1: pokjbbEcXXPlADXdSGHtZw ($18.40 in chips) 
Seat 2: k9nHZTHt8hYhYRcW8NTb4g ($29.90 in chips) 
Seat 3: mFv3iBCtrw9XfCDRB0d46Q ($5 in chips) 
Seat 4: xrf8tAXKQHG99HixCot1Iw ($23.70 in chips) 
Seat 5: iyZxqznXjv3vtvOJymkoLQ ($44.80 in chips) 
Seat 6: mfrkWA3PTeYPkbO6hi98Aw ($39.05 in chips) 
k9nHZTHt8hYhYRcW8NTb4g: posts small blind $0.10
mFv3iBCtrw9XfCDRB0d46Q: posts big blind $0.25
*** HOLE CARDS ***
xrf8tAXKQHG99HixCot1Iw: folds 
iyZxqznXjv3vtvOJymkoLQ: folds 
mfrkWA3PTeYPkbO6hi98Aw: folds 
pokjbbEcXXPlADXdSGHtZw: folds 
k9nHZTHt8hYhYRcW8NTb4g: calls $0.15
mFv3iBCtrw9XfCDRB0d46Q: checks 
*** FLOP *** [Qc 6d 4h]
k9nHZTHt8hYhYRcW8NTb4g: bets $0.50
mFv3iBCtrw9XfCDRB0d46Q: folds 
Uncalled bet ($0.50) returned to k9nHZTHt8hYhYRcW8NTb4g
k9nHZTHt8hYhYRcW8NTb4g collected $0.50 from pot
k9nHZTHt8hYhYRcW8NTb4g: doesn't show hand 
*** SUMMARY ***
Total pot $0.50 | Rake $0 
Board [Qc 6d 4h]
Seat 1: pokjbbEcXXPlADXdSGHtZw (button) folded before Flop (didn't bet)
Seat 2: k9nHZTHt8hYhYRcW8NTb4g (small blind) collected ($0.50)
Seat 3: mFv3iBCtrw9XfCDRB0d46Q (big blind) folded on the Flop
Seat 4: xrf8tAXKQHG99HixCot1Iw folded before Flop (didn't bet)
Seat 5: iyZxqznXjv3vtvOJymkoLQ folded before Flop (didn't bet)
Seat 6: mfrkWA3PTeYPkbO6hi98Aw folded before Flop (didn't bet)




PokerStars Game #59941723612:  Hold'em No Limit ($0.10/$0.25) - 2009/07/01 1:44:08 ET
Table 'Loy/olZ5qoDOSvX4UTujGg' 6-max Seat #2 is the button
Seat 1: HipgaJhkN4ie/tTw4dK3Ug ($12.80 in chips) 
Seat 2: 4z7mPbMLNp4TezHXin63Vw ($16.55 in chips) 
Seat 3: 32YL2ZEp8NT4JB2RVM9euQ ($15.80 in chips) 
Seat 4: /gJNBeCkWL4o85/jvlZ4BA ($28.55 in chips) 
Seat 5: tSR4329m40dZsN7YOpI9Kw ($28.35 in chips) 
Seat 6: qGHGf/553gQnDoklMRe3tg ($26.55 in chips) 
32YL2ZEp8NT4JB2RVM9euQ: posts small blind $0.10
/gJNBeCkWL4o85/jvlZ4BA: posts big blind $0.25
*** HOLE CARDS ***
tSR4329m40dZsN7YOpI9Kw: folds 
tSR4329m40dZsN7YOpI9Kw leaves the table
qGHGf/553gQnDoklMRe3tg: folds 
HipgaJhkN4ie/tTw4dK3Ug: folds 
4z7mPbMLNp4TezHXin63Vw: raises $0.25 to $0.50
32YL2ZEp8NT4JB2RVM9euQ: folds 
/gJNBeCkWL4o85/jvlZ4BA: folds 
Uncalled bet ($0.25) returned to 4z7mPbMLNp4TezHXin63Vw
4z7mPbMLNp4TezHXin63Vw collected $0.60 from pot
4z7mPbMLNp4TezHXin63Vw: doesn't show hand 
*** SUMMARY ***
Total pot $0.60 | Rake $0 
Seat 1: HipgaJhkN4ie/tTw4dK3Ug folded before Flop (didn't bet)
Seat 2: 4z7mPbMLNp4TezHXin63Vw (button) collected ($0.60)
Seat 3: 32YL2ZEp8NT4JB2RVM9euQ (small blind) folded before Flop
Seat 4: /gJNBeCkWL4o85/jvlZ4BA (big blind) folded before Flop
Seat 5: tSR4329m40dZsN7YOpI9Kw folded before Flop (didn't bet)
Seat 6: qGHGf/553gQnDoklMRe3tg folded before Flop (didn't bet)




PokerStars Game #59941723968:  Hold'em No Limit ($0.10/$0.25) - 2009/07/01 1:44:08 ET
Table 'l8hUTjBTXBorNUR/tyvSLw' 9-max Seat #4 is the button
Seat 1: cZ99hugmLBj9KhTlc8nCSw ($27.85 in chips) 
Seat 2: B6xHiX1SJkS0CUNCKDVwuQ ($20.90 in chips) 
Seat 3: ShCS62CJp4MKfKLKvGKQbA ($9.10 in chips) 
Seat 4: vPtFvcPtn/Afz0sucO1cmQ ($36.95 in chips) 
Seat 5: yyG4svzOpC1A+sUP/scg6w ($7.25 in chips) 
Seat 6: EVqHvqty1ZsuvDFiSXlSqQ ($23.85 in chips) 
Seat 7: F7pnn6czNpHvRM55XcA2EA ($33.40 in chips) 
Seat 8: Mh2r9hTeTEDnh19sRZtW3g ($5 in chips) 
yyG4svzOpC1A+sUP/scg6w: posts small blind $0.10
EVqHvqty1ZsuvDFiSXlSqQ: posts big blind $0.25
*** HOLE CARDS ***
F7pnn6czNpHvRM55XcA2EA: folds 
Mh2r9hTeTEDnh19sRZtW3g: folds 
cZ99hugmLBj9KhTlc8nCSw: folds 
B6xHiX1SJkS0CUNCKDVwuQ: folds 
ShCS62CJp4MKfKLKvGKQbA: folds 
vPtFvcPtn/Afz0sucO1cmQ: folds 
yyG4svzOpC1A+sUP/scg6w: calls $0.15
EVqHvqty1ZsuvDFiSXlSqQ: raises $0.25 to $0.50
yyG4svzOpC1A+sUP/scg6w: calls $0.25
*** FLOP *** [7c 3h Qs]
yyG4svzOpC1A+sUP/scg6w: checks 
EVqHvqty1ZsuvDFiSXlSqQ: checks 
*** TURN *** [7c 3h Qs] [Td]
yyG4svzOpC1A+sUP/scg6w: checks 
EVqHvqty1ZsuvDFiSXlSqQ: checks 
*** RIVER *** [7c 3h Qs Td] [Kc]
yyG4svzOpC1A+sUP/scg6w: checks 
EVqHvqty1ZsuvDFiSXlSqQ: bets $0.25
yyG4svzOpC1A+sUP/scg6w: folds 
Uncalled bet ($0.25) returned to EVqHvqty1ZsuvDFiSXlSqQ
EVqHvqty1ZsuvDFiSXlSqQ collected $0.95 from pot
*** SUMMARY ***
Total pot $1 | Rake $0.05 
Board [7c 3h Qs Td Kc]
Seat 1: cZ99hugmLBj9KhTlc8nCSw folded before Flop (didn't bet)
Seat 2: B6xHiX1SJkS0CUNCKDVwuQ folded before Flop (didn't bet)
Seat 3: ShCS62CJp4MKfKLKvGKQbA folded before Flop (didn't bet)
Seat 4: vPtFvcPtn/Afz0sucO1cmQ (button) folded before Flop (didn't bet)
Seat 5: yyG4svzOpC1A+sUP/scg6w (small blind) folded on the River
Seat 6: EVqHvqty1ZsuvDFiSXlSqQ (big blind) collected ($0.95)
Seat 7: F7pnn6czNpHvRM55XcA2EA folded before Flop (didn't bet)
Seat 8: Mh2r9hTeTEDnh19sRZtW3g folded before Flop (didn't bet)




PokerStars Game #59941723864:  Hold'em No Limit ($0.10/$0.25) - 2009/07/01 1:44:08 ET
Table '3LMlz3V4AziGlU+ikmyU8w' 6-max Seat #5 is the button
Seat 1: Wxq4Qyj0DnDXj2+taEOJFQ ($27.65 in chips) 
Seat 2: uR3AbFJLoOX86DOTtTgGcg ($27.50 in chips) 
Seat 3: Hzy03WtPHMYwLYM7hTTxQw ($29.60 in chips) 
Seat 4: 6DwBRH+xZ12AAZmeAg+aXw ($19.90 in chips) 
Seat 5: tOAk1Og4mVObMBOfvdDYOw ($25 in chips) 
Wxq4Qyj0DnDXj2+taEOJFQ: posts small blind $0.10
uR3AbFJLoOX86DOTtTgGcg: posts big blind $0.25
*** HOLE CARDS ***
Hzy03WtPHMYwLYM7hTTxQw: folds 
6DwBRH+xZ12AAZmeAg+aXw: folds 
tOAk1Og4mVObMBOfvdDYOw: folds 
Wxq4Qyj0DnDXj2+taEOJFQ: calls $0.15
uR3AbFJLoOX86DOTtTgGcg: checks 
*** FLOP *** [2s 8c 7d]
Wxq4Qyj0DnDXj2+taEOJFQ: bets $0.75
uR3AbFJLoOX86DOTtTgGcg: folds 
Uncalled bet ($0.75) returned to Wxq4Qyj0DnDXj2+taEOJFQ
Wxq4Qyj0DnDXj2+taEOJFQ collected $0.50 from pot
ZZm/rg8aThjE+A2LiItuzA leaves the table
*** SUMMARY ***
Total pot $0.50 | Rake $0 
Board [2s 8c 7d]
Seat 1: Wxq4Qyj0DnDXj2+taEOJFQ (small blind) collected ($0.50)
Seat 2: uR3AbFJLoOX86DOTtTgGcg (big blind) folded on the Flop
Seat 3: Hzy03WtPHMYwLYM7hTTxQw folded before Flop (didn't bet)
Seat 4: 6DwBRH+xZ12AAZmeAg+aXw folded before Flop (didn't bet)
Seat 5: tOAk1Og4mVObMBOfvdDYOw (button) folded before Flop (didn't bet)




PokerStars Game #59941723736:  Hold'em No Limit ($0.10/$0.25) - 2009/07/01 1:44:08 ET
Table '3eK1r4Q4BSYFvsKkuTLpIA' 9-max Seat #3 is the button
Seat 1: vSkQm2EelzwRGDDQQk0Fqw ($4.30 in chips) 
Seat 2: aNpwfA31EREwO+ar4XzBCw ($28.10 in chips) 
Seat 3: 56S3mA6Zs3pGR+0p0vUCtg ($35.85 in chips) 
Seat 4: +2kMBNpY4nF1qNCRd8SJLA ($25 in chips) 
Seat 5: 775TiRJajPtN/ucpTmHrXA ($14.75 in chips) 
Seat 6: +HvCCmsGSQeatf+GZ9zk8Q ($34.45 in chips) 
Seat 7: ljemhp25Zg+nlA9DLCIiUw ($25 in chips) 
Seat 8: /29aHLC+Q6KCDcNv2bPfAg ($12.80 in chips) 
Seat 9: +sbyWwIcFp9kP0bDtMegfQ ($60.40 in chips) 
+2kMBNpY4nF1qNCRd8SJLA: posts small blind $0.10
775TiRJajPtN/ucpTmHrXA: posts big blind $0.25
*** HOLE CARDS ***
+HvCCmsGSQeatf+GZ9zk8Q: calls $0.25
ljemhp25Zg+nlA9DLCIiUw: folds 
/29aHLC+Q6KCDcNv2bPfAg: calls $0.25
+sbyWwIcFp9kP0bDtMegfQ: folds 
vSkQm2EelzwRGDDQQk0Fqw: folds 
aNpwfA31EREwO+ar4XzBCw: folds 
56S3mA6Zs3pGR+0p0vUCtg: folds 
+2kMBNpY4nF1qNCRd8SJLA: folds 
775TiRJajPtN/ucpTmHrXA: raises $0.25 to $0.50
+HvCCmsGSQeatf+GZ9zk8Q: calls $0.25
/29aHLC+Q6KCDcNv2bPfAg: calls $0.25
*** FLOP *** [9h Th 2d]
775TiRJajPtN/ucpTmHrXA: checks 
+HvCCmsGSQeatf+GZ9zk8Q: checks 
/29aHLC+Q6KCDcNv2bPfAg: checks 
*** TURN *** [9h Th 2d] [Kd]
775TiRJajPtN/ucpTmHrXA: bets $1.25
+HvCCmsGSQeatf+GZ9zk8Q: calls $1.25
/29aHLC+Q6KCDcNv2bPfAg: folds 
*** RIVER *** [9h Th 2d Kd] [4s]
775TiRJajPtN/ucpTmHrXA: checks 
+HvCCmsGSQeatf+GZ9zk8Q: bets $3
775TiRJajPtN/ucpTmHrXA: calls $3
*** SHOW DOWN ***
+HvCCmsGSQeatf+GZ9zk8Q: shows [5d 7d] (high card King)
775TiRJajPtN/ucpTmHrXA: shows [Kh Jc] (a pair of Kings)
775TiRJajPtN/ucpTmHrXA collected $9.65 from pot
*** SUMMARY ***
Total pot $10.10 | Rake $0.45 
Board [9h Th 2d Kd 4s]
Seat 1: vSkQm2EelzwRGDDQQk0Fqw folded before Flop (didn't bet)
Seat 2: aNpwfA31EREwO+ar4XzBCw folded before Flop (didn't bet)
Seat 3: 56S3mA6Zs3pGR+0p0vUCtg (button) folded before Flop (didn't bet)
Seat 4: +2kMBNpY4nF1qNCRd8SJLA (small blind) folded before Flop
Seat 5: 775TiRJajPtN/ucpTmHrXA (big blind) showed [Kh Jc] and won ($9.65) with a pair of Kings
Seat 6: +HvCCmsGSQeatf+GZ9zk8Q showed [5d 7d] and lost with high card King
Seat 7: ljemhp25Zg+nlA9DLCIiUw folded before Flop (didn't bet)
Seat 8: /29aHLC+Q6KCDcNv2bPfAg folded on the Turn
Seat 9: +sbyWwIcFp9kP0bDtMegfQ folded before Flop (didn't bet)




PokerStars Game #59941724304:  Hold'em No Limit ($0.10/$0.25) - 2009/07/01 1:44:09 ET
Table 'by7aHYEDnDd144EXOXa/jA' 9-max Seat #1 is the button
Seat 1: j4q3p0lesp63b1gZDwLBZw ($6.25 in chips) 
Seat 2: vSkQm2EelzwRGDDQQk0Fqw ($6.10 in chips) 
Seat 3: HOEaXncFu2ij+D5/CANAZA ($12.10 in chips) 
Seat 4: 2Xwi447v1rBHM+92U0CduA ($4.25 in chips) 
Seat 5: yyG4svzOpC1A+sUP/scg6w ($4.20 in chips) 
Seat 6: sC4BsflLWW26Qm9m+1AwJQ ($14.90 in chips) 
Seat 8: 7je+LC5Mfs6nL8YBVh4frQ ($3.50 in chips) 
Seat 9: K0b5wNInj6hUGRr6yzKFtw ($25.05 in chips) 
vSkQm2EelzwRGDDQQk0Fqw: posts small blind $0.10
HOEaXncFu2ij+D5/CANAZA: posts big blind $0.25
Z9W7+g1WMhhZDi7DwGbCFA: sits out 
*** HOLE CARDS ***
2Xwi447v1rBHM+92U0CduA: folds 
yyG4svzOpC1A+sUP/scg6w: folds 
sC4BsflLWW26Qm9m+1AwJQ: raises $0.25 to $0.50
7je+LC5Mfs6nL8YBVh4frQ: folds 
K0b5wNInj6hUGRr6yzKFtw: folds 
j4q3p0lesp63b1gZDwLBZw: calls $0.50
vSkQm2EelzwRGDDQQk0Fqw: calls $0.40
HOEaXncFu2ij+D5/CANAZA: calls $0.25
*** FLOP *** [7c As 3c]
vSkQm2EelzwRGDDQQk0Fqw: checks 
HOEaXncFu2ij+D5/CANAZA: checks 
sC4BsflLWW26Qm9m+1AwJQ: checks 
j4q3p0lesp63b1gZDwLBZw: bets $2.50
vSkQm2EelzwRGDDQQk0Fqw: folds 
HOEaXncFu2ij+D5/CANAZA: folds 
sC4BsflLWW26Qm9m+1AwJQ: folds 
Uncalled bet ($2.50) returned to j4q3p0lesp63b1gZDwLBZw
j4q3p0lesp63b1gZDwLBZw collected $1.90 from pot
j4q3p0lesp63b1gZDwLBZw: doesn't show hand 
*** SUMMARY ***
Total pot $2 | Rake $0.10 
Board [7c As 3c]
Seat 1: j4q3p0lesp63b1gZDwLBZw (button) collected ($1.90)
Seat 2: vSkQm2EelzwRGDDQQk0Fqw (small blind) folded on the Flop
Seat 3: HOEaXncFu2ij+D5/CANAZA (big blind) folded on the Flop
Seat 4: 2Xwi447v1rBHM+92U0CduA folded before Flop (didn't bet)
Seat 5: yyG4svzOpC1A+sUP/scg6w folded before Flop (didn't bet)
Seat 6: sC4BsflLWW26Qm9m+1AwJQ folded on the Flop
Seat 8: 7je+LC5Mfs6nL8YBVh4frQ folded before Flop (didn't bet)
Seat 9: K0b5wNInj6hUGRr6yzKFtw folded before Flop (didn't bet)




PokerStars Game #59941724302:  Hold'em No Limit ($0.10/$0.25) - 2009/07/01 1:44:09 ET
Table 'QzXakDK7ZHNjgIpoUFGSKQ' 9-max Seat #1 is the button
Seat 1: w1ukf8uPa4+WH561TtVRxA ($28.70 in chips) 
Seat 2: QEbIGci+itdw+re8RM5fZA ($25 in chips) 
Seat 3: eK8qa6EPcH2zhtbmWSvc9g ($25.65 in chips) 
Seat 4: 12pxJGeALcKLTBryE6kFxA ($12.45 in chips) 
Seat 5: MtVtHDqIJTyUcXkRBBDIVA ($27.90 in chips) 
Seat 6: gehe91e0IyVT0QU/XBkEyg ($25 in chips) 
Seat 7: wGigCmBR/9XWkPpvYos3aQ ($29.90 in chips) 
Seat 9: lwrOE80tuooHfIBx/4LUSw ($24.15 in chips) 
QEbIGci+itdw+re8RM5fZA: posts small blind $0.10
eK8qa6EPcH2zhtbmWSvc9g: posts big blind $0.25
Z9W7+g1WMhhZDi7DwGbCFA: sits out 
*** HOLE CARDS ***
12pxJGeALcKLTBryE6kFxA: raises $0.75 to $1
MtVtHDqIJTyUcXkRBBDIVA: folds 
gehe91e0IyVT0QU/XBkEyg: folds 
wGigCmBR/9XWkPpvYos3aQ: folds 
lwrOE80tuooHfIBx/4LUSw: folds 
w1ukf8uPa4+WH561TtVRxA: calls $1
QEbIGci+itdw+re8RM5fZA: folds 
eK8qa6EPcH2zhtbmWSvc9g: folds 
*** FLOP *** [6s 3s Qs]
12pxJGeALcKLTBryE6kFxA: checks 
w1ukf8uPa4+WH561TtVRxA: bets $1
12pxJGeALcKLTBryE6kFxA: calls $1
*** TURN *** [6s 3s Qs] [Kh]
12pxJGeALcKLTBryE6kFxA: checks 
w1ukf8uPa4+WH561TtVRxA: checks 
*** RIVER *** [6s 3s Qs Kh] [Qh]
12pxJGeALcKLTBryE6kFxA: checks 
w1ukf8uPa4+WH561TtVRxA: checks 
*** SHOW DOWN ***
12pxJGeALcKLTBryE6kFxA: shows [Jd Jh] (two pair, Queens and Jacks)
w1ukf8uPa4+WH561TtVRxA: mucks hand 
12pxJGeALcKLTBryE6kFxA collected $4.15 from pot
*** SUMMARY ***
Total pot $4.35 | Rake $0.20 
Board [6s 3s Qs Kh Qh]
Seat 1: w1ukf8uPa4+WH561TtVRxA (button) mucked
Seat 2: QEbIGci+itdw+re8RM5fZA (small blind) folded before Flop
Seat 3: eK8qa6EPcH2zhtbmWSvc9g (big blind) folded before Flop
Seat 4: 12pxJGeALcKLTBryE6kFxA showed [Jd Jh] and won ($4.15) with two pair, Queens and Jacks
Seat 5: MtVtHDqIJTyUcXkRBBDIVA folded before Flop (didn't bet)
Seat 6: gehe91e0IyVT0QU/XBkEyg folded before Flop (didn't bet)
Seat 7: wGigCmBR/9XWkPpvYos3aQ folded before Flop (didn't bet)
Seat 9: lwrOE80tuooHfIBx/4LUSw folded before Flop (didn't bet)




PokerStars Game #59941724030:  Hold'em No Limit ($0.10/$0.25) - 2009/07/01 1:44:09 ET
Table 'aaXqTKUnxrX9DYXtxhWXxA' 6-max Seat #4 is the button
Seat 2: DE9hRlt14g+JdsRQ4wT7hg ($33.70 in chips) 
Seat 3: uUXdcVMNa05rfbntdvplfw ($8 in chips) 
Seat 4: 48oT5xFI+5CHUJlfoGrE4w ($9.65 in chips) 
Seat 5: kyRaCIljYA6l33lSKQfNsg ($26.70 in chips) 
Seat 6: buyjetgNT1McXtdaP4zynA ($49.55 in chips) 
kyRaCIljYA6l33lSKQfNsg: posts small blind $0.10
buyjetgNT1McXtdaP4zynA: posts big blind $0.25
aSrj4lVmn2owyQ1RbbOqxQ: sits out 
*** HOLE CARDS ***
DE9hRlt14g+JdsRQ4wT7hg: folds 
uUXdcVMNa05rfbntdvplfw: raises $0.75 to $1
48oT5xFI+5CHUJlfoGrE4w: folds 
kyRaCIljYA6l33lSKQfNsg: folds 
buyjetgNT1McXtdaP4zynA: folds 
Uncalled bet ($0.75) returned to uUXdcVMNa05rfbntdvplfw
uUXdcVMNa05rfbntdvplfw collected $0.60 from pot
*** SUMMARY ***
Total pot $0.60 | Rake $0 
Seat 2: DE9hRlt14g+JdsRQ4wT7hg folded before Flop (didn't bet)
Seat 3: uUXdcVMNa05rfbntdvplfw collected ($0.60)
Seat 4: 48oT5xFI+5CHUJlfoGrE4w (button) folded before Flop (didn't bet)
Seat 5: kyRaCIljYA6l33lSKQfNsg (small blind) folded before Flop
Seat 6: buyjetgNT1McXtdaP4zynA (big blind) folded before Flop




PokerStars Game #59941724326:  Hold'em No Limit ($0.10/$0.25) - 2009/07/01 1:44:09 ET
Table 'BpNkESDX1ip9c0K1hb5h7A' 6-max Seat #1 is the button
Seat 1: 5YZdVjBPZVEdubN4xEMPEg ($31.75 in chips) 
Seat 3: fZQg9veL7Dd/Z04ZTjC+wQ ($27.30 in chips) 
Seat 4: kG34n23qFQA3nzdOJTQ1dA ($25.90 in chips) 
Seat 5: L3/N/gliETan8N5Gim5h4Q ($25.75 in chips) 
Seat 6: 8EEqTTh7T1q48sYDqbI2Xg ($21.15 in chips) 
9U3ZKjCsarN0DjR6mSE8Ug will be allowed to play after the button
fZQg9veL7Dd/Z04ZTjC+wQ: posts small blind $0.10
kG34n23qFQA3nzdOJTQ1dA: posts big blind $0.25
*** HOLE CARDS ***
L3/N/gliETan8N5Gim5h4Q: folds 
8EEqTTh7T1q48sYDqbI2Xg: folds 
5YZdVjBPZVEdubN4xEMPEg: folds 
fZQg9veL7Dd/Z04ZTjC+wQ: raises $0.50 to $0.75
kG34n23qFQA3nzdOJTQ1dA: folds 
Uncalled bet ($0.50) returned to fZQg9veL7Dd/Z04ZTjC+wQ
fZQg9veL7Dd/Z04ZTjC+wQ collected $0.50 from pot
fZQg9veL7Dd/Z04ZTjC+wQ: doesn't show hand 
*** SUMMARY ***
Total pot $0.50 | Rake $0 
Seat 1: 5YZdVjBPZVEdubN4xEMPEg (button) folded before Flop (didn't bet)
Seat 3: fZQg9veL7Dd/Z04ZTjC+wQ (small blind) collected ($0.50)
Seat 4: kG34n23qFQA3nzdOJTQ1dA (big blind) folded before Flop
Seat 5: L3/N/gliETan8N5Gim5h4Q folded before Flop (didn't bet)
Seat 6: 8EEqTTh7T1q48sYDqbI2Xg folded before Flop (didn't bet)




PokerStars Game #59941724048:  Hold'em No Limit ($0.10/$0.25) - 2009/07/01 1:44:09 ET
Table 'WY+lMaAoIdBZmwk27/RJCA' 6-max Seat #5 is the button
Seat 1: zHHLkD2sRljslKKeQv/ZQw ($26.45 in chips) 
Seat 2: NhUN/JpAprdJeamFBgJH1w ($26.90 in chips) 
Seat 4: 0av6tRNdi0Ui4f15L7gsVg ($25 in chips) 
Seat 5: vqWjZmdQu/Hxw96/IJTWdQ ($30.10 in chips) 
Seat 6: cWc85bEzdRzpUMhRKm8pwQ ($25.60 in chips) 
cWc85bEzdRzpUMhRKm8pwQ: posts small blind $0.10
zHHLkD2sRljslKKeQv/ZQw: posts big blind $0.25
QqiZLFrN8iOUT/GHw7ztOA: sits out 
*** HOLE CARDS ***
NhUN/JpAprdJeamFBgJH1w: folds 
0av6tRNdi0Ui4f15L7gsVg: folds 
vqWjZmdQu/Hxw96/IJTWdQ: raises $0.50 to $0.75
cWc85bEzdRzpUMhRKm8pwQ: folds 
zHHLkD2sRljslKKeQv/ZQw: folds 
Uncalled bet ($0.50) returned to vqWjZmdQu/Hxw96/IJTWdQ
vqWjZmdQu/Hxw96/IJTWdQ collected $0.60 from pot
vqWjZmdQu/Hxw96/IJTWdQ: doesn't show hand 
*** SUMMARY ***
Total pot $0.60 | Rake $0 
Seat 1: zHHLkD2sRljslKKeQv/ZQw (big blind) folded before Flop
Seat 2: NhUN/JpAprdJeamFBgJH1w folded before Flop (didn't bet)
Seat 4: 0av6tRNdi0Ui4f15L7gsVg folded before Flop (didn't bet)
Seat 5: vqWjZmdQu/Hxw96/IJTWdQ (button) collected ($0.60)
Seat 6: cWc85bEzdRzpUMhRKm8pwQ (small blind) folded before Flop




PokerStars Game #59941724490:  Hold'em No Limit ($0.10/$0.25) - 2009/07/01 1:44:09 ET
Table 'ER5H84HUgJx7HyDLnELLeA' 6-max Seat #4 is the button
Seat 1: LJI7A1YgDM7hgh7o56+ReQ ($27.50 in chips) 
Seat 4: vqWjZmdQu/Hxw96/IJTWdQ ($25.25 in chips) 
Seat 5: mfrkWA3PTeYPkbO6hi98Aw ($25.30 in chips) 
Seat 6: 3zD3qLXT1bEffAoWGnc7wg ($51 in chips) 
mfrkWA3PTeYPkbO6hi98Aw: posts small blind $0.10
3zD3qLXT1bEffAoWGnc7wg: posts big blind $0.25
buyjetgNT1McXtdaP4zynA: sits out 
*** HOLE CARDS ***
LJI7A1YgDM7hgh7o56+ReQ: folds 
vqWjZmdQu/Hxw96/IJTWdQ: folds 
mfrkWA3PTeYPkbO6hi98Aw: folds 
Uncalled bet ($0.15) returned to 3zD3qLXT1bEffAoWGnc7wg
3zD3qLXT1bEffAoWGnc7wg collected $0.20 from pot
3zD3qLXT1bEffAoWGnc7wg: doesn't show hand 
*** SUMMARY ***
Total pot $0.20 | Rake $0 
Seat 1: LJI7A1YgDM7hgh7o56+ReQ folded before Flop (didn't bet)
Seat 4: vqWjZmdQu/Hxw96/IJTWdQ (button) folded before Flop (didn't bet)
Seat 5: mfrkWA3PTeYPkbO6hi98Aw (small blind) folded before Flop
Seat 6: 3zD3qLXT1bEffAoWGnc7wg (big blind) collected ($0.20)




PokerStars Game #59941724052:  Hold'em No Limit ($0.10/$0.25) - 2009/07/01 1:44:09 ET
Table 'x7YStLKc8hpt/pTgSetPKA' 9-max Seat #3 is the button
Seat 1: tYsOBqdU1+x+yFI7zHO7hQ ($25 in chips) 
Seat 3: S7Ki0P+0AIGPuIfGJjW0gg ($12.10 in chips) 
Seat 4: ydoFOVgzvZv9ZhuWu9rXAw ($5.25 in chips) 
Seat 6: 9YN2IkT2JYYKFErZtZvCtA ($47.70 in chips) 
Seat 7: dtZ84flFEi4Q+SGrHMJRDQ ($26.35 in chips) 
Seat 8: j4q3p0lesp63b1gZDwLBZw ($5 in chips) 
Seat 9: nm4Dj/f+jJEwKVsUnKh73g ($37.05 in chips) 
ydoFOVgzvZv9ZhuWu9rXAw: posts small blind $0.10
OiV1PWZ3IkN29JlmCcnTwQ: is sitting out 
9YN2IkT2JYYKFErZtZvCtA: posts big blind $0.25
*** HOLE CARDS ***
dtZ84flFEi4Q+SGrHMJRDQ: folds 
OiV1PWZ3IkN29JlmCcnTwQ leaves the table
j4q3p0lesp63b1gZDwLBZw: folds 
nm4Dj/f+jJEwKVsUnKh73g: folds 
tYsOBqdU1+x+yFI7zHO7hQ: folds 
S7Ki0P+0AIGPuIfGJjW0gg: folds 
ydoFOVgzvZv9ZhuWu9rXAw: folds 
Uncalled bet ($0.15) returned to 9YN2IkT2JYYKFErZtZvCtA
9YN2IkT2JYYKFErZtZvCtA collected $0.20 from pot
9YN2IkT2JYYKFErZtZvCtA: doesn't show hand 
*** SUMMARY ***
Total pot $0.20 | Rake $0 
Seat 1: tYsOBqdU1+x+yFI7zHO7hQ folded before Flop (didn't bet)
Seat 3: S7Ki0P+0AIGPuIfGJjW0gg (button) folded before Flop (didn't bet)
Seat 4: ydoFOVgzvZv9ZhuWu9rXAw (small blind) folded before Flop
Seat 6: 9YN2IkT2JYYKFErZtZvCtA (big blind) collected ($0.20)
Seat 7: dtZ84flFEi4Q+SGrHMJRDQ folded before Flop (didn't bet)
Seat 8: j4q3p0lesp63b1gZDwLBZw folded before Flop (didn't bet)
Seat 9: nm4Dj/f+jJEwKVsUnKh73g folded before Flop (didn't bet)




PokerStars Game #59941724306:  Hold'em No Limit ($0.10/$0.25) - 2009/07/01 1:44:09 ET
Table 'tErGGDyESv/0llKumVeZuQ' 9-max Seat #1 is the button
Seat 1: 3PmVnC/15cl4oyI1TKIt4g ($4.40 in chips) 
Seat 2: pN3IHvAKm2fz+sTRARTcrg ($24.40 in chips) 
Seat 4: yqkowiRWZ6NvRN9UUkYIlA ($5 in chips) 
Seat 5: 6RQUxA3jk+ePxB/+Hc0IKw ($13.85 in chips) 
Seat 7: uhrboV251dcgYniYTdFIcA ($29.15 in chips) 
Seat 8: UD63hhjq5lMoGqYLFTcH1A ($1.70 in chips) 
Seat 9: d6n762oPkegG086ZJyV5MA ($16.90 in chips) 
pN3IHvAKm2fz+sTRARTcrg: posts small blind $0.10
cFmpjvcjNoVAEAIQIxWkYg: is sitting out 
cFmpjvcjNoVAEAIQIxWkYg leaves the table
yqkowiRWZ6NvRN9UUkYIlA: posts big blind $0.25
*** HOLE CARDS ***
6RQUxA3jk+ePxB/+Hc0IKw: folds 
qwr38jl5txoR36M7G5qi4A joins the table at seat #3 
uhrboV251dcgYniYTdFIcA: folds 
UD63hhjq5lMoGqYLFTcH1A: folds 
d6n762oPkegG086ZJyV5MA: calls $0.25
3PmVnC/15cl4oyI1TKIt4g: raises $1 to $1.25
UD63hhjq5lMoGqYLFTcH1A leaves the table
pN3IHvAKm2fz+sTRARTcrg: raises $2.75 to $4
yqkowiRWZ6NvRN9UUkYIlA: folds 
clJsV3v77RS07bDKY+705w joins the table at seat #8 
d6n762oPkegG086ZJyV5MA: folds 
3PmVnC/15cl4oyI1TKIt4g: raises $0.40 to $4.40 and is all-in
pN3IHvAKm2fz+sTRARTcrg: calls $0.40
*** FLOP *** [Tc Qd Js]
*** TURN *** [Tc Qd Js] [7s]
*** RIVER *** [Tc Qd Js 7s] [4h]
*** SHOW DOWN ***
pN3IHvAKm2fz+sTRARTcrg: shows [Kd Ac] (a straight, Ten to Ace)
3PmVnC/15cl4oyI1TKIt4g: mucks hand 
pN3IHvAKm2fz+sTRARTcrg collected $8.85 from pot
*** SUMMARY ***
Total pot $9.30 | Rake $0.45 
Board [Tc Qd Js 7s 4h]
Seat 1: 3PmVnC/15cl4oyI1TKIt4g (button) mucked
Seat 2: pN3IHvAKm2fz+sTRARTcrg (small blind) showed [Kd Ac] and won ($8.85) with a straight, Ten to Ace
Seat 4: yqkowiRWZ6NvRN9UUkYIlA (big blind) folded before Flop
Seat 5: 6RQUxA3jk+ePxB/+Hc0IKw folded before Flop (didn't bet)
Seat 7: uhrboV251dcgYniYTdFIcA folded before Flop (didn't bet)
Seat 8: UD63hhjq5lMoGqYLFTcH1A folded before Flop (didn't bet)
Seat 9: d6n762oPkegG086ZJyV5MA folded before Flop




PokerStars Game #59941724138:  Hold'em No Limit ($0.10/$0.25) - 2009/07/01 1:44:09 ET
Table 'WEMI3Mtn7dGARDbgNrKibgoG007Tb0LYbfANo6QWd16wx Seat #4 is the button
Seat 1: DiSvPC2iudwL5j9u6Huyww ($46.65 in chips) 
Seat 4: zgi+EUykT/pZQpoUG6+oEg ($4.30 in chips) 
Seat 5: 8f0dtuUGqDbgE6up1lQAlg ($5.85 in chips) 
Seat 6: yqkowiRWZ6NvRN9UUkYIlA ($5 in chips) 
Seat 7: Mh2r9hTeTEDnh19sRZtW3g ($4.75 in chips) 
Seat 8: q4cNXFZGNhLfrTyVrIy6Mg ($12.30 in chips) 
Seat 9: EVqHvqty1ZsuvDFiSXlSqQ ($18.85 in chips) 
8f0dtuUGqDbgE6up1lQAlg: posts small blind $0.10
yqkowiRWZ6NvRN9UUkYIlA: posts big blind $0.25
pN3IHvAKm2fz+sTRARTcrg: sits out 
*** HOLE CARDS ***
Mh2r9hTeTEDnh19sRZtW3g: folds 
q4cNXFZGNhLfrTyVrIy6Mg: calls $0.25
EVqHvqty1ZsuvDFiSXlSqQ: folds 
DiSvPC2iudwL5j9u6Huyww: folds 
zgi+EUykT/pZQpoUG6+oEg: raises $1 to $1.25
8f0dtuUGqDbgE6up1lQAlg: folds 
yqkowiRWZ6NvRN9UUkYIlA: folds 
q4cNXFZGNhLfrTyVrIy6Mg: calls $1
*** FLOP *** [4s Kh 4d]
q4cNXFZGNhLfrTyVrIy6Mg: checks 
zgi+EUykT/pZQpoUG6+oEg: bets $1.50
q4cNXFZGNhLfrTyVrIy6Mg: raises $1.50 to $3
zgi+EUykT/pZQpoUG6+oEg: folds 
Uncalled bet ($1.50) returned to q4cNXFZGNhLfrTyVrIy6Mg
q4cNXFZGNhLfrTyVrIy6Mg collected $5.60 from pot
q4cNXFZGNhLfrTyVrIy6Mg: doesn't show hand 
*** SUMMARY ***
Total pot $5.85 | Rake $0.25 
Board [4s Kh 4d]
Seat 1: DiSvPC2iudwL5j9u6Huyww folded before Flop (didn't bet)
Seat 4: zgi+EUykT/pZQpoUG6+oEg (button) folded on the Flop
Seat 5: 8f0dtuUGqDbgE6up1lQAlg (small blind) folded before Flop
Seat 6: yqkowiRWZ6NvRN9UUkYIlA (big blind) folded before Flop
Seat 7: Mh2r9hTeTEDnh19sRZtW3g folded before Flop (didn't bet)
Seat 8: q4cNXFZGNhLfrTyVrIy6Mg collected ($5.60)
Seat 9: EVqHvqty1ZsuvDFiSXlSqQ folded before Flop (didn't bet)




PokerStars Game #59941724824:  Hold'em No Limit ($0.10/$0.25) - 2009/07/01 1:44:10 ET
Table 'NtCSSONEf1zaJo3042tQug' 6-max Seat #1 is the button
Seat 1: KXtdqb+rIMkjc0RvHDksGQ ($35.10 in chips) 
Seat 2: vqWjZmdQu/Hxw96/IJTWdQ ($27.05 in chips) 
Seat 3: 9kUKGKkblnIx3m8rlVol6Q ($15.65 in chips) 
Seat 4: HxD1kB8zCmalQSdWAkKmlg ($29.20 in chips) 
Seat 5: tOAk1Og4mVObMBOfvdDYOw ($30.40 in chips) 
Seat 6: LxehwDpTQ19ph4Qmc78+Pw ($29 in chips) 
vqWjZmdQu/Hxw96/IJTWdQ: posts small blind $0.10
9kUKGKkblnIx3m8rlVol6Q: posts big blind $0.25
*** HOLE CARDS ***
HxD1kB8zCmalQSdWAkKmlg: folds 
tOAk1Og4mVObMBOfvdDYOw: folds 
LxehwDpTQ19ph4Qmc78+Pw: folds 
KXtdqb+rIMkjc0RvHDksGQ: folds 
vqWjZmdQu/Hxw96/IJTWdQ: folds 
Uncalled bet ($0.15) returned to 9kUKGKkblnIx3m8rlVol6Q
9kUKGKkblnIx3m8rlVol6Q collected $0.20 from pot
9kUKGKkblnIx3m8rlVol6Q: doesn't show hand 
*** SUMMARY ***
Total pot $0.20 | Rake $0 
Seat 1: KXtdqb+rIMkjc0RvHDksGQ (button) folded before Flop (didn't bet)
Seat 2: vqWjZmdQu/Hxw96/IJTWdQ (small blind) folded before Flop
Seat 3: 9kUKGKkblnIx3m8rlVol6Q (big blind) collected ($0.20)
Seat 4: HxD1kB8zCmalQSdWAkKmlg folded before Flop (didn't bet)
Seat 5: tOAk1Og4mVObMBOfvdDYOw folded before Flop (didn't bet)
Seat 6: LxehwDpTQ19ph4Qmc78+Pw folded before Flop (didn't bet)




PokerStars Game #59941724846:  Hold'em No Limit ($0.10/$0.25) - 2009/07/01 1:44:10 ET
Table 'bIGKmJgZehWJ+FAo8b85iw' 9-max Seat #1 is the button
Seat 1: yyG4svzOpC1A+sUP/scg6w ($14.35 in chips) 
Seat 2: cCjRCvseA9rZn7Xr+GCCHg ($21.45 in chips) 
Seat 3: /FyMUX+W/tpNFcRWbUTJxQ ($11.15 in chips) 
Seat 4: LGxBRjCRn6KlQ/6B4eoXbA ($38.55 in chips) 
Seat 5: uLP/lYn7oKq9xCChBXsXxw ($25.25 in chips) 
Seat 6: PFNLAvMkr8qKc7xCiH0wTA ($18.10 in chips) 
Seat 7: HDDm1BkZtdsRyw2DJdqq6A ($2.15 in chips) 
Seat 8: +2kMBNpY4nF1qNCRd8SJLA ($54.20 in chips) 
Seat 9: aNpwfA31EREwO+ar4XzBCw ($31.75 in chips) 
cCjRCvseA9rZn7Xr+GCCHg: posts small blind $0.10
/FyMUX+W/tpNFcRWbUTJxQ: posts big blind $0.25
*** HOLE CARDS ***
HDDm1BkZtdsRyw2DJdqq6A said, "takin all my money!"
LGxBRjCRn6KlQ/6B4eoXbA: folds 
uLP/lYn7oKq9xCChBXsXxw: folds 
PFNLAvMkr8qKc7xCiH0wTA: calls $0.25
LGxBRjCRn6KlQ/6B4eoXbA said, "lol"
HDDm1BkZtdsRyw2DJdqq6A: raises $1.90 to $2.15 and is all-in
+2kMBNpY4nF1qNCRd8SJLA: folds 
aNpwfA31EREwO+ar4XzBCw: folds 
yyG4svzOpC1A+sUP/scg6w: calls $2.15
cCjRCvseA9rZn7Xr+GCCHg: folds 
LGxBRjCRn6KlQ/6B4eoXbA said, "give it"
/FyMUX+W/tpNFcRWbUTJxQ: raises $9 to $11.15 and is all-in
PFNLAvMkr8qKc7xCiH0wTA: folds 
yyG4svzOpC1A+sUP/scg6w: calls $9
*** FLOP *** [Jc Js 3d]
*** TURN *** [Jc Js 3d] [9d]
*** RIVER *** [Jc Js 3d 9d] [7d]
*** SHOW DOWN ***
/FyMUX+W/tpNFcRWbUTJxQ: shows [Kd Ks] (two pair, Kings and Jacks)
yyG4svzOpC1A+sUP/scg6w: mucks hand 
/FyMUX+W/tpNFcRWbUTJxQ collected $17.10 from side pot
HDDm1BkZtdsRyw2DJdqq6A: mucks hand 
/FyMUX+W/tpNFcRWbUTJxQ collected $6.50 from main pot
*** SUMMARY ***
Total pot $24.80 Main pot $6.50. Side pot $17.10. | Rake $1.20 
Board [Jc Js 3d 9d 7d]
Seat 1: yyG4svzOpC1A+sUP/scg6w (button) mucked
Seat 2: cCjRCvseA9rZn7Xr+GCCHg (small blind) folded before Flop
Seat 3: /FyMUX+W/tpNFcRWbUTJxQ (big blind) showed [Kd Ks] and won ($23.60) with two pair, Kings and Jacks
Seat 4: LGxBRjCRn6KlQ/6B4eoXbA folded before Flop (didn't bet)
Seat 5: uLP/lYn7oKq9xCChBXsXxw folded before Flop (didn't bet)
Seat 6: PFNLAvMkr8qKc7xCiH0wTA folded before Flop
Seat 7: HDDm1BkZtdsRyw2DJdqq6A mucked
Seat 8: +2kMBNpY4nF1qNCRd8SJLA folded before Flop (didn't bet)
Seat 9: aNpwfA31EREwO+ar4XzBCw folded before Flop (didn't bet)




PokerStars Game #59941725036:  Hold'em No Limit ($0.10/$0.25) - 2009/07/01 1:44:10 ET
Table '50f2Xa1b1jp6cfdTAgXFIg' 9-max Seat #6 is the button
Seat 1: pplNliE3WonjkPRf+GZq2A ($28.05 in chips) 
Seat 2: qxWFg3MZuVyidB0SJh5ywg ($29.95 in chips) 
Seat 3: RSojRXQHk0IRANbJYopT9g ($22.40 in chips) 
Seat 4: ghNKXUBl/H+t83JF079ZBA ($28.10 in chips) 
Seat 5: C1w4aCCgQVVSgNijoEahAg ($16.05 in chips) 
Seat 6: tLcDklc2rBORNfixyRfVfw ($25 in chips) 
Seat 7: w1ukf8uPa4+WH561TtVRxA ($25 in chips) 
Seat 8: x+W5+3qsdY4Iszf0hoH+Aw ($14.90 in chips) 
Seat 9: gehe91e0IyVT0QU/XBkEyg ($25.15 in chips) 
w1ukf8uPa4+WH561TtVRxA: posts small blind $0.10
x+W5+3qsdY4Iszf0hoH+Aw: posts big blind $0.25
*** HOLE CARDS ***
gehe91e0IyVT0QU/XBkEyg: folds 
pplNliE3WonjkPRf+GZq2A: folds 
qxWFg3MZuVyidB0SJh5ywg: folds 
RSojRXQHk0IRANbJYopT9g: folds 
ghNKXUBl/H+t83JF079ZBA: folds 
C1w4aCCgQVVSgNijoEahAg: calls $0.25
tLcDklc2rBORNfixyRfVfw: folds 
w1ukf8uPa4+WH561TtVRxA: folds 
qxWFg3MZuVyidB0SJh5ywg is sitting out
x+W5+3qsdY4Iszf0hoH+Aw: checks 
*** FLOP *** [Th 3d 2c]
x+W5+3qsdY4Iszf0hoH+Aw: checks 
C1w4aCCgQVVSgNijoEahAg: bets $0.50
x+W5+3qsdY4Iszf0hoH+Aw: folds 
Uncalled bet ($0.50) returned to C1w4aCCgQVVSgNijoEahAg
C1w4aCCgQVVSgNijoEahAg collected $0.60 from pot
*** SUMMARY ***
Total pot $0.60 | Rake $0 
Board [Th 3d 2c]
Seat 1: pplNliE3WonjkPRf+GZq2A folded before Flop (didn't bet)
Seat 2: qxWFg3MZuVyidB0SJh5ywg folded before Flop (didn't bet)
Seat 3: RSojRXQHk0IRANbJYopT9g folded before Flop (didn't bet)
Seat 4: ghNKXUBl/H+t83JF079ZBA folded before Flop (didn't bet)
Seat 5: C1w4aCCgQVVSgNijoEahAg collected ($0.60)
Seat 6: tLcDklc2rBORNfixyRfVfw (button) folded before Flop (didn't bet)
Seat 7: w1ukf8uPa4+WH561TtVRxA (small blind) folded before Flop
Seat 8: x+W5+3qsdY4Iszf0hoH+Aw (big blind) folded on the Flop
Seat 9: gehe91e0IyVT0QU/XBkEyg folded before Flop (didn't bet)




PokerStars Game #59941725540:  Hold'em No Limit ($0.10/$0.25) - 2009/07/01 1:44:11 ET
Table 'djcjiEGabFQO0MNG6jEeJQ' 9-max Seat #1 is the button
Seat 1: Bb42QRQMhg5/Y0vHP8/2Xw ($25 in chips) 
Seat 2: WKL8nUFr7TumC4EjLyqYzw ($5.35 in chips) 
Seat 3: zgi+EUykT/pZQpoUG6+oEg ($5 in chips) 
Seat 4: 2wcFsZsqEP5w1StUTVzJCg ($9.55 in chips) 
Seat 5: cZ99hugmLBj9KhTlc8nCSw ($42 in chips) 
Seat 6: aNpwfA31EREwO+ar4XzBCw ($74 in chips) 
Seat 7: 56S3mA6Zs3pGR+0p0vUCtg ($35.30 in chips) 
Seat 8: +sbyWwIcFp9kP0bDtMegfQ ($51.25 in chips) 
Seat 9: HPEB+AtKw1+C/cxU0o1ciw ($46.85 in chips) 
WKL8nUFr7TumC4EjLyqYzw: posts small blind $0.10
zgi+EUykT/pZQpoUG6+oEg: posts big blind $0.25
*** HOLE CARDS ***
2wcFsZsqEP5w1StUTVzJCg: folds 
cZ99hugmLBj9KhTlc8nCSw: folds 
aNpwfA31EREwO+ar4XzBCw: folds 
56S3mA6Zs3pGR+0p0vUCtg: calls $0.25
+sbyWwIcFp9kP0bDtMegfQ: folds 
HPEB+AtKw1+C/cxU0o1ciw: folds 
Bb42QRQMhg5/Y0vHP8/2Xw: raises $0.75 to $1
WKL8nUFr7TumC4EjLyqYzw: folds 
zgi+EUykT/pZQpoUG6+oEg: folds 
56S3mA6Zs3pGR+0p0vUCtg: folds 
Uncalled bet ($0.75) returned to Bb42QRQMhg5/Y0vHP8/2Xw
Bb42QRQMhg5/Y0vHP8/2Xw collected $0.85 from pot
*** SUMMARY ***
Total pot $0.85 | Rake $0 
Seat 1: Bb42QRQMhg5/Y0vHP8/2Xw (button) collected ($0.85)
Seat 2: WKL8nUFr7TumC4EjLyqYzw (small blind) folded before Flop
Seat 3: zgi+EUykT/pZQpoUG6+oEg (big blind) folded before Flop
Seat 4: 2wcFsZsqEP5w1StUTVzJCg folded before Flop (didn't bet)
Seat 5: cZ99hugmLBj9KhTlc8nCSw folded before Flop (didn't bet)
Seat 6: aNpwfA31EREwO+ar4XzBCw folded before Flop (didn't bet)
Seat 7: 56S3mA6Zs3pGR+0p0vUCtg folded before Flop
Seat 8: +sbyWwIcFp9kP0bDtMegfQ folded before Flop (didn't bet)
Seat 9: HPEB+AtKw1+C/cxU0o1ciw folded before Flop (didn't bet)




PokerStars Game #59941725404:  Hold'em No Limit ($0.10/$0.25) - 2009/07/01 1:44:11 ET
Table '2VkNDXXsBj4bSZw/uK5atw' 6-max Seat #6 is the button
Seat 1: xrf8tAXKQHG99HixCot1Iw ($15.10 in chips) 
Seat 2: v6mkGzCBCCXcgWQNSYVtKg ($13.30 in chips) 
Seat 5: 7f0OkhFEOf3T+rVOFHRLnw ($21.55 in chips) 
Seat 6: n6UPMnVR4v8LFP0rWP73Fg ($9.85 in chips) 
xrf8tAXKQHG99HixCot1Iw: posts small blind $0.10
v6mkGzCBCCXcgWQNSYVtKg: posts big blind $0.25
*** HOLE CARDS ***
7f0OkhFEOf3T+rVOFHRLnw: folds 
n6UPMnVR4v8LFP0rWP73Fg: folds 
xrf8tAXKQHG99HixCot1Iw: raises $0.50 to $0.75
barbarrin was removed from the table for failing to post
v6mkGzCBCCXcgWQNSYVtKg: calls $0.50
*** FLOP *** [6d Jh 5d]
xrf8tAXKQHG99HixCot1Iw: checks 
v6mkGzCBCCXcgWQNSYVtKg: checks 
*** TURN *** [6d Jh 5d] [Td]
xrf8tAXKQHG99HixCot1Iw: checks 
v6mkGzCBCCXcgWQNSYVtKg: checks 
*** RIVER *** [6d Jh 5d Td] [3c]
xrf8tAXKQHG99HixCot1Iw: checks 
v6mkGzCBCCXcgWQNSYVtKg: checks 
*** SHOW DOWN ***
xrf8tAXKQHG99HixCot1Iw: shows [Th Kc] (a pair of Tens)
v6mkGzCBCCXcgWQNSYVtKg: mucks hand 
xrf8tAXKQHG99HixCot1Iw collected $1.45 from pot
*** SUMMARY ***
Total pot $1.50 | Rake $0.05 
Board [6d Jh 5d Td 3c]
Seat 1: xrf8tAXKQHG99HixCot1Iw (small blind) showed [Th Kc] and won ($1.45) with a pair of Tens
Seat 2: v6mkGzCBCCXcgWQNSYVtKg (big blind) mucked
Seat 5: 7f0OkhFEOf3T+rVOFHRLnw folded before Flop (didn't bet)
Seat 6: n6UPMnVR4v8LFP0rWP73Fg (button) folded before Flop (didn't bet)




PokerStars Game #59941725082:  Hold'em No Limit ($0.10/$0.25) - 2009/07/01 1:44:11 ET
Table 'hfHe8uKeSJMyWAjSdM7ROQ' 6-max Seat #4 is the button
Seat 1: eHsmIvAb2JREg4O6hNPnXg ($40.95 in chips) 
Seat 2: QvTX2yGq3uKJiKPmns4TKQ ($30.40 in chips) 
Seat 3: oAzQdB2jFOH1NxFUPjYUGg ($26.40 in chips) 
Seat 4: b4wRQV3APH8irVk6bUFe2Q ($25.85 in chips) 
Seat 5: euswrBD1XG0Q5hB1iGJBKQ ($60.85 in chips) 
euswrBD1XG0Q5hB1iGJBKQ: posts small blind $0.10
eHsmIvAb2JREg4O6hNPnXg: posts big blind $0.25
*** HOLE CARDS ***
QvTX2yGq3uKJiKPmns4TKQ: calls $0.25
oAzQdB2jFOH1NxFUPjYUGg: folds 
b4wRQV3APH8irVk6bUFe2Q: folds 
euswrBD1XG0Q5hB1iGJBKQ: calls $0.15
eHsmIvAb2JREg4O6hNPnXg: checks 
*** FLOP *** [5c Ac 6c]
euswrBD1XG0Q5hB1iGJBKQ: checks 
eL3+wCBjFGfQ5FMdIZihwA joins the table at seat #6 
eHsmIvAb2JREg4O6hNPnXg: bets $0.25
QvTX2yGq3uKJiKPmns4TKQ: folds 
euswrBD1XG0Q5hB1iGJBKQ: calls $0.25
*** TURN *** [5c Ac 6c] [4s]
euswrBD1XG0Q5hB1iGJBKQ: checks 
eHsmIvAb2JREg4O6hNPnXg: checks 
*** RIVER *** [5c Ac 6c 4s] [3h]
euswrBD1XG0Q5hB1iGJBKQ: bets $1.50
eHsmIvAb2JREg4O6hNPnXg: folds 
Uncalled bet ($1.50) returned to euswrBD1XG0Q5hB1iGJBKQ
euswrBD1XG0Q5hB1iGJBKQ collected $1.20 from pot
euswrBD1XG0Q5hB1iGJBKQ: doesn't show hand 
*** SUMMARY ***
Total pot $1.25 | Rake $0.05 
Board [5c Ac 6c 4s 3h]
Seat 1: eHsmIvAb2JREg4O6hNPnXg (big blind) folded on the River
Seat 2: QvTX2yGq3uKJiKPmns4TKQ folded on the Flop
Seat 3: oAzQdB2jFOH1NxFUPjYUGg folded before Flop (didn't bet)
Seat 4: b4wRQV3APH8irVk6bUFe2Q (button) folded before Flop (didn't bet)
Seat 5: euswrBD1XG0Q5hB1iGJBKQ (small blind) collected ($1.20)




PokerStars Game #59941725252:  Hold'em No Limit ($0.10/$0.25) - 2009/07/01 1:44:11 ET
Table 'T/iCKJXGphRN3xcdwfE/JQ' 6-max Seat #4 is the button
Seat 1: wAKC8C/zN0c8V5v13dm9mA ($25 in chips) 
Seat 2: EeUZtMU058v2ObUACOF4Og ($36.30 in chips) 
Seat 3: IWAjoCPXtc1XUaZdp+pCpA ($23.35 in chips) 
Seat 4: tSR4329m40dZsN7YOpI9Kw ($52.95 in chips) 
Seat 5: gaPMxLGp9SOj4Lq6t+/0Ig ($3.95 in chips) 
Seat 6: Ey4Kn6PlnYb2srYYBJHvzg ($13.55 in chips) 
gaPMxLGp9SOj4Lq6t+/0Ig: posts small blind $0.10
Ey4Kn6PlnYb2srYYBJHvzg: posts big blind $0.25
*** HOLE CARDS ***
wAKC8C/zN0c8V5v13dm9mA: folds 
EeUZtMU058v2ObUACOF4Og: raises $0.75 to $1
IWAjoCPXtc1XUaZdp+pCpA: folds 
tSR4329m40dZsN7YOpI9Kw: folds 
gaPMxLGp9SOj4Lq6t+/0Ig: raises $2.95 to $3.95 and is all-in
Ey4Kn6PlnYb2srYYBJHvzg: folds 
EeUZtMU058v2ObUACOF4Og: calls $2.95
*** FLOP *** [Th Js 9d]
*** TURN *** [Th Js 9d] [Jh]
*** RIVER *** [Th Js 9d Jh] [Kd]
*** SHOW DOWN ***
gaPMxLGp9SOj4Lq6t+/0Ig: shows [Kh Jd] (a full house, Jacks full of Kings)
EeUZtMU058v2ObUACOF4Og: shows [Qd Qh] (a straight, Nine to King)
gaPMxLGp9SOj4Lq6t+/0Ig collected $7.75 from pot
*** SUMMARY ***
Total pot $8.15 | Rake $0.40 
Board [Th Js 9d Jh Kd]
Seat 1: wAKC8C/zN0c8V5v13dm9mA folded before Flop (didn't bet)
Seat 2: EeUZtMU058v2ObUACOF4Og showed [Qd Qh] and lost with a straight, Nine to King
Seat 3: IWAjoCPXtc1XUaZdp+pCpA folded before Flop (didn't bet)
Seat 4: tSR4329m40dZsN7YOpI9Kw (button) folded before Flop (didn't bet)
Seat 5: gaPMxLGp9SOj4Lq6t+/0Ig (small blind) showed [Kh Jd] and won ($7.75) with a full house, Jacks full of Kings
Seat 6: Ey4Kn6PlnYb2srYYBJHvzg (big blind) folded before Flop




PokerStars Game #59941725168:  Hold'em No Limit ($0.10/$0.25) - 2009/07/01 1:44:11 ET
Table '4hfTdIVT/qPsJNfWXLsVIw' 9-max Seat #3 is the button
Seat 1: GbHFBbLqLGz0Pwn6CJeAuw ($35.20 in chips) 
Seat 2: Pt637jKksB5MzP0UNJAAkw ($37.95 in chips) 
Seat 3: xnVwSkROfRtOw4eSoDANtw ($8.20 in chips) 
Seat 5: dtZ84flFEi4Q+SGrHMJRDQ ($25.20 in chips) 
Seat 6: VWUWpMLMj/Q1jRVpF7Aohw ($12.90 in chips) 
Seat 8: 7cv+9Zc9HIQHNvYsMfV3uA ($29 in chips) 
Seat 9: 9njEKzpOKC62MllUFUBWrA ($5.05 in chips) 
3PmVnC/15cl4oyI1TKIt4g will be allowed to play after the button
dtZ84flFEi4Q+SGrHMJRDQ: posts small blind $0.10
VWUWpMLMj/Q1jRVpF7Aohw: posts big blind $0.25
*** HOLE CARDS ***
7cv+9Zc9HIQHNvYsMfV3uA: folds 
9njEKzpOKC62MllUFUBWrA: calls $0.25
GbHFBbLqLGz0Pwn6CJeAuw: calls $0.25
Pt637jKksB5MzP0UNJAAkw: raises $0.75 to $1
xnVwSkROfRtOw4eSoDANtw: folds 
dtZ84flFEi4Q+SGrHMJRDQ: folds 
VWUWpMLMj/Q1jRVpF7Aohw: folds 
9njEKzpOKC62MllUFUBWrA: calls $0.75
GbHFBbLqLGz0Pwn6CJeAuw: calls $0.75
*** FLOP *** [9s Qc 5d]
9njEKzpOKC62MllUFUBWrA: checks 
GbHFBbLqLGz0Pwn6CJeAuw: bets $0.25
Pt637jKksB5MzP0UNJAAkw: calls $0.25
9njEKzpOKC62MllUFUBWrA: calls $0.25
*** TURN *** [9s Qc 5d] [4s]
9njEKzpOKC62MllUFUBWrA: bets $3.80 and is all-in
GbHFBbLqLGz0Pwn6CJeAuw: calls $3.80
Pt637jKksB5MzP0UNJAAkw: folds 
*** RIVER *** [9s Qc 5d 4s] [Jh]
*** SHOW DOWN ***
9njEKzpOKC62MllUFUBWrA: shows [Ad 9h] (a pair of Nines)
GbHFBbLqLGz0Pwn6CJeAuw: shows [Qd Qs] (three of a kind, Queens)
GbHFBbLqLGz0Pwn6CJeAuw collected $11.15 from pot
*** SUMMARY ***
Total pot $11.70 | Rake $0.55 
Board [9s Qc 5d 4s Jh]
Seat 1: GbHFBbLqLGz0Pwn6CJeAuw showed [Qd Qs] and won ($11.15) with three of a kind, Queens
Seat 2: Pt637jKksB5MzP0UNJAAkw folded on the Turn
Seat 3: xnVwSkROfRtOw4eSoDANtw (button) folded before Flop (didn't bet)
Seat 5: dtZ84flFEi4Q+SGrHMJRDQ (small blind) folded before Flop
Seat 6: VWUWpMLMj/Q1jRVpF7Aohw (big blind) folded before Flop
Seat 8: 7cv+9Zc9HIQHNvYsMfV3uA folded before Flop (didn't bet)
Seat 9: 9njEKzpOKC62MllUFUBWrA showed [Ad 9h] and lost with a pair of Nines




PokerStars Game #59941726054:  Hold'em No Limit ($0.10/$0.25) - 2009/07/01 1:44:12 ET
Table 'HIOfhT0zga/KonFhIl6O3w' 9-max Seat #9 is the button
Seat 1: oLa/tXLfSLLB28mcLGrxcg ($24.15 in chips) 
Seat 2: er86weqXTpTB6/w2dKlYgA ($17.25 in chips) 
Seat 4: qwr38jl5txoR36M7G5qi4A ($8.65 in chips) 
Seat 5: K1MDeapSEyKyGPNZGOKfEg ($38.10 in chips) 
Seat 6: MThMMgdB293VOucmN9sliQ ($25.45 in chips) 
Seat 7: wvlPJBB0PtYkfeeSRDaIvQ ($13.45 in chips) 
Seat 9: dfNim92Z6XK1/h5SFW5vDg ($28.70 in chips) 
oLa/tXLfSLLB28mcLGrxcg: posts small blind $0.10
er86weqXTpTB6/w2dKlYgA: posts big blind $0.25
X6+pSIPfovPcE87t+LmUKQ: sits out 
SpiiQQAzy4MUgV3I5W8giw: sits out 
*** HOLE CARDS ***
qwr38jl5txoR36M7G5qi4A: folds 
K1MDeapSEyKyGPNZGOKfEg: calls $0.25
MThMMgdB293VOucmN9sliQ: folds 
wvlPJBB0PtYkfeeSRDaIvQ: folds 
dfNim92Z6XK1/h5SFW5vDg: folds 
oLa/tXLfSLLB28mcLGrxcg: calls $0.15
er86weqXTpTB6/w2dKlYgA: checks 
*** FLOP *** [Qh 8s 3c]
oLa/tXLfSLLB28mcLGrxcg: bets $0.25
er86weqXTpTB6/w2dKlYgA: folds 
K1MDeapSEyKyGPNZGOKfEg: calls $0.25
*** TURN *** [Qh 8s 3c] [5d]
oLa/tXLfSLLB28mcLGrxcg: bets $0.25
K1MDeapSEyKyGPNZGOKfEg: calls $0.25
*** RIVER *** [Qh 8s 3c 5d] [Ah]
oLa/tXLfSLLB28mcLGrxcg: bets $1.25
K1MDeapSEyKyGPNZGOKfEg: calls $1.25
*** SHOW DOWN ***
oLa/tXLfSLLB28mcLGrxcg: shows [8c As] (two pair, Aces and Eights)
K1MDeapSEyKyGPNZGOKfEg: mucks hand 
oLa/tXLfSLLB28mcLGrxcg collected $4.05 from pot
*** SUMMARY ***
Total pot $4.25 | Rake $0.20 
Board [Qh 8s 3c 5d Ah]
Seat 1: oLa/tXLfSLLB28mcLGrxcg (small blind) showed [8c As] and won ($4.05) with two pair, Aces and Eights
Seat 2: er86weqXTpTB6/w2dKlYgA (big blind) folded on the Flop
Seat 4: qwr38jl5txoR36M7G5qi4A folded before Flop (didn't bet)
Seat 5: K1MDeapSEyKyGPNZGOKfEg mucked
Seat 6: MThMMgdB293VOucmN9sliQ folded before Flop (didn't bet)
Seat 7: wvlPJBB0PtYkfeeSRDaIvQ folded before Flop (didn't bet)
Seat 9: dfNim92Z6XK1/h5SFW5vDg (button) folded before Flop (didn't bet)




PokerStars Game #59941725794:  Hold'em No Limit ($0.10/$0.25) - 2009/07/01 1:44:12 ET
Table '3Ns9nuTkynfwbBfBXzg6ww' 6-max Seat #4 is the button
Seat 1: epAUIB7h2FJXzUPRIvSkRA ($25.35 in chips) 
Seat 2: zxeVQGaMKDsDzmSY+AInjA ($36.30 in chips) 
Seat 3: eL3+wCBjFGfQ5FMdIZihwA ($24.30 in chips) 
Seat 4: qGHGf/553gQnDoklMRe3tg ($30.60 in chips) 
Seat 5: wqphQtauX5Qn7WRJZS1flA ($25.40 in chips) 
Seat 6: DE9hRlt14g+JdsRQ4wT7hg ($33.55 in chips) 
wqphQtauX5Qn7WRJZS1flA: posts small blind $0.10
DE9hRlt14g+JdsRQ4wT7hg: posts big blind $0.25
*** HOLE CARDS ***
epAUIB7h2FJXzUPRIvSkRA: folds 
zxeVQGaMKDsDzmSY+AInjA: raises $0.50 to $0.75
eL3+wCBjFGfQ5FMdIZihwA: folds 
qGHGf/553gQnDoklMRe3tg: folds 
wqphQtauX5Qn7WRJZS1flA: folds 
DE9hRlt14g+JdsRQ4wT7hg: folds 
Uncalled bet ($0.50) returned to zxeVQGaMKDsDzmSY+AInjA
zxeVQGaMKDsDzmSY+AInjA collected $0.60 from pot
*** SUMMARY ***
Total pot $0.60 | Rake $0 
Seat 1: epAUIB7h2FJXzUPRIvSkRA folded before Flop (didn't bet)
Seat 2: zxeVQGaMKDsDzmSY+AInjA collected ($0.60)
Seat 3: eL3+wCBjFGfQ5FMdIZihwA folded before Flop (didn't bet)
Seat 4: qGHGf/553gQnDoklMRe3tg (button) folded before Flop (didn't bet)
Seat 5: wqphQtauX5Qn7WRJZS1flA (small blind) folded before Flop
Seat 6: DE9hRlt14g+JdsRQ4wT7hg (big blind) folded before Flop




PokerStars Game #59941725606:  Hold'em No Limit ($0.10/$0.25) - 2009/07/01 1:44:12 ET
Table 'vud0GB/ZlDCvUFhBFIaTlg' 9-max Seat #6 is the button
Seat 1: DiSvPC2iudwL5j9u6Huyww ($28.50 in chips) 
Seat 2: tLcDklc2rBORNfixyRfVfw ($26.30 in chips) 
Seat 3: W2YYHvqjaEpRrO7stZkClQ ($4.30 in chips) 
Seat 4: dWgEDExmVO0d+rRmUYCU5w ($15.60 in chips) 
Seat 5: eK8qa6EPcH2zhtbmWSvc9g ($25 in chips) 
Seat 6: gehe91e0IyVT0QU/XBkEyg ($24.90 in chips) 
Seat 7: iG7VeTyBWf6wYNvZpbTcbw ($16.85 in chips) 
Seat 9: PdIasPkzm2sqZnN41ZRXOg ($5.70 in chips) 
iG7VeTyBWf6wYNvZpbTcbw: posts small blind $0.10
PdIasPkzm2sqZnN41ZRXOg: posts big blind $0.25
*** HOLE CARDS ***
VegasVas joins the table at seat #8 
DiSvPC2iudwL5j9u6Huyww: folds 
tLcDklc2rBORNfixyRfVfw: folds 
W2YYHvqjaEpRrO7stZkClQ: folds 
dWgEDExmVO0d+rRmUYCU5w: calls $0.25
eK8qa6EPcH2zhtbmWSvc9g: folds 
gehe91e0IyVT0QU/XBkEyg: raises $0.75 to $1
iG7VeTyBWf6wYNvZpbTcbw: calls $0.90
PdIasPkzm2sqZnN41ZRXOg: folds 
dWgEDExmVO0d+rRmUYCU5w: folds 
*** FLOP *** [Kd 8h 3d]
iG7VeTyBWf6wYNvZpbTcbw: checks 
gehe91e0IyVT0QU/XBkEyg: bets $2
iG7VeTyBWf6wYNvZpbTcbw: raises $3 to $5
gehe91e0IyVT0QU/XBkEyg: folds 
Uncalled bet ($3) returned to iG7VeTyBWf6wYNvZpbTcbw
iG7VeTyBWf6wYNvZpbTcbw collected $6.20 from pot
*** SUMMARY ***
Total pot $6.50 | Rake $0.30 
Board [Kd 8h 3d]
Seat 1: DiSvPC2iudwL5j9u6Huyww folded before Flop (didn't bet)
Seat 2: tLcDklc2rBORNfixyRfVfw folded before Flop (didn't bet)
Seat 3: W2YYHvqjaEpRrO7stZkClQ folded before Flop (didn't bet)
Seat 4: dWgEDExmVO0d+rRmUYCU5w folded before Flop
Seat 5: eK8qa6EPcH2zhtbmWSvc9g folded before Flop (didn't bet)
Seat 6: gehe91e0IyVT0QU/XBkEyg (button) folded on the Flop
Seat 7: iG7VeTyBWf6wYNvZpbTcbw (small blind) collected ($6.20)
Seat 9: PdIasPkzm2sqZnN41ZRXOg (big blind) folded before Flop




PokerStars Game #59941726206:  Hold'em No Limit ($0.10/$0.25) - 2009/07/01 1:44:13 ET
Table 'G26g8jde1eR+mmabeFeSlw' 9-max Seat #5 is the button
Seat 1: qpG9m8I+cPw8VhB0mnGjYw ($29.40 in chips) 
Seat 2: BFYwQ0J4xWUQvouudojivA ($15.35 in chips) 
Seat 3: WKL8nUFr7TumC4EjLyqYzw ($6.50 in chips) 
Seat 4: 8EbrQ/EvFWt2cr0GaU82gQ ($4.65 in chips) 
Seat 5: hJ4uYjNmSZdjrKA8cjZqCA ($30.70 in chips) 
Seat 6: AHGkesF/mi4sDMpqrxBUoA ($8.80 in chips) 
Seat 7: nm4Dj/f+jJEwKVsUnKh73g ($39.85 in chips) 
Seat 9: VWUWpMLMj/Q1jRVpF7Aohw ($13.65 in chips) 
AHGkesF/mi4sDMpqrxBUoA: posts small blind $0.10
nm4Dj/f+jJEwKVsUnKh73g: posts big blind $0.25
CvL9Ch1HYCVbTsfpNucitg: sits out 
*** HOLE CARDS ***
VWUWpMLMj/Q1jRVpF7Aohw: folds 
qpG9m8I+cPw8VhB0mnGjYw: calls $0.25
BFYwQ0J4xWUQvouudojivA: folds 
WKL8nUFr7TumC4EjLyqYzw: folds 
8EbrQ/EvFWt2cr0GaU82gQ: folds 
hJ4uYjNmSZdjrKA8cjZqCA: folds 
AHGkesF/mi4sDMpqrxBUoA: calls $0.15
nm4Dj/f+jJEwKVsUnKh73g: checks 
*** FLOP *** [2h 5d 3s]
AHGkesF/mi4sDMpqrxBUoA: checks 
nm4Dj/f+jJEwKVsUnKh73g: checks 
qpG9m8I+cPw8VhB0mnGjYw: checks 
*** TURN *** [2h 5d 3s] [Ac]
AHGkesF/mi4sDMpqrxBUoA: checks 
nm4Dj/f+jJEwKVsUnKh73g: bets $0.50
qpG9m8I+cPw8VhB0mnGjYw: folds 
AHGkesF/mi4sDMpqrxBUoA: folds 
Uncalled bet ($0.50) returned to nm4Dj/f+jJEwKVsUnKh73g
nm4Dj/f+jJEwKVsUnKh73g collected $0.75 from pot
*** SUMMARY ***
Total pot $0.75 | Rake $0 
Board [2h 5d 3s Ac]
Seat 1: qpG9m8I+cPw8VhB0mnGjYw folded on the Turn
Seat 2: BFYwQ0J4xWUQvouudojivA folded before Flop (didn't bet)
Seat 3: WKL8nUFr7TumC4EjLyqYzw folded before Flop (didn't bet)
Seat 4: 8EbrQ/EvFWt2cr0GaU82gQ folded before Flop (didn't bet)
Seat 5: hJ4uYjNmSZdjrKA8cjZqCA (button) folded before Flop (didn't bet)
Seat 6: AHGkesF/mi4sDMpqrxBUoA (small blind) folded on the Turn
Seat 7: nm4Dj/f+jJEwKVsUnKh73g (big blind) collected ($0.75)
Seat 9: VWUWpMLMj/Q1jRVpF7Aohw folded before Flop (didn't bet)




PokerStars Game #59941726654:  Hold'em No Limit ($0.10/$0.25) - 2009/07/01 1:44:13 ET
Table 'VuY5ej47Cy8nOI3Wogmhzw' 6-max Seat #3 is the button
Seat 1: EeUZtMU058v2ObUACOF4Og ($37.85 in chips) 
Seat 2: AM6Yl+3esmhhMBlSnQhWbg ($18.10 in chips) 
Seat 3: v+QfkGiuj9bgtuNoVnDO8w ($29.30 in chips) 
Seat 4: QqiZLFrN8iOUT/GHw7ztOA ($25.10 in chips) 
Seat 5: iK/41//HmnLiIn0CVNNfyA ($12.70 in chips) 
QqiZLFrN8iOUT/GHw7ztOA: posts small blind $0.10
iK/41//HmnLiIn0CVNNfyA: posts big blind $0.25
+KblIivb6tainScpwm14RQ: sits out 
*** HOLE CARDS ***
EeUZtMU058v2ObUACOF4Og: folds 
AM6Yl+3esmhhMBlSnQhWbg: calls $0.25
v+QfkGiuj9bgtuNoVnDO8w: raises $1 to $1.25
QqiZLFrN8iOUT/GHw7ztOA: folds 
iK/41//HmnLiIn0CVNNfyA: calls $1
AM6Yl+3esmhhMBlSnQhWbg: folds 
*** FLOP *** [6h 9s Kh]
iK/41//HmnLiIn0CVNNfyA: checks 
v+QfkGiuj9bgtuNoVnDO8w: checks 
*** TURN *** [6h 9s Kh] [7d]
iK/41//HmnLiIn0CVNNfyA: checks 
v+QfkGiuj9bgtuNoVnDO8w: checks 
*** RIVER *** [6h 9s Kh 7d] [2c]
iK/41//HmnLiIn0CVNNfyA: bets $1.50
v+QfkGiuj9bgtuNoVnDO8w: folds 
Uncalled bet ($1.50) returned to iK/41//HmnLiIn0CVNNfyA
iK/41//HmnLiIn0CVNNfyA collected $2.75 from pot
iK/41//HmnLiIn0CVNNfyA: doesn't show hand 
*** SUMMARY ***
Total pot $2.85 | Rake $0.10 
Board [6h 9s Kh 7d 2c]
Seat 1: EeUZtMU058v2ObUACOF4Og folded before Flop (didn't bet)
Seat 2: AM6Yl+3esmhhMBlSnQhWbg folded before Flop
Seat 3: v+QfkGiuj9bgtuNoVnDO8w (button) folded on the River
Seat 4: QqiZLFrN8iOUT/GHw7ztOA (small blind) folded before Flop
Seat 5: iK/41//HmnLiIn0CVNNfyA (big blind) collected ($2.75)




PokerStars Game #59941726374:  Hold'em No Limit ($0.10/$0.25) - 2009/07/01 1:44:13 ET
Table '/JJyyIstHfkT7t/bW+WXgg' 6-max Seat #3 is the button
Seat 2: obJgSnVgWWWaAUtVILo77Q ($18.75 in chips) 
Seat 3: DR0nVIhVP77oEBlO9J8vlg ($34.65 in chips) 
Seat 4: JFIAqU8lCZ0vWwEl4bdGsg ($35.15 in chips) 
Seat 5: +ZlnqPoP3Hg4BIUxDfKd/A ($48.15 in chips) 
Seat 6: UmcUp27+PbgBItv3ZNlAWQ ($25 in chips) 
JFIAqU8lCZ0vWwEl4bdGsg: posts small blind $0.10
+ZlnqPoP3Hg4BIUxDfKd/A: posts big blind $0.25
*** HOLE CARDS ***
UmcUp27+PbgBItv3ZNlAWQ: folds 
obJgSnVgWWWaAUtVILo77Q: folds 
DR0nVIhVP77oEBlO9J8vlg: raises $0.50 to $0.75
JFIAqU8lCZ0vWwEl4bdGsg: folds 
+ZlnqPoP3Hg4BIUxDfKd/A: folds 
Uncalled bet ($0.50) returned to DR0nVIhVP77oEBlO9J8vlg
DR0nVIhVP77oEBlO9J8vlg collected $0.60 from pot
DR0nVIhVP77oEBlO9J8vlg: doesn't show hand 
*** SUMMARY ***
Total pot $0.60 | Rake $0 
Seat 2: obJgSnVgWWWaAUtVILo77Q folded before Flop (didn't bet)
Seat 3: DR0nVIhVP77oEBlO9J8vlg (button) collected ($0.60)
Seat 4: JFIAqU8lCZ0vWwEl4bdGsg (small blind) folded before Flop
Seat 5: +ZlnqPoP3Hg4BIUxDfKd/A (big blind) folded before Flop
Seat 6: UmcUp27+PbgBItv3ZNlAWQ folded before Flop (didn't bet)




PokerStars Game #59941726500:  Hold'em No Limit ($0.10/$0.25) - 2009/07/01 1:44:13 ET
Table 'dVzscin98UhGisTmV9BDcw' 9-max Seat #2 is the button
Seat 1: sBAwXpkpgyhyWbHIQcIJKA ($17.55 in chips) 
Seat 2: dfNim92Z6XK1/h5SFW5vDg ($28.25 in chips) 
Seat 3: cZ99hugmLBj9KhTlc8nCSw ($25 in chips) 
Seat 4: aNpwfA31EREwO+ar4XzBCw ($42.25 in chips) 
Seat 5: 22dIObOuor/A+IKWkNoAlA ($10.10 in chips) 
Seat 6: bXpVeaSTPBFSPJmeXxO7nw ($8.30 in chips) 
Seat 7: cKlmpQMahVsmOaxFQDcoOg ($24.65 in chips) 
Seat 8: /vn2Qu2dvc9AMMq46Ae0jA ($44.40 in chips) 
Seat 9: arxNSjreDRGFg13EAM2F1w ($25.35 in chips) 
cZ99hugmLBj9KhTlc8nCSw: posts small blind $0.10
aNpwfA31EREwO+ar4XzBCw: posts big blind $0.25
*** HOLE CARDS ***
22dIObOuor/A+IKWkNoAlA: folds 
bXpVeaSTPBFSPJmeXxO7nw: folds 
cKlmpQMahVsmOaxFQDcoOg: folds 
/vn2Qu2dvc9AMMq46Ae0jA: folds 
arxNSjreDRGFg13EAM2F1w: folds 
sBAwXpkpgyhyWbHIQcIJKA: folds 
dfNim92Z6XK1/h5SFW5vDg: folds 
22dIObOuor/A+IKWkNoAlA is sitting out
22dIObOuor/A+IKWkNoAlA leaves the table
cZ99hugmLBj9KhTlc8nCSw: folds 
Uncalled bet ($0.15) returned to aNpwfA31EREwO+ar4XzBCw
aNpwfA31EREwO+ar4XzBCw collected $0.20 from pot
aNpwfA31EREwO+ar4XzBCw: doesn't show hand 
*** SUMMARY ***
Total pot $0.20 | Rake $0 
Seat 1: sBAwXpkpgyhyWbHIQcIJKA folded before Flop (didn't bet)
Seat 2: dfNim92Z6XK1/h5SFW5vDg (button) folded before Flop (didn't bet)
Seat 3: cZ99hugmLBj9KhTlc8nCSw (small blind) folded before Flop
Seat 4: aNpwfA31EREwO+ar4XzBCw (big blind) collected ($0.20)
Seat 5: 22dIObOuor/A+IKWkNoAlA folded before Flop (didn't bet)
Seat 6: bXpVeaSTPBFSPJmeXxO7nw folded before Flop (didn't bet)
Seat 7: cKlmpQMahVsmOaxFQDcoOg folded before Flop (didn't bet)
Seat 8: /vn2Qu2dvc9AMMq46Ae0jA folded before Flop (didn't bet)
Seat 9: arxNSjreDRGFg13EAM2F1w folded before Flop (didn't bet)




PokerStars Game #59941726712:  Hold'em No Limit ($0.10/$0.25) - 2009/07/01 1:44:14 ET
Table '+68ihX5Br1xgGorX6zsCBg' 9-max Seat #9 is the button
Seat 1: IFB2mhulUVYIbb+KWwDC9w ($4.20 in chips) 
Seat 2: TeAfhXG1R60d8yPEHN3JiA ($27.05 in chips) 
Seat 3: PdIasPkzm2sqZnN41ZRXOg ($5 in chips) 
Seat 4: Oi0EiPIjriUb/6zT65YeWA ($26.95 in chips) 
Seat 5: ghNKXUBl/H+t83JF079ZBA ($29 in chips) 
Seat 6: X78b5v/uhqeXXoAijbw/yg ($26.40 in chips) 
Seat 7: V6p0jQ/RhUsqpHLmXvEX4Q ($14.35 in chips) 
Seat 8: Ut3g/kEEdCCbe/gbWrHnDg ($8.55 in chips) 
Seat 9: DiSvPC2iudwL5j9u6Huyww ($32.75 in chips) 
IFB2mhulUVYIbb+KWwDC9w: posts small blind $0.10
TeAfhXG1R60d8yPEHN3JiA: posts big blind $0.25
*** HOLE CARDS ***
PdIasPkzm2sqZnN41ZRXOg: folds 
Oi0EiPIjriUb/6zT65YeWA: folds 
ghNKXUBl/H+t83JF079ZBA: folds 
X78b5v/uhqeXXoAijbw/yg: folds 
V6p0jQ/RhUsqpHLmXvEX4Q: folds 
Ut3g/kEEdCCbe/gbWrHnDg: calls $0.25
DiSvPC2iudwL5j9u6Huyww: folds 
IFB2mhulUVYIbb+KWwDC9w: calls $0.15
TeAfhXG1R60d8yPEHN3JiA: checks 
*** FLOP *** [8c 3h Jd]
IFB2mhulUVYIbb+KWwDC9w: checks 
TeAfhXG1R60d8yPEHN3JiA: bets $0.50
Ut3g/kEEdCCbe/gbWrHnDg: calls $0.50
IFB2mhulUVYIbb+KWwDC9w: folds 
*** TURN *** [8c 3h Jd] [5d]
TeAfhXG1R60d8yPEHN3JiA: bets $1
Ut3g/kEEdCCbe/gbWrHnDg: calls $1
*** RIVER *** [8c 3h Jd 5d] [Kc]
TeAfhXG1R60d8yPEHN3JiA: checks 
Ut3g/kEEdCCbe/gbWrHnDg: checks 
*** SHOW DOWN ***
TeAfhXG1R60d8yPEHN3JiA: shows [2s 8h] (a pair of Eights)
Ut3g/kEEdCCbe/gbWrHnDg: mucks hand 
TeAfhXG1R60d8yPEHN3JiA collected $3.60 from pot
*** SUMMARY ***
Total pot $3.75 | Rake $0.15 
Board [8c 3h Jd 5d Kc]
Seat 1: IFB2mhulUVYIbb+KWwDC9w (small blind) folded on the Flop
Seat 2: TeAfhXG1R60d8yPEHN3JiA (big blind) showed [2s 8h] and won ($3.60) with a pair of Eights
Seat 3: PdIasPkzm2sqZnN41ZRXOg folded before Flop (didn't bet)
Seat 4: Oi0EiPIjriUb/6zT65YeWA folded before Flop (didn't bet)
Seat 5: ghNKXUBl/H+t83JF079ZBA folded before Flop (didn't bet)
Seat 6: X78b5v/uhqeXXoAijbw/yg folded before Flop (didn't bet)
Seat 7: V6p0jQ/RhUsqpHLmXvEX4Q folded before Flop (didn't bet)
Seat 8: Ut3g/kEEdCCbe/gbWrHnDg mucked
Seat 9: DiSvPC2iudwL5j9u6Huyww (button) folded before Flop (didn't bet)




PokerStars Game #59941727238:  Hold'em No Limit ($0.10/$0.25) - 2009/07/01 1:44:14 ET
Table '3lS+sU5k6mwJCS2nFMmQ6Q' 9-max Seat #5 is the button
Seat 1: VWUWpMLMj/Q1jRVpF7Aohw ($13.45 in chips) 
Seat 3: 1DXccE2UUK5DIRVGlOKnTA ($11.95 in chips) 
Seat 4: ydoFOVgzvZv9ZhuWu9rXAw ($10.70 in chips) 
Seat 5: NcPAt5YjVvDFEJTTgAVj8g ($5.75 in chips) 
Seat 6: hJ4uYjNmSZdjrKA8cjZqCA ($36.25 in chips) 
Seat 7: Th3FldXKQW6hWVVPahaoOQ ($30.85 in chips) 
Seat 8: 9lvO/qyU+xrU95Teu1fv0g ($5 in chips) 
Seat 9: 4awUyiDYTgylQKXZ9faBVA ($49.20 in chips) 
hJ4uYjNmSZdjrKA8cjZqCA: posts small blind $0.10
Th3FldXKQW6hWVVPahaoOQ: posts big blind $0.25
PdIasPkzm2sqZnN41ZRXOg: sits out 
*** HOLE CARDS ***
9lvO/qyU+xrU95Teu1fv0g: folds 
4awUyiDYTgylQKXZ9faBVA: folds 
VWUWpMLMj/Q1jRVpF7Aohw: folds 
1DXccE2UUK5DIRVGlOKnTA: folds 
ydoFOVgzvZv9ZhuWu9rXAw: folds 
NcPAt5YjVvDFEJTTgAVj8g: folds 
hJ4uYjNmSZdjrKA8cjZqCA: calls $0.15
Th3FldXKQW6hWVVPahaoOQ: checks 
*** FLOP *** [4c 8c 9h]
hJ4uYjNmSZdjrKA8cjZqCA: checks 
Th3FldXKQW6hWVVPahaoOQ: checks 
*** TURN *** [4c 8c 9h] [6c]
hJ4uYjNmSZdjrKA8cjZqCA: checks 
Th3FldXKQW6hWVVPahaoOQ: checks 
*** RIVER *** [4c 8c 9h 6c] [5d]
hJ4uYjNmSZdjrKA8cjZqCA: checks 
Th3FldXKQW6hWVVPahaoOQ: bets $0.25
hJ4uYjNmSZdjrKA8cjZqCA: calls $0.25
*** SHOW DOWN ***
Th3FldXKQW6hWVVPahaoOQ: shows [Js 7s] (a straight, Five to Nine)
hJ4uYjNmSZdjrKA8cjZqCA: mucks hand 
Th3FldXKQW6hWVVPahaoOQ collected $0.95 from pot
*** SUMMARY ***
Total pot $1 | Rake $0.05 
Board [4c 8c 9h 6c 5d]
Seat 1: VWUWpMLMj/Q1jRVpF7Aohw folded before Flop (didn't bet)
Seat 3: 1DXccE2UUK5DIRVGlOKnTA folded before Flop (didn't bet)
Seat 4: ydoFOVgzvZv9ZhuWu9rXAw folded before Flop (didn't bet)
Seat 5: NcPAt5YjVvDFEJTTgAVj8g (button) folded before Flop (didn't bet)
Seat 6: hJ4uYjNmSZdjrKA8cjZqCA (small blind) mucked
Seat 7: Th3FldXKQW6hWVVPahaoOQ (big blind) showed [Js 7s] and won ($0.95) with a straight, Five to Nine
Seat 8: 9lvO/qyU+xrU95Teu1fv0g folded before Flop (didn't bet)
Seat 9: 4awUyiDYTgylQKXZ9faBVA folded before Flop (didn't bet)




PokerStars Game #59941727066:  Hold'em No Limit ($0.10/$0.25) - 2009/07/01 1:44:14 ET
Table '63uh7ZsO7Tnt+E8b/2bu3A' 6-max Seat #6 is the button
Seat 1: 0av6tRNdi0Ui4f15L7gsVg ($30.65 in chips) 
Seat 2: SFmT9ZsVopnukjvAzrxTRg ($28.70 in chips) 
Seat 3: yVP7GLZBzx47OPi6jzUxMw ($7.75 in chips) 
Seat 4: 2tYgzzRRW/D2GWb2A7f1jw ($15.40 in chips) 
Seat 5: GbCVUNssQ7mqsPWr7J4d3w ($4.40 in chips) 
Seat 6: qGHGf/553gQnDoklMRe3tg ($28.65 in chips) 
0av6tRNdi0Ui4f15L7gsVg: posts small blind $0.10
SFmT9ZsVopnukjvAzrxTRg: posts big blind $0.25
*** HOLE CARDS ***
yVP7GLZBzx47OPi6jzUxMw: folds 
2tYgzzRRW/D2GWb2A7f1jw: calls $0.25
GbCVUNssQ7mqsPWr7J4d3w: folds 
qGHGf/553gQnDoklMRe3tg: raises $1 to $1.25
0av6tRNdi0Ui4f15L7gsVg: folds 
SFmT9ZsVopnukjvAzrxTRg: folds 
2tYgzzRRW/D2GWb2A7f1jw: calls $1
*** FLOP *** [Th Qd 8c]
2tYgzzRRW/D2GWb2A7f1jw: checks 
qGHGf/553gQnDoklMRe3tg: bets $2
2tYgzzRRW/D2GWb2A7f1jw: folds 
Uncalled bet ($2) returned to qGHGf/553gQnDoklMRe3tg
qGHGf/553gQnDoklMRe3tg collected $2.75 from pot
*** SUMMARY ***
Total pot $2.85 | Rake $0.10 
Board [Th Qd 8c]
Seat 1: 0av6tRNdi0Ui4f15L7gsVg (small blind) folded before Flop
Seat 2: SFmT9ZsVopnukjvAzrxTRg (big blind) folded before Flop
Seat 3: yVP7GLZBzx47OPi6jzUxMw folded before Flop (didn't bet)
Seat 4: 2tYgzzRRW/D2GWb2A7f1jw folded on the Flop
Seat 5: GbCVUNssQ7mqsPWr7J4d3w folded before Flop (didn't bet)
Seat 6: qGHGf/553gQnDoklMRe3tg (button) collected ($2.75)




PokerStars Game #59941726738:  Hold'em No Limit ($0.10/$0.25) - 2009/07/01 1:44:14 ET
Table 'srBTB98reCdD1TffxE6o7g' 6-max Seat #6 is the button
Seat 1: SFmT9ZsVopnukjvAzrxTRg ($34.05 in chips) 
Seat 2: mfrkWA3PTeYPkbO6hi98Aw ($25 in chips) 
Seat 3: VOmI0x4dDPnTESZd5B4d1Q ($48.20 in chips) 
Seat 4: 6DwBRH+xZ12AAZmeAg+aXw ($16.55 in chips) 
Seat 5: 8zUCJvLYLFM8AG6K5zjIvg ($16.60 in chips) 
Seat 6: BV+K0Phf5VBHr7aZPKqbUQ ($34.60 in chips) 
SFmT9ZsVopnukjvAzrxTRg: posts small blind $0.10
mfrkWA3PTeYPkbO6hi98Aw: posts big blind $0.25
*** HOLE CARDS ***
VOmI0x4dDPnTESZd5B4d1Q: folds 
6DwBRH+xZ12AAZmeAg+aXw: folds 
8zUCJvLYLFM8AG6K5zjIvg: folds 
BV+K0Phf5VBHr7aZPKqbUQ: folds 
SFmT9ZsVopnukjvAzrxTRg: folds 
Uncalled bet ($0.15) returned to mfrkWA3PTeYPkbO6hi98Aw
mfrkWA3PTeYPkbO6hi98Aw collected $0.20 from pot
mfrkWA3PTeYPkbO6hi98Aw: doesn't show hand 
*** SUMMARY ***
Total pot $0.20 | Rake $0 
Seat 1: SFmT9ZsVopnukjvAzrxTRg (small blind) folded before Flop
Seat 2: mfrkWA3PTeYPkbO6hi98Aw (big blind) collected ($0.20)
Seat 3: VOmI0x4dDPnTESZd5B4d1Q folded before Flop (didn't bet)
Seat 4: 6DwBRH+xZ12AAZmeAg+aXw folded before Flop (didn't bet)
Seat 5: 8zUCJvLYLFM8AG6K5zjIvg folded before Flop (didn't bet)
Seat 6: BV+K0Phf5VBHr7aZPKqbUQ (button) folded before Flop (didn't bet)




PokerStars Game #59941727194:  Hold'em No Limit ($0.10/$0.25) - 2009/07/01 1:44:14 ET
Table 'jdhJTJjFq2KTttwJcd+7nQ' 6-max Seat #5 is the button
Seat 1: LtASJ9OlkqGrrUKGQlpGAw ($26.70 in chips) 
Seat 2: Hsvkc0/G2VV78oVmWYXecw ($5 in chips) 
Seat 3: vqWjZmdQu/Hxw96/IJTWdQ ($25.95 in chips) 
Seat 4: vx7FwRcelVSsvNYAdp/z0A ($7.15 in chips) 
Seat 5: BV+K0Phf5VBHr7aZPKqbUQ ($25.75 in chips) 
Seat 6: yb6rnd48JuBccThV68VHAQ ($16.50 in chips) 
yb6rnd48JuBccThV68VHAQ: posts small blind $0.10
LtASJ9OlkqGrrUKGQlpGAw: posts big blind $0.25
*** HOLE CARDS ***
Hsvkc0/G2VV78oVmWYXecw: folds 
vqWjZmdQu/Hxw96/IJTWdQ: folds 
vx7FwRcelVSsvNYAdp/z0A: folds 
BV+K0Phf5VBHr7aZPKqbUQ: folds 
yb6rnd48JuBccThV68VHAQ: calls $0.15
LtASJ9OlkqGrrUKGQlpGAw: raises $0.75 to $1
yb6rnd48JuBccThV68VHAQ: folds 
Uncalled bet ($0.75) returned to LtASJ9OlkqGrrUKGQlpGAw
LtASJ9OlkqGrrUKGQlpGAw collected $0.50 from pot
LtASJ9OlkqGrrUKGQlpGAw: doesn't show hand 
*** SUMMARY ***
Total pot $0.50 | Rake $0 
Seat 1: LtASJ9OlkqGrrUKGQlpGAw (big blind) collected ($0.50)
Seat 2: Hsvkc0/G2VV78oVmWYXecw folded before Flop (didn't bet)
Seat 3: vqWjZmdQu/Hxw96/IJTWdQ folded before Flop (didn't bet)
Seat 4: vx7FwRcelVSsvNYAdp/z0A folded before Flop (didn't bet)
Seat 5: BV+K0Phf5VBHr7aZPKqbUQ (button) folded before Flop (didn't bet)
Seat 6: yb6rnd48JuBccThV68VHAQ (small blind) folded before Flop




PokerStars Game #59941727090:  Hold'em No Limit ($0.10/$0.25) - 2009/07/01 1:44:14 ET
Table 'KEoOIegxPF91KooL2AelUA' 6-max Seat #3 is the button
Seat 1: wsP46AGpqDjHZQmlRHKa9g ($42.25 in chips) 
Seat 2: 0Bg59Tnte1Tc7C4i9Jd9cQ ($7.90 in chips) 
Seat 3: zxeVQGaMKDsDzmSY+AInjA ($10.70 in chips) 
Seat 4: Wo60l2GQnSEc3bxPVyvIUw ($16.60 in chips) 
Seat 5: 08V++DOqzaNrRNsHIwi25w ($44.70 in chips) 
Seat 6: AMrBn4Vx9aAo/vv6WHLk6w ($3.15 in chips) 
Wo60l2GQnSEc3bxPVyvIUw: posts small blind $0.10
08V++DOqzaNrRNsHIwi25w: posts big blind $0.25
*** HOLE CARDS ***
AMrBn4Vx9aAo/vv6WHLk6w: folds 
wsP46AGpqDjHZQmlRHKa9g: folds 
0Bg59Tnte1Tc7C4i9Jd9cQ: folds 
zxeVQGaMKDsDzmSY+AInjA: folds 
Wo60l2GQnSEc3bxPVyvIUw: calls $0.15
08V++DOqzaNrRNsHIwi25w: raises $0.75 to $1
Wo60l2GQnSEc3bxPVyvIUw: calls $0.75
*** FLOP *** [Ac Kd Qc]
Wo60l2GQnSEc3bxPVyvIUw: checks 
08V++DOqzaNrRNsHIwi25w: bets $1.25
Wo60l2GQnSEc3bxPVyvIUw: calls $1.25
*** TURN *** [Ac Kd Qc] [8h]
Wo60l2GQnSEc3bxPVyvIUw: checks 
08V++DOqzaNrRNsHIwi25w: bets $3
Wo60l2GQnSEc3bxPVyvIUw: calls $3
*** RIVER *** [Ac Kd Qc 8h] [5c]
Wo60l2GQnSEc3bxPVyvIUw: checks 
08V++DOqzaNrRNsHIwi25w: checks 
*** SHOW DOWN ***
Wo60l2GQnSEc3bxPVyvIUw: shows [Qd 3c] (a pair of Queens)
08V++DOqzaNrRNsHIwi25w: shows [Ad 8s] (two pair, Aces and Eights)
08V++DOqzaNrRNsHIwi25w collected $10 from pot
*** SUMMARY ***
Total pot $10.50 | Rake $0.50 
Board [Ac Kd Qc 8h 5c]
Seat 1: wsP46AGpqDjHZQmlRHKa9g folded before Flop (didn't bet)
Seat 2: 0Bg59Tnte1Tc7C4i9Jd9cQ folded before Flop (didn't bet)
Seat 3: zxeVQGaMKDsDzmSY+AInjA (button) folded before Flop (didn't bet)
Seat 4: Wo60l2GQnSEc3bxPVyvIUw (small blind) showed [Qd 3c] and lost with a pair of Queens
Seat 5: 08V++DOqzaNrRNsHIwi25w (big blind) showed [Ad 8s] and won ($10) with two pair, Aces and Eights
Seat 6: AMrBn4Vx9aAo/vv6WHLk6w folded before Flop (didn't bet)




PokerStars Game #59941727242:  Hold'em No Limit ($0.10/$0.25) - 2009/07/01 1:44:14 ET
Table 'KYX9dFNuOA9l2PV46IebqQ' 9-max Seat #5 is the button
Seat 2: z2SmIaQ3+5n/eY1BN5HgPg ($6.25 in chips) 
Seat 3: Uq3NSX4cIFaXe7pbXQuU+Q ($9.80 in chips) 
Seat 4: rPXwQUVloUl+qZm3CCtaJw ($9.05 in chips) 
Seat 5: g7MXhRmNZxv1lIkKkUKa4w ($13.25 in chips) 
Seat 8: KRWTiGM4xH+MkvPtJz4+SA ($24.75 in chips) 
Seat 9: 6NECk10orj8iqgD3pZ2A0Q ($5 in chips) 
4QYM+pWPc3J+6i8Zv8LvLg will be allowed to play after the button
KRWTiGM4xH+MkvPtJz4+SA: posts small blind $0.10
6NECk10orj8iqgD3pZ2A0Q: posts big blind $0.25
qZqVFan2U+GAA/c5LQFbcw: sits out 
*** HOLE CARDS ***
FVZtQJMz59M6BoiON/88Xg joins the table at seat #7 
z2SmIaQ3+5n/eY1BN5HgPg: folds 
Uq3NSX4cIFaXe7pbXQuU+Q: folds 
rPXwQUVloUl+qZm3CCtaJw: folds 
g7MXhRmNZxv1lIkKkUKa4w: folds 
KRWTiGM4xH+MkvPtJz4+SA: folds 
Uncalled bet ($0.15) returned to 6NECk10orj8iqgD3pZ2A0Q
6NECk10orj8iqgD3pZ2A0Q collected $0.20 from pot
6NECk10orj8iqgD3pZ2A0Q: doesn't show hand 
*** SUMMARY ***
Total pot $0.20 | Rake $0 
Seat 2: z2SmIaQ3+5n/eY1BN5HgPg folded before Flop (didn't bet)
Seat 3: Uq3NSX4cIFaXe7pbXQuU+Q folded before Flop (didn't bet)
Seat 4: rPXwQUVloUl+qZm3CCtaJw folded before Flop (didn't bet)
Seat 5: g7MXhRmNZxv1lIkKkUKa4w (button) folded before Flop (didn't bet)
Seat 8: KRWTiGM4xH+MkvPtJz4+SA (small blind) folded before Flop
Seat 9: 6NECk10orj8iqgD3pZ2A0Q (big blind) collected ($0.20)




PokerStars Game #59941727264:  Hold'em No Limit ($0.10/$0.25) - 2009/07/01 1:44:15 ET
Table 'JJzUs04lHpXg6nboT1/jeg' 6-max Seat #3 is the button
Seat 1: MqMK8OWPSY1V4stf1Hy5Jw ($38.95 in chips) 
Seat 2: jxfR29d+dK/7h7s3SvCk+g ($6.70 in chips) 
Seat 3: 4zXbHDe39qNX46dAo81b4w ($7.30 in chips) 
Seat 4: 7VfhiFY533nbUKvyEthASw ($29.60 in chips) 
Seat 5: QvTX2yGq3uKJiKPmns4TKQ ($20.75 in chips) 
Seat 6: wqphQtauX5Qn7WRJZS1flA ($29.30 in chips) 
7VfhiFY533nbUKvyEthASw: posts small blind $0.10
QvTX2yGq3uKJiKPmns4TKQ: posts big blind $0.25
*** HOLE CARDS ***
wqphQtauX5Qn7WRJZS1flA: folds 
MqMK8OWPSY1V4stf1Hy5Jw: folds 
jxfR29d+dK/7h7s3SvCk+g: folds 
4zXbHDe39qNX46dAo81b4w: folds 
7VfhiFY533nbUKvyEthASw: folds 
Uncalled bet ($0.15) returned to QvTX2yGq3uKJiKPmns4TKQ
QvTX2yGq3uKJiKPmns4TKQ collected $0.20 from pot
QvTX2yGq3uKJiKPmns4TKQ: doesn't show hand 
*** SUMMARY ***
Total pot $0.20 | Rake $0 
Seat 1: MqMK8OWPSY1V4stf1Hy5Jw folded before Flop (didn't bet)
Seat 2: jxfR29d+dK/7h7s3SvCk+g folded before Flop (didn't bet)
Seat 3: 4zXbHDe39qNX46dAo81b4w (button) folded before Flop (didn't bet)
Seat 4: 7VfhiFY533nbUKvyEthASw (small blind) folded before Flop
Seat 5: QvTX2yGq3uKJiKPmns4TKQ (big blind) collected ($0.20)
Seat 6: wqphQtauX5Qn7WRJZS1flA folded before Flop (didn't bet)




PokerStars Game #59941727390:  Hold'em No Limit ($0.10/$0.25) - 2009/07/01 1:44:15 ET
Table 'xmJKTGBeWCwutccj3YfupQ' 6-max Seat #1 is the button
Seat 1: sVbkVl4OznxBCfi66UB9vw ($26.90 in chips) 
Seat 2: AxhCSFlGEh+FAc+VUD31JQ ($17.70 in chips) 
Seat 3: T5wrp/d5jarm+SxNy8OQAg ($24.20 in chips) 
Seat 4: uWjhTVMpuIroxXcmD3Okug ($9.50 in chips) 
Seat 5: DE9hRlt14g+JdsRQ4wT7hg ($28.25 in chips) 
Seat 6: 9bpVv1/Qh9IYtXuCtl5VtQ ($24.65 in chips) 
AxhCSFlGEh+FAc+VUD31JQ: posts small blind $0.10
T5wrp/d5jarm+SxNy8OQAg: posts big blind $0.25
*** HOLE CARDS ***
uWjhTVMpuIroxXcmD3Okug: folds 
DE9hRlt14g+JdsRQ4wT7hg: folds 
9bpVv1/Qh9IYtXuCtl5VtQ: folds 
sVbkVl4OznxBCfi66UB9vw: raises $0.45 to $0.70
AxhCSFlGEh+FAc+VUD31JQ: raises $1.55 to $2.25
T5wrp/d5jarm+SxNy8OQAg: folds 
sVbkVl4OznxBCfi66UB9vw: calls $1.55
*** FLOP *** [7h 2h Jd]
AxhCSFlGEh+FAc+VUD31JQ: bets $3.25
sVbkVl4OznxBCfi66UB9vw: calls $3.25
*** TURN *** [7h 2h Jd] [8h]
AxhCSFlGEh+FAc+VUD31JQ: bets $5
sVbkVl4OznxBCfi66UB9vw: calls $5
*** RIVER *** [7h 2h Jd 8h] [9d]
AxhCSFlGEh+FAc+VUD31JQ: bets $7.20 and is all-in
sVbkVl4OznxBCfi66UB9vw: calls $7.20
*** SHOW DOWN ***
AxhCSFlGEh+FAc+VUD31JQ: shows [Qc Kd] (high card King)
sVbkVl4OznxBCfi66UB9vw: shows [Kh 5h] (a flush, King high)
sVbkVl4OznxBCfi66UB9vw collected $33.95 from pot
*** SUMMARY ***
Total pot $35.65 | Rake $1.70 
Board [7h 2h Jd 8h 9d]
Seat 1: sVbkVl4OznxBCfi66UB9vw (button) showed [Kh 5h] and won ($33.95) with a flush, King high
Seat 2: AxhCSFlGEh+FAc+VUD31JQ (small blind) showed [Qc Kd] and lost with high card King
Seat 3: T5wrp/d5jarm+SxNy8OQAg (big blind) folded before Flop
Seat 4: uWjhTVMpuIroxXcmD3Okug folded before Flop (didn't bet)
Seat 5: DE9hRlt14g+JdsRQ4wT7hg folded before Flop (didn't bet)
Seat 6: 9bpVv1/Qh9IYtXuCtl5VtQ folded before Flop (didn't bet)




PokerStars Game #59941727550:  Hold'em No Limit ($0.10/$0.25) - 2009/07/01 1:44:15 ET
Table 'gnrUwXkIPE0C8xl6cB4Hyw' 9-max Seat #8 is the button
Seat 1: EQXHDnIzAsORnIXRNtXRlA ($22.60 in chips) 
Seat 2: 7je+LC5Mfs6nL8YBVh4frQ ($5 in chips) 
Seat 3: PdIasPkzm2sqZnN41ZRXOg ($5 in chips) 
Seat 4: wGigCmBR/9XWkPpvYos3aQ ($25.35 in chips) 
Seat 5: gehe91e0IyVT0QU/XBkEyg ($27.15 in chips) 
Seat 6: dtZ84flFEi4Q+SGrHMJRDQ ($25.80 in chips) 
Seat 7: OXPkK84/qv92EMwXPiG5rQ ($9.95 in chips) 
Seat 8: 4awUyiDYTgylQKXZ9faBVA ($60.65 in chips) 
Seat 9: F7pnn6czNpHvRM55XcA2EA ($25 in chips) 
F7pnn6czNpHvRM55XcA2EA: posts small blind $0.10
EQXHDnIzAsORnIXRNtXRlA: posts big blind $0.25
*** HOLE CARDS ***
7je+LC5Mfs6nL8YBVh4frQ: folds 
PdIasPkzm2sqZnN41ZRXOg: folds 
wGigCmBR/9XWkPpvYos3aQ: folds 
gehe91e0IyVT0QU/XBkEyg: calls $0.25
dtZ84flFEi4Q+SGrHMJRDQ: folds 
OXPkK84/qv92EMwXPiG5rQ: folds 
4awUyiDYTgylQKXZ9faBVA: folds 
F7pnn6czNpHvRM55XcA2EA: calls $0.15
EQXHDnIzAsORnIXRNtXRlA: checks 
*** FLOP *** [Kc 9h 8c]
F7pnn6czNpHvRM55XcA2EA: bets $0.50
EQXHDnIzAsORnIXRNtXRlA: folds 
gehe91e0IyVT0QU/XBkEyg: folds 
Uncalled bet ($0.50) returned to F7pnn6czNpHvRM55XcA2EA
F7pnn6czNpHvRM55XcA2EA collected $0.75 from pot
F7pnn6czNpHvRM55XcA2EA: doesn't show hand 
*** SUMMARY ***
Total pot $0.75 | Rake $0 
Board [Kc 9h 8c]
Seat 1: EQXHDnIzAsORnIXRNtXRlA (big blind) folded on the Flop
Seat 2: 7je+LC5Mfs6nL8YBVh4frQ folded before Flop (didn't bet)
Seat 3: PdIasPkzm2sqZnN41ZRXOg folded before Flop (didn't bet)
Seat 4: wGigCmBR/9XWkPpvYos3aQ folded before Flop (didn't bet)
Seat 5: gehe91e0IyVT0QU/XBkEyg folded on the Flop
Seat 6: dtZ84flFEi4Q+SGrHMJRDQ folded before Flop (didn't bet)
Seat 7: OXPkK84/qv92EMwXPiG5rQ folded before Flop (didn't bet)
Seat 8: 4awUyiDYTgylQKXZ9faBVA (button) folded before Flop (didn't bet)
Seat 9: F7pnn6czNpHvRM55XcA2EA (small blind) collected ($0.75)




PokerStars Game #59941728022:  Hold'em No Limit ($0.10/$0.25) - 2009/07/01 1:44:16 ET
Table 'U0hCzoS0KCJL+eoE054K4Q' 9-max Seat #9 is the button
Seat 1: XVEauYThJRhSTUAMxB/2ow ($38.20 in chips) 
Seat 2: MG90wfSJZnOejs/KD3vlQQ ($25 in chips) 
Seat 3: 8Cp1H3sSs8+jTTwLfeYKcw ($27.20 in chips) 
Seat 4: Bb42QRQMhg5/Y0vHP8/2Xw ($25 in chips) 
Seat 5: zgi+EUykT/pZQpoUG6+oEg ($6 in chips) 
Seat 6: V6p0jQ/RhUsqpHLmXvEX4Q ($11.90 in chips) 
Seat 7: uetHVityNsFnyX2bBnKe2A ($18.35 in chips) 
Seat 8: K0b5wNInj6hUGRr6yzKFtw ($27.45 in chips) 
Seat 9: wGigCmBR/9XWkPpvYos3aQ ($34.45 in chips) 
XVEauYThJRhSTUAMxB/2ow: posts small blind $0.10
MG90wfSJZnOejs/KD3vlQQ: posts big blind $0.25
*** HOLE CARDS ***
8Cp1H3sSs8+jTTwLfeYKcw: folds 
Bb42QRQMhg5/Y0vHP8/2Xw: folds 
zgi+EUykT/pZQpoUG6+oEg: folds 
V6p0jQ/RhUsqpHLmXvEX4Q: folds 
uetHVityNsFnyX2bBnKe2A: folds 
K0b5wNInj6hUGRr6yzKFtw: folds 
wGigCmBR/9XWkPpvYos3aQ: raises $0.65 to $0.90
XVEauYThJRhSTUAMxB/2ow: folds 
MG90wfSJZnOejs/KD3vlQQ: folds 
Uncalled bet ($0.65) returned to wGigCmBR/9XWkPpvYos3aQ
wGigCmBR/9XWkPpvYos3aQ collected $0.60 from pot
wGigCmBR/9XWkPpvYos3aQ: doesn't show hand 
*** SUMMARY ***
Total pot $0.60 | Rake $0 
Seat 1: XVEauYThJRhSTUAMxB/2ow (small blind) folded before Flop
Seat 2: MG90wfSJZnOejs/KD3vlQQ (big blind) folded before Flop
Seat 3: 8Cp1H3sSs8+jTTwLfeYKcw folded before Flop (didn't bet)
Seat 4: Bb42QRQMhg5/Y0vHP8/2Xw folded before Flop (didn't bet)
Seat 5: zgi+EUykT/pZQpoUG6+oEg folded before Flop (didn't bet)
Seat 6: V6p0jQ/RhUsqpHLmXvEX4Q folded before Flop (didn't bet)
Seat 7: uetHVityNsFnyX2bBnKe2A folded before Flop (didn't bet)
Seat 8: K0b5wNInj6hUGRr6yzKFtw folded before Flop (didn't bet)
Seat 9: wGigCmBR/9XWkPpvYos3aQ (button) collected ($0.60)




PokerStars Game #59941728228:  Hold'em No Limit ($0.10/$0.25) - 2009/07/01 1:44:16 ET
Table 'aT31tt16YvQM/Ue69HPLpA' 9-max Seat #7 is the button
Seat 1: fIgGw0jPUR7labvJPaPbeg ($11.45 in chips) 
Seat 2: PdIasPkzm2sqZnN41ZRXOg ($4.90 in chips) 
Seat 3: tYsOBqdU1+x+yFI7zHO7hQ ($25.15 in chips) 
Seat 4: wGigCmBR/9XWkPpvYos3aQ ($26.35 in chips) 
Seat 5: s2xLPOl/vhl/26apJ3vsOQ ($37.65 in chips) 
Seat 6: 7cv+9Zc9HIQHNvYsMfV3uA ($57.45 in chips) 
Seat 7: W8cIfrCR+zA8pCNyIuHu8g ($33.20 in chips) 
Seat 8: W6tExOcYX7qiy6Qdp+ZwFA ($4.75 in chips) 
Seat 9: TvIuLx9zUCE+9Li58iImOQ ($16.95 in chips) 
W6tExOcYX7qiy6Qdp+ZwFA: posts small blind $0.10
TvIuLx9zUCE+9Li58iImOQ: posts big blind $0.25
*** HOLE CARDS ***
fIgGw0jPUR7labvJPaPbeg: folds 
PdIasPkzm2sqZnN41ZRXOg: calls $0.25
tYsOBqdU1+x+yFI7zHO7hQ: folds 
wGigCmBR/9XWkPpvYos3aQ: folds 
s2xLPOl/vhl/26apJ3vsOQ: folds 
7cv+9Zc9HIQHNvYsMfV3uA: folds 
W8cIfrCR+zA8pCNyIuHu8g: raises $0.25 to $0.50
W6tExOcYX7qiy6Qdp+ZwFA: folds 
TvIuLx9zUCE+9Li58iImOQ: calls $0.25
PdIasPkzm2sqZnN41ZRXOg: calls $0.25
*** FLOP *** [7s Ad 7h]
TvIuLx9zUCE+9Li58iImOQ: checks 
PdIasPkzm2sqZnN41ZRXOg: checks 
W8cIfrCR+zA8pCNyIuHu8g: bets $0.50
TvIuLx9zUCE+9Li58iImOQ: folds 
PdIasPkzm2sqZnN41ZRXOg: folds 
Uncalled bet ($0.50) returned to W8cIfrCR+zA8pCNyIuHu8g
W8cIfrCR+zA8pCNyIuHu8g collected $1.55 from pot
W8cIfrCR+zA8pCNyIuHu8g: doesn't show hand 
*** SUMMARY ***
Total pot $1.60 | Rake $0.05 
Board [7s Ad 7h]
Seat 1: fIgGw0jPUR7labvJPaPbeg folded before Flop (didn't bet)
Seat 2: PdIasPkzm2sqZnN41ZRXOg folded on the Flop
Seat 3: tYsOBqdU1+x+yFI7zHO7hQ folded before Flop (didn't bet)
Seat 4: wGigCmBR/9XWkPpvYos3aQ folded before Flop (didn't bet)
Seat 5: s2xLPOl/vhl/26apJ3vsOQ folded before Flop (didn't bet)
Seat 6: 7cv+9Zc9HIQHNvYsMfV3uA folded before Flop (didn't bet)
Seat 7: W8cIfrCR+zA8pCNyIuHu8g (button) collected ($1.55)
Seat 8: W6tExOcYX7qiy6Qdp+ZwFA (small blind) folded before Flop
Seat 9: TvIuLx9zUCE+9Li58iImOQ (big blind) folded on the Flop




PokerStars Game #59941727948:  Hold'em No Limit ($0.10/$0.25) - 2009/07/01 1:44:16 ET
Table '3EebBlzq5yHSY2444L4zlg' 9-max Seat #3 is the button
Seat 1: XMSS6mD5B42I8wasdOMipQ ($29.15 in chips) 
Seat 2: b9UnopCOpq2MWP1DwqSO3Q ($17.95 in chips) 
Seat 3: IGbD5vKNhHe60dkdbjg/mw ($41.45 in chips) 
Seat 5: PFNLAvMkr8qKc7xCiH0wTA ($23.55 in chips) 
Seat 6: QEbIGci+itdw+re8RM5fZA ($50.35 in chips) 
Seat 7: DiSvPC2iudwL5j9u6Huyww ($48.85 in chips) 
Seat 8: dtZ84flFEi4Q+SGrHMJRDQ ($26.90 in chips) 
Seat 9: iZmSlSzYu5fJ67tDdQzymQ ($27.95 in chips) 
PdIasPkzm2sqZnN41ZRXOg will be allowed to play after the button
PFNLAvMkr8qKc7xCiH0wTA: posts small blind $0.10
QEbIGci+itdw+re8RM5fZA: posts big blind $0.25
*** HOLE CARDS ***
DiSvPC2iudwL5j9u6Huyww: folds 
dtZ84flFEi4Q+SGrHMJRDQ: folds 
iZmSlSzYu5fJ67tDdQzymQ: folds 
XMSS6mD5B42I8wasdOMipQ: raises $0.50 to $0.75
b9UnopCOpq2MWP1DwqSO3Q: folds 
IGbD5vKNhHe60dkdbjg/mw: folds 
PFNLAvMkr8qKc7xCiH0wTA: folds 
QEbIGci+itdw+re8RM5fZA: folds 
Uncalled bet ($0.50) returned to XMSS6mD5B42I8wasdOMipQ
XMSS6mD5B42I8wasdOMipQ collected $0.60 from pot
*** SUMMARY ***
Total pot $0.60 | Rake $0 
Seat 1: XMSS6mD5B42I8wasdOMipQ collected ($0.60)
Seat 2: b9UnopCOpq2MWP1DwqSO3Q folded before Flop (didn't bet)
Seat 3: IGbD5vKNhHe60dkdbjg/mw (button) folded before Flop (didn't bet)
Seat 5: PFNLAvMkr8qKc7xCiH0wTA (small blind) folded before Flop
Seat 6: QEbIGci+itdw+re8RM5fZA (big blind) folded before Flop
Seat 7: DiSvPC2iudwL5j9u6Huyww folded before Flop (didn't bet)
Seat 8: dtZ84flFEi4Q+SGrHMJRDQ folded before Flop (didn't bet)
Seat 9: iZmSlSzYu5fJ67tDdQzymQ folded before Flop (didn't bet)




PokerStars Game #59941728062:  Hold'em No Limit ($0.10/$0.25) - 2009/07/01 1:44:16 ET
Table 'QegsWX65l3n/K0A8XB78yg' 6-max Seat #2 is the button
Seat 1: p6adJRMXMBLr+xtQzqazIQ ($13.65 in chips) 
Seat 2: GC/9yVD59DUCX7hUI7gcLw ($61.60 in chips) 
Seat 3: iIgNoBh+3/Ix1/fLsg+HuA ($5.75 in chips) 
Seat 4: epAUIB7h2FJXzUPRIvSkRA ($25 in chips) 
Seat 6: 5PWs02z65jSO5pr/M6wx/w ($2.75 in chips) 
iIgNoBh+3/Ix1/fLsg+HuA: posts small blind $0.10
epAUIB7h2FJXzUPRIvSkRA: posts big blind $0.25
*** HOLE CARDS ***
5PWs02z65jSO5pr/M6wx/w: calls $0.25
OMGl+YMGogf2JWIRfT2/Yg leaves the table
p6adJRMXMBLr+xtQzqazIQ: calls $0.25
GC/9yVD59DUCX7hUI7gcLw: raises $1.25 to $1.50
iIgNoBh+3/Ix1/fLsg+HuA: folds 
QqiZLFrN8iOUT/GHw7ztOA joins the table at seat #5 
epAUIB7h2FJXzUPRIvSkRA: folds 
5PWs02z65jSO5pr/M6wx/w: folds 
p6adJRMXMBLr+xtQzqazIQ: calls $1.25
*** FLOP *** [Td 3h Tc]
p6adJRMXMBLr+xtQzqazIQ: checks 
GC/9yVD59DUCX7hUI7gcLw: bets $2.25
p6adJRMXMBLr+xtQzqazIQ: raises $9.90 to $12.15 and is all-in
GC/9yVD59DUCX7hUI7gcLw: folds 
Uncalled bet ($9.90) returned to p6adJRMXMBLr+xtQzqazIQ
p6adJRMXMBLr+xtQzqazIQ collected $7.75 from pot
p6adJRMXMBLr+xtQzqazIQ: doesn't show hand 
*** SUMMARY ***
Total pot $8.10 | Rake $0.35 
Board [Td 3h Tc]
Seat 1: p6adJRMXMBLr+xtQzqazIQ collected ($7.75)
Seat 2: GC/9yVD59DUCX7hUI7gcLw (button) folded on the Flop
Seat 3: iIgNoBh+3/Ix1/fLsg+HuA (small blind) folded before Flop
Seat 4: epAUIB7h2FJXzUPRIvSkRA (big blind) folded before Flop
Seat 6: 5PWs02z65jSO5pr/M6wx/w folded before Flop




PokerStars Game #59941728162:  Hold'em No Limit ($0.10/$0.25) - 2009/07/01 1:44:16 ET
Table 'mF3KHGMaTpaBZbtBoyfTeg' 6-max Seat #3 is the button
Seat 1: 0HAB2GdCAM7p7V00xueAVQ ($23.35 in chips) 
Seat 2: 6qsh9pnysDKJNhfFhFmKRQ ($14.10 in chips) 
Seat 3: 9kUKGKkblnIx3m8rlVol6Q ($9.70 in chips) 
Seat 4: FYepjhAvF8ZdVCmqHIy+eQ ($25 in chips) 
Seat 5: 8ClCHtFXGNplITm+63KB+Q ($44.65 in chips) 
Seat 6: kG34n23qFQA3nzdOJTQ1dA ($27.75 in chips) 
FYepjhAvF8ZdVCmqHIy+eQ: posts small blind $0.10
8ClCHtFXGNplITm+63KB+Q: posts big blind $0.25
*** HOLE CARDS ***
kG34n23qFQA3nzdOJTQ1dA: folds 
0HAB2GdCAM7p7V00xueAVQ: raises $0.50 to $0.75
6qsh9pnysDKJNhfFhFmKRQ: folds 
9kUKGKkblnIx3m8rlVol6Q: folds 
FYepjhAvF8ZdVCmqHIy+eQ: folds 
8ClCHtFXGNplITm+63KB+Q: folds 
Uncalled bet ($0.50) returned to 0HAB2GdCAM7p7V00xueAVQ
0HAB2GdCAM7p7V00xueAVQ collected $0.60 from pot
0HAB2GdCAM7p7V00xueAVQ: doesn't show hand 
*** SUMMARY ***
Total pot $0.60 | Rake $0 
Seat 1: 0HAB2GdCAM7p7V00xueAVQ collected ($0.60)
Seat 2: 6qsh9pnysDKJNhfFhFmKRQ folded before Flop (didn't bet)
Seat 3: 9kUKGKkblnIx3m8rlVol6Q (button) folded before Flop (didn't bet)
Seat 4: FYepjhAvF8ZdVCmqHIy+eQ (small blind) folded before Flop
Seat 5: 8ClCHtFXGNplITm+63KB+Q (big blind) folded before Flop
Seat 6: kG34n23qFQA3nzdOJTQ1dA folded before Flop (didn't bet)




PokerStars Game #59941728472:  Hold'em No Limit ($0.10/$0.25) - 2009/07/01 1:44:17 ET
Table 'nQC9LRg01NEuKFHF1nrDEw0XPo7K54oZIfG0xlNAcDRw-max Seat #6 is the button
Seat 1: qf+LMbROj8/qY878wkFHbQ ($14.90 in chips) 
Seat 2: ZhV6dUX9NQhT4zf7t+ZLJg ($24.75 in chips) 
Seat 3: 6+g0Lb6vfRDZkElV8ieHyQ ($24.85 in chips) 
Seat 5: kG34n23qFQA3nzdOJTQ1dA ($29.05 in chips) 
Seat 6: xQVFeVUDopz+akuEo2wXpQ ($53 in chips) 
qf+LMbROj8/qY878wkFHbQ: posts small blind $0.10
ZhV6dUX9NQhT4zf7t+ZLJg: posts big blind $0.25
*** HOLE CARDS ***
6+g0Lb6vfRDZkElV8ieHyQ: folds 
kG34n23qFQA3nzdOJTQ1dA: folds 
xQVFeVUDopz+akuEo2wXpQ: calls $0.25
qf+LMbROj8/qY878wkFHbQ: folds 
ZhV6dUX9NQhT4zf7t+ZLJg: checks 
*** FLOP *** [6s 9c 2c]
ZhV6dUX9NQhT4zf7t+ZLJg: checks 
xQVFeVUDopz+akuEo2wXpQ: checks 
*** TURN *** [6s 9c 2c] [7h]
ZhV6dUX9NQhT4zf7t+ZLJg: bets $0.50
xQVFeVUDopz+akuEo2wXpQ: calls $0.50
*** RIVER *** [6s 9c 2c 7h] [Th]
ZhV6dUX9NQhT4zf7t+ZLJg: bets $0.75
xQVFeVUDopz+akuEo2wXpQ: raises $1.25 to $2
ZhV6dUX9NQhT4zf7t+ZLJg: calls $1.25
*** SHOW DOWN ***
xQVFeVUDopz+akuEo2wXpQ: shows [8d Jd] (a straight, Seven to Jack)
ZhV6dUX9NQhT4zf7t+ZLJg: mucks hand 
xQVFeVUDopz+akuEo2wXpQ collected $5.35 from pot
*** SUMMARY ***
Total pot $5.60 | Rake $0.25 
Board [6s 9c 2c 7h Th]
Seat 1: qf+LMbROj8/qY878wkFHbQ (small blind) folded before Flop
Seat 2: ZhV6dUX9NQhT4zf7t+ZLJg (big blind) mucked
Seat 3: 6+g0Lb6vfRDZkElV8ieHyQ folded before Flop (didn't bet)
Seat 5: kG34n23qFQA3nzdOJTQ1dA folded before Flop (didn't bet)
Seat 6: xQVFeVUDopz+akuEo2wXpQ (button) showed [8d Jd] and won ($5.35) with a straight, Seven to Jack




PokerStars Game #59941728492:  Hold'em No Limit ($0.10/$0.25) - 2009/07/01 1:44:17 ET
Table 'ROYvQOMwUrvL3SOiHYcrWg' 9-max Seat #6 is the button
Seat 1: 22dIObOuor/A+IKWkNoAlA ($5 in chips) 
Seat 2: gehe91e0IyVT0QU/XBkEyg ($24.90 in chips) 
Seat 3: 8EbrQ/EvFWt2cr0GaU82gQ ($4.65 in chips) 
Seat 4: SHegmCn8B0InbWE/zFlvOw ($21.95 in chips) 
Seat 5: 7je+LC5Mfs6nL8YBVh4frQ ($4.65 in chips) 
Seat 6: P+9ymZQ3ktpQu1bn7HIjew ($20.50 in chips) 
Seat 7: tYsOBqdU1+x+yFI7zHO7hQ ($25 in chips) 
Seat 8: biJWLZ27fafNeBI2oT1KJw ($28.15 in chips) 
Seat 9: uhrboV251dcgYniYTdFIcA ($25.35 in chips) 
tYsOBqdU1+x+yFI7zHO7hQ: posts small blind $0.10
biJWLZ27fafNeBI2oT1KJw: posts big blind $0.25
*** HOLE CARDS ***
uhrboV251dcgYniYTdFIcA: folds 
22dIObOuor/A+IKWkNoAlA: folds 
gehe91e0IyVT0QU/XBkEyg: folds 
8EbrQ/EvFWt2cr0GaU82gQ: folds 
SHegmCn8B0InbWE/zFlvOw: folds 
7je+LC5Mfs6nL8YBVh4frQ: folds 
P+9ymZQ3ktpQu1bn7HIjew: folds 
tYsOBqdU1+x+yFI7zHO7hQ: folds 
Uncalled bet ($0.15) returned to biJWLZ27fafNeBI2oT1KJw
biJWLZ27fafNeBI2oT1KJw collected $0.20 from pot
biJWLZ27fafNeBI2oT1KJw: doesn't show hand 
*** SUMMARY ***
Total pot $0.20 | Rake $0 
Seat 1: 22dIObOuor/A+IKWkNoAlA folded before Flop (didn't bet)
Seat 2: gehe91e0IyVT0QU/XBkEyg folded before Flop (didn't bet)
Seat 3: 8EbrQ/EvFWt2cr0GaU82gQ folded before Flop (didn't bet)
Seat 4: SHegmCn8B0InbWE/zFlvOw folded before Flop (didn't bet)
Seat 5: 7je+LC5Mfs6nL8YBVh4frQ folded before Flop (didn't bet)
Seat 6: P+9ymZQ3ktpQu1bn7HIjew (button) folded before Flop (didn't bet)
Seat 7: tYsOBqdU1+x+yFI7zHO7hQ (small blind) folded before Flop
Seat 8: biJWLZ27fafNeBI2oT1KJw (big blind) collected ($0.20)
Seat 9: uhrboV251dcgYniYTdFIcA folded before Flop (didn't bet)




PokerStars Game #59941728886:  Hold'em No Limit ($0.10/$0.25) - 2009/07/01 1:44:18 ET
Table 'h02LhQ7B/Zk4ETRxxHhGYA' 9-max Seat #7 is the button
Seat 1: sD+TKtt36XiiN6jqHiLwDA ($25.25 in chips) 
Seat 2: 9lvO/qyU+xrU95Teu1fv0g ($6.30 in chips) 
Seat 3: arxNSjreDRGFg13EAM2F1w ($25 in chips) 
Seat 4: tYsOBqdU1+x+yFI7zHO7hQ ($38.10 in chips) 
Seat 5: cUxk0Jk4lrUQv9CJl0LPlg ($28 in chips) 
Seat 6: UvM6sxFT7el5hVDehvWvTA ($33.85 in chips) 
Seat 7: y7w8+Oqq4SkI1dkRDCx2Zg ($3.50 in chips) 
Seat 8: mUoFJKqCzIUABvOFbiINlQ ($14.60 in chips) 
Seat 9: MgzS9dEPzsGYQW57RteFhw ($7.15 in chips) 
mUoFJKqCzIUABvOFbiINlQ: posts small blind $0.10
MgzS9dEPzsGYQW57RteFhw: posts big blind $0.25
*** HOLE CARDS ***
sD+TKtt36XiiN6jqHiLwDA: calls $0.25
9lvO/qyU+xrU95Teu1fv0g: folds 
arxNSjreDRGFg13EAM2F1w: folds 
tYsOBqdU1+x+yFI7zHO7hQ: folds 
cUxk0Jk4lrUQv9CJl0LPlg: folds 
UvM6sxFT7el5hVDehvWvTA: raises $0.50 to $0.75
y7w8+Oqq4SkI1dkRDCx2Zg: folds 
mUoFJKqCzIUABvOFbiINlQ: folds 
MgzS9dEPzsGYQW57RteFhw: folds 
sD+TKtt36XiiN6jqHiLwDA: calls $0.50
*** FLOP *** [Qc 9h 3h]
sD+TKtt36XiiN6jqHiLwDA: checks 
UvM6sxFT7el5hVDehvWvTA: bets $0.95
sD+TKtt36XiiN6jqHiLwDA: raises $0.95 to $1.90
UvM6sxFT7el5hVDehvWvTA: calls $0.95
*** TURN *** [Qc 9h 3h] [8s]
sD+TKtt36XiiN6jqHiLwDA: bets $2.50
MgzS9dEPzsGYQW57RteFhw leaves the table
UvM6sxFT7el5hVDehvWvTA said, "AQ?"
UvM6sxFT7el5hVDehvWvTA said, "pocket kings?"
UvM6sxFT7el5hVDehvWvTA: folds 
Uncalled bet ($2.50) returned to sD+TKtt36XiiN6jqHiLwDA
sD+TKtt36XiiN6jqHiLwDA collected $5.40 from pot
sD+TKtt36XiiN6jqHiLwDA: doesn't show hand 
*** SUMMARY ***
Total pot $5.65 | Rake $0.25 
Board [Qc 9h 3h 8s]
Seat 1: sD+TKtt36XiiN6jqHiLwDA collected ($5.40)
Seat 2: 9lvO/qyU+xrU95Teu1fv0g folded before Flop (didn't bet)
Seat 3: arxNSjreDRGFg13EAM2F1w folded before Flop (didn't bet)
Seat 4: tYsOBqdU1+x+yFI7zHO7hQ folded before Flop (didn't bet)
Seat 5: cUxk0Jk4lrUQv9CJl0LPlg folded before Flop (didn't bet)
Seat 6: UvM6sxFT7el5hVDehvWvTA folded on the Turn
Seat 7: y7w8+Oqq4SkI1dkRDCx2Zg (button) folded before Flop (didn't bet)
Seat 8: mUoFJKqCzIUABvOFbiINlQ (small blind) folded before Flop
Seat 9: MgzS9dEPzsGYQW57RteFhw (big blind) folded before Flop




PokerStars Game #59941729236:  Hold'em No Limit ($0.10/$0.25) - 2009/07/01 1:44:18 ET
Table 'dNYnr4D4id1jwnEU66Yowg' 9-max Seat #2 is the button
Seat 1: 9lvO/qyU+xrU95Teu1fv0g ($4.40 in chips) 
Seat 2: Qduu7ikeizo6q6Ei9YvcJA ($24.65 in chips) 
Seat 3: IOx4EH8+y3jYZJc/LTRvOw ($25.25 in chips) 
Seat 4: VBHxUExRAMrbxUq/cVx9Gw ($4.95 in chips) 
Seat 5: 7cv+9Zc9HIQHNvYsMfV3uA ($25 in chips) 
Seat 6: 8EbrQ/EvFWt2cr0GaU82gQ ($4.65 in chips) 
Seat 7: DiSvPC2iudwL5j9u6Huyww ($25 in chips) 
Seat 8: RCqMONFrSPSArZh2Jsar/w ($34.10 in chips) 
Seat 9: /FE4MKSoQhXaDp4PBoLM2g ($14.75 in chips) 
IOx4EH8+y3jYZJc/LTRvOw: posts small blind $0.10
VBHxUExRAMrbxUq/cVx9Gw: posts big blind $0.25
*** HOLE CARDS ***
7cv+9Zc9HIQHNvYsMfV3uA: folds 
8EbrQ/EvFWt2cr0GaU82gQ: folds 
DiSvPC2iudwL5j9u6Huyww: folds 
RCqMONFrSPSArZh2Jsar/w: folds 
/FE4MKSoQhXaDp4PBoLM2g: calls $0.25
9lvO/qyU+xrU95Teu1fv0g: folds 
Qduu7ikeizo6q6Ei9YvcJA: folds 
IOx4EH8+y3jYZJc/LTRvOw: calls $0.15
VBHxUExRAMrbxUq/cVx9Gw: checks 
*** FLOP *** [6c 5h Qd]
IOx4EH8+y3jYZJc/LTRvOw: checks 
VBHxUExRAMrbxUq/cVx9Gw: checks 
/FE4MKSoQhXaDp4PBoLM2g: checks 
*** TURN *** [6c 5h Qd] [Ac]
IOx4EH8+y3jYZJc/LTRvOw: bets $0.25
VBHxUExRAMrbxUq/cVx9Gw: folds 
/FE4MKSoQhXaDp4PBoLM2g: folds 
Uncalled bet ($0.25) returned to IOx4EH8+y3jYZJc/LTRvOw
IOx4EH8+y3jYZJc/LTRvOw collected $0.75 from pot
*** SUMMARY ***
Total pot $0.75 | Rake $0 
Board [6c 5h Qd Ac]
Seat 1: 9lvO/qyU+xrU95Teu1fv0g folded before Flop (didn't bet)
Seat 2: Qduu7ikeizo6q6Ei9YvcJA (button) folded before Flop (didn't bet)
Seat 3: IOx4EH8+y3jYZJc/LTRvOw (small blind) collected ($0.75)
Seat 4: VBHxUExRAMrbxUq/cVx9Gw (big blind) folded on the Turn
Seat 5: 7cv+9Zc9HIQHNvYsMfV3uA folded before Flop (didn't bet)
Seat 6: 8EbrQ/EvFWt2cr0GaU82gQ folded before Flop (didn't bet)
Seat 7: DiSvPC2iudwL5j9u6Huyww folded before Flop (didn't bet)
Seat 8: RCqMONFrSPSArZh2Jsar/w folded before Flop (didn't bet)
Seat 9: /FE4MKSoQhXaDp4PBoLM2g folded on the Turn




PokerStars Game #59941729058:  Hold'em No Limit ($0.10/$0.25) - 2009/07/01 1:44:18 ET
Table 'ukli1Y7ieC5JQMTEFxM2Nw' 6-max Seat #5 is the button
Seat 1: N162H80ZIQevUf2EzGahCA ($8.55 in chips) 
Seat 2: u/yN5P9f3KlATg6WLWNkBQ ($43.55 in chips) 
Seat 3: ExeoJ1G/rSmWa3tRz7TlCA ($23.45 in chips) 
Seat 4: if4dh6jhJXeN3/qd3qCp9g ($28.35 in chips) 
Seat 5: Se+H4Z4PDr6+eIUDJX1rpg ($15.35 in chips) 
Seat 6: 32YL2ZEp8NT4JB2RVM9euQ ($30.25 in chips) 
32YL2ZEp8NT4JB2RVM9euQ: posts small blind $0.10
N162H80ZIQevUf2EzGahCA: posts big blind $0.25
*** HOLE CARDS ***
u/yN5P9f3KlATg6WLWNkBQ: calls $0.25
ExeoJ1G/rSmWa3tRz7TlCA: folds 
if4dh6jhJXeN3/qd3qCp9g: folds 
Se+H4Z4PDr6+eIUDJX1rpg: folds 
32YL2ZEp8NT4JB2RVM9euQ: folds 
N162H80ZIQevUf2EzGahCA: checks 
*** FLOP *** [Jh Ts 5s]
N162H80ZIQevUf2EzGahCA: bets $0.25
u/yN5P9f3KlATg6WLWNkBQ: folds 
Uncalled bet ($0.25) returned to N162H80ZIQevUf2EzGahCA
N162H80ZIQevUf2EzGahCA collected $0.60 from pot
N162H80ZIQevUf2EzGahCA: doesn't show hand 
*** SUMMARY ***
Total pot $0.60 | Rake $0 
Board [Jh Ts 5s]
Seat 1: N162H80ZIQevUf2EzGahCA (big blind) collected ($0.60)
Seat 2: u/yN5P9f3KlATg6WLWNkBQ folded on the Flop
Seat 3: ExeoJ1G/rSmWa3tRz7TlCA folded before Flop (didn't bet)
Seat 4: if4dh6jhJXeN3/qd3qCp9g folded before Flop (didn't bet)
Seat 5: Se+H4Z4PDr6+eIUDJX1rpg (button) folded before Flop (didn't bet)
Seat 6: 32YL2ZEp8NT4JB2RVM9euQ (small blind) folded before Flop




PokerStars Game #59941729572:  Hold'em No Limit ($0.10/$0.25) - 2009/07/01 1:44:19 ET
Table '4UJB/UOZ5aepyF2v+hIoUg' 6-max Seat #3 is the button
Seat 1: 08V++DOqzaNrRNsHIwi25w ($26.60 in chips) 
Seat 2: mFv3iBCtrw9XfCDRB0d46Q ($4.55 in chips) 
Seat 3: zlYHXTtJ5tcx9kwK2h5n9A ($38.65 in chips) 
Seat 4: R6AGToFJQOYVZAjC2jXEKw ($23.95 in chips) 
Seat 5: 3zD3qLXT1bEffAoWGnc7wg ($25.90 in chips) 
Seat 6: 2aphcinkTZT0B0Uoah6cvQ ($16.85 in chips) 
R6AGToFJQOYVZAjC2jXEKw: posts small blind $0.10
3zD3qLXT1bEffAoWGnc7wg: posts big blind $0.25
*** HOLE CARDS ***
2aphcinkTZT0B0Uoah6cvQ: folds 
08V++DOqzaNrRNsHIwi25w: folds 
mFv3iBCtrw9XfCDRB0d46Q: folds 
zlYHXTtJ5tcx9kwK2h5n9A: calls $0.25
R6AGToFJQOYVZAjC2jXEKw: folds 
3zD3qLXT1bEffAoWGnc7wg: checks 
*** FLOP *** [3s Kc Td]
3zD3qLXT1bEffAoWGnc7wg: checks 
zlYHXTtJ5tcx9kwK2h5n9A: bets $0.25
3zD3qLXT1bEffAoWGnc7wg: folds 
Uncalled bet ($0.25) returned to zlYHXTtJ5tcx9kwK2h5n9A
zlYHXTtJ5tcx9kwK2h5n9A collected $0.60 from pot
*** SUMMARY ***
Total pot $0.60 | Rake $0 
Board [3s Kc Td]
Seat 1: 08V++DOqzaNrRNsHIwi25w folded before Flop (didn't bet)
Seat 2: mFv3iBCtrw9XfCDRB0d46Q folded before Flop (didn't bet)
Seat 3: zlYHXTtJ5tcx9kwK2h5n9A (button) collected ($0.60)
Seat 4: R6AGToFJQOYVZAjC2jXEKw (small blind) folded before Flop
Seat 5: 3zD3qLXT1bEffAoWGnc7wg (big blind) folded on the Flop
Seat 6: 2aphcinkTZT0B0Uoah6cvQ folded before Flop (didn't bet)




PokerStars Game #59941729600:  Hold'em No Limit ($0.10/$0.25) - 2009/07/01 1:44:19 ET
Table 'l57rayEpPtZotP9nqgSWBg' 6-max Seat #5 is the button
Seat 1: DihMHaz4WNETH1bPDe13kA ($56.10 in chips) 
Seat 2: p6adJRMXMBLr+xtQzqazIQ ($15.55 in chips) 
Seat 3: L3/N/gliETan8N5Gim5h4Q ($25 in chips) 
Seat 4: OqkdGXy1SCzuN5Q0wNlFSg ($22.60 in chips) 
Seat 5: WKJHaZPUgrpTVyLOEjLYmg ($11.25 in chips) 
Seat 6: IGRfskE1v9H9Bn+fz8AgNQ ($17.90 in chips) 
IGRfskE1v9H9Bn+fz8AgNQ: posts small blind $0.10
DihMHaz4WNETH1bPDe13kA: posts big blind $0.25
*** HOLE CARDS ***
p6adJRMXMBLr+xtQzqazIQ: folds 
L3/N/gliETan8N5Gim5h4Q: folds 
OqkdGXy1SCzuN5Q0wNlFSg: folds 
WKJHaZPUgrpTVyLOEjLYmg: calls $0.25
IGRfskE1v9H9Bn+fz8AgNQ: calls $0.15
DihMHaz4WNETH1bPDe13kA: raises $1 to $1.25
WKJHaZPUgrpTVyLOEjLYmg: folds 
IGRfskE1v9H9Bn+fz8AgNQ: calls $1
*** FLOP *** [6d Jh 8c]
IGRfskE1v9H9Bn+fz8AgNQ: checks 
DihMHaz4WNETH1bPDe13kA: bets $1.45
IGRfskE1v9H9Bn+fz8AgNQ: calls $1.45
*** TURN *** [6d Jh 8c] [4c]
IGRfskE1v9H9Bn+fz8AgNQ: checks 
DihMHaz4WNETH1bPDe13kA: checks 
*** RIVER *** [6d Jh 8c 4c] [Ah]
IGRfskE1v9H9Bn+fz8AgNQ: checks 
DihMHaz4WNETH1bPDe13kA: bets $3.75
IGRfskE1v9H9Bn+fz8AgNQ: folds 
Uncalled bet ($3.75) returned to DihMHaz4WNETH1bPDe13kA
DihMHaz4WNETH1bPDe13kA collected $5.40 from pot
*** SUMMARY ***
Total pot $5.65 | Rake $0.25 
Board [6d Jh 8c 4c Ah]
Seat 1: DihMHaz4WNETH1bPDe13kA (big blind) collected ($5.40)
Seat 2: p6adJRMXMBLr+xtQzqazIQ folded before Flop (didn't bet)
Seat 3: L3/N/gliETan8N5Gim5h4Q folded before Flop (didn't bet)
Seat 4: OqkdGXy1SCzuN5Q0wNlFSg folded before Flop (didn't bet)
Seat 5: WKJHaZPUgrpTVyLOEjLYmg (button) folded before Flop
Seat 6: IGRfskE1v9H9Bn+fz8AgNQ (small blind) folded on the River




PokerStars Game #59941729666:  Hold'em No Limit ($0.10/$0.25) - 2009/07/01 1:44:19 ET
Table 'oZuNsbNJuUyQLGKzQ/4JFg' 6-max Seat #4 is the button
Seat 1: vqWjZmdQu/Hxw96/IJTWdQ ($25.70 in chips) 
Seat 2: UA5OsKS3VPaxa7uC8La/kA ($34.50 in chips) 
Seat 3: 8ClCHtFXGNplITm+63KB+Q ($51 in chips) 
Seat 4: 9bpVv1/Qh9IYtXuCtl5VtQ ($24.65 in chips) 
Seat 5: oBUDUfeUyCbZBsjxHZgSiw ($26.55 in chips) 
Seat 6: fwg6dK1+r4jy/y+JqenYYQ ($14.15 in chips) 
oBUDUfeUyCbZBsjxHZgSiw: posts small blind $0.10
fwg6dK1+r4jy/y+JqenYYQ: posts big blind $0.25
*** HOLE CARDS ***
vqWjZmdQu/Hxw96/IJTWdQ: folds 
UA5OsKS3VPaxa7uC8La/kA: folds 
8ClCHtFXGNplITm+63KB+Q: folds 
9bpVv1/Qh9IYtXuCtl5VtQ: raises $0.75 to $1
oBUDUfeUyCbZBsjxHZgSiw: calls $0.90
fwg6dK1+r4jy/y+JqenYYQ: folds 
*** FLOP *** [Kc 3h Qd]
oBUDUfeUyCbZBsjxHZgSiw: checks 
9bpVv1/Qh9IYtXuCtl5VtQ: bets $2
oBUDUfeUyCbZBsjxHZgSiw: folds 
Uncalled bet ($2) returned to 9bpVv1/Qh9IYtXuCtl5VtQ
9bpVv1/Qh9IYtXuCtl5VtQ collected $2.15 from pot
9bpVv1/Qh9IYtXuCtl5VtQ: doesn't show hand 
*** SUMMARY ***
Total pot $2.25 | Rake $0.10 
Board [Kc 3h Qd]
Seat 1: vqWjZmdQu/Hxw96/IJTWdQ folded before Flop (didn't bet)
Seat 2: UA5OsKS3VPaxa7uC8La/kA folded before Flop (didn't bet)
Seat 3: 8ClCHtFXGNplITm+63KB+Q folded before Flop (didn't bet)
Seat 4: 9bpVv1/Qh9IYtXuCtl5VtQ (button) collected ($2.15)
Seat 5: oBUDUfeUyCbZBsjxHZgSiw (small blind) folded on the Flop
Seat 6: fwg6dK1+r4jy/y+JqenYYQ (big blind) folded before Flop




PokerStars Game #59941729314:  Hold'em No Limit ($0.10/$0.25) - 2009/07/01 1:44:19 ET
Table 'biAgO3TKQBU8XcrVAoU5TA' 6-max Seat #6 is the button
Seat 1: jhDPlkir8wBYAddboBuF7Q ($16.80 in chips) 
Seat 2: GbCVUNssQ7mqsPWr7J4d3w ($5.30 in chips) 
Seat 3: mfrkWA3PTeYPkbO6hi98Aw ($32.40 in chips) 
Seat 4: Hsvkc0/G2VV78oVmWYXecw ($5 in chips) 
Seat 5: n6UPMnVR4v8LFP0rWP73Fg ($11.85 in chips) 
Seat 6: wMiE3yTbDJGOLOF9th7KPA ($8.45 in chips) 
jhDPlkir8wBYAddboBuF7Q: posts small blind $0.10
GbCVUNssQ7mqsPWr7J4d3w: posts big blind $0.25
*** HOLE CARDS ***
mfrkWA3PTeYPkbO6hi98Aw: folds 
Hsvkc0/G2VV78oVmWYXecw: folds 
n6UPMnVR4v8LFP0rWP73Fg: calls $0.25
wMiE3yTbDJGOLOF9th7KPA: calls $0.25
jhDPlkir8wBYAddboBuF7Q: calls $0.15
GbCVUNssQ7mqsPWr7J4d3w: checks 
*** FLOP *** [Qh 8s Ks]
jhDPlkir8wBYAddboBuF7Q: checks 
GbCVUNssQ7mqsPWr7J4d3w: checks 
n6UPMnVR4v8LFP0rWP73Fg: checks 
wMiE3yTbDJGOLOF9th7KPA: bets $0.50
jhDPlkir8wBYAddboBuF7Q: folds 
GbCVUNssQ7mqsPWr7J4d3w: calls $0.50
n6UPMnVR4v8LFP0rWP73Fg: folds 
*** TURN *** [Qh 8s Ks] [4d]
GbCVUNssQ7mqsPWr7J4d3w: checks 
wMiE3yTbDJGOLOF9th7KPA: bets $0.50
GbCVUNssQ7mqsPWr7J4d3w: calls $0.50
*** RIVER *** [Qh 8s Ks 4d] [8h]
GbCVUNssQ7mqsPWr7J4d3w: checks 
wMiE3yTbDJGOLOF9th7KPA: bets $0.50
GbCVUNssQ7mqsPWr7J4d3w: calls $0.50
*** SHOW DOWN ***
wMiE3yTbDJGOLOF9th7KPA: shows [Qd Ah] (two pair, Queens and Eights)
GbCVUNssQ7mqsPWr7J4d3w: shows [5s Kc] (two pair, Kings and Eights)
GbCVUNssQ7mqsPWr7J4d3w collected $3.85 from pot
*** SUMMARY ***
Total pot $4 | Rake $0.15 
Board [Qh 8s Ks 4d 8h]
Seat 1: jhDPlkir8wBYAddboBuF7Q (small blind) folded on the Flop
Seat 2: GbCVUNssQ7mqsPWr7J4d3w (big blind) showed [5s Kc] and won ($3.85) with two pair, Kings and Eights
Seat 3: mfrkWA3PTeYPkbO6hi98Aw folded before Flop (didn't bet)
Seat 4: Hsvkc0/G2VV78oVmWYXecw folded before Flop (didn't bet)
Seat 5: n6UPMnVR4v8LFP0rWP73Fg folded on the Flop
Seat 6: wMiE3yTbDJGOLOF9th7KPA (button) showed [Qd Ah] and lost with two pair, Queens and Eights




PokerStars Game #59941729762:  Hold'em No Limit ($0.10/$0.25) - 2009/07/01 1:44:19 ET
Table 'Xi38lWH8L2JHRAsKYVX8Qg' 6-max Seat #1 is the button
Seat 1: shP7DFAtX7gXcgMJX/OmRQ ($18.45 in chips) 
Seat 2: VOmI0x4dDPnTESZd5B4d1Q ($9.35 in chips) 
Seat 3: 6DwBRH+xZ12AAZmeAg+aXw ($35.05 in chips) 
Seat 4: kG34n23qFQA3nzdOJTQ1dA ($24.85 in chips) 
Seat 5: 79ID/ub1Pt/mDpCprVmOoA ($77.95 in chips) 
Seat 6: kyRaCIljYA6l33lSKQfNsg ($29.40 in chips) 
VOmI0x4dDPnTESZd5B4d1Q: posts small blind $0.10
6DwBRH+xZ12AAZmeAg+aXw: posts big blind $0.25
*** HOLE CARDS ***
kG34n23qFQA3nzdOJTQ1dA: folds 
79ID/ub1Pt/mDpCprVmOoA: folds 
kyRaCIljYA6l33lSKQfNsg: folds 
shP7DFAtX7gXcgMJX/OmRQ: folds 
VOmI0x4dDPnTESZd5B4d1Q: calls $0.15
6DwBRH+xZ12AAZmeAg+aXw: checks 
*** FLOP *** [6d Kh 6c]
VOmI0x4dDPnTESZd5B4d1Q: checks 
6DwBRH+xZ12AAZmeAg+aXw: checks 
*** TURN *** [6d Kh 6c] [3h]
VOmI0x4dDPnTESZd5B4d1Q: checks 
6DwBRH+xZ12AAZmeAg+aXw: checks 
*** RIVER *** [6d Kh 6c 3h] [4s]
VOmI0x4dDPnTESZd5B4d1Q: checks 
6DwBRH+xZ12AAZmeAg+aXw: checks 
*** SHOW DOWN ***
VOmI0x4dDPnTESZd5B4d1Q: shows [5h Ad] (a pair of Sixes)
6DwBRH+xZ12AAZmeAg+aXw: shows [4d 5c] (two pair, Sixes and Fours)
6DwBRH+xZ12AAZmeAg+aXw collected $0.50 from pot
*** SUMMARY ***
Total pot $0.50 | Rake $0 
Board [6d Kh 6c 3h 4s]
Seat 1: shP7DFAtX7gXcgMJX/OmRQ (button) folded before Flop (didn't bet)
Seat 2: VOmI0x4dDPnTESZd5B4d1Q (small blind) showed [5h Ad] and lost with a pair of Sixes
Seat 3: 6DwBRH+xZ12AAZmeAg+aXw (big blind) showed [4d 5c] and won ($0.50) with two pair, Sixes and Fours
Seat 4: kG34n23qFQA3nzdOJTQ1dA folded before Flop (didn't bet)
Seat 5: 79ID/ub1Pt/mDpCprVmOoA folded before Flop (didn't bet)
Seat 6: kyRaCIljYA6l33lSKQfNsg folded before Flop (didn't bet)




PokerStars Game #59941729840:  Hold'em No Limit ($0.10/$0.25) - 2009/07/01 1:44:19 ET
Table 'KKk6y4pAXeymxYcd0uZLqg' 9-max Seat #9 is the button
Seat 1: HPEB+AtKw1+C/cxU0o1ciw ($24.65 in chips) 
Seat 3: tLcDklc2rBORNfixyRfVfw ($25 in chips) 
Seat 4: YciNm3fUXAQaJeXG1rhrbw ($11.80 in chips) 
Seat 5: wGigCmBR/9XWkPpvYos3aQ ($38.85 in chips) 
Seat 6: QEbIGci+itdw+re8RM5fZA ($25 in chips) 
Seat 7: JjOuv8Vf56aiQjWi/rTPFA ($22.65 in chips) 
Seat 8: +2kMBNpY4nF1qNCRd8SJLA ($33 in chips) 
Seat 9: oLa/tXLfSLLB28mcLGrxcg ($25.45 in chips) 
HPEB+AtKw1+C/cxU0o1ciw: posts small blind $0.10
tLcDklc2rBORNfixyRfVfw: posts big blind $0.25
*** HOLE CARDS ***
YciNm3fUXAQaJeXG1rhrbw: calls $0.25
wGigCmBR/9XWkPpvYos3aQ: folds 
QEbIGci+itdw+re8RM5fZA: folds 
JjOuv8Vf56aiQjWi/rTPFA: calls $0.25
+2kMBNpY4nF1qNCRd8SJLA: folds 
oLa/tXLfSLLB28mcLGrxcg: folds 
HPEB+AtKw1+C/cxU0o1ciw: folds 
tLcDklc2rBORNfixyRfVfw: checks 
*** FLOP *** [Kc 2h 5d]
tLcDklc2rBORNfixyRfVfw: checks 
YciNm3fUXAQaJeXG1rhrbw: checks 
JjOuv8Vf56aiQjWi/rTPFA: bets $0.50
tLcDklc2rBORNfixyRfVfw: folds 
YciNm3fUXAQaJeXG1rhrbw: folds 
Uncalled bet ($0.50) returned to JjOuv8Vf56aiQjWi/rTPFA
JjOuv8Vf56aiQjWi/rTPFA collected $0.85 from pot
JjOuv8Vf56aiQjWi/rTPFA: doesn't show hand 
*** SUMMARY ***
Total pot $0.85 | Rake $0 
Board [Kc 2h 5d]
Seat 1: HPEB+AtKw1+C/cxU0o1ciw (small blind) folded before Flop
Seat 3: tLcDklc2rBORNfixyRfVfw (big blind) folded on the Flop
Seat 4: YciNm3fUXAQaJeXG1rhrbw folded on the Flop
Seat 5: wGigCmBR/9XWkPpvYos3aQ folded before Flop (didn't bet)
Seat 6: QEbIGci+itdw+re8RM5fZA folded before Flop (didn't bet)
Seat 7: JjOuv8Vf56aiQjWi/rTPFA collected ($0.85)
Seat 8: +2kMBNpY4nF1qNCRd8SJLA folded before Flop (didn't bet)
Seat 9: oLa/tXLfSLLB28mcLGrxcg (button) folded before Flop (didn't bet)




PokerStars Game #59941729372:  Hold'em No Limit ($0.10/$0.25) - 2009/07/01 1:44:19 ET
Table 'b64Z+5XI1xkQzNfq4QHr3A' 6-max Seat #2 is the button
Seat 2: SS/yfeArhULzIcOPe8MdPg ($25 in chips) 
Seat 3: u/yN5P9f3KlATg6WLWNkBQ ($37.85 in chips) 
Seat 4: SxIIgwXYLkwd6m3wLyPTCw ($12.65 in chips) 
Seat 5: JFIAqU8lCZ0vWwEl4bdGsg ($58.60 in chips) 
Seat 6: 8ClCHtFXGNplITm+63KB+Q ($35.85 in chips) 
u/yN5P9f3KlATg6WLWNkBQ: posts small blind $0.10
SxIIgwXYLkwd6m3wLyPTCw: posts big blind $0.25
*** HOLE CARDS ***
JFIAqU8lCZ0vWwEl4bdGsg: calls $0.25
8ClCHtFXGNplITm+63KB+Q: folds 
SS/yfeArhULzIcOPe8MdPg: folds 
u/yN5P9f3KlATg6WLWNkBQ: calls $0.15
SxIIgwXYLkwd6m3wLyPTCw: checks 
*** FLOP *** [Ah 5s Qc]
u/yN5P9f3KlATg6WLWNkBQ: checks 
SS/yfeArhULzIcOPe8MdPg leaves the table
SxIIgwXYLkwd6m3wLyPTCw: bets $0.50
JFIAqU8lCZ0vWwEl4bdGsg: folds 
cooleydoo joins the table at seat #2 
u/yN5P9f3KlATg6WLWNkBQ: calls $0.50
*** TURN *** [Ah 5s Qc] [8s]
u/yN5P9f3KlATg6WLWNkBQ: checks 
SxIIgwXYLkwd6m3wLyPTCw: bets $1.25
u/yN5P9f3KlATg6WLWNkBQ: raises $1.25 to $2.50
SxIIgwXYLkwd6m3wLyPTCw: raises $3.75 to $6.25
u/yN5P9f3KlATg6WLWNkBQ: raises $7.25 to $13.50
SxIIgwXYLkwd6m3wLyPTCw: calls $5.65 and is all-in
Uncalled bet ($1.60) returned to u/yN5P9f3KlATg6WLWNkBQ
*** RIVER *** [Ah 5s Qc 8s] [7h]
*** SHOW DOWN ***
u/yN5P9f3KlATg6WLWNkBQ: shows [8c As] (two pair, Aces and Eights)
SxIIgwXYLkwd6m3wLyPTCw: mucks hand 
u/yN5P9f3KlATg6WLWNkBQ collected $24.30 from pot
*** SUMMARY ***
Total pot $25.55 | Rake $1.25 
Board [Ah 5s Qc 8s 7h]
Seat 2: SS/yfeArhULzIcOPe8MdPg (button) folded before Flop (didn't bet)
Seat 3: u/yN5P9f3KlATg6WLWNkBQ (small blind) showed [8c As] and won ($24.30) with two pair, Aces and Eights
Seat 4: SxIIgwXYLkwd6m3wLyPTCw (big blind) mucked
Seat 5: JFIAqU8lCZ0vWwEl4bdGsg folded on the Flop
Seat 6: 8ClCHtFXGNplITm+63KB+Q folded before Flop (didn't bet)




PokerStars Game #59941729790:  Hold'em No Limit ($0.10/$0.25) - 2009/07/01 1:44:19 ET
Table 'sm5gqEvXgLbkkE4dryW/5g' 6-max Seat #1 is the button
Seat 1: v8m8XHovI5tqEA9mvplDSw ($41.20 in chips) 
Seat 2: 5xs5/u2z1CO9zkRvH72MQg ($19.25 in chips) 
Seat 3: UT5XpwOH1ipkOF7n1MqDJA ($21.40 in chips) 
Seat 4: cWc85bEzdRzpUMhRKm8pwQ ($25.75 in chips) 
Seat 6: aogAb4Eienxztk8p2v9VVw ($20.40 in chips) 
5xs5/u2z1CO9zkRvH72MQg: posts small blind $0.10
UT5XpwOH1ipkOF7n1MqDJA: posts big blind $0.25
*** HOLE CARDS ***
cWc85bEzdRzpUMhRKm8pwQ: folds 
aogAb4Eienxztk8p2v9VVw: folds 
v8m8XHovI5tqEA9mvplDSw: raises $0.75 to $1
5xs5/u2z1CO9zkRvH72MQg: folds 
UT5XpwOH1ipkOF7n1MqDJA: calls $0.75
*** FLOP *** [8h Qd Qs]
UT5XpwOH1ipkOF7n1MqDJA: checks 
v8m8XHovI5tqEA9mvplDSw: checks 
*** TURN *** [8h Qd Qs] [Jh]
UT5XpwOH1ipkOF7n1MqDJA: checks 
v8m8XHovI5tqEA9mvplDSw: checks 
*** RIVER *** [8h Qd Qs Jh] [6h]
UT5XpwOH1ipkOF7n1MqDJA: bets $2
v8m8XHovI5tqEA9mvplDSw: folds 
Uncalled bet ($2) returned to UT5XpwOH1ipkOF7n1MqDJA
UT5XpwOH1ipkOF7n1MqDJA collected $2 from pot
*** SUMMARY ***
Total pot $2.10 | Rake $0.10 
Board [8h Qd Qs Jh 6h]
Seat 1: v8m8XHovI5tqEA9mvplDSw (button) folded on the River
Seat 2: 5xs5/u2z1CO9zkRvH72MQg (small blind) folded before Flop
Seat 3: UT5XpwOH1ipkOF7n1MqDJA (big blind) collected ($2)
Seat 4: cWc85bEzdRzpUMhRKm8pwQ folded before Flop (didn't bet)
Seat 6: aogAb4Eienxztk8p2v9VVw folded before Flop (didn't bet)




PokerStars Game #59941730290:  Hold'em No Limit ($0.10/$0.25) - 2009/07/01 1:44:20 ET
Table 'yAHDCs33TIgw3ra63xuU2Q' 9-max Seat #9 is the button
Seat 1: ydoFOVgzvZv9ZhuWu9rXAw ($4.65 in chips) 
Seat 3: g6UPjSyxNLffCi+EqqIlEg ($21 in chips) 
Seat 4: j5spkbnOCRiLGiH6iqBaqw ($8.60 in chips) 
Seat 5: 4awUyiDYTgylQKXZ9faBVA ($37.60 in chips) 
Seat 6: DnDcAdn9P0zGovMERigpFA ($26.30 in chips) 
Seat 7: qxWFg3MZuVyidB0SJh5ywg ($27.75 in chips) 
Seat 8: tYsOBqdU1+x+yFI7zHO7hQ ($25 in chips) 
Seat 9: MtVtHDqIJTyUcXkRBBDIVA ($25.25 in chips) 
ydoFOVgzvZv9ZhuWu9rXAw: posts small blind $0.10
g6UPjSyxNLffCi+EqqIlEg: posts big blind $0.25
*** HOLE CARDS ***
j5spkbnOCRiLGiH6iqBaqw: folds 
4awUyiDYTgylQKXZ9faBVA: folds 
DnDcAdn9P0zGovMERigpFA: folds 
qxWFg3MZuVyidB0SJh5ywg: folds 
qxWFg3MZuVyidB0SJh5ywg is sitting out
tYsOBqdU1+x+yFI7zHO7hQ: folds 
MtVtHDqIJTyUcXkRBBDIVA: folds 
ydoFOVgzvZv9ZhuWu9rXAw: folds 
Uncalled bet ($0.15) returned to g6UPjSyxNLffCi+EqqIlEg
sat420Man leaves the table
g6UPjSyxNLffCi+EqqIlEg collected $0.20 from pot
*** SUMMARY ***
Total pot $0.20 | Rake $0 
Seat 1: ydoFOVgzvZv9ZhuWu9rXAw (small blind) folded before Flop
Seat 3: g6UPjSyxNLffCi+EqqIlEg (big blind) collected ($0.20)
Seat 4: j5spkbnOCRiLGiH6iqBaqw folded before Flop (didn't bet)
Seat 5: 4awUyiDYTgylQKXZ9faBVA folded before Flop (didn't bet)
Seat 6: DnDcAdn9P0zGovMERigpFA folded before Flop (didn't bet)
Seat 7: qxWFg3MZuVyidB0SJh5ywg folded before Flop (didn't bet)
Seat 8: tYsOBqdU1+x+yFI7zHO7hQ folded before Flop (didn't bet)
Seat 9: MtVtHDqIJTyUcXkRBBDIVA (button) folded before Flop (didn't bet)




PokerStars Game #59941729874:  Hold'em No Limit ($0.10/$0.25) - 2009/07/01 1:44:20 ET
Table 'fHv1Mk7ZbLjprZTGWKPiEQ' 6-max Seat #4 is the button
Seat 1: OIjOiBfQstWrK/RuXx7zcw ($3 in chips) 
Seat 2: 9U3ZKjCsarN0DjR6mSE8Ug ($15.05 in chips) 
Seat 3: /gJNBeCkWL4o85/jvlZ4BA ($27.15 in chips) 
Seat 4: TSmua8tGK3sTbwi0ynrW9Q ($58.80 in chips) 
Seat 5: LJI7A1YgDM7hgh7o56+ReQ ($26.40 in chips) 
Seat 6: AjG0X+rNtc2W08eph8oqpw ($35.85 in chips) 
LJI7A1YgDM7hgh7o56+ReQ: posts small blind $0.10
AjG0X+rNtc2W08eph8oqpw: posts big blind $0.25
*** HOLE CARDS ***
OIjOiBfQstWrK/RuXx7zcw: folds 
9U3ZKjCsarN0DjR6mSE8Ug: folds 
/gJNBeCkWL4o85/jvlZ4BA: folds 
TSmua8tGK3sTbwi0ynrW9Q: folds 
LJI7A1YgDM7hgh7o56+ReQ: folds 
Uncalled bet ($0.15) returned to AjG0X+rNtc2W08eph8oqpw
AjG0X+rNtc2W08eph8oqpw collected $0.20 from pot
AjG0X+rNtc2W08eph8oqpw: doesn't show hand 
*** SUMMARY ***
Total pot $0.20 | Rake $0 
Seat 1: OIjOiBfQstWrK/RuXx7zcw folded before Flop (didn't bet)
Seat 2: 9U3ZKjCsarN0DjR6mSE8Ug folded before Flop (didn't bet)
Seat 3: /gJNBeCkWL4o85/jvlZ4BA folded before Flop (didn't bet)
Seat 4: TSmua8tGK3sTbwi0ynrW9Q (button) folded before Flop (didn't bet)
Seat 5: LJI7A1YgDM7hgh7o56+ReQ (small blind) folded before Flop
Seat 6: AjG0X+rNtc2W08eph8oqpw (big blind) collected ($0.20)




PokerStars Game #59941730058:  Hold'em No Limit ($0.10/$0.25) - 2009/07/01 1:44:20 ET
Table 'vZfV/Uj0q8joA1du9sRJSg' 6-max Seat #6 is the button
Seat 1: Hsvkc0/G2VV78oVmWYXecw ($6.15 in chips) 
Seat 2: wMiE3yTbDJGOLOF9th7KPA ($8.65 in chips) 
Seat 3: cWc85bEzdRzpUMhRKm8pwQ ($25.60 in chips) 
Seat 4: v+QfkGiuj9bgtuNoVnDO8w ($44.35 in chips) 
Seat 5: kyRaCIljYA6l33lSKQfNsg ($27.85 in chips) 
Seat 6: 8ClCHtFXGNplITm+63KB+Q ($44.80 in chips) 
Hsvkc0/G2VV78oVmWYXecw: posts small blind $0.10
wMiE3yTbDJGOLOF9th7KPA: posts big blind $0.25
*** HOLE CARDS ***
cWc85bEzdRzpUMhRKm8pwQ: raises $0.75 to $1
v+QfkGiuj9bgtuNoVnDO8w: folds 
kyRaCIljYA6l33lSKQfNsg: folds 
8ClCHtFXGNplITm+63KB+Q: calls $1
Hsvkc0/G2VV78oVmWYXecw: folds 
wMiE3yTbDJGOLOF9th7KPA: calls $0.75
*** FLOP *** [7d Ts Qh]
wMiE3yTbDJGOLOF9th7KPA: bets $0.50
cWc85bEzdRzpUMhRKm8pwQ: folds 
8ClCHtFXGNplITm+63KB+Q: calls $0.50
*** TURN *** [7d Ts Qh] [6c]
wMiE3yTbDJGOLOF9th7KPA: checks 
8ClCHtFXGNplITm+63KB+Q: bets $2
wMiE3yTbDJGOLOF9th7KPA: calls $2
*** RIVER *** [7d Ts Qh 6c] [7s]
wMiE3yTbDJGOLOF9th7KPA: checks 
8ClCHtFXGNplITm+63KB+Q: bets $5.50
wMiE3yTbDJGOLOF9th7KPA: folds 
Uncalled bet ($5.50) returned to 8ClCHtFXGNplITm+63KB+Q
8ClCHtFXGNplITm+63KB+Q collected $7.75 from pot
8ClCHtFXGNplITm+63KB+Q: doesn't show hand 
*** SUMMARY ***
Total pot $8.10 | Rake $0.35 
Board [7d Ts Qh 6c 7s]
Seat 1: Hsvkc0/G2VV78oVmWYXecw (small blind) folded before Flop
Seat 2: wMiE3yTbDJGOLOF9th7KPA (big blind) folded on the River
Seat 3: cWc85bEzdRzpUMhRKm8pwQ folded on the Flop
Seat 4: v+QfkGiuj9bgtuNoVnDO8w folded before Flop (didn't bet)
Seat 5: kyRaCIljYA6l33lSKQfNsg folded before Flop (didn't bet)
Seat 6: 8ClCHtFXGNplITm+63KB+Q (button) collected ($7.75)




PokerStars Game #59941729914:  Hold'em No Limit ($0.10/$0.25) - 2009/07/01 1:44:20 ET
Table '52Meibn9NOL4XtVi1p2Upw' 9-max Seat #3 is the button
Seat 1: W6tExOcYX7qiy6Qdp+ZwFA ($6.80 in chips) 
Seat 3: Bb42QRQMhg5/Y0vHP8/2Xw ($25 in chips) 
Seat 4: oLa/tXLfSLLB28mcLGrxcg ($31.75 in chips) 
Seat 5: MXCztnYJ58KLHMztZvKrxA ($4.75 in chips) 
Seat 8: PFv56Q1PTkDC084eXIAYmw ($23.75 in chips) 
Seat 9: RCqMONFrSPSArZh2Jsar/w ($19.65 in chips) 
oLa/tXLfSLLB28mcLGrxcg: posts small blind $0.10
MXCztnYJ58KLHMztZvKrxA: posts big blind $0.25
WPT_Champ111: sits out 
Qduu7ikeizo6q6Ei9YvcJA: sits out 
*** HOLE CARDS ***
PFv56Q1PTkDC084eXIAYmw: folds 
RCqMONFrSPSArZh2Jsar/w: folds 
W6tExOcYX7qiy6Qdp+ZwFA: folds 
Bb42QRQMhg5/Y0vHP8/2Xw: folds 
oLa/tXLfSLLB28mcLGrxcg: folds 
Uncalled bet ($0.15) returned to MXCztnYJ58KLHMztZvKrxA
MXCztnYJ58KLHMztZvKrxA collected $0.20 from pot
MXCztnYJ58KLHMztZvKrxA: doesn't show hand 
*** SUMMARY ***
Total pot $0.20 | Rake $0 
Seat 1: W6tExOcYX7qiy6Qdp+ZwFA folded before Flop (didn't bet)
Seat 3: Bb42QRQMhg5/Y0vHP8/2Xw (button) folded before Flop (didn't bet)
Seat 4: oLa/tXLfSLLB28mcLGrxcg (small blind) folded before Flop
Seat 5: MXCztnYJ58KLHMztZvKrxA (big blind) collected ($0.20)
Seat 8: PFv56Q1PTkDC084eXIAYmw folded before Flop (didn't bet)
Seat 9: RCqMONFrSPSArZh2Jsar/w folded before Flop (didn't bet)




PokerStars Game #59941730270:  Hold'em No Limit ($0.10/$0.25) - 2009/07/01 1:44:20 ET
Table 'tANpk8z1C5o0Pq/hpYShHw' 9-max Seat #2 is the button
Seat 1: rQhYIYXSyH/IivYM1dlV5A ($16.90 in chips) 
Seat 2: og4yH4sZUZdC8jjgW8zPJQ ($8.60 in chips) 
Seat 4: j4q3p0lesp63b1gZDwLBZw ($5 in chips) 
Seat 5: X6+pSIPfovPcE87t+LmUKQ ($5 in chips) 
Seat 6: kN0AWJG6biW8tHtuF+wTjA ($14.50 in chips) 
Seat 7: aNpwfA31EREwO+ar4XzBCw ($27.30 in chips) 
Seat 9: gE5rN2TDY1aXcZn/TOPeZw ($7.95 in chips) 
j4q3p0lesp63b1gZDwLBZw: posts small blind $0.10
X6+pSIPfovPcE87t+LmUKQ: posts big blind $0.25
Z9W7+g1WMhhZDi7DwGbCFA: sits out 
*** HOLE CARDS ***
kN0AWJG6biW8tHtuF+wTjA: raises $0.25 to $0.50
aNpwfA31EREwO+ar4XzBCw: folds 
gE5rN2TDY1aXcZn/TOPeZw: folds 
rQhYIYXSyH/IivYM1dlV5A: folds 
og4yH4sZUZdC8jjgW8zPJQ: folds 
j4q3p0lesp63b1gZDwLBZw: folds 
X6+pSIPfovPcE87t+LmUKQ: calls $0.25
*** FLOP *** [3h 6c Qs]
X6+pSIPfovPcE87t+LmUKQ: checks 
kN0AWJG6biW8tHtuF+wTjA: bets $0.50
X6+pSIPfovPcE87t+LmUKQ: folds 
Uncalled bet ($0.50) returned to kN0AWJG6biW8tHtuF+wTjA
kN0AWJG6biW8tHtuF+wTjA collected $1.05 from pot
kN0AWJG6biW8tHtuF+wTjA: doesn't show hand 
*** SUMMARY ***
Total pot $1.10 | Rake $0.05 
Board [3h 6c Qs]
Seat 1: rQhYIYXSyH/IivYM1dlV5A folded before Flop (didn't bet)
Seat 2: og4yH4sZUZdC8jjgW8zPJQ (button) folded before Flop (didn't bet)
Seat 4: j4q3p0lesp63b1gZDwLBZw (small blind) folded before Flop
Seat 5: X6+pSIPfovPcE87t+LmUKQ (big blind) folded on the Flop
Seat 6: kN0AWJG6biW8tHtuF+wTjA collected ($1.05)
Seat 7: aNpwfA31EREwO+ar4XzBCw folded before Flop (didn't bet)
Seat 9: gE5rN2TDY1aXcZn/TOPeZw folded before Flop (didn't bet)




PokerStars Game #59941730514:  Hold'em No Limit ($0.10/$0.25) - 2009/07/01 1:44:21 ET
Table 'AUM6O+mgQAaLDZKMQ/5/gA' 9-max Seat #4 is the button
Seat 1: EIObtVVE4WXRXvLGJA6NHw ($16.25 in chips) 
Seat 3: CvL9Ch1HYCVbTsfpNucitg ($5 in chips) 
Seat 4: 4awUyiDYTgylQKXZ9faBVA ($27.70 in chips) 
Seat 5: +2kMBNpY4nF1qNCRd8SJLA ($25.40 in chips) 
Seat 6: v5jnQ1gfh9nLla3kMXG7Yg ($7.20 in chips) 
Seat 7: Bb42QRQMhg5/Y0vHP8/2Xw ($30.60 in chips) 
Seat 9: eK8qa6EPcH2zhtbmWSvc9g ($25.30 in chips) 
+2kMBNpY4nF1qNCRd8SJLA: posts small blind $0.10
v5jnQ1gfh9nLla3kMXG7Yg: posts big blind $0.25
*** HOLE CARDS ***
Bb42QRQMhg5/Y0vHP8/2Xw: calls $0.25
eK8qa6EPcH2zhtbmWSvc9g: raises $0.75 to $1
EIObtVVE4WXRXvLGJA6NHw: calls $1
CvL9Ch1HYCVbTsfpNucitg: folds 
4awUyiDYTgylQKXZ9faBVA: folds 
+2kMBNpY4nF1qNCRd8SJLA: folds 
v5jnQ1gfh9nLla3kMXG7Yg: folds 
Bb42QRQMhg5/Y0vHP8/2Xw: calls $0.75
*** FLOP *** [7c 6d As]
Bb42QRQMhg5/Y0vHP8/2Xw: checks 
eK8qa6EPcH2zhtbmWSvc9g: checks 
EIObtVVE4WXRXvLGJA6NHw: bets $0.75
Bb42QRQMhg5/Y0vHP8/2Xw: calls $0.75
eK8qa6EPcH2zhtbmWSvc9g: calls $0.75
*** TURN *** [7c 6d As] [4c]
Bb42QRQMhg5/Y0vHP8/2Xw: checks 
eK8qa6EPcH2zhtbmWSvc9g: checks 
EIObtVVE4WXRXvLGJA6NHw: checks 
*** RIVER *** [7c 6d As 4c] [9c]
Bb42QRQMhg5/Y0vHP8/2Xw: checks 
eK8qa6EPcH2zhtbmWSvc9g: checks 
zDrucyjVn5aeekNEc3cJrA has returned
EIObtVVE4WXRXvLGJA6NHw: bets $2
Bb42QRQMhg5/Y0vHP8/2Xw: folds 
eK8qa6EPcH2zhtbmWSvc9g: calls $2
*** SHOW DOWN ***
EIObtVVE4WXRXvLGJA6NHw: shows [Ts Qs] (high card Ace)
eK8qa6EPcH2zhtbmWSvc9g: shows [Js Jc] (a pair of Jacks)
eK8qa6EPcH2zhtbmWSvc9g collected $9.15 from pot
z5GxcHlYz/GSz6W2uFiTtg joins the table at seat #2 
*** SUMMARY ***
Total pot $9.60 | Rake $0.45 
Board [7c 6d As 4c 9c]
Seat 1: EIObtVVE4WXRXvLGJA6NHw showed [Ts Qs] and lost with high card Ace
Seat 3: CvL9Ch1HYCVbTsfpNucitg folded before Flop (didn't bet)
Seat 4: 4awUyiDYTgylQKXZ9faBVA (button) folded before Flop (didn't bet)
Seat 5: +2kMBNpY4nF1qNCRd8SJLA (small blind) folded before Flop
Seat 6: v5jnQ1gfh9nLla3kMXG7Yg (big blind) folded before Flop
Seat 7: Bb42QRQMhg5/Y0vHP8/2Xw folded on the River
Seat 9: eK8qa6EPcH2zhtbmWSvc9g showed [Js Jc] and won ($9.15) with a pair of Jacks




PokerStars Game #59941730442:  Hold'em No Limit ($0.10/$0.25) - 2009/07/01 1:44:21 ET
Table '6wawJ+MkkvuC3coG6r+Yhg' 6-max Seat #1 is the button
Seat 1: JQZew0FjzS19kTjeNtrE+A ($28.25 in chips) 
Seat 2: LtASJ9OlkqGrrUKGQlpGAw ($34.40 in chips) 
Seat 3: 3zD3qLXT1bEffAoWGnc7wg ($58.75 in chips) 
Seat 4: yxmjNFGiKI3b+XQGJzJVIg ($28.30 in chips) 
Seat 5: FZrgDbxAanC1xwZxXHJKVA ($3.20 in chips) 
Seat 6: B3X187C0tXFUfQpCu8pe8A ($26.75 in chips) 
LtASJ9OlkqGrrUKGQlpGAw: posts small blind $0.10
3zD3qLXT1bEffAoWGnc7wg: posts big blind $0.25
*** HOLE CARDS ***
yxmjNFGiKI3b+XQGJzJVIg: folds 
FZrgDbxAanC1xwZxXHJKVA: calls $0.25
B3X187C0tXFUfQpCu8pe8A: calls $0.25
JQZew0FjzS19kTjeNtrE+A: folds 
LtASJ9OlkqGrrUKGQlpGAw: calls $0.15
3zD3qLXT1bEffAoWGnc7wg: checks 
*** FLOP *** [6s 3s Tc]
LtASJ9OlkqGrrUKGQlpGAw: checks 
3zD3qLXT1bEffAoWGnc7wg: bets $1
FZrgDbxAanC1xwZxXHJKVA: calls $1
B3X187C0tXFUfQpCu8pe8A: calls $1
LtASJ9OlkqGrrUKGQlpGAw: folds 
*** TURN *** [6s 3s Tc] [Ah]
3zD3qLXT1bEffAoWGnc7wg: checks 
FZrgDbxAanC1xwZxXHJKVA: checks 
B3X187C0tXFUfQpCu8pe8A: checks 
*** RIVER *** [6s 3s Tc Ah] [5h]
3zD3qLXT1bEffAoWGnc7wg: checks 
FZrgDbxAanC1xwZxXHJKVA: checks 
B3X187C0tXFUfQpCu8pe8A: checks 
*** SHOW DOWN ***
3zD3qLXT1bEffAoWGnc7wg: shows [Qh Th] (a pair of Tens)
FZrgDbxAanC1xwZxXHJKVA: mucks hand 
B3X187C0tXFUfQpCu8pe8A: mucks hand 
3zD3qLXT1bEffAoWGnc7wg collected $3.85 from pot
*** SUMMARY ***
Total pot $4 | Rake $0.15 
Board [6s 3s Tc Ah 5h]
Seat 1: JQZew0FjzS19kTjeNtrE+A (button) folded before Flop (didn't bet)
Seat 2: LtASJ9OlkqGrrUKGQlpGAw (small blind) folded on the Flop
Seat 3: 3zD3qLXT1bEffAoWGnc7wg (big blind) showed [Qh Th] and won ($3.85) with a pair of Tens
Seat 4: yxmjNFGiKI3b+XQGJzJVIg folded before Flop (didn't bet)
Seat 5: FZrgDbxAanC1xwZxXHJKVA mucked
Seat 6: B3X187C0tXFUfQpCu8pe8A mucked




PokerStars Game #59941730396:  Hold'em No Limit ($0.10/$0.25) - 2009/07/01 1:44:21 ET
Table '2vH5RcmkT0F4XNS/EmmyMA' 6-max Seat #5 is the button
Seat 1: hOaWAImn5/MZDAWAPlYHCw ($6.50 in chips) 
Seat 2: W6Y6au0wf7gRAlqJYgOezw ($11.85 in chips) 
Seat 3: t8P79jKZYh/Wpx2V73pSqg ($29.90 in chips) 
Seat 4: FC6tJ9EOiutXO8hnpR4VgQ ($5.65 in chips) 
Seat 5: Hsvkc0/G2VV78oVmWYXecw ($5.15 in chips) 
Seat 6: if4dh6jhJXeN3/qd3qCp9g ($26.20 in chips) 
if4dh6jhJXeN3/qd3qCp9g: posts small blind $0.10
hOaWAImn5/MZDAWAPlYHCw: posts big blind $0.25
*** HOLE CARDS ***
W6Y6au0wf7gRAlqJYgOezw: folds 
t8P79jKZYh/Wpx2V73pSqg: raises $0.50 to $0.75
FC6tJ9EOiutXO8hnpR4VgQ: folds 
Hsvkc0/G2VV78oVmWYXecw: folds 
if4dh6jhJXeN3/qd3qCp9g: calls $0.65
hOaWAImn5/MZDAWAPlYHCw: folds 
*** FLOP *** [5d 7c Ac]
if4dh6jhJXeN3/qd3qCp9g: checks 
t8P79jKZYh/Wpx2V73pSqg: bets $1
if4dh6jhJXeN3/qd3qCp9g: folds 
Uncalled bet ($1) returned to t8P79jKZYh/Wpx2V73pSqg
t8P79jKZYh/Wpx2V73pSqg collected $1.70 from pot
*** SUMMARY ***
Total pot $1.75 | Rake $0.05 
Board [5d 7c Ac]
Seat 1: hOaWAImn5/MZDAWAPlYHCw (big blind) folded before Flop
Seat 2: W6Y6au0wf7gRAlqJYgOezw folded before Flop (didn't bet)
Seat 3: t8P79jKZYh/Wpx2V73pSqg collected ($1.70)
Seat 4: FC6tJ9EOiutXO8hnpR4VgQ folded before Flop (didn't bet)
Seat 5: Hsvkc0/G2VV78oVmWYXecw (button) folded before Flop (didn't bet)
Seat 6: if4dh6jhJXeN3/qd3qCp9g (small blind) folded on the Flop




PokerStars Game #59941730722:  Hold'em No Limit ($0.10/$0.25) - 2009/07/01 1:44:21 ET
Table 'Jz+kWRxWNGk9w24fdQEveA' 9-max Seat #8 is the button
Seat 1: Z9W7+g1WMhhZDi7DwGbCFA ($5 in chips) 
Seat 2: ljemhp25Zg+nlA9DLCIiUw ($38.85 in chips) 
Seat 4: HPEB+AtKw1+C/cxU0o1ciw ($29 in chips) 
Seat 5: d6eSA7wOH5mRaSyVDVRBLw ($11.75 in chips) 
Seat 6: BXkjaKe7T/rw37TNNtBVwQ ($5 in chips) 
Seat 7: wGigCmBR/9XWkPpvYos3aQ ($26.75 in chips) 
Seat 8: j4q3p0lesp63b1gZDwLBZw ($5 in chips) 
Seat 9: V6p0jQ/RhUsqpHLmXvEX4Q ($17.45 in chips) 
V6p0jQ/RhUsqpHLmXvEX4Q: posts small blind $0.10
Z9W7+g1WMhhZDi7DwGbCFA: posts big blind $0.25
WPT_Champ111: sits out 
BXkjaKe7T/rw37TNNtBVwQ: posts big blind $0.25
*** HOLE CARDS ***
ljemhp25Zg+nlA9DLCIiUw: folds 
HPEB+AtKw1+C/cxU0o1ciw: folds 
d6eSA7wOH5mRaSyVDVRBLw: folds 
BXkjaKe7T/rw37TNNtBVwQ: checks 
wGigCmBR/9XWkPpvYos3aQ: folds 
j4q3p0lesp63b1gZDwLBZw: folds 
V6p0jQ/RhUsqpHLmXvEX4Q: folds 
Z9W7+g1WMhhZDi7DwGbCFA: checks 
*** FLOP *** [9h Ad 2s]
Z9W7+g1WMhhZDi7DwGbCFA: checks 
BXkjaKe7T/rw37TNNtBVwQ: checks 
*** TURN *** [9h Ad 2s] [Jd]
Z9W7+g1WMhhZDi7DwGbCFA: checks 
BXkjaKe7T/rw37TNNtBVwQ: bets $0.50
Z9W7+g1WMhhZDi7DwGbCFA: folds 
Uncalled bet ($0.50) returned to BXkjaKe7T/rw37TNNtBVwQ
BXkjaKe7T/rw37TNNtBVwQ collected $0.60 from pot
BXkjaKe7T/rw37TNNtBVwQ: doesn't show hand 
*** SUMMARY ***
Total pot $0.60 | Rake $0 
Board [9h Ad 2s Jd]
Seat 1: Z9W7+g1WMhhZDi7DwGbCFA (big blind) folded on the Turn
Seat 2: ljemhp25Zg+nlA9DLCIiUw folded before Flop (didn't bet)
Seat 4: HPEB+AtKw1+C/cxU0o1ciw folded before Flop (didn't bet)
Seat 5: d6eSA7wOH5mRaSyVDVRBLw folded before Flop (didn't bet)
Seat 6: BXkjaKe7T/rw37TNNtBVwQ collected ($0.60)
Seat 7: wGigCmBR/9XWkPpvYos3aQ folded before Flop (didn't bet)
Seat 8: j4q3p0lesp63b1gZDwLBZw (button) folded before Flop (didn't bet)
Seat 9: V6p0jQ/RhUsqpHLmXvEX4Q (small blind) folded before Flop




PokerStars Game #59941730688:  Hold'em No Limit ($0.10/$0.25) - 2009/07/01 1:44:21 ET
Table 'axb9RsG8Zj1A0LEukTeFrQ' 9-max Seat #3 is the button
Seat 1: qwr38jl5txoR36M7G5qi4A ($8.50 in chips) 
Seat 3: H5Se03ZqSX7tbULXur2MAg ($23.85 in chips) 
Seat 4: tLcDklc2rBORNfixyRfVfw ($27.20 in chips) 
Seat 5: rLSSHKOHnb6yzVfDoQM/RA ($15.10 in chips) 
Seat 6: Iu9xjReQYvxYiqQm8n6MXQ ($5.35 in chips) 
Seat 7: PdIasPkzm2sqZnN41ZRXOg ($5 in chips) 
Seat 8: VBHxUExRAMrbxUq/cVx9Gw ($4.30 in chips) 
Seat 9: qbQE8CifKB4+OEvNF/61Rw ($57.40 in chips) 
tLcDklc2rBORNfixyRfVfw: posts small blind $0.10
rLSSHKOHnb6yzVfDoQM/RA: posts big blind $0.25
*** HOLE CARDS ***
Iu9xjReQYvxYiqQm8n6MXQ: folds 
PdIasPkzm2sqZnN41ZRXOg: folds 
VBHxUExRAMrbxUq/cVx9Gw: folds 
qbQE8CifKB4+OEvNF/61Rw: raises $0.25 to $0.50
qwr38jl5txoR36M7G5qi4A: folds 
H5Se03ZqSX7tbULXur2MAg: calls $0.50
tLcDklc2rBORNfixyRfVfw: folds 
rLSSHKOHnb6yzVfDoQM/RA: calls $0.25
*** FLOP *** [As Js 7c]
rLSSHKOHnb6yzVfDoQM/RA: checks 
qbQE8CifKB4+OEvNF/61Rw: bets $1
zDrucyjVn5aeekNEc3cJrA has returned
H5Se03ZqSX7tbULXur2MAg: folds 
rLSSHKOHnb6yzVfDoQM/RA: folds 
Uncalled bet ($1) returned to qbQE8CifKB4+OEvNF/61Rw
qbQE8CifKB4+OEvNF/61Rw collected $1.55 from pot
qbQE8CifKB4+OEvNF/61Rw: shows [Jc Jh] (three of a kind, Jacks)
*** SUMMARY ***
Total pot $1.60 | Rake $0.05 
Board [As Js 7c]
Seat 1: qwr38jl5txoR36M7G5qi4A folded before Flop (didn't bet)
Seat 3: H5Se03ZqSX7tbULXur2MAg (button) folded on the Flop
Seat 4: tLcDklc2rBORNfixyRfVfw (small blind) folded before Flop
Seat 5: rLSSHKOHnb6yzVfDoQM/RA (big blind) folded on the Flop
Seat 6: Iu9xjReQYvxYiqQm8n6MXQ folded before Flop (didn't bet)
Seat 7: PdIasPkzm2sqZnN41ZRXOg folded before Flop (didn't bet)
Seat 8: VBHxUExRAMrbxUq/cVx9Gw folded before Flop (didn't bet)
Seat 9: qbQE8CifKB4+OEvNF/61Rw collected ($1.55)




PokerStars Game #59941730488:  Hold'em No Limit ($0.10/$0.25) - 2009/07/01 1:44:21 ET
Table 'nc6OeGk/wtaWV+6N+kgnZQgZetDqJh6q9A3mLO3ThCsASeat #3 is the button
Seat 1: DihMHaz4WNETH1bPDe13kA ($26.05 in chips) 
Seat 2: JFIAqU8lCZ0vWwEl4bdGsg ($32.90 in chips) 
Seat 3: jp34e617tIzV8tKIWmfAbA ($33.45 in chips) 
Seat 4: BV+K0Phf5VBHr7aZPKqbUQ ($29.10 in chips) 
Seat 5: 5hAPbqNrvJb8PtLiceXtlgEKTLAV1bAterT0Mc1G6lBg5.10 in chips) 
BV+K0Phf5VBHr7aZPKqbUQ: posts small blind $0.10
5hAPbqNrvJb8PtLiceXtlgEKTLAV1bAterT0Mc1G6lBgsts big blind $0.25
StevenWu: sits out 
*** HOLE CARDS ***
DihMHaz4WNETH1bPDe13kA: folds 
JFIAqU8lCZ0vWwEl4bdGsg: folds 
jp34e617tIzV8tKIWmfAbA: raises $0.50 to $0.75
BV+K0Phf5VBHr7aZPKqbUQ: folds 
5hAPbqNrvJb8PtLiceXtlgEKTLAV1bAterT0Mc1G6lBglds 
Uncalled bet ($0.50) returned to jp34e617tIzV8tKIWmfAbA
jp34e617tIzV8tKIWmfAbA collected $0.60 from pot
*** SUMMARY ***
Total pot $0.60 | Rake $0 
Seat 1: DihMHaz4WNETH1bPDe13kA folded before Flop (didn't bet)
Seat 2: JFIAqU8lCZ0vWwEl4bdGsg folded before Flop (didn't bet)
Seat 3: jp34e617tIzV8tKIWmfAbA (button) collected ($0.60)
Seat 4: BV+K0Phf5VBHr7aZPKqbUQ (small blind) folded before Flop
Seat 5: 5hAPbqNrvJb8PtLiceXtlgEKTLAV1bAterT0Mc1G6lBgg blind) folded before Flop




PokerStars Game #59941730846:  Hold'em No Limit ($0.10/$0.25) - 2009/07/01 1:44:21 ET
Table 'Qr+t8WGovMECkBv+cV1lrg' 6-max Seat #2 is the button
Seat 1: EeUZtMU058v2ObUACOF4Og ($44.75 in chips) 
Seat 2: vqWjZmdQu/Hxw96/IJTWdQ ($25 in chips) 
Seat 3: uZKkrGByYgd4/ZBX2d4z+w ($26.40 in chips) 
Seat 4: 1NNFfYMd5Hsphl/FYz9fNA ($62.40 in chips) 
Seat 5: 9q7YGTKe9k5fYb4fmZc3Ww ($32.35 in chips) 
uZKkrGByYgd4/ZBX2d4z+w: posts small blind $0.10
1NNFfYMd5Hsphl/FYz9fNA: posts big blind $0.25
9U3ZKjCsarN0DjR6mSE8Ug: sits out 
*** HOLE CARDS ***
9q7YGTKe9k5fYb4fmZc3Ww: folds 
EeUZtMU058v2ObUACOF4Og: folds 
vqWjZmdQu/Hxw96/IJTWdQ: folds 
uZKkrGByYgd4/ZBX2d4z+w: calls $0.15
1NNFfYMd5Hsphl/FYz9fNA: checks 
*** FLOP *** [Qh Qs 9c]
uZKkrGByYgd4/ZBX2d4z+w: checks 
1NNFfYMd5Hsphl/FYz9fNA: checks 
*** TURN *** [Qh Qs 9c] [2h]
uZKkrGByYgd4/ZBX2d4z+w: checks 
1NNFfYMd5Hsphl/FYz9fNA: checks 
*** RIVER *** [Qh Qs 9c 2h] [Kd]
uZKkrGByYgd4/ZBX2d4z+w: bets $1
1NNFfYMd5Hsphl/FYz9fNA: folds 
Uncalled bet ($1) returned to uZKkrGByYgd4/ZBX2d4z+w
uZKkrGByYgd4/ZBX2d4z+w collected $0.50 from pot
*** SUMMARY ***
Total pot $0.50 | Rake $0 
Board [Qh Qs 9c 2h Kd]
Seat 1: EeUZtMU058v2ObUACOF4Og folded before Flop (didn't bet)
Seat 2: vqWjZmdQu/Hxw96/IJTWdQ (button) folded before Flop (didn't bet)
Seat 3: uZKkrGByYgd4/ZBX2d4z+w (small blind) collected ($0.50)
Seat 4: 1NNFfYMd5Hsphl/FYz9fNA (big blind) folded on the River
Seat 5: 9q7YGTKe9k5fYb4fmZc3Ww folded before Flop (didn't bet)




PokerStars Game #59941731378:  Hold'em No Limit ($0.10/$0.25) - 2009/07/01 1:44:22 ET
Table 'oxYpQNT8OHNCvpMIFi7UoA' 9-max Seat #1 is the button
Seat 1: EVqHvqty1ZsuvDFiSXlSqQ ($33.20 in chips) 
Seat 2: 8+iP8mvFyeAviW/yUH1CJg ($29.95 in chips) 
Seat 3: ubsjZomMWSV0hAiBLa7K1A ($19.65 in chips) 
Seat 4: eK8qa6EPcH2zhtbmWSvc9g ($25 in chips) 
Seat 5: ZoqLw33zTU6EsjOkfv/cGw ($19.90 in chips) 
Seat 6: VBHxUExRAMrbxUq/cVx9Gw ($5.40 in chips) 
Seat 7: X78b5v/uhqeXXoAijbw/yg ($36.65 in chips) 
Seat 9: pN3IHvAKm2fz+sTRARTcrg ($25 in chips) 
8+iP8mvFyeAviW/yUH1CJg: posts small blind $0.10
ubsjZomMWSV0hAiBLa7K1A: posts big blind $0.25
*** HOLE CARDS ***
eK8qa6EPcH2zhtbmWSvc9g: folds 
ZoqLw33zTU6EsjOkfv/cGw: folds 
VBHxUExRAMrbxUq/cVx9Gw: folds 
X78b5v/uhqeXXoAijbw/yg: folds 
pN3IHvAKm2fz+sTRARTcrg: folds 
EVqHvqty1ZsuvDFiSXlSqQ: folds 
8+iP8mvFyeAviW/yUH1CJg: calls $0.15
ubsjZomMWSV0hAiBLa7K1A: checks 
*** FLOP *** [7d 4s 3c]
8+iP8mvFyeAviW/yUH1CJg: checks 
ubsjZomMWSV0hAiBLa7K1A: checks 
*** TURN *** [7d 4s 3c] [4d]
8+iP8mvFyeAviW/yUH1CJg: checks 
ubsjZomMWSV0hAiBLa7K1A: checks 
*** RIVER *** [7d 4s 3c 4d] [5s]
8+iP8mvFyeAviW/yUH1CJg: checks 
ubsjZomMWSV0hAiBLa7K1A: bets $1.50
8+iP8mvFyeAviW/yUH1CJg: folds 
Uncalled bet ($1.50) returned to ubsjZomMWSV0hAiBLa7K1A
ubsjZomMWSV0hAiBLa7K1A collected $0.50 from pot
ubsjZomMWSV0hAiBLa7K1A: doesn't show hand 
*** SUMMARY ***
Total pot $0.50 | Rake $0 
Board [7d 4s 3c 4d 5s]
Seat 1: EVqHvqty1ZsuvDFiSXlSqQ (button) folded before Flop (didn't bet)
Seat 2: 8+iP8mvFyeAviW/yUH1CJg (small blind) folded on the River
Seat 3: ubsjZomMWSV0hAiBLa7K1A (big blind) collected ($0.50)
Seat 4: eK8qa6EPcH2zhtbmWSvc9g folded before Flop (didn't bet)
Seat 5: ZoqLw33zTU6EsjOkfv/cGw folded before Flop (didn't bet)
Seat 6: VBHxUExRAMrbxUq/cVx9Gw folded before Flop (didn't bet)
Seat 7: X78b5v/uhqeXXoAijbw/yg folded before Flop (didn't bet)
Seat 9: pN3IHvAKm2fz+sTRARTcrg folded before Flop (didn't bet)




PokerStars Game #59941731344:  Hold'em No Limit ($0.10/$0.25) - 2009/07/01 1:44:22 ET
Table 'Is9eNmJA1KnBOw0lcVkxUQ' 9-max Seat #1 is the button
Seat 1: 56S3mA6Zs3pGR+0p0vUCtg ($32 in chips) 
Seat 2: VllYilcih0t+gMD4GTRlgQ ($37.60 in chips) 
Seat 3: ubsjZomMWSV0hAiBLa7K1A ($19.50 in chips) 
Seat 4: cZ99hugmLBj9KhTlc8nCSw ($25 in chips) 
Seat 6: HapyJHxV6lc3eqoT7yWL2A ($33.45 in chips) 
Seat 7: aNpwfA31EREwO+ar4XzBCw ($29.05 in chips) 
Seat 8: Th3FldXKQW6hWVVPahaoOQ ($25.50 in chips) 
Seat 9: DdPXdieucQ+n99u1n3A+rQ ($4.90 in chips) 
VllYilcih0t+gMD4GTRlgQ: posts small blind $0.10
ubsjZomMWSV0hAiBLa7K1A: posts big blind $0.25
Qduu7ikeizo6q6Ei9YvcJA: sits out 
*** HOLE CARDS ***
cZ99hugmLBj9KhTlc8nCSw: folds 
HapyJHxV6lc3eqoT7yWL2A: raises $0.50 to $0.75
aNpwfA31EREwO+ar4XzBCw: calls $0.75
Th3FldXKQW6hWVVPahaoOQ: folds 
DdPXdieucQ+n99u1n3A+rQ: folds 
56S3mA6Zs3pGR+0p0vUCtg: folds 
VllYilcih0t+gMD4GTRlgQ: folds 
ubsjZomMWSV0hAiBLa7K1A: folds 
*** FLOP *** [8c 8s 2c]
HapyJHxV6lc3eqoT7yWL2A: bets $1.25
aNpwfA31EREwO+ar4XzBCw: folds 
Uncalled bet ($1.25) returned to HapyJHxV6lc3eqoT7yWL2A
HapyJHxV6lc3eqoT7yWL2A collected $1.80 from pot
HapyJHxV6lc3eqoT7yWL2A: doesn't show hand 
*** SUMMARY ***
Total pot $1.85 | Rake $0.05 
Board [8c 8s 2c]
Seat 1: 56S3mA6Zs3pGR+0p0vUCtg (button) folded before Flop (didn't bet)
Seat 2: VllYilcih0t+gMD4GTRlgQ (small blind) folded before Flop
Seat 3: ubsjZomMWSV0hAiBLa7K1A (big blind) folded before Flop
Seat 4: cZ99hugmLBj9KhTlc8nCSw folded before Flop (didn't bet)
Seat 6: HapyJHxV6lc3eqoT7yWL2A collected ($1.80)
Seat 7: aNpwfA31EREwO+ar4XzBCw folded on the Flop
Seat 8: Th3FldXKQW6hWVVPahaoOQ folded before Flop (didn't bet)
Seat 9: DdPXdieucQ+n99u1n3A+rQ folded before Flop (didn't bet)




PokerStars Game #59941731138:  Hold'em No Limit ($0.10/$0.25) - 2009/07/01 1:44:22 ET
Table '2AUmC2Rslg+QUbLfdgNdfg' 6-max Seat #4 is the button
Seat 1: YDXAegrCnzc0l6TSDNboXQ ($26.50 in chips) 
Seat 2: PLksyNlTVRVZwxJVC2/1eA ($22.50 in chips) 
Seat 3: JFIAqU8lCZ0vWwEl4bdGsg ($25.70 in chips) 
Seat 4: lquriepNQBhDV5P1SWHhnA ($26.25 in chips) 
Seat 6: xBWc54v+UTSJOiKpbAbJWg ($10.60 in chips) 
xBWc54v+UTSJOiKpbAbJWg: posts small blind $0.10
YDXAegrCnzc0l6TSDNboXQ: posts big blind $0.25
*** HOLE CARDS ***
PLksyNlTVRVZwxJVC2/1eA: folds 
JFIAqU8lCZ0vWwEl4bdGsg: folds 
lquriepNQBhDV5P1SWHhnA: folds 
xBWc54v+UTSJOiKpbAbJWg: calls $0.15
AMc4cCwUJhokdGRYIaVPhQ has returned
YDXAegrCnzc0l6TSDNboXQ: checks 
*** FLOP *** [Qd 9c Js]
xBWc54v+UTSJOiKpbAbJWg: checks 
YDXAegrCnzc0l6TSDNboXQ: checks 
*** TURN *** [Qd 9c Js] [3s]
xBWc54v+UTSJOiKpbAbJWg: bets $0.25
YDXAegrCnzc0l6TSDNboXQ: calls $0.25
*** RIVER *** [Qd 9c Js 3s] [4c]
xBWc54v+UTSJOiKpbAbJWg: bets $0.50
YDXAegrCnzc0l6TSDNboXQ: folds 
Uncalled bet ($0.50) returned to xBWc54v+UTSJOiKpbAbJWg
xBWc54v+UTSJOiKpbAbJWg collected $0.95 from pot
*** SUMMARY ***
Total pot $1 | Rake $0.05 
Board [Qd 9c Js 3s 4c]
Seat 1: YDXAegrCnzc0l6TSDNboXQ (big blind) folded on the River
Seat 2: PLksyNlTVRVZwxJVC2/1eA folded before Flop (didn't bet)
Seat 3: JFIAqU8lCZ0vWwEl4bdGsg folded before Flop (didn't bet)
Seat 4: lquriepNQBhDV5P1SWHhnA (button) folded before Flop (didn't bet)
Seat 6: xBWc54v+UTSJOiKpbAbJWg (small blind) collected ($0.95)




PokerStars Game #59941731280:  Hold'em No Limit ($0.10/$0.25) - 2009/07/01 1:44:22 ET
Table 'NtCSSONEf1zaJo3042tQug' 6-max Seat #2 is the button
Seat 1: KXtdqb+rIMkjc0RvHDksGQ ($35.10 in chips) 
Seat 2: vqWjZmdQu/Hxw96/IJTWdQ ($26.95 in chips) 
Seat 3: 9kUKGKkblnIx3m8rlVol6Q ($15.75 in chips) 
Seat 4: HxD1kB8zCmalQSdWAkKmlg ($29.20 in chips) 
Seat 5: tOAk1Og4mVObMBOfvdDYOw ($30.40 in chips) 
Seat 6: LxehwDpTQ19ph4Qmc78+Pw ($29 in chips) 
9kUKGKkblnIx3m8rlVol6Q: posts small blind $0.10
HxD1kB8zCmalQSdWAkKmlg: posts big blind $0.25
*** HOLE CARDS ***
tOAk1Og4mVObMBOfvdDYOw: folds 
LxehwDpTQ19ph4Qmc78+Pw: folds 
KXtdqb+rIMkjc0RvHDksGQ: folds 
vqWjZmdQu/Hxw96/IJTWdQ: raises $0.50 to $0.75
9kUKGKkblnIx3m8rlVol6Q: folds 
HxD1kB8zCmalQSdWAkKmlg: folds 
Uncalled bet ($0.50) returned to vqWjZmdQu/Hxw96/IJTWdQ
vqWjZmdQu/Hxw96/IJTWdQ collected $0.60 from pot
vqWjZmdQu/Hxw96/IJTWdQ: doesn't show hand 
*** SUMMARY ***
Total pot $0.60 | Rake $0 
Seat 1: KXtdqb+rIMkjc0RvHDksGQ folded before Flop (didn't bet)
Seat 2: vqWjZmdQu/Hxw96/IJTWdQ (button) collected ($0.60)
Seat 3: 9kUKGKkblnIx3m8rlVol6Q (small blind) folded before Flop
Seat 4: HxD1kB8zCmalQSdWAkKmlg (big blind) folded before Flop
Seat 5: tOAk1Og4mVObMBOfvdDYOw folded before Flop (didn't bet)
Seat 6: LxehwDpTQ19ph4Qmc78+Pw folded before Flop (didn't bet)




PokerStars Game #59941731230:  Hold'em No Limit ($0.10/$0.25) - 2009/07/01 1:44:22 ET
Table '5NipxzzFB2DffzDpddyQoQ' 6-max Seat #2 is the button
Seat 1: W87HPwOk1KtWaYyshBe1gA ($21.25 in chips) 
Seat 2: iauW7L/+7qzAuHow7CD75Q ($9.50 in chips) 
Seat 3: QvTX2yGq3uKJiKPmns4TKQ ($18.65 in chips) 
Seat 4: NTamLAiMZ86c5yM04t96LA ($16.10 in chips) 
Seat 5: faP2NVl/cFTZ1nE4pXzg8Q ($33.85 in chips) 
Seat 6: 7JqTFMyeNSVWsmp/yW35Tw ($28.55 in chips) 
QvTX2yGq3uKJiKPmns4TKQ: posts small blind $0.10
NTamLAiMZ86c5yM04t96LA: posts big blind $0.25
*** HOLE CARDS ***
NTamLAiMZ86c5yM04t96LA said, "dont say that"
iauW7L/+7qzAuHow7CD75Q said, "sorry"
faP2NVl/cFTZ1nE4pXzg8Q: folds 
7JqTFMyeNSVWsmp/yW35Tw: folds 
W87HPwOk1KtWaYyshBe1gA: folds 
iauW7L/+7qzAuHow7CD75Q: folds 
QvTX2yGq3uKJiKPmns4TKQ: raises $0.50 to $0.75
NTamLAiMZ86c5yM04t96LA: raises $15.35 to $16.10 and is all-in
QvTX2yGq3uKJiKPmns4TKQ: calls $15.35
*** FLOP *** [7d Kd 3d]
7JqTFMyeNSVWsmp/yW35Tw said, "you in tucson bdid?"
iauW7L/+7qzAuHow7CD75Q said, "lol"
*** TURN *** [7d Kd 3d] [2s]
iauW7L/+7qzAuHow7CD75Q said, "awesome"
*** RIVER *** [7d Kd 3d 2s] [4h]
7JqTFMyeNSVWsmp/yW35Tw said, "we are neighbors"
*** SHOW DOWN ***
QvTX2yGq3uKJiKPmns4TKQ: shows [Ah Jc] (high card Ace)
NTamLAiMZ86c5yM04t96LA: shows [Ac Qc] (high card Ace - King+Queen kicker)
NTamLAiMZ86c5yM04t96LA collected $30.60 from pot
*** SUMMARY ***
Total pot $32.20 | Rake $1.60 
Board [7d Kd 3d 2s 4h]
Seat 1: W87HPwOk1KtWaYyshBe1gA folded before Flop (didn't bet)
Seat 2: iauW7L/+7qzAuHow7CD75Q (button) folded before Flop (didn't bet)
Seat 3: QvTX2yGq3uKJiKPmns4TKQ (small blind) showed [Ah Jc] and lost with high card Ace
Seat 4: NTamLAiMZ86c5yM04t96LA (big blind) showed [Ac Qc] and won ($30.60) with high card Ace
Seat 5: faP2NVl/cFTZ1nE4pXzg8Q folded before Flop (didn't bet)
Seat 6: 7JqTFMyeNSVWsmp/yW35Tw folded before Flop (didn't bet)




PokerStars Game #59941731072:  Hold'em No Limit ($0.10/$0.25) - 2009/07/01 1:44:22 ET
Table 'vFZR6Kf2Th5xBXT9brGW6A' 6-max Seat #4 is the button
Seat 1: Q3EMN7b0ie81AFWkDrhCjw ($22.25 in chips) 
Seat 2: QiL+lEgEWwy21jk/ltaRLg ($22.40 in chips) 
Seat 3: SH1WjKVUjPiyXySjWSdazw ($21.35 in chips) 
Seat 4: 79ID/ub1Pt/mDpCprVmOoA ($35.20 in chips) 
Seat 5: SS/yfeArhULzIcOPe8MdPg ($26.40 in chips) 
Seat 6: 4x9jCqgSw4272dnaIqnanw ($5 in chips) 
SS/yfeArhULzIcOPe8MdPg: posts small blind $0.10
4x9jCqgSw4272dnaIqnanw: posts big blind $0.25
*** HOLE CARDS ***
Q3EMN7b0ie81AFWkDrhCjw: calls $0.25
QiL+lEgEWwy21jk/ltaRLg: folds 
SH1WjKVUjPiyXySjWSdazw: folds 
79ID/ub1Pt/mDpCprVmOoA: folds 
SS/yfeArhULzIcOPe8MdPg: folds 
4x9jCqgSw4272dnaIqnanw: checks 
*** FLOP *** [Qs 6c 9c]
4x9jCqgSw4272dnaIqnanw: bets $0.25
Q3EMN7b0ie81AFWkDrhCjw: folds 
Uncalled bet ($0.25) returned to 4x9jCqgSw4272dnaIqnanw
4x9jCqgSw4272dnaIqnanw collected $0.60 from pot
*** SUMMARY ***
Total pot $0.60 | Rake $0 
Board [Qs 6c 9c]
Seat 1: Q3EMN7b0ie81AFWkDrhCjw folded on the Flop
Seat 2: QiL+lEgEWwy21jk/ltaRLg folded before Flop (didn't bet)
Seat 3: SH1WjKVUjPiyXySjWSdazw folded before Flop (didn't bet)
Seat 4: 79ID/ub1Pt/mDpCprVmOoA (button) folded before Flop (didn't bet)
Seat 5: SS/yfeArhULzIcOPe8MdPg (small blind) folded before Flop
Seat 6: 4x9jCqgSw4272dnaIqnanw (big blind) collected ($0.60)




PokerStars Game #59941731222:  Hold'em No Limit ($0.10/$0.25) - 2009/07/01 1:44:22 ET
Table 'oJpFwZj9+FUGHX90Un8s9Q' 6-max Seat #3 is the button
Seat 1: 6DwBRH+xZ12AAZmeAg+aXw ($21.85 in chips) 
Seat 2: NtrVQ9UIql0rDCnKDKZ5FQ ($14.80 in chips) 
Seat 3: kyRaCIljYA6l33lSKQfNsg ($27 in chips) 
Seat 4: 6elpmfyt4Zw0yvd8lePSMQ ($21.90 in chips) 
Seat 5: kG34n23qFQA3nzdOJTQ1dA ($56.10 in chips) 
Seat 6: edio/rLJ06xeZOfLhoL3UA ($1.20 in chips) 
6elpmfyt4Zw0yvd8lePSMQ: posts small blind $0.10
kG34n23qFQA3nzdOJTQ1dA: posts big blind $0.25
*** HOLE CARDS ***
edio/rLJ06xeZOfLhoL3UA: calls $0.25
6DwBRH+xZ12AAZmeAg+aXw: raises $0.75 to $1
NtrVQ9UIql0rDCnKDKZ5FQ: folds 
kyRaCIljYA6l33lSKQfNsg: folds 
6elpmfyt4Zw0yvd8lePSMQ: folds 
kG34n23qFQA3nzdOJTQ1dA: folds 
edio/rLJ06xeZOfLhoL3UA: raises $0.20 to $1.20 and is all-in
6DwBRH+xZ12AAZmeAg+aXw: calls $0.20
*** FLOP *** [8s Ad 3s]
*** TURN *** [8s Ad 3s] [5c]
*** RIVER *** [8s Ad 3s 5c] [Ks]
*** SHOW DOWN ***
edio/rLJ06xeZOfLhoL3UA: shows [9c 6c] (high card Ace)
6DwBRH+xZ12AAZmeAg+aXw: shows [Kc Js] (a pair of Kings)
6DwBRH+xZ12AAZmeAg+aXw collected $2.65 from pot
*** SUMMARY ***
Total pot $2.75 | Rake $0.10 
Board [8s Ad 3s 5c Ks]
Seat 1: 6DwBRH+xZ12AAZmeAg+aXw showed [Kc Js] and won ($2.65) with a pair of Kings
Seat 2: NtrVQ9UIql0rDCnKDKZ5FQ folded before Flop (didn't bet)
Seat 3: kyRaCIljYA6l33lSKQfNsg (button) folded before Flop (didn't bet)
Seat 4: 6elpmfyt4Zw0yvd8lePSMQ (small blind) folded before Flop
Seat 5: kG34n23qFQA3nzdOJTQ1dA (big blind) folded before Flop
Seat 6: edio/rLJ06xeZOfLhoL3UA showed [9c 6c] and lost with high card Ace




PokerStars Game #59941731240:  Hold'em No Limit ($0.10/$0.25) - 2009/07/01 1:44:22 ET
Table 'nIRjSqm6RYUWJlyW2loYKA' 6-max Seat #2 is the button
Seat 1: BqTIZMLF3Kq/dZiALjvUCg ($4.75 in chips) 
Seat 2: NndRCAk4vU5JGDhTyy5LZg ($16.30 in chips) 
Seat 3: HbKNMWUwblC7HKtRCUhBWw ($14.75 in chips) 
Seat 4: /ZSSWvl8im2y38j1uEUAGA ($15 in chips) 
Seat 5: df01R5ThvHspD8FgKmaDvQ ($25 in chips) 
Seat 6: OIjOiBfQstWrK/RuXx7zcw ($5.95 in chips) 
HbKNMWUwblC7HKtRCUhBWw: posts small blind $0.10
/ZSSWvl8im2y38j1uEUAGA: posts big blind $0.25
df01R5ThvHspD8FgKmaDvQ: posts big blind $0.25
*** HOLE CARDS ***
df01R5ThvHspD8FgKmaDvQ: checks 
OIjOiBfQstWrK/RuXx7zcw: folds 
BqTIZMLF3Kq/dZiALjvUCg: calls $0.25
NndRCAk4vU5JGDhTyy5LZg: calls $0.25
HbKNMWUwblC7HKtRCUhBWw: calls $0.15
/ZSSWvl8im2y38j1uEUAGA: checks 
*** FLOP *** [Jh 8c Js]
HbKNMWUwblC7HKtRCUhBWw: bets $0.75
/ZSSWvl8im2y38j1uEUAGA: folds 
df01R5ThvHspD8FgKmaDvQ: folds 
BqTIZMLF3Kq/dZiALjvUCg: calls $0.75
NndRCAk4vU5JGDhTyy5LZg: calls $0.75
*** TURN *** [Jh 8c Js] [9c]
HbKNMWUwblC7HKtRCUhBWw: checks 
BqTIZMLF3Kq/dZiALjvUCg: checks 
NndRCAk4vU5JGDhTyy5LZg: checks 
*** RIVER *** [Jh 8c Js 9c] [Kh]
HbKNMWUwblC7HKtRCUhBWw: bets $2
BqTIZMLF3Kq/dZiALjvUCg: raises $1.75 to $3.75 and is all-in
NndRCAk4vU5JGDhTyy5LZg: folds 
HbKNMWUwblC7HKtRCUhBWw: calls $1.75
*** SHOW DOWN ***
BqTIZMLF3Kq/dZiALjvUCg: shows [Qd Qc] (two pair, Queens and Jacks)
HbKNMWUwblC7HKtRCUhBWw: shows [Kd 8d] (two pair, Kings and Jacks)
HbKNMWUwblC7HKtRCUhBWw collected $10.50 from pot
*** SUMMARY ***
Total pot $11 | Rake $0.50 
Board [Jh 8c Js 9c Kh]
Seat 1: BqTIZMLF3Kq/dZiALjvUCg showed [Qd Qc] and lost with two pair, Queens and Jacks
Seat 2: NndRCAk4vU5JGDhTyy5LZg (button) folded on the River
Seat 3: HbKNMWUwblC7HKtRCUhBWw (small blind) showed [Kd 8d] and won ($10.50) with two pair, Kings and Jacks
Seat 4: /ZSSWvl8im2y38j1uEUAGA (big blind) folded on the Flop
Seat 5: df01R5ThvHspD8FgKmaDvQ folded on the Flop
Seat 6: OIjOiBfQstWrK/RuXx7zcw folded before Flop (didn't bet)




PokerStars Game #59941731328:  Hold'em No Limit ($0.10/$0.25) - 2009/07/01 1:44:22 ET
Table 'C47I7CmrmFr8Oo7wOovVwQ' 6-max Seat #6 is the button
Seat 1: v6mkGzCBCCXcgWQNSYVtKg ($6.50 in chips) 
Seat 2: hOaWAImn5/MZDAWAPlYHCw ($5.15 in chips) 
Seat 3: H+8eOP3XJHXjACRDTiIHTQ ($16.90 in chips) 
Seat 4: yY5JuFtDfXWRaZlVby4LLw ($8.90 in chips) 
Seat 5: or309yYY9Y9bfFWtrB0yUg ($13.10 in chips) 
Seat 6: pD7ri5wL3vsa6S1ulMYQmQ ($24.50 in chips) 
v6mkGzCBCCXcgWQNSYVtKg: posts small blind $0.10
hOaWAImn5/MZDAWAPlYHCw: posts big blind $0.25
*** HOLE CARDS ***
H+8eOP3XJHXjACRDTiIHTQ: calls $0.25
yY5JuFtDfXWRaZlVby4LLw: folds 
or309yYY9Y9bfFWtrB0yUg: calls $0.25
pD7ri5wL3vsa6S1ulMYQmQ: folds 
v6mkGzCBCCXcgWQNSYVtKg: folds 
hOaWAImn5/MZDAWAPlYHCw: checks 
*** FLOP *** [Kh 7h As]
hOaWAImn5/MZDAWAPlYHCw: checks 
H+8eOP3XJHXjACRDTiIHTQ: bets $0.25
or309yYY9Y9bfFWtrB0yUg: calls $0.25
hOaWAImn5/MZDAWAPlYHCw: folds 
*** TURN *** [Kh 7h As] [7c]
H+8eOP3XJHXjACRDTiIHTQ: bets $1
or309yYY9Y9bfFWtrB0yUg: folds 
Uncalled bet ($1) returned to H+8eOP3XJHXjACRDTiIHTQ
H+8eOP3XJHXjACRDTiIHTQ collected $1.30 from pot
H+8eOP3XJHXjACRDTiIHTQ: doesn't show hand 
*** SUMMARY ***
Total pot $1.35 | Rake $0.05 
Board [Kh 7h As 7c]
Seat 1: v6mkGzCBCCXcgWQNSYVtKg (small blind) folded before Flop
Seat 2: hOaWAImn5/MZDAWAPlYHCw (big blind) folded on the Flop
Seat 3: H+8eOP3XJHXjACRDTiIHTQ collected ($1.30)
Seat 4: yY5JuFtDfXWRaZlVby4LLw folded before Flop (didn't bet)
Seat 5: or309yYY9Y9bfFWtrB0yUg folded on the Turn
Seat 6: pD7ri5wL3vsa6S1ulMYQmQ (button) folded before Flop (didn't bet)




PokerStars Game #59941731226:  Hold'em No Limit ($0.10/$0.25) - 2009/07/01 1:44:22 ET
Table 'mk323gviqdkOY5Aek/1EWg' 6-max Seat #2 is the button
Seat 1: L3/N/gliETan8N5Gim5h4Q ($25.40 in chips) 
Seat 2: GC/9yVD59DUCX7hUI7gcLw ($55.65 in chips) 
Seat 3: NuqYPwTLZYQhxOoVK3Yqlw ($23.40 in chips) 
Seat 4: +baiVgI/ETnBARLe5mARCw ($12.65 in chips) 
Seat 5: kjYRzIfvZNNflYMYRkkSVA ($28 in chips) 
Seat 6: KkXSr5xFjxLSD3wtAvT+WQ ($9 in chips) 
NuqYPwTLZYQhxOoVK3Yqlw: posts small blind $0.10
+baiVgI/ETnBARLe5mARCw: posts big blind $0.25
*** HOLE CARDS ***
kjYRzIfvZNNflYMYRkkSVA: calls $0.25
KkXSr5xFjxLSD3wtAvT+WQ: folds 
L3/N/gliETan8N5Gim5h4Q: folds 
GC/9yVD59DUCX7hUI7gcLw: folds 
NuqYPwTLZYQhxOoVK3Yqlw: folds 
+baiVgI/ETnBARLe5mARCw: checks 
*** FLOP *** [6c 4d Jc]
+baiVgI/ETnBARLe5mARCw: bets $0.25
kjYRzIfvZNNflYMYRkkSVA: raises $0.50 to $0.75
+baiVgI/ETnBARLe5mARCw: calls $0.50
*** TURN *** [6c 4d Jc] [7h]
+baiVgI/ETnBARLe5mARCw: checks 
kjYRzIfvZNNflYMYRkkSVA: bets $1.50
+baiVgI/ETnBARLe5mARCw: folds 
Uncalled bet ($1.50) returned to kjYRzIfvZNNflYMYRkkSVA
kjYRzIfvZNNflYMYRkkSVA collected $2 from pot
kjYRzIfvZNNflYMYRkkSVA: doesn't show hand 
*** SUMMARY ***
Total pot $2.10 | Rake $0.10 
Board [6c 4d Jc 7h]
Seat 1: L3/N/gliETan8N5Gim5h4Q folded before Flop (didn't bet)
Seat 2: GC/9yVD59DUCX7hUI7gcLw (button) folded before Flop (didn't bet)
Seat 3: NuqYPwTLZYQhxOoVK3Yqlw (small blind) folded before Flop
Seat 4: +baiVgI/ETnBARLe5mARCw (big blind) folded on the Turn
Seat 5: kjYRzIfvZNNflYMYRkkSVA collected ($2)
Seat 6: KkXSr5xFjxLSD3wtAvT+WQ folded before Flop (didn't bet)




PokerStars Game #59941731142:  Hold'em No Limit ($0.10/$0.25) - 2009/07/01 1:44:22 ET
Table 'Dun24l/X8kjpUHWBhkVOFw' 6-max Seat #1 is the button
Seat 1: u3Ol7kv1LmvszuHNm9rc6w ($25 in chips) 
Seat 3: +E5iJKkKVfaTgTqzuXXv0g ($15 in chips) 
Seat 4: 7/ROHX4tuLekJ2diYIlMkw ($5 in chips) 
+E5iJKkKVfaTgTqzuXXv0g: posts small blind $0.10
7/ROHX4tuLekJ2diYIlMkw: posts big blind $0.25
*** HOLE CARDS ***
u3Ol7kv1LmvszuHNm9rc6w: folds 
+E5iJKkKVfaTgTqzuXXv0g: calls $0.15
7/ROHX4tuLekJ2diYIlMkw: checks 
*** FLOP *** [3c Kd 3s]
+E5iJKkKVfaTgTqzuXXv0g: checks 
7/ROHX4tuLekJ2diYIlMkw: checks 
*** TURN *** [3c Kd 3s] [Qs]
+E5iJKkKVfaTgTqzuXXv0g: checks 
7/ROHX4tuLekJ2diYIlMkw: checks 
*** RIVER *** [3c Kd 3s Qs] [Kh]
+E5iJKkKVfaTgTqzuXXv0g: checks 
7/ROHX4tuLekJ2diYIlMkw: checks 
*** SHOW DOWN ***
+E5iJKkKVfaTgTqzuXXv0g: shows [5c 2c] (two pair, Kings and Threes)
7/ROHX4tuLekJ2diYIlMkw: shows [Tc 5h] (two pair, Kings and Threes)
+E5iJKkKVfaTgTqzuXXv0g collected $0.25 from pot
7/ROHX4tuLekJ2diYIlMkw collected $0.25 from pot
*** SUMMARY ***
Total pot $0.50 | Rake $0 
Board [3c Kd 3s Qs Kh]
Seat 1: u3Ol7kv1LmvszuHNm9rc6w (button) folded before Flop (didn't bet)
Seat 3: +E5iJKkKVfaTgTqzuXXv0g (small blind) showed [5c 2c] and won ($0.25) with two pair, Kings and Threes
Seat 4: 7/ROHX4tuLekJ2diYIlMkw (big blind) showed [Tc 5h] and won ($0.25) with two pair, Kings and Threes




PokerStars Game #59941731696:  Hold'em No Limit ($0.10/$0.25) - 2009/07/01 1:44:23 ET
Table 'FE/j6VqBY4j9Uq+VHURQCQ' 6-max Seat #6 is the button
Seat 1: ypmjhffk/YHGc51wgVXUTw ($42.70 in chips) 
Seat 2: 3zD3qLXT1bEffAoWGnc7wg ($40.10 in chips) 
Seat 3: lBoEwOFgzcERLIRUkUoRTw ($27.35 in chips) 
Seat 4: 7JyPCA0J2grhXQYxe1h3+A ($22.05 in chips) 
Seat 5: 4x9jCqgSw4272dnaIqnanw ($13.30 in chips) 
Seat 6: rpJ2ie+vculq8yrHlngRHQ ($11.20 in chips) 
ypmjhffk/YHGc51wgVXUTw: posts small blind $0.10
3zD3qLXT1bEffAoWGnc7wg: posts big blind $0.25
*** HOLE CARDS ***
lBoEwOFgzcERLIRUkUoRTw: folds 
7JyPCA0J2grhXQYxe1h3+A: folds 
4x9jCqgSw4272dnaIqnanw: folds 
rpJ2ie+vculq8yrHlngRHQ said, "***it"
rpJ2ie+vculq8yrHlngRHQ: raises $0.75 to $1
ypmjhffk/YHGc51wgVXUTw: folds 
3zD3qLXT1bEffAoWGnc7wg: folds 
Uncalled bet ($0.75) returned to rpJ2ie+vculq8yrHlngRHQ
rpJ2ie+vculq8yrHlngRHQ collected $0.60 from pot
*** SUMMARY ***
Total pot $0.60 | Rake $0 
Seat 1: ypmjhffk/YHGc51wgVXUTw (small blind) folded before Flop
Seat 2: 3zD3qLXT1bEffAoWGnc7wg (big blind) folded before Flop
Seat 3: lBoEwOFgzcERLIRUkUoRTw folded before Flop (didn't bet)
Seat 4: 7JyPCA0J2grhXQYxe1h3+A folded before Flop (didn't bet)
Seat 5: 4x9jCqgSw4272dnaIqnanw folded before Flop (didn't bet)
Seat 6: rpJ2ie+vculq8yrHlngRHQ (button) collected ($0.60)




PokerStars Game #59941731930:  Hold'em No Limit ($0.10/$0.25) - 2009/07/01 1:44:23 ET
Table 'MJ1SB76A4qJrlEa+C5e/8w' 6-max Seat #1 is the button
Seat 1: 0KDZiuXQg6UI9cqBR/AUnQ ($25.65 in chips) 
Seat 2: UA5OsKS3VPaxa7uC8La/kA ($37.15 in chips) 
Seat 3: DihMHaz4WNETH1bPDe13kA ($32.90 in chips) 
Seat 4: SFmT9ZsVopnukjvAzrxTRg ($27.80 in chips) 
Seat 5: Hsvkc0/G2VV78oVmWYXecw ($5 in chips) 
Seat 6: JFIAqU8lCZ0vWwEl4bdGsg ($30.30 in chips) 
UA5OsKS3VPaxa7uC8La/kA: posts small blind $0.10
DihMHaz4WNETH1bPDe13kA: posts big blind $0.25
*** HOLE CARDS ***
SFmT9ZsVopnukjvAzrxTRg: folds 
Hsvkc0/G2VV78oVmWYXecw: folds 
JFIAqU8lCZ0vWwEl4bdGsg: folds 
0KDZiuXQg6UI9cqBR/AUnQ: raises $0.25 to $0.50
UA5OsKS3VPaxa7uC8La/kA: folds 
DihMHaz4WNETH1bPDe13kA: folds 
Uncalled bet ($0.25) returned to 0KDZiuXQg6UI9cqBR/AUnQ
0KDZiuXQg6UI9cqBR/AUnQ collected $0.60 from pot
0KDZiuXQg6UI9cqBR/AUnQ: doesn't show hand 
*** SUMMARY ***
Total pot $0.60 | Rake $0 
Seat 1: 0KDZiuXQg6UI9cqBR/AUnQ (button) collected ($0.60)
Seat 2: UA5OsKS3VPaxa7uC8La/kA (small blind) folded before Flop
Seat 3: DihMHaz4WNETH1bPDe13kA (big blind) folded before Flop
Seat 4: SFmT9ZsVopnukjvAzrxTRg folded before Flop (didn't bet)
Seat 5: Hsvkc0/G2VV78oVmWYXecw folded before Flop (didn't bet)
Seat 6: JFIAqU8lCZ0vWwEl4bdGsg folded before Flop (didn't bet)




PokerStars Game #59941731746:  Hold'em No Limit ($0.10/$0.25) - 2009/07/01 1:44:23 ET
Table 'YlRA05h9BJ1EhOUSNUjJdg' 9-max Seat #6 is the button
Seat 1: dtZ84flFEi4Q+SGrHMJRDQ ($25 in chips) 
Seat 2: Y2GFAe+PT7xnUUtgqCNDFw ($12.05 in chips) 
Seat 3: Z5ZtGOON8kmSdSCll9Z3XA ($13.20 in chips) 
Seat 4: HPEB+AtKw1+C/cxU0o1ciw ($31.35 in chips) 
Seat 5: sx0lGrkT9fd4yFR+3cXUQg ($11.65 in chips) 
Seat 6: QEbIGci+itdw+re8RM5fZA ($44 in chips) 
Seat 7: dfNim92Z6XK1/h5SFW5vDg ($25 in chips) 
Seat 8: dmYlc+1cjwZMJ7wV+Z0rRg ($32.90 in chips) 
Seat 9: Z9AeOQX3yzuSvKAm/xyovg ($9.50 in chips) 
dfNim92Z6XK1/h5SFW5vDg: posts small blind $0.10
dmYlc+1cjwZMJ7wV+Z0rRg: posts big blind $0.25
*** HOLE CARDS ***
Z9AeOQX3yzuSvKAm/xyovg: raises $0.50 to $0.75
dtZ84flFEi4Q+SGrHMJRDQ: folds 
Y2GFAe+PT7xnUUtgqCNDFw: folds 
Z5ZtGOON8kmSdSCll9Z3XA: folds 
HPEB+AtKw1+C/cxU0o1ciw: folds 
sx0lGrkT9fd4yFR+3cXUQg: folds 
QEbIGci+itdw+re8RM5fZA: folds 
dfNim92Z6XK1/h5SFW5vDg: folds 
dmYlc+1cjwZMJ7wV+Z0rRg: folds 
Uncalled bet ($0.50) returned to Z9AeOQX3yzuSvKAm/xyovg
Z9AeOQX3yzuSvKAm/xyovg collected $0.60 from pot
*** SUMMARY ***
Total pot $0.60 | Rake $0 
Seat 1: dtZ84flFEi4Q+SGrHMJRDQ folded before Flop (didn't bet)
Seat 2: Y2GFAe+PT7xnUUtgqCNDFw folded before Flop (didn't bet)
Seat 3: Z5ZtGOON8kmSdSCll9Z3XA folded before Flop (didn't bet)
Seat 4: HPEB+AtKw1+C/cxU0o1ciw folded before Flop (didn't bet)
Seat 5: sx0lGrkT9fd4yFR+3cXUQg folded before Flop (didn't bet)
Seat 6: QEbIGci+itdw+re8RM5fZA (button) folded before Flop (didn't bet)
Seat 7: dfNim92Z6XK1/h5SFW5vDg (small blind) folded before Flop
Seat 8: dmYlc+1cjwZMJ7wV+Z0rRg (big blind) folded before Flop
Seat 9: Z9AeOQX3yzuSvKAm/xyovg collected ($0.60)




PokerStars Game #59941732468:  Hold'em No Limit ($0.10/$0.25) - 2009/07/01 1:44:24 ET
Table 'LwnjzXstPtSrqrV/oDpnXQ' 9-max Seat #1 is the button
Seat 1: 9YN2IkT2JYYKFErZtZvCtA ($18.45 in chips) 
Seat 2: uLP/lYn7oKq9xCChBXsXxw ($26.75 in chips) 
Seat 3: 7je+LC5Mfs6nL8YBVh4frQ ($4.30 in chips) 
Seat 4: CmngQmkKTp8tkl6GMRTl6w ($9.60 in chips) 
Seat 5: Th3FldXKQW6hWVVPahaoOQ ($25 in chips) 
Seat 6: ljemhp25Zg+nlA9DLCIiUw ($39.85 in chips) 
Seat 7: c/Dw/6HyqldTzIRodAIZmg ($13.75 in chips) 
Seat 8: ShXPHWfjhfmAwLgDdm6bRQ ($12.35 in chips) 
Seat 9: q6WfTUAD9mowIP63ASq2Dgz/khFDKGihQjwgoiKKPOeg70 in chips) 
uLP/lYn7oKq9xCChBXsXxw: posts small blind $0.10
7je+LC5Mfs6nL8YBVh4frQ: posts big blind $0.25
*** HOLE CARDS ***
CmngQmkKTp8tkl6GMRTl6w: folds 
Th3FldXKQW6hWVVPahaoOQ: raises $0.75 to $1
ljemhp25Zg+nlA9DLCIiUw: folds 
c/Dw/6HyqldTzIRodAIZmg: folds 
ShXPHWfjhfmAwLgDdm6bRQ: folds 
q6WfTUAD9mowIP63ASq2Dgz/khFDKGihQjwgoiKKPOegs 
9YN2IkT2JYYKFErZtZvCtA: calls $1
uLP/lYn7oKq9xCChBXsXxw: folds 
7je+LC5Mfs6nL8YBVh4frQ: folds 
*** FLOP *** [9h 7d Kh]
Th3FldXKQW6hWVVPahaoOQ: bets $1.50
9YN2IkT2JYYKFErZtZvCtA: folds 
Uncalled bet ($1.50) returned to Th3FldXKQW6hWVVPahaoOQ
Th3FldXKQW6hWVVPahaoOQ collected $2.25 from pot
Th3FldXKQW6hWVVPahaoOQ: doesn't show hand 
*** SUMMARY ***
Total pot $2.35 | Rake $0.10 
Board [9h 7d Kh]
Seat 1: 9YN2IkT2JYYKFErZtZvCtA (button) folded on the Flop
Seat 2: uLP/lYn7oKq9xCChBXsXxw (small blind) folded before Flop
Seat 3: 7je+LC5Mfs6nL8YBVh4frQ (big blind) folded before Flop
Seat 4: CmngQmkKTp8tkl6GMRTl6w folded before Flop (didn't bet)
Seat 5: Th3FldXKQW6hWVVPahaoOQ collected ($2.25)
Seat 6: ljemhp25Zg+nlA9DLCIiUw folded before Flop (didn't bet)
Seat 7: c/Dw/6HyqldTzIRodAIZmg folded before Flop (didn't bet)
Seat 8: ShXPHWfjhfmAwLgDdm6bRQ folded before Flop (didn't bet)
Seat 9: q6WfTUAD9mowIP63ASq2Dgz/khFDKGihQjwgoiKKPOegd before Flop (didn't bet)




PokerStars Game #59941732466:  Hold'em No Limit ($0.10/$0.25) - 2009/07/01 1:44:24 ET
Table 'BmUMTVcNATeov2rAGYU0Qg' 9-max Seat #1 is the button
Seat 1: QEbIGci+itdw+re8RM5fZA ($33.60 in chips) 
Seat 2: jJnMGXoBXye+afMd0k0rUw ($11.90 in chips) 
Seat 3: ir5Jy8ck6DrdqgJ/3chcWw ($7.95 in chips) 
Seat 4: aNpwfA31EREwO+ar4XzBCw ($37.85 in chips) 
Seat 5: QBNcj9fHxkh/+s/oVw+JmQ ($23.60 in chips) 
Seat 6: w1ukf8uPa4+WH561TtVRxA ($25 in chips) 
Seat 7: CmngQmkKTp8tkl6GMRTl6w ($8.50 in chips) 
Seat 8: f/H6PsHRl4W1JyNsEDvPtg ($34.80 in chips) 
Seat 9: /artgaAtyUtUtD8FZo6puA ($11.10 in chips) 
jJnMGXoBXye+afMd0k0rUw: posts small blind $0.10
ir5Jy8ck6DrdqgJ/3chcWw: posts big blind $0.25
*** HOLE CARDS ***
aNpwfA31EREwO+ar4XzBCw: folds 
QBNcj9fHxkh/+s/oVw+JmQ: folds 
w1ukf8uPa4+WH561TtVRxA: folds 
CmngQmkKTp8tkl6GMRTl6w: folds 
f/H6PsHRl4W1JyNsEDvPtg: folds 
/artgaAtyUtUtD8FZo6puA: folds 
QEbIGci+itdw+re8RM5fZA: folds 
jJnMGXoBXye+afMd0k0rUw: calls $0.15
ir5Jy8ck6DrdqgJ/3chcWw: checks 
*** FLOP *** [8c Qc 7c]
jJnMGXoBXye+afMd0k0rUw: checks 
ir5Jy8ck6DrdqgJ/3chcWw: bets $0.50
jJnMGXoBXye+afMd0k0rUw: folds 
Uncalled bet ($0.50) returned to ir5Jy8ck6DrdqgJ/3chcWw
ir5Jy8ck6DrdqgJ/3chcWw collected $0.50 from pot
*** SUMMARY ***
Total pot $0.50 | Rake $0 
Board [8c Qc 7c]
Seat 1: QEbIGci+itdw+re8RM5fZA (button) folded before Flop (didn't bet)
Seat 2: jJnMGXoBXye+afMd0k0rUw (small blind) folded on the Flop
Seat 3: ir5Jy8ck6DrdqgJ/3chcWw (big blind) collected ($0.50)
Seat 4: aNpwfA31EREwO+ar4XzBCw folded before Flop (didn't bet)
Seat 5: QBNcj9fHxkh/+s/oVw+JmQ folded before Flop (didn't bet)
Seat 6: w1ukf8uPa4+WH561TtVRxA folded before Flop (didn't bet)
Seat 7: CmngQmkKTp8tkl6GMRTl6w folded before Flop (didn't bet)
Seat 8: f/H6PsHRl4W1JyNsEDvPtg folded before Flop (didn't bet)
Seat 9: /artgaAtyUtUtD8FZo6puA folded before Flop (didn't bet)




PokerStars Game #59941732002:  Hold'em No Limit ($0.10/$0.25) - 2009/07/01 1:44:24 ET
Table 'rtxA1Y01Nrq5VoyzTAuusQ' 9-max Seat #2 is the button
Seat 1: w1ukf8uPa4+WH561TtVRxA ($26.55 in chips) 
Seat 2: Th3FldXKQW6hWVVPahaoOQ ($25 in chips) 
Seat 3: K9fS1IUr5GpiJG7VkJ7IbA ($5 in chips) 
Seat 4: RHqgdFvufLCYe54+qd2gcA ($5 in chips) 
Seat 5: MtVtHDqIJTyUcXkRBBDIVA ($32.40 in chips) 
Seat 7: 3PmVnC/15cl4oyI1TKIt4g ($9.65 in chips) 
Seat 8: DnDcAdn9P0zGovMERigpFA ($25 in chips) 
Seat 9: HPEB+AtKw1+C/cxU0o1ciw ($22.95 in chips) 
K9fS1IUr5GpiJG7VkJ7IbA: posts small blind $0.10
RHqgdFvufLCYe54+qd2gcA: posts big blind $0.25
*** HOLE CARDS ***
MtVtHDqIJTyUcXkRBBDIVA: folds 
3PmVnC/15cl4oyI1TKIt4g: folds 
DnDcAdn9P0zGovMERigpFA: raises $0.75 to $1
HPEB+AtKw1+C/cxU0o1ciw: folds 
w1ukf8uPa4+WH561TtVRxA: folds 
Th3FldXKQW6hWVVPahaoOQ: folds 
K9fS1IUr5GpiJG7VkJ7IbA: folds 
RHqgdFvufLCYe54+qd2gcA: folds 
Uncalled bet ($0.75) returned to DnDcAdn9P0zGovMERigpFA
DnDcAdn9P0zGovMERigpFA collected $0.60 from pot
DnDcAdn9P0zGovMERigpFA: doesn't show hand 
*** SUMMARY ***
Total pot $0.60 | Rake $0 
Seat 1: w1ukf8uPa4+WH561TtVRxA folded before Flop (didn't bet)
Seat 2: Th3FldXKQW6hWVVPahaoOQ (button) folded before Flop (didn't bet)
Seat 3: K9fS1IUr5GpiJG7VkJ7IbA (small blind) folded before Flop
Seat 4: RHqgdFvufLCYe54+qd2gcA (big blind) folded before Flop
Seat 5: MtVtHDqIJTyUcXkRBBDIVA folded before Flop (didn't bet)
Seat 7: 3PmVnC/15cl4oyI1TKIt4g folded before Flop (didn't bet)
Seat 8: DnDcAdn9P0zGovMERigpFA collected ($0.60)
Seat 9: HPEB+AtKw1+C/cxU0o1ciw folded before Flop (didn't bet)




PokerStars Game #59941732276:  Hold'em No Limit ($0.10/$0.25) - 2009/07/01 1:44:24 ET
Table '6aL2C8IFwHHr6SG6RgXaow' 9-max Seat #8 is the button
Seat 1: bXpVeaSTPBFSPJmeXxO7nw ($5 in chips) 
Seat 3: aCVg6cCxQcqClhB9nq/p1w ($12.90 in chips) 
Seat 4: BT6Oal0iO4P6kDuT7HFQDw ($19.10 in chips) 
Seat 5: wre31HfyzQGpIvID1istxw ($21.20 in chips) 
Seat 6: gehe91e0IyVT0QU/XBkEyg ($27.10 in chips) 
Seat 7: QJxYAPJ6uPZZcpdN+RvWcQ ($25 in chips) 
Seat 8: rQhYIYXSyH/IivYM1dlV5A ($21.40 in chips) 
Seat 9: CgIo2ItZqi4o3ayVG6HanQ ($24.10 in chips) 
CgIo2ItZqi4o3ayVG6HanQ: posts small blind $0.10
bXpVeaSTPBFSPJmeXxO7nw: posts big blind $0.25
*** HOLE CARDS ***
aCVg6cCxQcqClhB9nq/p1w: folds 
BT6Oal0iO4P6kDuT7HFQDw: calls $0.25
wre31HfyzQGpIvID1istxw: folds 
gehe91e0IyVT0QU/XBkEyg: folds 
QJxYAPJ6uPZZcpdN+RvWcQ: folds 
rQhYIYXSyH/IivYM1dlV5A: raises $0.50 to $0.75
CgIo2ItZqi4o3ayVG6HanQ: folds 
bXpVeaSTPBFSPJmeXxO7nw: folds 
BT6Oal0iO4P6kDuT7HFQDw: calls $0.50
*** FLOP *** [3d Jd Td]
BT6Oal0iO4P6kDuT7HFQDw: checks 
rQhYIYXSyH/IivYM1dlV5A: bets $0.50
BT6Oal0iO4P6kDuT7HFQDw: folds 
Uncalled bet ($0.50) returned to rQhYIYXSyH/IivYM1dlV5A
rQhYIYXSyH/IivYM1dlV5A collected $1.80 from pot
*** SUMMARY ***
Total pot $1.85 | Rake $0.05 
Board [3d Jd Td]
Seat 1: bXpVeaSTPBFSPJmeXxO7nw (big blind) folded before Flop
Seat 3: aCVg6cCxQcqClhB9nq/p1w folded before Flop (didn't bet)
Seat 4: BT6Oal0iO4P6kDuT7HFQDw folded on the Flop
Seat 5: wre31HfyzQGpIvID1istxw folded before Flop (didn't bet)
Seat 6: gehe91e0IyVT0QU/XBkEyg folded before Flop (didn't bet)
Seat 7: QJxYAPJ6uPZZcpdN+RvWcQ folded before Flop (didn't bet)
Seat 8: rQhYIYXSyH/IivYM1dlV5A (button) collected ($1.80)
Seat 9: CgIo2ItZqi4o3ayVG6HanQ (small blind) folded before Flop




PokerStars Game #59941732470:  Hold'em No Limit ($0.10/$0.25) - 2009/07/01 1:44:24 ET
Table 'Loy/olZ5qoDOSvX4UTujGg' 6-max Seat #3 is the button
Seat 1: HipgaJhkN4ie/tTw4dK3Ug ($12.80 in chips) 
Seat 2: 4z7mPbMLNp4TezHXin63Vw ($16.90 in chips) 
Seat 3: 32YL2ZEp8NT4JB2RVM9euQ ($15.70 in chips) 
Seat 4: /gJNBeCkWL4o85/jvlZ4BA ($28.30 in chips) 
Seat 6: qGHGf/553gQnDoklMRe3tg ($26.55 in chips) 
/gJNBeCkWL4o85/jvlZ4BA: posts small blind $0.10
qGHGf/553gQnDoklMRe3tg: posts big blind $0.25
*** HOLE CARDS ***
HipgaJhkN4ie/tTw4dK3Ug: folds 
4z7mPbMLNp4TezHXin63Vw: folds 
32YL2ZEp8NT4JB2RVM9euQ: folds 
/gJNBeCkWL4o85/jvlZ4BA: folds 
Uncalled bet ($0.15) returned to qGHGf/553gQnDoklMRe3tg
qGHGf/553gQnDoklMRe3tg collected $0.20 from pot
*** SUMMARY ***
Total pot $0.20 | Rake $0 
Seat 1: HipgaJhkN4ie/tTw4dK3Ug folded before Flop (didn't bet)
Seat 2: 4z7mPbMLNp4TezHXin63Vw folded before Flop (didn't bet)
Seat 3: 32YL2ZEp8NT4JB2RVM9euQ (button) folded before Flop (didn't bet)
Seat 4: /gJNBeCkWL4o85/jvlZ4BA (small blind) folded before Flop
Seat 6: qGHGf/553gQnDoklMRe3tg (big blind) collected ($0.20)




PokerStars Game #59941732230:  Hold'em No Limit ($0.10/$0.25) - 2009/07/01 1:44:24 ET
Table 'BpNkESDX1ip9c0K1hb5h7A' 6-max Seat #3 is the button
Seat 1: 5YZdVjBPZVEdubN4xEMPEg ($31.75 in chips) 
Seat 3: fZQg9veL7Dd/Z04ZTjC+wQ ($27.55 in chips) 
Seat 4: kG34n23qFQA3nzdOJTQ1dA ($25.65 in chips) 
Seat 5: L3/N/gliETan8N5Gim5h4Q ($25.75 in chips) 
Seat 6: 8EEqTTh7T1q48sYDqbI2Xg ($21.15 in chips) 
kG34n23qFQA3nzdOJTQ1dA: posts small blind $0.10
L3/N/gliETan8N5Gim5h4Q: posts big blind $0.25
9U3ZKjCsarN0DjR6mSE8Ug: sits out 
*** HOLE CARDS ***
8EEqTTh7T1q48sYDqbI2Xg: folds 
5YZdVjBPZVEdubN4xEMPEg: folds 
fZQg9veL7Dd/Z04ZTjC+wQ: raises $0.50 to $0.75
kG34n23qFQA3nzdOJTQ1dA: folds 
L3/N/gliETan8N5Gim5h4Q: folds 
Uncalled bet ($0.50) returned to fZQg9veL7Dd/Z04ZTjC+wQ
fZQg9veL7Dd/Z04ZTjC+wQ collected $0.60 from pot
fZQg9veL7Dd/Z04ZTjC+wQ: doesn't show hand 
*** SUMMARY ***
Total pot $0.60 | Rake $0 
Seat 1: 5YZdVjBPZVEdubN4xEMPEg folded before Flop (didn't bet)
Seat 3: fZQg9veL7Dd/Z04ZTjC+wQ (button) collected ($0.60)
Seat 4: kG34n23qFQA3nzdOJTQ1dA (small blind) folded before Flop
Seat 5: L3/N/gliETan8N5Gim5h4Q (big blind) folded before Flop
Seat 6: 8EEqTTh7T1q48sYDqbI2Xg folded before Flop (didn't bet)




PokerStars Game #59941732452:  Hold'em No Limit ($0.10/$0.25) - 2009/07/01 1:44:24 ET
Table 'fIMYcWwN4/aXFJvH5Z8Ymg' 6-max Seat #4 is the button
Seat 1: DihMHaz4WNETH1bPDe13kA ($25 in chips) 
Seat 3: 9bpVv1/Qh9IYtXuCtl5VtQ ($25 in chips) 
Seat 4: 32YL2ZEp8NT4JB2RVM9euQ ($42.40 in chips) 
Seat 5: lquriepNQBhDV5P1SWHhnA ($25.45 in chips) 
Seat 6: jp34e617tIzV8tKIWmfAbA ($28.35 in chips) 
lquriepNQBhDV5P1SWHhnA: posts small blind $0.10
jp34e617tIzV8tKIWmfAbA: posts big blind $0.25
StevenWu: sits out 
*** HOLE CARDS ***
DihMHaz4WNETH1bPDe13kA: folds 
9bpVv1/Qh9IYtXuCtl5VtQ: folds 
32YL2ZEp8NT4JB2RVM9euQ: folds 
lquriepNQBhDV5P1SWHhnA: folds 
Uncalled bet ($0.15) returned to jp34e617tIzV8tKIWmfAbA
jp34e617tIzV8tKIWmfAbA collected $0.20 from pot
*** SUMMARY ***
Total pot $0.20 | Rake $0 
Seat 1: DihMHaz4WNETH1bPDe13kA folded before Flop (didn't bet)
Seat 3: 9bpVv1/Qh9IYtXuCtl5VtQ folded before Flop (didn't bet)
Seat 4: 32YL2ZEp8NT4JB2RVM9euQ (button) folded before Flop (didn't bet)
Seat 5: lquriepNQBhDV5P1SWHhnA (small blind) folded before Flop
Seat 6: jp34e617tIzV8tKIWmfAbA (big blind) collected ($0.20)




PokerStars Game #59941732444:  Hold'em No Limit ($0.10/$0.25) - 2009/07/01 1:44:24 ET
Table 'aaXqTKUnxrX9DYXtxhWXxA' 6-max Seat #5 is the button
Seat 1: aSrj4lVmn2owyQ1RbbOqxQ ($25 in chips) 
Seat 2: DE9hRlt14g+JdsRQ4wT7hg ($33.70 in chips) 
Seat 3: uUXdcVMNa05rfbntdvplfw ($8.35 in chips) 
Seat 4: 48oT5xFI+5CHUJlfoGrE4w ($9.65 in chips) 
Seat 5: kyRaCIljYA6l33lSKQfNsg ($26.60 in chips) 
Seat 6: buyjetgNT1McXtdaP4zynA ($49.30 in chips) 
buyjetgNT1McXtdaP4zynA: posts small blind $0.10
aSrj4lVmn2owyQ1RbbOqxQ: posts big blind $0.25
*** HOLE CARDS ***
DE9hRlt14g+JdsRQ4wT7hg: folds 
uUXdcVMNa05rfbntdvplfw: folds 
48oT5xFI+5CHUJlfoGrE4w: folds 
kyRaCIljYA6l33lSKQfNsg: raises $0.50 to $0.75
buyjetgNT1McXtdaP4zynA: folds 
aSrj4lVmn2owyQ1RbbOqxQ: folds 
Uncalled bet ($0.50) returned to kyRaCIljYA6l33lSKQfNsg
kyRaCIljYA6l33lSKQfNsg collected $0.60 from pot
*** SUMMARY ***
Total pot $0.60 | Rake $0 
Seat 1: aSrj4lVmn2owyQ1RbbOqxQ (big blind) folded before Flop
Seat 2: DE9hRlt14g+JdsRQ4wT7hg folded before Flop (didn't bet)
Seat 3: uUXdcVMNa05rfbntdvplfw folded before Flop (didn't bet)
Seat 4: 48oT5xFI+5CHUJlfoGrE4w folded before Flop (didn't bet)
Seat 5: kyRaCIljYA6l33lSKQfNsg (button) collected ($0.60)
Seat 6: buyjetgNT1McXtdaP4zynA (small blind) folded before Flop




PokerStars Game #59941732132:  Hold'em No Limit ($0.10/$0.25) - 2009/07/01 1:44:24 ET
Table 'MiquQrQZJJq9ZtgRIp9HFQ' 6-max Seat #6 is the button
Seat 1: c3J/KYZ4cNsUEuz8v57I5A ($24.80 in chips) 
Seat 2: 2+6voGl1T1DO63JePptI3g ($15 in chips) 
Seat 3: 9h7TNZ1TDGRUJXA6rI+ZTw ($10 in chips) 
Seat 4: wAKC8C/zN0c8V5v13dm9mA ($58.30 in chips) 
Seat 5: iyZxqznXjv3vtvOJymkoLQ ($26.75 in chips) 
Seat 6: GbCVUNssQ7mqsPWr7J4d3w ($5 in chips) 
c3J/KYZ4cNsUEuz8v57I5A: posts small blind $0.10
2+6voGl1T1DO63JePptI3g: posts big blind $0.25
9h7TNZ1TDGRUJXA6rI+ZTw: posts big blind $0.25
*** HOLE CARDS ***
9h7TNZ1TDGRUJXA6rI+ZTw: checks 
wAKC8C/zN0c8V5v13dm9mA: folds 
iyZxqznXjv3vtvOJymkoLQ: folds 
GbCVUNssQ7mqsPWr7J4d3w: folds 
c3J/KYZ4cNsUEuz8v57I5A: raises $0.75 to $1
2+6voGl1T1DO63JePptI3g: calls $0.75
9h7TNZ1TDGRUJXA6rI+ZTw: folds 
*** FLOP *** [3c 8h 7d]
c3J/KYZ4cNsUEuz8v57I5A: bets $1.25
2+6voGl1T1DO63JePptI3g: calls $1.25
*** TURN *** [3c 8h 7d] [8d]
c3J/KYZ4cNsUEuz8v57I5A: bets $2
2+6voGl1T1DO63JePptI3g: calls $2
*** RIVER *** [3c 8h 7d 8d] [Td]
c3J/KYZ4cNsUEuz8v57I5A: checks 
2+6voGl1T1DO63JePptI3g: bets $10.75 and is all-in
c3J/KYZ4cNsUEuz8v57I5A: folds 
Uncalled bet ($10.75) returned to 2+6voGl1T1DO63JePptI3g
2+6voGl1T1DO63JePptI3g collected $8.35 from pot
2+6voGl1T1DO63JePptI3g: doesn't show hand 
*** SUMMARY ***
Total pot $8.75 | Rake $0.40 
Board [3c 8h 7d 8d Td]
Seat 1: c3J/KYZ4cNsUEuz8v57I5A (small blind) folded on the River
Seat 2: 2+6voGl1T1DO63JePptI3g (big blind) collected ($8.35)
Seat 3: 9h7TNZ1TDGRUJXA6rI+ZTw folded before Flop
Seat 4: wAKC8C/zN0c8V5v13dm9mA folded before Flop (didn't bet)
Seat 5: iyZxqznXjv3vtvOJymkoLQ folded before Flop (didn't bet)
Seat 6: GbCVUNssQ7mqsPWr7J4d3w (button) folded before Flop (didn't bet)




PokerStars Game #59941732552:  Hold'em No Limit ($0.10/$0.25) - 2009/07/01 1:44:25 ET
Table 'g+mPuNJBCHKE9ents7ZGtg' 6-max Seat #1 is the button
Seat 1: cezpHJ8FB07dj0xG+LhOvw ($58.30 in chips) 
Seat 2: fZQg9veL7Dd/Z04ZTjC+wQ ($65.80 in chips) 
Seat 3: FYepjhAvF8ZdVCmqHIy+eQ ($30.25 in chips) 
Seat 4: yVrjRIW0SMxgpvqSIPSe/w ($13.55 in chips) 
Seat 5: D3ikCR8c/o9jB5irZ3uGlw ($12.30 in chips) 
Seat 6: Mn2V28t5aGq2d09z+/o6Fw ($24.65 in chips) 
fZQg9veL7Dd/Z04ZTjC+wQ: posts small blind $0.10
FYepjhAvF8ZdVCmqHIy+eQ: posts big blind $0.25
*** HOLE CARDS ***
yVrjRIW0SMxgpvqSIPSe/w: folds 
D3ikCR8c/o9jB5irZ3uGlw: folds 
Mn2V28t5aGq2d09z+/o6Fw: folds 
cezpHJ8FB07dj0xG+LhOvw: raises $0.35 to $0.60
fZQg9veL7Dd/Z04ZTjC+wQ: folds 
FYepjhAvF8ZdVCmqHIy+eQ: folds 
Uncalled bet ($0.35) returned to cezpHJ8FB07dj0xG+LhOvw
cezpHJ8FB07dj0xG+LhOvw collected $0.60 from pot
*** SUMMARY ***
Total pot $0.60 | Rake $0 
Seat 1: cezpHJ8FB07dj0xG+LhOvw (button) collected ($0.60)
Seat 2: fZQg9veL7Dd/Z04ZTjC+wQ (small blind) folded before Flop
Seat 3: FYepjhAvF8ZdVCmqHIy+eQ (big blind) folded before Flop
Seat 4: yVrjRIW0SMxgpvqSIPSe/w folded before Flop (didn't bet)
Seat 5: D3ikCR8c/o9jB5irZ3uGlw folded before Flop (didn't bet)
Seat 6: Mn2V28t5aGq2d09z+/o6Fw folded before Flop (didn't bet)




PokerStars Game #59941732788:  Hold'em No Limit ($0.10/$0.25) - 2009/07/01 1:44:25 ET
Table 'Ok3oDLIsTc2+KxPcI0bAOA' 6-max Seat #1 is the button
Seat 1: agQm3ugZ3qSVYNgNu1ddeA ($40.75 in chips) 
Seat 2: wPSNSp4HYtytRMXTu3oPSQ ($26.70 in chips) 
Seat 3: lquriepNQBhDV5P1SWHhnA ($36.45 in chips) 
Seat 4: LJI7A1YgDM7hgh7o56+ReQ ($36.90 in chips) 
Seat 5: DFi/Lzkjsfv8QswS80JX9Q ($28.25 in chips) 
Seat 6: Hsvkc0/G2VV78oVmWYXecw ($5 in chips) 
wPSNSp4HYtytRMXTu3oPSQ: posts small blind $0.10
lquriepNQBhDV5P1SWHhnA: posts big blind $0.25
*** HOLE CARDS ***
LJI7A1YgDM7hgh7o56+ReQ: folds 
DFi/Lzkjsfv8QswS80JX9Q: folds 
Hsvkc0/G2VV78oVmWYXecw: folds 
agQm3ugZ3qSVYNgNu1ddeA: folds 
wPSNSp4HYtytRMXTu3oPSQ: calls $0.15
lquriepNQBhDV5P1SWHhnA: checks 
*** FLOP *** [7c 5d 7h]
wPSNSp4HYtytRMXTu3oPSQ: checks 
lquriepNQBhDV5P1SWHhnA: checks 
*** TURN *** [7c 5d 7h] [Tc]
wPSNSp4HYtytRMXTu3oPSQ: checks 
lquriepNQBhDV5P1SWHhnA: checks 
*** RIVER *** [7c 5d 7h Tc] [7d]
wPSNSp4HYtytRMXTu3oPSQ: checks 
lquriepNQBhDV5P1SWHhnA: checks 
*** SHOW DOWN ***
wPSNSp4HYtytRMXTu3oPSQ: shows [8c Ah] (three of a kind, Sevens)
lquriepNQBhDV5P1SWHhnA: mucks hand 
wPSNSp4HYtytRMXTu3oPSQ collected $0.50 from pot
*** SUMMARY ***
Total pot $0.50 | Rake $0 
Board [7c 5d 7h Tc 7d]
Seat 1: agQm3ugZ3qSVYNgNu1ddeA (button) folded before Flop (didn't bet)
Seat 2: wPSNSp4HYtytRMXTu3oPSQ (small blind) showed [8c Ah] and won ($0.50) with three of a kind, Sevens
Seat 3: lquriepNQBhDV5P1SWHhnA (big blind) mucked
Seat 4: LJI7A1YgDM7hgh7o56+ReQ folded before Flop (didn't bet)
Seat 5: DFi/Lzkjsfv8QswS80JX9Q folded before Flop (didn't bet)
Seat 6: Hsvkc0/G2VV78oVmWYXecw folded before Flop (didn't bet)




PokerStars Game #59941732800:  Hold'em No Limit ($0.10/$0.25) - 2009/07/01 1:44:25 ET
Table 'x7YStLKc8hpt/pTgSetPKA' 9-max Seat #4 is the button
Seat 1: tYsOBqdU1+x+yFI7zHO7hQ ($25 in chips) 
Seat 3: S7Ki0P+0AIGPuIfGJjW0gg ($12.10 in chips) 
Seat 4: ydoFOVgzvZv9ZhuWu9rXAw ($5.15 in chips) 
Seat 6: 9YN2IkT2JYYKFErZtZvCtA ($47.80 in chips) 
Seat 7: dtZ84flFEi4Q+SGrHMJRDQ ($26.35 in chips) 
Seat 8: j4q3p0lesp63b1gZDwLBZw ($5 in chips) 
Seat 9: nm4Dj/f+jJEwKVsUnKh73g ($37.05 in chips) 
9YN2IkT2JYYKFErZtZvCtA: posts small blind $0.10
dtZ84flFEi4Q+SGrHMJRDQ: posts big blind $0.25
*** HOLE CARDS ***
j4q3p0lesp63b1gZDwLBZw: folds 
nm4Dj/f+jJEwKVsUnKh73g: folds 
tYsOBqdU1+x+yFI7zHO7hQ: folds 
S7Ki0P+0AIGPuIfGJjW0gg: folds 
ydoFOVgzvZv9ZhuWu9rXAw: folds 
tLcDklc2rBORNfixyRfVfw joins the table at seat #5 
9YN2IkT2JYYKFErZtZvCtA: raises $0.75 to $1
dtZ84flFEi4Q+SGrHMJRDQ: folds 
Uncalled bet ($0.75) returned to 9YN2IkT2JYYKFErZtZvCtA
9YN2IkT2JYYKFErZtZvCtA collected $0.50 from pot
9YN2IkT2JYYKFErZtZvCtA: doesn't show hand 
*** SUMMARY ***
Total pot $0.50 | Rake $0 
Seat 1: tYsOBqdU1+x+yFI7zHO7hQ folded before Flop (didn't bet)
Seat 3: S7Ki0P+0AIGPuIfGJjW0gg folded before Flop (didn't bet)
Seat 4: ydoFOVgzvZv9ZhuWu9rXAw (button) folded before Flop (didn't bet)
Seat 6: 9YN2IkT2JYYKFErZtZvCtA (small blind) collected ($0.50)
Seat 7: dtZ84flFEi4Q+SGrHMJRDQ (big blind) folded before Flop
Seat 8: j4q3p0lesp63b1gZDwLBZw folded before Flop (didn't bet)
Seat 9: nm4Dj/f+jJEwKVsUnKh73g folded before Flop (didn't bet)




PokerStars Game #59941732540:  Hold'em No Limit ($0.10/$0.25) - 2009/07/01 1:44:25 ET
Table 'qInMnOOn7vKcj4bU7zju7g' 9-max Seat #4 is the button
Seat 1: CT7Xj/V/O5rBlhtt+RZeFQ ($38.40 in chips) 
Seat 2: HgIyqrvSG8TRRZl5mlzfHA ($71.35 in chips) 
Seat 4: ScCuCTbi71/EWsLKZXaZeg ($11.65 in chips) 
Seat 5: KlccfkOygm1GJZoSZYEgBw ($14.25 in chips) 
Seat 6: 4awUyiDYTgylQKXZ9faBVA ($25 in chips) 
Seat 7: DdPXdieucQ+n99u1n3A+rQ ($7.10 in chips) 
Seat 8: Mh2r9hTeTEDnh19sRZtW3g ($5.70 in chips) 
Seat 9: sbArFaUiGjfmf5dg1O4ffg ($4.95 in chips) 
KlccfkOygm1GJZoSZYEgBw: posts small blind $0.10
4awUyiDYTgylQKXZ9faBVA: posts big blind $0.25
*** HOLE CARDS ***
DdPXdieucQ+n99u1n3A+rQ: folds 
Mh2r9hTeTEDnh19sRZtW3g: folds 
sbArFaUiGjfmf5dg1O4ffg: raises $1 to $1.25
CT7Xj/V/O5rBlhtt+RZeFQ: folds 
HgIyqrvSG8TRRZl5mlzfHA: calls $1.25
ScCuCTbi71/EWsLKZXaZeg: calls $1.25
KlccfkOygm1GJZoSZYEgBw: folds 
4awUyiDYTgylQKXZ9faBVA: folds 
*** FLOP *** [Js 8s Qh]
sbArFaUiGjfmf5dg1O4ffg: checks 
HgIyqrvSG8TRRZl5mlzfHA: checks 
ScCuCTbi71/EWsLKZXaZeg: bets $2
sbArFaUiGjfmf5dg1O4ffg: folds 
HgIyqrvSG8TRRZl5mlzfHA: calls $2
*** TURN *** [Js 8s Qh] [5h]
HgIyqrvSG8TRRZl5mlzfHA: checks 
zDrucyjVn5aeekNEc3cJrA has returned
ScCuCTbi71/EWsLKZXaZeg: bets $2
HgIyqrvSG8TRRZl5mlzfHA: folds 
Uncalled bet ($2) returned to ScCuCTbi71/EWsLKZXaZeg
ScCuCTbi71/EWsLKZXaZeg collected $7.75 from pot
*** SUMMARY ***
Total pot $8.10 | Rake $0.35 
Board [Js 8s Qh 5h]
Seat 1: CT7Xj/V/O5rBlhtt+RZeFQ folded before Flop (didn't bet)
Seat 2: HgIyqrvSG8TRRZl5mlzfHA folded on the Turn
Seat 4: ScCuCTbi71/EWsLKZXaZeg (button) collected ($7.75)
Seat 5: KlccfkOygm1GJZoSZYEgBw (small blind) folded before Flop
Seat 6: 4awUyiDYTgylQKXZ9faBVA (big blind) folded before Flop
Seat 7: DdPXdieucQ+n99u1n3A+rQ folded before Flop (didn't bet)
Seat 8: Mh2r9hTeTEDnh19sRZtW3g folded before Flop (didn't bet)
Seat 9: sbArFaUiGjfmf5dg1O4ffg folded on the Flop




PokerStars Game #59941732818:  Hold'em No Limit ($0.10/$0.25) - 2009/07/01 1:44:25 ET
Table '0M5QEJGOThqZwQ/sjbjXYw' 6-max Seat #2 is the button
Seat 2: /gJNBeCkWL4o85/jvlZ4BA ($34.60 in chips) 
Seat 3: 3zD3qLXT1bEffAoWGnc7wg ($25 in chips) 
Seat 4: oBUDUfeUyCbZBsjxHZgSiw ($23.35 in chips) 
Seat 5: cWc85bEzdRzpUMhRKm8pwQ ($28.05 in chips) 
Seat 6: bb63I02U6p9a5MNFa1gCiw ($25 in chips) 
3zD3qLXT1bEffAoWGnc7wg: posts small blind $0.10
oBUDUfeUyCbZBsjxHZgSiw: posts big blind $0.25
bb63I02U6p9a5MNFa1gCiw: posts big blind $0.25
*** HOLE CARDS ***
cWc85bEzdRzpUMhRKm8pwQ: folds 
bb63I02U6p9a5MNFa1gCiw: checks 
/gJNBeCkWL4o85/jvlZ4BA: folds 
3zD3qLXT1bEffAoWGnc7wg: folds 
oBUDUfeUyCbZBsjxHZgSiw: raises $0.75 to $1
bb63I02U6p9a5MNFa1gCiw: calls $0.75
*** FLOP *** [Jd 5d 5h]
oBUDUfeUyCbZBsjxHZgSiw: checks 
bb63I02U6p9a5MNFa1gCiw: checks 
*** TURN *** [Jd 5d 5h] [3h]
oBUDUfeUyCbZBsjxHZgSiw: checks 
bb63I02U6p9a5MNFa1gCiw: checks 
*** RIVER *** [Jd 5d 5h 3h] [6c]
oBUDUfeUyCbZBsjxHZgSiw: checks 
bb63I02U6p9a5MNFa1gCiw: bets $0.50
oBUDUfeUyCbZBsjxHZgSiw: folds 
Uncalled bet ($0.50) returned to bb63I02U6p9a5MNFa1gCiw
bb63I02U6p9a5MNFa1gCiw collected $2 from pot
bb63I02U6p9a5MNFa1gCiw: doesn't show hand 
*** SUMMARY ***
Total pot $2.10 | Rake $0.10 
Board [Jd 5d 5h 3h 6c]
Seat 2: /gJNBeCkWL4o85/jvlZ4BA (button) folded before Flop (didn't bet)
Seat 3: 3zD3qLXT1bEffAoWGnc7wg (small blind) folded before Flop
Seat 4: oBUDUfeUyCbZBsjxHZgSiw (big blind) folded on the River
Seat 5: cWc85bEzdRzpUMhRKm8pwQ folded before Flop (didn't bet)
Seat 6: bb63I02U6p9a5MNFa1gCiw collected ($2)




PokerStars Game #59941732516:  Hold'em No Limit ($0.10/$0.25) - 2009/07/01 1:44:25 ET
Table '+fuYjvJy9okLr23QyZtanA' 9-max Seat #1 is the button
Seat 1: l9hUFnOCgg4TPYga9bvxhw ($10.70 in chips) 
Seat 2: tLcDklc2rBORNfixyRfVfw ($25 in chips) 
Seat 3: eK8qa6EPcH2zhtbmWSvc9g ($52.65 in chips) 
Seat 4: Bb42QRQMhg5/Y0vHP8/2Xw ($30.50 in chips) 
Seat 5: bXpVeaSTPBFSPJmeXxO7nw ($4.65 in chips) 
Seat 6: wGigCmBR/9XWkPpvYos3aQ ($30.20 in chips) 
Seat 7: dfNim92Z6XK1/h5SFW5vDg ($26.55 in chips) 
Seat 8: KqS/lY/fNB9qUxokm9QfeA ($12.25 in chips) 
Seat 9: OMhlmt2waO3z43ZSFNMmog ($27.55 in chips) 
tLcDklc2rBORNfixyRfVfw: posts small blind $0.10
eK8qa6EPcH2zhtbmWSvc9g: posts big blind $0.25
*** HOLE CARDS ***
Bb42QRQMhg5/Y0vHP8/2Xw: folds 
bXpVeaSTPBFSPJmeXxO7nw: folds 
wGigCmBR/9XWkPpvYos3aQ: folds 
dfNim92Z6XK1/h5SFW5vDg: folds 
KqS/lY/fNB9qUxokm9QfeA: folds 
OMhlmt2waO3z43ZSFNMmog: calls $0.25
l9hUFnOCgg4TPYga9bvxhw: folds 
tLcDklc2rBORNfixyRfVfw: folds 
eK8qa6EPcH2zhtbmWSvc9g: checks 
*** FLOP *** [Ts 6h 3c]
eK8qa6EPcH2zhtbmWSvc9g: checks 
OMhlmt2waO3z43ZSFNMmog: bets $1
eK8qa6EPcH2zhtbmWSvc9g: folds 
Uncalled bet ($1) returned to OMhlmt2waO3z43ZSFNMmog
OMhlmt2waO3z43ZSFNMmog collected $0.60 from pot
OMhlmt2waO3z43ZSFNMmog: doesn't show hand 
*** SUMMARY ***
Total pot $0.60 | Rake $0 
Board [Ts 6h 3c]
Seat 1: l9hUFnOCgg4TPYga9bvxhw (button) folded before Flop (didn't bet)
Seat 2: tLcDklc2rBORNfixyRfVfw (small blind) folded before Flop
Seat 3: eK8qa6EPcH2zhtbmWSvc9g (big blind) folded on the Flop
Seat 4: Bb42QRQMhg5/Y0vHP8/2Xw folded before Flop (didn't bet)
Seat 5: bXpVeaSTPBFSPJmeXxO7nw folded before Flop (didn't bet)
Seat 6: wGigCmBR/9XWkPpvYos3aQ folded before Flop (didn't bet)
Seat 7: dfNim92Z6XK1/h5SFW5vDg folded before Flop (didn't bet)
Seat 8: KqS/lY/fNB9qUxokm9QfeA folded before Flop (didn't bet)
Seat 9: OMhlmt2waO3z43ZSFNMmog collected ($0.60)




PokerStars Game #59941733496:  Hold'em No Limit ($0.10/$0.25) - 2009/07/01 1:44:26 ET
Table 'RPdw09/gGCIP4xFhDWJgXQ' 9-max Seat #6 is the button
Seat 1: aNpwfA31EREwO+ar4XzBCw ($27.50 in chips) 
Seat 2: Sd1tfhUq/M96GhXGv1hwFQ ($8.55 in chips) 
Seat 3: g5LAv1J/3Thw1zs/SEyfzw ($17.90 in chips) 
Seat 5: gehe91e0IyVT0QU/XBkEyg ($30.35 in chips) 
Seat 6: monZeAwXUmIA1l84cUd2hw ($14.50 in chips) 
Seat 7: EP17SQz/iWcuYdNOGeBgkw ($14 in chips) 
Seat 8: MG90wfSJZnOejs/KD3vlQQ ($30.15 in chips) 
Seat 9: O02ScVDnDZwH6KjZNJZMzA ($5 in chips) 
EP17SQz/iWcuYdNOGeBgkw: posts small blind $0.10
MG90wfSJZnOejs/KD3vlQQ: posts big blind $0.25
*** HOLE CARDS ***
O02ScVDnDZwH6KjZNJZMzA: folds 
aNpwfA31EREwO+ar4XzBCw: folds 
Sd1tfhUq/M96GhXGv1hwFQ: folds 
g5LAv1J/3Thw1zs/SEyfzw: raises $0.50 to $0.75
gehe91e0IyVT0QU/XBkEyg: folds 
monZeAwXUmIA1l84cUd2hw: folds 
EP17SQz/iWcuYdNOGeBgkw: folds 
MG90wfSJZnOejs/KD3vlQQ: folds 
Uncalled bet ($0.50) returned to g5LAv1J/3Thw1zs/SEyfzw
g5LAv1J/3Thw1zs/SEyfzw collected $0.60 from pot
g5LAv1J/3Thw1zs/SEyfzw: doesn't show hand 
*** SUMMARY ***
Total pot $0.60 | Rake $0 
Seat 1: aNpwfA31EREwO+ar4XzBCw folded before Flop (didn't bet)
Seat 2: Sd1tfhUq/M96GhXGv1hwFQ folded before Flop (didn't bet)
Seat 3: g5LAv1J/3Thw1zs/SEyfzw collected ($0.60)
Seat 5: gehe91e0IyVT0QU/XBkEyg folded before Flop (didn't bet)
Seat 6: monZeAwXUmIA1l84cUd2hw (button) folded before Flop (didn't bet)
Seat 7: EP17SQz/iWcuYdNOGeBgkw (small blind) folded before Flop
Seat 8: MG90wfSJZnOejs/KD3vlQQ (big blind) folded before Flop
Seat 9: O02ScVDnDZwH6KjZNJZMzA folded before Flop (didn't bet)




PokerStars Game #59941733192:  Hold'em No Limit ($0.10/$0.25) - 2009/07/01 1:44:26 ET
Table '/asc7VQ/OpF/oVJ3erB80w' 9-max Seat #9 is the button
Seat 2: +LseQ4csMghI3KY4cLSGMQ ($6.80 in chips) 
Seat 3: WEb58GPxGJGcxGh34AFZRQ ($7.10 in chips) 
Seat 4: Rjy74A2wdEiDWplMcUbA+w ($19.35 in chips) 
Seat 5: QB9VESHry/CRTDKMGwKwsQ ($42.45 in chips) 
Seat 7: 7Qlge5BZqMQvXxiy4HU3Hw ($7.50 in chips) 
Seat 8: jB7U2KxE3pjvDhvZHXK2Ag ($19.60 in chips) 
Seat 9: zUXhymECc2C9W9ZNw6qppA ($19.05 in chips) 
+LseQ4csMghI3KY4cLSGMQ: posts small blind $0.10
WEb58GPxGJGcxGh34AFZRQ: posts big blind $0.25
ValerbI4_K: sits out 
*** HOLE CARDS ***
Rjy74A2wdEiDWplMcUbA+w: calls $0.25
QB9VESHry/CRTDKMGwKwsQ: folds 
7Qlge5BZqMQvXxiy4HU3Hw: raises $0.75 to $1
7Qlge5BZqMQvXxiy4HU3Hw said, "TERRIBLE"
jB7U2KxE3pjvDhvZHXK2Ag: calls $1
zUXhymECc2C9W9ZNw6qppA: folds 
+LseQ4csMghI3KY4cLSGMQ: calls $0.90
WEb58GPxGJGcxGh34AFZRQ: folds 
Rjy74A2wdEiDWplMcUbA+w: calls $0.75
*** FLOP *** [Jc 6d Qd]
+LseQ4csMghI3KY4cLSGMQ said, "what happened.... I timed out lol"
+LseQ4csMghI3KY4cLSGMQ: checks 
Rjy74A2wdEiDWplMcUbA+w: checks 
7Qlge5BZqMQvXxiy4HU3Hw: checks 
jB7U2KxE3pjvDhvZHXK2Ag: checks 
*** TURN *** [Jc 6d Qd] [Kc]
+LseQ4csMghI3KY4cLSGMQ: bets $1
Rjy74A2wdEiDWplMcUbA+w: folds 
7Qlge5BZqMQvXxiy4HU3Hw: folds 
jB7U2KxE3pjvDhvZHXK2Ag: folds 
Uncalled bet ($1) returned to +LseQ4csMghI3KY4cLSGMQ
+LseQ4csMghI3KY4cLSGMQ collected $4.05 from pot
*** SUMMARY ***
Total pot $4.25 | Rake $0.20 
Board [Jc 6d Qd Kc]
Seat 2: +LseQ4csMghI3KY4cLSGMQ (small blind) collected ($4.05)
Seat 3: WEb58GPxGJGcxGh34AFZRQ (big blind) folded before Flop
Seat 4: Rjy74A2wdEiDWplMcUbA+w folded on the Turn
Seat 5: QB9VESHry/CRTDKMGwKwsQ folded before Flop (didn't bet)
Seat 7: 7Qlge5BZqMQvXxiy4HU3Hw folded on the Turn
Seat 8: jB7U2KxE3pjvDhvZHXK2Ag folded on the Turn
Seat 9: zUXhymECc2C9W9ZNw6qppA (button) folded before Flop (didn't bet)




PokerStars Game #59941733212:  Hold'em No Limit ($0.10/$0.25) - 2009/07/01 1:44:26 ET
Table 'sgdCtiuCu2BDZhyDi6RzTA' 6-max Seat #3 is the button
Seat 1: 3zD3qLXT1bEffAoWGnc7wg ($33.35 in chips) 
Seat 2: XD1i5m5PvBDnRzJaG/vINw ($24.05 in chips) 
Seat 3: eL3+wCBjFGfQ5FMdIZihwA ($25.50 in chips) 
Seat 4: rVKEgilmMX+EkKzDVvhmxA ($8.45 in chips) 
Seat 5: 0tQitW75xfmVWKldYHjmOQ ($3.40 in chips) 
Seat 6: KODslGU8ikCYS0/29dUkhg ($35.45 in chips) 
rVKEgilmMX+EkKzDVvhmxA: posts small blind $0.10
0tQitW75xfmVWKldYHjmOQ: posts big blind $0.25
*** HOLE CARDS ***
KODslGU8ikCYS0/29dUkhg: calls $0.25
3zD3qLXT1bEffAoWGnc7wg: raises $0.75 to $1
XD1i5m5PvBDnRzJaG/vINw: folds 
eL3+wCBjFGfQ5FMdIZihwA: folds 
rVKEgilmMX+EkKzDVvhmxA: folds 
0tQitW75xfmVWKldYHjmOQ: folds 
KODslGU8ikCYS0/29dUkhg: calls $0.75
*** FLOP *** [9d Kc 4h]
KODslGU8ikCYS0/29dUkhg: checks 
3zD3qLXT1bEffAoWGnc7wg: checks 
*** TURN *** [9d Kc 4h] [Qc]
KODslGU8ikCYS0/29dUkhg: bets $1.25
3zD3qLXT1bEffAoWGnc7wg: calls $1.25
*** RIVER *** [9d Kc 4h Qc] [Qd]
KODslGU8ikCYS0/29dUkhg: checks 
3zD3qLXT1bEffAoWGnc7wg: checks 
*** SHOW DOWN ***
KODslGU8ikCYS0/29dUkhg: shows [6d Ac] (a pair of Queens)
3zD3qLXT1bEffAoWGnc7wg: shows [8c 8s] (two pair, Queens and Eights)
3zD3qLXT1bEffAoWGnc7wg collected $4.65 from pot
*** SUMMARY ***
Total pot $4.85 | Rake $0.20 
Board [9d Kc 4h Qc Qd]
Seat 1: 3zD3qLXT1bEffAoWGnc7wg showed [8c 8s] and won ($4.65) with two pair, Queens and Eights
Seat 2: XD1i5m5PvBDnRzJaG/vINw folded before Flop (didn't bet)
Seat 3: eL3+wCBjFGfQ5FMdIZihwA (button) folded before Flop (didn't bet)
Seat 4: rVKEgilmMX+EkKzDVvhmxA (small blind) folded before Flop
Seat 5: 0tQitW75xfmVWKldYHjmOQ (big blind) folded before Flop
Seat 6: KODslGU8ikCYS0/29dUkhg showed [6d Ac] and lost with a pair of Queens




PokerStars Game #59941734108:  Hold'em No Limit ($0.10/$0.25) - 2009/07/01 1:44:27 ET
Table 'LG9H161ZAHDkOww+ih3Ptg' 6-max Seat #2 is the button
Seat 1: avl8CO/tc0F6eVSiB/KNRA ($24.75 in chips) 
Seat 2: kwsRmpZ1ZaLooISs+zfyKg ($25.70 in chips) 
Seat 3: 5Evvx7UYqXTBuvIc/9s/hA ($15.70 in chips) 
Seat 4: 0C28L4/59aRNtHoBhqTcLg ($60.55 in chips) 
Seat 5: lYjWCpfCxX2kgcHY3v4Yow ($30.10 in chips) 
Seat 6: v8m8XHovI5tqEA9mvplDSw ($26.40 in chips) 
5Evvx7UYqXTBuvIc/9s/hA: posts small blind $0.10
0C28L4/59aRNtHoBhqTcLg: posts big blind $0.25
*** HOLE CARDS ***
lYjWCpfCxX2kgcHY3v4Yow: folds 
v8m8XHovI5tqEA9mvplDSw: folds 
avl8CO/tc0F6eVSiB/KNRA: folds 
kwsRmpZ1ZaLooISs+zfyKg: folds 
5Evvx7UYqXTBuvIc/9s/hA: calls $0.15
0C28L4/59aRNtHoBhqTcLg: checks 
*** FLOP *** [8h 6c 5c]
5Evvx7UYqXTBuvIc/9s/hA: checks 
0C28L4/59aRNtHoBhqTcLg: checks 
*** TURN *** [8h 6c 5c] [6s]
5Evvx7UYqXTBuvIc/9s/hA: checks 
0C28L4/59aRNtHoBhqTcLg: checks 
*** RIVER *** [8h 6c 5c 6s] [5h]
5Evvx7UYqXTBuvIc/9s/hA: checks 
0C28L4/59aRNtHoBhqTcLg: checks 
*** SHOW DOWN ***
5Evvx7UYqXTBuvIc/9s/hA: shows [4s 9s] (two pair, Sixes and Fives)
0C28L4/59aRNtHoBhqTcLg: mucks hand 
5Evvx7UYqXTBuvIc/9s/hA collected $0.50 from pot
*** SUMMARY ***
Total pot $0.50 | Rake $0 
Board [8h 6c 5c 6s 5h]
Seat 1: avl8CO/tc0F6eVSiB/KNRA folded before Flop (didn't bet)
Seat 2: kwsRmpZ1ZaLooISs+zfyKg (button) folded before Flop (didn't bet)
Seat 3: 5Evvx7UYqXTBuvIc/9s/hA (small blind) showed [4s 9s] and won ($0.50) with two pair, Sixes and Fives
Seat 4: 0C28L4/59aRNtHoBhqTcLg (big blind) mucked
Seat 5: lYjWCpfCxX2kgcHY3v4Yow folded before Flop (didn't bet)
Seat 6: v8m8XHovI5tqEA9mvplDSw folded before Flop (didn't bet)




PokerStars Game #59941733674:  Hold'em No Limit ($0.10/$0.25) - 2009/07/01 1:44:27 ET
Table '+VTTYgQLH1awDHk+IAxqGg' 9-max Seat #1 is the button
Seat 1: arxNSjreDRGFg13EAM2F1w ($26.90 in chips) 
Seat 2: 2wcFsZsqEP5w1StUTVzJCg ($4.90 in chips) 
Seat 3: AiXn/9o1EwOPZUHujnh/bA ($12.15 in chips) 
Seat 4: gE5rN2TDY1aXcZn/TOPeZw ($10.65 in chips) 
Seat 5: sD+TKtt36XiiN6jqHiLwDA ($25.15 in chips) 
Seat 7: ljemhp25Zg+nlA9DLCIiUw ($25 in chips) 
Seat 8: 10vzP4r6ldwGLbYHKd9www ($17.65 in chips) 
Seat 9: S7Ki0P+0AIGPuIfGJjW0gg ($61 in chips) 
2wcFsZsqEP5w1StUTVzJCg: posts small blind $0.10
AiXn/9o1EwOPZUHujnh/bA: posts big blind $0.25
*** HOLE CARDS ***
gE5rN2TDY1aXcZn/TOPeZw: folds 
sD+TKtt36XiiN6jqHiLwDA: folds 
ljemhp25Zg+nlA9DLCIiUw: raises $0.50 to $0.75
10vzP4r6ldwGLbYHKd9www: folds 
S7Ki0P+0AIGPuIfGJjW0gg: folds 
arxNSjreDRGFg13EAM2F1w: folds 
2wcFsZsqEP5w1StUTVzJCg: calls $0.65
AiXn/9o1EwOPZUHujnh/bA: folds 
*** FLOP *** [2d 7c 6s]
2wcFsZsqEP5w1StUTVzJCg: checks 
ljemhp25Zg+nlA9DLCIiUw: checks 
*** TURN *** [2d 7c 6s] [9d]
2wcFsZsqEP5w1StUTVzJCg: checks 
ljemhp25Zg+nlA9DLCIiUw: checks 
*** RIVER *** [2d 7c 6s 9d] [8h]
2wcFsZsqEP5w1StUTVzJCg: checks 
ljemhp25Zg+nlA9DLCIiUw: checks 
*** SHOW DOWN ***
2wcFsZsqEP5w1StUTVzJCg: shows [Kh Ac] (high card Ace)
ljemhp25Zg+nlA9DLCIiUw: mucks hand 
2wcFsZsqEP5w1StUTVzJCg collected $1.70 from pot
*** SUMMARY ***
Total pot $1.75 | Rake $0.05 
Board [2d 7c 6s 9d 8h]
Seat 1: arxNSjreDRGFg13EAM2F1w (button) folded before Flop (didn't bet)
Seat 2: 2wcFsZsqEP5w1StUTVzJCg (small blind) showed [Kh Ac] and won ($1.70) with high card Ace
Seat 3: AiXn/9o1EwOPZUHujnh/bA (big blind) folded before Flop
Seat 4: gE5rN2TDY1aXcZn/TOPeZw folded before Flop (didn't bet)
Seat 5: sD+TKtt36XiiN6jqHiLwDA folded before Flop (didn't bet)
Seat 7: ljemhp25Zg+nlA9DLCIiUw mucked
Seat 8: 10vzP4r6ldwGLbYHKd9www folded before Flop (didn't bet)
Seat 9: S7Ki0P+0AIGPuIfGJjW0gg folded before Flop (didn't bet)




PokerStars Game #59941733640:  Hold'em No Limit ($0.10/$0.25) - 2009/07/01 1:44:27 ET
Table 'g6ryG70feTw9nNm+XJLuXw' 6-max Seat #4 is the button
Seat 1: v+QfkGiuj9bgtuNoVnDO8w ($35.60 in chips) 
Seat 2: SxIIgwXYLkwd6m3wLyPTCw ($33.10 in chips) 
Seat 3: cezpHJ8FB07dj0xG+LhOvw ($25 in chips) 
Seat 4: GC/9yVD59DUCX7hUI7gcLw ($44.35 in chips) 
Seat 5: EE16Ua5b1HSsYej5zeXOlA ($25.45 in chips) 
EE16Ua5b1HSsYej5zeXOlA: posts small blind $0.10
tSR4329m40dZsN7YOpI9Kw: is sitting out 
v+QfkGiuj9bgtuNoVnDO8w: posts big blind $0.25
*** HOLE CARDS ***
tSR4329m40dZsN7YOpI9Kw leaves the table
SxIIgwXYLkwd6m3wLyPTCw: folds 
cezpHJ8FB07dj0xG+LhOvw: raises $0.55 to $0.80
StevenWu joins the table at seat #6 
GC/9yVD59DUCX7hUI7gcLw: raises $2.20 to $3
EE16Ua5b1HSsYej5zeXOlA: folds 
v+QfkGiuj9bgtuNoVnDO8w: folds 
cezpHJ8FB07dj0xG+LhOvw: folds 
Uncalled bet ($2.20) returned to GC/9yVD59DUCX7hUI7gcLw
GC/9yVD59DUCX7hUI7gcLw collected $1.95 from pot
*** SUMMARY ***
Total pot $1.95 | Rake $0 
Seat 1: v+QfkGiuj9bgtuNoVnDO8w (big blind) folded before Flop
Seat 2: SxIIgwXYLkwd6m3wLyPTCw folded before Flop (didn't bet)
Seat 3: cezpHJ8FB07dj0xG+LhOvw folded before Flop
Seat 4: GC/9yVD59DUCX7hUI7gcLw (button) collected ($1.95)
Seat 5: EE16Ua5b1HSsYej5zeXOlA (small blind) folded before Flop




PokerStars Game #59941733914:  Hold'em No Limit ($0.10/$0.25) - 2009/07/01 1:44:27 ET
Table '9L7XfAwuM7XsXE8LIg2o5Q' 6-max Seat #4 is the button
Seat 1: dOIoLBxmpLHSXBN9LZnf0Q ($25.20 in chips) 
Seat 2: LJI7A1YgDM7hgh7o56+ReQ ($25.85 in chips) 
Seat 3: mFv3iBCtrw9XfCDRB0d46Q ($4.65 in chips) 
Seat 4: jp34e617tIzV8tKIWmfAbA ($39.45 in chips) 
Seat 6: k9nHZTHt8hYhYRcW8NTb4g ($38.30 in chips) 
texthgr8 will be allowed to play after the button
k9nHZTHt8hYhYRcW8NTb4g: posts small blind $0.10
dOIoLBxmpLHSXBN9LZnf0Q: posts big blind $0.25
*** HOLE CARDS ***
LJI7A1YgDM7hgh7o56+ReQ: raises $0.75 to $1
mFv3iBCtrw9XfCDRB0d46Q: folds 
jp34e617tIzV8tKIWmfAbA: calls $1
k9nHZTHt8hYhYRcW8NTb4g: calls $0.90
dOIoLBxmpLHSXBN9LZnf0Q: calls $0.75
*** FLOP *** [Qh Ad 5d]
k9nHZTHt8hYhYRcW8NTb4g: checks 
dOIoLBxmpLHSXBN9LZnf0Q: bets $0.25
LJI7A1YgDM7hgh7o56+ReQ: raises $2.75 to $3
jp34e617tIzV8tKIWmfAbA: folds 
k9nHZTHt8hYhYRcW8NTb4g: folds 
dOIoLBxmpLHSXBN9LZnf0Q: folds 
Uncalled bet ($2.75) returned to LJI7A1YgDM7hgh7o56+ReQ
LJI7A1YgDM7hgh7o56+ReQ collected $4.30 from pot
LJI7A1YgDM7hgh7o56+ReQ: doesn't show hand 
*** SUMMARY ***
Total pot $4.50 | Rake $0.20 
Board [Qh Ad 5d]
Seat 1: dOIoLBxmpLHSXBN9LZnf0Q (big blind) folded on the Flop
Seat 2: LJI7A1YgDM7hgh7o56+ReQ collected ($4.30)
Seat 3: mFv3iBCtrw9XfCDRB0d46Q folded before Flop (didn't bet)
Seat 4: jp34e617tIzV8tKIWmfAbA (button) folded on the Flop
Seat 6: k9nHZTHt8hYhYRcW8NTb4g (small blind) folded on the Flop




PokerStars Game #59941733650:  Hold'em No Limit ($0.10/$0.25) - 2009/07/01 1:44:27 ET
Table 'WY+lMaAoIdBZmwk27/RJCA' 6-max Seat #6 is the button
Seat 1: zHHLkD2sRljslKKeQv/ZQw ($26.20 in chips) 
Seat 2: NhUN/JpAprdJeamFBgJH1w ($26.90 in chips) 
Seat 4: 0av6tRNdi0Ui4f15L7gsVg ($25 in chips) 
Seat 5: vqWjZmdQu/Hxw96/IJTWdQ ($30.45 in chips) 
Seat 6: cWc85bEzdRzpUMhRKm8pwQ ($25.50 in chips) 
zHHLkD2sRljslKKeQv/ZQw: posts small blind $0.10
NhUN/JpAprdJeamFBgJH1w: posts big blind $0.25
QqiZLFrN8iOUT/GHw7ztOA: sits out 
*** HOLE CARDS ***
0av6tRNdi0Ui4f15L7gsVg: folds 
vqWjZmdQu/Hxw96/IJTWdQ: folds 
cWc85bEzdRzpUMhRKm8pwQ: folds 
zHHLkD2sRljslKKeQv/ZQw: folds 
Uncalled bet ($0.15) returned to NhUN/JpAprdJeamFBgJH1w
NhUN/JpAprdJeamFBgJH1w collected $0.20 from pot
NhUN/JpAprdJeamFBgJH1w: doesn't show hand 
*** SUMMARY ***
Total pot $0.20 | Rake $0 
Seat 1: zHHLkD2sRljslKKeQv/ZQw (small blind) folded before Flop
Seat 2: NhUN/JpAprdJeamFBgJH1w (big blind) collected ($0.20)
Seat 4: 0av6tRNdi0Ui4f15L7gsVg folded before Flop (didn't bet)
Seat 5: vqWjZmdQu/Hxw96/IJTWdQ folded before Flop (didn't bet)
Seat 6: cWc85bEzdRzpUMhRKm8pwQ (button) folded before Flop (didn't bet)




PokerStars Game #59941733824:  Hold'em No Limit ($0.10/$0.25) - 2009/07/01 1:44:27 ET
Table 'S6s+TmTlAjLHclBRvN5/fw' 9-max Seat #3 is the button
Seat 3: z2SmIaQ3+5n/eY1BN5HgPg ($5.05 in chips) 
Seat 4: RSal7+azPhXeqQO5L8XPfg ($15 in chips) 
z2SmIaQ3+5n/eY1BN5HgPg: posts small blind $0.10
RSal7+azPhXeqQO5L8XPfg: posts big blind $0.25
*** HOLE CARDS ***
z2SmIaQ3+5n/eY1BN5HgPg: calls $0.15
RSal7+azPhXeqQO5L8XPfg: checks 
*** FLOP *** [5h Qc Jh]
RSal7+azPhXeqQO5L8XPfg: bets $0.25
z2SmIaQ3+5n/eY1BN5HgPg: calls $0.25
*** TURN *** [5h Qc Jh] [4h]
RSal7+azPhXeqQO5L8XPfg: bets $0.25
z2SmIaQ3+5n/eY1BN5HgPg: raises $0.50 to $0.75
RSal7+azPhXeqQO5L8XPfg: calls $0.50
*** RIVER *** [5h Qc Jh 4h] [Tc]
RSal7+azPhXeqQO5L8XPfg: bets $0.25
z2SmIaQ3+5n/eY1BN5HgPg: raises $3.55 to $3.80 and is all-in
RSal7+azPhXeqQO5L8XPfg: folds 
Uncalled bet ($3.55) returned to z2SmIaQ3+5n/eY1BN5HgPg
z2SmIaQ3+5n/eY1BN5HgPg collected $2.90 from pot
z2SmIaQ3+5n/eY1BN5HgPg: doesn't show hand 
*** SUMMARY ***
Total pot $3 | Rake $0.10 
Board [5h Qc Jh 4h Tc]
Seat 3: z2SmIaQ3+5n/eY1BN5HgPg (button) (small blind) collected ($2.90)
Seat 4: RSal7+azPhXeqQO5L8XPfg (big blind) folded on the River




PokerStars Game #59941734062:  Hold'em No Limit ($0.10/$0.25) - 2009/07/01 1:44:27 ET
Table 'Jj2eLzVCUVAGBmM+Og79iQ' 9-max Seat #3 is the button
Seat 1: ShXPHWfjhfmAwLgDdm6bRQ ($7 in chips) 
Seat 2: oMxwMC7+uAsJudeUN6aP0A ($15.60 in chips) 
Seat 3: HPEB+AtKw1+C/cxU0o1ciw ($24.65 in chips) 
Seat 4: aNpwfA31EREwO+ar4XzBCw ($45 in chips) 
Seat 5: UkF1eqqUN0CCiimXAuN7og ($5 in chips) 
Seat 6: jZURAM/dgGCX+5lATlZugw ($14.55 in chips) 
Seat 7: K0b5wNInj6hUGRr6yzKFtw ($59.50 in chips) 
Seat 8: H5Se03ZqSX7tbULXur2MAg ($20.60 in chips) 
Seat 9: wU1LtrccnZo6PYKhlJ6ElQ ($24.25 in chips) 
aNpwfA31EREwO+ar4XzBCw: posts small blind $0.10
UkF1eqqUN0CCiimXAuN7og: posts big blind $0.25
ShXPHWfjhfmAwLgDdm6bRQ: posts big blind $0.25
*** HOLE CARDS ***
jZURAM/dgGCX+5lATlZugw: raises $0.75 to $1
K0b5wNInj6hUGRr6yzKFtw: folds 
H5Se03ZqSX7tbULXur2MAg: folds 
wU1LtrccnZo6PYKhlJ6ElQ: calls $1
ShXPHWfjhfmAwLgDdm6bRQ: folds 
oMxwMC7+uAsJudeUN6aP0A: calls $1
HPEB+AtKw1+C/cxU0o1ciw: folds 
aNpwfA31EREwO+ar4XzBCw: calls $0.90
UkF1eqqUN0CCiimXAuN7og: folds 
*** FLOP *** [7h 2h 3d]
aNpwfA31EREwO+ar4XzBCw: checks 
jZURAM/dgGCX+5lATlZugw: bets $4
wU1LtrccnZo6PYKhlJ6ElQ: folds 
wU1LtrccnZo6PYKhlJ6ElQ leaves the table
oMxwMC7+uAsJudeUN6aP0A: folds 
vSkQm2EelzwRGDDQQk0Fqw joins the table at seat #9 
aNpwfA31EREwO+ar4XzBCw: folds 
Uncalled bet ($4) returned to jZURAM/dgGCX+5lATlZugw
jZURAM/dgGCX+5lATlZugw collected $4.30 from pot
jZURAM/dgGCX+5lATlZugw: doesn't show hand 
*** SUMMARY ***
Total pot $4.50 | Rake $0.20 
Board [7h 2h 3d]
Seat 1: ShXPHWfjhfmAwLgDdm6bRQ folded before Flop
Seat 2: oMxwMC7+uAsJudeUN6aP0A folded on the Flop
Seat 3: HPEB+AtKw1+C/cxU0o1ciw (button) folded before Flop (didn't bet)
Seat 4: aNpwfA31EREwO+ar4XzBCw (small blind) folded on the Flop
Seat 5: UkF1eqqUN0CCiimXAuN7og (big blind) folded before Flop
Seat 6: jZURAM/dgGCX+5lATlZugw collected ($4.30)
Seat 7: K0b5wNInj6hUGRr6yzKFtw folded before Flop (didn't bet)
Seat 8: H5Se03ZqSX7tbULXur2MAg folded before Flop (didn't bet)
Seat 9: wU1LtrccnZo6PYKhlJ6ElQ folded on the Flop




PokerStars Game #59941733930:  Hold'em No Limit ($0.10/$0.25) - 2009/07/01 1:44:27 ET
Table 'P1IJQ2p3ACFySC35W1qwQw' 9-max Seat #2 is the button
Seat 1: bXpVeaSTPBFSPJmeXxO7nw ($4.90 in chips) 
Seat 2: vO3QVRovWemcGMkm7ijAIA ($5.35 in chips) 
Seat 3: PVxvfRTRvkgZf9WtquEkwQ ($25.10 in chips) 
Seat 4: c/9X4zftzphFxYtxp5kp9w ($27.90 in chips) 
Seat 5: ghNKXUBl/H+t83JF079ZBA ($56.45 in chips) 
Seat 6: ljemhp25Zg+nlA9DLCIiUw ($64.45 in chips) 
Seat 7: 7je+LC5Mfs6nL8YBVh4frQ ($5.45 in chips) 
Seat 8: tLcDklc2rBORNfixyRfVfw ($26.25 in chips) 
Seat 9: XXajyXkgbSGJKxQP3mal/Q ($14.90 in chips) 
PVxvfRTRvkgZf9WtquEkwQ: posts small blind $0.10
c/9X4zftzphFxYtxp5kp9w: posts big blind $0.25
*** HOLE CARDS ***
ghNKXUBl/H+t83JF079ZBA: folds 
ljemhp25Zg+nlA9DLCIiUw: folds 
7je+LC5Mfs6nL8YBVh4frQ: folds 
tLcDklc2rBORNfixyRfVfw: raises $0.75 to $1
XXajyXkgbSGJKxQP3mal/Q: folds 
bXpVeaSTPBFSPJmeXxO7nw: folds 
vO3QVRovWemcGMkm7ijAIA: folds 
PVxvfRTRvkgZf9WtquEkwQ: folds 
c/9X4zftzphFxYtxp5kp9w: folds 
Uncalled bet ($0.75) returned to tLcDklc2rBORNfixyRfVfw
tLcDklc2rBORNfixyRfVfw collected $0.60 from pot
tLcDklc2rBORNfixyRfVfw: doesn't show hand 
*** SUMMARY ***
Total pot $0.60 | Rake $0 
Seat 1: bXpVeaSTPBFSPJmeXxO7nw folded before Flop (didn't bet)
Seat 2: vO3QVRovWemcGMkm7ijAIA (button) folded before Flop (didn't bet)
Seat 3: PVxvfRTRvkgZf9WtquEkwQ (small blind) folded before Flop
Seat 4: c/9X4zftzphFxYtxp5kp9w (big blind) folded before Flop
Seat 5: ghNKXUBl/H+t83JF079ZBA folded before Flop (didn't bet)
Seat 6: ljemhp25Zg+nlA9DLCIiUw folded before Flop (didn't bet)
Seat 7: 7je+LC5Mfs6nL8YBVh4frQ folded before Flop (didn't bet)
Seat 8: tLcDklc2rBORNfixyRfVfw collected ($0.60)
Seat 9: XXajyXkgbSGJKxQP3mal/Q folded before Flop (didn't bet)




PokerStars Game #59941734214:  Hold'em No Limit ($0.10/$0.25) - 2009/07/01 1:44:28 ET
Table '+giHa6FUL6U5/AZnCJEGvQ' 9-max Seat #6 is the button
Seat 4: 10f7J+bM02ZfDHx0PgkNSg ($14.45 in chips) 
Seat 6: GTMnTen6sQSoCpS9sggLbg ($25.20 in chips) 
GTMnTen6sQSoCpS9sggLbg: posts small blind $0.10
10f7J+bM02ZfDHx0PgkNSg: posts big blind $0.25
*** HOLE CARDS ***
GTMnTen6sQSoCpS9sggLbg: calls $0.15
10f7J+bM02ZfDHx0PgkNSg: checks 
*** FLOP *** [Ad 5h Ac]
10f7J+bM02ZfDHx0PgkNSg: checks 
GTMnTen6sQSoCpS9sggLbg: bets $0.25
10f7J+bM02ZfDHx0PgkNSg: folds 
Uncalled bet ($0.25) returned to GTMnTen6sQSoCpS9sggLbg
GTMnTen6sQSoCpS9sggLbg collected $0.50 from pot
GTMnTen6sQSoCpS9sggLbg: doesn't show hand 
*** SUMMARY ***
Total pot $0.50 | Rake $0 
Board [Ad 5h Ac]
Seat 4: 10f7J+bM02ZfDHx0PgkNSg (big blind) folded on the Flop
Seat 6: GTMnTen6sQSoCpS9sggLbg (button) (small blind) collected ($0.50)




PokerStars Game #59941734576:  Hold'em No Limit ($0.10/$0.25) - 2009/07/01 1:44:28 ET
Table 'uFgIyfWPagvEVGEb86da7A' 9-max Seat #1 is the button
Seat 1: CT7Xj/V/O5rBlhtt+RZeFQ ($25.75 in chips) 
Seat 2: o3zvoO+PsqGti+1NZGNRrQ ($1.35 in chips) 
Seat 3: eGAnPT3w+iltM7HF59dzIg ($6.25 in chips) 
Seat 4: IGRfskE1v9H9Bn+fz8AgNQ ($26.90 in chips) 
Seat 5: X78b5v/uhqeXXoAijbw/yg ($28.30 in chips) 
Seat 7: 9zx7Mlww974uHUqoiq2eXA ($11.85 in chips) 
Seat 8: uLP/lYn7oKq9xCChBXsXxw ($24.30 in chips) 
Seat 9: sL5EaDXc90Iyxlm8ERXRQw ($18 in chips) 
o3zvoO+PsqGti+1NZGNRrQ: posts small blind $0.10
eGAnPT3w+iltM7HF59dzIg: posts big blind $0.25
*** HOLE CARDS ***
IGRfskE1v9H9Bn+fz8AgNQ: raises $0.50 to $0.75
X78b5v/uhqeXXoAijbw/yg: folds 
9zx7Mlww974uHUqoiq2eXA: folds 
uLP/lYn7oKq9xCChBXsXxw: folds 
sL5EaDXc90Iyxlm8ERXRQw: folds 
CT7Xj/V/O5rBlhtt+RZeFQ: folds 
o3zvoO+PsqGti+1NZGNRrQ: folds 
eGAnPT3w+iltM7HF59dzIg: folds 
Uncalled bet ($0.50) returned to IGRfskE1v9H9Bn+fz8AgNQ
IGRfskE1v9H9Bn+fz8AgNQ collected $0.60 from pot
IGRfskE1v9H9Bn+fz8AgNQ: doesn't show hand 
*** SUMMARY ***
Total pot $0.60 | Rake $0 
Seat 1: CT7Xj/V/O5rBlhtt+RZeFQ (button) folded before Flop (didn't bet)
Seat 2: o3zvoO+PsqGti+1NZGNRrQ (small blind) folded before Flop
Seat 3: eGAnPT3w+iltM7HF59dzIg (big blind) folded before Flop
Seat 4: IGRfskE1v9H9Bn+fz8AgNQ collected ($0.60)
Seat 5: X78b5v/uhqeXXoAijbw/yg folded before Flop (didn't bet)
Seat 7: 9zx7Mlww974uHUqoiq2eXA folded before Flop (didn't bet)
Seat 8: uLP/lYn7oKq9xCChBXsXxw folded before Flop (didn't bet)
Seat 9: sL5EaDXc90Iyxlm8ERXRQw folded before Flop (didn't bet)




PokerStars Game #59941734444:  Hold'em No Limit ($0.10/$0.25) - 2009/07/01 1:44:28 ET
Table 'ouLhepGYovxB2x0QxH7cVg' 9-max Seat #7 is the button
Seat 1: ghNKXUBl/H+t83JF079ZBA ($25.35 in chips) 
Seat 2: r1Z5m4PwSI5ANp7qCE1OJw ($18.85 in chips) 
Seat 3: bXpVeaSTPBFSPJmeXxO7nw ($5.25 in chips) 
Seat 4: a0Sx6GHY7ln2Ns2C97eXeA ($38.10 in chips) 
Seat 5: v60REj6f8jzMYT0VsZvaPQ ($9.65 in chips) 
Seat 7: JRV2PblFtPFz51l0Fwyz8g ($24.25 in chips) 
Seat 8: tLcDklc2rBORNfixyRfVfw ($25 in chips) 
Seat 9: ljemhp25Zg+nlA9DLCIiUw ($25.35 in chips) 
tLcDklc2rBORNfixyRfVfw: posts small blind $0.10
ljemhp25Zg+nlA9DLCIiUw: posts big blind $0.25
*** HOLE CARDS ***
ghNKXUBl/H+t83JF079ZBA: folds 
r1Z5m4PwSI5ANp7qCE1OJw: folds 
bXpVeaSTPBFSPJmeXxO7nw: folds 
a0Sx6GHY7ln2Ns2C97eXeA: folds 
v60REj6f8jzMYT0VsZvaPQ: raises $0.50 to $0.75
JRV2PblFtPFz51l0Fwyz8g: folds 
tLcDklc2rBORNfixyRfVfw: folds 
ljemhp25Zg+nlA9DLCIiUw: folds 
Uncalled bet ($0.50) returned to v60REj6f8jzMYT0VsZvaPQ
v60REj6f8jzMYT0VsZvaPQ collected $0.60 from pot
*** SUMMARY ***
Total pot $0.60 | Rake $0 
Seat 1: ghNKXUBl/H+t83JF079ZBA folded before Flop (didn't bet)
Seat 2: r1Z5m4PwSI5ANp7qCE1OJw folded before Flop (didn't bet)
Seat 3: bXpVeaSTPBFSPJmeXxO7nw folded before Flop (didn't bet)
Seat 4: a0Sx6GHY7ln2Ns2C97eXeA folded before Flop (didn't bet)
Seat 5: v60REj6f8jzMYT0VsZvaPQ collected ($0.60)
Seat 7: JRV2PblFtPFz51l0Fwyz8g (button) folded before Flop (didn't bet)
Seat 8: tLcDklc2rBORNfixyRfVfw (small blind) folded before Flop
Seat 9: ljemhp25Zg+nlA9DLCIiUw (big blind) folded before Flop




PokerStars Game #59941734220:  Hold'em No Limit ($0.10/$0.25) - 2009/07/01 1:44:28 ET
Table 'eOXPe2c6mG7DOFKvMsZZfA' 6-max Seat #6 is the button
Seat 1: s21kVGMLPAoHdWR+muSonw ($25.15 in chips) 
Seat 2: gaPMxLGp9SOj4Lq6t+/0Ig ($7.10 in chips) 
Seat 3: kReyZ6g6Fu3tQ0nyjDf9kA ($27.10 in chips) 
Seat 4: zHHLkD2sRljslKKeQv/ZQw ($35.35 in chips) 
Seat 5: NhUN/JpAprdJeamFBgJH1w ($32.30 in chips) 
Seat 6: Qpv/hb5ak7LeaDig1L5L8w ($13.60 in chips) 
s21kVGMLPAoHdWR+muSonw: posts small blind $0.10
gaPMxLGp9SOj4Lq6t+/0Ig: posts big blind $0.25
*** HOLE CARDS ***
kReyZ6g6Fu3tQ0nyjDf9kA: folds 
zHHLkD2sRljslKKeQv/ZQw: folds 
NhUN/JpAprdJeamFBgJH1w: folds 
Qpv/hb5ak7LeaDig1L5L8w: folds 
s21kVGMLPAoHdWR+muSonw: folds 
Uncalled bet ($0.15) returned to gaPMxLGp9SOj4Lq6t+/0Ig
gaPMxLGp9SOj4Lq6t+/0Ig collected $0.20 from pot
gaPMxLGp9SOj4Lq6t+/0Ig: doesn't show hand 
*** SUMMARY ***
Total pot $0.20 | Rake $0 
Seat 1: s21kVGMLPAoHdWR+muSonw (small blind) folded before Flop
Seat 2: gaPMxLGp9SOj4Lq6t+/0Ig (big blind) collected ($0.20)
Seat 3: kReyZ6g6Fu3tQ0nyjDf9kA folded before Flop (didn't bet)
Seat 4: zHHLkD2sRljslKKeQv/ZQw folded before Flop (didn't bet)
Seat 5: NhUN/JpAprdJeamFBgJH1w folded before Flop (didn't bet)
Seat 6: Qpv/hb5ak7LeaDig1L5L8w (button) folded before Flop (didn't bet)




PokerStars Game #59941734736:  Hold'em No Limit ($0.10/$0.25) - 2009/07/01 1:44:28 ET
Table 'ggwTHpIC5qhhHJSYjK1XCw' 6-max Seat #1 is the button
Seat 1: MqMK8OWPSY1V4stf1Hy5Jw ($78.85 in chips) 
Seat 2: /gJNBeCkWL4o85/jvlZ4BA ($26.95 in chips) 
Seat 3: SxIIgwXYLkwd6m3wLyPTCw ($69.70 in chips) 
Seat 4: JFIAqU8lCZ0vWwEl4bdGsg ($25.60 in chips) 
Seat 5: BvqhBa7W/To51LhEiIU/lw ($5.40 in chips) 
Seat 6: 732E3Iz0geWMK40ej+U9HA ($10.40 in chips) 
/gJNBeCkWL4o85/jvlZ4BA: posts small blind $0.10
SxIIgwXYLkwd6m3wLyPTCw: posts big blind $0.25
*** HOLE CARDS ***
JFIAqU8lCZ0vWwEl4bdGsg: folds 
BvqhBa7W/To51LhEiIU/lw: folds 
732E3Iz0geWMK40ej+U9HA: folds 
MqMK8OWPSY1V4stf1Hy5Jw: raises $0.75 to $1
/gJNBeCkWL4o85/jvlZ4BA: calls $0.90
SxIIgwXYLkwd6m3wLyPTCw: folds 
*** FLOP *** [9c 7s 3d]
/gJNBeCkWL4o85/jvlZ4BA: checks 
MqMK8OWPSY1V4stf1Hy5Jw: bets $2.15
/gJNBeCkWL4o85/jvlZ4BA: folds 
Uncalled bet ($2.15) returned to MqMK8OWPSY1V4stf1Hy5Jw
MqMK8OWPSY1V4stf1Hy5Jw collected $2.15 from pot
MqMK8OWPSY1V4stf1Hy5Jw: doesn't show hand 
*** SUMMARY ***
Total pot $2.25 | Rake $0.10 
Board [9c 7s 3d]
Seat 1: MqMK8OWPSY1V4stf1Hy5Jw (button) collected ($2.15)
Seat 2: /gJNBeCkWL4o85/jvlZ4BA (small blind) folded on the Flop
Seat 3: SxIIgwXYLkwd6m3wLyPTCw (big blind) folded before Flop
Seat 4: JFIAqU8lCZ0vWwEl4bdGsg folded before Flop (didn't bet)
Seat 5: BvqhBa7W/To51LhEiIU/lw folded before Flop (didn't bet)
Seat 6: 732E3Iz0geWMK40ej+U9HA folded before Flop (didn't bet)




PokerStars Game #59941734388:  Hold'em No Limit ($0.10/$0.25) - 2009/07/01 1:44:28 ET
Table 'ZEXL6Wh4qA4Afx8NnoBBAA' 6-max Seat #5 is the button
Seat 1: v8m8XHovI5tqEA9mvplDSw ($27.60 in chips) 
Seat 2: 6DwBRH+xZ12AAZmeAg+aXw ($24 in chips) 
Seat 3: +ZlnqPoP3Hg4BIUxDfKd/A ($32.05 in chips) 
Seat 4: FpN4KbLjlyRRKiVaQcoLqA ($29.60 in chips) 
Seat 5: if4dh6jhJXeN3/qd3qCp9g ($35.80 in chips) 
Seat 6: Lh8SlCq3OSDKWLUgAI/Lxw ($2.10 in chips) 
Lh8SlCq3OSDKWLUgAI/Lxw: posts small blind $0.10
v8m8XHovI5tqEA9mvplDSw: posts big blind $0.25
*** HOLE CARDS ***
6DwBRH+xZ12AAZmeAg+aXw: folds 
+ZlnqPoP3Hg4BIUxDfKd/A: folds 
FpN4KbLjlyRRKiVaQcoLqA: folds 
6DwBRH+xZ12AAZmeAg+aXw said, "wp"
if4dh6jhJXeN3/qd3qCp9g: folds 
Lh8SlCq3OSDKWLUgAI/Lxw: folds 
Uncalled bet ($0.15) returned to v8m8XHovI5tqEA9mvplDSw
v8m8XHovI5tqEA9mvplDSw collected $0.20 from pot
v8m8XHovI5tqEA9mvplDSw: doesn't show hand 
*** SUMMARY ***
Total pot $0.20 | Rake $0 
Seat 1: v8m8XHovI5tqEA9mvplDSw (big blind) collected ($0.20)
Seat 2: 6DwBRH+xZ12AAZmeAg+aXw folded before Flop (didn't bet)
Seat 3: +ZlnqPoP3Hg4BIUxDfKd/A folded before Flop (didn't bet)
Seat 4: FpN4KbLjlyRRKiVaQcoLqA folded before Flop (didn't bet)
Seat 5: if4dh6jhJXeN3/qd3qCp9g (button) folded before Flop (didn't bet)
Seat 6: Lh8SlCq3OSDKWLUgAI/Lxw (small blind) folded before Flop




PokerStars Game #59941734634:  Hold'em No Limit ($0.10/$0.25) - 2009/07/01 1:44:28 ET
Table 'TJS4XvvOjO3k7mH74HJw5g' 9-max Seat #6 is the button
Seat 1: K8I2mpRME07ZlOsT2x75Lg ($5.95 in chips) 
Seat 4: f/e5w8nN3RjdX9H1eRlDdA ($0.80 in chips) 
Seat 5: UlMB386Cfzy3EwurQoBjcA ($10.95 in chips) 
Seat 6: SRik8xyC/rVIBoX7VaOoMA ($13.90 in chips) 
Seat 7: B9u+i1s5aZZkmLTLUopTBg ($14.75 in chips) 
Seat 8: Qv4VzEkN09uD11sjKv02Ig ($17.95 in chips) 
Seat 9: +sbyWwIcFp9kP0bDtMegfQ ($42.65 in chips) 
B9u+i1s5aZZkmLTLUopTBg: posts small blind $0.10
Qv4VzEkN09uD11sjKv02Ig: posts big blind $0.25
yqkowiRWZ6NvRN9UUkYIlA: sits out 
8EbrQ/EvFWt2cr0GaU82gQ: sits out 
*** HOLE CARDS ***
+sbyWwIcFp9kP0bDtMegfQ: folds 
K8I2mpRME07ZlOsT2x75Lg: folds 
f/e5w8nN3RjdX9H1eRlDdA: raises $0.55 to $0.80 and is all-in
UlMB386Cfzy3EwurQoBjcA: folds 
SRik8xyC/rVIBoX7VaOoMA: folds 
B9u+i1s5aZZkmLTLUopTBg: folds 
Qv4VzEkN09uD11sjKv02Ig: calls $0.55
*** FLOP *** [9s Qd Kd]
*** TURN *** [9s Qd Kd] [2d]
*** RIVER *** [9s Qd Kd 2d] [3c]
*** SHOW DOWN ***
Qv4VzEkN09uD11sjKv02Ig: shows [8c 8s] (a pair of Eights)
f/e5w8nN3RjdX9H1eRlDdA: mucks hand 
Qv4VzEkN09uD11sjKv02Ig collected $1.65 from pot
*** SUMMARY ***
Total pot $1.70 | Rake $0.05 
Board [9s Qd Kd 2d 3c]
Seat 1: K8I2mpRME07ZlOsT2x75Lg folded before Flop (didn't bet)
Seat 4: f/e5w8nN3RjdX9H1eRlDdA mucked
Seat 5: UlMB386Cfzy3EwurQoBjcA folded before Flop (didn't bet)
Seat 6: SRik8xyC/rVIBoX7VaOoMA (button) folded before Flop (didn't bet)
Seat 7: B9u+i1s5aZZkmLTLUopTBg (small blind) folded before Flop
Seat 8: Qv4VzEkN09uD11sjKv02Ig (big blind) showed [8c 8s] and won ($1.65) with a pair of Eights
Seat 9: +sbyWwIcFp9kP0bDtMegfQ folded before Flop (didn't bet)




PokerStars Game #59941734218:  Hold'em No Limit ($0.10/$0.25) - 2009/07/01 1:44:28 ET
Table 'O5NgMYt6EWbLBozZb3kseg' 6-max Seat #1 is the button
Seat 1: MCCWc70bl051s/EF6nHRcA ($31.90 in chips) 
Seat 2: /gJNBeCkWL4o85/jvlZ4BA ($34.25 in chips) 
Seat 6: k9vn40MOqqb+xF+7GZ6v2g ($122.20 in chips) 
/gJNBeCkWL4o85/jvlZ4BA: posts small blind $0.10
vu2kzHaDtgr6NM7rdq0chA: is sitting out 
k9vn40MOqqb+xF+7GZ6v2g: posts big blind $0.25
*** HOLE CARDS ***
tLM9aw7T3kBEIhQEh1roOg said, "of course"
vu2kzHaDtgr6NM7rdq0chA leaves the table
MCCWc70bl051s/EF6nHRcA: folds 
MCCWc70bl051s/EF6nHRcA is sitting out
MCCWc70bl051s/EF6nHRcA leaves the table
/gJNBeCkWL4o85/jvlZ4BA: calls $0.15
tLM9aw7T3kBEIhQEh1roOg leaves the table
k9vn40MOqqb+xF+7GZ6v2g: checks 
*** FLOP *** [5d Qh 5c]
/gJNBeCkWL4o85/jvlZ4BA: bets $1.25
k9vn40MOqqb+xF+7GZ6v2g: calls $1.25
*** TURN *** [5d Qh 5c] [5h]
/gJNBeCkWL4o85/jvlZ4BA: bets $2.75
grly528 joins the table at seat #3 
k9vn40MOqqb+xF+7GZ6v2g: calls $2.75
*** RIVER *** [5d Qh 5c 5h] [7c]
/gJNBeCkWL4o85/jvlZ4BA: checks 
k9vn40MOqqb+xF+7GZ6v2g: bets $50.75
TKerouac joins the table at seat #4 
/gJNBeCkWL4o85/jvlZ4BA said, "lol"
/gJNBeCkWL4o85/jvlZ4BA: folds 
Uncalled bet ($50.75) returned to k9vn40MOqqb+xF+7GZ6v2g
/gJNBeCkWL4o85/jvlZ4BA is sitting out
/gJNBeCkWL4o85/jvlZ4BA has returned
k9vn40MOqqb+xF+7GZ6v2g collected $8.10 from pot
k9vn40MOqqb+xF+7GZ6v2g is sitting out
*** SUMMARY ***
Total pot $8.50 | Rake $0.40 
Board [5d Qh 5c 5h 7c]
Seat 1: MCCWc70bl051s/EF6nHRcA (button) folded before Flop (didn't bet)
Seat 2: /gJNBeCkWL4o85/jvlZ4BA (small blind) folded on the River
Seat 6: k9vn40MOqqb+xF+7GZ6v2g (big blind) collected ($8.10)




PokerStars Game #59941735174:  Hold'em No Limit ($0.10/$0.25) - 2009/07/01 1:44:29 ET
Table '+2VxGVfkEqJ1AYfQy/JH2w' 6-max Seat #1 is the button
Seat 1: if4dh6jhJXeN3/qd3qCp9g ($25.35 in chips) 
Seat 2: qllppsCmUqovlriIWCeM/g ($5.90 in chips) 
Seat 3: epAUIB7h2FJXzUPRIvSkRA ($25 in chips) 
Seat 4: y+a/yGW/Jy4bPJFnaeTz5w ($16.60 in chips) 
Seat 5: XD1i5m5PvBDnRzJaG/vINw ($22.35 in chips) 
Seat 6: L3/N/gliETan8N5Gim5h4Q ($25 in chips) 
qllppsCmUqovlriIWCeM/g: posts small blind $0.10
epAUIB7h2FJXzUPRIvSkRA: posts big blind $0.25
*** HOLE CARDS ***
y+a/yGW/Jy4bPJFnaeTz5w: folds 
XD1i5m5PvBDnRzJaG/vINw: raises $0.50 to $0.75
L3/N/gliETan8N5Gim5h4Q: folds 
if4dh6jhJXeN3/qd3qCp9g: calls $0.75
qllppsCmUqovlriIWCeM/g: calls $0.65
epAUIB7h2FJXzUPRIvSkRA: folds 
*** FLOP *** [Qh Ad Jh]
qllppsCmUqovlriIWCeM/g: checks 
XD1i5m5PvBDnRzJaG/vINw: bets $1
if4dh6jhJXeN3/qd3qCp9g: calls $1
qllppsCmUqovlriIWCeM/g: folds 
*** TURN *** [Qh Ad Jh] [6s]
XD1i5m5PvBDnRzJaG/vINw: checks 
if4dh6jhJXeN3/qd3qCp9g: checks 
*** RIVER *** [Qh Ad Jh 6s] [9s]
XD1i5m5PvBDnRzJaG/vINw: checks 
if4dh6jhJXeN3/qd3qCp9g: checks 
*** SHOW DOWN ***
XD1i5m5PvBDnRzJaG/vINw: shows [3d Kd] (high card Ace)
if4dh6jhJXeN3/qd3qCp9g: shows [As 8s] (a pair of Aces)
if4dh6jhJXeN3/qd3qCp9g collected $4.30 from pot
*** SUMMARY ***
Total pot $4.50 | Rake $0.20 
Board [Qh Ad Jh 6s 9s]
Seat 1: if4dh6jhJXeN3/qd3qCp9g (button) showed [As 8s] and won ($4.30) with a pair of Aces
Seat 2: qllppsCmUqovlriIWCeM/g (small blind) folded on the Flop
Seat 3: epAUIB7h2FJXzUPRIvSkRA (big blind) folded before Flop
Seat 4: y+a/yGW/Jy4bPJFnaeTz5w folded before Flop (didn't bet)
Seat 5: XD1i5m5PvBDnRzJaG/vINw showed [3d Kd] and lost with high card Ace
Seat 6: L3/N/gliETan8N5Gim5h4Q folded before Flop (didn't bet)




PokerStars Game #59941735022:  Hold'em No Limit ($0.10/$0.25) - 2009/07/01 1:44:29 ET
Table '5VWnrlxdjwVfMWkVS2WE7A' 6-max Seat #5 is the button
Seat 1: 82p+w3EmUaFFHuwpSeGY1w ($14.15 in chips) 
Seat 2: LJI7A1YgDM7hgh7o56+ReQ ($26 in chips) 
Seat 3: SFmT9ZsVopnukjvAzrxTRg ($39.15 in chips) 
Seat 4: Pb/gJ3OxOZx57fFp0MDgkg ($35.35 in chips) 
Seat 5: SgMFmwYtNvq9Y+2ZxPSiWQ ($16.10 in chips) 
Seat 6: LtASJ9OlkqGrrUKGQlpGAw ($5.35 in chips) 
LtASJ9OlkqGrrUKGQlpGAw: posts small blind $0.10
82p+w3EmUaFFHuwpSeGY1w: posts big blind $0.25
*** HOLE CARDS ***
LJI7A1YgDM7hgh7o56+ReQ: folds 
SFmT9ZsVopnukjvAzrxTRg: folds 
Pb/gJ3OxOZx57fFp0MDgkg: folds 
SgMFmwYtNvq9Y+2ZxPSiWQ: folds 
LtASJ9OlkqGrrUKGQlpGAw: folds 
Uncalled bet ($0.15) returned to 82p+w3EmUaFFHuwpSeGY1w
82p+w3EmUaFFHuwpSeGY1w collected $0.20 from pot
82p+w3EmUaFFHuwpSeGY1w: doesn't show hand 
*** SUMMARY ***
Total pot $0.20 | Rake $0 
Seat 1: 82p+w3EmUaFFHuwpSeGY1w (big blind) collected ($0.20)
Seat 2: LJI7A1YgDM7hgh7o56+ReQ folded before Flop (didn't bet)
Seat 3: SFmT9ZsVopnukjvAzrxTRg folded before Flop (didn't bet)
Seat 4: Pb/gJ3OxOZx57fFp0MDgkg folded before Flop (didn't bet)
Seat 5: SgMFmwYtNvq9Y+2ZxPSiWQ (button) folded before Flop (didn't bet)
Seat 6: LtASJ9OlkqGrrUKGQlpGAw (small blind) folded before Flop




PokerStars Game #59941734784:  Hold'em No Limit ($0.10/$0.25) - 2009/07/01 1:44:29 ET
Table '6wawJ+MkkvuC3coG6r+YhgZiwAqg4o02gNro+JOAaFNgSeat #8 is the button
Seat 1: 6RiVTYll/5D8zICp0MRpKw ($38.20 in chips) 
Seat 2: tYsOBqdU1+x+yFI7zHO7hQ ($31.40 in chips) 
Seat 3: aNpwfA31EREwO+ar4XzBCw ($29 in chips) 
Seat 5: 6HoFYfVGBefsR5Vrz62qIw5hAPbqNrvJb8PtLiceXtlg0.10 in chips) 
Seat 6: 5n7e7I+px7c6CQmLpPbtsg ($5 in chips) 
Seat 7: yyG4svzOpC1A+sUP/scg6w ($7.95 in chips) 
Seat 8: VLIsy+xjx3olLSYO3JLS6g ($8.35 in chips) 
Seat 9: ljemhp25Zg+nlA9DLCIiUw ($25 in chips) 
ljemhp25Zg+nlA9DLCIiUw: posts small blind $0.10
6RiVTYll/5D8zICp0MRpKw: posts big blind $0.25
RHqgdFvufLCYe54+qd2gcA: sits out 
*** HOLE CARDS ***
tYsOBqdU1+x+yFI7zHO7hQ: folds 
aNpwfA31EREwO+ar4XzBCw: folds 
6HoFYfVGBefsR5Vrz62qIw5hAPbqNrvJb8PtLiceXtlgises $0.25 to $0.50
5n7e7I+px7c6CQmLpPbtsg: folds 
yyG4svzOpC1A+sUP/scg6w: calls $0.50
VLIsy+xjx3olLSYO3JLS6g: folds 
ljemhp25Zg+nlA9DLCIiUw: folds 
6RiVTYll/5D8zICp0MRpKw: calls $0.25
*** FLOP *** [Qd 6s Th]
6RiVTYll/5D8zICp0MRpKw: checks 
6HoFYfVGBefsR5Vrz62qIw5hAPbqNrvJb8PtLiceXtlgts $1
yyG4svzOpC1A+sUP/scg6w: folds 
6RiVTYll/5D8zICp0MRpKw: calls $1
*** TURN *** [Qd 6s Th] [Kc]
6RiVTYll/5D8zICp0MRpKw: checks 
6HoFYfVGBefsR5Vrz62qIw5hAPbqNrvJb8PtLiceXtlgts $2
6RiVTYll/5D8zICp0MRpKw: raises $2.75 to $4.75
6HoFYfVGBefsR5Vrz62qIw5hAPbqNrvJb8PtLiceXtlglls $2.75
*** RIVER *** [Qd 6s Th Kc] [Jc]
6RiVTYll/5D8zICp0MRpKw: checks 
6HoFYfVGBefsR5Vrz62qIw5hAPbqNrvJb8PtLiceXtlgts $2
6RiVTYll/5D8zICp0MRpKw: calls $2
*** SHOW DOWN ***
6HoFYfVGBefsR5Vrz62qIw5hAPbqNrvJb8PtLiceXtlgows [As Kh] (a straight, Ten to Ace)
6RiVTYll/5D8zICp0MRpKw: mucks hand 
6HoFYfVGBefsR5Vrz62qIw5hAPbqNrvJb8PtLiceXtlglected $16.30 from pot
*** SUMMARY ***
Total pot $17.10 | Rake $0.80 
Board [Qd 6s Th Kc Jc]
Seat 1: 6RiVTYll/5D8zICp0MRpKw (big blind) mucked
Seat 2: tYsOBqdU1+x+yFI7zHO7hQ folded before Flop (didn't bet)
Seat 3: aNpwfA31EREwO+ar4XzBCw folded before Flop (didn't bet)
Seat 5: 6HoFYfVGBefsR5Vrz62qIw5hAPbqNrvJb8PtLiceXtlgwed [As Kh] and won ($16.30) with a straight, Ten to Ace
Seat 6: 5n7e7I+px7c6CQmLpPbtsg folded before Flop (didn't bet)
Seat 7: yyG4svzOpC1A+sUP/scg6w folded on the Flop
Seat 8: VLIsy+xjx3olLSYO3JLS6g (button) folded before Flop (didn't bet)
Seat 9: ljemhp25Zg+nlA9DLCIiUw (small blind) folded before Flop




PokerStars Game #59941735118:  Hold'em No Limit ($0.10/$0.25) - 2009/07/01 1:44:29 ET
Table 'GgmUtmhrYPRnhkqEEjD/Kw' 9-max Seat #4 is the button
Seat 2: ghNKXUBl/H+t83JF079ZBA ($25.15 in chips) 
Seat 3: dYvYZ723QlKIPiDa0pkedQ ($8.25 in chips) 
Seat 4: dfNim92Z6XK1/h5SFW5vDg ($25 in chips) 
Seat 5: ljemhp25Zg+nlA9DLCIiUw ($26.75 in chips) 
Seat 6: 4Ax0vobe1rLVIGZmkFINGA ($20.25 in chips) 
Seat 7: YwDw9cMqkbMznFK77rru4A ($5.15 in chips) 
Seat 8: DdPXdieucQ+n99u1n3A+rQ ($4.65 in chips) 
Seat 9: V6p0jQ/RhUsqpHLmXvEX4Q ($13.95 in chips) 
ljemhp25Zg+nlA9DLCIiUw: posts small blind $0.10
4Ax0vobe1rLVIGZmkFINGA: posts big blind $0.25
bXpVeaSTPBFSPJmeXxO7nw: sits out 
*** HOLE CARDS ***
YwDw9cMqkbMznFK77rru4A: calls $0.25
DdPXdieucQ+n99u1n3A+rQ: folds 
V6p0jQ/RhUsqpHLmXvEX4Q: folds 
ghNKXUBl/H+t83JF079ZBA: folds 
dYvYZ723QlKIPiDa0pkedQ: folds 
dfNim92Z6XK1/h5SFW5vDg: folds 
ljemhp25Zg+nlA9DLCIiUw: calls $0.15
4Ax0vobe1rLVIGZmkFINGA: checks 
*** FLOP *** [7s Ad 4h]
ljemhp25Zg+nlA9DLCIiUw: checks 
4Ax0vobe1rLVIGZmkFINGA: checks 
YwDw9cMqkbMznFK77rru4A: checks 
*** TURN *** [7s Ad 4h] [5c]
ljemhp25Zg+nlA9DLCIiUw: checks 
4Ax0vobe1rLVIGZmkFINGA: checks 
YwDw9cMqkbMznFK77rru4A: checks 
*** RIVER *** [7s Ad 4h 5c] [3s]
ljemhp25Zg+nlA9DLCIiUw: checks 
4Ax0vobe1rLVIGZmkFINGA: bets $0.50
YwDw9cMqkbMznFK77rru4A: folds 
ljemhp25Zg+nlA9DLCIiUw: folds 
Uncalled bet ($0.50) returned to 4Ax0vobe1rLVIGZmkFINGA
4Ax0vobe1rLVIGZmkFINGA collected $0.75 from pot
4Ax0vobe1rLVIGZmkFINGA: doesn't show hand 
*** SUMMARY ***
Total pot $0.75 | Rake $0 
Board [7s Ad 4h 5c 3s]
Seat 2: ghNKXUBl/H+t83JF079ZBA folded before Flop (didn't bet)
Seat 3: dYvYZ723QlKIPiDa0pkedQ folded before Flop (didn't bet)
Seat 4: dfNim92Z6XK1/h5SFW5vDg (button) folded before Flop (didn't bet)
Seat 5: ljemhp25Zg+nlA9DLCIiUw (small blind) folded on the River
Seat 6: 4Ax0vobe1rLVIGZmkFINGA (big blind) collected ($0.75)
Seat 7: YwDw9cMqkbMznFK77rru4A folded on the River
Seat 8: DdPXdieucQ+n99u1n3A+rQ folded before Flop (didn't bet)
Seat 9: V6p0jQ/RhUsqpHLmXvEX4Q folded before Flop (didn't bet)




PokerStars Game #59941735114:  Hold'em No Limit ($0.10/$0.25) - 2009/07/01 1:44:29 ET
Table '1HT8bEDpLPhOXxmqMtzF8w' 9-max Seat #6 is the button
Seat 1: YkkKQUDI0iWatY4h0WWaAQ ($12.90 in chips) 
Seat 2: r6hsffOo1iKmaPYKwAZmFw ($29 in chips) 
Seat 3: oLa/tXLfSLLB28mcLGrxcg ($24.75 in chips) 
Seat 4: aNpwfA31EREwO+ar4XzBCw ($25 in chips) 
Seat 5: CT2YIt3dXaE9eOIkS7FwNw ($22.55 in chips) 
Seat 6: bXpVeaSTPBFSPJmeXxO7nw ($5.25 in chips) 
Seat 7: PMhmqYBPHOAXjH25lRz69g ($18.05 in chips) 
Seat 8: ghNKXUBl/H+t83JF079ZBA ($32.10 in chips) 
PMhmqYBPHOAXjH25lRz69g: posts small blind $0.10
ghNKXUBl/H+t83JF079ZBA: posts big blind $0.25
Z9W7+g1WMhhZDi7DwGbCFA: sits out 
*** HOLE CARDS ***
YkkKQUDI0iWatY4h0WWaAQ: folds 
r6hsffOo1iKmaPYKwAZmFw: folds 
oLa/tXLfSLLB28mcLGrxcg: folds 
aNpwfA31EREwO+ar4XzBCw: folds 
CT2YIt3dXaE9eOIkS7FwNw: folds 
bXpVeaSTPBFSPJmeXxO7nw: folds 
PMhmqYBPHOAXjH25lRz69g: calls $0.15
ghNKXUBl/H+t83JF079ZBA: checks 
*** FLOP *** [6s Kc Ts]
PMhmqYBPHOAXjH25lRz69g: checks 
ghNKXUBl/H+t83JF079ZBA: bets $0.25
PMhmqYBPHOAXjH25lRz69g: calls $0.25
*** TURN *** [6s Kc Ts] [3d]
PMhmqYBPHOAXjH25lRz69g: checks 
ghNKXUBl/H+t83JF079ZBA: bets $0.75
PMhmqYBPHOAXjH25lRz69g: calls $0.75
*** RIVER *** [6s Kc Ts 3d] [2h]
PMhmqYBPHOAXjH25lRz69g: checks 
ghNKXUBl/H+t83JF079ZBA: bets $30.85 and is all-in
PMhmqYBPHOAXjH25lRz69g: folds 
Uncalled bet ($30.85) returned to ghNKXUBl/H+t83JF079ZBA
ghNKXUBl/H+t83JF079ZBA collected $2.40 from pot
ghNKXUBl/H+t83JF079ZBA: doesn't show hand 
*** SUMMARY ***
Total pot $2.50 | Rake $0.10 
Board [6s Kc Ts 3d 2h]
Seat 1: YkkKQUDI0iWatY4h0WWaAQ folded before Flop (didn't bet)
Seat 2: r6hsffOo1iKmaPYKwAZmFw folded before Flop (didn't bet)
Seat 3: oLa/tXLfSLLB28mcLGrxcg folded before Flop (didn't bet)
Seat 4: aNpwfA31EREwO+ar4XzBCw folded before Flop (didn't bet)
Seat 5: CT2YIt3dXaE9eOIkS7FwNw folded before Flop (didn't bet)
Seat 6: bXpVeaSTPBFSPJmeXxO7nw (button) folded before Flop (didn't bet)
Seat 7: PMhmqYBPHOAXjH25lRz69g (small blind) folded on the River
Seat 8: ghNKXUBl/H+t83JF079ZBA (big blind) collected ($2.40)




PokerStars Game #59941735050:  Hold'em No Limit ($0.10/$0.25) - 2009/07/01 1:44:29 ET
Table 'i93c3z9RLowvuJTKA2F4Jg' 6-max Seat #4 is the button
Seat 1: tbSZq5LHglyHk61mH9eDBw ($29.25 in chips) 
Seat 2: TSmua8tGK3sTbwi0ynrW9Q ($29.05 in chips) 
Seat 3: v8m8XHovI5tqEA9mvplDSw ($31.30 in chips) 
Seat 4: o86X2Q5GEDU3uP9oj1iFZA ($30.30 in chips) 
Seat 6: FpN4KbLjlyRRKiVaQcoLqA ($18.75 in chips) 
TI/C5Q+DEl4fLR3AofwYdg will be allowed to play after the button
FpN4KbLjlyRRKiVaQcoLqA: posts small blind $0.10
tbSZq5LHglyHk61mH9eDBw: posts big blind $0.25
*** HOLE CARDS ***
TSmua8tGK3sTbwi0ynrW9Q: folds 
v8m8XHovI5tqEA9mvplDSw: folds 
o86X2Q5GEDU3uP9oj1iFZA: calls $0.25
FpN4KbLjlyRRKiVaQcoLqA: calls $0.15
tbSZq5LHglyHk61mH9eDBw: checks 
*** FLOP *** [6d 7d 2c]
FpN4KbLjlyRRKiVaQcoLqA: checks 
tbSZq5LHglyHk61mH9eDBw: bets $0.25
o86X2Q5GEDU3uP9oj1iFZA: calls $0.25
FpN4KbLjlyRRKiVaQcoLqA: calls $0.25
*** TURN *** [6d 7d 2c] [4d]
FpN4KbLjlyRRKiVaQcoLqA: checks 
tbSZq5LHglyHk61mH9eDBw: checks 
o86X2Q5GEDU3uP9oj1iFZA: checks 
*** RIVER *** [6d 7d 2c 4d] [Js]
FpN4KbLjlyRRKiVaQcoLqA: checks 
tbSZq5LHglyHk61mH9eDBw: bets $1
o86X2Q5GEDU3uP9oj1iFZA: folds 
FpN4KbLjlyRRKiVaQcoLqA: folds 
Uncalled bet ($1) returned to tbSZq5LHglyHk61mH9eDBw
tbSZq5LHglyHk61mH9eDBw collected $1.45 from pot
*** SUMMARY ***
Total pot $1.50 | Rake $0.05 
Board [6d 7d 2c 4d Js]
Seat 1: tbSZq5LHglyHk61mH9eDBw (big blind) collected ($1.45)
Seat 2: TSmua8tGK3sTbwi0ynrW9Q folded before Flop (didn't bet)
Seat 3: v8m8XHovI5tqEA9mvplDSw folded before Flop (didn't bet)
Seat 4: o86X2Q5GEDU3uP9oj1iFZA (button) folded on the River
Seat 6: FpN4KbLjlyRRKiVaQcoLqA (small blind) folded on the River




PokerStars Game #59941735744:  Hold'em No Limit ($0.10/$0.25) - 2009/07/01 1:44:30 ET
Table 'edvgY2YQ1I34euq4EVqGnA' 6-max Seat #5 is the button
Seat 1: mvFHK3pE7tCxJEqLjKC70Q ($25.25 in chips) 
Seat 3: mFv3iBCtrw9XfCDRB0d46Q ($3.55 in chips) 
Seat 4: TI/C5Q+DEl4fLR3AofwYdg ($22.15 in chips) 
Seat 5: EE16Ua5b1HSsYej5zeXOlA ($55.80 in chips) 
Seat 6: kG34n23qFQA3nzdOJTQ1dA ($72.10 in chips) 
kG34n23qFQA3nzdOJTQ1dA: posts small blind $0.10
mvFHK3pE7tCxJEqLjKC70Q: posts big blind $0.25
*** HOLE CARDS ***
mFv3iBCtrw9XfCDRB0d46Q: folds 
TI/C5Q+DEl4fLR3AofwYdg: folds 
EE16Ua5b1HSsYej5zeXOlA: raises $0.50 to $0.75
kG34n23qFQA3nzdOJTQ1dA: calls $0.65
mvFHK3pE7tCxJEqLjKC70Q: folds 
*** FLOP *** [2d Ac 6h]
kG34n23qFQA3nzdOJTQ1dA: checks 
Hsvkc0/G2VV78oVmWYXecw joins the table at seat #2 
EE16Ua5b1HSsYej5zeXOlA: bets $1.20
kG34n23qFQA3nzdOJTQ1dA: folds 
Uncalled bet ($1.20) returned to EE16Ua5b1HSsYej5zeXOlA
EE16Ua5b1HSsYej5zeXOlA collected $1.70 from pot
EE16Ua5b1HSsYej5zeXOlA: doesn't show hand 
*** SUMMARY ***
Total pot $1.75 | Rake $0.05 
Board [2d Ac 6h]
Seat 1: mvFHK3pE7tCxJEqLjKC70Q (big blind) folded before Flop
Seat 3: mFv3iBCtrw9XfCDRB0d46Q folded before Flop (didn't bet)
Seat 4: TI/C5Q+DEl4fLR3AofwYdg folded before Flop (didn't bet)
Seat 5: EE16Ua5b1HSsYej5zeXOlA (button) collected ($1.70)
Seat 6: kG34n23qFQA3nzdOJTQ1dA (small blind) folded on the Flop




PokerStars Game #59941735384:  Hold'em No Limit ($0.10/$0.25) - 2009/07/01 1:44:30 ET
Table '2clPgY3+dETPD/8zjXZdFw' 6-max Seat #5 is the button
Seat 1: 4WFKzsjLSGnvHbVxKabsvQ ($30.80 in chips) 
Seat 2: cWc85bEzdRzpUMhRKm8pwQ ($25.45 in chips) 
Seat 3: SFmT9ZsVopnukjvAzrxTRg ($25 in chips) 
Seat 4: ljjhtb6FVPTx9AT9HNdtqg ($22 in chips) 
Seat 5: LJI7A1YgDM7hgh7o56+ReQ ($29.90 in chips) 
4WFKzsjLSGnvHbVxKabsvQ: posts small blind $0.10
cWc85bEzdRzpUMhRKm8pwQ: posts big blind $0.25
*** HOLE CARDS ***
SFmT9ZsVopnukjvAzrxTRg: folds 
ljjhtb6FVPTx9AT9HNdtqg: folds 
LJI7A1YgDM7hgh7o56+ReQ: folds 
4WFKzsjLSGnvHbVxKabsvQ: folds 
Uncalled bet ($0.15) returned to cWc85bEzdRzpUMhRKm8pwQ
cWc85bEzdRzpUMhRKm8pwQ collected $0.20 from pot
*** SUMMARY ***
Total pot $0.20 | Rake $0 
Seat 1: 4WFKzsjLSGnvHbVxKabsvQ (small blind) folded before Flop
Seat 2: cWc85bEzdRzpUMhRKm8pwQ (big blind) collected ($0.20)
Seat 3: SFmT9ZsVopnukjvAzrxTRg folded before Flop (didn't bet)
Seat 4: ljjhtb6FVPTx9AT9HNdtqg folded before Flop (didn't bet)
Seat 5: LJI7A1YgDM7hgh7o56+ReQ (button) folded before Flop (didn't bet)




PokerStars Game #59941735508:  Hold'em No Limit ($0.10/$0.25) - 2009/07/01 1:44:30 ET
Table 'sCop8wmj9zlSS2KJqk1QKQ' 9-max Seat #6 is the button
Seat 1: dtZ84flFEi4Q+SGrHMJRDQ ($40.85 in chips) 
Seat 2: YZaC69gFrepA6oCGtu7E0w ($39.35 in chips) 
Seat 3: M/9j4wkHH9i1JM51vgi1VA ($25 in chips) 
Seat 4: msUzkZl2RntUnTl6E8WaNA ($10.55 in chips) 
Seat 5: RHqgdFvufLCYe54+qd2gcA ($8.95 in chips) 
Seat 6: hZuGwtYmFKPmQ+v1wlmdfA ($42.70 in chips) 
Seat 7: 1gbA06IVB5XVZNlkqj7zJw ($13.10 in chips) 
Seat 8: xnVwSkROfRtOw4eSoDANtw ($20.65 in chips) 
Seat 9: tLcDklc2rBORNfixyRfVfw ($25 in chips) 
1gbA06IVB5XVZNlkqj7zJw: posts small blind $0.10
xnVwSkROfRtOw4eSoDANtw: posts big blind $0.25
M/9j4wkHH9i1JM51vgi1VA: posts big blind $0.25
*** HOLE CARDS ***
tLcDklc2rBORNfixyRfVfw: folds 
dtZ84flFEi4Q+SGrHMJRDQ: folds 
YZaC69gFrepA6oCGtu7E0w: calls $0.25
M/9j4wkHH9i1JM51vgi1VA: checks 
msUzkZl2RntUnTl6E8WaNA: folds 
RHqgdFvufLCYe54+qd2gcA: folds 
hZuGwtYmFKPmQ+v1wlmdfA: folds 
1gbA06IVB5XVZNlkqj7zJw: calls $0.15
xnVwSkROfRtOw4eSoDANtw: checks 
*** FLOP *** [Kh 8s Js]
1gbA06IVB5XVZNlkqj7zJw: checks 
xnVwSkROfRtOw4eSoDANtw: checks 
YZaC69gFrepA6oCGtu7E0w: checks 
M/9j4wkHH9i1JM51vgi1VA: checks 
*** TURN *** [Kh 8s Js] [Ad]
1gbA06IVB5XVZNlkqj7zJw: checks 
xnVwSkROfRtOw4eSoDANtw: checks 
YZaC69gFrepA6oCGtu7E0w: bets $0.50
M/9j4wkHH9i1JM51vgi1VA: folds 
1gbA06IVB5XVZNlkqj7zJw: folds 
xnVwSkROfRtOw4eSoDANtw: folds 
Uncalled bet ($0.50) returned to YZaC69gFrepA6oCGtu7E0w
YZaC69gFrepA6oCGtu7E0w collected $0.95 from pot
*** SUMMARY ***
Total pot $1 | Rake $0.05 
Board [Kh 8s Js Ad]
Seat 1: dtZ84flFEi4Q+SGrHMJRDQ folded before Flop (didn't bet)
Seat 2: YZaC69gFrepA6oCGtu7E0w collected ($0.95)
Seat 3: M/9j4wkHH9i1JM51vgi1VA folded on the Turn
Seat 4: msUzkZl2RntUnTl6E8WaNA folded before Flop (didn't bet)
Seat 5: RHqgdFvufLCYe54+qd2gcA folded before Flop (didn't bet)
Seat 6: hZuGwtYmFKPmQ+v1wlmdfA (button) folded before Flop (didn't bet)
Seat 7: 1gbA06IVB5XVZNlkqj7zJw (small blind) folded on the Turn
Seat 8: xnVwSkROfRtOw4eSoDANtw (big blind) folded on the Turn
Seat 9: tLcDklc2rBORNfixyRfVfw folded before Flop (didn't bet)




PokerStars Game #59941735376:  Hold'em No Limit ($0.10/$0.25) - 2009/07/01 1:44:30 ET
Table '8QBBaev+cI2i/r2H6ml/lg' 9-max Seat #4 is the button
Seat 1: s2xLPOl/vhl/26apJ3vsOQ ($35.80 in chips) 
Seat 2: y7tkvDmwKjURBkr73SZPXw ($12.25 in chips) 
Seat 3: zgi+EUykT/pZQpoUG6+oEg ($4.30 in chips) 
Seat 4: ytpGB2nr/CLVHnyKMRiEFQ ($15.95 in chips) 
Seat 5: 0QdZrkFD7aGKeBXPGbIomA ($11.45 in chips) 
Seat 6: X6+pSIPfovPcE87t+LmUKQ ($4.75 in chips) 
Seat 7: eK8qa6EPcH2zhtbmWSvc9g ($31.05 in chips) 
Seat 8: vr1IK/Q4HXm8s8V0/dePzQ ($11.80 in chips) 
Seat 9: EUMLvzDkECHBit+xa+uGjg ($24.75 in chips) 
0QdZrkFD7aGKeBXPGbIomA: posts small blind $0.10
X6+pSIPfovPcE87t+LmUKQ: posts big blind $0.25
*** HOLE CARDS ***
eK8qa6EPcH2zhtbmWSvc9g: folds 
vr1IK/Q4HXm8s8V0/dePzQ: calls $0.25
EUMLvzDkECHBit+xa+uGjg: folds 
s2xLPOl/vhl/26apJ3vsOQ: folds 
y7tkvDmwKjURBkr73SZPXw: folds 
zgi+EUykT/pZQpoUG6+oEg: folds 
ytpGB2nr/CLVHnyKMRiEFQ: calls $0.25
0QdZrkFD7aGKeBXPGbIomA: folds 
X6+pSIPfovPcE87t+LmUKQ: checks 
*** FLOP *** [Th Ah Kc]
X6+pSIPfovPcE87t+LmUKQ: checks 
vr1IK/Q4HXm8s8V0/dePzQ: bets $0.50
ytpGB2nr/CLVHnyKMRiEFQ: calls $0.50
X6+pSIPfovPcE87t+LmUKQ: folds 
*** TURN *** [Th Ah Kc] [7s]
vr1IK/Q4HXm8s8V0/dePzQ: bets $1
ytpGB2nr/CLVHnyKMRiEFQ: calls $1
*** RIVER *** [Th Ah Kc 7s] [Tc]
vr1IK/Q4HXm8s8V0/dePzQ: bets $1
ytpGB2nr/CLVHnyKMRiEFQ: calls $1
*** SHOW DOWN ***
vr1IK/Q4HXm8s8V0/dePzQ: shows [9d Kh] (two pair, Kings and Tens)
ytpGB2nr/CLVHnyKMRiEFQ: shows [8c Ks] (two pair, Kings and Tens)
vr1IK/Q4HXm8s8V0/dePzQ collected $2.80 from pot
ytpGB2nr/CLVHnyKMRiEFQ collected $2.80 from pot
*** SUMMARY ***
Total pot $5.85 | Rake $0.25 
Board [Th Ah Kc 7s Tc]
Seat 1: s2xLPOl/vhl/26apJ3vsOQ folded before Flop (didn't bet)
Seat 2: y7tkvDmwKjURBkr73SZPXw folded before Flop (didn't bet)
Seat 3: zgi+EUykT/pZQpoUG6+oEg folded before Flop (didn't bet)
Seat 4: ytpGB2nr/CLVHnyKMRiEFQ (button) showed [8c Ks] and won ($2.80) with two pair, Kings and Tens
Seat 5: 0QdZrkFD7aGKeBXPGbIomA (small blind) folded before Flop
Seat 6: X6+pSIPfovPcE87t+LmUKQ (big blind) folded on the Flop
Seat 7: eK8qa6EPcH2zhtbmWSvc9g folded before Flop (didn't bet)
Seat 8: vr1IK/Q4HXm8s8V0/dePzQ showed [9d Kh] and won ($2.80) with two pair, Kings and Tens
Seat 9: EUMLvzDkECHBit+xa+uGjg folded before Flop (didn't bet)




PokerStars Game #59941735532:  Hold'em No Limit ($0.10/$0.25) - 2009/07/01 1:44:30 ET
Table 'nc6OeGk/wtaWV+6N+kgnZQ' 6-max Seat #3 is the button
Seat 1: tSR4329m40dZsN7YOpI9Kw ($40.25 in chips) 
Seat 2: 8ClCHtFXGNplITm+63KB+Q ($34.75 in chips) 
Seat 3: y8wpMWGSX2zHZijurx21mg ($5.60 in chips) 
Seat 4: 3zD3qLXT1bEffAoWGnc7wg ($29.70 in chips) 
Seat 5: HCS0lMAAPmZE2Tl8J/SuKw ($11.20 in chips) 
Seat 6: mFv3iBCtrw9XfCDRB0d46Q ($3.55 in chips) 
3zD3qLXT1bEffAoWGnc7wg: posts small blind $0.10
HCS0lMAAPmZE2Tl8J/SuKw: posts big blind $0.25
*** HOLE CARDS ***
mFv3iBCtrw9XfCDRB0d46Q: folds 
tSR4329m40dZsN7YOpI9Kw: raises $0.50 to $0.75
8ClCHtFXGNplITm+63KB+Q: folds 
y8wpMWGSX2zHZijurx21mg: raises $0.50 to $1.25
3zD3qLXT1bEffAoWGnc7wg: folds 
HCS0lMAAPmZE2Tl8J/SuKw: folds 
tSR4329m40dZsN7YOpI9Kw: calls $0.50
*** FLOP *** [2c 8c 4h]
tSR4329m40dZsN7YOpI9Kw: checks 
y8wpMWGSX2zHZijurx21mg: bets $1
tSR4329m40dZsN7YOpI9Kw: folds 
Uncalled bet ($1) returned to y8wpMWGSX2zHZijurx21mg
y8wpMWGSX2zHZijurx21mg collected $2.75 from pot
y8wpMWGSX2zHZijurx21mg: doesn't show hand 
*** SUMMARY ***
Total pot $2.85 | Rake $0.10 
Board [2c 8c 4h]
Seat 1: tSR4329m40dZsN7YOpI9Kw folded on the Flop
Seat 2: 8ClCHtFXGNplITm+63KB+Q folded before Flop (didn't bet)
Seat 3: y8wpMWGSX2zHZijurx21mg (button) collected ($2.75)
Seat 4: 3zD3qLXT1bEffAoWGnc7wg (small blind) folded before Flop
Seat 5: HCS0lMAAPmZE2Tl8J/SuKw (big blind) folded before Flop
Seat 6: mFv3iBCtrw9XfCDRB0d46Q folded before Flop (didn't bet)




PokerStars Game #59941735368:  Hold'em No Limit ($0.10/$0.25) - 2009/07/01 1:44:30 ET
Table 'SHi8+hK6i7E2dJ/3Agbyig' 6-max Seat #1 is the button
Seat 1: gPEN9Zp33YTm/mu9/SYP1w ($24.65 in chips) 
Seat 2: LJI7A1YgDM7hgh7o56+ReQ ($28.55 in chips) 
Seat 3: P1Z7LWu+VU+WmJsI4mr0wA ($24 in chips) 
Seat 4: u0ikXOhAPSCLmg+l17oGRw ($10.15 in chips) 
Seat 5: v8m8XHovI5tqEA9mvplDSw ($53.45 in chips) 
Seat 6: cWc85bEzdRzpUMhRKm8pwQ ($32.30 in chips) 
LJI7A1YgDM7hgh7o56+ReQ: posts small blind $0.10
P1Z7LWu+VU+WmJsI4mr0wA: posts big blind $0.25
*** HOLE CARDS ***
u0ikXOhAPSCLmg+l17oGRw: calls $0.25
v8m8XHovI5tqEA9mvplDSw: folds 
cWc85bEzdRzpUMhRKm8pwQ: folds 
gPEN9Zp33YTm/mu9/SYP1w: folds 
LJI7A1YgDM7hgh7o56+ReQ: folds 
P1Z7LWu+VU+WmJsI4mr0wA: checks 
*** FLOP *** [6d 9d 2c]
P1Z7LWu+VU+WmJsI4mr0wA: checks 
u0ikXOhAPSCLmg+l17oGRw: bets $0.25
P1Z7LWu+VU+WmJsI4mr0wA: folds 
Uncalled bet ($0.25) returned to u0ikXOhAPSCLmg+l17oGRw
u0ikXOhAPSCLmg+l17oGRw collected $0.60 from pot
*** SUMMARY ***
Total pot $0.60 | Rake $0 
Board [6d 9d 2c]
Seat 1: gPEN9Zp33YTm/mu9/SYP1w (button) folded before Flop (didn't bet)
Seat 2: LJI7A1YgDM7hgh7o56+ReQ (small blind) folded before Flop
Seat 3: P1Z7LWu+VU+WmJsI4mr0wA (big blind) folded on the Flop
Seat 4: u0ikXOhAPSCLmg+l17oGRw collected ($0.60)
Seat 5: v8m8XHovI5tqEA9mvplDSw folded before Flop (didn't bet)
Seat 6: cWc85bEzdRzpUMhRKm8pwQ folded before Flop (didn't bet)




PokerStars Game #59941735276:  Hold'em No Limit ($0.10/$0.25) - 2009/07/01 1:44:30 ET
Table 'ykyWGjhNu7AvZXov27T4ew' 9-max Seat #5 is the button
Seat 2: MG90wfSJZnOejs/KD3vlQQ ($39.60 in chips) 
Seat 4: W6tExOcYX7qiy6Qdp+ZwFA ($5.90 in chips) 
Seat 5: CmngQmkKTp8tkl6GMRTl6w ($8.50 in chips) 
Seat 6: AiXn/9o1EwOPZUHujnh/bA ($19.90 in chips) 
Seat 7: npAYqa85pqnzfOK5ukX+BQ ($21.65 in chips) 
Seat 8: tYsOBqdU1+x+yFI7zHO7hQ ($49.35 in chips) 
Seat 9: wk9M6R3w+aDHpr8WV87RmQ ($11.25 in chips) 
AiXn/9o1EwOPZUHujnh/bA: posts small blind $0.10
npAYqa85pqnzfOK5ukX+BQ: posts big blind $0.25
Team Rsf: sits out 
*** HOLE CARDS ***
tYsOBqdU1+x+yFI7zHO7hQ: folds 
wk9M6R3w+aDHpr8WV87RmQ: folds 
MG90wfSJZnOejs/KD3vlQQ: folds 
W6tExOcYX7qiy6Qdp+ZwFA: folds 
NPI9ArW8kwrb6a2IAL6xMQ has returned
CmngQmkKTp8tkl6GMRTl6w: folds 
AiXn/9o1EwOPZUHujnh/bA: calls $0.15
npAYqa85pqnzfOK5ukX+BQ: checks 
*** FLOP *** [6s 7h Ac]
AiXn/9o1EwOPZUHujnh/bA: checks 
npAYqa85pqnzfOK5ukX+BQ: checks 
*** TURN *** [6s 7h Ac] [5h]
AiXn/9o1EwOPZUHujnh/bA: checks 
npAYqa85pqnzfOK5ukX+BQ: checks 
*** RIVER *** [6s 7h Ac 5h] [Tc]
AiXn/9o1EwOPZUHujnh/bA: checks 
npAYqa85pqnzfOK5ukX+BQ: checks 
*** SHOW DOWN ***
AiXn/9o1EwOPZUHujnh/bA: shows [9h Td] (a pair of Tens)
npAYqa85pqnzfOK5ukX+BQ: mucks hand 
AiXn/9o1EwOPZUHujnh/bA collected $0.50 from pot
*** SUMMARY ***
Total pot $0.50 | Rake $0 
Board [6s 7h Ac 5h Tc]
Seat 2: MG90wfSJZnOejs/KD3vlQQ folded before Flop (didn't bet)
Seat 4: W6tExOcYX7qiy6Qdp+ZwFA folded before Flop (didn't bet)
Seat 5: CmngQmkKTp8tkl6GMRTl6w (button) folded before Flop (didn't bet)
Seat 6: AiXn/9o1EwOPZUHujnh/bA (small blind) showed [9h Td] and won ($0.50) with a pair of Tens
Seat 7: npAYqa85pqnzfOK5ukX+BQ (big blind) mucked
Seat 8: tYsOBqdU1+x+yFI7zHO7hQ folded before Flop (didn't bet)
Seat 9: wk9M6R3w+aDHpr8WV87RmQ folded before Flop (didn't bet)




PokerStars Game #59941736212:  Hold'em No Limit ($0.10/$0.25) - 2009/07/01 1:44:31 ET
Table 'Y9EhDWuqWWQFM9SelXAj5g' 9-max Seat #9 is the button
Seat 2: W+njF1UnarGN2q2zP+R+cg ($8.50 in chips) 
Seat 4: V6p0jQ/RhUsqpHLmXvEX4Q ($13.35 in chips) 
Seat 5: CvL9Ch1HYCVbTsfpNucitg ($5.45 in chips) 
Seat 6: egvg3mTBBVzMHnJPIQiKcA ($14 in chips) 
Seat 7: aNpwfA31EREwO+ar4XzBCw ($26.60 in chips) 
Seat 8: XDxyajtqmdag0QPvwcOG7Q ($11.10 in chips) 
Seat 9: bOrfviVhRBpaOfMqUc74Tw ($22.15 in chips) 
W+njF1UnarGN2q2zP+R+cg: posts small blind $0.10
V6p0jQ/RhUsqpHLmXvEX4Q: posts big blind $0.25
*** HOLE CARDS ***
mikeritr joins the table at seat #3 
CvL9Ch1HYCVbTsfpNucitg: raises $0.75 to $1
egvg3mTBBVzMHnJPIQiKcA: folds 
aNpwfA31EREwO+ar4XzBCw: folds 
XDxyajtqmdag0QPvwcOG7Q: folds 
bOrfviVhRBpaOfMqUc74Tw: calls $1
W+njF1UnarGN2q2zP+R+cg: folds 
V6p0jQ/RhUsqpHLmXvEX4Q: folds 
*** FLOP *** [3c 9d 5h]
CvL9Ch1HYCVbTsfpNucitg: bets $2.25
bOrfviVhRBpaOfMqUc74Tw: folds 
Uncalled bet ($2.25) returned to CvL9Ch1HYCVbTsfpNucitg
CvL9Ch1HYCVbTsfpNucitg collected $2.25 from pot
CvL9Ch1HYCVbTsfpNucitg: doesn't show hand 
*** SUMMARY ***
Total pot $2.35 | Rake $0.10 
Board [3c 9d 5h]
Seat 2: W+njF1UnarGN2q2zP+R+cg (small blind) folded before Flop
Seat 4: V6p0jQ/RhUsqpHLmXvEX4Q (big blind) folded before Flop
Seat 5: CvL9Ch1HYCVbTsfpNucitg collected ($2.25)
Seat 6: egvg3mTBBVzMHnJPIQiKcA folded before Flop (didn't bet)
Seat 7: aNpwfA31EREwO+ar4XzBCw folded before Flop (didn't bet)
Seat 8: XDxyajtqmdag0QPvwcOG7Q folded before Flop (didn't bet)
Seat 9: bOrfviVhRBpaOfMqUc74Tw (button) folded on the Flop




PokerStars Game #59941736010:  Hold'em No Limit ($0.10/$0.25) - 2009/07/01 1:44:31 ET
Table '63h13e5p7cWe02rClZ1CHw' 6-max Seat #2 is the button
Seat 1: pokjbbEcXXPlADXdSGHtZw ($18.40 in chips) 
Seat 2: k9nHZTHt8hYhYRcW8NTb4g ($30.15 in chips) 
Seat 3: mFv3iBCtrw9XfCDRB0d46Q ($4.75 in chips) 
Seat 4: xrf8tAXKQHG99HixCot1Iw ($23.70 in chips) 
Seat 5: iyZxqznXjv3vtvOJymkoLQ ($44.80 in chips) 
Seat 6: mfrkWA3PTeYPkbO6hi98Aw ($39.05 in chips) 
mFv3iBCtrw9XfCDRB0d46Q: posts small blind $0.10
xrf8tAXKQHG99HixCot1Iw: posts big blind $0.25
*** HOLE CARDS ***
iyZxqznXjv3vtvOJymkoLQ: folds 
mfrkWA3PTeYPkbO6hi98Aw: folds 
pokjbbEcXXPlADXdSGHtZw: raises $0.50 to $0.75
k9nHZTHt8hYhYRcW8NTb4g: folds 
mFv3iBCtrw9XfCDRB0d46Q: folds 
xrf8tAXKQHG99HixCot1Iw: folds 
Uncalled bet ($0.50) returned to pokjbbEcXXPlADXdSGHtZw
pokjbbEcXXPlADXdSGHtZw collected $0.60 from pot
*** SUMMARY ***
Total pot $0.60 | Rake $0 
Seat 1: pokjbbEcXXPlADXdSGHtZw collected ($0.60)
Seat 2: k9nHZTHt8hYhYRcW8NTb4g (button) folded before Flop (didn't bet)
Seat 3: mFv3iBCtrw9XfCDRB0d46Q (small blind) folded before Flop
Seat 4: xrf8tAXKQHG99HixCot1Iw (big blind) folded before Flop
Seat 5: iyZxqznXjv3vtvOJymkoLQ folded before Flop (didn't bet)
Seat 6: mfrkWA3PTeYPkbO6hi98Aw folded before Flop (didn't bet)




PokerStars Game #59941735972:  Hold'em No Limit ($0.10/$0.25) - 2009/07/01 1:44:31 ET
Table '5SUMWYuPsGiOD0FY0QbgOw' 6-max Seat #2 is the button
Seat 1: SFmT9ZsVopnukjvAzrxTRg ($25 in chips) 
Seat 2: xrf8tAXKQHG99HixCot1Iw ($37.15 in chips) 
Seat 3: MqMK8OWPSY1V4stf1Hy5Jw ($38.55 in chips) 
Seat 4: BV+K0Phf5VBHr7aZPKqbUQ ($25.35 in chips) 
Seat 5: v+QfkGiuj9bgtuNoVnDO8w ($40.40 in chips) 
Seat 6: jA7YMtfNUnAaebB7Lj74EA ($26.20 in chips) 
MqMK8OWPSY1V4stf1Hy5Jw: posts small blind $0.10
BV+K0Phf5VBHr7aZPKqbUQ: posts big blind $0.25
*** HOLE CARDS ***
v+QfkGiuj9bgtuNoVnDO8w: folds 
jA7YMtfNUnAaebB7Lj74EA: folds 
SFmT9ZsVopnukjvAzrxTRg: folds 
xrf8tAXKQHG99HixCot1Iw: raises $0.50 to $0.75
MqMK8OWPSY1V4stf1Hy5Jw: folds 
BV+K0Phf5VBHr7aZPKqbUQ: folds 
Uncalled bet ($0.50) returned to xrf8tAXKQHG99HixCot1Iw
xrf8tAXKQHG99HixCot1Iw collected $0.60 from pot
xrf8tAXKQHG99HixCot1Iw: doesn't show hand 
*** SUMMARY ***
Total pot $0.60 | Rake $0 
Seat 1: SFmT9ZsVopnukjvAzrxTRg folded before Flop (didn't bet)
Seat 2: xrf8tAXKQHG99HixCot1Iw (button) collected ($0.60)
Seat 3: MqMK8OWPSY1V4stf1Hy5Jw (small blind) folded before Flop
Seat 4: BV+K0Phf5VBHr7aZPKqbUQ (big blind) folded before Flop
Seat 5: v+QfkGiuj9bgtuNoVnDO8w folded before Flop (didn't bet)
Seat 6: jA7YMtfNUnAaebB7Lj74EA folded before Flop (didn't bet)




PokerStars Game #59941736268:  Hold'em No Limit ($0.10/$0.25) - 2009/07/01 1:44:31 ET
Table 'JJzUs04lHpXg6nboT1/jeg' 6-max Seat #4 is the button
Seat 1: MqMK8OWPSY1V4stf1Hy5Jw ($38.95 in chips) 
Seat 2: jxfR29d+dK/7h7s3SvCk+g ($6.70 in chips) 
Seat 3: 4zXbHDe39qNX46dAo81b4w ($7.30 in chips) 
Seat 4: 7VfhiFY533nbUKvyEthASw ($29.50 in chips) 
Seat 5: QvTX2yGq3uKJiKPmns4TKQ ($20.85 in chips) 
Seat 6: wqphQtauX5Qn7WRJZS1flA ($29.30 in chips) 
QvTX2yGq3uKJiKPmns4TKQ: posts small blind $0.10
wqphQtauX5Qn7WRJZS1flA: posts big blind $0.25
*** HOLE CARDS ***
MqMK8OWPSY1V4stf1Hy5Jw: folds 
jxfR29d+dK/7h7s3SvCk+g: calls $0.25
4zXbHDe39qNX46dAo81b4w: folds 
7VfhiFY533nbUKvyEthASw: folds 
QvTX2yGq3uKJiKPmns4TKQ: raises $0.75 to $1
wqphQtauX5Qn7WRJZS1flA: folds 
jxfR29d+dK/7h7s3SvCk+g: calls $0.75
*** FLOP *** [Th 8s 5d]
QvTX2yGq3uKJiKPmns4TKQ: bets $1.25
jxfR29d+dK/7h7s3SvCk+g: raises $1.75 to $3
QvTX2yGq3uKJiKPmns4TKQ: folds 
Uncalled bet ($1.75) returned to jxfR29d+dK/7h7s3SvCk+g
jxfR29d+dK/7h7s3SvCk+g collected $4.55 from pot
*** SUMMARY ***
Total pot $4.75 | Rake $0.20 
Board [Th 8s 5d]
Seat 1: MqMK8OWPSY1V4stf1Hy5Jw folded before Flop (didn't bet)
Seat 2: jxfR29d+dK/7h7s3SvCk+g collected ($4.55)
Seat 3: 4zXbHDe39qNX46dAo81b4w folded before Flop (didn't bet)
Seat 4: 7VfhiFY533nbUKvyEthASw (button) folded before Flop (didn't bet)
Seat 5: QvTX2yGq3uKJiKPmns4TKQ (small blind) folded on the Flop
Seat 6: wqphQtauX5Qn7WRJZS1flA (big blind) folded before Flop




PokerStars Game #59941735848:  Hold'em No Limit ($0.10/$0.25) - 2009/07/01 1:44:31 ET
Table 'Mef6A0EMopL6WaFO5/KO9g' 6-max Seat #3 is the button
Seat 1: GbCVUNssQ7mqsPWr7J4d3w ($4.30 in chips) 
Seat 2: 8ClCHtFXGNplITm+63KB+Q ($29.90 in chips) 
Seat 3: Wq26opBLDGJe91GRJn2epg ($17.15 in chips) 
Seat 4: lquriepNQBhDV5P1SWHhnA ($25 in chips) 
Seat 5: DihMHaz4WNETH1bPDe13kA ($25 in chips) 
Seat 6: jp34e617tIzV8tKIWmfAbA ($33.30 in chips) 
lquriepNQBhDV5P1SWHhnA: posts small blind $0.10
DihMHaz4WNETH1bPDe13kA: posts big blind $0.25
*** HOLE CARDS ***
jp34e617tIzV8tKIWmfAbA: raises $0.50 to $0.75
GbCVUNssQ7mqsPWr7J4d3w: folds 
8ClCHtFXGNplITm+63KB+Q: folds 
Wq26opBLDGJe91GRJn2epg: folds 
lquriepNQBhDV5P1SWHhnA: folds 
DihMHaz4WNETH1bPDe13kA: folds 
Uncalled bet ($0.50) returned to jp34e617tIzV8tKIWmfAbA
jp34e617tIzV8tKIWmfAbA collected $0.60 from pot
*** SUMMARY ***
Total pot $0.60 | Rake $0 
Seat 1: GbCVUNssQ7mqsPWr7J4d3w folded before Flop (didn't bet)
Seat 2: 8ClCHtFXGNplITm+63KB+Q folded before Flop (didn't bet)
Seat 3: Wq26opBLDGJe91GRJn2epg (button) folded before Flop (didn't bet)
Seat 4: lquriepNQBhDV5P1SWHhnA (small blind) folded before Flop
Seat 5: DihMHaz4WNETH1bPDe13kA (big blind) folded before Flop
Seat 6: jp34e617tIzV8tKIWmfAbA collected ($0.60)




PokerStars Game #59941736050:  Hold'em No Limit ($0.10/$0.25) - 2009/07/01 1:44:31 ET
Table 'wixGE3Zge1qBdnpWijIl/w' 9-max Seat #5 is the button
Seat 1: 4GJMmHGKzu+gVtalqRy7dA ($19.10 in chips) 
Seat 2: DnDcAdn9P0zGovMERigpFA ($79.60 in chips) 
Seat 3: Bb42QRQMhg5/Y0vHP8/2Xw ($25 in chips) 
Seat 5: H5Se03ZqSX7tbULXur2MAg ($24.45 in chips) 
Seat 6: AP/rNvbsacTb4XtaAgKPiQ ($20.80 in chips) 
Seat 7: mMd8CDS/but3UC+Zp7Up2w ($20 in chips) 
Seat 8: ShCS62CJp4MKfKLKvGKQbA ($15.15 in chips) 
Seat 9: r6hsffOo1iKmaPYKwAZmFw ($29.15 in chips) 
AP/rNvbsacTb4XtaAgKPiQ: posts small blind $0.10
mMd8CDS/but3UC+Zp7Up2w: posts big blind $0.25
X6+pSIPfovPcE87t+LmUKQ: sits out 
*** HOLE CARDS ***
ShCS62CJp4MKfKLKvGKQbA: folds 
r6hsffOo1iKmaPYKwAZmFw: folds 
4GJMmHGKzu+gVtalqRy7dA: folds 
DnDcAdn9P0zGovMERigpFA: folds 
Bb42QRQMhg5/Y0vHP8/2Xw: folds 
H5Se03ZqSX7tbULXur2MAg: raises $0.50 to $0.75
AP/rNvbsacTb4XtaAgKPiQ: folds 
mMd8CDS/but3UC+Zp7Up2w: calls $0.50
*** FLOP *** [Jc Ah 4s]
mMd8CDS/but3UC+Zp7Up2w: checks 
H5Se03ZqSX7tbULXur2MAg: checks 
*** TURN *** [Jc Ah 4s] [7s]
mMd8CDS/but3UC+Zp7Up2w: bets $0.75
H5Se03ZqSX7tbULXur2MAg: folds 
Uncalled bet ($0.75) returned to mMd8CDS/but3UC+Zp7Up2w
mMd8CDS/but3UC+Zp7Up2w collected $1.55 from pot
*** SUMMARY ***
Total pot $1.60 | Rake $0.05 
Board [Jc Ah 4s 7s]
Seat 1: 4GJMmHGKzu+gVtalqRy7dA folded before Flop (didn't bet)
Seat 2: DnDcAdn9P0zGovMERigpFA folded before Flop (didn't bet)
Seat 3: Bb42QRQMhg5/Y0vHP8/2Xw folded before Flop (didn't bet)
Seat 5: H5Se03ZqSX7tbULXur2MAg (button) folded on the Turn
Seat 6: AP/rNvbsacTb4XtaAgKPiQ (small blind) folded before Flop
Seat 7: mMd8CDS/but3UC+Zp7Up2w (big blind) collected ($1.55)
Seat 8: ShCS62CJp4MKfKLKvGKQbA folded before Flop (didn't bet)
Seat 9: r6hsffOo1iKmaPYKwAZmFw folded before Flop (didn't bet)




PokerStars Game #59941735858:  Hold'em No Limit ($0.10/$0.25) - 2009/07/01 1:44:31 ET
Table 'wPWRBZPJl1HAnysw7qRR0A' 6-max Seat #3 is the button
Seat 1: m7ne1MOFTQXlsXT7/R/rug ($6.90 in chips) 
Seat 3: 1ZpoLWO2nm2w1Nd1v9Sr3g ($7.10 in chips) 
Seat 4: epAUIB7h2FJXzUPRIvSkRA ($39.50 in chips) 
Seat 5: y0B+UpYpOUJz3JWtlJQBSA ($16.35 in chips) 
epAUIB7h2FJXzUPRIvSkRA: posts small blind $0.10
y0B+UpYpOUJz3JWtlJQBSA: posts big blind $0.25
Voldemort219: sits out 
*** HOLE CARDS ***
m7ne1MOFTQXlsXT7/R/rug: folds 
xC0kaiDYM6YTlgODL83O5A has returned
1ZpoLWO2nm2w1Nd1v9Sr3g: raises $0.75 to $1
epAUIB7h2FJXzUPRIvSkRA: folds 
y0B+UpYpOUJz3JWtlJQBSA: folds 
Uncalled bet ($0.75) returned to 1ZpoLWO2nm2w1Nd1v9Sr3g
1ZpoLWO2nm2w1Nd1v9Sr3g collected $0.60 from pot
1ZpoLWO2nm2w1Nd1v9Sr3g: doesn't show hand 
*** SUMMARY ***
Total pot $0.60 | Rake $0 
Seat 1: m7ne1MOFTQXlsXT7/R/rug folded before Flop (didn't bet)
Seat 3: 1ZpoLWO2nm2w1Nd1v9Sr3g (button) collected ($0.60)
Seat 4: epAUIB7h2FJXzUPRIvSkRA (small blind) folded before Flop
Seat 5: y0B+UpYpOUJz3JWtlJQBSA (big blind) folded before Flop




PokerStars Game #59941736586:  Hold'em No Limit ($0.10/$0.25) - 2009/07/01 1:44:32 ET
Table 'XX2OuOsa8/8AC+/mR/Az6g' 9-max Seat #5 is the button
Seat 1: 56S3mA6Zs3pGR+0p0vUCtg ($24.40 in chips) 
Seat 2: Bb42QRQMhg5/Y0vHP8/2Xw ($27.10 in chips) 
Seat 3: oLa/tXLfSLLB28mcLGrxcg ($24.60 in chips) 
Seat 4: 52uIvr1a/mxEYD1W0ESvdQ ($27.05 in chips) 
Seat 5: SpiiQQAzy4MUgV3I5W8giw ($21.15 in chips) 
Seat 6: RCqMONFrSPSArZh2Jsar/w ($19.75 in chips) 
Seat 8: qwr38jl5txoR36M7G5qi4A ($10.35 in chips) 
Seat 9: V6p0jQ/RhUsqpHLmXvEX4Q ($11.15 in chips) 
RCqMONFrSPSArZh2Jsar/w: posts small blind $0.10
qwr38jl5txoR36M7G5qi4A: posts big blind $0.25
*** HOLE CARDS ***
V6p0jQ/RhUsqpHLmXvEX4Q: raises $1 to $1.25
56S3mA6Zs3pGR+0p0vUCtg: folds 
Bb42QRQMhg5/Y0vHP8/2Xw: folds 
oLa/tXLfSLLB28mcLGrxcg: folds 
52uIvr1a/mxEYD1W0ESvdQ: calls $1.25
SpiiQQAzy4MUgV3I5W8giw: folds 
RCqMONFrSPSArZh2Jsar/w: calls $1.15
qwr38jl5txoR36M7G5qi4A: folds 
*** FLOP *** [Qc 5c 7s]
RCqMONFrSPSArZh2Jsar/w: checks 
V6p0jQ/RhUsqpHLmXvEX4Q: bets $2.25
52uIvr1a/mxEYD1W0ESvdQ: calls $2.25
RCqMONFrSPSArZh2Jsar/w: folds 
*** TURN *** [Qc 5c 7s] [Qd]
V6p0jQ/RhUsqpHLmXvEX4Q: checks 
52uIvr1a/mxEYD1W0ESvdQ: checks 
*** RIVER *** [Qc 5c 7s Qd] [4c]
V6p0jQ/RhUsqpHLmXvEX4Q: checks 
52uIvr1a/mxEYD1W0ESvdQ: bets $8.75
V6p0jQ/RhUsqpHLmXvEX4Q: calls $7.65 and is all-in
Uncalled bet ($1.10) returned to 52uIvr1a/mxEYD1W0ESvdQ
*** SHOW DOWN ***
52uIvr1a/mxEYD1W0ESvdQ: shows [Qh Ks] (three of a kind, Queens)
V6p0jQ/RhUsqpHLmXvEX4Q: mucks hand 
52uIvr1a/mxEYD1W0ESvdQ collected $22.65 from pot
*** SUMMARY ***
Total pot $23.80 | Rake $1.15 
Board [Qc 5c 7s Qd 4c]
Seat 1: 56S3mA6Zs3pGR+0p0vUCtg folded before Flop (didn't bet)
Seat 2: Bb42QRQMhg5/Y0vHP8/2Xw folded before Flop (didn't bet)
Seat 3: oLa/tXLfSLLB28mcLGrxcg folded before Flop (didn't bet)
Seat 4: 52uIvr1a/mxEYD1W0ESvdQ showed [Qh Ks] and won ($22.65) with three of a kind, Queens
Seat 5: SpiiQQAzy4MUgV3I5W8giw (button) folded before Flop (didn't bet)
Seat 6: RCqMONFrSPSArZh2Jsar/w (small blind) folded on the Flop
Seat 8: qwr38jl5txoR36M7G5qi4A (big blind) folded before Flop
Seat 9: V6p0jQ/RhUsqpHLmXvEX4Q mucked




PokerStars Game #59941736568:  Hold'em No Limit ($0.10/$0.25) - 2009/07/01 1:44:32 ET
Table 'WEMI3Mtn7dGARDbgNrKibg' 9-max Seat #1 is the button
Seat 1: Th3FldXKQW6hWVVPahaoOQ ($30.15 in chips) 
Seat 2: tYsOBqdU1+x+yFI7zHO7hQ ($49.30 in chips) 
Seat 3: qwr38jl5txoR36M7G5qi4A ($7.75 in chips) 
Seat 4: Z5NNIVvnhb2IJbLcI79WYQ ($5.25 in chips) 
Seat 5: yzPZQFeaQTNf1YK3a0zRIw ($14.80 in chips) 
Seat 6: arxNSjreDRGFg13EAM2F1w ($25.45 in chips) 
Seat 7: DnDcAdn9P0zGovMERigpFA ($54.90 in chips) 
Seat 8: ghNKXUBl/H+t83JF079ZBA ($29.60 in chips) 
Seat 9: 2wcFsZsqEP5w1StUTVzJCg ($4.50 in chips) 
tYsOBqdU1+x+yFI7zHO7hQ: posts small blind $0.10
qwr38jl5txoR36M7G5qi4A: posts big blind $0.25
*** HOLE CARDS ***
Z5NNIVvnhb2IJbLcI79WYQ: folds 
yzPZQFeaQTNf1YK3a0zRIw: folds 
arxNSjreDRGFg13EAM2F1w: folds 
DnDcAdn9P0zGovMERigpFA: folds 
ghNKXUBl/H+t83JF079ZBA: folds 
2wcFsZsqEP5w1StUTVzJCg: folds 
Th3FldXKQW6hWVVPahaoOQ: raises $0.50 to $0.75
tYsOBqdU1+x+yFI7zHO7hQ: folds 
qwr38jl5txoR36M7G5qi4A: folds 
Uncalled bet ($0.50) returned to Th3FldXKQW6hWVVPahaoOQ
Th3FldXKQW6hWVVPahaoOQ collected $0.60 from pot
Th3FldXKQW6hWVVPahaoOQ: doesn't show hand 
*** SUMMARY ***
Total pot $0.60 | Rake $0 
Seat 1: Th3FldXKQW6hWVVPahaoOQ (button) collected ($0.60)
Seat 2: tYsOBqdU1+x+yFI7zHO7hQ (small blind) folded before Flop
Seat 3: qwr38jl5txoR36M7G5qi4A (big blind) folded before Flop
Seat 4: Z5NNIVvnhb2IJbLcI79WYQ folded before Flop (didn't bet)
Seat 5: yzPZQFeaQTNf1YK3a0zRIw folded before Flop (didn't bet)
Seat 6: arxNSjreDRGFg13EAM2F1w folded before Flop (didn't bet)
Seat 7: DnDcAdn9P0zGovMERigpFA folded before Flop (didn't bet)
Seat 8: ghNKXUBl/H+t83JF079ZBA folded before Flop (didn't bet)
Seat 9: 2wcFsZsqEP5w1StUTVzJCg folded before Flop (didn't bet)




PokerStars Game #59941737066:  Hold'em No Limit ($0.10/$0.25) - 2009/07/01 1:44:33 ET
Table 'IrJPyZ3JW2iIa+krdoSbJQ' 9-max Seat #5 is the button
Seat 1: Bb42QRQMhg5/Y0vHP8/2Xw ($26.25 in chips) 
Seat 2: X78b5v/uhqeXXoAijbw/yg ($42.95 in chips) 
Seat 3: CT7Xj/V/O5rBlhtt+RZeFQ ($25 in chips) 
Seat 4: bXpVeaSTPBFSPJmeXxO7nw ($4.65 in chips) 
Seat 5: tLcDklc2rBORNfixyRfVfw ($28.40 in chips) 
Seat 6: +sbyWwIcFp9kP0bDtMegfQ ($24.70 in chips) 
Seat 8: zZqOSFjPK4R4cwx0dONetw ($20.65 in chips) 
Seat 9: Mh2r9hTeTEDnh19sRZtW3g ($5.80 in chips) 
+sbyWwIcFp9kP0bDtMegfQ: posts small blind $0.10
zZqOSFjPK4R4cwx0dONetw: posts big blind $0.25
*** HOLE CARDS ***
Mh2r9hTeTEDnh19sRZtW3g: folds 
Bb42QRQMhg5/Y0vHP8/2Xw: folds 
X78b5v/uhqeXXoAijbw/yg: folds 
CT7Xj/V/O5rBlhtt+RZeFQ: folds 
bXpVeaSTPBFSPJmeXxO7nw: folds 
tLcDklc2rBORNfixyRfVfw: raises $0.75 to $1
+sbyWwIcFp9kP0bDtMegfQ: folds 
DSK-o_O joins the table at seat #7 
zZqOSFjPK4R4cwx0dONetw: calls $0.75
*** FLOP *** [4s 8s Kh]
zZqOSFjPK4R4cwx0dONetw: bets $1
tLcDklc2rBORNfixyRfVfw: raises $2.25 to $3.25
zZqOSFjPK4R4cwx0dONetw: folds 
Uncalled bet ($2.25) returned to tLcDklc2rBORNfixyRfVfw
tLcDklc2rBORNfixyRfVfw collected $3.90 from pot
tLcDklc2rBORNfixyRfVfw: doesn't show hand 
*** SUMMARY ***
Total pot $4.10 | Rake $0.20 
Board [4s 8s Kh]
Seat 1: Bb42QRQMhg5/Y0vHP8/2Xw folded before Flop (didn't bet)
Seat 2: X78b5v/uhqeXXoAijbw/yg folded before Flop (didn't bet)
Seat 3: CT7Xj/V/O5rBlhtt+RZeFQ folded before Flop (didn't bet)
Seat 4: bXpVeaSTPBFSPJmeXxO7nw folded before Flop (didn't bet)
Seat 5: tLcDklc2rBORNfixyRfVfw (button) collected ($3.90)
Seat 6: +sbyWwIcFp9kP0bDtMegfQ (small blind) folded before Flop
Seat 8: zZqOSFjPK4R4cwx0dONetw (big blind) folded on the Flop
Seat 9: Mh2r9hTeTEDnh19sRZtW3g folded before Flop (didn't bet)




PokerStars Game #59941737404:  Hold'em No Limit ($0.10/$0.25) - 2009/07/01 1:44:33 ET
Table 'hOE09W281uSob0XeJmUcRg' 6-max Seat #3 is the button
Seat 1: mfrkWA3PTeYPkbO6hi98Aw ($27.30 in chips) 
Seat 2: lRKJ8o/CnOPFwfHHm6ioMw ($15 in chips) 
Seat 3: y+a/yGW/Jy4bPJFnaeTz5w ($13.60 in chips) 
Seat 5: JFIAqU8lCZ0vWwEl4bdGsg ($25.50 in chips) 
Seat 6: x4ZJ8E/TUrtoB7WiHcv8WA ($14.35 in chips) 
JFIAqU8lCZ0vWwEl4bdGsg: posts small blind $0.10
x4ZJ8E/TUrtoB7WiHcv8WA: posts big blind $0.25
lRKJ8o/CnOPFwfHHm6ioMw: posts big blind $0.25
*** HOLE CARDS ***
mfrkWA3PTeYPkbO6hi98Aw: folds 
lRKJ8o/CnOPFwfHHm6ioMw: checks 
y+a/yGW/Jy4bPJFnaeTz5w: folds 
JFIAqU8lCZ0vWwEl4bdGsg: calls $0.15
x4ZJ8E/TUrtoB7WiHcv8WA: checks 
*** FLOP *** [Kc Ad 6c]
JFIAqU8lCZ0vWwEl4bdGsg: checks 
x4ZJ8E/TUrtoB7WiHcv8WA: bets $1.25
lRKJ8o/CnOPFwfHHm6ioMw: calls $1.25
JFIAqU8lCZ0vWwEl4bdGsg: folds 
*** TURN *** [Kc Ad 6c] [2s]
x4ZJ8E/TUrtoB7WiHcv8WA: bets $1.25
lRKJ8o/CnOPFwfHHm6ioMw: calls $1.25
*** RIVER *** [Kc Ad 6c 2s] [Ts]
x4ZJ8E/TUrtoB7WiHcv8WA: bets $1.50
lRKJ8o/CnOPFwfHHm6ioMw: folds 
Uncalled bet ($1.50) returned to x4ZJ8E/TUrtoB7WiHcv8WA
x4ZJ8E/TUrtoB7WiHcv8WA collected $5.50 from pot
x4ZJ8E/TUrtoB7WiHcv8WA: doesn't show hand 
*** SUMMARY ***
Total pot $5.75 | Rake $0.25 
Board [Kc Ad 6c 2s Ts]
Seat 1: mfrkWA3PTeYPkbO6hi98Aw folded before Flop (didn't bet)
Seat 2: lRKJ8o/CnOPFwfHHm6ioMw folded on the River
Seat 3: y+a/yGW/Jy4bPJFnaeTz5w (button) folded before Flop (didn't bet)
Seat 5: JFIAqU8lCZ0vWwEl4bdGsg (small blind) folded on the Flop
Seat 6: x4ZJ8E/TUrtoB7WiHcv8WA (big blind) collected ($5.50)




PokerStars Game #59941737406:  Hold'em No Limit ($0.10/$0.25) - 2009/07/01 1:44:33 ET
Table '60nA7av6bws9VnNmVwculA' 6-max Seat #5 is the button
Seat 1: if4dh6jhJXeN3/qd3qCp9g ($24.65 in chips) 
Seat 2: Bada343Si4xKu3fNXY99AA ($3.85 in chips) 
Seat 3: mnuJq+Q1IXKm/pCy+OzxmQ ($20.35 in chips) 
Seat 4: +baiVgI/ETnBARLe5mARCw ($18.50 in chips) 
Seat 5: zXh+lOT41Q2iWgCNj+OcRw ($12.35 in chips) 
Seat 6: mfrkWA3PTeYPkbO6hi98Aw ($24.85 in chips) 
mfrkWA3PTeYPkbO6hi98Aw: posts small blind $0.10
if4dh6jhJXeN3/qd3qCp9g: posts big blind $0.25
*** HOLE CARDS ***
Bada343Si4xKu3fNXY99AA: folds 
mnuJq+Q1IXKm/pCy+OzxmQ: folds 
+baiVgI/ETnBARLe5mARCw: calls $0.25
zXh+lOT41Q2iWgCNj+OcRw has timed out
zXh+lOT41Q2iWgCNj+OcRw: folds 
zXh+lOT41Q2iWgCNj+OcRw is sitting out
mfrkWA3PTeYPkbO6hi98Aw: folds 
if4dh6jhJXeN3/qd3qCp9g: checks 
*** FLOP *** [9h Ah 2c]
if4dh6jhJXeN3/qd3qCp9g: checks 
+baiVgI/ETnBARLe5mARCw: checks 
*** TURN *** [9h Ah 2c] [3s]
zXh+lOT41Q2iWgCNj+OcRw has returned
if4dh6jhJXeN3/qd3qCp9g: checks 
+baiVgI/ETnBARLe5mARCw: checks 
*** RIVER *** [9h Ah 2c 3s] [Kd]
if4dh6jhJXeN3/qd3qCp9g: checks 
+baiVgI/ETnBARLe5mARCw: checks 
*** SHOW DOWN ***
if4dh6jhJXeN3/qd3qCp9g: shows [7d 2h] (a pair of Deuces)
+baiVgI/ETnBARLe5mARCw: shows [Tc Td] (a pair of Tens)
+baiVgI/ETnBARLe5mARCw collected $0.60 from pot
*** SUMMARY ***
Total pot $0.60 | Rake $0 
Board [9h Ah 2c 3s Kd]
Seat 1: if4dh6jhJXeN3/qd3qCp9g (big blind) showed [7d 2h] and lost with a pair of Deuces
Seat 2: Bada343Si4xKu3fNXY99AA folded before Flop (didn't bet)
Seat 3: mnuJq+Q1IXKm/pCy+OzxmQ folded before Flop (didn't bet)
Seat 4: +baiVgI/ETnBARLe5mARCw showed [Tc Td] and won ($0.60) with a pair of Tens
Seat 5: zXh+lOT41Q2iWgCNj+OcRw (button) folded before Flop (didn't bet)
Seat 6: mfrkWA3PTeYPkbO6hi98Aw (small blind) folded before Flop




PokerStars Game #59941737850:  Hold'em No Limit ($0.10/$0.25) - 2009/07/01 1:44:34 ET
Table 'jdhJTJjFq2KTttwJcd+7nQ' 6-max Seat #6 is the button
Seat 1: LtASJ9OlkqGrrUKGQlpGAw ($26.95 in chips) 
Seat 2: Hsvkc0/G2VV78oVmWYXecw ($5 in chips) 
Seat 3: vqWjZmdQu/Hxw96/IJTWdQ ($25.95 in chips) 
Seat 4: vx7FwRcelVSsvNYAdp/z0A ($7.15 in chips) 
Seat 5: BV+K0Phf5VBHr7aZPKqbUQ ($25.75 in chips) 
Seat 6: yb6rnd48JuBccThV68VHAQ ($16.25 in chips) 
LtASJ9OlkqGrrUKGQlpGAw: posts small blind $0.10
Hsvkc0/G2VV78oVmWYXecw: posts big blind $0.25
*** HOLE CARDS ***
vqWjZmdQu/Hxw96/IJTWdQ: folds 
vx7FwRcelVSsvNYAdp/z0A: folds 
BV+K0Phf5VBHr7aZPKqbUQ: raises $0.50 to $0.75
yb6rnd48JuBccThV68VHAQ: folds 
LtASJ9OlkqGrrUKGQlpGAw: folds 
Hsvkc0/G2VV78oVmWYXecw: folds 
Uncalled bet ($0.50) returned to BV+K0Phf5VBHr7aZPKqbUQ
BV+K0Phf5VBHr7aZPKqbUQ collected $0.60 from pot
BV+K0Phf5VBHr7aZPKqbUQ: doesn't show hand 
*** SUMMARY ***
Total pot $0.60 | Rake $0 
Seat 1: LtASJ9OlkqGrrUKGQlpGAw (small blind) folded before Flop
Seat 2: Hsvkc0/G2VV78oVmWYXecw (big blind) folded before Flop
Seat 3: vqWjZmdQu/Hxw96/IJTWdQ folded before Flop (didn't bet)
Seat 4: vx7FwRcelVSsvNYAdp/z0A folded before Flop (didn't bet)
Seat 5: BV+K0Phf5VBHr7aZPKqbUQ collected ($0.60)
Seat 6: yb6rnd48JuBccThV68VHAQ (button) folded before Flop (didn't bet)




PokerStars Game #59941737664:  Hold'em No Limit ($0.10/$0.25) - 2009/07/01 1:44:34 ET
Table 'C8mMnVmvkagwolEzTvh07A' 9-max Seat #6 is the button
Seat 1: PqvgxdSg9z5VmrWpbYuz+g ($27.75 in chips) 
Seat 2: Bb42QRQMhg5/Y0vHP8/2Xw ($25 in chips) 
Seat 3: Th3FldXKQW6hWVVPahaoOQ ($35.35 in chips) 
Seat 4: dfNim92Z6XK1/h5SFW5vDg ($25 in chips) 
Seat 5: iGMlK+EhUflPB6jKQd95Cg ($27.50 in chips) 
Seat 6: AiXn/9o1EwOPZUHujnh/bA ($18.50 in chips) 
Seat 7: qmEgnPhQt24xdw/ZRVPLbA ($46 in chips) 
Seat 9: 4awUyiDYTgylQKXZ9faBVA ($25 in chips) 
qmEgnPhQt24xdw/ZRVPLbA: posts small blind $0.10
4awUyiDYTgylQKXZ9faBVA: posts big blind $0.25
*** HOLE CARDS ***
PqvgxdSg9z5VmrWpbYuz+g: calls $0.25
Bb42QRQMhg5/Y0vHP8/2Xw: folds 
Th3FldXKQW6hWVVPahaoOQ: folds 
dfNim92Z6XK1/h5SFW5vDg: folds 
iGMlK+EhUflPB6jKQd95Cg: folds 
AiXn/9o1EwOPZUHujnh/bA: folds 
qmEgnPhQt24xdw/ZRVPLbA: raises $1.25 to $1.50
4awUyiDYTgylQKXZ9faBVA: folds 
PqvgxdSg9z5VmrWpbYuz+g: folds 
Uncalled bet ($1.25) returned to qmEgnPhQt24xdw/ZRVPLbA
qmEgnPhQt24xdw/ZRVPLbA collected $0.75 from pot
qmEgnPhQt24xdw/ZRVPLbA: doesn't show hand 
*** SUMMARY ***
Total pot $0.75 | Rake $0 
Seat 1: PqvgxdSg9z5VmrWpbYuz+g folded before Flop
Seat 2: Bb42QRQMhg5/Y0vHP8/2Xw folded before Flop (didn't bet)
Seat 3: Th3FldXKQW6hWVVPahaoOQ folded before Flop (didn't bet)
Seat 4: dfNim92Z6XK1/h5SFW5vDg folded before Flop (didn't bet)
Seat 5: iGMlK+EhUflPB6jKQd95Cg folded before Flop (didn't bet)
Seat 6: AiXn/9o1EwOPZUHujnh/bA (button) folded before Flop (didn't bet)
Seat 7: qmEgnPhQt24xdw/ZRVPLbA (small blind) collected ($0.75)
Seat 9: 4awUyiDYTgylQKXZ9faBVA (big blind) folded before Flop




PokerStars Game #59941737602:  Hold'em No Limit ($0.10/$0.25) - 2009/07/01 1:44:34 ET
Table '3LMlz3V4AziGlU+ikmyU8w' 6-max Seat #1 is the button
Seat 1: Wxq4Qyj0DnDXj2+taEOJFQ ($27.90 in chips) 
Seat 2: uR3AbFJLoOX86DOTtTgGcg ($27.25 in chips) 
Seat 3: Hzy03WtPHMYwLYM7hTTxQw ($29.60 in chips) 
Seat 4: 6DwBRH+xZ12AAZmeAg+aXw ($19.90 in chips) 
Seat 5: tOAk1Og4mVObMBOfvdDYOw ($25 in chips) 
uR3AbFJLoOX86DOTtTgGcg: posts small blind $0.10
Hzy03WtPHMYwLYM7hTTxQw: posts big blind $0.25
*** HOLE CARDS ***
6DwBRH+xZ12AAZmeAg+aXw: folds 
tOAk1Og4mVObMBOfvdDYOw: raises $0.75 to $1
Wxq4Qyj0DnDXj2+taEOJFQ: calls $1
uR3AbFJLoOX86DOTtTgGcg: folds 
GloriaFades joins the table at seat #6 
Hzy03WtPHMYwLYM7hTTxQw: raises $2.50 to $3.50
tOAk1Og4mVObMBOfvdDYOw: folds 
Wxq4Qyj0DnDXj2+taEOJFQ: calls $2.50
*** FLOP *** [8s 6s 3c]
Hzy03WtPHMYwLYM7hTTxQw: bets $6.50
Wxq4Qyj0DnDXj2+taEOJFQ: calls $6.50
*** TURN *** [8s 6s 3c] [5h]
Hzy03WtPHMYwLYM7hTTxQw: checks 
Wxq4Qyj0DnDXj2+taEOJFQ: checks 
*** RIVER *** [8s 6s 3c 5h] [8h]
Hzy03WtPHMYwLYM7hTTxQw: bets $19.60 and is all-in
Wxq4Qyj0DnDXj2+taEOJFQ: calls $17.90 and is all-in
Uncalled bet ($1.70) returned to Hzy03WtPHMYwLYM7hTTxQw
*** SHOW DOWN ***
Hzy03WtPHMYwLYM7hTTxQw: shows [Qs Th] (a pair of Eights)
Wxq4Qyj0DnDXj2+taEOJFQ: shows [Qh Qd] (two pair, Queens and Eights)
Wxq4Qyj0DnDXj2+taEOJFQ collected $54.90 from pot
*** SUMMARY ***
Total pot $56.90 | Rake $2 
Board [8s 6s 3c 5h 8h]
Seat 1: Wxq4Qyj0DnDXj2+taEOJFQ (button) showed [Qh Qd] and won ($54.90) with two pair, Queens and Eights
Seat 2: uR3AbFJLoOX86DOTtTgGcg (small blind) folded before Flop
Seat 3: Hzy03WtPHMYwLYM7hTTxQw (big blind) showed [Qs Th] and lost with a pair of Eights
Seat 4: 6DwBRH+xZ12AAZmeAg+aXw folded before Flop (didn't bet)
Seat 5: tOAk1Og4mVObMBOfvdDYOw folded before Flop




PokerStars Game #59941737844:  Hold'em No Limit ($0.10/$0.25) - 2009/07/01 1:44:34 ET
Table 'Yb2CyZosw7N3yRRVLhKnKg' 9-max Seat #1 is the button
Seat 1: c/9X4zftzphFxYtxp5kp9w ($14.55 in chips) 
Seat 2: dtZ84flFEi4Q+SGrHMJRDQ ($27.65 in chips) 
Seat 3: wUanlt/hhheMA+jOrJk2Tg ($10 in chips) 
Seat 4: FG10kumpruEJ3PQJ7oGglQ ($11.70 in chips) 
Seat 5: T5Hk9oiIr+JDDMnEqwFCrw ($2.25 in chips) 
Seat 6: CgIo2ItZqi4o3ayVG6HanQ ($43.95 in chips) 
Seat 7: ljemhp25Zg+nlA9DLCIiUw ($26.85 in chips) 
Seat 8: HxDF4QSxC4z39D7teZpprQ ($10.75 in chips) 
Seat 9: 6DVf3fwEGECnjQ4Yp9AsFw ($15.50 in chips) 
dtZ84flFEi4Q+SGrHMJRDQ: posts small blind $0.10
wUanlt/hhheMA+jOrJk2Tg: posts big blind $0.25
*** HOLE CARDS ***
FG10kumpruEJ3PQJ7oGglQ: raises $0.50 to $0.75
T5Hk9oiIr+JDDMnEqwFCrw: folds 
CgIo2ItZqi4o3ayVG6HanQ: folds 
ljemhp25Zg+nlA9DLCIiUw: calls $0.75
HxDF4QSxC4z39D7teZpprQ: folds 
6DVf3fwEGECnjQ4Yp9AsFw: folds 
c/9X4zftzphFxYtxp5kp9w: calls $0.75
dtZ84flFEi4Q+SGrHMJRDQ: calls $0.65
wUanlt/hhheMA+jOrJk2Tg: folds 
*** FLOP *** [Th Qh 7s]
dtZ84flFEi4Q+SGrHMJRDQ: checks 
FG10kumpruEJ3PQJ7oGglQ: bets $1
ljemhp25Zg+nlA9DLCIiUw: folds 
c/9X4zftzphFxYtxp5kp9w: folds 
dtZ84flFEi4Q+SGrHMJRDQ: folds 
Uncalled bet ($1) returned to FG10kumpruEJ3PQJ7oGglQ
FG10kumpruEJ3PQJ7oGglQ collected $3.10 from pot
*** SUMMARY ***
Total pot $3.25 | Rake $0.15 
Board [Th Qh 7s]
Seat 1: c/9X4zftzphFxYtxp5kp9w (button) folded on the Flop
Seat 2: dtZ84flFEi4Q+SGrHMJRDQ (small blind) folded on the Flop
Seat 3: wUanlt/hhheMA+jOrJk2Tg (big blind) folded before Flop
Seat 4: FG10kumpruEJ3PQJ7oGglQ collected ($3.10)
Seat 5: T5Hk9oiIr+JDDMnEqwFCrw folded before Flop (didn't bet)
Seat 6: CgIo2ItZqi4o3ayVG6HanQ folded before Flop (didn't bet)
Seat 7: ljemhp25Zg+nlA9DLCIiUw folded on the Flop
Seat 8: HxDF4QSxC4z39D7teZpprQ folded before Flop (didn't bet)
Seat 9: 6DVf3fwEGECnjQ4Yp9AsFw folded before Flop (didn't bet)




PokerStars Game #59941738034:  Hold'em No Limit ($0.10/$0.25) - 2009/07/01 1:44:35 ET
Table '0XPo7K54oZIfG0xlNAcDRw' 9-max Seat #4 is the button
Seat 1: 7cv+9Zc9HIQHNvYsMfV3uA ($28.05 in chips) 
Seat 2: Prl9QvWQw/mISF4dSnnQUQ ($10.20 in chips) 
Seat 3: RHqgdFvufLCYe54+qd2gcA ($5 in chips) 
Seat 4: RubYqfvGrz2z+5ReNIj9QQ ($30.55 in chips) 
Seat 5: iOmwbUN7u4JFkV6VCA49aA ($15.40 in chips) 
Seat 6: M1nKET7WOTLbVPuAbJa3EA ($15 in chips) 
Seat 7: tYsOBqdU1+x+yFI7zHO7hQ ($28.80 in chips) 
Seat 8: v5jnQ1gfh9nLla3kMXG7Yg ($15.95 in chips) 
Seat 9: CmngQmkKTp8tkl6GMRTl6w ($13.60 in chips) 
iOmwbUN7u4JFkV6VCA49aA: posts small blind $0.10
M1nKET7WOTLbVPuAbJa3EA: posts big blind $0.25
Prl9QvWQw/mISF4dSnnQUQ: posts small blind $0.10
RHqgdFvufLCYe54+qd2gcA: posts big blind $0.25
*** HOLE CARDS ***
tYsOBqdU1+x+yFI7zHO7hQ: folds 
v5jnQ1gfh9nLla3kMXG7Yg: calls $0.25
CmngQmkKTp8tkl6GMRTl6w: folds 
7cv+9Zc9HIQHNvYsMfV3uA: calls $0.25
Prl9QvWQw/mISF4dSnnQUQ: folds 
RHqgdFvufLCYe54+qd2gcA: checks 
RubYqfvGrz2z+5ReNIj9QQ: calls $0.25
iOmwbUN7u4JFkV6VCA49aA: calls $0.15
M1nKET7WOTLbVPuAbJa3EA: checks 
*** FLOP *** [Kh Ac 8h]
iOmwbUN7u4JFkV6VCA49aA: checks 
M1nKET7WOTLbVPuAbJa3EA: checks 
v5jnQ1gfh9nLla3kMXG7Yg: checks 
7cv+9Zc9HIQHNvYsMfV3uA: bets $1.25
RHqgdFvufLCYe54+qd2gcA: folds 
RubYqfvGrz2z+5ReNIj9QQ: folds 
iOmwbUN7u4JFkV6VCA49aA: folds 
M1nKET7WOTLbVPuAbJa3EA: folds 
v5jnQ1gfh9nLla3kMXG7Yg: folds 
Uncalled bet ($1.25) returned to 7cv+9Zc9HIQHNvYsMfV3uA
7cv+9Zc9HIQHNvYsMfV3uA collected $1.55 from pot
7cv+9Zc9HIQHNvYsMfV3uA: doesn't show hand 
*** SUMMARY ***
Total pot $1.60 | Rake $0.05 
Board [Kh Ac 8h]
Seat 1: 7cv+9Zc9HIQHNvYsMfV3uA collected ($1.55)
Seat 2: Prl9QvWQw/mISF4dSnnQUQ folded before Flop
Seat 3: RHqgdFvufLCYe54+qd2gcA folded on the Flop
Seat 4: RubYqfvGrz2z+5ReNIj9QQ (button) folded on the Flop
Seat 5: iOmwbUN7u4JFkV6VCA49aA (small blind) folded on the Flop
Seat 6: M1nKET7WOTLbVPuAbJa3EA (big blind) folded on the Flop
Seat 7: tYsOBqdU1+x+yFI7zHO7hQ folded before Flop (didn't bet)
Seat 8: v5jnQ1gfh9nLla3kMXG7Yg folded on the Flop
Seat 9: CmngQmkKTp8tkl6GMRTl6w folded before Flop (didn't bet)




PokerStars Game #59941738314:  Hold'em No Limit ($0.10/$0.25) - 2009/07/01 1:44:35 ET
Table 'KYX9dFNuOA9l2PV46IebqQ' 9-max Seat #8 is the button
Seat 1: qZqVFan2U+GAA/c5LQFbcw ($10 in chips) 
Seat 2: z2SmIaQ3+5n/eY1BN5HgPg ($6.25 in chips) 
Seat 3: Uq3NSX4cIFaXe7pbXQuU+Q ($9.80 in chips) 
Seat 4: rPXwQUVloUl+qZm3CCtaJw ($9.05 in chips) 
Seat 5: g7MXhRmNZxv1lIkKkUKa4w ($13.25 in chips) 
Seat 6: 4QYM+pWPc3J+6i8Zv8LvLg ($13.30 in chips) 
Seat 7: FVZtQJMz59M6BoiON/88Xg ($7.25 in chips) 
Seat 8: KRWTiGM4xH+MkvPtJz4+SA ($24.65 in chips) 
Seat 9: 6NECk10orj8iqgD3pZ2A0Q ($5.10 in chips) 
6NECk10orj8iqgD3pZ2A0Q: posts small blind $0.10
qZqVFan2U+GAA/c5LQFbcw: posts big blind $0.25
4QYM+pWPc3J+6i8Zv8LvLg: posts big blind $0.25
FVZtQJMz59M6BoiON/88Xg: posts big blind $0.25
*** HOLE CARDS ***
z2SmIaQ3+5n/eY1BN5HgPg has timed out
z2SmIaQ3+5n/eY1BN5HgPg: folds 
z2SmIaQ3+5n/eY1BN5HgPg is sitting out
Uq3NSX4cIFaXe7pbXQuU+Q: calls $0.25
z2SmIaQ3+5n/eY1BN5HgPg has returned
rPXwQUVloUl+qZm3CCtaJw: calls $0.25
g7MXhRmNZxv1lIkKkUKa4w: calls $0.25
4QYM+pWPc3J+6i8Zv8LvLg: checks 
FVZtQJMz59M6BoiON/88Xg: raises $7 to $7.25 and is all-in
KRWTiGM4xH+MkvPtJz4+SA: folds 
6NECk10orj8iqgD3pZ2A0Q: folds 
qZqVFan2U+GAA/c5LQFbcw: folds 
Uq3NSX4cIFaXe7pbXQuU+Q: raises $2.55 to $9.80 and is all-in
rPXwQUVloUl+qZm3CCtaJw: folds 
g7MXhRmNZxv1lIkKkUKa4w: folds 
4QYM+pWPc3J+6i8Zv8LvLg: folds 
Uncalled bet ($2.55) returned to Uq3NSX4cIFaXe7pbXQuU+Q
*** FLOP *** [9s Qh 7d]
*** TURN *** [9s Qh 7d] [2h]
*** RIVER *** [9s Qh 7d 2h] [8c]
*** SHOW DOWN ***
Uq3NSX4cIFaXe7pbXQuU+Q: shows [Ah Qs] (a pair of Queens)
FVZtQJMz59M6BoiON/88Xg: shows [5s 6h] (a straight, Five to Nine)
FVZtQJMz59M6BoiON/88Xg collected $14.85 from pot
*** SUMMARY ***
Total pot $15.60 | Rake $0.75 
Board [9s Qh 7d 2h 8c]
Seat 1: qZqVFan2U+GAA/c5LQFbcw (big blind) folded before Flop
Seat 2: z2SmIaQ3+5n/eY1BN5HgPg folded before Flop (didn't bet)
Seat 3: Uq3NSX4cIFaXe7pbXQuU+Q showed [Ah Qs] and lost with a pair of Queens
Seat 4: rPXwQUVloUl+qZm3CCtaJw folded before Flop
Seat 5: g7MXhRmNZxv1lIkKkUKa4w folded before Flop
Seat 6: 4QYM+pWPc3J+6i8Zv8LvLg folded before Flop
Seat 7: FVZtQJMz59M6BoiON/88Xg showed [5s 6h] and won ($14.85) with a straight, Five to Nine
Seat 8: KRWTiGM4xH+MkvPtJz4+SA (button) folded before Flop (didn't bet)
Seat 9: 6NECk10orj8iqgD3pZ2A0Q (small blind) folded before Flop




PokerStars Game #59941738098:  Hold'em No Limit ($0.10/$0.25) - 2009/07/01 1:44:35 ET
Table 'rO1I30HnuCPB0M8qEX1TCQ' 9-max Seat #6 is the button
Seat 1: dfsOFy2nKDeSF9SjtdIyVA ($13.45 in chips) 
Seat 2: z1hPotrGOZjUjyoopZ7Ulg ($21.70 in chips) 
Seat 3: 2wcFsZsqEP5w1StUTVzJCg ($13.15 in chips) 
Seat 4: yyG4svzOpC1A+sUP/scg6w ($10.40 in chips) 
Seat 5: W6tExOcYX7qiy6Qdp+ZwFA ($5.10 in chips) 
Seat 6: 5n7e7I+px7c6CQmLpPbtsg ($4.65 in chips) 
Seat 7: bXpVeaSTPBFSPJmeXxO7nw ($4.75 in chips) 
Seat 8: 6mStmDUknIn/RyBEoiIyoQ ($1.70 in chips) 
bXpVeaSTPBFSPJmeXxO7nw: posts small blind $0.10
6mStmDUknIn/RyBEoiIyoQ: posts big blind $0.25
ValerbI4_K: sits out 
*** HOLE CARDS ***
dfsOFy2nKDeSF9SjtdIyVA: calls $0.25
z1hPotrGOZjUjyoopZ7Ulg: folds 
2wcFsZsqEP5w1StUTVzJCg: folds 
yyG4svzOpC1A+sUP/scg6w: folds 
W6tExOcYX7qiy6Qdp+ZwFA: folds 
5n7e7I+px7c6CQmLpPbtsg: folds 
bXpVeaSTPBFSPJmeXxO7nw: folds 
6mStmDUknIn/RyBEoiIyoQ: raises $1.45 to $1.70 and is all-in
dfsOFy2nKDeSF9SjtdIyVA: folds 
Uncalled bet ($1.45) returned to 6mStmDUknIn/RyBEoiIyoQ
6mStmDUknIn/RyBEoiIyoQ collected $0.60 from pot
6mStmDUknIn/RyBEoiIyoQ: doesn't show hand 
*** SUMMARY ***
Total pot $0.60 | Rake $0 
Seat 1: dfsOFy2nKDeSF9SjtdIyVA folded before Flop
Seat 2: z1hPotrGOZjUjyoopZ7Ulg folded before Flop (didn't bet)
Seat 3: 2wcFsZsqEP5w1StUTVzJCg folded before Flop (didn't bet)
Seat 4: yyG4svzOpC1A+sUP/scg6w folded before Flop (didn't bet)
Seat 5: W6tExOcYX7qiy6Qdp+ZwFA folded before Flop (didn't bet)
Seat 6: 5n7e7I+px7c6CQmLpPbtsg (button) folded before Flop (didn't bet)
Seat 7: bXpVeaSTPBFSPJmeXxO7nw (small blind) folded before Flop
Seat 8: 6mStmDUknIn/RyBEoiIyoQ (big blind) collected ($0.60)




PokerStars Game #59941738026:  Hold'em No Limit ($0.10/$0.25) - 2009/07/01 1:44:35 ET
Table 'GxdLtCpYxqT4aAbYqkEEpw' 6-max Seat #4 is the button
Seat 1: 2d/PU00mMdO9azAaXqcSbw ($10.35 in chips) 
Seat 3: LpmZGzLpOmfZUF7EV4ZlrQ ($16.25 in chips) 
Seat 4: 6wzJiRvp8HY6t+MQGnSIzA ($10.55 in chips) 
Seat 5: q6WfTUAD9mowIP63ASq2Dg ($44.95 in chips) 
Seat 6: DFi/Lzkjsfv8QswS80JX9Q ($25 in chips) 
q6WfTUAD9mowIP63ASq2Dg: posts small blind $0.10
DFi/Lzkjsfv8QswS80JX9Q: posts big blind $0.25
*** HOLE CARDS ***
2d/PU00mMdO9azAaXqcSbw: calls $0.25
LpmZGzLpOmfZUF7EV4ZlrQ: folds 
6wzJiRvp8HY6t+MQGnSIzA: folds 
MCCWc70bl051s/EF6nHRcA joins the table at seat #2 
q6WfTUAD9mowIP63ASq2Dg: calls $0.15
DFi/Lzkjsfv8QswS80JX9Q: checks 
*** FLOP *** [4s 2d 2s]
q6WfTUAD9mowIP63ASq2Dg: bets $0.75
DFi/Lzkjsfv8QswS80JX9Q: folds 
2d/PU00mMdO9azAaXqcSbw: calls $0.75
*** TURN *** [4s 2d 2s] [7d]
q6WfTUAD9mowIP63ASq2Dg: bets $1
2d/PU00mMdO9azAaXqcSbw: folds 
Uncalled bet ($1) returned to q6WfTUAD9mowIP63ASq2Dg
q6WfTUAD9mowIP63ASq2Dg collected $2.15 from pot
q6WfTUAD9mowIP63ASq2Dg: doesn't show hand 
*** SUMMARY ***
Total pot $2.25 | Rake $0.10 
Board [4s 2d 2s 7d]
Seat 1: 2d/PU00mMdO9azAaXqcSbw folded on the Turn
Seat 3: LpmZGzLpOmfZUF7EV4ZlrQ folded before Flop (didn't bet)
Seat 4: 6wzJiRvp8HY6t+MQGnSIzA (button) folded before Flop (didn't bet)
Seat 5: q6WfTUAD9mowIP63ASq2Dg (small blind) collected ($2.15)
Seat 6: DFi/Lzkjsfv8QswS80JX9Q (big blind) folded on the Flop




PokerStars Game #59941738368:  Hold'em No Limit ($0.10/$0.25) - 2009/07/01 1:44:35 ET
Table 'Loy/olZ5qoDOSvX4UTujGg' 6-max Seat #4 is the button
Seat 1: HipgaJhkN4ie/tTw4dK3Ug ($12.80 in chips) 
Seat 2: 4z7mPbMLNp4TezHXin63Vw ($16.90 in chips) 
Seat 3: 32YL2ZEp8NT4JB2RVM9euQ ($15.70 in chips) 
Seat 4: /gJNBeCkWL4o85/jvlZ4BA ($28.20 in chips) 
Seat 6: qGHGf/553gQnDoklMRe3tg ($26.65 in chips) 
qGHGf/553gQnDoklMRe3tg: posts small blind $0.10
HipgaJhkN4ie/tTw4dK3Ug: posts big blind $0.25
*** HOLE CARDS ***
Ar4vsUIUfJ7gbYh1c1m59g joins the table at seat #5 
4z7mPbMLNp4TezHXin63Vw: calls $0.25
32YL2ZEp8NT4JB2RVM9euQ: folds 
/gJNBeCkWL4o85/jvlZ4BA: folds 
qGHGf/553gQnDoklMRe3tg: calls $0.15
HipgaJhkN4ie/tTw4dK3Ug: raises $0.25 to $0.50
4z7mPbMLNp4TezHXin63Vw: calls $0.25
qGHGf/553gQnDoklMRe3tg: calls $0.25
*** FLOP *** [Ad 4s 3h]
qGHGf/553gQnDoklMRe3tg: checks 
HipgaJhkN4ie/tTw4dK3Ug: bets $0.50
4z7mPbMLNp4TezHXin63Vw: folds 
qGHGf/553gQnDoklMRe3tg: folds 
Uncalled bet ($0.50) returned to HipgaJhkN4ie/tTw4dK3Ug
HipgaJhkN4ie/tTw4dK3Ug collected $1.45 from pot
HipgaJhkN4ie/tTw4dK3Ug: doesn't show hand 
*** SUMMARY ***
Total pot $1.50 | Rake $0.05 
Board [Ad 4s 3h]
Seat 1: HipgaJhkN4ie/tTw4dK3Ug (big blind) collected ($1.45)
Seat 2: 4z7mPbMLNp4TezHXin63Vw folded on the Flop
Seat 3: 32YL2ZEp8NT4JB2RVM9euQ folded before Flop (didn't bet)
Seat 4: /gJNBeCkWL4o85/jvlZ4BA (button) folded before Flop (didn't bet)
Seat 6: qGHGf/553gQnDoklMRe3tg (small blind) folded on the Flop




PokerStars Game #59941738394:  Hold'em No Limit ($0.10/$0.25) - 2009/07/01 1:44:35 ET
Table 'hfHe8uKeSJMyWAjSdM7ROQMRfAiS/4JSfnUDlCcZo0wAx Seat #2 is the button
Seat 1: 48oT5xFI+5CHUJlfoGrE4w ($30.15 in chips) 
Seat 2: /gJNBeCkWL4o85/jvlZ4BA ($29.35 in chips) 
Seat 3: FYepjhAvF8ZdVCmqHIy+eQ ($38.80 in chips) 
Seat 4: b4wRQV3APH8irVk6bUFe2Q ($32.50 in chips) 
Seat 6: L3/N/gliETan8N5Gim5h4Q ($25 in chips) 
FYepjhAvF8ZdVCmqHIy+eQ: posts small blind $0.10
b4wRQV3APH8irVk6bUFe2Q: posts big blind $0.25
*** HOLE CARDS ***
L3/N/gliETan8N5Gim5h4Q: raises $0.50 to $0.75
48oT5xFI+5CHUJlfoGrE4w: folds 
/gJNBeCkWL4o85/jvlZ4BA: folds 
FYepjhAvF8ZdVCmqHIy+eQ: folds 
b4wRQV3APH8irVk6bUFe2Q: calls $0.50
*** FLOP *** [6d 8d Jd]
b4wRQV3APH8irVk6bUFe2Q: checks 
L3/N/gliETan8N5Gim5h4Q: checks 
*** TURN *** [6d 8d Jd] [5h]
b4wRQV3APH8irVk6bUFe2Q: bets $1.25
L3/N/gliETan8N5Gim5h4Q: calls $1.25
*** RIVER *** [6d 8d Jd 5h] [7c]
b4wRQV3APH8irVk6bUFe2Q: bets $2.25
L3/N/gliETan8N5Gim5h4Q: calls $2.25
*** SHOW DOWN ***
b4wRQV3APH8irVk6bUFe2Q: shows [Ah 9c] (a straight, Five to Nine)
L3/N/gliETan8N5Gim5h4Q: mucks hand 
b4wRQV3APH8irVk6bUFe2Q collected $8.20 from pot
*** SUMMARY ***
Total pot $8.60 | Rake $0.40 
Board [6d 8d Jd 5h 7c]
Seat 1: 48oT5xFI+5CHUJlfoGrE4w folded before Flop (didn't bet)
Seat 2: /gJNBeCkWL4o85/jvlZ4BA (button) folded before Flop (didn't bet)
Seat 3: FYepjhAvF8ZdVCmqHIy+eQ (small blind) folded before Flop
Seat 4: b4wRQV3APH8irVk6bUFe2Q (big blind) showed [Ah 9c] and won ($8.20) with a straight, Five to Nine
Seat 6: L3/N/gliETan8N5Gim5h4Q mucked




PokerStars Game #59941738910:  Hold'em No Limit ($0.10/$0.25) - 2009/07/01 1:44:36 ET
Table 'qryc9C/ELyQ3lubOaELNAQ' 6-max Seat #1 is the button
Seat 1: OZc6kkoTwtITj1ZfreJK1A ($65.95 in chips) 
Seat 2: LtASJ9OlkqGrrUKGQlpGAw ($30.05 in chips) 
Seat 3: wvIIdlbCgePONQwXjx9xzQ ($5 in chips) 
Seat 4: v+QfkGiuj9bgtuNoVnDO8w ($25.05 in chips) 
Seat 5: 9StOHp+Y1T0K13JdgS2oQQ ($36.60 in chips) 
LtASJ9OlkqGrrUKGQlpGAw: posts small blind $0.10
wvIIdlbCgePONQwXjx9xzQ: posts big blind $0.25
*** HOLE CARDS ***
v+QfkGiuj9bgtuNoVnDO8w: folds 
9StOHp+Y1T0K13JdgS2oQQ: raises $0.50 to $0.75
OZc6kkoTwtITj1ZfreJK1A: folds 
LtASJ9OlkqGrrUKGQlpGAw: folds 
wvIIdlbCgePONQwXjx9xzQ: calls $0.50
*** FLOP *** [8h Jd Kc]
u+J1MTXS2qhNVMbsBemNLg has returned
wvIIdlbCgePONQwXjx9xzQ: checks 
9StOHp+Y1T0K13JdgS2oQQ: bets $0.75
wvIIdlbCgePONQwXjx9xzQ: folds 
Uncalled bet ($0.75) returned to 9StOHp+Y1T0K13JdgS2oQQ
9StOHp+Y1T0K13JdgS2oQQ collected $1.55 from pot
9StOHp+Y1T0K13JdgS2oQQ: doesn't show hand 
*** SUMMARY ***
Total pot $1.60 | Rake $0.05 
Board [8h Jd Kc]
Seat 1: OZc6kkoTwtITj1ZfreJK1A (button) folded before Flop (didn't bet)
Seat 2: LtASJ9OlkqGrrUKGQlpGAw (small blind) folded before Flop
Seat 3: wvIIdlbCgePONQwXjx9xzQ (big blind) folded on the Flop
Seat 4: v+QfkGiuj9bgtuNoVnDO8w folded before Flop (didn't bet)
Seat 5: 9StOHp+Y1T0K13JdgS2oQQ collected ($1.55)




PokerStars Game #59941738564:  Hold'em No Limit ($0.10/$0.25) - 2009/07/01 1:44:36 ET
Table '/JJyyIstHfkT7t/bW+WXgg' 6-max Seat #4 is the button
Seat 2: obJgSnVgWWWaAUtVILo77Q ($18.75 in chips) 
Seat 3: DR0nVIhVP77oEBlO9J8vlg ($35 in chips) 
Seat 4: JFIAqU8lCZ0vWwEl4bdGsg ($35.05 in chips) 
Seat 5: +ZlnqPoP3Hg4BIUxDfKd/A ($47.90 in chips) 
Seat 6: UmcUp27+PbgBItv3ZNlAWQ ($25 in chips) 
+ZlnqPoP3Hg4BIUxDfKd/A: posts small blind $0.10
UmcUp27+PbgBItv3ZNlAWQ: posts big blind $0.25
*** HOLE CARDS ***
obJgSnVgWWWaAUtVILo77Q: calls $0.25
DR0nVIhVP77oEBlO9J8vlg: raises $0.50 to $0.75
JFIAqU8lCZ0vWwEl4bdGsg: folds 
+ZlnqPoP3Hg4BIUxDfKd/A: folds 
UmcUp27+PbgBItv3ZNlAWQ: folds 
obJgSnVgWWWaAUtVILo77Q: calls $0.50
*** FLOP *** [Qh 7s 9h]
obJgSnVgWWWaAUtVILo77Q: checks 
DR0nVIhVP77oEBlO9J8vlg: bets $1
obJgSnVgWWWaAUtVILo77Q: folds 
Uncalled bet ($1) returned to DR0nVIhVP77oEBlO9J8vlg
DR0nVIhVP77oEBlO9J8vlg collected $1.80 from pot
DR0nVIhVP77oEBlO9J8vlg: doesn't show hand 
*** SUMMARY ***
Total pot $1.85 | Rake $0.05 
Board [Qh 7s 9h]
Seat 2: obJgSnVgWWWaAUtVILo77Q folded on the Flop
Seat 3: DR0nVIhVP77oEBlO9J8vlg collected ($1.80)
Seat 4: JFIAqU8lCZ0vWwEl4bdGsg (button) folded before Flop (didn't bet)
Seat 5: +ZlnqPoP3Hg4BIUxDfKd/A (small blind) folded before Flop
Seat 6: UmcUp27+PbgBItv3ZNlAWQ (big blind) folded before Flop




PokerStars Game #59941738656:  Hold'em No Limit ($0.10/$0.25) - 2009/07/01 1:44:36 ET
Table 'mdub7rJf3Z5tCT9s/+1+Wg' 9-max Seat #9 is the button
Seat 1: cZ99hugmLBj9KhTlc8nCSw ($29 in chips) 
Seat 2: 539MC3AwKLWVFwzABc644Q ($9.60 in chips) 
Seat 3: PdIasPkzm2sqZnN41ZRXOg ($5.35 in chips) 
Seat 4: fDGyaQz0cs2s4FOYxkbIHA ($14.85 in chips) 
Seat 5: dfNim92Z6XK1/h5SFW5vDg ($26.25 in chips) 
Seat 6: T/CCwAWe2yhO0c4oHNwicw ($23.25 in chips) 
Seat 7: woe+9KKk+L3pZgMTuHcmog ($15.70 in chips) 
Seat 8: Z9AeOQX3yzuSvKAm/xyovg ($5.90 in chips) 
Seat 9: tYsOBqdU1+x+yFI7zHO7hQ ($36.80 in chips) 
cZ99hugmLBj9KhTlc8nCSw: posts small blind $0.10
539MC3AwKLWVFwzABc644Q: posts big blind $0.25
*** HOLE CARDS ***
PdIasPkzm2sqZnN41ZRXOg: folds 
fDGyaQz0cs2s4FOYxkbIHA: folds 
dfNim92Z6XK1/h5SFW5vDg: folds 
T/CCwAWe2yhO0c4oHNwicw: folds 
woe+9KKk+L3pZgMTuHcmog: folds 
Z9AeOQX3yzuSvKAm/xyovg: folds 
tYsOBqdU1+x+yFI7zHO7hQ: raises $0.50 to $0.75
cZ99hugmLBj9KhTlc8nCSw: folds 
539MC3AwKLWVFwzABc644Q: calls $0.50
*** FLOP *** [6s Qd Ah]
539MC3AwKLWVFwzABc644Q: bets $0.75
tYsOBqdU1+x+yFI7zHO7hQ: folds 
Uncalled bet ($0.75) returned to 539MC3AwKLWVFwzABc644Q
539MC3AwKLWVFwzABc644Q collected $1.55 from pot
*** SUMMARY ***
Total pot $1.60 | Rake $0.05 
Board [6s Qd Ah]
Seat 1: cZ99hugmLBj9KhTlc8nCSw (small blind) folded before Flop
Seat 2: 539MC3AwKLWVFwzABc644Q (big blind) collected ($1.55)
Seat 3: PdIasPkzm2sqZnN41ZRXOg folded before Flop (didn't bet)
Seat 4: fDGyaQz0cs2s4FOYxkbIHA folded before Flop (didn't bet)
Seat 5: dfNim92Z6XK1/h5SFW5vDg folded before Flop (didn't bet)
Seat 6: T/CCwAWe2yhO0c4oHNwicw folded before Flop (didn't bet)
Seat 7: woe+9KKk+L3pZgMTuHcmog folded before Flop (didn't bet)
Seat 8: Z9AeOQX3yzuSvKAm/xyovg folded before Flop (didn't bet)
Seat 9: tYsOBqdU1+x+yFI7zHO7hQ (button) folded on the Flop




PokerStars Game #59941738880:  Hold'em No Limit ($0.10/$0.25) - 2009/07/01 1:44:36 ET
Table 'mF3KHGMaTpaBZbtBoyfTeg' 6-max Seat #4 is the button
Seat 1: 0HAB2GdCAM7p7V00xueAVQ ($23.70 in chips) 
Seat 2: 6qsh9pnysDKJNhfFhFmKRQ ($14.10 in chips) 
Seat 3: 9kUKGKkblnIx3m8rlVol6Q ($9.70 in chips) 
Seat 4: FYepjhAvF8ZdVCmqHIy+eQ ($25 in chips) 
Seat 5: 8ClCHtFXGNplITm+63KB+Q ($44.40 in chips) 
Seat 6: kG34n23qFQA3nzdOJTQ1dA ($27.75 in chips) 
8ClCHtFXGNplITm+63KB+Q: posts small blind $0.10
kG34n23qFQA3nzdOJTQ1dA: posts big blind $0.25
*** HOLE CARDS ***
0HAB2GdCAM7p7V00xueAVQ: raises $0.25 to $0.50
6qsh9pnysDKJNhfFhFmKRQ: folds 
9kUKGKkblnIx3m8rlVol6Q: folds 
FYepjhAvF8ZdVCmqHIy+eQ: folds 
8ClCHtFXGNplITm+63KB+Q: folds 
kG34n23qFQA3nzdOJTQ1dA: folds 
Uncalled bet ($0.25) returned to 0HAB2GdCAM7p7V00xueAVQ
0HAB2GdCAM7p7V00xueAVQ collected $0.60 from pot
0HAB2GdCAM7p7V00xueAVQ: doesn't show hand 
*** SUMMARY ***
Total pot $0.60 | Rake $0 
Seat 1: 0HAB2GdCAM7p7V00xueAVQ collected ($0.60)
Seat 2: 6qsh9pnysDKJNhfFhFmKRQ folded before Flop (didn't bet)
Seat 3: 9kUKGKkblnIx3m8rlVol6Q folded before Flop (didn't bet)
Seat 4: FYepjhAvF8ZdVCmqHIy+eQ (button) folded before Flop (didn't bet)
Seat 5: 8ClCHtFXGNplITm+63KB+Q (small blind) folded before Flop
Seat 6: kG34n23qFQA3nzdOJTQ1dA (big blind) folded before Flop




PokerStars Game #59941739122:  Hold'em No Limit ($0.10/$0.25) - 2009/07/01 1:44:37 ET
Table 'VQNfcI8vTBCTvRfd3veTLQ' 6-max Seat #1 is the button
Seat 1: QiL+lEgEWwy21jk/ltaRLg ($17.10 in chips) 
Seat 2: 79ID/ub1Pt/mDpCprVmOoA ($31.65 in chips) 
Seat 3: LtASJ9OlkqGrrUKGQlpGAw ($11.75 in chips) 
Seat 4: QIWnfLSqfMcoFfdDe5LZPg ($37.80 in chips) 
Seat 5: gX2vbKwS/8zZPENAWB7hxQ ($24.45 in chips) 
Seat 6: LJI7A1YgDM7hgh7o56+ReQ ($27.35 in chips) 
79ID/ub1Pt/mDpCprVmOoA: posts small blind $0.10
LtASJ9OlkqGrrUKGQlpGAw: posts big blind $0.25
*** HOLE CARDS ***
QIWnfLSqfMcoFfdDe5LZPg: folds 
gX2vbKwS/8zZPENAWB7hxQ: folds 
LJI7A1YgDM7hgh7o56+ReQ: raises $0.75 to $1
QiL+lEgEWwy21jk/ltaRLg: folds 
79ID/ub1Pt/mDpCprVmOoA: folds 
LtASJ9OlkqGrrUKGQlpGAw: folds 
Uncalled bet ($0.75) returned to LJI7A1YgDM7hgh7o56+ReQ
LJI7A1YgDM7hgh7o56+ReQ collected $0.60 from pot
LJI7A1YgDM7hgh7o56+ReQ: doesn't show hand 
*** SUMMARY ***
Total pot $0.60 | Rake $0 
Seat 1: QiL+lEgEWwy21jk/ltaRLg (button) folded before Flop (didn't bet)
Seat 2: 79ID/ub1Pt/mDpCprVmOoA (small blind) folded before Flop
Seat 3: LtASJ9OlkqGrrUKGQlpGAw (big blind) folded before Flop
Seat 4: QIWnfLSqfMcoFfdDe5LZPg folded before Flop (didn't bet)
Seat 5: gX2vbKwS/8zZPENAWB7hxQ folded before Flop (didn't bet)
Seat 6: LJI7A1YgDM7hgh7o56+ReQ collected ($0.60)




PokerStars Game #59941739336:  Hold'em No Limit ($0.10/$0.25) - 2009/07/01 1:44:37 ET
Table 'SgI2Cobdjtkh0Fd0/eTTDg' 9-max Seat #4 is the button
Seat 1: NcPAt5YjVvDFEJTTgAVj8g ($5.95 in chips) 
Seat 2: uUc5QTI8+ZdC95UnznCsqg ($14.25 in chips) 
Seat 3: OiV1PWZ3IkN29JlmCcnTwQ ($5 in chips) 
Seat 4: s1y+qfkBnhgc67+X3ThjeA ($9.90 in chips) 
Seat 5: RHqgdFvufLCYe54+qd2gcA ($5.10 in chips) 
Seat 6: 6RiVTYll/5D8zICp0MRpKw ($26.25 in chips) 
Seat 7: lOuxRXNpa9V2VxLMNpxUOg ($19.95 in chips) 
Seat 8: 8GJHzzxiotOqC5gdtgpLoA ($9.65 in chips) 
Seat 9: cZ99hugmLBj9KhTlc8nCSw ($30.95 in chips) 
RHqgdFvufLCYe54+qd2gcA: posts small blind $0.10
6RiVTYll/5D8zICp0MRpKw: posts big blind $0.25
*** HOLE CARDS ***
lOuxRXNpa9V2VxLMNpxUOg: calls $0.25
8GJHzzxiotOqC5gdtgpLoA: folds 
cZ99hugmLBj9KhTlc8nCSw: folds 
NcPAt5YjVvDFEJTTgAVj8g: folds 
uUc5QTI8+ZdC95UnznCsqg: folds 
OiV1PWZ3IkN29JlmCcnTwQ: folds 
s1y+qfkBnhgc67+X3ThjeA: folds 
RHqgdFvufLCYe54+qd2gcA: raises $0.75 to $1
6RiVTYll/5D8zICp0MRpKw: folds 
lOuxRXNpa9V2VxLMNpxUOg: calls $0.75
*** FLOP *** [Th As 8h]
RHqgdFvufLCYe54+qd2gcA: bets $1.25
lOuxRXNpa9V2VxLMNpxUOg: folds 
Uncalled bet ($1.25) returned to RHqgdFvufLCYe54+qd2gcA
lOuxRXNpa9V2VxLMNpxUOg is sitting out
RHqgdFvufLCYe54+qd2gcA collected $2.15 from pot
RHqgdFvufLCYe54+qd2gcA: doesn't show hand 
*** SUMMARY ***
Total pot $2.25 | Rake $0.10 
Board [Th As 8h]
Seat 1: NcPAt5YjVvDFEJTTgAVj8g folded before Flop (didn't bet)
Seat 2: uUc5QTI8+ZdC95UnznCsqg folded before Flop (didn't bet)
Seat 3: OiV1PWZ3IkN29JlmCcnTwQ folded before Flop (didn't bet)
Seat 4: s1y+qfkBnhgc67+X3ThjeA (button) folded before Flop (didn't bet)
Seat 5: RHqgdFvufLCYe54+qd2gcA (small blind) collected ($2.15)
Seat 6: 6RiVTYll/5D8zICp0MRpKw (big blind) folded before Flop
Seat 7: lOuxRXNpa9V2VxLMNpxUOg folded on the Flop
Seat 8: 8GJHzzxiotOqC5gdtgpLoA folded before Flop (didn't bet)
Seat 9: cZ99hugmLBj9KhTlc8nCSw folded before Flop (didn't bet)




PokerStars Game #59941739074:  Hold'em No Limit ($0.10/$0.25) - 2009/07/01 1:44:37 ET
Table 'pAhiNHs/spaABQia+7gWNQ' 9-max Seat #4 is the button
Seat 1: ipgcO7Pa6LC8XWpVttZfnA ($4.65 in chips) 
Seat 2: dfNim92Z6XK1/h5SFW5vDg ($25.25 in chips) 
Seat 4: Qduu7ikeizo6q6Ei9YvcJA ($24.65 in chips) 
Seat 5: OlPJsgR4xypSg/w1z7Gyvw ($32.65 in chips) 
Seat 6: oLa/tXLfSLLB28mcLGrxcg ($24.85 in chips) 
Seat 7: +WTkVY3GeLxqGQBbMZQiWQ ($5.90 in chips) 
Seat 8: PskTLlFIRHSp61inskRzVg ($14 in chips) 
Seat 9: zgi+EUykT/pZQpoUG6+oEg ($6.15 in chips) 
OlPJsgR4xypSg/w1z7Gyvw: posts small blind $0.10
oLa/tXLfSLLB28mcLGrxcg: posts big blind $0.25
bXpVeaSTPBFSPJmeXxO7nw: sits out 
*** HOLE CARDS ***
+WTkVY3GeLxqGQBbMZQiWQ: folds 
PskTLlFIRHSp61inskRzVg: folds 
zgi+EUykT/pZQpoUG6+oEg: folds 
ipgcO7Pa6LC8XWpVttZfnA: raises $0.75 to $1
dfNim92Z6XK1/h5SFW5vDg: folds 
Qduu7ikeizo6q6Ei9YvcJA: calls $1
OlPJsgR4xypSg/w1z7Gyvw: calls $0.90
oLa/tXLfSLLB28mcLGrxcg: calls $0.75
*** FLOP *** [Qs 2c 5c]
OlPJsgR4xypSg/w1z7Gyvw: checks 
oLa/tXLfSLLB28mcLGrxcg: checks 
ipgcO7Pa6LC8XWpVttZfnA: checks 
Qduu7ikeizo6q6Ei9YvcJA: bets $2.75
OlPJsgR4xypSg/w1z7Gyvw: folds 
oLa/tXLfSLLB28mcLGrxcg: raises $5.75 to $8.50
ipgcO7Pa6LC8XWpVttZfnA: folds 
Qduu7ikeizo6q6Ei9YvcJA: raises $15.15 to $23.65 and is all-in
oLa/tXLfSLLB28mcLGrxcg: calls $15.15
*** TURN *** [Qs 2c 5c] [Tc]
*** RIVER *** [Qs 2c 5c Tc] [Ks]
*** SHOW DOWN ***
oLa/tXLfSLLB28mcLGrxcg: shows [Ad Qc] (a pair of Queens)
Qduu7ikeizo6q6Ei9YvcJA: shows [5s 5d] (three of a kind, Fives)
Qduu7ikeizo6q6Ei9YvcJA collected $48.75 from pot
*** SUMMARY ***
Total pot $51.30 | Rake $2.55 
Board [Qs 2c 5c Tc Ks]
Seat 1: ipgcO7Pa6LC8XWpVttZfnA folded on the Flop
Seat 2: dfNim92Z6XK1/h5SFW5vDg folded before Flop (didn't bet)
Seat 4: Qduu7ikeizo6q6Ei9YvcJA (button) showed [5s 5d] and won ($48.75) with three of a kind, Fives
Seat 5: OlPJsgR4xypSg/w1z7Gyvw (small blind) folded on the Flop
Seat 6: oLa/tXLfSLLB28mcLGrxcg (big blind) showed [Ad Qc] and lost with a pair of Queens
Seat 7: +WTkVY3GeLxqGQBbMZQiWQ folded before Flop (didn't bet)
Seat 8: PskTLlFIRHSp61inskRzVg folded before Flop (didn't bet)
Seat 9: zgi+EUykT/pZQpoUG6+oEg folded before Flop (didn't bet)




PokerStars Game #59941739298:  Hold'em No Limit ($0.10/$0.25) - 2009/07/01 1:44:37 ET
Table 'IIO2q2znuuAXmiZ2qFTcmg' 6-max Seat #4 is the button
Seat 2: cS21pIxRHx5Gt42o7hPZzw ($24.80 in chips) 
Seat 3: L3/N/gliETan8N5Gim5h4Q ($25 in chips) 
Seat 4: tSR4329m40dZsN7YOpI9Kw ($56.50 in chips) 
Seat 5: 9U3ZKjCsarN0DjR6mSE8Ug ($15.60 in chips) 
Seat 6: aogAb4Eienxztk8p2v9VVw ($37.10 in chips) 
9U3ZKjCsarN0DjR6mSE8Ug: posts small blind $0.10
aogAb4Eienxztk8p2v9VVw: posts big blind $0.25
*** HOLE CARDS ***
cS21pIxRHx5Gt42o7hPZzw: folds 
L3/N/gliETan8N5Gim5h4Q: raises $0.50 to $0.75
tSR4329m40dZsN7YOpI9Kw: folds 
9U3ZKjCsarN0DjR6mSE8Ug: folds 
aogAb4Eienxztk8p2v9VVw: folds 
Uncalled bet ($0.50) returned to L3/N/gliETan8N5Gim5h4Q
L3/N/gliETan8N5Gim5h4Q collected $0.60 from pot
L3/N/gliETan8N5Gim5h4Q: doesn't show hand 
*** SUMMARY ***
Total pot $0.60 | Rake $0 
Seat 2: cS21pIxRHx5Gt42o7hPZzw folded before Flop (didn't bet)
Seat 3: L3/N/gliETan8N5Gim5h4Q collected ($0.60)
Seat 4: tSR4329m40dZsN7YOpI9Kw (button) folded before Flop (didn't bet)
Seat 5: 9U3ZKjCsarN0DjR6mSE8Ug (small blind) folded before Flop
Seat 6: aogAb4Eienxztk8p2v9VVw (big blind) folded before Flop




PokerStars Game #59941739294:  Hold'em No Limit ($0.10/$0.25) - 2009/07/01 1:44:37 ET
Table 'nyTW9cVtYentc5V7xU/0jA' 6-max Seat #4 is the button
Seat 1: HI20pVxSHPZ29u9IDkmICg ($12.35 in chips) 
Seat 2: v6mkGzCBCCXcgWQNSYVtKg ($6.15 in chips) 
Seat 3: kG34n23qFQA3nzdOJTQ1dA ($36.10 in chips) 
Seat 4: NkB3D4eVHHXvB9Edaugc1Q ($31.95 in chips) 
zZAcuQ0EvirdEuiIbeaocQ will be allowed to play after the button
HI20pVxSHPZ29u9IDkmICg: posts small blind $0.10
v6mkGzCBCCXcgWQNSYVtKg: posts big blind $0.25
*** HOLE CARDS ***
kG34n23qFQA3nzdOJTQ1dA: folds 
NkB3D4eVHHXvB9Edaugc1Q: folds 
HI20pVxSHPZ29u9IDkmICg: raises $0.50 to $0.75
v6mkGzCBCCXcgWQNSYVtKg: folds 
Uncalled bet ($0.50) returned to HI20pVxSHPZ29u9IDkmICg
HI20pVxSHPZ29u9IDkmICg collected $0.50 from pot
*** SUMMARY ***
Total pot $0.50 | Rake $0 
Seat 1: HI20pVxSHPZ29u9IDkmICg (small blind) collected ($0.50)
Seat 2: v6mkGzCBCCXcgWQNSYVtKg (big blind) folded before Flop
Seat 3: kG34n23qFQA3nzdOJTQ1dA folded before Flop (didn't bet)
Seat 4: NkB3D4eVHHXvB9Edaugc1Q (button) folded before Flop (didn't bet)




PokerStars Game #59941739210:  Hold'em No Limit ($0.10/$0.25) - 2009/07/01 1:44:37 ET
Table 'zW+7jPbOLCvlPu+dUGY5WQ' 6-max Seat #4 is the button
Seat 1: eL3+wCBjFGfQ5FMdIZihwA ($26.25 in chips) 
Seat 2: cEMJmfAUQZmMChZe6aacKw ($8.60 in chips) 
Seat 4: i48129QFpEQQ+UN4aNtmww ($20.55 in chips) 
Seat 6: qGHGf/553gQnDoklMRe3tg ($24.75 in chips) 
Hsvkc0/G2VV78oVmWYXecw will be allowed to play after the button
qGHGf/553gQnDoklMRe3tg: posts small blind $0.10
eL3+wCBjFGfQ5FMdIZihwA: posts big blind $0.25
*** HOLE CARDS ***
cEMJmfAUQZmMChZe6aacKw: folds 
i48129QFpEQQ+UN4aNtmww: calls $0.25
qGHGf/553gQnDoklMRe3tg: folds 
eL3+wCBjFGfQ5FMdIZihwA: checks 
*** FLOP *** [Ks Qd Ac]
eL3+wCBjFGfQ5FMdIZihwA: checks 
i48129QFpEQQ+UN4aNtmww: checks 
*** TURN *** [Ks Qd Ac] [3c]
eL3+wCBjFGfQ5FMdIZihwA: checks 
i48129QFpEQQ+UN4aNtmww: checks 
*** RIVER *** [Ks Qd Ac 3c] [5c]
eL3+wCBjFGfQ5FMdIZihwA: checks 
i48129QFpEQQ+UN4aNtmww: checks 
*** SHOW DOWN ***
eL3+wCBjFGfQ5FMdIZihwA: shows [7s 3h] (a pair of Threes)
i48129QFpEQQ+UN4aNtmww: mucks hand 
eL3+wCBjFGfQ5FMdIZihwA collected $0.60 from pot
*** SUMMARY ***
Total pot $0.60 | Rake $0 
Board [Ks Qd Ac 3c 5c]
Seat 1: eL3+wCBjFGfQ5FMdIZihwA (big blind) showed [7s 3h] and won ($0.60) with a pair of Threes
Seat 2: cEMJmfAUQZmMChZe6aacKw folded before Flop (didn't bet)
Seat 4: i48129QFpEQQ+UN4aNtmww (button) mucked
Seat 6: qGHGf/553gQnDoklMRe3tg (small blind) folded before Flop




PokerStars Game #59941739276:  Hold'em No Limit ($0.10/$0.25) - 2009/07/01 1:44:37 ET
Table 'ER5H84HUgJx7HyDLnELLeA' 6-max Seat #5 is the button
Seat 1: LJI7A1YgDM7hgh7o56+ReQ ($27.50 in chips) 
Seat 4: vqWjZmdQu/Hxw96/IJTWdQ ($25.25 in chips) 
Seat 5: mfrkWA3PTeYPkbO6hi98Aw ($25.20 in chips) 
Seat 6: 3zD3qLXT1bEffAoWGnc7wg ($51.10 in chips) 
3zD3qLXT1bEffAoWGnc7wg: posts small blind $0.10
LJI7A1YgDM7hgh7o56+ReQ: posts big blind $0.25
buyjetgNT1McXtdaP4zynA: sits out 
*** HOLE CARDS ***
vqWjZmdQu/Hxw96/IJTWdQ: raises $0.50 to $0.75
mfrkWA3PTeYPkbO6hi98Aw: folds 
3zD3qLXT1bEffAoWGnc7wg: folds 
LJI7A1YgDM7hgh7o56+ReQ: folds 
Uncalled bet ($0.50) returned to vqWjZmdQu/Hxw96/IJTWdQ
vqWjZmdQu/Hxw96/IJTWdQ collected $0.60 from pot
vqWjZmdQu/Hxw96/IJTWdQ: doesn't show hand 
*** SUMMARY ***
Total pot $0.60 | Rake $0 
Seat 1: LJI7A1YgDM7hgh7o56+ReQ (big blind) folded before Flop
Seat 4: vqWjZmdQu/Hxw96/IJTWdQ collected ($0.60)
Seat 5: mfrkWA3PTeYPkbO6hi98Aw (button) folded before Flop (didn't bet)
Seat 6: 3zD3qLXT1bEffAoWGnc7wg (small blind) folded before Flop




PokerStars Game #59941739908:  Hold'em No Limit ($0.10/$0.25) - 2009/07/01 1:44:38 ET
Table 'gYBWJG3hEuJg6kphY0yhMg' 9-max Seat #9 is the button
Seat 1: AcL/hxc9eT0dCr2TYk/0Dg ($21.45 in chips) 
Seat 2: RCqMONFrSPSArZh2Jsar/w ($20 in chips) 
Seat 3: wGigCmBR/9XWkPpvYos3aQ ($25.35 in chips) 
Seat 4: V6p0jQ/RhUsqpHLmXvEX4Q ($15.15 in chips) 
Seat 5: +sbyWwIcFp9kP0bDtMegfQ ($27.95 in chips) 
Seat 7: aIEQGxUJwm61WfazSNFCdA ($10.80 in chips) 
Seat 8: 7je+LC5Mfs6nL8YBVh4frQ ($5 in chips) 
Seat 9: Bb42QRQMhg5/Y0vHP8/2Xw ($28.55 in chips) 
AcL/hxc9eT0dCr2TYk/0Dg: posts small blind $0.10
RCqMONFrSPSArZh2Jsar/w: posts big blind $0.25
Z9W7+g1WMhhZDi7DwGbCFA: sits out 
aIEQGxUJwm61WfazSNFCdA: posts big blind $0.25
7je+LC5Mfs6nL8YBVh4frQ: posts big blind $0.25
*** HOLE CARDS ***
wGigCmBR/9XWkPpvYos3aQ: folds 
V6p0jQ/RhUsqpHLmXvEX4Q: raises $0.75 to $1
+sbyWwIcFp9kP0bDtMegfQ: folds 
aIEQGxUJwm61WfazSNFCdA: folds 
7je+LC5Mfs6nL8YBVh4frQ: folds 
Bb42QRQMhg5/Y0vHP8/2Xw: folds 
AcL/hxc9eT0dCr2TYk/0Dg: calls $0.90
RCqMONFrSPSArZh2Jsar/w: folds 
*** FLOP *** [3c Tc 9c]
AcL/hxc9eT0dCr2TYk/0Dg: bets $1
V6p0jQ/RhUsqpHLmXvEX4Q: raises $2 to $3
AcL/hxc9eT0dCr2TYk/0Dg: raises $2 to $5
V6p0jQ/RhUsqpHLmXvEX4Q: folds 
Uncalled bet ($2) returned to AcL/hxc9eT0dCr2TYk/0Dg
AcL/hxc9eT0dCr2TYk/0Dg collected $8.35 from pot
AcL/hxc9eT0dCr2TYk/0Dg: doesn't show hand 
*** SUMMARY ***
Total pot $8.75 | Rake $0.40 
Board [3c Tc 9c]
Seat 1: AcL/hxc9eT0dCr2TYk/0Dg (small blind) collected ($8.35)
Seat 2: RCqMONFrSPSArZh2Jsar/w (big blind) folded before Flop
Seat 3: wGigCmBR/9XWkPpvYos3aQ folded before Flop (didn't bet)
Seat 4: V6p0jQ/RhUsqpHLmXvEX4Q folded on the Flop
Seat 5: +sbyWwIcFp9kP0bDtMegfQ folded before Flop (didn't bet)
Seat 7: aIEQGxUJwm61WfazSNFCdA folded before Flop
Seat 8: 7je+LC5Mfs6nL8YBVh4frQ folded before Flop
Seat 9: Bb42QRQMhg5/Y0vHP8/2Xw (button) folded before Flop (didn't bet)




PokerStars Game #59941739990:  Hold'em No Limit ($0.10/$0.25) - 2009/07/01 1:44:38 ET
Table '+UzantPJ4smVdrh+4GTu1w' 6-max Seat #2 is the button
Seat 1: TSmua8tGK3sTbwi0ynrW9Q ($28.35 in chips) 
Seat 2: tcbEu7VzyHQ+0lh+skbQhQ ($41 in chips) 
Seat 3: SS/yfeArhULzIcOPe8MdPg ($33.80 in chips) 
Seat 4: UmcUp27+PbgBItv3ZNlAWQ ($25.50 in chips) 
Seat 5: cj4VBQya7HtVL2zCGd5jLQ ($57.30 in chips) 
Seat 6: fZQg9veL7Dd/Z04ZTjC+wQ ($25 in chips) 
SS/yfeArhULzIcOPe8MdPg: posts small blind $0.10
UmcUp27+PbgBItv3ZNlAWQ: posts big blind $0.25
*** HOLE CARDS ***
cj4VBQya7HtVL2zCGd5jLQ: calls $0.25
fZQg9veL7Dd/Z04ZTjC+wQ: folds 
TSmua8tGK3sTbwi0ynrW9Q: folds 
tcbEu7VzyHQ+0lh+skbQhQ: folds 
SS/yfeArhULzIcOPe8MdPg: calls $0.15
UmcUp27+PbgBItv3ZNlAWQ: raises $1 to $1.25
cj4VBQya7HtVL2zCGd5jLQ: calls $1
SS/yfeArhULzIcOPe8MdPg: folds 
*** FLOP *** [5c 9h 6d]
UmcUp27+PbgBItv3ZNlAWQ: bets $4
cj4VBQya7HtVL2zCGd5jLQ: folds 
Uncalled bet ($4) returned to UmcUp27+PbgBItv3ZNlAWQ
UmcUp27+PbgBItv3ZNlAWQ collected $2.65 from pot
UmcUp27+PbgBItv3ZNlAWQ: doesn't show hand 
*** SUMMARY ***
Total pot $2.75 | Rake $0.10 
Board [5c 9h 6d]
Seat 1: TSmua8tGK3sTbwi0ynrW9Q folded before Flop (didn't bet)
Seat 2: tcbEu7VzyHQ+0lh+skbQhQ (button) folded before Flop (didn't bet)
Seat 3: SS/yfeArhULzIcOPe8MdPg (small blind) folded before Flop
Seat 4: UmcUp27+PbgBItv3ZNlAWQ (big blind) collected ($2.65)
Seat 5: cj4VBQya7HtVL2zCGd5jLQ folded on the Flop
Seat 6: fZQg9veL7Dd/Z04ZTjC+wQ folded before Flop (didn't bet)




PokerStars Game #59941739750:  Hold'em No Limit ($0.10/$0.25) - 2009/07/01 1:44:38 ET
Table 'Qk/910N2Yhg8u5vqTJk50Q' 9-max Seat #9 is the button
Seat 2: Th3FldXKQW6hWVVPahaoOQ ($45.15 in chips) 
Seat 3: ghNKXUBl/H+t83JF079ZBA ($26 in chips) 
Seat 5: zReBEigsxqZnag0RZAgpgA ($15.25 in chips) 
Seat 6: nAWaA+gDUSWOad+I9mKUEg ($11 in chips) 
Seat 7: aNpwfA31EREwO+ar4XzBCw ($26.35 in chips) 
Seat 8: 9PMD136+PrUsTwnP6fczyA ($12.65 in chips) 
Seat 9: M2QO2DxB5Wawg2h8HSpnYA ($17.70 in chips) 
Th3FldXKQW6hWVVPahaoOQ: posts small blind $0.10
ghNKXUBl/H+t83JF079ZBA: posts big blind $0.25
*** HOLE CARDS ***
zReBEigsxqZnag0RZAgpgA: folds 
nAWaA+gDUSWOad+I9mKUEg: calls $0.25
aNpwfA31EREwO+ar4XzBCw: folds 
9PMD136+PrUsTwnP6fczyA: folds 
M2QO2DxB5Wawg2h8HSpnYA: folds 
Th3FldXKQW6hWVVPahaoOQ: folds 
ghNKXUBl/H+t83JF079ZBA: checks 
*** FLOP *** [6c Ts 4h]
ghNKXUBl/H+t83JF079ZBA: checks 
nAWaA+gDUSWOad+I9mKUEg: bets $0.25
ghNKXUBl/H+t83JF079ZBA: folds 
Uncalled bet ($0.25) returned to nAWaA+gDUSWOad+I9mKUEg
nAWaA+gDUSWOad+I9mKUEg collected $0.60 from pot
nAWaA+gDUSWOad+I9mKUEg: doesn't show hand 
*** SUMMARY ***
Total pot $0.60 | Rake $0 
Board [6c Ts 4h]
Seat 2: Th3FldXKQW6hWVVPahaoOQ (small blind) folded before Flop
Seat 3: ghNKXUBl/H+t83JF079ZBA (big blind) folded on the Flop
Seat 5: zReBEigsxqZnag0RZAgpgA folded before Flop (didn't bet)
Seat 6: nAWaA+gDUSWOad+I9mKUEg collected ($0.60)
Seat 7: aNpwfA31EREwO+ar4XzBCw folded before Flop (didn't bet)
Seat 8: 9PMD136+PrUsTwnP6fczyA folded before Flop (didn't bet)
Seat 9: M2QO2DxB5Wawg2h8HSpnYA (button) folded before Flop (didn't bet)




PokerStars Game #59941740494:  Hold'em No Limit ($0.10/$0.25) - 2009/07/01 1:44:39 ET
Table 'nlpa8xI95gAflovnFxB2yg' 6-max Seat #5 is the button
Seat 1: fZQg9veL7Dd/Z04ZTjC+wQ ($62.15 in chips) 
Seat 2: Yuyy/pDz3yAO3EbHYRYnKw ($24.40 in chips) 
Seat 3: DihMHaz4WNETH1bPDe13kA ($25 in chips) 
Seat 4: if4dh6jhJXeN3/qd3qCp9g ($50.40 in chips) 
Seat 5: FDWzjQgBA5K04jOIY/j22w ($7.55 in chips) 
Seat 6: ATNFxN8fYVfSZMQW8dvbvw ($5.40 in chips) 
ATNFxN8fYVfSZMQW8dvbvw: posts small blind $0.10
fZQg9veL7Dd/Z04ZTjC+wQ: posts big blind $0.25
*** HOLE CARDS ***
Yuyy/pDz3yAO3EbHYRYnKw: folds 
DihMHaz4WNETH1bPDe13kA: folds 
if4dh6jhJXeN3/qd3qCp9g said, "oo"
if4dh6jhJXeN3/qd3qCp9g: raises $0.50 to $0.75
FDWzjQgBA5K04jOIY/j22w: calls $0.75
ATNFxN8fYVfSZMQW8dvbvw: folds 
fZQg9veL7Dd/Z04ZTjC+wQ: folds 
*** FLOP *** [Qs 4h 2h]
if4dh6jhJXeN3/qd3qCp9g: bets $1
FDWzjQgBA5K04jOIY/j22w: calls $1
*** TURN *** [Qs 4h 2h] [7s]
if4dh6jhJXeN3/qd3qCp9g: checks 
FDWzjQgBA5K04jOIY/j22w: checks 
*** RIVER *** [Qs 4h 2h 7s] [Jc]
if4dh6jhJXeN3/qd3qCp9g: checks 
FDWzjQgBA5K04jOIY/j22w: checks 
*** SHOW DOWN ***
if4dh6jhJXeN3/qd3qCp9g: shows [Ad 9d] (high card Ace)
FDWzjQgBA5K04jOIY/j22w: mucks hand 
if4dh6jhJXeN3/qd3qCp9g collected $3.70 from pot
*** SUMMARY ***
Total pot $3.85 | Rake $0.15 
Board [Qs 4h 2h 7s Jc]
Seat 1: fZQg9veL7Dd/Z04ZTjC+wQ (big blind) folded before Flop
Seat 2: Yuyy/pDz3yAO3EbHYRYnKw folded before Flop (didn't bet)
Seat 3: DihMHaz4WNETH1bPDe13kA folded before Flop (didn't bet)
Seat 4: if4dh6jhJXeN3/qd3qCp9g showed [Ad 9d] and won ($3.70) with high card Ace
Seat 5: FDWzjQgBA5K04jOIY/j22w (button) mucked
Seat 6: ATNFxN8fYVfSZMQW8dvbvw (small blind) folded before Flop




PokerStars Game #59941740456:  Hold'em No Limit ($0.10/$0.25) - 2009/07/01 1:44:39 ET
Table 'rjcb+nlE+0GuJ6lBhuCkkA' 6-max Seat #4 is the button
Seat 1: lBoEwOFgzcERLIRUkUoRTw ($13.60 in chips) 
Seat 2: lJphax9e7/+O/3YCKPJ0yQ ($6.35 in chips) 
Seat 3: 8ClCHtFXGNplITm+63KB+Q ($66.15 in chips) 
Seat 4: BV+K0Phf5VBHr7aZPKqbUQ ($36.40 in chips) 
Seat 5: GC/9yVD59DUCX7hUI7gcLw ($29.25 in chips) 
Seat 6: 32YL2ZEp8NT4JB2RVM9euQ ($15.65 in chips) 
GC/9yVD59DUCX7hUI7gcLw: posts small blind $0.10
32YL2ZEp8NT4JB2RVM9euQ: posts big blind $0.25
*** HOLE CARDS ***
lBoEwOFgzcERLIRUkUoRTw: folds 
lJphax9e7/+O/3YCKPJ0yQ: calls $0.25
8ClCHtFXGNplITm+63KB+Q: folds 
BV+K0Phf5VBHr7aZPKqbUQ: folds 
GC/9yVD59DUCX7hUI7gcLw: calls $0.15
32YL2ZEp8NT4JB2RVM9euQ: checks 
*** FLOP *** [4d 5h 6d]
GC/9yVD59DUCX7hUI7gcLw: checks 
32YL2ZEp8NT4JB2RVM9euQ: bets $0.75
lJphax9e7/+O/3YCKPJ0yQ: folds 
GC/9yVD59DUCX7hUI7gcLw: folds 
Uncalled bet ($0.75) returned to 32YL2ZEp8NT4JB2RVM9euQ
32YL2ZEp8NT4JB2RVM9euQ collected $0.75 from pot
32YL2ZEp8NT4JB2RVM9euQ: doesn't show hand 
*** SUMMARY ***
Total pot $0.75 | Rake $0 
Board [4d 5h 6d]
Seat 1: lBoEwOFgzcERLIRUkUoRTw folded before Flop (didn't bet)
Seat 2: lJphax9e7/+O/3YCKPJ0yQ folded on the Flop
Seat 3: 8ClCHtFXGNplITm+63KB+Q folded before Flop (didn't bet)
Seat 4: BV+K0Phf5VBHr7aZPKqbUQ (button) folded before Flop (didn't bet)
Seat 5: GC/9yVD59DUCX7hUI7gcLw (small blind) folded on the Flop
Seat 6: 32YL2ZEp8NT4JB2RVM9euQ (big blind) collected ($0.75)




PokerStars Game #59941740464:  Hold'em No Limit ($0.10/$0.25) - 2009/07/01 1:44:39 ET
Table '9iHhO6FyZVM8XpSc23TIgg' 6-max Seat #3 is the button
Seat 1: NhUN/JpAprdJeamFBgJH1w ($37.40 in chips) 
Seat 2: bJFzs6QmEEnz4miMfSDtcg ($40.05 in chips) 
Seat 3: TSmua8tGK3sTbwi0ynrW9Q ($26.50 in chips) 
Seat 5: xrf8tAXKQHG99HixCot1Iw ($78.95 in chips) 
Seat 6: iyZxqznXjv3vtvOJymkoLQ ($34.10 in chips) 
xrf8tAXKQHG99HixCot1Iw: posts small blind $0.10
iyZxqznXjv3vtvOJymkoLQ: posts big blind $0.25
*** HOLE CARDS ***
cfJccEfyn6IkquPN08hFsA has returned
bJFzs6QmEEnz4miMfSDtcg said, "zzzzzzzzzz"
NhUN/JpAprdJeamFBgJH1w: folds 
bJFzs6QmEEnz4miMfSDtcg: folds 
bJFzs6QmEEnz4miMfSDtcg said, "woulda doubled through both of u"
TSmua8tGK3sTbwi0ynrW9Q: folds 
xrf8tAXKQHG99HixCot1Iw: folds 
Uncalled bet ($0.15) returned to iyZxqznXjv3vtvOJymkoLQ
xrf8tAXKQHG99HixCot1Iw leaves the table
iyZxqznXjv3vtvOJymkoLQ collected $0.20 from pot
bJFzs6QmEEnz4miMfSDtcg said, "jacks"
iyZxqznXjv3vtvOJymkoLQ: doesn't show hand 
*** SUMMARY ***
Total pot $0.20 | Rake $0 
Seat 1: NhUN/JpAprdJeamFBgJH1w folded before Flop (didn't bet)
Seat 2: bJFzs6QmEEnz4miMfSDtcg folded before Flop (didn't bet)
Seat 3: TSmua8tGK3sTbwi0ynrW9Q (button) folded before Flop (didn't bet)
Seat 5: xrf8tAXKQHG99HixCot1Iw (small blind) folded before Flop
Seat 6: iyZxqznXjv3vtvOJymkoLQ (big blind) collected ($0.20)




PokerStars Game #59941740272:  Hold'em No Limit ($0.10/$0.25) - 2009/07/01 1:44:39 ET
Table 'BpNkESDX1ip9c0K1hb5h7A' 6-max Seat #4 is the button
Seat 1: 5YZdVjBPZVEdubN4xEMPEg ($31.75 in chips) 
Seat 3: fZQg9veL7Dd/Z04ZTjC+wQ ($27.90 in chips) 
Seat 4: kG34n23qFQA3nzdOJTQ1dA ($25.55 in chips) 
Seat 5: L3/N/gliETan8N5Gim5h4Q ($25.50 in chips) 
Seat 6: 8EEqTTh7T1q48sYDqbI2Xg ($21.15 in chips) 
L3/N/gliETan8N5Gim5h4Q: posts small blind $0.10
8EEqTTh7T1q48sYDqbI2Xg: posts big blind $0.25
9U3ZKjCsarN0DjR6mSE8Ug: sits out 
*** HOLE CARDS ***
5YZdVjBPZVEdubN4xEMPEg: folds 
fZQg9veL7Dd/Z04ZTjC+wQ: folds 
kG34n23qFQA3nzdOJTQ1dA: folds 
L3/N/gliETan8N5Gim5h4Q: folds 
Uncalled bet ($0.15) returned to 8EEqTTh7T1q48sYDqbI2Xg
8EEqTTh7T1q48sYDqbI2Xg collected $0.20 from pot
8EEqTTh7T1q48sYDqbI2Xg: doesn't show hand 
*** SUMMARY ***
Total pot $0.20 | Rake $0 
Seat 1: 5YZdVjBPZVEdubN4xEMPEg folded before Flop (didn't bet)
Seat 3: fZQg9veL7Dd/Z04ZTjC+wQ folded before Flop (didn't bet)
Seat 4: kG34n23qFQA3nzdOJTQ1dA (button) folded before Flop (didn't bet)
Seat 5: L3/N/gliETan8N5Gim5h4Q (small blind) folded before Flop
Seat 6: 8EEqTTh7T1q48sYDqbI2Xg (big blind) collected ($0.20)




PokerStars Game #59941740790:  Hold'em No Limit ($0.10/$0.25) - 2009/07/01 1:44:40 ET
Table 'JUMeG5SzDyo9HufhgemQeA' 9-max Seat #7 is the button
Seat 1: oLa/tXLfSLLB28mcLGrxcg ($24.55 in chips) 
Seat 2: Jve2LRs9vtGL7NdiNeXY/A ($15.50 in chips) 
Seat 3: IEvLSTIxhlti3EjZDarYnA ($32.50 in chips) 
Seat 4: 9+Um1wMtYNWnmPLUEU4viQ ($17.65 in chips) 
Seat 5: Ne5zBB6oEKrbigKRh6d6Xg ($10.25 in chips) 
Seat 6: wFCwdYKUXoQHhz8qeZuuAw ($24.60 in chips) 
Seat 7: aNpwfA31EREwO+ar4XzBCw ($32.15 in chips) 
Seat 9: V6p0jQ/RhUsqpHLmXvEX4Q ($13.55 in chips) 
V6p0jQ/RhUsqpHLmXvEX4Q: posts small blind $0.10
oLa/tXLfSLLB28mcLGrxcg: posts big blind $0.25
*** HOLE CARDS ***
Jve2LRs9vtGL7NdiNeXY/A: folds 
IEvLSTIxhlti3EjZDarYnA: raises $0.50 to $0.75
9+Um1wMtYNWnmPLUEU4viQ: folds 
Ne5zBB6oEKrbigKRh6d6Xg: calls $0.75
wFCwdYKUXoQHhz8qeZuuAw: folds 
aNpwfA31EREwO+ar4XzBCw: folds 
V6p0jQ/RhUsqpHLmXvEX4Q: folds 
zDrucyjVn5aeekNEc3cJrA has returned
oLa/tXLfSLLB28mcLGrxcg: folds 
*** FLOP *** [7s 4c 9d]
IEvLSTIxhlti3EjZDarYnA: checks 
Ne5zBB6oEKrbigKRh6d6Xg: bets $1
IEvLSTIxhlti3EjZDarYnA: folds 
Uncalled bet ($1) returned to Ne5zBB6oEKrbigKRh6d6Xg
Ne5zBB6oEKrbigKRh6d6Xg collected $1.80 from pot
*** SUMMARY ***
Total pot $1.85 | Rake $0.05 
Board [7s 4c 9d]
Seat 1: oLa/tXLfSLLB28mcLGrxcg (big blind) folded before Flop
Seat 2: Jve2LRs9vtGL7NdiNeXY/A folded before Flop (didn't bet)
Seat 3: IEvLSTIxhlti3EjZDarYnA folded on the Flop
Seat 4: 9+Um1wMtYNWnmPLUEU4viQ folded before Flop (didn't bet)
Seat 5: Ne5zBB6oEKrbigKRh6d6Xg collected ($1.80)
Seat 6: wFCwdYKUXoQHhz8qeZuuAw folded before Flop (didn't bet)
Seat 7: aNpwfA31EREwO+ar4XzBCw (button) folded before Flop (didn't bet)
Seat 9: V6p0jQ/RhUsqpHLmXvEX4Q (small blind) folded before Flop




