PokerStars Game #59937793530:  Hold'em No Limit ($1/$2) - 2009/07/01 0:00:00 ET
Table 'uJ9juaXXg9yIcSU8amxaXQ' 6-max Seat #2 is the button
Seat 1: HhIxv6mylwCAfv3sjJmq5g ($208.75 in chips)
Seat 2: DQlskgG4OtLpF2MVxLwf4A ($269.45 in chips)
Seat 3: zaogaltCDFVsIASEnrXs2w ($247.15 in chips)
Seat 5: F/075N6nU34Fn0zr6qD3aw ($237.05 in chips)
Seat 6: XrFG4dK06RVKLlX32/pjcQ ($47.90 in chips)
zaogaltCDFVsIASEnrXs2w: posts small blind $1
/PH6Ffnho4Ysm8S3V/oa+w: is sitting out
F/075N6nU34Fn0zr6qD3aw: posts big blind $2
*** HOLE CARDS ***
/PH6Ffnho4Ysm8S3V/oa+w has returned
/PH6Ffnho4Ysm8S3V/oa+w leaves the table
XrFG4dK06RVKLlX32/pjcQ: calls $2
HhIxv6mylwCAfv3sjJmq5g: folds
DQlskgG4OtLpF2MVxLwf4A: calls $2
zaogaltCDFVsIASEnrXs2w: calls $1
F/075N6nU34Fn0zr6qD3aw: checks
*** FLOP *** [6h Td Kd]
zaogaltCDFVsIASEnrXs2w: checks
F/075N6nU34Fn0zr6qD3aw: bets $4
XrFG4dK06RVKLlX32/pjcQ: folds
DQlskgG4OtLpF2MVxLwf4A: raises $8 to $12
zaogaltCDFVsIASEnrXs2w: folds
F/075N6nU34Fn0zr6qD3aw: folds
DQlskgG4OtLpF2MVxLwf4A collected $15.25 from pot
DQlskgG4OtLpF2MVxLwf4A: doesn't show hand
*** SUMMARY ***
Total pot $16 | Rake $0.75
Board [6h Td Kd]
Seat 1: HhIxv6mylwCAfv3sjJmq5g folded before Flop (didn't bet)
Seat 2: DQlskgG4OtLpF2MVxLwf4A (button) collected ($15.25)
Seat 3: zaogaltCDFVsIASEnrXs2w (small blind) folded on the Flop
Seat 5: F/075N6nU34Fn0zr6qD3aw (big blind) folded on the Flop
Seat 6: XrFG4dK06RVKLlX32/pjcQ folded on the Flop



PokerStars Game #59937793454:  Hold'em No Limit ($1/$2) - 2009/07/01 0:00:00 ET
Table 'ztv6V3FN2bQ9nmJPPdx6nQ' 6-max Seat #5 is the button
Seat 1: ek1hig03QiyONDHXvgqteQ ($199.75 in chips)
Seat 2: MQj83PQbe4xrqde2bUtorQ ($294.70 in chips)
Seat 3: Z55K9DbCHCUi6UaztIHi6g ($144.45 in chips)
Seat 4: vkfxu8f/jMYKUk6Ly4eujw ($318.70 in chips)
Seat 5: sTPOWERd9HWPCNrDBwsVjA ($200 in chips)
Seat 6: yZgdnRylE65JbScQ7qCWgw ($38 in chips)
yZgdnRylE65JbScQ7qCWgw: posts small blind $1
ek1hig03QiyONDHXvgqteQ: posts big blind $2
*** HOLE CARDS ***
MQj83PQbe4xrqde2bUtorQ: folds
Z55K9DbCHCUi6UaztIHi6g: folds
vkfxu8f/jMYKUk6Ly4eujw: raises $6 to $8
sTPOWERd9HWPCNrDBwsVjA: folds
yZgdnRylE65JbScQ7qCWgw: folds
ek1hig03QiyONDHXvgqteQ: folds
vkfxu8f/jMYKUk6Ly4eujw collected $5 from pot
vkfxu8f/jMYKUk6Ly4eujw: doesn't show hand
*** SUMMARY ***
Total pot $5 | Rake $0
Seat 1: ek1hig03QiyONDHXvgqteQ (big blind) folded before Flop
Seat 2: MQj83PQbe4xrqde2bUtorQ folded before Flop (didn't bet)
Seat 3: Z55K9DbCHCUi6UaztIHi6g folded before Flop (didn't bet)
Seat 4: vkfxu8f/jMYKUk6Ly4eujw collected ($5)
Seat 5: sTPOWERd9HWPCNrDBwsVjA (button) folded before Flop (didn't bet)
Seat 6: yZgdnRylE65JbScQ7qCWgw (small blind) folded before Flop



PokerStars Game #59937796680:  Hold'em No Limit ($1/$2) - 2009/07/01 0:00:03 ET
Table 'on4i1U1lCRmxsduFD3xiSg' 9-max Seat #9 is the button
Seat 1: BRHGptvmY2GKq4uuj7duDw ($278.60 in chips)
Seat 2: yZYrOeNDxQxkzpbgKX1bng ($70 in chips)
Seat 3: 5iPk5MyO3KVu18Y8XCYfFQ ($61.20 in chips)
Seat 4: Z3aYCZG/yXHYFjiWkGI5ug ($207.30 in chips)
Seat 5: QHxJjpVYwitg9krW6wZgJA ($200 in chips)
Seat 6: SB0tvOX0Kw61r2U851JFaA ($399.50 in chips)
Seat 7: xD4ElYxz6Ollzmam8BmMCw ($249.25 in chips)
Seat 8: YlSX2xwu8QMQReaxSAD8XA ($164.85 in chips)
Seat 9: iMe5yhc+1BaiIPHet3NMrA ($200 in chips)
BRHGptvmY2GKq4uuj7duDw: posts small blind $1
yZYrOeNDxQxkzpbgKX1bng: posts big blind $2
*** HOLE CARDS ***
5iPk5MyO3KVu18Y8XCYfFQ: folds
Z3aYCZG/yXHYFjiWkGI5ug: folds
QHxJjpVYwitg9krW6wZgJA: folds
SB0tvOX0Kw61r2U851JFaA: calls $2
xD4ElYxz6Ollzmam8BmMCw: folds
YlSX2xwu8QMQReaxSAD8XA: folds
iMe5yhc+1BaiIPHet3NMrA: folds
BRHGptvmY2GKq4uuj7duDw: calls $1
yZYrOeNDxQxkzpbgKX1bng: checks
*** FLOP *** [Qh 4c 4d]
BRHGptvmY2GKq4uuj7duDw: checks
yZYrOeNDxQxkzpbgKX1bng: checks
SB0tvOX0Kw61r2U851JFaA: checks
*** TURN *** [Qh 4c 4d] [Js]
BRHGptvmY2GKq4uuj7duDw: checks
yZYrOeNDxQxkzpbgKX1bng: checks
SB0tvOX0Kw61r2U851JFaA: bets $4
BRHGptvmY2GKq4uuj7duDw: folds
yZYrOeNDxQxkzpbgKX1bng: folds
SB0tvOX0Kw61r2U851JFaA collected $5.70 from pot
*** SUMMARY ***
Total pot $6 | Rake $0.30
Board [Qh 4c 4d Js]
Seat 1: BRHGptvmY2GKq4uuj7duDw (small blind) folded on the Turn
Seat 2: yZYrOeNDxQxkzpbgKX1bng (big blind) folded on the Turn
Seat 3: 5iPk5MyO3KVu18Y8XCYfFQ folded before Flop (didn't bet)
Seat 4: Z3aYCZG/yXHYFjiWkGI5ug folded before Flop (didn't bet)
Seat 5: QHxJjpVYwitg9krW6wZgJA folded before Flop (didn't bet)
Seat 6: SB0tvOX0Kw61r2U851JFaA collected ($5.70)
Seat 7: xD4ElYxz6Ollzmam8BmMCw folded before Flop (didn't bet)
Seat 8: YlSX2xwu8QMQReaxSAD8XA folded before Flop (didn't bet)
Seat 9: iMe5yhc+1BaiIPHet3NMrA (button) folded before Flop (didn't bet)



PokerStars Game #59937797220:  Hold'em No Limit ($1/$2) - 2009/07/01 0:00:04 ET
Table 'RF+CoNlqGlniDSszIP2SGw' 2-max Seat #2 is the button
Seat 1: e0oDWyrmgLpR6bROEqw1nQ ($252.50 in chips)
Seat 2: jKzajniHFCiIQAQeNkmTGg ($367.50 in chips)
jKzajniHFCiIQAQeNkmTGg: posts small blind $1
e0oDWyrmgLpR6bROEqw1nQ: posts big blind $2
*** HOLE CARDS ***
jKzajniHFCiIQAQeNkmTGg: folds
e0oDWyrmgLpR6bROEqw1nQ collected $2 from pot
*** SUMMARY ***
Total pot $2 | Rake $0
Seat 1: e0oDWyrmgLpR6bROEqw1nQ (big blind) collected ($2)
Seat 2: jKzajniHFCiIQAQeNkmTGg (button) (small blind) folded before Flop



PokerStars Game #59937800352:  Hold'em No Limit ($1/$2) - 2009/07/01 0:00:08 ET
Table 'HewZCzVOYGmuLDKthTi5Yw' 6-max Seat #4 is the button
Seat 1: 353332 ($226.75 in chips)
Seat 2: X7GlkHF+lkbarCLuZ4Uf0w ($37 in chips)
Seat 4: yZgdnRylE65JbScQ7qCWgw ($41 in chips)
Seat 5: 513FcCI8jHyQy2VWoIQkMg ($375.50 in chips)
513FcCI8jHyQy2VWoIQkMg: posts small blind $1
h7ppRQJTYBsHCbLMeW9T2g: is sitting out
353332: posts big blind $2
*** HOLE CARDS ***
h7ppRQJTYBsHCbLMeW9T2g leaves the table
X7GlkHF+lkbarCLuZ4Uf0w: folds
yZgdnRylE65JbScQ7qCWgw: folds
513FcCI8jHyQy2VWoIQkMg: folds
353332 collected $2 from pot
353332: doesn't show hand
*** SUMMARY ***
Total pot $2 | Rake $0
Seat 1: 353332 (big blind) collected ($2)
Seat 2: X7GlkHF+lkbarCLuZ4Uf0w folded before Flop (didn't bet)
Seat 4: yZgdnRylE65JbScQ7qCWgw (button) folded before Flop (didn't bet)
Seat 5: 513FcCI8jHyQy2VWoIQkMg (small blind) folded before Flop



PokerStars Game #59937801888:  Hold'em No Limit ($1/$2) - 2009/07/01 0:00:10 ET
Table 'RF+CoNlqGlniDSszIP2SGw' 2-max Seat #1 is the button
Seat 1: e0oDWyrmgLpR6bROEqw1nQ ($253.50 in chips)
Seat 2: jKzajniHFCiIQAQeNkmTGg ($366.50 in chips)
e0oDWyrmgLpR6bROEqw1nQ: posts small blind $1
jKzajniHFCiIQAQeNkmTGg: posts big blind $2
*** HOLE CARDS ***
e0oDWyrmgLpR6bROEqw1nQ: raises $4 to $6
jKzajniHFCiIQAQeNkmTGg: folds
e0oDWyrmgLpR6bROEqw1nQ collected $4 from pot
*** SUMMARY ***
Total pot $4 | Rake $0
Seat 1: e0oDWyrmgLpR6bROEqw1nQ (button) (small blind) collected ($4)
Seat 2: jKzajniHFCiIQAQeNkmTGg (big blind) folded before Flop



PokerStars Game #59937803118:  Hold'em No Limit ($1/$2) - 2009/07/01 0:00:12 ET
Table 'rsKRKlGHlxVyqJxzO2a2Ow' 9-max Seat #8 is the button
Seat 1: uYWfQJg2hgHLxri6/uVJiw ($183.30 in chips)
Seat 2: QHxJjpVYwitg9krW6wZgJA ($248 in chips)
Seat 3: 9sYbXdhj1M2bwKrVNxj5+Q ($93.80 in chips)
Seat 4: zJtQ1gxyi72XvGYS1tM+DA ($53.15 in chips)
Seat 5: QxGDcfm0Yb34yQ4T9e1PIA ($176.90 in chips)
Seat 6: H6Z4+qu8gR0VUiPOijndVg ($200 in chips)
Seat 7: kVCeGJ4NY7Fb0W74j1mAqA ($200 in chips)
Seat 8: Hc2itIxwbi1lwa+DAYYQGg ($46 in chips)
Seat 9: 5iPk5MyO3KVu18Y8XCYfFQ ($48.60 in chips)
5iPk5MyO3KVu18Y8XCYfFQ: posts small blind $1
uYWfQJg2hgHLxri6/uVJiw: posts big blind $2
*** HOLE CARDS ***
QHxJjpVYwitg9krW6wZgJA: folds
9sYbXdhj1M2bwKrVNxj5+Q: folds
zJtQ1gxyi72XvGYS1tM+DA: folds
QxGDcfm0Yb34yQ4T9e1PIA: folds
H6Z4+qu8gR0VUiPOijndVg: folds
kVCeGJ4NY7Fb0W74j1mAqA: folds
Hc2itIxwbi1lwa+DAYYQGg: folds
5iPk5MyO3KVu18Y8XCYfFQ: folds
uYWfQJg2hgHLxri6/uVJiw collected $2 from pot
uYWfQJg2hgHLxri6/uVJiw: doesn't show hand
*** SUMMARY ***
Total pot $2 | Rake $0
Seat 1: uYWfQJg2hgHLxri6/uVJiw (big blind) collected ($2)
Seat 2: QHxJjpVYwitg9krW6wZgJA folded before Flop (didn't bet)
Seat 3: 9sYbXdhj1M2bwKrVNxj5+Q folded before Flop (didn't bet)
Seat 4: zJtQ1gxyi72XvGYS1tM+DA folded before Flop (didn't bet)
Seat 5: QxGDcfm0Yb34yQ4T9e1PIA folded before Flop (didn't bet)
Seat 6: H6Z4+qu8gR0VUiPOijndVg folded before Flop (didn't bet)
Seat 7: kVCeGJ4NY7Fb0W74j1mAqA folded before Flop (didn't bet)
Seat 8: Hc2itIxwbi1lwa+DAYYQGg (button) folded before Flop (didn't bet)
Seat 9: 5iPk5MyO3KVu18Y8XCYfFQ (small blind) folded before Flop



PokerStars Game #59937803452:  Hold'em No Limit ($1/$2) - 2009/07/01 0:00:13 ET
Table 'CFkQcfWjKccZaZDf71FK+w' 6-max Seat #2 is the button
Seat 1: X7GlkHF+lkbarCLuZ4Uf0w ($37 in chips)
Seat 2: yZgdnRylE65JbScQ7qCWgw ($37 in chips)
Seat 3: ygTTt5ehT4aF86q1a8/R+w ($125.40 in chips)
Seat 4: B2Ih1sr5VZk+8He7rcrMtQ ($218.90 in chips)
Seat 5: 1njbh8TKSUF6l4V1XwGdcg ($200 in chips)
Seat 6: ORVqY3rf9X6ANA/8s+On2Q ($91 in chips)
ygTTt5ehT4aF86q1a8/R+w: posts small blind $1
B2Ih1sr5VZk+8He7rcrMtQ: posts big blind $2
*** HOLE CARDS ***
1njbh8TKSUF6l4V1XwGdcg: folds
ORVqY3rf9X6ANA/8s+On2Q: folds
X7GlkHF+lkbarCLuZ4Uf0w: folds
yZgdnRylE65JbScQ7qCWgw: folds
ygTTt5ehT4aF86q1a8/R+w: folds
B2Ih1sr5VZk+8He7rcrMtQ collected $2 from pot
*** SUMMARY ***
Total pot $2 | Rake $0
Seat 1: X7GlkHF+lkbarCLuZ4Uf0w folded before Flop (didn't bet)
Seat 2: yZgdnRylE65JbScQ7qCWgw (button) folded before Flop (didn't bet)
Seat 3: ygTTt5ehT4aF86q1a8/R+w (small blind) folded before Flop
Seat 4: B2Ih1sr5VZk+8He7rcrMtQ (big blind) collected ($2)
Seat 5: 1njbh8TKSUF6l4V1XwGdcg folded before Flop (didn't bet)
Seat 6: ORVqY3rf9X6ANA/8s+On2Q folded before Flop (didn't bet)



PokerStars Game #59937804058:  Hold'em No Limit ($1/$2) - 2009/07/01 0:00:14 ET
Table 'fe+AlpfadsfwxhZEvYFbbA' 6-max Seat #6 is the button
Seat 1: SLlqn2PPbQqwfcLfYqUXrw ($106.30 in chips)
Seat 2: /PH6Ffnho4Ysm8S3V/oa+w ($40 in chips)
Seat 3: 54yWzRRgS0oZ+S6LwZBxMQ ($33.65 in chips)
Seat 5: gGPaCoSWW1HoKYaqfAPecg ($202.20 in chips)
Seat 6: 5Y+ZGWLI4gnlpApDX5vy1A ($203 in chips)
SLlqn2PPbQqwfcLfYqUXrw: posts small blind $1
/PH6Ffnho4Ysm8S3V/oa+w: posts big blind $2
*** HOLE CARDS ***
54yWzRRgS0oZ+S6LwZBxMQ: folds
gGPaCoSWW1HoKYaqfAPecg: folds
5Y+ZGWLI4gnlpApDX5vy1A: folds
SLlqn2PPbQqwfcLfYqUXrw: calls $1
/PH6Ffnho4Ysm8S3V/oa+w: checks
*** FLOP *** [3d 9h Jh]
SLlqn2PPbQqwfcLfYqUXrw: bets $4
/PH6Ffnho4Ysm8S3V/oa+w: folds
SLlqn2PPbQqwfcLfYqUXrw collected $3.80 from pot
*** SUMMARY ***
Total pot $4 | Rake $0.20
Board [3d 9h Jh]
Seat 1: SLlqn2PPbQqwfcLfYqUXrw (small blind) collected ($3.80)
Seat 2: /PH6Ffnho4Ysm8S3V/oa+w (big blind) folded on the Flop
Seat 3: 54yWzRRgS0oZ+S6LwZBxMQ folded before Flop (didn't bet)
Seat 5: gGPaCoSWW1HoKYaqfAPecg folded before Flop (didn't bet)
Seat 6: 5Y+ZGWLI4gnlpApDX5vy1A (button) folded before Flop (didn't bet)



PokerStars Game #59937809544:  Hold'em No Limit ($1/$2) - 2009/07/01 0:00:21 ET
Table 'RF+CoNlqGlniDSszIP2SGw' 2-max Seat #2 is the button
Seat 1: e0oDWyrmgLpR6bROEqw1nQ ($255.50 in chips)
Seat 2: jKzajniHFCiIQAQeNkmTGg ($364.50 in chips)
jKzajniHFCiIQAQeNkmTGg: posts small blind $1
e0oDWyrmgLpR6bROEqw1nQ: posts big blind $2
*** HOLE CARDS ***
jKzajniHFCiIQAQeNkmTGg: raises $2 to $4
e0oDWyrmgLpR6bROEqw1nQ: folds
jKzajniHFCiIQAQeNkmTGg collected $4 from pot
jKzajniHFCiIQAQeNkmTGg: doesn't show hand
*** SUMMARY ***
Total pot $4 | Rake $0
Seat 1: e0oDWyrmgLpR6bROEqw1nQ (big blind) folded before Flop
Seat 2: jKzajniHFCiIQAQeNkmTGg (button) (small blind) collected ($4)



PokerStars Game #59937809142:  Hold'em No Limit ($1/$2) - 2009/07/01 0:00:21 ET
Table 'NmY84NAf9Mh0ckAckHnh5g' 2-max Seat #2 is the button
Seat 1: 6hvg964TSqZ3AL/0XK9aVQ ($400.90 in chips)
Seat 2: RwDoM55ZeQuI2ADyJhOb2Q ($200 in chips)
RwDoM55ZeQuI2ADyJhOb2Q: posts small blind $1
6hvg964TSqZ3AL/0XK9aVQ: posts big blind $2
*** HOLE CARDS ***
RwDoM55ZeQuI2ADyJhOb2Q: raises $4 to $6
6hvg964TSqZ3AL/0XK9aVQ: calls $4
*** FLOP *** [Tc 7s 5h]
6hvg964TSqZ3AL/0XK9aVQ: checks
RwDoM55ZeQuI2ADyJhOb2Q: bets $10
6hvg964TSqZ3AL/0XK9aVQ: folds
RwDoM55ZeQuI2ADyJhOb2Q collected $11.50 from pot
RwDoM55ZeQuI2ADyJhOb2Q: doesn't show hand
*** SUMMARY ***
Total pot $12 | Rake $0.50
Board [Tc 7s 5h]
Seat 1: 6hvg964TSqZ3AL/0XK9aVQ (big blind) folded on the Flop
Seat 2: RwDoM55ZeQuI2ADyJhOb2Q (button) (small blind) collected ($11.50)



PokerStars Game #59937812758:  Hold'em No Limit ($1/$2) - 2009/07/01 0:00:26 ET
Table 'jlrIxbrVIG+gjaUYT4za8g' 6-max Seat #4 is the button
Seat 1: ygTTt5ehT4aF86q1a8/R+w ($179.35 in chips)
Seat 2: N18PrNGQj43J7TJuQuu+tw ($164.35 in chips)
Seat 3: /PH6Ffnho4Ysm8S3V/oa+w ($40 in chips)
Seat 4: 8srN1dKQePlsv0GyTada+Q ($200 in chips)
Seat 5: F/075N6nU34Fn0zr6qD3aw ($173.55 in chips)
Seat 6: vkfxu8f/jMYKUk6Ly4eujw ($263.40 in chips)
F/075N6nU34Fn0zr6qD3aw: posts small blind $1
vkfxu8f/jMYKUk6Ly4eujw: posts big blind $2
*** HOLE CARDS ***
ygTTt5ehT4aF86q1a8/R+w: folds
N18PrNGQj43J7TJuQuu+tw: calls $2
/PH6Ffnho4Ysm8S3V/oa+w: folds
8srN1dKQePlsv0GyTada+Q: folds
F/075N6nU34Fn0zr6qD3aw: calls $1
vkfxu8f/jMYKUk6Ly4eujw: checks
*** FLOP *** [7s Kd 6d]
F/075N6nU34Fn0zr6qD3aw: checks
vkfxu8f/jMYKUk6Ly4eujw: checks
N18PrNGQj43J7TJuQuu+tw: bets $4
F/075N6nU34Fn0zr6qD3aw: folds
vkfxu8f/jMYKUk6Ly4eujw: folds
N18PrNGQj43J7TJuQuu+tw collected $5.70 from pot
*** SUMMARY ***
Total pot $6 | Rake $0.30
Board [7s Kd 6d]
Seat 1: ygTTt5ehT4aF86q1a8/R+w folded before Flop (didn't bet)
Seat 2: N18PrNGQj43J7TJuQuu+tw collected ($5.70)
Seat 3: /PH6Ffnho4Ysm8S3V/oa+w folded before Flop (didn't bet)
Seat 4: 8srN1dKQePlsv0GyTada+Q (button) folded before Flop (didn't bet)
Seat 5: F/075N6nU34Fn0zr6qD3aw (small blind) folded on the Flop
Seat 6: vkfxu8f/jMYKUk6Ly4eujw (big blind) folded on the Flop



PokerStars Game #59937814530:  Hold'em No Limit ($1/$2) - 2009/07/01 0:00:28 ET
Table '3FGoiEOffWrbgTfsB3t7FA' 2-max Seat #2 is the button
Seat 1: e0oDWyrmgLpR6bROEqw1nQ ($408 in chips)
Seat 2: +sy/nlNI20yZraIjs4AALg ($200.15 in chips)
+sy/nlNI20yZraIjs4AALg: posts small blind $1
e0oDWyrmgLpR6bROEqw1nQ: posts big blind $2
*** HOLE CARDS ***
+sy/nlNI20yZraIjs4AALg: calls $1
e0oDWyrmgLpR6bROEqw1nQ: checks
*** FLOP *** [9h 5s Jd]
e0oDWyrmgLpR6bROEqw1nQ: checks
+sy/nlNI20yZraIjs4AALg: checks
*** TURN *** [9h 5s Jd] [Kh]
e0oDWyrmgLpR6bROEqw1nQ: checks
+sy/nlNI20yZraIjs4AALg: checks
*** RIVER *** [9h 5s Jd Kh] [4c]
e0oDWyrmgLpR6bROEqw1nQ: checks
+sy/nlNI20yZraIjs4AALg: bets $8
e0oDWyrmgLpR6bROEqw1nQ: folds
+sy/nlNI20yZraIjs4AALg collected $3.80 from pot
*** SUMMARY ***
Total pot $4 | Rake $0.20
Board [9h 5s Jd Kh 4c]
Seat 1: e0oDWyrmgLpR6bROEqw1nQ (big blind) folded on the River
Seat 2: +sy/nlNI20yZraIjs4AALg (button) (small blind) collected ($3.80)



PokerStars Game #59937814426:  Hold'em No Limit ($1/$2) - 2009/07/01 0:00:28 ET
Table 'ztv6V3FN2bQ9nmJPPdx6nQ' 6-max Seat #6 is the button
Seat 1: ek1hig03QiyONDHXvgqteQ ($197.75 in chips)
Seat 3: Z55K9DbCHCUi6UaztIHi6g ($144.45 in chips)
Seat 4: vkfxu8f/jMYKUk6Ly4eujw ($321.70 in chips)
Seat 5: sTPOWERd9HWPCNrDBwsVjA ($200 in chips)
Seat 6: yZgdnRylE65JbScQ7qCWgw ($37 in chips)
ek1hig03QiyONDHXvgqteQ: posts small blind $1
MQj83PQbe4xrqde2bUtorQ: is sitting out
Z55K9DbCHCUi6UaztIHi6g: posts big blind $2
*** HOLE CARDS ***
MQj83PQbe4xrqde2bUtorQ leaves the table
vkfxu8f/jMYKUk6Ly4eujw: folds
sTPOWERd9HWPCNrDBwsVjA: folds
yZgdnRylE65JbScQ7qCWgw: folds
ek1hig03QiyONDHXvgqteQ: folds
Z55K9DbCHCUi6UaztIHi6g collected $2 from pot
*** SUMMARY ***
Total pot $2 | Rake $0
Seat 1: ek1hig03QiyONDHXvgqteQ (small blind) folded before Flop
Seat 3: Z55K9DbCHCUi6UaztIHi6g (big blind) collected ($2)
Seat 4: vkfxu8f/jMYKUk6Ly4eujw folded before Flop (didn't bet)
Seat 5: sTPOWERd9HWPCNrDBwsVjA folded before Flop (didn't bet)
Seat 6: yZgdnRylE65JbScQ7qCWgw (button) folded before Flop (didn't bet)



PokerStars Game #59937815166:  Hold'em No Limit ($1/$2) - 2009/07/01 0:00:29 ET
Table 'LL4bDFyhj5hsMpzaDugJZg' 6-max Seat #2 is the button
Seat 2: L3l+A4pJhOAD6HVVFXvVBw ($282.95 in chips)
Seat 3: gGPaCoSWW1HoKYaqfAPecg ($201 in chips)
Seat 4: 8srN1dKQePlsv0GyTada+Q ($217.30 in chips)
Seat 5: HgX0VeqE/dzSXd5BpntRBw ($203 in chips)
Seat 6: yZgdnRylE65JbScQ7qCWgw ($31 in chips)
gGPaCoSWW1HoKYaqfAPecg: posts small blind $1
8srN1dKQePlsv0GyTada+Q: posts big blind $2
*** HOLE CARDS ***
HgX0VeqE/dzSXd5BpntRBw: folds
yZgdnRylE65JbScQ7qCWgw: folds
L3l+A4pJhOAD6HVVFXvVBw: raises $2 to $4
gGPaCoSWW1HoKYaqfAPecg: raises $16 to $20
8srN1dKQePlsv0GyTada+Q: folds
L3l+A4pJhOAD6HVVFXvVBw: folds
gGPaCoSWW1HoKYaqfAPecg collected $10 from pot
*** SUMMARY ***
Total pot $10 | Rake $0
Seat 2: L3l+A4pJhOAD6HVVFXvVBw (button) folded before Flop
Seat 3: gGPaCoSWW1HoKYaqfAPecg (small blind) collected ($10)
Seat 4: 8srN1dKQePlsv0GyTada+Q (big blind) folded before Flop
Seat 5: HgX0VeqE/dzSXd5BpntRBw folded before Flop (didn't bet)
Seat 6: yZgdnRylE65JbScQ7qCWgw folded before Flop (didn't bet)



PokerStars Game #59937815804:  Hold'em No Limit ($1/$2) - 2009/07/01 0:00:30 ET
Table 'ZzSIe0zTCDv+n6hfbY5tTg' 6-max Seat #3 is the button
Seat 1: 8srN1dKQePlsv0GyTada+Q ($219.70 in chips)
Seat 2: JQAf1Fiqbg0N8wNGA2nZhw ($200 in chips)
Seat 3: Y+MK4vQx233i+/aiP6js/Q ($352.20 in chips)
Seat 5: Q3uFdu6ztesjDFiqkagTRQ ($203.10 in chips)
Seat 6: 39260874 ($195.75 in chips)
Q3uFdu6ztesjDFiqkagTRQ: posts small blind $1
39260874: posts big blind $2
*** HOLE CARDS ***
8srN1dKQePlsv0GyTada+Q: folds
JQAf1Fiqbg0N8wNGA2nZhw: folds
Y+MK4vQx233i+/aiP6js/Q: folds
Q3uFdu6ztesjDFiqkagTRQ: folds
39260874 collected $2 from pot
*** SUMMARY ***
Total pot $2 | Rake $0
Seat 1: 8srN1dKQePlsv0GyTada+Q folded before Flop (didn't bet)
Seat 2: JQAf1Fiqbg0N8wNGA2nZhw folded before Flop (didn't bet)
Seat 3: Y+MK4vQx233i+/aiP6js/Q (button) folded before Flop (didn't bet)
Seat 5: Q3uFdu6ztesjDFiqkagTRQ (small blind) folded before Flop
Seat 6: 39260874 (big blind) collected ($2)



PokerStars Game #59937815660:  Hold'em No Limit ($1/$2) - 2009/07/01 0:00:30 ET
Table 'RF+CoNlqGlniDSszIP2SGw' 2-max Seat #1 is the button
Seat 1: e0oDWyrmgLpR6bROEqw1nQ ($253.50 in chips)
Seat 2: jKzajniHFCiIQAQeNkmTGg ($366.50 in chips)
e0oDWyrmgLpR6bROEqw1nQ: posts small blind $1
jKzajniHFCiIQAQeNkmTGg: posts big blind $2
*** HOLE CARDS ***
e0oDWyrmgLpR6bROEqw1nQ: folds
jKzajniHFCiIQAQeNkmTGg collected $2 from pot
jKzajniHFCiIQAQeNkmTGg: doesn't show hand
*** SUMMARY ***
Total pot $2 | Rake $0
Seat 1: e0oDWyrmgLpR6bROEqw1nQ (button) (small blind) folded before Flop
Seat 2: jKzajniHFCiIQAQeNkmTGg (big blind) collected ($2)



PokerStars Game #59937817558:  Hold'em No Limit ($1/$2) - 2009/07/01 0:00:33 ET
Table 'rsKRKlGHlxVyqJxzO2a2Ow' 9-max Seat #9 is the button
Seat 1: uYWfQJg2hgHLxri6/uVJiw ($184.30 in chips)
Seat 2: QHxJjpVYwitg9krW6wZgJA ($248 in chips)
Seat 3: 9sYbXdhj1M2bwKrVNxj5+Q ($93.80 in chips)
Seat 4: zJtQ1gxyi72XvGYS1tM+DA ($53.15 in chips)
Seat 5: QxGDcfm0Yb34yQ4T9e1PIA ($176.90 in chips)
Seat 6: H6Z4+qu8gR0VUiPOijndVg ($200 in chips)
Seat 7: kVCeGJ4NY7Fb0W74j1mAqA ($200 in chips)
Seat 8: Hc2itIxwbi1lwa+DAYYQGg ($46 in chips)
Seat 9: 5iPk5MyO3KVu18Y8XCYfFQ ($47.60 in chips)
uYWfQJg2hgHLxri6/uVJiw: posts small blind $1
QHxJjpVYwitg9krW6wZgJA: posts big blind $2
*** HOLE CARDS ***
9sYbXdhj1M2bwKrVNxj5+Q: folds
zJtQ1gxyi72XvGYS1tM+DA: calls $2
QxGDcfm0Yb34yQ4T9e1PIA: folds
H6Z4+qu8gR0VUiPOijndVg: folds
kVCeGJ4NY7Fb0W74j1mAqA: folds
Hc2itIxwbi1lwa+DAYYQGg: folds
5iPk5MyO3KVu18Y8XCYfFQ: raises $45.60 to $47.60 and is all-in
uYWfQJg2hgHLxri6/uVJiw: calls $46.60
QHxJjpVYwitg9krW6wZgJA: folds
zJtQ1gxyi72XvGYS1tM+DA: folds
*** FLOP *** [2c Qc 3c]
*** TURN *** [2c Qc 3c] [5c]
*** RIVER *** [2c Qc 3c 5c] [8s]
*** SHOW DOWN ***
uYWfQJg2hgHLxri6/uVJiw: shows [Kd Ah] (high card Ace)
5iPk5MyO3KVu18Y8XCYfFQ: shows [Kc Ac] (a flush, Ace high)
5iPk5MyO3KVu18Y8XCYfFQ collected $96.20 from pot
*** SUMMARY ***
Total pot $99.20 | Rake $3
Board [2c Qc 3c 5c 8s]
Seat 1: uYWfQJg2hgHLxri6/uVJiw (small blind) showed [Kd Ah] and lost with high card Ace
Seat 2: QHxJjpVYwitg9krW6wZgJA (big blind) folded before Flop
Seat 3: 9sYbXdhj1M2bwKrVNxj5+Q folded before Flop (didn't bet)
Seat 4: zJtQ1gxyi72XvGYS1tM+DA folded before Flop
Seat 5: QxGDcfm0Yb34yQ4T9e1PIA folded before Flop (didn't bet)
Seat 6: H6Z4+qu8gR0VUiPOijndVg folded before Flop (didn't bet)
Seat 7: kVCeGJ4NY7Fb0W74j1mAqA folded before Flop (didn't bet)
Seat 8: Hc2itIxwbi1lwa+DAYYQGg folded before Flop (didn't bet)
Seat 9: 5iPk5MyO3KVu18Y8XCYfFQ (button) showed [Kc Ac] and won ($96.20) with a flush, Ace high



PokerStars Game #59937818774:  Hold'em No Limit ($1/$2) - 2009/07/01 0:00:34 ET
Table 'bJQ024BaYSBrW0sXpCZbNQ' 6-max Seat #2 is the button
Seat 1: yZgdnRylE65JbScQ7qCWgw ($37 in chips)
Seat 2: 1njbh8TKSUF6l4V1XwGdcg ($251.40 in chips)
Seat 3: vkfxu8f/jMYKUk6Ly4eujw ($212.30 in chips)
Seat 4: 9ni/OEXAqfc58zPQ0Tu9rQ ($290.05 in chips)
Seat 5: X7GlkHF+lkbarCLuZ4Uf0w ($37.10 in chips)
Seat 6: 9dpyyjDTCed6nV7JhaUUpw ($209 in chips)
vkfxu8f/jMYKUk6Ly4eujw: posts small blind $1
9ni/OEXAqfc58zPQ0Tu9rQ: posts big blind $2
*** HOLE CARDS ***
X7GlkHF+lkbarCLuZ4Uf0w: folds
9dpyyjDTCed6nV7JhaUUpw: folds
yZgdnRylE65JbScQ7qCWgw: folds
1njbh8TKSUF6l4V1XwGdcg: folds
vkfxu8f/jMYKUk6Ly4eujw: folds
9ni/OEXAqfc58zPQ0Tu9rQ collected $2 from pot
*** SUMMARY ***
Total pot $2 | Rake $0
Seat 1: yZgdnRylE65JbScQ7qCWgw folded before Flop (didn't bet)
Seat 2: 1njbh8TKSUF6l4V1XwGdcg (button) folded before Flop (didn't bet)
Seat 3: vkfxu8f/jMYKUk6Ly4eujw (small blind) folded before Flop
Seat 4: 9ni/OEXAqfc58zPQ0Tu9rQ (big blind) collected ($2)
Seat 5: X7GlkHF+lkbarCLuZ4Uf0w folded before Flop (didn't bet)
Seat 6: 9dpyyjDTCed6nV7JhaUUpw folded before Flop (didn't bet)



PokerStars Game #59937818990:  Hold'em No Limit ($1/$2) - 2009/07/01 0:00:35 ET
Table 'SF49/KQm8T4taMp6kb+HXA' 9-max Seat #8 is the button
Seat 1: l1bCLGuFqeFRwUfPsiDu/g ($196.95 in chips)
Seat 2: dJO4Wtu5e7hHBlpz0cmy1w ($80.20 in chips)
Seat 3: L88dtdULfz5oGDSuo9/RvA ($44.05 in chips)
Seat 4: 02K2DtsrlV5RLBdrzZcWqg ($104 in chips)
Seat 5: Z3aYCZG/yXHYFjiWkGI5ug ($226.50 in chips)
Seat 6: M2ht6rIKOI/my9eh610Nlw ($250.45 in chips)
Seat 7: n2VAbLaE5qgKr5mA4W6v4w ($56.50 in chips)
Seat 8: 5iPk5MyO3KVu18Y8XCYfFQ ($39 in chips)
Seat 9: O+jytCilwk7zItVCEavmtw ($113.10 in chips)
O+jytCilwk7zItVCEavmtw: posts small blind $1
l1bCLGuFqeFRwUfPsiDu/g: posts big blind $2
*** HOLE CARDS ***
dJO4Wtu5e7hHBlpz0cmy1w: folds
L88dtdULfz5oGDSuo9/RvA: calls $2
02K2DtsrlV5RLBdrzZcWqg: folds
Z3aYCZG/yXHYFjiWkGI5ug: raises $6 to $8
M2ht6rIKOI/my9eh610Nlw: folds
n2VAbLaE5qgKr5mA4W6v4w: folds
5iPk5MyO3KVu18Y8XCYfFQ: folds
O+jytCilwk7zItVCEavmtw: folds
l1bCLGuFqeFRwUfPsiDu/g: folds
L88dtdULfz5oGDSuo9/RvA: calls $6
*** FLOP *** [8d 5h 2h]
L88dtdULfz5oGDSuo9/RvA: checks
Z3aYCZG/yXHYFjiWkGI5ug: checks
*** TURN *** [8d 5h 2h] [Kh]
L88dtdULfz5oGDSuo9/RvA: checks
Z3aYCZG/yXHYFjiWkGI5ug: bets $12
L88dtdULfz5oGDSuo9/RvA: folds
Z3aYCZG/yXHYFjiWkGI5ug collected $18.05 from pot
*** SUMMARY ***
Total pot $19 | Rake $0.95
Board [8d 5h 2h Kh]
Seat 1: l1bCLGuFqeFRwUfPsiDu/g (big blind) folded before Flop
Seat 2: dJO4Wtu5e7hHBlpz0cmy1w folded before Flop (didn't bet)
Seat 3: L88dtdULfz5oGDSuo9/RvA folded on the Turn
Seat 4: 02K2DtsrlV5RLBdrzZcWqg folded before Flop (didn't bet)
Seat 5: Z3aYCZG/yXHYFjiWkGI5ug collected ($18.05)
Seat 6: M2ht6rIKOI/my9eh610Nlw folded before Flop (didn't bet)
Seat 7: n2VAbLaE5qgKr5mA4W6v4w folded before Flop (didn't bet)
Seat 8: 5iPk5MyO3KVu18Y8XCYfFQ (button) folded before Flop (didn't bet)
Seat 9: O+jytCilwk7zItVCEavmtw (small blind) folded before Flop



PokerStars Game #59937820594:  Hold'em No Limit ($1/$2) - 2009/07/01 0:00:37 ET
Table 'XP2sRSup+aRuwzx3vDZsDg' 6-max Seat #6 is the button
Seat 2: yZgdnRylE65JbScQ7qCWgw ($41 in chips)
Seat 3: X7GlkHF+lkbarCLuZ4Uf0w ($31 in chips)
Seat 4: JsC+WvfzqlxVs9G8/gSQAQ ($109.95 in chips)
Seat 5: vkfxu8f/jMYKUk6Ly4eujw ($200 in chips)
Seat 6: h7ppRQJTYBsHCbLMeW9T2g ($496.75 in chips)
yZgdnRylE65JbScQ7qCWgw: posts small blind $1
X7GlkHF+lkbarCLuZ4Uf0w: posts big blind $2
*** HOLE CARDS ***
JsC+WvfzqlxVs9G8/gSQAQ: raises $8 to $10
vkfxu8f/jMYKUk6Ly4eujw: folds
h7ppRQJTYBsHCbLMeW9T2g: folds
yZgdnRylE65JbScQ7qCWgw: folds
X7GlkHF+lkbarCLuZ4Uf0w: folds
JsC+WvfzqlxVs9G8/gSQAQ collected $5 from pot
*** SUMMARY ***
Total pot $5 | Rake $0
Seat 2: yZgdnRylE65JbScQ7qCWgw (small blind) folded before Flop
Seat 3: X7GlkHF+lkbarCLuZ4Uf0w (big blind) folded before Flop
Seat 4: JsC+WvfzqlxVs9G8/gSQAQ collected ($5)
Seat 5: vkfxu8f/jMYKUk6Ly4eujw folded before Flop (didn't bet)
Seat 6: h7ppRQJTYBsHCbLMeW9T2g (button) folded before Flop (didn't bet)



PokerStars Game #59937821264:  Hold'em No Limit ($1/$2) - 2009/07/01 0:00:38 ET
Table 'HewZCzVOYGmuLDKthTi5Yw' 6-max Seat #5 is the button
Seat 1: 353332 ($227.75 in chips)
Seat 2: X7GlkHF+lkbarCLuZ4Uf0w ($37 in chips)
Seat 4: yZgdnRylE65JbScQ7qCWgw ($41 in chips)
Seat 5: 513FcCI8jHyQy2VWoIQkMg ($374.50 in chips)
353332: posts small blind $1
X7GlkHF+lkbarCLuZ4Uf0w: posts big blind $2
*** HOLE CARDS ***
yZgdnRylE65JbScQ7qCWgw: folds
513FcCI8jHyQy2VWoIQkMg: folds
353332: raises $8 to $10
X7GlkHF+lkbarCLuZ4Uf0w: folds
353332 collected $4 from pot
353332: doesn't show hand
*** SUMMARY ***
Total pot $4 | Rake $0
Seat 1: 353332 (small blind) collected ($4)
Seat 2: X7GlkHF+lkbarCLuZ4Uf0w (big blind) folded before Flop
Seat 4: yZgdnRylE65JbScQ7qCWgw folded before Flop (didn't bet)
Seat 5: 513FcCI8jHyQy2VWoIQkMg (button) folded before Flop (didn't bet)



PokerStars Game #59937822210:  Hold'em No Limit ($1/$2) - 2009/07/01 0:00:39 ET
Table 'NmY84NAf9Mh0ckAckHnh5g' 2-max Seat #1 is the button
Seat 1: 6hvg964TSqZ3AL/0XK9aVQ ($394.90 in chips)
Seat 2: RwDoM55ZeQuI2ADyJhOb2Q ($205.50 in chips)
6hvg964TSqZ3AL/0XK9aVQ: posts small blind $1
RwDoM55ZeQuI2ADyJhOb2Q: posts big blind $2
*** HOLE CARDS ***
6hvg964TSqZ3AL/0XK9aVQ: folds
RwDoM55ZeQuI2ADyJhOb2Q collected $2 from pot
RwDoM55ZeQuI2ADyJhOb2Q: doesn't show hand
*** SUMMARY ***
Total pot $2 | Rake $0
Seat 1: 6hvg964TSqZ3AL/0XK9aVQ (button) (small blind) folded before Flop
Seat 2: RwDoM55ZeQuI2ADyJhOb2Q (big blind) collected ($2)



PokerStars Game #59937823214:  Hold'em No Limit ($1/$2) - 2009/07/01 0:00:40 ET
Table 'RF+CoNlqGlniDSszIP2SGw' 2-max Seat #2 is the button
Seat 1: e0oDWyrmgLpR6bROEqw1nQ ($252.50 in chips)
Seat 2: jKzajniHFCiIQAQeNkmTGg ($367.50 in chips)
jKzajniHFCiIQAQeNkmTGg: posts small blind $1
e0oDWyrmgLpR6bROEqw1nQ: posts big blind $2
*** HOLE CARDS ***
jKzajniHFCiIQAQeNkmTGg: raises $2 to $4
e0oDWyrmgLpR6bROEqw1nQ: folds
jKzajniHFCiIQAQeNkmTGg collected $4 from pot
jKzajniHFCiIQAQeNkmTGg: doesn't show hand
*** SUMMARY ***
Total pot $4 | Rake $0
Seat 1: e0oDWyrmgLpR6bROEqw1nQ (big blind) folded before Flop
Seat 2: jKzajniHFCiIQAQeNkmTGg (button) (small blind) collected ($4)



PokerStars Game #59937822690:  Hold'em No Limit ($1/$2) - 2009/07/01 0:00:40 ET
Table 'aSf77Sj8QEnzcc0WaxVD4Q' 6-max Seat #5 is the button
Seat 1: Q3uFdu6ztesjDFiqkagTRQ ($206 in chips)
Seat 2: vkfxu8f/jMYKUk6Ly4eujw ($207.75 in chips)
Seat 3: 9dpyyjDTCed6nV7JhaUUpw ($223.05 in chips)
Seat 4: 513FcCI8jHyQy2VWoIQkMg ($212.60 in chips)
Seat 5: InmkdI6G8TzSj9NhcCSyPg ($235 in chips)
Seat 6: vkoJRf3gidxY1pPi0AFWww ($336 in chips)
vkoJRf3gidxY1pPi0AFWww: posts small blind $1
Q3uFdu6ztesjDFiqkagTRQ: posts big blind $2
*** HOLE CARDS ***
vkfxu8f/jMYKUk6Ly4eujw: folds
9dpyyjDTCed6nV7JhaUUpw: folds
513FcCI8jHyQy2VWoIQkMg: folds
InmkdI6G8TzSj9NhcCSyPg: folds
vkoJRf3gidxY1pPi0AFWww: calls $1
Q3uFdu6ztesjDFiqkagTRQ: checks
*** FLOP *** [Jc Ac 7s]
vkoJRf3gidxY1pPi0AFWww: checks
Q3uFdu6ztesjDFiqkagTRQ: checks
*** TURN *** [Jc Ac 7s] [8h]
vkoJRf3gidxY1pPi0AFWww: bets $6
Q3uFdu6ztesjDFiqkagTRQ: calls $6
*** RIVER *** [Jc Ac 7s 8h] [6h]
vkoJRf3gidxY1pPi0AFWww: checks
Q3uFdu6ztesjDFiqkagTRQ: bets $2
vkoJRf3gidxY1pPi0AFWww: calls $2
*** SHOW DOWN ***
Q3uFdu6ztesjDFiqkagTRQ: shows [5s Jd] (a pair of Jacks)
vkoJRf3gidxY1pPi0AFWww: shows [As 3c] (a pair of Aces)
vkoJRf3gidxY1pPi0AFWww collected $19.05 from pot
*** SUMMARY ***
Total pot $20 | Rake $0.95
Board [Jc Ac 7s 8h 6h]
Seat 1: Q3uFdu6ztesjDFiqkagTRQ (big blind) showed [5s Jd] and lost with a pair of Jacks
Seat 2: vkfxu8f/jMYKUk6Ly4eujw folded before Flop (didn't bet)
Seat 3: 9dpyyjDTCed6nV7JhaUUpw folded before Flop (didn't bet)
Seat 4: 513FcCI8jHyQy2VWoIQkMg folded before Flop (didn't bet)
Seat 5: InmkdI6G8TzSj9NhcCSyPg (button) folded before Flop (didn't bet)
Seat 6: vkoJRf3gidxY1pPi0AFWww (small blind) showed [As 3c] and won ($19.05) with a pair of Aces



PokerStars Game #59937825384:  Hold'em No Limit ($1/$2) - 2009/07/01 0:00:43 ET
Table 'YqGfR5eHfMeSjb9a+QU9rg' 9-max Seat #9 is the button
Seat 1: qCBuzVnLcBR29snMAHq9PA ($178.55 in chips)
Seat 2: W3Nqt1GWlTi9tXQXMNEvgw ($164.60 in chips)
Seat 3: 02K2DtsrlV5RLBdrzZcWqg ($119.55 in chips)
Seat 5: MOBMOMQRN/z+fiGXGnZojw ($191.10 in chips)
Seat 6: 5iPk5MyO3KVu18Y8XCYfFQ ($36 in chips)
Seat 7: b0jO1SDhLedy1//CQlA8kw ($42 in chips)
Seat 8: GX1heJ+DSsvm7gzSPsYhhQ ($32 in chips)
Seat 9: RsrgM2l7PLbQ9xBbSi3IvQ ($110.40 in chips)
qCBuzVnLcBR29snMAHq9PA: posts small blind $1
W3Nqt1GWlTi9tXQXMNEvgw: posts big blind $2
QHxJjpVYwitg9krW6wZgJA: sits out
*** HOLE CARDS ***
02K2DtsrlV5RLBdrzZcWqg: folds
MOBMOMQRN/z+fiGXGnZojw: folds
5iPk5MyO3KVu18Y8XCYfFQ: folds
b0jO1SDhLedy1//CQlA8kw: folds
GX1heJ+DSsvm7gzSPsYhhQ: folds
RsrgM2l7PLbQ9xBbSi3IvQ: folds
qCBuzVnLcBR29snMAHq9PA: calls $1
W3Nqt1GWlTi9tXQXMNEvgw: checks
*** FLOP *** [Th 2h 2s]
qCBuzVnLcBR29snMAHq9PA: checks
W3Nqt1GWlTi9tXQXMNEvgw: checks
*** TURN *** [Th 2h 2s] [Kh]
qCBuzVnLcBR29snMAHq9PA: bets $2
W3Nqt1GWlTi9tXQXMNEvgw: folds
qCBuzVnLcBR29snMAHq9PA collected $3.80 from pot
qCBuzVnLcBR29snMAHq9PA: doesn't show hand
*** SUMMARY ***
Total pot $4 | Rake $0.20
Board [Th 2h 2s Kh]
Seat 1: qCBuzVnLcBR29snMAHq9PA (small blind) collected ($3.80)
Seat 2: W3Nqt1GWlTi9tXQXMNEvgw (big blind) folded on the Turn
Seat 3: 02K2DtsrlV5RLBdrzZcWqg folded before Flop (didn't bet)
Seat 5: MOBMOMQRN/z+fiGXGnZojw folded before Flop (didn't bet)
Seat 6: 5iPk5MyO3KVu18Y8XCYfFQ folded before Flop (didn't bet)
Seat 7: b0jO1SDhLedy1//CQlA8kw folded before Flop (didn't bet)
Seat 8: GX1heJ+DSsvm7gzSPsYhhQ folded before Flop (didn't bet)
Seat 9: RsrgM2l7PLbQ9xBbSi3IvQ (button) folded before Flop (didn't bet)



PokerStars Game #59937827028:  Hold'em No Limit ($1/$2) - 2009/07/01 0:00:46 ET
Table 'CFkQcfWjKccZaZDf71FK+w' 6-max Seat #3 is the button
Seat 1: X7GlkHF+lkbarCLuZ4Uf0w ($37 in chips)
Seat 2: yZgdnRylE65JbScQ7qCWgw ($37 in chips)
Seat 3: ygTTt5ehT4aF86q1a8/R+w ($124.40 in chips)
Seat 4: B2Ih1sr5VZk+8He7rcrMtQ ($219.90 in chips)
Seat 5: 1njbh8TKSUF6l4V1XwGdcg ($200 in chips)
Seat 6: ORVqY3rf9X6ANA/8s+On2Q ($91 in chips)
B2Ih1sr5VZk+8He7rcrMtQ: posts small blind $1
1njbh8TKSUF6l4V1XwGdcg: posts big blind $2
*** HOLE CARDS ***
ORVqY3rf9X6ANA/8s+On2Q: folds
X7GlkHF+lkbarCLuZ4Uf0w: folds
yZgdnRylE65JbScQ7qCWgw: folds
ygTTt5ehT4aF86q1a8/R+w: folds
B2Ih1sr5VZk+8He7rcrMtQ: folds
1njbh8TKSUF6l4V1XwGdcg collected $2 from pot
*** SUMMARY ***
Total pot $2 | Rake $0
Seat 1: X7GlkHF+lkbarCLuZ4Uf0w folded before Flop (didn't bet)
Seat 2: yZgdnRylE65JbScQ7qCWgw folded before Flop (didn't bet)
Seat 3: ygTTt5ehT4aF86q1a8/R+w (button) folded before Flop (didn't bet)
Seat 4: B2Ih1sr5VZk+8He7rcrMtQ (small blind) folded before Flop
Seat 5: 1njbh8TKSUF6l4V1XwGdcg (big blind) collected ($2)
Seat 6: ORVqY3rf9X6ANA/8s+On2Q folded before Flop (didn't bet)



PokerStars Game #59937828336:  Hold'em No Limit ($1/$2) - 2009/07/01 0:00:47 ET
Table 'NmY84NAf9Mh0ckAckHnh5g' 2-max Seat #2 is the button
Seat 1: 6hvg964TSqZ3AL/0XK9aVQ ($393.90 in chips)
Seat 2: RwDoM55ZeQuI2ADyJhOb2Q ($206.50 in chips)
RwDoM55ZeQuI2ADyJhOb2Q: posts small blind $1
6hvg964TSqZ3AL/0XK9aVQ: posts big blind $2
*** HOLE CARDS ***
RwDoM55ZeQuI2ADyJhOb2Q: raises $4 to $6
6hvg964TSqZ3AL/0XK9aVQ: folds
RwDoM55ZeQuI2ADyJhOb2Q collected $4 from pot
RwDoM55ZeQuI2ADyJhOb2Q: doesn't show hand
*** SUMMARY ***
Total pot $4 | Rake $0
Seat 1: 6hvg964TSqZ3AL/0XK9aVQ (big blind) folded before Flop
Seat 2: RwDoM55ZeQuI2ADyJhOb2Q (button) (small blind) collected ($4)



PokerStars Game #59937827788:  Hold'em No Limit ($1/$2) - 2009/07/01 0:00:47 ET
Table 'uJ9juaXXg9yIcSU8amxaXQ' 6-max Seat #3 is the button
Seat 1: HhIxv6mylwCAfv3sjJmq5g ($208.75 in chips)
Seat 2: DQlskgG4OtLpF2MVxLwf4A ($278.70 in chips)
Seat 3: zaogaltCDFVsIASEnrXs2w ($245.15 in chips)
Seat 5: F/075N6nU34Fn0zr6qD3aw ($231.05 in chips)
Seat 6: XrFG4dK06RVKLlX32/pjcQ ($45.90 in chips)
F/075N6nU34Fn0zr6qD3aw: posts small blind $1
XrFG4dK06RVKLlX32/pjcQ: posts big blind $2
*** HOLE CARDS ***
54yWzRRgS0oZ+S6LwZBxMQ joins the table at seat #4
HhIxv6mylwCAfv3sjJmq5g: raises $3 to $5
DQlskgG4OtLpF2MVxLwf4A: folds
zaogaltCDFVsIASEnrXs2w: calls $5
F/075N6nU34Fn0zr6qD3aw: folds
XrFG4dK06RVKLlX32/pjcQ: folds
*** FLOP *** [3s 7h 6s]
HhIxv6mylwCAfv3sjJmq5g: bets $8
zaogaltCDFVsIASEnrXs2w: calls $8
*** TURN *** [3s 7h 6s] [8s]
HhIxv6mylwCAfv3sjJmq5g: checks
zaogaltCDFVsIASEnrXs2w: bets $10
HhIxv6mylwCAfv3sjJmq5g: folds
zaogaltCDFVsIASEnrXs2w collected $27.60 from pot
*** SUMMARY ***
Total pot $29 | Rake $1.40
Board [3s 7h 6s 8s]
Seat 1: HhIxv6mylwCAfv3sjJmq5g folded on the Turn
Seat 2: DQlskgG4OtLpF2MVxLwf4A folded before Flop (didn't bet)
Seat 3: zaogaltCDFVsIASEnrXs2w (button) collected ($27.60)
Seat 5: F/075N6nU34Fn0zr6qD3aw (small blind) folded before Flop
Seat 6: XrFG4dK06RVKLlX32/pjcQ (big blind) folded before Flop



PokerStars Game #59937828256:  Hold'em No Limit ($1/$2) - 2009/07/01 0:00:47 ET
Table 'ztv6V3FN2bQ9nmJPPdx6nQ' 6-max Seat #1 is the button
Seat 1: ek1hig03QiyONDHXvgqteQ ($196.75 in chips)
Seat 3: Z55K9DbCHCUi6UaztIHi6g ($145.45 in chips)
Seat 4: vkfxu8f/jMYKUk6Ly4eujw ($321.70 in chips)
Seat 5: sTPOWERd9HWPCNrDBwsVjA ($200 in chips)
Seat 6: yZgdnRylE65JbScQ7qCWgw ($37 in chips)
Z55K9DbCHCUi6UaztIHi6g: posts small blind $1
vkfxu8f/jMYKUk6Ly4eujw: posts big blind $2
*** HOLE CARDS ***
sTPOWERd9HWPCNrDBwsVjA: folds
yZgdnRylE65JbScQ7qCWgw: folds
ek1hig03QiyONDHXvgqteQ: folds
Z55K9DbCHCUi6UaztIHi6g: calls $1
vkfxu8f/jMYKUk6Ly4eujw: raises $2 to $4
Z55K9DbCHCUi6UaztIHi6g: calls $2
*** FLOP *** [6s Ks 5h]
Z55K9DbCHCUi6UaztIHi6g: checks
vkfxu8f/jMYKUk6Ly4eujw: checks
*** TURN *** [6s Ks 5h] [7h]
Z55K9DbCHCUi6UaztIHi6g: bets $10
vkfxu8f/jMYKUk6Ly4eujw: folds
Z55K9DbCHCUi6UaztIHi6g collected $7.60 from pot
*** SUMMARY ***
Total pot $8 | Rake $0.40
Board [6s Ks 5h 7h]
Seat 1: ek1hig03QiyONDHXvgqteQ (button) folded before Flop (didn't bet)
Seat 3: Z55K9DbCHCUi6UaztIHi6g (small blind) collected ($7.60)
Seat 4: vkfxu8f/jMYKUk6Ly4eujw (big blind) folded on the Turn
Seat 5: sTPOWERd9HWPCNrDBwsVjA folded before Flop (didn't bet)
Seat 6: yZgdnRylE65JbScQ7qCWgw folded before Flop (didn't bet)



PokerStars Game #59937829616:  Hold'em No Limit ($1/$2) - 2009/07/01 0:00:49 ET
Table 'RF+CoNlqGlniDSszIP2SGw' 2-max Seat #1 is the button
Seat 1: e0oDWyrmgLpR6bROEqw1nQ ($250.50 in chips)
Seat 2: jKzajniHFCiIQAQeNkmTGg ($369.50 in chips)
e0oDWyrmgLpR6bROEqw1nQ: posts small blind $1
jKzajniHFCiIQAQeNkmTGg: posts big blind $2
*** HOLE CARDS ***
e0oDWyrmgLpR6bROEqw1nQ: raises $4 to $6
jKzajniHFCiIQAQeNkmTGg: folds
e0oDWyrmgLpR6bROEqw1nQ collected $4 from pot
*** SUMMARY ***
Total pot $4 | Rake $0
Seat 1: e0oDWyrmgLpR6bROEqw1nQ (button) (small blind) collected ($4)
Seat 2: jKzajniHFCiIQAQeNkmTGg (big blind) folded before Flop



PokerStars Game #59937829580:  Hold'em No Limit ($1/$2) - 2009/07/01 0:00:49 ET
Table 'l5lZHc5JRHEDt0Y2AVPq3g' 6-max Seat #1 is the button
Seat 1: gGPaCoSWW1HoKYaqfAPecg ($206.30 in chips)
Seat 2: my38j/MmtBd/8qVwmyCREA ($180.60 in chips)
Seat 3: yZgdnRylE65JbScQ7qCWgw ($31 in chips)
Seat 4: zNjJ/y4emmF+vzrCDd+ooA ($208.05 in chips)
Seat 5: 6fLdOUCRtX71xbVRhJEq8w ($200 in chips)
Seat 6: vkfxu8f/jMYKUk6Ly4eujw ($199 in chips)
my38j/MmtBd/8qVwmyCREA: posts small blind $1
yZgdnRylE65JbScQ7qCWgw: posts big blind $2
*** HOLE CARDS ***
zNjJ/y4emmF+vzrCDd+ooA: folds
6fLdOUCRtX71xbVRhJEq8w: folds
vkfxu8f/jMYKUk6Ly4eujw: folds
gGPaCoSWW1HoKYaqfAPecg: folds
my38j/MmtBd/8qVwmyCREA: calls $1
yZgdnRylE65JbScQ7qCWgw: checks
*** FLOP *** [Ah 7c Ad]
my38j/MmtBd/8qVwmyCREA: checks
yZgdnRylE65JbScQ7qCWgw: checks
*** TURN *** [Ah 7c Ad] [4s]
my38j/MmtBd/8qVwmyCREA: checks
yZgdnRylE65JbScQ7qCWgw: checks
*** RIVER *** [Ah 7c Ad 4s] [4d]
my38j/MmtBd/8qVwmyCREA: bets $26
yZgdnRylE65JbScQ7qCWgw: folds
my38j/MmtBd/8qVwmyCREA collected $3.80 from pot
*** SUMMARY ***
Total pot $4 | Rake $0.20
Board [Ah 7c Ad 4s 4d]
Seat 1: gGPaCoSWW1HoKYaqfAPecg (button) folded before Flop (didn't bet)
Seat 2: my38j/MmtBd/8qVwmyCREA (small blind) collected ($3.80)
Seat 3: yZgdnRylE65JbScQ7qCWgw (big blind) folded on the River
Seat 4: zNjJ/y4emmF+vzrCDd+ooA folded before Flop (didn't bet)
Seat 5: 6fLdOUCRtX71xbVRhJEq8w folded before Flop (didn't bet)
Seat 6: vkfxu8f/jMYKUk6Ly4eujw folded before Flop (didn't bet)



PokerStars Game #59937830196:  Hold'em No Limit ($1/$2) - 2009/07/01 0:00:50 ET
Table 'bJQ024BaYSBrW0sXpCZbNQ' 6-max Seat #3 is the button
Seat 1: yZgdnRylE65JbScQ7qCWgw ($37 in chips)
Seat 2: 1njbh8TKSUF6l4V1XwGdcg ($251.40 in chips)
Seat 3: vkfxu8f/jMYKUk6Ly4eujw ($211.30 in chips)
Seat 4: 9ni/OEXAqfc58zPQ0Tu9rQ ($291.05 in chips)
Seat 5: X7GlkHF+lkbarCLuZ4Uf0w ($37.10 in chips)
Seat 6: 9dpyyjDTCed6nV7JhaUUpw ($209 in chips)
9ni/OEXAqfc58zPQ0Tu9rQ: posts small blind $1
X7GlkHF+lkbarCLuZ4Uf0w: posts big blind $2
*** HOLE CARDS ***
9dpyyjDTCed6nV7JhaUUpw: folds
yZgdnRylE65JbScQ7qCWgw: folds
1njbh8TKSUF6l4V1XwGdcg: folds
vkfxu8f/jMYKUk6Ly4eujw: folds
9ni/OEXAqfc58zPQ0Tu9rQ: calls $1
X7GlkHF+lkbarCLuZ4Uf0w: raises $4 to $6
9ni/OEXAqfc58zPQ0Tu9rQ said, "allin"
9ni/OEXAqfc58zPQ0Tu9rQ: calls $4
*** FLOP *** [2d 3c 5s]
9ni/OEXAqfc58zPQ0Tu9rQ: checks
X7GlkHF+lkbarCLuZ4Uf0w: bets $4
9ni/OEXAqfc58zPQ0Tu9rQ: calls $4
*** TURN *** [2d 3c 5s] [Qs]
9ni/OEXAqfc58zPQ0Tu9rQ: checks
X7GlkHF+lkbarCLuZ4Uf0w: checks
*** RIVER *** [2d 3c 5s Qs] [Ac]
9ni/OEXAqfc58zPQ0Tu9rQ: checks
X7GlkHF+lkbarCLuZ4Uf0w: checks
*** SHOW DOWN ***
9ni/OEXAqfc58zPQ0Tu9rQ: shows [7h 6d] (high card Ace)
X7GlkHF+lkbarCLuZ4Uf0w: shows [3d Ts] (a pair of Threes)
X7GlkHF+lkbarCLuZ4Uf0w collected $19.05 from pot
*** SUMMARY ***
Total pot $20 | Rake $0.95
Board [2d 3c 5s Qs Ac]
Seat 1: yZgdnRylE65JbScQ7qCWgw folded before Flop (didn't bet)
Seat 2: 1njbh8TKSUF6l4V1XwGdcg folded before Flop (didn't bet)
Seat 3: vkfxu8f/jMYKUk6Ly4eujw (button) folded before Flop (didn't bet)
Seat 4: 9ni/OEXAqfc58zPQ0Tu9rQ (small blind) showed [7h 6d] and lost with high card Ace
Seat 5: X7GlkHF+lkbarCLuZ4Uf0w (big blind) showed [3d Ts] and won ($19.05) with a pair of Threes
Seat 6: 9dpyyjDTCed6nV7JhaUUpw folded before Flop (didn't bet)



PokerStars Game #59937831434:  Hold'em No Limit ($1/$2) - 2009/07/01 0:00:52 ET
Table 'WCA60bDA8ecovUgFSIZkTQ' 9-max Seat #9 is the button
Seat 1: xNLmepWbCljNEEeH8O5jSg ($267.65 in chips)
Seat 2: G1h8wamBcVJXtsKXZQ2EyA ($74.75 in chips)
Seat 3: 5iPk5MyO3KVu18Y8XCYfFQ ($40 in chips)
Seat 4: Q3uFdu6ztesjDFiqkagTRQ ($450.70 in chips)
Seat 5: Hc2itIxwbi1lwa+DAYYQGg ($312.30 in chips)
Seat 6: DOWQSOJ7GaX+ksfWTqPT5A ($203.75 in chips)
Seat 7: GX1heJ+DSsvm7gzSPsYhhQ ($34 in chips)
Seat 9: 3q2/0oJr3Mcy1W5tcN61ug ($301.20 in chips)
xNLmepWbCljNEEeH8O5jSg: posts small blind $1
G1h8wamBcVJXtsKXZQ2EyA: posts big blind $2
*** HOLE CARDS ***
5iPk5MyO3KVu18Y8XCYfFQ: folds
x+V1JgVDawsJTxKcxm7gxw has returned
Q3uFdu6ztesjDFiqkagTRQ: folds
Hc2itIxwbi1lwa+DAYYQGg: folds
DOWQSOJ7GaX+ksfWTqPT5A: raises $4 to $6
GX1heJ+DSsvm7gzSPsYhhQ: folds
3q2/0oJr3Mcy1W5tcN61ug: folds
xNLmepWbCljNEEeH8O5jSg: folds
G1h8wamBcVJXtsKXZQ2EyA: folds
DOWQSOJ7GaX+ksfWTqPT5A collected $5 from pot
DOWQSOJ7GaX+ksfWTqPT5A: doesn't show hand
*** SUMMARY ***
Total pot $5 | Rake $0
Seat 1: xNLmepWbCljNEEeH8O5jSg (small blind) folded before Flop
Seat 2: G1h8wamBcVJXtsKXZQ2EyA (big blind) folded before Flop
Seat 3: 5iPk5MyO3KVu18Y8XCYfFQ folded before Flop (didn't bet)
Seat 4: Q3uFdu6ztesjDFiqkagTRQ folded before Flop (didn't bet)
Seat 5: Hc2itIxwbi1lwa+DAYYQGg folded before Flop (didn't bet)
Seat 6: DOWQSOJ7GaX+ksfWTqPT5A collected ($5)
Seat 7: GX1heJ+DSsvm7gzSPsYhhQ folded before Flop (didn't bet)
Seat 9: 3q2/0oJr3Mcy1W5tcN61ug (button) folded before Flop (didn't bet)



PokerStars Game #59937834338:  Hold'em No Limit ($1/$2) - 2009/07/01 0:00:56 ET
Table 'fe+AlpfadsfwxhZEvYFbbA' 6-max Seat #1 is the button
Seat 1: SLlqn2PPbQqwfcLfYqUXrw ($108.10 in chips)
Seat 2: /PH6Ffnho4Ysm8S3V/oa+w ($40 in chips)
Seat 3: 54yWzRRgS0oZ+S6LwZBxMQ ($33.65 in chips)
Seat 5: gGPaCoSWW1HoKYaqfAPecg ($202.20 in chips)
Seat 6: 5Y+ZGWLI4gnlpApDX5vy1A ($203 in chips)
/PH6Ffnho4Ysm8S3V/oa+w: posts small blind $1
54yWzRRgS0oZ+S6LwZBxMQ: posts big blind $2
*** HOLE CARDS ***
gGPaCoSWW1HoKYaqfAPecg: folds
5Y+ZGWLI4gnlpApDX5vy1A: raises $2 to $4
SLlqn2PPbQqwfcLfYqUXrw: folds
/PH6Ffnho4Ysm8S3V/oa+w: folds
54yWzRRgS0oZ+S6LwZBxMQ: calls $2
*** FLOP *** [6h Td 2d]
54yWzRRgS0oZ+S6LwZBxMQ: checks
5Y+ZGWLI4gnlpApDX5vy1A: bets $5
54yWzRRgS0oZ+S6LwZBxMQ: folds
5Y+ZGWLI4gnlpApDX5vy1A collected $8.55 from pot
5Y+ZGWLI4gnlpApDX5vy1A: doesn't show hand
*** SUMMARY ***
Total pot $9 | Rake $0.45
Board [6h Td 2d]
Seat 1: SLlqn2PPbQqwfcLfYqUXrw (button) folded before Flop (didn't bet)
Seat 2: /PH6Ffnho4Ysm8S3V/oa+w (small blind) folded before Flop
Seat 3: 54yWzRRgS0oZ+S6LwZBxMQ (big blind) folded on the Flop
Seat 5: gGPaCoSWW1HoKYaqfAPecg folded before Flop (didn't bet)
Seat 6: 5Y+ZGWLI4gnlpApDX5vy1A collected ($8.55)



PokerStars Game #59937835270:  Hold'em No Limit ($1/$2) - 2009/07/01 0:00:57 ET
Table 'RF+CoNlqGlniDSszIP2SGw' 2-max Seat #2 is the button
Seat 1: e0oDWyrmgLpR6bROEqw1nQ ($252.50 in chips)
Seat 2: jKzajniHFCiIQAQeNkmTGg ($367.50 in chips)
jKzajniHFCiIQAQeNkmTGg: posts small blind $1
e0oDWyrmgLpR6bROEqw1nQ: posts big blind $2
*** HOLE CARDS ***
jKzajniHFCiIQAQeNkmTGg: raises $2 to $4
e0oDWyrmgLpR6bROEqw1nQ: calls $2
*** FLOP *** [Kc Kd Ts]
e0oDWyrmgLpR6bROEqw1nQ: checks
jKzajniHFCiIQAQeNkmTGg: bets $6
e0oDWyrmgLpR6bROEqw1nQ: folds
jKzajniHFCiIQAQeNkmTGg collected $7.60 from pot
jKzajniHFCiIQAQeNkmTGg: doesn't show hand
*** SUMMARY ***
Total pot $8 | Rake $0.40
Board [Kc Kd Ts]
Seat 1: e0oDWyrmgLpR6bROEqw1nQ (big blind) folded on the Flop
Seat 2: jKzajniHFCiIQAQeNkmTGg (button) (small blind) collected ($7.60)



PokerStars Game #59937835000:  Hold'em No Limit ($1/$2) - 2009/07/01 0:00:57 ET
Table 'NmY84NAf9Mh0ckAckHnh5g' 2-max Seat #1 is the button
Seat 1: 6hvg964TSqZ3AL/0XK9aVQ ($391.90 in chips)
Seat 2: RwDoM55ZeQuI2ADyJhOb2Q ($208.50 in chips)
6hvg964TSqZ3AL/0XK9aVQ: posts small blind $1
RwDoM55ZeQuI2ADyJhOb2Q: posts big blind $2
*** HOLE CARDS ***
6hvg964TSqZ3AL/0XK9aVQ: folds
RwDoM55ZeQuI2ADyJhOb2Q collected $2 from pot
RwDoM55ZeQuI2ADyJhOb2Q: doesn't show hand
*** SUMMARY ***
Total pot $2 | Rake $0
Seat 1: 6hvg964TSqZ3AL/0XK9aVQ (button) (small blind) folded before Flop
Seat 2: RwDoM55ZeQuI2ADyJhOb2Q (big blind) collected ($2)



PokerStars Game #59937836224:  Hold'em No Limit ($1/$2) - 2009/07/01 0:00:58 ET
Table 'eyAQSIlgc2o1Jxvbve4WGg' 9-max Seat #8 is the button
Seat 1: Q3uFdu6ztesjDFiqkagTRQ ($200 in chips)
Seat 4: Lr5OlNr2kebm3oHSC54eJg ($90.35 in chips)
Seat 5: rW/MyplHylMSBRaoRUzWrg ($103.70 in chips)
Seat 6: IikcENBHwoT7snSvBPSc7Q ($195.85 in chips)
Seat 7: QHxJjpVYwitg9krW6wZgJA ($200 in chips)
Seat 8: 5iPk5MyO3KVu18Y8XCYfFQ ($39 in chips)
Seat 9: Hc2itIxwbi1lwa+DAYYQGg ($51.85 in chips)
Hc2itIxwbi1lwa+DAYYQGg: posts small blind $1
Q3uFdu6ztesjDFiqkagTRQ: posts big blind $2
GX1heJ+DSsvm7gzSPsYhhQ: sits out
TAfo4veNRaRlzDXMMYS3Jg: sits out
*** HOLE CARDS ***
Lr5OlNr2kebm3oHSC54eJg: calls $2
rW/MyplHylMSBRaoRUzWrg: folds
IikcENBHwoT7snSvBPSc7Q: calls $2
QHxJjpVYwitg9krW6wZgJA: folds
5iPk5MyO3KVu18Y8XCYfFQ: folds
Hc2itIxwbi1lwa+DAYYQGg: folds
Q3uFdu6ztesjDFiqkagTRQ: checks
*** FLOP *** [Ks 4c Kd]
Q3uFdu6ztesjDFiqkagTRQ: checks
Lr5OlNr2kebm3oHSC54eJg: checks
IikcENBHwoT7snSvBPSc7Q: checks
*** TURN *** [Ks 4c Kd] [Ad]
Q3uFdu6ztesjDFiqkagTRQ: checks
Lr5OlNr2kebm3oHSC54eJg: bets $2
IikcENBHwoT7snSvBPSc7Q: calls $2
Q3uFdu6ztesjDFiqkagTRQ: folds
*** RIVER *** [Ks 4c Kd Ad] [4d]
Lr5OlNr2kebm3oHSC54eJg: bets $2
IikcENBHwoT7snSvBPSc7Q: calls $2
*** SHOW DOWN ***
Lr5OlNr2kebm3oHSC54eJg: shows [As 8c] (two pair, Aces and Kings)
IikcENBHwoT7snSvBPSc7Q: mucks hand
Lr5OlNr2kebm3oHSC54eJg collected $14.30 from pot
*** SUMMARY ***
Total pot $15 | Rake $0.70
Board [Ks 4c Kd Ad 4d]
Seat 1: Q3uFdu6ztesjDFiqkagTRQ (big blind) folded on the Turn
Seat 4: Lr5OlNr2kebm3oHSC54eJg showed [As 8c] and won ($14.30) with two pair, Aces and Kings
Seat 5: rW/MyplHylMSBRaoRUzWrg folded before Flop (didn't bet)
Seat 6: IikcENBHwoT7snSvBPSc7Q mucked
Seat 7: QHxJjpVYwitg9krW6wZgJA folded before Flop (didn't bet)
Seat 8: 5iPk5MyO3KVu18Y8XCYfFQ (button) folded before Flop (didn't bet)
Seat 9: Hc2itIxwbi1lwa+DAYYQGg (small blind) folded before Flop



PokerStars Game #59937837940:  Hold'em No Limit ($1/$2) - 2009/07/01 0:01:01 ET
Table 'LL4bDFyhj5hsMpzaDugJZg' 6-max Seat #3 is the button
Seat 2: L3l+A4pJhOAD6HVVFXvVBw ($278.95 in chips)
Seat 3: gGPaCoSWW1HoKYaqfAPecg ($207 in chips)
Seat 4: 8srN1dKQePlsv0GyTada+Q ($215.30 in chips)
Seat 5: HgX0VeqE/dzSXd5BpntRBw ($203 in chips)
Seat 6: yZgdnRylE65JbScQ7qCWgw ($31 in chips)
8srN1dKQePlsv0GyTada+Q: posts small blind $1
HgX0VeqE/dzSXd5BpntRBw: posts big blind $2
*** HOLE CARDS ***
yZgdnRylE65JbScQ7qCWgw: folds
IBW9lyGsaRmfcbyA/qFfEw joins the table at seat #1
L3l+A4pJhOAD6HVVFXvVBw: raises $2 to $4
gGPaCoSWW1HoKYaqfAPecg: folds
8srN1dKQePlsv0GyTada+Q: raises $12 to $16
HgX0VeqE/dzSXd5BpntRBw: folds
L3l+A4pJhOAD6HVVFXvVBw: calls $12
*** FLOP *** [3c 5d Ah]
8srN1dKQePlsv0GyTada+Q: bets $22
L3l+A4pJhOAD6HVVFXvVBw: folds
8srN1dKQePlsv0GyTada+Q collected $32.30 from pot
*** SUMMARY ***
Total pot $34 | Rake $1.70
Board [3c 5d Ah]
Seat 2: L3l+A4pJhOAD6HVVFXvVBw folded on the Flop
Seat 3: gGPaCoSWW1HoKYaqfAPecg (button) folded before Flop (didn't bet)
Seat 4: 8srN1dKQePlsv0GyTada+Q (small blind) collected ($32.30)
Seat 5: HgX0VeqE/dzSXd5BpntRBw (big blind) folded before Flop
Seat 6: yZgdnRylE65JbScQ7qCWgw folded before Flop (didn't bet)



PokerStars Game #59937838708:  Hold'em No Limit ($1/$2) - 2009/07/01 0:01:02 ET
Table 'HewZCzVOYGmuLDKthTi5Yw' 6-max Seat #1 is the button
Seat 1: 353332 ($229.75 in chips)
Seat 2: X7GlkHF+lkbarCLuZ4Uf0w ($35 in chips)
Seat 4: yZgdnRylE65JbScQ7qCWgw ($41 in chips)
Seat 5: 513FcCI8jHyQy2VWoIQkMg ($374.50 in chips)
X7GlkHF+lkbarCLuZ4Uf0w: posts small blind $1
yZgdnRylE65JbScQ7qCWgw: posts big blind $2
*** HOLE CARDS ***
513FcCI8jHyQy2VWoIQkMg: folds
353332: folds
X7GlkHF+lkbarCLuZ4Uf0w: raises $3 to $5
yZgdnRylE65JbScQ7qCWgw: folds
X7GlkHF+lkbarCLuZ4Uf0w collected $4 from pot
X7GlkHF+lkbarCLuZ4Uf0w: doesn't show hand
*** SUMMARY ***
Total pot $4 | Rake $0
Seat 1: 353332 (button) folded before Flop (didn't bet)
Seat 2: X7GlkHF+lkbarCLuZ4Uf0w (small blind) collected ($4)
Seat 4: yZgdnRylE65JbScQ7qCWgw (big blind) folded before Flop
Seat 5: 513FcCI8jHyQy2VWoIQkMg folded before Flop (didn't bet)



PokerStars Game #59937839730:  Hold'em No Limit ($1/$2) - 2009/07/01 0:01:03 ET
Table '3FGoiEOffWrbgTfsB3t7FA' 2-max Seat #1 is the button
Seat 1: e0oDWyrmgLpR6bROEqw1nQ ($406 in chips)
Seat 2: +sy/nlNI20yZraIjs4AALg ($201.95 in chips)
e0oDWyrmgLpR6bROEqw1nQ: posts small blind $1
+sy/nlNI20yZraIjs4AALg: posts big blind $2
*** HOLE CARDS ***
e0oDWyrmgLpR6bROEqw1nQ: folds
+sy/nlNI20yZraIjs4AALg collected $2 from pot
*** SUMMARY ***
Total pot $2 | Rake $0
Seat 1: e0oDWyrmgLpR6bROEqw1nQ (button) (small blind) folded before Flop
Seat 2: +sy/nlNI20yZraIjs4AALg (big blind) collected ($2)



PokerStars Game #59937839912:  Hold'em No Limit ($1/$2) - 2009/07/01 0:01:04 ET
Table 'NmY84NAf9Mh0ckAckHnh5g' 2-max Seat #2 is the button
Seat 1: 6hvg964TSqZ3AL/0XK9aVQ ($390.90 in chips)
Seat 2: RwDoM55ZeQuI2ADyJhOb2Q ($209.50 in chips)
RwDoM55ZeQuI2ADyJhOb2Q: posts small blind $1
6hvg964TSqZ3AL/0XK9aVQ: posts big blind $2
*** HOLE CARDS ***
RwDoM55ZeQuI2ADyJhOb2Q: raises $4 to $6
6hvg964TSqZ3AL/0XK9aVQ: folds
RwDoM55ZeQuI2ADyJhOb2Q collected $4 from pot
RwDoM55ZeQuI2ADyJhOb2Q: doesn't show hand
*** SUMMARY ***
Total pot $4 | Rake $0
Seat 1: 6hvg964TSqZ3AL/0XK9aVQ (big blind) folded before Flop
Seat 2: RwDoM55ZeQuI2ADyJhOb2Q (button) (small blind) collected ($4)



PokerStars Game #59937840810:  Hold'em No Limit ($1/$2) - 2009/07/01 0:01:05 ET
Table 'XP2sRSup+aRuwzx3vDZsDg' 6-max Seat #2 is the button
Seat 2: yZgdnRylE65JbScQ7qCWgw ($40 in chips)
Seat 3: X7GlkHF+lkbarCLuZ4Uf0w ($29 in chips)
Seat 4: JsC+WvfzqlxVs9G8/gSQAQ ($112.95 in chips)
Seat 5: vkfxu8f/jMYKUk6Ly4eujw ($200 in chips)
Seat 6: h7ppRQJTYBsHCbLMeW9T2g ($496.75 in chips)
X7GlkHF+lkbarCLuZ4Uf0w: posts small blind $1
JsC+WvfzqlxVs9G8/gSQAQ: posts big blind $2
*** HOLE CARDS ***
vkfxu8f/jMYKUk6Ly4eujw: folds
h7ppRQJTYBsHCbLMeW9T2g: folds
yZgdnRylE65JbScQ7qCWgw: folds
X7GlkHF+lkbarCLuZ4Uf0w: raises $3 to $5
JsC+WvfzqlxVs9G8/gSQAQ: calls $3
*** FLOP *** [Ad 4c 9c]
X7GlkHF+lkbarCLuZ4Uf0w: checks
JsC+WvfzqlxVs9G8/gSQAQ: checks
*** TURN *** [Ad 4c 9c] [Qc]
X7GlkHF+lkbarCLuZ4Uf0w: bets $7
JsC+WvfzqlxVs9G8/gSQAQ: folds
X7GlkHF+lkbarCLuZ4Uf0w collected $9.50 from pot
*** SUMMARY ***
Total pot $10 | Rake $0.50
Board [Ad 4c 9c Qc]
Seat 2: yZgdnRylE65JbScQ7qCWgw (button) folded before Flop (didn't bet)
Seat 3: X7GlkHF+lkbarCLuZ4Uf0w (small blind) collected ($9.50)
Seat 4: JsC+WvfzqlxVs9G8/gSQAQ (big blind) folded on the Turn
Seat 5: vkfxu8f/jMYKUk6Ly4eujw folded before Flop (didn't bet)
Seat 6: h7ppRQJTYBsHCbLMeW9T2g folded before Flop (didn't bet)



PokerStars Game #59937841780:  Hold'em No Limit ($1/$2) - 2009/07/01 0:01:06 ET
Table 'ZzSIe0zTCDv+n6hfbY5tTg' 6-max Seat #5 is the button
Seat 1: 8srN1dKQePlsv0GyTada+Q ($219.70 in chips)
Seat 2: JQAf1Fiqbg0N8wNGA2nZhw ($200 in chips)
Seat 3: Y+MK4vQx233i+/aiP6js/Q ($352.20 in chips)
Seat 5: Q3uFdu6ztesjDFiqkagTRQ ($202.10 in chips)
Seat 6: 39260874 ($196.75 in chips)
39260874: posts small blind $1
8srN1dKQePlsv0GyTada+Q: posts big blind $2
*** HOLE CARDS ***
JQAf1Fiqbg0N8wNGA2nZhw: folds
Y+MK4vQx233i+/aiP6js/Q: folds
Q3uFdu6ztesjDFiqkagTRQ: raises $4 to $6
39260874: folds
8srN1dKQePlsv0GyTada+Q: folds
Q3uFdu6ztesjDFiqkagTRQ collected $5 from pot
Q3uFdu6ztesjDFiqkagTRQ: doesn't show hand
*** SUMMARY ***
Total pot $5 | Rake $0
Seat 1: 8srN1dKQePlsv0GyTada+Q (big blind) folded before Flop
Seat 2: JQAf1Fiqbg0N8wNGA2nZhw folded before Flop (didn't bet)
Seat 3: Y+MK4vQx233i+/aiP6js/Q folded before Flop (didn't bet)
Seat 5: Q3uFdu6ztesjDFiqkagTRQ (button) collected ($5)
Seat 6: 39260874 (small blind) folded before Flop



PokerStars Game #59937845332:  Hold'em No Limit ($1/$2) - 2009/07/01 0:01:11 ET
Table 'NmY84NAf9Mh0ckAckHnh5g' 2-max Seat #1 is the button
Seat 1: 6hvg964TSqZ3AL/0XK9aVQ ($388.90 in chips)
Seat 2: RwDoM55ZeQuI2ADyJhOb2Q ($211.50 in chips)
6hvg964TSqZ3AL/0XK9aVQ: posts small blind $1
RwDoM55ZeQuI2ADyJhOb2Q: posts big blind $2
*** HOLE CARDS ***
6hvg964TSqZ3AL/0XK9aVQ: calls $1
RwDoM55ZeQuI2ADyJhOb2Q: raises $6 to $8
6hvg964TSqZ3AL/0XK9aVQ: calls $6
*** FLOP *** [3s 6d Qs]
RwDoM55ZeQuI2ADyJhOb2Q: bets $10
6hvg964TSqZ3AL/0XK9aVQ: calls $10
*** TURN *** [3s 6d Qs] [Qh]
RwDoM55ZeQuI2ADyJhOb2Q: bets $22
6hvg964TSqZ3AL/0XK9aVQ: calls $22
*** RIVER *** [3s 6d Qs Qh] [6h]
RwDoM55ZeQuI2ADyJhOb2Q: bets $42
6hvg964TSqZ3AL/0XK9aVQ: folds
RwDoM55ZeQuI2ADyJhOb2Q collected $79.50 from pot
RwDoM55ZeQuI2ADyJhOb2Q: doesn't show hand
*** SUMMARY ***
Total pot $80 | Rake $0.50
Board [3s 6d Qs Qh 6h]
Seat 1: 6hvg964TSqZ3AL/0XK9aVQ (button) (small blind) folded on the River
Seat 2: RwDoM55ZeQuI2ADyJhOb2Q (big blind) collected ($79.50)



PokerStars Game #59937845916:  Hold'em No Limit ($1/$2) - 2009/07/01 0:01:12 ET
Table 'CFkQcfWjKccZaZDf71FK+w' 6-max Seat #4 is the button
Seat 1: X7GlkHF+lkbarCLuZ4Uf0w ($37 in chips)
Seat 2: yZgdnRylE65JbScQ7qCWgw ($37 in chips)
Seat 3: ygTTt5ehT4aF86q1a8/R+w ($124.40 in chips)
Seat 4: B2Ih1sr5VZk+8He7rcrMtQ ($218.90 in chips)
Seat 5: 1njbh8TKSUF6l4V1XwGdcg ($201 in chips)
Seat 6: ORVqY3rf9X6ANA/8s+On2Q ($91 in chips)
1njbh8TKSUF6l4V1XwGdcg: posts small blind $1
ORVqY3rf9X6ANA/8s+On2Q: posts big blind $2
*** HOLE CARDS ***
X7GlkHF+lkbarCLuZ4Uf0w: folds
yZgdnRylE65JbScQ7qCWgw: folds
ygTTt5ehT4aF86q1a8/R+w: folds
B2Ih1sr5VZk+8He7rcrMtQ: raises $2 to $4
1njbh8TKSUF6l4V1XwGdcg: folds
ORVqY3rf9X6ANA/8s+On2Q: folds
B2Ih1sr5VZk+8He7rcrMtQ collected $5 from pot
*** SUMMARY ***
Total pot $5 | Rake $0
Seat 1: X7GlkHF+lkbarCLuZ4Uf0w folded before Flop (didn't bet)
Seat 2: yZgdnRylE65JbScQ7qCWgw folded before Flop (didn't bet)
Seat 3: ygTTt5ehT4aF86q1a8/R+w folded before Flop (didn't bet)
Seat 4: B2Ih1sr5VZk+8He7rcrMtQ (button) collected ($5)
Seat 5: 1njbh8TKSUF6l4V1XwGdcg (small blind) folded before Flop
Seat 6: ORVqY3rf9X6ANA/8s+On2Q (big blind) folded before Flop



PokerStars Game #59937846460:  Hold'em No Limit ($1/$2) - 2009/07/01 0:01:13 ET
Table '3FGoiEOffWrbgTfsB3t7FA' 2-max Seat #2 is the button
Seat 1: e0oDWyrmgLpR6bROEqw1nQ ($405 in chips)
Seat 2: +sy/nlNI20yZraIjs4AALg ($202.95 in chips)
+sy/nlNI20yZraIjs4AALg: posts small blind $1
e0oDWyrmgLpR6bROEqw1nQ: posts big blind $2
*** HOLE CARDS ***
+sy/nlNI20yZraIjs4AALg: calls $1
e0oDWyrmgLpR6bROEqw1nQ: checks
*** FLOP *** [4d Qh Kd]
e0oDWyrmgLpR6bROEqw1nQ: checks
+sy/nlNI20yZraIjs4AALg: bets $6
e0oDWyrmgLpR6bROEqw1nQ: folds
+sy/nlNI20yZraIjs4AALg collected $3.80 from pot
*** SUMMARY ***
Total pot $4 | Rake $0.20
Board [4d Qh Kd]
Seat 1: e0oDWyrmgLpR6bROEqw1nQ (big blind) folded on the Flop
Seat 2: +sy/nlNI20yZraIjs4AALg (button) (small blind) collected ($3.80)



PokerStars Game #59937847144:  Hold'em No Limit ($1/$2) - 2009/07/01 0:01:14 ET
Table 'RF+CoNlqGlniDSszIP2SGw' 2-max Seat #1 is the button
Seat 1: e0oDWyrmgLpR6bROEqw1nQ ($248.50 in chips)
Seat 2: jKzajniHFCiIQAQeNkmTGg ($371.10 in chips)
e0oDWyrmgLpR6bROEqw1nQ: posts small blind $1
jKzajniHFCiIQAQeNkmTGg: posts big blind $2
*** HOLE CARDS ***
e0oDWyrmgLpR6bROEqw1nQ: folds
jKzajniHFCiIQAQeNkmTGg collected $2 from pot
jKzajniHFCiIQAQeNkmTGg: doesn't show hand
*** SUMMARY ***
Total pot $2 | Rake $0
Seat 1: e0oDWyrmgLpR6bROEqw1nQ (button) (small blind) folded before Flop
Seat 2: jKzajniHFCiIQAQeNkmTGg (big blind) collected ($2)



PokerStars Game #59937847228:  Hold'em No Limit ($1/$2) - 2009/07/01 0:01:14 ET
Table 'pPQgcj9XT9CHBsbo1WTBug' 6-max Seat #1 is the button
Seat 1: DFVYDA6dKQy7R7mGIKogZA ($115.90 in chips)
Seat 3: vkfxu8f/jMYKUk6Ly4eujw ($194 in chips)
Seat 5: 4Cl43Q1TYQL8wn1NSCUkaw ($64.80 in chips)
Seat 6: yZgdnRylE65JbScQ7qCWgw ($31 in chips)
vkfxu8f/jMYKUk6Ly4eujw: posts small blind $1
4Cl43Q1TYQL8wn1NSCUkaw: posts big blind $2
*** HOLE CARDS ***
yZgdnRylE65JbScQ7qCWgw: folds
DFVYDA6dKQy7R7mGIKogZA: folds
vkfxu8f/jMYKUk6Ly4eujw: folds
4Cl43Q1TYQL8wn1NSCUkaw collected $2 from pot
*** SUMMARY ***
Total pot $2 | Rake $0
Seat 1: DFVYDA6dKQy7R7mGIKogZA (button) folded before Flop (didn't bet)
Seat 3: vkfxu8f/jMYKUk6Ly4eujw (small blind) folded before Flop
Seat 5: 4Cl43Q1TYQL8wn1NSCUkaw (big blind) collected ($2)
Seat 6: yZgdnRylE65JbScQ7qCWgw folded before Flop (didn't bet)



PokerStars Game #59937849456:  Hold'em No Limit ($1/$2) - 2009/07/01 0:01:17 ET
Table 'rsKRKlGHlxVyqJxzO2a2Ow' 9-max Seat #1 is the button
Seat 1: uYWfQJg2hgHLxri6/uVJiw ($136.70 in chips)
Seat 2: QHxJjpVYwitg9krW6wZgJA ($246 in chips)
Seat 3: 9sYbXdhj1M2bwKrVNxj5+Q ($93.80 in chips)
Seat 4: zJtQ1gxyi72XvGYS1tM+DA ($51.15 in chips)
Seat 5: QxGDcfm0Yb34yQ4T9e1PIA ($176.90 in chips)
Seat 6: H6Z4+qu8gR0VUiPOijndVg ($200 in chips)
Seat 7: kVCeGJ4NY7Fb0W74j1mAqA ($200 in chips)
Seat 8: Hc2itIxwbi1lwa+DAYYQGg ($46 in chips)
Seat 9: 5iPk5MyO3KVu18Y8XCYfFQ ($96.20 in chips)
QHxJjpVYwitg9krW6wZgJA: posts small blind $1
9sYbXdhj1M2bwKrVNxj5+Q: posts big blind $2
*** HOLE CARDS ***
zJtQ1gxyi72XvGYS1tM+DA: calls $2
QxGDcfm0Yb34yQ4T9e1PIA: calls $2
H6Z4+qu8gR0VUiPOijndVg: folds
kVCeGJ4NY7Fb0W74j1mAqA: folds
Hc2itIxwbi1lwa+DAYYQGg: folds
5iPk5MyO3KVu18Y8XCYfFQ: folds
uYWfQJg2hgHLxri6/uVJiw: folds
QHxJjpVYwitg9krW6wZgJA: calls $1
9sYbXdhj1M2bwKrVNxj5+Q: checks
*** FLOP *** [2s 8c 7s]
QHxJjpVYwitg9krW6wZgJA: checks
9sYbXdhj1M2bwKrVNxj5+Q: checks
zJtQ1gxyi72XvGYS1tM+DA: checks
QxGDcfm0Yb34yQ4T9e1PIA: checks
*** TURN *** [2s 8c 7s] [5h]
QHxJjpVYwitg9krW6wZgJA: checks
9sYbXdhj1M2bwKrVNxj5+Q: checks
zJtQ1gxyi72XvGYS1tM+DA: bets $8
QxGDcfm0Yb34yQ4T9e1PIA: calls $8
QHxJjpVYwitg9krW6wZgJA: folds
9sYbXdhj1M2bwKrVNxj5+Q: folds
*** RIVER *** [2s 8c 7s 5h] [Kc]
zJtQ1gxyi72XvGYS1tM+DA: checks
QxGDcfm0Yb34yQ4T9e1PIA: bets $18
zJtQ1gxyi72XvGYS1tM+DA: folds
QxGDcfm0Yb34yQ4T9e1PIA collected $22.85 from pot
QxGDcfm0Yb34yQ4T9e1PIA: doesn't show hand
*** SUMMARY ***
Total pot $24 | Rake $1.15
Board [2s 8c 7s 5h Kc]
Seat 1: uYWfQJg2hgHLxri6/uVJiw (button) folded before Flop (didn't bet)
Seat 2: QHxJjpVYwitg9krW6wZgJA (small blind) folded on the Turn
Seat 3: 9sYbXdhj1M2bwKrVNxj5+Q (big blind) folded on the Turn
Seat 4: zJtQ1gxyi72XvGYS1tM+DA folded on the River
Seat 5: QxGDcfm0Yb34yQ4T9e1PIA collected ($22.85)
Seat 6: H6Z4+qu8gR0VUiPOijndVg folded before Flop (didn't bet)
Seat 7: kVCeGJ4NY7Fb0W74j1mAqA folded before Flop (didn't bet)
Seat 8: Hc2itIxwbi1lwa+DAYYQGg folded before Flop (didn't bet)
Seat 9: 5iPk5MyO3KVu18Y8XCYfFQ folded before Flop (didn't bet)



PokerStars Game #59937850808:  Hold'em No Limit ($1/$2) - 2009/07/01 0:01:19 ET
Table 'qVXak+oTeDXMGbWa4sDU5Q' 9-max Seat #7 is the button
Seat 1: H6Z4+qu8gR0VUiPOijndVg ($257 in chips)
Seat 2: Hc2itIxwbi1lwa+DAYYQGg ($37 in chips)
Seat 3: oz9eCXGC7DdjQlL/nuWj1A ($93 in chips)
Seat 4: b0jO1SDhLedy1//CQlA8kw ($40 in chips)
Seat 5: VJh1u3Qcjd3FuCT5ejyKYg ($77.10 in chips)
Seat 6: Q3uFdu6ztesjDFiqkagTRQ ($239.40 in chips)
Seat 7: 5iPk5MyO3KVu18Y8XCYfFQ ($50.50 in chips)
Seat 8: 9pHZMviI9R8injxojGTnvw ($47.60 in chips)
Seat 9: IZ/2qsh1CIg9m5PWsMsLmA ($378.95 in chips)
9pHZMviI9R8injxojGTnvw: posts small blind $1
IZ/2qsh1CIg9m5PWsMsLmA: posts big blind $2
*** HOLE CARDS ***
H6Z4+qu8gR0VUiPOijndVg: folds
Hc2itIxwbi1lwa+DAYYQGg: folds
oz9eCXGC7DdjQlL/nuWj1A: folds
b0jO1SDhLedy1//CQlA8kw: folds
VJh1u3Qcjd3FuCT5ejyKYg: folds
Q3uFdu6ztesjDFiqkagTRQ: raises $4 to $6
5iPk5MyO3KVu18Y8XCYfFQ: raises $44.50 to $50.50 and is all-in
9pHZMviI9R8injxojGTnvw: folds
IZ/2qsh1CIg9m5PWsMsLmA: folds
Q3uFdu6ztesjDFiqkagTRQ: folds
5iPk5MyO3KVu18Y8XCYfFQ collected $15 from pot
5iPk5MyO3KVu18Y8XCYfFQ: doesn't show hand
*** SUMMARY ***
Total pot $15 | Rake $0
Seat 1: H6Z4+qu8gR0VUiPOijndVg folded before Flop (didn't bet)
Seat 2: Hc2itIxwbi1lwa+DAYYQGg folded before Flop (didn't bet)
Seat 3: oz9eCXGC7DdjQlL/nuWj1A folded before Flop (didn't bet)
Seat 4: b0jO1SDhLedy1//CQlA8kw folded before Flop (didn't bet)
Seat 5: VJh1u3Qcjd3FuCT5ejyKYg folded before Flop (didn't bet)
Seat 6: Q3uFdu6ztesjDFiqkagTRQ folded before Flop
Seat 7: 5iPk5MyO3KVu18Y8XCYfFQ (button) collected ($15)
Seat 8: 9pHZMviI9R8injxojGTnvw (small blind) folded before Flop
Seat 9: IZ/2qsh1CIg9m5PWsMsLmA (big blind) folded before Flop



PokerStars Game #59937851622:  Hold'em No Limit ($1/$2) - 2009/07/01 0:01:20 ET
Table 'RF+CoNlqGlniDSszIP2SGw' 2-max Seat #2 is the button
Seat 1: e0oDWyrmgLpR6bROEqw1nQ ($247.50 in chips)
Seat 2: jKzajniHFCiIQAQeNkmTGg ($372.10 in chips)
jKzajniHFCiIQAQeNkmTGg: posts small blind $1
e0oDWyrmgLpR6bROEqw1nQ: posts big blind $2
*** HOLE CARDS ***
jKzajniHFCiIQAQeNkmTGg: calls $1
e0oDWyrmgLpR6bROEqw1nQ: checks
*** FLOP *** [Qc 4c 8s]
e0oDWyrmgLpR6bROEqw1nQ: checks
jKzajniHFCiIQAQeNkmTGg: checks
*** TURN *** [Qc 4c 8s] [8d]
e0oDWyrmgLpR6bROEqw1nQ: checks
jKzajniHFCiIQAQeNkmTGg: checks
*** RIVER *** [Qc 4c 8s 8d] [8h]
e0oDWyrmgLpR6bROEqw1nQ: checks
jKzajniHFCiIQAQeNkmTGg: checks
*** SHOW DOWN ***
e0oDWyrmgLpR6bROEqw1nQ: shows [3c 9s] (three of a kind, Eights)
jKzajniHFCiIQAQeNkmTGg: shows [Kh 2h] (three of a kind, Eights - King kicker)
jKzajniHFCiIQAQeNkmTGg collected $3.80 from pot
*** SUMMARY ***
Total pot $4 | Rake $0.20
Board [Qc 4c 8s 8d 8h]
Seat 1: e0oDWyrmgLpR6bROEqw1nQ (big blind) showed [3c 9s] and lost with three of a kind, Eights
Seat 2: jKzajniHFCiIQAQeNkmTGg (button) (small blind) showed [Kh 2h] and won ($3.80) with three of a kind, Eights



PokerStars Game #59937852508:  Hold'em No Limit ($1/$2) - 2009/07/01 0:01:21 ET
Table 'WCA60bDA8ecovUgFSIZkTQ' 9-max Seat #1 is the button
Seat 1: xNLmepWbCljNEEeH8O5jSg ($266.65 in chips)
Seat 2: G1h8wamBcVJXtsKXZQ2EyA ($72.75 in chips)
Seat 3: 5iPk5MyO3KVu18Y8XCYfFQ ($40 in chips)
Seat 4: Q3uFdu6ztesjDFiqkagTRQ ($450.70 in chips)
Seat 5: Hc2itIxwbi1lwa+DAYYQGg ($312.30 in chips)
Seat 6: DOWQSOJ7GaX+ksfWTqPT5A ($206.75 in chips)
Seat 7: GX1heJ+DSsvm7gzSPsYhhQ ($34 in chips)
Seat 8: x+V1JgVDawsJTxKcxm7gxw ($100 in chips)
Seat 9: 3q2/0oJr3Mcy1W5tcN61ug ($301.20 in chips)
G1h8wamBcVJXtsKXZQ2EyA: posts small blind $1
5iPk5MyO3KVu18Y8XCYfFQ: posts big blind $2
*** HOLE CARDS ***
Q3uFdu6ztesjDFiqkagTRQ: folds
Hc2itIxwbi1lwa+DAYYQGg: folds
DOWQSOJ7GaX+ksfWTqPT5A: calls $2
GX1heJ+DSsvm7gzSPsYhhQ: folds
x+V1JgVDawsJTxKcxm7gxw: folds
3q2/0oJr3Mcy1W5tcN61ug: folds
xNLmepWbCljNEEeH8O5jSg: folds
G1h8wamBcVJXtsKXZQ2EyA: raises $4 to $6
5iPk5MyO3KVu18Y8XCYfFQ: folds
DOWQSOJ7GaX+ksfWTqPT5A: calls $4
*** FLOP *** [3s 6s As]
G1h8wamBcVJXtsKXZQ2EyA: bets $10
DOWQSOJ7GaX+ksfWTqPT5A: folds
G1h8wamBcVJXtsKXZQ2EyA collected $13.30 from pot
*** SUMMARY ***
Total pot $14 | Rake $0.70
Board [3s 6s As]
Seat 1: xNLmepWbCljNEEeH8O5jSg (button) folded before Flop (didn't bet)
Seat 2: G1h8wamBcVJXtsKXZQ2EyA (small blind) collected ($13.30)
Seat 3: 5iPk5MyO3KVu18Y8XCYfFQ (big blind) folded before Flop
Seat 4: Q3uFdu6ztesjDFiqkagTRQ folded before Flop (didn't bet)
Seat 5: Hc2itIxwbi1lwa+DAYYQGg folded before Flop (didn't bet)
Seat 6: DOWQSOJ7GaX+ksfWTqPT5A folded on the Flop
Seat 7: GX1heJ+DSsvm7gzSPsYhhQ folded before Flop (didn't bet)
Seat 8: x+V1JgVDawsJTxKcxm7gxw folded before Flop (didn't bet)
Seat 9: 3q2/0oJr3Mcy1W5tcN61ug folded before Flop (didn't bet)



PokerStars Game #59937855638:  Hold'em No Limit ($1/$2) - 2009/07/01 0:01:25 ET
Table 'YqGfR5eHfMeSjb9a+QU9rg' 9-max Seat #1 is the button
Seat 1: qCBuzVnLcBR29snMAHq9PA ($180.35 in chips)
Seat 2: W3Nqt1GWlTi9tXQXMNEvgw ($162.60 in chips)
Seat 3: 02K2DtsrlV5RLBdrzZcWqg ($119.55 in chips)
Seat 5: MOBMOMQRN/z+fiGXGnZojw ($191.10 in chips)
Seat 6: 5iPk5MyO3KVu18Y8XCYfFQ ($36 in chips)
Seat 7: b0jO1SDhLedy1//CQlA8kw ($42 in chips)
Seat 8: GX1heJ+DSsvm7gzSPsYhhQ ($32 in chips)
Seat 9: RsrgM2l7PLbQ9xBbSi3IvQ ($110.40 in chips)
W3Nqt1GWlTi9tXQXMNEvgw: posts small blind $1
02K2DtsrlV5RLBdrzZcWqg: posts big blind $2
QHxJjpVYwitg9krW6wZgJA: sits out
*** HOLE CARDS ***
MOBMOMQRN/z+fiGXGnZojw: folds
5iPk5MyO3KVu18Y8XCYfFQ: folds
b0jO1SDhLedy1//CQlA8kw: folds
GX1heJ+DSsvm7gzSPsYhhQ: folds
RsrgM2l7PLbQ9xBbSi3IvQ: folds
qCBuzVnLcBR29snMAHq9PA: folds
W3Nqt1GWlTi9tXQXMNEvgw: calls $1
02K2DtsrlV5RLBdrzZcWqg: raises $4 to $6
W3Nqt1GWlTi9tXQXMNEvgw: calls $4
*** FLOP *** [2h Tc 5c]
W3Nqt1GWlTi9tXQXMNEvgw: checks
02K2DtsrlV5RLBdrzZcWqg: bets $8
W3Nqt1GWlTi9tXQXMNEvgw: raises $8 to $16
02K2DtsrlV5RLBdrzZcWqg: calls $8
*** TURN *** [2h Tc 5c] [5d]
W3Nqt1GWlTi9tXQXMNEvgw: bets $22
02K2DtsrlV5RLBdrzZcWqg: calls $22
*** RIVER *** [2h Tc 5c 5d] [Jh]
W3Nqt1GWlTi9tXQXMNEvgw: bets $14
02K2DtsrlV5RLBdrzZcWqg: calls $14
*** SHOW DOWN ***
W3Nqt1GWlTi9tXQXMNEvgw: shows [Qd Qs] (two pair, Queens and Fives)
02K2DtsrlV5RLBdrzZcWqg: mucks hand
W3Nqt1GWlTi9tXQXMNEvgw collected $113 from pot
*** SUMMARY ***
Total pot $116 | Rake $3
Board [2h Tc 5c 5d Jh]
Seat 1: qCBuzVnLcBR29snMAHq9PA (button) folded before Flop (didn't bet)
Seat 2: W3Nqt1GWlTi9tXQXMNEvgw (small blind) showed [Qd Qs] and won ($113) with two pair, Queens and Fives
Seat 3: 02K2DtsrlV5RLBdrzZcWqg (big blind) mucked
Seat 5: MOBMOMQRN/z+fiGXGnZojw folded before Flop (didn't bet)
Seat 6: 5iPk5MyO3KVu18Y8XCYfFQ folded before Flop (didn't bet)
Seat 7: b0jO1SDhLedy1//CQlA8kw folded before Flop (didn't bet)
Seat 8: GX1heJ+DSsvm7gzSPsYhhQ folded before Flop (didn't bet)
Seat 9: RsrgM2l7PLbQ9xBbSi3IvQ folded before Flop (didn't bet)



PokerStars Game #59937856840:  Hold'em No Limit ($1/$2) - 2009/07/01 0:01:27 ET
Table 'HewZCzVOYGmuLDKthTi5Yw' 6-max Seat #2 is the button
Seat 1: 353332 ($229.75 in chips)
Seat 2: X7GlkHF+lkbarCLuZ4Uf0w ($37 in chips)
Seat 4: yZgdnRylE65JbScQ7qCWgw ($39 in chips)
Seat 5: 513FcCI8jHyQy2VWoIQkMg ($374.50 in chips)
yZgdnRylE65JbScQ7qCWgw: posts small blind $1
513FcCI8jHyQy2VWoIQkMg: posts big blind $2
*** HOLE CARDS ***
353332: folds
X7GlkHF+lkbarCLuZ4Uf0w: raises $2 to $4
yZgdnRylE65JbScQ7qCWgw: folds
513FcCI8jHyQy2VWoIQkMg: folds
X7GlkHF+lkbarCLuZ4Uf0w collected $5 from pot
X7GlkHF+lkbarCLuZ4Uf0w: doesn't show hand
*** SUMMARY ***
Total pot $5 | Rake $0
Seat 1: 353332 folded before Flop (didn't bet)
Seat 2: X7GlkHF+lkbarCLuZ4Uf0w (button) collected ($5)
Seat 4: yZgdnRylE65JbScQ7qCWgw (small blind) folded before Flop
Seat 5: 513FcCI8jHyQy2VWoIQkMg (big blind) folded before Flop



PokerStars Game #59937857258:  Hold'em No Limit ($1/$2) - 2009/07/01 0:01:28 ET
Table 'pPQgcj9XT9CHBsbo1WTBug' 6-max Seat #3 is the button
Seat 1: DFVYDA6dKQy7R7mGIKogZA ($115.90 in chips)
Seat 3: vkfxu8f/jMYKUk6Ly4eujw ($193 in chips)
Seat 5: 4Cl43Q1TYQL8wn1NSCUkaw ($65.80 in chips)
Seat 6: yZgdnRylE65JbScQ7qCWgw ($31 in chips)
4Cl43Q1TYQL8wn1NSCUkaw: posts small blind $1
yZgdnRylE65JbScQ7qCWgw: posts big blind $2
*** HOLE CARDS ***
DFVYDA6dKQy7R7mGIKogZA: folds
vkfxu8f/jMYKUk6Ly4eujw: folds
4Cl43Q1TYQL8wn1NSCUkaw: calls $1
yZgdnRylE65JbScQ7qCWgw: checks
*** FLOP *** [7d 8s Qc]
4Cl43Q1TYQL8wn1NSCUkaw: bets $4
yZgdnRylE65JbScQ7qCWgw: folds
4Cl43Q1TYQL8wn1NSCUkaw collected $3.80 from pot
*** SUMMARY ***
Total pot $4 | Rake $0.20
Board [7d 8s Qc]
Seat 1: DFVYDA6dKQy7R7mGIKogZA folded before Flop (didn't bet)
Seat 3: vkfxu8f/jMYKUk6Ly4eujw (button) folded before Flop (didn't bet)
Seat 5: 4Cl43Q1TYQL8wn1NSCUkaw (small blind) collected ($3.80)
Seat 6: yZgdnRylE65JbScQ7qCWgw (big blind) folded on the Flop



PokerStars Game #59937858608:  Hold'em No Limit ($1/$2) - 2009/07/01 0:01:30 ET
Table 'ztv6V3FN2bQ9nmJPPdx6nQ' 6-max Seat #3 is the button
Seat 1: ek1hig03QiyONDHXvgqteQ ($196.75 in chips)
Seat 3: Z55K9DbCHCUi6UaztIHi6g ($149.05 in chips)
Seat 4: vkfxu8f/jMYKUk6Ly4eujw ($317.70 in chips)
Seat 5: sTPOWERd9HWPCNrDBwsVjA ($200 in chips)
Seat 6: yZgdnRylE65JbScQ7qCWgw ($37 in chips)
vkfxu8f/jMYKUk6Ly4eujw: posts small blind $1
sTPOWERd9HWPCNrDBwsVjA: posts big blind $2
*** HOLE CARDS ***
yZgdnRylE65JbScQ7qCWgw: folds
ek1hig03QiyONDHXvgqteQ: folds
Z55K9DbCHCUi6UaztIHi6g: calls $2
vkfxu8f/jMYKUk6Ly4eujw: folds
sTPOWERd9HWPCNrDBwsVjA: checks
*** FLOP *** [2s 9c Ts]
sTPOWERd9HWPCNrDBwsVjA: bets $4
Z55K9DbCHCUi6UaztIHi6g: folds
sTPOWERd9HWPCNrDBwsVjA collected $4.75 from pot
*** SUMMARY ***
Total pot $5 | Rake $0.25
Board [2s 9c Ts]
Seat 1: ek1hig03QiyONDHXvgqteQ folded before Flop (didn't bet)
Seat 3: Z55K9DbCHCUi6UaztIHi6g (button) folded on the Flop
Seat 4: vkfxu8f/jMYKUk6Ly4eujw (small blind) folded before Flop
Seat 5: sTPOWERd9HWPCNrDBwsVjA (big blind) collected ($4.75)
Seat 6: yZgdnRylE65JbScQ7qCWgw folded before Flop (didn't bet)



PokerStars Game #59937860026:  Hold'em No Limit ($1/$2) - 2009/07/01 0:01:32 ET
Table 'fe+AlpfadsfwxhZEvYFbbA' 6-max Seat #2 is the button
Seat 1: SLlqn2PPbQqwfcLfYqUXrw ($108.10 in chips)
Seat 2: /PH6Ffnho4Ysm8S3V/oa+w ($40 in chips)
Seat 3: 54yWzRRgS0oZ+S6LwZBxMQ ($29.65 in chips)
Seat 5: gGPaCoSWW1HoKYaqfAPecg ($202.20 in chips)
Seat 6: 5Y+ZGWLI4gnlpApDX5vy1A ($207.55 in chips)
54yWzRRgS0oZ+S6LwZBxMQ: posts small blind $1
gGPaCoSWW1HoKYaqfAPecg: posts big blind $2
*** HOLE CARDS ***
5Y+ZGWLI4gnlpApDX5vy1A: folds
SLlqn2PPbQqwfcLfYqUXrw: raises $2 to $4
/PH6Ffnho4Ysm8S3V/oa+w: folds
54yWzRRgS0oZ+S6LwZBxMQ: calls $3
gGPaCoSWW1HoKYaqfAPecg: folds
*** FLOP *** [5s Ts 3h]
54yWzRRgS0oZ+S6LwZBxMQ: checks
SLlqn2PPbQqwfcLfYqUXrw: bets $6
54yWzRRgS0oZ+S6LwZBxMQ: raises $6 to $12
SLlqn2PPbQqwfcLfYqUXrw: raises $8 to $20
54yWzRRgS0oZ+S6LwZBxMQ: raises $5.65 to $25.65 and is all-in
SLlqn2PPbQqwfcLfYqUXrw: calls $5.65
*** TURN *** [5s Ts 3h] [Ks]
*** RIVER *** [5s Ts 3h Ks] [Qd]
*** SHOW DOWN ***
54yWzRRgS0oZ+S6LwZBxMQ: shows [5h 5d] (three of a kind, Fives)
SLlqn2PPbQqwfcLfYqUXrw: mucks hand
54yWzRRgS0oZ+S6LwZBxMQ collected $59.30 from pot
*** SUMMARY ***
Total pot $61.30 | Rake $2
Board [5s Ts 3h Ks Qd]
Seat 1: SLlqn2PPbQqwfcLfYqUXrw mucked
Seat 2: /PH6Ffnho4Ysm8S3V/oa+w (button) folded before Flop (didn't bet)
Seat 3: 54yWzRRgS0oZ+S6LwZBxMQ (small blind) showed [5h 5d] and won ($59.30) with three of a kind, Fives
Seat 5: gGPaCoSWW1HoKYaqfAPecg (big blind) folded before Flop
Seat 6: 5Y+ZGWLI4gnlpApDX5vy1A folded before Flop (didn't bet)



PokerStars Game #59937863440:  Hold'em No Limit ($1/$2) - 2009/07/01 0:01:36 ET
Table 'on4i1U1lCRmxsduFD3xiSg' 9-max Seat #1 is the button
Seat 1: BRHGptvmY2GKq4uuj7duDw ($276.60 in chips)
Seat 2: yZYrOeNDxQxkzpbgKX1bng ($68 in chips)
Seat 3: 5iPk5MyO3KVu18Y8XCYfFQ ($61.20 in chips)
Seat 4: Z3aYCZG/yXHYFjiWkGI5ug ($207.30 in chips)
Seat 5: QHxJjpVYwitg9krW6wZgJA ($200 in chips)
Seat 6: SB0tvOX0Kw61r2U851JFaA ($403.20 in chips)
Seat 7: xD4ElYxz6Ollzmam8BmMCw ($249.25 in chips)
Seat 8: YlSX2xwu8QMQReaxSAD8XA ($164.85 in chips)
Seat 9: iMe5yhc+1BaiIPHet3NMrA ($200 in chips)
yZYrOeNDxQxkzpbgKX1bng: posts small blind $1
5iPk5MyO3KVu18Y8XCYfFQ: posts big blind $2
*** HOLE CARDS ***
Z3aYCZG/yXHYFjiWkGI5ug: folds
QHxJjpVYwitg9krW6wZgJA: folds
SB0tvOX0Kw61r2U851JFaA: folds
xD4ElYxz6Ollzmam8BmMCw: folds
YlSX2xwu8QMQReaxSAD8XA: folds
iMe5yhc+1BaiIPHet3NMrA: folds
BRHGptvmY2GKq4uuj7duDw: folds
yZYrOeNDxQxkzpbgKX1bng: raises $2 to $4
5iPk5MyO3KVu18Y8XCYfFQ: raises $57.20 to $61.20 and is all-in
yZYrOeNDxQxkzpbgKX1bng: folds
5iPk5MyO3KVu18Y8XCYfFQ collected $8 from pot
*** SUMMARY ***
Total pot $8 | Rake $0
Seat 1: BRHGptvmY2GKq4uuj7duDw (button) folded before Flop (didn't bet)
Seat 2: yZYrOeNDxQxkzpbgKX1bng (small blind) folded before Flop
Seat 3: 5iPk5MyO3KVu18Y8XCYfFQ (big blind) collected ($8)
Seat 4: Z3aYCZG/yXHYFjiWkGI5ug folded before Flop (didn't bet)
Seat 5: QHxJjpVYwitg9krW6wZgJA folded before Flop (didn't bet)
Seat 6: SB0tvOX0Kw61r2U851JFaA folded before Flop (didn't bet)
Seat 7: xD4ElYxz6Ollzmam8BmMCw folded before Flop (didn't bet)
Seat 8: YlSX2xwu8QMQReaxSAD8XA folded before Flop (didn't bet)
Seat 9: iMe5yhc+1BaiIPHet3NMrA folded before Flop (didn't bet)



PokerStars Game #59937863484:  Hold'em No Limit ($1/$2) - 2009/07/01 0:01:36 ET
Table 'jlrIxbrVIG+gjaUYT4za8g' 6-max Seat #5 is the button
Seat 1: ygTTt5ehT4aF86q1a8/R+w ($179.35 in chips)
Seat 2: N18PrNGQj43J7TJuQuu+tw ($168.05 in chips)
Seat 3: /PH6Ffnho4Ysm8S3V/oa+w ($40 in chips)
Seat 4: 8srN1dKQePlsv0GyTada+Q ($200 in chips)
Seat 5: F/075N6nU34Fn0zr6qD3aw ($171.55 in chips)
Seat 6: vkfxu8f/jMYKUk6Ly4eujw ($261.40 in chips)
vkfxu8f/jMYKUk6Ly4eujw: posts small blind $1
ygTTt5ehT4aF86q1a8/R+w: posts big blind $2
*** HOLE CARDS ***
N18PrNGQj43J7TJuQuu+tw: folds
/PH6Ffnho4Ysm8S3V/oa+w: folds
8srN1dKQePlsv0GyTada+Q: raises $4 to $6
F/075N6nU34Fn0zr6qD3aw: folds
vkfxu8f/jMYKUk6Ly4eujw: folds
ygTTt5ehT4aF86q1a8/R+w: folds
8srN1dKQePlsv0GyTada+Q collected $5 from pot
*** SUMMARY ***
Total pot $5 | Rake $0
Seat 1: ygTTt5ehT4aF86q1a8/R+w (big blind) folded before Flop
Seat 2: N18PrNGQj43J7TJuQuu+tw folded before Flop (didn't bet)
Seat 3: /PH6Ffnho4Ysm8S3V/oa+w folded before Flop (didn't bet)
Seat 4: 8srN1dKQePlsv0GyTada+Q collected ($5)
Seat 5: F/075N6nU34Fn0zr6qD3aw (button) folded before Flop (didn't bet)
Seat 6: vkfxu8f/jMYKUk6Ly4eujw (small blind) folded before Flop



PokerStars Game #59937864082:  Hold'em No Limit ($1/$2) - 2009/07/01 0:01:37 ET
Table 'aSf77Sj8QEnzcc0WaxVD4Q' 6-max Seat #6 is the button
Seat 1: Q3uFdu6ztesjDFiqkagTRQ ($200 in chips)
Seat 2: vkfxu8f/jMYKUk6Ly4eujw ($207.75 in chips)
Seat 3: 9dpyyjDTCed6nV7JhaUUpw ($223.05 in chips)
Seat 4: 513FcCI8jHyQy2VWoIQkMg ($212.60 in chips)
Seat 5: InmkdI6G8TzSj9NhcCSyPg ($235 in chips)
Seat 6: vkoJRf3gidxY1pPi0AFWww ($345.05 in chips)
Q3uFdu6ztesjDFiqkagTRQ: posts small blind $1
vkfxu8f/jMYKUk6Ly4eujw: posts big blind $2
*** HOLE CARDS ***
9dpyyjDTCed6nV7JhaUUpw: folds
513FcCI8jHyQy2VWoIQkMg: folds
InmkdI6G8TzSj9NhcCSyPg: raises $4 to $6
vkoJRf3gidxY1pPi0AFWww: raises $6 to $12
Q3uFdu6ztesjDFiqkagTRQ: folds
vkfxu8f/jMYKUk6Ly4eujw: folds
InmkdI6G8TzSj9NhcCSyPg: raises $22 to $34
vkoJRf3gidxY1pPi0AFWww: calls $22
*** FLOP *** [8d 2c 6s]
InmkdI6G8TzSj9NhcCSyPg: bets $41
vkoJRf3gidxY1pPi0AFWww: folds
InmkdI6G8TzSj9NhcCSyPg collected $68 from pot
InmkdI6G8TzSj9NhcCSyPg: doesn't show hand
*** SUMMARY ***
Total pot $71 | Rake $3
Board [8d 2c 6s]
Seat 1: Q3uFdu6ztesjDFiqkagTRQ (small blind) folded before Flop
Seat 2: vkfxu8f/jMYKUk6Ly4eujw (big blind) folded before Flop
Seat 3: 9dpyyjDTCed6nV7JhaUUpw folded before Flop (didn't bet)
Seat 4: 513FcCI8jHyQy2VWoIQkMg folded before Flop (didn't bet)
Seat 5: InmkdI6G8TzSj9NhcCSyPg collected ($68)
Seat 6: vkoJRf3gidxY1pPi0AFWww (button) folded on the Flop



PokerStars Game #59937865388:  Hold'em No Limit ($1/$2) - 2009/07/01 0:01:39 ET
Table 'uJ9juaXXg9yIcSU8amxaXQ' 6-max Seat #5 is the button
Seat 1: HhIxv6mylwCAfv3sjJmq5g ($200 in chips)
Seat 2: DQlskgG4OtLpF2MVxLwf4A ($278.70 in chips)
Seat 3: zaogaltCDFVsIASEnrXs2w ($259.75 in chips)
Seat 5: F/075N6nU34Fn0zr6qD3aw ($230.05 in chips)
Seat 6: XrFG4dK06RVKLlX32/pjcQ ($43.90 in chips)
XrFG4dK06RVKLlX32/pjcQ: posts small blind $1
HhIxv6mylwCAfv3sjJmq5g: posts big blind $2
54yWzRRgS0oZ+S6LwZBxMQ: sits out
*** HOLE CARDS ***
DQlskgG4OtLpF2MVxLwf4A: folds
zaogaltCDFVsIASEnrXs2w: folds
F/075N6nU34Fn0zr6qD3aw: folds
XrFG4dK06RVKLlX32/pjcQ: calls $1
HhIxv6mylwCAfv3sjJmq5g: checks
*** FLOP *** [6s 4h As]
XrFG4dK06RVKLlX32/pjcQ: checks
HhIxv6mylwCAfv3sjJmq5g: checks
*** TURN *** [6s 4h As] [Jd]
XrFG4dK06RVKLlX32/pjcQ: checks
HhIxv6mylwCAfv3sjJmq5g: checks
*** RIVER *** [6s 4h As Jd] [Ks]
XrFG4dK06RVKLlX32/pjcQ: bets $6
HhIxv6mylwCAfv3sjJmq5g: folds
XrFG4dK06RVKLlX32/pjcQ collected $3.80 from pot
*** SUMMARY ***
Total pot $4 | Rake $0.20
Board [6s 4h As Jd Ks]
Seat 1: HhIxv6mylwCAfv3sjJmq5g (big blind) folded on the River
Seat 2: DQlskgG4OtLpF2MVxLwf4A folded before Flop (didn't bet)
Seat 3: zaogaltCDFVsIASEnrXs2w folded before Flop (didn't bet)
Seat 5: F/075N6nU34Fn0zr6qD3aw (button) folded before Flop (didn't bet)
Seat 6: XrFG4dK06RVKLlX32/pjcQ (small blind) collected ($3.80)



PokerStars Game #59937865848:  Hold'em No Limit ($1/$2) - 2009/07/01 0:01:40 ET
Table '3FGoiEOffWrbgTfsB3t7FA' 2-max Seat #1 is the button
Seat 1: e0oDWyrmgLpR6bROEqw1nQ ($403 in chips)
Seat 2: +sy/nlNI20yZraIjs4AALg ($204.75 in chips)
e0oDWyrmgLpR6bROEqw1nQ: posts small blind $1
+sy/nlNI20yZraIjs4AALg: posts big blind $2
*** HOLE CARDS ***
e0oDWyrmgLpR6bROEqw1nQ: raises $4 to $6
+sy/nlNI20yZraIjs4AALg: calls $4
*** FLOP *** [Tc 3c 4d]
+sy/nlNI20yZraIjs4AALg: checks
e0oDWyrmgLpR6bROEqw1nQ: bets $8
+sy/nlNI20yZraIjs4AALg: folds
e0oDWyrmgLpR6bROEqw1nQ collected $11.50 from pot
*** SUMMARY ***
Total pot $12 | Rake $0.50
Board [Tc 3c 4d]
Seat 1: e0oDWyrmgLpR6bROEqw1nQ (button) (small blind) collected ($11.50)
Seat 2: +sy/nlNI20yZraIjs4AALg (big blind) folded on the Flop



PokerStars Game #59937867408:  Hold'em No Limit ($1/$2) - 2009/07/01 0:01:42 ET
Table 'SF49/KQm8T4taMp6kb+HXA' 9-max Seat #9 is the button
Seat 1: l1bCLGuFqeFRwUfPsiDu/g ($194.95 in chips)
Seat 2: dJO4Wtu5e7hHBlpz0cmy1w ($80.20 in chips)
Seat 3: L88dtdULfz5oGDSuo9/RvA ($36.05 in chips)
Seat 4: 02K2DtsrlV5RLBdrzZcWqg ($104 in chips)
Seat 5: Z3aYCZG/yXHYFjiWkGI5ug ($236.55 in chips)
Seat 6: M2ht6rIKOI/my9eh610Nlw ($250.45 in chips)
Seat 7: n2VAbLaE5qgKr5mA4W6v4w ($56.50 in chips)
Seat 8: 5iPk5MyO3KVu18Y8XCYfFQ ($39 in chips)
Seat 9: O+jytCilwk7zItVCEavmtw ($112.10 in chips)
l1bCLGuFqeFRwUfPsiDu/g: posts small blind $1
dJO4Wtu5e7hHBlpz0cmy1w: posts big blind $2
*** HOLE CARDS ***
L88dtdULfz5oGDSuo9/RvA: folds
02K2DtsrlV5RLBdrzZcWqg: folds
02K2DtsrlV5RLBdrzZcWqg leaves the table
Z3aYCZG/yXHYFjiWkGI5ug: folds
M2ht6rIKOI/my9eh610Nlw: folds
n2VAbLaE5qgKr5mA4W6v4w: folds
5iPk5MyO3KVu18Y8XCYfFQ: folds
O+jytCilwk7zItVCEavmtw: raises $6 to $8
l1bCLGuFqeFRwUfPsiDu/g: folds
dJO4Wtu5e7hHBlpz0cmy1w: calls $6
*** FLOP *** [Ac Kd 2h]
dJO4Wtu5e7hHBlpz0cmy1w: checks
O+jytCilwk7zItVCEavmtw: checks
*** TURN *** [Ac Kd 2h] [6s]
dJO4Wtu5e7hHBlpz0cmy1w: checks
O+jytCilwk7zItVCEavmtw: checks
*** RIVER *** [Ac Kd 2h 6s] [Qs]
dJO4Wtu5e7hHBlpz0cmy1w: checks
O+jytCilwk7zItVCEavmtw: bets $8
dJO4Wtu5e7hHBlpz0cmy1w: folds
O+jytCilwk7zItVCEavmtw collected $16.15 from pot
*** SUMMARY ***
Total pot $17 | Rake $0.85
Board [Ac Kd 2h 6s Qs]
Seat 1: l1bCLGuFqeFRwUfPsiDu/g (small blind) folded before Flop
Seat 2: dJO4Wtu5e7hHBlpz0cmy1w (big blind) folded on the River
Seat 3: L88dtdULfz5oGDSuo9/RvA folded before Flop (didn't bet)
Seat 4: 02K2DtsrlV5RLBdrzZcWqg folded before Flop (didn't bet)
Seat 5: Z3aYCZG/yXHYFjiWkGI5ug folded before Flop (didn't bet)
Seat 6: M2ht6rIKOI/my9eh610Nlw folded before Flop (didn't bet)
Seat 7: n2VAbLaE5qgKr5mA4W6v4w folded before Flop (didn't bet)
Seat 8: 5iPk5MyO3KVu18Y8XCYfFQ folded before Flop (didn't bet)
Seat 9: O+jytCilwk7zItVCEavmtw (button) collected ($16.15)



PokerStars Game #59937868030:  Hold'em No Limit ($1/$2) - 2009/07/01 0:01:43 ET
Table 'l5lZHc5JRHEDt0Y2AVPq3g' 6-max Seat #2 is the button
Seat 1: gGPaCoSWW1HoKYaqfAPecg ($206.30 in chips)
Seat 2: my38j/MmtBd/8qVwmyCREA ($182.40 in chips)
Seat 3: yZgdnRylE65JbScQ7qCWgw ($29 in chips)
Seat 4: zNjJ/y4emmF+vzrCDd+ooA ($208.05 in chips)
Seat 5: 6fLdOUCRtX71xbVRhJEq8w ($200 in chips)
Seat 6: vkfxu8f/jMYKUk6Ly4eujw ($199 in chips)
yZgdnRylE65JbScQ7qCWgw: posts small blind $1
zNjJ/y4emmF+vzrCDd+ooA: posts big blind $2
*** HOLE CARDS ***
6fLdOUCRtX71xbVRhJEq8w: folds
vkfxu8f/jMYKUk6Ly4eujw: folds
gGPaCoSWW1HoKYaqfAPecg: folds
my38j/MmtBd/8qVwmyCREA: folds
yZgdnRylE65JbScQ7qCWgw: raises $27 to $29 and is all-in
zNjJ/y4emmF+vzrCDd+ooA: folds
yZgdnRylE65JbScQ7qCWgw collected $4 from pot
*** SUMMARY ***
Total pot $4 | Rake $0
Seat 1: gGPaCoSWW1HoKYaqfAPecg folded before Flop (didn't bet)
Seat 2: my38j/MmtBd/8qVwmyCREA (button) folded before Flop (didn't bet)
Seat 3: yZgdnRylE65JbScQ7qCWgw (small blind) collected ($4)
Seat 4: zNjJ/y4emmF+vzrCDd+ooA (big blind) folded before Flop
Seat 5: 6fLdOUCRtX71xbVRhJEq8w folded before Flop (didn't bet)
Seat 6: vkfxu8f/jMYKUk6Ly4eujw folded before Flop (didn't bet)



PokerStars Game #59937868664:  Hold'em No Limit ($1/$2) - 2009/07/01 0:01:44 ET
Table 'NmY84NAf9Mh0ckAckHnh5g' 2-max Seat #2 is the button
Seat 1: 6hvg964TSqZ3AL/0XK9aVQ ($348.90 in chips)
Seat 2: RwDoM55ZeQuI2ADyJhOb2Q ($251 in chips)
RwDoM55ZeQuI2ADyJhOb2Q: posts small blind $1
6hvg964TSqZ3AL/0XK9aVQ: posts big blind $2
*** HOLE CARDS ***
RwDoM55ZeQuI2ADyJhOb2Q: raises $4 to $6
6hvg964TSqZ3AL/0XK9aVQ: calls $4
*** FLOP *** [3d 2c 9d]
6hvg964TSqZ3AL/0XK9aVQ: checks
RwDoM55ZeQuI2ADyJhOb2Q: bets $6
6hvg964TSqZ3AL/0XK9aVQ: calls $6
*** TURN *** [3d 2c 9d] [5d]
6hvg964TSqZ3AL/0XK9aVQ: checks
RwDoM55ZeQuI2ADyJhOb2Q: bets $12
6hvg964TSqZ3AL/0XK9aVQ: calls $12
*** RIVER *** [3d 2c 9d 5d] [Jd]
6hvg964TSqZ3AL/0XK9aVQ: checks
RwDoM55ZeQuI2ADyJhOb2Q: checks
*** SHOW DOWN ***
6hvg964TSqZ3AL/0XK9aVQ: shows [3h Th] (a pair of Threes)
RwDoM55ZeQuI2ADyJhOb2Q: shows [Jc 7s] (a pair of Jacks)
RwDoM55ZeQuI2ADyJhOb2Q collected $47.50 from pot
*** SUMMARY ***
Total pot $48 | Rake $0.50
Board [3d 2c 9d 5d Jd]
Seat 1: 6hvg964TSqZ3AL/0XK9aVQ (big blind) showed [3h Th] and lost with a pair of Threes
Seat 2: RwDoM55ZeQuI2ADyJhOb2Q (button) (small blind) showed [Jc 7s] and won ($47.50) with a pair of Jacks



PokerStars Game #59937869144:  Hold'em No Limit ($1/$2) - 2009/07/01 0:01:44 ET
Table 'ZzSIe0zTCDv+n6hfbY5tTg' 6-max Seat #6 is the button
Seat 1: 8srN1dKQePlsv0GyTada+Q ($217.70 in chips)
Seat 2: JQAf1Fiqbg0N8wNGA2nZhw ($200 in chips)
Seat 3: Y+MK4vQx233i+/aiP6js/Q ($352.20 in chips)
Seat 5: Q3uFdu6ztesjDFiqkagTRQ ($205.10 in chips)
Seat 6: 39260874 ($195.75 in chips)
8srN1dKQePlsv0GyTada+Q: posts small blind $1
JQAf1Fiqbg0N8wNGA2nZhw: posts big blind $2
*** HOLE CARDS ***
Y+MK4vQx233i+/aiP6js/Q: folds
Q3uFdu6ztesjDFiqkagTRQ: folds
39260874: calls $2
8srN1dKQePlsv0GyTada+Q: calls $1
JQAf1Fiqbg0N8wNGA2nZhw: checks
*** FLOP *** [Th Ad Kd]
8srN1dKQePlsv0GyTada+Q: checks
JQAf1Fiqbg0N8wNGA2nZhw: checks
39260874: bets $2
8srN1dKQePlsv0GyTada+Q: folds
JQAf1Fiqbg0N8wNGA2nZhw: folds
39260874 collected $5.70 from pot
*** SUMMARY ***
Total pot $6 | Rake $0.30
Board [Th Ad Kd]
Seat 1: 8srN1dKQePlsv0GyTada+Q (small blind) folded on the Flop
Seat 2: JQAf1Fiqbg0N8wNGA2nZhw (big blind) folded on the Flop
Seat 3: Y+MK4vQx233i+/aiP6js/Q folded before Flop (didn't bet)
Seat 5: Q3uFdu6ztesjDFiqkagTRQ folded before Flop (didn't bet)
Seat 6: 39260874 (button) collected ($5.70)



PokerStars Game #59937872614:  Hold'em No Limit ($1/$2) - 2009/07/01 0:01:49 ET
Table 'LL4bDFyhj5hsMpzaDugJZg' 6-max Seat #4 is the button
Seat 2: L3l+A4pJhOAD6HVVFXvVBw ($262.95 in chips)
Seat 3: gGPaCoSWW1HoKYaqfAPecg ($207 in chips)
Seat 4: 8srN1dKQePlsv0GyTada+Q ($231.60 in chips)
Seat 5: HgX0VeqE/dzSXd5BpntRBw ($201 in chips)
Seat 6: yZgdnRylE65JbScQ7qCWgw ($31 in chips)
HgX0VeqE/dzSXd5BpntRBw: posts small blind $1
yZgdnRylE65JbScQ7qCWgw: posts big blind $2
IBW9lyGsaRmfcbyA/qFfEw: sits out
*** HOLE CARDS ***
L3l+A4pJhOAD6HVVFXvVBw: folds
gGPaCoSWW1HoKYaqfAPecg: raises $5 to $7
8srN1dKQePlsv0GyTada+Q: folds
HgX0VeqE/dzSXd5BpntRBw: raises $17 to $24
yZgdnRylE65JbScQ7qCWgw: folds
gGPaCoSWW1HoKYaqfAPecg: raises $34 to $58
HgX0VeqE/dzSXd5BpntRBw: folds
gGPaCoSWW1HoKYaqfAPecg collected $50 from pot
*** SUMMARY ***
Total pot $50 | Rake $0
Seat 2: L3l+A4pJhOAD6HVVFXvVBw folded before Flop (didn't bet)
Seat 3: gGPaCoSWW1HoKYaqfAPecg collected ($50)
Seat 4: 8srN1dKQePlsv0GyTada+Q (button) folded before Flop (didn't bet)
Seat 5: HgX0VeqE/dzSXd5BpntRBw (small blind) folded before Flop
Seat 6: yZgdnRylE65JbScQ7qCWgw (big blind) folded before Flop



PokerStars Game #59937873536:  Hold'em No Limit ($1/$2) - 2009/07/01 0:01:51 ET
Table 'bJQ024BaYSBrW0sXpCZbNQ' 6-max Seat #4 is the button
Seat 1: yZgdnRylE65JbScQ7qCWgw ($37 in chips)
Seat 2: 1njbh8TKSUF6l4V1XwGdcg ($251.40 in chips)
Seat 3: vkfxu8f/jMYKUk6Ly4eujw ($211.30 in chips)
Seat 4: 9ni/OEXAqfc58zPQ0Tu9rQ ($281.05 in chips)
Seat 5: X7GlkHF+lkbarCLuZ4Uf0w ($46.15 in chips)
Seat 6: 9dpyyjDTCed6nV7JhaUUpw ($209 in chips)
X7GlkHF+lkbarCLuZ4Uf0w: posts small blind $1
9dpyyjDTCed6nV7JhaUUpw: posts big blind $2
*** HOLE CARDS ***
yZgdnRylE65JbScQ7qCWgw: folds
1njbh8TKSUF6l4V1XwGdcg: folds
vkfxu8f/jMYKUk6Ly4eujw: folds
9ni/OEXAqfc58zPQ0Tu9rQ: folds
X7GlkHF+lkbarCLuZ4Uf0w: raises $3 to $5
9dpyyjDTCed6nV7JhaUUpw: calls $3
*** FLOP *** [Jh Qd 2d]
X7GlkHF+lkbarCLuZ4Uf0w: checks
9dpyyjDTCed6nV7JhaUUpw: bets $8
X7GlkHF+lkbarCLuZ4Uf0w: folds
9dpyyjDTCed6nV7JhaUUpw collected $9.50 from pot
9dpyyjDTCed6nV7JhaUUpw: doesn't show hand
*** SUMMARY ***
Total pot $10 | Rake $0.50
Board [Jh Qd 2d]
Seat 1: yZgdnRylE65JbScQ7qCWgw folded before Flop (didn't bet)
Seat 2: 1njbh8TKSUF6l4V1XwGdcg folded before Flop (didn't bet)
Seat 3: vkfxu8f/jMYKUk6Ly4eujw folded before Flop (didn't bet)
Seat 4: 9ni/OEXAqfc58zPQ0Tu9rQ (button) folded before Flop (didn't bet)
Seat 5: X7GlkHF+lkbarCLuZ4Uf0w (small blind) folded on the Flop
Seat 6: 9dpyyjDTCed6nV7JhaUUpw (big blind) collected ($9.50)



PokerStars Game #59937874366:  Hold'em No Limit ($1/$2) - 2009/07/01 0:01:52 ET
Table 'HewZCzVOYGmuLDKthTi5Yw' 6-max Seat #4 is the button
Seat 1: 353332 ($229.75 in chips)
Seat 2: X7GlkHF+lkbarCLuZ4Uf0w ($40 in chips)
Seat 4: yZgdnRylE65JbScQ7qCWgw ($38 in chips)
Seat 5: 513FcCI8jHyQy2VWoIQkMg ($372.50 in chips)
513FcCI8jHyQy2VWoIQkMg: posts small blind $1
353332: posts big blind $2
*** HOLE CARDS ***
X7GlkHF+lkbarCLuZ4Uf0w: folds
yZgdnRylE65JbScQ7qCWgw: folds
513FcCI8jHyQy2VWoIQkMg: folds
353332 collected $2 from pot
353332: doesn't show hand
*** SUMMARY ***
Total pot $2 | Rake $0
Seat 1: 353332 (big blind) collected ($2)
Seat 2: X7GlkHF+lkbarCLuZ4Uf0w folded before Flop (didn't bet)
Seat 4: yZgdnRylE65JbScQ7qCWgw (button) folded before Flop (didn't bet)
Seat 5: 513FcCI8jHyQy2VWoIQkMg (small blind) folded before Flop



PokerStars Game #59937875512:  Hold'em No Limit ($1/$2) - 2009/07/01 0:01:53 ET
Table 'WCA60bDA8ecovUgFSIZkTQ' 9-max Seat #2 is the button
Seat 1: xNLmepWbCljNEEeH8O5jSg ($266.65 in chips)
Seat 2: G1h8wamBcVJXtsKXZQ2EyA ($80.05 in chips)
Seat 3: 5iPk5MyO3KVu18Y8XCYfFQ ($38 in chips)
Seat 4: Q3uFdu6ztesjDFiqkagTRQ ($450.70 in chips)
Seat 5: Hc2itIxwbi1lwa+DAYYQGg ($312.30 in chips)
Seat 6: DOWQSOJ7GaX+ksfWTqPT5A ($200.75 in chips)
Seat 7: GX1heJ+DSsvm7gzSPsYhhQ ($34 in chips)
Seat 8: x+V1JgVDawsJTxKcxm7gxw ($100 in chips)
Seat 9: 3q2/0oJr3Mcy1W5tcN61ug ($301.20 in chips)
5iPk5MyO3KVu18Y8XCYfFQ: posts small blind $1
Q3uFdu6ztesjDFiqkagTRQ: posts big blind $2
*** HOLE CARDS ***
Hc2itIxwbi1lwa+DAYYQGg: folds
DOWQSOJ7GaX+ksfWTqPT5A: calls $2
GX1heJ+DSsvm7gzSPsYhhQ: folds
x+V1JgVDawsJTxKcxm7gxw: folds
3q2/0oJr3Mcy1W5tcN61ug: folds
xNLmepWbCljNEEeH8O5jSg: folds
G1h8wamBcVJXtsKXZQ2EyA: calls $2
5iPk5MyO3KVu18Y8XCYfFQ: folds
Q3uFdu6ztesjDFiqkagTRQ: checks
*** FLOP *** [Qd 4c Jh]
Q3uFdu6ztesjDFiqkagTRQ: checks
DOWQSOJ7GaX+ksfWTqPT5A: checks
G1h8wamBcVJXtsKXZQ2EyA: bets $6
Q3uFdu6ztesjDFiqkagTRQ: folds
DOWQSOJ7GaX+ksfWTqPT5A: folds
G1h8wamBcVJXtsKXZQ2EyA collected $6.65 from pot
*** SUMMARY ***
Total pot $7 | Rake $0.35
Board [Qd 4c Jh]
Seat 1: xNLmepWbCljNEEeH8O5jSg folded before Flop (didn't bet)
Seat 2: G1h8wamBcVJXtsKXZQ2EyA (button) collected ($6.65)
Seat 3: 5iPk5MyO3KVu18Y8XCYfFQ (small blind) folded before Flop
Seat 4: Q3uFdu6ztesjDFiqkagTRQ (big blind) folded on the Flop
Seat 5: Hc2itIxwbi1lwa+DAYYQGg folded before Flop (didn't bet)
Seat 6: DOWQSOJ7GaX+ksfWTqPT5A folded on the Flop
Seat 7: GX1heJ+DSsvm7gzSPsYhhQ folded before Flop (didn't bet)
Seat 8: x+V1JgVDawsJTxKcxm7gxw folded before Flop (didn't bet)
Seat 9: 3q2/0oJr3Mcy1W5tcN61ug folded before Flop (didn't bet)



PokerStars Game #59937881524:  Hold'em No Limit ($1/$2) - 2009/07/01 0:01:59 ET
Table 'qVXak+oTeDXMGbWa4sDU5Q' 9-max Seat #8 is the button
Seat 1: H6Z4+qu8gR0VUiPOijndVg ($257 in chips)
Seat 2: Hc2itIxwbi1lwa+DAYYQGg ($37 in chips)
Seat 3: oz9eCXGC7DdjQlL/nuWj1A ($93 in chips)
Seat 4: b0jO1SDhLedy1//CQlA8kw ($40 in chips)
Seat 5: VJh1u3Qcjd3FuCT5ejyKYg ($77.10 in chips)
Seat 6: Q3uFdu6ztesjDFiqkagTRQ ($233.40 in chips)
Seat 7: 5iPk5MyO3KVu18Y8XCYfFQ ($59.50 in chips)
Seat 8: 9pHZMviI9R8injxojGTnvw ($46.60 in chips)
Seat 9: IZ/2qsh1CIg9m5PWsMsLmA ($376.95 in chips)
IZ/2qsh1CIg9m5PWsMsLmA: posts small blind $1
H6Z4+qu8gR0VUiPOijndVg: posts big blind $2
*** HOLE CARDS ***
Hc2itIxwbi1lwa+DAYYQGg: folds
oz9eCXGC7DdjQlL/nuWj1A: calls $2
b0jO1SDhLedy1//CQlA8kw: folds
VJh1u3Qcjd3FuCT5ejyKYg: folds
Q3uFdu6ztesjDFiqkagTRQ: folds
5iPk5MyO3KVu18Y8XCYfFQ: folds
9pHZMviI9R8injxojGTnvw: calls $2
IZ/2qsh1CIg9m5PWsMsLmA: calls $1
H6Z4+qu8gR0VUiPOijndVg: checks
*** FLOP *** [8c Qc 2h]
IZ/2qsh1CIg9m5PWsMsLmA: checks
H6Z4+qu8gR0VUiPOijndVg: checks
oz9eCXGC7DdjQlL/nuWj1A: checks
9pHZMviI9R8injxojGTnvw: checks
*** TURN *** [8c Qc 2h] [Qh]
IZ/2qsh1CIg9m5PWsMsLmA: bets $6
H6Z4+qu8gR0VUiPOijndVg: folds
oz9eCXGC7DdjQlL/nuWj1A: folds
9pHZMviI9R8injxojGTnvw: calls $6
*** RIVER *** [8c Qc 2h Qh] [9d]
IZ/2qsh1CIg9m5PWsMsLmA: bets $8
9pHZMviI9R8injxojGTnvw: raises $18 to $26
IZ/2qsh1CIg9m5PWsMsLmA: folds
9pHZMviI9R8injxojGTnvw collected $34.25 from pot
*** SUMMARY ***
Total pot $36 | Rake $1.75
Board [8c Qc 2h Qh 9d]
Seat 1: H6Z4+qu8gR0VUiPOijndVg (big blind) folded on the Turn
Seat 2: Hc2itIxwbi1lwa+DAYYQGg folded before Flop (didn't bet)
Seat 3: oz9eCXGC7DdjQlL/nuWj1A folded on the Turn
Seat 4: b0jO1SDhLedy1//CQlA8kw folded before Flop (didn't bet)
Seat 5: VJh1u3Qcjd3FuCT5ejyKYg folded before Flop (didn't bet)
Seat 6: Q3uFdu6ztesjDFiqkagTRQ folded before Flop (didn't bet)
Seat 7: 5iPk5MyO3KVu18Y8XCYfFQ folded before Flop (didn't bet)
Seat 8: 9pHZMviI9R8injxojGTnvw (button) collected ($34.25)
Seat 9: IZ/2qsh1CIg9m5PWsMsLmA (small blind) folded on the River



PokerStars Game #59937881910:  Hold'em No Limit ($1/$2) - 2009/07/01 0:02:00 ET
Table 'XP2sRSup+aRuwzx3vDZsDg' 6-max Seat #3 is the button
Seat 2: yZgdnRylE65JbScQ7qCWgw ($40 in chips)
Seat 3: X7GlkHF+lkbarCLuZ4Uf0w ($33.50 in chips)
Seat 4: JsC+WvfzqlxVs9G8/gSQAQ ($107.95 in chips)
Seat 5: vkfxu8f/jMYKUk6Ly4eujw ($200 in chips)
Seat 6: h7ppRQJTYBsHCbLMeW9T2g ($496.75 in chips)
JsC+WvfzqlxVs9G8/gSQAQ: posts small blind $1
vkfxu8f/jMYKUk6Ly4eujw: posts big blind $2
o9jamqIi6sTTRSqudgboRA: sits out
*** HOLE CARDS ***
h7ppRQJTYBsHCbLMeW9T2g: folds
yZgdnRylE65JbScQ7qCWgw: folds
X7GlkHF+lkbarCLuZ4Uf0w: folds
JsC+WvfzqlxVs9G8/gSQAQ: calls $1
vkfxu8f/jMYKUk6Ly4eujw: checks
*** FLOP *** [3s Th Tc]
JsC+WvfzqlxVs9G8/gSQAQ: bets $2
vkfxu8f/jMYKUk6Ly4eujw: folds
JsC+WvfzqlxVs9G8/gSQAQ collected $3.80 from pot
JsC+WvfzqlxVs9G8/gSQAQ: doesn't show hand
*** SUMMARY ***
Total pot $4 | Rake $0.20
Board [3s Th Tc]
Seat 2: yZgdnRylE65JbScQ7qCWgw folded before Flop (didn't bet)
Seat 3: X7GlkHF+lkbarCLuZ4Uf0w (button) folded before Flop (didn't bet)
Seat 4: JsC+WvfzqlxVs9G8/gSQAQ (small blind) collected ($3.80)
Seat 5: vkfxu8f/jMYKUk6Ly4eujw (big blind) folded on the Flop
Seat 6: h7ppRQJTYBsHCbLMeW9T2g folded before Flop (didn't bet)



PokerStars Game #59937883210:  Hold'em No Limit ($1/$2) - 2009/07/01 0:02:02 ET
Table 'HewZCzVOYGmuLDKthTi5Yw' 6-max Seat #5 is the button
Seat 1: 353332 ($230.75 in chips)
Seat 2: X7GlkHF+lkbarCLuZ4Uf0w ($40 in chips)
Seat 4: yZgdnRylE65JbScQ7qCWgw ($38 in chips)
Seat 5: 513FcCI8jHyQy2VWoIQkMg ($371.50 in chips)
353332: posts small blind $1
X7GlkHF+lkbarCLuZ4Uf0w: posts big blind $2
*** HOLE CARDS ***
yZgdnRylE65JbScQ7qCWgw: folds
513FcCI8jHyQy2VWoIQkMg: folds
353332: raises $8 to $10
WJxW31eStwT28R2X/L8F5A joins the table at seat #3
X7GlkHF+lkbarCLuZ4Uf0w: folds
353332 collected $4 from pot
353332: doesn't show hand
*** SUMMARY ***
Total pot $4 | Rake $0
Seat 1: 353332 (small blind) collected ($4)
Seat 2: X7GlkHF+lkbarCLuZ4Uf0w (big blind) folded before Flop
Seat 4: yZgdnRylE65JbScQ7qCWgw folded before Flop (didn't bet)
Seat 5: 513FcCI8jHyQy2VWoIQkMg (button) folded before Flop (didn't bet)



PokerStars Game #59937883080:  Hold'em No Limit ($1/$2) - 2009/07/01 0:02:02 ET
Table 'jlrIxbrVIG+gjaUYT4za8g' 6-max Seat #6 is the button
Seat 1: ygTTt5ehT4aF86q1a8/R+w ($177.35 in chips)
Seat 2: N18PrNGQj43J7TJuQuu+tw ($168.05 in chips)
Seat 3: /PH6Ffnho4Ysm8S3V/oa+w ($40 in chips)
Seat 4: 8srN1dKQePlsv0GyTada+Q ($203 in chips)
Seat 5: F/075N6nU34Fn0zr6qD3aw ($171.55 in chips)
Seat 6: vkfxu8f/jMYKUk6Ly4eujw ($260.40 in chips)
ygTTt5ehT4aF86q1a8/R+w: posts small blind $1
N18PrNGQj43J7TJuQuu+tw: posts big blind $2
*** HOLE CARDS ***
/PH6Ffnho4Ysm8S3V/oa+w: folds
8srN1dKQePlsv0GyTada+Q: folds
F/075N6nU34Fn0zr6qD3aw: folds
vkfxu8f/jMYKUk6Ly4eujw: folds
ygTTt5ehT4aF86q1a8/R+w: folds
N18PrNGQj43J7TJuQuu+tw collected $2 from pot
*** SUMMARY ***
Total pot $2 | Rake $0
Seat 1: ygTTt5ehT4aF86q1a8/R+w (small blind) folded before Flop
Seat 2: N18PrNGQj43J7TJuQuu+tw (big blind) collected ($2)
Seat 3: /PH6Ffnho4Ysm8S3V/oa+w folded before Flop (didn't bet)
Seat 4: 8srN1dKQePlsv0GyTada+Q folded before Flop (didn't bet)
Seat 5: F/075N6nU34Fn0zr6qD3aw folded before Flop (didn't bet)
Seat 6: vkfxu8f/jMYKUk6Ly4eujw (button) folded before Flop (didn't bet)



PokerStars Game #59937884090:  Hold'em No Limit ($1/$2) - 2009/07/01 0:02:03 ET
Table '3FGoiEOffWrbgTfsB3t7FA' 2-max Seat #2 is the button
Seat 1: e0oDWyrmgLpR6bROEqw1nQ ($408.50 in chips)
Seat 2: +sy/nlNI20yZraIjs4AALg ($198.75 in chips)
+sy/nlNI20yZraIjs4AALg: posts small blind $1
e0oDWyrmgLpR6bROEqw1nQ: posts big blind $2
*** HOLE CARDS ***
+sy/nlNI20yZraIjs4AALg: folds
e0oDWyrmgLpR6bROEqw1nQ collected $2 from pot
*** SUMMARY ***
Total pot $2 | Rake $0
Seat 1: e0oDWyrmgLpR6bROEqw1nQ (big blind) collected ($2)
Seat 2: +sy/nlNI20yZraIjs4AALg (button) (small blind) folded before Flop



PokerStars Game #59937886504:  Hold'em No Limit ($1/$2) - 2009/07/01 0:02:07 ET
Table 'eyAQSIlgc2o1Jxvbve4WGg' 9-max Seat #9 is the button
Seat 1: Q3uFdu6ztesjDFiqkagTRQ ($200 in chips)
Seat 2: GX1heJ+DSsvm7gzSPsYhhQ ($40 in chips)
Seat 4: Lr5OlNr2kebm3oHSC54eJg ($98.65 in chips)
Seat 5: rW/MyplHylMSBRaoRUzWrg ($103.70 in chips)
Seat 6: IikcENBHwoT7snSvBPSc7Q ($189.85 in chips)
Seat 7: QHxJjpVYwitg9krW6wZgJA ($200 in chips)
Seat 8: 5iPk5MyO3KVu18Y8XCYfFQ ($39 in chips)
Seat 9: Hc2itIxwbi1lwa+DAYYQGg ($50.85 in chips)
Q3uFdu6ztesjDFiqkagTRQ: posts small blind $1
GX1heJ+DSsvm7gzSPsYhhQ: posts big blind $2
TAfo4veNRaRlzDXMMYS3Jg: sits out
*** HOLE CARDS ***
Lr5OlNr2kebm3oHSC54eJg: folds
rW/MyplHylMSBRaoRUzWrg: folds
IikcENBHwoT7snSvBPSc7Q: folds
QHxJjpVYwitg9krW6wZgJA: folds
5iPk5MyO3KVu18Y8XCYfFQ: folds
Hc2itIxwbi1lwa+DAYYQGg: folds
Q3uFdu6ztesjDFiqkagTRQ: raises $4 to $6
GX1heJ+DSsvm7gzSPsYhhQ: calls $4
*** FLOP *** [Qd Js Td]
Q3uFdu6ztesjDFiqkagTRQ: bets $10
GX1heJ+DSsvm7gzSPsYhhQ: raises $10 to $20
Q3uFdu6ztesjDFiqkagTRQ: raises $22 to $42
GX1heJ+DSsvm7gzSPsYhhQ: calls $14 and is all-in
*** TURN *** [Qd Js Td] [2d]
*** RIVER *** [Qd Js Td 2d] [9h]
*** SHOW DOWN ***
Q3uFdu6ztesjDFiqkagTRQ: shows [3d Ad] (a flush, Ace high)
GX1heJ+DSsvm7gzSPsYhhQ: mucks hand
Q3uFdu6ztesjDFiqkagTRQ collected $77 from pot
*** SUMMARY ***
Total pot $80 | Rake $3
Board [Qd Js Td 2d 9h]
Seat 1: Q3uFdu6ztesjDFiqkagTRQ (small blind) showed [3d Ad] and won ($77) with a flush, Ace high
Seat 2: GX1heJ+DSsvm7gzSPsYhhQ (big blind) mucked
Seat 4: Lr5OlNr2kebm3oHSC54eJg folded before Flop (didn't bet)
Seat 5: rW/MyplHylMSBRaoRUzWrg folded before Flop (didn't bet)
Seat 6: IikcENBHwoT7snSvBPSc7Q folded before Flop (didn't bet)
Seat 7: QHxJjpVYwitg9krW6wZgJA folded before Flop (didn't bet)
Seat 8: 5iPk5MyO3KVu18Y8XCYfFQ folded before Flop (didn't bet)
Seat 9: Hc2itIxwbi1lwa+DAYYQGg (button) folded before Flop (didn't bet)



PokerStars Game #59937887804:  Hold'em No Limit ($1/$2) - 2009/07/01 0:02:08 ET
Table 'CFkQcfWjKccZaZDf71FK+w' 6-max Seat #5 is the button
Seat 1: X7GlkHF+lkbarCLuZ4Uf0w ($37 in chips)
Seat 2: yZgdnRylE65JbScQ7qCWgw ($37 in chips)
Seat 3: ygTTt5ehT4aF86q1a8/R+w ($124.40 in chips)
Seat 4: B2Ih1sr5VZk+8He7rcrMtQ ($221.90 in chips)
Seat 5: 1njbh8TKSUF6l4V1XwGdcg ($200 in chips)
Seat 6: ORVqY3rf9X6ANA/8s+On2Q ($89 in chips)
ORVqY3rf9X6ANA/8s+On2Q: posts small blind $1
X7GlkHF+lkbarCLuZ4Uf0w: posts big blind $2
*** HOLE CARDS ***
yZgdnRylE65JbScQ7qCWgw: folds
ygTTt5ehT4aF86q1a8/R+w: folds
B2Ih1sr5VZk+8He7rcrMtQ: folds
1njbh8TKSUF6l4V1XwGdcg: raises $4 to $6
ORVqY3rf9X6ANA/8s+On2Q: folds
X7GlkHF+lkbarCLuZ4Uf0w: folds
1njbh8TKSUF6l4V1XwGdcg collected $5 from pot
*** SUMMARY ***
Total pot $5 | Rake $0
Seat 1: X7GlkHF+lkbarCLuZ4Uf0w (big blind) folded before Flop
Seat 2: yZgdnRylE65JbScQ7qCWgw folded before Flop (didn't bet)
Seat 3: ygTTt5ehT4aF86q1a8/R+w folded before Flop (didn't bet)
Seat 4: B2Ih1sr5VZk+8He7rcrMtQ folded before Flop (didn't bet)
Seat 5: 1njbh8TKSUF6l4V1XwGdcg (button) collected ($5)
Seat 6: ORVqY3rf9X6ANA/8s+On2Q (small blind) folded before Flop



PokerStars Game #59937888742:  Hold'em No Limit ($1/$2) - 2009/07/01 0:02:10 ET
Table 'l5lZHc5JRHEDt0Y2AVPq3g' 6-max Seat #3 is the button
Seat 1: gGPaCoSWW1HoKYaqfAPecg ($206.30 in chips)
Seat 2: my38j/MmtBd/8qVwmyCREA ($182.40 in chips)
Seat 3: yZgdnRylE65JbScQ7qCWgw ($31 in chips)
Seat 4: zNjJ/y4emmF+vzrCDd+ooA ($206.05 in chips)
Seat 5: 6fLdOUCRtX71xbVRhJEq8w ($200 in chips)
Seat 6: vkfxu8f/jMYKUk6Ly4eujw ($199 in chips)
zNjJ/y4emmF+vzrCDd+ooA: posts small blind $1
6fLdOUCRtX71xbVRhJEq8w: posts big blind $2
*** HOLE CARDS ***
vkfxu8f/jMYKUk6Ly4eujw: folds
gGPaCoSWW1HoKYaqfAPecg: folds
my38j/MmtBd/8qVwmyCREA: raises $4 to $6
yZgdnRylE65JbScQ7qCWgw: raises $25 to $31 and is all-in
zNjJ/y4emmF+vzrCDd+ooA: folds
6fLdOUCRtX71xbVRhJEq8w: folds
my38j/MmtBd/8qVwmyCREA: calls $25
*** FLOP *** [7c 8h 2d]
*** TURN *** [7c 8h 2d] [7h]
*** RIVER *** [7c 8h 2d 7h] [9c]
*** SHOW DOWN ***
my38j/MmtBd/8qVwmyCREA: shows [8d 8s] (a full house, Eights full of Sevens)
yZgdnRylE65JbScQ7qCWgw: mucks hand
my38j/MmtBd/8qVwmyCREA collected $62 from pot
*** SUMMARY ***
Total pot $65 | Rake $3
Board [7c 8h 2d 7h 9c]
Seat 1: gGPaCoSWW1HoKYaqfAPecg folded before Flop (didn't bet)
Seat 2: my38j/MmtBd/8qVwmyCREA showed [8d 8s] and won ($62) with a full house, Eights full of Sevens
Seat 3: yZgdnRylE65JbScQ7qCWgw (button) mucked
Seat 4: zNjJ/y4emmF+vzrCDd+ooA (small blind) folded before Flop
Seat 5: 6fLdOUCRtX71xbVRhJEq8w (big blind) folded before Flop
Seat 6: vkfxu8f/jMYKUk6Ly4eujw folded before Flop (didn't bet)



PokerStars Game #59937888778:  Hold'em No Limit ($1/$2) - 2009/07/01 0:02:10 ET
Table 'pPQgcj9XT9CHBsbo1WTBug' 6-max Seat #5 is the button
Seat 1: DFVYDA6dKQy7R7mGIKogZA ($115.90 in chips)
Seat 3: vkfxu8f/jMYKUk6Ly4eujw ($193 in chips)
Seat 5: 4Cl43Q1TYQL8wn1NSCUkaw ($67.60 in chips)
Seat 6: yZgdnRylE65JbScQ7qCWgw ($29 in chips)
yZgdnRylE65JbScQ7qCWgw: posts small blind $1
DFVYDA6dKQy7R7mGIKogZA: posts big blind $2
*** HOLE CARDS ***
vkfxu8f/jMYKUk6Ly4eujw: raises $4 to $6
4Cl43Q1TYQL8wn1NSCUkaw: folds
yZgdnRylE65JbScQ7qCWgw: folds
DFVYDA6dKQy7R7mGIKogZA: folds
vkfxu8f/jMYKUk6Ly4eujw collected $5 from pot
vkfxu8f/jMYKUk6Ly4eujw: doesn't show hand
*** SUMMARY ***
Total pot $5 | Rake $0
Seat 1: DFVYDA6dKQy7R7mGIKogZA (big blind) folded before Flop
Seat 3: vkfxu8f/jMYKUk6Ly4eujw collected ($5)
Seat 5: 4Cl43Q1TYQL8wn1NSCUkaw (button) folded before Flop (didn't bet)
Seat 6: yZgdnRylE65JbScQ7qCWgw (small blind) folded before Flop



PokerStars Game #59937890786:  Hold'em No Limit ($1/$2) - 2009/07/01 0:02:13 ET
Table 'NmY84NAf9Mh0ckAckHnh5g' 2-max Seat #1 is the button
Seat 1: 6hvg964TSqZ3AL/0XK9aVQ ($324.90 in chips)
Seat 2: RwDoM55ZeQuI2ADyJhOb2Q ($274.50 in chips)
6hvg964TSqZ3AL/0XK9aVQ: posts small blind $1
RwDoM55ZeQuI2ADyJhOb2Q: posts big blind $2
*** HOLE CARDS ***
6hvg964TSqZ3AL/0XK9aVQ: calls $1
RwDoM55ZeQuI2ADyJhOb2Q: checks
*** FLOP *** [Jh 8c 2s]
RwDoM55ZeQuI2ADyJhOb2Q: checks
6hvg964TSqZ3AL/0XK9aVQ: checks
*** TURN *** [Jh 8c 2s] [Kh]
RwDoM55ZeQuI2ADyJhOb2Q: checks
6hvg964TSqZ3AL/0XK9aVQ: bets $4
RwDoM55ZeQuI2ADyJhOb2Q: folds
6hvg964TSqZ3AL/0XK9aVQ collected $3.80 from pot
*** SUMMARY ***
Total pot $4 | Rake $0.20
Board [Jh 8c 2s Kh]
Seat 1: 6hvg964TSqZ3AL/0XK9aVQ (button) (small blind) collected ($3.80)
Seat 2: RwDoM55ZeQuI2ADyJhOb2Q (big blind) folded on the Turn



PokerStars Game #59937891010:  Hold'em No Limit ($1/$2) - 2009/07/01 0:02:13 ET
Table '3FGoiEOffWrbgTfsB3t7FA' 2-max Seat #1 is the button
Seat 1: e0oDWyrmgLpR6bROEqw1nQ ($409.50 in chips)
Seat 2: +sy/nlNI20yZraIjs4AALg ($197.75 in chips)
e0oDWyrmgLpR6bROEqw1nQ: posts small blind $1
+sy/nlNI20yZraIjs4AALg: posts big blind $2
*** HOLE CARDS ***
e0oDWyrmgLpR6bROEqw1nQ: raises $4 to $6
+sy/nlNI20yZraIjs4AALg: calls $4
*** FLOP *** [9h Kh Ad]
+sy/nlNI20yZraIjs4AALg: checks
e0oDWyrmgLpR6bROEqw1nQ: bets $8
+sy/nlNI20yZraIjs4AALg: calls $8
*** TURN *** [9h Kh Ad] [As]
+sy/nlNI20yZraIjs4AALg: checks
e0oDWyrmgLpR6bROEqw1nQ: checks
*** RIVER *** [9h Kh Ad As] [Ts]
+sy/nlNI20yZraIjs4AALg: bets $10
e0oDWyrmgLpR6bROEqw1nQ: raises $24 to $34
+sy/nlNI20yZraIjs4AALg: calls $24
*** SHOW DOWN ***
e0oDWyrmgLpR6bROEqw1nQ: shows [Qh Jd] (a straight, Ten to Ace)
+sy/nlNI20yZraIjs4AALg: mucks hand
e0oDWyrmgLpR6bROEqw1nQ collected $95.50 from pot
*** SUMMARY ***
Total pot $96 | Rake $0.50
Board [9h Kh Ad As Ts]
Seat 1: e0oDWyrmgLpR6bROEqw1nQ (button) (small blind) showed [Qh Jd] and won ($95.50) with a straight, Ten to Ace
Seat 2: +sy/nlNI20yZraIjs4AALg (big blind) mucked



PokerStars Game #59937897814:  Hold'em No Limit ($1/$2) - 2009/07/01 0:02:22 ET
Table 'uJ9juaXXg9yIcSU8amxaXQ' 6-max Seat #6 is the button
Seat 1: HhIxv6mylwCAfv3sjJmq5g ($200 in chips)
Seat 2: DQlskgG4OtLpF2MVxLwf4A ($278.70 in chips)
Seat 3: zaogaltCDFVsIASEnrXs2w ($259.75 in chips)
Seat 5: F/075N6nU34Fn0zr6qD3aw ($230.05 in chips)
Seat 6: XrFG4dK06RVKLlX32/pjcQ ($45.70 in chips)
HhIxv6mylwCAfv3sjJmq5g: posts small blind $1
DQlskgG4OtLpF2MVxLwf4A: posts big blind $2
54yWzRRgS0oZ+S6LwZBxMQ: sits out
*** HOLE CARDS ***
zaogaltCDFVsIASEnrXs2w: folds
F/075N6nU34Fn0zr6qD3aw: raises $6 to $8
XrFG4dK06RVKLlX32/pjcQ: folds
HhIxv6mylwCAfv3sjJmq5g: folds
DQlskgG4OtLpF2MVxLwf4A: folds
F/075N6nU34Fn0zr6qD3aw collected $5 from pot
*** SUMMARY ***
Total pot $5 | Rake $0
Seat 1: HhIxv6mylwCAfv3sjJmq5g (small blind) folded before Flop
Seat 2: DQlskgG4OtLpF2MVxLwf4A (big blind) folded before Flop
Seat 3: zaogaltCDFVsIASEnrXs2w folded before Flop (didn't bet)
Seat 5: F/075N6nU34Fn0zr6qD3aw collected ($5)
Seat 6: XrFG4dK06RVKLlX32/pjcQ (button) folded before Flop (didn't bet)



PokerStars Game #59937900858:  Hold'em No Limit ($1/$2) - 2009/07/01 0:02:26 ET
Table 'fe+AlpfadsfwxhZEvYFbbA' 6-max Seat #3 is the button
Seat 1: SLlqn2PPbQqwfcLfYqUXrw ($78.45 in chips)
Seat 2: /PH6Ffnho4Ysm8S3V/oa+w ($40 in chips)
Seat 3: 54yWzRRgS0oZ+S6LwZBxMQ ($59.30 in chips)
Seat 5: gGPaCoSWW1HoKYaqfAPecg ($200.20 in chips)
Seat 6: 5Y+ZGWLI4gnlpApDX5vy1A ($207.55 in chips)
gGPaCoSWW1HoKYaqfAPecg: posts small blind $1
5Y+ZGWLI4gnlpApDX5vy1A: posts big blind $2
*** HOLE CARDS ***
SLlqn2PPbQqwfcLfYqUXrw: raises $4 to $6
/PH6Ffnho4Ysm8S3V/oa+w: folds
54yWzRRgS0oZ+S6LwZBxMQ: folds
gGPaCoSWW1HoKYaqfAPecg: folds
5Y+ZGWLI4gnlpApDX5vy1A: folds
SLlqn2PPbQqwfcLfYqUXrw collected $5 from pot
*** SUMMARY ***
Total pot $5 | Rake $0
Seat 1: SLlqn2PPbQqwfcLfYqUXrw collected ($5)
Seat 2: /PH6Ffnho4Ysm8S3V/oa+w folded before Flop (didn't bet)
Seat 3: 54yWzRRgS0oZ+S6LwZBxMQ (button) folded before Flop (didn't bet)
Seat 5: gGPaCoSWW1HoKYaqfAPecg (small blind) folded before Flop
Seat 6: 5Y+ZGWLI4gnlpApDX5vy1A (big blind) folded before Flop



PokerStars Game #59937901602:  Hold'em No Limit ($1/$2) - 2009/07/01 0:02:28 ET
Table 'HewZCzVOYGmuLDKthTi5Yw' 6-max Seat #1 is the button
Seat 1: 353332 ($232.75 in chips)
Seat 2: X7GlkHF+lkbarCLuZ4Uf0w ($38 in chips)
Seat 3: WJxW31eStwT28R2X/L8F5A ($50 in chips)
Seat 4: yZgdnRylE65JbScQ7qCWgw ($38 in chips)
Seat 5: 513FcCI8jHyQy2VWoIQkMg ($371.50 in chips)
X7GlkHF+lkbarCLuZ4Uf0w: posts small blind $1
WJxW31eStwT28R2X/L8F5A: posts big blind $2
*** HOLE CARDS ***
yZgdnRylE65JbScQ7qCWgw: folds
513FcCI8jHyQy2VWoIQkMg: folds
353332: folds
X7GlkHF+lkbarCLuZ4Uf0w: raises $3 to $5
WJxW31eStwT28R2X/L8F5A: calls $3
*** FLOP *** [Qs 9c Kh]
X7GlkHF+lkbarCLuZ4Uf0w: checks
WJxW31eStwT28R2X/L8F5A: bets $4
X7GlkHF+lkbarCLuZ4Uf0w: folds
WJxW31eStwT28R2X/L8F5A collected $9.50 from pot
WJxW31eStwT28R2X/L8F5A: doesn't show hand
*** SUMMARY ***
Total pot $10 | Rake $0.50
Board [Qs 9c Kh]
Seat 1: 353332 (button) folded before Flop (didn't bet)
Seat 2: X7GlkHF+lkbarCLuZ4Uf0w (small blind) folded on the Flop
Seat 3: WJxW31eStwT28R2X/L8F5A (big blind) collected ($9.50)
Seat 4: yZgdnRylE65JbScQ7qCWgw folded before Flop (didn't bet)
Seat 5: 513FcCI8jHyQy2VWoIQkMg folded before Flop (didn't bet)



PokerStars Game #59937901606:  Hold'em No Limit ($1/$2) - 2009/07/01 0:02:28 ET
Table 'pPQgcj9XT9CHBsbo1WTBug' 6-max Seat #6 is the button
Seat 1: DFVYDA6dKQy7R7mGIKogZA ($113.90 in chips)
Seat 3: vkfxu8f/jMYKUk6Ly4eujw ($196 in chips)
Seat 5: 4Cl43Q1TYQL8wn1NSCUkaw ($67.60 in chips)
Seat 6: yZgdnRylE65JbScQ7qCWgw ($28 in chips)
DFVYDA6dKQy7R7mGIKogZA: posts small blind $1
vkfxu8f/jMYKUk6Ly4eujw: posts big blind $2
*** HOLE CARDS ***
4Cl43Q1TYQL8wn1NSCUkaw: folds
yZgdnRylE65JbScQ7qCWgw: folds
DFVYDA6dKQy7R7mGIKogZA: raises $2 to $4
vkfxu8f/jMYKUk6Ly4eujw: folds
DFVYDA6dKQy7R7mGIKogZA collected $4 from pot
*** SUMMARY ***
Total pot $4 | Rake $0
Seat 1: DFVYDA6dKQy7R7mGIKogZA (small blind) collected ($4)
Seat 3: vkfxu8f/jMYKUk6Ly4eujw (big blind) folded before Flop
Seat 5: 4Cl43Q1TYQL8wn1NSCUkaw folded before Flop (didn't bet)
Seat 6: yZgdnRylE65JbScQ7qCWgw (button) folded before Flop (didn't bet)



PokerStars Game #59937902224:  Hold'em No Limit ($1/$2) - 2009/07/01 0:02:28 ET
Table 'NmY84NAf9Mh0ckAckHnh5g' 2-max Seat #2 is the button
Seat 1: 6hvg964TSqZ3AL/0XK9aVQ ($326.70 in chips)
Seat 2: RwDoM55ZeQuI2ADyJhOb2Q ($272.50 in chips)
RwDoM55ZeQuI2ADyJhOb2Q: posts small blind $1
6hvg964TSqZ3AL/0XK9aVQ: posts big blind $2
*** HOLE CARDS ***
RwDoM55ZeQuI2ADyJhOb2Q: raises $2 to $4
6hvg964TSqZ3AL/0XK9aVQ: folds
RwDoM55ZeQuI2ADyJhOb2Q collected $4 from pot
RwDoM55ZeQuI2ADyJhOb2Q: doesn't show hand
*** SUMMARY ***
Total pot $4 | Rake $0
Seat 1: 6hvg964TSqZ3AL/0XK9aVQ (big blind) folded before Flop
Seat 2: RwDoM55ZeQuI2ADyJhOb2Q (button) (small blind) collected ($4)



PokerStars Game #59937905394:  Hold'em No Limit ($1/$2) - 2009/07/01 0:02:33 ET
Table 'jlrIxbrVIG+gjaUYT4za8g' 6-max Seat #1 is the button
Seat 1: ygTTt5ehT4aF86q1a8/R+w ($176.35 in chips)
Seat 2: N18PrNGQj43J7TJuQuu+tw ($169.05 in chips)
Seat 3: /PH6Ffnho4Ysm8S3V/oa+w ($40 in chips)
Seat 4: 8srN1dKQePlsv0GyTada+Q ($203 in chips)
Seat 5: F/075N6nU34Fn0zr6qD3aw ($171.55 in chips)
Seat 6: vkfxu8f/jMYKUk6Ly4eujw ($260.40 in chips)
N18PrNGQj43J7TJuQuu+tw: posts small blind $1
/PH6Ffnho4Ysm8S3V/oa+w: posts big blind $2
*** HOLE CARDS ***
8srN1dKQePlsv0GyTada+Q: folds
F/075N6nU34Fn0zr6qD3aw: folds
vkfxu8f/jMYKUk6Ly4eujw: raises $3 to $5
ygTTt5ehT4aF86q1a8/R+w: folds
N18PrNGQj43J7TJuQuu+tw: calls $4
/PH6Ffnho4Ysm8S3V/oa+w: folds
*** FLOP *** [5h Jd Kc]
N18PrNGQj43J7TJuQuu+tw: bets $8
vkfxu8f/jMYKUk6Ly4eujw: calls $8
*** TURN *** [5h Jd Kc] [Qd]
N18PrNGQj43J7TJuQuu+tw: checks
vkfxu8f/jMYKUk6Ly4eujw: checks
*** RIVER *** [5h Jd Kc Qd] [4s]
N18PrNGQj43J7TJuQuu+tw: checks
vkfxu8f/jMYKUk6Ly4eujw: checks
*** SHOW DOWN ***
N18PrNGQj43J7TJuQuu+tw: shows [4c Ac] (a pair of Fours)
vkfxu8f/jMYKUk6Ly4eujw: shows [Qh Tc] (a pair of Queens)
vkfxu8f/jMYKUk6Ly4eujw collected $26.65 from pot
*** SUMMARY ***
Total pot $28 | Rake $1.35
Board [5h Jd Kc Qd 4s]
Seat 1: ygTTt5ehT4aF86q1a8/R+w (button) folded before Flop (didn't bet)
Seat 2: N18PrNGQj43J7TJuQuu+tw (small blind) showed [4c Ac] and lost with a pair of Fours
Seat 3: /PH6Ffnho4Ysm8S3V/oa+w (big blind) folded before Flop
Seat 4: 8srN1dKQePlsv0GyTada+Q folded before Flop (didn't bet)
Seat 5: F/075N6nU34Fn0zr6qD3aw folded before Flop (didn't bet)
Seat 6: vkfxu8f/jMYKUk6Ly4eujw showed [Qh Tc] and won ($26.65) with a pair of Queens



PokerStars Game #59937905550:  Hold'em No Limit ($1/$2) - 2009/07/01 0:02:33 ET
Table 'ZzSIe0zTCDv+n6hfbY5tTg' 6-max Seat #1 is the button
Seat 1: 8srN1dKQePlsv0GyTada+Q ($215.70 in chips)
Seat 2: JQAf1Fiqbg0N8wNGA2nZhw ($200 in chips)
Seat 3: Y+MK4vQx233i+/aiP6js/Q ($352.20 in chips)
Seat 5: Q3uFdu6ztesjDFiqkagTRQ ($205.10 in chips)
Seat 6: 39260874 ($199.45 in chips)
JQAf1Fiqbg0N8wNGA2nZhw: posts small blind $1
Y+MK4vQx233i+/aiP6js/Q: posts big blind $2
*** HOLE CARDS ***
Q3uFdu6ztesjDFiqkagTRQ: folds
39260874: calls $2
8srN1dKQePlsv0GyTada+Q: folds
JQAf1Fiqbg0N8wNGA2nZhw: folds
Y+MK4vQx233i+/aiP6js/Q: checks
*** FLOP *** [Js 2s 3c]
Y+MK4vQx233i+/aiP6js/Q: checks
39260874: bets $2
Y+MK4vQx233i+/aiP6js/Q: folds
39260874 collected $4.75 from pot
*** SUMMARY ***
Total pot $5 | Rake $0.25
Board [Js 2s 3c]
Seat 1: 8srN1dKQePlsv0GyTada+Q (button) folded before Flop (didn't bet)
Seat 2: JQAf1Fiqbg0N8wNGA2nZhw (small blind) folded before Flop
Seat 3: Y+MK4vQx233i+/aiP6js/Q (big blind) folded on the Flop
Seat 5: Q3uFdu6ztesjDFiqkagTRQ folded before Flop (didn't bet)
Seat 6: 39260874 collected ($4.75)



PokerStars Game #59937907928:  Hold'em No Limit ($1/$2) - 2009/07/01 0:02:36 ET
Table 'NmY84NAf9Mh0ckAckHnh5g' 2-max Seat #1 is the button
Seat 1: 6hvg964TSqZ3AL/0XK9aVQ ($324.70 in chips)
Seat 2: RwDoM55ZeQuI2ADyJhOb2Q ($274.50 in chips)
6hvg964TSqZ3AL/0XK9aVQ: posts small blind $1
RwDoM55ZeQuI2ADyJhOb2Q: posts big blind $2
*** HOLE CARDS ***
6hvg964TSqZ3AL/0XK9aVQ: calls $1
RwDoM55ZeQuI2ADyJhOb2Q: raises $4 to $6
6hvg964TSqZ3AL/0XK9aVQ: calls $4
*** FLOP *** [3s 9h Tc]
RwDoM55ZeQuI2ADyJhOb2Q: bets $8
6hvg964TSqZ3AL/0XK9aVQ: calls $8
*** TURN *** [3s 9h Tc] [Jc]
RwDoM55ZeQuI2ADyJhOb2Q: bets $12
6hvg964TSqZ3AL/0XK9aVQ: calls $12
*** RIVER *** [3s 9h Tc Jc] [8h]
RwDoM55ZeQuI2ADyJhOb2Q: checks
6hvg964TSqZ3AL/0XK9aVQ: bets $120
RwDoM55ZeQuI2ADyJhOb2Q: folds
6hvg964TSqZ3AL/0XK9aVQ collected $51.50 from pot
*** SUMMARY ***
Total pot $52 | Rake $0.50
Board [3s 9h Tc Jc 8h]
Seat 1: 6hvg964TSqZ3AL/0XK9aVQ (button) (small blind) collected ($51.50)
Seat 2: RwDoM55ZeQuI2ADyJhOb2Q (big blind) folded on the River



PokerStars Game #59937908176:  Hold'em No Limit ($1/$2) - 2009/07/01 0:02:37 ET
Table 'uJ9juaXXg9yIcSU8amxaXQ' 6-max Seat #1 is the button
Seat 1: HhIxv6mylwCAfv3sjJmq5g ($200 in chips)
Seat 2: DQlskgG4OtLpF2MVxLwf4A ($276.70 in chips)
Seat 3: zaogaltCDFVsIASEnrXs2w ($259.75 in chips)
Seat 5: F/075N6nU34Fn0zr6qD3aw ($233.05 in chips)
Seat 6: XrFG4dK06RVKLlX32/pjcQ ($45.70 in chips)
DQlskgG4OtLpF2MVxLwf4A: posts small blind $1
zaogaltCDFVsIASEnrXs2w: posts big blind $2
54yWzRRgS0oZ+S6LwZBxMQ: sits out
*** HOLE CARDS ***
F/075N6nU34Fn0zr6qD3aw: folds
XrFG4dK06RVKLlX32/pjcQ: calls $2
HhIxv6mylwCAfv3sjJmq5g: folds
DQlskgG4OtLpF2MVxLwf4A: calls $1
zaogaltCDFVsIASEnrXs2w: checks
*** FLOP *** [Th Td Tc]
DQlskgG4OtLpF2MVxLwf4A: checks
zaogaltCDFVsIASEnrXs2w: checks
XrFG4dK06RVKLlX32/pjcQ: checks
*** TURN *** [Th Td Tc] [8d]
DQlskgG4OtLpF2MVxLwf4A: bets $4
zaogaltCDFVsIASEnrXs2w: folds
XrFG4dK06RVKLlX32/pjcQ: calls $4
*** RIVER *** [Th Td Tc 8d] [5h]
DQlskgG4OtLpF2MVxLwf4A: checks
XrFG4dK06RVKLlX32/pjcQ: checks
*** SHOW DOWN ***
DQlskgG4OtLpF2MVxLwf4A: shows [7d 8c] (a full house, Tens full of Eights)
XrFG4dK06RVKLlX32/pjcQ: mucks hand
DQlskgG4OtLpF2MVxLwf4A collected $13.35 from pot
*** SUMMARY ***
Total pot $14 | Rake $0.65
Board [Th Td Tc 8d 5h]
Seat 1: HhIxv6mylwCAfv3sjJmq5g (button) folded before Flop (didn't bet)
Seat 2: DQlskgG4OtLpF2MVxLwf4A (small blind) showed [7d 8c] and won ($13.35) with a full house, Tens full of Eights
Seat 3: zaogaltCDFVsIASEnrXs2w (big blind) folded on the Turn
Seat 5: F/075N6nU34Fn0zr6qD3aw folded before Flop (didn't bet)
Seat 6: XrFG4dK06RVKLlX32/pjcQ mucked



PokerStars Game #59937908642:  Hold'em No Limit ($1/$2) - 2009/07/01 0:02:37 ET
Table 'ztv6V3FN2bQ9nmJPPdx6nQ' 6-max Seat #4 is the button
Seat 1: ek1hig03QiyONDHXvgqteQ ($196.75 in chips)
Seat 3: Z55K9DbCHCUi6UaztIHi6g ($147.05 in chips)
Seat 4: vkfxu8f/jMYKUk6Ly4eujw ($316.70 in chips)
Seat 5: sTPOWERd9HWPCNrDBwsVjA ($202.75 in chips)
Seat 6: yZgdnRylE65JbScQ7qCWgw ($37 in chips)
sTPOWERd9HWPCNrDBwsVjA: posts small blind $1
yZgdnRylE65JbScQ7qCWgw: posts big blind $2
*** HOLE CARDS ***
ek1hig03QiyONDHXvgqteQ: folds
Z55K9DbCHCUi6UaztIHi6g: folds
vkfxu8f/jMYKUk6Ly4eujw: folds
sTPOWERd9HWPCNrDBwsVjA: raises $4 to $6
yZgdnRylE65JbScQ7qCWgw: folds
sTPOWERd9HWPCNrDBwsVjA collected $4 from pot
*** SUMMARY ***
Total pot $4 | Rake $0
Seat 1: ek1hig03QiyONDHXvgqteQ folded before Flop (didn't bet)
Seat 3: Z55K9DbCHCUi6UaztIHi6g folded before Flop (didn't bet)
Seat 4: vkfxu8f/jMYKUk6Ly4eujw (button) folded before Flop (didn't bet)
Seat 5: sTPOWERd9HWPCNrDBwsVjA (small blind) collected ($4)
Seat 6: yZgdnRylE65JbScQ7qCWgw (big blind) folded before Flop



PokerStars Game #59937910586:  Hold'em No Limit ($1/$2) - 2009/07/01 0:02:40 ET
Table 'YqGfR5eHfMeSjb9a+QU9rg' 9-max Seat #2 is the button
Seat 1: qCBuzVnLcBR29snMAHq9PA ($180.35 in chips)
Seat 2: W3Nqt1GWlTi9tXQXMNEvgw ($217.60 in chips)
Seat 3: 02K2DtsrlV5RLBdrzZcWqg ($61.55 in chips)
Seat 4: QHxJjpVYwitg9krW6wZgJA ($200 in chips)
Seat 5: MOBMOMQRN/z+fiGXGnZojw ($191.10 in chips)
Seat 6: 5iPk5MyO3KVu18Y8XCYfFQ ($36 in chips)
Seat 7: b0jO1SDhLedy1//CQlA8kw ($42 in chips)
Seat 8: GX1heJ+DSsvm7gzSPsYhhQ ($32 in chips)
Seat 9: RsrgM2l7PLbQ9xBbSi3IvQ ($110.40 in chips)
02K2DtsrlV5RLBdrzZcWqg: posts small blind $1
QHxJjpVYwitg9krW6wZgJA: posts big blind $2
*** HOLE CARDS ***
MOBMOMQRN/z+fiGXGnZojw: calls $2
5iPk5MyO3KVu18Y8XCYfFQ: folds
b0jO1SDhLedy1//CQlA8kw: folds
GX1heJ+DSsvm7gzSPsYhhQ: raises $6 to $8
RsrgM2l7PLbQ9xBbSi3IvQ: folds
qCBuzVnLcBR29snMAHq9PA: folds
W3Nqt1GWlTi9tXQXMNEvgw: folds
02K2DtsrlV5RLBdrzZcWqg: folds
QHxJjpVYwitg9krW6wZgJA: calls $6
MOBMOMQRN/z+fiGXGnZojw: calls $6
*** FLOP *** [8h Qd Tc]
02K2DtsrlV5RLBdrzZcWqg leaves the table
QHxJjpVYwitg9krW6wZgJA: checks
MOBMOMQRN/z+fiGXGnZojw: checks
GX1heJ+DSsvm7gzSPsYhhQ: bets $10
QHxJjpVYwitg9krW6wZgJA: calls $10
MOBMOMQRN/z+fiGXGnZojw: folds
*** TURN *** [8h Qd Tc] [4h]
QHxJjpVYwitg9krW6wZgJA: bets $6
GX1heJ+DSsvm7gzSPsYhhQ: raises $8 to $14 and is all-in
QHxJjpVYwitg9krW6wZgJA: calls $8
*** RIVER *** [8h Qd Tc 4h] [Kc]
*** SHOW DOWN ***
QHxJjpVYwitg9krW6wZgJA: shows [Ts Td] (three of a kind, Tens)
GX1heJ+DSsvm7gzSPsYhhQ: shows [Kh Ks] (three of a kind, Kings)
GX1heJ+DSsvm7gzSPsYhhQ collected $70 from pot
*** SUMMARY ***
Total pot $73 | Rake $3
Board [8h Qd Tc 4h Kc]
Seat 1: qCBuzVnLcBR29snMAHq9PA folded before Flop (didn't bet)
Seat 2: W3Nqt1GWlTi9tXQXMNEvgw (button) folded before Flop (didn't bet)
Seat 3: 02K2DtsrlV5RLBdrzZcWqg (small blind) folded before Flop
Seat 4: QHxJjpVYwitg9krW6wZgJA (big blind) showed [Ts Td] and lost with three of a kind, Tens
Seat 5: MOBMOMQRN/z+fiGXGnZojw folded on the Flop
Seat 6: 5iPk5MyO3KVu18Y8XCYfFQ folded before Flop (didn't bet)
Seat 7: b0jO1SDhLedy1//CQlA8kw folded before Flop (didn't bet)
Seat 8: GX1heJ+DSsvm7gzSPsYhhQ showed [Kh Ks] and won ($70) with three of a kind, Kings
Seat 9: RsrgM2l7PLbQ9xBbSi3IvQ folded before Flop (didn't bet)



PokerStars Game #59937911822:  Hold'em No Limit ($1/$2) - 2009/07/01 0:02:42 ET
Table 'WCA60bDA8ecovUgFSIZkTQ' 9-max Seat #3 is the button
Seat 1: xNLmepWbCljNEEeH8O5jSg ($266.65 in chips)
Seat 2: G1h8wamBcVJXtsKXZQ2EyA ($84.70 in chips)
Seat 3: 5iPk5MyO3KVu18Y8XCYfFQ ($37 in chips)
Seat 4: Q3uFdu6ztesjDFiqkagTRQ ($448.70 in chips)
Seat 5: Hc2itIxwbi1lwa+DAYYQGg ($312.30 in chips)
Seat 6: DOWQSOJ7GaX+ksfWTqPT5A ($198.75 in chips)
Seat 7: GX1heJ+DSsvm7gzSPsYhhQ ($34 in chips)
Seat 8: x+V1JgVDawsJTxKcxm7gxw ($100 in chips)
Seat 9: 3q2/0oJr3Mcy1W5tcN61ug ($301.20 in chips)
Q3uFdu6ztesjDFiqkagTRQ: posts small blind $1
Hc2itIxwbi1lwa+DAYYQGg: posts big blind $2
*** HOLE CARDS ***
DOWQSOJ7GaX+ksfWTqPT5A: folds
GX1heJ+DSsvm7gzSPsYhhQ: folds
x+V1JgVDawsJTxKcxm7gxw: folds
3q2/0oJr3Mcy1W5tcN61ug: folds
xNLmepWbCljNEEeH8O5jSg: folds
G1h8wamBcVJXtsKXZQ2EyA: folds
5iPk5MyO3KVu18Y8XCYfFQ: raises $2 to $4
Q3uFdu6ztesjDFiqkagTRQ: raises $10 to $14
Hc2itIxwbi1lwa+DAYYQGg: folds
5iPk5MyO3KVu18Y8XCYfFQ: raises $23 to $37 and is all-in
Q3uFdu6ztesjDFiqkagTRQ: calls $23
*** FLOP *** [3c 9s 7c]
*** TURN *** [3c 9s 7c] [8c]
*** RIVER *** [3c 9s 7c 8c] [8h]
*** SHOW DOWN ***
Q3uFdu6ztesjDFiqkagTRQ: shows [Ah 9h] (two pair, Nines and Eights)
5iPk5MyO3KVu18Y8XCYfFQ: mucks hand
Q3uFdu6ztesjDFiqkagTRQ collected $73 from pot
*** SUMMARY ***
Total pot $76 | Rake $3
Board [3c 9s 7c 8c 8h]
Seat 1: xNLmepWbCljNEEeH8O5jSg folded before Flop (didn't bet)
Seat 2: G1h8wamBcVJXtsKXZQ2EyA folded before Flop (didn't bet)
Seat 3: 5iPk5MyO3KVu18Y8XCYfFQ (button) mucked
Seat 4: Q3uFdu6ztesjDFiqkagTRQ (small blind) showed [Ah 9h] and won ($73) with two pair, Nines and Eights
Seat 5: Hc2itIxwbi1lwa+DAYYQGg (big blind) folded before Flop
Seat 6: DOWQSOJ7GaX+ksfWTqPT5A folded before Flop (didn't bet)
Seat 7: GX1heJ+DSsvm7gzSPsYhhQ folded before Flop (didn't bet)
Seat 8: x+V1JgVDawsJTxKcxm7gxw folded before Flop (didn't bet)
Seat 9: 3q2/0oJr3Mcy1W5tcN61ug folded before Flop (didn't bet)



PokerStars Game #59937914970:  Hold'em No Limit ($1/$2) - 2009/07/01 0:02:46 ET
Table 'rsKRKlGHlxVyqJxzO2a2Ow' 9-max Seat #2 is the button
Seat 1: uYWfQJg2hgHLxri6/uVJiw ($136.70 in chips)
Seat 2: QHxJjpVYwitg9krW6wZgJA ($244 in chips)
Seat 3: 9sYbXdhj1M2bwKrVNxj5+Q ($91.80 in chips)
Seat 4: zJtQ1gxyi72XvGYS1tM+DA ($41.15 in chips)
Seat 5: QxGDcfm0Yb34yQ4T9e1PIA ($189.75 in chips)
Seat 6: H6Z4+qu8gR0VUiPOijndVg ($200 in chips)
Seat 7: kVCeGJ4NY7Fb0W74j1mAqA ($200 in chips)
Seat 8: Hc2itIxwbi1lwa+DAYYQGg ($46 in chips)
Seat 9: 5iPk5MyO3KVu18Y8XCYfFQ ($96.20 in chips)
9sYbXdhj1M2bwKrVNxj5+Q: posts small blind $1
zJtQ1gxyi72XvGYS1tM+DA: posts big blind $2
*** HOLE CARDS ***
QxGDcfm0Yb34yQ4T9e1PIA: folds
QxGDcfm0Yb34yQ4T9e1PIA is sitting out
H6Z4+qu8gR0VUiPOijndVg: folds
kVCeGJ4NY7Fb0W74j1mAqA: folds
QxGDcfm0Yb34yQ4T9e1PIA leaves the table
Hc2itIxwbi1lwa+DAYYQGg: raises $4 to $6
5iPk5MyO3KVu18Y8XCYfFQ: folds
uYWfQJg2hgHLxri6/uVJiw: calls $6
5Q8U6iZbeO7xJSS4qvDP5g joins the table at seat #5
QHxJjpVYwitg9krW6wZgJA: folds
9sYbXdhj1M2bwKrVNxj5+Q: calls $5
zJtQ1gxyi72XvGYS1tM+DA: folds
*** FLOP *** [9s 8c 5d]
9sYbXdhj1M2bwKrVNxj5+Q: bets $6
Hc2itIxwbi1lwa+DAYYQGg: folds
uYWfQJg2hgHLxri6/uVJiw: calls $6
*** TURN *** [9s 8c 5d] [As]
9sYbXdhj1M2bwKrVNxj5+Q: bets $8
uYWfQJg2hgHLxri6/uVJiw: raises $12 to $20
9sYbXdhj1M2bwKrVNxj5+Q: folds
uYWfQJg2hgHLxri6/uVJiw collected $45.70 from pot
uYWfQJg2hgHLxri6/uVJiw: doesn't show hand
*** SUMMARY ***
Total pot $48 | Rake $2.30
Board [9s 8c 5d As]
Seat 1: uYWfQJg2hgHLxri6/uVJiw collected ($45.70)
Seat 2: QHxJjpVYwitg9krW6wZgJA (button) folded before Flop (didn't bet)
Seat 3: 9sYbXdhj1M2bwKrVNxj5+Q (small blind) folded on the Turn
Seat 4: zJtQ1gxyi72XvGYS1tM+DA (big blind) folded before Flop
Seat 5: QxGDcfm0Yb34yQ4T9e1PIA folded before Flop (didn't bet)
Seat 6: H6Z4+qu8gR0VUiPOijndVg folded before Flop (didn't bet)
Seat 7: kVCeGJ4NY7Fb0W74j1mAqA folded before Flop (didn't bet)
Seat 8: Hc2itIxwbi1lwa+DAYYQGg folded on the Flop
Seat 9: 5iPk5MyO3KVu18Y8XCYfFQ folded before Flop (didn't bet)



PokerStars Game #59937915094:  Hold'em No Limit ($1/$2) - 2009/07/01 0:02:47 ET
Table 'bJQ024BaYSBrW0sXpCZbNQ' 6-max Seat #5 is the button
Seat 1: yZgdnRylE65JbScQ7qCWgw ($37 in chips)
Seat 2: 1njbh8TKSUF6l4V1XwGdcg ($251.40 in chips)
Seat 3: vkfxu8f/jMYKUk6Ly4eujw ($211.30 in chips)
Seat 4: 9ni/OEXAqfc58zPQ0Tu9rQ ($281.05 in chips)
Seat 5: X7GlkHF+lkbarCLuZ4Uf0w ($41.15 in chips)
Seat 6: 9dpyyjDTCed6nV7JhaUUpw ($213.50 in chips)
9dpyyjDTCed6nV7JhaUUpw: posts small blind $1
yZgdnRylE65JbScQ7qCWgw: posts big blind $2
*** HOLE CARDS ***
1njbh8TKSUF6l4V1XwGdcg: folds
vkfxu8f/jMYKUk6Ly4eujw: raises $6 to $8
9ni/OEXAqfc58zPQ0Tu9rQ: folds
X7GlkHF+lkbarCLuZ4Uf0w: folds
9dpyyjDTCed6nV7JhaUUpw: folds
yZgdnRylE65JbScQ7qCWgw: folds
vkfxu8f/jMYKUk6Ly4eujw collected $5 from pot
vkfxu8f/jMYKUk6Ly4eujw: doesn't show hand
*** SUMMARY ***
Total pot $5 | Rake $0
Seat 1: yZgdnRylE65JbScQ7qCWgw (big blind) folded before Flop
Seat 2: 1njbh8TKSUF6l4V1XwGdcg folded before Flop (didn't bet)
Seat 3: vkfxu8f/jMYKUk6Ly4eujw collected ($5)
Seat 4: 9ni/OEXAqfc58zPQ0Tu9rQ folded before Flop (didn't bet)
Seat 5: X7GlkHF+lkbarCLuZ4Uf0w (button) folded before Flop (didn't bet)
Seat 6: 9dpyyjDTCed6nV7JhaUUpw (small blind) folded before Flop



PokerStars Game #59937917616:  Hold'em No Limit ($1/$2) - 2009/07/01 0:02:50 ET
Table 'l5lZHc5JRHEDt0Y2AVPq3g' 6-max Seat #4 is the button
Seat 1: gGPaCoSWW1HoKYaqfAPecg ($206.30 in chips)
Seat 2: my38j/MmtBd/8qVwmyCREA ($213.40 in chips)
Seat 3: yZgdnRylE65JbScQ7qCWgw ($40 in chips)
Seat 4: zNjJ/y4emmF+vzrCDd+ooA ($205.05 in chips)
Seat 5: 6fLdOUCRtX71xbVRhJEq8w ($200 in chips)
Seat 6: vkfxu8f/jMYKUk6Ly4eujw ($199 in chips)
6fLdOUCRtX71xbVRhJEq8w: posts small blind $1
vkfxu8f/jMYKUk6Ly4eujw: posts big blind $2
*** HOLE CARDS ***
gGPaCoSWW1HoKYaqfAPecg: folds
my38j/MmtBd/8qVwmyCREA: folds
yZgdnRylE65JbScQ7qCWgw: folds
zNjJ/y4emmF+vzrCDd+ooA: folds
6fLdOUCRtX71xbVRhJEq8w: folds
vkfxu8f/jMYKUk6Ly4eujw collected $2 from pot
vkfxu8f/jMYKUk6Ly4eujw: doesn't show hand
*** SUMMARY ***
Total pot $2 | Rake $0
Seat 1: gGPaCoSWW1HoKYaqfAPecg folded before Flop (didn't bet)
Seat 2: my38j/MmtBd/8qVwmyCREA folded before Flop (didn't bet)
Seat 3: yZgdnRylE65JbScQ7qCWgw folded before Flop (didn't bet)
Seat 4: zNjJ/y4emmF+vzrCDd+ooA (button) folded before Flop (didn't bet)
Seat 5: 6fLdOUCRtX71xbVRhJEq8w (small blind) folded before Flop
Seat 6: vkfxu8f/jMYKUk6Ly4eujw (big blind) collected ($2)



PokerStars Game #59937918198:  Hold'em No Limit ($1/$2) - 2009/07/01 0:02:51 ET
Table 'pPQgcj9XT9CHBsbo1WTBug' 6-max Seat #1 is the button
Seat 1: DFVYDA6dKQy7R7mGIKogZA ($115.90 in chips)
Seat 3: vkfxu8f/jMYKUk6Ly4eujw ($194 in chips)
Seat 5: 4Cl43Q1TYQL8wn1NSCUkaw ($67.60 in chips)
Seat 6: yZgdnRylE65JbScQ7qCWgw ($28 in chips)
FreeDomL1fe was removed from the table for failing to post
vkfxu8f/jMYKUk6Ly4eujw: posts small blind $1
4Cl43Q1TYQL8wn1NSCUkaw: posts big blind $2
*** HOLE CARDS ***
X7GlkHF+lkbarCLuZ4Uf0w joins the table at seat #2
yZgdnRylE65JbScQ7qCWgw: folds
DFVYDA6dKQy7R7mGIKogZA: folds
vkfxu8f/jMYKUk6Ly4eujw: raises $6 to $8
4Cl43Q1TYQL8wn1NSCUkaw: folds
vkfxu8f/jMYKUk6Ly4eujw collected $4 from pot
vkfxu8f/jMYKUk6Ly4eujw: doesn't show hand
*** SUMMARY ***
Total pot $4 | Rake $0
Seat 1: DFVYDA6dKQy7R7mGIKogZA (button) folded before Flop (didn't bet)
Seat 3: vkfxu8f/jMYKUk6Ly4eujw (small blind) collected ($4)
Seat 5: 4Cl43Q1TYQL8wn1NSCUkaw (big blind) folded before Flop
Seat 6: yZgdnRylE65JbScQ7qCWgw folded before Flop (didn't bet)



PokerStars Game #59937918754:  Hold'em No Limit ($1/$2) - 2009/07/01 0:02:52 ET
Table 'on4i1U1lCRmxsduFD3xiSg' 9-max Seat #2 is the button
Seat 1: BRHGptvmY2GKq4uuj7duDw ($276.60 in chips)
Seat 2: yZYrOeNDxQxkzpbgKX1bng ($64 in chips)
Seat 3: 5iPk5MyO3KVu18Y8XCYfFQ ($65.20 in chips)
Seat 4: Z3aYCZG/yXHYFjiWkGI5ug ($207.30 in chips)
Seat 5: QHxJjpVYwitg9krW6wZgJA ($200 in chips)
Seat 6: SB0tvOX0Kw61r2U851JFaA ($403.20 in chips)
Seat 7: xD4ElYxz6Ollzmam8BmMCw ($249.25 in chips)
Seat 8: YlSX2xwu8QMQReaxSAD8XA ($164.85 in chips)
Seat 9: iMe5yhc+1BaiIPHet3NMrA ($200 in chips)
5iPk5MyO3KVu18Y8XCYfFQ: posts small blind $1
Z3aYCZG/yXHYFjiWkGI5ug: posts big blind $2
*** HOLE CARDS ***
QHxJjpVYwitg9krW6wZgJA: folds
SB0tvOX0Kw61r2U851JFaA: folds
xD4ElYxz6Ollzmam8BmMCw: folds
YlSX2xwu8QMQReaxSAD8XA: folds
iMe5yhc+1BaiIPHet3NMrA: raises $4 to $6
BRHGptvmY2GKq4uuj7duDw: folds
yZYrOeNDxQxkzpbgKX1bng: folds
5iPk5MyO3KVu18Y8XCYfFQ: folds
Z3aYCZG/yXHYFjiWkGI5ug: folds
iMe5yhc+1BaiIPHet3NMrA collected $5 from pot
*** SUMMARY ***
Total pot $5 | Rake $0
Seat 1: BRHGptvmY2GKq4uuj7duDw folded before Flop (didn't bet)
Seat 2: yZYrOeNDxQxkzpbgKX1bng (button) folded before Flop (didn't bet)
Seat 3: 5iPk5MyO3KVu18Y8XCYfFQ (small blind) folded before Flop
Seat 4: Z3aYCZG/yXHYFjiWkGI5ug (big blind) folded before Flop
Seat 5: QHxJjpVYwitg9krW6wZgJA folded before Flop (didn't bet)
Seat 6: SB0tvOX0Kw61r2U851JFaA folded before Flop (didn't bet)
Seat 7: xD4ElYxz6Ollzmam8BmMCw folded before Flop (didn't bet)
Seat 8: YlSX2xwu8QMQReaxSAD8XA folded before Flop (didn't bet)
Seat 9: iMe5yhc+1BaiIPHet3NMrA collected ($5)



PokerStars Game #59937918990:  Hold'em No Limit ($1/$2) - 2009/07/01 0:02:52 ET
Table 'fe+AlpfadsfwxhZEvYFbbA' 6-max Seat #5 is the button
Seat 1: SLlqn2PPbQqwfcLfYqUXrw ($81.45 in chips)
Seat 2: /PH6Ffnho4Ysm8S3V/oa+w ($40 in chips)
Seat 3: 54yWzRRgS0oZ+S6LwZBxMQ ($59.30 in chips)
Seat 5: gGPaCoSWW1HoKYaqfAPecg ($200 in chips)
Seat 6: 5Y+ZGWLI4gnlpApDX5vy1A ($205.55 in chips)
5Y+ZGWLI4gnlpApDX5vy1A: posts small blind $1
SLlqn2PPbQqwfcLfYqUXrw: posts big blind $2
*** HOLE CARDS ***
/PH6Ffnho4Ysm8S3V/oa+w: folds
54yWzRRgS0oZ+S6LwZBxMQ has timed out
54yWzRRgS0oZ+S6LwZBxMQ: folds
54yWzRRgS0oZ+S6LwZBxMQ is sitting out
54yWzRRgS0oZ+S6LwZBxMQ has returned
gGPaCoSWW1HoKYaqfAPecg: folds
5Y+ZGWLI4gnlpApDX5vy1A: raises $8 to $10
SLlqn2PPbQqwfcLfYqUXrw: folds
5Y+ZGWLI4gnlpApDX5vy1A collected $4 from pot
5Y+ZGWLI4gnlpApDX5vy1A: doesn't show hand
*** SUMMARY ***
Total pot $4 | Rake $0
Seat 1: SLlqn2PPbQqwfcLfYqUXrw (big blind) folded before Flop
Seat 2: /PH6Ffnho4Ysm8S3V/oa+w folded before Flop (didn't bet)
Seat 3: 54yWzRRgS0oZ+S6LwZBxMQ folded before Flop (didn't bet)
Seat 5: gGPaCoSWW1HoKYaqfAPecg (button) folded before Flop (didn't bet)
Seat 6: 5Y+ZGWLI4gnlpApDX5vy1A (small blind) collected ($4)



PokerStars Game #59937919254:  Hold'em No Limit ($1/$2) - 2009/07/01 0:02:52 ET
Table 'CFkQcfWjKccZaZDf71FK+w' 6-max Seat #6 is the button
Seat 1: X7GlkHF+lkbarCLuZ4Uf0w ($35 in chips)
Seat 2: yZgdnRylE65JbScQ7qCWgw ($37 in chips)
Seat 3: ygTTt5ehT4aF86q1a8/R+w ($124.40 in chips)
Seat 4: B2Ih1sr5VZk+8He7rcrMtQ ($221.90 in chips)
Seat 5: 1njbh8TKSUF6l4V1XwGdcg ($203 in chips)
Seat 6: ORVqY3rf9X6ANA/8s+On2Q ($88 in chips)
X7GlkHF+lkbarCLuZ4Uf0w: posts small blind $1
yZgdnRylE65JbScQ7qCWgw: posts big blind $2
*** HOLE CARDS ***
ygTTt5ehT4aF86q1a8/R+w: folds
B2Ih1sr5VZk+8He7rcrMtQ: raises $4 to $6
1njbh8TKSUF6l4V1XwGdcg: folds
ORVqY3rf9X6ANA/8s+On2Q: folds
X7GlkHF+lkbarCLuZ4Uf0w: folds
yZgdnRylE65JbScQ7qCWgw: folds
B2Ih1sr5VZk+8He7rcrMtQ collected $5 from pot
*** SUMMARY ***
Total pot $5 | Rake $0
Seat 1: X7GlkHF+lkbarCLuZ4Uf0w (small blind) folded before Flop
Seat 2: yZgdnRylE65JbScQ7qCWgw (big blind) folded before Flop
Seat 3: ygTTt5ehT4aF86q1a8/R+w folded before Flop (didn't bet)
Seat 4: B2Ih1sr5VZk+8He7rcrMtQ collected ($5)
Seat 5: 1njbh8TKSUF6l4V1XwGdcg folded before Flop (didn't bet)
Seat 6: ORVqY3rf9X6ANA/8s+On2Q (button) folded before Flop (didn't bet)



PokerStars Game #59937918980:  Hold'em No Limit ($1/$2) - 2009/07/01 0:02:52 ET
Table 'aSf77Sj8QEnzcc0WaxVD4Q' 6-max Seat #1 is the button
Seat 1: Q3uFdu6ztesjDFiqkagTRQ ($200 in chips)
Seat 2: vkfxu8f/jMYKUk6Ly4eujw ($205.75 in chips)
Seat 3: 9dpyyjDTCed6nV7JhaUUpw ($223.05 in chips)
Seat 4: 513FcCI8jHyQy2VWoIQkMg ($212.60 in chips)
Seat 5: InmkdI6G8TzSj9NhcCSyPg ($269 in chips)
Seat 6: vkoJRf3gidxY1pPi0AFWww ($311.05 in chips)
vkfxu8f/jMYKUk6Ly4eujw: posts small blind $1
9dpyyjDTCed6nV7JhaUUpw: posts big blind $2
*** HOLE CARDS ***
513FcCI8jHyQy2VWoIQkMg: folds
InmkdI6G8TzSj9NhcCSyPg: folds
vkoJRf3gidxY1pPi0AFWww: calls $2
Q3uFdu6ztesjDFiqkagTRQ: folds
vkfxu8f/jMYKUk6Ly4eujw: folds
9dpyyjDTCed6nV7JhaUUpw: checks
*** FLOP *** [As 4d 7d]
9dpyyjDTCed6nV7JhaUUpw: checks
vkoJRf3gidxY1pPi0AFWww: checks
*** TURN *** [As 4d 7d] [4c]
9dpyyjDTCed6nV7JhaUUpw: checks
vkoJRf3gidxY1pPi0AFWww: checks
*** RIVER *** [As 4d 7d 4c] [Tc]
9dpyyjDTCed6nV7JhaUUpw: checks
vkoJRf3gidxY1pPi0AFWww: checks
*** SHOW DOWN ***
9dpyyjDTCed6nV7JhaUUpw: shows [Jd 2h] (a pair of Fours)
vkoJRf3gidxY1pPi0AFWww: shows [Qd Kh] (a pair of Fours - Ace+King kicker)
vkoJRf3gidxY1pPi0AFWww collected $4.75 from pot
*** SUMMARY ***
Total pot $5 | Rake $0.25
Board [As 4d 7d 4c Tc]
Seat 1: Q3uFdu6ztesjDFiqkagTRQ (button) folded before Flop (didn't bet)
Seat 2: vkfxu8f/jMYKUk6Ly4eujw (small blind) folded before Flop
Seat 3: 9dpyyjDTCed6nV7JhaUUpw (big blind) showed [Jd 2h] and lost with a pair of Fours
Seat 4: 513FcCI8jHyQy2VWoIQkMg folded before Flop (didn't bet)
Seat 5: InmkdI6G8TzSj9NhcCSyPg folded before Flop (didn't bet)
Seat 6: vkoJRf3gidxY1pPi0AFWww showed [Qd Kh] and won ($4.75) with a pair of Fours



PokerStars Game #59937921946:  Hold'em No Limit ($1/$2) - 2009/07/01 0:02:56 ET
Table 'ztv6V3FN2bQ9nmJPPdx6nQ' 6-max Seat #5 is the button
Seat 1: ek1hig03QiyONDHXvgqteQ ($196.75 in chips)
Seat 3: Z55K9DbCHCUi6UaztIHi6g ($147.05 in chips)
Seat 4: vkfxu8f/jMYKUk6Ly4eujw ($316.70 in chips)
Seat 5: sTPOWERd9HWPCNrDBwsVjA ($204.75 in chips)
Seat 6: yZgdnRylE65JbScQ7qCWgw ($35 in chips)
yZgdnRylE65JbScQ7qCWgw: posts small blind $1
ek1hig03QiyONDHXvgqteQ: posts big blind $2
*** HOLE CARDS ***
Z55K9DbCHCUi6UaztIHi6g: calls $2
vkfxu8f/jMYKUk6Ly4eujw: folds
sTPOWERd9HWPCNrDBwsVjA: calls $2
yZgdnRylE65JbScQ7qCWgw: folds
ek1hig03QiyONDHXvgqteQ: checks
*** FLOP *** [2h Ts 9c]
ek1hig03QiyONDHXvgqteQ: checks
Z55K9DbCHCUi6UaztIHi6g: checks
sTPOWERd9HWPCNrDBwsVjA: checks
*** TURN *** [2h Ts 9c] [8s]
ek1hig03QiyONDHXvgqteQ: bets $4
Z55K9DbCHCUi6UaztIHi6g: calls $4
sTPOWERd9HWPCNrDBwsVjA: folds
*** RIVER *** [2h Ts 9c 8s] [7d]
ek1hig03QiyONDHXvgqteQ: checks
Z55K9DbCHCUi6UaztIHi6g: checks
*** SHOW DOWN ***
ek1hig03QiyONDHXvgqteQ: shows [7h 7c] (three of a kind, Sevens)
Z55K9DbCHCUi6UaztIHi6g: mucks hand
ek1hig03QiyONDHXvgqteQ collected $14.30 from pot
*** SUMMARY ***
Total pot $15 | Rake $0.70
Board [2h Ts 9c 8s 7d]
Seat 1: ek1hig03QiyONDHXvgqteQ (big blind) showed [7h 7c] and won ($14.30) with three of a kind, Sevens
Seat 3: Z55K9DbCHCUi6UaztIHi6g mucked
Seat 4: vkfxu8f/jMYKUk6Ly4eujw folded before Flop (didn't bet)
Seat 5: sTPOWERd9HWPCNrDBwsVjA (button) folded on the Turn
Seat 6: yZgdnRylE65JbScQ7qCWgw (small blind) folded before Flop



PokerStars Game #59937925696:  Hold'em No Limit ($1/$2) - 2009/07/01 0:03:01 ET
Table 'SF49/KQm8T4taMp6kb+HXA' 9-max Seat #1 is the button
Seat 1: l1bCLGuFqeFRwUfPsiDu/g ($193.95 in chips)
Seat 2: dJO4Wtu5e7hHBlpz0cmy1w ($72.20 in chips)
Seat 3: L88dtdULfz5oGDSuo9/RvA ($36.05 in chips)
Seat 5: Z3aYCZG/yXHYFjiWkGI5ug ($236.55 in chips)
Seat 6: M2ht6rIKOI/my9eh610Nlw ($250.45 in chips)
Seat 7: n2VAbLaE5qgKr5mA4W6v4w ($56.50 in chips)
Seat 8: 5iPk5MyO3KVu18Y8XCYfFQ ($39 in chips)
Seat 9: O+jytCilwk7zItVCEavmtw ($120.25 in chips)
dJO4Wtu5e7hHBlpz0cmy1w: posts small blind $1
L88dtdULfz5oGDSuo9/RvA: posts big blind $2
*** HOLE CARDS ***
Z3aYCZG/yXHYFjiWkGI5ug: raises $4 to $6
M2ht6rIKOI/my9eh610Nlw: folds
n2VAbLaE5qgKr5mA4W6v4w: folds
5iPk5MyO3KVu18Y8XCYfFQ: folds
O+jytCilwk7zItVCEavmtw: folds
l1bCLGuFqeFRwUfPsiDu/g: folds
dJO4Wtu5e7hHBlpz0cmy1w: folds
L88dtdULfz5oGDSuo9/RvA: raises $30.05 to $36.05 and is all-in
Z3aYCZG/yXHYFjiWkGI5ug: folds
L88dtdULfz5oGDSuo9/RvA collected $13 from pot
*** SUMMARY ***
Total pot $13 | Rake $0
Seat 1: l1bCLGuFqeFRwUfPsiDu/g (button) folded before Flop (didn't bet)
Seat 2: dJO4Wtu5e7hHBlpz0cmy1w (small blind) folded before Flop
Seat 3: L88dtdULfz5oGDSuo9/RvA (big blind) collected ($13)
Seat 5: Z3aYCZG/yXHYFjiWkGI5ug folded before Flop
Seat 6: M2ht6rIKOI/my9eh610Nlw folded before Flop (didn't bet)
Seat 7: n2VAbLaE5qgKr5mA4W6v4w folded before Flop (didn't bet)
Seat 8: 5iPk5MyO3KVu18Y8XCYfFQ folded before Flop (didn't bet)
Seat 9: O+jytCilwk7zItVCEavmtw folded before Flop (didn't bet)



PokerStars Game #59937925858:  Hold'em No Limit ($1/$2) - 2009/07/01 0:03:02 ET
Table 'ZzSIe0zTCDv+n6hfbY5tTg' 6-max Seat #2 is the button
Seat 1: 8srN1dKQePlsv0GyTada+Q ($215.70 in chips)
Seat 2: JQAf1Fiqbg0N8wNGA2nZhw ($200 in chips)
Seat 3: Y+MK4vQx233i+/aiP6js/Q ($350.20 in chips)
Seat 5: Q3uFdu6ztesjDFiqkagTRQ ($205.10 in chips)
Seat 6: 39260874 ($202.20 in chips)
Y+MK4vQx233i+/aiP6js/Q: posts small blind $1
Q3uFdu6ztesjDFiqkagTRQ: posts big blind $2
*** HOLE CARDS ***
39260874: folds
39260874 leaves the table
8srN1dKQePlsv0GyTada+Q: folds
JQAf1Fiqbg0N8wNGA2nZhw: folds
Y+MK4vQx233i+/aiP6js/Q: folds
Q3uFdu6ztesjDFiqkagTRQ collected $2 from pot
Q3uFdu6ztesjDFiqkagTRQ: doesn't show hand
*** SUMMARY ***
Total pot $2 | Rake $0
Seat 1: 8srN1dKQePlsv0GyTada+Q folded before Flop (didn't bet)
Seat 2: JQAf1Fiqbg0N8wNGA2nZhw (button) folded before Flop (didn't bet)
Seat 3: Y+MK4vQx233i+/aiP6js/Q (small blind) folded before Flop
Seat 5: Q3uFdu6ztesjDFiqkagTRQ (big blind) collected ($2)
Seat 6: 39260874 folded before Flop (didn't bet)



PokerStars Game #59937928122:  Hold'em No Limit ($1/$2) - 2009/07/01 0:03:05 ET
Table 'HewZCzVOYGmuLDKthTi5Yw' 6-max Seat #2 is the button
Seat 1: 353332 ($232.75 in chips)
Seat 2: X7GlkHF+lkbarCLuZ4Uf0w ($33 in chips)
Seat 3: WJxW31eStwT28R2X/L8F5A ($54.50 in chips)
Seat 4: yZgdnRylE65JbScQ7qCWgw ($38 in chips)
Seat 5: 513FcCI8jHyQy2VWoIQkMg ($371.50 in chips)
WJxW31eStwT28R2X/L8F5A: posts small blind $1
yZgdnRylE65JbScQ7qCWgw: posts big blind $2
*** HOLE CARDS ***
513FcCI8jHyQy2VWoIQkMg: folds
353332: folds
X7GlkHF+lkbarCLuZ4Uf0w: raises $2 to $4
WJxW31eStwT28R2X/L8F5A: folds
yZgdnRylE65JbScQ7qCWgw: folds
X7GlkHF+lkbarCLuZ4Uf0w collected $5 from pot
X7GlkHF+lkbarCLuZ4Uf0w: doesn't show hand
*** SUMMARY ***
Total pot $5 | Rake $0
Seat 1: 353332 folded before Flop (didn't bet)
Seat 2: X7GlkHF+lkbarCLuZ4Uf0w (button) collected ($5)
Seat 3: WJxW31eStwT28R2X/L8F5A (small blind) folded before Flop
Seat 4: yZgdnRylE65JbScQ7qCWgw (big blind) folded before Flop
Seat 5: 513FcCI8jHyQy2VWoIQkMg folded before Flop (didn't bet)



PokerStars Game #59937929682:  Hold'em No Limit ($1/$2) - 2009/07/01 0:03:07 ET
Table 'l5lZHc5JRHEDt0Y2AVPq3g' 6-max Seat #5 is the button
Seat 1: gGPaCoSWW1HoKYaqfAPecg ($206.30 in chips)
Seat 2: my38j/MmtBd/8qVwmyCREA ($213.40 in chips)
Seat 3: yZgdnRylE65JbScQ7qCWgw ($40 in chips)
Seat 4: zNjJ/y4emmF+vzrCDd+ooA ($205.05 in chips)
Seat 5: 6fLdOUCRtX71xbVRhJEq8w ($200 in chips)
Seat 6: vkfxu8f/jMYKUk6Ly4eujw ($200 in chips)
vkfxu8f/jMYKUk6Ly4eujw: posts small blind $1
gGPaCoSWW1HoKYaqfAPecg: posts big blind $2
*** HOLE CARDS ***
my38j/MmtBd/8qVwmyCREA: folds
yZgdnRylE65JbScQ7qCWgw: folds
zNjJ/y4emmF+vzrCDd+ooA: calls $2
6fLdOUCRtX71xbVRhJEq8w: folds
vkfxu8f/jMYKUk6Ly4eujw: raises $8 to $10
gGPaCoSWW1HoKYaqfAPecg: folds
zNjJ/y4emmF+vzrCDd+ooA: calls $8
*** FLOP *** [5d As 5c]
vkfxu8f/jMYKUk6Ly4eujw: bets $20
zNjJ/y4emmF+vzrCDd+ooA: folds
vkfxu8f/jMYKUk6Ly4eujw collected $20.90 from pot
vkfxu8f/jMYKUk6Ly4eujw: doesn't show hand
*** SUMMARY ***
Total pot $22 | Rake $1.10
Board [5d As 5c]
Seat 1: gGPaCoSWW1HoKYaqfAPecg (big blind) folded before Flop
Seat 2: my38j/MmtBd/8qVwmyCREA folded before Flop (didn't bet)
Seat 3: yZgdnRylE65JbScQ7qCWgw folded before Flop (didn't bet)
Seat 4: zNjJ/y4emmF+vzrCDd+ooA folded on the Flop
Seat 5: 6fLdOUCRtX71xbVRhJEq8w (button) folded before Flop (didn't bet)
Seat 6: vkfxu8f/jMYKUk6Ly4eujw (small blind) collected ($20.90)



PokerStars Game #59937930204:  Hold'em No Limit ($1/$2) - 2009/07/01 0:03:08 ET
Table 'LL4bDFyhj5hsMpzaDugJZg' 6-max Seat #5 is the button
Seat 1: IBW9lyGsaRmfcbyA/qFfEw ($81.20 in chips)
Seat 2: L3l+A4pJhOAD6HVVFXvVBw ($262.95 in chips)
Seat 3: gGPaCoSWW1HoKYaqfAPecg ($233 in chips)
Seat 4: 8srN1dKQePlsv0GyTada+Q ($231.60 in chips)
Seat 5: HgX0VeqE/dzSXd5BpntRBw ($200 in chips)
Seat 6: yZgdnRylE65JbScQ7qCWgw ($29 in chips)
yZgdnRylE65JbScQ7qCWgw: posts small blind $1
IBW9lyGsaRmfcbyA/qFfEw: posts big blind $2
*** HOLE CARDS ***
L3l+A4pJhOAD6HVVFXvVBw: raises $4 to $6
gGPaCoSWW1HoKYaqfAPecg: folds
8srN1dKQePlsv0GyTada+Q: calls $6
HgX0VeqE/dzSXd5BpntRBw: folds
yZgdnRylE65JbScQ7qCWgw: folds
IBW9lyGsaRmfcbyA/qFfEw: folds
*** FLOP *** [6c 5c 9s]
L3l+A4pJhOAD6HVVFXvVBw: bets $4
8srN1dKQePlsv0GyTada+Q: calls $4
*** TURN *** [6c 5c 9s] [Qs]
L3l+A4pJhOAD6HVVFXvVBw: bets $4
8srN1dKQePlsv0GyTada+Q: raises $8 to $12
L3l+A4pJhOAD6HVVFXvVBw: calls $8
*** RIVER *** [6c 5c 9s Qs] [8h]
L3l+A4pJhOAD6HVVFXvVBw: checks
8srN1dKQePlsv0GyTada+Q: checks
*** SHOW DOWN ***
L3l+A4pJhOAD6HVVFXvVBw: shows [Jd Kc] (high card King)
8srN1dKQePlsv0GyTada+Q: shows [Ah Qc] (a pair of Queens)
8srN1dKQePlsv0GyTada+Q collected $44.75 from pot
*** SUMMARY ***
Total pot $47 | Rake $2.25
Board [6c 5c 9s Qs 8h]
Seat 1: IBW9lyGsaRmfcbyA/qFfEw (big blind) folded before Flop
Seat 2: L3l+A4pJhOAD6HVVFXvVBw showed [Jd Kc] and lost with high card King
Seat 3: gGPaCoSWW1HoKYaqfAPecg folded before Flop (didn't bet)
Seat 4: 8srN1dKQePlsv0GyTada+Q showed [Ah Qc] and won ($44.75) with a pair of Queens
Seat 5: HgX0VeqE/dzSXd5BpntRBw (button) folded before Flop (didn't bet)
Seat 6: yZgdnRylE65JbScQ7qCWgw (small blind) folded before Flop



PokerStars Game #59937930354:  Hold'em No Limit ($1/$2) - 2009/07/01 0:03:08 ET
Table '3FGoiEOffWrbgTfsB3t7FA' 2-max Seat #2 is the button
Seat 1: e0oDWyrmgLpR6bROEqw1nQ ($457 in chips)
Seat 2: +sy/nlNI20yZraIjs4AALg ($149.75 in chips)
+sy/nlNI20yZraIjs4AALg: posts small blind $1
e0oDWyrmgLpR6bROEqw1nQ: posts big blind $2
*** HOLE CARDS ***
+sy/nlNI20yZraIjs4AALg: calls $1
e0oDWyrmgLpR6bROEqw1nQ: checks
*** FLOP *** [5c 9h Jd]
e0oDWyrmgLpR6bROEqw1nQ: checks
+sy/nlNI20yZraIjs4AALg: bets $6
e0oDWyrmgLpR6bROEqw1nQ: folds
+sy/nlNI20yZraIjs4AALg collected $3.80 from pot
*** SUMMARY ***
Total pot $4 | Rake $0.20
Board [5c 9h Jd]
Seat 1: e0oDWyrmgLpR6bROEqw1nQ (big blind) folded on the Flop
Seat 2: +sy/nlNI20yZraIjs4AALg (button) (small blind) collected ($3.80)



PokerStars Game #59937932658:  Hold'em No Limit ($1/$2) - 2009/07/01 0:03:11 ET
Table 'NmY84NAf9Mh0ckAckHnh5g' 2-max Seat #2 is the button
Seat 1: 6hvg964TSqZ3AL/0XK9aVQ ($350.20 in chips)
Seat 2: RwDoM55ZeQuI2ADyJhOb2Q ($248.50 in chips)
RwDoM55ZeQuI2ADyJhOb2Q: posts small blind $1
6hvg964TSqZ3AL/0XK9aVQ: posts big blind $2
*** HOLE CARDS ***
RwDoM55ZeQuI2ADyJhOb2Q: raises $4 to $6
6hvg964TSqZ3AL/0XK9aVQ: calls $4
*** FLOP *** [6h 4d 8d]
6hvg964TSqZ3AL/0XK9aVQ: checks
RwDoM55ZeQuI2ADyJhOb2Q: bets $8
6hvg964TSqZ3AL/0XK9aVQ: folds
RwDoM55ZeQuI2ADyJhOb2Q collected $11.50 from pot
RwDoM55ZeQuI2ADyJhOb2Q: doesn't show hand
*** SUMMARY ***
Total pot $12 | Rake $0.50
Board [6h 4d 8d]
Seat 1: 6hvg964TSqZ3AL/0XK9aVQ (big blind) folded on the Flop
Seat 2: RwDoM55ZeQuI2ADyJhOb2Q (button) (small blind) collected ($11.50)



PokerStars Game #59937932888:  Hold'em No Limit ($1/$2) - 2009/07/01 0:03:11 ET
Table 'XP2sRSup+aRuwzx3vDZsDg' 6-max Seat #4 is the button
Seat 2: yZgdnRylE65JbScQ7qCWgw ($40 in chips)
Seat 3: X7GlkHF+lkbarCLuZ4Uf0w ($33.50 in chips)
Seat 4: JsC+WvfzqlxVs9G8/gSQAQ ($109.75 in chips)
Seat 5: vkfxu8f/jMYKUk6Ly4eujw ($198 in chips)
Seat 6: h7ppRQJTYBsHCbLMeW9T2g ($496.75 in chips)
vkfxu8f/jMYKUk6Ly4eujw: posts small blind $1
h7ppRQJTYBsHCbLMeW9T2g: posts big blind $2
o9jamqIi6sTTRSqudgboRA: sits out
*** HOLE CARDS ***
yZgdnRylE65JbScQ7qCWgw: folds
X7GlkHF+lkbarCLuZ4Uf0w: folds
JsC+WvfzqlxVs9G8/gSQAQ: folds
vkfxu8f/jMYKUk6Ly4eujw: raises $6 to $8
h7ppRQJTYBsHCbLMeW9T2g: folds
vkfxu8f/jMYKUk6Ly4eujw collected $4 from pot
*** SUMMARY ***
Total pot $4 | Rake $0
Seat 2: yZgdnRylE65JbScQ7qCWgw folded before Flop (didn't bet)
Seat 3: X7GlkHF+lkbarCLuZ4Uf0w folded before Flop (didn't bet)
Seat 4: JsC+WvfzqlxVs9G8/gSQAQ (button) folded before Flop (didn't bet)
Seat 5: vkfxu8f/jMYKUk6Ly4eujw (small blind) collected ($4)
Seat 6: h7ppRQJTYBsHCbLMeW9T2g (big blind) folded before Flop



PokerStars Game #59937933240:  Hold'em No Limit ($1/$2) - 2009/07/01 0:03:12 ET
Table 'eyAQSIlgc2o1Jxvbve4WGg' 9-max Seat #1 is the button
Seat 1: Q3uFdu6ztesjDFiqkagTRQ ($237 in chips)
Seat 2: GX1heJ+DSsvm7gzSPsYhhQ ($40 in chips)
Seat 3: TAfo4veNRaRlzDXMMYS3Jg ($40 in chips)
Seat 4: Lr5OlNr2kebm3oHSC54eJg ($98.65 in chips)
Seat 5: rW/MyplHylMSBRaoRUzWrg ($103.70 in chips)
Seat 6: IikcENBHwoT7snSvBPSc7Q ($189.85 in chips)
Seat 7: QHxJjpVYwitg9krW6wZgJA ($200 in chips)
Seat 8: 5iPk5MyO3KVu18Y8XCYfFQ ($39 in chips)
Seat 9: Hc2itIxwbi1lwa+DAYYQGg ($50.85 in chips)
GX1heJ+DSsvm7gzSPsYhhQ: posts small blind $1
TAfo4veNRaRlzDXMMYS3Jg: posts big blind $2
*** HOLE CARDS ***
Lr5OlNr2kebm3oHSC54eJg: folds
rW/MyplHylMSBRaoRUzWrg: folds
IikcENBHwoT7snSvBPSc7Q: calls $2
QHxJjpVYwitg9krW6wZgJA: raises $8 to $10
5iPk5MyO3KVu18Y8XCYfFQ: folds
Hc2itIxwbi1lwa+DAYYQGg: folds
Q3uFdu6ztesjDFiqkagTRQ: folds
GX1heJ+DSsvm7gzSPsYhhQ: folds
TAfo4veNRaRlzDXMMYS3Jg: folds
IikcENBHwoT7snSvBPSc7Q: folds
QHxJjpVYwitg9krW6wZgJA collected $7 from pot
QHxJjpVYwitg9krW6wZgJA: doesn't show hand
*** SUMMARY ***
Total pot $7 | Rake $0
Seat 1: Q3uFdu6ztesjDFiqkagTRQ (button) folded before Flop (didn't bet)
Seat 2: GX1heJ+DSsvm7gzSPsYhhQ (small blind) folded before Flop
Seat 3: TAfo4veNRaRlzDXMMYS3Jg (big blind) folded before Flop
Seat 4: Lr5OlNr2kebm3oHSC54eJg folded before Flop (didn't bet)
Seat 5: rW/MyplHylMSBRaoRUzWrg folded before Flop (didn't bet)
Seat 6: IikcENBHwoT7snSvBPSc7Q folded before Flop
Seat 7: QHxJjpVYwitg9krW6wZgJA collected ($7)
Seat 8: 5iPk5MyO3KVu18Y8XCYfFQ folded before Flop (didn't bet)
Seat 9: Hc2itIxwbi1lwa+DAYYQGg folded before Flop (didn't bet)



PokerStars Game #59937936408:  Hold'em No Limit ($1/$2) - 2009/07/01 0:03:16 ET
Table 'bJQ024BaYSBrW0sXpCZbNQ' 6-max Seat #6 is the button
Seat 1: yZgdnRylE65JbScQ7qCWgw ($35 in chips)
Seat 2: 1njbh8TKSUF6l4V1XwGdcg ($251.40 in chips)
Seat 3: vkfxu8f/jMYKUk6Ly4eujw ($214.30 in chips)
Seat 4: 9ni/OEXAqfc58zPQ0Tu9rQ ($281.05 in chips)
Seat 5: X7GlkHF+lkbarCLuZ4Uf0w ($41.15 in chips)
Seat 6: 9dpyyjDTCed6nV7JhaUUpw ($212.50 in chips)
yZgdnRylE65JbScQ7qCWgw: posts small blind $1
1njbh8TKSUF6l4V1XwGdcg: posts big blind $2
*** HOLE CARDS ***
vkfxu8f/jMYKUk6Ly4eujw: raises $4 to $6
9ni/OEXAqfc58zPQ0Tu9rQ: calls $6
X7GlkHF+lkbarCLuZ4Uf0w: folds
9dpyyjDTCed6nV7JhaUUpw: folds
yZgdnRylE65JbScQ7qCWgw: folds
1njbh8TKSUF6l4V1XwGdcg: calls $4
*** FLOP *** [As Ad Ah]
1njbh8TKSUF6l4V1XwGdcg: checks
vkfxu8f/jMYKUk6Ly4eujw: bets $18
9ni/OEXAqfc58zPQ0Tu9rQ: calls $18
1njbh8TKSUF6l4V1XwGdcg: folds
*** TURN *** [As Ad Ah] [Kd]
vkfxu8f/jMYKUk6Ly4eujw: bets $52
9ni/OEXAqfc58zPQ0Tu9rQ: folds
vkfxu8f/jMYKUk6Ly4eujw collected $52.30 from pot
vkfxu8f/jMYKUk6Ly4eujw: doesn't show hand
*** SUMMARY ***
Total pot $55 | Rake $2.70
Board [As Ad Ah Kd]
Seat 1: yZgdnRylE65JbScQ7qCWgw (small blind) folded before Flop
Seat 2: 1njbh8TKSUF6l4V1XwGdcg (big blind) folded on the Flop
Seat 3: vkfxu8f/jMYKUk6Ly4eujw collected ($52.30)
Seat 4: 9ni/OEXAqfc58zPQ0Tu9rQ folded on the Turn
Seat 5: X7GlkHF+lkbarCLuZ4Uf0w folded before Flop (didn't bet)
Seat 6: 9dpyyjDTCed6nV7JhaUUpw (button) folded before Flop (didn't bet)



PokerStars Game #59937937440:  Hold'em No Limit ($1/$2) - 2009/07/01 0:03:18 ET
Table 'pPQgcj9XT9CHBsbo1WTBug' 6-max Seat #3 is the button
Seat 1: DFVYDA6dKQy7R7mGIKogZA ($115.90 in chips)
Seat 3: vkfxu8f/jMYKUk6Ly4eujw ($196 in chips)
Seat 5: 4Cl43Q1TYQL8wn1NSCUkaw ($65.60 in chips)
Seat 6: yZgdnRylE65JbScQ7qCWgw ($28 in chips)
4Cl43Q1TYQL8wn1NSCUkaw: posts small blind $1
yZgdnRylE65JbScQ7qCWgw: posts big blind $2
X7GlkHF+lkbarCLuZ4Uf0w: sits out
*** HOLE CARDS ***
DFVYDA6dKQy7R7mGIKogZA: folds
vkfxu8f/jMYKUk6Ly4eujw: folds
4Cl43Q1TYQL8wn1NSCUkaw: calls $1
yZgdnRylE65JbScQ7qCWgw: raises $12 to $14
4Cl43Q1TYQL8wn1NSCUkaw: folds
yZgdnRylE65JbScQ7qCWgw collected $4 from pot
*** SUMMARY ***
Total pot $4 | Rake $0
Seat 1: DFVYDA6dKQy7R7mGIKogZA folded before Flop (didn't bet)
Seat 3: vkfxu8f/jMYKUk6Ly4eujw (button) folded before Flop (didn't bet)
Seat 5: 4Cl43Q1TYQL8wn1NSCUkaw (small blind) folded before Flop
Seat 6: yZgdnRylE65JbScQ7qCWgw (big blind) collected ($4)



PokerStars Game #59937938418:  Hold'em No Limit ($1/$2) - 2009/07/01 0:03:19 ET
Table 'ZzSIe0zTCDv+n6hfbY5tTg' 6-max Seat #3 is the button
Seat 1: 8srN1dKQePlsv0GyTada+Q ($215.70 in chips)
Seat 2: JQAf1Fiqbg0N8wNGA2nZhw ($200 in chips)
Seat 3: Y+MK4vQx233i+/aiP6js/Q ($349.20 in chips)
Seat 5: Q3uFdu6ztesjDFiqkagTRQ ($206.10 in chips)
Q3uFdu6ztesjDFiqkagTRQ: posts small blind $1
8srN1dKQePlsv0GyTada+Q: posts big blind $2
*** HOLE CARDS ***
JQAf1Fiqbg0N8wNGA2nZhw: folds
Y+MK4vQx233i+/aiP6js/Q: raises $4 to $6
Q3uFdu6ztesjDFiqkagTRQ: folds
8srN1dKQePlsv0GyTada+Q: folds
Y+MK4vQx233i+/aiP6js/Q collected $5 from pot
Y+MK4vQx233i+/aiP6js/Q: doesn't show hand
*** SUMMARY ***
Total pot $5 | Rake $0
Seat 1: 8srN1dKQePlsv0GyTada+Q (big blind) folded before Flop
Seat 2: JQAf1Fiqbg0N8wNGA2nZhw folded before Flop (didn't bet)
Seat 3: Y+MK4vQx233i+/aiP6js/Q (button) collected ($5)
Seat 5: Q3uFdu6ztesjDFiqkagTRQ (small blind) folded before Flop



PokerStars Game #59937941230:  Hold'em No Limit ($1/$2) - 2009/07/01 0:03:23 ET
Table 'uJ9juaXXg9yIcSU8amxaXQ' 6-max Seat #2 is the button
Seat 1: HhIxv6mylwCAfv3sjJmq5g ($200 in chips)
Seat 2: DQlskgG4OtLpF2MVxLwf4A ($284.05 in chips)
Seat 3: zaogaltCDFVsIASEnrXs2w ($257.75 in chips)
Seat 4: 54yWzRRgS0oZ+S6LwZBxMQ ($40 in chips)
Seat 5: F/075N6nU34Fn0zr6qD3aw ($233.05 in chips)
Seat 6: XrFG4dK06RVKLlX32/pjcQ ($39.70 in chips)
zaogaltCDFVsIASEnrXs2w: posts small blind $1
54yWzRRgS0oZ+S6LwZBxMQ: posts big blind $2
*** HOLE CARDS ***
F/075N6nU34Fn0zr6qD3aw: folds
XrFG4dK06RVKLlX32/pjcQ: calls $2
HhIxv6mylwCAfv3sjJmq5g: raises $5 to $7
DQlskgG4OtLpF2MVxLwf4A: folds
zaogaltCDFVsIASEnrXs2w: folds
54yWzRRgS0oZ+S6LwZBxMQ: folds
XrFG4dK06RVKLlX32/pjcQ: calls $5
*** FLOP *** [Qs 6d Kd]
XrFG4dK06RVKLlX32/pjcQ: bets $10
F/075N6nU34Fn0zr6qD3aw leaves the table
X7GlkHF+lkbarCLuZ4Uf0w joins the table at seat #5
HhIxv6mylwCAfv3sjJmq5g: raises $10 to $20
XrFG4dK06RVKLlX32/pjcQ: raises $10 to $30
HhIxv6mylwCAfv3sjJmq5g: raises $10 to $40
XrFG4dK06RVKLlX32/pjcQ: calls $2.70 and is all-in
*** TURN *** [Qs 6d Kd] [Ts]
*** RIVER *** [Qs 6d Kd Ts] [3s]
*** SHOW DOWN ***
XrFG4dK06RVKLlX32/pjcQ: shows [Jc Ah] (a straight, Ten to Ace)
HhIxv6mylwCAfv3sjJmq5g: mucks hand
XrFG4dK06RVKLlX32/pjcQ collected $79.40 from pot
*** SUMMARY ***
Total pot $82.40 | Rake $3
Board [Qs 6d Kd Ts 3s]
Seat 1: HhIxv6mylwCAfv3sjJmq5g mucked
Seat 2: DQlskgG4OtLpF2MVxLwf4A (button) folded before Flop (didn't bet)
Seat 3: zaogaltCDFVsIASEnrXs2w (small blind) folded before Flop
Seat 4: 54yWzRRgS0oZ+S6LwZBxMQ (big blind) folded before Flop
Seat 5: F/075N6nU34Fn0zr6qD3aw folded before Flop (didn't bet)
Seat 6: XrFG4dK06RVKLlX32/pjcQ showed [Jc Ah] and won ($79.40) with a straight, Ten to Ace



PokerStars Game #59937942830:  Hold'em No Limit ($1/$2) - 2009/07/01 0:03:25 ET
Table 'HewZCzVOYGmuLDKthTi5Yw' 6-max Seat #3 is the button
Seat 1: 353332 ($232.75 in chips)
Seat 2: X7GlkHF+lkbarCLuZ4Uf0w ($36 in chips)
Seat 3: WJxW31eStwT28R2X/L8F5A ($53.50 in chips)
Seat 4: yZgdnRylE65JbScQ7qCWgw ($36 in chips)
Seat 5: 513FcCI8jHyQy2VWoIQkMg ($371.50 in chips)
yZgdnRylE65JbScQ7qCWgw: posts small blind $1
513FcCI8jHyQy2VWoIQkMg: posts big blind $2
*** HOLE CARDS ***
353332: raises $6 to $8
X7GlkHF+lkbarCLuZ4Uf0w: folds
WJxW31eStwT28R2X/L8F5A: folds
yZgdnRylE65JbScQ7qCWgw: folds
513FcCI8jHyQy2VWoIQkMg: folds
353332 collected $5 from pot
353332: doesn't show hand
*** SUMMARY ***
Total pot $5 | Rake $0
Seat 1: 353332 collected ($5)
Seat 2: X7GlkHF+lkbarCLuZ4Uf0w folded before Flop (didn't bet)
Seat 3: WJxW31eStwT28R2X/L8F5A (button) folded before Flop (didn't bet)
Seat 4: yZgdnRylE65JbScQ7qCWgw (small blind) folded before Flop
Seat 5: 513FcCI8jHyQy2VWoIQkMg (big blind) folded before Flop



PokerStars Game #59937944278:  Hold'em No Limit ($1/$2) - 2009/07/01 0:03:27 ET
Table 'NmY84NAf9Mh0ckAckHnh5g' 2-max Seat #1 is the button
Seat 1: 6hvg964TSqZ3AL/0XK9aVQ ($344.20 in chips)
Seat 2: RwDoM55ZeQuI2ADyJhOb2Q ($254 in chips)
6hvg964TSqZ3AL/0XK9aVQ: posts small blind $1
RwDoM55ZeQuI2ADyJhOb2Q: posts big blind $2
*** HOLE CARDS ***
6hvg964TSqZ3AL/0XK9aVQ: folds
RwDoM55ZeQuI2ADyJhOb2Q collected $2 from pot
RwDoM55ZeQuI2ADyJhOb2Q: doesn't show hand
*** SUMMARY ***
Total pot $2 | Rake $0
Seat 1: 6hvg964TSqZ3AL/0XK9aVQ (button) (small blind) folded before Flop
Seat 2: RwDoM55ZeQuI2ADyJhOb2Q (big blind) collected ($2)



PokerStars Game #59937946446:  Hold'em No Limit ($1/$2) - 2009/07/01 0:03:30 ET
Table '3FGoiEOffWrbgTfsB3t7FA' 2-max Seat #1 is the button
Seat 1: e0oDWyrmgLpR6bROEqw1nQ ($455 in chips)
Seat 2: +sy/nlNI20yZraIjs4AALg ($151.55 in chips)
e0oDWyrmgLpR6bROEqw1nQ: posts small blind $1
+sy/nlNI20yZraIjs4AALg: posts big blind $2
*** HOLE CARDS ***
e0oDWyrmgLpR6bROEqw1nQ: folds
+sy/nlNI20yZraIjs4AALg collected $2 from pot
*** SUMMARY ***
Total pot $2 | Rake $0
Seat 1: e0oDWyrmgLpR6bROEqw1nQ (button) (small blind) folded before Flop
Seat 2: +sy/nlNI20yZraIjs4AALg (big blind) collected ($2)



PokerStars Game #59937948204:  Hold'em No Limit ($1/$2) - 2009/07/01 0:03:32 ET
Table 'fe+AlpfadsfwxhZEvYFbbA' 6-max Seat #6 is the button
Seat 1: SLlqn2PPbQqwfcLfYqUXrw ($79.45 in chips)
Seat 2: /PH6Ffnho4Ysm8S3V/oa+w ($40 in chips)
Seat 3: 54yWzRRgS0oZ+S6LwZBxMQ ($59.30 in chips)
Seat 5: gGPaCoSWW1HoKYaqfAPecg ($200 in chips)
Seat 6: 5Y+ZGWLI4gnlpApDX5vy1A ($207.55 in chips)
SLlqn2PPbQqwfcLfYqUXrw: posts small blind $1
/PH6Ffnho4Ysm8S3V/oa+w: posts big blind $2
*** HOLE CARDS ***
54yWzRRgS0oZ+S6LwZBxMQ: folds
gGPaCoSWW1HoKYaqfAPecg: folds
5Y+ZGWLI4gnlpApDX5vy1A: raises $2 to $4
SLlqn2PPbQqwfcLfYqUXrw: folds
/PH6Ffnho4Ysm8S3V/oa+w: folds
5Y+ZGWLI4gnlpApDX5vy1A collected $5 from pot
5Y+ZGWLI4gnlpApDX5vy1A: doesn't show hand
*** SUMMARY ***
Total pot $5 | Rake $0
Seat 1: SLlqn2PPbQqwfcLfYqUXrw (small blind) folded before Flop
Seat 2: /PH6Ffnho4Ysm8S3V/oa+w (big blind) folded before Flop
Seat 3: 54yWzRRgS0oZ+S6LwZBxMQ folded before Flop (didn't bet)
Seat 5: gGPaCoSWW1HoKYaqfAPecg folded before Flop (didn't bet)
Seat 6: 5Y+ZGWLI4gnlpApDX5vy1A (button) collected ($5)



PokerStars Game #59937948466:  Hold'em No Limit ($1/$2) - 2009/07/01 0:03:33 ET
Table 'aSf77Sj8QEnzcc0WaxVD4Q' 6-max Seat #2 is the button
Seat 1: Q3uFdu6ztesjDFiqkagTRQ ($200 in chips)
Seat 2: vkfxu8f/jMYKUk6Ly4eujw ($204.75 in chips)
Seat 3: 9dpyyjDTCed6nV7JhaUUpw ($221.05 in chips)
Seat 4: 513FcCI8jHyQy2VWoIQkMg ($212.60 in chips)
Seat 5: InmkdI6G8TzSj9NhcCSyPg ($269 in chips)
Seat 6: vkoJRf3gidxY1pPi0AFWww ($313.80 in chips)
9dpyyjDTCed6nV7JhaUUpw: posts small blind $1
513FcCI8jHyQy2VWoIQkMg: posts big blind $2
*** HOLE CARDS ***
InmkdI6G8TzSj9NhcCSyPg: folds
vkoJRf3gidxY1pPi0AFWww: folds
Q3uFdu6ztesjDFiqkagTRQ: folds
vkfxu8f/jMYKUk6Ly4eujw: folds
9dpyyjDTCed6nV7JhaUUpw: folds
513FcCI8jHyQy2VWoIQkMg collected $2 from pot
*** SUMMARY ***
Total pot $2 | Rake $0
Seat 1: Q3uFdu6ztesjDFiqkagTRQ folded before Flop (didn't bet)
Seat 2: vkfxu8f/jMYKUk6Ly4eujw (button) folded before Flop (didn't bet)
Seat 3: 9dpyyjDTCed6nV7JhaUUpw (small blind) folded before Flop
Seat 4: 513FcCI8jHyQy2VWoIQkMg (big blind) collected ($2)
Seat 5: InmkdI6G8TzSj9NhcCSyPg folded before Flop (didn't bet)
Seat 6: vkoJRf3gidxY1pPi0AFWww folded before Flop (didn't bet)



PokerStars Game #59937949056:  Hold'em No Limit ($1/$2) - 2009/07/01 0:03:34 ET
Table 'on4i1U1lCRmxsduFD3xiSg' 9-max Seat #3 is the button
Seat 1: BRHGptvmY2GKq4uuj7duDw ($276.60 in chips)
Seat 2: yZYrOeNDxQxkzpbgKX1bng ($64 in chips)
Seat 3: 5iPk5MyO3KVu18Y8XCYfFQ ($64.20 in chips)
Seat 4: Z3aYCZG/yXHYFjiWkGI5ug ($205.30 in chips)
Seat 5: QHxJjpVYwitg9krW6wZgJA ($200 in chips)
Seat 6: SB0tvOX0Kw61r2U851JFaA ($403.20 in chips)
Seat 7: xD4ElYxz6Ollzmam8BmMCw ($249.25 in chips)
Seat 8: YlSX2xwu8QMQReaxSAD8XA ($164.85 in chips)
Seat 9: iMe5yhc+1BaiIPHet3NMrA ($203 in chips)
Z3aYCZG/yXHYFjiWkGI5ug: posts small blind $1
QHxJjpVYwitg9krW6wZgJA: posts big blind $2
*** HOLE CARDS ***
SB0tvOX0Kw61r2U851JFaA: folds
xD4ElYxz6Ollzmam8BmMCw: calls $2
YlSX2xwu8QMQReaxSAD8XA: calls $2
iMe5yhc+1BaiIPHet3NMrA: folds
BRHGptvmY2GKq4uuj7duDw: folds
yZYrOeNDxQxkzpbgKX1bng: folds
5iPk5MyO3KVu18Y8XCYfFQ: folds
Z3aYCZG/yXHYFjiWkGI5ug: calls $1
QHxJjpVYwitg9krW6wZgJA: checks
*** FLOP *** [Qs 3s 7c]
Z3aYCZG/yXHYFjiWkGI5ug: checks
QHxJjpVYwitg9krW6wZgJA: checks
xD4ElYxz6Ollzmam8BmMCw: checks
YlSX2xwu8QMQReaxSAD8XA: bets $4
Z3aYCZG/yXHYFjiWkGI5ug: calls $4
QHxJjpVYwitg9krW6wZgJA: folds
xD4ElYxz6Ollzmam8BmMCw: folds
*** TURN *** [Qs 3s 7c] [Ac]
Z3aYCZG/yXHYFjiWkGI5ug: checks
YlSX2xwu8QMQReaxSAD8XA: bets $10
Z3aYCZG/yXHYFjiWkGI5ug: calls $10
*** RIVER *** [Qs 3s 7c Ac] [5h]
Z3aYCZG/yXHYFjiWkGI5ug: checks
YlSX2xwu8QMQReaxSAD8XA: checks
*** SHOW DOWN ***
Z3aYCZG/yXHYFjiWkGI5ug: shows [9s Qd] (a pair of Queens)
YlSX2xwu8QMQReaxSAD8XA: mucks hand
Z3aYCZG/yXHYFjiWkGI5ug collected $34.25 from pot
*** SUMMARY ***
Total pot $36 | Rake $1.75
Board [Qs 3s 7c Ac 5h]
Seat 1: BRHGptvmY2GKq4uuj7duDw folded before Flop (didn't bet)
Seat 2: yZYrOeNDxQxkzpbgKX1bng folded before Flop (didn't bet)
Seat 3: 5iPk5MyO3KVu18Y8XCYfFQ (button) folded before Flop (didn't bet)
Seat 4: Z3aYCZG/yXHYFjiWkGI5ug (small blind) showed [9s Qd] and won ($34.25) with a pair of Queens
Seat 5: QHxJjpVYwitg9krW6wZgJA (big blind) folded on the Flop
Seat 6: SB0tvOX0Kw61r2U851JFaA folded before Flop (didn't bet)
Seat 7: xD4ElYxz6Ollzmam8BmMCw folded on the Flop
Seat 8: YlSX2xwu8QMQReaxSAD8XA mucked
Seat 9: iMe5yhc+1BaiIPHet3NMrA folded before Flop (didn't bet)



PokerStars Game #59937949734:  Hold'em No Limit ($1/$2) - 2009/07/01 0:03:35 ET
Table 'WCA60bDA8ecovUgFSIZkTQ' 9-max Seat #4 is the button
Seat 1: xNLmepWbCljNEEeH8O5jSg ($266.65 in chips)
Seat 2: G1h8wamBcVJXtsKXZQ2EyA ($84.70 in chips)
Seat 3: 5iPk5MyO3KVu18Y8XCYfFQ ($40 in chips)
Seat 4: Q3uFdu6ztesjDFiqkagTRQ ($484.70 in chips)
Seat 5: Hc2itIxwbi1lwa+DAYYQGg ($310.30 in chips)
Seat 6: DOWQSOJ7GaX+ksfWTqPT5A ($198.75 in chips)
Seat 7: GX1heJ+DSsvm7gzSPsYhhQ ($34 in chips)
Seat 8: x+V1JgVDawsJTxKcxm7gxw ($100 in chips)
Seat 9: 3q2/0oJr3Mcy1W5tcN61ug ($301.20 in chips)
Hc2itIxwbi1lwa+DAYYQGg: posts small blind $1
DOWQSOJ7GaX+ksfWTqPT5A: posts big blind $2
*** HOLE CARDS ***
GX1heJ+DSsvm7gzSPsYhhQ: folds
x+V1JgVDawsJTxKcxm7gxw: folds
3q2/0oJr3Mcy1W5tcN61ug: folds
xNLmepWbCljNEEeH8O5jSg: folds
G1h8wamBcVJXtsKXZQ2EyA: folds
5iPk5MyO3KVu18Y8XCYfFQ: folds
Q3uFdu6ztesjDFiqkagTRQ: folds
Hc2itIxwbi1lwa+DAYYQGg: folds
DOWQSOJ7GaX+ksfWTqPT5A collected $2 from pot
DOWQSOJ7GaX+ksfWTqPT5A: doesn't show hand
*** SUMMARY ***
Total pot $2 | Rake $0
Seat 1: xNLmepWbCljNEEeH8O5jSg folded before Flop (didn't bet)
Seat 2: G1h8wamBcVJXtsKXZQ2EyA folded before Flop (didn't bet)
Seat 3: 5iPk5MyO3KVu18Y8XCYfFQ folded before Flop (didn't bet)
Seat 4: Q3uFdu6ztesjDFiqkagTRQ (button) folded before Flop (didn't bet)
Seat 5: Hc2itIxwbi1lwa+DAYYQGg (small blind) folded before Flop
Seat 6: DOWQSOJ7GaX+ksfWTqPT5A (big blind) collected ($2)
Seat 7: GX1heJ+DSsvm7gzSPsYhhQ folded before Flop (didn't bet)
Seat 8: x+V1JgVDawsJTxKcxm7gxw folded before Flop (didn't bet)
Seat 9: 3q2/0oJr3Mcy1W5tcN61ug folded before Flop (didn't bet)



PokerStars Game #59937950090:  Hold'em No Limit ($1/$2) - 2009/07/01 0:03:35 ET
Table 'rsKRKlGHlxVyqJxzO2a2Ow' 9-max Seat #3 is the button
Seat 1: uYWfQJg2hgHLxri6/uVJiw ($162.40 in chips)
Seat 2: QHxJjpVYwitg9krW6wZgJA ($244 in chips)
Seat 3: 9sYbXdhj1M2bwKrVNxj5+Q ($71.80 in chips)
Seat 4: zJtQ1gxyi72XvGYS1tM+DA ($39.15 in chips)
Seat 5: 5Q8U6iZbeO7xJSS4qvDP5g ($200 in chips)
Seat 6: H6Z4+qu8gR0VUiPOijndVg ($200 in chips)
Seat 7: kVCeGJ4NY7Fb0W74j1mAqA ($200 in chips)
Seat 8: Hc2itIxwbi1lwa+DAYYQGg ($40 in chips)
Seat 9: 5iPk5MyO3KVu18Y8XCYfFQ ($96.20 in chips)
zJtQ1gxyi72XvGYS1tM+DA: posts small blind $1
5Q8U6iZbeO7xJSS4qvDP5g: posts big blind $2
*** HOLE CARDS ***
H6Z4+qu8gR0VUiPOijndVg: folds
kVCeGJ4NY7Fb0W74j1mAqA: folds
Hc2itIxwbi1lwa+DAYYQGg: folds
5iPk5MyO3KVu18Y8XCYfFQ: folds
uYWfQJg2hgHLxri6/uVJiw: raises $4 to $6
QHxJjpVYwitg9krW6wZgJA: folds
9sYbXdhj1M2bwKrVNxj5+Q: folds
zJtQ1gxyi72XvGYS1tM+DA: folds
5Q8U6iZbeO7xJSS4qvDP5g: folds
uYWfQJg2hgHLxri6/uVJiw collected $5 from pot
*** SUMMARY ***
Total pot $5 | Rake $0
Seat 1: uYWfQJg2hgHLxri6/uVJiw collected ($5)
Seat 2: QHxJjpVYwitg9krW6wZgJA folded before Flop (didn't bet)
Seat 3: 9sYbXdhj1M2bwKrVNxj5+Q (button) folded before Flop (didn't bet)
Seat 4: zJtQ1gxyi72XvGYS1tM+DA (small blind) folded before Flop
Seat 5: 5Q8U6iZbeO7xJSS4qvDP5g (big blind) folded before Flop
Seat 6: H6Z4+qu8gR0VUiPOijndVg folded before Flop (didn't bet)
Seat 7: kVCeGJ4NY7Fb0W74j1mAqA folded before Flop (didn't bet)
Seat 8: Hc2itIxwbi1lwa+DAYYQGg folded before Flop (didn't bet)
Seat 9: 5iPk5MyO3KVu18Y8XCYfFQ folded before Flop (didn't bet)



PokerStars Game #59937950262:  Hold'em No Limit ($1/$2) - 2009/07/01 0:03:35 ET
Table 'SF49/KQm8T4taMp6kb+HXA' 9-max Seat #2 is the button
Seat 1: l1bCLGuFqeFRwUfPsiDu/g ($193.95 in chips)
Seat 2: dJO4Wtu5e7hHBlpz0cmy1w ($71.20 in chips)
Seat 3: L88dtdULfz5oGDSuo9/RvA ($43.05 in chips)
Seat 5: Z3aYCZG/yXHYFjiWkGI5ug ($230.55 in chips)
Seat 6: M2ht6rIKOI/my9eh610Nlw ($250.45 in chips)
Seat 7: n2VAbLaE5qgKr5mA4W6v4w ($56.50 in chips)
Seat 8: 5iPk5MyO3KVu18Y8XCYfFQ ($39 in chips)
Seat 9: O+jytCilwk7zItVCEavmtw ($120.25 in chips)
L88dtdULfz5oGDSuo9/RvA: posts small blind $1
Z3aYCZG/yXHYFjiWkGI5ug: posts big blind $2
*** HOLE CARDS ***
M2ht6rIKOI/my9eh610Nlw: folds
n2VAbLaE5qgKr5mA4W6v4w: calls $2
5iPk5MyO3KVu18Y8XCYfFQ: folds
O+jytCilwk7zItVCEavmtw: calls $2
l1bCLGuFqeFRwUfPsiDu/g: calls $2
dJO4Wtu5e7hHBlpz0cmy1w: folds
L88dtdULfz5oGDSuo9/RvA: calls $1
Z3aYCZG/yXHYFjiWkGI5ug: checks
*** FLOP *** [2h 9c Ts]
L88dtdULfz5oGDSuo9/RvA: checks
Z3aYCZG/yXHYFjiWkGI5ug: checks
n2VAbLaE5qgKr5mA4W6v4w: checks
O+jytCilwk7zItVCEavmtw: bets $8
l1bCLGuFqeFRwUfPsiDu/g: calls $8
L88dtdULfz5oGDSuo9/RvA: folds
Z3aYCZG/yXHYFjiWkGI5ug: folds
n2VAbLaE5qgKr5mA4W6v4w: folds
*** TURN *** [2h 9c Ts] [4s]
n2VAbLaE5qgKr5mA4W6v4w is sitting out
O+jytCilwk7zItVCEavmtw: bets $16
l1bCLGuFqeFRwUfPsiDu/g: folds
O+jytCilwk7zItVCEavmtw collected $24.75 from pot
*** SUMMARY ***
Total pot $26 | Rake $1.25
Board [2h 9c Ts 4s]
Seat 1: l1bCLGuFqeFRwUfPsiDu/g folded on the Turn
Seat 2: dJO4Wtu5e7hHBlpz0cmy1w (button) folded before Flop (didn't bet)
Seat 3: L88dtdULfz5oGDSuo9/RvA (small blind) folded on the Flop
Seat 5: Z3aYCZG/yXHYFjiWkGI5ug (big blind) folded on the Flop
Seat 6: M2ht6rIKOI/my9eh610Nlw folded before Flop (didn't bet)
Seat 7: n2VAbLaE5qgKr5mA4W6v4w folded on the Flop
Seat 8: 5iPk5MyO3KVu18Y8XCYfFQ folded before Flop (didn't bet)
Seat 9: O+jytCilwk7zItVCEavmtw collected ($24.75)



PokerStars Game #59937949774:  Hold'em No Limit ($1/$2) - 2009/07/01 0:03:35 ET
Table 'jlrIxbrVIG+gjaUYT4za8g' 6-max Seat #2 is the button
Seat 1: ygTTt5ehT4aF86q1a8/R+w ($176.35 in chips)
Seat 2: N18PrNGQj43J7TJuQuu+tw ($156.05 in chips)
Seat 3: /PH6Ffnho4Ysm8S3V/oa+w ($40 in chips)
Seat 4: 8srN1dKQePlsv0GyTada+Q ($203 in chips)
Seat 5: F/075N6nU34Fn0zr6qD3aw ($171.55 in chips)
Seat 6: vkfxu8f/jMYKUk6Ly4eujw ($274.05 in chips)
/PH6Ffnho4Ysm8S3V/oa+w: posts small blind $1
8srN1dKQePlsv0GyTada+Q: posts big blind $2
*** HOLE CARDS ***
F/075N6nU34Fn0zr6qD3aw: folds
vkfxu8f/jMYKUk6Ly4eujw: raises $6 to $8
ygTTt5ehT4aF86q1a8/R+w: folds
N18PrNGQj43J7TJuQuu+tw: calls $8
/PH6Ffnho4Ysm8S3V/oa+w: raises $32 to $40 and is all-in
8srN1dKQePlsv0GyTada+Q: folds
vkfxu8f/jMYKUk6Ly4eujw: calls $32
N18PrNGQj43J7TJuQuu+tw: folds
*** FLOP *** [5s Ts 4s]
*** TURN *** [5s Ts 4s] [7c]
*** RIVER *** [5s Ts 4s 7c] [Js]
*** SHOW DOWN ***
/PH6Ffnho4Ysm8S3V/oa+w: shows [Qh Ac] (high card Ace)
vkfxu8f/jMYKUk6Ly4eujw: shows [Ad Kc] (high card Ace - King kicker)
vkfxu8f/jMYKUk6Ly4eujw collected $87 from pot
*** SUMMARY ***
Total pot $90 | Rake $3
Board [5s Ts 4s 7c Js]
Seat 1: ygTTt5ehT4aF86q1a8/R+w folded before Flop (didn't bet)
Seat 2: N18PrNGQj43J7TJuQuu+tw (button) folded before Flop
Seat 3: /PH6Ffnho4Ysm8S3V/oa+w (small blind) showed [Qh Ac] and lost with high card Ace
Seat 4: 8srN1dKQePlsv0GyTada+Q (big blind) folded before Flop
Seat 5: F/075N6nU34Fn0zr6qD3aw folded before Flop (didn't bet)
Seat 6: vkfxu8f/jMYKUk6Ly4eujw showed [Ad Kc] and won ($87) with high card Ace



PokerStars Game #59937950348:  Hold'em No Limit ($1/$2) - 2009/07/01 0:03:35 ET
Table 'NmY84NAf9Mh0ckAckHnh5g' 2-max Seat #2 is the button
Seat 1: 6hvg964TSqZ3AL/0XK9aVQ ($343.20 in chips)
Seat 2: RwDoM55ZeQuI2ADyJhOb2Q ($255 in chips)
RwDoM55ZeQuI2ADyJhOb2Q: posts small blind $1
6hvg964TSqZ3AL/0XK9aVQ: posts big blind $2
*** HOLE CARDS ***
RwDoM55ZeQuI2ADyJhOb2Q: raises $4 to $6
6hvg964TSqZ3AL/0XK9aVQ: calls $4
*** FLOP *** [2d 4h 3c]
6hvg964TSqZ3AL/0XK9aVQ: checks
RwDoM55ZeQuI2ADyJhOb2Q: checks
*** TURN *** [2d 4h 3c] [Jd]
6hvg964TSqZ3AL/0XK9aVQ: bets $6
RwDoM55ZeQuI2ADyJhOb2Q: folds
6hvg964TSqZ3AL/0XK9aVQ collected $11.50 from pot
*** SUMMARY ***
Total pot $12 | Rake $0.50
Board [2d 4h 3c Jd]
Seat 1: 6hvg964TSqZ3AL/0XK9aVQ (big blind) collected ($11.50)
Seat 2: RwDoM55ZeQuI2ADyJhOb2Q (button) (small blind) folded on the Turn



PokerStars Game #59937951354:  Hold'em No Limit ($1/$2) - 2009/07/01 0:03:37 ET
Table 'XP2sRSup+aRuwzx3vDZsDg' 6-max Seat #5 is the button
Seat 1: o9jamqIi6sTTRSqudgboRA ($200 in chips)
Seat 2: yZgdnRylE65JbScQ7qCWgw ($40 in chips)
Seat 3: X7GlkHF+lkbarCLuZ4Uf0w ($33.50 in chips)
Seat 4: JsC+WvfzqlxVs9G8/gSQAQ ($109.75 in chips)
Seat 5: vkfxu8f/jMYKUk6Ly4eujw ($200 in chips)
Seat 6: h7ppRQJTYBsHCbLMeW9T2g ($494.75 in chips)
h7ppRQJTYBsHCbLMeW9T2g: posts small blind $1
o9jamqIi6sTTRSqudgboRA: posts big blind $2
*** HOLE CARDS ***
yZgdnRylE65JbScQ7qCWgw: folds
X7GlkHF+lkbarCLuZ4Uf0w: folds
JsC+WvfzqlxVs9G8/gSQAQ: calls $2
vkfxu8f/jMYKUk6Ly4eujw: folds
h7ppRQJTYBsHCbLMeW9T2g: folds
o9jamqIi6sTTRSqudgboRA: checks
*** FLOP *** [Td Qs Qh]
o9jamqIi6sTTRSqudgboRA: checks
JsC+WvfzqlxVs9G8/gSQAQ: checks
*** TURN *** [Td Qs Qh] [Kd]
o9jamqIi6sTTRSqudgboRA: bets $3.50
JsC+WvfzqlxVs9G8/gSQAQ: folds
o9jamqIi6sTTRSqudgboRA collected $4.75 from pot
*** SUMMARY ***
Total pot $5 | Rake $0.25
Board [Td Qs Qh Kd]
Seat 1: o9jamqIi6sTTRSqudgboRA (big blind) collected ($4.75)
Seat 2: yZgdnRylE65JbScQ7qCWgw folded before Flop (didn't bet)
Seat 3: X7GlkHF+lkbarCLuZ4Uf0w folded before Flop (didn't bet)
Seat 4: JsC+WvfzqlxVs9G8/gSQAQ folded on the Turn
Seat 5: vkfxu8f/jMYKUk6Ly4eujw (button) folded before Flop (didn't bet)
Seat 6: h7ppRQJTYBsHCbLMeW9T2g (small blind) folded before Flop



PokerStars Game #59937952310:  Hold'em No Limit ($1/$2) - 2009/07/01 0:03:38 ET
Table '3FGoiEOffWrbgTfsB3t7FA' 2-max Seat #2 is the button
Seat 1: e0oDWyrmgLpR6bROEqw1nQ ($454 in chips)
Seat 2: +sy/nlNI20yZraIjs4AALg ($152.55 in chips)
+sy/nlNI20yZraIjs4AALg: posts small blind $1
e0oDWyrmgLpR6bROEqw1nQ: posts big blind $2
*** HOLE CARDS ***
+sy/nlNI20yZraIjs4AALg: raises $2 to $4
e0oDWyrmgLpR6bROEqw1nQ: folds
+sy/nlNI20yZraIjs4AALg collected $4 from pot
*** SUMMARY ***
Total pot $4 | Rake $0
Seat 1: e0oDWyrmgLpR6bROEqw1nQ (big blind) folded before Flop
Seat 2: +sy/nlNI20yZraIjs4AALg (button) (small blind) collected ($4)



PokerStars Game #59937952922:  Hold'em No Limit ($1/$2) - 2009/07/01 0:03:39 ET
Table 'pPQgcj9XT9CHBsbo1WTBug' 6-max Seat #5 is the button
Seat 1: DFVYDA6dKQy7R7mGIKogZA ($115.90 in chips)
Seat 3: vkfxu8f/jMYKUk6Ly4eujw ($196 in chips)
Seat 5: 4Cl43Q1TYQL8wn1NSCUkaw ($63.60 in chips)
Seat 6: yZgdnRylE65JbScQ7qCWgw ($30 in chips)
yZgdnRylE65JbScQ7qCWgw: posts small blind $1
DFVYDA6dKQy7R7mGIKogZA: posts big blind $2
X7GlkHF+lkbarCLuZ4Uf0w: sits out
*** HOLE CARDS ***
vkfxu8f/jMYKUk6Ly4eujw: folds
4Cl43Q1TYQL8wn1NSCUkaw: folds
yZgdnRylE65JbScQ7qCWgw: raises $28 to $30 and is all-in
DFVYDA6dKQy7R7mGIKogZA: folds
yZgdnRylE65JbScQ7qCWgw collected $4 from pot
*** SUMMARY ***
Total pot $4 | Rake $0
Seat 1: DFVYDA6dKQy7R7mGIKogZA (big blind) folded before Flop
Seat 3: vkfxu8f/jMYKUk6Ly4eujw folded before Flop (didn't bet)
Seat 5: 4Cl43Q1TYQL8wn1NSCUkaw (button) folded before Flop (didn't bet)
Seat 6: yZgdnRylE65JbScQ7qCWgw (small blind) collected ($4)



PokerStars Game #59937956852:  Hold'em No Limit ($1/$2) - 2009/07/01 0:03:44 ET
Table 'CFkQcfWjKccZaZDf71FK+w' 6-max Seat #1 is the button
Seat 1: X7GlkHF+lkbarCLuZ4Uf0w ($34 in chips)
Seat 2: yZgdnRylE65JbScQ7qCWgw ($35 in chips)
Seat 3: ygTTt5ehT4aF86q1a8/R+w ($124.40 in chips)
Seat 4: B2Ih1sr5VZk+8He7rcrMtQ ($224.90 in chips)
Seat 5: 1njbh8TKSUF6l4V1XwGdcg ($203 in chips)
Seat 6: ORVqY3rf9X6ANA/8s+On2Q ($88 in chips)
yZgdnRylE65JbScQ7qCWgw: posts small blind $1
ygTTt5ehT4aF86q1a8/R+w: posts big blind $2
*** HOLE CARDS ***
B2Ih1sr5VZk+8He7rcrMtQ: folds
1njbh8TKSUF6l4V1XwGdcg: folds
ORVqY3rf9X6ANA/8s+On2Q: folds
X7GlkHF+lkbarCLuZ4Uf0w: folds
yZgdnRylE65JbScQ7qCWgw: raises $33 to $35 and is all-in
ygTTt5ehT4aF86q1a8/R+w: folds
yZgdnRylE65JbScQ7qCWgw collected $4 from pot
*** SUMMARY ***
Total pot $4 | Rake $0
Seat 1: X7GlkHF+lkbarCLuZ4Uf0w (button) folded before Flop (didn't bet)
Seat 2: yZgdnRylE65JbScQ7qCWgw (small blind) collected ($4)
Seat 3: ygTTt5ehT4aF86q1a8/R+w (big blind) folded before Flop
Seat 4: B2Ih1sr5VZk+8He7rcrMtQ folded before Flop (didn't bet)
Seat 5: 1njbh8TKSUF6l4V1XwGdcg folded before Flop (didn't bet)
Seat 6: ORVqY3rf9X6ANA/8s+On2Q folded before Flop (didn't bet)



PokerStars Game #59937958960:  Hold'em No Limit ($1/$2) - 2009/07/01 0:03:47 ET
Table 'HewZCzVOYGmuLDKthTi5Yw' 6-max Seat #4 is the button
Seat 1: 353332 ($235.75 in chips)
Seat 2: X7GlkHF+lkbarCLuZ4Uf0w ($36 in chips)
Seat 3: WJxW31eStwT28R2X/L8F5A ($53.50 in chips)
Seat 4: yZgdnRylE65JbScQ7qCWgw ($35 in chips)
Seat 5: 513FcCI8jHyQy2VWoIQkMg ($369.50 in chips)
513FcCI8jHyQy2VWoIQkMg: posts small blind $1
353332: posts big blind $2
*** HOLE CARDS ***
X7GlkHF+lkbarCLuZ4Uf0w: folds
WJxW31eStwT28R2X/L8F5A: folds
yZgdnRylE65JbScQ7qCWgw: folds
513FcCI8jHyQy2VWoIQkMg: folds
353332 collected $2 from pot
353332: doesn't show hand
*** SUMMARY ***
Total pot $2 | Rake $0
Seat 1: 353332 (big blind) collected ($2)
Seat 2: X7GlkHF+lkbarCLuZ4Uf0w folded before Flop (didn't bet)
Seat 3: WJxW31eStwT28R2X/L8F5A folded before Flop (didn't bet)
Seat 4: yZgdnRylE65JbScQ7qCWgw (button) folded before Flop (didn't bet)
Seat 5: 513FcCI8jHyQy2VWoIQkMg (small blind) folded before Flop



PokerStars Game #59937963470:  Hold'em No Limit ($1/$2) - 2009/07/01 0:03:53 ET
Table '3FGoiEOffWrbgTfsB3t7FA' 2-max Seat #1 is the button
Seat 1: e0oDWyrmgLpR6bROEqw1nQ ($452 in chips)
Seat 2: +sy/nlNI20yZraIjs4AALg ($154.55 in chips)
e0oDWyrmgLpR6bROEqw1nQ: posts small blind $1
+sy/nlNI20yZraIjs4AALg: posts big blind $2
*** HOLE CARDS ***
e0oDWyrmgLpR6bROEqw1nQ: raises $4 to $6
+sy/nlNI20yZraIjs4AALg: raises $4 to $10
e0oDWyrmgLpR6bROEqw1nQ: calls $4
*** FLOP *** [4c 7d Tc]
+sy/nlNI20yZraIjs4AALg: bets $10
e0oDWyrmgLpR6bROEqw1nQ: calls $10
*** TURN *** [4c 7d Tc] [4d]
+sy/nlNI20yZraIjs4AALg: bets $18
e0oDWyrmgLpR6bROEqw1nQ: raises $34 to $52
+sy/nlNI20yZraIjs4AALg: raises $82.55 to $134.55 and is all-in
e0oDWyrmgLpR6bROEqw1nQ: folds
+sy/nlNI20yZraIjs4AALg collected $143.50 from pot
*** SUMMARY ***
Total pot $144 | Rake $0.50
Board [4c 7d Tc 4d]
Seat 1: e0oDWyrmgLpR6bROEqw1nQ (button) (small blind) folded on the Turn
Seat 2: +sy/nlNI20yZraIjs4AALg (big blind) collected ($143.50)



PokerStars Game #59937966464:  Hold'em No Limit ($1/$2) - 2009/07/01 0:03:58 ET
Table 'NmY84NAf9Mh0ckAckHnh5g' 2-max Seat #1 is the button
Seat 1: 6hvg964TSqZ3AL/0XK9aVQ ($348.70 in chips)
Seat 2: RwDoM55ZeQuI2ADyJhOb2Q ($249 in chips)
6hvg964TSqZ3AL/0XK9aVQ: posts small blind $1
RwDoM55ZeQuI2ADyJhOb2Q: posts big blind $2
*** HOLE CARDS ***
6hvg964TSqZ3AL/0XK9aVQ: calls $1
RwDoM55ZeQuI2ADyJhOb2Q: checks
*** FLOP *** [5c 8d Qc]
RwDoM55ZeQuI2ADyJhOb2Q: bets $2
6hvg964TSqZ3AL/0XK9aVQ: calls $2
*** TURN *** [5c 8d Qc] [9c]
RwDoM55ZeQuI2ADyJhOb2Q: bets $4
6hvg964TSqZ3AL/0XK9aVQ: calls $4
*** RIVER *** [5c 8d Qc 9c] [Qd]
RwDoM55ZeQuI2ADyJhOb2Q: bets $6
6hvg964TSqZ3AL/0XK9aVQ: raises $14 to $20
RwDoM55ZeQuI2ADyJhOb2Q: calls $14
*** SHOW DOWN ***
6hvg964TSqZ3AL/0XK9aVQ: shows [Kc 8c] (a flush, King high)
RwDoM55ZeQuI2ADyJhOb2Q: mucks hand
6hvg964TSqZ3AL/0XK9aVQ collected $55.50 from pot
*** SUMMARY ***
Total pot $56 | Rake $0.50
Board [5c 8d Qc 9c Qd]
Seat 1: 6hvg964TSqZ3AL/0XK9aVQ (button) (small blind) showed [Kc 8c] and won ($55.50) with a flush, King high
Seat 2: RwDoM55ZeQuI2ADyJhOb2Q (big blind) mucked



PokerStars Game #59937966784:  Hold'em No Limit ($1/$2) - 2009/07/01 0:03:58 ET
Table 'srul5UFZXTEccVV5fpY91g' 9-max Seat #8 is the button
Seat 1: lfD8cBv31A/pio3pXJbPjA ($154.20 in chips)
Seat 2: tJYod1SLp2AcWPL/3hZ7ug ($152.20 in chips)
Seat 3: weUZ8S7tgbaeIpzi1gBNxQ ($48 in chips)
Seat 4: GG5lTuGt3+kwNYSbqeB6yw ($46 in chips)
Seat 5: 5iPk5MyO3KVu18Y8XCYfFQ ($46.10 in chips)
Seat 6: TAfo4veNRaRlzDXMMYS3Jg ($34 in chips)
Seat 7: s0erZsDxbZSaEPheMgibKg ($450.40 in chips)
Seat 8: jqICkNBEBjVScJ1iibba8Q ($293.65 in chips)
Seat 9: GX1heJ+DSsvm7gzSPsYhhQ ($38 in chips)
GX1heJ+DSsvm7gzSPsYhhQ: posts small blind $1
lfD8cBv31A/pio3pXJbPjA: posts big blind $2
s0erZsDxbZSaEPheMgibKg: posts small & big blinds $3
*** HOLE CARDS ***
tJYod1SLp2AcWPL/3hZ7ug: folds
weUZ8S7tgbaeIpzi1gBNxQ: folds
GG5lTuGt3+kwNYSbqeB6yw: raises $4 to $6
5iPk5MyO3KVu18Y8XCYfFQ: folds
TAfo4veNRaRlzDXMMYS3Jg: folds
s0erZsDxbZSaEPheMgibKg: folds
jqICkNBEBjVScJ1iibba8Q: calls $6
GX1heJ+DSsvm7gzSPsYhhQ: calls $5
lfD8cBv31A/pio3pXJbPjA: folds
*** FLOP *** [Qs Ad Jc]
GX1heJ+DSsvm7gzSPsYhhQ: checks
GG5lTuGt3+kwNYSbqeB6yw: bets $10
jqICkNBEBjVScJ1iibba8Q: calls $10
GX1heJ+DSsvm7gzSPsYhhQ: raises $16 to $26
GG5lTuGt3+kwNYSbqeB6yw: raises $14 to $40 and is all-in
jqICkNBEBjVScJ1iibba8Q: folds
GX1heJ+DSsvm7gzSPsYhhQ: calls $6 and is all-in
*** TURN *** [Qs Ad Jc] [7s]
*** RIVER *** [Qs Ad Jc 7s] [3s]
*** SHOW DOWN ***
GX1heJ+DSsvm7gzSPsYhhQ: shows [Jh Js] (three of a kind, Jacks)
GG5lTuGt3+kwNYSbqeB6yw: mucks hand
GX1heJ+DSsvm7gzSPsYhhQ collected $94 from pot
*** SUMMARY ***
Total pot $97 | Rake $3
Board [Qs Ad Jc 7s 3s]
Seat 1: lfD8cBv31A/pio3pXJbPjA (big blind) folded before Flop
Seat 2: tJYod1SLp2AcWPL/3hZ7ug folded before Flop (didn't bet)
Seat 3: weUZ8S7tgbaeIpzi1gBNxQ folded before Flop (didn't bet)
Seat 4: GG5lTuGt3+kwNYSbqeB6yw mucked
Seat 5: 5iPk5MyO3KVu18Y8XCYfFQ folded before Flop (didn't bet)
Seat 6: TAfo4veNRaRlzDXMMYS3Jg folded before Flop (didn't bet)
Seat 7: s0erZsDxbZSaEPheMgibKg folded before Flop
Seat 8: jqICkNBEBjVScJ1iibba8Q (button) folded on the Flop
Seat 9: GX1heJ+DSsvm7gzSPsYhhQ (small blind) showed [Jh Js] and won ($94) with three of a kind, Jacks



PokerStars Game #59937966748:  Hold'em No Limit ($1/$2) - 2009/07/01 0:03:58 ET
Table 'qVXak+oTeDXMGbWa4sDU5Q' 9-max Seat #9 is the button
Seat 1: H6Z4+qu8gR0VUiPOijndVg ($255 in chips)
Seat 2: Hc2itIxwbi1lwa+DAYYQGg ($37 in chips)
Seat 3: oz9eCXGC7DdjQlL/nuWj1A ($91 in chips)
Seat 4: b0jO1SDhLedy1//CQlA8kw ($40 in chips)
Seat 5: VJh1u3Qcjd3FuCT5ejyKYg ($77.10 in chips)
Seat 6: Q3uFdu6ztesjDFiqkagTRQ ($233.40 in chips)
Seat 7: 5iPk5MyO3KVu18Y8XCYfFQ ($59.50 in chips)
Seat 8: 9pHZMviI9R8injxojGTnvw ($64.85 in chips)
Seat 9: IZ/2qsh1CIg9m5PWsMsLmA ($360.95 in chips)
H6Z4+qu8gR0VUiPOijndVg: posts small blind $1
Hc2itIxwbi1lwa+DAYYQGg: posts big blind $2
*** HOLE CARDS ***
oz9eCXGC7DdjQlL/nuWj1A: folds
b0jO1SDhLedy1//CQlA8kw: folds
VJh1u3Qcjd3FuCT5ejyKYg is disconnected
VJh1u3Qcjd3FuCT5ejyKYg is connected
VJh1u3Qcjd3FuCT5ejyKYg: folds
Q3uFdu6ztesjDFiqkagTRQ: raises $4 to $6
5iPk5MyO3KVu18Y8XCYfFQ: folds
VJh1u3Qcjd3FuCT5ejyKYg leaves the table
9pHZMviI9R8injxojGTnvw: calls $6
IZ/2qsh1CIg9m5PWsMsLmA: folds
H6Z4+qu8gR0VUiPOijndVg: folds
Hc2itIxwbi1lwa+DAYYQGg: folds
*** FLOP *** [9d As 9h]
Q3uFdu6ztesjDFiqkagTRQ: bets $10
9pHZMviI9R8injxojGTnvw: folds
Q3uFdu6ztesjDFiqkagTRQ collected $14.25 from pot
Q3uFdu6ztesjDFiqkagTRQ: doesn't show hand
*** SUMMARY ***
Total pot $15 | Rake $0.75
Board [9d As 9h]
Seat 1: H6Z4+qu8gR0VUiPOijndVg (small blind) folded before Flop
Seat 2: Hc2itIxwbi1lwa+DAYYQGg (big blind) folded before Flop
Seat 3: oz9eCXGC7DdjQlL/nuWj1A folded before Flop (didn't bet)
Seat 4: b0jO1SDhLedy1//CQlA8kw folded before Flop (didn't bet)
Seat 5: VJh1u3Qcjd3FuCT5ejyKYg folded before Flop (didn't bet)
Seat 6: Q3uFdu6ztesjDFiqkagTRQ collected ($14.25)
Seat 7: 5iPk5MyO3KVu18Y8XCYfFQ folded before Flop (didn't bet)
Seat 8: 9pHZMviI9R8injxojGTnvw folded on the Flop
Seat 9: IZ/2qsh1CIg9m5PWsMsLmA (button) folded before Flop (didn't bet)



PokerStars Game #59937966504:  Hold'em No Limit ($1/$2) - 2009/07/01 0:03:58 ET
Table 'eyAQSIlgc2o1Jxvbve4WGg' 9-max Seat #2 is the button
Seat 1: Q3uFdu6ztesjDFiqkagTRQ ($237 in chips)
Seat 2: GX1heJ+DSsvm7gzSPsYhhQ ($39 in chips)
Seat 3: TAfo4veNRaRlzDXMMYS3Jg ($38 in chips)
Seat 4: Lr5OlNr2kebm3oHSC54eJg ($98.65 in chips)
Seat 5: rW/MyplHylMSBRaoRUzWrg ($103.70 in chips)
Seat 6: IikcENBHwoT7snSvBPSc7Q ($187.85 in chips)
Seat 7: QHxJjpVYwitg9krW6wZgJA ($205 in chips)
Seat 8: 5iPk5MyO3KVu18Y8XCYfFQ ($39 in chips)
Seat 9: Hc2itIxwbi1lwa+DAYYQGg ($50.85 in chips)
TAfo4veNRaRlzDXMMYS3Jg: posts small blind $1
Lr5OlNr2kebm3oHSC54eJg: posts big blind $2
*** HOLE CARDS ***
rW/MyplHylMSBRaoRUzWrg: folds
IikcENBHwoT7snSvBPSc7Q: folds
QHxJjpVYwitg9krW6wZgJA: calls $2
5iPk5MyO3KVu18Y8XCYfFQ: folds
Hc2itIxwbi1lwa+DAYYQGg: folds
Q3uFdu6ztesjDFiqkagTRQ: folds
GX1heJ+DSsvm7gzSPsYhhQ: folds
TAfo4veNRaRlzDXMMYS3Jg: folds
Lr5OlNr2kebm3oHSC54eJg: checks
*** FLOP *** [Jd 9h Tc]
Lr5OlNr2kebm3oHSC54eJg: bets $4
QHxJjpVYwitg9krW6wZgJA: folds
Lr5OlNr2kebm3oHSC54eJg collected $4.75 from pot
Lr5OlNr2kebm3oHSC54eJg: doesn't show hand
*** SUMMARY ***
Total pot $5 | Rake $0.25
Board [Jd 9h Tc]
Seat 1: Q3uFdu6ztesjDFiqkagTRQ folded before Flop (didn't bet)
Seat 2: GX1heJ+DSsvm7gzSPsYhhQ (button) folded before Flop (didn't bet)
Seat 3: TAfo4veNRaRlzDXMMYS3Jg (small blind) folded before Flop
Seat 4: Lr5OlNr2kebm3oHSC54eJg (big blind) collected ($4.75)
Seat 5: rW/MyplHylMSBRaoRUzWrg folded before Flop (didn't bet)
Seat 6: IikcENBHwoT7snSvBPSc7Q folded before Flop (didn't bet)
Seat 7: QHxJjpVYwitg9krW6wZgJA folded on the Flop
Seat 8: 5iPk5MyO3KVu18Y8XCYfFQ folded before Flop (didn't bet)
Seat 9: Hc2itIxwbi1lwa+DAYYQGg folded before Flop (didn't bet)



PokerStars Game #59937967918:  Hold'em No Limit ($1/$2) - 2009/07/01 0:03:59 ET
Table 'HewZCzVOYGmuLDKthTi5Yw' 6-max Seat #5 is the button
Seat 1: 353332 ($236.75 in chips)
Seat 2: X7GlkHF+lkbarCLuZ4Uf0w ($36 in chips)
Seat 3: WJxW31eStwT28R2X/L8F5A ($53.50 in chips)
Seat 4: yZgdnRylE65JbScQ7qCWgw ($35 in chips)
Seat 5: 513FcCI8jHyQy2VWoIQkMg ($368.50 in chips)
353332: posts small blind $1
X7GlkHF+lkbarCLuZ4Uf0w: posts big blind $2
*** HOLE CARDS ***
WJxW31eStwT28R2X/L8F5A: raises $2 to $4
yZgdnRylE65JbScQ7qCWgw: folds
513FcCI8jHyQy2VWoIQkMg: folds
353332: folds
X7GlkHF+lkbarCLuZ4Uf0w: folds
WJxW31eStwT28R2X/L8F5A collected $5 from pot
WJxW31eStwT28R2X/L8F5A: doesn't show hand
*** SUMMARY ***
Total pot $5 | Rake $0
Seat 1: 353332 (small blind) folded before Flop
Seat 2: X7GlkHF+lkbarCLuZ4Uf0w (big blind) folded before Flop
Seat 3: WJxW31eStwT28R2X/L8F5A collected ($5)
Seat 4: yZgdnRylE65JbScQ7qCWgw folded before Flop (didn't bet)
Seat 5: 513FcCI8jHyQy2VWoIQkMg (button) folded before Flop (didn't bet)



PokerStars Game #59937967310:  Hold'em No Limit ($1/$2) - 2009/07/01 0:03:59 ET
Table 'fe+AlpfadsfwxhZEvYFbbA' 6-max Seat #1 is the button
Seat 1: SLlqn2PPbQqwfcLfYqUXrw ($78.45 in chips)
Seat 2: /PH6Ffnho4Ysm8S3V/oa+w ($40 in chips)
Seat 3: 54yWzRRgS0oZ+S6LwZBxMQ ($59.30 in chips)
Seat 5: gGPaCoSWW1HoKYaqfAPecg ($200 in chips)
Seat 6: 5Y+ZGWLI4gnlpApDX5vy1A ($210.55 in chips)
/PH6Ffnho4Ysm8S3V/oa+w: posts small blind $1
54yWzRRgS0oZ+S6LwZBxMQ: posts big blind $2
*** HOLE CARDS ***
gGPaCoSWW1HoKYaqfAPecg: folds
5Y+ZGWLI4gnlpApDX5vy1A: folds
SLlqn2PPbQqwfcLfYqUXrw: raises $4 to $6
/PH6Ffnho4Ysm8S3V/oa+w: folds
54yWzRRgS0oZ+S6LwZBxMQ: folds
SLlqn2PPbQqwfcLfYqUXrw collected $5 from pot
*** SUMMARY ***
Total pot $5 | Rake $0
Seat 1: SLlqn2PPbQqwfcLfYqUXrw (button) collected ($5)
Seat 2: /PH6Ffnho4Ysm8S3V/oa+w (small blind) folded before Flop
Seat 3: 54yWzRRgS0oZ+S6LwZBxMQ (big blind) folded before Flop
Seat 5: gGPaCoSWW1HoKYaqfAPecg folded before Flop (didn't bet)
Seat 6: 5Y+ZGWLI4gnlpApDX5vy1A folded before Flop (didn't bet)



PokerStars Game #59937968504:  Hold'em No Limit ($1/$2) - 2009/07/01 0:04:00 ET
Table 'l5lZHc5JRHEDt0Y2AVPq3g' 6-max Seat #6 is the button
Seat 1: gGPaCoSWW1HoKYaqfAPecg ($204.30 in chips)
Seat 2: my38j/MmtBd/8qVwmyCREA ($213.40 in chips)
Seat 3: yZgdnRylE65JbScQ7qCWgw ($40 in chips)
Seat 4: zNjJ/y4emmF+vzrCDd+ooA ($195.05 in chips)
Seat 5: 6fLdOUCRtX71xbVRhJEq8w ($200 in chips)
Seat 6: vkfxu8f/jMYKUk6Ly4eujw ($210.90 in chips)
gGPaCoSWW1HoKYaqfAPecg: posts small blind $1
my38j/MmtBd/8qVwmyCREA: posts big blind $2
*** HOLE CARDS ***
yZgdnRylE65JbScQ7qCWgw: folds
zNjJ/y4emmF+vzrCDd+ooA: folds
6fLdOUCRtX71xbVRhJEq8w: folds
vkfxu8f/jMYKUk6Ly4eujw: raises $4 to $6
gGPaCoSWW1HoKYaqfAPecg: folds
my38j/MmtBd/8qVwmyCREA: calls $4
*** FLOP *** [Tc Qd 3c]
my38j/MmtBd/8qVwmyCREA: checks
vkfxu8f/jMYKUk6Ly4eujw: checks
*** TURN *** [Tc Qd 3c] [9h]
my38j/MmtBd/8qVwmyCREA: bets $4
vkfxu8f/jMYKUk6Ly4eujw: calls $4
*** RIVER *** [Tc Qd 3c 9h] [6d]
my38j/MmtBd/8qVwmyCREA: bets $4
vkfxu8f/jMYKUk6Ly4eujw: folds
my38j/MmtBd/8qVwmyCREA collected $20 from pot
*** SUMMARY ***
Total pot $21 | Rake $1
Board [Tc Qd 3c 9h 6d]
Seat 1: gGPaCoSWW1HoKYaqfAPecg (small blind) folded before Flop
Seat 2: my38j/MmtBd/8qVwmyCREA (big blind) collected ($20)
Seat 3: yZgdnRylE65JbScQ7qCWgw folded before Flop (didn't bet)
Seat 4: zNjJ/y4emmF+vzrCDd+ooA folded before Flop (didn't bet)
Seat 5: 6fLdOUCRtX71xbVRhJEq8w folded before Flop (didn't bet)
Seat 6: vkfxu8f/jMYKUk6Ly4eujw (button) folded on the River



PokerStars Game #59937970792:  Hold'em No Limit ($1/$2) - 2009/07/01 0:04:03 ET
Table 'pPQgcj9XT9CHBsbo1WTBug' 6-max Seat #6 is the button
Seat 1: DFVYDA6dKQy7R7mGIKogZA ($113.90 in chips)
Seat 2: X7GlkHF+lkbarCLuZ4Uf0w ($40 in chips)
Seat 3: vkfxu8f/jMYKUk6Ly4eujw ($196 in chips)
Seat 5: 4Cl43Q1TYQL8wn1NSCUkaw ($63.60 in chips)
Seat 6: yZgdnRylE65JbScQ7qCWgw ($32 in chips)
DFVYDA6dKQy7R7mGIKogZA: posts small blind $1
X7GlkHF+lkbarCLuZ4Uf0w: posts big blind $2
*** HOLE CARDS ***
vkfxu8f/jMYKUk6Ly4eujw: folds
4Cl43Q1TYQL8wn1NSCUkaw: folds
yZgdnRylE65JbScQ7qCWgw: raises $30 to $32 and is all-in
DFVYDA6dKQy7R7mGIKogZA: folds
X7GlkHF+lkbarCLuZ4Uf0w: folds
yZgdnRylE65JbScQ7qCWgw collected $5 from pot
*** SUMMARY ***
Total pot $5 | Rake $0
Seat 1: DFVYDA6dKQy7R7mGIKogZA (small blind) folded before Flop
Seat 2: X7GlkHF+lkbarCLuZ4Uf0w (big blind) folded before Flop
Seat 3: vkfxu8f/jMYKUk6Ly4eujw folded before Flop (didn't bet)
Seat 5: 4Cl43Q1TYQL8wn1NSCUkaw folded before Flop (didn't bet)
Seat 6: yZgdnRylE65JbScQ7qCWgw (button) collected ($5)



PokerStars Game #59937972432:  Hold'em No Limit ($1/$2) - 2009/07/01 0:04:06 ET
Table 'YqGfR5eHfMeSjb9a+QU9rg' 9-max Seat #4 is the button
Seat 1: qCBuzVnLcBR29snMAHq9PA ($180.35 in chips)
Seat 2: W3Nqt1GWlTi9tXQXMNEvgw ($217.60 in chips)
Seat 4: QHxJjpVYwitg9krW6wZgJA ($200 in chips)
Seat 5: MOBMOMQRN/z+fiGXGnZojw ($183.10 in chips)
Seat 6: 5iPk5MyO3KVu18Y8XCYfFQ ($36 in chips)
Seat 7: b0jO1SDhLedy1//CQlA8kw ($42 in chips)
Seat 8: GX1heJ+DSsvm7gzSPsYhhQ ($70 in chips)
Seat 9: RsrgM2l7PLbQ9xBbSi3IvQ ($110.40 in chips)
MOBMOMQRN/z+fiGXGnZojw: posts small blind $1
5iPk5MyO3KVu18Y8XCYfFQ: posts big blind $2
*** HOLE CARDS ***
QHxJjpVYwitg9krW6wZgJA said, "LOL"
b0jO1SDhLedy1//CQlA8kw: folds
GX1heJ+DSsvm7gzSPsYhhQ: folds
/gll27k+xWYV7Fbki0lFDQ joins the table at seat #3
RsrgM2l7PLbQ9xBbSi3IvQ: calls $2
qCBuzVnLcBR29snMAHq9PA: folds
W3Nqt1GWlTi9tXQXMNEvgw: folds
QHxJjpVYwitg9krW6wZgJA: folds
MOBMOMQRN/z+fiGXGnZojw: calls $1
5iPk5MyO3KVu18Y8XCYfFQ: checks
*** FLOP *** [5s 9c 2c]
MOBMOMQRN/z+fiGXGnZojw: bets $6
5iPk5MyO3KVu18Y8XCYfFQ: folds
RsrgM2l7PLbQ9xBbSi3IvQ: calls $6
*** TURN *** [5s 9c 2c] [4d]
MOBMOMQRN/z+fiGXGnZojw: checks
RsrgM2l7PLbQ9xBbSi3IvQ: bets $8
MOBMOMQRN/z+fiGXGnZojw: folds
RsrgM2l7PLbQ9xBbSi3IvQ collected $17.15 from pot
RsrgM2l7PLbQ9xBbSi3IvQ: doesn't show hand
*** SUMMARY ***
Total pot $18 | Rake $0.85
Board [5s 9c 2c 4d]
Seat 1: qCBuzVnLcBR29snMAHq9PA folded before Flop (didn't bet)
Seat 2: W3Nqt1GWlTi9tXQXMNEvgw folded before Flop (didn't bet)
Seat 4: QHxJjpVYwitg9krW6wZgJA (button) folded before Flop (didn't bet)
Seat 5: MOBMOMQRN/z+fiGXGnZojw (small blind) folded on the Turn
Seat 6: 5iPk5MyO3KVu18Y8XCYfFQ (big blind) folded on the Flop
Seat 7: b0jO1SDhLedy1//CQlA8kw folded before Flop (didn't bet)
Seat 8: GX1heJ+DSsvm7gzSPsYhhQ folded before Flop (didn't bet)
Seat 9: RsrgM2l7PLbQ9xBbSi3IvQ collected ($17.15)



PokerStars Game #59937973722:  Hold'em No Limit ($1/$2) - 2009/07/01 0:04:07 ET
Table 'WCA60bDA8ecovUgFSIZkTQ' 9-max Seat #5 is the button
Seat 1: xNLmepWbCljNEEeH8O5jSg ($266.65 in chips)
Seat 2: G1h8wamBcVJXtsKXZQ2EyA ($84.70 in chips)
Seat 3: 5iPk5MyO3KVu18Y8XCYfFQ ($40 in chips)
Seat 4: Q3uFdu6ztesjDFiqkagTRQ ($484.70 in chips)
Seat 5: Hc2itIxwbi1lwa+DAYYQGg ($309.30 in chips)
Seat 6: DOWQSOJ7GaX+ksfWTqPT5A ($199.75 in chips)
Seat 7: GX1heJ+DSsvm7gzSPsYhhQ ($34 in chips)
Seat 8: x+V1JgVDawsJTxKcxm7gxw ($100 in chips)
Seat 9: 3q2/0oJr3Mcy1W5tcN61ug ($301.20 in chips)
DOWQSOJ7GaX+ksfWTqPT5A: posts small blind $1
GX1heJ+DSsvm7gzSPsYhhQ: posts big blind $2
*** HOLE CARDS ***
x+V1JgVDawsJTxKcxm7gxw: folds
3q2/0oJr3Mcy1W5tcN61ug: folds
xNLmepWbCljNEEeH8O5jSg: folds
G1h8wamBcVJXtsKXZQ2EyA: calls $2
5iPk5MyO3KVu18Y8XCYfFQ: folds
Q3uFdu6ztesjDFiqkagTRQ: folds
Hc2itIxwbi1lwa+DAYYQGg: folds
DOWQSOJ7GaX+ksfWTqPT5A: raises $4 to $6
GX1heJ+DSsvm7gzSPsYhhQ: folds
G1h8wamBcVJXtsKXZQ2EyA: calls $4
*** FLOP *** [3c 5s Th]
DOWQSOJ7GaX+ksfWTqPT5A: bets $4
G1h8wamBcVJXtsKXZQ2EyA: folds
DOWQSOJ7GaX+ksfWTqPT5A collected $13.30 from pot
DOWQSOJ7GaX+ksfWTqPT5A: doesn't show hand
*** SUMMARY ***
Total pot $14 | Rake $0.70
Board [3c 5s Th]
Seat 1: xNLmepWbCljNEEeH8O5jSg folded before Flop (didn't bet)
Seat 2: G1h8wamBcVJXtsKXZQ2EyA folded on the Flop
Seat 3: 5iPk5MyO3KVu18Y8XCYfFQ folded before Flop (didn't bet)
Seat 4: Q3uFdu6ztesjDFiqkagTRQ folded before Flop (didn't bet)
Seat 5: Hc2itIxwbi1lwa+DAYYQGg (button) folded before Flop (didn't bet)
Seat 6: DOWQSOJ7GaX+ksfWTqPT5A (small blind) collected ($13.30)
Seat 7: GX1heJ+DSsvm7gzSPsYhhQ (big blind) folded before Flop
Seat 8: x+V1JgVDawsJTxKcxm7gxw folded before Flop (didn't bet)
Seat 9: 3q2/0oJr3Mcy1W5tcN61ug folded before Flop (didn't bet)



PokerStars Game #59937974006:  Hold'em No Limit ($1/$2) - 2009/07/01 0:04:08 ET
Table 'aSf77Sj8QEnzcc0WaxVD4Q' 6-max Seat #3 is the button
Seat 1: Q3uFdu6ztesjDFiqkagTRQ ($200 in chips)
Seat 2: vkfxu8f/jMYKUk6Ly4eujw ($204.75 in chips)
Seat 3: 9dpyyjDTCed6nV7JhaUUpw ($220.05 in chips)
Seat 4: 513FcCI8jHyQy2VWoIQkMg ($213.60 in chips)
Seat 5: InmkdI6G8TzSj9NhcCSyPg ($269 in chips)
Seat 6: vkoJRf3gidxY1pPi0AFWww ($313.80 in chips)
513FcCI8jHyQy2VWoIQkMg: posts small blind $1
InmkdI6G8TzSj9NhcCSyPg: posts big blind $2
*** HOLE CARDS ***
vkoJRf3gidxY1pPi0AFWww: folds
Q3uFdu6ztesjDFiqkagTRQ: folds
vkfxu8f/jMYKUk6Ly4eujw: folds
9dpyyjDTCed6nV7JhaUUpw: folds
513FcCI8jHyQy2VWoIQkMg: folds
InmkdI6G8TzSj9NhcCSyPg collected $2 from pot
InmkdI6G8TzSj9NhcCSyPg: doesn't show hand
*** SUMMARY ***
Total pot $2 | Rake $0
Seat 1: Q3uFdu6ztesjDFiqkagTRQ folded before Flop (didn't bet)
Seat 2: vkfxu8f/jMYKUk6Ly4eujw folded before Flop (didn't bet)
Seat 3: 9dpyyjDTCed6nV7JhaUUpw (button) folded before Flop (didn't bet)
Seat 4: 513FcCI8jHyQy2VWoIQkMg (small blind) folded before Flop
Seat 5: InmkdI6G8TzSj9NhcCSyPg (big blind) collected ($2)
Seat 6: vkoJRf3gidxY1pPi0AFWww folded before Flop (didn't bet)



PokerStars Game #59937977084:  Hold'em No Limit ($1/$2) - 2009/07/01 0:04:12 ET
Table 'LL4bDFyhj5hsMpzaDugJZg' 6-max Seat #6 is the button
Seat 1: IBW9lyGsaRmfcbyA/qFfEw ($79.20 in chips)
Seat 2: L3l+A4pJhOAD6HVVFXvVBw ($240.95 in chips)
Seat 3: gGPaCoSWW1HoKYaqfAPecg ($233 in chips)
Seat 4: 8srN1dKQePlsv0GyTada+Q ($254.35 in chips)
Seat 5: HgX0VeqE/dzSXd5BpntRBw ($200 in chips)
Seat 6: yZgdnRylE65JbScQ7qCWgw ($28 in chips)
IBW9lyGsaRmfcbyA/qFfEw: posts small blind $1
L3l+A4pJhOAD6HVVFXvVBw: posts big blind $2
*** HOLE CARDS ***
gGPaCoSWW1HoKYaqfAPecg: folds
8srN1dKQePlsv0GyTada+Q: folds
HgX0VeqE/dzSXd5BpntRBw: folds
yZgdnRylE65JbScQ7qCWgw: folds
IBW9lyGsaRmfcbyA/qFfEw: folds
L3l+A4pJhOAD6HVVFXvVBw collected $2 from pot
*** SUMMARY ***
Total pot $2 | Rake $0
Seat 1: IBW9lyGsaRmfcbyA/qFfEw (small blind) folded before Flop
Seat 2: L3l+A4pJhOAD6HVVFXvVBw (big blind) collected ($2)
Seat 3: gGPaCoSWW1HoKYaqfAPecg folded before Flop (didn't bet)
Seat 4: 8srN1dKQePlsv0GyTada+Q folded before Flop (didn't bet)
Seat 5: HgX0VeqE/dzSXd5BpntRBw folded before Flop (didn't bet)
Seat 6: yZgdnRylE65JbScQ7qCWgw (button) folded before Flop (didn't bet)



PokerStars Game #59937977964:  Hold'em No Limit ($1/$2) - 2009/07/01 0:04:13 ET
Table 'ztv6V3FN2bQ9nmJPPdx6nQ' 6-max Seat #6 is the button
Seat 1: ek1hig03QiyONDHXvgqteQ ($205.05 in chips)
Seat 3: Z55K9DbCHCUi6UaztIHi6g ($141.05 in chips)
Seat 4: vkfxu8f/jMYKUk6Ly4eujw ($316.70 in chips)
Seat 5: sTPOWERd9HWPCNrDBwsVjA ($202.75 in chips)
Seat 6: yZgdnRylE65JbScQ7qCWgw ($34 in chips)
ek1hig03QiyONDHXvgqteQ: posts small blind $1
Z55K9DbCHCUi6UaztIHi6g: posts big blind $2
*** HOLE CARDS ***
vkfxu8f/jMYKUk6Ly4eujw: raises $4 to $6
sTPOWERd9HWPCNrDBwsVjA: folds
yZgdnRylE65JbScQ7qCWgw: folds
ek1hig03QiyONDHXvgqteQ: folds
Z55K9DbCHCUi6UaztIHi6g is disconnected
Z55K9DbCHCUi6UaztIHi6g has timed out while disconnected
Z55K9DbCHCUi6UaztIHi6g: folds
Z55K9DbCHCUi6UaztIHi6g is sitting out
vkfxu8f/jMYKUk6Ly4eujw collected $5 from pot
vkfxu8f/jMYKUk6Ly4eujw: doesn't show hand
*** SUMMARY ***
Total pot $5 | Rake $0
Seat 1: ek1hig03QiyONDHXvgqteQ (small blind) folded before Flop
Seat 3: Z55K9DbCHCUi6UaztIHi6g (big blind) folded before Flop
Seat 4: vkfxu8f/jMYKUk6Ly4eujw collected ($5)
Seat 5: sTPOWERd9HWPCNrDBwsVjA folded before Flop (didn't bet)
Seat 6: yZgdnRylE65JbScQ7qCWgw (button) folded before Flop (didn't bet)



PokerStars Game #59937978036:  Hold'em No Limit ($1/$2) - 2009/07/01 0:04:14 ET
Table 'rsKRKlGHlxVyqJxzO2a2Ow' 9-max Seat #4 is the button
Seat 1: uYWfQJg2hgHLxri6/uVJiw ($165.40 in chips)
Seat 2: QHxJjpVYwitg9krW6wZgJA ($244 in chips)
Seat 3: 9sYbXdhj1M2bwKrVNxj5+Q ($71.80 in chips)
Seat 4: zJtQ1gxyi72XvGYS1tM+DA ($38.15 in chips)
Seat 5: 5Q8U6iZbeO7xJSS4qvDP5g ($200 in chips)
Seat 6: H6Z4+qu8gR0VUiPOijndVg ($200 in chips)
Seat 7: kVCeGJ4NY7Fb0W74j1mAqA ($200 in chips)
Seat 8: Hc2itIxwbi1lwa+DAYYQGg ($40 in chips)
Seat 9: 5iPk5MyO3KVu18Y8XCYfFQ ($96.20 in chips)
5Q8U6iZbeO7xJSS4qvDP5g: posts small blind $1
H6Z4+qu8gR0VUiPOijndVg: posts big blind $2
*** HOLE CARDS ***
kVCeGJ4NY7Fb0W74j1mAqA: folds
Hc2itIxwbi1lwa+DAYYQGg: folds
5iPk5MyO3KVu18Y8XCYfFQ: folds
uYWfQJg2hgHLxri6/uVJiw: raises $2 to $4
QHxJjpVYwitg9krW6wZgJA: folds
9sYbXdhj1M2bwKrVNxj5+Q: folds
zJtQ1gxyi72XvGYS1tM+DA: calls $4
5Q8U6iZbeO7xJSS4qvDP5g: folds
H6Z4+qu8gR0VUiPOijndVg: folds
*** FLOP *** [3d 4s Tc]
uYWfQJg2hgHLxri6/uVJiw: bets $4
zJtQ1gxyi72XvGYS1tM+DA: calls $4
*** TURN *** [3d 4s Tc] [9h]
uYWfQJg2hgHLxri6/uVJiw: checks
zJtQ1gxyi72XvGYS1tM+DA: bets $8
uYWfQJg2hgHLxri6/uVJiw: calls $8
*** RIVER *** [3d 4s Tc 9h] [7h]
uYWfQJg2hgHLxri6/uVJiw: checks
zJtQ1gxyi72XvGYS1tM+DA: bets $22.15 and is all-in
uYWfQJg2hgHLxri6/uVJiw: calls $22.15
*** SHOW DOWN ***
zJtQ1gxyi72XvGYS1tM+DA: shows [3h 4h] (two pair, Fours and Threes)
uYWfQJg2hgHLxri6/uVJiw: mucks hand
zJtQ1gxyi72XvGYS1tM+DA collected $76.30 from pot
*** SUMMARY ***
Total pot $79.30 | Rake $3
Board [3d 4s Tc 9h 7h]
Seat 1: uYWfQJg2hgHLxri6/uVJiw mucked
Seat 2: QHxJjpVYwitg9krW6wZgJA folded before Flop (didn't bet)
Seat 3: 9sYbXdhj1M2bwKrVNxj5+Q folded before Flop (didn't bet)
Seat 4: zJtQ1gxyi72XvGYS1tM+DA (button) showed [3h 4h] and won ($76.30) with two pair, Fours and Threes
Seat 5: 5Q8U6iZbeO7xJSS4qvDP5g (small blind) folded before Flop
Seat 6: H6Z4+qu8gR0VUiPOijndVg (big blind) folded before Flop
Seat 7: kVCeGJ4NY7Fb0W74j1mAqA folded before Flop (didn't bet)
Seat 8: Hc2itIxwbi1lwa+DAYYQGg folded before Flop (didn't bet)
Seat 9: 5iPk5MyO3KVu18Y8XCYfFQ folded before Flop (didn't bet)



PokerStars Game #59937984868:  Hold'em No Limit ($1/$2) - 2009/07/01 0:04:23 ET
Table 'XP2sRSup+aRuwzx3vDZsDg' 6-max Seat #6 is the button
Seat 1: o9jamqIi6sTTRSqudgboRA ($202.75 in chips)
Seat 2: yZgdnRylE65JbScQ7qCWgw ($40 in chips)
Seat 3: X7GlkHF+lkbarCLuZ4Uf0w ($33.50 in chips)
Seat 4: JsC+WvfzqlxVs9G8/gSQAQ ($107.75 in chips)
Seat 5: vkfxu8f/jMYKUk6Ly4eujw ($200 in chips)
Seat 6: h7ppRQJTYBsHCbLMeW9T2g ($493.75 in chips)
o9jamqIi6sTTRSqudgboRA: posts small blind $1
yZgdnRylE65JbScQ7qCWgw: posts big blind $2
*** HOLE CARDS ***
X7GlkHF+lkbarCLuZ4Uf0w: folds
JsC+WvfzqlxVs9G8/gSQAQ: folds
vkfxu8f/jMYKUk6Ly4eujw: folds
h7ppRQJTYBsHCbLMeW9T2g: folds
o9jamqIi6sTTRSqudgboRA: folds
yZgdnRylE65JbScQ7qCWgw collected $2 from pot
*** SUMMARY ***
Total pot $2 | Rake $0
Seat 1: o9jamqIi6sTTRSqudgboRA (small blind) folded before Flop
Seat 2: yZgdnRylE65JbScQ7qCWgw (big blind) collected ($2)
Seat 3: X7GlkHF+lkbarCLuZ4Uf0w folded before Flop (didn't bet)
Seat 4: JsC+WvfzqlxVs9G8/gSQAQ folded before Flop (didn't bet)
Seat 5: vkfxu8f/jMYKUk6Ly4eujw folded before Flop (didn't bet)
Seat 6: h7ppRQJTYBsHCbLMeW9T2g (button) folded before Flop (didn't bet)



PokerStars Game #59937985308:  Hold'em No Limit ($1/$2) - 2009/07/01 0:04:23 ET
Table 'NmY84NAf9Mh0ckAckHnh5g' 2-max Seat #2 is the button
Seat 1: 6hvg964TSqZ3AL/0XK9aVQ ($376.20 in chips)
Seat 2: RwDoM55ZeQuI2ADyJhOb2Q ($221 in chips)
RwDoM55ZeQuI2ADyJhOb2Q: posts small blind $1
6hvg964TSqZ3AL/0XK9aVQ: posts big blind $2
*** HOLE CARDS ***
RwDoM55ZeQuI2ADyJhOb2Q: folds
6hvg964TSqZ3AL/0XK9aVQ collected $2 from pot
*** SUMMARY ***
Total pot $2 | Rake $0
Seat 1: 6hvg964TSqZ3AL/0XK9aVQ (big blind) collected ($2)
Seat 2: RwDoM55ZeQuI2ADyJhOb2Q (button) (small blind) folded before Flop



PokerStars Game #59937985576:  Hold'em No Limit ($1/$2) - 2009/07/01 0:04:24 ET
Table 'HewZCzVOYGmuLDKthTi5Yw' 6-max Seat #1 is the button
Seat 1: 353332 ($235.75 in chips)
Seat 2: X7GlkHF+lkbarCLuZ4Uf0w ($34 in chips)
Seat 3: WJxW31eStwT28R2X/L8F5A ($56.50 in chips)
Seat 4: yZgdnRylE65JbScQ7qCWgw ($35 in chips)
Seat 5: 513FcCI8jHyQy2VWoIQkMg ($368.50 in chips)
X7GlkHF+lkbarCLuZ4Uf0w: posts small blind $1
WJxW31eStwT28R2X/L8F5A: posts big blind $2
*** HOLE CARDS ***
yZgdnRylE65JbScQ7qCWgw: folds
513FcCI8jHyQy2VWoIQkMg: folds
353332: folds
X7GlkHF+lkbarCLuZ4Uf0w: raises $3 to $5
WJxW31eStwT28R2X/L8F5A: folds
X7GlkHF+lkbarCLuZ4Uf0w collected $4 from pot
X7GlkHF+lkbarCLuZ4Uf0w: doesn't show hand
*** SUMMARY ***
Total pot $4 | Rake $0
Seat 1: 353332 (button) folded before Flop (didn't bet)
Seat 2: X7GlkHF+lkbarCLuZ4Uf0w (small blind) collected ($4)
Seat 3: WJxW31eStwT28R2X/L8F5A (big blind) folded before Flop
Seat 4: yZgdnRylE65JbScQ7qCWgw folded before Flop (didn't bet)
Seat 5: 513FcCI8jHyQy2VWoIQkMg folded before Flop (didn't bet)



PokerStars Game #59937986828:  Hold'em No Limit ($1/$2) - 2009/07/01 0:04:25 ET
Table 'bJQ024BaYSBrW0sXpCZbNQ' 6-max Seat #1 is the button
Seat 1: yZgdnRylE65JbScQ7qCWgw ($34 in chips)
Seat 2: 1njbh8TKSUF6l4V1XwGdcg ($245.40 in chips)
Seat 3: vkfxu8f/jMYKUk6Ly4eujw ($242.60 in chips)
Seat 4: 9ni/OEXAqfc58zPQ0Tu9rQ ($257.05 in chips)
Seat 5: X7GlkHF+lkbarCLuZ4Uf0w ($41.15 in chips)
Seat 6: 9dpyyjDTCed6nV7JhaUUpw ($212.50 in chips)
1njbh8TKSUF6l4V1XwGdcg: posts small blind $1
vkfxu8f/jMYKUk6Ly4eujw: posts big blind $2
*** HOLE CARDS ***
9ni/OEXAqfc58zPQ0Tu9rQ: folds
X7GlkHF+lkbarCLuZ4Uf0w: folds
9dpyyjDTCed6nV7JhaUUpw: raises $4 to $6
yZgdnRylE65JbScQ7qCWgw: folds
1njbh8TKSUF6l4V1XwGdcg: folds
vkfxu8f/jMYKUk6Ly4eujw: folds
9dpyyjDTCed6nV7JhaUUpw collected $5 from pot
9dpyyjDTCed6nV7JhaUUpw: doesn't show hand
*** SUMMARY ***
Total pot $5 | Rake $0
Seat 1: yZgdnRylE65JbScQ7qCWgw (button) folded before Flop (didn't bet)
Seat 2: 1njbh8TKSUF6l4V1XwGdcg (small blind) folded before Flop
Seat 3: vkfxu8f/jMYKUk6Ly4eujw (big blind) folded before Flop
Seat 4: 9ni/OEXAqfc58zPQ0Tu9rQ folded before Flop (didn't bet)
Seat 5: X7GlkHF+lkbarCLuZ4Uf0w folded before Flop (didn't bet)
Seat 6: 9dpyyjDTCed6nV7JhaUUpw collected ($5)



PokerStars Game #59937987586:  Hold'em No Limit ($1/$2) - 2009/07/01 0:04:27 ET
Table 'aSf77Sj8QEnzcc0WaxVD4Q' 6-max Seat #4 is the button
Seat 1: Q3uFdu6ztesjDFiqkagTRQ ($200 in chips)
Seat 2: vkfxu8f/jMYKUk6Ly4eujw ($204.75 in chips)
Seat 3: 9dpyyjDTCed6nV7JhaUUpw ($220.05 in chips)
Seat 4: 513FcCI8jHyQy2VWoIQkMg ($212.60 in chips)
Seat 5: InmkdI6G8TzSj9NhcCSyPg ($270 in chips)
Seat 6: vkoJRf3gidxY1pPi0AFWww ($313.80 in chips)
InmkdI6G8TzSj9NhcCSyPg: posts small blind $1
vkoJRf3gidxY1pPi0AFWww: posts big blind $2
*** HOLE CARDS ***
Q3uFdu6ztesjDFiqkagTRQ: raises $4 to $6
vkfxu8f/jMYKUk6Ly4eujw: calls $6
9dpyyjDTCed6nV7JhaUUpw: folds
513FcCI8jHyQy2VWoIQkMg: calls $6
InmkdI6G8TzSj9NhcCSyPg: folds
vkoJRf3gidxY1pPi0AFWww: folds
*** FLOP *** [Tc 8h Kc]
Q3uFdu6ztesjDFiqkagTRQ: checks
vkfxu8f/jMYKUk6Ly4eujw: checks
513FcCI8jHyQy2VWoIQkMg: bets $15
Q3uFdu6ztesjDFiqkagTRQ: calls $15
vkfxu8f/jMYKUk6Ly4eujw: folds
*** TURN *** [Tc 8h Kc] [Qc]
Q3uFdu6ztesjDFiqkagTRQ: bets $41
513FcCI8jHyQy2VWoIQkMg: folds
Q3uFdu6ztesjDFiqkagTRQ collected $48.55 from pot
Q3uFdu6ztesjDFiqkagTRQ: doesn't show hand
*** SUMMARY ***
Total pot $51 | Rake $2.45
Board [Tc 8h Kc Qc]
Seat 1: Q3uFdu6ztesjDFiqkagTRQ collected ($48.55)
Seat 2: vkfxu8f/jMYKUk6Ly4eujw folded on the Flop
Seat 3: 9dpyyjDTCed6nV7JhaUUpw folded before Flop (didn't bet)
Seat 4: 513FcCI8jHyQy2VWoIQkMg (button) folded on the Turn
Seat 5: InmkdI6G8TzSj9NhcCSyPg (small blind) folded before Flop
Seat 6: vkoJRf3gidxY1pPi0AFWww (big blind) folded before Flop



PokerStars Game #59937989496:  Hold'em No Limit ($1/$2) - 2009/07/01 0:04:29 ET
Table 'NmY84NAf9Mh0ckAckHnh5g' 2-max Seat #1 is the button
Seat 1: 6hvg964TSqZ3AL/0XK9aVQ ($377.20 in chips)
Seat 2: RwDoM55ZeQuI2ADyJhOb2Q ($220 in chips)
6hvg964TSqZ3AL/0XK9aVQ: posts small blind $1
RwDoM55ZeQuI2ADyJhOb2Q: posts big blind $2
*** HOLE CARDS ***
6hvg964TSqZ3AL/0XK9aVQ: folds
RwDoM55ZeQuI2ADyJhOb2Q collected $2 from pot
RwDoM55ZeQuI2ADyJhOb2Q: doesn't show hand
*** SUMMARY ***
Total pot $2 | Rake $0
Seat 1: 6hvg964TSqZ3AL/0XK9aVQ (button) (small blind) folded before Flop
Seat 2: RwDoM55ZeQuI2ADyJhOb2Q (big blind) collected ($2)



PokerStars Game #59937990754:  Hold'em No Limit ($1/$2) - 2009/07/01 0:04:31 ET
Table 'jlrIxbrVIG+gjaUYT4za8g' 6-max Seat #3 is the button
Seat 1: ygTTt5ehT4aF86q1a8/R+w ($176.35 in chips)
Seat 2: N18PrNGQj43J7TJuQuu+tw ($148.05 in chips)
Seat 3: /PH6Ffnho4Ysm8S3V/oa+w ($40 in chips)
Seat 4: 8srN1dKQePlsv0GyTada+Q ($201 in chips)
Seat 5: F/075N6nU34Fn0zr6qD3aw ($171.55 in chips)
Seat 6: vkfxu8f/jMYKUk6Ly4eujw ($321.05 in chips)
8srN1dKQePlsv0GyTada+Q: posts small blind $1
F/075N6nU34Fn0zr6qD3aw: posts big blind $2
*** HOLE CARDS ***
vkfxu8f/jMYKUk6Ly4eujw: raises $6 to $8
ygTTt5ehT4aF86q1a8/R+w: folds
N18PrNGQj43J7TJuQuu+tw: folds
/PH6Ffnho4Ysm8S3V/oa+w: raises $32 to $40 and is all-in
8srN1dKQePlsv0GyTada+Q: folds
F/075N6nU34Fn0zr6qD3aw: folds
vkfxu8f/jMYKUk6Ly4eujw: calls $32
*** FLOP *** [7s 5h 6h]
*** TURN *** [7s 5h 6h] [9s]
*** RIVER *** [7s 5h 6h 9s] [7d]
*** SHOW DOWN ***
vkfxu8f/jMYKUk6Ly4eujw: shows [Ad Ks] (a pair of Sevens)
/PH6Ffnho4Ysm8S3V/oa+w: shows [Qh Qc] (two pair, Queens and Sevens)
/PH6Ffnho4Ysm8S3V/oa+w collected $80 from pot
*** SUMMARY ***
Total pot $83 | Rake $3
Board [7s 5h 6h 9s 7d]
Seat 1: ygTTt5ehT4aF86q1a8/R+w folded before Flop (didn't bet)
Seat 2: N18PrNGQj43J7TJuQuu+tw folded before Flop (didn't bet)
Seat 3: /PH6Ffnho4Ysm8S3V/oa+w (button) showed [Qh Qc] and won ($80) with two pair, Queens and Sevens
Seat 4: 8srN1dKQePlsv0GyTada+Q (small blind) folded before Flop
Seat 5: F/075N6nU34Fn0zr6qD3aw (big blind) folded before Flop
Seat 6: vkfxu8f/jMYKUk6Ly4eujw showed [Ad Ks] and lost with a pair of Sevens



PokerStars Game #59937994504:  Hold'em No Limit ($1/$2) - 2009/07/01 0:04:36 ET
Table 'fe+AlpfadsfwxhZEvYFbbA' 6-max Seat #2 is the button
Seat 1: SLlqn2PPbQqwfcLfYqUXrw ($81.45 in chips)
Seat 2: /PH6Ffnho4Ysm8S3V/oa+w ($40 in chips)
Seat 3: 54yWzRRgS0oZ+S6LwZBxMQ ($57.30 in chips)
Seat 5: gGPaCoSWW1HoKYaqfAPecg ($200 in chips)
Seat 6: 5Y+ZGWLI4gnlpApDX5vy1A ($210.55 in chips)
54yWzRRgS0oZ+S6LwZBxMQ: posts small blind $1
gGPaCoSWW1HoKYaqfAPecg: posts big blind $2
*** HOLE CARDS ***
F/075N6nU34Fn0zr6qD3aw joins the table at seat #4
5Y+ZGWLI4gnlpApDX5vy1A: folds
SLlqn2PPbQqwfcLfYqUXrw: calls $2
/PH6Ffnho4Ysm8S3V/oa+w: folds
54yWzRRgS0oZ+S6LwZBxMQ: calls $1
gGPaCoSWW1HoKYaqfAPecg: checks
*** FLOP *** [2h Ah Kd]
54yWzRRgS0oZ+S6LwZBxMQ: bets $6
gGPaCoSWW1HoKYaqfAPecg: folds
SLlqn2PPbQqwfcLfYqUXrw: folds
54yWzRRgS0oZ+S6LwZBxMQ collected $5.70 from pot
54yWzRRgS0oZ+S6LwZBxMQ: doesn't show hand
*** SUMMARY ***
Total pot $6 | Rake $0.30
Board [2h Ah Kd]
Seat 1: SLlqn2PPbQqwfcLfYqUXrw folded on the Flop
Seat 2: /PH6Ffnho4Ysm8S3V/oa+w (button) folded before Flop (didn't bet)
Seat 3: 54yWzRRgS0oZ+S6LwZBxMQ (small blind) collected ($5.70)
Seat 5: gGPaCoSWW1HoKYaqfAPecg (big blind) folded on the Flop
Seat 6: 5Y+ZGWLI4gnlpApDX5vy1A folded before Flop (didn't bet)



PokerStars Game #59937996006:  Hold'em No Limit ($1/$2) - 2009/07/01 0:04:38 ET
Table 'NmY84NAf9Mh0ckAckHnh5g' 2-max Seat #2 is the button
Seat 1: 6hvg964TSqZ3AL/0XK9aVQ ($376.20 in chips)
Seat 2: RwDoM55ZeQuI2ADyJhOb2Q ($221 in chips)
RwDoM55ZeQuI2ADyJhOb2Q: posts small blind $1
6hvg964TSqZ3AL/0XK9aVQ: posts big blind $2
*** HOLE CARDS ***
RwDoM55ZeQuI2ADyJhOb2Q: raises $4 to $6
6hvg964TSqZ3AL/0XK9aVQ: raises $6 to $12
RwDoM55ZeQuI2ADyJhOb2Q: calls $6
*** FLOP *** [9d 4s 7d]
6hvg964TSqZ3AL/0XK9aVQ: checks
RwDoM55ZeQuI2ADyJhOb2Q: checks
*** TURN *** [9d 4s 7d] [4d]
6hvg964TSqZ3AL/0XK9aVQ: bets $10
RwDoM55ZeQuI2ADyJhOb2Q: folds
6hvg964TSqZ3AL/0XK9aVQ collected $23.50 from pot
*** SUMMARY ***
Total pot $24 | Rake $0.50
Board [9d 4s 7d 4d]
Seat 1: 6hvg964TSqZ3AL/0XK9aVQ (big blind) collected ($23.50)
Seat 2: RwDoM55ZeQuI2ADyJhOb2Q (button) (small blind) folded on the Turn



PokerStars Game #59937997718:  Hold'em No Limit ($1/$2) - 2009/07/01 0:04:40 ET
Table 'uJ9juaXXg9yIcSU8amxaXQ' 6-max Seat #3 is the button
Seat 1: HhIxv6mylwCAfv3sjJmq5g ($200 in chips)
Seat 2: DQlskgG4OtLpF2MVxLwf4A ($284.05 in chips)
Seat 3: zaogaltCDFVsIASEnrXs2w ($256.75 in chips)
Seat 4: 54yWzRRgS0oZ+S6LwZBxMQ ($38 in chips)
Seat 5: X7GlkHF+lkbarCLuZ4Uf0w ($40 in chips)
Seat 6: XrFG4dK06RVKLlX32/pjcQ ($79.40 in chips)
54yWzRRgS0oZ+S6LwZBxMQ: posts small blind $1
X7GlkHF+lkbarCLuZ4Uf0w: posts big blind $2
*** HOLE CARDS ***
XrFG4dK06RVKLlX32/pjcQ: folds
HhIxv6mylwCAfv3sjJmq5g: folds
DQlskgG4OtLpF2MVxLwf4A: folds
zaogaltCDFVsIASEnrXs2w: folds
54yWzRRgS0oZ+S6LwZBxMQ: calls $1
X7GlkHF+lkbarCLuZ4Uf0w: raises $4 to $6
54yWzRRgS0oZ+S6LwZBxMQ: folds
X7GlkHF+lkbarCLuZ4Uf0w collected $4 from pot
X7GlkHF+lkbarCLuZ4Uf0w: doesn't show hand
*** SUMMARY ***
Total pot $4 | Rake $0
Seat 1: HhIxv6mylwCAfv3sjJmq5g folded before Flop (didn't bet)
Seat 2: DQlskgG4OtLpF2MVxLwf4A folded before Flop (didn't bet)
Seat 3: zaogaltCDFVsIASEnrXs2w (button) folded before Flop (didn't bet)
Seat 4: 54yWzRRgS0oZ+S6LwZBxMQ (small blind) folded before Flop
Seat 5: X7GlkHF+lkbarCLuZ4Uf0w (big blind) collected ($4)
Seat 6: XrFG4dK06RVKLlX32/pjcQ folded before Flop (didn't bet)



PokerStars Game #59937998146:  Hold'em No Limit ($1/$2) - 2009/07/01 0:04:41 ET
Table 'pPQgcj9XT9CHBsbo1WTBug' 6-max Seat #1 is the button
Seat 1: DFVYDA6dKQy7R7mGIKogZA ($112.90 in chips)
Seat 2: X7GlkHF+lkbarCLuZ4Uf0w ($38 in chips)
Seat 3: vkfxu8f/jMYKUk6Ly4eujw ($196 in chips)
Seat 5: 4Cl43Q1TYQL8wn1NSCUkaw ($63.60 in chips)
Seat 6: yZgdnRylE65JbScQ7qCWgw ($35 in chips)
X7GlkHF+lkbarCLuZ4Uf0w: posts small blind $1
vkfxu8f/jMYKUk6Ly4eujw: posts big blind $2
*** HOLE CARDS ***
4Cl43Q1TYQL8wn1NSCUkaw: raises $2 to $4
yZgdnRylE65JbScQ7qCWgw: folds
DFVYDA6dKQy7R7mGIKogZA: folds
X7GlkHF+lkbarCLuZ4Uf0w: raises $34 to $38 and is all-in
vkfxu8f/jMYKUk6Ly4eujw: folds
4Cl43Q1TYQL8wn1NSCUkaw: folds
X7GlkHF+lkbarCLuZ4Uf0w collected $10 from pot
X7GlkHF+lkbarCLuZ4Uf0w: doesn't show hand
*** SUMMARY ***
Total pot $10 | Rake $0
Seat 1: DFVYDA6dKQy7R7mGIKogZA (button) folded before Flop (didn't bet)
Seat 2: X7GlkHF+lkbarCLuZ4Uf0w (small blind) collected ($10)
Seat 3: vkfxu8f/jMYKUk6Ly4eujw (big blind) folded before Flop
Seat 5: 4Cl43Q1TYQL8wn1NSCUkaw folded before Flop
Seat 6: yZgdnRylE65JbScQ7qCWgw folded before Flop (didn't bet)



PokerStars Game #59937998714:  Hold'em No Limit ($1/$2) - 2009/07/01 0:04:42 ET
Table 'LL4bDFyhj5hsMpzaDugJZg' 6-max Seat #1 is the button
Seat 1: IBW9lyGsaRmfcbyA/qFfEw ($78.20 in chips)
Seat 2: L3l+A4pJhOAD6HVVFXvVBw ($241.95 in chips)
Seat 3: gGPaCoSWW1HoKYaqfAPecg ($233 in chips)
Seat 4: 8srN1dKQePlsv0GyTada+Q ($254.35 in chips)
Seat 5: HgX0VeqE/dzSXd5BpntRBw ($200 in chips)
Seat 6: yZgdnRylE65JbScQ7qCWgw ($28 in chips)
L3l+A4pJhOAD6HVVFXvVBw: posts small blind $1
gGPaCoSWW1HoKYaqfAPecg: posts big blind $2
*** HOLE CARDS ***
8srN1dKQePlsv0GyTada+Q: folds
HgX0VeqE/dzSXd5BpntRBw: folds
yZgdnRylE65JbScQ7qCWgw: folds
IBW9lyGsaRmfcbyA/qFfEw: folds
L3l+A4pJhOAD6HVVFXvVBw: raises $2 to $4
gGPaCoSWW1HoKYaqfAPecg: raises $8 to $12
L3l+A4pJhOAD6HVVFXvVBw: calls $8
*** FLOP *** [5h Jc 5d]
L3l+A4pJhOAD6HVVFXvVBw: checks
gGPaCoSWW1HoKYaqfAPecg: bets $18.20
L3l+A4pJhOAD6HVVFXvVBw: calls $18.20
*** TURN *** [5h Jc 5d] [Kh]
L3l+A4pJhOAD6HVVFXvVBw: checks
gGPaCoSWW1HoKYaqfAPecg: checks
*** RIVER *** [5h Jc 5d Kh] [3h]
L3l+A4pJhOAD6HVVFXvVBw: bets $20
gGPaCoSWW1HoKYaqfAPecg: calls $20
*** SHOW DOWN ***
L3l+A4pJhOAD6HVVFXvVBw: shows [8c 5s] (three of a kind, Fives)
gGPaCoSWW1HoKYaqfAPecg: mucks hand
L3l+A4pJhOAD6HVVFXvVBw collected $97.40 from pot
*** SUMMARY ***
Total pot $100.40 | Rake $3
Board [5h Jc 5d Kh 3h]
Seat 1: IBW9lyGsaRmfcbyA/qFfEw (button) folded before Flop (didn't bet)
Seat 2: L3l+A4pJhOAD6HVVFXvVBw (small blind) showed [8c 5s] and won ($97.40) with three of a kind, Fives
Seat 3: gGPaCoSWW1HoKYaqfAPecg (big blind) mucked
Seat 4: 8srN1dKQePlsv0GyTada+Q folded before Flop (didn't bet)
Seat 5: HgX0VeqE/dzSXd5BpntRBw folded before Flop (didn't bet)
Seat 6: yZgdnRylE65JbScQ7qCWgw folded before Flop (didn't bet)



PokerStars Game #59938001284:  Hold'em No Limit ($1/$2) - 2009/07/01 0:04:45 ET
Table 'HewZCzVOYGmuLDKthTi5Yw' 6-max Seat #2 is the button
Seat 1: 353332 ($235.75 in chips)
Seat 2: X7GlkHF+lkbarCLuZ4Uf0w ($36 in chips)
Seat 3: WJxW31eStwT28R2X/L8F5A ($54.50 in chips)
Seat 4: yZgdnRylE65JbScQ7qCWgw ($35 in chips)
Seat 5: 513FcCI8jHyQy2VWoIQkMg ($368.50 in chips)
WJxW31eStwT28R2X/L8F5A: posts small blind $1
yZgdnRylE65JbScQ7qCWgw: posts big blind $2
*** HOLE CARDS ***
513FcCI8jHyQy2VWoIQkMg: raises $5 to $7
353332: folds
X7GlkHF+lkbarCLuZ4Uf0w: folds
WJxW31eStwT28R2X/L8F5A: folds
yZgdnRylE65JbScQ7qCWgw: folds
513FcCI8jHyQy2VWoIQkMg collected $5 from pot
*** SUMMARY ***
Total pot $5 | Rake $0
Seat 1: 353332 folded before Flop (didn't bet)
Seat 2: X7GlkHF+lkbarCLuZ4Uf0w (button) folded before Flop (didn't bet)
Seat 3: WJxW31eStwT28R2X/L8F5A (small blind) folded before Flop
Seat 4: yZgdnRylE65JbScQ7qCWgw (big blind) folded before Flop
Seat 5: 513FcCI8jHyQy2VWoIQkMg collected ($5)



PokerStars Game #59938001546:  Hold'em No Limit ($1/$2) - 2009/07/01 0:04:46 ET
Table 'WCA60bDA8ecovUgFSIZkTQ' 9-max Seat #6 is the button
Seat 1: xNLmepWbCljNEEeH8O5jSg ($266.65 in chips)
Seat 2: G1h8wamBcVJXtsKXZQ2EyA ($78.70 in chips)
Seat 3: 5iPk5MyO3KVu18Y8XCYfFQ ($40 in chips)
Seat 4: Q3uFdu6ztesjDFiqkagTRQ ($484.70 in chips)
Seat 5: Hc2itIxwbi1lwa+DAYYQGg ($309.30 in chips)
Seat 6: DOWQSOJ7GaX+ksfWTqPT5A ($207.05 in chips)
Seat 7: GX1heJ+DSsvm7gzSPsYhhQ ($32 in chips)
Seat 8: x+V1JgVDawsJTxKcxm7gxw ($100 in chips)
Seat 9: 3q2/0oJr3Mcy1W5tcN61ug ($301.20 in chips)
GX1heJ+DSsvm7gzSPsYhhQ: posts small blind $1
x+V1JgVDawsJTxKcxm7gxw: posts big blind $2
*** HOLE CARDS ***
3q2/0oJr3Mcy1W5tcN61ug: folds
xNLmepWbCljNEEeH8O5jSg: folds
G1h8wamBcVJXtsKXZQ2EyA: raises $2 to $4
5iPk5MyO3KVu18Y8XCYfFQ: folds
Q3uFdu6ztesjDFiqkagTRQ: folds
Hc2itIxwbi1lwa+DAYYQGg: folds
DOWQSOJ7GaX+ksfWTqPT5A: calls $4
GX1heJ+DSsvm7gzSPsYhhQ: folds
x+V1JgVDawsJTxKcxm7gxw: calls $2
*** FLOP *** [5c 8c Qc]
x+V1JgVDawsJTxKcxm7gxw: checks
G1h8wamBcVJXtsKXZQ2EyA: bets $8
DOWQSOJ7GaX+ksfWTqPT5A: calls $8
x+V1JgVDawsJTxKcxm7gxw: folds
*** TURN *** [5c 8c Qc] [5h]
G1h8wamBcVJXtsKXZQ2EyA: bets $10
DOWQSOJ7GaX+ksfWTqPT5A: calls $10
*** RIVER *** [5c 8c Qc 5h] [Qh]
G1h8wamBcVJXtsKXZQ2EyA: bets $10
DOWQSOJ7GaX+ksfWTqPT5A: calls $10
*** SHOW DOWN ***
G1h8wamBcVJXtsKXZQ2EyA: shows [Kh Ah] (two pair, Queens and Fives)
DOWQSOJ7GaX+ksfWTqPT5A: shows [6s 8h] (two pair, Queens and Eights)
DOWQSOJ7GaX+ksfWTqPT5A collected $66 from pot
*** SUMMARY ***
Total pot $69 | Rake $3
Board [5c 8c Qc 5h Qh]
Seat 1: xNLmepWbCljNEEeH8O5jSg folded before Flop (didn't bet)
Seat 2: G1h8wamBcVJXtsKXZQ2EyA showed [Kh Ah] and lost with two pair, Queens and Fives
Seat 3: 5iPk5MyO3KVu18Y8XCYfFQ folded before Flop (didn't bet)
Seat 4: Q3uFdu6ztesjDFiqkagTRQ folded before Flop (didn't bet)
Seat 5: Hc2itIxwbi1lwa+DAYYQGg folded before Flop (didn't bet)
Seat 6: DOWQSOJ7GaX+ksfWTqPT5A (button) showed [6s 8h] and won ($66) with two pair, Queens and Eights
Seat 7: GX1heJ+DSsvm7gzSPsYhhQ (small blind) folded before Flop
Seat 8: x+V1JgVDawsJTxKcxm7gxw (big blind) folded on the Flop
Seat 9: 3q2/0oJr3Mcy1W5tcN61ug folded before Flop (didn't bet)



PokerStars Game #59938001594:  Hold'em No Limit ($1/$2) - 2009/07/01 0:04:46 ET
Table 'SF49/KQm8T4taMp6kb+HXA' 9-max Seat #3 is the button
Seat 1: l1bCLGuFqeFRwUfPsiDu/g ($183.95 in chips)
Seat 2: dJO4Wtu5e7hHBlpz0cmy1w ($71.20 in chips)
Seat 3: L88dtdULfz5oGDSuo9/RvA ($41.05 in chips)
Seat 5: Z3aYCZG/yXHYFjiWkGI5ug ($228.55 in chips)
Seat 6: M2ht6rIKOI/my9eh610Nlw ($250.45 in chips)
Seat 8: 5iPk5MyO3KVu18Y8XCYfFQ ($39 in chips)
Seat 9: O+jytCilwk7zItVCEavmtw ($135 in chips)
Z3aYCZG/yXHYFjiWkGI5ug: posts small blind $1
M2ht6rIKOI/my9eh610Nlw: posts big blind $2
*** HOLE CARDS ***
5iPk5MyO3KVu18Y8XCYfFQ: folds
O+jytCilwk7zItVCEavmtw: folds
l1bCLGuFqeFRwUfPsiDu/g: folds
dJO4Wtu5e7hHBlpz0cmy1w: folds
L88dtdULfz5oGDSuo9/RvA: calls $2
Z3aYCZG/yXHYFjiWkGI5ug: folds
M2ht6rIKOI/my9eh610Nlw: checks
*** FLOP *** [3c Ks Th]
HffgoYm61KgkdMe/DYChIQ joins the table at seat #4
M2ht6rIKOI/my9eh610Nlw: checks
L88dtdULfz5oGDSuo9/RvA: checks
*** TURN *** [3c Ks Th] [7c]
M2ht6rIKOI/my9eh610Nlw: checks
L88dtdULfz5oGDSuo9/RvA: bets $4
M2ht6rIKOI/my9eh610Nlw: folds
O+jytCilwk7zItVCEavmtw is disconnected
L88dtdULfz5oGDSuo9/RvA collected $4.75 from pot
*** SUMMARY ***
Total pot $5 | Rake $0.25
Board [3c Ks Th 7c]
Seat 1: l1bCLGuFqeFRwUfPsiDu/g folded before Flop (didn't bet)
Seat 2: dJO4Wtu5e7hHBlpz0cmy1w folded before Flop (didn't bet)
Seat 3: L88dtdULfz5oGDSuo9/RvA (button) collected ($4.75)
Seat 5: Z3aYCZG/yXHYFjiWkGI5ug (small blind) folded before Flop
Seat 6: M2ht6rIKOI/my9eh610Nlw (big blind) folded on the Turn
Seat 8: 5iPk5MyO3KVu18Y8XCYfFQ folded before Flop (didn't bet)
Seat 9: O+jytCilwk7zItVCEavmtw folded before Flop (didn't bet)



PokerStars Game #59938002578:  Hold'em No Limit ($1/$2) - 2009/07/01 0:04:47 ET
Table 'CFkQcfWjKccZaZDf71FK+w' 6-max Seat #2 is the button
Seat 1: X7GlkHF+lkbarCLuZ4Uf0w ($34 in chips)
Seat 2: yZgdnRylE65JbScQ7qCWgw ($37 in chips)
Seat 3: ygTTt5ehT4aF86q1a8/R+w ($122.40 in chips)
Seat 4: B2Ih1sr5VZk+8He7rcrMtQ ($224.90 in chips)
Seat 5: 1njbh8TKSUF6l4V1XwGdcg ($203 in chips)
Seat 6: ORVqY3rf9X6ANA/8s+On2Q ($88 in chips)
ygTTt5ehT4aF86q1a8/R+w: posts small blind $1
B2Ih1sr5VZk+8He7rcrMtQ: posts big blind $2
*** HOLE CARDS ***
1njbh8TKSUF6l4V1XwGdcg: folds
ORVqY3rf9X6ANA/8s+On2Q: folds
X7GlkHF+lkbarCLuZ4Uf0w: folds
yZgdnRylE65JbScQ7qCWgw: raises $35 to $37 and is all-in
ygTTt5ehT4aF86q1a8/R+w: folds
B2Ih1sr5VZk+8He7rcrMtQ: folds
yZgdnRylE65JbScQ7qCWgw collected $5 from pot
*** SUMMARY ***
Total pot $5 | Rake $0
Seat 1: X7GlkHF+lkbarCLuZ4Uf0w folded before Flop (didn't bet)
Seat 2: yZgdnRylE65JbScQ7qCWgw (button) collected ($5)
Seat 3: ygTTt5ehT4aF86q1a8/R+w (small blind) folded before Flop
Seat 4: B2Ih1sr5VZk+8He7rcrMtQ (big blind) folded before Flop
Seat 5: 1njbh8TKSUF6l4V1XwGdcg folded before Flop (didn't bet)
Seat 6: ORVqY3rf9X6ANA/8s+On2Q folded before Flop (didn't bet)



PokerStars Game #59938003170:  Hold'em No Limit ($1/$2) - 2009/07/01 0:04:48 ET
Table 'XP2sRSup+aRuwzx3vDZsDg' 6-max Seat #1 is the button
Seat 1: o9jamqIi6sTTRSqudgboRA ($201.75 in chips)
Seat 2: yZgdnRylE65JbScQ7qCWgw ($41 in chips)
Seat 3: X7GlkHF+lkbarCLuZ4Uf0w ($33.50 in chips)
Seat 4: JsC+WvfzqlxVs9G8/gSQAQ ($107.75 in chips)
Seat 5: vkfxu8f/jMYKUk6Ly4eujw ($200 in chips)
Seat 6: h7ppRQJTYBsHCbLMeW9T2g ($493.75 in chips)
yZgdnRylE65JbScQ7qCWgw: posts small blind $1
X7GlkHF+lkbarCLuZ4Uf0w: posts big blind $2
*** HOLE CARDS ***
JsC+WvfzqlxVs9G8/gSQAQ: raises $4 to $6
vkfxu8f/jMYKUk6Ly4eujw: folds
h7ppRQJTYBsHCbLMeW9T2g: folds
o9jamqIi6sTTRSqudgboRA: folds
yZgdnRylE65JbScQ7qCWgw: folds
X7GlkHF+lkbarCLuZ4Uf0w: folds
JsC+WvfzqlxVs9G8/gSQAQ collected $5 from pot
*** SUMMARY ***
Total pot $5 | Rake $0
Seat 1: o9jamqIi6sTTRSqudgboRA (button) folded before Flop (didn't bet)
Seat 2: yZgdnRylE65JbScQ7qCWgw (small blind) folded before Flop
Seat 3: X7GlkHF+lkbarCLuZ4Uf0w (big blind) folded before Flop
Seat 4: JsC+WvfzqlxVs9G8/gSQAQ collected ($5)
Seat 5: vkfxu8f/jMYKUk6Ly4eujw folded before Flop (didn't bet)
Seat 6: h7ppRQJTYBsHCbLMeW9T2g folded before Flop (didn't bet)



PokerStars Game #59938004332:  Hold'em No Limit ($1/$2) - 2009/07/01 0:04:49 ET
Table 'bJQ024BaYSBrW0sXpCZbNQ' 6-max Seat #2 is the button
Seat 1: yZgdnRylE65JbScQ7qCWgw ($34 in chips)
Seat 2: 1njbh8TKSUF6l4V1XwGdcg ($244.40 in chips)
Seat 3: vkfxu8f/jMYKUk6Ly4eujw ($240.60 in chips)
Seat 4: 9ni/OEXAqfc58zPQ0Tu9rQ ($257.05 in chips)
Seat 5: X7GlkHF+lkbarCLuZ4Uf0w ($41.15 in chips)
Seat 6: 9dpyyjDTCed6nV7JhaUUpw ($215.50 in chips)
vkfxu8f/jMYKUk6Ly4eujw: posts small blind $1
9ni/OEXAqfc58zPQ0Tu9rQ: posts big blind $2
*** HOLE CARDS ***
9ni/OEXAqfc58zPQ0Tu9rQ said, "gggggrrrrrrrr"
X7GlkHF+lkbarCLuZ4Uf0w: folds
9dpyyjDTCed6nV7JhaUUpw: folds
yZgdnRylE65JbScQ7qCWgw: folds
1njbh8TKSUF6l4V1XwGdcg: raises $4 to $6
vkfxu8f/jMYKUk6Ly4eujw: folds
9ni/OEXAqfc58zPQ0Tu9rQ: folds
1njbh8TKSUF6l4V1XwGdcg collected $5 from pot
*** SUMMARY ***
Total pot $5 | Rake $0
Seat 1: yZgdnRylE65JbScQ7qCWgw folded before Flop (didn't bet)
Seat 2: 1njbh8TKSUF6l4V1XwGdcg (button) collected ($5)
Seat 3: vkfxu8f/jMYKUk6Ly4eujw (small blind) folded before Flop
Seat 4: 9ni/OEXAqfc58zPQ0Tu9rQ (big blind) folded before Flop
Seat 5: X7GlkHF+lkbarCLuZ4Uf0w folded before Flop (didn't bet)
Seat 6: 9dpyyjDTCed6nV7JhaUUpw folded before Flop (didn't bet)



PokerStars Game #59938006494:  Hold'em No Limit ($1/$2) - 2009/07/01 0:04:52 ET
Table 'eyAQSIlgc2o1Jxvbve4WGg' 9-max Seat #3 is the button
Seat 1: Q3uFdu6ztesjDFiqkagTRQ ($237 in chips)
Seat 2: GX1heJ+DSsvm7gzSPsYhhQ ($39 in chips)
Seat 3: TAfo4veNRaRlzDXMMYS3Jg ($37 in chips)
Seat 4: Lr5OlNr2kebm3oHSC54eJg ($101.40 in chips)
Seat 6: IikcENBHwoT7snSvBPSc7Q ($187.85 in chips)
Seat 7: QHxJjpVYwitg9krW6wZgJA ($203 in chips)
Seat 8: 5iPk5MyO3KVu18Y8XCYfFQ ($39 in chips)
Seat 9: Hc2itIxwbi1lwa+DAYYQGg ($50.85 in chips)
Lr5OlNr2kebm3oHSC54eJg: posts small blind $1
rW/MyplHylMSBRaoRUzWrg: is sitting out
IikcENBHwoT7snSvBPSc7Q: posts big blind $2
*** HOLE CARDS ***
rW/MyplHylMSBRaoRUzWrg leaves the table
QHxJjpVYwitg9krW6wZgJA: folds
5iPk5MyO3KVu18Y8XCYfFQ: folds
Hc2itIxwbi1lwa+DAYYQGg: folds
Q3uFdu6ztesjDFiqkagTRQ: folds
GX1heJ+DSsvm7gzSPsYhhQ: folds
JnV3SM2D6dAFYyGZHHpvrg joins the table at seat #5
TAfo4veNRaRlzDXMMYS3Jg: folds
Lr5OlNr2kebm3oHSC54eJg: calls $1
IikcENBHwoT7snSvBPSc7Q: raises $2 to $4
Lr5OlNr2kebm3oHSC54eJg: calls $2
*** FLOP *** [Qs 5d 4d]
Lr5OlNr2kebm3oHSC54eJg: checks
IikcENBHwoT7snSvBPSc7Q: bets $8
Lr5OlNr2kebm3oHSC54eJg: calls $8
*** TURN *** [Qs 5d 4d] [7d]
Lr5OlNr2kebm3oHSC54eJg: checks
IikcENBHwoT7snSvBPSc7Q: checks
*** RIVER *** [Qs 5d 4d 7d] [3d]
Lr5OlNr2kebm3oHSC54eJg: bets $10
IikcENBHwoT7snSvBPSc7Q: folds
Lr5OlNr2kebm3oHSC54eJg collected $22.85 from pot
*** SUMMARY ***
Total pot $24 | Rake $1.15
Board [Qs 5d 4d 7d 3d]
Seat 1: Q3uFdu6ztesjDFiqkagTRQ folded before Flop (didn't bet)
Seat 2: GX1heJ+DSsvm7gzSPsYhhQ folded before Flop (didn't bet)
Seat 3: TAfo4veNRaRlzDXMMYS3Jg (button) folded before Flop (didn't bet)
Seat 4: Lr5OlNr2kebm3oHSC54eJg (small blind) collected ($22.85)
Seat 6: IikcENBHwoT7snSvBPSc7Q (big blind) folded on the River
Seat 7: QHxJjpVYwitg9krW6wZgJA folded before Flop (didn't bet)
Seat 8: 5iPk5MyO3KVu18Y8XCYfFQ folded before Flop (didn't bet)
Seat 9: Hc2itIxwbi1lwa+DAYYQGg folded before Flop (didn't bet)



PokerStars Game #59938009318:  Hold'em No Limit ($1/$2) - 2009/07/01 0:04:56 ET
Table 'on4i1U1lCRmxsduFD3xiSg' 9-max Seat #4 is the button
Seat 1: BRHGptvmY2GKq4uuj7duDw ($276.60 in chips)
Seat 2: yZYrOeNDxQxkzpbgKX1bng ($64 in chips)
Seat 3: 5iPk5MyO3KVu18Y8XCYfFQ ($64.20 in chips)
Seat 4: Z3aYCZG/yXHYFjiWkGI5ug ($223.55 in chips)
Seat 5: QHxJjpVYwitg9krW6wZgJA ($200 in chips)
Seat 6: SB0tvOX0Kw61r2U851JFaA ($403.20 in chips)
Seat 7: xD4ElYxz6Ollzmam8BmMCw ($247.25 in chips)
Seat 8: YlSX2xwu8QMQReaxSAD8XA ($148.85 in chips)
Seat 9: iMe5yhc+1BaiIPHet3NMrA ($203 in chips)
QHxJjpVYwitg9krW6wZgJA: posts small blind $1
SB0tvOX0Kw61r2U851JFaA: posts big blind $2
*** HOLE CARDS ***
xD4ElYxz6Ollzmam8BmMCw: folds
YlSX2xwu8QMQReaxSAD8XA: folds
iMe5yhc+1BaiIPHet3NMrA: folds
BRHGptvmY2GKq4uuj7duDw: raises $4 to $6
yZYrOeNDxQxkzpbgKX1bng: folds
5iPk5MyO3KVu18Y8XCYfFQ: folds
Z3aYCZG/yXHYFjiWkGI5ug: folds
QHxJjpVYwitg9krW6wZgJA: folds
SB0tvOX0Kw61r2U851JFaA: calls $4
*** FLOP *** [As 3h 8h]
SB0tvOX0Kw61r2U851JFaA: bets $6
BRHGptvmY2GKq4uuj7duDw: calls $6
*** TURN *** [As 3h 8h] [2c]
SB0tvOX0Kw61r2U851JFaA: checks
BRHGptvmY2GKq4uuj7duDw: bets $12
SB0tvOX0Kw61r2U851JFaA: raises $12 to $24
BRHGptvmY2GKq4uuj7duDw: calls $12
*** RIVER *** [As 3h 8h 2c] [4c]
SB0tvOX0Kw61r2U851JFaA: checks
BRHGptvmY2GKq4uuj7duDw: checks
*** SHOW DOWN ***
SB0tvOX0Kw61r2U851JFaA: shows [8d 7s] (a pair of Eights)
BRHGptvmY2GKq4uuj7duDw: shows [Ah Js] (a pair of Aces)
BRHGptvmY2GKq4uuj7duDw collected $70 from pot
*** SUMMARY ***
Total pot $73 | Rake $3
Board [As 3h 8h 2c 4c]
Seat 1: BRHGptvmY2GKq4uuj7duDw showed [Ah Js] and won ($70) with a pair of Aces
Seat 2: yZYrOeNDxQxkzpbgKX1bng folded before Flop (didn't bet)
Seat 3: 5iPk5MyO3KVu18Y8XCYfFQ folded before Flop (didn't bet)
Seat 4: Z3aYCZG/yXHYFjiWkGI5ug (button) folded before Flop (didn't bet)
Seat 5: QHxJjpVYwitg9krW6wZgJA (small blind) folded before Flop
Seat 6: SB0tvOX0Kw61r2U851JFaA (big blind) showed [8d 7s] and lost with a pair of Eights
Seat 7: xD4ElYxz6Ollzmam8BmMCw folded before Flop (didn't bet)
Seat 8: YlSX2xwu8QMQReaxSAD8XA folded before Flop (didn't bet)
Seat 9: iMe5yhc+1BaiIPHet3NMrA folded before Flop (didn't bet)



PokerStars Game #59938009070:  Hold'em No Limit ($1/$2) - 2009/07/01 0:04:56 ET
Table '3FGoiEOffWrbgTfsB3t7FA' 2-max Seat #2 is the button
Seat 1: e0oDWyrmgLpR6bROEqw1nQ ($380 in chips)
Seat 2: +sy/nlNI20yZraIjs4AALg ($226.05 in chips)
+sy/nlNI20yZraIjs4AALg: posts small blind $1
e0oDWyrmgLpR6bROEqw1nQ: posts big blind $2
*** HOLE CARDS ***
+sy/nlNI20yZraIjs4AALg: calls $1
e0oDWyrmgLpR6bROEqw1nQ: raises $6 to $8
+sy/nlNI20yZraIjs4AALg: calls $6
*** FLOP *** [5h 6d 5c]
e0oDWyrmgLpR6bROEqw1nQ: bets $10
+sy/nlNI20yZraIjs4AALg: raises $10 to $20
e0oDWyrmgLpR6bROEqw1nQ: calls $10
*** TURN *** [5h 6d 5c] [Js]
e0oDWyrmgLpR6bROEqw1nQ: checks
+sy/nlNI20yZraIjs4AALg: bets $22
e0oDWyrmgLpR6bROEqw1nQ: calls $22
*** RIVER *** [5h 6d 5c Js] [4s]
e0oDWyrmgLpR6bROEqw1nQ: checks
+sy/nlNI20yZraIjs4AALg: checks
*** SHOW DOWN ***
e0oDWyrmgLpR6bROEqw1nQ: shows [9h 9d] (two pair, Nines and Fives)
+sy/nlNI20yZraIjs4AALg: mucks hand
e0oDWyrmgLpR6bROEqw1nQ collected $99.50 from pot
*** SUMMARY ***
Total pot $100 | Rake $0.50
Board [5h 6d 5c Js 4s]
Seat 1: e0oDWyrmgLpR6bROEqw1nQ (big blind) showed [9h 9d] and won ($99.50) with two pair, Nines and Fives
Seat 2: +sy/nlNI20yZraIjs4AALg (button) (small blind) mucked



PokerStars Game #59938009954:  Hold'em No Limit ($1/$2) - 2009/07/01 0:04:57 ET
Table 'NmY84NAf9Mh0ckAckHnh5g' 2-max Seat #1 is the button
Seat 1: 6hvg964TSqZ3AL/0XK9aVQ ($387.70 in chips)
Seat 2: RwDoM55ZeQuI2ADyJhOb2Q ($209 in chips)
6hvg964TSqZ3AL/0XK9aVQ: posts small blind $1
RwDoM55ZeQuI2ADyJhOb2Q: posts big blind $2
*** HOLE CARDS ***
6hvg964TSqZ3AL/0XK9aVQ: calls $1
RwDoM55ZeQuI2ADyJhOb2Q: raises $6 to $8
6hvg964TSqZ3AL/0XK9aVQ: calls $6
*** FLOP *** [2h 8h Qd]
RwDoM55ZeQuI2ADyJhOb2Q: bets $10
6hvg964TSqZ3AL/0XK9aVQ: folds
RwDoM55ZeQuI2ADyJhOb2Q collected $15.50 from pot
RwDoM55ZeQuI2ADyJhOb2Q: doesn't show hand
*** SUMMARY ***
Total pot $16 | Rake $0.50
Board [2h 8h Qd]
Seat 1: 6hvg964TSqZ3AL/0XK9aVQ (button) (small blind) folded on the Flop
Seat 2: RwDoM55ZeQuI2ADyJhOb2Q (big blind) collected ($15.50)



PokerStars Game #59938014936:  Hold'em No Limit ($1/$2) - 2009/07/01 0:05:04 ET
Table 'qVXak+oTeDXMGbWa4sDU5Q' 9-max Seat #1 is the button
Seat 1: H6Z4+qu8gR0VUiPOijndVg ($254 in chips)
Seat 2: Hc2itIxwbi1lwa+DAYYQGg ($35 in chips)
Seat 3: oz9eCXGC7DdjQlL/nuWj1A ($91 in chips)
Seat 4: b0jO1SDhLedy1//CQlA8kw ($40 in chips)
Seat 6: Q3uFdu6ztesjDFiqkagTRQ ($241.65 in chips)
Seat 7: 5iPk5MyO3KVu18Y8XCYfFQ ($59.50 in chips)
Seat 8: 9pHZMviI9R8injxojGTnvw ($58.85 in chips)
Seat 9: IZ/2qsh1CIg9m5PWsMsLmA ($360.95 in chips)
Hc2itIxwbi1lwa+DAYYQGg: posts small blind $1
oz9eCXGC7DdjQlL/nuWj1A: posts big blind $2
*** HOLE CARDS ***
b0jO1SDhLedy1//CQlA8kw: folds
Q3uFdu6ztesjDFiqkagTRQ: folds
5iPk5MyO3KVu18Y8XCYfFQ: folds
9pHZMviI9R8injxojGTnvw: folds
IZ/2qsh1CIg9m5PWsMsLmA: folds
H6Z4+qu8gR0VUiPOijndVg: raises $2 to $4
Hc2itIxwbi1lwa+DAYYQGg: calls $3
oz9eCXGC7DdjQlL/nuWj1A: calls $2
*** FLOP *** [Qd 3h 9d]
Hc2itIxwbi1lwa+DAYYQGg: checks
oz9eCXGC7DdjQlL/nuWj1A: checks
H6Z4+qu8gR0VUiPOijndVg: checks
*** TURN *** [Qd 3h 9d] [Qh]
Hc2itIxwbi1lwa+DAYYQGg: bets $6
oz9eCXGC7DdjQlL/nuWj1A: calls $6
H6Z4+qu8gR0VUiPOijndVg: folds
*** RIVER *** [Qd 3h 9d Qh] [9h]
Hc2itIxwbi1lwa+DAYYQGg: checks
oz9eCXGC7DdjQlL/nuWj1A: checks
*** SHOW DOWN ***
Hc2itIxwbi1lwa+DAYYQGg: shows [5d 5h] (two pair, Queens and Nines)
oz9eCXGC7DdjQlL/nuWj1A: shows [4h 2h] (a flush, Queen high)
oz9eCXGC7DdjQlL/nuWj1A collected $22.85 from pot
*** SUMMARY ***
Total pot $24 | Rake $1.15
Board [Qd 3h 9d Qh 9h]
Seat 1: H6Z4+qu8gR0VUiPOijndVg (button) folded on the Turn
Seat 2: Hc2itIxwbi1lwa+DAYYQGg (small blind) showed [5d 5h] and lost with two pair, Queens and Nines
Seat 3: oz9eCXGC7DdjQlL/nuWj1A (big blind) showed [4h 2h] and won ($22.85) with a flush, Queen high
Seat 4: b0jO1SDhLedy1//CQlA8kw folded before Flop (didn't bet)
Seat 6: Q3uFdu6ztesjDFiqkagTRQ folded before Flop (didn't bet)
Seat 7: 5iPk5MyO3KVu18Y8XCYfFQ folded before Flop (didn't bet)
Seat 8: 9pHZMviI9R8injxojGTnvw folded before Flop (didn't bet)
Seat 9: IZ/2qsh1CIg9m5PWsMsLmA folded before Flop (didn't bet)



PokerStars Game #59938019068:  Hold'em No Limit ($1/$2) - 2009/07/01 0:05:10 ET
Table 'gnHBqWll9O3fxG7Ojkz/ng' 9-max Seat #5 is the button
Seat 1: hpqdC/23wXosGOmzARr5NA ($160.30 in chips)
Seat 2: H6Z4+qu8gR0VUiPOijndVg ($200 in chips)
Seat 3: 5Q8U6iZbeO7xJSS4qvDP5g ($218.60 in chips)
Seat 4: n5XI5/7gN+gIubHFBH+mOw ($404.85 in chips)
Seat 5: GX1heJ+DSsvm7gzSPsYhhQ ($51.75 in chips)
Seat 6: 5iPk5MyO3KVu18Y8XCYfFQ ($38 in chips)
Seat 7: jqui3xAWCkcdPW36a6BD+w ($215.80 in chips)
Seat 8: De9g+AYjo0DN6C/+iT/nsg ($247.05 in chips)
Seat 9: kVCeGJ4NY7Fb0W74j1mAqA ($203 in chips)
5iPk5MyO3KVu18Y8XCYfFQ: posts small blind $1
jqui3xAWCkcdPW36a6BD+w: posts big blind $2
*** HOLE CARDS ***
De9g+AYjo0DN6C/+iT/nsg: folds
kVCeGJ4NY7Fb0W74j1mAqA: raises $5 to $7
hpqdC/23wXosGOmzARr5NA: folds
H6Z4+qu8gR0VUiPOijndVg: folds
5Q8U6iZbeO7xJSS4qvDP5g: folds
n5XI5/7gN+gIubHFBH+mOw: folds
GX1heJ+DSsvm7gzSPsYhhQ: folds
5iPk5MyO3KVu18Y8XCYfFQ: folds
jqui3xAWCkcdPW36a6BD+w: folds
kVCeGJ4NY7Fb0W74j1mAqA collected $5 from pot
kVCeGJ4NY7Fb0W74j1mAqA: doesn't show hand
*** SUMMARY ***
Total pot $5 | Rake $0
Seat 1: hpqdC/23wXosGOmzARr5NA folded before Flop (didn't bet)
Seat 2: H6Z4+qu8gR0VUiPOijndVg folded before Flop (didn't bet)
Seat 3: 5Q8U6iZbeO7xJSS4qvDP5g folded before Flop (didn't bet)
Seat 4: n5XI5/7gN+gIubHFBH+mOw folded before Flop (didn't bet)
Seat 5: GX1heJ+DSsvm7gzSPsYhhQ (button) folded before Flop (didn't bet)
Seat 6: 5iPk5MyO3KVu18Y8XCYfFQ (small blind) folded before Flop
Seat 7: jqui3xAWCkcdPW36a6BD+w (big blind) folded before Flop
Seat 8: De9g+AYjo0DN6C/+iT/nsg folded before Flop (didn't bet)
Seat 9: kVCeGJ4NY7Fb0W74j1mAqA collected ($5)



PokerStars Game #59938019856:  Hold'em No Limit ($1/$2) - 2009/07/01 0:05:11 ET
Table 'ztv6V3FN2bQ9nmJPPdx6nQ' 6-max Seat #1 is the button
Seat 1: ek1hig03QiyONDHXvgqteQ ($204.05 in chips)
Seat 4: vkfxu8f/jMYKUk6Ly4eujw ($319.70 in chips)
Seat 5: sTPOWERd9HWPCNrDBwsVjA ($202.75 in chips)
Seat 6: yZgdnRylE65JbScQ7qCWgw ($34 in chips)
vkfxu8f/jMYKUk6Ly4eujw: posts small blind $1
sTPOWERd9HWPCNrDBwsVjA: posts big blind $2
*** HOLE CARDS ***
yZgdnRylE65JbScQ7qCWgw: folds
ek1hig03QiyONDHXvgqteQ: folds
vkfxu8f/jMYKUk6Ly4eujw: folds
sTPOWERd9HWPCNrDBwsVjA collected $2 from pot
sTPOWERd9HWPCNrDBwsVjA: doesn't show hand
*** SUMMARY ***
Total pot $2 | Rake $0
Seat 1: ek1hig03QiyONDHXvgqteQ (button) folded before Flop (didn't bet)
Seat 4: vkfxu8f/jMYKUk6Ly4eujw (small blind) folded before Flop
Seat 5: sTPOWERd9HWPCNrDBwsVjA (big blind) collected ($2)
Seat 6: yZgdnRylE65JbScQ7qCWgw folded before Flop (didn't bet)



PokerStars Game #59938020502:  Hold'em No Limit ($1/$2) - 2009/07/01 0:05:12 ET
Table 'jlrIxbrVIG+gjaUYT4za8g' 6-max Seat #4 is the button
Seat 1: ygTTt5ehT4aF86q1a8/R+w ($176.35 in chips)
Seat 2: N18PrNGQj43J7TJuQuu+tw ($148.05 in chips)
Seat 3: /PH6Ffnho4Ysm8S3V/oa+w ($80 in chips)
Seat 4: 8srN1dKQePlsv0GyTada+Q ($200 in chips)
Seat 5: F/075N6nU34Fn0zr6qD3aw ($169.55 in chips)
Seat 6: vkfxu8f/jMYKUk6Ly4eujw ($281.05 in chips)
F/075N6nU34Fn0zr6qD3aw: posts small blind $1
vkfxu8f/jMYKUk6Ly4eujw: posts big blind $2
*** HOLE CARDS ***
ygTTt5ehT4aF86q1a8/R+w: folds
N18PrNGQj43J7TJuQuu+tw: raises $2 to $4
/PH6Ffnho4Ysm8S3V/oa+w: folds
8srN1dKQePlsv0GyTada+Q: folds
F/075N6nU34Fn0zr6qD3aw: folds
vkfxu8f/jMYKUk6Ly4eujw: folds
N18PrNGQj43J7TJuQuu+tw collected $5 from pot
*** SUMMARY ***
Total pot $5 | Rake $0
Seat 1: ygTTt5ehT4aF86q1a8/R+w folded before Flop (didn't bet)
Seat 2: N18PrNGQj43J7TJuQuu+tw collected ($5)
Seat 3: /PH6Ffnho4Ysm8S3V/oa+w folded before Flop (didn't bet)
Seat 4: 8srN1dKQePlsv0GyTada+Q (button) folded before Flop (didn't bet)
Seat 5: F/075N6nU34Fn0zr6qD3aw (small blind) folded before Flop
Seat 6: vkfxu8f/jMYKUk6Ly4eujw (big blind) folded before Flop



PokerStars Game #59938021494:  Hold'em No Limit ($1/$2) - 2009/07/01 0:05:13 ET
Table 'NmY84NAf9Mh0ckAckHnh5g' 2-max Seat #2 is the button
Seat 1: 6hvg964TSqZ3AL/0XK9aVQ ($379.70 in chips)
Seat 2: RwDoM55ZeQuI2ADyJhOb2Q ($216.50 in chips)
RwDoM55ZeQuI2ADyJhOb2Q: posts small blind $1
6hvg964TSqZ3AL/0XK9aVQ: posts big blind $2
*** HOLE CARDS ***
RwDoM55ZeQuI2ADyJhOb2Q: raises $4 to $6
6hvg964TSqZ3AL/0XK9aVQ: folds
RwDoM55ZeQuI2ADyJhOb2Q collected $4 from pot
RwDoM55ZeQuI2ADyJhOb2Q: doesn't show hand
*** SUMMARY ***
Total pot $4 | Rake $0
Seat 1: 6hvg964TSqZ3AL/0XK9aVQ (big blind) folded before Flop
Seat 2: RwDoM55ZeQuI2ADyJhOb2Q (button) (small blind) collected ($4)



PokerStars Game #59938021968:  Hold'em No Limit ($1/$2) - 2009/07/01 0:05:14 ET
Table 'YqGfR5eHfMeSjb9a+QU9rg' 9-max Seat #5 is the button
Seat 1: qCBuzVnLcBR29snMAHq9PA ($180.35 in chips)
Seat 2: W3Nqt1GWlTi9tXQXMNEvgw ($217.60 in chips)
Seat 3: /gll27k+xWYV7Fbki0lFDQ ($80 in chips)
Seat 4: QHxJjpVYwitg9krW6wZgJA ($200 in chips)
Seat 5: MOBMOMQRN/z+fiGXGnZojw ($175.10 in chips)
Seat 6: 5iPk5MyO3KVu18Y8XCYfFQ ($40 in chips)
Seat 7: b0jO1SDhLedy1//CQlA8kw ($42 in chips)
Seat 8: GX1heJ+DSsvm7gzSPsYhhQ ($70 in chips)
Seat 9: RsrgM2l7PLbQ9xBbSi3IvQ ($119.55 in chips)
5iPk5MyO3KVu18Y8XCYfFQ: posts small blind $1
b0jO1SDhLedy1//CQlA8kw: posts big blind $2
/gll27k+xWYV7Fbki0lFDQ: posts big blind $2
*** HOLE CARDS ***
GX1heJ+DSsvm7gzSPsYhhQ: folds
GX1heJ+DSsvm7gzSPsYhhQ leaves the table
RsrgM2l7PLbQ9xBbSi3IvQ: folds
qCBuzVnLcBR29snMAHq9PA: raises $2 to $4
W3Nqt1GWlTi9tXQXMNEvgw: calls $4
/gll27k+xWYV7Fbki0lFDQ: folds
JnV3SM2D6dAFYyGZHHpvrg joins the table at seat #8
QHxJjpVYwitg9krW6wZgJA: folds
MOBMOMQRN/z+fiGXGnZojw: folds
5iPk5MyO3KVu18Y8XCYfFQ: folds
b0jO1SDhLedy1//CQlA8kw: folds
*** FLOP *** [4s 9h As]
qCBuzVnLcBR29snMAHq9PA: bets $8
W3Nqt1GWlTi9tXQXMNEvgw: calls $8
*** TURN *** [4s 9h As] [6h]
qCBuzVnLcBR29snMAHq9PA: checks
W3Nqt1GWlTi9tXQXMNEvgw: bets $6
qCBuzVnLcBR29snMAHq9PA: calls $6
*** RIVER *** [4s 9h As 6h] [9d]
qCBuzVnLcBR29snMAHq9PA: checks
W3Nqt1GWlTi9tXQXMNEvgw: checks
*** SHOW DOWN ***
qCBuzVnLcBR29snMAHq9PA: shows [6d Jd] (two pair, Nines and Sixes)
W3Nqt1GWlTi9tXQXMNEvgw: shows [Ad Td] (two pair, Aces and Nines)
W3Nqt1GWlTi9tXQXMNEvgw collected $39.05 from pot
*** SUMMARY ***
Total pot $41 | Rake $1.95
Board [4s 9h As 6h 9d]
Seat 1: qCBuzVnLcBR29snMAHq9PA showed [6d Jd] and lost with two pair, Nines and Sixes
Seat 2: W3Nqt1GWlTi9tXQXMNEvgw showed [Ad Td] and won ($39.05) with two pair, Aces and Nines
Seat 3: /gll27k+xWYV7Fbki0lFDQ folded before Flop
Seat 4: QHxJjpVYwitg9krW6wZgJA folded before Flop (didn't bet)
Seat 5: MOBMOMQRN/z+fiGXGnZojw (button) folded before Flop (didn't bet)
Seat 6: 5iPk5MyO3KVu18Y8XCYfFQ (small blind) folded before Flop
Seat 7: b0jO1SDhLedy1//CQlA8kw (big blind) folded before Flop
Seat 8: GX1heJ+DSsvm7gzSPsYhhQ folded before Flop (didn't bet)
Seat 9: RsrgM2l7PLbQ9xBbSi3IvQ folded before Flop (didn't bet)



PokerStars Game #59938023268:  Hold'em No Limit ($1/$2) - 2009/07/01 0:05:15 ET
Table 'pPQgcj9XT9CHBsbo1WTBug' 6-max Seat #2 is the button
Seat 1: DFVYDA6dKQy7R7mGIKogZA ($112.90 in chips)
Seat 2: X7GlkHF+lkbarCLuZ4Uf0w ($44 in chips)
Seat 3: vkfxu8f/jMYKUk6Ly4eujw ($194 in chips)
Seat 5: 4Cl43Q1TYQL8wn1NSCUkaw ($59.60 in chips)
Seat 6: yZgdnRylE65JbScQ7qCWgw ($35 in chips)
vkfxu8f/jMYKUk6Ly4eujw: posts small blind $1
4Cl43Q1TYQL8wn1NSCUkaw: posts big blind $2
*** HOLE CARDS ***
yZgdnRylE65JbScQ7qCWgw: folds
DFVYDA6dKQy7R7mGIKogZA: calls $2
X7GlkHF+lkbarCLuZ4Uf0w: folds
vkfxu8f/jMYKUk6Ly4eujw: folds
4Cl43Q1TYQL8wn1NSCUkaw: checks
*** FLOP *** [6s 3d Qd]
4Cl43Q1TYQL8wn1NSCUkaw: bets $2
DFVYDA6dKQy7R7mGIKogZA: raises $2 to $4
4Cl43Q1TYQL8wn1NSCUkaw: calls $2
*** TURN *** [6s 3d Qd] [As]
4Cl43Q1TYQL8wn1NSCUkaw: checks
DFVYDA6dKQy7R7mGIKogZA: bets $6
4Cl43Q1TYQL8wn1NSCUkaw: folds
DFVYDA6dKQy7R7mGIKogZA collected $12.40 from pot
*** SUMMARY ***
Total pot $13 | Rake $0.60
Board [6s 3d Qd As]
Seat 1: DFVYDA6dKQy7R7mGIKogZA collected ($12.40)
Seat 2: X7GlkHF+lkbarCLuZ4Uf0w (button) folded before Flop (didn't bet)
Seat 3: vkfxu8f/jMYKUk6Ly4eujw (small blind) folded before Flop
Seat 5: 4Cl43Q1TYQL8wn1NSCUkaw (big blind) folded on the Turn
Seat 6: yZgdnRylE65JbScQ7qCWgw folded before Flop (didn't bet)



PokerStars Game #59938023110:  Hold'em No Limit ($1/$2) - 2009/07/01 0:05:15 ET
Table 'l5lZHc5JRHEDt0Y2AVPq3g' 6-max Seat #1 is the button
Seat 1: gGPaCoSWW1HoKYaqfAPecg ($203.30 in chips)
Seat 2: my38j/MmtBd/8qVwmyCREA ($223.40 in chips)
Seat 3: yZgdnRylE65JbScQ7qCWgw ($40 in chips)
Seat 4: zNjJ/y4emmF+vzrCDd+ooA ($195.05 in chips)
Seat 5: 6fLdOUCRtX71xbVRhJEq8w ($200 in chips)
Seat 6: vkfxu8f/jMYKUk6Ly4eujw ($200.90 in chips)
my38j/MmtBd/8qVwmyCREA: posts small blind $1
yZgdnRylE65JbScQ7qCWgw: posts big blind $2
*** HOLE CARDS ***
zNjJ/y4emmF+vzrCDd+ooA: raises $4 to $6
6fLdOUCRtX71xbVRhJEq8w: calls $6
vkfxu8f/jMYKUk6Ly4eujw: folds
gGPaCoSWW1HoKYaqfAPecg: folds
my38j/MmtBd/8qVwmyCREA: folds
yZgdnRylE65JbScQ7qCWgw: folds
*** FLOP *** [5d 7c Ac]
zNjJ/y4emmF+vzrCDd+ooA: bets $4
6fLdOUCRtX71xbVRhJEq8w: calls $4
*** TURN *** [5d 7c Ac] [5h]
zNjJ/y4emmF+vzrCDd+ooA: bets $8
6fLdOUCRtX71xbVRhJEq8w: folds
zNjJ/y4emmF+vzrCDd+ooA collected $21.90 from pot
*** SUMMARY ***
Total pot $23 | Rake $1.10
Board [5d 7c Ac 5h]
Seat 1: gGPaCoSWW1HoKYaqfAPecg (button) folded before Flop (didn't bet)
Seat 2: my38j/MmtBd/8qVwmyCREA (small blind) folded before Flop
Seat 3: yZgdnRylE65JbScQ7qCWgw (big blind) folded before Flop
Seat 4: zNjJ/y4emmF+vzrCDd+ooA collected ($21.90)
Seat 5: 6fLdOUCRtX71xbVRhJEq8w folded on the Turn
Seat 6: vkfxu8f/jMYKUk6Ly4eujw folded before Flop (didn't bet)



PokerStars Game #59938023450:  Hold'em No Limit ($1/$2) - 2009/07/01 0:05:16 ET
Table 'fe+AlpfadsfwxhZEvYFbbA' 6-max Seat #3 is the button
Seat 1: SLlqn2PPbQqwfcLfYqUXrw ($79.45 in chips)
Seat 2: /PH6Ffnho4Ysm8S3V/oa+w ($40 in chips)
Seat 3: 54yWzRRgS0oZ+S6LwZBxMQ ($61 in chips)
Seat 5: gGPaCoSWW1HoKYaqfAPecg ($200 in chips)
Seat 6: 5Y+ZGWLI4gnlpApDX5vy1A ($210.55 in chips)
F/075N6nU34Fn0zr6qD3aw will be allowed to play after the button
gGPaCoSWW1HoKYaqfAPecg: posts small blind $1
5Y+ZGWLI4gnlpApDX5vy1A: posts big blind $2
*** HOLE CARDS ***
SLlqn2PPbQqwfcLfYqUXrw: calls $2
/PH6Ffnho4Ysm8S3V/oa+w: folds
54yWzRRgS0oZ+S6LwZBxMQ: folds
gGPaCoSWW1HoKYaqfAPecg: folds
5Y+ZGWLI4gnlpApDX5vy1A: checks
*** FLOP *** [9h 5s Td]
5Y+ZGWLI4gnlpApDX5vy1A: checks
SLlqn2PPbQqwfcLfYqUXrw: checks
*** TURN *** [9h 5s Td] [As]
5Y+ZGWLI4gnlpApDX5vy1A: bets $4
SLlqn2PPbQqwfcLfYqUXrw: calls $4
*** RIVER *** [9h 5s Td As] [9d]
5Y+ZGWLI4gnlpApDX5vy1A: checks
SLlqn2PPbQqwfcLfYqUXrw: bets $8
5Y+ZGWLI4gnlpApDX5vy1A: folds
SLlqn2PPbQqwfcLfYqUXrw collected $12.40 from pot
*** SUMMARY ***
Total pot $13 | Rake $0.60
Board [9h 5s Td As 9d]
Seat 1: SLlqn2PPbQqwfcLfYqUXrw collected ($12.40)
Seat 2: /PH6Ffnho4Ysm8S3V/oa+w folded before Flop (didn't bet)
Seat 3: 54yWzRRgS0oZ+S6LwZBxMQ (button) folded before Flop (didn't bet)
Seat 5: gGPaCoSWW1HoKYaqfAPecg (small blind) folded before Flop
Seat 6: 5Y+ZGWLI4gnlpApDX5vy1A (big blind) folded on the River



PokerStars Game #59938025540:  Hold'em No Limit ($1/$2) - 2009/07/01 0:05:19 ET
Table 'HewZCzVOYGmuLDKthTi5Yw' 6-max Seat #3 is the button
Seat 1: 353332 ($235.75 in chips)
Seat 2: X7GlkHF+lkbarCLuZ4Uf0w ($36 in chips)
Seat 3: WJxW31eStwT28R2X/L8F5A ($53.50 in chips)
Seat 4: yZgdnRylE65JbScQ7qCWgw ($33 in chips)
Seat 5: 513FcCI8jHyQy2VWoIQkMg ($371.50 in chips)
yZgdnRylE65JbScQ7qCWgw: posts small blind $1
513FcCI8jHyQy2VWoIQkMg: posts big blind $2
*** HOLE CARDS ***
353332: folds
X7GlkHF+lkbarCLuZ4Uf0w: raises $2 to $4
WJxW31eStwT28R2X/L8F5A: folds
yZgdnRylE65JbScQ7qCWgw: folds
513FcCI8jHyQy2VWoIQkMg: folds
X7GlkHF+lkbarCLuZ4Uf0w collected $5 from pot
X7GlkHF+lkbarCLuZ4Uf0w: doesn't show hand
*** SUMMARY ***
Total pot $5 | Rake $0
Seat 1: 353332 folded before Flop (didn't bet)
Seat 2: X7GlkHF+lkbarCLuZ4Uf0w collected ($5)
Seat 3: WJxW31eStwT28R2X/L8F5A (button) folded before Flop (didn't bet)
Seat 4: yZgdnRylE65JbScQ7qCWgw (small blind) folded before Flop
Seat 5: 513FcCI8jHyQy2VWoIQkMg (big blind) folded before Flop



PokerStars Game #59938027600:  Hold'em No Limit ($1/$2) - 2009/07/01 0:05:22 ET
Table 'uJ9juaXXg9yIcSU8amxaXQ' 6-max Seat #4 is the button
Seat 1: HhIxv6mylwCAfv3sjJmq5g ($200 in chips)
Seat 2: DQlskgG4OtLpF2MVxLwf4A ($284.05 in chips)
Seat 3: zaogaltCDFVsIASEnrXs2w ($256.75 in chips)
Seat 4: 54yWzRRgS0oZ+S6LwZBxMQ ($36 in chips)
Seat 5: X7GlkHF+lkbarCLuZ4Uf0w ($42 in chips)
Seat 6: XrFG4dK06RVKLlX32/pjcQ ($79.40 in chips)
X7GlkHF+lkbarCLuZ4Uf0w: posts small blind $1
XrFG4dK06RVKLlX32/pjcQ: posts big blind $2
*** HOLE CARDS ***
HhIxv6mylwCAfv3sjJmq5g: folds
DQlskgG4OtLpF2MVxLwf4A: folds
zaogaltCDFVsIASEnrXs2w: folds
54yWzRRgS0oZ+S6LwZBxMQ: raises $2 to $4
X7GlkHF+lkbarCLuZ4Uf0w: raises $38 to $42 and is all-in
XrFG4dK06RVKLlX32/pjcQ: folds
54yWzRRgS0oZ+S6LwZBxMQ: folds
X7GlkHF+lkbarCLuZ4Uf0w collected $10 from pot
X7GlkHF+lkbarCLuZ4Uf0w: doesn't show hand
*** SUMMARY ***
Total pot $10 | Rake $0
Seat 1: HhIxv6mylwCAfv3sjJmq5g folded before Flop (didn't bet)
Seat 2: DQlskgG4OtLpF2MVxLwf4A folded before Flop (didn't bet)
Seat 3: zaogaltCDFVsIASEnrXs2w folded before Flop (didn't bet)
Seat 4: 54yWzRRgS0oZ+S6LwZBxMQ (button) folded before Flop
Seat 5: X7GlkHF+lkbarCLuZ4Uf0w (small blind) collected ($10)
Seat 6: XrFG4dK06RVKLlX32/pjcQ (big blind) folded before Flop



PokerStars Game #59938028346:  Hold'em No Limit ($1/$2) - 2009/07/01 0:05:23 ET
Table 'rsKRKlGHlxVyqJxzO2a2Ow' 9-max Seat #5 is the button
Seat 1: uYWfQJg2hgHLxri6/uVJiw ($127.25 in chips)
Seat 2: QHxJjpVYwitg9krW6wZgJA ($244 in chips)
Seat 3: 9sYbXdhj1M2bwKrVNxj5+Q ($151.80 in chips)
Seat 4: zJtQ1gxyi72XvGYS1tM+DA ($156.30 in chips)
Seat 5: 5Q8U6iZbeO7xJSS4qvDP5g ($200 in chips)
Seat 6: H6Z4+qu8gR0VUiPOijndVg ($200 in chips)
Seat 7: kVCeGJ4NY7Fb0W74j1mAqA ($200 in chips)
Seat 8: Hc2itIxwbi1lwa+DAYYQGg ($40 in chips)
Seat 9: 5iPk5MyO3KVu18Y8XCYfFQ ($96.20 in chips)
H6Z4+qu8gR0VUiPOijndVg: posts small blind $1
kVCeGJ4NY7Fb0W74j1mAqA: posts big blind $2
*** HOLE CARDS ***
Hc2itIxwbi1lwa+DAYYQGg: folds
5iPk5MyO3KVu18Y8XCYfFQ: folds
uYWfQJg2hgHLxri6/uVJiw: raises $4 to $6
QHxJjpVYwitg9krW6wZgJA: folds
9sYbXdhj1M2bwKrVNxj5+Q: calls $6
zJtQ1gxyi72XvGYS1tM+DA: folds
5Q8U6iZbeO7xJSS4qvDP5g: folds
H6Z4+qu8gR0VUiPOijndVg: folds
kVCeGJ4NY7Fb0W74j1mAqA: folds
*** FLOP *** [8h Ac Jd]
uYWfQJg2hgHLxri6/uVJiw: checks
9sYbXdhj1M2bwKrVNxj5+Q: checks
*** TURN *** [8h Ac Jd] [5d]
uYWfQJg2hgHLxri6/uVJiw: checks
9sYbXdhj1M2bwKrVNxj5+Q: checks
*** RIVER *** [8h Ac Jd 5d] [2d]
uYWfQJg2hgHLxri6/uVJiw: checks
9sYbXdhj1M2bwKrVNxj5+Q: checks
*** SHOW DOWN ***
uYWfQJg2hgHLxri6/uVJiw: shows [Qs Qc] (a pair of Queens)
9sYbXdhj1M2bwKrVNxj5+Q: mucks hand
uYWfQJg2hgHLxri6/uVJiw collected $14.25 from pot
*** SUMMARY ***
Total pot $15 | Rake $0.75
Board [8h Ac Jd 5d 2d]
Seat 1: uYWfQJg2hgHLxri6/uVJiw showed [Qs Qc] and won ($14.25) with a pair of Queens
Seat 2: QHxJjpVYwitg9krW6wZgJA folded before Flop (didn't bet)
Seat 3: 9sYbXdhj1M2bwKrVNxj5+Q mucked
Seat 4: zJtQ1gxyi72XvGYS1tM+DA folded before Flop (didn't bet)
Seat 5: 5Q8U6iZbeO7xJSS4qvDP5g (button) folded before Flop (didn't bet)
Seat 6: H6Z4+qu8gR0VUiPOijndVg (small blind) folded before Flop
Seat 7: kVCeGJ4NY7Fb0W74j1mAqA (big blind) folded before Flop
Seat 8: Hc2itIxwbi1lwa+DAYYQGg folded before Flop (didn't bet)
Seat 9: 5iPk5MyO3KVu18Y8XCYfFQ folded before Flop (didn't bet)



PokerStars Game #59938029066:  Hold'em No Limit ($1/$2) - 2009/07/01 0:05:24 ET
Table 'NmY84NAf9Mh0ckAckHnh5g' 2-max Seat #1 is the button
Seat 1: 6hvg964TSqZ3AL/0XK9aVQ ($377.70 in chips)
Seat 2: RwDoM55ZeQuI2ADyJhOb2Q ($218.50 in chips)
6hvg964TSqZ3AL/0XK9aVQ: posts small blind $1
RwDoM55ZeQuI2ADyJhOb2Q: posts big blind $2
*** HOLE CARDS ***
6hvg964TSqZ3AL/0XK9aVQ: calls $1
RwDoM55ZeQuI2ADyJhOb2Q: checks
*** FLOP *** [6s 5c 5h]
RwDoM55ZeQuI2ADyJhOb2Q: checks
6hvg964TSqZ3AL/0XK9aVQ: checks
*** TURN *** [6s 5c 5h] [6h]
RwDoM55ZeQuI2ADyJhOb2Q: checks
6hvg964TSqZ3AL/0XK9aVQ: checks
*** RIVER *** [6s 5c 5h 6h] [Qs]
RwDoM55ZeQuI2ADyJhOb2Q: bets $2
6hvg964TSqZ3AL/0XK9aVQ: folds
RwDoM55ZeQuI2ADyJhOb2Q collected $3.80 from pot
RwDoM55ZeQuI2ADyJhOb2Q: doesn't show hand
*** SUMMARY ***
Total pot $4 | Rake $0.20
Board [6s 5c 5h 6h Qs]
Seat 1: 6hvg964TSqZ3AL/0XK9aVQ (button) (small blind) folded on the River
Seat 2: RwDoM55ZeQuI2ADyJhOb2Q (big blind) collected ($3.80)



PokerStars Game #59938031838:  Hold'em No Limit ($1/$2) - 2009/07/01 0:05:27 ET
Table 'XP2sRSup+aRuwzx3vDZsDg' 6-max Seat #2 is the button
Seat 1: o9jamqIi6sTTRSqudgboRA ($201.75 in chips)
Seat 2: yZgdnRylE65JbScQ7qCWgw ($40 in chips)
Seat 3: X7GlkHF+lkbarCLuZ4Uf0w ($31.50 in chips)
Seat 4: JsC+WvfzqlxVs9G8/gSQAQ ($110.75 in chips)
Seat 5: vkfxu8f/jMYKUk6Ly4eujw ($200 in chips)
Seat 6: h7ppRQJTYBsHCbLMeW9T2g ($493.75 in chips)
X7GlkHF+lkbarCLuZ4Uf0w: posts small blind $1
JsC+WvfzqlxVs9G8/gSQAQ: posts big blind $2
*** HOLE CARDS ***
vkfxu8f/jMYKUk6Ly4eujw: folds
h7ppRQJTYBsHCbLMeW9T2g: raises $4 to $6
o9jamqIi6sTTRSqudgboRA: calls $6
yZgdnRylE65JbScQ7qCWgw: folds
X7GlkHF+lkbarCLuZ4Uf0w: folds
JsC+WvfzqlxVs9G8/gSQAQ: calls $4
*** FLOP *** [Td 6d Qd]
JsC+WvfzqlxVs9G8/gSQAQ: checks
h7ppRQJTYBsHCbLMeW9T2g: checks
o9jamqIi6sTTRSqudgboRA: bets $15
JsC+WvfzqlxVs9G8/gSQAQ: calls $15
h7ppRQJTYBsHCbLMeW9T2g: folds
*** TURN *** [Td 6d Qd] [4c]
JsC+WvfzqlxVs9G8/gSQAQ: checks
o9jamqIi6sTTRSqudgboRA: checks
*** RIVER *** [Td 6d Qd 4c] [Js]
JsC+WvfzqlxVs9G8/gSQAQ: bets $10
o9jamqIi6sTTRSqudgboRA: calls $10
*** SHOW DOWN ***
JsC+WvfzqlxVs9G8/gSQAQ: shows [6c 7d] (a pair of Sixes)
o9jamqIi6sTTRSqudgboRA: shows [Ah Ks] (a straight, Ten to Ace)
o9jamqIi6sTTRSqudgboRA collected $66 from pot
*** SUMMARY ***
Total pot $69 | Rake $3
Board [Td 6d Qd 4c Js]
Seat 1: o9jamqIi6sTTRSqudgboRA showed [Ah Ks] and won ($66) with a straight, Ten to Ace
Seat 2: yZgdnRylE65JbScQ7qCWgw (button) folded before Flop (didn't bet)
Seat 3: X7GlkHF+lkbarCLuZ4Uf0w (small blind) folded before Flop
Seat 4: JsC+WvfzqlxVs9G8/gSQAQ (big blind) showed [6c 7d] and lost with a pair of Sixes
Seat 5: vkfxu8f/jMYKUk6Ly4eujw folded before Flop (didn't bet)
Seat 6: h7ppRQJTYBsHCbLMeW9T2g folded on the Flop



PokerStars Game #59938035730:  Hold'em No Limit ($1/$2) - 2009/07/01 0:05:33 ET
Table 'bJQ024BaYSBrW0sXpCZbNQ' 6-max Seat #3 is the button
Seat 1: yZgdnRylE65JbScQ7qCWgw ($34 in chips)
Seat 2: 1njbh8TKSUF6l4V1XwGdcg ($247.40 in chips)
Seat 3: vkfxu8f/jMYKUk6Ly4eujw ($239.60 in chips)
Seat 4: 9ni/OEXAqfc58zPQ0Tu9rQ ($255.05 in chips)
Seat 5: X7GlkHF+lkbarCLuZ4Uf0w ($41.15 in chips)
Seat 6: 9dpyyjDTCed6nV7JhaUUpw ($215.50 in chips)
9ni/OEXAqfc58zPQ0Tu9rQ: posts small blind $1
X7GlkHF+lkbarCLuZ4Uf0w: posts big blind $2
*** HOLE CARDS ***
9dpyyjDTCed6nV7JhaUUpw: folds
yZgdnRylE65JbScQ7qCWgw: folds
1njbh8TKSUF6l4V1XwGdcg: folds
vkfxu8f/jMYKUk6Ly4eujw: raises $4 to $6
9ni/OEXAqfc58zPQ0Tu9rQ: calls $5
X7GlkHF+lkbarCLuZ4Uf0w: folds
*** FLOP *** [8h 2s Kh]
9ni/OEXAqfc58zPQ0Tu9rQ said, "allin"
9ni/OEXAqfc58zPQ0Tu9rQ: checks
vkfxu8f/jMYKUk6Ly4eujw: bets $8
9ni/OEXAqfc58zPQ0Tu9rQ: calls $8
*** TURN *** [8h 2s Kh] [8d]
9ni/OEXAqfc58zPQ0Tu9rQ: checks
vkfxu8f/jMYKUk6Ly4eujw: checks
*** RIVER *** [8h 2s Kh 8d] [3h]
9ni/OEXAqfc58zPQ0Tu9rQ: checks
vkfxu8f/jMYKUk6Ly4eujw: checks
*** SHOW DOWN ***
9ni/OEXAqfc58zPQ0Tu9rQ: shows [Js 8s] (three of a kind, Eights)
vkfxu8f/jMYKUk6Ly4eujw: mucks hand
9ni/OEXAqfc58zPQ0Tu9rQ collected $28.55 from pot
*** SUMMARY ***
Total pot $30 | Rake $1.45
Board [8h 2s Kh 8d 3h]
Seat 1: yZgdnRylE65JbScQ7qCWgw folded before Flop (didn't bet)
Seat 2: 1njbh8TKSUF6l4V1XwGdcg folded before Flop (didn't bet)
Seat 3: vkfxu8f/jMYKUk6Ly4eujw (button) mucked
Seat 4: 9ni/OEXAqfc58zPQ0Tu9rQ (small blind) showed [Js 8s] and won ($28.55) with three of a kind, Eights
Seat 5: X7GlkHF+lkbarCLuZ4Uf0w (big blind) folded before Flop
Seat 6: 9dpyyjDTCed6nV7JhaUUpw folded before Flop (didn't bet)



PokerStars Game #59938036648:  Hold'em No Limit ($1/$2) - 2009/07/01 0:05:34 ET
Table 'CFkQcfWjKccZaZDf71FK+w' 6-max Seat #3 is the button
Seat 1: X7GlkHF+lkbarCLuZ4Uf0w ($34 in chips)
Seat 2: yZgdnRylE65JbScQ7qCWgw ($40 in chips)
Seat 3: ygTTt5ehT4aF86q1a8/R+w ($121.40 in chips)
Seat 4: B2Ih1sr5VZk+8He7rcrMtQ ($222.90 in chips)
Seat 5: 1njbh8TKSUF6l4V1XwGdcg ($203 in chips)
Seat 6: ORVqY3rf9X6ANA/8s+On2Q ($88 in chips)
B2Ih1sr5VZk+8He7rcrMtQ: posts small blind $1
1njbh8TKSUF6l4V1XwGdcg: posts big blind $2
*** HOLE CARDS ***
ORVqY3rf9X6ANA/8s+On2Q: calls $2
X7GlkHF+lkbarCLuZ4Uf0w: folds
yZgdnRylE65JbScQ7qCWgw: folds
ygTTt5ehT4aF86q1a8/R+w: folds
B2Ih1sr5VZk+8He7rcrMtQ: calls $1
1njbh8TKSUF6l4V1XwGdcg: checks
*** FLOP *** [5s 7c Qh]
B2Ih1sr5VZk+8He7rcrMtQ: checks
1njbh8TKSUF6l4V1XwGdcg: bets $4
ORVqY3rf9X6ANA/8s+On2Q: calls $4
B2Ih1sr5VZk+8He7rcrMtQ: folds
*** TURN *** [5s 7c Qh] [4s]
1njbh8TKSUF6l4V1XwGdcg: bets $10
ORVqY3rf9X6ANA/8s+On2Q: calls $10
*** RIVER *** [5s 7c Qh 4s] [2h]
1njbh8TKSUF6l4V1XwGdcg: bets $24
ORVqY3rf9X6ANA/8s+On2Q: calls $24
*** SHOW DOWN ***
1njbh8TKSUF6l4V1XwGdcg: shows [Qc 5h] (two pair, Queens and Fives)
ORVqY3rf9X6ANA/8s+On2Q: mucks hand
1njbh8TKSUF6l4V1XwGdcg collected $79 from pot
*** SUMMARY ***
Total pot $82 | Rake $3
Board [5s 7c Qh 4s 2h]
Seat 1: X7GlkHF+lkbarCLuZ4Uf0w folded before Flop (didn't bet)
Seat 2: yZgdnRylE65JbScQ7qCWgw folded before Flop (didn't bet)
Seat 3: ygTTt5ehT4aF86q1a8/R+w (button) folded before Flop (didn't bet)
Seat 4: B2Ih1sr5VZk+8He7rcrMtQ (small blind) folded on the Flop
Seat 5: 1njbh8TKSUF6l4V1XwGdcg (big blind) showed [Qc 5h] and won ($79) with two pair, Queens and Fives
Seat 6: ORVqY3rf9X6ANA/8s+On2Q mucked



PokerStars Game #59938037640:  Hold'em No Limit ($1/$2) - 2009/07/01 0:05:35 ET
Table 'ztv6V3FN2bQ9nmJPPdx6nQ' 6-max Seat #4 is the button
Seat 1: ek1hig03QiyONDHXvgqteQ ($204.05 in chips)
Seat 4: vkfxu8f/jMYKUk6Ly4eujw ($318.70 in chips)
Seat 5: sTPOWERd9HWPCNrDBwsVjA ($203.75 in chips)
Seat 6: yZgdnRylE65JbScQ7qCWgw ($34 in chips)
sTPOWERd9HWPCNrDBwsVjA: posts small blind $1
yZgdnRylE65JbScQ7qCWgw: posts big blind $2
*** HOLE CARDS ***
ek1hig03QiyONDHXvgqteQ: raises $6 to $8
vkfxu8f/jMYKUk6Ly4eujw: calls $8
sTPOWERd9HWPCNrDBwsVjA: calls $7
yZgdnRylE65JbScQ7qCWgw: folds
*** FLOP *** [Tc 5s 6c]
sTPOWERd9HWPCNrDBwsVjA: checks
ek1hig03QiyONDHXvgqteQ: bets $14
vkfxu8f/jMYKUk6Ly4eujw: raises $34 to $48
sTPOWERd9HWPCNrDBwsVjA: folds
ek1hig03QiyONDHXvgqteQ: folds
vkfxu8f/jMYKUk6Ly4eujw collected $52 from pot
vkfxu8f/jMYKUk6Ly4eujw: doesn't show hand
*** SUMMARY ***
Total pot $54 | Rake $2
Board [Tc 5s 6c]
Seat 1: ek1hig03QiyONDHXvgqteQ folded on the Flop
Seat 4: vkfxu8f/jMYKUk6Ly4eujw (button) collected ($52)
Seat 5: sTPOWERd9HWPCNrDBwsVjA (small blind) folded on the Flop
Seat 6: yZgdnRylE65JbScQ7qCWgw (big blind) folded before Flop



PokerStars Game #59938038058:  Hold'em No Limit ($1/$2) - 2009/07/01 0:05:36 ET
Table 'SF49/KQm8T4taMp6kb+HXA' 9-max Seat #5 is the button
Seat 1: l1bCLGuFqeFRwUfPsiDu/g ($183.95 in chips)
Seat 2: dJO4Wtu5e7hHBlpz0cmy1w ($71.20 in chips)
Seat 3: L88dtdULfz5oGDSuo9/RvA ($43.80 in chips)
Seat 4: HffgoYm61KgkdMe/DYChIQ ($40 in chips)
Seat 5: Z3aYCZG/yXHYFjiWkGI5ug ($227.55 in chips)
Seat 6: M2ht6rIKOI/my9eh610Nlw ($248.45 in chips)
Seat 8: 5iPk5MyO3KVu18Y8XCYfFQ ($39 in chips)
Seat 9: O+jytCilwk7zItVCEavmtw ($135 in chips)
M2ht6rIKOI/my9eh610Nlw: posts small blind $1
5iPk5MyO3KVu18Y8XCYfFQ: posts big blind $2
HffgoYm61KgkdMe/DYChIQ: posts big blind $2
*** HOLE CARDS ***
O+jytCilwk7zItVCEavmtw: raises $6 to $8
l1bCLGuFqeFRwUfPsiDu/g: folds
dJO4Wtu5e7hHBlpz0cmy1w: folds
L88dtdULfz5oGDSuo9/RvA: folds
HffgoYm61KgkdMe/DYChIQ: folds
Z3aYCZG/yXHYFjiWkGI5ug: folds
M2ht6rIKOI/my9eh610Nlw: folds
5iPk5MyO3KVu18Y8XCYfFQ: folds
O+jytCilwk7zItVCEavmtw collected $7 from pot
O+jytCilwk7zItVCEavmtw: doesn't show hand
*** SUMMARY ***
Total pot $7 | Rake $0
Seat 1: l1bCLGuFqeFRwUfPsiDu/g folded before Flop (didn't bet)
Seat 2: dJO4Wtu5e7hHBlpz0cmy1w folded before Flop (didn't bet)
Seat 3: L88dtdULfz5oGDSuo9/RvA folded before Flop (didn't bet)
Seat 4: HffgoYm61KgkdMe/DYChIQ folded before Flop
Seat 5: Z3aYCZG/yXHYFjiWkGI5ug (button) folded before Flop (didn't bet)
Seat 6: M2ht6rIKOI/my9eh610Nlw (small blind) folded before Flop
Seat 8: 5iPk5MyO3KVu18Y8XCYfFQ (big blind) folded before Flop
Seat 9: O+jytCilwk7zItVCEavmtw collected ($7)



PokerStars Game #59938038084:  Hold'em No Limit ($1/$2) - 2009/07/01 0:05:36 ET
Table 'jlrIxbrVIG+gjaUYT4za8g' 6-max Seat #5 is the button
Seat 1: ygTTt5ehT4aF86q1a8/R+w ($176.35 in chips)
Seat 2: N18PrNGQj43J7TJuQuu+tw ($151.05 in chips)
Seat 3: /PH6Ffnho4Ysm8S3V/oa+w ($80 in chips)
Seat 4: 8srN1dKQePlsv0GyTada+Q ($200 in chips)
Seat 5: F/075N6nU34Fn0zr6qD3aw ($168.55 in chips)
Seat 6: vkfxu8f/jMYKUk6Ly4eujw ($279.05 in chips)
vkfxu8f/jMYKUk6Ly4eujw: posts small blind $1
ygTTt5ehT4aF86q1a8/R+w: posts big blind $2
*** HOLE CARDS ***
N18PrNGQj43J7TJuQuu+tw: calls $2
/PH6Ffnho4Ysm8S3V/oa+w: folds
8srN1dKQePlsv0GyTada+Q: folds
F/075N6nU34Fn0zr6qD3aw: folds
vkfxu8f/jMYKUk6Ly4eujw: folds
ygTTt5ehT4aF86q1a8/R+w: checks
*** FLOP *** [6s Ah 7s]
ygTTt5ehT4aF86q1a8/R+w: checks
N18PrNGQj43J7TJuQuu+tw: bets $2
ygTTt5ehT4aF86q1a8/R+w: folds
N18PrNGQj43J7TJuQuu+tw collected $4.75 from pot
*** SUMMARY ***
Total pot $5 | Rake $0.25
Board [6s Ah 7s]
Seat 1: ygTTt5ehT4aF86q1a8/R+w (big blind) folded on the Flop
Seat 2: N18PrNGQj43J7TJuQuu+tw collected ($4.75)
Seat 3: /PH6Ffnho4Ysm8S3V/oa+w folded before Flop (didn't bet)
Seat 4: 8srN1dKQePlsv0GyTada+Q folded before Flop (didn't bet)
Seat 5: F/075N6nU34Fn0zr6qD3aw (button) folded before Flop (didn't bet)
Seat 6: vkfxu8f/jMYKUk6Ly4eujw (small blind) folded before Flop



PokerStars Game #59938038774:  Hold'em No Limit ($1/$2) - 2009/07/01 0:05:37 ET
Table 'bIihwBANJSFqlHPPtset+w' 9-max Seat #7 is the button
Seat 1: jI3JDUGV63ccqtKgM3vMbw ($148.60 in chips)
Seat 2: lQYT23h5QCUVZAKxjOO39Q ($127.90 in chips)
Seat 3: acnZ0LD5jxKgWIHz+mpQ8Q ($226.40 in chips)
Seat 4: 7WWX5PClBdr/U44gUKBIEA ($284.65 in chips)
Seat 5: GX1heJ+DSsvm7gzSPsYhhQ ($47.80 in chips)
Seat 6: 5iPk5MyO3KVu18Y8XCYfFQ ($39 in chips)
Seat 7: 3q2/0oJr3Mcy1W5tcN61ug ($200 in chips)
Seat 8: iMe5yhc+1BaiIPHet3NMrA ($200 in chips)
Seat 9: rW/MyplHylMSBRaoRUzWrg ($38.55 in chips)
iMe5yhc+1BaiIPHet3NMrA: posts small blind $1
rW/MyplHylMSBRaoRUzWrg: posts big blind $2
*** HOLE CARDS ***
jI3JDUGV63ccqtKgM3vMbw: folds
lQYT23h5QCUVZAKxjOO39Q: calls $2
acnZ0LD5jxKgWIHz+mpQ8Q: raises $7 to $9
7WWX5PClBdr/U44gUKBIEA: folds
GX1heJ+DSsvm7gzSPsYhhQ: calls $9
5iPk5MyO3KVu18Y8XCYfFQ: folds
3q2/0oJr3Mcy1W5tcN61ug: folds
iMe5yhc+1BaiIPHet3NMrA: folds
rW/MyplHylMSBRaoRUzWrg: folds
lQYT23h5QCUVZAKxjOO39Q: folds
*** FLOP *** [5c 8d 9s]
acnZ0LD5jxKgWIHz+mpQ8Q: checks
GX1heJ+DSsvm7gzSPsYhhQ: bets $12
acnZ0LD5jxKgWIHz+mpQ8Q: folds
GX1heJ+DSsvm7gzSPsYhhQ collected $21.85 from pot
GX1heJ+DSsvm7gzSPsYhhQ: doesn't show hand
*** SUMMARY ***
Total pot $23 | Rake $1.15
Board [5c 8d 9s]
Seat 1: jI3JDUGV63ccqtKgM3vMbw folded before Flop (didn't bet)
Seat 2: lQYT23h5QCUVZAKxjOO39Q folded before Flop
Seat 3: acnZ0LD5jxKgWIHz+mpQ8Q folded on the Flop
Seat 4: 7WWX5PClBdr/U44gUKBIEA folded before Flop (didn't bet)
Seat 5: GX1heJ+DSsvm7gzSPsYhhQ collected ($21.85)
Seat 6: 5iPk5MyO3KVu18Y8XCYfFQ folded before Flop (didn't bet)
Seat 7: 3q2/0oJr3Mcy1W5tcN61ug (button) folded before Flop (didn't bet)
Seat 8: iMe5yhc+1BaiIPHet3NMrA (small blind) folded before Flop
Seat 9: rW/MyplHylMSBRaoRUzWrg (big blind) folded before Flop



PokerStars Game #59938042390:  Hold'em No Limit ($1/$2) - 2009/07/01 0:05:42 ET
Table 'NmY84NAf9Mh0ckAckHnh5g' 2-max Seat #2 is the button
Seat 1: 6hvg964TSqZ3AL/0XK9aVQ ($375.70 in chips)
Seat 2: RwDoM55ZeQuI2ADyJhOb2Q ($220.30 in chips)
RwDoM55ZeQuI2ADyJhOb2Q: posts small blind $1
6hvg964TSqZ3AL/0XK9aVQ: posts big blind $2
*** HOLE CARDS ***
RwDoM55ZeQuI2ADyJhOb2Q: raises $2 to $4
6hvg964TSqZ3AL/0XK9aVQ: calls $2
*** FLOP *** [Ac Ts Qd]
6hvg964TSqZ3AL/0XK9aVQ: checks
RwDoM55ZeQuI2ADyJhOb2Q: bets $6
6hvg964TSqZ3AL/0XK9aVQ: calls $6
*** TURN *** [Ac Ts Qd] [Qh]
6hvg964TSqZ3AL/0XK9aVQ: checks
RwDoM55ZeQuI2ADyJhOb2Q: bets $22
6hvg964TSqZ3AL/0XK9aVQ: folds
RwDoM55ZeQuI2ADyJhOb2Q collected $19.50 from pot
RwDoM55ZeQuI2ADyJhOb2Q: doesn't show hand
*** SUMMARY ***
Total pot $20 | Rake $0.50
Board [Ac Ts Qd Qh]
Seat 1: 6hvg964TSqZ3AL/0XK9aVQ (big blind) folded on the Turn
Seat 2: RwDoM55ZeQuI2ADyJhOb2Q (button) (small blind) collected ($19.50)



PokerStars Game #59938045866:  Hold'em No Limit ($1/$2) - 2009/07/01 0:05:47 ET
Table 'gnHBqWll9O3fxG7Ojkz/ng' 9-max Seat #6 is the button
Seat 1: hpqdC/23wXosGOmzARr5NA ($160.30 in chips)
Seat 2: H6Z4+qu8gR0VUiPOijndVg ($200 in chips)
Seat 3: 5Q8U6iZbeO7xJSS4qvDP5g ($218.60 in chips)
Seat 4: n5XI5/7gN+gIubHFBH+mOw ($404.85 in chips)
Seat 5: GX1heJ+DSsvm7gzSPsYhhQ ($51.75 in chips)
Seat 6: 5iPk5MyO3KVu18Y8XCYfFQ ($37 in chips)
Seat 7: jqui3xAWCkcdPW36a6BD+w ($213.80 in chips)
Seat 8: De9g+AYjo0DN6C/+iT/nsg ($247.05 in chips)
Seat 9: kVCeGJ4NY7Fb0W74j1mAqA ($206 in chips)
jqui3xAWCkcdPW36a6BD+w: posts small blind $1
De9g+AYjo0DN6C/+iT/nsg: posts big blind $2
*** HOLE CARDS ***
kVCeGJ4NY7Fb0W74j1mAqA: folds
hpqdC/23wXosGOmzARr5NA: folds
H6Z4+qu8gR0VUiPOijndVg: folds
5Q8U6iZbeO7xJSS4qvDP5g: folds
n5XI5/7gN+gIubHFBH+mOw: folds
GX1heJ+DSsvm7gzSPsYhhQ: raises $4 to $6
5iPk5MyO3KVu18Y8XCYfFQ: folds
jqui3xAWCkcdPW36a6BD+w: folds
De9g+AYjo0DN6C/+iT/nsg: folds
GX1heJ+DSsvm7gzSPsYhhQ collected $5 from pot
GX1heJ+DSsvm7gzSPsYhhQ: doesn't show hand
*** SUMMARY ***
Total pot $5 | Rake $0
Seat 1: hpqdC/23wXosGOmzARr5NA folded before Flop (didn't bet)
Seat 2: H6Z4+qu8gR0VUiPOijndVg folded before Flop (didn't bet)
Seat 3: 5Q8U6iZbeO7xJSS4qvDP5g folded before Flop (didn't bet)
Seat 4: n5XI5/7gN+gIubHFBH+mOw folded before Flop (didn't bet)
Seat 5: GX1heJ+DSsvm7gzSPsYhhQ collected ($5)
Seat 6: 5iPk5MyO3KVu18Y8XCYfFQ (button) folded before Flop (didn't bet)
Seat 7: jqui3xAWCkcdPW36a6BD+w (small blind) folded before Flop
Seat 8: De9g+AYjo0DN6C/+iT/nsg (big blind) folded before Flop
Seat 9: kVCeGJ4NY7Fb0W74j1mAqA folded before Flop (didn't bet)



PokerStars Game #59938048838:  Hold'em No Limit ($1/$2) - 2009/07/01 0:05:51 ET
Table 'WCA60bDA8ecovUgFSIZkTQ' 9-max Seat #7 is the button
Seat 1: xNLmepWbCljNEEeH8O5jSg ($266.65 in chips)
Seat 2: G1h8wamBcVJXtsKXZQ2EyA ($46.70 in chips)
Seat 3: 5iPk5MyO3KVu18Y8XCYfFQ ($40 in chips)
Seat 4: Q3uFdu6ztesjDFiqkagTRQ ($484.70 in chips)
Seat 5: Hc2itIxwbi1lwa+DAYYQGg ($309.30 in chips)
Seat 6: DOWQSOJ7GaX+ksfWTqPT5A ($241.05 in chips)
Seat 7: GX1heJ+DSsvm7gzSPsYhhQ ($31 in chips)
Seat 8: x+V1JgVDawsJTxKcxm7gxw ($96 in chips)
Seat 9: 3q2/0oJr3Mcy1W5tcN61ug ($301.20 in chips)
x+V1JgVDawsJTxKcxm7gxw: posts small blind $1
3q2/0oJr3Mcy1W5tcN61ug: posts big blind $2
*** HOLE CARDS ***
xNLmepWbCljNEEeH8O5jSg: folds
G1h8wamBcVJXtsKXZQ2EyA: folds
5iPk5MyO3KVu18Y8XCYfFQ: folds
Q3uFdu6ztesjDFiqkagTRQ: folds
Hc2itIxwbi1lwa+DAYYQGg: folds
DOWQSOJ7GaX+ksfWTqPT5A: raises $4 to $6
GX1heJ+DSsvm7gzSPsYhhQ: folds
x+V1JgVDawsJTxKcxm7gxw: folds
3q2/0oJr3Mcy1W5tcN61ug: folds
DOWQSOJ7GaX+ksfWTqPT5A collected $5 from pot
DOWQSOJ7GaX+ksfWTqPT5A: doesn't show hand
*** SUMMARY ***
Total pot $5 | Rake $0
Seat 1: xNLmepWbCljNEEeH8O5jSg folded before Flop (didn't bet)
Seat 2: G1h8wamBcVJXtsKXZQ2EyA folded before Flop (didn't bet)
Seat 3: 5iPk5MyO3KVu18Y8XCYfFQ folded before Flop (didn't bet)
Seat 4: Q3uFdu6ztesjDFiqkagTRQ folded before Flop (didn't bet)
Seat 5: Hc2itIxwbi1lwa+DAYYQGg folded before Flop (didn't bet)
Seat 6: DOWQSOJ7GaX+ksfWTqPT5A collected ($5)
Seat 7: GX1heJ+DSsvm7gzSPsYhhQ (button) folded before Flop (didn't bet)
Seat 8: x+V1JgVDawsJTxKcxm7gxw (small blind) folded before Flop
Seat 9: 3q2/0oJr3Mcy1W5tcN61ug (big blind) folded before Flop



PokerStars Game #59938051676:  Hold'em No Limit ($1/$2) - 2009/07/01 0:05:54 ET
Table 'HewZCzVOYGmuLDKthTi5Yw' 6-max Seat #4 is the button
Seat 1: 353332 ($235.75 in chips)
Seat 2: X7GlkHF+lkbarCLuZ4Uf0w ($39 in chips)
Seat 3: WJxW31eStwT28R2X/L8F5A ($53.50 in chips)
Seat 4: yZgdnRylE65JbScQ7qCWgw ($32 in chips)
Seat 5: 513FcCI8jHyQy2VWoIQkMg ($369.50 in chips)
513FcCI8jHyQy2VWoIQkMg: posts small blind $1
353332: posts big blind $2
*** HOLE CARDS ***
X7GlkHF+lkbarCLuZ4Uf0w: folds
WJxW31eStwT28R2X/L8F5A: folds
yZgdnRylE65JbScQ7qCWgw: folds
513FcCI8jHyQy2VWoIQkMg: raises $4 to $6
353332: folds
513FcCI8jHyQy2VWoIQkMg collected $4 from pot
*** SUMMARY ***
Total pot $4 | Rake $0
Seat 1: 353332 (big blind) folded before Flop
Seat 2: X7GlkHF+lkbarCLuZ4Uf0w folded before Flop (didn't bet)
Seat 3: WJxW31eStwT28R2X/L8F5A folded before Flop (didn't bet)
Seat 4: yZgdnRylE65JbScQ7qCWgw (button) folded before Flop (didn't bet)
Seat 5: 513FcCI8jHyQy2VWoIQkMg (small blind) collected ($4)



PokerStars Game #59938053330:  Hold'em No Limit ($1/$2) - 2009/07/01 0:05:57 ET
Table 'uJ9juaXXg9yIcSU8amxaXQ' 6-max Seat #5 is the button
Seat 1: HhIxv6mylwCAfv3sjJmq5g ($200 in chips)
Seat 2: DQlskgG4OtLpF2MVxLwf4A ($284.05 in chips)
Seat 3: zaogaltCDFVsIASEnrXs2w ($256.75 in chips)
Seat 4: 54yWzRRgS0oZ+S6LwZBxMQ ($32 in chips)
Seat 5: X7GlkHF+lkbarCLuZ4Uf0w ($48 in chips)
Seat 6: XrFG4dK06RVKLlX32/pjcQ ($77.40 in chips)
XrFG4dK06RVKLlX32/pjcQ: posts small blind $1
HhIxv6mylwCAfv3sjJmq5g: posts big blind $2
*** HOLE CARDS ***
DQlskgG4OtLpF2MVxLwf4A: folds
zaogaltCDFVsIASEnrXs2w: raises $4 to $6
54yWzRRgS0oZ+S6LwZBxMQ: folds
X7GlkHF+lkbarCLuZ4Uf0w: folds
XrFG4dK06RVKLlX32/pjcQ: folds
HhIxv6mylwCAfv3sjJmq5g: folds
zaogaltCDFVsIASEnrXs2w collected $5 from pot
*** SUMMARY ***
Total pot $5 | Rake $0
Seat 1: HhIxv6mylwCAfv3sjJmq5g (big blind) folded before Flop
Seat 2: DQlskgG4OtLpF2MVxLwf4A folded before Flop (didn't bet)
Seat 3: zaogaltCDFVsIASEnrXs2w collected ($5)
Seat 4: 54yWzRRgS0oZ+S6LwZBxMQ folded before Flop (didn't bet)
Seat 5: X7GlkHF+lkbarCLuZ4Uf0w (button) folded before Flop (didn't bet)
Seat 6: XrFG4dK06RVKLlX32/pjcQ (small blind) folded before Flop



PokerStars Game #59938054334:  Hold'em No Limit ($1/$2) - 2009/07/01 0:05:58 ET
Table 'eyAQSIlgc2o1Jxvbve4WGg' 9-max Seat #4 is the button
Seat 1: Q3uFdu6ztesjDFiqkagTRQ ($237 in chips)
Seat 2: GX1heJ+DSsvm7gzSPsYhhQ ($39 in chips)
Seat 3: TAfo4veNRaRlzDXMMYS3Jg ($37 in chips)
Seat 4: Lr5OlNr2kebm3oHSC54eJg ($112.25 in chips)
Seat 6: IikcENBHwoT7snSvBPSc7Q ($175.85 in chips)
Seat 7: QHxJjpVYwitg9krW6wZgJA ($203 in chips)
Seat 8: 5iPk5MyO3KVu18Y8XCYfFQ ($39 in chips)
Seat 9: Hc2itIxwbi1lwa+DAYYQGg ($50.85 in chips)
JnV3SM2D6dAFYyGZHHpvrg will be allowed to play after the button
IikcENBHwoT7snSvBPSc7Q: posts small blind $1
QHxJjpVYwitg9krW6wZgJA: posts big blind $2
*** HOLE CARDS ***
5iPk5MyO3KVu18Y8XCYfFQ: folds
Hc2itIxwbi1lwa+DAYYQGg: folds
Q3uFdu6ztesjDFiqkagTRQ: folds
GX1heJ+DSsvm7gzSPsYhhQ: folds
TAfo4veNRaRlzDXMMYS3Jg: folds
Lr5OlNr2kebm3oHSC54eJg: calls $2
IikcENBHwoT7snSvBPSc7Q: calls $1
QHxJjpVYwitg9krW6wZgJA: checks
*** FLOP *** [3d 6c 3h]
IikcENBHwoT7snSvBPSc7Q: checks
QHxJjpVYwitg9krW6wZgJA: checks
Lr5OlNr2kebm3oHSC54eJg: bets $4
IikcENBHwoT7snSvBPSc7Q: folds
QHxJjpVYwitg9krW6wZgJA: folds
Lr5OlNr2kebm3oHSC54eJg collected $5.70 from pot
Lr5OlNr2kebm3oHSC54eJg: doesn't show hand
*** SUMMARY ***
Total pot $6 | Rake $0.30
Board [3d 6c 3h]
Seat 1: Q3uFdu6ztesjDFiqkagTRQ folded before Flop (didn't bet)
Seat 2: GX1heJ+DSsvm7gzSPsYhhQ folded before Flop (didn't bet)
Seat 3: TAfo4veNRaRlzDXMMYS3Jg folded before Flop (didn't bet)
Seat 4: Lr5OlNr2kebm3oHSC54eJg (button) collected ($5.70)
Seat 6: IikcENBHwoT7snSvBPSc7Q (small blind) folded on the Flop
Seat 7: QHxJjpVYwitg9krW6wZgJA (big blind) folded on the Flop
Seat 8: 5iPk5MyO3KVu18Y8XCYfFQ folded before Flop (didn't bet)
Seat 9: Hc2itIxwbi1lwa+DAYYQGg folded before Flop (didn't bet)



PokerStars Game #59938054842:  Hold'em No Limit ($1/$2) - 2009/07/01 0:05:59 ET
Table '3FGoiEOffWrbgTfsB3t7FA' 2-max Seat #1 is the button
Seat 1: e0oDWyrmgLpR6bROEqw1nQ ($429.50 in chips)
Seat 2: +sy/nlNI20yZraIjs4AALg ($176.05 in chips)
e0oDWyrmgLpR6bROEqw1nQ: posts small blind $1
+sy/nlNI20yZraIjs4AALg: posts big blind $2
*** HOLE CARDS ***
e0oDWyrmgLpR6bROEqw1nQ: raises $4 to $6
+sy/nlNI20yZraIjs4AALg: calls $4
*** FLOP *** [9c Qd Jd]
+sy/nlNI20yZraIjs4AALg: checks
e0oDWyrmgLpR6bROEqw1nQ: checks
*** TURN *** [9c Qd Jd] [4d]
+sy/nlNI20yZraIjs4AALg: bets $8
e0oDWyrmgLpR6bROEqw1nQ: calls $8
*** RIVER *** [9c Qd Jd 4d] [8s]
+sy/nlNI20yZraIjs4AALg: bets $20
e0oDWyrmgLpR6bROEqw1nQ: folds
+sy/nlNI20yZraIjs4AALg collected $27.50 from pot
*** SUMMARY ***
Total pot $28 | Rake $0.50
Board [9c Qd Jd 4d 8s]
Seat 1: e0oDWyrmgLpR6bROEqw1nQ (button) (small blind) folded on the River
Seat 2: +sy/nlNI20yZraIjs4AALg (big blind) collected ($27.50)



PokerStars Game #59938056058:  Hold'em No Limit ($1/$2) - 2009/07/01 0:06:01 ET
Table 'srul5UFZXTEccVV5fpY91g' 9-max Seat #9 is the button
Seat 1: lfD8cBv31A/pio3pXJbPjA ($152.20 in chips)
Seat 2: tJYod1SLp2AcWPL/3hZ7ug ($152.20 in chips)
Seat 3: weUZ8S7tgbaeIpzi1gBNxQ ($48 in chips)
Seat 4: GG5lTuGt3+kwNYSbqeB6yw ($8 in chips)
Seat 5: 5iPk5MyO3KVu18Y8XCYfFQ ($46.10 in chips)
Seat 6: TAfo4veNRaRlzDXMMYS3Jg ($34 in chips)
Seat 7: s0erZsDxbZSaEPheMgibKg ($447.40 in chips)
Seat 8: jqICkNBEBjVScJ1iibba8Q ($277.65 in chips)
Seat 9: GX1heJ+DSsvm7gzSPsYhhQ ($94 in chips)
lfD8cBv31A/pio3pXJbPjA: posts small blind $1
tJYod1SLp2AcWPL/3hZ7ug: posts big blind $2
*** HOLE CARDS ***
weUZ8S7tgbaeIpzi1gBNxQ: raises $4 to $6
GG5lTuGt3+kwNYSbqeB6yw: folds
5iPk5MyO3KVu18Y8XCYfFQ: folds
TAfo4veNRaRlzDXMMYS3Jg: folds
s0erZsDxbZSaEPheMgibKg: folds
jqICkNBEBjVScJ1iibba8Q: folds
GX1heJ+DSsvm7gzSPsYhhQ: folds
lfD8cBv31A/pio3pXJbPjA: calls $5
tJYod1SLp2AcWPL/3hZ7ug: calls $4
*** FLOP *** [4h 4d 8c]
lfD8cBv31A/pio3pXJbPjA: checks
tJYod1SLp2AcWPL/3hZ7ug: checks
weUZ8S7tgbaeIpzi1gBNxQ: checks
*** TURN *** [4h 4d 8c] [Jc]
lfD8cBv31A/pio3pXJbPjA: bets $12
tJYod1SLp2AcWPL/3hZ7ug: calls $12
weUZ8S7tgbaeIpzi1gBNxQ: folds
*** RIVER *** [4h 4d 8c Jc] [Ts]
lfD8cBv31A/pio3pXJbPjA: bets $22
tJYod1SLp2AcWPL/3hZ7ug: calls $22
*** SHOW DOWN ***
lfD8cBv31A/pio3pXJbPjA: shows [Qc Qs] (two pair, Queens and Fours)
tJYod1SLp2AcWPL/3hZ7ug: mucks hand
lfD8cBv31A/pio3pXJbPjA collected $83 from pot
*** SUMMARY ***
Total pot $86 | Rake $3
Board [4h 4d 8c Jc Ts]
Seat 1: lfD8cBv31A/pio3pXJbPjA (small blind) showed [Qc Qs] and won ($83) with two pair, Queens and Fours
Seat 2: tJYod1SLp2AcWPL/3hZ7ug (big blind) mucked
Seat 3: weUZ8S7tgbaeIpzi1gBNxQ folded on the Turn
Seat 4: GG5lTuGt3+kwNYSbqeB6yw folded before Flop (didn't bet)
Seat 5: 5iPk5MyO3KVu18Y8XCYfFQ folded before Flop (didn't bet)
Seat 6: TAfo4veNRaRlzDXMMYS3Jg folded before Flop (didn't bet)
Seat 7: s0erZsDxbZSaEPheMgibKg folded before Flop (didn't bet)
Seat 8: jqICkNBEBjVScJ1iibba8Q folded before Flop (didn't bet)
Seat 9: GX1heJ+DSsvm7gzSPsYhhQ (button) folded before Flop (didn't bet)



PokerStars Game #59938057958:  Hold'em No Limit ($1/$2) - 2009/07/01 0:06:03 ET
Table 'qVXak+oTeDXMGbWa4sDU5Q' 9-max Seat #2 is the button
Seat 1: H6Z4+qu8gR0VUiPOijndVg ($250 in chips)
Seat 2: Hc2itIxwbi1lwa+DAYYQGg ($49 in chips)
Seat 3: oz9eCXGC7DdjQlL/nuWj1A ($103.85 in chips)
Seat 4: b0jO1SDhLedy1//CQlA8kw ($40 in chips)
Seat 6: Q3uFdu6ztesjDFiqkagTRQ ($241.65 in chips)
Seat 7: 5iPk5MyO3KVu18Y8XCYfFQ ($59.50 in chips)
Seat 8: 9pHZMviI9R8injxojGTnvw ($58.85 in chips)
Seat 9: IZ/2qsh1CIg9m5PWsMsLmA ($360.95 in chips)
oz9eCXGC7DdjQlL/nuWj1A: posts small blind $1
b0jO1SDhLedy1//CQlA8kw: posts big blind $2
*** HOLE CARDS ***
Q3uFdu6ztesjDFiqkagTRQ: raises $4 to $6
5iPk5MyO3KVu18Y8XCYfFQ: folds
9pHZMviI9R8injxojGTnvw: folds
IZ/2qsh1CIg9m5PWsMsLmA: folds
H6Z4+qu8gR0VUiPOijndVg: folds
Hc2itIxwbi1lwa+DAYYQGg: folds
oz9eCXGC7DdjQlL/nuWj1A: folds
b0jO1SDhLedy1//CQlA8kw: folds
Q3uFdu6ztesjDFiqkagTRQ collected $5 from pot
Q3uFdu6ztesjDFiqkagTRQ: doesn't show hand
*** SUMMARY ***
Total pot $5 | Rake $0
Seat 1: H6Z4+qu8gR0VUiPOijndVg folded before Flop (didn't bet)
Seat 2: Hc2itIxwbi1lwa+DAYYQGg (button) folded before Flop (didn't bet)
Seat 3: oz9eCXGC7DdjQlL/nuWj1A (small blind) folded before Flop
Seat 4: b0jO1SDhLedy1//CQlA8kw (big blind) folded before Flop
Seat 6: Q3uFdu6ztesjDFiqkagTRQ collected ($5)
Seat 7: 5iPk5MyO3KVu18Y8XCYfFQ folded before Flop (didn't bet)
Seat 8: 9pHZMviI9R8injxojGTnvw folded before Flop (didn't bet)
Seat 9: IZ/2qsh1CIg9m5PWsMsLmA folded before Flop (didn't bet)



PokerStars Game #59938058788:  Hold'em No Limit ($1/$2) - 2009/07/01 0:06:04 ET
Table 'l5lZHc5JRHEDt0Y2AVPq3g' 6-max Seat #2 is the button
Seat 1: gGPaCoSWW1HoKYaqfAPecg ($203.30 in chips)
Seat 2: my38j/MmtBd/8qVwmyCREA ($222.40 in chips)
Seat 3: yZgdnRylE65JbScQ7qCWgw ($38 in chips)
Seat 4: zNjJ/y4emmF+vzrCDd+ooA ($206.95 in chips)
Seat 5: 6fLdOUCRtX71xbVRhJEq8w ($200 in chips)
Seat 6: vkfxu8f/jMYKUk6Ly4eujw ($200.90 in chips)
yZgdnRylE65JbScQ7qCWgw: posts small blind $1
zNjJ/y4emmF+vzrCDd+ooA: posts big blind $2
*** HOLE CARDS ***
6fLdOUCRtX71xbVRhJEq8w: folds
vkfxu8f/jMYKUk6Ly4eujw: folds
gGPaCoSWW1HoKYaqfAPecg: folds
my38j/MmtBd/8qVwmyCREA: raises $4 to $6
yZgdnRylE65JbScQ7qCWgw: raises $32 to $38 and is all-in
zNjJ/y4emmF+vzrCDd+ooA: folds
my38j/MmtBd/8qVwmyCREA: calls $32
*** FLOP *** [9d 5h 6h]
*** TURN *** [9d 5h 6h] [Ah]
*** RIVER *** [9d 5h 6h Ah] [3c]
*** SHOW DOWN ***
yZgdnRylE65JbScQ7qCWgw: shows [Ts Th] (a pair of Tens)
my38j/MmtBd/8qVwmyCREA: shows [Qd Qc] (a pair of Queens)
my38j/MmtBd/8qVwmyCREA collected $75 from pot
*** SUMMARY ***
Total pot $78 | Rake $3
Board [9d 5h 6h Ah 3c]
Seat 1: gGPaCoSWW1HoKYaqfAPecg folded before Flop (didn't bet)
Seat 2: my38j/MmtBd/8qVwmyCREA (button) showed [Qd Qc] and won ($75) with a pair of Queens
Seat 3: yZgdnRylE65JbScQ7qCWgw (small blind) showed [Ts Th] and lost with a pair of Tens
Seat 4: zNjJ/y4emmF+vzrCDd+ooA (big blind) folded before Flop
Seat 5: 6fLdOUCRtX71xbVRhJEq8w folded before Flop (didn't bet)
Seat 6: vkfxu8f/jMYKUk6Ly4eujw folded before Flop (didn't bet)



PokerStars Game #59938058338:  Hold'em No Limit ($1/$2) - 2009/07/01 0:06:04 ET
Table 'LL4bDFyhj5hsMpzaDugJZg' 6-max Seat #2 is the button
Seat 1: IBW9lyGsaRmfcbyA/qFfEw ($78.20 in chips)
Seat 2: L3l+A4pJhOAD6HVVFXvVBw ($289.15 in chips)
Seat 3: gGPaCoSWW1HoKYaqfAPecg ($200 in chips)
Seat 4: 8srN1dKQePlsv0GyTada+Q ($254.35 in chips)
Seat 5: HgX0VeqE/dzSXd5BpntRBw ($200 in chips)
Seat 6: yZgdnRylE65JbScQ7qCWgw ($28 in chips)
gGPaCoSWW1HoKYaqfAPecg: posts small blind $1
8srN1dKQePlsv0GyTada+Q: posts big blind $2
*** HOLE CARDS ***
HgX0VeqE/dzSXd5BpntRBw: folds
yZgdnRylE65JbScQ7qCWgw: raises $26 to $28 and is all-in
IBW9lyGsaRmfcbyA/qFfEw: folds
L3l+A4pJhOAD6HVVFXvVBw: folds
gGPaCoSWW1HoKYaqfAPecg: folds
8srN1dKQePlsv0GyTada+Q: calls $26
*** FLOP *** [7h 5d Tc]
*** TURN *** [7h 5d Tc] [Jh]
*** RIVER *** [7h 5d Tc Jh] [9s]
*** SHOW DOWN ***
8srN1dKQePlsv0GyTada+Q: shows [5s 5h] (three of a kind, Fives)
yZgdnRylE65JbScQ7qCWgw: mucks hand
8srN1dKQePlsv0GyTada+Q collected $54.15 from pot
*** SUMMARY ***
Total pot $57 | Rake $2.85
Board [7h 5d Tc Jh 9s]
Seat 1: IBW9lyGsaRmfcbyA/qFfEw folded before Flop (didn't bet)
Seat 2: L3l+A4pJhOAD6HVVFXvVBw (button) folded before Flop (didn't bet)
Seat 3: gGPaCoSWW1HoKYaqfAPecg (small blind) folded before Flop
Seat 4: 8srN1dKQePlsv0GyTada+Q (big blind) showed [5s 5h] and won ($54.15) with three of a kind, Fives
Seat 5: HgX0VeqE/dzSXd5BpntRBw folded before Flop (didn't bet)
Seat 6: yZgdnRylE65JbScQ7qCWgw mucked



PokerStars Game #59938061512:  Hold'em No Limit ($1/$2) - 2009/07/01 0:06:08 ET
Table 'rsKRKlGHlxVyqJxzO2a2Ow' 9-max Seat #6 is the button
Seat 1: uYWfQJg2hgHLxri6/uVJiw ($135.50 in chips)
Seat 2: QHxJjpVYwitg9krW6wZgJA ($244 in chips)
Seat 3: 9sYbXdhj1M2bwKrVNxj5+Q ($145.80 in chips)
Seat 4: zJtQ1gxyi72XvGYS1tM+DA ($156.30 in chips)
Seat 5: 5Q8U6iZbeO7xJSS4qvDP5g ($200 in chips)
Seat 6: H6Z4+qu8gR0VUiPOijndVg ($200 in chips)
Seat 7: kVCeGJ4NY7Fb0W74j1mAqA ($200 in chips)
Seat 8: Hc2itIxwbi1lwa+DAYYQGg ($40 in chips)
Seat 9: 5iPk5MyO3KVu18Y8XCYfFQ ($96.20 in chips)
kVCeGJ4NY7Fb0W74j1mAqA: posts small blind $1
Hc2itIxwbi1lwa+DAYYQGg: posts big blind $2
*** HOLE CARDS ***
5iPk5MyO3KVu18Y8XCYfFQ: folds
uYWfQJg2hgHLxri6/uVJiw: folds
QHxJjpVYwitg9krW6wZgJA: folds
9sYbXdhj1M2bwKrVNxj5+Q: folds
zJtQ1gxyi72XvGYS1tM+DA: folds
5Q8U6iZbeO7xJSS4qvDP5g: raises $4 to $6
H6Z4+qu8gR0VUiPOijndVg: folds
kVCeGJ4NY7Fb0W74j1mAqA: folds
Hc2itIxwbi1lwa+DAYYQGg: folds
5Q8U6iZbeO7xJSS4qvDP5g collected $5 from pot
5Q8U6iZbeO7xJSS4qvDP5g: doesn't show hand
*** SUMMARY ***
Total pot $5 | Rake $0
Seat 1: uYWfQJg2hgHLxri6/uVJiw folded before Flop (didn't bet)
Seat 2: QHxJjpVYwitg9krW6wZgJA folded before Flop (didn't bet)
Seat 3: 9sYbXdhj1M2bwKrVNxj5+Q folded before Flop (didn't bet)
Seat 4: zJtQ1gxyi72XvGYS1tM+DA folded before Flop (didn't bet)
Seat 5: 5Q8U6iZbeO7xJSS4qvDP5g collected ($5)
Seat 6: H6Z4+qu8gR0VUiPOijndVg (button) folded before Flop (didn't bet)
Seat 7: kVCeGJ4NY7Fb0W74j1mAqA (small blind) folded before Flop
Seat 8: Hc2itIxwbi1lwa+DAYYQGg (big blind) folded before Flop
Seat 9: 5iPk5MyO3KVu18Y8XCYfFQ folded before Flop (didn't bet)



PokerStars Game #59938061772:  Hold'em No Limit ($1/$2) - 2009/07/01 0:06:09 ET
Table 'fe+AlpfadsfwxhZEvYFbbA' 6-max Seat #5 is the button
Seat 1: SLlqn2PPbQqwfcLfYqUXrw ($85.85 in chips)
Seat 2: /PH6Ffnho4Ysm8S3V/oa+w ($40 in chips)
Seat 3: 54yWzRRgS0oZ+S6LwZBxMQ ($61 in chips)
Seat 5: gGPaCoSWW1HoKYaqfAPecg ($200 in chips)
Seat 6: 5Y+ZGWLI4gnlpApDX5vy1A ($204.55 in chips)
5Y+ZGWLI4gnlpApDX5vy1A: posts small blind $1
SLlqn2PPbQqwfcLfYqUXrw: posts big blind $2
F/075N6nU34Fn0zr6qD3aw: sits out
*** HOLE CARDS ***
/PH6Ffnho4Ysm8S3V/oa+w: folds
54yWzRRgS0oZ+S6LwZBxMQ: folds
gGPaCoSWW1HoKYaqfAPecg: raises $5 to $7
5Y+ZGWLI4gnlpApDX5vy1A: folds
SLlqn2PPbQqwfcLfYqUXrw: calls $5
*** FLOP *** [3h Ks Jc]
SLlqn2PPbQqwfcLfYqUXrw: checks
gGPaCoSWW1HoKYaqfAPecg: checks
*** TURN *** [3h Ks Jc] [6d]
SLlqn2PPbQqwfcLfYqUXrw: bets $6
gGPaCoSWW1HoKYaqfAPecg: raises $14 to $20
SLlqn2PPbQqwfcLfYqUXrw: calls $14
*** RIVER *** [3h Ks Jc 6d] [5s]
SLlqn2PPbQqwfcLfYqUXrw: checks
gGPaCoSWW1HoKYaqfAPecg: bets $173 and is all-in
SLlqn2PPbQqwfcLfYqUXrw: folds
gGPaCoSWW1HoKYaqfAPecg collected $53 from pot
gGPaCoSWW1HoKYaqfAPecg: doesn't show hand
*** SUMMARY ***
Total pot $55 | Rake $2
Board [3h Ks Jc 6d 5s]
Seat 1: SLlqn2PPbQqwfcLfYqUXrw (big blind) folded on the River
Seat 2: /PH6Ffnho4Ysm8S3V/oa+w folded before Flop (didn't bet)
Seat 3: 54yWzRRgS0oZ+S6LwZBxMQ folded before Flop (didn't bet)
Seat 5: gGPaCoSWW1HoKYaqfAPecg (button) collected ($53)
Seat 6: 5Y+ZGWLI4gnlpApDX5vy1A (small blind) folded before Flop



PokerStars Game #59938062476:  Hold'em No Limit ($1/$2) - 2009/07/01 0:06:10 ET
Table 'NmY84NAf9Mh0ckAckHnh5g' 2-max Seat #1 is the button
Seat 1: 6hvg964TSqZ3AL/0XK9aVQ ($365.70 in chips)
Seat 2: RwDoM55ZeQuI2ADyJhOb2Q ($229.80 in chips)
6hvg964TSqZ3AL/0XK9aVQ: posts small blind $1
RwDoM55ZeQuI2ADyJhOb2Q: posts big blind $2
*** HOLE CARDS ***
6hvg964TSqZ3AL/0XK9aVQ: folds
RwDoM55ZeQuI2ADyJhOb2Q collected $2 from pot
RwDoM55ZeQuI2ADyJhOb2Q: doesn't show hand
*** SUMMARY ***
Total pot $2 | Rake $0
Seat 1: 6hvg964TSqZ3AL/0XK9aVQ (button) (small blind) folded before Flop
Seat 2: RwDoM55ZeQuI2ADyJhOb2Q (big blind) collected ($2)



PokerStars Game #59938063454:  Hold'em No Limit ($1/$2) - 2009/07/01 0:06:11 ET
Table 'aSf77Sj8QEnzcc0WaxVD4Q' 6-max Seat #5 is the button
Seat 1: Q3uFdu6ztesjDFiqkagTRQ ($227.55 in chips)
Seat 2: vkfxu8f/jMYKUk6Ly4eujw ($198.75 in chips)
Seat 3: 9dpyyjDTCed6nV7JhaUUpw ($220.05 in chips)
Seat 4: 513FcCI8jHyQy2VWoIQkMg ($200 in chips)
Seat 5: InmkdI6G8TzSj9NhcCSyPg ($269 in chips)
Seat 6: vkoJRf3gidxY1pPi0AFWww ($311.80 in chips)
vkoJRf3gidxY1pPi0AFWww: posts small blind $1
Q3uFdu6ztesjDFiqkagTRQ: posts big blind $2
*** HOLE CARDS ***
vkfxu8f/jMYKUk6Ly4eujw: folds
9dpyyjDTCed6nV7JhaUUpw: folds
513FcCI8jHyQy2VWoIQkMg: folds
InmkdI6G8TzSj9NhcCSyPg: folds
vkoJRf3gidxY1pPi0AFWww: calls $1
Q3uFdu6ztesjDFiqkagTRQ: checks
*** FLOP *** [5h Ad 3c]
vkoJRf3gidxY1pPi0AFWww: checks
Q3uFdu6ztesjDFiqkagTRQ: checks
*** TURN *** [5h Ad 3c] [Js]
vkoJRf3gidxY1pPi0AFWww: checks
Q3uFdu6ztesjDFiqkagTRQ: checks
*** RIVER *** [5h Ad 3c Js] [Ac]
vkoJRf3gidxY1pPi0AFWww: checks
Q3uFdu6ztesjDFiqkagTRQ: checks
*** SHOW DOWN ***
vkoJRf3gidxY1pPi0AFWww: shows [7c 4d] (a pair of Aces)
Q3uFdu6ztesjDFiqkagTRQ: shows [Th 5d] (two pair, Aces and Fives)
Q3uFdu6ztesjDFiqkagTRQ collected $3.80 from pot
*** SUMMARY ***
Total pot $4 | Rake $0.20
Board [5h Ad 3c Js Ac]
Seat 1: Q3uFdu6ztesjDFiqkagTRQ (big blind) showed [Th 5d] and won ($3.80) with two pair, Aces and Fives
Seat 2: vkfxu8f/jMYKUk6Ly4eujw folded before Flop (didn't bet)
Seat 3: 9dpyyjDTCed6nV7JhaUUpw folded before Flop (didn't bet)
Seat 4: 513FcCI8jHyQy2VWoIQkMg folded before Flop (didn't bet)
Seat 5: InmkdI6G8TzSj9NhcCSyPg (button) folded before Flop (didn't bet)
Seat 6: vkoJRf3gidxY1pPi0AFWww (small blind) showed [7c 4d] and lost with a pair of Aces



PokerStars Game #59938064980:  Hold'em No Limit ($1/$2) - 2009/07/01 0:06:13 ET
Table 'on4i1U1lCRmxsduFD3xiSg' 9-max Seat #5 is the button
Seat 1: BRHGptvmY2GKq4uuj7duDw ($310.60 in chips)
Seat 2: yZYrOeNDxQxkzpbgKX1bng ($64 in chips)
Seat 3: 5iPk5MyO3KVu18Y8XCYfFQ ($64.20 in chips)
Seat 4: Z3aYCZG/yXHYFjiWkGI5ug ($223.55 in chips)
Seat 5: QHxJjpVYwitg9krW6wZgJA ($200 in chips)
Seat 6: SB0tvOX0Kw61r2U851JFaA ($367.20 in chips)
Seat 7: xD4ElYxz6Ollzmam8BmMCw ($247.25 in chips)
Seat 8: YlSX2xwu8QMQReaxSAD8XA ($148.85 in chips)
Seat 9: iMe5yhc+1BaiIPHet3NMrA ($203 in chips)
SB0tvOX0Kw61r2U851JFaA: posts small blind $1
xD4ElYxz6Ollzmam8BmMCw: posts big blind $2
*** HOLE CARDS ***
YlSX2xwu8QMQReaxSAD8XA: folds
YlSX2xwu8QMQReaxSAD8XA leaves the table
iMe5yhc+1BaiIPHet3NMrA: folds
BRHGptvmY2GKq4uuj7duDw: folds
yZYrOeNDxQxkzpbgKX1bng: folds
cdC54j9fGGojcbzWB5PgzA joins the table at seat #8
5iPk5MyO3KVu18Y8XCYfFQ: folds
Z3aYCZG/yXHYFjiWkGI5ug: raises $4 to $6
QHxJjpVYwitg9krW6wZgJA: folds
SB0tvOX0Kw61r2U851JFaA: raises $12 to $18
xD4ElYxz6Ollzmam8BmMCw: folds
Z3aYCZG/yXHYFjiWkGI5ug: calls $12
*** FLOP *** [6s Td Kc]
SB0tvOX0Kw61r2U851JFaA: checks
Z3aYCZG/yXHYFjiWkGI5ug: bets $24
SB0tvOX0Kw61r2U851JFaA: calls $24
*** TURN *** [6s Td Kc] [7s]
SB0tvOX0Kw61r2U851JFaA: checks
Z3aYCZG/yXHYFjiWkGI5ug: checks
*** RIVER *** [6s Td Kc 7s] [Ts]
SB0tvOX0Kw61r2U851JFaA: checks
Z3aYCZG/yXHYFjiWkGI5ug: bets $66
SB0tvOX0Kw61r2U851JFaA: raises $66 to $132
Z3aYCZG/yXHYFjiWkGI5ug: raises $49.55 to $181.55 and is all-in
SB0tvOX0Kw61r2U851JFaA: calls $49.55
*** SHOW DOWN ***
Z3aYCZG/yXHYFjiWkGI5ug: shows [9c Tc] (three of a kind, Tens)
SB0tvOX0Kw61r2U851JFaA: mucks hand
Z3aYCZG/yXHYFjiWkGI5ug collected $446.10 from pot
*** SUMMARY ***
Total pot $449.10 | Rake $3
Board [6s Td Kc 7s Ts]
Seat 1: BRHGptvmY2GKq4uuj7duDw folded before Flop (didn't bet)
Seat 2: yZYrOeNDxQxkzpbgKX1bng folded before Flop (didn't bet)
Seat 3: 5iPk5MyO3KVu18Y8XCYfFQ folded before Flop (didn't bet)
Seat 4: Z3aYCZG/yXHYFjiWkGI5ug showed [9c Tc] and won ($446.10) with three of a kind, Tens
Seat 5: QHxJjpVYwitg9krW6wZgJA (button) folded before Flop (didn't bet)
Seat 6: SB0tvOX0Kw61r2U851JFaA (small blind) mucked
Seat 7: xD4ElYxz6Ollzmam8BmMCw (big blind) folded before Flop
Seat 8: YlSX2xwu8QMQReaxSAD8XA folded before Flop (didn't bet)
Seat 9: iMe5yhc+1BaiIPHet3NMrA folded before Flop (didn't bet)



PokerStars Game #59938065804:  Hold'em No Limit ($1/$2) - 2009/07/01 0:06:14 ET
Table 'pPQgcj9XT9CHBsbo1WTBug' 6-max Seat #3 is the button
Seat 1: DFVYDA6dKQy7R7mGIKogZA ($119.30 in chips)
Seat 2: X7GlkHF+lkbarCLuZ4Uf0w ($44 in chips)
Seat 3: vkfxu8f/jMYKUk6Ly4eujw ($193 in chips)
Seat 5: 4Cl43Q1TYQL8wn1NSCUkaw ($53.60 in chips)
Seat 6: yZgdnRylE65JbScQ7qCWgw ($35 in chips)
4Cl43Q1TYQL8wn1NSCUkaw: posts small blind $1
yZgdnRylE65JbScQ7qCWgw: posts big blind $2
*** HOLE CARDS ***
DFVYDA6dKQy7R7mGIKogZA: folds
X7GlkHF+lkbarCLuZ4Uf0w: folds
vkfxu8f/jMYKUk6Ly4eujw: folds
4Cl43Q1TYQL8wn1NSCUkaw: calls $1
yZgdnRylE65JbScQ7qCWgw: checks
*** FLOP *** [Ks 8c As]
4Cl43Q1TYQL8wn1NSCUkaw: checks
yZgdnRylE65JbScQ7qCWgw: checks
*** TURN *** [Ks 8c As] [2s]
4Cl43Q1TYQL8wn1NSCUkaw: checks
yZgdnRylE65JbScQ7qCWgw: checks
*** RIVER *** [Ks 8c As 2s] [Kc]
4Cl43Q1TYQL8wn1NSCUkaw: bets $4
yZgdnRylE65JbScQ7qCWgw: folds
4Cl43Q1TYQL8wn1NSCUkaw collected $3.80 from pot
*** SUMMARY ***
Total pot $4 | Rake $0.20
Board [Ks 8c As 2s Kc]
Seat 1: DFVYDA6dKQy7R7mGIKogZA folded before Flop (didn't bet)
Seat 2: X7GlkHF+lkbarCLuZ4Uf0w folded before Flop (didn't bet)
Seat 3: vkfxu8f/jMYKUk6Ly4eujw (button) folded before Flop (didn't bet)
Seat 5: 4Cl43Q1TYQL8wn1NSCUkaw (small blind) collected ($3.80)
Seat 6: yZgdnRylE65JbScQ7qCWgw (big blind) folded on the River



PokerStars Game #59938065658:  Hold'em No Limit ($1/$2) - 2009/07/01 0:06:14 ET
Table 'SF49/KQm8T4taMp6kb+HXA' 9-max Seat #6 is the button
Seat 1: l1bCLGuFqeFRwUfPsiDu/g ($183.95 in chips)
Seat 2: dJO4Wtu5e7hHBlpz0cmy1w ($71.20 in chips)
Seat 3: L88dtdULfz5oGDSuo9/RvA ($43.80 in chips)
Seat 4: HffgoYm61KgkdMe/DYChIQ ($38 in chips)
Seat 5: Z3aYCZG/yXHYFjiWkGI5ug ($227.55 in chips)
Seat 6: M2ht6rIKOI/my9eh610Nlw ($247.45 in chips)
Seat 8: 5iPk5MyO3KVu18Y8XCYfFQ ($37 in chips)
Seat 9: O+jytCilwk7zItVCEavmtw ($140 in chips)
5iPk5MyO3KVu18Y8XCYfFQ: posts small blind $1
O+jytCilwk7zItVCEavmtw: posts big blind $2
*** HOLE CARDS ***
l1bCLGuFqeFRwUfPsiDu/g: calls $2
dJO4Wtu5e7hHBlpz0cmy1w: folds
L88dtdULfz5oGDSuo9/RvA: folds
HffgoYm61KgkdMe/DYChIQ: folds
Z3aYCZG/yXHYFjiWkGI5ug: raises $6 to $8
M2ht6rIKOI/my9eh610Nlw: folds
n2VAbLaE5qgKr5mA4W6v4w is disconnected
5iPk5MyO3KVu18Y8XCYfFQ: folds
O+jytCilwk7zItVCEavmtw: folds
l1bCLGuFqeFRwUfPsiDu/g: calls $6
*** FLOP *** [8c 7c Th]
l1bCLGuFqeFRwUfPsiDu/g: bets $12
Z3aYCZG/yXHYFjiWkGI5ug: calls $12
*** TURN *** [8c 7c Th] [9d]
l1bCLGuFqeFRwUfPsiDu/g: bets $12
Z3aYCZG/yXHYFjiWkGI5ug: raises $26 to $38
l1bCLGuFqeFRwUfPsiDu/g: calls $26
*** RIVER *** [8c 7c Th 9d] [3c]
l1bCLGuFqeFRwUfPsiDu/g: checks
Z3aYCZG/yXHYFjiWkGI5ug: bets $32
l1bCLGuFqeFRwUfPsiDu/g: calls $32
*** SHOW DOWN ***
Z3aYCZG/yXHYFjiWkGI5ug: shows [Ks Jh] (a straight, Seven to Jack)
l1bCLGuFqeFRwUfPsiDu/g: shows [Jd Jc] (a straight, Seven to Jack)
l1bCLGuFqeFRwUfPsiDu/g collected $90 from pot
Z3aYCZG/yXHYFjiWkGI5ug collected $90 from pot
*** SUMMARY ***
Total pot $183 | Rake $3
Board [8c 7c Th 9d 3c]
Seat 1: l1bCLGuFqeFRwUfPsiDu/g showed [Jd Jc] and won ($90) with a straight, Seven to Jack
Seat 2: dJO4Wtu5e7hHBlpz0cmy1w folded before Flop (didn't bet)
Seat 3: L88dtdULfz5oGDSuo9/RvA folded before Flop (didn't bet)
Seat 4: HffgoYm61KgkdMe/DYChIQ folded before Flop (didn't bet)
Seat 5: Z3aYCZG/yXHYFjiWkGI5ug showed [Ks Jh] and won ($90) with a straight, Seven to Jack
Seat 6: M2ht6rIKOI/my9eh610Nlw (button) folded before Flop (didn't bet)
Seat 8: 5iPk5MyO3KVu18Y8XCYfFQ (small blind) folded before Flop
Seat 9: O+jytCilwk7zItVCEavmtw (big blind) folded before Flop



PokerStars Game #59938067210:  Hold'em No Limit ($1/$2) - 2009/07/01 0:06:16 ET
Table 'HewZCzVOYGmuLDKthTi5Yw' 6-max Seat #5 is the button
Seat 1: 353332 ($233.75 in chips)
Seat 2: X7GlkHF+lkbarCLuZ4Uf0w ($39 in chips)
Seat 3: WJxW31eStwT28R2X/L8F5A ($53.50 in chips)
Seat 4: yZgdnRylE65JbScQ7qCWgw ($32 in chips)
Seat 5: 513FcCI8jHyQy2VWoIQkMg ($371.50 in chips)
353332: posts small blind $1
X7GlkHF+lkbarCLuZ4Uf0w: posts big blind $2
*** HOLE CARDS ***
WJxW31eStwT28R2X/L8F5A: folds
yZgdnRylE65JbScQ7qCWgw: folds
513FcCI8jHyQy2VWoIQkMg: raises $4 to $6
353332: raises $13 to $19
X7GlkHF+lkbarCLuZ4Uf0w: folds
513FcCI8jHyQy2VWoIQkMg: folds
353332 collected $14 from pot
353332: doesn't show hand
*** SUMMARY ***
Total pot $14 | Rake $0
Seat 1: 353332 (small blind) collected ($14)
Seat 2: X7GlkHF+lkbarCLuZ4Uf0w (big blind) folded before Flop
Seat 3: WJxW31eStwT28R2X/L8F5A folded before Flop (didn't bet)
Seat 4: yZgdnRylE65JbScQ7qCWgw folded before Flop (didn't bet)
Seat 5: 513FcCI8jHyQy2VWoIQkMg (button) folded before Flop



PokerStars Game #59938068046:  Hold'em No Limit ($1/$2) - 2009/07/01 0:06:17 ET
Table 'NmY84NAf9Mh0ckAckHnh5g' 2-max Seat #2 is the button
Seat 1: 6hvg964TSqZ3AL/0XK9aVQ ($364.70 in chips)
Seat 2: RwDoM55ZeQuI2ADyJhOb2Q ($230.80 in chips)
RwDoM55ZeQuI2ADyJhOb2Q: posts small blind $1
6hvg964TSqZ3AL/0XK9aVQ: posts big blind $2
*** HOLE CARDS ***
RwDoM55ZeQuI2ADyJhOb2Q: raises $4 to $6
6hvg964TSqZ3AL/0XK9aVQ: calls $4
*** FLOP *** [Qc Kh 2d]
6hvg964TSqZ3AL/0XK9aVQ: checks
RwDoM55ZeQuI2ADyJhOb2Q: bets $6
6hvg964TSqZ3AL/0XK9aVQ: calls $6
*** TURN *** [Qc Kh 2d] [Kd]
6hvg964TSqZ3AL/0XK9aVQ: checks
RwDoM55ZeQuI2ADyJhOb2Q: bets $22
6hvg964TSqZ3AL/0XK9aVQ: calls $22
*** RIVER *** [Qc Kh 2d Kd] [2c]
6hvg964TSqZ3AL/0XK9aVQ: checks
RwDoM55ZeQuI2ADyJhOb2Q: bets $42
6hvg964TSqZ3AL/0XK9aVQ: folds
RwDoM55ZeQuI2ADyJhOb2Q collected $67.50 from pot
RwDoM55ZeQuI2ADyJhOb2Q: doesn't show hand
*** SUMMARY ***
Total pot $68 | Rake $0.50
Board [Qc Kh 2d Kd 2c]
Seat 1: 6hvg964TSqZ3AL/0XK9aVQ (big blind) folded on the River
Seat 2: RwDoM55ZeQuI2ADyJhOb2Q (button) (small blind) collected ($67.50)



PokerStars Game #59938068222:  Hold'em No Limit ($1/$2) - 2009/07/01 0:06:18 ET
Table 'gnHBqWll9O3fxG7Ojkz/ng' 9-max Seat #7 is the button
Seat 1: hpqdC/23wXosGOmzARr5NA ($160.30 in chips)
Seat 2: H6Z4+qu8gR0VUiPOijndVg ($200 in chips)
Seat 3: 5Q8U6iZbeO7xJSS4qvDP5g ($218.60 in chips)
Seat 4: n5XI5/7gN+gIubHFBH+mOw ($404.85 in chips)
Seat 5: GX1heJ+DSsvm7gzSPsYhhQ ($54.75 in chips)
Seat 6: 5iPk5MyO3KVu18Y8XCYfFQ ($37 in chips)
Seat 7: jqui3xAWCkcdPW36a6BD+w ($212.80 in chips)
Seat 8: De9g+AYjo0DN6C/+iT/nsg ($245.05 in chips)
Seat 9: kVCeGJ4NY7Fb0W74j1mAqA ($206 in chips)
De9g+AYjo0DN6C/+iT/nsg: posts small blind $1
kVCeGJ4NY7Fb0W74j1mAqA: posts big blind $2
*** HOLE CARDS ***
hpqdC/23wXosGOmzARr5NA: calls $2
H6Z4+qu8gR0VUiPOijndVg: folds
5Q8U6iZbeO7xJSS4qvDP5g: folds
n5XI5/7gN+gIubHFBH+mOw: folds
GX1heJ+DSsvm7gzSPsYhhQ: folds
5iPk5MyO3KVu18Y8XCYfFQ: raises $2 to $4
jqui3xAWCkcdPW36a6BD+w: folds
De9g+AYjo0DN6C/+iT/nsg: folds
kVCeGJ4NY7Fb0W74j1mAqA: folds
hpqdC/23wXosGOmzARr5NA: calls $2
*** FLOP *** [9h 8d 2h]
hpqdC/23wXosGOmzARr5NA: checks
5iPk5MyO3KVu18Y8XCYfFQ: bets $6
hpqdC/23wXosGOmzARr5NA: folds
5iPk5MyO3KVu18Y8XCYfFQ collected $10.45 from pot
5iPk5MyO3KVu18Y8XCYfFQ: doesn't show hand
*** SUMMARY ***
Total pot $11 | Rake $0.55
Board [9h 8d 2h]
Seat 1: hpqdC/23wXosGOmzARr5NA folded on the Flop
Seat 2: H6Z4+qu8gR0VUiPOijndVg folded before Flop (didn't bet)
Seat 3: 5Q8U6iZbeO7xJSS4qvDP5g folded before Flop (didn't bet)
Seat 4: n5XI5/7gN+gIubHFBH+mOw folded before Flop (didn't bet)
Seat 5: GX1heJ+DSsvm7gzSPsYhhQ folded before Flop (didn't bet)
Seat 6: 5iPk5MyO3KVu18Y8XCYfFQ collected ($10.45)
Seat 7: jqui3xAWCkcdPW36a6BD+w (button) folded before Flop (didn't bet)
Seat 8: De9g+AYjo0DN6C/+iT/nsg (small blind) folded before Flop
Seat 9: kVCeGJ4NY7Fb0W74j1mAqA (big blind) folded before Flop



PokerStars Game #59938069348:  Hold'em No Limit ($1/$2) - 2009/07/01 0:06:19 ET
Table 'ZrKaj8fA5nb08RKhIpHkZA' 9-max Seat #4 is the button
Seat 1: Hc2itIxwbi1lwa+DAYYQGg ($37 in chips)
Seat 2: TAfo4veNRaRlzDXMMYS3Jg ($37 in chips)
Seat 3: GX1heJ+DSsvm7gzSPsYhhQ ($36 in chips)
Seat 4: isdXtU9uuSM2LGqOKxtlwA ($116.35 in chips)
Seat 5: YlSX2xwu8QMQReaxSAD8XA ($207.45 in chips)
Seat 6: Q3uFdu6ztesjDFiqkagTRQ ($200 in chips)
Seat 7: ztEPtIZdGv4TcxTUTzbY1w ($80.85 in chips)
Seat 8: tnv1uD25KOWgMmyKcuOVog ($274.30 in chips)
Seat 9: Z3aYCZG/yXHYFjiWkGI5ug ($251 in chips)
YlSX2xwu8QMQReaxSAD8XA: posts small blind $1
Q3uFdu6ztesjDFiqkagTRQ: posts big blind $2
*** HOLE CARDS ***
ztEPtIZdGv4TcxTUTzbY1w: folds
tnv1uD25KOWgMmyKcuOVog: folds
Z3aYCZG/yXHYFjiWkGI5ug: raises $4 to $6
Hc2itIxwbi1lwa+DAYYQGg: folds
TAfo4veNRaRlzDXMMYS3Jg: folds
GX1heJ+DSsvm7gzSPsYhhQ: folds
isdXtU9uuSM2LGqOKxtlwA: calls $6
YlSX2xwu8QMQReaxSAD8XA: folds
Q3uFdu6ztesjDFiqkagTRQ: folds
*** FLOP *** [3h 4s Tc]
Z3aYCZG/yXHYFjiWkGI5ug: bets $10
isdXtU9uuSM2LGqOKxtlwA: folds
Z3aYCZG/yXHYFjiWkGI5ug collected $14.25 from pot
Z3aYCZG/yXHYFjiWkGI5ug: doesn't show hand
*** SUMMARY ***
Total pot $15 | Rake $0.75
Board [3h 4s Tc]
Seat 1: Hc2itIxwbi1lwa+DAYYQGg folded before Flop (didn't bet)
Seat 2: TAfo4veNRaRlzDXMMYS3Jg folded before Flop (didn't bet)
Seat 3: GX1heJ+DSsvm7gzSPsYhhQ folded before Flop (didn't bet)
Seat 4: isdXtU9uuSM2LGqOKxtlwA (button) folded on the Flop
Seat 5: YlSX2xwu8QMQReaxSAD8XA (small blind) folded before Flop
Seat 6: Q3uFdu6ztesjDFiqkagTRQ (big blind) folded before Flop
Seat 7: ztEPtIZdGv4TcxTUTzbY1w folded before Flop (didn't bet)
Seat 8: tnv1uD25KOWgMmyKcuOVog folded before Flop (didn't bet)
Seat 9: Z3aYCZG/yXHYFjiWkGI5ug collected ($14.25)



PokerStars Game #59938069732:  Hold'em No Limit ($1/$2) - 2009/07/01 0:06:20 ET
Table 'YqGfR5eHfMeSjb9a+QU9rg' 9-max Seat #6 is the button
Seat 1: qCBuzVnLcBR29snMAHq9PA ($162.35 in chips)
Seat 2: W3Nqt1GWlTi9tXQXMNEvgw ($238.65 in chips)
Seat 3: /gll27k+xWYV7Fbki0lFDQ ($78 in chips)
Seat 4: QHxJjpVYwitg9krW6wZgJA ($200 in chips)
Seat 5: MOBMOMQRN/z+fiGXGnZojw ($175.10 in chips)
Seat 6: 5iPk5MyO3KVu18Y8XCYfFQ ($39 in chips)
Seat 7: b0jO1SDhLedy1//CQlA8kw ($40 in chips)
Seat 8: JnV3SM2D6dAFYyGZHHpvrg ($100 in chips)
Seat 9: RsrgM2l7PLbQ9xBbSi3IvQ ($119.55 in chips)
b0jO1SDhLedy1//CQlA8kw: posts small blind $1
JnV3SM2D6dAFYyGZHHpvrg: posts big blind $2
*** HOLE CARDS ***
RsrgM2l7PLbQ9xBbSi3IvQ: folds
qCBuzVnLcBR29snMAHq9PA: folds
W3Nqt1GWlTi9tXQXMNEvgw: raises $2 to $4
/gll27k+xWYV7Fbki0lFDQ: calls $4
QHxJjpVYwitg9krW6wZgJA: calls $4
MOBMOMQRN/z+fiGXGnZojw: folds
5iPk5MyO3KVu18Y8XCYfFQ: folds
b0jO1SDhLedy1//CQlA8kw: folds
JnV3SM2D6dAFYyGZHHpvrg: folds
*** FLOP *** [9s Qs 2h]
W3Nqt1GWlTi9tXQXMNEvgw: checks
/gll27k+xWYV7Fbki0lFDQ: bets $8
QHxJjpVYwitg9krW6wZgJA: folds
W3Nqt1GWlTi9tXQXMNEvgw: folds
/gll27k+xWYV7Fbki0lFDQ collected $14.25 from pot
*** SUMMARY ***
Total pot $15 | Rake $0.75
Board [9s Qs 2h]
Seat 1: qCBuzVnLcBR29snMAHq9PA folded before Flop (didn't bet)
Seat 2: W3Nqt1GWlTi9tXQXMNEvgw folded on the Flop
Seat 3: /gll27k+xWYV7Fbki0lFDQ collected ($14.25)
Seat 4: QHxJjpVYwitg9krW6wZgJA folded on the Flop
Seat 5: MOBMOMQRN/z+fiGXGnZojw folded before Flop (didn't bet)
Seat 6: 5iPk5MyO3KVu18Y8XCYfFQ (button) folded before Flop (didn't bet)
Seat 7: b0jO1SDhLedy1//CQlA8kw (small blind) folded before Flop
Seat 8: JnV3SM2D6dAFYyGZHHpvrg (big blind) folded before Flop
Seat 9: RsrgM2l7PLbQ9xBbSi3IvQ folded before Flop (didn't bet)



PokerStars Game #59938069640:  Hold'em No Limit ($1/$2) - 2009/07/01 0:06:20 ET
Table 'WCA60bDA8ecovUgFSIZkTQ' 9-max Seat #8 is the button
Seat 2: G1h8wamBcVJXtsKXZQ2EyA ($46.70 in chips)
Seat 3: 5iPk5MyO3KVu18Y8XCYfFQ ($40 in chips)
Seat 4: Q3uFdu6ztesjDFiqkagTRQ ($484.70 in chips)
Seat 5: Hc2itIxwbi1lwa+DAYYQGg ($309.30 in chips)
Seat 6: DOWQSOJ7GaX+ksfWTqPT5A ($244.05 in chips)
Seat 7: GX1heJ+DSsvm7gzSPsYhhQ ($31 in chips)
Seat 8: x+V1JgVDawsJTxKcxm7gxw ($95 in chips)
Seat 9: 3q2/0oJr3Mcy1W5tcN61ug ($299.20 in chips)
3q2/0oJr3Mcy1W5tcN61ug: posts small blind $1
xNLmepWbCljNEEeH8O5jSg: is sitting out
G1h8wamBcVJXtsKXZQ2EyA: posts big blind $2
*** HOLE CARDS ***
xNLmepWbCljNEEeH8O5jSg leaves the table
5iPk5MyO3KVu18Y8XCYfFQ: folds
Q3uFdu6ztesjDFiqkagTRQ: folds
Hc2itIxwbi1lwa+DAYYQGg: folds
DOWQSOJ7GaX+ksfWTqPT5A: raises $4 to $6
GX1heJ+DSsvm7gzSPsYhhQ: raises $10 to $16
x+V1JgVDawsJTxKcxm7gxw: folds
3q2/0oJr3Mcy1W5tcN61ug: folds
G1h8wamBcVJXtsKXZQ2EyA: folds
CUZwDpLTQKhzarPe+JCLOQ joins the table at seat #1
DOWQSOJ7GaX+ksfWTqPT5A: raises $18 to $34
GX1heJ+DSsvm7gzSPsYhhQ: calls $15 and is all-in
*** FLOP *** [Ad 8s 8c]
*** TURN *** [Ad 8s 8c] [5c]
*** RIVER *** [Ad 8s 8c 5c] [7s]
*** SHOW DOWN ***
DOWQSOJ7GaX+ksfWTqPT5A: shows [Td Ah] (two pair, Aces and Eights)
GX1heJ+DSsvm7gzSPsYhhQ: mucks hand
DOWQSOJ7GaX+ksfWTqPT5A collected $62 from pot
*** SUMMARY ***
Total pot $65 | Rake $3
Board [Ad 8s 8c 5c 7s]
Seat 2: G1h8wamBcVJXtsKXZQ2EyA (big blind) folded before Flop
Seat 3: 5iPk5MyO3KVu18Y8XCYfFQ folded before Flop (didn't bet)
Seat 4: Q3uFdu6ztesjDFiqkagTRQ folded before Flop (didn't bet)
Seat 5: Hc2itIxwbi1lwa+DAYYQGg folded before Flop (didn't bet)
Seat 6: DOWQSOJ7GaX+ksfWTqPT5A showed [Td Ah] and won ($62) with two pair, Aces and Eights
Seat 7: GX1heJ+DSsvm7gzSPsYhhQ mucked
Seat 8: x+V1JgVDawsJTxKcxm7gxw (button) folded before Flop (didn't bet)
Seat 9: 3q2/0oJr3Mcy1W5tcN61ug (small blind) folded before Flop



PokerStars Game #59938069854:  Hold'em No Limit ($1/$2) - 2009/07/01 0:06:20 ET
Table 'uJ9juaXXg9yIcSU8amxaXQ' 6-max Seat #6 is the button
Seat 1: HhIxv6mylwCAfv3sjJmq5g ($200 in chips)
Seat 2: DQlskgG4OtLpF2MVxLwf4A ($284.05 in chips)
Seat 3: zaogaltCDFVsIASEnrXs2w ($259.75 in chips)
Seat 4: 54yWzRRgS0oZ+S6LwZBxMQ ($32 in chips)
Seat 5: X7GlkHF+lkbarCLuZ4Uf0w ($48 in chips)
Seat 6: XrFG4dK06RVKLlX32/pjcQ ($76.40 in chips)
HhIxv6mylwCAfv3sjJmq5g: posts small blind $1
DQlskgG4OtLpF2MVxLwf4A: posts big blind $2
*** HOLE CARDS ***
zaogaltCDFVsIASEnrXs2w: folds
54yWzRRgS0oZ+S6LwZBxMQ: folds
X7GlkHF+lkbarCLuZ4Uf0w: folds
XrFG4dK06RVKLlX32/pjcQ: folds
HhIxv6mylwCAfv3sjJmq5g: folds
DQlskgG4OtLpF2MVxLwf4A collected $2 from pot
DQlskgG4OtLpF2MVxLwf4A: doesn't show hand
*** SUMMARY ***
Total pot $2 | Rake $0
Seat 1: HhIxv6mylwCAfv3sjJmq5g (small blind) folded before Flop
Seat 2: DQlskgG4OtLpF2MVxLwf4A (big blind) collected ($2)
Seat 3: zaogaltCDFVsIASEnrXs2w folded before Flop (didn't bet)
Seat 4: 54yWzRRgS0oZ+S6LwZBxMQ folded before Flop (didn't bet)
Seat 5: X7GlkHF+lkbarCLuZ4Uf0w folded before Flop (didn't bet)
Seat 6: XrFG4dK06RVKLlX32/pjcQ (button) folded before Flop (didn't bet)



PokerStars Game #59938071334:  Hold'em No Limit ($1/$2) - 2009/07/01 0:06:22 ET
Table 'jlrIxbrVIG+gjaUYT4za8g' 6-max Seat #6 is the button
Seat 1: ygTTt5ehT4aF86q1a8/R+w ($174.35 in chips)
Seat 2: N18PrNGQj43J7TJuQuu+tw ($153.80 in chips)
Seat 3: /PH6Ffnho4Ysm8S3V/oa+w ($80 in chips)
Seat 4: 8srN1dKQePlsv0GyTada+Q ($200 in chips)
Seat 5: F/075N6nU34Fn0zr6qD3aw ($168.55 in chips)
Seat 6: vkfxu8f/jMYKUk6Ly4eujw ($278.05 in chips)
ygTTt5ehT4aF86q1a8/R+w: posts small blind $1
N18PrNGQj43J7TJuQuu+tw: posts big blind $2
*** HOLE CARDS ***
/PH6Ffnho4Ysm8S3V/oa+w: folds
8srN1dKQePlsv0GyTada+Q: folds
F/075N6nU34Fn0zr6qD3aw: folds
vkfxu8f/jMYKUk6Ly4eujw: folds
ygTTt5ehT4aF86q1a8/R+w: raises $4 to $6
N18PrNGQj43J7TJuQuu+tw: calls $4
*** FLOP *** [Td Ts 5d]
ygTTt5ehT4aF86q1a8/R+w: bets $8
N18PrNGQj43J7TJuQuu+tw: calls $8
*** TURN *** [Td Ts 5d] [9d]
ygTTt5ehT4aF86q1a8/R+w: checks
N18PrNGQj43J7TJuQuu+tw: bets $10
ygTTt5ehT4aF86q1a8/R+w: calls $10
*** RIVER *** [Td Ts 5d 9d] [9h]
ygTTt5ehT4aF86q1a8/R+w: checks
N18PrNGQj43J7TJuQuu+tw: checks
*** SHOW DOWN ***
ygTTt5ehT4aF86q1a8/R+w: shows [9s Ad] (a full house, Nines full of Tens)
N18PrNGQj43J7TJuQuu+tw: mucks hand
ygTTt5ehT4aF86q1a8/R+w collected $45.70 from pot
*** SUMMARY ***
Total pot $48 | Rake $2.30
Board [Td Ts 5d 9d 9h]
Seat 1: ygTTt5ehT4aF86q1a8/R+w (small blind) showed [9s Ad] and won ($45.70) with a full house, Nines full of Tens
Seat 2: N18PrNGQj43J7TJuQuu+tw (big blind) mucked
Seat 3: /PH6Ffnho4Ysm8S3V/oa+w folded before Flop (didn't bet)
Seat 4: 8srN1dKQePlsv0GyTada+Q folded before Flop (didn't bet)
Seat 5: F/075N6nU34Fn0zr6qD3aw folded before Flop (didn't bet)
Seat 6: vkfxu8f/jMYKUk6Ly4eujw (button) folded before Flop (didn't bet)



PokerStars Game #59938076008:  Hold'em No Limit ($1/$2) - 2009/07/01 0:06:28 ET
Table 'ztv6V3FN2bQ9nmJPPdx6nQ' 6-max Seat #5 is the button
Seat 1: ek1hig03QiyONDHXvgqteQ ($182.05 in chips)
Seat 4: vkfxu8f/jMYKUk6Ly4eujw ($348.70 in chips)
Seat 5: sTPOWERd9HWPCNrDBwsVjA ($195.75 in chips)
Seat 6: yZgdnRylE65JbScQ7qCWgw ($32 in chips)
yZgdnRylE65JbScQ7qCWgw: posts small blind $1
ek1hig03QiyONDHXvgqteQ: posts big blind $2
*** HOLE CARDS ***
vkfxu8f/jMYKUk6Ly4eujw: folds
sTPOWERd9HWPCNrDBwsVjA: folds
yZgdnRylE65JbScQ7qCWgw: folds
ek1hig03QiyONDHXvgqteQ collected $2 from pot
*** SUMMARY ***
Total pot $2 | Rake $0
Seat 1: ek1hig03QiyONDHXvgqteQ (big blind) collected ($2)
Seat 4: vkfxu8f/jMYKUk6Ly4eujw folded before Flop (didn't bet)
Seat 5: sTPOWERd9HWPCNrDBwsVjA (button) folded before Flop (didn't bet)
Seat 6: yZgdnRylE65JbScQ7qCWgw (small blind) folded before Flop



PokerStars Game #59938076346:  Hold'em No Limit ($1/$2) - 2009/07/01 0:06:29 ET
Table 'bJQ024BaYSBrW0sXpCZbNQ' 6-max Seat #4 is the button
Seat 1: yZgdnRylE65JbScQ7qCWgw ($34 in chips)
Seat 2: 1njbh8TKSUF6l4V1XwGdcg ($247.40 in chips)
Seat 3: vkfxu8f/jMYKUk6Ly4eujw ($225.60 in chips)
Seat 4: 9ni/OEXAqfc58zPQ0Tu9rQ ($269.60 in chips)
Seat 5: X7GlkHF+lkbarCLuZ4Uf0w ($39.15 in chips)
Seat 6: 9dpyyjDTCed6nV7JhaUUpw ($215.50 in chips)
X7GlkHF+lkbarCLuZ4Uf0w: posts small blind $1
9dpyyjDTCed6nV7JhaUUpw: posts big blind $2
*** HOLE CARDS ***
yZgdnRylE65JbScQ7qCWgw: folds
1njbh8TKSUF6l4V1XwGdcg: raises $4 to $6
vkfxu8f/jMYKUk6Ly4eujw: folds
9ni/OEXAqfc58zPQ0Tu9rQ: folds
X7GlkHF+lkbarCLuZ4Uf0w: folds
9dpyyjDTCed6nV7JhaUUpw: folds
1njbh8TKSUF6l4V1XwGdcg collected $5 from pot
*** SUMMARY ***
Total pot $5 | Rake $0
Seat 1: yZgdnRylE65JbScQ7qCWgw folded before Flop (didn't bet)
Seat 2: 1njbh8TKSUF6l4V1XwGdcg collected ($5)
Seat 3: vkfxu8f/jMYKUk6Ly4eujw folded before Flop (didn't bet)
Seat 4: 9ni/OEXAqfc58zPQ0Tu9rQ (button) folded before Flop (didn't bet)
Seat 5: X7GlkHF+lkbarCLuZ4Uf0w (small blind) folded before Flop
Seat 6: 9dpyyjDTCed6nV7JhaUUpw (big blind) folded before Flop



PokerStars Game #59938078718:  Hold'em No Limit ($1/$2) - 2009/07/01 0:06:32 ET
Table 'qVXak+oTeDXMGbWa4sDU5Q' 9-max Seat #3 is the button
Seat 1: H6Z4+qu8gR0VUiPOijndVg ($250 in chips)
Seat 2: Hc2itIxwbi1lwa+DAYYQGg ($49 in chips)
Seat 3: oz9eCXGC7DdjQlL/nuWj1A ($102.85 in chips)
Seat 4: b0jO1SDhLedy1//CQlA8kw ($38 in chips)
Seat 6: Q3uFdu6ztesjDFiqkagTRQ ($244.65 in chips)
Seat 7: 5iPk5MyO3KVu18Y8XCYfFQ ($59.50 in chips)
Seat 8: 9pHZMviI9R8injxojGTnvw ($58.85 in chips)
Seat 9: IZ/2qsh1CIg9m5PWsMsLmA ($360.95 in chips)
b0jO1SDhLedy1//CQlA8kw: posts small blind $1
Q3uFdu6ztesjDFiqkagTRQ: posts big blind $2
*** HOLE CARDS ***
5iPk5MyO3KVu18Y8XCYfFQ: folds
9pHZMviI9R8injxojGTnvw is disconnected
9pHZMviI9R8injxojGTnvw is connected
9pHZMviI9R8injxojGTnvw: folds
IZ/2qsh1CIg9m5PWsMsLmA: folds
H6Z4+qu8gR0VUiPOijndVg: folds
Hc2itIxwbi1lwa+DAYYQGg: folds
oz9eCXGC7DdjQlL/nuWj1A: raises $8 to $10
b0jO1SDhLedy1//CQlA8kw: folds
Q3uFdu6ztesjDFiqkagTRQ: folds
oz9eCXGC7DdjQlL/nuWj1A collected $5 from pot
*** SUMMARY ***
Total pot $5 | Rake $0
Seat 1: H6Z4+qu8gR0VUiPOijndVg folded before Flop (didn't bet)
Seat 2: Hc2itIxwbi1lwa+DAYYQGg folded before Flop (didn't bet)
Seat 3: oz9eCXGC7DdjQlL/nuWj1A (button) collected ($5)
Seat 4: b0jO1SDhLedy1//CQlA8kw (small blind) folded before Flop
Seat 6: Q3uFdu6ztesjDFiqkagTRQ (big blind) folded before Flop
Seat 7: 5iPk5MyO3KVu18Y8XCYfFQ folded before Flop (didn't bet)
Seat 8: 9pHZMviI9R8injxojGTnvw folded before Flop (didn't bet)
Seat 9: IZ/2qsh1CIg9m5PWsMsLmA folded before Flop (didn't bet)



PokerStars Game #59938080044:  Hold'em No Limit ($1/$2) - 2009/07/01 0:06:34 ET
Table 'l5lZHc5JRHEDt0Y2AVPq3g' 6-max Seat #3 is the button
Seat 1: gGPaCoSWW1HoKYaqfAPecg ($203.30 in chips)
Seat 2: my38j/MmtBd/8qVwmyCREA ($259.40 in chips)
Seat 3: yZgdnRylE65JbScQ7qCWgw ($40 in chips)
Seat 4: zNjJ/y4emmF+vzrCDd+ooA ($204.95 in chips)
Seat 5: 6fLdOUCRtX71xbVRhJEq8w ($200 in chips)
Seat 6: vkfxu8f/jMYKUk6Ly4eujw ($200.90 in chips)
zNjJ/y4emmF+vzrCDd+ooA: posts small blind $1
6fLdOUCRtX71xbVRhJEq8w: posts big blind $2
*** HOLE CARDS ***
vkfxu8f/jMYKUk6Ly4eujw: folds
gGPaCoSWW1HoKYaqfAPecg: folds
my38j/MmtBd/8qVwmyCREA: calls $2
yZgdnRylE65JbScQ7qCWgw: folds
zNjJ/y4emmF+vzrCDd+ooA: folds
6fLdOUCRtX71xbVRhJEq8w: checks
*** FLOP *** [5d 8d Qd]
6fLdOUCRtX71xbVRhJEq8w: checks
my38j/MmtBd/8qVwmyCREA: bets $2
6fLdOUCRtX71xbVRhJEq8w: folds
my38j/MmtBd/8qVwmyCREA collected $4.75 from pot
*** SUMMARY ***
Total pot $5 | Rake $0.25
Board [5d 8d Qd]
Seat 1: gGPaCoSWW1HoKYaqfAPecg folded before Flop (didn't bet)
Seat 2: my38j/MmtBd/8qVwmyCREA collected ($4.75)
Seat 3: yZgdnRylE65JbScQ7qCWgw (button) folded before Flop (didn't bet)
Seat 4: zNjJ/y4emmF+vzrCDd+ooA (small blind) folded before Flop
Seat 5: 6fLdOUCRtX71xbVRhJEq8w (big blind) folded on the Flop
Seat 6: vkfxu8f/jMYKUk6Ly4eujw folded before Flop (didn't bet)



PokerStars Game #59938082424:  Hold'em No Limit ($1/$2) - 2009/07/01 0:06:37 ET
Table 'rsKRKlGHlxVyqJxzO2a2Ow' 9-max Seat #7 is the button
Seat 1: uYWfQJg2hgHLxri6/uVJiw ($135.50 in chips)
Seat 2: QHxJjpVYwitg9krW6wZgJA ($244 in chips)
Seat 3: 9sYbXdhj1M2bwKrVNxj5+Q ($145.80 in chips)
Seat 4: zJtQ1gxyi72XvGYS1tM+DA ($156.30 in chips)
Seat 5: 5Q8U6iZbeO7xJSS4qvDP5g ($203 in chips)
Seat 6: H6Z4+qu8gR0VUiPOijndVg ($200 in chips)
Seat 7: kVCeGJ4NY7Fb0W74j1mAqA ($200 in chips)
Seat 8: Hc2itIxwbi1lwa+DAYYQGg ($38 in chips)
Seat 9: 5iPk5MyO3KVu18Y8XCYfFQ ($96.20 in chips)
Hc2itIxwbi1lwa+DAYYQGg: posts small blind $1
5iPk5MyO3KVu18Y8XCYfFQ: posts big blind $2
*** HOLE CARDS ***
uYWfQJg2hgHLxri6/uVJiw: folds
QHxJjpVYwitg9krW6wZgJA: folds
9sYbXdhj1M2bwKrVNxj5+Q: folds
zJtQ1gxyi72XvGYS1tM+DA: folds
5Q8U6iZbeO7xJSS4qvDP5g: folds
H6Z4+qu8gR0VUiPOijndVg: raises $4 to $6
kVCeGJ4NY7Fb0W74j1mAqA: folds
Hc2itIxwbi1lwa+DAYYQGg: folds
5iPk5MyO3KVu18Y8XCYfFQ: calls $4
*** FLOP *** [Kc 8d 8h]
5iPk5MyO3KVu18Y8XCYfFQ: checks
H6Z4+qu8gR0VUiPOijndVg: checks
*** TURN *** [Kc 8d 8h] [4h]
5iPk5MyO3KVu18Y8XCYfFQ: bets $6
H6Z4+qu8gR0VUiPOijndVg: calls $6
*** RIVER *** [Kc 8d 8h 4h] [Js]
5iPk5MyO3KVu18Y8XCYfFQ: checks
H6Z4+qu8gR0VUiPOijndVg: checks
*** SHOW DOWN ***
5iPk5MyO3KVu18Y8XCYfFQ: shows [Th Ac] (a pair of Eights)
H6Z4+qu8gR0VUiPOijndVg: shows [As 9s] (a pair of Eights)
5iPk5MyO3KVu18Y8XCYfFQ collected $11.90 from pot
H6Z4+qu8gR0VUiPOijndVg collected $11.90 from pot
*** SUMMARY ***
Total pot $25 | Rake $1.20
Board [Kc 8d 8h 4h Js]
Seat 1: uYWfQJg2hgHLxri6/uVJiw folded before Flop (didn't bet)
Seat 2: QHxJjpVYwitg9krW6wZgJA folded before Flop (didn't bet)
Seat 3: 9sYbXdhj1M2bwKrVNxj5+Q folded before Flop (didn't bet)
Seat 4: zJtQ1gxyi72XvGYS1tM+DA folded before Flop (didn't bet)
Seat 5: 5Q8U6iZbeO7xJSS4qvDP5g folded before Flop (didn't bet)
Seat 6: H6Z4+qu8gR0VUiPOijndVg showed [As 9s] and won ($11.90) with a pair of Eights
Seat 7: kVCeGJ4NY7Fb0W74j1mAqA (button) folded before Flop (didn't bet)
Seat 8: Hc2itIxwbi1lwa+DAYYQGg (small blind) folded before Flop
Seat 9: 5iPk5MyO3KVu18Y8XCYfFQ (big blind) showed [Th Ac] and won ($11.90) with a pair of Eights



PokerStars Game #59938086510:  Hold'em No Limit ($1/$2) - 2009/07/01 0:06:43 ET
Table 'CFkQcfWjKccZaZDf71FK+w' 6-max Seat #4 is the button
Seat 1: X7GlkHF+lkbarCLuZ4Uf0w ($34 in chips)
Seat 2: yZgdnRylE65JbScQ7qCWgw ($40 in chips)
Seat 3: ygTTt5ehT4aF86q1a8/R+w ($121.40 in chips)
Seat 4: B2Ih1sr5VZk+8He7rcrMtQ ($220.90 in chips)
Seat 5: 1njbh8TKSUF6l4V1XwGdcg ($242 in chips)
Seat 6: ORVqY3rf9X6ANA/8s+On2Q ($48 in chips)
1njbh8TKSUF6l4V1XwGdcg: posts small blind $1
ORVqY3rf9X6ANA/8s+On2Q: posts big blind $2
*** HOLE CARDS ***
X7GlkHF+lkbarCLuZ4Uf0w: folds
yZgdnRylE65JbScQ7qCWgw: raises $8 to $10
ygTTt5ehT4aF86q1a8/R+w has timed out
ygTTt5ehT4aF86q1a8/R+w: folds
ygTTt5ehT4aF86q1a8/R+w is sitting out
ygTTt5ehT4aF86q1a8/R+w has returned
B2Ih1sr5VZk+8He7rcrMtQ: folds
1njbh8TKSUF6l4V1XwGdcg: folds
ORVqY3rf9X6ANA/8s+On2Q: folds
yZgdnRylE65JbScQ7qCWgw collected $5 from pot
*** SUMMARY ***
Total pot $5 | Rake $0
Seat 1: X7GlkHF+lkbarCLuZ4Uf0w folded before Flop (didn't bet)
Seat 2: yZgdnRylE65JbScQ7qCWgw collected ($5)
Seat 3: ygTTt5ehT4aF86q1a8/R+w folded before Flop (didn't bet)
Seat 4: B2Ih1sr5VZk+8He7rcrMtQ (button) folded before Flop (didn't bet)
Seat 5: 1njbh8TKSUF6l4V1XwGdcg (small blind) folded before Flop
Seat 6: ORVqY3rf9X6ANA/8s+On2Q (big blind) folded before Flop



PokerStars Game #59938087436:  Hold'em No Limit ($1/$2) - 2009/07/01 0:06:44 ET
Table 'NmY84NAf9Mh0ckAckHnh5g' 2-max Seat #1 is the button
Seat 1: 6hvg964TSqZ3AL/0XK9aVQ ($330.70 in chips)
Seat 2: RwDoM55ZeQuI2ADyJhOb2Q ($264.30 in chips)
6hvg964TSqZ3AL/0XK9aVQ: posts small blind $1
RwDoM55ZeQuI2ADyJhOb2Q: posts big blind $2
*** HOLE CARDS ***
6hvg964TSqZ3AL/0XK9aVQ: calls $1
RwDoM55ZeQuI2ADyJhOb2Q: checks
*** FLOP *** [9s As Qc]
RwDoM55ZeQuI2ADyJhOb2Q: checks
6hvg964TSqZ3AL/0XK9aVQ: checks
*** TURN *** [9s As Qc] [5h]
RwDoM55ZeQuI2ADyJhOb2Q: checks
6hvg964TSqZ3AL/0XK9aVQ: checks
*** RIVER *** [9s As Qc 5h] [5d]
RwDoM55ZeQuI2ADyJhOb2Q: checks
6hvg964TSqZ3AL/0XK9aVQ: bets $4
RwDoM55ZeQuI2ADyJhOb2Q: calls $4
*** SHOW DOWN ***
6hvg964TSqZ3AL/0XK9aVQ: shows [4d 4h] (two pair, Fives and Fours)
RwDoM55ZeQuI2ADyJhOb2Q: mucks hand
6hvg964TSqZ3AL/0XK9aVQ collected $11.50 from pot
*** SUMMARY ***
Total pot $12 | Rake $0.50
Board [9s As Qc 5h 5d]
Seat 1: 6hvg964TSqZ3AL/0XK9aVQ (button) (small blind) showed [4d 4h] and won ($11.50) with two pair, Fives and Fours
Seat 2: RwDoM55ZeQuI2ADyJhOb2Q (big blind) mucked



PokerStars Game #59938088076:  Hold'em No Limit ($1/$2) - 2009/07/01 0:06:45 ET
Table 'ztv6V3FN2bQ9nmJPPdx6nQ' 6-max Seat #6 is the button
Seat 1: ek1hig03QiyONDHXvgqteQ ($183.05 in chips)
Seat 4: vkfxu8f/jMYKUk6Ly4eujw ($348.70 in chips)
Seat 5: sTPOWERd9HWPCNrDBwsVjA ($195.75 in chips)
Seat 6: yZgdnRylE65JbScQ7qCWgw ($31 in chips)
ek1hig03QiyONDHXvgqteQ: posts small blind $1
vkfxu8f/jMYKUk6Ly4eujw: posts big blind $2
*** HOLE CARDS ***
sTPOWERd9HWPCNrDBwsVjA: folds
yZgdnRylE65JbScQ7qCWgw: folds
ek1hig03QiyONDHXvgqteQ: calls $1
vkfxu8f/jMYKUk6Ly4eujw: raises $7 to $9
ek1hig03QiyONDHXvgqteQ: folds
vkfxu8f/jMYKUk6Ly4eujw collected $4 from pot
vkfxu8f/jMYKUk6Ly4eujw: doesn't show hand
*** SUMMARY ***
Total pot $4 | Rake $0
Seat 1: ek1hig03QiyONDHXvgqteQ (small blind) folded before Flop
Seat 4: vkfxu8f/jMYKUk6Ly4eujw (big blind) collected ($4)
Seat 5: sTPOWERd9HWPCNrDBwsVjA folded before Flop (didn't bet)
Seat 6: yZgdnRylE65JbScQ7qCWgw (button) folded before Flop (didn't bet)



PokerStars Game #59938089172:  Hold'em No Limit ($1/$2) - 2009/07/01 0:06:46 ET
Table '3FGoiEOffWrbgTfsB3t7FA' 2-max Seat #2 is the button
Seat 1: e0oDWyrmgLpR6bROEqw1nQ ($415.50 in chips)
Seat 2: +sy/nlNI20yZraIjs4AALg ($189.55 in chips)
+sy/nlNI20yZraIjs4AALg: posts small blind $1
e0oDWyrmgLpR6bROEqw1nQ: posts big blind $2
*** HOLE CARDS ***
+sy/nlNI20yZraIjs4AALg: folds
e0oDWyrmgLpR6bROEqw1nQ collected $2 from pot
*** SUMMARY ***
Total pot $2 | Rake $0
Seat 1: e0oDWyrmgLpR6bROEqw1nQ (big blind) collected ($2)
Seat 2: +sy/nlNI20yZraIjs4AALg (button) (small blind) folded before Flop



PokerStars Game #59938090420:  Hold'em No Limit ($1/$2) - 2009/07/01 0:06:48 ET
Table 'uJ9juaXXg9yIcSU8amxaXQ' 6-max Seat #1 is the button
Seat 1: HhIxv6mylwCAfv3sjJmq5g ($200 in chips)
Seat 2: DQlskgG4OtLpF2MVxLwf4A ($285.05 in chips)
Seat 3: zaogaltCDFVsIASEnrXs2w ($259.75 in chips)
Seat 4: 54yWzRRgS0oZ+S6LwZBxMQ ($32 in chips)
Seat 5: X7GlkHF+lkbarCLuZ4Uf0w ($48 in chips)
Seat 6: XrFG4dK06RVKLlX32/pjcQ ($76.40 in chips)
DQlskgG4OtLpF2MVxLwf4A: posts small blind $1
zaogaltCDFVsIASEnrXs2w: posts big blind $2
*** HOLE CARDS ***
54yWzRRgS0oZ+S6LwZBxMQ: folds
X7GlkHF+lkbarCLuZ4Uf0w: folds
XrFG4dK06RVKLlX32/pjcQ: folds
HhIxv6mylwCAfv3sjJmq5g: folds
DQlskgG4OtLpF2MVxLwf4A: folds
zaogaltCDFVsIASEnrXs2w collected $2 from pot
*** SUMMARY ***
Total pot $2 | Rake $0
Seat 1: HhIxv6mylwCAfv3sjJmq5g (button) folded before Flop (didn't bet)
Seat 2: DQlskgG4OtLpF2MVxLwf4A (small blind) folded before Flop
Seat 3: zaogaltCDFVsIASEnrXs2w (big blind) collected ($2)
Seat 4: 54yWzRRgS0oZ+S6LwZBxMQ folded before Flop (didn't bet)
Seat 5: X7GlkHF+lkbarCLuZ4Uf0w folded before Flop (didn't bet)
Seat 6: XrFG4dK06RVKLlX32/pjcQ folded before Flop (didn't bet)



PokerStars Game #59938089938:  Hold'em No Limit ($1/$2) - 2009/07/01 0:06:48 ET
Table 'eyAQSIlgc2o1Jxvbve4WGg' 9-max Seat #6 is the button
Seat 1: Q3uFdu6ztesjDFiqkagTRQ ($237 in chips)
Seat 2: GX1heJ+DSsvm7gzSPsYhhQ ($39 in chips)
Seat 3: TAfo4veNRaRlzDXMMYS3Jg ($37 in chips)
Seat 4: Lr5OlNr2kebm3oHSC54eJg ($115.95 in chips)
Seat 6: IikcENBHwoT7snSvBPSc7Q ($173.85 in chips)
Seat 7: QHxJjpVYwitg9krW6wZgJA ($201 in chips)
Seat 8: 5iPk5MyO3KVu18Y8XCYfFQ ($39 in chips)
Seat 9: Hc2itIxwbi1lwa+DAYYQGg ($50.85 in chips)
QHxJjpVYwitg9krW6wZgJA: posts small blind $1
5iPk5MyO3KVu18Y8XCYfFQ: posts big blind $2
JnV3SM2D6dAFYyGZHHpvrg: sits out
*** HOLE CARDS ***
Hc2itIxwbi1lwa+DAYYQGg: folds
Q3uFdu6ztesjDFiqkagTRQ: folds
GX1heJ+DSsvm7gzSPsYhhQ: folds
TAfo4veNRaRlzDXMMYS3Jg: raises $35 to $37 and is all-in
Lr5OlNr2kebm3oHSC54eJg: folds
IikcENBHwoT7snSvBPSc7Q: folds
QHxJjpVYwitg9krW6wZgJA: folds
5iPk5MyO3KVu18Y8XCYfFQ: folds
TAfo4veNRaRlzDXMMYS3Jg collected $5 from pot
TAfo4veNRaRlzDXMMYS3Jg: doesn't show hand
*** SUMMARY ***
Total pot $5 | Rake $0
Seat 1: Q3uFdu6ztesjDFiqkagTRQ folded before Flop (didn't bet)
Seat 2: GX1heJ+DSsvm7gzSPsYhhQ folded before Flop (didn't bet)
Seat 3: TAfo4veNRaRlzDXMMYS3Jg collected ($5)
Seat 4: Lr5OlNr2kebm3oHSC54eJg folded before Flop (didn't bet)
Seat 6: IikcENBHwoT7snSvBPSc7Q (button) folded before Flop (didn't bet)
Seat 7: QHxJjpVYwitg9krW6wZgJA (small blind) folded before Flop
Seat 8: 5iPk5MyO3KVu18Y8XCYfFQ (big blind) folded before Flop
Seat 9: Hc2itIxwbi1lwa+DAYYQGg folded before Flop (didn't bet)



PokerStars Game #59938093186:  Hold'em No Limit ($1/$2) - 2009/07/01 0:06:52 ET
Table 'aSf77Sj8QEnzcc0WaxVD4Q' 6-max Seat #6 is the button
Seat 1: Q3uFdu6ztesjDFiqkagTRQ ($229.35 in chips)
Seat 2: vkfxu8f/jMYKUk6Ly4eujw ($198.75 in chips)
Seat 3: 9dpyyjDTCed6nV7JhaUUpw ($220.05 in chips)
Seat 4: 513FcCI8jHyQy2VWoIQkMg ($200 in chips)
Seat 5: InmkdI6G8TzSj9NhcCSyPg ($269 in chips)
Seat 6: vkoJRf3gidxY1pPi0AFWww ($309.80 in chips)
Q3uFdu6ztesjDFiqkagTRQ: posts small blind $1
vkfxu8f/jMYKUk6Ly4eujw: posts big blind $2
*** HOLE CARDS ***
9dpyyjDTCed6nV7JhaUUpw: folds
513FcCI8jHyQy2VWoIQkMg: raises $5 to $7
InmkdI6G8TzSj9NhcCSyPg: folds
vkoJRf3gidxY1pPi0AFWww: folds
Q3uFdu6ztesjDFiqkagTRQ: folds
vkfxu8f/jMYKUk6Ly4eujw: folds
513FcCI8jHyQy2VWoIQkMg collected $5 from pot
*** SUMMARY ***
Total pot $5 | Rake $0
Seat 1: Q3uFdu6ztesjDFiqkagTRQ (small blind) folded before Flop
Seat 2: vkfxu8f/jMYKUk6Ly4eujw (big blind) folded before Flop
Seat 3: 9dpyyjDTCed6nV7JhaUUpw folded before Flop (didn't bet)
Seat 4: 513FcCI8jHyQy2VWoIQkMg collected ($5)
Seat 5: InmkdI6G8TzSj9NhcCSyPg folded before Flop (didn't bet)
Seat 6: vkoJRf3gidxY1pPi0AFWww (button) folded before Flop (didn't bet)



PokerStars Game #59938094398:  Hold'em No Limit ($1/$2) - 2009/07/01 0:06:54 ET
Table 'bJQ024BaYSBrW0sXpCZbNQ' 6-max Seat #5 is the button
Seat 1: yZgdnRylE65JbScQ7qCWgw ($34 in chips)
Seat 2: 1njbh8TKSUF6l4V1XwGdcg ($250.40 in chips)
Seat 3: vkfxu8f/jMYKUk6Ly4eujw ($225.60 in chips)
Seat 4: 9ni/OEXAqfc58zPQ0Tu9rQ ($269.60 in chips)
Seat 5: X7GlkHF+lkbarCLuZ4Uf0w ($38.15 in chips)
Seat 6: 9dpyyjDTCed6nV7JhaUUpw ($213.50 in chips)
9dpyyjDTCed6nV7JhaUUpw: posts small blind $1
yZgdnRylE65JbScQ7qCWgw: posts big blind $2
*** HOLE CARDS ***
1njbh8TKSUF6l4V1XwGdcg: folds
vkfxu8f/jMYKUk6Ly4eujw: raises $4 to $6
9ni/OEXAqfc58zPQ0Tu9rQ: folds
X7GlkHF+lkbarCLuZ4Uf0w: folds
9dpyyjDTCed6nV7JhaUUpw: folds
yZgdnRylE65JbScQ7qCWgw: folds
vkfxu8f/jMYKUk6Ly4eujw collected $5 from pot
vkfxu8f/jMYKUk6Ly4eujw: doesn't show hand
*** SUMMARY ***
Total pot $5 | Rake $0
Seat 1: yZgdnRylE65JbScQ7qCWgw (big blind) folded before Flop
Seat 2: 1njbh8TKSUF6l4V1XwGdcg folded before Flop (didn't bet)
Seat 3: vkfxu8f/jMYKUk6Ly4eujw collected ($5)
Seat 4: 9ni/OEXAqfc58zPQ0Tu9rQ folded before Flop (didn't bet)
Seat 5: X7GlkHF+lkbarCLuZ4Uf0w (button) folded before Flop (didn't bet)
Seat 6: 9dpyyjDTCed6nV7JhaUUpw (small blind) folded before Flop



PokerStars Game #59938096626:  Hold'em No Limit ($1/$2) - 2009/07/01 0:06:57 ET
Table 'HewZCzVOYGmuLDKthTi5Yw' 6-max Seat #1 is the button
Seat 1: 353332 ($241.75 in chips)
Seat 2: X7GlkHF+lkbarCLuZ4Uf0w ($37 in chips)
Seat 3: WJxW31eStwT28R2X/L8F5A ($53.50 in chips)
Seat 4: yZgdnRylE65JbScQ7qCWgw ($32 in chips)
Seat 5: 513FcCI8jHyQy2VWoIQkMg ($365.50 in chips)
X7GlkHF+lkbarCLuZ4Uf0w: posts small blind $1
WJxW31eStwT28R2X/L8F5A: posts big blind $2
*** HOLE CARDS ***
yZgdnRylE65JbScQ7qCWgw: folds
513FcCI8jHyQy2VWoIQkMg: folds
353332: raises $6 to $8
X7GlkHF+lkbarCLuZ4Uf0w: folds
WJxW31eStwT28R2X/L8F5A: folds
353332 collected $5 from pot
353332: doesn't show hand
*** SUMMARY ***
Total pot $5 | Rake $0
Seat 1: 353332 (button) collected ($5)
Seat 2: X7GlkHF+lkbarCLuZ4Uf0w (small blind) folded before Flop
Seat 3: WJxW31eStwT28R2X/L8F5A (big blind) folded before Flop
Seat 4: yZgdnRylE65JbScQ7qCWgw folded before Flop (didn't bet)
Seat 5: 513FcCI8jHyQy2VWoIQkMg folded before Flop (didn't bet)



PokerStars Game #59938097398:  Hold'em No Limit ($1/$2) - 2009/07/01 0:06:58 ET
Table '3FGoiEOffWrbgTfsB3t7FA' 2-max Seat #1 is the button
Seat 1: e0oDWyrmgLpR6bROEqw1nQ ($416.50 in chips)
Seat 2: +sy/nlNI20yZraIjs4AALg ($188.55 in chips)
e0oDWyrmgLpR6bROEqw1nQ: posts small blind $1
+sy/nlNI20yZraIjs4AALg: posts big blind $2
*** HOLE CARDS ***
e0oDWyrmgLpR6bROEqw1nQ: folds
+sy/nlNI20yZraIjs4AALg collected $2 from pot
*** SUMMARY ***
Total pot $2 | Rake $0
Seat 1: e0oDWyrmgLpR6bROEqw1nQ (button) (small blind) folded before Flop
Seat 2: +sy/nlNI20yZraIjs4AALg (big blind) collected ($2)



PokerStars Game #59938100246:  Hold'em No Limit ($1/$2) - 2009/07/01 0:07:02 ET
Table 'ZrKaj8fA5nb08RKhIpHkZA' 9-max Seat #5 is the button
Seat 1: Hc2itIxwbi1lwa+DAYYQGg ($37 in chips)
Seat 2: TAfo4veNRaRlzDXMMYS3Jg ($37 in chips)
Seat 3: GX1heJ+DSsvm7gzSPsYhhQ ($36 in chips)
Seat 4: isdXtU9uuSM2LGqOKxtlwA ($110.35 in chips)
Seat 5: YlSX2xwu8QMQReaxSAD8XA ($206.45 in chips)
Seat 6: Q3uFdu6ztesjDFiqkagTRQ ($200 in chips)
Seat 7: ztEPtIZdGv4TcxTUTzbY1w ($80.85 in chips)
Seat 8: tnv1uD25KOWgMmyKcuOVog ($274.30 in chips)
Seat 9: Z3aYCZG/yXHYFjiWkGI5ug ($259.25 in chips)
Q3uFdu6ztesjDFiqkagTRQ: posts small blind $1
ztEPtIZdGv4TcxTUTzbY1w: posts big blind $2
*** HOLE CARDS ***
tnv1uD25KOWgMmyKcuOVog: raises $2 to $4
Z3aYCZG/yXHYFjiWkGI5ug: folds
Hc2itIxwbi1lwa+DAYYQGg: folds
TAfo4veNRaRlzDXMMYS3Jg: folds
GX1heJ+DSsvm7gzSPsYhhQ: folds
isdXtU9uuSM2LGqOKxtlwA: calls $4
YlSX2xwu8QMQReaxSAD8XA: folds
Q3uFdu6ztesjDFiqkagTRQ: calls $3
ztEPtIZdGv4TcxTUTzbY1w: folds
*** FLOP *** [Ts Ah Jh]
Q3uFdu6ztesjDFiqkagTRQ: checks
tnv1uD25KOWgMmyKcuOVog: bets $4
isdXtU9uuSM2LGqOKxtlwA: calls $4
Q3uFdu6ztesjDFiqkagTRQ: folds
*** TURN *** [Ts Ah Jh] [Td]
tnv1uD25KOWgMmyKcuOVog: checks
isdXtU9uuSM2LGqOKxtlwA: checks
*** RIVER *** [Ts Ah Jh Td] [Kc]
tnv1uD25KOWgMmyKcuOVog: bets $12
isdXtU9uuSM2LGqOKxtlwA: folds
tnv1uD25KOWgMmyKcuOVog collected $20.95 from pot
*** SUMMARY ***
Total pot $22 | Rake $1.05
Board [Ts Ah Jh Td Kc]
Seat 1: Hc2itIxwbi1lwa+DAYYQGg folded before Flop (didn't bet)
Seat 2: TAfo4veNRaRlzDXMMYS3Jg folded before Flop (didn't bet)
Seat 3: GX1heJ+DSsvm7gzSPsYhhQ folded before Flop (didn't bet)
Seat 4: isdXtU9uuSM2LGqOKxtlwA folded on the River
Seat 5: YlSX2xwu8QMQReaxSAD8XA (button) folded before Flop (didn't bet)
Seat 6: Q3uFdu6ztesjDFiqkagTRQ (small blind) folded on the Flop
Seat 7: ztEPtIZdGv4TcxTUTzbY1w (big blind) folded before Flop
Seat 8: tnv1uD25KOWgMmyKcuOVog collected ($20.95)
Seat 9: Z3aYCZG/yXHYFjiWkGI5ug folded before Flop (didn't bet)



PokerStars Game #59938100018:  Hold'em No Limit ($1/$2) - 2009/07/01 0:07:02 ET
Table 'bIihwBANJSFqlHPPtset+w' 9-max Seat #8 is the button
Seat 1: jI3JDUGV63ccqtKgM3vMbw ($148.60 in chips)
Seat 2: lQYT23h5QCUVZAKxjOO39Q ($125.90 in chips)
Seat 3: acnZ0LD5jxKgWIHz+mpQ8Q ($217.40 in chips)
Seat 4: 7WWX5PClBdr/U44gUKBIEA ($284.65 in chips)
Seat 5: GX1heJ+DSsvm7gzSPsYhhQ ($60.65 in chips)
Seat 6: 5iPk5MyO3KVu18Y8XCYfFQ ($39 in chips)
Seat 7: 3q2/0oJr3Mcy1W5tcN61ug ($200 in chips)
Seat 8: iMe5yhc+1BaiIPHet3NMrA ($200 in chips)
Seat 9: rW/MyplHylMSBRaoRUzWrg ($36.55 in chips)
rW/MyplHylMSBRaoRUzWrg: posts small blind $1
jI3JDUGV63ccqtKgM3vMbw: posts big blind $2
*** HOLE CARDS ***
lQYT23h5QCUVZAKxjOO39Q: folds
acnZ0LD5jxKgWIHz+mpQ8Q: folds
7WWX5PClBdr/U44gUKBIEA: calls $2
GX1heJ+DSsvm7gzSPsYhhQ: calls $2
5iPk5MyO3KVu18Y8XCYfFQ: calls $2
3q2/0oJr3Mcy1W5tcN61ug: folds
iMe5yhc+1BaiIPHet3NMrA: calls $2
rW/MyplHylMSBRaoRUzWrg: calls $1
jI3JDUGV63ccqtKgM3vMbw: checks
*** FLOP *** [Ts 8c Td]
rW/MyplHylMSBRaoRUzWrg: checks
jI3JDUGV63ccqtKgM3vMbw: checks
7WWX5PClBdr/U44gUKBIEA: bets $8
GX1heJ+DSsvm7gzSPsYhhQ: raises $8 to $16
5iPk5MyO3KVu18Y8XCYfFQ: folds
iMe5yhc+1BaiIPHet3NMrA: calls $16
rW/MyplHylMSBRaoRUzWrg: folds
jI3JDUGV63ccqtKgM3vMbw: folds
7WWX5PClBdr/U44gUKBIEA: calls $8
*** TURN *** [Ts 8c Td] [9h]
7WWX5PClBdr/U44gUKBIEA: checks
GX1heJ+DSsvm7gzSPsYhhQ: checks
iMe5yhc+1BaiIPHet3NMrA: bets $28
7WWX5PClBdr/U44gUKBIEA: folds
GX1heJ+DSsvm7gzSPsYhhQ: calls $28
*** RIVER *** [Ts 8c Td 9h] [4d]
GX1heJ+DSsvm7gzSPsYhhQ: bets $14.65 and is all-in
iMe5yhc+1BaiIPHet3NMrA: calls $14.65
*** SHOW DOWN ***
GX1heJ+DSsvm7gzSPsYhhQ: shows [Jh Th] (three of a kind, Tens)
iMe5yhc+1BaiIPHet3NMrA: shows [Tc Kd] (three of a kind, Tens - King kicker)
iMe5yhc+1BaiIPHet3NMrA collected $142.30 from pot
*** SUMMARY ***
Total pot $145.30 | Rake $3
Board [Ts 8c Td 9h 4d]
Seat 1: jI3JDUGV63ccqtKgM3vMbw (big blind) folded on the Flop
Seat 2: lQYT23h5QCUVZAKxjOO39Q folded before Flop (didn't bet)
Seat 3: acnZ0LD5jxKgWIHz+mpQ8Q folded before Flop (didn't bet)
Seat 4: 7WWX5PClBdr/U44gUKBIEA folded on the Turn
Seat 5: GX1heJ+DSsvm7gzSPsYhhQ showed [Jh Th] and lost with three of a kind, Tens
Seat 6: 5iPk5MyO3KVu18Y8XCYfFQ folded on the Flop
Seat 7: 3q2/0oJr3Mcy1W5tcN61ug folded before Flop (didn't bet)
Seat 8: iMe5yhc+1BaiIPHet3NMrA (button) showed [Tc Kd] and won ($142.30) with three of a kind, Tens
Seat 9: rW/MyplHylMSBRaoRUzWrg (small blind) folded on the Flop



PokerStars Game #59938103154:  Hold'em No Limit ($1/$2) - 2009/07/01 0:07:06 ET
Table '3FGoiEOffWrbgTfsB3t7FA' 2-max Seat #2 is the button
Seat 1: e0oDWyrmgLpR6bROEqw1nQ ($415.50 in chips)
Seat 2: +sy/nlNI20yZraIjs4AALg ($189.55 in chips)
+sy/nlNI20yZraIjs4AALg: posts small blind $1
e0oDWyrmgLpR6bROEqw1nQ: posts big blind $2
*** HOLE CARDS ***
+sy/nlNI20yZraIjs4AALg: raises $2 to $4
e0oDWyrmgLpR6bROEqw1nQ: calls $2
*** FLOP *** [6s Qc 8s]
e0oDWyrmgLpR6bROEqw1nQ: checks
+sy/nlNI20yZraIjs4AALg: bets $8
e0oDWyrmgLpR6bROEqw1nQ: raises $18 to $26
+sy/nlNI20yZraIjs4AALg: folds
e0oDWyrmgLpR6bROEqw1nQ collected $23.50 from pot
*** SUMMARY ***
Total pot $24 | Rake $0.50
Board [6s Qc 8s]
Seat 1: e0oDWyrmgLpR6bROEqw1nQ (big blind) collected ($23.50)
Seat 2: +sy/nlNI20yZraIjs4AALg (button) (small blind) folded on the Flop



PokerStars Game #59938105046:  Hold'em No Limit ($1/$2) - 2009/07/01 0:07:09 ET
Table 'NmY84NAf9Mh0ckAckHnh5g' 2-max Seat #2 is the button
Seat 1: 6hvg964TSqZ3AL/0XK9aVQ ($336.20 in chips)
Seat 2: RwDoM55ZeQuI2ADyJhOb2Q ($258.30 in chips)
RwDoM55ZeQuI2ADyJhOb2Q: posts small blind $1
6hvg964TSqZ3AL/0XK9aVQ: posts big blind $2
*** HOLE CARDS ***
RwDoM55ZeQuI2ADyJhOb2Q: raises $4 to $6
6hvg964TSqZ3AL/0XK9aVQ: folds
RwDoM55ZeQuI2ADyJhOb2Q collected $4 from pot
RwDoM55ZeQuI2ADyJhOb2Q: doesn't show hand
*** SUMMARY ***
Total pot $4 | Rake $0
Seat 1: 6hvg964TSqZ3AL/0XK9aVQ (big blind) folded before Flop
Seat 2: RwDoM55ZeQuI2ADyJhOb2Q (button) (small blind) collected ($4)



PokerStars Game #59938107840:  Hold'em No Limit ($1/$2) - 2009/07/01 0:07:12 ET
Table 'uJ9juaXXg9yIcSU8amxaXQ' 6-max Seat #2 is the button
Seat 1: HhIxv6mylwCAfv3sjJmq5g ($200 in chips)
Seat 2: DQlskgG4OtLpF2MVxLwf4A ($284.05 in chips)
Seat 3: zaogaltCDFVsIASEnrXs2w ($260.75 in chips)
Seat 4: 54yWzRRgS0oZ+S6LwZBxMQ ($32 in chips)
Seat 5: X7GlkHF+lkbarCLuZ4Uf0w ($48 in chips)
Seat 6: XrFG4dK06RVKLlX32/pjcQ ($76.40 in chips)
zaogaltCDFVsIASEnrXs2w: posts small blind $1
54yWzRRgS0oZ+S6LwZBxMQ: posts big blind $2
*** HOLE CARDS ***
X7GlkHF+lkbarCLuZ4Uf0w: folds
XrFG4dK06RVKLlX32/pjcQ: folds
HhIxv6mylwCAfv3sjJmq5g: folds
DQlskgG4OtLpF2MVxLwf4A: raises $4 to $6
zaogaltCDFVsIASEnrXs2w: raises $12 to $18
54yWzRRgS0oZ+S6LwZBxMQ: folds
DQlskgG4OtLpF2MVxLwf4A: calls $12
*** FLOP *** [4h 7d 9h]
zaogaltCDFVsIASEnrXs2w: bets $18
XrFG4dK06RVKLlX32/pjcQ is sitting out
DQlskgG4OtLpF2MVxLwf4A: calls $18
*** TURN *** [4h 7d 9h] [Ks]
zaogaltCDFVsIASEnrXs2w: checks
DQlskgG4OtLpF2MVxLwf4A: checks
*** RIVER *** [4h 7d 9h Ks] [8d]
zaogaltCDFVsIASEnrXs2w: checks
DQlskgG4OtLpF2MVxLwf4A: checks
*** SHOW DOWN ***
zaogaltCDFVsIASEnrXs2w: shows [7h 6h] (a pair of Sevens)
DQlskgG4OtLpF2MVxLwf4A: mucks hand
zaogaltCDFVsIASEnrXs2w collected $71 from pot
*** SUMMARY ***
Total pot $74 | Rake $3
Board [4h 7d 9h Ks 8d]
Seat 1: HhIxv6mylwCAfv3sjJmq5g folded before Flop (didn't bet)
Seat 2: DQlskgG4OtLpF2MVxLwf4A (button) mucked
Seat 3: zaogaltCDFVsIASEnrXs2w (small blind) showed [7h 6h] and won ($71) with a pair of Sevens
Seat 4: 54yWzRRgS0oZ+S6LwZBxMQ (big blind) folded before Flop
Seat 5: X7GlkHF+lkbarCLuZ4Uf0w folded before Flop (didn't bet)
Seat 6: XrFG4dK06RVKLlX32/pjcQ folded before Flop (didn't bet)



PokerStars Game #59938107486:  Hold'em No Limit ($1/$2) - 2009/07/01 0:07:12 ET
Table 'ztv6V3FN2bQ9nmJPPdx6nQ' 6-max Seat #1 is the button
Seat 1: ek1hig03QiyONDHXvgqteQ ($181.05 in chips)
Seat 4: vkfxu8f/jMYKUk6Ly4eujw ($350.70 in chips)
Seat 5: sTPOWERd9HWPCNrDBwsVjA ($195.75 in chips)
Seat 6: yZgdnRylE65JbScQ7qCWgw ($31 in chips)
vkfxu8f/jMYKUk6Ly4eujw: posts small blind $1
sTPOWERd9HWPCNrDBwsVjA: posts big blind $2
*** HOLE CARDS ***
yZgdnRylE65JbScQ7qCWgw: folds
ek1hig03QiyONDHXvgqteQ: folds
vkfxu8f/jMYKUk6Ly4eujw: raises $6 to $8
sTPOWERd9HWPCNrDBwsVjA: calls $6
*** FLOP *** [3s 5c 5s]
vkfxu8f/jMYKUk6Ly4eujw: checks
sTPOWERd9HWPCNrDBwsVjA: checks
*** TURN *** [3s 5c 5s] [Jc]
vkfxu8f/jMYKUk6Ly4eujw: checks
sTPOWERd9HWPCNrDBwsVjA: bets $8
vkfxu8f/jMYKUk6Ly4eujw: folds
sTPOWERd9HWPCNrDBwsVjA collected $15.20 from pot
*** SUMMARY ***
Total pot $16 | Rake $0.80
Board [3s 5c 5s Jc]
Seat 1: ek1hig03QiyONDHXvgqteQ (button) folded before Flop (didn't bet)
Seat 4: vkfxu8f/jMYKUk6Ly4eujw (small blind) folded on the Turn
Seat 5: sTPOWERd9HWPCNrDBwsVjA (big blind) collected ($15.20)
Seat 6: yZgdnRylE65JbScQ7qCWgw folded before Flop (didn't bet)



PokerStars Game #59938108426:  Hold'em No Limit ($1/$2) - 2009/07/01 0:07:13 ET
Table 'LL4bDFyhj5hsMpzaDugJZg' 6-max Seat #3 is the button
Seat 1: IBW9lyGsaRmfcbyA/qFfEw ($78.20 in chips)
Seat 2: L3l+A4pJhOAD6HVVFXvVBw ($289.15 in chips)
Seat 3: gGPaCoSWW1HoKYaqfAPecg ($200 in chips)
Seat 4: 8srN1dKQePlsv0GyTada+Q ($280.50 in chips)
Seat 5: HgX0VeqE/dzSXd5BpntRBw ($200 in chips)
Seat 6: yZgdnRylE65JbScQ7qCWgw ($40 in chips)
8srN1dKQePlsv0GyTada+Q: posts small blind $1
HgX0VeqE/dzSXd5BpntRBw: posts big blind $2
*** HOLE CARDS ***
yZgdnRylE65JbScQ7qCWgw: folds
IBW9lyGsaRmfcbyA/qFfEw: calls $2
L3l+A4pJhOAD6HVVFXvVBw: folds
gGPaCoSWW1HoKYaqfAPecg: raises $7 to $9
8srN1dKQePlsv0GyTada+Q: folds
HgX0VeqE/dzSXd5BpntRBw: folds
IBW9lyGsaRmfcbyA/qFfEw: folds
gGPaCoSWW1HoKYaqfAPecg collected $7 from pot
gGPaCoSWW1HoKYaqfAPecg: doesn't show hand
*** SUMMARY ***
Total pot $7 | Rake $0
Seat 1: IBW9lyGsaRmfcbyA/qFfEw folded before Flop
Seat 2: L3l+A4pJhOAD6HVVFXvVBw folded before Flop (didn't bet)
Seat 3: gGPaCoSWW1HoKYaqfAPecg (button) collected ($7)
Seat 4: 8srN1dKQePlsv0GyTada+Q (small blind) folded before Flop
Seat 5: HgX0VeqE/dzSXd5BpntRBw (big blind) folded before Flop
Seat 6: yZgdnRylE65JbScQ7qCWgw folded before Flop (didn't bet)



PokerStars Game #59938108866:  Hold'em No Limit ($1/$2) - 2009/07/01 0:07:14 ET
Table 'YqGfR5eHfMeSjb9a+QU9rg' 9-max Seat #7 is the button
Seat 1: qCBuzVnLcBR29snMAHq9PA ($162.35 in chips)
Seat 2: W3Nqt1GWlTi9tXQXMNEvgw ($234.65 in chips)
Seat 3: /gll27k+xWYV7Fbki0lFDQ ($88.25 in chips)
Seat 4: QHxJjpVYwitg9krW6wZgJA ($200 in chips)
Seat 5: MOBMOMQRN/z+fiGXGnZojw ($175.10 in chips)
Seat 6: 5iPk5MyO3KVu18Y8XCYfFQ ($39 in chips)
Seat 7: b0jO1SDhLedy1//CQlA8kw ($39 in chips)
Seat 8: JnV3SM2D6dAFYyGZHHpvrg ($98 in chips)
Seat 9: RsrgM2l7PLbQ9xBbSi3IvQ ($119.55 in chips)
JnV3SM2D6dAFYyGZHHpvrg: posts small blind $1
RsrgM2l7PLbQ9xBbSi3IvQ: posts big blind $2
*** HOLE CARDS ***
qCBuzVnLcBR29snMAHq9PA: calls $2
W3Nqt1GWlTi9tXQXMNEvgw: folds
/gll27k+xWYV7Fbki0lFDQ: folds
QHxJjpVYwitg9krW6wZgJA: folds
MOBMOMQRN/z+fiGXGnZojw: calls $2
5iPk5MyO3KVu18Y8XCYfFQ: raises $37 to $39 and is all-in
b0jO1SDhLedy1//CQlA8kw: folds
JnV3SM2D6dAFYyGZHHpvrg: folds
RsrgM2l7PLbQ9xBbSi3IvQ: folds
qCBuzVnLcBR29snMAHq9PA: folds
MOBMOMQRN/z+fiGXGnZojw: folds
5iPk5MyO3KVu18Y8XCYfFQ collected $9 from pot
5iPk5MyO3KVu18Y8XCYfFQ: doesn't show hand
*** SUMMARY ***
Total pot $9 | Rake $0
Seat 1: qCBuzVnLcBR29snMAHq9PA folded before Flop
Seat 2: W3Nqt1GWlTi9tXQXMNEvgw folded before Flop (didn't bet)
Seat 3: /gll27k+xWYV7Fbki0lFDQ folded before Flop (didn't bet)
Seat 4: QHxJjpVYwitg9krW6wZgJA folded before Flop (didn't bet)
Seat 5: MOBMOMQRN/z+fiGXGnZojw folded before Flop
Seat 6: 5iPk5MyO3KVu18Y8XCYfFQ collected ($9)
Seat 7: b0jO1SDhLedy1//CQlA8kw (button) folded before Flop (didn't bet)
Seat 8: JnV3SM2D6dAFYyGZHHpvrg (small blind) folded before Flop
Seat 9: RsrgM2l7PLbQ9xBbSi3IvQ (big blind) folded before Flop



PokerStars Game #59938109132:  Hold'em No Limit ($1/$2) - 2009/07/01 0:07:14 ET
Table 'SF49/KQm8T4taMp6kb+HXA' 9-max Seat #8 is the button
Seat 1: l1bCLGuFqeFRwUfPsiDu/g ($183.95 in chips)
Seat 2: dJO4Wtu5e7hHBlpz0cmy1w ($71.20 in chips)
Seat 3: L88dtdULfz5oGDSuo9/RvA ($43.80 in chips)
Seat 4: HffgoYm61KgkdMe/DYChIQ ($38 in chips)
Seat 5: Z3aYCZG/yXHYFjiWkGI5ug ($227.55 in chips)
Seat 6: M2ht6rIKOI/my9eh610Nlw ($247.45 in chips)
Seat 8: 5iPk5MyO3KVu18Y8XCYfFQ ($36 in chips)
Seat 9: O+jytCilwk7zItVCEavmtw ($138 in chips)
O+jytCilwk7zItVCEavmtw: posts small blind $1
l1bCLGuFqeFRwUfPsiDu/g: posts big blind $2
*** HOLE CARDS ***
dJO4Wtu5e7hHBlpz0cmy1w: folds
L88dtdULfz5oGDSuo9/RvA: folds
HffgoYm61KgkdMe/DYChIQ: folds
dJO4Wtu5e7hHBlpz0cmy1w leaves the table
Z3aYCZG/yXHYFjiWkGI5ug: folds
M2ht6rIKOI/my9eh610Nlw: folds
5iPk5MyO3KVu18Y8XCYfFQ: raises $2 to $4
O+jytCilwk7zItVCEavmtw: folds
l1bCLGuFqeFRwUfPsiDu/g: folds
8Z3QifiM9eOd5EIJ25dXNg joins the table at seat #2
5iPk5MyO3KVu18Y8XCYfFQ collected $5 from pot
*** SUMMARY ***
Total pot $5 | Rake $0
Seat 1: l1bCLGuFqeFRwUfPsiDu/g (big blind) folded before Flop
Seat 2: dJO4Wtu5e7hHBlpz0cmy1w folded before Flop (didn't bet)
Seat 3: L88dtdULfz5oGDSuo9/RvA folded before Flop (didn't bet)
Seat 4: HffgoYm61KgkdMe/DYChIQ folded before Flop (didn't bet)
Seat 5: Z3aYCZG/yXHYFjiWkGI5ug folded before Flop (didn't bet)
Seat 6: M2ht6rIKOI/my9eh610Nlw folded before Flop (didn't bet)
Seat 8: 5iPk5MyO3KVu18Y8XCYfFQ (button) collected ($5)
Seat 9: O+jytCilwk7zItVCEavmtw (small blind) folded before Flop



PokerStars Game #59938110442:  Hold'em No Limit ($1/$2) - 2009/07/01 0:07:16 ET
Table 'HewZCzVOYGmuLDKthTi5Yw' 6-max Seat #2 is the button
Seat 1: 353332 ($244.75 in chips)
Seat 2: X7GlkHF+lkbarCLuZ4Uf0w ($36 in chips)
Seat 3: WJxW31eStwT28R2X/L8F5A ($51.50 in chips)
Seat 4: yZgdnRylE65JbScQ7qCWgw ($32 in chips)
Seat 5: 513FcCI8jHyQy2VWoIQkMg ($365.50 in chips)
WJxW31eStwT28R2X/L8F5A: posts small blind $1
yZgdnRylE65JbScQ7qCWgw: posts big blind $2
*** HOLE CARDS ***
513FcCI8jHyQy2VWoIQkMg: folds
353332: raises $6 to $8
X7GlkHF+lkbarCLuZ4Uf0w: folds
WJxW31eStwT28R2X/L8F5A: folds
yZgdnRylE65JbScQ7qCWgw: folds
353332 collected $5 from pot
353332: doesn't show hand
*** SUMMARY ***
Total pot $5 | Rake $0
Seat 1: 353332 collected ($5)
Seat 2: X7GlkHF+lkbarCLuZ4Uf0w (button) folded before Flop (didn't bet)
Seat 3: WJxW31eStwT28R2X/L8F5A (small blind) folded before Flop
Seat 4: yZgdnRylE65JbScQ7qCWgw (big blind) folded before Flop
Seat 5: 513FcCI8jHyQy2VWoIQkMg folded before Flop (didn't bet)



PokerStars Game #59938110928:  Hold'em No Limit ($1/$2) - 2009/07/01 0:07:16 ET
Table 'aSf77Sj8QEnzcc0WaxVD4Q' 6-max Seat #1 is the button
Seat 1: Q3uFdu6ztesjDFiqkagTRQ ($228.35 in chips)
Seat 2: vkfxu8f/jMYKUk6Ly4eujw ($196.75 in chips)
Seat 3: 9dpyyjDTCed6nV7JhaUUpw ($220.05 in chips)
Seat 4: 513FcCI8jHyQy2VWoIQkMg ($203 in chips)
Seat 5: InmkdI6G8TzSj9NhcCSyPg ($269 in chips)
Seat 6: vkoJRf3gidxY1pPi0AFWww ($309.80 in chips)
vkfxu8f/jMYKUk6Ly4eujw: posts small blind $1
9dpyyjDTCed6nV7JhaUUpw: posts big blind $2
*** HOLE CARDS ***
513FcCI8jHyQy2VWoIQkMg: folds
InmkdI6G8TzSj9NhcCSyPg: folds
vkoJRf3gidxY1pPi0AFWww: folds
Q3uFdu6ztesjDFiqkagTRQ: folds
vkfxu8f/jMYKUk6Ly4eujw: folds
9dpyyjDTCed6nV7JhaUUpw collected $2 from pot
9dpyyjDTCed6nV7JhaUUpw: doesn't show hand
*** SUMMARY ***
Total pot $2 | Rake $0
Seat 1: Q3uFdu6ztesjDFiqkagTRQ (button) folded before Flop (didn't bet)
Seat 2: vkfxu8f/jMYKUk6Ly4eujw (small blind) folded before Flop
Seat 3: 9dpyyjDTCed6nV7JhaUUpw (big blind) collected ($2)
Seat 4: 513FcCI8jHyQy2VWoIQkMg folded before Flop (didn't bet)
Seat 5: InmkdI6G8TzSj9NhcCSyPg folded before Flop (didn't bet)
Seat 6: vkoJRf3gidxY1pPi0AFWww folded before Flop (didn't bet)



PokerStars Game #59938110582:  Hold'em No Limit ($1/$2) - 2009/07/01 0:07:16 ET
Table 'NmY84NAf9Mh0ckAckHnh5g' 2-max Seat #1 is the button
Seat 1: 6hvg964TSqZ3AL/0XK9aVQ ($334.20 in chips)
Seat 2: RwDoM55ZeQuI2ADyJhOb2Q ($260.30 in chips)
6hvg964TSqZ3AL/0XK9aVQ: posts small blind $1
RwDoM55ZeQuI2ADyJhOb2Q: posts big blind $2
*** HOLE CARDS ***
6hvg964TSqZ3AL/0XK9aVQ: calls $1
RwDoM55ZeQuI2ADyJhOb2Q: checks
*** FLOP *** [5s 4d As]
RwDoM55ZeQuI2ADyJhOb2Q: bets $4
6hvg964TSqZ3AL/0XK9aVQ: calls $4
*** TURN *** [5s 4d As] [4c]
RwDoM55ZeQuI2ADyJhOb2Q: bets $12
6hvg964TSqZ3AL/0XK9aVQ: folds
RwDoM55ZeQuI2ADyJhOb2Q collected $11.50 from pot
RwDoM55ZeQuI2ADyJhOb2Q: doesn't show hand
*** SUMMARY ***
Total pot $12 | Rake $0.50
Board [5s 4d As 4c]
Seat 1: 6hvg964TSqZ3AL/0XK9aVQ (button) (small blind) folded on the Turn
Seat 2: RwDoM55ZeQuI2ADyJhOb2Q (big blind) collected ($11.50)



PokerStars Game #59938111780:  Hold'em No Limit ($1/$2) - 2009/07/01 0:07:18 ET
Table 'eyAQSIlgc2o1Jxvbve4WGg' 9-max Seat #7 is the button
Seat 1: Q3uFdu6ztesjDFiqkagTRQ ($237 in chips)
Seat 2: GX1heJ+DSsvm7gzSPsYhhQ ($39 in chips)
Seat 3: TAfo4veNRaRlzDXMMYS3Jg ($40 in chips)
Seat 4: Lr5OlNr2kebm3oHSC54eJg ($115.95 in chips)
Seat 6: IikcENBHwoT7snSvBPSc7Q ($173.85 in chips)
Seat 7: QHxJjpVYwitg9krW6wZgJA ($200 in chips)
Seat 8: 5iPk5MyO3KVu18Y8XCYfFQ ($37 in chips)
Seat 9: Hc2itIxwbi1lwa+DAYYQGg ($50.85 in chips)
5iPk5MyO3KVu18Y8XCYfFQ: posts small blind $1
Hc2itIxwbi1lwa+DAYYQGg: posts big blind $2
JnV3SM2D6dAFYyGZHHpvrg: sits out
*** HOLE CARDS ***
Q3uFdu6ztesjDFiqkagTRQ: folds
GX1heJ+DSsvm7gzSPsYhhQ: raises $4 to $6
TAfo4veNRaRlzDXMMYS3Jg: folds
Lr5OlNr2kebm3oHSC54eJg: folds
IikcENBHwoT7snSvBPSc7Q: folds
QHxJjpVYwitg9krW6wZgJA: folds
5iPk5MyO3KVu18Y8XCYfFQ: folds
Hc2itIxwbi1lwa+DAYYQGg: folds
GX1heJ+DSsvm7gzSPsYhhQ collected $5 from pot
GX1heJ+DSsvm7gzSPsYhhQ: doesn't show hand
*** SUMMARY ***
Total pot $5 | Rake $0
Seat 1: Q3uFdu6ztesjDFiqkagTRQ folded before Flop (didn't bet)
Seat 2: GX1heJ+DSsvm7gzSPsYhhQ collected ($5)
Seat 3: TAfo4veNRaRlzDXMMYS3Jg folded before Flop (didn't bet)
Seat 4: Lr5OlNr2kebm3oHSC54eJg folded before Flop (didn't bet)
Seat 6: IikcENBHwoT7snSvBPSc7Q folded before Flop (didn't bet)
Seat 7: QHxJjpVYwitg9krW6wZgJA (button) folded before Flop (didn't bet)
Seat 8: 5iPk5MyO3KVu18Y8XCYfFQ (small blind) folded before Flop
Seat 9: Hc2itIxwbi1lwa+DAYYQGg (big blind) folded before Flop



PokerStars Game #59938114700:  Hold'em No Limit ($1/$2) - 2009/07/01 0:07:22 ET
Table 'WCA60bDA8ecovUgFSIZkTQ' 9-max Seat #9 is the button
Seat 2: G1h8wamBcVJXtsKXZQ2EyA ($44.70 in chips)
Seat 3: 5iPk5MyO3KVu18Y8XCYfFQ ($40 in chips)
Seat 4: Q3uFdu6ztesjDFiqkagTRQ ($484.70 in chips)
Seat 5: Hc2itIxwbi1lwa+DAYYQGg ($309.30 in chips)
Seat 6: DOWQSOJ7GaX+ksfWTqPT5A ($275.05 in chips)
Seat 7: GX1heJ+DSsvm7gzSPsYhhQ ($40 in chips)
Seat 8: x+V1JgVDawsJTxKcxm7gxw ($95 in chips)
Seat 9: 3q2/0oJr3Mcy1W5tcN61ug ($298.20 in chips)
CUZwDpLTQKhzarPe+JCLOQ will be allowed to play after the button
G1h8wamBcVJXtsKXZQ2EyA: posts small blind $1
5iPk5MyO3KVu18Y8XCYfFQ: posts big blind $2
*** HOLE CARDS ***
Q3uFdu6ztesjDFiqkagTRQ: folds
Hc2itIxwbi1lwa+DAYYQGg: folds
DOWQSOJ7GaX+ksfWTqPT5A: folds
GX1heJ+DSsvm7gzSPsYhhQ: raises $4 to $6
x+V1JgVDawsJTxKcxm7gxw: folds
3q2/0oJr3Mcy1W5tcN61ug: folds
G1h8wamBcVJXtsKXZQ2EyA: folds
5iPk5MyO3KVu18Y8XCYfFQ: folds
GX1heJ+DSsvm7gzSPsYhhQ collected $5 from pot
GX1heJ+DSsvm7gzSPsYhhQ: doesn't show hand
*** SUMMARY ***
Total pot $5 | Rake $0
Seat 2: G1h8wamBcVJXtsKXZQ2EyA (small blind) folded before Flop
Seat 3: 5iPk5MyO3KVu18Y8XCYfFQ (big blind) folded before Flop
Seat 4: Q3uFdu6ztesjDFiqkagTRQ folded before Flop (didn't bet)
Seat 5: Hc2itIxwbi1lwa+DAYYQGg folded before Flop (didn't bet)
Seat 6: DOWQSOJ7GaX+ksfWTqPT5A folded before Flop (didn't bet)
Seat 7: GX1heJ+DSsvm7gzSPsYhhQ collected ($5)
Seat 8: x+V1JgVDawsJTxKcxm7gxw folded before Flop (didn't bet)
Seat 9: 3q2/0oJr3Mcy1W5tcN61ug (button) folded before Flop (didn't bet)



PokerStars Game #59938115112:  Hold'em No Limit ($1/$2) - 2009/07/01 0:07:22 ET
Table 'gnHBqWll9O3fxG7Ojkz/ng' 9-max Seat #8 is the button
Seat 1: hpqdC/23wXosGOmzARr5NA ($156.30 in chips)
Seat 2: H6Z4+qu8gR0VUiPOijndVg ($200 in chips)
Seat 3: 5Q8U6iZbeO7xJSS4qvDP5g ($218.60 in chips)
Seat 4: n5XI5/7gN+gIubHFBH+mOw ($404.85 in chips)
Seat 5: GX1heJ+DSsvm7gzSPsYhhQ ($54.75 in chips)
Seat 6: 5iPk5MyO3KVu18Y8XCYfFQ ($43.45 in chips)
Seat 7: jqui3xAWCkcdPW36a6BD+w ($212.80 in chips)
Seat 8: De9g+AYjo0DN6C/+iT/nsg ($244.05 in chips)
Seat 9: kVCeGJ4NY7Fb0W74j1mAqA ($204 in chips)
kVCeGJ4NY7Fb0W74j1mAqA: posts small blind $1
hpqdC/23wXosGOmzARr5NA: posts big blind $2
*** HOLE CARDS ***
H6Z4+qu8gR0VUiPOijndVg: folds
5Q8U6iZbeO7xJSS4qvDP5g: folds
n5XI5/7gN+gIubHFBH+mOw: folds
GX1heJ+DSsvm7gzSPsYhhQ: folds
5iPk5MyO3KVu18Y8XCYfFQ: folds
jqui3xAWCkcdPW36a6BD+w: folds
De9g+AYjo0DN6C/+iT/nsg: folds
kVCeGJ4NY7Fb0W74j1mAqA: folds
hpqdC/23wXosGOmzARr5NA collected $2 from pot
hpqdC/23wXosGOmzARr5NA: doesn't show hand
*** SUMMARY ***
Total pot $2 | Rake $0
Seat 1: hpqdC/23wXosGOmzARr5NA (big blind) collected ($2)
Seat 2: H6Z4+qu8gR0VUiPOijndVg folded before Flop (didn't bet)
Seat 3: 5Q8U6iZbeO7xJSS4qvDP5g folded before Flop (didn't bet)
Seat 4: n5XI5/7gN+gIubHFBH+mOw folded before Flop (didn't bet)
Seat 5: GX1heJ+DSsvm7gzSPsYhhQ folded before Flop (didn't bet)
Seat 6: 5iPk5MyO3KVu18Y8XCYfFQ folded before Flop (didn't bet)
Seat 7: jqui3xAWCkcdPW36a6BD+w folded before Flop (didn't bet)
Seat 8: De9g+AYjo0DN6C/+iT/nsg (button) folded before Flop (didn't bet)
Seat 9: kVCeGJ4NY7Fb0W74j1mAqA (small blind) folded before Flop



PokerStars Game #59938118010:  Hold'em No Limit ($1/$2) - 2009/07/01 0:07:26 ET
Table 'bJQ024BaYSBrW0sXpCZbNQ' 6-max Seat #6 is the button
Seat 1: yZgdnRylE65JbScQ7qCWgw ($32 in chips)
Seat 2: 1njbh8TKSUF6l4V1XwGdcg ($250.40 in chips)
Seat 3: vkfxu8f/jMYKUk6Ly4eujw ($228.60 in chips)
Seat 4: 9ni/OEXAqfc58zPQ0Tu9rQ ($269.60 in chips)
Seat 5: X7GlkHF+lkbarCLuZ4Uf0w ($38.15 in chips)
Seat 6: 9dpyyjDTCed6nV7JhaUUpw ($212.50 in chips)
yZgdnRylE65JbScQ7qCWgw: posts small blind $1
1njbh8TKSUF6l4V1XwGdcg: posts big blind $2
*** HOLE CARDS ***
vkfxu8f/jMYKUk6Ly4eujw: raises $4 to $6
9ni/OEXAqfc58zPQ0Tu9rQ: folds
X7GlkHF+lkbarCLuZ4Uf0w: folds
9dpyyjDTCed6nV7JhaUUpw: folds
yZgdnRylE65JbScQ7qCWgw: folds
1njbh8TKSUF6l4V1XwGdcg: calls $4
*** FLOP *** [2d 7d Th]
1njbh8TKSUF6l4V1XwGdcg: checks
vkfxu8f/jMYKUk6Ly4eujw: bets $8
1njbh8TKSUF6l4V1XwGdcg: raises $16 to $24
vkfxu8f/jMYKUk6Ly4eujw: folds
1njbh8TKSUF6l4V1XwGdcg collected $27.60 from pot
*** SUMMARY ***
Total pot $29 | Rake $1.40
Board [2d 7d Th]
Seat 1: yZgdnRylE65JbScQ7qCWgw (small blind) folded before Flop
Seat 2: 1njbh8TKSUF6l4V1XwGdcg (big blind) collected ($27.60)
Seat 3: vkfxu8f/jMYKUk6Ly4eujw folded on the Flop
Seat 4: 9ni/OEXAqfc58zPQ0Tu9rQ folded before Flop (didn't bet)
Seat 5: X7GlkHF+lkbarCLuZ4Uf0w folded before Flop (didn't bet)
Seat 6: 9dpyyjDTCed6nV7JhaUUpw (button) folded before Flop (didn't bet)



PokerStars Game #59938117618:  Hold'em No Limit ($1/$2) - 2009/07/01 0:07:26 ET
Table 'l5lZHc5JRHEDt0Y2AVPq3g' 6-max Seat #4 is the button
Seat 1: gGPaCoSWW1HoKYaqfAPecg ($203.30 in chips)
Seat 2: my38j/MmtBd/8qVwmyCREA ($262.15 in chips)
Seat 3: yZgdnRylE65JbScQ7qCWgw ($40 in chips)
Seat 4: zNjJ/y4emmF+vzrCDd+ooA ($203.95 in chips)
Seat 5: 6fLdOUCRtX71xbVRhJEq8w ($200 in chips)
Seat 6: vkfxu8f/jMYKUk6Ly4eujw ($200.90 in chips)
6fLdOUCRtX71xbVRhJEq8w: posts small blind $1
vkfxu8f/jMYKUk6Ly4eujw: posts big blind $2
*** HOLE CARDS ***
gGPaCoSWW1HoKYaqfAPecg: folds
my38j/MmtBd/8qVwmyCREA: calls $2
yZgdnRylE65JbScQ7qCWgw: folds
zNjJ/y4emmF+vzrCDd+ooA: folds
6fLdOUCRtX71xbVRhJEq8w: folds
vkfxu8f/jMYKUk6Ly4eujw: checks
*** FLOP *** [7h 6s Qd]
vkfxu8f/jMYKUk6Ly4eujw: checks
my38j/MmtBd/8qVwmyCREA: bets $4
vkfxu8f/jMYKUk6Ly4eujw: calls $4
*** TURN *** [7h 6s Qd] [4c]
vkfxu8f/jMYKUk6Ly4eujw: checks
my38j/MmtBd/8qVwmyCREA: checks
*** RIVER *** [7h 6s Qd 4c] [4h]
vkfxu8f/jMYKUk6Ly4eujw: checks
my38j/MmtBd/8qVwmyCREA: checks
*** SHOW DOWN ***
vkfxu8f/jMYKUk6Ly4eujw: shows [Ac 7s] (two pair, Sevens and Fours)
my38j/MmtBd/8qVwmyCREA: mucks hand
vkfxu8f/jMYKUk6Ly4eujw collected $12.40 from pot
*** SUMMARY ***
Total pot $13 | Rake $0.60
Board [7h 6s Qd 4c 4h]
Seat 1: gGPaCoSWW1HoKYaqfAPecg folded before Flop (didn't bet)
Seat 2: my38j/MmtBd/8qVwmyCREA mucked
Seat 3: yZgdnRylE65JbScQ7qCWgw folded before Flop (didn't bet)
Seat 4: zNjJ/y4emmF+vzrCDd+ooA (button) folded before Flop (didn't bet)
Seat 5: 6fLdOUCRtX71xbVRhJEq8w (small blind) folded before Flop
Seat 6: vkfxu8f/jMYKUk6Ly4eujw (big blind) showed [Ac 7s] and won ($12.40) with two pair, Sevens and Fours



PokerStars Game #59938119896:  Hold'em No Limit ($1/$2) - 2009/07/01 0:07:29 ET
Table 'HewZCzVOYGmuLDKthTi5Yw' 6-max Seat #3 is the button
Seat 1: 353332 ($247.75 in chips)
Seat 2: X7GlkHF+lkbarCLuZ4Uf0w ($36 in chips)
Seat 3: WJxW31eStwT28R2X/L8F5A ($50.50 in chips)
Seat 4: yZgdnRylE65JbScQ7qCWgw ($30 in chips)
Seat 5: 513FcCI8jHyQy2VWoIQkMg ($365.50 in chips)
yZgdnRylE65JbScQ7qCWgw: posts small blind $1
513FcCI8jHyQy2VWoIQkMg: posts big blind $2
*** HOLE CARDS ***
353332: folds
X7GlkHF+lkbarCLuZ4Uf0w: folds
WJxW31eStwT28R2X/L8F5A: calls $2
yZgdnRylE65JbScQ7qCWgw: folds
513FcCI8jHyQy2VWoIQkMg: checks
*** FLOP *** [6h 4c 4h]
513FcCI8jHyQy2VWoIQkMg: checks
WJxW31eStwT28R2X/L8F5A: bets $4
513FcCI8jHyQy2VWoIQkMg: folds
WJxW31eStwT28R2X/L8F5A collected $4.75 from pot
WJxW31eStwT28R2X/L8F5A: doesn't show hand
*** SUMMARY ***
Total pot $5 | Rake $0.25
Board [6h 4c 4h]
Seat 1: 353332 folded before Flop (didn't bet)
Seat 2: X7GlkHF+lkbarCLuZ4Uf0w folded before Flop (didn't bet)
Seat 3: WJxW31eStwT28R2X/L8F5A (button) collected ($4.75)
Seat 4: yZgdnRylE65JbScQ7qCWgw (small blind) folded before Flop
Seat 5: 513FcCI8jHyQy2VWoIQkMg (big blind) folded on the Flop



PokerStars Game #59938121878:  Hold'em No Limit ($1/$2) - 2009/07/01 0:07:32 ET
Table 'qVXak+oTeDXMGbWa4sDU5Q' 9-max Seat #4 is the button
Seat 1: H6Z4+qu8gR0VUiPOijndVg ($250 in chips)
Seat 2: Hc2itIxwbi1lwa+DAYYQGg ($49 in chips)
Seat 3: oz9eCXGC7DdjQlL/nuWj1A ($105.85 in chips)
Seat 4: b0jO1SDhLedy1//CQlA8kw ($37 in chips)
Seat 6: Q3uFdu6ztesjDFiqkagTRQ ($242.65 in chips)
Seat 7: 5iPk5MyO3KVu18Y8XCYfFQ ($59.50 in chips)
Seat 8: 9pHZMviI9R8injxojGTnvw ($58.85 in chips)
Seat 9: IZ/2qsh1CIg9m5PWsMsLmA ($360.95 in chips)
Q3uFdu6ztesjDFiqkagTRQ: posts small blind $1
5iPk5MyO3KVu18Y8XCYfFQ: posts big blind $2
*** HOLE CARDS ***
9pHZMviI9R8injxojGTnvw: folds
IZ/2qsh1CIg9m5PWsMsLmA: folds
NqKRc5xvcye0d7F6VOF6MQ joins the table at seat #5
H6Z4+qu8gR0VUiPOijndVg: folds
Hc2itIxwbi1lwa+DAYYQGg: folds
oz9eCXGC7DdjQlL/nuWj1A: folds
b0jO1SDhLedy1//CQlA8kw: folds
Q3uFdu6ztesjDFiqkagTRQ: raises $4 to $6
5iPk5MyO3KVu18Y8XCYfFQ: raises $8 to $14
Q3uFdu6ztesjDFiqkagTRQ: raises $132 to $146
5iPk5MyO3KVu18Y8XCYfFQ: calls $45.50 and is all-in
*** FLOP *** [Kh 9s Th]
*** TURN *** [Kh 9s Th] [6d]
*** RIVER *** [Kh 9s Th 6d] [9d]
*** SHOW DOWN ***
Q3uFdu6ztesjDFiqkagTRQ: shows [8s 8c] (two pair, Nines and Eights)
5iPk5MyO3KVu18Y8XCYfFQ: shows [Qh Qc] (two pair, Queens and Nines)
5iPk5MyO3KVu18Y8XCYfFQ collected $116 from pot
*** SUMMARY ***
Total pot $119 | Rake $3
Board [Kh 9s Th 6d 9d]
Seat 1: H6Z4+qu8gR0VUiPOijndVg folded before Flop (didn't bet)
Seat 2: Hc2itIxwbi1lwa+DAYYQGg folded before Flop (didn't bet)
Seat 3: oz9eCXGC7DdjQlL/nuWj1A folded before Flop (didn't bet)
Seat 4: b0jO1SDhLedy1//CQlA8kw (button) folded before Flop (didn't bet)
Seat 6: Q3uFdu6ztesjDFiqkagTRQ (small blind) showed [8s 8c] and lost with two pair, Nines and Eights
Seat 7: 5iPk5MyO3KVu18Y8XCYfFQ (big blind) showed [Qh Qc] and won ($116) with two pair, Queens and Nines
Seat 8: 9pHZMviI9R8injxojGTnvw folded before Flop (didn't bet)
Seat 9: IZ/2qsh1CIg9m5PWsMsLmA folded before Flop (didn't bet)



PokerStars Game #59938122642:  Hold'em No Limit ($1/$2) - 2009/07/01 0:07:33 ET
Table 'NmY84NAf9Mh0ckAckHnh5g' 2-max Seat #2 is the button
Seat 1: 6hvg964TSqZ3AL/0XK9aVQ ($328.20 in chips)
Seat 2: RwDoM55ZeQuI2ADyJhOb2Q ($265.80 in chips)
RwDoM55ZeQuI2ADyJhOb2Q: posts small blind $1
6hvg964TSqZ3AL/0XK9aVQ: posts big blind $2
*** HOLE CARDS ***
RwDoM55ZeQuI2ADyJhOb2Q: raises $4 to $6
6hvg964TSqZ3AL/0XK9aVQ: calls $4
*** FLOP *** [2h 6c 3c]
6hvg964TSqZ3AL/0XK9aVQ: checks
RwDoM55ZeQuI2ADyJhOb2Q: checks
*** TURN *** [2h 6c 3c] [4d]
6hvg964TSqZ3AL/0XK9aVQ: checks
RwDoM55ZeQuI2ADyJhOb2Q: bets $8
6hvg964TSqZ3AL/0XK9aVQ: calls $8
*** RIVER *** [2h 6c 3c 4d] [3s]
6hvg964TSqZ3AL/0XK9aVQ: checks
RwDoM55ZeQuI2ADyJhOb2Q: checks
*** SHOW DOWN ***
6hvg964TSqZ3AL/0XK9aVQ: shows [Tc 9c] (a pair of Threes)
RwDoM55ZeQuI2ADyJhOb2Q: shows [Jd 4s] (two pair, Fours and Threes)
RwDoM55ZeQuI2ADyJhOb2Q collected $27.50 from pot
*** SUMMARY ***
Total pot $28 | Rake $0.50
Board [2h 6c 3c 4d 3s]
Seat 1: 6hvg964TSqZ3AL/0XK9aVQ (big blind) showed [Tc 9c] and lost with a pair of Threes
Seat 2: RwDoM55ZeQuI2ADyJhOb2Q (button) (small blind) showed [Jd 4s] and won ($27.50) with two pair, Fours and Threes



PokerStars Game #59938123652:  Hold'em No Limit ($1/$2) - 2009/07/01 0:07:34 ET
Table 'aSf77Sj8QEnzcc0WaxVD4Q' 6-max Seat #2 is the button
Seat 1: Q3uFdu6ztesjDFiqkagTRQ ($228.35 in chips)
Seat 2: vkfxu8f/jMYKUk6Ly4eujw ($195.75 in chips)
Seat 3: 9dpyyjDTCed6nV7JhaUUpw ($221.05 in chips)
Seat 4: 513FcCI8jHyQy2VWoIQkMg ($203 in chips)
Seat 5: InmkdI6G8TzSj9NhcCSyPg ($269 in chips)
Seat 6: vkoJRf3gidxY1pPi0AFWww ($309.80 in chips)
9dpyyjDTCed6nV7JhaUUpw: posts small blind $1
513FcCI8jHyQy2VWoIQkMg: posts big blind $2
*** HOLE CARDS ***
InmkdI6G8TzSj9NhcCSyPg: raises $4 to $6
vkoJRf3gidxY1pPi0AFWww: calls $6
Q3uFdu6ztesjDFiqkagTRQ: folds
vkfxu8f/jMYKUk6Ly4eujw: folds
9dpyyjDTCed6nV7JhaUUpw: folds
513FcCI8jHyQy2VWoIQkMg: folds
*** FLOP *** [4h Jc 5h]
InmkdI6G8TzSj9NhcCSyPg: bets $10
vkoJRf3gidxY1pPi0AFWww: raises $10 to $20
InmkdI6G8TzSj9NhcCSyPg: folds
vkoJRf3gidxY1pPi0AFWww collected $33.30 from pot
vkoJRf3gidxY1pPi0AFWww: doesn't show hand
*** SUMMARY ***
Total pot $35 | Rake $1.70
Board [4h Jc 5h]
Seat 1: Q3uFdu6ztesjDFiqkagTRQ folded before Flop (didn't bet)
Seat 2: vkfxu8f/jMYKUk6Ly4eujw (button) folded before Flop (didn't bet)
Seat 3: 9dpyyjDTCed6nV7JhaUUpw (small blind) folded before Flop
Seat 4: 513FcCI8jHyQy2VWoIQkMg (big blind) folded before Flop
Seat 5: InmkdI6G8TzSj9NhcCSyPg folded on the Flop
Seat 6: vkoJRf3gidxY1pPi0AFWww collected ($33.30)



PokerStars Game #59938123926:  Hold'em No Limit ($1/$2) - 2009/07/01 0:07:35 ET
Table 'XP2sRSup+aRuwzx3vDZsDg' 6-max Seat #3 is the button
Seat 1: o9jamqIi6sTTRSqudgboRA ($236.75 in chips)
Seat 2: yZgdnRylE65JbScQ7qCWgw ($40 in chips)
Seat 3: X7GlkHF+lkbarCLuZ4Uf0w ($30.50 in chips)
Seat 4: JsC+WvfzqlxVs9G8/gSQAQ ($79.75 in chips)
Seat 5: vkfxu8f/jMYKUk6Ly4eujw ($200 in chips)
Seat 6: h7ppRQJTYBsHCbLMeW9T2g ($487.75 in chips)
JsC+WvfzqlxVs9G8/gSQAQ: posts small blind $1
vkfxu8f/jMYKUk6Ly4eujw: posts big blind $2
*** HOLE CARDS ***
h7ppRQJTYBsHCbLMeW9T2g: folds
o9jamqIi6sTTRSqudgboRA: raises $5 to $7
yZgdnRylE65JbScQ7qCWgw: folds
X7GlkHF+lkbarCLuZ4Uf0w: folds
JsC+WvfzqlxVs9G8/gSQAQ: calls $6
vkfxu8f/jMYKUk6Ly4eujw: calls $5
*** FLOP *** [9c Qs 2c]
JsC+WvfzqlxVs9G8/gSQAQ: checks
vkfxu8f/jMYKUk6Ly4eujw: checks
o9jamqIi6sTTRSqudgboRA: bets $16
JsC+WvfzqlxVs9G8/gSQAQ: folds
vkfxu8f/jMYKUk6Ly4eujw: folds
o9jamqIi6sTTRSqudgboRA collected $19.95 from pot
*** SUMMARY ***
Total pot $21 | Rake $1.05
Board [9c Qs 2c]
Seat 1: o9jamqIi6sTTRSqudgboRA collected ($19.95)
Seat 2: yZgdnRylE65JbScQ7qCWgw folded before Flop (didn't bet)
Seat 3: X7GlkHF+lkbarCLuZ4Uf0w (button) folded before Flop (didn't bet)
Seat 4: JsC+WvfzqlxVs9G8/gSQAQ (small blind) folded on the Flop
Seat 5: vkfxu8f/jMYKUk6Ly4eujw (big blind) folded on the Flop
Seat 6: h7ppRQJTYBsHCbLMeW9T2g folded before Flop (didn't bet)



PokerStars Game #59938126200:  Hold'em No Limit ($1/$2) - 2009/07/01 0:07:38 ET
Table 'pPQgcj9XT9CHBsbo1WTBug' 6-max Seat #5 is the button
Seat 1: DFVYDA6dKQy7R7mGIKogZA ($119.30 in chips)
Seat 2: X7GlkHF+lkbarCLuZ4Uf0w ($44 in chips)
Seat 3: vkfxu8f/jMYKUk6Ly4eujw ($193 in chips)
Seat 5: 4Cl43Q1TYQL8wn1NSCUkaw ($55.40 in chips)
Seat 6: yZgdnRylE65JbScQ7qCWgw ($33 in chips)
yZgdnRylE65JbScQ7qCWgw: posts small blind $1
DFVYDA6dKQy7R7mGIKogZA: posts big blind $2
*** HOLE CARDS ***
X7GlkHF+lkbarCLuZ4Uf0w: folds
vkfxu8f/jMYKUk6Ly4eujw: folds
4Cl43Q1TYQL8wn1NSCUkaw: folds
yZgdnRylE65JbScQ7qCWgw: raises $31 to $33 and is all-in
DFVYDA6dKQy7R7mGIKogZA: folds
yZgdnRylE65JbScQ7qCWgw collected $4 from pot
*** SUMMARY ***
Total pot $4 | Rake $0
Seat 1: DFVYDA6dKQy7R7mGIKogZA (big blind) folded before Flop
Seat 2: X7GlkHF+lkbarCLuZ4Uf0w folded before Flop (didn't bet)
Seat 3: vkfxu8f/jMYKUk6Ly4eujw folded before Flop (didn't bet)
Seat 5: 4Cl43Q1TYQL8wn1NSCUkaw (button) folded before Flop (didn't bet)
Seat 6: yZgdnRylE65JbScQ7qCWgw (small blind) collected ($4)



PokerStars Game #59938128682:  Hold'em No Limit ($1/$2) - 2009/07/01 0:07:41 ET
Table 'SF49/KQm8T4taMp6kb+HXA' 9-max Seat #9 is the button
Seat 1: l1bCLGuFqeFRwUfPsiDu/g ($181.95 in chips)
Seat 2: 8Z3QifiM9eOd5EIJ25dXNg ($60 in chips)
Seat 3: L88dtdULfz5oGDSuo9/RvA ($43.80 in chips)
Seat 4: HffgoYm61KgkdMe/DYChIQ ($38 in chips)
Seat 5: Z3aYCZG/yXHYFjiWkGI5ug ($227.55 in chips)
Seat 6: M2ht6rIKOI/my9eh610Nlw ($247.45 in chips)
Seat 8: 5iPk5MyO3KVu18Y8XCYfFQ ($39 in chips)
Seat 9: O+jytCilwk7zItVCEavmtw ($137 in chips)
l1bCLGuFqeFRwUfPsiDu/g: posts small blind $1
8Z3QifiM9eOd5EIJ25dXNg: posts big blind $2
*** HOLE CARDS ***
L88dtdULfz5oGDSuo9/RvA: folds
HffgoYm61KgkdMe/DYChIQ: calls $2
Z3aYCZG/yXHYFjiWkGI5ug: folds
M2ht6rIKOI/my9eh610Nlw: folds
5iPk5MyO3KVu18Y8XCYfFQ: folds
O+jytCilwk7zItVCEavmtw: folds
l1bCLGuFqeFRwUfPsiDu/g: calls $1
8Z3QifiM9eOd5EIJ25dXNg: checks
*** FLOP *** [Td 2h Ts]
l1bCLGuFqeFRwUfPsiDu/g: bets $4
8Z3QifiM9eOd5EIJ25dXNg: calls $4
HffgoYm61KgkdMe/DYChIQ: folds
*** TURN *** [Td 2h Ts] [9d]
l1bCLGuFqeFRwUfPsiDu/g: checks
8Z3QifiM9eOd5EIJ25dXNg: bets $6
l1bCLGuFqeFRwUfPsiDu/g: folds
8Z3QifiM9eOd5EIJ25dXNg collected $13.35 from pot
*** SUMMARY ***
Total pot $14 | Rake $0.65
Board [Td 2h Ts 9d]
Seat 1: l1bCLGuFqeFRwUfPsiDu/g (small blind) folded on the Turn
Seat 2: 8Z3QifiM9eOd5EIJ25dXNg (big blind) collected ($13.35)
Seat 3: L88dtdULfz5oGDSuo9/RvA folded before Flop (didn't bet)
Seat 4: HffgoYm61KgkdMe/DYChIQ folded on the Flop
Seat 5: Z3aYCZG/yXHYFjiWkGI5ug folded before Flop (didn't bet)
Seat 6: M2ht6rIKOI/my9eh610Nlw folded before Flop (didn't bet)
Seat 8: 5iPk5MyO3KVu18Y8XCYfFQ folded before Flop (didn't bet)
Seat 9: O+jytCilwk7zItVCEavmtw (button) folded before Flop (didn't bet)



PokerStars Game #59938129278:  Hold'em No Limit ($1/$2) - 2009/07/01 0:07:42 ET
Table 'eyAQSIlgc2o1Jxvbve4WGg' 9-max Seat #8 is the button
Seat 1: Q3uFdu6ztesjDFiqkagTRQ ($237 in chips)
Seat 2: GX1heJ+DSsvm7gzSPsYhhQ ($42 in chips)
Seat 3: TAfo4veNRaRlzDXMMYS3Jg ($40 in chips)
Seat 4: Lr5OlNr2kebm3oHSC54eJg ($115.95 in chips)
Seat 6: IikcENBHwoT7snSvBPSc7Q ($173.85 in chips)
Seat 7: QHxJjpVYwitg9krW6wZgJA ($200 in chips)
Seat 8: 5iPk5MyO3KVu18Y8XCYfFQ ($36 in chips)
Seat 9: Hc2itIxwbi1lwa+DAYYQGg ($48.85 in chips)
Hc2itIxwbi1lwa+DAYYQGg: posts small blind $1
Q3uFdu6ztesjDFiqkagTRQ: posts big blind $2
JnV3SM2D6dAFYyGZHHpvrg: sits out
*** HOLE CARDS ***
GX1heJ+DSsvm7gzSPsYhhQ: folds
GX1heJ+DSsvm7gzSPsYhhQ leaves the table
TAfo4veNRaRlzDXMMYS3Jg: folds
Lr5OlNr2kebm3oHSC54eJg: calls $2
IikcENBHwoT7snSvBPSc7Q: folds
craizer joins the table at seat #2
QHxJjpVYwitg9krW6wZgJA: folds
5iPk5MyO3KVu18Y8XCYfFQ: folds
Hc2itIxwbi1lwa+DAYYQGg: calls $1
Q3uFdu6ztesjDFiqkagTRQ: checks
*** FLOP *** [6c 4d 6d]
Hc2itIxwbi1lwa+DAYYQGg: checks
Q3uFdu6ztesjDFiqkagTRQ: checks
Lr5OlNr2kebm3oHSC54eJg: bets $4
Hc2itIxwbi1lwa+DAYYQGg: folds
craizer is sitting out
Q3uFdu6ztesjDFiqkagTRQ: folds
Lr5OlNr2kebm3oHSC54eJg collected $5.70 from pot
Lr5OlNr2kebm3oHSC54eJg: doesn't show hand
*** SUMMARY ***
Total pot $6 | Rake $0.30
Board [6c 4d 6d]
Seat 1: Q3uFdu6ztesjDFiqkagTRQ (big blind) folded on the Flop
Seat 2: GX1heJ+DSsvm7gzSPsYhhQ folded before Flop (didn't bet)
Seat 3: TAfo4veNRaRlzDXMMYS3Jg folded before Flop (didn't bet)
Seat 4: Lr5OlNr2kebm3oHSC54eJg collected ($5.70)
Seat 6: IikcENBHwoT7snSvBPSc7Q folded before Flop (didn't bet)
Seat 7: QHxJjpVYwitg9krW6wZgJA folded before Flop (didn't bet)
Seat 8: 5iPk5MyO3KVu18Y8XCYfFQ (button) folded before Flop (didn't bet)
Seat 9: Hc2itIxwbi1lwa+DAYYQGg (small blind) folded on the Flop



PokerStars Game #59938129478:  Hold'em No Limit ($1/$2) - 2009/07/01 0:07:42 ET
Table 'LL4bDFyhj5hsMpzaDugJZg' 6-max Seat #4 is the button
Seat 1: IBW9lyGsaRmfcbyA/qFfEw ($76.20 in chips)
Seat 2: L3l+A4pJhOAD6HVVFXvVBw ($289.15 in chips)
Seat 3: gGPaCoSWW1HoKYaqfAPecg ($205 in chips)
Seat 4: 8srN1dKQePlsv0GyTada+Q ($279.50 in chips)
Seat 5: HgX0VeqE/dzSXd5BpntRBw ($200 in chips)
Seat 6: yZgdnRylE65JbScQ7qCWgw ($40 in chips)
HgX0VeqE/dzSXd5BpntRBw: posts small blind $1
yZgdnRylE65JbScQ7qCWgw: posts big blind $2
*** HOLE CARDS ***
IBW9lyGsaRmfcbyA/qFfEw: raises $4 to $6
L3l+A4pJhOAD6HVVFXvVBw: folds
gGPaCoSWW1HoKYaqfAPecg: folds
8srN1dKQePlsv0GyTada+Q: calls $6
HgX0VeqE/dzSXd5BpntRBw: folds
yZgdnRylE65JbScQ7qCWgw: folds
*** FLOP *** [Ah Kc 7c]
IBW9lyGsaRmfcbyA/qFfEw: checks
8srN1dKQePlsv0GyTada+Q: bets $10
IBW9lyGsaRmfcbyA/qFfEw: folds
8srN1dKQePlsv0GyTada+Q collected $14.25 from pot
*** SUMMARY ***
Total pot $15 | Rake $0.75
Board [Ah Kc 7c]
Seat 1: IBW9lyGsaRmfcbyA/qFfEw folded on the Flop
Seat 2: L3l+A4pJhOAD6HVVFXvVBw folded before Flop (didn't bet)
Seat 3: gGPaCoSWW1HoKYaqfAPecg folded before Flop (didn't bet)
Seat 4: 8srN1dKQePlsv0GyTada+Q (button) collected ($14.25)
Seat 5: HgX0VeqE/dzSXd5BpntRBw (small blind) folded before Flop
Seat 6: yZgdnRylE65JbScQ7qCWgw (big blind) folded before Flop



PokerStars Game #59938130302:  Hold'em No Limit ($1/$2) - 2009/07/01 0:07:43 ET
Table '3FGoiEOffWrbgTfsB3t7FA' 2-max Seat #1 is the button
Seat 1: e0oDWyrmgLpR6bROEqw1nQ ($427 in chips)
Seat 2: +sy/nlNI20yZraIjs4AALg ($177.55 in chips)
e0oDWyrmgLpR6bROEqw1nQ: posts small blind $1
+sy/nlNI20yZraIjs4AALg: posts big blind $2
*** HOLE CARDS ***
e0oDWyrmgLpR6bROEqw1nQ: raises $4 to $6
+sy/nlNI20yZraIjs4AALg: raises $4 to $10
e0oDWyrmgLpR6bROEqw1nQ: calls $4
*** FLOP *** [8d 7c As]
+sy/nlNI20yZraIjs4AALg: checks
e0oDWyrmgLpR6bROEqw1nQ: checks
*** TURN *** [8d 7c As] [4d]
+sy/nlNI20yZraIjs4AALg: checks
e0oDWyrmgLpR6bROEqw1nQ: bets $14
+sy/nlNI20yZraIjs4AALg: raises $14 to $28
e0oDWyrmgLpR6bROEqw1nQ: calls $14
*** RIVER *** [8d 7c As 4d] [9d]
+sy/nlNI20yZraIjs4AALg: checks
e0oDWyrmgLpR6bROEqw1nQ: checks
*** SHOW DOWN ***
+sy/nlNI20yZraIjs4AALg: shows [6h 5s] (a straight, Five to Nine)
e0oDWyrmgLpR6bROEqw1nQ: mucks hand
+sy/nlNI20yZraIjs4AALg collected $75.50 from pot
*** SUMMARY ***
Total pot $76 | Rake $0.50
Board [8d 7c As 4d 9d]
Seat 1: e0oDWyrmgLpR6bROEqw1nQ (button) (small blind) mucked
Seat 2: +sy/nlNI20yZraIjs4AALg (big blind) showed [6h 5s] and won ($75.50) with a straight, Five to Nine



PokerStars Game #59938129950:  Hold'em No Limit ($1/$2) - 2009/07/01 0:07:43 ET
Table 'srul5UFZXTEccVV5fpY91g' 9-max Seat #1 is the button
Seat 1: lfD8cBv31A/pio3pXJbPjA ($195.20 in chips)
Seat 2: tJYod1SLp2AcWPL/3hZ7ug ($112.20 in chips)
Seat 3: weUZ8S7tgbaeIpzi1gBNxQ ($42 in chips)
Seat 4: GG5lTuGt3+kwNYSbqeB6yw ($78 in chips)
Seat 5: 5iPk5MyO3KVu18Y8XCYfFQ ($46.10 in chips)
Seat 6: TAfo4veNRaRlzDXMMYS3Jg ($34 in chips)
Seat 7: s0erZsDxbZSaEPheMgibKg ($447.40 in chips)
Seat 8: jqICkNBEBjVScJ1iibba8Q ($277.65 in chips)
Seat 9: GX1heJ+DSsvm7gzSPsYhhQ ($94 in chips)
tJYod1SLp2AcWPL/3hZ7ug: posts small blind $1
weUZ8S7tgbaeIpzi1gBNxQ: posts big blind $2
*** HOLE CARDS ***
GG5lTuGt3+kwNYSbqeB6yw: folds
5iPk5MyO3KVu18Y8XCYfFQ: folds
TAfo4veNRaRlzDXMMYS3Jg: folds
s0erZsDxbZSaEPheMgibKg: folds
jqICkNBEBjVScJ1iibba8Q: folds
GX1heJ+DSsvm7gzSPsYhhQ: folds
lfD8cBv31A/pio3pXJbPjA: folds
tJYod1SLp2AcWPL/3hZ7ug: folds
weUZ8S7tgbaeIpzi1gBNxQ collected $2 from pot
*** SUMMARY ***
Total pot $2 | Rake $0
Seat 1: lfD8cBv31A/pio3pXJbPjA (button) folded before Flop (didn't bet)
Seat 2: tJYod1SLp2AcWPL/3hZ7ug (small blind) folded before Flop
Seat 3: weUZ8S7tgbaeIpzi1gBNxQ (big blind) collected ($2)
Seat 4: GG5lTuGt3+kwNYSbqeB6yw folded before Flop (didn't bet)
Seat 5: 5iPk5MyO3KVu18Y8XCYfFQ folded before Flop (didn't bet)
Seat 6: TAfo4veNRaRlzDXMMYS3Jg folded before Flop (didn't bet)
Seat 7: s0erZsDxbZSaEPheMgibKg folded before Flop (didn't bet)
Seat 8: jqICkNBEBjVScJ1iibba8Q folded before Flop (didn't bet)
Seat 9: GX1heJ+DSsvm7gzSPsYhhQ folded before Flop (didn't bet)



PokerStars Game #59938130532:  Hold'em No Limit ($1/$2) - 2009/07/01 0:07:44 ET
Table 'rsKRKlGHlxVyqJxzO2a2Ow' 9-max Seat #8 is the button
Seat 1: uYWfQJg2hgHLxri6/uVJiw ($135.50 in chips)
Seat 2: QHxJjpVYwitg9krW6wZgJA ($244 in chips)
Seat 3: 9sYbXdhj1M2bwKrVNxj5+Q ($145.80 in chips)
Seat 4: zJtQ1gxyi72XvGYS1tM+DA ($156.30 in chips)
Seat 5: 5Q8U6iZbeO7xJSS4qvDP5g ($203 in chips)
Seat 6: H6Z4+qu8gR0VUiPOijndVg ($200 in chips)
Seat 7: kVCeGJ4NY7Fb0W74j1mAqA ($200 in chips)
Seat 8: Hc2itIxwbi1lwa+DAYYQGg ($37 in chips)
Seat 9: 5iPk5MyO3KVu18Y8XCYfFQ ($96.10 in chips)
5iPk5MyO3KVu18Y8XCYfFQ: posts small blind $1
uYWfQJg2hgHLxri6/uVJiw: posts big blind $2
*** HOLE CARDS ***
QHxJjpVYwitg9krW6wZgJA: folds
9sYbXdhj1M2bwKrVNxj5+Q: folds
zJtQ1gxyi72XvGYS1tM+DA: folds
5Q8U6iZbeO7xJSS4qvDP5g: folds
H6Z4+qu8gR0VUiPOijndVg: folds
kVCeGJ4NY7Fb0W74j1mAqA: folds
Hc2itIxwbi1lwa+DAYYQGg: folds
5iPk5MyO3KVu18Y8XCYfFQ: raises $2 to $4
uYWfQJg2hgHLxri6/uVJiw: folds
5iPk5MyO3KVu18Y8XCYfFQ collected $4 from pot
5iPk5MyO3KVu18Y8XCYfFQ: doesn't show hand
*** SUMMARY ***
Total pot $4 | Rake $0
Seat 1: uYWfQJg2hgHLxri6/uVJiw (big blind) folded before Flop
Seat 2: QHxJjpVYwitg9krW6wZgJA folded before Flop (didn't bet)
Seat 3: 9sYbXdhj1M2bwKrVNxj5+Q folded before Flop (didn't bet)
Seat 4: zJtQ1gxyi72XvGYS1tM+DA folded before Flop (didn't bet)
Seat 5: 5Q8U6iZbeO7xJSS4qvDP5g folded before Flop (didn't bet)
Seat 6: H6Z4+qu8gR0VUiPOijndVg folded before Flop (didn't bet)
Seat 7: kVCeGJ4NY7Fb0W74j1mAqA folded before Flop (didn't bet)
Seat 8: Hc2itIxwbi1lwa+DAYYQGg (button) folded before Flop (didn't bet)
Seat 9: 5iPk5MyO3KVu18Y8XCYfFQ (small blind) collected ($4)



PokerStars Game #59938132132:  Hold'em No Limit ($1/$2) - 2009/07/01 0:07:46 ET
Table 'fe+AlpfadsfwxhZEvYFbbA' 6-max Seat #6 is the button
Seat 1: SLlqn2PPbQqwfcLfYqUXrw ($58.85 in chips)
Seat 2: /PH6Ffnho4Ysm8S3V/oa+w ($40 in chips)
Seat 3: 54yWzRRgS0oZ+S6LwZBxMQ ($61 in chips)
Seat 5: gGPaCoSWW1HoKYaqfAPecg ($226 in chips)
Seat 6: 5Y+ZGWLI4gnlpApDX5vy1A ($203.55 in chips)
SLlqn2PPbQqwfcLfYqUXrw: posts small blind $1
/PH6Ffnho4Ysm8S3V/oa+w: posts big blind $2
F/075N6nU34Fn0zr6qD3aw: sits out
*** HOLE CARDS ***
54yWzRRgS0oZ+S6LwZBxMQ: folds
gGPaCoSWW1HoKYaqfAPecg: raises $5 to $7
5Y+ZGWLI4gnlpApDX5vy1A: raises $14 to $21
SLlqn2PPbQqwfcLfYqUXrw: folds
/PH6Ffnho4Ysm8S3V/oa+w: folds
gGPaCoSWW1HoKYaqfAPecg: raises $45 to $66
5Y+ZGWLI4gnlpApDX5vy1A: folds
SLlqn2PPbQqwfcLfYqUXrw leaves the table
gGPaCoSWW1HoKYaqfAPecg collected $45 from pot
gGPaCoSWW1HoKYaqfAPecg: doesn't show hand
*** SUMMARY ***
Total pot $45 | Rake $0
Seat 1: SLlqn2PPbQqwfcLfYqUXrw (small blind) folded before Flop
Seat 2: /PH6Ffnho4Ysm8S3V/oa+w (big blind) folded before Flop
Seat 3: 54yWzRRgS0oZ+S6LwZBxMQ folded before Flop (didn't bet)
Seat 5: gGPaCoSWW1HoKYaqfAPecg collected ($45)
Seat 6: 5Y+ZGWLI4gnlpApDX5vy1A (button) folded before Flop



PokerStars Game #59938133262:  Hold'em No Limit ($1/$2) - 2009/07/01 0:07:48 ET
Table 'jlrIxbrVIG+gjaUYT4za8g' 6-max Seat #1 is the button
Seat 1: ygTTt5ehT4aF86q1a8/R+w ($196.05 in chips)
Seat 2: N18PrNGQj43J7TJuQuu+tw ($129.80 in chips)
Seat 4: 8srN1dKQePlsv0GyTada+Q ($200 in chips)
Seat 5: F/075N6nU34Fn0zr6qD3aw ($168.55 in chips)
Seat 6: vkfxu8f/jMYKUk6Ly4eujw ($278.05 in chips)
N18PrNGQj43J7TJuQuu+tw: posts small blind $1
/PH6Ffnho4Ysm8S3V/oa+w: is sitting out
8srN1dKQePlsv0GyTada+Q: posts big blind $2
*** HOLE CARDS ***
/PH6Ffnho4Ysm8S3V/oa+w leaves the table
F/075N6nU34Fn0zr6qD3aw: folds
vkfxu8f/jMYKUk6Ly4eujw: folds
ygTTt5ehT4aF86q1a8/R+w: folds
N18PrNGQj43J7TJuQuu+tw: calls $1
8srN1dKQePlsv0GyTada+Q: checks
*** FLOP *** [Jh Td 7c]
N18PrNGQj43J7TJuQuu+tw: checks
8srN1dKQePlsv0GyTada+Q: checks
*** TURN *** [Jh Td 7c] [Qd]
N18PrNGQj43J7TJuQuu+tw: checks
8srN1dKQePlsv0GyTada+Q: checks
*** RIVER *** [Jh Td 7c Qd] [7h]
N18PrNGQj43J7TJuQuu+tw: checks
8srN1dKQePlsv0GyTada+Q: bets $4
N18PrNGQj43J7TJuQuu+tw: calls $4
*** SHOW DOWN ***
8srN1dKQePlsv0GyTada+Q: shows [8h 6d] (a pair of Sevens)
N18PrNGQj43J7TJuQuu+tw: shows [Tc 5d] (two pair, Tens and Sevens)
N18PrNGQj43J7TJuQuu+tw collected $11.45 from pot
*** SUMMARY ***
Total pot $12 | Rake $0.55
Board [Jh Td 7c Qd 7h]
Seat 1: ygTTt5ehT4aF86q1a8/R+w (button) folded before Flop (didn't bet)
Seat 2: N18PrNGQj43J7TJuQuu+tw (small blind) showed [Tc 5d] and won ($11.45) with two pair, Tens and Sevens
Seat 4: 8srN1dKQePlsv0GyTada+Q (big blind) showed [8h 6d] and lost with a pair of Sevens
Seat 5: F/075N6nU34Fn0zr6qD3aw folded before Flop (didn't bet)
Seat 6: vkfxu8f/jMYKUk6Ly4eujw folded before Flop (didn't bet)



PokerStars Game #59938134586:  Hold'em No Limit ($1/$2) - 2009/07/01 0:07:49 ET
Table 'CFkQcfWjKccZaZDf71FK+w' 6-max Seat #5 is the button
Seat 1: X7GlkHF+lkbarCLuZ4Uf0w ($34 in chips)
Seat 2: yZgdnRylE65JbScQ7qCWgw ($43 in chips)
Seat 3: ygTTt5ehT4aF86q1a8/R+w ($121.40 in chips)
Seat 4: B2Ih1sr5VZk+8He7rcrMtQ ($220.90 in chips)
Seat 5: 1njbh8TKSUF6l4V1XwGdcg ($241 in chips)
Seat 6: ORVqY3rf9X6ANA/8s+On2Q ($46 in chips)
ORVqY3rf9X6ANA/8s+On2Q: posts small blind $1
X7GlkHF+lkbarCLuZ4Uf0w: posts big blind $2
*** HOLE CARDS ***
yZgdnRylE65JbScQ7qCWgw: folds
ygTTt5ehT4aF86q1a8/R+w: raises $4 to $6
B2Ih1sr5VZk+8He7rcrMtQ: folds
1njbh8TKSUF6l4V1XwGdcg: calls $6
ORVqY3rf9X6ANA/8s+On2Q: calls $5
X7GlkHF+lkbarCLuZ4Uf0w: folds
*** FLOP *** [3d 6s Tc]
ORVqY3rf9X6ANA/8s+On2Q: checks
ygTTt5ehT4aF86q1a8/R+w: checks
1njbh8TKSUF6l4V1XwGdcg: checks
*** TURN *** [3d 6s Tc] [9c]
ORVqY3rf9X6ANA/8s+On2Q: checks
ygTTt5ehT4aF86q1a8/R+w: checks
1njbh8TKSUF6l4V1XwGdcg: checks
*** RIVER *** [3d 6s Tc 9c] [2c]
ORVqY3rf9X6ANA/8s+On2Q: checks
ygTTt5ehT4aF86q1a8/R+w: checks
1njbh8TKSUF6l4V1XwGdcg: checks
*** SHOW DOWN ***
ORVqY3rf9X6ANA/8s+On2Q: shows [Js Kh] (high card King)
ygTTt5ehT4aF86q1a8/R+w: shows [As Kc] (high card Ace)
1njbh8TKSUF6l4V1XwGdcg: mucks hand
ygTTt5ehT4aF86q1a8/R+w collected $19 from pot
*** SUMMARY ***
Total pot $20 | Rake $1
Board [3d 6s Tc 9c 2c]
Seat 1: X7GlkHF+lkbarCLuZ4Uf0w (big blind) folded before Flop
Seat 2: yZgdnRylE65JbScQ7qCWgw folded before Flop (didn't bet)
Seat 3: ygTTt5ehT4aF86q1a8/R+w showed [As Kc] and won ($19) with high card Ace
Seat 4: B2Ih1sr5VZk+8He7rcrMtQ folded before Flop (didn't bet)
Seat 5: 1njbh8TKSUF6l4V1XwGdcg (button) mucked
Seat 6: ORVqY3rf9X6ANA/8s+On2Q (small blind) showed [Js Kh] and lost with high card King



PokerStars Game #59938136170:  Hold'em No Limit ($1/$2) - 2009/07/01 0:07:52 ET
Table 'gnHBqWll9O3fxG7Ojkz/ng' 9-max Seat #9 is the button
Seat 1: hpqdC/23wXosGOmzARr5NA ($157.30 in chips)
Seat 2: H6Z4+qu8gR0VUiPOijndVg ($200 in chips)
Seat 3: 5Q8U6iZbeO7xJSS4qvDP5g ($218.60 in chips)
Seat 4: n5XI5/7gN+gIubHFBH+mOw ($404.85 in chips)
Seat 5: GX1heJ+DSsvm7gzSPsYhhQ ($54.75 in chips)
Seat 6: 5iPk5MyO3KVu18Y8XCYfFQ ($43.45 in chips)
Seat 7: jqui3xAWCkcdPW36a6BD+w ($212.80 in chips)
Seat 8: De9g+AYjo0DN6C/+iT/nsg ($244.05 in chips)
Seat 9: kVCeGJ4NY7Fb0W74j1mAqA ($203 in chips)
hpqdC/23wXosGOmzARr5NA: posts small blind $1
H6Z4+qu8gR0VUiPOijndVg: posts big blind $2
*** HOLE CARDS ***
5Q8U6iZbeO7xJSS4qvDP5g: folds
n5XI5/7gN+gIubHFBH+mOw: folds
GX1heJ+DSsvm7gzSPsYhhQ: folds
5iPk5MyO3KVu18Y8XCYfFQ has timed out
5iPk5MyO3KVu18Y8XCYfFQ: folds
5iPk5MyO3KVu18Y8XCYfFQ is sitting out
jqui3xAWCkcdPW36a6BD+w: folds
5iPk5MyO3KVu18Y8XCYfFQ has returned
De9g+AYjo0DN6C/+iT/nsg: folds
kVCeGJ4NY7Fb0W74j1mAqA: raises $4 to $6
hpqdC/23wXosGOmzARr5NA: folds
jqui3xAWCkcdPW36a6BD+w is sitting out
H6Z4+qu8gR0VUiPOijndVg: folds
kVCeGJ4NY7Fb0W74j1mAqA collected $5 from pot
kVCeGJ4NY7Fb0W74j1mAqA: doesn't show hand
*** SUMMARY ***
Total pot $5 | Rake $0
Seat 1: hpqdC/23wXosGOmzARr5NA (small blind) folded before Flop
Seat 2: H6Z4+qu8gR0VUiPOijndVg (big blind) folded before Flop
Seat 3: 5Q8U6iZbeO7xJSS4qvDP5g folded before Flop (didn't bet)
Seat 4: n5XI5/7gN+gIubHFBH+mOw folded before Flop (didn't bet)
Seat 5: GX1heJ+DSsvm7gzSPsYhhQ folded before Flop (didn't bet)
Seat 6: 5iPk5MyO3KVu18Y8XCYfFQ folded before Flop (didn't bet)
Seat 7: jqui3xAWCkcdPW36a6BD+w folded before Flop (didn't bet)
Seat 8: De9g+AYjo0DN6C/+iT/nsg folded before Flop (didn't bet)
Seat 9: kVCeGJ4NY7Fb0W74j1mAqA (button) collected ($5)



PokerStars Game #59938138062:  Hold'em No Limit ($1/$2) - 2009/07/01 0:07:54 ET
Table 'ztv6V3FN2bQ9nmJPPdx6nQ' 6-max Seat #4 is the button
Seat 1: ek1hig03QiyONDHXvgqteQ ($181.05 in chips)
Seat 4: vkfxu8f/jMYKUk6Ly4eujw ($342.70 in chips)
Seat 5: sTPOWERd9HWPCNrDBwsVjA ($202.95 in chips)
Seat 6: yZgdnRylE65JbScQ7qCWgw ($31 in chips)
sTPOWERd9HWPCNrDBwsVjA: posts small blind $1
yZgdnRylE65JbScQ7qCWgw: posts big blind $2
*** HOLE CARDS ***
ek1hig03QiyONDHXvgqteQ: folds
vkfxu8f/jMYKUk6Ly4eujw: folds
sTPOWERd9HWPCNrDBwsVjA: folds
yZgdnRylE65JbScQ7qCWgw collected $2 from pot
*** SUMMARY ***
Total pot $2 | Rake $0
Seat 1: ek1hig03QiyONDHXvgqteQ folded before Flop (didn't bet)
Seat 4: vkfxu8f/jMYKUk6Ly4eujw (button) folded before Flop (didn't bet)
Seat 5: sTPOWERd9HWPCNrDBwsVjA (small blind) folded before Flop
Seat 6: yZgdnRylE65JbScQ7qCWgw (big blind) collected ($2)



PokerStars Game #59938138836:  Hold'em No Limit ($1/$2) - 2009/07/01 0:07:55 ET
Table 'HewZCzVOYGmuLDKthTi5Yw' 6-max Seat #4 is the button
Seat 1: 353332 ($247.75 in chips)
Seat 2: X7GlkHF+lkbarCLuZ4Uf0w ($36 in chips)
Seat 3: WJxW31eStwT28R2X/L8F5A ($53.25 in chips)
Seat 4: yZgdnRylE65JbScQ7qCWgw ($29 in chips)
Seat 5: 513FcCI8jHyQy2VWoIQkMg ($363.50 in chips)
513FcCI8jHyQy2VWoIQkMg: posts small blind $1
353332: posts big blind $2
*** HOLE CARDS ***
X7GlkHF+lkbarCLuZ4Uf0w: raises $2 to $4
WJxW31eStwT28R2X/L8F5A: folds
yZgdnRylE65JbScQ7qCWgw: folds
513FcCI8jHyQy2VWoIQkMg: folds
353332: calls $2
*** FLOP *** [4c 7c Qs]
353332: checks
X7GlkHF+lkbarCLuZ4Uf0w: bets $4
353332: calls $4
*** TURN *** [4c 7c Qs] [7h]
353332: checks
X7GlkHF+lkbarCLuZ4Uf0w: checks
*** RIVER *** [4c 7c Qs 7h] [5d]
353332: bets $12
X7GlkHF+lkbarCLuZ4Uf0w: folds
353332 collected $16.20 from pot
353332: doesn't show hand
*** SUMMARY ***
Total pot $17 | Rake $0.80
Board [4c 7c Qs 7h 5d]
Seat 1: 353332 (big blind) collected ($16.20)
Seat 2: X7GlkHF+lkbarCLuZ4Uf0w folded on the River
Seat 3: WJxW31eStwT28R2X/L8F5A folded before Flop (didn't bet)
Seat 4: yZgdnRylE65JbScQ7qCWgw (button) folded before Flop (didn't bet)
Seat 5: 513FcCI8jHyQy2VWoIQkMg (small blind) folded before Flop



PokerStars Game #59938139014:  Hold'em No Limit ($1/$2) - 2009/07/01 0:07:55 ET
Table 'WCA60bDA8ecovUgFSIZkTQ' 9-max Seat #2 is the button
Seat 2: G1h8wamBcVJXtsKXZQ2EyA ($43.70 in chips)
Seat 3: 5iPk5MyO3KVu18Y8XCYfFQ ($38 in chips)
Seat 4: Q3uFdu6ztesjDFiqkagTRQ ($484.70 in chips)
Seat 5: Hc2itIxwbi1lwa+DAYYQGg ($309.30 in chips)
Seat 6: DOWQSOJ7GaX+ksfWTqPT5A ($275.05 in chips)
Seat 7: GX1heJ+DSsvm7gzSPsYhhQ ($43 in chips)
Seat 8: x+V1JgVDawsJTxKcxm7gxw ($95 in chips)
Seat 9: 3q2/0oJr3Mcy1W5tcN61ug ($298.20 in chips)
5iPk5MyO3KVu18Y8XCYfFQ: posts small blind $1
Q3uFdu6ztesjDFiqkagTRQ: posts big blind $2
CUZwDpLTQKhzarPe+JCLOQ: sits out
*** HOLE CARDS ***
Hc2itIxwbi1lwa+DAYYQGg: folds
DOWQSOJ7GaX+ksfWTqPT5A: folds
GX1heJ+DSsvm7gzSPsYhhQ: folds
x+V1JgVDawsJTxKcxm7gxw: folds
3q2/0oJr3Mcy1W5tcN61ug: folds
G1h8wamBcVJXtsKXZQ2EyA: folds
5iPk5MyO3KVu18Y8XCYfFQ: folds
Q3uFdu6ztesjDFiqkagTRQ collected $2 from pot
Q3uFdu6ztesjDFiqkagTRQ: doesn't show hand
*** SUMMARY ***
Total pot $2 | Rake $0
Seat 2: G1h8wamBcVJXtsKXZQ2EyA (button) folded before Flop (didn't bet)
Seat 3: 5iPk5MyO3KVu18Y8XCYfFQ (small blind) folded before Flop
Seat 4: Q3uFdu6ztesjDFiqkagTRQ (big blind) collected ($2)
Seat 5: Hc2itIxwbi1lwa+DAYYQGg folded before Flop (didn't bet)
Seat 6: DOWQSOJ7GaX+ksfWTqPT5A folded before Flop (didn't bet)
Seat 7: GX1heJ+DSsvm7gzSPsYhhQ folded before Flop (didn't bet)
Seat 8: x+V1JgVDawsJTxKcxm7gxw folded before Flop (didn't bet)
Seat 9: 3q2/0oJr3Mcy1W5tcN61ug folded before Flop (didn't bet)



PokerStars Game #59938140196:  Hold'em No Limit ($1/$2) - 2009/07/01 0:07:57 ET
Table 'uJ9juaXXg9yIcSU8amxaXQ' 6-max Seat #3 is the button
Seat 1: HhIxv6mylwCAfv3sjJmq5g ($200 in chips)
Seat 2: DQlskgG4OtLpF2MVxLwf4A ($248.05 in chips)
Seat 3: zaogaltCDFVsIASEnrXs2w ($295.75 in chips)
Seat 4: 54yWzRRgS0oZ+S6LwZBxMQ ($30 in chips)
Seat 5: X7GlkHF+lkbarCLuZ4Uf0w ($48 in chips)
54yWzRRgS0oZ+S6LwZBxMQ: posts small blind $1
X7GlkHF+lkbarCLuZ4Uf0w: posts big blind $2
*** HOLE CARDS ***
HhIxv6mylwCAfv3sjJmq5g: folds
DQlskgG4OtLpF2MVxLwf4A: folds
zaogaltCDFVsIASEnrXs2w: folds
54yWzRRgS0oZ+S6LwZBxMQ: calls $1
X7GlkHF+lkbarCLuZ4Uf0w: raises $4 to $6
54yWzRRgS0oZ+S6LwZBxMQ: folds
X7GlkHF+lkbarCLuZ4Uf0w collected $4 from pot
X7GlkHF+lkbarCLuZ4Uf0w: doesn't show hand
*** SUMMARY ***
Total pot $4 | Rake $0
Seat 1: HhIxv6mylwCAfv3sjJmq5g folded before Flop (didn't bet)
Seat 2: DQlskgG4OtLpF2MVxLwf4A folded before Flop (didn't bet)
Seat 3: zaogaltCDFVsIASEnrXs2w (button) folded before Flop (didn't bet)
Seat 4: 54yWzRRgS0oZ+S6LwZBxMQ (small blind) folded before Flop
Seat 5: X7GlkHF+lkbarCLuZ4Uf0w (big blind) collected ($4)



PokerStars Game #59938141188:  Hold'em No Limit ($1/$2) - 2009/07/01 0:07:58 ET
Table 'YqGfR5eHfMeSjb9a+QU9rg' 9-max Seat #8 is the button
Seat 1: qCBuzVnLcBR29snMAHq9PA ($160.35 in chips)
Seat 2: W3Nqt1GWlTi9tXQXMNEvgw ($234.65 in chips)
Seat 3: /gll27k+xWYV7Fbki0lFDQ ($88.25 in chips)
Seat 4: QHxJjpVYwitg9krW6wZgJA ($200 in chips)
Seat 5: MOBMOMQRN/z+fiGXGnZojw ($173.10 in chips)
Seat 6: 5iPk5MyO3KVu18Y8XCYfFQ ($46 in chips)
Seat 7: b0jO1SDhLedy1//CQlA8kw ($39 in chips)
Seat 8: JnV3SM2D6dAFYyGZHHpvrg ($97 in chips)
Seat 9: RsrgM2l7PLbQ9xBbSi3IvQ ($117.55 in chips)
RsrgM2l7PLbQ9xBbSi3IvQ: posts small blind $1
qCBuzVnLcBR29snMAHq9PA: posts big blind $2
*** HOLE CARDS ***
W3Nqt1GWlTi9tXQXMNEvgw: folds
/gll27k+xWYV7Fbki0lFDQ: folds
QHxJjpVYwitg9krW6wZgJA: raises $2 to $4
MOBMOMQRN/z+fiGXGnZojw: folds
5iPk5MyO3KVu18Y8XCYfFQ: folds
b0jO1SDhLedy1//CQlA8kw: folds
JnV3SM2D6dAFYyGZHHpvrg: folds
RsrgM2l7PLbQ9xBbSi3IvQ: folds
qCBuzVnLcBR29snMAHq9PA: calls $2
*** FLOP *** [Js 7c As]
qCBuzVnLcBR29snMAHq9PA: checks
QHxJjpVYwitg9krW6wZgJA: checks
*** TURN *** [Js 7c As] [Ah]
qCBuzVnLcBR29snMAHq9PA: bets $3
QHxJjpVYwitg9krW6wZgJA: folds
qCBuzVnLcBR29snMAHq9PA collected $8.55 from pot
qCBuzVnLcBR29snMAHq9PA: doesn't show hand
*** SUMMARY ***
Total pot $9 | Rake $0.45
Board [Js 7c As Ah]
Seat 1: qCBuzVnLcBR29snMAHq9PA (big blind) collected ($8.55)
Seat 2: W3Nqt1GWlTi9tXQXMNEvgw folded before Flop (didn't bet)
Seat 3: /gll27k+xWYV7Fbki0lFDQ folded before Flop (didn't bet)
Seat 4: QHxJjpVYwitg9krW6wZgJA folded on the Turn
Seat 5: MOBMOMQRN/z+fiGXGnZojw folded before Flop (didn't bet)
Seat 6: 5iPk5MyO3KVu18Y8XCYfFQ folded before Flop (didn't bet)
Seat 7: b0jO1SDhLedy1//CQlA8kw folded before Flop (didn't bet)
Seat 8: JnV3SM2D6dAFYyGZHHpvrg (button) folded before Flop (didn't bet)
Seat 9: RsrgM2l7PLbQ9xBbSi3IvQ (small blind) folded before Flop



PokerStars Game #59938142620:  Hold'em No Limit ($1/$2) - 2009/07/01 0:08:00 ET
Table 'NmY84NAf9Mh0ckAckHnh5g' 2-max Seat #1 is the button
Seat 1: 6hvg964TSqZ3AL/0XK9aVQ ($314.20 in chips)
Seat 2: RwDoM55ZeQuI2ADyJhOb2Q ($279.30 in chips)
6hvg964TSqZ3AL/0XK9aVQ: posts small blind $1
RwDoM55ZeQuI2ADyJhOb2Q: posts big blind $2
*** HOLE CARDS ***
6hvg964TSqZ3AL/0XK9aVQ: calls $1
RwDoM55ZeQuI2ADyJhOb2Q: checks
*** FLOP *** [4d 8c 9c]
RwDoM55ZeQuI2ADyJhOb2Q: checks
6hvg964TSqZ3AL/0XK9aVQ: checks
*** TURN *** [4d 8c 9c] [Ad]
RwDoM55ZeQuI2ADyJhOb2Q: checks
6hvg964TSqZ3AL/0XK9aVQ: checks
*** RIVER *** [4d 8c 9c Ad] [6s]
RwDoM55ZeQuI2ADyJhOb2Q: checks
6hvg964TSqZ3AL/0XK9aVQ: bets $4
RwDoM55ZeQuI2ADyJhOb2Q: folds
6hvg964TSqZ3AL/0XK9aVQ collected $3.80 from pot
*** SUMMARY ***
Total pot $4 | Rake $0.20
Board [4d 8c 9c Ad 6s]
Seat 1: 6hvg964TSqZ3AL/0XK9aVQ (button) (small blind) collected ($3.80)
Seat 2: RwDoM55ZeQuI2ADyJhOb2Q (big blind) folded on the River



PokerStars Game #59938146786:  Hold'em No Limit ($1/$2) - 2009/07/01 0:08:06 ET
Table 'ztv6V3FN2bQ9nmJPPdx6nQ' 6-max Seat #5 is the button
Seat 1: ek1hig03QiyONDHXvgqteQ ($181.05 in chips)
Seat 4: vkfxu8f/jMYKUk6Ly4eujw ($342.70 in chips)
Seat 5: sTPOWERd9HWPCNrDBwsVjA ($201.95 in chips)
Seat 6: yZgdnRylE65JbScQ7qCWgw ($32 in chips)
yZgdnRylE65JbScQ7qCWgw: posts small blind $1
ek1hig03QiyONDHXvgqteQ: posts big blind $2
*** HOLE CARDS ***
vkfxu8f/jMYKUk6Ly4eujw: folds
sTPOWERd9HWPCNrDBwsVjA: raises $4 to $6
yZgdnRylE65JbScQ7qCWgw: folds
ek1hig03QiyONDHXvgqteQ: folds
sTPOWERd9HWPCNrDBwsVjA collected $5 from pot
*** SUMMARY ***
Total pot $5 | Rake $0
Seat 1: ek1hig03QiyONDHXvgqteQ (big blind) folded before Flop
Seat 4: vkfxu8f/jMYKUk6Ly4eujw folded before Flop (didn't bet)
Seat 5: sTPOWERd9HWPCNrDBwsVjA (button) collected ($5)
Seat 6: yZgdnRylE65JbScQ7qCWgw (small blind) folded before Flop



PokerStars Game #59938147960:  Hold'em No Limit ($1/$2) - 2009/07/01 0:08:08 ET
Table 'srul5UFZXTEccVV5fpY91g' 9-max Seat #2 is the button
Seat 1: lfD8cBv31A/pio3pXJbPjA ($195.20 in chips)
Seat 2: tJYod1SLp2AcWPL/3hZ7ug ($111.20 in chips)
Seat 3: weUZ8S7tgbaeIpzi1gBNxQ ($43 in chips)
Seat 4: GG5lTuGt3+kwNYSbqeB6yw ($78 in chips)
Seat 5: 5iPk5MyO3KVu18Y8XCYfFQ ($46.10 in chips)
Seat 6: TAfo4veNRaRlzDXMMYS3Jg ($34 in chips)
Seat 7: s0erZsDxbZSaEPheMgibKg ($447.40 in chips)
Seat 8: jqICkNBEBjVScJ1iibba8Q ($277.65 in chips)
Seat 9: GX1heJ+DSsvm7gzSPsYhhQ ($94 in chips)
weUZ8S7tgbaeIpzi1gBNxQ: posts small blind $1
GG5lTuGt3+kwNYSbqeB6yw: posts big blind $2
*** HOLE CARDS ***
5iPk5MyO3KVu18Y8XCYfFQ: folds
TAfo4veNRaRlzDXMMYS3Jg: folds
s0erZsDxbZSaEPheMgibKg: raises $4 to $6
jqICkNBEBjVScJ1iibba8Q: folds
GX1heJ+DSsvm7gzSPsYhhQ: folds
lfD8cBv31A/pio3pXJbPjA: folds
tJYod1SLp2AcWPL/3hZ7ug: folds
weUZ8S7tgbaeIpzi1gBNxQ: calls $5
GG5lTuGt3+kwNYSbqeB6yw: calls $4
*** FLOP *** [5h 6h 4h]
weUZ8S7tgbaeIpzi1gBNxQ: checks
GG5lTuGt3+kwNYSbqeB6yw: checks
s0erZsDxbZSaEPheMgibKg: checks
*** TURN *** [5h 6h 4h] [3s]
weUZ8S7tgbaeIpzi1gBNxQ: checks
GG5lTuGt3+kwNYSbqeB6yw: bets $2
s0erZsDxbZSaEPheMgibKg: calls $2
weUZ8S7tgbaeIpzi1gBNxQ: calls $2
*** RIVER *** [5h 6h 4h 3s] [3c]
weUZ8S7tgbaeIpzi1gBNxQ: checks
GG5lTuGt3+kwNYSbqeB6yw: bets $10
s0erZsDxbZSaEPheMgibKg: folds
weUZ8S7tgbaeIpzi1gBNxQ: folds
GG5lTuGt3+kwNYSbqeB6yw collected $22.85 from pot
*** SUMMARY ***
Total pot $24 | Rake $1.15
Board [5h 6h 4h 3s 3c]
Seat 1: lfD8cBv31A/pio3pXJbPjA folded before Flop (didn't bet)
Seat 2: tJYod1SLp2AcWPL/3hZ7ug (button) folded before Flop (didn't bet)
Seat 3: weUZ8S7tgbaeIpzi1gBNxQ (small blind) folded on the River
Seat 4: GG5lTuGt3+kwNYSbqeB6yw (big blind) collected ($22.85)
Seat 5: 5iPk5MyO3KVu18Y8XCYfFQ folded before Flop (didn't bet)
Seat 6: TAfo4veNRaRlzDXMMYS3Jg folded before Flop (didn't bet)
Seat 7: s0erZsDxbZSaEPheMgibKg folded on the River
Seat 8: jqICkNBEBjVScJ1iibba8Q folded before Flop (didn't bet)
Seat 9: GX1heJ+DSsvm7gzSPsYhhQ folded before Flop (didn't bet)



PokerStars Game #59938150756:  Hold'em No Limit ($1/$2) - 2009/07/01 0:08:12 ET
Table 'ZrKaj8fA5nb08RKhIpHkZA' 9-max Seat #6 is the button
Seat 1: Hc2itIxwbi1lwa+DAYYQGg ($37 in chips)
Seat 2: TAfo4veNRaRlzDXMMYS3Jg ($37 in chips)
Seat 3: GX1heJ+DSsvm7gzSPsYhhQ ($36 in chips)
Seat 4: isdXtU9uuSM2LGqOKxtlwA ($102.35 in chips)
Seat 5: YlSX2xwu8QMQReaxSAD8XA ($206.45 in chips)
Seat 6: Q3uFdu6ztesjDFiqkagTRQ ($200 in chips)
Seat 7: ztEPtIZdGv4TcxTUTzbY1w ($78.85 in chips)
Seat 8: tnv1uD25KOWgMmyKcuOVog ($287.25 in chips)
Seat 9: Z3aYCZG/yXHYFjiWkGI5ug ($259.25 in chips)
ztEPtIZdGv4TcxTUTzbY1w: posts small blind $1
tnv1uD25KOWgMmyKcuOVog: posts big blind $2
*** HOLE CARDS ***
Z3aYCZG/yXHYFjiWkGI5ug: raises $6 to $8
Hc2itIxwbi1lwa+DAYYQGg: folds
TAfo4veNRaRlzDXMMYS3Jg: folds
GX1heJ+DSsvm7gzSPsYhhQ: folds
isdXtU9uuSM2LGqOKxtlwA: folds
isdXtU9uuSM2LGqOKxtlwA leaves the table
craizer joins the table at seat #4
YlSX2xwu8QMQReaxSAD8XA is disconnected
YlSX2xwu8QMQReaxSAD8XA is connected
craizer is sitting out
YlSX2xwu8QMQReaxSAD8XA: folds
Q3uFdu6ztesjDFiqkagTRQ: folds
ztEPtIZdGv4TcxTUTzbY1w: folds
tnv1uD25KOWgMmyKcuOVog: folds
craizer leaves the table
Z3aYCZG/yXHYFjiWkGI5ug collected $5 from pot
Z3aYCZG/yXHYFjiWkGI5ug: doesn't show hand
*** SUMMARY ***
Total pot $5 | Rake $0
Seat 1: Hc2itIxwbi1lwa+DAYYQGg folded before Flop (didn't bet)
Seat 2: TAfo4veNRaRlzDXMMYS3Jg folded before Flop (didn't bet)
Seat 3: GX1heJ+DSsvm7gzSPsYhhQ folded before Flop (didn't bet)
Seat 4: isdXtU9uuSM2LGqOKxtlwA folded before Flop (didn't bet)
Seat 5: YlSX2xwu8QMQReaxSAD8XA folded before Flop (didn't bet)
Seat 6: Q3uFdu6ztesjDFiqkagTRQ (button) folded before Flop (didn't bet)
Seat 7: ztEPtIZdGv4TcxTUTzbY1w (small blind) folded before Flop
Seat 8: tnv1uD25KOWgMmyKcuOVog (big blind) folded before Flop
Seat 9: Z3aYCZG/yXHYFjiWkGI5ug collected ($5)



PokerStars Game #59938154030:  Hold'em No Limit ($1/$2) - 2009/07/01 0:08:16 ET
Table 'bJQ024BaYSBrW0sXpCZbNQ' 6-max Seat #1 is the button
Seat 1: yZgdnRylE65JbScQ7qCWgw ($31 in chips)
Seat 2: 1njbh8TKSUF6l4V1XwGdcg ($264 in chips)
Seat 3: vkfxu8f/jMYKUk6Ly4eujw ($214.60 in chips)
Seat 4: 9ni/OEXAqfc58zPQ0Tu9rQ ($269.60 in chips)
Seat 5: X7GlkHF+lkbarCLuZ4Uf0w ($38.15 in chips)
Seat 6: 9dpyyjDTCed6nV7JhaUUpw ($212.50 in chips)
1njbh8TKSUF6l4V1XwGdcg: posts small blind $1
vkfxu8f/jMYKUk6Ly4eujw: posts big blind $2
*** HOLE CARDS ***
9ni/OEXAqfc58zPQ0Tu9rQ: folds
X7GlkHF+lkbarCLuZ4Uf0w: folds
9dpyyjDTCed6nV7JhaUUpw: folds
yZgdnRylE65JbScQ7qCWgw: folds
1njbh8TKSUF6l4V1XwGdcg: folds
vkfxu8f/jMYKUk6Ly4eujw collected $2 from pot
vkfxu8f/jMYKUk6Ly4eujw: doesn't show hand
*** SUMMARY ***
Total pot $2 | Rake $0
Seat 1: yZgdnRylE65JbScQ7qCWgw (button) folded before Flop (didn't bet)
Seat 2: 1njbh8TKSUF6l4V1XwGdcg (small blind) folded before Flop
Seat 3: vkfxu8f/jMYKUk6Ly4eujw (big blind) collected ($2)
Seat 4: 9ni/OEXAqfc58zPQ0Tu9rQ folded before Flop (didn't bet)
Seat 5: X7GlkHF+lkbarCLuZ4Uf0w folded before Flop (didn't bet)
Seat 6: 9dpyyjDTCed6nV7JhaUUpw folded before Flop (didn't bet)



PokerStars Game #59938155726:  Hold'em No Limit ($1/$2) - 2009/07/01 0:08:19 ET
Table 'pPQgcj9XT9CHBsbo1WTBug' 6-max Seat #6 is the button
Seat 1: DFVYDA6dKQy7R7mGIKogZA ($117.30 in chips)
Seat 2: X7GlkHF+lkbarCLuZ4Uf0w ($44 in chips)
Seat 3: vkfxu8f/jMYKUk6Ly4eujw ($193 in chips)
Seat 5: 4Cl43Q1TYQL8wn1NSCUkaw ($55.40 in chips)
Seat 6: yZgdnRylE65JbScQ7qCWgw ($35 in chips)
DFVYDA6dKQy7R7mGIKogZA: posts small blind $1
X7GlkHF+lkbarCLuZ4Uf0w: posts big blind $2
*** HOLE CARDS ***
vkfxu8f/jMYKUk6Ly4eujw: folds
4Cl43Q1TYQL8wn1NSCUkaw: raises $2 to $4
yZgdnRylE65JbScQ7qCWgw: folds
DFVYDA6dKQy7R7mGIKogZA: calls $3
X7GlkHF+lkbarCLuZ4Uf0w: folds
*** FLOP *** [2h 9s 5d]
DFVYDA6dKQy7R7mGIKogZA: checks
4Cl43Q1TYQL8wn1NSCUkaw: checks
*** TURN *** [2h 9s 5d] [Kc]
DFVYDA6dKQy7R7mGIKogZA: checks
4Cl43Q1TYQL8wn1NSCUkaw: bets $4
DFVYDA6dKQy7R7mGIKogZA: folds
4Cl43Q1TYQL8wn1NSCUkaw collected $9.50 from pot
*** SUMMARY ***
Total pot $10 | Rake $0.50
Board [2h 9s 5d Kc]
Seat 1: DFVYDA6dKQy7R7mGIKogZA (small blind) folded on the Turn
Seat 2: X7GlkHF+lkbarCLuZ4Uf0w (big blind) folded before Flop
Seat 3: vkfxu8f/jMYKUk6Ly4eujw folded before Flop (didn't bet)
Seat 5: 4Cl43Q1TYQL8wn1NSCUkaw collected ($9.50)
Seat 6: yZgdnRylE65JbScQ7qCWgw (button) folded before Flop (didn't bet)



PokerStars Game #59938156702:  Hold'em No Limit ($1/$2) - 2009/07/01 0:08:20 ET
Table 'on4i1U1lCRmxsduFD3xiSg' 9-max Seat #6 is the button
Seat 1: BRHGptvmY2GKq4uuj7duDw ($310.60 in chips)
Seat 2: yZYrOeNDxQxkzpbgKX1bng ($64 in chips)
Seat 3: 5iPk5MyO3KVu18Y8XCYfFQ ($64.20 in chips)
Seat 4: Z3aYCZG/yXHYFjiWkGI5ug ($446.10 in chips)
Seat 5: QHxJjpVYwitg9krW6wZgJA ($200 in chips)
Seat 6: SB0tvOX0Kw61r2U851JFaA ($143.65 in chips)
Seat 7: xD4ElYxz6Ollzmam8BmMCw ($245.25 in chips)
Seat 8: cdC54j9fGGojcbzWB5PgzA ($200 in chips)
Seat 9: iMe5yhc+1BaiIPHet3NMrA ($203 in chips)
xD4ElYxz6Ollzmam8BmMCw: posts small blind $1
cdC54j9fGGojcbzWB5PgzA: posts big blind $2
*** HOLE CARDS ***
iMe5yhc+1BaiIPHet3NMrA: folds
BRHGptvmY2GKq4uuj7duDw: folds
yZYrOeNDxQxkzpbgKX1bng: folds
5iPk5MyO3KVu18Y8XCYfFQ: folds
Z3aYCZG/yXHYFjiWkGI5ug: folds
QHxJjpVYwitg9krW6wZgJA: raises $2 to $4
SB0tvOX0Kw61r2U851JFaA: folds
xD4ElYxz6Ollzmam8BmMCw: folds
cdC54j9fGGojcbzWB5PgzA: folds
QHxJjpVYwitg9krW6wZgJA collected $5 from pot
*** SUMMARY ***
Total pot $5 | Rake $0
Seat 1: BRHGptvmY2GKq4uuj7duDw folded before Flop (didn't bet)
Seat 2: yZYrOeNDxQxkzpbgKX1bng folded before Flop (didn't bet)
Seat 3: 5iPk5MyO3KVu18Y8XCYfFQ folded before Flop (didn't bet)
Seat 4: Z3aYCZG/yXHYFjiWkGI5ug folded before Flop (didn't bet)
Seat 5: QHxJjpVYwitg9krW6wZgJA collected ($5)
Seat 6: SB0tvOX0Kw61r2U851JFaA (button) folded before Flop (didn't bet)
Seat 7: xD4ElYxz6Ollzmam8BmMCw (small blind) folded before Flop
Seat 8: cdC54j9fGGojcbzWB5PgzA (big blind) folded before Flop
Seat 9: iMe5yhc+1BaiIPHet3NMrA folded before Flop (didn't bet)



PokerStars Game #59938157332:  Hold'em No Limit ($1/$2) - 2009/07/01 0:08:21 ET
Table 'W9UeSV0aoPjh5SFSxM8jUQ' 9-max Seat #1 is the button
Seat 1: cdC54j9fGGojcbzWB5PgzA ($255.35 in chips)
Seat 2: iMe5yhc+1BaiIPHet3NMrA ($261.75 in chips)
Seat 3: TAfo4veNRaRlzDXMMYS3Jg ($40 in chips)
Seat 4: De9g+AYjo0DN6C/+iT/nsg ($200 in chips)
Seat 5: 5c0Nx4jItp6QcQ2ve2inRw ($306.30 in chips)
Seat 6: MXxB6weBWzZyAhRZb+/KVg ($200 in chips)
Seat 7: 4Cl43Q1TYQL8wn1NSCUkaw ($51.60 in chips)
Seat 8: gvAfRM7YyyK5hFYc5+qhNA ($95.90 in chips)
Seat 9: U2A5Hv6ib/5+gzO2wr7Z4w ($200 in chips)
iMe5yhc+1BaiIPHet3NMrA: posts small blind $1
TAfo4veNRaRlzDXMMYS3Jg: posts big blind $2
*** HOLE CARDS ***
De9g+AYjo0DN6C/+iT/nsg: folds
5c0Nx4jItp6QcQ2ve2inRw: folds
MXxB6weBWzZyAhRZb+/KVg: folds
4Cl43Q1TYQL8wn1NSCUkaw: folds
gvAfRM7YyyK5hFYc5+qhNA: raises $4 to $6
U2A5Hv6ib/5+gzO2wr7Z4w: folds
cdC54j9fGGojcbzWB5PgzA: raises $16 to $22
iMe5yhc+1BaiIPHet3NMrA: folds
TAfo4veNRaRlzDXMMYS3Jg: folds
gvAfRM7YyyK5hFYc5+qhNA: calls $16
*** FLOP *** [6c Qh 2c]
gvAfRM7YyyK5hFYc5+qhNA: checks
cdC54j9fGGojcbzWB5PgzA: checks
*** TURN *** [6c Qh 2c] [4c]
gvAfRM7YyyK5hFYc5+qhNA: checks
cdC54j9fGGojcbzWB5PgzA: checks
*** RIVER *** [6c Qh 2c 4c] [7h]
gvAfRM7YyyK5hFYc5+qhNA: bets $12
cdC54j9fGGojcbzWB5PgzA: folds
gvAfRM7YyyK5hFYc5+qhNA collected $44.65 from pot
gvAfRM7YyyK5hFYc5+qhNA: doesn't show hand
*** SUMMARY ***
Total pot $47 | Rake $2.35
Board [6c Qh 2c 4c 7h]
Seat 1: cdC54j9fGGojcbzWB5PgzA (button) folded on the River
Seat 2: iMe5yhc+1BaiIPHet3NMrA (small blind) folded before Flop
Seat 3: TAfo4veNRaRlzDXMMYS3Jg (big blind) folded before Flop
Seat 4: De9g+AYjo0DN6C/+iT/nsg folded before Flop (didn't bet)
Seat 5: 5c0Nx4jItp6QcQ2ve2inRw folded before Flop (didn't bet)
Seat 6: MXxB6weBWzZyAhRZb+/KVg folded before Flop (didn't bet)
Seat 7: 4Cl43Q1TYQL8wn1NSCUkaw folded before Flop (didn't bet)
Seat 8: gvAfRM7YyyK5hFYc5+qhNA collected ($44.65)
Seat 9: U2A5Hv6ib/5+gzO2wr7Z4w folded before Flop (didn't bet)



PokerStars Game #59938160822:  Hold'em No Limit ($1/$2) - 2009/07/01 0:08:25 ET
Table 'rsKRKlGHlxVyqJxzO2a2Ow' 9-max Seat #9 is the button
Seat 1: uYWfQJg2hgHLxri6/uVJiw ($133.50 in chips)
Seat 2: QHxJjpVYwitg9krW6wZgJA ($244 in chips)
Seat 3: 9sYbXdhj1M2bwKrVNxj5+Q ($145.80 in chips)
Seat 4: zJtQ1gxyi72XvGYS1tM+DA ($156.30 in chips)
Seat 5: 5Q8U6iZbeO7xJSS4qvDP5g ($203 in chips)
Seat 6: H6Z4+qu8gR0VUiPOijndVg ($200 in chips)
Seat 7: kVCeGJ4NY7Fb0W74j1mAqA ($200 in chips)
Seat 8: Hc2itIxwbi1lwa+DAYYQGg ($37 in chips)
Seat 9: 5iPk5MyO3KVu18Y8XCYfFQ ($98.10 in chips)
uYWfQJg2hgHLxri6/uVJiw: posts small blind $1
QHxJjpVYwitg9krW6wZgJA: posts big blind $2
*** HOLE CARDS ***
9sYbXdhj1M2bwKrVNxj5+Q: folds
zJtQ1gxyi72XvGYS1tM+DA: folds
5Q8U6iZbeO7xJSS4qvDP5g: folds
H6Z4+qu8gR0VUiPOijndVg: folds
kVCeGJ4NY7Fb0W74j1mAqA: folds
Hc2itIxwbi1lwa+DAYYQGg: folds
5iPk5MyO3KVu18Y8XCYfFQ: folds
uYWfQJg2hgHLxri6/uVJiw: raises $2 to $4
QHxJjpVYwitg9krW6wZgJA: calls $2
*** FLOP *** [Qc 5d Td]
uYWfQJg2hgHLxri6/uVJiw: bets $4
QHxJjpVYwitg9krW6wZgJA: folds
uYWfQJg2hgHLxri6/uVJiw collected $7.60 from pot
uYWfQJg2hgHLxri6/uVJiw: doesn't show hand
*** SUMMARY ***
Total pot $8 | Rake $0.40
Board [Qc 5d Td]
Seat 1: uYWfQJg2hgHLxri6/uVJiw (small blind) collected ($7.60)
Seat 2: QHxJjpVYwitg9krW6wZgJA (big blind) folded on the Flop
Seat 3: 9sYbXdhj1M2bwKrVNxj5+Q folded before Flop (didn't bet)
Seat 4: zJtQ1gxyi72XvGYS1tM+DA folded before Flop (didn't bet)
Seat 5: 5Q8U6iZbeO7xJSS4qvDP5g folded before Flop (didn't bet)
Seat 6: H6Z4+qu8gR0VUiPOijndVg folded before Flop (didn't bet)
Seat 7: kVCeGJ4NY7Fb0W74j1mAqA folded before Flop (didn't bet)
Seat 8: Hc2itIxwbi1lwa+DAYYQGg folded before Flop (didn't bet)
Seat 9: 5iPk5MyO3KVu18Y8XCYfFQ (button) folded before Flop (didn't bet)



PokerStars Game #59938161568:  Hold'em No Limit ($1/$2) - 2009/07/01 0:08:26 ET
Table 'uJ9juaXXg9yIcSU8amxaXQ' 6-max Seat #4 is the button
Seat 1: HhIxv6mylwCAfv3sjJmq5g ($200 in chips)
Seat 2: DQlskgG4OtLpF2MVxLwf4A ($248.05 in chips)
Seat 3: zaogaltCDFVsIASEnrXs2w ($295.75 in chips)
Seat 4: 54yWzRRgS0oZ+S6LwZBxMQ ($28 in chips)
Seat 5: X7GlkHF+lkbarCLuZ4Uf0w ($50 in chips)
X7GlkHF+lkbarCLuZ4Uf0w: posts small blind $1
HhIxv6mylwCAfv3sjJmq5g: posts big blind $2
*** HOLE CARDS ***
DQlskgG4OtLpF2MVxLwf4A: folds
zaogaltCDFVsIASEnrXs2w: folds
54yWzRRgS0oZ+S6LwZBxMQ: folds
X7GlkHF+lkbarCLuZ4Uf0w: raises $4 to $6
HhIxv6mylwCAfv3sjJmq5g: folds
X7GlkHF+lkbarCLuZ4Uf0w collected $4 from pot
X7GlkHF+lkbarCLuZ4Uf0w: doesn't show hand
*** SUMMARY ***
Total pot $4 | Rake $0
Seat 1: HhIxv6mylwCAfv3sjJmq5g (big blind) folded before Flop
Seat 2: DQlskgG4OtLpF2MVxLwf4A folded before Flop (didn't bet)
Seat 3: zaogaltCDFVsIASEnrXs2w folded before Flop (didn't bet)
Seat 4: 54yWzRRgS0oZ+S6LwZBxMQ (button) folded before Flop (didn't bet)
Seat 5: X7GlkHF+lkbarCLuZ4Uf0w (small blind) collected ($4)



PokerStars Game #59938163012:  Hold'em No Limit ($1/$2) - 2009/07/01 0:08:29 ET
Table 'aSf77Sj8QEnzcc0WaxVD4Q' 6-max Seat #3 is the button
Seat 1: Q3uFdu6ztesjDFiqkagTRQ ($228.35 in chips)
Seat 2: vkfxu8f/jMYKUk6Ly4eujw ($195.75 in chips)
Seat 3: 9dpyyjDTCed6nV7JhaUUpw ($220.05 in chips)
Seat 4: 513FcCI8jHyQy2VWoIQkMg ($201 in chips)
Seat 5: InmkdI6G8TzSj9NhcCSyPg ($253 in chips)
Seat 6: vkoJRf3gidxY1pPi0AFWww ($327.10 in chips)
513FcCI8jHyQy2VWoIQkMg: posts small blind $1
InmkdI6G8TzSj9NhcCSyPg: posts big blind $2
*** HOLE CARDS ***
vkoJRf3gidxY1pPi0AFWww: calls $2
Q3uFdu6ztesjDFiqkagTRQ: folds
vkfxu8f/jMYKUk6Ly4eujw: folds
9dpyyjDTCed6nV7JhaUUpw: folds
513FcCI8jHyQy2VWoIQkMg: folds
InmkdI6G8TzSj9NhcCSyPg: checks
*** FLOP *** [Ts Kd 8c]
InmkdI6G8TzSj9NhcCSyPg: checks
vkoJRf3gidxY1pPi0AFWww: checks
*** TURN *** [Ts Kd 8c] [4s]
InmkdI6G8TzSj9NhcCSyPg: checks
vkoJRf3gidxY1pPi0AFWww: bets $4
InmkdI6G8TzSj9NhcCSyPg: folds
vkoJRf3gidxY1pPi0AFWww collected $4.75 from pot
vkoJRf3gidxY1pPi0AFWww: doesn't show hand
*** SUMMARY ***
Total pot $5 | Rake $0.25
Board [Ts Kd 8c 4s]
Seat 1: Q3uFdu6ztesjDFiqkagTRQ folded before Flop (didn't bet)
Seat 2: vkfxu8f/jMYKUk6Ly4eujw folded before Flop (didn't bet)
Seat 3: 9dpyyjDTCed6nV7JhaUUpw (button) folded before Flop (didn't bet)
Seat 4: 513FcCI8jHyQy2VWoIQkMg (small blind) folded before Flop
Seat 5: InmkdI6G8TzSj9NhcCSyPg (big blind) folded on the Turn
Seat 6: vkoJRf3gidxY1pPi0AFWww collected ($4.75)



PokerStars Game #59938163854:  Hold'em No Limit ($1/$2) - 2009/07/01 0:08:30 ET
Table 'WCA60bDA8ecovUgFSIZkTQ' 9-max Seat #3 is the button
Seat 2: G1h8wamBcVJXtsKXZQ2EyA ($43.70 in chips)
Seat 3: 5iPk5MyO3KVu18Y8XCYfFQ ($37 in chips)
Seat 4: Q3uFdu6ztesjDFiqkagTRQ ($485.70 in chips)
Seat 5: Hc2itIxwbi1lwa+DAYYQGg ($309.30 in chips)
Seat 6: DOWQSOJ7GaX+ksfWTqPT5A ($275.05 in chips)
Seat 7: GX1heJ+DSsvm7gzSPsYhhQ ($43 in chips)
Seat 8: x+V1JgVDawsJTxKcxm7gxw ($95 in chips)
Seat 9: 3q2/0oJr3Mcy1W5tcN61ug ($298.20 in chips)
Q3uFdu6ztesjDFiqkagTRQ: posts small blind $1
Hc2itIxwbi1lwa+DAYYQGg: posts big blind $2
CUZwDpLTQKhzarPe+JCLOQ: sits out
*** HOLE CARDS ***
DOWQSOJ7GaX+ksfWTqPT5A: calls $2
GX1heJ+DSsvm7gzSPsYhhQ: raises $6 to $8
x+V1JgVDawsJTxKcxm7gxw: raises $12 to $20
3q2/0oJr3Mcy1W5tcN61ug: folds
G1h8wamBcVJXtsKXZQ2EyA: folds
5iPk5MyO3KVu18Y8XCYfFQ: folds
Q3uFdu6ztesjDFiqkagTRQ: folds
Hc2itIxwbi1lwa+DAYYQGg: folds
DOWQSOJ7GaX+ksfWTqPT5A: folds
GX1heJ+DSsvm7gzSPsYhhQ: calls $12
*** FLOP *** [5h 6s 8h]
GX1heJ+DSsvm7gzSPsYhhQ: checks
x+V1JgVDawsJTxKcxm7gxw: bets $23
GX1heJ+DSsvm7gzSPsYhhQ: calls $23 and is all-in
*** TURN *** [5h 6s 8h] [7h]
*** RIVER *** [5h 6s 8h 7h] [4s]
*** SHOW DOWN ***
GX1heJ+DSsvm7gzSPsYhhQ: shows [Qd Qh] (a straight, Four to Eight)
x+V1JgVDawsJTxKcxm7gxw: shows [Qc Qs] (a straight, Four to Eight)
GX1heJ+DSsvm7gzSPsYhhQ collected $44 from pot
x+V1JgVDawsJTxKcxm7gxw collected $44 from pot
*** SUMMARY ***
Total pot $91 | Rake $3
Board [5h 6s 8h 7h 4s]
Seat 2: G1h8wamBcVJXtsKXZQ2EyA folded before Flop (didn't bet)
Seat 3: 5iPk5MyO3KVu18Y8XCYfFQ (button) folded before Flop (didn't bet)
Seat 4: Q3uFdu6ztesjDFiqkagTRQ (small blind) folded before Flop
Seat 5: Hc2itIxwbi1lwa+DAYYQGg (big blind) folded before Flop
Seat 6: DOWQSOJ7GaX+ksfWTqPT5A folded before Flop
Seat 7: GX1heJ+DSsvm7gzSPsYhhQ showed [Qd Qh] and won ($44) with a straight, Four to Eight
Seat 8: x+V1JgVDawsJTxKcxm7gxw showed [Qc Qs] and won ($44) with a straight, Four to Eight
Seat 9: 3q2/0oJr3Mcy1W5tcN61ug folded before Flop (didn't bet)



PokerStars Game #59938165512:  Hold'em No Limit ($1/$2) - 2009/07/01 0:08:32 ET
Table 'ztv6V3FN2bQ9nmJPPdx6nQ' 6-max Seat #6 is the button
Seat 1: ek1hig03QiyONDHXvgqteQ ($179.05 in chips)
Seat 4: vkfxu8f/jMYKUk6Ly4eujw ($342.70 in chips)
Seat 5: sTPOWERd9HWPCNrDBwsVjA ($204.95 in chips)
Seat 6: yZgdnRylE65JbScQ7qCWgw ($31 in chips)
ek1hig03QiyONDHXvgqteQ: posts small blind $1
vkfxu8f/jMYKUk6Ly4eujw: posts big blind $2
*** HOLE CARDS ***
sTPOWERd9HWPCNrDBwsVjA: folds
2lOU1DcvUZaMcxZ95XfzXw joins the table at seat #2
yZgdnRylE65JbScQ7qCWgw: raises $8 to $10
ek1hig03QiyONDHXvgqteQ: folds
vkfxu8f/jMYKUk6Ly4eujw: folds
yZgdnRylE65JbScQ7qCWgw collected $5 from pot
*** SUMMARY ***
Total pot $5 | Rake $0
Seat 1: ek1hig03QiyONDHXvgqteQ (small blind) folded before Flop
Seat 4: vkfxu8f/jMYKUk6Ly4eujw (big blind) folded before Flop
Seat 5: sTPOWERd9HWPCNrDBwsVjA folded before Flop (didn't bet)
Seat 6: yZgdnRylE65JbScQ7qCWgw (button) collected ($5)



PokerStars Game #59938167650:  Hold'em No Limit ($1/$2) - 2009/07/01 0:08:35 ET
Table 'jlrIxbrVIG+gjaUYT4za8g' 6-max Seat #2 is the button
Seat 1: ygTTt5ehT4aF86q1a8/R+w ($196.05 in chips)
Seat 2: N18PrNGQj43J7TJuQuu+tw ($135.25 in chips)
Seat 4: 8srN1dKQePlsv0GyTada+Q ($200 in chips)
Seat 5: F/075N6nU34Fn0zr6qD3aw ($168.55 in chips)
Seat 6: vkfxu8f/jMYKUk6Ly4eujw ($278.05 in chips)
8srN1dKQePlsv0GyTada+Q: posts small blind $1
F/075N6nU34Fn0zr6qD3aw: posts big blind $2
*** HOLE CARDS ***
vkfxu8f/jMYKUk6Ly4eujw: folds
ygTTt5ehT4aF86q1a8/R+w: folds
N18PrNGQj43J7TJuQuu+tw: raises $2 to $4
8srN1dKQePlsv0GyTada+Q: folds
F/075N6nU34Fn0zr6qD3aw: calls $2
*** FLOP *** [4s 2c 4c]
54yWzRRgS0oZ+S6LwZBxMQ joins the table at seat #3
F/075N6nU34Fn0zr6qD3aw: checks
N18PrNGQj43J7TJuQuu+tw: bets $2
F/075N6nU34Fn0zr6qD3aw: folds
N18PrNGQj43J7TJuQuu+tw collected $8.55 from pot
*** SUMMARY ***
Total pot $9 | Rake $0.45
Board [4s 2c 4c]
Seat 1: ygTTt5ehT4aF86q1a8/R+w folded before Flop (didn't bet)
Seat 2: N18PrNGQj43J7TJuQuu+tw (button) collected ($8.55)
Seat 4: 8srN1dKQePlsv0GyTada+Q (small blind) folded before Flop
Seat 5: F/075N6nU34Fn0zr6qD3aw (big blind) folded on the Flop
Seat 6: vkfxu8f/jMYKUk6Ly4eujw folded before Flop (didn't bet)



PokerStars Game #59938168400:  Hold'em No Limit ($1/$2) - 2009/07/01 0:08:36 ET
Table 'l5lZHc5JRHEDt0Y2AVPq3g' 6-max Seat #5 is the button
Seat 1: gGPaCoSWW1HoKYaqfAPecg ($203.30 in chips)
Seat 2: my38j/MmtBd/8qVwmyCREA ($256.15 in chips)
Seat 3: yZgdnRylE65JbScQ7qCWgw ($40 in chips)
Seat 4: zNjJ/y4emmF+vzrCDd+ooA ($203.95 in chips)
Seat 5: 6fLdOUCRtX71xbVRhJEq8w ($200 in chips)
Seat 6: vkfxu8f/jMYKUk6Ly4eujw ($207.30 in chips)
vkfxu8f/jMYKUk6Ly4eujw: posts small blind $1
gGPaCoSWW1HoKYaqfAPecg: posts big blind $2
*** HOLE CARDS ***
my38j/MmtBd/8qVwmyCREA: calls $2
yZgdnRylE65JbScQ7qCWgw: folds
zNjJ/y4emmF+vzrCDd+ooA: folds
6fLdOUCRtX71xbVRhJEq8w: folds
vkfxu8f/jMYKUk6Ly4eujw: folds
gGPaCoSWW1HoKYaqfAPecg: checks
*** FLOP *** [As Kc 4s]
gGPaCoSWW1HoKYaqfAPecg: bets $3.80
my38j/MmtBd/8qVwmyCREA: calls $3.80
*** TURN *** [As Kc 4s] [5d]
gGPaCoSWW1HoKYaqfAPecg: bets $8.40
my38j/MmtBd/8qVwmyCREA: folds
gGPaCoSWW1HoKYaqfAPecg collected $12 from pot
gGPaCoSWW1HoKYaqfAPecg: doesn't show hand
*** SUMMARY ***
Total pot $12.60 | Rake $0.60
Board [As Kc 4s 5d]
Seat 1: gGPaCoSWW1HoKYaqfAPecg (big blind) collected ($12)
Seat 2: my38j/MmtBd/8qVwmyCREA folded on the Turn
Seat 3: yZgdnRylE65JbScQ7qCWgw folded before Flop (didn't bet)
Seat 4: zNjJ/y4emmF+vzrCDd+ooA folded before Flop (didn't bet)
Seat 5: 6fLdOUCRtX71xbVRhJEq8w (button) folded before Flop (didn't bet)
Seat 6: vkfxu8f/jMYKUk6Ly4eujw (small blind) folded before Flop



PokerStars Game #59938168908:  Hold'em No Limit ($1/$2) - 2009/07/01 0:08:37 ET
Table '3FGoiEOffWrbgTfsB3t7FA' 2-max Seat #2 is the button
Seat 1: e0oDWyrmgLpR6bROEqw1nQ ($389 in chips)
Seat 2: +sy/nlNI20yZraIjs4AALg ($215.05 in chips)
+sy/nlNI20yZraIjs4AALg: posts small blind $1
e0oDWyrmgLpR6bROEqw1nQ: posts big blind $2
*** HOLE CARDS ***
+sy/nlNI20yZraIjs4AALg: calls $1
e0oDWyrmgLpR6bROEqw1nQ: checks
*** FLOP *** [Qc Tc Th]
e0oDWyrmgLpR6bROEqw1nQ: checks
+sy/nlNI20yZraIjs4AALg: checks
*** TURN *** [Qc Tc Th] [8h]
e0oDWyrmgLpR6bROEqw1nQ: checks
+sy/nlNI20yZraIjs4AALg: checks
*** RIVER *** [Qc Tc Th 8h] [6s]
e0oDWyrmgLpR6bROEqw1nQ: checks
+sy/nlNI20yZraIjs4AALg: checks
*** SHOW DOWN ***
e0oDWyrmgLpR6bROEqw1nQ: shows [Jd 5d] (a pair of Tens)
+sy/nlNI20yZraIjs4AALg: shows [7s 6d] (two pair, Tens and Sixes)
+sy/nlNI20yZraIjs4AALg collected $3.80 from pot
*** SUMMARY ***
Total pot $4 | Rake $0.20
Board [Qc Tc Th 8h 6s]
Seat 1: e0oDWyrmgLpR6bROEqw1nQ (big blind) showed [Jd 5d] and lost with a pair of Tens
Seat 2: +sy/nlNI20yZraIjs4AALg (button) (small blind) showed [7s 6d] and won ($3.80) with two pair, Tens and Sixes



PokerStars Game #59938171564:  Hold'em No Limit ($1/$2) - 2009/07/01 0:08:41 ET
Table 'NmY84NAf9Mh0ckAckHnh5g' 2-max Seat #2 is the button
Seat 1: 6hvg964TSqZ3AL/0XK9aVQ ($316 in chips)
Seat 2: RwDoM55ZeQuI2ADyJhOb2Q ($277.30 in chips)
RwDoM55ZeQuI2ADyJhOb2Q: posts small blind $1
6hvg964TSqZ3AL/0XK9aVQ: posts big blind $2
*** HOLE CARDS ***
RwDoM55ZeQuI2ADyJhOb2Q: raises $4 to $6
6hvg964TSqZ3AL/0XK9aVQ: folds
RwDoM55ZeQuI2ADyJhOb2Q collected $4 from pot
RwDoM55ZeQuI2ADyJhOb2Q: doesn't show hand
*** SUMMARY ***
Total pot $4 | Rake $0
Seat 1: 6hvg964TSqZ3AL/0XK9aVQ (big blind) folded before Flop
Seat 2: RwDoM55ZeQuI2ADyJhOb2Q (button) (small blind) collected ($4)



PokerStars Game #59938172002:  Hold'em No Limit ($1/$2) - 2009/07/01 0:08:41 ET
Table 'gnHBqWll9O3fxG7Ojkz/ng' 9-max Seat #1 is the button
Seat 1: hpqdC/23wXosGOmzARr5NA ($156.30 in chips)
Seat 2: H6Z4+qu8gR0VUiPOijndVg ($200 in chips)
Seat 3: 5Q8U6iZbeO7xJSS4qvDP5g ($218.60 in chips)
Seat 4: n5XI5/7gN+gIubHFBH+mOw ($404.85 in chips)
Seat 5: GX1heJ+DSsvm7gzSPsYhhQ ($54.75 in chips)
Seat 6: 5iPk5MyO3KVu18Y8XCYfFQ ($43.45 in chips)
Seat 8: De9g+AYjo0DN6C/+iT/nsg ($244.05 in chips)
Seat 9: kVCeGJ4NY7Fb0W74j1mAqA ($206 in chips)
H6Z4+qu8gR0VUiPOijndVg: posts small blind $1
5Q8U6iZbeO7xJSS4qvDP5g: posts big blind $2
*** HOLE CARDS ***
n5XI5/7gN+gIubHFBH+mOw: folds
GX1heJ+DSsvm7gzSPsYhhQ: folds
5iPk5MyO3KVu18Y8XCYfFQ: folds
De9g+AYjo0DN6C/+iT/nsg: folds
kVCeGJ4NY7Fb0W74j1mAqA: folds
hpqdC/23wXosGOmzARr5NA: folds
H6Z4+qu8gR0VUiPOijndVg: folds
5Q8U6iZbeO7xJSS4qvDP5g collected $2 from pot
5Q8U6iZbeO7xJSS4qvDP5g: doesn't show hand
*** SUMMARY ***
Total pot $2 | Rake $0
Seat 1: hpqdC/23wXosGOmzARr5NA (button) folded before Flop (didn't bet)
Seat 2: H6Z4+qu8gR0VUiPOijndVg (small blind) folded before Flop
Seat 3: 5Q8U6iZbeO7xJSS4qvDP5g (big blind) collected ($2)
Seat 4: n5XI5/7gN+gIubHFBH+mOw folded before Flop (didn't bet)
Seat 5: GX1heJ+DSsvm7gzSPsYhhQ folded before Flop (didn't bet)
Seat 6: 5iPk5MyO3KVu18Y8XCYfFQ folded before Flop (didn't bet)
Seat 8: De9g+AYjo0DN6C/+iT/nsg folded before Flop (didn't bet)
Seat 9: kVCeGJ4NY7Fb0W74j1mAqA folded before Flop (didn't bet)



PokerStars Game #59938172868:  Hold'em No Limit ($1/$2) - 2009/07/01 0:08:42 ET
Table 'bJQ024BaYSBrW0sXpCZbNQ' 6-max Seat #2 is the button
Seat 1: yZgdnRylE65JbScQ7qCWgw ($31 in chips)
Seat 2: 1njbh8TKSUF6l4V1XwGdcg ($263 in chips)
Seat 3: vkfxu8f/jMYKUk6Ly4eujw ($215.60 in chips)
Seat 4: 9ni/OEXAqfc58zPQ0Tu9rQ ($269.60 in chips)
Seat 5: X7GlkHF+lkbarCLuZ4Uf0w ($38.15 in chips)
Seat 6: 9dpyyjDTCed6nV7JhaUUpw ($212.50 in chips)
vkfxu8f/jMYKUk6Ly4eujw: posts small blind $1
9ni/OEXAqfc58zPQ0Tu9rQ: posts big blind $2
*** HOLE CARDS ***
X7GlkHF+lkbarCLuZ4Uf0w: folds
9dpyyjDTCed6nV7JhaUUpw: folds
yZgdnRylE65JbScQ7qCWgw: folds
1njbh8TKSUF6l4V1XwGdcg: folds
vkfxu8f/jMYKUk6Ly4eujw: folds
9ni/OEXAqfc58zPQ0Tu9rQ collected $2 from pot
*** SUMMARY ***
Total pot $2 | Rake $0
Seat 1: yZgdnRylE65JbScQ7qCWgw folded before Flop (didn't bet)
Seat 2: 1njbh8TKSUF6l4V1XwGdcg (button) folded before Flop (didn't bet)
Seat 3: vkfxu8f/jMYKUk6Ly4eujw (small blind) folded before Flop
Seat 4: 9ni/OEXAqfc58zPQ0Tu9rQ (big blind) collected ($2)
Seat 5: X7GlkHF+lkbarCLuZ4Uf0w folded before Flop (didn't bet)
Seat 6: 9dpyyjDTCed6nV7JhaUUpw folded before Flop (didn't bet)



PokerStars Game #59938174322:  Hold'em No Limit ($1/$2) - 2009/07/01 0:08:45 ET
Table 'CFkQcfWjKccZaZDf71FK+w' 6-max Seat #6 is the button
Seat 1: X7GlkHF+lkbarCLuZ4Uf0w ($32 in chips)
Seat 2: yZgdnRylE65JbScQ7qCWgw ($43 in chips)
Seat 3: ygTTt5ehT4aF86q1a8/R+w ($134.40 in chips)
Seat 4: B2Ih1sr5VZk+8He7rcrMtQ ($220.90 in chips)
Seat 5: 1njbh8TKSUF6l4V1XwGdcg ($235 in chips)
Seat 6: ORVqY3rf9X6ANA/8s+On2Q ($40 in chips)
X7GlkHF+lkbarCLuZ4Uf0w: posts small blind $1
yZgdnRylE65JbScQ7qCWgw: posts big blind $2
*** HOLE CARDS ***
ygTTt5ehT4aF86q1a8/R+w: raises $4 to $6
B2Ih1sr5VZk+8He7rcrMtQ: folds
1njbh8TKSUF6l4V1XwGdcg: folds
ORVqY3rf9X6ANA/8s+On2Q: calls $6
X7GlkHF+lkbarCLuZ4Uf0w: folds
yZgdnRylE65JbScQ7qCWgw: folds
*** FLOP *** [7c Qd 4d]
ygTTt5ehT4aF86q1a8/R+w: checks
ORVqY3rf9X6ANA/8s+On2Q: checks
*** TURN *** [7c Qd 4d] [5d]
ygTTt5ehT4aF86q1a8/R+w: bets $8
ORVqY3rf9X6ANA/8s+On2Q: folds
ygTTt5ehT4aF86q1a8/R+w collected $14.25 from pot
*** SUMMARY ***
Total pot $15 | Rake $0.75
Board [7c Qd 4d 5d]
Seat 1: X7GlkHF+lkbarCLuZ4Uf0w (small blind) folded before Flop
Seat 2: yZgdnRylE65JbScQ7qCWgw (big blind) folded before Flop
Seat 3: ygTTt5ehT4aF86q1a8/R+w collected ($14.25)
Seat 4: B2Ih1sr5VZk+8He7rcrMtQ folded before Flop (didn't bet)
Seat 5: 1njbh8TKSUF6l4V1XwGdcg folded before Flop (didn't bet)
Seat 6: ORVqY3rf9X6ANA/8s+On2Q (button) folded on the Turn



PokerStars Game #59938175596:  Hold'em No Limit ($1/$2) - 2009/07/01 0:08:46 ET
Table 'qVXak+oTeDXMGbWa4sDU5Q' 9-max Seat #6 is the button
Seat 1: H6Z4+qu8gR0VUiPOijndVg ($250 in chips)
Seat 2: Hc2itIxwbi1lwa+DAYYQGg ($49 in chips)
Seat 3: oz9eCXGC7DdjQlL/nuWj1A ($105.85 in chips)
Seat 4: b0jO1SDhLedy1//CQlA8kw ($37 in chips)
Seat 6: Q3uFdu6ztesjDFiqkagTRQ ($200 in chips)
Seat 7: 5iPk5MyO3KVu18Y8XCYfFQ ($116 in chips)
Seat 8: 9pHZMviI9R8injxojGTnvw ($58.85 in chips)
Seat 9: IZ/2qsh1CIg9m5PWsMsLmA ($360.95 in chips)
5iPk5MyO3KVu18Y8XCYfFQ: posts small blind $1
9pHZMviI9R8injxojGTnvw: posts big blind $2
NqKRc5xvcye0d7F6VOF6MQ: sits out
*** HOLE CARDS ***
IZ/2qsh1CIg9m5PWsMsLmA: folds
H6Z4+qu8gR0VUiPOijndVg: folds
Hc2itIxwbi1lwa+DAYYQGg: folds
oz9eCXGC7DdjQlL/nuWj1A: folds
b0jO1SDhLedy1//CQlA8kw: raises $4 to $6
Q3uFdu6ztesjDFiqkagTRQ: folds
5iPk5MyO3KVu18Y8XCYfFQ: folds
9pHZMviI9R8injxojGTnvw: folds
b0jO1SDhLedy1//CQlA8kw collected $5 from pot
b0jO1SDhLedy1//CQlA8kw: doesn't show hand
*** SUMMARY ***
Total pot $5 | Rake $0
Seat 1: H6Z4+qu8gR0VUiPOijndVg folded before Flop (didn't bet)
Seat 2: Hc2itIxwbi1lwa+DAYYQGg folded before Flop (didn't bet)
Seat 3: oz9eCXGC7DdjQlL/nuWj1A folded before Flop (didn't bet)
Seat 4: b0jO1SDhLedy1//CQlA8kw collected ($5)
Seat 6: Q3uFdu6ztesjDFiqkagTRQ (button) folded before Flop (didn't bet)
Seat 7: 5iPk5MyO3KVu18Y8XCYfFQ (small blind) folded before Flop
Seat 8: 9pHZMviI9R8injxojGTnvw (big blind) folded before Flop
Seat 9: IZ/2qsh1CIg9m5PWsMsLmA folded before Flop (didn't bet)



PokerStars Game #59938180102:  Hold'em No Limit ($1/$2) - 2009/07/01 0:08:52 ET
Table 'uJ9juaXXg9yIcSU8amxaXQ' 6-max Seat #5 is the button
Seat 1: HhIxv6mylwCAfv3sjJmq5g ($200 in chips)
Seat 2: DQlskgG4OtLpF2MVxLwf4A ($248.05 in chips)
Seat 3: zaogaltCDFVsIASEnrXs2w ($295.75 in chips)
Seat 4: 54yWzRRgS0oZ+S6LwZBxMQ ($28 in chips)
Seat 5: X7GlkHF+lkbarCLuZ4Uf0w ($52 in chips)
HhIxv6mylwCAfv3sjJmq5g: posts small blind $1
DQlskgG4OtLpF2MVxLwf4A: posts big blind $2
*** HOLE CARDS ***
zaogaltCDFVsIASEnrXs2w: raises $4 to $6
54yWzRRgS0oZ+S6LwZBxMQ: folds
X7GlkHF+lkbarCLuZ4Uf0w: folds
HhIxv6mylwCAfv3sjJmq5g: folds
DQlskgG4OtLpF2MVxLwf4A: folds
zaogaltCDFVsIASEnrXs2w collected $5 from pot
*** SUMMARY ***
Total pot $5 | Rake $0
Seat 1: HhIxv6mylwCAfv3sjJmq5g (small blind) folded before Flop
Seat 2: DQlskgG4OtLpF2MVxLwf4A (big blind) folded before Flop
Seat 3: zaogaltCDFVsIASEnrXs2w collected ($5)
Seat 4: 54yWzRRgS0oZ+S6LwZBxMQ folded before Flop (didn't bet)
Seat 5: X7GlkHF+lkbarCLuZ4Uf0w (button) folded before Flop (didn't bet)



PokerStars Game #59938180022:  Hold'em No Limit ($1/$2) - 2009/07/01 0:08:52 ET
Table 'XP2sRSup+aRuwzx3vDZsDg' 6-max Seat #4 is the button
Seat 1: o9jamqIi6sTTRSqudgboRA ($249.70 in chips)
Seat 2: yZgdnRylE65JbScQ7qCWgw ($40 in chips)
Seat 3: X7GlkHF+lkbarCLuZ4Uf0w ($30.50 in chips)
Seat 4: JsC+WvfzqlxVs9G8/gSQAQ ($72.75 in chips)
Seat 5: vkfxu8f/jMYKUk6Ly4eujw ($193 in chips)
Seat 6: h7ppRQJTYBsHCbLMeW9T2g ($487.75 in chips)
vkfxu8f/jMYKUk6Ly4eujw: posts small blind $1
h7ppRQJTYBsHCbLMeW9T2g: posts big blind $2
*** HOLE CARDS ***
o9jamqIi6sTTRSqudgboRA: raises $5 to $7
yZgdnRylE65JbScQ7qCWgw: folds
X7GlkHF+lkbarCLuZ4Uf0w: folds
JsC+WvfzqlxVs9G8/gSQAQ: raises $5 to $12
vkfxu8f/jMYKUk6Ly4eujw: folds
h7ppRQJTYBsHCbLMeW9T2g: folds
o9jamqIi6sTTRSqudgboRA: calls $5
*** FLOP *** [2h Ah 6d]
o9jamqIi6sTTRSqudgboRA: checks
JsC+WvfzqlxVs9G8/gSQAQ: bets $12
o9jamqIi6sTTRSqudgboRA: folds
JsC+WvfzqlxVs9G8/gSQAQ collected $25.65 from pot
*** SUMMARY ***
Total pot $27 | Rake $1.35
Board [2h Ah 6d]
Seat 1: o9jamqIi6sTTRSqudgboRA folded on the Flop
Seat 2: yZgdnRylE65JbScQ7qCWgw folded before Flop (didn't bet)
Seat 3: X7GlkHF+lkbarCLuZ4Uf0w folded before Flop (didn't bet)
Seat 4: JsC+WvfzqlxVs9G8/gSQAQ (button) collected ($25.65)
Seat 5: vkfxu8f/jMYKUk6Ly4eujw (small blind) folded before Flop
Seat 6: h7ppRQJTYBsHCbLMeW9T2g (big blind) folded before Flop



PokerStars Game #59938180718:  Hold'em No Limit ($1/$2) - 2009/07/01 0:08:53 ET
Table 'NmY84NAf9Mh0ckAckHnh5g' 2-max Seat #1 is the button
Seat 1: 6hvg964TSqZ3AL/0XK9aVQ ($314 in chips)
Seat 2: RwDoM55ZeQuI2ADyJhOb2Q ($279.30 in chips)
6hvg964TSqZ3AL/0XK9aVQ: posts small blind $1
RwDoM55ZeQuI2ADyJhOb2Q: posts big blind $2
*** HOLE CARDS ***
6hvg964TSqZ3AL/0XK9aVQ: folds
RwDoM55ZeQuI2ADyJhOb2Q collected $2 from pot
RwDoM55ZeQuI2ADyJhOb2Q: doesn't show hand
*** SUMMARY ***
Total pot $2 | Rake $0
Seat 1: 6hvg964TSqZ3AL/0XK9aVQ (button) (small blind) folded before Flop
Seat 2: RwDoM55ZeQuI2ADyJhOb2Q (big blind) collected ($2)



PokerStars Game #59938182608:  Hold'em No Limit ($1/$2) - 2009/07/01 0:08:56 ET
Table 'SF49/KQm8T4taMp6kb+HXA' 9-max Seat #1 is the button
Seat 1: l1bCLGuFqeFRwUfPsiDu/g ($175.95 in chips)
Seat 2: 8Z3QifiM9eOd5EIJ25dXNg ($67.35 in chips)
Seat 3: L88dtdULfz5oGDSuo9/RvA ($43.80 in chips)
Seat 4: HffgoYm61KgkdMe/DYChIQ ($36 in chips)
Seat 5: Z3aYCZG/yXHYFjiWkGI5ug ($227.55 in chips)
Seat 6: M2ht6rIKOI/my9eh610Nlw ($247.45 in chips)
Seat 8: 5iPk5MyO3KVu18Y8XCYfFQ ($39 in chips)
Seat 9: O+jytCilwk7zItVCEavmtw ($137 in chips)
8Z3QifiM9eOd5EIJ25dXNg: posts small blind $1
L88dtdULfz5oGDSuo9/RvA: posts big blind $2
*** HOLE CARDS ***
HffgoYm61KgkdMe/DYChIQ: folds
Z3aYCZG/yXHYFjiWkGI5ug: folds
M2ht6rIKOI/my9eh610Nlw: folds
5iPk5MyO3KVu18Y8XCYfFQ: folds
n2VAbLaE5qgKr5mA4W6v4w is connected
O+jytCilwk7zItVCEavmtw: raises $6 to $8
l1bCLGuFqeFRwUfPsiDu/g: folds
8Z3QifiM9eOd5EIJ25dXNg: folds
n2VAbLaE5qgKr5mA4W6v4w has returned
L88dtdULfz5oGDSuo9/RvA: folds
n2VAbLaE5qgKr5mA4W6v4w is sitting out
O+jytCilwk7zItVCEavmtw collected $5 from pot
*** SUMMARY ***
Total pot $5 | Rake $0
Seat 1: l1bCLGuFqeFRwUfPsiDu/g (button) folded before Flop (didn't bet)
Seat 2: 8Z3QifiM9eOd5EIJ25dXNg (small blind) folded before Flop
Seat 3: L88dtdULfz5oGDSuo9/RvA (big blind) folded before Flop
Seat 4: HffgoYm61KgkdMe/DYChIQ folded before Flop (didn't bet)
Seat 5: Z3aYCZG/yXHYFjiWkGI5ug folded before Flop (didn't bet)
Seat 6: M2ht6rIKOI/my9eh610Nlw folded before Flop (didn't bet)
Seat 8: 5iPk5MyO3KVu18Y8XCYfFQ folded before Flop (didn't bet)
Seat 9: O+jytCilwk7zItVCEavmtw collected ($5)



PokerStars Game #59938183150:  Hold'em No Limit ($1/$2) - 2009/07/01 0:08:56 ET
Table 'rsKRKlGHlxVyqJxzO2a2Ow' 9-max Seat #1 is the button
Seat 1: uYWfQJg2hgHLxri6/uVJiw ($137.10 in chips)
Seat 2: QHxJjpVYwitg9krW6wZgJA ($240 in chips)
Seat 3: 9sYbXdhj1M2bwKrVNxj5+Q ($145.80 in chips)
Seat 4: zJtQ1gxyi72XvGYS1tM+DA ($156.30 in chips)
Seat 5: 5Q8U6iZbeO7xJSS4qvDP5g ($203 in chips)
Seat 6: H6Z4+qu8gR0VUiPOijndVg ($200 in chips)
Seat 7: kVCeGJ4NY7Fb0W74j1mAqA ($200 in chips)
Seat 8: Hc2itIxwbi1lwa+DAYYQGg ($37 in chips)
Seat 9: 5iPk5MyO3KVu18Y8XCYfFQ ($98.10 in chips)
QHxJjpVYwitg9krW6wZgJA: posts small blind $1
9sYbXdhj1M2bwKrVNxj5+Q: posts big blind $2
*** HOLE CARDS ***
zJtQ1gxyi72XvGYS1tM+DA: raises $2 to $4
5Q8U6iZbeO7xJSS4qvDP5g: folds
H6Z4+qu8gR0VUiPOijndVg: folds
kVCeGJ4NY7Fb0W74j1mAqA: folds
Hc2itIxwbi1lwa+DAYYQGg: folds
5iPk5MyO3KVu18Y8XCYfFQ: folds
uYWfQJg2hgHLxri6/uVJiw: folds
QHxJjpVYwitg9krW6wZgJA: folds
9sYbXdhj1M2bwKrVNxj5+Q: calls $2
*** FLOP *** [Ts 5s 2d]
9sYbXdhj1M2bwKrVNxj5+Q: checks
zJtQ1gxyi72XvGYS1tM+DA: bets $8
9sYbXdhj1M2bwKrVNxj5+Q: calls $8
*** TURN *** [Ts 5s 2d] [6h]
9sYbXdhj1M2bwKrVNxj5+Q: bets $8
zJtQ1gxyi72XvGYS1tM+DA: raises $8 to $16
9sYbXdhj1M2bwKrVNxj5+Q: calls $8
*** RIVER *** [Ts 5s 2d 6h] [2c]
9sYbXdhj1M2bwKrVNxj5+Q: checks
zJtQ1gxyi72XvGYS1tM+DA: bets $24
9sYbXdhj1M2bwKrVNxj5+Q: folds
zJtQ1gxyi72XvGYS1tM+DA collected $54.25 from pot
*** SUMMARY ***
Total pot $57 | Rake $2.75
Board [Ts 5s 2d 6h 2c]
Seat 1: uYWfQJg2hgHLxri6/uVJiw (button) folded before Flop (didn't bet)
Seat 2: QHxJjpVYwitg9krW6wZgJA (small blind) folded before Flop
Seat 3: 9sYbXdhj1M2bwKrVNxj5+Q (big blind) folded on the River
Seat 4: zJtQ1gxyi72XvGYS1tM+DA collected ($54.25)
Seat 5: 5Q8U6iZbeO7xJSS4qvDP5g folded before Flop (didn't bet)
Seat 6: H6Z4+qu8gR0VUiPOijndVg folded before Flop (didn't bet)
Seat 7: kVCeGJ4NY7Fb0W74j1mAqA folded before Flop (didn't bet)
Seat 8: Hc2itIxwbi1lwa+DAYYQGg folded before Flop (didn't bet)
Seat 9: 5iPk5MyO3KVu18Y8XCYfFQ folded before Flop (didn't bet)



PokerStars Game #59938184518:  Hold'em No Limit ($1/$2) - 2009/07/01 0:08:58 ET
Table 'ztv6V3FN2bQ9nmJPPdx6nQ' 6-max Seat #1 is the button
Seat 1: ek1hig03QiyONDHXvgqteQ ($178.05 in chips)
Seat 4: vkfxu8f/jMYKUk6Ly4eujw ($340.70 in chips)
Seat 5: sTPOWERd9HWPCNrDBwsVjA ($204.95 in chips)
Seat 6: yZgdnRylE65JbScQ7qCWgw ($34 in chips)
2lOU1DcvUZaMcxZ95XfzXw will be allowed to play after the button
vkfxu8f/jMYKUk6Ly4eujw: posts small blind $1
sTPOWERd9HWPCNrDBwsVjA: posts big blind $2
*** HOLE CARDS ***
yZgdnRylE65JbScQ7qCWgw: folds
ek1hig03QiyONDHXvgqteQ: folds
vkfxu8f/jMYKUk6Ly4eujw: folds
sTPOWERd9HWPCNrDBwsVjA collected $2 from pot
*** SUMMARY ***
Total pot $2 | Rake $0
Seat 1: ek1hig03QiyONDHXvgqteQ (button) folded before Flop (didn't bet)
Seat 4: vkfxu8f/jMYKUk6Ly4eujw (small blind) folded before Flop
Seat 5: sTPOWERd9HWPCNrDBwsVjA (big blind) collected ($2)
Seat 6: yZgdnRylE65JbScQ7qCWgw folded before Flop (didn't bet)



PokerStars Game #59938184426:  Hold'em No Limit ($1/$2) - 2009/07/01 0:08:58 ET
Table 'LL4bDFyhj5hsMpzaDugJZg' 6-max Seat #5 is the button
Seat 1: IBW9lyGsaRmfcbyA/qFfEw ($70.20 in chips)
Seat 2: L3l+A4pJhOAD6HVVFXvVBw ($289.15 in chips)
Seat 3: gGPaCoSWW1HoKYaqfAPecg ($205 in chips)
Seat 4: 8srN1dKQePlsv0GyTada+Q ($287.75 in chips)
Seat 5: HgX0VeqE/dzSXd5BpntRBw ($200 in chips)
Seat 6: yZgdnRylE65JbScQ7qCWgw ($38 in chips)
yZgdnRylE65JbScQ7qCWgw: posts small blind $1
IBW9lyGsaRmfcbyA/qFfEw: posts big blind $2
*** HOLE CARDS ***
L3l+A4pJhOAD6HVVFXvVBw: folds
gGPaCoSWW1HoKYaqfAPecg: folds
8srN1dKQePlsv0GyTada+Q: folds
HgX0VeqE/dzSXd5BpntRBw: raises $3 to $5
yZgdnRylE65JbScQ7qCWgw: folds
IBW9lyGsaRmfcbyA/qFfEw: folds
HgX0VeqE/dzSXd5BpntRBw collected $5 from pot
*** SUMMARY ***
Total pot $5 | Rake $0
Seat 1: IBW9lyGsaRmfcbyA/qFfEw (big blind) folded before Flop
Seat 2: L3l+A4pJhOAD6HVVFXvVBw folded before Flop (didn't bet)
Seat 3: gGPaCoSWW1HoKYaqfAPecg folded before Flop (didn't bet)
Seat 4: 8srN1dKQePlsv0GyTada+Q folded before Flop (didn't bet)
Seat 5: HgX0VeqE/dzSXd5BpntRBw (button) collected ($5)
Seat 6: yZgdnRylE65JbScQ7qCWgw (small blind) folded before Flop



PokerStars Game #59938185842:  Hold'em No Limit ($1/$2) - 2009/07/01 0:09:00 ET
Table 'NmY84NAf9Mh0ckAckHnh5g' 2-max Seat #2 is the button
Seat 1: 6hvg964TSqZ3AL/0XK9aVQ ($313 in chips)
Seat 2: RwDoM55ZeQuI2ADyJhOb2Q ($280.30 in chips)
RwDoM55ZeQuI2ADyJhOb2Q: posts small blind $1
6hvg964TSqZ3AL/0XK9aVQ: posts big blind $2
*** HOLE CARDS ***
RwDoM55ZeQuI2ADyJhOb2Q: raises $4 to $6
6hvg964TSqZ3AL/0XK9aVQ: folds
RwDoM55ZeQuI2ADyJhOb2Q collected $4 from pot
RwDoM55ZeQuI2ADyJhOb2Q: doesn't show hand
*** SUMMARY ***
Total pot $4 | Rake $0
Seat 1: 6hvg964TSqZ3AL/0XK9aVQ (big blind) folded before Flop
Seat 2: RwDoM55ZeQuI2ADyJhOb2Q (button) (small blind) collected ($4)



PokerStars Game #59938185912:  Hold'em No Limit ($1/$2) - 2009/07/01 0:09:00 ET
Table 'on4i1U1lCRmxsduFD3xiSg' 9-max Seat #7 is the button
Seat 1: BRHGptvmY2GKq4uuj7duDw ($310.60 in chips)
Seat 2: yZYrOeNDxQxkzpbgKX1bng ($64 in chips)
Seat 3: 5iPk5MyO3KVu18Y8XCYfFQ ($64.20 in chips)
Seat 4: Z3aYCZG/yXHYFjiWkGI5ug ($446.10 in chips)
Seat 5: QHxJjpVYwitg9krW6wZgJA ($203 in chips)
Seat 6: SB0tvOX0Kw61r2U851JFaA ($143.65 in chips)
Seat 7: xD4ElYxz6Ollzmam8BmMCw ($244.25 in chips)
Seat 8: cdC54j9fGGojcbzWB5PgzA ($200 in chips)
Seat 9: iMe5yhc+1BaiIPHet3NMrA ($203 in chips)
cdC54j9fGGojcbzWB5PgzA: posts small blind $1
iMe5yhc+1BaiIPHet3NMrA: posts big blind $2
*** HOLE CARDS ***
BRHGptvmY2GKq4uuj7duDw: raises $4 to $6
yZYrOeNDxQxkzpbgKX1bng: folds
5iPk5MyO3KVu18Y8XCYfFQ: folds
Z3aYCZG/yXHYFjiWkGI5ug: folds
QHxJjpVYwitg9krW6wZgJA: calls $6
SB0tvOX0Kw61r2U851JFaA: folds
xD4ElYxz6Ollzmam8BmMCw: folds
cdC54j9fGGojcbzWB5PgzA: folds
iMe5yhc+1BaiIPHet3NMrA: folds
*** FLOP *** [Qh 7s Jd]
BRHGptvmY2GKq4uuj7duDw: bets $10
QHxJjpVYwitg9krW6wZgJA: folds
BRHGptvmY2GKq4uuj7duDw collected $14.25 from pot
*** SUMMARY ***
Total pot $15 | Rake $0.75
Board [Qh 7s Jd]
Seat 1: BRHGptvmY2GKq4uuj7duDw collected ($14.25)
Seat 2: yZYrOeNDxQxkzpbgKX1bng folded before Flop (didn't bet)
Seat 3: 5iPk5MyO3KVu18Y8XCYfFQ folded before Flop (didn't bet)
Seat 4: Z3aYCZG/yXHYFjiWkGI5ug folded before Flop (didn't bet)
Seat 5: QHxJjpVYwitg9krW6wZgJA folded on the Flop
Seat 6: SB0tvOX0Kw61r2U851JFaA folded before Flop (didn't bet)
Seat 7: xD4ElYxz6Ollzmam8BmMCw (button) folded before Flop (didn't bet)
Seat 8: cdC54j9fGGojcbzWB5PgzA (small blind) folded before Flop
Seat 9: iMe5yhc+1BaiIPHet3NMrA (big blind) folded before Flop



PokerStars Game #59938187620:  Hold'em No Limit ($1/$2) - 2009/07/01 0:09:03 ET
Table 'eyAQSIlgc2o1Jxvbve4WGg' 9-max Seat #9 is the button
Seat 1: Q3uFdu6ztesjDFiqkagTRQ ($235 in chips)
Seat 3: TAfo4veNRaRlzDXMMYS3Jg ($40 in chips)
Seat 4: Lr5OlNr2kebm3oHSC54eJg ($119.65 in chips)
Seat 6: IikcENBHwoT7snSvBPSc7Q ($173.85 in chips)
Seat 7: QHxJjpVYwitg9krW6wZgJA ($200 in chips)
Seat 8: 5iPk5MyO3KVu18Y8XCYfFQ ($36 in chips)
Seat 9: Hc2itIxwbi1lwa+DAYYQGg ($46.85 in chips)
Q3uFdu6ztesjDFiqkagTRQ: posts small blind $1
TAfo4veNRaRlzDXMMYS3Jg: posts big blind $2
JnV3SM2D6dAFYyGZHHpvrg: sits out
*** HOLE CARDS ***
craizer leaves the table
Lr5OlNr2kebm3oHSC54eJg: folds
IikcENBHwoT7snSvBPSc7Q: raises $4 to $6
QHxJjpVYwitg9krW6wZgJA: folds
5iPk5MyO3KVu18Y8XCYfFQ: folds
Hc2itIxwbi1lwa+DAYYQGg: folds
Q3uFdu6ztesjDFiqkagTRQ: folds
TAfo4veNRaRlzDXMMYS3Jg: folds
IikcENBHwoT7snSvBPSc7Q collected $5 from pot
*** SUMMARY ***
Total pot $5 | Rake $0
Seat 1: Q3uFdu6ztesjDFiqkagTRQ (small blind) folded before Flop
Seat 3: TAfo4veNRaRlzDXMMYS3Jg (big blind) folded before Flop
Seat 4: Lr5OlNr2kebm3oHSC54eJg folded before Flop (didn't bet)
Seat 6: IikcENBHwoT7snSvBPSc7Q collected ($5)
Seat 7: QHxJjpVYwitg9krW6wZgJA folded before Flop (didn't bet)
Seat 8: 5iPk5MyO3KVu18Y8XCYfFQ folded before Flop (didn't bet)
Seat 9: Hc2itIxwbi1lwa+DAYYQGg (button) folded before Flop (didn't bet)



PokerStars Game #59938189846:  Hold'em No Limit ($1/$2) - 2009/07/01 0:09:06 ET
Table 'HewZCzVOYGmuLDKthTi5Yw' 6-max Seat #5 is the button
Seat 1: 353332 ($255.95 in chips)
Seat 2: X7GlkHF+lkbarCLuZ4Uf0w ($28 in chips)
Seat 3: WJxW31eStwT28R2X/L8F5A ($53.25 in chips)
Seat 4: yZgdnRylE65JbScQ7qCWgw ($29 in chips)
Seat 5: 513FcCI8jHyQy2VWoIQkMg ($362.50 in chips)
353332: posts small blind $1
X7GlkHF+lkbarCLuZ4Uf0w: posts big blind $2
*** HOLE CARDS ***
WJxW31eStwT28R2X/L8F5A: folds
yZgdnRylE65JbScQ7qCWgw: folds
513FcCI8jHyQy2VWoIQkMg: folds
353332: folds
X7GlkHF+lkbarCLuZ4Uf0w collected $2 from pot
X7GlkHF+lkbarCLuZ4Uf0w: doesn't show hand
*** SUMMARY ***
Total pot $2 | Rake $0
Seat 1: 353332 (small blind) folded before Flop
Seat 2: X7GlkHF+lkbarCLuZ4Uf0w (big blind) collected ($2)
Seat 3: WJxW31eStwT28R2X/L8F5A folded before Flop (didn't bet)
Seat 4: yZgdnRylE65JbScQ7qCWgw folded before Flop (didn't bet)
Seat 5: 513FcCI8jHyQy2VWoIQkMg (button) folded before Flop (didn't bet)



PokerStars Game #59938191480:  Hold'em No Limit ($1/$2) - 2009/07/01 0:09:08 ET
Table 'bJQ024BaYSBrW0sXpCZbNQ' 6-max Seat #3 is the button
Seat 1: yZgdnRylE65JbScQ7qCWgw ($31 in chips)
Seat 2: 1njbh8TKSUF6l4V1XwGdcg ($263 in chips)
Seat 3: vkfxu8f/jMYKUk6Ly4eujw ($214.60 in chips)
Seat 4: 9ni/OEXAqfc58zPQ0Tu9rQ ($270.60 in chips)
Seat 5: X7GlkHF+lkbarCLuZ4Uf0w ($38.15 in chips)
Seat 6: 9dpyyjDTCed6nV7JhaUUpw ($212.50 in chips)
9ni/OEXAqfc58zPQ0Tu9rQ: posts small blind $1
X7GlkHF+lkbarCLuZ4Uf0w: posts big blind $2
*** HOLE CARDS ***
9dpyyjDTCed6nV7JhaUUpw: folds
yZgdnRylE65JbScQ7qCWgw: folds
1njbh8TKSUF6l4V1XwGdcg: folds
vkfxu8f/jMYKUk6Ly4eujw: folds
9ni/OEXAqfc58zPQ0Tu9rQ: calls $1
X7GlkHF+lkbarCLuZ4Uf0w: raises $4 to $6
9ni/OEXAqfc58zPQ0Tu9rQ: folds
X7GlkHF+lkbarCLuZ4Uf0w collected $4 from pot
X7GlkHF+lkbarCLuZ4Uf0w: doesn't show hand
*** SUMMARY ***
Total pot $4 | Rake $0
Seat 1: yZgdnRylE65JbScQ7qCWgw folded before Flop (didn't bet)
Seat 2: 1njbh8TKSUF6l4V1XwGdcg folded before Flop (didn't bet)
Seat 3: vkfxu8f/jMYKUk6Ly4eujw (button) folded before Flop (didn't bet)
Seat 4: 9ni/OEXAqfc58zPQ0Tu9rQ (small blind) folded before Flop
Seat 5: X7GlkHF+lkbarCLuZ4Uf0w (big blind) collected ($4)
Seat 6: 9dpyyjDTCed6nV7JhaUUpw folded before Flop (didn't bet)



PokerStars Game #59938192636:  Hold'em No Limit ($1/$2) - 2009/07/01 0:09:10 ET
Table '3FGoiEOffWrbgTfsB3t7FA' 2-max Seat #1 is the button
Seat 1: e0oDWyrmgLpR6bROEqw1nQ ($387 in chips)
Seat 2: +sy/nlNI20yZraIjs4AALg ($216.85 in chips)
e0oDWyrmgLpR6bROEqw1nQ: posts small blind $1
+sy/nlNI20yZraIjs4AALg: posts big blind $2
*** HOLE CARDS ***
e0oDWyrmgLpR6bROEqw1nQ: raises $4 to $6
+sy/nlNI20yZraIjs4AALg: calls $4
*** FLOP *** [2d Qd 3c]
+sy/nlNI20yZraIjs4AALg: checks
e0oDWyrmgLpR6bROEqw1nQ: bets $8
+sy/nlNI20yZraIjs4AALg: calls $8
*** TURN *** [2d Qd 3c] [5h]
+sy/nlNI20yZraIjs4AALg: checks
e0oDWyrmgLpR6bROEqw1nQ: bets $18
+sy/nlNI20yZraIjs4AALg: folds
e0oDWyrmgLpR6bROEqw1nQ collected $27.50 from pot
*** SUMMARY ***
Total pot $28 | Rake $0.50
Board [2d Qd 3c 5h]
Seat 1: e0oDWyrmgLpR6bROEqw1nQ (button) (small blind) collected ($27.50)
Seat 2: +sy/nlNI20yZraIjs4AALg (big blind) folded on the Turn



PokerStars Game #59938193790:  Hold'em No Limit ($1/$2) - 2009/07/01 0:09:11 ET
Table 'pPQgcj9XT9CHBsbo1WTBug' 6-max Seat #1 is the button
Seat 1: DFVYDA6dKQy7R7mGIKogZA ($113.30 in chips)
Seat 2: X7GlkHF+lkbarCLuZ4Uf0w ($42 in chips)
Seat 3: vkfxu8f/jMYKUk6Ly4eujw ($193 in chips)
Seat 5: 4Cl43Q1TYQL8wn1NSCUkaw ($60.90 in chips)
Seat 6: yZgdnRylE65JbScQ7qCWgw ($35 in chips)
X7GlkHF+lkbarCLuZ4Uf0w: posts small blind $1
vkfxu8f/jMYKUk6Ly4eujw: posts big blind $2
*** HOLE CARDS ***
4Cl43Q1TYQL8wn1NSCUkaw: folds
yZgdnRylE65JbScQ7qCWgw: raises $6 to $8
DFVYDA6dKQy7R7mGIKogZA: raises $28 to $36
X7GlkHF+lkbarCLuZ4Uf0w: folds
vkfxu8f/jMYKUk6Ly4eujw: folds
yZgdnRylE65JbScQ7qCWgw: calls $27 and is all-in
*** FLOP *** [5c Qc Td]
*** TURN *** [5c Qc Td] [9h]
*** RIVER *** [5c Qc Td 9h] [Kh]
*** SHOW DOWN ***
yZgdnRylE65JbScQ7qCWgw: shows [Ad Ac] (a pair of Aces)
DFVYDA6dKQy7R7mGIKogZA: mucks hand
yZgdnRylE65JbScQ7qCWgw collected $71 from pot
*** SUMMARY ***
Total pot $73 | Rake $2
Board [5c Qc Td 9h Kh]
Seat 1: DFVYDA6dKQy7R7mGIKogZA (button) mucked
Seat 2: X7GlkHF+lkbarCLuZ4Uf0w (small blind) folded before Flop
Seat 3: vkfxu8f/jMYKUk6Ly4eujw (big blind) folded before Flop
Seat 5: 4Cl43Q1TYQL8wn1NSCUkaw folded before Flop (didn't bet)
Seat 6: yZgdnRylE65JbScQ7qCWgw showed [Ad Ac] and won ($71) with a pair of Aces



PokerStars Game #59938193402:  Hold'em No Limit ($1/$2) - 2009/07/01 0:09:11 ET
Table 'ZrKaj8fA5nb08RKhIpHkZA' 9-max Seat #7 is the button
Seat 1: Hc2itIxwbi1lwa+DAYYQGg ($37 in chips)
Seat 2: TAfo4veNRaRlzDXMMYS3Jg ($37 in chips)
Seat 3: GX1heJ+DSsvm7gzSPsYhhQ ($36 in chips)
Seat 5: YlSX2xwu8QMQReaxSAD8XA ($206.45 in chips)
Seat 6: Q3uFdu6ztesjDFiqkagTRQ ($200 in chips)
Seat 7: ztEPtIZdGv4TcxTUTzbY1w ($77.85 in chips)
Seat 8: tnv1uD25KOWgMmyKcuOVog ($285.25 in chips)
Seat 9: Z3aYCZG/yXHYFjiWkGI5ug ($262.25 in chips)
tnv1uD25KOWgMmyKcuOVog: posts small blind $1
Z3aYCZG/yXHYFjiWkGI5ug: posts big blind $2
*** HOLE CARDS ***
Hc2itIxwbi1lwa+DAYYQGg: folds
TAfo4veNRaRlzDXMMYS3Jg: folds
GX1heJ+DSsvm7gzSPsYhhQ: folds
YlSX2xwu8QMQReaxSAD8XA: calls $2
Q3uFdu6ztesjDFiqkagTRQ: folds
ztEPtIZdGv4TcxTUTzbY1w: folds
tnv1uD25KOWgMmyKcuOVog: calls $1
Z3aYCZG/yXHYFjiWkGI5ug: checks
*** FLOP *** [8d Ts 7d]
tnv1uD25KOWgMmyKcuOVog: bets $4
Z3aYCZG/yXHYFjiWkGI5ug: folds
YlSX2xwu8QMQReaxSAD8XA: folds
tnv1uD25KOWgMmyKcuOVog collected $5.70 from pot
*** SUMMARY ***
Total pot $6 | Rake $0.30
Board [8d Ts 7d]
Seat 1: Hc2itIxwbi1lwa+DAYYQGg folded before Flop (didn't bet)
Seat 2: TAfo4veNRaRlzDXMMYS3Jg folded before Flop (didn't bet)
Seat 3: GX1heJ+DSsvm7gzSPsYhhQ folded before Flop (didn't bet)
Seat 5: YlSX2xwu8QMQReaxSAD8XA folded on the Flop
Seat 6: Q3uFdu6ztesjDFiqkagTRQ folded before Flop (didn't bet)
Seat 7: ztEPtIZdGv4TcxTUTzbY1w (button) folded before Flop (didn't bet)
Seat 8: tnv1uD25KOWgMmyKcuOVog (small blind) collected ($5.70)
Seat 9: Z3aYCZG/yXHYFjiWkGI5ug (big blind) folded on the Flop



PokerStars Game #59938194154:  Hold'em No Limit ($1/$2) - 2009/07/01 0:09:12 ET
Table 'uJ9juaXXg9yIcSU8amxaXQ' 6-max Seat #1 is the button
Seat 1: HhIxv6mylwCAfv3sjJmq5g ($200 in chips)
Seat 2: DQlskgG4OtLpF2MVxLwf4A ($246.05 in chips)
Seat 3: zaogaltCDFVsIASEnrXs2w ($298.75 in chips)
Seat 4: 54yWzRRgS0oZ+S6LwZBxMQ ($28 in chips)
Seat 5: X7GlkHF+lkbarCLuZ4Uf0w ($52 in chips)
DQlskgG4OtLpF2MVxLwf4A: posts small blind $1
zaogaltCDFVsIASEnrXs2w: posts big blind $2
*** HOLE CARDS ***
54yWzRRgS0oZ+S6LwZBxMQ: folds
X7GlkHF+lkbarCLuZ4Uf0w: raises $2 to $4
HhIxv6mylwCAfv3sjJmq5g: folds
DQlskgG4OtLpF2MVxLwf4A: folds
zaogaltCDFVsIASEnrXs2w: calls $2
*** FLOP *** [8c 4h 5s]
zaogaltCDFVsIASEnrXs2w: checks
X7GlkHF+lkbarCLuZ4Uf0w: bets $4
zaogaltCDFVsIASEnrXs2w: folds
X7GlkHF+lkbarCLuZ4Uf0w collected $8.55 from pot
X7GlkHF+lkbarCLuZ4Uf0w: doesn't show hand
*** SUMMARY ***
Total pot $9 | Rake $0.45
Board [8c 4h 5s]
Seat 1: HhIxv6mylwCAfv3sjJmq5g (button) folded before Flop (didn't bet)
Seat 2: DQlskgG4OtLpF2MVxLwf4A (small blind) folded before Flop
Seat 3: zaogaltCDFVsIASEnrXs2w (big blind) folded on the Flop
Seat 4: 54yWzRRgS0oZ+S6LwZBxMQ folded before Flop (didn't bet)
Seat 5: X7GlkHF+lkbarCLuZ4Uf0w collected ($8.55)



PokerStars Game #59938194314:  Hold'em No Limit ($1/$2) - 2009/07/01 0:09:12 ET
Table 'NmY84NAf9Mh0ckAckHnh5g' 2-max Seat #1 is the button
Seat 1: 6hvg964TSqZ3AL/0XK9aVQ ($311 in chips)
Seat 2: RwDoM55ZeQuI2ADyJhOb2Q ($282.30 in chips)
6hvg964TSqZ3AL/0XK9aVQ: posts small blind $1
RwDoM55ZeQuI2ADyJhOb2Q: posts big blind $2
*** HOLE CARDS ***
6hvg964TSqZ3AL/0XK9aVQ: calls $1
RwDoM55ZeQuI2ADyJhOb2Q: raises $4 to $6
6hvg964TSqZ3AL/0XK9aVQ: calls $4
*** FLOP *** [Ac 7s Qh]
RwDoM55ZeQuI2ADyJhOb2Q: checks
6hvg964TSqZ3AL/0XK9aVQ: bets $6
RwDoM55ZeQuI2ADyJhOb2Q: calls $6
*** TURN *** [Ac 7s Qh] [3d]
RwDoM55ZeQuI2ADyJhOb2Q: checks
6hvg964TSqZ3AL/0XK9aVQ: bets $10
RwDoM55ZeQuI2ADyJhOb2Q: calls $10
*** RIVER *** [Ac 7s Qh 3d] [3c]
RwDoM55ZeQuI2ADyJhOb2Q: checks
6hvg964TSqZ3AL/0XK9aVQ: bets $24
RwDoM55ZeQuI2ADyJhOb2Q: calls $24
*** SHOW DOWN ***
6hvg964TSqZ3AL/0XK9aVQ: shows [As 9h] (two pair, Aces and Threes)
RwDoM55ZeQuI2ADyJhOb2Q: mucks hand
6hvg964TSqZ3AL/0XK9aVQ collected $91.50 from pot
*** SUMMARY ***
Total pot $92 | Rake $0.50
Board [Ac 7s Qh 3d 3c]
Seat 1: 6hvg964TSqZ3AL/0XK9aVQ (button) (small blind) showed [As 9h] and won ($91.50) with two pair, Aces and Threes
Seat 2: RwDoM55ZeQuI2ADyJhOb2Q (big blind) mucked



PokerStars Game #59938196470:  Hold'em No Limit ($1/$2) - 2009/07/01 0:09:15 ET
Table 'ztv6V3FN2bQ9nmJPPdx6nQ' 6-max Seat #4 is the button
Seat 1: ek1hig03QiyONDHXvgqteQ ($178.05 in chips)
Seat 2: 2lOU1DcvUZaMcxZ95XfzXw ($120 in chips)
Seat 4: vkfxu8f/jMYKUk6Ly4eujw ($339.70 in chips)
Seat 5: sTPOWERd9HWPCNrDBwsVjA ($205.95 in chips)
Seat 6: yZgdnRylE65JbScQ7qCWgw ($34 in chips)
sTPOWERd9HWPCNrDBwsVjA: posts small blind $1
yZgdnRylE65JbScQ7qCWgw: posts big blind $2
2lOU1DcvUZaMcxZ95XfzXw: posts big blind $2
*** HOLE CARDS ***
ek1hig03QiyONDHXvgqteQ: folds
2lOU1DcvUZaMcxZ95XfzXw: raises $4 to $6
vkfxu8f/jMYKUk6Ly4eujw: folds
sTPOWERd9HWPCNrDBwsVjA: folds
yZgdnRylE65JbScQ7qCWgw: folds
2lOU1DcvUZaMcxZ95XfzXw collected $5 from pot
*** SUMMARY ***
Total pot $5 | Rake $0
Seat 1: ek1hig03QiyONDHXvgqteQ folded before Flop (didn't bet)
Seat 2: 2lOU1DcvUZaMcxZ95XfzXw collected ($5)
Seat 4: vkfxu8f/jMYKUk6Ly4eujw (button) folded before Flop (didn't bet)
Seat 5: sTPOWERd9HWPCNrDBwsVjA (small blind) folded before Flop
Seat 6: yZgdnRylE65JbScQ7qCWgw (big blind) folded before Flop



PokerStars Game #59938197128:  Hold'em No Limit ($1/$2) - 2009/07/01 0:09:16 ET
Table 'qVXak+oTeDXMGbWa4sDU5Q' 9-max Seat #7 is the button
Seat 1: H6Z4+qu8gR0VUiPOijndVg ($250 in chips)
Seat 2: Hc2itIxwbi1lwa+DAYYQGg ($49 in chips)
Seat 3: oz9eCXGC7DdjQlL/nuWj1A ($105.85 in chips)
Seat 4: b0jO1SDhLedy1//CQlA8kw ($40 in chips)
Seat 6: Q3uFdu6ztesjDFiqkagTRQ ($200 in chips)
Seat 7: 5iPk5MyO3KVu18Y8XCYfFQ ($115 in chips)
Seat 8: 9pHZMviI9R8injxojGTnvw ($56.85 in chips)
Seat 9: IZ/2qsh1CIg9m5PWsMsLmA ($360.95 in chips)
9pHZMviI9R8injxojGTnvw: posts small blind $1
IZ/2qsh1CIg9m5PWsMsLmA: posts big blind $2
NqKRc5xvcye0d7F6VOF6MQ: sits out
*** HOLE CARDS ***
H6Z4+qu8gR0VUiPOijndVg: folds
Hc2itIxwbi1lwa+DAYYQGg: folds
oz9eCXGC7DdjQlL/nuWj1A: folds
b0jO1SDhLedy1//CQlA8kw: folds
Q3uFdu6ztesjDFiqkagTRQ: raises $4 to $6
5iPk5MyO3KVu18Y8XCYfFQ: folds
9pHZMviI9R8injxojGTnvw: calls $5
IZ/2qsh1CIg9m5PWsMsLmA: folds
*** FLOP *** [2c 5d Tc]
9pHZMviI9R8injxojGTnvw: checks
Q3uFdu6ztesjDFiqkagTRQ: checks
*** TURN *** [2c 5d Tc] [Qd]
9pHZMviI9R8injxojGTnvw: checks
Q3uFdu6ztesjDFiqkagTRQ: bets $10
9pHZMviI9R8injxojGTnvw: calls $10
*** RIVER *** [2c 5d Tc Qd] [Qs]
9pHZMviI9R8injxojGTnvw: checks
Q3uFdu6ztesjDFiqkagTRQ: bets $30
9pHZMviI9R8injxojGTnvw: calls $30
*** SHOW DOWN ***
Q3uFdu6ztesjDFiqkagTRQ: shows [9d Jh] (a pair of Queens)
9pHZMviI9R8injxojGTnvw: shows [4c 4h] (two pair, Queens and Fours)
9pHZMviI9R8injxojGTnvw collected $91 from pot
*** SUMMARY ***
Total pot $94 | Rake $3
Board [2c 5d Tc Qd Qs]
Seat 1: H6Z4+qu8gR0VUiPOijndVg folded before Flop (didn't bet)
Seat 2: Hc2itIxwbi1lwa+DAYYQGg folded before Flop (didn't bet)
Seat 3: oz9eCXGC7DdjQlL/nuWj1A folded before Flop (didn't bet)
Seat 4: b0jO1SDhLedy1//CQlA8kw folded before Flop (didn't bet)
Seat 6: Q3uFdu6ztesjDFiqkagTRQ showed [9d Jh] and lost with a pair of Queens
Seat 7: 5iPk5MyO3KVu18Y8XCYfFQ (button) folded before Flop (didn't bet)
Seat 8: 9pHZMviI9R8injxojGTnvw (small blind) showed [4c 4h] and won ($91) with two pair, Queens and Fours
Seat 9: IZ/2qsh1CIg9m5PWsMsLmA (big blind) folded before Flop



PokerStars Game #59938198310:  Hold'em No Limit ($1/$2) - 2009/07/01 0:09:18 ET
Table 'bIihwBANJSFqlHPPtset+w' 9-max Seat #9 is the button
Seat 1: jI3JDUGV63ccqtKgM3vMbw ($146.60 in chips)
Seat 2: lQYT23h5QCUVZAKxjOO39Q ($125.90 in chips)
Seat 3: acnZ0LD5jxKgWIHz+mpQ8Q ($217.40 in chips)
Seat 4: 7WWX5PClBdr/U44gUKBIEA ($266.65 in chips)
Seat 5: GX1heJ+DSsvm7gzSPsYhhQ ($40 in chips)
Seat 6: 5iPk5MyO3KVu18Y8XCYfFQ ($37 in chips)
Seat 7: 3q2/0oJr3Mcy1W5tcN61ug ($200 in chips)
Seat 8: iMe5yhc+1BaiIPHet3NMrA ($281.65 in chips)
Seat 9: rW/MyplHylMSBRaoRUzWrg ($34.55 in chips)
jI3JDUGV63ccqtKgM3vMbw: posts small blind $1
lQYT23h5QCUVZAKxjOO39Q: posts big blind $2
*** HOLE CARDS ***
acnZ0LD5jxKgWIHz+mpQ8Q: folds
7WWX5PClBdr/U44gUKBIEA: folds
GX1heJ+DSsvm7gzSPsYhhQ: folds
5iPk5MyO3KVu18Y8XCYfFQ: raises $2 to $4
3q2/0oJr3Mcy1W5tcN61ug: folds
iMe5yhc+1BaiIPHet3NMrA: folds
rW/MyplHylMSBRaoRUzWrg: folds
jI3JDUGV63ccqtKgM3vMbw: calls $3
lQYT23h5QCUVZAKxjOO39Q: calls $2
*** FLOP *** [Qs 3h Qd]
jI3JDUGV63ccqtKgM3vMbw: checks
lQYT23h5QCUVZAKxjOO39Q: checks
5iPk5MyO3KVu18Y8XCYfFQ: bets $6
jI3JDUGV63ccqtKgM3vMbw: folds
lQYT23h5QCUVZAKxjOO39Q: folds
5iPk5MyO3KVu18Y8XCYfFQ collected $11.40 from pot
*** SUMMARY ***
Total pot $12 | Rake $0.60
Board [Qs 3h Qd]
Seat 1: jI3JDUGV63ccqtKgM3vMbw (small blind) folded on the Flop
Seat 2: lQYT23h5QCUVZAKxjOO39Q (big blind) folded on the Flop
Seat 3: acnZ0LD5jxKgWIHz+mpQ8Q folded before Flop (didn't bet)
Seat 4: 7WWX5PClBdr/U44gUKBIEA folded before Flop (didn't bet)
Seat 5: GX1heJ+DSsvm7gzSPsYhhQ folded before Flop (didn't bet)
Seat 6: 5iPk5MyO3KVu18Y8XCYfFQ collected ($11.40)
Seat 7: 3q2/0oJr3Mcy1W5tcN61ug folded before Flop (didn't bet)
Seat 8: iMe5yhc+1BaiIPHet3NMrA folded before Flop (didn't bet)
Seat 9: rW/MyplHylMSBRaoRUzWrg (button) folded before Flop (didn't bet)



PokerStars Game #59938199044:  Hold'em No Limit ($1/$2) - 2009/07/01 0:09:19 ET
Table 'HewZCzVOYGmuLDKthTi5Yw' 6-max Seat #1 is the button
Seat 1: 353332 ($254.95 in chips)
Seat 2: X7GlkHF+lkbarCLuZ4Uf0w ($29 in chips)
Seat 3: WJxW31eStwT28R2X/L8F5A ($53.25 in chips)
Seat 4: yZgdnRylE65JbScQ7qCWgw ($29 in chips)
Seat 5: 513FcCI8jHyQy2VWoIQkMg ($362.50 in chips)
X7GlkHF+lkbarCLuZ4Uf0w: posts small blind $1
WJxW31eStwT28R2X/L8F5A: posts big blind $2
*** HOLE CARDS ***
yZgdnRylE65JbScQ7qCWgw: folds
513FcCI8jHyQy2VWoIQkMg: raises $3 to $5
353332: folds
X7GlkHF+lkbarCLuZ4Uf0w: folds
WJxW31eStwT28R2X/L8F5A: calls $3
*** FLOP *** [Ks Qc Qh]
WJxW31eStwT28R2X/L8F5A: checks
513FcCI8jHyQy2VWoIQkMg: bets $6
WJxW31eStwT28R2X/L8F5A: folds
513FcCI8jHyQy2VWoIQkMg collected $10.45 from pot
*** SUMMARY ***
Total pot $11 | Rake $0.55
Board [Ks Qc Qh]
Seat 1: 353332 (button) folded before Flop (didn't bet)
Seat 2: X7GlkHF+lkbarCLuZ4Uf0w (small blind) folded before Flop
Seat 3: WJxW31eStwT28R2X/L8F5A (big blind) folded on the Flop
Seat 4: yZgdnRylE65JbScQ7qCWgw folded before Flop (didn't bet)
Seat 5: 513FcCI8jHyQy2VWoIQkMg collected ($10.45)



PokerStars Game #59938199716:  Hold'em No Limit ($1/$2) - 2009/07/01 0:09:20 ET
Table 'jlrIxbrVIG+gjaUYT4za8g' 6-max Seat #4 is the button
Seat 1: ygTTt5ehT4aF86q1a8/R+w ($196.05 in chips)
Seat 2: N18PrNGQj43J7TJuQuu+tw ($139.80 in chips)
Seat 4: 8srN1dKQePlsv0GyTada+Q ($200 in chips)
Seat 5: F/075N6nU34Fn0zr6qD3aw ($164.55 in chips)
Seat 6: vkfxu8f/jMYKUk6Ly4eujw ($278.05 in chips)
F/075N6nU34Fn0zr6qD3aw: posts small blind $1
vkfxu8f/jMYKUk6Ly4eujw: posts big blind $2
54yWzRRgS0oZ+S6LwZBxMQ: sits out
*** HOLE CARDS ***
ygTTt5ehT4aF86q1a8/R+w: folds
N18PrNGQj43J7TJuQuu+tw: calls $2
8srN1dKQePlsv0GyTada+Q: folds
F/075N6nU34Fn0zr6qD3aw: calls $1
vkfxu8f/jMYKUk6Ly4eujw: checks
*** FLOP *** [Ac 6c 4s]
F/075N6nU34Fn0zr6qD3aw: checks
vkfxu8f/jMYKUk6Ly4eujw: checks
N18PrNGQj43J7TJuQuu+tw: checks
*** TURN *** [Ac 6c 4s] [2h]
F/075N6nU34Fn0zr6qD3aw: checks
vkfxu8f/jMYKUk6Ly4eujw: checks
N18PrNGQj43J7TJuQuu+tw: bets $2
F/075N6nU34Fn0zr6qD3aw: folds
vkfxu8f/jMYKUk6Ly4eujw: raises $9 to $11
N18PrNGQj43J7TJuQuu+tw: folds
vkfxu8f/jMYKUk6Ly4eujw collected $9.55 from pot
*** SUMMARY ***
Total pot $10 | Rake $0.45
Board [Ac 6c 4s 2h]
Seat 1: ygTTt5ehT4aF86q1a8/R+w folded before Flop (didn't bet)
Seat 2: N18PrNGQj43J7TJuQuu+tw folded on the Turn
Seat 4: 8srN1dKQePlsv0GyTada+Q (button) folded before Flop (didn't bet)
Seat 5: F/075N6nU34Fn0zr6qD3aw (small blind) folded on the Turn
Seat 6: vkfxu8f/jMYKUk6Ly4eujw (big blind) collected ($9.55)



PokerStars Game #59938199932:  Hold'em No Limit ($1/$2) - 2009/07/01 0:09:20 ET
Table 'YqGfR5eHfMeSjb9a+QU9rg' 9-max Seat #9 is the button
Seat 1: qCBuzVnLcBR29snMAHq9PA ($164.90 in chips)
Seat 2: W3Nqt1GWlTi9tXQXMNEvgw ($234.65 in chips)
Seat 3: /gll27k+xWYV7Fbki0lFDQ ($88.25 in chips)
Seat 4: QHxJjpVYwitg9krW6wZgJA ($200 in chips)
Seat 5: MOBMOMQRN/z+fiGXGnZojw ($173.10 in chips)
Seat 6: 5iPk5MyO3KVu18Y8XCYfFQ ($46 in chips)
Seat 7: b0jO1SDhLedy1//CQlA8kw ($39 in chips)
Seat 8: JnV3SM2D6dAFYyGZHHpvrg ($97 in chips)
Seat 9: RsrgM2l7PLbQ9xBbSi3IvQ ($116.55 in chips)
qCBuzVnLcBR29snMAHq9PA: posts small blind $1
W3Nqt1GWlTi9tXQXMNEvgw: posts big blind $2
*** HOLE CARDS ***
/gll27k+xWYV7Fbki0lFDQ: folds
QHxJjpVYwitg9krW6wZgJA: folds
MOBMOMQRN/z+fiGXGnZojw: folds
5iPk5MyO3KVu18Y8XCYfFQ: folds
b0jO1SDhLedy1//CQlA8kw: folds
JnV3SM2D6dAFYyGZHHpvrg: folds
RsrgM2l7PLbQ9xBbSi3IvQ: folds
qCBuzVnLcBR29snMAHq9PA: raises $4 to $6
W3Nqt1GWlTi9tXQXMNEvgw: calls $4
*** FLOP *** [5d 7c 6d]
qCBuzVnLcBR29snMAHq9PA: bets $8
W3Nqt1GWlTi9tXQXMNEvgw: calls $8
*** TURN *** [5d 7c 6d] [9c]
qCBuzVnLcBR29snMAHq9PA: checks
W3Nqt1GWlTi9tXQXMNEvgw: bets $14
RsrgM2l7PLbQ9xBbSi3IvQ is sitting out
qCBuzVnLcBR29snMAHq9PA: calls $14
*** RIVER *** [5d 7c 6d 9c] [2h]
qCBuzVnLcBR29snMAHq9PA: checks
W3Nqt1GWlTi9tXQXMNEvgw: bets $28
qCBuzVnLcBR29snMAHq9PA: folds
W3Nqt1GWlTi9tXQXMNEvgw collected $53.30 from pot
W3Nqt1GWlTi9tXQXMNEvgw: doesn't show hand
*** SUMMARY ***
Total pot $56 | Rake $2.70
Board [5d 7c 6d 9c 2h]
Seat 1: qCBuzVnLcBR29snMAHq9PA (small blind) folded on the River
Seat 2: W3Nqt1GWlTi9tXQXMNEvgw (big blind) collected ($53.30)
Seat 3: /gll27k+xWYV7Fbki0lFDQ folded before Flop (didn't bet)
Seat 4: QHxJjpVYwitg9krW6wZgJA folded before Flop (didn't bet)
Seat 5: MOBMOMQRN/z+fiGXGnZojw folded before Flop (didn't bet)
Seat 6: 5iPk5MyO3KVu18Y8XCYfFQ folded before Flop (didn't bet)
Seat 7: b0jO1SDhLedy1//CQlA8kw folded before Flop (didn't bet)
Seat 8: JnV3SM2D6dAFYyGZHHpvrg folded before Flop (didn't bet)
Seat 9: RsrgM2l7PLbQ9xBbSi3IvQ (button) folded before Flop (didn't bet)



PokerStars Game #59938200396:  Hold'em No Limit ($1/$2) - 2009/07/01 0:09:21 ET
Table 'gnHBqWll9O3fxG7Ojkz/ng' 9-max Seat #2 is the button
Seat 1: hpqdC/23wXosGOmzARr5NA ($156.30 in chips)
Seat 2: H6Z4+qu8gR0VUiPOijndVg ($200 in chips)
Seat 3: 5Q8U6iZbeO7xJSS4qvDP5g ($219.60 in chips)
Seat 4: n5XI5/7gN+gIubHFBH+mOw ($404.85 in chips)
Seat 5: GX1heJ+DSsvm7gzSPsYhhQ ($54.75 in chips)
Seat 6: 5iPk5MyO3KVu18Y8XCYfFQ ($43.45 in chips)
Seat 8: De9g+AYjo0DN6C/+iT/nsg ($244.05 in chips)
Seat 9: kVCeGJ4NY7Fb0W74j1mAqA ($206 in chips)
5Q8U6iZbeO7xJSS4qvDP5g: posts small blind $1
n5XI5/7gN+gIubHFBH+mOw: posts big blind $2
*** HOLE CARDS ***
GX1heJ+DSsvm7gzSPsYhhQ: raises $4 to $6
5iPk5MyO3KVu18Y8XCYfFQ: raises $37.45 to $43.45 and is all-in
De9g+AYjo0DN6C/+iT/nsg: folds
kVCeGJ4NY7Fb0W74j1mAqA: folds
hpqdC/23wXosGOmzARr5NA: folds
H6Z4+qu8gR0VUiPOijndVg: folds
5Q8U6iZbeO7xJSS4qvDP5g: folds
n5XI5/7gN+gIubHFBH+mOw: folds
GX1heJ+DSsvm7gzSPsYhhQ: folds
GX1heJ+DSsvm7gzSPsYhhQ leaves the table
5iPk5MyO3KVu18Y8XCYfFQ collected $15 from pot
5iPk5MyO3KVu18Y8XCYfFQ: doesn't show hand
*** SUMMARY ***
Total pot $15 | Rake $0
Seat 1: hpqdC/23wXosGOmzARr5NA folded before Flop (didn't bet)
Seat 2: H6Z4+qu8gR0VUiPOijndVg (button) folded before Flop (didn't bet)
Seat 3: 5Q8U6iZbeO7xJSS4qvDP5g (small blind) folded before Flop
Seat 4: n5XI5/7gN+gIubHFBH+mOw (big blind) folded before Flop
Seat 5: GX1heJ+DSsvm7gzSPsYhhQ folded before Flop
Seat 6: 5iPk5MyO3KVu18Y8XCYfFQ collected ($15)
Seat 8: De9g+AYjo0DN6C/+iT/nsg folded before Flop (didn't bet)
Seat 9: kVCeGJ4NY7Fb0W74j1mAqA folded before Flop (didn't bet)



PokerStars Game #59938202374:  Hold'em No Limit ($1/$2) - 2009/07/01 0:09:23 ET
Table 'l5lZHc5JRHEDt0Y2AVPq3g' 6-max Seat #6 is the button
Seat 1: gGPaCoSWW1HoKYaqfAPecg ($209.50 in chips)
Seat 2: my38j/MmtBd/8qVwmyCREA ($250.35 in chips)
Seat 3: yZgdnRylE65JbScQ7qCWgw ($40 in chips)
Seat 4: zNjJ/y4emmF+vzrCDd+ooA ($203.95 in chips)
Seat 5: 6fLdOUCRtX71xbVRhJEq8w ($200 in chips)
Seat 6: vkfxu8f/jMYKUk6Ly4eujw ($206.30 in chips)
gGPaCoSWW1HoKYaqfAPecg: posts small blind $1
my38j/MmtBd/8qVwmyCREA: posts big blind $2
*** HOLE CARDS ***
yZgdnRylE65JbScQ7qCWgw: folds
yZgdnRylE65JbScQ7qCWgw is sitting out
zNjJ/y4emmF+vzrCDd+ooA: folds
6fLdOUCRtX71xbVRhJEq8w: folds
vkfxu8f/jMYKUk6Ly4eujw: folds
gGPaCoSWW1HoKYaqfAPecg: folds
my38j/MmtBd/8qVwmyCREA collected $2 from pot
*** SUMMARY ***
Total pot $2 | Rake $0
Seat 1: gGPaCoSWW1HoKYaqfAPecg (small blind) folded before Flop
Seat 2: my38j/MmtBd/8qVwmyCREA (big blind) collected ($2)
Seat 3: yZgdnRylE65JbScQ7qCWgw folded before Flop (didn't bet)
Seat 4: zNjJ/y4emmF+vzrCDd+ooA folded before Flop (didn't bet)
Seat 5: 6fLdOUCRtX71xbVRhJEq8w folded before Flop (didn't bet)
Seat 6: vkfxu8f/jMYKUk6Ly4eujw (button) folded before Flop (didn't bet)



PokerStars Game #59938204102:  Hold'em No Limit ($1/$2) - 2009/07/01 0:09:26 ET
Table 'aSf77Sj8QEnzcc0WaxVD4Q' 6-max Seat #4 is the button
Seat 1: Q3uFdu6ztesjDFiqkagTRQ ($228.35 in chips)
Seat 2: vkfxu8f/jMYKUk6Ly4eujw ($195.75 in chips)
Seat 3: 9dpyyjDTCed6nV7JhaUUpw ($220.05 in chips)
Seat 4: 513FcCI8jHyQy2VWoIQkMg ($200 in chips)
Seat 5: InmkdI6G8TzSj9NhcCSyPg ($251 in chips)
Seat 6: vkoJRf3gidxY1pPi0AFWww ($329.85 in chips)
InmkdI6G8TzSj9NhcCSyPg: posts small blind $1
vkoJRf3gidxY1pPi0AFWww: posts big blind $2
*** HOLE CARDS ***
Q3uFdu6ztesjDFiqkagTRQ: folds
vkfxu8f/jMYKUk6Ly4eujw: folds
9dpyyjDTCed6nV7JhaUUpw: folds
513FcCI8jHyQy2VWoIQkMg: folds
InmkdI6G8TzSj9NhcCSyPg: folds
vkoJRf3gidxY1pPi0AFWww collected $2 from pot
vkoJRf3gidxY1pPi0AFWww: doesn't show hand
*** SUMMARY ***
Total pot $2 | Rake $0
Seat 1: Q3uFdu6ztesjDFiqkagTRQ folded before Flop (didn't bet)
Seat 2: vkfxu8f/jMYKUk6Ly4eujw folded before Flop (didn't bet)
Seat 3: 9dpyyjDTCed6nV7JhaUUpw folded before Flop (didn't bet)
Seat 4: 513FcCI8jHyQy2VWoIQkMg (button) folded before Flop (didn't bet)
Seat 5: InmkdI6G8TzSj9NhcCSyPg (small blind) folded before Flop
Seat 6: vkoJRf3gidxY1pPi0AFWww (big blind) collected ($2)



PokerStars Game #59938205044:  Hold'em No Limit ($1/$2) - 2009/07/01 0:09:27 ET
Table 'WCA60bDA8ecovUgFSIZkTQ' 9-max Seat #4 is the button
Seat 2: G1h8wamBcVJXtsKXZQ2EyA ($43.70 in chips)
Seat 3: 5iPk5MyO3KVu18Y8XCYfFQ ($37 in chips)
Seat 4: Q3uFdu6ztesjDFiqkagTRQ ($484.70 in chips)
Seat 5: Hc2itIxwbi1lwa+DAYYQGg ($307.30 in chips)
Seat 6: DOWQSOJ7GaX+ksfWTqPT5A ($273.05 in chips)
Seat 7: GX1heJ+DSsvm7gzSPsYhhQ ($44 in chips)
Seat 8: x+V1JgVDawsJTxKcxm7gxw ($96 in chips)
Seat 9: 3q2/0oJr3Mcy1W5tcN61ug ($298.20 in chips)
Hc2itIxwbi1lwa+DAYYQGg: posts small blind $1
DOWQSOJ7GaX+ksfWTqPT5A: posts big blind $2
CUZwDpLTQKhzarPe+JCLOQ: sits out
*** HOLE CARDS ***
GX1heJ+DSsvm7gzSPsYhhQ: folds
GX1heJ+DSsvm7gzSPsYhhQ leaves the table
x+V1JgVDawsJTxKcxm7gxw: calls $2
3q2/0oJr3Mcy1W5tcN61ug: folds
G1h8wamBcVJXtsKXZQ2EyA: calls $2
5iPk5MyO3KVu18Y8XCYfFQ: folds
Q3uFdu6ztesjDFiqkagTRQ: raises $12 to $14
Hc2itIxwbi1lwa+DAYYQGg: folds
DOWQSOJ7GaX+ksfWTqPT5A: calls $12
x+V1JgVDawsJTxKcxm7gxw: folds
G1h8wamBcVJXtsKXZQ2EyA: calls $12
*** FLOP *** [Ac 4c 2s]
DOWQSOJ7GaX+ksfWTqPT5A: checks
G1h8wamBcVJXtsKXZQ2EyA: bets $10
Q3uFdu6ztesjDFiqkagTRQ: folds
DOWQSOJ7GaX+ksfWTqPT5A: raises $20 to $30
G1h8wamBcVJXtsKXZQ2EyA: calls $19.70 and is all-in
*** TURN *** [Ac 4c 2s] [Th]
*** RIVER *** [Ac 4c 2s Th] [7h]
*** SHOW DOWN ***
DOWQSOJ7GaX+ksfWTqPT5A: shows [3h 2h] (a pair of Deuces)
G1h8wamBcVJXtsKXZQ2EyA: shows [8h Ad] (a pair of Aces)
G1h8wamBcVJXtsKXZQ2EyA collected $101.40 from pot
*** SUMMARY ***
Total pot $104.40 | Rake $3
Board [Ac 4c 2s Th 7h]
Seat 2: G1h8wamBcVJXtsKXZQ2EyA showed [8h Ad] and won ($101.40) with a pair of Aces
Seat 3: 5iPk5MyO3KVu18Y8XCYfFQ folded before Flop (didn't bet)
Seat 4: Q3uFdu6ztesjDFiqkagTRQ (button) folded on the Flop
Seat 5: Hc2itIxwbi1lwa+DAYYQGg (small blind) folded before Flop
Seat 6: DOWQSOJ7GaX+ksfWTqPT5A (big blind) showed [3h 2h] and lost with a pair of Deuces
Seat 7: GX1heJ+DSsvm7gzSPsYhhQ folded before Flop (didn't bet)
Seat 8: x+V1JgVDawsJTxKcxm7gxw folded before Flop
Seat 9: 3q2/0oJr3Mcy1W5tcN61ug folded before Flop (didn't bet)



PokerStars Game #59938207570:  Hold'em No Limit ($1/$2) - 2009/07/01 0:09:31 ET
Table 'SF49/KQm8T4taMp6kb+HXA' 9-max Seat #2 is the button
Seat 1: l1bCLGuFqeFRwUfPsiDu/g ($175.95 in chips)
Seat 2: 8Z3QifiM9eOd5EIJ25dXNg ($66.35 in chips)
Seat 3: L88dtdULfz5oGDSuo9/RvA ($41.80 in chips)
Seat 4: HffgoYm61KgkdMe/DYChIQ ($36 in chips)
Seat 5: Z3aYCZG/yXHYFjiWkGI5ug ($227.55 in chips)
Seat 6: M2ht6rIKOI/my9eh610Nlw ($247.45 in chips)
Seat 8: 5iPk5MyO3KVu18Y8XCYfFQ ($39 in chips)
Seat 9: O+jytCilwk7zItVCEavmtw ($140 in chips)
L88dtdULfz5oGDSuo9/RvA: posts small blind $1
HffgoYm61KgkdMe/DYChIQ: posts big blind $2
*** HOLE CARDS ***
n2VAbLaE5qgKr5mA4W6v4w has returned
Z3aYCZG/yXHYFjiWkGI5ug: folds
M2ht6rIKOI/my9eh610Nlw: folds
5iPk5MyO3KVu18Y8XCYfFQ: folds
O+jytCilwk7zItVCEavmtw: folds
l1bCLGuFqeFRwUfPsiDu/g: calls $2
8Z3QifiM9eOd5EIJ25dXNg: raises $6 to $8
L88dtdULfz5oGDSuo9/RvA: raises $10 to $18
HffgoYm61KgkdMe/DYChIQ: folds
l1bCLGuFqeFRwUfPsiDu/g: folds
8Z3QifiM9eOd5EIJ25dXNg: raises $48.35 to $66.35 and is all-in
L88dtdULfz5oGDSuo9/RvA: calls $23.80 and is all-in
*** FLOP *** [7h 6c 9c]
*** TURN *** [7h 6c 9c] [Ad]
*** RIVER *** [7h 6c 9c Ad] [3c]
*** SHOW DOWN ***
L88dtdULfz5oGDSuo9/RvA: shows [Ks Kd] (a pair of Kings)
8Z3QifiM9eOd5EIJ25dXNg: shows [As Js] (a pair of Aces)
8Z3QifiM9eOd5EIJ25dXNg collected $84.60 from pot
*** SUMMARY ***
Total pot $87.60 | Rake $3
Board [7h 6c 9c Ad 3c]
Seat 1: l1bCLGuFqeFRwUfPsiDu/g folded before Flop
Seat 2: 8Z3QifiM9eOd5EIJ25dXNg (button) showed [As Js] and won ($84.60) with a pair of Aces
Seat 3: L88dtdULfz5oGDSuo9/RvA (small blind) showed [Ks Kd] and lost with a pair of Kings
Seat 4: HffgoYm61KgkdMe/DYChIQ (big blind) folded before Flop
Seat 5: Z3aYCZG/yXHYFjiWkGI5ug folded before Flop (didn't bet)
Seat 6: M2ht6rIKOI/my9eh610Nlw folded before Flop (didn't bet)
Seat 8: 5iPk5MyO3KVu18Y8XCYfFQ folded before Flop (didn't bet)
Seat 9: O+jytCilwk7zItVCEavmtw folded before Flop (didn't bet)



PokerStars Game #59938210074:  Hold'em No Limit ($1/$2) - 2009/07/01 0:09:34 ET
Table 'ztv6V3FN2bQ9nmJPPdx6nQ' 6-max Seat #5 is the button
Seat 1: ek1hig03QiyONDHXvgqteQ ($178.05 in chips)
Seat 2: 2lOU1DcvUZaMcxZ95XfzXw ($123 in chips)
Seat 4: vkfxu8f/jMYKUk6Ly4eujw ($339.70 in chips)
Seat 5: sTPOWERd9HWPCNrDBwsVjA ($204.95 in chips)
Seat 6: yZgdnRylE65JbScQ7qCWgw ($32 in chips)
yZgdnRylE65JbScQ7qCWgw: posts small blind $1
ek1hig03QiyONDHXvgqteQ: posts big blind $2
*** HOLE CARDS ***
2lOU1DcvUZaMcxZ95XfzXw: folds
vkfxu8f/jMYKUk6Ly4eujw: raises $4 to $6
sTPOWERd9HWPCNrDBwsVjA: folds
yZgdnRylE65JbScQ7qCWgw: folds
ek1hig03QiyONDHXvgqteQ: calls $4
*** FLOP *** [Ts 5s 8d]
ek1hig03QiyONDHXvgqteQ: checks
vkfxu8f/jMYKUk6Ly4eujw: bets $8
ek1hig03QiyONDHXvgqteQ: calls $8
*** TURN *** [Ts 5s 8d] [8h]
ek1hig03QiyONDHXvgqteQ: checks
vkfxu8f/jMYKUk6Ly4eujw: checks
*** RIVER *** [Ts 5s 8d 8h] [Qh]
ek1hig03QiyONDHXvgqteQ: bets $18
vkfxu8f/jMYKUk6Ly4eujw: folds
ek1hig03QiyONDHXvgqteQ collected $27.60 from pot
*** SUMMARY ***
Total pot $29 | Rake $1.40
Board [Ts 5s 8d 8h Qh]
Seat 1: ek1hig03QiyONDHXvgqteQ (big blind) collected ($27.60)
Seat 2: 2lOU1DcvUZaMcxZ95XfzXw folded before Flop (didn't bet)
Seat 4: vkfxu8f/jMYKUk6Ly4eujw folded on the River
Seat 5: sTPOWERd9HWPCNrDBwsVjA (button) folded before Flop (didn't bet)
Seat 6: yZgdnRylE65JbScQ7qCWgw (small blind) folded before Flop



PokerStars Game #59938210144:  Hold'em No Limit ($1/$2) - 2009/07/01 0:09:34 ET
Table 'eyAQSIlgc2o1Jxvbve4WGg' 9-max Seat #1 is the button
Seat 1: Q3uFdu6ztesjDFiqkagTRQ ($234 in chips)
Seat 3: TAfo4veNRaRlzDXMMYS3Jg ($38 in chips)
Seat 5: JnV3SM2D6dAFYyGZHHpvrg ($100 in chips)
Seat 6: IikcENBHwoT7snSvBPSc7Q ($176.85 in chips)
Seat 7: QHxJjpVYwitg9krW6wZgJA ($200 in chips)
Seat 8: 5iPk5MyO3KVu18Y8XCYfFQ ($36 in chips)
Seat 9: Hc2itIxwbi1lwa+DAYYQGg ($46.85 in chips)
TAfo4veNRaRlzDXMMYS3Jg: posts small blind $1
Lr5OlNr2kebm3oHSC54eJg: is sitting out
JnV3SM2D6dAFYyGZHHpvrg: posts big blind $2
*** HOLE CARDS ***
IikcENBHwoT7snSvBPSc7Q: calls $2
QHxJjpVYwitg9krW6wZgJA: folds
5iPk5MyO3KVu18Y8XCYfFQ: folds
Hc2itIxwbi1lwa+DAYYQGg: folds
Q3uFdu6ztesjDFiqkagTRQ: folds
TAfo4veNRaRlzDXMMYS3Jg: folds
JnV3SM2D6dAFYyGZHHpvrg: checks
*** FLOP *** [4s Kh Js]
JnV3SM2D6dAFYyGZHHpvrg: checks
IikcENBHwoT7snSvBPSc7Q: bets $6
JnV3SM2D6dAFYyGZHHpvrg: folds
IikcENBHwoT7snSvBPSc7Q collected $4.75 from pot
Lr5OlNr2kebm3oHSC54eJg leaves the table
*** SUMMARY ***
Total pot $5 | Rake $0.25
Board [4s Kh Js]
Seat 1: Q3uFdu6ztesjDFiqkagTRQ (button) folded before Flop (didn't bet)
Seat 3: TAfo4veNRaRlzDXMMYS3Jg (small blind) folded before Flop
Seat 5: JnV3SM2D6dAFYyGZHHpvrg (big blind) folded on the Flop
Seat 6: IikcENBHwoT7snSvBPSc7Q collected ($4.75)
Seat 7: QHxJjpVYwitg9krW6wZgJA folded before Flop (didn't bet)
Seat 8: 5iPk5MyO3KVu18Y8XCYfFQ folded before Flop (didn't bet)
Seat 9: Hc2itIxwbi1lwa+DAYYQGg folded before Flop (didn't bet)



PokerStars Game #59938212444:  Hold'em No Limit ($1/$2) - 2009/07/01 0:09:37 ET
Table 'CFkQcfWjKccZaZDf71FK+w' 6-max Seat #1 is the button
Seat 1: X7GlkHF+lkbarCLuZ4Uf0w ($31 in chips)
Seat 2: yZgdnRylE65JbScQ7qCWgw ($41 in chips)
Seat 5: 1njbh8TKSUF6l4V1XwGdcg ($235 in chips)
Seat 6: ORVqY3rf9X6ANA/8s+On2Q ($34 in chips)
yZgdnRylE65JbScQ7qCWgw: posts small blind $1
ygTTt5ehT4aF86q1a8/R+w: is sitting out
1njbh8TKSUF6l4V1XwGdcg: posts big blind $2
*** HOLE CARDS ***
ygTTt5ehT4aF86q1a8/R+w leaves the table
ORVqY3rf9X6ANA/8s+On2Q: folds
X7GlkHF+lkbarCLuZ4Uf0w: raises $2 to $4
unluckySOB7 joins the table at seat #3
yZgdnRylE65JbScQ7qCWgw: raises $37 to $41 and is all-in
unluckySOB7 leaves the table
1njbh8TKSUF6l4V1XwGdcg: folds
X7GlkHF+lkbarCLuZ4Uf0w: folds
yZgdnRylE65JbScQ7qCWgw collected $10 from pot
*** SUMMARY ***
Total pot $10 | Rake $0
Seat 1: X7GlkHF+lkbarCLuZ4Uf0w (button) folded before Flop
Seat 2: yZgdnRylE65JbScQ7qCWgw (small blind) collected ($10)
Seat 5: 1njbh8TKSUF6l4V1XwGdcg (big blind) folded before Flop
Seat 6: ORVqY3rf9X6ANA/8s+On2Q folded before Flop (didn't bet)



PokerStars Game #59938213290:  Hold'em No Limit ($1/$2) - 2009/07/01 0:09:39 ET
Table 'bJQ024BaYSBrW0sXpCZbNQ' 6-max Seat #4 is the button
Seat 1: yZgdnRylE65JbScQ7qCWgw ($31 in chips)
Seat 2: 1njbh8TKSUF6l4V1XwGdcg ($263 in chips)
Seat 3: vkfxu8f/jMYKUk6Ly4eujw ($214.60 in chips)
Seat 4: 9ni/OEXAqfc58zPQ0Tu9rQ ($268.60 in chips)
Seat 5: X7GlkHF+lkbarCLuZ4Uf0w ($40.15 in chips)
Seat 6: 9dpyyjDTCed6nV7JhaUUpw ($212.50 in chips)
X7GlkHF+lkbarCLuZ4Uf0w: posts small blind $1
9dpyyjDTCed6nV7JhaUUpw: posts big blind $2
*** HOLE CARDS ***
yZgdnRylE65JbScQ7qCWgw: folds
1njbh8TKSUF6l4V1XwGdcg: folds
vkfxu8f/jMYKUk6Ly4eujw: folds
9ni/OEXAqfc58zPQ0Tu9rQ: folds
X7GlkHF+lkbarCLuZ4Uf0w: raises $3 to $5
9dpyyjDTCed6nV7JhaUUpw: folds
X7GlkHF+lkbarCLuZ4Uf0w collected $4 from pot
X7GlkHF+lkbarCLuZ4Uf0w: doesn't show hand
*** SUMMARY ***
Total pot $4 | Rake $0
Seat 1: yZgdnRylE65JbScQ7qCWgw folded before Flop (didn't bet)
Seat 2: 1njbh8TKSUF6l4V1XwGdcg folded before Flop (didn't bet)
Seat 3: vkfxu8f/jMYKUk6Ly4eujw folded before Flop (didn't bet)
Seat 4: 9ni/OEXAqfc58zPQ0Tu9rQ (button) folded before Flop (didn't bet)
Seat 5: X7GlkHF+lkbarCLuZ4Uf0w (small blind) collected ($4)
Seat 6: 9dpyyjDTCed6nV7JhaUUpw (big blind) folded before Flop



PokerStars Game #59938214186:  Hold'em No Limit ($1/$2) - 2009/07/01 0:09:40 ET
Table 'uJ9juaXXg9yIcSU8amxaXQ' 6-max Seat #2 is the button
Seat 1: HhIxv6mylwCAfv3sjJmq5g ($200 in chips)
Seat 2: DQlskgG4OtLpF2MVxLwf4A ($245.05 in chips)
Seat 3: zaogaltCDFVsIASEnrXs2w ($294.75 in chips)
Seat 4: 54yWzRRgS0oZ+S6LwZBxMQ ($28 in chips)
Seat 5: X7GlkHF+lkbarCLuZ4Uf0w ($56.55 in chips)
zaogaltCDFVsIASEnrXs2w: posts small blind $1
54yWzRRgS0oZ+S6LwZBxMQ: posts big blind $2
*** HOLE CARDS ***
X7GlkHF+lkbarCLuZ4Uf0w: folds
HhIxv6mylwCAfv3sjJmq5g: folds
DQlskgG4OtLpF2MVxLwf4A: folds
zaogaltCDFVsIASEnrXs2w: folds
54yWzRRgS0oZ+S6LwZBxMQ collected $2 from pot
54yWzRRgS0oZ+S6LwZBxMQ: doesn't show hand
*** SUMMARY ***
Total pot $2 | Rake $0
Seat 1: HhIxv6mylwCAfv3sjJmq5g folded before Flop (didn't bet)
Seat 2: DQlskgG4OtLpF2MVxLwf4A (button) folded before Flop (didn't bet)
Seat 3: zaogaltCDFVsIASEnrXs2w (small blind) folded before Flop
Seat 4: 54yWzRRgS0oZ+S6LwZBxMQ (big blind) collected ($2)
Seat 5: X7GlkHF+lkbarCLuZ4Uf0w folded before Flop (didn't bet)



PokerStars Game #59938214534:  Hold'em No Limit ($1/$2) - 2009/07/01 0:09:40 ET
Table 'ZrKaj8fA5nb08RKhIpHkZA' 9-max Seat #8 is the button
Seat 1: Hc2itIxwbi1lwa+DAYYQGg ($37 in chips)
Seat 2: TAfo4veNRaRlzDXMMYS3Jg ($37 in chips)
Seat 3: GX1heJ+DSsvm7gzSPsYhhQ ($36 in chips)
Seat 5: YlSX2xwu8QMQReaxSAD8XA ($204.45 in chips)
Seat 6: Q3uFdu6ztesjDFiqkagTRQ ($200 in chips)
Seat 7: ztEPtIZdGv4TcxTUTzbY1w ($77.85 in chips)
Seat 8: tnv1uD25KOWgMmyKcuOVog ($288.95 in chips)
Seat 9: Z3aYCZG/yXHYFjiWkGI5ug ($260.25 in chips)
Z3aYCZG/yXHYFjiWkGI5ug: posts small blind $1
Hc2itIxwbi1lwa+DAYYQGg: posts big blind $2
*** HOLE CARDS ***
TAfo4veNRaRlzDXMMYS3Jg: folds
GX1heJ+DSsvm7gzSPsYhhQ: folds
YlSX2xwu8QMQReaxSAD8XA: folds
Q3uFdu6ztesjDFiqkagTRQ: folds
ztEPtIZdGv4TcxTUTzbY1w: folds
tnv1uD25KOWgMmyKcuOVog: raises $4 to $6
Z3aYCZG/yXHYFjiWkGI5ug: folds
Hc2itIxwbi1lwa+DAYYQGg: folds
tnv1uD25KOWgMmyKcuOVog collected $5 from pot
*** SUMMARY ***
Total pot $5 | Rake $0
Seat 1: Hc2itIxwbi1lwa+DAYYQGg (big blind) folded before Flop
Seat 2: TAfo4veNRaRlzDXMMYS3Jg folded before Flop (didn't bet)
Seat 3: GX1heJ+DSsvm7gzSPsYhhQ folded before Flop (didn't bet)
Seat 5: YlSX2xwu8QMQReaxSAD8XA folded before Flop (didn't bet)
Seat 6: Q3uFdu6ztesjDFiqkagTRQ folded before Flop (didn't bet)
Seat 7: ztEPtIZdGv4TcxTUTzbY1w folded before Flop (didn't bet)
Seat 8: tnv1uD25KOWgMmyKcuOVog (button) collected ($5)
Seat 9: Z3aYCZG/yXHYFjiWkGI5ug (small blind) folded before Flop



PokerStars Game #59938215298:  Hold'em No Limit ($1/$2) - 2009/07/01 0:09:41 ET
Table 'on4i1U1lCRmxsduFD3xiSg' 9-max Seat #8 is the button
Seat 2: yZYrOeNDxQxkzpbgKX1bng ($64 in chips)
Seat 3: 5iPk5MyO3KVu18Y8XCYfFQ ($64.20 in chips)
Seat 4: Z3aYCZG/yXHYFjiWkGI5ug ($446.10 in chips)
Seat 5: QHxJjpVYwitg9krW6wZgJA ($200 in chips)
Seat 6: SB0tvOX0Kw61r2U851JFaA ($200 in chips)
Seat 7: xD4ElYxz6Ollzmam8BmMCw ($244.25 in chips)
Seat 8: cdC54j9fGGojcbzWB5PgzA ($200 in chips)
Seat 9: iMe5yhc+1BaiIPHet3NMrA ($201 in chips)
iMe5yhc+1BaiIPHet3NMrA: posts small blind $1
BRHGptvmY2GKq4uuj7duDw: is sitting out
yZYrOeNDxQxkzpbgKX1bng: posts big blind $2
*** HOLE CARDS ***
BRHGptvmY2GKq4uuj7duDw leaves the table
5iPk5MyO3KVu18Y8XCYfFQ: folds
Z3aYCZG/yXHYFjiWkGI5ug: folds
QHxJjpVYwitg9krW6wZgJA: folds
SB0tvOX0Kw61r2U851JFaA: folds
xD4ElYxz6Ollzmam8BmMCw: folds
cdC54j9fGGojcbzWB5PgzA: folds
iMe5yhc+1BaiIPHet3NMrA: calls $1
yZYrOeNDxQxkzpbgKX1bng: checks
*** FLOP *** [4d Th Tc]
iMe5yhc+1BaiIPHet3NMrA: checks
yZYrOeNDxQxkzpbgKX1bng: checks
*** TURN *** [4d Th Tc] [Kh]
iMe5yhc+1BaiIPHet3NMrA: bets $2
yZYrOeNDxQxkzpbgKX1bng: calls $2
*** RIVER *** [4d Th Tc Kh] [5s]
iMe5yhc+1BaiIPHet3NMrA: checks
yZYrOeNDxQxkzpbgKX1bng: checks
*** SHOW DOWN ***
iMe5yhc+1BaiIPHet3NMrA: shows [5c Qc] (two pair, Tens and Fives)
yZYrOeNDxQxkzpbgKX1bng: shows [Ks 9c] (two pair, Kings and Tens)
yZYrOeNDxQxkzpbgKX1bng collected $7.65 from pot
*** SUMMARY ***
Total pot $8 | Rake $0.35
Board [4d Th Tc Kh 5s]
Seat 2: yZYrOeNDxQxkzpbgKX1bng (big blind) showed [Ks 9c] and won ($7.65) with two pair, Kings and Tens
Seat 3: 5iPk5MyO3KVu18Y8XCYfFQ folded before Flop (didn't bet)
Seat 4: Z3aYCZG/yXHYFjiWkGI5ug folded before Flop (didn't bet)
Seat 5: QHxJjpVYwitg9krW6wZgJA folded before Flop (didn't bet)
Seat 6: SB0tvOX0Kw61r2U851JFaA folded before Flop (didn't bet)
Seat 7: xD4ElYxz6Ollzmam8BmMCw folded before Flop (didn't bet)
Seat 8: cdC54j9fGGojcbzWB5PgzA (button) folded before Flop (didn't bet)
Seat 9: iMe5yhc+1BaiIPHet3NMrA (small blind) showed [5c Qc] and lost with two pair, Tens and Fives



PokerStars Game #59938216450:  Hold'em No Limit ($1/$2) - 2009/07/01 0:09:43 ET
Table 'LL4bDFyhj5hsMpzaDugJZg' 6-max Seat #6 is the button
Seat 1: IBW9lyGsaRmfcbyA/qFfEw ($68.20 in chips)
Seat 2: L3l+A4pJhOAD6HVVFXvVBw ($289.15 in chips)
Seat 3: gGPaCoSWW1HoKYaqfAPecg ($205 in chips)
Seat 4: 8srN1dKQePlsv0GyTada+Q ($287.75 in chips)
Seat 5: HgX0VeqE/dzSXd5BpntRBw ($203 in chips)
Seat 6: yZgdnRylE65JbScQ7qCWgw ($37 in chips)
IBW9lyGsaRmfcbyA/qFfEw: posts small blind $1
L3l+A4pJhOAD6HVVFXvVBw: posts big blind $2
*** HOLE CARDS ***
gGPaCoSWW1HoKYaqfAPecg: folds
8srN1dKQePlsv0GyTada+Q: folds
HgX0VeqE/dzSXd5BpntRBw: folds
yZgdnRylE65JbScQ7qCWgw: folds
IBW9lyGsaRmfcbyA/qFfEw: folds
L3l+A4pJhOAD6HVVFXvVBw collected $2 from pot
*** SUMMARY ***
Total pot $2 | Rake $0
Seat 1: IBW9lyGsaRmfcbyA/qFfEw (small blind) folded before Flop
Seat 2: L3l+A4pJhOAD6HVVFXvVBw (big blind) collected ($2)
Seat 3: gGPaCoSWW1HoKYaqfAPecg folded before Flop (didn't bet)
Seat 4: 8srN1dKQePlsv0GyTada+Q folded before Flop (didn't bet)
Seat 5: HgX0VeqE/dzSXd5BpntRBw folded before Flop (didn't bet)
Seat 6: yZgdnRylE65JbScQ7qCWgw (button) folded before Flop (didn't bet)



PokerStars Game #59938217782:  Hold'em No Limit ($1/$2) - 2009/07/01 0:09:45 ET
Table 'l5lZHc5JRHEDt0Y2AVPq3g' 6-max Seat #1 is the button
Seat 1: gGPaCoSWW1HoKYaqfAPecg ($208.50 in chips)
Seat 2: my38j/MmtBd/8qVwmyCREA ($251.35 in chips)
Seat 4: zNjJ/y4emmF+vzrCDd+ooA ($203.95 in chips)
Seat 5: 6fLdOUCRtX71xbVRhJEq8w ($200 in chips)
Seat 6: vkfxu8f/jMYKUk6Ly4eujw ($206.30 in chips)
my38j/MmtBd/8qVwmyCREA: posts small blind $1
zNjJ/y4emmF+vzrCDd+ooA: posts big blind $2
*** HOLE CARDS ***
6fLdOUCRtX71xbVRhJEq8w: folds
vkfxu8f/jMYKUk6Ly4eujw: folds
gGPaCoSWW1HoKYaqfAPecg: raises $5 to $7
my38j/MmtBd/8qVwmyCREA: folds
zNjJ/y4emmF+vzrCDd+ooA: folds
gGPaCoSWW1HoKYaqfAPecg collected $5 from pot
gGPaCoSWW1HoKYaqfAPecg: doesn't show hand
*** SUMMARY ***
Total pot $5 | Rake $0
Seat 1: gGPaCoSWW1HoKYaqfAPecg (button) collected ($5)
Seat 2: my38j/MmtBd/8qVwmyCREA (small blind) folded before Flop
Seat 4: zNjJ/y4emmF+vzrCDd+ooA (big blind) folded before Flop
Seat 5: 6fLdOUCRtX71xbVRhJEq8w folded before Flop (didn't bet)
Seat 6: vkfxu8f/jMYKUk6Ly4eujw folded before Flop (didn't bet)



PokerStars Game #59938220796:  Hold'em No Limit ($1/$2) - 2009/07/01 0:09:49 ET
Table 'aSf77Sj8QEnzcc0WaxVD4Q' 6-max Seat #5 is the button
Seat 1: Q3uFdu6ztesjDFiqkagTRQ ($228.35 in chips)
Seat 2: vkfxu8f/jMYKUk6Ly4eujw ($195.75 in chips)
Seat 3: 9dpyyjDTCed6nV7JhaUUpw ($220.05 in chips)
Seat 4: 513FcCI8jHyQy2VWoIQkMg ($200 in chips)
Seat 5: InmkdI6G8TzSj9NhcCSyPg ($250 in chips)
Seat 6: vkoJRf3gidxY1pPi0AFWww ($330.85 in chips)
vkoJRf3gidxY1pPi0AFWww: posts small blind $1
Q3uFdu6ztesjDFiqkagTRQ: posts big blind $2
*** HOLE CARDS ***
vkfxu8f/jMYKUk6Ly4eujw: folds
9dpyyjDTCed6nV7JhaUUpw: raises $4 to $6
513FcCI8jHyQy2VWoIQkMg: folds
InmkdI6G8TzSj9NhcCSyPg: folds
vkoJRf3gidxY1pPi0AFWww: folds
Q3uFdu6ztesjDFiqkagTRQ: folds
9dpyyjDTCed6nV7JhaUUpw collected $5 from pot
9dpyyjDTCed6nV7JhaUUpw: doesn't show hand
*** SUMMARY ***
Total pot $5 | Rake $0
Seat 1: Q3uFdu6ztesjDFiqkagTRQ (big blind) folded before Flop
Seat 2: vkfxu8f/jMYKUk6Ly4eujw folded before Flop (didn't bet)
Seat 3: 9dpyyjDTCed6nV7JhaUUpw collected ($5)
Seat 4: 513FcCI8jHyQy2VWoIQkMg folded before Flop (didn't bet)
Seat 5: InmkdI6G8TzSj9NhcCSyPg (button) folded before Flop (didn't bet)
Seat 6: vkoJRf3gidxY1pPi0AFWww (small blind) folded before Flop



PokerStars Game #59938220240:  Hold'em No Limit ($1/$2) - 2009/07/01 0:09:49 ET
Table 'NmY84NAf9Mh0ckAckHnh5g' 2-max Seat #2 is the button
Seat 1: 6hvg964TSqZ3AL/0XK9aVQ ($356.50 in chips)
Seat 2: RwDoM55ZeQuI2ADyJhOb2Q ($236.30 in chips)
RwDoM55ZeQuI2ADyJhOb2Q: posts small blind $1
6hvg964TSqZ3AL/0XK9aVQ: posts big blind $2
*** HOLE CARDS ***
RwDoM55ZeQuI2ADyJhOb2Q: raises $4 to $6
6hvg964TSqZ3AL/0XK9aVQ: calls $4
*** FLOP *** [3s 8s Tc]
6hvg964TSqZ3AL/0XK9aVQ: checks
RwDoM55ZeQuI2ADyJhOb2Q: bets $8
6hvg964TSqZ3AL/0XK9aVQ: calls $8
*** TURN *** [3s 8s Tc] [4c]
6hvg964TSqZ3AL/0XK9aVQ: checks
RwDoM55ZeQuI2ADyJhOb2Q: bets $12
6hvg964TSqZ3AL/0XK9aVQ: folds
RwDoM55ZeQuI2ADyJhOb2Q collected $27.50 from pot
RwDoM55ZeQuI2ADyJhOb2Q: doesn't show hand
*** SUMMARY ***
Total pot $28 | Rake $0.50
Board [3s 8s Tc 4c]
Seat 1: 6hvg964TSqZ3AL/0XK9aVQ (big blind) folded on the Turn
Seat 2: RwDoM55ZeQuI2ADyJhOb2Q (button) (small blind) collected ($27.50)



PokerStars Game #59938224168:  Hold'em No Limit ($1/$2) - 2009/07/01 0:09:54 ET
Table '3FGoiEOffWrbgTfsB3t7FA' 2-max Seat #2 is the button
Seat 1: e0oDWyrmgLpR6bROEqw1nQ ($400.50 in chips)
Seat 2: +sy/nlNI20yZraIjs4AALg ($202.85 in chips)
+sy/nlNI20yZraIjs4AALg: posts small blind $1
e0oDWyrmgLpR6bROEqw1nQ: posts big blind $2
*** HOLE CARDS ***
+sy/nlNI20yZraIjs4AALg: calls $1
e0oDWyrmgLpR6bROEqw1nQ: checks
*** FLOP *** [Td Ks 2c]
e0oDWyrmgLpR6bROEqw1nQ: checks
+sy/nlNI20yZraIjs4AALg: bets $4
e0oDWyrmgLpR6bROEqw1nQ: folds
+sy/nlNI20yZraIjs4AALg collected $3.80 from pot
*** SUMMARY ***
Total pot $4 | Rake $0.20
Board [Td Ks 2c]
Seat 1: e0oDWyrmgLpR6bROEqw1nQ (big blind) folded on the Flop
Seat 2: +sy/nlNI20yZraIjs4AALg (button) (small blind) collected ($3.80)



PokerStars Game #59938224594:  Hold'em No Limit ($1/$2) - 2009/07/01 0:09:55 ET
Table 'srul5UFZXTEccVV5fpY91g' 9-max Seat #3 is the button
Seat 1: lfD8cBv31A/pio3pXJbPjA ($195.20 in chips)
Seat 2: tJYod1SLp2AcWPL/3hZ7ug ($111.20 in chips)
Seat 3: weUZ8S7tgbaeIpzi1gBNxQ ($35 in chips)
Seat 4: GG5lTuGt3+kwNYSbqeB6yw ($92.85 in chips)
Seat 5: 5iPk5MyO3KVu18Y8XCYfFQ ($46.10 in chips)
Seat 6: TAfo4veNRaRlzDXMMYS3Jg ($34 in chips)
Seat 7: s0erZsDxbZSaEPheMgibKg ($439.40 in chips)
Seat 8: jqICkNBEBjVScJ1iibba8Q ($277.65 in chips)
Seat 9: GX1heJ+DSsvm7gzSPsYhhQ ($94 in chips)
GG5lTuGt3+kwNYSbqeB6yw: posts small blind $1
5iPk5MyO3KVu18Y8XCYfFQ: posts big blind $2
*** HOLE CARDS ***
TAfo4veNRaRlzDXMMYS3Jg: folds
s0erZsDxbZSaEPheMgibKg: folds
jqICkNBEBjVScJ1iibba8Q: folds
GX1heJ+DSsvm7gzSPsYhhQ: folds
lfD8cBv31A/pio3pXJbPjA: folds
tJYod1SLp2AcWPL/3hZ7ug: folds
weUZ8S7tgbaeIpzi1gBNxQ: raises $6 to $8
GG5lTuGt3+kwNYSbqeB6yw: folds
5iPk5MyO3KVu18Y8XCYfFQ: folds
weUZ8S7tgbaeIpzi1gBNxQ collected $5 from pot
*** SUMMARY ***
Total pot $5 | Rake $0
Seat 1: lfD8cBv31A/pio3pXJbPjA folded before Flop (didn't bet)
Seat 2: tJYod1SLp2AcWPL/3hZ7ug folded before Flop (didn't bet)
Seat 3: weUZ8S7tgbaeIpzi1gBNxQ (button) collected ($5)
Seat 4: GG5lTuGt3+kwNYSbqeB6yw (small blind) folded before Flop
Seat 5: 5iPk5MyO3KVu18Y8XCYfFQ (big blind) folded before Flop
Seat 6: TAfo4veNRaRlzDXMMYS3Jg folded before Flop (didn't bet)
Seat 7: s0erZsDxbZSaEPheMgibKg folded before Flop (didn't bet)
Seat 8: jqICkNBEBjVScJ1iibba8Q folded before Flop (didn't bet)
Seat 9: GX1heJ+DSsvm7gzSPsYhhQ folded before Flop (didn't bet)



PokerStars Game #59938226162:  Hold'em No Limit ($1/$2) - 2009/07/01 0:09:57 ET
Table 'pPQgcj9XT9CHBsbo1WTBug' 6-max Seat #2 is the button
Seat 1: DFVYDA6dKQy7R7mGIKogZA ($78.30 in chips)
Seat 2: X7GlkHF+lkbarCLuZ4Uf0w ($41 in chips)
Seat 3: vkfxu8f/jMYKUk6Ly4eujw ($191 in chips)
Seat 5: 4Cl43Q1TYQL8wn1NSCUkaw ($60.90 in chips)
Seat 6: yZgdnRylE65JbScQ7qCWgw ($71 in chips)
vkfxu8f/jMYKUk6Ly4eujw: posts small blind $1
4Cl43Q1TYQL8wn1NSCUkaw: posts big blind $2
*** HOLE CARDS ***
yZgdnRylE65JbScQ7qCWgw: folds
DFVYDA6dKQy7R7mGIKogZA: folds
X7GlkHF+lkbarCLuZ4Uf0w: folds
vkfxu8f/jMYKUk6Ly4eujw: folds
4Cl43Q1TYQL8wn1NSCUkaw collected $2 from pot
*** SUMMARY ***
Total pot $2 | Rake $0
Seat 1: DFVYDA6dKQy7R7mGIKogZA folded before Flop (didn't bet)
Seat 2: X7GlkHF+lkbarCLuZ4Uf0w (button) folded before Flop (didn't bet)
Seat 3: vkfxu8f/jMYKUk6Ly4eujw (small blind) folded before Flop
Seat 5: 4Cl43Q1TYQL8wn1NSCUkaw (big blind) collected ($2)
Seat 6: yZgdnRylE65JbScQ7qCWgw folded before Flop (didn't bet)



PokerStars Game #59938227418:  Hold'em No Limit ($1/$2) - 2009/07/01 0:09:58 ET
Table 'rsKRKlGHlxVyqJxzO2a2Ow' 9-max Seat #2 is the button
Seat 1: uYWfQJg2hgHLxri6/uVJiw ($137.10 in chips)
Seat 2: QHxJjpVYwitg9krW6wZgJA ($239 in chips)
Seat 3: 9sYbXdhj1M2bwKrVNxj5+Q ($117.80 in chips)
Seat 4: zJtQ1gxyi72XvGYS1tM+DA ($182.55 in chips)
Seat 5: 5Q8U6iZbeO7xJSS4qvDP5g ($203 in chips)
Seat 6: H6Z4+qu8gR0VUiPOijndVg ($200 in chips)
Seat 7: kVCeGJ4NY7Fb0W74j1mAqA ($200 in chips)
Seat 8: Hc2itIxwbi1lwa+DAYYQGg ($37 in chips)
Seat 9: 5iPk5MyO3KVu18Y8XCYfFQ ($98.10 in chips)
9sYbXdhj1M2bwKrVNxj5+Q: posts small blind $1
zJtQ1gxyi72XvGYS1tM+DA: posts big blind $2
*** HOLE CARDS ***
5Q8U6iZbeO7xJSS4qvDP5g: folds
H6Z4+qu8gR0VUiPOijndVg: folds
kVCeGJ4NY7Fb0W74j1mAqA: folds
Hc2itIxwbi1lwa+DAYYQGg: folds
5iPk5MyO3KVu18Y8XCYfFQ: folds
uYWfQJg2hgHLxri6/uVJiw: folds
QHxJjpVYwitg9krW6wZgJA: raises $2 to $4
9sYbXdhj1M2bwKrVNxj5+Q: calls $3
zJtQ1gxyi72XvGYS1tM+DA: folds
*** FLOP *** [Jd 9d 2d]
9sYbXdhj1M2bwKrVNxj5+Q: checks
QHxJjpVYwitg9krW6wZgJA: bets $7
9sYbXdhj1M2bwKrVNxj5+Q: folds
QHxJjpVYwitg9krW6wZgJA collected $9.50 from pot
QHxJjpVYwitg9krW6wZgJA: doesn't show hand
*** SUMMARY ***
Total pot $10 | Rake $0.50
Board [Jd 9d 2d]
Seat 1: uYWfQJg2hgHLxri6/uVJiw folded before Flop (didn't bet)
Seat 2: QHxJjpVYwitg9krW6wZgJA (button) collected ($9.50)
Seat 3: 9sYbXdhj1M2bwKrVNxj5+Q (small blind) folded on the Flop
Seat 4: zJtQ1gxyi72XvGYS1tM+DA (big blind) folded before Flop
Seat 5: 5Q8U6iZbeO7xJSS4qvDP5g folded before Flop (didn't bet)
Seat 6: H6Z4+qu8gR0VUiPOijndVg folded before Flop (didn't bet)
Seat 7: kVCeGJ4NY7Fb0W74j1mAqA folded before Flop (didn't bet)
Seat 8: Hc2itIxwbi1lwa+DAYYQGg folded before Flop (didn't bet)
Seat 9: 5iPk5MyO3KVu18Y8XCYfFQ folded before Flop (didn't bet)



PokerStars Game #59938228186:  Hold'em No Limit ($1/$2) - 2009/07/01 0:09:59 ET
Table 'gnHBqWll9O3fxG7Ojkz/ng' 9-max Seat #3 is the button
Seat 1: hpqdC/23wXosGOmzARr5NA ($156.30 in chips)
Seat 2: H6Z4+qu8gR0VUiPOijndVg ($200 in chips)
Seat 3: 5Q8U6iZbeO7xJSS4qvDP5g ($218.60 in chips)
Seat 4: n5XI5/7gN+gIubHFBH+mOw ($402.85 in chips)
Seat 6: 5iPk5MyO3KVu18Y8XCYfFQ ($52.45 in chips)
Seat 8: De9g+AYjo0DN6C/+iT/nsg ($244.05 in chips)
Seat 9: kVCeGJ4NY7Fb0W74j1mAqA ($206 in chips)
n5XI5/7gN+gIubHFBH+mOw: posts small blind $1
5iPk5MyO3KVu18Y8XCYfFQ: posts big blind $2
*** HOLE CARDS ***
De9g+AYjo0DN6C/+iT/nsg: folds
kVCeGJ4NY7Fb0W74j1mAqA: folds
hpqdC/23wXosGOmzARr5NA: folds
H6Z4+qu8gR0VUiPOijndVg: raises $4 to $6
5Q8U6iZbeO7xJSS4qvDP5g: folds
n5XI5/7gN+gIubHFBH+mOw: folds
5iPk5MyO3KVu18Y8XCYfFQ: folds
H6Z4+qu8gR0VUiPOijndVg collected $5 from pot
H6Z4+qu8gR0VUiPOijndVg: doesn't show hand
*** SUMMARY ***
Total pot $5 | Rake $0
Seat 1: hpqdC/23wXosGOmzARr5NA folded before Flop (didn't bet)
Seat 2: H6Z4+qu8gR0VUiPOijndVg collected ($5)
Seat 3: 5Q8U6iZbeO7xJSS4qvDP5g (button) folded before Flop (didn't bet)
Seat 4: n5XI5/7gN+gIubHFBH+mOw (small blind) folded before Flop
Seat 6: 5iPk5MyO3KVu18Y8XCYfFQ (big blind) folded before Flop
Seat 8: De9g+AYjo0DN6C/+iT/nsg folded before Flop (didn't bet)
Seat 9: kVCeGJ4NY7Fb0W74j1mAqA folded before Flop (didn't bet)



PokerStars Game #59938229102:  Hold'em No Limit ($1/$2) - 2009/07/01 0:10:01 ET
Table 'G1Oqdy4Pqdb5gtx40rUBzA' 6-max Seat #1 is the button
Seat 1: QCqxb/MXSq5RKfPtjBjiBA ($136.80 in chips)
Seat 2: IzslX/oV8DoDQfxCV/3+kg ($347.10 in chips)
Seat 3: 6fLdOUCRtX71xbVRhJEq8w ($264.05 in chips)
Seat 5: X7GlkHF+lkbarCLuZ4Uf0w ($42 in chips)
Seat 6: gGPaCoSWW1HoKYaqfAPecg ($213.45 in chips)
IzslX/oV8DoDQfxCV/3+kg: posts small blind $1
6fLdOUCRtX71xbVRhJEq8w: posts big blind $2
*** HOLE CARDS ***
X7GlkHF+lkbarCLuZ4Uf0w: folds
gGPaCoSWW1HoKYaqfAPecg: folds
QCqxb/MXSq5RKfPtjBjiBA: folds
IzslX/oV8DoDQfxCV/3+kg: raises $4 to $6
6fLdOUCRtX71xbVRhJEq8w: folds
IzslX/oV8DoDQfxCV/3+kg collected $4 from pot
*** SUMMARY ***
Total pot $4 | Rake $0
Seat 1: QCqxb/MXSq5RKfPtjBjiBA (button) folded before Flop (didn't bet)
Seat 2: IzslX/oV8DoDQfxCV/3+kg (small blind) collected ($4)
Seat 3: 6fLdOUCRtX71xbVRhJEq8w (big blind) folded before Flop
Seat 5: X7GlkHF+lkbarCLuZ4Uf0w folded before Flop (didn't bet)
Seat 6: gGPaCoSWW1HoKYaqfAPecg folded before Flop (didn't bet)



PokerStars Game #59938230748:  Hold'em No Limit ($1/$2) - 2009/07/01 0:10:03 ET
Table 'HewZCzVOYGmuLDKthTi5Yw' 6-max Seat #2 is the button
Seat 1: 353332 ($254.95 in chips)
Seat 2: X7GlkHF+lkbarCLuZ4Uf0w ($28 in chips)
Seat 3: WJxW31eStwT28R2X/L8F5A ($48.25 in chips)
Seat 5: 513FcCI8jHyQy2VWoIQkMg ($367.95 in chips)
WJxW31eStwT28R2X/L8F5A: posts small blind $1
yZgdnRylE65JbScQ7qCWgw: is sitting out
513FcCI8jHyQy2VWoIQkMg: posts big blind $2
*** HOLE CARDS ***
353332: folds
X7GlkHF+lkbarCLuZ4Uf0w: folds
WJxW31eStwT28R2X/L8F5A: calls $1
513FcCI8jHyQy2VWoIQkMg: checks
*** FLOP *** [5d 5c Kc]
WJxW31eStwT28R2X/L8F5A: bets $2
513FcCI8jHyQy2VWoIQkMg: folds
/3OfVkAn8WikCv83i4bHHw joins the table at seat #6
WJxW31eStwT28R2X/L8F5A collected $3.80 from pot
WJxW31eStwT28R2X/L8F5A: doesn't show hand
*** SUMMARY ***
Total pot $4 | Rake $0.20
Board [5d 5c Kc]
Seat 1: 353332 folded before Flop (didn't bet)
Seat 2: X7GlkHF+lkbarCLuZ4Uf0w (button) folded before Flop (didn't bet)
Seat 3: WJxW31eStwT28R2X/L8F5A (small blind) collected ($3.80)
Seat 5: 513FcCI8jHyQy2VWoIQkMg (big blind) folded on the Flop



PokerStars Game #59938231208:  Hold'em No Limit ($1/$2) - 2009/07/01 0:10:04 ET
Table 'XP2sRSup+aRuwzx3vDZsDg' 6-max Seat #5 is the button
Seat 1: o9jamqIi6sTTRSqudgboRA ($237.70 in chips)
Seat 2: yZgdnRylE65JbScQ7qCWgw ($40 in chips)
Seat 3: X7GlkHF+lkbarCLuZ4Uf0w ($30.50 in chips)
Seat 4: JsC+WvfzqlxVs9G8/gSQAQ ($86.40 in chips)
Seat 5: vkfxu8f/jMYKUk6Ly4eujw ($192 in chips)
Seat 6: h7ppRQJTYBsHCbLMeW9T2g ($485.75 in chips)
h7ppRQJTYBsHCbLMeW9T2g: posts small blind $1
o9jamqIi6sTTRSqudgboRA: posts big blind $2
*** HOLE CARDS ***
yZgdnRylE65JbScQ7qCWgw: folds
yZgdnRylE65JbScQ7qCWgw is sitting out
X7GlkHF+lkbarCLuZ4Uf0w: folds
JsC+WvfzqlxVs9G8/gSQAQ: folds
vkfxu8f/jMYKUk6Ly4eujw: folds
h7ppRQJTYBsHCbLMeW9T2g: folds
o9jamqIi6sTTRSqudgboRA collected $2 from pot
o9jamqIi6sTTRSqudgboRA: doesn't show hand
*** SUMMARY ***
Total pot $2 | Rake $0
Seat 1: o9jamqIi6sTTRSqudgboRA (big blind) collected ($2)
Seat 2: yZgdnRylE65JbScQ7qCWgw folded before Flop (didn't bet)
Seat 3: X7GlkHF+lkbarCLuZ4Uf0w folded before Flop (didn't bet)
Seat 4: JsC+WvfzqlxVs9G8/gSQAQ folded before Flop (didn't bet)
Seat 5: vkfxu8f/jMYKUk6Ly4eujw (button) folded before Flop (didn't bet)
Seat 6: h7ppRQJTYBsHCbLMeW9T2g (small blind) folded before Flop



PokerStars Game #59938232542:  Hold'em No Limit ($1/$2) - 2009/07/01 0:10:06 ET
Table 'bJQ024BaYSBrW0sXpCZbNQ' 6-max Seat #5 is the button
Seat 2: 1njbh8TKSUF6l4V1XwGdcg ($263 in chips)
Seat 3: vkfxu8f/jMYKUk6Ly4eujw ($214.60 in chips)
Seat 4: 9ni/OEXAqfc58zPQ0Tu9rQ ($268.60 in chips)
Seat 5: X7GlkHF+lkbarCLuZ4Uf0w ($42.15 in chips)
Seat 6: 9dpyyjDTCed6nV7JhaUUpw ($210.50 in chips)
9dpyyjDTCed6nV7JhaUUpw: posts small blind $1
yZgdnRylE65JbScQ7qCWgw: is sitting out
1njbh8TKSUF6l4V1XwGdcg: posts big blind $2
*** HOLE CARDS ***
vkfxu8f/jMYKUk6Ly4eujw: folds
9ni/OEXAqfc58zPQ0Tu9rQ: folds
X7GlkHF+lkbarCLuZ4Uf0w: raises $2 to $4
9dpyyjDTCed6nV7JhaUUpw: folds
1njbh8TKSUF6l4V1XwGdcg: folds
yZgdnRylE65JbScQ7qCWgw leaves the table
X7GlkHF+lkbarCLuZ4Uf0w collected $5 from pot
X7GlkHF+lkbarCLuZ4Uf0w: doesn't show hand
*** SUMMARY ***
Total pot $5 | Rake $0
Seat 2: 1njbh8TKSUF6l4V1XwGdcg (big blind) folded before Flop
Seat 3: vkfxu8f/jMYKUk6Ly4eujw folded before Flop (didn't bet)
Seat 4: 9ni/OEXAqfc58zPQ0Tu9rQ folded before Flop (didn't bet)
Seat 5: X7GlkHF+lkbarCLuZ4Uf0w (button) collected ($5)
Seat 6: 9dpyyjDTCed6nV7JhaUUpw (small blind) folded before Flop



PokerStars Game #59938232980:  Hold'em No Limit ($1/$2) - 2009/07/01 0:10:06 ET
Table 'ZrKaj8fA5nb08RKhIpHkZA' 9-max Seat #9 is the button
Seat 1: Hc2itIxwbi1lwa+DAYYQGg ($35 in chips)
Seat 2: TAfo4veNRaRlzDXMMYS3Jg ($37 in chips)
Seat 3: GX1heJ+DSsvm7gzSPsYhhQ ($36 in chips)
Seat 5: YlSX2xwu8QMQReaxSAD8XA ($204.45 in chips)
Seat 6: Q3uFdu6ztesjDFiqkagTRQ ($200 in chips)
Seat 7: ztEPtIZdGv4TcxTUTzbY1w ($77.85 in chips)
Seat 8: tnv1uD25KOWgMmyKcuOVog ($291.95 in chips)
Seat 9: Z3aYCZG/yXHYFjiWkGI5ug ($259.25 in chips)
Hc2itIxwbi1lwa+DAYYQGg: posts small blind $1
TAfo4veNRaRlzDXMMYS3Jg: posts big blind $2
*** HOLE CARDS ***
GX1heJ+DSsvm7gzSPsYhhQ: folds
GX1heJ+DSsvm7gzSPsYhhQ leaves the table
YlSX2xwu8QMQReaxSAD8XA: folds
Q3uFdu6ztesjDFiqkagTRQ: folds
ztEPtIZdGv4TcxTUTzbY1w: folds
tnv1uD25KOWgMmyKcuOVog: folds
Z3aYCZG/yXHYFjiWkGI5ug: raises $4 to $6
Hc2itIxwbi1lwa+DAYYQGg: folds
TAfo4veNRaRlzDXMMYS3Jg: folds
Z3aYCZG/yXHYFjiWkGI5ug collected $5 from pot
Z3aYCZG/yXHYFjiWkGI5ug: doesn't show hand
*** SUMMARY ***
Total pot $5 | Rake $0
Seat 1: Hc2itIxwbi1lwa+DAYYQGg (small blind) folded before Flop
Seat 2: TAfo4veNRaRlzDXMMYS3Jg (big blind) folded before Flop
Seat 3: GX1heJ+DSsvm7gzSPsYhhQ folded before Flop (didn't bet)
Seat 5: YlSX2xwu8QMQReaxSAD8XA folded before Flop (didn't bet)
Seat 6: Q3uFdu6ztesjDFiqkagTRQ folded before Flop (didn't bet)
Seat 7: ztEPtIZdGv4TcxTUTzbY1w folded before Flop (didn't bet)
Seat 8: tnv1uD25KOWgMmyKcuOVog folded before Flop (didn't bet)
Seat 9: Z3aYCZG/yXHYFjiWkGI5ug (button) collected ($5)



PokerStars Game #59938233752:  Hold'em No Limit ($1/$2) - 2009/07/01 0:10:07 ET
Table 'l5lZHc5JRHEDt0Y2AVPq3g' 6-max Seat #2 is the button
Seat 1: gGPaCoSWW1HoKYaqfAPecg ($211.50 in chips)
Seat 2: my38j/MmtBd/8qVwmyCREA ($250.35 in chips)
Seat 4: zNjJ/y4emmF+vzrCDd+ooA ($201.95 in chips)
Seat 5: 6fLdOUCRtX71xbVRhJEq8w ($200 in chips)
Seat 6: vkfxu8f/jMYKUk6Ly4eujw ($206.30 in chips)
zNjJ/y4emmF+vzrCDd+ooA: posts small blind $1
6fLdOUCRtX71xbVRhJEq8w: posts big blind $2
*** HOLE CARDS ***
vkfxu8f/jMYKUk6Ly4eujw: folds
gGPaCoSWW1HoKYaqfAPecg: folds
my38j/MmtBd/8qVwmyCREA: folds
zNjJ/y4emmF+vzrCDd+ooA: raises $2 to $4
6fLdOUCRtX71xbVRhJEq8w: calls $2
*** FLOP *** [3c 2s 5c]
zNjJ/y4emmF+vzrCDd+ooA: bets $6
6fLdOUCRtX71xbVRhJEq8w: folds
zNjJ/y4emmF+vzrCDd+ooA collected $7.60 from pot
*** SUMMARY ***
Total pot $8 | Rake $0.40
Board [3c 2s 5c]
Seat 1: gGPaCoSWW1HoKYaqfAPecg folded before Flop (didn't bet)
Seat 2: my38j/MmtBd/8qVwmyCREA (button) folded before Flop (didn't bet)
Seat 4: zNjJ/y4emmF+vzrCDd+ooA (small blind) collected ($7.60)
Seat 5: 6fLdOUCRtX71xbVRhJEq8w (big blind) folded on the Flop
Seat 6: vkfxu8f/jMYKUk6Ly4eujw folded before Flop (didn't bet)



PokerStars Game #59938237916:  Hold'em No Limit ($1/$2) - 2009/07/01 0:10:13 ET
Table 'eyAQSIlgc2o1Jxvbve4WGg' 9-max Seat #3 is the button
Seat 1: Q3uFdu6ztesjDFiqkagTRQ ($234 in chips)
Seat 3: TAfo4veNRaRlzDXMMYS3Jg ($37 in chips)
Seat 5: JnV3SM2D6dAFYyGZHHpvrg ($98 in chips)
Seat 6: IikcENBHwoT7snSvBPSc7Q ($179.60 in chips)
Seat 7: QHxJjpVYwitg9krW6wZgJA ($200 in chips)
Seat 8: 5iPk5MyO3KVu18Y8XCYfFQ ($36 in chips)
Seat 9: Hc2itIxwbi1lwa+DAYYQGg ($46.85 in chips)
JnV3SM2D6dAFYyGZHHpvrg: posts small blind $1
IikcENBHwoT7snSvBPSc7Q: posts big blind $2
*** HOLE CARDS ***
QHxJjpVYwitg9krW6wZgJA: folds
5iPk5MyO3KVu18Y8XCYfFQ: folds
Hc2itIxwbi1lwa+DAYYQGg: folds
Q3uFdu6ztesjDFiqkagTRQ: folds
TAfo4veNRaRlzDXMMYS3Jg: folds
JnV3SM2D6dAFYyGZHHpvrg: folds
IikcENBHwoT7snSvBPSc7Q collected $2 from pot
*** SUMMARY ***
Total pot $2 | Rake $0
Seat 1: Q3uFdu6ztesjDFiqkagTRQ folded before Flop (didn't bet)
Seat 3: TAfo4veNRaRlzDXMMYS3Jg (button) folded before Flop (didn't bet)
Seat 5: JnV3SM2D6dAFYyGZHHpvrg (small blind) folded before Flop
Seat 6: IikcENBHwoT7snSvBPSc7Q (big blind) collected ($2)
Seat 7: QHxJjpVYwitg9krW6wZgJA folded before Flop (didn't bet)
Seat 8: 5iPk5MyO3KVu18Y8XCYfFQ folded before Flop (didn't bet)
Seat 9: Hc2itIxwbi1lwa+DAYYQGg folded before Flop (didn't bet)



PokerStars Game #59938239210:  Hold'em No Limit ($1/$2) - 2009/07/01 0:10:15 ET
Table 'aSf77Sj8QEnzcc0WaxVD4Q' 6-max Seat #6 is the button
Seat 1: Q3uFdu6ztesjDFiqkagTRQ ($226.35 in chips)
Seat 2: vkfxu8f/jMYKUk6Ly4eujw ($195.75 in chips)
Seat 3: 9dpyyjDTCed6nV7JhaUUpw ($223.05 in chips)
Seat 4: 513FcCI8jHyQy2VWoIQkMg ($200 in chips)
Seat 5: InmkdI6G8TzSj9NhcCSyPg ($250 in chips)
Seat 6: vkoJRf3gidxY1pPi0AFWww ($329.85 in chips)
Q3uFdu6ztesjDFiqkagTRQ: posts small blind $1
vkfxu8f/jMYKUk6Ly4eujw: posts big blind $2
*** HOLE CARDS ***
9dpyyjDTCed6nV7JhaUUpw: folds
513FcCI8jHyQy2VWoIQkMg: folds
InmkdI6G8TzSj9NhcCSyPg: folds
vkoJRf3gidxY1pPi0AFWww: calls $2
Q3uFdu6ztesjDFiqkagTRQ: folds
vkfxu8f/jMYKUk6Ly4eujw: checks
*** FLOP *** [5h 9c Kh]
vkfxu8f/jMYKUk6Ly4eujw: checks
vkoJRf3gidxY1pPi0AFWww: bets $4
vkfxu8f/jMYKUk6Ly4eujw: folds
vkoJRf3gidxY1pPi0AFWww collected $4.75 from pot
vkoJRf3gidxY1pPi0AFWww: doesn't show hand
*** SUMMARY ***
Total pot $5 | Rake $0.25
Board [5h 9c Kh]
Seat 1: Q3uFdu6ztesjDFiqkagTRQ (small blind) folded before Flop
Seat 2: vkfxu8f/jMYKUk6Ly4eujw (big blind) folded on the Flop
Seat 3: 9dpyyjDTCed6nV7JhaUUpw folded before Flop (didn't bet)
Seat 4: 513FcCI8jHyQy2VWoIQkMg folded before Flop (didn't bet)
Seat 5: InmkdI6G8TzSj9NhcCSyPg folded before Flop (didn't bet)
Seat 6: vkoJRf3gidxY1pPi0AFWww (button) collected ($4.75)



PokerStars Game #59938238980:  Hold'em No Limit ($1/$2) - 2009/07/01 0:10:15 ET
Table 'pPQgcj9XT9CHBsbo1WTBug' 6-max Seat #3 is the button
Seat 1: DFVYDA6dKQy7R7mGIKogZA ($78.30 in chips)
Seat 2: X7GlkHF+lkbarCLuZ4Uf0w ($41 in chips)
Seat 3: vkfxu8f/jMYKUk6Ly4eujw ($190 in chips)
Seat 5: 4Cl43Q1TYQL8wn1NSCUkaw ($61.90 in chips)
IPotsy was removed from the table for failing to post
4Cl43Q1TYQL8wn1NSCUkaw: posts small blind $1
yZgdnRylE65JbScQ7qCWgw: is sitting out
DFVYDA6dKQy7R7mGIKogZA: posts big blind $2
*** HOLE CARDS ***
yZgdnRylE65JbScQ7qCWgw leaves the table
X7GlkHF+lkbarCLuZ4Uf0w: raises $2 to $4
vkfxu8f/jMYKUk6Ly4eujw: folds
4Cl43Q1TYQL8wn1NSCUkaw: folds
DFVYDA6dKQy7R7mGIKogZA: calls $2
*** FLOP *** [Ts 3c Ks]
DFVYDA6dKQy7R7mGIKogZA: checks
X7GlkHF+lkbarCLuZ4Uf0w: bets $4
DFVYDA6dKQy7R7mGIKogZA: folds
X7GlkHF+lkbarCLuZ4Uf0w collected $8.55 from pot
X7GlkHF+lkbarCLuZ4Uf0w: doesn't show hand
*** SUMMARY ***
Total pot $9 | Rake $0.45
Board [Ts 3c Ks]
Seat 1: DFVYDA6dKQy7R7mGIKogZA (big blind) folded on the Flop
Seat 2: X7GlkHF+lkbarCLuZ4Uf0w collected ($8.55)
Seat 3: vkfxu8f/jMYKUk6Ly4eujw (button) folded before Flop (didn't bet)
Seat 5: 4Cl43Q1TYQL8wn1NSCUkaw (small blind) folded before Flop



PokerStars Game #59938239510:  Hold'em No Limit ($1/$2) - 2009/07/01 0:10:16 ET
Table 'G1Oqdy4Pqdb5gtx40rUBzA' 6-max Seat #2 is the button
Seat 1: QCqxb/MXSq5RKfPtjBjiBA ($136.80 in chips)
Seat 2: IzslX/oV8DoDQfxCV/3+kg ($349.10 in chips)
Seat 3: 6fLdOUCRtX71xbVRhJEq8w ($262.05 in chips)
Seat 5: X7GlkHF+lkbarCLuZ4Uf0w ($42 in chips)
Seat 6: gGPaCoSWW1HoKYaqfAPecg ($213.45 in chips)
6fLdOUCRtX71xbVRhJEq8w: posts small blind $1
X7GlkHF+lkbarCLuZ4Uf0w: posts big blind $2
*** HOLE CARDS ***
gGPaCoSWW1HoKYaqfAPecg: folds
QCqxb/MXSq5RKfPtjBjiBA: folds
IzslX/oV8DoDQfxCV/3+kg: raises $4 to $6
6fLdOUCRtX71xbVRhJEq8w: folds
X7GlkHF+lkbarCLuZ4Uf0w: folds
IzslX/oV8DoDQfxCV/3+kg collected $5 from pot
*** SUMMARY ***
Total pot $5 | Rake $0
Seat 1: QCqxb/MXSq5RKfPtjBjiBA folded before Flop (didn't bet)
Seat 2: IzslX/oV8DoDQfxCV/3+kg (button) collected ($5)
Seat 3: 6fLdOUCRtX71xbVRhJEq8w (small blind) folded before Flop
Seat 5: X7GlkHF+lkbarCLuZ4Uf0w (big blind) folded before Flop
Seat 6: gGPaCoSWW1HoKYaqfAPecg folded before Flop (didn't bet)



PokerStars Game #59938239410:  Hold'em No Limit ($1/$2) - 2009/07/01 0:10:16 ET
Table '3FGoiEOffWrbgTfsB3t7FA' 2-max Seat #1 is the button
Seat 1: e0oDWyrmgLpR6bROEqw1nQ ($398.50 in chips)
Seat 2: +sy/nlNI20yZraIjs4AALg ($204.65 in chips)
e0oDWyrmgLpR6bROEqw1nQ: posts small blind $1
+sy/nlNI20yZraIjs4AALg: posts big blind $2
*** HOLE CARDS ***
e0oDWyrmgLpR6bROEqw1nQ: raises $4 to $6
+sy/nlNI20yZraIjs4AALg: raises $4 to $10
e0oDWyrmgLpR6bROEqw1nQ: raises $20 to $30
+sy/nlNI20yZraIjs4AALg: calls $20
*** FLOP *** [5s 4s Qh]
+sy/nlNI20yZraIjs4AALg: checks
e0oDWyrmgLpR6bROEqw1nQ: bets $40
+sy/nlNI20yZraIjs4AALg: raises $134.65 to $174.65 and is all-in
e0oDWyrmgLpR6bROEqw1nQ: folds
+sy/nlNI20yZraIjs4AALg collected $139.50 from pot
*** SUMMARY ***
Total pot $140 | Rake $0.50
Board [5s 4s Qh]
Seat 1: e0oDWyrmgLpR6bROEqw1nQ (button) (small blind) folded on the Flop
Seat 2: +sy/nlNI20yZraIjs4AALg (big blind) collected ($139.50)



PokerStars Game #59938241414:  Hold'em No Limit ($1/$2) - 2009/07/01 0:10:18 ET
Table 'LL4bDFyhj5hsMpzaDugJZg' 6-max Seat #1 is the button
Seat 1: IBW9lyGsaRmfcbyA/qFfEw ($67.20 in chips)
Seat 2: L3l+A4pJhOAD6HVVFXvVBw ($290.15 in chips)
Seat 3: gGPaCoSWW1HoKYaqfAPecg ($205 in chips)
Seat 4: 8srN1dKQePlsv0GyTada+Q ($287.75 in chips)
Seat 5: HgX0VeqE/dzSXd5BpntRBw ($203 in chips)
Seat 6: yZgdnRylE65JbScQ7qCWgw ($37 in chips)
L3l+A4pJhOAD6HVVFXvVBw: posts small blind $1
gGPaCoSWW1HoKYaqfAPecg: posts big blind $2
*** HOLE CARDS ***
8srN1dKQePlsv0GyTada+Q: folds
HgX0VeqE/dzSXd5BpntRBw: folds
yZgdnRylE65JbScQ7qCWgw: folds
IBW9lyGsaRmfcbyA/qFfEw: folds
L3l+A4pJhOAD6HVVFXvVBw: calls $1
gGPaCoSWW1HoKYaqfAPecg: checks
*** FLOP *** [6h Jd 9c]
L3l+A4pJhOAD6HVVFXvVBw: bets $2
gGPaCoSWW1HoKYaqfAPecg: folds
L3l+A4pJhOAD6HVVFXvVBw collected $3.80 from pot
*** SUMMARY ***
Total pot $4 | Rake $0.20
Board [6h Jd 9c]
Seat 1: IBW9lyGsaRmfcbyA/qFfEw (button) folded before Flop (didn't bet)
Seat 2: L3l+A4pJhOAD6HVVFXvVBw (small blind) collected ($3.80)
Seat 3: gGPaCoSWW1HoKYaqfAPecg (big blind) folded on the Flop
Seat 4: 8srN1dKQePlsv0GyTada+Q folded before Flop (didn't bet)
Seat 5: HgX0VeqE/dzSXd5BpntRBw folded before Flop (didn't bet)
Seat 6: yZgdnRylE65JbScQ7qCWgw folded before Flop (didn't bet)



PokerStars Game #59938241480:  Hold'em No Limit ($1/$2) - 2009/07/01 0:10:19 ET
Table 'NmY84NAf9Mh0ckAckHnh5g' 2-max Seat #1 is the button
Seat 1: 6hvg964TSqZ3AL/0XK9aVQ ($342.50 in chips)
Seat 2: RwDoM55ZeQuI2ADyJhOb2Q ($249.80 in chips)
6hvg964TSqZ3AL/0XK9aVQ: posts small blind $1
RwDoM55ZeQuI2ADyJhOb2Q: posts big blind $2
*** HOLE CARDS ***
6hvg964TSqZ3AL/0XK9aVQ: calls $1
RwDoM55ZeQuI2ADyJhOb2Q: checks
*** FLOP *** [2c 2h 2d]
RwDoM55ZeQuI2ADyJhOb2Q: bets $2
6hvg964TSqZ3AL/0XK9aVQ: calls $2
*** TURN *** [2c 2h 2d] [2s]
RwDoM55ZeQuI2ADyJhOb2Q: bets $8
6hvg964TSqZ3AL/0XK9aVQ: calls $8
*** RIVER *** [2c 2h 2d 2s] [Ac]
RwDoM55ZeQuI2ADyJhOb2Q: bets $237.80 and is all-in
6hvg964TSqZ3AL/0XK9aVQ: calls $237.80
*** SHOW DOWN ***
RwDoM55ZeQuI2ADyJhOb2Q: shows [Kc 4d] (four of a kind, Deuces)
6hvg964TSqZ3AL/0XK9aVQ: shows [7d Th] (four of a kind, Deuces)
RwDoM55ZeQuI2ADyJhOb2Q collected $249.55 from pot
6hvg964TSqZ3AL/0XK9aVQ collected $249.55 from pot
*** SUMMARY ***
Total pot $499.60 | Rake $0.50
Board [2c 2h 2d 2s Ac]
Seat 1: 6hvg964TSqZ3AL/0XK9aVQ (button) (small blind) showed [7d Th] and won ($249.55) with four of a kind, Deuces
Seat 2: RwDoM55ZeQuI2ADyJhOb2Q (big blind) showed [Kc 4d] and won ($249.55) with four of a kind, Deuces



PokerStars Game #59938242412:  Hold'em No Limit ($1/$2) - 2009/07/01 0:10:20 ET
Table 'W9UeSV0aoPjh5SFSxM8jUQ' 9-max Seat #2 is the button
Seat 1: cdC54j9fGGojcbzWB5PgzA ($233.35 in chips)
Seat 2: iMe5yhc+1BaiIPHet3NMrA ($260.75 in chips)
Seat 3: TAfo4veNRaRlzDXMMYS3Jg ($38 in chips)
Seat 4: De9g+AYjo0DN6C/+iT/nsg ($200 in chips)
Seat 5: 5c0Nx4jItp6QcQ2ve2inRw ($306.30 in chips)
Seat 6: MXxB6weBWzZyAhRZb+/KVg ($200 in chips)
Seat 7: 4Cl43Q1TYQL8wn1NSCUkaw ($51.60 in chips)
Seat 8: gvAfRM7YyyK5hFYc5+qhNA ($118.55 in chips)
Seat 9: U2A5Hv6ib/5+gzO2wr7Z4w ($200 in chips)
TAfo4veNRaRlzDXMMYS3Jg: posts small blind $1
De9g+AYjo0DN6C/+iT/nsg: posts big blind $2
*** HOLE CARDS ***
5c0Nx4jItp6QcQ2ve2inRw: folds
MXxB6weBWzZyAhRZb+/KVg: folds
4Cl43Q1TYQL8wn1NSCUkaw: folds
gvAfRM7YyyK5hFYc5+qhNA: raises $2 to $4
U2A5Hv6ib/5+gzO2wr7Z4w: folds
cdC54j9fGGojcbzWB5PgzA: raises $10 to $14
iMe5yhc+1BaiIPHet3NMrA: folds
TAfo4veNRaRlzDXMMYS3Jg: folds
De9g+AYjo0DN6C/+iT/nsg: folds
gvAfRM7YyyK5hFYc5+qhNA: calls $10
*** FLOP *** [6c 4s As]
gvAfRM7YyyK5hFYc5+qhNA: bets $20
cdC54j9fGGojcbzWB5PgzA: calls $20
*** TURN *** [6c 4s As] [4h]
gvAfRM7YyyK5hFYc5+qhNA: bets $20
cdC54j9fGGojcbzWB5PgzA: calls $20
*** RIVER *** [6c 4s As 4h] [3d]
gvAfRM7YyyK5hFYc5+qhNA: bets $20
cdC54j9fGGojcbzWB5PgzA: raises $104 to $124
gvAfRM7YyyK5hFYc5+qhNA: calls $44.55 and is all-in
*** SHOW DOWN ***
cdC54j9fGGojcbzWB5PgzA: shows [Ad Qd] (two pair, Aces and Fours)
gvAfRM7YyyK5hFYc5+qhNA: shows [Ah Qc] (two pair, Aces and Fours)
gvAfRM7YyyK5hFYc5+qhNA collected $118.55 from pot
cdC54j9fGGojcbzWB5PgzA collected $118.55 from pot
*** SUMMARY ***
Total pot $240.10 | Rake $3
Board [6c 4s As 4h 3d]
Seat 1: cdC54j9fGGojcbzWB5PgzA showed [Ad Qd] and won ($118.55) with two pair, Aces and Fours
Seat 2: iMe5yhc+1BaiIPHet3NMrA (button) folded before Flop (didn't bet)
Seat 3: TAfo4veNRaRlzDXMMYS3Jg (small blind) folded before Flop
Seat 4: De9g+AYjo0DN6C/+iT/nsg (big blind) folded before Flop
Seat 5: 5c0Nx4jItp6QcQ2ve2inRw folded before Flop (didn't bet)
Seat 6: MXxB6weBWzZyAhRZb+/KVg folded before Flop (didn't bet)
Seat 7: 4Cl43Q1TYQL8wn1NSCUkaw folded before Flop (didn't bet)
Seat 8: gvAfRM7YyyK5hFYc5+qhNA showed [Ah Qc] and won ($118.55) with two pair, Aces and Fours
Seat 9: U2A5Hv6ib/5+gzO2wr7Z4w folded before Flop (didn't bet)



PokerStars Game #59938245134:  Hold'em No Limit ($1/$2) - 2009/07/01 0:10:24 ET
Table 'ztv6V3FN2bQ9nmJPPdx6nQ' 6-max Seat #6 is the button
Seat 1: ek1hig03QiyONDHXvgqteQ ($191.65 in chips)
Seat 2: 2lOU1DcvUZaMcxZ95XfzXw ($123 in chips)
Seat 4: vkfxu8f/jMYKUk6Ly4eujw ($325.70 in chips)
Seat 5: sTPOWERd9HWPCNrDBwsVjA ($204.95 in chips)
Seat 6: yZgdnRylE65JbScQ7qCWgw ($31 in chips)
ek1hig03QiyONDHXvgqteQ: posts small blind $1
2lOU1DcvUZaMcxZ95XfzXw: posts big blind $2
*** HOLE CARDS ***
vkfxu8f/jMYKUk6Ly4eujw: folds
sTPOWERd9HWPCNrDBwsVjA: folds
yZgdnRylE65JbScQ7qCWgw: folds
ek1hig03QiyONDHXvgqteQ: folds
2lOU1DcvUZaMcxZ95XfzXw collected $2 from pot
2lOU1DcvUZaMcxZ95XfzXw: doesn't show hand
*** SUMMARY ***
Total pot $2 | Rake $0
Seat 1: ek1hig03QiyONDHXvgqteQ (small blind) folded before Flop
Seat 2: 2lOU1DcvUZaMcxZ95XfzXw (big blind) collected ($2)
Seat 4: vkfxu8f/jMYKUk6Ly4eujw folded before Flop (didn't bet)
Seat 5: sTPOWERd9HWPCNrDBwsVjA folded before Flop (didn't bet)
Seat 6: yZgdnRylE65JbScQ7qCWgw (button) folded before Flop (didn't bet)



PokerStars Game #59938246002:  Hold'em No Limit ($1/$2) - 2009/07/01 0:10:25 ET
Table 'bJQ024BaYSBrW0sXpCZbNQ' 6-max Seat #6 is the button
Seat 2: 1njbh8TKSUF6l4V1XwGdcg ($261 in chips)
Seat 3: vkfxu8f/jMYKUk6Ly4eujw ($214.60 in chips)
Seat 4: 9ni/OEXAqfc58zPQ0Tu9rQ ($268.60 in chips)
Seat 5: X7GlkHF+lkbarCLuZ4Uf0w ($45.15 in chips)
Seat 6: 9dpyyjDTCed6nV7JhaUUpw ($209.50 in chips)
1njbh8TKSUF6l4V1XwGdcg: posts small blind $1
vkfxu8f/jMYKUk6Ly4eujw: posts big blind $2
*** HOLE CARDS ***
9ni/OEXAqfc58zPQ0Tu9rQ: folds
X7GlkHF+lkbarCLuZ4Uf0w: raises $2 to $4
9dpyyjDTCed6nV7JhaUUpw: folds
1njbh8TKSUF6l4V1XwGdcg: folds
vkfxu8f/jMYKUk6Ly4eujw: folds
X7GlkHF+lkbarCLuZ4Uf0w collected $5 from pot
X7GlkHF+lkbarCLuZ4Uf0w: doesn't show hand
*** SUMMARY ***
Total pot $5 | Rake $0
Seat 2: 1njbh8TKSUF6l4V1XwGdcg (small blind) folded before Flop
Seat 3: vkfxu8f/jMYKUk6Ly4eujw (big blind) folded before Flop
Seat 4: 9ni/OEXAqfc58zPQ0Tu9rQ folded before Flop (didn't bet)
Seat 5: X7GlkHF+lkbarCLuZ4Uf0w collected ($5)
Seat 6: 9dpyyjDTCed6nV7JhaUUpw (button) folded before Flop (didn't bet)



PokerStars Game #59938246378:  Hold'em No Limit ($1/$2) - 2009/07/01 0:10:25 ET
Table 'SF49/KQm8T4taMp6kb+HXA' 9-max Seat #4 is the button
Seat 1: l1bCLGuFqeFRwUfPsiDu/g ($173.95 in chips)
Seat 2: 8Z3QifiM9eOd5EIJ25dXNg ($109.15 in chips)
Seat 4: HffgoYm61KgkdMe/DYChIQ ($34 in chips)
Seat 5: Z3aYCZG/yXHYFjiWkGI5ug ($227.55 in chips)
Seat 6: M2ht6rIKOI/my9eh610Nlw ($247.45 in chips)
Seat 8: 5iPk5MyO3KVu18Y8XCYfFQ ($39 in chips)
Seat 9: O+jytCilwk7zItVCEavmtw ($140 in chips)
Z3aYCZG/yXHYFjiWkGI5ug: posts small blind $1
M2ht6rIKOI/my9eh610Nlw: posts big blind $2
n2VAbLaE5qgKr5mA4W6v4w: sits out
*** HOLE CARDS ***
5iPk5MyO3KVu18Y8XCYfFQ: folds
O+jytCilwk7zItVCEavmtw: raises $6 to $8
l1bCLGuFqeFRwUfPsiDu/g: folds
8Z3QifiM9eOd5EIJ25dXNg: folds
HffgoYm61KgkdMe/DYChIQ: folds
L88dtdULfz5oGDSuo9/RvA said, "every time on this site"
Z3aYCZG/yXHYFjiWkGI5ug: folds
M2ht6rIKOI/my9eh610Nlw: folds
O+jytCilwk7zItVCEavmtw collected $5 from pot
*** SUMMARY ***
Total pot $5 | Rake $0
Seat 1: l1bCLGuFqeFRwUfPsiDu/g folded before Flop (didn't bet)
Seat 2: 8Z3QifiM9eOd5EIJ25dXNg folded before Flop (didn't bet)
Seat 4: HffgoYm61KgkdMe/DYChIQ (button) folded before Flop (didn't bet)
Seat 5: Z3aYCZG/yXHYFjiWkGI5ug (small blind) folded before Flop
Seat 6: M2ht6rIKOI/my9eh610Nlw (big blind) folded before Flop
Seat 8: 5iPk5MyO3KVu18Y8XCYfFQ folded before Flop (didn't bet)
Seat 9: O+jytCilwk7zItVCEavmtw collected ($5)



PokerStars Game #59938246612:  Hold'em No Limit ($1/$2) - 2009/07/01 0:10:26 ET
Table 'CFkQcfWjKccZaZDf71FK+w' 6-max Seat #2 is the button
Seat 1: X7GlkHF+lkbarCLuZ4Uf0w ($27 in chips)
Seat 2: yZgdnRylE65JbScQ7qCWgw ($47 in chips)
Seat 5: 1njbh8TKSUF6l4V1XwGdcg ($233 in chips)
Seat 6: ORVqY3rf9X6ANA/8s+On2Q ($34 in chips)
1njbh8TKSUF6l4V1XwGdcg: posts small blind $1
ORVqY3rf9X6ANA/8s+On2Q: posts big blind $2
*** HOLE CARDS ***
X7GlkHF+lkbarCLuZ4Uf0w: folds
yZgdnRylE65JbScQ7qCWgw: raises $45 to $47 and is all-in
1njbh8TKSUF6l4V1XwGdcg: folds
ORVqY3rf9X6ANA/8s+On2Q: calls $32 and is all-in
*** FLOP *** [Kh 3h 5d]
*** TURN *** [Kh 3h 5d] [Td]
*** RIVER *** [Kh 3h 5d Td] [Ac]
*** SHOW DOWN ***
ORVqY3rf9X6ANA/8s+On2Q: shows [Qs Qd] (a pair of Queens)
yZgdnRylE65JbScQ7qCWgw: mucks hand
ORVqY3rf9X6ANA/8s+On2Q collected $67 from pot
*** SUMMARY ***
Total pot $69 | Rake $2
Board [Kh 3h 5d Td Ac]
Seat 1: X7GlkHF+lkbarCLuZ4Uf0w folded before Flop (didn't bet)
Seat 2: yZgdnRylE65JbScQ7qCWgw (button) mucked
Seat 5: 1njbh8TKSUF6l4V1XwGdcg (small blind) folded before Flop
Seat 6: ORVqY3rf9X6ANA/8s+On2Q (big blind) showed [Qs Qd] and won ($67) with a pair of Queens



PokerStars Game #59938250994:  Hold'em No Limit ($1/$2) - 2009/07/01 0:10:32 ET
Table 'srul5UFZXTEccVV5fpY91g' 9-max Seat #4 is the button
Seat 1: lfD8cBv31A/pio3pXJbPjA ($195.20 in chips)
Seat 2: tJYod1SLp2AcWPL/3hZ7ug ($111.20 in chips)
Seat 3: weUZ8S7tgbaeIpzi1gBNxQ ($38 in chips)
Seat 4: GG5lTuGt3+kwNYSbqeB6yw ($91.85 in chips)
Seat 5: 5iPk5MyO3KVu18Y8XCYfFQ ($44.10 in chips)
Seat 6: TAfo4veNRaRlzDXMMYS3Jg ($34 in chips)
Seat 7: s0erZsDxbZSaEPheMgibKg ($439.40 in chips)
Seat 8: jqICkNBEBjVScJ1iibba8Q ($277.65 in chips)
Seat 9: GX1heJ+DSsvm7gzSPsYhhQ ($94 in chips)
5iPk5MyO3KVu18Y8XCYfFQ: posts small blind $1
TAfo4veNRaRlzDXMMYS3Jg: posts big blind $2
*** HOLE CARDS ***
s0erZsDxbZSaEPheMgibKg: folds
jqICkNBEBjVScJ1iibba8Q: folds
GX1heJ+DSsvm7gzSPsYhhQ: folds
lfD8cBv31A/pio3pXJbPjA: folds
tJYod1SLp2AcWPL/3hZ7ug: calls $2
weUZ8S7tgbaeIpzi1gBNxQ: raises $8 to $10
GG5lTuGt3+kwNYSbqeB6yw: calls $10
5iPk5MyO3KVu18Y8XCYfFQ: folds
TAfo4veNRaRlzDXMMYS3Jg: folds
tJYod1SLp2AcWPL/3hZ7ug: folds
*** FLOP *** [3s 8c 7d]
weUZ8S7tgbaeIpzi1gBNxQ: bets $28 and is all-in
GG5lTuGt3+kwNYSbqeB6yw: folds
weUZ8S7tgbaeIpzi1gBNxQ collected $23.75 from pot
*** SUMMARY ***
Total pot $25 | Rake $1.25
Board [3s 8c 7d]
Seat 1: lfD8cBv31A/pio3pXJbPjA folded before Flop (didn't bet)
Seat 2: tJYod1SLp2AcWPL/3hZ7ug folded before Flop
Seat 3: weUZ8S7tgbaeIpzi1gBNxQ collected ($23.75)
Seat 4: GG5lTuGt3+kwNYSbqeB6yw (button) folded on the Flop
Seat 5: 5iPk5MyO3KVu18Y8XCYfFQ (small blind) folded before Flop
Seat 6: TAfo4veNRaRlzDXMMYS3Jg (big blind) folded before Flop
Seat 7: s0erZsDxbZSaEPheMgibKg folded before Flop (didn't bet)
Seat 8: jqICkNBEBjVScJ1iibba8Q folded before Flop (didn't bet)
Seat 9: GX1heJ+DSsvm7gzSPsYhhQ folded before Flop (didn't bet)



PokerStars Game #59938250820:  Hold'em No Limit ($1/$2) - 2009/07/01 0:10:32 ET
Table 'HewZCzVOYGmuLDKthTi5Yw' 6-max Seat #3 is the button
Seat 1: 353332 ($254.95 in chips)
Seat 2: X7GlkHF+lkbarCLuZ4Uf0w ($28 in chips)
Seat 3: WJxW31eStwT28R2X/L8F5A ($50.05 in chips)
Seat 5: 513FcCI8jHyQy2VWoIQkMg ($365.95 in chips)
Seat 6: /3OfVkAn8WikCv83i4bHHw ($120 in chips)
513FcCI8jHyQy2VWoIQkMg: posts small blind $1
/3OfVkAn8WikCv83i4bHHw: posts big blind $2
*** HOLE CARDS ***
353332: folds
X7GlkHF+lkbarCLuZ4Uf0w: folds
WJxW31eStwT28R2X/L8F5A: raises $2 to $4
513FcCI8jHyQy2VWoIQkMg: folds
/3OfVkAn8WikCv83i4bHHw: folds
WJxW31eStwT28R2X/L8F5A collected $5 from pot
WJxW31eStwT28R2X/L8F5A: doesn't show hand
*** SUMMARY ***
Total pot $5 | Rake $0
Seat 1: 353332 folded before Flop (didn't bet)
Seat 2: X7GlkHF+lkbarCLuZ4Uf0w folded before Flop (didn't bet)
Seat 3: WJxW31eStwT28R2X/L8F5A (button) collected ($5)
Seat 5: 513FcCI8jHyQy2VWoIQkMg (small blind) folded before Flop
Seat 6: /3OfVkAn8WikCv83i4bHHw (big blind) folded before Flop



PokerStars Game #59938252836:  Hold'em No Limit ($1/$2) - 2009/07/01 0:10:35 ET
Table 'XP2sRSup+aRuwzx3vDZsDg' 6-max Seat #6 is the button
Seat 1: o9jamqIi6sTTRSqudgboRA ($238.70 in chips)
Seat 3: X7GlkHF+lkbarCLuZ4Uf0w ($30.50 in chips)
Seat 4: JsC+WvfzqlxVs9G8/gSQAQ ($86.40 in chips)
Seat 5: vkfxu8f/jMYKUk6Ly4eujw ($192 in chips)
Seat 6: h7ppRQJTYBsHCbLMeW9T2g ($484.75 in chips)
o9jamqIi6sTTRSqudgboRA: posts small blind $1
X7GlkHF+lkbarCLuZ4Uf0w: posts big blind $2
*** HOLE CARDS ***
JsC+WvfzqlxVs9G8/gSQAQ: folds
vkfxu8f/jMYKUk6Ly4eujw: folds
h7ppRQJTYBsHCbLMeW9T2g: raises $2 to $4
o9jamqIi6sTTRSqudgboRA: folds
X7GlkHF+lkbarCLuZ4Uf0w: folds
h7ppRQJTYBsHCbLMeW9T2g collected $5 from pot
*** SUMMARY ***
Total pot $5 | Rake $0
Seat 1: o9jamqIi6sTTRSqudgboRA (small blind) folded before Flop
Seat 3: X7GlkHF+lkbarCLuZ4Uf0w (big blind) folded before Flop
Seat 4: JsC+WvfzqlxVs9G8/gSQAQ folded before Flop (didn't bet)
Seat 5: vkfxu8f/jMYKUk6Ly4eujw folded before Flop (didn't bet)
Seat 6: h7ppRQJTYBsHCbLMeW9T2g (button) collected ($5)



PokerStars Game #59938254020:  Hold'em No Limit ($1/$2) - 2009/07/01 0:10:36 ET
Table 'qVXak+oTeDXMGbWa4sDU5Q' 9-max Seat #8 is the button
Seat 1: H6Z4+qu8gR0VUiPOijndVg ($250 in chips)
Seat 2: Hc2itIxwbi1lwa+DAYYQGg ($49 in chips)
Seat 3: oz9eCXGC7DdjQlL/nuWj1A ($105.85 in chips)
Seat 4: b0jO1SDhLedy1//CQlA8kw ($40 in chips)
Seat 6: Q3uFdu6ztesjDFiqkagTRQ ($200 in chips)
Seat 7: 5iPk5MyO3KVu18Y8XCYfFQ ($115 in chips)
Seat 8: 9pHZMviI9R8injxojGTnvw ($101.85 in chips)
Seat 9: IZ/2qsh1CIg9m5PWsMsLmA ($358.95 in chips)
IZ/2qsh1CIg9m5PWsMsLmA: posts small blind $1
H6Z4+qu8gR0VUiPOijndVg: posts big blind $2
NqKRc5xvcye0d7F6VOF6MQ: sits out
*** HOLE CARDS ***
Hc2itIxwbi1lwa+DAYYQGg: folds
oz9eCXGC7DdjQlL/nuWj1A: calls $2
b0jO1SDhLedy1//CQlA8kw: folds
Q3uFdu6ztesjDFiqkagTRQ: folds
5iPk5MyO3KVu18Y8XCYfFQ: folds
9pHZMviI9R8injxojGTnvw: folds
IZ/2qsh1CIg9m5PWsMsLmA: folds
H6Z4+qu8gR0VUiPOijndVg: checks
*** FLOP *** [Ac 2c Qc]
H6Z4+qu8gR0VUiPOijndVg: checks
oz9eCXGC7DdjQlL/nuWj1A: checks
*** TURN *** [Ac 2c Qc] [Ad]
H6Z4+qu8gR0VUiPOijndVg: checks
oz9eCXGC7DdjQlL/nuWj1A: bets $4
H6Z4+qu8gR0VUiPOijndVg: folds
oz9eCXGC7DdjQlL/nuWj1A collected $4.75 from pot
*** SUMMARY ***
Total pot $5 | Rake $0.25
Board [Ac 2c Qc Ad]
Seat 1: H6Z4+qu8gR0VUiPOijndVg (big blind) folded on the Turn
Seat 2: Hc2itIxwbi1lwa+DAYYQGg folded before Flop (didn't bet)
Seat 3: oz9eCXGC7DdjQlL/nuWj1A collected ($4.75)
Seat 4: b0jO1SDhLedy1//CQlA8kw folded before Flop (didn't bet)
Seat 6: Q3uFdu6ztesjDFiqkagTRQ folded before Flop (didn't bet)
Seat 7: 5iPk5MyO3KVu18Y8XCYfFQ folded before Flop (didn't bet)
Seat 8: 9pHZMviI9R8injxojGTnvw (button) folded before Flop (didn't bet)
Seat 9: IZ/2qsh1CIg9m5PWsMsLmA (small blind) folded before Flop



PokerStars Game #59938254858:  Hold'em No Limit ($1/$2) - 2009/07/01 0:10:37 ET
Table 'ztv6V3FN2bQ9nmJPPdx6nQ' 6-max Seat #1 is the button
Seat 1: ek1hig03QiyONDHXvgqteQ ($190.65 in chips)
Seat 2: 2lOU1DcvUZaMcxZ95XfzXw ($124 in chips)
Seat 5: sTPOWERd9HWPCNrDBwsVjA ($204.95 in chips)
Seat 6: yZgdnRylE65JbScQ7qCWgw ($31 in chips)
2lOU1DcvUZaMcxZ95XfzXw: posts small blind $1
vkfxu8f/jMYKUk6Ly4eujw: is sitting out
sTPOWERd9HWPCNrDBwsVjA: posts big blind $2
*** HOLE CARDS ***
vkfxu8f/jMYKUk6Ly4eujw leaves the table
yZgdnRylE65JbScQ7qCWgw: raises $29 to $31 and is all-in
ek1hig03QiyONDHXvgqteQ: folds
2lOU1DcvUZaMcxZ95XfzXw: folds
sTPOWERd9HWPCNrDBwsVjA: calls $29
*** FLOP *** [3s 5c 8h]
2lOU1DcvUZaMcxZ95XfzXw said, "lol"
*** TURN *** [3s 5c 8h] [7h]
*** RIVER *** [3s 5c 8h 7h] [2d]
*** SHOW DOWN ***
sTPOWERd9HWPCNrDBwsVjA: shows [Qd Kc] (high card King)
yZgdnRylE65JbScQ7qCWgw: shows [Qh Ah] (high card Ace)
yZgdnRylE65JbScQ7qCWgw collected $61 from pot
*** SUMMARY ***
Total pot $63 | Rake $2
Board [3s 5c 8h 7h 2d]
Seat 1: ek1hig03QiyONDHXvgqteQ (button) folded before Flop (didn't bet)
Seat 2: 2lOU1DcvUZaMcxZ95XfzXw (small blind) folded before Flop
Seat 5: sTPOWERd9HWPCNrDBwsVjA (big blind) showed [Qd Kc] and lost with high card King
Seat 6: yZgdnRylE65JbScQ7qCWgw showed [Qh Ah] and won ($61) with high card Ace



PokerStars Game #59938255264:  Hold'em No Limit ($1/$2) - 2009/07/01 0:10:38 ET
Table 'G1Oqdy4Pqdb5gtx40rUBzA' 6-max Seat #3 is the button
Seat 1: QCqxb/MXSq5RKfPtjBjiBA ($136.80 in chips)
Seat 2: IzslX/oV8DoDQfxCV/3+kg ($352.10 in chips)
Seat 3: 6fLdOUCRtX71xbVRhJEq8w ($261.05 in chips)
Seat 5: X7GlkHF+lkbarCLuZ4Uf0w ($40 in chips)
Seat 6: gGPaCoSWW1HoKYaqfAPecg ($213.45 in chips)
X7GlkHF+lkbarCLuZ4Uf0w: posts small blind $1
gGPaCoSWW1HoKYaqfAPecg: posts big blind $2
*** HOLE CARDS ***
QCqxb/MXSq5RKfPtjBjiBA: folds
IzslX/oV8DoDQfxCV/3+kg: folds
6fLdOUCRtX71xbVRhJEq8w has timed out
6fLdOUCRtX71xbVRhJEq8w: folds
6fLdOUCRtX71xbVRhJEq8w is sitting out
X7GlkHF+lkbarCLuZ4Uf0w: raises $3 to $5
6fLdOUCRtX71xbVRhJEq8w has returned
gGPaCoSWW1HoKYaqfAPecg: raises $10 to $15
X7GlkHF+lkbarCLuZ4Uf0w: raises $25 to $40 and is all-in
gGPaCoSWW1HoKYaqfAPecg: calls $25
*** FLOP *** [Qh 9h 2d]
*** TURN *** [Qh 9h 2d] [9s]
*** RIVER *** [Qh 9h 2d 9s] [6h]
*** SHOW DOWN ***
X7GlkHF+lkbarCLuZ4Uf0w: shows [Jh Jc] (two pair, Jacks and Nines)
gGPaCoSWW1HoKYaqfAPecg: mucks hand
X7GlkHF+lkbarCLuZ4Uf0w collected $78 from pot
*** SUMMARY ***
Total pot $80 | Rake $2
Board [Qh 9h 2d 9s 6h]
Seat 1: QCqxb/MXSq5RKfPtjBjiBA folded before Flop (didn't bet)
Seat 2: IzslX/oV8DoDQfxCV/3+kg folded before Flop (didn't bet)
Seat 3: 6fLdOUCRtX71xbVRhJEq8w (button) folded before Flop (didn't bet)
Seat 5: X7GlkHF+lkbarCLuZ4Uf0w (small blind) showed [Jh Jc] and won ($78) with two pair, Jacks and Nines
Seat 6: gGPaCoSWW1HoKYaqfAPecg (big blind) mucked



PokerStars Game #59938255814:  Hold'em No Limit ($1/$2) - 2009/07/01 0:10:39 ET
Table 'bIihwBANJSFqlHPPtset+w' 9-max Seat #1 is the button
Seat 1: jI3JDUGV63ccqtKgM3vMbw ($142.60 in chips)
Seat 2: lQYT23h5QCUVZAKxjOO39Q ($121.90 in chips)
Seat 3: acnZ0LD5jxKgWIHz+mpQ8Q ($217.40 in chips)
Seat 4: 7WWX5PClBdr/U44gUKBIEA ($266.65 in chips)
Seat 5: GX1heJ+DSsvm7gzSPsYhhQ ($40 in chips)
Seat 6: 5iPk5MyO3KVu18Y8XCYfFQ ($44.40 in chips)
Seat 7: 3q2/0oJr3Mcy1W5tcN61ug ($200 in chips)
Seat 8: iMe5yhc+1BaiIPHet3NMrA ($281.65 in chips)
Seat 9: rW/MyplHylMSBRaoRUzWrg ($34.55 in chips)
lQYT23h5QCUVZAKxjOO39Q: posts small blind $1
acnZ0LD5jxKgWIHz+mpQ8Q: posts big blind $2
*** HOLE CARDS ***
7WWX5PClBdr/U44gUKBIEA: folds
GX1heJ+DSsvm7gzSPsYhhQ: folds
5iPk5MyO3KVu18Y8XCYfFQ: folds
3q2/0oJr3Mcy1W5tcN61ug: folds
iMe5yhc+1BaiIPHet3NMrA: folds
rW/MyplHylMSBRaoRUzWrg: folds
jI3JDUGV63ccqtKgM3vMbw: calls $2
lQYT23h5QCUVZAKxjOO39Q: raises $8 to $10
acnZ0LD5jxKgWIHz+mpQ8Q: folds
jI3JDUGV63ccqtKgM3vMbw: folds
lQYT23h5QCUVZAKxjOO39Q collected $6 from pot
*** SUMMARY ***
Total pot $6 | Rake $0
Seat 1: jI3JDUGV63ccqtKgM3vMbw (button) folded before Flop
Seat 2: lQYT23h5QCUVZAKxjOO39Q (small blind) collected ($6)
Seat 3: acnZ0LD5jxKgWIHz+mpQ8Q (big blind) folded before Flop
Seat 4: 7WWX5PClBdr/U44gUKBIEA folded before Flop (didn't bet)
Seat 5: GX1heJ+DSsvm7gzSPsYhhQ folded before Flop (didn't bet)
Seat 6: 5iPk5MyO3KVu18Y8XCYfFQ folded before Flop (didn't bet)
Seat 7: 3q2/0oJr3Mcy1W5tcN61ug folded before Flop (didn't bet)
Seat 8: iMe5yhc+1BaiIPHet3NMrA folded before Flop (didn't bet)
Seat 9: rW/MyplHylMSBRaoRUzWrg folded before Flop (didn't bet)



PokerStars Game #59938256738:  Hold'em No Limit ($1/$2) - 2009/07/01 0:10:40 ET
Table 'NmY84NAf9Mh0ckAckHnh5g' 2-max Seat #2 is the button
Seat 1: 6hvg964TSqZ3AL/0XK9aVQ ($342.25 in chips)
Seat 2: RwDoM55ZeQuI2ADyJhOb2Q ($249.55 in chips)
RwDoM55ZeQuI2ADyJhOb2Q: posts small blind $1
6hvg964TSqZ3AL/0XK9aVQ: posts big blind $2
*** HOLE CARDS ***
RwDoM55ZeQuI2ADyJhOb2Q: folds
6hvg964TSqZ3AL/0XK9aVQ collected $2 from pot
*** SUMMARY ***
Total pot $2 | Rake $0
Seat 1: 6hvg964TSqZ3AL/0XK9aVQ (big blind) collected ($2)
Seat 2: RwDoM55ZeQuI2ADyJhOb2Q (button) (small blind) folded before Flop



PokerStars Game #59938260420:  Hold'em No Limit ($1/$2) - 2009/07/01 0:10:45 ET
Table 'gnHBqWll9O3fxG7Ojkz/ng' 9-max Seat #4 is the button
Seat 1: hpqdC/23wXosGOmzARr5NA ($156.30 in chips)
Seat 2: H6Z4+qu8gR0VUiPOijndVg ($203 in chips)
Seat 3: 5Q8U6iZbeO7xJSS4qvDP5g ($218.60 in chips)
Seat 4: n5XI5/7gN+gIubHFBH+mOw ($401.85 in chips)
Seat 6: 5iPk5MyO3KVu18Y8XCYfFQ ($50.45 in chips)
Seat 8: De9g+AYjo0DN6C/+iT/nsg ($244.05 in chips)
Seat 9: kVCeGJ4NY7Fb0W74j1mAqA ($206 in chips)
5iPk5MyO3KVu18Y8XCYfFQ: posts small blind $1
De9g+AYjo0DN6C/+iT/nsg: posts big blind $2
*** HOLE CARDS ***
kVCeGJ4NY7Fb0W74j1mAqA: folds
hpqdC/23wXosGOmzARr5NA: folds
H6Z4+qu8gR0VUiPOijndVg: folds
5Q8U6iZbeO7xJSS4qvDP5g: folds
n5XI5/7gN+gIubHFBH+mOw: folds
5iPk5MyO3KVu18Y8XCYfFQ: raises $2 to $4
De9g+AYjo0DN6C/+iT/nsg: folds
5iPk5MyO3KVu18Y8XCYfFQ collected $4 from pot
5iPk5MyO3KVu18Y8XCYfFQ: doesn't show hand
*** SUMMARY ***
Total pot $4 | Rake $0
Seat 1: hpqdC/23wXosGOmzARr5NA folded before Flop (didn't bet)
Seat 2: H6Z4+qu8gR0VUiPOijndVg folded before Flop (didn't bet)
Seat 3: 5Q8U6iZbeO7xJSS4qvDP5g folded before Flop (didn't bet)
Seat 4: n5XI5/7gN+gIubHFBH+mOw (button) folded before Flop (didn't bet)
Seat 6: 5iPk5MyO3KVu18Y8XCYfFQ (small blind) collected ($4)
Seat 8: De9g+AYjo0DN6C/+iT/nsg (big blind) folded before Flop
Seat 9: kVCeGJ4NY7Fb0W74j1mAqA folded before Flop (didn't bet)



PokerStars Game #59938260000:  Hold'em No Limit ($1/$2) - 2009/07/01 0:10:45 ET
Table 'jlrIxbrVIG+gjaUYT4za8g' 6-max Seat #5 is the button
Seat 1: ygTTt5ehT4aF86q1a8/R+w ($196.05 in chips)
Seat 2: N18PrNGQj43J7TJuQuu+tw ($135.80 in chips)
Seat 4: 8srN1dKQePlsv0GyTada+Q ($200 in chips)
Seat 5: F/075N6nU34Fn0zr6qD3aw ($162.55 in chips)
Seat 6: vkfxu8f/jMYKUk6Ly4eujw ($283.60 in chips)
vkfxu8f/jMYKUk6Ly4eujw: posts small blind $1
ygTTt5ehT4aF86q1a8/R+w: posts big blind $2
54yWzRRgS0oZ+S6LwZBxMQ: sits out
*** HOLE CARDS ***
N18PrNGQj43J7TJuQuu+tw: folds
8srN1dKQePlsv0GyTada+Q: folds
F/075N6nU34Fn0zr6qD3aw: folds
vkfxu8f/jMYKUk6Ly4eujw: folds
ygTTt5ehT4aF86q1a8/R+w collected $2 from pot
*** SUMMARY ***
Total pot $2 | Rake $0
Seat 1: ygTTt5ehT4aF86q1a8/R+w (big blind) collected ($2)
Seat 2: N18PrNGQj43J7TJuQuu+tw folded before Flop (didn't bet)
Seat 4: 8srN1dKQePlsv0GyTada+Q folded before Flop (didn't bet)
Seat 5: F/075N6nU34Fn0zr6qD3aw (button) folded before Flop (didn't bet)
Seat 6: vkfxu8f/jMYKUk6Ly4eujw (small blind) folded before Flop



PokerStars Game #59938262430:  Hold'em No Limit ($1/$2) - 2009/07/01 0:10:48 ET
Table 'LL4bDFyhj5hsMpzaDugJZg' 6-max Seat #2 is the button
Seat 1: IBW9lyGsaRmfcbyA/qFfEw ($67.20 in chips)
Seat 2: L3l+A4pJhOAD6HVVFXvVBw ($291.95 in chips)
Seat 3: gGPaCoSWW1HoKYaqfAPecg ($203 in chips)
Seat 4: 8srN1dKQePlsv0GyTada+Q ($287.75 in chips)
Seat 5: HgX0VeqE/dzSXd5BpntRBw ($203 in chips)
Seat 6: yZgdnRylE65JbScQ7qCWgw ($37 in chips)
gGPaCoSWW1HoKYaqfAPecg: posts small blind $1
8srN1dKQePlsv0GyTada+Q: posts big blind $2
*** HOLE CARDS ***
HgX0VeqE/dzSXd5BpntRBw: folds
yZgdnRylE65JbScQ7qCWgw: folds
IBW9lyGsaRmfcbyA/qFfEw: folds
L3l+A4pJhOAD6HVVFXvVBw: folds
gGPaCoSWW1HoKYaqfAPecg: folds
8srN1dKQePlsv0GyTada+Q collected $2 from pot
*** SUMMARY ***
Total pot $2 | Rake $0
Seat 1: IBW9lyGsaRmfcbyA/qFfEw folded before Flop (didn't bet)
Seat 2: L3l+A4pJhOAD6HVVFXvVBw (button) folded before Flop (didn't bet)
Seat 3: gGPaCoSWW1HoKYaqfAPecg (small blind) folded before Flop
Seat 4: 8srN1dKQePlsv0GyTada+Q (big blind) collected ($2)
Seat 5: HgX0VeqE/dzSXd5BpntRBw folded before Flop (didn't bet)
Seat 6: yZgdnRylE65JbScQ7qCWgw folded before Flop (didn't bet)



PokerStars Game #59938263122:  Hold'em No Limit ($1/$2) - 2009/07/01 0:10:49 ET
Table 'bJQ024BaYSBrW0sXpCZbNQ' 6-max Seat #2 is the button
Seat 2: 1njbh8TKSUF6l4V1XwGdcg ($260 in chips)
Seat 3: vkfxu8f/jMYKUk6Ly4eujw ($212.60 in chips)
Seat 4: 9ni/OEXAqfc58zPQ0Tu9rQ ($268.60 in chips)
Seat 5: X7GlkHF+lkbarCLuZ4Uf0w ($48.15 in chips)
Seat 6: 9dpyyjDTCed6nV7JhaUUpw ($209.50 in chips)
vkfxu8f/jMYKUk6Ly4eujw: posts small blind $1
9ni/OEXAqfc58zPQ0Tu9rQ: posts big blind $2
*** HOLE CARDS ***
X7GlkHF+lkbarCLuZ4Uf0w: folds
9dpyyjDTCed6nV7JhaUUpw: folds
1njbh8TKSUF6l4V1XwGdcg: raises $4 to $6
vkfxu8f/jMYKUk6Ly4eujw: folds
9ni/OEXAqfc58zPQ0Tu9rQ: folds
1njbh8TKSUF6l4V1XwGdcg collected $5 from pot
*** SUMMARY ***
Total pot $5 | Rake $0
Seat 2: 1njbh8TKSUF6l4V1XwGdcg (button) collected ($5)
Seat 3: vkfxu8f/jMYKUk6Ly4eujw (small blind) folded before Flop
Seat 4: 9ni/OEXAqfc58zPQ0Tu9rQ (big blind) folded before Flop
Seat 5: X7GlkHF+lkbarCLuZ4Uf0w folded before Flop (didn't bet)
Seat 6: 9dpyyjDTCed6nV7JhaUUpw folded before Flop (didn't bet)



PokerStars Game #59938262958:  Hold'em No Limit ($1/$2) - 2009/07/01 0:10:49 ET
Table 'SF49/KQm8T4taMp6kb+HXA' 9-max Seat #5 is the button
Seat 1: l1bCLGuFqeFRwUfPsiDu/g ($173.95 in chips)
Seat 2: 8Z3QifiM9eOd5EIJ25dXNg ($109.15 in chips)
Seat 4: HffgoYm61KgkdMe/DYChIQ ($34 in chips)
Seat 5: Z3aYCZG/yXHYFjiWkGI5ug ($226.55 in chips)
Seat 6: M2ht6rIKOI/my9eh610Nlw ($245.45 in chips)
Seat 7: n2VAbLaE5qgKr5mA4W6v4w ($54.50 in chips)
Seat 8: 5iPk5MyO3KVu18Y8XCYfFQ ($39 in chips)
Seat 9: O+jytCilwk7zItVCEavmtw ($143 in chips)
M2ht6rIKOI/my9eh610Nlw: posts small blind $1
n2VAbLaE5qgKr5mA4W6v4w: posts big blind $2
*** HOLE CARDS ***
5iPk5MyO3KVu18Y8XCYfFQ: folds
O+jytCilwk7zItVCEavmtw: folds
l1bCLGuFqeFRwUfPsiDu/g: raises $6 to $8
8Z3QifiM9eOd5EIJ25dXNg: folds
HffgoYm61KgkdMe/DYChIQ: folds
Z3aYCZG/yXHYFjiWkGI5ug: folds
L88dtdULfz5oGDSuo9/RvA leaves the table
M2ht6rIKOI/my9eh610Nlw: folds
n2VAbLaE5qgKr5mA4W6v4w: folds
l1bCLGuFqeFRwUfPsiDu/g collected $5 from pot
*** SUMMARY ***
Total pot $5 | Rake $0
Seat 1: l1bCLGuFqeFRwUfPsiDu/g collected ($5)
Seat 2: 8Z3QifiM9eOd5EIJ25dXNg folded before Flop (didn't bet)
Seat 4: HffgoYm61KgkdMe/DYChIQ folded before Flop (didn't bet)
Seat 5: Z3aYCZG/yXHYFjiWkGI5ug (button) folded before Flop (didn't bet)
Seat 6: M2ht6rIKOI/my9eh610Nlw (small blind) folded before Flop
Seat 7: n2VAbLaE5qgKr5mA4W6v4w (big blind) folded before Flop
Seat 8: 5iPk5MyO3KVu18Y8XCYfFQ folded before Flop (didn't bet)
Seat 9: O+jytCilwk7zItVCEavmtw folded before Flop (didn't bet)



PokerStars Game #59938262770:  Hold'em No Limit ($1/$2) - 2009/07/01 0:10:49 ET
Table 'YqGfR5eHfMeSjb9a+QU9rg' 9-max Seat #1 is the button
Seat 1: qCBuzVnLcBR29snMAHq9PA ($136.90 in chips)
Seat 2: W3Nqt1GWlTi9tXQXMNEvgw ($259.95 in chips)
Seat 3: /gll27k+xWYV7Fbki0lFDQ ($88.25 in chips)
Seat 4: QHxJjpVYwitg9krW6wZgJA ($200 in chips)
Seat 5: MOBMOMQRN/z+fiGXGnZojw ($173.10 in chips)
Seat 6: 5iPk5MyO3KVu18Y8XCYfFQ ($46 in chips)
Seat 7: b0jO1SDhLedy1//CQlA8kw ($39 in chips)
Seat 8: JnV3SM2D6dAFYyGZHHpvrg ($97 in chips)
W3Nqt1GWlTi9tXQXMNEvgw: posts small blind $1
/gll27k+xWYV7Fbki0lFDQ: posts big blind $2
*** HOLE CARDS ***
QHxJjpVYwitg9krW6wZgJA: folds
MOBMOMQRN/z+fiGXGnZojw: folds
5iPk5MyO3KVu18Y8XCYfFQ: folds
b0jO1SDhLedy1//CQlA8kw: folds
JnV3SM2D6dAFYyGZHHpvrg: folds
qCBuzVnLcBR29snMAHq9PA: folds
W3Nqt1GWlTi9tXQXMNEvgw: calls $1
/gll27k+xWYV7Fbki0lFDQ: checks
*** FLOP *** [As Kc 8d]
W3Nqt1GWlTi9tXQXMNEvgw: checks
/gll27k+xWYV7Fbki0lFDQ: bets $4
W3Nqt1GWlTi9tXQXMNEvgw: folds
/gll27k+xWYV7Fbki0lFDQ collected $3.80 from pot
*** SUMMARY ***
Total pot $4 | Rake $0.20
Board [As Kc 8d]
Seat 1: qCBuzVnLcBR29snMAHq9PA (button) folded before Flop (didn't bet)
Seat 2: W3Nqt1GWlTi9tXQXMNEvgw (small blind) folded on the Flop
Seat 3: /gll27k+xWYV7Fbki0lFDQ (big blind) collected ($3.80)
Seat 4: QHxJjpVYwitg9krW6wZgJA folded before Flop (didn't bet)
Seat 5: MOBMOMQRN/z+fiGXGnZojw folded before Flop (didn't bet)
Seat 6: 5iPk5MyO3KVu18Y8XCYfFQ folded before Flop (didn't bet)
Seat 7: b0jO1SDhLedy1//CQlA8kw folded before Flop (didn't bet)
Seat 8: JnV3SM2D6dAFYyGZHHpvrg folded before Flop (didn't bet)



PokerStars Game #59938263874:  Hold'em No Limit ($1/$2) - 2009/07/01 0:10:50 ET
Table 'l5lZHc5JRHEDt0Y2AVPq3g' 6-max Seat #4 is the button
Seat 1: gGPaCoSWW1HoKYaqfAPecg ($211.50 in chips)
Seat 2: my38j/MmtBd/8qVwmyCREA ($250.35 in chips)
Seat 4: zNjJ/y4emmF+vzrCDd+ooA ($205.55 in chips)
Seat 5: 6fLdOUCRtX71xbVRhJEq8w ($200 in chips)
Seat 6: vkfxu8f/jMYKUk6Ly4eujw ($206.30 in chips)
6fLdOUCRtX71xbVRhJEq8w: posts small blind $1
vkfxu8f/jMYKUk6Ly4eujw: posts big blind $2
*** HOLE CARDS ***
gGPaCoSWW1HoKYaqfAPecg: raises $5 to $7
my38j/MmtBd/8qVwmyCREA: folds
zNjJ/y4emmF+vzrCDd+ooA: folds
6fLdOUCRtX71xbVRhJEq8w: folds
vkfxu8f/jMYKUk6Ly4eujw: folds
gGPaCoSWW1HoKYaqfAPecg collected $5 from pot
gGPaCoSWW1HoKYaqfAPecg: doesn't show hand
*** SUMMARY ***
Total pot $5 | Rake $0
Seat 1: gGPaCoSWW1HoKYaqfAPecg collected ($5)
Seat 2: my38j/MmtBd/8qVwmyCREA folded before Flop (didn't bet)
Seat 4: zNjJ/y4emmF+vzrCDd+ooA (button) folded before Flop (didn't bet)
Seat 5: 6fLdOUCRtX71xbVRhJEq8w (small blind) folded before Flop
Seat 6: vkfxu8f/jMYKUk6Ly4eujw (big blind) folded before Flop



PokerStars Game #59938263724:  Hold'em No Limit ($1/$2) - 2009/07/01 0:10:50 ET
Table 'eyAQSIlgc2o1Jxvbve4WGg' 9-max Seat #5 is the button
Seat 1: Q3uFdu6ztesjDFiqkagTRQ ($234 in chips)
Seat 3: TAfo4veNRaRlzDXMMYS3Jg ($37 in chips)
Seat 5: JnV3SM2D6dAFYyGZHHpvrg ($97 in chips)
Seat 6: IikcENBHwoT7snSvBPSc7Q ($180.60 in chips)
Seat 7: QHxJjpVYwitg9krW6wZgJA ($200 in chips)
Seat 8: 5iPk5MyO3KVu18Y8XCYfFQ ($36 in chips)
Seat 9: Hc2itIxwbi1lwa+DAYYQGg ($46.85 in chips)
IikcENBHwoT7snSvBPSc7Q: posts small blind $1
QHxJjpVYwitg9krW6wZgJA: posts big blind $2
*** HOLE CARDS ***
5iPk5MyO3KVu18Y8XCYfFQ: folds
Hc2itIxwbi1lwa+DAYYQGg: folds
Q3uFdu6ztesjDFiqkagTRQ: folds
TAfo4veNRaRlzDXMMYS3Jg: folds
JnV3SM2D6dAFYyGZHHpvrg: folds
IikcENBHwoT7snSvBPSc7Q: raises $4 to $6
QHxJjpVYwitg9krW6wZgJA: folds
IikcENBHwoT7snSvBPSc7Q collected $4 from pot
IikcENBHwoT7snSvBPSc7Q: doesn't show hand
*** SUMMARY ***
Total pot $4 | Rake $0
Seat 1: Q3uFdu6ztesjDFiqkagTRQ folded before Flop (didn't bet)
Seat 3: TAfo4veNRaRlzDXMMYS3Jg folded before Flop (didn't bet)
Seat 5: JnV3SM2D6dAFYyGZHHpvrg (button) folded before Flop (didn't bet)
Seat 6: IikcENBHwoT7snSvBPSc7Q (small blind) collected ($4)
Seat 7: QHxJjpVYwitg9krW6wZgJA (big blind) folded before Flop
Seat 8: 5iPk5MyO3KVu18Y8XCYfFQ folded before Flop (didn't bet)
Seat 9: Hc2itIxwbi1lwa+DAYYQGg folded before Flop (didn't bet)



PokerStars Game #59938265784:  Hold'em No Limit ($1/$2) - 2009/07/01 0:10:53 ET
Table 'pPQgcj9XT9CHBsbo1WTBug' 6-max Seat #5 is the button
Seat 1: DFVYDA6dKQy7R7mGIKogZA ($74.30 in chips)
Seat 2: X7GlkHF+lkbarCLuZ4Uf0w ($45.55 in chips)
Seat 3: vkfxu8f/jMYKUk6Ly4eujw ($190 in chips)
Seat 5: 4Cl43Q1TYQL8wn1NSCUkaw ($60.90 in chips)
DFVYDA6dKQy7R7mGIKogZA: posts small blind $1
X7GlkHF+lkbarCLuZ4Uf0w: posts big blind $2
*** HOLE CARDS ***
vkfxu8f/jMYKUk6Ly4eujw: raises $4 to $6
4Cl43Q1TYQL8wn1NSCUkaw: folds
DFVYDA6dKQy7R7mGIKogZA: folds
X7GlkHF+lkbarCLuZ4Uf0w: folds
vkfxu8f/jMYKUk6Ly4eujw collected $5 from pot
vkfxu8f/jMYKUk6Ly4eujw: doesn't show hand
*** SUMMARY ***
Total pot $5 | Rake $0
Seat 1: DFVYDA6dKQy7R7mGIKogZA (small blind) folded before Flop
Seat 2: X7GlkHF+lkbarCLuZ4Uf0w (big blind) folded before Flop
Seat 3: vkfxu8f/jMYKUk6Ly4eujw collected ($5)
Seat 5: 4Cl43Q1TYQL8wn1NSCUkaw (button) folded before Flop (didn't bet)



PokerStars Game #59938266238:  Hold'em No Limit ($1/$2) - 2009/07/01 0:10:54 ET
Table 'NmY84NAf9Mh0ckAckHnh5g' 2-max Seat #1 is the button
Seat 1: 6hvg964TSqZ3AL/0XK9aVQ ($343.25 in chips)
Seat 2: RwDoM55ZeQuI2ADyJhOb2Q ($248.55 in chips)
6hvg964TSqZ3AL/0XK9aVQ: posts small blind $1
RwDoM55ZeQuI2ADyJhOb2Q: posts big blind $2
*** HOLE CARDS ***
6hvg964TSqZ3AL/0XK9aVQ: calls $1
RwDoM55ZeQuI2ADyJhOb2Q: raises $8 to $10
6hvg964TSqZ3AL/0XK9aVQ: calls $8
*** FLOP *** [6d 3d Jh]
RwDoM55ZeQuI2ADyJhOb2Q: checks
6hvg964TSqZ3AL/0XK9aVQ: checks
*** TURN *** [6d 3d Jh] [4s]
RwDoM55ZeQuI2ADyJhOb2Q: checks
6hvg964TSqZ3AL/0XK9aVQ: checks
*** RIVER *** [6d 3d Jh 4s] [Kd]
RwDoM55ZeQuI2ADyJhOb2Q: checks
6hvg964TSqZ3AL/0XK9aVQ: bets $26
RwDoM55ZeQuI2ADyJhOb2Q: folds
6hvg964TSqZ3AL/0XK9aVQ collected $19.50 from pot
*** SUMMARY ***
Total pot $20 | Rake $0.50
Board [6d 3d Jh 4s Kd]
Seat 1: 6hvg964TSqZ3AL/0XK9aVQ (button) (small blind) collected ($19.50)
Seat 2: RwDoM55ZeQuI2ADyJhOb2Q (big blind) folded on the River



PokerStars Game #59938267338:  Hold'em No Limit ($1/$2) - 2009/07/01 0:10:55 ET
Table 'CFkQcfWjKccZaZDf71FK+w' 6-max Seat #5 is the button
Seat 1: X7GlkHF+lkbarCLuZ4Uf0w ($27 in chips)
Seat 2: yZgdnRylE65JbScQ7qCWgw ($13 in chips)
Seat 5: 1njbh8TKSUF6l4V1XwGdcg ($232 in chips)
Seat 6: ORVqY3rf9X6ANA/8s+On2Q ($67 in chips)
ORVqY3rf9X6ANA/8s+On2Q: posts small blind $1
X7GlkHF+lkbarCLuZ4Uf0w: posts big blind $2
*** HOLE CARDS ***
yZgdnRylE65JbScQ7qCWgw: folds
1njbh8TKSUF6l4V1XwGdcg: folds
ORVqY3rf9X6ANA/8s+On2Q: calls $1
yZgdnRylE65JbScQ7qCWgw is sitting out
X7GlkHF+lkbarCLuZ4Uf0w: raises $4 to $6
ORVqY3rf9X6ANA/8s+On2Q: calls $4
*** FLOP *** [9s Td 6c]
ORVqY3rf9X6ANA/8s+On2Q: bets $2
X7GlkHF+lkbarCLuZ4Uf0w: folds
ORVqY3rf9X6ANA/8s+On2Q collected $11.40 from pot
ORVqY3rf9X6ANA/8s+On2Q: doesn't show hand
*** SUMMARY ***
Total pot $12 | Rake $0.60
Board [9s Td 6c]
Seat 1: X7GlkHF+lkbarCLuZ4Uf0w (big blind) folded on the Flop
Seat 2: yZgdnRylE65JbScQ7qCWgw folded before Flop (didn't bet)
Seat 5: 1njbh8TKSUF6l4V1XwGdcg (button) folded before Flop (didn't bet)
Seat 6: ORVqY3rf9X6ANA/8s+On2Q (small blind) collected ($11.40)



PokerStars Game #59938267208:  Hold'em No Limit ($1/$2) - 2009/07/01 0:10:55 ET
Table 'rsKRKlGHlxVyqJxzO2a2Ow' 9-max Seat #3 is the button
Seat 1: uYWfQJg2hgHLxri6/uVJiw ($137.10 in chips)
Seat 2: QHxJjpVYwitg9krW6wZgJA ($244.50 in chips)
Seat 3: 9sYbXdhj1M2bwKrVNxj5+Q ($113.80 in chips)
Seat 4: zJtQ1gxyi72XvGYS1tM+DA ($180.55 in chips)
Seat 5: 5Q8U6iZbeO7xJSS4qvDP5g ($203 in chips)
Seat 6: H6Z4+qu8gR0VUiPOijndVg ($200 in chips)
Seat 7: kVCeGJ4NY7Fb0W74j1mAqA ($200 in chips)
Seat 8: Hc2itIxwbi1lwa+DAYYQGg ($37 in chips)
Seat 9: 5iPk5MyO3KVu18Y8XCYfFQ ($98.10 in chips)
zJtQ1gxyi72XvGYS1tM+DA: posts small blind $1
5Q8U6iZbeO7xJSS4qvDP5g: posts big blind $2
*** HOLE CARDS ***
H6Z4+qu8gR0VUiPOijndVg: folds
kVCeGJ4NY7Fb0W74j1mAqA: folds
Hc2itIxwbi1lwa+DAYYQGg: folds
5iPk5MyO3KVu18Y8XCYfFQ: folds
uYWfQJg2hgHLxri6/uVJiw: folds
QHxJjpVYwitg9krW6wZgJA: folds
9sYbXdhj1M2bwKrVNxj5+Q: folds
zJtQ1gxyi72XvGYS1tM+DA: raises $2 to $4
5Q8U6iZbeO7xJSS4qvDP5g: folds
zJtQ1gxyi72XvGYS1tM+DA collected $4 from pot
zJtQ1gxyi72XvGYS1tM+DA: doesn't show hand
*** SUMMARY ***
Total pot $4 | Rake $0
Seat 1: uYWfQJg2hgHLxri6/uVJiw folded before Flop (didn't bet)
Seat 2: QHxJjpVYwitg9krW6wZgJA folded before Flop (didn't bet)
Seat 3: 9sYbXdhj1M2bwKrVNxj5+Q (button) folded before Flop (didn't bet)
Seat 4: zJtQ1gxyi72XvGYS1tM+DA (small blind) collected ($4)
Seat 5: 5Q8U6iZbeO7xJSS4qvDP5g (big blind) folded before Flop
Seat 6: H6Z4+qu8gR0VUiPOijndVg folded before Flop (didn't bet)
Seat 7: kVCeGJ4NY7Fb0W74j1mAqA folded before Flop (didn't bet)
Seat 8: Hc2itIxwbi1lwa+DAYYQGg folded before Flop (didn't bet)
Seat 9: 5iPk5MyO3KVu18Y8XCYfFQ folded before Flop (didn't bet)



PokerStars Game #59938267646:  Hold'em No Limit ($1/$2) - 2009/07/01 0:10:56 ET
Table 'on4i1U1lCRmxsduFD3xiSg' 9-max Seat #9 is the button
Seat 2: yZYrOeNDxQxkzpbgKX1bng ($67.65 in chips)
Seat 3: 5iPk5MyO3KVu18Y8XCYfFQ ($64.20 in chips)
Seat 4: Z3aYCZG/yXHYFjiWkGI5ug ($446.10 in chips)
Seat 5: QHxJjpVYwitg9krW6wZgJA ($200 in chips)
Seat 6: SB0tvOX0Kw61r2U851JFaA ($200 in chips)
Seat 7: xD4ElYxz6Ollzmam8BmMCw ($244.25 in chips)
Seat 8: cdC54j9fGGojcbzWB5PgzA ($200 in chips)
Seat 9: iMe5yhc+1BaiIPHet3NMrA ($200 in chips)
so5k3vFDmokh2q3dImJ1GQ joins the table at seat #1
yZYrOeNDxQxkzpbgKX1bng: posts small blind $1
5iPk5MyO3KVu18Y8XCYfFQ: posts big blind $2
*** HOLE CARDS ***
Z3aYCZG/yXHYFjiWkGI5ug: folds
QHxJjpVYwitg9krW6wZgJA: folds
SB0tvOX0Kw61r2U851JFaA: raises $4 to $6
xD4ElYxz6Ollzmam8BmMCw: folds
cdC54j9fGGojcbzWB5PgzA: folds
iMe5yhc+1BaiIPHet3NMrA: folds
yZYrOeNDxQxkzpbgKX1bng: folds
5iPk5MyO3KVu18Y8XCYfFQ: folds
SB0tvOX0Kw61r2U851JFaA collected $5 from pot
*** SUMMARY ***
Total pot $5 | Rake $0
Seat 2: yZYrOeNDxQxkzpbgKX1bng (small blind) folded before Flop
Seat 3: 5iPk5MyO3KVu18Y8XCYfFQ (big blind) folded before Flop
Seat 4: Z3aYCZG/yXHYFjiWkGI5ug folded before Flop (didn't bet)
Seat 5: QHxJjpVYwitg9krW6wZgJA folded before Flop (didn't bet)
Seat 6: SB0tvOX0Kw61r2U851JFaA collected ($5)
Seat 7: xD4ElYxz6Ollzmam8BmMCw folded before Flop (didn't bet)
Seat 8: cdC54j9fGGojcbzWB5PgzA folded before Flop (didn't bet)
Seat 9: iMe5yhc+1BaiIPHet3NMrA (button) folded before Flop (didn't bet)



PokerStars Game #59938268568:  Hold'em No Limit ($1/$2) - 2009/07/01 0:10:57 ET
Table 'WCA60bDA8ecovUgFSIZkTQ' 9-max Seat #5 is the button
Seat 2: G1h8wamBcVJXtsKXZQ2EyA ($101.40 in chips)
Seat 3: 5iPk5MyO3KVu18Y8XCYfFQ ($37 in chips)
Seat 4: Q3uFdu6ztesjDFiqkagTRQ ($470.70 in chips)
Seat 5: Hc2itIxwbi1lwa+DAYYQGg ($306.30 in chips)
Seat 6: DOWQSOJ7GaX+ksfWTqPT5A ($229.35 in chips)
Seat 8: x+V1JgVDawsJTxKcxm7gxw ($94 in chips)
Seat 9: 3q2/0oJr3Mcy1W5tcN61ug ($298.20 in chips)
DOWQSOJ7GaX+ksfWTqPT5A: posts small blind $1
x+V1JgVDawsJTxKcxm7gxw: posts big blind $2
CUZwDpLTQKhzarPe+JCLOQ: sits out
*** HOLE CARDS ***
3q2/0oJr3Mcy1W5tcN61ug: folds
G1h8wamBcVJXtsKXZQ2EyA: folds
5iPk5MyO3KVu18Y8XCYfFQ: folds
Q3uFdu6ztesjDFiqkagTRQ: raises $4 to $6
Hc2itIxwbi1lwa+DAYYQGg: folds
DOWQSOJ7GaX+ksfWTqPT5A: calls $5
x+V1JgVDawsJTxKcxm7gxw: calls $4
*** FLOP *** [Jd 6s 7d]
DOWQSOJ7GaX+ksfWTqPT5A: checks
x+V1JgVDawsJTxKcxm7gxw: checks
Q3uFdu6ztesjDFiqkagTRQ: checks
*** TURN *** [Jd 6s 7d] [5c]
DOWQSOJ7GaX+ksfWTqPT5A: bets $6
x+V1JgVDawsJTxKcxm7gxw: calls $6
Q3uFdu6ztesjDFiqkagTRQ: folds
*** RIVER *** [Jd 6s 7d 5c] [9d]
DOWQSOJ7GaX+ksfWTqPT5A: bets $12
x+V1JgVDawsJTxKcxm7gxw: calls $12
*** SHOW DOWN ***
DOWQSOJ7GaX+ksfWTqPT5A: shows [8h Th] (a straight, Seven to Jack)
x+V1JgVDawsJTxKcxm7gxw: mucks hand
DOWQSOJ7GaX+ksfWTqPT5A collected $51.40 from pot
*** SUMMARY ***
Total pot $54 | Rake $2.60
Board [Jd 6s 7d 5c 9d]
Seat 2: G1h8wamBcVJXtsKXZQ2EyA folded before Flop (didn't bet)
Seat 3: 5iPk5MyO3KVu18Y8XCYfFQ folded before Flop (didn't bet)
Seat 4: Q3uFdu6ztesjDFiqkagTRQ folded on the Turn
Seat 5: Hc2itIxwbi1lwa+DAYYQGg (button) folded before Flop (didn't bet)
Seat 6: DOWQSOJ7GaX+ksfWTqPT5A (small blind) showed [8h Th] and won ($51.40) with a straight, Seven to Jack
Seat 8: x+V1JgVDawsJTxKcxm7gxw (big blind) mucked
Seat 9: 3q2/0oJr3Mcy1W5tcN61ug folded before Flop (didn't bet)



PokerStars Game #59938269460:  Hold'em No Limit ($1/$2) - 2009/07/01 0:10:58 ET
Table 'HewZCzVOYGmuLDKthTi5Yw' 6-max Seat #5 is the button
Seat 1: 353332 ($254.95 in chips)
Seat 2: X7GlkHF+lkbarCLuZ4Uf0w ($28 in chips)
Seat 3: WJxW31eStwT28R2X/L8F5A ($53.05 in chips)
Seat 5: 513FcCI8jHyQy2VWoIQkMg ($364.95 in chips)
Seat 6: /3OfVkAn8WikCv83i4bHHw ($118 in chips)
/3OfVkAn8WikCv83i4bHHw: posts small blind $1
353332: posts big blind $2
*** HOLE CARDS ***
X7GlkHF+lkbarCLuZ4Uf0w: folds
WJxW31eStwT28R2X/L8F5A: folds
513FcCI8jHyQy2VWoIQkMg: raises $4 to $6
/3OfVkAn8WikCv83i4bHHw: folds
353332: folds
513FcCI8jHyQy2VWoIQkMg collected $5 from pot
*** SUMMARY ***
Total pot $5 | Rake $0
Seat 1: 353332 (big blind) folded before Flop
Seat 2: X7GlkHF+lkbarCLuZ4Uf0w folded before Flop (didn't bet)
Seat 3: WJxW31eStwT28R2X/L8F5A folded before Flop (didn't bet)
Seat 5: 513FcCI8jHyQy2VWoIQkMg (button) collected ($5)
Seat 6: /3OfVkAn8WikCv83i4bHHw (small blind) folded before Flop



PokerStars Game #59938272758:  Hold'em No Limit ($1/$2) - 2009/07/01 0:11:03 ET
Table 'aSf77Sj8QEnzcc0WaxVD4Q' 6-max Seat #1 is the button
Seat 1: Q3uFdu6ztesjDFiqkagTRQ ($225.35 in chips)
Seat 2: vkfxu8f/jMYKUk6Ly4eujw ($193.75 in chips)
Seat 3: 9dpyyjDTCed6nV7JhaUUpw ($223.05 in chips)
Seat 4: 513FcCI8jHyQy2VWoIQkMg ($200 in chips)
Seat 5: InmkdI6G8TzSj9NhcCSyPg ($250 in chips)
Seat 6: vkoJRf3gidxY1pPi0AFWww ($332.60 in chips)
vkfxu8f/jMYKUk6Ly4eujw: posts small blind $1
9dpyyjDTCed6nV7JhaUUpw: posts big blind $2
*** HOLE CARDS ***
513FcCI8jHyQy2VWoIQkMg: folds
InmkdI6G8TzSj9NhcCSyPg: folds
vkoJRf3gidxY1pPi0AFWww: raises $4 to $6
Q3uFdu6ztesjDFiqkagTRQ: raises $14 to $20
vkfxu8f/jMYKUk6Ly4eujw: folds
9dpyyjDTCed6nV7JhaUUpw: folds
vkoJRf3gidxY1pPi0AFWww: calls $14
*** FLOP *** [4d 2c Td]
vkoJRf3gidxY1pPi0AFWww: checks
Q3uFdu6ztesjDFiqkagTRQ: bets $30
vkoJRf3gidxY1pPi0AFWww: folds
Q3uFdu6ztesjDFiqkagTRQ collected $40.85 from pot
Q3uFdu6ztesjDFiqkagTRQ: doesn't show hand
*** SUMMARY ***
Total pot $43 | Rake $2.15
Board [4d 2c Td]
Seat 1: Q3uFdu6ztesjDFiqkagTRQ (button) collected ($40.85)
Seat 2: vkfxu8f/jMYKUk6Ly4eujw (small blind) folded before Flop
Seat 3: 9dpyyjDTCed6nV7JhaUUpw (big blind) folded before Flop
Seat 4: 513FcCI8jHyQy2VWoIQkMg folded before Flop (didn't bet)
Seat 5: InmkdI6G8TzSj9NhcCSyPg folded before Flop (didn't bet)
Seat 6: vkoJRf3gidxY1pPi0AFWww folded on the Flop



PokerStars Game #59938274792:  Hold'em No Limit ($1/$2) - 2009/07/01 0:11:06 ET
Table '3FGoiEOffWrbgTfsB3t7FA' 2-max Seat #2 is the button
Seat 1: e0oDWyrmgLpR6bROEqw1nQ ($328.50 in chips)
Seat 2: +sy/nlNI20yZraIjs4AALg ($274.15 in chips)
+sy/nlNI20yZraIjs4AALg: posts small blind $1
e0oDWyrmgLpR6bROEqw1nQ: posts big blind $2
*** HOLE CARDS ***
+sy/nlNI20yZraIjs4AALg: calls $1
e0oDWyrmgLpR6bROEqw1nQ: raises $4 to $6
+sy/nlNI20yZraIjs4AALg: calls $4
*** FLOP *** [Ts 7c 2d]
e0oDWyrmgLpR6bROEqw1nQ: bets $8
+sy/nlNI20yZraIjs4AALg: folds
e0oDWyrmgLpR6bROEqw1nQ collected $11.50 from pot
*** SUMMARY ***
Total pot $12 | Rake $0.50
Board [Ts 7c 2d]
Seat 1: e0oDWyrmgLpR6bROEqw1nQ (big blind) collected ($11.50)
Seat 2: +sy/nlNI20yZraIjs4AALg (button) (small blind) folded on the Flop



PokerStars Game #59938275170:  Hold'em No Limit ($1/$2) - 2009/07/01 0:11:06 ET
Table 'jlrIxbrVIG+gjaUYT4za8g' 6-max Seat #6 is the button
Seat 1: ygTTt5ehT4aF86q1a8/R+w ($197.05 in chips)
Seat 2: N18PrNGQj43J7TJuQuu+tw ($135.80 in chips)
Seat 4: 8srN1dKQePlsv0GyTada+Q ($200 in chips)
Seat 5: F/075N6nU34Fn0zr6qD3aw ($162.55 in chips)
Seat 6: vkfxu8f/jMYKUk6Ly4eujw ($282.60 in chips)
ygTTt5ehT4aF86q1a8/R+w: posts small blind $1
N18PrNGQj43J7TJuQuu+tw: posts big blind $2
54yWzRRgS0oZ+S6LwZBxMQ: sits out
*** HOLE CARDS ***
8srN1dKQePlsv0GyTada+Q: folds
F/075N6nU34Fn0zr6qD3aw: folds
vkfxu8f/jMYKUk6Ly4eujw: raises $4 to $6
ygTTt5ehT4aF86q1a8/R+w: folds
N18PrNGQj43J7TJuQuu+tw: calls $4
*** FLOP *** [6c Jh Jc]
N18PrNGQj43J7TJuQuu+tw: checks
vkfxu8f/jMYKUk6Ly4eujw: bets $8
N18PrNGQj43J7TJuQuu+tw: folds
vkfxu8f/jMYKUk6Ly4eujw collected $12.35 from pot
*** SUMMARY ***
Total pot $13 | Rake $0.65
Board [6c Jh Jc]
Seat 1: ygTTt5ehT4aF86q1a8/R+w (small blind) folded before Flop
Seat 2: N18PrNGQj43J7TJuQuu+tw (big blind) folded on the Flop
Seat 4: 8srN1dKQePlsv0GyTada+Q folded before Flop (didn't bet)
Seat 5: F/075N6nU34Fn0zr6qD3aw folded before Flop (didn't bet)
Seat 6: vkfxu8f/jMYKUk6Ly4eujw (button) collected ($12.35)



PokerStars Game #59938275250:  Hold'em No Limit ($1/$2) - 2009/07/01 0:11:07 ET
Table 'gnHBqWll9O3fxG7Ojkz/ng' 9-max Seat #6 is the button
Seat 1: hpqdC/23wXosGOmzARr5NA ($156.30 in chips)
Seat 2: H6Z4+qu8gR0VUiPOijndVg ($203 in chips)
Seat 3: 5Q8U6iZbeO7xJSS4qvDP5g ($218.60 in chips)
Seat 4: n5XI5/7gN+gIubHFBH+mOw ($401.85 in chips)
Seat 6: 5iPk5MyO3KVu18Y8XCYfFQ ($52.45 in chips)
Seat 8: De9g+AYjo0DN6C/+iT/nsg ($242.05 in chips)
Seat 9: kVCeGJ4NY7Fb0W74j1mAqA ($206 in chips)
De9g+AYjo0DN6C/+iT/nsg: posts small blind $1
kVCeGJ4NY7Fb0W74j1mAqA: posts big blind $2
*** HOLE CARDS ***
hpqdC/23wXosGOmzARr5NA: calls $2
H6Z4+qu8gR0VUiPOijndVg: folds
5Q8U6iZbeO7xJSS4qvDP5g: folds
n5XI5/7gN+gIubHFBH+mOw: folds
5iPk5MyO3KVu18Y8XCYfFQ: folds
De9g+AYjo0DN6C/+iT/nsg: folds
kVCeGJ4NY7Fb0W74j1mAqA: checks
*** FLOP *** [Kd Ad 6c]
kVCeGJ4NY7Fb0W74j1mAqA: checks
hpqdC/23wXosGOmzARr5NA: bets $6
kVCeGJ4NY7Fb0W74j1mAqA: folds
hpqdC/23wXosGOmzARr5NA collected $4.75 from pot
hpqdC/23wXosGOmzARr5NA: doesn't show hand
*** SUMMARY ***
Total pot $5 | Rake $0.25
Board [Kd Ad 6c]
Seat 1: hpqdC/23wXosGOmzARr5NA collected ($4.75)
Seat 2: H6Z4+qu8gR0VUiPOijndVg folded before Flop (didn't bet)
Seat 3: 5Q8U6iZbeO7xJSS4qvDP5g folded before Flop (didn't bet)
Seat 4: n5XI5/7gN+gIubHFBH+mOw folded before Flop (didn't bet)
Seat 6: 5iPk5MyO3KVu18Y8XCYfFQ (button) folded before Flop (didn't bet)
Seat 8: De9g+AYjo0DN6C/+iT/nsg (small blind) folded before Flop
Seat 9: kVCeGJ4NY7Fb0W74j1mAqA (big blind) folded on the Flop



PokerStars Game #59938277142:  Hold'em No Limit ($1/$2) - 2009/07/01 0:11:09 ET
Table 'XP2sRSup+aRuwzx3vDZsDg' 6-max Seat #1 is the button
Seat 1: o9jamqIi6sTTRSqudgboRA ($237.70 in chips)
Seat 3: X7GlkHF+lkbarCLuZ4Uf0w ($28.50 in chips)
Seat 4: JsC+WvfzqlxVs9G8/gSQAQ ($86.40 in chips)
Seat 5: vkfxu8f/jMYKUk6Ly4eujw ($192 in chips)
Seat 6: h7ppRQJTYBsHCbLMeW9T2g ($487.75 in chips)
X7GlkHF+lkbarCLuZ4Uf0w: posts small blind $1
JsC+WvfzqlxVs9G8/gSQAQ: posts big blind $2
*** HOLE CARDS ***
vkfxu8f/jMYKUk6Ly4eujw: folds
h7ppRQJTYBsHCbLMeW9T2g: folds
o9jamqIi6sTTRSqudgboRA: folds
X7GlkHF+lkbarCLuZ4Uf0w: raises $3 to $5
JsC+WvfzqlxVs9G8/gSQAQ: folds
X7GlkHF+lkbarCLuZ4Uf0w collected $4 from pot
*** SUMMARY ***
Total pot $4 | Rake $0
Seat 1: o9jamqIi6sTTRSqudgboRA (button) folded before Flop (didn't bet)
Seat 3: X7GlkHF+lkbarCLuZ4Uf0w (small blind) collected ($4)
Seat 4: JsC+WvfzqlxVs9G8/gSQAQ (big blind) folded before Flop
Seat 5: vkfxu8f/jMYKUk6Ly4eujw folded before Flop (didn't bet)
Seat 6: h7ppRQJTYBsHCbLMeW9T2g folded before Flop (didn't bet)



PokerStars Game #59938277616:  Hold'em No Limit ($1/$2) - 2009/07/01 0:11:10 ET
Table 'LL4bDFyhj5hsMpzaDugJZg' 6-max Seat #3 is the button
Seat 1: IBW9lyGsaRmfcbyA/qFfEw ($67.20 in chips)
Seat 2: L3l+A4pJhOAD6HVVFXvVBw ($291.95 in chips)
Seat 3: gGPaCoSWW1HoKYaqfAPecg ($202 in chips)
Seat 4: 8srN1dKQePlsv0GyTada+Q ($288.75 in chips)
Seat 5: HgX0VeqE/dzSXd5BpntRBw ($203 in chips)
Seat 6: yZgdnRylE65JbScQ7qCWgw ($37 in chips)
8srN1dKQePlsv0GyTada+Q: posts small blind $1
HgX0VeqE/dzSXd5BpntRBw: posts big blind $2
*** HOLE CARDS ***
yZgdnRylE65JbScQ7qCWgw: folds
yZgdnRylE65JbScQ7qCWgw is sitting out
IBW9lyGsaRmfcbyA/qFfEw: folds
L3l+A4pJhOAD6HVVFXvVBw: folds
gGPaCoSWW1HoKYaqfAPecg: folds
8srN1dKQePlsv0GyTada+Q: raises $4 to $6
HgX0VeqE/dzSXd5BpntRBw: folds
8srN1dKQePlsv0GyTada+Q collected $4 from pot
*** SUMMARY ***
Total pot $4 | Rake $0
Seat 1: IBW9lyGsaRmfcbyA/qFfEw folded before Flop (didn't bet)
Seat 2: L3l+A4pJhOAD6HVVFXvVBw folded before Flop (didn't bet)
Seat 3: gGPaCoSWW1HoKYaqfAPecg (button) folded before Flop (didn't bet)
Seat 4: 8srN1dKQePlsv0GyTada+Q (small blind) collected ($4)
Seat 5: HgX0VeqE/dzSXd5BpntRBw (big blind) folded before Flop
Seat 6: yZgdnRylE65JbScQ7qCWgw folded before Flop (didn't bet)



PokerStars Game #59938280056:  Hold'em No Limit ($1/$2) - 2009/07/01 0:11:13 ET
Table 'YqGfR5eHfMeSjb9a+QU9rg' 9-max Seat #2 is the button
Seat 1: qCBuzVnLcBR29snMAHq9PA ($136.90 in chips)
Seat 2: W3Nqt1GWlTi9tXQXMNEvgw ($257.95 in chips)
Seat 3: /gll27k+xWYV7Fbki0lFDQ ($90.05 in chips)
Seat 4: QHxJjpVYwitg9krW6wZgJA ($200 in chips)
Seat 5: MOBMOMQRN/z+fiGXGnZojw ($173.10 in chips)
Seat 6: 5iPk5MyO3KVu18Y8XCYfFQ ($46 in chips)
Seat 7: b0jO1SDhLedy1//CQlA8kw ($39 in chips)
Seat 8: JnV3SM2D6dAFYyGZHHpvrg ($97 in chips)
/gll27k+xWYV7Fbki0lFDQ: posts small blind $1
QHxJjpVYwitg9krW6wZgJA: posts big blind $2
*** HOLE CARDS ***
RsrgM2l7PLbQ9xBbSi3IvQ has returned
MOBMOMQRN/z+fiGXGnZojw: folds
5iPk5MyO3KVu18Y8XCYfFQ: folds
b0jO1SDhLedy1//CQlA8kw: folds
JnV3SM2D6dAFYyGZHHpvrg: folds
qCBuzVnLcBR29snMAHq9PA: folds
W3Nqt1GWlTi9tXQXMNEvgw: calls $2
/gll27k+xWYV7Fbki0lFDQ: calls $1
QHxJjpVYwitg9krW6wZgJA: checks
*** FLOP *** [9s 3s 5s]
/gll27k+xWYV7Fbki0lFDQ: checks
QHxJjpVYwitg9krW6wZgJA: bets $6
W3Nqt1GWlTi9tXQXMNEvgw: folds
/gll27k+xWYV7Fbki0lFDQ: raises $8 to $14
QHxJjpVYwitg9krW6wZgJA: calls $8
*** TURN *** [9s 3s 5s] [7d]
/gll27k+xWYV7Fbki0lFDQ: checks
QHxJjpVYwitg9krW6wZgJA: bets $8
/gll27k+xWYV7Fbki0lFDQ: calls $8
*** RIVER *** [9s 3s 5s 7d] [8h]
/gll27k+xWYV7Fbki0lFDQ: bets $10
QHxJjpVYwitg9krW6wZgJA: calls $10
*** SHOW DOWN ***
/gll27k+xWYV7Fbki0lFDQ: shows [6h As] (a straight, Five to Nine)
QHxJjpVYwitg9krW6wZgJA: mucks hand
/gll27k+xWYV7Fbki0lFDQ collected $67 from pot
*** SUMMARY ***
Total pot $70 | Rake $3
Board [9s 3s 5s 7d 8h]
Seat 1: qCBuzVnLcBR29snMAHq9PA folded before Flop (didn't bet)
Seat 2: W3Nqt1GWlTi9tXQXMNEvgw (button) folded on the Flop
Seat 3: /gll27k+xWYV7Fbki0lFDQ (small blind) showed [6h As] and won ($67) with a straight, Five to Nine
Seat 4: QHxJjpVYwitg9krW6wZgJA (big blind) mucked
Seat 5: MOBMOMQRN/z+fiGXGnZojw folded before Flop (didn't bet)
Seat 6: 5iPk5MyO3KVu18Y8XCYfFQ folded before Flop (didn't bet)
Seat 7: b0jO1SDhLedy1//CQlA8kw folded before Flop (didn't bet)
Seat 8: JnV3SM2D6dAFYyGZHHpvrg folded before Flop (didn't bet)



PokerStars Game #59938281930:  Hold'em No Limit ($1/$2) - 2009/07/01 0:11:16 ET
Table 'HewZCzVOYGmuLDKthTi5Yw' 6-max Seat #6 is the button
Seat 1: 353332 ($252.95 in chips)
Seat 2: X7GlkHF+lkbarCLuZ4Uf0w ($28 in chips)
Seat 3: WJxW31eStwT28R2X/L8F5A ($53.05 in chips)
Seat 5: 513FcCI8jHyQy2VWoIQkMg ($367.95 in chips)
Seat 6: /3OfVkAn8WikCv83i4bHHw ($117 in chips)
353332: posts small blind $1
X7GlkHF+lkbarCLuZ4Uf0w: posts big blind $2
*** HOLE CARDS ***
WJxW31eStwT28R2X/L8F5A: calls $2
513FcCI8jHyQy2VWoIQkMg: raises $8 to $10
/3OfVkAn8WikCv83i4bHHw: folds
353332: folds
X7GlkHF+lkbarCLuZ4Uf0w: folds
WJxW31eStwT28R2X/L8F5A: calls $8
*** FLOP *** [6h 6s 2s]
WJxW31eStwT28R2X/L8F5A: checks
513FcCI8jHyQy2VWoIQkMg: bets $10
WJxW31eStwT28R2X/L8F5A: folds
513FcCI8jHyQy2VWoIQkMg collected $21.85 from pot
*** SUMMARY ***
Total pot $23 | Rake $1.15
Board [6h 6s 2s]
Seat 1: 353332 (small blind) folded before Flop
Seat 2: X7GlkHF+lkbarCLuZ4Uf0w (big blind) folded before Flop
Seat 3: WJxW31eStwT28R2X/L8F5A folded on the Flop
Seat 5: 513FcCI8jHyQy2VWoIQkMg collected ($21.85)
Seat 6: /3OfVkAn8WikCv83i4bHHw (button) folded before Flop (didn't bet)



PokerStars Game #59938281924:  Hold'em No Limit ($1/$2) - 2009/07/01 0:11:16 ET
Table 'bJQ024BaYSBrW0sXpCZbNQ' 6-max Seat #3 is the button
Seat 2: 1njbh8TKSUF6l4V1XwGdcg ($263 in chips)
Seat 3: vkfxu8f/jMYKUk6Ly4eujw ($211.60 in chips)
Seat 4: 9ni/OEXAqfc58zPQ0Tu9rQ ($266.60 in chips)
Seat 5: X7GlkHF+lkbarCLuZ4Uf0w ($48.15 in chips)
Seat 6: 9dpyyjDTCed6nV7JhaUUpw ($209.50 in chips)
9ni/OEXAqfc58zPQ0Tu9rQ: posts small blind $1
X7GlkHF+lkbarCLuZ4Uf0w: posts big blind $2
*** HOLE CARDS ***
9dpyyjDTCed6nV7JhaUUpw: folds
1njbh8TKSUF6l4V1XwGdcg: raises $4 to $6
vkfxu8f/jMYKUk6Ly4eujw: folds
9ni/OEXAqfc58zPQ0Tu9rQ: folds
X7GlkHF+lkbarCLuZ4Uf0w: folds
1njbh8TKSUF6l4V1XwGdcg collected $5 from pot
*** SUMMARY ***
Total pot $5 | Rake $0
Seat 2: 1njbh8TKSUF6l4V1XwGdcg collected ($5)
Seat 3: vkfxu8f/jMYKUk6Ly4eujw (button) folded before Flop (didn't bet)
Seat 4: 9ni/OEXAqfc58zPQ0Tu9rQ (small blind) folded before Flop
Seat 5: X7GlkHF+lkbarCLuZ4Uf0w (big blind) folded before Flop
Seat 6: 9dpyyjDTCed6nV7JhaUUpw folded before Flop (didn't bet)



PokerStars Game #59938282092:  Hold'em No Limit ($1/$2) - 2009/07/01 0:11:16 ET
Table 'pPQgcj9XT9CHBsbo1WTBug' 6-max Seat #1 is the button
Seat 1: DFVYDA6dKQy7R7mGIKogZA ($73.30 in chips)
Seat 2: X7GlkHF+lkbarCLuZ4Uf0w ($43.55 in chips)
Seat 3: vkfxu8f/jMYKUk6Ly4eujw ($193 in chips)
Seat 5: 4Cl43Q1TYQL8wn1NSCUkaw ($60.90 in chips)
X7GlkHF+lkbarCLuZ4Uf0w: posts small blind $1
vkfxu8f/jMYKUk6Ly4eujw: posts big blind $2
*** HOLE CARDS ***
4Cl43Q1TYQL8wn1NSCUkaw: raises $2 to $4
DFVYDA6dKQy7R7mGIKogZA: folds
X7GlkHF+lkbarCLuZ4Uf0w: folds
vkfxu8f/jMYKUk6Ly4eujw: calls $2
*** FLOP *** [Qh Tc Kd]
vkfxu8f/jMYKUk6Ly4eujw: checks
4Cl43Q1TYQL8wn1NSCUkaw: checks
*** TURN *** [Qh Tc Kd] [Ac]
vkfxu8f/jMYKUk6Ly4eujw: checks
4Cl43Q1TYQL8wn1NSCUkaw: checks
*** RIVER *** [Qh Tc Kd Ac] [5c]
vkfxu8f/jMYKUk6Ly4eujw: checks
4Cl43Q1TYQL8wn1NSCUkaw: bets $2
vkfxu8f/jMYKUk6Ly4eujw: folds
4Cl43Q1TYQL8wn1NSCUkaw collected $8.55 from pot
*** SUMMARY ***
Total pot $9 | Rake $0.45
Board [Qh Tc Kd Ac 5c]
Seat 1: DFVYDA6dKQy7R7mGIKogZA (button) folded before Flop (didn't bet)
Seat 2: X7GlkHF+lkbarCLuZ4Uf0w (small blind) folded before Flop
Seat 3: vkfxu8f/jMYKUk6Ly4eujw (big blind) folded on the River
Seat 5: 4Cl43Q1TYQL8wn1NSCUkaw collected ($8.55)



PokerStars Game #59938283154:  Hold'em No Limit ($1/$2) - 2009/07/01 0:11:18 ET
Table 'rsKRKlGHlxVyqJxzO2a2Ow' 9-max Seat #4 is the button
Seat 1: uYWfQJg2hgHLxri6/uVJiw ($137.10 in chips)
Seat 2: QHxJjpVYwitg9krW6wZgJA ($244.50 in chips)
Seat 3: 9sYbXdhj1M2bwKrVNxj5+Q ($113.80 in chips)
Seat 4: zJtQ1gxyi72XvGYS1tM+DA ($182.55 in chips)
Seat 5: 5Q8U6iZbeO7xJSS4qvDP5g ($201 in chips)
Seat 6: H6Z4+qu8gR0VUiPOijndVg ($200 in chips)
Seat 7: kVCeGJ4NY7Fb0W74j1mAqA ($200 in chips)
Seat 8: Hc2itIxwbi1lwa+DAYYQGg ($37 in chips)
Seat 9: 5iPk5MyO3KVu18Y8XCYfFQ ($98.10 in chips)
5Q8U6iZbeO7xJSS4qvDP5g: posts small blind $1
H6Z4+qu8gR0VUiPOijndVg: posts big blind $2
*** HOLE CARDS ***
kVCeGJ4NY7Fb0W74j1mAqA: folds
Hc2itIxwbi1lwa+DAYYQGg: folds
5iPk5MyO3KVu18Y8XCYfFQ: folds
uYWfQJg2hgHLxri6/uVJiw: folds
QHxJjpVYwitg9krW6wZgJA: raises $4 to $6
9sYbXdhj1M2bwKrVNxj5+Q: folds
zJtQ1gxyi72XvGYS1tM+DA: folds
5Q8U6iZbeO7xJSS4qvDP5g: folds
H6Z4+qu8gR0VUiPOijndVg: folds
QHxJjpVYwitg9krW6wZgJA collected $5 from pot
QHxJjpVYwitg9krW6wZgJA: doesn't show hand
*** SUMMARY ***
Total pot $5 | Rake $0
Seat 1: uYWfQJg2hgHLxri6/uVJiw folded before Flop (didn't bet)
Seat 2: QHxJjpVYwitg9krW6wZgJA collected ($5)
Seat 3: 9sYbXdhj1M2bwKrVNxj5+Q folded before Flop (didn't bet)
Seat 4: zJtQ1gxyi72XvGYS1tM+DA (button) folded before Flop (didn't bet)
Seat 5: 5Q8U6iZbeO7xJSS4qvDP5g (small blind) folded before Flop
Seat 6: H6Z4+qu8gR0VUiPOijndVg (big blind) folded before Flop
Seat 7: kVCeGJ4NY7Fb0W74j1mAqA folded before Flop (didn't bet)
Seat 8: Hc2itIxwbi1lwa+DAYYQGg folded before Flop (didn't bet)
Seat 9: 5iPk5MyO3KVu18Y8XCYfFQ folded before Flop (didn't bet)



PokerStars Game #59938285284:  Hold'em No Limit ($1/$2) - 2009/07/01 0:11:21 ET
Table 'l5lZHc5JRHEDt0Y2AVPq3g' 6-max Seat #5 is the button
Seat 1: gGPaCoSWW1HoKYaqfAPecg ($214.50 in chips)
Seat 2: my38j/MmtBd/8qVwmyCREA ($250.35 in chips)
Seat 4: zNjJ/y4emmF+vzrCDd+ooA ($205.55 in chips)
Seat 5: 6fLdOUCRtX71xbVRhJEq8w ($200 in chips)
Seat 6: vkfxu8f/jMYKUk6Ly4eujw ($204.30 in chips)
vkfxu8f/jMYKUk6Ly4eujw: posts small blind $1
gGPaCoSWW1HoKYaqfAPecg: posts big blind $2
*** HOLE CARDS ***
my38j/MmtBd/8qVwmyCREA: calls $2
zNjJ/y4emmF+vzrCDd+ooA: folds
6fLdOUCRtX71xbVRhJEq8w: folds
vkfxu8f/jMYKUk6Ly4eujw: folds
gGPaCoSWW1HoKYaqfAPecg: checks
*** FLOP *** [2s 5s Td]
gGPaCoSWW1HoKYaqfAPecg: bets $3.80
my38j/MmtBd/8qVwmyCREA: folds
gGPaCoSWW1HoKYaqfAPecg collected $4.75 from pot
gGPaCoSWW1HoKYaqfAPecg: doesn't show hand
*** SUMMARY ***
Total pot $5 | Rake $0.25
Board [2s 5s Td]
Seat 1: gGPaCoSWW1HoKYaqfAPecg (big blind) collected ($4.75)
Seat 2: my38j/MmtBd/8qVwmyCREA folded on the Flop
Seat 4: zNjJ/y4emmF+vzrCDd+ooA folded before Flop (didn't bet)
Seat 5: 6fLdOUCRtX71xbVRhJEq8w (button) folded before Flop (didn't bet)
Seat 6: vkfxu8f/jMYKUk6Ly4eujw (small blind) folded before Flop



PokerStars Game #59938285552:  Hold'em No Limit ($1/$2) - 2009/07/01 0:11:21 ET
Table 'SF49/KQm8T4taMp6kb+HXA' 9-max Seat #6 is the button
Seat 1: l1bCLGuFqeFRwUfPsiDu/g ($176.95 in chips)
Seat 2: 8Z3QifiM9eOd5EIJ25dXNg ($109.15 in chips)
Seat 4: HffgoYm61KgkdMe/DYChIQ ($34 in chips)
Seat 5: Z3aYCZG/yXHYFjiWkGI5ug ($226.55 in chips)
Seat 6: M2ht6rIKOI/my9eh610Nlw ($244.45 in chips)
Seat 7: n2VAbLaE5qgKr5mA4W6v4w ($52.50 in chips)
Seat 8: 5iPk5MyO3KVu18Y8XCYfFQ ($39 in chips)
Seat 9: O+jytCilwk7zItVCEavmtw ($143 in chips)
n2VAbLaE5qgKr5mA4W6v4w: posts small blind $1
5iPk5MyO3KVu18Y8XCYfFQ: posts big blind $2
*** HOLE CARDS ***
O+jytCilwk7zItVCEavmtw: folds
l1bCLGuFqeFRwUfPsiDu/g: folds
8Z3QifiM9eOd5EIJ25dXNg: folds
HffgoYm61KgkdMe/DYChIQ: folds
Z3aYCZG/yXHYFjiWkGI5ug: folds
M2ht6rIKOI/my9eh610Nlw: raises $2 to $4
n2VAbLaE5qgKr5mA4W6v4w: folds
5iPk5MyO3KVu18Y8XCYfFQ: raises $35 to $39 and is all-in
M2ht6rIKOI/my9eh610Nlw: folds
5iPk5MyO3KVu18Y8XCYfFQ collected $9 from pot
*** SUMMARY ***
Total pot $9 | Rake $0
Seat 1: l1bCLGuFqeFRwUfPsiDu/g folded before Flop (didn't bet)
Seat 2: 8Z3QifiM9eOd5EIJ25dXNg folded before Flop (didn't bet)
Seat 4: HffgoYm61KgkdMe/DYChIQ folded before Flop (didn't bet)
Seat 5: Z3aYCZG/yXHYFjiWkGI5ug folded before Flop (didn't bet)
Seat 6: M2ht6rIKOI/my9eh610Nlw (button) folded before Flop
Seat 7: n2VAbLaE5qgKr5mA4W6v4w (small blind) folded before Flop
Seat 8: 5iPk5MyO3KVu18Y8XCYfFQ (big blind) collected ($9)
Seat 9: O+jytCilwk7zItVCEavmtw folded before Flop (didn't bet)



PokerStars Game #59938286324:  Hold'em No Limit ($1/$2) - 2009/07/01 0:11:22 ET
Table 'srul5UFZXTEccVV5fpY91g' 9-max Seat #5 is the button
Seat 1: lfD8cBv31A/pio3pXJbPjA ($195.20 in chips)
Seat 2: tJYod1SLp2AcWPL/3hZ7ug ($109.20 in chips)
Seat 3: weUZ8S7tgbaeIpzi1gBNxQ ($51.75 in chips)
Seat 4: GG5lTuGt3+kwNYSbqeB6yw ($81.85 in chips)
Seat 5: 5iPk5MyO3KVu18Y8XCYfFQ ($43.10 in chips)
Seat 6: TAfo4veNRaRlzDXMMYS3Jg ($32 in chips)
Seat 7: s0erZsDxbZSaEPheMgibKg ($439.40 in chips)
Seat 8: jqICkNBEBjVScJ1iibba8Q ($277.65 in chips)
Seat 9: GX1heJ+DSsvm7gzSPsYhhQ ($94 in chips)
TAfo4veNRaRlzDXMMYS3Jg: posts small blind $1
s0erZsDxbZSaEPheMgibKg: posts big blind $2
*** HOLE CARDS ***
jqICkNBEBjVScJ1iibba8Q: folds
jqICkNBEBjVScJ1iibba8Q is sitting out
GX1heJ+DSsvm7gzSPsYhhQ: folds
lfD8cBv31A/pio3pXJbPjA: folds
tJYod1SLp2AcWPL/3hZ7ug: folds
weUZ8S7tgbaeIpzi1gBNxQ: folds
jqICkNBEBjVScJ1iibba8Q leaves the table
GG5lTuGt3+kwNYSbqeB6yw: folds
5iPk5MyO3KVu18Y8XCYfFQ: folds
TAfo4veNRaRlzDXMMYS3Jg: folds
s0erZsDxbZSaEPheMgibKg collected $2 from pot
*** SUMMARY ***
Total pot $2 | Rake $0
Seat 1: lfD8cBv31A/pio3pXJbPjA folded before Flop (didn't bet)
Seat 2: tJYod1SLp2AcWPL/3hZ7ug folded before Flop (didn't bet)
Seat 3: weUZ8S7tgbaeIpzi1gBNxQ folded before Flop (didn't bet)
Seat 4: GG5lTuGt3+kwNYSbqeB6yw folded before Flop (didn't bet)
Seat 5: 5iPk5MyO3KVu18Y8XCYfFQ (button) folded before Flop (didn't bet)
Seat 6: TAfo4veNRaRlzDXMMYS3Jg (small blind) folded before Flop
Seat 7: s0erZsDxbZSaEPheMgibKg (big blind) collected ($2)
Seat 8: jqICkNBEBjVScJ1iibba8Q folded before Flop (didn't bet)
Seat 9: GX1heJ+DSsvm7gzSPsYhhQ folded before Flop (didn't bet)



PokerStars Game #59938289748:  Hold'em No Limit ($1/$2) - 2009/07/01 0:11:27 ET
Table 'on4i1U1lCRmxsduFD3xiSg' 9-max Seat #2 is the button
Seat 1: so5k3vFDmokh2q3dImJ1GQ ($120 in chips)
Seat 2: yZYrOeNDxQxkzpbgKX1bng ($66.65 in chips)
Seat 3: 5iPk5MyO3KVu18Y8XCYfFQ ($62.20 in chips)
Seat 4: Z3aYCZG/yXHYFjiWkGI5ug ($446.10 in chips)
Seat 5: QHxJjpVYwitg9krW6wZgJA ($200 in chips)
Seat 6: SB0tvOX0Kw61r2U851JFaA ($203 in chips)
Seat 7: xD4ElYxz6Ollzmam8BmMCw ($244.25 in chips)
Seat 8: cdC54j9fGGojcbzWB5PgzA ($200 in chips)
Seat 9: iMe5yhc+1BaiIPHet3NMrA ($200 in chips)
5iPk5MyO3KVu18Y8XCYfFQ: posts small blind $1
Z3aYCZG/yXHYFjiWkGI5ug: posts big blind $2
so5k3vFDmokh2q3dImJ1GQ: posts big blind $2
*** HOLE CARDS ***
QHxJjpVYwitg9krW6wZgJA: folds
SB0tvOX0Kw61r2U851JFaA: calls $2
xD4ElYxz6Ollzmam8BmMCw: folds
cdC54j9fGGojcbzWB5PgzA: folds
iMe5yhc+1BaiIPHet3NMrA: calls $2
so5k3vFDmokh2q3dImJ1GQ: checks
yZYrOeNDxQxkzpbgKX1bng: folds
5iPk5MyO3KVu18Y8XCYfFQ: folds
Z3aYCZG/yXHYFjiWkGI5ug: raises $12 to $14
SB0tvOX0Kw61r2U851JFaA: folds
iMe5yhc+1BaiIPHet3NMrA: folds
so5k3vFDmokh2q3dImJ1GQ: folds
Z3aYCZG/yXHYFjiWkGI5ug collected $9 from pot
*** SUMMARY ***
Total pot $9 | Rake $0
Seat 1: so5k3vFDmokh2q3dImJ1GQ folded before Flop
Seat 2: yZYrOeNDxQxkzpbgKX1bng (button) folded before Flop (didn't bet)
Seat 3: 5iPk5MyO3KVu18Y8XCYfFQ (small blind) folded before Flop
Seat 4: Z3aYCZG/yXHYFjiWkGI5ug (big blind) collected ($9)
Seat 5: QHxJjpVYwitg9krW6wZgJA folded before Flop (didn't bet)
Seat 6: SB0tvOX0Kw61r2U851JFaA folded before Flop
Seat 7: xD4ElYxz6Ollzmam8BmMCw folded before Flop (didn't bet)
Seat 8: cdC54j9fGGojcbzWB5PgzA folded before Flop (didn't bet)
Seat 9: iMe5yhc+1BaiIPHet3NMrA folded before Flop



PokerStars Game #59938289950:  Hold'em No Limit ($1/$2) - 2009/07/01 0:11:27 ET
Table 'eyAQSIlgc2o1Jxvbve4WGg' 9-max Seat #6 is the button
Seat 1: Q3uFdu6ztesjDFiqkagTRQ ($234 in chips)
Seat 3: TAfo4veNRaRlzDXMMYS3Jg ($37 in chips)
Seat 5: JnV3SM2D6dAFYyGZHHpvrg ($97 in chips)
Seat 6: IikcENBHwoT7snSvBPSc7Q ($182.60 in chips)
Seat 7: QHxJjpVYwitg9krW6wZgJA ($200 in chips)
Seat 8: 5iPk5MyO3KVu18Y8XCYfFQ ($36 in chips)
Seat 9: Hc2itIxwbi1lwa+DAYYQGg ($46.85 in chips)
QHxJjpVYwitg9krW6wZgJA: posts small blind $1
5iPk5MyO3KVu18Y8XCYfFQ: posts big blind $2
*** HOLE CARDS ***
Hc2itIxwbi1lwa+DAYYQGg: folds
Q3uFdu6ztesjDFiqkagTRQ: folds
TAfo4veNRaRlzDXMMYS3Jg: folds
JnV3SM2D6dAFYyGZHHpvrg: folds
IikcENBHwoT7snSvBPSc7Q: folds
QHxJjpVYwitg9krW6wZgJA: raises $2 to $4
5iPk5MyO3KVu18Y8XCYfFQ: calls $2
*** FLOP *** [9c 8c Qc]
QHxJjpVYwitg9krW6wZgJA: checks
5iPk5MyO3KVu18Y8XCYfFQ: bets $4
QHxJjpVYwitg9krW6wZgJA: folds
5iPk5MyO3KVu18Y8XCYfFQ collected $7.60 from pot
5iPk5MyO3KVu18Y8XCYfFQ: doesn't show hand
*** SUMMARY ***
Total pot $8 | Rake $0.40
Board [9c 8c Qc]
Seat 1: Q3uFdu6ztesjDFiqkagTRQ folded before Flop (didn't bet)
Seat 3: TAfo4veNRaRlzDXMMYS3Jg folded before Flop (didn't bet)
Seat 5: JnV3SM2D6dAFYyGZHHpvrg folded before Flop (didn't bet)
Seat 6: IikcENBHwoT7snSvBPSc7Q (button) folded before Flop (didn't bet)
Seat 7: QHxJjpVYwitg9krW6wZgJA (small blind) folded on the Flop
Seat 8: 5iPk5MyO3KVu18Y8XCYfFQ (big blind) collected ($7.60)
Seat 9: Hc2itIxwbi1lwa+DAYYQGg folded before Flop (didn't bet)



PokerStars Game #59938290574:  Hold'em No Limit ($1/$2) - 2009/07/01 0:11:28 ET
Table 'bIihwBANJSFqlHPPtset+w' 9-max Seat #2 is the button
Seat 1: jI3JDUGV63ccqtKgM3vMbw ($140.60 in chips)
Seat 2: lQYT23h5QCUVZAKxjOO39Q ($125.90 in chips)
Seat 3: acnZ0LD5jxKgWIHz+mpQ8Q ($215.40 in chips)
Seat 4: 7WWX5PClBdr/U44gUKBIEA ($266.65 in chips)
Seat 5: GX1heJ+DSsvm7gzSPsYhhQ ($40 in chips)
Seat 6: 5iPk5MyO3KVu18Y8XCYfFQ ($44.40 in chips)
Seat 7: 3q2/0oJr3Mcy1W5tcN61ug ($200 in chips)
Seat 8: iMe5yhc+1BaiIPHet3NMrA ($281.65 in chips)
Seat 9: rW/MyplHylMSBRaoRUzWrg ($34.55 in chips)
acnZ0LD5jxKgWIHz+mpQ8Q: posts small blind $1
7WWX5PClBdr/U44gUKBIEA: posts big blind $2
*** HOLE CARDS ***
GX1heJ+DSsvm7gzSPsYhhQ: folds
GX1heJ+DSsvm7gzSPsYhhQ leaves the table
5iPk5MyO3KVu18Y8XCYfFQ: folds
3q2/0oJr3Mcy1W5tcN61ug: folds
iMe5yhc+1BaiIPHet3NMrA: folds
rW/MyplHylMSBRaoRUzWrg: folds
jI3JDUGV63ccqtKgM3vMbw: folds
lQYT23h5QCUVZAKxjOO39Q: folds
acnZ0LD5jxKgWIHz+mpQ8Q: calls $1
7WWX5PClBdr/U44gUKBIEA: checks
*** FLOP *** [Kd 9d Td]
acnZ0LD5jxKgWIHz+mpQ8Q: bets $2
7WWX5PClBdr/U44gUKBIEA: calls $2
*** TURN *** [Kd 9d Td] [3h]
acnZ0LD5jxKgWIHz+mpQ8Q: bets $2
7WWX5PClBdr/U44gUKBIEA: calls $2
*** RIVER *** [Kd 9d Td 3h] [Js]
acnZ0LD5jxKgWIHz+mpQ8Q: checks
7WWX5PClBdr/U44gUKBIEA: bets $6
acnZ0LD5jxKgWIHz+mpQ8Q: calls $6
*** SHOW DOWN ***
7WWX5PClBdr/U44gUKBIEA: shows [6d 3c] (a pair of Threes)
acnZ0LD5jxKgWIHz+mpQ8Q: shows [8d Kc] (a pair of Kings)
acnZ0LD5jxKgWIHz+mpQ8Q collected $22.85 from pot
*** SUMMARY ***
Total pot $24 | Rake $1.15
Board [Kd 9d Td 3h Js]
Seat 1: jI3JDUGV63ccqtKgM3vMbw folded before Flop (didn't bet)
Seat 2: lQYT23h5QCUVZAKxjOO39Q (button) folded before Flop (didn't bet)
Seat 3: acnZ0LD5jxKgWIHz+mpQ8Q (small blind) showed [8d Kc] and won ($22.85) with a pair of Kings
Seat 4: 7WWX5PClBdr/U44gUKBIEA (big blind) showed [6d 3c] and lost with a pair of Threes
Seat 5: GX1heJ+DSsvm7gzSPsYhhQ folded before Flop (didn't bet)
Seat 6: 5iPk5MyO3KVu18Y8XCYfFQ folded before Flop (didn't bet)
Seat 7: 3q2/0oJr3Mcy1W5tcN61ug folded before Flop (didn't bet)
Seat 8: iMe5yhc+1BaiIPHet3NMrA folded before Flop (didn't bet)
Seat 9: rW/MyplHylMSBRaoRUzWrg folded before Flop (didn't bet)



PokerStars Game #59938291078:  Hold'em No Limit ($1/$2) - 2009/07/01 0:11:29 ET
Table 'NmY84NAf9Mh0ckAckHnh5g' 2-max Seat #2 is the button
Seat 1: 6hvg964TSqZ3AL/0XK9aVQ ($352.75 in chips)
Seat 2: RwDoM55ZeQuI2ADyJhOb2Q ($238.55 in chips)
RwDoM55ZeQuI2ADyJhOb2Q: posts small blind $1
6hvg964TSqZ3AL/0XK9aVQ: posts big blind $2
*** HOLE CARDS ***
RwDoM55ZeQuI2ADyJhOb2Q: raises $4 to $6
6hvg964TSqZ3AL/0XK9aVQ: calls $4
*** FLOP *** [9d 7c Kc]
6hvg964TSqZ3AL/0XK9aVQ: checks
RwDoM55ZeQuI2ADyJhOb2Q: bets $6
6hvg964TSqZ3AL/0XK9aVQ: folds
RwDoM55ZeQuI2ADyJhOb2Q collected $11.50 from pot
RwDoM55ZeQuI2ADyJhOb2Q: doesn't show hand
*** SUMMARY ***
Total pot $12 | Rake $0.50
Board [9d 7c Kc]
Seat 1: 6hvg964TSqZ3AL/0XK9aVQ (big blind) folded on the Flop
Seat 2: RwDoM55ZeQuI2ADyJhOb2Q (button) (small blind) collected ($11.50)



PokerStars Game #59938291984:  Hold'em No Limit ($1/$2) - 2009/07/01 0:11:30 ET
Table 'G1Oqdy4Pqdb5gtx40rUBzA' 6-max Seat #5 is the button
Seat 1: QCqxb/MXSq5RKfPtjBjiBA ($136.80 in chips)
Seat 2: IzslX/oV8DoDQfxCV/3+kg ($352.10 in chips)
Seat 3: 6fLdOUCRtX71xbVRhJEq8w ($261.05 in chips)
Seat 5: X7GlkHF+lkbarCLuZ4Uf0w ($78 in chips)
Seat 6: gGPaCoSWW1HoKYaqfAPecg ($200 in chips)
gGPaCoSWW1HoKYaqfAPecg: posts small blind $1
QCqxb/MXSq5RKfPtjBjiBA: posts big blind $2
*** HOLE CARDS ***
IzslX/oV8DoDQfxCV/3+kg: folds
6fLdOUCRtX71xbVRhJEq8w: folds
X7GlkHF+lkbarCLuZ4Uf0w: folds
gGPaCoSWW1HoKYaqfAPecg: folds
QCqxb/MXSq5RKfPtjBjiBA collected $2 from pot
*** SUMMARY ***
Total pot $2 | Rake $0
Seat 1: QCqxb/MXSq5RKfPtjBjiBA (big blind) collected ($2)
Seat 2: IzslX/oV8DoDQfxCV/3+kg folded before Flop (didn't bet)
Seat 3: 6fLdOUCRtX71xbVRhJEq8w folded before Flop (didn't bet)
Seat 5: X7GlkHF+lkbarCLuZ4Uf0w (button) folded before Flop (didn't bet)
Seat 6: gGPaCoSWW1HoKYaqfAPecg (small blind) folded before Flop



PokerStars Game #59938294264:  Hold'em No Limit ($1/$2) - 2009/07/01 0:11:33 ET
Table '3FGoiEOffWrbgTfsB3t7FA' 2-max Seat #1 is the button
Seat 1: e0oDWyrmgLpR6bROEqw1nQ ($334 in chips)
Seat 2: +sy/nlNI20yZraIjs4AALg ($268.15 in chips)
e0oDWyrmgLpR6bROEqw1nQ: posts small blind $1
+sy/nlNI20yZraIjs4AALg: posts big blind $2
*** HOLE CARDS ***
e0oDWyrmgLpR6bROEqw1nQ: raises $4 to $6
+sy/nlNI20yZraIjs4AALg: calls $4
*** FLOP *** [Jh 4h 3h]
+sy/nlNI20yZraIjs4AALg: checks
e0oDWyrmgLpR6bROEqw1nQ: checks
*** TURN *** [Jh 4h 3h] [Ah]
+sy/nlNI20yZraIjs4AALg: checks
e0oDWyrmgLpR6bROEqw1nQ: checks
*** RIVER *** [Jh 4h 3h Ah] [6c]
+sy/nlNI20yZraIjs4AALg: bets $10
e0oDWyrmgLpR6bROEqw1nQ: folds
+sy/nlNI20yZraIjs4AALg collected $11.50 from pot
*** SUMMARY ***
Total pot $12 | Rake $0.50
Board [Jh 4h 3h Ah 6c]
Seat 1: e0oDWyrmgLpR6bROEqw1nQ (button) (small blind) folded on the River
Seat 2: +sy/nlNI20yZraIjs4AALg (big blind) collected ($11.50)



PokerStars Game #59938296946:  Hold'em No Limit ($1/$2) - 2009/07/01 0:11:37 ET
Table 'bJQ024BaYSBrW0sXpCZbNQ' 6-max Seat #4 is the button
Seat 2: 1njbh8TKSUF6l4V1XwGdcg ($266 in chips)
Seat 3: vkfxu8f/jMYKUk6Ly4eujw ($211.60 in chips)
Seat 4: 9ni/OEXAqfc58zPQ0Tu9rQ ($265.60 in chips)
Seat 5: X7GlkHF+lkbarCLuZ4Uf0w ($46.15 in chips)
Seat 6: 9dpyyjDTCed6nV7JhaUUpw ($209.50 in chips)
X7GlkHF+lkbarCLuZ4Uf0w: posts small blind $1
9dpyyjDTCed6nV7JhaUUpw: posts big blind $2
*** HOLE CARDS ***
1njbh8TKSUF6l4V1XwGdcg: folds
vkfxu8f/jMYKUk6Ly4eujw: folds
9ni/OEXAqfc58zPQ0Tu9rQ: folds
X7GlkHF+lkbarCLuZ4Uf0w: raises $3 to $5
9dpyyjDTCed6nV7JhaUUpw: raises $7 to $12
X7GlkHF+lkbarCLuZ4Uf0w: raises $34.15 to $46.15 and is all-in
Mo7b4GXWaawCURUQwq6RYg joins the table at seat #1
9dpyyjDTCed6nV7JhaUUpw: folds
X7GlkHF+lkbarCLuZ4Uf0w collected $24 from pot
X7GlkHF+lkbarCLuZ4Uf0w: doesn't show hand
*** SUMMARY ***
Total pot $24 | Rake $0
Seat 2: 1njbh8TKSUF6l4V1XwGdcg folded before Flop (didn't bet)
Seat 3: vkfxu8f/jMYKUk6Ly4eujw folded before Flop (didn't bet)
Seat 4: 9ni/OEXAqfc58zPQ0Tu9rQ (button) folded before Flop (didn't bet)
Seat 5: X7GlkHF+lkbarCLuZ4Uf0w (small blind) collected ($24)
Seat 6: 9dpyyjDTCed6nV7JhaUUpw (big blind) folded before Flop



PokerStars Game #59938297354:  Hold'em No Limit ($1/$2) - 2009/07/01 0:11:38 ET
Table 'XP2sRSup+aRuwzx3vDZsDg' 6-max Seat #3 is the button
Seat 1: o9jamqIi6sTTRSqudgboRA ($237.70 in chips)
Seat 3: X7GlkHF+lkbarCLuZ4Uf0w ($30.50 in chips)
Seat 4: JsC+WvfzqlxVs9G8/gSQAQ ($84.40 in chips)
Seat 6: h7ppRQJTYBsHCbLMeW9T2g ($487.75 in chips)
JsC+WvfzqlxVs9G8/gSQAQ: posts small blind $1
vkfxu8f/jMYKUk6Ly4eujw: is sitting out
h7ppRQJTYBsHCbLMeW9T2g: posts big blind $2
*** HOLE CARDS ***
vkfxu8f/jMYKUk6Ly4eujw leaves the table
o9jamqIi6sTTRSqudgboRA: folds
X7GlkHF+lkbarCLuZ4Uf0w: raises $2 to $4
JsC+WvfzqlxVs9G8/gSQAQ: calls $3
h7ppRQJTYBsHCbLMeW9T2g: folds
*** FLOP *** [Td 9d 5h]
JsC+WvfzqlxVs9G8/gSQAQ: bets $4
X7GlkHF+lkbarCLuZ4Uf0w: raises $22.50 to $26.50 and is all-in
JsC+WvfzqlxVs9G8/gSQAQ: folds
X7GlkHF+lkbarCLuZ4Uf0w collected $17.15 from pot
X7GlkHF+lkbarCLuZ4Uf0w: doesn't show hand
*** SUMMARY ***
Total pot $18 | Rake $0.85
Board [Td 9d 5h]
Seat 1: o9jamqIi6sTTRSqudgboRA folded before Flop (didn't bet)
Seat 3: X7GlkHF+lkbarCLuZ4Uf0w (button) collected ($17.15)
Seat 4: JsC+WvfzqlxVs9G8/gSQAQ (small blind) folded on the Flop
Seat 6: h7ppRQJTYBsHCbLMeW9T2g (big blind) folded before Flop



PokerStars Game #59938299650:  Hold'em No Limit ($1/$2) - 2009/07/01 0:11:41 ET
Table 'qVXak+oTeDXMGbWa4sDU5Q' 9-max Seat #9 is the button
Seat 1: H6Z4+qu8gR0VUiPOijndVg ($248 in chips)
Seat 2: Hc2itIxwbi1lwa+DAYYQGg ($49 in chips)
Seat 3: oz9eCXGC7DdjQlL/nuWj1A ($108.60 in chips)
Seat 4: b0jO1SDhLedy1//CQlA8kw ($40 in chips)
Seat 6: Q3uFdu6ztesjDFiqkagTRQ ($200 in chips)
Seat 7: 5iPk5MyO3KVu18Y8XCYfFQ ($115 in chips)
Seat 8: 9pHZMviI9R8injxojGTnvw ($101.85 in chips)
Seat 9: IZ/2qsh1CIg9m5PWsMsLmA ($357.95 in chips)
H6Z4+qu8gR0VUiPOijndVg: posts small blind $1
Hc2itIxwbi1lwa+DAYYQGg: posts big blind $2
NqKRc5xvcye0d7F6VOF6MQ: sits out
*** HOLE CARDS ***
oz9eCXGC7DdjQlL/nuWj1A: folds
b0jO1SDhLedy1//CQlA8kw: folds
Q3uFdu6ztesjDFiqkagTRQ: raises $4 to $6
5iPk5MyO3KVu18Y8XCYfFQ: folds
9pHZMviI9R8injxojGTnvw: folds
IZ/2qsh1CIg9m5PWsMsLmA: folds
H6Z4+qu8gR0VUiPOijndVg: folds
Hc2itIxwbi1lwa+DAYYQGg: folds
Q3uFdu6ztesjDFiqkagTRQ collected $5 from pot
Q3uFdu6ztesjDFiqkagTRQ: doesn't show hand
*** SUMMARY ***
Total pot $5 | Rake $0
Seat 1: H6Z4+qu8gR0VUiPOijndVg (small blind) folded before Flop
Seat 2: Hc2itIxwbi1lwa+DAYYQGg (big blind) folded before Flop
Seat 3: oz9eCXGC7DdjQlL/nuWj1A folded before Flop (didn't bet)
Seat 4: b0jO1SDhLedy1//CQlA8kw folded before Flop (didn't bet)
Seat 6: Q3uFdu6ztesjDFiqkagTRQ collected ($5)
Seat 7: 5iPk5MyO3KVu18Y8XCYfFQ folded before Flop (didn't bet)
Seat 8: 9pHZMviI9R8injxojGTnvw folded before Flop (didn't bet)
Seat 9: IZ/2qsh1CIg9m5PWsMsLmA (button) folded before Flop (didn't bet)



PokerStars Game #59938301240:  Hold'em No Limit ($1/$2) - 2009/07/01 0:11:43 ET
Table 'rsKRKlGHlxVyqJxzO2a2Ow' 9-max Seat #5 is the button
Seat 1: uYWfQJg2hgHLxri6/uVJiw ($137.10 in chips)
Seat 2: QHxJjpVYwitg9krW6wZgJA ($247.50 in chips)
Seat 3: 9sYbXdhj1M2bwKrVNxj5+Q ($113.80 in chips)
Seat 4: zJtQ1gxyi72XvGYS1tM+DA ($182.55 in chips)
Seat 5: 5Q8U6iZbeO7xJSS4qvDP5g ($200 in chips)
Seat 6: H6Z4+qu8gR0VUiPOijndVg ($200 in chips)
Seat 7: kVCeGJ4NY7Fb0W74j1mAqA ($200 in chips)
Seat 8: Hc2itIxwbi1lwa+DAYYQGg ($37 in chips)
Seat 9: 5iPk5MyO3KVu18Y8XCYfFQ ($98.10 in chips)
H6Z4+qu8gR0VUiPOijndVg: posts small blind $1
kVCeGJ4NY7Fb0W74j1mAqA: posts big blind $2
*** HOLE CARDS ***
Hc2itIxwbi1lwa+DAYYQGg: folds
5iPk5MyO3KVu18Y8XCYfFQ: folds
uYWfQJg2hgHLxri6/uVJiw: folds
QHxJjpVYwitg9krW6wZgJA: folds
9sYbXdhj1M2bwKrVNxj5+Q: folds
zJtQ1gxyi72XvGYS1tM+DA: folds
5Q8U6iZbeO7xJSS4qvDP5g: raises $4 to $6
H6Z4+qu8gR0VUiPOijndVg: folds
kVCeGJ4NY7Fb0W74j1mAqA: folds
5Q8U6iZbeO7xJSS4qvDP5g collected $5 from pot
5Q8U6iZbeO7xJSS4qvDP5g: doesn't show hand
*** SUMMARY ***
Total pot $5 | Rake $0
Seat 1: uYWfQJg2hgHLxri6/uVJiw folded before Flop (didn't bet)
Seat 2: QHxJjpVYwitg9krW6wZgJA folded before Flop (didn't bet)
Seat 3: 9sYbXdhj1M2bwKrVNxj5+Q folded before Flop (didn't bet)
Seat 4: zJtQ1gxyi72XvGYS1tM+DA folded before Flop (didn't bet)
Seat 5: 5Q8U6iZbeO7xJSS4qvDP5g (button) collected ($5)
Seat 6: H6Z4+qu8gR0VUiPOijndVg (small blind) folded before Flop
Seat 7: kVCeGJ4NY7Fb0W74j1mAqA (big blind) folded before Flop
Seat 8: Hc2itIxwbi1lwa+DAYYQGg folded before Flop (didn't bet)
Seat 9: 5iPk5MyO3KVu18Y8XCYfFQ folded before Flop (didn't bet)



PokerStars Game #59938301662:  Hold'em No Limit ($1/$2) - 2009/07/01 0:11:44 ET
Table 'NmY84NAf9Mh0ckAckHnh5g' 2-max Seat #1 is the button
Seat 1: 6hvg964TSqZ3AL/0XK9aVQ ($346.75 in chips)
Seat 2: RwDoM55ZeQuI2ADyJhOb2Q ($244.05 in chips)
6hvg964TSqZ3AL/0XK9aVQ: posts small blind $1
RwDoM55ZeQuI2ADyJhOb2Q: posts big blind $2
*** HOLE CARDS ***
6hvg964TSqZ3AL/0XK9aVQ: folds
RwDoM55ZeQuI2ADyJhOb2Q collected $2 from pot
RwDoM55ZeQuI2ADyJhOb2Q: doesn't show hand
*** SUMMARY ***
Total pot $2 | Rake $0
Seat 1: 6hvg964TSqZ3AL/0XK9aVQ (button) (small blind) folded before Flop
Seat 2: RwDoM55ZeQuI2ADyJhOb2Q (big blind) collected ($2)



PokerStars Game #59938301718:  Hold'em No Limit ($1/$2) - 2009/07/01 0:11:44 ET
Table 'gnHBqWll9O3fxG7Ojkz/ng' 9-max Seat #8 is the button
Seat 1: hpqdC/23wXosGOmzARr5NA ($159.05 in chips)
Seat 2: H6Z4+qu8gR0VUiPOijndVg ($203 in chips)
Seat 3: 5Q8U6iZbeO7xJSS4qvDP5g ($218.60 in chips)
Seat 4: n5XI5/7gN+gIubHFBH+mOw ($401.85 in chips)
Seat 6: 5iPk5MyO3KVu18Y8XCYfFQ ($52.45 in chips)
Seat 8: De9g+AYjo0DN6C/+iT/nsg ($241.05 in chips)
Seat 9: kVCeGJ4NY7Fb0W74j1mAqA ($204 in chips)
kVCeGJ4NY7Fb0W74j1mAqA: posts small blind $1
hpqdC/23wXosGOmzARr5NA: posts big blind $2
*** HOLE CARDS ***
rBQDMkKm9cZn6M9NPsiVew joins the table at seat #5
H6Z4+qu8gR0VUiPOijndVg: folds
5Q8U6iZbeO7xJSS4qvDP5g: folds
n5XI5/7gN+gIubHFBH+mOw: folds
5iPk5MyO3KVu18Y8XCYfFQ: folds
De9g+AYjo0DN6C/+iT/nsg: folds
kVCeGJ4NY7Fb0W74j1mAqA: raises $4 to $6
hpqdC/23wXosGOmzARr5NA: folds
kVCeGJ4NY7Fb0W74j1mAqA collected $4 from pot
kVCeGJ4NY7Fb0W74j1mAqA: doesn't show hand
*** SUMMARY ***
Total pot $4 | Rake $0
Seat 1: hpqdC/23wXosGOmzARr5NA (big blind) folded before Flop
Seat 2: H6Z4+qu8gR0VUiPOijndVg folded before Flop (didn't bet)
Seat 3: 5Q8U6iZbeO7xJSS4qvDP5g folded before Flop (didn't bet)
Seat 4: n5XI5/7gN+gIubHFBH+mOw folded before Flop (didn't bet)
Seat 6: 5iPk5MyO3KVu18Y8XCYfFQ folded before Flop (didn't bet)
Seat 8: De9g+AYjo0DN6C/+iT/nsg (button) folded before Flop (didn't bet)
Seat 9: kVCeGJ4NY7Fb0W74j1mAqA (small blind) collected ($4)



PokerStars Game #59938302120:  Hold'em No Limit ($1/$2) - 2009/07/01 0:11:45 ET
Table 'srul5UFZXTEccVV5fpY91g' 9-max Seat #6 is the button
Seat 1: lfD8cBv31A/pio3pXJbPjA ($195.20 in chips)
Seat 2: tJYod1SLp2AcWPL/3hZ7ug ($109.20 in chips)
Seat 3: weUZ8S7tgbaeIpzi1gBNxQ ($51.75 in chips)
Seat 4: GG5lTuGt3+kwNYSbqeB6yw ($81.85 in chips)
Seat 5: 5iPk5MyO3KVu18Y8XCYfFQ ($43.10 in chips)
Seat 6: TAfo4veNRaRlzDXMMYS3Jg ($31 in chips)
Seat 7: s0erZsDxbZSaEPheMgibKg ($440.40 in chips)
s0erZsDxbZSaEPheMgibKg: posts small blind $1
GX1heJ+DSsvm7gzSPsYhhQ: is sitting out
GX1heJ+DSsvm7gzSPsYhhQ leaves the table
lfD8cBv31A/pio3pXJbPjA: posts big blind $2
*** HOLE CARDS ***
tJYod1SLp2AcWPL/3hZ7ug: calls $2
weUZ8S7tgbaeIpzi1gBNxQ: folds
GG5lTuGt3+kwNYSbqeB6yw: folds
5iPk5MyO3KVu18Y8XCYfFQ: folds
TAfo4veNRaRlzDXMMYS3Jg: raises $29 to $31 and is all-in
s0erZsDxbZSaEPheMgibKg: folds
lfD8cBv31A/pio3pXJbPjA: folds
tJYod1SLp2AcWPL/3hZ7ug: folds
TAfo4veNRaRlzDXMMYS3Jg collected $7 from pot
*** SUMMARY ***
Total pot $7 | Rake $0
Seat 1: lfD8cBv31A/pio3pXJbPjA (big blind) folded before Flop
Seat 2: tJYod1SLp2AcWPL/3hZ7ug folded before Flop
Seat 3: weUZ8S7tgbaeIpzi1gBNxQ folded before Flop (didn't bet)
Seat 4: GG5lTuGt3+kwNYSbqeB6yw folded before Flop (didn't bet)
Seat 5: 5iPk5MyO3KVu18Y8XCYfFQ folded before Flop (didn't bet)
Seat 6: TAfo4veNRaRlzDXMMYS3Jg (button) collected ($7)
Seat 7: s0erZsDxbZSaEPheMgibKg (small blind) folded before Flop



PokerStars Game #59938304018:  Hold'em No Limit ($1/$2) - 2009/07/01 0:11:47 ET
Table 'G1Oqdy4Pqdb5gtx40rUBzA' 6-max Seat #6 is the button
Seat 1: QCqxb/MXSq5RKfPtjBjiBA ($137.80 in chips)
Seat 2: IzslX/oV8DoDQfxCV/3+kg ($352.10 in chips)
Seat 3: 6fLdOUCRtX71xbVRhJEq8w ($261.05 in chips)
Seat 5: X7GlkHF+lkbarCLuZ4Uf0w ($78 in chips)
Seat 6: gGPaCoSWW1HoKYaqfAPecg ($200 in chips)
QCqxb/MXSq5RKfPtjBjiBA: posts small blind $1
IzslX/oV8DoDQfxCV/3+kg: posts big blind $2
*** HOLE CARDS ***
B87ikIyZ/TzAVeXf38Ny0g joins the table at seat #4
6fLdOUCRtX71xbVRhJEq8w has timed out
6fLdOUCRtX71xbVRhJEq8w: folds
6fLdOUCRtX71xbVRhJEq8w is sitting out
6fLdOUCRtX71xbVRhJEq8w leaves the table
X7GlkHF+lkbarCLuZ4Uf0w: folds
gGPaCoSWW1HoKYaqfAPecg: folds
QCqxb/MXSq5RKfPtjBjiBA: calls $1
lE+RUsc9cdVV9eEi8uytew joins the table at seat #3
IzslX/oV8DoDQfxCV/3+kg: checks
*** FLOP *** [9c 3h 9h]
QCqxb/MXSq5RKfPtjBjiBA: bets $4
IzslX/oV8DoDQfxCV/3+kg: calls $4
*** TURN *** [9c 3h 9h] [8h]
QCqxb/MXSq5RKfPtjBjiBA: checks
IzslX/oV8DoDQfxCV/3+kg: bets $8
QCqxb/MXSq5RKfPtjBjiBA: calls $8
*** RIVER *** [9c 3h 9h 8h] [4h]
QCqxb/MXSq5RKfPtjBjiBA: checks
IzslX/oV8DoDQfxCV/3+kg: checks
*** SHOW DOWN ***
QCqxb/MXSq5RKfPtjBjiBA: shows [8s 5s] (two pair, Nines and Eights)
IzslX/oV8DoDQfxCV/3+kg: shows [5h As] (a flush, Nine high)
IzslX/oV8DoDQfxCV/3+kg collected $26.65 from pot
*** SUMMARY ***
Total pot $28 | Rake $1.35
Board [9c 3h 9h 8h 4h]
Seat 1: QCqxb/MXSq5RKfPtjBjiBA (small blind) showed [8s 5s] and lost with two pair, Nines and Eights
Seat 2: IzslX/oV8DoDQfxCV/3+kg (big blind) showed [5h As] and won ($26.65) with a flush, Nine high
Seat 3: 6fLdOUCRtX71xbVRhJEq8w folded before Flop (didn't bet)
Seat 5: X7GlkHF+lkbarCLuZ4Uf0w folded before Flop (didn't bet)
Seat 6: gGPaCoSWW1HoKYaqfAPecg (button) folded before Flop (didn't bet)



PokerStars Game #59938305120:  Hold'em No Limit ($1/$2) - 2009/07/01 0:11:49 ET
Table 'l5lZHc5JRHEDt0Y2AVPq3g' 6-max Seat #6 is the button
Seat 1: gGPaCoSWW1HoKYaqfAPecg ($217.25 in chips)
Seat 2: my38j/MmtBd/8qVwmyCREA ($248.35 in chips)
Seat 4: zNjJ/y4emmF+vzrCDd+ooA ($205.55 in chips)
Seat 5: 6fLdOUCRtX71xbVRhJEq8w ($200 in chips)
Seat 6: vkfxu8f/jMYKUk6Ly4eujw ($203.30 in chips)
gGPaCoSWW1HoKYaqfAPecg: posts small blind $1
my38j/MmtBd/8qVwmyCREA: posts big blind $2
*** HOLE CARDS ***
zNjJ/y4emmF+vzrCDd+ooA: calls $2
6fLdOUCRtX71xbVRhJEq8w: folds
vkfxu8f/jMYKUk6Ly4eujw: folds
gGPaCoSWW1HoKYaqfAPecg: folds
6fLdOUCRtX71xbVRhJEq8w leaves the table
my38j/MmtBd/8qVwmyCREA: checks
*** FLOP *** [Qs Tc 4s]
my38j/MmtBd/8qVwmyCREA: checks
zNjJ/y4emmF+vzrCDd+ooA: bets $2
X7GlkHF+lkbarCLuZ4Uf0w joins the table at seat #5
my38j/MmtBd/8qVwmyCREA: calls $2
*** TURN *** [Qs Tc 4s] [Qc]
my38j/MmtBd/8qVwmyCREA: checks
zNjJ/y4emmF+vzrCDd+ooA: bets $2
my38j/MmtBd/8qVwmyCREA: calls $2
*** RIVER *** [Qs Tc 4s Qc] [7d]
my38j/MmtBd/8qVwmyCREA: checks
zNjJ/y4emmF+vzrCDd+ooA: checks
*** SHOW DOWN ***
my38j/MmtBd/8qVwmyCREA: shows [Ts 6c] (two pair, Queens and Tens)
zNjJ/y4emmF+vzrCDd+ooA: shows [9h Th] (two pair, Queens and Tens - Nine kicker)
zNjJ/y4emmF+vzrCDd+ooA collected $12.40 from pot
*** SUMMARY ***
Total pot $13 | Rake $0.60
Board [Qs Tc 4s Qc 7d]
Seat 1: gGPaCoSWW1HoKYaqfAPecg (small blind) folded before Flop
Seat 2: my38j/MmtBd/8qVwmyCREA (big blind) showed [Ts 6c] and lost with two pair, Queens and Tens
Seat 4: zNjJ/y4emmF+vzrCDd+ooA showed [9h Th] and won ($12.40) with two pair, Queens and Tens
Seat 5: 6fLdOUCRtX71xbVRhJEq8w folded before Flop (didn't bet)
Seat 6: vkfxu8f/jMYKUk6Ly4eujw (button) folded before Flop (didn't bet)



PokerStars Game #59938305882:  Hold'em No Limit ($1/$2) - 2009/07/01 0:11:50 ET
Table 'HewZCzVOYGmuLDKthTi5Yw' 6-max Seat #1 is the button
Seat 1: 353332 ($251.95 in chips)
Seat 2: X7GlkHF+lkbarCLuZ4Uf0w ($26 in chips)
Seat 3: WJxW31eStwT28R2X/L8F5A ($43.05 in chips)
Seat 5: 513FcCI8jHyQy2VWoIQkMg ($379.80 in chips)
Seat 6: /3OfVkAn8WikCv83i4bHHw ($117 in chips)
X7GlkHF+lkbarCLuZ4Uf0w: posts small blind $1
WJxW31eStwT28R2X/L8F5A: posts big blind $2
*** HOLE CARDS ***
513FcCI8jHyQy2VWoIQkMg: folds
/3OfVkAn8WikCv83i4bHHw: folds
353332: folds
X7GlkHF+lkbarCLuZ4Uf0w: raises $3 to $5
WJxW31eStwT28R2X/L8F5A: folds
X7GlkHF+lkbarCLuZ4Uf0w collected $4 from pot
X7GlkHF+lkbarCLuZ4Uf0w: doesn't show hand
*** SUMMARY ***
Total pot $4 | Rake $0
Seat 1: 353332 (button) folded before Flop (didn't bet)
Seat 2: X7GlkHF+lkbarCLuZ4Uf0w (small blind) collected ($4)
Seat 3: WJxW31eStwT28R2X/L8F5A (big blind) folded before Flop
Seat 5: 513FcCI8jHyQy2VWoIQkMg folded before Flop (didn't bet)
Seat 6: /3OfVkAn8WikCv83i4bHHw folded before Flop (didn't bet)



PokerStars Game #59938306808:  Hold'em No Limit ($1/$2) - 2009/07/01 0:11:51 ET
Table 'NmY84NAf9Mh0ckAckHnh5g' 2-max Seat #2 is the button
Seat 1: 6hvg964TSqZ3AL/0XK9aVQ ($345.75 in chips)
Seat 2: RwDoM55ZeQuI2ADyJhOb2Q ($245.05 in chips)
RwDoM55ZeQuI2ADyJhOb2Q: posts small blind $1
6hvg964TSqZ3AL/0XK9aVQ: posts big blind $2
*** HOLE CARDS ***
RwDoM55ZeQuI2ADyJhOb2Q: raises $4 to $6
6hvg964TSqZ3AL/0XK9aVQ: calls $4
*** FLOP *** [Ah 6c 9s]
6hvg964TSqZ3AL/0XK9aVQ: checks
RwDoM55ZeQuI2ADyJhOb2Q: bets $6
6hvg964TSqZ3AL/0XK9aVQ: calls $6
*** TURN *** [Ah 6c 9s] [5d]
6hvg964TSqZ3AL/0XK9aVQ: checks
RwDoM55ZeQuI2ADyJhOb2Q: bets $10
6hvg964TSqZ3AL/0XK9aVQ: raises $20 to $30
RwDoM55ZeQuI2ADyJhOb2Q: folds
6hvg964TSqZ3AL/0XK9aVQ collected $43.50 from pot
*** SUMMARY ***
Total pot $44 | Rake $0.50
Board [Ah 6c 9s 5d]
Seat 1: 6hvg964TSqZ3AL/0XK9aVQ (big blind) collected ($43.50)
Seat 2: RwDoM55ZeQuI2ADyJhOb2Q (button) (small blind) folded on the Turn



PokerStars Game #59938308488:  Hold'em No Limit ($1/$2) - 2009/07/01 0:11:53 ET
Table 'LL4bDFyhj5hsMpzaDugJZg' 6-max Seat #4 is the button
Seat 1: IBW9lyGsaRmfcbyA/qFfEw ($67.20 in chips)
Seat 2: L3l+A4pJhOAD6HVVFXvVBw ($291.95 in chips)
Seat 3: gGPaCoSWW1HoKYaqfAPecg ($202 in chips)
Seat 4: 8srN1dKQePlsv0GyTada+Q ($290.75 in chips)
Seat 5: HgX0VeqE/dzSXd5BpntRBw ($201 in chips)
HgX0VeqE/dzSXd5BpntRBw: posts small blind $1
IBW9lyGsaRmfcbyA/qFfEw: posts big blind $2
*** HOLE CARDS ***
L3l+A4pJhOAD6HVVFXvVBw: raises $4 to $6
gGPaCoSWW1HoKYaqfAPecg: folds
8srN1dKQePlsv0GyTada+Q: calls $6
HgX0VeqE/dzSXd5BpntRBw: calls $5
IBW9lyGsaRmfcbyA/qFfEw: folds
*** FLOP *** [5d Qd 3c]
HgX0VeqE/dzSXd5BpntRBw: checks
L3l+A4pJhOAD6HVVFXvVBw: bets $6
8srN1dKQePlsv0GyTada+Q: raises $10 to $16
HgX0VeqE/dzSXd5BpntRBw: folds
L3l+A4pJhOAD6HVVFXvVBw: calls $10
*** TURN *** [5d Qd 3c] [Qs]
L3l+A4pJhOAD6HVVFXvVBw: checks
8srN1dKQePlsv0GyTada+Q: checks
*** RIVER *** [5d Qd 3c Qs] [2d]
L3l+A4pJhOAD6HVVFXvVBw: bets $10
8srN1dKQePlsv0GyTada+Q: folds
L3l+A4pJhOAD6HVVFXvVBw collected $50 from pot
*** SUMMARY ***
Total pot $52 | Rake $2
Board [5d Qd 3c Qs 2d]
Seat 1: IBW9lyGsaRmfcbyA/qFfEw (big blind) folded before Flop
Seat 2: L3l+A4pJhOAD6HVVFXvVBw collected ($50)
Seat 3: gGPaCoSWW1HoKYaqfAPecg folded before Flop (didn't bet)
Seat 4: 8srN1dKQePlsv0GyTada+Q (button) folded on the River
Seat 5: HgX0VeqE/dzSXd5BpntRBw (small blind) folded on the Flop



PokerStars Game #59938308976:  Hold'em No Limit ($1/$2) - 2009/07/01 0:11:54 ET
Table 'jlrIxbrVIG+gjaUYT4za8g' 6-max Seat #1 is the button
Seat 1: ygTTt5ehT4aF86q1a8/R+w ($196.05 in chips)
Seat 2: N18PrNGQj43J7TJuQuu+tw ($129.80 in chips)
Seat 3: 54yWzRRgS0oZ+S6LwZBxMQ ($40 in chips)
Seat 4: 8srN1dKQePlsv0GyTada+Q ($200 in chips)
Seat 5: F/075N6nU34Fn0zr6qD3aw ($162.55 in chips)
Seat 6: vkfxu8f/jMYKUk6Ly4eujw ($288.95 in chips)
N18PrNGQj43J7TJuQuu+tw: posts small blind $1
54yWzRRgS0oZ+S6LwZBxMQ: posts big blind $2
*** HOLE CARDS ***
8srN1dKQePlsv0GyTada+Q: folds
F/075N6nU34Fn0zr6qD3aw: folds
vkfxu8f/jMYKUk6Ly4eujw: folds
ygTTt5ehT4aF86q1a8/R+w: folds
N18PrNGQj43J7TJuQuu+tw: calls $1
54yWzRRgS0oZ+S6LwZBxMQ: checks
*** FLOP *** [Kc 4c 2s]
N18PrNGQj43J7TJuQuu+tw: checks
54yWzRRgS0oZ+S6LwZBxMQ: bets $4
F/075N6nU34Fn0zr6qD3aw leaves the table
N18PrNGQj43J7TJuQuu+tw: folds
VuZb/hkEc4X7s93w2ZZTpA joins the table at seat #5
54yWzRRgS0oZ+S6LwZBxMQ collected $3.80 from pot
*** SUMMARY ***
Total pot $4 | Rake $0.20
Board [Kc 4c 2s]
Seat 1: ygTTt5ehT4aF86q1a8/R+w (button) folded before Flop (didn't bet)
Seat 2: N18PrNGQj43J7TJuQuu+tw (small blind) folded on the Flop
Seat 3: 54yWzRRgS0oZ+S6LwZBxMQ (big blind) collected ($3.80)
Seat 4: 8srN1dKQePlsv0GyTada+Q folded before Flop (didn't bet)
Seat 5: F/075N6nU34Fn0zr6qD3aw folded before Flop (didn't bet)
Seat 6: vkfxu8f/jMYKUk6Ly4eujw folded before Flop (didn't bet)



PokerStars Game #59938312372:  Hold'em No Limit ($1/$2) - 2009/07/01 0:11:59 ET
Table 'W9UeSV0aoPjh5SFSxM8jUQ' 9-max Seat #3 is the button
Seat 1: cdC54j9fGGojcbzWB5PgzA ($233.35 in chips)
Seat 2: iMe5yhc+1BaiIPHet3NMrA ($260.75 in chips)
Seat 3: TAfo4veNRaRlzDXMMYS3Jg ($37 in chips)
Seat 4: De9g+AYjo0DN6C/+iT/nsg ($198 in chips)
Seat 6: MXxB6weBWzZyAhRZb+/KVg ($200 in chips)
Seat 7: 4Cl43Q1TYQL8wn1NSCUkaw ($51.60 in chips)
Seat 8: gvAfRM7YyyK5hFYc5+qhNA ($118.55 in chips)
Seat 9: U2A5Hv6ib/5+gzO2wr7Z4w ($200 in chips)
De9g+AYjo0DN6C/+iT/nsg: posts small blind $1
gvAfRM7YyyK5hFYc5+qhNA said, "nh lol"
5c0Nx4jItp6QcQ2ve2inRw: is sitting out
MXxB6weBWzZyAhRZb+/KVg: posts big blind $2
*** HOLE CARDS ***
5c0Nx4jItp6QcQ2ve2inRw leaves the table
4Cl43Q1TYQL8wn1NSCUkaw: folds
gvAfRM7YyyK5hFYc5+qhNA: folds
gvAfRM7YyyK5hFYc5+qhNA leaves the table
U2A5Hv6ib/5+gzO2wr7Z4w: folds
cdC54j9fGGojcbzWB5PgzA: folds
iMe5yhc+1BaiIPHet3NMrA: folds
TAfo4veNRaRlzDXMMYS3Jg: folds
De9g+AYjo0DN6C/+iT/nsg: folds
MXxB6weBWzZyAhRZb+/KVg collected $2 from pot
*** SUMMARY ***
Total pot $2 | Rake $0
Seat 1: cdC54j9fGGojcbzWB5PgzA folded before Flop (didn't bet)
Seat 2: iMe5yhc+1BaiIPHet3NMrA folded before Flop (didn't bet)
Seat 3: TAfo4veNRaRlzDXMMYS3Jg (button) folded before Flop (didn't bet)
Seat 4: De9g+AYjo0DN6C/+iT/nsg (small blind) folded before Flop
Seat 6: MXxB6weBWzZyAhRZb+/KVg (big blind) collected ($2)
Seat 7: 4Cl43Q1TYQL8wn1NSCUkaw folded before Flop (didn't bet)
Seat 8: gvAfRM7YyyK5hFYc5+qhNA folded before Flop (didn't bet)
Seat 9: U2A5Hv6ib/5+gzO2wr7Z4w folded before Flop (didn't bet)



PokerStars Game #59938314642:  Hold'em No Limit ($1/$2) - 2009/07/01 0:12:02 ET
Table 'SF49/KQm8T4taMp6kb+HXA' 9-max Seat #7 is the button
Seat 1: l1bCLGuFqeFRwUfPsiDu/g ($176.95 in chips)
Seat 2: 8Z3QifiM9eOd5EIJ25dXNg ($109.15 in chips)
Seat 4: HffgoYm61KgkdMe/DYChIQ ($34 in chips)
Seat 5: Z3aYCZG/yXHYFjiWkGI5ug ($226.55 in chips)
Seat 6: M2ht6rIKOI/my9eh610Nlw ($240.45 in chips)
Seat 7: n2VAbLaE5qgKr5mA4W6v4w ($51.50 in chips)
Seat 8: 5iPk5MyO3KVu18Y8XCYfFQ ($44 in chips)
Seat 9: O+jytCilwk7zItVCEavmtw ($143 in chips)
5iPk5MyO3KVu18Y8XCYfFQ: posts small blind $1
O+jytCilwk7zItVCEavmtw: posts big blind $2
*** HOLE CARDS ***
l1bCLGuFqeFRwUfPsiDu/g: folds
8Z3QifiM9eOd5EIJ25dXNg: calls $2
HffgoYm61KgkdMe/DYChIQ: folds
Z3aYCZG/yXHYFjiWkGI5ug: folds
M2ht6rIKOI/my9eh610Nlw: raises $3.80 to $5.80
n2VAbLaE5qgKr5mA4W6v4w: folds
5iPk5MyO3KVu18Y8XCYfFQ: folds
O+jytCilwk7zItVCEavmtw: calls $3.80
8Z3QifiM9eOd5EIJ25dXNg: calls $3.80
*** FLOP *** [Ts Qc Kc]
O+jytCilwk7zItVCEavmtw: bets $8
8Z3QifiM9eOd5EIJ25dXNg: folds
M2ht6rIKOI/my9eh610Nlw: raises $40 to $48
O+jytCilwk7zItVCEavmtw said, "K ng?"
O+jytCilwk7zItVCEavmtw said, "nh"
O+jytCilwk7zItVCEavmtw: folds
M2ht6rIKOI/my9eh610Nlw collected $32.75 from pot
*** SUMMARY ***
Total pot $34.40 | Rake $1.65
Board [Ts Qc Kc]
Seat 1: l1bCLGuFqeFRwUfPsiDu/g folded before Flop (didn't bet)
Seat 2: 8Z3QifiM9eOd5EIJ25dXNg folded on the Flop
Seat 4: HffgoYm61KgkdMe/DYChIQ folded before Flop (didn't bet)
Seat 5: Z3aYCZG/yXHYFjiWkGI5ug folded before Flop (didn't bet)
Seat 6: M2ht6rIKOI/my9eh610Nlw collected ($32.75)
Seat 7: n2VAbLaE5qgKr5mA4W6v4w (button) folded before Flop (didn't bet)
Seat 8: 5iPk5MyO3KVu18Y8XCYfFQ (small blind) folded before Flop
Seat 9: O+jytCilwk7zItVCEavmtw (big blind) folded on the Flop



PokerStars Game #59938314762:  Hold'em No Limit ($1/$2) - 2009/07/01 0:12:02 ET
Table 'aSf77Sj8QEnzcc0WaxVD4Q' 6-max Seat #2 is the button
Seat 1: Q3uFdu6ztesjDFiqkagTRQ ($246.20 in chips)
Seat 2: vkfxu8f/jMYKUk6Ly4eujw ($192.75 in chips)
Seat 3: 9dpyyjDTCed6nV7JhaUUpw ($221.05 in chips)
Seat 4: 513FcCI8jHyQy2VWoIQkMg ($200 in chips)
Seat 5: InmkdI6G8TzSj9NhcCSyPg ($250 in chips)
Seat 6: vkoJRf3gidxY1pPi0AFWww ($312.60 in chips)
9dpyyjDTCed6nV7JhaUUpw: posts small blind $1
513FcCI8jHyQy2VWoIQkMg: posts big blind $2
*** HOLE CARDS ***
InmkdI6G8TzSj9NhcCSyPg: folds
vkoJRf3gidxY1pPi0AFWww: calls $2
Q3uFdu6ztesjDFiqkagTRQ: folds
vkfxu8f/jMYKUk6Ly4eujw: folds
9dpyyjDTCed6nV7JhaUUpw: folds
513FcCI8jHyQy2VWoIQkMg: checks
*** FLOP *** [Qs Qc 3s]
513FcCI8jHyQy2VWoIQkMg: checks
vkoJRf3gidxY1pPi0AFWww: checks
*** TURN *** [Qs Qc 3s] [Jh]
513FcCI8jHyQy2VWoIQkMg: checks
vkoJRf3gidxY1pPi0AFWww: checks
*** RIVER *** [Qs Qc 3s Jh] [Kc]
513FcCI8jHyQy2VWoIQkMg: checks
vkoJRf3gidxY1pPi0AFWww: checks
*** SHOW DOWN ***
513FcCI8jHyQy2VWoIQkMg: shows [Kh 3h] (two pair, Kings and Queens)
vkoJRf3gidxY1pPi0AFWww: mucks hand
513FcCI8jHyQy2VWoIQkMg collected $4.75 from pot
*** SUMMARY ***
Total pot $5 | Rake $0.25
Board [Qs Qc 3s Jh Kc]
Seat 1: Q3uFdu6ztesjDFiqkagTRQ folded before Flop (didn't bet)
Seat 2: vkfxu8f/jMYKUk6Ly4eujw (button) folded before Flop (didn't bet)
Seat 3: 9dpyyjDTCed6nV7JhaUUpw (small blind) folded before Flop
Seat 4: 513FcCI8jHyQy2VWoIQkMg (big blind) showed [Kh 3h] and won ($4.75) with two pair, Kings and Queens
Seat 5: InmkdI6G8TzSj9NhcCSyPg folded before Flop (didn't bet)
Seat 6: vkoJRf3gidxY1pPi0AFWww mucked



PokerStars Game #59938317400:  Hold'em No Limit ($1/$2) - 2009/07/01 0:12:06 ET
Table 'bJQ024BaYSBrW0sXpCZbNQ' 6-max Seat #5 is the button
Seat 1: Mo7b4GXWaawCURUQwq6RYg ($120 in chips)
Seat 2: 1njbh8TKSUF6l4V1XwGdcg ($266 in chips)
Seat 3: vkfxu8f/jMYKUk6Ly4eujw ($211.60 in chips)
Seat 4: 9ni/OEXAqfc58zPQ0Tu9rQ ($265.60 in chips)
Seat 5: X7GlkHF+lkbarCLuZ4Uf0w ($58.15 in chips)
Seat 6: 9dpyyjDTCed6nV7JhaUUpw ($200 in chips)
9dpyyjDTCed6nV7JhaUUpw: posts small blind $1
Mo7b4GXWaawCURUQwq6RYg: posts big blind $2
*** HOLE CARDS ***
1njbh8TKSUF6l4V1XwGdcg: folds
vkfxu8f/jMYKUk6Ly4eujw: folds
9ni/OEXAqfc58zPQ0Tu9rQ is disconnected
9ni/OEXAqfc58zPQ0Tu9rQ is connected
9ni/OEXAqfc58zPQ0Tu9rQ: folds
X7GlkHF+lkbarCLuZ4Uf0w: folds
9dpyyjDTCed6nV7JhaUUpw: folds
Mo7b4GXWaawCURUQwq6RYg collected $2 from pot
Mo7b4GXWaawCURUQwq6RYg: doesn't show hand
*** SUMMARY ***
Total pot $2 | Rake $0
Seat 1: Mo7b4GXWaawCURUQwq6RYg (big blind) collected ($2)
Seat 2: 1njbh8TKSUF6l4V1XwGdcg folded before Flop (didn't bet)
Seat 3: vkfxu8f/jMYKUk6Ly4eujw folded before Flop (didn't bet)
Seat 4: 9ni/OEXAqfc58zPQ0Tu9rQ folded before Flop (didn't bet)
Seat 5: X7GlkHF+lkbarCLuZ4Uf0w (button) folded before Flop (didn't bet)
Seat 6: 9dpyyjDTCed6nV7JhaUUpw (small blind) folded before Flop



PokerStars Game #59938317226:  Hold'em No Limit ($1/$2) - 2009/07/01 0:12:06 ET
Table 'rsKRKlGHlxVyqJxzO2a2Ow' 9-max Seat #6 is the button
Seat 1: uYWfQJg2hgHLxri6/uVJiw ($137.10 in chips)
Seat 2: QHxJjpVYwitg9krW6wZgJA ($247.50 in chips)
Seat 3: 9sYbXdhj1M2bwKrVNxj5+Q ($113.80 in chips)
Seat 4: zJtQ1gxyi72XvGYS1tM+DA ($182.55 in chips)
Seat 5: 5Q8U6iZbeO7xJSS4qvDP5g ($203 in chips)
Seat 6: H6Z4+qu8gR0VUiPOijndVg ($200 in chips)
Seat 7: kVCeGJ4NY7Fb0W74j1mAqA ($200 in chips)
Seat 8: Hc2itIxwbi1lwa+DAYYQGg ($37 in chips)
Seat 9: 5iPk5MyO3KVu18Y8XCYfFQ ($98.10 in chips)
kVCeGJ4NY7Fb0W74j1mAqA: posts small blind $1
Hc2itIxwbi1lwa+DAYYQGg: posts big blind $2
*** HOLE CARDS ***
5iPk5MyO3KVu18Y8XCYfFQ: folds
uYWfQJg2hgHLxri6/uVJiw: folds
QHxJjpVYwitg9krW6wZgJA: folds
9sYbXdhj1M2bwKrVNxj5+Q: folds
zJtQ1gxyi72XvGYS1tM+DA: folds
5Q8U6iZbeO7xJSS4qvDP5g: folds
H6Z4+qu8gR0VUiPOijndVg: raises $2 to $4
kVCeGJ4NY7Fb0W74j1mAqA: raises $9 to $13
Hc2itIxwbi1lwa+DAYYQGg: folds
H6Z4+qu8gR0VUiPOijndVg: folds
kVCeGJ4NY7Fb0W74j1mAqA collected $10 from pot
kVCeGJ4NY7Fb0W74j1mAqA: doesn't show hand
*** SUMMARY ***
Total pot $10 | Rake $0
Seat 1: uYWfQJg2hgHLxri6/uVJiw folded before Flop (didn't bet)
Seat 2: QHxJjpVYwitg9krW6wZgJA folded before Flop (didn't bet)
Seat 3: 9sYbXdhj1M2bwKrVNxj5+Q folded before Flop (didn't bet)
Seat 4: zJtQ1gxyi72XvGYS1tM+DA folded before Flop (didn't bet)
Seat 5: 5Q8U6iZbeO7xJSS4qvDP5g folded before Flop (didn't bet)
Seat 6: H6Z4+qu8gR0VUiPOijndVg (button) folded before Flop
Seat 7: kVCeGJ4NY7Fb0W74j1mAqA (small blind) collected ($10)
Seat 8: Hc2itIxwbi1lwa+DAYYQGg (big blind) folded before Flop
Seat 9: 5iPk5MyO3KVu18Y8XCYfFQ folded before Flop (didn't bet)



PokerStars Game #59938319774:  Hold'em No Limit ($1/$2) - 2009/07/01 0:12:09 ET
Table 'gnHBqWll9O3fxG7Ojkz/ng' 9-max Seat #9 is the button
Seat 1: hpqdC/23wXosGOmzARr5NA ($157.05 in chips)
Seat 2: H6Z4+qu8gR0VUiPOijndVg ($203 in chips)
Seat 3: 5Q8U6iZbeO7xJSS4qvDP5g ($218.60 in chips)
Seat 4: n5XI5/7gN+gIubHFBH+mOw ($401.85 in chips)
Seat 6: 5iPk5MyO3KVu18Y8XCYfFQ ($52.45 in chips)
Seat 8: De9g+AYjo0DN6C/+iT/nsg ($241.05 in chips)
Seat 9: kVCeGJ4NY7Fb0W74j1mAqA ($206 in chips)
hpqdC/23wXosGOmzARr5NA: posts small blind $1
H6Z4+qu8gR0VUiPOijndVg: posts big blind $2
rBQDMkKm9cZn6M9NPsiVew: sits out
*** HOLE CARDS ***
5Q8U6iZbeO7xJSS4qvDP5g: folds
n5XI5/7gN+gIubHFBH+mOw: folds
5iPk5MyO3KVu18Y8XCYfFQ: folds
De9g+AYjo0DN6C/+iT/nsg: raises $4 to $6
kVCeGJ4NY7Fb0W74j1mAqA: folds
hpqdC/23wXosGOmzARr5NA: folds
H6Z4+qu8gR0VUiPOijndVg: folds
De9g+AYjo0DN6C/+iT/nsg collected $5 from pot
De9g+AYjo0DN6C/+iT/nsg: doesn't show hand
*** SUMMARY ***
Total pot $5 | Rake $0
Seat 1: hpqdC/23wXosGOmzARr5NA (small blind) folded before Flop
Seat 2: H6Z4+qu8gR0VUiPOijndVg (big blind) folded before Flop
Seat 3: 5Q8U6iZbeO7xJSS4qvDP5g folded before Flop (didn't bet)
Seat 4: n5XI5/7gN+gIubHFBH+mOw folded before Flop (didn't bet)
Seat 6: 5iPk5MyO3KVu18Y8XCYfFQ folded before Flop (didn't bet)
Seat 8: De9g+AYjo0DN6C/+iT/nsg collected ($5)
Seat 9: kVCeGJ4NY7Fb0W74j1mAqA (button) folded before Flop (didn't bet)



PokerStars Game #59938321502:  Hold'em No Limit ($1/$2) - 2009/07/01 0:12:12 ET
Table 'qVXak+oTeDXMGbWa4sDU5Q' 9-max Seat #1 is the button
Seat 1: H6Z4+qu8gR0VUiPOijndVg ($247 in chips)
Seat 2: Hc2itIxwbi1lwa+DAYYQGg ($47 in chips)
Seat 3: oz9eCXGC7DdjQlL/nuWj1A ($108.60 in chips)
Seat 4: b0jO1SDhLedy1//CQlA8kw ($40 in chips)
Seat 6: Q3uFdu6ztesjDFiqkagTRQ ($203 in chips)
Seat 7: 5iPk5MyO3KVu18Y8XCYfFQ ($115 in chips)
Seat 8: 9pHZMviI9R8injxojGTnvw ($101.85 in chips)
Seat 9: IZ/2qsh1CIg9m5PWsMsLmA ($357.95 in chips)
Hc2itIxwbi1lwa+DAYYQGg: posts small blind $1
oz9eCXGC7DdjQlL/nuWj1A: posts big blind $2
NqKRc5xvcye0d7F6VOF6MQ: sits out
*** HOLE CARDS ***
b0jO1SDhLedy1//CQlA8kw: folds
Q3uFdu6ztesjDFiqkagTRQ: raises $4 to $6
5iPk5MyO3KVu18Y8XCYfFQ: folds
9pHZMviI9R8injxojGTnvw: calls $6
IZ/2qsh1CIg9m5PWsMsLmA: calls $6
H6Z4+qu8gR0VUiPOijndVg: folds
Hc2itIxwbi1lwa+DAYYQGg: folds
oz9eCXGC7DdjQlL/nuWj1A: folds
*** FLOP *** [4s 8d 2c]
Q3uFdu6ztesjDFiqkagTRQ: checks
9pHZMviI9R8injxojGTnvw: bets $8
IZ/2qsh1CIg9m5PWsMsLmA: folds
Q3uFdu6ztesjDFiqkagTRQ: folds
9pHZMviI9R8injxojGTnvw collected $19.95 from pot
*** SUMMARY ***
Total pot $21 | Rake $1.05
Board [4s 8d 2c]
Seat 1: H6Z4+qu8gR0VUiPOijndVg (button) folded before Flop (didn't bet)
Seat 2: Hc2itIxwbi1lwa+DAYYQGg (small blind) folded before Flop
Seat 3: oz9eCXGC7DdjQlL/nuWj1A (big blind) folded before Flop
Seat 4: b0jO1SDhLedy1//CQlA8kw folded before Flop (didn't bet)
Seat 6: Q3uFdu6ztesjDFiqkagTRQ folded on the Flop
Seat 7: 5iPk5MyO3KVu18Y8XCYfFQ folded before Flop (didn't bet)
Seat 8: 9pHZMviI9R8injxojGTnvw collected ($19.95)
Seat 9: IZ/2qsh1CIg9m5PWsMsLmA folded on the Flop



PokerStars Game #59938322190:  Hold'em No Limit ($1/$2) - 2009/07/01 0:12:13 ET
Table '3FGoiEOffWrbgTfsB3t7FA' 2-max Seat #2 is the button
Seat 1: e0oDWyrmgLpR6bROEqw1nQ ($328 in chips)
Seat 2: +sy/nlNI20yZraIjs4AALg ($273.65 in chips)
+sy/nlNI20yZraIjs4AALg: posts small blind $1
e0oDWyrmgLpR6bROEqw1nQ: posts big blind $2
*** HOLE CARDS ***
+sy/nlNI20yZraIjs4AALg: calls $1
e0oDWyrmgLpR6bROEqw1nQ: checks
*** FLOP *** [Jc 5c 4h]
e0oDWyrmgLpR6bROEqw1nQ: checks
+sy/nlNI20yZraIjs4AALg: checks
*** TURN *** [Jc 5c 4h] [Jh]
e0oDWyrmgLpR6bROEqw1nQ: bets $4
+sy/nlNI20yZraIjs4AALg: calls $4
*** RIVER *** [Jc 5c 4h Jh] [Qd]
e0oDWyrmgLpR6bROEqw1nQ: bets $8
+sy/nlNI20yZraIjs4AALg: calls $8
*** SHOW DOWN ***
e0oDWyrmgLpR6bROEqw1nQ: shows [4s Jd] (a full house, Jacks full of Fours)
+sy/nlNI20yZraIjs4AALg: mucks hand
e0oDWyrmgLpR6bROEqw1nQ collected $27.50 from pot
*** SUMMARY ***
Total pot $28 | Rake $0.50
Board [Jc 5c 4h Jh Qd]
Seat 1: e0oDWyrmgLpR6bROEqw1nQ (big blind) showed [4s Jd] and won ($27.50) with a full house, Jacks full of Fours
Seat 2: +sy/nlNI20yZraIjs4AALg (button) (small blind) mucked



PokerStars Game #59938323850:  Hold'em No Limit ($1/$2) - 2009/07/01 0:12:15 ET
Table 'WCA60bDA8ecovUgFSIZkTQ' 9-max Seat #6 is the button
Seat 2: G1h8wamBcVJXtsKXZQ2EyA ($101.40 in chips)
Seat 3: 5iPk5MyO3KVu18Y8XCYfFQ ($37 in chips)
Seat 4: Q3uFdu6ztesjDFiqkagTRQ ($464.70 in chips)
Seat 5: Hc2itIxwbi1lwa+DAYYQGg ($306.30 in chips)
Seat 6: DOWQSOJ7GaX+ksfWTqPT5A ($256.75 in chips)
Seat 8: x+V1JgVDawsJTxKcxm7gxw ($70 in chips)
Seat 9: 3q2/0oJr3Mcy1W5tcN61ug ($298.20 in chips)
x+V1JgVDawsJTxKcxm7gxw: posts small blind $1
3q2/0oJr3Mcy1W5tcN61ug: posts big blind $2
CUZwDpLTQKhzarPe+JCLOQ: sits out
*** HOLE CARDS ***
G1h8wamBcVJXtsKXZQ2EyA: folds
5iPk5MyO3KVu18Y8XCYfFQ: folds
Q3uFdu6ztesjDFiqkagTRQ: folds
Hc2itIxwbi1lwa+DAYYQGg: folds
DOWQSOJ7GaX+ksfWTqPT5A: folds
x+V1JgVDawsJTxKcxm7gxw: raises $4 to $6
3q2/0oJr3Mcy1W5tcN61ug: folds
x+V1JgVDawsJTxKcxm7gxw collected $4 from pot
x+V1JgVDawsJTxKcxm7gxw: doesn't show hand
*** SUMMARY ***
Total pot $4 | Rake $0
Seat 2: G1h8wamBcVJXtsKXZQ2EyA folded before Flop (didn't bet)
Seat 3: 5iPk5MyO3KVu18Y8XCYfFQ folded before Flop (didn't bet)
Seat 4: Q3uFdu6ztesjDFiqkagTRQ folded before Flop (didn't bet)
Seat 5: Hc2itIxwbi1lwa+DAYYQGg folded before Flop (didn't bet)
Seat 6: DOWQSOJ7GaX+ksfWTqPT5A (button) folded before Flop (didn't bet)
Seat 8: x+V1JgVDawsJTxKcxm7gxw (small blind) collected ($4)
Seat 9: 3q2/0oJr3Mcy1W5tcN61ug (big blind) folded before Flop



PokerStars Game #59938324078:  Hold'em No Limit ($1/$2) - 2009/07/01 0:12:16 ET
Table 'pPQgcj9XT9CHBsbo1WTBug' 6-max Seat #2 is the button
Seat 1: DFVYDA6dKQy7R7mGIKogZA ($73.30 in chips)
Seat 2: X7GlkHF+lkbarCLuZ4Uf0w ($42.55 in chips)
Seat 3: vkfxu8f/jMYKUk6Ly4eujw ($189 in chips)
Seat 5: 4Cl43Q1TYQL8wn1NSCUkaw ($65.45 in chips)
vkfxu8f/jMYKUk6Ly4eujw: posts small blind $1
4Cl43Q1TYQL8wn1NSCUkaw: posts big blind $2
*** HOLE CARDS ***
DFVYDA6dKQy7R7mGIKogZA: raises $2 to $4
X7GlkHF+lkbarCLuZ4Uf0w: folds
vkfxu8f/jMYKUk6Ly4eujw: folds
4Cl43Q1TYQL8wn1NSCUkaw: calls $2
*** FLOP *** [Kd 4h Ac]
4Cl43Q1TYQL8wn1NSCUkaw: checks
DFVYDA6dKQy7R7mGIKogZA: bets $8
4Cl43Q1TYQL8wn1NSCUkaw: folds
DFVYDA6dKQy7R7mGIKogZA collected $8.55 from pot
*** SUMMARY ***
Total pot $9 | Rake $0.45
Board [Kd 4h Ac]
Seat 1: DFVYDA6dKQy7R7mGIKogZA collected ($8.55)
Seat 2: X7GlkHF+lkbarCLuZ4Uf0w (button) folded before Flop (didn't bet)
Seat 3: vkfxu8f/jMYKUk6Ly4eujw (small blind) folded before Flop
Seat 5: 4Cl43Q1TYQL8wn1NSCUkaw (big blind) folded on the Flop



PokerStars Game #59938326752:  Hold'em No Limit ($1/$2) - 2009/07/01 0:12:20 ET
Table 'YqGfR5eHfMeSjb9a+QU9rg' 9-max Seat #3 is the button
Seat 1: qCBuzVnLcBR29snMAHq9PA ($136.90 in chips)
Seat 2: W3Nqt1GWlTi9tXQXMNEvgw ($255.95 in chips)
Seat 3: /gll27k+xWYV7Fbki0lFDQ ($123.05 in chips)
Seat 4: QHxJjpVYwitg9krW6wZgJA ($200 in chips)
Seat 5: MOBMOMQRN/z+fiGXGnZojw ($173.10 in chips)
Seat 6: 5iPk5MyO3KVu18Y8XCYfFQ ($46 in chips)
Seat 7: b0jO1SDhLedy1//CQlA8kw ($39 in chips)
Seat 8: JnV3SM2D6dAFYyGZHHpvrg ($100 in chips)
Seat 9: RsrgM2l7PLbQ9xBbSi3IvQ ($116.55 in chips)
QHxJjpVYwitg9krW6wZgJA: posts small blind $1
MOBMOMQRN/z+fiGXGnZojw: posts big blind $2
*** HOLE CARDS ***
5iPk5MyO3KVu18Y8XCYfFQ: folds
b0jO1SDhLedy1//CQlA8kw: folds
JnV3SM2D6dAFYyGZHHpvrg: folds
RsrgM2l7PLbQ9xBbSi3IvQ has timed out
RsrgM2l7PLbQ9xBbSi3IvQ: folds
RsrgM2l7PLbQ9xBbSi3IvQ is sitting out
qCBuzVnLcBR29snMAHq9PA: folds
W3Nqt1GWlTi9tXQXMNEvgw: raises $2 to $4
/gll27k+xWYV7Fbki0lFDQ: folds
QHxJjpVYwitg9krW6wZgJA: folds
RsrgM2l7PLbQ9xBbSi3IvQ has returned
MOBMOMQRN/z+fiGXGnZojw: calls $2
*** FLOP *** [9h 5c 7h]
MOBMOMQRN/z+fiGXGnZojw: checks
W3Nqt1GWlTi9tXQXMNEvgw: bets $6
MOBMOMQRN/z+fiGXGnZojw: calls $6
*** TURN *** [9h 5c 7h] [Th]
MOBMOMQRN/z+fiGXGnZojw: bets $12
W3Nqt1GWlTi9tXQXMNEvgw: folds
MOBMOMQRN/z+fiGXGnZojw collected $20 from pot
*** SUMMARY ***
Total pot $21 | Rake $1
Board [9h 5c 7h Th]
Seat 1: qCBuzVnLcBR29snMAHq9PA folded before Flop (didn't bet)
Seat 2: W3Nqt1GWlTi9tXQXMNEvgw folded on the Turn
Seat 3: /gll27k+xWYV7Fbki0lFDQ (button) folded before Flop (didn't bet)
Seat 4: QHxJjpVYwitg9krW6wZgJA (small blind) folded before Flop
Seat 5: MOBMOMQRN/z+fiGXGnZojw (big blind) collected ($20)
Seat 6: 5iPk5MyO3KVu18Y8XCYfFQ folded before Flop (didn't bet)
Seat 7: b0jO1SDhLedy1//CQlA8kw folded before Flop (didn't bet)
Seat 8: JnV3SM2D6dAFYyGZHHpvrg folded before Flop (didn't bet)
Seat 9: RsrgM2l7PLbQ9xBbSi3IvQ folded before Flop (didn't bet)



PokerStars Game #59938328358:  Hold'em No Limit ($1/$2) - 2009/07/01 0:12:22 ET
Table 'HewZCzVOYGmuLDKthTi5Yw' 6-max Seat #2 is the button
Seat 1: 353332 ($251.95 in chips)
Seat 2: X7GlkHF+lkbarCLuZ4Uf0w ($28 in chips)
Seat 3: WJxW31eStwT28R2X/L8F5A ($41.05 in chips)
Seat 5: 513FcCI8jHyQy2VWoIQkMg ($379.80 in chips)
Seat 6: /3OfVkAn8WikCv83i4bHHw ($117 in chips)
WJxW31eStwT28R2X/L8F5A: posts small blind $1
513FcCI8jHyQy2VWoIQkMg: posts big blind $2
*** HOLE CARDS ***
/3OfVkAn8WikCv83i4bHHw: folds
353332: folds
/3OfVkAn8WikCv83i4bHHw leaves the table
X7GlkHF+lkbarCLuZ4Uf0w: raises $2 to $4
WJxW31eStwT28R2X/L8F5A: folds
513FcCI8jHyQy2VWoIQkMg: folds
X7GlkHF+lkbarCLuZ4Uf0w collected $5 from pot
X7GlkHF+lkbarCLuZ4Uf0w: doesn't show hand
*** SUMMARY ***
Total pot $5 | Rake $0
Seat 1: 353332 folded before Flop (didn't bet)
Seat 2: X7GlkHF+lkbarCLuZ4Uf0w (button) collected ($5)
Seat 3: WJxW31eStwT28R2X/L8F5A (small blind) folded before Flop
Seat 5: 513FcCI8jHyQy2VWoIQkMg (big blind) folded before Flop
Seat 6: /3OfVkAn8WikCv83i4bHHw folded before Flop (didn't bet)



PokerStars Game #59938328604:  Hold'em No Limit ($1/$2) - 2009/07/01 0:12:22 ET
Table 'NmY84NAf9Mh0ckAckHnh5g' 2-max Seat #1 is the button
Seat 1: 6hvg964TSqZ3AL/0XK9aVQ ($367.25 in chips)
Seat 2: RwDoM55ZeQuI2ADyJhOb2Q ($223.05 in chips)
6hvg964TSqZ3AL/0XK9aVQ: posts small blind $1
RwDoM55ZeQuI2ADyJhOb2Q: posts big blind $2
*** HOLE CARDS ***
6hvg964TSqZ3AL/0XK9aVQ: folds
RwDoM55ZeQuI2ADyJhOb2Q collected $2 from pot
RwDoM55ZeQuI2ADyJhOb2Q: doesn't show hand
*** SUMMARY ***
Total pot $2 | Rake $0
Seat 1: 6hvg964TSqZ3AL/0XK9aVQ (button) (small blind) folded before Flop
Seat 2: RwDoM55ZeQuI2ADyJhOb2Q (big blind) collected ($2)



PokerStars Game #59938332968:  Hold'em No Limit ($1/$2) - 2009/07/01 0:12:28 ET
Table 'NmY84NAf9Mh0ckAckHnh5g' 2-max Seat #2 is the button
Seat 1: 6hvg964TSqZ3AL/0XK9aVQ ($366.25 in chips)
Seat 2: RwDoM55ZeQuI2ADyJhOb2Q ($224.05 in chips)
RwDoM55ZeQuI2ADyJhOb2Q: posts small blind $1
6hvg964TSqZ3AL/0XK9aVQ: posts big blind $2
*** HOLE CARDS ***
RwDoM55ZeQuI2ADyJhOb2Q: raises $4 to $6
6hvg964TSqZ3AL/0XK9aVQ: calls $4
*** FLOP *** [6h 5h 3h]
6hvg964TSqZ3AL/0XK9aVQ: checks
RwDoM55ZeQuI2ADyJhOb2Q: bets $8
6hvg964TSqZ3AL/0XK9aVQ: calls $8
*** TURN *** [6h 5h 3h] [6d]
6hvg964TSqZ3AL/0XK9aVQ: checks
RwDoM55ZeQuI2ADyJhOb2Q: checks
*** RIVER *** [6h 5h 3h 6d] [4s]
6hvg964TSqZ3AL/0XK9aVQ: bets $12
RwDoM55ZeQuI2ADyJhOb2Q: calls $12
*** SHOW DOWN ***
6hvg964TSqZ3AL/0XK9aVQ: shows [Ts Kh] (a pair of Sixes)
RwDoM55ZeQuI2ADyJhOb2Q: shows [Kd 4d] (two pair, Sixes and Fours)
RwDoM55ZeQuI2ADyJhOb2Q collected $51.50 from pot
*** SUMMARY ***
Total pot $52 | Rake $0.50
Board [6h 5h 3h 6d 4s]
Seat 1: 6hvg964TSqZ3AL/0XK9aVQ (big blind) showed [Ts Kh] and lost with a pair of Sixes
Seat 2: RwDoM55ZeQuI2ADyJhOb2Q (button) (small blind) showed [Kd 4d] and won ($51.50) with two pair, Sixes and Fours



PokerStars Game #59938333312:  Hold'em No Limit ($1/$2) - 2009/07/01 0:12:29 ET
Table 'srul5UFZXTEccVV5fpY91g' 9-max Seat #7 is the button
Seat 1: lfD8cBv31A/pio3pXJbPjA ($193.20 in chips)
Seat 2: tJYod1SLp2AcWPL/3hZ7ug ($107.20 in chips)
Seat 3: weUZ8S7tgbaeIpzi1gBNxQ ($51.75 in chips)
Seat 4: GG5lTuGt3+kwNYSbqeB6yw ($81.85 in chips)
Seat 5: 5iPk5MyO3KVu18Y8XCYfFQ ($43.10 in chips)
Seat 6: TAfo4veNRaRlzDXMMYS3Jg ($36 in chips)
Seat 7: s0erZsDxbZSaEPheMgibKg ($439.40 in chips)
lfD8cBv31A/pio3pXJbPjA: posts small blind $1
tJYod1SLp2AcWPL/3hZ7ug: posts big blind $2
*** HOLE CARDS ***
weUZ8S7tgbaeIpzi1gBNxQ: folds
GG5lTuGt3+kwNYSbqeB6yw: folds
5iPk5MyO3KVu18Y8XCYfFQ: folds
TAfo4veNRaRlzDXMMYS3Jg: folds
s0erZsDxbZSaEPheMgibKg: raises $6 to $8
lfD8cBv31A/pio3pXJbPjA: calls $7
tJYod1SLp2AcWPL/3hZ7ug: calls $6
*** FLOP *** [Tc 7c 2h]
lfD8cBv31A/pio3pXJbPjA: checks
tJYod1SLp2AcWPL/3hZ7ug: checks
s0erZsDxbZSaEPheMgibKg: bets $14
lfD8cBv31A/pio3pXJbPjA: calls $14
tJYod1SLp2AcWPL/3hZ7ug: calls $14
*** TURN *** [Tc 7c 2h] [5h]
lfD8cBv31A/pio3pXJbPjA: checks
tJYod1SLp2AcWPL/3hZ7ug: checks
s0erZsDxbZSaEPheMgibKg: checks
*** RIVER *** [Tc 7c 2h 5h] [Jh]
lfD8cBv31A/pio3pXJbPjA: checks
tJYod1SLp2AcWPL/3hZ7ug: checks
s0erZsDxbZSaEPheMgibKg: checks
*** SHOW DOWN ***
lfD8cBv31A/pio3pXJbPjA: shows [Ac Ks] (high card Ace)
tJYod1SLp2AcWPL/3hZ7ug: shows [7s Ah] (a pair of Sevens)
s0erZsDxbZSaEPheMgibKg: shows [Td 3h] (a pair of Tens)
s0erZsDxbZSaEPheMgibKg collected $63 from pot
*** SUMMARY ***
Total pot $66 | Rake $3
Board [Tc 7c 2h 5h Jh]
Seat 1: lfD8cBv31A/pio3pXJbPjA (small blind) showed [Ac Ks] and lost with high card Ace
Seat 2: tJYod1SLp2AcWPL/3hZ7ug (big blind) showed [7s Ah] and lost with a pair of Sevens
Seat 3: weUZ8S7tgbaeIpzi1gBNxQ folded before Flop (didn't bet)
Seat 4: GG5lTuGt3+kwNYSbqeB6yw folded before Flop (didn't bet)
Seat 5: 5iPk5MyO3KVu18Y8XCYfFQ folded before Flop (didn't bet)
Seat 6: TAfo4veNRaRlzDXMMYS3Jg folded before Flop (didn't bet)
Seat 7: s0erZsDxbZSaEPheMgibKg (button) showed [Td 3h] and won ($63) with a pair of Tens



PokerStars Game #59938334368:  Hold'em No Limit ($1/$2) - 2009/07/01 0:12:30 ET
Table 'on4i1U1lCRmxsduFD3xiSg' 9-max Seat #3 is the button
Seat 1: so5k3vFDmokh2q3dImJ1GQ ($118 in chips)
Seat 2: yZYrOeNDxQxkzpbgKX1bng ($66.65 in chips)
Seat 3: 5iPk5MyO3KVu18Y8XCYfFQ ($61.20 in chips)
Seat 4: Z3aYCZG/yXHYFjiWkGI5ug ($453.10 in chips)
Seat 5: QHxJjpVYwitg9krW6wZgJA ($200 in chips)
Seat 6: SB0tvOX0Kw61r2U851JFaA ($201 in chips)
Seat 7: xD4ElYxz6Ollzmam8BmMCw ($244.25 in chips)
Seat 8: cdC54j9fGGojcbzWB5PgzA ($200 in chips)
Seat 9: iMe5yhc+1BaiIPHet3NMrA ($200 in chips)
Z3aYCZG/yXHYFjiWkGI5ug: posts small blind $1
QHxJjpVYwitg9krW6wZgJA: posts big blind $2
*** HOLE CARDS ***
SB0tvOX0Kw61r2U851JFaA: folds
xD4ElYxz6Ollzmam8BmMCw: calls $2
SB0tvOX0Kw61r2U851JFaA leaves the table
cdC54j9fGGojcbzWB5PgzA: folds
CUZwDpLTQKhzarPe+JCLOQ joins the table at seat #6
iMe5yhc+1BaiIPHet3NMrA: folds
so5k3vFDmokh2q3dImJ1GQ: folds
yZYrOeNDxQxkzpbgKX1bng: folds
5iPk5MyO3KVu18Y8XCYfFQ: folds
Z3aYCZG/yXHYFjiWkGI5ug: raises $8 to $10
QHxJjpVYwitg9krW6wZgJA: folds
xD4ElYxz6Ollzmam8BmMCw: raises $13 to $23
Z3aYCZG/yXHYFjiWkGI5ug: calls $13
*** FLOP *** [7d Qh 6c]
Z3aYCZG/yXHYFjiWkGI5ug: checks
xD4ElYxz6Ollzmam8BmMCw: checks
*** TURN *** [7d Qh 6c] [6s]
Z3aYCZG/yXHYFjiWkGI5ug: checks
xD4ElYxz6Ollzmam8BmMCw: bets $19
Z3aYCZG/yXHYFjiWkGI5ug: calls $19
*** RIVER *** [7d Qh 6c 6s] [8d]
Z3aYCZG/yXHYFjiWkGI5ug: checks
xD4ElYxz6Ollzmam8BmMCw: bets $33
Z3aYCZG/yXHYFjiWkGI5ug: calls $33
*** SHOW DOWN ***
xD4ElYxz6Ollzmam8BmMCw: shows [Jd Js] (two pair, Jacks and Sixes)
Z3aYCZG/yXHYFjiWkGI5ug: shows [Qd Ac] (two pair, Queens and Sixes)
Z3aYCZG/yXHYFjiWkGI5ug collected $149 from pot
*** SUMMARY ***
Total pot $152 | Rake $3
Board [7d Qh 6c 6s 8d]
Seat 1: so5k3vFDmokh2q3dImJ1GQ folded before Flop (didn't bet)
Seat 2: yZYrOeNDxQxkzpbgKX1bng folded before Flop (didn't bet)
Seat 3: 5iPk5MyO3KVu18Y8XCYfFQ (button) folded before Flop (didn't bet)
Seat 4: Z3aYCZG/yXHYFjiWkGI5ug (small blind) showed [Qd Ac] and won ($149) with two pair, Queens and Sixes
Seat 5: QHxJjpVYwitg9krW6wZgJA (big blind) folded before Flop
Seat 6: SB0tvOX0Kw61r2U851JFaA folded before Flop (didn't bet)
Seat 7: xD4ElYxz6Ollzmam8BmMCw showed [Jd Js] and lost with two pair, Jacks and Sixes
Seat 8: cdC54j9fGGojcbzWB5PgzA folded before Flop (didn't bet)
Seat 9: iMe5yhc+1BaiIPHet3NMrA folded before Flop (didn't bet)



PokerStars Game #59938335304:  Hold'em No Limit ($1/$2) - 2009/07/01 0:12:32 ET
Table 'gnHBqWll9O3fxG7Ojkz/ng' 9-max Seat #1 is the button
Seat 1: hpqdC/23wXosGOmzARr5NA ($156.05 in chips)
Seat 2: H6Z4+qu8gR0VUiPOijndVg ($201 in chips)
Seat 3: 5Q8U6iZbeO7xJSS4qvDP5g ($218.60 in chips)
Seat 4: n5XI5/7gN+gIubHFBH+mOw ($401.85 in chips)
Seat 6: 5iPk5MyO3KVu18Y8XCYfFQ ($52.45 in chips)
Seat 8: De9g+AYjo0DN6C/+iT/nsg ($244.05 in chips)
Seat 9: kVCeGJ4NY7Fb0W74j1mAqA ($206 in chips)
H6Z4+qu8gR0VUiPOijndVg: posts small blind $1
5Q8U6iZbeO7xJSS4qvDP5g: posts big blind $2
rBQDMkKm9cZn6M9NPsiVew: sits out
*** HOLE CARDS ***
n5XI5/7gN+gIubHFBH+mOw: calls $2
5iPk5MyO3KVu18Y8XCYfFQ: folds
De9g+AYjo0DN6C/+iT/nsg: folds
kVCeGJ4NY7Fb0W74j1mAqA: folds
hpqdC/23wXosGOmzARr5NA: folds
H6Z4+qu8gR0VUiPOijndVg: calls $1
5Q8U6iZbeO7xJSS4qvDP5g: checks
*** FLOP *** [2d 8h Ad]
H6Z4+qu8gR0VUiPOijndVg: checks
5Q8U6iZbeO7xJSS4qvDP5g: checks
n5XI5/7gN+gIubHFBH+mOw: bets $24
H6Z4+qu8gR0VUiPOijndVg: folds
5Q8U6iZbeO7xJSS4qvDP5g: folds
n5XI5/7gN+gIubHFBH+mOw collected $5.70 from pot
*** SUMMARY ***
Total pot $6 | Rake $0.30
Board [2d 8h Ad]
Seat 1: hpqdC/23wXosGOmzARr5NA (button) folded before Flop (didn't bet)
Seat 2: H6Z4+qu8gR0VUiPOijndVg (small blind) folded on the Flop
Seat 3: 5Q8U6iZbeO7xJSS4qvDP5g (big blind) folded on the Flop
Seat 4: n5XI5/7gN+gIubHFBH+mOw collected ($5.70)
Seat 6: 5iPk5MyO3KVu18Y8XCYfFQ folded before Flop (didn't bet)
Seat 8: De9g+AYjo0DN6C/+iT/nsg folded before Flop (didn't bet)
Seat 9: kVCeGJ4NY7Fb0W74j1mAqA folded before Flop (didn't bet)



PokerStars Game #59938336060:  Hold'em No Limit ($1/$2) - 2009/07/01 0:12:33 ET
Table 'HxRHVC7PeqC33y4Kt+aXWg' 2-max Seat #2 is the button
Seat 1: x8INLjfrAPdSY3gjU4zJhw ($241 in chips)
Seat 2: mgi+mjKb1Sc3CCs7TlfoCw ($229.50 in chips)
mgi+mjKb1Sc3CCs7TlfoCw: posts small blind $1
x8INLjfrAPdSY3gjU4zJhw: posts big blind $2
*** HOLE CARDS ***
mgi+mjKb1Sc3CCs7TlfoCw: raises $4 to $6
x8INLjfrAPdSY3gjU4zJhw: raises $14 to $20
mgi+mjKb1Sc3CCs7TlfoCw: calls $14
*** FLOP *** [Ad 5h 4s]
x8INLjfrAPdSY3gjU4zJhw: bets $30
mgi+mjKb1Sc3CCs7TlfoCw: folds
x8INLjfrAPdSY3gjU4zJhw collected $39.50 from pot
x8INLjfrAPdSY3gjU4zJhw: doesn't show hand
*** SUMMARY ***
Total pot $40 | Rake $0.50
Board [Ad 5h 4s]
Seat 1: x8INLjfrAPdSY3gjU4zJhw (big blind) collected ($39.50)
Seat 2: mgi+mjKb1Sc3CCs7TlfoCw (button) (small blind) folded on the Flop



PokerStars Game #59938337884:  Hold'em No Limit ($1/$2) - 2009/07/01 0:12:35 ET
Table 'bIihwBANJSFqlHPPtset+w' 9-max Seat #3 is the button
Seat 1: jI3JDUGV63ccqtKgM3vMbw ($140.60 in chips)
Seat 2: lQYT23h5QCUVZAKxjOO39Q ($125.90 in chips)
Seat 3: acnZ0LD5jxKgWIHz+mpQ8Q ($226.25 in chips)
Seat 4: 7WWX5PClBdr/U44gUKBIEA ($254.65 in chips)
Seat 6: 5iPk5MyO3KVu18Y8XCYfFQ ($44.40 in chips)
Seat 7: 3q2/0oJr3Mcy1W5tcN61ug ($200 in chips)
Seat 8: iMe5yhc+1BaiIPHet3NMrA ($281.65 in chips)
Seat 9: rW/MyplHylMSBRaoRUzWrg ($34.55 in chips)
7WWX5PClBdr/U44gUKBIEA: posts small blind $1
5iPk5MyO3KVu18Y8XCYfFQ: posts big blind $2
*** HOLE CARDS ***
3q2/0oJr3Mcy1W5tcN61ug: folds
iMe5yhc+1BaiIPHet3NMrA: folds
rW/MyplHylMSBRaoRUzWrg: folds
jI3JDUGV63ccqtKgM3vMbw: folds
lQYT23h5QCUVZAKxjOO39Q: folds
acnZ0LD5jxKgWIHz+mpQ8Q: folds
7WWX5PClBdr/U44gUKBIEA: calls $1
5iPk5MyO3KVu18Y8XCYfFQ: checks
*** FLOP *** [Ks 2d 6c]
7WWX5PClBdr/U44gUKBIEA: bets $2
5iPk5MyO3KVu18Y8XCYfFQ: calls $2
*** TURN *** [Ks 2d 6c] [3c]
7WWX5PClBdr/U44gUKBIEA: checks
5iPk5MyO3KVu18Y8XCYfFQ: bets $6
7WWX5PClBdr/U44gUKBIEA: calls $6
*** RIVER *** [Ks 2d 6c 3c] [Th]
7WWX5PClBdr/U44gUKBIEA: checks
5iPk5MyO3KVu18Y8XCYfFQ: bets $10
7WWX5PClBdr/U44gUKBIEA: raises $25 to $35
5iPk5MyO3KVu18Y8XCYfFQ: calls $24.40 and is all-in
*** SHOW DOWN ***
7WWX5PClBdr/U44gUKBIEA: shows [2s 2c] (three of a kind, Deuces)
5iPk5MyO3KVu18Y8XCYfFQ: mucks hand
7WWX5PClBdr/U44gUKBIEA collected $85.80 from pot
*** SUMMARY ***
Total pot $88.80 | Rake $3
Board [Ks 2d 6c 3c Th]
Seat 1: jI3JDUGV63ccqtKgM3vMbw folded before Flop (didn't bet)
Seat 2: lQYT23h5QCUVZAKxjOO39Q folded before Flop (didn't bet)
Seat 3: acnZ0LD5jxKgWIHz+mpQ8Q (button) folded before Flop (didn't bet)
Seat 4: 7WWX5PClBdr/U44gUKBIEA (small blind) showed [2s 2c] and won ($85.80) with three of a kind, Deuces
Seat 6: 5iPk5MyO3KVu18Y8XCYfFQ (big blind) mucked
Seat 7: 3q2/0oJr3Mcy1W5tcN61ug folded before Flop (didn't bet)
Seat 8: iMe5yhc+1BaiIPHet3NMrA folded before Flop (didn't bet)
Seat 9: rW/MyplHylMSBRaoRUzWrg folded before Flop (didn't bet)



PokerStars Game #59938338210:  Hold'em No Limit ($1/$2) - 2009/07/01 0:12:36 ET
Table 'WCA60bDA8ecovUgFSIZkTQ' 9-max Seat #8 is the button
Seat 1: CUZwDpLTQKhzarPe+JCLOQ ($200 in chips)
Seat 2: G1h8wamBcVJXtsKXZQ2EyA ($101.40 in chips)
Seat 3: 5iPk5MyO3KVu18Y8XCYfFQ ($37 in chips)
Seat 4: Q3uFdu6ztesjDFiqkagTRQ ($464.70 in chips)
Seat 5: Hc2itIxwbi1lwa+DAYYQGg ($306.30 in chips)
Seat 6: DOWQSOJ7GaX+ksfWTqPT5A ($256.75 in chips)
Seat 8: x+V1JgVDawsJTxKcxm7gxw ($72 in chips)
Seat 9: 3q2/0oJr3Mcy1W5tcN61ug ($296.20 in chips)
3q2/0oJr3Mcy1W5tcN61ug: posts small blind $1
CUZwDpLTQKhzarPe+JCLOQ: posts big blind $2
*** HOLE CARDS ***
G1h8wamBcVJXtsKXZQ2EyA: folds
5iPk5MyO3KVu18Y8XCYfFQ: folds
Q3uFdu6ztesjDFiqkagTRQ: folds
Hc2itIxwbi1lwa+DAYYQGg: folds
DOWQSOJ7GaX+ksfWTqPT5A: folds
x+V1JgVDawsJTxKcxm7gxw: calls $2
3q2/0oJr3Mcy1W5tcN61ug: calls $1
CUZwDpLTQKhzarPe+JCLOQ: checks
*** FLOP *** [4d Qd 5d]
3q2/0oJr3Mcy1W5tcN61ug: checks
CUZwDpLTQKhzarPe+JCLOQ: bets $4
2YpnxJiexJHyERfbqgwEcw joins the table at seat #7
x+V1JgVDawsJTxKcxm7gxw: calls $4
3q2/0oJr3Mcy1W5tcN61ug: folds
*** TURN *** [4d Qd 5d] [7c]
CUZwDpLTQKhzarPe+JCLOQ: bets $6
x+V1JgVDawsJTxKcxm7gxw: calls $6
*** RIVER *** [4d Qd 5d 7c] [Ac]
CUZwDpLTQKhzarPe+JCLOQ: bets $12
x+V1JgVDawsJTxKcxm7gxw: folds
CUZwDpLTQKhzarPe+JCLOQ collected $24.75 from pot
CUZwDpLTQKhzarPe+JCLOQ: doesn't show hand
*** SUMMARY ***
Total pot $26 | Rake $1.25
Board [4d Qd 5d 7c Ac]
Seat 1: CUZwDpLTQKhzarPe+JCLOQ (big blind) collected ($24.75)
Seat 2: G1h8wamBcVJXtsKXZQ2EyA folded before Flop (didn't bet)
Seat 3: 5iPk5MyO3KVu18Y8XCYfFQ folded before Flop (didn't bet)
Seat 4: Q3uFdu6ztesjDFiqkagTRQ folded before Flop (didn't bet)
Seat 5: Hc2itIxwbi1lwa+DAYYQGg folded before Flop (didn't bet)
Seat 6: DOWQSOJ7GaX+ksfWTqPT5A folded before Flop (didn't bet)
Seat 8: x+V1JgVDawsJTxKcxm7gxw (button) folded on the River
Seat 9: 3q2/0oJr3Mcy1W5tcN61ug (small blind) folded on the Flop



PokerStars Game #59938339360:  Hold'em No Limit ($1/$2) - 2009/07/01 0:12:38 ET
Table 'eyAQSIlgc2o1Jxvbve4WGg' 9-max Seat #7 is the button
Seat 1: Q3uFdu6ztesjDFiqkagTRQ ($234 in chips)
Seat 3: TAfo4veNRaRlzDXMMYS3Jg ($37 in chips)
Seat 5: JnV3SM2D6dAFYyGZHHpvrg ($100 in chips)
Seat 6: IikcENBHwoT7snSvBPSc7Q ($182.60 in chips)
Seat 7: QHxJjpVYwitg9krW6wZgJA ($200 in chips)
Seat 8: 5iPk5MyO3KVu18Y8XCYfFQ ($39.60 in chips)
Seat 9: Hc2itIxwbi1lwa+DAYYQGg ($46.85 in chips)
5iPk5MyO3KVu18Y8XCYfFQ: posts small blind $1
Hc2itIxwbi1lwa+DAYYQGg: posts big blind $2
*** HOLE CARDS ***
Q3uFdu6ztesjDFiqkagTRQ: raises $4 to $6
TAfo4veNRaRlzDXMMYS3Jg: folds
JnV3SM2D6dAFYyGZHHpvrg: folds
IikcENBHwoT7snSvBPSc7Q: folds
QHxJjpVYwitg9krW6wZgJA: folds
5iPk5MyO3KVu18Y8XCYfFQ: folds
Hc2itIxwbi1lwa+DAYYQGg: raises $40.85 to $46.85 and is all-in
Q3uFdu6ztesjDFiqkagTRQ: folds
Hc2itIxwbi1lwa+DAYYQGg collected $13 from pot
*** SUMMARY ***
Total pot $13 | Rake $0
Seat 1: Q3uFdu6ztesjDFiqkagTRQ folded before Flop
Seat 3: TAfo4veNRaRlzDXMMYS3Jg folded before Flop (didn't bet)
Seat 5: JnV3SM2D6dAFYyGZHHpvrg folded before Flop (didn't bet)
Seat 6: IikcENBHwoT7snSvBPSc7Q folded before Flop (didn't bet)
Seat 7: QHxJjpVYwitg9krW6wZgJA (button) folded before Flop (didn't bet)
Seat 8: 5iPk5MyO3KVu18Y8XCYfFQ (small blind) folded before Flop
Seat 9: Hc2itIxwbi1lwa+DAYYQGg (big blind) collected ($13)



PokerStars Game #59938343434:  Hold'em No Limit ($1/$2) - 2009/07/01 0:12:43 ET
Table 'l5lZHc5JRHEDt0Y2AVPq3g' 6-max Seat #1 is the button
Seat 1: gGPaCoSWW1HoKYaqfAPecg ($216.25 in chips)
Seat 2: my38j/MmtBd/8qVwmyCREA ($242.35 in chips)
Seat 4: zNjJ/y4emmF+vzrCDd+ooA ($211.95 in chips)
Seat 6: vkfxu8f/jMYKUk6Ly4eujw ($203.30 in chips)
my38j/MmtBd/8qVwmyCREA: posts small blind $1
zNjJ/y4emmF+vzrCDd+ooA: posts big blind $2
X7GlkHF+lkbarCLuZ4Uf0w: sits out
*** HOLE CARDS ***
vkfxu8f/jMYKUk6Ly4eujw: folds
gGPaCoSWW1HoKYaqfAPecg: folds
my38j/MmtBd/8qVwmyCREA: calls $1
zNjJ/y4emmF+vzrCDd+ooA: checks
*** FLOP *** [7h 4h 3s]
my38j/MmtBd/8qVwmyCREA: checks
zNjJ/y4emmF+vzrCDd+ooA: bets $4
my38j/MmtBd/8qVwmyCREA: folds
zNjJ/y4emmF+vzrCDd+ooA collected $3.80 from pot
*** SUMMARY ***
Total pot $4 | Rake $0.20
Board [7h 4h 3s]
Seat 1: gGPaCoSWW1HoKYaqfAPecg (button) folded before Flop (didn't bet)
Seat 2: my38j/MmtBd/8qVwmyCREA (small blind) folded on the Flop
Seat 4: zNjJ/y4emmF+vzrCDd+ooA (big blind) collected ($3.80)
Seat 6: vkfxu8f/jMYKUk6Ly4eujw folded before Flop (didn't bet)



PokerStars Game #59938346016:  Hold'em No Limit ($1/$2) - 2009/07/01 0:12:47 ET
Table 'rsKRKlGHlxVyqJxzO2a2Ow' 9-max Seat #7 is the button
Seat 1: uYWfQJg2hgHLxri6/uVJiw ($137.10 in chips)
Seat 2: QHxJjpVYwitg9krW6wZgJA ($247.50 in chips)
Seat 3: 9sYbXdhj1M2bwKrVNxj5+Q ($113.80 in chips)
Seat 4: zJtQ1gxyi72XvGYS1tM+DA ($182.55 in chips)
Seat 5: 5Q8U6iZbeO7xJSS4qvDP5g ($203 in chips)
Seat 6: H6Z4+qu8gR0VUiPOijndVg ($200 in chips)
Seat 7: kVCeGJ4NY7Fb0W74j1mAqA ($206 in chips)
Seat 8: Hc2itIxwbi1lwa+DAYYQGg ($35 in chips)
Seat 9: 5iPk5MyO3KVu18Y8XCYfFQ ($98.10 in chips)
Hc2itIxwbi1lwa+DAYYQGg: posts small blind $1
5iPk5MyO3KVu18Y8XCYfFQ: posts big blind $2
*** HOLE CARDS ***
uYWfQJg2hgHLxri6/uVJiw: folds
QHxJjpVYwitg9krW6wZgJA: folds
9sYbXdhj1M2bwKrVNxj5+Q: folds
zJtQ1gxyi72XvGYS1tM+DA: raises $2 to $4
5Q8U6iZbeO7xJSS4qvDP5g: folds
H6Z4+qu8gR0VUiPOijndVg: folds
kVCeGJ4NY7Fb0W74j1mAqA: folds
Hc2itIxwbi1lwa+DAYYQGg: folds
5iPk5MyO3KVu18Y8XCYfFQ: calls $2
*** FLOP *** [6c 5s 2c]
5iPk5MyO3KVu18Y8XCYfFQ: bets $6
zJtQ1gxyi72XvGYS1tM+DA: folds
5iPk5MyO3KVu18Y8XCYfFQ collected $8.55 from pot
5iPk5MyO3KVu18Y8XCYfFQ: doesn't show hand
*** SUMMARY ***
Total pot $9 | Rake $0.45
Board [6c 5s 2c]
Seat 1: uYWfQJg2hgHLxri6/uVJiw folded before Flop (didn't bet)
Seat 2: QHxJjpVYwitg9krW6wZgJA folded before Flop (didn't bet)
Seat 3: 9sYbXdhj1M2bwKrVNxj5+Q folded before Flop (didn't bet)
Seat 4: zJtQ1gxyi72XvGYS1tM+DA folded on the Flop
Seat 5: 5Q8U6iZbeO7xJSS4qvDP5g folded before Flop (didn't bet)
Seat 6: H6Z4+qu8gR0VUiPOijndVg folded before Flop (didn't bet)
Seat 7: kVCeGJ4NY7Fb0W74j1mAqA (button) folded before Flop (didn't bet)
Seat 8: Hc2itIxwbi1lwa+DAYYQGg (small blind) folded before Flop
Seat 9: 5iPk5MyO3KVu18Y8XCYfFQ (big blind) collected ($8.55)



PokerStars Game #59938347850:  Hold'em No Limit ($1/$2) - 2009/07/01 0:12:50 ET
Table 'HewZCzVOYGmuLDKthTi5Yw' 6-max Seat #3 is the button
Seat 1: 353332 ($251.95 in chips)
Seat 2: X7GlkHF+lkbarCLuZ4Uf0w ($31 in chips)
Seat 3: WJxW31eStwT28R2X/L8F5A ($40.05 in chips)
Seat 5: 513FcCI8jHyQy2VWoIQkMg ($377.80 in chips)
513FcCI8jHyQy2VWoIQkMg: posts small blind $1
353332: posts big blind $2
*** HOLE CARDS ***
X7GlkHF+lkbarCLuZ4Uf0w: raises $2 to $4
WJxW31eStwT28R2X/L8F5A: folds
513FcCI8jHyQy2VWoIQkMg: raises $8 to $12
353332: calls $10
X7GlkHF+lkbarCLuZ4Uf0w: folds
*** FLOP *** [5h 2c 5d]
513FcCI8jHyQy2VWoIQkMg: bets $17
353332: calls $17
*** TURN *** [5h 2c 5d] [7c]
513FcCI8jHyQy2VWoIQkMg: bets $48
yZgdnRylE65JbScQ7qCWgw leaves the table
353332: folds
513FcCI8jHyQy2VWoIQkMg collected $60 from pot
*** SUMMARY ***
Total pot $62 | Rake $2
Board [5h 2c 5d 7c]
Seat 1: 353332 (big blind) folded on the Turn
Seat 2: X7GlkHF+lkbarCLuZ4Uf0w folded before Flop
Seat 3: WJxW31eStwT28R2X/L8F5A (button) folded before Flop (didn't bet)
Seat 5: 513FcCI8jHyQy2VWoIQkMg (small blind) collected ($60)



PokerStars Game #59938348014:  Hold'em No Limit ($1/$2) - 2009/07/01 0:12:50 ET
Table 'jlrIxbrVIG+gjaUYT4za8g' 6-max Seat #2 is the button
Seat 1: ygTTt5ehT4aF86q1a8/R+w ($196.05 in chips)
Seat 2: N18PrNGQj43J7TJuQuu+tw ($127.80 in chips)
Seat 3: 54yWzRRgS0oZ+S6LwZBxMQ ($41.80 in chips)
Seat 4: 8srN1dKQePlsv0GyTada+Q ($200 in chips)
Seat 6: vkfxu8f/jMYKUk6Ly4eujw ($288.95 in chips)
54yWzRRgS0oZ+S6LwZBxMQ: posts small blind $1
8srN1dKQePlsv0GyTada+Q: posts big blind $2
*** HOLE CARDS ***
vkfxu8f/jMYKUk6Ly4eujw: raises $4 to $6
ygTTt5ehT4aF86q1a8/R+w: folds
N18PrNGQj43J7TJuQuu+tw: folds
54yWzRRgS0oZ+S6LwZBxMQ: folds
8srN1dKQePlsv0GyTada+Q: calls $4
*** FLOP *** [4c Ac 6c]
8srN1dKQePlsv0GyTada+Q: checks
vkfxu8f/jMYKUk6Ly4eujw: checks
*** TURN *** [4c Ac 6c] [As]
8srN1dKQePlsv0GyTada+Q: bets $8
vkfxu8f/jMYKUk6Ly4eujw: folds
8srN1dKQePlsv0GyTada+Q collected $12.35 from pot
*** SUMMARY ***
Total pot $13 | Rake $0.65
Board [4c Ac 6c As]
Seat 1: ygTTt5ehT4aF86q1a8/R+w folded before Flop (didn't bet)
Seat 2: N18PrNGQj43J7TJuQuu+tw (button) folded before Flop (didn't bet)
Seat 3: 54yWzRRgS0oZ+S6LwZBxMQ (small blind) folded before Flop
Seat 4: 8srN1dKQePlsv0GyTada+Q (big blind) collected ($12.35)
Seat 6: vkfxu8f/jMYKUk6Ly4eujw folded on the Turn



PokerStars Game #59938348106:  Hold'em No Limit ($1/$2) - 2009/07/01 0:12:50 ET
Table 'aSf77Sj8QEnzcc0WaxVD4Q' 6-max Seat #3 is the button
Seat 1: Q3uFdu6ztesjDFiqkagTRQ ($246.20 in chips)
Seat 2: vkfxu8f/jMYKUk6Ly4eujw ($192.75 in chips)
Seat 3: 9dpyyjDTCed6nV7JhaUUpw ($220.05 in chips)
Seat 4: 513FcCI8jHyQy2VWoIQkMg ($202.75 in chips)
Seat 5: InmkdI6G8TzSj9NhcCSyPg ($250 in chips)
Seat 6: vkoJRf3gidxY1pPi0AFWww ($310.60 in chips)
513FcCI8jHyQy2VWoIQkMg: posts small blind $1
InmkdI6G8TzSj9NhcCSyPg: posts big blind $2
*** HOLE CARDS ***
vkoJRf3gidxY1pPi0AFWww: folds
Q3uFdu6ztesjDFiqkagTRQ: folds
vkfxu8f/jMYKUk6Ly4eujw: raises $6 to $8
9dpyyjDTCed6nV7JhaUUpw: raises $16 to $24
513FcCI8jHyQy2VWoIQkMg: folds
InmkdI6G8TzSj9NhcCSyPg: folds
vkfxu8f/jMYKUk6Ly4eujw: calls $16
*** FLOP *** [8d 5c 4c]
vkfxu8f/jMYKUk6Ly4eujw: checks
9dpyyjDTCed6nV7JhaUUpw: bets $26
vkfxu8f/jMYKUk6Ly4eujw: raises $142.75 to $168.75 and is all-in
9dpyyjDTCed6nV7JhaUUpw: folds
vkfxu8f/jMYKUk6Ly4eujw collected $100 from pot
vkfxu8f/jMYKUk6Ly4eujw: doesn't show hand
*** SUMMARY ***
Total pot $103 | Rake $3
Board [8d 5c 4c]
Seat 1: Q3uFdu6ztesjDFiqkagTRQ folded before Flop (didn't bet)
Seat 2: vkfxu8f/jMYKUk6Ly4eujw collected ($100)
Seat 3: 9dpyyjDTCed6nV7JhaUUpw (button) folded on the Flop
Seat 4: 513FcCI8jHyQy2VWoIQkMg (small blind) folded before Flop
Seat 5: InmkdI6G8TzSj9NhcCSyPg (big blind) folded before Flop
Seat 6: vkoJRf3gidxY1pPi0AFWww folded before Flop (didn't bet)



PokerStars Game #59938349398:  Hold'em No Limit ($1/$2) - 2009/07/01 0:12:52 ET
Table '3FGoiEOffWrbgTfsB3t7FA' 2-max Seat #1 is the button
Seat 1: e0oDWyrmgLpR6bROEqw1nQ ($341.50 in chips)
Seat 2: +sy/nlNI20yZraIjs4AALg ($259.65 in chips)
e0oDWyrmgLpR6bROEqw1nQ: posts small blind $1
+sy/nlNI20yZraIjs4AALg: posts big blind $2
*** HOLE CARDS ***
e0oDWyrmgLpR6bROEqw1nQ: raises $4 to $6
+sy/nlNI20yZraIjs4AALg: folds
e0oDWyrmgLpR6bROEqw1nQ collected $4 from pot
*** SUMMARY ***
Total pot $4 | Rake $0
Seat 1: e0oDWyrmgLpR6bROEqw1nQ (button) (small blind) collected ($4)
Seat 2: +sy/nlNI20yZraIjs4AALg (big blind) folded before Flop



PokerStars Game #59938351582:  Hold'em No Limit ($1/$2) - 2009/07/01 0:12:55 ET
Table 'HxRHVC7PeqC33y4Kt+aXWg' 2-max Seat #1 is the button
Seat 1: x8INLjfrAPdSY3gjU4zJhw ($260.50 in chips)
Seat 2: mgi+mjKb1Sc3CCs7TlfoCw ($209.50 in chips)
x8INLjfrAPdSY3gjU4zJhw: posts small blind $1
mgi+mjKb1Sc3CCs7TlfoCw: posts big blind $2
*** HOLE CARDS ***
x8INLjfrAPdSY3gjU4zJhw: raises $4 to $6
mgi+mjKb1Sc3CCs7TlfoCw: raises $14 to $20
x8INLjfrAPdSY3gjU4zJhw: calls $14
*** FLOP *** [2s 9c 8c]
mgi+mjKb1Sc3CCs7TlfoCw: checks
x8INLjfrAPdSY3gjU4zJhw: checks
*** TURN *** [2s 9c 8c] [9h]
mgi+mjKb1Sc3CCs7TlfoCw: bets $36
x8INLjfrAPdSY3gjU4zJhw: calls $36
*** RIVER *** [2s 9c 8c 9h] [3d]
mgi+mjKb1Sc3CCs7TlfoCw: bets $92
x8INLjfrAPdSY3gjU4zJhw: calls $92
*** SHOW DOWN ***
mgi+mjKb1Sc3CCs7TlfoCw: shows [Ac Ts] (a pair of Nines)
x8INLjfrAPdSY3gjU4zJhw: shows [4h 4d] (two pair, Nines and Fours)
x8INLjfrAPdSY3gjU4zJhw collected $295.50 from pot
*** SUMMARY ***
Total pot $296 | Rake $0.50
Board [2s 9c 8c 9h 3d]
Seat 1: x8INLjfrAPdSY3gjU4zJhw (button) (small blind) showed [4h 4d] and won ($295.50) with two pair, Nines and Fours
Seat 2: mgi+mjKb1Sc3CCs7TlfoCw (big blind) showed [Ac Ts] and lost with a pair of Nines



PokerStars Game #59938351344:  Hold'em No Limit ($1/$2) - 2009/07/01 0:12:55 ET
Table 'NmY84NAf9Mh0ckAckHnh5g' 2-max Seat #1 is the button
Seat 1: 6hvg964TSqZ3AL/0XK9aVQ ($340.25 in chips)
Seat 2: RwDoM55ZeQuI2ADyJhOb2Q ($249.55 in chips)
6hvg964TSqZ3AL/0XK9aVQ: posts small blind $1
RwDoM55ZeQuI2ADyJhOb2Q: posts big blind $2
*** HOLE CARDS ***
6hvg964TSqZ3AL/0XK9aVQ: calls $1
RwDoM55ZeQuI2ADyJhOb2Q: checks
*** FLOP *** [Td 7h 4s]
RwDoM55ZeQuI2ADyJhOb2Q: bets $4
6hvg964TSqZ3AL/0XK9aVQ: calls $4
*** TURN *** [Td 7h 4s] [Kd]
RwDoM55ZeQuI2ADyJhOb2Q: bets $8
6hvg964TSqZ3AL/0XK9aVQ: calls $8
*** RIVER *** [Td 7h 4s Kd] [8d]
RwDoM55ZeQuI2ADyJhOb2Q: bets $22
6hvg964TSqZ3AL/0XK9aVQ: calls $22
*** SHOW DOWN ***
RwDoM55ZeQuI2ADyJhOb2Q: shows [3h Tc] (a pair of Tens)
6hvg964TSqZ3AL/0XK9aVQ: shows [9d Th] (a pair of Tens - King+Nine kicker)
6hvg964TSqZ3AL/0XK9aVQ collected $71.50 from pot
*** SUMMARY ***
Total pot $72 | Rake $0.50
Board [Td 7h 4s Kd 8d]
Seat 1: 6hvg964TSqZ3AL/0XK9aVQ (button) (small blind) showed [9d Th] and won ($71.50) with a pair of Tens
Seat 2: RwDoM55ZeQuI2ADyJhOb2Q (big blind) showed [3h Tc] and lost with a pair of Tens



PokerStars Game #59938352044:  Hold'em No Limit ($1/$2) - 2009/07/01 0:12:56 ET
Table 'XP2sRSup+aRuwzx3vDZsDg' 6-max Seat #4 is the button
Seat 1: o9jamqIi6sTTRSqudgboRA ($237.70 in chips)
Seat 3: X7GlkHF+lkbarCLuZ4Uf0w ($39.65 in chips)
Seat 4: JsC+WvfzqlxVs9G8/gSQAQ ($76.40 in chips)
Seat 6: h7ppRQJTYBsHCbLMeW9T2g ($485.75 in chips)
h7ppRQJTYBsHCbLMeW9T2g: posts small blind $1
o9jamqIi6sTTRSqudgboRA: posts big blind $2
*** HOLE CARDS ***
X7GlkHF+lkbarCLuZ4Uf0w: raises $2 to $4
JsC+WvfzqlxVs9G8/gSQAQ: calls $4
h7ppRQJTYBsHCbLMeW9T2g: folds
o9jamqIi6sTTRSqudgboRA: folds
*** FLOP *** [3s 6s 8c]
X7GlkHF+lkbarCLuZ4Uf0w: checks
JsC+WvfzqlxVs9G8/gSQAQ: bets $6
X7GlkHF+lkbarCLuZ4Uf0w: raises $29.65 to $35.65 and is all-in
JsC+WvfzqlxVs9G8/gSQAQ: calls $29.65
*** TURN *** [3s 6s 8c] [Jd]
*** RIVER *** [3s 6s 8c Jd] [Td]
*** SHOW DOWN ***
X7GlkHF+lkbarCLuZ4Uf0w: shows [8d Ac] (a pair of Eights)
JsC+WvfzqlxVs9G8/gSQAQ: shows [Ks Kc] (a pair of Kings)
JsC+WvfzqlxVs9G8/gSQAQ collected $80.30 from pot
*** SUMMARY ***
Total pot $82.30 | Rake $2
Board [3s 6s 8c Jd Td]
Seat 1: o9jamqIi6sTTRSqudgboRA (big blind) folded before Flop
Seat 3: X7GlkHF+lkbarCLuZ4Uf0w showed [8d Ac] and lost with a pair of Eights
Seat 4: JsC+WvfzqlxVs9G8/gSQAQ (button) showed [Ks Kc] and won ($80.30) with a pair of Kings
Seat 6: h7ppRQJTYBsHCbLMeW9T2g (small blind) folded before Flop



PokerStars Game #59938353378:  Hold'em No Limit ($1/$2) - 2009/07/01 0:12:57 ET
Table 'bJQ024BaYSBrW0sXpCZbNQ' 6-max Seat #6 is the button
Seat 1: Mo7b4GXWaawCURUQwq6RYg ($121 in chips)
Seat 2: 1njbh8TKSUF6l4V1XwGdcg ($266 in chips)
Seat 3: vkfxu8f/jMYKUk6Ly4eujw ($211.60 in chips)
Seat 4: 9ni/OEXAqfc58zPQ0Tu9rQ ($265.60 in chips)
Seat 5: X7GlkHF+lkbarCLuZ4Uf0w ($58.15 in chips)
Seat 6: 9dpyyjDTCed6nV7JhaUUpw ($200 in chips)
Mo7b4GXWaawCURUQwq6RYg: posts small blind $1
1njbh8TKSUF6l4V1XwGdcg: posts big blind $2
*** HOLE CARDS ***
vkfxu8f/jMYKUk6Ly4eujw: folds
9ni/OEXAqfc58zPQ0Tu9rQ: folds
vkfxu8f/jMYKUk6Ly4eujw leaves the table
X7GlkHF+lkbarCLuZ4Uf0w: folds
9dpyyjDTCed6nV7JhaUUpw: folds
Mo7b4GXWaawCURUQwq6RYg: calls $1
1njbh8TKSUF6l4V1XwGdcg: checks
*** FLOP *** [6h As 6d]
Mo7b4GXWaawCURUQwq6RYg: checks
1njbh8TKSUF6l4V1XwGdcg: bets $2
Mo7b4GXWaawCURUQwq6RYg: folds
1njbh8TKSUF6l4V1XwGdcg collected $3.80 from pot
*** SUMMARY ***
Total pot $4 | Rake $0.20
Board [6h As 6d]
Seat 1: Mo7b4GXWaawCURUQwq6RYg (small blind) folded on the Flop
Seat 2: 1njbh8TKSUF6l4V1XwGdcg (big blind) collected ($3.80)
Seat 3: vkfxu8f/jMYKUk6Ly4eujw folded before Flop (didn't bet)
Seat 4: 9ni/OEXAqfc58zPQ0Tu9rQ folded before Flop (didn't bet)
Seat 5: X7GlkHF+lkbarCLuZ4Uf0w folded before Flop (didn't bet)
Seat 6: 9dpyyjDTCed6nV7JhaUUpw (button) folded before Flop (didn't bet)



PokerStars Game #59938357580:  Hold'em No Limit ($1/$2) - 2009/07/01 0:13:04 ET
Table 'G1Oqdy4Pqdb5gtx40rUBzA' 6-max Seat #1 is the button
Seat 1: QCqxb/MXSq5RKfPtjBjiBA ($123.80 in chips)
Seat 2: IzslX/oV8DoDQfxCV/3+kg ($364.75 in chips)
Seat 3: lE+RUsc9cdVV9eEi8uytew ($100 in chips)
Seat 5: X7GlkHF+lkbarCLuZ4Uf0w ($78 in chips)
Seat 6: gGPaCoSWW1HoKYaqfAPecg ($200 in chips)
IzslX/oV8DoDQfxCV/3+kg: posts small blind $1
lE+RUsc9cdVV9eEi8uytew: posts big blind $2
B87ikIyZ/TzAVeXf38Ny0g: sits out
*** HOLE CARDS ***
X7GlkHF+lkbarCLuZ4Uf0w: folds
gGPaCoSWW1HoKYaqfAPecg: folds
QCqxb/MXSq5RKfPtjBjiBA: raises $4 to $6
IzslX/oV8DoDQfxCV/3+kg: folds
lE+RUsc9cdVV9eEi8uytew: calls $4
*** FLOP *** [5s 4s Kd]
lE+RUsc9cdVV9eEi8uytew: bets $6
QCqxb/MXSq5RKfPtjBjiBA: raises $18 to $24
lE+RUsc9cdVV9eEi8uytew: folds
QCqxb/MXSq5RKfPtjBjiBA collected $23.80 from pot
*** SUMMARY ***
Total pot $25 | Rake $1.20
Board [5s 4s Kd]
Seat 1: QCqxb/MXSq5RKfPtjBjiBA (button) collected ($23.80)
Seat 2: IzslX/oV8DoDQfxCV/3+kg (small blind) folded before Flop
Seat 3: lE+RUsc9cdVV9eEi8uytew (big blind) folded on the Flop
Seat 5: X7GlkHF+lkbarCLuZ4Uf0w folded before Flop (didn't bet)
Seat 6: gGPaCoSWW1HoKYaqfAPecg folded before Flop (didn't bet)



PokerStars Game #59938358772:  Hold'em No Limit ($1/$2) - 2009/07/01 0:13:05 ET
Table 'pPQgcj9XT9CHBsbo1WTBug' 6-max Seat #3 is the button
Seat 1: DFVYDA6dKQy7R7mGIKogZA ($77.85 in chips)
Seat 2: X7GlkHF+lkbarCLuZ4Uf0w ($42.55 in chips)
Seat 3: vkfxu8f/jMYKUk6Ly4eujw ($188 in chips)
Seat 5: 4Cl43Q1TYQL8wn1NSCUkaw ($61.45 in chips)
4Cl43Q1TYQL8wn1NSCUkaw: posts small blind $1
DFVYDA6dKQy7R7mGIKogZA: posts big blind $2
*** HOLE CARDS ***
X7GlkHF+lkbarCLuZ4Uf0w: folds
vkfxu8f/jMYKUk6Ly4eujw: folds
4Cl43Q1TYQL8wn1NSCUkaw: calls $1
DFVYDA6dKQy7R7mGIKogZA: checks
*** FLOP *** [6s Qc 3c]
4Cl43Q1TYQL8wn1NSCUkaw: bets $4
DFVYDA6dKQy7R7mGIKogZA: calls $4
*** TURN *** [6s Qc 3c] [2s]
4Cl43Q1TYQL8wn1NSCUkaw: bets $35
DFVYDA6dKQy7R7mGIKogZA: calls $35
*** RIVER *** [6s Qc 3c 2s] [4c]
4Cl43Q1TYQL8wn1NSCUkaw: bets $20.45 and is all-in
DFVYDA6dKQy7R7mGIKogZA: calls $20.45
*** SHOW DOWN ***
4Cl43Q1TYQL8wn1NSCUkaw: shows [6h 2d] (two pair, Sixes and Deuces)
DFVYDA6dKQy7R7mGIKogZA: shows [5c 2c] (a flush, Queen high)
DFVYDA6dKQy7R7mGIKogZA collected $120.90 from pot
*** SUMMARY ***
Total pot $122.90 | Rake $2
Board [6s Qc 3c 2s 4c]
Seat 1: DFVYDA6dKQy7R7mGIKogZA (big blind) showed [5c 2c] and won ($120.90) with a flush, Queen high
Seat 2: X7GlkHF+lkbarCLuZ4Uf0w folded before Flop (didn't bet)
Seat 3: vkfxu8f/jMYKUk6Ly4eujw (button) folded before Flop (didn't bet)
Seat 5: 4Cl43Q1TYQL8wn1NSCUkaw (small blind) showed [6h 2d] and lost with two pair, Sixes and Deuces



PokerStars Game #59938358578:  Hold'em No Limit ($1/$2) - 2009/07/01 0:13:05 ET
Table '3FGoiEOffWrbgTfsB3t7FA' 2-max Seat #2 is the button
Seat 1: e0oDWyrmgLpR6bROEqw1nQ ($343.50 in chips)
Seat 2: +sy/nlNI20yZraIjs4AALg ($257.65 in chips)
+sy/nlNI20yZraIjs4AALg: posts small blind $1
e0oDWyrmgLpR6bROEqw1nQ: posts big blind $2
*** HOLE CARDS ***
+sy/nlNI20yZraIjs4AALg: folds
e0oDWyrmgLpR6bROEqw1nQ collected $2 from pot
*** SUMMARY ***
Total pot $2 | Rake $0
Seat 1: e0oDWyrmgLpR6bROEqw1nQ (big blind) collected ($2)
Seat 2: +sy/nlNI20yZraIjs4AALg (button) (small blind) folded before Flop



PokerStars Game #59938359254:  Hold'em No Limit ($1/$2) - 2009/07/01 0:13:06 ET
Table 'qVXak+oTeDXMGbWa4sDU5Q' 9-max Seat #2 is the button
Seat 1: H6Z4+qu8gR0VUiPOijndVg ($247 in chips)
Seat 2: Hc2itIxwbi1lwa+DAYYQGg ($46 in chips)
Seat 3: oz9eCXGC7DdjQlL/nuWj1A ($106.60 in chips)
Seat 4: b0jO1SDhLedy1//CQlA8kw ($40 in chips)
Seat 6: Q3uFdu6ztesjDFiqkagTRQ ($200 in chips)
Seat 7: 5iPk5MyO3KVu18Y8XCYfFQ ($115 in chips)
Seat 8: 9pHZMviI9R8injxojGTnvw ($115.80 in chips)
Seat 9: IZ/2qsh1CIg9m5PWsMsLmA ($351.95 in chips)
oz9eCXGC7DdjQlL/nuWj1A: posts small blind $1
b0jO1SDhLedy1//CQlA8kw: posts big blind $2
NqKRc5xvcye0d7F6VOF6MQ: sits out
*** HOLE CARDS ***
Q3uFdu6ztesjDFiqkagTRQ: folds
5iPk5MyO3KVu18Y8XCYfFQ: folds
9pHZMviI9R8injxojGTnvw: folds
IZ/2qsh1CIg9m5PWsMsLmA: folds
H6Z4+qu8gR0VUiPOijndVg: raises $4 to $6
Hc2itIxwbi1lwa+DAYYQGg: folds
oz9eCXGC7DdjQlL/nuWj1A: calls $5
b0jO1SDhLedy1//CQlA8kw: folds
*** FLOP *** [8h Ac 9c]
oz9eCXGC7DdjQlL/nuWj1A: checks
H6Z4+qu8gR0VUiPOijndVg: bets $10
oz9eCXGC7DdjQlL/nuWj1A: folds
H6Z4+qu8gR0VUiPOijndVg collected $13.30 from pot
H6Z4+qu8gR0VUiPOijndVg: doesn't show hand
*** SUMMARY ***
Total pot $14 | Rake $0.70
Board [8h Ac 9c]
Seat 1: H6Z4+qu8gR0VUiPOijndVg collected ($13.30)
Seat 2: Hc2itIxwbi1lwa+DAYYQGg (button) folded before Flop (didn't bet)
Seat 3: oz9eCXGC7DdjQlL/nuWj1A (small blind) folded on the Flop
Seat 4: b0jO1SDhLedy1//CQlA8kw (big blind) folded before Flop
Seat 6: Q3uFdu6ztesjDFiqkagTRQ folded before Flop (didn't bet)
Seat 7: 5iPk5MyO3KVu18Y8XCYfFQ folded before Flop (didn't bet)
Seat 8: 9pHZMviI9R8injxojGTnvw folded before Flop (didn't bet)
Seat 9: IZ/2qsh1CIg9m5PWsMsLmA folded before Flop (didn't bet)



PokerStars Game #59938361406:  Hold'em No Limit ($1/$2) - 2009/07/01 0:13:09 ET
Table 'W9UeSV0aoPjh5SFSxM8jUQ' 9-max Seat #4 is the button
Seat 1: cdC54j9fGGojcbzWB5PgzA ($233.35 in chips)
Seat 2: iMe5yhc+1BaiIPHet3NMrA ($260.75 in chips)
Seat 3: TAfo4veNRaRlzDXMMYS3Jg ($37 in chips)
Seat 4: De9g+AYjo0DN6C/+iT/nsg ($197 in chips)
Seat 6: MXxB6weBWzZyAhRZb+/KVg ($201 in chips)
Seat 7: 4Cl43Q1TYQL8wn1NSCUkaw ($51.60 in chips)
Seat 9: U2A5Hv6ib/5+gzO2wr7Z4w ($200 in chips)
MXxB6weBWzZyAhRZb+/KVg: posts small blind $1
4Cl43Q1TYQL8wn1NSCUkaw: posts big blind $2
*** HOLE CARDS ***
U2A5Hv6ib/5+gzO2wr7Z4w: folds
cdC54j9fGGojcbzWB5PgzA: folds
iMe5yhc+1BaiIPHet3NMrA: folds
TAfo4veNRaRlzDXMMYS3Jg: raises $35 to $37 and is all-in
De9g+AYjo0DN6C/+iT/nsg: folds
MXxB6weBWzZyAhRZb+/KVg: folds
4Cl43Q1TYQL8wn1NSCUkaw: folds
TAfo4veNRaRlzDXMMYS3Jg collected $5 from pot
*** SUMMARY ***
Total pot $5 | Rake $0
Seat 1: cdC54j9fGGojcbzWB5PgzA folded before Flop (didn't bet)
Seat 2: iMe5yhc+1BaiIPHet3NMrA folded before Flop (didn't bet)
Seat 3: TAfo4veNRaRlzDXMMYS3Jg collected ($5)
Seat 4: De9g+AYjo0DN6C/+iT/nsg (button) folded before Flop (didn't bet)
Seat 6: MXxB6weBWzZyAhRZb+/KVg (small blind) folded before Flop
Seat 7: 4Cl43Q1TYQL8wn1NSCUkaw (big blind) folded before Flop
Seat 9: U2A5Hv6ib/5+gzO2wr7Z4w folded before Flop (didn't bet)



PokerStars Game #59938365352:  Hold'em No Limit ($1/$2) - 2009/07/01 0:13:15 ET
Table '3FGoiEOffWrbgTfsB3t7FA' 2-max Seat #1 is the button
Seat 1: e0oDWyrmgLpR6bROEqw1nQ ($344.50 in chips)
Seat 2: +sy/nlNI20yZraIjs4AALg ($256.65 in chips)
e0oDWyrmgLpR6bROEqw1nQ: posts small blind $1
+sy/nlNI20yZraIjs4AALg: posts big blind $2
*** HOLE CARDS ***
e0oDWyrmgLpR6bROEqw1nQ: raises $4 to $6
+sy/nlNI20yZraIjs4AALg: raises $4 to $10
e0oDWyrmgLpR6bROEqw1nQ: calls $4
*** FLOP *** [5h 9s 2s]
+sy/nlNI20yZraIjs4AALg: bets $10
e0oDWyrmgLpR6bROEqw1nQ: raises $20 to $30
+sy/nlNI20yZraIjs4AALg: calls $20
*** TURN *** [5h 9s 2s] [Tc]
+sy/nlNI20yZraIjs4AALg: bets $40
e0oDWyrmgLpR6bROEqw1nQ: calls $40
*** RIVER *** [5h 9s 2s Tc] [7d]
+sy/nlNI20yZraIjs4AALg: bets $90
e0oDWyrmgLpR6bROEqw1nQ: folds
+sy/nlNI20yZraIjs4AALg collected $159.50 from pot
*** SUMMARY ***
Total pot $160 | Rake $0.50
Board [5h 9s 2s Tc 7d]
Seat 1: e0oDWyrmgLpR6bROEqw1nQ (button) (small blind) folded on the River
Seat 2: +sy/nlNI20yZraIjs4AALg (big blind) collected ($159.50)



PokerStars Game #59938367286:  Hold'em No Limit ($1/$2) - 2009/07/01 0:13:17 ET
Table 'NmY84NAf9Mh0ckAckHnh5g' 2-max Seat #2 is the button
Seat 1: 6hvg964TSqZ3AL/0XK9aVQ ($375.75 in chips)
Seat 2: RwDoM55ZeQuI2ADyJhOb2Q ($213.55 in chips)
RwDoM55ZeQuI2ADyJhOb2Q: posts small blind $1
6hvg964TSqZ3AL/0XK9aVQ: posts big blind $2
*** HOLE CARDS ***
RwDoM55ZeQuI2ADyJhOb2Q: raises $4 to $6
6hvg964TSqZ3AL/0XK9aVQ: calls $4
*** FLOP *** [5c 2s Ks]
6hvg964TSqZ3AL/0XK9aVQ: checks
RwDoM55ZeQuI2ADyJhOb2Q: bets $8
6hvg964TSqZ3AL/0XK9aVQ: folds
RwDoM55ZeQuI2ADyJhOb2Q collected $11.50 from pot
RwDoM55ZeQuI2ADyJhOb2Q: doesn't show hand
*** SUMMARY ***
Total pot $12 | Rake $0.50
Board [5c 2s Ks]
Seat 1: 6hvg964TSqZ3AL/0XK9aVQ (big blind) folded on the Flop
Seat 2: RwDoM55ZeQuI2ADyJhOb2Q (button) (small blind) collected ($11.50)



PokerStars Game #59938367152:  Hold'em No Limit ($1/$2) - 2009/07/01 0:13:17 ET
Table 'eyAQSIlgc2o1Jxvbve4WGg' 9-max Seat #8 is the button
Seat 1: Q3uFdu6ztesjDFiqkagTRQ ($228 in chips)
Seat 3: TAfo4veNRaRlzDXMMYS3Jg ($37 in chips)
Seat 5: JnV3SM2D6dAFYyGZHHpvrg ($100 in chips)
Seat 6: IikcENBHwoT7snSvBPSc7Q ($182.60 in chips)
Seat 7: QHxJjpVYwitg9krW6wZgJA ($200 in chips)
Seat 8: 5iPk5MyO3KVu18Y8XCYfFQ ($38.60 in chips)
Seat 9: Hc2itIxwbi1lwa+DAYYQGg ($53.85 in chips)
Hc2itIxwbi1lwa+DAYYQGg: posts small blind $1
Q3uFdu6ztesjDFiqkagTRQ: posts big blind $2
*** HOLE CARDS ***
TAfo4veNRaRlzDXMMYS3Jg: folds
JnV3SM2D6dAFYyGZHHpvrg: folds
IikcENBHwoT7snSvBPSc7Q: folds
QHxJjpVYwitg9krW6wZgJA: raises $2 to $4
5iPk5MyO3KVu18Y8XCYfFQ: folds
Hc2itIxwbi1lwa+DAYYQGg: folds
Q3uFdu6ztesjDFiqkagTRQ: raises $14 to $18
QHxJjpVYwitg9krW6wZgJA: folds
Q3uFdu6ztesjDFiqkagTRQ collected $9 from pot
Q3uFdu6ztesjDFiqkagTRQ: doesn't show hand
*** SUMMARY ***
Total pot $9 | Rake $0
Seat 1: Q3uFdu6ztesjDFiqkagTRQ (big blind) collected ($9)
Seat 3: TAfo4veNRaRlzDXMMYS3Jg folded before Flop (didn't bet)
Seat 5: JnV3SM2D6dAFYyGZHHpvrg folded before Flop (didn't bet)
Seat 6: IikcENBHwoT7snSvBPSc7Q folded before Flop (didn't bet)
Seat 7: QHxJjpVYwitg9krW6wZgJA folded before Flop
Seat 8: 5iPk5MyO3KVu18Y8XCYfFQ (button) folded before Flop (didn't bet)
Seat 9: Hc2itIxwbi1lwa+DAYYQGg (small blind) folded before Flop



PokerStars Game #59938370266:  Hold'em No Limit ($1/$2) - 2009/07/01 0:13:21 ET
Table 'l5lZHc5JRHEDt0Y2AVPq3g' 6-max Seat #2 is the button
Seat 1: gGPaCoSWW1HoKYaqfAPecg ($216.25 in chips)
Seat 2: my38j/MmtBd/8qVwmyCREA ($240.35 in chips)
Seat 4: zNjJ/y4emmF+vzrCDd+ooA ($213.75 in chips)
Seat 5: X7GlkHF+lkbarCLuZ4Uf0w ($40 in chips)
Seat 6: vkfxu8f/jMYKUk6Ly4eujw ($203.30 in chips)
zNjJ/y4emmF+vzrCDd+ooA: posts small blind $1
X7GlkHF+lkbarCLuZ4Uf0w: posts big blind $2
*** HOLE CARDS ***
vkfxu8f/jMYKUk6Ly4eujw: folds
gGPaCoSWW1HoKYaqfAPecg: folds
my38j/MmtBd/8qVwmyCREA: folds
zNjJ/y4emmF+vzrCDd+ooA: calls $1
X7GlkHF+lkbarCLuZ4Uf0w: raises $4 to $6
zNjJ/y4emmF+vzrCDd+ooA: folds
X7GlkHF+lkbarCLuZ4Uf0w collected $4 from pot
X7GlkHF+lkbarCLuZ4Uf0w: doesn't show hand
*** SUMMARY ***
Total pot $4 | Rake $0
Seat 1: gGPaCoSWW1HoKYaqfAPecg folded before Flop (didn't bet)
Seat 2: my38j/MmtBd/8qVwmyCREA (button) folded before Flop (didn't bet)
Seat 4: zNjJ/y4emmF+vzrCDd+ooA (small blind) folded before Flop
Seat 5: X7GlkHF+lkbarCLuZ4Uf0w (big blind) collected ($4)
Seat 6: vkfxu8f/jMYKUk6Ly4eujw folded before Flop (didn't bet)



PokerStars Game #59938372720:  Hold'em No Limit ($1/$2) - 2009/07/01 0:13:25 ET
Table 'YqGfR5eHfMeSjb9a+QU9rg' 9-max Seat #4 is the button
Seat 1: qCBuzVnLcBR29snMAHq9PA ($136.90 in chips)
Seat 2: W3Nqt1GWlTi9tXQXMNEvgw ($245.95 in chips)
Seat 3: /gll27k+xWYV7Fbki0lFDQ ($123.05 in chips)
Seat 4: QHxJjpVYwitg9krW6wZgJA ($200 in chips)
Seat 5: MOBMOMQRN/z+fiGXGnZojw ($183.10 in chips)
Seat 6: 5iPk5MyO3KVu18Y8XCYfFQ ($46 in chips)
Seat 7: b0jO1SDhLedy1//CQlA8kw ($39 in chips)
Seat 8: JnV3SM2D6dAFYyGZHHpvrg ($100 in chips)
Seat 9: RsrgM2l7PLbQ9xBbSi3IvQ ($116.55 in chips)
MOBMOMQRN/z+fiGXGnZojw: posts small blind $1
5iPk5MyO3KVu18Y8XCYfFQ: posts big blind $2
*** HOLE CARDS ***
b0jO1SDhLedy1//CQlA8kw: raises $5 to $7
JnV3SM2D6dAFYyGZHHpvrg: folds
RsrgM2l7PLbQ9xBbSi3IvQ: folds
qCBuzVnLcBR29snMAHq9PA: folds
W3Nqt1GWlTi9tXQXMNEvgw: folds
/gll27k+xWYV7Fbki0lFDQ: folds
QHxJjpVYwitg9krW6wZgJA: folds
MOBMOMQRN/z+fiGXGnZojw: folds
5iPk5MyO3KVu18Y8XCYfFQ: folds
b0jO1SDhLedy1//CQlA8kw collected $5 from pot
b0jO1SDhLedy1//CQlA8kw: doesn't show hand
*** SUMMARY ***
Total pot $5 | Rake $0
Seat 1: qCBuzVnLcBR29snMAHq9PA folded before Flop (didn't bet)
Seat 2: W3Nqt1GWlTi9tXQXMNEvgw folded before Flop (didn't bet)
Seat 3: /gll27k+xWYV7Fbki0lFDQ folded before Flop (didn't bet)
Seat 4: QHxJjpVYwitg9krW6wZgJA (button) folded before Flop (didn't bet)
Seat 5: MOBMOMQRN/z+fiGXGnZojw (small blind) folded before Flop
Seat 6: 5iPk5MyO3KVu18Y8XCYfFQ (big blind) folded before Flop
Seat 7: b0jO1SDhLedy1//CQlA8kw collected ($5)
Seat 8: JnV3SM2D6dAFYyGZHHpvrg folded before Flop (didn't bet)
Seat 9: RsrgM2l7PLbQ9xBbSi3IvQ folded before Flop (didn't bet)



PokerStars Game #59938377516:  Hold'em No Limit ($1/$2) - 2009/07/01 0:13:32 ET
Table 'bJQ024BaYSBrW0sXpCZbNQ' 6-max Seat #1 is the button
Seat 1: Mo7b4GXWaawCURUQwq6RYg ($119 in chips)
Seat 2: 1njbh8TKSUF6l4V1XwGdcg ($267.80 in chips)
Seat 4: 9ni/OEXAqfc58zPQ0Tu9rQ ($265.60 in chips)
Seat 5: X7GlkHF+lkbarCLuZ4Uf0w ($58.15 in chips)
Seat 6: 9dpyyjDTCed6nV7JhaUUpw ($200 in chips)
1njbh8TKSUF6l4V1XwGdcg: posts small blind $1
9ni/OEXAqfc58zPQ0Tu9rQ: posts big blind $2
*** HOLE CARDS ***
X7GlkHF+lkbarCLuZ4Uf0w: folds
9dpyyjDTCed6nV7JhaUUpw: folds
Mo7b4GXWaawCURUQwq6RYg: raises $4 to $6
1njbh8TKSUF6l4V1XwGdcg: calls $5
9ni/OEXAqfc58zPQ0Tu9rQ: folds
*** FLOP *** [7c As Ad]
1njbh8TKSUF6l4V1XwGdcg: checks
Mo7b4GXWaawCURUQwq6RYg: checks
*** TURN *** [7c As Ad] [Kc]
1njbh8TKSUF6l4V1XwGdcg: bets $10
Mo7b4GXWaawCURUQwq6RYg: raises $15 to $25
1njbh8TKSUF6l4V1XwGdcg: calls $15
*** RIVER *** [7c As Ad Kc] [Jh]
1njbh8TKSUF6l4V1XwGdcg: checks
Mo7b4GXWaawCURUQwq6RYg: bets $44
1njbh8TKSUF6l4V1XwGdcg: calls $44
*** SHOW DOWN ***
Mo7b4GXWaawCURUQwq6RYg: shows [6d 5d] (a pair of Aces)
1njbh8TKSUF6l4V1XwGdcg: shows [Ac Tc] (three of a kind, Aces)
1njbh8TKSUF6l4V1XwGdcg collected $150 from pot
*** SUMMARY ***
Total pot $152 | Rake $2
Board [7c As Ad Kc Jh]
Seat 1: Mo7b4GXWaawCURUQwq6RYg (button) showed [6d 5d] and lost with a pair of Aces
Seat 2: 1njbh8TKSUF6l4V1XwGdcg (small blind) showed [Ac Tc] and won ($150) with three of a kind, Aces
Seat 4: 9ni/OEXAqfc58zPQ0Tu9rQ (big blind) folded before Flop
Seat 5: X7GlkHF+lkbarCLuZ4Uf0w folded before Flop (didn't bet)
Seat 6: 9dpyyjDTCed6nV7JhaUUpw folded before Flop (didn't bet)



PokerStars Game #59938377410:  Hold'em No Limit ($1/$2) - 2009/07/01 0:13:32 ET
Table 'gnHBqWll9O3fxG7Ojkz/ng' 9-max Seat #2 is the button
Seat 1: hpqdC/23wXosGOmzARr5NA ($156.05 in chips)
Seat 2: H6Z4+qu8gR0VUiPOijndVg ($200 in chips)
Seat 3: 5Q8U6iZbeO7xJSS4qvDP5g ($216.60 in chips)
Seat 4: n5XI5/7gN+gIubHFBH+mOw ($405.55 in chips)
Seat 6: 5iPk5MyO3KVu18Y8XCYfFQ ($52.45 in chips)
Seat 8: De9g+AYjo0DN6C/+iT/nsg ($244.05 in chips)
Seat 9: kVCeGJ4NY7Fb0W74j1mAqA ($206 in chips)
5Q8U6iZbeO7xJSS4qvDP5g: posts small blind $1
n5XI5/7gN+gIubHFBH+mOw: posts big blind $2
rBQDMkKm9cZn6M9NPsiVew: sits out
*** HOLE CARDS ***
5iPk5MyO3KVu18Y8XCYfFQ: folds
De9g+AYjo0DN6C/+iT/nsg: folds
kVCeGJ4NY7Fb0W74j1mAqA: folds
hpqdC/23wXosGOmzARr5NA: calls $2
H6Z4+qu8gR0VUiPOijndVg: folds
5Q8U6iZbeO7xJSS4qvDP5g: folds
n5XI5/7gN+gIubHFBH+mOw: checks
*** FLOP *** [3c Kh Ts]
n5XI5/7gN+gIubHFBH+mOw: bets $2
hpqdC/23wXosGOmzARr5NA: calls $2
*** TURN *** [3c Kh Ts] [Th]
n5XI5/7gN+gIubHFBH+mOw: bets $6
hpqdC/23wXosGOmzARr5NA: folds
n5XI5/7gN+gIubHFBH+mOw collected $8.60 from pot
*** SUMMARY ***
Total pot $9 | Rake $0.40
Board [3c Kh Ts Th]
Seat 1: hpqdC/23wXosGOmzARr5NA folded on the Turn
Seat 2: H6Z4+qu8gR0VUiPOijndVg (button) folded before Flop (didn't bet)
Seat 3: 5Q8U6iZbeO7xJSS4qvDP5g (small blind) folded before Flop
Seat 4: n5XI5/7gN+gIubHFBH+mOw (big blind) collected ($8.60)
Seat 6: 5iPk5MyO3KVu18Y8XCYfFQ folded before Flop (didn't bet)
Seat 8: De9g+AYjo0DN6C/+iT/nsg folded before Flop (didn't bet)
Seat 9: kVCeGJ4NY7Fb0W74j1mAqA folded before Flop (didn't bet)



PokerStars Game #59938377762:  Hold'em No Limit ($1/$2) - 2009/07/01 0:13:32 ET
Table 'NmY84NAf9Mh0ckAckHnh5g' 2-max Seat #1 is the button
Seat 1: 6hvg964TSqZ3AL/0XK9aVQ ($369.75 in chips)
Seat 2: RwDoM55ZeQuI2ADyJhOb2Q ($219.05 in chips)
6hvg964TSqZ3AL/0XK9aVQ: posts small blind $1
RwDoM55ZeQuI2ADyJhOb2Q: posts big blind $2
*** HOLE CARDS ***
6hvg964TSqZ3AL/0XK9aVQ: calls $1
RwDoM55ZeQuI2ADyJhOb2Q: checks
*** FLOP *** [Qc Kd 6h]
RwDoM55ZeQuI2ADyJhOb2Q: checks
6hvg964TSqZ3AL/0XK9aVQ: checks
*** TURN *** [Qc Kd 6h] [4h]
RwDoM55ZeQuI2ADyJhOb2Q: checks
6hvg964TSqZ3AL/0XK9aVQ: checks
*** RIVER *** [Qc Kd 6h 4h] [Qh]
RwDoM55ZeQuI2ADyJhOb2Q: checks
6hvg964TSqZ3AL/0XK9aVQ: checks
*** SHOW DOWN ***
RwDoM55ZeQuI2ADyJhOb2Q: shows [3d As] (a pair of Queens)
6hvg964TSqZ3AL/0XK9aVQ: mucks hand
RwDoM55ZeQuI2ADyJhOb2Q collected $3.80 from pot
*** SUMMARY ***
Total pot $4 | Rake $0.20
Board [Qc Kd 6h 4h Qh]
Seat 1: 6hvg964TSqZ3AL/0XK9aVQ (button) (small blind) mucked
Seat 2: RwDoM55ZeQuI2ADyJhOb2Q (big blind) showed [3d As] and won ($3.80) with a pair of Queens



PokerStars Game #59938378764:  Hold'em No Limit ($1/$2) - 2009/07/01 0:13:34 ET
Table 'WCA60bDA8ecovUgFSIZkTQ' 9-max Seat #9 is the button
Seat 1: CUZwDpLTQKhzarPe+JCLOQ ($212.75 in chips)
Seat 2: G1h8wamBcVJXtsKXZQ2EyA ($101.40 in chips)
Seat 3: 5iPk5MyO3KVu18Y8XCYfFQ ($37 in chips)
Seat 4: Q3uFdu6ztesjDFiqkagTRQ ($464.70 in chips)
Seat 5: Hc2itIxwbi1lwa+DAYYQGg ($306.30 in chips)
Seat 6: DOWQSOJ7GaX+ksfWTqPT5A ($256.75 in chips)
Seat 8: x+V1JgVDawsJTxKcxm7gxw ($60 in chips)
Seat 9: 3q2/0oJr3Mcy1W5tcN61ug ($294.20 in chips)
CUZwDpLTQKhzarPe+JCLOQ: posts small blind $1
G1h8wamBcVJXtsKXZQ2EyA: posts big blind $2
2YpnxJiexJHyERfbqgwEcw: sits out
*** HOLE CARDS ***
5iPk5MyO3KVu18Y8XCYfFQ: folds
Q3uFdu6ztesjDFiqkagTRQ: folds
Hc2itIxwbi1lwa+DAYYQGg: folds
DOWQSOJ7GaX+ksfWTqPT5A: calls $2
x+V1JgVDawsJTxKcxm7gxw: raises $6 to $8
3q2/0oJr3Mcy1W5tcN61ug: folds
CUZwDpLTQKhzarPe+JCLOQ: folds
G1h8wamBcVJXtsKXZQ2EyA: folds
DOWQSOJ7GaX+ksfWTqPT5A: calls $6
*** FLOP *** [5s Qh Kc]
DOWQSOJ7GaX+ksfWTqPT5A: checks
x+V1JgVDawsJTxKcxm7gxw: checks
*** TURN *** [5s Qh Kc] [2c]
DOWQSOJ7GaX+ksfWTqPT5A: checks
x+V1JgVDawsJTxKcxm7gxw: checks
*** RIVER *** [5s Qh Kc 2c] [Qd]
DOWQSOJ7GaX+ksfWTqPT5A: checks
x+V1JgVDawsJTxKcxm7gxw: checks
*** SHOW DOWN ***
DOWQSOJ7GaX+ksfWTqPT5A: shows [Js 9d] (a pair of Queens)
x+V1JgVDawsJTxKcxm7gxw: shows [Tc Ad] (a pair of Queens - Ace kicker)
x+V1JgVDawsJTxKcxm7gxw collected $18.05 from pot
*** SUMMARY ***
Total pot $19 | Rake $0.95
Board [5s Qh Kc 2c Qd]
Seat 1: CUZwDpLTQKhzarPe+JCLOQ (small blind) folded before Flop
Seat 2: G1h8wamBcVJXtsKXZQ2EyA (big blind) folded before Flop
Seat 3: 5iPk5MyO3KVu18Y8XCYfFQ folded before Flop (didn't bet)
Seat 4: Q3uFdu6ztesjDFiqkagTRQ folded before Flop (didn't bet)
Seat 5: Hc2itIxwbi1lwa+DAYYQGg folded before Flop (didn't bet)
Seat 6: DOWQSOJ7GaX+ksfWTqPT5A showed [Js 9d] and lost with a pair of Queens
Seat 8: x+V1JgVDawsJTxKcxm7gxw showed [Tc Ad] and won ($18.05) with a pair of Queens
Seat 9: 3q2/0oJr3Mcy1W5tcN61ug (button) folded before Flop (didn't bet)



PokerStars Game #59938380240:  Hold'em No Limit ($1/$2) - 2009/07/01 0:13:36 ET
Table 'rsKRKlGHlxVyqJxzO2a2Ow' 9-max Seat #8 is the button
Seat 1: uYWfQJg2hgHLxri6/uVJiw ($137.10 in chips)
Seat 2: QHxJjpVYwitg9krW6wZgJA ($247.50 in chips)
Seat 3: 9sYbXdhj1M2bwKrVNxj5+Q ($113.80 in chips)
Seat 4: zJtQ1gxyi72XvGYS1tM+DA ($178.55 in chips)
Seat 5: 5Q8U6iZbeO7xJSS4qvDP5g ($203 in chips)
Seat 6: H6Z4+qu8gR0VUiPOijndVg ($200 in chips)
Seat 7: kVCeGJ4NY7Fb0W74j1mAqA ($206 in chips)
Seat 8: Hc2itIxwbi1lwa+DAYYQGg ($34 in chips)
Seat 9: 5iPk5MyO3KVu18Y8XCYfFQ ($102.65 in chips)
5iPk5MyO3KVu18Y8XCYfFQ: posts small blind $1
uYWfQJg2hgHLxri6/uVJiw: posts big blind $2
*** HOLE CARDS ***
QHxJjpVYwitg9krW6wZgJA: folds
9sYbXdhj1M2bwKrVNxj5+Q: raises $4 to $6
zJtQ1gxyi72XvGYS1tM+DA: folds
5Q8U6iZbeO7xJSS4qvDP5g: folds
H6Z4+qu8gR0VUiPOijndVg: folds
kVCeGJ4NY7Fb0W74j1mAqA: folds
Hc2itIxwbi1lwa+DAYYQGg: folds
5iPk5MyO3KVu18Y8XCYfFQ: calls $5
uYWfQJg2hgHLxri6/uVJiw: calls $4
*** FLOP *** [7c Tc 9h]
5iPk5MyO3KVu18Y8XCYfFQ: checks
uYWfQJg2hgHLxri6/uVJiw: bets $8
9sYbXdhj1M2bwKrVNxj5+Q: folds
5iPk5MyO3KVu18Y8XCYfFQ: raises $88.65 to $96.65 and is all-in
uYWfQJg2hgHLxri6/uVJiw: folds
5iPk5MyO3KVu18Y8XCYfFQ collected $32.35 from pot
5iPk5MyO3KVu18Y8XCYfFQ: doesn't show hand
*** SUMMARY ***
Total pot $34 | Rake $1.65
Board [7c Tc 9h]
Seat 1: uYWfQJg2hgHLxri6/uVJiw (big blind) folded on the Flop
Seat 2: QHxJjpVYwitg9krW6wZgJA folded before Flop (didn't bet)
Seat 3: 9sYbXdhj1M2bwKrVNxj5+Q folded on the Flop
Seat 4: zJtQ1gxyi72XvGYS1tM+DA folded before Flop (didn't bet)
Seat 5: 5Q8U6iZbeO7xJSS4qvDP5g folded before Flop (didn't bet)
Seat 6: H6Z4+qu8gR0VUiPOijndVg folded before Flop (didn't bet)
Seat 7: kVCeGJ4NY7Fb0W74j1mAqA folded before Flop (didn't bet)
Seat 8: Hc2itIxwbi1lwa+DAYYQGg (button) folded before Flop (didn't bet)
Seat 9: 5iPk5MyO3KVu18Y8XCYfFQ (small blind) collected ($32.35)



PokerStars Game #59938382700:  Hold'em No Limit ($1/$2) - 2009/07/01 0:13:39 ET
Table 'W9UeSV0aoPjh5SFSxM8jUQ' 9-max Seat #6 is the button
Seat 1: cdC54j9fGGojcbzWB5PgzA ($233.35 in chips)
Seat 2: iMe5yhc+1BaiIPHet3NMrA ($260.75 in chips)
Seat 3: TAfo4veNRaRlzDXMMYS3Jg ($40 in chips)
Seat 4: De9g+AYjo0DN6C/+iT/nsg ($197 in chips)
Seat 6: MXxB6weBWzZyAhRZb+/KVg ($200 in chips)
Seat 7: 4Cl43Q1TYQL8wn1NSCUkaw ($49.60 in chips)
Seat 9: U2A5Hv6ib/5+gzO2wr7Z4w ($200 in chips)
4Cl43Q1TYQL8wn1NSCUkaw: posts small blind $1
U2A5Hv6ib/5+gzO2wr7Z4w: posts big blind $2
*** HOLE CARDS ***
cdC54j9fGGojcbzWB5PgzA: raises $6 to $8
CUZwDpLTQKhzarPe+JCLOQ joins the table at seat #5
iMe5yhc+1BaiIPHet3NMrA: calls $8
TAfo4veNRaRlzDXMMYS3Jg: folds
De9g+AYjo0DN6C/+iT/nsg: folds
MXxB6weBWzZyAhRZb+/KVg: folds
4Cl43Q1TYQL8wn1NSCUkaw: folds
U2A5Hv6ib/5+gzO2wr7Z4w: folds
*** FLOP *** [8s 5c Kh]
cdC54j9fGGojcbzWB5PgzA: bets $14
iMe5yhc+1BaiIPHet3NMrA: calls $14
*** TURN *** [8s 5c Kh] [Jh]
cdC54j9fGGojcbzWB5PgzA: bets $31
iMe5yhc+1BaiIPHet3NMrA: calls $31
*** RIVER *** [8s 5c Kh Jh] [8c]
cdC54j9fGGojcbzWB5PgzA: checks
iMe5yhc+1BaiIPHet3NMrA: checks
*** SHOW DOWN ***
cdC54j9fGGojcbzWB5PgzA: shows [Qs As] (a pair of Eights)
iMe5yhc+1BaiIPHet3NMrA: shows [Ac Kd] (two pair, Kings and Eights)
iMe5yhc+1BaiIPHet3NMrA collected $106 from pot
*** SUMMARY ***
Total pot $109 | Rake $3
Board [8s 5c Kh Jh 8c]
Seat 1: cdC54j9fGGojcbzWB5PgzA showed [Qs As] and lost with a pair of Eights
Seat 2: iMe5yhc+1BaiIPHet3NMrA showed [Ac Kd] and won ($106) with two pair, Kings and Eights
Seat 3: TAfo4veNRaRlzDXMMYS3Jg folded before Flop (didn't bet)
Seat 4: De9g+AYjo0DN6C/+iT/nsg folded before Flop (didn't bet)
Seat 6: MXxB6weBWzZyAhRZb+/KVg (button) folded before Flop (didn't bet)
Seat 7: 4Cl43Q1TYQL8wn1NSCUkaw (small blind) folded before Flop
Seat 9: U2A5Hv6ib/5+gzO2wr7Z4w (big blind) folded before Flop



PokerStars Game #59938383870:  Hold'em No Limit ($1/$2) - 2009/07/01 0:13:41 ET
Table 'SF49/KQm8T4taMp6kb+HXA' 9-max Seat #8 is the button
Seat 1: l1bCLGuFqeFRwUfPsiDu/g ($176.95 in chips)
Seat 2: 8Z3QifiM9eOd5EIJ25dXNg ($103.35 in chips)
Seat 4: HffgoYm61KgkdMe/DYChIQ ($34 in chips)
Seat 5: Z3aYCZG/yXHYFjiWkGI5ug ($226.55 in chips)
Seat 6: M2ht6rIKOI/my9eh610Nlw ($259.40 in chips)
Seat 7: n2VAbLaE5qgKr5mA4W6v4w ($51.50 in chips)
Seat 8: 5iPk5MyO3KVu18Y8XCYfFQ ($43 in chips)
Seat 9: O+jytCilwk7zItVCEavmtw ($129.20 in chips)
O+jytCilwk7zItVCEavmtw: posts small blind $1
l1bCLGuFqeFRwUfPsiDu/g: posts big blind $2
*** HOLE CARDS ***
8Z3QifiM9eOd5EIJ25dXNg: folds
HffgoYm61KgkdMe/DYChIQ: folds
Z3aYCZG/yXHYFjiWkGI5ug: folds
M2ht6rIKOI/my9eh610Nlw: raises $2 to $4
n2VAbLaE5qgKr5mA4W6v4w: folds
5iPk5MyO3KVu18Y8XCYfFQ: folds
O+jytCilwk7zItVCEavmtw: folds
l1bCLGuFqeFRwUfPsiDu/g: folds
M2ht6rIKOI/my9eh610Nlw collected $5 from pot
*** SUMMARY ***
Total pot $5 | Rake $0
Seat 1: l1bCLGuFqeFRwUfPsiDu/g (big blind) folded before Flop
Seat 2: 8Z3QifiM9eOd5EIJ25dXNg folded before Flop (didn't bet)
Seat 4: HffgoYm61KgkdMe/DYChIQ folded before Flop (didn't bet)
Seat 5: Z3aYCZG/yXHYFjiWkGI5ug folded before Flop (didn't bet)
Seat 6: M2ht6rIKOI/my9eh610Nlw collected ($5)
Seat 7: n2VAbLaE5qgKr5mA4W6v4w folded before Flop (didn't bet)
Seat 8: 5iPk5MyO3KVu18Y8XCYfFQ (button) folded before Flop (didn't bet)
Seat 9: O+jytCilwk7zItVCEavmtw (small blind) folded before Flop



PokerStars Game #59938384748:  Hold'em No Limit ($1/$2) - 2009/07/01 0:13:42 ET
Table 'mGpP9StWRnoeiBDExc6Frg' 6-max Seat #1 is the button
Seat 1: zWFU82nxIRvzK4mKiL4m0Q ($55.15 in chips)
Seat 3: 3HrFUl+TAqSP1U00zz3P7A ($176.60 in chips)
Seat 4: qXDd0ZyMIse0OBu8pxeQ3Q ($215 in chips)
Seat 5: d1puGuVBE0fidn+5eRJ0tw ($178 in chips)
Seat 6: X7GlkHF+lkbarCLuZ4Uf0w ($34.45 in chips)
DQlskgG4OtLpF2MVxLwf4A will be allowed to play after the button
3HrFUl+TAqSP1U00zz3P7A: posts small blind $1
qXDd0ZyMIse0OBu8pxeQ3Q: posts big blind $2
*** HOLE CARDS ***
d1puGuVBE0fidn+5eRJ0tw: folds
X7GlkHF+lkbarCLuZ4Uf0w: folds
zWFU82nxIRvzK4mKiL4m0Q: folds
3HrFUl+TAqSP1U00zz3P7A: folds
qXDd0ZyMIse0OBu8pxeQ3Q collected $2 from pot
*** SUMMARY ***
Total pot $2 | Rake $0
Seat 1: zWFU82nxIRvzK4mKiL4m0Q (button) folded before Flop (didn't bet)
Seat 3: 3HrFUl+TAqSP1U00zz3P7A (small blind) folded before Flop
Seat 4: qXDd0ZyMIse0OBu8pxeQ3Q (big blind) collected ($2)
Seat 5: d1puGuVBE0fidn+5eRJ0tw folded before Flop (didn't bet)
Seat 6: X7GlkHF+lkbarCLuZ4Uf0w folded before Flop (didn't bet)



PokerStars Game #59938385052:  Hold'em No Limit ($1/$2) - 2009/07/01 0:13:42 ET
Table 'LL4bDFyhj5hsMpzaDugJZg' 6-max Seat #5 is the button
Seat 1: IBW9lyGsaRmfcbyA/qFfEw ($65.20 in chips)
Seat 2: L3l+A4pJhOAD6HVVFXvVBw ($319.95 in chips)
Seat 3: gGPaCoSWW1HoKYaqfAPecg ($202 in chips)
Seat 4: 8srN1dKQePlsv0GyTada+Q ($268.75 in chips)
Seat 5: HgX0VeqE/dzSXd5BpntRBw ($200 in chips)
IBW9lyGsaRmfcbyA/qFfEw: posts small blind $1
L3l+A4pJhOAD6HVVFXvVBw: posts big blind $2
*** HOLE CARDS ***
gGPaCoSWW1HoKYaqfAPecg: raises $5 to $7
8srN1dKQePlsv0GyTada+Q: folds
HgX0VeqE/dzSXd5BpntRBw: folds
IBW9lyGsaRmfcbyA/qFfEw: folds
L3l+A4pJhOAD6HVVFXvVBw: folds
gGPaCoSWW1HoKYaqfAPecg collected $5 from pot
*** SUMMARY ***
Total pot $5 | Rake $0
Seat 1: IBW9lyGsaRmfcbyA/qFfEw (small blind) folded before Flop
Seat 2: L3l+A4pJhOAD6HVVFXvVBw (big blind) folded before Flop
Seat 3: gGPaCoSWW1HoKYaqfAPecg collected ($5)
Seat 4: 8srN1dKQePlsv0GyTada+Q folded before Flop (didn't bet)
Seat 5: HgX0VeqE/dzSXd5BpntRBw (button) folded before Flop (didn't bet)



PokerStars Game #59938387878:  Hold'em No Limit ($1/$2) - 2009/07/01 0:13:46 ET
Table 'qVXak+oTeDXMGbWa4sDU5Q' 9-max Seat #3 is the button
Seat 1: H6Z4+qu8gR0VUiPOijndVg ($254.30 in chips)
Seat 2: Hc2itIxwbi1lwa+DAYYQGg ($46 in chips)
Seat 3: oz9eCXGC7DdjQlL/nuWj1A ($100.60 in chips)
Seat 4: b0jO1SDhLedy1//CQlA8kw ($38 in chips)
Seat 5: NqKRc5xvcye0d7F6VOF6MQ ($60 in chips)
Seat 6: Q3uFdu6ztesjDFiqkagTRQ ($200 in chips)
Seat 7: 5iPk5MyO3KVu18Y8XCYfFQ ($115 in chips)
Seat 8: 9pHZMviI9R8injxojGTnvw ($115.80 in chips)
Seat 9: IZ/2qsh1CIg9m5PWsMsLmA ($351.95 in chips)
b0jO1SDhLedy1//CQlA8kw: posts small blind $1
NqKRc5xvcye0d7F6VOF6MQ: posts big blind $2
*** HOLE CARDS ***
Q3uFdu6ztesjDFiqkagTRQ: folds
5iPk5MyO3KVu18Y8XCYfFQ: folds
9pHZMviI9R8injxojGTnvw: folds
IZ/2qsh1CIg9m5PWsMsLmA: folds
H6Z4+qu8gR0VUiPOijndVg: folds
Hc2itIxwbi1lwa+DAYYQGg: folds
oz9eCXGC7DdjQlL/nuWj1A: folds
b0jO1SDhLedy1//CQlA8kw: raises $3 to $5
NqKRc5xvcye0d7F6VOF6MQ: folds
b0jO1SDhLedy1//CQlA8kw collected $4 from pot
b0jO1SDhLedy1//CQlA8kw: doesn't show hand
*** SUMMARY ***
Total pot $4 | Rake $0
Seat 1: H6Z4+qu8gR0VUiPOijndVg folded before Flop (didn't bet)
Seat 2: Hc2itIxwbi1lwa+DAYYQGg folded before Flop (didn't bet)
Seat 3: oz9eCXGC7DdjQlL/nuWj1A (button) folded before Flop (didn't bet)
Seat 4: b0jO1SDhLedy1//CQlA8kw (small blind) collected ($4)
Seat 5: NqKRc5xvcye0d7F6VOF6MQ (big blind) folded before Flop
Seat 6: Q3uFdu6ztesjDFiqkagTRQ folded before Flop (didn't bet)
Seat 7: 5iPk5MyO3KVu18Y8XCYfFQ folded before Flop (didn't bet)
Seat 8: 9pHZMviI9R8injxojGTnvw folded before Flop (didn't bet)
Seat 9: IZ/2qsh1CIg9m5PWsMsLmA folded before Flop (didn't bet)



PokerStars Game #59938388532:  Hold'em No Limit ($1/$2) - 2009/07/01 0:13:47 ET
Table 'l5lZHc5JRHEDt0Y2AVPq3g' 6-max Seat #4 is the button
Seat 1: gGPaCoSWW1HoKYaqfAPecg ($216.25 in chips)
Seat 2: my38j/MmtBd/8qVwmyCREA ($240.35 in chips)
Seat 4: zNjJ/y4emmF+vzrCDd+ooA ($211.75 in chips)
Seat 5: X7GlkHF+lkbarCLuZ4Uf0w ($42 in chips)
Seat 6: vkfxu8f/jMYKUk6Ly4eujw ($203.30 in chips)
X7GlkHF+lkbarCLuZ4Uf0w: posts small blind $1
vkfxu8f/jMYKUk6Ly4eujw: posts big blind $2
*** HOLE CARDS ***
gGPaCoSWW1HoKYaqfAPecg: folds
my38j/MmtBd/8qVwmyCREA: folds
zNjJ/y4emmF+vzrCDd+ooA: folds
X7GlkHF+lkbarCLuZ4Uf0w: raises $3 to $5
vkfxu8f/jMYKUk6Ly4eujw: calls $3
*** FLOP *** [Jh 3h Ks]
X7GlkHF+lkbarCLuZ4Uf0w: bets $7
vkfxu8f/jMYKUk6Ly4eujw: calls $7
*** TURN *** [Jh 3h Ks] [Kc]
yZgdnRylE65JbScQ7qCWgw leaves the table
X7GlkHF+lkbarCLuZ4Uf0w: bets $30 and is all-in
DQlskgG4OtLpF2MVxLwf4A joins the table at seat #3
vkfxu8f/jMYKUk6Ly4eujw: folds
X7GlkHF+lkbarCLuZ4Uf0w collected $22.85 from pot
X7GlkHF+lkbarCLuZ4Uf0w: doesn't show hand
*** SUMMARY ***
Total pot $24 | Rake $1.15
Board [Jh 3h Ks Kc]
Seat 1: gGPaCoSWW1HoKYaqfAPecg folded before Flop (didn't bet)
Seat 2: my38j/MmtBd/8qVwmyCREA folded before Flop (didn't bet)
Seat 4: zNjJ/y4emmF+vzrCDd+ooA (button) folded before Flop (didn't bet)
Seat 5: X7GlkHF+lkbarCLuZ4Uf0w (small blind) collected ($22.85)
Seat 6: vkfxu8f/jMYKUk6Ly4eujw (big blind) folded on the Turn



PokerStars Game #59938389160:  Hold'em No Limit ($1/$2) - 2009/07/01 0:13:48 ET
Table 'YqGfR5eHfMeSjb9a+QU9rg' 9-max Seat #5 is the button
Seat 1: qCBuzVnLcBR29snMAHq9PA ($136.90 in chips)
Seat 2: W3Nqt1GWlTi9tXQXMNEvgw ($245.95 in chips)
Seat 3: /gll27k+xWYV7Fbki0lFDQ ($123.05 in chips)
Seat 4: QHxJjpVYwitg9krW6wZgJA ($200 in chips)
Seat 5: MOBMOMQRN/z+fiGXGnZojw ($182.10 in chips)
Seat 6: 5iPk5MyO3KVu18Y8XCYfFQ ($44 in chips)
Seat 8: JnV3SM2D6dAFYyGZHHpvrg ($100 in chips)
Seat 9: RsrgM2l7PLbQ9xBbSi3IvQ ($116.55 in chips)
5iPk5MyO3KVu18Y8XCYfFQ: posts small blind $1
b0jO1SDhLedy1//CQlA8kw: is sitting out
JnV3SM2D6dAFYyGZHHpvrg: posts big blind $2
*** HOLE CARDS ***
b0jO1SDhLedy1//CQlA8kw leaves the table
RsrgM2l7PLbQ9xBbSi3IvQ: folds
qCBuzVnLcBR29snMAHq9PA: folds
W3Nqt1GWlTi9tXQXMNEvgw: folds
RsrgM2l7PLbQ9xBbSi3IvQ is sitting out
/gll27k+xWYV7Fbki0lFDQ is disconnected
/gll27k+xWYV7Fbki0lFDQ has timed out while disconnected
/gll27k+xWYV7Fbki0lFDQ: folds
/gll27k+xWYV7Fbki0lFDQ is sitting out
QHxJjpVYwitg9krW6wZgJA: folds
MOBMOMQRN/z+fiGXGnZojw: calls $2
5iPk5MyO3KVu18Y8XCYfFQ: folds
JnV3SM2D6dAFYyGZHHpvrg: checks
*** FLOP *** [6d 3d Kc]
/gll27k+xWYV7Fbki0lFDQ is connected
JnV3SM2D6dAFYyGZHHpvrg: checks
MOBMOMQRN/z+fiGXGnZojw: bets $6
JnV3SM2D6dAFYyGZHHpvrg: folds
MOBMOMQRN/z+fiGXGnZojw collected $4.75 from pot
*** SUMMARY ***
Total pot $5 | Rake $0.25
Board [6d 3d Kc]
Seat 1: qCBuzVnLcBR29snMAHq9PA folded before Flop (didn't bet)
Seat 2: W3Nqt1GWlTi9tXQXMNEvgw folded before Flop (didn't bet)
Seat 3: /gll27k+xWYV7Fbki0lFDQ folded before Flop (didn't bet)
Seat 4: QHxJjpVYwitg9krW6wZgJA folded before Flop (didn't bet)
Seat 5: MOBMOMQRN/z+fiGXGnZojw (button) collected ($4.75)
Seat 6: 5iPk5MyO3KVu18Y8XCYfFQ (small blind) folded before Flop
Seat 8: JnV3SM2D6dAFYyGZHHpvrg (big blind) folded on the Flop
Seat 9: RsrgM2l7PLbQ9xBbSi3IvQ folded before Flop (didn't bet)



PokerStars Game #59938392220:  Hold'em No Limit ($1/$2) - 2009/07/01 0:13:53 ET
Table 'XP2sRSup+aRuwzx3vDZsDg' 6-max Seat #6 is the button
Seat 1: o9jamqIi6sTTRSqudgboRA ($235.70 in chips)
Seat 3: X7GlkHF+lkbarCLuZ4Uf0w ($40 in chips)
Seat 4: JsC+WvfzqlxVs9G8/gSQAQ ($117.05 in chips)
Seat 6: h7ppRQJTYBsHCbLMeW9T2g ($484.75 in chips)
o9jamqIi6sTTRSqudgboRA: posts small blind $1
X7GlkHF+lkbarCLuZ4Uf0w: posts big blind $2
*** HOLE CARDS ***
JsC+WvfzqlxVs9G8/gSQAQ: folds
h7ppRQJTYBsHCbLMeW9T2g: folds
o9jamqIi6sTTRSqudgboRA: raises $4 to $6
X7GlkHF+lkbarCLuZ4Uf0w: folds
o9jamqIi6sTTRSqudgboRA collected $4 from pot
*** SUMMARY ***
Total pot $4 | Rake $0
Seat 1: o9jamqIi6sTTRSqudgboRA (small blind) collected ($4)
Seat 3: X7GlkHF+lkbarCLuZ4Uf0w (big blind) folded before Flop
Seat 4: JsC+WvfzqlxVs9G8/gSQAQ folded before Flop (didn't bet)
Seat 6: h7ppRQJTYBsHCbLMeW9T2g (button) folded before Flop (didn't bet)



PokerStars Game #59938392232:  Hold'em No Limit ($1/$2) - 2009/07/01 0:13:53 ET
Table 'NmY84NAf9Mh0ckAckHnh5g' 2-max Seat #2 is the button
Seat 1: 6hvg964TSqZ3AL/0XK9aVQ ($367.75 in chips)
Seat 2: RwDoM55ZeQuI2ADyJhOb2Q ($220.85 in chips)
RwDoM55ZeQuI2ADyJhOb2Q: posts small blind $1
6hvg964TSqZ3AL/0XK9aVQ: posts big blind $2
*** HOLE CARDS ***
RwDoM55ZeQuI2ADyJhOb2Q: raises $4 to $6
6hvg964TSqZ3AL/0XK9aVQ: calls $4
*** FLOP *** [6d 9h 4h]
6hvg964TSqZ3AL/0XK9aVQ: checks
RwDoM55ZeQuI2ADyJhOb2Q: bets $8
6hvg964TSqZ3AL/0XK9aVQ: calls $8
*** TURN *** [6d 9h 4h] [5c]
6hvg964TSqZ3AL/0XK9aVQ: checks
RwDoM55ZeQuI2ADyJhOb2Q: bets $32
6hvg964TSqZ3AL/0XK9aVQ: folds
RwDoM55ZeQuI2ADyJhOb2Q collected $27.50 from pot
RwDoM55ZeQuI2ADyJhOb2Q: doesn't show hand
*** SUMMARY ***
Total pot $28 | Rake $0.50
Board [6d 9h 4h 5c]
Seat 1: 6hvg964TSqZ3AL/0XK9aVQ (big blind) folded on the Turn
Seat 2: RwDoM55ZeQuI2ADyJhOb2Q (button) (small blind) collected ($27.50)



PokerStars Game #59938393134:  Hold'em No Limit ($1/$2) - 2009/07/01 0:13:54 ET
Table 'G1Oqdy4Pqdb5gtx40rUBzA' 6-max Seat #2 is the button
Seat 1: QCqxb/MXSq5RKfPtjBjiBA ($135.60 in chips)
Seat 2: IzslX/oV8DoDQfxCV/3+kg ($363.75 in chips)
Seat 3: lE+RUsc9cdVV9eEi8uytew ($88 in chips)
Seat 4: B87ikIyZ/TzAVeXf38Ny0g ($200 in chips)
Seat 5: X7GlkHF+lkbarCLuZ4Uf0w ($78 in chips)
Seat 6: gGPaCoSWW1HoKYaqfAPecg ($200 in chips)
lE+RUsc9cdVV9eEi8uytew: posts small blind $1
B87ikIyZ/TzAVeXf38Ny0g: posts big blind $2
*** HOLE CARDS ***
X7GlkHF+lkbarCLuZ4Uf0w: folds
gGPaCoSWW1HoKYaqfAPecg: folds
QCqxb/MXSq5RKfPtjBjiBA: folds
IzslX/oV8DoDQfxCV/3+kg: folds
lE+RUsc9cdVV9eEi8uytew: raises $6 to $8
B87ikIyZ/TzAVeXf38Ny0g: folds
lE+RUsc9cdVV9eEi8uytew collected $4 from pot
*** SUMMARY ***
Total pot $4 | Rake $0
Seat 1: QCqxb/MXSq5RKfPtjBjiBA folded before Flop (didn't bet)
Seat 2: IzslX/oV8DoDQfxCV/3+kg (button) folded before Flop (didn't bet)
Seat 3: lE+RUsc9cdVV9eEi8uytew (small blind) collected ($4)
Seat 4: B87ikIyZ/TzAVeXf38Ny0g (big blind) folded before Flop
Seat 5: X7GlkHF+lkbarCLuZ4Uf0w folded before Flop (didn't bet)
Seat 6: gGPaCoSWW1HoKYaqfAPecg folded before Flop (didn't bet)



PokerStars Game #59938393028:  Hold'em No Limit ($1/$2) - 2009/07/01 0:13:54 ET
Table 'on4i1U1lCRmxsduFD3xiSg' 9-max Seat #4 is the button
Seat 1: so5k3vFDmokh2q3dImJ1GQ ($118 in chips)
Seat 2: yZYrOeNDxQxkzpbgKX1bng ($66.65 in chips)
Seat 3: 5iPk5MyO3KVu18Y8XCYfFQ ($61.20 in chips)
Seat 4: Z3aYCZG/yXHYFjiWkGI5ug ($527.10 in chips)
Seat 5: QHxJjpVYwitg9krW6wZgJA ($200 in chips)
Seat 6: CUZwDpLTQKhzarPe+JCLOQ ($200 in chips)
Seat 7: xD4ElYxz6Ollzmam8BmMCw ($169.25 in chips)
Seat 8: cdC54j9fGGojcbzWB5PgzA ($200 in chips)
Seat 9: iMe5yhc+1BaiIPHet3NMrA ($200 in chips)
QHxJjpVYwitg9krW6wZgJA: posts small blind $1
CUZwDpLTQKhzarPe+JCLOQ: posts big blind $2
*** HOLE CARDS ***
xD4ElYxz6Ollzmam8BmMCw: folds
cdC54j9fGGojcbzWB5PgzA: folds
iMe5yhc+1BaiIPHet3NMrA: folds
so5k3vFDmokh2q3dImJ1GQ: folds
yZYrOeNDxQxkzpbgKX1bng: folds
5iPk5MyO3KVu18Y8XCYfFQ: folds
Z3aYCZG/yXHYFjiWkGI5ug: raises $4 to $6
QHxJjpVYwitg9krW6wZgJA: folds
CUZwDpLTQKhzarPe+JCLOQ: folds
Z3aYCZG/yXHYFjiWkGI5ug collected $5 from pot
*** SUMMARY ***
Total pot $5 | Rake $0
Seat 1: so5k3vFDmokh2q3dImJ1GQ folded before Flop (didn't bet)
Seat 2: yZYrOeNDxQxkzpbgKX1bng folded before Flop (didn't bet)
Seat 3: 5iPk5MyO3KVu18Y8XCYfFQ folded before Flop (didn't bet)
Seat 4: Z3aYCZG/yXHYFjiWkGI5ug (button) collected ($5)
Seat 5: QHxJjpVYwitg9krW6wZgJA (small blind) folded before Flop
Seat 6: CUZwDpLTQKhzarPe+JCLOQ (big blind) folded before Flop
Seat 7: xD4ElYxz6Ollzmam8BmMCw folded before Flop (didn't bet)
Seat 8: cdC54j9fGGojcbzWB5PgzA folded before Flop (didn't bet)
Seat 9: iMe5yhc+1BaiIPHet3NMrA folded before Flop (didn't bet)



PokerStars Game #59938394026:  Hold'em No Limit ($1/$2) - 2009/07/01 0:13:55 ET
Table 'eyAQSIlgc2o1Jxvbve4WGg' 9-max Seat #9 is the button
Seat 1: Q3uFdu6ztesjDFiqkagTRQ ($233 in chips)
Seat 3: TAfo4veNRaRlzDXMMYS3Jg ($37 in chips)
Seat 5: JnV3SM2D6dAFYyGZHHpvrg ($100 in chips)
Seat 6: IikcENBHwoT7snSvBPSc7Q ($182.60 in chips)
Seat 7: QHxJjpVYwitg9krW6wZgJA ($200 in chips)
Seat 8: 5iPk5MyO3KVu18Y8XCYfFQ ($38.60 in chips)
Seat 9: Hc2itIxwbi1lwa+DAYYQGg ($52.85 in chips)
Q3uFdu6ztesjDFiqkagTRQ: posts small blind $1
TAfo4veNRaRlzDXMMYS3Jg: posts big blind $2
*** HOLE CARDS ***
JnV3SM2D6dAFYyGZHHpvrg: folds
IikcENBHwoT7snSvBPSc7Q: folds
QHxJjpVYwitg9krW6wZgJA: folds
5iPk5MyO3KVu18Y8XCYfFQ: folds
Hc2itIxwbi1lwa+DAYYQGg: folds
Q3uFdu6ztesjDFiqkagTRQ: folds
TAfo4veNRaRlzDXMMYS3Jg collected $2 from pot
TAfo4veNRaRlzDXMMYS3Jg: doesn't show hand
*** SUMMARY ***
Total pot $2 | Rake $0
Seat 1: Q3uFdu6ztesjDFiqkagTRQ (small blind) folded before Flop
Seat 3: TAfo4veNRaRlzDXMMYS3Jg (big blind) collected ($2)
Seat 5: JnV3SM2D6dAFYyGZHHpvrg folded before Flop (didn't bet)
Seat 6: IikcENBHwoT7snSvBPSc7Q folded before Flop (didn't bet)
Seat 7: QHxJjpVYwitg9krW6wZgJA folded before Flop (didn't bet)
Seat 8: 5iPk5MyO3KVu18Y8XCYfFQ folded before Flop (didn't bet)
Seat 9: Hc2itIxwbi1lwa+DAYYQGg (button) folded before Flop (didn't bet)



PokerStars Game #59938394530:  Hold'em No Limit ($1/$2) - 2009/07/01 0:13:56 ET
Table 'mGpP9StWRnoeiBDExc6Frg' 6-max Seat #3 is the button
Seat 1: zWFU82nxIRvzK4mKiL4m0Q ($55.15 in chips)
Seat 3: 3HrFUl+TAqSP1U00zz3P7A ($175.60 in chips)
Seat 4: qXDd0ZyMIse0OBu8pxeQ3Q ($216 in chips)
Seat 5: d1puGuVBE0fidn+5eRJ0tw ($178 in chips)
Seat 6: X7GlkHF+lkbarCLuZ4Uf0w ($34.45 in chips)
qXDd0ZyMIse0OBu8pxeQ3Q: posts small blind $1
d1puGuVBE0fidn+5eRJ0tw: posts big blind $2
DQlskgG4OtLpF2MVxLwf4A: sits out
*** HOLE CARDS ***
X7GlkHF+lkbarCLuZ4Uf0w: folds
zWFU82nxIRvzK4mKiL4m0Q: folds
3HrFUl+TAqSP1U00zz3P7A: folds
qXDd0ZyMIse0OBu8pxeQ3Q: folds
d1puGuVBE0fidn+5eRJ0tw collected $2 from pot
d1puGuVBE0fidn+5eRJ0tw: doesn't show hand
*** SUMMARY ***
Total pot $2 | Rake $0
Seat 1: zWFU82nxIRvzK4mKiL4m0Q folded before Flop (didn't bet)
Seat 3: 3HrFUl+TAqSP1U00zz3P7A (button) folded before Flop (didn't bet)
Seat 4: qXDd0ZyMIse0OBu8pxeQ3Q (small blind) folded before Flop
Seat 5: d1puGuVBE0fidn+5eRJ0tw (big blind) collected ($2)
Seat 6: X7GlkHF+lkbarCLuZ4Uf0w folded before Flop (didn't bet)



PokerStars Game #59938394614:  Hold'em No Limit ($1/$2) - 2009/07/01 0:13:56 ET
Table 'jlrIxbrVIG+gjaUYT4za8g' 6-max Seat #3 is the button
Seat 1: ygTTt5ehT4aF86q1a8/R+w ($196.05 in chips)
Seat 2: N18PrNGQj43J7TJuQuu+tw ($127.80 in chips)
Seat 3: 54yWzRRgS0oZ+S6LwZBxMQ ($40.80 in chips)
Seat 4: 8srN1dKQePlsv0GyTada+Q ($206.35 in chips)
Seat 6: vkfxu8f/jMYKUk6Ly4eujw ($282.95 in chips)
8srN1dKQePlsv0GyTada+Q: posts small blind $1
vkfxu8f/jMYKUk6Ly4eujw: posts big blind $2
*** HOLE CARDS ***
ygTTt5ehT4aF86q1a8/R+w: folds
N18PrNGQj43J7TJuQuu+tw: calls $2
54yWzRRgS0oZ+S6LwZBxMQ: folds
8srN1dKQePlsv0GyTada+Q: folds
vkfxu8f/jMYKUk6Ly4eujw: checks
*** FLOP *** [5d Kc 4d]
vkfxu8f/jMYKUk6Ly4eujw: checks
N18PrNGQj43J7TJuQuu+tw: bets $4
vkfxu8f/jMYKUk6Ly4eujw: folds
N18PrNGQj43J7TJuQuu+tw collected $4.75 from pot
*** SUMMARY ***
Total pot $5 | Rake $0.25
Board [5d Kc 4d]
Seat 1: ygTTt5ehT4aF86q1a8/R+w folded before Flop (didn't bet)
Seat 2: N18PrNGQj43J7TJuQuu+tw collected ($4.75)
Seat 3: 54yWzRRgS0oZ+S6LwZBxMQ (button) folded before Flop (didn't bet)
Seat 4: 8srN1dKQePlsv0GyTada+Q (small blind) folded before Flop
Seat 6: vkfxu8f/jMYKUk6Ly4eujw (big blind) folded on the Flop



PokerStars Game #59938398182:  Hold'em No Limit ($1/$2) - 2009/07/01 0:14:01 ET
Table 'HxRHVC7PeqC33y4Kt+aXWg' 2-max Seat #2 is the button
Seat 1: x8INLjfrAPdSY3gjU4zJhw ($408 in chips)
Seat 2: mgi+mjKb1Sc3CCs7TlfoCw ($61.50 in chips)
mgi+mjKb1Sc3CCs7TlfoCw: posts small blind $1
x8INLjfrAPdSY3gjU4zJhw: posts big blind $2
*** HOLE CARDS ***
mgi+mjKb1Sc3CCs7TlfoCw: raises $18 to $20
x8INLjfrAPdSY3gjU4zJhw: folds
mgi+mjKb1Sc3CCs7TlfoCw collected $4 from pot
mgi+mjKb1Sc3CCs7TlfoCw: doesn't show hand
*** SUMMARY ***
Total pot $4 | Rake $0
Seat 1: x8INLjfrAPdSY3gjU4zJhw (big blind) folded before Flop
Seat 2: mgi+mjKb1Sc3CCs7TlfoCw (button) (small blind) collected ($4)



PokerStars Game #59938399974:  Hold'em No Limit ($1/$2) - 2009/07/01 0:14:04 ET
Table 'RF+CoNlqGlniDSszIP2SGw' 2-max Seat #1 is the button
Seat 1: e0oDWyrmgLpR6bROEqw1nQ ($301.95 in chips)
Seat 2: jKzajniHFCiIQAQeNkmTGg ($311.70 in chips)
e0oDWyrmgLpR6bROEqw1nQ: posts small blind $1
jKzajniHFCiIQAQeNkmTGg: posts big blind $2
*** HOLE CARDS ***
e0oDWyrmgLpR6bROEqw1nQ: raises $4 to $6
jKzajniHFCiIQAQeNkmTGg: folds
jKzajniHFCiIQAQeNkmTGg is sitting out
e0oDWyrmgLpR6bROEqw1nQ collected $4 from pot
*** SUMMARY ***
Total pot $4 | Rake $0
Seat 1: e0oDWyrmgLpR6bROEqw1nQ (button) (small blind) collected ($4)
Seat 2: jKzajniHFCiIQAQeNkmTGg (big blind) folded before Flop



PokerStars Game #59938402032:  Hold'em No Limit ($1/$2) - 2009/07/01 0:14:07 ET
Table 'aSf77Sj8QEnzcc0WaxVD4Q' 6-max Seat #4 is the button
Seat 1: Q3uFdu6ztesjDFiqkagTRQ ($246.20 in chips)
Seat 2: vkfxu8f/jMYKUk6Ly4eujw ($242.75 in chips)
Seat 3: 9dpyyjDTCed6nV7JhaUUpw ($200 in chips)
Seat 4: 513FcCI8jHyQy2VWoIQkMg ($201.75 in chips)
Seat 5: InmkdI6G8TzSj9NhcCSyPg ($248 in chips)
Seat 6: vkoJRf3gidxY1pPi0AFWww ($310.60 in chips)
InmkdI6G8TzSj9NhcCSyPg: posts small blind $1
vkoJRf3gidxY1pPi0AFWww: posts big blind $2
*** HOLE CARDS ***
Q3uFdu6ztesjDFiqkagTRQ: folds
vkfxu8f/jMYKUk6Ly4eujw: folds
9dpyyjDTCed6nV7JhaUUpw: folds
513FcCI8jHyQy2VWoIQkMg: raises $4 to $6
InmkdI6G8TzSj9NhcCSyPg: folds
vkoJRf3gidxY1pPi0AFWww: raises $18 to $24
513FcCI8jHyQy2VWoIQkMg: folds
vkoJRf3gidxY1pPi0AFWww collected $13 from pot
vkoJRf3gidxY1pPi0AFWww: doesn't show hand
*** SUMMARY ***
Total pot $13 | Rake $0
Seat 1: Q3uFdu6ztesjDFiqkagTRQ folded before Flop (didn't bet)
Seat 2: vkfxu8f/jMYKUk6Ly4eujw folded before Flop (didn't bet)
Seat 3: 9dpyyjDTCed6nV7JhaUUpw folded before Flop (didn't bet)
Seat 4: 513FcCI8jHyQy2VWoIQkMg (button) folded before Flop
Seat 5: InmkdI6G8TzSj9NhcCSyPg (small blind) folded before Flop
Seat 6: vkoJRf3gidxY1pPi0AFWww (big blind) collected ($13)



PokerStars Game #59938407094:  Hold'em No Limit ($1/$2) - 2009/07/01 0:14:14 ET
Table 'bIihwBANJSFqlHPPtset+w' 9-max Seat #4 is the button
Seat 1: jI3JDUGV63ccqtKgM3vMbw ($140.60 in chips)
Seat 2: lQYT23h5QCUVZAKxjOO39Q ($125.90 in chips)
Seat 3: acnZ0LD5jxKgWIHz+mpQ8Q ($226.25 in chips)
Seat 4: 7WWX5PClBdr/U44gUKBIEA ($296.05 in chips)
Seat 6: 5iPk5MyO3KVu18Y8XCYfFQ ($40 in chips)
Seat 7: 3q2/0oJr3Mcy1W5tcN61ug ($200 in chips)
Seat 8: iMe5yhc+1BaiIPHet3NMrA ($281.65 in chips)
Seat 9: rW/MyplHylMSBRaoRUzWrg ($34.55 in chips)
5iPk5MyO3KVu18Y8XCYfFQ: posts small blind $1
3q2/0oJr3Mcy1W5tcN61ug: posts big blind $2
*** HOLE CARDS ***
iMe5yhc+1BaiIPHet3NMrA: folds
rW/MyplHylMSBRaoRUzWrg: raises $6 to $8
jI3JDUGV63ccqtKgM3vMbw: calls $8
lQYT23h5QCUVZAKxjOO39Q: folds
acnZ0LD5jxKgWIHz+mpQ8Q: folds
7WWX5PClBdr/U44gUKBIEA: folds
5iPk5MyO3KVu18Y8XCYfFQ: folds
3q2/0oJr3Mcy1W5tcN61ug: folds
*** FLOP *** [Kd 5s 6c]
rW/MyplHylMSBRaoRUzWrg: bets $10
jI3JDUGV63ccqtKgM3vMbw: raises $30 to $40
rW/MyplHylMSBRaoRUzWrg: folds
jI3JDUGV63ccqtKgM3vMbw collected $37.10 from pot
*** SUMMARY ***
Total pot $39 | Rake $1.90
Board [Kd 5s 6c]
Seat 1: jI3JDUGV63ccqtKgM3vMbw collected ($37.10)
Seat 2: lQYT23h5QCUVZAKxjOO39Q folded before Flop (didn't bet)
Seat 3: acnZ0LD5jxKgWIHz+mpQ8Q folded before Flop (didn't bet)
Seat 4: 7WWX5PClBdr/U44gUKBIEA (button) folded before Flop (didn't bet)
Seat 6: 5iPk5MyO3KVu18Y8XCYfFQ (small blind) folded before Flop
Seat 7: 3q2/0oJr3Mcy1W5tcN61ug (big blind) folded before Flop
Seat 8: iMe5yhc+1BaiIPHet3NMrA folded before Flop (didn't bet)
Seat 9: rW/MyplHylMSBRaoRUzWrg folded on the Flop



PokerStars Game #59938407746:  Hold'em No Limit ($1/$2) - 2009/07/01 0:14:15 ET
Table 'qVXak+oTeDXMGbWa4sDU5Q' 9-max Seat #4 is the button
Seat 1: H6Z4+qu8gR0VUiPOijndVg ($254.30 in chips)
Seat 2: Hc2itIxwbi1lwa+DAYYQGg ($46 in chips)
Seat 3: oz9eCXGC7DdjQlL/nuWj1A ($100.60 in chips)
Seat 4: b0jO1SDhLedy1//CQlA8kw ($40 in chips)
Seat 5: NqKRc5xvcye0d7F6VOF6MQ ($58 in chips)
Seat 6: Q3uFdu6ztesjDFiqkagTRQ ($200 in chips)
Seat 7: 5iPk5MyO3KVu18Y8XCYfFQ ($115 in chips)
Seat 8: 9pHZMviI9R8injxojGTnvw ($115.80 in chips)
Seat 9: IZ/2qsh1CIg9m5PWsMsLmA ($351.95 in chips)
NqKRc5xvcye0d7F6VOF6MQ: posts small blind $1
Q3uFdu6ztesjDFiqkagTRQ: posts big blind $2
*** HOLE CARDS ***
5iPk5MyO3KVu18Y8XCYfFQ: folds
9pHZMviI9R8injxojGTnvw: folds
IZ/2qsh1CIg9m5PWsMsLmA: folds
H6Z4+qu8gR0VUiPOijndVg: folds
Hc2itIxwbi1lwa+DAYYQGg: folds
oz9eCXGC7DdjQlL/nuWj1A: folds
b0jO1SDhLedy1//CQlA8kw: raises $4 to $6
NqKRc5xvcye0d7F6VOF6MQ: calls $5
Q3uFdu6ztesjDFiqkagTRQ: folds
*** FLOP *** [Jd Jh Qc]
NqKRc5xvcye0d7F6VOF6MQ: checks
b0jO1SDhLedy1//CQlA8kw: bets $7
NqKRc5xvcye0d7F6VOF6MQ: calls $7
*** TURN *** [Jd Jh Qc] [8d]
NqKRc5xvcye0d7F6VOF6MQ: checks
b0jO1SDhLedy1//CQlA8kw: checks
*** RIVER *** [Jd Jh Qc 8d] [9s]
NqKRc5xvcye0d7F6VOF6MQ: bets $12
b0jO1SDhLedy1//CQlA8kw: calls $12
*** SHOW DOWN ***
NqKRc5xvcye0d7F6VOF6MQ: shows [Td Tc] (a straight, Eight to Queen)
b0jO1SDhLedy1//CQlA8kw: mucks hand
NqKRc5xvcye0d7F6VOF6MQ collected $49.50 from pot
*** SUMMARY ***
Total pot $52 | Rake $2.50
Board [Jd Jh Qc 8d 9s]
Seat 1: H6Z4+qu8gR0VUiPOijndVg folded before Flop (didn't bet)
Seat 2: Hc2itIxwbi1lwa+DAYYQGg folded before Flop (didn't bet)
Seat 3: oz9eCXGC7DdjQlL/nuWj1A folded before Flop (didn't bet)
Seat 4: b0jO1SDhLedy1//CQlA8kw (button) mucked
Seat 5: NqKRc5xvcye0d7F6VOF6MQ (small blind) showed [Td Tc] and won ($49.50) with a straight, Eight to Queen
Seat 6: Q3uFdu6ztesjDFiqkagTRQ (big blind) folded before Flop
Seat 7: 5iPk5MyO3KVu18Y8XCYfFQ folded before Flop (didn't bet)
Seat 8: 9pHZMviI9R8injxojGTnvw folded before Flop (didn't bet)
Seat 9: IZ/2qsh1CIg9m5PWsMsLmA folded before Flop (didn't bet)



PokerStars Game #59938407336:  Hold'em No Limit ($1/$2) - 2009/07/01 0:14:15 ET
Table 'NmY84NAf9Mh0ckAckHnh5g' 2-max Seat #1 is the button
Seat 1: 6hvg964TSqZ3AL/0XK9aVQ ($353.75 in chips)
Seat 2: RwDoM55ZeQuI2ADyJhOb2Q ($234.35 in chips)
6hvg964TSqZ3AL/0XK9aVQ: posts small blind $1
RwDoM55ZeQuI2ADyJhOb2Q: posts big blind $2
*** HOLE CARDS ***
6hvg964TSqZ3AL/0XK9aVQ: folds
RwDoM55ZeQuI2ADyJhOb2Q collected $2 from pot
RwDoM55ZeQuI2ADyJhOb2Q: doesn't show hand
*** SUMMARY ***
Total pot $2 | Rake $0
Seat 1: 6hvg964TSqZ3AL/0XK9aVQ (button) (small blind) folded before Flop
Seat 2: RwDoM55ZeQuI2ADyJhOb2Q (big blind) collected ($2)



PokerStars Game #59938409974:  Hold'em No Limit ($1/$2) - 2009/07/01 0:14:18 ET
Table 'LL4bDFyhj5hsMpzaDugJZg' 6-max Seat #1 is the button
Seat 1: IBW9lyGsaRmfcbyA/qFfEw ($64.20 in chips)
Seat 2: L3l+A4pJhOAD6HVVFXvVBw ($317.95 in chips)
Seat 3: gGPaCoSWW1HoKYaqfAPecg ($205 in chips)
Seat 4: 8srN1dKQePlsv0GyTada+Q ($268.75 in chips)
Seat 5: HgX0VeqE/dzSXd5BpntRBw ($200 in chips)
L3l+A4pJhOAD6HVVFXvVBw: posts small blind $1
gGPaCoSWW1HoKYaqfAPecg: posts big blind $2
*** HOLE CARDS ***
8srN1dKQePlsv0GyTada+Q: folds
yZgdnRylE65JbScQ7qCWgw leaves the table
HgX0VeqE/dzSXd5BpntRBw: folds
/PH6Ffnho4Ysm8S3V/oa+w joins the table at seat #6
IBW9lyGsaRmfcbyA/qFfEw: folds
L3l+A4pJhOAD6HVVFXvVBw: raises $4 to $6
gGPaCoSWW1HoKYaqfAPecg: folds
L3l+A4pJhOAD6HVVFXvVBw collected $4 from pot
*** SUMMARY ***
Total pot $4 | Rake $0
Seat 1: IBW9lyGsaRmfcbyA/qFfEw (button) folded before Flop (didn't bet)
Seat 2: L3l+A4pJhOAD6HVVFXvVBw (small blind) collected ($4)
Seat 3: gGPaCoSWW1HoKYaqfAPecg (big blind) folded before Flop
Seat 4: 8srN1dKQePlsv0GyTada+Q folded before Flop (didn't bet)
Seat 5: HgX0VeqE/dzSXd5BpntRBw folded before Flop (didn't bet)



PokerStars Game #59938409356:  Hold'em No Limit ($1/$2) - 2009/07/01 0:14:18 ET
Table 'G1Oqdy4Pqdb5gtx40rUBzA' 6-max Seat #3 is the button
Seat 1: QCqxb/MXSq5RKfPtjBjiBA ($135.60 in chips)
Seat 2: IzslX/oV8DoDQfxCV/3+kg ($363.75 in chips)
Seat 3: lE+RUsc9cdVV9eEi8uytew ($90 in chips)
Seat 4: B87ikIyZ/TzAVeXf38Ny0g ($200 in chips)
Seat 6: gGPaCoSWW1HoKYaqfAPecg ($200 in chips)
B87ikIyZ/TzAVeXf38Ny0g: posts small blind $1
X7GlkHF+lkbarCLuZ4Uf0w: is sitting out
gGPaCoSWW1HoKYaqfAPecg: posts big blind $2
*** HOLE CARDS ***
X7GlkHF+lkbarCLuZ4Uf0w has returned
QCqxb/MXSq5RKfPtjBjiBA: folds
IzslX/oV8DoDQfxCV/3+kg: folds
lE+RUsc9cdVV9eEi8uytew: calls $2
B87ikIyZ/TzAVeXf38Ny0g: folds
gGPaCoSWW1HoKYaqfAPecg: checks
*** FLOP *** [9c Js 4d]
gGPaCoSWW1HoKYaqfAPecg: checks
lE+RUsc9cdVV9eEi8uytew: bets $6
gGPaCoSWW1HoKYaqfAPecg: folds
lE+RUsc9cdVV9eEi8uytew collected $4.75 from pot
*** SUMMARY ***
Total pot $5 | Rake $0.25
Board [9c Js 4d]
Seat 1: QCqxb/MXSq5RKfPtjBjiBA folded before Flop (didn't bet)
Seat 2: IzslX/oV8DoDQfxCV/3+kg folded before Flop (didn't bet)
Seat 3: lE+RUsc9cdVV9eEi8uytew (button) collected ($4.75)
Seat 4: B87ikIyZ/TzAVeXf38Ny0g (small blind) folded before Flop
Seat 6: gGPaCoSWW1HoKYaqfAPecg (big blind) folded on the Flop



PokerStars Game #59938410988:  Hold'em No Limit ($1/$2) - 2009/07/01 0:14:20 ET
Table 'HxRHVC7PeqC33y4Kt+aXWg' 2-max Seat #1 is the button
Seat 1: x8INLjfrAPdSY3gjU4zJhw ($406 in chips)
Seat 2: mgi+mjKb1Sc3CCs7TlfoCw ($200 in chips)
x8INLjfrAPdSY3gjU4zJhw: posts small blind $1
mgi+mjKb1Sc3CCs7TlfoCw: posts big blind $2
*** HOLE CARDS ***
x8INLjfrAPdSY3gjU4zJhw: raises $4 to $6
mgi+mjKb1Sc3CCs7TlfoCw: folds
x8INLjfrAPdSY3gjU4zJhw collected $4 from pot
x8INLjfrAPdSY3gjU4zJhw: doesn't show hand
*** SUMMARY ***
Total pot $4 | Rake $0
Seat 1: x8INLjfrAPdSY3gjU4zJhw (button) (small blind) collected ($4)
Seat 2: mgi+mjKb1Sc3CCs7TlfoCw (big blind) folded before Flop



PokerStars Game #59938411538:  Hold'em No Limit ($1/$2) - 2009/07/01 0:14:21 ET
Table 'NmY84NAf9Mh0ckAckHnh5g' 2-max Seat #2 is the button
Seat 1: 6hvg964TSqZ3AL/0XK9aVQ ($352.75 in chips)
Seat 2: RwDoM55ZeQuI2ADyJhOb2Q ($235.35 in chips)
RwDoM55ZeQuI2ADyJhOb2Q: posts small blind $1
6hvg964TSqZ3AL/0XK9aVQ: posts big blind $2
*** HOLE CARDS ***
RwDoM55ZeQuI2ADyJhOb2Q: raises $4 to $6
6hvg964TSqZ3AL/0XK9aVQ: calls $4
*** FLOP *** [Jc Qs Jh]
6hvg964TSqZ3AL/0XK9aVQ: checks
RwDoM55ZeQuI2ADyJhOb2Q: bets $8
6hvg964TSqZ3AL/0XK9aVQ: folds
RwDoM55ZeQuI2ADyJhOb2Q collected $11.50 from pot
RwDoM55ZeQuI2ADyJhOb2Q: doesn't show hand
*** SUMMARY ***
Total pot $12 | Rake $0.50
Board [Jc Qs Jh]
Seat 1: 6hvg964TSqZ3AL/0XK9aVQ (big blind) folded on the Flop
Seat 2: RwDoM55ZeQuI2ADyJhOb2Q (button) (small blind) collected ($11.50)



PokerStars Game #59938411632:  Hold'em No Limit ($1/$2) - 2009/07/01 0:14:21 ET
Table 'gnHBqWll9O3fxG7Ojkz/ng' 9-max Seat #3 is the button
Seat 1: hpqdC/23wXosGOmzARr5NA ($152.05 in chips)
Seat 2: H6Z4+qu8gR0VUiPOijndVg ($200 in chips)
Seat 3: 5Q8U6iZbeO7xJSS4qvDP5g ($215.60 in chips)
Seat 4: n5XI5/7gN+gIubHFBH+mOw ($410.15 in chips)
Seat 5: rBQDMkKm9cZn6M9NPsiVew ($120 in chips)
Seat 6: 5iPk5MyO3KVu18Y8XCYfFQ ($52.45 in chips)
Seat 8: De9g+AYjo0DN6C/+iT/nsg ($244.05 in chips)
Seat 9: kVCeGJ4NY7Fb0W74j1mAqA ($206 in chips)
n5XI5/7gN+gIubHFBH+mOw: posts small blind $1
rBQDMkKm9cZn6M9NPsiVew: posts big blind $2
*** HOLE CARDS ***
5iPk5MyO3KVu18Y8XCYfFQ: folds
De9g+AYjo0DN6C/+iT/nsg: raises $4 to $6
kVCeGJ4NY7Fb0W74j1mAqA: folds
hpqdC/23wXosGOmzARr5NA: folds
H6Z4+qu8gR0VUiPOijndVg: folds
5Q8U6iZbeO7xJSS4qvDP5g: folds
n5XI5/7gN+gIubHFBH+mOw: folds
rBQDMkKm9cZn6M9NPsiVew: folds
De9g+AYjo0DN6C/+iT/nsg collected $5 from pot
De9g+AYjo0DN6C/+iT/nsg: doesn't show hand
*** SUMMARY ***
Total pot $5 | Rake $0
Seat 1: hpqdC/23wXosGOmzARr5NA folded before Flop (didn't bet)
Seat 2: H6Z4+qu8gR0VUiPOijndVg folded before Flop (didn't bet)
Seat 3: 5Q8U6iZbeO7xJSS4qvDP5g (button) folded before Flop (didn't bet)
Seat 4: n5XI5/7gN+gIubHFBH+mOw (small blind) folded before Flop
Seat 5: rBQDMkKm9cZn6M9NPsiVew (big blind) folded before Flop
Seat 6: 5iPk5MyO3KVu18Y8XCYfFQ folded before Flop (didn't bet)
Seat 8: De9g+AYjo0DN6C/+iT/nsg collected ($5)
Seat 9: kVCeGJ4NY7Fb0W74j1mAqA folded before Flop (didn't bet)



PokerStars Game #59938412568:  Hold'em No Limit ($1/$2) - 2009/07/01 0:14:22 ET
Table 'WCA60bDA8ecovUgFSIZkTQ' 9-max Seat #1 is the button
Seat 1: CUZwDpLTQKhzarPe+JCLOQ ($211.75 in chips)
Seat 2: G1h8wamBcVJXtsKXZQ2EyA ($99.40 in chips)
Seat 3: 5iPk5MyO3KVu18Y8XCYfFQ ($37 in chips)
Seat 4: Q3uFdu6ztesjDFiqkagTRQ ($464.70 in chips)
Seat 5: Hc2itIxwbi1lwa+DAYYQGg ($306.30 in chips)
Seat 6: DOWQSOJ7GaX+ksfWTqPT5A ($248.75 in chips)
Seat 7: 2YpnxJiexJHyERfbqgwEcw ($60 in chips)
Seat 8: x+V1JgVDawsJTxKcxm7gxw ($70.05 in chips)
Seat 9: 3q2/0oJr3Mcy1W5tcN61ug ($294.20 in chips)
G1h8wamBcVJXtsKXZQ2EyA: posts small blind $1
5iPk5MyO3KVu18Y8XCYfFQ: posts big blind $2
2YpnxJiexJHyERfbqgwEcw: posts big blind $2
*** HOLE CARDS ***
Q3uFdu6ztesjDFiqkagTRQ: folds
Hc2itIxwbi1lwa+DAYYQGg: folds
DOWQSOJ7GaX+ksfWTqPT5A: raises $4 to $6
2YpnxJiexJHyERfbqgwEcw: folds
x+V1JgVDawsJTxKcxm7gxw: raises $12 to $18
3q2/0oJr3Mcy1W5tcN61ug: folds
CUZwDpLTQKhzarPe+JCLOQ: folds
G1h8wamBcVJXtsKXZQ2EyA: folds
5iPk5MyO3KVu18Y8XCYfFQ: folds
DOWQSOJ7GaX+ksfWTqPT5A: calls $12
*** FLOP *** [6c Tc 6s]
DOWQSOJ7GaX+ksfWTqPT5A: checks
x+V1JgVDawsJTxKcxm7gxw: bets $52.05 and is all-in
DOWQSOJ7GaX+ksfWTqPT5A: folds
x+V1JgVDawsJTxKcxm7gxw collected $38.95 from pot
x+V1JgVDawsJTxKcxm7gxw: doesn't show hand
*** SUMMARY ***
Total pot $41 | Rake $2.05
Board [6c Tc 6s]
Seat 1: CUZwDpLTQKhzarPe+JCLOQ (button) folded before Flop (didn't bet)
Seat 2: G1h8wamBcVJXtsKXZQ2EyA (small blind) folded before Flop
Seat 3: 5iPk5MyO3KVu18Y8XCYfFQ (big blind) folded before Flop
Seat 4: Q3uFdu6ztesjDFiqkagTRQ folded before Flop (didn't bet)
Seat 5: Hc2itIxwbi1lwa+DAYYQGg folded before Flop (didn't bet)
Seat 6: DOWQSOJ7GaX+ksfWTqPT5A folded on the Flop
Seat 7: 2YpnxJiexJHyERfbqgwEcw folded before Flop
Seat 8: x+V1JgVDawsJTxKcxm7gxw collected ($38.95)
Seat 9: 3q2/0oJr3Mcy1W5tcN61ug folded before Flop (didn't bet)



PokerStars Game #59938413220:  Hold'em No Limit ($1/$2) - 2009/07/01 0:14:23 ET
Table 'SF49/KQm8T4taMp6kb+HXA' 9-max Seat #9 is the button
Seat 1: l1bCLGuFqeFRwUfPsiDu/g ($174.95 in chips)
Seat 2: 8Z3QifiM9eOd5EIJ25dXNg ($103.35 in chips)
Seat 4: HffgoYm61KgkdMe/DYChIQ ($34 in chips)
Seat 5: Z3aYCZG/yXHYFjiWkGI5ug ($226.55 in chips)
Seat 6: M2ht6rIKOI/my9eh610Nlw ($262.40 in chips)
Seat 7: n2VAbLaE5qgKr5mA4W6v4w ($51.50 in chips)
Seat 8: 5iPk5MyO3KVu18Y8XCYfFQ ($43 in chips)
Seat 9: O+jytCilwk7zItVCEavmtw ($128.20 in chips)
l1bCLGuFqeFRwUfPsiDu/g: posts small blind $1
8Z3QifiM9eOd5EIJ25dXNg: posts big blind $2
*** HOLE CARDS ***
HffgoYm61KgkdMe/DYChIQ: raises $2 to $4
Z3aYCZG/yXHYFjiWkGI5ug: folds
M2ht6rIKOI/my9eh610Nlw: raises $2 to $6
n2VAbLaE5qgKr5mA4W6v4w: calls $6
5iPk5MyO3KVu18Y8XCYfFQ: folds
O+jytCilwk7zItVCEavmtw: folds
l1bCLGuFqeFRwUfPsiDu/g: calls $5
8Z3QifiM9eOd5EIJ25dXNg: folds
HffgoYm61KgkdMe/DYChIQ: calls $2
*** FLOP *** [5d 7c 7h]
l1bCLGuFqeFRwUfPsiDu/g: checks
HffgoYm61KgkdMe/DYChIQ: checks
M2ht6rIKOI/my9eh610Nlw: bets $2
n2VAbLaE5qgKr5mA4W6v4w: calls $2
l1bCLGuFqeFRwUfPsiDu/g: calls $2
HffgoYm61KgkdMe/DYChIQ: calls $2
*** TURN *** [5d 7c 7h] [2d]
l1bCLGuFqeFRwUfPsiDu/g: checks
HffgoYm61KgkdMe/DYChIQ: checks
M2ht6rIKOI/my9eh610Nlw: bets $38
n2VAbLaE5qgKr5mA4W6v4w: folds
l1bCLGuFqeFRwUfPsiDu/g: folds
HffgoYm61KgkdMe/DYChIQ: calls $26 and is all-in
*** RIVER *** [5d 7c 7h 2d] [Jh]
*** SHOW DOWN ***
HffgoYm61KgkdMe/DYChIQ: shows [2c Ad] (two pair, Sevens and Deuces)
M2ht6rIKOI/my9eh610Nlw: mucks hand
HffgoYm61KgkdMe/DYChIQ collected $83 from pot
*** SUMMARY ***
Total pot $86 | Rake $3
Board [5d 7c 7h 2d Jh]
Seat 1: l1bCLGuFqeFRwUfPsiDu/g (small blind) folded on the Turn
Seat 2: 8Z3QifiM9eOd5EIJ25dXNg (big blind) folded before Flop
Seat 4: HffgoYm61KgkdMe/DYChIQ showed [2c Ad] and won ($83) with two pair, Sevens and Deuces
Seat 5: Z3aYCZG/yXHYFjiWkGI5ug folded before Flop (didn't bet)
Seat 6: M2ht6rIKOI/my9eh610Nlw mucked
Seat 7: n2VAbLaE5qgKr5mA4W6v4w folded on the Turn
Seat 8: 5iPk5MyO3KVu18Y8XCYfFQ folded before Flop (didn't bet)
Seat 9: O+jytCilwk7zItVCEavmtw (button) folded before Flop (didn't bet)



PokerStars Game #59938413672:  Hold'em No Limit ($1/$2) - 2009/07/01 0:14:24 ET
Table '3FGoiEOffWrbgTfsB3t7FA' 2-max Seat #2 is the button
Seat 1: e0oDWyrmgLpR6bROEqw1nQ ($264.50 in chips)
Seat 2: +sy/nlNI20yZraIjs4AALg ($336.15 in chips)
+sy/nlNI20yZraIjs4AALg: posts small blind $1
e0oDWyrmgLpR6bROEqw1nQ: posts big blind $2
*** HOLE CARDS ***
+sy/nlNI20yZraIjs4AALg: calls $1
e0oDWyrmgLpR6bROEqw1nQ: checks
*** FLOP *** [2s 4s Tc]
e0oDWyrmgLpR6bROEqw1nQ: bets $4
+sy/nlNI20yZraIjs4AALg: calls $4
*** TURN *** [2s 4s Tc] [Qs]
e0oDWyrmgLpR6bROEqw1nQ: checks
+sy/nlNI20yZraIjs4AALg: checks
*** RIVER *** [2s 4s Tc Qs] [8s]
e0oDWyrmgLpR6bROEqw1nQ: checks
+sy/nlNI20yZraIjs4AALg: bets $10
e0oDWyrmgLpR6bROEqw1nQ: folds
+sy/nlNI20yZraIjs4AALg collected $11.50 from pot
*** SUMMARY ***
Total pot $12 | Rake $0.50
Board [2s 4s Tc Qs 8s]
Seat 1: e0oDWyrmgLpR6bROEqw1nQ (big blind) folded on the River
Seat 2: +sy/nlNI20yZraIjs4AALg (button) (small blind) collected ($11.50)



PokerStars Game #59938414512:  Hold'em No Limit ($1/$2) - 2009/07/01 0:14:25 ET
Table 'XP2sRSup+aRuwzx3vDZsDg' 6-max Seat #1 is the button
Seat 1: o9jamqIi6sTTRSqudgboRA ($237.70 in chips)
Seat 3: X7GlkHF+lkbarCLuZ4Uf0w ($38 in chips)
Seat 4: JsC+WvfzqlxVs9G8/gSQAQ ($117.05 in chips)
Seat 6: h7ppRQJTYBsHCbLMeW9T2g ($484.75 in chips)
X7GlkHF+lkbarCLuZ4Uf0w: posts small blind $1
JsC+WvfzqlxVs9G8/gSQAQ: posts big blind $2
*** HOLE CARDS ***
yZgdnRylE65JbScQ7qCWgw leaves the table
894kvCY4GHivBpqwizsecg joins the table at seat #5
h7ppRQJTYBsHCbLMeW9T2g: raises $4 to $6
o9jamqIi6sTTRSqudgboRA: calls $6
X7GlkHF+lkbarCLuZ4Uf0w: raises $32 to $38 and is all-in
JsC+WvfzqlxVs9G8/gSQAQ: folds
h7ppRQJTYBsHCbLMeW9T2g: folds
o9jamqIi6sTTRSqudgboRA: calls $32
*** FLOP *** [6s 9d 5c]
*** TURN *** [6s 9d 5c] [3c]
*** RIVER *** [6s 9d 5c 3c] [7s]
*** SHOW DOWN ***
X7GlkHF+lkbarCLuZ4Uf0w: shows [Jc As] (high card Ace)
o9jamqIi6sTTRSqudgboRA: shows [Jd Ah] (high card Ace)
X7GlkHF+lkbarCLuZ4Uf0w collected $41 from pot
o9jamqIi6sTTRSqudgboRA collected $41 from pot
*** SUMMARY ***
Total pot $84 | Rake $2
Board [6s 9d 5c 3c 7s]
Seat 1: o9jamqIi6sTTRSqudgboRA (button) showed [Jd Ah] and won ($41) with high card Ace
Seat 3: X7GlkHF+lkbarCLuZ4Uf0w (small blind) showed [Jc As] and won ($41) with high card Ace
Seat 4: JsC+WvfzqlxVs9G8/gSQAQ (big blind) folded before Flop
Seat 6: h7ppRQJTYBsHCbLMeW9T2g folded before Flop



PokerStars Game #59938414912:  Hold'em No Limit ($1/$2) - 2009/07/01 0:14:26 ET
Table 'eyAQSIlgc2o1Jxvbve4WGg' 9-max Seat #1 is the button
Seat 1: Q3uFdu6ztesjDFiqkagTRQ ($232 in chips)
Seat 3: TAfo4veNRaRlzDXMMYS3Jg ($38 in chips)
Seat 5: JnV3SM2D6dAFYyGZHHpvrg ($100 in chips)
Seat 6: IikcENBHwoT7snSvBPSc7Q ($182.60 in chips)
Seat 7: QHxJjpVYwitg9krW6wZgJA ($200 in chips)
Seat 8: 5iPk5MyO3KVu18Y8XCYfFQ ($38.60 in chips)
Seat 9: Hc2itIxwbi1lwa+DAYYQGg ($52.85 in chips)
TAfo4veNRaRlzDXMMYS3Jg: posts small blind $1
JnV3SM2D6dAFYyGZHHpvrg: posts big blind $2
*** HOLE CARDS ***
IikcENBHwoT7snSvBPSc7Q: folds
QHxJjpVYwitg9krW6wZgJA: folds
miAHPEBdznuHNzK6YM3hRA joins the table at seat #4
5iPk5MyO3KVu18Y8XCYfFQ: folds
Hc2itIxwbi1lwa+DAYYQGg: folds
Q3uFdu6ztesjDFiqkagTRQ: folds
TAfo4veNRaRlzDXMMYS3Jg: folds
JnV3SM2D6dAFYyGZHHpvrg collected $2 from pot
*** SUMMARY ***
Total pot $2 | Rake $0
Seat 1: Q3uFdu6ztesjDFiqkagTRQ (button) folded before Flop (didn't bet)
Seat 3: TAfo4veNRaRlzDXMMYS3Jg (small blind) folded before Flop
Seat 5: JnV3SM2D6dAFYyGZHHpvrg (big blind) collected ($2)
Seat 6: IikcENBHwoT7snSvBPSc7Q folded before Flop (didn't bet)
Seat 7: QHxJjpVYwitg9krW6wZgJA folded before Flop (didn't bet)
Seat 8: 5iPk5MyO3KVu18Y8XCYfFQ folded before Flop (didn't bet)
Seat 9: Hc2itIxwbi1lwa+DAYYQGg folded before Flop (didn't bet)



PokerStars Game #59938418222:  Hold'em No Limit ($1/$2) - 2009/07/01 0:14:30 ET
Table 'srul5UFZXTEccVV5fpY91g' 9-max Seat #1 is the button
Seat 1: lfD8cBv31A/pio3pXJbPjA ($171.20 in chips)
Seat 2: tJYod1SLp2AcWPL/3hZ7ug ($85.20 in chips)
Seat 3: weUZ8S7tgbaeIpzi1gBNxQ ($51.75 in chips)
Seat 4: GG5lTuGt3+kwNYSbqeB6yw ($81.85 in chips)
Seat 5: 5iPk5MyO3KVu18Y8XCYfFQ ($43.10 in chips)
Seat 6: TAfo4veNRaRlzDXMMYS3Jg ($36 in chips)
Seat 7: s0erZsDxbZSaEPheMgibKg ($480.40 in chips)
tJYod1SLp2AcWPL/3hZ7ug: posts small blind $1
weUZ8S7tgbaeIpzi1gBNxQ: posts big blind $2
*** HOLE CARDS ***
GG5lTuGt3+kwNYSbqeB6yw: calls $2
5iPk5MyO3KVu18Y8XCYfFQ: folds
TAfo4veNRaRlzDXMMYS3Jg: folds
s0erZsDxbZSaEPheMgibKg: folds
lfD8cBv31A/pio3pXJbPjA: folds
tJYod1SLp2AcWPL/3hZ7ug: folds
weUZ8S7tgbaeIpzi1gBNxQ: checks
*** FLOP *** [2c 6d As]
weUZ8S7tgbaeIpzi1gBNxQ: checks
GG5lTuGt3+kwNYSbqeB6yw: bets $2
weUZ8S7tgbaeIpzi1gBNxQ: folds
GG5lTuGt3+kwNYSbqeB6yw collected $4.75 from pot
*** SUMMARY ***
Total pot $5 | Rake $0.25
Board [2c 6d As]
Seat 1: lfD8cBv31A/pio3pXJbPjA (button) folded before Flop (didn't bet)
Seat 2: tJYod1SLp2AcWPL/3hZ7ug (small blind) folded before Flop
Seat 3: weUZ8S7tgbaeIpzi1gBNxQ (big blind) folded on the Flop
Seat 4: GG5lTuGt3+kwNYSbqeB6yw collected ($4.75)
Seat 5: 5iPk5MyO3KVu18Y8XCYfFQ folded before Flop (didn't bet)
Seat 6: TAfo4veNRaRlzDXMMYS3Jg folded before Flop (didn't bet)
Seat 7: s0erZsDxbZSaEPheMgibKg folded before Flop (didn't bet)



PokerStars Game #59938419728:  Hold'em No Limit ($1/$2) - 2009/07/01 0:14:32 ET
Table 'HxRHVC7PeqC33y4Kt+aXWg' 2-max Seat #2 is the button
Seat 1: x8INLjfrAPdSY3gjU4zJhw ($408 in chips)
Seat 2: mgi+mjKb1Sc3CCs7TlfoCw ($198 in chips)
mgi+mjKb1Sc3CCs7TlfoCw: posts small blind $1
x8INLjfrAPdSY3gjU4zJhw: posts big blind $2
*** HOLE CARDS ***
mgi+mjKb1Sc3CCs7TlfoCw: raises $4 to $6
x8INLjfrAPdSY3gjU4zJhw: folds
mgi+mjKb1Sc3CCs7TlfoCw collected $4 from pot
mgi+mjKb1Sc3CCs7TlfoCw: doesn't show hand
*** SUMMARY ***
Total pot $4 | Rake $0
Seat 1: x8INLjfrAPdSY3gjU4zJhw (big blind) folded before Flop
Seat 2: mgi+mjKb1Sc3CCs7TlfoCw (button) (small blind) collected ($4)



PokerStars Game #59938419186:  Hold'em No Limit ($1/$2) - 2009/07/01 0:14:32 ET
Table 'mGpP9StWRnoeiBDExc6Frg' 6-max Seat #4 is the button
Seat 1: zWFU82nxIRvzK4mKiL4m0Q ($55.15 in chips)
Seat 3: 3HrFUl+TAqSP1U00zz3P7A ($175.60 in chips)
Seat 4: qXDd0ZyMIse0OBu8pxeQ3Q ($215 in chips)
Seat 5: d1puGuVBE0fidn+5eRJ0tw ($179 in chips)
Seat 6: X7GlkHF+lkbarCLuZ4Uf0w ($34.45 in chips)
d1puGuVBE0fidn+5eRJ0tw: posts small blind $1
X7GlkHF+lkbarCLuZ4Uf0w: posts big blind $2
DQlskgG4OtLpF2MVxLwf4A: sits out
*** HOLE CARDS ***
zWFU82nxIRvzK4mKiL4m0Q: calls $2
3HrFUl+TAqSP1U00zz3P7A: folds
3HrFUl+TAqSP1U00zz3P7A is sitting out
qXDd0ZyMIse0OBu8pxeQ3Q has timed out
qXDd0ZyMIse0OBu8pxeQ3Q: folds
qXDd0ZyMIse0OBu8pxeQ3Q is sitting out
qXDd0ZyMIse0OBu8pxeQ3Q has returned
d1puGuVBE0fidn+5eRJ0tw: calls $1
X7GlkHF+lkbarCLuZ4Uf0w: checks
*** FLOP *** [Jh 2s 3c]
d1puGuVBE0fidn+5eRJ0tw: bets $2
X7GlkHF+lkbarCLuZ4Uf0w: folds
zWFU82nxIRvzK4mKiL4m0Q: calls $2
*** TURN *** [Jh 2s 3c] [As]
d1puGuVBE0fidn+5eRJ0tw: checks
zWFU82nxIRvzK4mKiL4m0Q: checks
*** RIVER *** [Jh 2s 3c As] [Ac]
d1puGuVBE0fidn+5eRJ0tw: bets $4
zWFU82nxIRvzK4mKiL4m0Q: raises $4 to $8
d1puGuVBE0fidn+5eRJ0tw: calls $4
*** SHOW DOWN ***
zWFU82nxIRvzK4mKiL4m0Q: shows [Ah 9c] (three of a kind, Aces)
d1puGuVBE0fidn+5eRJ0tw: mucks hand
zWFU82nxIRvzK4mKiL4m0Q collected $24.75 from pot
*** SUMMARY ***
Total pot $26 | Rake $1.25
Board [Jh 2s 3c As Ac]
Seat 1: zWFU82nxIRvzK4mKiL4m0Q showed [Ah 9c] and won ($24.75) with three of a kind, Aces
Seat 3: 3HrFUl+TAqSP1U00zz3P7A folded before Flop (didn't bet)
Seat 4: qXDd0ZyMIse0OBu8pxeQ3Q (button) folded before Flop (didn't bet)
Seat 5: d1puGuVBE0fidn+5eRJ0tw (small blind) mucked
Seat 6: X7GlkHF+lkbarCLuZ4Uf0w (big blind) folded on the Flop



PokerStars Game #59938420750:  Hold'em No Limit ($1/$2) - 2009/07/01 0:14:34 ET
Table 'HewZCzVOYGmuLDKthTi5Yw' 6-max Seat #5 is the button
Seat 1: 353332 ($222.95 in chips)
Seat 2: X7GlkHF+lkbarCLuZ4Uf0w ($27 in chips)
Seat 3: WJxW31eStwT28R2X/L8F5A ($40.05 in chips)
Seat 5: 513FcCI8jHyQy2VWoIQkMg ($408.80 in chips)
353332: posts small blind $1
X7GlkHF+lkbarCLuZ4Uf0w: posts big blind $2
*** HOLE CARDS ***
WJxW31eStwT28R2X/L8F5A: folds
513FcCI8jHyQy2VWoIQkMg: raises $4 to $6
353332: calls $5
X7GlkHF+lkbarCLuZ4Uf0w: folds
*** FLOP *** [Ac 2d Tc]
353332: checks
513FcCI8jHyQy2VWoIQkMg: checks
*** TURN *** [Ac 2d Tc] [6d]
353332: bets $11
513FcCI8jHyQy2VWoIQkMg: calls $11
*** RIVER *** [Ac 2d Tc 6d] [8d]
353332: checks
513FcCI8jHyQy2VWoIQkMg: checks
*** SHOW DOWN ***
353332: shows [Qd As] (a pair of Aces)
513FcCI8jHyQy2VWoIQkMg: mucks hand
353332 collected $34.25 from pot
*** SUMMARY ***
Total pot $36 | Rake $1.75
Board [Ac 2d Tc 6d 8d]
Seat 1: 353332 (small blind) showed [Qd As] and won ($34.25) with a pair of Aces
Seat 2: X7GlkHF+lkbarCLuZ4Uf0w (big blind) folded before Flop
Seat 3: WJxW31eStwT28R2X/L8F5A folded before Flop (didn't bet)
Seat 5: 513FcCI8jHyQy2VWoIQkMg (button) mucked



PokerStars Game #59938421556:  Hold'em No Limit ($1/$2) - 2009/07/01 0:14:35 ET
Table 'on4i1U1lCRmxsduFD3xiSg' 9-max Seat #5 is the button
Seat 1: so5k3vFDmokh2q3dImJ1GQ ($118 in chips)
Seat 2: yZYrOeNDxQxkzpbgKX1bng ($66.65 in chips)
Seat 3: 5iPk5MyO3KVu18Y8XCYfFQ ($61.20 in chips)
Seat 4: Z3aYCZG/yXHYFjiWkGI5ug ($530.10 in chips)
Seat 5: QHxJjpVYwitg9krW6wZgJA ($200 in chips)
Seat 6: CUZwDpLTQKhzarPe+JCLOQ ($200 in chips)
Seat 7: xD4ElYxz6Ollzmam8BmMCw ($200 in chips)
Seat 8: cdC54j9fGGojcbzWB5PgzA ($200 in chips)
Seat 9: iMe5yhc+1BaiIPHet3NMrA ($200 in chips)
CUZwDpLTQKhzarPe+JCLOQ: posts small blind $1
xD4ElYxz6Ollzmam8BmMCw: posts big blind $2
*** HOLE CARDS ***
cdC54j9fGGojcbzWB5PgzA: folds
iMe5yhc+1BaiIPHet3NMrA: calls $2
so5k3vFDmokh2q3dImJ1GQ: folds
yZYrOeNDxQxkzpbgKX1bng: folds
5iPk5MyO3KVu18Y8XCYfFQ: folds
Z3aYCZG/yXHYFjiWkGI5ug: folds
QHxJjpVYwitg9krW6wZgJA: folds
CUZwDpLTQKhzarPe+JCLOQ: calls $1
xD4ElYxz6Ollzmam8BmMCw: checks
*** FLOP *** [6c 6h 2c]
CUZwDpLTQKhzarPe+JCLOQ: bets $4
xD4ElYxz6Ollzmam8BmMCw: folds
iMe5yhc+1BaiIPHet3NMrA: raises $8 to $12
CUZwDpLTQKhzarPe+JCLOQ: calls $8
*** TURN *** [6c 6h 2c] [3s]
CUZwDpLTQKhzarPe+JCLOQ: bets $14
iMe5yhc+1BaiIPHet3NMrA: folds
CUZwDpLTQKhzarPe+JCLOQ collected $28.55 from pot
*** SUMMARY ***
Total pot $30 | Rake $1.45
Board [6c 6h 2c 3s]
Seat 1: so5k3vFDmokh2q3dImJ1GQ folded before Flop (didn't bet)
Seat 2: yZYrOeNDxQxkzpbgKX1bng folded before Flop (didn't bet)
Seat 3: 5iPk5MyO3KVu18Y8XCYfFQ folded before Flop (didn't bet)
Seat 4: Z3aYCZG/yXHYFjiWkGI5ug folded before Flop (didn't bet)
Seat 5: QHxJjpVYwitg9krW6wZgJA (button) folded before Flop (didn't bet)
Seat 6: CUZwDpLTQKhzarPe+JCLOQ (small blind) collected ($28.55)
Seat 7: xD4ElYxz6Ollzmam8BmMCw (big blind) folded on the Flop
Seat 8: cdC54j9fGGojcbzWB5PgzA folded before Flop (didn't bet)
Seat 9: iMe5yhc+1BaiIPHet3NMrA folded on the Turn



PokerStars Game #59938421246:  Hold'em No Limit ($1/$2) - 2009/07/01 0:14:35 ET
Table 'NmY84NAf9Mh0ckAckHnh5g' 2-max Seat #1 is the button
Seat 1: 6hvg964TSqZ3AL/0XK9aVQ ($346.75 in chips)
Seat 2: RwDoM55ZeQuI2ADyJhOb2Q ($240.85 in chips)
6hvg964TSqZ3AL/0XK9aVQ: posts small blind $1
RwDoM55ZeQuI2ADyJhOb2Q: posts big blind $2
*** HOLE CARDS ***
6hvg964TSqZ3AL/0XK9aVQ: folds
RwDoM55ZeQuI2ADyJhOb2Q collected $2 from pot
RwDoM55ZeQuI2ADyJhOb2Q: doesn't show hand
*** SUMMARY ***
Total pot $2 | Rake $0
Seat 1: 6hvg964TSqZ3AL/0XK9aVQ (button) (small blind) folded before Flop
Seat 2: RwDoM55ZeQuI2ADyJhOb2Q (big blind) collected ($2)



PokerStars Game #59938421620:  Hold'em No Limit ($1/$2) - 2009/07/01 0:14:35 ET
Table 'aSf77Sj8QEnzcc0WaxVD4Q' 6-max Seat #5 is the button
Seat 1: Q3uFdu6ztesjDFiqkagTRQ ($246.20 in chips)
Seat 2: vkfxu8f/jMYKUk6Ly4eujw ($242.75 in chips)
Seat 3: 9dpyyjDTCed6nV7JhaUUpw ($200 in chips)
Seat 4: 513FcCI8jHyQy2VWoIQkMg ($200 in chips)
Seat 5: InmkdI6G8TzSj9NhcCSyPg ($247 in chips)
Seat 6: vkoJRf3gidxY1pPi0AFWww ($317.60 in chips)
vkoJRf3gidxY1pPi0AFWww: posts small blind $1
Q3uFdu6ztesjDFiqkagTRQ: posts big blind $2
*** HOLE CARDS ***
vkfxu8f/jMYKUk6Ly4eujw has timed out
vkfxu8f/jMYKUk6Ly4eujw: folds
vkfxu8f/jMYKUk6Ly4eujw is sitting out
9dpyyjDTCed6nV7JhaUUpw: folds
513FcCI8jHyQy2VWoIQkMg: folds
InmkdI6G8TzSj9NhcCSyPg: folds
vkoJRf3gidxY1pPi0AFWww: calls $1
vkfxu8f/jMYKUk6Ly4eujw has returned
Q3uFdu6ztesjDFiqkagTRQ: raises $12 to $14
vkoJRf3gidxY1pPi0AFWww: folds
Q3uFdu6ztesjDFiqkagTRQ collected $4 from pot
Q3uFdu6ztesjDFiqkagTRQ: doesn't show hand
*** SUMMARY ***
Total pot $4 | Rake $0
Seat 1: Q3uFdu6ztesjDFiqkagTRQ (big blind) collected ($4)
Seat 2: vkfxu8f/jMYKUk6Ly4eujw folded before Flop (didn't bet)
Seat 3: 9dpyyjDTCed6nV7JhaUUpw folded before Flop (didn't bet)
Seat 4: 513FcCI8jHyQy2VWoIQkMg folded before Flop (didn't bet)
Seat 5: InmkdI6G8TzSj9NhcCSyPg (button) folded before Flop (didn't bet)
Seat 6: vkoJRf3gidxY1pPi0AFWww (small blind) folded before Flop



PokerStars Game #59938425398:  Hold'em No Limit ($1/$2) - 2009/07/01 0:14:40 ET
Table 'NmY84NAf9Mh0ckAckHnh5g' 2-max Seat #2 is the button
Seat 1: 6hvg964TSqZ3AL/0XK9aVQ ($345.75 in chips)
Seat 2: RwDoM55ZeQuI2ADyJhOb2Q ($241.85 in chips)
RwDoM55ZeQuI2ADyJhOb2Q: posts small blind $1
6hvg964TSqZ3AL/0XK9aVQ: posts big blind $2
*** HOLE CARDS ***
RwDoM55ZeQuI2ADyJhOb2Q: raises $4 to $6
6hvg964TSqZ3AL/0XK9aVQ: calls $4
*** FLOP *** [2d 8s 6s]
6hvg964TSqZ3AL/0XK9aVQ: checks
RwDoM55ZeQuI2ADyJhOb2Q: checks
*** TURN *** [2d 8s 6s] [Qd]
6hvg964TSqZ3AL/0XK9aVQ: bets $6
RwDoM55ZeQuI2ADyJhOb2Q: calls $6
*** RIVER *** [2d 8s 6s Qd] [7d]
6hvg964TSqZ3AL/0XK9aVQ: bets $16
RwDoM55ZeQuI2ADyJhOb2Q: folds
6hvg964TSqZ3AL/0XK9aVQ collected $23.50 from pot
6hvg964TSqZ3AL/0XK9aVQ: doesn't show hand
*** SUMMARY ***
Total pot $24 | Rake $0.50
Board [2d 8s 6s Qd 7d]
Seat 1: 6hvg964TSqZ3AL/0XK9aVQ (big blind) collected ($23.50)
Seat 2: RwDoM55ZeQuI2ADyJhOb2Q (button) (small blind) folded on the River



PokerStars Game #59938428322:  Hold'em No Limit ($1/$2) - 2009/07/01 0:14:44 ET
Table 'rsKRKlGHlxVyqJxzO2a2Ow' 9-max Seat #9 is the button
Seat 1: uYWfQJg2hgHLxri6/uVJiw ($123.10 in chips)
Seat 2: QHxJjpVYwitg9krW6wZgJA ($247.50 in chips)
Seat 3: 9sYbXdhj1M2bwKrVNxj5+Q ($107.80 in chips)
Seat 4: zJtQ1gxyi72XvGYS1tM+DA ($178.55 in chips)
Seat 5: 5Q8U6iZbeO7xJSS4qvDP5g ($203 in chips)
Seat 6: H6Z4+qu8gR0VUiPOijndVg ($200 in chips)
Seat 7: kVCeGJ4NY7Fb0W74j1mAqA ($206 in chips)
Seat 8: Hc2itIxwbi1lwa+DAYYQGg ($34 in chips)
Seat 9: 5iPk5MyO3KVu18Y8XCYfFQ ($121 in chips)
uYWfQJg2hgHLxri6/uVJiw: posts small blind $1
QHxJjpVYwitg9krW6wZgJA: posts big blind $2
*** HOLE CARDS ***
9sYbXdhj1M2bwKrVNxj5+Q: folds
zJtQ1gxyi72XvGYS1tM+DA: folds
5Q8U6iZbeO7xJSS4qvDP5g: folds
H6Z4+qu8gR0VUiPOijndVg: folds
kVCeGJ4NY7Fb0W74j1mAqA: folds
Hc2itIxwbi1lwa+DAYYQGg: folds
5iPk5MyO3KVu18Y8XCYfFQ: folds
uYWfQJg2hgHLxri6/uVJiw: calls $1
QHxJjpVYwitg9krW6wZgJA: checks
*** FLOP *** [Kd 3s 7d]
uYWfQJg2hgHLxri6/uVJiw: checks
QHxJjpVYwitg9krW6wZgJA: bets $4
uYWfQJg2hgHLxri6/uVJiw: calls $4
*** TURN *** [Kd 3s 7d] [4c]
uYWfQJg2hgHLxri6/uVJiw: checks
QHxJjpVYwitg9krW6wZgJA: checks
*** RIVER *** [Kd 3s 7d 4c] [5h]
uYWfQJg2hgHLxri6/uVJiw: bets $4
QHxJjpVYwitg9krW6wZgJA: calls $4
*** SHOW DOWN ***
uYWfQJg2hgHLxri6/uVJiw: shows [7c Td] (a pair of Sevens)
QHxJjpVYwitg9krW6wZgJA: shows [5s 5d] (three of a kind, Fives)
QHxJjpVYwitg9krW6wZgJA collected $19.05 from pot
*** SUMMARY ***
Total pot $20 | Rake $0.95
Board [Kd 3s 7d 4c 5h]
Seat 1: uYWfQJg2hgHLxri6/uVJiw (small blind) showed [7c Td] and lost with a pair of Sevens
Seat 2: QHxJjpVYwitg9krW6wZgJA (big blind) showed [5s 5d] and won ($19.05) with three of a kind, Fives
Seat 3: 9sYbXdhj1M2bwKrVNxj5+Q folded before Flop (didn't bet)
Seat 4: zJtQ1gxyi72XvGYS1tM+DA folded before Flop (didn't bet)
Seat 5: 5Q8U6iZbeO7xJSS4qvDP5g folded before Flop (didn't bet)
Seat 6: H6Z4+qu8gR0VUiPOijndVg folded before Flop (didn't bet)
Seat 7: kVCeGJ4NY7Fb0W74j1mAqA folded before Flop (didn't bet)
Seat 8: Hc2itIxwbi1lwa+DAYYQGg folded before Flop (didn't bet)
Seat 9: 5iPk5MyO3KVu18Y8XCYfFQ (button) folded before Flop (didn't bet)



PokerStars Game #59938430120:  Hold'em No Limit ($1/$2) - 2009/07/01 0:14:47 ET
Table 'gnHBqWll9O3fxG7Ojkz/ng' 9-max Seat #4 is the button
Seat 1: hpqdC/23wXosGOmzARr5NA ($152.05 in chips)
Seat 2: H6Z4+qu8gR0VUiPOijndVg ($200 in chips)
Seat 3: 5Q8U6iZbeO7xJSS4qvDP5g ($215.60 in chips)
Seat 4: n5XI5/7gN+gIubHFBH+mOw ($409.15 in chips)
Seat 5: rBQDMkKm9cZn6M9NPsiVew ($118 in chips)
Seat 6: 5iPk5MyO3KVu18Y8XCYfFQ ($52.45 in chips)
Seat 8: De9g+AYjo0DN6C/+iT/nsg ($247.05 in chips)
Seat 9: kVCeGJ4NY7Fb0W74j1mAqA ($206 in chips)
rBQDMkKm9cZn6M9NPsiVew: posts small blind $1
5iPk5MyO3KVu18Y8XCYfFQ: posts big blind $2
*** HOLE CARDS ***
De9g+AYjo0DN6C/+iT/nsg: folds
kVCeGJ4NY7Fb0W74j1mAqA: folds
hpqdC/23wXosGOmzARr5NA: folds
H6Z4+qu8gR0VUiPOijndVg: folds
5Q8U6iZbeO7xJSS4qvDP5g: raises $4 to $6
n5XI5/7gN+gIubHFBH+mOw: folds
rBQDMkKm9cZn6M9NPsiVew: folds
5iPk5MyO3KVu18Y8XCYfFQ: raises $46.45 to $52.45 and is all-in
5Q8U6iZbeO7xJSS4qvDP5g: folds
5iPk5MyO3KVu18Y8XCYfFQ collected $13 from pot
5iPk5MyO3KVu18Y8XCYfFQ: doesn't show hand
*** SUMMARY ***
Total pot $13 | Rake $0
Seat 1: hpqdC/23wXosGOmzARr5NA folded before Flop (didn't bet)
Seat 2: H6Z4+qu8gR0VUiPOijndVg folded before Flop (didn't bet)
Seat 3: 5Q8U6iZbeO7xJSS4qvDP5g folded before Flop
Seat 4: n5XI5/7gN+gIubHFBH+mOw (button) folded before Flop (didn't bet)
Seat 5: rBQDMkKm9cZn6M9NPsiVew (small blind) folded before Flop
Seat 6: 5iPk5MyO3KVu18Y8XCYfFQ (big blind) collected ($13)
Seat 8: De9g+AYjo0DN6C/+iT/nsg folded before Flop (didn't bet)
Seat 9: kVCeGJ4NY7Fb0W74j1mAqA folded before Flop (didn't bet)



PokerStars Game #59938431660:  Hold'em No Limit ($1/$2) - 2009/07/01 0:14:49 ET
Table 'eyAQSIlgc2o1Jxvbve4WGg' 9-max Seat #3 is the button
Seat 1: Q3uFdu6ztesjDFiqkagTRQ ($232 in chips)
Seat 3: TAfo4veNRaRlzDXMMYS3Jg ($37 in chips)
Seat 5: JnV3SM2D6dAFYyGZHHpvrg ($101 in chips)
Seat 6: IikcENBHwoT7snSvBPSc7Q ($182.60 in chips)
Seat 7: QHxJjpVYwitg9krW6wZgJA ($200 in chips)
Seat 8: 5iPk5MyO3KVu18Y8XCYfFQ ($38.60 in chips)
Seat 9: Hc2itIxwbi1lwa+DAYYQGg ($52.85 in chips)
miAHPEBdznuHNzK6YM3hRA will be allowed to play after the button
JnV3SM2D6dAFYyGZHHpvrg: posts small blind $1
IikcENBHwoT7snSvBPSc7Q: posts big blind $2
*** HOLE CARDS ***
QHxJjpVYwitg9krW6wZgJA: folds
5iPk5MyO3KVu18Y8XCYfFQ: folds
Hc2itIxwbi1lwa+DAYYQGg: folds
Q3uFdu6ztesjDFiqkagTRQ: folds
TAfo4veNRaRlzDXMMYS3Jg: folds
JnV3SM2D6dAFYyGZHHpvrg: raises $2 to $4
IikcENBHwoT7snSvBPSc7Q: raises $8 to $12
JnV3SM2D6dAFYyGZHHpvrg: folds
IikcENBHwoT7snSvBPSc7Q collected $8 from pot
IikcENBHwoT7snSvBPSc7Q: doesn't show hand
*** SUMMARY ***
Total pot $8 | Rake $0
Seat 1: Q3uFdu6ztesjDFiqkagTRQ folded before Flop (didn't bet)
Seat 3: TAfo4veNRaRlzDXMMYS3Jg (button) folded before Flop (didn't bet)
Seat 5: JnV3SM2D6dAFYyGZHHpvrg (small blind) folded before Flop
Seat 6: IikcENBHwoT7snSvBPSc7Q (big blind) collected ($8)
Seat 7: QHxJjpVYwitg9krW6wZgJA folded before Flop (didn't bet)
Seat 8: 5iPk5MyO3KVu18Y8XCYfFQ folded before Flop (didn't bet)
Seat 9: Hc2itIxwbi1lwa+DAYYQGg folded before Flop (didn't bet)



PokerStars Game #59938434216:  Hold'em No Limit ($1/$2) - 2009/07/01 0:14:53 ET
Table 'jlrIxbrVIG+gjaUYT4za8g' 6-max Seat #4 is the button
Seat 1: ygTTt5ehT4aF86q1a8/R+w ($196.05 in chips)
Seat 2: N18PrNGQj43J7TJuQuu+tw ($130.55 in chips)
Seat 3: 54yWzRRgS0oZ+S6LwZBxMQ ($40.80 in chips)
Seat 4: 8srN1dKQePlsv0GyTada+Q ($205.35 in chips)
Seat 6: vkfxu8f/jMYKUk6Ly4eujw ($280.95 in chips)
vkfxu8f/jMYKUk6Ly4eujw: posts small blind $1
ygTTt5ehT4aF86q1a8/R+w: posts big blind $2
*** HOLE CARDS ***
N18PrNGQj43J7TJuQuu+tw: calls $2
54yWzRRgS0oZ+S6LwZBxMQ: folds
8srN1dKQePlsv0GyTada+Q: calls $2
vkfxu8f/jMYKUk6Ly4eujw: folds
ygTTt5ehT4aF86q1a8/R+w: checks
*** FLOP *** [5c Th 6d]
ygTTt5ehT4aF86q1a8/R+w: checks
N18PrNGQj43J7TJuQuu+tw: checks
8srN1dKQePlsv0GyTada+Q: checks
*** TURN *** [5c Th 6d] [3d]
ygTTt5ehT4aF86q1a8/R+w: checks
N18PrNGQj43J7TJuQuu+tw: bets $6
8srN1dKQePlsv0GyTada+Q: calls $6
ygTTt5ehT4aF86q1a8/R+w: folds
*** RIVER *** [5c Th 6d 3d] [9s]
N18PrNGQj43J7TJuQuu+tw: checks
8srN1dKQePlsv0GyTada+Q: checks
*** SHOW DOWN ***
N18PrNGQj43J7TJuQuu+tw: shows [As Jc] (high card Ace)
8srN1dKQePlsv0GyTada+Q: mucks hand
N18PrNGQj43J7TJuQuu+tw collected $18.10 from pot
*** SUMMARY ***
Total pot $19 | Rake $0.90
Board [5c Th 6d 3d 9s]
Seat 1: ygTTt5ehT4aF86q1a8/R+w (big blind) folded on the Turn
Seat 2: N18PrNGQj43J7TJuQuu+tw showed [As Jc] and won ($18.10) with high card Ace
Seat 3: 54yWzRRgS0oZ+S6LwZBxMQ folded before Flop (didn't bet)
Seat 4: 8srN1dKQePlsv0GyTada+Q (button) mucked
Seat 6: vkfxu8f/jMYKUk6Ly4eujw (small blind) folded before Flop



PokerStars Game #59938435940:  Hold'em No Limit ($1/$2) - 2009/07/01 0:14:55 ET
Table 'LL4bDFyhj5hsMpzaDugJZg' 6-max Seat #2 is the button
Seat 1: IBW9lyGsaRmfcbyA/qFfEw ($64.20 in chips)
Seat 2: L3l+A4pJhOAD6HVVFXvVBw ($319.95 in chips)
Seat 3: gGPaCoSWW1HoKYaqfAPecg ($203 in chips)
Seat 4: 8srN1dKQePlsv0GyTada+Q ($268.75 in chips)
Seat 5: HgX0VeqE/dzSXd5BpntRBw ($200 in chips)
gGPaCoSWW1HoKYaqfAPecg: posts small blind $1
8srN1dKQePlsv0GyTada+Q: posts big blind $2
/PH6Ffnho4Ysm8S3V/oa+w: sits out
*** HOLE CARDS ***
HgX0VeqE/dzSXd5BpntRBw: folds
IBW9lyGsaRmfcbyA/qFfEw: folds
L3l+A4pJhOAD6HVVFXvVBw: folds
gGPaCoSWW1HoKYaqfAPecg: raises $5 to $7
8srN1dKQePlsv0GyTada+Q: folds
gGPaCoSWW1HoKYaqfAPecg collected $4 from pot
*** SUMMARY ***
Total pot $4 | Rake $0
Seat 1: IBW9lyGsaRmfcbyA/qFfEw folded before Flop (didn't bet)
Seat 2: L3l+A4pJhOAD6HVVFXvVBw (button) folded before Flop (didn't bet)
Seat 3: gGPaCoSWW1HoKYaqfAPecg (small blind) collected ($4)
Seat 4: 8srN1dKQePlsv0GyTada+Q (big blind) folded before Flop
Seat 5: HgX0VeqE/dzSXd5BpntRBw folded before Flop (didn't bet)



PokerStars Game #59938436516:  Hold'em No Limit ($1/$2) - 2009/07/01 0:14:56 ET
Table 'W9UeSV0aoPjh5SFSxM8jUQ' 9-max Seat #7 is the button
Seat 1: cdC54j9fGGojcbzWB5PgzA ($200 in chips)
Seat 2: iMe5yhc+1BaiIPHet3NMrA ($313.75 in chips)
Seat 3: TAfo4veNRaRlzDXMMYS3Jg ($40 in chips)
Seat 4: De9g+AYjo0DN6C/+iT/nsg ($197 in chips)
Seat 6: MXxB6weBWzZyAhRZb+/KVg ($200 in chips)
Seat 7: 4Cl43Q1TYQL8wn1NSCUkaw ($48.60 in chips)
Seat 9: U2A5Hv6ib/5+gzO2wr7Z4w ($200 in chips)
U2A5Hv6ib/5+gzO2wr7Z4w: posts small blind $1
cdC54j9fGGojcbzWB5PgzA: posts big blind $2
CUZwDpLTQKhzarPe+JCLOQ: sits out
*** HOLE CARDS ***
iMe5yhc+1BaiIPHet3NMrA: folds
TAfo4veNRaRlzDXMMYS3Jg: folds
De9g+AYjo0DN6C/+iT/nsg: folds
MXxB6weBWzZyAhRZb+/KVg: calls $2
4Cl43Q1TYQL8wn1NSCUkaw: calls $2
U2A5Hv6ib/5+gzO2wr7Z4w: calls $1
cdC54j9fGGojcbzWB5PgzA: checks
*** FLOP *** [7s 7h 4h]
U2A5Hv6ib/5+gzO2wr7Z4w: checks
cdC54j9fGGojcbzWB5PgzA: checks
MXxB6weBWzZyAhRZb+/KVg: checks
4Cl43Q1TYQL8wn1NSCUkaw: checks
*** TURN *** [7s 7h 4h] [9c]
U2A5Hv6ib/5+gzO2wr7Z4w: checks
cdC54j9fGGojcbzWB5PgzA: bets $6
MXxB6weBWzZyAhRZb+/KVg: folds
4Cl43Q1TYQL8wn1NSCUkaw: folds
U2A5Hv6ib/5+gzO2wr7Z4w: folds
cdC54j9fGGojcbzWB5PgzA collected $7.60 from pot
*** SUMMARY ***
Total pot $8 | Rake $0.40
Board [7s 7h 4h 9c]
Seat 1: cdC54j9fGGojcbzWB5PgzA (big blind) collected ($7.60)
Seat 2: iMe5yhc+1BaiIPHet3NMrA folded before Flop (didn't bet)
Seat 3: TAfo4veNRaRlzDXMMYS3Jg folded before Flop (didn't bet)
Seat 4: De9g+AYjo0DN6C/+iT/nsg folded before Flop (didn't bet)
Seat 6: MXxB6weBWzZyAhRZb+/KVg folded on the Turn
Seat 7: 4Cl43Q1TYQL8wn1NSCUkaw (button) folded on the Turn
Seat 9: U2A5Hv6ib/5+gzO2wr7Z4w (small blind) folded on the Turn



PokerStars Game #59938439254:  Hold'em No Limit ($1/$2) - 2009/07/01 0:15:00 ET
Table 'l5lZHc5JRHEDt0Y2AVPq3g' 6-max Seat #5 is the button
Seat 1: gGPaCoSWW1HoKYaqfAPecg ($216.25 in chips)
Seat 2: my38j/MmtBd/8qVwmyCREA ($240.35 in chips)
Seat 4: zNjJ/y4emmF+vzrCDd+ooA ($211.75 in chips)
Seat 5: X7GlkHF+lkbarCLuZ4Uf0w ($52.85 in chips)
Seat 6: vkfxu8f/jMYKUk6Ly4eujw ($191.30 in chips)
vkfxu8f/jMYKUk6Ly4eujw: posts small blind $1
gGPaCoSWW1HoKYaqfAPecg: posts big blind $2
DQlskgG4OtLpF2MVxLwf4A: sits out
*** HOLE CARDS ***
my38j/MmtBd/8qVwmyCREA: folds
zNjJ/y4emmF+vzrCDd+ooA: calls $2
X7GlkHF+lkbarCLuZ4Uf0w: folds
vkfxu8f/jMYKUk6Ly4eujw: calls $1
gGPaCoSWW1HoKYaqfAPecg: checks
*** FLOP *** [5h 4c Ks]
vkfxu8f/jMYKUk6Ly4eujw: checks
my38j/MmtBd/8qVwmyCREA leaves the table
/PH6Ffnho4Ysm8S3V/oa+w joins the table at seat #2
gGPaCoSWW1HoKYaqfAPecg: bets $4.55
zNjJ/y4emmF+vzrCDd+ooA: raises $4.55 to $9.10
vkfxu8f/jMYKUk6Ly4eujw: folds
gGPaCoSWW1HoKYaqfAPecg: calls $4.55
*** TURN *** [5h 4c Ks] [Ac]
gGPaCoSWW1HoKYaqfAPecg: bets $12
zNjJ/y4emmF+vzrCDd+ooA: folds
gGPaCoSWW1HoKYaqfAPecg collected $23.05 from pot
gGPaCoSWW1HoKYaqfAPecg: doesn't show hand
*** SUMMARY ***
Total pot $24.20 | Rake $1.15
Board [5h 4c Ks Ac]
Seat 1: gGPaCoSWW1HoKYaqfAPecg (big blind) collected ($23.05)
Seat 2: my38j/MmtBd/8qVwmyCREA folded before Flop (didn't bet)
Seat 4: zNjJ/y4emmF+vzrCDd+ooA folded on the Turn
Seat 5: X7GlkHF+lkbarCLuZ4Uf0w (button) folded before Flop (didn't bet)
Seat 6: vkfxu8f/jMYKUk6Ly4eujw (small blind) folded on the Flop



PokerStars Game #59938440772:  Hold'em No Limit ($1/$2) - 2009/07/01 0:15:02 ET
Table 'NmY84NAf9Mh0ckAckHnh5g' 2-max Seat #1 is the button
Seat 1: 6hvg964TSqZ3AL/0XK9aVQ ($357.25 in chips)
Seat 2: RwDoM55ZeQuI2ADyJhOb2Q ($229.85 in chips)
6hvg964TSqZ3AL/0XK9aVQ: posts small blind $1
RwDoM55ZeQuI2ADyJhOb2Q: posts big blind $2
*** HOLE CARDS ***
6hvg964TSqZ3AL/0XK9aVQ: folds
RwDoM55ZeQuI2ADyJhOb2Q collected $2 from pot
RwDoM55ZeQuI2ADyJhOb2Q: doesn't show hand
*** SUMMARY ***
Total pot $2 | Rake $0
Seat 1: 6hvg964TSqZ3AL/0XK9aVQ (button) (small blind) folded before Flop
Seat 2: RwDoM55ZeQuI2ADyJhOb2Q (big blind) collected ($2)



PokerStars Game #59938442582:  Hold'em No Limit ($1/$2) - 2009/07/01 0:15:05 ET
Table '3FGoiEOffWrbgTfsB3t7FA' 2-max Seat #1 is the button
Seat 1: e0oDWyrmgLpR6bROEqw1nQ ($258.50 in chips)
Seat 2: +sy/nlNI20yZraIjs4AALg ($341.65 in chips)
e0oDWyrmgLpR6bROEqw1nQ: posts small blind $1
+sy/nlNI20yZraIjs4AALg: posts big blind $2
*** HOLE CARDS ***
e0oDWyrmgLpR6bROEqw1nQ: folds
+sy/nlNI20yZraIjs4AALg collected $2 from pot
*** SUMMARY ***
Total pot $2 | Rake $0
Seat 1: e0oDWyrmgLpR6bROEqw1nQ (button) (small blind) folded before Flop
Seat 2: +sy/nlNI20yZraIjs4AALg (big blind) collected ($2)



PokerStars Game #59938444944:  Hold'em No Limit ($1/$2) - 2009/07/01 0:15:08 ET
Table 'NmY84NAf9Mh0ckAckHnh5g' 2-max Seat #2 is the button
Seat 1: 6hvg964TSqZ3AL/0XK9aVQ ($356.25 in chips)
Seat 2: RwDoM55ZeQuI2ADyJhOb2Q ($230.85 in chips)
RwDoM55ZeQuI2ADyJhOb2Q: posts small blind $1
6hvg964TSqZ3AL/0XK9aVQ: posts big blind $2
*** HOLE CARDS ***
RwDoM55ZeQuI2ADyJhOb2Q: folds
6hvg964TSqZ3AL/0XK9aVQ collected $2 from pot
6hvg964TSqZ3AL/0XK9aVQ: doesn't show hand
*** SUMMARY ***
Total pot $2 | Rake $0
Seat 1: 6hvg964TSqZ3AL/0XK9aVQ (big blind) collected ($2)
Seat 2: RwDoM55ZeQuI2ADyJhOb2Q (button) (small blind) folded before Flop



PokerStars Game #59938446640:  Hold'em No Limit ($1/$2) - 2009/07/01 0:15:11 ET
Table 'XP2sRSup+aRuwzx3vDZsDg' 6-max Seat #3 is the button
Seat 1: o9jamqIi6sTTRSqudgboRA ($240.70 in chips)
Seat 3: X7GlkHF+lkbarCLuZ4Uf0w ($41 in chips)
Seat 4: JsC+WvfzqlxVs9G8/gSQAQ ($115.05 in chips)
Seat 5: 894kvCY4GHivBpqwizsecg ($120 in chips)
Seat 6: h7ppRQJTYBsHCbLMeW9T2g ($478.75 in chips)
JsC+WvfzqlxVs9G8/gSQAQ: posts small blind $1
894kvCY4GHivBpqwizsecg: posts big blind $2
*** HOLE CARDS ***
h7ppRQJTYBsHCbLMeW9T2g: folds
o9jamqIi6sTTRSqudgboRA: folds
X7GlkHF+lkbarCLuZ4Uf0w: raises $2 to $4
JsC+WvfzqlxVs9G8/gSQAQ: raises $6 to $10
894kvCY4GHivBpqwizsecg: folds
Ep0hd57w9DDqfTwA66dJVw joins the table at seat #2
X7GlkHF+lkbarCLuZ4Uf0w: folds
JsC+WvfzqlxVs9G8/gSQAQ collected $10 from pot
*** SUMMARY ***
Total pot $10 | Rake $0
Seat 1: o9jamqIi6sTTRSqudgboRA folded before Flop (didn't bet)
Seat 3: X7GlkHF+lkbarCLuZ4Uf0w (button) folded before Flop
Seat 4: JsC+WvfzqlxVs9G8/gSQAQ (small blind) collected ($10)
Seat 5: 894kvCY4GHivBpqwizsecg (big blind) folded before Flop
Seat 6: h7ppRQJTYBsHCbLMeW9T2g folded before Flop (didn't bet)



PokerStars Game #59938446938:  Hold'em No Limit ($1/$2) - 2009/07/01 0:15:11 ET
Table 'bIihwBANJSFqlHPPtset+w' 9-max Seat #6 is the button
Seat 1: jI3JDUGV63ccqtKgM3vMbw ($159.70 in chips)
Seat 2: lQYT23h5QCUVZAKxjOO39Q ($125.90 in chips)
Seat 3: acnZ0LD5jxKgWIHz+mpQ8Q ($226.25 in chips)
Seat 4: 7WWX5PClBdr/U44gUKBIEA ($296.05 in chips)
Seat 6: 5iPk5MyO3KVu18Y8XCYfFQ ($39 in chips)
Seat 7: 3q2/0oJr3Mcy1W5tcN61ug ($200 in chips)
Seat 8: iMe5yhc+1BaiIPHet3NMrA ($281.65 in chips)
Seat 9: rW/MyplHylMSBRaoRUzWrg ($40 in chips)
3q2/0oJr3Mcy1W5tcN61ug: posts small blind $1
iMe5yhc+1BaiIPHet3NMrA: posts big blind $2
*** HOLE CARDS ***
rW/MyplHylMSBRaoRUzWrg: folds
jI3JDUGV63ccqtKgM3vMbw: folds
lQYT23h5QCUVZAKxjOO39Q: folds
acnZ0LD5jxKgWIHz+mpQ8Q: raises $4 to $6
7WWX5PClBdr/U44gUKBIEA: folds
5iPk5MyO3KVu18Y8XCYfFQ: folds
3q2/0oJr3Mcy1W5tcN61ug: folds
iMe5yhc+1BaiIPHet3NMrA: folds
acnZ0LD5jxKgWIHz+mpQ8Q collected $5 from pot
*** SUMMARY ***
Total pot $5 | Rake $0
Seat 1: jI3JDUGV63ccqtKgM3vMbw folded before Flop (didn't bet)
Seat 2: lQYT23h5QCUVZAKxjOO39Q folded before Flop (didn't bet)
Seat 3: acnZ0LD5jxKgWIHz+mpQ8Q collected ($5)
Seat 4: 7WWX5PClBdr/U44gUKBIEA folded before Flop (didn't bet)
Seat 6: 5iPk5MyO3KVu18Y8XCYfFQ (button) folded before Flop (didn't bet)
Seat 7: 3q2/0oJr3Mcy1W5tcN61ug (small blind) folded before Flop
Seat 8: iMe5yhc+1BaiIPHet3NMrA (big blind) folded before Flop
Seat 9: rW/MyplHylMSBRaoRUzWrg folded before Flop (didn't bet)



PokerStars Game #59938447522:  Hold'em No Limit ($1/$2) - 2009/07/01 0:15:12 ET
Table 'srul5UFZXTEccVV5fpY91g' 9-max Seat #2 is the button
Seat 1: lfD8cBv31A/pio3pXJbPjA ($171.20 in chips)
Seat 2: tJYod1SLp2AcWPL/3hZ7ug ($84.20 in chips)
Seat 3: weUZ8S7tgbaeIpzi1gBNxQ ($49.75 in chips)
Seat 4: GG5lTuGt3+kwNYSbqeB6yw ($84.60 in chips)
Seat 5: 5iPk5MyO3KVu18Y8XCYfFQ ($43.10 in chips)
Seat 6: TAfo4veNRaRlzDXMMYS3Jg ($36 in chips)
Seat 7: s0erZsDxbZSaEPheMgibKg ($480.40 in chips)
weUZ8S7tgbaeIpzi1gBNxQ: posts small blind $1
GG5lTuGt3+kwNYSbqeB6yw: posts big blind $2
*** HOLE CARDS ***
5iPk5MyO3KVu18Y8XCYfFQ: folds
TAfo4veNRaRlzDXMMYS3Jg: folds
s0erZsDxbZSaEPheMgibKg: folds
lfD8cBv31A/pio3pXJbPjA: folds
tJYod1SLp2AcWPL/3hZ7ug: raises $4 to $6
weUZ8S7tgbaeIpzi1gBNxQ: folds
GG5lTuGt3+kwNYSbqeB6yw: folds
tJYod1SLp2AcWPL/3hZ7ug collected $5 from pot
*** SUMMARY ***
Total pot $5 | Rake $0
Seat 1: lfD8cBv31A/pio3pXJbPjA folded before Flop (didn't bet)
Seat 2: tJYod1SLp2AcWPL/3hZ7ug (button) collected ($5)
Seat 3: weUZ8S7tgbaeIpzi1gBNxQ (small blind) folded before Flop
Seat 4: GG5lTuGt3+kwNYSbqeB6yw (big blind) folded before Flop
Seat 5: 5iPk5MyO3KVu18Y8XCYfFQ folded before Flop (didn't bet)
Seat 6: TAfo4veNRaRlzDXMMYS3Jg folded before Flop (didn't bet)
Seat 7: s0erZsDxbZSaEPheMgibKg folded before Flop (didn't bet)



PokerStars Game #59938448558:  Hold'em No Limit ($1/$2) - 2009/07/01 0:15:13 ET
Table '3FGoiEOffWrbgTfsB3t7FA' 2-max Seat #2 is the button
Seat 1: e0oDWyrmgLpR6bROEqw1nQ ($257.50 in chips)
Seat 2: +sy/nlNI20yZraIjs4AALg ($342.65 in chips)
+sy/nlNI20yZraIjs4AALg: posts small blind $1
e0oDWyrmgLpR6bROEqw1nQ: posts big blind $2
*** HOLE CARDS ***
+sy/nlNI20yZraIjs4AALg: calls $1
e0oDWyrmgLpR6bROEqw1nQ: raises $4 to $6
+sy/nlNI20yZraIjs4AALg: calls $4
*** FLOP *** [Ts 2c Tc]
e0oDWyrmgLpR6bROEqw1nQ: bets $8
+sy/nlNI20yZraIjs4AALg: folds
e0oDWyrmgLpR6bROEqw1nQ collected $11.50 from pot
*** SUMMARY ***
Total pot $12 | Rake $0.50
Board [Ts 2c Tc]
Seat 1: e0oDWyrmgLpR6bROEqw1nQ (big blind) collected ($11.50)
Seat 2: +sy/nlNI20yZraIjs4AALg (button) (small blind) folded on the Flop



PokerStars Game #59938450338:  Hold'em No Limit ($1/$2) - 2009/07/01 0:15:16 ET
Table 'aSf77Sj8QEnzcc0WaxVD4Q' 6-max Seat #6 is the button
Seat 1: Q3uFdu6ztesjDFiqkagTRQ ($248.20 in chips)
Seat 2: vkfxu8f/jMYKUk6Ly4eujw ($242.75 in chips)
Seat 3: 9dpyyjDTCed6nV7JhaUUpw ($200 in chips)
Seat 4: 513FcCI8jHyQy2VWoIQkMg ($200 in chips)
Seat 5: InmkdI6G8TzSj9NhcCSyPg ($247 in chips)
Seat 6: vkoJRf3gidxY1pPi0AFWww ($315.60 in chips)
Q3uFdu6ztesjDFiqkagTRQ: posts small blind $1
vkfxu8f/jMYKUk6Ly4eujw: posts big blind $2
*** HOLE CARDS ***
9dpyyjDTCed6nV7JhaUUpw: folds
513FcCI8jHyQy2VWoIQkMg: folds
InmkdI6G8TzSj9NhcCSyPg: folds
vkoJRf3gidxY1pPi0AFWww: folds
Q3uFdu6ztesjDFiqkagTRQ: raises $4 to $6
vkfxu8f/jMYKUk6Ly4eujw: folds
Q3uFdu6ztesjDFiqkagTRQ collected $4 from pot
Q3uFdu6ztesjDFiqkagTRQ: doesn't show hand
*** SUMMARY ***
Total pot $4 | Rake $0
Seat 1: Q3uFdu6ztesjDFiqkagTRQ (small blind) collected ($4)
Seat 2: vkfxu8f/jMYKUk6Ly4eujw (big blind) folded before Flop
Seat 3: 9dpyyjDTCed6nV7JhaUUpw folded before Flop (didn't bet)
Seat 4: 513FcCI8jHyQy2VWoIQkMg folded before Flop (didn't bet)
Seat 5: InmkdI6G8TzSj9NhcCSyPg folded before Flop (didn't bet)
Seat 6: vkoJRf3gidxY1pPi0AFWww (button) folded before Flop (didn't bet)



PokerStars Game #59938450854:  Hold'em No Limit ($1/$2) - 2009/07/01 0:15:17 ET
Table 'LL4bDFyhj5hsMpzaDugJZg' 6-max Seat #3 is the button
Seat 1: IBW9lyGsaRmfcbyA/qFfEw ($64.20 in chips)
Seat 2: L3l+A4pJhOAD6HVVFXvVBw ($319.95 in chips)
Seat 3: gGPaCoSWW1HoKYaqfAPecg ($205 in chips)
Seat 4: 8srN1dKQePlsv0GyTada+Q ($266.75 in chips)
Seat 5: HgX0VeqE/dzSXd5BpntRBw ($200 in chips)
8srN1dKQePlsv0GyTada+Q: posts small blind $1
HgX0VeqE/dzSXd5BpntRBw: posts big blind $2
/PH6Ffnho4Ysm8S3V/oa+w: sits out
*** HOLE CARDS ***
IBW9lyGsaRmfcbyA/qFfEw: folds
L3l+A4pJhOAD6HVVFXvVBw: folds
gGPaCoSWW1HoKYaqfAPecg: raises $5 to $7
8srN1dKQePlsv0GyTada+Q: folds
HgX0VeqE/dzSXd5BpntRBw: calls $5
*** FLOP *** [2c 4h Jh]
HgX0VeqE/dzSXd5BpntRBw: checks
gGPaCoSWW1HoKYaqfAPecg: bets $11.40
HgX0VeqE/dzSXd5BpntRBw: calls $11.40
*** TURN *** [2c 4h Jh] [9s]
HgX0VeqE/dzSXd5BpntRBw: bets $28
gGPaCoSWW1HoKYaqfAPecg: calls $28
*** RIVER *** [2c 4h Jh 9s] [Ks]
HgX0VeqE/dzSXd5BpntRBw: checks
gGPaCoSWW1HoKYaqfAPecg: checks
*** SHOW DOWN ***
HgX0VeqE/dzSXd5BpntRBw: shows [Jc Ad] (a pair of Jacks)
gGPaCoSWW1HoKYaqfAPecg: mucks hand
HgX0VeqE/dzSXd5BpntRBw collected $91.80 from pot
*** SUMMARY ***
Total pot $93.80 | Rake $2
Board [2c 4h Jh 9s Ks]
Seat 1: IBW9lyGsaRmfcbyA/qFfEw folded before Flop (didn't bet)
Seat 2: L3l+A4pJhOAD6HVVFXvVBw folded before Flop (didn't bet)
Seat 3: gGPaCoSWW1HoKYaqfAPecg (button) mucked
Seat 4: 8srN1dKQePlsv0GyTada+Q (small blind) folded before Flop
Seat 5: HgX0VeqE/dzSXd5BpntRBw (big blind) showed [Jc Ad] and won ($91.80) with a pair of Jacks



PokerStars Game #59938451724:  Hold'em No Limit ($1/$2) - 2009/07/01 0:15:18 ET
Table 'NmY84NAf9Mh0ckAckHnh5g' 2-max Seat #1 is the button
Seat 1: 6hvg964TSqZ3AL/0XK9aVQ ($357.25 in chips)
Seat 2: RwDoM55ZeQuI2ADyJhOb2Q ($229.85 in chips)
6hvg964TSqZ3AL/0XK9aVQ: posts small blind $1
RwDoM55ZeQuI2ADyJhOb2Q: posts big blind $2
*** HOLE CARDS ***
6hvg964TSqZ3AL/0XK9aVQ: folds
RwDoM55ZeQuI2ADyJhOb2Q collected $2 from pot
RwDoM55ZeQuI2ADyJhOb2Q: doesn't show hand
*** SUMMARY ***
Total pot $2 | Rake $0
Seat 1: 6hvg964TSqZ3AL/0XK9aVQ (button) (small blind) folded before Flop
Seat 2: RwDoM55ZeQuI2ADyJhOb2Q (big blind) collected ($2)



PokerStars Game #59938453870:  Hold'em No Limit ($1/$2) - 2009/07/01 0:15:21 ET
Table 'G1Oqdy4Pqdb5gtx40rUBzA' 6-max Seat #4 is the button
Seat 1: QCqxb/MXSq5RKfPtjBjiBA ($135.60 in chips)
Seat 2: IzslX/oV8DoDQfxCV/3+kg ($363.75 in chips)
Seat 3: lE+RUsc9cdVV9eEi8uytew ($92.75 in chips)
Seat 4: B87ikIyZ/TzAVeXf38Ny0g ($200 in chips)
Seat 6: gGPaCoSWW1HoKYaqfAPecg ($200 in chips)
X7GlkHF+lkbarCLuZ4Uf0w will be allowed to play after the button
gGPaCoSWW1HoKYaqfAPecg: posts small blind $1
QCqxb/MXSq5RKfPtjBjiBA: posts big blind $2
*** HOLE CARDS ***
IzslX/oV8DoDQfxCV/3+kg: raises $4 to $6
lE+RUsc9cdVV9eEi8uytew: raises $8 to $14
B87ikIyZ/TzAVeXf38Ny0g: folds
gGPaCoSWW1HoKYaqfAPecg: folds
QCqxb/MXSq5RKfPtjBjiBA: folds
IzslX/oV8DoDQfxCV/3+kg: calls $8
*** FLOP *** [4c Ac 7h]
IzslX/oV8DoDQfxCV/3+kg: checks
lE+RUsc9cdVV9eEi8uytew: checks
*** TURN *** [4c Ac 7h] [9c]
IzslX/oV8DoDQfxCV/3+kg: checks
lE+RUsc9cdVV9eEi8uytew: checks
*** RIVER *** [4c Ac 7h 9c] [5s]
IzslX/oV8DoDQfxCV/3+kg: checks
lE+RUsc9cdVV9eEi8uytew: checks
*** SHOW DOWN ***
IzslX/oV8DoDQfxCV/3+kg: shows [2h 2s] (a pair of Deuces)
lE+RUsc9cdVV9eEi8uytew: shows [Th Td] (a pair of Tens)
lE+RUsc9cdVV9eEi8uytew collected $29.45 from pot
*** SUMMARY ***
Total pot $31 | Rake $1.55
Board [4c Ac 7h 9c 5s]
Seat 1: QCqxb/MXSq5RKfPtjBjiBA (big blind) folded before Flop
Seat 2: IzslX/oV8DoDQfxCV/3+kg showed [2h 2s] and lost with a pair of Deuces
Seat 3: lE+RUsc9cdVV9eEi8uytew showed [Th Td] and won ($29.45) with a pair of Tens
Seat 4: B87ikIyZ/TzAVeXf38Ny0g (button) folded before Flop (didn't bet)
Seat 6: gGPaCoSWW1HoKYaqfAPecg (small blind) folded before Flop



PokerStars Game #59938453490:  Hold'em No Limit ($1/$2) - 2009/07/01 0:15:21 ET
Table 'qVXak+oTeDXMGbWa4sDU5Q' 9-max Seat #5 is the button
Seat 1: H6Z4+qu8gR0VUiPOijndVg ($254.30 in chips)
Seat 2: Hc2itIxwbi1lwa+DAYYQGg ($46 in chips)
Seat 3: oz9eCXGC7DdjQlL/nuWj1A ($100.60 in chips)
Seat 4: b0jO1SDhLedy1//CQlA8kw ($40 in chips)
Seat 5: NqKRc5xvcye0d7F6VOF6MQ ($82.50 in chips)
Seat 6: Q3uFdu6ztesjDFiqkagTRQ ($200 in chips)
Seat 7: 5iPk5MyO3KVu18Y8XCYfFQ ($115 in chips)
Seat 8: 9pHZMviI9R8injxojGTnvw ($115.80 in chips)
Seat 9: IZ/2qsh1CIg9m5PWsMsLmA ($351.95 in chips)
Q3uFdu6ztesjDFiqkagTRQ: posts small blind $1
5iPk5MyO3KVu18Y8XCYfFQ: posts big blind $2
*** HOLE CARDS ***
9pHZMviI9R8injxojGTnvw: folds
IZ/2qsh1CIg9m5PWsMsLmA: folds
H6Z4+qu8gR0VUiPOijndVg: folds
Hc2itIxwbi1lwa+DAYYQGg: folds
oz9eCXGC7DdjQlL/nuWj1A: calls $2
b0jO1SDhLedy1//CQlA8kw: raises $7 to $9
NqKRc5xvcye0d7F6VOF6MQ: folds
Q3uFdu6ztesjDFiqkagTRQ: folds
5iPk5MyO3KVu18Y8XCYfFQ: folds
oz9eCXGC7DdjQlL/nuWj1A: calls $7
*** FLOP *** [4c 2c Ad]
oz9eCXGC7DdjQlL/nuWj1A: checks
b0jO1SDhLedy1//CQlA8kw: bets $10
oz9eCXGC7DdjQlL/nuWj1A: calls $10
*** TURN *** [4c 2c Ad] [3d]
oz9eCXGC7DdjQlL/nuWj1A: checks
b0jO1SDhLedy1//CQlA8kw: checks
*** RIVER *** [4c 2c Ad 3d] [4d]
oz9eCXGC7DdjQlL/nuWj1A: bets $12
b0jO1SDhLedy1//CQlA8kw: folds
oz9eCXGC7DdjQlL/nuWj1A collected $39.05 from pot
oz9eCXGC7DdjQlL/nuWj1A: doesn't show hand
*** SUMMARY ***
Total pot $41 | Rake $1.95
Board [4c 2c Ad 3d 4d]
Seat 1: H6Z4+qu8gR0VUiPOijndVg folded before Flop (didn't bet)
Seat 2: Hc2itIxwbi1lwa+DAYYQGg folded before Flop (didn't bet)
Seat 3: oz9eCXGC7DdjQlL/nuWj1A collected ($39.05)
Seat 4: b0jO1SDhLedy1//CQlA8kw folded on the River
Seat 5: NqKRc5xvcye0d7F6VOF6MQ (button) folded before Flop (didn't bet)
Seat 6: Q3uFdu6ztesjDFiqkagTRQ (small blind) folded before Flop
Seat 7: 5iPk5MyO3KVu18Y8XCYfFQ (big blind) folded before Flop
Seat 8: 9pHZMviI9R8injxojGTnvw folded before Flop (didn't bet)
Seat 9: IZ/2qsh1CIg9m5PWsMsLmA folded before Flop (didn't bet)



PokerStars Game #59938454992:  Hold'em No Limit ($1/$2) - 2009/07/01 0:15:23 ET
Table 'bJQ024BaYSBrW0sXpCZbNQ' 6-max Seat #2 is the button
Seat 1: Mo7b4GXWaawCURUQwq6RYg ($44 in chips)
Seat 2: 1njbh8TKSUF6l4V1XwGdcg ($342.80 in chips)
Seat 4: 9ni/OEXAqfc58zPQ0Tu9rQ ($263.60 in chips)
Seat 6: 9dpyyjDTCed6nV7JhaUUpw ($200 in chips)
9ni/OEXAqfc58zPQ0Tu9rQ: posts small blind $1
X7GlkHF+lkbarCLuZ4Uf0w: is sitting out
9dpyyjDTCed6nV7JhaUUpw: posts big blind $2
*** HOLE CARDS ***
X7GlkHF+lkbarCLuZ4Uf0w has returned
Mo7b4GXWaawCURUQwq6RYg: raises $4 to $6
X7GlkHF+lkbarCLuZ4Uf0w leaves the table
1njbh8TKSUF6l4V1XwGdcg: folds
9ni/OEXAqfc58zPQ0Tu9rQ: calls $5
9dpyyjDTCed6nV7JhaUUpw: folds
*** FLOP *** [Ad Qc 3h]
9ni/OEXAqfc58zPQ0Tu9rQ: bets $8
Mo7b4GXWaawCURUQwq6RYg: raises $8 to $16
9ni/OEXAqfc58zPQ0Tu9rQ: raises $241.60 to $257.60 and is all-in
Mo7b4GXWaawCURUQwq6RYg: calls $22 and is all-in
*** TURN *** [Ad Qc 3h] [Jh]
*** RIVER *** [Ad Qc 3h Jh] [6d]
*** SHOW DOWN ***
9ni/OEXAqfc58zPQ0Tu9rQ: shows [3c 3d] (three of a kind, Threes)
Mo7b4GXWaawCURUQwq6RYg: mucks hand
9ni/OEXAqfc58zPQ0Tu9rQ collected $88 from pot
*** SUMMARY ***
Total pot $90 | Rake $2
Board [Ad Qc 3h Jh 6d]
Seat 1: Mo7b4GXWaawCURUQwq6RYg mucked
Seat 2: 1njbh8TKSUF6l4V1XwGdcg (button) folded before Flop (didn't bet)
Seat 4: 9ni/OEXAqfc58zPQ0Tu9rQ (small blind) showed [3c 3d] and won ($88) with three of a kind, Threes
Seat 6: 9dpyyjDTCed6nV7JhaUUpw (big blind) folded before Flop



PokerStars Game #59938455186:  Hold'em No Limit ($1/$2) - 2009/07/01 0:15:23 ET
Table 'gnHBqWll9O3fxG7Ojkz/ng' 9-max Seat #5 is the button
Seat 1: hpqdC/23wXosGOmzARr5NA ($152.05 in chips)
Seat 2: H6Z4+qu8gR0VUiPOijndVg ($200 in chips)
Seat 3: 5Q8U6iZbeO7xJSS4qvDP5g ($209.60 in chips)
Seat 4: n5XI5/7gN+gIubHFBH+mOw ($409.15 in chips)
Seat 5: rBQDMkKm9cZn6M9NPsiVew ($117 in chips)
Seat 6: 5iPk5MyO3KVu18Y8XCYfFQ ($59.45 in chips)
Seat 9: kVCeGJ4NY7Fb0W74j1mAqA ($206 in chips)
5iPk5MyO3KVu18Y8XCYfFQ: posts small blind $1
De9g+AYjo0DN6C/+iT/nsg: is sitting out
kVCeGJ4NY7Fb0W74j1mAqA: posts big blind $2
*** HOLE CARDS ***
De9g+AYjo0DN6C/+iT/nsg leaves the table
hpqdC/23wXosGOmzARr5NA: folds
H6Z4+qu8gR0VUiPOijndVg: folds
5Q8U6iZbeO7xJSS4qvDP5g: raises $6 to $8
n5XI5/7gN+gIubHFBH+mOw: calls $8
rBQDMkKm9cZn6M9NPsiVew: folds
5iPk5MyO3KVu18Y8XCYfFQ: folds
kVCeGJ4NY7Fb0W74j1mAqA: calls $6
*** FLOP *** [7d Qc Qh]
kVCeGJ4NY7Fb0W74j1mAqA: checks
JpnYBfO6Nq6INmRDDoBX1g joins the table at seat #8
5Q8U6iZbeO7xJSS4qvDP5g: bets $17
n5XI5/7gN+gIubHFBH+mOw: folds
kVCeGJ4NY7Fb0W74j1mAqA: folds
5Q8U6iZbeO7xJSS4qvDP5g collected $23.75 from pot
5Q8U6iZbeO7xJSS4qvDP5g: doesn't show hand
*** SUMMARY ***
Total pot $25 | Rake $1.25
Board [7d Qc Qh]
Seat 1: hpqdC/23wXosGOmzARr5NA folded before Flop (didn't bet)
Seat 2: H6Z4+qu8gR0VUiPOijndVg folded before Flop (didn't bet)
Seat 3: 5Q8U6iZbeO7xJSS4qvDP5g collected ($23.75)
Seat 4: n5XI5/7gN+gIubHFBH+mOw folded on the Flop
Seat 5: rBQDMkKm9cZn6M9NPsiVew (button) folded before Flop (didn't bet)
Seat 6: 5iPk5MyO3KVu18Y8XCYfFQ (small blind) folded before Flop
Seat 9: kVCeGJ4NY7Fb0W74j1mAqA (big blind) folded on the Flop



PokerStars Game #59938455914:  Hold'em No Limit ($1/$2) - 2009/07/01 0:15:24 ET
Table 'NmY84NAf9Mh0ckAckHnh5g' 2-max Seat #2 is the button
Seat 1: 6hvg964TSqZ3AL/0XK9aVQ ($356.25 in chips)
Seat 2: RwDoM55ZeQuI2ADyJhOb2Q ($230.85 in chips)
RwDoM55ZeQuI2ADyJhOb2Q: posts small blind $1
6hvg964TSqZ3AL/0XK9aVQ: posts big blind $2
*** HOLE CARDS ***
RwDoM55ZeQuI2ADyJhOb2Q: raises $4 to $6
6hvg964TSqZ3AL/0XK9aVQ: calls $4
*** FLOP *** [6h 2s Ad]
6hvg964TSqZ3AL/0XK9aVQ: checks
RwDoM55ZeQuI2ADyJhOb2Q: bets $6
6hvg964TSqZ3AL/0XK9aVQ: folds
RwDoM55ZeQuI2ADyJhOb2Q collected $11.50 from pot
RwDoM55ZeQuI2ADyJhOb2Q: doesn't show hand
*** SUMMARY ***
Total pot $12 | Rake $0.50
Board [6h 2s Ad]
Seat 1: 6hvg964TSqZ3AL/0XK9aVQ (big blind) folded on the Flop
Seat 2: RwDoM55ZeQuI2ADyJhOb2Q (button) (small blind) collected ($11.50)



PokerStars Game #59938456410:  Hold'em No Limit ($1/$2) - 2009/07/01 0:15:25 ET
Table 'WCA60bDA8ecovUgFSIZkTQ' 9-max Seat #2 is the button
Seat 1: CUZwDpLTQKhzarPe+JCLOQ ($211.75 in chips)
Seat 2: G1h8wamBcVJXtsKXZQ2EyA ($98.40 in chips)
Seat 3: 5iPk5MyO3KVu18Y8XCYfFQ ($40 in chips)
Seat 4: Q3uFdu6ztesjDFiqkagTRQ ($464.70 in chips)
Seat 5: Hc2itIxwbi1lwa+DAYYQGg ($306.30 in chips)
Seat 6: DOWQSOJ7GaX+ksfWTqPT5A ($230.75 in chips)
Seat 7: 2YpnxJiexJHyERfbqgwEcw ($58 in chips)
Seat 8: x+V1JgVDawsJTxKcxm7gxw ($91 in chips)
Seat 9: 3q2/0oJr3Mcy1W5tcN61ug ($294.20 in chips)
5iPk5MyO3KVu18Y8XCYfFQ: posts small blind $1
Q3uFdu6ztesjDFiqkagTRQ: posts big blind $2
*** HOLE CARDS ***
Hc2itIxwbi1lwa+DAYYQGg: folds
DOWQSOJ7GaX+ksfWTqPT5A: raises $4 to $6
2YpnxJiexJHyERfbqgwEcw: folds
x+V1JgVDawsJTxKcxm7gxw: folds
3q2/0oJr3Mcy1W5tcN61ug: folds
CUZwDpLTQKhzarPe+JCLOQ: folds
G1h8wamBcVJXtsKXZQ2EyA: folds
5iPk5MyO3KVu18Y8XCYfFQ: folds
Q3uFdu6ztesjDFiqkagTRQ: folds
DOWQSOJ7GaX+ksfWTqPT5A collected $5 from pot
DOWQSOJ7GaX+ksfWTqPT5A: doesn't show hand
*** SUMMARY ***
Total pot $5 | Rake $0
Seat 1: CUZwDpLTQKhzarPe+JCLOQ folded before Flop (didn't bet)
Seat 2: G1h8wamBcVJXtsKXZQ2EyA (button) folded before Flop (didn't bet)
Seat 3: 5iPk5MyO3KVu18Y8XCYfFQ (small blind) folded before Flop
Seat 4: Q3uFdu6ztesjDFiqkagTRQ (big blind) folded before Flop
Seat 5: Hc2itIxwbi1lwa+DAYYQGg folded before Flop (didn't bet)
Seat 6: DOWQSOJ7GaX+ksfWTqPT5A collected ($5)
Seat 7: 2YpnxJiexJHyERfbqgwEcw folded before Flop (didn't bet)
Seat 8: x+V1JgVDawsJTxKcxm7gxw folded before Flop (didn't bet)
Seat 9: 3q2/0oJr3Mcy1W5tcN61ug folded before Flop (didn't bet)



PokerStars Game #59938457078:  Hold'em No Limit ($1/$2) - 2009/07/01 0:15:26 ET
Table 'HewZCzVOYGmuLDKthTi5Yw' 6-max Seat #1 is the button
Seat 1: 353332 ($240.20 in chips)
Seat 2: X7GlkHF+lkbarCLuZ4Uf0w ($25 in chips)
Seat 3: WJxW31eStwT28R2X/L8F5A ($40.05 in chips)
Seat 5: 513FcCI8jHyQy2VWoIQkMg ($391.80 in chips)
X7GlkHF+lkbarCLuZ4Uf0w: posts small blind $1
WJxW31eStwT28R2X/L8F5A: posts big blind $2
*** HOLE CARDS ***
513FcCI8jHyQy2VWoIQkMg: raises $3 to $5
353332: folds
X7GlkHF+lkbarCLuZ4Uf0w: folds
WJxW31eStwT28R2X/L8F5A: calls $3
*** FLOP *** [Qs 6d 4h]
WJxW31eStwT28R2X/L8F5A: checks
513FcCI8jHyQy2VWoIQkMg: checks
*** TURN *** [Qs 6d 4h] [Tc]
WJxW31eStwT28R2X/L8F5A: bets $4
513FcCI8jHyQy2VWoIQkMg: calls $4
*** RIVER *** [Qs 6d 4h Tc] [Jd]
WJxW31eStwT28R2X/L8F5A: bets $4
jAWL00OhCFkIBMd/+4Fzsw joins the table at seat #6
513FcCI8jHyQy2VWoIQkMg: raises $14 to $18
WJxW31eStwT28R2X/L8F5A: folds
513FcCI8jHyQy2VWoIQkMg collected $25.70 from pot
*** SUMMARY ***
Total pot $27 | Rake $1.30
Board [Qs 6d 4h Tc Jd]
Seat 1: 353332 (button) folded before Flop (didn't bet)
Seat 2: X7GlkHF+lkbarCLuZ4Uf0w (small blind) folded before Flop
Seat 3: WJxW31eStwT28R2X/L8F5A (big blind) folded on the River
Seat 5: 513FcCI8jHyQy2VWoIQkMg collected ($25.70)



PokerStars Game #59938458572:  Hold'em No Limit ($1/$2) - 2009/07/01 0:15:28 ET
Table 'rsKRKlGHlxVyqJxzO2a2Ow' 9-max Seat #1 is the button
Seat 1: uYWfQJg2hgHLxri6/uVJiw ($113.10 in chips)
Seat 2: QHxJjpVYwitg9krW6wZgJA ($256.55 in chips)
Seat 3: 9sYbXdhj1M2bwKrVNxj5+Q ($107.80 in chips)
Seat 4: zJtQ1gxyi72XvGYS1tM+DA ($178.55 in chips)
Seat 5: 5Q8U6iZbeO7xJSS4qvDP5g ($203 in chips)
Seat 6: H6Z4+qu8gR0VUiPOijndVg ($200 in chips)
Seat 7: kVCeGJ4NY7Fb0W74j1mAqA ($206 in chips)
Seat 8: Hc2itIxwbi1lwa+DAYYQGg ($34 in chips)
Seat 9: 5iPk5MyO3KVu18Y8XCYfFQ ($121 in chips)
QHxJjpVYwitg9krW6wZgJA: posts small blind $1
9sYbXdhj1M2bwKrVNxj5+Q: posts big blind $2
*** HOLE CARDS ***
zJtQ1gxyi72XvGYS1tM+DA: folds
5Q8U6iZbeO7xJSS4qvDP5g: folds
H6Z4+qu8gR0VUiPOijndVg: folds
kVCeGJ4NY7Fb0W74j1mAqA: folds
Hc2itIxwbi1lwa+DAYYQGg: folds
5iPk5MyO3KVu18Y8XCYfFQ: folds
uYWfQJg2hgHLxri6/uVJiw: folds
QHxJjpVYwitg9krW6wZgJA: folds
9sYbXdhj1M2bwKrVNxj5+Q collected $2 from pot
*** SUMMARY ***
Total pot $2 | Rake $0
Seat 1: uYWfQJg2hgHLxri6/uVJiw (button) folded before Flop (didn't bet)
Seat 2: QHxJjpVYwitg9krW6wZgJA (small blind) folded before Flop
Seat 3: 9sYbXdhj1M2bwKrVNxj5+Q (big blind) collected ($2)
Seat 4: zJtQ1gxyi72XvGYS1tM+DA folded before Flop (didn't bet)
Seat 5: 5Q8U6iZbeO7xJSS4qvDP5g folded before Flop (didn't bet)
Seat 6: H6Z4+qu8gR0VUiPOijndVg folded before Flop (didn't bet)
Seat 7: kVCeGJ4NY7Fb0W74j1mAqA folded before Flop (didn't bet)
Seat 8: Hc2itIxwbi1lwa+DAYYQGg folded before Flop (didn't bet)
Seat 9: 5iPk5MyO3KVu18Y8XCYfFQ folded before Flop (didn't bet)



PokerStars Game #59938459886:  Hold'em No Limit ($1/$2) - 2009/07/01 0:15:30 ET
Table 'mGpP9StWRnoeiBDExc6Frg' 6-max Seat #5 is the button
Seat 1: zWFU82nxIRvzK4mKiL4m0Q ($67.90 in chips)
Seat 4: qXDd0ZyMIse0OBu8pxeQ3Q ($215 in chips)
Seat 5: d1puGuVBE0fidn+5eRJ0tw ($167 in chips)
Seat 6: X7GlkHF+lkbarCLuZ4Uf0w ($32.45 in chips)
X7GlkHF+lkbarCLuZ4Uf0w: posts small blind $1
zWFU82nxIRvzK4mKiL4m0Q: posts big blind $2
DQlskgG4OtLpF2MVxLwf4A: sits out
*** HOLE CARDS ***
qXDd0ZyMIse0OBu8pxeQ3Q: folds
d1puGuVBE0fidn+5eRJ0tw: folds
X7GlkHF+lkbarCLuZ4Uf0w: raises $3 to $5
zWFU82nxIRvzK4mKiL4m0Q: folds
X7GlkHF+lkbarCLuZ4Uf0w collected $4 from pot
X7GlkHF+lkbarCLuZ4Uf0w: doesn't show hand
*** SUMMARY ***
Total pot $4 | Rake $0
Seat 1: zWFU82nxIRvzK4mKiL4m0Q (big blind) folded before Flop
Seat 4: qXDd0ZyMIse0OBu8pxeQ3Q folded before Flop (didn't bet)
Seat 5: d1puGuVBE0fidn+5eRJ0tw (button) folded before Flop (didn't bet)
Seat 6: X7GlkHF+lkbarCLuZ4Uf0w (small blind) collected ($4)



PokerStars Game #59938461550:  Hold'em No Limit ($1/$2) - 2009/07/01 0:15:32 ET
Table 'eyAQSIlgc2o1Jxvbve4WGg' 9-max Seat #5 is the button
Seat 1: Q3uFdu6ztesjDFiqkagTRQ ($232 in chips)
Seat 3: TAfo4veNRaRlzDXMMYS3Jg ($37 in chips)
Seat 4: miAHPEBdznuHNzK6YM3hRA ($87.80 in chips)
Seat 5: JnV3SM2D6dAFYyGZHHpvrg ($97 in chips)
Seat 6: IikcENBHwoT7snSvBPSc7Q ($186.60 in chips)
Seat 7: QHxJjpVYwitg9krW6wZgJA ($200 in chips)
Seat 8: 5iPk5MyO3KVu18Y8XCYfFQ ($38.60 in chips)
Seat 9: Hc2itIxwbi1lwa+DAYYQGg ($52.85 in chips)
IikcENBHwoT7snSvBPSc7Q: posts small blind $1
QHxJjpVYwitg9krW6wZgJA: posts big blind $2
miAHPEBdznuHNzK6YM3hRA: posts big blind $2
*** HOLE CARDS ***
5iPk5MyO3KVu18Y8XCYfFQ: folds
Hc2itIxwbi1lwa+DAYYQGg: raises $6 to $8
Q3uFdu6ztesjDFiqkagTRQ: folds
TAfo4veNRaRlzDXMMYS3Jg: folds
miAHPEBdznuHNzK6YM3hRA: calls $6
JnV3SM2D6dAFYyGZHHpvrg: folds
IikcENBHwoT7snSvBPSc7Q: calls $7
QHxJjpVYwitg9krW6wZgJA: folds
*** FLOP *** [5h Ks Jc]
IikcENBHwoT7snSvBPSc7Q: checks
Hc2itIxwbi1lwa+DAYYQGg: checks
miAHPEBdznuHNzK6YM3hRA: checks
*** TURN *** [5h Ks Jc] [4h]
IikcENBHwoT7snSvBPSc7Q: checks
Hc2itIxwbi1lwa+DAYYQGg: checks
miAHPEBdznuHNzK6YM3hRA: bets $10
IikcENBHwoT7snSvBPSc7Q: folds
Hc2itIxwbi1lwa+DAYYQGg: folds
miAHPEBdznuHNzK6YM3hRA collected $24.70 from pot
*** SUMMARY ***
Total pot $26 | Rake $1.30
Board [5h Ks Jc 4h]
Seat 1: Q3uFdu6ztesjDFiqkagTRQ folded before Flop (didn't bet)
Seat 3: TAfo4veNRaRlzDXMMYS3Jg folded before Flop (didn't bet)
Seat 4: miAHPEBdznuHNzK6YM3hRA collected ($24.70)
Seat 5: JnV3SM2D6dAFYyGZHHpvrg (button) folded before Flop (didn't bet)
Seat 6: IikcENBHwoT7snSvBPSc7Q (small blind) folded on the Turn
Seat 7: QHxJjpVYwitg9krW6wZgJA (big blind) folded before Flop
Seat 8: 5iPk5MyO3KVu18Y8XCYfFQ folded before Flop (didn't bet)
Seat 9: Hc2itIxwbi1lwa+DAYYQGg folded on the Turn



PokerStars Game #59938461148:  Hold'em No Limit ($1/$2) - 2009/07/01 0:15:32 ET
Table 'RF+CoNlqGlniDSszIP2SGw' 2-max Seat #1 is the button
Seat 1: lce17gGUzV617adMdsa27A ($114 in chips)
Seat 2: pVqEzK9wXlRMECnb1Zg4Zw ($122 in chips)
lce17gGUzV617adMdsa27A: posts small blind $1
pVqEzK9wXlRMECnb1Zg4Zw: posts big blind $2
*** HOLE CARDS ***
lce17gGUzV617adMdsa27A: raises $4 to $6
pVqEzK9wXlRMECnb1Zg4Zw: raises $4 to $10
lce17gGUzV617adMdsa27A: raises $16 to $26
pVqEzK9wXlRMECnb1Zg4Zw: calls $16
*** FLOP *** [4d 4h 8d]
pVqEzK9wXlRMECnb1Zg4Zw: checks
lce17gGUzV617adMdsa27A: bets $36
pVqEzK9wXlRMECnb1Zg4Zw: folds
lce17gGUzV617adMdsa27A collected $51.50 from pot
lce17gGUzV617adMdsa27A: doesn't show hand
*** SUMMARY ***
Total pot $52 | Rake $0.50
Board [4d 4h 8d]
Seat 1: lce17gGUzV617adMdsa27A (button) (small blind) collected ($51.50)
Seat 2: pVqEzK9wXlRMECnb1Zg4Zw (big blind) folded on the Flop



PokerStars Game #59938465772:  Hold'em No Limit ($1/$2) - 2009/07/01 0:15:38 ET
Table '3FGoiEOffWrbgTfsB3t7FA' 2-max Seat #1 is the button
Seat 1: e0oDWyrmgLpR6bROEqw1nQ ($263 in chips)
Seat 2: +sy/nlNI20yZraIjs4AALg ($336.65 in chips)
e0oDWyrmgLpR6bROEqw1nQ: posts small blind $1
+sy/nlNI20yZraIjs4AALg: posts big blind $2
*** HOLE CARDS ***
e0oDWyrmgLpR6bROEqw1nQ: raises $4 to $6
+sy/nlNI20yZraIjs4AALg: calls $4
*** FLOP *** [3h 4s 2s]
+sy/nlNI20yZraIjs4AALg: checks
e0oDWyrmgLpR6bROEqw1nQ: bets $8
+sy/nlNI20yZraIjs4AALg: calls $8
*** TURN *** [3h 4s 2s] [Qh]
+sy/nlNI20yZraIjs4AALg: checks
e0oDWyrmgLpR6bROEqw1nQ: bets $20
+sy/nlNI20yZraIjs4AALg: raises $20 to $40
e0oDWyrmgLpR6bROEqw1nQ: calls $20
*** RIVER *** [3h 4s 2s Qh] [As]
+sy/nlNI20yZraIjs4AALg: checks
e0oDWyrmgLpR6bROEqw1nQ: checks
*** SHOW DOWN ***
+sy/nlNI20yZraIjs4AALg: shows [Qc 6h] (a pair of Queens)
e0oDWyrmgLpR6bROEqw1nQ: shows [Qs 7c] (a pair of Queens - Ace+Seven kicker)
e0oDWyrmgLpR6bROEqw1nQ collected $107.50 from pot
*** SUMMARY ***
Total pot $108 | Rake $0.50
Board [3h 4s 2s Qh As]
Seat 1: e0oDWyrmgLpR6bROEqw1nQ (button) (small blind) showed [Qs 7c] and won ($107.50) with a pair of Queens
Seat 2: +sy/nlNI20yZraIjs4AALg (big blind) showed [Qc 6h] and lost with a pair of Queens



PokerStars Game #59938467674:  Hold'em No Limit ($1/$2) - 2009/07/01 0:15:41 ET
Table 'NmY84NAf9Mh0ckAckHnh5g' 2-max Seat #1 is the button
Seat 1: 6hvg964TSqZ3AL/0XK9aVQ ($350.25 in chips)
Seat 2: RwDoM55ZeQuI2ADyJhOb2Q ($236.35 in chips)
6hvg964TSqZ3AL/0XK9aVQ: posts small blind $1
RwDoM55ZeQuI2ADyJhOb2Q: posts big blind $2
*** HOLE CARDS ***
6hvg964TSqZ3AL/0XK9aVQ: folds
RwDoM55ZeQuI2ADyJhOb2Q collected $2 from pot
RwDoM55ZeQuI2ADyJhOb2Q: doesn't show hand
*** SUMMARY ***
Total pot $2 | Rake $0
Seat 1: 6hvg964TSqZ3AL/0XK9aVQ (button) (small blind) folded before Flop
Seat 2: RwDoM55ZeQuI2ADyJhOb2Q (big blind) collected ($2)



PokerStars Game #59938468794:  Hold'em No Limit ($1/$2) - 2009/07/01 0:15:42 ET
Table 'srul5UFZXTEccVV5fpY91g' 9-max Seat #3 is the button
Seat 1: lfD8cBv31A/pio3pXJbPjA ($171.20 in chips)
Seat 2: tJYod1SLp2AcWPL/3hZ7ug ($87.20 in chips)
Seat 3: weUZ8S7tgbaeIpzi1gBNxQ ($48.75 in chips)
Seat 4: GG5lTuGt3+kwNYSbqeB6yw ($82.60 in chips)
Seat 5: 5iPk5MyO3KVu18Y8XCYfFQ ($43.10 in chips)
Seat 6: TAfo4veNRaRlzDXMMYS3Jg ($36 in chips)
Seat 7: s0erZsDxbZSaEPheMgibKg ($480.40 in chips)
GG5lTuGt3+kwNYSbqeB6yw: posts small blind $1
5iPk5MyO3KVu18Y8XCYfFQ: posts big blind $2
*** HOLE CARDS ***
TAfo4veNRaRlzDXMMYS3Jg: folds
s0erZsDxbZSaEPheMgibKg: raises $4 to $6
lfD8cBv31A/pio3pXJbPjA: folds
tJYod1SLp2AcWPL/3hZ7ug: folds
weUZ8S7tgbaeIpzi1gBNxQ: folds
GG5lTuGt3+kwNYSbqeB6yw: calls $5
5iPk5MyO3KVu18Y8XCYfFQ: folds
*** FLOP *** [5s 6h 4c]
GG5lTuGt3+kwNYSbqeB6yw: checks
s0erZsDxbZSaEPheMgibKg: bets $10
GG5lTuGt3+kwNYSbqeB6yw: calls $10
*** TURN *** [5s 6h 4c] [6d]
GG5lTuGt3+kwNYSbqeB6yw: checks
s0erZsDxbZSaEPheMgibKg: checks
*** RIVER *** [5s 6h 4c 6d] [4s]
GG5lTuGt3+kwNYSbqeB6yw: bets $6
s0erZsDxbZSaEPheMgibKg: calls $6
*** SHOW DOWN ***
GG5lTuGt3+kwNYSbqeB6yw: shows [8s 8c] (two pair, Eights and Sixes)
s0erZsDxbZSaEPheMgibKg: mucks hand
GG5lTuGt3+kwNYSbqeB6yw collected $43.80 from pot
*** SUMMARY ***
Total pot $46 | Rake $2.20
Board [5s 6h 4c 6d 4s]
Seat 1: lfD8cBv31A/pio3pXJbPjA folded before Flop (didn't bet)
Seat 2: tJYod1SLp2AcWPL/3hZ7ug folded before Flop (didn't bet)
Seat 3: weUZ8S7tgbaeIpzi1gBNxQ (button) folded before Flop (didn't bet)
Seat 4: GG5lTuGt3+kwNYSbqeB6yw (small blind) showed [8s 8c] and won ($43.80) with two pair, Eights and Sixes
Seat 5: 5iPk5MyO3KVu18Y8XCYfFQ (big blind) folded before Flop
Seat 6: TAfo4veNRaRlzDXMMYS3Jg folded before Flop (didn't bet)
Seat 7: s0erZsDxbZSaEPheMgibKg mucked



PokerStars Game #59938468192:  Hold'em No Limit ($1/$2) - 2009/07/01 0:15:42 ET
Table 'aSf77Sj8QEnzcc0WaxVD4Q' 6-max Seat #1 is the button
Seat 1: Q3uFdu6ztesjDFiqkagTRQ ($250.20 in chips)
Seat 2: vkfxu8f/jMYKUk6Ly4eujw ($240.75 in chips)
Seat 3: 9dpyyjDTCed6nV7JhaUUpw ($200 in chips)
Seat 4: 513FcCI8jHyQy2VWoIQkMg ($200 in chips)
Seat 5: InmkdI6G8TzSj9NhcCSyPg ($247 in chips)
Seat 6: vkoJRf3gidxY1pPi0AFWww ($315.60 in chips)
vkfxu8f/jMYKUk6Ly4eujw: posts small blind $1
9dpyyjDTCed6nV7JhaUUpw: posts big blind $2
*** HOLE CARDS ***
513FcCI8jHyQy2VWoIQkMg: folds
InmkdI6G8TzSj9NhcCSyPg: folds
vkoJRf3gidxY1pPi0AFWww: folds
Q3uFdu6ztesjDFiqkagTRQ: folds
vkfxu8f/jMYKUk6Ly4eujw: folds
9dpyyjDTCed6nV7JhaUUpw collected $2 from pot
9dpyyjDTCed6nV7JhaUUpw: doesn't show hand
*** SUMMARY ***
Total pot $2 | Rake $0
Seat 1: Q3uFdu6ztesjDFiqkagTRQ (button) folded before Flop (didn't bet)
Seat 2: vkfxu8f/jMYKUk6Ly4eujw (small blind) folded before Flop
Seat 3: 9dpyyjDTCed6nV7JhaUUpw (big blind) collected ($2)
Seat 4: 513FcCI8jHyQy2VWoIQkMg folded before Flop (didn't bet)
Seat 5: InmkdI6G8TzSj9NhcCSyPg folded before Flop (didn't bet)
Seat 6: vkoJRf3gidxY1pPi0AFWww folded before Flop (didn't bet)



PokerStars Game #59938469838:  Hold'em No Limit ($1/$2) - 2009/07/01 0:15:44 ET
Table 'bIihwBANJSFqlHPPtset+w' 9-max Seat #7 is the button
Seat 1: jI3JDUGV63ccqtKgM3vMbw ($159.70 in chips)
Seat 2: lQYT23h5QCUVZAKxjOO39Q ($125.90 in chips)
Seat 3: acnZ0LD5jxKgWIHz+mpQ8Q ($229.25 in chips)
Seat 4: 7WWX5PClBdr/U44gUKBIEA ($296.05 in chips)
Seat 6: 5iPk5MyO3KVu18Y8XCYfFQ ($39 in chips)
Seat 7: 3q2/0oJr3Mcy1W5tcN61ug ($200 in chips)
Seat 8: iMe5yhc+1BaiIPHet3NMrA ($279.65 in chips)
Seat 9: rW/MyplHylMSBRaoRUzWrg ($40 in chips)
iMe5yhc+1BaiIPHet3NMrA: posts small blind $1
rW/MyplHylMSBRaoRUzWrg: posts big blind $2
*** HOLE CARDS ***
jI3JDUGV63ccqtKgM3vMbw: folds
lQYT23h5QCUVZAKxjOO39Q: folds
acnZ0LD5jxKgWIHz+mpQ8Q: folds
7WWX5PClBdr/U44gUKBIEA: folds
5iPk5MyO3KVu18Y8XCYfFQ: folds
3q2/0oJr3Mcy1W5tcN61ug: folds
iMe5yhc+1BaiIPHet3NMrA: folds
rW/MyplHylMSBRaoRUzWrg collected $2 from pot
rW/MyplHylMSBRaoRUzWrg: doesn't show hand
*** SUMMARY ***
Total pot $2 | Rake $0
Seat 1: jI3JDUGV63ccqtKgM3vMbw folded before Flop (didn't bet)
Seat 2: lQYT23h5QCUVZAKxjOO39Q folded before Flop (didn't bet)
Seat 3: acnZ0LD5jxKgWIHz+mpQ8Q folded before Flop (didn't bet)
Seat 4: 7WWX5PClBdr/U44gUKBIEA folded before Flop (didn't bet)
Seat 6: 5iPk5MyO3KVu18Y8XCYfFQ folded before Flop (didn't bet)
Seat 7: 3q2/0oJr3Mcy1W5tcN61ug (button) folded before Flop (didn't bet)
Seat 8: iMe5yhc+1BaiIPHet3NMrA (small blind) folded before Flop
Seat 9: rW/MyplHylMSBRaoRUzWrg (big blind) collected ($2)



PokerStars Game #59938471982:  Hold'em No Limit ($1/$2) - 2009/07/01 0:15:47 ET
Table 'NmY84NAf9Mh0ckAckHnh5g' 2-max Seat #2 is the button
Seat 1: 6hvg964TSqZ3AL/0XK9aVQ ($349.25 in chips)
Seat 2: RwDoM55ZeQuI2ADyJhOb2Q ($237.35 in chips)
RwDoM55ZeQuI2ADyJhOb2Q: posts small blind $1
6hvg964TSqZ3AL/0XK9aVQ: posts big blind $2
*** HOLE CARDS ***
RwDoM55ZeQuI2ADyJhOb2Q: folds
6hvg964TSqZ3AL/0XK9aVQ collected $2 from pot
*** SUMMARY ***
Total pot $2 | Rake $0
Seat 1: 6hvg964TSqZ3AL/0XK9aVQ (big blind) collected ($2)
Seat 2: RwDoM55ZeQuI2ADyJhOb2Q (button) (small blind) folded before Flop



PokerStars Game #59938472378:  Hold'em No Limit ($1/$2) - 2009/07/01 0:15:48 ET
Table 'mGpP9StWRnoeiBDExc6Frg' 6-max Seat #6 is the button
Seat 1: zWFU82nxIRvzK4mKiL4m0Q ($65.90 in chips)
Seat 2: DQlskgG4OtLpF2MVxLwf4A ($200 in chips)
Seat 4: qXDd0ZyMIse0OBu8pxeQ3Q ($215 in chips)
Seat 5: d1puGuVBE0fidn+5eRJ0tw ($167 in chips)
Seat 6: X7GlkHF+lkbarCLuZ4Uf0w ($34.45 in chips)
zWFU82nxIRvzK4mKiL4m0Q: posts small blind $1
DQlskgG4OtLpF2MVxLwf4A: posts big blind $2
*** HOLE CARDS ***
qXDd0ZyMIse0OBu8pxeQ3Q: folds
d1puGuVBE0fidn+5eRJ0tw: folds
3HrFUl+TAqSP1U00zz3P7A has returned
X7GlkHF+lkbarCLuZ4Uf0w: raises $2 to $4
zWFU82nxIRvzK4mKiL4m0Q: calls $3
DQlskgG4OtLpF2MVxLwf4A: folds
*** FLOP *** [7d 8s 8d]
zWFU82nxIRvzK4mKiL4m0Q: checks
X7GlkHF+lkbarCLuZ4Uf0w: bets $4
zWFU82nxIRvzK4mKiL4m0Q: calls $4
*** TURN *** [7d 8s 8d] [Kc]
zWFU82nxIRvzK4mKiL4m0Q: checks
X7GlkHF+lkbarCLuZ4Uf0w: checks
*** RIVER *** [7d 8s 8d Kc] [Ts]
zWFU82nxIRvzK4mKiL4m0Q: bets $6
X7GlkHF+lkbarCLuZ4Uf0w: folds
zWFU82nxIRvzK4mKiL4m0Q collected $17.15 from pot
*** SUMMARY ***
Total pot $18 | Rake $0.85
Board [7d 8s 8d Kc Ts]
Seat 1: zWFU82nxIRvzK4mKiL4m0Q (small blind) collected ($17.15)
Seat 2: DQlskgG4OtLpF2MVxLwf4A (big blind) folded before Flop
Seat 4: qXDd0ZyMIse0OBu8pxeQ3Q folded before Flop (didn't bet)
Seat 5: d1puGuVBE0fidn+5eRJ0tw folded before Flop (didn't bet)
Seat 6: X7GlkHF+lkbarCLuZ4Uf0w (button) folded on the River



PokerStars Game #59938475498:  Hold'em No Limit ($1/$2) - 2009/07/01 0:15:52 ET
Table 'XP2sRSup+aRuwzx3vDZsDg' 6-max Seat #4 is the button
Seat 1: o9jamqIi6sTTRSqudgboRA ($240.70 in chips)
Seat 2: Ep0hd57w9DDqfTwA66dJVw ($78 in chips)
Seat 3: X7GlkHF+lkbarCLuZ4Uf0w ($37 in chips)
Seat 4: JsC+WvfzqlxVs9G8/gSQAQ ($121.05 in chips)
Seat 5: 894kvCY4GHivBpqwizsecg ($118 in chips)
Seat 6: h7ppRQJTYBsHCbLMeW9T2g ($478.75 in chips)
894kvCY4GHivBpqwizsecg: posts small blind $1
h7ppRQJTYBsHCbLMeW9T2g: posts big blind $2
Ep0hd57w9DDqfTwA66dJVw: posts big blind $2
*** HOLE CARDS ***
o9jamqIi6sTTRSqudgboRA: folds
Ep0hd57w9DDqfTwA66dJVw: checks
X7GlkHF+lkbarCLuZ4Uf0w: folds
JsC+WvfzqlxVs9G8/gSQAQ: raises $8 to $10
894kvCY4GHivBpqwizsecg: folds
h7ppRQJTYBsHCbLMeW9T2g: folds
Ep0hd57w9DDqfTwA66dJVw: calls $8
*** FLOP *** [8h Tc Js]
Ep0hd57w9DDqfTwA66dJVw: bets $4
JsC+WvfzqlxVs9G8/gSQAQ: raises $24 to $28
Ep0hd57w9DDqfTwA66dJVw: folds
JsC+WvfzqlxVs9G8/gSQAQ collected $29.55 from pot
*** SUMMARY ***
Total pot $31 | Rake $1.45
Board [8h Tc Js]
Seat 1: o9jamqIi6sTTRSqudgboRA folded before Flop (didn't bet)
Seat 2: Ep0hd57w9DDqfTwA66dJVw folded on the Flop
Seat 3: X7GlkHF+lkbarCLuZ4Uf0w folded before Flop (didn't bet)
Seat 4: JsC+WvfzqlxVs9G8/gSQAQ (button) collected ($29.55)
Seat 5: 894kvCY4GHivBpqwizsecg (small blind) folded before Flop
Seat 6: h7ppRQJTYBsHCbLMeW9T2g (big blind) folded before Flop



PokerStars Game #59938476318:  Hold'em No Limit ($1/$2) - 2009/07/01 0:15:53 ET
Table 'NmY84NAf9Mh0ckAckHnh5g' 2-max Seat #1 is the button
Seat 1: 6hvg964TSqZ3AL/0XK9aVQ ($350.25 in chips)
Seat 2: RwDoM55ZeQuI2ADyJhOb2Q ($236.35 in chips)
6hvg964TSqZ3AL/0XK9aVQ: posts small blind $1
RwDoM55ZeQuI2ADyJhOb2Q: posts big blind $2
*** HOLE CARDS ***
6hvg964TSqZ3AL/0XK9aVQ: calls $1
RwDoM55ZeQuI2ADyJhOb2Q: checks
*** FLOP *** [7s Kc Jd]
RwDoM55ZeQuI2ADyJhOb2Q: checks
6hvg964TSqZ3AL/0XK9aVQ: checks
*** TURN *** [7s Kc Jd] [Kd]
RwDoM55ZeQuI2ADyJhOb2Q: bets $4
6hvg964TSqZ3AL/0XK9aVQ: calls $4
*** RIVER *** [7s Kc Jd Kd] [2d]
RwDoM55ZeQuI2ADyJhOb2Q: bets $10
6hvg964TSqZ3AL/0XK9aVQ: raises $20 to $30
RwDoM55ZeQuI2ADyJhOb2Q: raises $200.35 to $230.35 and is all-in
6hvg964TSqZ3AL/0XK9aVQ: calls $200.35
*** SHOW DOWN ***
RwDoM55ZeQuI2ADyJhOb2Q: shows [4d 6d] (a flush, King high)
6hvg964TSqZ3AL/0XK9aVQ: shows [Ad 5d] (a flush, Ace high)
6hvg964TSqZ3AL/0XK9aVQ collected $472.20 from pot
*** SUMMARY ***
Total pot $472.70 | Rake $0.50
Board [7s Kc Jd Kd 2d]
Seat 1: 6hvg964TSqZ3AL/0XK9aVQ (button) (small blind) showed [Ad 5d] and won ($472.20) with a flush, Ace high
Seat 2: RwDoM55ZeQuI2ADyJhOb2Q (big blind) showed [4d 6d] and lost with a flush, King high



PokerStars Game #59938477158:  Hold'em No Limit ($1/$2) - 2009/07/01 0:15:55 ET
Table 'WCA60bDA8ecovUgFSIZkTQ' 9-max Seat #3 is the button
Seat 1: CUZwDpLTQKhzarPe+JCLOQ ($211.75 in chips)
Seat 2: G1h8wamBcVJXtsKXZQ2EyA ($98.40 in chips)
Seat 3: 5iPk5MyO3KVu18Y8XCYfFQ ($39 in chips)
Seat 4: Q3uFdu6ztesjDFiqkagTRQ ($462.70 in chips)
Seat 5: Hc2itIxwbi1lwa+DAYYQGg ($306.30 in chips)
Seat 6: DOWQSOJ7GaX+ksfWTqPT5A ($233.75 in chips)
Seat 7: 2YpnxJiexJHyERfbqgwEcw ($58 in chips)
Seat 8: x+V1JgVDawsJTxKcxm7gxw ($91 in chips)
Seat 9: 3q2/0oJr3Mcy1W5tcN61ug ($294.20 in chips)
Q3uFdu6ztesjDFiqkagTRQ: posts small blind $1
Hc2itIxwbi1lwa+DAYYQGg: posts big blind $2
*** HOLE CARDS ***
DOWQSOJ7GaX+ksfWTqPT5A: calls $2
2YpnxJiexJHyERfbqgwEcw: folds
x+V1JgVDawsJTxKcxm7gxw: folds
3q2/0oJr3Mcy1W5tcN61ug: folds
CUZwDpLTQKhzarPe+JCLOQ: folds
G1h8wamBcVJXtsKXZQ2EyA: folds
5iPk5MyO3KVu18Y8XCYfFQ: folds
Q3uFdu6ztesjDFiqkagTRQ: folds
Hc2itIxwbi1lwa+DAYYQGg: checks
*** FLOP *** [4d Ks Tc]
Hc2itIxwbi1lwa+DAYYQGg: checks
DOWQSOJ7GaX+ksfWTqPT5A: checks
*** TURN *** [4d Ks Tc] [Qs]
Hc2itIxwbi1lwa+DAYYQGg: checks
DOWQSOJ7GaX+ksfWTqPT5A: checks
*** RIVER *** [4d Ks Tc Qs] [Kd]
Hc2itIxwbi1lwa+DAYYQGg: checks
DOWQSOJ7GaX+ksfWTqPT5A: checks
*** SHOW DOWN ***
Hc2itIxwbi1lwa+DAYYQGg: shows [7s Jh] (a pair of Kings)
DOWQSOJ7GaX+ksfWTqPT5A: shows [Ah 6h] (a pair of Kings - Ace kicker)
DOWQSOJ7GaX+ksfWTqPT5A collected $4.75 from pot
*** SUMMARY ***
Total pot $5 | Rake $0.25
Board [4d Ks Tc Qs Kd]
Seat 1: CUZwDpLTQKhzarPe+JCLOQ folded before Flop (didn't bet)
Seat 2: G1h8wamBcVJXtsKXZQ2EyA folded before Flop (didn't bet)
Seat 3: 5iPk5MyO3KVu18Y8XCYfFQ (button) folded before Flop (didn't bet)
Seat 4: Q3uFdu6ztesjDFiqkagTRQ (small blind) folded before Flop
Seat 5: Hc2itIxwbi1lwa+DAYYQGg (big blind) showed [7s Jh] and lost with a pair of Kings
Seat 6: DOWQSOJ7GaX+ksfWTqPT5A showed [Ah 6h] and won ($4.75) with a pair of Kings
Seat 7: 2YpnxJiexJHyERfbqgwEcw folded before Flop (didn't bet)
Seat 8: x+V1JgVDawsJTxKcxm7gxw folded before Flop (didn't bet)
Seat 9: 3q2/0oJr3Mcy1W5tcN61ug folded before Flop (didn't bet)



PokerStars Game #59938477328:  Hold'em No Limit ($1/$2) - 2009/07/01 0:15:55 ET
Table 'rsKRKlGHlxVyqJxzO2a2Ow' 9-max Seat #2 is the button
Seat 1: uYWfQJg2hgHLxri6/uVJiw ($113.10 in chips)
Seat 2: QHxJjpVYwitg9krW6wZgJA ($255.55 in chips)
Seat 3: 9sYbXdhj1M2bwKrVNxj5+Q ($108.80 in chips)
Seat 4: zJtQ1gxyi72XvGYS1tM+DA ($178.55 in chips)
Seat 5: 5Q8U6iZbeO7xJSS4qvDP5g ($203 in chips)
Seat 6: H6Z4+qu8gR0VUiPOijndVg ($200 in chips)
Seat 7: kVCeGJ4NY7Fb0W74j1mAqA ($206 in chips)
Seat 8: Hc2itIxwbi1lwa+DAYYQGg ($34 in chips)
Seat 9: 5iPk5MyO3KVu18Y8XCYfFQ ($121 in chips)
9sYbXdhj1M2bwKrVNxj5+Q: posts small blind $1
zJtQ1gxyi72XvGYS1tM+DA: posts big blind $2
*** HOLE CARDS ***
5Q8U6iZbeO7xJSS4qvDP5g: folds
H6Z4+qu8gR0VUiPOijndVg: folds
kVCeGJ4NY7Fb0W74j1mAqA: folds
Hc2itIxwbi1lwa+DAYYQGg: folds
5iPk5MyO3KVu18Y8XCYfFQ: folds
uYWfQJg2hgHLxri6/uVJiw: raises $4 to $6
QHxJjpVYwitg9krW6wZgJA: folds
9sYbXdhj1M2bwKrVNxj5+Q: folds
zJtQ1gxyi72XvGYS1tM+DA: folds
uYWfQJg2hgHLxri6/uVJiw collected $5 from pot
uYWfQJg2hgHLxri6/uVJiw: doesn't show hand
*** SUMMARY ***
Total pot $5 | Rake $0
Seat 1: uYWfQJg2hgHLxri6/uVJiw collected ($5)
Seat 2: QHxJjpVYwitg9krW6wZgJA (button) folded before Flop (didn't bet)
Seat 3: 9sYbXdhj1M2bwKrVNxj5+Q (small blind) folded before Flop
Seat 4: zJtQ1gxyi72XvGYS1tM+DA (big blind) folded before Flop
Seat 5: 5Q8U6iZbeO7xJSS4qvDP5g folded before Flop (didn't bet)
Seat 6: H6Z4+qu8gR0VUiPOijndVg folded before Flop (didn't bet)
Seat 7: kVCeGJ4NY7Fb0W74j1mAqA folded before Flop (didn't bet)
Seat 8: Hc2itIxwbi1lwa+DAYYQGg folded before Flop (didn't bet)
Seat 9: 5iPk5MyO3KVu18Y8XCYfFQ folded before Flop (didn't bet)



PokerStars Game #59938478192:  Hold'em No Limit ($1/$2) - 2009/07/01 0:15:56 ET
Table 'RF+CoNlqGlniDSszIP2SGw' 2-max Seat #2 is the button
Seat 1: lce17gGUzV617adMdsa27A ($139.50 in chips)
Seat 2: pVqEzK9wXlRMECnb1Zg4Zw ($96 in chips)
pVqEzK9wXlRMECnb1Zg4Zw: posts small blind $1
lce17gGUzV617adMdsa27A: posts big blind $2
*** HOLE CARDS ***
pVqEzK9wXlRMECnb1Zg4Zw: calls $1
lce17gGUzV617adMdsa27A: checks
*** FLOP *** [6h Jc 3c]
lce17gGUzV617adMdsa27A: checks
pVqEzK9wXlRMECnb1Zg4Zw: bets $6
lce17gGUzV617adMdsa27A: folds
pVqEzK9wXlRMECnb1Zg4Zw collected $3.80 from pot
pVqEzK9wXlRMECnb1Zg4Zw: doesn't show hand
*** SUMMARY ***
Total pot $4 | Rake $0.20
Board [6h Jc 3c]
Seat 1: lce17gGUzV617adMdsa27A (big blind) folded on the Flop
Seat 2: pVqEzK9wXlRMECnb1Zg4Zw (button) (small blind) collected ($3.80)



PokerStars Game #59938484194:  Hold'em No Limit ($1/$2) - 2009/07/01 0:16:05 ET
Table 'W9UeSV0aoPjh5SFSxM8jUQ' 9-max Seat #9 is the button
Seat 1: cdC54j9fGGojcbzWB5PgzA ($205.60 in chips)
Seat 2: iMe5yhc+1BaiIPHet3NMrA ($313.75 in chips)
Seat 3: TAfo4veNRaRlzDXMMYS3Jg ($40 in chips)
Seat 4: De9g+AYjo0DN6C/+iT/nsg ($197 in chips)
Seat 6: MXxB6weBWzZyAhRZb+/KVg ($198 in chips)
Seat 7: 4Cl43Q1TYQL8wn1NSCUkaw ($46.60 in chips)
Seat 9: U2A5Hv6ib/5+gzO2wr7Z4w ($200 in chips)
cdC54j9fGGojcbzWB5PgzA: posts small blind $1
iMe5yhc+1BaiIPHet3NMrA: posts big blind $2
CUZwDpLTQKhzarPe+JCLOQ: sits out
*** HOLE CARDS ***
TAfo4veNRaRlzDXMMYS3Jg: folds
De9g+AYjo0DN6C/+iT/nsg: folds
MXxB6weBWzZyAhRZb+/KVg: folds
4Cl43Q1TYQL8wn1NSCUkaw: folds
U2A5Hv6ib/5+gzO2wr7Z4w: folds
cdC54j9fGGojcbzWB5PgzA: folds
iMe5yhc+1BaiIPHet3NMrA collected $2 from pot
*** SUMMARY ***
Total pot $2 | Rake $0
Seat 1: cdC54j9fGGojcbzWB5PgzA (small blind) folded before Flop
Seat 2: iMe5yhc+1BaiIPHet3NMrA (big blind) collected ($2)
Seat 3: TAfo4veNRaRlzDXMMYS3Jg folded before Flop (didn't bet)
Seat 4: De9g+AYjo0DN6C/+iT/nsg folded before Flop (didn't bet)
Seat 6: MXxB6weBWzZyAhRZb+/KVg folded before Flop (didn't bet)
Seat 7: 4Cl43Q1TYQL8wn1NSCUkaw folded before Flop (didn't bet)
Seat 9: U2A5Hv6ib/5+gzO2wr7Z4w (button) folded before Flop (didn't bet)



PokerStars Game #59938487316:  Hold'em No Limit ($1/$2) - 2009/07/01 0:16:09 ET
Table 'RF+CoNlqGlniDSszIP2SGw' 2-max Seat #1 is the button
Seat 1: lce17gGUzV617adMdsa27A ($137.50 in chips)
Seat 2: pVqEzK9wXlRMECnb1Zg4Zw ($123.80 in chips)
lce17gGUzV617adMdsa27A: posts small blind $1
pVqEzK9wXlRMECnb1Zg4Zw: posts big blind $2
*** HOLE CARDS ***
lce17gGUzV617adMdsa27A: raises $4 to $6
pVqEzK9wXlRMECnb1Zg4Zw: raises $4 to $10
lce17gGUzV617adMdsa27A: calls $4
*** FLOP *** [4s 3d Ac]
pVqEzK9wXlRMECnb1Zg4Zw: checks
lce17gGUzV617adMdsa27A: checks
*** TURN *** [4s 3d Ac] [5c]
pVqEzK9wXlRMECnb1Zg4Zw: checks
lce17gGUzV617adMdsa27A: bets $10
pVqEzK9wXlRMECnb1Zg4Zw: folds
lce17gGUzV617adMdsa27A collected $19.50 from pot
lce17gGUzV617adMdsa27A: doesn't show hand
*** SUMMARY ***
Total pot $20 | Rake $0.50
Board [4s 3d Ac 5c]
Seat 1: lce17gGUzV617adMdsa27A (button) (small blind) collected ($19.50)
Seat 2: pVqEzK9wXlRMECnb1Zg4Zw (big blind) folded on the Turn



PokerStars Game #59938487186:  Hold'em No Limit ($1/$2) - 2009/07/01 0:16:09 ET
Table 'on4i1U1lCRmxsduFD3xiSg' 9-max Seat #6 is the button
Seat 1: so5k3vFDmokh2q3dImJ1GQ ($118 in chips)
Seat 2: yZYrOeNDxQxkzpbgKX1bng ($66.65 in chips)
Seat 3: 5iPk5MyO3KVu18Y8XCYfFQ ($61.20 in chips)
Seat 4: Z3aYCZG/yXHYFjiWkGI5ug ($530.10 in chips)
Seat 5: QHxJjpVYwitg9krW6wZgJA ($200 in chips)
Seat 6: CUZwDpLTQKhzarPe+JCLOQ ($214.55 in chips)
Seat 7: xD4ElYxz6Ollzmam8BmMCw ($198 in chips)
Seat 8: cdC54j9fGGojcbzWB5PgzA ($200 in chips)
Seat 9: iMe5yhc+1BaiIPHet3NMrA ($200 in chips)
xD4ElYxz6Ollzmam8BmMCw: posts small blind $1
cdC54j9fGGojcbzWB5PgzA: posts big blind $2
*** HOLE CARDS ***
iMe5yhc+1BaiIPHet3NMrA: folds
so5k3vFDmokh2q3dImJ1GQ: folds
yZYrOeNDxQxkzpbgKX1bng: folds
5iPk5MyO3KVu18Y8XCYfFQ: folds
Z3aYCZG/yXHYFjiWkGI5ug: folds
QHxJjpVYwitg9krW6wZgJA: raises $2 to $4
CUZwDpLTQKhzarPe+JCLOQ: folds
xD4ElYxz6Ollzmam8BmMCw: folds
cdC54j9fGGojcbzWB5PgzA: folds
QHxJjpVYwitg9krW6wZgJA collected $5 from pot
*** SUMMARY ***
Total pot $5 | Rake $0
Seat 1: so5k3vFDmokh2q3dImJ1GQ folded before Flop (didn't bet)
Seat 2: yZYrOeNDxQxkzpbgKX1bng folded before Flop (didn't bet)
Seat 3: 5iPk5MyO3KVu18Y8XCYfFQ folded before Flop (didn't bet)
Seat 4: Z3aYCZG/yXHYFjiWkGI5ug folded before Flop (didn't bet)
Seat 5: QHxJjpVYwitg9krW6wZgJA collected ($5)
Seat 6: CUZwDpLTQKhzarPe+JCLOQ (button) folded before Flop (didn't bet)
Seat 7: xD4ElYxz6Ollzmam8BmMCw (small blind) folded before Flop
Seat 8: cdC54j9fGGojcbzWB5PgzA (big blind) folded before Flop
Seat 9: iMe5yhc+1BaiIPHet3NMrA folded before Flop (didn't bet)



PokerStars Game #59938488460:  Hold'em No Limit ($1/$2) - 2009/07/01 0:16:11 ET
Table 'gnHBqWll9O3fxG7Ojkz/ng' 9-max Seat #6 is the button
Seat 1: hpqdC/23wXosGOmzARr5NA ($152.05 in chips)
Seat 2: H6Z4+qu8gR0VUiPOijndVg ($200 in chips)
Seat 3: 5Q8U6iZbeO7xJSS4qvDP5g ($225.35 in chips)
Seat 4: n5XI5/7gN+gIubHFBH+mOw ($401.15 in chips)
Seat 5: rBQDMkKm9cZn6M9NPsiVew ($117 in chips)
Seat 6: 5iPk5MyO3KVu18Y8XCYfFQ ($58.45 in chips)
Seat 9: kVCeGJ4NY7Fb0W74j1mAqA ($200 in chips)
JpnYBfO6Nq6INmRDDoBX1g will be allowed to play after the button
kVCeGJ4NY7Fb0W74j1mAqA: posts small blind $1
hpqdC/23wXosGOmzARr5NA: posts big blind $2
*** HOLE CARDS ***
H6Z4+qu8gR0VUiPOijndVg: raises $4 to $6
5Q8U6iZbeO7xJSS4qvDP5g: folds
n5XI5/7gN+gIubHFBH+mOw: folds
rBQDMkKm9cZn6M9NPsiVew: folds
5iPk5MyO3KVu18Y8XCYfFQ: folds
kVCeGJ4NY7Fb0W74j1mAqA: folds
hpqdC/23wXosGOmzARr5NA: folds
H6Z4+qu8gR0VUiPOijndVg collected $5 from pot
H6Z4+qu8gR0VUiPOijndVg: doesn't show hand
*** SUMMARY ***
Total pot $5 | Rake $0
Seat 1: hpqdC/23wXosGOmzARr5NA (big blind) folded before Flop
Seat 2: H6Z4+qu8gR0VUiPOijndVg collected ($5)
Seat 3: 5Q8U6iZbeO7xJSS4qvDP5g folded before Flop (didn't bet)
Seat 4: n5XI5/7gN+gIubHFBH+mOw folded before Flop (didn't bet)
Seat 5: rBQDMkKm9cZn6M9NPsiVew folded before Flop (didn't bet)
Seat 6: 5iPk5MyO3KVu18Y8XCYfFQ (button) folded before Flop (didn't bet)
Seat 9: kVCeGJ4NY7Fb0W74j1mAqA (small blind) folded before Flop



PokerStars Game #59938491298:  Hold'em No Limit ($1/$2) - 2009/07/01 0:16:15 ET
Table 'bIihwBANJSFqlHPPtset+w' 9-max Seat #8 is the button
Seat 1: jI3JDUGV63ccqtKgM3vMbw ($159.70 in chips)
Seat 2: lQYT23h5QCUVZAKxjOO39Q ($125.90 in chips)
Seat 3: acnZ0LD5jxKgWIHz+mpQ8Q ($229.25 in chips)
Seat 4: 7WWX5PClBdr/U44gUKBIEA ($296.05 in chips)
Seat 6: 5iPk5MyO3KVu18Y8XCYfFQ ($39 in chips)
Seat 7: 3q2/0oJr3Mcy1W5tcN61ug ($200 in chips)
Seat 8: iMe5yhc+1BaiIPHet3NMrA ($278.65 in chips)
Seat 9: rW/MyplHylMSBRaoRUzWrg ($41 in chips)
rW/MyplHylMSBRaoRUzWrg: posts small blind $1
jI3JDUGV63ccqtKgM3vMbw: posts big blind $2
*** HOLE CARDS ***
lQYT23h5QCUVZAKxjOO39Q: folds
acnZ0LD5jxKgWIHz+mpQ8Q: raises $4 to $6
7WWX5PClBdr/U44gUKBIEA: folds
5iPk5MyO3KVu18Y8XCYfFQ: raises $33 to $39 and is all-in
3q2/0oJr3Mcy1W5tcN61ug: folds
iMe5yhc+1BaiIPHet3NMrA: folds
rW/MyplHylMSBRaoRUzWrg: raises $2 to $41 and is all-in
jI3JDUGV63ccqtKgM3vMbw: folds
acnZ0LD5jxKgWIHz+mpQ8Q: folds
*** FLOP *** [5h 4d As]
*** TURN *** [5h 4d As] [6c]
*** RIVER *** [5h 4d As 6c] [6h]
*** SHOW DOWN ***
rW/MyplHylMSBRaoRUzWrg: shows [Qc Qs] (two pair, Queens and Sixes)
5iPk5MyO3KVu18Y8XCYfFQ: shows [Kc Kh] (two pair, Kings and Sixes)
5iPk5MyO3KVu18Y8XCYfFQ collected $83 from pot
*** SUMMARY ***
Total pot $86 | Rake $3
Board [5h 4d As 6c 6h]
Seat 1: jI3JDUGV63ccqtKgM3vMbw (big blind) folded before Flop
Seat 2: lQYT23h5QCUVZAKxjOO39Q folded before Flop (didn't bet)
Seat 3: acnZ0LD5jxKgWIHz+mpQ8Q folded before Flop
Seat 4: 7WWX5PClBdr/U44gUKBIEA folded before Flop (didn't bet)
Seat 6: 5iPk5MyO3KVu18Y8XCYfFQ showed [Kc Kh] and won ($83) with two pair, Kings and Sixes
Seat 7: 3q2/0oJr3Mcy1W5tcN61ug folded before Flop (didn't bet)
Seat 8: iMe5yhc+1BaiIPHet3NMrA (button) folded before Flop (didn't bet)
Seat 9: rW/MyplHylMSBRaoRUzWrg (small blind) showed [Qc Qs] and lost with two pair, Queens and Sixes



PokerStars Game #59938492020:  Hold'em No Limit ($1/$2) - 2009/07/01 0:16:16 ET
Table 'l5lZHc5JRHEDt0Y2AVPq3g' 6-max Seat #6 is the button
Seat 1: gGPaCoSWW1HoKYaqfAPecg ($228.20 in chips)
Seat 2: /PH6Ffnho4Ysm8S3V/oa+w ($40 in chips)
Seat 4: zNjJ/y4emmF+vzrCDd+ooA ($200.65 in chips)
Seat 5: X7GlkHF+lkbarCLuZ4Uf0w ($52.85 in chips)
Seat 6: vkfxu8f/jMYKUk6Ly4eujw ($189.30 in chips)
gGPaCoSWW1HoKYaqfAPecg: posts small blind $1
/PH6Ffnho4Ysm8S3V/oa+w: posts big blind $2
DQlskgG4OtLpF2MVxLwf4A: sits out
*** HOLE CARDS ***
zNjJ/y4emmF+vzrCDd+ooA: folds
X7GlkHF+lkbarCLuZ4Uf0w: raises $2 to $4
vkfxu8f/jMYKUk6Ly4eujw: folds
gGPaCoSWW1HoKYaqfAPecg: folds
/PH6Ffnho4Ysm8S3V/oa+w: folds
X7GlkHF+lkbarCLuZ4Uf0w collected $5 from pot
X7GlkHF+lkbarCLuZ4Uf0w: doesn't show hand
*** SUMMARY ***
Total pot $5 | Rake $0
Seat 1: gGPaCoSWW1HoKYaqfAPecg (small blind) folded before Flop
Seat 2: /PH6Ffnho4Ysm8S3V/oa+w (big blind) folded before Flop
Seat 4: zNjJ/y4emmF+vzrCDd+ooA folded before Flop (didn't bet)
Seat 5: X7GlkHF+lkbarCLuZ4Uf0w collected ($5)
Seat 6: vkfxu8f/jMYKUk6Ly4eujw (button) folded before Flop (didn't bet)



PokerStars Game #59938491974:  Hold'em No Limit ($1/$2) - 2009/07/01 0:16:16 ET
Table 'aSf77Sj8QEnzcc0WaxVD4Q' 6-max Seat #2 is the button
Seat 1: Q3uFdu6ztesjDFiqkagTRQ ($250.20 in chips)
Seat 2: vkfxu8f/jMYKUk6Ly4eujw ($239.75 in chips)
Seat 3: 9dpyyjDTCed6nV7JhaUUpw ($201 in chips)
Seat 4: 513FcCI8jHyQy2VWoIQkMg ($200 in chips)
Seat 5: InmkdI6G8TzSj9NhcCSyPg ($247 in chips)
Seat 6: vkoJRf3gidxY1pPi0AFWww ($315.60 in chips)
9dpyyjDTCed6nV7JhaUUpw: posts small blind $1
513FcCI8jHyQy2VWoIQkMg: posts big blind $2
*** HOLE CARDS ***
InmkdI6G8TzSj9NhcCSyPg: folds
vkoJRf3gidxY1pPi0AFWww: calls $2
Q3uFdu6ztesjDFiqkagTRQ: folds
vkfxu8f/jMYKUk6Ly4eujw: raises $5 to $7
9dpyyjDTCed6nV7JhaUUpw: folds
513FcCI8jHyQy2VWoIQkMg: folds
vkoJRf3gidxY1pPi0AFWww: calls $5
*** FLOP *** [Qs Qh 3h]
vkoJRf3gidxY1pPi0AFWww: bets $8
vkfxu8f/jMYKUk6Ly4eujw: raises $32 to $40
vkoJRf3gidxY1pPi0AFWww: folds
vkfxu8f/jMYKUk6Ly4eujw collected $31.40 from pot
vkfxu8f/jMYKUk6Ly4eujw: doesn't show hand
*** SUMMARY ***
Total pot $33 | Rake $1.60
Board [Qs Qh 3h]
Seat 1: Q3uFdu6ztesjDFiqkagTRQ folded before Flop (didn't bet)
Seat 2: vkfxu8f/jMYKUk6Ly4eujw (button) collected ($31.40)
Seat 3: 9dpyyjDTCed6nV7JhaUUpw (small blind) folded before Flop
Seat 4: 513FcCI8jHyQy2VWoIQkMg (big blind) folded before Flop
Seat 5: InmkdI6G8TzSj9NhcCSyPg folded before Flop (didn't bet)
Seat 6: vkoJRf3gidxY1pPi0AFWww folded on the Flop



PokerStars Game #59938494710:  Hold'em No Limit ($1/$2) - 2009/07/01 0:16:20 ET
Table 'qVXak+oTeDXMGbWa4sDU5Q' 9-max Seat #6 is the button
Seat 1: H6Z4+qu8gR0VUiPOijndVg ($254.30 in chips)
Seat 2: Hc2itIxwbi1lwa+DAYYQGg ($46 in chips)
Seat 3: oz9eCXGC7DdjQlL/nuWj1A ($120.65 in chips)
Seat 4: b0jO1SDhLedy1//CQlA8kw ($40 in chips)
Seat 5: NqKRc5xvcye0d7F6VOF6MQ ($82.50 in chips)
Seat 6: Q3uFdu6ztesjDFiqkagTRQ ($200 in chips)
Seat 7: 5iPk5MyO3KVu18Y8XCYfFQ ($113 in chips)
Seat 8: 9pHZMviI9R8injxojGTnvw ($115.80 in chips)
Seat 9: IZ/2qsh1CIg9m5PWsMsLmA ($351.95 in chips)
5iPk5MyO3KVu18Y8XCYfFQ: posts small blind $1
9pHZMviI9R8injxojGTnvw: posts big blind $2
*** HOLE CARDS ***
IZ/2qsh1CIg9m5PWsMsLmA: folds
H6Z4+qu8gR0VUiPOijndVg: folds
Hc2itIxwbi1lwa+DAYYQGg: folds
oz9eCXGC7DdjQlL/nuWj1A: folds
b0jO1SDhLedy1//CQlA8kw: folds
NqKRc5xvcye0d7F6VOF6MQ: folds
IZ/2qsh1CIg9m5PWsMsLmA leaves the table
Q3uFdu6ztesjDFiqkagTRQ: folds
5iPk5MyO3KVu18Y8XCYfFQ: raises $2 to $4
ZP45Tu5Zqo4v+ZgqIQVoOQ joins the table at seat #9
9pHZMviI9R8injxojGTnvw: raises $8 to $12
5iPk5MyO3KVu18Y8XCYfFQ: folds
9pHZMviI9R8injxojGTnvw collected $8 from pot
*** SUMMARY ***
Total pot $8 | Rake $0
Seat 1: H6Z4+qu8gR0VUiPOijndVg folded before Flop (didn't bet)
Seat 2: Hc2itIxwbi1lwa+DAYYQGg folded before Flop (didn't bet)
Seat 3: oz9eCXGC7DdjQlL/nuWj1A folded before Flop (didn't bet)
Seat 4: b0jO1SDhLedy1//CQlA8kw folded before Flop (didn't bet)
Seat 5: NqKRc5xvcye0d7F6VOF6MQ folded before Flop (didn't bet)
Seat 6: Q3uFdu6ztesjDFiqkagTRQ (button) folded before Flop (didn't bet)
Seat 7: 5iPk5MyO3KVu18Y8XCYfFQ (small blind) folded before Flop
Seat 8: 9pHZMviI9R8injxojGTnvw (big blind) collected ($8)
Seat 9: IZ/2qsh1CIg9m5PWsMsLmA folded before Flop (didn't bet)



PokerStars Game #59938495556:  Hold'em No Limit ($1/$2) - 2009/07/01 0:16:21 ET
Table 'ZzSIe0zTCDv+n6hfbY5tTg' 6-max Seat #6 is the button
Seat 1: 8srN1dKQePlsv0GyTada+Q ($264.70 in chips)
Seat 2: B87ikIyZ/TzAVeXf38Ny0g ($200 in chips)
Seat 4: ky55L0pITYgYLeqFB9gP/Q ($147.40 in chips)
Seat 5: Q3uFdu6ztesjDFiqkagTRQ ($200 in chips)
Seat 6: InmkdI6G8TzSj9NhcCSyPg ($200 in chips)
8srN1dKQePlsv0GyTada+Q: posts small blind $1
B87ikIyZ/TzAVeXf38Ny0g: posts big blind $2
*** HOLE CARDS ***
ky55L0pITYgYLeqFB9gP/Q: calls $2
Q3uFdu6ztesjDFiqkagTRQ: raises $10 to $12
InmkdI6G8TzSj9NhcCSyPg: folds
8srN1dKQePlsv0GyTada+Q: folds
X7GlkHF+lkbarCLuZ4Uf0w joins the table at seat #3
B87ikIyZ/TzAVeXf38Ny0g: folds
ky55L0pITYgYLeqFB9gP/Q: calls $10
*** FLOP *** [7s Qs 7h]
ky55L0pITYgYLeqFB9gP/Q: checks
Q3uFdu6ztesjDFiqkagTRQ: bets $18
ky55L0pITYgYLeqFB9gP/Q: folds
Q3uFdu6ztesjDFiqkagTRQ collected $25.65 from pot
Q3uFdu6ztesjDFiqkagTRQ: doesn't show hand
*** SUMMARY ***
Total pot $27 | Rake $1.35
Board [7s Qs 7h]
Seat 1: 8srN1dKQePlsv0GyTada+Q (small blind) folded before Flop
Seat 2: B87ikIyZ/TzAVeXf38Ny0g (big blind) folded before Flop
Seat 4: ky55L0pITYgYLeqFB9gP/Q folded on the Flop
Seat 5: Q3uFdu6ztesjDFiqkagTRQ collected ($25.65)
Seat 6: InmkdI6G8TzSj9NhcCSyPg (button) folded before Flop (didn't bet)



PokerStars Game #59938497514:  Hold'em No Limit ($1/$2) - 2009/07/01 0:16:24 ET
Table 'SF49/KQm8T4taMp6kb+HXA' 9-max Seat #1 is the button
Seat 1: l1bCLGuFqeFRwUfPsiDu/g ($166.95 in chips)
Seat 2: 8Z3QifiM9eOd5EIJ25dXNg ($101.35 in chips)
Seat 4: HffgoYm61KgkdMe/DYChIQ ($123 in chips)
Seat 5: Z3aYCZG/yXHYFjiWkGI5ug ($226.55 in chips)
Seat 6: M2ht6rIKOI/my9eh610Nlw ($228.40 in chips)
Seat 7: n2VAbLaE5qgKr5mA4W6v4w ($43.50 in chips)
Seat 8: 5iPk5MyO3KVu18Y8XCYfFQ ($43 in chips)
Seat 9: O+jytCilwk7zItVCEavmtw ($128.20 in chips)
8Z3QifiM9eOd5EIJ25dXNg: posts small blind $1
HffgoYm61KgkdMe/DYChIQ: posts big blind $2
*** HOLE CARDS ***
Z3aYCZG/yXHYFjiWkGI5ug: folds
M2ht6rIKOI/my9eh610Nlw: folds
n2VAbLaE5qgKr5mA4W6v4w: calls $2
5iPk5MyO3KVu18Y8XCYfFQ: folds
O+jytCilwk7zItVCEavmtw: folds
l1bCLGuFqeFRwUfPsiDu/g: raises $6 to $8
8Z3QifiM9eOd5EIJ25dXNg: calls $7
HffgoYm61KgkdMe/DYChIQ: calls $6
n2VAbLaE5qgKr5mA4W6v4w: calls $6
*** FLOP *** [4s Jh Ad]
8Z3QifiM9eOd5EIJ25dXNg: bets $8
HffgoYm61KgkdMe/DYChIQ: folds
n2VAbLaE5qgKr5mA4W6v4w: folds
l1bCLGuFqeFRwUfPsiDu/g: raises $12 to $20
8Z3QifiM9eOd5EIJ25dXNg: calls $12
*** TURN *** [4s Jh Ad] [4h]
8Z3QifiM9eOd5EIJ25dXNg: checks
l1bCLGuFqeFRwUfPsiDu/g: checks
*** RIVER *** [4s Jh Ad 4h] [Qd]
8Z3QifiM9eOd5EIJ25dXNg: checks
l1bCLGuFqeFRwUfPsiDu/g: bets $28
8Z3QifiM9eOd5EIJ25dXNg: calls $28
*** SHOW DOWN ***
l1bCLGuFqeFRwUfPsiDu/g: shows [Ac Qc] (two pair, Aces and Queens)
8Z3QifiM9eOd5EIJ25dXNg: mucks hand
l1bCLGuFqeFRwUfPsiDu/g collected $125 from pot
*** SUMMARY ***
Total pot $128 | Rake $3
Board [4s Jh Ad 4h Qd]
Seat 1: l1bCLGuFqeFRwUfPsiDu/g (button) showed [Ac Qc] and won ($125) with two pair, Aces and Queens
Seat 2: 8Z3QifiM9eOd5EIJ25dXNg (small blind) mucked
Seat 4: HffgoYm61KgkdMe/DYChIQ (big blind) folded on the Flop
Seat 5: Z3aYCZG/yXHYFjiWkGI5ug folded before Flop (didn't bet)
Seat 6: M2ht6rIKOI/my9eh610Nlw folded before Flop (didn't bet)
Seat 7: n2VAbLaE5qgKr5mA4W6v4w folded on the Flop
Seat 8: 5iPk5MyO3KVu18Y8XCYfFQ folded before Flop (didn't bet)
Seat 9: O+jytCilwk7zItVCEavmtw folded before Flop (didn't bet)



PokerStars Game #59938497968:  Hold'em No Limit ($1/$2) - 2009/07/01 0:16:25 ET
Table 'NmY84NAf9Mh0ckAckHnh5g' 2-max Seat #2 is the button
Seat 1: 6hvg964TSqZ3AL/0XK9aVQ ($586.10 in chips)
Seat 2: RwDoM55ZeQuI2ADyJhOb2Q ($40 in chips)
RwDoM55ZeQuI2ADyJhOb2Q: posts small blind $1
6hvg964TSqZ3AL/0XK9aVQ: posts big blind $2
*** HOLE CARDS ***
RwDoM55ZeQuI2ADyJhOb2Q: raises $4 to $6
6hvg964TSqZ3AL/0XK9aVQ: folds
RwDoM55ZeQuI2ADyJhOb2Q collected $4 from pot
RwDoM55ZeQuI2ADyJhOb2Q: doesn't show hand
*** SUMMARY ***
Total pot $4 | Rake $0
Seat 1: 6hvg964TSqZ3AL/0XK9aVQ (big blind) folded before Flop
Seat 2: RwDoM55ZeQuI2ADyJhOb2Q (button) (small blind) collected ($4)



PokerStars Game #59938500784:  Hold'em No Limit ($1/$2) - 2009/07/01 0:16:29 ET
Table 'RF+CoNlqGlniDSszIP2SGw' 2-max Seat #2 is the button
Seat 1: lce17gGUzV617adMdsa27A ($147 in chips)
Seat 2: pVqEzK9wXlRMECnb1Zg4Zw ($113.80 in chips)
pVqEzK9wXlRMECnb1Zg4Zw: posts small blind $1
lce17gGUzV617adMdsa27A: posts big blind $2
*** HOLE CARDS ***
pVqEzK9wXlRMECnb1Zg4Zw: raises $6 to $8
lce17gGUzV617adMdsa27A: raises $22 to $30
pVqEzK9wXlRMECnb1Zg4Zw: raises $22 to $52
lce17gGUzV617adMdsa27A: raises $95 to $147 and is all-in
pVqEzK9wXlRMECnb1Zg4Zw: calls $61.80 and is all-in
*** FLOP *** [7d Tc 6s]
*** TURN *** [7d Tc 6s] [Ad]
*** RIVER *** [7d Tc 6s Ad] [Ts]
*** SHOW DOWN ***
lce17gGUzV617adMdsa27A: shows [As Jc] (two pair, Aces and Tens)
pVqEzK9wXlRMECnb1Zg4Zw: shows [Ac Ah] (a full house, Aces full of Tens)
pVqEzK9wXlRMECnb1Zg4Zw collected $227.10 from pot
*** SUMMARY ***
Total pot $227.60 | Rake $0.50
Board [7d Tc 6s Ad Ts]
Seat 1: lce17gGUzV617adMdsa27A (big blind) showed [As Jc] and lost with two pair, Aces and Tens
Seat 2: pVqEzK9wXlRMECnb1Zg4Zw (button) (small blind) showed [Ac Ah] and won ($227.10) with a full house, Aces full of Tens



PokerStars Game #59938500822:  Hold'em No Limit ($1/$2) - 2009/07/01 0:16:29 ET
Table 'G1Oqdy4Pqdb5gtx40rUBzA' 6-max Seat #6 is the button
Seat 1: QCqxb/MXSq5RKfPtjBjiBA ($133.60 in chips)
Seat 2: IzslX/oV8DoDQfxCV/3+kg ($349.75 in chips)
Seat 3: lE+RUsc9cdVV9eEi8uytew ($108.20 in chips)
Seat 4: B87ikIyZ/TzAVeXf38Ny0g ($200 in chips)
Seat 6: gGPaCoSWW1HoKYaqfAPecg ($200 in chips)
QCqxb/MXSq5RKfPtjBjiBA: posts small blind $1
IzslX/oV8DoDQfxCV/3+kg: posts big blind $2
X7GlkHF+lkbarCLuZ4Uf0w: sits out
*** HOLE CARDS ***
lE+RUsc9cdVV9eEi8uytew: folds
B87ikIyZ/TzAVeXf38Ny0g: folds
gGPaCoSWW1HoKYaqfAPecg: folds
QCqxb/MXSq5RKfPtjBjiBA: calls $1
IzslX/oV8DoDQfxCV/3+kg: checks
*** FLOP *** [5s 6c Tc]
QCqxb/MXSq5RKfPtjBjiBA: bets $4
IzslX/oV8DoDQfxCV/3+kg: folds
QCqxb/MXSq5RKfPtjBjiBA collected $3.80 from pot
*** SUMMARY ***
Total pot $4 | Rake $0.20
Board [5s 6c Tc]
Seat 1: QCqxb/MXSq5RKfPtjBjiBA (small blind) collected ($3.80)
Seat 2: IzslX/oV8DoDQfxCV/3+kg (big blind) folded on the Flop
Seat 3: lE+RUsc9cdVV9eEi8uytew folded before Flop (didn't bet)
Seat 4: B87ikIyZ/TzAVeXf38Ny0g folded before Flop (didn't bet)
Seat 6: gGPaCoSWW1HoKYaqfAPecg (button) folded before Flop (didn't bet)



PokerStars Game #59938502270:  Hold'em No Limit ($1/$2) - 2009/07/01 0:16:31 ET
Table 'HewZCzVOYGmuLDKthTi5Yw' 6-max Seat #2 is the button
Seat 1: 353332 ($240.20 in chips)
Seat 2: X7GlkHF+lkbarCLuZ4Uf0w ($24 in chips)
Seat 3: WJxW31eStwT28R2X/L8F5A ($27.05 in chips)
Seat 5: 513FcCI8jHyQy2VWoIQkMg ($404.50 in chips)
Seat 6: jAWL00OhCFkIBMd/+4Fzsw ($120 in chips)
WJxW31eStwT28R2X/L8F5A: posts small blind $1
513FcCI8jHyQy2VWoIQkMg: posts big blind $2
jAWL00OhCFkIBMd/+4Fzsw: posts big blind $2
*** HOLE CARDS ***
jAWL00OhCFkIBMd/+4Fzsw: checks
353332: folds
X7GlkHF+lkbarCLuZ4Uf0w: raises $4 to $6
WJxW31eStwT28R2X/L8F5A: raises $21.05 to $27.05 and is all-in
513FcCI8jHyQy2VWoIQkMg: folds
jAWL00OhCFkIBMd/+4Fzsw: folds
X7GlkHF+lkbarCLuZ4Uf0w: calls $18 and is all-in
*** FLOP *** [6d 9c 8s]
*** TURN *** [6d 9c 8s] [3s]
*** RIVER *** [6d 9c 8s 3s] [Ks]
*** SHOW DOWN ***
WJxW31eStwT28R2X/L8F5A: shows [Qh Ad] (high card Ace)
X7GlkHF+lkbarCLuZ4Uf0w: shows [As Ac] (a pair of Aces)
X7GlkHF+lkbarCLuZ4Uf0w collected $50 from pot
*** SUMMARY ***
Total pot $52 | Rake $2
Board [6d 9c 8s 3s Ks]
Seat 1: 353332 folded before Flop (didn't bet)
Seat 2: X7GlkHF+lkbarCLuZ4Uf0w (button) showed [As Ac] and won ($50) with a pair of Aces
Seat 3: WJxW31eStwT28R2X/L8F5A (small blind) showed [Qh Ad] and lost with high card Ace
Seat 5: 513FcCI8jHyQy2VWoIQkMg (big blind) folded before Flop
Seat 6: jAWL00OhCFkIBMd/+4Fzsw folded before Flop



PokerStars Game #59938503084:  Hold'em No Limit ($1/$2) - 2009/07/01 0:16:32 ET
Table 'eyAQSIlgc2o1Jxvbve4WGg' 9-max Seat #6 is the button
Seat 1: Q3uFdu6ztesjDFiqkagTRQ ($232 in chips)
Seat 3: TAfo4veNRaRlzDXMMYS3Jg ($37 in chips)
Seat 4: miAHPEBdznuHNzK6YM3hRA ($104.50 in chips)
Seat 5: JnV3SM2D6dAFYyGZHHpvrg ($97 in chips)
Seat 6: IikcENBHwoT7snSvBPSc7Q ($178.60 in chips)
Seat 7: QHxJjpVYwitg9krW6wZgJA ($200 in chips)
Seat 8: 5iPk5MyO3KVu18Y8XCYfFQ ($38.60 in chips)
Seat 9: Hc2itIxwbi1lwa+DAYYQGg ($44.85 in chips)
QHxJjpVYwitg9krW6wZgJA: posts small blind $1
5iPk5MyO3KVu18Y8XCYfFQ: posts big blind $2
*** HOLE CARDS ***
g7gL2NLJCdZPPV399WKT1w joins the table at seat #2
Hc2itIxwbi1lwa+DAYYQGg: folds
Q3uFdu6ztesjDFiqkagTRQ: folds
TAfo4veNRaRlzDXMMYS3Jg: folds
miAHPEBdznuHNzK6YM3hRA: calls $2
JnV3SM2D6dAFYyGZHHpvrg: folds
IikcENBHwoT7snSvBPSc7Q: folds
QHxJjpVYwitg9krW6wZgJA: calls $1
5iPk5MyO3KVu18Y8XCYfFQ: checks
*** FLOP *** [Kc Th 9c]
QHxJjpVYwitg9krW6wZgJA: checks
5iPk5MyO3KVu18Y8XCYfFQ: checks
miAHPEBdznuHNzK6YM3hRA: bets $2
QHxJjpVYwitg9krW6wZgJA: folds
5iPk5MyO3KVu18Y8XCYfFQ: folds
miAHPEBdznuHNzK6YM3hRA collected $5.70 from pot
miAHPEBdznuHNzK6YM3hRA: shows [2c Qc] (high card King)
*** SUMMARY ***
Total pot $6 | Rake $0.30
Board [Kc Th 9c]
Seat 1: Q3uFdu6ztesjDFiqkagTRQ folded before Flop (didn't bet)
Seat 3: TAfo4veNRaRlzDXMMYS3Jg folded before Flop (didn't bet)
Seat 4: miAHPEBdznuHNzK6YM3hRA collected ($5.70)
Seat 5: JnV3SM2D6dAFYyGZHHpvrg folded before Flop (didn't bet)
Seat 6: IikcENBHwoT7snSvBPSc7Q (button) folded before Flop (didn't bet)
Seat 7: QHxJjpVYwitg9krW6wZgJA (small blind) folded on the Flop
Seat 8: 5iPk5MyO3KVu18Y8XCYfFQ (big blind) folded on the Flop
Seat 9: Hc2itIxwbi1lwa+DAYYQGg folded before Flop (didn't bet)



PokerStars Game #59938502944:  Hold'em No Limit ($1/$2) - 2009/07/01 0:16:32 ET
Table '3FGoiEOffWrbgTfsB3t7FA' 2-max Seat #2 is the button
Seat 1: e0oDWyrmgLpR6bROEqw1nQ ($316.50 in chips)
Seat 2: +sy/nlNI20yZraIjs4AALg ($282.65 in chips)
+sy/nlNI20yZraIjs4AALg: posts small blind $1
e0oDWyrmgLpR6bROEqw1nQ: posts big blind $2
*** HOLE CARDS ***
+sy/nlNI20yZraIjs4AALg: raises $4 to $6
e0oDWyrmgLpR6bROEqw1nQ: raises $14 to $20
+sy/nlNI20yZraIjs4AALg: calls $14
*** FLOP *** [5c 5d 2c]
e0oDWyrmgLpR6bROEqw1nQ: bets $26
+sy/nlNI20yZraIjs4AALg: calls $26
*** TURN *** [5c 5d 2c] [Ts]
e0oDWyrmgLpR6bROEqw1nQ: bets $64
+sy/nlNI20yZraIjs4AALg: folds
e0oDWyrmgLpR6bROEqw1nQ collected $91.50 from pot
*** SUMMARY ***
Total pot $92 | Rake $0.50
Board [5c 5d 2c Ts]
Seat 1: e0oDWyrmgLpR6bROEqw1nQ (big blind) collected ($91.50)
Seat 2: +sy/nlNI20yZraIjs4AALg (button) (small blind) folded on the Turn



PokerStars Game #59938503844:  Hold'em No Limit ($1/$2) - 2009/07/01 0:16:34 ET
Table 'rsKRKlGHlxVyqJxzO2a2Ow' 9-max Seat #3 is the button
Seat 1: uYWfQJg2hgHLxri6/uVJiw ($116.10 in chips)
Seat 2: QHxJjpVYwitg9krW6wZgJA ($255.55 in chips)
Seat 3: 9sYbXdhj1M2bwKrVNxj5+Q ($107.80 in chips)
Seat 4: zJtQ1gxyi72XvGYS1tM+DA ($176.55 in chips)
Seat 5: 5Q8U6iZbeO7xJSS4qvDP5g ($203 in chips)
Seat 6: H6Z4+qu8gR0VUiPOijndVg ($200 in chips)
Seat 7: kVCeGJ4NY7Fb0W74j1mAqA ($206 in chips)
Seat 8: Hc2itIxwbi1lwa+DAYYQGg ($34 in chips)
Seat 9: 5iPk5MyO3KVu18Y8XCYfFQ ($121 in chips)
zJtQ1gxyi72XvGYS1tM+DA: posts small blind $1
5Q8U6iZbeO7xJSS4qvDP5g: posts big blind $2
*** HOLE CARDS ***
H6Z4+qu8gR0VUiPOijndVg: folds
kVCeGJ4NY7Fb0W74j1mAqA: folds
Hc2itIxwbi1lwa+DAYYQGg: raises $4 to $6
5iPk5MyO3KVu18Y8XCYfFQ: folds
uYWfQJg2hgHLxri6/uVJiw: folds
QHxJjpVYwitg9krW6wZgJA: folds
9sYbXdhj1M2bwKrVNxj5+Q: folds
zJtQ1gxyi72XvGYS1tM+DA: folds
5Q8U6iZbeO7xJSS4qvDP5g: folds
Hc2itIxwbi1lwa+DAYYQGg collected $5 from pot
*** SUMMARY ***
Total pot $5 | Rake $0
Seat 1: uYWfQJg2hgHLxri6/uVJiw folded before Flop (didn't bet)
Seat 2: QHxJjpVYwitg9krW6wZgJA folded before Flop (didn't bet)
Seat 3: 9sYbXdhj1M2bwKrVNxj5+Q (button) folded before Flop (didn't bet)
Seat 4: zJtQ1gxyi72XvGYS1tM+DA (small blind) folded before Flop
Seat 5: 5Q8U6iZbeO7xJSS4qvDP5g (big blind) folded before Flop
Seat 6: H6Z4+qu8gR0VUiPOijndVg folded before Flop (didn't bet)
Seat 7: kVCeGJ4NY7Fb0W74j1mAqA folded before Flop (didn't bet)
Seat 8: Hc2itIxwbi1lwa+DAYYQGg collected ($5)
Seat 9: 5iPk5MyO3KVu18Y8XCYfFQ folded before Flop (didn't bet)



PokerStars Game #59938505146:  Hold'em No Limit ($1/$2) - 2009/07/01 0:16:35 ET
Table 'NmY84NAf9Mh0ckAckHnh5g' 2-max Seat #1 is the button
Seat 1: 6hvg964TSqZ3AL/0XK9aVQ ($584.10 in chips)
Seat 2: RwDoM55ZeQuI2ADyJhOb2Q ($200 in chips)
6hvg964TSqZ3AL/0XK9aVQ: posts small blind $1
RwDoM55ZeQuI2ADyJhOb2Q: posts big blind $2
*** HOLE CARDS ***
6hvg964TSqZ3AL/0XK9aVQ: calls $1
RwDoM55ZeQuI2ADyJhOb2Q: checks
*** FLOP *** [5h As Qc]
RwDoM55ZeQuI2ADyJhOb2Q: checks
6hvg964TSqZ3AL/0XK9aVQ: checks
*** TURN *** [5h As Qc] [Jd]
RwDoM55ZeQuI2ADyJhOb2Q: checks
6hvg964TSqZ3AL/0XK9aVQ: bets $10
RwDoM55ZeQuI2ADyJhOb2Q: folds
6hvg964TSqZ3AL/0XK9aVQ collected $3.80 from pot
*** SUMMARY ***
Total pot $4 | Rake $0.20
Board [5h As Qc Jd]
Seat 1: 6hvg964TSqZ3AL/0XK9aVQ (button) (small blind) collected ($3.80)
Seat 2: RwDoM55ZeQuI2ADyJhOb2Q (big blind) folded on the Turn



PokerStars Game #59938505302:  Hold'em No Limit ($1/$2) - 2009/07/01 0:16:36 ET
Table 'l5lZHc5JRHEDt0Y2AVPq3g' 6-max Seat #1 is the button
Seat 1: gGPaCoSWW1HoKYaqfAPecg ($227.20 in chips)
Seat 2: /PH6Ffnho4Ysm8S3V/oa+w ($40 in chips)
Seat 3: DQlskgG4OtLpF2MVxLwf4A ($200 in chips)
Seat 4: zNjJ/y4emmF+vzrCDd+ooA ($200.65 in chips)
Seat 5: X7GlkHF+lkbarCLuZ4Uf0w ($55.85 in chips)
Seat 6: vkfxu8f/jMYKUk6Ly4eujw ($189.30 in chips)
/PH6Ffnho4Ysm8S3V/oa+w: posts small blind $1
DQlskgG4OtLpF2MVxLwf4A: posts big blind $2
*** HOLE CARDS ***
zNjJ/y4emmF+vzrCDd+ooA: raises $6 to $8
X7GlkHF+lkbarCLuZ4Uf0w: folds
vkfxu8f/jMYKUk6Ly4eujw: folds
gGPaCoSWW1HoKYaqfAPecg: folds
/PH6Ffnho4Ysm8S3V/oa+w: folds
DQlskgG4OtLpF2MVxLwf4A: folds
zNjJ/y4emmF+vzrCDd+ooA collected $5 from pot
*** SUMMARY ***
Total pot $5 | Rake $0
Seat 1: gGPaCoSWW1HoKYaqfAPecg (button) folded before Flop (didn't bet)
Seat 2: /PH6Ffnho4Ysm8S3V/oa+w (small blind) folded before Flop
Seat 3: DQlskgG4OtLpF2MVxLwf4A (big blind) folded before Flop
Seat 4: zNjJ/y4emmF+vzrCDd+ooA collected ($5)
Seat 5: X7GlkHF+lkbarCLuZ4Uf0w folded before Flop (didn't bet)
Seat 6: vkfxu8f/jMYKUk6Ly4eujw folded before Flop (didn't bet)



PokerStars Game #59938506934:  Hold'em No Limit ($1/$2) - 2009/07/01 0:16:38 ET
Table 'XP2sRSup+aRuwzx3vDZsDg' 6-max Seat #5 is the button
Seat 1: o9jamqIi6sTTRSqudgboRA ($240.70 in chips)
Seat 2: Ep0hd57w9DDqfTwA66dJVw ($64 in chips)
Seat 3: X7GlkHF+lkbarCLuZ4Uf0w ($37 in chips)
Seat 4: JsC+WvfzqlxVs9G8/gSQAQ ($136.60 in chips)
Seat 5: 894kvCY4GHivBpqwizsecg ($117 in chips)
Seat 6: h7ppRQJTYBsHCbLMeW9T2g ($476.75 in chips)
h7ppRQJTYBsHCbLMeW9T2g: posts small blind $1
o9jamqIi6sTTRSqudgboRA: posts big blind $2
*** HOLE CARDS ***
Ep0hd57w9DDqfTwA66dJVw: calls $2
X7GlkHF+lkbarCLuZ4Uf0w: folds
JsC+WvfzqlxVs9G8/gSQAQ: calls $2
894kvCY4GHivBpqwizsecg: calls $2
h7ppRQJTYBsHCbLMeW9T2g: raises $12 to $14
o9jamqIi6sTTRSqudgboRA: calls $12
Ep0hd57w9DDqfTwA66dJVw: folds
JsC+WvfzqlxVs9G8/gSQAQ: calls $12
894kvCY4GHivBpqwizsecg: folds
*** FLOP *** [8h 3s Jh]
h7ppRQJTYBsHCbLMeW9T2g: checks
o9jamqIi6sTTRSqudgboRA: checks
JsC+WvfzqlxVs9G8/gSQAQ: bets $20
h7ppRQJTYBsHCbLMeW9T2g: folds
o9jamqIi6sTTRSqudgboRA: folds
JsC+WvfzqlxVs9G8/gSQAQ collected $43.70 from pot
*** SUMMARY ***
Total pot $46 | Rake $2.30
Board [8h 3s Jh]
Seat 1: o9jamqIi6sTTRSqudgboRA (big blind) folded on the Flop
Seat 2: Ep0hd57w9DDqfTwA66dJVw folded before Flop
Seat 3: X7GlkHF+lkbarCLuZ4Uf0w folded before Flop (didn't bet)
Seat 4: JsC+WvfzqlxVs9G8/gSQAQ collected ($43.70)
Seat 5: 894kvCY4GHivBpqwizsecg (button) folded before Flop
Seat 6: h7ppRQJTYBsHCbLMeW9T2g (small blind) folded on the Flop



PokerStars Game #59938506846:  Hold'em No Limit ($1/$2) - 2009/07/01 0:16:38 ET
Table 'W9UeSV0aoPjh5SFSxM8jUQ' 9-max Seat #1 is the button
Seat 1: cdC54j9fGGojcbzWB5PgzA ($204.60 in chips)
Seat 2: iMe5yhc+1BaiIPHet3NMrA ($314.75 in chips)
Seat 3: TAfo4veNRaRlzDXMMYS3Jg ($40 in chips)
Seat 4: De9g+AYjo0DN6C/+iT/nsg ($197 in chips)
Seat 6: MXxB6weBWzZyAhRZb+/KVg ($198 in chips)
Seat 7: 4Cl43Q1TYQL8wn1NSCUkaw ($46.60 in chips)
Seat 9: U2A5Hv6ib/5+gzO2wr7Z4w ($200 in chips)
iMe5yhc+1BaiIPHet3NMrA: posts small blind $1
TAfo4veNRaRlzDXMMYS3Jg: posts big blind $2
CUZwDpLTQKhzarPe+JCLOQ: sits out
*** HOLE CARDS ***
De9g+AYjo0DN6C/+iT/nsg: folds
z89zAYE4dlPgjkofBKII0Q joins the table at seat #8
MXxB6weBWzZyAhRZb+/KVg: folds
4Cl43Q1TYQL8wn1NSCUkaw: folds
U2A5Hv6ib/5+gzO2wr7Z4w: raises $4 to $6
cdC54j9fGGojcbzWB5PgzA: folds
iMe5yhc+1BaiIPHet3NMrA: folds
TAfo4veNRaRlzDXMMYS3Jg: folds
U2A5Hv6ib/5+gzO2wr7Z4w collected $5 from pot
*** SUMMARY ***
Total pot $5 | Rake $0
Seat 1: cdC54j9fGGojcbzWB5PgzA (button) folded before Flop (didn't bet)
Seat 2: iMe5yhc+1BaiIPHet3NMrA (small blind) folded before Flop
Seat 3: TAfo4veNRaRlzDXMMYS3Jg (big blind) folded before Flop
Seat 4: De9g+AYjo0DN6C/+iT/nsg folded before Flop (didn't bet)
Seat 6: MXxB6weBWzZyAhRZb+/KVg folded before Flop (didn't bet)
Seat 7: 4Cl43Q1TYQL8wn1NSCUkaw folded before Flop (didn't bet)
Seat 9: U2A5Hv6ib/5+gzO2wr7Z4w collected ($5)



PokerStars Game #59938508100:  Hold'em No Limit ($1/$2) - 2009/07/01 0:16:40 ET
Table 'WCA60bDA8ecovUgFSIZkTQ' 9-max Seat #4 is the button
Seat 1: CUZwDpLTQKhzarPe+JCLOQ ($211.75 in chips)
Seat 2: G1h8wamBcVJXtsKXZQ2EyA ($98.40 in chips)
Seat 3: 5iPk5MyO3KVu18Y8XCYfFQ ($39 in chips)
Seat 4: Q3uFdu6ztesjDFiqkagTRQ ($461.70 in chips)
Seat 5: Hc2itIxwbi1lwa+DAYYQGg ($304.30 in chips)
Seat 6: DOWQSOJ7GaX+ksfWTqPT5A ($236.50 in chips)
Seat 7: 2YpnxJiexJHyERfbqgwEcw ($58 in chips)
Seat 8: x+V1JgVDawsJTxKcxm7gxw ($91 in chips)
Seat 9: 3q2/0oJr3Mcy1W5tcN61ug ($294.20 in chips)
Hc2itIxwbi1lwa+DAYYQGg: posts small blind $1
DOWQSOJ7GaX+ksfWTqPT5A: posts big blind $2
*** HOLE CARDS ***
2YpnxJiexJHyERfbqgwEcw: folds
x+V1JgVDawsJTxKcxm7gxw: folds
3q2/0oJr3Mcy1W5tcN61ug: folds
CUZwDpLTQKhzarPe+JCLOQ: folds
G1h8wamBcVJXtsKXZQ2EyA: calls $2
5iPk5MyO3KVu18Y8XCYfFQ: folds
Q3uFdu6ztesjDFiqkagTRQ: folds
Hc2itIxwbi1lwa+DAYYQGg: calls $1
DOWQSOJ7GaX+ksfWTqPT5A: checks
*** FLOP *** [6d 4d 9s]
Hc2itIxwbi1lwa+DAYYQGg: bets $2
DOWQSOJ7GaX+ksfWTqPT5A: calls $2
G1h8wamBcVJXtsKXZQ2EyA: raises $8 to $10
Hc2itIxwbi1lwa+DAYYQGg: folds
DOWQSOJ7GaX+ksfWTqPT5A: folds
G1h8wamBcVJXtsKXZQ2EyA collected $11.45 from pot
*** SUMMARY ***
Total pot $12 | Rake $0.55
Board [6d 4d 9s]
Seat 1: CUZwDpLTQKhzarPe+JCLOQ folded before Flop (didn't bet)
Seat 2: G1h8wamBcVJXtsKXZQ2EyA collected ($11.45)
Seat 3: 5iPk5MyO3KVu18Y8XCYfFQ folded before Flop (didn't bet)
Seat 4: Q3uFdu6ztesjDFiqkagTRQ (button) folded before Flop (didn't bet)
Seat 5: Hc2itIxwbi1lwa+DAYYQGg (small blind) folded on the Flop
Seat 6: DOWQSOJ7GaX+ksfWTqPT5A (big blind) folded on the Flop
Seat 7: 2YpnxJiexJHyERfbqgwEcw folded before Flop (didn't bet)
Seat 8: x+V1JgVDawsJTxKcxm7gxw folded before Flop (didn't bet)
Seat 9: 3q2/0oJr3Mcy1W5tcN61ug folded before Flop (didn't bet)



PokerStars Game #59938509124:  Hold'em No Limit ($1/$2) - 2009/07/01 0:16:41 ET
Table 'LL4bDFyhj5hsMpzaDugJZg' 6-max Seat #4 is the button
Seat 1: IBW9lyGsaRmfcbyA/qFfEw ($64.20 in chips)
Seat 2: L3l+A4pJhOAD6HVVFXvVBw ($319.95 in chips)
Seat 3: gGPaCoSWW1HoKYaqfAPecg ($200 in chips)
Seat 4: 8srN1dKQePlsv0GyTada+Q ($265.75 in chips)
Seat 5: HgX0VeqE/dzSXd5BpntRBw ($245.40 in chips)
Seat 6: /PH6Ffnho4Ysm8S3V/oa+w ($40 in chips)
HgX0VeqE/dzSXd5BpntRBw: posts small blind $1
/PH6Ffnho4Ysm8S3V/oa+w: posts big blind $2
*** HOLE CARDS ***
IBW9lyGsaRmfcbyA/qFfEw: folds
L3l+A4pJhOAD6HVVFXvVBw: raises $4 to $6
gGPaCoSWW1HoKYaqfAPecg: folds
8srN1dKQePlsv0GyTada+Q: calls $6
HgX0VeqE/dzSXd5BpntRBw: folds
/PH6Ffnho4Ysm8S3V/oa+w: folds
*** FLOP *** [9d As 4h]
L3l+A4pJhOAD6HVVFXvVBw: bets $6
8srN1dKQePlsv0GyTada+Q: calls $6
*** TURN *** [9d As 4h] [6d]
L3l+A4pJhOAD6HVVFXvVBw: bets $6
8srN1dKQePlsv0GyTada+Q: calls $6
*** RIVER *** [9d As 4h 6d] [4c]
L3l+A4pJhOAD6HVVFXvVBw: bets $6
8srN1dKQePlsv0GyTada+Q: calls $6
*** SHOW DOWN ***
L3l+A4pJhOAD6HVVFXvVBw: shows [Tc Td] (two pair, Tens and Fours)
8srN1dKQePlsv0GyTada+Q: mucks hand
L3l+A4pJhOAD6HVVFXvVBw collected $48.55 from pot
*** SUMMARY ***
Total pot $51 | Rake $2.45
Board [9d As 4h 6d 4c]
Seat 1: IBW9lyGsaRmfcbyA/qFfEw folded before Flop (didn't bet)
Seat 2: L3l+A4pJhOAD6HVVFXvVBw showed [Tc Td] and won ($48.55) with two pair, Tens and Fours
Seat 3: gGPaCoSWW1HoKYaqfAPecg folded before Flop (didn't bet)
Seat 4: 8srN1dKQePlsv0GyTada+Q (button) mucked
Seat 5: HgX0VeqE/dzSXd5BpntRBw (small blind) folded before Flop
Seat 6: /PH6Ffnho4Ysm8S3V/oa+w (big blind) folded before Flop



PokerStars Game #59938509712:  Hold'em No Limit ($1/$2) - 2009/07/01 0:16:42 ET
Table 'gnHBqWll9O3fxG7Ojkz/ng' 9-max Seat #9 is the button
Seat 1: hpqdC/23wXosGOmzARr5NA ($150.05 in chips)
Seat 2: H6Z4+qu8gR0VUiPOijndVg ($203 in chips)
Seat 3: 5Q8U6iZbeO7xJSS4qvDP5g ($225.35 in chips)
Seat 4: n5XI5/7gN+gIubHFBH+mOw ($401.15 in chips)
Seat 5: rBQDMkKm9cZn6M9NPsiVew ($117 in chips)
Seat 6: 5iPk5MyO3KVu18Y8XCYfFQ ($58.45 in chips)
Seat 8: JpnYBfO6Nq6INmRDDoBX1g ($50 in chips)
Seat 9: kVCeGJ4NY7Fb0W74j1mAqA ($200 in chips)
hpqdC/23wXosGOmzARr5NA: posts small blind $1
H6Z4+qu8gR0VUiPOijndVg: posts big blind $2
JpnYBfO6Nq6INmRDDoBX1g: posts big blind $2
*** HOLE CARDS ***
5Q8U6iZbeO7xJSS4qvDP5g: folds
n5XI5/7gN+gIubHFBH+mOw: folds
rBQDMkKm9cZn6M9NPsiVew: calls $2
5iPk5MyO3KVu18Y8XCYfFQ: folds
JpnYBfO6Nq6INmRDDoBX1g: raises $18 to $20
kVCeGJ4NY7Fb0W74j1mAqA: folds
hpqdC/23wXosGOmzARr5NA: folds
H6Z4+qu8gR0VUiPOijndVg: folds
rBQDMkKm9cZn6M9NPsiVew: calls $18
*** FLOP *** [7h 6c Jd]
rBQDMkKm9cZn6M9NPsiVew: checks
JpnYBfO6Nq6INmRDDoBX1g: bets $30 and is all-in
rBQDMkKm9cZn6M9NPsiVew: calls $30
*** TURN *** [7h 6c Jd] [2h]
*** RIVER *** [7h 6c Jd 2h] [6s]
*** SHOW DOWN ***
rBQDMkKm9cZn6M9NPsiVew: shows [Ah Qh] (a pair of Sixes)
JpnYBfO6Nq6INmRDDoBX1g: mucks hand
rBQDMkKm9cZn6M9NPsiVew collected $100 from pot
*** SUMMARY ***
Total pot $103 | Rake $3
Board [7h 6c Jd 2h 6s]
Seat 1: hpqdC/23wXosGOmzARr5NA (small blind) folded before Flop
Seat 2: H6Z4+qu8gR0VUiPOijndVg (big blind) folded before Flop
Seat 3: 5Q8U6iZbeO7xJSS4qvDP5g folded before Flop (didn't bet)
Seat 4: n5XI5/7gN+gIubHFBH+mOw folded before Flop (didn't bet)
Seat 5: rBQDMkKm9cZn6M9NPsiVew showed [Ah Qh] and won ($100) with a pair of Sixes
Seat 6: 5iPk5MyO3KVu18Y8XCYfFQ folded before Flop (didn't bet)
Seat 8: JpnYBfO6Nq6INmRDDoBX1g mucked
Seat 9: kVCeGJ4NY7Fb0W74j1mAqA (button) folded before Flop (didn't bet)



PokerStars Game #59938513398:  Hold'em No Limit ($1/$2) - 2009/07/01 0:16:47 ET
Table 'mGpP9StWRnoeiBDExc6Frg' 6-max Seat #1 is the button
Seat 1: zWFU82nxIRvzK4mKiL4m0Q ($75.05 in chips)
Seat 2: DQlskgG4OtLpF2MVxLwf4A ($198 in chips)
Seat 3: 3HrFUl+TAqSP1U00zz3P7A ($175.60 in chips)
Seat 4: qXDd0ZyMIse0OBu8pxeQ3Q ($215 in chips)
Seat 5: d1puGuVBE0fidn+5eRJ0tw ($167 in chips)
Seat 6: X7GlkHF+lkbarCLuZ4Uf0w ($26.45 in chips)
DQlskgG4OtLpF2MVxLwf4A: posts small blind $1
3HrFUl+TAqSP1U00zz3P7A: posts big blind $2
*** HOLE CARDS ***
qXDd0ZyMIse0OBu8pxeQ3Q: raises $5 to $7
d1puGuVBE0fidn+5eRJ0tw: folds
X7GlkHF+lkbarCLuZ4Uf0w: folds
zWFU82nxIRvzK4mKiL4m0Q: folds
DQlskgG4OtLpF2MVxLwf4A: folds
3HrFUl+TAqSP1U00zz3P7A: folds
qXDd0ZyMIse0OBu8pxeQ3Q collected $5 from pot
*** SUMMARY ***
Total pot $5 | Rake $0
Seat 1: zWFU82nxIRvzK4mKiL4m0Q (button) folded before Flop (didn't bet)
Seat 2: DQlskgG4OtLpF2MVxLwf4A (small blind) folded before Flop
Seat 3: 3HrFUl+TAqSP1U00zz3P7A (big blind) folded before Flop
Seat 4: qXDd0ZyMIse0OBu8pxeQ3Q collected ($5)
Seat 5: d1puGuVBE0fidn+5eRJ0tw folded before Flop (didn't bet)
Seat 6: X7GlkHF+lkbarCLuZ4Uf0w folded before Flop (didn't bet)



PokerStars Game #59938515978:  Hold'em No Limit ($1/$2) - 2009/07/01 0:16:51 ET
Table 'RF+CoNlqGlniDSszIP2SGw' 2-max Seat #1 is the button
Seat 1: lce17gGUzV617adMdsa27A ($33.20 in chips)
Seat 2: pVqEzK9wXlRMECnb1Zg4Zw ($227.10 in chips)
lce17gGUzV617adMdsa27A: posts small blind $1
pVqEzK9wXlRMECnb1Zg4Zw: posts big blind $2
*** HOLE CARDS ***
lce17gGUzV617adMdsa27A: raises $12 to $14
pVqEzK9wXlRMECnb1Zg4Zw: folds
lce17gGUzV617adMdsa27A collected $4 from pot
*** SUMMARY ***
Total pot $4 | Rake $0
Seat 1: lce17gGUzV617adMdsa27A (button) (small blind) collected ($4)
Seat 2: pVqEzK9wXlRMECnb1Zg4Zw (big blind) folded before Flop



PokerStars Game #59938516312:  Hold'em No Limit ($1/$2) - 2009/07/01 0:16:51 ET
Table 'on4i1U1lCRmxsduFD3xiSg' 9-max Seat #7 is the button
Seat 1: so5k3vFDmokh2q3dImJ1GQ ($118 in chips)
Seat 2: yZYrOeNDxQxkzpbgKX1bng ($66.65 in chips)
Seat 3: 5iPk5MyO3KVu18Y8XCYfFQ ($61.20 in chips)
Seat 4: Z3aYCZG/yXHYFjiWkGI5ug ($530.10 in chips)
Seat 5: QHxJjpVYwitg9krW6wZgJA ($203 in chips)
Seat 6: CUZwDpLTQKhzarPe+JCLOQ ($214.55 in chips)
Seat 7: xD4ElYxz6Ollzmam8BmMCw ($197 in chips)
Seat 8: cdC54j9fGGojcbzWB5PgzA ($200 in chips)
Seat 9: iMe5yhc+1BaiIPHet3NMrA ($200 in chips)
cdC54j9fGGojcbzWB5PgzA: posts small blind $1
iMe5yhc+1BaiIPHet3NMrA: posts big blind $2
*** HOLE CARDS ***
so5k3vFDmokh2q3dImJ1GQ: folds
yZYrOeNDxQxkzpbgKX1bng: folds
5iPk5MyO3KVu18Y8XCYfFQ: folds
Z3aYCZG/yXHYFjiWkGI5ug: folds
QHxJjpVYwitg9krW6wZgJA: folds
CUZwDpLTQKhzarPe+JCLOQ: folds
xD4ElYxz6Ollzmam8BmMCw: folds
cdC54j9fGGojcbzWB5PgzA: folds
iMe5yhc+1BaiIPHet3NMrA collected $2 from pot
*** SUMMARY ***
Total pot $2 | Rake $0
Seat 1: so5k3vFDmokh2q3dImJ1GQ folded before Flop (didn't bet)
Seat 2: yZYrOeNDxQxkzpbgKX1bng folded before Flop (didn't bet)
Seat 3: 5iPk5MyO3KVu18Y8XCYfFQ folded before Flop (didn't bet)
Seat 4: Z3aYCZG/yXHYFjiWkGI5ug folded before Flop (didn't bet)
Seat 5: QHxJjpVYwitg9krW6wZgJA folded before Flop (didn't bet)
Seat 6: CUZwDpLTQKhzarPe+JCLOQ folded before Flop (didn't bet)
Seat 7: xD4ElYxz6Ollzmam8BmMCw (button) folded before Flop (didn't bet)
Seat 8: cdC54j9fGGojcbzWB5PgzA (small blind) folded before Flop
Seat 9: iMe5yhc+1BaiIPHet3NMrA (big blind) collected ($2)



PokerStars Game #59938516472:  Hold'em No Limit ($1/$2) - 2009/07/01 0:16:52 ET
Table 'qVXak+oTeDXMGbWa4sDU5Q' 9-max Seat #7 is the button
Seat 1: H6Z4+qu8gR0VUiPOijndVg ($254.30 in chips)
Seat 2: Hc2itIxwbi1lwa+DAYYQGg ($46 in chips)
Seat 3: oz9eCXGC7DdjQlL/nuWj1A ($120.65 in chips)
Seat 4: b0jO1SDhLedy1//CQlA8kw ($40 in chips)
Seat 5: NqKRc5xvcye0d7F6VOF6MQ ($82.50 in chips)
Seat 6: Q3uFdu6ztesjDFiqkagTRQ ($200 in chips)
Seat 7: 5iPk5MyO3KVu18Y8XCYfFQ ($109 in chips)
Seat 8: 9pHZMviI9R8injxojGTnvw ($119.80 in chips)
Seat 9: ZP45Tu5Zqo4v+ZgqIQVoOQ ($200 in chips)
9pHZMviI9R8injxojGTnvw: posts small blind $1
ZP45Tu5Zqo4v+ZgqIQVoOQ: posts big blind $2
*** HOLE CARDS ***
H6Z4+qu8gR0VUiPOijndVg: raises $4 to $6
Hc2itIxwbi1lwa+DAYYQGg: folds
oz9eCXGC7DdjQlL/nuWj1A: folds
b0jO1SDhLedy1//CQlA8kw: folds
NqKRc5xvcye0d7F6VOF6MQ: folds
Q3uFdu6ztesjDFiqkagTRQ: folds
5iPk5MyO3KVu18Y8XCYfFQ: folds
9pHZMviI9R8injxojGTnvw: folds
ZP45Tu5Zqo4v+ZgqIQVoOQ: folds
H6Z4+qu8gR0VUiPOijndVg collected $5 from pot
H6Z4+qu8gR0VUiPOijndVg: doesn't show hand
*** SUMMARY ***
Total pot $5 | Rake $0
Seat 1: H6Z4+qu8gR0VUiPOijndVg collected ($5)
Seat 2: Hc2itIxwbi1lwa+DAYYQGg folded before Flop (didn't bet)
Seat 3: oz9eCXGC7DdjQlL/nuWj1A folded before Flop (didn't bet)
Seat 4: b0jO1SDhLedy1//CQlA8kw folded before Flop (didn't bet)
Seat 5: NqKRc5xvcye0d7F6VOF6MQ folded before Flop (didn't bet)
Seat 6: Q3uFdu6ztesjDFiqkagTRQ folded before Flop (didn't bet)
Seat 7: 5iPk5MyO3KVu18Y8XCYfFQ (button) folded before Flop (didn't bet)
Seat 8: 9pHZMviI9R8injxojGTnvw (small blind) folded before Flop
Seat 9: ZP45Tu5Zqo4v+ZgqIQVoOQ (big blind) folded before Flop



PokerStars Game #59938521356:  Hold'em No Limit ($1/$2) - 2009/07/01 0:16:59 ET
Table 'jlrIxbrVIG+gjaUYT4za8g' 6-max Seat #6 is the button
Seat 1: ygTTt5ehT4aF86q1a8/R+w ($194.05 in chips)
Seat 2: N18PrNGQj43J7TJuQuu+tw ($140.65 in chips)
Seat 3: 54yWzRRgS0oZ+S6LwZBxMQ ($40.80 in chips)
Seat 4: 8srN1dKQePlsv0GyTada+Q ($200 in chips)
Seat 6: vkfxu8f/jMYKUk6Ly4eujw ($279.95 in chips)
ygTTt5ehT4aF86q1a8/R+w: posts small blind $1
N18PrNGQj43J7TJuQuu+tw: posts big blind $2
*** HOLE CARDS ***
54yWzRRgS0oZ+S6LwZBxMQ: folds
8srN1dKQePlsv0GyTada+Q: raises $4 to $6
vkfxu8f/jMYKUk6Ly4eujw: folds
ygTTt5ehT4aF86q1a8/R+w: folds
N18PrNGQj43J7TJuQuu+tw: calls $4
*** FLOP *** [7s 4h 2c]
N18PrNGQj43J7TJuQuu+tw: checks
8srN1dKQePlsv0GyTada+Q: bets $6
N18PrNGQj43J7TJuQuu+tw: calls $6
*** TURN *** [7s 4h 2c] [Jc]
N18PrNGQj43J7TJuQuu+tw: checks
8srN1dKQePlsv0GyTada+Q: checks
*** RIVER *** [7s 4h 2c Jc] [5d]
N18PrNGQj43J7TJuQuu+tw: checks
8srN1dKQePlsv0GyTada+Q: checks
*** SHOW DOWN ***
N18PrNGQj43J7TJuQuu+tw: shows [7h 8h] (a pair of Sevens)
8srN1dKQePlsv0GyTada+Q: mucks hand
N18PrNGQj43J7TJuQuu+tw collected $23.80 from pot
*** SUMMARY ***
Total pot $25 | Rake $1.20
Board [7s 4h 2c Jc 5d]
Seat 1: ygTTt5ehT4aF86q1a8/R+w (small blind) folded before Flop
Seat 2: N18PrNGQj43J7TJuQuu+tw (big blind) showed [7h 8h] and won ($23.80) with a pair of Sevens
Seat 3: 54yWzRRgS0oZ+S6LwZBxMQ folded before Flop (didn't bet)
Seat 4: 8srN1dKQePlsv0GyTada+Q mucked
Seat 6: vkfxu8f/jMYKUk6Ly4eujw (button) folded before Flop (didn't bet)



PokerStars Game #59938522474:  Hold'em No Limit ($1/$2) - 2009/07/01 0:17:00 ET
Table 'G1Oqdy4Pqdb5gtx40rUBzA' 6-max Seat #1 is the button
Seat 1: QCqxb/MXSq5RKfPtjBjiBA ($135.40 in chips)
Seat 2: IzslX/oV8DoDQfxCV/3+kg ($347.75 in chips)
Seat 3: lE+RUsc9cdVV9eEi8uytew ($108.20 in chips)
Seat 4: B87ikIyZ/TzAVeXf38Ny0g ($200 in chips)
Seat 6: gGPaCoSWW1HoKYaqfAPecg ($200 in chips)
IzslX/oV8DoDQfxCV/3+kg: posts small blind $1
lE+RUsc9cdVV9eEi8uytew: posts big blind $2
X7GlkHF+lkbarCLuZ4Uf0w: sits out
*** HOLE CARDS ***
B87ikIyZ/TzAVeXf38Ny0g: folds
gGPaCoSWW1HoKYaqfAPecg: folds
QCqxb/MXSq5RKfPtjBjiBA: raises $4 to $6
IzslX/oV8DoDQfxCV/3+kg: calls $5
lE+RUsc9cdVV9eEi8uytew: folds
*** FLOP *** [Js 8c Qd]
IzslX/oV8DoDQfxCV/3+kg: checks
QCqxb/MXSq5RKfPtjBjiBA: bets $8
IzslX/oV8DoDQfxCV/3+kg: calls $8
*** TURN *** [Js 8c Qd] [Kc]
IzslX/oV8DoDQfxCV/3+kg: checks
QCqxb/MXSq5RKfPtjBjiBA: bets $14
IzslX/oV8DoDQfxCV/3+kg: raises $24 to $38
QCqxb/MXSq5RKfPtjBjiBA: calls $24
*** RIVER *** [Js 8c Qd Kc] [As]
IzslX/oV8DoDQfxCV/3+kg: bets $36
QCqxb/MXSq5RKfPtjBjiBA: raises $47.40 to $83.40 and is all-in
IzslX/oV8DoDQfxCV/3+kg: calls $47.40
*** SHOW DOWN ***
QCqxb/MXSq5RKfPtjBjiBA: shows [9h Qh] (a pair of Queens)
IzslX/oV8DoDQfxCV/3+kg: shows [Tc Ac] (a straight, Ten to Ace)
IzslX/oV8DoDQfxCV/3+kg collected $270.80 from pot
*** SUMMARY ***
Total pot $272.80 | Rake $2
Board [Js 8c Qd Kc As]
Seat 1: QCqxb/MXSq5RKfPtjBjiBA (button) showed [9h Qh] and lost with a pair of Queens
Seat 2: IzslX/oV8DoDQfxCV/3+kg (small blind) showed [Tc Ac] and won ($270.80) with a straight, Ten to Ace
Seat 3: lE+RUsc9cdVV9eEi8uytew (big blind) folded before Flop
Seat 4: B87ikIyZ/TzAVeXf38Ny0g folded before Flop (didn't bet)
Seat 6: gGPaCoSWW1HoKYaqfAPecg folded before Flop (didn't bet)



PokerStars Game #59938522348:  Hold'em No Limit ($1/$2) - 2009/07/01 0:17:00 ET
Table 'RF+CoNlqGlniDSszIP2SGw' 2-max Seat #2 is the button
Seat 1: lce17gGUzV617adMdsa27A ($35.20 in chips)
Seat 2: pVqEzK9wXlRMECnb1Zg4Zw ($225.10 in chips)
pVqEzK9wXlRMECnb1Zg4Zw: posts small blind $1
lce17gGUzV617adMdsa27A: posts big blind $2
*** HOLE CARDS ***
pVqEzK9wXlRMECnb1Zg4Zw: calls $1
lce17gGUzV617adMdsa27A: raises $10 to $12
pVqEzK9wXlRMECnb1Zg4Zw: folds
lce17gGUzV617adMdsa27A collected $4 from pot
lce17gGUzV617adMdsa27A: doesn't show hand
*** SUMMARY ***
Total pot $4 | Rake $0
Seat 1: lce17gGUzV617adMdsa27A (big blind) collected ($4)
Seat 2: pVqEzK9wXlRMECnb1Zg4Zw (button) (small blind) folded before Flop



PokerStars Game #59938522134:  Hold'em No Limit ($1/$2) - 2009/07/01 0:17:00 ET
Table 'srul5UFZXTEccVV5fpY91g' 9-max Seat #4 is the button
Seat 1: lfD8cBv31A/pio3pXJbPjA ($171.20 in chips)
Seat 2: tJYod1SLp2AcWPL/3hZ7ug ($87.20 in chips)
Seat 3: weUZ8S7tgbaeIpzi1gBNxQ ($48.75 in chips)
Seat 4: GG5lTuGt3+kwNYSbqeB6yw ($104.40 in chips)
Seat 5: 5iPk5MyO3KVu18Y8XCYfFQ ($41.10 in chips)
Seat 6: TAfo4veNRaRlzDXMMYS3Jg ($36 in chips)
Seat 7: s0erZsDxbZSaEPheMgibKg ($458.40 in chips)
5iPk5MyO3KVu18Y8XCYfFQ: posts small blind $1
TAfo4veNRaRlzDXMMYS3Jg: posts big blind $2
*** HOLE CARDS ***
s0erZsDxbZSaEPheMgibKg: calls $2
lfD8cBv31A/pio3pXJbPjA: raises $2 to $4
tJYod1SLp2AcWPL/3hZ7ug: folds
weUZ8S7tgbaeIpzi1gBNxQ: folds
GG5lTuGt3+kwNYSbqeB6yw: folds
5iPk5MyO3KVu18Y8XCYfFQ: calls $3
TAfo4veNRaRlzDXMMYS3Jg: folds
s0erZsDxbZSaEPheMgibKg: calls $2
*** FLOP *** [9d Td 5h]
5iPk5MyO3KVu18Y8XCYfFQ: bets $8
s0erZsDxbZSaEPheMgibKg: folds
lfD8cBv31A/pio3pXJbPjA: calls $8
*** TURN *** [9d Td 5h] [8h]
5iPk5MyO3KVu18Y8XCYfFQ: bets $29.10 and is all-in
lfD8cBv31A/pio3pXJbPjA: folds
5iPk5MyO3KVu18Y8XCYfFQ collected $28.55 from pot
*** SUMMARY ***
Total pot $30 | Rake $1.45
Board [9d Td 5h 8h]
Seat 1: lfD8cBv31A/pio3pXJbPjA folded on the Turn
Seat 2: tJYod1SLp2AcWPL/3hZ7ug folded before Flop (didn't bet)
Seat 3: weUZ8S7tgbaeIpzi1gBNxQ folded before Flop (didn't bet)
Seat 4: GG5lTuGt3+kwNYSbqeB6yw (button) folded before Flop (didn't bet)
Seat 5: 5iPk5MyO3KVu18Y8XCYfFQ (small blind) collected ($28.55)
Seat 6: TAfo4veNRaRlzDXMMYS3Jg (big blind) folded before Flop
Seat 7: s0erZsDxbZSaEPheMgibKg folded on the Flop



PokerStars Game #59938523692:  Hold'em No Limit ($1/$2) - 2009/07/01 0:17:02 ET
Table 'ZzSIe0zTCDv+n6hfbY5tTg' 6-max Seat #1 is the button
Seat 1: 8srN1dKQePlsv0GyTada+Q ($263.70 in chips)
Seat 2: B87ikIyZ/TzAVeXf38Ny0g ($200 in chips)
Seat 3: X7GlkHF+lkbarCLuZ4Uf0w ($40 in chips)
Seat 4: ky55L0pITYgYLeqFB9gP/Q ($135.40 in chips)
Seat 5: Q3uFdu6ztesjDFiqkagTRQ ($213.65 in chips)
Seat 6: InmkdI6G8TzSj9NhcCSyPg ($200 in chips)
B87ikIyZ/TzAVeXf38Ny0g: posts small blind $1
X7GlkHF+lkbarCLuZ4Uf0w: posts big blind $2
*** HOLE CARDS ***
ky55L0pITYgYLeqFB9gP/Q: calls $2
Q3uFdu6ztesjDFiqkagTRQ: folds
InmkdI6G8TzSj9NhcCSyPg: raises $6 to $8
8srN1dKQePlsv0GyTada+Q has timed out
8srN1dKQePlsv0GyTada+Q: folds
8srN1dKQePlsv0GyTada+Q is sitting out
8srN1dKQePlsv0GyTada+Q has returned
B87ikIyZ/TzAVeXf38Ny0g: folds
X7GlkHF+lkbarCLuZ4Uf0w: folds
ky55L0pITYgYLeqFB9gP/Q: calls $6
*** FLOP *** [5h Tc Jd]
ky55L0pITYgYLeqFB9gP/Q: checks
InmkdI6G8TzSj9NhcCSyPg: bets $12
ky55L0pITYgYLeqFB9gP/Q: calls $12
*** TURN *** [5h Tc Jd] [Qd]
ky55L0pITYgYLeqFB9gP/Q: checks
InmkdI6G8TzSj9NhcCSyPg: bets $26
ky55L0pITYgYLeqFB9gP/Q: raises $89.40 to $115.40 and is all-in
InmkdI6G8TzSj9NhcCSyPg: folds
ky55L0pITYgYLeqFB9gP/Q collected $92 from pot
ky55L0pITYgYLeqFB9gP/Q: doesn't show hand
*** SUMMARY ***
Total pot $95 | Rake $3
Board [5h Tc Jd Qd]
Seat 1: 8srN1dKQePlsv0GyTada+Q (button) folded before Flop (didn't bet)
Seat 2: B87ikIyZ/TzAVeXf38Ny0g (small blind) folded before Flop
Seat 3: X7GlkHF+lkbarCLuZ4Uf0w (big blind) folded before Flop
Seat 4: ky55L0pITYgYLeqFB9gP/Q collected ($92)
Seat 5: Q3uFdu6ztesjDFiqkagTRQ folded before Flop (didn't bet)
Seat 6: InmkdI6G8TzSj9NhcCSyPg folded on the Turn



PokerStars Game #59938523928:  Hold'em No Limit ($1/$2) - 2009/07/01 0:17:02 ET
Table 'HewZCzVOYGmuLDKthTi5Yw' 6-max Seat #3 is the button
Seat 1: 353332 ($240.20 in chips)
Seat 2: X7GlkHF+lkbarCLuZ4Uf0w ($50 in chips)
Seat 3: WJxW31eStwT28R2X/L8F5A ($3.05 in chips)
Seat 5: 513FcCI8jHyQy2VWoIQkMg ($402.50 in chips)
Seat 6: jAWL00OhCFkIBMd/+4Fzsw ($118 in chips)
513FcCI8jHyQy2VWoIQkMg: posts small blind $1
jAWL00OhCFkIBMd/+4Fzsw: posts big blind $2
*** HOLE CARDS ***
353332: folds
X7GlkHF+lkbarCLuZ4Uf0w: raises $2 to $4
WJxW31eStwT28R2X/L8F5A: calls $3.05 and is all-in
513FcCI8jHyQy2VWoIQkMg: folds
jAWL00OhCFkIBMd/+4Fzsw: calls $2
*** FLOP *** [9c 3h 7c]
jAWL00OhCFkIBMd/+4Fzsw: checks
X7GlkHF+lkbarCLuZ4Uf0w: bets $46 and is all-in
jAWL00OhCFkIBMd/+4Fzsw: folds
*** TURN *** [9c 3h 7c] [7s]
*** RIVER *** [9c 3h 7c 7s] [5h]
*** SHOW DOWN ***
X7GlkHF+lkbarCLuZ4Uf0w: shows [Ad Ah] (two pair, Aces and Sevens)
X7GlkHF+lkbarCLuZ4Uf0w collected $1.80 from side pot
WJxW31eStwT28R2X/L8F5A: mucks hand
X7GlkHF+lkbarCLuZ4Uf0w collected $9.65 from main pot
*** SUMMARY ***
Total pot $12.05 Main pot $9.65. Side pot $1.80. | Rake $0.60
Board [9c 3h 7c 7s 5h]
Seat 1: 353332 folded before Flop (didn't bet)
Seat 2: X7GlkHF+lkbarCLuZ4Uf0w showed [Ad Ah] and won ($11.45) with two pair, Aces and Sevens
Seat 3: WJxW31eStwT28R2X/L8F5A (button) mucked
Seat 5: 513FcCI8jHyQy2VWoIQkMg (small blind) folded before Flop
Seat 6: jAWL00OhCFkIBMd/+4Fzsw (big blind) folded on the Flop



PokerStars Game #59938524170:  Hold'em No Limit ($1/$2) - 2009/07/01 0:17:03 ET
Table 'rsKRKlGHlxVyqJxzO2a2Ow' 9-max Seat #4 is the button
Seat 1: uYWfQJg2hgHLxri6/uVJiw ($116.10 in chips)
Seat 2: QHxJjpVYwitg9krW6wZgJA ($255.55 in chips)
Seat 3: 9sYbXdhj1M2bwKrVNxj5+Q ($107.80 in chips)
Seat 4: zJtQ1gxyi72XvGYS1tM+DA ($175.55 in chips)
Seat 5: 5Q8U6iZbeO7xJSS4qvDP5g ($201 in chips)
Seat 6: H6Z4+qu8gR0VUiPOijndVg ($200 in chips)
Seat 7: kVCeGJ4NY7Fb0W74j1mAqA ($206 in chips)
Seat 8: Hc2itIxwbi1lwa+DAYYQGg ($37 in chips)
Seat 9: 5iPk5MyO3KVu18Y8XCYfFQ ($121 in chips)
5Q8U6iZbeO7xJSS4qvDP5g: posts small blind $1
H6Z4+qu8gR0VUiPOijndVg: posts big blind $2
*** HOLE CARDS ***
kVCeGJ4NY7Fb0W74j1mAqA: raises $5 to $7
Hc2itIxwbi1lwa+DAYYQGg: folds
5iPk5MyO3KVu18Y8XCYfFQ: folds
uYWfQJg2hgHLxri6/uVJiw: folds
QHxJjpVYwitg9krW6wZgJA: folds
9sYbXdhj1M2bwKrVNxj5+Q: folds
zJtQ1gxyi72XvGYS1tM+DA: folds
5Q8U6iZbeO7xJSS4qvDP5g: folds
H6Z4+qu8gR0VUiPOijndVg: folds
kVCeGJ4NY7Fb0W74j1mAqA collected $5 from pot
kVCeGJ4NY7Fb0W74j1mAqA: doesn't show hand
*** SUMMARY ***
Total pot $5 | Rake $0
Seat 1: uYWfQJg2hgHLxri6/uVJiw folded before Flop (didn't bet)
Seat 2: QHxJjpVYwitg9krW6wZgJA folded before Flop (didn't bet)
Seat 3: 9sYbXdhj1M2bwKrVNxj5+Q folded before Flop (didn't bet)
Seat 4: zJtQ1gxyi72XvGYS1tM+DA (button) folded before Flop (didn't bet)
Seat 5: 5Q8U6iZbeO7xJSS4qvDP5g (small blind) folded before Flop
Seat 6: H6Z4+qu8gR0VUiPOijndVg (big blind) folded before Flop
Seat 7: kVCeGJ4NY7Fb0W74j1mAqA collected ($5)
Seat 8: Hc2itIxwbi1lwa+DAYYQGg folded before Flop (didn't bet)
Seat 9: 5iPk5MyO3KVu18Y8XCYfFQ folded before Flop (didn't bet)



PokerStars Game #59938525376:  Hold'em No Limit ($1/$2) - 2009/07/01 0:17:04 ET
Table 'NmY84NAf9Mh0ckAckHnh5g' 2-max Seat #2 is the button
Seat 1: 6hvg964TSqZ3AL/0XK9aVQ ($585.90 in chips)
Seat 2: RwDoM55ZeQuI2ADyJhOb2Q ($198 in chips)
RwDoM55ZeQuI2ADyJhOb2Q: posts small blind $1
6hvg964TSqZ3AL/0XK9aVQ: posts big blind $2
*** HOLE CARDS ***
RwDoM55ZeQuI2ADyJhOb2Q: raises $4 to $6
6hvg964TSqZ3AL/0XK9aVQ: calls $4
*** FLOP *** [Kc Jd 5h]
6hvg964TSqZ3AL/0XK9aVQ: checks
RwDoM55ZeQuI2ADyJhOb2Q: bets $8
6hvg964TSqZ3AL/0XK9aVQ: calls $8
*** TURN *** [Kc Jd 5h] [8c]
6hvg964TSqZ3AL/0XK9aVQ: checks
RwDoM55ZeQuI2ADyJhOb2Q: bets $22
6hvg964TSqZ3AL/0XK9aVQ: calls $22
*** RIVER *** [Kc Jd 5h 8c] [Jc]
6hvg964TSqZ3AL/0XK9aVQ: checks
RwDoM55ZeQuI2ADyJhOb2Q: checks
*** SHOW DOWN ***
6hvg964TSqZ3AL/0XK9aVQ: shows [Td Jh] (three of a kind, Jacks)
RwDoM55ZeQuI2ADyJhOb2Q: mucks hand
6hvg964TSqZ3AL/0XK9aVQ collected $71.50 from pot
*** SUMMARY ***
Total pot $72 | Rake $0.50
Board [Kc Jd 5h 8c Jc]
Seat 1: 6hvg964TSqZ3AL/0XK9aVQ (big blind) showed [Td Jh] and won ($71.50) with three of a kind, Jacks
Seat 2: RwDoM55ZeQuI2ADyJhOb2Q (button) (small blind) mucked



PokerStars Game #59938525642:  Hold'em No Limit ($1/$2) - 2009/07/01 0:17:05 ET
Table 'mGpP9StWRnoeiBDExc6Frg' 6-max Seat #2 is the button
Seat 1: zWFU82nxIRvzK4mKiL4m0Q ($75.05 in chips)
Seat 2: DQlskgG4OtLpF2MVxLwf4A ($200 in chips)
Seat 3: 3HrFUl+TAqSP1U00zz3P7A ($173.60 in chips)
Seat 4: qXDd0ZyMIse0OBu8pxeQ3Q ($218 in chips)
Seat 5: d1puGuVBE0fidn+5eRJ0tw ($167 in chips)
Seat 6: X7GlkHF+lkbarCLuZ4Uf0w ($26.45 in chips)
3HrFUl+TAqSP1U00zz3P7A: posts small blind $1
qXDd0ZyMIse0OBu8pxeQ3Q: posts big blind $2
*** HOLE CARDS ***
d1puGuVBE0fidn+5eRJ0tw: calls $2
X7GlkHF+lkbarCLuZ4Uf0w: folds
zWFU82nxIRvzK4mKiL4m0Q: folds
DQlskgG4OtLpF2MVxLwf4A: folds
3HrFUl+TAqSP1U00zz3P7A: calls $1
qXDd0ZyMIse0OBu8pxeQ3Q: checks
*** FLOP *** [Kc 2s Jd]
3HrFUl+TAqSP1U00zz3P7A: checks
qXDd0ZyMIse0OBu8pxeQ3Q: checks
d1puGuVBE0fidn+5eRJ0tw: bets $4
3HrFUl+TAqSP1U00zz3P7A: folds
qXDd0ZyMIse0OBu8pxeQ3Q: folds
d1puGuVBE0fidn+5eRJ0tw collected $5.70 from pot
*** SUMMARY ***
Total pot $6 | Rake $0.30
Board [Kc 2s Jd]
Seat 1: zWFU82nxIRvzK4mKiL4m0Q folded before Flop (didn't bet)
Seat 2: DQlskgG4OtLpF2MVxLwf4A (button) folded before Flop (didn't bet)
Seat 3: 3HrFUl+TAqSP1U00zz3P7A (small blind) folded on the Flop
Seat 4: qXDd0ZyMIse0OBu8pxeQ3Q (big blind) folded on the Flop
Seat 5: d1puGuVBE0fidn+5eRJ0tw collected ($5.70)
Seat 6: X7GlkHF+lkbarCLuZ4Uf0w folded before Flop (didn't bet)



PokerStars Game #59938529790:  Hold'em No Limit ($1/$2) - 2009/07/01 0:17:11 ET
Table 'bIihwBANJSFqlHPPtset+w' 9-max Seat #9 is the button
Seat 1: jI3JDUGV63ccqtKgM3vMbw ($157.70 in chips)
Seat 2: lQYT23h5QCUVZAKxjOO39Q ($125.90 in chips)
Seat 3: acnZ0LD5jxKgWIHz+mpQ8Q ($223.25 in chips)
Seat 4: 7WWX5PClBdr/U44gUKBIEA ($296.05 in chips)
Seat 6: 5iPk5MyO3KVu18Y8XCYfFQ ($83 in chips)
Seat 7: 3q2/0oJr3Mcy1W5tcN61ug ($200 in chips)
Seat 8: iMe5yhc+1BaiIPHet3NMrA ($278.65 in chips)
Seat 9: rW/MyplHylMSBRaoRUzWrg ($40 in chips)
jI3JDUGV63ccqtKgM3vMbw: posts small blind $1
lQYT23h5QCUVZAKxjOO39Q: posts big blind $2
*** HOLE CARDS ***
acnZ0LD5jxKgWIHz+mpQ8Q: folds
7WWX5PClBdr/U44gUKBIEA: folds
5iPk5MyO3KVu18Y8XCYfFQ: folds
3q2/0oJr3Mcy1W5tcN61ug: raises $4 to $6
iMe5yhc+1BaiIPHet3NMrA: folds
rW/MyplHylMSBRaoRUzWrg: folds
jI3JDUGV63ccqtKgM3vMbw: folds
lQYT23h5QCUVZAKxjOO39Q: calls $4
*** FLOP *** [4d Ac Kd]
lQYT23h5QCUVZAKxjOO39Q: checks
3q2/0oJr3Mcy1W5tcN61ug: bets $8
lQYT23h5QCUVZAKxjOO39Q: folds
3q2/0oJr3Mcy1W5tcN61ug collected $12.35 from pot
*** SUMMARY ***
Total pot $13 | Rake $0.65
Board [4d Ac Kd]
Seat 1: jI3JDUGV63ccqtKgM3vMbw (small blind) folded before Flop
Seat 2: lQYT23h5QCUVZAKxjOO39Q (big blind) folded on the Flop
Seat 3: acnZ0LD5jxKgWIHz+mpQ8Q folded before Flop (didn't bet)
Seat 4: 7WWX5PClBdr/U44gUKBIEA folded before Flop (didn't bet)
Seat 6: 5iPk5MyO3KVu18Y8XCYfFQ folded before Flop (didn't bet)
Seat 7: 3q2/0oJr3Mcy1W5tcN61ug collected ($12.35)
Seat 8: iMe5yhc+1BaiIPHet3NMrA folded before Flop (didn't bet)
Seat 9: rW/MyplHylMSBRaoRUzWrg (button) folded before Flop (didn't bet)



PokerStars Game #59938530734:  Hold'em No Limit ($1/$2) - 2009/07/01 0:17:12 ET
Table 'aSf77Sj8QEnzcc0WaxVD4Q' 6-max Seat #3 is the button
Seat 1: Q3uFdu6ztesjDFiqkagTRQ ($250.20 in chips)
Seat 2: vkfxu8f/jMYKUk6Ly4eujw ($256.15 in chips)
Seat 3: 9dpyyjDTCed6nV7JhaUUpw ($200 in chips)
Seat 4: 513FcCI8jHyQy2VWoIQkMg ($200 in chips)
Seat 5: InmkdI6G8TzSj9NhcCSyPg ($247 in chips)
Seat 6: vkoJRf3gidxY1pPi0AFWww ($300.60 in chips)
513FcCI8jHyQy2VWoIQkMg: posts small blind $1
InmkdI6G8TzSj9NhcCSyPg: posts big blind $2
*** HOLE CARDS ***
vkoJRf3gidxY1pPi0AFWww: folds
Q3uFdu6ztesjDFiqkagTRQ: folds
vkfxu8f/jMYKUk6Ly4eujw: folds
9dpyyjDTCed6nV7JhaUUpw: folds
513FcCI8jHyQy2VWoIQkMg: folds
InmkdI6G8TzSj9NhcCSyPg collected $2 from pot
InmkdI6G8TzSj9NhcCSyPg: doesn't show hand
*** SUMMARY ***
Total pot $2 | Rake $0
Seat 1: Q3uFdu6ztesjDFiqkagTRQ folded before Flop (didn't bet)
Seat 2: vkfxu8f/jMYKUk6Ly4eujw folded before Flop (didn't bet)
Seat 3: 9dpyyjDTCed6nV7JhaUUpw (button) folded before Flop (didn't bet)
Seat 4: 513FcCI8jHyQy2VWoIQkMg (small blind) folded before Flop
Seat 5: InmkdI6G8TzSj9NhcCSyPg (big blind) collected ($2)
Seat 6: vkoJRf3gidxY1pPi0AFWww folded before Flop (didn't bet)



PokerStars Game #59938531832:  Hold'em No Limit ($1/$2) - 2009/07/01 0:17:14 ET
Table 'l5lZHc5JRHEDt0Y2AVPq3g' 6-max Seat #2 is the button
Seat 1: gGPaCoSWW1HoKYaqfAPecg ($227.20 in chips)
Seat 2: /PH6Ffnho4Ysm8S3V/oa+w ($40 in chips)
Seat 3: DQlskgG4OtLpF2MVxLwf4A ($198 in chips)
Seat 4: zNjJ/y4emmF+vzrCDd+ooA ($203.65 in chips)
Seat 5: X7GlkHF+lkbarCLuZ4Uf0w ($55.85 in chips)
Seat 6: vkfxu8f/jMYKUk6Ly4eujw ($189.30 in chips)
DQlskgG4OtLpF2MVxLwf4A: posts small blind $1
zNjJ/y4emmF+vzrCDd+ooA: posts big blind $2
*** HOLE CARDS ***
X7GlkHF+lkbarCLuZ4Uf0w: folds
vkfxu8f/jMYKUk6Ly4eujw: folds
gGPaCoSWW1HoKYaqfAPecg: raises $5 to $7
/PH6Ffnho4Ysm8S3V/oa+w: folds
DQlskgG4OtLpF2MVxLwf4A: folds
zNjJ/y4emmF+vzrCDd+ooA: folds
gGPaCoSWW1HoKYaqfAPecg collected $5 from pot
gGPaCoSWW1HoKYaqfAPecg: doesn't show hand
*** SUMMARY ***
Total pot $5 | Rake $0
Seat 1: gGPaCoSWW1HoKYaqfAPecg collected ($5)
Seat 2: /PH6Ffnho4Ysm8S3V/oa+w (button) folded before Flop (didn't bet)
Seat 3: DQlskgG4OtLpF2MVxLwf4A (small blind) folded before Flop
Seat 4: zNjJ/y4emmF+vzrCDd+ooA (big blind) folded before Flop
Seat 5: X7GlkHF+lkbarCLuZ4Uf0w folded before Flop (didn't bet)
Seat 6: vkfxu8f/jMYKUk6Ly4eujw folded before Flop (didn't bet)



PokerStars Game #59938535362:  Hold'em No Limit ($1/$2) - 2009/07/01 0:17:19 ET
Table 'on4i1U1lCRmxsduFD3xiSg' 9-max Seat #8 is the button
Seat 1: so5k3vFDmokh2q3dImJ1GQ ($118 in chips)
Seat 2: yZYrOeNDxQxkzpbgKX1bng ($66.65 in chips)
Seat 3: 5iPk5MyO3KVu18Y8XCYfFQ ($61.20 in chips)
Seat 4: Z3aYCZG/yXHYFjiWkGI5ug ($530.10 in chips)
Seat 5: QHxJjpVYwitg9krW6wZgJA ($203 in chips)
Seat 6: CUZwDpLTQKhzarPe+JCLOQ ($214.55 in chips)
Seat 7: xD4ElYxz6Ollzmam8BmMCw ($197 in chips)
Seat 8: cdC54j9fGGojcbzWB5PgzA ($200 in chips)
Seat 9: iMe5yhc+1BaiIPHet3NMrA ($201 in chips)
iMe5yhc+1BaiIPHet3NMrA: posts small blind $1
so5k3vFDmokh2q3dImJ1GQ: posts big blind $2
*** HOLE CARDS ***
yZYrOeNDxQxkzpbgKX1bng: folds
5iPk5MyO3KVu18Y8XCYfFQ: folds
Z3aYCZG/yXHYFjiWkGI5ug: folds
QHxJjpVYwitg9krW6wZgJA: folds
CUZwDpLTQKhzarPe+JCLOQ: folds
xD4ElYxz6Ollzmam8BmMCw: folds
cdC54j9fGGojcbzWB5PgzA: folds
iMe5yhc+1BaiIPHet3NMrA: folds
so5k3vFDmokh2q3dImJ1GQ collected $2 from pot
*** SUMMARY ***
Total pot $2 | Rake $0
Seat 1: so5k3vFDmokh2q3dImJ1GQ (big blind) collected ($2)
Seat 2: yZYrOeNDxQxkzpbgKX1bng folded before Flop (didn't bet)
Seat 3: 5iPk5MyO3KVu18Y8XCYfFQ folded before Flop (didn't bet)
Seat 4: Z3aYCZG/yXHYFjiWkGI5ug folded before Flop (didn't bet)
Seat 5: QHxJjpVYwitg9krW6wZgJA folded before Flop (didn't bet)
Seat 6: CUZwDpLTQKhzarPe+JCLOQ folded before Flop (didn't bet)
Seat 7: xD4ElYxz6Ollzmam8BmMCw folded before Flop (didn't bet)
Seat 8: cdC54j9fGGojcbzWB5PgzA (button) folded before Flop (didn't bet)
Seat 9: iMe5yhc+1BaiIPHet3NMrA (small blind) folded before Flop



PokerStars Game #59938537670:  Hold'em No Limit ($1/$2) - 2009/07/01 0:17:23 ET
Table 'eyAQSIlgc2o1Jxvbve4WGg' 9-max Seat #7 is the button
Seat 1: Q3uFdu6ztesjDFiqkagTRQ ($232 in chips)
Seat 3: TAfo4veNRaRlzDXMMYS3Jg ($37 in chips)
Seat 4: miAHPEBdznuHNzK6YM3hRA ($108.20 in chips)
Seat 5: JnV3SM2D6dAFYyGZHHpvrg ($97 in chips)
Seat 6: IikcENBHwoT7snSvBPSc7Q ($178.60 in chips)
Seat 7: QHxJjpVYwitg9krW6wZgJA ($200 in chips)
Seat 8: 5iPk5MyO3KVu18Y8XCYfFQ ($36.60 in chips)
Seat 9: Hc2itIxwbi1lwa+DAYYQGg ($44.85 in chips)
5iPk5MyO3KVu18Y8XCYfFQ: posts small blind $1
Hc2itIxwbi1lwa+DAYYQGg: posts big blind $2
g7gL2NLJCdZPPV399WKT1w: sits out
*** HOLE CARDS ***
Q3uFdu6ztesjDFiqkagTRQ: folds
TAfo4veNRaRlzDXMMYS3Jg: folds
miAHPEBdznuHNzK6YM3hRA: calls $2
JnV3SM2D6dAFYyGZHHpvrg: folds
IikcENBHwoT7snSvBPSc7Q: folds
QHxJjpVYwitg9krW6wZgJA: calls $2
5iPk5MyO3KVu18Y8XCYfFQ: folds
Hc2itIxwbi1lwa+DAYYQGg: checks
*** FLOP *** [3s Qc 5h]
Hc2itIxwbi1lwa+DAYYQGg: checks
miAHPEBdznuHNzK6YM3hRA: checks
QHxJjpVYwitg9krW6wZgJA: bets $6
Hc2itIxwbi1lwa+DAYYQGg: folds
miAHPEBdznuHNzK6YM3hRA: folds
QHxJjpVYwitg9krW6wZgJA collected $6.65 from pot
QHxJjpVYwitg9krW6wZgJA: doesn't show hand
*** SUMMARY ***
Total pot $7 | Rake $0.35
Board [3s Qc 5h]
Seat 1: Q3uFdu6ztesjDFiqkagTRQ folded before Flop (didn't bet)
Seat 3: TAfo4veNRaRlzDXMMYS3Jg folded before Flop (didn't bet)
Seat 4: miAHPEBdznuHNzK6YM3hRA folded on the Flop
Seat 5: JnV3SM2D6dAFYyGZHHpvrg folded before Flop (didn't bet)
Seat 6: IikcENBHwoT7snSvBPSc7Q folded before Flop (didn't bet)
Seat 7: QHxJjpVYwitg9krW6wZgJA (button) collected ($6.65)
Seat 8: 5iPk5MyO3KVu18Y8XCYfFQ (small blind) folded before Flop
Seat 9: Hc2itIxwbi1lwa+DAYYQGg (big blind) folded on the Flop



PokerStars Game #59938539208:  Hold'em No Limit ($1/$2) - 2009/07/01 0:17:25 ET
Table 'W9UeSV0aoPjh5SFSxM8jUQ' 9-max Seat #2 is the button
Seat 1: cdC54j9fGGojcbzWB5PgzA ($204.60 in chips)
Seat 2: iMe5yhc+1BaiIPHet3NMrA ($313.75 in chips)
Seat 3: TAfo4veNRaRlzDXMMYS3Jg ($38 in chips)
Seat 4: De9g+AYjo0DN6C/+iT/nsg ($197 in chips)
Seat 6: MXxB6weBWzZyAhRZb+/KVg ($198 in chips)
Seat 7: 4Cl43Q1TYQL8wn1NSCUkaw ($46.60 in chips)
Seat 8: z89zAYE4dlPgjkofBKII0Q ($40 in chips)
Seat 9: U2A5Hv6ib/5+gzO2wr7Z4w ($203 in chips)
TAfo4veNRaRlzDXMMYS3Jg: posts small blind $1
De9g+AYjo0DN6C/+iT/nsg: posts big blind $2
CUZwDpLTQKhzarPe+JCLOQ: sits out
z89zAYE4dlPgjkofBKII0Q: posts big blind $2
*** HOLE CARDS ***
MXxB6weBWzZyAhRZb+/KVg: calls $2
4Cl43Q1TYQL8wn1NSCUkaw: calls $2
z89zAYE4dlPgjkofBKII0Q: checks
U2A5Hv6ib/5+gzO2wr7Z4w: folds
cdC54j9fGGojcbzWB5PgzA: folds
iMe5yhc+1BaiIPHet3NMrA: folds
TAfo4veNRaRlzDXMMYS3Jg: folds
De9g+AYjo0DN6C/+iT/nsg: checks
*** FLOP *** [6h 6d 3h]
De9g+AYjo0DN6C/+iT/nsg: checks
MXxB6weBWzZyAhRZb+/KVg: checks
4Cl43Q1TYQL8wn1NSCUkaw: checks
z89zAYE4dlPgjkofBKII0Q: bets $6
De9g+AYjo0DN6C/+iT/nsg: folds
MXxB6weBWzZyAhRZb+/KVg: folds
4Cl43Q1TYQL8wn1NSCUkaw: folds
z89zAYE4dlPgjkofBKII0Q collected $8.55 from pot
*** SUMMARY ***
Total pot $9 | Rake $0.45
Board [6h 6d 3h]
Seat 1: cdC54j9fGGojcbzWB5PgzA folded before Flop (didn't bet)
Seat 2: iMe5yhc+1BaiIPHet3NMrA (button) folded before Flop (didn't bet)
Seat 3: TAfo4veNRaRlzDXMMYS3Jg (small blind) folded before Flop
Seat 4: De9g+AYjo0DN6C/+iT/nsg (big blind) folded on the Flop
Seat 6: MXxB6weBWzZyAhRZb+/KVg folded on the Flop
Seat 7: 4Cl43Q1TYQL8wn1NSCUkaw folded on the Flop
Seat 8: z89zAYE4dlPgjkofBKII0Q collected ($8.55)
Seat 9: U2A5Hv6ib/5+gzO2wr7Z4w folded before Flop (didn't bet)



PokerStars Game #59938543288:  Hold'em No Limit ($1/$2) - 2009/07/01 0:17:31 ET
Table 'gnHBqWll9O3fxG7Ojkz/ng' 9-max Seat #1 is the button
Seat 1: hpqdC/23wXosGOmzARr5NA ($149.05 in chips)
Seat 2: H6Z4+qu8gR0VUiPOijndVg ($201 in chips)
Seat 3: 5Q8U6iZbeO7xJSS4qvDP5g ($225.35 in chips)
Seat 4: n5XI5/7gN+gIubHFBH+mOw ($401.15 in chips)
Seat 5: rBQDMkKm9cZn6M9NPsiVew ($167 in chips)
Seat 6: 5iPk5MyO3KVu18Y8XCYfFQ ($58.45 in chips)
Seat 9: kVCeGJ4NY7Fb0W74j1mAqA ($200 in chips)
H6Z4+qu8gR0VUiPOijndVg: posts small blind $1
5Q8U6iZbeO7xJSS4qvDP5g: posts big blind $2
*** HOLE CARDS ***
n5XI5/7gN+gIubHFBH+mOw: folds
rBQDMkKm9cZn6M9NPsiVew: folds
JpnYBfO6Nq6INmRDDoBX1g said, "lol no draw call nice"
5iPk5MyO3KVu18Y8XCYfFQ: folds
kVCeGJ4NY7Fb0W74j1mAqA: folds
hpqdC/23wXosGOmzARr5NA: folds
JpnYBfO6Nq6INmRDDoBX1g leaves the table
H6Z4+qu8gR0VUiPOijndVg: folds
5Q8U6iZbeO7xJSS4qvDP5g collected $2 from pot
5Q8U6iZbeO7xJSS4qvDP5g: doesn't show hand
*** SUMMARY ***
Total pot $2 | Rake $0
Seat 1: hpqdC/23wXosGOmzARr5NA (button) folded before Flop (didn't bet)
Seat 2: H6Z4+qu8gR0VUiPOijndVg (small blind) folded before Flop
Seat 3: 5Q8U6iZbeO7xJSS4qvDP5g (big blind) collected ($2)
Seat 4: n5XI5/7gN+gIubHFBH+mOw folded before Flop (didn't bet)
Seat 5: rBQDMkKm9cZn6M9NPsiVew folded before Flop (didn't bet)
Seat 6: 5iPk5MyO3KVu18Y8XCYfFQ folded before Flop (didn't bet)
Seat 9: kVCeGJ4NY7Fb0W74j1mAqA folded before Flop (didn't bet)



PokerStars Game #59938544510:  Hold'em No Limit ($1/$2) - 2009/07/01 0:17:32 ET
Table 'WCA60bDA8ecovUgFSIZkTQ' 9-max Seat #5 is the button
Seat 1: CUZwDpLTQKhzarPe+JCLOQ ($211.75 in chips)
Seat 2: G1h8wamBcVJXtsKXZQ2EyA ($105.85 in chips)
Seat 3: 5iPk5MyO3KVu18Y8XCYfFQ ($39 in chips)
Seat 4: Q3uFdu6ztesjDFiqkagTRQ ($461.70 in chips)
Seat 5: Hc2itIxwbi1lwa+DAYYQGg ($300.30 in chips)
Seat 6: DOWQSOJ7GaX+ksfWTqPT5A ($232.50 in chips)
Seat 7: 2YpnxJiexJHyERfbqgwEcw ($58 in chips)
Seat 8: x+V1JgVDawsJTxKcxm7gxw ($91 in chips)
Seat 9: 3q2/0oJr3Mcy1W5tcN61ug ($294.20 in chips)
DOWQSOJ7GaX+ksfWTqPT5A: posts small blind $1
2YpnxJiexJHyERfbqgwEcw: posts big blind $2
*** HOLE CARDS ***
x+V1JgVDawsJTxKcxm7gxw: folds
3q2/0oJr3Mcy1W5tcN61ug: folds
CUZwDpLTQKhzarPe+JCLOQ: folds
G1h8wamBcVJXtsKXZQ2EyA: folds
5iPk5MyO3KVu18Y8XCYfFQ: raises $2 to $4
Q3uFdu6ztesjDFiqkagTRQ: folds
Hc2itIxwbi1lwa+DAYYQGg: folds
DOWQSOJ7GaX+ksfWTqPT5A: calls $3
2YpnxJiexJHyERfbqgwEcw: folds
*** FLOP *** [3c Ac 6c]
DOWQSOJ7GaX+ksfWTqPT5A: checks
5iPk5MyO3KVu18Y8XCYfFQ: bets $6
DOWQSOJ7GaX+ksfWTqPT5A: calls $6
*** TURN *** [3c Ac 6c] [4c]
DOWQSOJ7GaX+ksfWTqPT5A: checks
5iPk5MyO3KVu18Y8XCYfFQ: checks
*** RIVER *** [3c Ac 6c 4c] [Qh]
DOWQSOJ7GaX+ksfWTqPT5A: bets $6
5iPk5MyO3KVu18Y8XCYfFQ: calls $6
*** SHOW DOWN ***
DOWQSOJ7GaX+ksfWTqPT5A: shows [4d 7c] (a flush, Ace high)
5iPk5MyO3KVu18Y8XCYfFQ: mucks hand
DOWQSOJ7GaX+ksfWTqPT5A collected $32.40 from pot
*** SUMMARY ***
Total pot $34 | Rake $1.60
Board [3c Ac 6c 4c Qh]
Seat 1: CUZwDpLTQKhzarPe+JCLOQ folded before Flop (didn't bet)
Seat 2: G1h8wamBcVJXtsKXZQ2EyA folded before Flop (didn't bet)
Seat 3: 5iPk5MyO3KVu18Y8XCYfFQ mucked
Seat 4: Q3uFdu6ztesjDFiqkagTRQ folded before Flop (didn't bet)
Seat 5: Hc2itIxwbi1lwa+DAYYQGg (button) folded before Flop (didn't bet)
Seat 6: DOWQSOJ7GaX+ksfWTqPT5A (small blind) showed [4d 7c] and won ($32.40) with a flush, Ace high
Seat 7: 2YpnxJiexJHyERfbqgwEcw (big blind) folded before Flop
Seat 8: x+V1JgVDawsJTxKcxm7gxw folded before Flop (didn't bet)
Seat 9: 3q2/0oJr3Mcy1W5tcN61ug folded before Flop (didn't bet)



PokerStars Game #59938544706:  Hold'em No Limit ($1/$2) - 2009/07/01 0:17:33 ET
Table 'qVXak+oTeDXMGbWa4sDU5Q' 9-max Seat #8 is the button
Seat 1: H6Z4+qu8gR0VUiPOijndVg ($257.30 in chips)
Seat 2: Hc2itIxwbi1lwa+DAYYQGg ($46 in chips)
Seat 3: oz9eCXGC7DdjQlL/nuWj1A ($120.65 in chips)
Seat 4: b0jO1SDhLedy1//CQlA8kw ($40 in chips)
Seat 5: NqKRc5xvcye0d7F6VOF6MQ ($82.50 in chips)
Seat 6: Q3uFdu6ztesjDFiqkagTRQ ($200 in chips)
Seat 7: 5iPk5MyO3KVu18Y8XCYfFQ ($109 in chips)
Seat 8: 9pHZMviI9R8injxojGTnvw ($118.80 in chips)
Seat 9: ZP45Tu5Zqo4v+ZgqIQVoOQ ($198 in chips)
ZP45Tu5Zqo4v+ZgqIQVoOQ: posts small blind $1
H6Z4+qu8gR0VUiPOijndVg: posts big blind $2
*** HOLE CARDS ***
Hc2itIxwbi1lwa+DAYYQGg: folds
oz9eCXGC7DdjQlL/nuWj1A: folds
b0jO1SDhLedy1//CQlA8kw: raises $5 to $7
NqKRc5xvcye0d7F6VOF6MQ: folds
Q3uFdu6ztesjDFiqkagTRQ: folds
5iPk5MyO3KVu18Y8XCYfFQ: folds
9pHZMviI9R8injxojGTnvw: folds
ZP45Tu5Zqo4v+ZgqIQVoOQ: folds
H6Z4+qu8gR0VUiPOijndVg: folds
b0jO1SDhLedy1//CQlA8kw collected $5 from pot
b0jO1SDhLedy1//CQlA8kw: doesn't show hand
*** SUMMARY ***
Total pot $5 | Rake $0
Seat 1: H6Z4+qu8gR0VUiPOijndVg (big blind) folded before Flop
Seat 2: Hc2itIxwbi1lwa+DAYYQGg folded before Flop (didn't bet)
Seat 3: oz9eCXGC7DdjQlL/nuWj1A folded before Flop (didn't bet)
Seat 4: b0jO1SDhLedy1//CQlA8kw collected ($5)
Seat 5: NqKRc5xvcye0d7F6VOF6MQ folded before Flop (didn't bet)
Seat 6: Q3uFdu6ztesjDFiqkagTRQ folded before Flop (didn't bet)
Seat 7: 5iPk5MyO3KVu18Y8XCYfFQ folded before Flop (didn't bet)
Seat 8: 9pHZMviI9R8injxojGTnvw (button) folded before Flop (didn't bet)
Seat 9: ZP45Tu5Zqo4v+ZgqIQVoOQ (small blind) folded before Flop



PokerStars Game #59938545122:  Hold'em No Limit ($1/$2) - 2009/07/01 0:17:33 ET
Table '3FGoiEOffWrbgTfsB3t7FA' 2-max Seat #1 is the button
Seat 1: e0oDWyrmgLpR6bROEqw1nQ ($362 in chips)
Seat 2: +sy/nlNI20yZraIjs4AALg ($236.65 in chips)
e0oDWyrmgLpR6bROEqw1nQ: posts small blind $1
+sy/nlNI20yZraIjs4AALg: posts big blind $2
*** HOLE CARDS ***
e0oDWyrmgLpR6bROEqw1nQ: raises $4 to $6
+sy/nlNI20yZraIjs4AALg: raises $4 to $10
e0oDWyrmgLpR6bROEqw1nQ: calls $4
*** FLOP *** [6d 7c Ks]
+sy/nlNI20yZraIjs4AALg: checks
e0oDWyrmgLpR6bROEqw1nQ: checks
*** TURN *** [6d 7c Ks] [2s]
+sy/nlNI20yZraIjs4AALg: checks
e0oDWyrmgLpR6bROEqw1nQ: checks
*** RIVER *** [6d 7c Ks 2s] [Jc]
+sy/nlNI20yZraIjs4AALg: bets $20
e0oDWyrmgLpR6bROEqw1nQ: calls $20
*** SHOW DOWN ***
+sy/nlNI20yZraIjs4AALg: shows [Kc Td] (a pair of Kings)
e0oDWyrmgLpR6bROEqw1nQ: mucks hand
+sy/nlNI20yZraIjs4AALg collected $59.50 from pot
*** SUMMARY ***
Total pot $60 | Rake $0.50
Board [6d 7c Ks 2s Jc]
Seat 1: e0oDWyrmgLpR6bROEqw1nQ (button) (small blind) mucked
Seat 2: +sy/nlNI20yZraIjs4AALg (big blind) showed [Kc Td] and won ($59.50) with a pair of Kings



PokerStars Game #59938545890:  Hold'em No Limit ($1/$2) - 2009/07/01 0:17:34 ET
Table 'rsKRKlGHlxVyqJxzO2a2Ow' 9-max Seat #5 is the button
Seat 1: uYWfQJg2hgHLxri6/uVJiw ($116.10 in chips)
Seat 2: QHxJjpVYwitg9krW6wZgJA ($255.55 in chips)
Seat 3: 9sYbXdhj1M2bwKrVNxj5+Q ($107.80 in chips)
Seat 4: zJtQ1gxyi72XvGYS1tM+DA ($175.55 in chips)
Seat 5: 5Q8U6iZbeO7xJSS4qvDP5g ($200 in chips)
Seat 6: H6Z4+qu8gR0VUiPOijndVg ($200 in chips)
Seat 8: Hc2itIxwbi1lwa+DAYYQGg ($37 in chips)
Seat 9: 5iPk5MyO3KVu18Y8XCYfFQ ($121 in chips)
H6Z4+qu8gR0VUiPOijndVg: posts small blind $1
kVCeGJ4NY7Fb0W74j1mAqA: is sitting out
Hc2itIxwbi1lwa+DAYYQGg: posts big blind $2
*** HOLE CARDS ***
kVCeGJ4NY7Fb0W74j1mAqA leaves the table
5iPk5MyO3KVu18Y8XCYfFQ: folds
uYWfQJg2hgHLxri6/uVJiw is disconnected
uYWfQJg2hgHLxri6/uVJiw has timed out while disconnected
uYWfQJg2hgHLxri6/uVJiw: folds
uYWfQJg2hgHLxri6/uVJiw is sitting out
QHxJjpVYwitg9krW6wZgJA: folds
9sYbXdhj1M2bwKrVNxj5+Q: folds
zJtQ1gxyi72XvGYS1tM+DA: folds
zJtQ1gxyi72XvGYS1tM+DA leaves the table
5Q8U6iZbeO7xJSS4qvDP5g: raises $4 to $6
H6Z4+qu8gR0VUiPOijndVg: raises $16 to $22
Hc2itIxwbi1lwa+DAYYQGg: folds
5Q8U6iZbeO7xJSS4qvDP5g: folds
H6Z4+qu8gR0VUiPOijndVg collected $14 from pot
H6Z4+qu8gR0VUiPOijndVg: doesn't show hand
*** SUMMARY ***
Total pot $14 | Rake $0
Seat 1: uYWfQJg2hgHLxri6/uVJiw folded before Flop (didn't bet)
Seat 2: QHxJjpVYwitg9krW6wZgJA folded before Flop (didn't bet)
Seat 3: 9sYbXdhj1M2bwKrVNxj5+Q folded before Flop (didn't bet)
Seat 4: zJtQ1gxyi72XvGYS1tM+DA folded before Flop (didn't bet)
Seat 5: 5Q8U6iZbeO7xJSS4qvDP5g (button) folded before Flop
Seat 6: H6Z4+qu8gR0VUiPOijndVg (small blind) collected ($14)
Seat 8: Hc2itIxwbi1lwa+DAYYQGg (big blind) folded before Flop
Seat 9: 5iPk5MyO3KVu18Y8XCYfFQ folded before Flop (didn't bet)



PokerStars Game #59938549766:  Hold'em No Limit ($1/$2) - 2009/07/01 0:17:40 ET
Table 'HewZCzVOYGmuLDKthTi5Yw' 6-max Seat #5 is the button
Seat 1: 353332 ($240.20 in chips)
Seat 2: X7GlkHF+lkbarCLuZ4Uf0w ($57.45 in chips)
Seat 5: 513FcCI8jHyQy2VWoIQkMg ($401.50 in chips)
Seat 6: jAWL00OhCFkIBMd/+4Fzsw ($114 in chips)
jAWL00OhCFkIBMd/+4Fzsw: posts small blind $1
353332: posts big blind $2
*** HOLE CARDS ***
X7GlkHF+lkbarCLuZ4Uf0w: folds
WJxW31eStwT28R2X/L8F5A leaves the table
513FcCI8jHyQy2VWoIQkMg: raises $4 to $6
jAWL00OhCFkIBMd/+4Fzsw: folds
353332: raises $12 to $18
513FcCI8jHyQy2VWoIQkMg: folds
353332 collected $13 from pot
353332: doesn't show hand
*** SUMMARY ***
Total pot $13 | Rake $0
Seat 1: 353332 (big blind) collected ($13)
Seat 2: X7GlkHF+lkbarCLuZ4Uf0w folded before Flop (didn't bet)
Seat 5: 513FcCI8jHyQy2VWoIQkMg (button) folded before Flop
Seat 6: jAWL00OhCFkIBMd/+4Fzsw (small blind) folded before Flop



PokerStars Game #59938550224:  Hold'em No Limit ($1/$2) - 2009/07/01 0:17:41 ET
Table 'NmY84NAf9Mh0ckAckHnh5g' 2-max Seat #1 is the button
Seat 1: 6hvg964TSqZ3AL/0XK9aVQ ($621.40 in chips)
Seat 2: RwDoM55ZeQuI2ADyJhOb2Q ($162 in chips)
6hvg964TSqZ3AL/0XK9aVQ: posts small blind $1
RwDoM55ZeQuI2ADyJhOb2Q: posts big blind $2
*** HOLE CARDS ***
6hvg964TSqZ3AL/0XK9aVQ: calls $1
RwDoM55ZeQuI2ADyJhOb2Q: checks
*** FLOP *** [7s 8c Tc]
RwDoM55ZeQuI2ADyJhOb2Q: bets $4
6hvg964TSqZ3AL/0XK9aVQ: calls $4
*** TURN *** [7s 8c Tc] [6h]
RwDoM55ZeQuI2ADyJhOb2Q: bets $10
6hvg964TSqZ3AL/0XK9aVQ: raises $18 to $28
RwDoM55ZeQuI2ADyJhOb2Q: calls $18
*** RIVER *** [7s 8c Tc 6h] [9s]
RwDoM55ZeQuI2ADyJhOb2Q: checks
6hvg964TSqZ3AL/0XK9aVQ: checks
*** SHOW DOWN ***
RwDoM55ZeQuI2ADyJhOb2Q: shows [Ts 4c] (a straight, Six to Ten)
6hvg964TSqZ3AL/0XK9aVQ: shows [9c Ac] (a straight, Six to Ten)
RwDoM55ZeQuI2ADyJhOb2Q collected $33.75 from pot
6hvg964TSqZ3AL/0XK9aVQ collected $33.75 from pot
*** SUMMARY ***
Total pot $68 | Rake $0.50
Board [7s 8c Tc 6h 9s]
Seat 1: 6hvg964TSqZ3AL/0XK9aVQ (button) (small blind) showed [9c Ac] and won ($33.75) with a straight, Six to Ten
Seat 2: RwDoM55ZeQuI2ADyJhOb2Q (big blind) showed [Ts 4c] and won ($33.75) with a straight, Six to Ten



PokerStars Game #59938550434:  Hold'em No Limit ($1/$2) - 2009/07/01 0:17:41 ET
Table 'aSf77Sj8QEnzcc0WaxVD4Q' 6-max Seat #4 is the button
Seat 1: Q3uFdu6ztesjDFiqkagTRQ ($250.20 in chips)
Seat 2: vkfxu8f/jMYKUk6Ly4eujw ($256.15 in chips)
Seat 3: 9dpyyjDTCed6nV7JhaUUpw ($200 in chips)
Seat 4: 513FcCI8jHyQy2VWoIQkMg ($200 in chips)
Seat 5: InmkdI6G8TzSj9NhcCSyPg ($248 in chips)
Seat 6: vkoJRf3gidxY1pPi0AFWww ($300.60 in chips)
InmkdI6G8TzSj9NhcCSyPg: posts small blind $1
vkoJRf3gidxY1pPi0AFWww: posts big blind $2
*** HOLE CARDS ***
Q3uFdu6ztesjDFiqkagTRQ: folds
vkfxu8f/jMYKUk6Ly4eujw: raises $6 to $8
9dpyyjDTCed6nV7JhaUUpw: folds
513FcCI8jHyQy2VWoIQkMg: folds
InmkdI6G8TzSj9NhcCSyPg: folds
vkoJRf3gidxY1pPi0AFWww: folds
vkfxu8f/jMYKUk6Ly4eujw collected $5 from pot
vkfxu8f/jMYKUk6Ly4eujw: doesn't show hand
*** SUMMARY ***
Total pot $5 | Rake $0
Seat 1: Q3uFdu6ztesjDFiqkagTRQ folded before Flop (didn't bet)
Seat 2: vkfxu8f/jMYKUk6Ly4eujw collected ($5)
Seat 3: 9dpyyjDTCed6nV7JhaUUpw folded before Flop (didn't bet)
Seat 4: 513FcCI8jHyQy2VWoIQkMg (button) folded before Flop (didn't bet)
Seat 5: InmkdI6G8TzSj9NhcCSyPg (small blind) folded before Flop
Seat 6: vkoJRf3gidxY1pPi0AFWww (big blind) folded before Flop



PokerStars Game #59938550924:  Hold'em No Limit ($1/$2) - 2009/07/01 0:17:42 ET
Table 'l5lZHc5JRHEDt0Y2AVPq3g' 6-max Seat #3 is the button
Seat 1: gGPaCoSWW1HoKYaqfAPecg ($230.20 in chips)
Seat 2: /PH6Ffnho4Ysm8S3V/oa+w ($40 in chips)
Seat 3: DQlskgG4OtLpF2MVxLwf4A ($200 in chips)
Seat 4: zNjJ/y4emmF+vzrCDd+ooA ($201.65 in chips)
Seat 5: X7GlkHF+lkbarCLuZ4Uf0w ($55.85 in chips)
Seat 6: vkfxu8f/jMYKUk6Ly4eujw ($189.30 in chips)
zNjJ/y4emmF+vzrCDd+ooA: posts small blind $1
X7GlkHF+lkbarCLuZ4Uf0w: posts big blind $2
*** HOLE CARDS ***
vkfxu8f/jMYKUk6Ly4eujw: folds
vkfxu8f/jMYKUk6Ly4eujw leaves the table
gGPaCoSWW1HoKYaqfAPecg: folds
/PH6Ffnho4Ysm8S3V/oa+w: folds
DQlskgG4OtLpF2MVxLwf4A: folds
zNjJ/y4emmF+vzrCDd+ooA: folds
X7GlkHF+lkbarCLuZ4Uf0w collected $2 from pot
X7GlkHF+lkbarCLuZ4Uf0w: doesn't show hand
*** SUMMARY ***
Total pot $2 | Rake $0
Seat 1: gGPaCoSWW1HoKYaqfAPecg folded before Flop (didn't bet)
Seat 2: /PH6Ffnho4Ysm8S3V/oa+w folded before Flop (didn't bet)
Seat 3: DQlskgG4OtLpF2MVxLwf4A (button) folded before Flop (didn't bet)
Seat 4: zNjJ/y4emmF+vzrCDd+ooA (small blind) folded before Flop
Seat 5: X7GlkHF+lkbarCLuZ4Uf0w (big blind) collected ($2)
Seat 6: vkfxu8f/jMYKUk6Ly4eujw folded before Flop (didn't bet)



PokerStars Game #59938554402:  Hold'em No Limit ($1/$2) - 2009/07/01 0:17:47 ET
Table 'LL4bDFyhj5hsMpzaDugJZg' 6-max Seat #5 is the button
Seat 1: IBW9lyGsaRmfcbyA/qFfEw ($64.20 in chips)
Seat 2: L3l+A4pJhOAD6HVVFXvVBw ($344.50 in chips)
Seat 3: gGPaCoSWW1HoKYaqfAPecg ($200 in chips)
Seat 4: 8srN1dKQePlsv0GyTada+Q ($241.75 in chips)
Seat 5: HgX0VeqE/dzSXd5BpntRBw ($244.40 in chips)
Seat 6: /PH6Ffnho4Ysm8S3V/oa+w ($40 in chips)
/PH6Ffnho4Ysm8S3V/oa+w: posts small blind $1
IBW9lyGsaRmfcbyA/qFfEw: posts big blind $2
*** HOLE CARDS ***
L3l+A4pJhOAD6HVVFXvVBw: raises $2 to $4
gGPaCoSWW1HoKYaqfAPecg: folds
8srN1dKQePlsv0GyTada+Q: raises $12 to $16
HgX0VeqE/dzSXd5BpntRBw: folds
/PH6Ffnho4Ysm8S3V/oa+w: folds
IBW9lyGsaRmfcbyA/qFfEw: folds
L3l+A4pJhOAD6HVVFXvVBw: folds
8srN1dKQePlsv0GyTada+Q collected $11 from pot
*** SUMMARY ***
Total pot $11 | Rake $0
Seat 1: IBW9lyGsaRmfcbyA/qFfEw (big blind) folded before Flop
Seat 2: L3l+A4pJhOAD6HVVFXvVBw folded before Flop
Seat 3: gGPaCoSWW1HoKYaqfAPecg folded before Flop (didn't bet)
Seat 4: 8srN1dKQePlsv0GyTada+Q collected ($11)
Seat 5: HgX0VeqE/dzSXd5BpntRBw (button) folded before Flop (didn't bet)
Seat 6: /PH6Ffnho4Ysm8S3V/oa+w (small blind) folded before Flop



PokerStars Game #59938555434:  Hold'em No Limit ($1/$2) - 2009/07/01 0:17:48 ET
Table 'XP2sRSup+aRuwzx3vDZsDg' 6-max Seat #6 is the button
Seat 1: o9jamqIi6sTTRSqudgboRA ($226.70 in chips)
Seat 2: Ep0hd57w9DDqfTwA66dJVw ($62 in chips)
Seat 3: X7GlkHF+lkbarCLuZ4Uf0w ($37 in chips)
Seat 4: JsC+WvfzqlxVs9G8/gSQAQ ($166.30 in chips)
Seat 5: 894kvCY4GHivBpqwizsecg ($115 in chips)
Seat 6: h7ppRQJTYBsHCbLMeW9T2g ($462.75 in chips)
o9jamqIi6sTTRSqudgboRA: posts small blind $1
Ep0hd57w9DDqfTwA66dJVw: posts big blind $2
*** HOLE CARDS ***
X7GlkHF+lkbarCLuZ4Uf0w: folds
JsC+WvfzqlxVs9G8/gSQAQ: raises $4 to $6
894kvCY4GHivBpqwizsecg: folds
h7ppRQJTYBsHCbLMeW9T2g: calls $6
o9jamqIi6sTTRSqudgboRA: folds
Ep0hd57w9DDqfTwA66dJVw: calls $4
*** FLOP *** [Kd Qs Ah]
Ep0hd57w9DDqfTwA66dJVw: bets $4
JsC+WvfzqlxVs9G8/gSQAQ: raises $14 to $18
h7ppRQJTYBsHCbLMeW9T2g: folds
Ep0hd57w9DDqfTwA66dJVw: raises $38 to $56 and is all-in
JsC+WvfzqlxVs9G8/gSQAQ: calls $38
*** TURN *** [Kd Qs Ah] [9d]
*** RIVER *** [Kd Qs Ah 9d] [5s]
*** SHOW DOWN ***
Ep0hd57w9DDqfTwA66dJVw: shows [6h Ac] (a pair of Aces)
JsC+WvfzqlxVs9G8/gSQAQ: shows [As Tc] (a pair of Aces - King+Queen+Ten kicker)
JsC+WvfzqlxVs9G8/gSQAQ collected $128 from pot
*** SUMMARY ***
Total pot $131 | Rake $3
Board [Kd Qs Ah 9d 5s]
Seat 1: o9jamqIi6sTTRSqudgboRA (small blind) folded before Flop
Seat 2: Ep0hd57w9DDqfTwA66dJVw (big blind) showed [6h Ac] and lost with a pair of Aces
Seat 3: X7GlkHF+lkbarCLuZ4Uf0w folded before Flop (didn't bet)
Seat 4: JsC+WvfzqlxVs9G8/gSQAQ showed [As Tc] and won ($128) with a pair of Aces
Seat 5: 894kvCY4GHivBpqwizsecg folded before Flop (didn't bet)
Seat 6: h7ppRQJTYBsHCbLMeW9T2g (button) folded on the Flop



PokerStars Game #59938558774:  Hold'em No Limit ($1/$2) - 2009/07/01 0:17:53 ET
Table 'SF49/KQm8T4taMp6kb+HXA' 9-max Seat #2 is the button
Seat 1: l1bCLGuFqeFRwUfPsiDu/g ($235.95 in chips)
Seat 2: 8Z3QifiM9eOd5EIJ25dXNg ($45.35 in chips)
Seat 4: HffgoYm61KgkdMe/DYChIQ ($115 in chips)
Seat 5: Z3aYCZG/yXHYFjiWkGI5ug ($226.55 in chips)
Seat 6: M2ht6rIKOI/my9eh610Nlw ($228.40 in chips)
Seat 7: n2VAbLaE5qgKr5mA4W6v4w ($35.50 in chips)
Seat 8: 5iPk5MyO3KVu18Y8XCYfFQ ($43 in chips)
Seat 9: O+jytCilwk7zItVCEavmtw ($128.20 in chips)
pCmk6FpSOLJ+85o1tLHIag joins the table at seat #3
HffgoYm61KgkdMe/DYChIQ: posts small blind $1
Z3aYCZG/yXHYFjiWkGI5ug: posts big blind $2
*** HOLE CARDS ***
M2ht6rIKOI/my9eh610Nlw: folds
n2VAbLaE5qgKr5mA4W6v4w: folds
5iPk5MyO3KVu18Y8XCYfFQ: raises $2 to $4
O+jytCilwk7zItVCEavmtw: calls $4
l1bCLGuFqeFRwUfPsiDu/g: raises $14 to $18
8Z3QifiM9eOd5EIJ25dXNg: folds
HffgoYm61KgkdMe/DYChIQ: folds
Z3aYCZG/yXHYFjiWkGI5ug: folds
5iPk5MyO3KVu18Y8XCYfFQ: folds
O+jytCilwk7zItVCEavmtw: folds
l1bCLGuFqeFRwUfPsiDu/g collected $15 from pot
*** SUMMARY ***
Total pot $15 | Rake $0
Seat 1: l1bCLGuFqeFRwUfPsiDu/g collected ($15)
Seat 2: 8Z3QifiM9eOd5EIJ25dXNg (button) folded before Flop (didn't bet)
Seat 4: HffgoYm61KgkdMe/DYChIQ (small blind) folded before Flop
Seat 5: Z3aYCZG/yXHYFjiWkGI5ug (big blind) folded before Flop
Seat 6: M2ht6rIKOI/my9eh610Nlw folded before Flop (didn't bet)
Seat 7: n2VAbLaE5qgKr5mA4W6v4w folded before Flop (didn't bet)
Seat 8: 5iPk5MyO3KVu18Y8XCYfFQ folded before Flop
Seat 9: O+jytCilwk7zItVCEavmtw folded before Flop



PokerStars Game #59938559450:  Hold'em No Limit ($1/$2) - 2009/07/01 0:17:54 ET
Table 'mGpP9StWRnoeiBDExc6Frg' 6-max Seat #3 is the button
Seat 1: zWFU82nxIRvzK4mKiL4m0Q ($75.05 in chips)
Seat 2: DQlskgG4OtLpF2MVxLwf4A ($200 in chips)
Seat 3: 3HrFUl+TAqSP1U00zz3P7A ($171.60 in chips)
Seat 4: qXDd0ZyMIse0OBu8pxeQ3Q ($216 in chips)
Seat 5: d1puGuVBE0fidn+5eRJ0tw ($170.70 in chips)
Seat 6: X7GlkHF+lkbarCLuZ4Uf0w ($26.45 in chips)
qXDd0ZyMIse0OBu8pxeQ3Q: posts small blind $1
d1puGuVBE0fidn+5eRJ0tw: posts big blind $2
*** HOLE CARDS ***
X7GlkHF+lkbarCLuZ4Uf0w: folds
zWFU82nxIRvzK4mKiL4m0Q: folds
DQlskgG4OtLpF2MVxLwf4A: raises $4 to $6
3HrFUl+TAqSP1U00zz3P7A: folds
qXDd0ZyMIse0OBu8pxeQ3Q: folds
d1puGuVBE0fidn+5eRJ0tw: folds
DQlskgG4OtLpF2MVxLwf4A collected $5 from pot
DQlskgG4OtLpF2MVxLwf4A: doesn't show hand
*** SUMMARY ***
Total pot $5 | Rake $0
Seat 1: zWFU82nxIRvzK4mKiL4m0Q folded before Flop (didn't bet)
Seat 2: DQlskgG4OtLpF2MVxLwf4A collected ($5)
Seat 3: 3HrFUl+TAqSP1U00zz3P7A (button) folded before Flop (didn't bet)
Seat 4: qXDd0ZyMIse0OBu8pxeQ3Q (small blind) folded before Flop
Seat 5: d1puGuVBE0fidn+5eRJ0tw (big blind) folded before Flop
Seat 6: X7GlkHF+lkbarCLuZ4Uf0w folded before Flop (didn't bet)



PokerStars Game #59938563186:  Hold'em No Limit ($1/$2) - 2009/07/01 0:17:59 ET
Table 'gnHBqWll9O3fxG7Ojkz/ng' 9-max Seat #2 is the button
Seat 1: hpqdC/23wXosGOmzARr5NA ($149.05 in chips)
Seat 2: H6Z4+qu8gR0VUiPOijndVg ($200 in chips)
Seat 3: 5Q8U6iZbeO7xJSS4qvDP5g ($226.35 in chips)
Seat 4: n5XI5/7gN+gIubHFBH+mOw ($401.15 in chips)
Seat 5: rBQDMkKm9cZn6M9NPsiVew ($167 in chips)
Seat 6: 5iPk5MyO3KVu18Y8XCYfFQ ($58.45 in chips)
Seat 9: kVCeGJ4NY7Fb0W74j1mAqA ($200 in chips)
5Q8U6iZbeO7xJSS4qvDP5g: posts small blind $1
n5XI5/7gN+gIubHFBH+mOw: posts big blind $2
*** HOLE CARDS ***
rBQDMkKm9cZn6M9NPsiVew: folds
5iPk5MyO3KVu18Y8XCYfFQ: folds
kVCeGJ4NY7Fb0W74j1mAqA: folds
hpqdC/23wXosGOmzARr5NA: folds
cM6efHzdxoqYm0EQKP4TTQ joins the table at seat #8
H6Z4+qu8gR0VUiPOijndVg: folds
5Q8U6iZbeO7xJSS4qvDP5g: folds
n5XI5/7gN+gIubHFBH+mOw collected $2 from pot
*** SUMMARY ***
Total pot $2 | Rake $0
Seat 1: hpqdC/23wXosGOmzARr5NA folded before Flop (didn't bet)
Seat 2: H6Z4+qu8gR0VUiPOijndVg (button) folded before Flop (didn't bet)
Seat 3: 5Q8U6iZbeO7xJSS4qvDP5g (small blind) folded before Flop
Seat 4: n5XI5/7gN+gIubHFBH+mOw (big blind) collected ($2)
Seat 5: rBQDMkKm9cZn6M9NPsiVew folded before Flop (didn't bet)
Seat 6: 5iPk5MyO3KVu18Y8XCYfFQ folded before Flop (didn't bet)
Seat 9: kVCeGJ4NY7Fb0W74j1mAqA folded before Flop (didn't bet)



PokerStars Game #59938563788:  Hold'em No Limit ($1/$2) - 2009/07/01 0:18:00 ET
Table 'qVXak+oTeDXMGbWa4sDU5Q' 9-max Seat #9 is the button
Seat 1: H6Z4+qu8gR0VUiPOijndVg ($255.30 in chips)
Seat 2: Hc2itIxwbi1lwa+DAYYQGg ($46 in chips)
Seat 3: oz9eCXGC7DdjQlL/nuWj1A ($120.65 in chips)
Seat 4: b0jO1SDhLedy1//CQlA8kw ($43 in chips)
Seat 5: NqKRc5xvcye0d7F6VOF6MQ ($82.50 in chips)
Seat 6: Q3uFdu6ztesjDFiqkagTRQ ($200 in chips)
Seat 7: 5iPk5MyO3KVu18Y8XCYfFQ ($109 in chips)
Seat 8: 9pHZMviI9R8injxojGTnvw ($118.80 in chips)
Seat 9: ZP45Tu5Zqo4v+ZgqIQVoOQ ($197 in chips)
H6Z4+qu8gR0VUiPOijndVg: posts small blind $1
Hc2itIxwbi1lwa+DAYYQGg: posts big blind $2
*** HOLE CARDS ***
oz9eCXGC7DdjQlL/nuWj1A: folds
b0jO1SDhLedy1//CQlA8kw: folds
NqKRc5xvcye0d7F6VOF6MQ: folds
Q3uFdu6ztesjDFiqkagTRQ: folds
5iPk5MyO3KVu18Y8XCYfFQ: folds
9pHZMviI9R8injxojGTnvw: folds
ZP45Tu5Zqo4v+ZgqIQVoOQ: folds
H6Z4+qu8gR0VUiPOijndVg: folds
Hc2itIxwbi1lwa+DAYYQGg collected $2 from pot
*** SUMMARY ***
Total pot $2 | Rake $0
Seat 1: H6Z4+qu8gR0VUiPOijndVg (small blind) folded before Flop
Seat 2: Hc2itIxwbi1lwa+DAYYQGg (big blind) collected ($2)
Seat 3: oz9eCXGC7DdjQlL/nuWj1A folded before Flop (didn't bet)
Seat 4: b0jO1SDhLedy1//CQlA8kw folded before Flop (didn't bet)
Seat 5: NqKRc5xvcye0d7F6VOF6MQ folded before Flop (didn't bet)
Seat 6: Q3uFdu6ztesjDFiqkagTRQ folded before Flop (didn't bet)
Seat 7: 5iPk5MyO3KVu18Y8XCYfFQ folded before Flop (didn't bet)
Seat 8: 9pHZMviI9R8injxojGTnvw folded before Flop (didn't bet)
Seat 9: ZP45Tu5Zqo4v+ZgqIQVoOQ (button) folded before Flop (didn't bet)



PokerStars Game #59938563958:  Hold'em No Limit ($1/$2) - 2009/07/01 0:18:01 ET
Table 'l5lZHc5JRHEDt0Y2AVPq3g' 6-max Seat #4 is the button
Seat 1: gGPaCoSWW1HoKYaqfAPecg ($230.20 in chips)
Seat 2: /PH6Ffnho4Ysm8S3V/oa+w ($40 in chips)
Seat 3: DQlskgG4OtLpF2MVxLwf4A ($200 in chips)
Seat 4: zNjJ/y4emmF+vzrCDd+ooA ($200.65 in chips)
Seat 5: X7GlkHF+lkbarCLuZ4Uf0w ($56.85 in chips)
X7GlkHF+lkbarCLuZ4Uf0w: posts small blind $1
gGPaCoSWW1HoKYaqfAPecg: posts big blind $2
*** HOLE CARDS ***
/PH6Ffnho4Ysm8S3V/oa+w: folds
DQlskgG4OtLpF2MVxLwf4A: folds
zNjJ/y4emmF+vzrCDd+ooA: folds
X7GlkHF+lkbarCLuZ4Uf0w: folds
gGPaCoSWW1HoKYaqfAPecg collected $2 from pot
gGPaCoSWW1HoKYaqfAPecg: doesn't show hand
*** SUMMARY ***
Total pot $2 | Rake $0
Seat 1: gGPaCoSWW1HoKYaqfAPecg (big blind) collected ($2)
Seat 2: /PH6Ffnho4Ysm8S3V/oa+w folded before Flop (didn't bet)
Seat 3: DQlskgG4OtLpF2MVxLwf4A folded before Flop (didn't bet)
Seat 4: zNjJ/y4emmF+vzrCDd+ooA (button) folded before Flop (didn't bet)
Seat 5: X7GlkHF+lkbarCLuZ4Uf0w (small blind) folded before Flop



PokerStars Game #59938567292:  Hold'em No Limit ($1/$2) - 2009/07/01 0:18:05 ET
Table 'on4i1U1lCRmxsduFD3xiSg' 9-max Seat #9 is the button
Seat 1: so5k3vFDmokh2q3dImJ1GQ ($119 in chips)
Seat 2: yZYrOeNDxQxkzpbgKX1bng ($66.65 in chips)
Seat 3: 5iPk5MyO3KVu18Y8XCYfFQ ($61.20 in chips)
Seat 4: Z3aYCZG/yXHYFjiWkGI5ug ($530.10 in chips)
Seat 5: QHxJjpVYwitg9krW6wZgJA ($203 in chips)
Seat 6: CUZwDpLTQKhzarPe+JCLOQ ($214.55 in chips)
Seat 7: xD4ElYxz6Ollzmam8BmMCw ($197 in chips)
Seat 8: cdC54j9fGGojcbzWB5PgzA ($200 in chips)
Seat 9: iMe5yhc+1BaiIPHet3NMrA ($200 in chips)
so5k3vFDmokh2q3dImJ1GQ: posts small blind $1
yZYrOeNDxQxkzpbgKX1bng: posts big blind $2
*** HOLE CARDS ***
5iPk5MyO3KVu18Y8XCYfFQ: folds
Z3aYCZG/yXHYFjiWkGI5ug: folds
QHxJjpVYwitg9krW6wZgJA: folds
CUZwDpLTQKhzarPe+JCLOQ: folds
xD4ElYxz6Ollzmam8BmMCw: folds
cdC54j9fGGojcbzWB5PgzA: folds
iMe5yhc+1BaiIPHet3NMrA: calls $2
so5k3vFDmokh2q3dImJ1GQ: calls $1
yZYrOeNDxQxkzpbgKX1bng: checks
*** FLOP *** [6d Qs Td]
so5k3vFDmokh2q3dImJ1GQ: checks
yZYrOeNDxQxkzpbgKX1bng: checks
iMe5yhc+1BaiIPHet3NMrA: checks
*** TURN *** [6d Qs Td] [2c]
so5k3vFDmokh2q3dImJ1GQ: bets $2
yZYrOeNDxQxkzpbgKX1bng: calls $2
iMe5yhc+1BaiIPHet3NMrA: folds
*** RIVER *** [6d Qs Td 2c] [7d]
so5k3vFDmokh2q3dImJ1GQ: checks
yZYrOeNDxQxkzpbgKX1bng: checks
*** SHOW DOWN ***
so5k3vFDmokh2q3dImJ1GQ: shows [6c 5d] (a pair of Sixes)
yZYrOeNDxQxkzpbgKX1bng: shows [Ts Ah] (a pair of Tens)
yZYrOeNDxQxkzpbgKX1bng collected $9.55 from pot
*** SUMMARY ***
Total pot $10 | Rake $0.45
Board [6d Qs Td 2c 7d]
Seat 1: so5k3vFDmokh2q3dImJ1GQ (small blind) showed [6c 5d] and lost with a pair of Sixes
Seat 2: yZYrOeNDxQxkzpbgKX1bng (big blind) showed [Ts Ah] and won ($9.55) with a pair of Tens
Seat 3: 5iPk5MyO3KVu18Y8XCYfFQ folded before Flop (didn't bet)
Seat 4: Z3aYCZG/yXHYFjiWkGI5ug folded before Flop (didn't bet)
Seat 5: QHxJjpVYwitg9krW6wZgJA folded before Flop (didn't bet)
Seat 6: CUZwDpLTQKhzarPe+JCLOQ folded before Flop (didn't bet)
Seat 7: xD4ElYxz6Ollzmam8BmMCw folded before Flop (didn't bet)
Seat 8: cdC54j9fGGojcbzWB5PgzA folded before Flop (didn't bet)
Seat 9: iMe5yhc+1BaiIPHet3NMrA (button) folded on the Turn



PokerStars Game #59938568582:  Hold'em No Limit ($1/$2) - 2009/07/01 0:18:07 ET
Table 'bIihwBANJSFqlHPPtset+w' 9-max Seat #1 is the button
Seat 1: jI3JDUGV63ccqtKgM3vMbw ($156.70 in chips)
Seat 2: lQYT23h5QCUVZAKxjOO39Q ($119.90 in chips)
Seat 3: acnZ0LD5jxKgWIHz+mpQ8Q ($223.25 in chips)
Seat 4: 7WWX5PClBdr/U44gUKBIEA ($296.05 in chips)
Seat 6: 5iPk5MyO3KVu18Y8XCYfFQ ($83 in chips)
Seat 7: 3q2/0oJr3Mcy1W5tcN61ug ($206.35 in chips)
Seat 8: iMe5yhc+1BaiIPHet3NMrA ($278.65 in chips)
Seat 9: rW/MyplHylMSBRaoRUzWrg ($40 in chips)
lQYT23h5QCUVZAKxjOO39Q: posts small blind $1
acnZ0LD5jxKgWIHz+mpQ8Q: posts big blind $2
*** HOLE CARDS ***
7WWX5PClBdr/U44gUKBIEA: folds
rNejrG5tkeRBbL+UmC0iJA joins the table at seat #5
5iPk5MyO3KVu18Y8XCYfFQ: raises $6 to $8
3q2/0oJr3Mcy1W5tcN61ug: folds
iMe5yhc+1BaiIPHet3NMrA: folds
rW/MyplHylMSBRaoRUzWrg: folds
jI3JDUGV63ccqtKgM3vMbw: folds
lQYT23h5QCUVZAKxjOO39Q: folds
acnZ0LD5jxKgWIHz+mpQ8Q: folds
5iPk5MyO3KVu18Y8XCYfFQ collected $5 from pot
*** SUMMARY ***
Total pot $5 | Rake $0
Seat 1: jI3JDUGV63ccqtKgM3vMbw (button) folded before Flop (didn't bet)
Seat 2: lQYT23h5QCUVZAKxjOO39Q (small blind) folded before Flop
Seat 3: acnZ0LD5jxKgWIHz+mpQ8Q (big blind) folded before Flop
Seat 4: 7WWX5PClBdr/U44gUKBIEA folded before Flop (didn't bet)
Seat 6: 5iPk5MyO3KVu18Y8XCYfFQ collected ($5)
Seat 7: 3q2/0oJr3Mcy1W5tcN61ug folded before Flop (didn't bet)
Seat 8: iMe5yhc+1BaiIPHet3NMrA folded before Flop (didn't bet)
Seat 9: rW/MyplHylMSBRaoRUzWrg folded before Flop (didn't bet)



PokerStars Game #59938570380:  Hold'em No Limit ($1/$2) - 2009/07/01 0:18:10 ET
Table 'eyAQSIlgc2o1Jxvbve4WGg' 9-max Seat #8 is the button
Seat 2: g7gL2NLJCdZPPV399WKT1w ($50 in chips)
Seat 3: TAfo4veNRaRlzDXMMYS3Jg ($37 in chips)
Seat 4: miAHPEBdznuHNzK6YM3hRA ($106.20 in chips)
Seat 5: JnV3SM2D6dAFYyGZHHpvrg ($97 in chips)
Seat 6: IikcENBHwoT7snSvBPSc7Q ($178.60 in chips)
Seat 7: QHxJjpVYwitg9krW6wZgJA ($204.65 in chips)
Seat 8: 5iPk5MyO3KVu18Y8XCYfFQ ($40 in chips)
Seat 9: Hc2itIxwbi1lwa+DAYYQGg ($42.85 in chips)
Hc2itIxwbi1lwa+DAYYQGg: posts small blind $1
Q3uFdu6ztesjDFiqkagTRQ: is sitting out
g7gL2NLJCdZPPV399WKT1w: posts big blind $2
*** HOLE CARDS ***
TAfo4veNRaRlzDXMMYS3Jg: folds
miAHPEBdznuHNzK6YM3hRA: folds
JnV3SM2D6dAFYyGZHHpvrg: folds
IikcENBHwoT7snSvBPSc7Q: folds
QHxJjpVYwitg9krW6wZgJA: folds
Q3uFdu6ztesjDFiqkagTRQ leaves the table
5iPk5MyO3KVu18Y8XCYfFQ has timed out
5iPk5MyO3KVu18Y8XCYfFQ: folds
5iPk5MyO3KVu18Y8XCYfFQ is sitting out
5iPk5MyO3KVu18Y8XCYfFQ has returned
Hc2itIxwbi1lwa+DAYYQGg: folds
g7gL2NLJCdZPPV399WKT1w collected $2 from pot
g7gL2NLJCdZPPV399WKT1w: doesn't show hand
*** SUMMARY ***
Total pot $2 | Rake $0
Seat 2: g7gL2NLJCdZPPV399WKT1w (big blind) collected ($2)
Seat 3: TAfo4veNRaRlzDXMMYS3Jg folded before Flop (didn't bet)
Seat 4: miAHPEBdznuHNzK6YM3hRA folded before Flop (didn't bet)
Seat 5: JnV3SM2D6dAFYyGZHHpvrg folded before Flop (didn't bet)
Seat 6: IikcENBHwoT7snSvBPSc7Q folded before Flop (didn't bet)
Seat 7: QHxJjpVYwitg9krW6wZgJA folded before Flop (didn't bet)
Seat 8: 5iPk5MyO3KVu18Y8XCYfFQ (button) folded before Flop (didn't bet)
Seat 9: Hc2itIxwbi1lwa+DAYYQGg (small blind) folded before Flop



PokerStars Game #59938570856:  Hold'em No Limit ($1/$2) - 2009/07/01 0:18:11 ET
Table 'mGpP9StWRnoeiBDExc6Frg' 6-max Seat #4 is the button
Seat 1: zWFU82nxIRvzK4mKiL4m0Q ($75.05 in chips)
Seat 2: DQlskgG4OtLpF2MVxLwf4A ($203 in chips)
Seat 3: 3HrFUl+TAqSP1U00zz3P7A ($171.60 in chips)
Seat 4: qXDd0ZyMIse0OBu8pxeQ3Q ($215 in chips)
Seat 5: d1puGuVBE0fidn+5eRJ0tw ($168.70 in chips)
Seat 6: X7GlkHF+lkbarCLuZ4Uf0w ($26.45 in chips)
d1puGuVBE0fidn+5eRJ0tw: posts small blind $1
X7GlkHF+lkbarCLuZ4Uf0w: posts big blind $2
*** HOLE CARDS ***
zWFU82nxIRvzK4mKiL4m0Q: calls $2
DQlskgG4OtLpF2MVxLwf4A: raises $8 to $10
3HrFUl+TAqSP1U00zz3P7A: folds
qXDd0ZyMIse0OBu8pxeQ3Q: folds
d1puGuVBE0fidn+5eRJ0tw: folds
X7GlkHF+lkbarCLuZ4Uf0w: folds
zWFU82nxIRvzK4mKiL4m0Q: calls $8
*** FLOP *** [8h 8d Qc]
zWFU82nxIRvzK4mKiL4m0Q: checks
DQlskgG4OtLpF2MVxLwf4A: bets $15
zWFU82nxIRvzK4mKiL4m0Q: folds
DQlskgG4OtLpF2MVxLwf4A collected $21.85 from pot
DQlskgG4OtLpF2MVxLwf4A: doesn't show hand
*** SUMMARY ***
Total pot $23 | Rake $1.15
Board [8h 8d Qc]
Seat 1: zWFU82nxIRvzK4mKiL4m0Q folded on the Flop
Seat 2: DQlskgG4OtLpF2MVxLwf4A collected ($21.85)
Seat 3: 3HrFUl+TAqSP1U00zz3P7A folded before Flop (didn't bet)
Seat 4: qXDd0ZyMIse0OBu8pxeQ3Q (button) folded before Flop (didn't bet)
Seat 5: d1puGuVBE0fidn+5eRJ0tw (small blind) folded before Flop
Seat 6: X7GlkHF+lkbarCLuZ4Uf0w (big blind) folded before Flop



PokerStars Game #59938570946:  Hold'em No Limit ($1/$2) - 2009/07/01 0:18:11 ET
Table 'OZyw34U4j4WtFFWsEHZQgQ' 2-max Seat #2 is the button
Seat 1: pVqEzK9wXlRMECnb1Zg4Zw ($80 in chips)
Seat 2: rAtTyvrJ8f1LaUh2O5U4nA ($46 in chips)
rAtTyvrJ8f1LaUh2O5U4nA: posts small blind $1
pVqEzK9wXlRMECnb1Zg4Zw: posts big blind $2
*** HOLE CARDS ***
rAtTyvrJ8f1LaUh2O5U4nA: calls $1
pVqEzK9wXlRMECnb1Zg4Zw: checks
*** FLOP *** [3s Tc Ad]
pVqEzK9wXlRMECnb1Zg4Zw: bets $4
rAtTyvrJ8f1LaUh2O5U4nA: calls $4
*** TURN *** [3s Tc Ad] [2d]
pVqEzK9wXlRMECnb1Zg4Zw: bets $10
rAtTyvrJ8f1LaUh2O5U4nA: folds
pVqEzK9wXlRMECnb1Zg4Zw collected $11.50 from pot
pVqEzK9wXlRMECnb1Zg4Zw: doesn't show hand
*** SUMMARY ***
Total pot $12 | Rake $0.50
Board [3s Tc Ad 2d]
Seat 1: pVqEzK9wXlRMECnb1Zg4Zw (big blind) collected ($11.50)
Seat 2: rAtTyvrJ8f1LaUh2O5U4nA (button) (small blind) folded on the Turn



PokerStars Game #59938572726:  Hold'em No Limit ($1/$2) - 2009/07/01 0:18:13 ET
Table 'jlrIxbrVIG+gjaUYT4za8g' 6-max Seat #1 is the button
Seat 1: ygTTt5ehT4aF86q1a8/R+w ($193.05 in chips)
Seat 2: N18PrNGQj43J7TJuQuu+tw ($152.45 in chips)
Seat 3: 54yWzRRgS0oZ+S6LwZBxMQ ($40.80 in chips)
Seat 4: 8srN1dKQePlsv0GyTada+Q ($200 in chips)
Seat 6: vkfxu8f/jMYKUk6Ly4eujw ($279.95 in chips)
N18PrNGQj43J7TJuQuu+tw: posts small blind $1
54yWzRRgS0oZ+S6LwZBxMQ: posts big blind $2
*** HOLE CARDS ***
8srN1dKQePlsv0GyTada+Q: folds
vkfxu8f/jMYKUk6Ly4eujw: raises $4 to $6
ygTTt5ehT4aF86q1a8/R+w: folds
N18PrNGQj43J7TJuQuu+tw: folds
54yWzRRgS0oZ+S6LwZBxMQ: folds
vkfxu8f/jMYKUk6Ly4eujw collected $5 from pot
*** SUMMARY ***
Total pot $5 | Rake $0
Seat 1: ygTTt5ehT4aF86q1a8/R+w (button) folded before Flop (didn't bet)
Seat 2: N18PrNGQj43J7TJuQuu+tw (small blind) folded before Flop
Seat 3: 54yWzRRgS0oZ+S6LwZBxMQ (big blind) folded before Flop
Seat 4: 8srN1dKQePlsv0GyTada+Q folded before Flop (didn't bet)
Seat 6: vkfxu8f/jMYKUk6Ly4eujw collected ($5)



PokerStars Game #59938575088:  Hold'em No Limit ($1/$2) - 2009/07/01 0:18:17 ET
Table 'NmY84NAf9Mh0ckAckHnh5g' 2-max Seat #2 is the button
Seat 1: 6hvg964TSqZ3AL/0XK9aVQ ($621.15 in chips)
Seat 2: RwDoM55ZeQuI2ADyJhOb2Q ($161.75 in chips)
RwDoM55ZeQuI2ADyJhOb2Q: posts small blind $1
6hvg964TSqZ3AL/0XK9aVQ: posts big blind $2
*** HOLE CARDS ***
RwDoM55ZeQuI2ADyJhOb2Q: raises $4 to $6
6hvg964TSqZ3AL/0XK9aVQ: calls $4
*** FLOP *** [Ad 4d 6s]
6hvg964TSqZ3AL/0XK9aVQ: checks
RwDoM55ZeQuI2ADyJhOb2Q: bets $8
6hvg964TSqZ3AL/0XK9aVQ: calls $8
*** TURN *** [Ad 4d 6s] [9c]
6hvg964TSqZ3AL/0XK9aVQ: checks
RwDoM55ZeQuI2ADyJhOb2Q: checks
*** RIVER *** [Ad 4d 6s 9c] [7h]
6hvg964TSqZ3AL/0XK9aVQ: bets $18
RwDoM55ZeQuI2ADyJhOb2Q: folds
6hvg964TSqZ3AL/0XK9aVQ collected $27.50 from pot
6hvg964TSqZ3AL/0XK9aVQ: doesn't show hand
*** SUMMARY ***
Total pot $28 | Rake $0.50
Board [Ad 4d 6s 9c 7h]
Seat 1: 6hvg964TSqZ3AL/0XK9aVQ (big blind) collected ($27.50)
Seat 2: RwDoM55ZeQuI2ADyJhOb2Q (button) (small blind) folded on the River



PokerStars Game #59938575078:  Hold'em No Limit ($1/$2) - 2009/07/01 0:18:17 ET
Table '3FGoiEOffWrbgTfsB3t7FA' 2-max Seat #2 is the button
Seat 1: e0oDWyrmgLpR6bROEqw1nQ ($332 in chips)
Seat 2: +sy/nlNI20yZraIjs4AALg ($266.15 in chips)
+sy/nlNI20yZraIjs4AALg: posts small blind $1
e0oDWyrmgLpR6bROEqw1nQ: posts big blind $2
*** HOLE CARDS ***
+sy/nlNI20yZraIjs4AALg: raises $2 to $4
e0oDWyrmgLpR6bROEqw1nQ: calls $2
*** FLOP *** [Td 3s 4h]
e0oDWyrmgLpR6bROEqw1nQ: bets $4
+sy/nlNI20yZraIjs4AALg: calls $4
*** TURN *** [Td 3s 4h] [Jd]
e0oDWyrmgLpR6bROEqw1nQ: checks
+sy/nlNI20yZraIjs4AALg: checks
*** RIVER *** [Td 3s 4h Jd] [As]
e0oDWyrmgLpR6bROEqw1nQ: checks
+sy/nlNI20yZraIjs4AALg: bets $16
e0oDWyrmgLpR6bROEqw1nQ: folds
+sy/nlNI20yZraIjs4AALg collected $15.50 from pot
*** SUMMARY ***
Total pot $16 | Rake $0.50
Board [Td 3s 4h Jd As]
Seat 1: e0oDWyrmgLpR6bROEqw1nQ (big blind) folded on the River
Seat 2: +sy/nlNI20yZraIjs4AALg (button) (small blind) collected ($15.50)



PokerStars Game #59938577438:  Hold'em No Limit ($1/$2) - 2009/07/01 0:18:20 ET
Table 'l5lZHc5JRHEDt0Y2AVPq3g' 6-max Seat #5 is the button
Seat 1: gGPaCoSWW1HoKYaqfAPecg ($231.20 in chips)
Seat 2: /PH6Ffnho4Ysm8S3V/oa+w ($40 in chips)
Seat 3: DQlskgG4OtLpF2MVxLwf4A ($200 in chips)
Seat 4: zNjJ/y4emmF+vzrCDd+ooA ($200.65 in chips)
Seat 5: X7GlkHF+lkbarCLuZ4Uf0w ($55.85 in chips)
gGPaCoSWW1HoKYaqfAPecg: posts small blind $1
/PH6Ffnho4Ysm8S3V/oa+w: posts big blind $2
*** HOLE CARDS ***
DQlskgG4OtLpF2MVxLwf4A: folds
DQlskgG4OtLpF2MVxLwf4A is sitting out
zNjJ/y4emmF+vzrCDd+ooA: folds
DQlskgG4OtLpF2MVxLwf4A leaves the table
X7GlkHF+lkbarCLuZ4Uf0w: folds
gGPaCoSWW1HoKYaqfAPecg: raises $5 to $7
/PH6Ffnho4Ysm8S3V/oa+w: folds
gGPaCoSWW1HoKYaqfAPecg collected $4 from pot
gGPaCoSWW1HoKYaqfAPecg: doesn't show hand
*** SUMMARY ***
Total pot $4 | Rake $0
Seat 1: gGPaCoSWW1HoKYaqfAPecg (small blind) collected ($4)
Seat 2: /PH6Ffnho4Ysm8S3V/oa+w (big blind) folded before Flop
Seat 3: DQlskgG4OtLpF2MVxLwf4A folded before Flop (didn't bet)
Seat 4: zNjJ/y4emmF+vzrCDd+ooA folded before Flop (didn't bet)
Seat 5: X7GlkHF+lkbarCLuZ4Uf0w (button) folded before Flop (didn't bet)



PokerStars Game #59938578690:  Hold'em No Limit ($1/$2) - 2009/07/01 0:18:22 ET
Table 'aSf77Sj8QEnzcc0WaxVD4Q' 6-max Seat #5 is the button
Seat 2: vkfxu8f/jMYKUk6Ly4eujw ($259.15 in chips)
Seat 3: 9dpyyjDTCed6nV7JhaUUpw ($200 in chips)
Seat 4: 513FcCI8jHyQy2VWoIQkMg ($200 in chips)
Seat 5: InmkdI6G8TzSj9NhcCSyPg ($247 in chips)
Seat 6: vkoJRf3gidxY1pPi0AFWww ($298.60 in chips)
vkoJRf3gidxY1pPi0AFWww: posts small blind $1
Q3uFdu6ztesjDFiqkagTRQ: is sitting out
vkfxu8f/jMYKUk6Ly4eujw: posts big blind $2
*** HOLE CARDS ***
9dpyyjDTCed6nV7JhaUUpw: folds
513FcCI8jHyQy2VWoIQkMg: folds
Q3uFdu6ztesjDFiqkagTRQ leaves the table
InmkdI6G8TzSj9NhcCSyPg: folds
vkoJRf3gidxY1pPi0AFWww: calls $1
vkfxu8f/jMYKUk6Ly4eujw: checks
*** FLOP *** [2c 6d Kh]
vkoJRf3gidxY1pPi0AFWww: checks
vkfxu8f/jMYKUk6Ly4eujw: checks
*** TURN *** [2c 6d Kh] [Ac]
vkoJRf3gidxY1pPi0AFWww: bets $4
54yWzRRgS0oZ+S6LwZBxMQ joins the table at seat #1
vkfxu8f/jMYKUk6Ly4eujw: folds
vkoJRf3gidxY1pPi0AFWww collected $3.80 from pot
vkoJRf3gidxY1pPi0AFWww: doesn't show hand
*** SUMMARY ***
Total pot $4 | Rake $0.20
Board [2c 6d Kh Ac]
Seat 2: vkfxu8f/jMYKUk6Ly4eujw (big blind) folded on the Turn
Seat 3: 9dpyyjDTCed6nV7JhaUUpw folded before Flop (didn't bet)
Seat 4: 513FcCI8jHyQy2VWoIQkMg folded before Flop (didn't bet)
Seat 5: InmkdI6G8TzSj9NhcCSyPg (button) folded before Flop (didn't bet)
Seat 6: vkoJRf3gidxY1pPi0AFWww (small blind) collected ($3.80)



PokerStars Game #59938579022:  Hold'em No Limit ($1/$2) - 2009/07/01 0:18:23 ET
Table 'gnHBqWll9O3fxG7Ojkz/ng' 9-max Seat #3 is the button
Seat 1: hpqdC/23wXosGOmzARr5NA ($149.05 in chips)
Seat 2: H6Z4+qu8gR0VUiPOijndVg ($200 in chips)
Seat 3: 5Q8U6iZbeO7xJSS4qvDP5g ($225.35 in chips)
Seat 4: n5XI5/7gN+gIubHFBH+mOw ($402.15 in chips)
Seat 5: rBQDMkKm9cZn6M9NPsiVew ($167 in chips)
Seat 6: 5iPk5MyO3KVu18Y8XCYfFQ ($58.45 in chips)
Seat 8: cM6efHzdxoqYm0EQKP4TTQ ($60 in chips)
Seat 9: kVCeGJ4NY7Fb0W74j1mAqA ($200 in chips)
n5XI5/7gN+gIubHFBH+mOw: posts small blind $1
rBQDMkKm9cZn6M9NPsiVew: posts big blind $2
cM6efHzdxoqYm0EQKP4TTQ: posts big blind $2
*** HOLE CARDS ***
5iPk5MyO3KVu18Y8XCYfFQ has timed out
5iPk5MyO3KVu18Y8XCYfFQ: folds
5iPk5MyO3KVu18Y8XCYfFQ is sitting out
cM6efHzdxoqYm0EQKP4TTQ: checks
kVCeGJ4NY7Fb0W74j1mAqA: folds
hpqdC/23wXosGOmzARr5NA: calls $2
5iPk5MyO3KVu18Y8XCYfFQ has returned
H6Z4+qu8gR0VUiPOijndVg: folds
5Q8U6iZbeO7xJSS4qvDP5g: folds
n5XI5/7gN+gIubHFBH+mOw: calls $1
rBQDMkKm9cZn6M9NPsiVew: checks
*** FLOP *** [6s 5c 4c]
n5XI5/7gN+gIubHFBH+mOw: checks
rBQDMkKm9cZn6M9NPsiVew: checks
cM6efHzdxoqYm0EQKP4TTQ: checks
hpqdC/23wXosGOmzARr5NA: checks
*** TURN *** [6s 5c 4c] [Kc]
jqui3xAWCkcdPW36a6BD+w has returned
n5XI5/7gN+gIubHFBH+mOw: checks
rBQDMkKm9cZn6M9NPsiVew: checks
cM6efHzdxoqYm0EQKP4TTQ: bets $10
hpqdC/23wXosGOmzARr5NA: folds
n5XI5/7gN+gIubHFBH+mOw: folds
rBQDMkKm9cZn6M9NPsiVew: raises $10 to $20
cM6efHzdxoqYm0EQKP4TTQ: calls $10
*** RIVER *** [6s 5c 4c Kc] [8h]
rBQDMkKm9cZn6M9NPsiVew: checks
cM6efHzdxoqYm0EQKP4TTQ: checks
*** SHOW DOWN ***
rBQDMkKm9cZn6M9NPsiVew: shows [Qh Ad] (high card Ace)
cM6efHzdxoqYm0EQKP4TTQ: shows [2h Ks] (a pair of Kings)
cM6efHzdxoqYm0EQKP4TTQ collected $45.65 from pot
*** SUMMARY ***
Total pot $48 | Rake $2.35
Board [6s 5c 4c Kc 8h]
Seat 1: hpqdC/23wXosGOmzARr5NA folded on the Turn
Seat 2: H6Z4+qu8gR0VUiPOijndVg folded before Flop (didn't bet)
Seat 3: 5Q8U6iZbeO7xJSS4qvDP5g (button) folded before Flop (didn't bet)
Seat 4: n5XI5/7gN+gIubHFBH+mOw (small blind) folded on the Turn
Seat 5: rBQDMkKm9cZn6M9NPsiVew (big blind) showed [Qh Ad] and lost with high card Ace
Seat 6: 5iPk5MyO3KVu18Y8XCYfFQ folded before Flop (didn't bet)
Seat 8: cM6efHzdxoqYm0EQKP4TTQ showed [2h Ks] and won ($45.65) with a pair of Kings
Seat 9: kVCeGJ4NY7Fb0W74j1mAqA folded before Flop (didn't bet)



PokerStars Game #59938582064:  Hold'em No Limit ($1/$2) - 2009/07/01 0:18:27 ET
Table 'srul5UFZXTEccVV5fpY91g' 9-max Seat #5 is the button
Seat 1: lfD8cBv31A/pio3pXJbPjA ($159.20 in chips)
Seat 2: tJYod1SLp2AcWPL/3hZ7ug ($87.20 in chips)
Seat 3: weUZ8S7tgbaeIpzi1gBNxQ ($48.75 in chips)
Seat 4: GG5lTuGt3+kwNYSbqeB6yw ($104.40 in chips)
Seat 5: 5iPk5MyO3KVu18Y8XCYfFQ ($57.65 in chips)
Seat 6: TAfo4veNRaRlzDXMMYS3Jg ($34 in chips)
Seat 7: s0erZsDxbZSaEPheMgibKg ($454.40 in chips)
TAfo4veNRaRlzDXMMYS3Jg: posts small blind $1
s0erZsDxbZSaEPheMgibKg: posts big blind $2
*** HOLE CARDS ***
lfD8cBv31A/pio3pXJbPjA: folds
tJYod1SLp2AcWPL/3hZ7ug: raises $4 to $6
weUZ8S7tgbaeIpzi1gBNxQ: folds
GG5lTuGt3+kwNYSbqeB6yw: folds
5iPk5MyO3KVu18Y8XCYfFQ: folds
TAfo4veNRaRlzDXMMYS3Jg: folds
s0erZsDxbZSaEPheMgibKg: folds
tJYod1SLp2AcWPL/3hZ7ug collected $5 from pot
*** SUMMARY ***
Total pot $5 | Rake $0
Seat 1: lfD8cBv31A/pio3pXJbPjA folded before Flop (didn't bet)
Seat 2: tJYod1SLp2AcWPL/3hZ7ug collected ($5)
Seat 3: weUZ8S7tgbaeIpzi1gBNxQ folded before Flop (didn't bet)
Seat 4: GG5lTuGt3+kwNYSbqeB6yw folded before Flop (didn't bet)
Seat 5: 5iPk5MyO3KVu18Y8XCYfFQ (button) folded before Flop (didn't bet)
Seat 6: TAfo4veNRaRlzDXMMYS3Jg (small blind) folded before Flop
Seat 7: s0erZsDxbZSaEPheMgibKg (big blind) folded before Flop



PokerStars Game #59938583162:  Hold'em No Limit ($1/$2) - 2009/07/01 0:18:29 ET
Table 'OZyw34U4j4WtFFWsEHZQgQ' 2-max Seat #1 is the button
Seat 1: pVqEzK9wXlRMECnb1Zg4Zw ($85.50 in chips)
Seat 2: rAtTyvrJ8f1LaUh2O5U4nA ($40 in chips)
pVqEzK9wXlRMECnb1Zg4Zw: posts small blind $1
rAtTyvrJ8f1LaUh2O5U4nA: posts big blind $2
*** HOLE CARDS ***
pVqEzK9wXlRMECnb1Zg4Zw: calls $1
rAtTyvrJ8f1LaUh2O5U4nA: raises $4 to $6
pVqEzK9wXlRMECnb1Zg4Zw: folds
rAtTyvrJ8f1LaUh2O5U4nA collected $4 from pot
rAtTyvrJ8f1LaUh2O5U4nA: doesn't show hand
*** SUMMARY ***
Total pot $4 | Rake $0
Seat 1: pVqEzK9wXlRMECnb1Zg4Zw (button) (small blind) folded before Flop
Seat 2: rAtTyvrJ8f1LaUh2O5U4nA (big blind) collected ($4)



PokerStars Game #59938589154:  Hold'em No Limit ($1/$2) - 2009/07/01 0:18:38 ET
Table 'l5lZHc5JRHEDt0Y2AVPq3g' 6-max Seat #1 is the button
Seat 1: gGPaCoSWW1HoKYaqfAPecg ($233.20 in chips)
Seat 2: /PH6Ffnho4Ysm8S3V/oa+w ($40 in chips)
Seat 4: zNjJ/y4emmF+vzrCDd+ooA ($200.65 in chips)
Seat 5: X7GlkHF+lkbarCLuZ4Uf0w ($55.85 in chips)
/PH6Ffnho4Ysm8S3V/oa+w: posts small blind $1
zNjJ/y4emmF+vzrCDd+ooA: posts big blind $2
*** HOLE CARDS ***
X7GlkHF+lkbarCLuZ4Uf0w: folds
gGPaCoSWW1HoKYaqfAPecg: folds
/PH6Ffnho4Ysm8S3V/oa+w: raises $38 to $40 and is all-in
zNjJ/y4emmF+vzrCDd+ooA: folds
/PH6Ffnho4Ysm8S3V/oa+w collected $4 from pot
/PH6Ffnho4Ysm8S3V/oa+w: doesn't show hand
*** SUMMARY ***
Total pot $4 | Rake $0
Seat 1: gGPaCoSWW1HoKYaqfAPecg (button) folded before Flop (didn't bet)
Seat 2: /PH6Ffnho4Ysm8S3V/oa+w (small blind) collected ($4)
Seat 4: zNjJ/y4emmF+vzrCDd+ooA (big blind) folded before Flop
Seat 5: X7GlkHF+lkbarCLuZ4Uf0w folded before Flop (didn't bet)



PokerStars Game #59938590002:  Hold'em No Limit ($1/$2) - 2009/07/01 0:18:39 ET
Table 'OZyw34U4j4WtFFWsEHZQgQ' 2-max Seat #2 is the button
Seat 1: pVqEzK9wXlRMECnb1Zg4Zw ($83.50 in chips)
Seat 2: rAtTyvrJ8f1LaUh2O5U4nA ($42 in chips)
rAtTyvrJ8f1LaUh2O5U4nA: posts small blind $1
pVqEzK9wXlRMECnb1Zg4Zw: posts big blind $2
*** HOLE CARDS ***
rAtTyvrJ8f1LaUh2O5U4nA: calls $1
pVqEzK9wXlRMECnb1Zg4Zw: raises $8 to $10
rAtTyvrJ8f1LaUh2O5U4nA: folds
pVqEzK9wXlRMECnb1Zg4Zw collected $4 from pot
pVqEzK9wXlRMECnb1Zg4Zw: doesn't show hand
*** SUMMARY ***
Total pot $4 | Rake $0
Seat 1: pVqEzK9wXlRMECnb1Zg4Zw (big blind) collected ($4)
Seat 2: rAtTyvrJ8f1LaUh2O5U4nA (button) (small blind) folded before Flop



PokerStars Game #59938591062:  Hold'em No Limit ($1/$2) - 2009/07/01 0:18:41 ET
Table 'LL4bDFyhj5hsMpzaDugJZg' 6-max Seat #6 is the button
Seat 1: IBW9lyGsaRmfcbyA/qFfEw ($62.20 in chips)
Seat 3: gGPaCoSWW1HoKYaqfAPecg ($200 in chips)
Seat 4: 8srN1dKQePlsv0GyTada+Q ($248.75 in chips)
Seat 5: HgX0VeqE/dzSXd5BpntRBw ($244.40 in chips)
Seat 6: /PH6Ffnho4Ysm8S3V/oa+w ($40 in chips)
IBW9lyGsaRmfcbyA/qFfEw: posts small blind $1
L3l+A4pJhOAD6HVVFXvVBw: is sitting out
gGPaCoSWW1HoKYaqfAPecg: posts big blind $2
*** HOLE CARDS ***
L3l+A4pJhOAD6HVVFXvVBw leaves the table
8srN1dKQePlsv0GyTada+Q: folds
HgX0VeqE/dzSXd5BpntRBw: folds
/PH6Ffnho4Ysm8S3V/oa+w: folds
IBW9lyGsaRmfcbyA/qFfEw: folds
gGPaCoSWW1HoKYaqfAPecg collected $2 from pot
*** SUMMARY ***
Total pot $2 | Rake $0
Seat 1: IBW9lyGsaRmfcbyA/qFfEw (small blind) folded before Flop
Seat 3: gGPaCoSWW1HoKYaqfAPecg (big blind) collected ($2)
Seat 4: 8srN1dKQePlsv0GyTada+Q folded before Flop (didn't bet)
Seat 5: HgX0VeqE/dzSXd5BpntRBw folded before Flop (didn't bet)
Seat 6: /PH6Ffnho4Ysm8S3V/oa+w (button) folded before Flop (didn't bet)



PokerStars Game #59938591818:  Hold'em No Limit ($1/$2) - 2009/07/01 0:18:42 ET
Table 'qVXak+oTeDXMGbWa4sDU5Q' 9-max Seat #1 is the button
Seat 1: H6Z4+qu8gR0VUiPOijndVg ($254.30 in chips)
Seat 2: Hc2itIxwbi1lwa+DAYYQGg ($47 in chips)
Seat 3: oz9eCXGC7DdjQlL/nuWj1A ($120.65 in chips)
Seat 4: b0jO1SDhLedy1//CQlA8kw ($43 in chips)
Seat 5: NqKRc5xvcye0d7F6VOF6MQ ($82.50 in chips)
Seat 6: Q3uFdu6ztesjDFiqkagTRQ ($200 in chips)
Seat 7: 5iPk5MyO3KVu18Y8XCYfFQ ($109 in chips)
Seat 8: 9pHZMviI9R8injxojGTnvw ($118.80 in chips)
Seat 9: ZP45Tu5Zqo4v+ZgqIQVoOQ ($197 in chips)
Hc2itIxwbi1lwa+DAYYQGg: posts small blind $1
oz9eCXGC7DdjQlL/nuWj1A: posts big blind $2
*** HOLE CARDS ***
b0jO1SDhLedy1//CQlA8kw: folds
NqKRc5xvcye0d7F6VOF6MQ: folds
Q3uFdu6ztesjDFiqkagTRQ: folds
5iPk5MyO3KVu18Y8XCYfFQ: folds
9pHZMviI9R8injxojGTnvw: folds
ZP45Tu5Zqo4v+ZgqIQVoOQ: folds
H6Z4+qu8gR0VUiPOijndVg: raises $2 to $4
Hc2itIxwbi1lwa+DAYYQGg: folds
oz9eCXGC7DdjQlL/nuWj1A: folds
H6Z4+qu8gR0VUiPOijndVg collected $5 from pot
H6Z4+qu8gR0VUiPOijndVg: doesn't show hand
*** SUMMARY ***
Total pot $5 | Rake $0
Seat 1: H6Z4+qu8gR0VUiPOijndVg (button) collected ($5)
Seat 2: Hc2itIxwbi1lwa+DAYYQGg (small blind) folded before Flop
Seat 3: oz9eCXGC7DdjQlL/nuWj1A (big blind) folded before Flop
Seat 4: b0jO1SDhLedy1//CQlA8kw folded before Flop (didn't bet)
Seat 5: NqKRc5xvcye0d7F6VOF6MQ folded before Flop (didn't bet)
Seat 6: Q3uFdu6ztesjDFiqkagTRQ folded before Flop (didn't bet)
Seat 7: 5iPk5MyO3KVu18Y8XCYfFQ folded before Flop (didn't bet)
Seat 8: 9pHZMviI9R8injxojGTnvw folded before Flop (didn't bet)
Seat 9: ZP45Tu5Zqo4v+ZgqIQVoOQ folded before Flop (didn't bet)



PokerStars Game #59938595224:  Hold'em No Limit ($1/$2) - 2009/07/01 0:18:47 ET
Table 'eyAQSIlgc2o1Jxvbve4WGg' 9-max Seat #9 is the button
Seat 2: g7gL2NLJCdZPPV399WKT1w ($51 in chips)
Seat 3: TAfo4veNRaRlzDXMMYS3Jg ($37 in chips)
Seat 4: miAHPEBdznuHNzK6YM3hRA ($106.20 in chips)
Seat 5: JnV3SM2D6dAFYyGZHHpvrg ($97 in chips)
Seat 6: IikcENBHwoT7snSvBPSc7Q ($178.60 in chips)
Seat 7: QHxJjpVYwitg9krW6wZgJA ($204.65 in chips)
Seat 8: 5iPk5MyO3KVu18Y8XCYfFQ ($40 in chips)
Seat 9: Hc2itIxwbi1lwa+DAYYQGg ($41.85 in chips)
g7gL2NLJCdZPPV399WKT1w: posts small blind $1
TAfo4veNRaRlzDXMMYS3Jg: posts big blind $2
*** HOLE CARDS ***
miAHPEBdznuHNzK6YM3hRA: folds
JnV3SM2D6dAFYyGZHHpvrg: folds
IikcENBHwoT7snSvBPSc7Q: folds
QHxJjpVYwitg9krW6wZgJA: folds
UZEsV9yKUMqmpYPiOFpaZw joins the table at seat #1
5iPk5MyO3KVu18Y8XCYfFQ: folds
Hc2itIxwbi1lwa+DAYYQGg: folds
g7gL2NLJCdZPPV399WKT1w: folds
TAfo4veNRaRlzDXMMYS3Jg collected $2 from pot
TAfo4veNRaRlzDXMMYS3Jg: doesn't show hand
*** SUMMARY ***
Total pot $2 | Rake $0
Seat 2: g7gL2NLJCdZPPV399WKT1w (small blind) folded before Flop
Seat 3: TAfo4veNRaRlzDXMMYS3Jg (big blind) collected ($2)
Seat 4: miAHPEBdznuHNzK6YM3hRA folded before Flop (didn't bet)
Seat 5: JnV3SM2D6dAFYyGZHHpvrg folded before Flop (didn't bet)
Seat 6: IikcENBHwoT7snSvBPSc7Q folded before Flop (didn't bet)
Seat 7: QHxJjpVYwitg9krW6wZgJA folded before Flop (didn't bet)
Seat 8: 5iPk5MyO3KVu18Y8XCYfFQ folded before Flop (didn't bet)
Seat 9: Hc2itIxwbi1lwa+DAYYQGg (button) folded before Flop (didn't bet)



PokerStars Game #59938596176:  Hold'em No Limit ($1/$2) - 2009/07/01 0:18:48 ET
Table 'XP2sRSup+aRuwzx3vDZsDg' 6-max Seat #1 is the button
Seat 1: o9jamqIi6sTTRSqudgboRA ($225.70 in chips)
Seat 3: X7GlkHF+lkbarCLuZ4Uf0w ($37 in chips)
Seat 4: JsC+WvfzqlxVs9G8/gSQAQ ($232.30 in chips)
Seat 5: 894kvCY4GHivBpqwizsecg ($115 in chips)
Seat 6: h7ppRQJTYBsHCbLMeW9T2g ($456.75 in chips)
X7GlkHF+lkbarCLuZ4Uf0w: posts small blind $1
JsC+WvfzqlxVs9G8/gSQAQ: posts big blind $2
*** HOLE CARDS ***
Ep0hd57w9DDqfTwA66dJVw leaves the table
894kvCY4GHivBpqwizsecg: calls $2
h7ppRQJTYBsHCbLMeW9T2g: folds
o9jamqIi6sTTRSqudgboRA: folds
X7GlkHF+lkbarCLuZ4Uf0w: folds
JsC+WvfzqlxVs9G8/gSQAQ: checks
*** FLOP *** [5c Th 5d]
JsC+WvfzqlxVs9G8/gSQAQ: checks
894kvCY4GHivBpqwizsecg: bets $2
JsC+WvfzqlxVs9G8/gSQAQ: folds
894kvCY4GHivBpqwizsecg collected $4.75 from pot
*** SUMMARY ***
Total pot $5 | Rake $0.25
Board [5c Th 5d]
Seat 1: o9jamqIi6sTTRSqudgboRA (button) folded before Flop (didn't bet)
Seat 3: X7GlkHF+lkbarCLuZ4Uf0w (small blind) folded before Flop
Seat 4: JsC+WvfzqlxVs9G8/gSQAQ (big blind) folded on the Flop
Seat 5: 894kvCY4GHivBpqwizsecg collected ($4.75)
Seat 6: h7ppRQJTYBsHCbLMeW9T2g folded before Flop (didn't bet)



PokerStars Game #59938596196:  Hold'em No Limit ($1/$2) - 2009/07/01 0:18:48 ET
Table 'NmY84NAf9Mh0ckAckHnh5g' 2-max Seat #1 is the button
Seat 1: 6hvg964TSqZ3AL/0XK9aVQ ($634.65 in chips)
Seat 2: RwDoM55ZeQuI2ADyJhOb2Q ($187 in chips)
6hvg964TSqZ3AL/0XK9aVQ: posts small blind $1
RwDoM55ZeQuI2ADyJhOb2Q: posts big blind $2
*** HOLE CARDS ***
6hvg964TSqZ3AL/0XK9aVQ: folds
RwDoM55ZeQuI2ADyJhOb2Q collected $2 from pot
RwDoM55ZeQuI2ADyJhOb2Q: doesn't show hand
*** SUMMARY ***
Total pot $2 | Rake $0
Seat 1: 6hvg964TSqZ3AL/0XK9aVQ (button) (small blind) folded before Flop
Seat 2: RwDoM55ZeQuI2ADyJhOb2Q (big blind) collected ($2)



PokerStars Game #59938597252:  Hold'em No Limit ($1/$2) - 2009/07/01 0:18:49 ET
Table 'OZyw34U4j4WtFFWsEHZQgQ' 2-max Seat #1 is the button
Seat 1: pVqEzK9wXlRMECnb1Zg4Zw ($85.50 in chips)
Seat 2: rAtTyvrJ8f1LaUh2O5U4nA ($40 in chips)
pVqEzK9wXlRMECnb1Zg4Zw: posts small blind $1
rAtTyvrJ8f1LaUh2O5U4nA: posts big blind $2
*** HOLE CARDS ***
pVqEzK9wXlRMECnb1Zg4Zw: raises $6 to $8
rAtTyvrJ8f1LaUh2O5U4nA: folds
pVqEzK9wXlRMECnb1Zg4Zw collected $4 from pot
pVqEzK9wXlRMECnb1Zg4Zw: doesn't show hand
*** SUMMARY ***
Total pot $4 | Rake $0
Seat 1: pVqEzK9wXlRMECnb1Zg4Zw (button) (small blind) collected ($4)
Seat 2: rAtTyvrJ8f1LaUh2O5U4nA (big blind) folded before Flop



PokerStars Game #59938597980:  Hold'em No Limit ($1/$2) - 2009/07/01 0:18:50 ET
Table 'jlrIxbrVIG+gjaUYT4za8g' 6-max Seat #2 is the button
Seat 1: ygTTt5ehT4aF86q1a8/R+w ($193.05 in chips)
Seat 2: N18PrNGQj43J7TJuQuu+tw ($151.45 in chips)
Seat 3: 54yWzRRgS0oZ+S6LwZBxMQ ($38.80 in chips)
Seat 4: 8srN1dKQePlsv0GyTada+Q ($200 in chips)
Seat 6: vkfxu8f/jMYKUk6Ly4eujw ($282.95 in chips)
54yWzRRgS0oZ+S6LwZBxMQ: posts small blind $1
8srN1dKQePlsv0GyTada+Q: posts big blind $2
*** HOLE CARDS ***
vkfxu8f/jMYKUk6Ly4eujw: folds
ygTTt5ehT4aF86q1a8/R+w: folds
N18PrNGQj43J7TJuQuu+tw: raises $2 to $4
54yWzRRgS0oZ+S6LwZBxMQ: folds
8srN1dKQePlsv0GyTada+Q: calls $2
*** FLOP *** [3h 8c Qs]
8srN1dKQePlsv0GyTada+Q: bets $6
N18PrNGQj43J7TJuQuu+tw: calls $6
*** TURN *** [3h 8c Qs] [6c]
8srN1dKQePlsv0GyTada+Q: bets $14
N18PrNGQj43J7TJuQuu+tw: calls $14
*** RIVER *** [3h 8c Qs 6c] [Jd]
8srN1dKQePlsv0GyTada+Q: bets $21
VuZb/hkEc4X7s93w2ZZTpA has returned
N18PrNGQj43J7TJuQuu+tw: folds
8srN1dKQePlsv0GyTada+Q collected $47 from pot
*** SUMMARY ***
Total pot $49 | Rake $2
Board [3h 8c Qs 6c Jd]
Seat 1: ygTTt5ehT4aF86q1a8/R+w folded before Flop (didn't bet)
Seat 2: N18PrNGQj43J7TJuQuu+tw (button) folded on the River
Seat 3: 54yWzRRgS0oZ+S6LwZBxMQ (small blind) folded before Flop
Seat 4: 8srN1dKQePlsv0GyTada+Q (big blind) collected ($47)
Seat 6: vkfxu8f/jMYKUk6Ly4eujw folded before Flop (didn't bet)



PokerStars Game #59938599274:  Hold'em No Limit ($1/$2) - 2009/07/01 0:18:52 ET
Table 'bIihwBANJSFqlHPPtset+w' 9-max Seat #2 is the button
Seat 1: jI3JDUGV63ccqtKgM3vMbw ($156.70 in chips)
Seat 2: lQYT23h5QCUVZAKxjOO39Q ($118.90 in chips)
Seat 3: acnZ0LD5jxKgWIHz+mpQ8Q ($221.25 in chips)
Seat 4: 7WWX5PClBdr/U44gUKBIEA ($296.05 in chips)
Seat 6: 5iPk5MyO3KVu18Y8XCYfFQ ($86 in chips)
Seat 7: 3q2/0oJr3Mcy1W5tcN61ug ($206.35 in chips)
Seat 8: iMe5yhc+1BaiIPHet3NMrA ($278.65 in chips)
Seat 9: rW/MyplHylMSBRaoRUzWrg ($40 in chips)
acnZ0LD5jxKgWIHz+mpQ8Q: posts small blind $1
7WWX5PClBdr/U44gUKBIEA: posts big blind $2
rNejrG5tkeRBbL+UmC0iJA: sits out
*** HOLE CARDS ***
5iPk5MyO3KVu18Y8XCYfFQ: folds
3q2/0oJr3Mcy1W5tcN61ug: folds
iMe5yhc+1BaiIPHet3NMrA: folds
rW/MyplHylMSBRaoRUzWrg: folds
jI3JDUGV63ccqtKgM3vMbw: raises $6 to $8
lQYT23h5QCUVZAKxjOO39Q: folds
acnZ0LD5jxKgWIHz+mpQ8Q: folds
7WWX5PClBdr/U44gUKBIEA: folds
jI3JDUGV63ccqtKgM3vMbw collected $5 from pot
*** SUMMARY ***
Total pot $5 | Rake $0
Seat 1: jI3JDUGV63ccqtKgM3vMbw collected ($5)
Seat 2: lQYT23h5QCUVZAKxjOO39Q (button) folded before Flop (didn't bet)
Seat 3: acnZ0LD5jxKgWIHz+mpQ8Q (small blind) folded before Flop
Seat 4: 7WWX5PClBdr/U44gUKBIEA (big blind) folded before Flop
Seat 6: 5iPk5MyO3KVu18Y8XCYfFQ folded before Flop (didn't bet)
Seat 7: 3q2/0oJr3Mcy1W5tcN61ug folded before Flop (didn't bet)
Seat 8: iMe5yhc+1BaiIPHet3NMrA folded before Flop (didn't bet)
Seat 9: rW/MyplHylMSBRaoRUzWrg folded before Flop (didn't bet)



PokerStars Game #59938600680:  Hold'em No Limit ($1/$2) - 2009/07/01 0:18:54 ET
Table 'NmY84NAf9Mh0ckAckHnh5g' 2-max Seat #2 is the button
Seat 1: 6hvg964TSqZ3AL/0XK9aVQ ($633.65 in chips)
Seat 2: RwDoM55ZeQuI2ADyJhOb2Q ($188 in chips)
RwDoM55ZeQuI2ADyJhOb2Q: posts small blind $1
6hvg964TSqZ3AL/0XK9aVQ: posts big blind $2
*** HOLE CARDS ***
RwDoM55ZeQuI2ADyJhOb2Q: raises $4 to $6
6hvg964TSqZ3AL/0XK9aVQ: folds
RwDoM55ZeQuI2ADyJhOb2Q collected $4 from pot
RwDoM55ZeQuI2ADyJhOb2Q: doesn't show hand
*** SUMMARY ***
Total pot $4 | Rake $0
Seat 1: 6hvg964TSqZ3AL/0XK9aVQ (big blind) folded before Flop
Seat 2: RwDoM55ZeQuI2ADyJhOb2Q (button) (small blind) collected ($4)



PokerStars Game #59938602352:  Hold'em No Limit ($1/$2) - 2009/07/01 0:18:56 ET
Table 'OZyw34U4j4WtFFWsEHZQgQ' 2-max Seat #2 is the button
Seat 1: pVqEzK9wXlRMECnb1Zg4Zw ($87.50 in chips)
Seat 2: rAtTyvrJ8f1LaUh2O5U4nA ($38 in chips)
rAtTyvrJ8f1LaUh2O5U4nA: posts small blind $1
pVqEzK9wXlRMECnb1Zg4Zw: posts big blind $2
*** HOLE CARDS ***
rAtTyvrJ8f1LaUh2O5U4nA: calls $1
pVqEzK9wXlRMECnb1Zg4Zw: checks
*** FLOP *** [8h 7s Tc]
pVqEzK9wXlRMECnb1Zg4Zw: checks
rAtTyvrJ8f1LaUh2O5U4nA: checks
*** TURN *** [8h 7s Tc] [Ad]
pVqEzK9wXlRMECnb1Zg4Zw: checks
rAtTyvrJ8f1LaUh2O5U4nA: checks
*** RIVER *** [8h 7s Tc Ad] [Td]
pVqEzK9wXlRMECnb1Zg4Zw: checks
rAtTyvrJ8f1LaUh2O5U4nA: checks
*** SHOW DOWN ***
pVqEzK9wXlRMECnb1Zg4Zw: shows [6d 4s] (a pair of Tens)
rAtTyvrJ8f1LaUh2O5U4nA: shows [Qh Kh] (a pair of Tens - Ace+King kicker)
rAtTyvrJ8f1LaUh2O5U4nA collected $3.80 from pot
*** SUMMARY ***
Total pot $4 | Rake $0.20
Board [8h 7s Tc Ad Td]
Seat 1: pVqEzK9wXlRMECnb1Zg4Zw (big blind) showed [6d 4s] and lost with a pair of Tens
Seat 2: rAtTyvrJ8f1LaUh2O5U4nA (button) (small blind) showed [Qh Kh] and won ($3.80) with a pair of Tens



PokerStars Game #59938602922:  Hold'em No Limit ($1/$2) - 2009/07/01 0:18:57 ET
Table 'G1Oqdy4Pqdb5gtx40rUBzA' 6-max Seat #2 is the button
Seat 2: IzslX/oV8DoDQfxCV/3+kg ($483.15 in chips)
Seat 3: lE+RUsc9cdVV9eEi8uytew ($106.20 in chips)
Seat 4: B87ikIyZ/TzAVeXf38Ny0g ($200 in chips)
Seat 6: gGPaCoSWW1HoKYaqfAPecg ($200 in chips)
lE+RUsc9cdVV9eEi8uytew: posts small blind $1
B87ikIyZ/TzAVeXf38Ny0g: posts big blind $2
X7GlkHF+lkbarCLuZ4Uf0w: sits out
*** HOLE CARDS ***
gGPaCoSWW1HoKYaqfAPecg: raises $5 to $7
IzslX/oV8DoDQfxCV/3+kg: calls $7
lE+RUsc9cdVV9eEi8uytew: calls $6
QCqxb/MXSq5RKfPtjBjiBA leaves the table
B87ikIyZ/TzAVeXf38Ny0g: folds
*** FLOP *** [Ah Tc 3s]
lE+RUsc9cdVV9eEi8uytew: bets $6
bz8Aw6kfX2xUq2sOyZlUCQ joins the table at seat #1
gGPaCoSWW1HoKYaqfAPecg: calls $6
IzslX/oV8DoDQfxCV/3+kg: folds
*** TURN *** [Ah Tc 3s] [8d]
lE+RUsc9cdVV9eEi8uytew: checks
gGPaCoSWW1HoKYaqfAPecg: bets $23.35
lE+RUsc9cdVV9eEi8uytew: raises $69.85 to $93.20 and is all-in
gGPaCoSWW1HoKYaqfAPecg: folds
lE+RUsc9cdVV9eEi8uytew collected $79.70 from pot
*** SUMMARY ***
Total pot $81.70 | Rake $2
Board [Ah Tc 3s 8d]
Seat 2: IzslX/oV8DoDQfxCV/3+kg (button) folded on the Flop
Seat 3: lE+RUsc9cdVV9eEi8uytew (small blind) collected ($79.70)
Seat 4: B87ikIyZ/TzAVeXf38Ny0g (big blind) folded before Flop
Seat 6: gGPaCoSWW1HoKYaqfAPecg folded on the Turn



PokerStars Game #59938603052:  Hold'em No Limit ($1/$2) - 2009/07/01 0:18:58 ET
Table '3FGoiEOffWrbgTfsB3t7FA' 2-max Seat #1 is the button
Seat 1: e0oDWyrmgLpR6bROEqw1nQ ($324 in chips)
Seat 2: +sy/nlNI20yZraIjs4AALg ($273.65 in chips)
e0oDWyrmgLpR6bROEqw1nQ: posts small blind $1
+sy/nlNI20yZraIjs4AALg: posts big blind $2
*** HOLE CARDS ***
e0oDWyrmgLpR6bROEqw1nQ: raises $4 to $6
+sy/nlNI20yZraIjs4AALg: folds
e0oDWyrmgLpR6bROEqw1nQ collected $4 from pot
*** SUMMARY ***
Total pot $4 | Rake $0
Seat 1: e0oDWyrmgLpR6bROEqw1nQ (button) (small blind) collected ($4)
Seat 2: +sy/nlNI20yZraIjs4AALg (big blind) folded before Flop



PokerStars Game #59938603422:  Hold'em No Limit ($1/$2) - 2009/07/01 0:18:58 ET
Table 'srul5UFZXTEccVV5fpY91g' 9-max Seat #6 is the button
Seat 1: lfD8cBv31A/pio3pXJbPjA ($159.20 in chips)
Seat 2: tJYod1SLp2AcWPL/3hZ7ug ($90.20 in chips)
Seat 3: weUZ8S7tgbaeIpzi1gBNxQ ($48.75 in chips)
Seat 4: GG5lTuGt3+kwNYSbqeB6yw ($104.40 in chips)
Seat 5: 5iPk5MyO3KVu18Y8XCYfFQ ($57.65 in chips)
Seat 6: TAfo4veNRaRlzDXMMYS3Jg ($33 in chips)
Seat 7: s0erZsDxbZSaEPheMgibKg ($452.40 in chips)
s0erZsDxbZSaEPheMgibKg: posts small blind $1
lfD8cBv31A/pio3pXJbPjA: posts big blind $2
*** HOLE CARDS ***
tJYod1SLp2AcWPL/3hZ7ug: calls $2
weUZ8S7tgbaeIpzi1gBNxQ: folds
GG5lTuGt3+kwNYSbqeB6yw: folds
5iPk5MyO3KVu18Y8XCYfFQ: folds
TAfo4veNRaRlzDXMMYS3Jg: folds
s0erZsDxbZSaEPheMgibKg: calls $1
lfD8cBv31A/pio3pXJbPjA: checks
*** FLOP *** [2h 7h 6h]
jRGC4KXXODbHEN275TXFCA joins the table at seat #9
s0erZsDxbZSaEPheMgibKg: bets $8
lfD8cBv31A/pio3pXJbPjA: folds
tJYod1SLp2AcWPL/3hZ7ug: folds
s0erZsDxbZSaEPheMgibKg collected $5.70 from pot
*** SUMMARY ***
Total pot $6 | Rake $0.30
Board [2h 7h 6h]
Seat 1: lfD8cBv31A/pio3pXJbPjA (big blind) folded on the Flop
Seat 2: tJYod1SLp2AcWPL/3hZ7ug folded on the Flop
Seat 3: weUZ8S7tgbaeIpzi1gBNxQ folded before Flop (didn't bet)
Seat 4: GG5lTuGt3+kwNYSbqeB6yw folded before Flop (didn't bet)
Seat 5: 5iPk5MyO3KVu18Y8XCYfFQ folded before Flop (didn't bet)
Seat 6: TAfo4veNRaRlzDXMMYS3Jg (button) folded before Flop (didn't bet)
Seat 7: s0erZsDxbZSaEPheMgibKg (small blind) collected ($5.70)



PokerStars Game #59938603664:  Hold'em No Limit ($1/$2) - 2009/07/01 0:18:59 ET
Table 'SF49/KQm8T4taMp6kb+HXA' 9-max Seat #4 is the button
Seat 1: l1bCLGuFqeFRwUfPsiDu/g ($246.95 in chips)
Seat 2: 8Z3QifiM9eOd5EIJ25dXNg ($45.35 in chips)
Seat 3: pCmk6FpSOLJ+85o1tLHIag ($100 in chips)
Seat 4: HffgoYm61KgkdMe/DYChIQ ($114 in chips)
Seat 5: Z3aYCZG/yXHYFjiWkGI5ug ($224.55 in chips)
Seat 6: M2ht6rIKOI/my9eh610Nlw ($228.40 in chips)
Seat 7: n2VAbLaE5qgKr5mA4W6v4w ($35.50 in chips)
Seat 8: 5iPk5MyO3KVu18Y8XCYfFQ ($39 in chips)
Seat 9: O+jytCilwk7zItVCEavmtw ($124.20 in chips)
Z3aYCZG/yXHYFjiWkGI5ug: posts small blind $1
M2ht6rIKOI/my9eh610Nlw: posts big blind $2
pCmk6FpSOLJ+85o1tLHIag: posts big blind $2
*** HOLE CARDS ***
n2VAbLaE5qgKr5mA4W6v4w has timed out
n2VAbLaE5qgKr5mA4W6v4w: folds
n2VAbLaE5qgKr5mA4W6v4w is sitting out
5iPk5MyO3KVu18Y8XCYfFQ: raises $8 to $10
O+jytCilwk7zItVCEavmtw: folds
l1bCLGuFqeFRwUfPsiDu/g: calls $10
8Z3QifiM9eOd5EIJ25dXNg: folds
pCmk6FpSOLJ+85o1tLHIag: folds
HffgoYm61KgkdMe/DYChIQ: folds
Z3aYCZG/yXHYFjiWkGI5ug: folds
M2ht6rIKOI/my9eh610Nlw: folds
*** FLOP *** [Kc Kh 4s]
n2VAbLaE5qgKr5mA4W6v4w has returned
5iPk5MyO3KVu18Y8XCYfFQ: bets $10
l1bCLGuFqeFRwUfPsiDu/g: raises $12 to $22
5iPk5MyO3KVu18Y8XCYfFQ: raises $7 to $29 and is all-in
l1bCLGuFqeFRwUfPsiDu/g: calls $7
*** TURN *** [Kc Kh 4s] [Jc]
*** RIVER *** [Kc Kh 4s Jc] [Ts]
*** SHOW DOWN ***
5iPk5MyO3KVu18Y8XCYfFQ: shows [9d 9s] (two pair, Kings and Nines)
l1bCLGuFqeFRwUfPsiDu/g: shows [Jd Jh] (a full house, Jacks full of Kings)
l1bCLGuFqeFRwUfPsiDu/g collected $80 from pot
*** SUMMARY ***
Total pot $83 | Rake $3
Board [Kc Kh 4s Jc Ts]
Seat 1: l1bCLGuFqeFRwUfPsiDu/g showed [Jd Jh] and won ($80) with a full house, Jacks full of Kings
Seat 2: 8Z3QifiM9eOd5EIJ25dXNg folded before Flop (didn't bet)
Seat 3: pCmk6FpSOLJ+85o1tLHIag folded before Flop
Seat 4: HffgoYm61KgkdMe/DYChIQ (button) folded before Flop (didn't bet)
Seat 5: Z3aYCZG/yXHYFjiWkGI5ug (small blind) folded before Flop
Seat 6: M2ht6rIKOI/my9eh610Nlw (big blind) folded before Flop
Seat 7: n2VAbLaE5qgKr5mA4W6v4w folded before Flop (didn't bet)
Seat 8: 5iPk5MyO3KVu18Y8XCYfFQ showed [9d 9s] and lost with two pair, Kings and Nines
Seat 9: O+jytCilwk7zItVCEavmtw folded before Flop (didn't bet)



PokerStars Game #59938605570:  Hold'em No Limit ($1/$2) - 2009/07/01 0:19:01 ET
Table 'ZzSIe0zTCDv+n6hfbY5tTg' 6-max Seat #2 is the button
Seat 1: 8srN1dKQePlsv0GyTada+Q ($263.70 in chips)
Seat 2: B87ikIyZ/TzAVeXf38Ny0g ($200 in chips)
Seat 3: X7GlkHF+lkbarCLuZ4Uf0w ($38 in chips)
Seat 4: ky55L0pITYgYLeqFB9gP/Q ($181.40 in chips)
Seat 5: Q3uFdu6ztesjDFiqkagTRQ ($213.65 in chips)
Seat 6: InmkdI6G8TzSj9NhcCSyPg ($200 in chips)
X7GlkHF+lkbarCLuZ4Uf0w: posts small blind $1
ky55L0pITYgYLeqFB9gP/Q: posts big blind $2
*** HOLE CARDS ***
Q3uFdu6ztesjDFiqkagTRQ: folds
InmkdI6G8TzSj9NhcCSyPg: folds
8srN1dKQePlsv0GyTada+Q: raises $4 to $6
B87ikIyZ/TzAVeXf38Ny0g: folds
X7GlkHF+lkbarCLuZ4Uf0w: folds
ky55L0pITYgYLeqFB9gP/Q: calls $4
*** FLOP *** [5h Qs Qd]
ky55L0pITYgYLeqFB9gP/Q: checks
8srN1dKQePlsv0GyTada+Q: bets $8
ky55L0pITYgYLeqFB9gP/Q: folds
8srN1dKQePlsv0GyTada+Q collected $12.35 from pot
8srN1dKQePlsv0GyTada+Q: doesn't show hand
*** SUMMARY ***
Total pot $13 | Rake $0.65
Board [5h Qs Qd]
Seat 1: 8srN1dKQePlsv0GyTada+Q collected ($12.35)
Seat 2: B87ikIyZ/TzAVeXf38Ny0g (button) folded before Flop (didn't bet)
Seat 3: X7GlkHF+lkbarCLuZ4Uf0w (small blind) folded before Flop
Seat 4: ky55L0pITYgYLeqFB9gP/Q (big blind) folded on the Flop
Seat 5: Q3uFdu6ztesjDFiqkagTRQ folded before Flop (didn't bet)
Seat 6: InmkdI6G8TzSj9NhcCSyPg folded before Flop (didn't bet)



PokerStars Game #59938605382:  Hold'em No Limit ($1/$2) - 2009/07/01 0:19:01 ET
Table 'NmY84NAf9Mh0ckAckHnh5g' 2-max Seat #1 is the button
Seat 1: 6hvg964TSqZ3AL/0XK9aVQ ($631.65 in chips)
Seat 2: RwDoM55ZeQuI2ADyJhOb2Q ($190 in chips)
6hvg964TSqZ3AL/0XK9aVQ: posts small blind $1
RwDoM55ZeQuI2ADyJhOb2Q: posts big blind $2
*** HOLE CARDS ***
6hvg964TSqZ3AL/0XK9aVQ: folds
RwDoM55ZeQuI2ADyJhOb2Q collected $2 from pot
RwDoM55ZeQuI2ADyJhOb2Q: doesn't show hand
*** SUMMARY ***
Total pot $2 | Rake $0
Seat 1: 6hvg964TSqZ3AL/0XK9aVQ (button) (small blind) folded before Flop
Seat 2: RwDoM55ZeQuI2ADyJhOb2Q (big blind) collected ($2)



PokerStars Game #59938609730:  Hold'em No Limit ($1/$2) - 2009/07/01 0:19:07 ET
Table 'NmY84NAf9Mh0ckAckHnh5g' 2-max Seat #2 is the button
Seat 1: 6hvg964TSqZ3AL/0XK9aVQ ($630.65 in chips)
Seat 2: RwDoM55ZeQuI2ADyJhOb2Q ($191 in chips)
RwDoM55ZeQuI2ADyJhOb2Q: posts small blind $1
6hvg964TSqZ3AL/0XK9aVQ: posts big blind $2
*** HOLE CARDS ***
RwDoM55ZeQuI2ADyJhOb2Q: raises $4 to $6
6hvg964TSqZ3AL/0XK9aVQ: folds
RwDoM55ZeQuI2ADyJhOb2Q collected $4 from pot
RwDoM55ZeQuI2ADyJhOb2Q: doesn't show hand
*** SUMMARY ***
Total pot $4 | Rake $0
Seat 1: 6hvg964TSqZ3AL/0XK9aVQ (big blind) folded before Flop
Seat 2: RwDoM55ZeQuI2ADyJhOb2Q (button) (small blind) collected ($4)



PokerStars Game #59938609226:  Hold'em No Limit ($1/$2) - 2009/07/01 0:19:07 ET
Table 'aSf77Sj8QEnzcc0WaxVD4Q' 6-max Seat #6 is the button
Seat 2: vkfxu8f/jMYKUk6Ly4eujw ($257.15 in chips)
Seat 3: 9dpyyjDTCed6nV7JhaUUpw ($200 in chips)
Seat 4: 513FcCI8jHyQy2VWoIQkMg ($200 in chips)
Seat 5: InmkdI6G8TzSj9NhcCSyPg ($247 in chips)
Seat 6: vkoJRf3gidxY1pPi0AFWww ($300.40 in chips)
54yWzRRgS0oZ+S6LwZBxMQ will be allowed to play after the button
vkfxu8f/jMYKUk6Ly4eujw: posts small blind $1
9dpyyjDTCed6nV7JhaUUpw: posts big blind $2
*** HOLE CARDS ***
513FcCI8jHyQy2VWoIQkMg: folds
InmkdI6G8TzSj9NhcCSyPg: raises $4 to $6
vkoJRf3gidxY1pPi0AFWww: folds
vkfxu8f/jMYKUk6Ly4eujw: folds
9dpyyjDTCed6nV7JhaUUpw: folds
InmkdI6G8TzSj9NhcCSyPg collected $5 from pot
InmkdI6G8TzSj9NhcCSyPg: doesn't show hand
*** SUMMARY ***
Total pot $5 | Rake $0
Seat 2: vkfxu8f/jMYKUk6Ly4eujw (small blind) folded before Flop
Seat 3: 9dpyyjDTCed6nV7JhaUUpw (big blind) folded before Flop
Seat 4: 513FcCI8jHyQy2VWoIQkMg folded before Flop (didn't bet)
Seat 5: InmkdI6G8TzSj9NhcCSyPg collected ($5)
Seat 6: vkoJRf3gidxY1pPi0AFWww (button) folded before Flop (didn't bet)



PokerStars Game #59938609682:  Hold'em No Limit ($1/$2) - 2009/07/01 0:19:07 ET
Table 'LL4bDFyhj5hsMpzaDugJZg' 6-max Seat #1 is the button
Seat 1: IBW9lyGsaRmfcbyA/qFfEw ($61.20 in chips)
Seat 3: gGPaCoSWW1HoKYaqfAPecg ($201 in chips)
Seat 4: 8srN1dKQePlsv0GyTada+Q ($248.75 in chips)
Seat 5: HgX0VeqE/dzSXd5BpntRBw ($244.40 in chips)
Seat 6: /PH6Ffnho4Ysm8S3V/oa+w ($40 in chips)
gGPaCoSWW1HoKYaqfAPecg: posts small blind $1
8srN1dKQePlsv0GyTada+Q: posts big blind $2
*** HOLE CARDS ***
HgX0VeqE/dzSXd5BpntRBw: folds
/PH6Ffnho4Ysm8S3V/oa+w: folds
IBW9lyGsaRmfcbyA/qFfEw: raises $2 to $4
gGPaCoSWW1HoKYaqfAPecg: raises $9 to $13
8srN1dKQePlsv0GyTada+Q: folds
IBW9lyGsaRmfcbyA/qFfEw: folds
gGPaCoSWW1HoKYaqfAPecg collected $10 from pot
*** SUMMARY ***
Total pot $10 | Rake $0
Seat 1: IBW9lyGsaRmfcbyA/qFfEw (button) folded before Flop
Seat 3: gGPaCoSWW1HoKYaqfAPecg (small blind) collected ($10)
Seat 4: 8srN1dKQePlsv0GyTada+Q (big blind) folded before Flop
Seat 5: HgX0VeqE/dzSXd5BpntRBw folded before Flop (didn't bet)
Seat 6: /PH6Ffnho4Ysm8S3V/oa+w folded before Flop (didn't bet)



PokerStars Game #59938610354:  Hold'em No Limit ($1/$2) - 2009/07/01 0:19:08 ET
Table 'WCA60bDA8ecovUgFSIZkTQ' 9-max Seat #6 is the button
Seat 1: CUZwDpLTQKhzarPe+JCLOQ ($211.75 in chips)
Seat 2: G1h8wamBcVJXtsKXZQ2EyA ($105.85 in chips)
Seat 3: 5iPk5MyO3KVu18Y8XCYfFQ ($40 in chips)
Seat 4: Q3uFdu6ztesjDFiqkagTRQ ($461.70 in chips)
Seat 5: Hc2itIxwbi1lwa+DAYYQGg ($300.30 in chips)
Seat 6: DOWQSOJ7GaX+ksfWTqPT5A ($248.90 in chips)
Seat 7: 2YpnxJiexJHyERfbqgwEcw ($56 in chips)
Seat 8: x+V1JgVDawsJTxKcxm7gxw ($91 in chips)
Seat 9: 3q2/0oJr3Mcy1W5tcN61ug ($294.20 in chips)
2YpnxJiexJHyERfbqgwEcw: posts small blind $1
x+V1JgVDawsJTxKcxm7gxw: posts big blind $2
*** HOLE CARDS ***
3q2/0oJr3Mcy1W5tcN61ug: folds
CUZwDpLTQKhzarPe+JCLOQ: folds
G1h8wamBcVJXtsKXZQ2EyA: folds
5iPk5MyO3KVu18Y8XCYfFQ: folds
Q3uFdu6ztesjDFiqkagTRQ: raises $4 to $6
Hc2itIxwbi1lwa+DAYYQGg: folds
DOWQSOJ7GaX+ksfWTqPT5A: raises $6 to $12
2YpnxJiexJHyERfbqgwEcw: folds
x+V1JgVDawsJTxKcxm7gxw: folds
Q3uFdu6ztesjDFiqkagTRQ: raises $30 to $42
DOWQSOJ7GaX+ksfWTqPT5A: raises $206.90 to $248.90 and is all-in
Q3uFdu6ztesjDFiqkagTRQ: calls $206.90
*** FLOP *** [Ts 6h 4h]
*** TURN *** [Ts 6h 4h] [2d]
*** RIVER *** [Ts 6h 4h 2d] [Jd]
*** SHOW DOWN ***
Q3uFdu6ztesjDFiqkagTRQ: shows [Ks Kh] (a pair of Kings)
DOWQSOJ7GaX+ksfWTqPT5A: mucks hand
Q3uFdu6ztesjDFiqkagTRQ collected $497.80 from pot
*** SUMMARY ***
Total pot $500.80 | Rake $3
Board [Ts 6h 4h 2d Jd]
Seat 1: CUZwDpLTQKhzarPe+JCLOQ folded before Flop (didn't bet)
Seat 2: G1h8wamBcVJXtsKXZQ2EyA folded before Flop (didn't bet)
Seat 3: 5iPk5MyO3KVu18Y8XCYfFQ folded before Flop (didn't bet)
Seat 4: Q3uFdu6ztesjDFiqkagTRQ showed [Ks Kh] and won ($497.80) with a pair of Kings
Seat 5: Hc2itIxwbi1lwa+DAYYQGg folded before Flop (didn't bet)
Seat 6: DOWQSOJ7GaX+ksfWTqPT5A (button) mucked
Seat 7: 2YpnxJiexJHyERfbqgwEcw (small blind) folded before Flop
Seat 8: x+V1JgVDawsJTxKcxm7gxw (big blind) folded before Flop
Seat 9: 3q2/0oJr3Mcy1W5tcN61ug folded before Flop (didn't bet)



PokerStars Game #59938610868:  Hold'em No Limit ($1/$2) - 2009/07/01 0:19:09 ET
Table '3FGoiEOffWrbgTfsB3t7FA' 2-max Seat #2 is the button
Seat 1: e0oDWyrmgLpR6bROEqw1nQ ($326 in chips)
Seat 2: +sy/nlNI20yZraIjs4AALg ($271.65 in chips)
+sy/nlNI20yZraIjs4AALg: posts small blind $1
e0oDWyrmgLpR6bROEqw1nQ: posts big blind $2
*** HOLE CARDS ***
+sy/nlNI20yZraIjs4AALg: raises $4 to $6
e0oDWyrmgLpR6bROEqw1nQ: folds
+sy/nlNI20yZraIjs4AALg collected $4 from pot
*** SUMMARY ***
Total pot $4 | Rake $0
Seat 1: e0oDWyrmgLpR6bROEqw1nQ (big blind) folded before Flop
Seat 2: +sy/nlNI20yZraIjs4AALg (button) (small blind) collected ($4)



PokerStars Game #59938610938:  Hold'em No Limit ($1/$2) - 2009/07/01 0:19:09 ET
Table 'mGpP9StWRnoeiBDExc6Frg' 6-max Seat #5 is the button
Seat 1: zWFU82nxIRvzK4mKiL4m0Q ($65.05 in chips)
Seat 2: DQlskgG4OtLpF2MVxLwf4A ($214.85 in chips)
Seat 3: 3HrFUl+TAqSP1U00zz3P7A ($171.60 in chips)
Seat 4: qXDd0ZyMIse0OBu8pxeQ3Q ($215 in chips)
Seat 5: d1puGuVBE0fidn+5eRJ0tw ($167.70 in chips)
Seat 6: X7GlkHF+lkbarCLuZ4Uf0w ($24.45 in chips)
X7GlkHF+lkbarCLuZ4Uf0w: posts small blind $1
zWFU82nxIRvzK4mKiL4m0Q: posts big blind $2
*** HOLE CARDS ***
DQlskgG4OtLpF2MVxLwf4A: raises $6 to $8
3HrFUl+TAqSP1U00zz3P7A: calls $8
qXDd0ZyMIse0OBu8pxeQ3Q: folds
d1puGuVBE0fidn+5eRJ0tw: folds
X7GlkHF+lkbarCLuZ4Uf0w: folds
zWFU82nxIRvzK4mKiL4m0Q: folds
*** FLOP *** [3h Td Kc]
DQlskgG4OtLpF2MVxLwf4A: bets $13
3HrFUl+TAqSP1U00zz3P7A: calls $13
*** TURN *** [3h Td Kc] [2d]
DQlskgG4OtLpF2MVxLwf4A: checks
3HrFUl+TAqSP1U00zz3P7A: bets $22
DQlskgG4OtLpF2MVxLwf4A: calls $22
*** RIVER *** [3h Td Kc 2d] [9h]
DQlskgG4OtLpF2MVxLwf4A: checks
3HrFUl+TAqSP1U00zz3P7A: bets $52
DQlskgG4OtLpF2MVxLwf4A: calls $52
*** SHOW DOWN ***
3HrFUl+TAqSP1U00zz3P7A: shows [Tc Jc] (a pair of Tens)
DQlskgG4OtLpF2MVxLwf4A: shows [Jh Kd] (a pair of Kings)
DQlskgG4OtLpF2MVxLwf4A collected $190 from pot
*** SUMMARY ***
Total pot $193 | Rake $3
Board [3h Td Kc 2d 9h]
Seat 1: zWFU82nxIRvzK4mKiL4m0Q (big blind) folded before Flop
Seat 2: DQlskgG4OtLpF2MVxLwf4A showed [Jh Kd] and won ($190) with a pair of Kings
Seat 3: 3HrFUl+TAqSP1U00zz3P7A showed [Tc Jc] and lost with a pair of Tens
Seat 4: qXDd0ZyMIse0OBu8pxeQ3Q folded before Flop (didn't bet)
Seat 5: d1puGuVBE0fidn+5eRJ0tw (button) folded before Flop (didn't bet)
Seat 6: X7GlkHF+lkbarCLuZ4Uf0w (small blind) folded before Flop



PokerStars Game #59938615226:  Hold'em No Limit ($1/$2) - 2009/07/01 0:19:15 ET
Table 'OZyw34U4j4WtFFWsEHZQgQ' 2-max Seat #1 is the button
Seat 1: pVqEzK9wXlRMECnb1Zg4Zw ($85.50 in chips)
Seat 2: rAtTyvrJ8f1LaUh2O5U4nA ($39.80 in chips)
pVqEzK9wXlRMECnb1Zg4Zw: posts small blind $1
rAtTyvrJ8f1LaUh2O5U4nA: posts big blind $2
*** HOLE CARDS ***
pVqEzK9wXlRMECnb1Zg4Zw: raises $8 to $10
rAtTyvrJ8f1LaUh2O5U4nA: raises $29.80 to $39.80 and is all-in
pVqEzK9wXlRMECnb1Zg4Zw: folds
rAtTyvrJ8f1LaUh2O5U4nA collected $20 from pot
rAtTyvrJ8f1LaUh2O5U4nA: doesn't show hand
*** SUMMARY ***
Total pot $20 | Rake $0
Seat 1: pVqEzK9wXlRMECnb1Zg4Zw (button) (small blind) folded before Flop
Seat 2: rAtTyvrJ8f1LaUh2O5U4nA (big blind) collected ($20)



PokerStars Game #59938614742:  Hold'em No Limit ($1/$2) - 2009/07/01 0:19:15 ET
Table 'NmY84NAf9Mh0ckAckHnh5g' 2-max Seat #1 is the button
Seat 1: 6hvg964TSqZ3AL/0XK9aVQ ($628.65 in chips)
Seat 2: RwDoM55ZeQuI2ADyJhOb2Q ($193 in chips)
6hvg964TSqZ3AL/0XK9aVQ: posts small blind $1
RwDoM55ZeQuI2ADyJhOb2Q: posts big blind $2
*** HOLE CARDS ***
6hvg964TSqZ3AL/0XK9aVQ: folds
RwDoM55ZeQuI2ADyJhOb2Q collected $2 from pot
RwDoM55ZeQuI2ADyJhOb2Q: doesn't show hand
*** SUMMARY ***
Total pot $2 | Rake $0
Seat 1: 6hvg964TSqZ3AL/0XK9aVQ (button) (small blind) folded before Flop
Seat 2: RwDoM55ZeQuI2ADyJhOb2Q (big blind) collected ($2)



PokerStars Game #59938617126:  Hold'em No Limit ($1/$2) - 2009/07/01 0:19:18 ET
Table 'on4i1U1lCRmxsduFD3xiSg' 9-max Seat #1 is the button
Seat 1: so5k3vFDmokh2q3dImJ1GQ ($115 in chips)
Seat 2: yZYrOeNDxQxkzpbgKX1bng ($72.20 in chips)
Seat 3: 5iPk5MyO3KVu18Y8XCYfFQ ($61.20 in chips)
Seat 4: Z3aYCZG/yXHYFjiWkGI5ug ($530.10 in chips)
Seat 5: QHxJjpVYwitg9krW6wZgJA ($203 in chips)
Seat 6: CUZwDpLTQKhzarPe+JCLOQ ($214.55 in chips)
Seat 7: xD4ElYxz6Ollzmam8BmMCw ($197 in chips)
Seat 8: cdC54j9fGGojcbzWB5PgzA ($200 in chips)
Seat 9: iMe5yhc+1BaiIPHet3NMrA ($200 in chips)
yZYrOeNDxQxkzpbgKX1bng: posts small blind $1
5iPk5MyO3KVu18Y8XCYfFQ: posts big blind $2
*** HOLE CARDS ***
Z3aYCZG/yXHYFjiWkGI5ug: folds
QHxJjpVYwitg9krW6wZgJA: folds
CUZwDpLTQKhzarPe+JCLOQ: raises $6 to $8
xD4ElYxz6Ollzmam8BmMCw: folds
cdC54j9fGGojcbzWB5PgzA: folds
iMe5yhc+1BaiIPHet3NMrA: folds
so5k3vFDmokh2q3dImJ1GQ: folds
yZYrOeNDxQxkzpbgKX1bng: folds
5iPk5MyO3KVu18Y8XCYfFQ: folds
CUZwDpLTQKhzarPe+JCLOQ collected $5 from pot
*** SUMMARY ***
Total pot $5 | Rake $0
Seat 1: so5k3vFDmokh2q3dImJ1GQ (button) folded before Flop (didn't bet)
Seat 2: yZYrOeNDxQxkzpbgKX1bng (small blind) folded before Flop
Seat 3: 5iPk5MyO3KVu18Y8XCYfFQ (big blind) folded before Flop
Seat 4: Z3aYCZG/yXHYFjiWkGI5ug folded before Flop (didn't bet)
Seat 5: QHxJjpVYwitg9krW6wZgJA folded before Flop (didn't bet)
Seat 6: CUZwDpLTQKhzarPe+JCLOQ collected ($5)
Seat 7: xD4ElYxz6Ollzmam8BmMCw folded before Flop (didn't bet)
Seat 8: cdC54j9fGGojcbzWB5PgzA folded before Flop (didn't bet)
Seat 9: iMe5yhc+1BaiIPHet3NMrA folded before Flop (didn't bet)



PokerStars Game #59938618494:  Hold'em No Limit ($1/$2) - 2009/07/01 0:19:20 ET
Table 'W9UeSV0aoPjh5SFSxM8jUQ' 9-max Seat #3 is the button
Seat 1: cdC54j9fGGojcbzWB5PgzA ($204.60 in chips)
Seat 2: iMe5yhc+1BaiIPHet3NMrA ($313.75 in chips)
Seat 3: TAfo4veNRaRlzDXMMYS3Jg ($37 in chips)
Seat 4: De9g+AYjo0DN6C/+iT/nsg ($195 in chips)
Seat 5: CUZwDpLTQKhzarPe+JCLOQ ($200 in chips)
Seat 6: MXxB6weBWzZyAhRZb+/KVg ($196 in chips)
Seat 7: 4Cl43Q1TYQL8wn1NSCUkaw ($44.60 in chips)
Seat 8: z89zAYE4dlPgjkofBKII0Q ($46.55 in chips)
Seat 9: U2A5Hv6ib/5+gzO2wr7Z4w ($203 in chips)
De9g+AYjo0DN6C/+iT/nsg: posts small blind $1
CUZwDpLTQKhzarPe+JCLOQ: posts big blind $2
*** HOLE CARDS ***
MXxB6weBWzZyAhRZb+/KVg: folds
4Cl43Q1TYQL8wn1NSCUkaw: folds
z89zAYE4dlPgjkofBKII0Q: folds
U2A5Hv6ib/5+gzO2wr7Z4w: folds
cdC54j9fGGojcbzWB5PgzA: folds
iMe5yhc+1BaiIPHet3NMrA: raises $4 to $6
TAfo4veNRaRlzDXMMYS3Jg: folds
De9g+AYjo0DN6C/+iT/nsg: folds
CUZwDpLTQKhzarPe+JCLOQ: folds
iMe5yhc+1BaiIPHet3NMrA collected $5 from pot
iMe5yhc+1BaiIPHet3NMrA: doesn't show hand
*** SUMMARY ***
Total pot $5 | Rake $0
Seat 1: cdC54j9fGGojcbzWB5PgzA folded before Flop (didn't bet)
Seat 2: iMe5yhc+1BaiIPHet3NMrA collected ($5)
Seat 3: TAfo4veNRaRlzDXMMYS3Jg (button) folded before Flop (didn't bet)
Seat 4: De9g+AYjo0DN6C/+iT/nsg (small blind) folded before Flop
Seat 5: CUZwDpLTQKhzarPe+JCLOQ (big blind) folded before Flop
Seat 6: MXxB6weBWzZyAhRZb+/KVg folded before Flop (didn't bet)
Seat 7: 4Cl43Q1TYQL8wn1NSCUkaw folded before Flop (didn't bet)
Seat 8: z89zAYE4dlPgjkofBKII0Q folded before Flop (didn't bet)
Seat 9: U2A5Hv6ib/5+gzO2wr7Z4w folded before Flop (didn't bet)



PokerStars Game #59938619002:  Hold'em No Limit ($1/$2) - 2009/07/01 0:19:21 ET
Table 'qVXak+oTeDXMGbWa4sDU5Q' 9-max Seat #2 is the button
Seat 1: H6Z4+qu8gR0VUiPOijndVg ($257.30 in chips)
Seat 2: Hc2itIxwbi1lwa+DAYYQGg ($46 in chips)
Seat 3: oz9eCXGC7DdjQlL/nuWj1A ($118.65 in chips)
Seat 5: NqKRc5xvcye0d7F6VOF6MQ ($82.50 in chips)
Seat 6: Q3uFdu6ztesjDFiqkagTRQ ($200 in chips)
Seat 7: 5iPk5MyO3KVu18Y8XCYfFQ ($109 in chips)
Seat 8: 9pHZMviI9R8injxojGTnvw ($118.80 in chips)
Seat 9: ZP45Tu5Zqo4v+ZgqIQVoOQ ($197 in chips)
oz9eCXGC7DdjQlL/nuWj1A: posts small blind $1
b0jO1SDhLedy1//CQlA8kw: is sitting out
NqKRc5xvcye0d7F6VOF6MQ: posts big blind $2
*** HOLE CARDS ***
b0jO1SDhLedy1//CQlA8kw leaves the table
Q3uFdu6ztesjDFiqkagTRQ: folds
5iPk5MyO3KVu18Y8XCYfFQ: folds
9pHZMviI9R8injxojGTnvw: raises $4 to $6
ZP45Tu5Zqo4v+ZgqIQVoOQ: folds
H6Z4+qu8gR0VUiPOijndVg: folds
Hc2itIxwbi1lwa+DAYYQGg: folds
oz9eCXGC7DdjQlL/nuWj1A: folds
NqKRc5xvcye0d7F6VOF6MQ: calls $4
*** FLOP *** [Jd 5c Kd]
NqKRc5xvcye0d7F6VOF6MQ: bets $6
lQYT23h5QCUVZAKxjOO39Q joins the table at seat #4
9pHZMviI9R8injxojGTnvw: calls $6
*** TURN *** [Jd 5c Kd] [2c]
NqKRc5xvcye0d7F6VOF6MQ: bets $8
9pHZMviI9R8injxojGTnvw: raises $18 to $26
NqKRc5xvcye0d7F6VOF6MQ: calls $18
*** RIVER *** [Jd 5c Kd 2c] [7h]
NqKRc5xvcye0d7F6VOF6MQ: bets $8
9pHZMviI9R8injxojGTnvw: raises $34 to $42
NqKRc5xvcye0d7F6VOF6MQ: calls $34
*** SHOW DOWN ***
9pHZMviI9R8injxojGTnvw: shows [Tc Ac] (high card Ace)
NqKRc5xvcye0d7F6VOF6MQ: shows [Qs Ks] (a pair of Kings)
NqKRc5xvcye0d7F6VOF6MQ collected $158 from pot
*** SUMMARY ***
Total pot $161 | Rake $3
Board [Jd 5c Kd 2c 7h]
Seat 1: H6Z4+qu8gR0VUiPOijndVg folded before Flop (didn't bet)
Seat 2: Hc2itIxwbi1lwa+DAYYQGg (button) folded before Flop (didn't bet)
Seat 3: oz9eCXGC7DdjQlL/nuWj1A (small blind) folded before Flop
Seat 5: NqKRc5xvcye0d7F6VOF6MQ (big blind) showed [Qs Ks] and won ($158) with a pair of Kings
Seat 6: Q3uFdu6ztesjDFiqkagTRQ folded before Flop (didn't bet)
Seat 7: 5iPk5MyO3KVu18Y8XCYfFQ folded before Flop (didn't bet)
Seat 8: 9pHZMviI9R8injxojGTnvw showed [Tc Ac] and lost with high card Ace
Seat 9: ZP45Tu5Zqo4v+ZgqIQVoOQ folded before Flop (didn't bet)



PokerStars Game #59938619060:  Hold'em No Limit ($1/$2) - 2009/07/01 0:19:21 ET
Table 'NmY84NAf9Mh0ckAckHnh5g' 2-max Seat #2 is the button
Seat 1: 6hvg964TSqZ3AL/0XK9aVQ ($627.65 in chips)
Seat 2: RwDoM55ZeQuI2ADyJhOb2Q ($194 in chips)
RwDoM55ZeQuI2ADyJhOb2Q: posts small blind $1
6hvg964TSqZ3AL/0XK9aVQ: posts big blind $2
*** HOLE CARDS ***
RwDoM55ZeQuI2ADyJhOb2Q: folds
6hvg964TSqZ3AL/0XK9aVQ collected $2 from pot
*** SUMMARY ***
Total pot $2 | Rake $0
Seat 1: 6hvg964TSqZ3AL/0XK9aVQ (big blind) collected ($2)
Seat 2: RwDoM55ZeQuI2ADyJhOb2Q (button) (small blind) folded before Flop



PokerStars Game #59938622038:  Hold'em No Limit ($1/$2) - 2009/07/01 0:19:25 ET
Table 'OZyw34U4j4WtFFWsEHZQgQ' 2-max Seat #2 is the button
Seat 1: pVqEzK9wXlRMECnb1Zg4Zw ($75.50 in chips)
Seat 2: rAtTyvrJ8f1LaUh2O5U4nA ($49.80 in chips)
rAtTyvrJ8f1LaUh2O5U4nA: posts small blind $1
pVqEzK9wXlRMECnb1Zg4Zw: posts big blind $2
*** HOLE CARDS ***
rAtTyvrJ8f1LaUh2O5U4nA: folds
pVqEzK9wXlRMECnb1Zg4Zw collected $2 from pot
pVqEzK9wXlRMECnb1Zg4Zw: doesn't show hand
*** SUMMARY ***
Total pot $2 | Rake $0
Seat 1: pVqEzK9wXlRMECnb1Zg4Zw (big blind) collected ($2)
Seat 2: rAtTyvrJ8f1LaUh2O5U4nA (button) (small blind) folded before Flop



PokerStars Game #59938622142:  Hold'em No Limit ($1/$2) - 2009/07/01 0:19:26 ET
Table '3FGoiEOffWrbgTfsB3t7FA' 2-max Seat #1 is the button
Seat 1: e0oDWyrmgLpR6bROEqw1nQ ($324 in chips)
Seat 2: +sy/nlNI20yZraIjs4AALg ($273.65 in chips)
e0oDWyrmgLpR6bROEqw1nQ: posts small blind $1
+sy/nlNI20yZraIjs4AALg: posts big blind $2
*** HOLE CARDS ***
e0oDWyrmgLpR6bROEqw1nQ: raises $4 to $6
+sy/nlNI20yZraIjs4AALg: calls $4
*** FLOP *** [2s Tc 7h]
+sy/nlNI20yZraIjs4AALg: checks
e0oDWyrmgLpR6bROEqw1nQ: bets $8
+sy/nlNI20yZraIjs4AALg: calls $8
*** TURN *** [2s Tc 7h] [6c]
+sy/nlNI20yZraIjs4AALg: checks
e0oDWyrmgLpR6bROEqw1nQ: bets $18
+sy/nlNI20yZraIjs4AALg: calls $18
*** RIVER *** [2s Tc 7h 6c] [7s]
+sy/nlNI20yZraIjs4AALg: checks
e0oDWyrmgLpR6bROEqw1nQ: bets $44
+sy/nlNI20yZraIjs4AALg: calls $44
*** SHOW DOWN ***
e0oDWyrmgLpR6bROEqw1nQ: shows [Ac Ah] (two pair, Aces and Sevens)
+sy/nlNI20yZraIjs4AALg: mucks hand
e0oDWyrmgLpR6bROEqw1nQ collected $151.50 from pot
*** SUMMARY ***
Total pot $152 | Rake $0.50
Board [2s Tc 7h 6c 7s]
Seat 1: e0oDWyrmgLpR6bROEqw1nQ (button) (small blind) showed [Ac Ah] and won ($151.50) with two pair, Aces and Sevens
Seat 2: +sy/nlNI20yZraIjs4AALg (big blind) mucked



PokerStars Game #59938623448:  Hold'em No Limit ($1/$2) - 2009/07/01 0:19:28 ET
Table 'NmY84NAf9Mh0ckAckHnh5g' 2-max Seat #1 is the button
Seat 1: 6hvg964TSqZ3AL/0XK9aVQ ($628.65 in chips)
Seat 2: RwDoM55ZeQuI2ADyJhOb2Q ($193 in chips)
6hvg964TSqZ3AL/0XK9aVQ: posts small blind $1
RwDoM55ZeQuI2ADyJhOb2Q: posts big blind $2
*** HOLE CARDS ***
6hvg964TSqZ3AL/0XK9aVQ: folds
RwDoM55ZeQuI2ADyJhOb2Q collected $2 from pot
RwDoM55ZeQuI2ADyJhOb2Q: doesn't show hand
*** SUMMARY ***
Total pot $2 | Rake $0
Seat 1: 6hvg964TSqZ3AL/0XK9aVQ (button) (small blind) folded before Flop
Seat 2: RwDoM55ZeQuI2ADyJhOb2Q (big blind) collected ($2)



PokerStars Game #59938623980:  Hold'em No Limit ($1/$2) - 2009/07/01 0:19:28 ET
Table 'aSf77Sj8QEnzcc0WaxVD4Q' 6-max Seat #2 is the button
Seat 2: vkfxu8f/jMYKUk6Ly4eujw ($256.15 in chips)
Seat 3: 9dpyyjDTCed6nV7JhaUUpw ($200 in chips)
Seat 4: 513FcCI8jHyQy2VWoIQkMg ($200 in chips)
Seat 5: InmkdI6G8TzSj9NhcCSyPg ($250 in chips)
Seat 6: vkoJRf3gidxY1pPi0AFWww ($300.40 in chips)
9dpyyjDTCed6nV7JhaUUpw: posts small blind $1
513FcCI8jHyQy2VWoIQkMg: posts big blind $2
54yWzRRgS0oZ+S6LwZBxMQ: sits out
*** HOLE CARDS ***
InmkdI6G8TzSj9NhcCSyPg: folds
vkoJRf3gidxY1pPi0AFWww: calls $2
vkfxu8f/jMYKUk6Ly4eujw: folds
9dpyyjDTCed6nV7JhaUUpw: folds
513FcCI8jHyQy2VWoIQkMg: checks
*** FLOP *** [6s Ad 4h]
513FcCI8jHyQy2VWoIQkMg: checks
vkoJRf3gidxY1pPi0AFWww: checks
*** TURN *** [6s Ad 4h] [6d]
513FcCI8jHyQy2VWoIQkMg: checks
vkoJRf3gidxY1pPi0AFWww: checks
*** RIVER *** [6s Ad 4h 6d] [9h]
513FcCI8jHyQy2VWoIQkMg: checks
vkoJRf3gidxY1pPi0AFWww: checks
*** SHOW DOWN ***
513FcCI8jHyQy2VWoIQkMg: shows [3c Kh] (a pair of Sixes)
vkoJRf3gidxY1pPi0AFWww: mucks hand
513FcCI8jHyQy2VWoIQkMg collected $4.75 from pot
*** SUMMARY ***
Total pot $5 | Rake $0.25
Board [6s Ad 4h 6d 9h]
Seat 2: vkfxu8f/jMYKUk6Ly4eujw (button) folded before Flop (didn't bet)
Seat 3: 9dpyyjDTCed6nV7JhaUUpw (small blind) folded before Flop
Seat 4: 513FcCI8jHyQy2VWoIQkMg (big blind) showed [3c Kh] and won ($4.75) with a pair of Sixes
Seat 5: InmkdI6G8TzSj9NhcCSyPg folded before Flop (didn't bet)
Seat 6: vkoJRf3gidxY1pPi0AFWww mucked



PokerStars Game #59938623650:  Hold'em No Limit ($1/$2) - 2009/07/01 0:19:28 ET
Table 'bIihwBANJSFqlHPPtset+w' 9-max Seat #3 is the button
Seat 1: jI3JDUGV63ccqtKgM3vMbw ($159.70 in chips)
Seat 2: lQYT23h5QCUVZAKxjOO39Q ($118.90 in chips)
Seat 3: acnZ0LD5jxKgWIHz+mpQ8Q ($220.25 in chips)
Seat 4: 7WWX5PClBdr/U44gUKBIEA ($294.05 in chips)
Seat 5: rNejrG5tkeRBbL+UmC0iJA ($120 in chips)
Seat 6: 5iPk5MyO3KVu18Y8XCYfFQ ($86 in chips)
Seat 7: 3q2/0oJr3Mcy1W5tcN61ug ($206.35 in chips)
Seat 8: iMe5yhc+1BaiIPHet3NMrA ($278.65 in chips)
Seat 9: rW/MyplHylMSBRaoRUzWrg ($40 in chips)
7WWX5PClBdr/U44gUKBIEA: posts small blind $1
rNejrG5tkeRBbL+UmC0iJA: posts big blind $2
*** HOLE CARDS ***
5iPk5MyO3KVu18Y8XCYfFQ: folds
3q2/0oJr3Mcy1W5tcN61ug: folds
iMe5yhc+1BaiIPHet3NMrA: folds
rW/MyplHylMSBRaoRUzWrg: folds
jI3JDUGV63ccqtKgM3vMbw: folds
lQYT23h5QCUVZAKxjOO39Q: folds
acnZ0LD5jxKgWIHz+mpQ8Q: raises $4 to $6
7WWX5PClBdr/U44gUKBIEA: folds
rNejrG5tkeRBbL+UmC0iJA: calls $4
*** FLOP *** [Jh 6d Ah]
rNejrG5tkeRBbL+UmC0iJA: checks
acnZ0LD5jxKgWIHz+mpQ8Q: bets $8
rNejrG5tkeRBbL+UmC0iJA: raises $8 to $16
acnZ0LD5jxKgWIHz+mpQ8Q: raises $24 to $40
rNejrG5tkeRBbL+UmC0iJA: raises $74 to $114 and is all-in
acnZ0LD5jxKgWIHz+mpQ8Q: folds
rNejrG5tkeRBbL+UmC0iJA collected $90 from pot
*** SUMMARY ***
Total pot $93 | Rake $3
Board [Jh 6d Ah]
Seat 1: jI3JDUGV63ccqtKgM3vMbw folded before Flop (didn't bet)
Seat 2: lQYT23h5QCUVZAKxjOO39Q folded before Flop (didn't bet)
Seat 3: acnZ0LD5jxKgWIHz+mpQ8Q (button) folded on the Flop
Seat 4: 7WWX5PClBdr/U44gUKBIEA (small blind) folded before Flop
Seat 5: rNejrG5tkeRBbL+UmC0iJA (big blind) collected ($90)
Seat 6: 5iPk5MyO3KVu18Y8XCYfFQ folded before Flop (didn't bet)
Seat 7: 3q2/0oJr3Mcy1W5tcN61ug folded before Flop (didn't bet)
Seat 8: iMe5yhc+1BaiIPHet3NMrA folded before Flop (didn't bet)
Seat 9: rW/MyplHylMSBRaoRUzWrg folded before Flop (didn't bet)



PokerStars Game #59938624180:  Hold'em No Limit ($1/$2) - 2009/07/01 0:19:29 ET
Table 'eyAQSIlgc2o1Jxvbve4WGg' 9-max Seat #2 is the button
Seat 1: UZEsV9yKUMqmpYPiOFpaZw ($75 in chips)
Seat 2: g7gL2NLJCdZPPV399WKT1w ($50 in chips)
Seat 3: TAfo4veNRaRlzDXMMYS3Jg ($38 in chips)
Seat 4: miAHPEBdznuHNzK6YM3hRA ($106.20 in chips)
Seat 5: JnV3SM2D6dAFYyGZHHpvrg ($97 in chips)
Seat 6: IikcENBHwoT7snSvBPSc7Q ($178.60 in chips)
Seat 7: QHxJjpVYwitg9krW6wZgJA ($204.65 in chips)
Seat 8: 5iPk5MyO3KVu18Y8XCYfFQ ($40 in chips)
Seat 9: Hc2itIxwbi1lwa+DAYYQGg ($41.85 in chips)
TAfo4veNRaRlzDXMMYS3Jg: posts small blind $1
miAHPEBdznuHNzK6YM3hRA: posts big blind $2
UZEsV9yKUMqmpYPiOFpaZw: posts big blind $2
*** HOLE CARDS ***
JnV3SM2D6dAFYyGZHHpvrg: folds
IikcENBHwoT7snSvBPSc7Q: raises $6 to $8
QHxJjpVYwitg9krW6wZgJA: folds
5iPk5MyO3KVu18Y8XCYfFQ: folds
Hc2itIxwbi1lwa+DAYYQGg: folds
UZEsV9yKUMqmpYPiOFpaZw: folds
g7gL2NLJCdZPPV399WKT1w: folds
TAfo4veNRaRlzDXMMYS3Jg: folds
miAHPEBdznuHNzK6YM3hRA: calls $6
*** FLOP *** [6c 5s Tc]
miAHPEBdznuHNzK6YM3hRA: checks
IikcENBHwoT7snSvBPSc7Q: checks
*** TURN *** [6c 5s Tc] [9d]
miAHPEBdznuHNzK6YM3hRA: checks
IikcENBHwoT7snSvBPSc7Q: checks
*** RIVER *** [6c 5s Tc 9d] [8d]
miAHPEBdznuHNzK6YM3hRA: bets $10
IikcENBHwoT7snSvBPSc7Q: folds
miAHPEBdznuHNzK6YM3hRA collected $18.05 from pot
miAHPEBdznuHNzK6YM3hRA: shows [Jc Qc] (a straight, Eight to Queen)
*** SUMMARY ***
Total pot $19 | Rake $0.95
Board [6c 5s Tc 9d 8d]
Seat 1: UZEsV9yKUMqmpYPiOFpaZw folded before Flop
Seat 2: g7gL2NLJCdZPPV399WKT1w (button) folded before Flop (didn't bet)
Seat 3: TAfo4veNRaRlzDXMMYS3Jg (small blind) folded before Flop
Seat 4: miAHPEBdznuHNzK6YM3hRA (big blind) collected ($18.05)
Seat 5: JnV3SM2D6dAFYyGZHHpvrg folded before Flop (didn't bet)
Seat 6: IikcENBHwoT7snSvBPSc7Q folded on the River
Seat 7: QHxJjpVYwitg9krW6wZgJA folded before Flop (didn't bet)
Seat 8: 5iPk5MyO3KVu18Y8XCYfFQ folded before Flop (didn't bet)
Seat 9: Hc2itIxwbi1lwa+DAYYQGg folded before Flop (didn't bet)



PokerStars Game #59938624702:  Hold'em No Limit ($1/$2) - 2009/07/01 0:19:29 ET
Table 'XP2sRSup+aRuwzx3vDZsDg' 6-max Seat #3 is the button
Seat 1: o9jamqIi6sTTRSqudgboRA ($225.70 in chips)
Seat 3: X7GlkHF+lkbarCLuZ4Uf0w ($36 in chips)
Seat 5: 894kvCY4GHivBpqwizsecg ($117.75 in chips)
Seat 6: h7ppRQJTYBsHCbLMeW9T2g ($456.75 in chips)
JsC+WvfzqlxVs9G8/gSQAQ: is sitting out
894kvCY4GHivBpqwizsecg: posts small blind $1
h7ppRQJTYBsHCbLMeW9T2g: posts big blind $2
*** HOLE CARDS ***
JsC+WvfzqlxVs9G8/gSQAQ leaves the table
o9jamqIi6sTTRSqudgboRA: folds
X7GlkHF+lkbarCLuZ4Uf0w: folds
894kvCY4GHivBpqwizsecg: folds
h7ppRQJTYBsHCbLMeW9T2g collected $2 from pot
*** SUMMARY ***
Total pot $2 | Rake $0
Seat 1: o9jamqIi6sTTRSqudgboRA folded before Flop (didn't bet)
Seat 3: X7GlkHF+lkbarCLuZ4Uf0w (button) folded before Flop (didn't bet)
Seat 5: 894kvCY4GHivBpqwizsecg (small blind) folded before Flop
Seat 6: h7ppRQJTYBsHCbLMeW9T2g (big blind) collected ($2)



PokerStars Game #59938625734:  Hold'em No Limit ($1/$2) - 2009/07/01 0:19:31 ET
Table 'OZyw34U4j4WtFFWsEHZQgQ' 2-max Seat #1 is the button
Seat 1: pVqEzK9wXlRMECnb1Zg4Zw ($76.50 in chips)
Seat 2: rAtTyvrJ8f1LaUh2O5U4nA ($48.80 in chips)
pVqEzK9wXlRMECnb1Zg4Zw: posts small blind $1
rAtTyvrJ8f1LaUh2O5U4nA: posts big blind $2
*** HOLE CARDS ***
pVqEzK9wXlRMECnb1Zg4Zw: calls $1
rAtTyvrJ8f1LaUh2O5U4nA: checks
*** FLOP *** [Kh 4h Qs]
rAtTyvrJ8f1LaUh2O5U4nA: checks
pVqEzK9wXlRMECnb1Zg4Zw: bets $4
rAtTyvrJ8f1LaUh2O5U4nA: folds
pVqEzK9wXlRMECnb1Zg4Zw collected $3.80 from pot
pVqEzK9wXlRMECnb1Zg4Zw: doesn't show hand
*** SUMMARY ***
Total pot $4 | Rake $0.20
Board [Kh 4h Qs]
Seat 1: pVqEzK9wXlRMECnb1Zg4Zw (button) (small blind) collected ($3.80)
Seat 2: rAtTyvrJ8f1LaUh2O5U4nA (big blind) folded on the Flop



PokerStars Game #59938627830:  Hold'em No Limit ($1/$2) - 2009/07/01 0:19:34 ET
Table 'NmY84NAf9Mh0ckAckHnh5g' 2-max Seat #2 is the button
Seat 1: 6hvg964TSqZ3AL/0XK9aVQ ($627.65 in chips)
Seat 2: RwDoM55ZeQuI2ADyJhOb2Q ($194 in chips)
RwDoM55ZeQuI2ADyJhOb2Q: posts small blind $1
6hvg964TSqZ3AL/0XK9aVQ: posts big blind $2
*** HOLE CARDS ***
RwDoM55ZeQuI2ADyJhOb2Q: folds
6hvg964TSqZ3AL/0XK9aVQ collected $2 from pot
*** SUMMARY ***
Total pot $2 | Rake $0
Seat 1: 6hvg964TSqZ3AL/0XK9aVQ (big blind) collected ($2)
Seat 2: RwDoM55ZeQuI2ADyJhOb2Q (button) (small blind) folded before Flop



PokerStars Game #59938632714:  Hold'em No Limit ($1/$2) - 2009/07/01 0:19:41 ET
Table 'ZzSIe0zTCDv+n6hfbY5tTg' 6-max Seat #3 is the button
Seat 1: 8srN1dKQePlsv0GyTada+Q ($270.05 in chips)
Seat 2: B87ikIyZ/TzAVeXf38Ny0g ($200 in chips)
Seat 3: X7GlkHF+lkbarCLuZ4Uf0w ($37 in chips)
Seat 4: ky55L0pITYgYLeqFB9gP/Q ($175.40 in chips)
Seat 6: InmkdI6G8TzSj9NhcCSyPg ($200 in chips)
ky55L0pITYgYLeqFB9gP/Q: posts small blind $1
Q3uFdu6ztesjDFiqkagTRQ: is sitting out
InmkdI6G8TzSj9NhcCSyPg: posts big blind $2
*** HOLE CARDS ***
Q3uFdu6ztesjDFiqkagTRQ leaves the table
8srN1dKQePlsv0GyTada+Q: folds
B87ikIyZ/TzAVeXf38Ny0g: raises $4 to $6
X7GlkHF+lkbarCLuZ4Uf0w: folds
ky55L0pITYgYLeqFB9gP/Q: folds
InmkdI6G8TzSj9NhcCSyPg: folds
B87ikIyZ/TzAVeXf38Ny0g collected $5 from pot
B87ikIyZ/TzAVeXf38Ny0g: doesn't show hand
*** SUMMARY ***
Total pot $5 | Rake $0
Seat 1: 8srN1dKQePlsv0GyTada+Q folded before Flop (didn't bet)
Seat 2: B87ikIyZ/TzAVeXf38Ny0g collected ($5)
Seat 3: X7GlkHF+lkbarCLuZ4Uf0w (button) folded before Flop (didn't bet)
Seat 4: ky55L0pITYgYLeqFB9gP/Q (small blind) folded before Flop
Seat 6: InmkdI6G8TzSj9NhcCSyPg (big blind) folded before Flop



PokerStars Game #59938633698:  Hold'em No Limit ($1/$2) - 2009/07/01 0:19:42 ET
Table 'NmY84NAf9Mh0ckAckHnh5g' 2-max Seat #1 is the button
Seat 1: 6hvg964TSqZ3AL/0XK9aVQ ($628.65 in chips)
Seat 2: RwDoM55ZeQuI2ADyJhOb2Q ($193 in chips)
6hvg964TSqZ3AL/0XK9aVQ: posts small blind $1
RwDoM55ZeQuI2ADyJhOb2Q: posts big blind $2
*** HOLE CARDS ***
6hvg964TSqZ3AL/0XK9aVQ: calls $1
RwDoM55ZeQuI2ADyJhOb2Q: checks
*** FLOP *** [8s 7c 8c]
RwDoM55ZeQuI2ADyJhOb2Q: checks
6hvg964TSqZ3AL/0XK9aVQ: checks
*** TURN *** [8s 7c 8c] [2d]
RwDoM55ZeQuI2ADyJhOb2Q: checks
6hvg964TSqZ3AL/0XK9aVQ: checks
*** RIVER *** [8s 7c 8c 2d] [Qs]
RwDoM55ZeQuI2ADyJhOb2Q: checks
6hvg964TSqZ3AL/0XK9aVQ: bets $8
RwDoM55ZeQuI2ADyJhOb2Q: folds
6hvg964TSqZ3AL/0XK9aVQ collected $3.80 from pot
*** SUMMARY ***
Total pot $4 | Rake $0.20
Board [8s 7c 8c 2d Qs]
Seat 1: 6hvg964TSqZ3AL/0XK9aVQ (button) (small blind) collected ($3.80)
Seat 2: RwDoM55ZeQuI2ADyJhOb2Q (big blind) folded on the River



PokerStars Game #59938635130:  Hold'em No Limit ($1/$2) - 2009/07/01 0:19:44 ET
Table 'OZyw34U4j4WtFFWsEHZQgQ' 2-max Seat #2 is the button
Seat 1: pVqEzK9wXlRMECnb1Zg4Zw ($78.30 in chips)
Seat 2: rAtTyvrJ8f1LaUh2O5U4nA ($46.80 in chips)
rAtTyvrJ8f1LaUh2O5U4nA: posts small blind $1
pVqEzK9wXlRMECnb1Zg4Zw: posts big blind $2
*** HOLE CARDS ***
rAtTyvrJ8f1LaUh2O5U4nA: calls $1
pVqEzK9wXlRMECnb1Zg4Zw: checks
*** FLOP *** [5c 8c 3d]
pVqEzK9wXlRMECnb1Zg4Zw: bets $4
rAtTyvrJ8f1LaUh2O5U4nA: folds
pVqEzK9wXlRMECnb1Zg4Zw collected $3.80 from pot
pVqEzK9wXlRMECnb1Zg4Zw: doesn't show hand
*** SUMMARY ***
Total pot $4 | Rake $0.20
Board [5c 8c 3d]
Seat 1: pVqEzK9wXlRMECnb1Zg4Zw (big blind) collected ($3.80)
Seat 2: rAtTyvrJ8f1LaUh2O5U4nA (button) (small blind) folded on the Flop



PokerStars Game #59938635788:  Hold'em No Limit ($1/$2) - 2009/07/01 0:19:45 ET
Table 'gnHBqWll9O3fxG7Ojkz/ng' 9-max Seat #4 is the button
Seat 1: hpqdC/23wXosGOmzARr5NA ($147.05 in chips)
Seat 2: H6Z4+qu8gR0VUiPOijndVg ($200 in chips)
Seat 3: 5Q8U6iZbeO7xJSS4qvDP5g ($225.35 in chips)
Seat 4: n5XI5/7gN+gIubHFBH+mOw ($400.15 in chips)
Seat 5: rBQDMkKm9cZn6M9NPsiVew ($145 in chips)
Seat 6: 5iPk5MyO3KVu18Y8XCYfFQ ($58.45 in chips)
Seat 8: cM6efHzdxoqYm0EQKP4TTQ ($83.65 in chips)
Seat 9: kVCeGJ4NY7Fb0W74j1mAqA ($200 in chips)
rBQDMkKm9cZn6M9NPsiVew: posts small blind $1
5iPk5MyO3KVu18Y8XCYfFQ: posts big blind $2
jqui3xAWCkcdPW36a6BD+w: sits out
*** HOLE CARDS ***
cM6efHzdxoqYm0EQKP4TTQ: calls $2
kVCeGJ4NY7Fb0W74j1mAqA: folds
hpqdC/23wXosGOmzARr5NA: folds
H6Z4+qu8gR0VUiPOijndVg: folds
5Q8U6iZbeO7xJSS4qvDP5g: folds
n5XI5/7gN+gIubHFBH+mOw has timed out
n5XI5/7gN+gIubHFBH+mOw: folds
n5XI5/7gN+gIubHFBH+mOw is sitting out
rBQDMkKm9cZn6M9NPsiVew: calls $1
n5XI5/7gN+gIubHFBH+mOw has returned
5iPk5MyO3KVu18Y8XCYfFQ: checks
*** FLOP *** [8h 7s 7c]
rBQDMkKm9cZn6M9NPsiVew: checks
5iPk5MyO3KVu18Y8XCYfFQ: checks
cM6efHzdxoqYm0EQKP4TTQ: checks
*** TURN *** [8h 7s 7c] [4s]
rBQDMkKm9cZn6M9NPsiVew: bets $6
5iPk5MyO3KVu18Y8XCYfFQ: folds
cM6efHzdxoqYm0EQKP4TTQ: calls $6
*** RIVER *** [8h 7s 7c 4s] [Ad]
rBQDMkKm9cZn6M9NPsiVew: bets $10
cM6efHzdxoqYm0EQKP4TTQ: raises $10 to $20
rBQDMkKm9cZn6M9NPsiVew: calls $10
*** SHOW DOWN ***
cM6efHzdxoqYm0EQKP4TTQ: shows [8s 8c] (a full house, Eights full of Sevens)
rBQDMkKm9cZn6M9NPsiVew: mucks hand
cM6efHzdxoqYm0EQKP4TTQ collected $55.15 from pot
*** SUMMARY ***
Total pot $58 | Rake $2.85
Board [8h 7s 7c 4s Ad]
Seat 1: hpqdC/23wXosGOmzARr5NA folded before Flop (didn't bet)
Seat 2: H6Z4+qu8gR0VUiPOijndVg folded before Flop (didn't bet)
Seat 3: 5Q8U6iZbeO7xJSS4qvDP5g folded before Flop (didn't bet)
Seat 4: n5XI5/7gN+gIubHFBH+mOw (button) folded before Flop (didn't bet)
Seat 5: rBQDMkKm9cZn6M9NPsiVew (small blind) mucked
Seat 6: 5iPk5MyO3KVu18Y8XCYfFQ (big blind) folded on the Turn
Seat 8: cM6efHzdxoqYm0EQKP4TTQ showed [8s 8c] and won ($55.15) with a full house, Eights full of Sevens
Seat 9: kVCeGJ4NY7Fb0W74j1mAqA folded before Flop (didn't bet)



PokerStars Game #59938640258:  Hold'em No Limit ($1/$2) - 2009/07/01 0:19:52 ET
Table 'XP2sRSup+aRuwzx3vDZsDg' 6-max Seat #5 is the button
Seat 1: o9jamqIi6sTTRSqudgboRA ($225.70 in chips)
Seat 3: X7GlkHF+lkbarCLuZ4Uf0w ($36 in chips)
Seat 5: 894kvCY4GHivBpqwizsecg ($116.75 in chips)
Seat 6: h7ppRQJTYBsHCbLMeW9T2g ($457.75 in chips)
h7ppRQJTYBsHCbLMeW9T2g: posts small blind $1
o9jamqIi6sTTRSqudgboRA: posts big blind $2
*** HOLE CARDS ***
X7GlkHF+lkbarCLuZ4Uf0w: folds
894kvCY4GHivBpqwizsecg: calls $2
h7ppRQJTYBsHCbLMeW9T2g: calls $1
o9jamqIi6sTTRSqudgboRA: checks
*** FLOP *** [8h Ah 7s]
h7ppRQJTYBsHCbLMeW9T2g: checks
o9jamqIi6sTTRSqudgboRA: checks
894kvCY4GHivBpqwizsecg: checks
*** TURN *** [8h Ah 7s] [Qc]
h7ppRQJTYBsHCbLMeW9T2g: checks
o9jamqIi6sTTRSqudgboRA: checks
894kvCY4GHivBpqwizsecg: bets $4
h7ppRQJTYBsHCbLMeW9T2g: folds
o9jamqIi6sTTRSqudgboRA: folds
894kvCY4GHivBpqwizsecg collected $5.70 from pot
894kvCY4GHivBpqwizsecg: doesn't show hand
*** SUMMARY ***
Total pot $6 | Rake $0.30
Board [8h Ah 7s Qc]
Seat 1: o9jamqIi6sTTRSqudgboRA (big blind) folded on the Turn
Seat 3: X7GlkHF+lkbarCLuZ4Uf0w folded before Flop (didn't bet)
Seat 5: 894kvCY4GHivBpqwizsecg (button) collected ($5.70)
Seat 6: h7ppRQJTYBsHCbLMeW9T2g (small blind) folded on the Turn



PokerStars Game #59938640354:  Hold'em No Limit ($1/$2) - 2009/07/01 0:19:52 ET
Table 'LL4bDFyhj5hsMpzaDugJZg' 6-max Seat #3 is the button
Seat 1: IBW9lyGsaRmfcbyA/qFfEw ($57.20 in chips)
Seat 3: gGPaCoSWW1HoKYaqfAPecg ($207 in chips)
Seat 4: 8srN1dKQePlsv0GyTada+Q ($246.75 in chips)
Seat 6: /PH6Ffnho4Ysm8S3V/oa+w ($40 in chips)
8srN1dKQePlsv0GyTada+Q: posts small blind $1
/PH6Ffnho4Ysm8S3V/oa+w: posts big blind $2
*** HOLE CARDS ***
HgX0VeqE/dzSXd5BpntRBw leaves the table
IBW9lyGsaRmfcbyA/qFfEw: folds
gGPaCoSWW1HoKYaqfAPecg: folds
8srN1dKQePlsv0GyTada+Q: raises $4 to $6
/PH6Ffnho4Ysm8S3V/oa+w: folds
8srN1dKQePlsv0GyTada+Q collected $4 from pot
*** SUMMARY ***
Total pot $4 | Rake $0
Seat 1: IBW9lyGsaRmfcbyA/qFfEw folded before Flop (didn't bet)
Seat 3: gGPaCoSWW1HoKYaqfAPecg (button) folded before Flop (didn't bet)
Seat 4: 8srN1dKQePlsv0GyTada+Q (small blind) collected ($4)
Seat 6: /PH6Ffnho4Ysm8S3V/oa+w (big blind) folded before Flop



PokerStars Game #59938641014:  Hold'em No Limit ($1/$2) - 2009/07/01 0:19:53 ET
Table 'rKeCh+eBn4RNvybCUYkoTQ' 9-max Seat #2 is the button
Seat 1: De9g+AYjo0DN6C/+iT/nsg ($246.30 in chips)
Seat 2: oEFhmBFI/N1eUlbVXORRnw ($194.65 in chips)
Seat 3: R9FzbEg1XYsiOty4kvbqhg ($144.30 in chips)
Seat 4: x/sLO+9OHvhcHLxOgSmnOg ($58.75 in chips)
Seat 5: iuQs2eTwwwpiBYdCIQ/ogA ($165.45 in chips)
Seat 6: TAfo4veNRaRlzDXMMYS3Jg ($42 in chips)
Seat 7: U+Qo1rnyH4lm7ehksiWi7w ($61.20 in chips)
Seat 8: pN/Ip0ePsUVIdUlGgLrkUw ($217.40 in chips)
Seat 9: SZnYUzONNVlDaSCSt67hQA ($61.80 in chips)
R9FzbEg1XYsiOty4kvbqhg: posts small blind $1
x/sLO+9OHvhcHLxOgSmnOg: posts big blind $2
*** HOLE CARDS ***
iuQs2eTwwwpiBYdCIQ/ogA: folds
TAfo4veNRaRlzDXMMYS3Jg: folds
U+Qo1rnyH4lm7ehksiWi7w: folds
pN/Ip0ePsUVIdUlGgLrkUw: folds
SZnYUzONNVlDaSCSt67hQA: folds
De9g+AYjo0DN6C/+iT/nsg: folds
oEFhmBFI/N1eUlbVXORRnw: calls $2
R9FzbEg1XYsiOty4kvbqhg: calls $1
x/sLO+9OHvhcHLxOgSmnOg: raises $6 to $8
oEFhmBFI/N1eUlbVXORRnw: folds
R9FzbEg1XYsiOty4kvbqhg: folds
x/sLO+9OHvhcHLxOgSmnOg collected $6 from pot
x/sLO+9OHvhcHLxOgSmnOg: doesn't show hand
*** SUMMARY ***
Total pot $6 | Rake $0
Seat 1: De9g+AYjo0DN6C/+iT/nsg folded before Flop (didn't bet)
Seat 2: oEFhmBFI/N1eUlbVXORRnw (button) folded before Flop
Seat 3: R9FzbEg1XYsiOty4kvbqhg (small blind) folded before Flop
Seat 4: x/sLO+9OHvhcHLxOgSmnOg (big blind) collected ($6)
Seat 5: iuQs2eTwwwpiBYdCIQ/ogA folded before Flop (didn't bet)
Seat 6: TAfo4veNRaRlzDXMMYS3Jg folded before Flop (didn't bet)
Seat 7: U+Qo1rnyH4lm7ehksiWi7w folded before Flop (didn't bet)
Seat 8: pN/Ip0ePsUVIdUlGgLrkUw folded before Flop (didn't bet)
Seat 9: SZnYUzONNVlDaSCSt67hQA folded before Flop (didn't bet)



PokerStars Game #59938642342:  Hold'em No Limit ($1/$2) - 2009/07/01 0:19:55 ET
Table 'G1Oqdy4Pqdb5gtx40rUBzA' 6-max Seat #3 is the button
Seat 2: IzslX/oV8DoDQfxCV/3+kg ($476.15 in chips)
Seat 3: lE+RUsc9cdVV9eEi8uytew ($149.55 in chips)
Seat 4: B87ikIyZ/TzAVeXf38Ny0g ($200 in chips)
Seat 5: X7GlkHF+lkbarCLuZ4Uf0w ($78 in chips)
Seat 6: gGPaCoSWW1HoKYaqfAPecg ($200 in chips)
B87ikIyZ/TzAVeXf38Ny0g: posts small blind $1
X7GlkHF+lkbarCLuZ4Uf0w: posts big blind $2
bz8Aw6kfX2xUq2sOyZlUCQ: sits out
*** HOLE CARDS ***
gGPaCoSWW1HoKYaqfAPecg: raises $5 to $7
IzslX/oV8DoDQfxCV/3+kg: folds
lE+RUsc9cdVV9eEi8uytew: calls $7
B87ikIyZ/TzAVeXf38Ny0g: folds
X7GlkHF+lkbarCLuZ4Uf0w: folds
*** FLOP *** [6d 7h Td]
gGPaCoSWW1HoKYaqfAPecg: checks
lE+RUsc9cdVV9eEi8uytew: bets $8
gGPaCoSWW1HoKYaqfAPecg: folds
lE+RUsc9cdVV9eEi8uytew collected $16.15 from pot
*** SUMMARY ***
Total pot $17 | Rake $0.85
Board [6d 7h Td]
Seat 2: IzslX/oV8DoDQfxCV/3+kg folded before Flop (didn't bet)
Seat 3: lE+RUsc9cdVV9eEi8uytew (button) collected ($16.15)
Seat 4: B87ikIyZ/TzAVeXf38Ny0g (small blind) folded before Flop
Seat 5: X7GlkHF+lkbarCLuZ4Uf0w (big blind) folded before Flop
Seat 6: gGPaCoSWW1HoKYaqfAPecg folded on the Flop



PokerStars Game #59938642654:  Hold'em No Limit ($1/$2) - 2009/07/01 0:19:55 ET
Table 'WCA60bDA8ecovUgFSIZkTQ' 9-max Seat #7 is the button
Seat 1: CUZwDpLTQKhzarPe+JCLOQ ($211.75 in chips)
Seat 2: G1h8wamBcVJXtsKXZQ2EyA ($105.85 in chips)
Seat 3: 5iPk5MyO3KVu18Y8XCYfFQ ($40 in chips)
Seat 4: Q3uFdu6ztesjDFiqkagTRQ ($710.60 in chips)
Seat 5: Hc2itIxwbi1lwa+DAYYQGg ($300.30 in chips)
Seat 7: 2YpnxJiexJHyERfbqgwEcw ($55 in chips)
Seat 8: x+V1JgVDawsJTxKcxm7gxw ($89 in chips)
x+V1JgVDawsJTxKcxm7gxw: posts small blind $1
3q2/0oJr3Mcy1W5tcN61ug: is sitting out
CUZwDpLTQKhzarPe+JCLOQ: posts big blind $2
*** HOLE CARDS ***
G1h8wamBcVJXtsKXZQ2EyA: calls $2
3q2/0oJr3Mcy1W5tcN61ug leaves the table
DOWQSOJ7GaX+ksfWTqPT5A leaves the table
5iPk5MyO3KVu18Y8XCYfFQ: raises $10 to $12
Q3uFdu6ztesjDFiqkagTRQ: folds
Hc2itIxwbi1lwa+DAYYQGg: folds
2YpnxJiexJHyERfbqgwEcw: folds
x+V1JgVDawsJTxKcxm7gxw: folds
CUZwDpLTQKhzarPe+JCLOQ: folds
G1h8wamBcVJXtsKXZQ2EyA: folds
5iPk5MyO3KVu18Y8XCYfFQ collected $7 from pot
5iPk5MyO3KVu18Y8XCYfFQ: doesn't show hand
*** SUMMARY ***
Total pot $7 | Rake $0
Seat 1: CUZwDpLTQKhzarPe+JCLOQ (big blind) folded before Flop
Seat 2: G1h8wamBcVJXtsKXZQ2EyA folded before Flop
Seat 3: 5iPk5MyO3KVu18Y8XCYfFQ collected ($7)
Seat 4: Q3uFdu6ztesjDFiqkagTRQ folded before Flop (didn't bet)
Seat 5: Hc2itIxwbi1lwa+DAYYQGg folded before Flop (didn't bet)
Seat 7: 2YpnxJiexJHyERfbqgwEcw (button) folded before Flop (didn't bet)
Seat 8: x+V1JgVDawsJTxKcxm7gxw (small blind) folded before Flop



PokerStars Game #59938645220:  Hold'em No Limit ($1/$2) - 2009/07/01 0:19:59 ET
Table 'srul5UFZXTEccVV5fpY91g' 9-max Seat #7 is the button
Seat 1: lfD8cBv31A/pio3pXJbPjA ($157.20 in chips)
Seat 2: tJYod1SLp2AcWPL/3hZ7ug ($88.20 in chips)
Seat 3: weUZ8S7tgbaeIpzi1gBNxQ ($48.75 in chips)
Seat 4: GG5lTuGt3+kwNYSbqeB6yw ($104.40 in chips)
Seat 5: 5iPk5MyO3KVu18Y8XCYfFQ ($57.65 in chips)
Seat 6: TAfo4veNRaRlzDXMMYS3Jg ($33 in chips)
Seat 7: s0erZsDxbZSaEPheMgibKg ($456.10 in chips)
jRGC4KXXODbHEN275TXFCA will be allowed to play after the button
lfD8cBv31A/pio3pXJbPjA: posts small blind $1
tJYod1SLp2AcWPL/3hZ7ug: posts big blind $2
*** HOLE CARDS ***
weUZ8S7tgbaeIpzi1gBNxQ: folds
GG5lTuGt3+kwNYSbqeB6yw: folds
UZEsV9yKUMqmpYPiOFpaZw joins the table at seat #8
5iPk5MyO3KVu18Y8XCYfFQ: raises $2 to $4
TAfo4veNRaRlzDXMMYS3Jg: folds
s0erZsDxbZSaEPheMgibKg: folds
lfD8cBv31A/pio3pXJbPjA: calls $3
tJYod1SLp2AcWPL/3hZ7ug: calls $2
*** FLOP *** [4c Kc 7h]
lfD8cBv31A/pio3pXJbPjA: checks
tJYod1SLp2AcWPL/3hZ7ug: checks
5iPk5MyO3KVu18Y8XCYfFQ: bets $6
lfD8cBv31A/pio3pXJbPjA: folds
tJYod1SLp2AcWPL/3hZ7ug: calls $6
*** TURN *** [4c Kc 7h] [8s]
tJYod1SLp2AcWPL/3hZ7ug: checks
5iPk5MyO3KVu18Y8XCYfFQ: checks
*** RIVER *** [4c Kc 7h 8s] [2d]
tJYod1SLp2AcWPL/3hZ7ug: bets $10
5iPk5MyO3KVu18Y8XCYfFQ: calls $10
*** SHOW DOWN ***
tJYod1SLp2AcWPL/3hZ7ug: shows [Ah Th] (high card Ace)
5iPk5MyO3KVu18Y8XCYfFQ: shows [Qc Ad] (high card Ace - King+Queen kicker)
5iPk5MyO3KVu18Y8XCYfFQ collected $41.90 from pot
*** SUMMARY ***
Total pot $44 | Rake $2.10
Board [4c Kc 7h 8s 2d]
Seat 1: lfD8cBv31A/pio3pXJbPjA (small blind) folded on the Flop
Seat 2: tJYod1SLp2AcWPL/3hZ7ug (big blind) showed [Ah Th] and lost with high card Ace
Seat 3: weUZ8S7tgbaeIpzi1gBNxQ folded before Flop (didn't bet)
Seat 4: GG5lTuGt3+kwNYSbqeB6yw folded before Flop (didn't bet)
Seat 5: 5iPk5MyO3KVu18Y8XCYfFQ showed [Qc Ad] and won ($41.90) with high card Ace
Seat 6: TAfo4veNRaRlzDXMMYS3Jg folded before Flop (didn't bet)
Seat 7: s0erZsDxbZSaEPheMgibKg (button) folded before Flop (didn't bet)



PokerStars Game #59938645250:  Hold'em No Limit ($1/$2) - 2009/07/01 0:19:59 ET
Table 'on4i1U1lCRmxsduFD3xiSg' 9-max Seat #2 is the button
Seat 1: so5k3vFDmokh2q3dImJ1GQ ($115 in chips)
Seat 2: yZYrOeNDxQxkzpbgKX1bng ($71.20 in chips)
Seat 3: 5iPk5MyO3KVu18Y8XCYfFQ ($59.20 in chips)
Seat 4: Z3aYCZG/yXHYFjiWkGI5ug ($530.10 in chips)
Seat 5: QHxJjpVYwitg9krW6wZgJA ($203 in chips)
Seat 6: CUZwDpLTQKhzarPe+JCLOQ ($217.55 in chips)
Seat 7: xD4ElYxz6Ollzmam8BmMCw ($197 in chips)
Seat 8: cdC54j9fGGojcbzWB5PgzA ($200 in chips)
Seat 9: iMe5yhc+1BaiIPHet3NMrA ($200 in chips)
5iPk5MyO3KVu18Y8XCYfFQ: posts small blind $1
Z3aYCZG/yXHYFjiWkGI5ug: posts big blind $2
*** HOLE CARDS ***
QHxJjpVYwitg9krW6wZgJA: folds
CUZwDpLTQKhzarPe+JCLOQ: folds
xD4ElYxz6Ollzmam8BmMCw: calls $2
cdC54j9fGGojcbzWB5PgzA: folds
iMe5yhc+1BaiIPHet3NMrA: folds
so5k3vFDmokh2q3dImJ1GQ: folds
yZYrOeNDxQxkzpbgKX1bng: calls $2
5iPk5MyO3KVu18Y8XCYfFQ: folds
Z3aYCZG/yXHYFjiWkGI5ug: checks
*** FLOP *** [6d 9s 3s]
Z3aYCZG/yXHYFjiWkGI5ug: checks
xD4ElYxz6Ollzmam8BmMCw: checks
yZYrOeNDxQxkzpbgKX1bng: checks
*** TURN *** [6d 9s 3s] [Th]
Z3aYCZG/yXHYFjiWkGI5ug: checks
xD4ElYxz6Ollzmam8BmMCw: bets $4
yZYrOeNDxQxkzpbgKX1bng: calls $4
Z3aYCZG/yXHYFjiWkGI5ug: folds
*** RIVER *** [6d 9s 3s Th] [Jd]
xD4ElYxz6Ollzmam8BmMCw: checks
yZYrOeNDxQxkzpbgKX1bng: checks
*** SHOW DOWN ***
xD4ElYxz6Ollzmam8BmMCw: shows [Qh 7h] (high card Queen)
yZYrOeNDxQxkzpbgKX1bng: shows [7c Tc] (a pair of Tens)
yZYrOeNDxQxkzpbgKX1bng collected $14.30 from pot
*** SUMMARY ***
Total pot $15 | Rake $0.70
Board [6d 9s 3s Th Jd]
Seat 1: so5k3vFDmokh2q3dImJ1GQ folded before Flop (didn't bet)
Seat 2: yZYrOeNDxQxkzpbgKX1bng (button) showed [7c Tc] and won ($14.30) with a pair of Tens
Seat 3: 5iPk5MyO3KVu18Y8XCYfFQ (small blind) folded before Flop
Seat 4: Z3aYCZG/yXHYFjiWkGI5ug (big blind) folded on the Turn
Seat 5: QHxJjpVYwitg9krW6wZgJA folded before Flop (didn't bet)
Seat 6: CUZwDpLTQKhzarPe+JCLOQ folded before Flop (didn't bet)
Seat 7: xD4ElYxz6Ollzmam8BmMCw showed [Qh 7h] and lost with high card Queen
Seat 8: cdC54j9fGGojcbzWB5PgzA folded before Flop (didn't bet)
Seat 9: iMe5yhc+1BaiIPHet3NMrA folded before Flop (didn't bet)



PokerStars Game #59938645722:  Hold'em No Limit ($1/$2) - 2009/07/01 0:20:00 ET
Table 'mGpP9StWRnoeiBDExc6Frg' 6-max Seat #6 is the button
Seat 1: zWFU82nxIRvzK4mKiL4m0Q ($63.05 in chips)
Seat 2: DQlskgG4OtLpF2MVxLwf4A ($309.85 in chips)
Seat 3: 3HrFUl+TAqSP1U00zz3P7A ($76.60 in chips)
Seat 4: qXDd0ZyMIse0OBu8pxeQ3Q ($215 in chips)
Seat 5: d1puGuVBE0fidn+5eRJ0tw ($167.70 in chips)
Seat 6: X7GlkHF+lkbarCLuZ4Uf0w ($23.45 in chips)
zWFU82nxIRvzK4mKiL4m0Q: posts small blind $1
DQlskgG4OtLpF2MVxLwf4A: posts big blind $2
*** HOLE CARDS ***
3HrFUl+TAqSP1U00zz3P7A: folds
qXDd0ZyMIse0OBu8pxeQ3Q: folds
d1puGuVBE0fidn+5eRJ0tw: folds
X7GlkHF+lkbarCLuZ4Uf0w: folds
zWFU82nxIRvzK4mKiL4m0Q: calls $1
DQlskgG4OtLpF2MVxLwf4A: checks
*** FLOP *** [Kh Ts 9h]
zWFU82nxIRvzK4mKiL4m0Q: checks
DQlskgG4OtLpF2MVxLwf4A: checks
*** TURN *** [Kh Ts 9h] [3h]
zWFU82nxIRvzK4mKiL4m0Q: checks
DQlskgG4OtLpF2MVxLwf4A: checks
*** RIVER *** [Kh Ts 9h 3h] [7h]
zWFU82nxIRvzK4mKiL4m0Q: checks
DQlskgG4OtLpF2MVxLwf4A: checks
*** SHOW DOWN ***
zWFU82nxIRvzK4mKiL4m0Q: shows [5d 7d] (a pair of Sevens)
DQlskgG4OtLpF2MVxLwf4A: mucks hand
zWFU82nxIRvzK4mKiL4m0Q collected $3.80 from pot
*** SUMMARY ***
Total pot $4 | Rake $0.20
Board [Kh Ts 9h 3h 7h]
Seat 1: zWFU82nxIRvzK4mKiL4m0Q (small blind) showed [5d 7d] and won ($3.80) with a pair of Sevens
Seat 2: DQlskgG4OtLpF2MVxLwf4A (big blind) mucked
Seat 3: 3HrFUl+TAqSP1U00zz3P7A folded before Flop (didn't bet)
Seat 4: qXDd0ZyMIse0OBu8pxeQ3Q folded before Flop (didn't bet)
Seat 5: d1puGuVBE0fidn+5eRJ0tw folded before Flop (didn't bet)
Seat 6: X7GlkHF+lkbarCLuZ4Uf0w (button) folded before Flop (didn't bet)



PokerStars Game #59938646826:  Hold'em No Limit ($1/$2) - 2009/07/01 0:20:01 ET
Table 'jlrIxbrVIG+gjaUYT4za8g' 6-max Seat #3 is the button
Seat 1: ygTTt5ehT4aF86q1a8/R+w ($193.05 in chips)
Seat 2: N18PrNGQj43J7TJuQuu+tw ($127.45 in chips)
Seat 3: 54yWzRRgS0oZ+S6LwZBxMQ ($37.80 in chips)
Seat 4: 8srN1dKQePlsv0GyTada+Q ($223 in chips)
Seat 5: VuZb/hkEc4X7s93w2ZZTpA ($200 in chips)
Seat 6: vkfxu8f/jMYKUk6Ly4eujw ($282.95 in chips)
8srN1dKQePlsv0GyTada+Q: posts small blind $1
VuZb/hkEc4X7s93w2ZZTpA: posts big blind $2
*** HOLE CARDS ***
vkfxu8f/jMYKUk6Ly4eujw: folds
ygTTt5ehT4aF86q1a8/R+w: folds
N18PrNGQj43J7TJuQuu+tw: calls $2
54yWzRRgS0oZ+S6LwZBxMQ: folds
8srN1dKQePlsv0GyTada+Q: calls $1
VuZb/hkEc4X7s93w2ZZTpA: checks
*** FLOP *** [5c 2s Qc]
8srN1dKQePlsv0GyTada+Q: checks
VuZb/hkEc4X7s93w2ZZTpA: checks
N18PrNGQj43J7TJuQuu+tw: bets $8
8srN1dKQePlsv0GyTada+Q: folds
VuZb/hkEc4X7s93w2ZZTpA: folds
N18PrNGQj43J7TJuQuu+tw collected $5.70 from pot
*** SUMMARY ***
Total pot $6 | Rake $0.30
Board [5c 2s Qc]
Seat 1: ygTTt5ehT4aF86q1a8/R+w folded before Flop (didn't bet)
Seat 2: N18PrNGQj43J7TJuQuu+tw collected ($5.70)
Seat 3: 54yWzRRgS0oZ+S6LwZBxMQ (button) folded before Flop (didn't bet)
Seat 4: 8srN1dKQePlsv0GyTada+Q (small blind) folded on the Flop
Seat 5: VuZb/hkEc4X7s93w2ZZTpA (big blind) folded on the Flop
Seat 6: vkfxu8f/jMYKUk6Ly4eujw folded before Flop (didn't bet)



PokerStars Game #59938646492:  Hold'em No Limit ($1/$2) - 2009/07/01 0:20:01 ET
Table 'OZyw34U4j4WtFFWsEHZQgQ' 2-max Seat #1 is the button
Seat 1: pVqEzK9wXlRMECnb1Zg4Zw ($80.10 in chips)
Seat 2: rAtTyvrJ8f1LaUh2O5U4nA ($44.80 in chips)
pVqEzK9wXlRMECnb1Zg4Zw: posts small blind $1
rAtTyvrJ8f1LaUh2O5U4nA: posts big blind $2
*** HOLE CARDS ***
pVqEzK9wXlRMECnb1Zg4Zw: calls $1
rAtTyvrJ8f1LaUh2O5U4nA: checks
*** FLOP *** [Kd 4d 4h]
rAtTyvrJ8f1LaUh2O5U4nA: bets $2
pVqEzK9wXlRMECnb1Zg4Zw: folds
rAtTyvrJ8f1LaUh2O5U4nA collected $3.80 from pot
rAtTyvrJ8f1LaUh2O5U4nA: doesn't show hand
*** SUMMARY ***
Total pot $4 | Rake $0.20
Board [Kd 4d 4h]
Seat 1: pVqEzK9wXlRMECnb1Zg4Zw (button) (small blind) folded on the Flop
Seat 2: rAtTyvrJ8f1LaUh2O5U4nA (big blind) collected ($3.80)



PokerStars Game #59938650394:  Hold'em No Limit ($1/$2) - 2009/07/01 0:20:06 ET
Table 'NmY84NAf9Mh0ckAckHnh5g' 2-max Seat #2 is the button
Seat 1: 6hvg964TSqZ3AL/0XK9aVQ ($630.45 in chips)
Seat 2: RwDoM55ZeQuI2ADyJhOb2Q ($191 in chips)
RwDoM55ZeQuI2ADyJhOb2Q: posts small blind $1
6hvg964TSqZ3AL/0XK9aVQ: posts big blind $2
*** HOLE CARDS ***
RwDoM55ZeQuI2ADyJhOb2Q: raises $4 to $6
6hvg964TSqZ3AL/0XK9aVQ: calls $4
*** FLOP *** [3d 5s Qc]
6hvg964TSqZ3AL/0XK9aVQ: checks
RwDoM55ZeQuI2ADyJhOb2Q: bets $8
6hvg964TSqZ3AL/0XK9aVQ: calls $8
*** TURN *** [3d 5s Qc] [9d]
6hvg964TSqZ3AL/0XK9aVQ: checks
RwDoM55ZeQuI2ADyJhOb2Q: bets $22
6hvg964TSqZ3AL/0XK9aVQ: folds
RwDoM55ZeQuI2ADyJhOb2Q collected $27.50 from pot
RwDoM55ZeQuI2ADyJhOb2Q: doesn't show hand
*** SUMMARY ***
Total pot $28 | Rake $0.50
Board [3d 5s Qc 9d]
Seat 1: 6hvg964TSqZ3AL/0XK9aVQ (big blind) folded on the Turn
Seat 2: RwDoM55ZeQuI2ADyJhOb2Q (button) (small blind) collected ($27.50)



PokerStars Game #59938650190:  Hold'em No Limit ($1/$2) - 2009/07/01 0:20:06 ET
Table 'W9UeSV0aoPjh5SFSxM8jUQ' 9-max Seat #4 is the button
Seat 1: cdC54j9fGGojcbzWB5PgzA ($204.60 in chips)
Seat 2: iMe5yhc+1BaiIPHet3NMrA ($316.75 in chips)
Seat 3: TAfo4veNRaRlzDXMMYS3Jg ($37 in chips)
Seat 4: De9g+AYjo0DN6C/+iT/nsg ($194 in chips)
Seat 5: CUZwDpLTQKhzarPe+JCLOQ ($200 in chips)
Seat 6: MXxB6weBWzZyAhRZb+/KVg ($196 in chips)
Seat 7: 4Cl43Q1TYQL8wn1NSCUkaw ($44.60 in chips)
Seat 8: z89zAYE4dlPgjkofBKII0Q ($46.55 in chips)
Seat 9: U2A5Hv6ib/5+gzO2wr7Z4w ($203 in chips)
CUZwDpLTQKhzarPe+JCLOQ: posts small blind $1
MXxB6weBWzZyAhRZb+/KVg: posts big blind $2
*** HOLE CARDS ***
4Cl43Q1TYQL8wn1NSCUkaw: folds
z89zAYE4dlPgjkofBKII0Q: calls $2
U2A5Hv6ib/5+gzO2wr7Z4w: folds
cdC54j9fGGojcbzWB5PgzA: folds
iMe5yhc+1BaiIPHet3NMrA: folds
TAfo4veNRaRlzDXMMYS3Jg: folds
De9g+AYjo0DN6C/+iT/nsg: raises $8 to $10
CUZwDpLTQKhzarPe+JCLOQ: calls $9
MXxB6weBWzZyAhRZb+/KVg: folds
z89zAYE4dlPgjkofBKII0Q: calls $8
*** FLOP *** [3c 6h Qd]
CUZwDpLTQKhzarPe+JCLOQ: checks
z89zAYE4dlPgjkofBKII0Q: checks
De9g+AYjo0DN6C/+iT/nsg: bets $24
CUZwDpLTQKhzarPe+JCLOQ: calls $24
z89zAYE4dlPgjkofBKII0Q: raises $12.55 to $36.55 and is all-in
De9g+AYjo0DN6C/+iT/nsg: calls $12.55
CUZwDpLTQKhzarPe+JCLOQ: calls $12.55
*** TURN *** [3c 6h Qd] [4c]
CUZwDpLTQKhzarPe+JCLOQ: checks
De9g+AYjo0DN6C/+iT/nsg: checks
*** RIVER *** [3c 6h Qd 4c] [2h]
CUZwDpLTQKhzarPe+JCLOQ: checks
De9g+AYjo0DN6C/+iT/nsg: checks
*** SHOW DOWN ***
CUZwDpLTQKhzarPe+JCLOQ: shows [8c 8h] (a pair of Eights)
z89zAYE4dlPgjkofBKII0Q: shows [Jc Qc] (a pair of Queens)
De9g+AYjo0DN6C/+iT/nsg: shows [Kd Kc] (a pair of Kings)
De9g+AYjo0DN6C/+iT/nsg collected $138.65 from pot
*** SUMMARY ***
Total pot $141.65 | Rake $3
Board [3c 6h Qd 4c 2h]
Seat 1: cdC54j9fGGojcbzWB5PgzA folded before Flop (didn't bet)
Seat 2: iMe5yhc+1BaiIPHet3NMrA folded before Flop (didn't bet)
Seat 3: TAfo4veNRaRlzDXMMYS3Jg folded before Flop (didn't bet)
Seat 4: De9g+AYjo0DN6C/+iT/nsg (button) showed [Kd Kc] and won ($138.65) with a pair of Kings
Seat 5: CUZwDpLTQKhzarPe+JCLOQ (small blind) showed [8c 8h] and lost with a pair of Eights
Seat 6: MXxB6weBWzZyAhRZb+/KVg (big blind) folded before Flop
Seat 7: 4Cl43Q1TYQL8wn1NSCUkaw folded before Flop (didn't bet)
Seat 8: z89zAYE4dlPgjkofBKII0Q showed [Jc Qc] and lost with a pair of Queens
Seat 9: U2A5Hv6ib/5+gzO2wr7Z4w folded before Flop (didn't bet)



PokerStars Game #59938656132:  Hold'em No Limit ($1/$2) - 2009/07/01 0:20:15 ET
Table 'OZyw34U4j4WtFFWsEHZQgQ' 2-max Seat #2 is the button
Seat 1: pVqEzK9wXlRMECnb1Zg4Zw ($78.10 in chips)
Seat 2: rAtTyvrJ8f1LaUh2O5U4nA ($46.60 in chips)
rAtTyvrJ8f1LaUh2O5U4nA: posts small blind $1
pVqEzK9wXlRMECnb1Zg4Zw: posts big blind $2
*** HOLE CARDS ***
rAtTyvrJ8f1LaUh2O5U4nA: raises $3 to $5
pVqEzK9wXlRMECnb1Zg4Zw: calls $3
*** FLOP *** [Qd Jh Td]
pVqEzK9wXlRMECnb1Zg4Zw: checks
rAtTyvrJ8f1LaUh2O5U4nA: checks
*** TURN *** [Qd Jh Td] [3d]
pVqEzK9wXlRMECnb1Zg4Zw: bets $10
rAtTyvrJ8f1LaUh2O5U4nA: folds
pVqEzK9wXlRMECnb1Zg4Zw collected $9.50 from pot
pVqEzK9wXlRMECnb1Zg4Zw: doesn't show hand
*** SUMMARY ***
Total pot $10 | Rake $0.50
Board [Qd Jh Td 3d]
Seat 1: pVqEzK9wXlRMECnb1Zg4Zw (big blind) collected ($9.50)
Seat 2: rAtTyvrJ8f1LaUh2O5U4nA (button) (small blind) folded on the Turn



PokerStars Game #59938660826:  Hold'em No Limit ($1/$2) - 2009/07/01 0:20:22 ET
Table 'aSf77Sj8QEnzcc0WaxVD4Q' 6-max Seat #3 is the button
Seat 2: vkfxu8f/jMYKUk6Ly4eujw ($256.15 in chips)
Seat 3: 9dpyyjDTCed6nV7JhaUUpw ($200 in chips)
Seat 4: 513FcCI8jHyQy2VWoIQkMg ($202.75 in chips)
Seat 5: InmkdI6G8TzSj9NhcCSyPg ($250 in chips)
Seat 6: vkoJRf3gidxY1pPi0AFWww ($298.40 in chips)
513FcCI8jHyQy2VWoIQkMg: posts small blind $1
InmkdI6G8TzSj9NhcCSyPg: posts big blind $2
54yWzRRgS0oZ+S6LwZBxMQ: sits out
*** HOLE CARDS ***
vkoJRf3gidxY1pPi0AFWww: calls $2
vkfxu8f/jMYKUk6Ly4eujw: folds
9dpyyjDTCed6nV7JhaUUpw: folds
513FcCI8jHyQy2VWoIQkMg: folds
InmkdI6G8TzSj9NhcCSyPg: checks
*** FLOP *** [Kd Ks 8h]
InmkdI6G8TzSj9NhcCSyPg: checks
vkoJRf3gidxY1pPi0AFWww: checks
*** TURN *** [Kd Ks 8h] [4s]
InmkdI6G8TzSj9NhcCSyPg: checks
vkoJRf3gidxY1pPi0AFWww: checks
*** RIVER *** [Kd Ks 8h 4s] [6d]
InmkdI6G8TzSj9NhcCSyPg: checks
vkoJRf3gidxY1pPi0AFWww: bets $4
InmkdI6G8TzSj9NhcCSyPg: folds
vkoJRf3gidxY1pPi0AFWww collected $4.75 from pot
vkoJRf3gidxY1pPi0AFWww: doesn't show hand
*** SUMMARY ***
Total pot $5 | Rake $0.25
Board [Kd Ks 8h 4s 6d]
Seat 2: vkfxu8f/jMYKUk6Ly4eujw folded before Flop (didn't bet)
Seat 3: 9dpyyjDTCed6nV7JhaUUpw (button) folded before Flop (didn't bet)
Seat 4: 513FcCI8jHyQy2VWoIQkMg (small blind) folded before Flop
Seat 5: InmkdI6G8TzSj9NhcCSyPg (big blind) folded on the River
Seat 6: vkoJRf3gidxY1pPi0AFWww collected ($4.75)



PokerStars Game #59938661532:  Hold'em No Limit ($1/$2) - 2009/07/01 0:20:23 ET
Table 'WCA60bDA8ecovUgFSIZkTQ' 9-max Seat #8 is the button
Seat 1: CUZwDpLTQKhzarPe+JCLOQ ($209.75 in chips)
Seat 2: G1h8wamBcVJXtsKXZQ2EyA ($103.85 in chips)
Seat 3: 5iPk5MyO3KVu18Y8XCYfFQ ($45 in chips)
Seat 4: Q3uFdu6ztesjDFiqkagTRQ ($710.60 in chips)
Seat 5: Hc2itIxwbi1lwa+DAYYQGg ($300.30 in chips)
Seat 7: 2YpnxJiexJHyERfbqgwEcw ($55 in chips)
Seat 8: x+V1JgVDawsJTxKcxm7gxw ($88 in chips)
CUZwDpLTQKhzarPe+JCLOQ: posts small blind $1
G1h8wamBcVJXtsKXZQ2EyA: posts big blind $2
*** HOLE CARDS ***
5iPk5MyO3KVu18Y8XCYfFQ: folds
Q3uFdu6ztesjDFiqkagTRQ: folds
Hc2itIxwbi1lwa+DAYYQGg: folds
2YpnxJiexJHyERfbqgwEcw: folds
x+V1JgVDawsJTxKcxm7gxw: folds
CUZwDpLTQKhzarPe+JCLOQ: folds
G1h8wamBcVJXtsKXZQ2EyA collected $2 from pot
*** SUMMARY ***
Total pot $2 | Rake $0
Seat 1: CUZwDpLTQKhzarPe+JCLOQ (small blind) folded before Flop
Seat 2: G1h8wamBcVJXtsKXZQ2EyA (big blind) collected ($2)
Seat 3: 5iPk5MyO3KVu18Y8XCYfFQ folded before Flop (didn't bet)
Seat 4: Q3uFdu6ztesjDFiqkagTRQ folded before Flop (didn't bet)
Seat 5: Hc2itIxwbi1lwa+DAYYQGg folded before Flop (didn't bet)
Seat 7: 2YpnxJiexJHyERfbqgwEcw folded before Flop (didn't bet)
Seat 8: x+V1JgVDawsJTxKcxm7gxw (button) folded before Flop (didn't bet)



PokerStars Game #59938662316:  Hold'em No Limit ($1/$2) - 2009/07/01 0:20:24 ET
Table 'LL4bDFyhj5hsMpzaDugJZg' 6-max Seat #4 is the button
Seat 1: IBW9lyGsaRmfcbyA/qFfEw ($57.20 in chips)
Seat 3: gGPaCoSWW1HoKYaqfAPecg ($207 in chips)
Seat 4: 8srN1dKQePlsv0GyTada+Q ($248.75 in chips)
Seat 6: /PH6Ffnho4Ysm8S3V/oa+w ($40 in chips)
/PH6Ffnho4Ysm8S3V/oa+w: posts small blind $1
IBW9lyGsaRmfcbyA/qFfEw: posts big blind $2
*** HOLE CARDS ***
gGPaCoSWW1HoKYaqfAPecg: folds
8srN1dKQePlsv0GyTada+Q: raises $4 to $6
/PH6Ffnho4Ysm8S3V/oa+w: folds
IBW9lyGsaRmfcbyA/qFfEw: folds
8srN1dKQePlsv0GyTada+Q collected $5 from pot
*** SUMMARY ***
Total pot $5 | Rake $0
Seat 1: IBW9lyGsaRmfcbyA/qFfEw (big blind) folded before Flop
Seat 3: gGPaCoSWW1HoKYaqfAPecg folded before Flop (didn't bet)
Seat 4: 8srN1dKQePlsv0GyTada+Q (button) collected ($5)
Seat 6: /PH6Ffnho4Ysm8S3V/oa+w (small blind) folded before Flop



PokerStars Game #59938663250:  Hold'em No Limit ($1/$2) - 2009/07/01 0:20:25 ET
Table '3FGoiEOffWrbgTfsB3t7FA' 2-max Seat #2 is the button
Seat 1: e0oDWyrmgLpR6bROEqw1nQ ($399.50 in chips)
Seat 2: +sy/nlNI20yZraIjs4AALg ($197.65 in chips)
+sy/nlNI20yZraIjs4AALg: posts small blind $1
e0oDWyrmgLpR6bROEqw1nQ: posts big blind $2
*** HOLE CARDS ***
+sy/nlNI20yZraIjs4AALg: folds
e0oDWyrmgLpR6bROEqw1nQ collected $2 from pot
*** SUMMARY ***
Total pot $2 | Rake $0
Seat 1: e0oDWyrmgLpR6bROEqw1nQ (big blind) collected ($2)
Seat 2: +sy/nlNI20yZraIjs4AALg (button) (small blind) folded before Flop



PokerStars Game #59938664016:  Hold'em No Limit ($1/$2) - 2009/07/01 0:20:26 ET
Table 'qVXak+oTeDXMGbWa4sDU5Q' 9-max Seat #3 is the button
Seat 1: H6Z4+qu8gR0VUiPOijndVg ($257.30 in chips)
Seat 2: Hc2itIxwbi1lwa+DAYYQGg ($46 in chips)
Seat 3: oz9eCXGC7DdjQlL/nuWj1A ($117.65 in chips)
Seat 5: NqKRc5xvcye0d7F6VOF6MQ ($160.50 in chips)
Seat 7: 5iPk5MyO3KVu18Y8XCYfFQ ($109 in chips)
Seat 8: 9pHZMviI9R8injxojGTnvw ($38.80 in chips)
Seat 9: ZP45Tu5Zqo4v+ZgqIQVoOQ ($197 in chips)
lQYT23h5QCUVZAKxjOO39Q will be allowed to play after the button
NqKRc5xvcye0d7F6VOF6MQ: posts small blind $1
Q3uFdu6ztesjDFiqkagTRQ: is sitting out
5iPk5MyO3KVu18Y8XCYfFQ: posts big blind $2
*** HOLE CARDS ***
9pHZMviI9R8injxojGTnvw: calls $2
ZP45Tu5Zqo4v+ZgqIQVoOQ: folds
H6Z4+qu8gR0VUiPOijndVg: folds
Hc2itIxwbi1lwa+DAYYQGg: folds
oz9eCXGC7DdjQlL/nuWj1A: folds
NqKRc5xvcye0d7F6VOF6MQ: calls $1
5iPk5MyO3KVu18Y8XCYfFQ: checks
*** FLOP *** [Ks Kh Ad]
NqKRc5xvcye0d7F6VOF6MQ: bets $6
5iPk5MyO3KVu18Y8XCYfFQ: folds
9pHZMviI9R8injxojGTnvw: calls $6
*** TURN *** [Ks Kh Ad] [7d]
NqKRc5xvcye0d7F6VOF6MQ: bets $30
9pHZMviI9R8injxojGTnvw: folds
NqKRc5xvcye0d7F6VOF6MQ collected $17.15 from pot
NqKRc5xvcye0d7F6VOF6MQ: doesn't show hand
*** SUMMARY ***
Total pot $18 | Rake $0.85
Board [Ks Kh Ad 7d]
Seat 1: H6Z4+qu8gR0VUiPOijndVg folded before Flop (didn't bet)
Seat 2: Hc2itIxwbi1lwa+DAYYQGg folded before Flop (didn't bet)
Seat 3: oz9eCXGC7DdjQlL/nuWj1A (button) folded before Flop (didn't bet)
Seat 5: NqKRc5xvcye0d7F6VOF6MQ (small blind) collected ($17.15)
Seat 7: 5iPk5MyO3KVu18Y8XCYfFQ (big blind) folded on the Flop
Seat 8: 9pHZMviI9R8injxojGTnvw folded on the Turn
Seat 9: ZP45Tu5Zqo4v+ZgqIQVoOQ folded before Flop (didn't bet)



PokerStars Game #59938663592:  Hold'em No Limit ($1/$2) - 2009/07/01 0:20:26 ET
Table 'eyAQSIlgc2o1Jxvbve4WGg' 9-max Seat #3 is the button
Seat 1: UZEsV9yKUMqmpYPiOFpaZw ($73 in chips)
Seat 2: g7gL2NLJCdZPPV399WKT1w ($50 in chips)
Seat 3: TAfo4veNRaRlzDXMMYS3Jg ($37 in chips)
Seat 4: miAHPEBdznuHNzK6YM3hRA ($116.25 in chips)
Seat 5: JnV3SM2D6dAFYyGZHHpvrg ($97 in chips)
Seat 6: IikcENBHwoT7snSvBPSc7Q ($170.60 in chips)
Seat 7: QHxJjpVYwitg9krW6wZgJA ($204.65 in chips)
Seat 8: 5iPk5MyO3KVu18Y8XCYfFQ ($40 in chips)
Seat 9: Hc2itIxwbi1lwa+DAYYQGg ($41.85 in chips)
miAHPEBdznuHNzK6YM3hRA: posts small blind $1
JnV3SM2D6dAFYyGZHHpvrg: posts big blind $2
*** HOLE CARDS ***
IikcENBHwoT7snSvBPSc7Q: folds
QHxJjpVYwitg9krW6wZgJA: folds
5iPk5MyO3KVu18Y8XCYfFQ: folds
Hc2itIxwbi1lwa+DAYYQGg: folds
UZEsV9yKUMqmpYPiOFpaZw: folds
g7gL2NLJCdZPPV399WKT1w: calls $2
TAfo4veNRaRlzDXMMYS3Jg: folds
miAHPEBdznuHNzK6YM3hRA: calls $1
JnV3SM2D6dAFYyGZHHpvrg: checks
*** FLOP *** [2s Ac 9c]
miAHPEBdznuHNzK6YM3hRA: bets $12
JnV3SM2D6dAFYyGZHHpvrg: folds
g7gL2NLJCdZPPV399WKT1w: folds
miAHPEBdznuHNzK6YM3hRA collected $5.70 from pot
*** SUMMARY ***
Total pot $6 | Rake $0.30
Board [2s Ac 9c]
Seat 1: UZEsV9yKUMqmpYPiOFpaZw folded before Flop (didn't bet)
Seat 2: g7gL2NLJCdZPPV399WKT1w folded on the Flop
Seat 3: TAfo4veNRaRlzDXMMYS3Jg (button) folded before Flop (didn't bet)
Seat 4: miAHPEBdznuHNzK6YM3hRA (small blind) collected ($5.70)
Seat 5: JnV3SM2D6dAFYyGZHHpvrg (big blind) folded on the Flop
Seat 6: IikcENBHwoT7snSvBPSc7Q folded before Flop (didn't bet)
Seat 7: QHxJjpVYwitg9krW6wZgJA folded before Flop (didn't bet)
Seat 8: 5iPk5MyO3KVu18Y8XCYfFQ folded before Flop (didn't bet)
Seat 9: Hc2itIxwbi1lwa+DAYYQGg folded before Flop (didn't bet)



PokerStars Game #59938664324:  Hold'em No Limit ($1/$2) - 2009/07/01 0:20:27 ET
Table 'NmY84NAf9Mh0ckAckHnh5g' 2-max Seat #1 is the button
Seat 1: 6hvg964TSqZ3AL/0XK9aVQ ($616.45 in chips)
Seat 2: RwDoM55ZeQuI2ADyJhOb2Q ($204.50 in chips)
6hvg964TSqZ3AL/0XK9aVQ: posts small blind $1
RwDoM55ZeQuI2ADyJhOb2Q: posts big blind $2
*** HOLE CARDS ***
6hvg964TSqZ3AL/0XK9aVQ: folds
RwDoM55ZeQuI2ADyJhOb2Q collected $2 from pot
RwDoM55ZeQuI2ADyJhOb2Q: doesn't show hand
*** SUMMARY ***
Total pot $2 | Rake $0
Seat 1: 6hvg964TSqZ3AL/0XK9aVQ (button) (small blind) folded before Flop
Seat 2: RwDoM55ZeQuI2ADyJhOb2Q (big blind) collected ($2)



PokerStars Game #59938665618:  Hold'em No Limit ($1/$2) - 2009/07/01 0:20:29 ET
Table 'ZzSIe0zTCDv+n6hfbY5tTg' 6-max Seat #4 is the button
Seat 1: 8srN1dKQePlsv0GyTada+Q ($270.05 in chips)
Seat 2: B87ikIyZ/TzAVeXf38Ny0g ($203 in chips)
Seat 3: X7GlkHF+lkbarCLuZ4Uf0w ($37 in chips)
Seat 4: ky55L0pITYgYLeqFB9gP/Q ($174.40 in chips)
Seat 6: InmkdI6G8TzSj9NhcCSyPg ($200 in chips)
InmkdI6G8TzSj9NhcCSyPg: posts small blind $1
8srN1dKQePlsv0GyTada+Q: posts big blind $2
*** HOLE CARDS ***
B87ikIyZ/TzAVeXf38Ny0g: folds
X7GlkHF+lkbarCLuZ4Uf0w: raises $2 to $4
ky55L0pITYgYLeqFB9gP/Q: calls $4
InmkdI6G8TzSj9NhcCSyPg: folds
8srN1dKQePlsv0GyTada+Q: calls $2
*** FLOP *** [8d Tc 3s]
8srN1dKQePlsv0GyTada+Q: bets $8
X7GlkHF+lkbarCLuZ4Uf0w: folds
ky55L0pITYgYLeqFB9gP/Q: folds
8srN1dKQePlsv0GyTada+Q collected $12.35 from pot
8srN1dKQePlsv0GyTada+Q: doesn't show hand
*** SUMMARY ***
Total pot $13 | Rake $0.65
Board [8d Tc 3s]
Seat 1: 8srN1dKQePlsv0GyTada+Q (big blind) collected ($12.35)
Seat 2: B87ikIyZ/TzAVeXf38Ny0g folded before Flop (didn't bet)
Seat 3: X7GlkHF+lkbarCLuZ4Uf0w folded on the Flop
Seat 4: ky55L0pITYgYLeqFB9gP/Q (button) folded on the Flop
Seat 6: InmkdI6G8TzSj9NhcCSyPg (small blind) folded before Flop



PokerStars Game #59938668342:  Hold'em No Limit ($1/$2) - 2009/07/01 0:20:33 ET
Table 'NmY84NAf9Mh0ckAckHnh5g' 2-max Seat #2 is the button
Seat 1: 6hvg964TSqZ3AL/0XK9aVQ ($615.45 in chips)
Seat 2: RwDoM55ZeQuI2ADyJhOb2Q ($205.50 in chips)
RwDoM55ZeQuI2ADyJhOb2Q: posts small blind $1
6hvg964TSqZ3AL/0XK9aVQ: posts big blind $2
*** HOLE CARDS ***
RwDoM55ZeQuI2ADyJhOb2Q: raises $4 to $6
6hvg964TSqZ3AL/0XK9aVQ: calls $4
*** FLOP *** [8c Ad 7c]
6hvg964TSqZ3AL/0XK9aVQ: checks
RwDoM55ZeQuI2ADyJhOb2Q: checks
*** TURN *** [8c Ad 7c] [6s]
6hvg964TSqZ3AL/0XK9aVQ: checks
RwDoM55ZeQuI2ADyJhOb2Q: bets $10
6hvg964TSqZ3AL/0XK9aVQ: calls $10
*** RIVER *** [8c Ad 7c 6s] [6c]
6hvg964TSqZ3AL/0XK9aVQ: checks
RwDoM55ZeQuI2ADyJhOb2Q: bets $52
6hvg964TSqZ3AL/0XK9aVQ: folds
RwDoM55ZeQuI2ADyJhOb2Q collected $31.50 from pot
RwDoM55ZeQuI2ADyJhOb2Q: doesn't show hand
*** SUMMARY ***
Total pot $32 | Rake $0.50
Board [8c Ad 7c 6s 6c]
Seat 1: 6hvg964TSqZ3AL/0XK9aVQ (big blind) folded on the River
Seat 2: RwDoM55ZeQuI2ADyJhOb2Q (button) (small blind) collected ($31.50)



PokerStars Game #59938671378:  Hold'em No Limit ($1/$2) - 2009/07/01 0:20:37 ET
Table '5G1PjWSk2ALz0O/eqyYy/g' 2-max Seat #1 is the button
Seat 1: Z4HwehErEwzsv/noQlfUlg ($149.10 in chips)
Seat 2: v4dp1VoMhJV4zmCXtmG5LQ ($206.50 in chips)
Z4HwehErEwzsv/noQlfUlg: posts small blind $1
v4dp1VoMhJV4zmCXtmG5LQ: posts big blind $2
*** HOLE CARDS ***
Z4HwehErEwzsv/noQlfUlg: raises $2 to $4
v4dp1VoMhJV4zmCXtmG5LQ: calls $2
*** FLOP *** [3s 5d Jc]
v4dp1VoMhJV4zmCXtmG5LQ: checks
Z4HwehErEwzsv/noQlfUlg: bets $4
v4dp1VoMhJV4zmCXtmG5LQ: calls $4
*** TURN *** [3s 5d Jc] [Tc]
v4dp1VoMhJV4zmCXtmG5LQ: checks
Z4HwehErEwzsv/noQlfUlg: bets $16
v4dp1VoMhJV4zmCXtmG5LQ: folds
Z4HwehErEwzsv/noQlfUlg collected $15.50 from pot
Z4HwehErEwzsv/noQlfUlg: doesn't show hand
*** SUMMARY ***
Total pot $16 | Rake $0.50
Board [3s 5d Jc Tc]
Seat 1: Z4HwehErEwzsv/noQlfUlg (button) (small blind) collected ($15.50)
Seat 2: v4dp1VoMhJV4zmCXtmG5LQ (big blind) folded on the Turn



PokerStars Game #59938671166:  Hold'em No Limit ($1/$2) - 2009/07/01 0:20:37 ET
Table 'SF49/KQm8T4taMp6kb+HXA' 9-max Seat #5 is the button
Seat 1: l1bCLGuFqeFRwUfPsiDu/g ($287.95 in chips)
Seat 2: 8Z3QifiM9eOd5EIJ25dXNg ($45.35 in chips)
Seat 3: pCmk6FpSOLJ+85o1tLHIag ($98 in chips)
Seat 4: HffgoYm61KgkdMe/DYChIQ ($114 in chips)
Seat 5: Z3aYCZG/yXHYFjiWkGI5ug ($223.55 in chips)
Seat 6: M2ht6rIKOI/my9eh610Nlw ($226.40 in chips)
Seat 7: n2VAbLaE5qgKr5mA4W6v4w ($35.50 in chips)
Seat 8: 5iPk5MyO3KVu18Y8XCYfFQ ($40 in chips)
Seat 9: O+jytCilwk7zItVCEavmtw ($124.20 in chips)
M2ht6rIKOI/my9eh610Nlw: posts small blind $1
n2VAbLaE5qgKr5mA4W6v4w: posts big blind $2
*** HOLE CARDS ***
5iPk5MyO3KVu18Y8XCYfFQ: folds
O+jytCilwk7zItVCEavmtw: raises $6 to $8
l1bCLGuFqeFRwUfPsiDu/g: folds
8Z3QifiM9eOd5EIJ25dXNg: calls $8
pCmk6FpSOLJ+85o1tLHIag: folds
HffgoYm61KgkdMe/DYChIQ: folds
Z3aYCZG/yXHYFjiWkGI5ug: folds
M2ht6rIKOI/my9eh610Nlw: folds
n2VAbLaE5qgKr5mA4W6v4w: folds
*** FLOP *** [9d 8c Js]
O+jytCilwk7zItVCEavmtw: bets $10
8Z3QifiM9eOd5EIJ25dXNg: calls $10
*** TURN *** [9d 8c Js] [Ad]
O+jytCilwk7zItVCEavmtw: bets $32
8Z3QifiM9eOd5EIJ25dXNg: calls $27.35 and is all-in
*** RIVER *** [9d 8c Js Ad] [Kd]
*** SHOW DOWN ***
O+jytCilwk7zItVCEavmtw: shows [8s 8d] (three of a kind, Eights)
8Z3QifiM9eOd5EIJ25dXNg: mucks hand
O+jytCilwk7zItVCEavmtw collected $90.70 from pot
*** SUMMARY ***
Total pot $93.70 | Rake $3
Board [9d 8c Js Ad Kd]
Seat 1: l1bCLGuFqeFRwUfPsiDu/g folded before Flop (didn't bet)
Seat 2: 8Z3QifiM9eOd5EIJ25dXNg mucked
Seat 3: pCmk6FpSOLJ+85o1tLHIag folded before Flop (didn't bet)
Seat 4: HffgoYm61KgkdMe/DYChIQ folded before Flop (didn't bet)
Seat 5: Z3aYCZG/yXHYFjiWkGI5ug (button) folded before Flop (didn't bet)
Seat 6: M2ht6rIKOI/my9eh610Nlw (small blind) folded before Flop
Seat 7: n2VAbLaE5qgKr5mA4W6v4w (big blind) folded before Flop
Seat 8: 5iPk5MyO3KVu18Y8XCYfFQ folded before Flop (didn't bet)
Seat 9: O+jytCilwk7zItVCEavmtw showed [8s 8d] and won ($90.70) with three of a kind, Eights



PokerStars Game #59938672220:  Hold'em No Limit ($1/$2) - 2009/07/01 0:20:38 ET
Table 'rKeCh+eBn4RNvybCUYkoTQ' 9-max Seat #3 is the button
Seat 1: De9g+AYjo0DN6C/+iT/nsg ($246.30 in chips)
Seat 2: oEFhmBFI/N1eUlbVXORRnw ($192.65 in chips)
Seat 3: R9FzbEg1XYsiOty4kvbqhg ($142.30 in chips)
Seat 4: x/sLO+9OHvhcHLxOgSmnOg ($62.75 in chips)
Seat 5: iuQs2eTwwwpiBYdCIQ/ogA ($165.45 in chips)
Seat 6: TAfo4veNRaRlzDXMMYS3Jg ($42 in chips)
Seat 7: U+Qo1rnyH4lm7ehksiWi7w ($61.20 in chips)
Seat 8: pN/Ip0ePsUVIdUlGgLrkUw ($217.40 in chips)
Seat 9: SZnYUzONNVlDaSCSt67hQA ($61.80 in chips)
x/sLO+9OHvhcHLxOgSmnOg: posts small blind $1
iuQs2eTwwwpiBYdCIQ/ogA: posts big blind $2
*** HOLE CARDS ***
TAfo4veNRaRlzDXMMYS3Jg: folds
U+Qo1rnyH4lm7ehksiWi7w: folds
pN/Ip0ePsUVIdUlGgLrkUw: folds
SZnYUzONNVlDaSCSt67hQA: calls $2
De9g+AYjo0DN6C/+iT/nsg: folds
oEFhmBFI/N1eUlbVXORRnw: folds
R9FzbEg1XYsiOty4kvbqhg: folds
x/sLO+9OHvhcHLxOgSmnOg: calls $1
iuQs2eTwwwpiBYdCIQ/ogA: checks
*** FLOP *** [As 3h 9h]
x/sLO+9OHvhcHLxOgSmnOg: checks
iuQs2eTwwwpiBYdCIQ/ogA: checks
SZnYUzONNVlDaSCSt67hQA: checks
*** TURN *** [As 3h 9h] [7s]
x/sLO+9OHvhcHLxOgSmnOg: checks
iuQs2eTwwwpiBYdCIQ/ogA: checks
SZnYUzONNVlDaSCSt67hQA: bets $4
x/sLO+9OHvhcHLxOgSmnOg: calls $4
iuQs2eTwwwpiBYdCIQ/ogA: folds
*** RIVER *** [As 3h 9h 7s] [Ac]
x/sLO+9OHvhcHLxOgSmnOg: checks
SZnYUzONNVlDaSCSt67hQA: bets $6
x/sLO+9OHvhcHLxOgSmnOg: folds
SZnYUzONNVlDaSCSt67hQA collected $13.35 from pot
SZnYUzONNVlDaSCSt67hQA: doesn't show hand
*** SUMMARY ***
Total pot $14 | Rake $0.65
Board [As 3h 9h 7s Ac]
Seat 1: De9g+AYjo0DN6C/+iT/nsg folded before Flop (didn't bet)
Seat 2: oEFhmBFI/N1eUlbVXORRnw folded before Flop (didn't bet)
Seat 3: R9FzbEg1XYsiOty4kvbqhg (button) folded before Flop (didn't bet)
Seat 4: x/sLO+9OHvhcHLxOgSmnOg (small blind) folded on the River
Seat 5: iuQs2eTwwwpiBYdCIQ/ogA (big blind) folded on the Turn
Seat 6: TAfo4veNRaRlzDXMMYS3Jg folded before Flop (didn't bet)
Seat 7: U+Qo1rnyH4lm7ehksiWi7w folded before Flop (didn't bet)
Seat 8: pN/Ip0ePsUVIdUlGgLrkUw folded before Flop (didn't bet)
Seat 9: SZnYUzONNVlDaSCSt67hQA collected ($13.35)



PokerStars Game #59938672296:  Hold'em No Limit ($1/$2) - 2009/07/01 0:20:39 ET
Table 'OZyw34U4j4WtFFWsEHZQgQ' 2-max Seat #1 is the button
Seat 1: pVqEzK9wXlRMECnb1Zg4Zw ($82.60 in chips)
Seat 2: rAtTyvrJ8f1LaUh2O5U4nA ($41.60 in chips)
pVqEzK9wXlRMECnb1Zg4Zw: posts small blind $1
rAtTyvrJ8f1LaUh2O5U4nA: posts big blind $2
*** HOLE CARDS ***
pVqEzK9wXlRMECnb1Zg4Zw: raises $4 to $6
rAtTyvrJ8f1LaUh2O5U4nA: folds
pVqEzK9wXlRMECnb1Zg4Zw collected $4 from pot
pVqEzK9wXlRMECnb1Zg4Zw: doesn't show hand
*** SUMMARY ***
Total pot $4 | Rake $0
Seat 1: pVqEzK9wXlRMECnb1Zg4Zw (button) (small blind) collected ($4)
Seat 2: rAtTyvrJ8f1LaUh2O5U4nA (big blind) folded before Flop



PokerStars Game #59938678068:  Hold'em No Limit ($1/$2) - 2009/07/01 0:20:47 ET
Table 'OZyw34U4j4WtFFWsEHZQgQ' 2-max Seat #2 is the button
Seat 1: pVqEzK9wXlRMECnb1Zg4Zw ($84.60 in chips)
Seat 2: rAtTyvrJ8f1LaUh2O5U4nA ($39.60 in chips)
rAtTyvrJ8f1LaUh2O5U4nA: posts small blind $1
pVqEzK9wXlRMECnb1Zg4Zw: posts big blind $2
*** HOLE CARDS ***
rAtTyvrJ8f1LaUh2O5U4nA: folds
pVqEzK9wXlRMECnb1Zg4Zw collected $2 from pot
pVqEzK9wXlRMECnb1Zg4Zw: doesn't show hand
*** SUMMARY ***
Total pot $2 | Rake $0
Seat 1: pVqEzK9wXlRMECnb1Zg4Zw (big blind) collected ($2)
Seat 2: rAtTyvrJ8f1LaUh2O5U4nA (button) (small blind) folded before Flop



PokerStars Game #59938678436:  Hold'em No Limit ($1/$2) - 2009/07/01 0:20:47 ET
Table 'bIihwBANJSFqlHPPtset+w' 9-max Seat #4 is the button
Seat 1: jI3JDUGV63ccqtKgM3vMbw ($159.70 in chips)
Seat 2: lQYT23h5QCUVZAKxjOO39Q ($118.90 in chips)
Seat 3: acnZ0LD5jxKgWIHz+mpQ8Q ($200 in chips)
Seat 4: 7WWX5PClBdr/U44gUKBIEA ($293.05 in chips)
Seat 5: rNejrG5tkeRBbL+UmC0iJA ($164 in chips)
Seat 6: 5iPk5MyO3KVu18Y8XCYfFQ ($86 in chips)
Seat 7: 3q2/0oJr3Mcy1W5tcN61ug ($206.35 in chips)
Seat 8: iMe5yhc+1BaiIPHet3NMrA ($278.65 in chips)
Seat 9: rW/MyplHylMSBRaoRUzWrg ($40 in chips)
rNejrG5tkeRBbL+UmC0iJA: posts small blind $1
5iPk5MyO3KVu18Y8XCYfFQ: posts big blind $2
*** HOLE CARDS ***
3q2/0oJr3Mcy1W5tcN61ug: folds
iMe5yhc+1BaiIPHet3NMrA: folds
rW/MyplHylMSBRaoRUzWrg: folds
jI3JDUGV63ccqtKgM3vMbw: folds
lQYT23h5QCUVZAKxjOO39Q: folds
acnZ0LD5jxKgWIHz+mpQ8Q: folds
7WWX5PClBdr/U44gUKBIEA: folds
rNejrG5tkeRBbL+UmC0iJA: calls $1
5iPk5MyO3KVu18Y8XCYfFQ: checks
*** FLOP *** [Ac 8d 6h]
rNejrG5tkeRBbL+UmC0iJA: checks
5iPk5MyO3KVu18Y8XCYfFQ: bets $2
rNejrG5tkeRBbL+UmC0iJA: folds
5iPk5MyO3KVu18Y8XCYfFQ collected $3.80 from pot
*** SUMMARY ***
Total pot $4 | Rake $0.20
Board [Ac 8d 6h]
Seat 1: jI3JDUGV63ccqtKgM3vMbw folded before Flop (didn't bet)
Seat 2: lQYT23h5QCUVZAKxjOO39Q folded before Flop (didn't bet)
Seat 3: acnZ0LD5jxKgWIHz+mpQ8Q folded before Flop (didn't bet)
Seat 4: 7WWX5PClBdr/U44gUKBIEA (button) folded before Flop (didn't bet)
Seat 5: rNejrG5tkeRBbL+UmC0iJA (small blind) folded on the Flop
Seat 6: 5iPk5MyO3KVu18Y8XCYfFQ (big blind) collected ($3.80)
Seat 7: 3q2/0oJr3Mcy1W5tcN61ug folded before Flop (didn't bet)
Seat 8: iMe5yhc+1BaiIPHet3NMrA folded before Flop (didn't bet)
Seat 9: rW/MyplHylMSBRaoRUzWrg folded before Flop (didn't bet)



PokerStars Game #59938678624:  Hold'em No Limit ($1/$2) - 2009/07/01 0:20:48 ET
Table 'G1Oqdy4Pqdb5gtx40rUBzA' 6-max Seat #4 is the button
Seat 1: bz8Aw6kfX2xUq2sOyZlUCQ ($92.85 in chips)
Seat 2: IzslX/oV8DoDQfxCV/3+kg ($476.15 in chips)
Seat 3: lE+RUsc9cdVV9eEi8uytew ($158.70 in chips)
Seat 4: B87ikIyZ/TzAVeXf38Ny0g ($200 in chips)
Seat 5: X7GlkHF+lkbarCLuZ4Uf0w ($76 in chips)
X7GlkHF+lkbarCLuZ4Uf0w: posts small blind $1
gGPaCoSWW1HoKYaqfAPecg: is sitting out
bz8Aw6kfX2xUq2sOyZlUCQ: posts big blind $2
*** HOLE CARDS ***
IzslX/oV8DoDQfxCV/3+kg: raises $4 to $6
lE+RUsc9cdVV9eEi8uytew: calls $6
B87ikIyZ/TzAVeXf38Ny0g: calls $6
X7GlkHF+lkbarCLuZ4Uf0w: folds
bz8Aw6kfX2xUq2sOyZlUCQ: folds
*** FLOP *** [3s 5s Jc]
IzslX/oV8DoDQfxCV/3+kg: checks
lE+RUsc9cdVV9eEi8uytew: bets $8
B87ikIyZ/TzAVeXf38Ny0g: calls $8
IzslX/oV8DoDQfxCV/3+kg: folds
*** TURN *** [3s 5s Jc] [Td]
gGPaCoSWW1HoKYaqfAPecg leaves the table
lE+RUsc9cdVV9eEi8uytew: bets $24
B87ikIyZ/TzAVeXf38Ny0g: folds
lE+RUsc9cdVV9eEi8uytew collected $35.25 from pot
lE+RUsc9cdVV9eEi8uytew: doesn't show hand
*** SUMMARY ***
Total pot $37 | Rake $1.75
Board [3s 5s Jc Td]
Seat 1: bz8Aw6kfX2xUq2sOyZlUCQ (big blind) folded before Flop
Seat 2: IzslX/oV8DoDQfxCV/3+kg folded on the Flop
Seat 3: lE+RUsc9cdVV9eEi8uytew collected ($35.25)
Seat 4: B87ikIyZ/TzAVeXf38Ny0g (button) folded on the Turn
Seat 5: X7GlkHF+lkbarCLuZ4Uf0w (small blind) folded before Flop



PokerStars Game #59938679170:  Hold'em No Limit ($1/$2) - 2009/07/01 0:20:48 ET
Table 'mGpP9StWRnoeiBDExc6Frg' 6-max Seat #1 is the button
Seat 1: zWFU82nxIRvzK4mKiL4m0Q ($64.85 in chips)
Seat 2: DQlskgG4OtLpF2MVxLwf4A ($307.85 in chips)
Seat 3: 3HrFUl+TAqSP1U00zz3P7A ($76.60 in chips)
Seat 4: qXDd0ZyMIse0OBu8pxeQ3Q ($215 in chips)
Seat 5: d1puGuVBE0fidn+5eRJ0tw ($167.70 in chips)
Seat 6: X7GlkHF+lkbarCLuZ4Uf0w ($23.45 in chips)
DQlskgG4OtLpF2MVxLwf4A: posts small blind $1
3HrFUl+TAqSP1U00zz3P7A: posts big blind $2
*** HOLE CARDS ***
qXDd0ZyMIse0OBu8pxeQ3Q: folds
d1puGuVBE0fidn+5eRJ0tw: folds
X7GlkHF+lkbarCLuZ4Uf0w: folds
zWFU82nxIRvzK4mKiL4m0Q: calls $2
DQlskgG4OtLpF2MVxLwf4A: raises $8 to $10
3HrFUl+TAqSP1U00zz3P7A: folds
zWFU82nxIRvzK4mKiL4m0Q: folds
DQlskgG4OtLpF2MVxLwf4A collected $6 from pot
DQlskgG4OtLpF2MVxLwf4A: doesn't show hand
*** SUMMARY ***
Total pot $6 | Rake $0
Seat 1: zWFU82nxIRvzK4mKiL4m0Q (button) folded before Flop
Seat 2: DQlskgG4OtLpF2MVxLwf4A (small blind) collected ($6)
Seat 3: 3HrFUl+TAqSP1U00zz3P7A (big blind) folded before Flop
Seat 4: qXDd0ZyMIse0OBu8pxeQ3Q folded before Flop (didn't bet)
Seat 5: d1puGuVBE0fidn+5eRJ0tw folded before Flop (didn't bet)
Seat 6: X7GlkHF+lkbarCLuZ4Uf0w folded before Flop (didn't bet)



PokerStars Game #59938679344:  Hold'em No Limit ($1/$2) - 2009/07/01 0:20:49 ET
Table 'WCA60bDA8ecovUgFSIZkTQ' 9-max Seat #1 is the button
Seat 1: CUZwDpLTQKhzarPe+JCLOQ ($208.75 in chips)
Seat 2: G1h8wamBcVJXtsKXZQ2EyA ($104.85 in chips)
Seat 3: 5iPk5MyO3KVu18Y8XCYfFQ ($45 in chips)
Seat 4: Q3uFdu6ztesjDFiqkagTRQ ($710.60 in chips)
Seat 5: Hc2itIxwbi1lwa+DAYYQGg ($300.30 in chips)
Seat 7: 2YpnxJiexJHyERfbqgwEcw ($55 in chips)
Seat 8: x+V1JgVDawsJTxKcxm7gxw ($88 in chips)
G1h8wamBcVJXtsKXZQ2EyA: posts small blind $1
5iPk5MyO3KVu18Y8XCYfFQ: posts big blind $2
*** HOLE CARDS ***
Q3uFdu6ztesjDFiqkagTRQ: folds
Hc2itIxwbi1lwa+DAYYQGg: folds
2YpnxJiexJHyERfbqgwEcw: raises $4 to $6
x+V1JgVDawsJTxKcxm7gxw: calls $6
CUZwDpLTQKhzarPe+JCLOQ: folds
G1h8wamBcVJXtsKXZQ2EyA: folds
5iPk5MyO3KVu18Y8XCYfFQ: folds
*** FLOP *** [Ts 8h Th]
2YpnxJiexJHyERfbqgwEcw: bets $8
x+V1JgVDawsJTxKcxm7gxw: folds
2YpnxJiexJHyERfbqgwEcw collected $14.25 from pot
2YpnxJiexJHyERfbqgwEcw: doesn't show hand
*** SUMMARY ***
Total pot $15 | Rake $0.75
Board [Ts 8h Th]
Seat 1: CUZwDpLTQKhzarPe+JCLOQ (button) folded before Flop (didn't bet)
Seat 2: G1h8wamBcVJXtsKXZQ2EyA (small blind) folded before Flop
Seat 3: 5iPk5MyO3KVu18Y8XCYfFQ (big blind) folded before Flop
Seat 4: Q3uFdu6ztesjDFiqkagTRQ folded before Flop (didn't bet)
Seat 5: Hc2itIxwbi1lwa+DAYYQGg folded before Flop (didn't bet)
Seat 7: 2YpnxJiexJHyERfbqgwEcw collected ($14.25)
Seat 8: x+V1JgVDawsJTxKcxm7gxw folded on the Flop



PokerStars Game #59938680044:  Hold'em No Limit ($1/$2) - 2009/07/01 0:20:50 ET
Table 'jlrIxbrVIG+gjaUYT4za8g' 6-max Seat #4 is the button
Seat 1: ygTTt5ehT4aF86q1a8/R+w ($193.05 in chips)
Seat 2: N18PrNGQj43J7TJuQuu+tw ($131.15 in chips)
Seat 3: 54yWzRRgS0oZ+S6LwZBxMQ ($37.80 in chips)
Seat 4: 8srN1dKQePlsv0GyTada+Q ($221 in chips)
Seat 5: VuZb/hkEc4X7s93w2ZZTpA ($200 in chips)
Seat 6: vkfxu8f/jMYKUk6Ly4eujw ($282.95 in chips)
VuZb/hkEc4X7s93w2ZZTpA: posts small blind $1
vkfxu8f/jMYKUk6Ly4eujw: posts big blind $2
*** HOLE CARDS ***
ygTTt5ehT4aF86q1a8/R+w: folds
N18PrNGQj43J7TJuQuu+tw: calls $2
54yWzRRgS0oZ+S6LwZBxMQ: folds
8srN1dKQePlsv0GyTada+Q: folds
VuZb/hkEc4X7s93w2ZZTpA: folds
vkfxu8f/jMYKUk6Ly4eujw: raises $8 to $10
N18PrNGQj43J7TJuQuu+tw: calls $8
*** FLOP *** [2s Jh As]
vkfxu8f/jMYKUk6Ly4eujw: checks
N18PrNGQj43J7TJuQuu+tw: bets $16
vkfxu8f/jMYKUk6Ly4eujw: folds
N18PrNGQj43J7TJuQuu+tw collected $19.95 from pot
N18PrNGQj43J7TJuQuu+tw: shows [6h Kh] (high card Ace)
*** SUMMARY ***
Total pot $21 | Rake $1.05
Board [2s Jh As]
Seat 1: ygTTt5ehT4aF86q1a8/R+w folded before Flop (didn't bet)
Seat 2: N18PrNGQj43J7TJuQuu+tw collected ($19.95)
Seat 3: 54yWzRRgS0oZ+S6LwZBxMQ folded before Flop (didn't bet)
Seat 4: 8srN1dKQePlsv0GyTada+Q (button) folded before Flop (didn't bet)
Seat 5: VuZb/hkEc4X7s93w2ZZTpA (small blind) folded before Flop
Seat 6: vkfxu8f/jMYKUk6Ly4eujw (big blind) folded on the Flop



PokerStars Game #59938680640:  Hold'em No Limit ($1/$2) - 2009/07/01 0:20:51 ET
Table 'P/yCfYl1GfGsu/e6DxDy/A' 2-max Seat #1 is the button
Seat 1: 7fOCUy3x9hdkmXkkDNolGQ ($213 in chips)
Seat 2: RwDoM55ZeQuI2ADyJhOb2Q ($570.50 in chips)
7fOCUy3x9hdkmXkkDNolGQ: posts small blind $1
RwDoM55ZeQuI2ADyJhOb2Q: posts big blind $2
*** HOLE CARDS ***
7fOCUy3x9hdkmXkkDNolGQ: folds
RwDoM55ZeQuI2ADyJhOb2Q collected $2 from pot
RwDoM55ZeQuI2ADyJhOb2Q: doesn't show hand
*** SUMMARY ***
Total pot $2 | Rake $0
Seat 1: 7fOCUy3x9hdkmXkkDNolGQ (button) (small blind) folded before Flop
Seat 2: RwDoM55ZeQuI2ADyJhOb2Q (big blind) collected ($2)



PokerStars Game #59938682348:  Hold'em No Limit ($1/$2) - 2009/07/01 0:20:53 ET
Table 'OZyw34U4j4WtFFWsEHZQgQ' 2-max Seat #1 is the button
Seat 1: pVqEzK9wXlRMECnb1Zg4Zw ($85.60 in chips)
Seat 2: rAtTyvrJ8f1LaUh2O5U4nA ($38.60 in chips)
pVqEzK9wXlRMECnb1Zg4Zw: posts small blind $1
rAtTyvrJ8f1LaUh2O5U4nA: posts big blind $2
*** HOLE CARDS ***
pVqEzK9wXlRMECnb1Zg4Zw: raises $4 to $6
rAtTyvrJ8f1LaUh2O5U4nA: raises $32.60 to $38.60 and is all-in
pVqEzK9wXlRMECnb1Zg4Zw: folds
rAtTyvrJ8f1LaUh2O5U4nA collected $12 from pot
rAtTyvrJ8f1LaUh2O5U4nA: shows [Tc 8d] (high card Ten)
*** SUMMARY ***
Total pot $12 | Rake $0
Seat 1: pVqEzK9wXlRMECnb1Zg4Zw (button) (small blind) folded before Flop
Seat 2: rAtTyvrJ8f1LaUh2O5U4nA (big blind) collected ($12)



PokerStars Game #59938685032:  Hold'em No Limit ($1/$2) - 2009/07/01 0:20:57 ET
Table 'P/yCfYl1GfGsu/e6DxDy/A' 2-max Seat #2 is the button
Seat 1: 7fOCUy3x9hdkmXkkDNolGQ ($212 in chips)
Seat 2: RwDoM55ZeQuI2ADyJhOb2Q ($571.50 in chips)
RwDoM55ZeQuI2ADyJhOb2Q: posts small blind $1
7fOCUy3x9hdkmXkkDNolGQ: posts big blind $2
*** HOLE CARDS ***
RwDoM55ZeQuI2ADyJhOb2Q: raises $4 to $6
7fOCUy3x9hdkmXkkDNolGQ: raises $14 to $20
RwDoM55ZeQuI2ADyJhOb2Q: folds
7fOCUy3x9hdkmXkkDNolGQ collected $12 from pot
7fOCUy3x9hdkmXkkDNolGQ: doesn't show hand
*** SUMMARY ***
Total pot $12 | Rake $0
Seat 1: 7fOCUy3x9hdkmXkkDNolGQ (big blind) collected ($12)
Seat 2: RwDoM55ZeQuI2ADyJhOb2Q (button) (small blind) folded before Flop



PokerStars Game #59938685874:  Hold'em No Limit ($1/$2) - 2009/07/01 0:20:58 ET
Table 'NmY84NAf9Mh0ckAckHnh5g' 2-max Seat #1 is the button
Seat 1: 6hvg964TSqZ3AL/0XK9aVQ ($599.45 in chips)
Seat 2: RwDoM55ZeQuI2ADyJhOb2Q ($221 in chips)
6hvg964TSqZ3AL/0XK9aVQ: posts small blind $1
RwDoM55ZeQuI2ADyJhOb2Q: posts big blind $2
*** HOLE CARDS ***
6hvg964TSqZ3AL/0XK9aVQ: calls $1
RwDoM55ZeQuI2ADyJhOb2Q: raises $6 to $8
6hvg964TSqZ3AL/0XK9aVQ: calls $6
*** FLOP *** [9h 9d 4h]
RwDoM55ZeQuI2ADyJhOb2Q: bets $12
6hvg964TSqZ3AL/0XK9aVQ: calls $12
*** TURN *** [9h 9d 4h] [3c]
RwDoM55ZeQuI2ADyJhOb2Q: bets $32
6hvg964TSqZ3AL/0XK9aVQ: calls $32
*** RIVER *** [9h 9d 4h 3c] [3h]
RwDoM55ZeQuI2ADyJhOb2Q: checks
6hvg964TSqZ3AL/0XK9aVQ: bets $82
RwDoM55ZeQuI2ADyJhOb2Q: folds
6hvg964TSqZ3AL/0XK9aVQ collected $103.50 from pot
*** SUMMARY ***
Total pot $104 | Rake $0.50
Board [9h 9d 4h 3c 3h]
Seat 1: 6hvg964TSqZ3AL/0XK9aVQ (button) (small blind) collected ($103.50)
Seat 2: RwDoM55ZeQuI2ADyJhOb2Q (big blind) folded on the River



PokerStars Game #59938686592:  Hold'em No Limit ($1/$2) - 2009/07/01 0:20:59 ET
Table '5G1PjWSk2ALz0O/eqyYy/g' 2-max Seat #2 is the button
Seat 1: Z4HwehErEwzsv/noQlfUlg ($156.60 in chips)
Seat 2: v4dp1VoMhJV4zmCXtmG5LQ ($200 in chips)
v4dp1VoMhJV4zmCXtmG5LQ: posts small blind $1
Z4HwehErEwzsv/noQlfUlg: posts big blind $2
*** HOLE CARDS ***
v4dp1VoMhJV4zmCXtmG5LQ: raises $4 to $6
Z4HwehErEwzsv/noQlfUlg: calls $4
*** FLOP *** [6s Qh 4h]
Z4HwehErEwzsv/noQlfUlg: checks
v4dp1VoMhJV4zmCXtmG5LQ: bets $8
Z4HwehErEwzsv/noQlfUlg: raises $10 to $18
v4dp1VoMhJV4zmCXtmG5LQ: folds
Z4HwehErEwzsv/noQlfUlg collected $27.50 from pot
Z4HwehErEwzsv/noQlfUlg: doesn't show hand
*** SUMMARY ***
Total pot $28 | Rake $0.50
Board [6s Qh 4h]
Seat 1: Z4HwehErEwzsv/noQlfUlg (big blind) collected ($27.50)
Seat 2: v4dp1VoMhJV4zmCXtmG5LQ (button) (small blind) folded on the Flop



PokerStars Game #59938689804:  Hold'em No Limit ($1/$2) - 2009/07/01 0:21:04 ET
Table 'OZyw34U4j4WtFFWsEHZQgQ' 2-max Seat #2 is the button
Seat 1: pVqEzK9wXlRMECnb1Zg4Zw ($79.60 in chips)
Seat 2: rAtTyvrJ8f1LaUh2O5U4nA ($44.60 in chips)
rAtTyvrJ8f1LaUh2O5U4nA: posts small blind $1
pVqEzK9wXlRMECnb1Zg4Zw: posts big blind $2
*** HOLE CARDS ***
rAtTyvrJ8f1LaUh2O5U4nA: calls $1
pVqEzK9wXlRMECnb1Zg4Zw: checks
*** FLOP *** [9s 5s 9h]
pVqEzK9wXlRMECnb1Zg4Zw: checks
rAtTyvrJ8f1LaUh2O5U4nA: bets $2
pVqEzK9wXlRMECnb1Zg4Zw: calls $2
*** TURN *** [9s 5s 9h] [8c]
pVqEzK9wXlRMECnb1Zg4Zw: checks
rAtTyvrJ8f1LaUh2O5U4nA: checks
*** RIVER *** [9s 5s 9h 8c] [2d]
pVqEzK9wXlRMECnb1Zg4Zw: checks
rAtTyvrJ8f1LaUh2O5U4nA: bets $2
pVqEzK9wXlRMECnb1Zg4Zw: calls $2
*** SHOW DOWN ***
rAtTyvrJ8f1LaUh2O5U4nA: shows [5c Ad] (two pair, Nines and Fives)
pVqEzK9wXlRMECnb1Zg4Zw: mucks hand
rAtTyvrJ8f1LaUh2O5U4nA collected $11.50 from pot
*** SUMMARY ***
Total pot $12 | Rake $0.50
Board [9s 5s 9h 8c 2d]
Seat 1: pVqEzK9wXlRMECnb1Zg4Zw (big blind) mucked
Seat 2: rAtTyvrJ8f1LaUh2O5U4nA (button) (small blind) showed [5c Ad] and won ($11.50) with two pair, Nines and Fives



PokerStars Game #59938690352:  Hold'em No Limit ($1/$2) - 2009/07/01 0:21:05 ET
Table 'BSRfGh+QobUe0AgIMtt/fw' 9-max Seat #7 is the button
Seat 1: QHxJjpVYwitg9krW6wZgJA ($292.30 in chips)
Seat 2: +C3eP/ysyROWbEXJFPswVA ($96.35 in chips)
Seat 3: XSBFygUEk3Ijl/S/KhD4PA ($370.60 in chips)
Seat 4: 5iPk5MyO3KVu18Y8XCYfFQ ($40 in chips)
Seat 5: odhvI/CZeMsPyo1n1U7+hA ($65 in chips)
Seat 6: H6Z4+qu8gR0VUiPOijndVg ($207.40 in chips)
Seat 7: RgU4royPa+zJopKX0xA3RA ($138.70 in chips)
Seat 8: /XRRUMKiOOItJFbrM26RrA ($56 in chips)
/XRRUMKiOOItJFbrM26RrA: posts small blind $1
b0jO1SDhLedy1//CQlA8kw: is sitting out
QHxJjpVYwitg9krW6wZgJA: posts big blind $2
*** HOLE CARDS ***
b0jO1SDhLedy1//CQlA8kw leaves the table
+C3eP/ysyROWbEXJFPswVA: folds
XSBFygUEk3Ijl/S/KhD4PA: folds
+C3eP/ysyROWbEXJFPswVA leaves the table
5iPk5MyO3KVu18Y8XCYfFQ: folds
odhvI/CZeMsPyo1n1U7+hA: folds
H6Z4+qu8gR0VUiPOijndVg: folds
RgU4royPa+zJopKX0xA3RA: calls $2
/XRRUMKiOOItJFbrM26RrA: calls $1
QHxJjpVYwitg9krW6wZgJA: checks
*** FLOP *** [8d Js 8h]
GX1heJ+DSsvm7gzSPsYhhQ joins the table at seat #2
/XRRUMKiOOItJFbrM26RrA: checks
QHxJjpVYwitg9krW6wZgJA: checks
RgU4royPa+zJopKX0xA3RA: bets $6
/XRRUMKiOOItJFbrM26RrA: folds
QHxJjpVYwitg9krW6wZgJA: folds
RgU4royPa+zJopKX0xA3RA collected $5.70 from pot
RgU4royPa+zJopKX0xA3RA: doesn't show hand
*** SUMMARY ***
Total pot $6 | Rake $0.30
Board [8d Js 8h]
Seat 1: QHxJjpVYwitg9krW6wZgJA (big blind) folded on the Flop
Seat 2: +C3eP/ysyROWbEXJFPswVA folded before Flop (didn't bet)
Seat 3: XSBFygUEk3Ijl/S/KhD4PA folded before Flop (didn't bet)
Seat 4: 5iPk5MyO3KVu18Y8XCYfFQ folded before Flop (didn't bet)
Seat 5: odhvI/CZeMsPyo1n1U7+hA folded before Flop (didn't bet)
Seat 6: H6Z4+qu8gR0VUiPOijndVg folded before Flop (didn't bet)
Seat 7: RgU4royPa+zJopKX0xA3RA (button) collected ($5.70)
Seat 8: /XRRUMKiOOItJFbrM26RrA (small blind) folded on the Flop



PokerStars Game #59938693380:  Hold'em No Limit ($1/$2) - 2009/07/01 0:21:09 ET
Table 'ZzSIe0zTCDv+n6hfbY5tTg' 6-max Seat #6 is the button
Seat 1: 8srN1dKQePlsv0GyTada+Q ($278.40 in chips)
Seat 2: B87ikIyZ/TzAVeXf38Ny0g ($203 in chips)
Seat 3: X7GlkHF+lkbarCLuZ4Uf0w ($33 in chips)
Seat 4: ky55L0pITYgYLeqFB9gP/Q ($170.40 in chips)
Seat 6: InmkdI6G8TzSj9NhcCSyPg ($200 in chips)
8srN1dKQePlsv0GyTada+Q: posts small blind $1
B87ikIyZ/TzAVeXf38Ny0g: posts big blind $2
*** HOLE CARDS ***
X7GlkHF+lkbarCLuZ4Uf0w: folds
ky55L0pITYgYLeqFB9gP/Q: raises $6 to $8
InmkdI6G8TzSj9NhcCSyPg: folds
8srN1dKQePlsv0GyTada+Q: folds
B87ikIyZ/TzAVeXf38Ny0g: calls $6
*** FLOP *** [2d 8d Ts]
B87ikIyZ/TzAVeXf38Ny0g: checks
ky55L0pITYgYLeqFB9gP/Q: bets $16
B87ikIyZ/TzAVeXf38Ny0g: calls $16
*** TURN *** [2d 8d Ts] [6s]
B87ikIyZ/TzAVeXf38Ny0g: checks
ky55L0pITYgYLeqFB9gP/Q: bets $44
B87ikIyZ/TzAVeXf38Ny0g: folds
ky55L0pITYgYLeqFB9gP/Q collected $47 from pot
ky55L0pITYgYLeqFB9gP/Q: doesn't show hand
*** SUMMARY ***
Total pot $49 | Rake $2
Board [2d 8d Ts 6s]
Seat 1: 8srN1dKQePlsv0GyTada+Q (small blind) folded before Flop
Seat 2: B87ikIyZ/TzAVeXf38Ny0g (big blind) folded on the Turn
Seat 3: X7GlkHF+lkbarCLuZ4Uf0w folded before Flop (didn't bet)
Seat 4: ky55L0pITYgYLeqFB9gP/Q collected ($47)
Seat 6: InmkdI6G8TzSj9NhcCSyPg (button) folded before Flop (didn't bet)



PokerStars Game #59938693504:  Hold'em No Limit ($1/$2) - 2009/07/01 0:21:10 ET
Table 'mGpP9StWRnoeiBDExc6Frg' 6-max Seat #2 is the button
Seat 1: zWFU82nxIRvzK4mKiL4m0Q ($62.85 in chips)
Seat 2: DQlskgG4OtLpF2MVxLwf4A ($311.85 in chips)
Seat 3: 3HrFUl+TAqSP1U00zz3P7A ($74.60 in chips)
Seat 4: qXDd0ZyMIse0OBu8pxeQ3Q ($215 in chips)
Seat 5: d1puGuVBE0fidn+5eRJ0tw ($167.70 in chips)
Seat 6: X7GlkHF+lkbarCLuZ4Uf0w ($23.45 in chips)
3HrFUl+TAqSP1U00zz3P7A: posts small blind $1
qXDd0ZyMIse0OBu8pxeQ3Q: posts big blind $2
*** HOLE CARDS ***
d1puGuVBE0fidn+5eRJ0tw: folds
X7GlkHF+lkbarCLuZ4Uf0w: folds
zWFU82nxIRvzK4mKiL4m0Q: folds
DQlskgG4OtLpF2MVxLwf4A: folds
3HrFUl+TAqSP1U00zz3P7A: folds
qXDd0ZyMIse0OBu8pxeQ3Q collected $2 from pot
*** SUMMARY ***
Total pot $2 | Rake $0
Seat 1: zWFU82nxIRvzK4mKiL4m0Q folded before Flop (didn't bet)
Seat 2: DQlskgG4OtLpF2MVxLwf4A (button) folded before Flop (didn't bet)
Seat 3: 3HrFUl+TAqSP1U00zz3P7A (small blind) folded before Flop
Seat 4: qXDd0ZyMIse0OBu8pxeQ3Q (big blind) collected ($2)
Seat 5: d1puGuVBE0fidn+5eRJ0tw folded before Flop (didn't bet)
Seat 6: X7GlkHF+lkbarCLuZ4Uf0w folded before Flop (didn't bet)



PokerStars Game #59938695398:  Hold'em No Limit ($1/$2) - 2009/07/01 0:21:12 ET
Table 'P/yCfYl1GfGsu/e6DxDy/A' 2-max Seat #1 is the button
Seat 1: 7fOCUy3x9hdkmXkkDNolGQ ($218 in chips)
Seat 2: RwDoM55ZeQuI2ADyJhOb2Q ($565.50 in chips)
7fOCUy3x9hdkmXkkDNolGQ: posts small blind $1
RwDoM55ZeQuI2ADyJhOb2Q: posts big blind $2
*** HOLE CARDS ***
7fOCUy3x9hdkmXkkDNolGQ: folds
RwDoM55ZeQuI2ADyJhOb2Q collected $2 from pot
RwDoM55ZeQuI2ADyJhOb2Q: doesn't show hand
*** SUMMARY ***
Total pot $2 | Rake $0
Seat 1: 7fOCUy3x9hdkmXkkDNolGQ (button) (small blind) folded before Flop
Seat 2: RwDoM55ZeQuI2ADyJhOb2Q (big blind) collected ($2)



PokerStars Game #59938695924:  Hold'em No Limit ($1/$2) - 2009/07/01 0:21:13 ET
Table 'aSf77Sj8QEnzcc0WaxVD4Q' 6-max Seat #4 is the button
Seat 2: vkfxu8f/jMYKUk6Ly4eujw ($256.15 in chips)
Seat 3: 9dpyyjDTCed6nV7JhaUUpw ($200 in chips)
Seat 4: 513FcCI8jHyQy2VWoIQkMg ($201.75 in chips)
Seat 5: InmkdI6G8TzSj9NhcCSyPg ($248 in chips)
Seat 6: vkoJRf3gidxY1pPi0AFWww ($301.15 in chips)
InmkdI6G8TzSj9NhcCSyPg: posts small blind $1
vkoJRf3gidxY1pPi0AFWww: posts big blind $2
54yWzRRgS0oZ+S6LwZBxMQ: sits out
*** HOLE CARDS ***
vkfxu8f/jMYKUk6Ly4eujw: folds
9dpyyjDTCed6nV7JhaUUpw: folds
513FcCI8jHyQy2VWoIQkMg: folds
InmkdI6G8TzSj9NhcCSyPg: folds
vkoJRf3gidxY1pPi0AFWww collected $2 from pot
vkoJRf3gidxY1pPi0AFWww: doesn't show hand
*** SUMMARY ***
Total pot $2 | Rake $0
Seat 2: vkfxu8f/jMYKUk6Ly4eujw folded before Flop (didn't bet)
Seat 3: 9dpyyjDTCed6nV7JhaUUpw folded before Flop (didn't bet)
Seat 4: 513FcCI8jHyQy2VWoIQkMg (button) folded before Flop (didn't bet)
Seat 5: InmkdI6G8TzSj9NhcCSyPg (small blind) folded before Flop
Seat 6: vkoJRf3gidxY1pPi0AFWww (big blind) collected ($2)



PokerStars Game #59938696326:  Hold'em No Limit ($1/$2) - 2009/07/01 0:21:14 ET
Table 'gnHBqWll9O3fxG7Ojkz/ng' 9-max Seat #5 is the button
Seat 1: hpqdC/23wXosGOmzARr5NA ($147.05 in chips)
Seat 2: H6Z4+qu8gR0VUiPOijndVg ($200 in chips)
Seat 3: 5Q8U6iZbeO7xJSS4qvDP5g ($225.35 in chips)
Seat 4: n5XI5/7gN+gIubHFBH+mOw ($400.15 in chips)
Seat 5: rBQDMkKm9cZn6M9NPsiVew ($117 in chips)
Seat 6: 5iPk5MyO3KVu18Y8XCYfFQ ($56.45 in chips)
Seat 7: jqui3xAWCkcdPW36a6BD+w ($212.80 in chips)
Seat 8: cM6efHzdxoqYm0EQKP4TTQ ($110.80 in chips)
Seat 9: kVCeGJ4NY7Fb0W74j1mAqA ($200 in chips)
5iPk5MyO3KVu18Y8XCYfFQ: posts small blind $1
jqui3xAWCkcdPW36a6BD+w: posts big blind $2
*** HOLE CARDS ***
cM6efHzdxoqYm0EQKP4TTQ: calls $2
kVCeGJ4NY7Fb0W74j1mAqA: folds
hpqdC/23wXosGOmzARr5NA: folds
H6Z4+qu8gR0VUiPOijndVg: folds
5Q8U6iZbeO7xJSS4qvDP5g: folds
n5XI5/7gN+gIubHFBH+mOw has timed out
n5XI5/7gN+gIubHFBH+mOw: folds
n5XI5/7gN+gIubHFBH+mOw is sitting out
rBQDMkKm9cZn6M9NPsiVew: folds
5iPk5MyO3KVu18Y8XCYfFQ: folds
jqui3xAWCkcdPW36a6BD+w: checks
*** FLOP *** [Tc 9c Qs]
jqui3xAWCkcdPW36a6BD+w: checks
cM6efHzdxoqYm0EQKP4TTQ: checks
*** TURN *** [Tc 9c Qs] [9s]
jqui3xAWCkcdPW36a6BD+w: checks
cM6efHzdxoqYm0EQKP4TTQ: checks
*** RIVER *** [Tc 9c Qs 9s] [Kh]
jqui3xAWCkcdPW36a6BD+w: checks
cM6efHzdxoqYm0EQKP4TTQ: checks
*** SHOW DOWN ***
jqui3xAWCkcdPW36a6BD+w: shows [Ks 5s] (two pair, Kings and Nines)
cM6efHzdxoqYm0EQKP4TTQ: mucks hand
jqui3xAWCkcdPW36a6BD+w collected $4.75 from pot
*** SUMMARY ***
Total pot $5 | Rake $0.25
Board [Tc 9c Qs 9s Kh]
Seat 1: hpqdC/23wXosGOmzARr5NA folded before Flop (didn't bet)
Seat 2: H6Z4+qu8gR0VUiPOijndVg folded before Flop (didn't bet)
Seat 3: 5Q8U6iZbeO7xJSS4qvDP5g folded before Flop (didn't bet)
Seat 4: n5XI5/7gN+gIubHFBH+mOw folded before Flop (didn't bet)
Seat 5: rBQDMkKm9cZn6M9NPsiVew (button) folded before Flop (didn't bet)
Seat 6: 5iPk5MyO3KVu18Y8XCYfFQ (small blind) folded before Flop
Seat 7: jqui3xAWCkcdPW36a6BD+w (big blind) showed [Ks 5s] and won ($4.75) with two pair, Kings and Nines
Seat 8: cM6efHzdxoqYm0EQKP4TTQ mucked
Seat 9: kVCeGJ4NY7Fb0W74j1mAqA folded before Flop (didn't bet)



PokerStars Game #59938698916:  Hold'em No Limit ($1/$2) - 2009/07/01 0:21:17 ET
Table '5G1PjWSk2ALz0O/eqyYy/g' 2-max Seat #1 is the button
Seat 1: Z4HwehErEwzsv/noQlfUlg ($170.10 in chips)
Seat 2: v4dp1VoMhJV4zmCXtmG5LQ ($200 in chips)
Z4HwehErEwzsv/noQlfUlg: posts small blind $1
v4dp1VoMhJV4zmCXtmG5LQ: posts big blind $2
*** HOLE CARDS ***
Z4HwehErEwzsv/noQlfUlg: folds
v4dp1VoMhJV4zmCXtmG5LQ collected $2 from pot
v4dp1VoMhJV4zmCXtmG5LQ: doesn't show hand
*** SUMMARY ***
Total pot $2 | Rake $0
Seat 1: Z4HwehErEwzsv/noQlfUlg (button) (small blind) folded before Flop
Seat 2: v4dp1VoMhJV4zmCXtmG5LQ (big blind) collected ($2)



PokerStars Game #59938699524:  Hold'em No Limit ($1/$2) - 2009/07/01 0:21:18 ET
Table 'P/yCfYl1GfGsu/e6DxDy/A' 2-max Seat #2 is the button
Seat 1: 7fOCUy3x9hdkmXkkDNolGQ ($217 in chips)
Seat 2: RwDoM55ZeQuI2ADyJhOb2Q ($566.50 in chips)
RwDoM55ZeQuI2ADyJhOb2Q: posts small blind $1
7fOCUy3x9hdkmXkkDNolGQ: posts big blind $2
*** HOLE CARDS ***
RwDoM55ZeQuI2ADyJhOb2Q: raises $4 to $6
7fOCUy3x9hdkmXkkDNolGQ: calls $4
*** FLOP *** [Kd Ks 4s]
7fOCUy3x9hdkmXkkDNolGQ: checks
RwDoM55ZeQuI2ADyJhOb2Q: checks
*** TURN *** [Kd Ks 4s] [9d]
7fOCUy3x9hdkmXkkDNolGQ: bets $10
RwDoM55ZeQuI2ADyJhOb2Q: calls $10
*** RIVER *** [Kd Ks 4s 9d] [6s]
7fOCUy3x9hdkmXkkDNolGQ: bets $26
RwDoM55ZeQuI2ADyJhOb2Q: calls $26
*** SHOW DOWN ***
7fOCUy3x9hdkmXkkDNolGQ: shows [Kc 2c] (three of a kind, Kings)
RwDoM55ZeQuI2ADyJhOb2Q: mucks hand
7fOCUy3x9hdkmXkkDNolGQ collected $83.50 from pot
*** SUMMARY ***
Total pot $84 | Rake $0.50
Board [Kd Ks 4s 9d 6s]
Seat 1: 7fOCUy3x9hdkmXkkDNolGQ (big blind) showed [Kc 2c] and won ($83.50) with three of a kind, Kings
Seat 2: RwDoM55ZeQuI2ADyJhOb2Q (button) (small blind) mucked



PokerStars Game #59938700392:  Hold'em No Limit ($1/$2) - 2009/07/01 0:21:20 ET
Table 'XP2sRSup+aRuwzx3vDZsDg' 6-max Seat #6 is the button
Seat 1: o9jamqIi6sTTRSqudgboRA ($223.70 in chips)
Seat 3: X7GlkHF+lkbarCLuZ4Uf0w ($36 in chips)
Seat 5: 894kvCY4GHivBpqwizsecg ($120.45 in chips)
Seat 6: h7ppRQJTYBsHCbLMeW9T2g ($455.75 in chips)
o9jamqIi6sTTRSqudgboRA: posts small blind $1
X7GlkHF+lkbarCLuZ4Uf0w: posts big blind $2
*** HOLE CARDS ***
894kvCY4GHivBpqwizsecg: folds
h7ppRQJTYBsHCbLMeW9T2g: folds
o9jamqIi6sTTRSqudgboRA: folds
X7GlkHF+lkbarCLuZ4Uf0w collected $2 from pot
*** SUMMARY ***
Total pot $2 | Rake $0
Seat 1: o9jamqIi6sTTRSqudgboRA (small blind) folded before Flop
Seat 3: X7GlkHF+lkbarCLuZ4Uf0w (big blind) collected ($2)
Seat 5: 894kvCY4GHivBpqwizsecg folded before Flop (didn't bet)
Seat 6: h7ppRQJTYBsHCbLMeW9T2g (button) folded before Flop (didn't bet)



PokerStars Game #59938701128:  Hold'em No Limit ($1/$2) - 2009/07/01 0:21:21 ET
Table 'on4i1U1lCRmxsduFD3xiSg' 9-max Seat #3 is the button
Seat 1: so5k3vFDmokh2q3dImJ1GQ ($115 in chips)
Seat 2: yZYrOeNDxQxkzpbgKX1bng ($79.50 in chips)
Seat 3: 5iPk5MyO3KVu18Y8XCYfFQ ($58.20 in chips)
Seat 4: Z3aYCZG/yXHYFjiWkGI5ug ($528.10 in chips)
Seat 5: QHxJjpVYwitg9krW6wZgJA ($203 in chips)
Seat 6: CUZwDpLTQKhzarPe+JCLOQ ($217.55 in chips)
Seat 7: xD4ElYxz6Ollzmam8BmMCw ($191 in chips)
Seat 8: cdC54j9fGGojcbzWB5PgzA ($200 in chips)
Seat 9: iMe5yhc+1BaiIPHet3NMrA ($200 in chips)
Z3aYCZG/yXHYFjiWkGI5ug: posts small blind $1
QHxJjpVYwitg9krW6wZgJA: posts big blind $2
*** HOLE CARDS ***
CUZwDpLTQKhzarPe+JCLOQ: folds
xD4ElYxz6Ollzmam8BmMCw: folds
cdC54j9fGGojcbzWB5PgzA: folds
iMe5yhc+1BaiIPHet3NMrA: folds
so5k3vFDmokh2q3dImJ1GQ: raises $4 to $6
yZYrOeNDxQxkzpbgKX1bng: folds
5iPk5MyO3KVu18Y8XCYfFQ: folds
Z3aYCZG/yXHYFjiWkGI5ug: folds
QHxJjpVYwitg9krW6wZgJA: folds
so5k3vFDmokh2q3dImJ1GQ collected $5 from pot
*** SUMMARY ***
Total pot $5 | Rake $0
Seat 1: so5k3vFDmokh2q3dImJ1GQ collected ($5)
Seat 2: yZYrOeNDxQxkzpbgKX1bng folded before Flop (didn't bet)
Seat 3: 5iPk5MyO3KVu18Y8XCYfFQ (button) folded before Flop (didn't bet)
Seat 4: Z3aYCZG/yXHYFjiWkGI5ug (small blind) folded before Flop
Seat 5: QHxJjpVYwitg9krW6wZgJA (big blind) folded before Flop
Seat 6: CUZwDpLTQKhzarPe+JCLOQ folded before Flop (didn't bet)
Seat 7: xD4ElYxz6Ollzmam8BmMCw folded before Flop (didn't bet)
Seat 8: cdC54j9fGGojcbzWB5PgzA folded before Flop (didn't bet)
Seat 9: iMe5yhc+1BaiIPHet3NMrA folded before Flop (didn't bet)



PokerStars Game #59938702854:  Hold'em No Limit ($1/$2) - 2009/07/01 0:21:23 ET
Table 'uJ9juaXXg9yIcSU8amxaXQ' 6-max Seat #3 is the button
Seat 2: yynBOXUjw28V5kz84sxX4g ($127.40 in chips)
Seat 3: zaogaltCDFVsIASEnrXs2w ($292 in chips)
Seat 5: aMZYAxFxWTQXE9aUus4sxg ($68.15 in chips)
Seat 6: XrFG4dK06RVKLlX32/pjcQ ($61 in chips)
zNjJ/y4emmF+vzrCDd+ooA will be allowed to play after the button
aMZYAxFxWTQXE9aUus4sxg: posts small blind $1
XrFG4dK06RVKLlX32/pjcQ: posts big blind $2
*** HOLE CARDS ***
yynBOXUjw28V5kz84sxX4g: folds
zaogaltCDFVsIASEnrXs2w: folds
aMZYAxFxWTQXE9aUus4sxg: folds
XrFG4dK06RVKLlX32/pjcQ collected $2 from pot
*** SUMMARY ***
Total pot $2 | Rake $0
Seat 2: yynBOXUjw28V5kz84sxX4g folded before Flop (didn't bet)
Seat 3: zaogaltCDFVsIASEnrXs2w (button) folded before Flop (didn't bet)
Seat 5: aMZYAxFxWTQXE9aUus4sxg (small blind) folded before Flop
Seat 6: XrFG4dK06RVKLlX32/pjcQ (big blind) collected ($2)



PokerStars Game #59938703608:  Hold'em No Limit ($1/$2) - 2009/07/01 0:21:24 ET
Table 'srul5UFZXTEccVV5fpY91g' 9-max Seat #1 is the button
Seat 1: lfD8cBv31A/pio3pXJbPjA ($153.20 in chips)
Seat 2: tJYod1SLp2AcWPL/3hZ7ug ($68.20 in chips)
Seat 3: weUZ8S7tgbaeIpzi1gBNxQ ($48.75 in chips)
Seat 4: GG5lTuGt3+kwNYSbqeB6yw ($104.40 in chips)
Seat 5: 5iPk5MyO3KVu18Y8XCYfFQ ($79.55 in chips)
Seat 6: TAfo4veNRaRlzDXMMYS3Jg ($33 in chips)
Seat 7: s0erZsDxbZSaEPheMgibKg ($456.10 in chips)
Seat 8: UZEsV9yKUMqmpYPiOFpaZw ($75 in chips)
Seat 9: jRGC4KXXODbHEN275TXFCA ($150 in chips)
tJYod1SLp2AcWPL/3hZ7ug: posts small blind $1
weUZ8S7tgbaeIpzi1gBNxQ: posts big blind $2
UZEsV9yKUMqmpYPiOFpaZw: posts big blind $2
jRGC4KXXODbHEN275TXFCA: posts big blind $2
*** HOLE CARDS ***
GG5lTuGt3+kwNYSbqeB6yw: calls $2
5iPk5MyO3KVu18Y8XCYfFQ: folds
TAfo4veNRaRlzDXMMYS3Jg: folds
s0erZsDxbZSaEPheMgibKg: raises $10 to $12
UZEsV9yKUMqmpYPiOFpaZw: folds
jRGC4KXXODbHEN275TXFCA: calls $10
lfD8cBv31A/pio3pXJbPjA: folds
tJYod1SLp2AcWPL/3hZ7ug: folds
weUZ8S7tgbaeIpzi1gBNxQ: folds
GG5lTuGt3+kwNYSbqeB6yw: calls $10
*** FLOP *** [Kc Ad 3d]
GG5lTuGt3+kwNYSbqeB6yw: checks
s0erZsDxbZSaEPheMgibKg: checks
jRGC4KXXODbHEN275TXFCA: bets $25
GG5lTuGt3+kwNYSbqeB6yw: folds
s0erZsDxbZSaEPheMgibKg: folds
jRGC4KXXODbHEN275TXFCA collected $38.95 from pot
*** SUMMARY ***
Total pot $41 | Rake $2.05
Board [Kc Ad 3d]
Seat 1: lfD8cBv31A/pio3pXJbPjA (button) folded before Flop (didn't bet)
Seat 2: tJYod1SLp2AcWPL/3hZ7ug (small blind) folded before Flop
Seat 3: weUZ8S7tgbaeIpzi1gBNxQ (big blind) folded before Flop
Seat 4: GG5lTuGt3+kwNYSbqeB6yw folded on the Flop
Seat 5: 5iPk5MyO3KVu18Y8XCYfFQ folded before Flop (didn't bet)
Seat 6: TAfo4veNRaRlzDXMMYS3Jg folded before Flop (didn't bet)
Seat 7: s0erZsDxbZSaEPheMgibKg folded on the Flop
Seat 8: UZEsV9yKUMqmpYPiOFpaZw folded before Flop
Seat 9: jRGC4KXXODbHEN275TXFCA collected ($38.95)



PokerStars Game #59938703112:  Hold'em No Limit ($1/$2) - 2009/07/01 0:21:24 ET
Table 'OZyw34U4j4WtFFWsEHZQgQ' 2-max Seat #1 is the button
Seat 1: pVqEzK9wXlRMECnb1Zg4Zw ($73.60 in chips)
Seat 2: rAtTyvrJ8f1LaUh2O5U4nA ($50.10 in chips)
pVqEzK9wXlRMECnb1Zg4Zw: posts small blind $1
rAtTyvrJ8f1LaUh2O5U4nA: posts big blind $2
*** HOLE CARDS ***
pVqEzK9wXlRMECnb1Zg4Zw: calls $1
rAtTyvrJ8f1LaUh2O5U4nA: raises $2 to $4
pVqEzK9wXlRMECnb1Zg4Zw: calls $2
*** FLOP *** [4d 8s 9c]
rAtTyvrJ8f1LaUh2O5U4nA: checks
pVqEzK9wXlRMECnb1Zg4Zw: checks
*** TURN *** [4d 8s 9c] [Jc]
rAtTyvrJ8f1LaUh2O5U4nA: checks
pVqEzK9wXlRMECnb1Zg4Zw: checks
*** RIVER *** [4d 8s 9c Jc] [4h]
rAtTyvrJ8f1LaUh2O5U4nA: checks
pVqEzK9wXlRMECnb1Zg4Zw: checks
*** SHOW DOWN ***
rAtTyvrJ8f1LaUh2O5U4nA: shows [5h 5d] (two pair, Fives and Fours)
pVqEzK9wXlRMECnb1Zg4Zw: mucks hand
rAtTyvrJ8f1LaUh2O5U4nA collected $7.60 from pot
*** SUMMARY ***
Total pot $8 | Rake $0.40
Board [4d 8s 9c Jc 4h]
Seat 1: pVqEzK9wXlRMECnb1Zg4Zw (button) (small blind) mucked
Seat 2: rAtTyvrJ8f1LaUh2O5U4nA (big blind) showed [5h 5d] and won ($7.60) with two pair, Fives and Fours



PokerStars Game #59938703576:  Hold'em No Limit ($1/$2) - 2009/07/01 0:21:24 ET
Table '5G1PjWSk2ALz0O/eqyYy/g' 2-max Seat #2 is the button
Seat 1: Z4HwehErEwzsv/noQlfUlg ($169.10 in chips)
Seat 2: v4dp1VoMhJV4zmCXtmG5LQ ($201 in chips)
v4dp1VoMhJV4zmCXtmG5LQ: posts small blind $1
Z4HwehErEwzsv/noQlfUlg: posts big blind $2
*** HOLE CARDS ***
v4dp1VoMhJV4zmCXtmG5LQ: raises $4 to $6
Z4HwehErEwzsv/noQlfUlg: calls $4
*** FLOP *** [2d 6h 5d]
Z4HwehErEwzsv/noQlfUlg: checks
v4dp1VoMhJV4zmCXtmG5LQ: checks
*** TURN *** [2d 6h 5d] [7d]
Z4HwehErEwzsv/noQlfUlg: checks
v4dp1VoMhJV4zmCXtmG5LQ: bets $10
Z4HwehErEwzsv/noQlfUlg: folds
v4dp1VoMhJV4zmCXtmG5LQ collected $11.50 from pot
v4dp1VoMhJV4zmCXtmG5LQ: doesn't show hand
*** SUMMARY ***
Total pot $12 | Rake $0.50
Board [2d 6h 5d 7d]
Seat 1: Z4HwehErEwzsv/noQlfUlg (big blind) folded on the Turn
Seat 2: v4dp1VoMhJV4zmCXtmG5LQ (button) (small blind) collected ($11.50)



PokerStars Game #59938705326:  Hold'em No Limit ($1/$2) - 2009/07/01 0:21:27 ET
Table 'qVXak+oTeDXMGbWa4sDU5Q' 9-max Seat #5 is the button
Seat 1: H6Z4+qu8gR0VUiPOijndVg ($257.30 in chips)
Seat 2: Hc2itIxwbi1lwa+DAYYQGg ($46 in chips)
Seat 3: oz9eCXGC7DdjQlL/nuWj1A ($117.65 in chips)
Seat 4: lQYT23h5QCUVZAKxjOO39Q ($200 in chips)
Seat 5: NqKRc5xvcye0d7F6VOF6MQ ($169.65 in chips)
Seat 7: 5iPk5MyO3KVu18Y8XCYfFQ ($107 in chips)
Seat 8: 9pHZMviI9R8injxojGTnvw ($30.80 in chips)
Seat 9: ZP45Tu5Zqo4v+ZgqIQVoOQ ($197 in chips)
5iPk5MyO3KVu18Y8XCYfFQ: posts small blind $1
9pHZMviI9R8injxojGTnvw: posts big blind $2
lQYT23h5QCUVZAKxjOO39Q: posts big blind $2
*** HOLE CARDS ***
ZP45Tu5Zqo4v+ZgqIQVoOQ: folds
H6Z4+qu8gR0VUiPOijndVg: folds
Hc2itIxwbi1lwa+DAYYQGg: folds
oz9eCXGC7DdjQlL/nuWj1A: calls $2
lQYT23h5QCUVZAKxjOO39Q: checks
NqKRc5xvcye0d7F6VOF6MQ: folds
5iPk5MyO3KVu18Y8XCYfFQ: folds
9pHZMviI9R8injxojGTnvw: checks
*** FLOP *** [3h Js 5d]
9pHZMviI9R8injxojGTnvw: checks
oz9eCXGC7DdjQlL/nuWj1A: bets $4
lQYT23h5QCUVZAKxjOO39Q: folds
9pHZMviI9R8injxojGTnvw: folds
oz9eCXGC7DdjQlL/nuWj1A collected $6.65 from pot
*** SUMMARY ***
Total pot $7 | Rake $0.35
Board [3h Js 5d]
Seat 1: H6Z4+qu8gR0VUiPOijndVg folded before Flop (didn't bet)
Seat 2: Hc2itIxwbi1lwa+DAYYQGg folded before Flop (didn't bet)
Seat 3: oz9eCXGC7DdjQlL/nuWj1A collected ($6.65)
Seat 4: lQYT23h5QCUVZAKxjOO39Q folded on the Flop
Seat 5: NqKRc5xvcye0d7F6VOF6MQ (button) folded before Flop (didn't bet)
Seat 7: 5iPk5MyO3KVu18Y8XCYfFQ (small blind) folded before Flop
Seat 8: 9pHZMviI9R8injxojGTnvw (big blind) folded on the Flop
Seat 9: ZP45Tu5Zqo4v+ZgqIQVoOQ folded before Flop (didn't bet)



PokerStars Game #59938707384:  Hold'em No Limit ($1/$2) - 2009/07/01 0:21:30 ET
Table 'eyAQSIlgc2o1Jxvbve4WGg' 9-max Seat #4 is the button
Seat 1: UZEsV9yKUMqmpYPiOFpaZw ($73 in chips)
Seat 2: g7gL2NLJCdZPPV399WKT1w ($48 in chips)
Seat 3: TAfo4veNRaRlzDXMMYS3Jg ($37 in chips)
Seat 4: miAHPEBdznuHNzK6YM3hRA ($119.95 in chips)
Seat 5: JnV3SM2D6dAFYyGZHHpvrg ($95 in chips)
Seat 6: IikcENBHwoT7snSvBPSc7Q ($170.60 in chips)
Seat 7: QHxJjpVYwitg9krW6wZgJA ($204.65 in chips)
Seat 8: 5iPk5MyO3KVu18Y8XCYfFQ ($40 in chips)
Seat 9: Hc2itIxwbi1lwa+DAYYQGg ($41.85 in chips)
JnV3SM2D6dAFYyGZHHpvrg: posts small blind $1
IikcENBHwoT7snSvBPSc7Q: posts big blind $2
*** HOLE CARDS ***
QHxJjpVYwitg9krW6wZgJA: folds
5iPk5MyO3KVu18Y8XCYfFQ: folds
Hc2itIxwbi1lwa+DAYYQGg: folds
UZEsV9yKUMqmpYPiOFpaZw: folds
g7gL2NLJCdZPPV399WKT1w: folds
TAfo4veNRaRlzDXMMYS3Jg: folds
miAHPEBdznuHNzK6YM3hRA: calls $2
JnV3SM2D6dAFYyGZHHpvrg: folds
IikcENBHwoT7snSvBPSc7Q: checks
*** FLOP *** [7d 8d 5h]
IikcENBHwoT7snSvBPSc7Q: bets $4
miAHPEBdznuHNzK6YM3hRA: calls $4
*** TURN *** [7d 8d 5h] [8h]
IikcENBHwoT7snSvBPSc7Q: checks
miAHPEBdznuHNzK6YM3hRA: bets $14
IikcENBHwoT7snSvBPSc7Q: calls $14
*** RIVER *** [7d 8d 5h 8h] [7s]
IikcENBHwoT7snSvBPSc7Q: checks
miAHPEBdznuHNzK6YM3hRA: bets $52
IikcENBHwoT7snSvBPSc7Q: folds
miAHPEBdznuHNzK6YM3hRA collected $39 from pot
miAHPEBdznuHNzK6YM3hRA: shows [9s 6d] (a straight, Five to Nine)
*** SUMMARY ***
Total pot $41 | Rake $2
Board [7d 8d 5h 8h 7s]
Seat 1: UZEsV9yKUMqmpYPiOFpaZw folded before Flop (didn't bet)
Seat 2: g7gL2NLJCdZPPV399WKT1w folded before Flop (didn't bet)
Seat 3: TAfo4veNRaRlzDXMMYS3Jg folded before Flop (didn't bet)
Seat 4: miAHPEBdznuHNzK6YM3hRA (button) collected ($39)
Seat 5: JnV3SM2D6dAFYyGZHHpvrg (small blind) folded before Flop
Seat 6: IikcENBHwoT7snSvBPSc7Q (big blind) folded on the River
Seat 7: QHxJjpVYwitg9krW6wZgJA folded before Flop (didn't bet)
Seat 8: 5iPk5MyO3KVu18Y8XCYfFQ folded before Flop (didn't bet)
Seat 9: Hc2itIxwbi1lwa+DAYYQGg folded before Flop (didn't bet)



PokerStars Game #59938707362:  Hold'em No Limit ($1/$2) - 2009/07/01 0:21:30 ET
Table 'mGpP9StWRnoeiBDExc6Frg' 6-max Seat #3 is the button
Seat 1: zWFU82nxIRvzK4mKiL4m0Q ($62.85 in chips)
Seat 2: DQlskgG4OtLpF2MVxLwf4A ($311.85 in chips)
Seat 3: 3HrFUl+TAqSP1U00zz3P7A ($73.60 in chips)
Seat 4: qXDd0ZyMIse0OBu8pxeQ3Q ($216 in chips)
Seat 5: d1puGuVBE0fidn+5eRJ0tw ($167.70 in chips)
Seat 6: X7GlkHF+lkbarCLuZ4Uf0w ($23.45 in chips)
qXDd0ZyMIse0OBu8pxeQ3Q: posts small blind $1
d1puGuVBE0fidn+5eRJ0tw: posts big blind $2
*** HOLE CARDS ***
X7GlkHF+lkbarCLuZ4Uf0w: folds
zWFU82nxIRvzK4mKiL4m0Q: folds
DQlskgG4OtLpF2MVxLwf4A: folds
3HrFUl+TAqSP1U00zz3P7A: folds
qXDd0ZyMIse0OBu8pxeQ3Q: raises $4 to $6
d1puGuVBE0fidn+5eRJ0tw: folds
qXDd0ZyMIse0OBu8pxeQ3Q collected $4 from pot
*** SUMMARY ***
Total pot $4 | Rake $0
Seat 1: zWFU82nxIRvzK4mKiL4m0Q folded before Flop (didn't bet)
Seat 2: DQlskgG4OtLpF2MVxLwf4A folded before Flop (didn't bet)
Seat 3: 3HrFUl+TAqSP1U00zz3P7A (button) folded before Flop (didn't bet)
Seat 4: qXDd0ZyMIse0OBu8pxeQ3Q (small blind) collected ($4)
Seat 5: d1puGuVBE0fidn+5eRJ0tw (big blind) folded before Flop
Seat 6: X7GlkHF+lkbarCLuZ4Uf0w folded before Flop (didn't bet)



PokerStars Game #59938708576:  Hold'em No Limit ($1/$2) - 2009/07/01 0:21:31 ET
Table 'aSf77Sj8QEnzcc0WaxVD4Q' 6-max Seat #5 is the button
Seat 1: 54yWzRRgS0oZ+S6LwZBxMQ ($40 in chips)
Seat 2: vkfxu8f/jMYKUk6Ly4eujw ($256.15 in chips)
Seat 3: 9dpyyjDTCed6nV7JhaUUpw ($200 in chips)
Seat 4: 513FcCI8jHyQy2VWoIQkMg ($201.75 in chips)
Seat 5: InmkdI6G8TzSj9NhcCSyPg ($247 in chips)
Seat 6: vkoJRf3gidxY1pPi0AFWww ($302.15 in chips)
vkoJRf3gidxY1pPi0AFWww: posts small blind $1
54yWzRRgS0oZ+S6LwZBxMQ: posts big blind $2
*** HOLE CARDS ***
vkfxu8f/jMYKUk6Ly4eujw: folds
9dpyyjDTCed6nV7JhaUUpw: raises $4 to $6
513FcCI8jHyQy2VWoIQkMg: folds
InmkdI6G8TzSj9NhcCSyPg: folds
vkoJRf3gidxY1pPi0AFWww: calls $5
54yWzRRgS0oZ+S6LwZBxMQ: folds
*** FLOP *** [5d 3s Th]
vkoJRf3gidxY1pPi0AFWww: checks
9dpyyjDTCed6nV7JhaUUpw: bets $8
vkoJRf3gidxY1pPi0AFWww: folds
9dpyyjDTCed6nV7JhaUUpw collected $13.30 from pot
9dpyyjDTCed6nV7JhaUUpw: doesn't show hand
*** SUMMARY ***
Total pot $14 | Rake $0.70
Board [5d 3s Th]
Seat 1: 54yWzRRgS0oZ+S6LwZBxMQ (big blind) folded before Flop
Seat 2: vkfxu8f/jMYKUk6Ly4eujw folded before Flop (didn't bet)
Seat 3: 9dpyyjDTCed6nV7JhaUUpw collected ($13.30)
Seat 4: 513FcCI8jHyQy2VWoIQkMg folded before Flop (didn't bet)
Seat 5: InmkdI6G8TzSj9NhcCSyPg (button) folded before Flop (didn't bet)
Seat 6: vkoJRf3gidxY1pPi0AFWww (small blind) folded on the Flop



PokerStars Game #59938712408:  Hold'em No Limit ($1/$2) - 2009/07/01 0:21:37 ET
Table 'uJ9juaXXg9yIcSU8amxaXQ' 6-max Seat #5 is the button
Seat 2: yynBOXUjw28V5kz84sxX4g ($127.40 in chips)
Seat 3: zaogaltCDFVsIASEnrXs2w ($292 in chips)
Seat 4: zNjJ/y4emmF+vzrCDd+ooA ($120 in chips)
Seat 5: aMZYAxFxWTQXE9aUus4sxg ($67.15 in chips)
Seat 6: XrFG4dK06RVKLlX32/pjcQ ($62 in chips)
XrFG4dK06RVKLlX32/pjcQ: posts small blind $1
yynBOXUjw28V5kz84sxX4g: posts big blind $2
zNjJ/y4emmF+vzrCDd+ooA: posts big blind $2
*** HOLE CARDS ***
zaogaltCDFVsIASEnrXs2w: folds
zNjJ/y4emmF+vzrCDd+ooA: checks
aMZYAxFxWTQXE9aUus4sxg: calls $2
XrFG4dK06RVKLlX32/pjcQ: calls $1
yynBOXUjw28V5kz84sxX4g: checks
*** FLOP *** [5c Ts 7s]
XrFG4dK06RVKLlX32/pjcQ: checks
yynBOXUjw28V5kz84sxX4g: bets $4
zNjJ/y4emmF+vzrCDd+ooA: folds
aMZYAxFxWTQXE9aUus4sxg: folds
XrFG4dK06RVKLlX32/pjcQ: calls $4
*** TURN *** [5c Ts 7s] [9d]
XrFG4dK06RVKLlX32/pjcQ: checks
yynBOXUjw28V5kz84sxX4g: bets $6
XrFG4dK06RVKLlX32/pjcQ: calls $6
*** RIVER *** [5c Ts 7s 9d] [3c]
XrFG4dK06RVKLlX32/pjcQ: checks
yynBOXUjw28V5kz84sxX4g: bets $18
XrFG4dK06RVKLlX32/pjcQ: folds
yynBOXUjw28V5kz84sxX4g collected $26.65 from pot
*** SUMMARY ***
Total pot $28 | Rake $1.35
Board [5c Ts 7s 9d 3c]
Seat 2: yynBOXUjw28V5kz84sxX4g (big blind) collected ($26.65)
Seat 3: zaogaltCDFVsIASEnrXs2w folded before Flop (didn't bet)
Seat 4: zNjJ/y4emmF+vzrCDd+ooA folded on the Flop
Seat 5: aMZYAxFxWTQXE9aUus4sxg (button) folded on the Flop
Seat 6: XrFG4dK06RVKLlX32/pjcQ (small blind) folded on the River



PokerStars Game #59938713198:  Hold'em No Limit ($1/$2) - 2009/07/01 0:21:38 ET
Table 'W9UeSV0aoPjh5SFSxM8jUQ' 9-max Seat #5 is the button
Seat 1: cdC54j9fGGojcbzWB5PgzA ($204.60 in chips)
Seat 2: iMe5yhc+1BaiIPHet3NMrA ($316.75 in chips)
Seat 3: TAfo4veNRaRlzDXMMYS3Jg ($37 in chips)
Seat 4: De9g+AYjo0DN6C/+iT/nsg ($286.10 in chips)
Seat 5: CUZwDpLTQKhzarPe+JCLOQ ($200 in chips)
Seat 6: MXxB6weBWzZyAhRZb+/KVg ($194 in chips)
Seat 7: 4Cl43Q1TYQL8wn1NSCUkaw ($44.60 in chips)
Seat 9: U2A5Hv6ib/5+gzO2wr7Z4w ($203 in chips)
MXxB6weBWzZyAhRZb+/KVg: posts small blind $1
4Cl43Q1TYQL8wn1NSCUkaw: posts big blind $2
*** HOLE CARDS ***
U2A5Hv6ib/5+gzO2wr7Z4w: folds
cdC54j9fGGojcbzWB5PgzA: folds
iMe5yhc+1BaiIPHet3NMrA: folds
TAfo4veNRaRlzDXMMYS3Jg: folds
z89zAYE4dlPgjkofBKII0Q leaves the table
De9g+AYjo0DN6C/+iT/nsg: folds
CUZwDpLTQKhzarPe+JCLOQ: folds
MXxB6weBWzZyAhRZb+/KVg: folds
GX1heJ+DSsvm7gzSPsYhhQ joins the table at seat #8
4Cl43Q1TYQL8wn1NSCUkaw collected $2 from pot
*** SUMMARY ***
Total pot $2 | Rake $0
Seat 1: cdC54j9fGGojcbzWB5PgzA folded before Flop (didn't bet)
Seat 2: iMe5yhc+1BaiIPHet3NMrA folded before Flop (didn't bet)
Seat 3: TAfo4veNRaRlzDXMMYS3Jg folded before Flop (didn't bet)
Seat 4: De9g+AYjo0DN6C/+iT/nsg folded before Flop (didn't bet)
Seat 5: CUZwDpLTQKhzarPe+JCLOQ (button) folded before Flop (didn't bet)
Seat 6: MXxB6weBWzZyAhRZb+/KVg (small blind) folded before Flop
Seat 7: 4Cl43Q1TYQL8wn1NSCUkaw (big blind) collected ($2)
Seat 9: U2A5Hv6ib/5+gzO2wr7Z4w folded before Flop (didn't bet)



PokerStars Game #59938714760:  Hold'em No Limit ($1/$2) - 2009/07/01 0:21:41 ET
Table 'SF49/KQm8T4taMp6kb+HXA' 9-max Seat #6 is the button
Seat 1: l1bCLGuFqeFRwUfPsiDu/g ($287.95 in chips)
Seat 2: 8Z3QifiM9eOd5EIJ25dXNg ($40 in chips)
Seat 3: pCmk6FpSOLJ+85o1tLHIag ($98 in chips)
Seat 4: HffgoYm61KgkdMe/DYChIQ ($114 in chips)
Seat 5: Z3aYCZG/yXHYFjiWkGI5ug ($223.55 in chips)
Seat 6: M2ht6rIKOI/my9eh610Nlw ($225.40 in chips)
Seat 7: n2VAbLaE5qgKr5mA4W6v4w ($33.50 in chips)
Seat 8: 5iPk5MyO3KVu18Y8XCYfFQ ($40 in chips)
Seat 9: O+jytCilwk7zItVCEavmtw ($169.55 in chips)
n2VAbLaE5qgKr5mA4W6v4w: posts small blind $1
5iPk5MyO3KVu18Y8XCYfFQ: posts big blind $2
*** HOLE CARDS ***
O+jytCilwk7zItVCEavmtw: folds
O+jytCilwk7zItVCEavmtw leaves the table
l1bCLGuFqeFRwUfPsiDu/g: raises $6 to $8
8Z3QifiM9eOd5EIJ25dXNg: folds
pCmk6FpSOLJ+85o1tLHIag: folds
HffgoYm61KgkdMe/DYChIQ: folds
Z3aYCZG/yXHYFjiWkGI5ug: folds
M2ht6rIKOI/my9eh610Nlw: folds
n2VAbLaE5qgKr5mA4W6v4w: folds
5iPk5MyO3KVu18Y8XCYfFQ: folds
l1bCLGuFqeFRwUfPsiDu/g collected $5 from pot
*** SUMMARY ***
Total pot $5 | Rake $0
Seat 1: l1bCLGuFqeFRwUfPsiDu/g collected ($5)
Seat 2: 8Z3QifiM9eOd5EIJ25dXNg folded before Flop (didn't bet)
Seat 3: pCmk6FpSOLJ+85o1tLHIag folded before Flop (didn't bet)
Seat 4: HffgoYm61KgkdMe/DYChIQ folded before Flop (didn't bet)
Seat 5: Z3aYCZG/yXHYFjiWkGI5ug folded before Flop (didn't bet)
Seat 6: M2ht6rIKOI/my9eh610Nlw (button) folded before Flop (didn't bet)
Seat 7: n2VAbLaE5qgKr5mA4W6v4w (small blind) folded before Flop
Seat 8: 5iPk5MyO3KVu18Y8XCYfFQ (big blind) folded before Flop
Seat 9: O+jytCilwk7zItVCEavmtw folded before Flop (didn't bet)



PokerStars Game #59938716658:  Hold'em No Limit ($1/$2) - 2009/07/01 0:21:43 ET
Table 'XP2sRSup+aRuwzx3vDZsDg' 6-max Seat #1 is the button
Seat 1: o9jamqIi6sTTRSqudgboRA ($222.70 in chips)
Seat 3: X7GlkHF+lkbarCLuZ4Uf0w ($37 in chips)
Seat 5: 894kvCY4GHivBpqwizsecg ($120.45 in chips)
Seat 6: h7ppRQJTYBsHCbLMeW9T2g ($455.75 in chips)
X7GlkHF+lkbarCLuZ4Uf0w: posts small blind $1
894kvCY4GHivBpqwizsecg: posts big blind $2
*** HOLE CARDS ***
h7ppRQJTYBsHCbLMeW9T2g: raises $4 to $6
hCtfSY4dRapM2rhEFmS4Ug joins the table at seat #4
o9jamqIi6sTTRSqudgboRA: calls $6
X7GlkHF+lkbarCLuZ4Uf0w: folds
894kvCY4GHivBpqwizsecg: calls $4
*** FLOP *** [8d 6c 7s]
894kvCY4GHivBpqwizsecg: checks
h7ppRQJTYBsHCbLMeW9T2g: checks
o9jamqIi6sTTRSqudgboRA: checks
*** TURN *** [8d 6c 7s] [3d]
894kvCY4GHivBpqwizsecg: checks
h7ppRQJTYBsHCbLMeW9T2g: checks
o9jamqIi6sTTRSqudgboRA: bets $13
ygTTt5ehT4aF86q1a8/R+w joins the table at seat #2
894kvCY4GHivBpqwizsecg: folds
h7ppRQJTYBsHCbLMeW9T2g: folds
o9jamqIi6sTTRSqudgboRA collected $18.05 from pot
*** SUMMARY ***
Total pot $19 | Rake $0.95
Board [8d 6c 7s 3d]
Seat 1: o9jamqIi6sTTRSqudgboRA (button) collected ($18.05)
Seat 3: X7GlkHF+lkbarCLuZ4Uf0w (small blind) folded before Flop
Seat 5: 894kvCY4GHivBpqwizsecg (big blind) folded on the Turn
Seat 6: h7ppRQJTYBsHCbLMeW9T2g folded on the Turn



PokerStars Game #59938717410:  Hold'em No Limit ($1/$2) - 2009/07/01 0:21:44 ET
Table 'bIihwBANJSFqlHPPtset+w' 9-max Seat #5 is the button
Seat 1: jI3JDUGV63ccqtKgM3vMbw ($159.70 in chips)
Seat 2: lQYT23h5QCUVZAKxjOO39Q ($118.90 in chips)
Seat 3: acnZ0LD5jxKgWIHz+mpQ8Q ($200 in chips)
Seat 4: 7WWX5PClBdr/U44gUKBIEA ($293.05 in chips)
Seat 5: rNejrG5tkeRBbL+UmC0iJA ($162 in chips)
Seat 6: 5iPk5MyO3KVu18Y8XCYfFQ ($87.80 in chips)
Seat 8: iMe5yhc+1BaiIPHet3NMrA ($278.65 in chips)
Seat 9: rW/MyplHylMSBRaoRUzWrg ($40 in chips)
5iPk5MyO3KVu18Y8XCYfFQ: posts small blind $1
3q2/0oJr3Mcy1W5tcN61ug: is sitting out
iMe5yhc+1BaiIPHet3NMrA: posts big blind $2
*** HOLE CARDS ***
3q2/0oJr3Mcy1W5tcN61ug leaves the table
rW/MyplHylMSBRaoRUzWrg: folds
jI3JDUGV63ccqtKgM3vMbw: folds
lQYT23h5QCUVZAKxjOO39Q: folds
acnZ0LD5jxKgWIHz+mpQ8Q: raises $4 to $6
7WWX5PClBdr/U44gUKBIEA: folds
rNejrG5tkeRBbL+UmC0iJA: calls $6
pCmk6FpSOLJ+85o1tLHIag joins the table at seat #7
5iPk5MyO3KVu18Y8XCYfFQ: folds
iMe5yhc+1BaiIPHet3NMrA: folds
*** FLOP *** [Ad 9c Jd]
acnZ0LD5jxKgWIHz+mpQ8Q: bets $11
rNejrG5tkeRBbL+UmC0iJA: calls $11
*** TURN *** [Ad 9c Jd] [6h]
acnZ0LD5jxKgWIHz+mpQ8Q: checks
rNejrG5tkeRBbL+UmC0iJA: bets $30
acnZ0LD5jxKgWIHz+mpQ8Q: folds
rNejrG5tkeRBbL+UmC0iJA collected $35.20 from pot
*** SUMMARY ***
Total pot $37 | Rake $1.80
Board [Ad 9c Jd 6h]
Seat 1: jI3JDUGV63ccqtKgM3vMbw folded before Flop (didn't bet)
Seat 2: lQYT23h5QCUVZAKxjOO39Q folded before Flop (didn't bet)
Seat 3: acnZ0LD5jxKgWIHz+mpQ8Q folded on the Turn
Seat 4: 7WWX5PClBdr/U44gUKBIEA folded before Flop (didn't bet)
Seat 5: rNejrG5tkeRBbL+UmC0iJA (button) collected ($35.20)
Seat 6: 5iPk5MyO3KVu18Y8XCYfFQ (small blind) folded before Flop
Seat 8: iMe5yhc+1BaiIPHet3NMrA (big blind) folded before Flop
Seat 9: rW/MyplHylMSBRaoRUzWrg folded before Flop (didn't bet)



PokerStars Game #59938718216:  Hold'em No Limit ($1/$2) - 2009/07/01 0:21:45 ET
Table 'jlrIxbrVIG+gjaUYT4za8g' 6-max Seat #5 is the button
Seat 1: ygTTt5ehT4aF86q1a8/R+w ($193.05 in chips)
Seat 2: N18PrNGQj43J7TJuQuu+tw ($141.10 in chips)
Seat 3: 54yWzRRgS0oZ+S6LwZBxMQ ($37.80 in chips)
Seat 4: 8srN1dKQePlsv0GyTada+Q ($221 in chips)
Seat 5: VuZb/hkEc4X7s93w2ZZTpA ($200 in chips)
Seat 6: vkfxu8f/jMYKUk6Ly4eujw ($272.95 in chips)
vkfxu8f/jMYKUk6Ly4eujw: posts small blind $1
ygTTt5ehT4aF86q1a8/R+w: posts big blind $2
*** HOLE CARDS ***
N18PrNGQj43J7TJuQuu+tw: folds
54yWzRRgS0oZ+S6LwZBxMQ: folds
8srN1dKQePlsv0GyTada+Q: folds
VuZb/hkEc4X7s93w2ZZTpA: folds
vkfxu8f/jMYKUk6Ly4eujw: folds
ygTTt5ehT4aF86q1a8/R+w collected $2 from pot
*** SUMMARY ***
Total pot $2 | Rake $0
Seat 1: ygTTt5ehT4aF86q1a8/R+w (big blind) collected ($2)
Seat 2: N18PrNGQj43J7TJuQuu+tw folded before Flop (didn't bet)
Seat 3: 54yWzRRgS0oZ+S6LwZBxMQ folded before Flop (didn't bet)
Seat 4: 8srN1dKQePlsv0GyTada+Q folded before Flop (didn't bet)
Seat 5: VuZb/hkEc4X7s93w2ZZTpA (button) folded before Flop (didn't bet)
Seat 6: vkfxu8f/jMYKUk6Ly4eujw (small blind) folded before Flop



PokerStars Game #59938718424:  Hold'em No Limit ($1/$2) - 2009/07/01 0:21:46 ET
Table 'OZyw34U4j4WtFFWsEHZQgQ' 2-max Seat #2 is the button
Seat 1: pVqEzK9wXlRMECnb1Zg4Zw ($69.60 in chips)
Seat 2: rAtTyvrJ8f1LaUh2O5U4nA ($53.70 in chips)
rAtTyvrJ8f1LaUh2O5U4nA: posts small blind $1
pVqEzK9wXlRMECnb1Zg4Zw: posts big blind $2
*** HOLE CARDS ***
rAtTyvrJ8f1LaUh2O5U4nA: calls $1
pVqEzK9wXlRMECnb1Zg4Zw: raises $8 to $10
rAtTyvrJ8f1LaUh2O5U4nA: raises $43.70 to $53.70 and is all-in
pVqEzK9wXlRMECnb1Zg4Zw: folds
rAtTyvrJ8f1LaUh2O5U4nA collected $20 from pot
*** SUMMARY ***
Total pot $20 | Rake $0
Seat 1: pVqEzK9wXlRMECnb1Zg4Zw (big blind) folded before Flop
Seat 2: rAtTyvrJ8f1LaUh2O5U4nA (button) (small blind) collected ($20)



PokerStars Game #59938720318:  Hold'em No Limit ($1/$2) - 2009/07/01 0:21:49 ET
Table 'NmY84NAf9Mh0ckAckHnh5g' 2-max Seat #2 is the button
Seat 1: 6hvg964TSqZ3AL/0XK9aVQ ($650.95 in chips)
Seat 2: RwDoM55ZeQuI2ADyJhOb2Q ($169 in chips)
RwDoM55ZeQuI2ADyJhOb2Q: posts small blind $1
6hvg964TSqZ3AL/0XK9aVQ: posts big blind $2
*** HOLE CARDS ***
RwDoM55ZeQuI2ADyJhOb2Q: raises $4 to $6
6hvg964TSqZ3AL/0XK9aVQ: calls $4
*** FLOP *** [Jh 7s 6s]
6hvg964TSqZ3AL/0XK9aVQ: checks
RwDoM55ZeQuI2ADyJhOb2Q: bets $10
6hvg964TSqZ3AL/0XK9aVQ: folds
RwDoM55ZeQuI2ADyJhOb2Q collected $11.50 from pot
RwDoM55ZeQuI2ADyJhOb2Q: doesn't show hand
*** SUMMARY ***
Total pot $12 | Rake $0.50
Board [Jh 7s 6s]
Seat 1: 6hvg964TSqZ3AL/0XK9aVQ (big blind) folded on the Flop
Seat 2: RwDoM55ZeQuI2ADyJhOb2Q (button) (small blind) collected ($11.50)



PokerStars Game #59938722576:  Hold'em No Limit ($1/$2) - 2009/07/01 0:21:52 ET
Table '5G1PjWSk2ALz0O/eqyYy/g' 2-max Seat #1 is the button
Seat 1: Z4HwehErEwzsv/noQlfUlg ($163.10 in chips)
Seat 2: v4dp1VoMhJV4zmCXtmG5LQ ($206.50 in chips)
Z4HwehErEwzsv/noQlfUlg: posts small blind $1
v4dp1VoMhJV4zmCXtmG5LQ: posts big blind $2
*** HOLE CARDS ***
Z4HwehErEwzsv/noQlfUlg: raises $2 to $4
v4dp1VoMhJV4zmCXtmG5LQ: raises $6 to $10
Z4HwehErEwzsv/noQlfUlg: folds
v4dp1VoMhJV4zmCXtmG5LQ collected $8 from pot
v4dp1VoMhJV4zmCXtmG5LQ: doesn't show hand
*** SUMMARY ***
Total pot $8 | Rake $0
Seat 1: Z4HwehErEwzsv/noQlfUlg (button) (small blind) folded before Flop
Seat 2: v4dp1VoMhJV4zmCXtmG5LQ (big blind) collected ($8)



PokerStars Game #59938724274:  Hold'em No Limit ($1/$2) - 2009/07/01 0:21:54 ET
Table 'on4i1U1lCRmxsduFD3xiSg' 9-max Seat #4 is the button
Seat 1: so5k3vFDmokh2q3dImJ1GQ ($118 in chips)
Seat 2: yZYrOeNDxQxkzpbgKX1bng ($79.50 in chips)
Seat 3: 5iPk5MyO3KVu18Y8XCYfFQ ($58.20 in chips)
Seat 4: Z3aYCZG/yXHYFjiWkGI5ug ($527.10 in chips)
Seat 5: QHxJjpVYwitg9krW6wZgJA ($201 in chips)
Seat 6: CUZwDpLTQKhzarPe+JCLOQ ($217.55 in chips)
Seat 7: xD4ElYxz6Ollzmam8BmMCw ($191 in chips)
Seat 8: cdC54j9fGGojcbzWB5PgzA ($200 in chips)
Seat 9: iMe5yhc+1BaiIPHet3NMrA ($200 in chips)
QHxJjpVYwitg9krW6wZgJA: posts small blind $1
CUZwDpLTQKhzarPe+JCLOQ: posts big blind $2
*** HOLE CARDS ***
xD4ElYxz6Ollzmam8BmMCw: calls $2
cdC54j9fGGojcbzWB5PgzA: folds
iMe5yhc+1BaiIPHet3NMrA: folds
so5k3vFDmokh2q3dImJ1GQ: calls $2
yZYrOeNDxQxkzpbgKX1bng: raises $8 to $10
5iPk5MyO3KVu18Y8XCYfFQ: folds
Z3aYCZG/yXHYFjiWkGI5ug: folds
QHxJjpVYwitg9krW6wZgJA: folds
CUZwDpLTQKhzarPe+JCLOQ: folds
xD4ElYxz6Ollzmam8BmMCw: folds
so5k3vFDmokh2q3dImJ1GQ: calls $8
*** FLOP *** [Kh 8s Kc]
so5k3vFDmokh2q3dImJ1GQ: checks
yZYrOeNDxQxkzpbgKX1bng: bets $20
so5k3vFDmokh2q3dImJ1GQ: folds
yZYrOeNDxQxkzpbgKX1bng collected $23.75 from pot
*** SUMMARY ***
Total pot $25 | Rake $1.25
Board [Kh 8s Kc]
Seat 1: so5k3vFDmokh2q3dImJ1GQ folded on the Flop
Seat 2: yZYrOeNDxQxkzpbgKX1bng collected ($23.75)
Seat 3: 5iPk5MyO3KVu18Y8XCYfFQ folded before Flop (didn't bet)
Seat 4: Z3aYCZG/yXHYFjiWkGI5ug (button) folded before Flop (didn't bet)
Seat 5: QHxJjpVYwitg9krW6wZgJA (small blind) folded before Flop
Seat 6: CUZwDpLTQKhzarPe+JCLOQ (big blind) folded before Flop
Seat 7: xD4ElYxz6Ollzmam8BmMCw folded before Flop
Seat 8: cdC54j9fGGojcbzWB5PgzA folded before Flop (didn't bet)
Seat 9: iMe5yhc+1BaiIPHet3NMrA folded before Flop (didn't bet)



PokerStars Game #59938727052:  Hold'em No Limit ($1/$2) - 2009/07/01 0:21:59 ET
Table 'P/yCfYl1GfGsu/e6DxDy/A' 2-max Seat #1 is the button
Seat 1: 7fOCUy3x9hdkmXkkDNolGQ ($258.50 in chips)
Seat 2: RwDoM55ZeQuI2ADyJhOb2Q ($524.50 in chips)
7fOCUy3x9hdkmXkkDNolGQ: posts small blind $1
RwDoM55ZeQuI2ADyJhOb2Q: posts big blind $2
*** HOLE CARDS ***
7fOCUy3x9hdkmXkkDNolGQ: folds
RwDoM55ZeQuI2ADyJhOb2Q collected $2 from pot
RwDoM55ZeQuI2ADyJhOb2Q: doesn't show hand
*** SUMMARY ***
Total pot $2 | Rake $0
Seat 1: 7fOCUy3x9hdkmXkkDNolGQ (button) (small blind) folded before Flop
Seat 2: RwDoM55ZeQuI2ADyJhOb2Q (big blind) collected ($2)



PokerStars Game #59938730418:  Hold'em No Limit ($1/$2) - 2009/07/01 0:22:04 ET
Table 'NmY84NAf9Mh0ckAckHnh5g' 2-max Seat #1 is the button
Seat 1: 6hvg964TSqZ3AL/0XK9aVQ ($644.95 in chips)
Seat 2: RwDoM55ZeQuI2ADyJhOb2Q ($200 in chips)
6hvg964TSqZ3AL/0XK9aVQ: posts small blind $1
RwDoM55ZeQuI2ADyJhOb2Q: posts big blind $2
*** HOLE CARDS ***
6hvg964TSqZ3AL/0XK9aVQ: calls $1
RwDoM55ZeQuI2ADyJhOb2Q: raises $8 to $10
6hvg964TSqZ3AL/0XK9aVQ: calls $8
*** FLOP *** [5h Qd 4h]
RwDoM55ZeQuI2ADyJhOb2Q: bets $22
6hvg964TSqZ3AL/0XK9aVQ: calls $22
*** TURN *** [5h Qd 4h] [Tc]
RwDoM55ZeQuI2ADyJhOb2Q: bets $52
6hvg964TSqZ3AL/0XK9aVQ: folds
RwDoM55ZeQuI2ADyJhOb2Q collected $63.50 from pot
RwDoM55ZeQuI2ADyJhOb2Q: doesn't show hand
*** SUMMARY ***
Total pot $64 | Rake $0.50
Board [5h Qd 4h Tc]
Seat 1: 6hvg964TSqZ3AL/0XK9aVQ (button) (small blind) folded on the Turn
Seat 2: RwDoM55ZeQuI2ADyJhOb2Q (big blind) collected ($63.50)



PokerStars Game #59938731300:  Hold'em No Limit ($1/$2) - 2009/07/01 0:22:05 ET
Table 'OZyw34U4j4WtFFWsEHZQgQ' 2-max Seat #1 is the button
Seat 1: pVqEzK9wXlRMECnb1Zg4Zw ($59.60 in chips)
Seat 2: rAtTyvrJ8f1LaUh2O5U4nA ($63.70 in chips)
pVqEzK9wXlRMECnb1Zg4Zw: posts small blind $1
rAtTyvrJ8f1LaUh2O5U4nA: posts big blind $2
*** HOLE CARDS ***
pVqEzK9wXlRMECnb1Zg4Zw: raises $4 to $6
rAtTyvrJ8f1LaUh2O5U4nA: folds
pVqEzK9wXlRMECnb1Zg4Zw collected $4 from pot
pVqEzK9wXlRMECnb1Zg4Zw: doesn't show hand
*** SUMMARY ***
Total pot $4 | Rake $0
Seat 1: pVqEzK9wXlRMECnb1Zg4Zw (button) (small blind) collected ($4)
Seat 2: rAtTyvrJ8f1LaUh2O5U4nA (big blind) folded before Flop



PokerStars Game #59938730960:  Hold'em No Limit ($1/$2) - 2009/07/01 0:22:05 ET
Table 'mGpP9StWRnoeiBDExc6Frg' 6-max Seat #4 is the button
Seat 1: zWFU82nxIRvzK4mKiL4m0Q ($62.85 in chips)
Seat 2: DQlskgG4OtLpF2MVxLwf4A ($311.85 in chips)
Seat 3: 3HrFUl+TAqSP1U00zz3P7A ($73.60 in chips)
Seat 4: qXDd0ZyMIse0OBu8pxeQ3Q ($218 in chips)
Seat 5: d1puGuVBE0fidn+5eRJ0tw ($165.70 in chips)
Seat 6: X7GlkHF+lkbarCLuZ4Uf0w ($23.45 in chips)
d1puGuVBE0fidn+5eRJ0tw: posts small blind $1
X7GlkHF+lkbarCLuZ4Uf0w: posts big blind $2
*** HOLE CARDS ***
zWFU82nxIRvzK4mKiL4m0Q: calls $2
DQlskgG4OtLpF2MVxLwf4A: folds
3HrFUl+TAqSP1U00zz3P7A: raises $6 to $8
qXDd0ZyMIse0OBu8pxeQ3Q: folds
d1puGuVBE0fidn+5eRJ0tw: folds
X7GlkHF+lkbarCLuZ4Uf0w: folds
zWFU82nxIRvzK4mKiL4m0Q: calls $6
*** FLOP *** [2d 8h Ac]
zWFU82nxIRvzK4mKiL4m0Q: checks
3HrFUl+TAqSP1U00zz3P7A: bets $12
zWFU82nxIRvzK4mKiL4m0Q: folds
3HrFUl+TAqSP1U00zz3P7A collected $18.05 from pot
3HrFUl+TAqSP1U00zz3P7A: doesn't show hand
*** SUMMARY ***
Total pot $19 | Rake $0.95
Board [2d 8h Ac]
Seat 1: zWFU82nxIRvzK4mKiL4m0Q folded on the Flop
Seat 2: DQlskgG4OtLpF2MVxLwf4A folded before Flop (didn't bet)
Seat 3: 3HrFUl+TAqSP1U00zz3P7A collected ($18.05)
Seat 4: qXDd0ZyMIse0OBu8pxeQ3Q (button) folded before Flop (didn't bet)
Seat 5: d1puGuVBE0fidn+5eRJ0tw (small blind) folded before Flop
Seat 6: X7GlkHF+lkbarCLuZ4Uf0w (big blind) folded before Flop



PokerStars Game #59938731022:  Hold'em No Limit ($1/$2) - 2009/07/01 0:22:05 ET
Table 'qVXak+oTeDXMGbWa4sDU5Q' 9-max Seat #7 is the button
Seat 1: H6Z4+qu8gR0VUiPOijndVg ($257.30 in chips)
Seat 2: Hc2itIxwbi1lwa+DAYYQGg ($46 in chips)
Seat 3: oz9eCXGC7DdjQlL/nuWj1A ($122.30 in chips)
Seat 4: lQYT23h5QCUVZAKxjOO39Q ($198 in chips)
Seat 5: NqKRc5xvcye0d7F6VOF6MQ ($169.65 in chips)
Seat 7: 5iPk5MyO3KVu18Y8XCYfFQ ($106 in chips)
Seat 8: 9pHZMviI9R8injxojGTnvw ($28.80 in chips)
Seat 9: ZP45Tu5Zqo4v+ZgqIQVoOQ ($197 in chips)
9pHZMviI9R8injxojGTnvw: posts small blind $1
ZP45Tu5Zqo4v+ZgqIQVoOQ: posts big blind $2
*** HOLE CARDS ***
H6Z4+qu8gR0VUiPOijndVg: folds
Hc2itIxwbi1lwa+DAYYQGg: folds
oz9eCXGC7DdjQlL/nuWj1A: folds
lQYT23h5QCUVZAKxjOO39Q: folds
NqKRc5xvcye0d7F6VOF6MQ: folds
5iPk5MyO3KVu18Y8XCYfFQ: raises $2 to $4
9pHZMviI9R8injxojGTnvw: folds
ZP45Tu5Zqo4v+ZgqIQVoOQ: folds
5iPk5MyO3KVu18Y8XCYfFQ collected $5 from pot
5iPk5MyO3KVu18Y8XCYfFQ: doesn't show hand
*** SUMMARY ***
Total pot $5 | Rake $0
Seat 1: H6Z4+qu8gR0VUiPOijndVg folded before Flop (didn't bet)
Seat 2: Hc2itIxwbi1lwa+DAYYQGg folded before Flop (didn't bet)
Seat 3: oz9eCXGC7DdjQlL/nuWj1A folded before Flop (didn't bet)
Seat 4: lQYT23h5QCUVZAKxjOO39Q folded before Flop (didn't bet)
Seat 5: NqKRc5xvcye0d7F6VOF6MQ folded before Flop (didn't bet)
Seat 7: 5iPk5MyO3KVu18Y8XCYfFQ (button) collected ($5)
Seat 8: 9pHZMviI9R8injxojGTnvw (small blind) folded before Flop
Seat 9: ZP45Tu5Zqo4v+ZgqIQVoOQ (big blind) folded before Flop



PokerStars Game #59938731042:  Hold'em No Limit ($1/$2) - 2009/07/01 0:22:05 ET
Table 'CFkQcfWjKccZaZDf71FK+w' 6-max Seat #1 is the button
Seat 1: U2A5Hv6ib/5+gzO2wr7Z4w ($200 in chips)
Seat 2: X7GlkHF+lkbarCLuZ4Uf0w ($38 in chips)
Seat 4: e8nZKSbIdIO7e2NdQe/OFQ ($226.60 in chips)
Seat 5: 1njbh8TKSUF6l4V1XwGdcg ($213.80 in chips)
Seat 6: ORVqY3rf9X6ANA/8s+On2Q ($88.85 in chips)
X7GlkHF+lkbarCLuZ4Uf0w: posts small blind $1
e8nZKSbIdIO7e2NdQe/OFQ: posts big blind $2
*** HOLE CARDS ***
1njbh8TKSUF6l4V1XwGdcg: folds
ORVqY3rf9X6ANA/8s+On2Q: folds
U2A5Hv6ib/5+gzO2wr7Z4w: raises $4 to $6
X7GlkHF+lkbarCLuZ4Uf0w: folds
e8nZKSbIdIO7e2NdQe/OFQ: calls $4
*** FLOP *** [8s Jd 6d]
e8nZKSbIdIO7e2NdQe/OFQ: bets $2
U2A5Hv6ib/5+gzO2wr7Z4w: calls $2
*** TURN *** [8s Jd 6d] [2d]
e8nZKSbIdIO7e2NdQe/OFQ: bets $16
U2A5Hv6ib/5+gzO2wr7Z4w: folds
e8nZKSbIdIO7e2NdQe/OFQ collected $16.20 from pot
*** SUMMARY ***
Total pot $17 | Rake $0.80
Board [8s Jd 6d 2d]
Seat 1: U2A5Hv6ib/5+gzO2wr7Z4w (button) folded on the Turn
Seat 2: X7GlkHF+lkbarCLuZ4Uf0w (small blind) folded before Flop
Seat 4: e8nZKSbIdIO7e2NdQe/OFQ (big blind) collected ($16.20)
Seat 5: 1njbh8TKSUF6l4V1XwGdcg folded before Flop (didn't bet)
Seat 6: ORVqY3rf9X6ANA/8s+On2Q folded before Flop (didn't bet)



PokerStars Game #59938730976:  Hold'em No Limit ($1/$2) - 2009/07/01 0:22:05 ET
Table 'G1Oqdy4Pqdb5gtx40rUBzA' 6-max Seat #5 is the button
Seat 1: bz8Aw6kfX2xUq2sOyZlUCQ ($90.85 in chips)
Seat 2: IzslX/oV8DoDQfxCV/3+kg ($470.15 in chips)
Seat 3: lE+RUsc9cdVV9eEi8uytew ($179.95 in chips)
Seat 4: B87ikIyZ/TzAVeXf38Ny0g ($200 in chips)
Seat 5: X7GlkHF+lkbarCLuZ4Uf0w ($75 in chips)
bz8Aw6kfX2xUq2sOyZlUCQ: posts small blind $1
IzslX/oV8DoDQfxCV/3+kg: posts big blind $2
*** HOLE CARDS ***
lE+RUsc9cdVV9eEi8uytew: folds
B87ikIyZ/TzAVeXf38Ny0g: folds
X7GlkHF+lkbarCLuZ4Uf0w: raises $2 to $4
bz8Aw6kfX2xUq2sOyZlUCQ: folds
IzslX/oV8DoDQfxCV/3+kg: folds
X7GlkHF+lkbarCLuZ4Uf0w collected $5 from pot
X7GlkHF+lkbarCLuZ4Uf0w: doesn't show hand
*** SUMMARY ***
Total pot $5 | Rake $0
Seat 1: bz8Aw6kfX2xUq2sOyZlUCQ (small blind) folded before Flop
Seat 2: IzslX/oV8DoDQfxCV/3+kg (big blind) folded before Flop
Seat 3: lE+RUsc9cdVV9eEi8uytew folded before Flop (didn't bet)
Seat 4: B87ikIyZ/TzAVeXf38Ny0g folded before Flop (didn't bet)
Seat 5: X7GlkHF+lkbarCLuZ4Uf0w (button) collected ($5)



PokerStars Game #59938732914:  Hold'em No Limit ($1/$2) - 2009/07/01 0:22:07 ET
Table 'P/yCfYl1GfGsu/e6DxDy/A' 2-max Seat #2 is the button
Seat 1: 7fOCUy3x9hdkmXkkDNolGQ ($257.50 in chips)
Seat 2: RwDoM55ZeQuI2ADyJhOb2Q ($525.50 in chips)
RwDoM55ZeQuI2ADyJhOb2Q: posts small blind $1
7fOCUy3x9hdkmXkkDNolGQ: posts big blind $2
*** HOLE CARDS ***
RwDoM55ZeQuI2ADyJhOb2Q: raises $4 to $6
7fOCUy3x9hdkmXkkDNolGQ: raises $14 to $20
RwDoM55ZeQuI2ADyJhOb2Q: calls $14
*** FLOP *** [4d 5s 6h]
7fOCUy3x9hdkmXkkDNolGQ: bets $22
RwDoM55ZeQuI2ADyJhOb2Q: calls $22
*** TURN *** [4d 5s 6h] [Ks]
7fOCUy3x9hdkmXkkDNolGQ: checks
RwDoM55ZeQuI2ADyJhOb2Q: bets $52
7fOCUy3x9hdkmXkkDNolGQ: calls $52
*** RIVER *** [4d 5s 6h Ks] [Js]
7fOCUy3x9hdkmXkkDNolGQ: checks
RwDoM55ZeQuI2ADyJhOb2Q: bets $188
7fOCUy3x9hdkmXkkDNolGQ: folds
RwDoM55ZeQuI2ADyJhOb2Q collected $187.50 from pot
RwDoM55ZeQuI2ADyJhOb2Q: doesn't show hand
*** SUMMARY ***
Total pot $188 | Rake $0.50
Board [4d 5s 6h Ks Js]
Seat 1: 7fOCUy3x9hdkmXkkDNolGQ (big blind) folded on the River
Seat 2: RwDoM55ZeQuI2ADyJhOb2Q (button) (small blind) collected ($187.50)



PokerStars Game #59938732804:  Hold'em No Limit ($1/$2) - 2009/07/01 0:22:07 ET
Table '5G1PjWSk2ALz0O/eqyYy/g' 2-max Seat #2 is the button
Seat 1: Z4HwehErEwzsv/noQlfUlg ($159.10 in chips)
Seat 2: v4dp1VoMhJV4zmCXtmG5LQ ($210.50 in chips)
v4dp1VoMhJV4zmCXtmG5LQ: posts small blind $1
Z4HwehErEwzsv/noQlfUlg: posts big blind $2
*** HOLE CARDS ***
v4dp1VoMhJV4zmCXtmG5LQ: raises $4 to $6
Z4HwehErEwzsv/noQlfUlg: folds
v4dp1VoMhJV4zmCXtmG5LQ collected $4 from pot
v4dp1VoMhJV4zmCXtmG5LQ: doesn't show hand
*** SUMMARY ***
Total pot $4 | Rake $0
Seat 1: Z4HwehErEwzsv/noQlfUlg (big blind) folded before Flop
Seat 2: v4dp1VoMhJV4zmCXtmG5LQ (button) (small blind) collected ($4)



PokerStars Game #59938734354:  Hold'em No Limit ($1/$2) - 2009/07/01 0:22:09 ET
Table 'aSf77Sj8QEnzcc0WaxVD4Q' 6-max Seat #6 is the button
Seat 1: 54yWzRRgS0oZ+S6LwZBxMQ ($38 in chips)
Seat 2: vkfxu8f/jMYKUk6Ly4eujw ($256.15 in chips)
Seat 3: 9dpyyjDTCed6nV7JhaUUpw ($207.30 in chips)
Seat 4: 513FcCI8jHyQy2VWoIQkMg ($201.75 in chips)
Seat 5: InmkdI6G8TzSj9NhcCSyPg ($247 in chips)
Seat 6: vkoJRf3gidxY1pPi0AFWww ($296.15 in chips)
54yWzRRgS0oZ+S6LwZBxMQ: posts small blind $1
vkfxu8f/jMYKUk6Ly4eujw: posts big blind $2
*** HOLE CARDS ***
9dpyyjDTCed6nV7JhaUUpw: folds
513FcCI8jHyQy2VWoIQkMg: folds
InmkdI6G8TzSj9NhcCSyPg: folds
vkoJRf3gidxY1pPi0AFWww: calls $2
54yWzRRgS0oZ+S6LwZBxMQ: calls $1
vkfxu8f/jMYKUk6Ly4eujw: raises $9 to $11
vkoJRf3gidxY1pPi0AFWww: raises $21 to $32
54yWzRRgS0oZ+S6LwZBxMQ: folds
vkfxu8f/jMYKUk6Ly4eujw: folds
vkoJRf3gidxY1pPi0AFWww collected $24 from pot
vkoJRf3gidxY1pPi0AFWww: doesn't show hand
*** SUMMARY ***
Total pot $24 | Rake $0
Seat 1: 54yWzRRgS0oZ+S6LwZBxMQ (small blind) folded before Flop
Seat 2: vkfxu8f/jMYKUk6Ly4eujw (big blind) folded before Flop
Seat 3: 9dpyyjDTCed6nV7JhaUUpw folded before Flop (didn't bet)
Seat 4: 513FcCI8jHyQy2VWoIQkMg folded before Flop (didn't bet)
Seat 5: InmkdI6G8TzSj9NhcCSyPg folded before Flop (didn't bet)
Seat 6: vkoJRf3gidxY1pPi0AFWww (button) collected ($24)



PokerStars Game #59938737384:  Hold'em No Limit ($1/$2) - 2009/07/01 0:22:14 ET
Table 'OZyw34U4j4WtFFWsEHZQgQ' 2-max Seat #2 is the button
Seat 1: pVqEzK9wXlRMECnb1Zg4Zw ($61.60 in chips)
Seat 2: rAtTyvrJ8f1LaUh2O5U4nA ($61.70 in chips)
rAtTyvrJ8f1LaUh2O5U4nA: posts small blind $1
pVqEzK9wXlRMECnb1Zg4Zw: posts big blind $2
*** HOLE CARDS ***
rAtTyvrJ8f1LaUh2O5U4nA: calls $1
pVqEzK9wXlRMECnb1Zg4Zw: checks
*** FLOP *** [Qd Ac 8h]
pVqEzK9wXlRMECnb1Zg4Zw: checks
rAtTyvrJ8f1LaUh2O5U4nA: checks
*** TURN *** [Qd Ac 8h] [5s]
pVqEzK9wXlRMECnb1Zg4Zw: checks
rAtTyvrJ8f1LaUh2O5U4nA: checks
*** RIVER *** [Qd Ac 8h 5s] [4h]
pVqEzK9wXlRMECnb1Zg4Zw: bets $12
rAtTyvrJ8f1LaUh2O5U4nA: folds
pVqEzK9wXlRMECnb1Zg4Zw collected $3.80 from pot
pVqEzK9wXlRMECnb1Zg4Zw: doesn't show hand
*** SUMMARY ***
Total pot $4 | Rake $0.20
Board [Qd Ac 8h 5s 4h]
Seat 1: pVqEzK9wXlRMECnb1Zg4Zw (big blind) collected ($3.80)
Seat 2: rAtTyvrJ8f1LaUh2O5U4nA (button) (small blind) folded on the River



PokerStars Game #59938738190:  Hold'em No Limit ($1/$2) - 2009/07/01 0:22:15 ET
Table 'W9UeSV0aoPjh5SFSxM8jUQ' 9-max Seat #6 is the button
Seat 1: cdC54j9fGGojcbzWB5PgzA ($204.60 in chips)
Seat 2: iMe5yhc+1BaiIPHet3NMrA ($316.75 in chips)
Seat 3: TAfo4veNRaRlzDXMMYS3Jg ($37 in chips)
Seat 4: De9g+AYjo0DN6C/+iT/nsg ($286.10 in chips)
Seat 5: CUZwDpLTQKhzarPe+JCLOQ ($200 in chips)
Seat 6: MXxB6weBWzZyAhRZb+/KVg ($193 in chips)
Seat 7: 4Cl43Q1TYQL8wn1NSCUkaw ($45.60 in chips)
Seat 8: GX1heJ+DSsvm7gzSPsYhhQ ($40 in chips)
Seat 9: U2A5Hv6ib/5+gzO2wr7Z4w ($203 in chips)
4Cl43Q1TYQL8wn1NSCUkaw: posts small blind $1
GX1heJ+DSsvm7gzSPsYhhQ: posts big blind $2
*** HOLE CARDS ***
U2A5Hv6ib/5+gzO2wr7Z4w: folds
cdC54j9fGGojcbzWB5PgzA: folds
iMe5yhc+1BaiIPHet3NMrA: folds
TAfo4veNRaRlzDXMMYS3Jg: folds
De9g+AYjo0DN6C/+iT/nsg: folds
CUZwDpLTQKhzarPe+JCLOQ: folds
MXxB6weBWzZyAhRZb+/KVg: folds
4Cl43Q1TYQL8wn1NSCUkaw: calls $1
GX1heJ+DSsvm7gzSPsYhhQ: checks
*** FLOP *** [4c 7c 9d]
4Cl43Q1TYQL8wn1NSCUkaw: checks
GX1heJ+DSsvm7gzSPsYhhQ: bets $2
4Cl43Q1TYQL8wn1NSCUkaw: folds
GX1heJ+DSsvm7gzSPsYhhQ collected $3.80 from pot
*** SUMMARY ***
Total pot $4 | Rake $0.20
Board [4c 7c 9d]
Seat 1: cdC54j9fGGojcbzWB5PgzA folded before Flop (didn't bet)
Seat 2: iMe5yhc+1BaiIPHet3NMrA folded before Flop (didn't bet)
Seat 3: TAfo4veNRaRlzDXMMYS3Jg folded before Flop (didn't bet)
Seat 4: De9g+AYjo0DN6C/+iT/nsg folded before Flop (didn't bet)
Seat 5: CUZwDpLTQKhzarPe+JCLOQ folded before Flop (didn't bet)
Seat 6: MXxB6weBWzZyAhRZb+/KVg (button) folded before Flop (didn't bet)
Seat 7: 4Cl43Q1TYQL8wn1NSCUkaw (small blind) folded on the Flop
Seat 8: GX1heJ+DSsvm7gzSPsYhhQ (big blind) collected ($3.80)
Seat 9: U2A5Hv6ib/5+gzO2wr7Z4w folded before Flop (didn't bet)



PokerStars Game #59938738672:  Hold'em No Limit ($1/$2) - 2009/07/01 0:22:16 ET
Table '5G1PjWSk2ALz0O/eqyYy/g' 2-max Seat #1 is the button
Seat 1: Z4HwehErEwzsv/noQlfUlg ($157.10 in chips)
Seat 2: v4dp1VoMhJV4zmCXtmG5LQ ($212.50 in chips)
Z4HwehErEwzsv/noQlfUlg: posts small blind $1
v4dp1VoMhJV4zmCXtmG5LQ: posts big blind $2
*** HOLE CARDS ***
Z4HwehErEwzsv/noQlfUlg: raises $4 to $6
v4dp1VoMhJV4zmCXtmG5LQ: folds
Z4HwehErEwzsv/noQlfUlg collected $4 from pot
Z4HwehErEwzsv/noQlfUlg: doesn't show hand
*** SUMMARY ***
Total pot $4 | Rake $0
Seat 1: Z4HwehErEwzsv/noQlfUlg (button) (small blind) collected ($4)
Seat 2: v4dp1VoMhJV4zmCXtmG5LQ (big blind) folded before Flop



PokerStars Game #59938741740:  Hold'em No Limit ($1/$2) - 2009/07/01 0:22:21 ET
Table 'SF49/KQm8T4taMp6kb+HXA' 9-max Seat #7 is the button
Seat 1: l1bCLGuFqeFRwUfPsiDu/g ($290.95 in chips)
Seat 2: 8Z3QifiM9eOd5EIJ25dXNg ($120 in chips)
Seat 3: pCmk6FpSOLJ+85o1tLHIag ($98 in chips)
Seat 4: HffgoYm61KgkdMe/DYChIQ ($114 in chips)
Seat 5: Z3aYCZG/yXHYFjiWkGI5ug ($223.55 in chips)
Seat 6: M2ht6rIKOI/my9eh610Nlw ($225.40 in chips)
Seat 7: n2VAbLaE5qgKr5mA4W6v4w ($32.50 in chips)
Seat 8: 5iPk5MyO3KVu18Y8XCYfFQ ($38 in chips)
5iPk5MyO3KVu18Y8XCYfFQ: posts small blind $1
l1bCLGuFqeFRwUfPsiDu/g: posts big blind $2
*** HOLE CARDS ***
/inIs/z/PcX+TniIFpaxpg joins the table at seat #9
8Z3QifiM9eOd5EIJ25dXNg has timed out
8Z3QifiM9eOd5EIJ25dXNg: folds
8Z3QifiM9eOd5EIJ25dXNg is sitting out
pCmk6FpSOLJ+85o1tLHIag: folds
HffgoYm61KgkdMe/DYChIQ: calls $2
Z3aYCZG/yXHYFjiWkGI5ug: folds
M2ht6rIKOI/my9eh610Nlw: folds
n2VAbLaE5qgKr5mA4W6v4w: raises $5.50 to $7.50
5iPk5MyO3KVu18Y8XCYfFQ: folds
l1bCLGuFqeFRwUfPsiDu/g: folds
HffgoYm61KgkdMe/DYChIQ: calls $5.50
*** FLOP *** [3d 7s Ad]
HffgoYm61KgkdMe/DYChIQ: checks
n2VAbLaE5qgKr5mA4W6v4w: checks
*** TURN *** [3d 7s Ad] [3c]
HffgoYm61KgkdMe/DYChIQ: bets $6
n2VAbLaE5qgKr5mA4W6v4w: folds
HffgoYm61KgkdMe/DYChIQ collected $17.10 from pot
*** SUMMARY ***
Total pot $18 | Rake $0.90
Board [3d 7s Ad 3c]
Seat 1: l1bCLGuFqeFRwUfPsiDu/g (big blind) folded before Flop
Seat 2: 8Z3QifiM9eOd5EIJ25dXNg folded before Flop (didn't bet)
Seat 3: pCmk6FpSOLJ+85o1tLHIag folded before Flop (didn't bet)
Seat 4: HffgoYm61KgkdMe/DYChIQ collected ($17.10)
Seat 5: Z3aYCZG/yXHYFjiWkGI5ug folded before Flop (didn't bet)
Seat 6: M2ht6rIKOI/my9eh610Nlw folded before Flop (didn't bet)
Seat 7: n2VAbLaE5qgKr5mA4W6v4w (button) folded on the Turn
Seat 8: 5iPk5MyO3KVu18Y8XCYfFQ (small blind) folded before Flop



PokerStars Game #59938741676:  Hold'em No Limit ($1/$2) - 2009/07/01 0:22:21 ET
Table 'BSRfGh+QobUe0AgIMtt/fw' 9-max Seat #8 is the button
Seat 1: QHxJjpVYwitg9krW6wZgJA ($290.30 in chips)
Seat 2: GX1heJ+DSsvm7gzSPsYhhQ ($40 in chips)
Seat 3: XSBFygUEk3Ijl/S/KhD4PA ($370.60 in chips)
Seat 4: 5iPk5MyO3KVu18Y8XCYfFQ ($40 in chips)
Seat 5: odhvI/CZeMsPyo1n1U7+hA ($65 in chips)
Seat 6: H6Z4+qu8gR0VUiPOijndVg ($207.40 in chips)
Seat 7: RgU4royPa+zJopKX0xA3RA ($142.40 in chips)
Seat 8: /XRRUMKiOOItJFbrM26RrA ($54 in chips)
QHxJjpVYwitg9krW6wZgJA: posts small blind $1
GX1heJ+DSsvm7gzSPsYhhQ: posts big blind $2
*** HOLE CARDS ***
/inIs/z/PcX+TniIFpaxpg joins the table at seat #9
XSBFygUEk3Ijl/S/KhD4PA: calls $2
5iPk5MyO3KVu18Y8XCYfFQ: folds
odhvI/CZeMsPyo1n1U7+hA: raises $4 to $6
H6Z4+qu8gR0VUiPOijndVg: folds
RgU4royPa+zJopKX0xA3RA: folds
/XRRUMKiOOItJFbrM26RrA: folds
QHxJjpVYwitg9krW6wZgJA: folds
GX1heJ+DSsvm7gzSPsYhhQ: folds
XSBFygUEk3Ijl/S/KhD4PA: calls $4
*** FLOP *** [Tc 7h 6c]
XSBFygUEk3Ijl/S/KhD4PA: checks
odhvI/CZeMsPyo1n1U7+hA: checks
*** TURN *** [Tc 7h 6c] [9d]
XSBFygUEk3Ijl/S/KhD4PA: bets $8
odhvI/CZeMsPyo1n1U7+hA: calls $8
*** RIVER *** [Tc 7h 6c 9d] [Ks]
XSBFygUEk3Ijl/S/KhD4PA: checks
odhvI/CZeMsPyo1n1U7+hA: bets $14
XSBFygUEk3Ijl/S/KhD4PA: folds
odhvI/CZeMsPyo1n1U7+hA collected $29.50 from pot
*** SUMMARY ***
Total pot $31 | Rake $1.50
Board [Tc 7h 6c 9d Ks]
Seat 1: QHxJjpVYwitg9krW6wZgJA (small blind) folded before Flop
Seat 2: GX1heJ+DSsvm7gzSPsYhhQ (big blind) folded before Flop
Seat 3: XSBFygUEk3Ijl/S/KhD4PA folded on the River
Seat 4: 5iPk5MyO3KVu18Y8XCYfFQ folded before Flop (didn't bet)
Seat 5: odhvI/CZeMsPyo1n1U7+hA collected ($29.50)
Seat 6: H6Z4+qu8gR0VUiPOijndVg folded before Flop (didn't bet)
Seat 7: RgU4royPa+zJopKX0xA3RA folded before Flop (didn't bet)
Seat 8: /XRRUMKiOOItJFbrM26RrA (button) folded before Flop (didn't bet)



PokerStars Game #59938744204:  Hold'em No Limit ($1/$2) - 2009/07/01 0:22:24 ET
Table 'jlrIxbrVIG+gjaUYT4za8g' 6-max Seat #6 is the button
Seat 1: ygTTt5ehT4aF86q1a8/R+w ($194.05 in chips)
Seat 2: N18PrNGQj43J7TJuQuu+tw ($141.10 in chips)
Seat 3: 54yWzRRgS0oZ+S6LwZBxMQ ($37.80 in chips)
Seat 4: 8srN1dKQePlsv0GyTada+Q ($221 in chips)
Seat 5: VuZb/hkEc4X7s93w2ZZTpA ($200 in chips)
Seat 6: vkfxu8f/jMYKUk6Ly4eujw ($271.95 in chips)
ygTTt5ehT4aF86q1a8/R+w: posts small blind $1
N18PrNGQj43J7TJuQuu+tw: posts big blind $2
*** HOLE CARDS ***
54yWzRRgS0oZ+S6LwZBxMQ: folds
8srN1dKQePlsv0GyTada+Q: folds
VuZb/hkEc4X7s93w2ZZTpA: folds
vkfxu8f/jMYKUk6Ly4eujw: raises $6 to $8
ygTTt5ehT4aF86q1a8/R+w: folds
N18PrNGQj43J7TJuQuu+tw: calls $6
*** FLOP *** [8h 8d Ts]
N18PrNGQj43J7TJuQuu+tw: bets $8
vkfxu8f/jMYKUk6Ly4eujw: folds
N18PrNGQj43J7TJuQuu+tw collected $16.15 from pot
*** SUMMARY ***
Total pot $17 | Rake $0.85
Board [8h 8d Ts]
Seat 1: ygTTt5ehT4aF86q1a8/R+w (small blind) folded before Flop
Seat 2: N18PrNGQj43J7TJuQuu+tw (big blind) collected ($16.15)
Seat 3: 54yWzRRgS0oZ+S6LwZBxMQ folded before Flop (didn't bet)
Seat 4: 8srN1dKQePlsv0GyTada+Q folded before Flop (didn't bet)
Seat 5: VuZb/hkEc4X7s93w2ZZTpA folded before Flop (didn't bet)
Seat 6: vkfxu8f/jMYKUk6Ly4eujw (button) folded on the Flop



PokerStars Game #59938744428:  Hold'em No Limit ($1/$2) - 2009/07/01 0:22:25 ET
Table '5G1PjWSk2ALz0O/eqyYy/g' 2-max Seat #2 is the button
Seat 1: Z4HwehErEwzsv/noQlfUlg ($159.10 in chips)
Seat 2: v4dp1VoMhJV4zmCXtmG5LQ ($210.50 in chips)
v4dp1VoMhJV4zmCXtmG5LQ: posts small blind $1
Z4HwehErEwzsv/noQlfUlg: posts big blind $2
*** HOLE CARDS ***
v4dp1VoMhJV4zmCXtmG5LQ: folds
Z4HwehErEwzsv/noQlfUlg collected $2 from pot
Z4HwehErEwzsv/noQlfUlg: doesn't show hand
*** SUMMARY ***
Total pot $2 | Rake $0
Seat 1: Z4HwehErEwzsv/noQlfUlg (big blind) collected ($2)
Seat 2: v4dp1VoMhJV4zmCXtmG5LQ (button) (small blind) folded before Flop



PokerStars Game #59938745196:  Hold'em No Limit ($1/$2) - 2009/07/01 0:22:26 ET
Table 'NmY84NAf9Mh0ckAckHnh5g' 2-max Seat #2 is the button
Seat 1: 6hvg964TSqZ3AL/0XK9aVQ ($612.95 in chips)
Seat 2: RwDoM55ZeQuI2ADyJhOb2Q ($231.50 in chips)
RwDoM55ZeQuI2ADyJhOb2Q: posts small blind $1
6hvg964TSqZ3AL/0XK9aVQ: posts big blind $2
*** HOLE CARDS ***
RwDoM55ZeQuI2ADyJhOb2Q: folds
6hvg964TSqZ3AL/0XK9aVQ collected $2 from pot
6hvg964TSqZ3AL/0XK9aVQ: doesn't show hand
*** SUMMARY ***
Total pot $2 | Rake $0
Seat 1: 6hvg964TSqZ3AL/0XK9aVQ (big blind) collected ($2)
Seat 2: RwDoM55ZeQuI2ADyJhOb2Q (button) (small blind) folded before Flop



PokerStars Game #59938745238:  Hold'em No Limit ($1/$2) - 2009/07/01 0:22:26 ET
Table 'uJ9juaXXg9yIcSU8amxaXQ' 6-max Seat #6 is the button
Seat 2: yynBOXUjw28V5kz84sxX4g ($142.05 in chips)
Seat 3: zaogaltCDFVsIASEnrXs2w ($292 in chips)
Seat 4: zNjJ/y4emmF+vzrCDd+ooA ($118 in chips)
Seat 5: aMZYAxFxWTQXE9aUus4sxg ($65.15 in chips)
Seat 6: XrFG4dK06RVKLlX32/pjcQ ($50 in chips)
yynBOXUjw28V5kz84sxX4g: posts small blind $1
zaogaltCDFVsIASEnrXs2w: posts big blind $2
*** HOLE CARDS ***
zNjJ/y4emmF+vzrCDd+ooA: folds
aMZYAxFxWTQXE9aUus4sxg: folds
XrFG4dK06RVKLlX32/pjcQ: folds
yynBOXUjw28V5kz84sxX4g: calls $1
zaogaltCDFVsIASEnrXs2w: raises $6 to $8
yynBOXUjw28V5kz84sxX4g: folds
zaogaltCDFVsIASEnrXs2w collected $4 from pot
*** SUMMARY ***
Total pot $4 | Rake $0
Seat 2: yynBOXUjw28V5kz84sxX4g (small blind) folded before Flop
Seat 3: zaogaltCDFVsIASEnrXs2w (big blind) collected ($4)
Seat 4: zNjJ/y4emmF+vzrCDd+ooA folded before Flop (didn't bet)
Seat 5: aMZYAxFxWTQXE9aUus4sxg folded before Flop (didn't bet)
Seat 6: XrFG4dK06RVKLlX32/pjcQ (button) folded before Flop (didn't bet)



PokerStars Game #59938745100:  Hold'em No Limit ($1/$2) - 2009/07/01 0:22:26 ET
Table 'ZzSIe0zTCDv+n6hfbY5tTg' 6-max Seat #1 is the button
Seat 1: 8srN1dKQePlsv0GyTada+Q ($277.40 in chips)
Seat 2: B87ikIyZ/TzAVeXf38Ny0g ($200 in chips)
Seat 3: X7GlkHF+lkbarCLuZ4Uf0w ($33 in chips)
Seat 4: ky55L0pITYgYLeqFB9gP/Q ($193.40 in chips)
Seat 6: InmkdI6G8TzSj9NhcCSyPg ($200 in chips)
B87ikIyZ/TzAVeXf38Ny0g: posts small blind $1
X7GlkHF+lkbarCLuZ4Uf0w: posts big blind $2
*** HOLE CARDS ***
ky55L0pITYgYLeqFB9gP/Q: folds
InmkdI6G8TzSj9NhcCSyPg: folds
8srN1dKQePlsv0GyTada+Q has timed out
8srN1dKQePlsv0GyTada+Q: folds
8srN1dKQePlsv0GyTada+Q is sitting out
B87ikIyZ/TzAVeXf38Ny0g: raises $4 to $6
f2eTKbND+tM3kUw9o6WYWg joins the table at seat #5
X7GlkHF+lkbarCLuZ4Uf0w: raises $27 to $33 and is all-in
B87ikIyZ/TzAVeXf38Ny0g: calls $27
*** FLOP *** [4d 5c 3d]
*** TURN *** [4d 5c 3d] [Ks]
*** RIVER *** [4d 5c 3d Ks] [Ts]
*** SHOW DOWN ***
B87ikIyZ/TzAVeXf38Ny0g: shows [Ad 7c] (high card Ace)
X7GlkHF+lkbarCLuZ4Uf0w: shows [4h 4c] (three of a kind, Fours)
X7GlkHF+lkbarCLuZ4Uf0w collected $64 from pot
*** SUMMARY ***
Total pot $66 | Rake $2
Board [4d 5c 3d Ks Ts]
Seat 1: 8srN1dKQePlsv0GyTada+Q (button) folded before Flop (didn't bet)
Seat 2: B87ikIyZ/TzAVeXf38Ny0g (small blind) showed [Ad 7c] and lost with high card Ace
Seat 3: X7GlkHF+lkbarCLuZ4Uf0w (big blind) showed [4h 4c] and won ($64) with three of a kind, Fours
Seat 4: ky55L0pITYgYLeqFB9gP/Q folded before Flop (didn't bet)
Seat 6: InmkdI6G8TzSj9NhcCSyPg folded before Flop (didn't bet)



PokerStars Game #59938748522:  Hold'em No Limit ($1/$2) - 2009/07/01 0:22:31 ET
Table 'gnHBqWll9O3fxG7Ojkz/ng' 9-max Seat #6 is the button
Seat 1: hpqdC/23wXosGOmzARr5NA ($147.05 in chips)
Seat 2: H6Z4+qu8gR0VUiPOijndVg ($200 in chips)
Seat 3: 5Q8U6iZbeO7xJSS4qvDP5g ($225.35 in chips)
Seat 5: rBQDMkKm9cZn6M9NPsiVew ($117 in chips)
Seat 6: 5iPk5MyO3KVu18Y8XCYfFQ ($55.45 in chips)
Seat 7: jqui3xAWCkcdPW36a6BD+w ($215.55 in chips)
Seat 8: cM6efHzdxoqYm0EQKP4TTQ ($108.80 in chips)
Seat 9: kVCeGJ4NY7Fb0W74j1mAqA ($200 in chips)
jqui3xAWCkcdPW36a6BD+w: posts small blind $1
cM6efHzdxoqYm0EQKP4TTQ: posts big blind $2
*** HOLE CARDS ***
kVCeGJ4NY7Fb0W74j1mAqA: folds
hpqdC/23wXosGOmzARr5NA: folds
H6Z4+qu8gR0VUiPOijndVg: folds
5Q8U6iZbeO7xJSS4qvDP5g: raises $6 to $8
rBQDMkKm9cZn6M9NPsiVew: folds
5iPk5MyO3KVu18Y8XCYfFQ: folds
kVCeGJ4NY7Fb0W74j1mAqA leaves the table
jqui3xAWCkcdPW36a6BD+w: folds
cM6efHzdxoqYm0EQKP4TTQ: folds
5Q8U6iZbeO7xJSS4qvDP5g collected $5 from pot
5Q8U6iZbeO7xJSS4qvDP5g: doesn't show hand
*** SUMMARY ***
Total pot $5 | Rake $0
Seat 1: hpqdC/23wXosGOmzARr5NA folded before Flop (didn't bet)
Seat 2: H6Z4+qu8gR0VUiPOijndVg folded before Flop (didn't bet)
Seat 3: 5Q8U6iZbeO7xJSS4qvDP5g collected ($5)
Seat 5: rBQDMkKm9cZn6M9NPsiVew folded before Flop (didn't bet)
Seat 6: 5iPk5MyO3KVu18Y8XCYfFQ (button) folded before Flop (didn't bet)
Seat 7: jqui3xAWCkcdPW36a6BD+w (small blind) folded before Flop
Seat 8: cM6efHzdxoqYm0EQKP4TTQ (big blind) folded before Flop
Seat 9: kVCeGJ4NY7Fb0W74j1mAqA folded before Flop (didn't bet)



PokerStars Game #59938748556:  Hold'em No Limit ($1/$2) - 2009/07/01 0:22:31 ET
Table 'qVXak+oTeDXMGbWa4sDU5Q' 9-max Seat #8 is the button
Seat 1: H6Z4+qu8gR0VUiPOijndVg ($257.30 in chips)
Seat 2: Hc2itIxwbi1lwa+DAYYQGg ($46 in chips)
Seat 3: oz9eCXGC7DdjQlL/nuWj1A ($122.30 in chips)
Seat 4: lQYT23h5QCUVZAKxjOO39Q ($198 in chips)
Seat 5: NqKRc5xvcye0d7F6VOF6MQ ($169.65 in chips)
Seat 7: 5iPk5MyO3KVu18Y8XCYfFQ ($109 in chips)
Seat 8: 9pHZMviI9R8injxojGTnvw ($27.80 in chips)
Seat 9: ZP45Tu5Zqo4v+ZgqIQVoOQ ($195 in chips)
ZP45Tu5Zqo4v+ZgqIQVoOQ: posts small blind $1
H6Z4+qu8gR0VUiPOijndVg: posts big blind $2
*** HOLE CARDS ***
Hc2itIxwbi1lwa+DAYYQGg: folds
oz9eCXGC7DdjQlL/nuWj1A: folds
lQYT23h5QCUVZAKxjOO39Q: raises $6 to $8
NqKRc5xvcye0d7F6VOF6MQ: folds
5iPk5MyO3KVu18Y8XCYfFQ: folds
9pHZMviI9R8injxojGTnvw: folds
ZP45Tu5Zqo4v+ZgqIQVoOQ: folds
H6Z4+qu8gR0VUiPOijndVg: folds
lQYT23h5QCUVZAKxjOO39Q collected $5 from pot
*** SUMMARY ***
Total pot $5 | Rake $0
Seat 1: H6Z4+qu8gR0VUiPOijndVg (big blind) folded before Flop
Seat 2: Hc2itIxwbi1lwa+DAYYQGg folded before Flop (didn't bet)
Seat 3: oz9eCXGC7DdjQlL/nuWj1A folded before Flop (didn't bet)
Seat 4: lQYT23h5QCUVZAKxjOO39Q collected ($5)
Seat 5: NqKRc5xvcye0d7F6VOF6MQ folded before Flop (didn't bet)
Seat 7: 5iPk5MyO3KVu18Y8XCYfFQ folded before Flop (didn't bet)
Seat 8: 9pHZMviI9R8injxojGTnvw (button) folded before Flop (didn't bet)
Seat 9: ZP45Tu5Zqo4v+ZgqIQVoOQ (small blind) folded before Flop



PokerStars Game #59938748390:  Hold'em No Limit ($1/$2) - 2009/07/01 0:22:31 ET
Table 'OZyw34U4j4WtFFWsEHZQgQ' 2-max Seat #1 is the button
Seat 1: pVqEzK9wXlRMECnb1Zg4Zw ($63.40 in chips)
Seat 2: rAtTyvrJ8f1LaUh2O5U4nA ($59.70 in chips)
pVqEzK9wXlRMECnb1Zg4Zw: posts small blind $1
rAtTyvrJ8f1LaUh2O5U4nA: posts big blind $2
*** HOLE CARDS ***
pVqEzK9wXlRMECnb1Zg4Zw: folds
rAtTyvrJ8f1LaUh2O5U4nA collected $2 from pot
rAtTyvrJ8f1LaUh2O5U4nA: doesn't show hand
*** SUMMARY ***
Total pot $2 | Rake $0
Seat 1: pVqEzK9wXlRMECnb1Zg4Zw (button) (small blind) folded before Flop
Seat 2: rAtTyvrJ8f1LaUh2O5U4nA (big blind) collected ($2)



PokerStars Game #59938748874:  Hold'em No Limit ($1/$2) - 2009/07/01 0:22:31 ET
Table '5G1PjWSk2ALz0O/eqyYy/g' 2-max Seat #1 is the button
Seat 1: Z4HwehErEwzsv/noQlfUlg ($160.10 in chips)
Seat 2: v4dp1VoMhJV4zmCXtmG5LQ ($209.50 in chips)
Z4HwehErEwzsv/noQlfUlg: posts small blind $1
v4dp1VoMhJV4zmCXtmG5LQ: posts big blind $2
*** HOLE CARDS ***
Z4HwehErEwzsv/noQlfUlg: calls $1
v4dp1VoMhJV4zmCXtmG5LQ: checks
*** FLOP *** [4c 7s Td]
v4dp1VoMhJV4zmCXtmG5LQ: checks
Z4HwehErEwzsv/noQlfUlg: bets $4
v4dp1VoMhJV4zmCXtmG5LQ: folds
Z4HwehErEwzsv/noQlfUlg collected $3.80 from pot
Z4HwehErEwzsv/noQlfUlg: doesn't show hand
*** SUMMARY ***
Total pot $4 | Rake $0.20
Board [4c 7s Td]
Seat 1: Z4HwehErEwzsv/noQlfUlg (button) (small blind) collected ($3.80)
Seat 2: v4dp1VoMhJV4zmCXtmG5LQ (big blind) folded on the Flop



PokerStars Game #59938749258:  Hold'em No Limit ($1/$2) - 2009/07/01 0:22:32 ET
Table 'NmY84NAf9Mh0ckAckHnh5g' 2-max Seat #1 is the button
Seat 1: 6hvg964TSqZ3AL/0XK9aVQ ($613.95 in chips)
Seat 2: RwDoM55ZeQuI2ADyJhOb2Q ($230.50 in chips)
6hvg964TSqZ3AL/0XK9aVQ: posts small blind $1
RwDoM55ZeQuI2ADyJhOb2Q: posts big blind $2
*** HOLE CARDS ***
6hvg964TSqZ3AL/0XK9aVQ: folds
RwDoM55ZeQuI2ADyJhOb2Q collected $2 from pot
RwDoM55ZeQuI2ADyJhOb2Q: doesn't show hand
*** SUMMARY ***
Total pot $2 | Rake $0
Seat 1: 6hvg964TSqZ3AL/0XK9aVQ (button) (small blind) folded before Flop
Seat 2: RwDoM55ZeQuI2ADyJhOb2Q (big blind) collected ($2)



PokerStars Game #59938752212:  Hold'em No Limit ($1/$2) - 2009/07/01 0:22:36 ET
Table 'OZyw34U4j4WtFFWsEHZQgQ' 2-max Seat #2 is the button
Seat 1: pVqEzK9wXlRMECnb1Zg4Zw ($62.40 in chips)
Seat 2: rAtTyvrJ8f1LaUh2O5U4nA ($60.70 in chips)
rAtTyvrJ8f1LaUh2O5U4nA: posts small blind $1
pVqEzK9wXlRMECnb1Zg4Zw: posts big blind $2
*** HOLE CARDS ***
rAtTyvrJ8f1LaUh2O5U4nA: raises $2 to $4
pVqEzK9wXlRMECnb1Zg4Zw: raises $2 to $6
rAtTyvrJ8f1LaUh2O5U4nA: calls $2
*** FLOP *** [7s Qc Ks]
pVqEzK9wXlRMECnb1Zg4Zw: checks
rAtTyvrJ8f1LaUh2O5U4nA: checks
*** TURN *** [7s Qc Ks] [8d]
pVqEzK9wXlRMECnb1Zg4Zw: checks
rAtTyvrJ8f1LaUh2O5U4nA: checks
*** RIVER *** [7s Qc Ks 8d] [As]
pVqEzK9wXlRMECnb1Zg4Zw: checks
rAtTyvrJ8f1LaUh2O5U4nA: checks
*** SHOW DOWN ***
pVqEzK9wXlRMECnb1Zg4Zw: shows [Ah 5c] (a pair of Aces)
rAtTyvrJ8f1LaUh2O5U4nA: mucks hand
pVqEzK9wXlRMECnb1Zg4Zw collected $11.50 from pot
*** SUMMARY ***
Total pot $12 | Rake $0.50
Board [7s Qc Ks 8d As]
Seat 1: pVqEzK9wXlRMECnb1Zg4Zw (big blind) showed [Ah 5c] and won ($11.50) with a pair of Aces
Seat 2: rAtTyvrJ8f1LaUh2O5U4nA (button) (small blind) mucked



PokerStars Game #59938752884:  Hold'em No Limit ($1/$2) - 2009/07/01 0:22:37 ET
Table 'G1Oqdy4Pqdb5gtx40rUBzA' 6-max Seat #1 is the button
Seat 1: bz8Aw6kfX2xUq2sOyZlUCQ ($89.85 in chips)
Seat 2: IzslX/oV8DoDQfxCV/3+kg ($468.15 in chips)
Seat 3: lE+RUsc9cdVV9eEi8uytew ($179.95 in chips)
Seat 4: B87ikIyZ/TzAVeXf38Ny0g ($200 in chips)
Seat 5: X7GlkHF+lkbarCLuZ4Uf0w ($78 in chips)
IzslX/oV8DoDQfxCV/3+kg: posts small blind $1
lE+RUsc9cdVV9eEi8uytew: posts big blind $2
*** HOLE CARDS ***
B87ikIyZ/TzAVeXf38Ny0g: folds
X7GlkHF+lkbarCLuZ4Uf0w: folds
bz8Aw6kfX2xUq2sOyZlUCQ: raises $2 to $4
IzslX/oV8DoDQfxCV/3+kg: calls $3
lE+RUsc9cdVV9eEi8uytew: raises $6 to $10
bz8Aw6kfX2xUq2sOyZlUCQ: folds
IzslX/oV8DoDQfxCV/3+kg: folds
lE+RUsc9cdVV9eEi8uytew collected $12 from pot
lE+RUsc9cdVV9eEi8uytew: doesn't show hand
*** SUMMARY ***
Total pot $12 | Rake $0
Seat 1: bz8Aw6kfX2xUq2sOyZlUCQ (button) folded before Flop
Seat 2: IzslX/oV8DoDQfxCV/3+kg (small blind) folded before Flop
Seat 3: lE+RUsc9cdVV9eEi8uytew (big blind) collected ($12)
Seat 4: B87ikIyZ/TzAVeXf38Ny0g folded before Flop (didn't bet)
Seat 5: X7GlkHF+lkbarCLuZ4Uf0w folded before Flop (didn't bet)



PokerStars Game #59938753120:  Hold'em No Limit ($1/$2) - 2009/07/01 0:22:38 ET
Table 'NmY84NAf9Mh0ckAckHnh5g' 2-max Seat #2 is the button
Seat 1: 6hvg964TSqZ3AL/0XK9aVQ ($612.95 in chips)
Seat 2: RwDoM55ZeQuI2ADyJhOb2Q ($231.50 in chips)
RwDoM55ZeQuI2ADyJhOb2Q: posts small blind $1
6hvg964TSqZ3AL/0XK9aVQ: posts big blind $2
*** HOLE CARDS ***
RwDoM55ZeQuI2ADyJhOb2Q: folds
6hvg964TSqZ3AL/0XK9aVQ collected $2 from pot
6hvg964TSqZ3AL/0XK9aVQ: doesn't show hand
*** SUMMARY ***
Total pot $2 | Rake $0
Seat 1: 6hvg964TSqZ3AL/0XK9aVQ (big blind) collected ($2)
Seat 2: RwDoM55ZeQuI2ADyJhOb2Q (button) (small blind) folded before Flop



PokerStars Game #59938755444:  Hold'em No Limit ($1/$2) - 2009/07/01 0:22:41 ET
Table 'uJ9juaXXg9yIcSU8amxaXQ' 6-max Seat #2 is the button
Seat 2: yynBOXUjw28V5kz84sxX4g ($140.05 in chips)
Seat 3: zaogaltCDFVsIASEnrXs2w ($294 in chips)
Seat 4: zNjJ/y4emmF+vzrCDd+ooA ($118 in chips)
Seat 5: aMZYAxFxWTQXE9aUus4sxg ($65.15 in chips)
Seat 6: XrFG4dK06RVKLlX32/pjcQ ($50 in chips)
zaogaltCDFVsIASEnrXs2w: posts small blind $1
zNjJ/y4emmF+vzrCDd+ooA: posts big blind $2
*** HOLE CARDS ***
aMZYAxFxWTQXE9aUus4sxg: calls $2
XrFG4dK06RVKLlX32/pjcQ: calls $2
yynBOXUjw28V5kz84sxX4g: calls $2
zaogaltCDFVsIASEnrXs2w: folds
zNjJ/y4emmF+vzrCDd+ooA: checks
*** FLOP *** [6c Kh Qc]
zNjJ/y4emmF+vzrCDd+ooA: bets $2
aMZYAxFxWTQXE9aUus4sxg: calls $2
XrFG4dK06RVKLlX32/pjcQ: calls $2
yynBOXUjw28V5kz84sxX4g: calls $2
*** TURN *** [6c Kh Qc] [9h]
zNjJ/y4emmF+vzrCDd+ooA: checks
aMZYAxFxWTQXE9aUus4sxg: checks
XrFG4dK06RVKLlX32/pjcQ: checks
yynBOXUjw28V5kz84sxX4g: checks
*** RIVER *** [6c Kh Qc 9h] [Td]
zNjJ/y4emmF+vzrCDd+ooA: bets $4
aMZYAxFxWTQXE9aUus4sxg: folds
XrFG4dK06RVKLlX32/pjcQ: raises $4 to $8
yynBOXUjw28V5kz84sxX4g: folds
zNjJ/y4emmF+vzrCDd+ooA: folds
XrFG4dK06RVKLlX32/pjcQ collected $23.80 from pot
*** SUMMARY ***
Total pot $25 | Rake $1.20
Board [6c Kh Qc 9h Td]
Seat 2: yynBOXUjw28V5kz84sxX4g (button) folded on the River
Seat 3: zaogaltCDFVsIASEnrXs2w (small blind) folded before Flop
Seat 4: zNjJ/y4emmF+vzrCDd+ooA (big blind) folded on the River
Seat 5: aMZYAxFxWTQXE9aUus4sxg folded on the River
Seat 6: XrFG4dK06RVKLlX32/pjcQ collected ($23.80)



PokerStars Game #59938755492:  Hold'em No Limit ($1/$2) - 2009/07/01 0:22:41 ET
Table 'eyAQSIlgc2o1Jxvbve4WGg' 9-max Seat #5 is the button
Seat 1: UZEsV9yKUMqmpYPiOFpaZw ($73 in chips)
Seat 2: g7gL2NLJCdZPPV399WKT1w ($48 in chips)
Seat 3: TAfo4veNRaRlzDXMMYS3Jg ($37 in chips)
Seat 4: miAHPEBdznuHNzK6YM3hRA ($138.95 in chips)
Seat 5: JnV3SM2D6dAFYyGZHHpvrg ($94 in chips)
Seat 6: IikcENBHwoT7snSvBPSc7Q ($150.60 in chips)
Seat 7: QHxJjpVYwitg9krW6wZgJA ($204.65 in chips)
Seat 8: 5iPk5MyO3KVu18Y8XCYfFQ ($40 in chips)
Seat 9: Hc2itIxwbi1lwa+DAYYQGg ($41.85 in chips)
IikcENBHwoT7snSvBPSc7Q: posts small blind $1
QHxJjpVYwitg9krW6wZgJA: posts big blind $2
*** HOLE CARDS ***
5iPk5MyO3KVu18Y8XCYfFQ: folds
Hc2itIxwbi1lwa+DAYYQGg: folds
UZEsV9yKUMqmpYPiOFpaZw: folds
g7gL2NLJCdZPPV399WKT1w has timed out
g7gL2NLJCdZPPV399WKT1w: folds
g7gL2NLJCdZPPV399WKT1w is sitting out
TAfo4veNRaRlzDXMMYS3Jg: folds
miAHPEBdznuHNzK6YM3hRA: calls $2
JnV3SM2D6dAFYyGZHHpvrg: folds
IikcENBHwoT7snSvBPSc7Q: calls $1
QHxJjpVYwitg9krW6wZgJA: checks
*** FLOP *** [Ks 6c 3s]
IikcENBHwoT7snSvBPSc7Q: checks
QHxJjpVYwitg9krW6wZgJA: checks
miAHPEBdznuHNzK6YM3hRA: checks
*** TURN *** [Ks 6c 3s] [8h]
IikcENBHwoT7snSvBPSc7Q: checks
g7gL2NLJCdZPPV399WKT1w has returned
QHxJjpVYwitg9krW6wZgJA: checks
miAHPEBdznuHNzK6YM3hRA: checks
*** RIVER *** [Ks 6c 3s 8h] [5s]
IikcENBHwoT7snSvBPSc7Q: checks
QHxJjpVYwitg9krW6wZgJA: checks
miAHPEBdznuHNzK6YM3hRA: checks
*** SHOW DOWN ***
IikcENBHwoT7snSvBPSc7Q: shows [Jh Ah] (high card Ace)
QHxJjpVYwitg9krW6wZgJA: shows [6d 4d] (a pair of Sixes)
miAHPEBdznuHNzK6YM3hRA: mucks hand
QHxJjpVYwitg9krW6wZgJA collected $5.70 from pot
*** SUMMARY ***
Total pot $6 | Rake $0.30
Board [Ks 6c 3s 8h 5s]
Seat 1: UZEsV9yKUMqmpYPiOFpaZw folded before Flop (didn't bet)
Seat 2: g7gL2NLJCdZPPV399WKT1w folded before Flop (didn't bet)
Seat 3: TAfo4veNRaRlzDXMMYS3Jg folded before Flop (didn't bet)
Seat 4: miAHPEBdznuHNzK6YM3hRA mucked
Seat 5: JnV3SM2D6dAFYyGZHHpvrg (button) folded before Flop (didn't bet)
Seat 6: IikcENBHwoT7snSvBPSc7Q (small blind) showed [Jh Ah] and lost with high card Ace
Seat 7: QHxJjpVYwitg9krW6wZgJA (big blind) showed [6d 4d] and won ($5.70) with a pair of Sixes
Seat 8: 5iPk5MyO3KVu18Y8XCYfFQ folded before Flop (didn't bet)
Seat 9: Hc2itIxwbi1lwa+DAYYQGg folded before Flop (didn't bet)



PokerStars Game #59938755728:  Hold'em No Limit ($1/$2) - 2009/07/01 0:22:42 ET
Table 'bIihwBANJSFqlHPPtset+w' 9-max Seat #6 is the button
Seat 1: jI3JDUGV63ccqtKgM3vMbw ($159.70 in chips)
Seat 2: lQYT23h5QCUVZAKxjOO39Q ($118.90 in chips)
Seat 3: acnZ0LD5jxKgWIHz+mpQ8Q ($200 in chips)
Seat 4: 7WWX5PClBdr/U44gUKBIEA ($293.05 in chips)
Seat 5: rNejrG5tkeRBbL+UmC0iJA ($180.20 in chips)
Seat 6: 5iPk5MyO3KVu18Y8XCYfFQ ($86.80 in chips)
Seat 8: iMe5yhc+1BaiIPHet3NMrA ($276.65 in chips)
pCmk6FpSOLJ+85o1tLHIag will be allowed to play after the button
iMe5yhc+1BaiIPHet3NMrA: posts small blind $1
rW/MyplHylMSBRaoRUzWrg: is sitting out
jI3JDUGV63ccqtKgM3vMbw: posts big blind $2
*** HOLE CARDS ***
lQYT23h5QCUVZAKxjOO39Q: folds
rW/MyplHylMSBRaoRUzWrg leaves the table
acnZ0LD5jxKgWIHz+mpQ8Q: raises $4 to $6
7WWX5PClBdr/U44gUKBIEA: folds
rNejrG5tkeRBbL+UmC0iJA: folds
5iPk5MyO3KVu18Y8XCYfFQ: folds
iMe5yhc+1BaiIPHet3NMrA: folds
jI3JDUGV63ccqtKgM3vMbw: folds
acnZ0LD5jxKgWIHz+mpQ8Q collected $5 from pot
*** SUMMARY ***
Total pot $5 | Rake $0
Seat 1: jI3JDUGV63ccqtKgM3vMbw (big blind) folded before Flop
Seat 2: lQYT23h5QCUVZAKxjOO39Q folded before Flop (didn't bet)
Seat 3: acnZ0LD5jxKgWIHz+mpQ8Q collected ($5)
Seat 4: 7WWX5PClBdr/U44gUKBIEA folded before Flop (didn't bet)
Seat 5: rNejrG5tkeRBbL+UmC0iJA folded before Flop (didn't bet)
Seat 6: 5iPk5MyO3KVu18Y8XCYfFQ (button) folded before Flop (didn't bet)
Seat 8: iMe5yhc+1BaiIPHet3NMrA (small blind) folded before Flop



PokerStars Game #59938756974:  Hold'em No Limit ($1/$2) - 2009/07/01 0:22:44 ET
Table 'mGpP9StWRnoeiBDExc6Frg' 6-max Seat #5 is the button
Seat 1: zWFU82nxIRvzK4mKiL4m0Q ($54.85 in chips)
Seat 2: DQlskgG4OtLpF2MVxLwf4A ($311.85 in chips)
Seat 3: 3HrFUl+TAqSP1U00zz3P7A ($83.65 in chips)
Seat 4: qXDd0ZyMIse0OBu8pxeQ3Q ($218 in chips)
Seat 5: d1puGuVBE0fidn+5eRJ0tw ($164.70 in chips)
Seat 6: X7GlkHF+lkbarCLuZ4Uf0w ($21.45 in chips)
X7GlkHF+lkbarCLuZ4Uf0w: posts small blind $1
zWFU82nxIRvzK4mKiL4m0Q: posts big blind $2
*** HOLE CARDS ***
DQlskgG4OtLpF2MVxLwf4A: folds
3HrFUl+TAqSP1U00zz3P7A: calls $2
qXDd0ZyMIse0OBu8pxeQ3Q: folds
d1puGuVBE0fidn+5eRJ0tw: folds
X7GlkHF+lkbarCLuZ4Uf0w: folds
zWFU82nxIRvzK4mKiL4m0Q: checks
*** FLOP *** [Tc 2d Qs]
zWFU82nxIRvzK4mKiL4m0Q: checks
3HrFUl+TAqSP1U00zz3P7A: bets $4
zWFU82nxIRvzK4mKiL4m0Q: folds
3HrFUl+TAqSP1U00zz3P7A collected $4.75 from pot
3HrFUl+TAqSP1U00zz3P7A: doesn't show hand
*** SUMMARY ***
Total pot $5 | Rake $0.25
Board [Tc 2d Qs]
Seat 1: zWFU82nxIRvzK4mKiL4m0Q (big blind) folded on the Flop
Seat 2: DQlskgG4OtLpF2MVxLwf4A folded before Flop (didn't bet)
Seat 3: 3HrFUl+TAqSP1U00zz3P7A collected ($4.75)
Seat 4: qXDd0ZyMIse0OBu8pxeQ3Q folded before Flop (didn't bet)
Seat 5: d1puGuVBE0fidn+5eRJ0tw (button) folded before Flop (didn't bet)
Seat 6: X7GlkHF+lkbarCLuZ4Uf0w (small blind) folded before Flop



PokerStars Game #59938757928:  Hold'em No Limit ($1/$2) - 2009/07/01 0:22:45 ET
Table 'NmY84NAf9Mh0ckAckHnh5g' 2-max Seat #1 is the button
Seat 1: 6hvg964TSqZ3AL/0XK9aVQ ($613.95 in chips)
Seat 2: RwDoM55ZeQuI2ADyJhOb2Q ($230.50 in chips)
6hvg964TSqZ3AL/0XK9aVQ: posts small blind $1
RwDoM55ZeQuI2ADyJhOb2Q: posts big blind $2
*** HOLE CARDS ***
6hvg964TSqZ3AL/0XK9aVQ: folds
RwDoM55ZeQuI2ADyJhOb2Q collected $2 from pot
RwDoM55ZeQuI2ADyJhOb2Q: doesn't show hand
*** SUMMARY ***
Total pot $2 | Rake $0
Seat 1: 6hvg964TSqZ3AL/0XK9aVQ (button) (small blind) folded before Flop
Seat 2: RwDoM55ZeQuI2ADyJhOb2Q (big blind) collected ($2)



PokerStars Game #59938757880:  Hold'em No Limit ($1/$2) - 2009/07/01 0:22:45 ET
Table '5G1PjWSk2ALz0O/eqyYy/g' 2-max Seat #2 is the button
Seat 1: Z4HwehErEwzsv/noQlfUlg ($161.90 in chips)
Seat 2: v4dp1VoMhJV4zmCXtmG5LQ ($207.50 in chips)
v4dp1VoMhJV4zmCXtmG5LQ: posts small blind $1
Z4HwehErEwzsv/noQlfUlg: posts big blind $2
*** HOLE CARDS ***
v4dp1VoMhJV4zmCXtmG5LQ: raises $4 to $6
Z4HwehErEwzsv/noQlfUlg: calls $4
*** FLOP *** [5h Ks 3h]
Z4HwehErEwzsv/noQlfUlg: checks
v4dp1VoMhJV4zmCXtmG5LQ: checks
*** TURN *** [5h Ks 3h] [9c]
Z4HwehErEwzsv/noQlfUlg: bets $4
v4dp1VoMhJV4zmCXtmG5LQ: calls $4
*** RIVER *** [5h Ks 3h 9c] [Ad]
Z4HwehErEwzsv/noQlfUlg: checks
v4dp1VoMhJV4zmCXtmG5LQ: bets $12
Z4HwehErEwzsv/noQlfUlg: folds
v4dp1VoMhJV4zmCXtmG5LQ collected $19.50 from pot
v4dp1VoMhJV4zmCXtmG5LQ: doesn't show hand
*** SUMMARY ***
Total pot $20 | Rake $0.50
Board [5h Ks 3h 9c Ad]
Seat 1: Z4HwehErEwzsv/noQlfUlg (big blind) folded on the River
Seat 2: v4dp1VoMhJV4zmCXtmG5LQ (button) (small blind) collected ($19.50)



PokerStars Game #59938757790:  Hold'em No Limit ($1/$2) - 2009/07/01 0:22:45 ET
Table 'gftD4mDF7mIFKvSrIyaRbw' 9-max Seat #9 is the button
Seat 2: CKDJ8bJWIRDDBziHsebH5w ($152.45 in chips)
Seat 3: CUZwDpLTQKhzarPe+JCLOQ ($200 in chips)
Seat 4: eeMEdaNqHXOk6uYL+zQnAA ($62.35 in chips)
Seat 5: mpsfNtnMVDqQHTe92AhIdw ($295.20 in chips)
Seat 6: 2NvwF8W2nzsbS+G//yLAbQ ($41.90 in chips)
Seat 7: 5iPk5MyO3KVu18Y8XCYfFQ ($49.65 in chips)
Seat 8: R/wPwjEcvTU2fxPXxn/XgQ ($76.55 in chips)
Seat 9: F7m34OOfAQ7annesMHVjKw ($203.30 in chips)
trion12: is sitting out
CKDJ8bJWIRDDBziHsebH5w: posts small blind $1
CUZwDpLTQKhzarPe+JCLOQ: posts big blind $2
*** HOLE CARDS ***
eeMEdaNqHXOk6uYL+zQnAA: folds
mpsfNtnMVDqQHTe92AhIdw: folds
2NvwF8W2nzsbS+G//yLAbQ: folds
5iPk5MyO3KVu18Y8XCYfFQ: folds
trion12 leaves the table
TAfo4veNRaRlzDXMMYS3Jg joins the table at seat #1
R/wPwjEcvTU2fxPXxn/XgQ: folds
F7m34OOfAQ7annesMHVjKw: raises $2 to $4
CKDJ8bJWIRDDBziHsebH5w: folds
CUZwDpLTQKhzarPe+JCLOQ: calls $2
*** FLOP *** [8s Tc 9d]
CUZwDpLTQKhzarPe+JCLOQ: bets $6
F7m34OOfAQ7annesMHVjKw: calls $6
*** TURN *** [8s Tc 9d] [6d]
CUZwDpLTQKhzarPe+JCLOQ: bets $10
F7m34OOfAQ7annesMHVjKw: raises $10 to $20
CUZwDpLTQKhzarPe+JCLOQ: calls $10
*** RIVER *** [8s Tc 9d 6d] [5h]
CUZwDpLTQKhzarPe+JCLOQ: checks
F7m34OOfAQ7annesMHVjKw: checks
*** SHOW DOWN ***
CUZwDpLTQKhzarPe+JCLOQ: shows [Th Qs] (a pair of Tens)
F7m34OOfAQ7annesMHVjKw: shows [8c 6s] (two pair, Eights and Sixes)
F7m34OOfAQ7annesMHVjKw collected $58 from pot
*** SUMMARY ***
Total pot $61 | Rake $3
Board [8s Tc 9d 6d 5h]
Seat 2: CKDJ8bJWIRDDBziHsebH5w (small blind) folded before Flop
Seat 3: CUZwDpLTQKhzarPe+JCLOQ (big blind) showed [Th Qs] and lost with a pair of Tens
Seat 4: eeMEdaNqHXOk6uYL+zQnAA folded before Flop (didn't bet)
Seat 5: mpsfNtnMVDqQHTe92AhIdw folded before Flop (didn't bet)
Seat 6: 2NvwF8W2nzsbS+G//yLAbQ folded before Flop (didn't bet)
Seat 7: 5iPk5MyO3KVu18Y8XCYfFQ folded before Flop (didn't bet)
Seat 8: R/wPwjEcvTU2fxPXxn/XgQ folded before Flop (didn't bet)
Seat 9: F7m34OOfAQ7annesMHVjKw (button) showed [8c 6s] and won ($58) with two pair, Eights and Sixes



PokerStars Game #59938760982:  Hold'em No Limit ($1/$2) - 2009/07/01 0:22:50 ET
Table 'rKeCh+eBn4RNvybCUYkoTQ' 9-max Seat #4 is the button
Seat 1: De9g+AYjo0DN6C/+iT/nsg ($246.30 in chips)
Seat 2: oEFhmBFI/N1eUlbVXORRnw ($192.65 in chips)
Seat 3: R9FzbEg1XYsiOty4kvbqhg ($142.30 in chips)
Seat 4: x/sLO+9OHvhcHLxOgSmnOg ($56.75 in chips)
Seat 5: iuQs2eTwwwpiBYdCIQ/ogA ($163.45 in chips)
Seat 6: TAfo4veNRaRlzDXMMYS3Jg ($42 in chips)
Seat 7: U+Qo1rnyH4lm7ehksiWi7w ($61.20 in chips)
Seat 8: pN/Ip0ePsUVIdUlGgLrkUw ($217.40 in chips)
Seat 9: SZnYUzONNVlDaSCSt67hQA ($69.15 in chips)
iuQs2eTwwwpiBYdCIQ/ogA: posts small blind $1
TAfo4veNRaRlzDXMMYS3Jg: posts big blind $2
*** HOLE CARDS ***
U+Qo1rnyH4lm7ehksiWi7w: folds
pN/Ip0ePsUVIdUlGgLrkUw: raises $4 to $6
SZnYUzONNVlDaSCSt67hQA: folds
De9g+AYjo0DN6C/+iT/nsg: folds
oEFhmBFI/N1eUlbVXORRnw: folds
R9FzbEg1XYsiOty4kvbqhg: folds
x/sLO+9OHvhcHLxOgSmnOg: folds
iuQs2eTwwwpiBYdCIQ/ogA: calls $5
TAfo4veNRaRlzDXMMYS3Jg: folds
*** FLOP *** [5s Qs 9h]
iuQs2eTwwwpiBYdCIQ/ogA: checks
pN/Ip0ePsUVIdUlGgLrkUw: bets $8
iuQs2eTwwwpiBYdCIQ/ogA: folds
pN/Ip0ePsUVIdUlGgLrkUw collected $13.30 from pot
pN/Ip0ePsUVIdUlGgLrkUw: doesn't show hand
*** SUMMARY ***
Total pot $14 | Rake $0.70
Board [5s Qs 9h]
Seat 1: De9g+AYjo0DN6C/+iT/nsg folded before Flop (didn't bet)
Seat 2: oEFhmBFI/N1eUlbVXORRnw folded before Flop (didn't bet)
Seat 3: R9FzbEg1XYsiOty4kvbqhg folded before Flop (didn't bet)
Seat 4: x/sLO+9OHvhcHLxOgSmnOg (button) folded before Flop (didn't bet)
Seat 5: iuQs2eTwwwpiBYdCIQ/ogA (small blind) folded on the Flop
Seat 6: TAfo4veNRaRlzDXMMYS3Jg (big blind) folded before Flop
Seat 7: U+Qo1rnyH4lm7ehksiWi7w folded before Flop (didn't bet)
Seat 8: pN/Ip0ePsUVIdUlGgLrkUw collected ($13.30)
Seat 9: SZnYUzONNVlDaSCSt67hQA folded before Flop (didn't bet)



PokerStars Game #59938762058:  Hold'em No Limit ($1/$2) - 2009/07/01 0:22:51 ET
Table 'NmY84NAf9Mh0ckAckHnh5g' 2-max Seat #2 is the button
Seat 1: 6hvg964TSqZ3AL/0XK9aVQ ($612.95 in chips)
Seat 2: RwDoM55ZeQuI2ADyJhOb2Q ($231.50 in chips)
RwDoM55ZeQuI2ADyJhOb2Q: posts small blind $1
6hvg964TSqZ3AL/0XK9aVQ: posts big blind $2
*** HOLE CARDS ***
RwDoM55ZeQuI2ADyJhOb2Q: raises $4 to $6
6hvg964TSqZ3AL/0XK9aVQ: calls $4
*** FLOP *** [9s 5c 4d]
6hvg964TSqZ3AL/0XK9aVQ: checks
RwDoM55ZeQuI2ADyJhOb2Q: bets $8
6hvg964TSqZ3AL/0XK9aVQ: calls $8
*** TURN *** [9s 5c 4d] [9c]
6hvg964TSqZ3AL/0XK9aVQ: checks
RwDoM55ZeQuI2ADyJhOb2Q: bets $22
6hvg964TSqZ3AL/0XK9aVQ: calls $22
*** RIVER *** [9s 5c 4d 9c] [5s]
6hvg964TSqZ3AL/0XK9aVQ: checks
RwDoM55ZeQuI2ADyJhOb2Q: bets $42
6hvg964TSqZ3AL/0XK9aVQ: folds
RwDoM55ZeQuI2ADyJhOb2Q collected $71.50 from pot
RwDoM55ZeQuI2ADyJhOb2Q: doesn't show hand
*** SUMMARY ***
Total pot $72 | Rake $0.50
Board [9s 5c 4d 9c 5s]
Seat 1: 6hvg964TSqZ3AL/0XK9aVQ (big blind) folded on the River
Seat 2: RwDoM55ZeQuI2ADyJhOb2Q (button) (small blind) collected ($71.50)



PokerStars Game #59938765304:  Hold'em No Limit ($1/$2) - 2009/07/01 0:22:56 ET
Table 'gnHBqWll9O3fxG7Ojkz/ng' 9-max Seat #7 is the button
Seat 1: hpqdC/23wXosGOmzARr5NA ($147.05 in chips)
Seat 2: H6Z4+qu8gR0VUiPOijndVg ($200 in chips)
Seat 3: 5Q8U6iZbeO7xJSS4qvDP5g ($228.35 in chips)
Seat 5: rBQDMkKm9cZn6M9NPsiVew ($117 in chips)
Seat 6: 5iPk5MyO3KVu18Y8XCYfFQ ($55.45 in chips)
Seat 7: jqui3xAWCkcdPW36a6BD+w ($214.55 in chips)
Seat 8: cM6efHzdxoqYm0EQKP4TTQ ($106.80 in chips)
cM6efHzdxoqYm0EQKP4TTQ: posts small blind $1
hpqdC/23wXosGOmzARr5NA: posts big blind $2
*** HOLE CARDS ***
H6Z4+qu8gR0VUiPOijndVg: folds
GX1heJ+DSsvm7gzSPsYhhQ joins the table at seat #9
5Q8U6iZbeO7xJSS4qvDP5g: folds
rBQDMkKm9cZn6M9NPsiVew: calls $2
5iPk5MyO3KVu18Y8XCYfFQ: raises $53.45 to $55.45 and is all-in
jqui3xAWCkcdPW36a6BD+w: folds
cM6efHzdxoqYm0EQKP4TTQ: folds
hpqdC/23wXosGOmzARr5NA: folds
rBQDMkKm9cZn6M9NPsiVew: calls $53.45
*** FLOP *** [6c Tc 8d]
*** TURN *** [6c Tc 8d] [8s]
*** RIVER *** [6c Tc 8d 8s] [3s]
*** SHOW DOWN ***
rBQDMkKm9cZn6M9NPsiVew: shows [Ad Td] (two pair, Tens and Eights)
5iPk5MyO3KVu18Y8XCYfFQ: mucks hand
rBQDMkKm9cZn6M9NPsiVew collected $110.90 from pot
*** SUMMARY ***
Total pot $113.90 | Rake $3
Board [6c Tc 8d 8s 3s]
Seat 1: hpqdC/23wXosGOmzARr5NA (big blind) folded before Flop
Seat 2: H6Z4+qu8gR0VUiPOijndVg folded before Flop (didn't bet)
Seat 3: 5Q8U6iZbeO7xJSS4qvDP5g folded before Flop (didn't bet)
Seat 5: rBQDMkKm9cZn6M9NPsiVew showed [Ad Td] and won ($110.90) with two pair, Tens and Eights
Seat 6: 5iPk5MyO3KVu18Y8XCYfFQ mucked
Seat 7: jqui3xAWCkcdPW36a6BD+w (button) folded before Flop (didn't bet)
Seat 8: cM6efHzdxoqYm0EQKP4TTQ (small blind) folded before Flop



PokerStars Game #59938766580:  Hold'em No Limit ($1/$2) - 2009/07/01 0:22:58 ET
Table 'srul5UFZXTEccVV5fpY91g' 9-max Seat #2 is the button
Seat 1: lfD8cBv31A/pio3pXJbPjA ($153.20 in chips)
Seat 2: tJYod1SLp2AcWPL/3hZ7ug ($67.20 in chips)
Seat 3: weUZ8S7tgbaeIpzi1gBNxQ ($46.75 in chips)
Seat 4: GG5lTuGt3+kwNYSbqeB6yw ($92.40 in chips)
Seat 5: 5iPk5MyO3KVu18Y8XCYfFQ ($79.55 in chips)
Seat 6: TAfo4veNRaRlzDXMMYS3Jg ($33 in chips)
Seat 7: s0erZsDxbZSaEPheMgibKg ($444.10 in chips)
Seat 8: UZEsV9yKUMqmpYPiOFpaZw ($73 in chips)
Seat 9: jRGC4KXXODbHEN275TXFCA ($176.95 in chips)
weUZ8S7tgbaeIpzi1gBNxQ: posts small blind $1
GG5lTuGt3+kwNYSbqeB6yw: posts big blind $2
*** HOLE CARDS ***
5iPk5MyO3KVu18Y8XCYfFQ: folds
TAfo4veNRaRlzDXMMYS3Jg: folds
s0erZsDxbZSaEPheMgibKg: folds
UZEsV9yKUMqmpYPiOFpaZw: folds
jRGC4KXXODbHEN275TXFCA: calls $2
lfD8cBv31A/pio3pXJbPjA: folds
tJYod1SLp2AcWPL/3hZ7ug: folds
weUZ8S7tgbaeIpzi1gBNxQ: calls $1
GG5lTuGt3+kwNYSbqeB6yw: checks
*** FLOP *** [Ah 5d 6s]
weUZ8S7tgbaeIpzi1gBNxQ: checks
GG5lTuGt3+kwNYSbqeB6yw: checks
jRGC4KXXODbHEN275TXFCA: checks
*** TURN *** [Ah 5d 6s] [Tc]
weUZ8S7tgbaeIpzi1gBNxQ: checks
GG5lTuGt3+kwNYSbqeB6yw: checks
jRGC4KXXODbHEN275TXFCA: bets $4
weUZ8S7tgbaeIpzi1gBNxQ: folds
GG5lTuGt3+kwNYSbqeB6yw: calls $4
*** RIVER *** [Ah 5d 6s Tc] [Kh]
GG5lTuGt3+kwNYSbqeB6yw: checks
jRGC4KXXODbHEN275TXFCA: checks
*** SHOW DOWN ***
GG5lTuGt3+kwNYSbqeB6yw: shows [9s 5c] (a pair of Fives)
jRGC4KXXODbHEN275TXFCA: shows [Ts 9d] (a pair of Tens)
jRGC4KXXODbHEN275TXFCA collected $13.35 from pot
*** SUMMARY ***
Total pot $14 | Rake $0.65
Board [Ah 5d 6s Tc Kh]
Seat 1: lfD8cBv31A/pio3pXJbPjA folded before Flop (didn't bet)
Seat 2: tJYod1SLp2AcWPL/3hZ7ug (button) folded before Flop (didn't bet)
Seat 3: weUZ8S7tgbaeIpzi1gBNxQ (small blind) folded on the Turn
Seat 4: GG5lTuGt3+kwNYSbqeB6yw (big blind) showed [9s 5c] and lost with a pair of Fives
Seat 5: 5iPk5MyO3KVu18Y8XCYfFQ folded before Flop (didn't bet)
Seat 6: TAfo4veNRaRlzDXMMYS3Jg folded before Flop (didn't bet)
Seat 7: s0erZsDxbZSaEPheMgibKg folded before Flop (didn't bet)
Seat 8: UZEsV9yKUMqmpYPiOFpaZw folded before Flop (didn't bet)
Seat 9: jRGC4KXXODbHEN275TXFCA showed [Ts 9d] and won ($13.35) with a pair of Tens



PokerStars Game #59938767508:  Hold'em No Limit ($1/$2) - 2009/07/01 0:22:59 ET
Table 'CFkQcfWjKccZaZDf71FK+w' 6-max Seat #2 is the button
Seat 1: U2A5Hv6ib/5+gzO2wr7Z4w ($200 in chips)
Seat 2: X7GlkHF+lkbarCLuZ4Uf0w ($37 in chips)
Seat 4: e8nZKSbIdIO7e2NdQe/OFQ ($234.80 in chips)
Seat 5: 1njbh8TKSUF6l4V1XwGdcg ($213.80 in chips)
Seat 6: ORVqY3rf9X6ANA/8s+On2Q ($88.85 in chips)
e8nZKSbIdIO7e2NdQe/OFQ: posts small blind $1
1njbh8TKSUF6l4V1XwGdcg: posts big blind $2
*** HOLE CARDS ***
ORVqY3rf9X6ANA/8s+On2Q has timed out while being disconnected
ORVqY3rf9X6ANA/8s+On2Q: folds
ORVqY3rf9X6ANA/8s+On2Q is sitting out
U2A5Hv6ib/5+gzO2wr7Z4w: folds
X7GlkHF+lkbarCLuZ4Uf0w: raises $2 to $4
e8nZKSbIdIO7e2NdQe/OFQ: folds
1njbh8TKSUF6l4V1XwGdcg: raises $6 to $10
ORVqY3rf9X6ANA/8s+On2Q is disconnected
X7GlkHF+lkbarCLuZ4Uf0w: folds
1njbh8TKSUF6l4V1XwGdcg collected $9 from pot
*** SUMMARY ***
Total pot $9 | Rake $0
Seat 1: U2A5Hv6ib/5+gzO2wr7Z4w folded before Flop (didn't bet)
Seat 2: X7GlkHF+lkbarCLuZ4Uf0w (button) folded before Flop
Seat 4: e8nZKSbIdIO7e2NdQe/OFQ (small blind) folded before Flop
Seat 5: 1njbh8TKSUF6l4V1XwGdcg (big blind) collected ($9)
Seat 6: ORVqY3rf9X6ANA/8s+On2Q folded before Flop (didn't bet)



PokerStars Game #59938768626:  Hold'em No Limit ($1/$2) - 2009/07/01 0:23:01 ET
Table 'P/yCfYl1GfGsu/e6DxDy/A' 2-max Seat #1 is the button
Seat 1: 7fOCUy3x9hdkmXkkDNolGQ ($200 in chips)
Seat 2: RwDoM55ZeQuI2ADyJhOb2Q ($619 in chips)
7fOCUy3x9hdkmXkkDNolGQ: posts small blind $1
RwDoM55ZeQuI2ADyJhOb2Q: posts big blind $2
*** HOLE CARDS ***
7fOCUy3x9hdkmXkkDNolGQ: folds
RwDoM55ZeQuI2ADyJhOb2Q collected $2 from pot
RwDoM55ZeQuI2ADyJhOb2Q: doesn't show hand
*** SUMMARY ***
Total pot $2 | Rake $0
Seat 1: 7fOCUy3x9hdkmXkkDNolGQ (button) (small blind) folded before Flop
Seat 2: RwDoM55ZeQuI2ADyJhOb2Q (big blind) collected ($2)



PokerStars Game #59938771518:  Hold'em No Limit ($1/$2) - 2009/07/01 0:23:05 ET
Table 'W9UeSV0aoPjh5SFSxM8jUQ' 9-max Seat #7 is the button
Seat 1: cdC54j9fGGojcbzWB5PgzA ($204.60 in chips)
Seat 2: iMe5yhc+1BaiIPHet3NMrA ($316.75 in chips)
Seat 3: TAfo4veNRaRlzDXMMYS3Jg ($37 in chips)
Seat 4: De9g+AYjo0DN6C/+iT/nsg ($286.10 in chips)
Seat 5: CUZwDpLTQKhzarPe+JCLOQ ($200 in chips)
Seat 6: MXxB6weBWzZyAhRZb+/KVg ($193 in chips)
Seat 7: 4Cl43Q1TYQL8wn1NSCUkaw ($43.60 in chips)
Seat 8: GX1heJ+DSsvm7gzSPsYhhQ ($41.80 in chips)
Seat 9: U2A5Hv6ib/5+gzO2wr7Z4w ($203 in chips)
GX1heJ+DSsvm7gzSPsYhhQ: posts small blind $1
U2A5Hv6ib/5+gzO2wr7Z4w: posts big blind $2
*** HOLE CARDS ***
cdC54j9fGGojcbzWB5PgzA: folds
iMe5yhc+1BaiIPHet3NMrA: folds
TAfo4veNRaRlzDXMMYS3Jg: folds
De9g+AYjo0DN6C/+iT/nsg: folds
CUZwDpLTQKhzarPe+JCLOQ: folds
MXxB6weBWzZyAhRZb+/KVg: calls $2
4Cl43Q1TYQL8wn1NSCUkaw: folds
GX1heJ+DSsvm7gzSPsYhhQ: calls $1
U2A5Hv6ib/5+gzO2wr7Z4w: checks
*** FLOP *** [6c Jc 7d]
GX1heJ+DSsvm7gzSPsYhhQ: checks
U2A5Hv6ib/5+gzO2wr7Z4w: bets $6
MXxB6weBWzZyAhRZb+/KVg: raises $6 to $12
GX1heJ+DSsvm7gzSPsYhhQ: folds
U2A5Hv6ib/5+gzO2wr7Z4w: raises $38 to $50
MXxB6weBWzZyAhRZb+/KVg: calls $38
*** TURN *** [6c Jc 7d] [7h]
TAfo4veNRaRlzDXMMYS3Jg is disconnected
U2A5Hv6ib/5+gzO2wr7Z4w: bets $46
MXxB6weBWzZyAhRZb+/KVg: raises $95 to $141 and is all-in
U2A5Hv6ib/5+gzO2wr7Z4w: calls $95
*** RIVER *** [6c Jc 7d 7h] [2h]
*** SHOW DOWN ***
U2A5Hv6ib/5+gzO2wr7Z4w: shows [6h 6s] (a full house, Sixes full of Sevens)
MXxB6weBWzZyAhRZb+/KVg: mucks hand
U2A5Hv6ib/5+gzO2wr7Z4w collected $385 from pot
*** SUMMARY ***
Total pot $388 | Rake $3
Board [6c Jc 7d 7h 2h]
Seat 1: cdC54j9fGGojcbzWB5PgzA folded before Flop (didn't bet)
Seat 2: iMe5yhc+1BaiIPHet3NMrA folded before Flop (didn't bet)
Seat 3: TAfo4veNRaRlzDXMMYS3Jg folded before Flop (didn't bet)
Seat 4: De9g+AYjo0DN6C/+iT/nsg folded before Flop (didn't bet)
Seat 5: CUZwDpLTQKhzarPe+JCLOQ folded before Flop (didn't bet)
Seat 6: MXxB6weBWzZyAhRZb+/KVg mucked
Seat 7: 4Cl43Q1TYQL8wn1NSCUkaw (button) folded before Flop (didn't bet)
Seat 8: GX1heJ+DSsvm7gzSPsYhhQ (small blind) folded on the Flop
Seat 9: U2A5Hv6ib/5+gzO2wr7Z4w (big blind) showed [6h 6s] and won ($385) with a full house, Sixes full of Sevens



PokerStars Game #59938772386:  Hold'em No Limit ($1/$2) - 2009/07/01 0:23:06 ET
Table 'OZyw34U4j4WtFFWsEHZQgQ' 2-max Seat #1 is the button
Seat 1: pVqEzK9wXlRMECnb1Zg4Zw ($67.90 in chips)
Seat 2: rAtTyvrJ8f1LaUh2O5U4nA ($54.70 in chips)
pVqEzK9wXlRMECnb1Zg4Zw: posts small blind $1
rAtTyvrJ8f1LaUh2O5U4nA: posts big blind $2
*** HOLE CARDS ***
pVqEzK9wXlRMECnb1Zg4Zw: raises $4 to $6
rAtTyvrJ8f1LaUh2O5U4nA: folds
pVqEzK9wXlRMECnb1Zg4Zw collected $4 from pot
pVqEzK9wXlRMECnb1Zg4Zw: doesn't show hand
*** SUMMARY ***
Total pot $4 | Rake $0
Seat 1: pVqEzK9wXlRMECnb1Zg4Zw (button) (small blind) collected ($4)
Seat 2: rAtTyvrJ8f1LaUh2O5U4nA (big blind) folded before Flop



PokerStars Game #59938772438:  Hold'em No Limit ($1/$2) - 2009/07/01 0:23:07 ET
Table 'P/yCfYl1GfGsu/e6DxDy/A' 2-max Seat #2 is the button
Seat 1: 7fOCUy3x9hdkmXkkDNolGQ ($200 in chips)
Seat 2: RwDoM55ZeQuI2ADyJhOb2Q ($620 in chips)
RwDoM55ZeQuI2ADyJhOb2Q: posts small blind $1
7fOCUy3x9hdkmXkkDNolGQ: posts big blind $2
*** HOLE CARDS ***
RwDoM55ZeQuI2ADyJhOb2Q: folds
7fOCUy3x9hdkmXkkDNolGQ collected $2 from pot
7fOCUy3x9hdkmXkkDNolGQ: doesn't show hand
*** SUMMARY ***
Total pot $2 | Rake $0
Seat 1: 7fOCUy3x9hdkmXkkDNolGQ (big blind) collected ($2)
Seat 2: RwDoM55ZeQuI2ADyJhOb2Q (button) (small blind) folded before Flop



PokerStars Game #59938774446:  Hold'em No Limit ($1/$2) - 2009/07/01 0:23:09 ET
Table 'bIihwBANJSFqlHPPtset+w' 9-max Seat #8 is the button
Seat 1: jI3JDUGV63ccqtKgM3vMbw ($157.70 in chips)
Seat 2: lQYT23h5QCUVZAKxjOO39Q ($118.90 in chips)
Seat 3: acnZ0LD5jxKgWIHz+mpQ8Q ($203 in chips)
Seat 4: 7WWX5PClBdr/U44gUKBIEA ($293.05 in chips)
Seat 5: rNejrG5tkeRBbL+UmC0iJA ($180.20 in chips)
Seat 6: 5iPk5MyO3KVu18Y8XCYfFQ ($86.80 in chips)
Seat 7: pCmk6FpSOLJ+85o1tLHIag ($100 in chips)
Seat 8: iMe5yhc+1BaiIPHet3NMrA ($275.65 in chips)
jI3JDUGV63ccqtKgM3vMbw: posts small blind $1
lQYT23h5QCUVZAKxjOO39Q: posts big blind $2
pCmk6FpSOLJ+85o1tLHIag: posts big blind $2
*** HOLE CARDS ***
acnZ0LD5jxKgWIHz+mpQ8Q: raises $6 to $8
7WWX5PClBdr/U44gUKBIEA: folds
rNejrG5tkeRBbL+UmC0iJA: folds
GX1heJ+DSsvm7gzSPsYhhQ joins the table at seat #9
5iPk5MyO3KVu18Y8XCYfFQ: folds
pCmk6FpSOLJ+85o1tLHIag: calls $6
iMe5yhc+1BaiIPHet3NMrA: folds
jI3JDUGV63ccqtKgM3vMbw: folds
lQYT23h5QCUVZAKxjOO39Q: calls $6
*** FLOP *** [9c 8d 2h]
lQYT23h5QCUVZAKxjOO39Q: checks
acnZ0LD5jxKgWIHz+mpQ8Q: bets $18
pCmk6FpSOLJ+85o1tLHIag: folds
lQYT23h5QCUVZAKxjOO39Q: folds
acnZ0LD5jxKgWIHz+mpQ8Q collected $23.75 from pot
*** SUMMARY ***
Total pot $25 | Rake $1.25
Board [9c 8d 2h]
Seat 1: jI3JDUGV63ccqtKgM3vMbw (small blind) folded before Flop
Seat 2: lQYT23h5QCUVZAKxjOO39Q (big blind) folded on the Flop
Seat 3: acnZ0LD5jxKgWIHz+mpQ8Q collected ($23.75)
Seat 4: 7WWX5PClBdr/U44gUKBIEA folded before Flop (didn't bet)
Seat 5: rNejrG5tkeRBbL+UmC0iJA folded before Flop (didn't bet)
Seat 6: 5iPk5MyO3KVu18Y8XCYfFQ folded before Flop (didn't bet)
Seat 7: pCmk6FpSOLJ+85o1tLHIag folded on the Flop
Seat 8: iMe5yhc+1BaiIPHet3NMrA (button) folded before Flop (didn't bet)



PokerStars Game #59938775484:  Hold'em No Limit ($1/$2) - 2009/07/01 0:23:11 ET
Table 'mGpP9StWRnoeiBDExc6Frg' 6-max Seat #6 is the button
Seat 1: zWFU82nxIRvzK4mKiL4m0Q ($52.85 in chips)
Seat 2: DQlskgG4OtLpF2MVxLwf4A ($311.85 in chips)
Seat 3: 3HrFUl+TAqSP1U00zz3P7A ($86.40 in chips)
Seat 4: qXDd0ZyMIse0OBu8pxeQ3Q ($218 in chips)
Seat 5: d1puGuVBE0fidn+5eRJ0tw ($164.70 in chips)
Seat 6: X7GlkHF+lkbarCLuZ4Uf0w ($20.45 in chips)
zWFU82nxIRvzK4mKiL4m0Q: posts small blind $1
DQlskgG4OtLpF2MVxLwf4A: posts big blind $2
*** HOLE CARDS ***
3HrFUl+TAqSP1U00zz3P7A: folds
qXDd0ZyMIse0OBu8pxeQ3Q: folds
d1puGuVBE0fidn+5eRJ0tw: folds
X7GlkHF+lkbarCLuZ4Uf0w: raises $2 to $4
zWFU82nxIRvzK4mKiL4m0Q: raises $2 to $6
DQlskgG4OtLpF2MVxLwf4A: folds
X7GlkHF+lkbarCLuZ4Uf0w: calls $2
*** FLOP *** [4h 6c 2s]
zWFU82nxIRvzK4mKiL4m0Q: bets $6
X7GlkHF+lkbarCLuZ4Uf0w: folds
zWFU82nxIRvzK4mKiL4m0Q collected $13.30 from pot
*** SUMMARY ***
Total pot $14 | Rake $0.70
Board [4h 6c 2s]
Seat 1: zWFU82nxIRvzK4mKiL4m0Q (small blind) collected ($13.30)
Seat 2: DQlskgG4OtLpF2MVxLwf4A (big blind) folded before Flop
Seat 3: 3HrFUl+TAqSP1U00zz3P7A folded before Flop (didn't bet)
Seat 4: qXDd0ZyMIse0OBu8pxeQ3Q folded before Flop (didn't bet)
Seat 5: d1puGuVBE0fidn+5eRJ0tw folded before Flop (didn't bet)
Seat 6: X7GlkHF+lkbarCLuZ4Uf0w (button) folded on the Flop



PokerStars Game #59938777610:  Hold'em No Limit ($1/$2) - 2009/07/01 0:23:14 ET
Table 'P/yCfYl1GfGsu/e6DxDy/A' 2-max Seat #1 is the button
Seat 1: 7fOCUy3x9hdkmXkkDNolGQ ($201 in chips)
Seat 2: RwDoM55ZeQuI2ADyJhOb2Q ($619 in chips)
7fOCUy3x9hdkmXkkDNolGQ: posts small blind $1
RwDoM55ZeQuI2ADyJhOb2Q: posts big blind $2
*** HOLE CARDS ***
7fOCUy3x9hdkmXkkDNolGQ: folds
RwDoM55ZeQuI2ADyJhOb2Q collected $2 from pot
RwDoM55ZeQuI2ADyJhOb2Q: doesn't show hand
*** SUMMARY ***
Total pot $2 | Rake $0
Seat 1: 7fOCUy3x9hdkmXkkDNolGQ (button) (small blind) folded before Flop
Seat 2: RwDoM55ZeQuI2ADyJhOb2Q (big blind) collected ($2)



PokerStars Game #59938777730:  Hold'em No Limit ($1/$2) - 2009/07/01 0:23:14 ET
Table 'G1Oqdy4Pqdb5gtx40rUBzA' 6-max Seat #2 is the button
Seat 1: bz8Aw6kfX2xUq2sOyZlUCQ ($85.85 in chips)
Seat 2: IzslX/oV8DoDQfxCV/3+kg ($464.15 in chips)
Seat 3: lE+RUsc9cdVV9eEi8uytew ($187.95 in chips)
Seat 4: B87ikIyZ/TzAVeXf38Ny0g ($200 in chips)
Seat 5: X7GlkHF+lkbarCLuZ4Uf0w ($78 in chips)
lE+RUsc9cdVV9eEi8uytew: posts small blind $1
B87ikIyZ/TzAVeXf38Ny0g: posts big blind $2
*** HOLE CARDS ***
X7GlkHF+lkbarCLuZ4Uf0w: folds
bz8Aw6kfX2xUq2sOyZlUCQ: folds
IzslX/oV8DoDQfxCV/3+kg: folds
lE+RUsc9cdVV9eEi8uytew: calls $1
B87ikIyZ/TzAVeXf38Ny0g: checks
*** FLOP *** [8d Qd Kc]
lE+RUsc9cdVV9eEi8uytew: checks
B87ikIyZ/TzAVeXf38Ny0g: bets $4
lE+RUsc9cdVV9eEi8uytew: folds
B87ikIyZ/TzAVeXf38Ny0g collected $3.80 from pot
B87ikIyZ/TzAVeXf38Ny0g: doesn't show hand
*** SUMMARY ***
Total pot $4 | Rake $0.20
Board [8d Qd Kc]
Seat 1: bz8Aw6kfX2xUq2sOyZlUCQ folded before Flop (didn't bet)
Seat 2: IzslX/oV8DoDQfxCV/3+kg (button) folded before Flop (didn't bet)
Seat 3: lE+RUsc9cdVV9eEi8uytew (small blind) folded on the Flop
Seat 4: B87ikIyZ/TzAVeXf38Ny0g (big blind) collected ($3.80)
Seat 5: X7GlkHF+lkbarCLuZ4Uf0w folded before Flop (didn't bet)



PokerStars Game #59938777192:  Hold'em No Limit ($1/$2) - 2009/07/01 0:23:14 ET
Table 'ZzSIe0zTCDv+n6hfbY5tTg' 6-max Seat #2 is the button
Seat 2: B87ikIyZ/TzAVeXf38Ny0g ($200 in chips)
Seat 3: X7GlkHF+lkbarCLuZ4Uf0w ($64 in chips)
Seat 4: ky55L0pITYgYLeqFB9gP/Q ($193.40 in chips)
Seat 6: InmkdI6G8TzSj9NhcCSyPg ($200 in chips)
X7GlkHF+lkbarCLuZ4Uf0w: posts small blind $1
ky55L0pITYgYLeqFB9gP/Q: posts big blind $2
f2eTKbND+tM3kUw9o6WYWg: sits out
*** HOLE CARDS ***
InmkdI6G8TzSj9NhcCSyPg: folds
B87ikIyZ/TzAVeXf38Ny0g: raises $4 to $6
X7GlkHF+lkbarCLuZ4Uf0w: folds
ky55L0pITYgYLeqFB9gP/Q: folds
B87ikIyZ/TzAVeXf38Ny0g collected $5 from pot
B87ikIyZ/TzAVeXf38Ny0g: doesn't show hand
*** SUMMARY ***
Total pot $5 | Rake $0
Seat 2: B87ikIyZ/TzAVeXf38Ny0g (button) collected ($5)
Seat 3: X7GlkHF+lkbarCLuZ4Uf0w (small blind) folded before Flop
Seat 4: ky55L0pITYgYLeqFB9gP/Q (big blind) folded before Flop
Seat 6: InmkdI6G8TzSj9NhcCSyPg folded before Flop (didn't bet)



PokerStars Game #59938779018:  Hold'em No Limit ($1/$2) - 2009/07/01 0:23:16 ET
Table '5G1PjWSk2ALz0O/eqyYy/g' 2-max Seat #1 is the button
Seat 1: Z4HwehErEwzsv/noQlfUlg ($151.90 in chips)
Seat 2: v4dp1VoMhJV4zmCXtmG5LQ ($217 in chips)
Z4HwehErEwzsv/noQlfUlg: posts small blind $1
v4dp1VoMhJV4zmCXtmG5LQ: posts big blind $2
*** HOLE CARDS ***
Z4HwehErEwzsv/noQlfUlg: calls $1
v4dp1VoMhJV4zmCXtmG5LQ: checks
*** FLOP *** [Th 6h Td]
v4dp1VoMhJV4zmCXtmG5LQ: bets $4
Z4HwehErEwzsv/noQlfUlg: folds
v4dp1VoMhJV4zmCXtmG5LQ collected $3.80 from pot
v4dp1VoMhJV4zmCXtmG5LQ: doesn't show hand
*** SUMMARY ***
Total pot $4 | Rake $0.20
Board [Th 6h Td]
Seat 1: Z4HwehErEwzsv/noQlfUlg (button) (small blind) folded on the Flop
Seat 2: v4dp1VoMhJV4zmCXtmG5LQ (big blind) collected ($3.80)



PokerStars Game #59938778610:  Hold'em No Limit ($1/$2) - 2009/07/01 0:23:16 ET
Table 'jlrIxbrVIG+gjaUYT4za8g' 6-max Seat #1 is the button
Seat 1: ygTTt5ehT4aF86q1a8/R+w ($193.05 in chips)
Seat 2: N18PrNGQj43J7TJuQuu+tw ($149.25 in chips)
Seat 3: 54yWzRRgS0oZ+S6LwZBxMQ ($37.80 in chips)
Seat 4: 8srN1dKQePlsv0GyTada+Q ($221 in chips)
Seat 5: VuZb/hkEc4X7s93w2ZZTpA ($200 in chips)
Seat 6: vkfxu8f/jMYKUk6Ly4eujw ($263.95 in chips)
N18PrNGQj43J7TJuQuu+tw: posts small blind $1
54yWzRRgS0oZ+S6LwZBxMQ: posts big blind $2
*** HOLE CARDS ***
8srN1dKQePlsv0GyTada+Q: folds
VuZb/hkEc4X7s93w2ZZTpA: folds
vkfxu8f/jMYKUk6Ly4eujw: folds
ygTTt5ehT4aF86q1a8/R+w: raises $4 to $6
N18PrNGQj43J7TJuQuu+tw: calls $5
54yWzRRgS0oZ+S6LwZBxMQ: folds
*** FLOP *** [9d 3c 2d]
N18PrNGQj43J7TJuQuu+tw: checks
ygTTt5ehT4aF86q1a8/R+w: checks
*** TURN *** [9d 3c 2d] [Th]
N18PrNGQj43J7TJuQuu+tw: bets $8
ygTTt5ehT4aF86q1a8/R+w: folds
N18PrNGQj43J7TJuQuu+tw collected $13.30 from pot
*** SUMMARY ***
Total pot $14 | Rake $0.70
Board [9d 3c 2d Th]
Seat 1: ygTTt5ehT4aF86q1a8/R+w (button) folded on the Turn
Seat 2: N18PrNGQj43J7TJuQuu+tw (small blind) collected ($13.30)
Seat 3: 54yWzRRgS0oZ+S6LwZBxMQ (big blind) folded before Flop
Seat 4: 8srN1dKQePlsv0GyTada+Q folded before Flop (didn't bet)
Seat 5: VuZb/hkEc4X7s93w2ZZTpA folded before Flop (didn't bet)
Seat 6: vkfxu8f/jMYKUk6Ly4eujw folded before Flop (didn't bet)



PokerStars Game #59938779422:  Hold'em No Limit ($1/$2) - 2009/07/01 0:23:17 ET
Table 'aSf77Sj8QEnzcc0WaxVD4Q' 6-max Seat #1 is the button
Seat 1: 54yWzRRgS0oZ+S6LwZBxMQ ($36 in chips)
Seat 2: vkfxu8f/jMYKUk6Ly4eujw ($245.15 in chips)
Seat 3: 9dpyyjDTCed6nV7JhaUUpw ($207.30 in chips)
Seat 4: 513FcCI8jHyQy2VWoIQkMg ($201.75 in chips)
Seat 5: InmkdI6G8TzSj9NhcCSyPg ($247 in chips)
Seat 6: vkoJRf3gidxY1pPi0AFWww ($309.15 in chips)
vkfxu8f/jMYKUk6Ly4eujw: posts small blind $1
9dpyyjDTCed6nV7JhaUUpw: posts big blind $2
*** HOLE CARDS ***
513FcCI8jHyQy2VWoIQkMg: folds
InmkdI6G8TzSj9NhcCSyPg: folds
vkoJRf3gidxY1pPi0AFWww: calls $2
54yWzRRgS0oZ+S6LwZBxMQ: calls $2
vkfxu8f/jMYKUk6Ly4eujw: folds
9dpyyjDTCed6nV7JhaUUpw: checks
*** FLOP *** [6c Qc Jh]
9dpyyjDTCed6nV7JhaUUpw: checks
vkoJRf3gidxY1pPi0AFWww: bets $4
54yWzRRgS0oZ+S6LwZBxMQ: folds
9dpyyjDTCed6nV7JhaUUpw: folds
vkoJRf3gidxY1pPi0AFWww collected $6.65 from pot
vkoJRf3gidxY1pPi0AFWww: doesn't show hand
*** SUMMARY ***
Total pot $7 | Rake $0.35
Board [6c Qc Jh]
Seat 1: 54yWzRRgS0oZ+S6LwZBxMQ (button) folded on the Flop
Seat 2: vkfxu8f/jMYKUk6Ly4eujw (small blind) folded before Flop
Seat 3: 9dpyyjDTCed6nV7JhaUUpw (big blind) folded on the Flop
Seat 4: 513FcCI8jHyQy2VWoIQkMg folded before Flop (didn't bet)
Seat 5: InmkdI6G8TzSj9NhcCSyPg folded before Flop (didn't bet)
Seat 6: vkoJRf3gidxY1pPi0AFWww collected ($6.65)



PokerStars Game #59938780096:  Hold'em No Limit ($1/$2) - 2009/07/01 0:23:18 ET
Table 'NmY84NAf9Mh0ckAckHnh5g' 2-max Seat #1 is the button
Seat 1: 6hvg964TSqZ3AL/0XK9aVQ ($576.95 in chips)
Seat 2: RwDoM55ZeQuI2ADyJhOb2Q ($267 in chips)
6hvg964TSqZ3AL/0XK9aVQ: posts small blind $1
RwDoM55ZeQuI2ADyJhOb2Q: posts big blind $2
*** HOLE CARDS ***
6hvg964TSqZ3AL/0XK9aVQ: folds
RwDoM55ZeQuI2ADyJhOb2Q collected $2 from pot
RwDoM55ZeQuI2ADyJhOb2Q: doesn't show hand
*** SUMMARY ***
Total pot $2 | Rake $0
Seat 1: 6hvg964TSqZ3AL/0XK9aVQ (button) (small blind) folded before Flop
Seat 2: RwDoM55ZeQuI2ADyJhOb2Q (big blind) collected ($2)



PokerStars Game #59938781170:  Hold'em No Limit ($1/$2) - 2009/07/01 0:23:20 ET
Table 'OZyw34U4j4WtFFWsEHZQgQ' 2-max Seat #2 is the button
Seat 1: pVqEzK9wXlRMECnb1Zg4Zw ($69.90 in chips)
Seat 2: rAtTyvrJ8f1LaUh2O5U4nA ($52.70 in chips)
rAtTyvrJ8f1LaUh2O5U4nA: posts small blind $1
pVqEzK9wXlRMECnb1Zg4Zw: posts big blind $2
*** HOLE CARDS ***
rAtTyvrJ8f1LaUh2O5U4nA: raises $5 to $7
pVqEzK9wXlRMECnb1Zg4Zw: folds
rAtTyvrJ8f1LaUh2O5U4nA collected $4 from pot
rAtTyvrJ8f1LaUh2O5U4nA: doesn't show hand
*** SUMMARY ***
Total pot $4 | Rake $0
Seat 1: pVqEzK9wXlRMECnb1Zg4Zw (big blind) folded before Flop
Seat 2: rAtTyvrJ8f1LaUh2O5U4nA (button) (small blind) collected ($4)



PokerStars Game #59938781660:  Hold'em No Limit ($1/$2) - 2009/07/01 0:23:20 ET
Table 'P/yCfYl1GfGsu/e6DxDy/A' 2-max Seat #2 is the button
Seat 1: 7fOCUy3x9hdkmXkkDNolGQ ($200 in chips)
Seat 2: RwDoM55ZeQuI2ADyJhOb2Q ($620 in chips)
RwDoM55ZeQuI2ADyJhOb2Q: posts small blind $1
7fOCUy3x9hdkmXkkDNolGQ: posts big blind $2
*** HOLE CARDS ***
RwDoM55ZeQuI2ADyJhOb2Q: raises $4 to $6
7fOCUy3x9hdkmXkkDNolGQ: folds
RwDoM55ZeQuI2ADyJhOb2Q collected $4 from pot
RwDoM55ZeQuI2ADyJhOb2Q: doesn't show hand
*** SUMMARY ***
Total pot $4 | Rake $0
Seat 1: 7fOCUy3x9hdkmXkkDNolGQ (big blind) folded before Flop
Seat 2: RwDoM55ZeQuI2ADyJhOb2Q (button) (small blind) collected ($4)



PokerStars Game #59938784262:  Hold'em No Limit ($1/$2) - 2009/07/01 0:23:24 ET
Table 'NmY84NAf9Mh0ckAckHnh5g' 2-max Seat #2 is the button
Seat 1: 6hvg964TSqZ3AL/0XK9aVQ ($575.95 in chips)
Seat 2: RwDoM55ZeQuI2ADyJhOb2Q ($268 in chips)
RwDoM55ZeQuI2ADyJhOb2Q: posts small blind $1
6hvg964TSqZ3AL/0XK9aVQ: posts big blind $2
*** HOLE CARDS ***
RwDoM55ZeQuI2ADyJhOb2Q: folds
6hvg964TSqZ3AL/0XK9aVQ collected $2 from pot
*** SUMMARY ***
Total pot $2 | Rake $0
Seat 1: 6hvg964TSqZ3AL/0XK9aVQ (big blind) collected ($2)
Seat 2: RwDoM55ZeQuI2ADyJhOb2Q (button) (small blind) folded before Flop



PokerStars Game #59938785514:  Hold'em No Limit ($1/$2) - 2009/07/01 0:23:26 ET
Table 'on4i1U1lCRmxsduFD3xiSg' 9-max Seat #5 is the button
Seat 1: so5k3vFDmokh2q3dImJ1GQ ($108 in chips)
Seat 2: yZYrOeNDxQxkzpbgKX1bng ($93.25 in chips)
Seat 3: 5iPk5MyO3KVu18Y8XCYfFQ ($58.20 in chips)
Seat 4: Z3aYCZG/yXHYFjiWkGI5ug ($527.10 in chips)
Seat 5: QHxJjpVYwitg9krW6wZgJA ($200 in chips)
Seat 6: CUZwDpLTQKhzarPe+JCLOQ ($215.55 in chips)
Seat 7: xD4ElYxz6Ollzmam8BmMCw ($189 in chips)
Seat 8: cdC54j9fGGojcbzWB5PgzA ($200 in chips)
Seat 9: iMe5yhc+1BaiIPHet3NMrA ($200 in chips)
CUZwDpLTQKhzarPe+JCLOQ: posts small blind $1
xD4ElYxz6Ollzmam8BmMCw: posts big blind $2
*** HOLE CARDS ***
cdC54j9fGGojcbzWB5PgzA: folds
iMe5yhc+1BaiIPHet3NMrA: folds
so5k3vFDmokh2q3dImJ1GQ: folds
yZYrOeNDxQxkzpbgKX1bng: calls $2
5iPk5MyO3KVu18Y8XCYfFQ: folds
Z3aYCZG/yXHYFjiWkGI5ug: folds
QHxJjpVYwitg9krW6wZgJA: folds
CUZwDpLTQKhzarPe+JCLOQ: folds
xD4ElYxz6Ollzmam8BmMCw: checks
*** FLOP *** [Tc 5d 7s]
xD4ElYxz6Ollzmam8BmMCw: checks
yZYrOeNDxQxkzpbgKX1bng: bets $2
xD4ElYxz6Ollzmam8BmMCw: raises $4 to $6
yZYrOeNDxQxkzpbgKX1bng: calls $4
*** TURN *** [Tc 5d 7s] [6c]
xD4ElYxz6Ollzmam8BmMCw: bets $10
yZYrOeNDxQxkzpbgKX1bng: calls $10
*** RIVER *** [Tc 5d 7s 6c] [3s]
xD4ElYxz6Ollzmam8BmMCw: bets $42
yZYrOeNDxQxkzpbgKX1bng: calls $42
*** SHOW DOWN ***
xD4ElYxz6Ollzmam8BmMCw: shows [5h 7h] (two pair, Sevens and Fives)
yZYrOeNDxQxkzpbgKX1bng: mucks hand
xD4ElYxz6Ollzmam8BmMCw collected $118 from pot
*** SUMMARY ***
Total pot $121 | Rake $3
Board [Tc 5d 7s 6c 3s]
Seat 1: so5k3vFDmokh2q3dImJ1GQ folded before Flop (didn't bet)
Seat 2: yZYrOeNDxQxkzpbgKX1bng mucked
Seat 3: 5iPk5MyO3KVu18Y8XCYfFQ folded before Flop (didn't bet)
Seat 4: Z3aYCZG/yXHYFjiWkGI5ug folded before Flop (didn't bet)
Seat 5: QHxJjpVYwitg9krW6wZgJA (button) folded before Flop (didn't bet)
Seat 6: CUZwDpLTQKhzarPe+JCLOQ (small blind) folded before Flop
Seat 7: xD4ElYxz6Ollzmam8BmMCw (big blind) showed [5h 7h] and won ($118) with two pair, Sevens and Fives
Seat 8: cdC54j9fGGojcbzWB5PgzA folded before Flop (didn't bet)
Seat 9: iMe5yhc+1BaiIPHet3NMrA folded before Flop (didn't bet)



PokerStars Game #59938785984:  Hold'em No Limit ($1/$2) - 2009/07/01 0:23:27 ET
Table 'P/yCfYl1GfGsu/e6DxDy/A' 2-max Seat #1 is the button
Seat 1: 7fOCUy3x9hdkmXkkDNolGQ ($200 in chips)
Seat 2: RwDoM55ZeQuI2ADyJhOb2Q ($622 in chips)
7fOCUy3x9hdkmXkkDNolGQ: posts small blind $1
RwDoM55ZeQuI2ADyJhOb2Q: posts big blind $2
*** HOLE CARDS ***
7fOCUy3x9hdkmXkkDNolGQ: folds
RwDoM55ZeQuI2ADyJhOb2Q collected $2 from pot
RwDoM55ZeQuI2ADyJhOb2Q: doesn't show hand
*** SUMMARY ***
Total pot $2 | Rake $0
Seat 1: 7fOCUy3x9hdkmXkkDNolGQ (button) (small blind) folded before Flop
Seat 2: RwDoM55ZeQuI2ADyJhOb2Q (big blind) collected ($2)



PokerStars Game #59938788468:  Hold'em No Limit ($1/$2) - 2009/07/01 0:23:30 ET
Table 'OZyw34U4j4WtFFWsEHZQgQ' 2-max Seat #1 is the button
Seat 1: pVqEzK9wXlRMECnb1Zg4Zw ($67.90 in chips)
Seat 2: rAtTyvrJ8f1LaUh2O5U4nA ($54.70 in chips)
pVqEzK9wXlRMECnb1Zg4Zw: posts small blind $1
rAtTyvrJ8f1LaUh2O5U4nA: posts big blind $2
*** HOLE CARDS ***
pVqEzK9wXlRMECnb1Zg4Zw: raises $6 to $8
rAtTyvrJ8f1LaUh2O5U4nA: folds
pVqEzK9wXlRMECnb1Zg4Zw collected $4 from pot
pVqEzK9wXlRMECnb1Zg4Zw: doesn't show hand
*** SUMMARY ***
Total pot $4 | Rake $0
Seat 1: pVqEzK9wXlRMECnb1Zg4Zw (button) (small blind) collected ($4)
Seat 2: rAtTyvrJ8f1LaUh2O5U4nA (big blind) folded before Flop



PokerStars Game #59938788416:  Hold'em No Limit ($1/$2) - 2009/07/01 0:23:30 ET
Table '5G1PjWSk2ALz0O/eqyYy/g' 2-max Seat #2 is the button
Seat 1: Z4HwehErEwzsv/noQlfUlg ($149.90 in chips)
Seat 2: v4dp1VoMhJV4zmCXtmG5LQ ($218.80 in chips)
v4dp1VoMhJV4zmCXtmG5LQ: posts small blind $1
Z4HwehErEwzsv/noQlfUlg: posts big blind $2
*** HOLE CARDS ***
v4dp1VoMhJV4zmCXtmG5LQ: raises $4 to $6
Z4HwehErEwzsv/noQlfUlg: calls $4
*** FLOP *** [8d As Th]
Z4HwehErEwzsv/noQlfUlg: checks
v4dp1VoMhJV4zmCXtmG5LQ: bets $8
Z4HwehErEwzsv/noQlfUlg: folds
v4dp1VoMhJV4zmCXtmG5LQ collected $11.50 from pot
v4dp1VoMhJV4zmCXtmG5LQ: doesn't show hand
*** SUMMARY ***
Total pot $12 | Rake $0.50
Board [8d As Th]
Seat 1: Z4HwehErEwzsv/noQlfUlg (big blind) folded on the Flop
Seat 2: v4dp1VoMhJV4zmCXtmG5LQ (button) (small blind) collected ($11.50)



PokerStars Game #59938788002:  Hold'em No Limit ($1/$2) - 2009/07/01 0:23:30 ET
Table 'uJ9juaXXg9yIcSU8amxaXQ' 6-max Seat #3 is the button
Seat 2: yynBOXUjw28V5kz84sxX4g ($136.05 in chips)
Seat 3: zaogaltCDFVsIASEnrXs2w ($293 in chips)
Seat 4: zNjJ/y4emmF+vzrCDd+ooA ($110 in chips)
Seat 5: aMZYAxFxWTQXE9aUus4sxg ($61.15 in chips)
Seat 6: XrFG4dK06RVKLlX32/pjcQ ($65.80 in chips)
zNjJ/y4emmF+vzrCDd+ooA: posts small blind $1
aMZYAxFxWTQXE9aUus4sxg: posts big blind $2
*** HOLE CARDS ***
XrFG4dK06RVKLlX32/pjcQ: calls $2
yynBOXUjw28V5kz84sxX4g: folds
zaogaltCDFVsIASEnrXs2w: folds
zNjJ/y4emmF+vzrCDd+ooA: calls $1
aMZYAxFxWTQXE9aUus4sxg: checks
*** FLOP *** [4s 2h Th]
zNjJ/y4emmF+vzrCDd+ooA: bets $4
aMZYAxFxWTQXE9aUus4sxg: folds
XrFG4dK06RVKLlX32/pjcQ: calls $4
*** TURN *** [4s 2h Th] [5s]
zNjJ/y4emmF+vzrCDd+ooA: bets $6
XrFG4dK06RVKLlX32/pjcQ: folds
zNjJ/y4emmF+vzrCDd+ooA collected $13.35 from pot
*** SUMMARY ***
Total pot $14 | Rake $0.65
Board [4s 2h Th 5s]
Seat 2: yynBOXUjw28V5kz84sxX4g folded before Flop (didn't bet)
Seat 3: zaogaltCDFVsIASEnrXs2w (button) folded before Flop (didn't bet)
Seat 4: zNjJ/y4emmF+vzrCDd+ooA (small blind) collected ($13.35)
Seat 5: aMZYAxFxWTQXE9aUus4sxg (big blind) folded on the Flop
Seat 6: XrFG4dK06RVKLlX32/pjcQ folded on the Turn



PokerStars Game #59938788734:  Hold'em No Limit ($1/$2) - 2009/07/01 0:23:31 ET
Table 'gnHBqWll9O3fxG7Ojkz/ng' 9-max Seat #8 is the button
Seat 1: hpqdC/23wXosGOmzARr5NA ($145.05 in chips)
Seat 2: H6Z4+qu8gR0VUiPOijndVg ($200 in chips)
Seat 3: 5Q8U6iZbeO7xJSS4qvDP5g ($228.35 in chips)
Seat 5: rBQDMkKm9cZn6M9NPsiVew ($172.45 in chips)
Seat 6: 5iPk5MyO3KVu18Y8XCYfFQ ($40 in chips)
Seat 7: jqui3xAWCkcdPW36a6BD+w ($214.55 in chips)
Seat 8: cM6efHzdxoqYm0EQKP4TTQ ($105.80 in chips)
GX1heJ+DSsvm7gzSPsYhhQ will be allowed to play after the button
hpqdC/23wXosGOmzARr5NA: posts small blind $1
H6Z4+qu8gR0VUiPOijndVg: posts big blind $2
*** HOLE CARDS ***
5Q8U6iZbeO7xJSS4qvDP5g: raises $6 to $8
rBQDMkKm9cZn6M9NPsiVew: folds
5iPk5MyO3KVu18Y8XCYfFQ: folds
jqui3xAWCkcdPW36a6BD+w: folds
n5XI5/7gN+gIubHFBH+mOw has returned
cM6efHzdxoqYm0EQKP4TTQ: folds
hpqdC/23wXosGOmzARr5NA: folds
H6Z4+qu8gR0VUiPOijndVg: folds
5Q8U6iZbeO7xJSS4qvDP5g collected $5 from pot
5Q8U6iZbeO7xJSS4qvDP5g: doesn't show hand
*** SUMMARY ***
Total pot $5 | Rake $0
Seat 1: hpqdC/23wXosGOmzARr5NA (small blind) folded before Flop
Seat 2: H6Z4+qu8gR0VUiPOijndVg (big blind) folded before Flop
Seat 3: 5Q8U6iZbeO7xJSS4qvDP5g collected ($5)
Seat 5: rBQDMkKm9cZn6M9NPsiVew folded before Flop (didn't bet)
Seat 6: 5iPk5MyO3KVu18Y8XCYfFQ folded before Flop (didn't bet)
Seat 7: jqui3xAWCkcdPW36a6BD+w folded before Flop (didn't bet)
Seat 8: cM6efHzdxoqYm0EQKP4TTQ (button) folded before Flop (didn't bet)



PokerStars Game #59938789692:  Hold'em No Limit ($1/$2) - 2009/07/01 0:23:32 ET
Table 'NmY84NAf9Mh0ckAckHnh5g' 2-max Seat #1 is the button
Seat 1: 6hvg964TSqZ3AL/0XK9aVQ ($576.95 in chips)
Seat 2: RwDoM55ZeQuI2ADyJhOb2Q ($267 in chips)
6hvg964TSqZ3AL/0XK9aVQ: posts small blind $1
RwDoM55ZeQuI2ADyJhOb2Q: posts big blind $2
*** HOLE CARDS ***
6hvg964TSqZ3AL/0XK9aVQ: folds
RwDoM55ZeQuI2ADyJhOb2Q collected $2 from pot
RwDoM55ZeQuI2ADyJhOb2Q: doesn't show hand
*** SUMMARY ***
Total pot $2 | Rake $0
Seat 1: 6hvg964TSqZ3AL/0XK9aVQ (button) (small blind) folded before Flop
Seat 2: RwDoM55ZeQuI2ADyJhOb2Q (big blind) collected ($2)



PokerStars Game #59938789852:  Hold'em No Limit ($1/$2) - 2009/07/01 0:23:33 ET
Table 'P/yCfYl1GfGsu/e6DxDy/A' 2-max Seat #2 is the button
Seat 1: 7fOCUy3x9hdkmXkkDNolGQ ($200 in chips)
Seat 2: RwDoM55ZeQuI2ADyJhOb2Q ($623 in chips)
RwDoM55ZeQuI2ADyJhOb2Q: posts small blind $1
7fOCUy3x9hdkmXkkDNolGQ: posts big blind $2
*** HOLE CARDS ***
RwDoM55ZeQuI2ADyJhOb2Q: folds
7fOCUy3x9hdkmXkkDNolGQ collected $2 from pot
7fOCUy3x9hdkmXkkDNolGQ: doesn't show hand
*** SUMMARY ***
Total pot $2 | Rake $0
Seat 1: 7fOCUy3x9hdkmXkkDNolGQ (big blind) collected ($2)
Seat 2: RwDoM55ZeQuI2ADyJhOb2Q (button) (small blind) folded before Flop



PokerStars Game #59938790586:  Hold'em No Limit ($1/$2) - 2009/07/01 0:23:34 ET
Table 'XP2sRSup+aRuwzx3vDZsDg' 6-max Seat #3 is the button
Seat 1: o9jamqIi6sTTRSqudgboRA ($234.75 in chips)
Seat 3: X7GlkHF+lkbarCLuZ4Uf0w ($36 in chips)
Seat 5: 894kvCY4GHivBpqwizsecg ($114.45 in chips)
Seat 6: h7ppRQJTYBsHCbLMeW9T2g ($449.75 in chips)
hCtfSY4dRapM2rhEFmS4Ug will be allowed to play after the button
894kvCY4GHivBpqwizsecg: posts small blind $1
h7ppRQJTYBsHCbLMeW9T2g: posts big blind $2
ygTTt5ehT4aF86q1a8/R+w: sits out
*** HOLE CARDS ***
o9jamqIi6sTTRSqudgboRA: folds
X7GlkHF+lkbarCLuZ4Uf0w: raises $2 to $4
894kvCY4GHivBpqwizsecg: folds
h7ppRQJTYBsHCbLMeW9T2g: folds
X7GlkHF+lkbarCLuZ4Uf0w collected $5 from pot
*** SUMMARY ***
Total pot $5 | Rake $0
Seat 1: o9jamqIi6sTTRSqudgboRA folded before Flop (didn't bet)
Seat 3: X7GlkHF+lkbarCLuZ4Uf0w (button) collected ($5)
Seat 5: 894kvCY4GHivBpqwizsecg (small blind) folded before Flop
Seat 6: h7ppRQJTYBsHCbLMeW9T2g (big blind) folded before Flop



PokerStars Game #59938791642:  Hold'em No Limit ($1/$2) - 2009/07/01 0:23:35 ET
Table 'ZzSIe0zTCDv+n6hfbY5tTg' 6-max Seat #3 is the button
Seat 2: B87ikIyZ/TzAVeXf38Ny0g ($203 in chips)
Seat 3: X7GlkHF+lkbarCLuZ4Uf0w ($63 in chips)
Seat 4: ky55L0pITYgYLeqFB9gP/Q ($191.40 in chips)
Seat 5: f2eTKbND+tM3kUw9o6WYWg ($100 in chips)
Seat 6: InmkdI6G8TzSj9NhcCSyPg ($200 in chips)
ky55L0pITYgYLeqFB9gP/Q: posts small blind $1
f2eTKbND+tM3kUw9o6WYWg: posts big blind $2
*** HOLE CARDS ***
InmkdI6G8TzSj9NhcCSyPg: folds
B87ikIyZ/TzAVeXf38Ny0g: folds
X7GlkHF+lkbarCLuZ4Uf0w: folds
ky55L0pITYgYLeqFB9gP/Q: folds
f2eTKbND+tM3kUw9o6WYWg collected $2 from pot
f2eTKbND+tM3kUw9o6WYWg: doesn't show hand
*** SUMMARY ***
Total pot $2 | Rake $0
Seat 2: B87ikIyZ/TzAVeXf38Ny0g folded before Flop (didn't bet)
Seat 3: X7GlkHF+lkbarCLuZ4Uf0w (button) folded before Flop (didn't bet)
Seat 4: ky55L0pITYgYLeqFB9gP/Q (small blind) folded before Flop
Seat 5: f2eTKbND+tM3kUw9o6WYWg (big blind) collected ($2)
Seat 6: InmkdI6G8TzSj9NhcCSyPg folded before Flop (didn't bet)



PokerStars Game #59938792330:  Hold'em No Limit ($1/$2) - 2009/07/01 0:23:36 ET
Table 'rKeCh+eBn4RNvybCUYkoTQ' 9-max Seat #5 is the button
Seat 1: De9g+AYjo0DN6C/+iT/nsg ($246.30 in chips)
Seat 2: oEFhmBFI/N1eUlbVXORRnw ($192.65 in chips)
Seat 3: R9FzbEg1XYsiOty4kvbqhg ($142.30 in chips)
Seat 4: x/sLO+9OHvhcHLxOgSmnOg ($56.75 in chips)
Seat 5: iuQs2eTwwwpiBYdCIQ/ogA ($157.45 in chips)
Seat 6: TAfo4veNRaRlzDXMMYS3Jg ($40 in chips)
Seat 7: U+Qo1rnyH4lm7ehksiWi7w ($61.20 in chips)
Seat 8: pN/Ip0ePsUVIdUlGgLrkUw ($224.70 in chips)
Seat 9: SZnYUzONNVlDaSCSt67hQA ($69.15 in chips)
TAfo4veNRaRlzDXMMYS3Jg: posts small blind $1
U+Qo1rnyH4lm7ehksiWi7w: posts big blind $2
*** HOLE CARDS ***
pN/Ip0ePsUVIdUlGgLrkUw: folds
SZnYUzONNVlDaSCSt67hQA: calls $2
De9g+AYjo0DN6C/+iT/nsg: folds
oEFhmBFI/N1eUlbVXORRnw: folds
R9FzbEg1XYsiOty4kvbqhg: folds
x/sLO+9OHvhcHLxOgSmnOg: folds
iuQs2eTwwwpiBYdCIQ/ogA: calls $2
TAfo4veNRaRlzDXMMYS3Jg is disconnected
TAfo4veNRaRlzDXMMYS3Jg has timed out while disconnected
TAfo4veNRaRlzDXMMYS3Jg: folds
TAfo4veNRaRlzDXMMYS3Jg is sitting out
U+Qo1rnyH4lm7ehksiWi7w: checks
*** FLOP *** [Th 7d Ks]
U+Qo1rnyH4lm7ehksiWi7w: checks
SZnYUzONNVlDaSCSt67hQA: bets $6
iuQs2eTwwwpiBYdCIQ/ogA: folds
U+Qo1rnyH4lm7ehksiWi7w: folds
SZnYUzONNVlDaSCSt67hQA collected $6.65 from pot
SZnYUzONNVlDaSCSt67hQA: doesn't show hand
*** SUMMARY ***
Total pot $7 | Rake $0.35
Board [Th 7d Ks]
Seat 1: De9g+AYjo0DN6C/+iT/nsg folded before Flop (didn't bet)
Seat 2: oEFhmBFI/N1eUlbVXORRnw folded before Flop (didn't bet)
Seat 3: R9FzbEg1XYsiOty4kvbqhg folded before Flop (didn't bet)
Seat 4: x/sLO+9OHvhcHLxOgSmnOg folded before Flop (didn't bet)
Seat 5: iuQs2eTwwwpiBYdCIQ/ogA (button) folded on the Flop
Seat 6: TAfo4veNRaRlzDXMMYS3Jg (small blind) folded before Flop
Seat 7: U+Qo1rnyH4lm7ehksiWi7w (big blind) folded on the Flop
Seat 8: pN/Ip0ePsUVIdUlGgLrkUw folded before Flop (didn't bet)
Seat 9: SZnYUzONNVlDaSCSt67hQA collected ($6.65)



PokerStars Game #59938793618:  Hold'em No Limit ($1/$2) - 2009/07/01 0:23:38 ET
Table 'NmY84NAf9Mh0ckAckHnh5g' 2-max Seat #2 is the button
Seat 1: 6hvg964TSqZ3AL/0XK9aVQ ($575.95 in chips)
Seat 2: RwDoM55ZeQuI2ADyJhOb2Q ($268 in chips)
RwDoM55ZeQuI2ADyJhOb2Q: posts small blind $1
6hvg964TSqZ3AL/0XK9aVQ: posts big blind $2
*** HOLE CARDS ***
RwDoM55ZeQuI2ADyJhOb2Q: raises $4 to $6
6hvg964TSqZ3AL/0XK9aVQ: calls $4
*** FLOP *** [3s 5s 3h]
6hvg964TSqZ3AL/0XK9aVQ: checks
RwDoM55ZeQuI2ADyJhOb2Q: bets $10
6hvg964TSqZ3AL/0XK9aVQ: calls $10
*** TURN *** [3s 5s 3h] [6h]
6hvg964TSqZ3AL/0XK9aVQ: checks
RwDoM55ZeQuI2ADyJhOb2Q: bets $32
6hvg964TSqZ3AL/0XK9aVQ: calls $32
*** RIVER *** [3s 5s 3h 6h] [8c]
6hvg964TSqZ3AL/0XK9aVQ: checks
RwDoM55ZeQuI2ADyJhOb2Q: bets $72
6hvg964TSqZ3AL/0XK9aVQ: folds
RwDoM55ZeQuI2ADyJhOb2Q collected $95.50 from pot
RwDoM55ZeQuI2ADyJhOb2Q: doesn't show hand
*** SUMMARY ***
Total pot $96 | Rake $0.50
Board [3s 5s 3h 6h 8c]
Seat 1: 6hvg964TSqZ3AL/0XK9aVQ (big blind) folded on the River
Seat 2: RwDoM55ZeQuI2ADyJhOb2Q (button) (small blind) collected ($95.50)



PokerStars Game #59938793550:  Hold'em No Limit ($1/$2) - 2009/07/01 0:23:38 ET
Table 'P/yCfYl1GfGsu/e6DxDy/A' 2-max Seat #1 is the button
Seat 1: 7fOCUy3x9hdkmXkkDNolGQ ($201 in chips)
Seat 2: RwDoM55ZeQuI2ADyJhOb2Q ($622 in chips)
7fOCUy3x9hdkmXkkDNolGQ: posts small blind $1
RwDoM55ZeQuI2ADyJhOb2Q: posts big blind $2
*** HOLE CARDS ***
7fOCUy3x9hdkmXkkDNolGQ: raises $4 to $6
RwDoM55ZeQuI2ADyJhOb2Q: calls $4
*** FLOP *** [2h As 2c]
RwDoM55ZeQuI2ADyJhOb2Q: checks
7fOCUy3x9hdkmXkkDNolGQ: bets $8
RwDoM55ZeQuI2ADyJhOb2Q: folds
7fOCUy3x9hdkmXkkDNolGQ collected $11.50 from pot
7fOCUy3x9hdkmXkkDNolGQ: doesn't show hand
*** SUMMARY ***
Total pot $12 | Rake $0.50
Board [2h As 2c]
Seat 1: 7fOCUy3x9hdkmXkkDNolGQ (button) (small blind) collected ($11.50)
Seat 2: RwDoM55ZeQuI2ADyJhOb2Q (big blind) folded on the Flop



PokerStars Game #59938793796:  Hold'em No Limit ($1/$2) - 2009/07/01 0:23:39 ET
Table 'OZyw34U4j4WtFFWsEHZQgQ' 2-max Seat #2 is the button
Seat 1: pVqEzK9wXlRMECnb1Zg4Zw ($69.90 in chips)
Seat 2: rAtTyvrJ8f1LaUh2O5U4nA ($52.70 in chips)
rAtTyvrJ8f1LaUh2O5U4nA: posts small blind $1
pVqEzK9wXlRMECnb1Zg4Zw: posts big blind $2
*** HOLE CARDS ***
rAtTyvrJ8f1LaUh2O5U4nA: folds
pVqEzK9wXlRMECnb1Zg4Zw collected $2 from pot
pVqEzK9wXlRMECnb1Zg4Zw: doesn't show hand
*** SUMMARY ***
Total pot $2 | Rake $0
Seat 1: pVqEzK9wXlRMECnb1Zg4Zw (big blind) collected ($2)
Seat 2: rAtTyvrJ8f1LaUh2O5U4nA (button) (small blind) folded before Flop



PokerStars Game #59938794492:  Hold'em No Limit ($1/$2) - 2009/07/01 0:23:40 ET
Table 'ztv6V3FN2bQ9nmJPPdx6nQ' 6-max Seat #3 is the button
Seat 1: ek1hig03QiyONDHXvgqteQ ($320.35 in chips)
Seat 2: 5Y+ZGWLI4gnlpApDX5vy1A ($231.45 in chips)
Seat 3: Z55K9DbCHCUi6UaztIHi6g ($139.45 in chips)
Seat 4: vVSUvlW/pvneUNUHDgyXgw ($200 in chips)
Seat 5: sTPOWERd9HWPCNrDBwsVjA ($214.40 in chips)
Seat 6: mfy7uGZcqA2PVQqEVbJ7+g ($201.75 in chips)
vVSUvlW/pvneUNUHDgyXgw: posts small blind $1
sTPOWERd9HWPCNrDBwsVjA: posts big blind $2
*** HOLE CARDS ***
mfy7uGZcqA2PVQqEVbJ7+g: folds
ek1hig03QiyONDHXvgqteQ: folds
5Y+ZGWLI4gnlpApDX5vy1A: folds
Z55K9DbCHCUi6UaztIHi6g: folds
vVSUvlW/pvneUNUHDgyXgw: folds
sTPOWERd9HWPCNrDBwsVjA collected $2 from pot
*** SUMMARY ***
Total pot $2 | Rake $0
Seat 1: ek1hig03QiyONDHXvgqteQ folded before Flop (didn't bet)
Seat 2: 5Y+ZGWLI4gnlpApDX5vy1A folded before Flop (didn't bet)
Seat 3: Z55K9DbCHCUi6UaztIHi6g (button) folded before Flop (didn't bet)
Seat 4: vVSUvlW/pvneUNUHDgyXgw (small blind) folded before Flop
Seat 5: sTPOWERd9HWPCNrDBwsVjA (big blind) collected ($2)
Seat 6: mfy7uGZcqA2PVQqEVbJ7+g folded before Flop (didn't bet)



PokerStars Game #59938797586:  Hold'em No Limit ($1/$2) - 2009/07/01 0:23:44 ET
Table 'OZyw34U4j4WtFFWsEHZQgQ' 2-max Seat #1 is the button
Seat 1: pVqEzK9wXlRMECnb1Zg4Zw ($70.90 in chips)
Seat 2: rAtTyvrJ8f1LaUh2O5U4nA ($51.70 in chips)
pVqEzK9wXlRMECnb1Zg4Zw: posts small blind $1
rAtTyvrJ8f1LaUh2O5U4nA: posts big blind $2
*** HOLE CARDS ***
pVqEzK9wXlRMECnb1Zg4Zw: raises $6 to $8
rAtTyvrJ8f1LaUh2O5U4nA: folds
pVqEzK9wXlRMECnb1Zg4Zw collected $4 from pot
pVqEzK9wXlRMECnb1Zg4Zw: doesn't show hand
*** SUMMARY ***
Total pot $4 | Rake $0
Seat 1: pVqEzK9wXlRMECnb1Zg4Zw (button) (small blind) collected ($4)
Seat 2: rAtTyvrJ8f1LaUh2O5U4nA (big blind) folded before Flop



PokerStars Game #59938799180:  Hold'em No Limit ($1/$2) - 2009/07/01 0:23:47 ET
Table 'G1Oqdy4Pqdb5gtx40rUBzA' 6-max Seat #3 is the button
Seat 1: bz8Aw6kfX2xUq2sOyZlUCQ ($85.85 in chips)
Seat 2: IzslX/oV8DoDQfxCV/3+kg ($464.15 in chips)
Seat 3: lE+RUsc9cdVV9eEi8uytew ($185.95 in chips)
Seat 4: B87ikIyZ/TzAVeXf38Ny0g ($201.80 in chips)
B87ikIyZ/TzAVeXf38Ny0g: posts small blind $1
X7GlkHF+lkbarCLuZ4Uf0w: is sitting out
X7GlkHF+lkbarCLuZ4Uf0w has returned
bz8Aw6kfX2xUq2sOyZlUCQ: posts big blind $2
*** HOLE CARDS ***
X7GlkHF+lkbarCLuZ4Uf0w leaves the table
IzslX/oV8DoDQfxCV/3+kg: folds
lE+RUsc9cdVV9eEi8uytew: calls $2
B87ikIyZ/TzAVeXf38Ny0g: folds
bz8Aw6kfX2xUq2sOyZlUCQ: checks
*** FLOP *** [Jd As Th]
bz8Aw6kfX2xUq2sOyZlUCQ: checks
lE+RUsc9cdVV9eEi8uytew: bets $6
bz8Aw6kfX2xUq2sOyZlUCQ: calls $6
*** TURN *** [Jd As Th] [Td]
bz8Aw6kfX2xUq2sOyZlUCQ: checks
lE+RUsc9cdVV9eEi8uytew: bets $14
bz8Aw6kfX2xUq2sOyZlUCQ: folds
lE+RUsc9cdVV9eEi8uytew collected $16.20 from pot
lE+RUsc9cdVV9eEi8uytew: doesn't show hand
*** SUMMARY ***
Total pot $17 | Rake $0.80
Board [Jd As Th Td]
Seat 1: bz8Aw6kfX2xUq2sOyZlUCQ (big blind) folded on the Turn
Seat 2: IzslX/oV8DoDQfxCV/3+kg folded before Flop (didn't bet)
Seat 3: lE+RUsc9cdVV9eEi8uytew (button) collected ($16.20)
Seat 4: B87ikIyZ/TzAVeXf38Ny0g (small blind) folded before Flop



PokerStars Game #59938800734:  Hold'em No Limit ($1/$2) - 2009/07/01 0:23:49 ET
Table '5G1PjWSk2ALz0O/eqyYy/g' 2-max Seat #1 is the button
Seat 1: Z4HwehErEwzsv/noQlfUlg ($143.90 in chips)
Seat 2: v4dp1VoMhJV4zmCXtmG5LQ ($224.30 in chips)
Z4HwehErEwzsv/noQlfUlg: posts small blind $1
v4dp1VoMhJV4zmCXtmG5LQ: posts big blind $2
*** HOLE CARDS ***
Z4HwehErEwzsv/noQlfUlg: calls $1
v4dp1VoMhJV4zmCXtmG5LQ: raises $6 to $8
Z4HwehErEwzsv/noQlfUlg: folds
v4dp1VoMhJV4zmCXtmG5LQ collected $4 from pot
v4dp1VoMhJV4zmCXtmG5LQ: doesn't show hand
*** SUMMARY ***
Total pot $4 | Rake $0
Seat 1: Z4HwehErEwzsv/noQlfUlg (button) (small blind) folded before Flop
Seat 2: v4dp1VoMhJV4zmCXtmG5LQ (big blind) collected ($4)



PokerStars Game #59938802050:  Hold'em No Limit ($1/$2) - 2009/07/01 0:23:51 ET
Table 'SF49/KQm8T4taMp6kb+HXA' 9-max Seat #8 is the button
Seat 1: l1bCLGuFqeFRwUfPsiDu/g ($288.95 in chips)
Seat 3: pCmk6FpSOLJ+85o1tLHIag ($98 in chips)
Seat 4: HffgoYm61KgkdMe/DYChIQ ($123.60 in chips)
Seat 5: Z3aYCZG/yXHYFjiWkGI5ug ($223.55 in chips)
Seat 6: M2ht6rIKOI/my9eh610Nlw ($225.40 in chips)
Seat 7: n2VAbLaE5qgKr5mA4W6v4w ($25 in chips)
Seat 8: 5iPk5MyO3KVu18Y8XCYfFQ ($37 in chips)
/inIs/z/PcX+TniIFpaxpg will be allowed to play after the button
l1bCLGuFqeFRwUfPsiDu/g: posts small blind $1
pCmk6FpSOLJ+85o1tLHIag: posts big blind $2
*** HOLE CARDS ***
HffgoYm61KgkdMe/DYChIQ: calls $2
Z3aYCZG/yXHYFjiWkGI5ug: folds
M2ht6rIKOI/my9eh610Nlw: folds
n2VAbLaE5qgKr5mA4W6v4w: folds
5iPk5MyO3KVu18Y8XCYfFQ: raises $35 to $37 and is all-in
l1bCLGuFqeFRwUfPsiDu/g: folds
pCmk6FpSOLJ+85o1tLHIag: folds
HffgoYm61KgkdMe/DYChIQ: calls $35
*** FLOP *** [Qh 5h Qd]
*** TURN *** [Qh 5h Qd] [9s]
*** RIVER *** [Qh 5h Qd 9s] [Kc]
*** SHOW DOWN ***
HffgoYm61KgkdMe/DYChIQ: shows [2s 2h] (two pair, Queens and Deuces)
5iPk5MyO3KVu18Y8XCYfFQ: shows [Qc Ac] (three of a kind, Queens)
5iPk5MyO3KVu18Y8XCYfFQ collected $74 from pot
*** SUMMARY ***
Total pot $77 | Rake $3
Board [Qh 5h Qd 9s Kc]
Seat 1: l1bCLGuFqeFRwUfPsiDu/g (small blind) folded before Flop
Seat 3: pCmk6FpSOLJ+85o1tLHIag (big blind) folded before Flop
Seat 4: HffgoYm61KgkdMe/DYChIQ showed [2s 2h] and lost with two pair, Queens and Deuces
Seat 5: Z3aYCZG/yXHYFjiWkGI5ug folded before Flop (didn't bet)
Seat 6: M2ht6rIKOI/my9eh610Nlw folded before Flop (didn't bet)
Seat 7: n2VAbLaE5qgKr5mA4W6v4w folded before Flop (didn't bet)
Seat 8: 5iPk5MyO3KVu18Y8XCYfFQ (button) showed [Qc Ac] and won ($74) with three of a kind, Queens



PokerStars Game #59938802156:  Hold'em No Limit ($1/$2) - 2009/07/01 0:23:51 ET
Table 'eyAQSIlgc2o1Jxvbve4WGg' 9-max Seat #6 is the button
Seat 1: UZEsV9yKUMqmpYPiOFpaZw ($73 in chips)
Seat 2: g7gL2NLJCdZPPV399WKT1w ($48 in chips)
Seat 3: TAfo4veNRaRlzDXMMYS3Jg ($37 in chips)
Seat 4: miAHPEBdznuHNzK6YM3hRA ($136.95 in chips)
Seat 5: JnV3SM2D6dAFYyGZHHpvrg ($94 in chips)
Seat 6: IikcENBHwoT7snSvBPSc7Q ($148.60 in chips)
Seat 7: QHxJjpVYwitg9krW6wZgJA ($208.35 in chips)
Seat 8: 5iPk5MyO3KVu18Y8XCYfFQ ($40 in chips)
Seat 9: Hc2itIxwbi1lwa+DAYYQGg ($41.85 in chips)
QHxJjpVYwitg9krW6wZgJA: posts small blind $1
5iPk5MyO3KVu18Y8XCYfFQ: posts big blind $2
*** HOLE CARDS ***
Hc2itIxwbi1lwa+DAYYQGg: folds
Hc2itIxwbi1lwa+DAYYQGg leaves the table
UZEsV9yKUMqmpYPiOFpaZw: folds
g7gL2NLJCdZPPV399WKT1w: folds
GX1heJ+DSsvm7gzSPsYhhQ joins the table at seat #9
TAfo4veNRaRlzDXMMYS3Jg has timed out while being disconnected
TAfo4veNRaRlzDXMMYS3Jg: folds
TAfo4veNRaRlzDXMMYS3Jg is sitting out
miAHPEBdznuHNzK6YM3hRA: calls $2
JnV3SM2D6dAFYyGZHHpvrg: folds
IikcENBHwoT7snSvBPSc7Q: folds
QHxJjpVYwitg9krW6wZgJA: folds
TAfo4veNRaRlzDXMMYS3Jg is disconnected
5iPk5MyO3KVu18Y8XCYfFQ: checks
*** FLOP *** [8c 3d 8s]
5iPk5MyO3KVu18Y8XCYfFQ: bets $2
miAHPEBdznuHNzK6YM3hRA: raises $2 to $4
5iPk5MyO3KVu18Y8XCYfFQ: folds
miAHPEBdznuHNzK6YM3hRA collected $8.60 from pot
*** SUMMARY ***
Total pot $9 | Rake $0.40
Board [8c 3d 8s]
Seat 1: UZEsV9yKUMqmpYPiOFpaZw folded before Flop (didn't bet)
Seat 2: g7gL2NLJCdZPPV399WKT1w folded before Flop (didn't bet)
Seat 3: TAfo4veNRaRlzDXMMYS3Jg folded before Flop (didn't bet)
Seat 4: miAHPEBdznuHNzK6YM3hRA collected ($8.60)
Seat 5: JnV3SM2D6dAFYyGZHHpvrg folded before Flop (didn't bet)
Seat 6: IikcENBHwoT7snSvBPSc7Q (button) folded before Flop (didn't bet)
Seat 7: QHxJjpVYwitg9krW6wZgJA (small blind) folded before Flop
Seat 8: 5iPk5MyO3KVu18Y8XCYfFQ (big blind) folded on the Flop
Seat 9: Hc2itIxwbi1lwa+DAYYQGg folded before Flop (didn't bet)



PokerStars Game #59938803084:  Hold'em No Limit ($1/$2) - 2009/07/01 0:23:53 ET
Table 'OZyw34U4j4WtFFWsEHZQgQ' 2-max Seat #2 is the button
Seat 1: pVqEzK9wXlRMECnb1Zg4Zw ($72.90 in chips)
Seat 2: rAtTyvrJ8f1LaUh2O5U4nA ($49.70 in chips)
rAtTyvrJ8f1LaUh2O5U4nA: posts small blind $1
pVqEzK9wXlRMECnb1Zg4Zw: posts big blind $2
*** HOLE CARDS ***
rAtTyvrJ8f1LaUh2O5U4nA: raises $2 to $4
pVqEzK9wXlRMECnb1Zg4Zw: raises $24 to $28
rAtTyvrJ8f1LaUh2O5U4nA: folds
pVqEzK9wXlRMECnb1Zg4Zw collected $8 from pot
pVqEzK9wXlRMECnb1Zg4Zw: doesn't show hand
*** SUMMARY ***
Total pot $8 | Rake $0
Seat 1: pVqEzK9wXlRMECnb1Zg4Zw (big blind) collected ($8)
Seat 2: rAtTyvrJ8f1LaUh2O5U4nA (button) (small blind) folded before Flop



PokerStars Game #59938803798:  Hold'em No Limit ($1/$2) - 2009/07/01 0:23:54 ET
Table 'gftD4mDF7mIFKvSrIyaRbw' 9-max Seat #2 is the button
Seat 2: CKDJ8bJWIRDDBziHsebH5w ($151.45 in chips)
Seat 3: CUZwDpLTQKhzarPe+JCLOQ ($200 in chips)
Seat 4: eeMEdaNqHXOk6uYL+zQnAA ($62.35 in chips)
Seat 5: mpsfNtnMVDqQHTe92AhIdw ($295.20 in chips)
Seat 6: 2NvwF8W2nzsbS+G//yLAbQ ($41.90 in chips)
Seat 7: 5iPk5MyO3KVu18Y8XCYfFQ ($49.65 in chips)
Seat 8: R/wPwjEcvTU2fxPXxn/XgQ ($76.55 in chips)
Seat 9: F7m34OOfAQ7annesMHVjKw ($231.30 in chips)
CUZwDpLTQKhzarPe+JCLOQ: posts small blind $1
eeMEdaNqHXOk6uYL+zQnAA: posts big blind $2
TAfo4veNRaRlzDXMMYS3Jg: sits out
*** HOLE CARDS ***
mpsfNtnMVDqQHTe92AhIdw: calls $2
2NvwF8W2nzsbS+G//yLAbQ: folds
5iPk5MyO3KVu18Y8XCYfFQ: folds
R/wPwjEcvTU2fxPXxn/XgQ: folds
F7m34OOfAQ7annesMHVjKw: calls $2
CKDJ8bJWIRDDBziHsebH5w: raises $4 to $6
CUZwDpLTQKhzarPe+JCLOQ: folds
eeMEdaNqHXOk6uYL+zQnAA: calls $4
mpsfNtnMVDqQHTe92AhIdw: calls $4
F7m34OOfAQ7annesMHVjKw: calls $4
*** FLOP *** [Td 7c 8s]
eeMEdaNqHXOk6uYL+zQnAA: checks
mpsfNtnMVDqQHTe92AhIdw: checks
F7m34OOfAQ7annesMHVjKw: checks
TAfo4veNRaRlzDXMMYS3Jg is disconnected
CKDJ8bJWIRDDBziHsebH5w: checks
*** TURN *** [Td 7c 8s] [8h]
eeMEdaNqHXOk6uYL+zQnAA: checks
mpsfNtnMVDqQHTe92AhIdw: checks
F7m34OOfAQ7annesMHVjKw: checks
CKDJ8bJWIRDDBziHsebH5w: checks
*** RIVER *** [Td 7c 8s 8h] [6s]
eeMEdaNqHXOk6uYL+zQnAA: bets $6
mpsfNtnMVDqQHTe92AhIdw: folds
F7m34OOfAQ7annesMHVjKw: folds
CKDJ8bJWIRDDBziHsebH5w: folds
eeMEdaNqHXOk6uYL+zQnAA collected $23.75 from pot
eeMEdaNqHXOk6uYL+zQnAA: doesn't show hand
*** SUMMARY ***
Total pot $25 | Rake $1.25
Board [Td 7c 8s 8h 6s]
Seat 2: CKDJ8bJWIRDDBziHsebH5w (button) folded on the River
Seat 3: CUZwDpLTQKhzarPe+JCLOQ (small blind) folded before Flop
Seat 4: eeMEdaNqHXOk6uYL+zQnAA (big blind) collected ($23.75)
Seat 5: mpsfNtnMVDqQHTe92AhIdw folded on the River
Seat 6: 2NvwF8W2nzsbS+G//yLAbQ folded before Flop (didn't bet)
Seat 7: 5iPk5MyO3KVu18Y8XCYfFQ folded before Flop (didn't bet)
Seat 8: R/wPwjEcvTU2fxPXxn/XgQ folded before Flop (didn't bet)
Seat 9: F7m34OOfAQ7annesMHVjKw folded on the River



PokerStars Game #59938807192:  Hold'em No Limit ($1/$2) - 2009/07/01 0:23:59 ET
Table 'ztv6V3FN2bQ9nmJPPdx6nQ' 6-max Seat #4 is the button
Seat 1: ek1hig03QiyONDHXvgqteQ ($320.35 in chips)
Seat 2: 5Y+ZGWLI4gnlpApDX5vy1A ($231.45 in chips)
Seat 3: Z55K9DbCHCUi6UaztIHi6g ($139.45 in chips)
Seat 4: vVSUvlW/pvneUNUHDgyXgw ($200 in chips)
Seat 5: sTPOWERd9HWPCNrDBwsVjA ($215.40 in chips)
Seat 6: mfy7uGZcqA2PVQqEVbJ7+g ($201.75 in chips)
sTPOWERd9HWPCNrDBwsVjA: posts small blind $1
mfy7uGZcqA2PVQqEVbJ7+g: posts big blind $2
*** HOLE CARDS ***
ek1hig03QiyONDHXvgqteQ: folds
5Y+ZGWLI4gnlpApDX5vy1A: raises $6 to $8
Z55K9DbCHCUi6UaztIHi6g: calls $8
vVSUvlW/pvneUNUHDgyXgw: folds
sTPOWERd9HWPCNrDBwsVjA: folds
mfy7uGZcqA2PVQqEVbJ7+g: folds
*** FLOP *** [7s 3c Ts]
5Y+ZGWLI4gnlpApDX5vy1A: bets $12
Z55K9DbCHCUi6UaztIHi6g: raises $18 to $30
5Y+ZGWLI4gnlpApDX5vy1A: raises $193.45 to $223.45 and is all-in
Z55K9DbCHCUi6UaztIHi6g: folds
5Y+ZGWLI4gnlpApDX5vy1A collected $76 from pot
5Y+ZGWLI4gnlpApDX5vy1A: doesn't show hand
*** SUMMARY ***
Total pot $79 | Rake $3
Board [7s 3c Ts]
Seat 1: ek1hig03QiyONDHXvgqteQ folded before Flop (didn't bet)
Seat 2: 5Y+ZGWLI4gnlpApDX5vy1A collected ($76)
Seat 3: Z55K9DbCHCUi6UaztIHi6g folded on the Flop
Seat 4: vVSUvlW/pvneUNUHDgyXgw (button) folded before Flop (didn't bet)
Seat 5: sTPOWERd9HWPCNrDBwsVjA (small blind) folded before Flop
Seat 6: mfy7uGZcqA2PVQqEVbJ7+g (big blind) folded before Flop



PokerStars Game #59938808094:  Hold'em No Limit ($1/$2) - 2009/07/01 0:24:00 ET
Table '5G1PjWSk2ALz0O/eqyYy/g' 2-max Seat #2 is the button
Seat 1: Z4HwehErEwzsv/noQlfUlg ($141.90 in chips)
Seat 2: v4dp1VoMhJV4zmCXtmG5LQ ($226.30 in chips)
v4dp1VoMhJV4zmCXtmG5LQ: posts small blind $1
Z4HwehErEwzsv/noQlfUlg: posts big blind $2
*** HOLE CARDS ***
v4dp1VoMhJV4zmCXtmG5LQ: raises $4 to $6
Z4HwehErEwzsv/noQlfUlg: folds
v4dp1VoMhJV4zmCXtmG5LQ collected $4 from pot
v4dp1VoMhJV4zmCXtmG5LQ: doesn't show hand
*** SUMMARY ***
Total pot $4 | Rake $0
Seat 1: Z4HwehErEwzsv/noQlfUlg (big blind) folded before Flop
Seat 2: v4dp1VoMhJV4zmCXtmG5LQ (button) (small blind) collected ($4)



PokerStars Game #59938808960:  Hold'em No Limit ($1/$2) - 2009/07/01 0:24:01 ET
Table 'P/yCfYl1GfGsu/e6DxDy/A' 2-max Seat #2 is the button
Seat 1: 7fOCUy3x9hdkmXkkDNolGQ ($206.50 in chips)
Seat 2: RwDoM55ZeQuI2ADyJhOb2Q ($616 in chips)
RwDoM55ZeQuI2ADyJhOb2Q: posts small blind $1
7fOCUy3x9hdkmXkkDNolGQ: posts big blind $2
*** HOLE CARDS ***
RwDoM55ZeQuI2ADyJhOb2Q: folds
7fOCUy3x9hdkmXkkDNolGQ collected $2 from pot
7fOCUy3x9hdkmXkkDNolGQ: doesn't show hand
*** SUMMARY ***
Total pot $2 | Rake $0
Seat 1: 7fOCUy3x9hdkmXkkDNolGQ (big blind) collected ($2)
Seat 2: RwDoM55ZeQuI2ADyJhOb2Q (button) (small blind) folded before Flop



PokerStars Game #59938809708:  Hold'em No Limit ($1/$2) - 2009/07/01 0:24:03 ET
Table 'BSRfGh+QobUe0AgIMtt/fw' 9-max Seat #1 is the button
Seat 1: QHxJjpVYwitg9krW6wZgJA ($289.30 in chips)
Seat 2: GX1heJ+DSsvm7gzSPsYhhQ ($38 in chips)
Seat 3: XSBFygUEk3Ijl/S/KhD4PA ($356.60 in chips)
Seat 4: 5iPk5MyO3KVu18Y8XCYfFQ ($40 in chips)
Seat 5: odhvI/CZeMsPyo1n1U7+hA ($80.50 in chips)
Seat 6: H6Z4+qu8gR0VUiPOijndVg ($207.40 in chips)
Seat 7: RgU4royPa+zJopKX0xA3RA ($142.40 in chips)
Seat 8: /XRRUMKiOOItJFbrM26RrA ($54 in chips)
GX1heJ+DSsvm7gzSPsYhhQ: posts small blind $1
XSBFygUEk3Ijl/S/KhD4PA: posts big blind $2
/inIs/z/PcX+TniIFpaxpg: sits out
*** HOLE CARDS ***
5iPk5MyO3KVu18Y8XCYfFQ: raises $2 to $4
odhvI/CZeMsPyo1n1U7+hA: folds
H6Z4+qu8gR0VUiPOijndVg: folds
RgU4royPa+zJopKX0xA3RA: calls $4
/XRRUMKiOOItJFbrM26RrA: folds
QHxJjpVYwitg9krW6wZgJA: folds
GX1heJ+DSsvm7gzSPsYhhQ: folds
XSBFygUEk3Ijl/S/KhD4PA: calls $2
*** FLOP *** [Qh 4h 6d]
XSBFygUEk3Ijl/S/KhD4PA: checks
5iPk5MyO3KVu18Y8XCYfFQ: bets $6
RgU4royPa+zJopKX0xA3RA: raises $6 to $12
XSBFygUEk3Ijl/S/KhD4PA: folds
5iPk5MyO3KVu18Y8XCYfFQ: calls $6
*** TURN *** [Qh 4h 6d] [Jd]
5iPk5MyO3KVu18Y8XCYfFQ: checks
RgU4royPa+zJopKX0xA3RA: bets $10
5iPk5MyO3KVu18Y8XCYfFQ: folds
RgU4royPa+zJopKX0xA3RA collected $35.20 from pot
*** SUMMARY ***
Total pot $37 | Rake $1.80
Board [Qh 4h 6d Jd]
Seat 1: QHxJjpVYwitg9krW6wZgJA (button) folded before Flop (didn't bet)
Seat 2: GX1heJ+DSsvm7gzSPsYhhQ (small blind) folded before Flop
Seat 3: XSBFygUEk3Ijl/S/KhD4PA (big blind) folded on the Flop
Seat 4: 5iPk5MyO3KVu18Y8XCYfFQ folded on the Turn
Seat 5: odhvI/CZeMsPyo1n1U7+hA folded before Flop (didn't bet)
Seat 6: H6Z4+qu8gR0VUiPOijndVg folded before Flop (didn't bet)
Seat 7: RgU4royPa+zJopKX0xA3RA collected ($35.20)
Seat 8: /XRRUMKiOOItJFbrM26RrA folded before Flop (didn't bet)



PokerStars Game #59938811316:  Hold'em No Limit ($1/$2) - 2009/07/01 0:24:05 ET
Table 'bIihwBANJSFqlHPPtset+w' 9-max Seat #1 is the button
Seat 1: jI3JDUGV63ccqtKgM3vMbw ($156.70 in chips)
Seat 2: lQYT23h5QCUVZAKxjOO39Q ($110.90 in chips)
Seat 3: acnZ0LD5jxKgWIHz+mpQ8Q ($218.75 in chips)
Seat 4: 7WWX5PClBdr/U44gUKBIEA ($293.05 in chips)
Seat 5: rNejrG5tkeRBbL+UmC0iJA ($180.20 in chips)
Seat 6: 5iPk5MyO3KVu18Y8XCYfFQ ($86.80 in chips)
Seat 7: pCmk6FpSOLJ+85o1tLHIag ($92 in chips)
Seat 8: iMe5yhc+1BaiIPHet3NMrA ($275.65 in chips)
lQYT23h5QCUVZAKxjOO39Q: posts small blind $1
acnZ0LD5jxKgWIHz+mpQ8Q: posts big blind $2
GX1heJ+DSsvm7gzSPsYhhQ: sits out
*** HOLE CARDS ***
7WWX5PClBdr/U44gUKBIEA: folds
rNejrG5tkeRBbL+UmC0iJA: calls $2
5iPk5MyO3KVu18Y8XCYfFQ: raises $8 to $10
pCmk6FpSOLJ+85o1tLHIag: folds
iMe5yhc+1BaiIPHet3NMrA: folds
jI3JDUGV63ccqtKgM3vMbw: folds
lQYT23h5QCUVZAKxjOO39Q: folds
acnZ0LD5jxKgWIHz+mpQ8Q: folds
rNejrG5tkeRBbL+UmC0iJA: calls $8
*** FLOP *** [5s Tc 7c]
rNejrG5tkeRBbL+UmC0iJA: checks
5iPk5MyO3KVu18Y8XCYfFQ: bets $10
rNejrG5tkeRBbL+UmC0iJA: calls $10
*** TURN *** [5s Tc 7c] [6h]
rNejrG5tkeRBbL+UmC0iJA: checks
5iPk5MyO3KVu18Y8XCYfFQ: checks
*** RIVER *** [5s Tc 7c 6h] [9c]
rNejrG5tkeRBbL+UmC0iJA: bets $10
5iPk5MyO3KVu18Y8XCYfFQ: folds
rNejrG5tkeRBbL+UmC0iJA collected $40.95 from pot
*** SUMMARY ***
Total pot $43 | Rake $2.05
Board [5s Tc 7c 6h 9c]
Seat 1: jI3JDUGV63ccqtKgM3vMbw (button) folded before Flop (didn't bet)
Seat 2: lQYT23h5QCUVZAKxjOO39Q (small blind) folded before Flop
Seat 3: acnZ0LD5jxKgWIHz+mpQ8Q (big blind) folded before Flop
Seat 4: 7WWX5PClBdr/U44gUKBIEA folded before Flop (didn't bet)
Seat 5: rNejrG5tkeRBbL+UmC0iJA collected ($40.95)
Seat 6: 5iPk5MyO3KVu18Y8XCYfFQ folded on the River
Seat 7: pCmk6FpSOLJ+85o1tLHIag folded before Flop (didn't bet)
Seat 8: iMe5yhc+1BaiIPHet3NMrA folded before Flop (didn't bet)



PokerStars Game #59938811990:  Hold'em No Limit ($1/$2) - 2009/07/01 0:24:06 ET
Table 'uJ9juaXXg9yIcSU8amxaXQ' 6-max Seat #4 is the button
Seat 2: yynBOXUjw28V5kz84sxX4g ($136.05 in chips)
Seat 3: zaogaltCDFVsIASEnrXs2w ($293 in chips)
Seat 4: zNjJ/y4emmF+vzrCDd+ooA ($117.35 in chips)
Seat 5: aMZYAxFxWTQXE9aUus4sxg ($59.15 in chips)
Seat 6: XrFG4dK06RVKLlX32/pjcQ ($59.80 in chips)
aMZYAxFxWTQXE9aUus4sxg: posts small blind $1
XrFG4dK06RVKLlX32/pjcQ: posts big blind $2
*** HOLE CARDS ***
yynBOXUjw28V5kz84sxX4g: folds
zaogaltCDFVsIASEnrXs2w: folds
zNjJ/y4emmF+vzrCDd+ooA: folds
aMZYAxFxWTQXE9aUus4sxg: calls $1
XrFG4dK06RVKLlX32/pjcQ: checks
*** FLOP *** [3s Ks 4c]
zaogaltCDFVsIASEnrXs2w is sitting out
aMZYAxFxWTQXE9aUus4sxg: checks
XrFG4dK06RVKLlX32/pjcQ: checks
*** TURN *** [3s Ks 4c] [2h]
aMZYAxFxWTQXE9aUus4sxg: checks
XrFG4dK06RVKLlX32/pjcQ: checks
*** RIVER *** [3s Ks 4c 2h] [4h]
aMZYAxFxWTQXE9aUus4sxg: checks
XrFG4dK06RVKLlX32/pjcQ: bets $2
aMZYAxFxWTQXE9aUus4sxg: folds
XrFG4dK06RVKLlX32/pjcQ collected $3.80 from pot
*** SUMMARY ***
Total pot $4 | Rake $0.20
Board [3s Ks 4c 2h 4h]
Seat 2: yynBOXUjw28V5kz84sxX4g folded before Flop (didn't bet)
Seat 3: zaogaltCDFVsIASEnrXs2w folded before Flop (didn't bet)
Seat 4: zNjJ/y4emmF+vzrCDd+ooA (button) folded before Flop (didn't bet)
Seat 5: aMZYAxFxWTQXE9aUus4sxg (small blind) folded on the River
Seat 6: XrFG4dK06RVKLlX32/pjcQ (big blind) collected ($3.80)



PokerStars Game #59938811652:  Hold'em No Limit ($1/$2) - 2009/07/01 0:24:06 ET
Table 'ZzSIe0zTCDv+n6hfbY5tTg' 6-max Seat #4 is the button
Seat 2: B87ikIyZ/TzAVeXf38Ny0g ($203 in chips)
Seat 3: X7GlkHF+lkbarCLuZ4Uf0w ($63 in chips)
Seat 4: ky55L0pITYgYLeqFB9gP/Q ($190.40 in chips)
Seat 5: f2eTKbND+tM3kUw9o6WYWg ($101 in chips)
Seat 6: InmkdI6G8TzSj9NhcCSyPg ($200 in chips)
f2eTKbND+tM3kUw9o6WYWg: posts small blind $1
InmkdI6G8TzSj9NhcCSyPg: posts big blind $2
*** HOLE CARDS ***
B87ikIyZ/TzAVeXf38Ny0g: folds
X7GlkHF+lkbarCLuZ4Uf0w: folds
ky55L0pITYgYLeqFB9gP/Q: folds
f2eTKbND+tM3kUw9o6WYWg: raises $4 to $6
InmkdI6G8TzSj9NhcCSyPg: folds
f2eTKbND+tM3kUw9o6WYWg collected $4 from pot
f2eTKbND+tM3kUw9o6WYWg: doesn't show hand
*** SUMMARY ***
Total pot $4 | Rake $0
Seat 2: B87ikIyZ/TzAVeXf38Ny0g folded before Flop (didn't bet)
Seat 3: X7GlkHF+lkbarCLuZ4Uf0w folded before Flop (didn't bet)
Seat 4: ky55L0pITYgYLeqFB9gP/Q (button) folded before Flop (didn't bet)
Seat 5: f2eTKbND+tM3kUw9o6WYWg (small blind) collected ($4)
Seat 6: InmkdI6G8TzSj9NhcCSyPg (big blind) folded before Flop



PokerStars Game #59938812348:  Hold'em No Limit ($1/$2) - 2009/07/01 0:24:07 ET
Table 'OZyw34U4j4WtFFWsEHZQgQ' 2-max Seat #1 is the button
Seat 1: pVqEzK9wXlRMECnb1Zg4Zw ($76.90 in chips)
Seat 2: rAtTyvrJ8f1LaUh2O5U4nA ($45.70 in chips)
pVqEzK9wXlRMECnb1Zg4Zw: posts small blind $1
rAtTyvrJ8f1LaUh2O5U4nA: posts big blind $2
*** HOLE CARDS ***
pVqEzK9wXlRMECnb1Zg4Zw: raises $6 to $8
rAtTyvrJ8f1LaUh2O5U4nA: folds
pVqEzK9wXlRMECnb1Zg4Zw collected $4 from pot
pVqEzK9wXlRMECnb1Zg4Zw: doesn't show hand
*** SUMMARY ***
Total pot $4 | Rake $0
Seat 1: pVqEzK9wXlRMECnb1Zg4Zw (button) (small blind) collected ($4)
Seat 2: rAtTyvrJ8f1LaUh2O5U4nA (big blind) folded before Flop



PokerStars Game #59938812326:  Hold'em No Limit ($1/$2) - 2009/07/01 0:24:07 ET
Table 'NmY84NAf9Mh0ckAckHnh5g' 2-max Seat #1 is the button
Seat 1: 6hvg964TSqZ3AL/0XK9aVQ ($527.95 in chips)
Seat 2: RwDoM55ZeQuI2ADyJhOb2Q ($315.50 in chips)
6hvg964TSqZ3AL/0XK9aVQ: posts small blind $1
RwDoM55ZeQuI2ADyJhOb2Q: posts big blind $2
*** HOLE CARDS ***
6hvg964TSqZ3AL/0XK9aVQ: folds
RwDoM55ZeQuI2ADyJhOb2Q collected $2 from pot
RwDoM55ZeQuI2ADyJhOb2Q: doesn't show hand
*** SUMMARY ***
Total pot $2 | Rake $0
Seat 1: 6hvg964TSqZ3AL/0XK9aVQ (button) (small blind) folded before Flop
Seat 2: RwDoM55ZeQuI2ADyJhOb2Q (big blind) collected ($2)



PokerStars Game #59938812322:  Hold'em No Limit ($1/$2) - 2009/07/01 0:24:07 ET
Table 'mGpP9StWRnoeiBDExc6Frg' 6-max Seat #1 is the button
Seat 1: zWFU82nxIRvzK4mKiL4m0Q ($60.15 in chips)
Seat 2: DQlskgG4OtLpF2MVxLwf4A ($309.85 in chips)
Seat 3: 3HrFUl+TAqSP1U00zz3P7A ($86.40 in chips)
Seat 4: qXDd0ZyMIse0OBu8pxeQ3Q ($218 in chips)
Seat 5: d1puGuVBE0fidn+5eRJ0tw ($164.70 in chips)
Seat 6: X7GlkHF+lkbarCLuZ4Uf0w ($40 in chips)
DQlskgG4OtLpF2MVxLwf4A: posts small blind $1
3HrFUl+TAqSP1U00zz3P7A: posts big blind $2
*** HOLE CARDS ***
qXDd0ZyMIse0OBu8pxeQ3Q: folds
d1puGuVBE0fidn+5eRJ0tw: folds
X7GlkHF+lkbarCLuZ4Uf0w: raises $2 to $4
zWFU82nxIRvzK4mKiL4m0Q: folds
DQlskgG4OtLpF2MVxLwf4A: folds
3HrFUl+TAqSP1U00zz3P7A: folds
X7GlkHF+lkbarCLuZ4Uf0w collected $5 from pot
X7GlkHF+lkbarCLuZ4Uf0w: doesn't show hand
*** SUMMARY ***
Total pot $5 | Rake $0
Seat 1: zWFU82nxIRvzK4mKiL4m0Q (button) folded before Flop (didn't bet)
Seat 2: DQlskgG4OtLpF2MVxLwf4A (small blind) folded before Flop
Seat 3: 3HrFUl+TAqSP1U00zz3P7A (big blind) folded before Flop
Seat 4: qXDd0ZyMIse0OBu8pxeQ3Q folded before Flop (didn't bet)
Seat 5: d1puGuVBE0fidn+5eRJ0tw folded before Flop (didn't bet)
Seat 6: X7GlkHF+lkbarCLuZ4Uf0w collected ($5)



PokerStars Game #59938813434:  Hold'em No Limit ($1/$2) - 2009/07/01 0:24:08 ET
Table 'XP2sRSup+aRuwzx3vDZsDg' 6-max Seat #5 is the button
Seat 1: o9jamqIi6sTTRSqudgboRA ($234.75 in chips)
Seat 3: X7GlkHF+lkbarCLuZ4Uf0w ($39 in chips)
Seat 4: hCtfSY4dRapM2rhEFmS4Ug ($120 in chips)
Seat 5: 894kvCY4GHivBpqwizsecg ($113.45 in chips)
Seat 6: h7ppRQJTYBsHCbLMeW9T2g ($447.75 in chips)
h7ppRQJTYBsHCbLMeW9T2g: posts small blind $1
o9jamqIi6sTTRSqudgboRA: posts big blind $2
ygTTt5ehT4aF86q1a8/R+w: sits out
hCtfSY4dRapM2rhEFmS4Ug: posts big blind $2
*** HOLE CARDS ***
X7GlkHF+lkbarCLuZ4Uf0w: folds
hCtfSY4dRapM2rhEFmS4Ug: raises $6 to $8
894kvCY4GHivBpqwizsecg: folds
h7ppRQJTYBsHCbLMeW9T2g: folds
o9jamqIi6sTTRSqudgboRA: folds
hCtfSY4dRapM2rhEFmS4Ug collected $5 from pot
*** SUMMARY ***
Total pot $5 | Rake $0
Seat 1: o9jamqIi6sTTRSqudgboRA (big blind) folded before Flop
Seat 3: X7GlkHF+lkbarCLuZ4Uf0w folded before Flop (didn't bet)
Seat 4: hCtfSY4dRapM2rhEFmS4Ug collected ($5)
Seat 5: 894kvCY4GHivBpqwizsecg (button) folded before Flop (didn't bet)
Seat 6: h7ppRQJTYBsHCbLMeW9T2g (small blind) folded before Flop



PokerStars Game #59938814158:  Hold'em No Limit ($1/$2) - 2009/07/01 0:24:09 ET
Table 'aSf77Sj8QEnzcc0WaxVD4Q' 6-max Seat #2 is the button
Seat 1: 54yWzRRgS0oZ+S6LwZBxMQ ($34 in chips)
Seat 2: vkfxu8f/jMYKUk6Ly4eujw ($244.15 in chips)
Seat 3: 9dpyyjDTCed6nV7JhaUUpw ($205.30 in chips)
Seat 4: 513FcCI8jHyQy2VWoIQkMg ($201.75 in chips)
Seat 5: InmkdI6G8TzSj9NhcCSyPg ($247 in chips)
Seat 6: vkoJRf3gidxY1pPi0AFWww ($313.80 in chips)
9dpyyjDTCed6nV7JhaUUpw: posts small blind $1
513FcCI8jHyQy2VWoIQkMg: posts big blind $2
*** HOLE CARDS ***
InmkdI6G8TzSj9NhcCSyPg: folds
vkoJRf3gidxY1pPi0AFWww: folds
54yWzRRgS0oZ+S6LwZBxMQ: raises $2 to $4
vkfxu8f/jMYKUk6Ly4eujw: folds
9dpyyjDTCed6nV7JhaUUpw: folds
513FcCI8jHyQy2VWoIQkMg: folds
54yWzRRgS0oZ+S6LwZBxMQ collected $5 from pot
54yWzRRgS0oZ+S6LwZBxMQ: doesn't show hand
*** SUMMARY ***
Total pot $5 | Rake $0
Seat 1: 54yWzRRgS0oZ+S6LwZBxMQ collected ($5)
Seat 2: vkfxu8f/jMYKUk6Ly4eujw (button) folded before Flop (didn't bet)
Seat 3: 9dpyyjDTCed6nV7JhaUUpw (small blind) folded before Flop
Seat 4: 513FcCI8jHyQy2VWoIQkMg (big blind) folded before Flop
Seat 5: InmkdI6G8TzSj9NhcCSyPg folded before Flop (didn't bet)
Seat 6: vkoJRf3gidxY1pPi0AFWww folded before Flop (didn't bet)



PokerStars Game #59938814072:  Hold'em No Limit ($1/$2) - 2009/07/01 0:24:09 ET
Table 'P/yCfYl1GfGsu/e6DxDy/A' 2-max Seat #1 is the button
Seat 1: 7fOCUy3x9hdkmXkkDNolGQ ($207.50 in chips)
Seat 2: RwDoM55ZeQuI2ADyJhOb2Q ($615 in chips)
7fOCUy3x9hdkmXkkDNolGQ: posts small blind $1
RwDoM55ZeQuI2ADyJhOb2Q: posts big blind $2
*** HOLE CARDS ***
7fOCUy3x9hdkmXkkDNolGQ: raises $4 to $6
RwDoM55ZeQuI2ADyJhOb2Q: calls $4
*** FLOP *** [Ac 8h 7c]
RwDoM55ZeQuI2ADyJhOb2Q: bets $8
7fOCUy3x9hdkmXkkDNolGQ: raises $16 to $24
RwDoM55ZeQuI2ADyJhOb2Q: raises $82 to $106
7fOCUy3x9hdkmXkkDNolGQ: raises $95.50 to $201.50 and is all-in
RwDoM55ZeQuI2ADyJhOb2Q: calls $95.50
*** TURN *** [Ac 8h 7c] [9h]
*** RIVER *** [Ac 8h 7c 9h] [9s]
*** SHOW DOWN ***
RwDoM55ZeQuI2ADyJhOb2Q: shows [5c 6c] (a straight, Five to Nine)
7fOCUy3x9hdkmXkkDNolGQ: mucks hand
RwDoM55ZeQuI2ADyJhOb2Q collected $414.50 from pot
*** SUMMARY ***
Total pot $415 | Rake $0.50
Board [Ac 8h 7c 9h 9s]
Seat 1: 7fOCUy3x9hdkmXkkDNolGQ (button) (small blind) mucked
Seat 2: RwDoM55ZeQuI2ADyJhOb2Q (big blind) showed [5c 6c] and won ($414.50) with a straight, Five to Nine



PokerStars Game #59938813682:  Hold'em No Limit ($1/$2) - 2009/07/01 0:24:09 ET
Table '5G1PjWSk2ALz0O/eqyYy/g' 2-max Seat #1 is the button
Seat 1: Z4HwehErEwzsv/noQlfUlg ($139.90 in chips)
Seat 2: v4dp1VoMhJV4zmCXtmG5LQ ($228.30 in chips)
Z4HwehErEwzsv/noQlfUlg: posts small blind $1
v4dp1VoMhJV4zmCXtmG5LQ: posts big blind $2
*** HOLE CARDS ***
Z4HwehErEwzsv/noQlfUlg: raises $2 to $4
v4dp1VoMhJV4zmCXtmG5LQ: folds
Z4HwehErEwzsv/noQlfUlg collected $4 from pot
*** SUMMARY ***
Total pot $4 | Rake $0
Seat 1: Z4HwehErEwzsv/noQlfUlg (button) (small blind) collected ($4)
Seat 2: v4dp1VoMhJV4zmCXtmG5LQ (big blind) folded before Flop



PokerStars Game #59938816502:  Hold'em No Limit ($1/$2) - 2009/07/01 0:24:13 ET
Table 'NmY84NAf9Mh0ckAckHnh5g' 2-max Seat #2 is the button
Seat 1: 6hvg964TSqZ3AL/0XK9aVQ ($526.95 in chips)
Seat 2: RwDoM55ZeQuI2ADyJhOb2Q ($316.50 in chips)
RwDoM55ZeQuI2ADyJhOb2Q: posts small blind $1
6hvg964TSqZ3AL/0XK9aVQ: posts big blind $2
*** HOLE CARDS ***
RwDoM55ZeQuI2ADyJhOb2Q: folds
6hvg964TSqZ3AL/0XK9aVQ collected $2 from pot
6hvg964TSqZ3AL/0XK9aVQ: doesn't show hand
*** SUMMARY ***
Total pot $2 | Rake $0
Seat 1: 6hvg964TSqZ3AL/0XK9aVQ (big blind) collected ($2)
Seat 2: RwDoM55ZeQuI2ADyJhOb2Q (button) (small blind) folded before Flop



PokerStars Game #59938817180:  Hold'em No Limit ($1/$2) - 2009/07/01 0:24:14 ET
Table 'jCW99a4MXoPgL0PwEZ4IuQ' 2-max Seat #1 is the button
Seat 1: t6Jd836OSEMbcRi7rfGp5g ($224.50 in chips)
Seat 2: bWN162Ep6lKyJ0MW6unz4w ($195.50 in chips)
t6Jd836OSEMbcRi7rfGp5g: posts small blind $1
bWN162Ep6lKyJ0MW6unz4w: posts big blind $2
*** HOLE CARDS ***
t6Jd836OSEMbcRi7rfGp5g: raises $4 to $6
bWN162Ep6lKyJ0MW6unz4w: raises $12 to $18
t6Jd836OSEMbcRi7rfGp5g: folds
bWN162Ep6lKyJ0MW6unz4w collected $12 from pot
bWN162Ep6lKyJ0MW6unz4w: doesn't show hand
*** SUMMARY ***
Total pot $12 | Rake $0
Seat 1: t6Jd836OSEMbcRi7rfGp5g (button) (small blind) folded before Flop
Seat 2: bWN162Ep6lKyJ0MW6unz4w (big blind) collected ($12)



PokerStars Game #59938817662:  Hold'em No Limit ($1/$2) - 2009/07/01 0:24:15 ET
Table 'OZyw34U4j4WtFFWsEHZQgQ' 2-max Seat #2 is the button
Seat 1: pVqEzK9wXlRMECnb1Zg4Zw ($78.90 in chips)
Seat 2: rAtTyvrJ8f1LaUh2O5U4nA ($43.70 in chips)
rAtTyvrJ8f1LaUh2O5U4nA: posts small blind $1
pVqEzK9wXlRMECnb1Zg4Zw: posts big blind $2
*** HOLE CARDS ***
rAtTyvrJ8f1LaUh2O5U4nA: folds
pVqEzK9wXlRMECnb1Zg4Zw collected $2 from pot
pVqEzK9wXlRMECnb1Zg4Zw: doesn't show hand
*** SUMMARY ***
Total pot $2 | Rake $0
Seat 1: pVqEzK9wXlRMECnb1Zg4Zw (big blind) collected ($2)
Seat 2: rAtTyvrJ8f1LaUh2O5U4nA (button) (small blind) folded before Flop



PokerStars Game #59938817706:  Hold'em No Limit ($1/$2) - 2009/07/01 0:24:15 ET
Table 'jlrIxbrVIG+gjaUYT4za8g' 6-max Seat #2 is the button
Seat 1: ygTTt5ehT4aF86q1a8/R+w ($187.05 in chips)
Seat 2: N18PrNGQj43J7TJuQuu+tw ($156.55 in chips)
Seat 3: 54yWzRRgS0oZ+S6LwZBxMQ ($35.80 in chips)
Seat 4: 8srN1dKQePlsv0GyTada+Q ($221 in chips)
Seat 5: VuZb/hkEc4X7s93w2ZZTpA ($200 in chips)
Seat 6: vkfxu8f/jMYKUk6Ly4eujw ($263.95 in chips)
54yWzRRgS0oZ+S6LwZBxMQ: posts small blind $1
8srN1dKQePlsv0GyTada+Q: posts big blind $2
*** HOLE CARDS ***
VuZb/hkEc4X7s93w2ZZTpA: folds
vkfxu8f/jMYKUk6Ly4eujw: folds
ygTTt5ehT4aF86q1a8/R+w: folds
N18PrNGQj43J7TJuQuu+tw: calls $2
54yWzRRgS0oZ+S6LwZBxMQ: calls $1
8srN1dKQePlsv0GyTada+Q: checks
*** FLOP *** [Ac 9h 9c]
54yWzRRgS0oZ+S6LwZBxMQ: bets $4
8srN1dKQePlsv0GyTada+Q: folds
N18PrNGQj43J7TJuQuu+tw: folds
54yWzRRgS0oZ+S6LwZBxMQ collected $5.70 from pot
*** SUMMARY ***
Total pot $6 | Rake $0.30
Board [Ac 9h 9c]
Seat 1: ygTTt5ehT4aF86q1a8/R+w folded before Flop (didn't bet)
Seat 2: N18PrNGQj43J7TJuQuu+tw (button) folded on the Flop
Seat 3: 54yWzRRgS0oZ+S6LwZBxMQ (small blind) collected ($5.70)
Seat 4: 8srN1dKQePlsv0GyTada+Q (big blind) folded on the Flop
Seat 5: VuZb/hkEc4X7s93w2ZZTpA folded before Flop (didn't bet)
Seat 6: vkfxu8f/jMYKUk6Ly4eujw folded before Flop (didn't bet)



PokerStars Game #59938818586:  Hold'em No Limit ($1/$2) - 2009/07/01 0:24:16 ET
Table '5G1PjWSk2ALz0O/eqyYy/g' 2-max Seat #2 is the button
Seat 1: Z4HwehErEwzsv/noQlfUlg ($141.90 in chips)
Seat 2: v4dp1VoMhJV4zmCXtmG5LQ ($226.30 in chips)
v4dp1VoMhJV4zmCXtmG5LQ: posts small blind $1
Z4HwehErEwzsv/noQlfUlg: posts big blind $2
*** HOLE CARDS ***
v4dp1VoMhJV4zmCXtmG5LQ: raises $4 to $6
Z4HwehErEwzsv/noQlfUlg: calls $4
*** FLOP *** [5c 9h 4d]
Z4HwehErEwzsv/noQlfUlg: bets $6
v4dp1VoMhJV4zmCXtmG5LQ: calls $6
*** TURN *** [5c 9h 4d] [Tc]
Z4HwehErEwzsv/noQlfUlg: checks
v4dp1VoMhJV4zmCXtmG5LQ: bets $14
Z4HwehErEwzsv/noQlfUlg: folds
v4dp1VoMhJV4zmCXtmG5LQ collected $23.50 from pot
v4dp1VoMhJV4zmCXtmG5LQ: doesn't show hand
*** SUMMARY ***
Total pot $24 | Rake $0.50
Board [5c 9h 4d Tc]
Seat 1: Z4HwehErEwzsv/noQlfUlg (big blind) folded on the Turn
Seat 2: v4dp1VoMhJV4zmCXtmG5LQ (button) (small blind) collected ($23.50)



PokerStars Game #59938818686:  Hold'em No Limit ($1/$2) - 2009/07/01 0:24:16 ET
Table 'gnHBqWll9O3fxG7Ojkz/ng' 9-max Seat #1 is the button
Seat 1: hpqdC/23wXosGOmzARr5NA ($144.05 in chips)
Seat 2: H6Z4+qu8gR0VUiPOijndVg ($200 in chips)
Seat 3: 5Q8U6iZbeO7xJSS4qvDP5g ($231.35 in chips)
Seat 4: n5XI5/7gN+gIubHFBH+mOw ($400.15 in chips)
Seat 5: rBQDMkKm9cZn6M9NPsiVew ($172.45 in chips)
Seat 6: 5iPk5MyO3KVu18Y8XCYfFQ ($40 in chips)
Seat 7: jqui3xAWCkcdPW36a6BD+w ($214.55 in chips)
Seat 8: cM6efHzdxoqYm0EQKP4TTQ ($105.80 in chips)
H6Z4+qu8gR0VUiPOijndVg: posts small blind $1
5Q8U6iZbeO7xJSS4qvDP5g: posts big blind $2
GX1heJ+DSsvm7gzSPsYhhQ: sits out
*** HOLE CARDS ***
n5XI5/7gN+gIubHFBH+mOw: calls $2
rBQDMkKm9cZn6M9NPsiVew: folds
5iPk5MyO3KVu18Y8XCYfFQ: folds
jqui3xAWCkcdPW36a6BD+w: calls $2
cM6efHzdxoqYm0EQKP4TTQ: folds
hpqdC/23wXosGOmzARr5NA: calls $2
H6Z4+qu8gR0VUiPOijndVg: calls $1
5Q8U6iZbeO7xJSS4qvDP5g: checks
*** FLOP *** [Qc Td 7h]
H6Z4+qu8gR0VUiPOijndVg: checks
5Q8U6iZbeO7xJSS4qvDP5g: checks
n5XI5/7gN+gIubHFBH+mOw: checks
jqui3xAWCkcdPW36a6BD+w: checks
hpqdC/23wXosGOmzARr5NA: checks
*** TURN *** [Qc Td 7h] [6h]
H6Z4+qu8gR0VUiPOijndVg: checks
5Q8U6iZbeO7xJSS4qvDP5g: checks
n5XI5/7gN+gIubHFBH+mOw: bets $10
jqui3xAWCkcdPW36a6BD+w: folds
hpqdC/23wXosGOmzARr5NA: calls $10
H6Z4+qu8gR0VUiPOijndVg: folds
5Q8U6iZbeO7xJSS4qvDP5g: folds
*** RIVER *** [Qc Td 7h 6h] [4s]
n5XI5/7gN+gIubHFBH+mOw: bets $20
hpqdC/23wXosGOmzARr5NA: calls $20
*** SHOW DOWN ***
n5XI5/7gN+gIubHFBH+mOw: shows [Ks 9s] (high card King)
hpqdC/23wXosGOmzARr5NA: shows [6c 7c] (two pair, Sevens and Sixes)
hpqdC/23wXosGOmzARr5NA collected $67 from pot
*** SUMMARY ***
Total pot $70 | Rake $3
Board [Qc Td 7h 6h 4s]
Seat 1: hpqdC/23wXosGOmzARr5NA (button) showed [6c 7c] and won ($67) with two pair, Sevens and Sixes
Seat 2: H6Z4+qu8gR0VUiPOijndVg (small blind) folded on the Turn
Seat 3: 5Q8U6iZbeO7xJSS4qvDP5g (big blind) folded on the Turn
Seat 4: n5XI5/7gN+gIubHFBH+mOw showed [Ks 9s] and lost with high card King
Seat 5: rBQDMkKm9cZn6M9NPsiVew folded before Flop (didn't bet)
Seat 6: 5iPk5MyO3KVu18Y8XCYfFQ folded before Flop (didn't bet)
Seat 7: jqui3xAWCkcdPW36a6BD+w folded on the Turn
Seat 8: cM6efHzdxoqYm0EQKP4TTQ folded before Flop (didn't bet)



PokerStars Game #59938821348:  Hold'em No Limit ($1/$2) - 2009/07/01 0:24:20 ET
Table 'NmY84NAf9Mh0ckAckHnh5g' 2-max Seat #1 is the button
Seat 1: 6hvg964TSqZ3AL/0XK9aVQ ($527.95 in chips)
Seat 2: RwDoM55ZeQuI2ADyJhOb2Q ($315.50 in chips)
6hvg964TSqZ3AL/0XK9aVQ: posts small blind $1
RwDoM55ZeQuI2ADyJhOb2Q: posts big blind $2
*** HOLE CARDS ***
6hvg964TSqZ3AL/0XK9aVQ: calls $1
RwDoM55ZeQuI2ADyJhOb2Q: checks
*** FLOP *** [Ts 5c Qc]
RwDoM55ZeQuI2ADyJhOb2Q: bets $4
6hvg964TSqZ3AL/0XK9aVQ: calls $4
*** TURN *** [Ts 5c Qc] [9s]
RwDoM55ZeQuI2ADyJhOb2Q: bets $12
6hvg964TSqZ3AL/0XK9aVQ: calls $12
*** RIVER *** [Ts 5c Qc 9s] [Kh]
RwDoM55ZeQuI2ADyJhOb2Q: bets $42
6hvg964TSqZ3AL/0XK9aVQ: folds
RwDoM55ZeQuI2ADyJhOb2Q collected $35.50 from pot
RwDoM55ZeQuI2ADyJhOb2Q: doesn't show hand
*** SUMMARY ***
Total pot $36 | Rake $0.50
Board [Ts 5c Qc 9s Kh]
Seat 1: 6hvg964TSqZ3AL/0XK9aVQ (button) (small blind) folded on the River
Seat 2: RwDoM55ZeQuI2ADyJhOb2Q (big blind) collected ($35.50)



PokerStars Game #59938822270:  Hold'em No Limit ($1/$2) - 2009/07/01 0:24:22 ET
Table 'OZyw34U4j4WtFFWsEHZQgQ' 2-max Seat #1 is the button
Seat 1: pVqEzK9wXlRMECnb1Zg4Zw ($79.90 in chips)
Seat 2: rAtTyvrJ8f1LaUh2O5U4nA ($42.70 in chips)
pVqEzK9wXlRMECnb1Zg4Zw: posts small blind $1
rAtTyvrJ8f1LaUh2O5U4nA: posts big blind $2
*** HOLE CARDS ***
pVqEzK9wXlRMECnb1Zg4Zw: folds
rAtTyvrJ8f1LaUh2O5U4nA collected $2 from pot
*** SUMMARY ***
Total pot $2 | Rake $0
Seat 1: pVqEzK9wXlRMECnb1Zg4Zw (button) (small blind) folded before Flop
Seat 2: rAtTyvrJ8f1LaUh2O5U4nA (big blind) collected ($2)



PokerStars Game #59938824270:  Hold'em No Limit ($1/$2) - 2009/07/01 0:24:25 ET
Table 'jCW99a4MXoPgL0PwEZ4IuQ' 2-max Seat #2 is the button
Seat 1: t6Jd836OSEMbcRi7rfGp5g ($218.50 in chips)
Seat 2: bWN162Ep6lKyJ0MW6unz4w ($201.50 in chips)
bWN162Ep6lKyJ0MW6unz4w: posts small blind $1
t6Jd836OSEMbcRi7rfGp5g: posts big blind $2
*** HOLE CARDS ***
bWN162Ep6lKyJ0MW6unz4w: raises $4 to $6
t6Jd836OSEMbcRi7rfGp5g: folds
bWN162Ep6lKyJ0MW6unz4w collected $4 from pot
bWN162Ep6lKyJ0MW6unz4w: doesn't show hand
*** SUMMARY ***
Total pot $4 | Rake $0
Seat 1: t6Jd836OSEMbcRi7rfGp5g (big blind) folded before Flop
Seat 2: bWN162Ep6lKyJ0MW6unz4w (button) (small blind) collected ($4)



PokerStars Game #59938826328:  Hold'em No Limit ($1/$2) - 2009/07/01 0:24:28 ET
Table 'OZyw34U4j4WtFFWsEHZQgQ' 2-max Seat #2 is the button
Seat 1: pVqEzK9wXlRMECnb1Zg4Zw ($78.90 in chips)
Seat 2: rAtTyvrJ8f1LaUh2O5U4nA ($43.70 in chips)
rAtTyvrJ8f1LaUh2O5U4nA: posts small blind $1
pVqEzK9wXlRMECnb1Zg4Zw: posts big blind $2
*** HOLE CARDS ***
rAtTyvrJ8f1LaUh2O5U4nA: raises $2 to $4
pVqEzK9wXlRMECnb1Zg4Zw: folds
rAtTyvrJ8f1LaUh2O5U4nA collected $4 from pot
rAtTyvrJ8f1LaUh2O5U4nA: doesn't show hand
*** SUMMARY ***
Total pot $4 | Rake $0
Seat 1: pVqEzK9wXlRMECnb1Zg4Zw (big blind) folded before Flop
Seat 2: rAtTyvrJ8f1LaUh2O5U4nA (button) (small blind) collected ($4)



PokerStars Game #59938826396:  Hold'em No Limit ($1/$2) - 2009/07/01 0:24:28 ET
Table 'mGpP9StWRnoeiBDExc6Frg' 6-max Seat #2 is the button
Seat 1: zWFU82nxIRvzK4mKiL4m0Q ($60.15 in chips)
Seat 2: DQlskgG4OtLpF2MVxLwf4A ($308.85 in chips)
Seat 3: 3HrFUl+TAqSP1U00zz3P7A ($84.40 in chips)
Seat 4: qXDd0ZyMIse0OBu8pxeQ3Q ($218 in chips)
Seat 5: d1puGuVBE0fidn+5eRJ0tw ($164.70 in chips)
Seat 6: X7GlkHF+lkbarCLuZ4Uf0w ($43 in chips)
3HrFUl+TAqSP1U00zz3P7A: posts small blind $1
qXDd0ZyMIse0OBu8pxeQ3Q: posts big blind $2
*** HOLE CARDS ***
d1puGuVBE0fidn+5eRJ0tw: folds
X7GlkHF+lkbarCLuZ4Uf0w: folds
zWFU82nxIRvzK4mKiL4m0Q: folds
DQlskgG4OtLpF2MVxLwf4A: folds
3HrFUl+TAqSP1U00zz3P7A: folds
qXDd0ZyMIse0OBu8pxeQ3Q collected $2 from pot
*** SUMMARY ***
Total pot $2 | Rake $0
Seat 1: zWFU82nxIRvzK4mKiL4m0Q folded before Flop (didn't bet)
Seat 2: DQlskgG4OtLpF2MVxLwf4A (button) folded before Flop (didn't bet)
Seat 3: 3HrFUl+TAqSP1U00zz3P7A (small blind) folded before Flop
Seat 4: qXDd0ZyMIse0OBu8pxeQ3Q (big blind) collected ($2)
Seat 5: d1puGuVBE0fidn+5eRJ0tw folded before Flop (didn't bet)
Seat 6: X7GlkHF+lkbarCLuZ4Uf0w folded before Flop (didn't bet)



PokerStars Game #59938828556:  Hold'em No Limit ($1/$2) - 2009/07/01 0:24:31 ET
Table 'srul5UFZXTEccVV5fpY91g' 9-max Seat #3 is the button
Seat 1: lfD8cBv31A/pio3pXJbPjA ($153.20 in chips)
Seat 2: tJYod1SLp2AcWPL/3hZ7ug ($67.20 in chips)
Seat 3: weUZ8S7tgbaeIpzi1gBNxQ ($44.75 in chips)
Seat 4: GG5lTuGt3+kwNYSbqeB6yw ($86.40 in chips)
Seat 5: 5iPk5MyO3KVu18Y8XCYfFQ ($79.55 in chips)
Seat 6: TAfo4veNRaRlzDXMMYS3Jg ($33 in chips)
Seat 7: s0erZsDxbZSaEPheMgibKg ($444.10 in chips)
Seat 8: UZEsV9yKUMqmpYPiOFpaZw ($73 in chips)
Seat 9: jRGC4KXXODbHEN275TXFCA ($184.30 in chips)
GG5lTuGt3+kwNYSbqeB6yw: posts small blind $1
5iPk5MyO3KVu18Y8XCYfFQ: posts big blind $2
*** HOLE CARDS ***
TAfo4veNRaRlzDXMMYS3Jg is disconnected
TAfo4veNRaRlzDXMMYS3Jg has timed out while disconnected
TAfo4veNRaRlzDXMMYS3Jg: folds
TAfo4veNRaRlzDXMMYS3Jg is sitting out
s0erZsDxbZSaEPheMgibKg: folds
UZEsV9yKUMqmpYPiOFpaZw: raises $2 to $4
jRGC4KXXODbHEN275TXFCA: folds
lfD8cBv31A/pio3pXJbPjA: folds
tJYod1SLp2AcWPL/3hZ7ug: folds
weUZ8S7tgbaeIpzi1gBNxQ: folds
GG5lTuGt3+kwNYSbqeB6yw: folds
5iPk5MyO3KVu18Y8XCYfFQ: folds
UZEsV9yKUMqmpYPiOFpaZw collected $5 from pot
UZEsV9yKUMqmpYPiOFpaZw: doesn't show hand
*** SUMMARY ***
Total pot $5 | Rake $0
Seat 1: lfD8cBv31A/pio3pXJbPjA folded before Flop (didn't bet)
Seat 2: tJYod1SLp2AcWPL/3hZ7ug folded before Flop (didn't bet)
Seat 3: weUZ8S7tgbaeIpzi1gBNxQ (button) folded before Flop (didn't bet)
Seat 4: GG5lTuGt3+kwNYSbqeB6yw (small blind) folded before Flop
Seat 5: 5iPk5MyO3KVu18Y8XCYfFQ (big blind) folded before Flop
Seat 6: TAfo4veNRaRlzDXMMYS3Jg folded before Flop (didn't bet)
Seat 7: s0erZsDxbZSaEPheMgibKg folded before Flop (didn't bet)
Seat 8: UZEsV9yKUMqmpYPiOFpaZw collected ($5)
Seat 9: jRGC4KXXODbHEN275TXFCA folded before Flop (didn't bet)



PokerStars Game #59938829750:  Hold'em No Limit ($1/$2) - 2009/07/01 0:24:33 ET
Table 'CFkQcfWjKccZaZDf71FK+w' 6-max Seat #4 is the button
Seat 1: U2A5Hv6ib/5+gzO2wr7Z4w ($200 in chips)
Seat 2: X7GlkHF+lkbarCLuZ4Uf0w ($33 in chips)
Seat 4: e8nZKSbIdIO7e2NdQe/OFQ ($233.80 in chips)
Seat 5: 1njbh8TKSUF6l4V1XwGdcg ($218.80 in chips)
1njbh8TKSUF6l4V1XwGdcg: posts small blind $1
U2A5Hv6ib/5+gzO2wr7Z4w: posts big blind $2
*** HOLE CARDS ***
X7GlkHF+lkbarCLuZ4Uf0w: folds
e8nZKSbIdIO7e2NdQe/OFQ: folds
1njbh8TKSUF6l4V1XwGdcg: folds
U2A5Hv6ib/5+gzO2wr7Z4w collected $2 from pot
*** SUMMARY ***
Total pot $2 | Rake $0
Seat 1: U2A5Hv6ib/5+gzO2wr7Z4w (big blind) collected ($2)
Seat 2: X7GlkHF+lkbarCLuZ4Uf0w folded before Flop (didn't bet)
Seat 4: e8nZKSbIdIO7e2NdQe/OFQ (button) folded before Flop (didn't bet)
Seat 5: 1njbh8TKSUF6l4V1XwGdcg (small blind) folded before Flop



PokerStars Game #59938831974:  Hold'em No Limit ($1/$2) - 2009/07/01 0:24:36 ET
Table 'XP2sRSup+aRuwzx3vDZsDg' 6-max Seat #6 is the button
Seat 1: o9jamqIi6sTTRSqudgboRA ($232.75 in chips)
Seat 2: ygTTt5ehT4aF86q1a8/R+w ($100 in chips)
Seat 3: X7GlkHF+lkbarCLuZ4Uf0w ($39 in chips)
Seat 4: hCtfSY4dRapM2rhEFmS4Ug ($123 in chips)
Seat 5: 894kvCY4GHivBpqwizsecg ($113.45 in chips)
Seat 6: h7ppRQJTYBsHCbLMeW9T2g ($446.75 in chips)
o9jamqIi6sTTRSqudgboRA: posts small blind $1
ygTTt5ehT4aF86q1a8/R+w: posts big blind $2
*** HOLE CARDS ***
X7GlkHF+lkbarCLuZ4Uf0w: folds
hCtfSY4dRapM2rhEFmS4Ug: folds
894kvCY4GHivBpqwizsecg: calls $2
h7ppRQJTYBsHCbLMeW9T2g: folds
o9jamqIi6sTTRSqudgboRA: folds
ygTTt5ehT4aF86q1a8/R+w: checks
*** FLOP *** [3d Ks As]
ygTTt5ehT4aF86q1a8/R+w: checks
894kvCY4GHivBpqwizsecg: checks
*** TURN *** [3d Ks As] [Th]
ygTTt5ehT4aF86q1a8/R+w: checks
894kvCY4GHivBpqwizsecg: checks
*** RIVER *** [3d Ks As Th] [Qc]
ygTTt5ehT4aF86q1a8/R+w: checks
894kvCY4GHivBpqwizsecg: checks
*** SHOW DOWN ***
ygTTt5ehT4aF86q1a8/R+w: shows [2c 2d] (a pair of Deuces)
894kvCY4GHivBpqwizsecg: shows [8d Qd] (a pair of Queens)
894kvCY4GHivBpqwizsecg collected $4.75 from pot
*** SUMMARY ***
Total pot $5 | Rake $0.25
Board [3d Ks As Th Qc]
Seat 1: o9jamqIi6sTTRSqudgboRA (small blind) folded before Flop
Seat 2: ygTTt5ehT4aF86q1a8/R+w (big blind) showed [2c 2d] and lost with a pair of Deuces
Seat 3: X7GlkHF+lkbarCLuZ4Uf0w folded before Flop (didn't bet)
Seat 4: hCtfSY4dRapM2rhEFmS4Ug folded before Flop (didn't bet)
Seat 5: 894kvCY4GHivBpqwizsecg showed [8d Qd] and won ($4.75) with a pair of Queens
Seat 6: h7ppRQJTYBsHCbLMeW9T2g (button) folded before Flop (didn't bet)



PokerStars Game #59938831928:  Hold'em No Limit ($1/$2) - 2009/07/01 0:24:36 ET
Table 'aSf77Sj8QEnzcc0WaxVD4Q' 6-max Seat #3 is the button
Seat 1: 54yWzRRgS0oZ+S6LwZBxMQ ($37 in chips)
Seat 2: vkfxu8f/jMYKUk6Ly4eujw ($244.15 in chips)
Seat 3: 9dpyyjDTCed6nV7JhaUUpw ($204.30 in chips)
Seat 4: 513FcCI8jHyQy2VWoIQkMg ($200 in chips)
Seat 5: InmkdI6G8TzSj9NhcCSyPg ($247 in chips)
Seat 6: vkoJRf3gidxY1pPi0AFWww ($313.80 in chips)
513FcCI8jHyQy2VWoIQkMg: posts small blind $1
InmkdI6G8TzSj9NhcCSyPg: posts big blind $2
*** HOLE CARDS ***
vkoJRf3gidxY1pPi0AFWww: folds
54yWzRRgS0oZ+S6LwZBxMQ has timed out
54yWzRRgS0oZ+S6LwZBxMQ: folds
54yWzRRgS0oZ+S6LwZBxMQ is sitting out
vkfxu8f/jMYKUk6Ly4eujw: folds
9dpyyjDTCed6nV7JhaUUpw: folds
54yWzRRgS0oZ+S6LwZBxMQ has returned
513FcCI8jHyQy2VWoIQkMg: raises $4 to $6
InmkdI6G8TzSj9NhcCSyPg: folds
513FcCI8jHyQy2VWoIQkMg collected $4 from pot
*** SUMMARY ***
Total pot $4 | Rake $0
Seat 1: 54yWzRRgS0oZ+S6LwZBxMQ folded before Flop (didn't bet)
Seat 2: vkfxu8f/jMYKUk6Ly4eujw folded before Flop (didn't bet)
Seat 3: 9dpyyjDTCed6nV7JhaUUpw (button) folded before Flop (didn't bet)
Seat 4: 513FcCI8jHyQy2VWoIQkMg (small blind) collected ($4)
Seat 5: InmkdI6G8TzSj9NhcCSyPg (big blind) folded before Flop
Seat 6: vkoJRf3gidxY1pPi0AFWww folded before Flop (didn't bet)



PokerStars Game #59938831444:  Hold'em No Limit ($1/$2) - 2009/07/01 0:24:36 ET
Table 'OZyw34U4j4WtFFWsEHZQgQ' 2-max Seat #1 is the button
Seat 1: pVqEzK9wXlRMECnb1Zg4Zw ($76.90 in chips)
Seat 2: rAtTyvrJ8f1LaUh2O5U4nA ($45.70 in chips)
pVqEzK9wXlRMECnb1Zg4Zw: posts small blind $1
rAtTyvrJ8f1LaUh2O5U4nA: posts big blind $2
*** HOLE CARDS ***
pVqEzK9wXlRMECnb1Zg4Zw: raises $4 to $6
rAtTyvrJ8f1LaUh2O5U4nA: calls $4
*** FLOP *** [9h Jd Qs]
rAtTyvrJ8f1LaUh2O5U4nA: bets $6
pVqEzK9wXlRMECnb1Zg4Zw: calls $6
*** TURN *** [9h Jd Qs] [4d]
rAtTyvrJ8f1LaUh2O5U4nA: checks
pVqEzK9wXlRMECnb1Zg4Zw: checks
*** RIVER *** [9h Jd Qs 4d] [5h]
rAtTyvrJ8f1LaUh2O5U4nA: checks
pVqEzK9wXlRMECnb1Zg4Zw: checks
*** SHOW DOWN ***
rAtTyvrJ8f1LaUh2O5U4nA: shows [2h Jh] (a pair of Jacks)
pVqEzK9wXlRMECnb1Zg4Zw: mucks hand
rAtTyvrJ8f1LaUh2O5U4nA collected $23.50 from pot
*** SUMMARY ***
Total pot $24 | Rake $0.50
Board [9h Jd Qs 4d 5h]
Seat 1: pVqEzK9wXlRMECnb1Zg4Zw (button) (small blind) mucked
Seat 2: rAtTyvrJ8f1LaUh2O5U4nA (big blind) showed [2h Jh] and won ($23.50) with a pair of Jacks



PokerStars Game #59938835212:  Hold'em No Limit ($1/$2) - 2009/07/01 0:24:41 ET
Table 'ZzSIe0zTCDv+n6hfbY5tTg' 6-max Seat #5 is the button
Seat 2: B87ikIyZ/TzAVeXf38Ny0g ($203 in chips)
Seat 3: X7GlkHF+lkbarCLuZ4Uf0w ($63 in chips)
Seat 4: ky55L0pITYgYLeqFB9gP/Q ($190.40 in chips)
Seat 5: f2eTKbND+tM3kUw9o6WYWg ($103 in chips)
Seat 6: InmkdI6G8TzSj9NhcCSyPg ($200 in chips)
InmkdI6G8TzSj9NhcCSyPg: posts small blind $1
B87ikIyZ/TzAVeXf38Ny0g: posts big blind $2
*** HOLE CARDS ***
X7GlkHF+lkbarCLuZ4Uf0w: folds
ky55L0pITYgYLeqFB9gP/Q: raises $4 to $6
f2eTKbND+tM3kUw9o6WYWg: calls $6
InmkdI6G8TzSj9NhcCSyPg: folds
B87ikIyZ/TzAVeXf38Ny0g: folds
*** FLOP *** [Qd 9s Jc]
ky55L0pITYgYLeqFB9gP/Q: bets $8
f2eTKbND+tM3kUw9o6WYWg: raises $8 to $16
ky55L0pITYgYLeqFB9gP/Q: calls $8
*** TURN *** [Qd 9s Jc] [Ks]
ky55L0pITYgYLeqFB9gP/Q: checks
f2eTKbND+tM3kUw9o6WYWg: checks
*** RIVER *** [Qd 9s Jc Ks] [Th]
ky55L0pITYgYLeqFB9gP/Q: checks
f2eTKbND+tM3kUw9o6WYWg: bets $15
ky55L0pITYgYLeqFB9gP/Q: calls $15
*** SHOW DOWN ***
f2eTKbND+tM3kUw9o6WYWg: shows [Ah 9d] (a straight, Ten to Ace)
ky55L0pITYgYLeqFB9gP/Q: mucks hand
f2eTKbND+tM3kUw9o6WYWg collected $75 from pot
*** SUMMARY ***
Total pot $77 | Rake $2
Board [Qd 9s Jc Ks Th]
Seat 2: B87ikIyZ/TzAVeXf38Ny0g (big blind) folded before Flop
Seat 3: X7GlkHF+lkbarCLuZ4Uf0w folded before Flop (didn't bet)
Seat 4: ky55L0pITYgYLeqFB9gP/Q mucked
Seat 5: f2eTKbND+tM3kUw9o6WYWg (button) showed [Ah 9d] and won ($75) with a straight, Ten to Ace
Seat 6: InmkdI6G8TzSj9NhcCSyPg (small blind) folded before Flop



PokerStars Game #59938836164:  Hold'em No Limit ($1/$2) - 2009/07/01 0:24:43 ET
Table '5G1PjWSk2ALz0O/eqyYy/g' 2-max Seat #1 is the button
Seat 1: Z4HwehErEwzsv/noQlfUlg ($129.90 in chips)
Seat 2: v4dp1VoMhJV4zmCXtmG5LQ ($237.80 in chips)
Z4HwehErEwzsv/noQlfUlg: posts small blind $1
v4dp1VoMhJV4zmCXtmG5LQ: posts big blind $2
*** HOLE CARDS ***
Z4HwehErEwzsv/noQlfUlg: raises $4 to $6
v4dp1VoMhJV4zmCXtmG5LQ: folds
Z4HwehErEwzsv/noQlfUlg collected $4 from pot
Z4HwehErEwzsv/noQlfUlg: doesn't show hand
*** SUMMARY ***
Total pot $4 | Rake $0
Seat 1: Z4HwehErEwzsv/noQlfUlg (button) (small blind) collected ($4)
Seat 2: v4dp1VoMhJV4zmCXtmG5LQ (big blind) folded before Flop



PokerStars Game #59938837512:  Hold'em No Limit ($1/$2) - 2009/07/01 0:24:45 ET
Table 'jCW99a4MXoPgL0PwEZ4IuQ' 2-max Seat #1 is the button
Seat 1: t6Jd836OSEMbcRi7rfGp5g ($216.50 in chips)
Seat 2: bWN162Ep6lKyJ0MW6unz4w ($203.50 in chips)
t6Jd836OSEMbcRi7rfGp5g: posts small blind $1
bWN162Ep6lKyJ0MW6unz4w: posts big blind $2
*** HOLE CARDS ***
t6Jd836OSEMbcRi7rfGp5g: raises $4 to $6
bWN162Ep6lKyJ0MW6unz4w: folds
t6Jd836OSEMbcRi7rfGp5g collected $4 from pot
*** SUMMARY ***
Total pot $4 | Rake $0
Seat 1: t6Jd836OSEMbcRi7rfGp5g (button) (small blind) collected ($4)
Seat 2: bWN162Ep6lKyJ0MW6unz4w (big blind) folded before Flop



PokerStars Game #59938837336:  Hold'em No Limit ($1/$2) - 2009/07/01 0:24:45 ET
Table 'SF49/KQm8T4taMp6kb+HXA' 9-max Seat #1 is the button
Seat 1: l1bCLGuFqeFRwUfPsiDu/g ($287.95 in chips)
Seat 3: pCmk6FpSOLJ+85o1tLHIag ($96 in chips)
Seat 4: HffgoYm61KgkdMe/DYChIQ ($86.60 in chips)
Seat 5: Z3aYCZG/yXHYFjiWkGI5ug ($223.55 in chips)
Seat 6: M2ht6rIKOI/my9eh610Nlw ($225.40 in chips)
Seat 7: n2VAbLaE5qgKr5mA4W6v4w ($25 in chips)
Seat 8: 5iPk5MyO3KVu18Y8XCYfFQ ($74 in chips)
pCmk6FpSOLJ+85o1tLHIag: posts small blind $1
HffgoYm61KgkdMe/DYChIQ: posts big blind $2
/inIs/z/PcX+TniIFpaxpg: sits out
*** HOLE CARDS ***
Z3aYCZG/yXHYFjiWkGI5ug: folds
M2ht6rIKOI/my9eh610Nlw: raises $2 to $4
n2VAbLaE5qgKr5mA4W6v4w: calls $4
5iPk5MyO3KVu18Y8XCYfFQ: folds
l1bCLGuFqeFRwUfPsiDu/g: folds
pCmk6FpSOLJ+85o1tLHIag: folds
HffgoYm61KgkdMe/DYChIQ: raises $6 to $10
M2ht6rIKOI/my9eh610Nlw: folds
n2VAbLaE5qgKr5mA4W6v4w: raises $15 to $25 and is all-in
HffgoYm61KgkdMe/DYChIQ: calls $15
*** FLOP *** [2s Ah 9c]
*** TURN *** [2s Ah 9c] [3c]
*** RIVER *** [2s Ah 9c 3c] [As]
*** SHOW DOWN ***
HffgoYm61KgkdMe/DYChIQ: shows [9s 9h] (a full house, Nines full of Aces)
n2VAbLaE5qgKr5mA4W6v4w: mucks hand
HffgoYm61KgkdMe/DYChIQ collected $52.25 from pot
*** SUMMARY ***
Total pot $55 | Rake $2.75
Board [2s Ah 9c 3c As]
Seat 1: l1bCLGuFqeFRwUfPsiDu/g (button) folded before Flop (didn't bet)
Seat 3: pCmk6FpSOLJ+85o1tLHIag (small blind) folded before Flop
Seat 4: HffgoYm61KgkdMe/DYChIQ (big blind) showed [9s 9h] and won ($52.25) with a full house, Nines full of Aces
Seat 5: Z3aYCZG/yXHYFjiWkGI5ug folded before Flop (didn't bet)
Seat 6: M2ht6rIKOI/my9eh610Nlw folded before Flop
Seat 7: n2VAbLaE5qgKr5mA4W6v4w mucked
Seat 8: 5iPk5MyO3KVu18Y8XCYfFQ folded before Flop (didn't bet)



PokerStars Game #59938840266:  Hold'em No Limit ($1/$2) - 2009/07/01 0:24:49 ET
Table 'P/yCfYl1GfGsu/e6DxDy/A' 2-max Seat #2 is the button
Seat 1: 7fOCUy3x9hdkmXkkDNolGQ ($200 in chips)
Seat 2: RwDoM55ZeQuI2ADyJhOb2Q ($822 in chips)
RwDoM55ZeQuI2ADyJhOb2Q: posts small blind $1
7fOCUy3x9hdkmXkkDNolGQ said, "kleJFH'DS;LJ"
7fOCUy3x9hdkmXkkDNolGQ: posts big blind $2
*** HOLE CARDS ***
RwDoM55ZeQuI2ADyJhOb2Q: raises $4 to $6
7fOCUy3x9hdkmXkkDNolGQ: folds
RwDoM55ZeQuI2ADyJhOb2Q collected $4 from pot
RwDoM55ZeQuI2ADyJhOb2Q: doesn't show hand
*** SUMMARY ***
Total pot $4 | Rake $0
Seat 1: 7fOCUy3x9hdkmXkkDNolGQ (big blind) folded before Flop
Seat 2: RwDoM55ZeQuI2ADyJhOb2Q (button) (small blind) collected ($4)



PokerStars Game #59938840430:  Hold'em No Limit ($1/$2) - 2009/07/01 0:24:49 ET
Table 'uJ9juaXXg9yIcSU8amxaXQ' 6-max Seat #5 is the button
Seat 2: yynBOXUjw28V5kz84sxX4g ($136.05 in chips)
Seat 4: zNjJ/y4emmF+vzrCDd+ooA ($117.35 in chips)
Seat 5: aMZYAxFxWTQXE9aUus4sxg ($57.15 in chips)
Seat 6: XrFG4dK06RVKLlX32/pjcQ ($61.60 in chips)
XrFG4dK06RVKLlX32/pjcQ: posts small blind $1
yynBOXUjw28V5kz84sxX4g: posts big blind $2
*** HOLE CARDS ***
zNjJ/y4emmF+vzrCDd+ooA: calls $2
aMZYAxFxWTQXE9aUus4sxg: folds
XrFG4dK06RVKLlX32/pjcQ: calls $1
yynBOXUjw28V5kz84sxX4g: checks
*** FLOP *** [2c 5d 3h]
XrFG4dK06RVKLlX32/pjcQ: checks
yynBOXUjw28V5kz84sxX4g: checks
zNjJ/y4emmF+vzrCDd+ooA: bets $2
XrFG4dK06RVKLlX32/pjcQ: calls $2
yynBOXUjw28V5kz84sxX4g: calls $2
*** TURN *** [2c 5d 3h] [Qd]
XrFG4dK06RVKLlX32/pjcQ: bets $2
yynBOXUjw28V5kz84sxX4g: calls $2
zNjJ/y4emmF+vzrCDd+ooA: folds
*** RIVER *** [2c 5d 3h Qd] [7d]
XrFG4dK06RVKLlX32/pjcQ: bets $10
JsqOjN/eHz0uYVf/PyUJ6Q is connected
yynBOXUjw28V5kz84sxX4g: raises $18 to $28
JsqOjN/eHz0uYVf/PyUJ6Q has returned
XrFG4dK06RVKLlX32/pjcQ: folds
yynBOXUjw28V5kz84sxX4g collected $34.25 from pot
*** SUMMARY ***
Total pot $36 | Rake $1.75
Board [2c 5d 3h Qd 7d]
Seat 2: yynBOXUjw28V5kz84sxX4g (big blind) collected ($34.25)
Seat 4: zNjJ/y4emmF+vzrCDd+ooA folded on the Turn
Seat 5: aMZYAxFxWTQXE9aUus4sxg (button) folded before Flop (didn't bet)
Seat 6: XrFG4dK06RVKLlX32/pjcQ (small blind) folded on the River



PokerStars Game #59938840818:  Hold'em No Limit ($1/$2) - 2009/07/01 0:24:50 ET
Table 'CFkQcfWjKccZaZDf71FK+w' 6-max Seat #5 is the button
Seat 1: U2A5Hv6ib/5+gzO2wr7Z4w ($201 in chips)
Seat 2: X7GlkHF+lkbarCLuZ4Uf0w ($33 in chips)
Seat 4: e8nZKSbIdIO7e2NdQe/OFQ ($233.80 in chips)
Seat 5: 1njbh8TKSUF6l4V1XwGdcg ($217.80 in chips)
U2A5Hv6ib/5+gzO2wr7Z4w: posts small blind $1
X7GlkHF+lkbarCLuZ4Uf0w: posts big blind $2
*** HOLE CARDS ***
e8nZKSbIdIO7e2NdQe/OFQ: folds
1njbh8TKSUF6l4V1XwGdcg: folds
R5/GXj0PUdNkzHU6Omb/JA is connected
R5/GXj0PUdNkzHU6Omb/JA has returned
U2A5Hv6ib/5+gzO2wr7Z4w: folds
X7GlkHF+lkbarCLuZ4Uf0w collected $2 from pot
*** SUMMARY ***
Total pot $2 | Rake $0
Seat 1: U2A5Hv6ib/5+gzO2wr7Z4w (small blind) folded before Flop
Seat 2: X7GlkHF+lkbarCLuZ4Uf0w (big blind) collected ($2)
Seat 4: e8nZKSbIdIO7e2NdQe/OFQ folded before Flop (didn't bet)
Seat 5: 1njbh8TKSUF6l4V1XwGdcg (button) folded before Flop (didn't bet)



PokerStars Game #59938841260:  Hold'em No Limit ($1/$2) - 2009/07/01 0:24:50 ET
Table 'mGpP9StWRnoeiBDExc6Frg' 6-max Seat #3 is the button
Seat 1: zWFU82nxIRvzK4mKiL4m0Q ($60.15 in chips)
Seat 2: DQlskgG4OtLpF2MVxLwf4A ($308.85 in chips)
Seat 3: 3HrFUl+TAqSP1U00zz3P7A ($83.40 in chips)
Seat 4: qXDd0ZyMIse0OBu8pxeQ3Q ($219 in chips)
Seat 5: d1puGuVBE0fidn+5eRJ0tw ($164.70 in chips)
Seat 6: X7GlkHF+lkbarCLuZ4Uf0w ($43 in chips)
qXDd0ZyMIse0OBu8pxeQ3Q: posts small blind $1
d1puGuVBE0fidn+5eRJ0tw: posts big blind $2
*** HOLE CARDS ***
X7GlkHF+lkbarCLuZ4Uf0w: folds
zWFU82nxIRvzK4mKiL4m0Q: calls $2
DQlskgG4OtLpF2MVxLwf4A: calls $2
3HrFUl+TAqSP1U00zz3P7A: folds
qXDd0ZyMIse0OBu8pxeQ3Q: folds
d1puGuVBE0fidn+5eRJ0tw: checks
*** FLOP *** [Td 2s 9c]
d1puGuVBE0fidn+5eRJ0tw: checks
zWFU82nxIRvzK4mKiL4m0Q: checks
DQlskgG4OtLpF2MVxLwf4A: checks
*** TURN *** [Td 2s 9c] [4h]
d1puGuVBE0fidn+5eRJ0tw: bets $2
zWFU82nxIRvzK4mKiL4m0Q: calls $2
DQlskgG4OtLpF2MVxLwf4A: folds
*** RIVER *** [Td 2s 9c 4h] [9s]
d1puGuVBE0fidn+5eRJ0tw: bets $2
zWFU82nxIRvzK4mKiL4m0Q: calls $2
*** SHOW DOWN ***
d1puGuVBE0fidn+5eRJ0tw: shows [6h Tc] (two pair, Tens and Nines)
zWFU82nxIRvzK4mKiL4m0Q: mucks hand
d1puGuVBE0fidn+5eRJ0tw collected $14.30 from pot
*** SUMMARY ***
Total pot $15 | Rake $0.70
Board [Td 2s 9c 4h 9s]
Seat 1: zWFU82nxIRvzK4mKiL4m0Q mucked
Seat 2: DQlskgG4OtLpF2MVxLwf4A folded on the Turn
Seat 3: 3HrFUl+TAqSP1U00zz3P7A (button) folded before Flop (didn't bet)
Seat 4: qXDd0ZyMIse0OBu8pxeQ3Q (small blind) folded before Flop
Seat 5: d1puGuVBE0fidn+5eRJ0tw (big blind) showed [6h Tc] and won ($14.30) with two pair, Tens and Nines
Seat 6: X7GlkHF+lkbarCLuZ4Uf0w folded before Flop (didn't bet)



PokerStars Game #59938841786:  Hold'em No Limit ($1/$2) - 2009/07/01 0:24:51 ET
Table 'ztv6V3FN2bQ9nmJPPdx6nQ' 6-max Seat #5 is the button
Seat 1: ek1hig03QiyONDHXvgqteQ ($320.35 in chips)
Seat 2: 5Y+ZGWLI4gnlpApDX5vy1A ($269.45 in chips)
Seat 3: Z55K9DbCHCUi6UaztIHi6g ($101.45 in chips)
Seat 4: vVSUvlW/pvneUNUHDgyXgw ($200 in chips)
Seat 5: sTPOWERd9HWPCNrDBwsVjA ($214.40 in chips)
Seat 6: mfy7uGZcqA2PVQqEVbJ7+g ($199.75 in chips)
mfy7uGZcqA2PVQqEVbJ7+g: posts small blind $1
ek1hig03QiyONDHXvgqteQ: posts big blind $2
*** HOLE CARDS ***
5Y+ZGWLI4gnlpApDX5vy1A: folds
Z55K9DbCHCUi6UaztIHi6g: folds
vVSUvlW/pvneUNUHDgyXgw: folds
sTPOWERd9HWPCNrDBwsVjA: folds
mfy7uGZcqA2PVQqEVbJ7+g: raises $5 to $7
ek1hig03QiyONDHXvgqteQ: folds
mfy7uGZcqA2PVQqEVbJ7+g collected $4 from pot
mfy7uGZcqA2PVQqEVbJ7+g: doesn't show hand
*** SUMMARY ***
Total pot $4 | Rake $0
Seat 1: ek1hig03QiyONDHXvgqteQ (big blind) folded before Flop
Seat 2: 5Y+ZGWLI4gnlpApDX5vy1A folded before Flop (didn't bet)
Seat 3: Z55K9DbCHCUi6UaztIHi6g folded before Flop (didn't bet)
Seat 4: vVSUvlW/pvneUNUHDgyXgw folded before Flop (didn't bet)
Seat 5: sTPOWERd9HWPCNrDBwsVjA (button) folded before Flop (didn't bet)
Seat 6: mfy7uGZcqA2PVQqEVbJ7+g (small blind) collected ($4)



PokerStars Game #59938841652:  Hold'em No Limit ($1/$2) - 2009/07/01 0:24:51 ET
Table '5G1PjWSk2ALz0O/eqyYy/g' 2-max Seat #2 is the button
Seat 1: Z4HwehErEwzsv/noQlfUlg ($131.90 in chips)
Seat 2: v4dp1VoMhJV4zmCXtmG5LQ ($235.80 in chips)
v4dp1VoMhJV4zmCXtmG5LQ: posts small blind $1
Z4HwehErEwzsv/noQlfUlg: posts big blind $2
*** HOLE CARDS ***
v4dp1VoMhJV4zmCXtmG5LQ: raises $4 to $6
Z4HwehErEwzsv/noQlfUlg: raises $6 to $12
v4dp1VoMhJV4zmCXtmG5LQ: calls $6
*** FLOP *** [9c Td 7c]
Z4HwehErEwzsv/noQlfUlg: checks
v4dp1VoMhJV4zmCXtmG5LQ: checks
*** TURN *** [9c Td 7c] [5s]
Z4HwehErEwzsv/noQlfUlg: bets $25
v4dp1VoMhJV4zmCXtmG5LQ: folds
Z4HwehErEwzsv/noQlfUlg collected $23.50 from pot
Z4HwehErEwzsv/noQlfUlg: doesn't show hand
*** SUMMARY ***
Total pot $24 | Rake $0.50
Board [9c Td 7c 5s]
Seat 1: Z4HwehErEwzsv/noQlfUlg (big blind) collected ($23.50)
Seat 2: v4dp1VoMhJV4zmCXtmG5LQ (button) (small blind) folded on the Turn



PokerStars Game #59938841332:  Hold'em No Limit ($1/$2) - 2009/07/01 0:24:51 ET
Table 'G1Oqdy4Pqdb5gtx40rUBzA' 6-max Seat #4 is the button
Seat 1: bz8Aw6kfX2xUq2sOyZlUCQ ($77.85 in chips)
Seat 2: IzslX/oV8DoDQfxCV/3+kg ($464.15 in chips)
Seat 3: lE+RUsc9cdVV9eEi8uytew ($194.15 in chips)
Seat 4: B87ikIyZ/TzAVeXf38Ny0g ($200.80 in chips)
bz8Aw6kfX2xUq2sOyZlUCQ: posts small blind $1
IzslX/oV8DoDQfxCV/3+kg: posts big blind $2
*** HOLE CARDS ***
lE+RUsc9cdVV9eEi8uytew: calls $2
B87ikIyZ/TzAVeXf38Ny0g: folds
bz8Aw6kfX2xUq2sOyZlUCQ: folds
IzslX/oV8DoDQfxCV/3+kg: checks
*** FLOP *** [6s Jc 9s]
IzslX/oV8DoDQfxCV/3+kg: checks
lE+RUsc9cdVV9eEi8uytew: bets $6
IzslX/oV8DoDQfxCV/3+kg: folds
lE+RUsc9cdVV9eEi8uytew collected $4.75 from pot
lE+RUsc9cdVV9eEi8uytew: doesn't show hand
*** SUMMARY ***
Total pot $5 | Rake $0.25
Board [6s Jc 9s]
Seat 1: bz8Aw6kfX2xUq2sOyZlUCQ (small blind) folded before Flop
Seat 2: IzslX/oV8DoDQfxCV/3+kg (big blind) folded on the Flop
Seat 3: lE+RUsc9cdVV9eEi8uytew collected ($4.75)
Seat 4: B87ikIyZ/TzAVeXf38Ny0g (button) folded before Flop (didn't bet)



PokerStars Game #59938844424:  Hold'em No Limit ($1/$2) - 2009/07/01 0:24:55 ET
Table 'gftD4mDF7mIFKvSrIyaRbw' 9-max Seat #3 is the button
Seat 2: CKDJ8bJWIRDDBziHsebH5w ($145.45 in chips)
Seat 3: CUZwDpLTQKhzarPe+JCLOQ ($200 in chips)
Seat 4: eeMEdaNqHXOk6uYL+zQnAA ($80.10 in chips)
Seat 5: mpsfNtnMVDqQHTe92AhIdw ($289.20 in chips)
Seat 6: 2NvwF8W2nzsbS+G//yLAbQ ($41.90 in chips)
Seat 7: 5iPk5MyO3KVu18Y8XCYfFQ ($49.65 in chips)
Seat 8: R/wPwjEcvTU2fxPXxn/XgQ ($76.55 in chips)
Seat 9: F7m34OOfAQ7annesMHVjKw ($225.30 in chips)
eeMEdaNqHXOk6uYL+zQnAA: posts small blind $1
mpsfNtnMVDqQHTe92AhIdw: posts big blind $2
TAfo4veNRaRlzDXMMYS3Jg has timed out while disconnected
TAfo4veNRaRlzDXMMYS3Jg: is sitting out
*** HOLE CARDS ***
2NvwF8W2nzsbS+G//yLAbQ: calls $2
5iPk5MyO3KVu18Y8XCYfFQ: raises $8 to $10
R/wPwjEcvTU2fxPXxn/XgQ: folds
F7m34OOfAQ7annesMHVjKw: folds
CKDJ8bJWIRDDBziHsebH5w: folds
CUZwDpLTQKhzarPe+JCLOQ: folds
eeMEdaNqHXOk6uYL+zQnAA: folds
mpsfNtnMVDqQHTe92AhIdw: folds
2NvwF8W2nzsbS+G//yLAbQ: raises $12 to $22
5iPk5MyO3KVu18Y8XCYfFQ: raises $27.65 to $49.65 and is all-in
2NvwF8W2nzsbS+G//yLAbQ: calls $19.90 and is all-in
*** FLOP *** [Qh 3s 3d]
*** TURN *** [Qh 3s 3d] [7h]
*** RIVER *** [Qh 3s 3d 7h] [9h]
*** SHOW DOWN ***
2NvwF8W2nzsbS+G//yLAbQ: shows [Qd Qs] (a full house, Queens full of Threes)
5iPk5MyO3KVu18Y8XCYfFQ: mucks hand
2NvwF8W2nzsbS+G//yLAbQ collected $83.80 from pot
*** SUMMARY ***
Total pot $86.80 | Rake $3
Board [Qh 3s 3d 7h 9h]
Seat 2: CKDJ8bJWIRDDBziHsebH5w folded before Flop (didn't bet)
Seat 3: CUZwDpLTQKhzarPe+JCLOQ (button) folded before Flop (didn't bet)
Seat 4: eeMEdaNqHXOk6uYL+zQnAA (small blind) folded before Flop
Seat 5: mpsfNtnMVDqQHTe92AhIdw (big blind) folded before Flop
Seat 6: 2NvwF8W2nzsbS+G//yLAbQ showed [Qd Qs] and won ($83.80) with a full house, Queens full of Threes
Seat 7: 5iPk5MyO3KVu18Y8XCYfFQ mucked
Seat 8: R/wPwjEcvTU2fxPXxn/XgQ folded before Flop (didn't bet)
Seat 9: F7m34OOfAQ7annesMHVjKw folded before Flop (didn't bet)



PokerStars Game #59938845134:  Hold'em No Limit ($1/$2) - 2009/07/01 0:24:56 ET
Table 'on4i1U1lCRmxsduFD3xiSg' 9-max Seat #6 is the button
Seat 1: so5k3vFDmokh2q3dImJ1GQ ($108 in chips)
Seat 2: yZYrOeNDxQxkzpbgKX1bng ($33.25 in chips)
Seat 3: 5iPk5MyO3KVu18Y8XCYfFQ ($58.20 in chips)
Seat 4: Z3aYCZG/yXHYFjiWkGI5ug ($527.10 in chips)
Seat 5: QHxJjpVYwitg9krW6wZgJA ($200 in chips)
Seat 6: CUZwDpLTQKhzarPe+JCLOQ ($214.55 in chips)
Seat 7: xD4ElYxz6Ollzmam8BmMCw ($247 in chips)
Seat 8: cdC54j9fGGojcbzWB5PgzA ($200 in chips)
Seat 9: iMe5yhc+1BaiIPHet3NMrA ($200 in chips)
xD4ElYxz6Ollzmam8BmMCw: posts small blind $1
cdC54j9fGGojcbzWB5PgzA: posts big blind $2
*** HOLE CARDS ***
iMe5yhc+1BaiIPHet3NMrA: folds
so5k3vFDmokh2q3dImJ1GQ: folds
yZYrOeNDxQxkzpbgKX1bng: folds
5iPk5MyO3KVu18Y8XCYfFQ: folds
Z3aYCZG/yXHYFjiWkGI5ug: folds
QHxJjpVYwitg9krW6wZgJA: folds
CUZwDpLTQKhzarPe+JCLOQ: folds
xD4ElYxz6Ollzmam8BmMCw is disconnected
xD4ElYxz6Ollzmam8BmMCw has timed out while disconnected
xD4ElYxz6Ollzmam8BmMCw: folds
xD4ElYxz6Ollzmam8BmMCw is sitting out
cdC54j9fGGojcbzWB5PgzA collected $2 from pot
*** SUMMARY ***
Total pot $2 | Rake $0
Seat 1: so5k3vFDmokh2q3dImJ1GQ folded before Flop (didn't bet)
Seat 2: yZYrOeNDxQxkzpbgKX1bng folded before Flop (didn't bet)
Seat 3: 5iPk5MyO3KVu18Y8XCYfFQ folded before Flop (didn't bet)
Seat 4: Z3aYCZG/yXHYFjiWkGI5ug folded before Flop (didn't bet)
Seat 5: QHxJjpVYwitg9krW6wZgJA folded before Flop (didn't bet)
Seat 6: CUZwDpLTQKhzarPe+JCLOQ (button) folded before Flop (didn't bet)
Seat 7: xD4ElYxz6Ollzmam8BmMCw (small blind) folded before Flop
Seat 8: cdC54j9fGGojcbzWB5PgzA (big blind) collected ($2)
Seat 9: iMe5yhc+1BaiIPHet3NMrA folded before Flop (didn't bet)



PokerStars Game #59938845228:  Hold'em No Limit ($1/$2) - 2009/07/01 0:24:56 ET
Table 'YqGfR5eHfMeSjb9a+QU9rg' 9-max Seat #5 is the button
Seat 1: qCBuzVnLcBR29snMAHq9PA ($115.90 in chips)
Seat 2: W3Nqt1GWlTi9tXQXMNEvgw ($259.75 in chips)
Seat 3: /gll27k+xWYV7Fbki0lFDQ ($110.85 in chips)
Seat 4: QHxJjpVYwitg9krW6wZgJA ($200 in chips)
Seat 5: MOBMOMQRN/z+fiGXGnZojw ($221.95 in chips)
Seat 6: 5iPk5MyO3KVu18Y8XCYfFQ ($43 in chips)
Seat 7: tAhiYXx1KvTp5hhBamTYfQ ($203.05 in chips)
Seat 8: JnV3SM2D6dAFYyGZHHpvrg ($97 in chips)
Seat 9: Hc2itIxwbi1lwa+DAYYQGg ($37 in chips)
5iPk5MyO3KVu18Y8XCYfFQ: posts small blind $1
tAhiYXx1KvTp5hhBamTYfQ: posts big blind $2
*** HOLE CARDS ***
JnV3SM2D6dAFYyGZHHpvrg: folds
Hc2itIxwbi1lwa+DAYYQGg: folds
qCBuzVnLcBR29snMAHq9PA: folds
W3Nqt1GWlTi9tXQXMNEvgw: raises $2 to $4
Hc2itIxwbi1lwa+DAYYQGg leaves the table
/gll27k+xWYV7Fbki0lFDQ: folds
/inIs/z/PcX+TniIFpaxpg joins the table at seat #9
QHxJjpVYwitg9krW6wZgJA: folds
MOBMOMQRN/z+fiGXGnZojw: folds
5iPk5MyO3KVu18Y8XCYfFQ: folds
tAhiYXx1KvTp5hhBamTYfQ: calls $2
*** FLOP *** [5c 2c 9d]
tAhiYXx1KvTp5hhBamTYfQ: checks
W3Nqt1GWlTi9tXQXMNEvgw: checks
*** TURN *** [5c 2c 9d] [2h]
tAhiYXx1KvTp5hhBamTYfQ: bets $4
W3Nqt1GWlTi9tXQXMNEvgw: folds
tAhiYXx1KvTp5hhBamTYfQ collected $8.55 from pot
tAhiYXx1KvTp5hhBamTYfQ: doesn't show hand
*** SUMMARY ***
Total pot $9 | Rake $0.45
Board [5c 2c 9d 2h]
Seat 1: qCBuzVnLcBR29snMAHq9PA folded before Flop (didn't bet)
Seat 2: W3Nqt1GWlTi9tXQXMNEvgw folded on the Turn
Seat 3: /gll27k+xWYV7Fbki0lFDQ folded before Flop (didn't bet)
Seat 4: QHxJjpVYwitg9krW6wZgJA folded before Flop (didn't bet)
Seat 5: MOBMOMQRN/z+fiGXGnZojw (button) folded before Flop (didn't bet)
Seat 6: 5iPk5MyO3KVu18Y8XCYfFQ (small blind) folded before Flop
Seat 7: tAhiYXx1KvTp5hhBamTYfQ (big blind) collected ($8.55)
Seat 8: JnV3SM2D6dAFYyGZHHpvrg folded before Flop (didn't bet)
Seat 9: Hc2itIxwbi1lwa+DAYYQGg folded before Flop (didn't bet)



PokerStars Game #59938845034:  Hold'em No Limit ($1/$2) - 2009/07/01 0:24:56 ET
Table 'OZyw34U4j4WtFFWsEHZQgQ' 2-max Seat #2 is the button
Seat 1: pVqEzK9wXlRMECnb1Zg4Zw ($64.90 in chips)
Seat 2: rAtTyvrJ8f1LaUh2O5U4nA ($57.20 in chips)
rAtTyvrJ8f1LaUh2O5U4nA: posts small blind $1
pVqEzK9wXlRMECnb1Zg4Zw: posts big blind $2
*** HOLE CARDS ***
rAtTyvrJ8f1LaUh2O5U4nA: folds
pVqEzK9wXlRMECnb1Zg4Zw collected $2 from pot
pVqEzK9wXlRMECnb1Zg4Zw: doesn't show hand
*** SUMMARY ***
Total pot $2 | Rake $0
Seat 1: pVqEzK9wXlRMECnb1Zg4Zw (big blind) collected ($2)
Seat 2: rAtTyvrJ8f1LaUh2O5U4nA (button) (small blind) folded before Flop



PokerStars Game #59938845256:  Hold'em No Limit ($1/$2) - 2009/07/01 0:24:56 ET
Table 'jCW99a4MXoPgL0PwEZ4IuQ' 2-max Seat #2 is the button
Seat 1: t6Jd836OSEMbcRi7rfGp5g ($218.50 in chips)
Seat 2: bWN162Ep6lKyJ0MW6unz4w ($201.50 in chips)
bWN162Ep6lKyJ0MW6unz4w: posts small blind $1
t6Jd836OSEMbcRi7rfGp5g: posts big blind $2
*** HOLE CARDS ***
bWN162Ep6lKyJ0MW6unz4w: raises $4 to $6
t6Jd836OSEMbcRi7rfGp5g: calls $4
*** FLOP *** [8h 6c 7d]
t6Jd836OSEMbcRi7rfGp5g: checks
bWN162Ep6lKyJ0MW6unz4w: bets $8
t6Jd836OSEMbcRi7rfGp5g: folds
bWN162Ep6lKyJ0MW6unz4w collected $11.50 from pot
bWN162Ep6lKyJ0MW6unz4w: doesn't show hand
*** SUMMARY ***
Total pot $12 | Rake $0.50
Board [8h 6c 7d]
Seat 1: t6Jd836OSEMbcRi7rfGp5g (big blind) folded on the Flop
Seat 2: bWN162Ep6lKyJ0MW6unz4w (button) (small blind) collected ($11.50)



PokerStars Game #59938845144:  Hold'em No Limit ($1/$2) - 2009/07/01 0:24:56 ET
Table 'NmY84NAf9Mh0ckAckHnh5g' 2-max Seat #2 is the button
Seat 1: 6hvg964TSqZ3AL/0XK9aVQ ($509.95 in chips)
Seat 2: RwDoM55ZeQuI2ADyJhOb2Q ($333 in chips)
RwDoM55ZeQuI2ADyJhOb2Q: posts small blind $1
6hvg964TSqZ3AL/0XK9aVQ: posts big blind $2
*** HOLE CARDS ***
RwDoM55ZeQuI2ADyJhOb2Q: raises $4 to $6
6hvg964TSqZ3AL/0XK9aVQ: folds
RwDoM55ZeQuI2ADyJhOb2Q collected $4 from pot
RwDoM55ZeQuI2ADyJhOb2Q: doesn't show hand
*** SUMMARY ***
Total pot $4 | Rake $0
Seat 1: 6hvg964TSqZ3AL/0XK9aVQ (big blind) folded before Flop
Seat 2: RwDoM55ZeQuI2ADyJhOb2Q (button) (small blind) collected ($4)



PokerStars Game #59938845436:  Hold'em No Limit ($1/$2) - 2009/07/01 0:24:57 ET
Table 'eyAQSIlgc2o1Jxvbve4WGg' 9-max Seat #7 is the button
Seat 1: UZEsV9yKUMqmpYPiOFpaZw ($73 in chips)
Seat 2: g7gL2NLJCdZPPV399WKT1w ($48 in chips)
Seat 4: miAHPEBdznuHNzK6YM3hRA ($141.55 in chips)
Seat 5: JnV3SM2D6dAFYyGZHHpvrg ($94 in chips)
Seat 6: IikcENBHwoT7snSvBPSc7Q ($148.60 in chips)
Seat 7: QHxJjpVYwitg9krW6wZgJA ($207.35 in chips)
Seat 8: 5iPk5MyO3KVu18Y8XCYfFQ ($36 in chips)
Seat 9: GX1heJ+DSsvm7gzSPsYhhQ ($42 in chips)
5iPk5MyO3KVu18Y8XCYfFQ: posts small blind $1
GX1heJ+DSsvm7gzSPsYhhQ: posts big blind $2
*** HOLE CARDS ***
UZEsV9yKUMqmpYPiOFpaZw: folds
g7gL2NLJCdZPPV399WKT1w: folds
miAHPEBdznuHNzK6YM3hRA: calls $2
JnV3SM2D6dAFYyGZHHpvrg: folds
IikcENBHwoT7snSvBPSc7Q: calls $2
QHxJjpVYwitg9krW6wZgJA: calls $2
5iPk5MyO3KVu18Y8XCYfFQ: folds
GX1heJ+DSsvm7gzSPsYhhQ: checks
*** FLOP *** [Kh 4h Ac]
GX1heJ+DSsvm7gzSPsYhhQ: checks
miAHPEBdznuHNzK6YM3hRA: checks
IikcENBHwoT7snSvBPSc7Q: checks
QHxJjpVYwitg9krW6wZgJA: bets $6
GX1heJ+DSsvm7gzSPsYhhQ: folds
miAHPEBdznuHNzK6YM3hRA: folds
IikcENBHwoT7snSvBPSc7Q: folds
QHxJjpVYwitg9krW6wZgJA collected $8.55 from pot
QHxJjpVYwitg9krW6wZgJA: doesn't show hand
*** SUMMARY ***
Total pot $9 | Rake $0.45
Board [Kh 4h Ac]
Seat 1: UZEsV9yKUMqmpYPiOFpaZw folded before Flop (didn't bet)
Seat 2: g7gL2NLJCdZPPV399WKT1w folded before Flop (didn't bet)
Seat 4: miAHPEBdznuHNzK6YM3hRA folded on the Flop
Seat 5: JnV3SM2D6dAFYyGZHHpvrg folded before Flop (didn't bet)
Seat 6: IikcENBHwoT7snSvBPSc7Q folded on the Flop
Seat 7: QHxJjpVYwitg9krW6wZgJA (button) collected ($8.55)
Seat 8: 5iPk5MyO3KVu18Y8XCYfFQ (small blind) folded before Flop
Seat 9: GX1heJ+DSsvm7gzSPsYhhQ (big blind) folded on the Flop



PokerStars Game #59938848870:  Hold'em No Limit ($1/$2) - 2009/07/01 0:25:02 ET
Table 'rKeCh+eBn4RNvybCUYkoTQ' 9-max Seat #7 is the button
Seat 1: De9g+AYjo0DN6C/+iT/nsg ($246.30 in chips)
Seat 2: oEFhmBFI/N1eUlbVXORRnw ($192.65 in chips)
Seat 3: R9FzbEg1XYsiOty4kvbqhg ($142.30 in chips)
Seat 4: x/sLO+9OHvhcHLxOgSmnOg ($56.75 in chips)
Seat 5: iuQs2eTwwwpiBYdCIQ/ogA ($155.45 in chips)
Seat 7: U+Qo1rnyH4lm7ehksiWi7w ($59.20 in chips)
Seat 8: pN/Ip0ePsUVIdUlGgLrkUw ($224.70 in chips)
Seat 9: SZnYUzONNVlDaSCSt67hQA ($73.80 in chips)
pN/Ip0ePsUVIdUlGgLrkUw: posts small blind $1
SZnYUzONNVlDaSCSt67hQA: posts big blind $2
*** HOLE CARDS ***
De9g+AYjo0DN6C/+iT/nsg: folds
De9g+AYjo0DN6C/+iT/nsg leaves the table
oEFhmBFI/N1eUlbVXORRnw: folds
oEFhmBFI/N1eUlbVXORRnw leaves the table
R9FzbEg1XYsiOty4kvbqhg: raises $4 to $6
/inIs/z/PcX+TniIFpaxpg joins the table at seat #1
x/sLO+9OHvhcHLxOgSmnOg has timed out
x/sLO+9OHvhcHLxOgSmnOg: folds
x/sLO+9OHvhcHLxOgSmnOg is sitting out
GX1heJ+DSsvm7gzSPsYhhQ joins the table at seat #2
iuQs2eTwwwpiBYdCIQ/ogA has timed out
iuQs2eTwwwpiBYdCIQ/ogA: folds
iuQs2eTwwwpiBYdCIQ/ogA is sitting out
U+Qo1rnyH4lm7ehksiWi7w: folds
pN/Ip0ePsUVIdUlGgLrkUw: folds
SZnYUzONNVlDaSCSt67hQA: folds
R9FzbEg1XYsiOty4kvbqhg collected $5 from pot
R9FzbEg1XYsiOty4kvbqhg: doesn't show hand
*** SUMMARY ***
Total pot $5 | Rake $0
Seat 1: De9g+AYjo0DN6C/+iT/nsg folded before Flop (didn't bet)
Seat 2: oEFhmBFI/N1eUlbVXORRnw folded before Flop (didn't bet)
Seat 3: R9FzbEg1XYsiOty4kvbqhg collected ($5)
Seat 4: x/sLO+9OHvhcHLxOgSmnOg folded before Flop (didn't bet)
Seat 5: iuQs2eTwwwpiBYdCIQ/ogA folded before Flop (didn't bet)
Seat 7: U+Qo1rnyH4lm7ehksiWi7w (button) folded before Flop (didn't bet)
Seat 8: pN/Ip0ePsUVIdUlGgLrkUw (small blind) folded before Flop
Seat 9: SZnYUzONNVlDaSCSt67hQA (big blind) folded before Flop



PokerStars Game #59938848700:  Hold'em No Limit ($1/$2) - 2009/07/01 0:25:02 ET
Table 'OZyw34U4j4WtFFWsEHZQgQ' 2-max Seat #1 is the button
Seat 1: pVqEzK9wXlRMECnb1Zg4Zw ($65.90 in chips)
Seat 2: rAtTyvrJ8f1LaUh2O5U4nA ($56.20 in chips)
pVqEzK9wXlRMECnb1Zg4Zw: posts small blind $1
rAtTyvrJ8f1LaUh2O5U4nA: posts big blind $2
*** HOLE CARDS ***
pVqEzK9wXlRMECnb1Zg4Zw: folds
rAtTyvrJ8f1LaUh2O5U4nA collected $2 from pot
*** SUMMARY ***
Total pot $2 | Rake $0
Seat 1: pVqEzK9wXlRMECnb1Zg4Zw (button) (small blind) folded before Flop
Seat 2: rAtTyvrJ8f1LaUh2O5U4nA (big blind) collected ($2)



PokerStars Game #59938850016:  Hold'em No Limit ($1/$2) - 2009/07/01 0:25:03 ET
Table 'P/yCfYl1GfGsu/e6DxDy/A' 2-max Seat #1 is the button
Seat 1: 7fOCUy3x9hdkmXkkDNolGQ ($200 in chips)
Seat 2: RwDoM55ZeQuI2ADyJhOb2Q ($824 in chips)
7fOCUy3x9hdkmXkkDNolGQ: posts small blind $1
RwDoM55ZeQuI2ADyJhOb2Q: posts big blind $2
*** HOLE CARDS ***
7fOCUy3x9hdkmXkkDNolGQ: raises $4 to $6
RwDoM55ZeQuI2ADyJhOb2Q: folds
7fOCUy3x9hdkmXkkDNolGQ collected $4 from pot
7fOCUy3x9hdkmXkkDNolGQ: doesn't show hand
*** SUMMARY ***
Total pot $4 | Rake $0
Seat 1: 7fOCUy3x9hdkmXkkDNolGQ (button) (small blind) collected ($4)
Seat 2: RwDoM55ZeQuI2ADyJhOb2Q (big blind) folded before Flop



PokerStars Game #59938850282:  Hold'em No Limit ($1/$2) - 2009/07/01 0:25:04 ET
Table 'NmY84NAf9Mh0ckAckHnh5g' 2-max Seat #1 is the button
Seat 1: 6hvg964TSqZ3AL/0XK9aVQ ($507.95 in chips)
Seat 2: RwDoM55ZeQuI2ADyJhOb2Q ($335 in chips)
6hvg964TSqZ3AL/0XK9aVQ: posts small blind $1
RwDoM55ZeQuI2ADyJhOb2Q: posts big blind $2
*** HOLE CARDS ***
6hvg964TSqZ3AL/0XK9aVQ: folds
RwDoM55ZeQuI2ADyJhOb2Q collected $2 from pot
RwDoM55ZeQuI2ADyJhOb2Q: doesn't show hand
*** SUMMARY ***
Total pot $2 | Rake $0
Seat 1: 6hvg964TSqZ3AL/0XK9aVQ (button) (small blind) folded before Flop
Seat 2: RwDoM55ZeQuI2ADyJhOb2Q (big blind) collected ($2)



PokerStars Game #59938852280:  Hold'em No Limit ($1/$2) - 2009/07/01 0:25:07 ET
Table 'W9UeSV0aoPjh5SFSxM8jUQ' 9-max Seat #8 is the button
Seat 1: cdC54j9fGGojcbzWB5PgzA ($204.60 in chips)
Seat 2: iMe5yhc+1BaiIPHet3NMrA ($316.75 in chips)
Seat 3: TAfo4veNRaRlzDXMMYS3Jg ($37 in chips)
Seat 4: De9g+AYjo0DN6C/+iT/nsg ($286.10 in chips)
Seat 5: CUZwDpLTQKhzarPe+JCLOQ ($200 in chips)
Seat 7: 4Cl43Q1TYQL8wn1NSCUkaw ($43.60 in chips)
Seat 8: GX1heJ+DSsvm7gzSPsYhhQ ($39.80 in chips)
Seat 9: U2A5Hv6ib/5+gzO2wr7Z4w ($395 in chips)
U2A5Hv6ib/5+gzO2wr7Z4w: posts small blind $1
cdC54j9fGGojcbzWB5PgzA: posts big blind $2
*** HOLE CARDS ***
iMe5yhc+1BaiIPHet3NMrA: calls $2
TAfo4veNRaRlzDXMMYS3Jg has timed out while disconnected
TAfo4veNRaRlzDXMMYS3Jg: folds
TAfo4veNRaRlzDXMMYS3Jg is sitting out
De9g+AYjo0DN6C/+iT/nsg: folds
CUZwDpLTQKhzarPe+JCLOQ: folds
4Cl43Q1TYQL8wn1NSCUkaw: calls $2
GX1heJ+DSsvm7gzSPsYhhQ: calls $2
MXxB6weBWzZyAhRZb+/KVg has returned
U2A5Hv6ib/5+gzO2wr7Z4w: folds
cdC54j9fGGojcbzWB5PgzA: checks
*** FLOP *** [Ah Qs 9h]
cdC54j9fGGojcbzWB5PgzA: checks
iMe5yhc+1BaiIPHet3NMrA: checks
4Cl43Q1TYQL8wn1NSCUkaw: checks
GX1heJ+DSsvm7gzSPsYhhQ: checks
*** TURN *** [Ah Qs 9h] [7d]
TAfo4veNRaRlzDXMMYS3Jg is connected
cdC54j9fGGojcbzWB5PgzA: checks
iMe5yhc+1BaiIPHet3NMrA: checks
4Cl43Q1TYQL8wn1NSCUkaw: checks
TAfo4veNRaRlzDXMMYS3Jg has returned
GX1heJ+DSsvm7gzSPsYhhQ: checks
*** RIVER *** [Ah Qs 9h 7d] [4h]
cdC54j9fGGojcbzWB5PgzA: checks
iMe5yhc+1BaiIPHet3NMrA: checks
4Cl43Q1TYQL8wn1NSCUkaw: bets $4
GX1heJ+DSsvm7gzSPsYhhQ: folds
cdC54j9fGGojcbzWB5PgzA: folds
iMe5yhc+1BaiIPHet3NMrA: folds
4Cl43Q1TYQL8wn1NSCUkaw collected $8.55 from pot
*** SUMMARY ***
Total pot $9 | Rake $0.45
Board [Ah Qs 9h 7d 4h]
Seat 1: cdC54j9fGGojcbzWB5PgzA (big blind) folded on the River
Seat 2: iMe5yhc+1BaiIPHet3NMrA folded on the River
Seat 3: TAfo4veNRaRlzDXMMYS3Jg folded before Flop (didn't bet)
Seat 4: De9g+AYjo0DN6C/+iT/nsg folded before Flop (didn't bet)
Seat 5: CUZwDpLTQKhzarPe+JCLOQ folded before Flop (didn't bet)
Seat 7: 4Cl43Q1TYQL8wn1NSCUkaw collected ($8.55)
Seat 8: GX1heJ+DSsvm7gzSPsYhhQ (button) folded on the River
Seat 9: U2A5Hv6ib/5+gzO2wr7Z4w (small blind) folded before Flop



PokerStars Game #59938852786:  Hold'em No Limit ($1/$2) - 2009/07/01 0:25:08 ET
Table 'OZyw34U4j4WtFFWsEHZQgQ' 2-max Seat #2 is the button
Seat 1: pVqEzK9wXlRMECnb1Zg4Zw ($64.90 in chips)
Seat 2: rAtTyvrJ8f1LaUh2O5U4nA ($57.20 in chips)
rAtTyvrJ8f1LaUh2O5U4nA: posts small blind $1
pVqEzK9wXlRMECnb1Zg4Zw: posts big blind $2
*** HOLE CARDS ***
rAtTyvrJ8f1LaUh2O5U4nA: calls $1
pVqEzK9wXlRMECnb1Zg4Zw: raises $8 to $10
rAtTyvrJ8f1LaUh2O5U4nA: raises $47.20 to $57.20 and is all-in
pVqEzK9wXlRMECnb1Zg4Zw: folds
rAtTyvrJ8f1LaUh2O5U4nA collected $20 from pot
rAtTyvrJ8f1LaUh2O5U4nA: doesn't show hand
*** SUMMARY ***
Total pot $20 | Rake $0
Seat 1: pVqEzK9wXlRMECnb1Zg4Zw (big blind) folded before Flop
Seat 2: rAtTyvrJ8f1LaUh2O5U4nA (button) (small blind) collected ($20)



PokerStars Game #59938853842:  Hold'em No Limit ($1/$2) - 2009/07/01 0:25:09 ET
Table 'jlrIxbrVIG+gjaUYT4za8g' 6-max Seat #3 is the button
Seat 1: ygTTt5ehT4aF86q1a8/R+w ($187.05 in chips)
Seat 2: N18PrNGQj43J7TJuQuu+tw ($154.55 in chips)
Seat 3: 54yWzRRgS0oZ+S6LwZBxMQ ($39.50 in chips)
Seat 4: 8srN1dKQePlsv0GyTada+Q ($219 in chips)
Seat 6: vkfxu8f/jMYKUk6Ly4eujw ($263.95 in chips)
8srN1dKQePlsv0GyTada+Q: posts small blind $1
VuZb/hkEc4X7s93w2ZZTpA: is sitting out
VuZb/hkEc4X7s93w2ZZTpA leaves the table
vkfxu8f/jMYKUk6Ly4eujw: posts big blind $2
*** HOLE CARDS ***
ygTTt5ehT4aF86q1a8/R+w: folds
N18PrNGQj43J7TJuQuu+tw: calls $2
54yWzRRgS0oZ+S6LwZBxMQ: folds
8srN1dKQePlsv0GyTada+Q: raises $6 to $8
vkfxu8f/jMYKUk6Ly4eujw: folds
N18PrNGQj43J7TJuQuu+tw: calls $6
*** FLOP *** [5h Qs Ts]
8srN1dKQePlsv0GyTada+Q: bets $12
N18PrNGQj43J7TJuQuu+tw: folds
8srN1dKQePlsv0GyTada+Q collected $17.10 from pot
*** SUMMARY ***
Total pot $18 | Rake $0.90
Board [5h Qs Ts]
Seat 1: ygTTt5ehT4aF86q1a8/R+w folded before Flop (didn't bet)
Seat 2: N18PrNGQj43J7TJuQuu+tw folded on the Flop
Seat 3: 54yWzRRgS0oZ+S6LwZBxMQ (button) folded before Flop (didn't bet)
Seat 4: 8srN1dKQePlsv0GyTada+Q (small blind) collected ($17.10)
Seat 6: vkfxu8f/jMYKUk6Ly4eujw (big blind) folded before Flop



PokerStars Game #59938854600:  Hold'em No Limit ($1/$2) - 2009/07/01 0:25:10 ET
Table 'NmY84NAf9Mh0ckAckHnh5g' 2-max Seat #2 is the button
Seat 1: 6hvg964TSqZ3AL/0XK9aVQ ($506.95 in chips)
Seat 2: RwDoM55ZeQuI2ADyJhOb2Q ($336 in chips)
RwDoM55ZeQuI2ADyJhOb2Q: posts small blind $1
6hvg964TSqZ3AL/0XK9aVQ: posts big blind $2
*** HOLE CARDS ***
RwDoM55ZeQuI2ADyJhOb2Q: folds
6hvg964TSqZ3AL/0XK9aVQ collected $2 from pot
*** SUMMARY ***
Total pot $2 | Rake $0
Seat 1: 6hvg964TSqZ3AL/0XK9aVQ (big blind) collected ($2)
Seat 2: RwDoM55ZeQuI2ADyJhOb2Q (button) (small blind) folded before Flop



PokerStars Game #59938856016:  Hold'em No Limit ($1/$2) - 2009/07/01 0:25:12 ET
Table 'P/yCfYl1GfGsu/e6DxDy/A' 2-max Seat #2 is the button
Seat 1: 7fOCUy3x9hdkmXkkDNolGQ ($202 in chips)
Seat 2: RwDoM55ZeQuI2ADyJhOb2Q ($822 in chips)
RwDoM55ZeQuI2ADyJhOb2Q: posts small blind $1
7fOCUy3x9hdkmXkkDNolGQ: posts big blind $2
*** HOLE CARDS ***
RwDoM55ZeQuI2ADyJhOb2Q: raises $4 to $6
7fOCUy3x9hdkmXkkDNolGQ: raises $14 to $20
RwDoM55ZeQuI2ADyJhOb2Q: calls $14
*** FLOP *** [Js 2d 5d]
7fOCUy3x9hdkmXkkDNolGQ: bets $31
RwDoM55ZeQuI2ADyJhOb2Q: folds
7fOCUy3x9hdkmXkkDNolGQ collected $39.50 from pot
7fOCUy3x9hdkmXkkDNolGQ: doesn't show hand
*** SUMMARY ***
Total pot $40 | Rake $0.50
Board [Js 2d 5d]
Seat 1: 7fOCUy3x9hdkmXkkDNolGQ (big blind) collected ($39.50)
Seat 2: RwDoM55ZeQuI2ADyJhOb2Q (button) (small blind) folded on the Flop



PokerStars Game #59938856458:  Hold'em No Limit ($1/$2) - 2009/07/01 0:25:13 ET
Table '5G1PjWSk2ALz0O/eqyYy/g' 2-max Seat #1 is the button
Seat 1: Z4HwehErEwzsv/noQlfUlg ($143.40 in chips)
Seat 2: v4dp1VoMhJV4zmCXtmG5LQ ($223.80 in chips)
Z4HwehErEwzsv/noQlfUlg: posts small blind $1
v4dp1VoMhJV4zmCXtmG5LQ: posts big blind $2
*** HOLE CARDS ***
Z4HwehErEwzsv/noQlfUlg: calls $1
v4dp1VoMhJV4zmCXtmG5LQ: raises $6 to $8
Z4HwehErEwzsv/noQlfUlg: calls $6
*** FLOP *** [3h 8c 6h]
v4dp1VoMhJV4zmCXtmG5LQ: bets $12
Z4HwehErEwzsv/noQlfUlg: calls $12
*** TURN *** [3h 8c 6h] [7h]
v4dp1VoMhJV4zmCXtmG5LQ: bets $22
Z4HwehErEwzsv/noQlfUlg: raises $101.40 to $123.40 and is all-in
v4dp1VoMhJV4zmCXtmG5LQ: folds
Z4HwehErEwzsv/noQlfUlg collected $83.50 from pot
Z4HwehErEwzsv/noQlfUlg: doesn't show hand
*** SUMMARY ***
Total pot $84 | Rake $0.50
Board [3h 8c 6h 7h]
Seat 1: Z4HwehErEwzsv/noQlfUlg (button) (small blind) collected ($83.50)
Seat 2: v4dp1VoMhJV4zmCXtmG5LQ (big blind) folded on the Turn



PokerStars Game #59938856578:  Hold'em No Limit ($1/$2) - 2009/07/01 0:25:13 ET
Table 'ztv6V3FN2bQ9nmJPPdx6nQ' 6-max Seat #6 is the button
Seat 1: ek1hig03QiyONDHXvgqteQ ($318.35 in chips)
Seat 2: 5Y+ZGWLI4gnlpApDX5vy1A ($269.45 in chips)
Seat 3: Z55K9DbCHCUi6UaztIHi6g ($101.45 in chips)
Seat 4: vVSUvlW/pvneUNUHDgyXgw ($200 in chips)
Seat 5: sTPOWERd9HWPCNrDBwsVjA ($214.40 in chips)
Seat 6: mfy7uGZcqA2PVQqEVbJ7+g ($201.75 in chips)
ek1hig03QiyONDHXvgqteQ: posts small blind $1
5Y+ZGWLI4gnlpApDX5vy1A: posts big blind $2
*** HOLE CARDS ***
Z55K9DbCHCUi6UaztIHi6g: calls $2
vVSUvlW/pvneUNUHDgyXgw: raises $10 to $12
sTPOWERd9HWPCNrDBwsVjA: folds
mfy7uGZcqA2PVQqEVbJ7+g: folds
ek1hig03QiyONDHXvgqteQ: folds
5Y+ZGWLI4gnlpApDX5vy1A: calls $10
Z55K9DbCHCUi6UaztIHi6g: calls $10
*** FLOP *** [2h Ad 3c]
5Y+ZGWLI4gnlpApDX5vy1A: checks
Z55K9DbCHCUi6UaztIHi6g: checks
vVSUvlW/pvneUNUHDgyXgw: bets $10
5Y+ZGWLI4gnlpApDX5vy1A: calls $10
Z55K9DbCHCUi6UaztIHi6g: calls $10
*** TURN *** [2h Ad 3c] [6s]
5Y+ZGWLI4gnlpApDX5vy1A: checks
Z55K9DbCHCUi6UaztIHi6g: checks
vVSUvlW/pvneUNUHDgyXgw: bets $14
5Y+ZGWLI4gnlpApDX5vy1A: folds
Z55K9DbCHCUi6UaztIHi6g: calls $14
*** RIVER *** [2h Ad 3c 6s] [Qc]
Z55K9DbCHCUi6UaztIHi6g: checks
vVSUvlW/pvneUNUHDgyXgw: bets $24
Z55K9DbCHCUi6UaztIHi6g: folds
vVSUvlW/pvneUNUHDgyXgw collected $92 from pot
vVSUvlW/pvneUNUHDgyXgw: doesn't show hand
*** SUMMARY ***
Total pot $95 | Rake $3
Board [2h Ad 3c 6s Qc]
Seat 1: ek1hig03QiyONDHXvgqteQ (small blind) folded before Flop
Seat 2: 5Y+ZGWLI4gnlpApDX5vy1A (big blind) folded on the Turn
Seat 3: Z55K9DbCHCUi6UaztIHi6g folded on the River
Seat 4: vVSUvlW/pvneUNUHDgyXgw collected ($92)
Seat 5: sTPOWERd9HWPCNrDBwsVjA folded before Flop (didn't bet)
Seat 6: mfy7uGZcqA2PVQqEVbJ7+g (button) folded before Flop (didn't bet)



PokerStars Game #59938856850:  Hold'em No Limit ($1/$2) - 2009/07/01 0:25:14 ET
Table 'aSf77Sj8QEnzcc0WaxVD4Q' 6-max Seat #4 is the button
Seat 1: 54yWzRRgS0oZ+S6LwZBxMQ ($37 in chips)
Seat 2: vkfxu8f/jMYKUk6Ly4eujw ($244.15 in chips)
Seat 3: 9dpyyjDTCed6nV7JhaUUpw ($204.30 in chips)
Seat 4: 513FcCI8jHyQy2VWoIQkMg ($202 in chips)
Seat 5: InmkdI6G8TzSj9NhcCSyPg ($245 in chips)
Seat 6: vkoJRf3gidxY1pPi0AFWww ($313.80 in chips)
InmkdI6G8TzSj9NhcCSyPg: posts small blind $1
vkoJRf3gidxY1pPi0AFWww: posts big blind $2
*** HOLE CARDS ***
54yWzRRgS0oZ+S6LwZBxMQ: folds
vkfxu8f/jMYKUk6Ly4eujw: folds
9dpyyjDTCed6nV7JhaUUpw: folds
513FcCI8jHyQy2VWoIQkMg: folds
InmkdI6G8TzSj9NhcCSyPg: raises $4 to $6
vkoJRf3gidxY1pPi0AFWww: calls $4
*** FLOP *** [8h Kd Qd]
InmkdI6G8TzSj9NhcCSyPg: bets $8
vkoJRf3gidxY1pPi0AFWww: calls $8
*** TURN *** [8h Kd Qd] [2s]
InmkdI6G8TzSj9NhcCSyPg: bets $21
vkoJRf3gidxY1pPi0AFWww: folds
InmkdI6G8TzSj9NhcCSyPg collected $26.65 from pot
*** SUMMARY ***
Total pot $28 | Rake $1.35
Board [8h Kd Qd 2s]
Seat 1: 54yWzRRgS0oZ+S6LwZBxMQ folded before Flop (didn't bet)
Seat 2: vkfxu8f/jMYKUk6Ly4eujw folded before Flop (didn't bet)
Seat 3: 9dpyyjDTCed6nV7JhaUUpw folded before Flop (didn't bet)
Seat 4: 513FcCI8jHyQy2VWoIQkMg (button) folded before Flop (didn't bet)
Seat 5: InmkdI6G8TzSj9NhcCSyPg (small blind) collected ($26.65)
Seat 6: vkoJRf3gidxY1pPi0AFWww (big blind) folded on the Turn



PokerStars Game #59938858904:  Hold'em No Limit ($1/$2) - 2009/07/01 0:25:17 ET
Table 'NmY84NAf9Mh0ckAckHnh5g' 2-max Seat #1 is the button
Seat 1: 6hvg964TSqZ3AL/0XK9aVQ ($507.95 in chips)
Seat 2: RwDoM55ZeQuI2ADyJhOb2Q ($335 in chips)
6hvg964TSqZ3AL/0XK9aVQ: posts small blind $1
RwDoM55ZeQuI2ADyJhOb2Q: posts big blind $2
*** HOLE CARDS ***
6hvg964TSqZ3AL/0XK9aVQ: calls $1
RwDoM55ZeQuI2ADyJhOb2Q: checks
*** FLOP *** [3s 6h 7s]
RwDoM55ZeQuI2ADyJhOb2Q: checks
6hvg964TSqZ3AL/0XK9aVQ: checks
*** TURN *** [3s 6h 7s] [Qs]
RwDoM55ZeQuI2ADyJhOb2Q: checks
6hvg964TSqZ3AL/0XK9aVQ: bets $4
RwDoM55ZeQuI2ADyJhOb2Q: folds
6hvg964TSqZ3AL/0XK9aVQ collected $3.80 from pot
*** SUMMARY ***
Total pot $4 | Rake $0.20
Board [3s 6h 7s Qs]
Seat 1: 6hvg964TSqZ3AL/0XK9aVQ (button) (small blind) collected ($3.80)
Seat 2: RwDoM55ZeQuI2ADyJhOb2Q (big blind) folded on the Turn



PokerStars Game #59938859566:  Hold'em No Limit ($1/$2) - 2009/07/01 0:25:18 ET
Table 'jCW99a4MXoPgL0PwEZ4IuQ' 2-max Seat #1 is the button
Seat 1: t6Jd836OSEMbcRi7rfGp5g ($212.50 in chips)
Seat 2: bWN162Ep6lKyJ0MW6unz4w ($207 in chips)
t6Jd836OSEMbcRi7rfGp5g: posts small blind $1
bWN162Ep6lKyJ0MW6unz4w: posts big blind $2
*** HOLE CARDS ***
t6Jd836OSEMbcRi7rfGp5g: raises $4 to $6
bWN162Ep6lKyJ0MW6unz4w: calls $4
*** FLOP *** [Qh Jc 6c]
bWN162Ep6lKyJ0MW6unz4w: checks
t6Jd836OSEMbcRi7rfGp5g: checks
*** TURN *** [Qh Jc 6c] [9d]
bWN162Ep6lKyJ0MW6unz4w: bets $6
t6Jd836OSEMbcRi7rfGp5g: folds
bWN162Ep6lKyJ0MW6unz4w collected $11.50 from pot
bWN162Ep6lKyJ0MW6unz4w: doesn't show hand
*** SUMMARY ***
Total pot $12 | Rake $0.50
Board [Qh Jc 6c 9d]
Seat 1: t6Jd836OSEMbcRi7rfGp5g (button) (small blind) folded on the Turn
Seat 2: bWN162Ep6lKyJ0MW6unz4w (big blind) collected ($11.50)



PokerStars Game #59938861302:  Hold'em No Limit ($1/$2) - 2009/07/01 0:25:21 ET
Table 'G1Oqdy4Pqdb5gtx40rUBzA' 6-max Seat #1 is the button
Seat 1: bz8Aw6kfX2xUq2sOyZlUCQ ($76.85 in chips)
Seat 2: IzslX/oV8DoDQfxCV/3+kg ($462.15 in chips)
Seat 3: lE+RUsc9cdVV9eEi8uytew ($196.90 in chips)
Seat 4: B87ikIyZ/TzAVeXf38Ny0g ($200.80 in chips)
IzslX/oV8DoDQfxCV/3+kg: posts small blind $1
lE+RUsc9cdVV9eEi8uytew: posts big blind $2
*** HOLE CARDS ***
B87ikIyZ/TzAVeXf38Ny0g: raises $4 to $6
bz8Aw6kfX2xUq2sOyZlUCQ: folds
IzslX/oV8DoDQfxCV/3+kg: folds
lE+RUsc9cdVV9eEi8uytew: folds
B87ikIyZ/TzAVeXf38Ny0g collected $5 from pot
B87ikIyZ/TzAVeXf38Ny0g: doesn't show hand
*** SUMMARY ***
Total pot $5 | Rake $0
Seat 1: bz8Aw6kfX2xUq2sOyZlUCQ (button) folded before Flop (didn't bet)
Seat 2: IzslX/oV8DoDQfxCV/3+kg (small blind) folded before Flop
Seat 3: lE+RUsc9cdVV9eEi8uytew (big blind) folded before Flop
Seat 4: B87ikIyZ/TzAVeXf38Ny0g collected ($5)



PokerStars Game #59938863836:  Hold'em No Limit ($1/$2) - 2009/07/01 0:25:24 ET
Table 'OZyw34U4j4WtFFWsEHZQgQ' 2-max Seat #1 is the button
Seat 1: pVqEzK9wXlRMECnb1Zg4Zw ($54.90 in chips)
Seat 2: rAtTyvrJ8f1LaUh2O5U4nA ($67.20 in chips)
pVqEzK9wXlRMECnb1Zg4Zw: posts small blind $1
rAtTyvrJ8f1LaUh2O5U4nA: posts big blind $2
*** HOLE CARDS ***
pVqEzK9wXlRMECnb1Zg4Zw: raises $6 to $8
rAtTyvrJ8f1LaUh2O5U4nA: folds
pVqEzK9wXlRMECnb1Zg4Zw collected $4 from pot
pVqEzK9wXlRMECnb1Zg4Zw: doesn't show hand
*** SUMMARY ***
Total pot $4 | Rake $0
Seat 1: pVqEzK9wXlRMECnb1Zg4Zw (button) (small blind) collected ($4)
Seat 2: rAtTyvrJ8f1LaUh2O5U4nA (big blind) folded before Flop



PokerStars Game #59938864440:  Hold'em No Limit ($1/$2) - 2009/07/01 0:25:25 ET
Table 'CFkQcfWjKccZaZDf71FK+w' 6-max Seat #1 is the button
Seat 1: U2A5Hv6ib/5+gzO2wr7Z4w ($200 in chips)
Seat 2: X7GlkHF+lkbarCLuZ4Uf0w ($34 in chips)
Seat 3: R5/GXj0PUdNkzHU6Omb/JA ($98 in chips)
Seat 4: e8nZKSbIdIO7e2NdQe/OFQ ($233.80 in chips)
Seat 5: 1njbh8TKSUF6l4V1XwGdcg ($217.80 in chips)
X7GlkHF+lkbarCLuZ4Uf0w: posts small blind $1
R5/GXj0PUdNkzHU6Omb/JA: posts big blind $2
*** HOLE CARDS ***
e8nZKSbIdIO7e2NdQe/OFQ: folds
1njbh8TKSUF6l4V1XwGdcg: folds
U2A5Hv6ib/5+gzO2wr7Z4w: raises $4 to $6
X7GlkHF+lkbarCLuZ4Uf0w: folds
R5/GXj0PUdNkzHU6Omb/JA: folds
U2A5Hv6ib/5+gzO2wr7Z4w collected $5 from pot
*** SUMMARY ***
Total pot $5 | Rake $0
Seat 1: U2A5Hv6ib/5+gzO2wr7Z4w (button) collected ($5)
Seat 2: X7GlkHF+lkbarCLuZ4Uf0w (small blind) folded before Flop
Seat 3: R5/GXj0PUdNkzHU6Omb/JA (big blind) folded before Flop
Seat 4: e8nZKSbIdIO7e2NdQe/OFQ folded before Flop (didn't bet)
Seat 5: 1njbh8TKSUF6l4V1XwGdcg folded before Flop (didn't bet)



PokerStars Game #59938864010:  Hold'em No Limit ($1/$2) - 2009/07/01 0:25:25 ET
Table 'BSRfGh+QobUe0AgIMtt/fw' 9-max Seat #2 is the button
Seat 1: QHxJjpVYwitg9krW6wZgJA ($289.30 in chips)
Seat 2: GX1heJ+DSsvm7gzSPsYhhQ ($37 in chips)
Seat 3: XSBFygUEk3Ijl/S/KhD4PA ($352.60 in chips)
Seat 4: 5iPk5MyO3KVu18Y8XCYfFQ ($40 in chips)
Seat 5: odhvI/CZeMsPyo1n1U7+hA ($80.50 in chips)
Seat 6: H6Z4+qu8gR0VUiPOijndVg ($207.40 in chips)
Seat 7: RgU4royPa+zJopKX0xA3RA ($161.60 in chips)
Seat 8: /XRRUMKiOOItJFbrM26RrA ($54 in chips)
XSBFygUEk3Ijl/S/KhD4PA: posts small blind $1
5iPk5MyO3KVu18Y8XCYfFQ: posts big blind $2
/inIs/z/PcX+TniIFpaxpg: sits out
*** HOLE CARDS ***
odhvI/CZeMsPyo1n1U7+hA: calls $2
H6Z4+qu8gR0VUiPOijndVg: folds
RgU4royPa+zJopKX0xA3RA: folds
/XRRUMKiOOItJFbrM26RrA: folds
QHxJjpVYwitg9krW6wZgJA: folds
GX1heJ+DSsvm7gzSPsYhhQ: calls $2
XSBFygUEk3Ijl/S/KhD4PA: folds
5iPk5MyO3KVu18Y8XCYfFQ: checks
*** FLOP *** [Js 7d 8c]
5iPk5MyO3KVu18Y8XCYfFQ: checks
odhvI/CZeMsPyo1n1U7+hA: checks
GX1heJ+DSsvm7gzSPsYhhQ: checks
*** TURN *** [Js 7d 8c] [Ts]
5iPk5MyO3KVu18Y8XCYfFQ: checks
odhvI/CZeMsPyo1n1U7+hA: bets $2
GX1heJ+DSsvm7gzSPsYhhQ: calls $2
5iPk5MyO3KVu18Y8XCYfFQ: folds
*** RIVER *** [Js 7d 8c Ts] [2h]
odhvI/CZeMsPyo1n1U7+hA: bets $4
GX1heJ+DSsvm7gzSPsYhhQ: folds
odhvI/CZeMsPyo1n1U7+hA collected $10.50 from pot
*** SUMMARY ***
Total pot $11 | Rake $0.50
Board [Js 7d 8c Ts 2h]
Seat 1: QHxJjpVYwitg9krW6wZgJA folded before Flop (didn't bet)
Seat 2: GX1heJ+DSsvm7gzSPsYhhQ (button) folded on the River
Seat 3: XSBFygUEk3Ijl/S/KhD4PA (small blind) folded before Flop
Seat 4: 5iPk5MyO3KVu18Y8XCYfFQ (big blind) folded on the Turn
Seat 5: odhvI/CZeMsPyo1n1U7+hA collected ($10.50)
Seat 6: H6Z4+qu8gR0VUiPOijndVg folded before Flop (didn't bet)
Seat 7: RgU4royPa+zJopKX0xA3RA folded before Flop (didn't bet)
Seat 8: /XRRUMKiOOItJFbrM26RrA folded before Flop (didn't bet)



PokerStars Game #59938865442:  Hold'em No Limit ($1/$2) - 2009/07/01 0:25:27 ET
Table 'ZzSIe0zTCDv+n6hfbY5tTg' 6-max Seat #6 is the button
Seat 2: B87ikIyZ/TzAVeXf38Ny0g ($201 in chips)
Seat 4: ky55L0pITYgYLeqFB9gP/Q ($153.40 in chips)
Seat 5: f2eTKbND+tM3kUw9o6WYWg ($141 in chips)
Seat 6: InmkdI6G8TzSj9NhcCSyPg ($200 in chips)
B87ikIyZ/TzAVeXf38Ny0g: posts small blind $1
X7GlkHF+lkbarCLuZ4Uf0w: is sitting out
ky55L0pITYgYLeqFB9gP/Q: posts big blind $2
*** HOLE CARDS ***
X7GlkHF+lkbarCLuZ4Uf0w has returned
f2eTKbND+tM3kUw9o6WYWg: raises $4 to $6
InmkdI6G8TzSj9NhcCSyPg: folds
B87ikIyZ/TzAVeXf38Ny0g: folds
ky55L0pITYgYLeqFB9gP/Q: calls $4
*** FLOP *** [Kd 7c 4s]
ky55L0pITYgYLeqFB9gP/Q: checks
f2eTKbND+tM3kUw9o6WYWg: checks
*** TURN *** [Kd 7c 4s] [9s]
ky55L0pITYgYLeqFB9gP/Q: checks
f2eTKbND+tM3kUw9o6WYWg: checks
*** RIVER *** [Kd 7c 4s 9s] [8s]
ky55L0pITYgYLeqFB9gP/Q: checks
f2eTKbND+tM3kUw9o6WYWg: checks
*** SHOW DOWN ***
ky55L0pITYgYLeqFB9gP/Q: shows [Ac 2c] (high card Ace)
f2eTKbND+tM3kUw9o6WYWg: shows [Jh 7s] (a pair of Sevens)
f2eTKbND+tM3kUw9o6WYWg collected $12.35 from pot
*** SUMMARY ***
Total pot $13 | Rake $0.65
Board [Kd 7c 4s 9s 8s]
Seat 2: B87ikIyZ/TzAVeXf38Ny0g (small blind) folded before Flop
Seat 4: ky55L0pITYgYLeqFB9gP/Q (big blind) showed [Ac 2c] and lost with high card Ace
Seat 5: f2eTKbND+tM3kUw9o6WYWg showed [Jh 7s] and won ($12.35) with a pair of Sevens
Seat 6: InmkdI6G8TzSj9NhcCSyPg (button) folded before Flop (didn't bet)



PokerStars Game #59938866922:  Hold'em No Limit ($1/$2) - 2009/07/01 0:25:29 ET
Table 'srul5UFZXTEccVV5fpY91g' 9-max Seat #4 is the button
Seat 1: lfD8cBv31A/pio3pXJbPjA ($153.20 in chips)
Seat 2: tJYod1SLp2AcWPL/3hZ7ug ($67.20 in chips)
Seat 3: weUZ8S7tgbaeIpzi1gBNxQ ($44.75 in chips)
Seat 4: GG5lTuGt3+kwNYSbqeB6yw ($85.40 in chips)
Seat 5: 5iPk5MyO3KVu18Y8XCYfFQ ($77.55 in chips)
Seat 7: s0erZsDxbZSaEPheMgibKg ($444.10 in chips)
Seat 8: UZEsV9yKUMqmpYPiOFpaZw ($76 in chips)
Seat 9: jRGC4KXXODbHEN275TXFCA ($184.30 in chips)
5iPk5MyO3KVu18Y8XCYfFQ: posts small blind $1
s0erZsDxbZSaEPheMgibKg: posts big blind $2
*** HOLE CARDS ***
UZEsV9yKUMqmpYPiOFpaZw: folds
jRGC4KXXODbHEN275TXFCA: calls $2
lfD8cBv31A/pio3pXJbPjA: folds
tJYod1SLp2AcWPL/3hZ7ug: calls $2
weUZ8S7tgbaeIpzi1gBNxQ: raises $8 to $10
GG5lTuGt3+kwNYSbqeB6yw: folds
5iPk5MyO3KVu18Y8XCYfFQ: folds
s0erZsDxbZSaEPheMgibKg: folds
jRGC4KXXODbHEN275TXFCA: folds
tJYod1SLp2AcWPL/3hZ7ug: calls $8
*** FLOP *** [Tc 3c 8h]
tJYod1SLp2AcWPL/3hZ7ug: checks
weUZ8S7tgbaeIpzi1gBNxQ: checks
*** TURN *** [Tc 3c 8h] [4h]
tJYod1SLp2AcWPL/3hZ7ug: checks
weUZ8S7tgbaeIpzi1gBNxQ: checks
*** RIVER *** [Tc 3c 8h 4h] [2d]
tJYod1SLp2AcWPL/3hZ7ug: bets $18
weUZ8S7tgbaeIpzi1gBNxQ: folds
TAfo4veNRaRlzDXMMYS3Jg is connected
tJYod1SLp2AcWPL/3hZ7ug collected $23.75 from pot
*** SUMMARY ***
Total pot $25 | Rake $1.25
Board [Tc 3c 8h 4h 2d]
Seat 1: lfD8cBv31A/pio3pXJbPjA folded before Flop (didn't bet)
Seat 2: tJYod1SLp2AcWPL/3hZ7ug collected ($23.75)
Seat 3: weUZ8S7tgbaeIpzi1gBNxQ folded on the River
Seat 4: GG5lTuGt3+kwNYSbqeB6yw (button) folded before Flop (didn't bet)
Seat 5: 5iPk5MyO3KVu18Y8XCYfFQ (small blind) folded before Flop
Seat 7: s0erZsDxbZSaEPheMgibKg (big blind) folded before Flop
Seat 8: UZEsV9yKUMqmpYPiOFpaZw folded before Flop (didn't bet)
Seat 9: jRGC4KXXODbHEN275TXFCA folded before Flop



PokerStars Game #59938867612:  Hold'em No Limit ($1/$2) - 2009/07/01 0:25:30 ET
Table 'QxerF7GUfCbl+4a8XaTB2w' 6-max Seat #4 is the button
Seat 1: o9jamqIi6sTTRSqudgboRA ($203 in chips)
Seat 2: 513FcCI8jHyQy2VWoIQkMg ($220.10 in chips)
Seat 3: vkfxu8f/jMYKUk6Ly4eujw ($197 in chips)
Seat 4: WfaZs12BkYO+BUX5VWpuWQ ($57.20 in chips)
Seat 5: ezK4YR9nqEKpOT/tYPvHKA ($113.05 in chips)
Seat 6: RUZs7P4uzWavoA6iEpDKLw ($148.85 in chips)
ezK4YR9nqEKpOT/tYPvHKA: posts small blind $1
RUZs7P4uzWavoA6iEpDKLw: posts big blind $2
*** HOLE CARDS ***
o9jamqIi6sTTRSqudgboRA: folds
513FcCI8jHyQy2VWoIQkMg: raises $5 to $7
vkfxu8f/jMYKUk6Ly4eujw: folds
WfaZs12BkYO+BUX5VWpuWQ: folds
ezK4YR9nqEKpOT/tYPvHKA: folds
RUZs7P4uzWavoA6iEpDKLw: folds
513FcCI8jHyQy2VWoIQkMg collected $5 from pot
*** SUMMARY ***
Total pot $5 | Rake $0
Seat 1: o9jamqIi6sTTRSqudgboRA folded before Flop (didn't bet)
Seat 2: 513FcCI8jHyQy2VWoIQkMg collected ($5)
Seat 3: vkfxu8f/jMYKUk6Ly4eujw folded before Flop (didn't bet)
Seat 4: WfaZs12BkYO+BUX5VWpuWQ (button) folded before Flop (didn't bet)
Seat 5: ezK4YR9nqEKpOT/tYPvHKA (small blind) folded before Flop
Seat 6: RUZs7P4uzWavoA6iEpDKLw (big blind) folded before Flop



PokerStars Game #59938869584:  Hold'em No Limit ($1/$2) - 2009/07/01 0:25:33 ET
Table 'OZyw34U4j4WtFFWsEHZQgQ' 2-max Seat #2 is the button
Seat 1: pVqEzK9wXlRMECnb1Zg4Zw ($83 in chips)
Seat 2: rAtTyvrJ8f1LaUh2O5U4nA ($65.20 in chips)
rAtTyvrJ8f1LaUh2O5U4nA: posts small blind $1
pVqEzK9wXlRMECnb1Zg4Zw: posts big blind $2
*** HOLE CARDS ***
rAtTyvrJ8f1LaUh2O5U4nA: raises $6 to $8
pVqEzK9wXlRMECnb1Zg4Zw: calls $6
*** FLOP *** [8c 6h Js]
pVqEzK9wXlRMECnb1Zg4Zw: checks
rAtTyvrJ8f1LaUh2O5U4nA: checks
*** TURN *** [8c 6h Js] [3d]
pVqEzK9wXlRMECnb1Zg4Zw: checks
rAtTyvrJ8f1LaUh2O5U4nA: checks
*** RIVER *** [8c 6h Js 3d] [9h]
pVqEzK9wXlRMECnb1Zg4Zw: checks
rAtTyvrJ8f1LaUh2O5U4nA: checks
*** SHOW DOWN ***
pVqEzK9wXlRMECnb1Zg4Zw: shows [Ac 7h] (high card Ace)
rAtTyvrJ8f1LaUh2O5U4nA: mucks hand
pVqEzK9wXlRMECnb1Zg4Zw collected $15.50 from pot
*** SUMMARY ***
Total pot $16 | Rake $0.50
Board [8c 6h Js 3d 9h]
Seat 1: pVqEzK9wXlRMECnb1Zg4Zw (big blind) showed [Ac 7h] and won ($15.50) with high card Ace
Seat 2: rAtTyvrJ8f1LaUh2O5U4nA (button) (small blind) mucked



PokerStars Game #59938870986:  Hold'em No Limit ($1/$2) - 2009/07/01 0:25:35 ET
Table 'mGpP9StWRnoeiBDExc6Frg' 6-max Seat #4 is the button
Seat 1: zWFU82nxIRvzK4mKiL4m0Q ($54.15 in chips)
Seat 2: DQlskgG4OtLpF2MVxLwf4A ($306.85 in chips)
Seat 3: 3HrFUl+TAqSP1U00zz3P7A ($83.40 in chips)
Seat 4: qXDd0ZyMIse0OBu8pxeQ3Q ($218 in chips)
Seat 5: d1puGuVBE0fidn+5eRJ0tw ($173 in chips)
Seat 6: X7GlkHF+lkbarCLuZ4Uf0w ($43 in chips)
d1puGuVBE0fidn+5eRJ0tw: posts small blind $1
X7GlkHF+lkbarCLuZ4Uf0w: posts big blind $2
*** HOLE CARDS ***
zWFU82nxIRvzK4mKiL4m0Q: folds
DQlskgG4OtLpF2MVxLwf4A: folds
3HrFUl+TAqSP1U00zz3P7A: folds
qXDd0ZyMIse0OBu8pxeQ3Q: folds
d1puGuVBE0fidn+5eRJ0tw: calls $1
X7GlkHF+lkbarCLuZ4Uf0w: raises $4 to $6
d1puGuVBE0fidn+5eRJ0tw: folds
X7GlkHF+lkbarCLuZ4Uf0w collected $4 from pot
X7GlkHF+lkbarCLuZ4Uf0w: doesn't show hand
*** SUMMARY ***
Total pot $4 | Rake $0
Seat 1: zWFU82nxIRvzK4mKiL4m0Q folded before Flop (didn't bet)
Seat 2: DQlskgG4OtLpF2MVxLwf4A folded before Flop (didn't bet)
Seat 3: 3HrFUl+TAqSP1U00zz3P7A folded before Flop (didn't bet)
Seat 4: qXDd0ZyMIse0OBu8pxeQ3Q (button) folded before Flop (didn't bet)
Seat 5: d1puGuVBE0fidn+5eRJ0tw (small blind) folded before Flop
Seat 6: X7GlkHF+lkbarCLuZ4Uf0w (big blind) collected ($4)



PokerStars Game #59938871720:  Hold'em No Limit ($1/$2) - 2009/07/01 0:25:36 ET
Table 'jCW99a4MXoPgL0PwEZ4IuQ' 2-max Seat #2 is the button
Seat 1: t6Jd836OSEMbcRi7rfGp5g ($206.50 in chips)
Seat 2: bWN162Ep6lKyJ0MW6unz4w ($212.50 in chips)
bWN162Ep6lKyJ0MW6unz4w: posts small blind $1
t6Jd836OSEMbcRi7rfGp5g: posts big blind $2
*** HOLE CARDS ***
bWN162Ep6lKyJ0MW6unz4w: raises $4 to $6
t6Jd836OSEMbcRi7rfGp5g: raises $14 to $20
bWN162Ep6lKyJ0MW6unz4w: folds
t6Jd836OSEMbcRi7rfGp5g collected $12 from pot
*** SUMMARY ***
Total pot $12 | Rake $0
Seat 1: t6Jd836OSEMbcRi7rfGp5g (big blind) collected ($12)
Seat 2: bWN162Ep6lKyJ0MW6unz4w (button) (small blind) folded before Flop



PokerStars Game #59938872098:  Hold'em No Limit ($1/$2) - 2009/07/01 0:25:37 ET
Table 'P/yCfYl1GfGsu/e6DxDy/A' 2-max Seat #1 is the button
Seat 1: 7fOCUy3x9hdkmXkkDNolGQ ($221.50 in chips)
Seat 2: RwDoM55ZeQuI2ADyJhOb2Q ($802 in chips)
7fOCUy3x9hdkmXkkDNolGQ: posts small blind $1
RwDoM55ZeQuI2ADyJhOb2Q: posts big blind $2
*** HOLE CARDS ***
7fOCUy3x9hdkmXkkDNolGQ: folds
RwDoM55ZeQuI2ADyJhOb2Q collected $2 from pot
RwDoM55ZeQuI2ADyJhOb2Q: doesn't show hand
*** SUMMARY ***
Total pot $2 | Rake $0
Seat 1: 7fOCUy3x9hdkmXkkDNolGQ (button) (small blind) folded before Flop
Seat 2: RwDoM55ZeQuI2ADyJhOb2Q (big blind) collected ($2)



PokerStars Game #59938871946:  Hold'em No Limit ($1/$2) - 2009/07/01 0:25:37 ET
Table 'bIihwBANJSFqlHPPtset+w' 9-max Seat #2 is the button
Seat 1: jI3JDUGV63ccqtKgM3vMbw ($156.70 in chips)
Seat 2: lQYT23h5QCUVZAKxjOO39Q ($109.90 in chips)
Seat 3: acnZ0LD5jxKgWIHz+mpQ8Q ($216.75 in chips)
Seat 4: 7WWX5PClBdr/U44gUKBIEA ($293.05 in chips)
Seat 5: rNejrG5tkeRBbL+UmC0iJA ($201.15 in chips)
Seat 6: 5iPk5MyO3KVu18Y8XCYfFQ ($66.80 in chips)
Seat 7: pCmk6FpSOLJ+85o1tLHIag ($92 in chips)
Seat 8: iMe5yhc+1BaiIPHet3NMrA ($275.65 in chips)
acnZ0LD5jxKgWIHz+mpQ8Q: posts small blind $1
7WWX5PClBdr/U44gUKBIEA: posts big blind $2
GX1heJ+DSsvm7gzSPsYhhQ: sits out
*** HOLE CARDS ***
rNejrG5tkeRBbL+UmC0iJA: folds
5iPk5MyO3KVu18Y8XCYfFQ: folds
pCmk6FpSOLJ+85o1tLHIag: folds
iMe5yhc+1BaiIPHet3NMrA: folds
jI3JDUGV63ccqtKgM3vMbw: folds
lQYT23h5QCUVZAKxjOO39Q: folds
acnZ0LD5jxKgWIHz+mpQ8Q: folds
7WWX5PClBdr/U44gUKBIEA collected $2 from pot
*** SUMMARY ***
Total pot $2 | Rake $0
Seat 1: jI3JDUGV63ccqtKgM3vMbw folded before Flop (didn't bet)
Seat 2: lQYT23h5QCUVZAKxjOO39Q (button) folded before Flop (didn't bet)
Seat 3: acnZ0LD5jxKgWIHz+mpQ8Q (small blind) folded before Flop
Seat 4: 7WWX5PClBdr/U44gUKBIEA (big blind) collected ($2)
Seat 5: rNejrG5tkeRBbL+UmC0iJA folded before Flop (didn't bet)
Seat 6: 5iPk5MyO3KVu18Y8XCYfFQ folded before Flop (didn't bet)
Seat 7: pCmk6FpSOLJ+85o1tLHIag folded before Flop (didn't bet)
Seat 8: iMe5yhc+1BaiIPHet3NMrA folded before Flop (didn't bet)



PokerStars Game #59938872916:  Hold'em No Limit ($1/$2) - 2009/07/01 0:25:38 ET
Table 'gnHBqWll9O3fxG7Ojkz/ng' 9-max Seat #2 is the button
Seat 1: hpqdC/23wXosGOmzARr5NA ($179.05 in chips)
Seat 2: H6Z4+qu8gR0VUiPOijndVg ($200 in chips)
Seat 3: 5Q8U6iZbeO7xJSS4qvDP5g ($229.35 in chips)
Seat 4: n5XI5/7gN+gIubHFBH+mOw ($368.15 in chips)
Seat 5: rBQDMkKm9cZn6M9NPsiVew ($172.45 in chips)
Seat 6: 5iPk5MyO3KVu18Y8XCYfFQ ($40 in chips)
Seat 7: jqui3xAWCkcdPW36a6BD+w ($212.55 in chips)
Seat 8: cM6efHzdxoqYm0EQKP4TTQ ($105.80 in chips)
5Q8U6iZbeO7xJSS4qvDP5g: posts small blind $1
n5XI5/7gN+gIubHFBH+mOw: posts big blind $2
GX1heJ+DSsvm7gzSPsYhhQ: sits out
*** HOLE CARDS ***
rBQDMkKm9cZn6M9NPsiVew: calls $2
5iPk5MyO3KVu18Y8XCYfFQ: folds
jqui3xAWCkcdPW36a6BD+w: folds
cM6efHzdxoqYm0EQKP4TTQ: folds
hpqdC/23wXosGOmzARr5NA: folds
H6Z4+qu8gR0VUiPOijndVg: folds
n5XI5/7gN+gIubHFBH+mOw said, "ouch"
5Q8U6iZbeO7xJSS4qvDP5g: folds
n5XI5/7gN+gIubHFBH+mOw: checks
*** FLOP *** [3d 4h Qc]
n5XI5/7gN+gIubHFBH+mOw: checks
rBQDMkKm9cZn6M9NPsiVew: checks
*** TURN *** [3d 4h Qc] [9c]
n5XI5/7gN+gIubHFBH+mOw: bets $4
rBQDMkKm9cZn6M9NPsiVew: folds
n5XI5/7gN+gIubHFBH+mOw collected $4.75 from pot
*** SUMMARY ***
Total pot $5 | Rake $0.25
Board [3d 4h Qc 9c]
Seat 1: hpqdC/23wXosGOmzARr5NA folded before Flop (didn't bet)
Seat 2: H6Z4+qu8gR0VUiPOijndVg (button) folded before Flop (didn't bet)
Seat 3: 5Q8U6iZbeO7xJSS4qvDP5g (small blind) folded before Flop
Seat 4: n5XI5/7gN+gIubHFBH+mOw (big blind) collected ($4.75)
Seat 5: rBQDMkKm9cZn6M9NPsiVew folded on the Turn
Seat 6: 5iPk5MyO3KVu18Y8XCYfFQ folded before Flop (didn't bet)
Seat 7: jqui3xAWCkcdPW36a6BD+w folded before Flop (didn't bet)
Seat 8: cM6efHzdxoqYm0EQKP4TTQ folded before Flop (didn't bet)



PokerStars Game #59938873862:  Hold'em No Limit ($1/$2) - 2009/07/01 0:25:40 ET
Table 'NmY84NAf9Mh0ckAckHnh5g' 2-max Seat #2 is the button
Seat 1: 6hvg964TSqZ3AL/0XK9aVQ ($509.75 in chips)
Seat 2: RwDoM55ZeQuI2ADyJhOb2Q ($333 in chips)
RwDoM55ZeQuI2ADyJhOb2Q: posts small blind $1
6hvg964TSqZ3AL/0XK9aVQ: posts big blind $2
*** HOLE CARDS ***
RwDoM55ZeQuI2ADyJhOb2Q: raises $4 to $6
6hvg964TSqZ3AL/0XK9aVQ: calls $4
*** FLOP *** [Jc 3c Ad]
6hvg964TSqZ3AL/0XK9aVQ: checks
RwDoM55ZeQuI2ADyJhOb2Q: checks
*** TURN *** [Jc 3c Ad] [3d]
6hvg964TSqZ3AL/0XK9aVQ: checks
RwDoM55ZeQuI2ADyJhOb2Q: checks
*** RIVER *** [Jc 3c Ad 3d] [Qd]
6hvg964TSqZ3AL/0XK9aVQ: bets $10
RwDoM55ZeQuI2ADyJhOb2Q: raises $30 to $40
6hvg964TSqZ3AL/0XK9aVQ: folds
RwDoM55ZeQuI2ADyJhOb2Q collected $31.50 from pot
RwDoM55ZeQuI2ADyJhOb2Q: doesn't show hand
*** SUMMARY ***
Total pot $32 | Rake $0.50
Board [Jc 3c Ad 3d Qd]
Seat 1: 6hvg964TSqZ3AL/0XK9aVQ (big blind) folded on the River
Seat 2: RwDoM55ZeQuI2ADyJhOb2Q (button) (small blind) collected ($31.50)



PokerStars Game #59938874824:  Hold'em No Limit ($1/$2) - 2009/07/01 0:25:41 ET
Table 'YqGfR5eHfMeSjb9a+QU9rg' 9-max Seat #6 is the button
Seat 1: qCBuzVnLcBR29snMAHq9PA ($115.90 in chips)
Seat 2: W3Nqt1GWlTi9tXQXMNEvgw ($255.75 in chips)
Seat 3: /gll27k+xWYV7Fbki0lFDQ ($110.85 in chips)
Seat 4: QHxJjpVYwitg9krW6wZgJA ($200 in chips)
Seat 5: MOBMOMQRN/z+fiGXGnZojw ($221.95 in chips)
Seat 6: 5iPk5MyO3KVu18Y8XCYfFQ ($42 in chips)
Seat 7: tAhiYXx1KvTp5hhBamTYfQ ($207.60 in chips)
Seat 8: JnV3SM2D6dAFYyGZHHpvrg ($100 in chips)
tAhiYXx1KvTp5hhBamTYfQ: posts small blind $1
JnV3SM2D6dAFYyGZHHpvrg: posts big blind $2
/inIs/z/PcX+TniIFpaxpg: sits out
*** HOLE CARDS ***
qCBuzVnLcBR29snMAHq9PA: raises $2 to $4
W3Nqt1GWlTi9tXQXMNEvgw: folds
/gll27k+xWYV7Fbki0lFDQ: folds
QHxJjpVYwitg9krW6wZgJA: folds
MOBMOMQRN/z+fiGXGnZojw: calls $4
5iPk5MyO3KVu18Y8XCYfFQ: folds
tAhiYXx1KvTp5hhBamTYfQ: folds
JnV3SM2D6dAFYyGZHHpvrg: calls $2
*** FLOP *** [2d 7s 4h]
JnV3SM2D6dAFYyGZHHpvrg: checks
qCBuzVnLcBR29snMAHq9PA: checks
MOBMOMQRN/z+fiGXGnZojw: bets $10
JnV3SM2D6dAFYyGZHHpvrg: folds
qCBuzVnLcBR29snMAHq9PA: folds
MOBMOMQRN/z+fiGXGnZojw collected $12.35 from pot
*** SUMMARY ***
Total pot $13 | Rake $0.65
Board [2d 7s 4h]
Seat 1: qCBuzVnLcBR29snMAHq9PA folded on the Flop
Seat 2: W3Nqt1GWlTi9tXQXMNEvgw folded before Flop (didn't bet)
Seat 3: /gll27k+xWYV7Fbki0lFDQ folded before Flop (didn't bet)
Seat 4: QHxJjpVYwitg9krW6wZgJA folded before Flop (didn't bet)
Seat 5: MOBMOMQRN/z+fiGXGnZojw collected ($12.35)
Seat 6: 5iPk5MyO3KVu18Y8XCYfFQ (button) folded before Flop (didn't bet)
Seat 7: tAhiYXx1KvTp5hhBamTYfQ (small blind) folded before Flop
Seat 8: JnV3SM2D6dAFYyGZHHpvrg (big blind) folded on the Flop



PokerStars Game #59938874906:  Hold'em No Limit ($1/$2) - 2009/07/01 0:25:41 ET
Table 'G1Oqdy4Pqdb5gtx40rUBzA' 6-max Seat #2 is the button
Seat 1: bz8Aw6kfX2xUq2sOyZlUCQ ($76.85 in chips)
Seat 2: IzslX/oV8DoDQfxCV/3+kg ($461.15 in chips)
Seat 3: lE+RUsc9cdVV9eEi8uytew ($194.90 in chips)
Seat 4: B87ikIyZ/TzAVeXf38Ny0g ($203.80 in chips)
lE+RUsc9cdVV9eEi8uytew: posts small blind $1
B87ikIyZ/TzAVeXf38Ny0g: posts big blind $2
*** HOLE CARDS ***
bz8Aw6kfX2xUq2sOyZlUCQ: raises $4 to $6
IzslX/oV8DoDQfxCV/3+kg: folds
lE+RUsc9cdVV9eEi8uytew: folds
B87ikIyZ/TzAVeXf38Ny0g: folds
bz8Aw6kfX2xUq2sOyZlUCQ collected $5 from pot
*** SUMMARY ***
Total pot $5 | Rake $0
Seat 1: bz8Aw6kfX2xUq2sOyZlUCQ collected ($5)
Seat 2: IzslX/oV8DoDQfxCV/3+kg (button) folded before Flop (didn't bet)
Seat 3: lE+RUsc9cdVV9eEi8uytew (small blind) folded before Flop
Seat 4: B87ikIyZ/TzAVeXf38Ny0g (big blind) folded before Flop



PokerStars Game #59938875466:  Hold'em No Limit ($1/$2) - 2009/07/01 0:25:42 ET
Table 'kq5zaQ+1hLNf8LZfGnbTAA' 6-max Seat #3 is the button
Seat 1: 8srN1dKQePlsv0GyTada+Q ($200 in chips)
Seat 2: H8kZwxsevA5S0PwFy0Jegg ($150.50 in chips)
Seat 3: vkfxu8f/jMYKUk6Ly4eujw ($197 in chips)
Seat 4: hjmQ/y4JIAjzsvBGw83Qmg ($169.90 in chips)
Seat 5: qXDd0ZyMIse0OBu8pxeQ3Q ($200 in chips)
Seat 6: o9jamqIi6sTTRSqudgboRA ($312.20 in chips)
hjmQ/y4JIAjzsvBGw83Qmg: posts small blind $1
qXDd0ZyMIse0OBu8pxeQ3Q: posts big blind $2
*** HOLE CARDS ***
o9jamqIi6sTTRSqudgboRA: folds
8srN1dKQePlsv0GyTada+Q: folds
H8kZwxsevA5S0PwFy0Jegg: folds
vkfxu8f/jMYKUk6Ly4eujw: folds
hjmQ/y4JIAjzsvBGw83Qmg: folds
qXDd0ZyMIse0OBu8pxeQ3Q collected $2 from pot
*** SUMMARY ***
Total pot $2 | Rake $0
Seat 1: 8srN1dKQePlsv0GyTada+Q folded before Flop (didn't bet)
Seat 2: H8kZwxsevA5S0PwFy0Jegg folded before Flop (didn't bet)
Seat 3: vkfxu8f/jMYKUk6Ly4eujw (button) folded before Flop (didn't bet)
Seat 4: hjmQ/y4JIAjzsvBGw83Qmg (small blind) folded before Flop
Seat 5: qXDd0ZyMIse0OBu8pxeQ3Q (big blind) collected ($2)
Seat 6: o9jamqIi6sTTRSqudgboRA folded before Flop (didn't bet)



PokerStars Game #59938876292:  Hold'em No Limit ($1/$2) - 2009/07/01 0:25:43 ET
Table 'P/yCfYl1GfGsu/e6DxDy/A' 2-max Seat #2 is the button
Seat 1: 7fOCUy3x9hdkmXkkDNolGQ ($220.50 in chips)
Seat 2: RwDoM55ZeQuI2ADyJhOb2Q ($803 in chips)
RwDoM55ZeQuI2ADyJhOb2Q: posts small blind $1
7fOCUy3x9hdkmXkkDNolGQ: posts big blind $2
*** HOLE CARDS ***
RwDoM55ZeQuI2ADyJhOb2Q: folds
7fOCUy3x9hdkmXkkDNolGQ collected $2 from pot
7fOCUy3x9hdkmXkkDNolGQ: doesn't show hand
*** SUMMARY ***
Total pot $2 | Rake $0
Seat 1: 7fOCUy3x9hdkmXkkDNolGQ (big blind) collected ($2)
Seat 2: RwDoM55ZeQuI2ADyJhOb2Q (button) (small blind) folded before Flop



PokerStars Game #59938878634:  Hold'em No Limit ($1/$2) - 2009/07/01 0:25:47 ET
Table '5G1PjWSk2ALz0O/eqyYy/g' 2-max Seat #2 is the button
Seat 1: Z4HwehErEwzsv/noQlfUlg ($184.90 in chips)
Seat 2: v4dp1VoMhJV4zmCXtmG5LQ ($200 in chips)
v4dp1VoMhJV4zmCXtmG5LQ: posts small blind $1
Z4HwehErEwzsv/noQlfUlg: posts big blind $2
*** HOLE CARDS ***
v4dp1VoMhJV4zmCXtmG5LQ: raises $4 to $6
Z4HwehErEwzsv/noQlfUlg: folds
v4dp1VoMhJV4zmCXtmG5LQ collected $4 from pot
v4dp1VoMhJV4zmCXtmG5LQ: doesn't show hand
*** SUMMARY ***
Total pot $4 | Rake $0
Seat 1: Z4HwehErEwzsv/noQlfUlg (big blind) folded before Flop
Seat 2: v4dp1VoMhJV4zmCXtmG5LQ (button) (small blind) collected ($4)



PokerStars Game #59938879396:  Hold'em No Limit ($1/$2) - 2009/07/01 0:25:48 ET
Table 'jCW99a4MXoPgL0PwEZ4IuQ' 2-max Seat #1 is the button
Seat 1: t6Jd836OSEMbcRi7rfGp5g ($212.50 in chips)
Seat 2: bWN162Ep6lKyJ0MW6unz4w ($206.50 in chips)
t6Jd836OSEMbcRi7rfGp5g: posts small blind $1
bWN162Ep6lKyJ0MW6unz4w: posts big blind $2
*** HOLE CARDS ***
t6Jd836OSEMbcRi7rfGp5g: raises $4 to $6
bWN162Ep6lKyJ0MW6unz4w: calls $4
*** FLOP *** [Ks 9d 8c]
bWN162Ep6lKyJ0MW6unz4w: checks
t6Jd836OSEMbcRi7rfGp5g: bets $8
bWN162Ep6lKyJ0MW6unz4w: folds
t6Jd836OSEMbcRi7rfGp5g collected $11.50 from pot
*** SUMMARY ***
Total pot $12 | Rake $0.50
Board [Ks 9d 8c]
Seat 1: t6Jd836OSEMbcRi7rfGp5g (button) (small blind) collected ($11.50)
Seat 2: bWN162Ep6lKyJ0MW6unz4w (big blind) folded on the Flop



PokerStars Game #59938879496:  Hold'em No Limit ($1/$2) - 2009/07/01 0:25:48 ET
Table 'CFkQcfWjKccZaZDf71FK+w' 6-max Seat #2 is the button
Seat 1: U2A5Hv6ib/5+gzO2wr7Z4w ($203 in chips)
Seat 2: X7GlkHF+lkbarCLuZ4Uf0w ($33 in chips)
Seat 3: R5/GXj0PUdNkzHU6Omb/JA ($96 in chips)
Seat 4: e8nZKSbIdIO7e2NdQe/OFQ ($233.80 in chips)
Seat 5: 1njbh8TKSUF6l4V1XwGdcg ($217.80 in chips)
R5/GXj0PUdNkzHU6Omb/JA: posts small blind $1
e8nZKSbIdIO7e2NdQe/OFQ: posts big blind $2
*** HOLE CARDS ***
1njbh8TKSUF6l4V1XwGdcg: raises $6 to $8
U2A5Hv6ib/5+gzO2wr7Z4w: folds
X7GlkHF+lkbarCLuZ4Uf0w: folds
R5/GXj0PUdNkzHU6Omb/JA: folds
e8nZKSbIdIO7e2NdQe/OFQ: folds
1njbh8TKSUF6l4V1XwGdcg collected $5 from pot
*** SUMMARY ***
Total pot $5 | Rake $0
Seat 1: U2A5Hv6ib/5+gzO2wr7Z4w folded before Flop (didn't bet)
Seat 2: X7GlkHF+lkbarCLuZ4Uf0w (button) folded before Flop (didn't bet)
Seat 3: R5/GXj0PUdNkzHU6Omb/JA (small blind) folded before Flop
Seat 4: e8nZKSbIdIO7e2NdQe/OFQ (big blind) folded before Flop
Seat 5: 1njbh8TKSUF6l4V1XwGdcg collected ($5)



PokerStars Game #59938880036:  Hold'em No Limit ($1/$2) - 2009/07/01 0:25:49 ET
Table 'QxerF7GUfCbl+4a8XaTB2w' 6-max Seat #5 is the button
Seat 1: o9jamqIi6sTTRSqudgboRA ($203 in chips)
Seat 2: 513FcCI8jHyQy2VWoIQkMg ($223.10 in chips)
Seat 3: vkfxu8f/jMYKUk6Ly4eujw ($197 in chips)
Seat 4: WfaZs12BkYO+BUX5VWpuWQ ($57.20 in chips)
Seat 5: ezK4YR9nqEKpOT/tYPvHKA ($112.05 in chips)
Seat 6: RUZs7P4uzWavoA6iEpDKLw ($146.85 in chips)
RUZs7P4uzWavoA6iEpDKLw: posts small blind $1
o9jamqIi6sTTRSqudgboRA: posts big blind $2
*** HOLE CARDS ***
513FcCI8jHyQy2VWoIQkMg: folds
vkfxu8f/jMYKUk6Ly4eujw: folds
WfaZs12BkYO+BUX5VWpuWQ: folds
ezK4YR9nqEKpOT/tYPvHKA: raises $4 to $6
RUZs7P4uzWavoA6iEpDKLw: calls $5
o9jamqIi6sTTRSqudgboRA: folds
*** FLOP *** [6d 7h 6s]
RUZs7P4uzWavoA6iEpDKLw: checks
ezK4YR9nqEKpOT/tYPvHKA: checks
*** TURN *** [6d 7h 6s] [Ad]
RUZs7P4uzWavoA6iEpDKLw: checks
ezK4YR9nqEKpOT/tYPvHKA: bets $8
RUZs7P4uzWavoA6iEpDKLw: calls $8
*** RIVER *** [6d 7h 6s Ad] [Jc]
RUZs7P4uzWavoA6iEpDKLw: checks
ezK4YR9nqEKpOT/tYPvHKA: checks
*** SHOW DOWN ***
RUZs7P4uzWavoA6iEpDKLw: shows [9d 4d] (a pair of Sixes)
ezK4YR9nqEKpOT/tYPvHKA: shows [Js Qs] (two pair, Jacks and Sixes)
ezK4YR9nqEKpOT/tYPvHKA collected $28.55 from pot
*** SUMMARY ***
Total pot $30 | Rake $1.45
Board [6d 7h 6s Ad Jc]
Seat 1: o9jamqIi6sTTRSqudgboRA (big blind) folded before Flop
Seat 2: 513FcCI8jHyQy2VWoIQkMg folded before Flop (didn't bet)
Seat 3: vkfxu8f/jMYKUk6Ly4eujw folded before Flop (didn't bet)
Seat 4: WfaZs12BkYO+BUX5VWpuWQ folded before Flop (didn't bet)
Seat 5: ezK4YR9nqEKpOT/tYPvHKA (button) showed [Js Qs] and won ($28.55) with two pair, Jacks and Sixes
Seat 6: RUZs7P4uzWavoA6iEpDKLw (small blind) showed [9d 4d] and lost with a pair of Sixes



PokerStars Game #59938880604:  Hold'em No Limit ($1/$2) - 2009/07/01 0:25:50 ET
Table 'P/yCfYl1GfGsu/e6DxDy/A' 2-max Seat #1 is the button
Seat 1: 7fOCUy3x9hdkmXkkDNolGQ ($221.50 in chips)
Seat 2: RwDoM55ZeQuI2ADyJhOb2Q ($802 in chips)
7fOCUy3x9hdkmXkkDNolGQ: posts small blind $1
RwDoM55ZeQuI2ADyJhOb2Q: posts big blind $2
*** HOLE CARDS ***
7fOCUy3x9hdkmXkkDNolGQ: raises $4 to $6
RwDoM55ZeQuI2ADyJhOb2Q: folds
7fOCUy3x9hdkmXkkDNolGQ collected $4 from pot
7fOCUy3x9hdkmXkkDNolGQ: doesn't show hand
*** SUMMARY ***
Total pot $4 | Rake $0
Seat 1: 7fOCUy3x9hdkmXkkDNolGQ (button) (small blind) collected ($4)
Seat 2: RwDoM55ZeQuI2ADyJhOb2Q (big blind) folded before Flop



PokerStars Game #59938881456:  Hold'em No Limit ($1/$2) - 2009/07/01 0:25:51 ET
Table 'XP2sRSup+aRuwzx3vDZsDg' 6-max Seat #1 is the button
Seat 1: o9jamqIi6sTTRSqudgboRA ($231.75 in chips)
Seat 2: ygTTt5ehT4aF86q1a8/R+w ($100 in chips)
Seat 3: X7GlkHF+lkbarCLuZ4Uf0w ($39 in chips)
Seat 4: hCtfSY4dRapM2rhEFmS4Ug ($123 in chips)
Seat 5: 894kvCY4GHivBpqwizsecg ($116.20 in chips)
Seat 6: h7ppRQJTYBsHCbLMeW9T2g ($446.75 in chips)
ygTTt5ehT4aF86q1a8/R+w: posts small blind $1
X7GlkHF+lkbarCLuZ4Uf0w: posts big blind $2
*** HOLE CARDS ***
hCtfSY4dRapM2rhEFmS4Ug: folds
894kvCY4GHivBpqwizsecg: raises $4 to $6
h7ppRQJTYBsHCbLMeW9T2g: folds
o9jamqIi6sTTRSqudgboRA: folds
ygTTt5ehT4aF86q1a8/R+w: folds
X7GlkHF+lkbarCLuZ4Uf0w: folds
894kvCY4GHivBpqwizsecg collected $5 from pot
*** SUMMARY ***
Total pot $5 | Rake $0
Seat 1: o9jamqIi6sTTRSqudgboRA (button) folded before Flop (didn't bet)
Seat 2: ygTTt5ehT4aF86q1a8/R+w (small blind) folded before Flop
Seat 3: X7GlkHF+lkbarCLuZ4Uf0w (big blind) folded before Flop
Seat 4: hCtfSY4dRapM2rhEFmS4Ug folded before Flop (didn't bet)
Seat 5: 894kvCY4GHivBpqwizsecg collected ($5)
Seat 6: h7ppRQJTYBsHCbLMeW9T2g folded before Flop (didn't bet)



PokerStars Game #59938885600:  Hold'em No Limit ($1/$2) - 2009/07/01 0:25:57 ET
Table '5G1PjWSk2ALz0O/eqyYy/g' 2-max Seat #1 is the button
Seat 1: Z4HwehErEwzsv/noQlfUlg ($182.90 in chips)
Seat 2: v4dp1VoMhJV4zmCXtmG5LQ ($202 in chips)
Z4HwehErEwzsv/noQlfUlg: posts small blind $1
v4dp1VoMhJV4zmCXtmG5LQ: posts big blind $2
*** HOLE CARDS ***
Z4HwehErEwzsv/noQlfUlg: calls $1
v4dp1VoMhJV4zmCXtmG5LQ: raises $6 to $8
Z4HwehErEwzsv/noQlfUlg: folds
v4dp1VoMhJV4zmCXtmG5LQ collected $4 from pot
v4dp1VoMhJV4zmCXtmG5LQ: doesn't show hand
*** SUMMARY ***
Total pot $4 | Rake $0
Seat 1: Z4HwehErEwzsv/noQlfUlg (button) (small blind) folded before Flop
Seat 2: v4dp1VoMhJV4zmCXtmG5LQ (big blind) collected ($4)



PokerStars Game #59938887824:  Hold'em No Limit ($1/$2) - 2009/07/01 0:26:00 ET
Table 'kq5zaQ+1hLNf8LZfGnbTAA' 6-max Seat #4 is the button
Seat 1: 8srN1dKQePlsv0GyTada+Q ($200 in chips)
Seat 2: H8kZwxsevA5S0PwFy0Jegg ($150.50 in chips)
Seat 3: vkfxu8f/jMYKUk6Ly4eujw ($197 in chips)
Seat 4: hjmQ/y4JIAjzsvBGw83Qmg ($168.90 in chips)
Seat 5: qXDd0ZyMIse0OBu8pxeQ3Q ($201 in chips)
Seat 6: o9jamqIi6sTTRSqudgboRA ($312.20 in chips)
qXDd0ZyMIse0OBu8pxeQ3Q: posts small blind $1
o9jamqIi6sTTRSqudgboRA: posts big blind $2
*** HOLE CARDS ***
8srN1dKQePlsv0GyTada+Q: folds
H8kZwxsevA5S0PwFy0Jegg: folds
vkfxu8f/jMYKUk6Ly4eujw: folds
hjmQ/y4JIAjzsvBGw83Qmg: folds
qXDd0ZyMIse0OBu8pxeQ3Q: raises $4 to $6
o9jamqIi6sTTRSqudgboRA: folds
qXDd0ZyMIse0OBu8pxeQ3Q collected $4 from pot
*** SUMMARY ***
Total pot $4 | Rake $0
Seat 1: 8srN1dKQePlsv0GyTada+Q folded before Flop (didn't bet)
Seat 2: H8kZwxsevA5S0PwFy0Jegg folded before Flop (didn't bet)
Seat 3: vkfxu8f/jMYKUk6Ly4eujw folded before Flop (didn't bet)
Seat 4: hjmQ/y4JIAjzsvBGw83Qmg (button) folded before Flop (didn't bet)
Seat 5: qXDd0ZyMIse0OBu8pxeQ3Q (small blind) collected ($4)
Seat 6: o9jamqIi6sTTRSqudgboRA (big blind) folded before Flop



PokerStars Game #59938888106:  Hold'em No Limit ($1/$2) - 2009/07/01 0:26:01 ET
Table 'P/yCfYl1GfGsu/e6DxDy/A' 2-max Seat #2 is the button
Seat 1: 7fOCUy3x9hdkmXkkDNolGQ ($223.50 in chips)
Seat 2: RwDoM55ZeQuI2ADyJhOb2Q ($800 in chips)
RwDoM55ZeQuI2ADyJhOb2Q: posts small blind $1
7fOCUy3x9hdkmXkkDNolGQ: posts big blind $2
*** HOLE CARDS ***
RwDoM55ZeQuI2ADyJhOb2Q: raises $4 to $6
7fOCUy3x9hdkmXkkDNolGQ: raises $14 to $20
RwDoM55ZeQuI2ADyJhOb2Q: calls $14
*** FLOP *** [6c Th 5h]
7fOCUy3x9hdkmXkkDNolGQ: checks
RwDoM55ZeQuI2ADyJhOb2Q: bets $22
7fOCUy3x9hdkmXkkDNolGQ: raises $30 to $52
RwDoM55ZeQuI2ADyJhOb2Q: calls $30
*** TURN *** [6c Th 5h] [8s]
7fOCUy3x9hdkmXkkDNolGQ: bets $151.50 and is all-in
RwDoM55ZeQuI2ADyJhOb2Q: calls $151.50
*** RIVER *** [6c Th 5h 8s] [8c]
*** SHOW DOWN ***
7fOCUy3x9hdkmXkkDNolGQ: shows [Kc Kh] (two pair, Kings and Eights)
RwDoM55ZeQuI2ADyJhOb2Q: mucks hand
7fOCUy3x9hdkmXkkDNolGQ collected $446.50 from pot
*** SUMMARY ***
Total pot $447 | Rake $0.50
Board [6c Th 5h 8s 8c]
Seat 1: 7fOCUy3x9hdkmXkkDNolGQ (big blind) showed [Kc Kh] and won ($446.50) with two pair, Kings and Eights
Seat 2: RwDoM55ZeQuI2ADyJhOb2Q (button) (small blind) mucked



PokerStars Game #59938888070:  Hold'em No Limit ($1/$2) - 2009/07/01 0:26:01 ET
Table 'jlrIxbrVIG+gjaUYT4za8g' 6-max Seat #4 is the button
Seat 1: ygTTt5ehT4aF86q1a8/R+w ($187.05 in chips)
Seat 2: N18PrNGQj43J7TJuQuu+tw ($146.55 in chips)
Seat 3: 54yWzRRgS0oZ+S6LwZBxMQ ($39.50 in chips)
Seat 4: 8srN1dKQePlsv0GyTada+Q ($228.10 in chips)
Seat 6: vkfxu8f/jMYKUk6Ly4eujw ($261.95 in chips)
vkfxu8f/jMYKUk6Ly4eujw: posts small blind $1
ygTTt5ehT4aF86q1a8/R+w: posts big blind $2
*** HOLE CARDS ***
N18PrNGQj43J7TJuQuu+tw: folds
54yWzRRgS0oZ+S6LwZBxMQ: calls $2
8srN1dKQePlsv0GyTada+Q: folds
vkfxu8f/jMYKUk6Ly4eujw: folds
CroCopHiKiK joins the table at seat #5
ygTTt5ehT4aF86q1a8/R+w: checks
*** FLOP *** [Ah Ad 3c]
ygTTt5ehT4aF86q1a8/R+w: checks
54yWzRRgS0oZ+S6LwZBxMQ: bets $4
ygTTt5ehT4aF86q1a8/R+w: folds
54yWzRRgS0oZ+S6LwZBxMQ collected $4.75 from pot
*** SUMMARY ***
Total pot $5 | Rake $0.25
Board [Ah Ad 3c]
Seat 1: ygTTt5ehT4aF86q1a8/R+w (big blind) folded on the Flop
Seat 2: N18PrNGQj43J7TJuQuu+tw folded before Flop (didn't bet)
Seat 3: 54yWzRRgS0oZ+S6LwZBxMQ collected ($4.75)
Seat 4: 8srN1dKQePlsv0GyTada+Q (button) folded before Flop (didn't bet)
Seat 6: vkfxu8f/jMYKUk6Ly4eujw (small blind) folded before Flop



PokerStars Game #59938888700:  Hold'em No Limit ($1/$2) - 2009/07/01 0:26:02 ET
Table 'gftD4mDF7mIFKvSrIyaRbw' 9-max Seat #4 is the button
Seat 2: CKDJ8bJWIRDDBziHsebH5w ($145.45 in chips)
Seat 3: CUZwDpLTQKhzarPe+JCLOQ ($200 in chips)
Seat 4: eeMEdaNqHXOk6uYL+zQnAA ($79.10 in chips)
Seat 5: mpsfNtnMVDqQHTe92AhIdw ($287.20 in chips)
Seat 6: 2NvwF8W2nzsbS+G//yLAbQ ($83.80 in chips)
Seat 7: 5iPk5MyO3KVu18Y8XCYfFQ ($40 in chips)
Seat 8: R/wPwjEcvTU2fxPXxn/XgQ ($76.55 in chips)
Seat 9: F7m34OOfAQ7annesMHVjKw ($225.30 in chips)
mpsfNtnMVDqQHTe92AhIdw: posts small blind $1
2NvwF8W2nzsbS+G//yLAbQ: posts big blind $2
*** HOLE CARDS ***
5iPk5MyO3KVu18Y8XCYfFQ: folds
R/wPwjEcvTU2fxPXxn/XgQ: folds
F7m34OOfAQ7annesMHVjKw: folds
CKDJ8bJWIRDDBziHsebH5w: folds
CUZwDpLTQKhzarPe+JCLOQ: folds
eeMEdaNqHXOk6uYL+zQnAA: folds
mpsfNtnMVDqQHTe92AhIdw: folds
2NvwF8W2nzsbS+G//yLAbQ collected $2 from pot
TAfo4veNRaRlzDXMMYS3Jg is connected
*** SUMMARY ***
Total pot $2 | Rake $0
Seat 2: CKDJ8bJWIRDDBziHsebH5w folded before Flop (didn't bet)
Seat 3: CUZwDpLTQKhzarPe+JCLOQ folded before Flop (didn't bet)
Seat 4: eeMEdaNqHXOk6uYL+zQnAA (button) folded before Flop (didn't bet)
Seat 5: mpsfNtnMVDqQHTe92AhIdw (small blind) folded before Flop
Seat 6: 2NvwF8W2nzsbS+G//yLAbQ (big blind) collected ($2)
Seat 7: 5iPk5MyO3KVu18Y8XCYfFQ folded before Flop (didn't bet)
Seat 8: R/wPwjEcvTU2fxPXxn/XgQ folded before Flop (didn't bet)
Seat 9: F7m34OOfAQ7annesMHVjKw folded before Flop (didn't bet)



PokerStars Game #59938888716:  Hold'em No Limit ($1/$2) - 2009/07/01 0:26:02 ET
Table 'mGpP9StWRnoeiBDExc6Frg' 6-max Seat #5 is the button
Seat 1: zWFU82nxIRvzK4mKiL4m0Q ($54.15 in chips)
Seat 2: DQlskgG4OtLpF2MVxLwf4A ($306.85 in chips)
Seat 3: 3HrFUl+TAqSP1U00zz3P7A ($83.40 in chips)
Seat 4: qXDd0ZyMIse0OBu8pxeQ3Q ($218 in chips)
Seat 5: d1puGuVBE0fidn+5eRJ0tw ($171 in chips)
Seat 6: X7GlkHF+lkbarCLuZ4Uf0w ($45 in chips)
X7GlkHF+lkbarCLuZ4Uf0w: posts small blind $1
zWFU82nxIRvzK4mKiL4m0Q: posts big blind $2
*** HOLE CARDS ***
DQlskgG4OtLpF2MVxLwf4A: folds
3HrFUl+TAqSP1U00zz3P7A: raises $4 to $6
qXDd0ZyMIse0OBu8pxeQ3Q: folds
d1puGuVBE0fidn+5eRJ0tw: folds
X7GlkHF+lkbarCLuZ4Uf0w: raises $39 to $45 and is all-in
zWFU82nxIRvzK4mKiL4m0Q: folds
3HrFUl+TAqSP1U00zz3P7A: folds
X7GlkHF+lkbarCLuZ4Uf0w collected $14 from pot
X7GlkHF+lkbarCLuZ4Uf0w: doesn't show hand
*** SUMMARY ***
Total pot $14 | Rake $0
Seat 1: zWFU82nxIRvzK4mKiL4m0Q (big blind) folded before Flop
Seat 2: DQlskgG4OtLpF2MVxLwf4A folded before Flop (didn't bet)
Seat 3: 3HrFUl+TAqSP1U00zz3P7A folded before Flop
Seat 4: qXDd0ZyMIse0OBu8pxeQ3Q folded before Flop (didn't bet)
Seat 5: d1puGuVBE0fidn+5eRJ0tw (button) folded before Flop (didn't bet)
Seat 6: X7GlkHF+lkbarCLuZ4Uf0w (small blind) collected ($14)



PokerStars Game #59938889614:  Hold'em No Limit ($1/$2) - 2009/07/01 0:26:03 ET
Table 'OZyw34U4j4WtFFWsEHZQgQ' 2-max Seat #1 is the button
Seat 1: pVqEzK9wXlRMECnb1Zg4Zw ($90.50 in chips)
Seat 2: rAtTyvrJ8f1LaUh2O5U4nA ($57.20 in chips)
pVqEzK9wXlRMECnb1Zg4Zw: posts small blind $1
rAtTyvrJ8f1LaUh2O5U4nA: posts big blind $2
*** HOLE CARDS ***
pVqEzK9wXlRMECnb1Zg4Zw: calls $1
rAtTyvrJ8f1LaUh2O5U4nA: checks
*** FLOP *** [9s Qd Qc]
rAtTyvrJ8f1LaUh2O5U4nA: bets $3
pVqEzK9wXlRMECnb1Zg4Zw: calls $3
*** TURN *** [9s Qd Qc] [Js]
rAtTyvrJ8f1LaUh2O5U4nA: bets $6.45
pVqEzK9wXlRMECnb1Zg4Zw: calls $6.45
*** RIVER *** [9s Qd Qc Js] [Td]
rAtTyvrJ8f1LaUh2O5U4nA: bets $13
pVqEzK9wXlRMECnb1Zg4Zw: folds
rAtTyvrJ8f1LaUh2O5U4nA collected $22.40 from pot
*** SUMMARY ***
Total pot $22.90 | Rake $0.50
Board [9s Qd Qc Js Td]
Seat 1: pVqEzK9wXlRMECnb1Zg4Zw (button) (small blind) folded on the River
Seat 2: rAtTyvrJ8f1LaUh2O5U4nA (big blind) collected ($22.40)



PokerStars Game #59938890238:  Hold'em No Limit ($1/$2) - 2009/07/01 0:26:04 ET
Table 'jCW99a4MXoPgL0PwEZ4IuQ' 2-max Seat #2 is the button
Seat 1: t6Jd836OSEMbcRi7rfGp5g ($218 in chips)
Seat 2: bWN162Ep6lKyJ0MW6unz4w ($200.50 in chips)
bWN162Ep6lKyJ0MW6unz4w: posts small blind $1
t6Jd836OSEMbcRi7rfGp5g: posts big blind $2
*** HOLE CARDS ***
bWN162Ep6lKyJ0MW6unz4w: calls $1
t6Jd836OSEMbcRi7rfGp5g: checks
*** FLOP *** [Jd 3s 8d]
t6Jd836OSEMbcRi7rfGp5g: bets $4
bWN162Ep6lKyJ0MW6unz4w: calls $4
*** TURN *** [Jd 3s 8d] [Kd]
t6Jd836OSEMbcRi7rfGp5g: bets $10
bWN162Ep6lKyJ0MW6unz4w: calls $10
*** RIVER *** [Jd 3s 8d Kd] [5c]
t6Jd836OSEMbcRi7rfGp5g: bets $32
bWN162Ep6lKyJ0MW6unz4w: calls $32
*** SHOW DOWN ***
t6Jd836OSEMbcRi7rfGp5g: shows [Qc 9h] (high card King)
bWN162Ep6lKyJ0MW6unz4w: shows [5h 8s] (two pair, Eights and Fives)
bWN162Ep6lKyJ0MW6unz4w collected $95.50 from pot
*** SUMMARY ***
Total pot $96 | Rake $0.50
Board [Jd 3s 8d Kd 5c]
Seat 1: t6Jd836OSEMbcRi7rfGp5g (big blind) showed [Qc 9h] and lost with high card King
Seat 2: bWN162Ep6lKyJ0MW6unz4w (button) (small blind) showed [5h 8s] and won ($95.50) with two pair, Eights and Fives



PokerStars Game #59938890292:  Hold'em No Limit ($1/$2) - 2009/07/01 0:26:04 ET
Table 'eyAQSIlgc2o1Jxvbve4WGg' 9-max Seat #8 is the button
Seat 1: UZEsV9yKUMqmpYPiOFpaZw ($73 in chips)
Seat 2: g7gL2NLJCdZPPV399WKT1w ($48 in chips)
Seat 4: miAHPEBdznuHNzK6YM3hRA ($139.55 in chips)
Seat 5: JnV3SM2D6dAFYyGZHHpvrg ($100 in chips)
Seat 6: IikcENBHwoT7snSvBPSc7Q ($146.60 in chips)
Seat 7: QHxJjpVYwitg9krW6wZgJA ($213.90 in chips)
Seat 8: 5iPk5MyO3KVu18Y8XCYfFQ ($40 in chips)
Seat 9: GX1heJ+DSsvm7gzSPsYhhQ ($40 in chips)
GX1heJ+DSsvm7gzSPsYhhQ: posts small blind $1
UZEsV9yKUMqmpYPiOFpaZw: posts big blind $2
*** HOLE CARDS ***
g7gL2NLJCdZPPV399WKT1w: folds
miAHPEBdznuHNzK6YM3hRA: calls $2
JnV3SM2D6dAFYyGZHHpvrg: folds
IikcENBHwoT7snSvBPSc7Q: calls $2
TAfo4veNRaRlzDXMMYS3Jg is connected
QHxJjpVYwitg9krW6wZgJA: folds
5iPk5MyO3KVu18Y8XCYfFQ: folds
GX1heJ+DSsvm7gzSPsYhhQ: folds
UZEsV9yKUMqmpYPiOFpaZw: checks
*** FLOP *** [7d Kc 2c]
UZEsV9yKUMqmpYPiOFpaZw: checks
miAHPEBdznuHNzK6YM3hRA: bets $2
IikcENBHwoT7snSvBPSc7Q: calls $2
UZEsV9yKUMqmpYPiOFpaZw: calls $2
*** TURN *** [7d Kc 2c] [8s]
TAfo4veNRaRlzDXMMYS3Jg leaves the table
UZEsV9yKUMqmpYPiOFpaZw: checks
miAHPEBdznuHNzK6YM3hRA: bets $2
IikcENBHwoT7snSvBPSc7Q: calls $2
UZEsV9yKUMqmpYPiOFpaZw: folds
*** RIVER *** [7d Kc 2c 8s] [4c]
miAHPEBdznuHNzK6YM3hRA: bets $2
IikcENBHwoT7snSvBPSc7Q: raises $6 to $8
miAHPEBdznuHNzK6YM3hRA: calls $6
*** SHOW DOWN ***
IikcENBHwoT7snSvBPSc7Q: shows [8c 3c] (a flush, King high)
miAHPEBdznuHNzK6YM3hRA: shows [5s Ks] (a pair of Kings)
IikcENBHwoT7snSvBPSc7Q collected $31.40 from pot
*** SUMMARY ***
Total pot $33 | Rake $1.60
Board [7d Kc 2c 8s 4c]
Seat 1: UZEsV9yKUMqmpYPiOFpaZw (big blind) folded on the Turn
Seat 2: g7gL2NLJCdZPPV399WKT1w folded before Flop (didn't bet)
Seat 4: miAHPEBdznuHNzK6YM3hRA showed [5s Ks] and lost with a pair of Kings
Seat 5: JnV3SM2D6dAFYyGZHHpvrg folded before Flop (didn't bet)
Seat 6: IikcENBHwoT7snSvBPSc7Q showed [8c 3c] and won ($31.40) with a flush, King high
Seat 7: QHxJjpVYwitg9krW6wZgJA folded before Flop (didn't bet)
Seat 8: 5iPk5MyO3KVu18Y8XCYfFQ (button) folded before Flop (didn't bet)
Seat 9: GX1heJ+DSsvm7gzSPsYhhQ (small blind) folded before Flop



PokerStars Game #59938892848:  Hold'em No Limit ($1/$2) - 2009/07/01 0:26:08 ET
Table 'ZzSIe0zTCDv+n6hfbY5tTg' 6-max Seat #2 is the button
Seat 2: B87ikIyZ/TzAVeXf38Ny0g ($200 in chips)
Seat 4: ky55L0pITYgYLeqFB9gP/Q ($147.40 in chips)
Seat 5: f2eTKbND+tM3kUw9o6WYWg ($147.35 in chips)
Seat 6: InmkdI6G8TzSj9NhcCSyPg ($200 in chips)
X7GlkHF+lkbarCLuZ4Uf0w will be allowed to play after the button
ky55L0pITYgYLeqFB9gP/Q: posts small blind $1
f2eTKbND+tM3kUw9o6WYWg: posts big blind $2
*** HOLE CARDS ***
InmkdI6G8TzSj9NhcCSyPg: folds
B87ikIyZ/TzAVeXf38Ny0g: folds
ky55L0pITYgYLeqFB9gP/Q: calls $1
f2eTKbND+tM3kUw9o6WYWg: checks
*** FLOP *** [2c 5s 4d]
ky55L0pITYgYLeqFB9gP/Q: bets $4
f2eTKbND+tM3kUw9o6WYWg: raises $6 to $10
ky55L0pITYgYLeqFB9gP/Q: calls $6
*** TURN *** [2c 5s 4d] [Ah]
ky55L0pITYgYLeqFB9gP/Q: checks
f2eTKbND+tM3kUw9o6WYWg: bets $18
ky55L0pITYgYLeqFB9gP/Q: folds
f2eTKbND+tM3kUw9o6WYWg collected $22.85 from pot
f2eTKbND+tM3kUw9o6WYWg: doesn't show hand
*** SUMMARY ***
Total pot $24 | Rake $1.15
Board [2c 5s 4d Ah]
Seat 2: B87ikIyZ/TzAVeXf38Ny0g (button) folded before Flop (didn't bet)
Seat 4: ky55L0pITYgYLeqFB9gP/Q (small blind) folded on the Turn
Seat 5: f2eTKbND+tM3kUw9o6WYWg (big blind) collected ($22.85)
Seat 6: InmkdI6G8TzSj9NhcCSyPg folded before Flop (didn't bet)



PokerStars Game #59938893142:  Hold'em No Limit ($1/$2) - 2009/07/01 0:26:08 ET
Table '5G1PjWSk2ALz0O/eqyYy/g' 2-max Seat #2 is the button
Seat 1: Z4HwehErEwzsv/noQlfUlg ($180.90 in chips)
Seat 2: v4dp1VoMhJV4zmCXtmG5LQ ($204 in chips)
v4dp1VoMhJV4zmCXtmG5LQ: posts small blind $1
Z4HwehErEwzsv/noQlfUlg: posts big blind $2
*** HOLE CARDS ***
v4dp1VoMhJV4zmCXtmG5LQ: folds
Z4HwehErEwzsv/noQlfUlg collected $2 from pot
Z4HwehErEwzsv/noQlfUlg: doesn't show hand
*** SUMMARY ***
Total pot $2 | Rake $0
Seat 1: Z4HwehErEwzsv/noQlfUlg (big blind) collected ($2)
Seat 2: v4dp1VoMhJV4zmCXtmG5LQ (button) (small blind) folded before Flop



PokerStars Game #59938893834:  Hold'em No Limit ($1/$2) - 2009/07/01 0:26:09 ET
Table 'uJ9juaXXg9yIcSU8amxaXQ' 6-max Seat #6 is the button
Seat 2: yynBOXUjw28V5kz84sxX4g ($154.30 in chips)
Seat 4: zNjJ/y4emmF+vzrCDd+ooA ($113.35 in chips)
Seat 5: aMZYAxFxWTQXE9aUus4sxg ($57.15 in chips)
Seat 6: XrFG4dK06RVKLlX32/pjcQ ($45.60 in chips)
JsqOjN/eHz0uYVf/PyUJ6Q will be allowed to play after the button
yynBOXUjw28V5kz84sxX4g: posts small blind $1
zNjJ/y4emmF+vzrCDd+ooA: posts big blind $2
*** HOLE CARDS ***
aMZYAxFxWTQXE9aUus4sxg: calls $2
XrFG4dK06RVKLlX32/pjcQ: folds
yynBOXUjw28V5kz84sxX4g: calls $1
zNjJ/y4emmF+vzrCDd+ooA: checks
*** FLOP *** [Qs 2s 5c]
yynBOXUjw28V5kz84sxX4g: checks
zNjJ/y4emmF+vzrCDd+ooA: checks
aMZYAxFxWTQXE9aUus4sxg: checks
*** TURN *** [Qs 2s 5c] [Jh]
yynBOXUjw28V5kz84sxX4g: checks
zNjJ/y4emmF+vzrCDd+ooA: bets $2
aMZYAxFxWTQXE9aUus4sxg: calls $2
yynBOXUjw28V5kz84sxX4g: folds
*** RIVER *** [Qs 2s 5c Jh] [6d]
zNjJ/y4emmF+vzrCDd+ooA: checks
aMZYAxFxWTQXE9aUus4sxg: checks
*** SHOW DOWN ***
zNjJ/y4emmF+vzrCDd+ooA: shows [Jd 3c] (a pair of Jacks)
aMZYAxFxWTQXE9aUus4sxg: mucks hand
zNjJ/y4emmF+vzrCDd+ooA collected $9.55 from pot
*** SUMMARY ***
Total pot $10 | Rake $0.45
Board [Qs 2s 5c Jh 6d]
Seat 2: yynBOXUjw28V5kz84sxX4g (small blind) folded on the Turn
Seat 4: zNjJ/y4emmF+vzrCDd+ooA (big blind) showed [Jd 3c] and won ($9.55) with a pair of Jacks
Seat 5: aMZYAxFxWTQXE9aUus4sxg mucked
Seat 6: XrFG4dK06RVKLlX32/pjcQ (button) folded before Flop (didn't bet)



PokerStars Game #59938894214:  Hold'em No Limit ($1/$2) - 2009/07/01 0:26:10 ET
Table 'bIihwBANJSFqlHPPtset+w' 9-max Seat #3 is the button
Seat 1: jI3JDUGV63ccqtKgM3vMbw ($156.70 in chips)
Seat 2: lQYT23h5QCUVZAKxjOO39Q ($109.90 in chips)
Seat 3: acnZ0LD5jxKgWIHz+mpQ8Q ($215.75 in chips)
Seat 4: 7WWX5PClBdr/U44gUKBIEA ($294.05 in chips)
Seat 5: rNejrG5tkeRBbL+UmC0iJA ($201.15 in chips)
Seat 6: 5iPk5MyO3KVu18Y8XCYfFQ ($66.80 in chips)
Seat 7: pCmk6FpSOLJ+85o1tLHIag ($92 in chips)
Seat 8: iMe5yhc+1BaiIPHet3NMrA ($275.65 in chips)
7WWX5PClBdr/U44gUKBIEA: posts small blind $1
rNejrG5tkeRBbL+UmC0iJA: posts big blind $2
GX1heJ+DSsvm7gzSPsYhhQ: sits out
*** HOLE CARDS ***
5iPk5MyO3KVu18Y8XCYfFQ: folds
pCmk6FpSOLJ+85o1tLHIag: calls $2
iMe5yhc+1BaiIPHet3NMrA: folds
jI3JDUGV63ccqtKgM3vMbw: calls $2
lQYT23h5QCUVZAKxjOO39Q: folds
acnZ0LD5jxKgWIHz+mpQ8Q: folds
7WWX5PClBdr/U44gUKBIEA: calls $1
rNejrG5tkeRBbL+UmC0iJA: checks
*** FLOP *** [Kc Qd Th]
7WWX5PClBdr/U44gUKBIEA: checks
rNejrG5tkeRBbL+UmC0iJA: checks
pCmk6FpSOLJ+85o1tLHIag: checks
jI3JDUGV63ccqtKgM3vMbw: checks
*** TURN *** [Kc Qd Th] [6c]
7WWX5PClBdr/U44gUKBIEA: checks
rNejrG5tkeRBbL+UmC0iJA: checks
pCmk6FpSOLJ+85o1tLHIag: checks
jI3JDUGV63ccqtKgM3vMbw: bets $6
7WWX5PClBdr/U44gUKBIEA: calls $6
rNejrG5tkeRBbL+UmC0iJA: folds
pCmk6FpSOLJ+85o1tLHIag: folds
*** RIVER *** [Kc Qd Th 6c] [5c]
7WWX5PClBdr/U44gUKBIEA: checks
jI3JDUGV63ccqtKgM3vMbw: checks
*** SHOW DOWN ***
7WWX5PClBdr/U44gUKBIEA: shows [7c Js] (high card King)
jI3JDUGV63ccqtKgM3vMbw: shows [Qc Kd] (two pair, Kings and Queens)
jI3JDUGV63ccqtKgM3vMbw collected $19.05 from pot
*** SUMMARY ***
Total pot $20 | Rake $0.95
Board [Kc Qd Th 6c 5c]
Seat 1: jI3JDUGV63ccqtKgM3vMbw showed [Qc Kd] and won ($19.05) with two pair, Kings and Queens
Seat 2: lQYT23h5QCUVZAKxjOO39Q folded before Flop (didn't bet)
Seat 3: acnZ0LD5jxKgWIHz+mpQ8Q (button) folded before Flop (didn't bet)
Seat 4: 7WWX5PClBdr/U44gUKBIEA (small blind) showed [7c Js] and lost with high card King
Seat 5: rNejrG5tkeRBbL+UmC0iJA (big blind) folded on the Turn
Seat 6: 5iPk5MyO3KVu18Y8XCYfFQ folded before Flop (didn't bet)
Seat 7: pCmk6FpSOLJ+85o1tLHIag folded on the Turn
Seat 8: iMe5yhc+1BaiIPHet3NMrA folded before Flop (didn't bet)



PokerStars Game #59938894540:  Hold'em No Limit ($1/$2) - 2009/07/01 0:26:10 ET
Table 'NmY84NAf9Mh0ckAckHnh5g' 2-max Seat #1 is the button
Seat 1: 6hvg964TSqZ3AL/0XK9aVQ ($493.75 in chips)
Seat 2: RwDoM55ZeQuI2ADyJhOb2Q ($348.50 in chips)
6hvg964TSqZ3AL/0XK9aVQ: posts small blind $1
RwDoM55ZeQuI2ADyJhOb2Q: posts big blind $2
*** HOLE CARDS ***
6hvg964TSqZ3AL/0XK9aVQ: calls $1
RwDoM55ZeQuI2ADyJhOb2Q: checks
*** FLOP *** [6d 7d 4h]
RwDoM55ZeQuI2ADyJhOb2Q: checks
6hvg964TSqZ3AL/0XK9aVQ: checks
*** TURN *** [6d 7d 4h] [6h]
RwDoM55ZeQuI2ADyJhOb2Q: bets $4
6hvg964TSqZ3AL/0XK9aVQ: calls $4
*** RIVER *** [6d 7d 4h 6h] [5d]
RwDoM55ZeQuI2ADyJhOb2Q: checks
6hvg964TSqZ3AL/0XK9aVQ: checks
*** SHOW DOWN ***
RwDoM55ZeQuI2ADyJhOb2Q: shows [2d 6s] (three of a kind, Sixes)
6hvg964TSqZ3AL/0XK9aVQ: mucks hand
RwDoM55ZeQuI2ADyJhOb2Q collected $11.50 from pot
*** SUMMARY ***
Total pot $12 | Rake $0.50
Board [6d 7d 4h 6h 5d]
Seat 1: 6hvg964TSqZ3AL/0XK9aVQ (button) (small blind) mucked
Seat 2: RwDoM55ZeQuI2ADyJhOb2Q (big blind) showed [2d 6s] and won ($11.50) with three of a kind, Sixes



PokerStars Game #59938897170:  Hold'em No Limit ($1/$2) - 2009/07/01 0:26:15 ET
Table 'CFkQcfWjKccZaZDf71FK+w' 6-max Seat #3 is the button
Seat 1: U2A5Hv6ib/5+gzO2wr7Z4w ($203 in chips)
Seat 2: X7GlkHF+lkbarCLuZ4Uf0w ($33 in chips)
Seat 3: R5/GXj0PUdNkzHU6Omb/JA ($95 in chips)
Seat 4: e8nZKSbIdIO7e2NdQe/OFQ ($231.80 in chips)
Seat 5: 1njbh8TKSUF6l4V1XwGdcg ($220.80 in chips)
e8nZKSbIdIO7e2NdQe/OFQ: posts small blind $1
1njbh8TKSUF6l4V1XwGdcg: posts big blind $2
*** HOLE CARDS ***
U2A5Hv6ib/5+gzO2wr7Z4w: folds
X7GlkHF+lkbarCLuZ4Uf0w: raises $2 to $4
R5/GXj0PUdNkzHU6Omb/JA: folds
e8nZKSbIdIO7e2NdQe/OFQ: folds
1njbh8TKSUF6l4V1XwGdcg: raises $8 to $12
X7GlkHF+lkbarCLuZ4Uf0w: folds
1njbh8TKSUF6l4V1XwGdcg collected $9 from pot
*** SUMMARY ***
Total pot $9 | Rake $0
Seat 1: U2A5Hv6ib/5+gzO2wr7Z4w folded before Flop (didn't bet)
Seat 2: X7GlkHF+lkbarCLuZ4Uf0w folded before Flop
Seat 3: R5/GXj0PUdNkzHU6Omb/JA (button) folded before Flop (didn't bet)
Seat 4: e8nZKSbIdIO7e2NdQe/OFQ (small blind) folded before Flop
Seat 5: 1njbh8TKSUF6l4V1XwGdcg (big blind) collected ($9)



PokerStars Game #59938898260:  Hold'em No Limit ($1/$2) - 2009/07/01 0:26:16 ET
Table '5G1PjWSk2ALz0O/eqyYy/g' 2-max Seat #1 is the button
Seat 1: Z4HwehErEwzsv/noQlfUlg ($181.90 in chips)
Seat 2: v4dp1VoMhJV4zmCXtmG5LQ ($203 in chips)
Z4HwehErEwzsv/noQlfUlg: posts small blind $1
v4dp1VoMhJV4zmCXtmG5LQ: posts big blind $2
*** HOLE CARDS ***
Z4HwehErEwzsv/noQlfUlg: raises $4 to $6
v4dp1VoMhJV4zmCXtmG5LQ: calls $4
*** FLOP *** [2h 5d 7d]
v4dp1VoMhJV4zmCXtmG5LQ: checks
Z4HwehErEwzsv/noQlfUlg: checks
*** TURN *** [2h 5d 7d] [9c]
v4dp1VoMhJV4zmCXtmG5LQ: bets $12
Z4HwehErEwzsv/noQlfUlg: calls $12
*** RIVER *** [2h 5d 7d 9c] [5c]
v4dp1VoMhJV4zmCXtmG5LQ: bets $32
Z4HwehErEwzsv/noQlfUlg: calls $32
*** SHOW DOWN ***
v4dp1VoMhJV4zmCXtmG5LQ: shows [2s 2c] (a full house, Deuces full of Fives)
Z4HwehErEwzsv/noQlfUlg: shows [9s Js] (two pair, Nines and Fives)
v4dp1VoMhJV4zmCXtmG5LQ collected $99.50 from pot
*** SUMMARY ***
Total pot $100 | Rake $0.50
Board [2h 5d 7d 9c 5c]
Seat 1: Z4HwehErEwzsv/noQlfUlg (button) (small blind) showed [9s Js] and lost with two pair, Nines and Fives
Seat 2: v4dp1VoMhJV4zmCXtmG5LQ (big blind) showed [2s 2c] and won ($99.50) with a full house, Deuces full of Fives



PokerStars Game #59938898344:  Hold'em No Limit ($1/$2) - 2009/07/01 0:26:16 ET
Table 'aSf77Sj8QEnzcc0WaxVD4Q' 6-max Seat #5 is the button
Seat 1: 54yWzRRgS0oZ+S6LwZBxMQ ($37 in chips)
Seat 2: vkfxu8f/jMYKUk6Ly4eujw ($244.15 in chips)
Seat 3: 9dpyyjDTCed6nV7JhaUUpw ($204.30 in chips)
Seat 4: 513FcCI8jHyQy2VWoIQkMg ($202 in chips)
Seat 5: InmkdI6G8TzSj9NhcCSyPg ($257.65 in chips)
Seat 6: vkoJRf3gidxY1pPi0AFWww ($299.80 in chips)
vkoJRf3gidxY1pPi0AFWww: posts small blind $1
54yWzRRgS0oZ+S6LwZBxMQ: posts big blind $2
*** HOLE CARDS ***
vkfxu8f/jMYKUk6Ly4eujw: folds
9dpyyjDTCed6nV7JhaUUpw: folds
513FcCI8jHyQy2VWoIQkMg: folds
InmkdI6G8TzSj9NhcCSyPg: folds
vkoJRf3gidxY1pPi0AFWww: calls $1
54yWzRRgS0oZ+S6LwZBxMQ: checks
*** FLOP *** [Th Kc 8s]
vkoJRf3gidxY1pPi0AFWww: checks
54yWzRRgS0oZ+S6LwZBxMQ: bets $4
vkoJRf3gidxY1pPi0AFWww: folds
54yWzRRgS0oZ+S6LwZBxMQ collected $3.80 from pot
54yWzRRgS0oZ+S6LwZBxMQ: doesn't show hand
*** SUMMARY ***
Total pot $4 | Rake $0.20
Board [Th Kc 8s]
Seat 1: 54yWzRRgS0oZ+S6LwZBxMQ (big blind) collected ($3.80)
Seat 2: vkfxu8f/jMYKUk6Ly4eujw folded before Flop (didn't bet)
Seat 3: 9dpyyjDTCed6nV7JhaUUpw folded before Flop (didn't bet)
Seat 4: 513FcCI8jHyQy2VWoIQkMg folded before Flop (didn't bet)
Seat 5: InmkdI6G8TzSj9NhcCSyPg (button) folded before Flop (didn't bet)
Seat 6: vkoJRf3gidxY1pPi0AFWww (small blind) folded on the Flop



PokerStars Game #59938898956:  Hold'em No Limit ($1/$2) - 2009/07/01 0:26:17 ET
Table 'gnHBqWll9O3fxG7Ojkz/ng' 9-max Seat #3 is the button
Seat 1: hpqdC/23wXosGOmzARr5NA ($179.05 in chips)
Seat 2: H6Z4+qu8gR0VUiPOijndVg ($200 in chips)
Seat 3: 5Q8U6iZbeO7xJSS4qvDP5g ($228.35 in chips)
Seat 4: n5XI5/7gN+gIubHFBH+mOw ($370.90 in chips)
Seat 5: rBQDMkKm9cZn6M9NPsiVew ($170.45 in chips)
Seat 6: 5iPk5MyO3KVu18Y8XCYfFQ ($40 in chips)
Seat 7: jqui3xAWCkcdPW36a6BD+w ($212.55 in chips)
Seat 8: cM6efHzdxoqYm0EQKP4TTQ ($105.80 in chips)
n5XI5/7gN+gIubHFBH+mOw: posts small blind $1
rBQDMkKm9cZn6M9NPsiVew: posts big blind $2
GX1heJ+DSsvm7gzSPsYhhQ: sits out
*** HOLE CARDS ***
5iPk5MyO3KVu18Y8XCYfFQ: folds
jqui3xAWCkcdPW36a6BD+w: folds
cM6efHzdxoqYm0EQKP4TTQ: folds
hpqdC/23wXosGOmzARr5NA: folds
H6Z4+qu8gR0VUiPOijndVg: folds
5Q8U6iZbeO7xJSS4qvDP5g: raises $4 to $6
n5XI5/7gN+gIubHFBH+mOw: folds
rBQDMkKm9cZn6M9NPsiVew: folds
5Q8U6iZbeO7xJSS4qvDP5g collected $5 from pot
5Q8U6iZbeO7xJSS4qvDP5g: doesn't show hand
*** SUMMARY ***
Total pot $5 | Rake $0
Seat 1: hpqdC/23wXosGOmzARr5NA folded before Flop (didn't bet)
Seat 2: H6Z4+qu8gR0VUiPOijndVg folded before Flop (didn't bet)
Seat 3: 5Q8U6iZbeO7xJSS4qvDP5g (button) collected ($5)
Seat 4: n5XI5/7gN+gIubHFBH+mOw (small blind) folded before Flop
Seat 5: rBQDMkKm9cZn6M9NPsiVew (big blind) folded before Flop
Seat 6: 5iPk5MyO3KVu18Y8XCYfFQ folded before Flop (didn't bet)
Seat 7: jqui3xAWCkcdPW36a6BD+w folded before Flop (didn't bet)
Seat 8: cM6efHzdxoqYm0EQKP4TTQ folded before Flop (didn't bet)



PokerStars Game #59938900426:  Hold'em No Limit ($1/$2) - 2009/07/01 0:26:20 ET
Table 'QxerF7GUfCbl+4a8XaTB2w' 6-max Seat #6 is the button
Seat 1: o9jamqIi6sTTRSqudgboRA ($201 in chips)
Seat 2: 513FcCI8jHyQy2VWoIQkMg ($223.10 in chips)
Seat 3: vkfxu8f/jMYKUk6Ly4eujw ($197 in chips)
Seat 4: WfaZs12BkYO+BUX5VWpuWQ ($57.20 in chips)
Seat 5: ezK4YR9nqEKpOT/tYPvHKA ($126.60 in chips)
Seat 6: RUZs7P4uzWavoA6iEpDKLw ($132.85 in chips)
o9jamqIi6sTTRSqudgboRA: posts small blind $1
513FcCI8jHyQy2VWoIQkMg: posts big blind $2
*** HOLE CARDS ***
vkfxu8f/jMYKUk6Ly4eujw: folds
WfaZs12BkYO+BUX5VWpuWQ: folds
ezK4YR9nqEKpOT/tYPvHKA: folds
RUZs7P4uzWavoA6iEpDKLw: folds
o9jamqIi6sTTRSqudgboRA: raises $5 to $7
513FcCI8jHyQy2VWoIQkMg: folds
o9jamqIi6sTTRSqudgboRA collected $4 from pot
o9jamqIi6sTTRSqudgboRA: doesn't show hand
*** SUMMARY ***
Total pot $4 | Rake $0
Seat 1: o9jamqIi6sTTRSqudgboRA (small blind) collected ($4)
Seat 2: 513FcCI8jHyQy2VWoIQkMg (big blind) folded before Flop
Seat 3: vkfxu8f/jMYKUk6Ly4eujw folded before Flop (didn't bet)
Seat 4: WfaZs12BkYO+BUX5VWpuWQ folded before Flop (didn't bet)
Seat 5: ezK4YR9nqEKpOT/tYPvHKA folded before Flop (didn't bet)
Seat 6: RUZs7P4uzWavoA6iEpDKLw (button) folded before Flop (didn't bet)



PokerStars Game #59938903550:  Hold'em No Limit ($1/$2) - 2009/07/01 0:26:24 ET
Table 'kq5zaQ+1hLNf8LZfGnbTAA' 6-max Seat #5 is the button
Seat 1: 8srN1dKQePlsv0GyTada+Q ($200 in chips)
Seat 2: H8kZwxsevA5S0PwFy0Jegg ($150.50 in chips)
Seat 3: vkfxu8f/jMYKUk6Ly4eujw ($197 in chips)
Seat 4: hjmQ/y4JIAjzsvBGw83Qmg ($168.90 in chips)
Seat 5: qXDd0ZyMIse0OBu8pxeQ3Q ($203 in chips)
Seat 6: o9jamqIi6sTTRSqudgboRA ($310.20 in chips)
o9jamqIi6sTTRSqudgboRA: posts small blind $1
8srN1dKQePlsv0GyTada+Q: posts big blind $2
*** HOLE CARDS ***
H8kZwxsevA5S0PwFy0Jegg: calls $2
vkfxu8f/jMYKUk6Ly4eujw: folds
hjmQ/y4JIAjzsvBGw83Qmg: folds
qXDd0ZyMIse0OBu8pxeQ3Q: folds
o9jamqIi6sTTRSqudgboRA: calls $1
8srN1dKQePlsv0GyTada+Q: checks
*** FLOP *** [8c Qc Ks]
o9jamqIi6sTTRSqudgboRA: bets $5
8srN1dKQePlsv0GyTada+Q: folds
H8kZwxsevA5S0PwFy0Jegg: calls $5
*** TURN *** [8c Qc Ks] [Tc]
o9jamqIi6sTTRSqudgboRA: bets $12
H8kZwxsevA5S0PwFy0Jegg: calls $12
*** RIVER *** [8c Qc Ks Tc] [Js]
o9jamqIi6sTTRSqudgboRA: checks
hjmQ/y4JIAjzsvBGw83Qmg is disconnected
H8kZwxsevA5S0PwFy0Jegg: bets $10
o9jamqIi6sTTRSqudgboRA: folds
H8kZwxsevA5S0PwFy0Jegg collected $38.05 from pot
*** SUMMARY ***
Total pot $40 | Rake $1.95
Board [8c Qc Ks Tc Js]
Seat 1: 8srN1dKQePlsv0GyTada+Q (big blind) folded on the Flop
Seat 2: H8kZwxsevA5S0PwFy0Jegg collected ($38.05)
Seat 3: vkfxu8f/jMYKUk6Ly4eujw folded before Flop (didn't bet)
Seat 4: hjmQ/y4JIAjzsvBGw83Qmg folded before Flop (didn't bet)
Seat 5: qXDd0ZyMIse0OBu8pxeQ3Q (button) folded before Flop (didn't bet)
Seat 6: o9jamqIi6sTTRSqudgboRA (small blind) folded on the River



PokerStars Game #59938904572:  Hold'em No Limit ($1/$2) - 2009/07/01 0:26:26 ET
Table 'gftD4mDF7mIFKvSrIyaRbw' 9-max Seat #5 is the button
Seat 2: CKDJ8bJWIRDDBziHsebH5w ($145.45 in chips)
Seat 3: CUZwDpLTQKhzarPe+JCLOQ ($200 in chips)
Seat 4: eeMEdaNqHXOk6uYL+zQnAA ($79.10 in chips)
Seat 5: mpsfNtnMVDqQHTe92AhIdw ($286.20 in chips)
Seat 6: 2NvwF8W2nzsbS+G//yLAbQ ($84.80 in chips)
Seat 7: 5iPk5MyO3KVu18Y8XCYfFQ ($40 in chips)
Seat 8: R/wPwjEcvTU2fxPXxn/XgQ ($76.55 in chips)
Seat 9: F7m34OOfAQ7annesMHVjKw ($225.30 in chips)
2NvwF8W2nzsbS+G//yLAbQ: posts small blind $1
5iPk5MyO3KVu18Y8XCYfFQ: posts big blind $2
*** HOLE CARDS ***
R/wPwjEcvTU2fxPXxn/XgQ: folds
F7m34OOfAQ7annesMHVjKw: raises $2 to $4
CKDJ8bJWIRDDBziHsebH5w: folds
CUZwDpLTQKhzarPe+JCLOQ: folds
eeMEdaNqHXOk6uYL+zQnAA: folds
mpsfNtnMVDqQHTe92AhIdw: folds
2NvwF8W2nzsbS+G//yLAbQ: calls $3
5iPk5MyO3KVu18Y8XCYfFQ: folds
*** FLOP *** [Kd 4c 5s]
2NvwF8W2nzsbS+G//yLAbQ: checks
F7m34OOfAQ7annesMHVjKw: bets $4
TAfo4veNRaRlzDXMMYS3Jg leaves the table
2NvwF8W2nzsbS+G//yLAbQ: calls $4
*** TURN *** [Kd 4c 5s] [8h]
2NvwF8W2nzsbS+G//yLAbQ: bets $6
F7m34OOfAQ7annesMHVjKw: folds
2NvwF8W2nzsbS+G//yLAbQ collected $17.15 from pot
*** SUMMARY ***
Total pot $18 | Rake $0.85
Board [Kd 4c 5s 8h]
Seat 2: CKDJ8bJWIRDDBziHsebH5w folded before Flop (didn't bet)
Seat 3: CUZwDpLTQKhzarPe+JCLOQ folded before Flop (didn't bet)
Seat 4: eeMEdaNqHXOk6uYL+zQnAA folded before Flop (didn't bet)
Seat 5: mpsfNtnMVDqQHTe92AhIdw (button) folded before Flop (didn't bet)
Seat 6: 2NvwF8W2nzsbS+G//yLAbQ (small blind) collected ($17.15)
Seat 7: 5iPk5MyO3KVu18Y8XCYfFQ (big blind) folded before Flop
Seat 8: R/wPwjEcvTU2fxPXxn/XgQ folded before Flop (didn't bet)
Seat 9: F7m34OOfAQ7annesMHVjKw folded on the Turn



PokerStars Game #59938905468:  Hold'em No Limit ($1/$2) - 2009/07/01 0:26:27 ET
Table 'XP2sRSup+aRuwzx3vDZsDg' 6-max Seat #2 is the button
Seat 1: o9jamqIi6sTTRSqudgboRA ($231.75 in chips)
Seat 2: ygTTt5ehT4aF86q1a8/R+w ($100 in chips)
Seat 3: X7GlkHF+lkbarCLuZ4Uf0w ($37 in chips)
Seat 4: hCtfSY4dRapM2rhEFmS4Ug ($123 in chips)
Seat 5: 894kvCY4GHivBpqwizsecg ($119.20 in chips)
Seat 6: h7ppRQJTYBsHCbLMeW9T2g ($446.75 in chips)
X7GlkHF+lkbarCLuZ4Uf0w: posts small blind $1
hCtfSY4dRapM2rhEFmS4Ug: posts big blind $2
*** HOLE CARDS ***
894kvCY4GHivBpqwizsecg: folds
h7ppRQJTYBsHCbLMeW9T2g: folds
o9jamqIi6sTTRSqudgboRA: folds
ygTTt5ehT4aF86q1a8/R+w: folds
X7GlkHF+lkbarCLuZ4Uf0w: raises $3 to $5
hCtfSY4dRapM2rhEFmS4Ug: calls $3
*** FLOP *** [Th Qs 8c]
X7GlkHF+lkbarCLuZ4Uf0w: checks
hCtfSY4dRapM2rhEFmS4Ug: bets $6
X7GlkHF+lkbarCLuZ4Uf0w: folds
hCtfSY4dRapM2rhEFmS4Ug collected $9.50 from pot
*** SUMMARY ***
Total pot $10 | Rake $0.50
Board [Th Qs 8c]
Seat 1: o9jamqIi6sTTRSqudgboRA folded before Flop (didn't bet)
Seat 2: ygTTt5ehT4aF86q1a8/R+w (button) folded before Flop (didn't bet)
Seat 3: X7GlkHF+lkbarCLuZ4Uf0w (small blind) folded on the Flop
Seat 4: hCtfSY4dRapM2rhEFmS4Ug (big blind) collected ($9.50)
Seat 5: 894kvCY4GHivBpqwizsecg folded before Flop (didn't bet)
Seat 6: h7ppRQJTYBsHCbLMeW9T2g folded before Flop (didn't bet)



PokerStars Game #59938906300:  Hold'em No Limit ($1/$2) - 2009/07/01 0:26:28 ET
Table 'jCW99a4MXoPgL0PwEZ4IuQ' 2-max Seat #1 is the button
Seat 1: t6Jd836OSEMbcRi7rfGp5g ($200 in chips)
Seat 2: bWN162Ep6lKyJ0MW6unz4w ($248 in chips)
t6Jd836OSEMbcRi7rfGp5g: posts small blind $1
bWN162Ep6lKyJ0MW6unz4w: posts big blind $2
*** HOLE CARDS ***
t6Jd836OSEMbcRi7rfGp5g: raises $4 to $6
bWN162Ep6lKyJ0MW6unz4w: raises $12 to $18
t6Jd836OSEMbcRi7rfGp5g: folds
bWN162Ep6lKyJ0MW6unz4w collected $12 from pot
bWN162Ep6lKyJ0MW6unz4w: doesn't show hand
*** SUMMARY ***
Total pot $12 | Rake $0
Seat 1: t6Jd836OSEMbcRi7rfGp5g (button) (small blind) folded before Flop
Seat 2: bWN162Ep6lKyJ0MW6unz4w (big blind) collected ($12)



PokerStars Game #59938906640:  Hold'em No Limit ($1/$2) - 2009/07/01 0:26:29 ET
Table 'mGpP9StWRnoeiBDExc6Frg' 6-max Seat #6 is the button
Seat 1: zWFU82nxIRvzK4mKiL4m0Q ($52.15 in chips)
Seat 2: DQlskgG4OtLpF2MVxLwf4A ($306.85 in chips)
Seat 3: 3HrFUl+TAqSP1U00zz3P7A ($77.40 in chips)
Seat 4: qXDd0ZyMIse0OBu8pxeQ3Q ($218 in chips)
Seat 5: d1puGuVBE0fidn+5eRJ0tw ($171 in chips)
Seat 6: X7GlkHF+lkbarCLuZ4Uf0w ($53 in chips)
zWFU82nxIRvzK4mKiL4m0Q: posts small blind $1
DQlskgG4OtLpF2MVxLwf4A: posts big blind $2
*** HOLE CARDS ***
3HrFUl+TAqSP1U00zz3P7A: folds
qXDd0ZyMIse0OBu8pxeQ3Q: folds
d1puGuVBE0fidn+5eRJ0tw: calls $2
X7GlkHF+lkbarCLuZ4Uf0w: folds
zWFU82nxIRvzK4mKiL4m0Q: calls $1
DQlskgG4OtLpF2MVxLwf4A: checks
*** FLOP *** [Ks 5d 6h]
zWFU82nxIRvzK4mKiL4m0Q: checks
DQlskgG4OtLpF2MVxLwf4A: checks
d1puGuVBE0fidn+5eRJ0tw: bets $6
zWFU82nxIRvzK4mKiL4m0Q: folds
DQlskgG4OtLpF2MVxLwf4A: calls $6
*** TURN *** [Ks 5d 6h] [5s]
DQlskgG4OtLpF2MVxLwf4A: checks
d1puGuVBE0fidn+5eRJ0tw: bets $8
DQlskgG4OtLpF2MVxLwf4A: calls $8
*** RIVER *** [Ks 5d 6h 5s] [7h]
DQlskgG4OtLpF2MVxLwf4A: checks
d1puGuVBE0fidn+5eRJ0tw: bets $20
DQlskgG4OtLpF2MVxLwf4A: calls $20
*** SHOW DOWN ***
d1puGuVBE0fidn+5eRJ0tw: shows [3c 3h] (two pair, Fives and Threes)
DQlskgG4OtLpF2MVxLwf4A: shows [9h Kh] (two pair, Kings and Fives)
DQlskgG4OtLpF2MVxLwf4A collected $71 from pot
*** SUMMARY ***
Total pot $74 | Rake $3
Board [Ks 5d 6h 5s 7h]
Seat 1: zWFU82nxIRvzK4mKiL4m0Q (small blind) folded on the Flop
Seat 2: DQlskgG4OtLpF2MVxLwf4A (big blind) showed [9h Kh] and won ($71) with two pair, Kings and Fives
Seat 3: 3HrFUl+TAqSP1U00zz3P7A folded before Flop (didn't bet)
Seat 4: qXDd0ZyMIse0OBu8pxeQ3Q folded before Flop (didn't bet)
Seat 5: d1puGuVBE0fidn+5eRJ0tw showed [3c 3h] and lost with two pair, Fives and Threes
Seat 6: X7GlkHF+lkbarCLuZ4Uf0w (button) folded before Flop (didn't bet)



PokerStars Game #59938907228:  Hold'em No Limit ($1/$2) - 2009/07/01 0:26:30 ET
Table 'srul5UFZXTEccVV5fpY91g' 9-max Seat #5 is the button
Seat 1: lfD8cBv31A/pio3pXJbPjA ($153.20 in chips)
Seat 2: tJYod1SLp2AcWPL/3hZ7ug ($80.95 in chips)
Seat 3: weUZ8S7tgbaeIpzi1gBNxQ ($34.75 in chips)
Seat 4: GG5lTuGt3+kwNYSbqeB6yw ($85.40 in chips)
Seat 5: 5iPk5MyO3KVu18Y8XCYfFQ ($76.55 in chips)
Seat 7: s0erZsDxbZSaEPheMgibKg ($442.10 in chips)
Seat 8: UZEsV9yKUMqmpYPiOFpaZw ($76 in chips)
Seat 9: jRGC4KXXODbHEN275TXFCA ($182.30 in chips)
s0erZsDxbZSaEPheMgibKg: posts small blind $1
UZEsV9yKUMqmpYPiOFpaZw: posts big blind $2
*** HOLE CARDS ***
jRGC4KXXODbHEN275TXFCA: calls $2
TAfo4veNRaRlzDXMMYS3Jg has returned
lfD8cBv31A/pio3pXJbPjA: folds
tJYod1SLp2AcWPL/3hZ7ug: folds
weUZ8S7tgbaeIpzi1gBNxQ: raises $6 to $8
GG5lTuGt3+kwNYSbqeB6yw: calls $8
5iPk5MyO3KVu18Y8XCYfFQ: folds
s0erZsDxbZSaEPheMgibKg: folds
UZEsV9yKUMqmpYPiOFpaZw: folds
jRGC4KXXODbHEN275TXFCA: raises $34 to $42
weUZ8S7tgbaeIpzi1gBNxQ: calls $26.75 and is all-in
GG5lTuGt3+kwNYSbqeB6yw: calls $34
*** FLOP *** [Kc 4h Qd]
jRGC4KXXODbHEN275TXFCA: checks
GG5lTuGt3+kwNYSbqeB6yw: bets $43.40 and is all-in
jRGC4KXXODbHEN275TXFCA: folds
*** TURN *** [Kc 4h Qd] [2s]
*** RIVER *** [Kc 4h Qd 2s] [Qs]
*** SHOW DOWN ***
GG5lTuGt3+kwNYSbqeB6yw: shows [Kd Ts] (two pair, Kings and Queens)
GG5lTuGt3+kwNYSbqeB6yw collected $14.50 from side pot
weUZ8S7tgbaeIpzi1gBNxQ: mucks hand
GG5lTuGt3+kwNYSbqeB6yw collected $104.25 from main pot
*** SUMMARY ***
Total pot $121.75 Main pot $104.25. Side pot $14.50. | Rake $3
Board [Kc 4h Qd 2s Qs]
Seat 1: lfD8cBv31A/pio3pXJbPjA folded before Flop (didn't bet)
Seat 2: tJYod1SLp2AcWPL/3hZ7ug folded before Flop (didn't bet)
Seat 3: weUZ8S7tgbaeIpzi1gBNxQ mucked
Seat 4: GG5lTuGt3+kwNYSbqeB6yw showed [Kd Ts] and won ($118.75) with two pair, Kings and Queens
Seat 5: 5iPk5MyO3KVu18Y8XCYfFQ (button) folded before Flop (didn't bet)
Seat 7: s0erZsDxbZSaEPheMgibKg (small blind) folded before Flop
Seat 8: UZEsV9yKUMqmpYPiOFpaZw (big blind) folded before Flop
Seat 9: jRGC4KXXODbHEN275TXFCA folded on the Flop



PokerStars Game #59938908734:  Hold'em No Limit ($1/$2) - 2009/07/01 0:26:32 ET
Table '+hSnXFQrGw1PlVgTnuj+sA' 6-max Seat #4 is the button
Seat 2: 54yWzRRgS0oZ+S6LwZBxMQ ($33.80 in chips)
Seat 3: 1njbh8TKSUF6l4V1XwGdcg ($207.30 in chips)
Seat 4: sTPOWERd9HWPCNrDBwsVjA ($377 in chips)
Seat 5: /PH6Ffnho4Ysm8S3V/oa+w ($40 in chips)
Seat 6: RwDoM55ZeQuI2ADyJhOb2Q ($172.50 in chips)
/PH6Ffnho4Ysm8S3V/oa+w: posts small blind $1
RwDoM55ZeQuI2ADyJhOb2Q: posts big blind $2
*** HOLE CARDS ***
54yWzRRgS0oZ+S6LwZBxMQ: folds
1njbh8TKSUF6l4V1XwGdcg: raises $4 to $6
mfy7uGZcqA2PVQqEVbJ7+g joins the table at seat #1
sTPOWERd9HWPCNrDBwsVjA: calls $6
/PH6Ffnho4Ysm8S3V/oa+w: folds
RwDoM55ZeQuI2ADyJhOb2Q: calls $4
*** FLOP *** [Kh 6h 7s]
RwDoM55ZeQuI2ADyJhOb2Q: checks
1njbh8TKSUF6l4V1XwGdcg: bets $12
sTPOWERd9HWPCNrDBwsVjA: folds
RwDoM55ZeQuI2ADyJhOb2Q: calls $12
*** TURN *** [Kh 6h 7s] [Qs]
RwDoM55ZeQuI2ADyJhOb2Q: checks
1njbh8TKSUF6l4V1XwGdcg: bets $32
RwDoM55ZeQuI2ADyJhOb2Q: calls $32
*** RIVER *** [Kh 6h 7s Qs] [6d]
RwDoM55ZeQuI2ADyJhOb2Q: checks
1njbh8TKSUF6l4V1XwGdcg: bets $148
RwDoM55ZeQuI2ADyJhOb2Q: folds
1njbh8TKSUF6l4V1XwGdcg collected $105 from pot
*** SUMMARY ***
Total pot $107 | Rake $2
Board [Kh 6h 7s Qs 6d]
Seat 2: 54yWzRRgS0oZ+S6LwZBxMQ folded before Flop (didn't bet)
Seat 3: 1njbh8TKSUF6l4V1XwGdcg collected ($105)
Seat 4: sTPOWERd9HWPCNrDBwsVjA (button) folded on the Flop
Seat 5: /PH6Ffnho4Ysm8S3V/oa+w (small blind) folded before Flop
Seat 6: RwDoM55ZeQuI2ADyJhOb2Q (big blind) folded on the River



PokerStars Game #59938909026:  Hold'em No Limit ($1/$2) - 2009/07/01 0:26:33 ET
Table 'jlrIxbrVIG+gjaUYT4za8g' 6-max Seat #6 is the button
Seat 1: ygTTt5ehT4aF86q1a8/R+w ($185.05 in chips)
Seat 2: N18PrNGQj43J7TJuQuu+tw ($146.55 in chips)
Seat 3: 54yWzRRgS0oZ+S6LwZBxMQ ($42.25 in chips)
Seat 4: 8srN1dKQePlsv0GyTada+Q ($228.10 in chips)
Seat 6: vkfxu8f/jMYKUk6Ly4eujw ($260.95 in chips)
ygTTt5ehT4aF86q1a8/R+w: posts small blind $1
N18PrNGQj43J7TJuQuu+tw: posts big blind $2
CroCopHiKiK: sits out
*** HOLE CARDS ***
54yWzRRgS0oZ+S6LwZBxMQ: folds
8srN1dKQePlsv0GyTada+Q: folds
vkfxu8f/jMYKUk6Ly4eujw: folds
ygTTt5ehT4aF86q1a8/R+w: raises $4 to $6
N18PrNGQj43J7TJuQuu+tw: calls $4
*** FLOP *** [3d Ts Qd]
ygTTt5ehT4aF86q1a8/R+w: bets $6
N18PrNGQj43J7TJuQuu+tw: calls $6
*** TURN *** [3d Ts Qd] [2h]
ygTTt5ehT4aF86q1a8/R+w: checks
N18PrNGQj43J7TJuQuu+tw: bets $10
ygTTt5ehT4aF86q1a8/R+w: raises $18 to $28
N18PrNGQj43J7TJuQuu+tw: calls $18
*** RIVER *** [3d Ts Qd 2h] [7h]
ygTTt5ehT4aF86q1a8/R+w: bets $60
N18PrNGQj43J7TJuQuu+tw: folds
ygTTt5ehT4aF86q1a8/R+w collected $78 from pot
*** SUMMARY ***
Total pot $80 | Rake $2
Board [3d Ts Qd 2h 7h]
Seat 1: ygTTt5ehT4aF86q1a8/R+w (small blind) collected ($78)
Seat 2: N18PrNGQj43J7TJuQuu+tw (big blind) folded on the River
Seat 3: 54yWzRRgS0oZ+S6LwZBxMQ folded before Flop (didn't bet)
Seat 4: 8srN1dKQePlsv0GyTada+Q folded before Flop (didn't bet)
Seat 6: vkfxu8f/jMYKUk6Ly4eujw (button) folded before Flop (didn't bet)



PokerStars Game #59938911130:  Hold'em No Limit ($1/$2) - 2009/07/01 0:26:36 ET
Table 'ztv6V3FN2bQ9nmJPPdx6nQ' 6-max Seat #1 is the button
Seat 1: ek1hig03QiyONDHXvgqteQ ($317.35 in chips)
Seat 2: 5Y+ZGWLI4gnlpApDX5vy1A ($247.45 in chips)
Seat 3: Z55K9DbCHCUi6UaztIHi6g ($65.45 in chips)
Seat 4: vVSUvlW/pvneUNUHDgyXgw ($256 in chips)
Seat 5: sTPOWERd9HWPCNrDBwsVjA ($214.40 in chips)
Seat 6: mfy7uGZcqA2PVQqEVbJ7+g ($201.75 in chips)
5Y+ZGWLI4gnlpApDX5vy1A: posts small blind $1
Z55K9DbCHCUi6UaztIHi6g: posts big blind $2
*** HOLE CARDS ***
vVSUvlW/pvneUNUHDgyXgw: folds
sTPOWERd9HWPCNrDBwsVjA: calls $2
mfy7uGZcqA2PVQqEVbJ7+g: folds
ek1hig03QiyONDHXvgqteQ: folds
5Y+ZGWLI4gnlpApDX5vy1A: calls $1
Z55K9DbCHCUi6UaztIHi6g: checks
*** FLOP *** [7c Ad Ts]
5Y+ZGWLI4gnlpApDX5vy1A: checks
Z55K9DbCHCUi6UaztIHi6g: checks
ek1hig03QiyONDHXvgqteQ is sitting out
ek1hig03QiyONDHXvgqteQ leaves the table
sTPOWERd9HWPCNrDBwsVjA: bets $6
5Y+ZGWLI4gnlpApDX5vy1A: calls $6
Z55K9DbCHCUi6UaztIHi6g: calls $6
*** TURN *** [7c Ad Ts] [3s]
vkfxu8f/jMYKUk6Ly4eujw joins the table at seat #1
5Y+ZGWLI4gnlpApDX5vy1A: checks
Z55K9DbCHCUi6UaztIHi6g: checks
sTPOWERd9HWPCNrDBwsVjA: checks
*** RIVER *** [7c Ad Ts 3s] [7h]
5Y+ZGWLI4gnlpApDX5vy1A: checks
Z55K9DbCHCUi6UaztIHi6g: checks
sTPOWERd9HWPCNrDBwsVjA: checks
*** SHOW DOWN ***
5Y+ZGWLI4gnlpApDX5vy1A: shows [8s Ah] (two pair, Aces and Sevens)
Z55K9DbCHCUi6UaztIHi6g: mucks hand
sTPOWERd9HWPCNrDBwsVjA: mucks hand
5Y+ZGWLI4gnlpApDX5vy1A collected $22.85 from pot
*** SUMMARY ***
Total pot $24 | Rake $1.15
Board [7c Ad Ts 3s 7h]
Seat 1: ek1hig03QiyONDHXvgqteQ (button) folded before Flop (didn't bet)
Seat 2: 5Y+ZGWLI4gnlpApDX5vy1A (small blind) showed [8s Ah] and won ($22.85) with two pair, Aces and Sevens
Seat 3: Z55K9DbCHCUi6UaztIHi6g (big blind) mucked
Seat 4: vVSUvlW/pvneUNUHDgyXgw folded before Flop (didn't bet)
Seat 5: sTPOWERd9HWPCNrDBwsVjA mucked
Seat 6: mfy7uGZcqA2PVQqEVbJ7+g folded before Flop (didn't bet)



PokerStars Game #59938911886:  Hold'em No Limit ($1/$2) - 2009/07/01 0:26:37 ET
Table 'OZyw34U4j4WtFFWsEHZQgQ' 2-max Seat #2 is the button
Seat 1: pVqEzK9wXlRMECnb1Zg4Zw ($79.05 in chips)
Seat 2: rAtTyvrJ8f1LaUh2O5U4nA ($68.15 in chips)
rAtTyvrJ8f1LaUh2O5U4nA: posts small blind $1
pVqEzK9wXlRMECnb1Zg4Zw: posts big blind $2
*** HOLE CARDS ***
rAtTyvrJ8f1LaUh2O5U4nA: raises $4 to $6
pVqEzK9wXlRMECnb1Zg4Zw: raises $73.05 to $79.05 and is all-in
rAtTyvrJ8f1LaUh2O5U4nA: folds
pVqEzK9wXlRMECnb1Zg4Zw collected $12 from pot
pVqEzK9wXlRMECnb1Zg4Zw: doesn't show hand
*** SUMMARY ***
Total pot $12 | Rake $0
Seat 1: pVqEzK9wXlRMECnb1Zg4Zw (big blind) collected ($12)
Seat 2: rAtTyvrJ8f1LaUh2O5U4nA (button) (small blind) folded before Flop



PokerStars Game #59938912498:  Hold'em No Limit ($1/$2) - 2009/07/01 0:26:38 ET
Table 'NmY84NAf9Mh0ckAckHnh5g' 2-max Seat #2 is the button
Seat 1: 6hvg964TSqZ3AL/0XK9aVQ ($487.75 in chips)
Seat 2: RwDoM55ZeQuI2ADyJhOb2Q ($354 in chips)
RwDoM55ZeQuI2ADyJhOb2Q: posts small blind $1
6hvg964TSqZ3AL/0XK9aVQ: posts big blind $2
*** HOLE CARDS ***
RwDoM55ZeQuI2ADyJhOb2Q: folds
6hvg964TSqZ3AL/0XK9aVQ collected $2 from pot
6hvg964TSqZ3AL/0XK9aVQ: doesn't show hand
*** SUMMARY ***
Total pot $2 | Rake $0
Seat 1: 6hvg964TSqZ3AL/0XK9aVQ (big blind) collected ($2)
Seat 2: RwDoM55ZeQuI2ADyJhOb2Q (button) (small blind) folded before Flop



PokerStars Game #59938912810:  Hold'em No Limit ($1/$2) - 2009/07/01 0:26:38 ET
Table 'YqGfR5eHfMeSjb9a+QU9rg' 9-max Seat #7 is the button
Seat 1: qCBuzVnLcBR29snMAHq9PA ($111.90 in chips)
Seat 2: W3Nqt1GWlTi9tXQXMNEvgw ($255.75 in chips)
Seat 3: /gll27k+xWYV7Fbki0lFDQ ($110.85 in chips)
Seat 4: QHxJjpVYwitg9krW6wZgJA ($200 in chips)
Seat 5: MOBMOMQRN/z+fiGXGnZojw ($230.30 in chips)
Seat 6: 5iPk5MyO3KVu18Y8XCYfFQ ($42 in chips)
Seat 7: tAhiYXx1KvTp5hhBamTYfQ ($206.60 in chips)
Seat 8: JnV3SM2D6dAFYyGZHHpvrg ($96 in chips)
Seat 9: /inIs/z/PcX+TniIFpaxpg ($40 in chips)
JnV3SM2D6dAFYyGZHHpvrg: posts small blind $1
/inIs/z/PcX+TniIFpaxpg: posts big blind $2
*** HOLE CARDS ***
qCBuzVnLcBR29snMAHq9PA: folds
W3Nqt1GWlTi9tXQXMNEvgw: folds
/gll27k+xWYV7Fbki0lFDQ: folds
QHxJjpVYwitg9krW6wZgJA: folds
MOBMOMQRN/z+fiGXGnZojw: calls $2
5iPk5MyO3KVu18Y8XCYfFQ: folds
tAhiYXx1KvTp5hhBamTYfQ: folds
JnV3SM2D6dAFYyGZHHpvrg: folds
/inIs/z/PcX+TniIFpaxpg: checks
*** FLOP *** [Tc Kh Td]
/inIs/z/PcX+TniIFpaxpg: checks
MOBMOMQRN/z+fiGXGnZojw: bets $6
/inIs/z/PcX+TniIFpaxpg: calls $6
*** TURN *** [Tc Kh Td] [4h]
/inIs/z/PcX+TniIFpaxpg: checks
MOBMOMQRN/z+fiGXGnZojw: checks
*** RIVER *** [Tc Kh Td 4h] [2d]
/inIs/z/PcX+TniIFpaxpg: bets $10
MOBMOMQRN/z+fiGXGnZojw: calls $10
*** SHOW DOWN ***
/inIs/z/PcX+TniIFpaxpg: shows [3h 7h] (a pair of Tens)
MOBMOMQRN/z+fiGXGnZojw: shows [Kc Jd] (two pair, Kings and Tens)
MOBMOMQRN/z+fiGXGnZojw collected $35.20 from pot
*** SUMMARY ***
Total pot $37 | Rake $1.80
Board [Tc Kh Td 4h 2d]
Seat 1: qCBuzVnLcBR29snMAHq9PA folded before Flop (didn't bet)
Seat 2: W3Nqt1GWlTi9tXQXMNEvgw folded before Flop (didn't bet)
Seat 3: /gll27k+xWYV7Fbki0lFDQ folded before Flop (didn't bet)
Seat 4: QHxJjpVYwitg9krW6wZgJA folded before Flop (didn't bet)
Seat 5: MOBMOMQRN/z+fiGXGnZojw showed [Kc Jd] and won ($35.20) with two pair, Kings and Tens
Seat 6: 5iPk5MyO3KVu18Y8XCYfFQ folded before Flop (didn't bet)
Seat 7: tAhiYXx1KvTp5hhBamTYfQ (button) folded before Flop (didn't bet)
Seat 8: JnV3SM2D6dAFYyGZHHpvrg (small blind) folded before Flop
Seat 9: /inIs/z/PcX+TniIFpaxpg (big blind) showed [3h 7h] and lost with a pair of Tens



PokerStars Game #59938916084:  Hold'em No Limit ($1/$2) - 2009/07/01 0:26:43 ET
Table 'QxerF7GUfCbl+4a8XaTB2w' 6-max Seat #1 is the button
Seat 1: o9jamqIi6sTTRSqudgboRA ($203 in chips)
Seat 2: 513FcCI8jHyQy2VWoIQkMg ($221.10 in chips)
Seat 3: vkfxu8f/jMYKUk6Ly4eujw ($197 in chips)
Seat 4: WfaZs12BkYO+BUX5VWpuWQ ($57.20 in chips)
Seat 5: ezK4YR9nqEKpOT/tYPvHKA ($126.60 in chips)
Seat 6: RUZs7P4uzWavoA6iEpDKLw ($132.85 in chips)
513FcCI8jHyQy2VWoIQkMg: posts small blind $1
vkfxu8f/jMYKUk6Ly4eujw: posts big blind $2
*** HOLE CARDS ***
WfaZs12BkYO+BUX5VWpuWQ: folds
ezK4YR9nqEKpOT/tYPvHKA: folds
RUZs7P4uzWavoA6iEpDKLw: folds
o9jamqIi6sTTRSqudgboRA: folds
513FcCI8jHyQy2VWoIQkMg: folds
vkfxu8f/jMYKUk6Ly4eujw collected $2 from pot
*** SUMMARY ***
Total pot $2 | Rake $0
Seat 1: o9jamqIi6sTTRSqudgboRA (button) folded before Flop (didn't bet)
Seat 2: 513FcCI8jHyQy2VWoIQkMg (small blind) folded before Flop
Seat 3: vkfxu8f/jMYKUk6Ly4eujw (big blind) collected ($2)
Seat 4: WfaZs12BkYO+BUX5VWpuWQ folded before Flop (didn't bet)
Seat 5: ezK4YR9nqEKpOT/tYPvHKA folded before Flop (didn't bet)
Seat 6: RUZs7P4uzWavoA6iEpDKLw folded before Flop (didn't bet)



PokerStars Game #59938916570:  Hold'em No Limit ($1/$2) - 2009/07/01 0:26:44 ET
Table 'NmY84NAf9Mh0ckAckHnh5g' 2-max Seat #1 is the button
Seat 1: 6hvg964TSqZ3AL/0XK9aVQ ($488.75 in chips)
Seat 2: RwDoM55ZeQuI2ADyJhOb2Q ($353 in chips)
6hvg964TSqZ3AL/0XK9aVQ: posts small blind $1
RwDoM55ZeQuI2ADyJhOb2Q: posts big blind $2
*** HOLE CARDS ***
6hvg964TSqZ3AL/0XK9aVQ: calls $1
RwDoM55ZeQuI2ADyJhOb2Q: checks
*** FLOP *** [6s 3d 6c]
RwDoM55ZeQuI2ADyJhOb2Q: bets $4
6hvg964TSqZ3AL/0XK9aVQ: folds
RwDoM55ZeQuI2ADyJhOb2Q collected $3.80 from pot
RwDoM55ZeQuI2ADyJhOb2Q: doesn't show hand
*** SUMMARY ***
Total pot $4 | Rake $0.20
Board [6s 3d 6c]
Seat 1: 6hvg964TSqZ3AL/0XK9aVQ (button) (small blind) folded on the Flop
Seat 2: RwDoM55ZeQuI2ADyJhOb2Q (big blind) collected ($3.80)



PokerStars Game #59938916784:  Hold'em No Limit ($1/$2) - 2009/07/01 0:26:45 ET
Table 'uJ9juaXXg9yIcSU8amxaXQ' 6-max Seat #2 is the button
Seat 2: yynBOXUjw28V5kz84sxX4g ($152.30 in chips)
Seat 4: zNjJ/y4emmF+vzrCDd+ooA ($118.90 in chips)
Seat 5: aMZYAxFxWTQXE9aUus4sxg ($53.15 in chips)
Seat 6: XrFG4dK06RVKLlX32/pjcQ ($45.60 in chips)
zNjJ/y4emmF+vzrCDd+ooA: posts small blind $1
aMZYAxFxWTQXE9aUus4sxg: posts big blind $2
JsqOjN/eHz0uYVf/PyUJ6Q: sits out
*** HOLE CARDS ***
XrFG4dK06RVKLlX32/pjcQ: calls $2
yynBOXUjw28V5kz84sxX4g: folds
zNjJ/y4emmF+vzrCDd+ooA: calls $1
aMZYAxFxWTQXE9aUus4sxg: checks
*** FLOP *** [Qd 9s 7c]
zNjJ/y4emmF+vzrCDd+ooA: checks
aMZYAxFxWTQXE9aUus4sxg: checks
XrFG4dK06RVKLlX32/pjcQ: checks
*** TURN *** [Qd 9s 7c] [Qc]
zNjJ/y4emmF+vzrCDd+ooA: checks
aMZYAxFxWTQXE9aUus4sxg: bets $2
XrFG4dK06RVKLlX32/pjcQ: folds
zNjJ/y4emmF+vzrCDd+ooA: folds
aMZYAxFxWTQXE9aUus4sxg collected $5.70 from pot
*** SUMMARY ***
Total pot $6 | Rake $0.30
Board [Qd 9s 7c Qc]
Seat 2: yynBOXUjw28V5kz84sxX4g (button) folded before Flop (didn't bet)
Seat 4: zNjJ/y4emmF+vzrCDd+ooA (small blind) folded on the Turn
Seat 5: aMZYAxFxWTQXE9aUus4sxg (big blind) collected ($5.70)
Seat 6: XrFG4dK06RVKLlX32/pjcQ folded on the Turn



PokerStars Game #59938918048:  Hold'em No Limit ($1/$2) - 2009/07/01 0:26:46 ET
Table 'jCW99a4MXoPgL0PwEZ4IuQ' 2-max Seat #2 is the button
Seat 1: t6Jd836OSEMbcRi7rfGp5g ($200 in chips)
Seat 2: bWN162Ep6lKyJ0MW6unz4w ($254 in chips)
bWN162Ep6lKyJ0MW6unz4w: posts small blind $1
t6Jd836OSEMbcRi7rfGp5g: posts big blind $2
*** HOLE CARDS ***
bWN162Ep6lKyJ0MW6unz4w: folds
t6Jd836OSEMbcRi7rfGp5g collected $2 from pot
*** SUMMARY ***
Total pot $2 | Rake $0
Seat 1: t6Jd836OSEMbcRi7rfGp5g (big blind) collected ($2)
Seat 2: bWN162Ep6lKyJ0MW6unz4w (button) (small blind) folded before Flop



PokerStars Game #59938919030:  Hold'em No Limit ($1/$2) - 2009/07/01 0:26:48 ET
Table 'gnHBqWll9O3fxG7Ojkz/ng' 9-max Seat #4 is the button
Seat 1: hpqdC/23wXosGOmzARr5NA ($179.05 in chips)
Seat 2: H6Z4+qu8gR0VUiPOijndVg ($200 in chips)
Seat 3: 5Q8U6iZbeO7xJSS4qvDP5g ($231.35 in chips)
Seat 4: n5XI5/7gN+gIubHFBH+mOw ($369.90 in chips)
Seat 5: rBQDMkKm9cZn6M9NPsiVew ($168.45 in chips)
Seat 6: 5iPk5MyO3KVu18Y8XCYfFQ ($40 in chips)
Seat 7: jqui3xAWCkcdPW36a6BD+w ($212.55 in chips)
Seat 8: cM6efHzdxoqYm0EQKP4TTQ ($105.80 in chips)
rBQDMkKm9cZn6M9NPsiVew: posts small blind $1
5iPk5MyO3KVu18Y8XCYfFQ: posts big blind $2
GX1heJ+DSsvm7gzSPsYhhQ: sits out
*** HOLE CARDS ***
jqui3xAWCkcdPW36a6BD+w: folds
cM6efHzdxoqYm0EQKP4TTQ: calls $2
hpqdC/23wXosGOmzARr5NA: folds
H6Z4+qu8gR0VUiPOijndVg: folds
5Q8U6iZbeO7xJSS4qvDP5g: folds
n5XI5/7gN+gIubHFBH+mOw: folds
rBQDMkKm9cZn6M9NPsiVew: calls $1
5iPk5MyO3KVu18Y8XCYfFQ: checks
*** FLOP *** [9s Qc Ah]
rBQDMkKm9cZn6M9NPsiVew: checks
5iPk5MyO3KVu18Y8XCYfFQ: bets $4
cM6efHzdxoqYm0EQKP4TTQ: calls $4
rBQDMkKm9cZn6M9NPsiVew: folds
*** TURN *** [9s Qc Ah] [2c]
5iPk5MyO3KVu18Y8XCYfFQ: checks
cM6efHzdxoqYm0EQKP4TTQ: checks
*** RIVER *** [9s Qc Ah 2c] [8h]
5iPk5MyO3KVu18Y8XCYfFQ: checks
cM6efHzdxoqYm0EQKP4TTQ: checks
*** SHOW DOWN ***
5iPk5MyO3KVu18Y8XCYfFQ: shows [Jd Ks] (high card Ace)
cM6efHzdxoqYm0EQKP4TTQ: shows [9d Kc] (a pair of Nines)
cM6efHzdxoqYm0EQKP4TTQ collected $13.35 from pot
*** SUMMARY ***
Total pot $14 | Rake $0.65
Board [9s Qc Ah 2c 8h]
Seat 1: hpqdC/23wXosGOmzARr5NA folded before Flop (didn't bet)
Seat 2: H6Z4+qu8gR0VUiPOijndVg folded before Flop (didn't bet)
Seat 3: 5Q8U6iZbeO7xJSS4qvDP5g folded before Flop (didn't bet)
Seat 4: n5XI5/7gN+gIubHFBH+mOw (button) folded before Flop (didn't bet)
Seat 5: rBQDMkKm9cZn6M9NPsiVew (small blind) folded on the Flop
Seat 6: 5iPk5MyO3KVu18Y8XCYfFQ (big blind) showed [Jd Ks] and lost with high card Ace
Seat 7: jqui3xAWCkcdPW36a6BD+w folded before Flop (didn't bet)
Seat 8: cM6efHzdxoqYm0EQKP4TTQ showed [9d Kc] and won ($13.35) with a pair of Nines



PokerStars Game #59938920396:  Hold'em No Limit ($1/$2) - 2009/07/01 0:26:50 ET
Table 'ZzSIe0zTCDv+n6hfbY5tTg' 6-max Seat #4 is the button
Seat 2: B87ikIyZ/TzAVeXf38Ny0g ($200 in chips)
Seat 4: ky55L0pITYgYLeqFB9gP/Q ($135.40 in chips)
Seat 5: f2eTKbND+tM3kUw9o6WYWg ($158.20 in chips)
Seat 6: InmkdI6G8TzSj9NhcCSyPg ($200 in chips)
f2eTKbND+tM3kUw9o6WYWg: posts small blind $1
InmkdI6G8TzSj9NhcCSyPg: posts big blind $2
X7GlkHF+lkbarCLuZ4Uf0w: sits out
*** HOLE CARDS ***
B87ikIyZ/TzAVeXf38Ny0g: folds
ky55L0pITYgYLeqFB9gP/Q: folds
f2eTKbND+tM3kUw9o6WYWg: raises $4 to $6
InmkdI6G8TzSj9NhcCSyPg: folds
f2eTKbND+tM3kUw9o6WYWg collected $4 from pot
f2eTKbND+tM3kUw9o6WYWg: doesn't show hand
*** SUMMARY ***
Total pot $4 | Rake $0
Seat 2: B87ikIyZ/TzAVeXf38Ny0g folded before Flop (didn't bet)
Seat 4: ky55L0pITYgYLeqFB9gP/Q (button) folded before Flop (didn't bet)
Seat 5: f2eTKbND+tM3kUw9o6WYWg (small blind) collected ($4)
Seat 6: InmkdI6G8TzSj9NhcCSyPg (big blind) folded before Flop



PokerStars Game #59938920882:  Hold'em No Limit ($1/$2) - 2009/07/01 0:26:51 ET
Table 'OZyw34U4j4WtFFWsEHZQgQ' 2-max Seat #1 is the button
Seat 1: pVqEzK9wXlRMECnb1Zg4Zw ($85.05 in chips)
Seat 2: rAtTyvrJ8f1LaUh2O5U4nA ($62.15 in chips)
pVqEzK9wXlRMECnb1Zg4Zw: posts small blind $1
rAtTyvrJ8f1LaUh2O5U4nA: posts big blind $2
*** HOLE CARDS ***
pVqEzK9wXlRMECnb1Zg4Zw: calls $1
rAtTyvrJ8f1LaUh2O5U4nA: checks
*** FLOP *** [Kc 7d 7c]
rAtTyvrJ8f1LaUh2O5U4nA: checks
pVqEzK9wXlRMECnb1Zg4Zw: bets $4
rAtTyvrJ8f1LaUh2O5U4nA: folds
pVqEzK9wXlRMECnb1Zg4Zw collected $3.80 from pot
pVqEzK9wXlRMECnb1Zg4Zw: doesn't show hand
*** SUMMARY ***
Total pot $4 | Rake $0.20
Board [Kc 7d 7c]
Seat 1: pVqEzK9wXlRMECnb1Zg4Zw (button) (small blind) collected ($3.80)
Seat 2: rAtTyvrJ8f1LaUh2O5U4nA (big blind) folded on the Flop



PokerStars Game #59938921452:  Hold'em No Limit ($1/$2) - 2009/07/01 0:26:51 ET
Table '5G1PjWSk2ALz0O/eqyYy/g' 2-max Seat #2 is the button
Seat 1: Z4HwehErEwzsv/noQlfUlg ($131.90 in chips)
Seat 2: v4dp1VoMhJV4zmCXtmG5LQ ($252.50 in chips)
v4dp1VoMhJV4zmCXtmG5LQ: posts small blind $1
Z4HwehErEwzsv/noQlfUlg: posts big blind $2
*** HOLE CARDS ***
v4dp1VoMhJV4zmCXtmG5LQ: raises $4 to $6
Z4HwehErEwzsv/noQlfUlg: folds
v4dp1VoMhJV4zmCXtmG5LQ collected $4 from pot
v4dp1VoMhJV4zmCXtmG5LQ: doesn't show hand
*** SUMMARY ***
Total pot $4 | Rake $0
Seat 1: Z4HwehErEwzsv/noQlfUlg (big blind) folded before Flop
Seat 2: v4dp1VoMhJV4zmCXtmG5LQ (button) (small blind) collected ($4)



PokerStars Game #59938922022:  Hold'em No Limit ($1/$2) - 2009/07/01 0:26:52 ET
Table 'jCW99a4MXoPgL0PwEZ4IuQ' 2-max Seat #1 is the button
Seat 1: t6Jd836OSEMbcRi7rfGp5g ($201 in chips)
Seat 2: bWN162Ep6lKyJ0MW6unz4w ($253 in chips)
t6Jd836OSEMbcRi7rfGp5g: posts small blind $1
bWN162Ep6lKyJ0MW6unz4w: posts big blind $2
*** HOLE CARDS ***
t6Jd836OSEMbcRi7rfGp5g: raises $4 to $6
bWN162Ep6lKyJ0MW6unz4w: calls $4
*** FLOP *** [6c 8h As]
bWN162Ep6lKyJ0MW6unz4w: checks
t6Jd836OSEMbcRi7rfGp5g: checks
*** TURN *** [6c 8h As] [7h]
bWN162Ep6lKyJ0MW6unz4w: bets $8
t6Jd836OSEMbcRi7rfGp5g: folds
bWN162Ep6lKyJ0MW6unz4w collected $11.50 from pot
bWN162Ep6lKyJ0MW6unz4w: doesn't show hand
*** SUMMARY ***
Total pot $12 | Rake $0.50
Board [6c 8h As 7h]
Seat 1: t6Jd836OSEMbcRi7rfGp5g (button) (small blind) folded on the Turn
Seat 2: bWN162Ep6lKyJ0MW6unz4w (big blind) collected ($11.50)



PokerStars Game #59938922788:  Hold'em No Limit ($1/$2) - 2009/07/01 0:26:53 ET
Table 'P/yCfYl1GfGsu/e6DxDy/A' 2-max Seat #1 is the button
Seat 1: 7fOCUy3x9hdkmXkkDNolGQ ($446.50 in chips)
Seat 2: RwDoM55ZeQuI2ADyJhOb2Q ($576.50 in chips)
7fOCUy3x9hdkmXkkDNolGQ: posts small blind $1
RwDoM55ZeQuI2ADyJhOb2Q: posts big blind $2
*** HOLE CARDS ***
7fOCUy3x9hdkmXkkDNolGQ: raises $4 to $6
RwDoM55ZeQuI2ADyJhOb2Q: calls $4
*** FLOP *** [Jh As Qc]
RwDoM55ZeQuI2ADyJhOb2Q: checks
7fOCUy3x9hdkmXkkDNolGQ: bets $8
RwDoM55ZeQuI2ADyJhOb2Q: raises $14 to $22
7fOCUy3x9hdkmXkkDNolGQ: calls $14
*** TURN *** [Jh As Qc] [Qs]
RwDoM55ZeQuI2ADyJhOb2Q: bets $32
7fOCUy3x9hdkmXkkDNolGQ: calls $32
*** RIVER *** [Jh As Qc Qs] [5c]
RwDoM55ZeQuI2ADyJhOb2Q: bets $72
7fOCUy3x9hdkmXkkDNolGQ: folds
RwDoM55ZeQuI2ADyJhOb2Q collected $119.50 from pot
RwDoM55ZeQuI2ADyJhOb2Q: doesn't show hand
*** SUMMARY ***
Total pot $120 | Rake $0.50
Board [Jh As Qc Qs 5c]
Seat 1: 7fOCUy3x9hdkmXkkDNolGQ (button) (small blind) folded on the River
Seat 2: RwDoM55ZeQuI2ADyJhOb2Q (big blind) collected ($119.50)



PokerStars Game #59938923724:  Hold'em No Limit ($1/$2) - 2009/07/01 0:26:55 ET
Table 'QxerF7GUfCbl+4a8XaTB2w' 6-max Seat #2 is the button
Seat 1: o9jamqIi6sTTRSqudgboRA ($203 in chips)
Seat 2: 513FcCI8jHyQy2VWoIQkMg ($220.10 in chips)
Seat 3: vkfxu8f/jMYKUk6Ly4eujw ($198 in chips)
Seat 4: WfaZs12BkYO+BUX5VWpuWQ ($57.20 in chips)
Seat 5: ezK4YR9nqEKpOT/tYPvHKA ($126.60 in chips)
Seat 6: RUZs7P4uzWavoA6iEpDKLw ($132.85 in chips)
vkfxu8f/jMYKUk6Ly4eujw: posts small blind $1
WfaZs12BkYO+BUX5VWpuWQ: posts big blind $2
*** HOLE CARDS ***
ezK4YR9nqEKpOT/tYPvHKA: folds
RUZs7P4uzWavoA6iEpDKLw: raises $4 to $6
o9jamqIi6sTTRSqudgboRA: folds
513FcCI8jHyQy2VWoIQkMg: calls $6
vkfxu8f/jMYKUk6Ly4eujw: folds
WfaZs12BkYO+BUX5VWpuWQ: folds
*** FLOP *** [3d 3s 9s]
RUZs7P4uzWavoA6iEpDKLw: checks
513FcCI8jHyQy2VWoIQkMg: bets $10
RUZs7P4uzWavoA6iEpDKLw: folds
513FcCI8jHyQy2VWoIQkMg collected $14.25 from pot
*** SUMMARY ***
Total pot $15 | Rake $0.75
Board [3d 3s 9s]
Seat 1: o9jamqIi6sTTRSqudgboRA folded before Flop (didn't bet)
Seat 2: 513FcCI8jHyQy2VWoIQkMg (button) collected ($14.25)
Seat 3: vkfxu8f/jMYKUk6Ly4eujw (small blind) folded before Flop
Seat 4: WfaZs12BkYO+BUX5VWpuWQ (big blind) folded before Flop
Seat 5: ezK4YR9nqEKpOT/tYPvHKA folded before Flop (didn't bet)
Seat 6: RUZs7P4uzWavoA6iEpDKLw folded on the Flop



PokerStars Game #59938924898:  Hold'em No Limit ($1/$2) - 2009/07/01 0:26:57 ET
Table '8Y6PEyoNuepZTai2Q56aHw' 9-max Seat #9 is the button
Seat 1: 5Q8U6iZbeO7xJSS4qvDP5g ($200 in chips)
Seat 2: bsoztaaq0ABC+bfmYRj8Bg ($76.20 in chips)
Seat 3: U2A5Hv6ib/5+gzO2wr7Z4w ($222.50 in chips)
Seat 4: R2ZqNf1ZzAx8zCo/BK1DAw ($142.90 in chips)
Seat 6: U6hiWxhGo9OzXssAHPjKCQ ($26.85 in chips)
Seat 8: nmKMR6NlUE4ZWSCM5fh3MQ ($162.75 in chips)
Seat 9: F7m34OOfAQ7annesMHVjKw ($127.75 in chips)
5Q8U6iZbeO7xJSS4qvDP5g: posts small blind $1
bsoztaaq0ABC+bfmYRj8Bg: posts big blind $2
/inIs/z/PcX+TniIFpaxpg: sits out
GX1heJ+DSsvm7gzSPsYhhQ: sits out
*** HOLE CARDS ***
U2A5Hv6ib/5+gzO2wr7Z4w: folds
R2ZqNf1ZzAx8zCo/BK1DAw: folds
U6hiWxhGo9OzXssAHPjKCQ: calls $2
nmKMR6NlUE4ZWSCM5fh3MQ: raises $6 to $8
F7m34OOfAQ7annesMHVjKw: folds
5Q8U6iZbeO7xJSS4qvDP5g: folds
bsoztaaq0ABC+bfmYRj8Bg: calls $6
U6hiWxhGo9OzXssAHPjKCQ: calls $6
*** FLOP *** [Qd 5d Ks]
bsoztaaq0ABC+bfmYRj8Bg: checks
U6hiWxhGo9OzXssAHPjKCQ: checks
nmKMR6NlUE4ZWSCM5fh3MQ: checks
*** TURN *** [Qd 5d Ks] [Ah]
bsoztaaq0ABC+bfmYRj8Bg: bets $8
U6hiWxhGo9OzXssAHPjKCQ: calls $8
nmKMR6NlUE4ZWSCM5fh3MQ: folds
*** RIVER *** [Qd 5d Ks Ah] [Tc]
bsoztaaq0ABC+bfmYRj8Bg: bets $10
U6hiWxhGo9OzXssAHPjKCQ: calls $10
*** SHOW DOWN ***
bsoztaaq0ABC+bfmYRj8Bg: shows [Qs Ad] (two pair, Aces and Queens)
U6hiWxhGo9OzXssAHPjKCQ: mucks hand
bsoztaaq0ABC+bfmYRj8Bg collected $58.05 from pot
*** SUMMARY ***
Total pot $61 | Rake $2.95
Board [Qd 5d Ks Ah Tc]
Seat 1: 5Q8U6iZbeO7xJSS4qvDP5g (small blind) folded before Flop
Seat 2: bsoztaaq0ABC+bfmYRj8Bg (big blind) showed [Qs Ad] and won ($58.05) with two pair, Aces and Queens
Seat 3: U2A5Hv6ib/5+gzO2wr7Z4w folded before Flop (didn't bet)
Seat 4: R2ZqNf1ZzAx8zCo/BK1DAw folded before Flop (didn't bet)
Seat 6: U6hiWxhGo9OzXssAHPjKCQ mucked
Seat 8: nmKMR6NlUE4ZWSCM5fh3MQ folded on the Turn
Seat 9: F7m34OOfAQ7annesMHVjKw (button) folded before Flop (didn't bet)



PokerStars Game #59938925694:  Hold'em No Limit ($1/$2) - 2009/07/01 0:26:58 ET
Table 'aSf77Sj8QEnzcc0WaxVD4Q' 6-max Seat #6 is the button
Seat 1: 54yWzRRgS0oZ+S6LwZBxMQ ($38.80 in chips)
Seat 2: vkfxu8f/jMYKUk6Ly4eujw ($244.15 in chips)
Seat 3: 9dpyyjDTCed6nV7JhaUUpw ($204.30 in chips)
Seat 4: 513FcCI8jHyQy2VWoIQkMg ($202 in chips)
Seat 5: InmkdI6G8TzSj9NhcCSyPg ($257.65 in chips)
Seat 6: vkoJRf3gidxY1pPi0AFWww ($297.80 in chips)
54yWzRRgS0oZ+S6LwZBxMQ: posts small blind $1
vkfxu8f/jMYKUk6Ly4eujw: posts big blind $2
*** HOLE CARDS ***
9dpyyjDTCed6nV7JhaUUpw: folds
513FcCI8jHyQy2VWoIQkMg: folds
InmkdI6G8TzSj9NhcCSyPg: folds
vkoJRf3gidxY1pPi0AFWww: folds
54yWzRRgS0oZ+S6LwZBxMQ: folds
vkfxu8f/jMYKUk6Ly4eujw collected $2 from pot
vkfxu8f/jMYKUk6Ly4eujw: doesn't show hand
*** SUMMARY ***
Total pot $2 | Rake $0
Seat 1: 54yWzRRgS0oZ+S6LwZBxMQ (small blind) folded before Flop
Seat 2: vkfxu8f/jMYKUk6Ly4eujw (big blind) collected ($2)
Seat 3: 9dpyyjDTCed6nV7JhaUUpw folded before Flop (didn't bet)
Seat 4: 513FcCI8jHyQy2VWoIQkMg folded before Flop (didn't bet)
Seat 5: InmkdI6G8TzSj9NhcCSyPg folded before Flop (didn't bet)
Seat 6: vkoJRf3gidxY1pPi0AFWww (button) folded before Flop (didn't bet)



PokerStars Game #59938926228:  Hold'em No Limit ($1/$2) - 2009/07/01 0:26:59 ET
Table 'CFkQcfWjKccZaZDf71FK+w' 6-max Seat #4 is the button
Seat 1: U2A5Hv6ib/5+gzO2wr7Z4w ($203 in chips)
Seat 2: X7GlkHF+lkbarCLuZ4Uf0w ($29 in chips)
Seat 3: R5/GXj0PUdNkzHU6Omb/JA ($95 in chips)
Seat 4: e8nZKSbIdIO7e2NdQe/OFQ ($230.80 in chips)
Seat 5: 1njbh8TKSUF6l4V1XwGdcg ($225.80 in chips)
1njbh8TKSUF6l4V1XwGdcg: posts small blind $1
U2A5Hv6ib/5+gzO2wr7Z4w: posts big blind $2
*** HOLE CARDS ***
X7GlkHF+lkbarCLuZ4Uf0w: folds
R5/GXj0PUdNkzHU6Omb/JA: folds
e8nZKSbIdIO7e2NdQe/OFQ: raises $4 to $6
1njbh8TKSUF6l4V1XwGdcg: folds
U2A5Hv6ib/5+gzO2wr7Z4w: folds
e8nZKSbIdIO7e2NdQe/OFQ collected $5 from pot
*** SUMMARY ***
Total pot $5 | Rake $0
Seat 1: U2A5Hv6ib/5+gzO2wr7Z4w (big blind) folded before Flop
Seat 2: X7GlkHF+lkbarCLuZ4Uf0w folded before Flop (didn't bet)
Seat 3: R5/GXj0PUdNkzHU6Omb/JA folded before Flop (didn't bet)
Seat 4: e8nZKSbIdIO7e2NdQe/OFQ (button) collected ($5)
Seat 5: 1njbh8TKSUF6l4V1XwGdcg (small blind) folded before Flop



PokerStars Game #59938927332:  Hold'em No Limit ($1/$2) - 2009/07/01 0:27:00 ET
Table 'on4i1U1lCRmxsduFD3xiSg' 9-max Seat #8 is the button
Seat 1: so5k3vFDmokh2q3dImJ1GQ ($108 in chips)
Seat 2: yZYrOeNDxQxkzpbgKX1bng ($33.25 in chips)
Seat 3: 5iPk5MyO3KVu18Y8XCYfFQ ($58.20 in chips)
Seat 4: Z3aYCZG/yXHYFjiWkGI5ug ($527.10 in chips)
Seat 5: QHxJjpVYwitg9krW6wZgJA ($200 in chips)
Seat 6: CUZwDpLTQKhzarPe+JCLOQ ($214.55 in chips)
Seat 8: cdC54j9fGGojcbzWB5PgzA ($201 in chips)
Seat 9: iMe5yhc+1BaiIPHet3NMrA ($200 in chips)
iMe5yhc+1BaiIPHet3NMrA: posts small blind $1
so5k3vFDmokh2q3dImJ1GQ: posts big blind $2
*** HOLE CARDS ***
yZYrOeNDxQxkzpbgKX1bng: folds
5iPk5MyO3KVu18Y8XCYfFQ: folds
Z3aYCZG/yXHYFjiWkGI5ug: folds
QHxJjpVYwitg9krW6wZgJA: raises $4 to $6
CUZwDpLTQKhzarPe+JCLOQ: folds
cdC54j9fGGojcbzWB5PgzA: folds
iMe5yhc+1BaiIPHet3NMrA: folds
so5k3vFDmokh2q3dImJ1GQ: folds
QHxJjpVYwitg9krW6wZgJA collected $5 from pot
*** SUMMARY ***
Total pot $5 | Rake $0
Seat 1: so5k3vFDmokh2q3dImJ1GQ (big blind) folded before Flop
Seat 2: yZYrOeNDxQxkzpbgKX1bng folded before Flop (didn't bet)
Seat 3: 5iPk5MyO3KVu18Y8XCYfFQ folded before Flop (didn't bet)
Seat 4: Z3aYCZG/yXHYFjiWkGI5ug folded before Flop (didn't bet)
Seat 5: QHxJjpVYwitg9krW6wZgJA collected ($5)
Seat 6: CUZwDpLTQKhzarPe+JCLOQ folded before Flop (didn't bet)
Seat 8: cdC54j9fGGojcbzWB5PgzA (button) folded before Flop (didn't bet)
Seat 9: iMe5yhc+1BaiIPHet3NMrA (small blind) folded before Flop



PokerStars Game #59938927422:  Hold'em No Limit ($1/$2) - 2009/07/01 0:27:00 ET
Table '5G1PjWSk2ALz0O/eqyYy/g' 2-max Seat #1 is the button
Seat 1: Z4HwehErEwzsv/noQlfUlg ($129.90 in chips)
Seat 2: v4dp1VoMhJV4zmCXtmG5LQ ($254.50 in chips)
Z4HwehErEwzsv/noQlfUlg: posts small blind $1
v4dp1VoMhJV4zmCXtmG5LQ: posts big blind $2
*** HOLE CARDS ***
Z4HwehErEwzsv/noQlfUlg: folds
v4dp1VoMhJV4zmCXtmG5LQ collected $2 from pot
v4dp1VoMhJV4zmCXtmG5LQ: doesn't show hand
*** SUMMARY ***
Total pot $2 | Rake $0
Seat 1: Z4HwehErEwzsv/noQlfUlg (button) (small blind) folded before Flop
Seat 2: v4dp1VoMhJV4zmCXtmG5LQ (big blind) collected ($2)



PokerStars Game #59938928222:  Hold'em No Limit ($1/$2) - 2009/07/01 0:27:02 ET
Table 'NmY84NAf9Mh0ckAckHnh5g' 2-max Seat #2 is the button
Seat 1: 6hvg964TSqZ3AL/0XK9aVQ ($486.75 in chips)
Seat 2: RwDoM55ZeQuI2ADyJhOb2Q ($354.80 in chips)
RwDoM55ZeQuI2ADyJhOb2Q: posts small blind $1
6hvg964TSqZ3AL/0XK9aVQ: posts big blind $2
*** HOLE CARDS ***
RwDoM55ZeQuI2ADyJhOb2Q: raises $4 to $6
6hvg964TSqZ3AL/0XK9aVQ: calls $4
*** FLOP *** [Js 6d 9h]
6hvg964TSqZ3AL/0XK9aVQ: checks
RwDoM55ZeQuI2ADyJhOb2Q: bets $8
6hvg964TSqZ3AL/0XK9aVQ: calls $8
*** TURN *** [Js 6d 9h] [7h]
6hvg964TSqZ3AL/0XK9aVQ: checks
RwDoM55ZeQuI2ADyJhOb2Q: checks
*** RIVER *** [Js 6d 9h 7h] [3d]
6hvg964TSqZ3AL/0XK9aVQ: bets $40
RwDoM55ZeQuI2ADyJhOb2Q: folds
6hvg964TSqZ3AL/0XK9aVQ collected $27.50 from pot
6hvg964TSqZ3AL/0XK9aVQ: doesn't show hand
*** SUMMARY ***
Total pot $28 | Rake $0.50
Board [Js 6d 9h 7h 3d]
Seat 1: 6hvg964TSqZ3AL/0XK9aVQ (big blind) collected ($27.50)
Seat 2: RwDoM55ZeQuI2ADyJhOb2Q (button) (small blind) folded on the River



PokerStars Game #59938929394:  Hold'em No Limit ($1/$2) - 2009/07/01 0:27:03 ET
Table 'BSRfGh+QobUe0AgIMtt/fw' 9-max Seat #3 is the button
Seat 1: QHxJjpVYwitg9krW6wZgJA ($289.30 in chips)
Seat 2: GX1heJ+DSsvm7gzSPsYhhQ ($33 in chips)
Seat 3: XSBFygUEk3Ijl/S/KhD4PA ($351.60 in chips)
Seat 4: 5iPk5MyO3KVu18Y8XCYfFQ ($38 in chips)
Seat 5: odhvI/CZeMsPyo1n1U7+hA ($87 in chips)
Seat 6: H6Z4+qu8gR0VUiPOijndVg ($207.40 in chips)
Seat 7: RgU4royPa+zJopKX0xA3RA ($161.60 in chips)
Seat 8: /XRRUMKiOOItJFbrM26RrA ($54 in chips)
5iPk5MyO3KVu18Y8XCYfFQ: posts small blind $1
odhvI/CZeMsPyo1n1U7+hA: posts big blind $2
/inIs/z/PcX+TniIFpaxpg: sits out
*** HOLE CARDS ***
H6Z4+qu8gR0VUiPOijndVg: folds
RgU4royPa+zJopKX0xA3RA: raises $6 to $8
/XRRUMKiOOItJFbrM26RrA: folds
QHxJjpVYwitg9krW6wZgJA: folds
GX1heJ+DSsvm7gzSPsYhhQ: folds
XSBFygUEk3Ijl/S/KhD4PA: folds
5iPk5MyO3KVu18Y8XCYfFQ: folds
odhvI/CZeMsPyo1n1U7+hA: calls $6
*** FLOP *** [Qs 9d Ks]
odhvI/CZeMsPyo1n1U7+hA: bets $6
RgU4royPa+zJopKX0xA3RA: raises $6 to $12
odhvI/CZeMsPyo1n1U7+hA: calls $6
*** TURN *** [Qs 9d Ks] [As]
odhvI/CZeMsPyo1n1U7+hA: bets $12
RgU4royPa+zJopKX0xA3RA: raises $12 to $24
odhvI/CZeMsPyo1n1U7+hA: raises $24 to $48
RgU4royPa+zJopKX0xA3RA: raises $24 to $72
odhvI/CZeMsPyo1n1U7+hA: calls $19 and is all-in
*** RIVER *** [Qs 9d Ks As] [8c]
*** SHOW DOWN ***
odhvI/CZeMsPyo1n1U7+hA: shows [Ts 9s] (a flush, Ace high)
RgU4royPa+zJopKX0xA3RA: mucks hand
odhvI/CZeMsPyo1n1U7+hA collected $172 from pot
*** SUMMARY ***
Total pot $175 | Rake $3
Board [Qs 9d Ks As 8c]
Seat 1: QHxJjpVYwitg9krW6wZgJA folded before Flop (didn't bet)
Seat 2: GX1heJ+DSsvm7gzSPsYhhQ folded before Flop (didn't bet)
Seat 3: XSBFygUEk3Ijl/S/KhD4PA (button) folded before Flop (didn't bet)
Seat 4: 5iPk5MyO3KVu18Y8XCYfFQ (small blind) folded before Flop
Seat 5: odhvI/CZeMsPyo1n1U7+hA (big blind) showed [Ts 9s] and won ($172) with a flush, Ace high
Seat 6: H6Z4+qu8gR0VUiPOijndVg folded before Flop (didn't bet)
Seat 7: RgU4royPa+zJopKX0xA3RA mucked
Seat 8: /XRRUMKiOOItJFbrM26RrA folded before Flop (didn't bet)



PokerStars Game #59938930006:  Hold'em No Limit ($1/$2) - 2009/07/01 0:27:04 ET
Table 'OZyw34U4j4WtFFWsEHZQgQ' 2-max Seat #2 is the button
Seat 1: pVqEzK9wXlRMECnb1Zg4Zw ($86.85 in chips)
Seat 2: rAtTyvrJ8f1LaUh2O5U4nA ($60.15 in chips)
rAtTyvrJ8f1LaUh2O5U4nA: posts small blind $1
pVqEzK9wXlRMECnb1Zg4Zw: posts big blind $2
*** HOLE CARDS ***
rAtTyvrJ8f1LaUh2O5U4nA: calls $1
pVqEzK9wXlRMECnb1Zg4Zw: raises $2 to $4
rAtTyvrJ8f1LaUh2O5U4nA: raises $2 to $6
pVqEzK9wXlRMECnb1Zg4Zw: calls $2
*** FLOP *** [6s Th 3c]
pVqEzK9wXlRMECnb1Zg4Zw: checks
rAtTyvrJ8f1LaUh2O5U4nA: bets $6.50
pVqEzK9wXlRMECnb1Zg4Zw: raises $74.35 to $80.85 and is all-in
rAtTyvrJ8f1LaUh2O5U4nA said, "77s no good?"
rAtTyvrJ8f1LaUh2O5U4nA: folds
rAtTyvrJ8f1LaUh2O5U4nA said, "nh"
pVqEzK9wXlRMECnb1Zg4Zw collected $24.50 from pot
pVqEzK9wXlRMECnb1Zg4Zw: doesn't show hand
*** SUMMARY ***
Total pot $25 | Rake $0.50
Board [6s Th 3c]
Seat 1: pVqEzK9wXlRMECnb1Zg4Zw (big blind) collected ($24.50)
Seat 2: rAtTyvrJ8f1LaUh2O5U4nA (button) (small blind) folded on the Flop



PokerStars Game #59938930710:  Hold'em No Limit ($1/$2) - 2009/07/01 0:27:05 ET
Table 'ZzSIe0zTCDv+n6hfbY5tTg' 6-max Seat #5 is the button
Seat 2: B87ikIyZ/TzAVeXf38Ny0g ($200 in chips)
Seat 4: ky55L0pITYgYLeqFB9gP/Q ($135.40 in chips)
Seat 5: f2eTKbND+tM3kUw9o6WYWg ($160.20 in chips)
Seat 6: InmkdI6G8TzSj9NhcCSyPg ($200 in chips)
InmkdI6G8TzSj9NhcCSyPg: posts small blind $1
B87ikIyZ/TzAVeXf38Ny0g: posts big blind $2
X7GlkHF+lkbarCLuZ4Uf0w: sits out
*** HOLE CARDS ***
ky55L0pITYgYLeqFB9gP/Q: folds
f2eTKbND+tM3kUw9o6WYWg: raises $4 to $6
InmkdI6G8TzSj9NhcCSyPg: calls $5
B87ikIyZ/TzAVeXf38Ny0g: folds
*** FLOP *** [4d 4c Jc]
InmkdI6G8TzSj9NhcCSyPg: checks
f2eTKbND+tM3kUw9o6WYWg: bets $8
InmkdI6G8TzSj9NhcCSyPg: folds
f2eTKbND+tM3kUw9o6WYWg collected $13.30 from pot
f2eTKbND+tM3kUw9o6WYWg: doesn't show hand
*** SUMMARY ***
Total pot $14 | Rake $0.70
Board [4d 4c Jc]
Seat 2: B87ikIyZ/TzAVeXf38Ny0g (big blind) folded before Flop
Seat 4: ky55L0pITYgYLeqFB9gP/Q folded before Flop (didn't bet)
Seat 5: f2eTKbND+tM3kUw9o6WYWg (button) collected ($13.30)
Seat 6: InmkdI6G8TzSj9NhcCSyPg (small blind) folded on the Flop



PokerStars Game #59938930900:  Hold'em No Limit ($1/$2) - 2009/07/01 0:27:06 ET
Table 'W9UeSV0aoPjh5SFSxM8jUQ' 9-max Seat #9 is the button
Seat 1: cdC54j9fGGojcbzWB5PgzA ($202.60 in chips)
Seat 2: iMe5yhc+1BaiIPHet3NMrA ($314.75 in chips)
Seat 3: TAfo4veNRaRlzDXMMYS3Jg ($37 in chips)
Seat 4: De9g+AYjo0DN6C/+iT/nsg ($286.10 in chips)
Seat 5: CUZwDpLTQKhzarPe+JCLOQ ($200 in chips)
Seat 6: MXxB6weBWzZyAhRZb+/KVg ($200 in chips)
Seat 7: 4Cl43Q1TYQL8wn1NSCUkaw ($50.15 in chips)
Seat 8: GX1heJ+DSsvm7gzSPsYhhQ ($37.80 in chips)
Seat 9: U2A5Hv6ib/5+gzO2wr7Z4w ($394 in chips)
cdC54j9fGGojcbzWB5PgzA: posts small blind $1
iMe5yhc+1BaiIPHet3NMrA: posts big blind $2
*** HOLE CARDS ***
TAfo4veNRaRlzDXMMYS3Jg: folds
De9g+AYjo0DN6C/+iT/nsg: folds
CUZwDpLTQKhzarPe+JCLOQ: folds
MXxB6weBWzZyAhRZb+/KVg: folds
4Cl43Q1TYQL8wn1NSCUkaw: folds
GX1heJ+DSsvm7gzSPsYhhQ: raises $4 to $6
U2A5Hv6ib/5+gzO2wr7Z4w: folds
cdC54j9fGGojcbzWB5PgzA: folds
iMe5yhc+1BaiIPHet3NMrA: folds
GX1heJ+DSsvm7gzSPsYhhQ collected $5 from pot
*** SUMMARY ***
Total pot $5 | Rake $0
Seat 1: cdC54j9fGGojcbzWB5PgzA (small blind) folded before Flop
Seat 2: iMe5yhc+1BaiIPHet3NMrA (big blind) folded before Flop
Seat 3: TAfo4veNRaRlzDXMMYS3Jg folded before Flop (didn't bet)
Seat 4: De9g+AYjo0DN6C/+iT/nsg folded before Flop (didn't bet)
Seat 5: CUZwDpLTQKhzarPe+JCLOQ folded before Flop (didn't bet)
Seat 6: MXxB6weBWzZyAhRZb+/KVg folded before Flop (didn't bet)
Seat 7: 4Cl43Q1TYQL8wn1NSCUkaw folded before Flop (didn't bet)
Seat 8: GX1heJ+DSsvm7gzSPsYhhQ collected ($5)
Seat 9: U2A5Hv6ib/5+gzO2wr7Z4w (button) folded before Flop (didn't bet)



PokerStars Game #59938933120:  Hold'em No Limit ($1/$2) - 2009/07/01 0:27:09 ET
Table '5G1PjWSk2ALz0O/eqyYy/g' 2-max Seat #2 is the button
Seat 1: Z4HwehErEwzsv/noQlfUlg ($128.90 in chips)
Seat 2: v4dp1VoMhJV4zmCXtmG5LQ ($255.50 in chips)
v4dp1VoMhJV4zmCXtmG5LQ: posts small blind $1
Z4HwehErEwzsv/noQlfUlg: posts big blind $2
*** HOLE CARDS ***
v4dp1VoMhJV4zmCXtmG5LQ: raises $4 to $6
Z4HwehErEwzsv/noQlfUlg: raises $4 to $10
v4dp1VoMhJV4zmCXtmG5LQ: calls $4
*** FLOP *** [5d 9s 8c]
Z4HwehErEwzsv/noQlfUlg: bets $8
v4dp1VoMhJV4zmCXtmG5LQ: folds
Z4HwehErEwzsv/noQlfUlg collected $19.50 from pot
Z4HwehErEwzsv/noQlfUlg: doesn't show hand
*** SUMMARY ***
Total pot $20 | Rake $0.50
Board [5d 9s 8c]
Seat 1: Z4HwehErEwzsv/noQlfUlg (big blind) collected ($19.50)
Seat 2: v4dp1VoMhJV4zmCXtmG5LQ (button) (small blind) folded on the Flop



PokerStars Game #59938934014:  Hold'em No Limit ($1/$2) - 2009/07/01 0:27:10 ET
Table 'aSf77Sj8QEnzcc0WaxVD4Q' 6-max Seat #1 is the button
Seat 1: 54yWzRRgS0oZ+S6LwZBxMQ ($37.80 in chips)
Seat 2: vkfxu8f/jMYKUk6Ly4eujw ($245.15 in chips)
Seat 3: 9dpyyjDTCed6nV7JhaUUpw ($204.30 in chips)
Seat 4: 513FcCI8jHyQy2VWoIQkMg ($202 in chips)
Seat 5: InmkdI6G8TzSj9NhcCSyPg ($257.65 in chips)
Seat 6: vkoJRf3gidxY1pPi0AFWww ($297.80 in chips)
vkfxu8f/jMYKUk6Ly4eujw: posts small blind $1
9dpyyjDTCed6nV7JhaUUpw: posts big blind $2
*** HOLE CARDS ***
513FcCI8jHyQy2VWoIQkMg: folds
InmkdI6G8TzSj9NhcCSyPg: folds
vkoJRf3gidxY1pPi0AFWww: folds
54yWzRRgS0oZ+S6LwZBxMQ: folds
vkfxu8f/jMYKUk6Ly4eujw: folds
9dpyyjDTCed6nV7JhaUUpw collected $2 from pot
9dpyyjDTCed6nV7JhaUUpw: doesn't show hand
*** SUMMARY ***
Total pot $2 | Rake $0
Seat 1: 54yWzRRgS0oZ+S6LwZBxMQ (button) folded before Flop (didn't bet)
Seat 2: vkfxu8f/jMYKUk6Ly4eujw (small blind) folded before Flop
Seat 3: 9dpyyjDTCed6nV7JhaUUpw (big blind) collected ($2)
Seat 4: 513FcCI8jHyQy2VWoIQkMg folded before Flop (didn't bet)
Seat 5: InmkdI6G8TzSj9NhcCSyPg folded before Flop (didn't bet)
Seat 6: vkoJRf3gidxY1pPi0AFWww folded before Flop (didn't bet)



PokerStars Game #59938935210:  Hold'em No Limit ($1/$2) - 2009/07/01 0:27:12 ET
Table 'uJ9juaXXg9yIcSU8amxaXQ' 6-max Seat #4 is the button
Seat 2: yynBOXUjw28V5kz84sxX4g ($152.30 in chips)
Seat 4: zNjJ/y4emmF+vzrCDd+ooA ($116.90 in chips)
Seat 5: aMZYAxFxWTQXE9aUus4sxg ($56.85 in chips)
Seat 6: XrFG4dK06RVKLlX32/pjcQ ($43.60 in chips)
aMZYAxFxWTQXE9aUus4sxg: posts small blind $1
XrFG4dK06RVKLlX32/pjcQ: posts big blind $2
JsqOjN/eHz0uYVf/PyUJ6Q: sits out
*** HOLE CARDS ***
yynBOXUjw28V5kz84sxX4g: calls $2
zNjJ/y4emmF+vzrCDd+ooA: folds
aMZYAxFxWTQXE9aUus4sxg: calls $1
XrFG4dK06RVKLlX32/pjcQ: checks
*** FLOP *** [Qs 2h Kh]
aMZYAxFxWTQXE9aUus4sxg: checks
XrFG4dK06RVKLlX32/pjcQ: checks
yynBOXUjw28V5kz84sxX4g: checks
*** TURN *** [Qs 2h Kh] [8s]
aMZYAxFxWTQXE9aUus4sxg: bets $2
XrFG4dK06RVKLlX32/pjcQ: folds
yynBOXUjw28V5kz84sxX4g: folds
aMZYAxFxWTQXE9aUus4sxg collected $5.70 from pot
*** SUMMARY ***
Total pot $6 | Rake $0.30
Board [Qs 2h Kh 8s]
Seat 2: yynBOXUjw28V5kz84sxX4g folded on the Turn
Seat 4: zNjJ/y4emmF+vzrCDd+ooA (button) folded before Flop (didn't bet)
Seat 5: aMZYAxFxWTQXE9aUus4sxg (small blind) collected ($5.70)
Seat 6: XrFG4dK06RVKLlX32/pjcQ (big blind) folded on the Turn



PokerStars Game #59938935612:  Hold'em No Limit ($1/$2) - 2009/07/01 0:27:13 ET
Table 'bIihwBANJSFqlHPPtset+w' 9-max Seat #4 is the button
Seat 1: jI3JDUGV63ccqtKgM3vMbw ($167.75 in chips)
Seat 2: lQYT23h5QCUVZAKxjOO39Q ($109.90 in chips)
Seat 3: acnZ0LD5jxKgWIHz+mpQ8Q ($215.75 in chips)
Seat 4: 7WWX5PClBdr/U44gUKBIEA ($286.05 in chips)
Seat 5: rNejrG5tkeRBbL+UmC0iJA ($199.15 in chips)
Seat 6: 5iPk5MyO3KVu18Y8XCYfFQ ($66.80 in chips)
Seat 7: pCmk6FpSOLJ+85o1tLHIag ($90 in chips)
Seat 8: iMe5yhc+1BaiIPHet3NMrA ($275.65 in chips)
rNejrG5tkeRBbL+UmC0iJA: posts small blind $1
5iPk5MyO3KVu18Y8XCYfFQ: posts big blind $2
GX1heJ+DSsvm7gzSPsYhhQ: sits out
*** HOLE CARDS ***
pCmk6FpSOLJ+85o1tLHIag: folds
iMe5yhc+1BaiIPHet3NMrA: folds
jI3JDUGV63ccqtKgM3vMbw: folds
lQYT23h5QCUVZAKxjOO39Q: calls $2
acnZ0LD5jxKgWIHz+mpQ8Q: raises $6 to $8
7WWX5PClBdr/U44gUKBIEA: folds
rNejrG5tkeRBbL+UmC0iJA: folds
5iPk5MyO3KVu18Y8XCYfFQ: folds
lQYT23h5QCUVZAKxjOO39Q: calls $6
*** FLOP *** [Ac 2d 4c]
lQYT23h5QCUVZAKxjOO39Q: checks
acnZ0LD5jxKgWIHz+mpQ8Q: bets $12
lQYT23h5QCUVZAKxjOO39Q: calls $12
*** TURN *** [Ac 2d 4c] [4s]
lQYT23h5QCUVZAKxjOO39Q: bets $12
acnZ0LD5jxKgWIHz+mpQ8Q: calls $12
*** RIVER *** [Ac 2d 4c 4s] [8s]
lQYT23h5QCUVZAKxjOO39Q: checks
acnZ0LD5jxKgWIHz+mpQ8Q: bets $80
lQYT23h5QCUVZAKxjOO39Q said, "bluf"
lQYT23h5QCUVZAKxjOO39Q: folds
acnZ0LD5jxKgWIHz+mpQ8Q collected $64 from pot
*** SUMMARY ***
Total pot $67 | Rake $3
Board [Ac 2d 4c 4s 8s]
Seat 1: jI3JDUGV63ccqtKgM3vMbw folded before Flop (didn't bet)
Seat 2: lQYT23h5QCUVZAKxjOO39Q folded on the River
Seat 3: acnZ0LD5jxKgWIHz+mpQ8Q collected ($64)
Seat 4: 7WWX5PClBdr/U44gUKBIEA (button) folded before Flop (didn't bet)
Seat 5: rNejrG5tkeRBbL+UmC0iJA (small blind) folded before Flop
Seat 6: 5iPk5MyO3KVu18Y8XCYfFQ (big blind) folded before Flop
Seat 7: pCmk6FpSOLJ+85o1tLHIag folded before Flop (didn't bet)
Seat 8: iMe5yhc+1BaiIPHet3NMrA folded before Flop (didn't bet)



PokerStars Game #59938938644:  Hold'em No Limit ($1/$2) - 2009/07/01 0:27:17 ET
Table 'jCW99a4MXoPgL0PwEZ4IuQ' 2-max Seat #2 is the button
Seat 1: t6Jd836OSEMbcRi7rfGp5g ($200 in chips)
Seat 2: bWN162Ep6lKyJ0MW6unz4w ($258.50 in chips)
bWN162Ep6lKyJ0MW6unz4w: posts small blind $1
t6Jd836OSEMbcRi7rfGp5g: posts big blind $2
*** HOLE CARDS ***
bWN162Ep6lKyJ0MW6unz4w: folds
t6Jd836OSEMbcRi7rfGp5g collected $2 from pot
*** SUMMARY ***
Total pot $2 | Rake $0
Seat 1: t6Jd836OSEMbcRi7rfGp5g (big blind) collected ($2)
Seat 2: bWN162Ep6lKyJ0MW6unz4w (button) (small blind) folded before Flop



PokerStars Game #59938942154:  Hold'em No Limit ($1/$2) - 2009/07/01 0:27:23 ET
Table 'eyAQSIlgc2o1Jxvbve4WGg' 9-max Seat #9 is the button
Seat 1: UZEsV9yKUMqmpYPiOFpaZw ($69 in chips)
Seat 2: g7gL2NLJCdZPPV399WKT1w ($48 in chips)
Seat 4: miAHPEBdznuHNzK6YM3hRA ($125.55 in chips)
Seat 5: JnV3SM2D6dAFYyGZHHpvrg ($100 in chips)
Seat 6: IikcENBHwoT7snSvBPSc7Q ($164 in chips)
Seat 7: QHxJjpVYwitg9krW6wZgJA ($213.90 in chips)
Seat 8: 5iPk5MyO3KVu18Y8XCYfFQ ($40 in chips)
Seat 9: GX1heJ+DSsvm7gzSPsYhhQ ($39 in chips)
UZEsV9yKUMqmpYPiOFpaZw: posts small blind $1
g7gL2NLJCdZPPV399WKT1w: posts big blind $2
*** HOLE CARDS ***
miAHPEBdznuHNzK6YM3hRA: raises $2 to $4
pcpwdr joins the table at seat #3
JnV3SM2D6dAFYyGZHHpvrg: calls $4
IikcENBHwoT7snSvBPSc7Q: folds
pcpwdr leaves the table
QHxJjpVYwitg9krW6wZgJA: folds
5iPk5MyO3KVu18Y8XCYfFQ: folds
GX1heJ+DSsvm7gzSPsYhhQ: folds
oJooWHfAxUkwfT5OoynLdw joins the table at seat #3
UZEsV9yKUMqmpYPiOFpaZw: folds
g7gL2NLJCdZPPV399WKT1w: folds
*** FLOP *** [Ts 8d 6s]
miAHPEBdznuHNzK6YM3hRA: bets $2
JnV3SM2D6dAFYyGZHHpvrg: calls $2
*** TURN *** [Ts 8d 6s] [2d]
miAHPEBdznuHNzK6YM3hRA: bets $12
JnV3SM2D6dAFYyGZHHpvrg: calls $12
*** RIVER *** [Ts 8d 6s 2d] [9s]
miAHPEBdznuHNzK6YM3hRA: bets $12
JnV3SM2D6dAFYyGZHHpvrg: raises $21 to $33
miAHPEBdznuHNzK6YM3hRA: folds
JnV3SM2D6dAFYyGZHHpvrg collected $60 from pot
*** SUMMARY ***
Total pot $63 | Rake $3
Board [Ts 8d 6s 2d 9s]
Seat 1: UZEsV9yKUMqmpYPiOFpaZw (small blind) folded before Flop
Seat 2: g7gL2NLJCdZPPV399WKT1w (big blind) folded before Flop
Seat 4: miAHPEBdznuHNzK6YM3hRA folded on the River
Seat 5: JnV3SM2D6dAFYyGZHHpvrg collected ($60)
Seat 6: IikcENBHwoT7snSvBPSc7Q folded before Flop (didn't bet)
Seat 7: QHxJjpVYwitg9krW6wZgJA folded before Flop (didn't bet)
Seat 8: 5iPk5MyO3KVu18Y8XCYfFQ folded before Flop (didn't bet)
Seat 9: GX1heJ+DSsvm7gzSPsYhhQ (button) folded before Flop (didn't bet)



PokerStars Game #59938942836:  Hold'em No Limit ($1/$2) - 2009/07/01 0:27:24 ET
Table 'jCW99a4MXoPgL0PwEZ4IuQ' 2-max Seat #1 is the button
Seat 1: t6Jd836OSEMbcRi7rfGp5g ($201 in chips)
Seat 2: bWN162Ep6lKyJ0MW6unz4w ($257.50 in chips)
t6Jd836OSEMbcRi7rfGp5g: posts small blind $1
bWN162Ep6lKyJ0MW6unz4w: posts big blind $2
*** HOLE CARDS ***
t6Jd836OSEMbcRi7rfGp5g: raises $4 to $6
bWN162Ep6lKyJ0MW6unz4w: folds
t6Jd836OSEMbcRi7rfGp5g collected $4 from pot
*** SUMMARY ***
Total pot $4 | Rake $0
Seat 1: t6Jd836OSEMbcRi7rfGp5g (button) (small blind) collected ($4)
Seat 2: bWN162Ep6lKyJ0MW6unz4w (big blind) folded before Flop



PokerStars Game #59938944768:  Hold'em No Limit ($1/$2) - 2009/07/01 0:27:26 ET
Table 'P/yCfYl1GfGsu/e6DxDy/A' 2-max Seat #2 is the button
Seat 1: 7fOCUy3x9hdkmXkkDNolGQ ($386.50 in chips)
Seat 2: RwDoM55ZeQuI2ADyJhOb2Q ($636 in chips)
RwDoM55ZeQuI2ADyJhOb2Q: posts small blind $1
7fOCUy3x9hdkmXkkDNolGQ: posts big blind $2
*** HOLE CARDS ***
RwDoM55ZeQuI2ADyJhOb2Q: folds
7fOCUy3x9hdkmXkkDNolGQ collected $2 from pot
7fOCUy3x9hdkmXkkDNolGQ: doesn't show hand
*** SUMMARY ***
Total pot $2 | Rake $0
Seat 1: 7fOCUy3x9hdkmXkkDNolGQ (big blind) collected ($2)
Seat 2: RwDoM55ZeQuI2ADyJhOb2Q (button) (small blind) folded before Flop



PokerStars Game #59938944420:  Hold'em No Limit ($1/$2) - 2009/07/01 0:27:26 ET
Table '5G1PjWSk2ALz0O/eqyYy/g' 2-max Seat #1 is the button
Seat 1: Z4HwehErEwzsv/noQlfUlg ($138.40 in chips)
Seat 2: v4dp1VoMhJV4zmCXtmG5LQ ($245.50 in chips)
Z4HwehErEwzsv/noQlfUlg: posts small blind $1
v4dp1VoMhJV4zmCXtmG5LQ: posts big blind $2
*** HOLE CARDS ***
Z4HwehErEwzsv/noQlfUlg: folds
v4dp1VoMhJV4zmCXtmG5LQ collected $2 from pot
v4dp1VoMhJV4zmCXtmG5LQ: doesn't show hand
*** SUMMARY ***
Total pot $2 | Rake $0
Seat 1: Z4HwehErEwzsv/noQlfUlg (button) (small blind) folded before Flop
Seat 2: v4dp1VoMhJV4zmCXtmG5LQ (big blind) collected ($2)



PokerStars Game #59938944338:  Hold'em No Limit ($1/$2) - 2009/07/01 0:27:26 ET
Table 'gftD4mDF7mIFKvSrIyaRbw' 9-max Seat #6 is the button
Seat 2: CKDJ8bJWIRDDBziHsebH5w ($145.45 in chips)
Seat 3: CUZwDpLTQKhzarPe+JCLOQ ($200 in chips)
Seat 4: eeMEdaNqHXOk6uYL+zQnAA ($79.10 in chips)
Seat 5: mpsfNtnMVDqQHTe92AhIdw ($286.20 in chips)
Seat 6: 2NvwF8W2nzsbS+G//yLAbQ ($93.95 in chips)
Seat 7: 5iPk5MyO3KVu18Y8XCYfFQ ($38 in chips)
Seat 8: R/wPwjEcvTU2fxPXxn/XgQ ($76.55 in chips)
Seat 9: F7m34OOfAQ7annesMHVjKw ($217.30 in chips)
5iPk5MyO3KVu18Y8XCYfFQ: posts small blind $1
R/wPwjEcvTU2fxPXxn/XgQ: posts big blind $2
*** HOLE CARDS ***
F7m34OOfAQ7annesMHVjKw: folds
CKDJ8bJWIRDDBziHsebH5w: raises $2 to $4
CUZwDpLTQKhzarPe+JCLOQ: folds
eeMEdaNqHXOk6uYL+zQnAA: calls $4
mpsfNtnMVDqQHTe92AhIdw: folds
2NvwF8W2nzsbS+G//yLAbQ: folds
5iPk5MyO3KVu18Y8XCYfFQ: folds
R/wPwjEcvTU2fxPXxn/XgQ: calls $2
*** FLOP *** [Jh 4c Ad]
R/wPwjEcvTU2fxPXxn/XgQ: checks
CKDJ8bJWIRDDBziHsebH5w: bets $6
eeMEdaNqHXOk6uYL+zQnAA: folds
R/wPwjEcvTU2fxPXxn/XgQ: folds
CKDJ8bJWIRDDBziHsebH5w collected $12.35 from pot
CKDJ8bJWIRDDBziHsebH5w: doesn't show hand
*** SUMMARY ***
Total pot $13 | Rake $0.65
Board [Jh 4c Ad]
Seat 2: CKDJ8bJWIRDDBziHsebH5w collected ($12.35)
Seat 3: CUZwDpLTQKhzarPe+JCLOQ folded before Flop (didn't bet)
Seat 4: eeMEdaNqHXOk6uYL+zQnAA folded on the Flop
Seat 5: mpsfNtnMVDqQHTe92AhIdw folded before Flop (didn't bet)
Seat 6: 2NvwF8W2nzsbS+G//yLAbQ (button) folded before Flop (didn't bet)
Seat 7: 5iPk5MyO3KVu18Y8XCYfFQ (small blind) folded before Flop
Seat 8: R/wPwjEcvTU2fxPXxn/XgQ (big blind) folded on the Flop
Seat 9: F7m34OOfAQ7annesMHVjKw folded before Flop (didn't bet)



PokerStars Game #59938944674:  Hold'em No Limit ($1/$2) - 2009/07/01 0:27:26 ET
Table 'YqGfR5eHfMeSjb9a+QU9rg' 9-max Seat #8 is the button
Seat 1: qCBuzVnLcBR29snMAHq9PA ($111.90 in chips)
Seat 2: W3Nqt1GWlTi9tXQXMNEvgw ($255.75 in chips)
Seat 3: /gll27k+xWYV7Fbki0lFDQ ($110.85 in chips)
Seat 4: QHxJjpVYwitg9krW6wZgJA ($200 in chips)
Seat 5: MOBMOMQRN/z+fiGXGnZojw ($247.50 in chips)
Seat 6: 5iPk5MyO3KVu18Y8XCYfFQ ($42 in chips)
Seat 7: tAhiYXx1KvTp5hhBamTYfQ ($206.60 in chips)
Seat 8: JnV3SM2D6dAFYyGZHHpvrg ($95 in chips)
Seat 9: /inIs/z/PcX+TniIFpaxpg ($22 in chips)
/inIs/z/PcX+TniIFpaxpg: posts small blind $1
qCBuzVnLcBR29snMAHq9PA: posts big blind $2
*** HOLE CARDS ***
W3Nqt1GWlTi9tXQXMNEvgw: folds
/gll27k+xWYV7Fbki0lFDQ: folds
QHxJjpVYwitg9krW6wZgJA: folds
MOBMOMQRN/z+fiGXGnZojw: folds
5iPk5MyO3KVu18Y8XCYfFQ: folds
tAhiYXx1KvTp5hhBamTYfQ: raises $6 to $8
JnV3SM2D6dAFYyGZHHpvrg: folds
/inIs/z/PcX+TniIFpaxpg: folds
qCBuzVnLcBR29snMAHq9PA: folds
tAhiYXx1KvTp5hhBamTYfQ collected $5 from pot
tAhiYXx1KvTp5hhBamTYfQ: doesn't show hand
*** SUMMARY ***
Total pot $5 | Rake $0
Seat 1: qCBuzVnLcBR29snMAHq9PA (big blind) folded before Flop
Seat 2: W3Nqt1GWlTi9tXQXMNEvgw folded before Flop (didn't bet)
Seat 3: /gll27k+xWYV7Fbki0lFDQ folded before Flop (didn't bet)
Seat 4: QHxJjpVYwitg9krW6wZgJA folded before Flop (didn't bet)
Seat 5: MOBMOMQRN/z+fiGXGnZojw folded before Flop (didn't bet)
Seat 6: 5iPk5MyO3KVu18Y8XCYfFQ folded before Flop (didn't bet)
Seat 7: tAhiYXx1KvTp5hhBamTYfQ collected ($5)
Seat 8: JnV3SM2D6dAFYyGZHHpvrg (button) folded before Flop (didn't bet)
Seat 9: /inIs/z/PcX+TniIFpaxpg (small blind) folded before Flop



PokerStars Game #59938945288:  Hold'em No Limit ($1/$2) - 2009/07/01 0:27:27 ET
Table 'QxerF7GUfCbl+4a8XaTB2w' 6-max Seat #3 is the button
Seat 1: o9jamqIi6sTTRSqudgboRA ($203 in chips)
Seat 2: 513FcCI8jHyQy2VWoIQkMg ($228.35 in chips)
Seat 3: vkfxu8f/jMYKUk6Ly4eujw ($197 in chips)
Seat 4: WfaZs12BkYO+BUX5VWpuWQ ($55.20 in chips)
Seat 5: ezK4YR9nqEKpOT/tYPvHKA ($126.60 in chips)
Seat 6: RUZs7P4uzWavoA6iEpDKLw ($126.85 in chips)
WfaZs12BkYO+BUX5VWpuWQ: posts small blind $1
ezK4YR9nqEKpOT/tYPvHKA: posts big blind $2
*** HOLE CARDS ***
RUZs7P4uzWavoA6iEpDKLw: calls $2
o9jamqIi6sTTRSqudgboRA: folds
513FcCI8jHyQy2VWoIQkMg: folds
vkfxu8f/jMYKUk6Ly4eujw: folds
WfaZs12BkYO+BUX5VWpuWQ: folds
ezK4YR9nqEKpOT/tYPvHKA: checks
*** FLOP *** [7d 7h 7s]
ezK4YR9nqEKpOT/tYPvHKA: checks
RUZs7P4uzWavoA6iEpDKLw: bets $4
ezK4YR9nqEKpOT/tYPvHKA: folds
RUZs7P4uzWavoA6iEpDKLw collected $4.75 from pot
RUZs7P4uzWavoA6iEpDKLw: doesn't show hand
*** SUMMARY ***
Total pot $5 | Rake $0.25
Board [7d 7h 7s]
Seat 1: o9jamqIi6sTTRSqudgboRA folded before Flop (didn't bet)
Seat 2: 513FcCI8jHyQy2VWoIQkMg folded before Flop (didn't bet)
Seat 3: vkfxu8f/jMYKUk6Ly4eujw (button) folded before Flop (didn't bet)
Seat 4: WfaZs12BkYO+BUX5VWpuWQ (small blind) folded before Flop
Seat 5: ezK4YR9nqEKpOT/tYPvHKA (big blind) folded on the Flop
Seat 6: RUZs7P4uzWavoA6iEpDKLw collected ($4.75)



PokerStars Game #59938946264:  Hold'em No Limit ($1/$2) - 2009/07/01 0:27:29 ET
Table 'CFkQcfWjKccZaZDf71FK+w' 6-max Seat #5 is the button
Seat 1: U2A5Hv6ib/5+gzO2wr7Z4w ($201 in chips)
Seat 2: X7GlkHF+lkbarCLuZ4Uf0w ($29 in chips)
Seat 3: R5/GXj0PUdNkzHU6Omb/JA ($95 in chips)
Seat 4: e8nZKSbIdIO7e2NdQe/OFQ ($233.80 in chips)
Seat 5: 1njbh8TKSUF6l4V1XwGdcg ($224.80 in chips)
U2A5Hv6ib/5+gzO2wr7Z4w: posts small blind $1
X7GlkHF+lkbarCLuZ4Uf0w: posts big blind $2
*** HOLE CARDS ***
R5/GXj0PUdNkzHU6Omb/JA: folds
e8nZKSbIdIO7e2NdQe/OFQ: folds
1njbh8TKSUF6l4V1XwGdcg: folds
U2A5Hv6ib/5+gzO2wr7Z4w: raises $4 to $6
X7GlkHF+lkbarCLuZ4Uf0w: folds
U2A5Hv6ib/5+gzO2wr7Z4w collected $4 from pot
*** SUMMARY ***
Total pot $4 | Rake $0
Seat 1: U2A5Hv6ib/5+gzO2wr7Z4w (small blind) collected ($4)
Seat 2: X7GlkHF+lkbarCLuZ4Uf0w (big blind) folded before Flop
Seat 3: R5/GXj0PUdNkzHU6Omb/JA folded before Flop (didn't bet)
Seat 4: e8nZKSbIdIO7e2NdQe/OFQ folded before Flop (didn't bet)
Seat 5: 1njbh8TKSUF6l4V1XwGdcg (button) folded before Flop (didn't bet)



PokerStars Game #59938947468:  Hold'em No Limit ($1/$2) - 2009/07/01 0:27:31 ET
Table 'jCW99a4MXoPgL0PwEZ4IuQ' 2-max Seat #2 is the button
Seat 1: t6Jd836OSEMbcRi7rfGp5g ($203 in chips)
Seat 2: bWN162Ep6lKyJ0MW6unz4w ($255.50 in chips)
bWN162Ep6lKyJ0MW6unz4w: posts small blind $1
t6Jd836OSEMbcRi7rfGp5g: posts big blind $2
*** HOLE CARDS ***
bWN162Ep6lKyJ0MW6unz4w: raises $4 to $6
t6Jd836OSEMbcRi7rfGp5g: calls $4
*** FLOP *** [Js 5h 2c]
t6Jd836OSEMbcRi7rfGp5g: checks
bWN162Ep6lKyJ0MW6unz4w: checks
*** TURN *** [Js 5h 2c] [Ad]
t6Jd836OSEMbcRi7rfGp5g: checks
bWN162Ep6lKyJ0MW6unz4w: checks
*** RIVER *** [Js 5h 2c Ad] [3s]
t6Jd836OSEMbcRi7rfGp5g: checks
bWN162Ep6lKyJ0MW6unz4w: bets $6
t6Jd836OSEMbcRi7rfGp5g: calls $6
*** SHOW DOWN ***
bWN162Ep6lKyJ0MW6unz4w: shows [Kc Ah] (a pair of Aces)
t6Jd836OSEMbcRi7rfGp5g: mucks hand
bWN162Ep6lKyJ0MW6unz4w collected $23.50 from pot
*** SUMMARY ***
Total pot $24 | Rake $0.50
Board [Js 5h 2c Ad 3s]
Seat 1: t6Jd836OSEMbcRi7rfGp5g (big blind) mucked
Seat 2: bWN162Ep6lKyJ0MW6unz4w (button) (small blind) showed [Kc Ah] and won ($23.50) with a pair of Aces



PokerStars Game #59938949094:  Hold'em No Limit ($1/$2) - 2009/07/01 0:27:33 ET
Table '5G1PjWSk2ALz0O/eqyYy/g' 2-max Seat #2 is the button
Seat 1: Z4HwehErEwzsv/noQlfUlg ($137.40 in chips)
Seat 2: v4dp1VoMhJV4zmCXtmG5LQ ($246.50 in chips)
v4dp1VoMhJV4zmCXtmG5LQ: posts small blind $1
Z4HwehErEwzsv/noQlfUlg: posts big blind $2
*** HOLE CARDS ***
v4dp1VoMhJV4zmCXtmG5LQ: raises $4 to $6
Z4HwehErEwzsv/noQlfUlg: calls $4
*** FLOP *** [8c 7c 4s]
Z4HwehErEwzsv/noQlfUlg: checks
v4dp1VoMhJV4zmCXtmG5LQ: bets $8
Z4HwehErEwzsv/noQlfUlg: calls $8
*** TURN *** [8c 7c 4s] [8s]
Z4HwehErEwzsv/noQlfUlg: checks
v4dp1VoMhJV4zmCXtmG5LQ: checks
*** RIVER *** [8c 7c 4s 8s] [4d]
Z4HwehErEwzsv/noQlfUlg: bets $29
v4dp1VoMhJV4zmCXtmG5LQ: folds
Z4HwehErEwzsv/noQlfUlg collected $27.50 from pot
Z4HwehErEwzsv/noQlfUlg: doesn't show hand
*** SUMMARY ***
Total pot $28 | Rake $0.50
Board [8c 7c 4s 8s 4d]
Seat 1: Z4HwehErEwzsv/noQlfUlg (big blind) collected ($27.50)
Seat 2: v4dp1VoMhJV4zmCXtmG5LQ (button) (small blind) folded on the River



PokerStars Game #59938949440:  Hold'em No Limit ($1/$2) - 2009/07/01 0:27:34 ET
Table 'P/yCfYl1GfGsu/e6DxDy/A' 2-max Seat #1 is the button
Seat 1: 7fOCUy3x9hdkmXkkDNolGQ ($387.50 in chips)
Seat 2: RwDoM55ZeQuI2ADyJhOb2Q ($635 in chips)
7fOCUy3x9hdkmXkkDNolGQ: posts small blind $1
RwDoM55ZeQuI2ADyJhOb2Q: posts big blind $2
*** HOLE CARDS ***
7fOCUy3x9hdkmXkkDNolGQ: folds
RwDoM55ZeQuI2ADyJhOb2Q collected $2 from pot
RwDoM55ZeQuI2ADyJhOb2Q: doesn't show hand
*** SUMMARY ***
Total pot $2 | Rake $0
Seat 1: 7fOCUy3x9hdkmXkkDNolGQ (button) (small blind) folded before Flop
Seat 2: RwDoM55ZeQuI2ADyJhOb2Q (big blind) collected ($2)



PokerStars Game #59938952420:  Hold'em No Limit ($1/$2) - 2009/07/01 0:27:38 ET
Table 'mGpP9StWRnoeiBDExc6Frg' 6-max Seat #1 is the button
Seat 1: zWFU82nxIRvzK4mKiL4m0Q ($50.15 in chips)
Seat 2: DQlskgG4OtLpF2MVxLwf4A ($341.85 in chips)
Seat 3: 3HrFUl+TAqSP1U00zz3P7A ($77.40 in chips)
Seat 4: qXDd0ZyMIse0OBu8pxeQ3Q ($218 in chips)
Seat 5: d1puGuVBE0fidn+5eRJ0tw ($135 in chips)
Seat 6: X7GlkHF+lkbarCLuZ4Uf0w ($53 in chips)
DQlskgG4OtLpF2MVxLwf4A: posts small blind $1
3HrFUl+TAqSP1U00zz3P7A: posts big blind $2
*** HOLE CARDS ***
qXDd0ZyMIse0OBu8pxeQ3Q: folds
d1puGuVBE0fidn+5eRJ0tw: folds
X7GlkHF+lkbarCLuZ4Uf0w: folds
zWFU82nxIRvzK4mKiL4m0Q: folds
DQlskgG4OtLpF2MVxLwf4A: folds
3HrFUl+TAqSP1U00zz3P7A collected $2 from pot
3HrFUl+TAqSP1U00zz3P7A: doesn't show hand
*** SUMMARY ***
Total pot $2 | Rake $0
Seat 1: zWFU82nxIRvzK4mKiL4m0Q (button) folded before Flop (didn't bet)
Seat 2: DQlskgG4OtLpF2MVxLwf4A (small blind) folded before Flop
Seat 3: 3HrFUl+TAqSP1U00zz3P7A (big blind) collected ($2)
Seat 4: qXDd0ZyMIse0OBu8pxeQ3Q folded before Flop (didn't bet)
Seat 5: d1puGuVBE0fidn+5eRJ0tw folded before Flop (didn't bet)
Seat 6: X7GlkHF+lkbarCLuZ4Uf0w folded before Flop (didn't bet)



PokerStars Game #59938952156:  Hold'em No Limit ($1/$2) - 2009/07/01 0:27:38 ET
Table 'ZzSIe0zTCDv+n6hfbY5tTg' 6-max Seat #6 is the button
Seat 2: B87ikIyZ/TzAVeXf38Ny0g ($200 in chips)
Seat 3: X7GlkHF+lkbarCLuZ4Uf0w ($63 in chips)
Seat 4: ky55L0pITYgYLeqFB9gP/Q ($135.40 in chips)
Seat 5: f2eTKbND+tM3kUw9o6WYWg ($167.50 in chips)
Seat 6: InmkdI6G8TzSj9NhcCSyPg ($200 in chips)
B87ikIyZ/TzAVeXf38Ny0g: posts small blind $1
X7GlkHF+lkbarCLuZ4Uf0w: posts big blind $2
*** HOLE CARDS ***
ky55L0pITYgYLeqFB9gP/Q: calls $2
8srN1dKQePlsv0GyTada+Q has returned
f2eTKbND+tM3kUw9o6WYWg: calls $2
InmkdI6G8TzSj9NhcCSyPg: folds
B87ikIyZ/TzAVeXf38Ny0g: calls $1
X7GlkHF+lkbarCLuZ4Uf0w: checks
*** FLOP *** [Tc 9h 2c]
B87ikIyZ/TzAVeXf38Ny0g: bets $6
X7GlkHF+lkbarCLuZ4Uf0w: calls $6
ky55L0pITYgYLeqFB9gP/Q: folds
f2eTKbND+tM3kUw9o6WYWg: folds
*** TURN *** [Tc 9h 2c] [Kh]
B87ikIyZ/TzAVeXf38Ny0g: checks
X7GlkHF+lkbarCLuZ4Uf0w: checks
*** RIVER *** [Tc 9h 2c Kh] [8h]
B87ikIyZ/TzAVeXf38Ny0g: checks
X7GlkHF+lkbarCLuZ4Uf0w: checks
*** SHOW DOWN ***
B87ikIyZ/TzAVeXf38Ny0g: shows [8s 7c] (a pair of Eights)
X7GlkHF+lkbarCLuZ4Uf0w: shows [Qs Td] (a pair of Tens)
X7GlkHF+lkbarCLuZ4Uf0w collected $19.05 from pot
*** SUMMARY ***
Total pot $20 | Rake $0.95
Board [Tc 9h 2c Kh 8h]
Seat 2: B87ikIyZ/TzAVeXf38Ny0g (small blind) showed [8s 7c] and lost with a pair of Eights
Seat 3: X7GlkHF+lkbarCLuZ4Uf0w (big blind) showed [Qs Td] and won ($19.05) with a pair of Tens
Seat 4: ky55L0pITYgYLeqFB9gP/Q folded on the Flop
Seat 5: f2eTKbND+tM3kUw9o6WYWg folded on the Flop
Seat 6: InmkdI6G8TzSj9NhcCSyPg (button) folded before Flop (didn't bet)



PokerStars Game #59938953008:  Hold'em No Limit ($1/$2) - 2009/07/01 0:27:39 ET
Table 'aSf77Sj8QEnzcc0WaxVD4Q' 6-max Seat #2 is the button
Seat 1: 54yWzRRgS0oZ+S6LwZBxMQ ($37.80 in chips)
Seat 2: vkfxu8f/jMYKUk6Ly4eujw ($244.15 in chips)
Seat 3: 9dpyyjDTCed6nV7JhaUUpw ($205.30 in chips)
Seat 4: 513FcCI8jHyQy2VWoIQkMg ($202 in chips)
Seat 5: InmkdI6G8TzSj9NhcCSyPg ($257.65 in chips)
Seat 6: vkoJRf3gidxY1pPi0AFWww ($297.80 in chips)
9dpyyjDTCed6nV7JhaUUpw: posts small blind $1
513FcCI8jHyQy2VWoIQkMg: posts big blind $2
*** HOLE CARDS ***
InmkdI6G8TzSj9NhcCSyPg: raises $4 to $6
vkoJRf3gidxY1pPi0AFWww: raises $12 to $18
54yWzRRgS0oZ+S6LwZBxMQ: folds
vkfxu8f/jMYKUk6Ly4eujw: folds
9dpyyjDTCed6nV7JhaUUpw: folds
513FcCI8jHyQy2VWoIQkMg: folds
InmkdI6G8TzSj9NhcCSyPg: folds
vkoJRf3gidxY1pPi0AFWww collected $15 from pot
vkoJRf3gidxY1pPi0AFWww: doesn't show hand
*** SUMMARY ***
Total pot $15 | Rake $0
Seat 1: 54yWzRRgS0oZ+S6LwZBxMQ folded before Flop (didn't bet)
Seat 2: vkfxu8f/jMYKUk6Ly4eujw (button) folded before Flop (didn't bet)
Seat 3: 9dpyyjDTCed6nV7JhaUUpw (small blind) folded before Flop
Seat 4: 513FcCI8jHyQy2VWoIQkMg (big blind) folded before Flop
Seat 5: InmkdI6G8TzSj9NhcCSyPg folded before Flop
Seat 6: vkoJRf3gidxY1pPi0AFWww collected ($15)



PokerStars Game #59938953210:  Hold'em No Limit ($1/$2) - 2009/07/01 0:27:39 ET
Table 'W9UeSV0aoPjh5SFSxM8jUQ' 9-max Seat #1 is the button
Seat 1: cdC54j9fGGojcbzWB5PgzA ($201.60 in chips)
Seat 2: iMe5yhc+1BaiIPHet3NMrA ($312.75 in chips)
Seat 5: CUZwDpLTQKhzarPe+JCLOQ ($200 in chips)
Seat 6: MXxB6weBWzZyAhRZb+/KVg ($200 in chips)
Seat 7: 4Cl43Q1TYQL8wn1NSCUkaw ($50.15 in chips)
Seat 8: GX1heJ+DSsvm7gzSPsYhhQ ($40.80 in chips)
Seat 9: U2A5Hv6ib/5+gzO2wr7Z4w ($394 in chips)
iMe5yhc+1BaiIPHet3NMrA: posts small blind $1
TAfo4veNRaRlzDXMMYS3Jg: is sitting out
De9g+AYjo0DN6C/+iT/nsg: is sitting out
De9g+AYjo0DN6C/+iT/nsg leaves the table
TAfo4veNRaRlzDXMMYS3Jg leaves the table
CUZwDpLTQKhzarPe+JCLOQ: posts big blind $2
*** HOLE CARDS ***
/inIs/z/PcX+TniIFpaxpg joins the table at seat #3
silverfox72 joins the table at seat #4
MXxB6weBWzZyAhRZb+/KVg: folds
4Cl43Q1TYQL8wn1NSCUkaw: folds
GX1heJ+DSsvm7gzSPsYhhQ: folds
U2A5Hv6ib/5+gzO2wr7Z4w: folds
cdC54j9fGGojcbzWB5PgzA: raises $4 to $6
iMe5yhc+1BaiIPHet3NMrA: folds
CUZwDpLTQKhzarPe+JCLOQ: folds
cdC54j9fGGojcbzWB5PgzA collected $5 from pot
*** SUMMARY ***
Total pot $5 | Rake $0
Seat 1: cdC54j9fGGojcbzWB5PgzA (button) collected ($5)
Seat 2: iMe5yhc+1BaiIPHet3NMrA (small blind) folded before Flop
Seat 5: CUZwDpLTQKhzarPe+JCLOQ (big blind) folded before Flop
Seat 6: MXxB6weBWzZyAhRZb+/KVg folded before Flop (didn't bet)
Seat 7: 4Cl43Q1TYQL8wn1NSCUkaw folded before Flop (didn't bet)
Seat 8: GX1heJ+DSsvm7gzSPsYhhQ folded before Flop (didn't bet)
Seat 9: U2A5Hv6ib/5+gzO2wr7Z4w folded before Flop (didn't bet)



PokerStars Game #59938954556:  Hold'em No Limit ($1/$2) - 2009/07/01 0:27:41 ET
Table 'NmY84NAf9Mh0ckAckHnh5g' 2-max Seat #1 is the button
Seat 1: 6hvg964TSqZ3AL/0XK9aVQ ($500.25 in chips)
Seat 2: RwDoM55ZeQuI2ADyJhOb2Q ($340.80 in chips)
6hvg964TSqZ3AL/0XK9aVQ: posts small blind $1
RwDoM55ZeQuI2ADyJhOb2Q: posts big blind $2
*** HOLE CARDS ***
6hvg964TSqZ3AL/0XK9aVQ: folds
RwDoM55ZeQuI2ADyJhOb2Q collected $2 from pot
RwDoM55ZeQuI2ADyJhOb2Q: doesn't show hand
*** SUMMARY ***
Total pot $2 | Rake $0
Seat 1: 6hvg964TSqZ3AL/0XK9aVQ (button) (small blind) folded before Flop
Seat 2: RwDoM55ZeQuI2ADyJhOb2Q (big blind) collected ($2)



PokerStars Game #59938954800:  Hold'em No Limit ($1/$2) - 2009/07/01 0:27:42 ET
Table 'P/yCfYl1GfGsu/e6DxDy/A' 2-max Seat #2 is the button
Seat 1: 7fOCUy3x9hdkmXkkDNolGQ ($386.50 in chips)
Seat 2: RwDoM55ZeQuI2ADyJhOb2Q ($636 in chips)
RwDoM55ZeQuI2ADyJhOb2Q: posts small blind $1
7fOCUy3x9hdkmXkkDNolGQ: posts big blind $2
*** HOLE CARDS ***
RwDoM55ZeQuI2ADyJhOb2Q: raises $4 to $6
7fOCUy3x9hdkmXkkDNolGQ: raises $14 to $20
RwDoM55ZeQuI2ADyJhOb2Q: calls $14
*** FLOP *** [6d As Td]
7fOCUy3x9hdkmXkkDNolGQ: checks
RwDoM55ZeQuI2ADyJhOb2Q: checks
*** TURN *** [6d As Td] [Ah]
7fOCUy3x9hdkmXkkDNolGQ: checks
RwDoM55ZeQuI2ADyJhOb2Q: bets $22
7fOCUy3x9hdkmXkkDNolGQ: calls $22
*** RIVER *** [6d As Td Ah] [4c]
7fOCUy3x9hdkmXkkDNolGQ: checks
RwDoM55ZeQuI2ADyJhOb2Q: bets $72
7fOCUy3x9hdkmXkkDNolGQ: calls $72
*** SHOW DOWN ***
RwDoM55ZeQuI2ADyJhOb2Q: shows [Qh Qd] (two pair, Aces and Queens)
7fOCUy3x9hdkmXkkDNolGQ: mucks hand
RwDoM55ZeQuI2ADyJhOb2Q collected $227.50 from pot
*** SUMMARY ***
Total pot $228 | Rake $0.50
Board [6d As Td Ah 4c]
Seat 1: 7fOCUy3x9hdkmXkkDNolGQ (big blind) mucked
Seat 2: RwDoM55ZeQuI2ADyJhOb2Q (button) (small blind) showed [Qh Qd] and won ($227.50) with two pair, Aces and Queens



PokerStars Game #59938955288:  Hold'em No Limit ($1/$2) - 2009/07/01 0:27:42 ET
Table 'gnHBqWll9O3fxG7Ojkz/ng' 9-max Seat #5 is the button
Seat 1: hpqdC/23wXosGOmzARr5NA ($179.05 in chips)
Seat 2: H6Z4+qu8gR0VUiPOijndVg ($200 in chips)
Seat 3: 5Q8U6iZbeO7xJSS4qvDP5g ($231.35 in chips)
Seat 4: n5XI5/7gN+gIubHFBH+mOw ($369.90 in chips)
Seat 5: rBQDMkKm9cZn6M9NPsiVew ($166.45 in chips)
Seat 6: 5iPk5MyO3KVu18Y8XCYfFQ ($40 in chips)
Seat 7: jqui3xAWCkcdPW36a6BD+w ($212.55 in chips)
Seat 8: cM6efHzdxoqYm0EQKP4TTQ ($113.15 in chips)
5iPk5MyO3KVu18Y8XCYfFQ: posts small blind $1
jqui3xAWCkcdPW36a6BD+w: posts big blind $2
GX1heJ+DSsvm7gzSPsYhhQ: sits out
*** HOLE CARDS ***
cM6efHzdxoqYm0EQKP4TTQ: calls $2
hpqdC/23wXosGOmzARr5NA: folds
H6Z4+qu8gR0VUiPOijndVg: folds
5Q8U6iZbeO7xJSS4qvDP5g: folds
n5XI5/7gN+gIubHFBH+mOw: folds
rBQDMkKm9cZn6M9NPsiVew: folds
5iPk5MyO3KVu18Y8XCYfFQ: folds
jqui3xAWCkcdPW36a6BD+w: checks
*** FLOP *** [Kc Td Kd]
jqui3xAWCkcdPW36a6BD+w: checks
cM6efHzdxoqYm0EQKP4TTQ: checks
*** TURN *** [Kc Td Kd] [8h]
jqui3xAWCkcdPW36a6BD+w: checks
cM6efHzdxoqYm0EQKP4TTQ: checks
*** RIVER *** [Kc Td Kd 8h] [Js]
jqui3xAWCkcdPW36a6BD+w: checks
cM6efHzdxoqYm0EQKP4TTQ: bets $4
jqui3xAWCkcdPW36a6BD+w: folds
cM6efHzdxoqYm0EQKP4TTQ collected $4.75 from pot
cM6efHzdxoqYm0EQKP4TTQ: doesn't show hand
*** SUMMARY ***
Total pot $5 | Rake $0.25
Board [Kc Td Kd 8h Js]
Seat 1: hpqdC/23wXosGOmzARr5NA folded before Flop (didn't bet)
Seat 2: H6Z4+qu8gR0VUiPOijndVg folded before Flop (didn't bet)
Seat 3: 5Q8U6iZbeO7xJSS4qvDP5g folded before Flop (didn't bet)
Seat 4: n5XI5/7gN+gIubHFBH+mOw folded before Flop (didn't bet)
Seat 5: rBQDMkKm9cZn6M9NPsiVew (button) folded before Flop (didn't bet)
Seat 6: 5iPk5MyO3KVu18Y8XCYfFQ (small blind) folded before Flop
Seat 7: jqui3xAWCkcdPW36a6BD+w (big blind) folded on the River
Seat 8: cM6efHzdxoqYm0EQKP4TTQ collected ($4.75)



PokerStars Game #59938955742:  Hold'em No Limit ($1/$2) - 2009/07/01 0:27:43 ET
Table 'uJ9juaXXg9yIcSU8amxaXQ' 6-max Seat #5 is the button
Seat 1: JsqOjN/eHz0uYVf/PyUJ6Q ($38 in chips)
Seat 2: yynBOXUjw28V5kz84sxX4g ($150.30 in chips)
Seat 4: zNjJ/y4emmF+vzrCDd+ooA ($116.90 in chips)
Seat 5: aMZYAxFxWTQXE9aUus4sxg ($60.55 in chips)
Seat 6: XrFG4dK06RVKLlX32/pjcQ ($41.60 in chips)
XrFG4dK06RVKLlX32/pjcQ: posts small blind $1
JsqOjN/eHz0uYVf/PyUJ6Q: posts big blind $2
*** HOLE CARDS ***
yynBOXUjw28V5kz84sxX4g: folds
zNjJ/y4emmF+vzrCDd+ooA: folds
aMZYAxFxWTQXE9aUus4sxg: calls $2
XrFG4dK06RVKLlX32/pjcQ: calls $1
JsqOjN/eHz0uYVf/PyUJ6Q: raises $2 to $4
aMZYAxFxWTQXE9aUus4sxg: calls $2
XrFG4dK06RVKLlX32/pjcQ: folds
*** FLOP *** [6s 6h 3h]
JsqOjN/eHz0uYVf/PyUJ6Q: bets $4
aMZYAxFxWTQXE9aUus4sxg: folds
JsqOjN/eHz0uYVf/PyUJ6Q collected $9.50 from pot
JsqOjN/eHz0uYVf/PyUJ6Q: doesn't show hand
*** SUMMARY ***
Total pot $10 | Rake $0.50
Board [6s 6h 3h]
Seat 1: JsqOjN/eHz0uYVf/PyUJ6Q (big blind) collected ($9.50)
Seat 2: yynBOXUjw28V5kz84sxX4g folded before Flop (didn't bet)
Seat 4: zNjJ/y4emmF+vzrCDd+ooA folded before Flop (didn't bet)
Seat 5: aMZYAxFxWTQXE9aUus4sxg (button) folded on the Flop
Seat 6: XrFG4dK06RVKLlX32/pjcQ (small blind) folded before Flop



PokerStars Game #59938956460:  Hold'em No Limit ($1/$2) - 2009/07/01 0:27:44 ET
Table 'srul5UFZXTEccVV5fpY91g' 9-max Seat #7 is the button
Seat 1: lfD8cBv31A/pio3pXJbPjA ($153.20 in chips)
Seat 2: tJYod1SLp2AcWPL/3hZ7ug ($80.95 in chips)
Seat 4: GG5lTuGt3+kwNYSbqeB6yw ($162.15 in chips)
Seat 5: 5iPk5MyO3KVu18Y8XCYfFQ ($76.55 in chips)
Seat 7: s0erZsDxbZSaEPheMgibKg ($441.10 in chips)
Seat 8: UZEsV9yKUMqmpYPiOFpaZw ($74 in chips)
Seat 9: jRGC4KXXODbHEN275TXFCA ($140.30 in chips)
UZEsV9yKUMqmpYPiOFpaZw: posts small blind $1
jRGC4KXXODbHEN275TXFCA: posts big blind $2
TAfo4veNRaRlzDXMMYS3Jg: is sitting out
*** HOLE CARDS ***
weUZ8S7tgbaeIpzi1gBNxQ has returned
lfD8cBv31A/pio3pXJbPjA: folds
TAfo4veNRaRlzDXMMYS3Jg leaves the table
tJYod1SLp2AcWPL/3hZ7ug: folds
GG5lTuGt3+kwNYSbqeB6yw: folds
weUZ8S7tgbaeIpzi1gBNxQ said, "nh"
5iPk5MyO3KVu18Y8XCYfFQ: folds
s0erZsDxbZSaEPheMgibKg: raises $8 to $10
UZEsV9yKUMqmpYPiOFpaZw: folds
jRGC4KXXODbHEN275TXFCA: folds
s0erZsDxbZSaEPheMgibKg collected $5 from pot
*** SUMMARY ***
Total pot $5 | Rake $0
Seat 1: lfD8cBv31A/pio3pXJbPjA folded before Flop (didn't bet)
Seat 2: tJYod1SLp2AcWPL/3hZ7ug folded before Flop (didn't bet)
Seat 4: GG5lTuGt3+kwNYSbqeB6yw folded before Flop (didn't bet)
Seat 5: 5iPk5MyO3KVu18Y8XCYfFQ folded before Flop (didn't bet)
Seat 7: s0erZsDxbZSaEPheMgibKg (button) collected ($5)
Seat 8: UZEsV9yKUMqmpYPiOFpaZw (small blind) folded before Flop
Seat 9: jRGC4KXXODbHEN275TXFCA (big blind) folded before Flop



PokerStars Game #59938956338:  Hold'em No Limit ($1/$2) - 2009/07/01 0:27:44 ET
Table 'kq5zaQ+1hLNf8LZfGnbTAA' 6-max Seat #6 is the button
Seat 1: 8srN1dKQePlsv0GyTada+Q ($200 in chips)
Seat 2: H8kZwxsevA5S0PwFy0Jegg ($169.55 in chips)
Seat 3: vkfxu8f/jMYKUk6Ly4eujw ($197 in chips)
Seat 4: hjmQ/y4JIAjzsvBGw83Qmg ($168.90 in chips)
Seat 5: qXDd0ZyMIse0OBu8pxeQ3Q ($203 in chips)
Seat 6: o9jamqIi6sTTRSqudgboRA ($291.20 in chips)
8srN1dKQePlsv0GyTada+Q: posts small blind $1
H8kZwxsevA5S0PwFy0Jegg: posts big blind $2
*** HOLE CARDS ***
vkfxu8f/jMYKUk6Ly4eujw: folds
hjmQ/y4JIAjzsvBGw83Qmg is connected
hjmQ/y4JIAjzsvBGw83Qmg: calls $2
qXDd0ZyMIse0OBu8pxeQ3Q: folds
o9jamqIi6sTTRSqudgboRA: folds
8srN1dKQePlsv0GyTada+Q: raises $6 to $8
H8kZwxsevA5S0PwFy0Jegg: folds
hjmQ/y4JIAjzsvBGw83Qmg: folds
8srN1dKQePlsv0GyTada+Q collected $6 from pot
8srN1dKQePlsv0GyTada+Q: doesn't show hand
*** SUMMARY ***
Total pot $6 | Rake $0
Seat 1: 8srN1dKQePlsv0GyTada+Q (small blind) collected ($6)
Seat 2: H8kZwxsevA5S0PwFy0Jegg (big blind) folded before Flop
Seat 3: vkfxu8f/jMYKUk6Ly4eujw folded before Flop (didn't bet)
Seat 4: hjmQ/y4JIAjzsvBGw83Qmg folded before Flop
Seat 5: qXDd0ZyMIse0OBu8pxeQ3Q folded before Flop (didn't bet)
Seat 6: o9jamqIi6sTTRSqudgboRA (button) folded before Flop (didn't bet)



PokerStars Game #59938956742:  Hold'em No Limit ($1/$2) - 2009/07/01 0:27:45 ET
Table 'XP2sRSup+aRuwzx3vDZsDg' 6-max Seat #3 is the button
Seat 1: o9jamqIi6sTTRSqudgboRA ($231.75 in chips)
Seat 2: ygTTt5ehT4aF86q1a8/R+w ($100 in chips)
Seat 3: X7GlkHF+lkbarCLuZ4Uf0w ($32 in chips)
Seat 4: hCtfSY4dRapM2rhEFmS4Ug ($127.50 in chips)
Seat 5: 894kvCY4GHivBpqwizsecg ($119.20 in chips)
Seat 6: h7ppRQJTYBsHCbLMeW9T2g ($446.75 in chips)
hCtfSY4dRapM2rhEFmS4Ug: posts small blind $1
894kvCY4GHivBpqwizsecg: posts big blind $2
*** HOLE CARDS ***
h7ppRQJTYBsHCbLMeW9T2g: folds
o9jamqIi6sTTRSqudgboRA: raises $5 to $7
ygTTt5ehT4aF86q1a8/R+w: folds
X7GlkHF+lkbarCLuZ4Uf0w: folds
hCtfSY4dRapM2rhEFmS4Ug: folds
894kvCY4GHivBpqwizsecg: folds
o9jamqIi6sTTRSqudgboRA collected $5 from pot
*** SUMMARY ***
Total pot $5 | Rake $0
Seat 1: o9jamqIi6sTTRSqudgboRA collected ($5)
Seat 2: ygTTt5ehT4aF86q1a8/R+w folded before Flop (didn't bet)
Seat 3: X7GlkHF+lkbarCLuZ4Uf0w (button) folded before Flop (didn't bet)
Seat 4: hCtfSY4dRapM2rhEFmS4Ug (small blind) folded before Flop
Seat 5: 894kvCY4GHivBpqwizsecg (big blind) folded before Flop
Seat 6: h7ppRQJTYBsHCbLMeW9T2g folded before Flop (didn't bet)



PokerStars Game #59938956674:  Hold'em No Limit ($1/$2) - 2009/07/01 0:27:45 ET
Table 'on4i1U1lCRmxsduFD3xiSg' 9-max Seat #9 is the button
Seat 1: so5k3vFDmokh2q3dImJ1GQ ($106 in chips)
Seat 2: yZYrOeNDxQxkzpbgKX1bng ($33.25 in chips)
Seat 3: 5iPk5MyO3KVu18Y8XCYfFQ ($58.20 in chips)
Seat 4: Z3aYCZG/yXHYFjiWkGI5ug ($527.10 in chips)
Seat 5: QHxJjpVYwitg9krW6wZgJA ($203 in chips)
Seat 6: CUZwDpLTQKhzarPe+JCLOQ ($214.55 in chips)
Seat 8: cdC54j9fGGojcbzWB5PgzA ($201 in chips)
Seat 9: iMe5yhc+1BaiIPHet3NMrA ($200 in chips)
so5k3vFDmokh2q3dImJ1GQ: posts small blind $1
yZYrOeNDxQxkzpbgKX1bng: posts big blind $2
*** HOLE CARDS ***
5iPk5MyO3KVu18Y8XCYfFQ: raises $6 to $8
Z3aYCZG/yXHYFjiWkGI5ug: folds
QHxJjpVYwitg9krW6wZgJA: folds
CUZwDpLTQKhzarPe+JCLOQ: calls $8
cdC54j9fGGojcbzWB5PgzA: folds
iMe5yhc+1BaiIPHet3NMrA: calls $8
so5k3vFDmokh2q3dImJ1GQ: folds
yZYrOeNDxQxkzpbgKX1bng: folds
*** FLOP *** [Kh 3d 3h]
5iPk5MyO3KVu18Y8XCYfFQ: bets $10
CUZwDpLTQKhzarPe+JCLOQ: folds
iMe5yhc+1BaiIPHet3NMrA: folds
5iPk5MyO3KVu18Y8XCYfFQ collected $25.65 from pot
*** SUMMARY ***
Total pot $27 | Rake $1.35
Board [Kh 3d 3h]
Seat 1: so5k3vFDmokh2q3dImJ1GQ (small blind) folded before Flop
Seat 2: yZYrOeNDxQxkzpbgKX1bng (big blind) folded before Flop
Seat 3: 5iPk5MyO3KVu18Y8XCYfFQ collected ($25.65)
Seat 4: Z3aYCZG/yXHYFjiWkGI5ug folded before Flop (didn't bet)
Seat 5: QHxJjpVYwitg9krW6wZgJA folded before Flop (didn't bet)
Seat 6: CUZwDpLTQKhzarPe+JCLOQ folded on the Flop
Seat 8: cdC54j9fGGojcbzWB5PgzA folded before Flop (didn't bet)
Seat 9: iMe5yhc+1BaiIPHet3NMrA (button) folded on the Flop



PokerStars Game #59938958478:  Hold'em No Limit ($1/$2) - 2009/07/01 0:27:47 ET
Table 'OZyw34U4j4WtFFWsEHZQgQ' 2-max Seat #1 is the button
Seat 1: pVqEzK9wXlRMECnb1Zg4Zw ($98.85 in chips)
Seat 2: rAtTyvrJ8f1LaUh2O5U4nA ($47.65 in chips)
pVqEzK9wXlRMECnb1Zg4Zw: posts small blind $1
rAtTyvrJ8f1LaUh2O5U4nA: posts big blind $2
*** HOLE CARDS ***
pVqEzK9wXlRMECnb1Zg4Zw said, "not anymore"
pVqEzK9wXlRMECnb1Zg4Zw: calls $1
rAtTyvrJ8f1LaUh2O5U4nA: checks
*** FLOP *** [5c Js Qd]
rAtTyvrJ8f1LaUh2O5U4nA: bets $2
pVqEzK9wXlRMECnb1Zg4Zw: folds
rAtTyvrJ8f1LaUh2O5U4nA collected $3.80 from pot
rAtTyvrJ8f1LaUh2O5U4nA: doesn't show hand
*** SUMMARY ***
Total pot $4 | Rake $0.20
Board [5c Js Qd]
Seat 1: pVqEzK9wXlRMECnb1Zg4Zw (button) (small blind) folded on the Flop
Seat 2: rAtTyvrJ8f1LaUh2O5U4nA (big blind) collected ($3.80)



PokerStars Game #59938958530:  Hold'em No Limit ($1/$2) - 2009/07/01 0:27:47 ET
Table 'NmY84NAf9Mh0ckAckHnh5g' 2-max Seat #2 is the button
Seat 1: 6hvg964TSqZ3AL/0XK9aVQ ($499.25 in chips)
Seat 2: RwDoM55ZeQuI2ADyJhOb2Q ($341.80 in chips)
RwDoM55ZeQuI2ADyJhOb2Q: posts small blind $1
6hvg964TSqZ3AL/0XK9aVQ: posts big blind $2
*** HOLE CARDS ***
RwDoM55ZeQuI2ADyJhOb2Q: folds
6hvg964TSqZ3AL/0XK9aVQ collected $2 from pot
6hvg964TSqZ3AL/0XK9aVQ: doesn't show hand
*** SUMMARY ***
Total pot $2 | Rake $0
Seat 1: 6hvg964TSqZ3AL/0XK9aVQ (big blind) collected ($2)
Seat 2: RwDoM55ZeQuI2ADyJhOb2Q (button) (small blind) folded before Flop



PokerStars Game #59938962382:  Hold'em No Limit ($1/$2) - 2009/07/01 0:27:53 ET
Table 'QxerF7GUfCbl+4a8XaTB2w' 6-max Seat #4 is the button
Seat 1: o9jamqIi6sTTRSqudgboRA ($203 in chips)
Seat 2: 513FcCI8jHyQy2VWoIQkMg ($228.35 in chips)
Seat 3: vkfxu8f/jMYKUk6Ly4eujw ($197 in chips)
Seat 4: WfaZs12BkYO+BUX5VWpuWQ ($54.20 in chips)
Seat 5: ezK4YR9nqEKpOT/tYPvHKA ($124.60 in chips)
Seat 6: RUZs7P4uzWavoA6iEpDKLw ($129.60 in chips)
ezK4YR9nqEKpOT/tYPvHKA: posts small blind $1
RUZs7P4uzWavoA6iEpDKLw: posts big blind $2
*** HOLE CARDS ***
o9jamqIi6sTTRSqudgboRA: folds
513FcCI8jHyQy2VWoIQkMg: folds
vkfxu8f/jMYKUk6Ly4eujw: folds
WfaZs12BkYO+BUX5VWpuWQ: folds
WfaZs12BkYO+BUX5VWpuWQ leaves the table
ezK4YR9nqEKpOT/tYPvHKA: calls $1
RUZs7P4uzWavoA6iEpDKLw: checks
*** FLOP *** [Qd 3s Ad]
ezK4YR9nqEKpOT/tYPvHKA: checks
RUZs7P4uzWavoA6iEpDKLw: checks
*** TURN *** [Qd 3s Ad] [Jc]
ezK4YR9nqEKpOT/tYPvHKA: bets $2
RUZs7P4uzWavoA6iEpDKLw: folds
CroCopHiKiK joins the table at seat #4
ezK4YR9nqEKpOT/tYPvHKA collected $3.80 from pot
ezK4YR9nqEKpOT/tYPvHKA: doesn't show hand
*** SUMMARY ***
Total pot $4 | Rake $0.20
Board [Qd 3s Ad Jc]
Seat 1: o9jamqIi6sTTRSqudgboRA folded before Flop (didn't bet)
Seat 2: 513FcCI8jHyQy2VWoIQkMg folded before Flop (didn't bet)
Seat 3: vkfxu8f/jMYKUk6Ly4eujw folded before Flop (didn't bet)
Seat 4: WfaZs12BkYO+BUX5VWpuWQ (button) folded before Flop (didn't bet)
Seat 5: ezK4YR9nqEKpOT/tYPvHKA (small blind) collected ($3.80)
Seat 6: RUZs7P4uzWavoA6iEpDKLw (big blind) folded on the Turn



PokerStars Game #59938962278:  Hold'em No Limit ($1/$2) - 2009/07/01 0:27:53 ET
Table 'ztv6V3FN2bQ9nmJPPdx6nQ' 6-max Seat #2 is the button
Seat 2: 5Y+ZGWLI4gnlpApDX5vy1A ($262.30 in chips)
Seat 3: Z55K9DbCHCUi6UaztIHi6g ($57.45 in chips)
Seat 4: vVSUvlW/pvneUNUHDgyXgw ($256 in chips)
Seat 5: sTPOWERd9HWPCNrDBwsVjA ($206.40 in chips)
Seat 6: mfy7uGZcqA2PVQqEVbJ7+g ($201.75 in chips)
Z55K9DbCHCUi6UaztIHi6g: posts small blind $1
vVSUvlW/pvneUNUHDgyXgw: posts big blind $2
vkfxu8f/jMYKUk6Ly4eujw: sits out
*** HOLE CARDS ***
sTPOWERd9HWPCNrDBwsVjA: folds
mfy7uGZcqA2PVQqEVbJ7+g: folds
5Y+ZGWLI4gnlpApDX5vy1A: folds
Z55K9DbCHCUi6UaztIHi6g: calls $1
vVSUvlW/pvneUNUHDgyXgw: raises $6 to $8
Z55K9DbCHCUi6UaztIHi6g: calls $6
*** FLOP *** [8c 8d 6d]
Z55K9DbCHCUi6UaztIHi6g: checks
vVSUvlW/pvneUNUHDgyXgw: bets $10
Z55K9DbCHCUi6UaztIHi6g: calls $10
*** TURN *** [8c 8d 6d] [7c]
Z55K9DbCHCUi6UaztIHi6g: checks
vVSUvlW/pvneUNUHDgyXgw: bets $23
Z55K9DbCHCUi6UaztIHi6g: raises $16.45 to $39.45 and is all-in
vVSUvlW/pvneUNUHDgyXgw: calls $16.45
*** RIVER *** [8c 8d 6d 7c] [5s]
*** SHOW DOWN ***
Z55K9DbCHCUi6UaztIHi6g: shows [9d Jd] (a straight, Five to Nine)
vVSUvlW/pvneUNUHDgyXgw: mucks hand
Z55K9DbCHCUi6UaztIHi6g collected $112.90 from pot
*** SUMMARY ***
Total pot $114.90 | Rake $2
Board [8c 8d 6d 7c 5s]
Seat 2: 5Y+ZGWLI4gnlpApDX5vy1A (button) folded before Flop (didn't bet)
Seat 3: Z55K9DbCHCUi6UaztIHi6g (small blind) showed [9d Jd] and won ($112.90) with a straight, Five to Nine
Seat 4: vVSUvlW/pvneUNUHDgyXgw (big blind) mucked
Seat 5: sTPOWERd9HWPCNrDBwsVjA folded before Flop (didn't bet)
Seat 6: mfy7uGZcqA2PVQqEVbJ7+g folded before Flop (didn't bet)



PokerStars Game #59938963624:  Hold'em No Limit ($1/$2) - 2009/07/01 0:27:55 ET
Table 'NmY84NAf9Mh0ckAckHnh5g' 2-max Seat #1 is the button
Seat 1: 6hvg964TSqZ3AL/0XK9aVQ ($500.25 in chips)
Seat 2: RwDoM55ZeQuI2ADyJhOb2Q ($340.80 in chips)
6hvg964TSqZ3AL/0XK9aVQ: posts small blind $1
RwDoM55ZeQuI2ADyJhOb2Q: posts big blind $2
*** HOLE CARDS ***
6hvg964TSqZ3AL/0XK9aVQ: folds
RwDoM55ZeQuI2ADyJhOb2Q collected $2 from pot
RwDoM55ZeQuI2ADyJhOb2Q: doesn't show hand
*** SUMMARY ***
Total pot $2 | Rake $0
Seat 1: 6hvg964TSqZ3AL/0XK9aVQ (button) (small blind) folded before Flop
Seat 2: RwDoM55ZeQuI2ADyJhOb2Q (big blind) collected ($2)



PokerStars Game #59938964904:  Hold'em No Limit ($1/$2) - 2009/07/01 0:27:57 ET
Table 'jlrIxbrVIG+gjaUYT4za8g' 6-max Seat #1 is the button
Seat 1: ygTTt5ehT4aF86q1a8/R+w ($223.05 in chips)
Seat 2: N18PrNGQj43J7TJuQuu+tw ($106.55 in chips)
Seat 3: 54yWzRRgS0oZ+S6LwZBxMQ ($42.25 in chips)
Seat 4: 8srN1dKQePlsv0GyTada+Q ($228.10 in chips)
Seat 6: vkfxu8f/jMYKUk6Ly4eujw ($260.95 in chips)
N18PrNGQj43J7TJuQuu+tw: posts small blind $1
54yWzRRgS0oZ+S6LwZBxMQ: posts big blind $2
CroCopHiKiK: sits out
*** HOLE CARDS ***
8srN1dKQePlsv0GyTada+Q: folds
vkfxu8f/jMYKUk6Ly4eujw: raises $4 to $6
ygTTt5ehT4aF86q1a8/R+w: folds
N18PrNGQj43J7TJuQuu+tw: folds
54yWzRRgS0oZ+S6LwZBxMQ: folds
vkfxu8f/jMYKUk6Ly4eujw collected $5 from pot
*** SUMMARY ***
Total pot $5 | Rake $0
Seat 1: ygTTt5ehT4aF86q1a8/R+w (button) folded before Flop (didn't bet)
Seat 2: N18PrNGQj43J7TJuQuu+tw (small blind) folded before Flop
Seat 3: 54yWzRRgS0oZ+S6LwZBxMQ (big blind) folded before Flop
Seat 4: 8srN1dKQePlsv0GyTada+Q folded before Flop (didn't bet)
Seat 6: vkfxu8f/jMYKUk6Ly4eujw collected ($5)



PokerStars Game #59938965658:  Hold'em No Limit ($1/$2) - 2009/07/01 0:27:58 ET
Table 'jCW99a4MXoPgL0PwEZ4IuQ' 2-max Seat #1 is the button
Seat 1: t6Jd836OSEMbcRi7rfGp5g ($200 in chips)
Seat 2: bWN162Ep6lKyJ0MW6unz4w ($267 in chips)
t6Jd836OSEMbcRi7rfGp5g: posts small blind $1
bWN162Ep6lKyJ0MW6unz4w: posts big blind $2
*** HOLE CARDS ***
t6Jd836OSEMbcRi7rfGp5g: raises $4 to $6
bWN162Ep6lKyJ0MW6unz4w: folds
t6Jd836OSEMbcRi7rfGp5g collected $4 from pot
*** SUMMARY ***
Total pot $4 | Rake $0
Seat 1: t6Jd836OSEMbcRi7rfGp5g (button) (small blind) collected ($4)
Seat 2: bWN162Ep6lKyJ0MW6unz4w (big blind) folded before Flop



PokerStars Game #59938965844:  Hold'em No Limit ($1/$2) - 2009/07/01 0:27:58 ET
Table 'mGpP9StWRnoeiBDExc6Frg' 6-max Seat #2 is the button
Seat 1: zWFU82nxIRvzK4mKiL4m0Q ($50.15 in chips)
Seat 2: DQlskgG4OtLpF2MVxLwf4A ($340.85 in chips)
Seat 3: 3HrFUl+TAqSP1U00zz3P7A ($78.40 in chips)
Seat 4: qXDd0ZyMIse0OBu8pxeQ3Q ($218 in chips)
Seat 5: d1puGuVBE0fidn+5eRJ0tw ($135 in chips)
Seat 6: X7GlkHF+lkbarCLuZ4Uf0w ($53 in chips)
3HrFUl+TAqSP1U00zz3P7A: posts small blind $1
qXDd0ZyMIse0OBu8pxeQ3Q: posts big blind $2
*** HOLE CARDS ***
d1puGuVBE0fidn+5eRJ0tw: folds
X7GlkHF+lkbarCLuZ4Uf0w: folds
zWFU82nxIRvzK4mKiL4m0Q: folds
DQlskgG4OtLpF2MVxLwf4A: folds
3HrFUl+TAqSP1U00zz3P7A: raises $4 to $6
qXDd0ZyMIse0OBu8pxeQ3Q: folds
3HrFUl+TAqSP1U00zz3P7A collected $4 from pot
3HrFUl+TAqSP1U00zz3P7A: doesn't show hand
*** SUMMARY ***
Total pot $4 | Rake $0
Seat 1: zWFU82nxIRvzK4mKiL4m0Q folded before Flop (didn't bet)
Seat 2: DQlskgG4OtLpF2MVxLwf4A (button) folded before Flop (didn't bet)
Seat 3: 3HrFUl+TAqSP1U00zz3P7A (small blind) collected ($4)
Seat 4: qXDd0ZyMIse0OBu8pxeQ3Q (big blind) folded before Flop
Seat 5: d1puGuVBE0fidn+5eRJ0tw folded before Flop (didn't bet)
Seat 6: X7GlkHF+lkbarCLuZ4Uf0w folded before Flop (didn't bet)



PokerStars Game #59938966332:  Hold'em No Limit ($1/$2) - 2009/07/01 0:27:59 ET
Table 'gftD4mDF7mIFKvSrIyaRbw' 9-max Seat #7 is the button
Seat 2: CKDJ8bJWIRDDBziHsebH5w ($153.80 in chips)
Seat 3: CUZwDpLTQKhzarPe+JCLOQ ($200 in chips)
Seat 4: eeMEdaNqHXOk6uYL+zQnAA ($75.10 in chips)
Seat 5: mpsfNtnMVDqQHTe92AhIdw ($286.20 in chips)
Seat 6: 2NvwF8W2nzsbS+G//yLAbQ ($93.95 in chips)
Seat 7: 5iPk5MyO3KVu18Y8XCYfFQ ($37 in chips)
Seat 8: R/wPwjEcvTU2fxPXxn/XgQ ($72.55 in chips)
Seat 9: F7m34OOfAQ7annesMHVjKw ($217.30 in chips)
R/wPwjEcvTU2fxPXxn/XgQ: posts small blind $1
F7m34OOfAQ7annesMHVjKw: posts big blind $2
*** HOLE CARDS ***
CKDJ8bJWIRDDBziHsebH5w: raises $4 to $6
CUZwDpLTQKhzarPe+JCLOQ: folds
eeMEdaNqHXOk6uYL+zQnAA: folds
mpsfNtnMVDqQHTe92AhIdw: folds
2NvwF8W2nzsbS+G//yLAbQ: folds
5iPk5MyO3KVu18Y8XCYfFQ: folds
R/wPwjEcvTU2fxPXxn/XgQ: folds
/inIs/z/PcX+TniIFpaxpg joins the table at seat #1
F7m34OOfAQ7annesMHVjKw: raises $18 to $24
CKDJ8bJWIRDDBziHsebH5w: calls $18
*** FLOP *** [Qs 7s Td]
F7m34OOfAQ7annesMHVjKw: bets $60
CKDJ8bJWIRDDBziHsebH5w: folds
F7m34OOfAQ7annesMHVjKw collected $46.55 from pot
F7m34OOfAQ7annesMHVjKw: doesn't show hand
*** SUMMARY ***
Total pot $49 | Rake $2.45
Board [Qs 7s Td]
Seat 2: CKDJ8bJWIRDDBziHsebH5w folded on the Flop
Seat 3: CUZwDpLTQKhzarPe+JCLOQ folded before Flop (didn't bet)
Seat 4: eeMEdaNqHXOk6uYL+zQnAA folded before Flop (didn't bet)
Seat 5: mpsfNtnMVDqQHTe92AhIdw folded before Flop (didn't bet)
Seat 6: 2NvwF8W2nzsbS+G//yLAbQ folded before Flop (didn't bet)
Seat 7: 5iPk5MyO3KVu18Y8XCYfFQ (button) folded before Flop (didn't bet)
Seat 8: R/wPwjEcvTU2fxPXxn/XgQ (small blind) folded before Flop
Seat 9: F7m34OOfAQ7annesMHVjKw (big blind) collected ($46.55)



PokerStars Game #59938967778:  Hold'em No Limit ($1/$2) - 2009/07/01 0:28:01 ET
Table 'NmY84NAf9Mh0ckAckHnh5g' 2-max Seat #2 is the button
Seat 1: 6hvg964TSqZ3AL/0XK9aVQ ($499.25 in chips)
Seat 2: RwDoM55ZeQuI2ADyJhOb2Q ($341.80 in chips)
RwDoM55ZeQuI2ADyJhOb2Q: posts small blind $1
6hvg964TSqZ3AL/0XK9aVQ: posts big blind $2
*** HOLE CARDS ***
RwDoM55ZeQuI2ADyJhOb2Q: folds
6hvg964TSqZ3AL/0XK9aVQ collected $2 from pot
6hvg964TSqZ3AL/0XK9aVQ: doesn't show hand
*** SUMMARY ***
Total pot $2 | Rake $0
Seat 1: 6hvg964TSqZ3AL/0XK9aVQ (big blind) collected ($2)
Seat 2: RwDoM55ZeQuI2ADyJhOb2Q (button) (small blind) folded before Flop



PokerStars Game #59938968500:  Hold'em No Limit ($1/$2) - 2009/07/01 0:28:02 ET
Table '5G1PjWSk2ALz0O/eqyYy/g' 2-max Seat #1 is the button
Seat 1: Z4HwehErEwzsv/noQlfUlg ($150.90 in chips)
Seat 2: v4dp1VoMhJV4zmCXtmG5LQ ($232.50 in chips)
Z4HwehErEwzsv/noQlfUlg: posts small blind $1
v4dp1VoMhJV4zmCXtmG5LQ: posts big blind $2
*** HOLE CARDS ***
Z4HwehErEwzsv/noQlfUlg: raises $2 to $4
v4dp1VoMhJV4zmCXtmG5LQ: calls $2
*** FLOP *** [8h 6s 7c]
v4dp1VoMhJV4zmCXtmG5LQ: checks
Z4HwehErEwzsv/noQlfUlg: bets $6
v4dp1VoMhJV4zmCXtmG5LQ: calls $6
*** TURN *** [8h 6s 7c] [4s]
v4dp1VoMhJV4zmCXtmG5LQ: bets $12
Z4HwehErEwzsv/noQlfUlg: calls $12
*** RIVER *** [8h 6s 7c 4s] [6d]
v4dp1VoMhJV4zmCXtmG5LQ: bets $32
Z4HwehErEwzsv/noQlfUlg: folds
v4dp1VoMhJV4zmCXtmG5LQ collected $43.50 from pot
v4dp1VoMhJV4zmCXtmG5LQ: doesn't show hand
*** SUMMARY ***
Total pot $44 | Rake $0.50
Board [8h 6s 7c 4s 6d]
Seat 1: Z4HwehErEwzsv/noQlfUlg (button) (small blind) folded on the River
Seat 2: v4dp1VoMhJV4zmCXtmG5LQ (big blind) collected ($43.50)



PokerStars Game #59938971434:  Hold'em No Limit ($1/$2) - 2009/07/01 0:28:07 ET
Table 'jCW99a4MXoPgL0PwEZ4IuQ' 2-max Seat #2 is the button
Seat 1: t6Jd836OSEMbcRi7rfGp5g ($202 in chips)
Seat 2: bWN162Ep6lKyJ0MW6unz4w ($265 in chips)
bWN162Ep6lKyJ0MW6unz4w: posts small blind $1
t6Jd836OSEMbcRi7rfGp5g: posts big blind $2
*** HOLE CARDS ***
bWN162Ep6lKyJ0MW6unz4w: folds
t6Jd836OSEMbcRi7rfGp5g collected $2 from pot
*** SUMMARY ***
Total pot $2 | Rake $0
Seat 1: t6Jd836OSEMbcRi7rfGp5g (big blind) collected ($2)
Seat 2: bWN162Ep6lKyJ0MW6unz4w (button) (small blind) folded before Flop



PokerStars Game #59938971288:  Hold'em No Limit ($1/$2) - 2009/07/01 0:28:07 ET
Table 'aSf77Sj8QEnzcc0WaxVD4Q' 6-max Seat #3 is the button
Seat 1: 54yWzRRgS0oZ+S6LwZBxMQ ($37.80 in chips)
Seat 2: vkfxu8f/jMYKUk6Ly4eujw ($244.15 in chips)
Seat 3: 9dpyyjDTCed6nV7JhaUUpw ($204.30 in chips)
Seat 4: 513FcCI8jHyQy2VWoIQkMg ($200 in chips)
Seat 5: InmkdI6G8TzSj9NhcCSyPg ($251.65 in chips)
Seat 6: vkoJRf3gidxY1pPi0AFWww ($306.80 in chips)
513FcCI8jHyQy2VWoIQkMg: posts small blind $1
InmkdI6G8TzSj9NhcCSyPg: posts big blind $2
*** HOLE CARDS ***
vkoJRf3gidxY1pPi0AFWww: folds
54yWzRRgS0oZ+S6LwZBxMQ: folds
vkfxu8f/jMYKUk6Ly4eujw: folds
9dpyyjDTCed6nV7JhaUUpw: folds
513FcCI8jHyQy2VWoIQkMg: folds
InmkdI6G8TzSj9NhcCSyPg collected $2 from pot
InmkdI6G8TzSj9NhcCSyPg: doesn't show hand
*** SUMMARY ***
Total pot $2 | Rake $0
Seat 1: 54yWzRRgS0oZ+S6LwZBxMQ folded before Flop (didn't bet)
Seat 2: vkfxu8f/jMYKUk6Ly4eujw folded before Flop (didn't bet)
Seat 3: 9dpyyjDTCed6nV7JhaUUpw (button) folded before Flop (didn't bet)
Seat 4: 513FcCI8jHyQy2VWoIQkMg (small blind) folded before Flop
Seat 5: InmkdI6G8TzSj9NhcCSyPg (big blind) collected ($2)
Seat 6: vkoJRf3gidxY1pPi0AFWww folded before Flop (didn't bet)



PokerStars Game #59938972350:  Hold'em No Limit ($1/$2) - 2009/07/01 0:28:08 ET
Table 'CFkQcfWjKccZaZDf71FK+w' 6-max Seat #1 is the button
Seat 1: U2A5Hv6ib/5+gzO2wr7Z4w ($203 in chips)
Seat 2: X7GlkHF+lkbarCLuZ4Uf0w ($27 in chips)
Seat 3: R5/GXj0PUdNkzHU6Omb/JA ($95 in chips)
Seat 4: e8nZKSbIdIO7e2NdQe/OFQ ($233.80 in chips)
Seat 5: 1njbh8TKSUF6l4V1XwGdcg ($224.80 in chips)
X7GlkHF+lkbarCLuZ4Uf0w: posts small blind $1
R5/GXj0PUdNkzHU6Omb/JA: posts big blind $2
*** HOLE CARDS ***
e8nZKSbIdIO7e2NdQe/OFQ: folds
1njbh8TKSUF6l4V1XwGdcg: folds
ORVqY3rf9X6ANA/8s+On2Q is connected
U2A5Hv6ib/5+gzO2wr7Z4w: raises $4 to $6
X7GlkHF+lkbarCLuZ4Uf0w: folds
R5/GXj0PUdNkzHU6Omb/JA: folds
U2A5Hv6ib/5+gzO2wr7Z4w collected $5 from pot
*** SUMMARY ***
Total pot $5 | Rake $0
Seat 1: U2A5Hv6ib/5+gzO2wr7Z4w (button) collected ($5)
Seat 2: X7GlkHF+lkbarCLuZ4Uf0w (small blind) folded before Flop
Seat 3: R5/GXj0PUdNkzHU6Omb/JA (big blind) folded before Flop
Seat 4: e8nZKSbIdIO7e2NdQe/OFQ folded before Flop (didn't bet)
Seat 5: 1njbh8TKSUF6l4V1XwGdcg folded before Flop (didn't bet)



PokerStars Game #59938973616:  Hold'em No Limit ($1/$2) - 2009/07/01 0:28:10 ET
Table 'YqGfR5eHfMeSjb9a+QU9rg' 9-max Seat #9 is the button
Seat 1: qCBuzVnLcBR29snMAHq9PA ($109.90 in chips)
Seat 2: W3Nqt1GWlTi9tXQXMNEvgw ($255.75 in chips)
Seat 3: /gll27k+xWYV7Fbki0lFDQ ($110.85 in chips)
Seat 4: QHxJjpVYwitg9krW6wZgJA ($200 in chips)
Seat 5: MOBMOMQRN/z+fiGXGnZojw ($247.50 in chips)
Seat 6: 5iPk5MyO3KVu18Y8XCYfFQ ($42 in chips)
Seat 7: tAhiYXx1KvTp5hhBamTYfQ ($209.60 in chips)
Seat 8: JnV3SM2D6dAFYyGZHHpvrg ($95 in chips)
Seat 9: /inIs/z/PcX+TniIFpaxpg ($21 in chips)
qCBuzVnLcBR29snMAHq9PA: posts small blind $1
W3Nqt1GWlTi9tXQXMNEvgw: posts big blind $2
*** HOLE CARDS ***
/gll27k+xWYV7Fbki0lFDQ: folds
QHxJjpVYwitg9krW6wZgJA: folds
MOBMOMQRN/z+fiGXGnZojw: folds
5iPk5MyO3KVu18Y8XCYfFQ: folds
tAhiYXx1KvTp5hhBamTYfQ: raises $4 to $6
JnV3SM2D6dAFYyGZHHpvrg: raises $12 to $18
/inIs/z/PcX+TniIFpaxpg: folds
qCBuzVnLcBR29snMAHq9PA: folds
W3Nqt1GWlTi9tXQXMNEvgw: folds
tAhiYXx1KvTp5hhBamTYfQ: calls $12
*** FLOP *** [7d 2d 6s]
tAhiYXx1KvTp5hhBamTYfQ: checks
JnV3SM2D6dAFYyGZHHpvrg: bets $22
tAhiYXx1KvTp5hhBamTYfQ: folds
JnV3SM2D6dAFYyGZHHpvrg collected $37.05 from pot
*** SUMMARY ***
Total pot $39 | Rake $1.95
Board [7d 2d 6s]
Seat 1: qCBuzVnLcBR29snMAHq9PA (small blind) folded before Flop
Seat 2: W3Nqt1GWlTi9tXQXMNEvgw (big blind) folded before Flop
Seat 3: /gll27k+xWYV7Fbki0lFDQ folded before Flop (didn't bet)
Seat 4: QHxJjpVYwitg9krW6wZgJA folded before Flop (didn't bet)
Seat 5: MOBMOMQRN/z+fiGXGnZojw folded before Flop (didn't bet)
Seat 6: 5iPk5MyO3KVu18Y8XCYfFQ folded before Flop (didn't bet)
Seat 7: tAhiYXx1KvTp5hhBamTYfQ folded on the Flop
Seat 8: JnV3SM2D6dAFYyGZHHpvrg collected ($37.05)
Seat 9: /inIs/z/PcX+TniIFpaxpg (button) folded before Flop (didn't bet)



PokerStars Game #59938973640:  Hold'em No Limit ($1/$2) - 2009/07/01 0:28:10 ET
Table 'P/yCfYl1GfGsu/e6DxDy/A' 2-max Seat #1 is the button
Seat 1: 7fOCUy3x9hdkmXkkDNolGQ ($272.50 in chips)
Seat 2: RwDoM55ZeQuI2ADyJhOb2Q ($749.50 in chips)
7fOCUy3x9hdkmXkkDNolGQ: posts small blind $1
RwDoM55ZeQuI2ADyJhOb2Q: posts big blind $2
*** HOLE CARDS ***
7fOCUy3x9hdkmXkkDNolGQ: raises $4 to $6
RwDoM55ZeQuI2ADyJhOb2Q: folds
7fOCUy3x9hdkmXkkDNolGQ collected $4 from pot
7fOCUy3x9hdkmXkkDNolGQ: doesn't show hand
*** SUMMARY ***
Total pot $4 | Rake $0
Seat 1: 7fOCUy3x9hdkmXkkDNolGQ (button) (small blind) collected ($4)
Seat 2: RwDoM55ZeQuI2ADyJhOb2Q (big blind) folded before Flop



PokerStars Game #59938974300:  Hold'em No Limit ($1/$2) - 2009/07/01 0:28:11 ET
Table 'NmY84NAf9Mh0ckAckHnh5g' 2-max Seat #1 is the button
Seat 1: 6hvg964TSqZ3AL/0XK9aVQ ($500.25 in chips)
Seat 2: RwDoM55ZeQuI2ADyJhOb2Q ($340.80 in chips)
6hvg964TSqZ3AL/0XK9aVQ: posts small blind $1
RwDoM55ZeQuI2ADyJhOb2Q: posts big blind $2
*** HOLE CARDS ***
6hvg964TSqZ3AL/0XK9aVQ: folds
RwDoM55ZeQuI2ADyJhOb2Q collected $2 from pot
RwDoM55ZeQuI2ADyJhOb2Q: doesn't show hand
*** SUMMARY ***
Total pot $2 | Rake $0
Seat 1: 6hvg964TSqZ3AL/0XK9aVQ (button) (small blind) folded before Flop
Seat 2: RwDoM55ZeQuI2ADyJhOb2Q (big blind) collected ($2)



PokerStars Game #59938975512:  Hold'em No Limit ($1/$2) - 2009/07/01 0:28:13 ET
Table 'jCW99a4MXoPgL0PwEZ4IuQ' 2-max Seat #1 is the button
Seat 1: t6Jd836OSEMbcRi7rfGp5g ($203 in chips)
Seat 2: bWN162Ep6lKyJ0MW6unz4w ($264 in chips)
t6Jd836OSEMbcRi7rfGp5g: posts small blind $1
bWN162Ep6lKyJ0MW6unz4w: posts big blind $2
*** HOLE CARDS ***
t6Jd836OSEMbcRi7rfGp5g: raises $4 to $6
bWN162Ep6lKyJ0MW6unz4w: folds
t6Jd836OSEMbcRi7rfGp5g collected $4 from pot
*** SUMMARY ***
Total pot $4 | Rake $0
Seat 1: t6Jd836OSEMbcRi7rfGp5g (button) (small blind) collected ($4)
Seat 2: bWN162Ep6lKyJ0MW6unz4w (big blind) folded before Flop



PokerStars Game #59938977776:  Hold'em No Limit ($1/$2) - 2009/07/01 0:28:16 ET
Table 'jlrIxbrVIG+gjaUYT4za8g' 6-max Seat #2 is the button
Seat 1: ygTTt5ehT4aF86q1a8/R+w ($223.05 in chips)
Seat 2: N18PrNGQj43J7TJuQuu+tw ($105.55 in chips)
Seat 3: 54yWzRRgS0oZ+S6LwZBxMQ ($40.25 in chips)
Seat 4: 8srN1dKQePlsv0GyTada+Q ($228.10 in chips)
Seat 6: vkfxu8f/jMYKUk6Ly4eujw ($263.95 in chips)
54yWzRRgS0oZ+S6LwZBxMQ: posts small blind $1
8srN1dKQePlsv0GyTada+Q: posts big blind $2
CroCopHiKiK: sits out
*** HOLE CARDS ***
vkfxu8f/jMYKUk6Ly4eujw: folds
ygTTt5ehT4aF86q1a8/R+w: folds
N18PrNGQj43J7TJuQuu+tw: calls $2
54yWzRRgS0oZ+S6LwZBxMQ: folds
8srN1dKQePlsv0GyTada+Q: raises $6 to $8
N18PrNGQj43J7TJuQuu+tw: calls $6
*** FLOP *** [Jh 6d Qd]
8srN1dKQePlsv0GyTada+Q: checks
N18PrNGQj43J7TJuQuu+tw: bets $12
8srN1dKQePlsv0GyTada+Q: calls $12
*** TURN *** [Jh 6d Qd] [9h]
8srN1dKQePlsv0GyTada+Q: checks
N18PrNGQj43J7TJuQuu+tw: checks
*** RIVER *** [Jh 6d Qd 9h] [5h]
8srN1dKQePlsv0GyTada+Q: checks
N18PrNGQj43J7TJuQuu+tw: bets $10
8srN1dKQePlsv0GyTada+Q: calls $10
*** SHOW DOWN ***
N18PrNGQj43J7TJuQuu+tw: shows [Tc 3c] (high card Queen)
8srN1dKQePlsv0GyTada+Q: shows [Jd As] (a pair of Jacks)
8srN1dKQePlsv0GyTada+Q collected $59 from pot
*** SUMMARY ***
Total pot $61 | Rake $2
Board [Jh 6d Qd 9h 5h]
Seat 1: ygTTt5ehT4aF86q1a8/R+w folded before Flop (didn't bet)
Seat 2: N18PrNGQj43J7TJuQuu+tw (button) showed [Tc 3c] and lost with high card Queen
Seat 3: 54yWzRRgS0oZ+S6LwZBxMQ (small blind) folded before Flop
Seat 4: 8srN1dKQePlsv0GyTada+Q (big blind) showed [Jd As] and won ($59) with a pair of Jacks
Seat 6: vkfxu8f/jMYKUk6Ly4eujw folded before Flop (didn't bet)



PokerStars Game #59938978344:  Hold'em No Limit ($1/$2) - 2009/07/01 0:28:17 ET
Table 'NmY84NAf9Mh0ckAckHnh5g' 2-max Seat #2 is the button
Seat 1: 6hvg964TSqZ3AL/0XK9aVQ ($499.25 in chips)
Seat 2: RwDoM55ZeQuI2ADyJhOb2Q ($341.80 in chips)
RwDoM55ZeQuI2ADyJhOb2Q: posts small blind $1
6hvg964TSqZ3AL/0XK9aVQ: posts big blind $2
*** HOLE CARDS ***
RwDoM55ZeQuI2ADyJhOb2Q: folds
6hvg964TSqZ3AL/0XK9aVQ collected $2 from pot
6hvg964TSqZ3AL/0XK9aVQ: doesn't show hand
*** SUMMARY ***
Total pot $2 | Rake $0
Seat 1: 6hvg964TSqZ3AL/0XK9aVQ (big blind) collected ($2)
Seat 2: RwDoM55ZeQuI2ADyJhOb2Q (button) (small blind) folded before Flop



PokerStars Game #59938978426:  Hold'em No Limit ($1/$2) - 2009/07/01 0:28:17 ET
Table 'XP2sRSup+aRuwzx3vDZsDg' 6-max Seat #4 is the button
Seat 1: o9jamqIi6sTTRSqudgboRA ($234.75 in chips)
Seat 2: ygTTt5ehT4aF86q1a8/R+w ($100 in chips)
Seat 3: X7GlkHF+lkbarCLuZ4Uf0w ($32 in chips)
Seat 4: hCtfSY4dRapM2rhEFmS4Ug ($126.50 in chips)
Seat 5: 894kvCY4GHivBpqwizsecg ($117.20 in chips)
Seat 6: h7ppRQJTYBsHCbLMeW9T2g ($446.75 in chips)
894kvCY4GHivBpqwizsecg: posts small blind $1
h7ppRQJTYBsHCbLMeW9T2g: posts big blind $2
*** HOLE CARDS ***
o9jamqIi6sTTRSqudgboRA: raises $5 to $7
ygTTt5ehT4aF86q1a8/R+w: folds
X7GlkHF+lkbarCLuZ4Uf0w: folds
hCtfSY4dRapM2rhEFmS4Ug: folds
894kvCY4GHivBpqwizsecg: folds
h7ppRQJTYBsHCbLMeW9T2g: folds
o9jamqIi6sTTRSqudgboRA collected $5 from pot
*** SUMMARY ***
Total pot $5 | Rake $0
Seat 1: o9jamqIi6sTTRSqudgboRA collected ($5)
Seat 2: ygTTt5ehT4aF86q1a8/R+w folded before Flop (didn't bet)
Seat 3: X7GlkHF+lkbarCLuZ4Uf0w folded before Flop (didn't bet)
Seat 4: hCtfSY4dRapM2rhEFmS4Ug (button) folded before Flop (didn't bet)
Seat 5: 894kvCY4GHivBpqwizsecg (small blind) folded before Flop
Seat 6: h7ppRQJTYBsHCbLMeW9T2g (big blind) folded before Flop



PokerStars Game #59938979194:  Hold'em No Limit ($1/$2) - 2009/07/01 0:28:19 ET
Table 'uJ9juaXXg9yIcSU8amxaXQ' 6-max Seat #6 is the button
Seat 1: JsqOjN/eHz0uYVf/PyUJ6Q ($43.50 in chips)
Seat 2: yynBOXUjw28V5kz84sxX4g ($150.30 in chips)
Seat 4: zNjJ/y4emmF+vzrCDd+ooA ($116.90 in chips)
Seat 5: aMZYAxFxWTQXE9aUus4sxg ($56.55 in chips)
Seat 6: XrFG4dK06RVKLlX32/pjcQ ($39.60 in chips)
JsqOjN/eHz0uYVf/PyUJ6Q: posts small blind $1
yynBOXUjw28V5kz84sxX4g: posts big blind $2
*** HOLE CARDS ***
zNjJ/y4emmF+vzrCDd+ooA: calls $2
aMZYAxFxWTQXE9aUus4sxg: folds
XrFG4dK06RVKLlX32/pjcQ: folds
JsqOjN/eHz0uYVf/PyUJ6Q: calls $1
yynBOXUjw28V5kz84sxX4g: checks
*** FLOP *** [6c Qs Qh]
zaogaltCDFVsIASEnrXs2w has returned
JsqOjN/eHz0uYVf/PyUJ6Q: checks
yynBOXUjw28V5kz84sxX4g: checks
zNjJ/y4emmF+vzrCDd+ooA: bets $6
JsqOjN/eHz0uYVf/PyUJ6Q: folds
yynBOXUjw28V5kz84sxX4g: folds
zNjJ/y4emmF+vzrCDd+ooA collected $5.70 from pot
*** SUMMARY ***
Total pot $6 | Rake $0.30
Board [6c Qs Qh]
Seat 1: JsqOjN/eHz0uYVf/PyUJ6Q (small blind) folded on the Flop
Seat 2: yynBOXUjw28V5kz84sxX4g (big blind) folded on the Flop
Seat 4: zNjJ/y4emmF+vzrCDd+ooA collected ($5.70)
Seat 5: aMZYAxFxWTQXE9aUus4sxg folded before Flop (didn't bet)
Seat 6: XrFG4dK06RVKLlX32/pjcQ (button) folded before Flop (didn't bet)



PokerStars Game #59938979764:  Hold'em No Limit ($1/$2) - 2009/07/01 0:28:19 ET
Table 'QxerF7GUfCbl+4a8XaTB2w' 6-max Seat #5 is the button
Seat 1: o9jamqIi6sTTRSqudgboRA ($203 in chips)
Seat 2: 513FcCI8jHyQy2VWoIQkMg ($228.35 in chips)
Seat 3: vkfxu8f/jMYKUk6Ly4eujw ($197 in chips)
Seat 5: ezK4YR9nqEKpOT/tYPvHKA ($126.40 in chips)
Seat 6: RUZs7P4uzWavoA6iEpDKLw ($127.60 in chips)
RUZs7P4uzWavoA6iEpDKLw: posts small blind $1
o9jamqIi6sTTRSqudgboRA: posts big blind $2
CroCopHiKiK: sits out
*** HOLE CARDS ***
513FcCI8jHyQy2VWoIQkMg: folds
vkfxu8f/jMYKUk6Ly4eujw: folds
ezK4YR9nqEKpOT/tYPvHKA: folds
RUZs7P4uzWavoA6iEpDKLw: calls $1
o9jamqIi6sTTRSqudgboRA: checks
*** FLOP *** [8d Jc Js]
RUZs7P4uzWavoA6iEpDKLw: checks
o9jamqIi6sTTRSqudgboRA: checks
*** TURN *** [8d Jc Js] [5s]
RUZs7P4uzWavoA6iEpDKLw: bets $4
o9jamqIi6sTTRSqudgboRA: folds
RUZs7P4uzWavoA6iEpDKLw collected $3.80 from pot
RUZs7P4uzWavoA6iEpDKLw: doesn't show hand
*** SUMMARY ***
Total pot $4 | Rake $0.20
Board [8d Jc Js 5s]
Seat 1: o9jamqIi6sTTRSqudgboRA (big blind) folded on the Turn
Seat 2: 513FcCI8jHyQy2VWoIQkMg folded before Flop (didn't bet)
Seat 3: vkfxu8f/jMYKUk6Ly4eujw folded before Flop (didn't bet)
Seat 5: ezK4YR9nqEKpOT/tYPvHKA (button) folded before Flop (didn't bet)
Seat 6: RUZs7P4uzWavoA6iEpDKLw (small blind) collected ($3.80)



PokerStars Game #59938979234:  Hold'em No Limit ($1/$2) - 2009/07/01 0:28:19 ET
Table 'srul5UFZXTEccVV5fpY91g' 9-max Seat #8 is the button
Seat 1: lfD8cBv31A/pio3pXJbPjA ($153.20 in chips)
Seat 2: tJYod1SLp2AcWPL/3hZ7ug ($80.95 in chips)
Seat 3: weUZ8S7tgbaeIpzi1gBNxQ ($55 in chips)
Seat 4: GG5lTuGt3+kwNYSbqeB6yw ($162.15 in chips)
Seat 5: 5iPk5MyO3KVu18Y8XCYfFQ ($76.55 in chips)
Seat 7: s0erZsDxbZSaEPheMgibKg ($444.10 in chips)
Seat 8: UZEsV9yKUMqmpYPiOFpaZw ($73 in chips)
Seat 9: jRGC4KXXODbHEN275TXFCA ($138.30 in chips)
jRGC4KXXODbHEN275TXFCA: posts small blind $1
lfD8cBv31A/pio3pXJbPjA: posts big blind $2
*** HOLE CARDS ***
tJYod1SLp2AcWPL/3hZ7ug: raises $2 to $4
weUZ8S7tgbaeIpzi1gBNxQ: folds
GG5lTuGt3+kwNYSbqeB6yw: folds
/inIs/z/PcX+TniIFpaxpg joins the table at seat #6
5iPk5MyO3KVu18Y8XCYfFQ: folds
s0erZsDxbZSaEPheMgibKg: raises $4 to $8
UZEsV9yKUMqmpYPiOFpaZw: folds
jRGC4KXXODbHEN275TXFCA: calls $7
lfD8cBv31A/pio3pXJbPjA: folds
tJYod1SLp2AcWPL/3hZ7ug: calls $4
*** FLOP *** [Js Qh 7s]
jRGC4KXXODbHEN275TXFCA: checks
tJYod1SLp2AcWPL/3hZ7ug: checks
s0erZsDxbZSaEPheMgibKg: checks
*** TURN *** [Js Qh 7s] [8s]
jRGC4KXXODbHEN275TXFCA: bets $20
tJYod1SLp2AcWPL/3hZ7ug: folds
s0erZsDxbZSaEPheMgibKg: folds
jRGC4KXXODbHEN275TXFCA collected $24.70 from pot
*** SUMMARY ***
Total pot $26 | Rake $1.30
Board [Js Qh 7s 8s]
Seat 1: lfD8cBv31A/pio3pXJbPjA (big blind) folded before Flop
Seat 2: tJYod1SLp2AcWPL/3hZ7ug folded on the Turn
Seat 3: weUZ8S7tgbaeIpzi1gBNxQ folded before Flop (didn't bet)
Seat 4: GG5lTuGt3+kwNYSbqeB6yw folded before Flop (didn't bet)
Seat 5: 5iPk5MyO3KVu18Y8XCYfFQ folded before Flop (didn't bet)
Seat 7: s0erZsDxbZSaEPheMgibKg folded on the Turn
Seat 8: UZEsV9yKUMqmpYPiOFpaZw (button) folded before Flop (didn't bet)
Seat 9: jRGC4KXXODbHEN275TXFCA (small blind) collected ($24.70)



PokerStars Game #59938980100:  Hold'em No Limit ($1/$2) - 2009/07/01 0:28:20 ET
Table 'BSRfGh+QobUe0AgIMtt/fw' 9-max Seat #4 is the button
Seat 1: QHxJjpVYwitg9krW6wZgJA ($289.30 in chips)
Seat 2: GX1heJ+DSsvm7gzSPsYhhQ ($33 in chips)
Seat 3: XSBFygUEk3Ijl/S/KhD4PA ($351.60 in chips)
Seat 4: 5iPk5MyO3KVu18Y8XCYfFQ ($37 in chips)
Seat 5: odhvI/CZeMsPyo1n1U7+hA ($172 in chips)
Seat 6: H6Z4+qu8gR0VUiPOijndVg ($207.40 in chips)
Seat 7: RgU4royPa+zJopKX0xA3RA ($74.60 in chips)
Seat 8: /XRRUMKiOOItJFbrM26RrA ($54 in chips)
odhvI/CZeMsPyo1n1U7+hA: posts small blind $1
H6Z4+qu8gR0VUiPOijndVg: posts big blind $2
/inIs/z/PcX+TniIFpaxpg: sits out
*** HOLE CARDS ***
RgU4royPa+zJopKX0xA3RA: calls $2
/XRRUMKiOOItJFbrM26RrA: folds
QHxJjpVYwitg9krW6wZgJA: folds
GX1heJ+DSsvm7gzSPsYhhQ: folds
XSBFygUEk3Ijl/S/KhD4PA: folds
5iPk5MyO3KVu18Y8XCYfFQ: raises $35 to $37 and is all-in
odhvI/CZeMsPyo1n1U7+hA: folds
H6Z4+qu8gR0VUiPOijndVg: folds
RgU4royPa+zJopKX0xA3RA: calls $35
odhvI/CZeMsPyo1n1U7+hA leaves the table
*** FLOP *** [6d 2c Kc]
*** TURN *** [6d 2c Kc] [4c]
*** RIVER *** [6d 2c Kc 4c] [9h]
*** SHOW DOWN ***
RgU4royPa+zJopKX0xA3RA: shows [Ts Qs] (high card King)
5iPk5MyO3KVu18Y8XCYfFQ: shows [Tc As] (high card Ace)
5iPk5MyO3KVu18Y8XCYfFQ collected $74 from pot
*** SUMMARY ***
Total pot $77 | Rake $3
Board [6d 2c Kc 4c 9h]
Seat 1: QHxJjpVYwitg9krW6wZgJA folded before Flop (didn't bet)
Seat 2: GX1heJ+DSsvm7gzSPsYhhQ folded before Flop (didn't bet)
Seat 3: XSBFygUEk3Ijl/S/KhD4PA folded before Flop (didn't bet)
Seat 4: 5iPk5MyO3KVu18Y8XCYfFQ (button) showed [Tc As] and won ($74) with high card Ace
Seat 5: odhvI/CZeMsPyo1n1U7+hA (small blind) folded before Flop
Seat 6: H6Z4+qu8gR0VUiPOijndVg (big blind) folded before Flop
Seat 7: RgU4royPa+zJopKX0xA3RA showed [Ts Qs] and lost with high card King
Seat 8: /XRRUMKiOOItJFbrM26RrA folded before Flop (didn't bet)



PokerStars Game #59938981600:  Hold'em No Limit ($1/$2) - 2009/07/01 0:28:22 ET
Table 'mGpP9StWRnoeiBDExc6Frg' 6-max Seat #3 is the button
Seat 1: zWFU82nxIRvzK4mKiL4m0Q ($50.15 in chips)
Seat 2: DQlskgG4OtLpF2MVxLwf4A ($340.85 in chips)
Seat 3: 3HrFUl+TAqSP1U00zz3P7A ($80.40 in chips)
Seat 4: qXDd0ZyMIse0OBu8pxeQ3Q ($216 in chips)
Seat 5: d1puGuVBE0fidn+5eRJ0tw ($135 in chips)
Seat 6: X7GlkHF+lkbarCLuZ4Uf0w ($53 in chips)
qXDd0ZyMIse0OBu8pxeQ3Q: posts small blind $1
d1puGuVBE0fidn+5eRJ0tw: posts big blind $2
*** HOLE CARDS ***
X7GlkHF+lkbarCLuZ4Uf0w: folds
zWFU82nxIRvzK4mKiL4m0Q: calls $2
DQlskgG4OtLpF2MVxLwf4A: folds
3HrFUl+TAqSP1U00zz3P7A: folds
qXDd0ZyMIse0OBu8pxeQ3Q: raises $8 to $10
d1puGuVBE0fidn+5eRJ0tw: folds
zWFU82nxIRvzK4mKiL4m0Q: calls $8
*** FLOP *** [5d Ts Jd]
qXDd0ZyMIse0OBu8pxeQ3Q: bets $12
zWFU82nxIRvzK4mKiL4m0Q: raises $12 to $24
qXDd0ZyMIse0OBu8pxeQ3Q: raises $22 to $46
zWFU82nxIRvzK4mKiL4m0Q: calls $16.15 and is all-in
*** TURN *** [5d Ts Jd] [3h]
*** RIVER *** [5d Ts Jd 3h] [4h]
*** SHOW DOWN ***
qXDd0ZyMIse0OBu8pxeQ3Q: shows [Ad As] (a pair of Aces)
zWFU82nxIRvzK4mKiL4m0Q: mucks hand
qXDd0ZyMIse0OBu8pxeQ3Q collected $99.30 from pot
*** SUMMARY ***
Total pot $102.30 | Rake $3
Board [5d Ts Jd 3h 4h]
Seat 1: zWFU82nxIRvzK4mKiL4m0Q mucked
Seat 2: DQlskgG4OtLpF2MVxLwf4A folded before Flop (didn't bet)
Seat 3: 3HrFUl+TAqSP1U00zz3P7A (button) folded before Flop (didn't bet)
Seat 4: qXDd0ZyMIse0OBu8pxeQ3Q (small blind) showed [Ad As] and won ($99.30) with a pair of Aces
Seat 5: d1puGuVBE0fidn+5eRJ0tw (big blind) folded before Flop
Seat 6: X7GlkHF+lkbarCLuZ4Uf0w folded before Flop (didn't bet)



PokerStars Game #59938981876:  Hold'em No Limit ($1/$2) - 2009/07/01 0:28:23 ET
Table 'kq5zaQ+1hLNf8LZfGnbTAA' 6-max Seat #1 is the button
Seat 1: 8srN1dKQePlsv0GyTada+Q ($204 in chips)
Seat 2: H8kZwxsevA5S0PwFy0Jegg ($167.55 in chips)
Seat 3: vkfxu8f/jMYKUk6Ly4eujw ($197 in chips)
Seat 4: hjmQ/y4JIAjzsvBGw83Qmg ($166.90 in chips)
Seat 5: qXDd0ZyMIse0OBu8pxeQ3Q ($203 in chips)
Seat 6: o9jamqIi6sTTRSqudgboRA ($291.20 in chips)
H8kZwxsevA5S0PwFy0Jegg: posts small blind $1
vkfxu8f/jMYKUk6Ly4eujw: posts big blind $2
*** HOLE CARDS ***
hjmQ/y4JIAjzsvBGw83Qmg: calls $2
qXDd0ZyMIse0OBu8pxeQ3Q: folds
o9jamqIi6sTTRSqudgboRA: folds
8srN1dKQePlsv0GyTada+Q: folds
H8kZwxsevA5S0PwFy0Jegg: calls $1
vkfxu8f/jMYKUk6Ly4eujw: checks
*** FLOP *** [9s Th Kh]
H8kZwxsevA5S0PwFy0Jegg: checks
vkfxu8f/jMYKUk6Ly4eujw: checks
hjmQ/y4JIAjzsvBGw83Qmg: checks
*** TURN *** [9s Th Kh] [6h]
H8kZwxsevA5S0PwFy0Jegg: bets $2
vkfxu8f/jMYKUk6Ly4eujw: folds
hjmQ/y4JIAjzsvBGw83Qmg: calls $2
*** RIVER *** [9s Th Kh 6h] [5h]
H8kZwxsevA5S0PwFy0Jegg: bets $10
hjmQ/y4JIAjzsvBGw83Qmg: folds
H8kZwxsevA5S0PwFy0Jegg collected $9.55 from pot
*** SUMMARY ***
Total pot $10 | Rake $0.45
Board [9s Th Kh 6h 5h]
Seat 1: 8srN1dKQePlsv0GyTada+Q (button) folded before Flop (didn't bet)
Seat 2: H8kZwxsevA5S0PwFy0Jegg (small blind) collected ($9.55)
Seat 3: vkfxu8f/jMYKUk6Ly4eujw (big blind) folded on the Turn
Seat 4: hjmQ/y4JIAjzsvBGw83Qmg folded on the River
Seat 5: qXDd0ZyMIse0OBu8pxeQ3Q folded before Flop (didn't bet)
Seat 6: o9jamqIi6sTTRSqudgboRA folded before Flop (didn't bet)



PokerStars Game #59938984284:  Hold'em No Limit ($1/$2) - 2009/07/01 0:28:26 ET
Table 'P/yCfYl1GfGsu/e6DxDy/A' 2-max Seat #2 is the button
Seat 1: 7fOCUy3x9hdkmXkkDNolGQ ($274.50 in chips)
Seat 2: RwDoM55ZeQuI2ADyJhOb2Q ($747.50 in chips)
RwDoM55ZeQuI2ADyJhOb2Q: posts small blind $1
7fOCUy3x9hdkmXkkDNolGQ: posts big blind $2
*** HOLE CARDS ***
RwDoM55ZeQuI2ADyJhOb2Q: raises $4 to $6
7fOCUy3x9hdkmXkkDNolGQ: folds
RwDoM55ZeQuI2ADyJhOb2Q collected $4 from pot
RwDoM55ZeQuI2ADyJhOb2Q: doesn't show hand
*** SUMMARY ***
Total pot $4 | Rake $0
Seat 1: 7fOCUy3x9hdkmXkkDNolGQ (big blind) folded before Flop
Seat 2: RwDoM55ZeQuI2ADyJhOb2Q (button) (small blind) collected ($4)



PokerStars Game #59938985082:  Hold'em No Limit ($1/$2) - 2009/07/01 0:28:28 ET
Table 'NmY84NAf9Mh0ckAckHnh5g' 2-max Seat #1 is the button
Seat 1: 6hvg964TSqZ3AL/0XK9aVQ ($500.25 in chips)
Seat 2: RwDoM55ZeQuI2ADyJhOb2Q ($340.80 in chips)
6hvg964TSqZ3AL/0XK9aVQ: posts small blind $1
RwDoM55ZeQuI2ADyJhOb2Q: posts big blind $2
*** HOLE CARDS ***
6hvg964TSqZ3AL/0XK9aVQ: folds
RwDoM55ZeQuI2ADyJhOb2Q collected $2 from pot
RwDoM55ZeQuI2ADyJhOb2Q: doesn't show hand
*** SUMMARY ***
Total pot $2 | Rake $0
Seat 1: 6hvg964TSqZ3AL/0XK9aVQ (button) (small blind) folded before Flop
Seat 2: RwDoM55ZeQuI2ADyJhOb2Q (big blind) collected ($2)



PokerStars Game #59938986736:  Hold'em No Limit ($1/$2) - 2009/07/01 0:28:30 ET
Table 'jCW99a4MXoPgL0PwEZ4IuQ' 2-max Seat #2 is the button
Seat 1: t6Jd836OSEMbcRi7rfGp5g ($205 in chips)
Seat 2: bWN162Ep6lKyJ0MW6unz4w ($262 in chips)
bWN162Ep6lKyJ0MW6unz4w: posts small blind $1
t6Jd836OSEMbcRi7rfGp5g: posts big blind $2
*** HOLE CARDS ***
bWN162Ep6lKyJ0MW6unz4w: raises $4 to $6
t6Jd836OSEMbcRi7rfGp5g: calls $4
*** FLOP *** [Jd Ts 8d]
t6Jd836OSEMbcRi7rfGp5g: checks
bWN162Ep6lKyJ0MW6unz4w: bets $8
t6Jd836OSEMbcRi7rfGp5g: raises $16 to $24
bWN162Ep6lKyJ0MW6unz4w: calls $16
*** TURN *** [Jd Ts 8d] [2d]
t6Jd836OSEMbcRi7rfGp5g: bets $44
bWN162Ep6lKyJ0MW6unz4w: folds
t6Jd836OSEMbcRi7rfGp5g collected $59.50 from pot
*** SUMMARY ***
Total pot $60 | Rake $0.50
Board [Jd Ts 8d 2d]
Seat 1: t6Jd836OSEMbcRi7rfGp5g (big blind) collected ($59.50)
Seat 2: bWN162Ep6lKyJ0MW6unz4w (button) (small blind) folded on the Turn



PokerStars Game #59938988824:  Hold'em No Limit ($1/$2) - 2009/07/01 0:28:33 ET
Table 'NmY84NAf9Mh0ckAckHnh5g' 2-max Seat #2 is the button
Seat 1: 6hvg964TSqZ3AL/0XK9aVQ ($499.25 in chips)
Seat 2: RwDoM55ZeQuI2ADyJhOb2Q ($341.80 in chips)
RwDoM55ZeQuI2ADyJhOb2Q: posts small blind $1
6hvg964TSqZ3AL/0XK9aVQ: posts big blind $2
*** HOLE CARDS ***
RwDoM55ZeQuI2ADyJhOb2Q: raises $4 to $6
6hvg964TSqZ3AL/0XK9aVQ: calls $4
*** FLOP *** [6h 7h 8c]
6hvg964TSqZ3AL/0XK9aVQ: checks
RwDoM55ZeQuI2ADyJhOb2Q: bets $8
6hvg964TSqZ3AL/0XK9aVQ: calls $8
*** TURN *** [6h 7h 8c] [2d]
6hvg964TSqZ3AL/0XK9aVQ: checks
RwDoM55ZeQuI2ADyJhOb2Q: checks
*** RIVER *** [6h 7h 8c 2d] [Jd]
6hvg964TSqZ3AL/0XK9aVQ: bets $28
RwDoM55ZeQuI2ADyJhOb2Q: calls $28
*** SHOW DOWN ***
6hvg964TSqZ3AL/0XK9aVQ: shows [Ks 5h] (high card King)
RwDoM55ZeQuI2ADyJhOb2Q: shows [6s Kh] (a pair of Sixes)
RwDoM55ZeQuI2ADyJhOb2Q collected $83.50 from pot
*** SUMMARY ***
Total pot $84 | Rake $0.50
Board [6h 7h 8c 2d Jd]
Seat 1: 6hvg964TSqZ3AL/0XK9aVQ (big blind) showed [Ks 5h] and lost with high card King
Seat 2: RwDoM55ZeQuI2ADyJhOb2Q (button) (small blind) showed [6s Kh] and won ($83.50) with a pair of Sixes



PokerStars Game #59938988386:  Hold'em No Limit ($1/$2) - 2009/07/01 0:28:33 ET
Table 'W9UeSV0aoPjh5SFSxM8jUQ' 9-max Seat #2 is the button
Seat 1: cdC54j9fGGojcbzWB5PgzA ($204.60 in chips)
Seat 2: iMe5yhc+1BaiIPHet3NMrA ($311.75 in chips)
Seat 5: CUZwDpLTQKhzarPe+JCLOQ ($200 in chips)
Seat 6: MXxB6weBWzZyAhRZb+/KVg ($200 in chips)
Seat 7: 4Cl43Q1TYQL8wn1NSCUkaw ($50.15 in chips)
Seat 8: GX1heJ+DSsvm7gzSPsYhhQ ($40.80 in chips)
Seat 9: U2A5Hv6ib/5+gzO2wr7Z4w ($394 in chips)
/inIs/z/PcX+TniIFpaxpg will be allowed to play after the button
silverfox72 will be allowed to play after the button
CUZwDpLTQKhzarPe+JCLOQ: posts small blind $1
MXxB6weBWzZyAhRZb+/KVg: posts big blind $2
*** HOLE CARDS ***
4Cl43Q1TYQL8wn1NSCUkaw: folds
GX1heJ+DSsvm7gzSPsYhhQ: folds
U2A5Hv6ib/5+gzO2wr7Z4w: folds
cdC54j9fGGojcbzWB5PgzA: raises $4 to $6
iMe5yhc+1BaiIPHet3NMrA: folds
CUZwDpLTQKhzarPe+JCLOQ: folds
MXxB6weBWzZyAhRZb+/KVg: calls $4
*** FLOP *** [4s 9d 5s]
MXxB6weBWzZyAhRZb+/KVg: checks
cdC54j9fGGojcbzWB5PgzA: bets $10
MXxB6weBWzZyAhRZb+/KVg: folds
cdC54j9fGGojcbzWB5PgzA collected $12.35 from pot
*** SUMMARY ***
Total pot $13 | Rake $0.65
Board [4s 9d 5s]
Seat 1: cdC54j9fGGojcbzWB5PgzA collected ($12.35)
Seat 2: iMe5yhc+1BaiIPHet3NMrA (button) folded before Flop (didn't bet)
Seat 5: CUZwDpLTQKhzarPe+JCLOQ (small blind) folded before Flop
Seat 6: MXxB6weBWzZyAhRZb+/KVg (big blind) folded on the Flop
Seat 7: 4Cl43Q1TYQL8wn1NSCUkaw folded before Flop (didn't bet)
Seat 8: GX1heJ+DSsvm7gzSPsYhhQ folded before Flop (didn't bet)
Seat 9: U2A5Hv6ib/5+gzO2wr7Z4w folded before Flop (didn't bet)



PokerStars Game #59938988530:  Hold'em No Limit ($1/$2) - 2009/07/01 0:28:33 ET
Table 'CFkQcfWjKccZaZDf71FK+w' 6-max Seat #2 is the button
Seat 1: U2A5Hv6ib/5+gzO2wr7Z4w ($206 in chips)
Seat 2: X7GlkHF+lkbarCLuZ4Uf0w ($26 in chips)
Seat 3: R5/GXj0PUdNkzHU6Omb/JA ($93 in chips)
Seat 4: e8nZKSbIdIO7e2NdQe/OFQ ($233.80 in chips)
Seat 5: 1njbh8TKSUF6l4V1XwGdcg ($224.80 in chips)
R5/GXj0PUdNkzHU6Omb/JA: posts small blind $1
e8nZKSbIdIO7e2NdQe/OFQ: posts big blind $2
*** HOLE CARDS ***
1njbh8TKSUF6l4V1XwGdcg: folds
U2A5Hv6ib/5+gzO2wr7Z4w: raises $4 to $6
X7GlkHF+lkbarCLuZ4Uf0w: folds
R5/GXj0PUdNkzHU6Omb/JA: folds
e8nZKSbIdIO7e2NdQe/OFQ: folds
U2A5Hv6ib/5+gzO2wr7Z4w collected $5 from pot
*** SUMMARY ***
Total pot $5 | Rake $0
Seat 1: U2A5Hv6ib/5+gzO2wr7Z4w collected ($5)
Seat 2: X7GlkHF+lkbarCLuZ4Uf0w (button) folded before Flop (didn't bet)
Seat 3: R5/GXj0PUdNkzHU6Omb/JA (small blind) folded before Flop
Seat 4: e8nZKSbIdIO7e2NdQe/OFQ (big blind) folded before Flop
Seat 5: 1njbh8TKSUF6l4V1XwGdcg folded before Flop (didn't bet)



PokerStars Game #59938989386:  Hold'em No Limit ($1/$2) - 2009/07/01 0:28:34 ET
Table 'on4i1U1lCRmxsduFD3xiSg' 9-max Seat #1 is the button
Seat 1: so5k3vFDmokh2q3dImJ1GQ ($105 in chips)
Seat 2: yZYrOeNDxQxkzpbgKX1bng ($31.25 in chips)
Seat 3: 5iPk5MyO3KVu18Y8XCYfFQ ($75.85 in chips)
Seat 4: Z3aYCZG/yXHYFjiWkGI5ug ($527.10 in chips)
Seat 5: QHxJjpVYwitg9krW6wZgJA ($203 in chips)
Seat 6: CUZwDpLTQKhzarPe+JCLOQ ($206.55 in chips)
Seat 8: cdC54j9fGGojcbzWB5PgzA ($201 in chips)
Seat 9: iMe5yhc+1BaiIPHet3NMrA ($200 in chips)
yZYrOeNDxQxkzpbgKX1bng: posts small blind $1
5iPk5MyO3KVu18Y8XCYfFQ: posts big blind $2
*** HOLE CARDS ***
Z3aYCZG/yXHYFjiWkGI5ug: folds
QHxJjpVYwitg9krW6wZgJA: folds
CUZwDpLTQKhzarPe+JCLOQ: folds
cdC54j9fGGojcbzWB5PgzA: folds
iMe5yhc+1BaiIPHet3NMrA: calls $2
so5k3vFDmokh2q3dImJ1GQ: folds
yZYrOeNDxQxkzpbgKX1bng: folds
5iPk5MyO3KVu18Y8XCYfFQ: checks
*** FLOP *** [Ac 2d 5s]
5iPk5MyO3KVu18Y8XCYfFQ: bets $4
iMe5yhc+1BaiIPHet3NMrA: calls $4
*** TURN *** [Ac 2d 5s] [8s]
5iPk5MyO3KVu18Y8XCYfFQ: bets $6
iMe5yhc+1BaiIPHet3NMrA: folds
5iPk5MyO3KVu18Y8XCYfFQ collected $12.40 from pot
*** SUMMARY ***
Total pot $13 | Rake $0.60
Board [Ac 2d 5s 8s]
Seat 1: so5k3vFDmokh2q3dImJ1GQ (button) folded before Flop (didn't bet)
Seat 2: yZYrOeNDxQxkzpbgKX1bng (small blind) folded before Flop
Seat 3: 5iPk5MyO3KVu18Y8XCYfFQ (big blind) collected ($12.40)
Seat 4: Z3aYCZG/yXHYFjiWkGI5ug folded before Flop (didn't bet)
Seat 5: QHxJjpVYwitg9krW6wZgJA folded before Flop (didn't bet)
Seat 6: CUZwDpLTQKhzarPe+JCLOQ folded before Flop (didn't bet)
Seat 8: cdC54j9fGGojcbzWB5PgzA folded before Flop (didn't bet)
Seat 9: iMe5yhc+1BaiIPHet3NMrA folded on the Turn



PokerStars Game #59938989214:  Hold'em No Limit ($1/$2) - 2009/07/01 0:28:34 ET
Table 'aSf77Sj8QEnzcc0WaxVD4Q' 6-max Seat #4 is the button
Seat 1: 54yWzRRgS0oZ+S6LwZBxMQ ($37.80 in chips)
Seat 2: vkfxu8f/jMYKUk6Ly4eujw ($244.15 in chips)
Seat 3: 9dpyyjDTCed6nV7JhaUUpw ($204.30 in chips)
Seat 4: 513FcCI8jHyQy2VWoIQkMg ($200 in chips)
Seat 5: InmkdI6G8TzSj9NhcCSyPg ($252.65 in chips)
Seat 6: vkoJRf3gidxY1pPi0AFWww ($306.80 in chips)
InmkdI6G8TzSj9NhcCSyPg: posts small blind $1
vkoJRf3gidxY1pPi0AFWww: posts big blind $2
*** HOLE CARDS ***
54yWzRRgS0oZ+S6LwZBxMQ: folds
vkfxu8f/jMYKUk6Ly4eujw: folds
9dpyyjDTCed6nV7JhaUUpw: folds
513FcCI8jHyQy2VWoIQkMg: folds
InmkdI6G8TzSj9NhcCSyPg: folds
vkoJRf3gidxY1pPi0AFWww collected $2 from pot
vkoJRf3gidxY1pPi0AFWww: doesn't show hand
*** SUMMARY ***
Total pot $2 | Rake $0
Seat 1: 54yWzRRgS0oZ+S6LwZBxMQ folded before Flop (didn't bet)
Seat 2: vkfxu8f/jMYKUk6Ly4eujw folded before Flop (didn't bet)
Seat 3: 9dpyyjDTCed6nV7JhaUUpw folded before Flop (didn't bet)
Seat 4: 513FcCI8jHyQy2VWoIQkMg (button) folded before Flop (didn't bet)
Seat 5: InmkdI6G8TzSj9NhcCSyPg (small blind) folded before Flop
Seat 6: vkoJRf3gidxY1pPi0AFWww (big blind) collected ($2)



PokerStars Game #59938989632:  Hold'em No Limit ($1/$2) - 2009/07/01 0:28:34 ET
Table 'P/yCfYl1GfGsu/e6DxDy/A' 2-max Seat #1 is the button
Seat 1: 7fOCUy3x9hdkmXkkDNolGQ ($272.50 in chips)
Seat 2: RwDoM55ZeQuI2ADyJhOb2Q ($749.50 in chips)
7fOCUy3x9hdkmXkkDNolGQ: posts small blind $1
RwDoM55ZeQuI2ADyJhOb2Q: posts big blind $2
*** HOLE CARDS ***
7fOCUy3x9hdkmXkkDNolGQ: raises $4 to $6
RwDoM55ZeQuI2ADyJhOb2Q: calls $4
*** FLOP *** [8s As 5c]
RwDoM55ZeQuI2ADyJhOb2Q: checks
7fOCUy3x9hdkmXkkDNolGQ: bets $8
RwDoM55ZeQuI2ADyJhOb2Q: folds
7fOCUy3x9hdkmXkkDNolGQ collected $11.50 from pot
7fOCUy3x9hdkmXkkDNolGQ: doesn't show hand
*** SUMMARY ***
Total pot $12 | Rake $0.50
Board [8s As 5c]
Seat 1: 7fOCUy3x9hdkmXkkDNolGQ (button) (small blind) collected ($11.50)
Seat 2: RwDoM55ZeQuI2ADyJhOb2Q (big blind) folded on the Flop



PokerStars Game #59938995270:  Hold'em No Limit ($1/$2) - 2009/07/01 0:28:43 ET
Table '+hSnXFQrGw1PlVgTnuj+sA' 6-max Seat #5 is the button
Seat 1: mfy7uGZcqA2PVQqEVbJ7+g ($196.55 in chips)
Seat 2: 54yWzRRgS0oZ+S6LwZBxMQ ($33.80 in chips)
Seat 3: 1njbh8TKSUF6l4V1XwGdcg ($262.30 in chips)
Seat 4: sTPOWERd9HWPCNrDBwsVjA ($371 in chips)
Seat 5: /PH6Ffnho4Ysm8S3V/oa+w ($40 in chips)
Seat 6: RwDoM55ZeQuI2ADyJhOb2Q ($122.50 in chips)
RwDoM55ZeQuI2ADyJhOb2Q: posts small blind $1
mfy7uGZcqA2PVQqEVbJ7+g: posts big blind $2
*** HOLE CARDS ***
54yWzRRgS0oZ+S6LwZBxMQ: folds
1njbh8TKSUF6l4V1XwGdcg: raises $4 to $6
sTPOWERd9HWPCNrDBwsVjA: folds
/PH6Ffnho4Ysm8S3V/oa+w: folds
RwDoM55ZeQuI2ADyJhOb2Q: folds
mfy7uGZcqA2PVQqEVbJ7+g: folds
1njbh8TKSUF6l4V1XwGdcg collected $5 from pot
*** SUMMARY ***
Total pot $5 | Rake $0
Seat 1: mfy7uGZcqA2PVQqEVbJ7+g (big blind) folded before Flop
Seat 2: 54yWzRRgS0oZ+S6LwZBxMQ folded before Flop (didn't bet)
Seat 3: 1njbh8TKSUF6l4V1XwGdcg collected ($5)
Seat 4: sTPOWERd9HWPCNrDBwsVjA folded before Flop (didn't bet)
Seat 5: /PH6Ffnho4Ysm8S3V/oa+w (button) folded before Flop (didn't bet)
Seat 6: RwDoM55ZeQuI2ADyJhOb2Q (small blind) folded before Flop



PokerStars Game #59938996854:  Hold'em No Limit ($1/$2) - 2009/07/01 0:28:45 ET
Table 'ZzSIe0zTCDv+n6hfbY5tTg' 6-max Seat #2 is the button
Seat 2: B87ikIyZ/TzAVeXf38Ny0g ($200 in chips)
Seat 3: X7GlkHF+lkbarCLuZ4Uf0w ($74.05 in chips)
Seat 4: ky55L0pITYgYLeqFB9gP/Q ($133.40 in chips)
Seat 5: f2eTKbND+tM3kUw9o6WYWg ($165.50 in chips)
Seat 6: InmkdI6G8TzSj9NhcCSyPg ($200 in chips)
X7GlkHF+lkbarCLuZ4Uf0w: posts small blind $1
ky55L0pITYgYLeqFB9gP/Q: posts big blind $2
8srN1dKQePlsv0GyTada+Q: sits out
*** HOLE CARDS ***
f2eTKbND+tM3kUw9o6WYWg: raises $4 to $6
InmkdI6G8TzSj9NhcCSyPg: calls $6
B87ikIyZ/TzAVeXf38Ny0g: calls $6
X7GlkHF+lkbarCLuZ4Uf0w: folds
ky55L0pITYgYLeqFB9gP/Q: folds
*** FLOP *** [Ac Td 6d]
f2eTKbND+tM3kUw9o6WYWg: bets $8
InmkdI6G8TzSj9NhcCSyPg: raises $18 to $26
B87ikIyZ/TzAVeXf38Ny0g: folds
f2eTKbND+tM3kUw9o6WYWg: folds
InmkdI6G8TzSj9NhcCSyPg collected $35.25 from pot
InmkdI6G8TzSj9NhcCSyPg: doesn't show hand
*** SUMMARY ***
Total pot $37 | Rake $1.75
Board [Ac Td 6d]
Seat 2: B87ikIyZ/TzAVeXf38Ny0g (button) folded on the Flop
Seat 3: X7GlkHF+lkbarCLuZ4Uf0w (small blind) folded before Flop
Seat 4: ky55L0pITYgYLeqFB9gP/Q (big blind) folded before Flop
Seat 5: f2eTKbND+tM3kUw9o6WYWg folded on the Flop
Seat 6: InmkdI6G8TzSj9NhcCSyPg collected ($35.25)



PokerStars Game #59938997788:  Hold'em No Limit ($1/$2) - 2009/07/01 0:28:47 ET
Table '5G1PjWSk2ALz0O/eqyYy/g' 2-max Seat #2 is the button
Seat 1: Z4HwehErEwzsv/noQlfUlg ($128.90 in chips)
Seat 2: v4dp1VoMhJV4zmCXtmG5LQ ($254 in chips)
v4dp1VoMhJV4zmCXtmG5LQ: posts small blind $1
Z4HwehErEwzsv/noQlfUlg: posts big blind $2
*** HOLE CARDS ***
v4dp1VoMhJV4zmCXtmG5LQ: raises $4 to $6
Z4HwehErEwzsv/noQlfUlg: folds
v4dp1VoMhJV4zmCXtmG5LQ collected $4 from pot
v4dp1VoMhJV4zmCXtmG5LQ: doesn't show hand
*** SUMMARY ***
Total pot $4 | Rake $0
Seat 1: Z4HwehErEwzsv/noQlfUlg (big blind) folded before Flop
Seat 2: v4dp1VoMhJV4zmCXtmG5LQ (button) (small blind) collected ($4)



PokerStars Game #59938999678:  Hold'em No Limit ($1/$2) - 2009/07/01 0:28:50 ET
Table 'XP2sRSup+aRuwzx3vDZsDg' 6-max Seat #5 is the button
Seat 1: o9jamqIi6sTTRSqudgboRA ($237.75 in chips)
Seat 2: ygTTt5ehT4aF86q1a8/R+w ($100 in chips)
Seat 3: X7GlkHF+lkbarCLuZ4Uf0w ($32 in chips)
Seat 4: hCtfSY4dRapM2rhEFmS4Ug ($126.50 in chips)
Seat 5: 894kvCY4GHivBpqwizsecg ($116.20 in chips)
Seat 6: h7ppRQJTYBsHCbLMeW9T2g ($444.75 in chips)
h7ppRQJTYBsHCbLMeW9T2g: posts small blind $1
o9jamqIi6sTTRSqudgboRA: posts big blind $2
*** HOLE CARDS ***
ygTTt5ehT4aF86q1a8/R+w: folds
X7GlkHF+lkbarCLuZ4Uf0w: folds
hCtfSY4dRapM2rhEFmS4Ug: raises $4 to $6
894kvCY4GHivBpqwizsecg: folds
h7ppRQJTYBsHCbLMeW9T2g: folds
o9jamqIi6sTTRSqudgboRA: folds
hCtfSY4dRapM2rhEFmS4Ug collected $5 from pot
*** SUMMARY ***
Total pot $5 | Rake $0
Seat 1: o9jamqIi6sTTRSqudgboRA (big blind) folded before Flop
Seat 2: ygTTt5ehT4aF86q1a8/R+w folded before Flop (didn't bet)
Seat 3: X7GlkHF+lkbarCLuZ4Uf0w folded before Flop (didn't bet)
Seat 4: hCtfSY4dRapM2rhEFmS4Ug collected ($5)
Seat 5: 894kvCY4GHivBpqwizsecg (button) folded before Flop (didn't bet)
Seat 6: h7ppRQJTYBsHCbLMeW9T2g (small blind) folded before Flop



PokerStars Game #59938999780:  Hold'em No Limit ($1/$2) - 2009/07/01 0:28:50 ET
Table 'ztv6V3FN2bQ9nmJPPdx6nQ' 6-max Seat #3 is the button
Seat 2: 5Y+ZGWLI4gnlpApDX5vy1A ($262.30 in chips)
Seat 3: Z55K9DbCHCUi6UaztIHi6g ($112.90 in chips)
Seat 4: vVSUvlW/pvneUNUHDgyXgw ($200 in chips)
Seat 5: sTPOWERd9HWPCNrDBwsVjA ($206.40 in chips)
Seat 6: mfy7uGZcqA2PVQqEVbJ7+g ($201.75 in chips)
vVSUvlW/pvneUNUHDgyXgw: posts small blind $1
sTPOWERd9HWPCNrDBwsVjA: posts big blind $2
vkfxu8f/jMYKUk6Ly4eujw: sits out
*** HOLE CARDS ***
mfy7uGZcqA2PVQqEVbJ7+g: folds
5Y+ZGWLI4gnlpApDX5vy1A: folds
Z55K9DbCHCUi6UaztIHi6g: folds
vVSUvlW/pvneUNUHDgyXgw: folds
sTPOWERd9HWPCNrDBwsVjA collected $2 from pot
*** SUMMARY ***
Total pot $2 | Rake $0
Seat 2: 5Y+ZGWLI4gnlpApDX5vy1A folded before Flop (didn't bet)
Seat 3: Z55K9DbCHCUi6UaztIHi6g (button) folded before Flop (didn't bet)
Seat 4: vVSUvlW/pvneUNUHDgyXgw (small blind) folded before Flop
Seat 5: sTPOWERd9HWPCNrDBwsVjA (big blind) collected ($2)
Seat 6: mfy7uGZcqA2PVQqEVbJ7+g folded before Flop (didn't bet)



PokerStars Game #59939000226:  Hold'em No Limit ($1/$2) - 2009/07/01 0:28:50 ET
Table 'eyAQSIlgc2o1Jxvbve4WGg' 9-max Seat #1 is the button
Seat 1: UZEsV9yKUMqmpYPiOFpaZw ($68 in chips)
Seat 2: g7gL2NLJCdZPPV399WKT1w ($46 in chips)
Seat 3: oJooWHfAxUkwfT5OoynLdw ($43.80 in chips)
Seat 4: miAHPEBdznuHNzK6YM3hRA ($95.55 in chips)
Seat 5: JnV3SM2D6dAFYyGZHHpvrg ($130 in chips)
Seat 6: IikcENBHwoT7snSvBPSc7Q ($164 in chips)
Seat 7: QHxJjpVYwitg9krW6wZgJA ($213.90 in chips)
Seat 8: 5iPk5MyO3KVu18Y8XCYfFQ ($40 in chips)
Seat 9: GX1heJ+DSsvm7gzSPsYhhQ ($39 in chips)
g7gL2NLJCdZPPV399WKT1w: posts small blind $1
oJooWHfAxUkwfT5OoynLdw: posts big blind $2
*** HOLE CARDS ***
miAHPEBdznuHNzK6YM3hRA: calls $2
JnV3SM2D6dAFYyGZHHpvrg: calls $2
IikcENBHwoT7snSvBPSc7Q: calls $2
QHxJjpVYwitg9krW6wZgJA: folds
5iPk5MyO3KVu18Y8XCYfFQ: folds
GX1heJ+DSsvm7gzSPsYhhQ: folds
UZEsV9yKUMqmpYPiOFpaZw: folds
g7gL2NLJCdZPPV399WKT1w: folds
oJooWHfAxUkwfT5OoynLdw: checks
*** FLOP *** [As 9h Jd]
oJooWHfAxUkwfT5OoynLdw: checks
miAHPEBdznuHNzK6YM3hRA: bets $6
JnV3SM2D6dAFYyGZHHpvrg: folds
IikcENBHwoT7snSvBPSc7Q: folds
oJooWHfAxUkwfT5OoynLdw: folds
miAHPEBdznuHNzK6YM3hRA collected $8.55 from pot
*** SUMMARY ***
Total pot $9 | Rake $0.45
Board [As 9h Jd]
Seat 1: UZEsV9yKUMqmpYPiOFpaZw (button) folded before Flop (didn't bet)
Seat 2: g7gL2NLJCdZPPV399WKT1w (small blind) folded before Flop
Seat 3: oJooWHfAxUkwfT5OoynLdw (big blind) folded on the Flop
Seat 4: miAHPEBdznuHNzK6YM3hRA collected ($8.55)
Seat 5: JnV3SM2D6dAFYyGZHHpvrg folded on the Flop
Seat 6: IikcENBHwoT7snSvBPSc7Q folded on the Flop
Seat 7: QHxJjpVYwitg9krW6wZgJA folded before Flop (didn't bet)
Seat 8: 5iPk5MyO3KVu18Y8XCYfFQ folded before Flop (didn't bet)
Seat 9: GX1heJ+DSsvm7gzSPsYhhQ folded before Flop (didn't bet)



PokerStars Game #59939002136:  Hold'em No Limit ($1/$2) - 2009/07/01 0:28:53 ET
Table 'QxerF7GUfCbl+4a8XaTB2w' 6-max Seat #6 is the button
Seat 1: o9jamqIi6sTTRSqudgboRA ($201 in chips)
Seat 2: 513FcCI8jHyQy2VWoIQkMg ($228.35 in chips)
Seat 3: vkfxu8f/jMYKUk6Ly4eujw ($197 in chips)
Seat 5: ezK4YR9nqEKpOT/tYPvHKA ($126.40 in chips)
Seat 6: RUZs7P4uzWavoA6iEpDKLw ($129.40 in chips)
o9jamqIi6sTTRSqudgboRA: posts small blind $1
513FcCI8jHyQy2VWoIQkMg: posts big blind $2
CroCopHiKiK: sits out
*** HOLE CARDS ***
vkfxu8f/jMYKUk6Ly4eujw: folds
ezK4YR9nqEKpOT/tYPvHKA: raises $4 to $6
RUZs7P4uzWavoA6iEpDKLw: calls $6
o9jamqIi6sTTRSqudgboRA: folds
513FcCI8jHyQy2VWoIQkMg: folds
*** FLOP *** [Qs Ad 6d]
ezK4YR9nqEKpOT/tYPvHKA: checks
RUZs7P4uzWavoA6iEpDKLw: bets $4
ezK4YR9nqEKpOT/tYPvHKA: calls $4
*** TURN *** [Qs Ad 6d] [Js]
ezK4YR9nqEKpOT/tYPvHKA: checks
RUZs7P4uzWavoA6iEpDKLw: checks
*** RIVER *** [Qs Ad 6d Js] [Ks]
ezK4YR9nqEKpOT/tYPvHKA: checks
RUZs7P4uzWavoA6iEpDKLw: checks
*** SHOW DOWN ***
ezK4YR9nqEKpOT/tYPvHKA: shows [7s 7c] (a pair of Sevens)
RUZs7P4uzWavoA6iEpDKLw: shows [9s Ah] (a pair of Aces)
RUZs7P4uzWavoA6iEpDKLw collected $21.90 from pot
*** SUMMARY ***
Total pot $23 | Rake $1.10
Board [Qs Ad 6d Js Ks]
Seat 1: o9jamqIi6sTTRSqudgboRA (small blind) folded before Flop
Seat 2: 513FcCI8jHyQy2VWoIQkMg (big blind) folded before Flop
Seat 3: vkfxu8f/jMYKUk6Ly4eujw folded before Flop (didn't bet)
Seat 5: ezK4YR9nqEKpOT/tYPvHKA showed [7s 7c] and lost with a pair of Sevens
Seat 6: RUZs7P4uzWavoA6iEpDKLw (button) showed [9s Ah] and won ($21.90) with a pair of Aces



PokerStars Game #59939001976:  Hold'em No Limit ($1/$2) - 2009/07/01 0:28:53 ET
Table 'uJ9juaXXg9yIcSU8amxaXQ' 6-max Seat #1 is the button
Seat 1: JsqOjN/eHz0uYVf/PyUJ6Q ($41.50 in chips)
Seat 2: yynBOXUjw28V5kz84sxX4g ($148.30 in chips)
Seat 3: zaogaltCDFVsIASEnrXs2w ($293 in chips)
Seat 4: zNjJ/y4emmF+vzrCDd+ooA ($120.60 in chips)
Seat 5: aMZYAxFxWTQXE9aUus4sxg ($56.55 in chips)
Seat 6: XrFG4dK06RVKLlX32/pjcQ ($39.60 in chips)
yynBOXUjw28V5kz84sxX4g: posts small blind $1
zaogaltCDFVsIASEnrXs2w: posts big blind $2
*** HOLE CARDS ***
zNjJ/y4emmF+vzrCDd+ooA: calls $2
aMZYAxFxWTQXE9aUus4sxg: folds
XrFG4dK06RVKLlX32/pjcQ: folds
JsqOjN/eHz0uYVf/PyUJ6Q: calls $2
yynBOXUjw28V5kz84sxX4g: folds
zaogaltCDFVsIASEnrXs2w: checks
*** FLOP *** [7c Th 7s]
zaogaltCDFVsIASEnrXs2w: checks
zNjJ/y4emmF+vzrCDd+ooA: checks
JsqOjN/eHz0uYVf/PyUJ6Q: checks
*** TURN *** [7c Th 7s] [Js]
zaogaltCDFVsIASEnrXs2w: checks
zNjJ/y4emmF+vzrCDd+ooA: checks
JsqOjN/eHz0uYVf/PyUJ6Q: checks
*** RIVER *** [7c Th 7s Js] [Kh]
zaogaltCDFVsIASEnrXs2w: checks
zNjJ/y4emmF+vzrCDd+ooA: checks
JsqOjN/eHz0uYVf/PyUJ6Q: checks
*** SHOW DOWN ***
zaogaltCDFVsIASEnrXs2w: shows [Jh 6c] (two pair, Jacks and Sevens)
zNjJ/y4emmF+vzrCDd+ooA: mucks hand
JsqOjN/eHz0uYVf/PyUJ6Q: mucks hand
zaogaltCDFVsIASEnrXs2w collected $6.65 from pot
*** SUMMARY ***
Total pot $7 | Rake $0.35
Board [7c Th 7s Js Kh]
Seat 1: JsqOjN/eHz0uYVf/PyUJ6Q (button) mucked
Seat 2: yynBOXUjw28V5kz84sxX4g (small blind) folded before Flop
Seat 3: zaogaltCDFVsIASEnrXs2w (big blind) showed [Jh 6c] and won ($6.65) with two pair, Jacks and Sevens
Seat 4: zNjJ/y4emmF+vzrCDd+ooA mucked
Seat 5: aMZYAxFxWTQXE9aUus4sxg folded before Flop (didn't bet)
Seat 6: XrFG4dK06RVKLlX32/pjcQ folded before Flop (didn't bet)



