PokerStars Game #59941479330:  Hold'em No Limit ($1/$2) - 2009/07/01 1:36:44 ET
Table 'G1Oqdy4Pqdb5gtx40rUBzA' 6-max Seat #4 is the button
Seat 2: 4uqU0dG67owXuPz303Al4w ($515.25 in chips)
Seat 3: VvdR9F3I+2yELkfTVvC1dg ($234.90 in chips)
Seat 4: B87ikIyZ/TzAVeXf38Ny0g ($211.55 in chips)
Seat 5: F1+Ml47qRQWunzPnGhLLzQ ($196.30 in chips)
Seat 6: qCnEYuAE5y5A7bk6fO5/jQ ($200 in chips)
F1+Ml47qRQWunzPnGhLLzQ: posts small blind $1
qCnEYuAE5y5A7bk6fO5/jQ: posts big blind $2
*** HOLE CARDS ***
4uqU0dG67owXuPz303Al4w: raises $4 to $6
VvdR9F3I+2yELkfTVvC1dg: folds
B87ikIyZ/TzAVeXf38Ny0g: folds
F1+Ml47qRQWunzPnGhLLzQ: folds
qCnEYuAE5y5A7bk6fO5/jQ: calls $4
*** FLOP *** [Kc Kh 9d]
qCnEYuAE5y5A7bk6fO5/jQ: checks
4uqU0dG67owXuPz303Al4w: bets $10
qCnEYuAE5y5A7bk6fO5/jQ: folds
4uqU0dG67owXuPz303Al4w collected $12.35 from pot
*** SUMMARY ***
Total pot $13 | Rake $0.65
Board [Kc Kh 9d]
Seat 2: 4uqU0dG67owXuPz303Al4w collected ($12.35)
Seat 3: VvdR9F3I+2yELkfTVvC1dg folded before Flop (didn't bet)
Seat 4: B87ikIyZ/TzAVeXf38Ny0g (button) folded before Flop (didn't bet)
Seat 5: F1+Ml47qRQWunzPnGhLLzQ (small blind) folded before Flop
Seat 6: qCnEYuAE5y5A7bk6fO5/jQ (big blind) folded on the Flop



PokerStars Game #59941480378:  Hold'em No Limit ($1/$2) - 2009/07/01 1:36:46 ET
Table '8Y6PEyoNuepZTai2Q56aHw' 9-max Seat #7 is the button
Seat 1: 5Q8U6iZbeO7xJSS4qvDP5g ($311.80 in chips)
Seat 2: gDCJIAlovbPnTvMM7Dd1gA ($197.55 in chips)
Seat 3: WUlHm+ydPPHG7Lb0rePSdA ($214.10 in chips)
Seat 4: xKkwALG38OfLQ9DXuJgR1w ($210.25 in chips)
Seat 5: /inIs/z/PcX+TniIFpaxpg ($40 in chips)
Seat 6: NtLDBSjsJQEKekh5cdinvw ($373.35 in chips)
Seat 7: Kzta8yu9vxHT4B70mjBZ+w ($200 in chips)
Seat 9: F7m34OOfAQ7annesMHVjKw ($191 in chips)
+T/63sAeZzWyHchahJ36GQ will be allowed to play after the button
F7m34OOfAQ7annesMHVjKw: posts small blind $1
5Q8U6iZbeO7xJSS4qvDP5g: posts big blind $2
*** HOLE CARDS ***
gDCJIAlovbPnTvMM7Dd1gA: calls $2
WUlHm+ydPPHG7Lb0rePSdA: folds
xKkwALG38OfLQ9DXuJgR1w: raises $4 to $6
/inIs/z/PcX+TniIFpaxpg: folds
NtLDBSjsJQEKekh5cdinvw: folds
Kzta8yu9vxHT4B70mjBZ+w: folds
F7m34OOfAQ7annesMHVjKw: folds
5Q8U6iZbeO7xJSS4qvDP5g: folds
gDCJIAlovbPnTvMM7Dd1gA: folds
xKkwALG38OfLQ9DXuJgR1w collected $7 from pot
xKkwALG38OfLQ9DXuJgR1w: doesn't show hand
*** SUMMARY ***
Total pot $7 | Rake $0
Seat 1: 5Q8U6iZbeO7xJSS4qvDP5g (big blind) folded before Flop
Seat 2: gDCJIAlovbPnTvMM7Dd1gA folded before Flop
Seat 3: WUlHm+ydPPHG7Lb0rePSdA folded before Flop (didn't bet)
Seat 4: xKkwALG38OfLQ9DXuJgR1w collected ($7)
Seat 5: /inIs/z/PcX+TniIFpaxpg folded before Flop (didn't bet)
Seat 6: NtLDBSjsJQEKekh5cdinvw folded before Flop (didn't bet)
Seat 7: Kzta8yu9vxHT4B70mjBZ+w (button) folded before Flop (didn't bet)
Seat 9: F7m34OOfAQ7annesMHVjKw (small blind) folded before Flop



PokerStars Game #59941480716:  Hold'em No Limit ($1/$2) - 2009/07/01 1:36:46 ET
Table 'pPQgcj9XT9CHBsbo1WTBug' 6-max Seat #5 is the button
Seat 1: DFVYDA6dKQy7R7mGIKogZA ($143.50 in chips)
Seat 2: qXDd0ZyMIse0OBu8pxeQ3Q ($200 in chips)
Seat 3: 54yWzRRgS0oZ+S6LwZBxMQ ($49.50 in chips)
Seat 4: gqlysXCbT8V54f/1lf9h3A ($73.45 in chips)
Seat 5: vkfxu8f/jMYKUk6Ly4eujw ($193.55 in chips)
Seat 6: Yr7pZltpy3IUNdKS9PCEiw ($311.80 in chips)
Yr7pZltpy3IUNdKS9PCEiw: posts small blind $1
DFVYDA6dKQy7R7mGIKogZA: posts big blind $2
*** HOLE CARDS ***
qXDd0ZyMIse0OBu8pxeQ3Q: folds
54yWzRRgS0oZ+S6LwZBxMQ: folds
gqlysXCbT8V54f/1lf9h3A: folds
vkfxu8f/jMYKUk6Ly4eujw: raises $6 to $8
Yr7pZltpy3IUNdKS9PCEiw: folds
DFVYDA6dKQy7R7mGIKogZA: folds
vkfxu8f/jMYKUk6Ly4eujw collected $5 from pot
*** SUMMARY ***
Total pot $5 | Rake $0
Seat 1: DFVYDA6dKQy7R7mGIKogZA (big blind) folded before Flop
Seat 2: qXDd0ZyMIse0OBu8pxeQ3Q folded before Flop (didn't bet)
Seat 3: 54yWzRRgS0oZ+S6LwZBxMQ folded before Flop (didn't bet)
Seat 4: gqlysXCbT8V54f/1lf9h3A folded before Flop (didn't bet)
Seat 5: vkfxu8f/jMYKUk6Ly4eujw (button) collected ($5)
Seat 6: Yr7pZltpy3IUNdKS9PCEiw (small blind) folded before Flop



PokerStars Game #59941482892:  Hold'em No Limit ($1/$2) - 2009/07/01 1:36:50 ET
Table 'gnHBqWll9O3fxG7Ojkz/ng' 9-max Seat #4 is the button
Seat 1: TAfo4veNRaRlzDXMMYS3Jg ($31 in chips)
Seat 2: H6Z4+qu8gR0VUiPOijndVg ($331.95 in chips)
Seat 3: 5Q8U6iZbeO7xJSS4qvDP5g ($218.05 in chips)
Seat 4: nXDI8Y/S6POzRwANu3d8hQ ($35 in chips)
Seat 5: rBQDMkKm9cZn6M9NPsiVew ($225.15 in chips)
Seat 6: KqHysDSpCPaPyK3tJC1aEw ($200 in chips)
Seat 7: jqui3xAWCkcdPW36a6BD+w ($345.55 in chips)
Seat 8: cM6efHzdxoqYm0EQKP4TTQ ($87.75 in chips)
Seat 9: GX1heJ+DSsvm7gzSPsYhhQ ($50.35 in chips)
rBQDMkKm9cZn6M9NPsiVew: posts small blind $1
KqHysDSpCPaPyK3tJC1aEw: posts big blind $2
*** HOLE CARDS ***
jqui3xAWCkcdPW36a6BD+w: folds
cM6efHzdxoqYm0EQKP4TTQ: calls $2
GX1heJ+DSsvm7gzSPsYhhQ: folds
TAfo4veNRaRlzDXMMYS3Jg: folds
H6Z4+qu8gR0VUiPOijndVg: folds
5Q8U6iZbeO7xJSS4qvDP5g: folds
nXDI8Y/S6POzRwANu3d8hQ: folds
rBQDMkKm9cZn6M9NPsiVew: folds
KqHysDSpCPaPyK3tJC1aEw: checks
*** FLOP *** [5h Ts Ah]
KqHysDSpCPaPyK3tJC1aEw: checks
cM6efHzdxoqYm0EQKP4TTQ: bets $6
KqHysDSpCPaPyK3tJC1aEw: folds
cM6efHzdxoqYm0EQKP4TTQ collected $4.75 from pot
*** SUMMARY ***
Total pot $5 | Rake $0.25
Board [5h Ts Ah]
Seat 1: TAfo4veNRaRlzDXMMYS3Jg folded before Flop (didn't bet)
Seat 2: H6Z4+qu8gR0VUiPOijndVg folded before Flop (didn't bet)
Seat 3: 5Q8U6iZbeO7xJSS4qvDP5g folded before Flop (didn't bet)
Seat 4: nXDI8Y/S6POzRwANu3d8hQ (button) folded before Flop (didn't bet)
Seat 5: rBQDMkKm9cZn6M9NPsiVew (small blind) folded before Flop
Seat 6: KqHysDSpCPaPyK3tJC1aEw (big blind) folded on the Flop
Seat 7: jqui3xAWCkcdPW36a6BD+w folded before Flop (didn't bet)
Seat 8: cM6efHzdxoqYm0EQKP4TTQ collected ($4.75)
Seat 9: GX1heJ+DSsvm7gzSPsYhhQ folded before Flop (didn't bet)



PokerStars Game #59941483060:  Hold'em No Limit ($1/$2) - 2009/07/01 1:36:50 ET
Table '3WCXyaiCAbqSShQu7FIjvA' 9-max Seat #5 is the button
Seat 1: kTCkABD1UUldS9DFRGfCwQ ($154.75 in chips)
Seat 2: TAfo4veNRaRlzDXMMYS3Jg ($37 in chips)
Seat 3: 5Q8U6iZbeO7xJSS4qvDP5g ($273.85 in chips)
Seat 4: waEF/+pxZTxNo4FvsORuXg ($78.40 in chips)
Seat 5: CkE3IyJF1KvdaAOmZY5XqQ ($200 in chips)
Seat 6: 5jQlngvMSqM/WoonOcR5kw ($284.65 in chips)
Seat 7: nXDI8Y/S6POzRwANu3d8hQ ($40 in chips)
Seat 8: 1CtiZuXDFaJL1dJPQKyi8Q ($237.05 in chips)
Seat 9: FiXPLJyqb24l32QST2TInw ($110.40 in chips)
5jQlngvMSqM/WoonOcR5kw: posts small blind $1
nXDI8Y/S6POzRwANu3d8hQ: posts big blind $2
*** HOLE CARDS ***
1CtiZuXDFaJL1dJPQKyi8Q: folds
FiXPLJyqb24l32QST2TInw: folds
kTCkABD1UUldS9DFRGfCwQ: folds
TAfo4veNRaRlzDXMMYS3Jg: folds
5Q8U6iZbeO7xJSS4qvDP5g: folds
waEF/+pxZTxNo4FvsORuXg: calls $2
CkE3IyJF1KvdaAOmZY5XqQ: folds
5jQlngvMSqM/WoonOcR5kw: calls $1
nXDI8Y/S6POzRwANu3d8hQ: checks
*** FLOP *** [5h Ad 3d]
5jQlngvMSqM/WoonOcR5kw: checks
nXDI8Y/S6POzRwANu3d8hQ: checks
waEF/+pxZTxNo4FvsORuXg: checks
*** TURN *** [5h Ad 3d] [7c]
5jQlngvMSqM/WoonOcR5kw: bets $2
nXDI8Y/S6POzRwANu3d8hQ: folds
waEF/+pxZTxNo4FvsORuXg: folds
5jQlngvMSqM/WoonOcR5kw collected $5.70 from pot
*** SUMMARY ***
Total pot $6 | Rake $0.30
Board [5h Ad 3d 7c]
Seat 1: kTCkABD1UUldS9DFRGfCwQ folded before Flop (didn't bet)
Seat 2: TAfo4veNRaRlzDXMMYS3Jg folded before Flop (didn't bet)
Seat 3: 5Q8U6iZbeO7xJSS4qvDP5g folded before Flop (didn't bet)
Seat 4: waEF/+pxZTxNo4FvsORuXg folded on the Turn
Seat 5: CkE3IyJF1KvdaAOmZY5XqQ (button) folded before Flop (didn't bet)
Seat 6: 5jQlngvMSqM/WoonOcR5kw (small blind) collected ($5.70)
Seat 7: nXDI8Y/S6POzRwANu3d8hQ (big blind) folded on the Turn
Seat 8: 1CtiZuXDFaJL1dJPQKyi8Q folded before Flop (didn't bet)
Seat 9: FiXPLJyqb24l32QST2TInw folded before Flop (didn't bet)



PokerStars Game #59941483044:  Hold'em No Limit ($1/$2) - 2009/07/01 1:36:50 ET
Table 'uJ9juaXXg9yIcSU8amxaXQ' 6-max Seat #1 is the button
Seat 1: JsqOjN/eHz0uYVf/PyUJ6Q ($155.25 in chips)
Seat 2: VvdR9F3I+2yELkfTVvC1dg ($224.10 in chips)
Seat 3: qXDd0ZyMIse0OBu8pxeQ3Q ($246.40 in chips)
Seat 4: zNjJ/y4emmF+vzrCDd+ooA ($223.05 in chips)
Seat 5: YsLQ3BAvgQHWXMAv3Wv6Hg ($200 in chips)
VvdR9F3I+2yELkfTVvC1dg: posts small blind $1
qXDd0ZyMIse0OBu8pxeQ3Q: posts big blind $2
/PH6Ffnho4Ysm8S3V/oa+w: sits out
*** HOLE CARDS ***
zNjJ/y4emmF+vzrCDd+ooA: folds
YsLQ3BAvgQHWXMAv3Wv6Hg: raises $4 to $6
JsqOjN/eHz0uYVf/PyUJ6Q: folds
VvdR9F3I+2yELkfTVvC1dg: folds
qXDd0ZyMIse0OBu8pxeQ3Q: folds
YsLQ3BAvgQHWXMAv3Wv6Hg collected $5 from pot
YsLQ3BAvgQHWXMAv3Wv6Hg: doesn't show hand
*** SUMMARY ***
Total pot $5 | Rake $0
Seat 1: JsqOjN/eHz0uYVf/PyUJ6Q (button) folded before Flop (didn't bet)
Seat 2: VvdR9F3I+2yELkfTVvC1dg (small blind) folded before Flop
Seat 3: qXDd0ZyMIse0OBu8pxeQ3Q (big blind) folded before Flop
Seat 4: zNjJ/y4emmF+vzrCDd+ooA folded before Flop (didn't bet)
Seat 5: YsLQ3BAvgQHWXMAv3Wv6Hg collected ($5)



PokerStars Game #59941483122:  Hold'em No Limit ($1/$2) - 2009/07/01 1:36:51 ET
Table 'gftD4mDF7mIFKvSrIyaRbw' 9-max Seat #2 is the button
Seat 2: GX1heJ+DSsvm7gzSPsYhhQ ($33 in chips)
Seat 3: CUZwDpLTQKhzarPe+JCLOQ ($223.65 in chips)
Seat 4: /inIs/z/PcX+TniIFpaxpg ($37 in chips)
Seat 5: mpsfNtnMVDqQHTe92AhIdw ($97.10 in chips)
Seat 6: 2NvwF8W2nzsbS+G//yLAbQ ($118.20 in chips)
Seat 7: +T/63sAeZzWyHchahJ36GQ ($46 in chips)
Seat 8: MpL4DeEqGQu0H8TJEbEOrg ($38 in chips)
CUZwDpLTQKhzarPe+JCLOQ: posts small blind $1
/inIs/z/PcX+TniIFpaxpg: posts big blind $2
*** HOLE CARDS ***
mpsfNtnMVDqQHTe92AhIdw: folds
2NvwF8W2nzsbS+G//yLAbQ: folds
+T/63sAeZzWyHchahJ36GQ: folds
MpL4DeEqGQu0H8TJEbEOrg: folds
GX1heJ+DSsvm7gzSPsYhhQ: folds
CUZwDpLTQKhzarPe+JCLOQ: folds
/inIs/z/PcX+TniIFpaxpg collected $2 from pot
/inIs/z/PcX+TniIFpaxpg: doesn't show hand
*** SUMMARY ***
Total pot $2 | Rake $0
Seat 2: GX1heJ+DSsvm7gzSPsYhhQ (button) folded before Flop (didn't bet)
Seat 3: CUZwDpLTQKhzarPe+JCLOQ (small blind) folded before Flop
Seat 4: /inIs/z/PcX+TniIFpaxpg (big blind) collected ($2)
Seat 5: mpsfNtnMVDqQHTe92AhIdw folded before Flop (didn't bet)
Seat 6: 2NvwF8W2nzsbS+G//yLAbQ folded before Flop (didn't bet)
Seat 7: +T/63sAeZzWyHchahJ36GQ folded before Flop (didn't bet)
Seat 8: MpL4DeEqGQu0H8TJEbEOrg folded before Flop (didn't bet)



PokerStars Game #59941483766:  Hold'em No Limit ($1/$2) - 2009/07/01 1:36:52 ET
Table 'YqGfR5eHfMeSjb9a+QU9rg' 9-max Seat #4 is the button
Seat 1: rW/MyplHylMSBRaoRUzWrg ($36 in chips)
Seat 3: /gll27k+xWYV7Fbki0lFDQ ($258.75 in chips)
Seat 4: GX1heJ+DSsvm7gzSPsYhhQ ($34 in chips)
Seat 5: CkE3IyJF1KvdaAOmZY5XqQ ($202.75 in chips)
Seat 6: TAfo4veNRaRlzDXMMYS3Jg ($37 in chips)
Seat 7: 41aZuLBz9nAi2GPVKabmCw ($99.95 in chips)
Seat 8: JnV3SM2D6dAFYyGZHHpvrg ($93.25 in chips)
Seat 9: /inIs/z/PcX+TniIFpaxpg ($202.20 in chips)
CkE3IyJF1KvdaAOmZY5XqQ: posts small blind $1
TAfo4veNRaRlzDXMMYS3Jg: posts big blind $2
nXDI8Y/S6POzRwANu3d8hQ: sits out
*** HOLE CARDS ***
41aZuLBz9nAi2GPVKabmCw: folds
JnV3SM2D6dAFYyGZHHpvrg: folds
/inIs/z/PcX+TniIFpaxpg: folds
rW/MyplHylMSBRaoRUzWrg: raises $6 to $8
/gll27k+xWYV7Fbki0lFDQ: folds
GX1heJ+DSsvm7gzSPsYhhQ: folds
CkE3IyJF1KvdaAOmZY5XqQ: folds
TAfo4veNRaRlzDXMMYS3Jg: folds
rW/MyplHylMSBRaoRUzWrg collected $5 from pot
*** SUMMARY ***
Total pot $5 | Rake $0
Seat 1: rW/MyplHylMSBRaoRUzWrg collected ($5)
Seat 3: /gll27k+xWYV7Fbki0lFDQ folded before Flop (didn't bet)
Seat 4: GX1heJ+DSsvm7gzSPsYhhQ (button) folded before Flop (didn't bet)
Seat 5: CkE3IyJF1KvdaAOmZY5XqQ (small blind) folded before Flop
Seat 6: TAfo4veNRaRlzDXMMYS3Jg (big blind) folded before Flop
Seat 7: 41aZuLBz9nAi2GPVKabmCw folded before Flop (didn't bet)
Seat 8: JnV3SM2D6dAFYyGZHHpvrg folded before Flop (didn't bet)
Seat 9: /inIs/z/PcX+TniIFpaxpg folded before Flop (didn't bet)



PokerStars Game #59941483844:  Hold'em No Limit ($1/$2) - 2009/07/01 1:36:52 ET
Table 'eyAQSIlgc2o1Jxvbve4WGg' 9-max Seat #6 is the button
Seat 1: UZEsV9yKUMqmpYPiOFpaZw ($100.20 in chips)
Seat 2: kM9CA+2UcdMjbCMbtUCGiA ($200 in chips)
Seat 4: CkE3IyJF1KvdaAOmZY5XqQ ($200 in chips)
Seat 5: mIKx5lhIt13X5eZQH0ZeMA ($131.40 in chips)
Seat 6: nXDI8Y/S6POzRwANu3d8hQ ($31 in chips)
Seat 7: u3OrI5uGx9mx1fE7dgr+EA ($73.20 in chips)
Seat 8: 1CtiZuXDFaJL1dJPQKyi8Q ($155.95 in chips)
Seat 9: WUlHm+ydPPHG7Lb0rePSdA ($143.20 in chips)
u3OrI5uGx9mx1fE7dgr+EA: posts small blind $1
1CtiZuXDFaJL1dJPQKyi8Q: posts big blind $2
*** HOLE CARDS ***
WUlHm+ydPPHG7Lb0rePSdA: folds
UZEsV9yKUMqmpYPiOFpaZw: folds
kM9CA+2UcdMjbCMbtUCGiA: raises $3 to $5
CkE3IyJF1KvdaAOmZY5XqQ: folds
mIKx5lhIt13X5eZQH0ZeMA: folds
nXDI8Y/S6POzRwANu3d8hQ: folds
u3OrI5uGx9mx1fE7dgr+EA: folds
1CtiZuXDFaJL1dJPQKyi8Q: folds
kM9CA+2UcdMjbCMbtUCGiA collected $5 from pot
kM9CA+2UcdMjbCMbtUCGiA: doesn't show hand
*** SUMMARY ***
Total pot $5 | Rake $0
Seat 1: UZEsV9yKUMqmpYPiOFpaZw folded before Flop (didn't bet)
Seat 2: kM9CA+2UcdMjbCMbtUCGiA collected ($5)
Seat 4: CkE3IyJF1KvdaAOmZY5XqQ folded before Flop (didn't bet)
Seat 5: mIKx5lhIt13X5eZQH0ZeMA folded before Flop (didn't bet)
Seat 6: nXDI8Y/S6POzRwANu3d8hQ (button) folded before Flop (didn't bet)
Seat 7: u3OrI5uGx9mx1fE7dgr+EA (small blind) folded before Flop
Seat 8: 1CtiZuXDFaJL1dJPQKyi8Q (big blind) folded before Flop
Seat 9: WUlHm+ydPPHG7Lb0rePSdA folded before Flop (didn't bet)



PokerStars Game #59941484518:  Hold'em No Limit ($1/$2) - 2009/07/01 1:36:53 ET
Table 'UGLAZZyv+cXmnKjYin0etA' 6-max Seat #3 is the button
Seat 1: vkfxu8f/jMYKUk6Ly4eujw ($201 in chips)
Seat 2: eDLH1PUXFpvJBNMXBVQcGA ($279.35 in chips)
Seat 3: ygTTt5ehT4aF86q1a8/R+w ($114.20 in chips)
Seat 4: SiGJDsvRViJX05vHhA80GQ ($232.85 in chips)
Seat 5: 54yWzRRgS0oZ+S6LwZBxMQ ($35.75 in chips)
Seat 6: sTPOWERd9HWPCNrDBwsVjA ($210.10 in chips)
SiGJDsvRViJX05vHhA80GQ: posts small blind $1
54yWzRRgS0oZ+S6LwZBxMQ: posts big blind $2
*** HOLE CARDS ***
sTPOWERd9HWPCNrDBwsVjA: folds
vkfxu8f/jMYKUk6Ly4eujw: folds
eDLH1PUXFpvJBNMXBVQcGA: raises $4 to $6
ygTTt5ehT4aF86q1a8/R+w: folds
SiGJDsvRViJX05vHhA80GQ: folds
54yWzRRgS0oZ+S6LwZBxMQ: raises $12 to $18
eDLH1PUXFpvJBNMXBVQcGA: calls $12
*** FLOP *** [Jh 3s 2h]
54yWzRRgS0oZ+S6LwZBxMQ: bets $12
eDLH1PUXFpvJBNMXBVQcGA: raises $12 to $24
54yWzRRgS0oZ+S6LwZBxMQ: calls $5.75 and is all-in
*** TURN *** [Jh 3s 2h] [8s]
*** RIVER *** [Jh 3s 2h 8s] [Ts]
*** SHOW DOWN ***
54yWzRRgS0oZ+S6LwZBxMQ: shows [Qs Qh] (a pair of Queens)
eDLH1PUXFpvJBNMXBVQcGA: shows [6s As] (a flush, Ace high)
eDLH1PUXFpvJBNMXBVQcGA collected $69.50 from pot
*** SUMMARY ***
Total pot $72.50 | Rake $3
Board [Jh 3s 2h 8s Ts]
Seat 1: vkfxu8f/jMYKUk6Ly4eujw folded before Flop (didn't bet)
Seat 2: eDLH1PUXFpvJBNMXBVQcGA showed [6s As] and won ($69.50) with a flush, Ace high
Seat 3: ygTTt5ehT4aF86q1a8/R+w (button) folded before Flop (didn't bet)
Seat 4: SiGJDsvRViJX05vHhA80GQ (small blind) folded before Flop
Seat 5: 54yWzRRgS0oZ+S6LwZBxMQ (big blind) showed [Qs Qh] and lost with a pair of Queens
Seat 6: sTPOWERd9HWPCNrDBwsVjA folded before Flop (didn't bet)



PokerStars Game #59941484560:  Hold'em No Limit ($1/$2) - 2009/07/01 1:36:53 ET
Table 'P/yCfYl1GfGsu/e6DxDy/A' 2-max Seat #2 is the button
Seat 1: 7fOCUy3x9hdkmXkkDNolGQ ($490 in chips)
Seat 2: RwDoM55ZeQuI2ADyJhOb2Q ($989 in chips)
RwDoM55ZeQuI2ADyJhOb2Q: posts small blind $1
7fOCUy3x9hdkmXkkDNolGQ: posts big blind $2
*** HOLE CARDS ***
RwDoM55ZeQuI2ADyJhOb2Q: raises $4 to $6
7fOCUy3x9hdkmXkkDNolGQ: raises $14 to $20
RwDoM55ZeQuI2ADyJhOb2Q: raises $54 to $74
7fOCUy3x9hdkmXkkDNolGQ: folds
RwDoM55ZeQuI2ADyJhOb2Q collected $40 from pot
RwDoM55ZeQuI2ADyJhOb2Q: doesn't show hand
*** SUMMARY ***
Total pot $40 | Rake $0
Seat 1: 7fOCUy3x9hdkmXkkDNolGQ (big blind) folded before Flop
Seat 2: RwDoM55ZeQuI2ADyJhOb2Q (button) (small blind) collected ($40)



PokerStars Game #59941485762:  Hold'em No Limit ($1/$2) - 2009/07/01 1:36:55 ET
Table '/dyk+YdRGv90j2box35j8w' 6-max Seat #1 is the button
Seat 1: 8srN1dKQePlsv0GyTada+Q ($209.25 in chips)
Seat 2: qCnEYuAE5y5A7bk6fO5/jQ ($468.60 in chips)
Seat 3: sTPOWERd9HWPCNrDBwsVjA ($185.50 in chips)
Seat 4: z/u1YTnkiIDrtp/2cA2dBg ($165.85 in chips)
Seat 5: VvdR9F3I+2yELkfTVvC1dg ($243 in chips)
Seat 6: gnYme0DNFflnMhrdbxe1Ag ($204 in chips)
qCnEYuAE5y5A7bk6fO5/jQ: posts small blind $1
sTPOWERd9HWPCNrDBwsVjA: posts big blind $2
*** HOLE CARDS ***
z/u1YTnkiIDrtp/2cA2dBg has timed out
z/u1YTnkiIDrtp/2cA2dBg: folds
z/u1YTnkiIDrtp/2cA2dBg is sitting out
VvdR9F3I+2yELkfTVvC1dg: folds
gnYme0DNFflnMhrdbxe1Ag: folds
8srN1dKQePlsv0GyTada+Q: raises $3 to $5
qCnEYuAE5y5A7bk6fO5/jQ: folds
sTPOWERd9HWPCNrDBwsVjA: folds
8srN1dKQePlsv0GyTada+Q collected $5 from pot
8srN1dKQePlsv0GyTada+Q: doesn't show hand
*** SUMMARY ***
Total pot $5 | Rake $0
Seat 1: 8srN1dKQePlsv0GyTada+Q (button) collected ($5)
Seat 2: qCnEYuAE5y5A7bk6fO5/jQ (small blind) folded before Flop
Seat 3: sTPOWERd9HWPCNrDBwsVjA (big blind) folded before Flop
Seat 4: z/u1YTnkiIDrtp/2cA2dBg folded before Flop (didn't bet)
Seat 5: VvdR9F3I+2yELkfTVvC1dg folded before Flop (didn't bet)
Seat 6: gnYme0DNFflnMhrdbxe1Ag folded before Flop (didn't bet)



PokerStars Game #59941486484:  Hold'em No Limit ($1/$2) - 2009/07/01 1:36:57 ET
Table 'NmY84NAf9Mh0ckAckHnh5g' 2-max Seat #1 is the button
Seat 1: 6hvg964TSqZ3AL/0XK9aVQ ($449 in chips)
Seat 2: RwDoM55ZeQuI2ADyJhOb2Q ($546.50 in chips)
6hvg964TSqZ3AL/0XK9aVQ: posts small blind $1
RwDoM55ZeQuI2ADyJhOb2Q: posts big blind $2
*** HOLE CARDS ***
6hvg964TSqZ3AL/0XK9aVQ: calls $1
RwDoM55ZeQuI2ADyJhOb2Q: checks
*** FLOP *** [9s 4h 9d]
RwDoM55ZeQuI2ADyJhOb2Q: checks
6hvg964TSqZ3AL/0XK9aVQ: checks
*** TURN *** [9s 4h 9d] [9c]
RwDoM55ZeQuI2ADyJhOb2Q: bets $4
6hvg964TSqZ3AL/0XK9aVQ: calls $4
*** RIVER *** [9s 4h 9d 9c] [2s]
RwDoM55ZeQuI2ADyJhOb2Q: bets $8
6hvg964TSqZ3AL/0XK9aVQ: folds
RwDoM55ZeQuI2ADyJhOb2Q collected $11.50 from pot
RwDoM55ZeQuI2ADyJhOb2Q: doesn't show hand
*** SUMMARY ***
Total pot $12 | Rake $0.50
Board [9s 4h 9d 9c 2s]
Seat 1: 6hvg964TSqZ3AL/0XK9aVQ (button) (small blind) folded on the River
Seat 2: RwDoM55ZeQuI2ADyJhOb2Q (big blind) collected ($11.50)



PokerStars Game #59941486968:  Hold'em No Limit ($1/$2) - 2009/07/01 1:36:58 ET
Table 'CFkQcfWjKccZaZDf71FK+w' 6-max Seat #4 is the button
Seat 1: vkfxu8f/jMYKUk6Ly4eujw ($197 in chips)
Seat 2: ewN/vzF22+/gdzjIKBOlkA ($216.05 in chips)
Seat 3: 09BNF4quPDzanQzM8vc6WA ($43.65 in chips)
Seat 4: ygTTt5ehT4aF86q1a8/R+w ($246.35 in chips)
Seat 5: 2lOU1DcvUZaMcxZ95XfzXw ($135.60 in chips)
Seat 6: ORVqY3rf9X6ANA/8s+On2Q ($126.60 in chips)
2lOU1DcvUZaMcxZ95XfzXw: posts small blind $1
ORVqY3rf9X6ANA/8s+On2Q: posts big blind $2
*** HOLE CARDS ***
vkfxu8f/jMYKUk6Ly4eujw: raises $6 to $8
ewN/vzF22+/gdzjIKBOlkA: folds
09BNF4quPDzanQzM8vc6WA: folds
ygTTt5ehT4aF86q1a8/R+w: folds
2lOU1DcvUZaMcxZ95XfzXw: calls $7
ORVqY3rf9X6ANA/8s+On2Q: calls $6
*** FLOP *** [Kh Th Kd]
2lOU1DcvUZaMcxZ95XfzXw: checks
ORVqY3rf9X6ANA/8s+On2Q: checks
vkfxu8f/jMYKUk6Ly4eujw: bets $15
2lOU1DcvUZaMcxZ95XfzXw: calls $15
ORVqY3rf9X6ANA/8s+On2Q: folds
*** TURN *** [Kh Th Kd] [Jd]
2lOU1DcvUZaMcxZ95XfzXw: checks
vkfxu8f/jMYKUk6Ly4eujw: checks
*** RIVER *** [Kh Th Kd Jd] [3c]
2lOU1DcvUZaMcxZ95XfzXw: checks
vkfxu8f/jMYKUk6Ly4eujw: checks
*** SHOW DOWN ***
2lOU1DcvUZaMcxZ95XfzXw: shows [6c 6h] (two pair, Kings and Sixes)
vkfxu8f/jMYKUk6Ly4eujw: shows [Qs Qh] (two pair, Kings and Queens)
vkfxu8f/jMYKUk6Ly4eujw collected $51.40 from pot
*** SUMMARY ***
Total pot $54 | Rake $2.60
Board [Kh Th Kd Jd 3c]
Seat 1: vkfxu8f/jMYKUk6Ly4eujw showed [Qs Qh] and won ($51.40) with two pair, Kings and Queens
Seat 2: ewN/vzF22+/gdzjIKBOlkA folded before Flop (didn't bet)
Seat 3: 09BNF4quPDzanQzM8vc6WA folded before Flop (didn't bet)
Seat 4: ygTTt5ehT4aF86q1a8/R+w (button) folded before Flop (didn't bet)
Seat 5: 2lOU1DcvUZaMcxZ95XfzXw (small blind) showed [6c 6h] and lost with two pair, Kings and Sixes
Seat 6: ORVqY3rf9X6ANA/8s+On2Q (big blind) folded on the Flop



PokerStars Game #59941489186:  Hold'em No Limit ($1/$2) - 2009/07/01 1:37:02 ET
Table 'W9UeSV0aoPjh5SFSxM8jUQ' 9-max Seat #5 is the button
Seat 1: mIKx5lhIt13X5eZQH0ZeMA ($34.85 in chips)
Seat 3: /inIs/z/PcX+TniIFpaxpg ($22 in chips)
Seat 4: 4YA/sQy1Emm680zhbPUjow ($156.60 in chips)
Seat 5: ri8CLkX3e9JF34dQNbsHGA ($40 in chips)
Seat 7: I2ipWauytvrkEer4XD3Sjg ($73.70 in chips)
Seat 8: odhvI/CZeMsPyo1n1U7+hA ($22.40 in chips)
Seat 9: Q104K4iDGcqOlVrjAkzPEA ($104 in chips)
I2ipWauytvrkEer4XD3Sjg: posts small blind $1
odhvI/CZeMsPyo1n1U7+hA: posts big blind $2
KqHysDSpCPaPyK3tJC1aEw: sits out
*** HOLE CARDS ***
Q104K4iDGcqOlVrjAkzPEA: calls $2
mIKx5lhIt13X5eZQH0ZeMA: folds
254YPxPJr5Sw58bkD0YqYQ joins the table at seat #6
/inIs/z/PcX+TniIFpaxpg: folds
4YA/sQy1Emm680zhbPUjow: folds
ri8CLkX3e9JF34dQNbsHGA: calls $2
I2ipWauytvrkEer4XD3Sjg: folds
odhvI/CZeMsPyo1n1U7+hA: checks
*** FLOP *** [Qc 2s 9h]
odhvI/CZeMsPyo1n1U7+hA: bets $4
Q104K4iDGcqOlVrjAkzPEA: folds
ri8CLkX3e9JF34dQNbsHGA: folds
odhvI/CZeMsPyo1n1U7+hA collected $6.65 from pot
*** SUMMARY ***
Total pot $7 | Rake $0.35
Board [Qc 2s 9h]
Seat 1: mIKx5lhIt13X5eZQH0ZeMA folded before Flop (didn't bet)
Seat 3: /inIs/z/PcX+TniIFpaxpg folded before Flop (didn't bet)
Seat 4: 4YA/sQy1Emm680zhbPUjow folded before Flop (didn't bet)
Seat 5: ri8CLkX3e9JF34dQNbsHGA (button) folded on the Flop
Seat 7: I2ipWauytvrkEer4XD3Sjg (small blind) folded before Flop
Seat 8: odhvI/CZeMsPyo1n1U7+hA (big blind) collected ($6.65)
Seat 9: Q104K4iDGcqOlVrjAkzPEA folded on the Flop



PokerStars Game #59941490180:  Hold'em No Limit ($1/$2) - 2009/07/01 1:37:03 ET
Table 'rKeCh+eBn4RNvybCUYkoTQ' 9-max Seat #6 is the button
Seat 1: /inIs/z/PcX+TniIFpaxpg ($198 in chips)
Seat 2: 9cBHwK40Tl06vheE7B3LHQ ($98.80 in chips)
Seat 3: GX1heJ+DSsvm7gzSPsYhhQ ($49 in chips)
Seat 5: WUlHm+ydPPHG7Lb0rePSdA ($122 in chips)
Seat 6: EBV6OktyeSmh4w6sWmcWOw ($286.80 in chips)
Seat 7: rW/MyplHylMSBRaoRUzWrg ($29 in chips)
Seat 8: pN/Ip0ePsUVIdUlGgLrkUw ($246.35 in chips)
Seat 9: Kzta8yu9vxHT4B70mjBZ+w ($214.25 in chips)
rW/MyplHylMSBRaoRUzWrg: posts small blind $1
pN/Ip0ePsUVIdUlGgLrkUw: posts big blind $2
*** HOLE CARDS ***
Kzta8yu9vxHT4B70mjBZ+w: folds
/inIs/z/PcX+TniIFpaxpg: folds
9cBHwK40Tl06vheE7B3LHQ: folds
9cBHwK40Tl06vheE7B3LHQ leaves the table
GX1heJ+DSsvm7gzSPsYhhQ: folds
WUlHm+ydPPHG7Lb0rePSdA: folds
EBV6OktyeSmh4w6sWmcWOw: folds
rW/MyplHylMSBRaoRUzWrg: folds
31HuO+DQxppUQEedBWukug is connected
pN/Ip0ePsUVIdUlGgLrkUw collected $2 from pot
pN/Ip0ePsUVIdUlGgLrkUw: doesn't show hand
*** SUMMARY ***
Total pot $2 | Rake $0
Seat 1: /inIs/z/PcX+TniIFpaxpg folded before Flop (didn't bet)
Seat 2: 9cBHwK40Tl06vheE7B3LHQ folded before Flop (didn't bet)
Seat 3: GX1heJ+DSsvm7gzSPsYhhQ folded before Flop (didn't bet)
Seat 5: WUlHm+ydPPHG7Lb0rePSdA folded before Flop (didn't bet)
Seat 6: EBV6OktyeSmh4w6sWmcWOw (button) folded before Flop (didn't bet)
Seat 7: rW/MyplHylMSBRaoRUzWrg (small blind) folded before Flop
Seat 8: pN/Ip0ePsUVIdUlGgLrkUw (big blind) collected ($2)
Seat 9: Kzta8yu9vxHT4B70mjBZ+w folded before Flop (didn't bet)



PokerStars Game #59941490132:  Hold'em No Limit ($1/$2) - 2009/07/01 1:37:03 ET
Table 'uJ9juaXXg9yIcSU8amxaXQ' 6-max Seat #2 is the button
Seat 1: JsqOjN/eHz0uYVf/PyUJ6Q ($155.25 in chips)
Seat 2: VvdR9F3I+2yELkfTVvC1dg ($223.10 in chips)
Seat 3: qXDd0ZyMIse0OBu8pxeQ3Q ($244.40 in chips)
Seat 4: zNjJ/y4emmF+vzrCDd+ooA ($223.05 in chips)
Seat 5: YsLQ3BAvgQHWXMAv3Wv6Hg ($203 in chips)
qXDd0ZyMIse0OBu8pxeQ3Q: posts small blind $1
zNjJ/y4emmF+vzrCDd+ooA: posts big blind $2
/PH6Ffnho4Ysm8S3V/oa+w: sits out
*** HOLE CARDS ***
YsLQ3BAvgQHWXMAv3Wv6Hg: folds
JsqOjN/eHz0uYVf/PyUJ6Q: folds
VvdR9F3I+2yELkfTVvC1dg: folds
qXDd0ZyMIse0OBu8pxeQ3Q: folds
zNjJ/y4emmF+vzrCDd+ooA collected $2 from pot
*** SUMMARY ***
Total pot $2 | Rake $0
Seat 1: JsqOjN/eHz0uYVf/PyUJ6Q folded before Flop (didn't bet)
Seat 2: VvdR9F3I+2yELkfTVvC1dg (button) folded before Flop (didn't bet)
Seat 3: qXDd0ZyMIse0OBu8pxeQ3Q (small blind) folded before Flop
Seat 4: zNjJ/y4emmF+vzrCDd+ooA (big blind) collected ($2)
Seat 5: YsLQ3BAvgQHWXMAv3Wv6Hg folded before Flop (didn't bet)



PokerStars Game #59941490844:  Hold'em No Limit ($1/$2) - 2009/07/01 1:37:04 ET
Table 'on4i1U1lCRmxsduFD3xiSg' 9-max Seat #2 is the button
Seat 1: so5k3vFDmokh2q3dImJ1GQ ($176.30 in chips)
Seat 2: NqSvZNzJ4RkR3sCmgQnyLw ($44.85 in chips)
Seat 3: GX1heJ+DSsvm7gzSPsYhhQ ($40 in chips)
Seat 4: DFQVuszLVclqjA46pN4Vvw ($85.50 in chips)
Seat 6: +T/63sAeZzWyHchahJ36GQ ($74 in chips)
Seat 7: /inIs/z/PcX+TniIFpaxpg ($271.05 in chips)
Seat 8: ZYHoLw2lWmRS7CSHi8L8Xg ($200 in chips)
Seat 9: TAfo4veNRaRlzDXMMYS3Jg ($37 in chips)
GX1heJ+DSsvm7gzSPsYhhQ: posts small blind $1
DFQVuszLVclqjA46pN4Vvw: posts big blind $2
*** HOLE CARDS ***
+T/63sAeZzWyHchahJ36GQ: folds
/inIs/z/PcX+TniIFpaxpg: folds
ZYHoLw2lWmRS7CSHi8L8Xg: folds
TAfo4veNRaRlzDXMMYS3Jg: folds
so5k3vFDmokh2q3dImJ1GQ: folds
NqSvZNzJ4RkR3sCmgQnyLw: folds
GX1heJ+DSsvm7gzSPsYhhQ: folds
DFQVuszLVclqjA46pN4Vvw collected $2 from pot
*** SUMMARY ***
Total pot $2 | Rake $0
Seat 1: so5k3vFDmokh2q3dImJ1GQ folded before Flop (didn't bet)
Seat 2: NqSvZNzJ4RkR3sCmgQnyLw (button) folded before Flop (didn't bet)
Seat 3: GX1heJ+DSsvm7gzSPsYhhQ (small blind) folded before Flop
Seat 4: DFQVuszLVclqjA46pN4Vvw (big blind) collected ($2)
Seat 6: +T/63sAeZzWyHchahJ36GQ folded before Flop (didn't bet)
Seat 7: /inIs/z/PcX+TniIFpaxpg folded before Flop (didn't bet)
Seat 8: ZYHoLw2lWmRS7CSHi8L8Xg folded before Flop (didn't bet)
Seat 9: TAfo4veNRaRlzDXMMYS3Jg folded before Flop (didn't bet)



PokerStars Game #59941491952:  Hold'em No Limit ($1/$2) - 2009/07/01 1:37:06 ET
Table 'SF49/KQm8T4taMp6kb+HXA' 9-max Seat #1 is the button
Seat 1: CUZwDpLTQKhzarPe+JCLOQ ($303.15 in chips)
Seat 2: rW/MyplHylMSBRaoRUzWrg ($41 in chips)
Seat 3: pCmk6FpSOLJ+85o1tLHIag ($280.75 in chips)
Seat 4: HffgoYm61KgkdMe/DYChIQ ($268.25 in chips)
Seat 5: ri8CLkX3e9JF34dQNbsHGA ($40 in chips)
Seat 7: nXDI8Y/S6POzRwANu3d8hQ ($37 in chips)
Seat 8: GgrYze3jkUdSO7a7CuJGDw ($194 in chips)
Seat 9: /inIs/z/PcX+TniIFpaxpg ($317.15 in chips)
rW/MyplHylMSBRaoRUzWrg: posts small blind $1
pCmk6FpSOLJ+85o1tLHIag: posts big blind $2
*** HOLE CARDS ***
HffgoYm61KgkdMe/DYChIQ: folds
ri8CLkX3e9JF34dQNbsHGA: raises $2 to $4
31HuO+DQxppUQEedBWukug is connected
nXDI8Y/S6POzRwANu3d8hQ: folds
GgrYze3jkUdSO7a7CuJGDw: folds
/inIs/z/PcX+TniIFpaxpg: folds
CUZwDpLTQKhzarPe+JCLOQ: folds
rW/MyplHylMSBRaoRUzWrg: folds
pCmk6FpSOLJ+85o1tLHIag: folds
ri8CLkX3e9JF34dQNbsHGA collected $5 from pot
*** SUMMARY ***
Total pot $5 | Rake $0
Seat 1: CUZwDpLTQKhzarPe+JCLOQ (button) folded before Flop (didn't bet)
Seat 2: rW/MyplHylMSBRaoRUzWrg (small blind) folded before Flop
Seat 3: pCmk6FpSOLJ+85o1tLHIag (big blind) folded before Flop
Seat 4: HffgoYm61KgkdMe/DYChIQ folded before Flop (didn't bet)
Seat 5: ri8CLkX3e9JF34dQNbsHGA collected ($5)
Seat 7: nXDI8Y/S6POzRwANu3d8hQ folded before Flop (didn't bet)
Seat 8: GgrYze3jkUdSO7a7CuJGDw folded before Flop (didn't bet)
Seat 9: /inIs/z/PcX+TniIFpaxpg folded before Flop (didn't bet)



PokerStars Game #59941491880:  Hold'em No Limit ($1/$2) - 2009/07/01 1:37:06 ET
Table 'TsEDkiO4tzCTCzJ7tNdEqw' 6-max Seat #2 is the button
Seat 1: MfXQsYD8pGeCS7XOtyV+vw ($58.05 in chips)
Seat 2: 4dcDwIHRm96PwtqkpQiuiA ($89.65 in chips)
Seat 3: ubtx4Z5L+AcK71MTvYiGVw ($233 in chips)
Seat 4: K8MXCrNAVYlMnnCeM32Kxw ($99.50 in chips)
Seat 5: VvdR9F3I+2yELkfTVvC1dg ($247.35 in chips)
Seat 6: uCqEjnxh2/vFBjKYkfTOkw ($166.70 in chips)
ubtx4Z5L+AcK71MTvYiGVw: posts small blind $1
K8MXCrNAVYlMnnCeM32Kxw: posts big blind $2
*** HOLE CARDS ***
VvdR9F3I+2yELkfTVvC1dg: folds
uCqEjnxh2/vFBjKYkfTOkw: folds
MfXQsYD8pGeCS7XOtyV+vw: calls $2
4dcDwIHRm96PwtqkpQiuiA: folds
ubtx4Z5L+AcK71MTvYiGVw: raises $8 to $10
K8MXCrNAVYlMnnCeM32Kxw: folds
MfXQsYD8pGeCS7XOtyV+vw: calls $8
*** FLOP *** [Jc Qd As]
ubtx4Z5L+AcK71MTvYiGVw: checks
MfXQsYD8pGeCS7XOtyV+vw: checks
*** TURN *** [Jc Qd As] [Ks]
ubtx4Z5L+AcK71MTvYiGVw: checks
MfXQsYD8pGeCS7XOtyV+vw: bets $6
ubtx4Z5L+AcK71MTvYiGVw: calls $6
*** RIVER *** [Jc Qd As Ks] [Jd]
ubtx4Z5L+AcK71MTvYiGVw: checks
MfXQsYD8pGeCS7XOtyV+vw: bets $27
ubtx4Z5L+AcK71MTvYiGVw: raises $27 to $54
MfXQsYD8pGeCS7XOtyV+vw: calls $15.05 and is all-in
*** SHOW DOWN ***
ubtx4Z5L+AcK71MTvYiGVw: shows [Kd Kc] (a full house, Kings full of Jacks)
MfXQsYD8pGeCS7XOtyV+vw: mucks hand
ubtx4Z5L+AcK71MTvYiGVw collected $115.10 from pot
*** SUMMARY ***
Total pot $118.10 | Rake $3
Board [Jc Qd As Ks Jd]
Seat 1: MfXQsYD8pGeCS7XOtyV+vw mucked
Seat 2: 4dcDwIHRm96PwtqkpQiuiA (button) folded before Flop (didn't bet)
Seat 3: ubtx4Z5L+AcK71MTvYiGVw (small blind) showed [Kd Kc] and won ($115.10) with a full house, Kings full of Jacks
Seat 4: K8MXCrNAVYlMnnCeM32Kxw (big blind) folded before Flop
Seat 5: VvdR9F3I+2yELkfTVvC1dg folded before Flop (didn't bet)
Seat 6: uCqEjnxh2/vFBjKYkfTOkw folded before Flop (didn't bet)



PokerStars Game #59941492394:  Hold'em No Limit ($1/$2) - 2009/07/01 1:37:07 ET
Table 'aSf77Sj8QEnzcc0WaxVD4Q' 6-max Seat #6 is the button
Seat 1: UELtvp+JfwI7XDGVwSxZXA ($263.10 in chips)
Seat 2: vkfxu8f/jMYKUk6Ly4eujw ($208.80 in chips)
Seat 3: 9dpyyjDTCed6nV7JhaUUpw ($521.10 in chips)
Seat 4: YsLQ3BAvgQHWXMAv3Wv6Hg ($200 in chips)
Seat 5: VvdR9F3I+2yELkfTVvC1dg ($258 in chips)
Seat 6: vkoJRf3gidxY1pPi0AFWww ($132.10 in chips)
UELtvp+JfwI7XDGVwSxZXA: posts small blind $1
vkfxu8f/jMYKUk6Ly4eujw: posts big blind $2
*** HOLE CARDS ***
9dpyyjDTCed6nV7JhaUUpw: folds
YsLQ3BAvgQHWXMAv3Wv6Hg: raises $4 to $6
VvdR9F3I+2yELkfTVvC1dg: folds
vkoJRf3gidxY1pPi0AFWww: folds
UELtvp+JfwI7XDGVwSxZXA: calls $5
vkfxu8f/jMYKUk6Ly4eujw: calls $4
*** FLOP *** [8c Ts Qs]
UELtvp+JfwI7XDGVwSxZXA: checks
vkfxu8f/jMYKUk6Ly4eujw: bets $17
YsLQ3BAvgQHWXMAv3Wv6Hg: calls $17
UELtvp+JfwI7XDGVwSxZXA: folds
*** TURN *** [8c Ts Qs] [9d]
vkfxu8f/jMYKUk6Ly4eujw: bets $49
YsLQ3BAvgQHWXMAv3Wv6Hg: raises $128 to $177 and is all-in
vkfxu8f/jMYKUk6Ly4eujw: calls $128
*** RIVER *** [8c Ts Qs 9d] [6h]
*** SHOW DOWN ***
vkfxu8f/jMYKUk6Ly4eujw: shows [Kh Jd] (a straight, Nine to King)
YsLQ3BAvgQHWXMAv3Wv6Hg: shows [Kc Jh] (a straight, Nine to King)
vkfxu8f/jMYKUk6Ly4eujw collected $201.50 from pot
YsLQ3BAvgQHWXMAv3Wv6Hg collected $201.50 from pot
*** SUMMARY ***
Total pot $406 | Rake $3
Board [8c Ts Qs 9d 6h]
Seat 1: UELtvp+JfwI7XDGVwSxZXA (small blind) folded on the Flop
Seat 2: vkfxu8f/jMYKUk6Ly4eujw (big blind) showed [Kh Jd] and won ($201.50) with a straight, Nine to King
Seat 3: 9dpyyjDTCed6nV7JhaUUpw folded before Flop (didn't bet)
Seat 4: YsLQ3BAvgQHWXMAv3Wv6Hg showed [Kc Jh] and won ($201.50) with a straight, Nine to King
Seat 5: VvdR9F3I+2yELkfTVvC1dg folded before Flop (didn't bet)
Seat 6: vkoJRf3gidxY1pPi0AFWww (button) folded before Flop (didn't bet)



PokerStars Game #59941492756:  Hold'em No Limit ($1/$2) - 2009/07/01 1:37:08 ET
Table 'gftD4mDF7mIFKvSrIyaRbw' 9-max Seat #3 is the button
Seat 2: GX1heJ+DSsvm7gzSPsYhhQ ($33 in chips)
Seat 3: CUZwDpLTQKhzarPe+JCLOQ ($222.65 in chips)
Seat 4: /inIs/z/PcX+TniIFpaxpg ($38 in chips)
Seat 5: mpsfNtnMVDqQHTe92AhIdw ($97.10 in chips)
Seat 6: 2NvwF8W2nzsbS+G//yLAbQ ($118.20 in chips)
Seat 7: +T/63sAeZzWyHchahJ36GQ ($46 in chips)
Seat 8: MpL4DeEqGQu0H8TJEbEOrg ($38 in chips)
/inIs/z/PcX+TniIFpaxpg: posts small blind $1
mpsfNtnMVDqQHTe92AhIdw: posts big blind $2
*** HOLE CARDS ***
2NvwF8W2nzsbS+G//yLAbQ: folds
F7m34OOfAQ7annesMHVjKw has returned
+T/63sAeZzWyHchahJ36GQ: raises $4 to $6
MpL4DeEqGQu0H8TJEbEOrg: folds
F7m34OOfAQ7annesMHVjKw leaves the table
GX1heJ+DSsvm7gzSPsYhhQ: calls $6
CUZwDpLTQKhzarPe+JCLOQ: folds
KqHysDSpCPaPyK3tJC1aEw joins the table at seat #9
/inIs/z/PcX+TniIFpaxpg: folds
mpsfNtnMVDqQHTe92AhIdw: folds
*** FLOP *** [Ks 7c Ts]
+T/63sAeZzWyHchahJ36GQ: bets $8
31HuO+DQxppUQEedBWukug is connected
GX1heJ+DSsvm7gzSPsYhhQ: folds
+T/63sAeZzWyHchahJ36GQ collected $14.25 from pot
+T/63sAeZzWyHchahJ36GQ: doesn't show hand
*** SUMMARY ***
Total pot $15 | Rake $0.75
Board [Ks 7c Ts]
Seat 2: GX1heJ+DSsvm7gzSPsYhhQ folded on the Flop
Seat 3: CUZwDpLTQKhzarPe+JCLOQ (button) folded before Flop (didn't bet)
Seat 4: /inIs/z/PcX+TniIFpaxpg (small blind) folded before Flop
Seat 5: mpsfNtnMVDqQHTe92AhIdw (big blind) folded before Flop
Seat 6: 2NvwF8W2nzsbS+G//yLAbQ folded before Flop (didn't bet)
Seat 7: +T/63sAeZzWyHchahJ36GQ collected ($14.25)
Seat 8: MpL4DeEqGQu0H8TJEbEOrg folded before Flop (didn't bet)



PokerStars Game #59941493644:  Hold'em No Limit ($1/$2) - 2009/07/01 1:37:09 ET
Table 'kq5zaQ+1hLNf8LZfGnbTAA' 6-max Seat #2 is the button
Seat 1: 8srN1dKQePlsv0GyTada+Q ($427.60 in chips)
Seat 2: nXDI8Y/S6POzRwANu3d8hQ ($144 in chips)
Seat 3: /PH6Ffnho4Ysm8S3V/oa+w ($41 in chips)
Seat 4: 3dAbvkxS5NPQTBAbvpinVg ($278.45 in chips)
Seat 5: gnYme0DNFflnMhrdbxe1Ag ($226.35 in chips)
Seat 6: mfy7uGZcqA2PVQqEVbJ7+g ($196.45 in chips)
/PH6Ffnho4Ysm8S3V/oa+w: posts small blind $1
3dAbvkxS5NPQTBAbvpinVg: posts big blind $2
*** HOLE CARDS ***
gnYme0DNFflnMhrdbxe1Ag: folds
mfy7uGZcqA2PVQqEVbJ7+g: folds
8srN1dKQePlsv0GyTada+Q: raises $4 to $6
nXDI8Y/S6POzRwANu3d8hQ: folds
/PH6Ffnho4Ysm8S3V/oa+w: folds
3dAbvkxS5NPQTBAbvpinVg: folds
8srN1dKQePlsv0GyTada+Q collected $5 from pot
8srN1dKQePlsv0GyTada+Q: doesn't show hand
*** SUMMARY ***
Total pot $5 | Rake $0
Seat 1: 8srN1dKQePlsv0GyTada+Q collected ($5)
Seat 2: nXDI8Y/S6POzRwANu3d8hQ (button) folded before Flop (didn't bet)
Seat 3: /PH6Ffnho4Ysm8S3V/oa+w (small blind) folded before Flop
Seat 4: 3dAbvkxS5NPQTBAbvpinVg (big blind) folded before Flop
Seat 5: gnYme0DNFflnMhrdbxe1Ag folded before Flop (didn't bet)
Seat 6: mfy7uGZcqA2PVQqEVbJ7+g folded before Flop (didn't bet)



PokerStars Game #59941493322:  Hold'em No Limit ($1/$2) - 2009/07/01 1:37:09 ET
Table '/ci73fTmzTzmGWzAtqEX2Q' 9-max Seat #1 is the button
Seat 1: 9efVc1cB3yHt4TvBkTusPw ($153.90 in chips)
Seat 2: pN/Ip0ePsUVIdUlGgLrkUw ($223 in chips)
Seat 3: kK1+5ivyJZeA8hQF2pdvvQ ($64.55 in chips)
Seat 4: 2yq7Zp4xmrhAw8+37hTkaA ($169.20 in chips)
Seat 5: 1CtiZuXDFaJL1dJPQKyi8Q ($170.35 in chips)
Seat 6: GX1heJ+DSsvm7gzSPsYhhQ ($89.30 in chips)
Seat 8: /inIs/z/PcX+TniIFpaxpg ($34 in chips)
Seat 9: S8aS+9FTYQ/ICLBNThcrkg ($179 in chips)
pN/Ip0ePsUVIdUlGgLrkUw: posts small blind $1
kK1+5ivyJZeA8hQF2pdvvQ: posts big blind $2
+T/63sAeZzWyHchahJ36GQ: sits out
*** HOLE CARDS ***
2yq7Zp4xmrhAw8+37hTkaA: folds
1CtiZuXDFaJL1dJPQKyi8Q: raises $4 to $6
GX1heJ+DSsvm7gzSPsYhhQ: folds
/inIs/z/PcX+TniIFpaxpg: folds
S8aS+9FTYQ/ICLBNThcrkg: folds
9efVc1cB3yHt4TvBkTusPw: calls $6
pN/Ip0ePsUVIdUlGgLrkUw: folds
kK1+5ivyJZeA8hQF2pdvvQ: folds
*** FLOP *** [5h 9d 5c]
1CtiZuXDFaJL1dJPQKyi8Q: bets $8
9efVc1cB3yHt4TvBkTusPw: folds
1CtiZuXDFaJL1dJPQKyi8Q collected $14.25 from pot
1CtiZuXDFaJL1dJPQKyi8Q: doesn't show hand
*** SUMMARY ***
Total pot $15 | Rake $0.75
Board [5h 9d 5c]
Seat 1: 9efVc1cB3yHt4TvBkTusPw (button) folded on the Flop
Seat 2: pN/Ip0ePsUVIdUlGgLrkUw (small blind) folded before Flop
Seat 3: kK1+5ivyJZeA8hQF2pdvvQ (big blind) folded before Flop
Seat 4: 2yq7Zp4xmrhAw8+37hTkaA folded before Flop (didn't bet)
Seat 5: 1CtiZuXDFaJL1dJPQKyi8Q collected ($14.25)
Seat 6: GX1heJ+DSsvm7gzSPsYhhQ folded before Flop (didn't bet)
Seat 8: /inIs/z/PcX+TniIFpaxpg folded before Flop (didn't bet)
Seat 9: S8aS+9FTYQ/ICLBNThcrkg folded before Flop (didn't bet)



PokerStars Game #59941493590:  Hold'em No Limit ($1/$2) - 2009/07/01 1:37:09 ET
Table '8Y6PEyoNuepZTai2Q56aHw' 9-max Seat #9 is the button
Seat 1: 5Q8U6iZbeO7xJSS4qvDP5g ($309.80 in chips)
Seat 2: gDCJIAlovbPnTvMM7Dd1gA ($195.55 in chips)
Seat 3: WUlHm+ydPPHG7Lb0rePSdA ($214.10 in chips)
Seat 4: xKkwALG38OfLQ9DXuJgR1w ($215.25 in chips)
Seat 5: /inIs/z/PcX+TniIFpaxpg ($40 in chips)
Seat 6: NtLDBSjsJQEKekh5cdinvw ($373.35 in chips)
Seat 7: Kzta8yu9vxHT4B70mjBZ+w ($200 in chips)
Seat 9: F7m34OOfAQ7annesMHVjKw ($190 in chips)
5Q8U6iZbeO7xJSS4qvDP5g: posts small blind $1
gDCJIAlovbPnTvMM7Dd1gA: posts big blind $2
+T/63sAeZzWyHchahJ36GQ: sits out
*** HOLE CARDS ***
WUlHm+ydPPHG7Lb0rePSdA: folds
xKkwALG38OfLQ9DXuJgR1w: folds
/inIs/z/PcX+TniIFpaxpg: folds
NtLDBSjsJQEKekh5cdinvw: folds
Kzta8yu9vxHT4B70mjBZ+w: folds
F7m34OOfAQ7annesMHVjKw: raises $2 to $4
5Q8U6iZbeO7xJSS4qvDP5g: folds
gDCJIAlovbPnTvMM7Dd1gA: calls $2
*** FLOP *** [7d Th Td]
gDCJIAlovbPnTvMM7Dd1gA: checks
F7m34OOfAQ7annesMHVjKw has timed out
F7m34OOfAQ7annesMHVjKw: checks
*** TURN *** [7d Th Td] [3s]
gDCJIAlovbPnTvMM7Dd1gA: bets $2
F7m34OOfAQ7annesMHVjKw: calls $2
*** RIVER *** [7d Th Td 3s] [Kh]
gDCJIAlovbPnTvMM7Dd1gA: checks
F7m34OOfAQ7annesMHVjKw: checks
*** SHOW DOWN ***
gDCJIAlovbPnTvMM7Dd1gA: shows [4h 5d] (a pair of Tens)
F7m34OOfAQ7annesMHVjKw: shows [8c Qs] (a pair of Tens - King+Queen kicker)
F7m34OOfAQ7annesMHVjKw collected $12.40 from pot
*** SUMMARY ***
Total pot $13 | Rake $0.60
Board [7d Th Td 3s Kh]
Seat 1: 5Q8U6iZbeO7xJSS4qvDP5g (small blind) folded before Flop
Seat 2: gDCJIAlovbPnTvMM7Dd1gA (big blind) showed [4h 5d] and lost with a pair of Tens
Seat 3: WUlHm+ydPPHG7Lb0rePSdA folded before Flop (didn't bet)
Seat 4: xKkwALG38OfLQ9DXuJgR1w folded before Flop (didn't bet)
Seat 5: /inIs/z/PcX+TniIFpaxpg folded before Flop (didn't bet)
Seat 6: NtLDBSjsJQEKekh5cdinvw folded before Flop (didn't bet)
Seat 7: Kzta8yu9vxHT4B70mjBZ+w folded before Flop (didn't bet)
Seat 9: F7m34OOfAQ7annesMHVjKw (button) showed [8c Qs] and won ($12.40) with a pair of Tens



PokerStars Game #59941495822:  Hold'em No Limit ($1/$2) - 2009/07/01 1:37:13 ET
Table 'G1Oqdy4Pqdb5gtx40rUBzA' 6-max Seat #5 is the button
Seat 2: 4uqU0dG67owXuPz303Al4w ($521.60 in chips)
Seat 3: VvdR9F3I+2yELkfTVvC1dg ($234.90 in chips)
Seat 4: B87ikIyZ/TzAVeXf38Ny0g ($211.55 in chips)
Seat 5: F1+Ml47qRQWunzPnGhLLzQ ($195.30 in chips)
Seat 6: qCnEYuAE5y5A7bk6fO5/jQ ($200 in chips)
qCnEYuAE5y5A7bk6fO5/jQ: posts small blind $1
4uqU0dG67owXuPz303Al4w: posts big blind $2
*** HOLE CARDS ***
VvdR9F3I+2yELkfTVvC1dg: raises $2 to $4
B87ikIyZ/TzAVeXf38Ny0g: folds
F1+Ml47qRQWunzPnGhLLzQ: calls $4
qCnEYuAE5y5A7bk6fO5/jQ: folds
4uqU0dG67owXuPz303Al4w: calls $2
*** FLOP *** [Qh 9c Ts]
4uqU0dG67owXuPz303Al4w: checks
VvdR9F3I+2yELkfTVvC1dg: checks
F1+Ml47qRQWunzPnGhLLzQ: bets $4
4uqU0dG67owXuPz303Al4w: folds
VvdR9F3I+2yELkfTVvC1dg: folds
F1+Ml47qRQWunzPnGhLLzQ collected $12.35 from pot
F1+Ml47qRQWunzPnGhLLzQ: doesn't show hand
*** SUMMARY ***
Total pot $13 | Rake $0.65
Board [Qh 9c Ts]
Seat 2: 4uqU0dG67owXuPz303Al4w (big blind) folded on the Flop
Seat 3: VvdR9F3I+2yELkfTVvC1dg folded on the Flop
Seat 4: B87ikIyZ/TzAVeXf38Ny0g folded before Flop (didn't bet)
Seat 5: F1+Ml47qRQWunzPnGhLLzQ (button) collected ($12.35)
Seat 6: qCnEYuAE5y5A7bk6fO5/jQ (small blind) folded before Flop



PokerStars Game #59941495524:  Hold'em No Limit ($1/$2) - 2009/07/01 1:37:13 ET
Table 'pPQgcj9XT9CHBsbo1WTBug' 6-max Seat #6 is the button
Seat 1: DFVYDA6dKQy7R7mGIKogZA ($141.50 in chips)
Seat 2: qXDd0ZyMIse0OBu8pxeQ3Q ($200 in chips)
Seat 3: 54yWzRRgS0oZ+S6LwZBxMQ ($49.50 in chips)
Seat 4: gqlysXCbT8V54f/1lf9h3A ($73.45 in chips)
Seat 5: vkfxu8f/jMYKUk6Ly4eujw ($196.55 in chips)
Seat 6: Yr7pZltpy3IUNdKS9PCEiw ($310.80 in chips)
DFVYDA6dKQy7R7mGIKogZA: posts small blind $1
qXDd0ZyMIse0OBu8pxeQ3Q: posts big blind $2
*** HOLE CARDS ***
54yWzRRgS0oZ+S6LwZBxMQ: folds
gqlysXCbT8V54f/1lf9h3A: calls $2
vkfxu8f/jMYKUk6Ly4eujw: folds
Yr7pZltpy3IUNdKS9PCEiw: calls $2
DFVYDA6dKQy7R7mGIKogZA: calls $1
qXDd0ZyMIse0OBu8pxeQ3Q: checks
*** FLOP *** [4h 7d 9c]
DFVYDA6dKQy7R7mGIKogZA: checks
qXDd0ZyMIse0OBu8pxeQ3Q: bets $7
gqlysXCbT8V54f/1lf9h3A: calls $7
Yr7pZltpy3IUNdKS9PCEiw: folds
DFVYDA6dKQy7R7mGIKogZA: folds
*** TURN *** [4h 7d 9c] [2s]
qXDd0ZyMIse0OBu8pxeQ3Q: bets $18
gqlysXCbT8V54f/1lf9h3A: folds
qXDd0ZyMIse0OBu8pxeQ3Q collected $20.95 from pot
*** SUMMARY ***
Total pot $22 | Rake $1.05
Board [4h 7d 9c 2s]
Seat 1: DFVYDA6dKQy7R7mGIKogZA (small blind) folded on the Flop
Seat 2: qXDd0ZyMIse0OBu8pxeQ3Q (big blind) collected ($20.95)
Seat 3: 54yWzRRgS0oZ+S6LwZBxMQ folded before Flop (didn't bet)
Seat 4: gqlysXCbT8V54f/1lf9h3A folded on the Turn
Seat 5: vkfxu8f/jMYKUk6Ly4eujw folded before Flop (didn't bet)
Seat 6: Yr7pZltpy3IUNdKS9PCEiw (button) folded on the Flop



PokerStars Game #59941495644:  Hold'em No Limit ($1/$2) - 2009/07/01 1:37:13 ET
Table 'ztv6V3FN2bQ9nmJPPdx6nQ' 6-max Seat #2 is the button
Seat 1: 6fLdOUCRtX71xbVRhJEq8w ($238.35 in chips)
Seat 2: 5Y+ZGWLI4gnlpApDX5vy1A ($375.75 in chips)
Seat 3: ubtx4Z5L+AcK71MTvYiGVw ($246 in chips)
Seat 4: UaZ5yj+6LjtWqMQg2QskUw ($106.30 in chips)
Seat 5: sTPOWERd9HWPCNrDBwsVjA ($219.80 in chips)
Seat 6: mfy7uGZcqA2PVQqEVbJ7+g ($112.60 in chips)
ubtx4Z5L+AcK71MTvYiGVw: posts small blind $1
UaZ5yj+6LjtWqMQg2QskUw: posts big blind $2
*** HOLE CARDS ***
sTPOWERd9HWPCNrDBwsVjA: folds
mfy7uGZcqA2PVQqEVbJ7+g: folds
6fLdOUCRtX71xbVRhJEq8w: folds
5Y+ZGWLI4gnlpApDX5vy1A: raises $2 to $4
ubtx4Z5L+AcK71MTvYiGVw: folds
UaZ5yj+6LjtWqMQg2QskUw: calls $2
*** FLOP *** [Qh Ts 4h]
UaZ5yj+6LjtWqMQg2QskUw: checks
5Y+ZGWLI4gnlpApDX5vy1A: checks
*** TURN *** [Qh Ts 4h] [Ac]
UaZ5yj+6LjtWqMQg2QskUw: bets $4
5Y+ZGWLI4gnlpApDX5vy1A: calls $4
*** RIVER *** [Qh Ts 4h Ac] [3d]
UaZ5yj+6LjtWqMQg2QskUw: bets $8
5Y+ZGWLI4gnlpApDX5vy1A: calls $8
*** SHOW DOWN ***
UaZ5yj+6LjtWqMQg2QskUw: shows [8c 7d] (high card Ace)
5Y+ZGWLI4gnlpApDX5vy1A: shows [Qc Js] (a pair of Queens)
5Y+ZGWLI4gnlpApDX5vy1A collected $31.40 from pot
*** SUMMARY ***
Total pot $33 | Rake $1.60
Board [Qh Ts 4h Ac 3d]
Seat 1: 6fLdOUCRtX71xbVRhJEq8w folded before Flop (didn't bet)
Seat 2: 5Y+ZGWLI4gnlpApDX5vy1A (button) showed [Qc Js] and won ($31.40) with a pair of Queens
Seat 3: ubtx4Z5L+AcK71MTvYiGVw (small blind) folded before Flop
Seat 4: UaZ5yj+6LjtWqMQg2QskUw (big blind) showed [8c 7d] and lost with high card Ace
Seat 5: sTPOWERd9HWPCNrDBwsVjA folded before Flop (didn't bet)
Seat 6: mfy7uGZcqA2PVQqEVbJ7+g folded before Flop (didn't bet)



PokerStars Game #59941495424:  Hold'em No Limit ($1/$2) - 2009/07/01 1:37:13 ET
Table '4NGNnZ/osQfNq6abYqkJeA' 6-max Seat #1 is the button
Seat 1: vkfxu8f/jMYKUk6Ly4eujw ($190 in chips)
Seat 2: 669iGNwYwgRZg3nhS+aDAQ ($100.90 in chips)
Seat 3: 54yWzRRgS0oZ+S6LwZBxMQ ($30 in chips)
Seat 4: sY+4Uuh5z/6AbXXaCS10jw ($236.25 in chips)
Seat 5: VvdR9F3I+2yELkfTVvC1dg ($241.55 in chips)
Seat 6: /PH6Ffnho4Ysm8S3V/oa+w ($40 in chips)
669iGNwYwgRZg3nhS+aDAQ: posts small blind $1
54yWzRRgS0oZ+S6LwZBxMQ: posts big blind $2
*** HOLE CARDS ***
sY+4Uuh5z/6AbXXaCS10jw: folds
VvdR9F3I+2yELkfTVvC1dg: folds
/PH6Ffnho4Ysm8S3V/oa+w: folds
vkfxu8f/jMYKUk6Ly4eujw: raises $6 to $8
669iGNwYwgRZg3nhS+aDAQ: folds
54yWzRRgS0oZ+S6LwZBxMQ: folds
vkfxu8f/jMYKUk6Ly4eujw collected $5 from pot
vkfxu8f/jMYKUk6Ly4eujw: doesn't show hand
*** SUMMARY ***
Total pot $5 | Rake $0
Seat 1: vkfxu8f/jMYKUk6Ly4eujw (button) collected ($5)
Seat 2: 669iGNwYwgRZg3nhS+aDAQ (small blind) folded before Flop
Seat 3: 54yWzRRgS0oZ+S6LwZBxMQ (big blind) folded before Flop
Seat 4: sY+4Uuh5z/6AbXXaCS10jw folded before Flop (didn't bet)
Seat 5: VvdR9F3I+2yELkfTVvC1dg folded before Flop (didn't bet)
Seat 6: /PH6Ffnho4Ysm8S3V/oa+w folded before Flop (didn't bet)



PokerStars Game #59941497068:  Hold'em No Limit ($1/$2) - 2009/07/01 1:37:15 ET
Table 'LL4bDFyhj5hsMpzaDugJZg' 6-max Seat #5 is the button
Seat 2: IZng3w8jiJHHp3LbYKLi4w ($56.75 in chips)
Seat 3: iI/NMpRxMkGieArQEhACSA ($561.90 in chips)
Seat 4: 8srN1dKQePlsv0GyTada+Q ($200 in chips)
Seat 5: A2GTwTiwkb1ilNWgW487Vg ($125.50 in chips)
Seat 6: 692Q4sfB0gTElzS0WMeg+A ($206.35 in chips)
692Q4sfB0gTElzS0WMeg+A: posts small blind $1
IZng3w8jiJHHp3LbYKLi4w: posts big blind $2
*** HOLE CARDS ***
iI/NMpRxMkGieArQEhACSA: folds
8srN1dKQePlsv0GyTada+Q: folds
A2GTwTiwkb1ilNWgW487Vg: folds
692Q4sfB0gTElzS0WMeg+A: folds
IZng3w8jiJHHp3LbYKLi4w collected $2 from pot
*** SUMMARY ***
Total pot $2 | Rake $0
Seat 2: IZng3w8jiJHHp3LbYKLi4w (big blind) collected ($2)
Seat 3: iI/NMpRxMkGieArQEhACSA folded before Flop (didn't bet)
Seat 4: 8srN1dKQePlsv0GyTada+Q folded before Flop (didn't bet)
Seat 5: A2GTwTiwkb1ilNWgW487Vg (button) folded before Flop (didn't bet)
Seat 6: 692Q4sfB0gTElzS0WMeg+A (small blind) folded before Flop



PokerStars Game #59941497270:  Hold'em No Limit ($1/$2) - 2009/07/01 1:37:16 ET
Table 'qVXak+oTeDXMGbWa4sDU5Q' 9-max Seat #9 is the button
Seat 1: H6Z4+qu8gR0VUiPOijndVg ($210.55 in chips)
Seat 3: WUlHm+ydPPHG7Lb0rePSdA ($175.10 in chips)
Seat 4: lQYT23h5QCUVZAKxjOO39Q ($198.70 in chips)
Seat 5: FWGiDqRwvLeKmHq9t4Jy9w ($265.80 in chips)
Seat 6: GX1heJ+DSsvm7gzSPsYhhQ ($43 in chips)
Seat 7: PfmlvZlFiss79a6IoEr11g ($154.30 in chips)
Seat 8: Z0rzUi0y1x80UdIpofoNbA ($109.55 in chips)
Seat 9: CkE3IyJF1KvdaAOmZY5XqQ ($215.55 in chips)
H6Z4+qu8gR0VUiPOijndVg: posts small blind $1
rW/MyplHylMSBRaoRUzWrg: is sitting out
WUlHm+ydPPHG7Lb0rePSdA: posts big blind $2
*** HOLE CARDS ***
lQYT23h5QCUVZAKxjOO39Q: folds
FWGiDqRwvLeKmHq9t4Jy9w: folds
GX1heJ+DSsvm7gzSPsYhhQ: folds
rW/MyplHylMSBRaoRUzWrg leaves the table
PfmlvZlFiss79a6IoEr11g: raises $4 to $6
Z0rzUi0y1x80UdIpofoNbA: folds
CkE3IyJF1KvdaAOmZY5XqQ: folds
H6Z4+qu8gR0VUiPOijndVg: raises $14 to $20
WUlHm+ydPPHG7Lb0rePSdA: folds
PfmlvZlFiss79a6IoEr11g: calls $14
*** FLOP *** [3d 4c 7h]
H6Z4+qu8gR0VUiPOijndVg: bets $20
PfmlvZlFiss79a6IoEr11g: folds
H6Z4+qu8gR0VUiPOijndVg collected $39.90 from pot
CST1bO+CmVQOtNgiT0cKPg joins the table at seat #2
H6Z4+qu8gR0VUiPOijndVg: doesn't show hand
*** SUMMARY ***
Total pot $42 | Rake $2.10
Board [3d 4c 7h]
Seat 1: H6Z4+qu8gR0VUiPOijndVg (small blind) collected ($39.90)
Seat 3: WUlHm+ydPPHG7Lb0rePSdA (big blind) folded before Flop
Seat 4: lQYT23h5QCUVZAKxjOO39Q folded before Flop (didn't bet)
Seat 5: FWGiDqRwvLeKmHq9t4Jy9w folded before Flop (didn't bet)
Seat 6: GX1heJ+DSsvm7gzSPsYhhQ folded before Flop (didn't bet)
Seat 7: PfmlvZlFiss79a6IoEr11g folded on the Flop
Seat 8: Z0rzUi0y1x80UdIpofoNbA folded before Flop (didn't bet)
Seat 9: CkE3IyJF1KvdaAOmZY5XqQ (button) folded before Flop (didn't bet)



PokerStars Game #59941498680:  Hold'em No Limit ($1/$2) - 2009/07/01 1:37:18 ET
Table 'uJ9juaXXg9yIcSU8amxaXQ' 6-max Seat #3 is the button
Seat 1: JsqOjN/eHz0uYVf/PyUJ6Q ($155.25 in chips)
Seat 2: VvdR9F3I+2yELkfTVvC1dg ($223.10 in chips)
Seat 3: qXDd0ZyMIse0OBu8pxeQ3Q ($243.40 in chips)
Seat 4: zNjJ/y4emmF+vzrCDd+ooA ($224.05 in chips)
Seat 5: YsLQ3BAvgQHWXMAv3Wv6Hg ($203 in chips)
zNjJ/y4emmF+vzrCDd+ooA: posts small blind $1
YsLQ3BAvgQHWXMAv3Wv6Hg: posts big blind $2
/PH6Ffnho4Ysm8S3V/oa+w: sits out
*** HOLE CARDS ***
JsqOjN/eHz0uYVf/PyUJ6Q: calls $2
VvdR9F3I+2yELkfTVvC1dg: folds
qXDd0ZyMIse0OBu8pxeQ3Q: folds
zNjJ/y4emmF+vzrCDd+ooA: calls $1
YsLQ3BAvgQHWXMAv3Wv6Hg: checks
*** FLOP *** [Kc 3s Jd]
zNjJ/y4emmF+vzrCDd+ooA: checks
YsLQ3BAvgQHWXMAv3Wv6Hg: bets $4
JsqOjN/eHz0uYVf/PyUJ6Q: folds
zNjJ/y4emmF+vzrCDd+ooA: folds
YsLQ3BAvgQHWXMAv3Wv6Hg collected $5.70 from pot
YsLQ3BAvgQHWXMAv3Wv6Hg: doesn't show hand
*** SUMMARY ***
Total pot $6 | Rake $0.30
Board [Kc 3s Jd]
Seat 1: JsqOjN/eHz0uYVf/PyUJ6Q folded on the Flop
Seat 2: VvdR9F3I+2yELkfTVvC1dg folded before Flop (didn't bet)
Seat 3: qXDd0ZyMIse0OBu8pxeQ3Q (button) folded before Flop (didn't bet)
Seat 4: zNjJ/y4emmF+vzrCDd+ooA (small blind) folded on the Flop
Seat 5: YsLQ3BAvgQHWXMAv3Wv6Hg (big blind) collected ($5.70)



PokerStars Game #59941500182:  Hold'em No Limit ($1/$2) - 2009/07/01 1:37:21 ET
Table 'YqGfR5eHfMeSjb9a+QU9rg' 9-max Seat #5 is the button
Seat 1: rW/MyplHylMSBRaoRUzWrg ($39 in chips)
Seat 3: /gll27k+xWYV7Fbki0lFDQ ($258.75 in chips)
Seat 4: GX1heJ+DSsvm7gzSPsYhhQ ($34 in chips)
Seat 5: CkE3IyJF1KvdaAOmZY5XqQ ($201.75 in chips)
Seat 6: TAfo4veNRaRlzDXMMYS3Jg ($35 in chips)
Seat 7: 41aZuLBz9nAi2GPVKabmCw ($99.95 in chips)
Seat 8: JnV3SM2D6dAFYyGZHHpvrg ($93.25 in chips)
Seat 9: /inIs/z/PcX+TniIFpaxpg ($202.20 in chips)
TAfo4veNRaRlzDXMMYS3Jg: posts small blind $1
41aZuLBz9nAi2GPVKabmCw: posts big blind $2
nXDI8Y/S6POzRwANu3d8hQ: sits out
*** HOLE CARDS ***
JnV3SM2D6dAFYyGZHHpvrg: folds
/inIs/z/PcX+TniIFpaxpg: folds
rW/MyplHylMSBRaoRUzWrg: folds
/gll27k+xWYV7Fbki0lFDQ: folds
GX1heJ+DSsvm7gzSPsYhhQ: folds
CkE3IyJF1KvdaAOmZY5XqQ: folds
TAfo4veNRaRlzDXMMYS3Jg: raises $33 to $35 and is all-in
41aZuLBz9nAi2GPVKabmCw: folds
TAfo4veNRaRlzDXMMYS3Jg collected $4 from pot
TAfo4veNRaRlzDXMMYS3Jg: doesn't show hand
*** SUMMARY ***
Total pot $4 | Rake $0
Seat 1: rW/MyplHylMSBRaoRUzWrg folded before Flop (didn't bet)
Seat 3: /gll27k+xWYV7Fbki0lFDQ folded before Flop (didn't bet)
Seat 4: GX1heJ+DSsvm7gzSPsYhhQ folded before Flop (didn't bet)
Seat 5: CkE3IyJF1KvdaAOmZY5XqQ (button) folded before Flop (didn't bet)
Seat 6: TAfo4veNRaRlzDXMMYS3Jg (small blind) collected ($4)
Seat 7: 41aZuLBz9nAi2GPVKabmCw (big blind) folded before Flop
Seat 8: JnV3SM2D6dAFYyGZHHpvrg folded before Flop (didn't bet)
Seat 9: /inIs/z/PcX+TniIFpaxpg folded before Flop (didn't bet)



PokerStars Game #59941500208:  Hold'em No Limit ($1/$2) - 2009/07/01 1:37:21 ET
Table 'eyAQSIlgc2o1Jxvbve4WGg' 9-max Seat #7 is the button
Seat 1: UZEsV9yKUMqmpYPiOFpaZw ($100.20 in chips)
Seat 2: kM9CA+2UcdMjbCMbtUCGiA ($203 in chips)
Seat 4: CkE3IyJF1KvdaAOmZY5XqQ ($200 in chips)
Seat 5: mIKx5lhIt13X5eZQH0ZeMA ($131.40 in chips)
Seat 6: nXDI8Y/S6POzRwANu3d8hQ ($31 in chips)
Seat 7: u3OrI5uGx9mx1fE7dgr+EA ($72.20 in chips)
Seat 8: 1CtiZuXDFaJL1dJPQKyi8Q ($153.95 in chips)
Seat 9: WUlHm+ydPPHG7Lb0rePSdA ($143.20 in chips)
1CtiZuXDFaJL1dJPQKyi8Q: posts small blind $1
WUlHm+ydPPHG7Lb0rePSdA: posts big blind $2
*** HOLE CARDS ***
UZEsV9yKUMqmpYPiOFpaZw: folds
kM9CA+2UcdMjbCMbtUCGiA: folds
CkE3IyJF1KvdaAOmZY5XqQ: folds
mIKx5lhIt13X5eZQH0ZeMA: folds
nXDI8Y/S6POzRwANu3d8hQ: folds
u3OrI5uGx9mx1fE7dgr+EA: folds
1CtiZuXDFaJL1dJPQKyi8Q: folds
WUlHm+ydPPHG7Lb0rePSdA collected $2 from pot
WUlHm+ydPPHG7Lb0rePSdA: doesn't show hand
*** SUMMARY ***
Total pot $2 | Rake $0
Seat 1: UZEsV9yKUMqmpYPiOFpaZw folded before Flop (didn't bet)
Seat 2: kM9CA+2UcdMjbCMbtUCGiA folded before Flop (didn't bet)
Seat 4: CkE3IyJF1KvdaAOmZY5XqQ folded before Flop (didn't bet)
Seat 5: mIKx5lhIt13X5eZQH0ZeMA folded before Flop (didn't bet)
Seat 6: nXDI8Y/S6POzRwANu3d8hQ folded before Flop (didn't bet)
Seat 7: u3OrI5uGx9mx1fE7dgr+EA (button) folded before Flop (didn't bet)
Seat 8: 1CtiZuXDFaJL1dJPQKyi8Q (small blind) folded before Flop
Seat 9: WUlHm+ydPPHG7Lb0rePSdA (big blind) collected ($2)



PokerStars Game #59941500760:  Hold'em No Limit ($1/$2) - 2009/07/01 1:37:22 ET
Table 'NmY84NAf9Mh0ckAckHnh5g' 2-max Seat #2 is the button
Seat 1: 6hvg964TSqZ3AL/0XK9aVQ ($443 in chips)
Seat 2: RwDoM55ZeQuI2ADyJhOb2Q ($552 in chips)
RwDoM55ZeQuI2ADyJhOb2Q: posts small blind $1
6hvg964TSqZ3AL/0XK9aVQ: posts big blind $2
*** HOLE CARDS ***
RwDoM55ZeQuI2ADyJhOb2Q: folds
6hvg964TSqZ3AL/0XK9aVQ collected $2 from pot
*** SUMMARY ***
Total pot $2 | Rake $0
Seat 1: 6hvg964TSqZ3AL/0XK9aVQ (big blind) collected ($2)
Seat 2: RwDoM55ZeQuI2ADyJhOb2Q (button) (small blind) folded before Flop



PokerStars Game #59941501058:  Hold'em No Limit ($1/$2) - 2009/07/01 1:37:23 ET
Table 'jlrIxbrVIG+gjaUYT4za8g' 6-max Seat #2 is the button
Seat 1: ygTTt5ehT4aF86q1a8/R+w ($232.30 in chips)
Seat 2: /PH6Ffnho4Ysm8S3V/oa+w ($40 in chips)
Seat 3: gnYme0DNFflnMhrdbxe1Ag ($200 in chips)
Seat 4: 8srN1dKQePlsv0GyTada+Q ($257.20 in chips)
Seat 5: AyBB0k3Dcl7xbXUeGMw06g ($73.65 in chips)
Seat 6: vkfxu8f/jMYKUk6Ly4eujw ($335.20 in chips)
gnYme0DNFflnMhrdbxe1Ag: posts small blind $1
8srN1dKQePlsv0GyTada+Q: posts big blind $2
*** HOLE CARDS ***
AyBB0k3Dcl7xbXUeGMw06g: folds
vkfxu8f/jMYKUk6Ly4eujw: folds
ygTTt5ehT4aF86q1a8/R+w: raises $4 to $6
/PH6Ffnho4Ysm8S3V/oa+w: folds
gnYme0DNFflnMhrdbxe1Ag: folds
8srN1dKQePlsv0GyTada+Q: folds
ygTTt5ehT4aF86q1a8/R+w collected $5 from pot
*** SUMMARY ***
Total pot $5 | Rake $0
Seat 1: ygTTt5ehT4aF86q1a8/R+w collected ($5)
Seat 2: /PH6Ffnho4Ysm8S3V/oa+w (button) folded before Flop (didn't bet)
Seat 3: gnYme0DNFflnMhrdbxe1Ag (small blind) folded before Flop
Seat 4: 8srN1dKQePlsv0GyTada+Q (big blind) folded before Flop
Seat 5: AyBB0k3Dcl7xbXUeGMw06g folded before Flop (didn't bet)
Seat 6: vkfxu8f/jMYKUk6Ly4eujw folded before Flop (didn't bet)



PokerStars Game #59941502184:  Hold'em No Limit ($1/$2) - 2009/07/01 1:37:25 ET
Table 'P/yCfYl1GfGsu/e6DxDy/A' 2-max Seat #1 is the button
Seat 1: 7fOCUy3x9hdkmXkkDNolGQ ($470 in chips)
Seat 2: RwDoM55ZeQuI2ADyJhOb2Q ($1009 in chips)
7fOCUy3x9hdkmXkkDNolGQ: posts small blind $1
RwDoM55ZeQuI2ADyJhOb2Q: posts big blind $2
*** HOLE CARDS ***
7fOCUy3x9hdkmXkkDNolGQ: raises $4 to $6
RwDoM55ZeQuI2ADyJhOb2Q: folds
7fOCUy3x9hdkmXkkDNolGQ collected $4 from pot
7fOCUy3x9hdkmXkkDNolGQ: doesn't show hand
*** SUMMARY ***
Total pot $4 | Rake $0
Seat 1: 7fOCUy3x9hdkmXkkDNolGQ (button) (small blind) collected ($4)
Seat 2: RwDoM55ZeQuI2ADyJhOb2Q (big blind) folded before Flop



PokerStars Game #59941502674:  Hold'em No Limit ($1/$2) - 2009/07/01 1:37:26 ET
Table 'ZzSIe0zTCDv+n6hfbY5tTg' 6-max Seat #4 is the button
Seat 1: VvdR9F3I+2yELkfTVvC1dg ($237 in chips)
Seat 2: B87ikIyZ/TzAVeXf38Ny0g ($237 in chips)
Seat 3: gsugPj31Hui3Jefl98MBOA ($358.25 in chips)
Seat 4: qXDd0ZyMIse0OBu8pxeQ3Q ($259 in chips)
Seat 5: 3dAbvkxS5NPQTBAbvpinVg ($487.35 in chips)
Seat 6: 09BNF4quPDzanQzM8vc6WA ($23.05 in chips)
3dAbvkxS5NPQTBAbvpinVg: posts small blind $1
09BNF4quPDzanQzM8vc6WA: posts big blind $2
*** HOLE CARDS ***
VvdR9F3I+2yELkfTVvC1dg: folds
B87ikIyZ/TzAVeXf38Ny0g: folds
gsugPj31Hui3Jefl98MBOA: folds
qXDd0ZyMIse0OBu8pxeQ3Q: folds
3dAbvkxS5NPQTBAbvpinVg: raises $104 to $106
09BNF4quPDzanQzM8vc6WA: calls $21.05 and is all-in
*** FLOP *** [Js As 9c]
*** TURN *** [Js As 9c] [2c]
*** RIVER *** [Js As 9c 2c] [6c]
*** SHOW DOWN ***
3dAbvkxS5NPQTBAbvpinVg: shows [Jh 5h] (a pair of Jacks)
09BNF4quPDzanQzM8vc6WA: mucks hand
3dAbvkxS5NPQTBAbvpinVg collected $43.80 from pot
*** SUMMARY ***
Total pot $46.10 | Rake $2.30
Board [Js As 9c 2c 6c]
Seat 1: VvdR9F3I+2yELkfTVvC1dg folded before Flop (didn't bet)
Seat 2: B87ikIyZ/TzAVeXf38Ny0g folded before Flop (didn't bet)
Seat 3: gsugPj31Hui3Jefl98MBOA folded before Flop (didn't bet)
Seat 4: qXDd0ZyMIse0OBu8pxeQ3Q (button) folded before Flop (didn't bet)
Seat 5: 3dAbvkxS5NPQTBAbvpinVg (small blind) showed [Jh 5h] and won ($43.80) with a pair of Jacks
Seat 6: 09BNF4quPDzanQzM8vc6WA (big blind) mucked



PokerStars Game #59941504126:  Hold'em No Limit ($1/$2) - 2009/07/01 1:37:28 ET
Table 'NmY84NAf9Mh0ckAckHnh5g' 2-max Seat #1 is the button
Seat 1: 6hvg964TSqZ3AL/0XK9aVQ ($444 in chips)
Seat 2: RwDoM55ZeQuI2ADyJhOb2Q ($551 in chips)
6hvg964TSqZ3AL/0XK9aVQ: posts small blind $1
RwDoM55ZeQuI2ADyJhOb2Q: posts big blind $2
*** HOLE CARDS ***
6hvg964TSqZ3AL/0XK9aVQ: folds
RwDoM55ZeQuI2ADyJhOb2Q collected $2 from pot
RwDoM55ZeQuI2ADyJhOb2Q: doesn't show hand
*** SUMMARY ***
Total pot $2 | Rake $0
Seat 1: 6hvg964TSqZ3AL/0XK9aVQ (button) (small blind) folded before Flop
Seat 2: RwDoM55ZeQuI2ADyJhOb2Q (big blind) collected ($2)



PokerStars Game #59941506064:  Hold'em No Limit ($1/$2) - 2009/07/01 1:37:32 ET
Table 'P/yCfYl1GfGsu/e6DxDy/A' 2-max Seat #2 is the button
Seat 1: 7fOCUy3x9hdkmXkkDNolGQ ($472 in chips)
Seat 2: RwDoM55ZeQuI2ADyJhOb2Q ($1007 in chips)
RwDoM55ZeQuI2ADyJhOb2Q: posts small blind $1
7fOCUy3x9hdkmXkkDNolGQ: posts big blind $2
*** HOLE CARDS ***
RwDoM55ZeQuI2ADyJhOb2Q: raises $4 to $6
7fOCUy3x9hdkmXkkDNolGQ: folds
RwDoM55ZeQuI2ADyJhOb2Q collected $4 from pot
RwDoM55ZeQuI2ADyJhOb2Q: doesn't show hand
*** SUMMARY ***
Total pot $4 | Rake $0
Seat 1: 7fOCUy3x9hdkmXkkDNolGQ (big blind) folded before Flop
Seat 2: RwDoM55ZeQuI2ADyJhOb2Q (button) (small blind) collected ($4)



PokerStars Game #59941506136:  Hold'em No Limit ($1/$2) - 2009/07/01 1:37:32 ET
Table 'LL4bDFyhj5hsMpzaDugJZg' 6-max Seat #6 is the button
Seat 2: IZng3w8jiJHHp3LbYKLi4w ($57.75 in chips)
Seat 3: iI/NMpRxMkGieArQEhACSA ($561.90 in chips)
Seat 4: 8srN1dKQePlsv0GyTada+Q ($200 in chips)
Seat 5: A2GTwTiwkb1ilNWgW487Vg ($125.50 in chips)
Seat 6: 692Q4sfB0gTElzS0WMeg+A ($205.35 in chips)
IZng3w8jiJHHp3LbYKLi4w: posts small blind $1
iI/NMpRxMkGieArQEhACSA: posts big blind $2
*** HOLE CARDS ***
8srN1dKQePlsv0GyTada+Q: folds
A2GTwTiwkb1ilNWgW487Vg: folds
692Q4sfB0gTElzS0WMeg+A: folds
IZng3w8jiJHHp3LbYKLi4w: calls $1
iI/NMpRxMkGieArQEhACSA: checks
*** FLOP *** [Ad Td Qc]
IZng3w8jiJHHp3LbYKLi4w: checks
iI/NMpRxMkGieArQEhACSA: bets $4
IZng3w8jiJHHp3LbYKLi4w: calls $4
*** TURN *** [Ad Td Qc] [6h]
IZng3w8jiJHHp3LbYKLi4w: checks
iI/NMpRxMkGieArQEhACSA: bets $10
IZng3w8jiJHHp3LbYKLi4w: folds
iI/NMpRxMkGieArQEhACSA collected $11.45 from pot
*** SUMMARY ***
Total pot $12 | Rake $0.55
Board [Ad Td Qc 6h]
Seat 2: IZng3w8jiJHHp3LbYKLi4w (small blind) folded on the Turn
Seat 3: iI/NMpRxMkGieArQEhACSA (big blind) collected ($11.45)
Seat 4: 8srN1dKQePlsv0GyTada+Q folded before Flop (didn't bet)
Seat 5: A2GTwTiwkb1ilNWgW487Vg folded before Flop (didn't bet)
Seat 6: 692Q4sfB0gTElzS0WMeg+A (button) folded before Flop (didn't bet)



PokerStars Game #59941507234:  Hold'em No Limit ($1/$2) - 2009/07/01 1:37:34 ET
Table 'NmY84NAf9Mh0ckAckHnh5g' 2-max Seat #2 is the button
Seat 1: 6hvg964TSqZ3AL/0XK9aVQ ($443 in chips)
Seat 2: RwDoM55ZeQuI2ADyJhOb2Q ($552 in chips)
RwDoM55ZeQuI2ADyJhOb2Q: posts small blind $1
6hvg964TSqZ3AL/0XK9aVQ: posts big blind $2
*** HOLE CARDS ***
RwDoM55ZeQuI2ADyJhOb2Q: raises $4 to $6
6hvg964TSqZ3AL/0XK9aVQ: folds
RwDoM55ZeQuI2ADyJhOb2Q collected $4 from pot
RwDoM55ZeQuI2ADyJhOb2Q: doesn't show hand
*** SUMMARY ***
Total pot $4 | Rake $0
Seat 1: 6hvg964TSqZ3AL/0XK9aVQ (big blind) folded before Flop
Seat 2: RwDoM55ZeQuI2ADyJhOb2Q (button) (small blind) collected ($4)



PokerStars Game #59941507628:  Hold'em No Limit ($1/$2) - 2009/07/01 1:37:35 ET
Table 'rKeCh+eBn4RNvybCUYkoTQ' 9-max Seat #7 is the button
Seat 1: /inIs/z/PcX+TniIFpaxpg ($198 in chips)
Seat 3: GX1heJ+DSsvm7gzSPsYhhQ ($49 in chips)
Seat 5: WUlHm+ydPPHG7Lb0rePSdA ($122 in chips)
Seat 6: EBV6OktyeSmh4w6sWmcWOw ($286.80 in chips)
Seat 7: rW/MyplHylMSBRaoRUzWrg ($28 in chips)
Seat 8: pN/Ip0ePsUVIdUlGgLrkUw ($247.35 in chips)
Seat 9: Kzta8yu9vxHT4B70mjBZ+w ($214.25 in chips)
pN/Ip0ePsUVIdUlGgLrkUw: posts small blind $1
Kzta8yu9vxHT4B70mjBZ+w: posts big blind $2
*** HOLE CARDS ***
/inIs/z/PcX+TniIFpaxpg: folds
nXDI8Y/S6POzRwANu3d8hQ joins the table at seat #2
GX1heJ+DSsvm7gzSPsYhhQ: folds
WUlHm+ydPPHG7Lb0rePSdA: folds
EBV6OktyeSmh4w6sWmcWOw: folds
rW/MyplHylMSBRaoRUzWrg: folds
pN/Ip0ePsUVIdUlGgLrkUw: folds
Kzta8yu9vxHT4B70mjBZ+w collected $2 from pot
Kzta8yu9vxHT4B70mjBZ+w: doesn't show hand
*** SUMMARY ***
Total pot $2 | Rake $0
Seat 1: /inIs/z/PcX+TniIFpaxpg folded before Flop (didn't bet)
Seat 3: GX1heJ+DSsvm7gzSPsYhhQ folded before Flop (didn't bet)
Seat 5: WUlHm+ydPPHG7Lb0rePSdA folded before Flop (didn't bet)
Seat 6: EBV6OktyeSmh4w6sWmcWOw folded before Flop (didn't bet)
Seat 7: rW/MyplHylMSBRaoRUzWrg (button) folded before Flop (didn't bet)
Seat 8: pN/Ip0ePsUVIdUlGgLrkUw (small blind) folded before Flop
Seat 9: Kzta8yu9vxHT4B70mjBZ+w (big blind) collected ($2)



PokerStars Game #59941508272:  Hold'em No Limit ($1/$2) - 2009/07/01 1:37:36 ET
Table 'on4i1U1lCRmxsduFD3xiSg' 9-max Seat #3 is the button
Seat 1: so5k3vFDmokh2q3dImJ1GQ ($176.30 in chips)
Seat 2: NqSvZNzJ4RkR3sCmgQnyLw ($44.85 in chips)
Seat 3: GX1heJ+DSsvm7gzSPsYhhQ ($39 in chips)
Seat 4: DFQVuszLVclqjA46pN4Vvw ($86.50 in chips)
Seat 7: /inIs/z/PcX+TniIFpaxpg ($271.05 in chips)
Seat 8: ZYHoLw2lWmRS7CSHi8L8Xg ($200 in chips)
Seat 9: TAfo4veNRaRlzDXMMYS3Jg ($37 in chips)
DFQVuszLVclqjA46pN4Vvw: posts small blind $1
+T/63sAeZzWyHchahJ36GQ: is sitting out
/inIs/z/PcX+TniIFpaxpg: posts big blind $2
*** HOLE CARDS ***
+T/63sAeZzWyHchahJ36GQ leaves the table
ZYHoLw2lWmRS7CSHi8L8Xg: folds
TAfo4veNRaRlzDXMMYS3Jg: folds
so5k3vFDmokh2q3dImJ1GQ: folds
NqSvZNzJ4RkR3sCmgQnyLw: folds
KqHysDSpCPaPyK3tJC1aEw joins the table at seat #6
GX1heJ+DSsvm7gzSPsYhhQ: raises $4 to $6
DFQVuszLVclqjA46pN4Vvw: calls $5
/inIs/z/PcX+TniIFpaxpg: folds
*** FLOP *** [Jd Tc Ks]
37j/5DgMG5m9lMfFofEAOg has returned
DFQVuszLVclqjA46pN4Vvw: checks
GX1heJ+DSsvm7gzSPsYhhQ: checks
*** TURN *** [Jd Tc Ks] [8s]
DFQVuszLVclqjA46pN4Vvw: checks
GX1heJ+DSsvm7gzSPsYhhQ: checks
*** RIVER *** [Jd Tc Ks 8s] [4s]
DFQVuszLVclqjA46pN4Vvw: checks
GX1heJ+DSsvm7gzSPsYhhQ: checks
*** SHOW DOWN ***
DFQVuszLVclqjA46pN4Vvw: shows [3h 3d] (a pair of Threes)
GX1heJ+DSsvm7gzSPsYhhQ: mucks hand
DFQVuszLVclqjA46pN4Vvw collected $13.30 from pot
*** SUMMARY ***
Total pot $14 | Rake $0.70
Board [Jd Tc Ks 8s 4s]
Seat 1: so5k3vFDmokh2q3dImJ1GQ folded before Flop (didn't bet)
Seat 2: NqSvZNzJ4RkR3sCmgQnyLw folded before Flop (didn't bet)
Seat 3: GX1heJ+DSsvm7gzSPsYhhQ (button) mucked
Seat 4: DFQVuszLVclqjA46pN4Vvw (small blind) showed [3h 3d] and won ($13.30) with a pair of Threes
Seat 7: /inIs/z/PcX+TniIFpaxpg (big blind) folded before Flop
Seat 8: ZYHoLw2lWmRS7CSHi8L8Xg folded before Flop (didn't bet)
Seat 9: TAfo4veNRaRlzDXMMYS3Jg folded before Flop (didn't bet)



PokerStars Game #59941508184:  Hold'em No Limit ($1/$2) - 2009/07/01 1:37:36 ET
Table 'kq5zaQ+1hLNf8LZfGnbTAA' 6-max Seat #3 is the button
Seat 1: 8srN1dKQePlsv0GyTada+Q ($430.60 in chips)
Seat 2: nXDI8Y/S6POzRwANu3d8hQ ($144 in chips)
Seat 3: /PH6Ffnho4Ysm8S3V/oa+w ($40 in chips)
Seat 4: 3dAbvkxS5NPQTBAbvpinVg ($276.45 in chips)
Seat 5: gnYme0DNFflnMhrdbxe1Ag ($226.35 in chips)
Seat 6: mfy7uGZcqA2PVQqEVbJ7+g ($196.45 in chips)
3dAbvkxS5NPQTBAbvpinVg: posts small blind $1
gnYme0DNFflnMhrdbxe1Ag: posts big blind $2
*** HOLE CARDS ***
mfy7uGZcqA2PVQqEVbJ7+g: raises $5 to $7
8srN1dKQePlsv0GyTada+Q: folds
nXDI8Y/S6POzRwANu3d8hQ: folds
/PH6Ffnho4Ysm8S3V/oa+w: folds
3dAbvkxS5NPQTBAbvpinVg: folds
gnYme0DNFflnMhrdbxe1Ag: folds
mfy7uGZcqA2PVQqEVbJ7+g collected $5 from pot
mfy7uGZcqA2PVQqEVbJ7+g: doesn't show hand
*** SUMMARY ***
Total pot $5 | Rake $0
Seat 1: 8srN1dKQePlsv0GyTada+Q folded before Flop (didn't bet)
Seat 2: nXDI8Y/S6POzRwANu3d8hQ folded before Flop (didn't bet)
Seat 3: /PH6Ffnho4Ysm8S3V/oa+w (button) folded before Flop (didn't bet)
Seat 4: 3dAbvkxS5NPQTBAbvpinVg (small blind) folded before Flop
Seat 5: gnYme0DNFflnMhrdbxe1Ag (big blind) folded before Flop
Seat 6: mfy7uGZcqA2PVQqEVbJ7+g collected ($5)



PokerStars Game #59941508716:  Hold'em No Limit ($1/$2) - 2009/07/01 1:37:37 ET
Table '/dyk+YdRGv90j2box35j8w' 6-max Seat #2 is the button
Seat 1: 8srN1dKQePlsv0GyTada+Q ($212.25 in chips)
Seat 2: qCnEYuAE5y5A7bk6fO5/jQ ($467.60 in chips)
Seat 3: sTPOWERd9HWPCNrDBwsVjA ($183.50 in chips)
Seat 5: VvdR9F3I+2yELkfTVvC1dg ($243 in chips)
Seat 6: gnYme0DNFflnMhrdbxe1Ag ($204 in chips)
sTPOWERd9HWPCNrDBwsVjA: posts small blind $1
VvdR9F3I+2yELkfTVvC1dg: posts big blind $2
*** HOLE CARDS ***
gnYme0DNFflnMhrdbxe1Ag: raises $4 to $6
8srN1dKQePlsv0GyTada+Q: folds
qCnEYuAE5y5A7bk6fO5/jQ: folds
sTPOWERd9HWPCNrDBwsVjA: folds
VvdR9F3I+2yELkfTVvC1dg: raises $15 to $21
gnYme0DNFflnMhrdbxe1Ag: folds
VvdR9F3I+2yELkfTVvC1dg collected $13 from pot
VvdR9F3I+2yELkfTVvC1dg: doesn't show hand
*** SUMMARY ***
Total pot $13 | Rake $0
Seat 1: 8srN1dKQePlsv0GyTada+Q folded before Flop (didn't bet)
Seat 2: qCnEYuAE5y5A7bk6fO5/jQ (button) folded before Flop (didn't bet)
Seat 3: sTPOWERd9HWPCNrDBwsVjA (small blind) folded before Flop
Seat 5: VvdR9F3I+2yELkfTVvC1dg (big blind) collected ($13)
Seat 6: gnYme0DNFflnMhrdbxe1Ag folded before Flop



PokerStars Game #59941509756:  Hold'em No Limit ($1/$2) - 2009/07/01 1:37:38 ET
Table 'P/yCfYl1GfGsu/e6DxDy/A' 2-max Seat #1 is the button
Seat 1: 7fOCUy3x9hdkmXkkDNolGQ ($470 in chips)
Seat 2: RwDoM55ZeQuI2ADyJhOb2Q ($1009 in chips)
7fOCUy3x9hdkmXkkDNolGQ: posts small blind $1
RwDoM55ZeQuI2ADyJhOb2Q: posts big blind $2
*** HOLE CARDS ***
7fOCUy3x9hdkmXkkDNolGQ: raises $4 to $6
RwDoM55ZeQuI2ADyJhOb2Q: folds
7fOCUy3x9hdkmXkkDNolGQ collected $4 from pot
7fOCUy3x9hdkmXkkDNolGQ: doesn't show hand
*** SUMMARY ***
Total pot $4 | Rake $0
Seat 1: 7fOCUy3x9hdkmXkkDNolGQ (button) (small blind) collected ($4)
Seat 2: RwDoM55ZeQuI2ADyJhOb2Q (big blind) folded before Flop



PokerStars Game #59941511266:  Hold'em No Limit ($1/$2) - 2009/07/01 1:37:41 ET
Table 'NmY84NAf9Mh0ckAckHnh5g' 2-max Seat #1 is the button
Seat 1: 6hvg964TSqZ3AL/0XK9aVQ ($441 in chips)
Seat 2: RwDoM55ZeQuI2ADyJhOb2Q ($554 in chips)
6hvg964TSqZ3AL/0XK9aVQ: posts small blind $1
RwDoM55ZeQuI2ADyJhOb2Q: posts big blind $2
*** HOLE CARDS ***
6hvg964TSqZ3AL/0XK9aVQ: calls $1
RwDoM55ZeQuI2ADyJhOb2Q: checks
*** FLOP *** [6d 5s Th]
RwDoM55ZeQuI2ADyJhOb2Q: checks
6hvg964TSqZ3AL/0XK9aVQ: checks
*** TURN *** [6d 5s Th] [Ts]
RwDoM55ZeQuI2ADyJhOb2Q: checks
6hvg964TSqZ3AL/0XK9aVQ: bets $4
RwDoM55ZeQuI2ADyJhOb2Q: folds
6hvg964TSqZ3AL/0XK9aVQ collected $3.80 from pot
6hvg964TSqZ3AL/0XK9aVQ: doesn't show hand
*** SUMMARY ***
Total pot $4 | Rake $0.20
Board [6d 5s Th Ts]
Seat 1: 6hvg964TSqZ3AL/0XK9aVQ (button) (small blind) collected ($3.80)
Seat 2: RwDoM55ZeQuI2ADyJhOb2Q (big blind) folded on the Turn



PokerStars Game #59941511054:  Hold'em No Limit ($1/$2) - 2009/07/01 1:37:41 ET
Table 'gnHBqWll9O3fxG7Ojkz/ng' 9-max Seat #5 is the button
Seat 1: TAfo4veNRaRlzDXMMYS3Jg ($31 in chips)
Seat 2: H6Z4+qu8gR0VUiPOijndVg ($331.95 in chips)
Seat 3: 5Q8U6iZbeO7xJSS4qvDP5g ($218.05 in chips)
Seat 4: nXDI8Y/S6POzRwANu3d8hQ ($35 in chips)
Seat 5: rBQDMkKm9cZn6M9NPsiVew ($224.15 in chips)
Seat 6: KqHysDSpCPaPyK3tJC1aEw ($200 in chips)
Seat 7: jqui3xAWCkcdPW36a6BD+w ($345.55 in chips)
Seat 8: cM6efHzdxoqYm0EQKP4TTQ ($90.50 in chips)
Seat 9: GX1heJ+DSsvm7gzSPsYhhQ ($50.35 in chips)
KqHysDSpCPaPyK3tJC1aEw: posts small blind $1
jqui3xAWCkcdPW36a6BD+w: posts big blind $2
*** HOLE CARDS ***
cM6efHzdxoqYm0EQKP4TTQ: calls $2
GX1heJ+DSsvm7gzSPsYhhQ: folds
TAfo4veNRaRlzDXMMYS3Jg: folds
H6Z4+qu8gR0VUiPOijndVg: folds
5Q8U6iZbeO7xJSS4qvDP5g: folds
nXDI8Y/S6POzRwANu3d8hQ: raises $6 to $8
rBQDMkKm9cZn6M9NPsiVew: folds
KqHysDSpCPaPyK3tJC1aEw: folds
jqui3xAWCkcdPW36a6BD+w: folds
cM6efHzdxoqYm0EQKP4TTQ: calls $6
*** FLOP *** [9s 4d Qs]
cM6efHzdxoqYm0EQKP4TTQ: checks
nXDI8Y/S6POzRwANu3d8hQ: bets $8
cM6efHzdxoqYm0EQKP4TTQ: raises $18 to $26
nXDI8Y/S6POzRwANu3d8hQ: folds
cM6efHzdxoqYm0EQKP4TTQ collected $33.30 from pot
*** SUMMARY ***
Total pot $35 | Rake $1.70
Board [9s 4d Qs]
Seat 1: TAfo4veNRaRlzDXMMYS3Jg folded before Flop (didn't bet)
Seat 2: H6Z4+qu8gR0VUiPOijndVg folded before Flop (didn't bet)
Seat 3: 5Q8U6iZbeO7xJSS4qvDP5g folded before Flop (didn't bet)
Seat 4: nXDI8Y/S6POzRwANu3d8hQ folded on the Flop
Seat 5: rBQDMkKm9cZn6M9NPsiVew (button) folded before Flop (didn't bet)
Seat 6: KqHysDSpCPaPyK3tJC1aEw (small blind) folded before Flop
Seat 7: jqui3xAWCkcdPW36a6BD+w (big blind) folded before Flop
Seat 8: cM6efHzdxoqYm0EQKP4TTQ collected ($33.30)
Seat 9: GX1heJ+DSsvm7gzSPsYhhQ folded before Flop (didn't bet)



PokerStars Game #59941511634:  Hold'em No Limit ($1/$2) - 2009/07/01 1:37:42 ET
Table 'gftD4mDF7mIFKvSrIyaRbw' 9-max Seat #4 is the button
Seat 2: GX1heJ+DSsvm7gzSPsYhhQ ($40 in chips)
Seat 3: CUZwDpLTQKhzarPe+JCLOQ ($222.65 in chips)
Seat 4: /inIs/z/PcX+TniIFpaxpg ($37 in chips)
Seat 5: mpsfNtnMVDqQHTe92AhIdw ($95.10 in chips)
Seat 6: 2NvwF8W2nzsbS+G//yLAbQ ($118.20 in chips)
Seat 7: +T/63sAeZzWyHchahJ36GQ ($54.25 in chips)
Seat 8: MpL4DeEqGQu0H8TJEbEOrg ($38 in chips)
mpsfNtnMVDqQHTe92AhIdw: posts small blind $1
2NvwF8W2nzsbS+G//yLAbQ: posts big blind $2
KqHysDSpCPaPyK3tJC1aEw: sits out
*** HOLE CARDS ***
+T/63sAeZzWyHchahJ36GQ: raises $4 to $6
MpL4DeEqGQu0H8TJEbEOrg: folds
GX1heJ+DSsvm7gzSPsYhhQ: folds
CUZwDpLTQKhzarPe+JCLOQ: calls $6
/inIs/z/PcX+TniIFpaxpg: folds
mpsfNtnMVDqQHTe92AhIdw: folds
2NvwF8W2nzsbS+G//yLAbQ: raises $6 to $12
+T/63sAeZzWyHchahJ36GQ: calls $6
CUZwDpLTQKhzarPe+JCLOQ: calls $6
*** FLOP *** [8d Qh 3h]
2NvwF8W2nzsbS+G//yLAbQ: checks
+T/63sAeZzWyHchahJ36GQ: checks
CUZwDpLTQKhzarPe+JCLOQ: checks
*** TURN *** [8d Qh 3h] [4c]
2NvwF8W2nzsbS+G//yLAbQ: bets $17
+T/63sAeZzWyHchahJ36GQ: calls $17
CUZwDpLTQKhzarPe+JCLOQ: folds
*** RIVER *** [8d Qh 3h 4c] [3c]
2NvwF8W2nzsbS+G//yLAbQ: checks
+T/63sAeZzWyHchahJ36GQ: checks
*** SHOW DOWN ***
2NvwF8W2nzsbS+G//yLAbQ: shows [Ah Kd] (a pair of Threes)
+T/63sAeZzWyHchahJ36GQ: shows [Ts Tc] (two pair, Tens and Threes)
+T/63sAeZzWyHchahJ36GQ collected $68 from pot
*** SUMMARY ***
Total pot $71 | Rake $3
Board [8d Qh 3h 4c 3c]
Seat 2: GX1heJ+DSsvm7gzSPsYhhQ folded before Flop (didn't bet)
Seat 3: CUZwDpLTQKhzarPe+JCLOQ folded on the Turn
Seat 4: /inIs/z/PcX+TniIFpaxpg (button) folded before Flop (didn't bet)
Seat 5: mpsfNtnMVDqQHTe92AhIdw (small blind) folded before Flop
Seat 6: 2NvwF8W2nzsbS+G//yLAbQ (big blind) showed [Ah Kd] and lost with a pair of Threes
Seat 7: +T/63sAeZzWyHchahJ36GQ showed [Ts Tc] and won ($68) with two pair, Tens and Threes
Seat 8: MpL4DeEqGQu0H8TJEbEOrg folded before Flop (didn't bet)



PokerStars Game #59941513082:  Hold'em No Limit ($1/$2) - 2009/07/01 1:37:44 ET
Table '4NGNnZ/osQfNq6abYqkJeA' 6-max Seat #2 is the button
Seat 1: vkfxu8f/jMYKUk6Ly4eujw ($193 in chips)
Seat 2: 669iGNwYwgRZg3nhS+aDAQ ($99.90 in chips)
Seat 3: 54yWzRRgS0oZ+S6LwZBxMQ ($28 in chips)
Seat 4: sY+4Uuh5z/6AbXXaCS10jw ($236.25 in chips)
Seat 5: VvdR9F3I+2yELkfTVvC1dg ($241.55 in chips)
Seat 6: /PH6Ffnho4Ysm8S3V/oa+w ($40 in chips)
54yWzRRgS0oZ+S6LwZBxMQ: posts small blind $1
sY+4Uuh5z/6AbXXaCS10jw: posts big blind $2
*** HOLE CARDS ***
VvdR9F3I+2yELkfTVvC1dg: folds
/PH6Ffnho4Ysm8S3V/oa+w: folds
vkfxu8f/jMYKUk6Ly4eujw: folds
669iGNwYwgRZg3nhS+aDAQ: folds
54yWzRRgS0oZ+S6LwZBxMQ: calls $1
sY+4Uuh5z/6AbXXaCS10jw: checks
*** FLOP *** [6d Th Qh]
54yWzRRgS0oZ+S6LwZBxMQ: checks
sY+4Uuh5z/6AbXXaCS10jw: checks
*** TURN *** [6d Th Qh] [2s]
54yWzRRgS0oZ+S6LwZBxMQ: bets $4
sY+4Uuh5z/6AbXXaCS10jw: folds
54yWzRRgS0oZ+S6LwZBxMQ collected $3.80 from pot
54yWzRRgS0oZ+S6LwZBxMQ: doesn't show hand
*** SUMMARY ***
Total pot $4 | Rake $0.20
Board [6d Th Qh 2s]
Seat 1: vkfxu8f/jMYKUk6Ly4eujw folded before Flop (didn't bet)
Seat 2: 669iGNwYwgRZg3nhS+aDAQ (button) folded before Flop (didn't bet)
Seat 3: 54yWzRRgS0oZ+S6LwZBxMQ (small blind) collected ($3.80)
Seat 4: sY+4Uuh5z/6AbXXaCS10jw (big blind) folded on the Turn
Seat 5: VvdR9F3I+2yELkfTVvC1dg folded before Flop (didn't bet)
Seat 6: /PH6Ffnho4Ysm8S3V/oa+w folded before Flop (didn't bet)



PokerStars Game #59941513580:  Hold'em No Limit ($1/$2) - 2009/07/01 1:37:45 ET
Table 'jlrIxbrVIG+gjaUYT4za8g' 6-max Seat #3 is the button
Seat 1: ygTTt5ehT4aF86q1a8/R+w ($235.30 in chips)
Seat 2: /PH6Ffnho4Ysm8S3V/oa+w ($40 in chips)
Seat 3: gnYme0DNFflnMhrdbxe1Ag ($200 in chips)
Seat 4: 8srN1dKQePlsv0GyTada+Q ($255.20 in chips)
Seat 5: AyBB0k3Dcl7xbXUeGMw06g ($73.65 in chips)
Seat 6: vkfxu8f/jMYKUk6Ly4eujw ($335.20 in chips)
8srN1dKQePlsv0GyTada+Q: posts small blind $1
AyBB0k3Dcl7xbXUeGMw06g: posts big blind $2
*** HOLE CARDS ***
vkfxu8f/jMYKUk6Ly4eujw: folds
ygTTt5ehT4aF86q1a8/R+w: folds
vkfxu8f/jMYKUk6Ly4eujw leaves the table
/PH6Ffnho4Ysm8S3V/oa+w: folds
gnYme0DNFflnMhrdbxe1Ag: raises $4 to $6
8srN1dKQePlsv0GyTada+Q: folds
AyBB0k3Dcl7xbXUeGMw06g: folds
gnYme0DNFflnMhrdbxe1Ag collected $5 from pot
*** SUMMARY ***
Total pot $5 | Rake $0
Seat 1: ygTTt5ehT4aF86q1a8/R+w folded before Flop (didn't bet)
Seat 2: /PH6Ffnho4Ysm8S3V/oa+w folded before Flop (didn't bet)
Seat 3: gnYme0DNFflnMhrdbxe1Ag (button) collected ($5)
Seat 4: 8srN1dKQePlsv0GyTada+Q (small blind) folded before Flop
Seat 5: AyBB0k3Dcl7xbXUeGMw06g (big blind) folded before Flop
Seat 6: vkfxu8f/jMYKUk6Ly4eujw folded before Flop (didn't bet)



PokerStars Game #59941513962:  Hold'em No Limit ($1/$2) - 2009/07/01 1:37:46 ET
Table 'P/yCfYl1GfGsu/e6DxDy/A' 2-max Seat #2 is the button
Seat 1: 7fOCUy3x9hdkmXkkDNolGQ ($472 in chips)
Seat 2: RwDoM55ZeQuI2ADyJhOb2Q ($1007 in chips)
RwDoM55ZeQuI2ADyJhOb2Q: posts small blind $1
7fOCUy3x9hdkmXkkDNolGQ: posts big blind $2
*** HOLE CARDS ***
RwDoM55ZeQuI2ADyJhOb2Q: raises $4 to $6
7fOCUy3x9hdkmXkkDNolGQ: folds
RwDoM55ZeQuI2ADyJhOb2Q collected $4 from pot
RwDoM55ZeQuI2ADyJhOb2Q: doesn't show hand
*** SUMMARY ***
Total pot $4 | Rake $0
Seat 1: 7fOCUy3x9hdkmXkkDNolGQ (big blind) folded before Flop
Seat 2: RwDoM55ZeQuI2ADyJhOb2Q (button) (small blind) collected ($4)



PokerStars Game #59941515242:  Hold'em No Limit ($1/$2) - 2009/07/01 1:37:48 ET
Table 'mGpP9StWRnoeiBDExc6Frg' 6-max Seat #2 is the button
Seat 1: VvdR9F3I+2yELkfTVvC1dg ($313.60 in chips)
Seat 2: vkfxu8f/jMYKUk6Ly4eujw ($196 in chips)
Seat 4: 4dcDwIHRm96PwtqkpQiuiA ($76.70 in chips)
Seat 5: d1puGuVBE0fidn+5eRJ0tw ($203.65 in chips)
Seat 6: B2Ih1sr5VZk+8He7rcrMtQ ($423.05 in chips)
4dcDwIHRm96PwtqkpQiuiA: posts small blind $1
d1puGuVBE0fidn+5eRJ0tw: posts big blind $2
*** HOLE CARDS ***
7acrZUQC3Zc9BNLjoKIcLQ has returned
B2Ih1sr5VZk+8He7rcrMtQ: folds
VvdR9F3I+2yELkfTVvC1dg: raises $2 to $4
vkfxu8f/jMYKUk6Ly4eujw: folds
4dcDwIHRm96PwtqkpQiuiA: folds
d1puGuVBE0fidn+5eRJ0tw: calls $2
*** FLOP *** [2c 2d 8s]
d1puGuVBE0fidn+5eRJ0tw: checks
VvdR9F3I+2yELkfTVvC1dg: bets $6.40
d1puGuVBE0fidn+5eRJ0tw: folds
VvdR9F3I+2yELkfTVvC1dg collected $8.55 from pot
VvdR9F3I+2yELkfTVvC1dg: doesn't show hand
*** SUMMARY ***
Total pot $9 | Rake $0.45
Board [2c 2d 8s]
Seat 1: VvdR9F3I+2yELkfTVvC1dg collected ($8.55)
Seat 2: vkfxu8f/jMYKUk6Ly4eujw (button) folded before Flop (didn't bet)
Seat 4: 4dcDwIHRm96PwtqkpQiuiA (small blind) folded before Flop
Seat 5: d1puGuVBE0fidn+5eRJ0tw (big blind) folded on the Flop
Seat 6: B2Ih1sr5VZk+8He7rcrMtQ folded before Flop (didn't bet)



PokerStars Game #59941515372:  Hold'em No Limit ($1/$2) - 2009/07/01 1:37:48 ET
Table 'SF49/KQm8T4taMp6kb+HXA' 9-max Seat #2 is the button
Seat 1: CUZwDpLTQKhzarPe+JCLOQ ($303.15 in chips)
Seat 2: rW/MyplHylMSBRaoRUzWrg ($40 in chips)
Seat 3: pCmk6FpSOLJ+85o1tLHIag ($278.75 in chips)
Seat 4: HffgoYm61KgkdMe/DYChIQ ($268.25 in chips)
Seat 5: ri8CLkX3e9JF34dQNbsHGA ($43 in chips)
Seat 7: nXDI8Y/S6POzRwANu3d8hQ ($37 in chips)
Seat 8: GgrYze3jkUdSO7a7CuJGDw ($194 in chips)
Seat 9: /inIs/z/PcX+TniIFpaxpg ($317.15 in chips)
pCmk6FpSOLJ+85o1tLHIag: posts small blind $1
HffgoYm61KgkdMe/DYChIQ: posts big blind $2
*** HOLE CARDS ***
ri8CLkX3e9JF34dQNbsHGA: folds
nXDI8Y/S6POzRwANu3d8hQ: folds
GgrYze3jkUdSO7a7CuJGDw: folds
/inIs/z/PcX+TniIFpaxpg: folds
CUZwDpLTQKhzarPe+JCLOQ: folds
rW/MyplHylMSBRaoRUzWrg: folds
pCmk6FpSOLJ+85o1tLHIag: folds
HffgoYm61KgkdMe/DYChIQ collected $2 from pot
*** SUMMARY ***
Total pot $2 | Rake $0
Seat 1: CUZwDpLTQKhzarPe+JCLOQ folded before Flop (didn't bet)
Seat 2: rW/MyplHylMSBRaoRUzWrg (button) folded before Flop (didn't bet)
Seat 3: pCmk6FpSOLJ+85o1tLHIag (small blind) folded before Flop
Seat 4: HffgoYm61KgkdMe/DYChIQ (big blind) collected ($2)
Seat 5: ri8CLkX3e9JF34dQNbsHGA folded before Flop (didn't bet)
Seat 7: nXDI8Y/S6POzRwANu3d8hQ folded before Flop (didn't bet)
Seat 8: GgrYze3jkUdSO7a7CuJGDw folded before Flop (didn't bet)
Seat 9: /inIs/z/PcX+TniIFpaxpg folded before Flop (didn't bet)



PokerStars Game #59941515476:  Hold'em No Limit ($1/$2) - 2009/07/01 1:37:48 ET
Table 'eyAQSIlgc2o1Jxvbve4WGg' 9-max Seat #8 is the button
Seat 1: UZEsV9yKUMqmpYPiOFpaZw ($100.20 in chips)
Seat 2: kM9CA+2UcdMjbCMbtUCGiA ($203 in chips)
Seat 4: CkE3IyJF1KvdaAOmZY5XqQ ($200 in chips)
Seat 5: mIKx5lhIt13X5eZQH0ZeMA ($131.40 in chips)
Seat 6: nXDI8Y/S6POzRwANu3d8hQ ($31 in chips)
Seat 7: u3OrI5uGx9mx1fE7dgr+EA ($72.20 in chips)
Seat 8: 1CtiZuXDFaJL1dJPQKyi8Q ($152.95 in chips)
Seat 9: WUlHm+ydPPHG7Lb0rePSdA ($144.20 in chips)
WUlHm+ydPPHG7Lb0rePSdA: posts small blind $1
UZEsV9yKUMqmpYPiOFpaZw: posts big blind $2
*** HOLE CARDS ***
kM9CA+2UcdMjbCMbtUCGiA: folds
CkE3IyJF1KvdaAOmZY5XqQ has timed out
CkE3IyJF1KvdaAOmZY5XqQ: folds
CkE3IyJF1KvdaAOmZY5XqQ is sitting out
mIKx5lhIt13X5eZQH0ZeMA: folds
CkE3IyJF1KvdaAOmZY5XqQ has returned
nXDI8Y/S6POzRwANu3d8hQ: folds
u3OrI5uGx9mx1fE7dgr+EA: calls $2
1CtiZuXDFaJL1dJPQKyi8Q: folds
WUlHm+ydPPHG7Lb0rePSdA: folds
UZEsV9yKUMqmpYPiOFpaZw: checks
*** FLOP *** [9d Kc Jd]
UZEsV9yKUMqmpYPiOFpaZw: checks
u3OrI5uGx9mx1fE7dgr+EA: bets $2
UZEsV9yKUMqmpYPiOFpaZw: calls $2
*** TURN *** [9d Kc Jd] [8s]
UZEsV9yKUMqmpYPiOFpaZw: checks
u3OrI5uGx9mx1fE7dgr+EA: checks
*** RIVER *** [9d Kc Jd 8s] [Kd]
UZEsV9yKUMqmpYPiOFpaZw: checks
u3OrI5uGx9mx1fE7dgr+EA: bets $6
UZEsV9yKUMqmpYPiOFpaZw: folds
u3OrI5uGx9mx1fE7dgr+EA collected $8.60 from pot
u3OrI5uGx9mx1fE7dgr+EA: doesn't show hand
*** SUMMARY ***
Total pot $9 | Rake $0.40
Board [9d Kc Jd 8s Kd]
Seat 1: UZEsV9yKUMqmpYPiOFpaZw (big blind) folded on the River
Seat 2: kM9CA+2UcdMjbCMbtUCGiA folded before Flop (didn't bet)
Seat 4: CkE3IyJF1KvdaAOmZY5XqQ folded before Flop (didn't bet)
Seat 5: mIKx5lhIt13X5eZQH0ZeMA folded before Flop (didn't bet)
Seat 6: nXDI8Y/S6POzRwANu3d8hQ folded before Flop (didn't bet)
Seat 7: u3OrI5uGx9mx1fE7dgr+EA collected ($8.60)
Seat 8: 1CtiZuXDFaJL1dJPQKyi8Q (button) folded before Flop (didn't bet)
Seat 9: WUlHm+ydPPHG7Lb0rePSdA (small blind) folded before Flop



PokerStars Game #59941515682:  Hold'em No Limit ($1/$2) - 2009/07/01 1:37:49 ET
Table 'YqGfR5eHfMeSjb9a+QU9rg' 9-max Seat #6 is the button
Seat 1: rW/MyplHylMSBRaoRUzWrg ($39 in chips)
Seat 3: /gll27k+xWYV7Fbki0lFDQ ($258.75 in chips)
Seat 4: GX1heJ+DSsvm7gzSPsYhhQ ($34 in chips)
Seat 5: CkE3IyJF1KvdaAOmZY5XqQ ($201.75 in chips)
Seat 6: TAfo4veNRaRlzDXMMYS3Jg ($37 in chips)
Seat 7: 41aZuLBz9nAi2GPVKabmCw ($97.95 in chips)
Seat 8: JnV3SM2D6dAFYyGZHHpvrg ($93.25 in chips)
Seat 9: /inIs/z/PcX+TniIFpaxpg ($202.20 in chips)
41aZuLBz9nAi2GPVKabmCw: posts small blind $1
JnV3SM2D6dAFYyGZHHpvrg: posts big blind $2
nXDI8Y/S6POzRwANu3d8hQ: sits out
*** HOLE CARDS ***
/inIs/z/PcX+TniIFpaxpg: folds
rW/MyplHylMSBRaoRUzWrg: folds
/gll27k+xWYV7Fbki0lFDQ: folds
GX1heJ+DSsvm7gzSPsYhhQ: folds
CkE3IyJF1KvdaAOmZY5XqQ has timed out
CkE3IyJF1KvdaAOmZY5XqQ: folds
CkE3IyJF1KvdaAOmZY5XqQ is sitting out
CkE3IyJF1KvdaAOmZY5XqQ has returned
TAfo4veNRaRlzDXMMYS3Jg: raises $35 to $37 and is all-in
41aZuLBz9nAi2GPVKabmCw: folds
JnV3SM2D6dAFYyGZHHpvrg: folds
TAfo4veNRaRlzDXMMYS3Jg collected $5 from pot
TAfo4veNRaRlzDXMMYS3Jg: doesn't show hand
*** SUMMARY ***
Total pot $5 | Rake $0
Seat 1: rW/MyplHylMSBRaoRUzWrg folded before Flop (didn't bet)
Seat 3: /gll27k+xWYV7Fbki0lFDQ folded before Flop (didn't bet)
Seat 4: GX1heJ+DSsvm7gzSPsYhhQ folded before Flop (didn't bet)
Seat 5: CkE3IyJF1KvdaAOmZY5XqQ folded before Flop (didn't bet)
Seat 6: TAfo4veNRaRlzDXMMYS3Jg (button) collected ($5)
Seat 7: 41aZuLBz9nAi2GPVKabmCw (small blind) folded before Flop
Seat 8: JnV3SM2D6dAFYyGZHHpvrg (big blind) folded before Flop
Seat 9: /inIs/z/PcX+TniIFpaxpg folded before Flop (didn't bet)



PokerStars Game #59941516668:  Hold'em No Limit ($1/$2) - 2009/07/01 1:37:51 ET
Table '3WCXyaiCAbqSShQu7FIjvA' 9-max Seat #6 is the button
Seat 1: kTCkABD1UUldS9DFRGfCwQ ($154.75 in chips)
Seat 2: TAfo4veNRaRlzDXMMYS3Jg ($37 in chips)
Seat 3: 5Q8U6iZbeO7xJSS4qvDP5g ($273.85 in chips)
Seat 4: waEF/+pxZTxNo4FvsORuXg ($76.40 in chips)
Seat 5: CkE3IyJF1KvdaAOmZY5XqQ ($200 in chips)
Seat 6: 5jQlngvMSqM/WoonOcR5kw ($288.35 in chips)
Seat 7: nXDI8Y/S6POzRwANu3d8hQ ($38 in chips)
Seat 8: 1CtiZuXDFaJL1dJPQKyi8Q ($237.05 in chips)
Seat 9: FiXPLJyqb24l32QST2TInw ($110.40 in chips)
nXDI8Y/S6POzRwANu3d8hQ: posts small blind $1
1CtiZuXDFaJL1dJPQKyi8Q: posts big blind $2
*** HOLE CARDS ***
FiXPLJyqb24l32QST2TInw: folds
kTCkABD1UUldS9DFRGfCwQ: folds
TAfo4veNRaRlzDXMMYS3Jg: folds
5Q8U6iZbeO7xJSS4qvDP5g: folds
waEF/+pxZTxNo4FvsORuXg: raises $6 to $8
CkE3IyJF1KvdaAOmZY5XqQ: folds
5jQlngvMSqM/WoonOcR5kw: folds
nXDI8Y/S6POzRwANu3d8hQ: folds
1CtiZuXDFaJL1dJPQKyi8Q: calls $6
*** FLOP *** [9c 8c Tc]
1CtiZuXDFaJL1dJPQKyi8Q: checks
waEF/+pxZTxNo4FvsORuXg: bets $8
1CtiZuXDFaJL1dJPQKyi8Q: calls $8
*** TURN *** [9c 8c Tc] [Ts]
FiXPLJyqb24l32QST2TInw is sitting out
1CtiZuXDFaJL1dJPQKyi8Q: bets $16
waEF/+pxZTxNo4FvsORuXg: calls $16
*** RIVER *** [9c 8c Tc Ts] [3d]
1CtiZuXDFaJL1dJPQKyi8Q: checks
waEF/+pxZTxNo4FvsORuXg: checks
*** SHOW DOWN ***
1CtiZuXDFaJL1dJPQKyi8Q: shows [Kh Qh] (a pair of Tens)
waEF/+pxZTxNo4FvsORuXg: shows [As Ah] (two pair, Aces and Tens)
waEF/+pxZTxNo4FvsORuXg collected $62 from pot
*** SUMMARY ***
Total pot $65 | Rake $3
Board [9c 8c Tc Ts 3d]
Seat 1: kTCkABD1UUldS9DFRGfCwQ folded before Flop (didn't bet)
Seat 2: TAfo4veNRaRlzDXMMYS3Jg folded before Flop (didn't bet)
Seat 3: 5Q8U6iZbeO7xJSS4qvDP5g folded before Flop (didn't bet)
Seat 4: waEF/+pxZTxNo4FvsORuXg showed [As Ah] and won ($62) with two pair, Aces and Tens
Seat 5: CkE3IyJF1KvdaAOmZY5XqQ folded before Flop (didn't bet)
Seat 6: 5jQlngvMSqM/WoonOcR5kw (button) folded before Flop (didn't bet)
Seat 7: nXDI8Y/S6POzRwANu3d8hQ (small blind) folded before Flop
Seat 8: 1CtiZuXDFaJL1dJPQKyi8Q (big blind) showed [Kh Qh] and lost with a pair of Tens
Seat 9: FiXPLJyqb24l32QST2TInw folded before Flop (didn't bet)



PokerStars Game #59941517270:  Hold'em No Limit ($1/$2) - 2009/07/01 1:37:52 ET
Table 'G1Oqdy4Pqdb5gtx40rUBzA' 6-max Seat #6 is the button
Seat 2: 4uqU0dG67owXuPz303Al4w ($517.60 in chips)
Seat 3: VvdR9F3I+2yELkfTVvC1dg ($230.90 in chips)
Seat 4: B87ikIyZ/TzAVeXf38Ny0g ($211.55 in chips)
Seat 5: F1+Ml47qRQWunzPnGhLLzQ ($203.65 in chips)
Seat 6: qCnEYuAE5y5A7bk6fO5/jQ ($200 in chips)
4uqU0dG67owXuPz303Al4w: posts small blind $1
VvdR9F3I+2yELkfTVvC1dg: posts big blind $2
*** HOLE CARDS ***
B87ikIyZ/TzAVeXf38Ny0g: folds
F1+Ml47qRQWunzPnGhLLzQ: folds
qCnEYuAE5y5A7bk6fO5/jQ: folds
4uqU0dG67owXuPz303Al4w: raises $6 to $8
VvdR9F3I+2yELkfTVvC1dg: folds
4uqU0dG67owXuPz303Al4w collected $4 from pot
*** SUMMARY ***
Total pot $4 | Rake $0
Seat 2: 4uqU0dG67owXuPz303Al4w (small blind) collected ($4)
Seat 3: VvdR9F3I+2yELkfTVvC1dg (big blind) folded before Flop
Seat 4: B87ikIyZ/TzAVeXf38Ny0g folded before Flop (didn't bet)
Seat 5: F1+Ml47qRQWunzPnGhLLzQ folded before Flop (didn't bet)
Seat 6: qCnEYuAE5y5A7bk6fO5/jQ (button) folded before Flop (didn't bet)



PokerStars Game #59941517580:  Hold'em No Limit ($1/$2) - 2009/07/01 1:37:52 ET
Table 'P/yCfYl1GfGsu/e6DxDy/A' 2-max Seat #1 is the button
Seat 1: 7fOCUy3x9hdkmXkkDNolGQ ($470 in chips)
Seat 2: RwDoM55ZeQuI2ADyJhOb2Q ($1009 in chips)
7fOCUy3x9hdkmXkkDNolGQ: posts small blind $1
RwDoM55ZeQuI2ADyJhOb2Q: posts big blind $2
*** HOLE CARDS ***
7fOCUy3x9hdkmXkkDNolGQ: raises $4 to $6
RwDoM55ZeQuI2ADyJhOb2Q: raises $10 to $16
7fOCUy3x9hdkmXkkDNolGQ: raises $39 to $55
RwDoM55ZeQuI2ADyJhOb2Q: folds
7fOCUy3x9hdkmXkkDNolGQ collected $32 from pot
7fOCUy3x9hdkmXkkDNolGQ: doesn't show hand
*** SUMMARY ***
Total pot $32 | Rake $0
Seat 1: 7fOCUy3x9hdkmXkkDNolGQ (button) (small blind) collected ($32)
Seat 2: RwDoM55ZeQuI2ADyJhOb2Q (big blind) folded before Flop



PokerStars Game #59941519200:  Hold'em No Limit ($1/$2) - 2009/07/01 1:37:55 ET
Table '/ci73fTmzTzmGWzAtqEX2Q' 9-max Seat #2 is the button
Seat 1: 9efVc1cB3yHt4TvBkTusPw ($147.90 in chips)
Seat 2: pN/Ip0ePsUVIdUlGgLrkUw ($222 in chips)
Seat 3: kK1+5ivyJZeA8hQF2pdvvQ ($62.55 in chips)
Seat 4: 2yq7Zp4xmrhAw8+37hTkaA ($169.20 in chips)
Seat 5: 1CtiZuXDFaJL1dJPQKyi8Q ($178.60 in chips)
Seat 6: GX1heJ+DSsvm7gzSPsYhhQ ($89.30 in chips)
Seat 8: /inIs/z/PcX+TniIFpaxpg ($34 in chips)
Seat 9: S8aS+9FTYQ/ICLBNThcrkg ($179 in chips)
kK1+5ivyJZeA8hQF2pdvvQ: posts small blind $1
2yq7Zp4xmrhAw8+37hTkaA: posts big blind $2
+T/63sAeZzWyHchahJ36GQ: sits out
*** HOLE CARDS ***
1CtiZuXDFaJL1dJPQKyi8Q: folds
GX1heJ+DSsvm7gzSPsYhhQ: folds
/inIs/z/PcX+TniIFpaxpg: folds
S8aS+9FTYQ/ICLBNThcrkg: folds
9efVc1cB3yHt4TvBkTusPw: folds
pN/Ip0ePsUVIdUlGgLrkUw: raises $4 to $6
kK1+5ivyJZeA8hQF2pdvvQ: folds
2yq7Zp4xmrhAw8+37hTkaA: folds
pN/Ip0ePsUVIdUlGgLrkUw collected $5 from pot
*** SUMMARY ***
Total pot $5 | Rake $0
Seat 1: 9efVc1cB3yHt4TvBkTusPw folded before Flop (didn't bet)
Seat 2: pN/Ip0ePsUVIdUlGgLrkUw (button) collected ($5)
Seat 3: kK1+5ivyJZeA8hQF2pdvvQ (small blind) folded before Flop
Seat 4: 2yq7Zp4xmrhAw8+37hTkaA (big blind) folded before Flop
Seat 5: 1CtiZuXDFaJL1dJPQKyi8Q folded before Flop (didn't bet)
Seat 6: GX1heJ+DSsvm7gzSPsYhhQ folded before Flop (didn't bet)
Seat 8: /inIs/z/PcX+TniIFpaxpg folded before Flop (didn't bet)
Seat 9: S8aS+9FTYQ/ICLBNThcrkg folded before Flop (didn't bet)



PokerStars Game #59941519224:  Hold'em No Limit ($1/$2) - 2009/07/01 1:37:55 ET
Table 'kq5zaQ+1hLNf8LZfGnbTAA' 6-max Seat #4 is the button
Seat 1: 8srN1dKQePlsv0GyTada+Q ($430.60 in chips)
Seat 2: nXDI8Y/S6POzRwANu3d8hQ ($144 in chips)
Seat 3: /PH6Ffnho4Ysm8S3V/oa+w ($40 in chips)
Seat 4: 3dAbvkxS5NPQTBAbvpinVg ($275.45 in chips)
Seat 5: gnYme0DNFflnMhrdbxe1Ag ($224.35 in chips)
Seat 6: mfy7uGZcqA2PVQqEVbJ7+g ($199.45 in chips)
gnYme0DNFflnMhrdbxe1Ag: posts small blind $1
mfy7uGZcqA2PVQqEVbJ7+g: posts big blind $2
*** HOLE CARDS ***
8srN1dKQePlsv0GyTada+Q: folds
nXDI8Y/S6POzRwANu3d8hQ: folds
/PH6Ffnho4Ysm8S3V/oa+w: folds
3dAbvkxS5NPQTBAbvpinVg: raises $4 to $6
gnYme0DNFflnMhrdbxe1Ag: folds
mfy7uGZcqA2PVQqEVbJ7+g: folds
3dAbvkxS5NPQTBAbvpinVg collected $5 from pot
3dAbvkxS5NPQTBAbvpinVg: doesn't show hand
*** SUMMARY ***
Total pot $5 | Rake $0
Seat 1: 8srN1dKQePlsv0GyTada+Q folded before Flop (didn't bet)
Seat 2: nXDI8Y/S6POzRwANu3d8hQ folded before Flop (didn't bet)
Seat 3: /PH6Ffnho4Ysm8S3V/oa+w folded before Flop (didn't bet)
Seat 4: 3dAbvkxS5NPQTBAbvpinVg (button) collected ($5)
Seat 5: gnYme0DNFflnMhrdbxe1Ag (small blind) folded before Flop
Seat 6: mfy7uGZcqA2PVQqEVbJ7+g (big blind) folded before Flop



PokerStars Game #59941519808:  Hold'em No Limit ($1/$2) - 2009/07/01 1:37:56 ET
Table '/dyk+YdRGv90j2box35j8w' 6-max Seat #3 is the button
Seat 1: 8srN1dKQePlsv0GyTada+Q ($212.25 in chips)
Seat 2: qCnEYuAE5y5A7bk6fO5/jQ ($467.60 in chips)
Seat 3: sTPOWERd9HWPCNrDBwsVjA ($182.50 in chips)
Seat 5: VvdR9F3I+2yELkfTVvC1dg ($250 in chips)
Seat 6: gnYme0DNFflnMhrdbxe1Ag ($200 in chips)
VvdR9F3I+2yELkfTVvC1dg: posts small blind $1
gnYme0DNFflnMhrdbxe1Ag: posts big blind $2
*** HOLE CARDS ***
8srN1dKQePlsv0GyTada+Q: folds
qCnEYuAE5y5A7bk6fO5/jQ: raises $4 to $6
sTPOWERd9HWPCNrDBwsVjA: folds
z/u1YTnkiIDrtp/2cA2dBg has returned
VvdR9F3I+2yELkfTVvC1dg: folds
gnYme0DNFflnMhrdbxe1Ag: folds
qCnEYuAE5y5A7bk6fO5/jQ collected $5 from pot
qCnEYuAE5y5A7bk6fO5/jQ: doesn't show hand
*** SUMMARY ***
Total pot $5 | Rake $0
Seat 1: 8srN1dKQePlsv0GyTada+Q folded before Flop (didn't bet)
Seat 2: qCnEYuAE5y5A7bk6fO5/jQ collected ($5)
Seat 3: sTPOWERd9HWPCNrDBwsVjA (button) folded before Flop (didn't bet)
Seat 5: VvdR9F3I+2yELkfTVvC1dg (small blind) folded before Flop
Seat 6: gnYme0DNFflnMhrdbxe1Ag (big blind) folded before Flop



PokerStars Game #59941520226:  Hold'em No Limit ($1/$2) - 2009/07/01 1:37:57 ET
Table 'NmY84NAf9Mh0ckAckHnh5g' 2-max Seat #2 is the button
Seat 1: 6hvg964TSqZ3AL/0XK9aVQ ($442.80 in chips)
Seat 2: RwDoM55ZeQuI2ADyJhOb2Q ($552 in chips)
RwDoM55ZeQuI2ADyJhOb2Q: posts small blind $1
6hvg964TSqZ3AL/0XK9aVQ: posts big blind $2
*** HOLE CARDS ***
RwDoM55ZeQuI2ADyJhOb2Q: folds
6hvg964TSqZ3AL/0XK9aVQ collected $2 from pot
*** SUMMARY ***
Total pot $2 | Rake $0
Seat 1: 6hvg964TSqZ3AL/0XK9aVQ (big blind) collected ($2)
Seat 2: RwDoM55ZeQuI2ADyJhOb2Q (button) (small blind) folded before Flop



PokerStars Game #59941521890:  Hold'em No Limit ($1/$2) - 2009/07/01 1:38:00 ET
Table 'qVXak+oTeDXMGbWa4sDU5Q' 9-max Seat #1 is the button
Seat 1: H6Z4+qu8gR0VUiPOijndVg ($230.45 in chips)
Seat 3: WUlHm+ydPPHG7Lb0rePSdA ($173.10 in chips)
Seat 4: lQYT23h5QCUVZAKxjOO39Q ($198.70 in chips)
Seat 5: FWGiDqRwvLeKmHq9t4Jy9w ($265.80 in chips)
Seat 6: GX1heJ+DSsvm7gzSPsYhhQ ($43 in chips)
Seat 7: PfmlvZlFiss79a6IoEr11g ($134.30 in chips)
Seat 8: Z0rzUi0y1x80UdIpofoNbA ($109.55 in chips)
Seat 9: CkE3IyJF1KvdaAOmZY5XqQ ($215.55 in chips)
CST1bO+CmVQOtNgiT0cKPg will be allowed to play after the button
WUlHm+ydPPHG7Lb0rePSdA: posts small blind $1
lQYT23h5QCUVZAKxjOO39Q: posts big blind $2
*** HOLE CARDS ***
FWGiDqRwvLeKmHq9t4Jy9w: folds
FWGiDqRwvLeKmHq9t4Jy9w leaves the table
GX1heJ+DSsvm7gzSPsYhhQ: folds
PfmlvZlFiss79a6IoEr11g: raises $4 to $6
Z0rzUi0y1x80UdIpofoNbA: folds
zJtQ1gxyi72XvGYS1tM+DA joins the table at seat #5
CkE3IyJF1KvdaAOmZY5XqQ: folds
H6Z4+qu8gR0VUiPOijndVg: folds
WUlHm+ydPPHG7Lb0rePSdA: folds
lQYT23h5QCUVZAKxjOO39Q: calls $4
*** FLOP *** [Tc 6h 2d]
lQYT23h5QCUVZAKxjOO39Q: bets $6
PfmlvZlFiss79a6IoEr11g: calls $6
*** TURN *** [Tc 6h 2d] [6d]
lQYT23h5QCUVZAKxjOO39Q: bets $10
PfmlvZlFiss79a6IoEr11g: calls $10
*** RIVER *** [Tc 6h 2d 6d] [4c]
lQYT23h5QCUVZAKxjOO39Q: bets $14
PfmlvZlFiss79a6IoEr11g: raises $24 to $38
lQYT23h5QCUVZAKxjOO39Q: folds
PfmlvZlFiss79a6IoEr11g collected $70 from pot
*** SUMMARY ***
Total pot $73 | Rake $3
Board [Tc 6h 2d 6d 4c]
Seat 1: H6Z4+qu8gR0VUiPOijndVg (button) folded before Flop (didn't bet)
Seat 3: WUlHm+ydPPHG7Lb0rePSdA (small blind) folded before Flop
Seat 4: lQYT23h5QCUVZAKxjOO39Q (big blind) folded on the River
Seat 5: FWGiDqRwvLeKmHq9t4Jy9w folded before Flop (didn't bet)
Seat 6: GX1heJ+DSsvm7gzSPsYhhQ folded before Flop (didn't bet)
Seat 7: PfmlvZlFiss79a6IoEr11g collected ($70)
Seat 8: Z0rzUi0y1x80UdIpofoNbA folded before Flop (didn't bet)
Seat 9: CkE3IyJF1KvdaAOmZY5XqQ folded before Flop (didn't bet)



PokerStars Game #59941522618:  Hold'em No Limit ($1/$2) - 2009/07/01 1:38:01 ET
Table 'uJ9juaXXg9yIcSU8amxaXQ' 6-max Seat #4 is the button
Seat 1: JsqOjN/eHz0uYVf/PyUJ6Q ($153.25 in chips)
Seat 2: VvdR9F3I+2yELkfTVvC1dg ($223.10 in chips)
Seat 3: qXDd0ZyMIse0OBu8pxeQ3Q ($243.40 in chips)
Seat 4: zNjJ/y4emmF+vzrCDd+ooA ($222.05 in chips)
Seat 5: YsLQ3BAvgQHWXMAv3Wv6Hg ($206.70 in chips)
Seat 6: /PH6Ffnho4Ysm8S3V/oa+w ($40 in chips)
YsLQ3BAvgQHWXMAv3Wv6Hg: posts small blind $1
/PH6Ffnho4Ysm8S3V/oa+w: posts big blind $2
*** HOLE CARDS ***
JsqOjN/eHz0uYVf/PyUJ6Q: folds
VvdR9F3I+2yELkfTVvC1dg: folds
qXDd0ZyMIse0OBu8pxeQ3Q: raises $5 to $7
zNjJ/y4emmF+vzrCDd+ooA: folds
YsLQ3BAvgQHWXMAv3Wv6Hg: folds
/PH6Ffnho4Ysm8S3V/oa+w: folds
qXDd0ZyMIse0OBu8pxeQ3Q collected $5 from pot
*** SUMMARY ***
Total pot $5 | Rake $0
Seat 1: JsqOjN/eHz0uYVf/PyUJ6Q folded before Flop (didn't bet)
Seat 2: VvdR9F3I+2yELkfTVvC1dg folded before Flop (didn't bet)
Seat 3: qXDd0ZyMIse0OBu8pxeQ3Q collected ($5)
Seat 4: zNjJ/y4emmF+vzrCDd+ooA (button) folded before Flop (didn't bet)
Seat 5: YsLQ3BAvgQHWXMAv3Wv6Hg (small blind) folded before Flop
Seat 6: /PH6Ffnho4Ysm8S3V/oa+w (big blind) folded before Flop



PokerStars Game #59941522790:  Hold'em No Limit ($1/$2) - 2009/07/01 1:38:02 ET
Table 'ztv6V3FN2bQ9nmJPPdx6nQ' 6-max Seat #3 is the button
Seat 1: 6fLdOUCRtX71xbVRhJEq8w ($238.35 in chips)
Seat 2: 5Y+ZGWLI4gnlpApDX5vy1A ($391.15 in chips)
Seat 3: ubtx4Z5L+AcK71MTvYiGVw ($245 in chips)
Seat 4: UaZ5yj+6LjtWqMQg2QskUw ($90.30 in chips)
Seat 5: sTPOWERd9HWPCNrDBwsVjA ($219.80 in chips)
Seat 6: mfy7uGZcqA2PVQqEVbJ7+g ($112.60 in chips)
UaZ5yj+6LjtWqMQg2QskUw: posts small blind $1
sTPOWERd9HWPCNrDBwsVjA: posts big blind $2
*** HOLE CARDS ***
mfy7uGZcqA2PVQqEVbJ7+g: folds
6fLdOUCRtX71xbVRhJEq8w: folds
5Y+ZGWLI4gnlpApDX5vy1A: folds
ubtx4Z5L+AcK71MTvYiGVw: folds
UaZ5yj+6LjtWqMQg2QskUw: calls $1
sTPOWERd9HWPCNrDBwsVjA: checks
*** FLOP *** [3s 7d 9c]
UaZ5yj+6LjtWqMQg2QskUw: checks
sTPOWERd9HWPCNrDBwsVjA: bets $4
UaZ5yj+6LjtWqMQg2QskUw: folds
sTPOWERd9HWPCNrDBwsVjA collected $3.80 from pot
*** SUMMARY ***
Total pot $4 | Rake $0.20
Board [3s 7d 9c]
Seat 1: 6fLdOUCRtX71xbVRhJEq8w folded before Flop (didn't bet)
Seat 2: 5Y+ZGWLI4gnlpApDX5vy1A folded before Flop (didn't bet)
Seat 3: ubtx4Z5L+AcK71MTvYiGVw (button) folded before Flop (didn't bet)
Seat 4: UaZ5yj+6LjtWqMQg2QskUw (small blind) folded on the Flop
Seat 5: sTPOWERd9HWPCNrDBwsVjA (big blind) collected ($3.80)
Seat 6: mfy7uGZcqA2PVQqEVbJ7+g folded before Flop (didn't bet)



PokerStars Game #59941523476:  Hold'em No Limit ($1/$2) - 2009/07/01 1:38:03 ET
Table 'NmY84NAf9Mh0ckAckHnh5g' 2-max Seat #1 is the button
Seat 1: 6hvg964TSqZ3AL/0XK9aVQ ($443.80 in chips)
Seat 2: RwDoM55ZeQuI2ADyJhOb2Q ($551 in chips)
6hvg964TSqZ3AL/0XK9aVQ: posts small blind $1
RwDoM55ZeQuI2ADyJhOb2Q: posts big blind $2
*** HOLE CARDS ***
6hvg964TSqZ3AL/0XK9aVQ: calls $1
RwDoM55ZeQuI2ADyJhOb2Q: checks
*** FLOP *** [5s 7h 6h]
RwDoM55ZeQuI2ADyJhOb2Q: checks
6hvg964TSqZ3AL/0XK9aVQ: checks
*** TURN *** [5s 7h 6h] [Qd]
RwDoM55ZeQuI2ADyJhOb2Q: checks
6hvg964TSqZ3AL/0XK9aVQ: checks
*** RIVER *** [5s 7h 6h Qd] [Ac]
RwDoM55ZeQuI2ADyJhOb2Q: checks
6hvg964TSqZ3AL/0XK9aVQ: checks
*** SHOW DOWN ***
RwDoM55ZeQuI2ADyJhOb2Q: shows [Jc 3c] (high card Ace)
6hvg964TSqZ3AL/0XK9aVQ: shows [Kd 8s] (high card Ace - King kicker)
6hvg964TSqZ3AL/0XK9aVQ collected $3.80 from pot
*** SUMMARY ***
Total pot $4 | Rake $0.20
Board [5s 7h 6h Qd Ac]
Seat 1: 6hvg964TSqZ3AL/0XK9aVQ (button) (small blind) showed [Kd 8s] and won ($3.80) with high card Ace
Seat 2: RwDoM55ZeQuI2ADyJhOb2Q (big blind) showed [Jc 3c] and lost with high card Ace



PokerStars Game #59941525296:  Hold'em No Limit ($1/$2) - 2009/07/01 1:38:06 ET
Table 'CFkQcfWjKccZaZDf71FK+w' 6-max Seat #5 is the button
Seat 1: vkfxu8f/jMYKUk6Ly4eujw ($225.40 in chips)
Seat 2: ewN/vzF22+/gdzjIKBOlkA ($216.05 in chips)
Seat 3: 09BNF4quPDzanQzM8vc6WA ($43.65 in chips)
Seat 4: ygTTt5ehT4aF86q1a8/R+w ($246.35 in chips)
Seat 5: 2lOU1DcvUZaMcxZ95XfzXw ($112.60 in chips)
Seat 6: ORVqY3rf9X6ANA/8s+On2Q ($118.60 in chips)
ORVqY3rf9X6ANA/8s+On2Q: posts small blind $1
vkfxu8f/jMYKUk6Ly4eujw: posts big blind $2
*** HOLE CARDS ***
ewN/vzF22+/gdzjIKBOlkA: raises $6 to $8
09BNF4quPDzanQzM8vc6WA: folds
ygTTt5ehT4aF86q1a8/R+w: folds
2lOU1DcvUZaMcxZ95XfzXw: calls $8
ORVqY3rf9X6ANA/8s+On2Q: calls $7
vkfxu8f/jMYKUk6Ly4eujw: folds
*** FLOP *** [6c Ac 8d]
ORVqY3rf9X6ANA/8s+On2Q: bets $10
ewN/vzF22+/gdzjIKBOlkA: folds
2lOU1DcvUZaMcxZ95XfzXw: raises $10 to $20
ORVqY3rf9X6ANA/8s+On2Q: calls $10
*** TURN *** [6c Ac 8d] [5h]
ORVqY3rf9X6ANA/8s+On2Q: checks
2lOU1DcvUZaMcxZ95XfzXw: bets $26
ORVqY3rf9X6ANA/8s+On2Q: calls $26
*** RIVER *** [6c Ac 8d 5h] [Th]
ORVqY3rf9X6ANA/8s+On2Q: checks
2lOU1DcvUZaMcxZ95XfzXw: bets $18
ORVqY3rf9X6ANA/8s+On2Q: calls $18
*** SHOW DOWN ***
2lOU1DcvUZaMcxZ95XfzXw: shows [Ad Ks] (a pair of Aces)
ORVqY3rf9X6ANA/8s+On2Q: mucks hand
2lOU1DcvUZaMcxZ95XfzXw collected $151 from pot
*** SUMMARY ***
Total pot $154 | Rake $3
Board [6c Ac 8d 5h Th]
Seat 1: vkfxu8f/jMYKUk6Ly4eujw (big blind) folded before Flop
Seat 2: ewN/vzF22+/gdzjIKBOlkA folded on the Flop
Seat 3: 09BNF4quPDzanQzM8vc6WA folded before Flop (didn't bet)
Seat 4: ygTTt5ehT4aF86q1a8/R+w folded before Flop (didn't bet)
Seat 5: 2lOU1DcvUZaMcxZ95XfzXw (button) showed [Ad Ks] and won ($151) with a pair of Aces
Seat 6: ORVqY3rf9X6ANA/8s+On2Q (small blind) mucked



PokerStars Game #59941526244:  Hold'em No Limit ($1/$2) - 2009/07/01 1:38:08 ET
Table 'UGLAZZyv+cXmnKjYin0etA' 6-max Seat #4 is the button
Seat 1: vkfxu8f/jMYKUk6Ly4eujw ($201 in chips)
Seat 2: eDLH1PUXFpvJBNMXBVQcGA ($313.10 in chips)
Seat 3: ygTTt5ehT4aF86q1a8/R+w ($114.20 in chips)
Seat 4: SiGJDsvRViJX05vHhA80GQ ($231.85 in chips)
Seat 5: 54yWzRRgS0oZ+S6LwZBxMQ ($40 in chips)
Seat 6: sTPOWERd9HWPCNrDBwsVjA ($210.10 in chips)
54yWzRRgS0oZ+S6LwZBxMQ: posts small blind $1
sTPOWERd9HWPCNrDBwsVjA: posts big blind $2
*** HOLE CARDS ***
vkfxu8f/jMYKUk6Ly4eujw: folds
eDLH1PUXFpvJBNMXBVQcGA: folds
ygTTt5ehT4aF86q1a8/R+w: folds
SiGJDsvRViJX05vHhA80GQ: folds
54yWzRRgS0oZ+S6LwZBxMQ: calls $1
sTPOWERd9HWPCNrDBwsVjA: checks
*** FLOP *** [2s 6c 8c]
54yWzRRgS0oZ+S6LwZBxMQ: bets $4
sTPOWERd9HWPCNrDBwsVjA: calls $4
*** TURN *** [2s 6c 8c] [Ah]
54yWzRRgS0oZ+S6LwZBxMQ: bets $4
sTPOWERd9HWPCNrDBwsVjA: raises $12 to $16
54yWzRRgS0oZ+S6LwZBxMQ: folds
sTPOWERd9HWPCNrDBwsVjA collected $19.05 from pot
*** SUMMARY ***
Total pot $20 | Rake $0.95
Board [2s 6c 8c Ah]
Seat 1: vkfxu8f/jMYKUk6Ly4eujw folded before Flop (didn't bet)
Seat 2: eDLH1PUXFpvJBNMXBVQcGA folded before Flop (didn't bet)
Seat 3: ygTTt5ehT4aF86q1a8/R+w folded before Flop (didn't bet)
Seat 4: SiGJDsvRViJX05vHhA80GQ (button) folded before Flop (didn't bet)
Seat 5: 54yWzRRgS0oZ+S6LwZBxMQ (small blind) folded on the Turn
Seat 6: sTPOWERd9HWPCNrDBwsVjA (big blind) collected ($19.05)



PokerStars Game #59941526350:  Hold'em No Limit ($1/$2) - 2009/07/01 1:38:08 ET
Table 'rKeCh+eBn4RNvybCUYkoTQ' 9-max Seat #8 is the button
Seat 1: /inIs/z/PcX+TniIFpaxpg ($198 in chips)
Seat 3: GX1heJ+DSsvm7gzSPsYhhQ ($49 in chips)
Seat 5: WUlHm+ydPPHG7Lb0rePSdA ($122 in chips)
Seat 6: EBV6OktyeSmh4w6sWmcWOw ($286.80 in chips)
Seat 7: rW/MyplHylMSBRaoRUzWrg ($28 in chips)
Seat 8: pN/Ip0ePsUVIdUlGgLrkUw ($246.35 in chips)
Seat 9: Kzta8yu9vxHT4B70mjBZ+w ($215.25 in chips)
Kzta8yu9vxHT4B70mjBZ+w: posts small blind $1
/inIs/z/PcX+TniIFpaxpg: posts big blind $2
nXDI8Y/S6POzRwANu3d8hQ: sits out
*** HOLE CARDS ***
GX1heJ+DSsvm7gzSPsYhhQ: folds
WUlHm+ydPPHG7Lb0rePSdA: folds
EBV6OktyeSmh4w6sWmcWOw: folds
rW/MyplHylMSBRaoRUzWrg: folds
pN/Ip0ePsUVIdUlGgLrkUw: folds
Kzta8yu9vxHT4B70mjBZ+w: raises $4 to $6
/inIs/z/PcX+TniIFpaxpg: folds
Kzta8yu9vxHT4B70mjBZ+w collected $4 from pot
Kzta8yu9vxHT4B70mjBZ+w: doesn't show hand
*** SUMMARY ***
Total pot $4 | Rake $0
Seat 1: /inIs/z/PcX+TniIFpaxpg (big blind) folded before Flop
Seat 3: GX1heJ+DSsvm7gzSPsYhhQ folded before Flop (didn't bet)
Seat 5: WUlHm+ydPPHG7Lb0rePSdA folded before Flop (didn't bet)
Seat 6: EBV6OktyeSmh4w6sWmcWOw folded before Flop (didn't bet)
Seat 7: rW/MyplHylMSBRaoRUzWrg folded before Flop (didn't bet)
Seat 8: pN/Ip0ePsUVIdUlGgLrkUw (button) folded before Flop (didn't bet)
Seat 9: Kzta8yu9vxHT4B70mjBZ+w (small blind) collected ($4)



PokerStars Game #59941527336:  Hold'em No Limit ($1/$2) - 2009/07/01 1:38:10 ET
Table 'W9UeSV0aoPjh5SFSxM8jUQ' 9-max Seat #7 is the button
Seat 1: mIKx5lhIt13X5eZQH0ZeMA ($34.85 in chips)
Seat 3: /inIs/z/PcX+TniIFpaxpg ($22 in chips)
Seat 4: 4YA/sQy1Emm680zhbPUjow ($156.60 in chips)
Seat 5: ri8CLkX3e9JF34dQNbsHGA ($40 in chips)
Seat 7: I2ipWauytvrkEer4XD3Sjg ($72.70 in chips)
Seat 8: odhvI/CZeMsPyo1n1U7+hA ($27.05 in chips)
Seat 9: Q104K4iDGcqOlVrjAkzPEA ($102 in chips)
odhvI/CZeMsPyo1n1U7+hA: posts small blind $1
Q104K4iDGcqOlVrjAkzPEA: posts big blind $2
KqHysDSpCPaPyK3tJC1aEw: sits out
254YPxPJr5Sw58bkD0YqYQ: sits out
*** HOLE CARDS ***
mIKx5lhIt13X5eZQH0ZeMA: folds
/inIs/z/PcX+TniIFpaxpg: folds
4YA/sQy1Emm680zhbPUjow: folds
ri8CLkX3e9JF34dQNbsHGA: folds
I2ipWauytvrkEer4XD3Sjg: folds
I2ipWauytvrkEer4XD3Sjg leaves the table
TAfo4veNRaRlzDXMMYS3Jg joins the table at seat #7
odhvI/CZeMsPyo1n1U7+hA: calls $1
Q104K4iDGcqOlVrjAkzPEA: checks
*** FLOP *** [Js 9c 3s]
odhvI/CZeMsPyo1n1U7+hA: checks
Q104K4iDGcqOlVrjAkzPEA: bets $4
odhvI/CZeMsPyo1n1U7+hA: folds
Q104K4iDGcqOlVrjAkzPEA collected $3.80 from pot
*** SUMMARY ***
Total pot $4 | Rake $0.20
Board [Js 9c 3s]
Seat 1: mIKx5lhIt13X5eZQH0ZeMA folded before Flop (didn't bet)
Seat 3: /inIs/z/PcX+TniIFpaxpg folded before Flop (didn't bet)
Seat 4: 4YA/sQy1Emm680zhbPUjow folded before Flop (didn't bet)
Seat 5: ri8CLkX3e9JF34dQNbsHGA folded before Flop (didn't bet)
Seat 7: I2ipWauytvrkEer4XD3Sjg (button) folded before Flop (didn't bet)
Seat 8: odhvI/CZeMsPyo1n1U7+hA (small blind) folded on the Flop
Seat 9: Q104K4iDGcqOlVrjAkzPEA (big blind) collected ($3.80)



PokerStars Game #59941527310:  Hold'em No Limit ($1/$2) - 2009/07/01 1:38:10 ET
Table 'P/yCfYl1GfGsu/e6DxDy/A' 2-max Seat #2 is the button
Seat 1: 7fOCUy3x9hdkmXkkDNolGQ ($486 in chips)
Seat 2: RwDoM55ZeQuI2ADyJhOb2Q ($993 in chips)
RwDoM55ZeQuI2ADyJhOb2Q: posts small blind $1
7fOCUy3x9hdkmXkkDNolGQ: posts big blind $2
*** HOLE CARDS ***
RwDoM55ZeQuI2ADyJhOb2Q: raises $4 to $6
7fOCUy3x9hdkmXkkDNolGQ: folds
RwDoM55ZeQuI2ADyJhOb2Q collected $4 from pot
RwDoM55ZeQuI2ADyJhOb2Q: doesn't show hand
*** SUMMARY ***
Total pot $4 | Rake $0
Seat 1: 7fOCUy3x9hdkmXkkDNolGQ (big blind) folded before Flop
Seat 2: RwDoM55ZeQuI2ADyJhOb2Q (button) (small blind) collected ($4)



PokerStars Game #59941528660:  Hold'em No Limit ($1/$2) - 2009/07/01 1:38:12 ET
Table 'ZzSIe0zTCDv+n6hfbY5tTg' 6-max Seat #5 is the button
Seat 1: VvdR9F3I+2yELkfTVvC1dg ($237 in chips)
Seat 2: B87ikIyZ/TzAVeXf38Ny0g ($237 in chips)
Seat 3: gsugPj31Hui3Jefl98MBOA ($358.25 in chips)
Seat 4: qXDd0ZyMIse0OBu8pxeQ3Q ($259 in chips)
Seat 5: 3dAbvkxS5NPQTBAbvpinVg ($508.10 in chips)
Seat 6: 09BNF4quPDzanQzM8vc6WA ($40 in chips)
09BNF4quPDzanQzM8vc6WA: posts small blind $1
VvdR9F3I+2yELkfTVvC1dg: posts big blind $2
*** HOLE CARDS ***
B87ikIyZ/TzAVeXf38Ny0g: folds
gsugPj31Hui3Jefl98MBOA: folds
qXDd0ZyMIse0OBu8pxeQ3Q: folds
3dAbvkxS5NPQTBAbvpinVg: folds
09BNF4quPDzanQzM8vc6WA: folds
VvdR9F3I+2yELkfTVvC1dg collected $2 from pot
VvdR9F3I+2yELkfTVvC1dg: doesn't show hand
*** SUMMARY ***
Total pot $2 | Rake $0
Seat 1: VvdR9F3I+2yELkfTVvC1dg (big blind) collected ($2)
Seat 2: B87ikIyZ/TzAVeXf38Ny0g folded before Flop (didn't bet)
Seat 3: gsugPj31Hui3Jefl98MBOA folded before Flop (didn't bet)
Seat 4: qXDd0ZyMIse0OBu8pxeQ3Q folded before Flop (didn't bet)
Seat 5: 3dAbvkxS5NPQTBAbvpinVg (button) folded before Flop (didn't bet)
Seat 6: 09BNF4quPDzanQzM8vc6WA (small blind) folded before Flop



PokerStars Game #59941528436:  Hold'em No Limit ($1/$2) - 2009/07/01 1:38:12 ET
Table 'kq5zaQ+1hLNf8LZfGnbTAA' 6-max Seat #5 is the button
Seat 1: 8srN1dKQePlsv0GyTada+Q ($430.60 in chips)
Seat 2: nXDI8Y/S6POzRwANu3d8hQ ($144 in chips)
Seat 3: /PH6Ffnho4Ysm8S3V/oa+w ($40 in chips)
Seat 4: 3dAbvkxS5NPQTBAbvpinVg ($278.45 in chips)
Seat 5: gnYme0DNFflnMhrdbxe1Ag ($223.35 in chips)
Seat 6: mfy7uGZcqA2PVQqEVbJ7+g ($197.45 in chips)
mfy7uGZcqA2PVQqEVbJ7+g: posts small blind $1
8srN1dKQePlsv0GyTada+Q: posts big blind $2
*** HOLE CARDS ***
nXDI8Y/S6POzRwANu3d8hQ: folds
/PH6Ffnho4Ysm8S3V/oa+w: folds
3dAbvkxS5NPQTBAbvpinVg: raises $4 to $6
gnYme0DNFflnMhrdbxe1Ag: folds
mfy7uGZcqA2PVQqEVbJ7+g: folds
8srN1dKQePlsv0GyTada+Q: folds
3dAbvkxS5NPQTBAbvpinVg collected $5 from pot
3dAbvkxS5NPQTBAbvpinVg: doesn't show hand
*** SUMMARY ***
Total pot $5 | Rake $0
Seat 1: 8srN1dKQePlsv0GyTada+Q (big blind) folded before Flop
Seat 2: nXDI8Y/S6POzRwANu3d8hQ folded before Flop (didn't bet)
Seat 3: /PH6Ffnho4Ysm8S3V/oa+w folded before Flop (didn't bet)
Seat 4: 3dAbvkxS5NPQTBAbvpinVg collected ($5)
Seat 5: gnYme0DNFflnMhrdbxe1Ag (button) folded before Flop (didn't bet)
Seat 6: mfy7uGZcqA2PVQqEVbJ7+g (small blind) folded before Flop



PokerStars Game #59941528312:  Hold'em No Limit ($1/$2) - 2009/07/01 1:38:12 ET
Table 'jlrIxbrVIG+gjaUYT4za8g' 6-max Seat #4 is the button
Seat 1: ygTTt5ehT4aF86q1a8/R+w ($235.30 in chips)
Seat 2: /PH6Ffnho4Ysm8S3V/oa+w ($40 in chips)
Seat 3: gnYme0DNFflnMhrdbxe1Ag ($203 in chips)
Seat 4: 8srN1dKQePlsv0GyTada+Q ($254.20 in chips)
Seat 5: AyBB0k3Dcl7xbXUeGMw06g ($71.65 in chips)
AyBB0k3Dcl7xbXUeGMw06g: posts small blind $1
ygTTt5ehT4aF86q1a8/R+w: posts big blind $2
*** HOLE CARDS ***
/PH6Ffnho4Ysm8S3V/oa+w: folds
BWhgxe7gWiYobRbwdG+d2Q joins the table at seat #6
gnYme0DNFflnMhrdbxe1Ag: folds
8srN1dKQePlsv0GyTada+Q: raises $4 to $6
AyBB0k3Dcl7xbXUeGMw06g: calls $5
ygTTt5ehT4aF86q1a8/R+w: folds
*** FLOP *** [Ac 5s 7d]
AyBB0k3Dcl7xbXUeGMw06g: checks
8srN1dKQePlsv0GyTada+Q: checks
*** TURN *** [Ac 5s 7d] [7s]
AyBB0k3Dcl7xbXUeGMw06g: bets $6
8srN1dKQePlsv0GyTada+Q: calls $6
*** RIVER *** [Ac 5s 7d 7s] [2h]
AyBB0k3Dcl7xbXUeGMw06g: checks
8srN1dKQePlsv0GyTada+Q: bets $8
AyBB0k3Dcl7xbXUeGMw06g: folds
8srN1dKQePlsv0GyTada+Q collected $24.75 from pot
*** SUMMARY ***
Total pot $26 | Rake $1.25
Board [Ac 5s 7d 7s 2h]
Seat 1: ygTTt5ehT4aF86q1a8/R+w (big blind) folded before Flop
Seat 2: /PH6Ffnho4Ysm8S3V/oa+w folded before Flop (didn't bet)
Seat 3: gnYme0DNFflnMhrdbxe1Ag folded before Flop (didn't bet)
Seat 4: 8srN1dKQePlsv0GyTada+Q (button) collected ($24.75)
Seat 5: AyBB0k3Dcl7xbXUeGMw06g (small blind) folded on the River



PokerStars Game #59941528434:  Hold'em No Limit ($1/$2) - 2009/07/01 1:38:12 ET
Table 'TsEDkiO4tzCTCzJ7tNdEqw' 6-max Seat #3 is the button
Seat 2: 4dcDwIHRm96PwtqkpQiuiA ($89.65 in chips)
Seat 3: ubtx4Z5L+AcK71MTvYiGVw ($290.05 in chips)
Seat 4: K8MXCrNAVYlMnnCeM32Kxw ($97.50 in chips)
Seat 5: VvdR9F3I+2yELkfTVvC1dg ($247.35 in chips)
Seat 6: uCqEjnxh2/vFBjKYkfTOkw ($166.70 in chips)
K8MXCrNAVYlMnnCeM32Kxw: posts small blind $1
VvdR9F3I+2yELkfTVvC1dg: posts big blind $2
*** HOLE CARDS ***
uCqEjnxh2/vFBjKYkfTOkw: folds
4dcDwIHRm96PwtqkpQiuiA: folds
ubtx4Z5L+AcK71MTvYiGVw: folds
K8MXCrNAVYlMnnCeM32Kxw: raises $2 to $4
MfXQsYD8pGeCS7XOtyV+vw said, "wow... nh.. luckyn riv"
VvdR9F3I+2yELkfTVvC1dg: folds
K8MXCrNAVYlMnnCeM32Kxw collected $4 from pot
*** SUMMARY ***
Total pot $4 | Rake $0
Seat 2: 4dcDwIHRm96PwtqkpQiuiA folded before Flop (didn't bet)
Seat 3: ubtx4Z5L+AcK71MTvYiGVw (button) folded before Flop (didn't bet)
Seat 4: K8MXCrNAVYlMnnCeM32Kxw (small blind) collected ($4)
Seat 5: VvdR9F3I+2yELkfTVvC1dg (big blind) folded before Flop
Seat 6: uCqEjnxh2/vFBjKYkfTOkw folded before Flop (didn't bet)



PokerStars Game #59941529768:  Hold'em No Limit ($1/$2) - 2009/07/01 1:38:15 ET
Table 'bJQ024BaYSBrW0sXpCZbNQ' 6-max Seat #2 is the button
Seat 1: KfwW5us6tydK81NYTtK1gw ($203 in chips)
Seat 2: 3dAbvkxS5NPQTBAbvpinVg ($200 in chips)
Seat 3: /PH6Ffnho4Ysm8S3V/oa+w ($40 in chips)
Seat 4: TBaQIN+sQ7eb7P99QnaORQ ($69.15 in chips)
Seat 5: VvdR9F3I+2yELkfTVvC1dg ($200 in chips)
/PH6Ffnho4Ysm8S3V/oa+w: posts small blind $1
TBaQIN+sQ7eb7P99QnaORQ: posts big blind $2
*** HOLE CARDS ***
VvdR9F3I+2yELkfTVvC1dg: folds
KfwW5us6tydK81NYTtK1gw: folds
3dAbvkxS5NPQTBAbvpinVg: folds
/PH6Ffnho4Ysm8S3V/oa+w: raises $3 to $5
4bqvCfJ0e8CTYnn0Go9hbQ has returned
TBaQIN+sQ7eb7P99QnaORQ: folds
/PH6Ffnho4Ysm8S3V/oa+w collected $4 from pot
/PH6Ffnho4Ysm8S3V/oa+w: doesn't show hand
*** SUMMARY ***
Total pot $4 | Rake $0
Seat 1: KfwW5us6tydK81NYTtK1gw folded before Flop (didn't bet)
Seat 2: 3dAbvkxS5NPQTBAbvpinVg (button) folded before Flop (didn't bet)
Seat 3: /PH6Ffnho4Ysm8S3V/oa+w (small blind) collected ($4)
Seat 4: TBaQIN+sQ7eb7P99QnaORQ (big blind) folded before Flop
Seat 5: VvdR9F3I+2yELkfTVvC1dg folded before Flop (didn't bet)



PokerStars Game #59941530084:  Hold'em No Limit ($1/$2) - 2009/07/01 1:38:15 ET
Table 'aSf77Sj8QEnzcc0WaxVD4Q' 6-max Seat #1 is the button
Seat 1: UELtvp+JfwI7XDGVwSxZXA ($257.10 in chips)
Seat 2: vkfxu8f/jMYKUk6Ly4eujw ($210.30 in chips)
Seat 3: 9dpyyjDTCed6nV7JhaUUpw ($521.10 in chips)
Seat 4: YsLQ3BAvgQHWXMAv3Wv6Hg ($201.50 in chips)
Seat 5: VvdR9F3I+2yELkfTVvC1dg ($258 in chips)
Seat 6: vkoJRf3gidxY1pPi0AFWww ($132.10 in chips)
vkfxu8f/jMYKUk6Ly4eujw: posts small blind $1
9dpyyjDTCed6nV7JhaUUpw: posts big blind $2
*** HOLE CARDS ***
YsLQ3BAvgQHWXMAv3Wv6Hg: folds
VvdR9F3I+2yELkfTVvC1dg: folds
vkoJRf3gidxY1pPi0AFWww: folds
UELtvp+JfwI7XDGVwSxZXA: raises $4 to $6
vkfxu8f/jMYKUk6Ly4eujw: folds
9dpyyjDTCed6nV7JhaUUpw: folds
UELtvp+JfwI7XDGVwSxZXA collected $5 from pot
*** SUMMARY ***
Total pot $5 | Rake $0
Seat 1: UELtvp+JfwI7XDGVwSxZXA (button) collected ($5)
Seat 2: vkfxu8f/jMYKUk6Ly4eujw (small blind) folded before Flop
Seat 3: 9dpyyjDTCed6nV7JhaUUpw (big blind) folded before Flop
Seat 4: YsLQ3BAvgQHWXMAv3Wv6Hg folded before Flop (didn't bet)
Seat 5: VvdR9F3I+2yELkfTVvC1dg folded before Flop (didn't bet)
Seat 6: vkoJRf3gidxY1pPi0AFWww folded before Flop (didn't bet)



PokerStars Game #59941530584:  Hold'em No Limit ($1/$2) - 2009/07/01 1:38:16 ET
Table 'P/yCfYl1GfGsu/e6DxDy/A' 2-max Seat #1 is the button
Seat 1: 7fOCUy3x9hdkmXkkDNolGQ ($484 in chips)
Seat 2: RwDoM55ZeQuI2ADyJhOb2Q ($995 in chips)
7fOCUy3x9hdkmXkkDNolGQ: posts small blind $1
RwDoM55ZeQuI2ADyJhOb2Q: posts big blind $2
*** HOLE CARDS ***
7fOCUy3x9hdkmXkkDNolGQ: folds
RwDoM55ZeQuI2ADyJhOb2Q collected $2 from pot
RwDoM55ZeQuI2ADyJhOb2Q: doesn't show hand
*** SUMMARY ***
Total pot $2 | Rake $0
Seat 1: 7fOCUy3x9hdkmXkkDNolGQ (button) (small blind) folded before Flop
Seat 2: RwDoM55ZeQuI2ADyJhOb2Q (big blind) collected ($2)



PokerStars Game #59941531108:  Hold'em No Limit ($1/$2) - 2009/07/01 1:38:17 ET
Table 'SF49/KQm8T4taMp6kb+HXA' 9-max Seat #3 is the button
Seat 1: CUZwDpLTQKhzarPe+JCLOQ ($303.15 in chips)
Seat 2: rW/MyplHylMSBRaoRUzWrg ($40 in chips)
Seat 3: pCmk6FpSOLJ+85o1tLHIag ($277.75 in chips)
Seat 4: HffgoYm61KgkdMe/DYChIQ ($269.25 in chips)
Seat 7: nXDI8Y/S6POzRwANu3d8hQ ($37 in chips)
Seat 8: GgrYze3jkUdSO7a7CuJGDw ($194 in chips)
Seat 9: /inIs/z/PcX+TniIFpaxpg ($317.15 in chips)
HffgoYm61KgkdMe/DYChIQ: posts small blind $1
ri8CLkX3e9JF34dQNbsHGA: is sitting out
ri8CLkX3e9JF34dQNbsHGA leaves the table
nXDI8Y/S6POzRwANu3d8hQ: posts big blind $2
*** HOLE CARDS ***
GgrYze3jkUdSO7a7CuJGDw: folds
/inIs/z/PcX+TniIFpaxpg: folds
CUZwDpLTQKhzarPe+JCLOQ: folds
rW/MyplHylMSBRaoRUzWrg: folds
pCmk6FpSOLJ+85o1tLHIag: folds
GgrYze3jkUdSO7a7CuJGDw leaves the table
HffgoYm61KgkdMe/DYChIQ: calls $1
MpL4DeEqGQu0H8TJEbEOrg joins the table at seat #5
nXDI8Y/S6POzRwANu3d8hQ: raises $8 to $10
HffgoYm61KgkdMe/DYChIQ: folds
nXDI8Y/S6POzRwANu3d8hQ collected $4 from pot
*** SUMMARY ***
Total pot $4 | Rake $0
Seat 1: CUZwDpLTQKhzarPe+JCLOQ folded before Flop (didn't bet)
Seat 2: rW/MyplHylMSBRaoRUzWrg folded before Flop (didn't bet)
Seat 3: pCmk6FpSOLJ+85o1tLHIag (button) folded before Flop (didn't bet)
Seat 4: HffgoYm61KgkdMe/DYChIQ (small blind) folded before Flop
Seat 7: nXDI8Y/S6POzRwANu3d8hQ (big blind) collected ($4)
Seat 8: GgrYze3jkUdSO7a7CuJGDw folded before Flop (didn't bet)
Seat 9: /inIs/z/PcX+TniIFpaxpg folded before Flop (didn't bet)



PokerStars Game #59941531844:  Hold'em No Limit ($1/$2) - 2009/07/01 1:38:18 ET
Table 'AtOXMvcrtQM8yLNcALmfLQ' 2-max Seat #1 is the button
Seat 1: +HlQuAsMqZGYYtjcPO/a3A ($332.50 in chips)
Seat 2: pVqEzK9wXlRMECnb1Zg4Zw ($238.50 in chips)
+HlQuAsMqZGYYtjcPO/a3A: posts small blind $1
pVqEzK9wXlRMECnb1Zg4Zw: posts big blind $2
*** HOLE CARDS ***
+HlQuAsMqZGYYtjcPO/a3A: raises $4 to $6
pVqEzK9wXlRMECnb1Zg4Zw: folds
+HlQuAsMqZGYYtjcPO/a3A collected $4 from pot
*** SUMMARY ***
Total pot $4 | Rake $0
Seat 1: +HlQuAsMqZGYYtjcPO/a3A (button) (small blind) collected ($4)
Seat 2: pVqEzK9wXlRMECnb1Zg4Zw (big blind) folded before Flop



PokerStars Game #59941531892:  Hold'em No Limit ($1/$2) - 2009/07/01 1:38:18 ET
Table 'G1Oqdy4Pqdb5gtx40rUBzA' 6-max Seat #2 is the button
Seat 2: 4uqU0dG67owXuPz303Al4w ($519.60 in chips)
Seat 3: VvdR9F3I+2yELkfTVvC1dg ($228.90 in chips)
Seat 4: B87ikIyZ/TzAVeXf38Ny0g ($211.55 in chips)
Seat 5: F1+Ml47qRQWunzPnGhLLzQ ($203.65 in chips)
Seat 6: qCnEYuAE5y5A7bk6fO5/jQ ($200 in chips)
VvdR9F3I+2yELkfTVvC1dg: posts small blind $1
B87ikIyZ/TzAVeXf38Ny0g: posts big blind $2
*** HOLE CARDS ***
F1+Ml47qRQWunzPnGhLLzQ: folds
qCnEYuAE5y5A7bk6fO5/jQ: folds
4uqU0dG67owXuPz303Al4w: folds
VvdR9F3I+2yELkfTVvC1dg: folds
B87ikIyZ/TzAVeXf38Ny0g collected $2 from pot
B87ikIyZ/TzAVeXf38Ny0g: doesn't show hand
*** SUMMARY ***
Total pot $2 | Rake $0
Seat 2: 4uqU0dG67owXuPz303Al4w (button) folded before Flop (didn't bet)
Seat 3: VvdR9F3I+2yELkfTVvC1dg (small blind) folded before Flop
Seat 4: B87ikIyZ/TzAVeXf38Ny0g (big blind) collected ($2)
Seat 5: F1+Ml47qRQWunzPnGhLLzQ folded before Flop (didn't bet)
Seat 6: qCnEYuAE5y5A7bk6fO5/jQ folded before Flop (didn't bet)



PokerStars Game #59941533054:  Hold'em No Limit ($1/$2) - 2009/07/01 1:38:20 ET
Table '8Y6PEyoNuepZTai2Q56aHw' 9-max Seat #1 is the button
Seat 1: 5Q8U6iZbeO7xJSS4qvDP5g ($308.80 in chips)
Seat 2: gDCJIAlovbPnTvMM7Dd1gA ($189.55 in chips)
Seat 3: WUlHm+ydPPHG7Lb0rePSdA ($214.10 in chips)
Seat 4: xKkwALG38OfLQ9DXuJgR1w ($215.25 in chips)
Seat 5: /inIs/z/PcX+TniIFpaxpg ($40 in chips)
Seat 6: NtLDBSjsJQEKekh5cdinvw ($373.35 in chips)
Seat 7: Kzta8yu9vxHT4B70mjBZ+w ($200 in chips)
Seat 9: F7m34OOfAQ7annesMHVjKw ($196.40 in chips)
gDCJIAlovbPnTvMM7Dd1gA: posts small blind $1
WUlHm+ydPPHG7Lb0rePSdA: posts big blind $2
+T/63sAeZzWyHchahJ36GQ: sits out
*** HOLE CARDS ***
xKkwALG38OfLQ9DXuJgR1w: raises $4 to $6
/inIs/z/PcX+TniIFpaxpg: folds
NtLDBSjsJQEKekh5cdinvw: folds
Kzta8yu9vxHT4B70mjBZ+w: folds
F7m34OOfAQ7annesMHVjKw: folds
5Q8U6iZbeO7xJSS4qvDP5g: calls $6
gDCJIAlovbPnTvMM7Dd1gA: folds
WUlHm+ydPPHG7Lb0rePSdA: folds
*** FLOP *** [Tc 5d 9s]
xKkwALG38OfLQ9DXuJgR1w: bets $14
5Q8U6iZbeO7xJSS4qvDP5g: calls $14
*** TURN *** [Tc 5d 9s] [Ks]
xKkwALG38OfLQ9DXuJgR1w: bets $30
5Q8U6iZbeO7xJSS4qvDP5g: calls $30
*** RIVER *** [Tc 5d 9s Ks] [3d]
xKkwALG38OfLQ9DXuJgR1w: bets $50
5Q8U6iZbeO7xJSS4qvDP5g: raises $208.80 to $258.80 and is all-in
xKkwALG38OfLQ9DXuJgR1w has timed out
xKkwALG38OfLQ9DXuJgR1w: folds
xKkwALG38OfLQ9DXuJgR1w is sitting out
5Q8U6iZbeO7xJSS4qvDP5g collected $200 from pot
5Q8U6iZbeO7xJSS4qvDP5g: doesn't show hand
*** SUMMARY ***
Total pot $203 | Rake $3
Board [Tc 5d 9s Ks 3d]
Seat 1: 5Q8U6iZbeO7xJSS4qvDP5g (button) collected ($200)
Seat 2: gDCJIAlovbPnTvMM7Dd1gA (small blind) folded before Flop
Seat 3: WUlHm+ydPPHG7Lb0rePSdA (big blind) folded before Flop
Seat 4: xKkwALG38OfLQ9DXuJgR1w folded on the River
Seat 5: /inIs/z/PcX+TniIFpaxpg folded before Flop (didn't bet)
Seat 6: NtLDBSjsJQEKekh5cdinvw folded before Flop (didn't bet)
Seat 7: Kzta8yu9vxHT4B70mjBZ+w folded before Flop (didn't bet)
Seat 9: F7m34OOfAQ7annesMHVjKw folded before Flop (didn't bet)



PokerStars Game #59941533394:  Hold'em No Limit ($1/$2) - 2009/07/01 1:38:21 ET
Table '4NGNnZ/osQfNq6abYqkJeA' 6-max Seat #3 is the button
Seat 1: vkfxu8f/jMYKUk6Ly4eujw ($193 in chips)
Seat 2: 669iGNwYwgRZg3nhS+aDAQ ($99.90 in chips)
Seat 3: 54yWzRRgS0oZ+S6LwZBxMQ ($29.80 in chips)
Seat 4: sY+4Uuh5z/6AbXXaCS10jw ($234.25 in chips)
Seat 5: VvdR9F3I+2yELkfTVvC1dg ($241.55 in chips)
Seat 6: /PH6Ffnho4Ysm8S3V/oa+w ($40 in chips)
sY+4Uuh5z/6AbXXaCS10jw: posts small blind $1
VvdR9F3I+2yELkfTVvC1dg: posts big blind $2
*** HOLE CARDS ***
/PH6Ffnho4Ysm8S3V/oa+w: folds
vkfxu8f/jMYKUk6Ly4eujw: folds
669iGNwYwgRZg3nhS+aDAQ: folds
54yWzRRgS0oZ+S6LwZBxMQ: raises $4 to $6
sY+4Uuh5z/6AbXXaCS10jw: folds
VvdR9F3I+2yELkfTVvC1dg: folds
54yWzRRgS0oZ+S6LwZBxMQ collected $5 from pot
54yWzRRgS0oZ+S6LwZBxMQ: doesn't show hand
*** SUMMARY ***
Total pot $5 | Rake $0
Seat 1: vkfxu8f/jMYKUk6Ly4eujw folded before Flop (didn't bet)
Seat 2: 669iGNwYwgRZg3nhS+aDAQ folded before Flop (didn't bet)
Seat 3: 54yWzRRgS0oZ+S6LwZBxMQ (button) collected ($5)
Seat 4: sY+4Uuh5z/6AbXXaCS10jw (small blind) folded before Flop
Seat 5: VvdR9F3I+2yELkfTVvC1dg (big blind) folded before Flop
Seat 6: /PH6Ffnho4Ysm8S3V/oa+w folded before Flop (didn't bet)



PokerStars Game #59941533212:  Hold'em No Limit ($1/$2) - 2009/07/01 1:38:21 ET
Table 'NmY84NAf9Mh0ckAckHnh5g' 2-max Seat #2 is the button
Seat 1: 6hvg964TSqZ3AL/0XK9aVQ ($445.60 in chips)
Seat 2: RwDoM55ZeQuI2ADyJhOb2Q ($549 in chips)
RwDoM55ZeQuI2ADyJhOb2Q: posts small blind $1
6hvg964TSqZ3AL/0XK9aVQ: posts big blind $2
*** HOLE CARDS ***
RwDoM55ZeQuI2ADyJhOb2Q: raises $4 to $6
6hvg964TSqZ3AL/0XK9aVQ: calls $4
*** FLOP *** [Tc 8c Th]
6hvg964TSqZ3AL/0XK9aVQ: checks
RwDoM55ZeQuI2ADyJhOb2Q: bets $10
6hvg964TSqZ3AL/0XK9aVQ: folds
RwDoM55ZeQuI2ADyJhOb2Q collected $11.50 from pot
RwDoM55ZeQuI2ADyJhOb2Q: doesn't show hand
*** SUMMARY ***
Total pot $12 | Rake $0.50
Board [Tc 8c Th]
Seat 1: 6hvg964TSqZ3AL/0XK9aVQ (big blind) folded on the Flop
Seat 2: RwDoM55ZeQuI2ADyJhOb2Q (button) (small blind) collected ($11.50)



PokerStars Game #59941533836:  Hold'em No Limit ($1/$2) - 2009/07/01 1:38:22 ET
Table 'P/yCfYl1GfGsu/e6DxDy/A' 2-max Seat #2 is the button
Seat 1: 7fOCUy3x9hdkmXkkDNolGQ ($483 in chips)
Seat 2: RwDoM55ZeQuI2ADyJhOb2Q ($996 in chips)
RwDoM55ZeQuI2ADyJhOb2Q: posts small blind $1
7fOCUy3x9hdkmXkkDNolGQ: posts big blind $2
*** HOLE CARDS ***
RwDoM55ZeQuI2ADyJhOb2Q: raises $4 to $6
7fOCUy3x9hdkmXkkDNolGQ: folds
RwDoM55ZeQuI2ADyJhOb2Q collected $4 from pot
RwDoM55ZeQuI2ADyJhOb2Q: doesn't show hand
*** SUMMARY ***
Total pot $4 | Rake $0
Seat 1: 7fOCUy3x9hdkmXkkDNolGQ (big blind) folded before Flop
Seat 2: RwDoM55ZeQuI2ADyJhOb2Q (button) (small blind) collected ($4)



PokerStars Game #59941533738:  Hold'em No Limit ($1/$2) - 2009/07/01 1:38:22 ET
Table '/dyk+YdRGv90j2box35j8w' 6-max Seat #5 is the button
Seat 1: 8srN1dKQePlsv0GyTada+Q ($212.25 in chips)
Seat 2: qCnEYuAE5y5A7bk6fO5/jQ ($470.60 in chips)
Seat 3: sTPOWERd9HWPCNrDBwsVjA ($182.50 in chips)
Seat 5: VvdR9F3I+2yELkfTVvC1dg ($249 in chips)
Seat 6: gnYme0DNFflnMhrdbxe1Ag ($200 in chips)
gnYme0DNFflnMhrdbxe1Ag: posts small blind $1
8srN1dKQePlsv0GyTada+Q: posts big blind $2
z/u1YTnkiIDrtp/2cA2dBg: sits out
*** HOLE CARDS ***
qCnEYuAE5y5A7bk6fO5/jQ: raises $4 to $6
sTPOWERd9HWPCNrDBwsVjA: folds
VvdR9F3I+2yELkfTVvC1dg: folds
gnYme0DNFflnMhrdbxe1Ag: folds
8srN1dKQePlsv0GyTada+Q: folds
qCnEYuAE5y5A7bk6fO5/jQ collected $5 from pot
qCnEYuAE5y5A7bk6fO5/jQ: doesn't show hand
*** SUMMARY ***
Total pot $5 | Rake $0
Seat 1: 8srN1dKQePlsv0GyTada+Q (big blind) folded before Flop
Seat 2: qCnEYuAE5y5A7bk6fO5/jQ collected ($5)
Seat 3: sTPOWERd9HWPCNrDBwsVjA folded before Flop (didn't bet)
Seat 5: VvdR9F3I+2yELkfTVvC1dg (button) folded before Flop (didn't bet)
Seat 6: gnYme0DNFflnMhrdbxe1Ag (small blind) folded before Flop



PokerStars Game #59941535394:  Hold'em No Limit ($1/$2) - 2009/07/01 1:38:25 ET
Table 'mGpP9StWRnoeiBDExc6Frg' 6-max Seat #4 is the button
Seat 1: VvdR9F3I+2yELkfTVvC1dg ($318.15 in chips)
Seat 2: vkfxu8f/jMYKUk6Ly4eujw ($196 in chips)
Seat 3: 7acrZUQC3Zc9BNLjoKIcLQ ($23.15 in chips)
Seat 4: 4dcDwIHRm96PwtqkpQiuiA ($75.70 in chips)
Seat 5: d1puGuVBE0fidn+5eRJ0tw ($199.65 in chips)
Seat 6: B2Ih1sr5VZk+8He7rcrMtQ ($423.05 in chips)
d1puGuVBE0fidn+5eRJ0tw: posts small blind $1
B2Ih1sr5VZk+8He7rcrMtQ: posts big blind $2
7acrZUQC3Zc9BNLjoKIcLQ: posts small blind $1
*** HOLE CARDS ***
VvdR9F3I+2yELkfTVvC1dg: raises $4 to $6
vkfxu8f/jMYKUk6Ly4eujw: folds
7acrZUQC3Zc9BNLjoKIcLQ: calls $6
4dcDwIHRm96PwtqkpQiuiA: calls $6
d1puGuVBE0fidn+5eRJ0tw: folds
B2Ih1sr5VZk+8He7rcrMtQ: calls $4
*** FLOP *** [6h Qd 7c]
B2Ih1sr5VZk+8He7rcrMtQ: checks
VvdR9F3I+2yELkfTVvC1dg: checks
7acrZUQC3Zc9BNLjoKIcLQ: bets $12
4dcDwIHRm96PwtqkpQiuiA: folds
B2Ih1sr5VZk+8He7rcrMtQ: folds
VvdR9F3I+2yELkfTVvC1dg: folds
7acrZUQC3Zc9BNLjoKIcLQ collected $24.70 from pot
*** SUMMARY ***
Total pot $26 | Rake $1.30
Board [6h Qd 7c]
Seat 1: VvdR9F3I+2yELkfTVvC1dg folded on the Flop
Seat 2: vkfxu8f/jMYKUk6Ly4eujw folded before Flop (didn't bet)
Seat 3: 7acrZUQC3Zc9BNLjoKIcLQ collected ($24.70)
Seat 4: 4dcDwIHRm96PwtqkpQiuiA (button) folded on the Flop
Seat 5: d1puGuVBE0fidn+5eRJ0tw (small blind) folded before Flop
Seat 6: B2Ih1sr5VZk+8He7rcrMtQ (big blind) folded on the Flop



PokerStars Game #59941536920:  Hold'em No Limit ($1/$2) - 2009/07/01 1:38:28 ET
Table 'LL4bDFyhj5hsMpzaDugJZg' 6-max Seat #2 is the button
Seat 2: IZng3w8jiJHHp3LbYKLi4w ($51.75 in chips)
Seat 3: iI/NMpRxMkGieArQEhACSA ($567.35 in chips)
Seat 4: 8srN1dKQePlsv0GyTada+Q ($200 in chips)
Seat 5: A2GTwTiwkb1ilNWgW487Vg ($125.50 in chips)
Seat 6: 692Q4sfB0gTElzS0WMeg+A ($205.35 in chips)
iI/NMpRxMkGieArQEhACSA: posts small blind $1
8srN1dKQePlsv0GyTada+Q: posts big blind $2
*** HOLE CARDS ***
A2GTwTiwkb1ilNWgW487Vg: raises $2 to $4
692Q4sfB0gTElzS0WMeg+A: folds
IZng3w8jiJHHp3LbYKLi4w: folds
iI/NMpRxMkGieArQEhACSA: raises $6 to $10
8srN1dKQePlsv0GyTada+Q: folds
A2GTwTiwkb1ilNWgW487Vg: calls $6
*** FLOP *** [8s 3d Jc]
iI/NMpRxMkGieArQEhACSA: bets $10
A2GTwTiwkb1ilNWgW487Vg: folds
iI/NMpRxMkGieArQEhACSA collected $20.90 from pot
*** SUMMARY ***
Total pot $22 | Rake $1.10
Board [8s 3d Jc]
Seat 2: IZng3w8jiJHHp3LbYKLi4w (button) folded before Flop (didn't bet)
Seat 3: iI/NMpRxMkGieArQEhACSA (small blind) collected ($20.90)
Seat 4: 8srN1dKQePlsv0GyTada+Q (big blind) folded before Flop
Seat 5: A2GTwTiwkb1ilNWgW487Vg folded on the Flop
Seat 6: 692Q4sfB0gTElzS0WMeg+A folded before Flop (didn't bet)



PokerStars Game #59941537122:  Hold'em No Limit ($1/$2) - 2009/07/01 1:38:28 ET
Table '/ci73fTmzTzmGWzAtqEX2Q' 9-max Seat #3 is the button
Seat 1: 9efVc1cB3yHt4TvBkTusPw ($147.90 in chips)
Seat 2: pN/Ip0ePsUVIdUlGgLrkUw ($225 in chips)
Seat 3: kK1+5ivyJZeA8hQF2pdvvQ ($61.55 in chips)
Seat 4: 2yq7Zp4xmrhAw8+37hTkaA ($167.20 in chips)
Seat 5: 1CtiZuXDFaJL1dJPQKyi8Q ($178.60 in chips)
Seat 6: GX1heJ+DSsvm7gzSPsYhhQ ($89.30 in chips)
Seat 8: /inIs/z/PcX+TniIFpaxpg ($34 in chips)
Seat 9: S8aS+9FTYQ/ICLBNThcrkg ($179 in chips)
2yq7Zp4xmrhAw8+37hTkaA: posts small blind $1
1CtiZuXDFaJL1dJPQKyi8Q: posts big blind $2
+T/63sAeZzWyHchahJ36GQ: sits out
*** HOLE CARDS ***
GX1heJ+DSsvm7gzSPsYhhQ: calls $2
/inIs/z/PcX+TniIFpaxpg: folds
S8aS+9FTYQ/ICLBNThcrkg: calls $2
9efVc1cB3yHt4TvBkTusPw: calls $2
pN/Ip0ePsUVIdUlGgLrkUw: folds
kK1+5ivyJZeA8hQF2pdvvQ: folds
2yq7Zp4xmrhAw8+37hTkaA: calls $1
1CtiZuXDFaJL1dJPQKyi8Q: checks
*** FLOP *** [Ah Td Kh]
2yq7Zp4xmrhAw8+37hTkaA: checks
1CtiZuXDFaJL1dJPQKyi8Q: checks
GX1heJ+DSsvm7gzSPsYhhQ: checks
S8aS+9FTYQ/ICLBNThcrkg: checks
9efVc1cB3yHt4TvBkTusPw: checks
*** TURN *** [Ah Td Kh] [9c]
2yq7Zp4xmrhAw8+37hTkaA: bets $4
1CtiZuXDFaJL1dJPQKyi8Q: raises $8 to $12
GX1heJ+DSsvm7gzSPsYhhQ: folds
GX1heJ+DSsvm7gzSPsYhhQ leaves the table
S8aS+9FTYQ/ICLBNThcrkg: folds
9efVc1cB3yHt4TvBkTusPw: folds
KqHysDSpCPaPyK3tJC1aEw joins the table at seat #6
2yq7Zp4xmrhAw8+37hTkaA: folds
1CtiZuXDFaJL1dJPQKyi8Q collected $17.15 from pot
*** SUMMARY ***
Total pot $18 | Rake $0.85
Board [Ah Td Kh 9c]
Seat 1: 9efVc1cB3yHt4TvBkTusPw folded on the Turn
Seat 2: pN/Ip0ePsUVIdUlGgLrkUw folded before Flop (didn't bet)
Seat 3: kK1+5ivyJZeA8hQF2pdvvQ (button) folded before Flop (didn't bet)
Seat 4: 2yq7Zp4xmrhAw8+37hTkaA (small blind) folded on the Turn
Seat 5: 1CtiZuXDFaJL1dJPQKyi8Q (big blind) collected ($17.15)
Seat 6: GX1heJ+DSsvm7gzSPsYhhQ folded on the Turn
Seat 8: /inIs/z/PcX+TniIFpaxpg folded before Flop (didn't bet)
Seat 9: S8aS+9FTYQ/ICLBNThcrkg folded on the Turn



PokerStars Game #59941537692:  Hold'em No Limit ($1/$2) - 2009/07/01 1:38:29 ET
Table 'kq5zaQ+1hLNf8LZfGnbTAA' 6-max Seat #6 is the button
Seat 1: 8srN1dKQePlsv0GyTada+Q ($428.60 in chips)
Seat 2: nXDI8Y/S6POzRwANu3d8hQ ($144 in chips)
Seat 3: /PH6Ffnho4Ysm8S3V/oa+w ($40 in chips)
Seat 4: 3dAbvkxS5NPQTBAbvpinVg ($281.45 in chips)
Seat 5: gnYme0DNFflnMhrdbxe1Ag ($223.35 in chips)
Seat 6: mfy7uGZcqA2PVQqEVbJ7+g ($196.45 in chips)
8srN1dKQePlsv0GyTada+Q: posts small blind $1
nXDI8Y/S6POzRwANu3d8hQ: posts big blind $2
*** HOLE CARDS ***
/PH6Ffnho4Ysm8S3V/oa+w: raises $2 to $4
3dAbvkxS5NPQTBAbvpinVg: folds
gnYme0DNFflnMhrdbxe1Ag: calls $4
mfy7uGZcqA2PVQqEVbJ7+g: calls $4
8srN1dKQePlsv0GyTada+Q: folds
nXDI8Y/S6POzRwANu3d8hQ: calls $2
*** FLOP *** [Kc Qc 2h]
nXDI8Y/S6POzRwANu3d8hQ: checks
/PH6Ffnho4Ysm8S3V/oa+w: bets $8
gnYme0DNFflnMhrdbxe1Ag: folds
mfy7uGZcqA2PVQqEVbJ7+g: folds
nXDI8Y/S6POzRwANu3d8hQ: folds
/PH6Ffnho4Ysm8S3V/oa+w collected $16.15 from pot
/PH6Ffnho4Ysm8S3V/oa+w: doesn't show hand
*** SUMMARY ***
Total pot $17 | Rake $0.85
Board [Kc Qc 2h]
Seat 1: 8srN1dKQePlsv0GyTada+Q (small blind) folded before Flop
Seat 2: nXDI8Y/S6POzRwANu3d8hQ (big blind) folded on the Flop
Seat 3: /PH6Ffnho4Ysm8S3V/oa+w collected ($16.15)
Seat 4: 3dAbvkxS5NPQTBAbvpinVg folded before Flop (didn't bet)
Seat 5: gnYme0DNFflnMhrdbxe1Ag folded on the Flop
Seat 6: mfy7uGZcqA2PVQqEVbJ7+g (button) folded on the Flop



PokerStars Game #59941538614:  Hold'em No Limit ($1/$2) - 2009/07/01 1:38:30 ET
Table 'P/yCfYl1GfGsu/e6DxDy/A' 2-max Seat #1 is the button
Seat 1: 7fOCUy3x9hdkmXkkDNolGQ ($481 in chips)
Seat 2: RwDoM55ZeQuI2ADyJhOb2Q ($998 in chips)
7fOCUy3x9hdkmXkkDNolGQ: posts small blind $1
RwDoM55ZeQuI2ADyJhOb2Q: posts big blind $2
*** HOLE CARDS ***
7fOCUy3x9hdkmXkkDNolGQ: folds
RwDoM55ZeQuI2ADyJhOb2Q collected $2 from pot
RwDoM55ZeQuI2ADyJhOb2Q: doesn't show hand
*** SUMMARY ***
Total pot $2 | Rake $0
Seat 1: 7fOCUy3x9hdkmXkkDNolGQ (button) (small blind) folded before Flop
Seat 2: RwDoM55ZeQuI2ADyJhOb2Q (big blind) collected ($2)



PokerStars Game #59941539064:  Hold'em No Limit ($1/$2) - 2009/07/01 1:38:31 ET
Table 'pPQgcj9XT9CHBsbo1WTBug' 6-max Seat #1 is the button
Seat 1: DFVYDA6dKQy7R7mGIKogZA ($139.50 in chips)
Seat 2: qXDd0ZyMIse0OBu8pxeQ3Q ($211.95 in chips)
Seat 3: 54yWzRRgS0oZ+S6LwZBxMQ ($49.50 in chips)
Seat 4: gqlysXCbT8V54f/1lf9h3A ($64.45 in chips)
Seat 5: vkfxu8f/jMYKUk6Ly4eujw ($196.55 in chips)
Seat 6: Yr7pZltpy3IUNdKS9PCEiw ($308.80 in chips)
qXDd0ZyMIse0OBu8pxeQ3Q: posts small blind $1
54yWzRRgS0oZ+S6LwZBxMQ: posts big blind $2
*** HOLE CARDS ***
gqlysXCbT8V54f/1lf9h3A: raises $4 to $6
vkfxu8f/jMYKUk6Ly4eujw: folds
Yr7pZltpy3IUNdKS9PCEiw has timed out
Yr7pZltpy3IUNdKS9PCEiw: folds
Yr7pZltpy3IUNdKS9PCEiw is sitting out
DFVYDA6dKQy7R7mGIKogZA: calls $6
qXDd0ZyMIse0OBu8pxeQ3Q: folds
54yWzRRgS0oZ+S6LwZBxMQ: raises $12 to $18
gqlysXCbT8V54f/1lf9h3A: calls $12
DFVYDA6dKQy7R7mGIKogZA: calls $12
*** FLOP *** [8c Ad Th]
54yWzRRgS0oZ+S6LwZBxMQ: bets $6
gqlysXCbT8V54f/1lf9h3A: folds
DFVYDA6dKQy7R7mGIKogZA: calls $6
*** TURN *** [8c Ad Th] [Qh]
54yWzRRgS0oZ+S6LwZBxMQ: bets $14
DFVYDA6dKQy7R7mGIKogZA: calls $14
*** RIVER *** [8c Ad Th Qh] [Td]
54yWzRRgS0oZ+S6LwZBxMQ: bets $11.50 and is all-in
DFVYDA6dKQy7R7mGIKogZA: calls $11.50
*** SHOW DOWN ***
54yWzRRgS0oZ+S6LwZBxMQ: shows [Qd Qc] (a full house, Queens full of Tens)
DFVYDA6dKQy7R7mGIKogZA: mucks hand
54yWzRRgS0oZ+S6LwZBxMQ collected $115 from pot
*** SUMMARY ***
Total pot $118 | Rake $3
Board [8c Ad Th Qh Td]
Seat 1: DFVYDA6dKQy7R7mGIKogZA (button) mucked
Seat 2: qXDd0ZyMIse0OBu8pxeQ3Q (small blind) folded before Flop
Seat 3: 54yWzRRgS0oZ+S6LwZBxMQ (big blind) showed [Qd Qc] and won ($115) with a full house, Queens full of Tens
Seat 4: gqlysXCbT8V54f/1lf9h3A folded on the Flop
Seat 5: vkfxu8f/jMYKUk6Ly4eujw folded before Flop (didn't bet)
Seat 6: Yr7pZltpy3IUNdKS9PCEiw folded before Flop (didn't bet)



PokerStars Game #59941539056:  Hold'em No Limit ($1/$2) - 2009/07/01 1:38:31 ET
Table 'YqGfR5eHfMeSjb9a+QU9rg' 9-max Seat #7 is the button
Seat 1: rW/MyplHylMSBRaoRUzWrg ($39 in chips)
Seat 3: /gll27k+xWYV7Fbki0lFDQ ($258.75 in chips)
Seat 4: GX1heJ+DSsvm7gzSPsYhhQ ($34 in chips)
Seat 5: CkE3IyJF1KvdaAOmZY5XqQ ($201.75 in chips)
Seat 6: TAfo4veNRaRlzDXMMYS3Jg ($40 in chips)
Seat 7: 41aZuLBz9nAi2GPVKabmCw ($96.95 in chips)
Seat 8: JnV3SM2D6dAFYyGZHHpvrg ($91.25 in chips)
Seat 9: /inIs/z/PcX+TniIFpaxpg ($202.20 in chips)
JnV3SM2D6dAFYyGZHHpvrg: posts small blind $1
/inIs/z/PcX+TniIFpaxpg: posts big blind $2
nXDI8Y/S6POzRwANu3d8hQ: sits out
*** HOLE CARDS ***
rW/MyplHylMSBRaoRUzWrg: folds
/gll27k+xWYV7Fbki0lFDQ: folds
GX1heJ+DSsvm7gzSPsYhhQ: folds
CkE3IyJF1KvdaAOmZY5XqQ: folds
TAfo4veNRaRlzDXMMYS3Jg: folds
41aZuLBz9nAi2GPVKabmCw: calls $2
JnV3SM2D6dAFYyGZHHpvrg: folds
/inIs/z/PcX+TniIFpaxpg: raises $8 to $10
41aZuLBz9nAi2GPVKabmCw: folds
/inIs/z/PcX+TniIFpaxpg collected $5 from pot
/inIs/z/PcX+TniIFpaxpg: doesn't show hand
*** SUMMARY ***
Total pot $5 | Rake $0
Seat 1: rW/MyplHylMSBRaoRUzWrg folded before Flop (didn't bet)
Seat 3: /gll27k+xWYV7Fbki0lFDQ folded before Flop (didn't bet)
Seat 4: GX1heJ+DSsvm7gzSPsYhhQ folded before Flop (didn't bet)
Seat 5: CkE3IyJF1KvdaAOmZY5XqQ folded before Flop (didn't bet)
Seat 6: TAfo4veNRaRlzDXMMYS3Jg folded before Flop (didn't bet)
Seat 7: 41aZuLBz9nAi2GPVKabmCw (button) folded before Flop
Seat 8: JnV3SM2D6dAFYyGZHHpvrg (small blind) folded before Flop
Seat 9: /inIs/z/PcX+TniIFpaxpg (big blind) collected ($5)



PokerStars Game #59941540000:  Hold'em No Limit ($1/$2) - 2009/07/01 1:38:33 ET
Table 'G1Oqdy4Pqdb5gtx40rUBzA' 6-max Seat #3 is the button
Seat 2: 4uqU0dG67owXuPz303Al4w ($519.60 in chips)
Seat 3: VvdR9F3I+2yELkfTVvC1dg ($227.90 in chips)
Seat 4: B87ikIyZ/TzAVeXf38Ny0g ($212.55 in chips)
Seat 5: F1+Ml47qRQWunzPnGhLLzQ ($203.65 in chips)
Seat 6: qCnEYuAE5y5A7bk6fO5/jQ ($200 in chips)
B87ikIyZ/TzAVeXf38Ny0g: posts small blind $1
F1+Ml47qRQWunzPnGhLLzQ: posts big blind $2
*** HOLE CARDS ***
qCnEYuAE5y5A7bk6fO5/jQ: folds
4uqU0dG67owXuPz303Al4w: raises $4 to $6
VvdR9F3I+2yELkfTVvC1dg: folds
ubtx4Z5L+AcK71MTvYiGVw leaves the table
B87ikIyZ/TzAVeXf38Ny0g: folds
F1+Ml47qRQWunzPnGhLLzQ: folds
4uqU0dG67owXuPz303Al4w collected $5 from pot
*** SUMMARY ***
Total pot $5 | Rake $0
Seat 2: 4uqU0dG67owXuPz303Al4w collected ($5)
Seat 3: VvdR9F3I+2yELkfTVvC1dg (button) folded before Flop (didn't bet)
Seat 4: B87ikIyZ/TzAVeXf38Ny0g (small blind) folded before Flop
Seat 5: F1+Ml47qRQWunzPnGhLLzQ (big blind) folded before Flop
Seat 6: qCnEYuAE5y5A7bk6fO5/jQ folded before Flop (didn't bet)



PokerStars Game #59941539816:  Hold'em No Limit ($1/$2) - 2009/07/01 1:38:33 ET
Table 'AtOXMvcrtQM8yLNcALmfLQ' 2-max Seat #2 is the button
Seat 1: +HlQuAsMqZGYYtjcPO/a3A ($334.50 in chips)
Seat 2: pVqEzK9wXlRMECnb1Zg4Zw ($236.50 in chips)
pVqEzK9wXlRMECnb1Zg4Zw: posts small blind $1
+HlQuAsMqZGYYtjcPO/a3A: posts big blind $2
*** HOLE CARDS ***
pVqEzK9wXlRMECnb1Zg4Zw: raises $6 to $8
+HlQuAsMqZGYYtjcPO/a3A: folds
pVqEzK9wXlRMECnb1Zg4Zw collected $4 from pot
pVqEzK9wXlRMECnb1Zg4Zw: doesn't show hand
*** SUMMARY ***
Total pot $4 | Rake $0
Seat 1: +HlQuAsMqZGYYtjcPO/a3A (big blind) folded before Flop
Seat 2: pVqEzK9wXlRMECnb1Zg4Zw (button) (small blind) collected ($4)



PokerStars Game #59941540734:  Hold'em No Limit ($1/$2) - 2009/07/01 1:38:34 ET
Table 'NmY84NAf9Mh0ckAckHnh5g' 2-max Seat #1 is the button
Seat 1: 6hvg964TSqZ3AL/0XK9aVQ ($439.60 in chips)
Seat 2: RwDoM55ZeQuI2ADyJhOb2Q ($554.50 in chips)
6hvg964TSqZ3AL/0XK9aVQ: posts small blind $1
RwDoM55ZeQuI2ADyJhOb2Q: posts big blind $2
*** HOLE CARDS ***
6hvg964TSqZ3AL/0XK9aVQ: calls $1
RwDoM55ZeQuI2ADyJhOb2Q: checks
*** FLOP *** [7s 3c Ac]
RwDoM55ZeQuI2ADyJhOb2Q: bets $8
6hvg964TSqZ3AL/0XK9aVQ: calls $8
*** TURN *** [7s 3c Ac] [Td]
RwDoM55ZeQuI2ADyJhOb2Q: checks
6hvg964TSqZ3AL/0XK9aVQ: checks
*** RIVER *** [7s 3c Ac Td] [4h]
RwDoM55ZeQuI2ADyJhOb2Q: checks
6hvg964TSqZ3AL/0XK9aVQ: bets $48
RwDoM55ZeQuI2ADyJhOb2Q: folds
6hvg964TSqZ3AL/0XK9aVQ collected $19.50 from pot
6hvg964TSqZ3AL/0XK9aVQ: doesn't show hand
*** SUMMARY ***
Total pot $20 | Rake $0.50
Board [7s 3c Ac Td 4h]
Seat 1: 6hvg964TSqZ3AL/0XK9aVQ (button) (small blind) collected ($19.50)
Seat 2: RwDoM55ZeQuI2ADyJhOb2Q (big blind) folded on the River



PokerStars Game #59941540788:  Hold'em No Limit ($1/$2) - 2009/07/01 1:38:34 ET
Table 'TsEDkiO4tzCTCzJ7tNdEqw' 6-max Seat #4 is the button
Seat 2: 4dcDwIHRm96PwtqkpQiuiA ($89.65 in chips)
Seat 3: ubtx4Z5L+AcK71MTvYiGVw ($290.05 in chips)
Seat 4: K8MXCrNAVYlMnnCeM32Kxw ($99.50 in chips)
Seat 5: VvdR9F3I+2yELkfTVvC1dg ($245.35 in chips)
Seat 6: uCqEjnxh2/vFBjKYkfTOkw ($166.70 in chips)
VvdR9F3I+2yELkfTVvC1dg: posts small blind $1
uCqEjnxh2/vFBjKYkfTOkw: posts big blind $2
*** HOLE CARDS ***
MfXQsYD8pGeCS7XOtyV+vw leaves the table
4dcDwIHRm96PwtqkpQiuiA: folds
ubtx4Z5L+AcK71MTvYiGVw: folds
K8MXCrNAVYlMnnCeM32Kxw: raises $6 to $8
VvdR9F3I+2yELkfTVvC1dg: folds
uCqEjnxh2/vFBjKYkfTOkw: calls $6
*** FLOP *** [Ad 6d Jd]
uCqEjnxh2/vFBjKYkfTOkw: checks
K8MXCrNAVYlMnnCeM32Kxw: bets $6
uCqEjnxh2/vFBjKYkfTOkw: raises $10 to $16
K8MXCrNAVYlMnnCeM32Kxw: folds
uCqEjnxh2/vFBjKYkfTOkw collected $27.60 from pot
uCqEjnxh2/vFBjKYkfTOkw: doesn't show hand
*** SUMMARY ***
Total pot $29 | Rake $1.40
Board [Ad 6d Jd]
Seat 2: 4dcDwIHRm96PwtqkpQiuiA folded before Flop (didn't bet)
Seat 3: ubtx4Z5L+AcK71MTvYiGVw folded before Flop (didn't bet)
Seat 4: K8MXCrNAVYlMnnCeM32Kxw (button) folded on the Flop
Seat 5: VvdR9F3I+2yELkfTVvC1dg (small blind) folded before Flop
Seat 6: uCqEjnxh2/vFBjKYkfTOkw (big blind) collected ($27.60)



PokerStars Game #59941540536:  Hold'em No Limit ($1/$2) - 2009/07/01 1:38:34 ET
Table 'gnHBqWll9O3fxG7Ojkz/ng' 9-max Seat #6 is the button
Seat 1: TAfo4veNRaRlzDXMMYS3Jg ($31 in chips)
Seat 2: H6Z4+qu8gR0VUiPOijndVg ($331.95 in chips)
Seat 3: 5Q8U6iZbeO7xJSS4qvDP5g ($218.05 in chips)
Seat 4: nXDI8Y/S6POzRwANu3d8hQ ($19 in chips)
Seat 5: rBQDMkKm9cZn6M9NPsiVew ($224.15 in chips)
Seat 6: KqHysDSpCPaPyK3tJC1aEw ($200 in chips)
Seat 7: jqui3xAWCkcdPW36a6BD+w ($343.55 in chips)
Seat 8: cM6efHzdxoqYm0EQKP4TTQ ($107.80 in chips)
Seat 9: GX1heJ+DSsvm7gzSPsYhhQ ($50.35 in chips)
jqui3xAWCkcdPW36a6BD+w: posts small blind $1
cM6efHzdxoqYm0EQKP4TTQ: posts big blind $2
*** HOLE CARDS ***
GX1heJ+DSsvm7gzSPsYhhQ: folds
TAfo4veNRaRlzDXMMYS3Jg: folds
H6Z4+qu8gR0VUiPOijndVg: folds
5Q8U6iZbeO7xJSS4qvDP5g: folds
nXDI8Y/S6POzRwANu3d8hQ: folds
rBQDMkKm9cZn6M9NPsiVew: calls $2
KqHysDSpCPaPyK3tJC1aEw: folds
jqui3xAWCkcdPW36a6BD+w: folds
cM6efHzdxoqYm0EQKP4TTQ: checks
*** FLOP *** [2h Jd Qc]
cM6efHzdxoqYm0EQKP4TTQ: checks
rBQDMkKm9cZn6M9NPsiVew: checks
*** TURN *** [2h Jd Qc] [5s]
cM6efHzdxoqYm0EQKP4TTQ: checks
rBQDMkKm9cZn6M9NPsiVew: checks
*** RIVER *** [2h Jd Qc 5s] [9s]
cM6efHzdxoqYm0EQKP4TTQ: bets $6
rBQDMkKm9cZn6M9NPsiVew: folds
cM6efHzdxoqYm0EQKP4TTQ collected $4.75 from pot
cM6efHzdxoqYm0EQKP4TTQ: doesn't show hand
*** SUMMARY ***
Total pot $5 | Rake $0.25
Board [2h Jd Qc 5s 9s]
Seat 1: TAfo4veNRaRlzDXMMYS3Jg folded before Flop (didn't bet)
Seat 2: H6Z4+qu8gR0VUiPOijndVg folded before Flop (didn't bet)
Seat 3: 5Q8U6iZbeO7xJSS4qvDP5g folded before Flop (didn't bet)
Seat 4: nXDI8Y/S6POzRwANu3d8hQ folded before Flop (didn't bet)
Seat 5: rBQDMkKm9cZn6M9NPsiVew folded on the River
Seat 6: KqHysDSpCPaPyK3tJC1aEw (button) folded before Flop (didn't bet)
Seat 7: jqui3xAWCkcdPW36a6BD+w (small blind) folded before Flop
Seat 8: cM6efHzdxoqYm0EQKP4TTQ (big blind) collected ($4.75)
Seat 9: GX1heJ+DSsvm7gzSPsYhhQ folded before Flop (didn't bet)



PokerStars Game #59941542174:  Hold'em No Limit ($1/$2) - 2009/07/01 1:38:37 ET
Table 'uJ9juaXXg9yIcSU8amxaXQ' 6-max Seat #5 is the button
Seat 1: JsqOjN/eHz0uYVf/PyUJ6Q ($153.25 in chips)
Seat 2: VvdR9F3I+2yELkfTVvC1dg ($223.10 in chips)
Seat 3: qXDd0ZyMIse0OBu8pxeQ3Q ($246.40 in chips)
Seat 4: zNjJ/y4emmF+vzrCDd+ooA ($222.05 in chips)
Seat 5: YsLQ3BAvgQHWXMAv3Wv6Hg ($205.70 in chips)
Seat 6: /PH6Ffnho4Ysm8S3V/oa+w ($40 in chips)
/PH6Ffnho4Ysm8S3V/oa+w: posts small blind $1
JsqOjN/eHz0uYVf/PyUJ6Q: posts big blind $2
*** HOLE CARDS ***
VvdR9F3I+2yELkfTVvC1dg: folds
qXDd0ZyMIse0OBu8pxeQ3Q: raises $5 to $7
zNjJ/y4emmF+vzrCDd+ooA: folds
YsLQ3BAvgQHWXMAv3Wv6Hg: folds
/PH6Ffnho4Ysm8S3V/oa+w: folds
JsqOjN/eHz0uYVf/PyUJ6Q: folds
qXDd0ZyMIse0OBu8pxeQ3Q collected $5 from pot
*** SUMMARY ***
Total pot $5 | Rake $0
Seat 1: JsqOjN/eHz0uYVf/PyUJ6Q (big blind) folded before Flop
Seat 2: VvdR9F3I+2yELkfTVvC1dg folded before Flop (didn't bet)
Seat 3: qXDd0ZyMIse0OBu8pxeQ3Q collected ($5)
Seat 4: zNjJ/y4emmF+vzrCDd+ooA folded before Flop (didn't bet)
Seat 5: YsLQ3BAvgQHWXMAv3Wv6Hg (button) folded before Flop (didn't bet)
Seat 6: /PH6Ffnho4Ysm8S3V/oa+w (small blind) folded before Flop



PokerStars Game #59941542282:  Hold'em No Limit ($1/$2) - 2009/07/01 1:38:37 ET
Table 'P/yCfYl1GfGsu/e6DxDy/A' 2-max Seat #2 is the button
Seat 1: 7fOCUy3x9hdkmXkkDNolGQ ($480 in chips)
Seat 2: RwDoM55ZeQuI2ADyJhOb2Q ($999 in chips)
RwDoM55ZeQuI2ADyJhOb2Q: posts small blind $1
7fOCUy3x9hdkmXkkDNolGQ: posts big blind $2
*** HOLE CARDS ***
RwDoM55ZeQuI2ADyJhOb2Q: raises $4 to $6
7fOCUy3x9hdkmXkkDNolGQ: raises $14 to $20
RwDoM55ZeQuI2ADyJhOb2Q: folds
7fOCUy3x9hdkmXkkDNolGQ collected $12 from pot
7fOCUy3x9hdkmXkkDNolGQ: doesn't show hand
*** SUMMARY ***
Total pot $12 | Rake $0
Seat 1: 7fOCUy3x9hdkmXkkDNolGQ (big blind) collected ($12)
Seat 2: RwDoM55ZeQuI2ADyJhOb2Q (button) (small blind) folded before Flop



PokerStars Game #59941542904:  Hold'em No Limit ($1/$2) - 2009/07/01 1:38:38 ET
Table 'rKeCh+eBn4RNvybCUYkoTQ' 9-max Seat #9 is the button
Seat 1: /inIs/z/PcX+TniIFpaxpg ($196 in chips)
Seat 2: nXDI8Y/S6POzRwANu3d8hQ ($40 in chips)
Seat 3: GX1heJ+DSsvm7gzSPsYhhQ ($49 in chips)
Seat 5: WUlHm+ydPPHG7Lb0rePSdA ($122 in chips)
Seat 6: EBV6OktyeSmh4w6sWmcWOw ($286.80 in chips)
Seat 7: rW/MyplHylMSBRaoRUzWrg ($28 in chips)
Seat 8: pN/Ip0ePsUVIdUlGgLrkUw ($246.35 in chips)
Seat 9: Kzta8yu9vxHT4B70mjBZ+w ($217.25 in chips)
/inIs/z/PcX+TniIFpaxpg: posts small blind $1
nXDI8Y/S6POzRwANu3d8hQ: posts big blind $2
*** HOLE CARDS ***
GX1heJ+DSsvm7gzSPsYhhQ: raises $4 to $6
WUlHm+ydPPHG7Lb0rePSdA: folds
EBV6OktyeSmh4w6sWmcWOw: folds
rW/MyplHylMSBRaoRUzWrg: raises $6 to $12
pN/Ip0ePsUVIdUlGgLrkUw: folds
Kzta8yu9vxHT4B70mjBZ+w: raises $32 to $44
/inIs/z/PcX+TniIFpaxpg: folds
nXDI8Y/S6POzRwANu3d8hQ: calls $38 and is all-in
GX1heJ+DSsvm7gzSPsYhhQ: folds
rW/MyplHylMSBRaoRUzWrg: calls $16 and is all-in
*** FLOP *** [8d 5c Qc]
*** TURN *** [8d 5c Qc] [Qh]
*** RIVER *** [8d 5c Qc Qh] [Qd]
*** SHOW DOWN ***
nXDI8Y/S6POzRwANu3d8hQ: shows [Ad Ac] (a full house, Queens full of Aces)
Kzta8yu9vxHT4B70mjBZ+w: mucks hand
nXDI8Y/S6POzRwANu3d8hQ collected $24 from side pot
rW/MyplHylMSBRaoRUzWrg: mucks hand
nXDI8Y/S6POzRwANu3d8hQ collected $88 from main pot
*** SUMMARY ***
Total pot $115 Main pot $88. Side pot $24. | Rake $3
Board [8d 5c Qc Qh Qd]
Seat 1: /inIs/z/PcX+TniIFpaxpg (small blind) folded before Flop
Seat 2: nXDI8Y/S6POzRwANu3d8hQ (big blind) showed [Ad Ac] and won ($112) with a full house, Queens full of Aces
Seat 3: GX1heJ+DSsvm7gzSPsYhhQ folded before Flop
Seat 5: WUlHm+ydPPHG7Lb0rePSdA folded before Flop (didn't bet)
Seat 6: EBV6OktyeSmh4w6sWmcWOw folded before Flop (didn't bet)
Seat 7: rW/MyplHylMSBRaoRUzWrg mucked
Seat 8: pN/Ip0ePsUVIdUlGgLrkUw folded before Flop (didn't bet)
Seat 9: Kzta8yu9vxHT4B70mjBZ+w (button) mucked



PokerStars Game #59941543622:  Hold'em No Limit ($1/$2) - 2009/07/01 1:38:39 ET
Table 'bJQ024BaYSBrW0sXpCZbNQ' 6-max Seat #3 is the button
Seat 1: KfwW5us6tydK81NYTtK1gw ($203 in chips)
Seat 2: 3dAbvkxS5NPQTBAbvpinVg ($200 in chips)
Seat 3: /PH6Ffnho4Ysm8S3V/oa+w ($42 in chips)
Seat 4: TBaQIN+sQ7eb7P99QnaORQ ($67.15 in chips)
Seat 5: VvdR9F3I+2yELkfTVvC1dg ($200 in chips)
Seat 6: 4bqvCfJ0e8CTYnn0Go9hbQ ($102.20 in chips)
TBaQIN+sQ7eb7P99QnaORQ: posts small blind $1
VvdR9F3I+2yELkfTVvC1dg: posts big blind $2
*** HOLE CARDS ***
4bqvCfJ0e8CTYnn0Go9hbQ: calls $2
KfwW5us6tydK81NYTtK1gw: folds
3dAbvkxS5NPQTBAbvpinVg: folds
/PH6Ffnho4Ysm8S3V/oa+w: raises $4 to $6
TBaQIN+sQ7eb7P99QnaORQ: calls $5
VvdR9F3I+2yELkfTVvC1dg: folds
4bqvCfJ0e8CTYnn0Go9hbQ: calls $4
*** FLOP *** [7d 5d 2s]
TBaQIN+sQ7eb7P99QnaORQ: checks
4bqvCfJ0e8CTYnn0Go9hbQ: checks
/PH6Ffnho4Ysm8S3V/oa+w: bets $9
TBaQIN+sQ7eb7P99QnaORQ: folds
4bqvCfJ0e8CTYnn0Go9hbQ: calls $9
*** TURN *** [7d 5d 2s] [Ad]
4bqvCfJ0e8CTYnn0Go9hbQ: checks
/PH6Ffnho4Ysm8S3V/oa+w: bets $27 and is all-in
4bqvCfJ0e8CTYnn0Go9hbQ: calls $27
*** RIVER *** [7d 5d 2s Ad] [9d]
*** SHOW DOWN ***
4bqvCfJ0e8CTYnn0Go9hbQ: shows [Td Ac] (a flush, Ace high)
/PH6Ffnho4Ysm8S3V/oa+w: mucks hand
4bqvCfJ0e8CTYnn0Go9hbQ collected $89 from pot
*** SUMMARY ***
Total pot $92 | Rake $3
Board [7d 5d 2s Ad 9d]
Seat 1: KfwW5us6tydK81NYTtK1gw folded before Flop (didn't bet)
Seat 2: 3dAbvkxS5NPQTBAbvpinVg folded before Flop (didn't bet)
Seat 3: /PH6Ffnho4Ysm8S3V/oa+w (button) mucked
Seat 4: TBaQIN+sQ7eb7P99QnaORQ (small blind) folded on the Flop
Seat 5: VvdR9F3I+2yELkfTVvC1dg (big blind) folded before Flop
Seat 6: 4bqvCfJ0e8CTYnn0Go9hbQ showed [Td Ac] and won ($89) with a flush, Ace high



PokerStars Game #59941544038:  Hold'em No Limit ($1/$2) - 2009/07/01 1:38:40 ET
Table 'ZzSIe0zTCDv+n6hfbY5tTg' 6-max Seat #6 is the button
Seat 1: VvdR9F3I+2yELkfTVvC1dg ($238 in chips)
Seat 2: B87ikIyZ/TzAVeXf38Ny0g ($237 in chips)
Seat 3: gsugPj31Hui3Jefl98MBOA ($358.25 in chips)
Seat 4: qXDd0ZyMIse0OBu8pxeQ3Q ($259 in chips)
Seat 5: 3dAbvkxS5NPQTBAbvpinVg ($508.10 in chips)
Seat 6: 09BNF4quPDzanQzM8vc6WA ($39 in chips)
VvdR9F3I+2yELkfTVvC1dg: posts small blind $1
B87ikIyZ/TzAVeXf38Ny0g: posts big blind $2
*** HOLE CARDS ***
gsugPj31Hui3Jefl98MBOA: folds
qXDd0ZyMIse0OBu8pxeQ3Q: raises $5 to $7
3dAbvkxS5NPQTBAbvpinVg: calls $7
09BNF4quPDzanQzM8vc6WA: folds
VvdR9F3I+2yELkfTVvC1dg: raises $22 to $29
B87ikIyZ/TzAVeXf38Ny0g: folds
qXDd0ZyMIse0OBu8pxeQ3Q: folds
3dAbvkxS5NPQTBAbvpinVg: folds
VvdR9F3I+2yELkfTVvC1dg collected $23 from pot
VvdR9F3I+2yELkfTVvC1dg: doesn't show hand
*** SUMMARY ***
Total pot $23 | Rake $0
Seat 1: VvdR9F3I+2yELkfTVvC1dg (small blind) collected ($23)
Seat 2: B87ikIyZ/TzAVeXf38Ny0g (big blind) folded before Flop
Seat 3: gsugPj31Hui3Jefl98MBOA folded before Flop (didn't bet)
Seat 4: qXDd0ZyMIse0OBu8pxeQ3Q folded before Flop
Seat 5: 3dAbvkxS5NPQTBAbvpinVg folded before Flop
Seat 6: 09BNF4quPDzanQzM8vc6WA (button) folded before Flop (didn't bet)



PokerStars Game #59941544772:  Hold'em No Limit ($1/$2) - 2009/07/01 1:38:41 ET
Table 'AtOXMvcrtQM8yLNcALmfLQ' 2-max Seat #1 is the button
Seat 1: +HlQuAsMqZGYYtjcPO/a3A ($332.50 in chips)
Seat 2: pVqEzK9wXlRMECnb1Zg4Zw ($238.50 in chips)
+HlQuAsMqZGYYtjcPO/a3A: posts small blind $1
pVqEzK9wXlRMECnb1Zg4Zw: posts big blind $2
*** HOLE CARDS ***
+HlQuAsMqZGYYtjcPO/a3A: raises $4 to $6
pVqEzK9wXlRMECnb1Zg4Zw: calls $4
*** FLOP *** [2s Qc 9h]
pVqEzK9wXlRMECnb1Zg4Zw: checks
+HlQuAsMqZGYYtjcPO/a3A: checks
*** TURN *** [2s Qc 9h] [8c]
pVqEzK9wXlRMECnb1Zg4Zw: checks
+HlQuAsMqZGYYtjcPO/a3A: bets $10
pVqEzK9wXlRMECnb1Zg4Zw: folds
+HlQuAsMqZGYYtjcPO/a3A collected $11.50 from pot
*** SUMMARY ***
Total pot $12 | Rake $0.50
Board [2s Qc 9h 8c]
Seat 1: +HlQuAsMqZGYYtjcPO/a3A (button) (small blind) collected ($11.50)
Seat 2: pVqEzK9wXlRMECnb1Zg4Zw (big blind) folded on the Turn



PokerStars Game #59941545172:  Hold'em No Limit ($1/$2) - 2009/07/01 1:38:42 ET
Table 'aSf77Sj8QEnzcc0WaxVD4Q' 6-max Seat #2 is the button
Seat 1: UELtvp+JfwI7XDGVwSxZXA ($260.10 in chips)
Seat 2: vkfxu8f/jMYKUk6Ly4eujw ($209.30 in chips)
Seat 3: 9dpyyjDTCed6nV7JhaUUpw ($519.10 in chips)
Seat 4: YsLQ3BAvgQHWXMAv3Wv6Hg ($201.50 in chips)
Seat 5: VvdR9F3I+2yELkfTVvC1dg ($258 in chips)
Seat 6: vkoJRf3gidxY1pPi0AFWww ($132.10 in chips)
9dpyyjDTCed6nV7JhaUUpw: posts small blind $1
YsLQ3BAvgQHWXMAv3Wv6Hg: posts big blind $2
*** HOLE CARDS ***
VvdR9F3I+2yELkfTVvC1dg: folds
vkoJRf3gidxY1pPi0AFWww: folds
UELtvp+JfwI7XDGVwSxZXA: folds
vkfxu8f/jMYKUk6Ly4eujw: raises $4 to $6
9dpyyjDTCed6nV7JhaUUpw: folds
YsLQ3BAvgQHWXMAv3Wv6Hg: calls $4
*** FLOP *** [8c 3c 2d]
YsLQ3BAvgQHWXMAv3Wv6Hg: checks
vkfxu8f/jMYKUk6Ly4eujw: bets $8
YsLQ3BAvgQHWXMAv3Wv6Hg: folds
vkfxu8f/jMYKUk6Ly4eujw collected $12.35 from pot
vkfxu8f/jMYKUk6Ly4eujw: doesn't show hand
*** SUMMARY ***
Total pot $13 | Rake $0.65
Board [8c 3c 2d]
Seat 1: UELtvp+JfwI7XDGVwSxZXA folded before Flop (didn't bet)
Seat 2: vkfxu8f/jMYKUk6Ly4eujw (button) collected ($12.35)
Seat 3: 9dpyyjDTCed6nV7JhaUUpw (small blind) folded before Flop
Seat 4: YsLQ3BAvgQHWXMAv3Wv6Hg (big blind) folded on the Flop
Seat 5: VvdR9F3I+2yELkfTVvC1dg folded before Flop (didn't bet)
Seat 6: vkoJRf3gidxY1pPi0AFWww folded before Flop (didn't bet)



PokerStars Game #59941545696:  Hold'em No Limit ($1/$2) - 2009/07/01 1:38:43 ET
Table '/dyk+YdRGv90j2box35j8w' 6-max Seat #6 is the button
Seat 1: 8srN1dKQePlsv0GyTada+Q ($210.25 in chips)
Seat 2: qCnEYuAE5y5A7bk6fO5/jQ ($473.60 in chips)
Seat 3: sTPOWERd9HWPCNrDBwsVjA ($182.50 in chips)
Seat 5: VvdR9F3I+2yELkfTVvC1dg ($249 in chips)
Seat 6: gnYme0DNFflnMhrdbxe1Ag ($200 in chips)
8srN1dKQePlsv0GyTada+Q: posts small blind $1
qCnEYuAE5y5A7bk6fO5/jQ: posts big blind $2
z/u1YTnkiIDrtp/2cA2dBg: sits out
*** HOLE CARDS ***
sTPOWERd9HWPCNrDBwsVjA: folds
VvdR9F3I+2yELkfTVvC1dg: raises $2 to $4
gnYme0DNFflnMhrdbxe1Ag: folds
8srN1dKQePlsv0GyTada+Q: folds
qCnEYuAE5y5A7bk6fO5/jQ: folds
VvdR9F3I+2yELkfTVvC1dg collected $5 from pot
VvdR9F3I+2yELkfTVvC1dg: doesn't show hand
*** SUMMARY ***
Total pot $5 | Rake $0
Seat 1: 8srN1dKQePlsv0GyTada+Q (small blind) folded before Flop
Seat 2: qCnEYuAE5y5A7bk6fO5/jQ (big blind) folded before Flop
Seat 3: sTPOWERd9HWPCNrDBwsVjA folded before Flop (didn't bet)
Seat 5: VvdR9F3I+2yELkfTVvC1dg collected ($5)
Seat 6: gnYme0DNFflnMhrdbxe1Ag (button) folded before Flop (didn't bet)



PokerStars Game #59941547138:  Hold'em No Limit ($1/$2) - 2009/07/01 1:38:46 ET
Table 'on4i1U1lCRmxsduFD3xiSg' 9-max Seat #4 is the button
Seat 1: so5k3vFDmokh2q3dImJ1GQ ($176.30 in chips)
Seat 2: NqSvZNzJ4RkR3sCmgQnyLw ($44.85 in chips)
Seat 3: GX1heJ+DSsvm7gzSPsYhhQ ($33 in chips)
Seat 4: DFQVuszLVclqjA46pN4Vvw ($93.80 in chips)
Seat 7: /inIs/z/PcX+TniIFpaxpg ($269.05 in chips)
Seat 8: ZYHoLw2lWmRS7CSHi8L8Xg ($200 in chips)
Seat 9: TAfo4veNRaRlzDXMMYS3Jg ($37 in chips)
37j/5DgMG5m9lMfFofEAOg will be allowed to play after the button
KqHysDSpCPaPyK3tJC1aEw will be allowed to play after the button
/inIs/z/PcX+TniIFpaxpg: posts small blind $1
ZYHoLw2lWmRS7CSHi8L8Xg: posts big blind $2
*** HOLE CARDS ***
TAfo4veNRaRlzDXMMYS3Jg: folds
so5k3vFDmokh2q3dImJ1GQ: folds
NqSvZNzJ4RkR3sCmgQnyLw: folds
GX1heJ+DSsvm7gzSPsYhhQ: folds
DFQVuszLVclqjA46pN4Vvw: folds
/inIs/z/PcX+TniIFpaxpg: folds
ZYHoLw2lWmRS7CSHi8L8Xg collected $2 from pot
ZYHoLw2lWmRS7CSHi8L8Xg: doesn't show hand
*** SUMMARY ***
Total pot $2 | Rake $0
Seat 1: so5k3vFDmokh2q3dImJ1GQ folded before Flop (didn't bet)
Seat 2: NqSvZNzJ4RkR3sCmgQnyLw folded before Flop (didn't bet)
Seat 3: GX1heJ+DSsvm7gzSPsYhhQ folded before Flop (didn't bet)
Seat 4: DFQVuszLVclqjA46pN4Vvw (button) folded before Flop (didn't bet)
Seat 7: /inIs/z/PcX+TniIFpaxpg (small blind) folded before Flop
Seat 8: ZYHoLw2lWmRS7CSHi8L8Xg (big blind) collected ($2)
Seat 9: TAfo4veNRaRlzDXMMYS3Jg folded before Flop (didn't bet)



PokerStars Game #59941547738:  Hold'em No Limit ($1/$2) - 2009/07/01 1:38:47 ET
Table 'P/yCfYl1GfGsu/e6DxDy/A' 2-max Seat #1 is the button
Seat 1: 7fOCUy3x9hdkmXkkDNolGQ ($486 in chips)
Seat 2: RwDoM55ZeQuI2ADyJhOb2Q ($993 in chips)
7fOCUy3x9hdkmXkkDNolGQ: posts small blind $1
RwDoM55ZeQuI2ADyJhOb2Q: posts big blind $2
*** HOLE CARDS ***
7fOCUy3x9hdkmXkkDNolGQ: raises $4 to $6
RwDoM55ZeQuI2ADyJhOb2Q: calls $4
*** FLOP *** [Kd Kh Jc]
RwDoM55ZeQuI2ADyJhOb2Q: checks
7fOCUy3x9hdkmXkkDNolGQ: bets $8
RwDoM55ZeQuI2ADyJhOb2Q: calls $8
*** TURN *** [Kd Kh Jc] [2d]
RwDoM55ZeQuI2ADyJhOb2Q: checks
7fOCUy3x9hdkmXkkDNolGQ: checks
*** RIVER *** [Kd Kh Jc 2d] [7d]
RwDoM55ZeQuI2ADyJhOb2Q: checks
7fOCUy3x9hdkmXkkDNolGQ: bets $18
RwDoM55ZeQuI2ADyJhOb2Q: folds
7fOCUy3x9hdkmXkkDNolGQ collected $27.50 from pot
7fOCUy3x9hdkmXkkDNolGQ: doesn't show hand
*** SUMMARY ***
Total pot $28 | Rake $0.50
Board [Kd Kh Jc 2d 7d]
Seat 1: 7fOCUy3x9hdkmXkkDNolGQ (button) (small blind) collected ($27.50)
Seat 2: RwDoM55ZeQuI2ADyJhOb2Q (big blind) folded on the River



PokerStars Game #59941551286:  Hold'em No Limit ($1/$2) - 2009/07/01 1:38:53 ET
Table 'ztv6V3FN2bQ9nmJPPdx6nQ' 6-max Seat #4 is the button
Seat 1: 6fLdOUCRtX71xbVRhJEq8w ($238.35 in chips)
Seat 2: 5Y+ZGWLI4gnlpApDX5vy1A ($391.15 in chips)
Seat 3: ubtx4Z5L+AcK71MTvYiGVw ($245 in chips)
Seat 4: UaZ5yj+6LjtWqMQg2QskUw ($88.30 in chips)
Seat 5: sTPOWERd9HWPCNrDBwsVjA ($221.60 in chips)
Seat 6: mfy7uGZcqA2PVQqEVbJ7+g ($112.60 in chips)
sTPOWERd9HWPCNrDBwsVjA: posts small blind $1
mfy7uGZcqA2PVQqEVbJ7+g: posts big blind $2
*** HOLE CARDS ***
6fLdOUCRtX71xbVRhJEq8w: folds
5Y+ZGWLI4gnlpApDX5vy1A: raises $6 to $8
ubtx4Z5L+AcK71MTvYiGVw: folds
UaZ5yj+6LjtWqMQg2QskUw: folds
sTPOWERd9HWPCNrDBwsVjA: folds
mfy7uGZcqA2PVQqEVbJ7+g: folds
5Y+ZGWLI4gnlpApDX5vy1A collected $5 from pot
5Y+ZGWLI4gnlpApDX5vy1A: doesn't show hand
*** SUMMARY ***
Total pot $5 | Rake $0
Seat 1: 6fLdOUCRtX71xbVRhJEq8w folded before Flop (didn't bet)
Seat 2: 5Y+ZGWLI4gnlpApDX5vy1A collected ($5)
Seat 3: ubtx4Z5L+AcK71MTvYiGVw folded before Flop (didn't bet)
Seat 4: UaZ5yj+6LjtWqMQg2QskUw (button) folded before Flop (didn't bet)
Seat 5: sTPOWERd9HWPCNrDBwsVjA (small blind) folded before Flop
Seat 6: mfy7uGZcqA2PVQqEVbJ7+g (big blind) folded before Flop



PokerStars Game #59941552500:  Hold'em No Limit ($1/$2) - 2009/07/01 1:38:56 ET
Table 'uJ9juaXXg9yIcSU8amxaXQ' 6-max Seat #6 is the button
Seat 1: JsqOjN/eHz0uYVf/PyUJ6Q ($151.25 in chips)
Seat 2: VvdR9F3I+2yELkfTVvC1dg ($223.10 in chips)
Seat 3: qXDd0ZyMIse0OBu8pxeQ3Q ($249.40 in chips)
Seat 4: zNjJ/y4emmF+vzrCDd+ooA ($222.05 in chips)
Seat 5: YsLQ3BAvgQHWXMAv3Wv6Hg ($205.70 in chips)
Seat 6: /PH6Ffnho4Ysm8S3V/oa+w ($40 in chips)
JsqOjN/eHz0uYVf/PyUJ6Q: posts small blind $1
VvdR9F3I+2yELkfTVvC1dg: posts big blind $2
*** HOLE CARDS ***
qXDd0ZyMIse0OBu8pxeQ3Q: folds
zNjJ/y4emmF+vzrCDd+ooA: folds
YsLQ3BAvgQHWXMAv3Wv6Hg: folds
/PH6Ffnho4Ysm8S3V/oa+w: raises $2 to $4
JsqOjN/eHz0uYVf/PyUJ6Q: folds
VvdR9F3I+2yELkfTVvC1dg: folds
/PH6Ffnho4Ysm8S3V/oa+w collected $5 from pot
/PH6Ffnho4Ysm8S3V/oa+w: doesn't show hand
*** SUMMARY ***
Total pot $5 | Rake $0
Seat 1: JsqOjN/eHz0uYVf/PyUJ6Q (small blind) folded before Flop
Seat 2: VvdR9F3I+2yELkfTVvC1dg (big blind) folded before Flop
Seat 3: qXDd0ZyMIse0OBu8pxeQ3Q folded before Flop (didn't bet)
Seat 4: zNjJ/y4emmF+vzrCDd+ooA folded before Flop (didn't bet)
Seat 5: YsLQ3BAvgQHWXMAv3Wv6Hg folded before Flop (didn't bet)
Seat 6: /PH6Ffnho4Ysm8S3V/oa+w (button) collected ($5)



PokerStars Game #59941552714:  Hold'em No Limit ($1/$2) - 2009/07/01 1:38:56 ET
Table '4NGNnZ/osQfNq6abYqkJeA' 6-max Seat #4 is the button
Seat 1: vkfxu8f/jMYKUk6Ly4eujw ($193 in chips)
Seat 2: 669iGNwYwgRZg3nhS+aDAQ ($99.90 in chips)
Seat 3: 54yWzRRgS0oZ+S6LwZBxMQ ($32.80 in chips)
Seat 4: sY+4Uuh5z/6AbXXaCS10jw ($233.25 in chips)
Seat 5: VvdR9F3I+2yELkfTVvC1dg ($239.55 in chips)
Seat 6: /PH6Ffnho4Ysm8S3V/oa+w ($40 in chips)
VvdR9F3I+2yELkfTVvC1dg: posts small blind $1
/PH6Ffnho4Ysm8S3V/oa+w: posts big blind $2
*** HOLE CARDS ***
vkfxu8f/jMYKUk6Ly4eujw: folds
669iGNwYwgRZg3nhS+aDAQ: folds
54yWzRRgS0oZ+S6LwZBxMQ: folds
sY+4Uuh5z/6AbXXaCS10jw: folds
VvdR9F3I+2yELkfTVvC1dg: folds
/PH6Ffnho4Ysm8S3V/oa+w collected $2 from pot
/PH6Ffnho4Ysm8S3V/oa+w: doesn't show hand
*** SUMMARY ***
Total pot $2 | Rake $0
Seat 1: vkfxu8f/jMYKUk6Ly4eujw folded before Flop (didn't bet)
Seat 2: 669iGNwYwgRZg3nhS+aDAQ folded before Flop (didn't bet)
Seat 3: 54yWzRRgS0oZ+S6LwZBxMQ folded before Flop (didn't bet)
Seat 4: sY+4Uuh5z/6AbXXaCS10jw (button) folded before Flop (didn't bet)
Seat 5: VvdR9F3I+2yELkfTVvC1dg (small blind) folded before Flop
Seat 6: /PH6Ffnho4Ysm8S3V/oa+w (big blind) collected ($2)



PokerStars Game #59941554158:  Hold'em No Limit ($1/$2) - 2009/07/01 1:38:59 ET
Table 'NmY84NAf9Mh0ckAckHnh5g' 2-max Seat #2 is the button
Seat 1: 6hvg964TSqZ3AL/0XK9aVQ ($449.10 in chips)
Seat 2: RwDoM55ZeQuI2ADyJhOb2Q ($544.50 in chips)
RwDoM55ZeQuI2ADyJhOb2Q: posts small blind $1
6hvg964TSqZ3AL/0XK9aVQ: posts big blind $2
*** HOLE CARDS ***
RwDoM55ZeQuI2ADyJhOb2Q: folds
6hvg964TSqZ3AL/0XK9aVQ collected $2 from pot
6hvg964TSqZ3AL/0XK9aVQ: doesn't show hand
*** SUMMARY ***
Total pot $2 | Rake $0
Seat 1: 6hvg964TSqZ3AL/0XK9aVQ (big blind) collected ($2)
Seat 2: RwDoM55ZeQuI2ADyJhOb2Q (button) (small blind) folded before Flop



PokerStars Game #59941554950:  Hold'em No Limit ($1/$2) - 2009/07/01 1:39:00 ET
Table 'LL4bDFyhj5hsMpzaDugJZg' 6-max Seat #3 is the button
Seat 2: IZng3w8jiJHHp3LbYKLi4w ($51.75 in chips)
Seat 3: iI/NMpRxMkGieArQEhACSA ($578.25 in chips)
Seat 4: 8srN1dKQePlsv0GyTada+Q ($200 in chips)
Seat 6: 692Q4sfB0gTElzS0WMeg+A ($205.35 in chips)
8srN1dKQePlsv0GyTada+Q: posts small blind $1
A2GTwTiwkb1ilNWgW487Vg: is sitting out
692Q4sfB0gTElzS0WMeg+A: posts big blind $2
*** HOLE CARDS ***
A2GTwTiwkb1ilNWgW487Vg leaves the table
IZng3w8jiJHHp3LbYKLi4w: folds
iI/NMpRxMkGieArQEhACSA: folds
8srN1dKQePlsv0GyTada+Q: folds
692Q4sfB0gTElzS0WMeg+A collected $2 from pot
692Q4sfB0gTElzS0WMeg+A: doesn't show hand
*** SUMMARY ***
Total pot $2 | Rake $0
Seat 2: IZng3w8jiJHHp3LbYKLi4w folded before Flop (didn't bet)
Seat 3: iI/NMpRxMkGieArQEhACSA (button) folded before Flop (didn't bet)
Seat 4: 8srN1dKQePlsv0GyTada+Q (small blind) folded before Flop
Seat 6: 692Q4sfB0gTElzS0WMeg+A (big blind) collected ($2)



PokerStars Game #59941556086:  Hold'em No Limit ($1/$2) - 2009/07/01 1:39:02 ET
Table 'UGLAZZyv+cXmnKjYin0etA' 6-max Seat #5 is the button
Seat 1: vkfxu8f/jMYKUk6Ly4eujw ($201 in chips)
Seat 2: eDLH1PUXFpvJBNMXBVQcGA ($313.10 in chips)
Seat 3: ygTTt5ehT4aF86q1a8/R+w ($114.20 in chips)
Seat 4: SiGJDsvRViJX05vHhA80GQ ($231.85 in chips)
Seat 5: 54yWzRRgS0oZ+S6LwZBxMQ ($30 in chips)
Seat 6: sTPOWERd9HWPCNrDBwsVjA ($219.15 in chips)
sTPOWERd9HWPCNrDBwsVjA: posts small blind $1
vkfxu8f/jMYKUk6Ly4eujw: posts big blind $2
*** HOLE CARDS ***
eDLH1PUXFpvJBNMXBVQcGA: folds
ygTTt5ehT4aF86q1a8/R+w: folds
SiGJDsvRViJX05vHhA80GQ: folds
54yWzRRgS0oZ+S6LwZBxMQ: raises $2 to $4
sTPOWERd9HWPCNrDBwsVjA: folds
vkfxu8f/jMYKUk6Ly4eujw: folds
54yWzRRgS0oZ+S6LwZBxMQ collected $5 from pot
*** SUMMARY ***
Total pot $5 | Rake $0
Seat 1: vkfxu8f/jMYKUk6Ly4eujw (big blind) folded before Flop
Seat 2: eDLH1PUXFpvJBNMXBVQcGA folded before Flop (didn't bet)
Seat 3: ygTTt5ehT4aF86q1a8/R+w folded before Flop (didn't bet)
Seat 4: SiGJDsvRViJX05vHhA80GQ folded before Flop (didn't bet)
Seat 5: 54yWzRRgS0oZ+S6LwZBxMQ (button) collected ($5)
Seat 6: sTPOWERd9HWPCNrDBwsVjA (small blind) folded before Flop



PokerStars Game #59941556486:  Hold'em No Limit ($1/$2) - 2009/07/01 1:39:03 ET
Table 'CFkQcfWjKccZaZDf71FK+w' 6-max Seat #6 is the button
Seat 1: vkfxu8f/jMYKUk6Ly4eujw ($223.40 in chips)
Seat 2: ewN/vzF22+/gdzjIKBOlkA ($208.05 in chips)
Seat 3: 09BNF4quPDzanQzM8vc6WA ($43.65 in chips)
Seat 4: ygTTt5ehT4aF86q1a8/R+w ($246.35 in chips)
Seat 5: 2lOU1DcvUZaMcxZ95XfzXw ($191.60 in chips)
Seat 6: ORVqY3rf9X6ANA/8s+On2Q ($46.60 in chips)
vkfxu8f/jMYKUk6Ly4eujw: posts small blind $1
ewN/vzF22+/gdzjIKBOlkA: posts big blind $2
*** HOLE CARDS ***
09BNF4quPDzanQzM8vc6WA: folds
ygTTt5ehT4aF86q1a8/R+w: folds
2lOU1DcvUZaMcxZ95XfzXw: calls $2
ORVqY3rf9X6ANA/8s+On2Q: folds
vkfxu8f/jMYKUk6Ly4eujw: folds
ewN/vzF22+/gdzjIKBOlkA: checks
*** FLOP *** [7d Qd Th]
ewN/vzF22+/gdzjIKBOlkA: checks
2lOU1DcvUZaMcxZ95XfzXw: bets $6
ewN/vzF22+/gdzjIKBOlkA: folds
2lOU1DcvUZaMcxZ95XfzXw collected $4.75 from pot
*** SUMMARY ***
Total pot $5 | Rake $0.25
Board [7d Qd Th]
Seat 1: vkfxu8f/jMYKUk6Ly4eujw (small blind) folded before Flop
Seat 2: ewN/vzF22+/gdzjIKBOlkA (big blind) folded on the Flop
Seat 3: 09BNF4quPDzanQzM8vc6WA folded before Flop (didn't bet)
Seat 4: ygTTt5ehT4aF86q1a8/R+w folded before Flop (didn't bet)
Seat 5: 2lOU1DcvUZaMcxZ95XfzXw collected ($4.75)
Seat 6: ORVqY3rf9X6ANA/8s+On2Q (button) folded before Flop (didn't bet)



PokerStars Game #59941556972:  Hold'em No Limit ($1/$2) - 2009/07/01 1:39:04 ET
Table 'G1Oqdy4Pqdb5gtx40rUBzA' 6-max Seat #4 is the button
Seat 2: 4uqU0dG67owXuPz303Al4w ($522.60 in chips)
Seat 3: VvdR9F3I+2yELkfTVvC1dg ($227.90 in chips)
Seat 4: B87ikIyZ/TzAVeXf38Ny0g ($211.55 in chips)
Seat 5: F1+Ml47qRQWunzPnGhLLzQ ($201.65 in chips)
Seat 6: qCnEYuAE5y5A7bk6fO5/jQ ($200 in chips)
F1+Ml47qRQWunzPnGhLLzQ: posts small blind $1
qCnEYuAE5y5A7bk6fO5/jQ: posts big blind $2
*** HOLE CARDS ***
4uqU0dG67owXuPz303Al4w: folds
VvdR9F3I+2yELkfTVvC1dg: folds
B87ikIyZ/TzAVeXf38Ny0g: raises $4 to $6
F1+Ml47qRQWunzPnGhLLzQ: folds
qCnEYuAE5y5A7bk6fO5/jQ: raises $16 to $22
B87ikIyZ/TzAVeXf38Ny0g: folds
qCnEYuAE5y5A7bk6fO5/jQ collected $13 from pot
qCnEYuAE5y5A7bk6fO5/jQ: doesn't show hand
*** SUMMARY ***
Total pot $13 | Rake $0
Seat 2: 4uqU0dG67owXuPz303Al4w folded before Flop (didn't bet)
Seat 3: VvdR9F3I+2yELkfTVvC1dg folded before Flop (didn't bet)
Seat 4: B87ikIyZ/TzAVeXf38Ny0g (button) folded before Flop
Seat 5: F1+Ml47qRQWunzPnGhLLzQ (small blind) folded before Flop
Seat 6: qCnEYuAE5y5A7bk6fO5/jQ (big blind) collected ($13)



PokerStars Game #59941557396:  Hold'em No Limit ($1/$2) - 2009/07/01 1:39:04 ET
Table 'NmY84NAf9Mh0ckAckHnh5g' 2-max Seat #1 is the button
Seat 1: 6hvg964TSqZ3AL/0XK9aVQ ($450.10 in chips)
Seat 2: RwDoM55ZeQuI2ADyJhOb2Q ($543.50 in chips)
6hvg964TSqZ3AL/0XK9aVQ: posts small blind $1
RwDoM55ZeQuI2ADyJhOb2Q: posts big blind $2
*** HOLE CARDS ***
6hvg964TSqZ3AL/0XK9aVQ: folds
RwDoM55ZeQuI2ADyJhOb2Q collected $2 from pot
RwDoM55ZeQuI2ADyJhOb2Q: doesn't show hand
*** SUMMARY ***
Total pot $2 | Rake $0
Seat 1: 6hvg964TSqZ3AL/0XK9aVQ (button) (small blind) folded before Flop
Seat 2: RwDoM55ZeQuI2ADyJhOb2Q (big blind) collected ($2)



PokerStars Game #59941559078:  Hold'em No Limit ($1/$2) - 2009/07/01 1:39:07 ET
Table 'YqGfR5eHfMeSjb9a+QU9rg' 9-max Seat #8 is the button
Seat 1: rW/MyplHylMSBRaoRUzWrg ($39 in chips)
Seat 3: /gll27k+xWYV7Fbki0lFDQ ($258.75 in chips)
Seat 4: GX1heJ+DSsvm7gzSPsYhhQ ($34 in chips)
Seat 5: CkE3IyJF1KvdaAOmZY5XqQ ($201.75 in chips)
Seat 6: TAfo4veNRaRlzDXMMYS3Jg ($40 in chips)
Seat 7: 41aZuLBz9nAi2GPVKabmCw ($94.95 in chips)
Seat 8: JnV3SM2D6dAFYyGZHHpvrg ($90.25 in chips)
Seat 9: /inIs/z/PcX+TniIFpaxpg ($205.20 in chips)
/inIs/z/PcX+TniIFpaxpg: posts small blind $1
rW/MyplHylMSBRaoRUzWrg: posts big blind $2
nXDI8Y/S6POzRwANu3d8hQ: sits out
*** HOLE CARDS ***
/gll27k+xWYV7Fbki0lFDQ: folds
GX1heJ+DSsvm7gzSPsYhhQ: folds
CkE3IyJF1KvdaAOmZY5XqQ: folds
TAfo4veNRaRlzDXMMYS3Jg: folds
41aZuLBz9nAi2GPVKabmCw: calls $2
JnV3SM2D6dAFYyGZHHpvrg: calls $2
/inIs/z/PcX+TniIFpaxpg: folds
rW/MyplHylMSBRaoRUzWrg: checks
*** FLOP *** [6d Ad Jd]
rW/MyplHylMSBRaoRUzWrg: checks
41aZuLBz9nAi2GPVKabmCw: checks
JnV3SM2D6dAFYyGZHHpvrg: checks
*** TURN *** [6d Ad Jd] [3s]
rW/MyplHylMSBRaoRUzWrg: checks
41aZuLBz9nAi2GPVKabmCw: bets $4
JnV3SM2D6dAFYyGZHHpvrg: calls $4
rW/MyplHylMSBRaoRUzWrg: folds
*** RIVER *** [6d Ad Jd 3s] [Tc]
41aZuLBz9nAi2GPVKabmCw: bets $4
JnV3SM2D6dAFYyGZHHpvrg: raises $12 to $16
41aZuLBz9nAi2GPVKabmCw: folds
JnV3SM2D6dAFYyGZHHpvrg collected $21.90 from pot
*** SUMMARY ***
Total pot $23 | Rake $1.10
Board [6d Ad Jd 3s Tc]
Seat 1: rW/MyplHylMSBRaoRUzWrg (big blind) folded on the Turn
Seat 3: /gll27k+xWYV7Fbki0lFDQ folded before Flop (didn't bet)
Seat 4: GX1heJ+DSsvm7gzSPsYhhQ folded before Flop (didn't bet)
Seat 5: CkE3IyJF1KvdaAOmZY5XqQ folded before Flop (didn't bet)
Seat 6: TAfo4veNRaRlzDXMMYS3Jg folded before Flop (didn't bet)
Seat 7: 41aZuLBz9nAi2GPVKabmCw folded on the River
Seat 8: JnV3SM2D6dAFYyGZHHpvrg (button) collected ($21.90)
Seat 9: /inIs/z/PcX+TniIFpaxpg (small blind) folded before Flop



PokerStars Game #59941559994:  Hold'em No Limit ($1/$2) - 2009/07/01 1:39:09 ET
Table '3WCXyaiCAbqSShQu7FIjvA' 9-max Seat #7 is the button
Seat 1: kTCkABD1UUldS9DFRGfCwQ ($154.75 in chips)
Seat 2: TAfo4veNRaRlzDXMMYS3Jg ($37 in chips)
Seat 3: 5Q8U6iZbeO7xJSS4qvDP5g ($273.85 in chips)
Seat 4: waEF/+pxZTxNo4FvsORuXg ($106.40 in chips)
Seat 5: CkE3IyJF1KvdaAOmZY5XqQ ($200 in chips)
Seat 6: 5jQlngvMSqM/WoonOcR5kw ($288.35 in chips)
Seat 7: nXDI8Y/S6POzRwANu3d8hQ ($37 in chips)
Seat 8: 1CtiZuXDFaJL1dJPQKyi8Q ($205.05 in chips)
1CtiZuXDFaJL1dJPQKyi8Q: posts small blind $1
kTCkABD1UUldS9DFRGfCwQ: posts big blind $2
*** HOLE CARDS ***
TAfo4veNRaRlzDXMMYS3Jg: folds
5Q8U6iZbeO7xJSS4qvDP5g: raises $6 to $8
waEF/+pxZTxNo4FvsORuXg: folds
CkE3IyJF1KvdaAOmZY5XqQ: folds
5jQlngvMSqM/WoonOcR5kw: folds
nXDI8Y/S6POzRwANu3d8hQ: folds
1CtiZuXDFaJL1dJPQKyi8Q: folds
kTCkABD1UUldS9DFRGfCwQ: folds
5Q8U6iZbeO7xJSS4qvDP5g collected $5 from pot
5Q8U6iZbeO7xJSS4qvDP5g: doesn't show hand
*** SUMMARY ***
Total pot $5 | Rake $0
Seat 1: kTCkABD1UUldS9DFRGfCwQ (big blind) folded before Flop
Seat 2: TAfo4veNRaRlzDXMMYS3Jg folded before Flop (didn't bet)
Seat 3: 5Q8U6iZbeO7xJSS4qvDP5g collected ($5)
Seat 4: waEF/+pxZTxNo4FvsORuXg folded before Flop (didn't bet)
Seat 5: CkE3IyJF1KvdaAOmZY5XqQ folded before Flop (didn't bet)
Seat 6: 5jQlngvMSqM/WoonOcR5kw folded before Flop (didn't bet)
Seat 7: nXDI8Y/S6POzRwANu3d8hQ (button) folded before Flop (didn't bet)
Seat 8: 1CtiZuXDFaJL1dJPQKyi8Q (small blind) folded before Flop



PokerStars Game #59941560750:  Hold'em No Limit ($1/$2) - 2009/07/01 1:39:10 ET
Table 'NmY84NAf9Mh0ckAckHnh5g' 2-max Seat #2 is the button
Seat 1: 6hvg964TSqZ3AL/0XK9aVQ ($449.10 in chips)
Seat 2: RwDoM55ZeQuI2ADyJhOb2Q ($544.50 in chips)
RwDoM55ZeQuI2ADyJhOb2Q: posts small blind $1
6hvg964TSqZ3AL/0XK9aVQ: posts big blind $2
*** HOLE CARDS ***
RwDoM55ZeQuI2ADyJhOb2Q: raises $4 to $6
6hvg964TSqZ3AL/0XK9aVQ: calls $4
*** FLOP *** [7d 6d 4s]
6hvg964TSqZ3AL/0XK9aVQ: checks
RwDoM55ZeQuI2ADyJhOb2Q: bets $12
6hvg964TSqZ3AL/0XK9aVQ: calls $12
*** TURN *** [7d 6d 4s] [Qh]
6hvg964TSqZ3AL/0XK9aVQ: checks
RwDoM55ZeQuI2ADyJhOb2Q: checks
*** RIVER *** [7d 6d 4s Qh] [Kd]
6hvg964TSqZ3AL/0XK9aVQ: checks
RwDoM55ZeQuI2ADyJhOb2Q: checks
*** SHOW DOWN ***
6hvg964TSqZ3AL/0XK9aVQ: shows [3h 6h] (a pair of Sixes)
RwDoM55ZeQuI2ADyJhOb2Q: mucks hand
6hvg964TSqZ3AL/0XK9aVQ collected $35.50 from pot
*** SUMMARY ***
Total pot $36 | Rake $0.50
Board [7d 6d 4s Qh Kd]
Seat 1: 6hvg964TSqZ3AL/0XK9aVQ (big blind) showed [3h 6h] and won ($35.50) with a pair of Sixes
Seat 2: RwDoM55ZeQuI2ADyJhOb2Q (button) (small blind) mucked



PokerStars Game #59941561614:  Hold'em No Limit ($1/$2) - 2009/07/01 1:39:12 ET
Table 'on4i1U1lCRmxsduFD3xiSg' 9-max Seat #7 is the button
Seat 1: so5k3vFDmokh2q3dImJ1GQ ($176.30 in chips)
Seat 2: NqSvZNzJ4RkR3sCmgQnyLw ($44.85 in chips)
Seat 3: GX1heJ+DSsvm7gzSPsYhhQ ($33 in chips)
Seat 4: DFQVuszLVclqjA46pN4Vvw ($93.80 in chips)
Seat 5: 37j/5DgMG5m9lMfFofEAOg ($57.70 in chips)
Seat 7: /inIs/z/PcX+TniIFpaxpg ($268.05 in chips)
Seat 8: ZYHoLw2lWmRS7CSHi8L8Xg ($201 in chips)
Seat 9: TAfo4veNRaRlzDXMMYS3Jg ($37 in chips)
ZYHoLw2lWmRS7CSHi8L8Xg: posts small blind $1
TAfo4veNRaRlzDXMMYS3Jg: posts big blind $2
37j/5DgMG5m9lMfFofEAOg: posts small & big blinds $3
KqHysDSpCPaPyK3tJC1aEw: sits out
*** HOLE CARDS ***
so5k3vFDmokh2q3dImJ1GQ: folds
NqSvZNzJ4RkR3sCmgQnyLw: raises $6 to $8
GX1heJ+DSsvm7gzSPsYhhQ: folds
DFQVuszLVclqjA46pN4Vvw: folds
37j/5DgMG5m9lMfFofEAOg: folds
/inIs/z/PcX+TniIFpaxpg: folds
ZYHoLw2lWmRS7CSHi8L8Xg: folds
TAfo4veNRaRlzDXMMYS3Jg: folds
NqSvZNzJ4RkR3sCmgQnyLw collected $8 from pot
*** SUMMARY ***
Total pot $8 | Rake $0
Seat 1: so5k3vFDmokh2q3dImJ1GQ folded before Flop (didn't bet)
Seat 2: NqSvZNzJ4RkR3sCmgQnyLw collected ($8)
Seat 3: GX1heJ+DSsvm7gzSPsYhhQ folded before Flop (didn't bet)
Seat 4: DFQVuszLVclqjA46pN4Vvw folded before Flop (didn't bet)
Seat 5: 37j/5DgMG5m9lMfFofEAOg folded before Flop
Seat 7: /inIs/z/PcX+TniIFpaxpg (button) folded before Flop (didn't bet)
Seat 8: ZYHoLw2lWmRS7CSHi8L8Xg (small blind) folded before Flop
Seat 9: TAfo4veNRaRlzDXMMYS3Jg (big blind) folded before Flop



PokerStars Game #59941562438:  Hold'em No Limit ($1/$2) - 2009/07/01 1:39:14 ET
Table 'P/yCfYl1GfGsu/e6DxDy/A' 2-max Seat #2 is the button
Seat 1: 7fOCUy3x9hdkmXkkDNolGQ ($499.50 in chips)
Seat 2: RwDoM55ZeQuI2ADyJhOb2Q ($979 in chips)
RwDoM55ZeQuI2ADyJhOb2Q: posts small blind $1
7fOCUy3x9hdkmXkkDNolGQ: posts big blind $2
*** HOLE CARDS ***
RwDoM55ZeQuI2ADyJhOb2Q: raises $4 to $6
7fOCUy3x9hdkmXkkDNolGQ: calls $4
*** FLOP *** [Jh 7h 4c]
7fOCUy3x9hdkmXkkDNolGQ: checks
RwDoM55ZeQuI2ADyJhOb2Q: bets $8
7fOCUy3x9hdkmXkkDNolGQ: folds
RwDoM55ZeQuI2ADyJhOb2Q collected $11.50 from pot
RwDoM55ZeQuI2ADyJhOb2Q: doesn't show hand
*** SUMMARY ***
Total pot $12 | Rake $0.50
Board [Jh 7h 4c]
Seat 1: 7fOCUy3x9hdkmXkkDNolGQ (big blind) folded on the Flop
Seat 2: RwDoM55ZeQuI2ADyJhOb2Q (button) (small blind) collected ($11.50)



PokerStars Game #59941563262:  Hold'em No Limit ($1/$2) - 2009/07/01 1:39:15 ET
Table 'aSf77Sj8QEnzcc0WaxVD4Q' 6-max Seat #3 is the button
Seat 1: UELtvp+JfwI7XDGVwSxZXA ($260.10 in chips)
Seat 2: vkfxu8f/jMYKUk6Ly4eujw ($215.65 in chips)
Seat 3: 9dpyyjDTCed6nV7JhaUUpw ($518.10 in chips)
Seat 4: YsLQ3BAvgQHWXMAv3Wv6Hg ($200 in chips)
Seat 5: VvdR9F3I+2yELkfTVvC1dg ($258 in chips)
Seat 6: vkoJRf3gidxY1pPi0AFWww ($132.10 in chips)
YsLQ3BAvgQHWXMAv3Wv6Hg: posts small blind $1
VvdR9F3I+2yELkfTVvC1dg: posts big blind $2
*** HOLE CARDS ***
vkoJRf3gidxY1pPi0AFWww: folds
UELtvp+JfwI7XDGVwSxZXA: calls $2
vkfxu8f/jMYKUk6Ly4eujw: raises $8 to $10
9dpyyjDTCed6nV7JhaUUpw: calls $10
YsLQ3BAvgQHWXMAv3Wv6Hg: folds
VvdR9F3I+2yELkfTVvC1dg: folds
UELtvp+JfwI7XDGVwSxZXA: calls $8
*** FLOP *** [Td Kh Kd]
UELtvp+JfwI7XDGVwSxZXA: checks
vkfxu8f/jMYKUk6Ly4eujw: bets $31
9dpyyjDTCed6nV7JhaUUpw: calls $31
UELtvp+JfwI7XDGVwSxZXA: folds
*** TURN *** [Td Kh Kd] [6c]
vkfxu8f/jMYKUk6Ly4eujw: bets $60
9dpyyjDTCed6nV7JhaUUpw: raises $417.10 to $477.10 and is all-in
vkfxu8f/jMYKUk6Ly4eujw: calls $114.65 and is all-in
*** RIVER *** [Td Kh Kd 6c] [Ts]
*** SHOW DOWN ***
vkfxu8f/jMYKUk6Ly4eujw: shows [Ac As] (two pair, Aces and Kings)
9dpyyjDTCed6nV7JhaUUpw: shows [Qh Ks] (a full house, Kings full of Tens)
9dpyyjDTCed6nV7JhaUUpw collected $441.30 from pot
*** SUMMARY ***
Total pot $444.30 | Rake $3
Board [Td Kh Kd 6c Ts]
Seat 1: UELtvp+JfwI7XDGVwSxZXA folded on the Flop
Seat 2: vkfxu8f/jMYKUk6Ly4eujw showed [Ac As] and lost with two pair, Aces and Kings
Seat 3: 9dpyyjDTCed6nV7JhaUUpw (button) showed [Qh Ks] and won ($441.30) with a full house, Kings full of Tens
Seat 4: YsLQ3BAvgQHWXMAv3Wv6Hg (small blind) folded before Flop
Seat 5: VvdR9F3I+2yELkfTVvC1dg (big blind) folded before Flop
Seat 6: vkoJRf3gidxY1pPi0AFWww folded before Flop (didn't bet)



PokerStars Game #59941564622:  Hold'em No Limit ($1/$2) - 2009/07/01 1:39:17 ET
Table 'ztv6V3FN2bQ9nmJPPdx6nQ' 6-max Seat #5 is the button
Seat 1: 6fLdOUCRtX71xbVRhJEq8w ($238.35 in chips)
Seat 2: 5Y+ZGWLI4gnlpApDX5vy1A ($394.15 in chips)
Seat 3: ubtx4Z5L+AcK71MTvYiGVw ($245 in chips)
Seat 4: UaZ5yj+6LjtWqMQg2QskUw ($88.30 in chips)
Seat 5: sTPOWERd9HWPCNrDBwsVjA ($220.60 in chips)
Seat 6: mfy7uGZcqA2PVQqEVbJ7+g ($110.60 in chips)
mfy7uGZcqA2PVQqEVbJ7+g: posts small blind $1
6fLdOUCRtX71xbVRhJEq8w: posts big blind $2
*** HOLE CARDS ***
5Y+ZGWLI4gnlpApDX5vy1A: folds
ubtx4Z5L+AcK71MTvYiGVw: folds
UaZ5yj+6LjtWqMQg2QskUw: folds
sTPOWERd9HWPCNrDBwsVjA: folds
mfy7uGZcqA2PVQqEVbJ7+g: folds
6fLdOUCRtX71xbVRhJEq8w collected $2 from pot
*** SUMMARY ***
Total pot $2 | Rake $0
Seat 1: 6fLdOUCRtX71xbVRhJEq8w (big blind) collected ($2)
Seat 2: 5Y+ZGWLI4gnlpApDX5vy1A folded before Flop (didn't bet)
Seat 3: ubtx4Z5L+AcK71MTvYiGVw folded before Flop (didn't bet)
Seat 4: UaZ5yj+6LjtWqMQg2QskUw folded before Flop (didn't bet)
Seat 5: sTPOWERd9HWPCNrDBwsVjA (button) folded before Flop (didn't bet)
Seat 6: mfy7uGZcqA2PVQqEVbJ7+g (small blind) folded before Flop



PokerStars Game #59941564556:  Hold'em No Limit ($1/$2) - 2009/07/01 1:39:17 ET
Table '4NGNnZ/osQfNq6abYqkJeA' 6-max Seat #5 is the button
Seat 2: 669iGNwYwgRZg3nhS+aDAQ ($99.90 in chips)
Seat 3: 54yWzRRgS0oZ+S6LwZBxMQ ($32.80 in chips)
Seat 4: sY+4Uuh5z/6AbXXaCS10jw ($233.25 in chips)
Seat 5: VvdR9F3I+2yELkfTVvC1dg ($238.55 in chips)
Seat 6: /PH6Ffnho4Ysm8S3V/oa+w ($41 in chips)
/PH6Ffnho4Ysm8S3V/oa+w: posts small blind $1
vkfxu8f/jMYKUk6Ly4eujw: is sitting out
669iGNwYwgRZg3nhS+aDAQ: posts big blind $2
*** HOLE CARDS ***
54yWzRRgS0oZ+S6LwZBxMQ: calls $2
sY+4Uuh5z/6AbXXaCS10jw: folds
VvdR9F3I+2yELkfTVvC1dg: folds
vkfxu8f/jMYKUk6Ly4eujw leaves the table
/PH6Ffnho4Ysm8S3V/oa+w: folds
669iGNwYwgRZg3nhS+aDAQ: checks
*** FLOP *** [3h 5s Th]
669iGNwYwgRZg3nhS+aDAQ: bets $4
54yWzRRgS0oZ+S6LwZBxMQ: calls $4
*** TURN *** [3h 5s Th] [As]
669iGNwYwgRZg3nhS+aDAQ: bets $4
54yWzRRgS0oZ+S6LwZBxMQ: calls $4
*** RIVER *** [3h 5s Th As] [2c]
669iGNwYwgRZg3nhS+aDAQ: checks
54yWzRRgS0oZ+S6LwZBxMQ: checks
*** SHOW DOWN ***
669iGNwYwgRZg3nhS+aDAQ: shows [Td 8d] (a pair of Tens)
54yWzRRgS0oZ+S6LwZBxMQ: mucks hand
669iGNwYwgRZg3nhS+aDAQ collected $20 from pot
*** SUMMARY ***
Total pot $21 | Rake $1
Board [3h 5s Th As 2c]
Seat 2: 669iGNwYwgRZg3nhS+aDAQ (big blind) showed [Td 8d] and won ($20) with a pair of Tens
Seat 3: 54yWzRRgS0oZ+S6LwZBxMQ mucked
Seat 4: sY+4Uuh5z/6AbXXaCS10jw folded before Flop (didn't bet)
Seat 5: VvdR9F3I+2yELkfTVvC1dg (button) folded before Flop (didn't bet)
Seat 6: /PH6Ffnho4Ysm8S3V/oa+w (small blind) folded before Flop



PokerStars Game #59941564938:  Hold'em No Limit ($1/$2) - 2009/07/01 1:39:18 ET
Table 'eyAQSIlgc2o1Jxvbve4WGg' 9-max Seat #9 is the button
Seat 1: UZEsV9yKUMqmpYPiOFpaZw ($96.20 in chips)
Seat 2: kM9CA+2UcdMjbCMbtUCGiA ($203 in chips)
Seat 4: CkE3IyJF1KvdaAOmZY5XqQ ($200 in chips)
Seat 5: mIKx5lhIt13X5eZQH0ZeMA ($131.40 in chips)
Seat 6: nXDI8Y/S6POzRwANu3d8hQ ($31 in chips)
Seat 7: u3OrI5uGx9mx1fE7dgr+EA ($76.80 in chips)
Seat 8: 1CtiZuXDFaJL1dJPQKyi8Q ($152.95 in chips)
Seat 9: WUlHm+ydPPHG7Lb0rePSdA ($143.20 in chips)
UZEsV9yKUMqmpYPiOFpaZw: posts small blind $1
kM9CA+2UcdMjbCMbtUCGiA: posts big blind $2
*** HOLE CARDS ***
CkE3IyJF1KvdaAOmZY5XqQ: folds
mIKx5lhIt13X5eZQH0ZeMA: folds
nXDI8Y/S6POzRwANu3d8hQ: folds
u3OrI5uGx9mx1fE7dgr+EA: calls $2
1CtiZuXDFaJL1dJPQKyi8Q: folds
WUlHm+ydPPHG7Lb0rePSdA: folds
UZEsV9yKUMqmpYPiOFpaZw: calls $1
kM9CA+2UcdMjbCMbtUCGiA: checks
*** FLOP *** [5h Jd 3d]
UZEsV9yKUMqmpYPiOFpaZw: checks
kM9CA+2UcdMjbCMbtUCGiA: checks
u3OrI5uGx9mx1fE7dgr+EA: bets $2
UZEsV9yKUMqmpYPiOFpaZw: folds
kM9CA+2UcdMjbCMbtUCGiA: folds
u3OrI5uGx9mx1fE7dgr+EA collected $5.70 from pot
u3OrI5uGx9mx1fE7dgr+EA: doesn't show hand
*** SUMMARY ***
Total pot $6 | Rake $0.30
Board [5h Jd 3d]
Seat 1: UZEsV9yKUMqmpYPiOFpaZw (small blind) folded on the Flop
Seat 2: kM9CA+2UcdMjbCMbtUCGiA (big blind) folded on the Flop
Seat 4: CkE3IyJF1KvdaAOmZY5XqQ folded before Flop (didn't bet)
Seat 5: mIKx5lhIt13X5eZQH0ZeMA folded before Flop (didn't bet)
Seat 6: nXDI8Y/S6POzRwANu3d8hQ folded before Flop (didn't bet)
Seat 7: u3OrI5uGx9mx1fE7dgr+EA collected ($5.70)
Seat 8: 1CtiZuXDFaJL1dJPQKyi8Q folded before Flop (didn't bet)
Seat 9: WUlHm+ydPPHG7Lb0rePSdA (button) folded before Flop (didn't bet)



PokerStars Game #59941565292:  Hold'em No Limit ($1/$2) - 2009/07/01 1:39:19 ET
Table 'jlrIxbrVIG+gjaUYT4za8g' 6-max Seat #5 is the button
Seat 1: ygTTt5ehT4aF86q1a8/R+w ($233.30 in chips)
Seat 2: /PH6Ffnho4Ysm8S3V/oa+w ($40 in chips)
Seat 3: gnYme0DNFflnMhrdbxe1Ag ($203 in chips)
Seat 4: 8srN1dKQePlsv0GyTada+Q ($266.95 in chips)
Seat 5: AyBB0k3Dcl7xbXUeGMw06g ($59.65 in chips)
BWhgxe7gWiYobRbwdG+d2Q will be allowed to play after the button
ygTTt5ehT4aF86q1a8/R+w: posts small blind $1
/PH6Ffnho4Ysm8S3V/oa+w: posts big blind $2
*** HOLE CARDS ***
gnYme0DNFflnMhrdbxe1Ag: folds
8srN1dKQePlsv0GyTada+Q: folds
AyBB0k3Dcl7xbXUeGMw06g: calls $2
ygTTt5ehT4aF86q1a8/R+w: folds
/PH6Ffnho4Ysm8S3V/oa+w: checks
*** FLOP *** [3s 5s 2h]
/PH6Ffnho4Ysm8S3V/oa+w: bets $3
AyBB0k3Dcl7xbXUeGMw06g: calls $3
*** TURN *** [3s 5s 2h] [7h]
/PH6Ffnho4Ysm8S3V/oa+w: checks
AyBB0k3Dcl7xbXUeGMw06g: bets $4
/PH6Ffnho4Ysm8S3V/oa+w: raises $13 to $17
AyBB0k3Dcl7xbXUeGMw06g: calls $13
*** RIVER *** [3s 5s 2h 7h] [8d]
/PH6Ffnho4Ysm8S3V/oa+w: bets $18 and is all-in
AyBB0k3Dcl7xbXUeGMw06g: folds
/PH6Ffnho4Ysm8S3V/oa+w collected $43 from pot
*** SUMMARY ***
Total pot $45 | Rake $2
Board [3s 5s 2h 7h 8d]
Seat 1: ygTTt5ehT4aF86q1a8/R+w (small blind) folded before Flop
Seat 2: /PH6Ffnho4Ysm8S3V/oa+w (big blind) collected ($43)
Seat 3: gnYme0DNFflnMhrdbxe1Ag folded before Flop (didn't bet)
Seat 4: 8srN1dKQePlsv0GyTada+Q folded before Flop (didn't bet)
Seat 5: AyBB0k3Dcl7xbXUeGMw06g (button) folded on the River



PokerStars Game #59941565244:  Hold'em No Limit ($1/$2) - 2009/07/01 1:39:19 ET
Table '/dyk+YdRGv90j2box35j8w' 6-max Seat #1 is the button
Seat 1: 8srN1dKQePlsv0GyTada+Q ($209.25 in chips)
Seat 2: qCnEYuAE5y5A7bk6fO5/jQ ($471.60 in chips)
Seat 3: sTPOWERd9HWPCNrDBwsVjA ($182.50 in chips)
Seat 5: VvdR9F3I+2yELkfTVvC1dg ($252 in chips)
Seat 6: gnYme0DNFflnMhrdbxe1Ag ($200 in chips)
qCnEYuAE5y5A7bk6fO5/jQ: posts small blind $1
sTPOWERd9HWPCNrDBwsVjA: posts big blind $2
z/u1YTnkiIDrtp/2cA2dBg: sits out
*** HOLE CARDS ***
VvdR9F3I+2yELkfTVvC1dg: folds
gnYme0DNFflnMhrdbxe1Ag: folds
8srN1dKQePlsv0GyTada+Q: raises $3 to $5
qCnEYuAE5y5A7bk6fO5/jQ: folds
sTPOWERd9HWPCNrDBwsVjA: folds
8srN1dKQePlsv0GyTada+Q collected $5 from pot
8srN1dKQePlsv0GyTada+Q: doesn't show hand
*** SUMMARY ***
Total pot $5 | Rake $0
Seat 1: 8srN1dKQePlsv0GyTada+Q (button) collected ($5)
Seat 2: qCnEYuAE5y5A7bk6fO5/jQ (small blind) folded before Flop
Seat 3: sTPOWERd9HWPCNrDBwsVjA (big blind) folded before Flop
Seat 5: VvdR9F3I+2yELkfTVvC1dg folded before Flop (didn't bet)
Seat 6: gnYme0DNFflnMhrdbxe1Ag folded before Flop (didn't bet)



PokerStars Game #59941565324:  Hold'em No Limit ($1/$2) - 2009/07/01 1:39:19 ET
Table 'kq5zaQ+1hLNf8LZfGnbTAA' 6-max Seat #1 is the button
Seat 1: 8srN1dKQePlsv0GyTada+Q ($427.60 in chips)
Seat 2: nXDI8Y/S6POzRwANu3d8hQ ($140 in chips)
Seat 3: /PH6Ffnho4Ysm8S3V/oa+w ($52.15 in chips)
Seat 4: 3dAbvkxS5NPQTBAbvpinVg ($281.45 in chips)
Seat 5: gnYme0DNFflnMhrdbxe1Ag ($219.35 in chips)
Seat 6: mfy7uGZcqA2PVQqEVbJ7+g ($192.45 in chips)
nXDI8Y/S6POzRwANu3d8hQ: posts small blind $1
/PH6Ffnho4Ysm8S3V/oa+w: posts big blind $2
*** HOLE CARDS ***
3dAbvkxS5NPQTBAbvpinVg: folds
gnYme0DNFflnMhrdbxe1Ag: folds
mfy7uGZcqA2PVQqEVbJ7+g: folds
8srN1dKQePlsv0GyTada+Q: raises $3 to $5
nXDI8Y/S6POzRwANu3d8hQ: folds
/PH6Ffnho4Ysm8S3V/oa+w: folds
8srN1dKQePlsv0GyTada+Q collected $5 from pot
8srN1dKQePlsv0GyTada+Q: doesn't show hand
*** SUMMARY ***
Total pot $5 | Rake $0
Seat 1: 8srN1dKQePlsv0GyTada+Q (button) collected ($5)
Seat 2: nXDI8Y/S6POzRwANu3d8hQ (small blind) folded before Flop
Seat 3: /PH6Ffnho4Ysm8S3V/oa+w (big blind) folded before Flop
Seat 4: 3dAbvkxS5NPQTBAbvpinVg folded before Flop (didn't bet)
Seat 5: gnYme0DNFflnMhrdbxe1Ag folded before Flop (didn't bet)
Seat 6: mfy7uGZcqA2PVQqEVbJ7+g folded before Flop (didn't bet)



PokerStars Game #59941565472:  Hold'em No Limit ($1/$2) - 2009/07/01 1:39:19 ET
Table 'AtOXMvcrtQM8yLNcALmfLQ' 2-max Seat #2 is the button
Seat 1: +HlQuAsMqZGYYtjcPO/a3A ($338 in chips)
Seat 2: pVqEzK9wXlRMECnb1Zg4Zw ($232.50 in chips)
pVqEzK9wXlRMECnb1Zg4Zw: posts small blind $1
+HlQuAsMqZGYYtjcPO/a3A: posts big blind $2
*** HOLE CARDS ***
pVqEzK9wXlRMECnb1Zg4Zw: raises $6 to $8
+HlQuAsMqZGYYtjcPO/a3A: folds
pVqEzK9wXlRMECnb1Zg4Zw collected $4 from pot
pVqEzK9wXlRMECnb1Zg4Zw: doesn't show hand
*** SUMMARY ***
Total pot $4 | Rake $0
Seat 1: +HlQuAsMqZGYYtjcPO/a3A (big blind) folded before Flop
Seat 2: pVqEzK9wXlRMECnb1Zg4Zw (button) (small blind) collected ($4)



PokerStars Game #59941566250:  Hold'em No Limit ($1/$2) - 2009/07/01 1:39:20 ET
Table 'LL4bDFyhj5hsMpzaDugJZg' 6-max Seat #4 is the button
Seat 2: IZng3w8jiJHHp3LbYKLi4w ($51.75 in chips)
Seat 3: iI/NMpRxMkGieArQEhACSA ($578.25 in chips)
Seat 4: 8srN1dKQePlsv0GyTada+Q ($200 in chips)
Seat 6: 692Q4sfB0gTElzS0WMeg+A ($206.35 in chips)
692Q4sfB0gTElzS0WMeg+A: posts small blind $1
IZng3w8jiJHHp3LbYKLi4w: posts big blind $2
*** HOLE CARDS ***
iI/NMpRxMkGieArQEhACSA: raises $4 to $6
8srN1dKQePlsv0GyTada+Q: folds
692Q4sfB0gTElzS0WMeg+A: folds
IZng3w8jiJHHp3LbYKLi4w: folds
iI/NMpRxMkGieArQEhACSA collected $5 from pot
iI/NMpRxMkGieArQEhACSA: doesn't show hand
*** SUMMARY ***
Total pot $5 | Rake $0
Seat 2: IZng3w8jiJHHp3LbYKLi4w (big blind) folded before Flop
Seat 3: iI/NMpRxMkGieArQEhACSA collected ($5)
Seat 4: 8srN1dKQePlsv0GyTada+Q (button) folded before Flop (didn't bet)
Seat 6: 692Q4sfB0gTElzS0WMeg+A (small blind) folded before Flop



PokerStars Game #59941568474:  Hold'em No Limit ($1/$2) - 2009/07/01 1:39:24 ET
Table 'ZzSIe0zTCDv+n6hfbY5tTg' 6-max Seat #1 is the button
Seat 1: VvdR9F3I+2yELkfTVvC1dg ($254 in chips)
Seat 2: B87ikIyZ/TzAVeXf38Ny0g ($235 in chips)
Seat 3: gsugPj31Hui3Jefl98MBOA ($358.25 in chips)
Seat 4: qXDd0ZyMIse0OBu8pxeQ3Q ($252 in chips)
Seat 5: 3dAbvkxS5NPQTBAbvpinVg ($501.10 in chips)
Seat 6: 09BNF4quPDzanQzM8vc6WA ($39 in chips)
B87ikIyZ/TzAVeXf38Ny0g: posts small blind $1
gsugPj31Hui3Jefl98MBOA: posts big blind $2
*** HOLE CARDS ***
qXDd0ZyMIse0OBu8pxeQ3Q: raises $5 to $7
3dAbvkxS5NPQTBAbvpinVg: folds
09BNF4quPDzanQzM8vc6WA: folds
VvdR9F3I+2yELkfTVvC1dg: folds
B87ikIyZ/TzAVeXf38Ny0g: folds
gsugPj31Hui3Jefl98MBOA: folds
qXDd0ZyMIse0OBu8pxeQ3Q collected $5 from pot
*** SUMMARY ***
Total pot $5 | Rake $0
Seat 1: VvdR9F3I+2yELkfTVvC1dg (button) folded before Flop (didn't bet)
Seat 2: B87ikIyZ/TzAVeXf38Ny0g (small blind) folded before Flop
Seat 3: gsugPj31Hui3Jefl98MBOA (big blind) folded before Flop
Seat 4: qXDd0ZyMIse0OBu8pxeQ3Q collected ($5)
Seat 5: 3dAbvkxS5NPQTBAbvpinVg folded before Flop (didn't bet)
Seat 6: 09BNF4quPDzanQzM8vc6WA folded before Flop (didn't bet)



PokerStars Game #59941569566:  Hold'em No Limit ($1/$2) - 2009/07/01 1:39:26 ET
Table 'BSRfGh+QobUe0AgIMtt/fw' 9-max Seat #1 is the button
Seat 1: gDn/rYeNwCyWEgRhyWp4PA ($155.70 in chips)
Seat 2: +SmnXtdmwqXGEJfLeJDIUQ ($38 in chips)
Seat 3: WUlHm+ydPPHG7Lb0rePSdA ($120 in chips)
Seat 5: GX1heJ+DSsvm7gzSPsYhhQ ($99.80 in chips)
Seat 6: H6Z4+qu8gR0VUiPOijndVg ($200 in chips)
Seat 7: CkE3IyJF1KvdaAOmZY5XqQ ($206.10 in chips)
Seat 8: /XRRUMKiOOItJFbrM26RrA ($85.30 in chips)
Seat 9: /inIs/z/PcX+TniIFpaxpg ($415.25 in chips)
+SmnXtdmwqXGEJfLeJDIUQ: posts small blind $1
WUlHm+ydPPHG7Lb0rePSdA: posts big blind $2
+T/63sAeZzWyHchahJ36GQ: sits out
*** HOLE CARDS ***
GX1heJ+DSsvm7gzSPsYhhQ: folds
H6Z4+qu8gR0VUiPOijndVg: raises $6 to $8
CkE3IyJF1KvdaAOmZY5XqQ: folds
/XRRUMKiOOItJFbrM26RrA: folds
/inIs/z/PcX+TniIFpaxpg: folds
gDn/rYeNwCyWEgRhyWp4PA: folds
+SmnXtdmwqXGEJfLeJDIUQ: folds
WUlHm+ydPPHG7Lb0rePSdA: folds
H6Z4+qu8gR0VUiPOijndVg collected $5 from pot
H6Z4+qu8gR0VUiPOijndVg: doesn't show hand
*** SUMMARY ***
Total pot $5 | Rake $0
Seat 1: gDn/rYeNwCyWEgRhyWp4PA (button) folded before Flop (didn't bet)
Seat 2: +SmnXtdmwqXGEJfLeJDIUQ (small blind) folded before Flop
Seat 3: WUlHm+ydPPHG7Lb0rePSdA (big blind) folded before Flop
Seat 5: GX1heJ+DSsvm7gzSPsYhhQ folded before Flop (didn't bet)
Seat 6: H6Z4+qu8gR0VUiPOijndVg collected ($5)
Seat 7: CkE3IyJF1KvdaAOmZY5XqQ folded before Flop (didn't bet)
Seat 8: /XRRUMKiOOItJFbrM26RrA folded before Flop (didn't bet)
Seat 9: /inIs/z/PcX+TniIFpaxpg folded before Flop (didn't bet)



PokerStars Game #59941569716:  Hold'em No Limit ($1/$2) - 2009/07/01 1:39:27 ET
Table 'P/yCfYl1GfGsu/e6DxDy/A' 2-max Seat #1 is the button
Seat 1: 7fOCUy3x9hdkmXkkDNolGQ ($493.50 in chips)
Seat 2: RwDoM55ZeQuI2ADyJhOb2Q ($984.50 in chips)
7fOCUy3x9hdkmXkkDNolGQ: posts small blind $1
RwDoM55ZeQuI2ADyJhOb2Q: posts big blind $2
*** HOLE CARDS ***
7fOCUy3x9hdkmXkkDNolGQ: raises $4 to $6
RwDoM55ZeQuI2ADyJhOb2Q: folds
7fOCUy3x9hdkmXkkDNolGQ collected $4 from pot
7fOCUy3x9hdkmXkkDNolGQ: doesn't show hand
*** SUMMARY ***
Total pot $4 | Rake $0
Seat 1: 7fOCUy3x9hdkmXkkDNolGQ (button) (small blind) collected ($4)
Seat 2: RwDoM55ZeQuI2ADyJhOb2Q (big blind) folded before Flop



PokerStars Game #59941570916:  Hold'em No Limit ($1/$2) - 2009/07/01 1:39:29 ET
Table 'CFkQcfWjKccZaZDf71FK+w' 6-max Seat #1 is the button
Seat 1: vkfxu8f/jMYKUk6Ly4eujw ($222.40 in chips)
Seat 2: ewN/vzF22+/gdzjIKBOlkA ($206.05 in chips)
Seat 3: 09BNF4quPDzanQzM8vc6WA ($43.65 in chips)
Seat 4: ygTTt5ehT4aF86q1a8/R+w ($246.35 in chips)
Seat 5: 2lOU1DcvUZaMcxZ95XfzXw ($194.35 in chips)
Seat 6: ORVqY3rf9X6ANA/8s+On2Q ($46.60 in chips)
ewN/vzF22+/gdzjIKBOlkA: posts small blind $1
09BNF4quPDzanQzM8vc6WA: posts big blind $2
*** HOLE CARDS ***
ygTTt5ehT4aF86q1a8/R+w: folds
2lOU1DcvUZaMcxZ95XfzXw: calls $2
ORVqY3rf9X6ANA/8s+On2Q: folds
vkfxu8f/jMYKUk6Ly4eujw: raises $8 to $10
ewN/vzF22+/gdzjIKBOlkA: folds
09BNF4quPDzanQzM8vc6WA: folds
2lOU1DcvUZaMcxZ95XfzXw: calls $8
*** FLOP *** [2h Kh Td]
2lOU1DcvUZaMcxZ95XfzXw: checks
vkfxu8f/jMYKUk6Ly4eujw: bets $21
2lOU1DcvUZaMcxZ95XfzXw: folds
vkfxu8f/jMYKUk6Ly4eujw collected $21.85 from pot
*** SUMMARY ***
Total pot $23 | Rake $1.15
Board [2h Kh Td]
Seat 1: vkfxu8f/jMYKUk6Ly4eujw (button) collected ($21.85)
Seat 2: ewN/vzF22+/gdzjIKBOlkA (small blind) folded before Flop
Seat 3: 09BNF4quPDzanQzM8vc6WA (big blind) folded before Flop
Seat 4: ygTTt5ehT4aF86q1a8/R+w folded before Flop (didn't bet)
Seat 5: 2lOU1DcvUZaMcxZ95XfzXw folded on the Flop
Seat 6: ORVqY3rf9X6ANA/8s+On2Q folded before Flop (didn't bet)



PokerStars Game #59941571614:  Hold'em No Limit ($1/$2) - 2009/07/01 1:39:30 ET
Table 'uJ9juaXXg9yIcSU8amxaXQ' 6-max Seat #1 is the button
Seat 1: JsqOjN/eHz0uYVf/PyUJ6Q ($150.25 in chips)
Seat 2: VvdR9F3I+2yELkfTVvC1dg ($221.10 in chips)
Seat 3: qXDd0ZyMIse0OBu8pxeQ3Q ($249.40 in chips)
Seat 4: zNjJ/y4emmF+vzrCDd+ooA ($222.05 in chips)
Seat 5: YsLQ3BAvgQHWXMAv3Wv6Hg ($205.70 in chips)
Seat 6: /PH6Ffnho4Ysm8S3V/oa+w ($43 in chips)
VvdR9F3I+2yELkfTVvC1dg: posts small blind $1
qXDd0ZyMIse0OBu8pxeQ3Q: posts big blind $2
*** HOLE CARDS ***
zNjJ/y4emmF+vzrCDd+ooA: folds
YsLQ3BAvgQHWXMAv3Wv6Hg: folds
/PH6Ffnho4Ysm8S3V/oa+w: folds
JsqOjN/eHz0uYVf/PyUJ6Q: folds
VvdR9F3I+2yELkfTVvC1dg: raises $2 to $4
qXDd0ZyMIse0OBu8pxeQ3Q: folds
VvdR9F3I+2yELkfTVvC1dg collected $4 from pot
VvdR9F3I+2yELkfTVvC1dg: doesn't show hand
*** SUMMARY ***
Total pot $4 | Rake $0
Seat 1: JsqOjN/eHz0uYVf/PyUJ6Q (button) folded before Flop (didn't bet)
Seat 2: VvdR9F3I+2yELkfTVvC1dg (small blind) collected ($4)
Seat 3: qXDd0ZyMIse0OBu8pxeQ3Q (big blind) folded before Flop
Seat 4: zNjJ/y4emmF+vzrCDd+ooA folded before Flop (didn't bet)
Seat 5: YsLQ3BAvgQHWXMAv3Wv6Hg folded before Flop (didn't bet)
Seat 6: /PH6Ffnho4Ysm8S3V/oa+w folded before Flop (didn't bet)



PokerStars Game #59941572038:  Hold'em No Limit ($1/$2) - 2009/07/01 1:39:31 ET
Table 'TsEDkiO4tzCTCzJ7tNdEqw' 6-max Seat #5 is the button
Seat 2: 4dcDwIHRm96PwtqkpQiuiA ($89.65 in chips)
Seat 3: ubtx4Z5L+AcK71MTvYiGVw ($290.05 in chips)
Seat 4: K8MXCrNAVYlMnnCeM32Kxw ($85.50 in chips)
Seat 5: VvdR9F3I+2yELkfTVvC1dg ($244.35 in chips)
Seat 6: uCqEjnxh2/vFBjKYkfTOkw ($180.30 in chips)
uCqEjnxh2/vFBjKYkfTOkw: posts small blind $1
4dcDwIHRm96PwtqkpQiuiA: posts big blind $2
*** HOLE CARDS ***
ubtx4Z5L+AcK71MTvYiGVw: raises $6 to $8
K8MXCrNAVYlMnnCeM32Kxw: folds
vkfxu8f/jMYKUk6Ly4eujw joins the table at seat #1
VvdR9F3I+2yELkfTVvC1dg: folds
uCqEjnxh2/vFBjKYkfTOkw: folds
4dcDwIHRm96PwtqkpQiuiA: folds
ubtx4Z5L+AcK71MTvYiGVw collected $5 from pot
ubtx4Z5L+AcK71MTvYiGVw: doesn't show hand
*** SUMMARY ***
Total pot $5 | Rake $0
Seat 2: 4dcDwIHRm96PwtqkpQiuiA (big blind) folded before Flop
Seat 3: ubtx4Z5L+AcK71MTvYiGVw collected ($5)
Seat 4: K8MXCrNAVYlMnnCeM32Kxw folded before Flop (didn't bet)
Seat 5: VvdR9F3I+2yELkfTVvC1dg (button) folded before Flop (didn't bet)
Seat 6: uCqEjnxh2/vFBjKYkfTOkw (small blind) folded before Flop



PokerStars Game #59941572256:  Hold'em No Limit ($1/$2) - 2009/07/01 1:39:31 ET
Table 'NmY84NAf9Mh0ckAckHnh5g' 2-max Seat #1 is the button
Seat 1: 6hvg964TSqZ3AL/0XK9aVQ ($466.60 in chips)
Seat 2: RwDoM55ZeQuI2ADyJhOb2Q ($526.50 in chips)
6hvg964TSqZ3AL/0XK9aVQ: posts small blind $1
RwDoM55ZeQuI2ADyJhOb2Q: posts big blind $2
*** HOLE CARDS ***
6hvg964TSqZ3AL/0XK9aVQ: folds
RwDoM55ZeQuI2ADyJhOb2Q collected $2 from pot
RwDoM55ZeQuI2ADyJhOb2Q: doesn't show hand
*** SUMMARY ***
Total pot $2 | Rake $0
Seat 1: 6hvg964TSqZ3AL/0XK9aVQ (button) (small blind) folded before Flop
Seat 2: RwDoM55ZeQuI2ADyJhOb2Q (big blind) collected ($2)



PokerStars Game #59941572428:  Hold'em No Limit ($1/$2) - 2009/07/01 1:39:32 ET
Table 'mGpP9StWRnoeiBDExc6Frg' 6-max Seat #5 is the button
Seat 1: VvdR9F3I+2yELkfTVvC1dg ($312.15 in chips)
Seat 2: vkfxu8f/jMYKUk6Ly4eujw ($196 in chips)
Seat 3: 7acrZUQC3Zc9BNLjoKIcLQ ($40.85 in chips)
Seat 4: 4dcDwIHRm96PwtqkpQiuiA ($69.70 in chips)
Seat 5: d1puGuVBE0fidn+5eRJ0tw ($198.65 in chips)
Seat 6: B2Ih1sr5VZk+8He7rcrMtQ ($417.05 in chips)
B2Ih1sr5VZk+8He7rcrMtQ: posts small blind $1
VvdR9F3I+2yELkfTVvC1dg: posts big blind $2
*** HOLE CARDS ***
vkfxu8f/jMYKUk6Ly4eujw: raises $6 to $8
7acrZUQC3Zc9BNLjoKIcLQ: folds
4dcDwIHRm96PwtqkpQiuiA: folds
d1puGuVBE0fidn+5eRJ0tw: folds
B2Ih1sr5VZk+8He7rcrMtQ: folds
VvdR9F3I+2yELkfTVvC1dg: folds
vkfxu8f/jMYKUk6Ly4eujw collected $5 from pot
vkfxu8f/jMYKUk6Ly4eujw: doesn't show hand
*** SUMMARY ***
Total pot $5 | Rake $0
Seat 1: VvdR9F3I+2yELkfTVvC1dg (big blind) folded before Flop
Seat 2: vkfxu8f/jMYKUk6Ly4eujw collected ($5)
Seat 3: 7acrZUQC3Zc9BNLjoKIcLQ folded before Flop (didn't bet)
Seat 4: 4dcDwIHRm96PwtqkpQiuiA folded before Flop (didn't bet)
Seat 5: d1puGuVBE0fidn+5eRJ0tw (button) folded before Flop (didn't bet)
Seat 6: B2Ih1sr5VZk+8He7rcrMtQ (small blind) folded before Flop



PokerStars Game #59941572826:  Hold'em No Limit ($1/$2) - 2009/07/01 1:39:32 ET
Table 'ztv6V3FN2bQ9nmJPPdx6nQ' 6-max Seat #6 is the button
Seat 1: 6fLdOUCRtX71xbVRhJEq8w ($239.35 in chips)
Seat 2: 5Y+ZGWLI4gnlpApDX5vy1A ($394.15 in chips)
Seat 3: ubtx4Z5L+AcK71MTvYiGVw ($245 in chips)
Seat 4: UaZ5yj+6LjtWqMQg2QskUw ($88.30 in chips)
Seat 5: sTPOWERd9HWPCNrDBwsVjA ($220.60 in chips)
Seat 6: mfy7uGZcqA2PVQqEVbJ7+g ($109.60 in chips)
6fLdOUCRtX71xbVRhJEq8w: posts small blind $1
5Y+ZGWLI4gnlpApDX5vy1A: posts big blind $2
*** HOLE CARDS ***
ubtx4Z5L+AcK71MTvYiGVw: folds
UaZ5yj+6LjtWqMQg2QskUw: raises $2 to $4
sTPOWERd9HWPCNrDBwsVjA: folds
mfy7uGZcqA2PVQqEVbJ7+g: folds
6fLdOUCRtX71xbVRhJEq8w: folds
5Y+ZGWLI4gnlpApDX5vy1A: folds
UaZ5yj+6LjtWqMQg2QskUw collected $5 from pot
*** SUMMARY ***
Total pot $5 | Rake $0
Seat 1: 6fLdOUCRtX71xbVRhJEq8w (small blind) folded before Flop
Seat 2: 5Y+ZGWLI4gnlpApDX5vy1A (big blind) folded before Flop
Seat 3: ubtx4Z5L+AcK71MTvYiGVw folded before Flop (didn't bet)
Seat 4: UaZ5yj+6LjtWqMQg2QskUw collected ($5)
Seat 5: sTPOWERd9HWPCNrDBwsVjA folded before Flop (didn't bet)
Seat 6: mfy7uGZcqA2PVQqEVbJ7+g (button) folded before Flop (didn't bet)



PokerStars Game #59941573372:  Hold'em No Limit ($1/$2) - 2009/07/01 1:39:33 ET
Table 'UGLAZZyv+cXmnKjYin0etA' 6-max Seat #6 is the button
Seat 1: vkfxu8f/jMYKUk6Ly4eujw ($199 in chips)
Seat 2: eDLH1PUXFpvJBNMXBVQcGA ($313.10 in chips)
Seat 3: ygTTt5ehT4aF86q1a8/R+w ($114.20 in chips)
Seat 4: SiGJDsvRViJX05vHhA80GQ ($231.85 in chips)
Seat 5: 54yWzRRgS0oZ+S6LwZBxMQ ($33 in chips)
Seat 6: sTPOWERd9HWPCNrDBwsVjA ($218.15 in chips)
vkfxu8f/jMYKUk6Ly4eujw: posts small blind $1
eDLH1PUXFpvJBNMXBVQcGA: posts big blind $2
*** HOLE CARDS ***
ygTTt5ehT4aF86q1a8/R+w: folds
SiGJDsvRViJX05vHhA80GQ: folds
54yWzRRgS0oZ+S6LwZBxMQ: calls $2
sTPOWERd9HWPCNrDBwsVjA: folds
vkfxu8f/jMYKUk6Ly4eujw: raises $8 to $10
eDLH1PUXFpvJBNMXBVQcGA: folds
54yWzRRgS0oZ+S6LwZBxMQ: folds
vkfxu8f/jMYKUk6Ly4eujw collected $6 from pot
*** SUMMARY ***
Total pot $6 | Rake $0
Seat 1: vkfxu8f/jMYKUk6Ly4eujw (small blind) collected ($6)
Seat 2: eDLH1PUXFpvJBNMXBVQcGA (big blind) folded before Flop
Seat 3: ygTTt5ehT4aF86q1a8/R+w folded before Flop (didn't bet)
Seat 4: SiGJDsvRViJX05vHhA80GQ folded before Flop (didn't bet)
Seat 5: 54yWzRRgS0oZ+S6LwZBxMQ folded before Flop
Seat 6: sTPOWERd9HWPCNrDBwsVjA (button) folded before Flop (didn't bet)



PokerStars Game #59941573640:  Hold'em No Limit ($1/$2) - 2009/07/01 1:39:34 ET
Table 'AtOXMvcrtQM8yLNcALmfLQ' 2-max Seat #1 is the button
Seat 1: +HlQuAsMqZGYYtjcPO/a3A ($336 in chips)
Seat 2: pVqEzK9wXlRMECnb1Zg4Zw ($234.50 in chips)
+HlQuAsMqZGYYtjcPO/a3A: posts small blind $1
pVqEzK9wXlRMECnb1Zg4Zw: posts big blind $2
*** HOLE CARDS ***
+HlQuAsMqZGYYtjcPO/a3A: calls $1
pVqEzK9wXlRMECnb1Zg4Zw: raises $8 to $10
+HlQuAsMqZGYYtjcPO/a3A: folds
pVqEzK9wXlRMECnb1Zg4Zw collected $4 from pot
pVqEzK9wXlRMECnb1Zg4Zw: doesn't show hand
*** SUMMARY ***
Total pot $4 | Rake $0
Seat 1: +HlQuAsMqZGYYtjcPO/a3A (button) (small blind) folded before Flop
Seat 2: pVqEzK9wXlRMECnb1Zg4Zw (big blind) collected ($4)



PokerStars Game #59941574468:  Hold'em No Limit ($1/$2) - 2009/07/01 1:39:35 ET
Table 'qVXak+oTeDXMGbWa4sDU5Q' 9-max Seat #3 is the button
Seat 1: H6Z4+qu8gR0VUiPOijndVg ($230.45 in chips)
Seat 2: CST1bO+CmVQOtNgiT0cKPg ($100 in chips)
Seat 3: WUlHm+ydPPHG7Lb0rePSdA ($172.10 in chips)
Seat 4: lQYT23h5QCUVZAKxjOO39Q ($162.70 in chips)
Seat 5: zJtQ1gxyi72XvGYS1tM+DA ($100 in chips)
Seat 6: GX1heJ+DSsvm7gzSPsYhhQ ($43 in chips)
Seat 7: PfmlvZlFiss79a6IoEr11g ($168.30 in chips)
Seat 8: Z0rzUi0y1x80UdIpofoNbA ($109.55 in chips)
Seat 9: CkE3IyJF1KvdaAOmZY5XqQ ($215.55 in chips)
lQYT23h5QCUVZAKxjOO39Q: posts small blind $1
zJtQ1gxyi72XvGYS1tM+DA: posts big blind $2
CST1bO+CmVQOtNgiT0cKPg: posts big blind $2
*** HOLE CARDS ***
GX1heJ+DSsvm7gzSPsYhhQ: folds
PfmlvZlFiss79a6IoEr11g: folds
Z0rzUi0y1x80UdIpofoNbA: folds
CkE3IyJF1KvdaAOmZY5XqQ: folds
H6Z4+qu8gR0VUiPOijndVg: folds
CST1bO+CmVQOtNgiT0cKPg: raises $8 to $10
WUlHm+ydPPHG7Lb0rePSdA: folds
lQYT23h5QCUVZAKxjOO39Q: calls $9
zJtQ1gxyi72XvGYS1tM+DA: folds
*** FLOP *** [Qh 5d Th]
lQYT23h5QCUVZAKxjOO39Q: checks
CST1bO+CmVQOtNgiT0cKPg: bets $16
lQYT23h5QCUVZAKxjOO39Q: calls $16
*** TURN *** [Qh 5d Th] [4c]
lQYT23h5QCUVZAKxjOO39Q: checks
CST1bO+CmVQOtNgiT0cKPg: checks
*** RIVER *** [Qh 5d Th 4c] [Qc]
lQYT23h5QCUVZAKxjOO39Q: bets $30
CST1bO+CmVQOtNgiT0cKPg: folds
lQYT23h5QCUVZAKxjOO39Q collected $51.40 from pot
*** SUMMARY ***
Total pot $54 | Rake $2.60
Board [Qh 5d Th 4c Qc]
Seat 1: H6Z4+qu8gR0VUiPOijndVg folded before Flop (didn't bet)
Seat 2: CST1bO+CmVQOtNgiT0cKPg folded on the River
Seat 3: WUlHm+ydPPHG7Lb0rePSdA (button) folded before Flop (didn't bet)
Seat 4: lQYT23h5QCUVZAKxjOO39Q (small blind) collected ($51.40)
Seat 5: zJtQ1gxyi72XvGYS1tM+DA (big blind) folded before Flop
Seat 6: GX1heJ+DSsvm7gzSPsYhhQ folded before Flop (didn't bet)
Seat 7: PfmlvZlFiss79a6IoEr11g folded before Flop (didn't bet)
Seat 8: Z0rzUi0y1x80UdIpofoNbA folded before Flop (didn't bet)
Seat 9: CkE3IyJF1KvdaAOmZY5XqQ folded before Flop (didn't bet)



PokerStars Game #59941574778:  Hold'em No Limit ($1/$2) - 2009/07/01 1:39:36 ET
Table 'P/yCfYl1GfGsu/e6DxDy/A' 2-max Seat #2 is the button
Seat 1: 7fOCUy3x9hdkmXkkDNolGQ ($495.50 in chips)
Seat 2: RwDoM55ZeQuI2ADyJhOb2Q ($982.50 in chips)
RwDoM55ZeQuI2ADyJhOb2Q: posts small blind $1
7fOCUy3x9hdkmXkkDNolGQ: posts big blind $2
*** HOLE CARDS ***
RwDoM55ZeQuI2ADyJhOb2Q: raises $4 to $6
7fOCUy3x9hdkmXkkDNolGQ: folds
RwDoM55ZeQuI2ADyJhOb2Q collected $4 from pot
RwDoM55ZeQuI2ADyJhOb2Q: doesn't show hand
*** SUMMARY ***
Total pot $4 | Rake $0
Seat 1: 7fOCUy3x9hdkmXkkDNolGQ (big blind) folded before Flop
Seat 2: RwDoM55ZeQuI2ADyJhOb2Q (button) (small blind) collected ($4)



PokerStars Game #59941575578:  Hold'em No Limit ($1/$2) - 2009/07/01 1:39:37 ET
Table 'NmY84NAf9Mh0ckAckHnh5g' 2-max Seat #2 is the button
Seat 1: 6hvg964TSqZ3AL/0XK9aVQ ($465.60 in chips)
Seat 2: RwDoM55ZeQuI2ADyJhOb2Q ($527.50 in chips)
RwDoM55ZeQuI2ADyJhOb2Q: posts small blind $1
6hvg964TSqZ3AL/0XK9aVQ: posts big blind $2
*** HOLE CARDS ***
RwDoM55ZeQuI2ADyJhOb2Q: raises $4 to $6
6hvg964TSqZ3AL/0XK9aVQ: folds
RwDoM55ZeQuI2ADyJhOb2Q collected $4 from pot
RwDoM55ZeQuI2ADyJhOb2Q: doesn't show hand
*** SUMMARY ***
Total pot $4 | Rake $0
Seat 1: 6hvg964TSqZ3AL/0XK9aVQ (big blind) folded before Flop
Seat 2: RwDoM55ZeQuI2ADyJhOb2Q (button) (small blind) collected ($4)



PokerStars Game #59941575402:  Hold'em No Limit ($1/$2) - 2009/07/01 1:39:37 ET
Table '3WCXyaiCAbqSShQu7FIjvA' 9-max Seat #8 is the button
Seat 1: kTCkABD1UUldS9DFRGfCwQ ($152.75 in chips)
Seat 2: TAfo4veNRaRlzDXMMYS3Jg ($37 in chips)
Seat 3: 5Q8U6iZbeO7xJSS4qvDP5g ($276.85 in chips)
Seat 4: waEF/+pxZTxNo4FvsORuXg ($106.40 in chips)
Seat 5: CkE3IyJF1KvdaAOmZY5XqQ ($200 in chips)
Seat 6: 5jQlngvMSqM/WoonOcR5kw ($288.35 in chips)
Seat 7: nXDI8Y/S6POzRwANu3d8hQ ($37 in chips)
Seat 8: 1CtiZuXDFaJL1dJPQKyi8Q ($204.05 in chips)
kTCkABD1UUldS9DFRGfCwQ: posts small blind $1
TAfo4veNRaRlzDXMMYS3Jg: posts big blind $2
*** HOLE CARDS ***
5Q8U6iZbeO7xJSS4qvDP5g: folds
waEF/+pxZTxNo4FvsORuXg: folds
CkE3IyJF1KvdaAOmZY5XqQ: folds
5jQlngvMSqM/WoonOcR5kw: calls $2
nXDI8Y/S6POzRwANu3d8hQ: folds
1CtiZuXDFaJL1dJPQKyi8Q: folds
5jQlngvMSqM/WoonOcR5kw said, "zzzzzzzzzzzzzzz"
kTCkABD1UUldS9DFRGfCwQ: calls $1
TAfo4veNRaRlzDXMMYS3Jg: checks
*** FLOP *** [3c Qc 5h]
kTCkABD1UUldS9DFRGfCwQ: checks
TAfo4veNRaRlzDXMMYS3Jg: bets $35 and is all-in
5jQlngvMSqM/WoonOcR5kw: folds
kTCkABD1UUldS9DFRGfCwQ: folds
TAfo4veNRaRlzDXMMYS3Jg collected $5.70 from pot
TAfo4veNRaRlzDXMMYS3Jg: doesn't show hand
*** SUMMARY ***
Total pot $6 | Rake $0.30
Board [3c Qc 5h]
Seat 1: kTCkABD1UUldS9DFRGfCwQ (small blind) folded on the Flop
Seat 2: TAfo4veNRaRlzDXMMYS3Jg (big blind) collected ($5.70)
Seat 3: 5Q8U6iZbeO7xJSS4qvDP5g folded before Flop (didn't bet)
Seat 4: waEF/+pxZTxNo4FvsORuXg folded before Flop (didn't bet)
Seat 5: CkE3IyJF1KvdaAOmZY5XqQ folded before Flop (didn't bet)
Seat 6: 5jQlngvMSqM/WoonOcR5kw folded on the Flop
Seat 7: nXDI8Y/S6POzRwANu3d8hQ folded before Flop (didn't bet)
Seat 8: 1CtiZuXDFaJL1dJPQKyi8Q (button) folded before Flop (didn't bet)



PokerStars Game #59941575856:  Hold'em No Limit ($1/$2) - 2009/07/01 1:39:38 ET
Table 'rKeCh+eBn4RNvybCUYkoTQ' 9-max Seat #1 is the button
Seat 1: /inIs/z/PcX+TniIFpaxpg ($195 in chips)
Seat 2: nXDI8Y/S6POzRwANu3d8hQ ($112 in chips)
Seat 3: GX1heJ+DSsvm7gzSPsYhhQ ($43 in chips)
Seat 5: WUlHm+ydPPHG7Lb0rePSdA ($122 in chips)
Seat 6: EBV6OktyeSmh4w6sWmcWOw ($286.80 in chips)
Seat 7: rW/MyplHylMSBRaoRUzWrg ($40 in chips)
Seat 8: pN/Ip0ePsUVIdUlGgLrkUw ($246.35 in chips)
Seat 9: Kzta8yu9vxHT4B70mjBZ+w ($200 in chips)
nXDI8Y/S6POzRwANu3d8hQ: posts small blind $1
GX1heJ+DSsvm7gzSPsYhhQ: posts big blind $2
*** HOLE CARDS ***
WUlHm+ydPPHG7Lb0rePSdA: folds
EBV6OktyeSmh4w6sWmcWOw: folds
rW/MyplHylMSBRaoRUzWrg: folds
pN/Ip0ePsUVIdUlGgLrkUw: folds
Kzta8yu9vxHT4B70mjBZ+w: folds
/inIs/z/PcX+TniIFpaxpg: folds
nXDI8Y/S6POzRwANu3d8hQ: raises $6 to $8
GX1heJ+DSsvm7gzSPsYhhQ: folds
nXDI8Y/S6POzRwANu3d8hQ collected $4 from pot
nXDI8Y/S6POzRwANu3d8hQ: doesn't show hand
*** SUMMARY ***
Total pot $4 | Rake $0
Seat 1: /inIs/z/PcX+TniIFpaxpg (button) folded before Flop (didn't bet)
Seat 2: nXDI8Y/S6POzRwANu3d8hQ (small blind) collected ($4)
Seat 3: GX1heJ+DSsvm7gzSPsYhhQ (big blind) folded before Flop
Seat 5: WUlHm+ydPPHG7Lb0rePSdA folded before Flop (didn't bet)
Seat 6: EBV6OktyeSmh4w6sWmcWOw folded before Flop (didn't bet)
Seat 7: rW/MyplHylMSBRaoRUzWrg folded before Flop (didn't bet)
Seat 8: pN/Ip0ePsUVIdUlGgLrkUw folded before Flop (didn't bet)
Seat 9: Kzta8yu9vxHT4B70mjBZ+w folded before Flop (didn't bet)



PokerStars Game #59941577142:  Hold'em No Limit ($1/$2) - 2009/07/01 1:39:40 ET
Table 'gnHBqWll9O3fxG7Ojkz/ng' 9-max Seat #7 is the button
Seat 1: TAfo4veNRaRlzDXMMYS3Jg ($31 in chips)
Seat 2: H6Z4+qu8gR0VUiPOijndVg ($331.95 in chips)
Seat 3: 5Q8U6iZbeO7xJSS4qvDP5g ($218.05 in chips)
Seat 4: nXDI8Y/S6POzRwANu3d8hQ ($19 in chips)
Seat 5: rBQDMkKm9cZn6M9NPsiVew ($222.15 in chips)
Seat 6: KqHysDSpCPaPyK3tJC1aEw ($200 in chips)
Seat 7: jqui3xAWCkcdPW36a6BD+w ($342.55 in chips)
Seat 8: cM6efHzdxoqYm0EQKP4TTQ ($110.55 in chips)
Seat 9: GX1heJ+DSsvm7gzSPsYhhQ ($50.35 in chips)
cM6efHzdxoqYm0EQKP4TTQ: posts small blind $1
GX1heJ+DSsvm7gzSPsYhhQ: posts big blind $2
*** HOLE CARDS ***
TAfo4veNRaRlzDXMMYS3Jg: folds
H6Z4+qu8gR0VUiPOijndVg: folds
5Q8U6iZbeO7xJSS4qvDP5g: folds
nXDI8Y/S6POzRwANu3d8hQ: folds
rBQDMkKm9cZn6M9NPsiVew: folds
KqHysDSpCPaPyK3tJC1aEw: folds
jqui3xAWCkcdPW36a6BD+w: folds
cM6efHzdxoqYm0EQKP4TTQ: calls $1
GX1heJ+DSsvm7gzSPsYhhQ: checks
*** FLOP *** [5c 4d Ac]
cM6efHzdxoqYm0EQKP4TTQ: checks
GX1heJ+DSsvm7gzSPsYhhQ: bets $2
cM6efHzdxoqYm0EQKP4TTQ: calls $2
*** TURN *** [5c 4d Ac] [9s]
cM6efHzdxoqYm0EQKP4TTQ: checks
GX1heJ+DSsvm7gzSPsYhhQ: checks
*** RIVER *** [5c 4d Ac 9s] [6d]
cM6efHzdxoqYm0EQKP4TTQ: bets $8
GX1heJ+DSsvm7gzSPsYhhQ: folds
cM6efHzdxoqYm0EQKP4TTQ collected $7.65 from pot
*** SUMMARY ***
Total pot $8 | Rake $0.35
Board [5c 4d Ac 9s 6d]
Seat 1: TAfo4veNRaRlzDXMMYS3Jg folded before Flop (didn't bet)
Seat 2: H6Z4+qu8gR0VUiPOijndVg folded before Flop (didn't bet)
Seat 3: 5Q8U6iZbeO7xJSS4qvDP5g folded before Flop (didn't bet)
Seat 4: nXDI8Y/S6POzRwANu3d8hQ folded before Flop (didn't bet)
Seat 5: rBQDMkKm9cZn6M9NPsiVew folded before Flop (didn't bet)
Seat 6: KqHysDSpCPaPyK3tJC1aEw folded before Flop (didn't bet)
Seat 7: jqui3xAWCkcdPW36a6BD+w (button) folded before Flop (didn't bet)
Seat 8: cM6efHzdxoqYm0EQKP4TTQ (small blind) collected ($7.65)
Seat 9: GX1heJ+DSsvm7gzSPsYhhQ (big blind) folded on the River



PokerStars Game #59941578366:  Hold'em No Limit ($1/$2) - 2009/07/01 1:39:42 ET
Table 'bJQ024BaYSBrW0sXpCZbNQ' 6-max Seat #4 is the button
Seat 1: KfwW5us6tydK81NYTtK1gw ($203 in chips)
Seat 2: 3dAbvkxS5NPQTBAbvpinVg ($200 in chips)
Seat 3: /PH6Ffnho4Ysm8S3V/oa+w ($40 in chips)
Seat 4: TBaQIN+sQ7eb7P99QnaORQ ($61.15 in chips)
Seat 5: VvdR9F3I+2yELkfTVvC1dg ($200 in chips)
Seat 6: 4bqvCfJ0e8CTYnn0Go9hbQ ($149.20 in chips)
VvdR9F3I+2yELkfTVvC1dg: posts small blind $1
4bqvCfJ0e8CTYnn0Go9hbQ: posts big blind $2
*** HOLE CARDS ***
TBaQIN+sQ7eb7P99QnaORQ said, "damn"
KfwW5us6tydK81NYTtK1gw: raises $2 to $4
3dAbvkxS5NPQTBAbvpinVg: calls $4
/PH6Ffnho4Ysm8S3V/oa+w: folds
TBaQIN+sQ7eb7P99QnaORQ: raises $10 to $14
VvdR9F3I+2yELkfTVvC1dg: folds
4bqvCfJ0e8CTYnn0Go9hbQ: folds
KfwW5us6tydK81NYTtK1gw: folds
3dAbvkxS5NPQTBAbvpinVg: folds
TBaQIN+sQ7eb7P99QnaORQ collected $15 from pot
*** SUMMARY ***
Total pot $15 | Rake $0
Seat 1: KfwW5us6tydK81NYTtK1gw folded before Flop
Seat 2: 3dAbvkxS5NPQTBAbvpinVg folded before Flop
Seat 3: /PH6Ffnho4Ysm8S3V/oa+w folded before Flop (didn't bet)
Seat 4: TBaQIN+sQ7eb7P99QnaORQ (button) collected ($15)
Seat 5: VvdR9F3I+2yELkfTVvC1dg (small blind) folded before Flop
Seat 6: 4bqvCfJ0e8CTYnn0Go9hbQ (big blind) folded before Flop



PokerStars Game #59941578762:  Hold'em No Limit ($1/$2) - 2009/07/01 1:39:43 ET
Table 'P/yCfYl1GfGsu/e6DxDy/A' 2-max Seat #1 is the button
Seat 1: 7fOCUy3x9hdkmXkkDNolGQ ($493.50 in chips)
Seat 2: RwDoM55ZeQuI2ADyJhOb2Q ($984.50 in chips)
7fOCUy3x9hdkmXkkDNolGQ: posts small blind $1
RwDoM55ZeQuI2ADyJhOb2Q: posts big blind $2
*** HOLE CARDS ***
7fOCUy3x9hdkmXkkDNolGQ: raises $4 to $6
RwDoM55ZeQuI2ADyJhOb2Q: folds
7fOCUy3x9hdkmXkkDNolGQ collected $4 from pot
7fOCUy3x9hdkmXkkDNolGQ: doesn't show hand
*** SUMMARY ***
Total pot $4 | Rake $0
Seat 1: 7fOCUy3x9hdkmXkkDNolGQ (button) (small blind) collected ($4)
Seat 2: RwDoM55ZeQuI2ADyJhOb2Q (big blind) folded before Flop



PokerStars Game #59941579654:  Hold'em No Limit ($1/$2) - 2009/07/01 1:39:44 ET
Table 'NmY84NAf9Mh0ckAckHnh5g' 2-max Seat #1 is the button
Seat 1: 6hvg964TSqZ3AL/0XK9aVQ ($463.60 in chips)
Seat 2: RwDoM55ZeQuI2ADyJhOb2Q ($529.50 in chips)
6hvg964TSqZ3AL/0XK9aVQ: posts small blind $1
RwDoM55ZeQuI2ADyJhOb2Q: posts big blind $2
*** HOLE CARDS ***
6hvg964TSqZ3AL/0XK9aVQ: folds
RwDoM55ZeQuI2ADyJhOb2Q collected $2 from pot
RwDoM55ZeQuI2ADyJhOb2Q: doesn't show hand
*** SUMMARY ***
Total pot $2 | Rake $0
Seat 1: 6hvg964TSqZ3AL/0XK9aVQ (button) (small blind) folded before Flop
Seat 2: RwDoM55ZeQuI2ADyJhOb2Q (big blind) collected ($2)



PokerStars Game #59941579670:  Hold'em No Limit ($1/$2) - 2009/07/01 1:39:44 ET
Table 'LL4bDFyhj5hsMpzaDugJZg' 6-max Seat #6 is the button
Seat 2: IZng3w8jiJHHp3LbYKLi4w ($49.75 in chips)
Seat 3: iI/NMpRxMkGieArQEhACSA ($581.25 in chips)
Seat 4: 8srN1dKQePlsv0GyTada+Q ($200 in chips)
Seat 6: 692Q4sfB0gTElzS0WMeg+A ($205.35 in chips)
IZng3w8jiJHHp3LbYKLi4w: posts small blind $1
iI/NMpRxMkGieArQEhACSA: posts big blind $2
*** HOLE CARDS ***
8srN1dKQePlsv0GyTada+Q: raises $4 to $6
692Q4sfB0gTElzS0WMeg+A: folds
IZng3w8jiJHHp3LbYKLi4w: folds
iI/NMpRxMkGieArQEhACSA: folds
8srN1dKQePlsv0GyTada+Q collected $5 from pot
*** SUMMARY ***
Total pot $5 | Rake $0
Seat 2: IZng3w8jiJHHp3LbYKLi4w (small blind) folded before Flop
Seat 3: iI/NMpRxMkGieArQEhACSA (big blind) folded before Flop
Seat 4: 8srN1dKQePlsv0GyTada+Q collected ($5)
Seat 6: 692Q4sfB0gTElzS0WMeg+A (button) folded before Flop (didn't bet)



PokerStars Game #59941581800:  Hold'em No Limit ($1/$2) - 2009/07/01 1:39:48 ET
Table 'ZzSIe0zTCDv+n6hfbY5tTg' 6-max Seat #2 is the button
Seat 1: VvdR9F3I+2yELkfTVvC1dg ($254 in chips)
Seat 2: B87ikIyZ/TzAVeXf38Ny0g ($234 in chips)
Seat 3: gsugPj31Hui3Jefl98MBOA ($356.25 in chips)
Seat 5: 3dAbvkxS5NPQTBAbvpinVg ($501.10 in chips)
Seat 6: 09BNF4quPDzanQzM8vc6WA ($39 in chips)
gsugPj31Hui3Jefl98MBOA: posts small blind $1
qXDd0ZyMIse0OBu8pxeQ3Q: is sitting out
3dAbvkxS5NPQTBAbvpinVg: posts big blind $2
*** HOLE CARDS ***
09BNF4quPDzanQzM8vc6WA: folds
VvdR9F3I+2yELkfTVvC1dg: raises $2 to $4
B87ikIyZ/TzAVeXf38Ny0g: folds
gsugPj31Hui3Jefl98MBOA: folds
3dAbvkxS5NPQTBAbvpinVg: folds
VvdR9F3I+2yELkfTVvC1dg collected $5 from pot
VvdR9F3I+2yELkfTVvC1dg: doesn't show hand
*** SUMMARY ***
Total pot $5 | Rake $0
Seat 1: VvdR9F3I+2yELkfTVvC1dg collected ($5)
Seat 2: B87ikIyZ/TzAVeXf38Ny0g (button) folded before Flop (didn't bet)
Seat 3: gsugPj31Hui3Jefl98MBOA (small blind) folded before Flop
Seat 5: 3dAbvkxS5NPQTBAbvpinVg (big blind) folded before Flop
Seat 6: 09BNF4quPDzanQzM8vc6WA folded before Flop (didn't bet)



PokerStars Game #59941582466:  Hold'em No Limit ($1/$2) - 2009/07/01 1:39:49 ET
Table 'G1Oqdy4Pqdb5gtx40rUBzA' 6-max Seat #5 is the button
Seat 3: VvdR9F3I+2yELkfTVvC1dg ($227.90 in chips)
Seat 4: B87ikIyZ/TzAVeXf38Ny0g ($205.55 in chips)
Seat 5: F1+Ml47qRQWunzPnGhLLzQ ($200.65 in chips)
Seat 6: qCnEYuAE5y5A7bk6fO5/jQ ($207 in chips)
qCnEYuAE5y5A7bk6fO5/jQ: posts small blind $1
4uqU0dG67owXuPz303Al4w: is sitting out
VvdR9F3I+2yELkfTVvC1dg: posts big blind $2
*** HOLE CARDS ***
B87ikIyZ/TzAVeXf38Ny0g: folds
F1+Ml47qRQWunzPnGhLLzQ: calls $2
qCnEYuAE5y5A7bk6fO5/jQ: folds
VvdR9F3I+2yELkfTVvC1dg: checks
*** FLOP *** [3h 6d 5d]
VvdR9F3I+2yELkfTVvC1dg: checks
F1+Ml47qRQWunzPnGhLLzQ: checks
*** TURN *** [3h 6d 5d] [Ad]
4uqU0dG67owXuPz303Al4w leaves the table
VvdR9F3I+2yELkfTVvC1dg: checks
F1+Ml47qRQWunzPnGhLLzQ: bets $2
VvdR9F3I+2yELkfTVvC1dg: folds
F1+Ml47qRQWunzPnGhLLzQ collected $4.75 from pot
F1+Ml47qRQWunzPnGhLLzQ: doesn't show hand
*** SUMMARY ***
Total pot $5 | Rake $0.25
Board [3h 6d 5d Ad]
Seat 3: VvdR9F3I+2yELkfTVvC1dg (big blind) folded on the Turn
Seat 4: B87ikIyZ/TzAVeXf38Ny0g folded before Flop (didn't bet)
Seat 5: F1+Ml47qRQWunzPnGhLLzQ (button) collected ($4.75)
Seat 6: qCnEYuAE5y5A7bk6fO5/jQ (small blind) folded before Flop



PokerStars Game #59941582654:  Hold'em No Limit ($1/$2) - 2009/07/01 1:39:50 ET
Table 'NmY84NAf9Mh0ckAckHnh5g' 2-max Seat #2 is the button
Seat 1: 6hvg964TSqZ3AL/0XK9aVQ ($462.60 in chips)
Seat 2: RwDoM55ZeQuI2ADyJhOb2Q ($530.50 in chips)
RwDoM55ZeQuI2ADyJhOb2Q: posts small blind $1
6hvg964TSqZ3AL/0XK9aVQ: posts big blind $2
*** HOLE CARDS ***
RwDoM55ZeQuI2ADyJhOb2Q: raises $4 to $6
6hvg964TSqZ3AL/0XK9aVQ: folds
RwDoM55ZeQuI2ADyJhOb2Q collected $4 from pot
RwDoM55ZeQuI2ADyJhOb2Q: doesn't show hand
*** SUMMARY ***
Total pot $4 | Rake $0
Seat 1: 6hvg964TSqZ3AL/0XK9aVQ (big blind) folded before Flop
Seat 2: RwDoM55ZeQuI2ADyJhOb2Q (button) (small blind) collected ($4)



PokerStars Game #59941584764:  Hold'em No Limit ($1/$2) - 2009/07/01 1:39:53 ET
Table 'kq5zaQ+1hLNf8LZfGnbTAA' 6-max Seat #2 is the button
Seat 1: 8srN1dKQePlsv0GyTada+Q ($430.60 in chips)
Seat 2: nXDI8Y/S6POzRwANu3d8hQ ($139 in chips)
Seat 3: /PH6Ffnho4Ysm8S3V/oa+w ($50.15 in chips)
Seat 4: 3dAbvkxS5NPQTBAbvpinVg ($281.45 in chips)
Seat 5: gnYme0DNFflnMhrdbxe1Ag ($219.35 in chips)
Seat 6: mfy7uGZcqA2PVQqEVbJ7+g ($192.45 in chips)
/PH6Ffnho4Ysm8S3V/oa+w: posts small blind $1
3dAbvkxS5NPQTBAbvpinVg: posts big blind $2
*** HOLE CARDS ***
gnYme0DNFflnMhrdbxe1Ag: raises $4 to $6
mfy7uGZcqA2PVQqEVbJ7+g: folds
8srN1dKQePlsv0GyTada+Q: folds
nXDI8Y/S6POzRwANu3d8hQ: folds
/PH6Ffnho4Ysm8S3V/oa+w: folds
3dAbvkxS5NPQTBAbvpinVg: folds
gnYme0DNFflnMhrdbxe1Ag collected $5 from pot
gnYme0DNFflnMhrdbxe1Ag: doesn't show hand
*** SUMMARY ***
Total pot $5 | Rake $0
Seat 1: 8srN1dKQePlsv0GyTada+Q folded before Flop (didn't bet)
Seat 2: nXDI8Y/S6POzRwANu3d8hQ (button) folded before Flop (didn't bet)
Seat 3: /PH6Ffnho4Ysm8S3V/oa+w (small blind) folded before Flop
Seat 4: 3dAbvkxS5NPQTBAbvpinVg (big blind) folded before Flop
Seat 5: gnYme0DNFflnMhrdbxe1Ag collected ($5)
Seat 6: mfy7uGZcqA2PVQqEVbJ7+g folded before Flop (didn't bet)



PokerStars Game #59941585076:  Hold'em No Limit ($1/$2) - 2009/07/01 1:39:54 ET
Table 'ztv6V3FN2bQ9nmJPPdx6nQ' 6-max Seat #1 is the button
Seat 1: 6fLdOUCRtX71xbVRhJEq8w ($238.35 in chips)
Seat 2: 5Y+ZGWLI4gnlpApDX5vy1A ($392.15 in chips)
Seat 3: ubtx4Z5L+AcK71MTvYiGVw ($245 in chips)
Seat 4: UaZ5yj+6LjtWqMQg2QskUw ($91.30 in chips)
Seat 5: sTPOWERd9HWPCNrDBwsVjA ($220.60 in chips)
Seat 6: mfy7uGZcqA2PVQqEVbJ7+g ($109.60 in chips)
5Y+ZGWLI4gnlpApDX5vy1A: posts small blind $1
ubtx4Z5L+AcK71MTvYiGVw: posts big blind $2
*** HOLE CARDS ***
UaZ5yj+6LjtWqMQg2QskUw: folds
sTPOWERd9HWPCNrDBwsVjA: folds
mfy7uGZcqA2PVQqEVbJ7+g: folds
6fLdOUCRtX71xbVRhJEq8w: folds
5Y+ZGWLI4gnlpApDX5vy1A: raises $6 to $8
ubtx4Z5L+AcK71MTvYiGVw: folds
5Y+ZGWLI4gnlpApDX5vy1A collected $4 from pot
5Y+ZGWLI4gnlpApDX5vy1A: doesn't show hand
*** SUMMARY ***
Total pot $4 | Rake $0
Seat 1: 6fLdOUCRtX71xbVRhJEq8w (button) folded before Flop (didn't bet)
Seat 2: 5Y+ZGWLI4gnlpApDX5vy1A (small blind) collected ($4)
Seat 3: ubtx4Z5L+AcK71MTvYiGVw (big blind) folded before Flop
Seat 4: UaZ5yj+6LjtWqMQg2QskUw folded before Flop (didn't bet)
Seat 5: sTPOWERd9HWPCNrDBwsVjA folded before Flop (didn't bet)
Seat 6: mfy7uGZcqA2PVQqEVbJ7+g folded before Flop (didn't bet)



PokerStars Game #59941586088:  Hold'em No Limit ($1/$2) - 2009/07/01 1:39:56 ET
Table '/dyk+YdRGv90j2box35j8w' 6-max Seat #2 is the button
Seat 1: 8srN1dKQePlsv0GyTada+Q ($212.25 in chips)
Seat 2: qCnEYuAE5y5A7bk6fO5/jQ ($470.60 in chips)
Seat 3: sTPOWERd9HWPCNrDBwsVjA ($180.50 in chips)
Seat 4: z/u1YTnkiIDrtp/2cA2dBg ($165.85 in chips)
Seat 5: VvdR9F3I+2yELkfTVvC1dg ($252 in chips)
Seat 6: gnYme0DNFflnMhrdbxe1Ag ($200 in chips)
sTPOWERd9HWPCNrDBwsVjA: posts small blind $1
z/u1YTnkiIDrtp/2cA2dBg: posts big blind $2
*** HOLE CARDS ***
VvdR9F3I+2yELkfTVvC1dg: folds
gnYme0DNFflnMhrdbxe1Ag: folds
8srN1dKQePlsv0GyTada+Q: folds
qCnEYuAE5y5A7bk6fO5/jQ: raises $4 to $6
sTPOWERd9HWPCNrDBwsVjA: folds
z/u1YTnkiIDrtp/2cA2dBg: calls $4
*** FLOP *** [Ad 7h Ac]
z/u1YTnkiIDrtp/2cA2dBg: checks
qCnEYuAE5y5A7bk6fO5/jQ: bets $8
z/u1YTnkiIDrtp/2cA2dBg: calls $8
*** TURN *** [Ad 7h Ac] [2s]
z/u1YTnkiIDrtp/2cA2dBg: checks
qCnEYuAE5y5A7bk6fO5/jQ: bets $22
z/u1YTnkiIDrtp/2cA2dBg: folds
qCnEYuAE5y5A7bk6fO5/jQ collected $27.60 from pot
qCnEYuAE5y5A7bk6fO5/jQ: doesn't show hand
*** SUMMARY ***
Total pot $29 | Rake $1.40
Board [Ad 7h Ac 2s]
Seat 1: 8srN1dKQePlsv0GyTada+Q folded before Flop (didn't bet)
Seat 2: qCnEYuAE5y5A7bk6fO5/jQ (button) collected ($27.60)
Seat 3: sTPOWERd9HWPCNrDBwsVjA (small blind) folded before Flop
Seat 4: z/u1YTnkiIDrtp/2cA2dBg (big blind) folded on the Turn
Seat 5: VvdR9F3I+2yELkfTVvC1dg folded before Flop (didn't bet)
Seat 6: gnYme0DNFflnMhrdbxe1Ag folded before Flop (didn't bet)



PokerStars Game #59941586226:  Hold'em No Limit ($1/$2) - 2009/07/01 1:39:56 ET
Table '/ci73fTmzTzmGWzAtqEX2Q' 9-max Seat #4 is the button
Seat 1: 9efVc1cB3yHt4TvBkTusPw ($145.90 in chips)
Seat 2: pN/Ip0ePsUVIdUlGgLrkUw ($225 in chips)
Seat 3: kK1+5ivyJZeA8hQF2pdvvQ ($61.55 in chips)
Seat 4: 2yq7Zp4xmrhAw8+37hTkaA ($161.20 in chips)
Seat 5: 1CtiZuXDFaJL1dJPQKyi8Q ($189.75 in chips)
Seat 6: KqHysDSpCPaPyK3tJC1aEw ($200 in chips)
Seat 8: /inIs/z/PcX+TniIFpaxpg ($34 in chips)
Seat 9: S8aS+9FTYQ/ICLBNThcrkg ($177 in chips)
1CtiZuXDFaJL1dJPQKyi8Q: posts small blind $1
KqHysDSpCPaPyK3tJC1aEw: posts big blind $2
+T/63sAeZzWyHchahJ36GQ: sits out
*** HOLE CARDS ***
/inIs/z/PcX+TniIFpaxpg: folds
S8aS+9FTYQ/ICLBNThcrkg: folds
9efVc1cB3yHt4TvBkTusPw: folds
pN/Ip0ePsUVIdUlGgLrkUw: folds
kK1+5ivyJZeA8hQF2pdvvQ: folds
2yq7Zp4xmrhAw8+37hTkaA: folds
1CtiZuXDFaJL1dJPQKyi8Q: folds
KqHysDSpCPaPyK3tJC1aEw collected $2 from pot
*** SUMMARY ***
Total pot $2 | Rake $0
Seat 1: 9efVc1cB3yHt4TvBkTusPw folded before Flop (didn't bet)
Seat 2: pN/Ip0ePsUVIdUlGgLrkUw folded before Flop (didn't bet)
Seat 3: kK1+5ivyJZeA8hQF2pdvvQ folded before Flop (didn't bet)
Seat 4: 2yq7Zp4xmrhAw8+37hTkaA (button) folded before Flop (didn't bet)
Seat 5: 1CtiZuXDFaJL1dJPQKyi8Q (small blind) folded before Flop
Seat 6: KqHysDSpCPaPyK3tJC1aEw (big blind) collected ($2)
Seat 8: /inIs/z/PcX+TniIFpaxpg folded before Flop (didn't bet)
Seat 9: S8aS+9FTYQ/ICLBNThcrkg folded before Flop (didn't bet)



PokerStars Game #59941586638:  Hold'em No Limit ($1/$2) - 2009/07/01 1:39:57 ET
Table 'mGpP9StWRnoeiBDExc6Frg' 6-max Seat #6 is the button
Seat 1: VvdR9F3I+2yELkfTVvC1dg ($310.15 in chips)
Seat 2: vkfxu8f/jMYKUk6Ly4eujw ($199 in chips)
Seat 3: 7acrZUQC3Zc9BNLjoKIcLQ ($40.85 in chips)
Seat 4: 4dcDwIHRm96PwtqkpQiuiA ($69.70 in chips)
Seat 5: d1puGuVBE0fidn+5eRJ0tw ($198.65 in chips)
Seat 6: B2Ih1sr5VZk+8He7rcrMtQ ($416.05 in chips)
VvdR9F3I+2yELkfTVvC1dg: posts small blind $1
vkfxu8f/jMYKUk6Ly4eujw: posts big blind $2
*** HOLE CARDS ***
7acrZUQC3Zc9BNLjoKIcLQ: raises $2 to $4
4dcDwIHRm96PwtqkpQiuiA: folds
d1puGuVBE0fidn+5eRJ0tw: calls $4
B2Ih1sr5VZk+8He7rcrMtQ: folds
VvdR9F3I+2yELkfTVvC1dg: folds
vkfxu8f/jMYKUk6Ly4eujw: folds
*** FLOP *** [8s 8c Qc]
7acrZUQC3Zc9BNLjoKIcLQ: bets $6
d1puGuVBE0fidn+5eRJ0tw: raises $32 to $38
7acrZUQC3Zc9BNLjoKIcLQ: folds
d1puGuVBE0fidn+5eRJ0tw collected $21.90 from pot
*** SUMMARY ***
Total pot $23 | Rake $1.10
Board [8s 8c Qc]
Seat 1: VvdR9F3I+2yELkfTVvC1dg (small blind) folded before Flop
Seat 2: vkfxu8f/jMYKUk6Ly4eujw (big blind) folded before Flop
Seat 3: 7acrZUQC3Zc9BNLjoKIcLQ folded on the Flop
Seat 4: 4dcDwIHRm96PwtqkpQiuiA folded before Flop (didn't bet)
Seat 5: d1puGuVBE0fidn+5eRJ0tw collected ($21.90)
Seat 6: B2Ih1sr5VZk+8He7rcrMtQ (button) folded before Flop (didn't bet)



PokerStars Game #59941586966:  Hold'em No Limit ($1/$2) - 2009/07/01 1:39:57 ET
Table 'NmY84NAf9Mh0ckAckHnh5g' 2-max Seat #1 is the button
Seat 1: 6hvg964TSqZ3AL/0XK9aVQ ($460.60 in chips)
Seat 2: RwDoM55ZeQuI2ADyJhOb2Q ($532.50 in chips)
6hvg964TSqZ3AL/0XK9aVQ: posts small blind $1
RwDoM55ZeQuI2ADyJhOb2Q: posts big blind $2
*** HOLE CARDS ***
6hvg964TSqZ3AL/0XK9aVQ: calls $1
RwDoM55ZeQuI2ADyJhOb2Q: checks
*** FLOP *** [2d 8s Kh]
RwDoM55ZeQuI2ADyJhOb2Q: checks
6hvg964TSqZ3AL/0XK9aVQ: checks
*** TURN *** [2d 8s Kh] [5c]
RwDoM55ZeQuI2ADyJhOb2Q: checks
6hvg964TSqZ3AL/0XK9aVQ: bets $4
RwDoM55ZeQuI2ADyJhOb2Q: folds
6hvg964TSqZ3AL/0XK9aVQ collected $3.80 from pot
*** SUMMARY ***
Total pot $4 | Rake $0.20
Board [2d 8s Kh 5c]
Seat 1: 6hvg964TSqZ3AL/0XK9aVQ (button) (small blind) collected ($3.80)
Seat 2: RwDoM55ZeQuI2ADyJhOb2Q (big blind) folded on the Turn



PokerStars Game #59941588392:  Hold'em No Limit ($1/$2) - 2009/07/01 1:40:00 ET
Table 'AtOXMvcrtQM8yLNcALmfLQ' 2-max Seat #2 is the button
Seat 1: +HlQuAsMqZGYYtjcPO/a3A ($334 in chips)
Seat 2: pVqEzK9wXlRMECnb1Zg4Zw ($236.50 in chips)
pVqEzK9wXlRMECnb1Zg4Zw: posts small blind $1
+HlQuAsMqZGYYtjcPO/a3A: posts big blind $2
*** HOLE CARDS ***
pVqEzK9wXlRMECnb1Zg4Zw: raises $6 to $8
+HlQuAsMqZGYYtjcPO/a3A: calls $6
*** FLOP *** [3s 5h 6c]
+HlQuAsMqZGYYtjcPO/a3A: checks
pVqEzK9wXlRMECnb1Zg4Zw: checks
*** TURN *** [3s 5h 6c] [Td]
+HlQuAsMqZGYYtjcPO/a3A: checks
pVqEzK9wXlRMECnb1Zg4Zw: checks
*** RIVER *** [3s 5h 6c Td] [8d]
+HlQuAsMqZGYYtjcPO/a3A: checks
pVqEzK9wXlRMECnb1Zg4Zw: checks
*** SHOW DOWN ***
+HlQuAsMqZGYYtjcPO/a3A: shows [Js Qc] (high card Queen)
pVqEzK9wXlRMECnb1Zg4Zw: shows [2s As] (high card Ace)
pVqEzK9wXlRMECnb1Zg4Zw collected $15.50 from pot
*** SUMMARY ***
Total pot $16 | Rake $0.50
Board [3s 5h 6c Td 8d]
Seat 1: +HlQuAsMqZGYYtjcPO/a3A (big blind) showed [Js Qc] and lost with high card Queen
Seat 2: pVqEzK9wXlRMECnb1Zg4Zw (button) (small blind) showed [2s As] and won ($15.50) with high card Ace



PokerStars Game #59941589124:  Hold'em No Limit ($1/$2) - 2009/07/01 1:40:01 ET
Table 'TsEDkiO4tzCTCzJ7tNdEqw' 6-max Seat #6 is the button
Seat 2: 4dcDwIHRm96PwtqkpQiuiA ($87.65 in chips)
Seat 3: ubtx4Z5L+AcK71MTvYiGVw ($293.05 in chips)
Seat 4: K8MXCrNAVYlMnnCeM32Kxw ($85.50 in chips)
Seat 5: VvdR9F3I+2yELkfTVvC1dg ($244.35 in chips)
Seat 6: uCqEjnxh2/vFBjKYkfTOkw ($179.30 in chips)
vkfxu8f/jMYKUk6Ly4eujw will be allowed to play after the button
4dcDwIHRm96PwtqkpQiuiA: posts small blind $1
ubtx4Z5L+AcK71MTvYiGVw: posts big blind $2
*** HOLE CARDS ***
K8MXCrNAVYlMnnCeM32Kxw: folds
VvdR9F3I+2yELkfTVvC1dg: raises $2 to $4
uCqEjnxh2/vFBjKYkfTOkw: folds
4dcDwIHRm96PwtqkpQiuiA: folds
ubtx4Z5L+AcK71MTvYiGVw: folds
VvdR9F3I+2yELkfTVvC1dg collected $5 from pot
VvdR9F3I+2yELkfTVvC1dg: doesn't show hand
*** SUMMARY ***
Total pot $5 | Rake $0
Seat 2: 4dcDwIHRm96PwtqkpQiuiA (small blind) folded before Flop
Seat 3: ubtx4Z5L+AcK71MTvYiGVw (big blind) folded before Flop
Seat 4: K8MXCrNAVYlMnnCeM32Kxw folded before Flop (didn't bet)
Seat 5: VvdR9F3I+2yELkfTVvC1dg collected ($5)
Seat 6: uCqEjnxh2/vFBjKYkfTOkw (button) folded before Flop (didn't bet)



PokerStars Game #59941589830:  Hold'em No Limit ($1/$2) - 2009/07/01 1:40:03 ET
Table 'UGLAZZyv+cXmnKjYin0etA' 6-max Seat #1 is the button
Seat 1: vkfxu8f/jMYKUk6Ly4eujw ($203 in chips)
Seat 2: eDLH1PUXFpvJBNMXBVQcGA ($311.10 in chips)
Seat 3: ygTTt5ehT4aF86q1a8/R+w ($114.20 in chips)
Seat 4: SiGJDsvRViJX05vHhA80GQ ($231.85 in chips)
Seat 5: 54yWzRRgS0oZ+S6LwZBxMQ ($31 in chips)
Seat 6: sTPOWERd9HWPCNrDBwsVjA ($218.15 in chips)
eDLH1PUXFpvJBNMXBVQcGA: posts small blind $1
ygTTt5ehT4aF86q1a8/R+w: posts big blind $2
*** HOLE CARDS ***
SiGJDsvRViJX05vHhA80GQ: raises $4 to $6
54yWzRRgS0oZ+S6LwZBxMQ: folds
sTPOWERd9HWPCNrDBwsVjA: folds
vkfxu8f/jMYKUk6Ly4eujw: folds
eDLH1PUXFpvJBNMXBVQcGA: folds
ygTTt5ehT4aF86q1a8/R+w: folds
SiGJDsvRViJX05vHhA80GQ collected $5 from pot
*** SUMMARY ***
Total pot $5 | Rake $0
Seat 1: vkfxu8f/jMYKUk6Ly4eujw (button) folded before Flop (didn't bet)
Seat 2: eDLH1PUXFpvJBNMXBVQcGA (small blind) folded before Flop
Seat 3: ygTTt5ehT4aF86q1a8/R+w (big blind) folded before Flop
Seat 4: SiGJDsvRViJX05vHhA80GQ collected ($5)
Seat 5: 54yWzRRgS0oZ+S6LwZBxMQ folded before Flop (didn't bet)
Seat 6: sTPOWERd9HWPCNrDBwsVjA folded before Flop (didn't bet)



PokerStars Game #59941589908:  Hold'em No Limit ($1/$2) - 2009/07/01 1:40:03 ET
Table 'LL4bDFyhj5hsMpzaDugJZg' 6-max Seat #2 is the button
Seat 2: IZng3w8jiJHHp3LbYKLi4w ($48.75 in chips)
Seat 3: iI/NMpRxMkGieArQEhACSA ($579.25 in chips)
Seat 4: 8srN1dKQePlsv0GyTada+Q ($203 in chips)
Seat 6: 692Q4sfB0gTElzS0WMeg+A ($205.35 in chips)
iI/NMpRxMkGieArQEhACSA: posts small blind $1
8srN1dKQePlsv0GyTada+Q: posts big blind $2
*** HOLE CARDS ***
692Q4sfB0gTElzS0WMeg+A: folds
vkfxu8f/jMYKUk6Ly4eujw joins the table at seat #5
IZng3w8jiJHHp3LbYKLi4w: calls $2
iI/NMpRxMkGieArQEhACSA: raises $6 to $8
8srN1dKQePlsv0GyTada+Q: folds
IZng3w8jiJHHp3LbYKLi4w: folds
iI/NMpRxMkGieArQEhACSA collected $6 from pot
*** SUMMARY ***
Total pot $6 | Rake $0
Seat 2: IZng3w8jiJHHp3LbYKLi4w (button) folded before Flop
Seat 3: iI/NMpRxMkGieArQEhACSA (small blind) collected ($6)
Seat 4: 8srN1dKQePlsv0GyTada+Q (big blind) folded before Flop
Seat 6: 692Q4sfB0gTElzS0WMeg+A folded before Flop (didn't bet)



PokerStars Game #59941590502:  Hold'em No Limit ($1/$2) - 2009/07/01 1:40:04 ET
Table 'pPQgcj9XT9CHBsbo1WTBug' 6-max Seat #2 is the button
Seat 1: DFVYDA6dKQy7R7mGIKogZA ($90 in chips)
Seat 2: qXDd0ZyMIse0OBu8pxeQ3Q ($210.95 in chips)
Seat 3: 54yWzRRgS0oZ+S6LwZBxMQ ($115 in chips)
Seat 4: gqlysXCbT8V54f/1lf9h3A ($46.45 in chips)
Seat 5: vkfxu8f/jMYKUk6Ly4eujw ($196.55 in chips)
54yWzRRgS0oZ+S6LwZBxMQ: posts small blind $1
gqlysXCbT8V54f/1lf9h3A: posts big blind $2
*** HOLE CARDS ***
vkfxu8f/jMYKUk6Ly4eujw: folds
DFVYDA6dKQy7R7mGIKogZA: calls $2
qXDd0ZyMIse0OBu8pxeQ3Q: raises $7 to $9
54yWzRRgS0oZ+S6LwZBxMQ: folds
gqlysXCbT8V54f/1lf9h3A: calls $7
DFVYDA6dKQy7R7mGIKogZA: raises $7 to $16
qXDd0ZyMIse0OBu8pxeQ3Q: calls $7
gqlysXCbT8V54f/1lf9h3A: calls $7
*** FLOP *** [2c 4c Ks]
gqlysXCbT8V54f/1lf9h3A: checks
DFVYDA6dKQy7R7mGIKogZA: bets $14
qXDd0ZyMIse0OBu8pxeQ3Q: folds
gqlysXCbT8V54f/1lf9h3A: folds
DFVYDA6dKQy7R7mGIKogZA collected $47 from pot
*** SUMMARY ***
Total pot $49 | Rake $2
Board [2c 4c Ks]
Seat 1: DFVYDA6dKQy7R7mGIKogZA collected ($47)
Seat 2: qXDd0ZyMIse0OBu8pxeQ3Q (button) folded on the Flop
Seat 3: 54yWzRRgS0oZ+S6LwZBxMQ (small blind) folded before Flop
Seat 4: gqlysXCbT8V54f/1lf9h3A (big blind) folded on the Flop
Seat 5: vkfxu8f/jMYKUk6Ly4eujw folded before Flop (didn't bet)



PokerStars Game #59941592584:  Hold'em No Limit ($1/$2) - 2009/07/01 1:40:08 ET
Table 'ztv6V3FN2bQ9nmJPPdx6nQ' 6-max Seat #2 is the button
Seat 1: 6fLdOUCRtX71xbVRhJEq8w ($238.35 in chips)
Seat 2: 5Y+ZGWLI4gnlpApDX5vy1A ($394.15 in chips)
Seat 3: ubtx4Z5L+AcK71MTvYiGVw ($243 in chips)
Seat 4: UaZ5yj+6LjtWqMQg2QskUw ($91.30 in chips)
Seat 5: sTPOWERd9HWPCNrDBwsVjA ($220.60 in chips)
Seat 6: mfy7uGZcqA2PVQqEVbJ7+g ($109.60 in chips)
ubtx4Z5L+AcK71MTvYiGVw: posts small blind $1
UaZ5yj+6LjtWqMQg2QskUw: posts big blind $2
*** HOLE CARDS ***
sTPOWERd9HWPCNrDBwsVjA: folds
mfy7uGZcqA2PVQqEVbJ7+g: folds
6fLdOUCRtX71xbVRhJEq8w has timed out
6fLdOUCRtX71xbVRhJEq8w: folds
6fLdOUCRtX71xbVRhJEq8w is sitting out
6fLdOUCRtX71xbVRhJEq8w has returned
5Y+ZGWLI4gnlpApDX5vy1A: folds
ubtx4Z5L+AcK71MTvYiGVw: raises $6 to $8
UaZ5yj+6LjtWqMQg2QskUw: calls $6
*** FLOP *** [Ac Qc 8d]
ubtx4Z5L+AcK71MTvYiGVw: bets $10
UaZ5yj+6LjtWqMQg2QskUw: folds
ubtx4Z5L+AcK71MTvYiGVw collected $15.20 from pot
ubtx4Z5L+AcK71MTvYiGVw: doesn't show hand
*** SUMMARY ***
Total pot $16 | Rake $0.80
Board [Ac Qc 8d]
Seat 1: 6fLdOUCRtX71xbVRhJEq8w folded before Flop (didn't bet)
Seat 2: 5Y+ZGWLI4gnlpApDX5vy1A (button) folded before Flop (didn't bet)
Seat 3: ubtx4Z5L+AcK71MTvYiGVw (small blind) collected ($15.20)
Seat 4: UaZ5yj+6LjtWqMQg2QskUw (big blind) folded on the Flop
Seat 5: sTPOWERd9HWPCNrDBwsVjA folded before Flop (didn't bet)
Seat 6: mfy7uGZcqA2PVQqEVbJ7+g folded before Flop (didn't bet)



PokerStars Game #59941593316:  Hold'em No Limit ($1/$2) - 2009/07/01 1:40:09 ET
Table 'uJ9juaXXg9yIcSU8amxaXQ' 6-max Seat #2 is the button
Seat 1: JsqOjN/eHz0uYVf/PyUJ6Q ($150.25 in chips)
Seat 2: VvdR9F3I+2yELkfTVvC1dg ($223.10 in chips)
Seat 3: qXDd0ZyMIse0OBu8pxeQ3Q ($247.40 in chips)
Seat 4: zNjJ/y4emmF+vzrCDd+ooA ($222.05 in chips)
Seat 5: YsLQ3BAvgQHWXMAv3Wv6Hg ($205.70 in chips)
Seat 6: /PH6Ffnho4Ysm8S3V/oa+w ($43 in chips)
qXDd0ZyMIse0OBu8pxeQ3Q: posts small blind $1
zNjJ/y4emmF+vzrCDd+ooA: posts big blind $2
*** HOLE CARDS ***
YsLQ3BAvgQHWXMAv3Wv6Hg: folds
/PH6Ffnho4Ysm8S3V/oa+w: folds
JsqOjN/eHz0uYVf/PyUJ6Q: folds
VvdR9F3I+2yELkfTVvC1dg: raises $2 to $4
qXDd0ZyMIse0OBu8pxeQ3Q: calls $3
zNjJ/y4emmF+vzrCDd+ooA: calls $2
*** FLOP *** [4h 2s Qh]
qXDd0ZyMIse0OBu8pxeQ3Q: checks
zNjJ/y4emmF+vzrCDd+ooA: checks
VvdR9F3I+2yELkfTVvC1dg: checks
*** TURN *** [4h 2s Qh] [Ts]
qXDd0ZyMIse0OBu8pxeQ3Q: checks
zNjJ/y4emmF+vzrCDd+ooA: bets $8
VvdR9F3I+2yELkfTVvC1dg: folds
qXDd0ZyMIse0OBu8pxeQ3Q: folds
zNjJ/y4emmF+vzrCDd+ooA collected $11.40 from pot
*** SUMMARY ***
Total pot $12 | Rake $0.60
Board [4h 2s Qh Ts]
Seat 1: JsqOjN/eHz0uYVf/PyUJ6Q folded before Flop (didn't bet)
Seat 2: VvdR9F3I+2yELkfTVvC1dg (button) folded on the Turn
Seat 3: qXDd0ZyMIse0OBu8pxeQ3Q (small blind) folded on the Turn
Seat 4: zNjJ/y4emmF+vzrCDd+ooA (big blind) collected ($11.40)
Seat 5: YsLQ3BAvgQHWXMAv3Wv6Hg folded before Flop (didn't bet)
Seat 6: /PH6Ffnho4Ysm8S3V/oa+w folded before Flop (didn't bet)



PokerStars Game #59941593318:  Hold'em No Limit ($1/$2) - 2009/07/01 1:40:09 ET
Table 'BSRfGh+QobUe0AgIMtt/fw' 9-max Seat #2 is the button
Seat 1: gDn/rYeNwCyWEgRhyWp4PA ($155.70 in chips)
Seat 2: +SmnXtdmwqXGEJfLeJDIUQ ($37 in chips)
Seat 3: WUlHm+ydPPHG7Lb0rePSdA ($120 in chips)
Seat 4: +T/63sAeZzWyHchahJ36GQ ($40 in chips)
Seat 5: GX1heJ+DSsvm7gzSPsYhhQ ($99.80 in chips)
Seat 6: H6Z4+qu8gR0VUiPOijndVg ($203 in chips)
Seat 7: CkE3IyJF1KvdaAOmZY5XqQ ($206.10 in chips)
Seat 8: /XRRUMKiOOItJFbrM26RrA ($85.30 in chips)
Seat 9: /inIs/z/PcX+TniIFpaxpg ($415.25 in chips)
WUlHm+ydPPHG7Lb0rePSdA: posts small blind $1
+T/63sAeZzWyHchahJ36GQ: posts big blind $2
*** HOLE CARDS ***
GX1heJ+DSsvm7gzSPsYhhQ: folds
GX1heJ+DSsvm7gzSPsYhhQ leaves the table
H6Z4+qu8gR0VUiPOijndVg: folds
CkE3IyJF1KvdaAOmZY5XqQ: folds
/XRRUMKiOOItJFbrM26RrA: folds
/inIs/z/PcX+TniIFpaxpg: folds
gDn/rYeNwCyWEgRhyWp4PA: folds
+SmnXtdmwqXGEJfLeJDIUQ: folds
v0q3vrz/d9oDjLrAG8Ausw joins the table at seat #5
WUlHm+ydPPHG7Lb0rePSdA: folds
+T/63sAeZzWyHchahJ36GQ collected $2 from pot
*** SUMMARY ***
Total pot $2 | Rake $0
Seat 1: gDn/rYeNwCyWEgRhyWp4PA folded before Flop (didn't bet)
Seat 2: +SmnXtdmwqXGEJfLeJDIUQ (button) folded before Flop (didn't bet)
Seat 3: WUlHm+ydPPHG7Lb0rePSdA (small blind) folded before Flop
Seat 4: +T/63sAeZzWyHchahJ36GQ (big blind) collected ($2)
Seat 5: GX1heJ+DSsvm7gzSPsYhhQ folded before Flop (didn't bet)
Seat 6: H6Z4+qu8gR0VUiPOijndVg folded before Flop (didn't bet)
Seat 7: CkE3IyJF1KvdaAOmZY5XqQ folded before Flop (didn't bet)
Seat 8: /XRRUMKiOOItJFbrM26RrA folded before Flop (didn't bet)
Seat 9: /inIs/z/PcX+TniIFpaxpg folded before Flop (didn't bet)



PokerStars Game #59941594642:  Hold'em No Limit ($1/$2) - 2009/07/01 1:40:11 ET
Table 'rKeCh+eBn4RNvybCUYkoTQ' 9-max Seat #2 is the button
Seat 1: /inIs/z/PcX+TniIFpaxpg ($195 in chips)
Seat 2: nXDI8Y/S6POzRwANu3d8hQ ($114 in chips)
Seat 3: GX1heJ+DSsvm7gzSPsYhhQ ($41 in chips)
Seat 5: WUlHm+ydPPHG7Lb0rePSdA ($122 in chips)
Seat 6: EBV6OktyeSmh4w6sWmcWOw ($286.80 in chips)
Seat 7: rW/MyplHylMSBRaoRUzWrg ($40 in chips)
Seat 8: pN/Ip0ePsUVIdUlGgLrkUw ($246.35 in chips)
Seat 9: Kzta8yu9vxHT4B70mjBZ+w ($200 in chips)
GX1heJ+DSsvm7gzSPsYhhQ: posts small blind $1
WUlHm+ydPPHG7Lb0rePSdA: posts big blind $2
*** HOLE CARDS ***
31HuO+DQxppUQEedBWukug has returned
EBV6OktyeSmh4w6sWmcWOw: folds
rW/MyplHylMSBRaoRUzWrg: folds
pN/Ip0ePsUVIdUlGgLrkUw: folds
Kzta8yu9vxHT4B70mjBZ+w: folds
/inIs/z/PcX+TniIFpaxpg: raises $4 to $6
nXDI8Y/S6POzRwANu3d8hQ: raises $10 to $16
GX1heJ+DSsvm7gzSPsYhhQ: folds
WUlHm+ydPPHG7Lb0rePSdA: folds
/inIs/z/PcX+TniIFpaxpg: calls $10
*** FLOP *** [4c 6d 5s]
/inIs/z/PcX+TniIFpaxpg: checks
nXDI8Y/S6POzRwANu3d8hQ: bets $18
/inIs/z/PcX+TniIFpaxpg: folds
nXDI8Y/S6POzRwANu3d8hQ collected $33.25 from pot
nXDI8Y/S6POzRwANu3d8hQ: doesn't show hand
*** SUMMARY ***
Total pot $35 | Rake $1.75
Board [4c 6d 5s]
Seat 1: /inIs/z/PcX+TniIFpaxpg folded on the Flop
Seat 2: nXDI8Y/S6POzRwANu3d8hQ (button) collected ($33.25)
Seat 3: GX1heJ+DSsvm7gzSPsYhhQ (small blind) folded before Flop
Seat 5: WUlHm+ydPPHG7Lb0rePSdA (big blind) folded before Flop
Seat 6: EBV6OktyeSmh4w6sWmcWOw folded before Flop (didn't bet)
Seat 7: rW/MyplHylMSBRaoRUzWrg folded before Flop (didn't bet)
Seat 8: pN/Ip0ePsUVIdUlGgLrkUw folded before Flop (didn't bet)
Seat 9: Kzta8yu9vxHT4B70mjBZ+w folded before Flop (didn't bet)



PokerStars Game #59941595358:  Hold'em No Limit ($1/$2) - 2009/07/01 1:40:13 ET
Table 'on4i1U1lCRmxsduFD3xiSg' 9-max Seat #8 is the button
Seat 1: so5k3vFDmokh2q3dImJ1GQ ($176.30 in chips)
Seat 2: NqSvZNzJ4RkR3sCmgQnyLw ($50.85 in chips)
Seat 3: GX1heJ+DSsvm7gzSPsYhhQ ($33 in chips)
Seat 4: DFQVuszLVclqjA46pN4Vvw ($93.80 in chips)
Seat 5: 37j/5DgMG5m9lMfFofEAOg ($54.70 in chips)
Seat 7: /inIs/z/PcX+TniIFpaxpg ($268.05 in chips)
Seat 8: ZYHoLw2lWmRS7CSHi8L8Xg ($200 in chips)
Seat 9: TAfo4veNRaRlzDXMMYS3Jg ($35 in chips)
TAfo4veNRaRlzDXMMYS3Jg: posts small blind $1
so5k3vFDmokh2q3dImJ1GQ: posts big blind $2
KqHysDSpCPaPyK3tJC1aEw: sits out
*** HOLE CARDS ***
NqSvZNzJ4RkR3sCmgQnyLw: folds
GX1heJ+DSsvm7gzSPsYhhQ: folds
DFQVuszLVclqjA46pN4Vvw: folds
37j/5DgMG5m9lMfFofEAOg: calls $2
/inIs/z/PcX+TniIFpaxpg: folds
ZYHoLw2lWmRS7CSHi8L8Xg: calls $2
TAfo4veNRaRlzDXMMYS3Jg: raises $33 to $35 and is all-in
so5k3vFDmokh2q3dImJ1GQ: folds
37j/5DgMG5m9lMfFofEAOg: calls $33
ZYHoLw2lWmRS7CSHi8L8Xg: folds
*** FLOP *** [9h Tc Ad]
*** TURN *** [9h Tc Ad] [7h]
*** RIVER *** [9h Tc Ad 7h] [Kc]
*** SHOW DOWN ***
TAfo4veNRaRlzDXMMYS3Jg: shows [8h 8c] (a pair of Eights)
37j/5DgMG5m9lMfFofEAOg: shows [9s Js] (a pair of Nines)
37j/5DgMG5m9lMfFofEAOg collected $71 from pot
*** SUMMARY ***
Total pot $74 | Rake $3
Board [9h Tc Ad 7h Kc]
Seat 1: so5k3vFDmokh2q3dImJ1GQ (big blind) folded before Flop
Seat 2: NqSvZNzJ4RkR3sCmgQnyLw folded before Flop (didn't bet)
Seat 3: GX1heJ+DSsvm7gzSPsYhhQ folded before Flop (didn't bet)
Seat 4: DFQVuszLVclqjA46pN4Vvw folded before Flop (didn't bet)
Seat 5: 37j/5DgMG5m9lMfFofEAOg showed [9s Js] and won ($71) with a pair of Nines
Seat 7: /inIs/z/PcX+TniIFpaxpg folded before Flop (didn't bet)
Seat 8: ZYHoLw2lWmRS7CSHi8L8Xg (button) folded before Flop
Seat 9: TAfo4veNRaRlzDXMMYS3Jg (small blind) showed [8h 8c] and lost with a pair of Eights



PokerStars Game #59941597700:  Hold'em No Limit ($1/$2) - 2009/07/01 1:40:17 ET
Table '4NGNnZ/osQfNq6abYqkJeA' 6-max Seat #6 is the button
Seat 2: 669iGNwYwgRZg3nhS+aDAQ ($109.90 in chips)
Seat 3: 54yWzRRgS0oZ+S6LwZBxMQ ($22.80 in chips)
Seat 4: sY+4Uuh5z/6AbXXaCS10jw ($233.25 in chips)
Seat 5: VvdR9F3I+2yELkfTVvC1dg ($238.55 in chips)
Seat 6: /PH6Ffnho4Ysm8S3V/oa+w ($40 in chips)
669iGNwYwgRZg3nhS+aDAQ: posts small blind $1
54yWzRRgS0oZ+S6LwZBxMQ: posts big blind $2
*** HOLE CARDS ***
sY+4Uuh5z/6AbXXaCS10jw: folds
VvdR9F3I+2yELkfTVvC1dg: folds
/PH6Ffnho4Ysm8S3V/oa+w: folds
669iGNwYwgRZg3nhS+aDAQ: calls $1
54yWzRRgS0oZ+S6LwZBxMQ: checks
*** FLOP *** [3s 9h 2s]
669iGNwYwgRZg3nhS+aDAQ: bets $4
54yWzRRgS0oZ+S6LwZBxMQ: folds
669iGNwYwgRZg3nhS+aDAQ collected $3.80 from pot
*** SUMMARY ***
Total pot $4 | Rake $0.20
Board [3s 9h 2s]
Seat 2: 669iGNwYwgRZg3nhS+aDAQ (small blind) collected ($3.80)
Seat 3: 54yWzRRgS0oZ+S6LwZBxMQ (big blind) folded on the Flop
Seat 4: sY+4Uuh5z/6AbXXaCS10jw folded before Flop (didn't bet)
Seat 5: VvdR9F3I+2yELkfTVvC1dg folded before Flop (didn't bet)
Seat 6: /PH6Ffnho4Ysm8S3V/oa+w (button) folded before Flop (didn't bet)



PokerStars Game #59941598052:  Hold'em No Limit ($1/$2) - 2009/07/01 1:40:18 ET
Table '8Y6PEyoNuepZTai2Q56aHw' 9-max Seat #2 is the button
Seat 1: 5Q8U6iZbeO7xJSS4qvDP5g ($408.80 in chips)
Seat 2: gDCJIAlovbPnTvMM7Dd1gA ($188.55 in chips)
Seat 3: WUlHm+ydPPHG7Lb0rePSdA ($212.10 in chips)
Seat 5: /inIs/z/PcX+TniIFpaxpg ($40 in chips)
Seat 6: NtLDBSjsJQEKekh5cdinvw ($373.35 in chips)
Seat 7: Kzta8yu9vxHT4B70mjBZ+w ($200 in chips)
Seat 9: F7m34OOfAQ7annesMHVjKw ($196.40 in chips)
WUlHm+ydPPHG7Lb0rePSdA: posts small blind $1
/inIs/z/PcX+TniIFpaxpg: posts big blind $2
+T/63sAeZzWyHchahJ36GQ: sits out
*** HOLE CARDS ***
NtLDBSjsJQEKekh5cdinvw: folds
Kzta8yu9vxHT4B70mjBZ+w: folds
F7m34OOfAQ7annesMHVjKw has timed out
F7m34OOfAQ7annesMHVjKw: folds
F7m34OOfAQ7annesMHVjKw is sitting out
5Q8U6iZbeO7xJSS4qvDP5g: folds
gDCJIAlovbPnTvMM7Dd1gA: folds
WUlHm+ydPPHG7Lb0rePSdA: folds
/inIs/z/PcX+TniIFpaxpg collected $2 from pot
/inIs/z/PcX+TniIFpaxpg: doesn't show hand
*** SUMMARY ***
Total pot $2 | Rake $0
Seat 1: 5Q8U6iZbeO7xJSS4qvDP5g folded before Flop (didn't bet)
Seat 2: gDCJIAlovbPnTvMM7Dd1gA (button) folded before Flop (didn't bet)
Seat 3: WUlHm+ydPPHG7Lb0rePSdA (small blind) folded before Flop
Seat 5: /inIs/z/PcX+TniIFpaxpg (big blind) collected ($2)
Seat 6: NtLDBSjsJQEKekh5cdinvw folded before Flop (didn't bet)
Seat 7: Kzta8yu9vxHT4B70mjBZ+w folded before Flop (didn't bet)
Seat 9: F7m34OOfAQ7annesMHVjKw folded before Flop (didn't bet)



PokerStars Game #59941598584:  Hold'em No Limit ($1/$2) - 2009/07/01 1:40:19 ET
Table 'ZzSIe0zTCDv+n6hfbY5tTg' 6-max Seat #3 is the button
Seat 1: VvdR9F3I+2yELkfTVvC1dg ($257 in chips)
Seat 2: B87ikIyZ/TzAVeXf38Ny0g ($234 in chips)
Seat 3: gsugPj31Hui3Jefl98MBOA ($355.25 in chips)
Seat 5: 3dAbvkxS5NPQTBAbvpinVg ($499.10 in chips)
Seat 6: 09BNF4quPDzanQzM8vc6WA ($39 in chips)
3dAbvkxS5NPQTBAbvpinVg: posts small blind $1
09BNF4quPDzanQzM8vc6WA: posts big blind $2
*** HOLE CARDS ***
VvdR9F3I+2yELkfTVvC1dg: folds
B87ikIyZ/TzAVeXf38Ny0g: raises $4 to $6
gsugPj31Hui3Jefl98MBOA: folds
3dAbvkxS5NPQTBAbvpinVg: folds
09BNF4quPDzanQzM8vc6WA: folds
B87ikIyZ/TzAVeXf38Ny0g collected $5 from pot
B87ikIyZ/TzAVeXf38Ny0g: doesn't show hand
*** SUMMARY ***
Total pot $5 | Rake $0
Seat 1: VvdR9F3I+2yELkfTVvC1dg folded before Flop (didn't bet)
Seat 2: B87ikIyZ/TzAVeXf38Ny0g collected ($5)
Seat 3: gsugPj31Hui3Jefl98MBOA (button) folded before Flop (didn't bet)
Seat 5: 3dAbvkxS5NPQTBAbvpinVg (small blind) folded before Flop
Seat 6: 09BNF4quPDzanQzM8vc6WA (big blind) folded before Flop



PokerStars Game #59941598978:  Hold'em No Limit ($1/$2) - 2009/07/01 1:40:19 ET
Table 'eyAQSIlgc2o1Jxvbve4WGg' 9-max Seat #1 is the button
Seat 1: UZEsV9yKUMqmpYPiOFpaZw ($94.20 in chips)
Seat 2: kM9CA+2UcdMjbCMbtUCGiA ($201 in chips)
Seat 4: CkE3IyJF1KvdaAOmZY5XqQ ($200 in chips)
Seat 5: mIKx5lhIt13X5eZQH0ZeMA ($131.40 in chips)
Seat 6: nXDI8Y/S6POzRwANu3d8hQ ($31 in chips)
Seat 7: u3OrI5uGx9mx1fE7dgr+EA ($80.50 in chips)
Seat 8: 1CtiZuXDFaJL1dJPQKyi8Q ($152.95 in chips)
Seat 9: WUlHm+ydPPHG7Lb0rePSdA ($143.20 in chips)
kM9CA+2UcdMjbCMbtUCGiA: posts small blind $1
CkE3IyJF1KvdaAOmZY5XqQ: posts big blind $2
*** HOLE CARDS ***
mIKx5lhIt13X5eZQH0ZeMA: folds
nXDI8Y/S6POzRwANu3d8hQ: raises $6 to $8
u3OrI5uGx9mx1fE7dgr+EA: calls $8
1CtiZuXDFaJL1dJPQKyi8Q: folds
WUlHm+ydPPHG7Lb0rePSdA: folds
UZEsV9yKUMqmpYPiOFpaZw: calls $8
kM9CA+2UcdMjbCMbtUCGiA: folds
CkE3IyJF1KvdaAOmZY5XqQ: folds
*** FLOP *** [5c Jc 4h]
nXDI8Y/S6POzRwANu3d8hQ: bets $16
u3OrI5uGx9mx1fE7dgr+EA: folds
UZEsV9yKUMqmpYPiOFpaZw: raises $70.20 to $86.20 and is all-in
nXDI8Y/S6POzRwANu3d8hQ: calls $7 and is all-in
*** TURN *** [5c Jc 4h] [Jh]
*** RIVER *** [5c Jc 4h Jh] [9s]
*** SHOW DOWN ***
nXDI8Y/S6POzRwANu3d8hQ: shows [Qs Qh] (two pair, Queens and Jacks)
UZEsV9yKUMqmpYPiOFpaZw: mucks hand
nXDI8Y/S6POzRwANu3d8hQ collected $70 from pot
*** SUMMARY ***
Total pot $73 | Rake $3
Board [5c Jc 4h Jh 9s]
Seat 1: UZEsV9yKUMqmpYPiOFpaZw (button) mucked
Seat 2: kM9CA+2UcdMjbCMbtUCGiA (small blind) folded before Flop
Seat 4: CkE3IyJF1KvdaAOmZY5XqQ (big blind) folded before Flop
Seat 5: mIKx5lhIt13X5eZQH0ZeMA folded before Flop (didn't bet)
Seat 6: nXDI8Y/S6POzRwANu3d8hQ showed [Qs Qh] and won ($70) with two pair, Queens and Jacks
Seat 7: u3OrI5uGx9mx1fE7dgr+EA folded on the Flop
Seat 8: 1CtiZuXDFaJL1dJPQKyi8Q folded before Flop (didn't bet)
Seat 9: WUlHm+ydPPHG7Lb0rePSdA folded before Flop (didn't bet)



PokerStars Game #59941599530:  Hold'em No Limit ($1/$2) - 2009/07/01 1:40:20 ET
Table 'bJQ024BaYSBrW0sXpCZbNQ' 6-max Seat #5 is the button
Seat 1: KfwW5us6tydK81NYTtK1gw ($200 in chips)
Seat 2: 3dAbvkxS5NPQTBAbvpinVg ($200 in chips)
Seat 3: /PH6Ffnho4Ysm8S3V/oa+w ($40 in chips)
Seat 4: TBaQIN+sQ7eb7P99QnaORQ ($72.15 in chips)
Seat 5: VvdR9F3I+2yELkfTVvC1dg ($200 in chips)
Seat 6: 4bqvCfJ0e8CTYnn0Go9hbQ ($147.20 in chips)
4bqvCfJ0e8CTYnn0Go9hbQ: posts small blind $1
KfwW5us6tydK81NYTtK1gw: posts big blind $2
*** HOLE CARDS ***
3dAbvkxS5NPQTBAbvpinVg: folds
/PH6Ffnho4Ysm8S3V/oa+w: folds
TBaQIN+sQ7eb7P99QnaORQ: folds
VvdR9F3I+2yELkfTVvC1dg: folds
4bqvCfJ0e8CTYnn0Go9hbQ: folds
KfwW5us6tydK81NYTtK1gw collected $2 from pot
KfwW5us6tydK81NYTtK1gw: doesn't show hand
*** SUMMARY ***
Total pot $2 | Rake $0
Seat 1: KfwW5us6tydK81NYTtK1gw (big blind) collected ($2)
Seat 2: 3dAbvkxS5NPQTBAbvpinVg folded before Flop (didn't bet)
Seat 3: /PH6Ffnho4Ysm8S3V/oa+w folded before Flop (didn't bet)
Seat 4: TBaQIN+sQ7eb7P99QnaORQ folded before Flop (didn't bet)
Seat 5: VvdR9F3I+2yELkfTVvC1dg (button) folded before Flop (didn't bet)
Seat 6: 4bqvCfJ0e8CTYnn0Go9hbQ (small blind) folded before Flop



PokerStars Game #59941599396:  Hold'em No Limit ($1/$2) - 2009/07/01 1:40:20 ET
Table 'CFkQcfWjKccZaZDf71FK+w' 6-max Seat #2 is the button
Seat 1: vkfxu8f/jMYKUk6Ly4eujw ($234.25 in chips)
Seat 2: ewN/vzF22+/gdzjIKBOlkA ($205.05 in chips)
Seat 3: 09BNF4quPDzanQzM8vc6WA ($41.65 in chips)
Seat 4: ygTTt5ehT4aF86q1a8/R+w ($246.35 in chips)
Seat 5: 2lOU1DcvUZaMcxZ95XfzXw ($184.35 in chips)
Seat 6: ORVqY3rf9X6ANA/8s+On2Q ($46.60 in chips)
09BNF4quPDzanQzM8vc6WA: posts small blind $1
ygTTt5ehT4aF86q1a8/R+w: posts big blind $2
*** HOLE CARDS ***
2lOU1DcvUZaMcxZ95XfzXw: calls $2
ORVqY3rf9X6ANA/8s+On2Q: folds
vkfxu8f/jMYKUk6Ly4eujw: folds
ewN/vzF22+/gdzjIKBOlkA: folds
09BNF4quPDzanQzM8vc6WA: folds
ygTTt5ehT4aF86q1a8/R+w: checks
*** FLOP *** [Jc 7s 8s]
ygTTt5ehT4aF86q1a8/R+w: checks
2lOU1DcvUZaMcxZ95XfzXw: checks
*** TURN *** [Jc 7s 8s] [4h]
ygTTt5ehT4aF86q1a8/R+w: checks
2lOU1DcvUZaMcxZ95XfzXw: checks
*** RIVER *** [Jc 7s 8s 4h] [Ks]
ygTTt5ehT4aF86q1a8/R+w: checks
2lOU1DcvUZaMcxZ95XfzXw: checks
*** SHOW DOWN ***
ygTTt5ehT4aF86q1a8/R+w: shows [Qd 3d] (high card King)
2lOU1DcvUZaMcxZ95XfzXw: shows [5h 4d] (a pair of Fours)
2lOU1DcvUZaMcxZ95XfzXw collected $4.75 from pot
*** SUMMARY ***
Total pot $5 | Rake $0.25
Board [Jc 7s 8s 4h Ks]
Seat 1: vkfxu8f/jMYKUk6Ly4eujw folded before Flop (didn't bet)
Seat 2: ewN/vzF22+/gdzjIKBOlkA (button) folded before Flop (didn't bet)
Seat 3: 09BNF4quPDzanQzM8vc6WA (small blind) folded before Flop
Seat 4: ygTTt5ehT4aF86q1a8/R+w (big blind) showed [Qd 3d] and lost with high card King
Seat 5: 2lOU1DcvUZaMcxZ95XfzXw showed [5h 4d] and won ($4.75) with a pair of Fours
Seat 6: ORVqY3rf9X6ANA/8s+On2Q folded before Flop (didn't bet)



PokerStars Game #59941599430:  Hold'em No Limit ($1/$2) - 2009/07/01 1:40:20 ET
Table 'NmY84NAf9Mh0ckAckHnh5g' 2-max Seat #2 is the button
Seat 1: 6hvg964TSqZ3AL/0XK9aVQ ($462.40 in chips)
Seat 2: RwDoM55ZeQuI2ADyJhOb2Q ($530.50 in chips)
RwDoM55ZeQuI2ADyJhOb2Q: posts small blind $1
6hvg964TSqZ3AL/0XK9aVQ: posts big blind $2
*** HOLE CARDS ***
RwDoM55ZeQuI2ADyJhOb2Q: raises $4 to $6
6hvg964TSqZ3AL/0XK9aVQ: calls $4
*** FLOP *** [8h Qh 2s]
6hvg964TSqZ3AL/0XK9aVQ: checks
RwDoM55ZeQuI2ADyJhOb2Q: checks
*** TURN *** [8h Qh 2s] [Th]
6hvg964TSqZ3AL/0XK9aVQ: checks
RwDoM55ZeQuI2ADyJhOb2Q: checks
*** RIVER *** [8h Qh 2s Th] [8s]
6hvg964TSqZ3AL/0XK9aVQ: bets $8
RwDoM55ZeQuI2ADyJhOb2Q: raises $14 to $22
6hvg964TSqZ3AL/0XK9aVQ: calls $14
*** SHOW DOWN ***
RwDoM55ZeQuI2ADyJhOb2Q: shows [8c 4c] (three of a kind, Eights)
6hvg964TSqZ3AL/0XK9aVQ: mucks hand
RwDoM55ZeQuI2ADyJhOb2Q collected $55.50 from pot
*** SUMMARY ***
Total pot $56 | Rake $0.50
Board [8h Qh 2s Th 8s]
Seat 1: 6hvg964TSqZ3AL/0XK9aVQ (big blind) mucked
Seat 2: RwDoM55ZeQuI2ADyJhOb2Q (button) (small blind) showed [8c 4c] and won ($55.50) with three of a kind, Eights



PokerStars Game #59941600454:  Hold'em No Limit ($1/$2) - 2009/07/01 1:40:22 ET
Table 'kq5zaQ+1hLNf8LZfGnbTAA' 6-max Seat #3 is the button
Seat 1: 8srN1dKQePlsv0GyTada+Q ($430.60 in chips)
Seat 2: nXDI8Y/S6POzRwANu3d8hQ ($139 in chips)
Seat 3: /PH6Ffnho4Ysm8S3V/oa+w ($49.15 in chips)
Seat 4: 3dAbvkxS5NPQTBAbvpinVg ($279.45 in chips)
Seat 5: gnYme0DNFflnMhrdbxe1Ag ($222.35 in chips)
Seat 6: mfy7uGZcqA2PVQqEVbJ7+g ($192.45 in chips)
3dAbvkxS5NPQTBAbvpinVg: posts small blind $1
gnYme0DNFflnMhrdbxe1Ag: posts big blind $2
*** HOLE CARDS ***
mfy7uGZcqA2PVQqEVbJ7+g: folds
8srN1dKQePlsv0GyTada+Q: folds
nXDI8Y/S6POzRwANu3d8hQ: folds
/PH6Ffnho4Ysm8S3V/oa+w: folds
3dAbvkxS5NPQTBAbvpinVg: folds
gnYme0DNFflnMhrdbxe1Ag collected $2 from pot
gnYme0DNFflnMhrdbxe1Ag: doesn't show hand
*** SUMMARY ***
Total pot $2 | Rake $0
Seat 1: 8srN1dKQePlsv0GyTada+Q folded before Flop (didn't bet)
Seat 2: nXDI8Y/S6POzRwANu3d8hQ folded before Flop (didn't bet)
Seat 3: /PH6Ffnho4Ysm8S3V/oa+w (button) folded before Flop (didn't bet)
Seat 4: 3dAbvkxS5NPQTBAbvpinVg (small blind) folded before Flop
Seat 5: gnYme0DNFflnMhrdbxe1Ag (big blind) collected ($2)
Seat 6: mfy7uGZcqA2PVQqEVbJ7+g folded before Flop (didn't bet)



PokerStars Game #59941601712:  Hold'em No Limit ($1/$2) - 2009/07/01 1:40:24 ET
Table 'YqGfR5eHfMeSjb9a+QU9rg' 9-max Seat #9 is the button
Seat 1: rW/MyplHylMSBRaoRUzWrg ($37 in chips)
Seat 2: nXDI8Y/S6POzRwANu3d8hQ ($40 in chips)
Seat 3: /gll27k+xWYV7Fbki0lFDQ ($258.75 in chips)
Seat 4: GX1heJ+DSsvm7gzSPsYhhQ ($34 in chips)
Seat 5: CkE3IyJF1KvdaAOmZY5XqQ ($201.75 in chips)
Seat 6: TAfo4veNRaRlzDXMMYS3Jg ($40 in chips)
Seat 7: 41aZuLBz9nAi2GPVKabmCw ($84.95 in chips)
Seat 8: JnV3SM2D6dAFYyGZHHpvrg ($102.15 in chips)
Seat 9: /inIs/z/PcX+TniIFpaxpg ($204.20 in chips)
rW/MyplHylMSBRaoRUzWrg: posts small blind $1
nXDI8Y/S6POzRwANu3d8hQ: posts big blind $2
*** HOLE CARDS ***
/gll27k+xWYV7Fbki0lFDQ: calls $2
GX1heJ+DSsvm7gzSPsYhhQ: folds
CkE3IyJF1KvdaAOmZY5XqQ: raises $6 to $8
TAfo4veNRaRlzDXMMYS3Jg: folds
41aZuLBz9nAi2GPVKabmCw: folds
JnV3SM2D6dAFYyGZHHpvrg: folds
/inIs/z/PcX+TniIFpaxpg: folds
rW/MyplHylMSBRaoRUzWrg: folds
nXDI8Y/S6POzRwANu3d8hQ: folds
/gll27k+xWYV7Fbki0lFDQ: calls $6
*** FLOP *** [Th Td 2c]
/gll27k+xWYV7Fbki0lFDQ: checks
CkE3IyJF1KvdaAOmZY5XqQ: bets $16
/gll27k+xWYV7Fbki0lFDQ: folds
CkE3IyJF1KvdaAOmZY5XqQ collected $18.05 from pot
*** SUMMARY ***
Total pot $19 | Rake $0.95
Board [Th Td 2c]
Seat 1: rW/MyplHylMSBRaoRUzWrg (small blind) folded before Flop
Seat 2: nXDI8Y/S6POzRwANu3d8hQ (big blind) folded before Flop
Seat 3: /gll27k+xWYV7Fbki0lFDQ folded on the Flop
Seat 4: GX1heJ+DSsvm7gzSPsYhhQ folded before Flop (didn't bet)
Seat 5: CkE3IyJF1KvdaAOmZY5XqQ collected ($18.05)
Seat 6: TAfo4veNRaRlzDXMMYS3Jg folded before Flop (didn't bet)
Seat 7: 41aZuLBz9nAi2GPVKabmCw folded before Flop (didn't bet)
Seat 8: JnV3SM2D6dAFYyGZHHpvrg folded before Flop (didn't bet)
Seat 9: /inIs/z/PcX+TniIFpaxpg (button) folded before Flop (didn't bet)



PokerStars Game #59941602102:  Hold'em No Limit ($1/$2) - 2009/07/01 1:40:25 ET
Table '/ci73fTmzTzmGWzAtqEX2Q' 9-max Seat #5 is the button
Seat 1: 9efVc1cB3yHt4TvBkTusPw ($145.90 in chips)
Seat 2: pN/Ip0ePsUVIdUlGgLrkUw ($225 in chips)
Seat 3: kK1+5ivyJZeA8hQF2pdvvQ ($61.55 in chips)
Seat 4: 2yq7Zp4xmrhAw8+37hTkaA ($161.20 in chips)
Seat 5: 1CtiZuXDFaJL1dJPQKyi8Q ($188.75 in chips)
Seat 6: KqHysDSpCPaPyK3tJC1aEw ($201 in chips)
Seat 7: +T/63sAeZzWyHchahJ36GQ ($40 in chips)
Seat 8: /inIs/z/PcX+TniIFpaxpg ($34 in chips)
Seat 9: S8aS+9FTYQ/ICLBNThcrkg ($177 in chips)
KqHysDSpCPaPyK3tJC1aEw: posts small blind $1
+T/63sAeZzWyHchahJ36GQ: posts big blind $2
*** HOLE CARDS ***
/inIs/z/PcX+TniIFpaxpg: folds
S8aS+9FTYQ/ICLBNThcrkg: folds
9efVc1cB3yHt4TvBkTusPw: folds
pN/Ip0ePsUVIdUlGgLrkUw: folds
kK1+5ivyJZeA8hQF2pdvvQ: folds
2yq7Zp4xmrhAw8+37hTkaA: folds
1CtiZuXDFaJL1dJPQKyi8Q: raises $4 to $6
KqHysDSpCPaPyK3tJC1aEw: folds
+T/63sAeZzWyHchahJ36GQ: folds
1CtiZuXDFaJL1dJPQKyi8Q collected $5 from pot
*** SUMMARY ***
Total pot $5 | Rake $0
Seat 1: 9efVc1cB3yHt4TvBkTusPw folded before Flop (didn't bet)
Seat 2: pN/Ip0ePsUVIdUlGgLrkUw folded before Flop (didn't bet)
Seat 3: kK1+5ivyJZeA8hQF2pdvvQ folded before Flop (didn't bet)
Seat 4: 2yq7Zp4xmrhAw8+37hTkaA folded before Flop (didn't bet)
Seat 5: 1CtiZuXDFaJL1dJPQKyi8Q (button) collected ($5)
Seat 6: KqHysDSpCPaPyK3tJC1aEw (small blind) folded before Flop
Seat 7: +T/63sAeZzWyHchahJ36GQ (big blind) folded before Flop
Seat 8: /inIs/z/PcX+TniIFpaxpg folded before Flop (didn't bet)
Seat 9: S8aS+9FTYQ/ICLBNThcrkg folded before Flop (didn't bet)



PokerStars Game #59941601934:  Hold'em No Limit ($1/$2) - 2009/07/01 1:40:25 ET
Table 'TsEDkiO4tzCTCzJ7tNdEqw' 6-max Seat #2 is the button
Seat 2: 4dcDwIHRm96PwtqkpQiuiA ($86.65 in chips)
Seat 3: ubtx4Z5L+AcK71MTvYiGVw ($291.05 in chips)
Seat 4: K8MXCrNAVYlMnnCeM32Kxw ($85.50 in chips)
Seat 5: VvdR9F3I+2yELkfTVvC1dg ($247.35 in chips)
Seat 6: uCqEjnxh2/vFBjKYkfTOkw ($179.30 in chips)
ubtx4Z5L+AcK71MTvYiGVw: posts small blind $1
K8MXCrNAVYlMnnCeM32Kxw: posts big blind $2
vkfxu8f/jMYKUk6Ly4eujw: sits out
*** HOLE CARDS ***
VvdR9F3I+2yELkfTVvC1dg: folds
uCqEjnxh2/vFBjKYkfTOkw: raises $6 to $8
4dcDwIHRm96PwtqkpQiuiA: folds
ubtx4Z5L+AcK71MTvYiGVw: calls $7
K8MXCrNAVYlMnnCeM32Kxw: raises $6 to $14
uCqEjnxh2/vFBjKYkfTOkw: calls $6
ubtx4Z5L+AcK71MTvYiGVw: calls $6
*** FLOP *** [8c 8s Td]
ubtx4Z5L+AcK71MTvYiGVw: checks
K8MXCrNAVYlMnnCeM32Kxw: bets $10
uCqEjnxh2/vFBjKYkfTOkw: calls $10
ubtx4Z5L+AcK71MTvYiGVw: calls $10
*** TURN *** [8c 8s Td] [2d]
ubtx4Z5L+AcK71MTvYiGVw: checks
K8MXCrNAVYlMnnCeM32Kxw: bets $30
uCqEjnxh2/vFBjKYkfTOkw: calls $30
ubtx4Z5L+AcK71MTvYiGVw: folds
*** RIVER *** [8c 8s Td 2d] [6h]
K8MXCrNAVYlMnnCeM32Kxw: bets $20
uCqEjnxh2/vFBjKYkfTOkw: raises $20 to $40
K8MXCrNAVYlMnnCeM32Kxw: calls $11.50 and is all-in
*** SHOW DOWN ***
uCqEjnxh2/vFBjKYkfTOkw: shows [8h Qs] (three of a kind, Eights)
K8MXCrNAVYlMnnCeM32Kxw: mucks hand
uCqEjnxh2/vFBjKYkfTOkw collected $193 from pot
*** SUMMARY ***
Total pot $195 | Rake $2
Board [8c 8s Td 2d 6h]
Seat 2: 4dcDwIHRm96PwtqkpQiuiA (button) folded before Flop (didn't bet)
Seat 3: ubtx4Z5L+AcK71MTvYiGVw (small blind) folded on the Turn
Seat 4: K8MXCrNAVYlMnnCeM32Kxw (big blind) mucked
Seat 5: VvdR9F3I+2yELkfTVvC1dg folded before Flop (didn't bet)
Seat 6: uCqEjnxh2/vFBjKYkfTOkw showed [8h Qs] and won ($193) with three of a kind, Eights



PokerStars Game #59941602330:  Hold'em No Limit ($1/$2) - 2009/07/01 1:40:25 ET
Table 'P/yCfYl1GfGsu/e6DxDy/A' 2-max Seat #1 is the button
Seat 1: 7fOCUy3x9hdkmXkkDNolGQ ($421.50 in chips)
Seat 2: RwDoM55ZeQuI2ADyJhOb2Q ($1056 in chips)
7fOCUy3x9hdkmXkkDNolGQ: posts small blind $1
RwDoM55ZeQuI2ADyJhOb2Q: posts big blind $2
*** HOLE CARDS ***
7fOCUy3x9hdkmXkkDNolGQ: raises $4 to $6
RwDoM55ZeQuI2ADyJhOb2Q: folds
7fOCUy3x9hdkmXkkDNolGQ collected $4 from pot
7fOCUy3x9hdkmXkkDNolGQ: doesn't show hand
*** SUMMARY ***
Total pot $4 | Rake $0
Seat 1: 7fOCUy3x9hdkmXkkDNolGQ (button) (small blind) collected ($4)
Seat 2: RwDoM55ZeQuI2ADyJhOb2Q (big blind) folded before Flop



PokerStars Game #59941604146:  Hold'em No Limit ($1/$2) - 2009/07/01 1:40:28 ET
Table '3WCXyaiCAbqSShQu7FIjvA' 9-max Seat #1 is the button
Seat 1: kTCkABD1UUldS9DFRGfCwQ ($150.75 in chips)
Seat 2: TAfo4veNRaRlzDXMMYS3Jg ($40.70 in chips)
Seat 3: 5Q8U6iZbeO7xJSS4qvDP5g ($276.85 in chips)
Seat 4: waEF/+pxZTxNo4FvsORuXg ($106.40 in chips)
Seat 5: CkE3IyJF1KvdaAOmZY5XqQ ($200 in chips)
Seat 6: 5jQlngvMSqM/WoonOcR5kw ($286.35 in chips)
Seat 7: nXDI8Y/S6POzRwANu3d8hQ ($37 in chips)
Seat 8: 1CtiZuXDFaJL1dJPQKyi8Q ($204.05 in chips)
TAfo4veNRaRlzDXMMYS3Jg: posts small blind $1
5Q8U6iZbeO7xJSS4qvDP5g: posts big blind $2
*** HOLE CARDS ***
waEF/+pxZTxNo4FvsORuXg: folds
CkE3IyJF1KvdaAOmZY5XqQ: folds
5jQlngvMSqM/WoonOcR5kw: calls $2
nXDI8Y/S6POzRwANu3d8hQ: folds
1CtiZuXDFaJL1dJPQKyi8Q: folds
kTCkABD1UUldS9DFRGfCwQ: folds
TAfo4veNRaRlzDXMMYS3Jg: folds
5Q8U6iZbeO7xJSS4qvDP5g: checks
*** FLOP *** [Kc 3s As]
FiXPLJyqb24l32QST2TInw has returned
5Q8U6iZbeO7xJSS4qvDP5g: bets $4
5jQlngvMSqM/WoonOcR5kw: calls $4
*** TURN *** [Kc 3s As] [Ks]
5Q8U6iZbeO7xJSS4qvDP5g: bets $12
5jQlngvMSqM/WoonOcR5kw: folds
5Q8U6iZbeO7xJSS4qvDP5g collected $12.40 from pot
5Q8U6iZbeO7xJSS4qvDP5g: doesn't show hand
*** SUMMARY ***
Total pot $13 | Rake $0.60
Board [Kc 3s As Ks]
Seat 1: kTCkABD1UUldS9DFRGfCwQ (button) folded before Flop (didn't bet)
Seat 2: TAfo4veNRaRlzDXMMYS3Jg (small blind) folded before Flop
Seat 3: 5Q8U6iZbeO7xJSS4qvDP5g (big blind) collected ($12.40)
Seat 4: waEF/+pxZTxNo4FvsORuXg folded before Flop (didn't bet)
Seat 5: CkE3IyJF1KvdaAOmZY5XqQ folded before Flop (didn't bet)
Seat 6: 5jQlngvMSqM/WoonOcR5kw folded on the Turn
Seat 7: nXDI8Y/S6POzRwANu3d8hQ folded before Flop (didn't bet)
Seat 8: 1CtiZuXDFaJL1dJPQKyi8Q folded before Flop (didn't bet)



PokerStars Game #59941604400:  Hold'em No Limit ($1/$2) - 2009/07/01 1:40:29 ET
Table 'qVXak+oTeDXMGbWa4sDU5Q' 9-max Seat #4 is the button
Seat 1: H6Z4+qu8gR0VUiPOijndVg ($230.45 in chips)
Seat 2: CST1bO+CmVQOtNgiT0cKPg ($74 in chips)
Seat 3: WUlHm+ydPPHG7Lb0rePSdA ($172.10 in chips)
Seat 4: lQYT23h5QCUVZAKxjOO39Q ($188.10 in chips)
Seat 5: zJtQ1gxyi72XvGYS1tM+DA ($98 in chips)
Seat 6: GX1heJ+DSsvm7gzSPsYhhQ ($43 in chips)
Seat 7: PfmlvZlFiss79a6IoEr11g ($168.30 in chips)
Seat 8: Z0rzUi0y1x80UdIpofoNbA ($109.55 in chips)
Seat 9: CkE3IyJF1KvdaAOmZY5XqQ ($215.55 in chips)
zJtQ1gxyi72XvGYS1tM+DA: posts small blind $1
GX1heJ+DSsvm7gzSPsYhhQ: posts big blind $2
*** HOLE CARDS ***
PfmlvZlFiss79a6IoEr11g: folds
Z0rzUi0y1x80UdIpofoNbA: folds
PfmlvZlFiss79a6IoEr11g leaves the table
CkE3IyJF1KvdaAOmZY5XqQ has timed out
CkE3IyJF1KvdaAOmZY5XqQ: folds
CkE3IyJF1KvdaAOmZY5XqQ is sitting out
H6Z4+qu8gR0VUiPOijndVg: folds
CkE3IyJF1KvdaAOmZY5XqQ has returned
CST1bO+CmVQOtNgiT0cKPg: raises $4 to $6
6oGEJqk9oDy29sSaLs+LGA joins the table at seat #7
WUlHm+ydPPHG7Lb0rePSdA: folds
lQYT23h5QCUVZAKxjOO39Q: folds
zJtQ1gxyi72XvGYS1tM+DA: folds
GX1heJ+DSsvm7gzSPsYhhQ: folds
CST1bO+CmVQOtNgiT0cKPg collected $5 from pot
*** SUMMARY ***
Total pot $5 | Rake $0
Seat 1: H6Z4+qu8gR0VUiPOijndVg folded before Flop (didn't bet)
Seat 2: CST1bO+CmVQOtNgiT0cKPg collected ($5)
Seat 3: WUlHm+ydPPHG7Lb0rePSdA folded before Flop (didn't bet)
Seat 4: lQYT23h5QCUVZAKxjOO39Q (button) folded before Flop (didn't bet)
Seat 5: zJtQ1gxyi72XvGYS1tM+DA (small blind) folded before Flop
Seat 6: GX1heJ+DSsvm7gzSPsYhhQ (big blind) folded before Flop
Seat 7: PfmlvZlFiss79a6IoEr11g folded before Flop (didn't bet)
Seat 8: Z0rzUi0y1x80UdIpofoNbA folded before Flop (didn't bet)
Seat 9: CkE3IyJF1KvdaAOmZY5XqQ folded before Flop (didn't bet)



PokerStars Game #59941606036:  Hold'em No Limit ($1/$2) - 2009/07/01 1:40:32 ET
Table 'LL4bDFyhj5hsMpzaDugJZg' 6-max Seat #3 is the button
Seat 2: IZng3w8jiJHHp3LbYKLi4w ($46.75 in chips)
Seat 3: iI/NMpRxMkGieArQEhACSA ($583.25 in chips)
Seat 4: 8srN1dKQePlsv0GyTada+Q ($201 in chips)
Seat 6: 692Q4sfB0gTElzS0WMeg+A ($205.35 in chips)
8srN1dKQePlsv0GyTada+Q: posts small blind $1
vkfxu8f/jMYKUk6Ly4eujw: is sitting out
692Q4sfB0gTElzS0WMeg+A: posts big blind $2
*** HOLE CARDS ***
vkfxu8f/jMYKUk6Ly4eujw leaves the table
IZng3w8jiJHHp3LbYKLi4w: raises $4 to $6
iI/NMpRxMkGieArQEhACSA: folds
8srN1dKQePlsv0GyTada+Q: folds
692Q4sfB0gTElzS0WMeg+A: calls $4
*** FLOP *** [8d Kd Ts]
692Q4sfB0gTElzS0WMeg+A: checks
IZng3w8jiJHHp3LbYKLi4w: bets $8
692Q4sfB0gTElzS0WMeg+A: raises $12 to $20
IZng3w8jiJHHp3LbYKLi4w: calls $12
*** TURN *** [8d Kd Ts] [8h]
692Q4sfB0gTElzS0WMeg+A: bets $66
IZng3w8jiJHHp3LbYKLi4w: calls $20.75 and is all-in
*** RIVER *** [8d Kd Ts 8h] [3d]
*** SHOW DOWN ***
692Q4sfB0gTElzS0WMeg+A: shows [Kc Tc] (two pair, Kings and Tens)
IZng3w8jiJHHp3LbYKLi4w: mucks hand
692Q4sfB0gTElzS0WMeg+A collected $92.50 from pot
*** SUMMARY ***
Total pot $94.50 | Rake $2
Board [8d Kd Ts 8h 3d]
Seat 2: IZng3w8jiJHHp3LbYKLi4w mucked
Seat 3: iI/NMpRxMkGieArQEhACSA (button) folded before Flop (didn't bet)
Seat 4: 8srN1dKQePlsv0GyTada+Q (small blind) folded before Flop
Seat 6: 692Q4sfB0gTElzS0WMeg+A (big blind) showed [Kc Tc] and won ($92.50) with two pair, Kings and Tens



PokerStars Game #59941606300:  Hold'em No Limit ($1/$2) - 2009/07/01 1:40:32 ET
Table 'AtOXMvcrtQM8yLNcALmfLQ' 2-max Seat #1 is the button
Seat 1: +HlQuAsMqZGYYtjcPO/a3A ($326 in chips)
Seat 2: pVqEzK9wXlRMECnb1Zg4Zw ($244 in chips)
+HlQuAsMqZGYYtjcPO/a3A: posts small blind $1
pVqEzK9wXlRMECnb1Zg4Zw: posts big blind $2
*** HOLE CARDS ***
+HlQuAsMqZGYYtjcPO/a3A: folds
pVqEzK9wXlRMECnb1Zg4Zw collected $2 from pot
pVqEzK9wXlRMECnb1Zg4Zw: doesn't show hand
*** SUMMARY ***
Total pot $2 | Rake $0
Seat 1: +HlQuAsMqZGYYtjcPO/a3A (button) (small blind) folded before Flop
Seat 2: pVqEzK9wXlRMECnb1Zg4Zw (big blind) collected ($2)



PokerStars Game #59941606822:  Hold'em No Limit ($1/$2) - 2009/07/01 1:40:33 ET
Table 'P/yCfYl1GfGsu/e6DxDy/A' 2-max Seat #2 is the button
Seat 1: 7fOCUy3x9hdkmXkkDNolGQ ($423.50 in chips)
Seat 2: RwDoM55ZeQuI2ADyJhOb2Q ($1054 in chips)
RwDoM55ZeQuI2ADyJhOb2Q: posts small blind $1
7fOCUy3x9hdkmXkkDNolGQ: posts big blind $2
*** HOLE CARDS ***
RwDoM55ZeQuI2ADyJhOb2Q: raises $4 to $6
7fOCUy3x9hdkmXkkDNolGQ: folds
RwDoM55ZeQuI2ADyJhOb2Q collected $4 from pot
RwDoM55ZeQuI2ADyJhOb2Q: doesn't show hand
*** SUMMARY ***
Total pot $4 | Rake $0
Seat 1: 7fOCUy3x9hdkmXkkDNolGQ (big blind) folded before Flop
Seat 2: RwDoM55ZeQuI2ADyJhOb2Q (button) (small blind) collected ($4)



PokerStars Game #59941607688:  Hold'em No Limit ($1/$2) - 2009/07/01 1:40:35 ET
Table 'jlrIxbrVIG+gjaUYT4za8g' 6-max Seat #1 is the button
Seat 1: ygTTt5ehT4aF86q1a8/R+w ($232.30 in chips)
Seat 2: /PH6Ffnho4Ysm8S3V/oa+w ($61 in chips)
Seat 3: gnYme0DNFflnMhrdbxe1Ag ($203 in chips)
Seat 4: 8srN1dKQePlsv0GyTada+Q ($266.95 in chips)
Seat 5: AyBB0k3Dcl7xbXUeGMw06g ($37.65 in chips)
/PH6Ffnho4Ysm8S3V/oa+w: posts small blind $1
gnYme0DNFflnMhrdbxe1Ag: posts big blind $2
BWhgxe7gWiYobRbwdG+d2Q: sits out
*** HOLE CARDS ***
8srN1dKQePlsv0GyTada+Q: folds
AyBB0k3Dcl7xbXUeGMw06g: calls $2
ygTTt5ehT4aF86q1a8/R+w: folds
/PH6Ffnho4Ysm8S3V/oa+w: folds
gnYme0DNFflnMhrdbxe1Ag: checks
*** FLOP *** [As Th Td]
gnYme0DNFflnMhrdbxe1Ag: checks
AyBB0k3Dcl7xbXUeGMw06g: checks
*** TURN *** [As Th Td] [5h]
gnYme0DNFflnMhrdbxe1Ag: checks
AyBB0k3Dcl7xbXUeGMw06g: checks
*** RIVER *** [As Th Td 5h] [6d]
gnYme0DNFflnMhrdbxe1Ag: checks
AyBB0k3Dcl7xbXUeGMw06g: bets $8
gnYme0DNFflnMhrdbxe1Ag: folds
AyBB0k3Dcl7xbXUeGMw06g collected $4.75 from pot
*** SUMMARY ***
Total pot $5 | Rake $0.25
Board [As Th Td 5h 6d]
Seat 1: ygTTt5ehT4aF86q1a8/R+w (button) folded before Flop (didn't bet)
Seat 2: /PH6Ffnho4Ysm8S3V/oa+w (small blind) folded before Flop
Seat 3: gnYme0DNFflnMhrdbxe1Ag (big blind) folded on the River
Seat 4: 8srN1dKQePlsv0GyTada+Q folded before Flop (didn't bet)
Seat 5: AyBB0k3Dcl7xbXUeGMw06g collected ($4.75)



PokerStars Game #59941608818:  Hold'em No Limit ($1/$2) - 2009/07/01 1:40:37 ET
Table 'mGpP9StWRnoeiBDExc6Frg' 6-max Seat #1 is the button
Seat 1: VvdR9F3I+2yELkfTVvC1dg ($309.15 in chips)
Seat 2: vkfxu8f/jMYKUk6Ly4eujw ($197 in chips)
Seat 3: 7acrZUQC3Zc9BNLjoKIcLQ ($30.85 in chips)
Seat 4: 4dcDwIHRm96PwtqkpQiuiA ($69.70 in chips)
Seat 5: d1puGuVBE0fidn+5eRJ0tw ($210.55 in chips)
Seat 6: B2Ih1sr5VZk+8He7rcrMtQ ($416.05 in chips)
vkfxu8f/jMYKUk6Ly4eujw: posts small blind $1
7acrZUQC3Zc9BNLjoKIcLQ: posts big blind $2
*** HOLE CARDS ***
4dcDwIHRm96PwtqkpQiuiA: folds
d1puGuVBE0fidn+5eRJ0tw: folds
B2Ih1sr5VZk+8He7rcrMtQ: folds
VvdR9F3I+2yELkfTVvC1dg: folds
vkfxu8f/jMYKUk6Ly4eujw: raises $6 to $8
7acrZUQC3Zc9BNLjoKIcLQ: folds
vkfxu8f/jMYKUk6Ly4eujw collected $4 from pot
vkfxu8f/jMYKUk6Ly4eujw: doesn't show hand
*** SUMMARY ***
Total pot $4 | Rake $0
Seat 1: VvdR9F3I+2yELkfTVvC1dg (button) folded before Flop (didn't bet)
Seat 2: vkfxu8f/jMYKUk6Ly4eujw (small blind) collected ($4)
Seat 3: 7acrZUQC3Zc9BNLjoKIcLQ (big blind) folded before Flop
Seat 4: 4dcDwIHRm96PwtqkpQiuiA folded before Flop (didn't bet)
Seat 5: d1puGuVBE0fidn+5eRJ0tw folded before Flop (didn't bet)
Seat 6: B2Ih1sr5VZk+8He7rcrMtQ folded before Flop (didn't bet)



PokerStars Game #59941610294:  Hold'em No Limit ($1/$2) - 2009/07/01 1:40:40 ET
Table 'G1Oqdy4Pqdb5gtx40rUBzA' 6-max Seat #6 is the button
Seat 3: VvdR9F3I+2yELkfTVvC1dg ($225.90 in chips)
Seat 4: B87ikIyZ/TzAVeXf38Ny0g ($205.55 in chips)
Seat 5: F1+Ml47qRQWunzPnGhLLzQ ($203.40 in chips)
Seat 6: qCnEYuAE5y5A7bk6fO5/jQ ($206 in chips)
VvdR9F3I+2yELkfTVvC1dg: posts small blind $1
B87ikIyZ/TzAVeXf38Ny0g: posts big blind $2
*** HOLE CARDS ***
F1+Ml47qRQWunzPnGhLLzQ: folds
qCnEYuAE5y5A7bk6fO5/jQ: folds
VvdR9F3I+2yELkfTVvC1dg: folds
B87ikIyZ/TzAVeXf38Ny0g collected $2 from pot
B87ikIyZ/TzAVeXf38Ny0g: doesn't show hand
*** SUMMARY ***
Total pot $2 | Rake $0
Seat 3: VvdR9F3I+2yELkfTVvC1dg (small blind) folded before Flop
Seat 4: B87ikIyZ/TzAVeXf38Ny0g (big blind) collected ($2)
Seat 5: F1+Ml47qRQWunzPnGhLLzQ folded before Flop (didn't bet)
Seat 6: qCnEYuAE5y5A7bk6fO5/jQ (button) folded before Flop (didn't bet)



PokerStars Game #59941610292:  Hold'em No Limit ($1/$2) - 2009/07/01 1:40:40 ET
Table 'AtOXMvcrtQM8yLNcALmfLQ' 2-max Seat #2 is the button
Seat 1: +HlQuAsMqZGYYtjcPO/a3A ($325 in chips)
Seat 2: pVqEzK9wXlRMECnb1Zg4Zw ($245 in chips)
pVqEzK9wXlRMECnb1Zg4Zw: posts small blind $1
+HlQuAsMqZGYYtjcPO/a3A: posts big blind $2
*** HOLE CARDS ***
pVqEzK9wXlRMECnb1Zg4Zw: raises $6 to $8
+HlQuAsMqZGYYtjcPO/a3A: folds
pVqEzK9wXlRMECnb1Zg4Zw collected $4 from pot
pVqEzK9wXlRMECnb1Zg4Zw: doesn't show hand
*** SUMMARY ***
Total pot $4 | Rake $0
Seat 1: +HlQuAsMqZGYYtjcPO/a3A (big blind) folded before Flop
Seat 2: pVqEzK9wXlRMECnb1Zg4Zw (button) (small blind) collected ($4)



PokerStars Game #59941611192:  Hold'em No Limit ($1/$2) - 2009/07/01 1:40:41 ET
Table 'P/yCfYl1GfGsu/e6DxDy/A' 2-max Seat #1 is the button
Seat 1: 7fOCUy3x9hdkmXkkDNolGQ ($421.50 in chips)
Seat 2: RwDoM55ZeQuI2ADyJhOb2Q ($1056 in chips)
7fOCUy3x9hdkmXkkDNolGQ: posts small blind $1
RwDoM55ZeQuI2ADyJhOb2Q: posts big blind $2
*** HOLE CARDS ***
7fOCUy3x9hdkmXkkDNolGQ: raises $4 to $6
RwDoM55ZeQuI2ADyJhOb2Q: calls $4
*** FLOP *** [7c Tc Qc]
RwDoM55ZeQuI2ADyJhOb2Q: checks
7fOCUy3x9hdkmXkkDNolGQ: bets $8
RwDoM55ZeQuI2ADyJhOb2Q: folds
7fOCUy3x9hdkmXkkDNolGQ collected $11.50 from pot
7fOCUy3x9hdkmXkkDNolGQ: doesn't show hand
*** SUMMARY ***
Total pot $12 | Rake $0.50
Board [7c Tc Qc]
Seat 1: 7fOCUy3x9hdkmXkkDNolGQ (button) (small blind) collected ($11.50)
Seat 2: RwDoM55ZeQuI2ADyJhOb2Q (big blind) folded on the Flop



PokerStars Game #59941610886:  Hold'em No Limit ($1/$2) - 2009/07/01 1:40:41 ET
Table 'bJQ024BaYSBrW0sXpCZbNQ' 6-max Seat #6 is the button
Seat 1: KfwW5us6tydK81NYTtK1gw ($201 in chips)
Seat 2: 3dAbvkxS5NPQTBAbvpinVg ($200 in chips)
Seat 3: /PH6Ffnho4Ysm8S3V/oa+w ($40 in chips)
Seat 4: TBaQIN+sQ7eb7P99QnaORQ ($72.15 in chips)
Seat 5: VvdR9F3I+2yELkfTVvC1dg ($200 in chips)
Seat 6: 4bqvCfJ0e8CTYnn0Go9hbQ ($146.20 in chips)
KfwW5us6tydK81NYTtK1gw: posts small blind $1
3dAbvkxS5NPQTBAbvpinVg: posts big blind $2
*** HOLE CARDS ***
/PH6Ffnho4Ysm8S3V/oa+w: folds
TBaQIN+sQ7eb7P99QnaORQ: raises $10 to $12
VvdR9F3I+2yELkfTVvC1dg: calls $12
4bqvCfJ0e8CTYnn0Go9hbQ: folds
KfwW5us6tydK81NYTtK1gw: folds
3dAbvkxS5NPQTBAbvpinVg: folds
*** FLOP *** [4h 8h 5h]
TBaQIN+sQ7eb7P99QnaORQ: bets $60.15 and is all-in
VvdR9F3I+2yELkfTVvC1dg: folds
TBaQIN+sQ7eb7P99QnaORQ collected $25.65 from pot
*** SUMMARY ***
Total pot $27 | Rake $1.35
Board [4h 8h 5h]
Seat 1: KfwW5us6tydK81NYTtK1gw (small blind) folded before Flop
Seat 2: 3dAbvkxS5NPQTBAbvpinVg (big blind) folded before Flop
Seat 3: /PH6Ffnho4Ysm8S3V/oa+w folded before Flop (didn't bet)
Seat 4: TBaQIN+sQ7eb7P99QnaORQ collected ($25.65)
Seat 5: VvdR9F3I+2yELkfTVvC1dg folded on the Flop
Seat 6: 4bqvCfJ0e8CTYnn0Go9hbQ (button) folded before Flop (didn't bet)



PokerStars Game #59941612888:  Hold'em No Limit ($1/$2) - 2009/07/01 1:40:44 ET
Table 'zEOkwFUmNLBlvazOXtwH8w' 2-max Seat #2 is the button
Seat 1: gu6Ee9WAefYH8BG9//A1pw ($120 in chips)
Seat 2: SLKKhEamo9/21wMiSyGsQw ($40 in chips)
SLKKhEamo9/21wMiSyGsQw: posts small blind $1
gu6Ee9WAefYH8BG9//A1pw: posts big blind $2
*** HOLE CARDS ***
SLKKhEamo9/21wMiSyGsQw: raises $18 to $20
gu6Ee9WAefYH8BG9//A1pw: calls $18
*** FLOP *** [7s 6s 9c]
gu6Ee9WAefYH8BG9//A1pw: bets $16
SLKKhEamo9/21wMiSyGsQw: raises $4 to $20 and is all-in
gu6Ee9WAefYH8BG9//A1pw: folds
SLKKhEamo9/21wMiSyGsQw collected $71.50 from pot
SLKKhEamo9/21wMiSyGsQw: doesn't show hand
*** SUMMARY ***
Total pot $72 | Rake $0.50
Board [7s 6s 9c]
Seat 1: gu6Ee9WAefYH8BG9//A1pw (big blind) folded on the Flop
Seat 2: SLKKhEamo9/21wMiSyGsQw (button) (small blind) collected ($71.50)



PokerStars Game #59941612776:  Hold'em No Limit ($1/$2) - 2009/07/01 1:40:44 ET
Table 'NmY84NAf9Mh0ckAckHnh5g' 2-max Seat #1 is the button
Seat 1: 6hvg964TSqZ3AL/0XK9aVQ ($434.40 in chips)
Seat 2: RwDoM55ZeQuI2ADyJhOb2Q ($558 in chips)
6hvg964TSqZ3AL/0XK9aVQ: posts small blind $1
RwDoM55ZeQuI2ADyJhOb2Q: posts big blind $2
*** HOLE CARDS ***
6hvg964TSqZ3AL/0XK9aVQ: calls $1
RwDoM55ZeQuI2ADyJhOb2Q: checks
*** FLOP *** [2d 2c 2h]
RwDoM55ZeQuI2ADyJhOb2Q: checks
6hvg964TSqZ3AL/0XK9aVQ: checks
*** TURN *** [2d 2c 2h] [Jh]
RwDoM55ZeQuI2ADyJhOb2Q: checks
6hvg964TSqZ3AL/0XK9aVQ: checks
*** RIVER *** [2d 2c 2h Jh] [6h]
RwDoM55ZeQuI2ADyJhOb2Q: checks
6hvg964TSqZ3AL/0XK9aVQ: bets $2
RwDoM55ZeQuI2ADyJhOb2Q: folds
6hvg964TSqZ3AL/0XK9aVQ collected $3.80 from pot
6hvg964TSqZ3AL/0XK9aVQ: doesn't show hand
*** SUMMARY ***
Total pot $4 | Rake $0.20
Board [2d 2c 2h Jh 6h]
Seat 1: 6hvg964TSqZ3AL/0XK9aVQ (button) (small blind) collected ($3.80)
Seat 2: RwDoM55ZeQuI2ADyJhOb2Q (big blind) folded on the River



PokerStars Game #59941614954:  Hold'em No Limit ($1/$2) - 2009/07/01 1:40:48 ET
Table 'G1Oqdy4Pqdb5gtx40rUBzA' 6-max Seat #3 is the button
Seat 3: VvdR9F3I+2yELkfTVvC1dg ($224.90 in chips)
Seat 4: B87ikIyZ/TzAVeXf38Ny0g ($206.55 in chips)
Seat 5: F1+Ml47qRQWunzPnGhLLzQ ($203.40 in chips)
Seat 6: qCnEYuAE5y5A7bk6fO5/jQ ($206 in chips)
B87ikIyZ/TzAVeXf38Ny0g: posts small blind $1
F1+Ml47qRQWunzPnGhLLzQ: posts big blind $2
*** HOLE CARDS ***
qCnEYuAE5y5A7bk6fO5/jQ: raises $4 to $6
VvdR9F3I+2yELkfTVvC1dg: calls $6
B87ikIyZ/TzAVeXf38Ny0g: folds
F1+Ml47qRQWunzPnGhLLzQ: folds
*** FLOP *** [Ks Qc Kh]
BWhgxe7gWiYobRbwdG+d2Q joins the table at seat #1
qCnEYuAE5y5A7bk6fO5/jQ: bets $10
VvdR9F3I+2yELkfTVvC1dg: folds
qCnEYuAE5y5A7bk6fO5/jQ collected $14.25 from pot
qCnEYuAE5y5A7bk6fO5/jQ: doesn't show hand
*** SUMMARY ***
Total pot $15 | Rake $0.75
Board [Ks Qc Kh]
Seat 3: VvdR9F3I+2yELkfTVvC1dg (button) folded on the Flop
Seat 4: B87ikIyZ/TzAVeXf38Ny0g (small blind) folded before Flop
Seat 5: F1+Ml47qRQWunzPnGhLLzQ (big blind) folded before Flop
Seat 6: qCnEYuAE5y5A7bk6fO5/jQ collected ($14.25)



PokerStars Game #59941615308:  Hold'em No Limit ($1/$2) - 2009/07/01 1:40:48 ET
Table 'gnHBqWll9O3fxG7Ojkz/ng' 9-max Seat #8 is the button
Seat 1: TAfo4veNRaRlzDXMMYS3Jg ($31 in chips)
Seat 2: H6Z4+qu8gR0VUiPOijndVg ($331.95 in chips)
Seat 3: 5Q8U6iZbeO7xJSS4qvDP5g ($218.05 in chips)
Seat 4: nXDI8Y/S6POzRwANu3d8hQ ($19 in chips)
Seat 5: rBQDMkKm9cZn6M9NPsiVew ($222.15 in chips)
Seat 6: KqHysDSpCPaPyK3tJC1aEw ($200 in chips)
Seat 7: jqui3xAWCkcdPW36a6BD+w ($342.55 in chips)
Seat 8: cM6efHzdxoqYm0EQKP4TTQ ($114.20 in chips)
Seat 9: GX1heJ+DSsvm7gzSPsYhhQ ($46.35 in chips)
GX1heJ+DSsvm7gzSPsYhhQ: posts small blind $1
TAfo4veNRaRlzDXMMYS3Jg: posts big blind $2
*** HOLE CARDS ***
H6Z4+qu8gR0VUiPOijndVg: folds
5Q8U6iZbeO7xJSS4qvDP5g: folds
nXDI8Y/S6POzRwANu3d8hQ: folds
rBQDMkKm9cZn6M9NPsiVew: calls $2
KqHysDSpCPaPyK3tJC1aEw: folds
jqui3xAWCkcdPW36a6BD+w: folds
cM6efHzdxoqYm0EQKP4TTQ: folds
GX1heJ+DSsvm7gzSPsYhhQ: folds
TAfo4veNRaRlzDXMMYS3Jg: raises $29 to $31 and is all-in
rBQDMkKm9cZn6M9NPsiVew: folds
TAfo4veNRaRlzDXMMYS3Jg collected $5 from pot
TAfo4veNRaRlzDXMMYS3Jg: doesn't show hand
*** SUMMARY ***
Total pot $5 | Rake $0
Seat 1: TAfo4veNRaRlzDXMMYS3Jg (big blind) collected ($5)
Seat 2: H6Z4+qu8gR0VUiPOijndVg folded before Flop (didn't bet)
Seat 3: 5Q8U6iZbeO7xJSS4qvDP5g folded before Flop (didn't bet)
Seat 4: nXDI8Y/S6POzRwANu3d8hQ folded before Flop (didn't bet)
Seat 5: rBQDMkKm9cZn6M9NPsiVew folded before Flop
Seat 6: KqHysDSpCPaPyK3tJC1aEw folded before Flop (didn't bet)
Seat 7: jqui3xAWCkcdPW36a6BD+w folded before Flop (didn't bet)
Seat 8: cM6efHzdxoqYm0EQKP4TTQ (button) folded before Flop (didn't bet)
Seat 9: GX1heJ+DSsvm7gzSPsYhhQ (small blind) folded before Flop



PokerStars Game #59941615026:  Hold'em No Limit ($1/$2) - 2009/07/01 1:40:48 ET
Table 'ZzSIe0zTCDv+n6hfbY5tTg' 6-max Seat #5 is the button
Seat 1: VvdR9F3I+2yELkfTVvC1dg ($257 in chips)
Seat 2: B87ikIyZ/TzAVeXf38Ny0g ($237 in chips)
Seat 3: gsugPj31Hui3Jefl98MBOA ($355.25 in chips)
Seat 5: 3dAbvkxS5NPQTBAbvpinVg ($498.10 in chips)
Seat 6: 09BNF4quPDzanQzM8vc6WA ($37 in chips)
09BNF4quPDzanQzM8vc6WA: posts small blind $1
VvdR9F3I+2yELkfTVvC1dg: posts big blind $2
*** HOLE CARDS ***
B87ikIyZ/TzAVeXf38Ny0g: folds
gsugPj31Hui3Jefl98MBOA: calls $2
qXDd0ZyMIse0OBu8pxeQ3Q leaves the table
3dAbvkxS5NPQTBAbvpinVg: folds
09BNF4quPDzanQzM8vc6WA: folds
VvdR9F3I+2yELkfTVvC1dg: checks
*** FLOP *** [Ks 7s 6h]
VvdR9F3I+2yELkfTVvC1dg: checks
54yWzRRgS0oZ+S6LwZBxMQ joins the table at seat #4
gsugPj31Hui3Jefl98MBOA: bets $4
VvdR9F3I+2yELkfTVvC1dg: folds
gsugPj31Hui3Jefl98MBOA collected $4.75 from pot
*** SUMMARY ***
Total pot $5 | Rake $0.25
Board [Ks 7s 6h]
Seat 1: VvdR9F3I+2yELkfTVvC1dg (big blind) folded on the Flop
Seat 2: B87ikIyZ/TzAVeXf38Ny0g folded before Flop (didn't bet)
Seat 3: gsugPj31Hui3Jefl98MBOA collected ($4.75)
Seat 5: 3dAbvkxS5NPQTBAbvpinVg (button) folded before Flop (didn't bet)
Seat 6: 09BNF4quPDzanQzM8vc6WA (small blind) folded before Flop



PokerStars Game #59941616012:  Hold'em No Limit ($1/$2) - 2009/07/01 1:40:50 ET
Table 'BSRfGh+QobUe0AgIMtt/fw' 9-max Seat #3 is the button
Seat 1: gDn/rYeNwCyWEgRhyWp4PA ($155.70 in chips)
Seat 2: +SmnXtdmwqXGEJfLeJDIUQ ($37 in chips)
Seat 3: WUlHm+ydPPHG7Lb0rePSdA ($120 in chips)
Seat 4: +T/63sAeZzWyHchahJ36GQ ($41 in chips)
Seat 5: v0q3vrz/d9oDjLrAG8Ausw ($200 in chips)
Seat 6: H6Z4+qu8gR0VUiPOijndVg ($203 in chips)
Seat 7: CkE3IyJF1KvdaAOmZY5XqQ ($206.10 in chips)
Seat 8: /XRRUMKiOOItJFbrM26RrA ($85.30 in chips)
Seat 9: /inIs/z/PcX+TniIFpaxpg ($415.25 in chips)
+T/63sAeZzWyHchahJ36GQ: posts small blind $1
v0q3vrz/d9oDjLrAG8Ausw: posts big blind $2
*** HOLE CARDS ***
H6Z4+qu8gR0VUiPOijndVg: folds
CkE3IyJF1KvdaAOmZY5XqQ: folds
/XRRUMKiOOItJFbrM26RrA: calls $2
/inIs/z/PcX+TniIFpaxpg: folds
gDn/rYeNwCyWEgRhyWp4PA: folds
+SmnXtdmwqXGEJfLeJDIUQ: folds
WUlHm+ydPPHG7Lb0rePSdA: folds
+T/63sAeZzWyHchahJ36GQ: folds
v0q3vrz/d9oDjLrAG8Ausw: checks
*** FLOP *** [3d 3h Qc]
v0q3vrz/d9oDjLrAG8Ausw: checks
/XRRUMKiOOItJFbrM26RrA: checks
*** TURN *** [3d 3h Qc] [6d]
v0q3vrz/d9oDjLrAG8Ausw: bets $4
/XRRUMKiOOItJFbrM26RrA: folds
v0q3vrz/d9oDjLrAG8Ausw collected $4.75 from pot
*** SUMMARY ***
Total pot $5 | Rake $0.25
Board [3d 3h Qc 6d]
Seat 1: gDn/rYeNwCyWEgRhyWp4PA folded before Flop (didn't bet)
Seat 2: +SmnXtdmwqXGEJfLeJDIUQ folded before Flop (didn't bet)
Seat 3: WUlHm+ydPPHG7Lb0rePSdA (button) folded before Flop (didn't bet)
Seat 4: +T/63sAeZzWyHchahJ36GQ (small blind) folded before Flop
Seat 5: v0q3vrz/d9oDjLrAG8Ausw (big blind) collected ($4.75)
Seat 6: H6Z4+qu8gR0VUiPOijndVg folded before Flop (didn't bet)
Seat 7: CkE3IyJF1KvdaAOmZY5XqQ folded before Flop (didn't bet)
Seat 8: /XRRUMKiOOItJFbrM26RrA folded on the Turn
Seat 9: /inIs/z/PcX+TniIFpaxpg folded before Flop (didn't bet)



PokerStars Game #59941615982:  Hold'em No Limit ($1/$2) - 2009/07/01 1:40:50 ET
Table 'kq5zaQ+1hLNf8LZfGnbTAA' 6-max Seat #4 is the button
Seat 1: 8srN1dKQePlsv0GyTada+Q ($430.60 in chips)
Seat 2: nXDI8Y/S6POzRwANu3d8hQ ($139 in chips)
Seat 3: /PH6Ffnho4Ysm8S3V/oa+w ($49.15 in chips)
Seat 4: 3dAbvkxS5NPQTBAbvpinVg ($278.45 in chips)
Seat 5: gnYme0DNFflnMhrdbxe1Ag ($223.35 in chips)
Seat 6: mfy7uGZcqA2PVQqEVbJ7+g ($192.45 in chips)
gnYme0DNFflnMhrdbxe1Ag: posts small blind $1
mfy7uGZcqA2PVQqEVbJ7+g: posts big blind $2
*** HOLE CARDS ***
8srN1dKQePlsv0GyTada+Q: raises $4 to $6
nXDI8Y/S6POzRwANu3d8hQ: folds
/PH6Ffnho4Ysm8S3V/oa+w: folds
3dAbvkxS5NPQTBAbvpinVg: folds
gnYme0DNFflnMhrdbxe1Ag: folds
mfy7uGZcqA2PVQqEVbJ7+g: calls $4
*** FLOP *** [5s Ah Jc]
mfy7uGZcqA2PVQqEVbJ7+g: checks
8srN1dKQePlsv0GyTada+Q: checks
*** TURN *** [5s Ah Jc] [8s]
mfy7uGZcqA2PVQqEVbJ7+g: bets $7
8srN1dKQePlsv0GyTada+Q: calls $7
*** RIVER *** [5s Ah Jc 8s] [2c]
mfy7uGZcqA2PVQqEVbJ7+g: checks
8srN1dKQePlsv0GyTada+Q: checks
*** SHOW DOWN ***
mfy7uGZcqA2PVQqEVbJ7+g: shows [Ts As] (a pair of Aces)
8srN1dKQePlsv0GyTada+Q: mucks hand
mfy7uGZcqA2PVQqEVbJ7+g collected $25.70 from pot
*** SUMMARY ***
Total pot $27 | Rake $1.30
Board [5s Ah Jc 8s 2c]
Seat 1: 8srN1dKQePlsv0GyTada+Q mucked
Seat 2: nXDI8Y/S6POzRwANu3d8hQ folded before Flop (didn't bet)
Seat 3: /PH6Ffnho4Ysm8S3V/oa+w folded before Flop (didn't bet)
Seat 4: 3dAbvkxS5NPQTBAbvpinVg (button) folded before Flop (didn't bet)
Seat 5: gnYme0DNFflnMhrdbxe1Ag (small blind) folded before Flop
Seat 6: mfy7uGZcqA2PVQqEVbJ7+g (big blind) showed [Ts As] and won ($25.70) with a pair of Aces



PokerStars Game #59941616076:  Hold'em No Limit ($1/$2) - 2009/07/01 1:40:50 ET
Table '/dyk+YdRGv90j2box35j8w' 6-max Seat #3 is the button
Seat 1: 8srN1dKQePlsv0GyTada+Q ($212.25 in chips)
Seat 2: qCnEYuAE5y5A7bk6fO5/jQ ($484.20 in chips)
Seat 3: sTPOWERd9HWPCNrDBwsVjA ($179.50 in chips)
Seat 4: z/u1YTnkiIDrtp/2cA2dBg ($151.85 in chips)
Seat 5: VvdR9F3I+2yELkfTVvC1dg ($252 in chips)
Seat 6: gnYme0DNFflnMhrdbxe1Ag ($200 in chips)
z/u1YTnkiIDrtp/2cA2dBg: posts small blind $1
VvdR9F3I+2yELkfTVvC1dg: posts big blind $2
*** HOLE CARDS ***
gnYme0DNFflnMhrdbxe1Ag: folds
8srN1dKQePlsv0GyTada+Q: raises $4 to $6
qCnEYuAE5y5A7bk6fO5/jQ: folds
sTPOWERd9HWPCNrDBwsVjA: calls $6
z/u1YTnkiIDrtp/2cA2dBg: folds
VvdR9F3I+2yELkfTVvC1dg: folds
*** FLOP *** [Kd 6c 4s]
8srN1dKQePlsv0GyTada+Q: bets $8
sTPOWERd9HWPCNrDBwsVjA: calls $8
*** TURN *** [Kd 6c 4s] [Qd]
8srN1dKQePlsv0GyTada+Q: bets $16
sTPOWERd9HWPCNrDBwsVjA: calls $16
*** RIVER *** [Kd 6c 4s Qd] [2c]
z/u1YTnkiIDrtp/2cA2dBg leaves the table
8srN1dKQePlsv0GyTada+Q: checks
sTPOWERd9HWPCNrDBwsVjA: checks
*** SHOW DOWN ***
8srN1dKQePlsv0GyTada+Q: shows [7s 5s] (high card King)
sTPOWERd9HWPCNrDBwsVjA: shows [Th Ts] (a pair of Tens)
sTPOWERd9HWPCNrDBwsVjA collected $60 from pot
*** SUMMARY ***
Total pot $63 | Rake $3
Board [Kd 6c 4s Qd 2c]
Seat 1: 8srN1dKQePlsv0GyTada+Q showed [7s 5s] and lost with high card King
Seat 2: qCnEYuAE5y5A7bk6fO5/jQ folded before Flop (didn't bet)
Seat 3: sTPOWERd9HWPCNrDBwsVjA (button) showed [Th Ts] and won ($60) with a pair of Tens
Seat 4: z/u1YTnkiIDrtp/2cA2dBg (small blind) folded before Flop
Seat 5: VvdR9F3I+2yELkfTVvC1dg (big blind) folded before Flop
Seat 6: gnYme0DNFflnMhrdbxe1Ag folded before Flop (didn't bet)



PokerStars Game #59941618250:  Hold'em No Limit ($1/$2) - 2009/07/01 1:40:54 ET
Table 'AtOXMvcrtQM8yLNcALmfLQ' 2-max Seat #1 is the button
Seat 1: +HlQuAsMqZGYYtjcPO/a3A ($323 in chips)
Seat 2: pVqEzK9wXlRMECnb1Zg4Zw ($247 in chips)
+HlQuAsMqZGYYtjcPO/a3A: posts small blind $1
pVqEzK9wXlRMECnb1Zg4Zw: posts big blind $2
*** HOLE CARDS ***
+HlQuAsMqZGYYtjcPO/a3A: calls $1
pVqEzK9wXlRMECnb1Zg4Zw: raises $8 to $10
+HlQuAsMqZGYYtjcPO/a3A: calls $8
*** FLOP *** [Qs 3c 2d]
pVqEzK9wXlRMECnb1Zg4Zw: bets $16
+HlQuAsMqZGYYtjcPO/a3A: folds
pVqEzK9wXlRMECnb1Zg4Zw collected $19.50 from pot
pVqEzK9wXlRMECnb1Zg4Zw: doesn't show hand
*** SUMMARY ***
Total pot $20 | Rake $0.50
Board [Qs 3c 2d]
Seat 1: +HlQuAsMqZGYYtjcPO/a3A (button) (small blind) folded on the Flop
Seat 2: pVqEzK9wXlRMECnb1Zg4Zw (big blind) collected ($19.50)



PokerStars Game #59941619642:  Hold'em No Limit ($1/$2) - 2009/07/01 1:40:56 ET
Table 'UGLAZZyv+cXmnKjYin0etA' 6-max Seat #2 is the button
Seat 1: vkfxu8f/jMYKUk6Ly4eujw ($203 in chips)
Seat 2: eDLH1PUXFpvJBNMXBVQcGA ($310.10 in chips)
Seat 3: ygTTt5ehT4aF86q1a8/R+w ($112.20 in chips)
Seat 4: SiGJDsvRViJX05vHhA80GQ ($234.85 in chips)
Seat 5: 54yWzRRgS0oZ+S6LwZBxMQ ($31 in chips)
Seat 6: sTPOWERd9HWPCNrDBwsVjA ($218.15 in chips)
ygTTt5ehT4aF86q1a8/R+w: posts small blind $1
SiGJDsvRViJX05vHhA80GQ: posts big blind $2
*** HOLE CARDS ***
54yWzRRgS0oZ+S6LwZBxMQ: calls $2
sTPOWERd9HWPCNrDBwsVjA: folds
vkfxu8f/jMYKUk6Ly4eujw: folds
eDLH1PUXFpvJBNMXBVQcGA: folds
ygTTt5ehT4aF86q1a8/R+w: folds
SiGJDsvRViJX05vHhA80GQ: checks
*** FLOP *** [5s Ah Td]
SiGJDsvRViJX05vHhA80GQ: checks
54yWzRRgS0oZ+S6LwZBxMQ: bets $4
SiGJDsvRViJX05vHhA80GQ: folds
54yWzRRgS0oZ+S6LwZBxMQ collected $4.75 from pot
*** SUMMARY ***
Total pot $5 | Rake $0.25
Board [5s Ah Td]
Seat 1: vkfxu8f/jMYKUk6Ly4eujw folded before Flop (didn't bet)
Seat 2: eDLH1PUXFpvJBNMXBVQcGA (button) folded before Flop (didn't bet)
Seat 3: ygTTt5ehT4aF86q1a8/R+w (small blind) folded before Flop
Seat 4: SiGJDsvRViJX05vHhA80GQ (big blind) folded on the Flop
Seat 5: 54yWzRRgS0oZ+S6LwZBxMQ collected ($4.75)
Seat 6: sTPOWERd9HWPCNrDBwsVjA folded before Flop (didn't bet)



PokerStars Game #59941620342:  Hold'em No Limit ($1/$2) - 2009/07/01 1:40:57 ET
Table '/ci73fTmzTzmGWzAtqEX2Q' 9-max Seat #6 is the button
Seat 1: 9efVc1cB3yHt4TvBkTusPw ($145.90 in chips)
Seat 2: pN/Ip0ePsUVIdUlGgLrkUw ($225 in chips)
Seat 3: kK1+5ivyJZeA8hQF2pdvvQ ($61.55 in chips)
Seat 4: 2yq7Zp4xmrhAw8+37hTkaA ($161.20 in chips)
Seat 5: 1CtiZuXDFaJL1dJPQKyi8Q ($191.75 in chips)
Seat 6: KqHysDSpCPaPyK3tJC1aEw ($200 in chips)
Seat 7: +T/63sAeZzWyHchahJ36GQ ($38 in chips)
Seat 8: /inIs/z/PcX+TniIFpaxpg ($34 in chips)
Seat 9: S8aS+9FTYQ/ICLBNThcrkg ($177 in chips)
+T/63sAeZzWyHchahJ36GQ: posts small blind $1
/inIs/z/PcX+TniIFpaxpg: posts big blind $2
*** HOLE CARDS ***
S8aS+9FTYQ/ICLBNThcrkg: folds
9efVc1cB3yHt4TvBkTusPw: folds
pN/Ip0ePsUVIdUlGgLrkUw: folds
kK1+5ivyJZeA8hQF2pdvvQ: calls $2
2yq7Zp4xmrhAw8+37hTkaA: folds
1CtiZuXDFaJL1dJPQKyi8Q: folds
KqHysDSpCPaPyK3tJC1aEw: folds
+T/63sAeZzWyHchahJ36GQ: folds
/inIs/z/PcX+TniIFpaxpg: checks
*** FLOP *** [9h Th 7d]
/inIs/z/PcX+TniIFpaxpg: bets $2
kK1+5ivyJZeA8hQF2pdvvQ: folds
/inIs/z/PcX+TniIFpaxpg collected $4.75 from pot
*** SUMMARY ***
Total pot $5 | Rake $0.25
Board [9h Th 7d]
Seat 1: 9efVc1cB3yHt4TvBkTusPw folded before Flop (didn't bet)
Seat 2: pN/Ip0ePsUVIdUlGgLrkUw folded before Flop (didn't bet)
Seat 3: kK1+5ivyJZeA8hQF2pdvvQ folded on the Flop
Seat 4: 2yq7Zp4xmrhAw8+37hTkaA folded before Flop (didn't bet)
Seat 5: 1CtiZuXDFaJL1dJPQKyi8Q folded before Flop (didn't bet)
Seat 6: KqHysDSpCPaPyK3tJC1aEw (button) folded before Flop (didn't bet)
Seat 7: +T/63sAeZzWyHchahJ36GQ (small blind) folded before Flop
Seat 8: /inIs/z/PcX+TniIFpaxpg (big blind) collected ($4.75)
Seat 9: S8aS+9FTYQ/ICLBNThcrkg folded before Flop (didn't bet)



PokerStars Game #59941620716:  Hold'em No Limit ($1/$2) - 2009/07/01 1:40:58 ET
Table 'ztv6V3FN2bQ9nmJPPdx6nQ' 6-max Seat #3 is the button
Seat 1: 6fLdOUCRtX71xbVRhJEq8w ($238.35 in chips)
Seat 2: 5Y+ZGWLI4gnlpApDX5vy1A ($394.15 in chips)
Seat 3: ubtx4Z5L+AcK71MTvYiGVw ($250.20 in chips)
Seat 4: UaZ5yj+6LjtWqMQg2QskUw ($83.30 in chips)
Seat 5: sTPOWERd9HWPCNrDBwsVjA ($220.60 in chips)
Seat 6: mfy7uGZcqA2PVQqEVbJ7+g ($109.60 in chips)
UaZ5yj+6LjtWqMQg2QskUw: posts small blind $1
sTPOWERd9HWPCNrDBwsVjA: posts big blind $2
*** HOLE CARDS ***
mfy7uGZcqA2PVQqEVbJ7+g: folds
6fLdOUCRtX71xbVRhJEq8w: folds
5Y+ZGWLI4gnlpApDX5vy1A: raises $4 to $6
ubtx4Z5L+AcK71MTvYiGVw: calls $6
UaZ5yj+6LjtWqMQg2QskUw: folds
sTPOWERd9HWPCNrDBwsVjA: folds
*** FLOP *** [As Tc 9c]
5Y+ZGWLI4gnlpApDX5vy1A: bets $12
ubtx4Z5L+AcK71MTvYiGVw: folds
5Y+ZGWLI4gnlpApDX5vy1A collected $14.25 from pot
5Y+ZGWLI4gnlpApDX5vy1A: doesn't show hand
*** SUMMARY ***
Total pot $15 | Rake $0.75
Board [As Tc 9c]
Seat 1: 6fLdOUCRtX71xbVRhJEq8w folded before Flop (didn't bet)
Seat 2: 5Y+ZGWLI4gnlpApDX5vy1A collected ($14.25)
Seat 3: ubtx4Z5L+AcK71MTvYiGVw (button) folded on the Flop
Seat 4: UaZ5yj+6LjtWqMQg2QskUw (small blind) folded before Flop
Seat 5: sTPOWERd9HWPCNrDBwsVjA (big blind) folded before Flop
Seat 6: mfy7uGZcqA2PVQqEVbJ7+g folded before Flop (didn't bet)



PokerStars Game #59941621748:  Hold'em No Limit ($1/$2) - 2009/07/01 1:41:00 ET
Table 'aSf77Sj8QEnzcc0WaxVD4Q' 6-max Seat #4 is the button
Seat 1: UELtvp+JfwI7XDGVwSxZXA ($250.10 in chips)
Seat 2: vkfxu8f/jMYKUk6Ly4eujw ($40 in chips)
Seat 3: 9dpyyjDTCed6nV7JhaUUpw ($743.75 in chips)
Seat 4: YsLQ3BAvgQHWXMAv3Wv6Hg ($200 in chips)
Seat 5: VvdR9F3I+2yELkfTVvC1dg ($256 in chips)
Seat 6: vkoJRf3gidxY1pPi0AFWww ($132.10 in chips)
VvdR9F3I+2yELkfTVvC1dg: posts small blind $1
vkoJRf3gidxY1pPi0AFWww: posts big blind $2
*** HOLE CARDS ***
UELtvp+JfwI7XDGVwSxZXA: folds
vkfxu8f/jMYKUk6Ly4eujw: folds
9dpyyjDTCed6nV7JhaUUpw: folds
YsLQ3BAvgQHWXMAv3Wv6Hg: folds
VvdR9F3I+2yELkfTVvC1dg: folds
vkoJRf3gidxY1pPi0AFWww collected $2 from pot
vkoJRf3gidxY1pPi0AFWww: doesn't show hand
*** SUMMARY ***
Total pot $2 | Rake $0
Seat 1: UELtvp+JfwI7XDGVwSxZXA folded before Flop (didn't bet)
Seat 2: vkfxu8f/jMYKUk6Ly4eujw folded before Flop (didn't bet)
Seat 3: 9dpyyjDTCed6nV7JhaUUpw folded before Flop (didn't bet)
Seat 4: YsLQ3BAvgQHWXMAv3Wv6Hg (button) folded before Flop (didn't bet)
Seat 5: VvdR9F3I+2yELkfTVvC1dg (small blind) folded before Flop
Seat 6: vkoJRf3gidxY1pPi0AFWww (big blind) collected ($2)



PokerStars Game #59941622144:  Hold'em No Limit ($1/$2) - 2009/07/01 1:41:00 ET
Table '4NGNnZ/osQfNq6abYqkJeA' 6-max Seat #2 is the button
Seat 2: 669iGNwYwgRZg3nhS+aDAQ ($111.70 in chips)
Seat 3: 54yWzRRgS0oZ+S6LwZBxMQ ($20.80 in chips)
Seat 4: sY+4Uuh5z/6AbXXaCS10jw ($233.25 in chips)
Seat 5: VvdR9F3I+2yELkfTVvC1dg ($238.55 in chips)
Seat 6: /PH6Ffnho4Ysm8S3V/oa+w ($40 in chips)
54yWzRRgS0oZ+S6LwZBxMQ: posts small blind $1
sY+4Uuh5z/6AbXXaCS10jw: posts big blind $2
*** HOLE CARDS ***
VvdR9F3I+2yELkfTVvC1dg: folds
/PH6Ffnho4Ysm8S3V/oa+w: raises $2 to $4
669iGNwYwgRZg3nhS+aDAQ: raises $4 to $8
54yWzRRgS0oZ+S6LwZBxMQ: folds
sY+4Uuh5z/6AbXXaCS10jw: folds
/PH6Ffnho4Ysm8S3V/oa+w: folds
669iGNwYwgRZg3nhS+aDAQ collected $11 from pot
*** SUMMARY ***
Total pot $11 | Rake $0
Seat 2: 669iGNwYwgRZg3nhS+aDAQ (button) collected ($11)
Seat 3: 54yWzRRgS0oZ+S6LwZBxMQ (small blind) folded before Flop
Seat 4: sY+4Uuh5z/6AbXXaCS10jw (big blind) folded before Flop
Seat 5: VvdR9F3I+2yELkfTVvC1dg folded before Flop (didn't bet)
Seat 6: /PH6Ffnho4Ysm8S3V/oa+w folded before Flop



PokerStars Game #59941621844:  Hold'em No Limit ($1/$2) - 2009/07/01 1:41:00 ET
Table 'P/yCfYl1GfGsu/e6DxDy/A' 2-max Seat #2 is the button
Seat 1: 7fOCUy3x9hdkmXkkDNolGQ ($427 in chips)
Seat 2: RwDoM55ZeQuI2ADyJhOb2Q ($1050 in chips)
RwDoM55ZeQuI2ADyJhOb2Q: posts small blind $1
7fOCUy3x9hdkmXkkDNolGQ: posts big blind $2
*** HOLE CARDS ***
RwDoM55ZeQuI2ADyJhOb2Q: raises $4 to $6
7fOCUy3x9hdkmXkkDNolGQ: calls $4
*** FLOP *** [8c 4h 3h]
7fOCUy3x9hdkmXkkDNolGQ: checks
RwDoM55ZeQuI2ADyJhOb2Q: bets $6
7fOCUy3x9hdkmXkkDNolGQ: raises $16 to $22
RwDoM55ZeQuI2ADyJhOb2Q: folds
7fOCUy3x9hdkmXkkDNolGQ collected $23.50 from pot
7fOCUy3x9hdkmXkkDNolGQ: doesn't show hand
*** SUMMARY ***
Total pot $24 | Rake $0.50
Board [8c 4h 3h]
Seat 1: 7fOCUy3x9hdkmXkkDNolGQ (big blind) collected ($23.50)
Seat 2: RwDoM55ZeQuI2ADyJhOb2Q (button) (small blind) folded on the Flop



PokerStars Game #59941624294:  Hold'em No Limit ($1/$2) - 2009/07/01 1:41:04 ET
Table 'NmY84NAf9Mh0ckAckHnh5g' 2-max Seat #2 is the button
Seat 1: 6hvg964TSqZ3AL/0XK9aVQ ($436.20 in chips)
Seat 2: RwDoM55ZeQuI2ADyJhOb2Q ($556 in chips)
RwDoM55ZeQuI2ADyJhOb2Q: posts small blind $1
6hvg964TSqZ3AL/0XK9aVQ: posts big blind $2
*** HOLE CARDS ***
RwDoM55ZeQuI2ADyJhOb2Q: raises $4 to $6
6hvg964TSqZ3AL/0XK9aVQ: calls $4
*** FLOP *** [8d 6s 9c]
6hvg964TSqZ3AL/0XK9aVQ: checks
RwDoM55ZeQuI2ADyJhOb2Q: bets $12
6hvg964TSqZ3AL/0XK9aVQ: calls $12
*** TURN *** [8d 6s 9c] [Qs]
6hvg964TSqZ3AL/0XK9aVQ: checks
RwDoM55ZeQuI2ADyJhOb2Q: bets $32
6hvg964TSqZ3AL/0XK9aVQ: calls $32
*** RIVER *** [8d 6s 9c Qs] [3d]
6hvg964TSqZ3AL/0XK9aVQ: checks
RwDoM55ZeQuI2ADyJhOb2Q: bets $32
6hvg964TSqZ3AL/0XK9aVQ: calls $32
*** SHOW DOWN ***
RwDoM55ZeQuI2ADyJhOb2Q: shows [7h 9h] (a pair of Nines)
6hvg964TSqZ3AL/0XK9aVQ: shows [9s Js] (a pair of Nines - Queen+Jack kicker)
6hvg964TSqZ3AL/0XK9aVQ collected $163.50 from pot
*** SUMMARY ***
Total pot $164 | Rake $0.50
Board [8d 6s 9c Qs 3d]
Seat 1: 6hvg964TSqZ3AL/0XK9aVQ (big blind) showed [9s Js] and won ($163.50) with a pair of Nines
Seat 2: RwDoM55ZeQuI2ADyJhOb2Q (button) (small blind) showed [7h 9h] and lost with a pair of Nines



PokerStars Game #59941624616:  Hold'em No Limit ($1/$2) - 2009/07/01 1:41:05 ET
Table 'CFkQcfWjKccZaZDf71FK+w' 6-max Seat #3 is the button
Seat 1: vkfxu8f/jMYKUk6Ly4eujw ($234.25 in chips)
Seat 2: ewN/vzF22+/gdzjIKBOlkA ($205.05 in chips)
Seat 3: 09BNF4quPDzanQzM8vc6WA ($40.65 in chips)
Seat 4: ygTTt5ehT4aF86q1a8/R+w ($244.35 in chips)
Seat 5: 2lOU1DcvUZaMcxZ95XfzXw ($187.10 in chips)
Seat 6: ORVqY3rf9X6ANA/8s+On2Q ($46.60 in chips)
ygTTt5ehT4aF86q1a8/R+w: posts small blind $1
2lOU1DcvUZaMcxZ95XfzXw: posts big blind $2
*** HOLE CARDS ***
ORVqY3rf9X6ANA/8s+On2Q: calls $2
vkfxu8f/jMYKUk6Ly4eujw: raises $8 to $10
ewN/vzF22+/gdzjIKBOlkA: folds
09BNF4quPDzanQzM8vc6WA: folds
ygTTt5ehT4aF86q1a8/R+w: folds
2lOU1DcvUZaMcxZ95XfzXw: folds
ORVqY3rf9X6ANA/8s+On2Q: folds
vkfxu8f/jMYKUk6Ly4eujw collected $7 from pot
*** SUMMARY ***
Total pot $7 | Rake $0
Seat 1: vkfxu8f/jMYKUk6Ly4eujw collected ($7)
Seat 2: ewN/vzF22+/gdzjIKBOlkA folded before Flop (didn't bet)
Seat 3: 09BNF4quPDzanQzM8vc6WA (button) folded before Flop (didn't bet)
Seat 4: ygTTt5ehT4aF86q1a8/R+w (small blind) folded before Flop
Seat 5: 2lOU1DcvUZaMcxZ95XfzXw (big blind) folded before Flop
Seat 6: ORVqY3rf9X6ANA/8s+On2Q folded before Flop



PokerStars Game #59941624586:  Hold'em No Limit ($1/$2) - 2009/07/01 1:41:05 ET
Table 'mGpP9StWRnoeiBDExc6Frg' 6-max Seat #2 is the button
Seat 1: VvdR9F3I+2yELkfTVvC1dg ($309.15 in chips)
Seat 2: vkfxu8f/jMYKUk6Ly4eujw ($199 in chips)
Seat 3: 7acrZUQC3Zc9BNLjoKIcLQ ($28.85 in chips)
Seat 4: 4dcDwIHRm96PwtqkpQiuiA ($69.70 in chips)
Seat 5: d1puGuVBE0fidn+5eRJ0tw ($210.55 in chips)
Seat 6: B2Ih1sr5VZk+8He7rcrMtQ ($416.05 in chips)
7acrZUQC3Zc9BNLjoKIcLQ: posts small blind $1
4dcDwIHRm96PwtqkpQiuiA: posts big blind $2
*** HOLE CARDS ***
d1puGuVBE0fidn+5eRJ0tw: folds
B2Ih1sr5VZk+8He7rcrMtQ: calls $2
VvdR9F3I+2yELkfTVvC1dg: folds
vkfxu8f/jMYKUk6Ly4eujw: raises $8 to $10
7acrZUQC3Zc9BNLjoKIcLQ: folds
4dcDwIHRm96PwtqkpQiuiA: folds
B2Ih1sr5VZk+8He7rcrMtQ: folds
vkfxu8f/jMYKUk6Ly4eujw collected $7 from pot
vkfxu8f/jMYKUk6Ly4eujw: doesn't show hand
*** SUMMARY ***
Total pot $7 | Rake $0
Seat 1: VvdR9F3I+2yELkfTVvC1dg folded before Flop (didn't bet)
Seat 2: vkfxu8f/jMYKUk6Ly4eujw (button) collected ($7)
Seat 3: 7acrZUQC3Zc9BNLjoKIcLQ (small blind) folded before Flop
Seat 4: 4dcDwIHRm96PwtqkpQiuiA (big blind) folded before Flop
Seat 5: d1puGuVBE0fidn+5eRJ0tw folded before Flop (didn't bet)
Seat 6: B2Ih1sr5VZk+8He7rcrMtQ folded before Flop



PokerStars Game #59941625786:  Hold'em No Limit ($1/$2) - 2009/07/01 1:41:07 ET
Table 'pPQgcj9XT9CHBsbo1WTBug' 6-max Seat #3 is the button
Seat 1: DFVYDA6dKQy7R7mGIKogZA ($121 in chips)
Seat 2: qXDd0ZyMIse0OBu8pxeQ3Q ($200 in chips)
Seat 3: 54yWzRRgS0oZ+S6LwZBxMQ ($114 in chips)
Seat 4: gqlysXCbT8V54f/1lf9h3A ($30.45 in chips)
Seat 5: vkfxu8f/jMYKUk6Ly4eujw ($196.55 in chips)
gqlysXCbT8V54f/1lf9h3A: posts small blind $1
vkfxu8f/jMYKUk6Ly4eujw: posts big blind $2
*** HOLE CARDS ***
DFVYDA6dKQy7R7mGIKogZA: calls $2
qXDd0ZyMIse0OBu8pxeQ3Q: folds
54yWzRRgS0oZ+S6LwZBxMQ: folds
gqlysXCbT8V54f/1lf9h3A: raises $4 to $6
vkfxu8f/jMYKUk6Ly4eujw: folds
DFVYDA6dKQy7R7mGIKogZA: calls $4
*** FLOP *** [5c Ah 4d]
gqlysXCbT8V54f/1lf9h3A: bets $6
DFVYDA6dKQy7R7mGIKogZA: raises $30 to $36
gqlysXCbT8V54f/1lf9h3A: folds
DFVYDA6dKQy7R7mGIKogZA collected $24.75 from pot
*** SUMMARY ***
Total pot $26 | Rake $1.25
Board [5c Ah 4d]
Seat 1: DFVYDA6dKQy7R7mGIKogZA collected ($24.75)
Seat 2: qXDd0ZyMIse0OBu8pxeQ3Q folded before Flop (didn't bet)
Seat 3: 54yWzRRgS0oZ+S6LwZBxMQ (button) folded before Flop (didn't bet)
Seat 4: gqlysXCbT8V54f/1lf9h3A (small blind) folded on the Flop
Seat 5: vkfxu8f/jMYKUk6Ly4eujw (big blind) folded before Flop



PokerStars Game #59941626722:  Hold'em No Limit ($1/$2) - 2009/07/01 1:41:09 ET
Table 'G1Oqdy4Pqdb5gtx40rUBzA' 6-max Seat #4 is the button
Seat 3: VvdR9F3I+2yELkfTVvC1dg ($218.90 in chips)
Seat 4: B87ikIyZ/TzAVeXf38Ny0g ($205.55 in chips)
Seat 5: F1+Ml47qRQWunzPnGhLLzQ ($201.40 in chips)
Seat 6: qCnEYuAE5y5A7bk6fO5/jQ ($214.25 in chips)
F1+Ml47qRQWunzPnGhLLzQ: posts small blind $1
qCnEYuAE5y5A7bk6fO5/jQ: posts big blind $2
BWhgxe7gWiYobRbwdG+d2Q: sits out
*** HOLE CARDS ***
VvdR9F3I+2yELkfTVvC1dg: folds
B87ikIyZ/TzAVeXf38Ny0g: raises $4 to $6
m7mYVfnCOK5TE/VkN/FhOg joins the table at seat #2
F1+Ml47qRQWunzPnGhLLzQ: folds
qCnEYuAE5y5A7bk6fO5/jQ: folds
B87ikIyZ/TzAVeXf38Ny0g collected $5 from pot
B87ikIyZ/TzAVeXf38Ny0g: doesn't show hand
*** SUMMARY ***
Total pot $5 | Rake $0
Seat 3: VvdR9F3I+2yELkfTVvC1dg folded before Flop (didn't bet)
Seat 4: B87ikIyZ/TzAVeXf38Ny0g (button) collected ($5)
Seat 5: F1+Ml47qRQWunzPnGhLLzQ (small blind) folded before Flop
Seat 6: qCnEYuAE5y5A7bk6fO5/jQ (big blind) folded before Flop



PokerStars Game #59941628294:  Hold'em No Limit ($1/$2) - 2009/07/01 1:41:11 ET
Table 'aSf77Sj8QEnzcc0WaxVD4Q' 6-max Seat #5 is the button
Seat 1: UELtvp+JfwI7XDGVwSxZXA ($250.10 in chips)
Seat 2: vkfxu8f/jMYKUk6Ly4eujw ($200 in chips)
Seat 3: 9dpyyjDTCed6nV7JhaUUpw ($743.75 in chips)
Seat 4: YsLQ3BAvgQHWXMAv3Wv6Hg ($200 in chips)
Seat 5: VvdR9F3I+2yELkfTVvC1dg ($255 in chips)
Seat 6: vkoJRf3gidxY1pPi0AFWww ($133.10 in chips)
vkoJRf3gidxY1pPi0AFWww: posts small blind $1
UELtvp+JfwI7XDGVwSxZXA: posts big blind $2
*** HOLE CARDS ***
vkfxu8f/jMYKUk6Ly4eujw: folds
9dpyyjDTCed6nV7JhaUUpw: folds
YsLQ3BAvgQHWXMAv3Wv6Hg: folds
VvdR9F3I+2yELkfTVvC1dg: raises $2 to $4
vkoJRf3gidxY1pPi0AFWww: calls $3
UELtvp+JfwI7XDGVwSxZXA: calls $2
*** FLOP *** [As 5d 2d]
vkoJRf3gidxY1pPi0AFWww: checks
UELtvp+JfwI7XDGVwSxZXA: checks
VvdR9F3I+2yELkfTVvC1dg: checks
*** TURN *** [As 5d 2d] [6h]
vkoJRf3gidxY1pPi0AFWww: checks
UELtvp+JfwI7XDGVwSxZXA: checks
VvdR9F3I+2yELkfTVvC1dg: checks
*** RIVER *** [As 5d 2d 6h] [Jd]
vkoJRf3gidxY1pPi0AFWww: bets $6
UELtvp+JfwI7XDGVwSxZXA: folds
VvdR9F3I+2yELkfTVvC1dg: folds
vkoJRf3gidxY1pPi0AFWww collected $11.40 from pot
vkoJRf3gidxY1pPi0AFWww: doesn't show hand
*** SUMMARY ***
Total pot $12 | Rake $0.60
Board [As 5d 2d 6h Jd]
Seat 1: UELtvp+JfwI7XDGVwSxZXA (big blind) folded on the River
Seat 2: vkfxu8f/jMYKUk6Ly4eujw folded before Flop (didn't bet)
Seat 3: 9dpyyjDTCed6nV7JhaUUpw folded before Flop (didn't bet)
Seat 4: YsLQ3BAvgQHWXMAv3Wv6Hg folded before Flop (didn't bet)
Seat 5: VvdR9F3I+2yELkfTVvC1dg (button) folded on the River
Seat 6: vkoJRf3gidxY1pPi0AFWww (small blind) collected ($11.40)



PokerStars Game #59941629302:  Hold'em No Limit ($1/$2) - 2009/07/01 1:41:13 ET
Table 'qVXak+oTeDXMGbWa4sDU5Q' 9-max Seat #5 is the button
Seat 1: H6Z4+qu8gR0VUiPOijndVg ($230.45 in chips)
Seat 2: CST1bO+CmVQOtNgiT0cKPg ($77 in chips)
Seat 3: WUlHm+ydPPHG7Lb0rePSdA ($172.10 in chips)
Seat 4: lQYT23h5QCUVZAKxjOO39Q ($188.10 in chips)
Seat 5: zJtQ1gxyi72XvGYS1tM+DA ($97 in chips)
Seat 6: GX1heJ+DSsvm7gzSPsYhhQ ($41 in chips)
Seat 7: 6oGEJqk9oDy29sSaLs+LGA ($81.65 in chips)
Seat 8: Z0rzUi0y1x80UdIpofoNbA ($109.55 in chips)
Seat 9: CkE3IyJF1KvdaAOmZY5XqQ ($215.55 in chips)
GX1heJ+DSsvm7gzSPsYhhQ: posts small blind $1
6oGEJqk9oDy29sSaLs+LGA: posts big blind $2
*** HOLE CARDS ***
Z0rzUi0y1x80UdIpofoNbA: folds
CkE3IyJF1KvdaAOmZY5XqQ: folds
H6Z4+qu8gR0VUiPOijndVg: folds
CST1bO+CmVQOtNgiT0cKPg: calls $2
WUlHm+ydPPHG7Lb0rePSdA: folds
lQYT23h5QCUVZAKxjOO39Q: folds
zJtQ1gxyi72XvGYS1tM+DA: folds
GX1heJ+DSsvm7gzSPsYhhQ: folds
6oGEJqk9oDy29sSaLs+LGA: checks
*** FLOP *** [9s 7c Qc]
6oGEJqk9oDy29sSaLs+LGA: checks
CST1bO+CmVQOtNgiT0cKPg: bets $4
6oGEJqk9oDy29sSaLs+LGA: folds
CST1bO+CmVQOtNgiT0cKPg collected $4.75 from pot
*** SUMMARY ***
Total pot $5 | Rake $0.25
Board [9s 7c Qc]
Seat 1: H6Z4+qu8gR0VUiPOijndVg folded before Flop (didn't bet)
Seat 2: CST1bO+CmVQOtNgiT0cKPg collected ($4.75)
Seat 3: WUlHm+ydPPHG7Lb0rePSdA folded before Flop (didn't bet)
Seat 4: lQYT23h5QCUVZAKxjOO39Q folded before Flop (didn't bet)
Seat 5: zJtQ1gxyi72XvGYS1tM+DA (button) folded before Flop (didn't bet)
Seat 6: GX1heJ+DSsvm7gzSPsYhhQ (small blind) folded before Flop
Seat 7: 6oGEJqk9oDy29sSaLs+LGA (big blind) folded on the Flop
Seat 8: Z0rzUi0y1x80UdIpofoNbA folded before Flop (didn't bet)
Seat 9: CkE3IyJF1KvdaAOmZY5XqQ folded before Flop (didn't bet)



PokerStars Game #59941629998:  Hold'em No Limit ($1/$2) - 2009/07/01 1:41:15 ET
Table 'uJ9juaXXg9yIcSU8amxaXQ' 6-max Seat #3 is the button
Seat 1: JsqOjN/eHz0uYVf/PyUJ6Q ($150.25 in chips)
Seat 2: VvdR9F3I+2yELkfTVvC1dg ($219.10 in chips)
Seat 3: qXDd0ZyMIse0OBu8pxeQ3Q ($243.40 in chips)
Seat 4: zNjJ/y4emmF+vzrCDd+ooA ($229.45 in chips)
Seat 5: YsLQ3BAvgQHWXMAv3Wv6Hg ($205.70 in chips)
Seat 6: /PH6Ffnho4Ysm8S3V/oa+w ($43 in chips)
zNjJ/y4emmF+vzrCDd+ooA: posts small blind $1
YsLQ3BAvgQHWXMAv3Wv6Hg: posts big blind $2
*** HOLE CARDS ***
/PH6Ffnho4Ysm8S3V/oa+w: folds
JsqOjN/eHz0uYVf/PyUJ6Q: folds
VvdR9F3I+2yELkfTVvC1dg: folds
qXDd0ZyMIse0OBu8pxeQ3Q: folds
zNjJ/y4emmF+vzrCDd+ooA: folds
YsLQ3BAvgQHWXMAv3Wv6Hg collected $2 from pot
YsLQ3BAvgQHWXMAv3Wv6Hg: doesn't show hand
*** SUMMARY ***
Total pot $2 | Rake $0
Seat 1: JsqOjN/eHz0uYVf/PyUJ6Q folded before Flop (didn't bet)
Seat 2: VvdR9F3I+2yELkfTVvC1dg folded before Flop (didn't bet)
Seat 3: qXDd0ZyMIse0OBu8pxeQ3Q (button) folded before Flop (didn't bet)
Seat 4: zNjJ/y4emmF+vzrCDd+ooA (small blind) folded before Flop
Seat 5: YsLQ3BAvgQHWXMAv3Wv6Hg (big blind) collected ($2)
Seat 6: /PH6Ffnho4Ysm8S3V/oa+w folded before Flop (didn't bet)



PokerStars Game #59941632002:  Hold'em No Limit ($1/$2) - 2009/07/01 1:41:18 ET
Table 'P/yCfYl1GfGsu/e6DxDy/A' 2-max Seat #1 is the button
Seat 1: 7fOCUy3x9hdkmXkkDNolGQ ($438.50 in chips)
Seat 2: RwDoM55ZeQuI2ADyJhOb2Q ($1038 in chips)
7fOCUy3x9hdkmXkkDNolGQ: posts small blind $1
RwDoM55ZeQuI2ADyJhOb2Q: posts big blind $2
*** HOLE CARDS ***
7fOCUy3x9hdkmXkkDNolGQ: raises $4 to $6
RwDoM55ZeQuI2ADyJhOb2Q: folds
7fOCUy3x9hdkmXkkDNolGQ collected $4 from pot
7fOCUy3x9hdkmXkkDNolGQ: doesn't show hand
*** SUMMARY ***
Total pot $4 | Rake $0
Seat 1: 7fOCUy3x9hdkmXkkDNolGQ (button) (small blind) collected ($4)
Seat 2: RwDoM55ZeQuI2ADyJhOb2Q (big blind) folded before Flop



PokerStars Game #59941632248:  Hold'em No Limit ($1/$2) - 2009/07/01 1:41:19 ET
Table 'zEOkwFUmNLBlvazOXtwH8w' 2-max Seat #1 is the button
Seat 1: gu6Ee9WAefYH8BG9//A1pw ($84 in chips)
Seat 2: SLKKhEamo9/21wMiSyGsQw ($75.50 in chips)
gu6Ee9WAefYH8BG9//A1pw: posts small blind $1
SLKKhEamo9/21wMiSyGsQw: posts big blind $2
*** HOLE CARDS ***
gu6Ee9WAefYH8BG9//A1pw: raises $34 to $36
SLKKhEamo9/21wMiSyGsQw: raises $34 to $70
gu6Ee9WAefYH8BG9//A1pw: calls $34
*** FLOP *** [3h 8s 8d]
SLKKhEamo9/21wMiSyGsQw: bets $5.50 and is all-in
gu6Ee9WAefYH8BG9//A1pw: folds
SLKKhEamo9/21wMiSyGsQw collected $139.50 from pot
SLKKhEamo9/21wMiSyGsQw: doesn't show hand
*** SUMMARY ***
Total pot $140 | Rake $0.50
Board [3h 8s 8d]
Seat 1: gu6Ee9WAefYH8BG9//A1pw (button) (small blind) folded on the Flop
Seat 2: SLKKhEamo9/21wMiSyGsQw (big blind) collected ($139.50)



PokerStars Game #59941632818:  Hold'em No Limit ($1/$2) - 2009/07/01 1:41:20 ET
Table 'AtOXMvcrtQM8yLNcALmfLQ' 2-max Seat #2 is the button
Seat 1: +HlQuAsMqZGYYtjcPO/a3A ($313 in chips)
Seat 2: pVqEzK9wXlRMECnb1Zg4Zw ($256.50 in chips)
pVqEzK9wXlRMECnb1Zg4Zw: posts small blind $1
+HlQuAsMqZGYYtjcPO/a3A: posts big blind $2
*** HOLE CARDS ***
pVqEzK9wXlRMECnb1Zg4Zw: folds
+HlQuAsMqZGYYtjcPO/a3A collected $2 from pot
*** SUMMARY ***
Total pot $2 | Rake $0
Seat 1: +HlQuAsMqZGYYtjcPO/a3A (big blind) collected ($2)
Seat 2: pVqEzK9wXlRMECnb1Zg4Zw (button) (small blind) folded before Flop



PokerStars Game #59941632766:  Hold'em No Limit ($1/$2) - 2009/07/01 1:41:20 ET
Table 'bJQ024BaYSBrW0sXpCZbNQ' 6-max Seat #1 is the button
Seat 1: KfwW5us6tydK81NYTtK1gw ($200 in chips)
Seat 2: 3dAbvkxS5NPQTBAbvpinVg ($200 in chips)
Seat 3: /PH6Ffnho4Ysm8S3V/oa+w ($40 in chips)
Seat 4: TBaQIN+sQ7eb7P99QnaORQ ($85.80 in chips)
Seat 5: VvdR9F3I+2yELkfTVvC1dg ($200 in chips)
Seat 6: 4bqvCfJ0e8CTYnn0Go9hbQ ($146.20 in chips)
3dAbvkxS5NPQTBAbvpinVg: posts small blind $1
/PH6Ffnho4Ysm8S3V/oa+w: posts big blind $2
*** HOLE CARDS ***
TBaQIN+sQ7eb7P99QnaORQ: folds
VvdR9F3I+2yELkfTVvC1dg: folds
4bqvCfJ0e8CTYnn0Go9hbQ: folds
KfwW5us6tydK81NYTtK1gw: raises $2 to $4
3dAbvkxS5NPQTBAbvpinVg: folds
/PH6Ffnho4Ysm8S3V/oa+w: folds
KfwW5us6tydK81NYTtK1gw collected $5 from pot
KfwW5us6tydK81NYTtK1gw: doesn't show hand
*** SUMMARY ***
Total pot $5 | Rake $0
Seat 1: KfwW5us6tydK81NYTtK1gw (button) collected ($5)
Seat 2: 3dAbvkxS5NPQTBAbvpinVg (small blind) folded before Flop
Seat 3: /PH6Ffnho4Ysm8S3V/oa+w (big blind) folded before Flop
Seat 4: TBaQIN+sQ7eb7P99QnaORQ folded before Flop (didn't bet)
Seat 5: VvdR9F3I+2yELkfTVvC1dg folded before Flop (didn't bet)
Seat 6: 4bqvCfJ0e8CTYnn0Go9hbQ folded before Flop (didn't bet)



PokerStars Game #59941633700:  Hold'em No Limit ($1/$2) - 2009/07/01 1:41:21 ET
Table 'ZzSIe0zTCDv+n6hfbY5tTg' 6-max Seat #6 is the button
Seat 1: VvdR9F3I+2yELkfTVvC1dg ($255 in chips)
Seat 2: B87ikIyZ/TzAVeXf38Ny0g ($237 in chips)
Seat 3: gsugPj31Hui3Jefl98MBOA ($358 in chips)
Seat 5: 3dAbvkxS5NPQTBAbvpinVg ($498.10 in chips)
Seat 6: 09BNF4quPDzanQzM8vc6WA ($36 in chips)
VvdR9F3I+2yELkfTVvC1dg: posts small blind $1
B87ikIyZ/TzAVeXf38Ny0g: posts big blind $2
54yWzRRgS0oZ+S6LwZBxMQ: sits out
*** HOLE CARDS ***
gsugPj31Hui3Jefl98MBOA: calls $2
3dAbvkxS5NPQTBAbvpinVg: raises $8 to $10
09BNF4quPDzanQzM8vc6WA: folds
VvdR9F3I+2yELkfTVvC1dg: folds
B87ikIyZ/TzAVeXf38Ny0g: folds
gsugPj31Hui3Jefl98MBOA: folds
3dAbvkxS5NPQTBAbvpinVg collected $7 from pot
3dAbvkxS5NPQTBAbvpinVg: doesn't show hand
*** SUMMARY ***
Total pot $7 | Rake $0
Seat 1: VvdR9F3I+2yELkfTVvC1dg (small blind) folded before Flop
Seat 2: B87ikIyZ/TzAVeXf38Ny0g (big blind) folded before Flop
Seat 3: gsugPj31Hui3Jefl98MBOA folded before Flop
Seat 5: 3dAbvkxS5NPQTBAbvpinVg collected ($7)
Seat 6: 09BNF4quPDzanQzM8vc6WA (button) folded before Flop (didn't bet)



PokerStars Game #59941635824:  Hold'em No Limit ($1/$2) - 2009/07/01 1:41:25 ET
Table 'YqGfR5eHfMeSjb9a+QU9rg' 9-max Seat #1 is the button
Seat 1: rW/MyplHylMSBRaoRUzWrg ($36 in chips)
Seat 2: nXDI8Y/S6POzRwANu3d8hQ ($38 in chips)
Seat 3: /gll27k+xWYV7Fbki0lFDQ ($250.75 in chips)
Seat 4: GX1heJ+DSsvm7gzSPsYhhQ ($34 in chips)
Seat 5: CkE3IyJF1KvdaAOmZY5XqQ ($211.80 in chips)
Seat 6: TAfo4veNRaRlzDXMMYS3Jg ($40 in chips)
Seat 7: 41aZuLBz9nAi2GPVKabmCw ($84.95 in chips)
Seat 8: JnV3SM2D6dAFYyGZHHpvrg ($102.15 in chips)
Seat 9: /inIs/z/PcX+TniIFpaxpg ($204.20 in chips)
nXDI8Y/S6POzRwANu3d8hQ: posts small blind $1
/gll27k+xWYV7Fbki0lFDQ: posts big blind $2
*** HOLE CARDS ***
GX1heJ+DSsvm7gzSPsYhhQ: raises $4 to $6
CkE3IyJF1KvdaAOmZY5XqQ: calls $6
TAfo4veNRaRlzDXMMYS3Jg: folds
41aZuLBz9nAi2GPVKabmCw: folds
JnV3SM2D6dAFYyGZHHpvrg: folds
/inIs/z/PcX+TniIFpaxpg: folds
rW/MyplHylMSBRaoRUzWrg: raises $30 to $36 and is all-in
nXDI8Y/S6POzRwANu3d8hQ: folds
/gll27k+xWYV7Fbki0lFDQ: folds
GX1heJ+DSsvm7gzSPsYhhQ: calls $28 and is all-in
CkE3IyJF1KvdaAOmZY5XqQ: folds
*** FLOP *** [7d Ts Qc]
*** TURN *** [7d Ts Qc] [Kc]
*** RIVER *** [7d Ts Qc Kc] [4d]
*** SHOW DOWN ***
GX1heJ+DSsvm7gzSPsYhhQ: shows [9h 9d] (a pair of Nines)
rW/MyplHylMSBRaoRUzWrg: shows [Ac Ks] (a pair of Kings)
rW/MyplHylMSBRaoRUzWrg collected $74 from pot
*** SUMMARY ***
Total pot $77 | Rake $3
Board [7d Ts Qc Kc 4d]
Seat 1: rW/MyplHylMSBRaoRUzWrg (button) showed [Ac Ks] and won ($74) with a pair of Kings
Seat 2: nXDI8Y/S6POzRwANu3d8hQ (small blind) folded before Flop
Seat 3: /gll27k+xWYV7Fbki0lFDQ (big blind) folded before Flop
Seat 4: GX1heJ+DSsvm7gzSPsYhhQ showed [9h 9d] and lost with a pair of Nines
Seat 5: CkE3IyJF1KvdaAOmZY5XqQ folded before Flop
Seat 6: TAfo4veNRaRlzDXMMYS3Jg folded before Flop (didn't bet)
Seat 7: 41aZuLBz9nAi2GPVKabmCw folded before Flop (didn't bet)
Seat 8: JnV3SM2D6dAFYyGZHHpvrg folded before Flop (didn't bet)
Seat 9: /inIs/z/PcX+TniIFpaxpg folded before Flop (didn't bet)



PokerStars Game #59941635628:  Hold'em No Limit ($1/$2) - 2009/07/01 1:41:25 ET
Table '3WCXyaiCAbqSShQu7FIjvA' 9-max Seat #2 is the button
Seat 1: kTCkABD1UUldS9DFRGfCwQ ($150.75 in chips)
Seat 2: TAfo4veNRaRlzDXMMYS3Jg ($39.70 in chips)
Seat 3: 5Q8U6iZbeO7xJSS4qvDP5g ($283.25 in chips)
Seat 4: waEF/+pxZTxNo4FvsORuXg ($106.40 in chips)
Seat 5: CkE3IyJF1KvdaAOmZY5XqQ ($200 in chips)
Seat 6: 5jQlngvMSqM/WoonOcR5kw ($280.35 in chips)
Seat 7: nXDI8Y/S6POzRwANu3d8hQ ($37 in chips)
Seat 8: 1CtiZuXDFaJL1dJPQKyi8Q ($204.05 in chips)
Seat 9: FiXPLJyqb24l32QST2TInw ($110.40 in chips)
5Q8U6iZbeO7xJSS4qvDP5g: posts small blind $1
waEF/+pxZTxNo4FvsORuXg: posts big blind $2
FiXPLJyqb24l32QST2TInw: posts small & big blinds $3
*** HOLE CARDS ***
CkE3IyJF1KvdaAOmZY5XqQ: folds
5jQlngvMSqM/WoonOcR5kw: calls $2
nXDI8Y/S6POzRwANu3d8hQ: folds
1CtiZuXDFaJL1dJPQKyi8Q: folds
FiXPLJyqb24l32QST2TInw: checks
kTCkABD1UUldS9DFRGfCwQ: folds
TAfo4veNRaRlzDXMMYS3Jg: folds
5Q8U6iZbeO7xJSS4qvDP5g: raises $11 to $13
waEF/+pxZTxNo4FvsORuXg: folds
5jQlngvMSqM/WoonOcR5kw: calls $11
FiXPLJyqb24l32QST2TInw: folds
*** FLOP *** [9c 8s 2d]
5Q8U6iZbeO7xJSS4qvDP5g: checks
5jQlngvMSqM/WoonOcR5kw: bets $30
5Q8U6iZbeO7xJSS4qvDP5g: folds
5jQlngvMSqM/WoonOcR5kw collected $29.45 from pot
*** SUMMARY ***
Total pot $31 | Rake $1.55
Board [9c 8s 2d]
Seat 1: kTCkABD1UUldS9DFRGfCwQ folded before Flop (didn't bet)
Seat 2: TAfo4veNRaRlzDXMMYS3Jg (button) folded before Flop (didn't bet)
Seat 3: 5Q8U6iZbeO7xJSS4qvDP5g (small blind) folded on the Flop
Seat 4: waEF/+pxZTxNo4FvsORuXg (big blind) folded before Flop
Seat 5: CkE3IyJF1KvdaAOmZY5XqQ folded before Flop (didn't bet)
Seat 6: 5jQlngvMSqM/WoonOcR5kw collected ($29.45)
Seat 7: nXDI8Y/S6POzRwANu3d8hQ folded before Flop (didn't bet)
Seat 8: 1CtiZuXDFaJL1dJPQKyi8Q folded before Flop (didn't bet)
Seat 9: FiXPLJyqb24l32QST2TInw folded before Flop



PokerStars Game #59941636106:  Hold'em No Limit ($1/$2) - 2009/07/01 1:41:26 ET
Table 'on4i1U1lCRmxsduFD3xiSg' 9-max Seat #9 is the button
Seat 1: so5k3vFDmokh2q3dImJ1GQ ($174.30 in chips)
Seat 2: NqSvZNzJ4RkR3sCmgQnyLw ($50.85 in chips)
Seat 3: GX1heJ+DSsvm7gzSPsYhhQ ($33 in chips)
Seat 4: DFQVuszLVclqjA46pN4Vvw ($93.80 in chips)
Seat 5: 37j/5DgMG5m9lMfFofEAOg ($90.70 in chips)
Seat 7: /inIs/z/PcX+TniIFpaxpg ($268.05 in chips)
Seat 8: ZYHoLw2lWmRS7CSHi8L8Xg ($200 in chips)
Seat 9: TAfo4veNRaRlzDXMMYS3Jg ($40 in chips)
so5k3vFDmokh2q3dImJ1GQ: posts small blind $1
NqSvZNzJ4RkR3sCmgQnyLw: posts big blind $2
KqHysDSpCPaPyK3tJC1aEw: sits out
*** HOLE CARDS ***
GX1heJ+DSsvm7gzSPsYhhQ: folds
DFQVuszLVclqjA46pN4Vvw: raises $4 to $6
37j/5DgMG5m9lMfFofEAOg: folds
/inIs/z/PcX+TniIFpaxpg: folds
ZYHoLw2lWmRS7CSHi8L8Xg: folds
TAfo4veNRaRlzDXMMYS3Jg: folds
so5k3vFDmokh2q3dImJ1GQ: folds
NqSvZNzJ4RkR3sCmgQnyLw: calls $4
*** FLOP *** [3c Kh Th]
NqSvZNzJ4RkR3sCmgQnyLw: checks
DFQVuszLVclqjA46pN4Vvw: checks
*** TURN *** [3c Kh Th] [Ac]
NqSvZNzJ4RkR3sCmgQnyLw: bets $6
DFQVuszLVclqjA46pN4Vvw: raises $6 to $12
NqSvZNzJ4RkR3sCmgQnyLw: raises $32.85 to $44.85 and is all-in
DFQVuszLVclqjA46pN4Vvw: folds
NqSvZNzJ4RkR3sCmgQnyLw collected $35.20 from pot
*** SUMMARY ***
Total pot $37 | Rake $1.80
Board [3c Kh Th Ac]
Seat 1: so5k3vFDmokh2q3dImJ1GQ (small blind) folded before Flop
Seat 2: NqSvZNzJ4RkR3sCmgQnyLw (big blind) collected ($35.20)
Seat 3: GX1heJ+DSsvm7gzSPsYhhQ folded before Flop (didn't bet)
Seat 4: DFQVuszLVclqjA46pN4Vvw folded on the Turn
Seat 5: 37j/5DgMG5m9lMfFofEAOg folded before Flop (didn't bet)
Seat 7: /inIs/z/PcX+TniIFpaxpg folded before Flop (didn't bet)
Seat 8: ZYHoLw2lWmRS7CSHi8L8Xg folded before Flop (didn't bet)
Seat 9: TAfo4veNRaRlzDXMMYS3Jg (button) folded before Flop (didn't bet)



PokerStars Game #59941636256:  Hold'em No Limit ($1/$2) - 2009/07/01 1:41:26 ET
Table 'AtOXMvcrtQM8yLNcALmfLQ' 2-max Seat #1 is the button
Seat 1: +HlQuAsMqZGYYtjcPO/a3A ($314 in chips)
Seat 2: pVqEzK9wXlRMECnb1Zg4Zw ($255.50 in chips)
+HlQuAsMqZGYYtjcPO/a3A: posts small blind $1
pVqEzK9wXlRMECnb1Zg4Zw: posts big blind $2
*** HOLE CARDS ***
+HlQuAsMqZGYYtjcPO/a3A: folds
pVqEzK9wXlRMECnb1Zg4Zw collected $2 from pot
pVqEzK9wXlRMECnb1Zg4Zw: doesn't show hand
*** SUMMARY ***
Total pot $2 | Rake $0
Seat 1: +HlQuAsMqZGYYtjcPO/a3A (button) (small blind) folded before Flop
Seat 2: pVqEzK9wXlRMECnb1Zg4Zw (big blind) collected ($2)



PokerStars Game #59941636092:  Hold'em No Limit ($1/$2) - 2009/07/01 1:41:26 ET
Table 'P/yCfYl1GfGsu/e6DxDy/A' 2-max Seat #2 is the button
Seat 1: 7fOCUy3x9hdkmXkkDNolGQ ($440.50 in chips)
Seat 2: RwDoM55ZeQuI2ADyJhOb2Q ($1036 in chips)
RwDoM55ZeQuI2ADyJhOb2Q: posts small blind $1
7fOCUy3x9hdkmXkkDNolGQ: posts big blind $2
*** HOLE CARDS ***
RwDoM55ZeQuI2ADyJhOb2Q: folds
7fOCUy3x9hdkmXkkDNolGQ collected $2 from pot
7fOCUy3x9hdkmXkkDNolGQ: doesn't show hand
*** SUMMARY ***
Total pot $2 | Rake $0
Seat 1: 7fOCUy3x9hdkmXkkDNolGQ (big blind) collected ($2)
Seat 2: RwDoM55ZeQuI2ADyJhOb2Q (button) (small blind) folded before Flop



PokerStars Game #59941637480:  Hold'em No Limit ($1/$2) - 2009/07/01 1:41:28 ET
Table 'CFkQcfWjKccZaZDf71FK+w' 6-max Seat #4 is the button
Seat 1: vkfxu8f/jMYKUk6Ly4eujw ($239.25 in chips)
Seat 2: ewN/vzF22+/gdzjIKBOlkA ($205.05 in chips)
Seat 3: 09BNF4quPDzanQzM8vc6WA ($40.65 in chips)
Seat 4: ygTTt5ehT4aF86q1a8/R+w ($243.35 in chips)
Seat 5: 2lOU1DcvUZaMcxZ95XfzXw ($185.10 in chips)
Seat 6: ORVqY3rf9X6ANA/8s+On2Q ($44.60 in chips)
2lOU1DcvUZaMcxZ95XfzXw: posts small blind $1
ORVqY3rf9X6ANA/8s+On2Q: posts big blind $2
*** HOLE CARDS ***
vkfxu8f/jMYKUk6Ly4eujw: raises $6 to $8
ewN/vzF22+/gdzjIKBOlkA: folds
09BNF4quPDzanQzM8vc6WA: folds
ygTTt5ehT4aF86q1a8/R+w: folds
2lOU1DcvUZaMcxZ95XfzXw: folds
ORVqY3rf9X6ANA/8s+On2Q: folds
vkfxu8f/jMYKUk6Ly4eujw collected $5 from pot
*** SUMMARY ***
Total pot $5 | Rake $0
Seat 1: vkfxu8f/jMYKUk6Ly4eujw collected ($5)
Seat 2: ewN/vzF22+/gdzjIKBOlkA folded before Flop (didn't bet)
Seat 3: 09BNF4quPDzanQzM8vc6WA folded before Flop (didn't bet)
Seat 4: ygTTt5ehT4aF86q1a8/R+w (button) folded before Flop (didn't bet)
Seat 5: 2lOU1DcvUZaMcxZ95XfzXw (small blind) folded before Flop
Seat 6: ORVqY3rf9X6ANA/8s+On2Q (big blind) folded before Flop



PokerStars Game #59941637780:  Hold'em No Limit ($1/$2) - 2009/07/01 1:41:29 ET
Table 'G1Oqdy4Pqdb5gtx40rUBzA' 6-max Seat #5 is the button
Seat 1: BWhgxe7gWiYobRbwdG+d2Q ($196 in chips)
Seat 3: VvdR9F3I+2yELkfTVvC1dg ($218.90 in chips)
Seat 4: B87ikIyZ/TzAVeXf38Ny0g ($208.55 in chips)
Seat 5: F1+Ml47qRQWunzPnGhLLzQ ($200.40 in chips)
Seat 6: qCnEYuAE5y5A7bk6fO5/jQ ($212.25 in chips)
qCnEYuAE5y5A7bk6fO5/jQ: posts small blind $1
BWhgxe7gWiYobRbwdG+d2Q: posts big blind $2
m7mYVfnCOK5TE/VkN/FhOg: sits out
*** HOLE CARDS ***
VvdR9F3I+2yELkfTVvC1dg: folds
B87ikIyZ/TzAVeXf38Ny0g: raises $4 to $6
F1+Ml47qRQWunzPnGhLLzQ: folds
qCnEYuAE5y5A7bk6fO5/jQ: folds
BWhgxe7gWiYobRbwdG+d2Q: folds
B87ikIyZ/TzAVeXf38Ny0g collected $5 from pot
B87ikIyZ/TzAVeXf38Ny0g: doesn't show hand
*** SUMMARY ***
Total pot $5 | Rake $0
Seat 1: BWhgxe7gWiYobRbwdG+d2Q (big blind) folded before Flop
Seat 3: VvdR9F3I+2yELkfTVvC1dg folded before Flop (didn't bet)
Seat 4: B87ikIyZ/TzAVeXf38Ny0g collected ($5)
Seat 5: F1+Ml47qRQWunzPnGhLLzQ (button) folded before Flop (didn't bet)
Seat 6: qCnEYuAE5y5A7bk6fO5/jQ (small blind) folded before Flop



PokerStars Game #59941638980:  Hold'em No Limit ($1/$2) - 2009/07/01 1:41:31 ET
Table '4NGNnZ/osQfNq6abYqkJeA' 6-max Seat #3 is the button
Seat 2: 669iGNwYwgRZg3nhS+aDAQ ($118.70 in chips)
Seat 3: 54yWzRRgS0oZ+S6LwZBxMQ ($19.80 in chips)
Seat 4: sY+4Uuh5z/6AbXXaCS10jw ($231.25 in chips)
Seat 5: VvdR9F3I+2yELkfTVvC1dg ($238.55 in chips)
Seat 6: /PH6Ffnho4Ysm8S3V/oa+w ($40 in chips)
sY+4Uuh5z/6AbXXaCS10jw: posts small blind $1
VvdR9F3I+2yELkfTVvC1dg: posts big blind $2
*** HOLE CARDS ***
/PH6Ffnho4Ysm8S3V/oa+w: folds
669iGNwYwgRZg3nhS+aDAQ: folds
54yWzRRgS0oZ+S6LwZBxMQ: raises $17.80 to $19.80 and is all-in
sY+4Uuh5z/6AbXXaCS10jw: folds
VvdR9F3I+2yELkfTVvC1dg: folds
54yWzRRgS0oZ+S6LwZBxMQ collected $5 from pot
54yWzRRgS0oZ+S6LwZBxMQ: doesn't show hand
*** SUMMARY ***
Total pot $5 | Rake $0
Seat 2: 669iGNwYwgRZg3nhS+aDAQ folded before Flop (didn't bet)
Seat 3: 54yWzRRgS0oZ+S6LwZBxMQ (button) collected ($5)
Seat 4: sY+4Uuh5z/6AbXXaCS10jw (small blind) folded before Flop
Seat 5: VvdR9F3I+2yELkfTVvC1dg (big blind) folded before Flop
Seat 6: /PH6Ffnho4Ysm8S3V/oa+w folded before Flop (didn't bet)



PokerStars Game #59941639692:  Hold'em No Limit ($1/$2) - 2009/07/01 1:41:32 ET
Table 'rKeCh+eBn4RNvybCUYkoTQ' 9-max Seat #3 is the button
Seat 1: /inIs/z/PcX+TniIFpaxpg ($179 in chips)
Seat 2: nXDI8Y/S6POzRwANu3d8hQ ($131.25 in chips)
Seat 3: GX1heJ+DSsvm7gzSPsYhhQ ($40 in chips)
Seat 5: WUlHm+ydPPHG7Lb0rePSdA ($120 in chips)
Seat 6: EBV6OktyeSmh4w6sWmcWOw ($286.80 in chips)
Seat 7: rW/MyplHylMSBRaoRUzWrg ($40 in chips)
Seat 8: pN/Ip0ePsUVIdUlGgLrkUw ($246.35 in chips)
Seat 9: Kzta8yu9vxHT4B70mjBZ+w ($200 in chips)
31HuO+DQxppUQEedBWukug will be allowed to play after the button
WUlHm+ydPPHG7Lb0rePSdA: posts small blind $1
EBV6OktyeSmh4w6sWmcWOw: posts big blind $2
*** HOLE CARDS ***
rW/MyplHylMSBRaoRUzWrg: folds
pN/Ip0ePsUVIdUlGgLrkUw: folds
Kzta8yu9vxHT4B70mjBZ+w: folds
Kzta8yu9vxHT4B70mjBZ+w leaves the table
/inIs/z/PcX+TniIFpaxpg: raises $6 to $8
nXDI8Y/S6POzRwANu3d8hQ: folds
GX1heJ+DSsvm7gzSPsYhhQ: folds
WUlHm+ydPPHG7Lb0rePSdA: folds
EBV6OktyeSmh4w6sWmcWOw: folds
/inIs/z/PcX+TniIFpaxpg collected $5 from pot
/inIs/z/PcX+TniIFpaxpg: doesn't show hand
*** SUMMARY ***
Total pot $5 | Rake $0
Seat 1: /inIs/z/PcX+TniIFpaxpg collected ($5)
Seat 2: nXDI8Y/S6POzRwANu3d8hQ folded before Flop (didn't bet)
Seat 3: GX1heJ+DSsvm7gzSPsYhhQ (button) folded before Flop (didn't bet)
Seat 5: WUlHm+ydPPHG7Lb0rePSdA (small blind) folded before Flop
Seat 6: EBV6OktyeSmh4w6sWmcWOw (big blind) folded before Flop
Seat 7: rW/MyplHylMSBRaoRUzWrg folded before Flop (didn't bet)
Seat 8: pN/Ip0ePsUVIdUlGgLrkUw folded before Flop (didn't bet)
Seat 9: Kzta8yu9vxHT4B70mjBZ+w folded before Flop (didn't bet)



PokerStars Game #59941639646:  Hold'em No Limit ($1/$2) - 2009/07/01 1:41:32 ET
Table 'mGpP9StWRnoeiBDExc6Frg' 6-max Seat #3 is the button
Seat 1: VvdR9F3I+2yELkfTVvC1dg ($309.15 in chips)
Seat 2: vkfxu8f/jMYKUk6Ly4eujw ($204 in chips)
Seat 3: 7acrZUQC3Zc9BNLjoKIcLQ ($27.85 in chips)
Seat 4: 4dcDwIHRm96PwtqkpQiuiA ($67.70 in chips)
Seat 5: d1puGuVBE0fidn+5eRJ0tw ($210.55 in chips)
Seat 6: B2Ih1sr5VZk+8He7rcrMtQ ($414.05 in chips)
4dcDwIHRm96PwtqkpQiuiA: posts small blind $1
d1puGuVBE0fidn+5eRJ0tw: posts big blind $2
*** HOLE CARDS ***
B2Ih1sr5VZk+8He7rcrMtQ: calls $2
VvdR9F3I+2yELkfTVvC1dg: folds
vkfxu8f/jMYKUk6Ly4eujw: folds
7acrZUQC3Zc9BNLjoKIcLQ: folds
4dcDwIHRm96PwtqkpQiuiA: folds
d1puGuVBE0fidn+5eRJ0tw: checks
*** FLOP *** [Th 5h 2d]
d1puGuVBE0fidn+5eRJ0tw: checks
B2Ih1sr5VZk+8He7rcrMtQ: bets $6
d1puGuVBE0fidn+5eRJ0tw: folds
B2Ih1sr5VZk+8He7rcrMtQ collected $4.75 from pot
*** SUMMARY ***
Total pot $5 | Rake $0.25
Board [Th 5h 2d]
Seat 1: VvdR9F3I+2yELkfTVvC1dg folded before Flop (didn't bet)
Seat 2: vkfxu8f/jMYKUk6Ly4eujw folded before Flop (didn't bet)
Seat 3: 7acrZUQC3Zc9BNLjoKIcLQ (button) folded before Flop (didn't bet)
Seat 4: 4dcDwIHRm96PwtqkpQiuiA (small blind) folded before Flop
Seat 5: d1puGuVBE0fidn+5eRJ0tw (big blind) folded on the Flop
Seat 6: B2Ih1sr5VZk+8He7rcrMtQ collected ($4.75)



PokerStars Game #59941640246:  Hold'em No Limit ($1/$2) - 2009/07/01 1:41:33 ET
Table 'NmY84NAf9Mh0ckAckHnh5g' 2-max Seat #1 is the button
Seat 1: 6hvg964TSqZ3AL/0XK9aVQ ($517.70 in chips)
Seat 2: RwDoM55ZeQuI2ADyJhOb2Q ($474 in chips)
6hvg964TSqZ3AL/0XK9aVQ: posts small blind $1
RwDoM55ZeQuI2ADyJhOb2Q: posts big blind $2
*** HOLE CARDS ***
6hvg964TSqZ3AL/0XK9aVQ: folds
RwDoM55ZeQuI2ADyJhOb2Q collected $2 from pot
RwDoM55ZeQuI2ADyJhOb2Q: doesn't show hand
*** SUMMARY ***
Total pot $2 | Rake $0
Seat 1: 6hvg964TSqZ3AL/0XK9aVQ (button) (small blind) folded before Flop
Seat 2: RwDoM55ZeQuI2ADyJhOb2Q (big blind) collected ($2)



PokerStars Game #59941640206:  Hold'em No Limit ($1/$2) - 2009/07/01 1:41:33 ET
Table 'P/yCfYl1GfGsu/e6DxDy/A' 2-max Seat #1 is the button
Seat 1: 7fOCUy3x9hdkmXkkDNolGQ ($441.50 in chips)
Seat 2: RwDoM55ZeQuI2ADyJhOb2Q ($1035 in chips)
7fOCUy3x9hdkmXkkDNolGQ: posts small blind $1
RwDoM55ZeQuI2ADyJhOb2Q: posts big blind $2
*** HOLE CARDS ***
7fOCUy3x9hdkmXkkDNolGQ: folds
RwDoM55ZeQuI2ADyJhOb2Q collected $2 from pot
RwDoM55ZeQuI2ADyJhOb2Q: doesn't show hand
*** SUMMARY ***
Total pot $2 | Rake $0
Seat 1: 7fOCUy3x9hdkmXkkDNolGQ (button) (small blind) folded before Flop
Seat 2: RwDoM55ZeQuI2ADyJhOb2Q (big blind) collected ($2)



PokerStars Game #59941640810:  Hold'em No Limit ($1/$2) - 2009/07/01 1:41:34 ET
Table 'ztv6V3FN2bQ9nmJPPdx6nQ' 6-max Seat #4 is the button
Seat 1: 6fLdOUCRtX71xbVRhJEq8w ($238.35 in chips)
Seat 2: 5Y+ZGWLI4gnlpApDX5vy1A ($402.40 in chips)
Seat 3: ubtx4Z5L+AcK71MTvYiGVw ($244.20 in chips)
Seat 4: UaZ5yj+6LjtWqMQg2QskUw ($82.30 in chips)
Seat 5: sTPOWERd9HWPCNrDBwsVjA ($218.60 in chips)
Seat 6: mfy7uGZcqA2PVQqEVbJ7+g ($109.60 in chips)
sTPOWERd9HWPCNrDBwsVjA: posts small blind $1
mfy7uGZcqA2PVQqEVbJ7+g: posts big blind $2
*** HOLE CARDS ***
6fLdOUCRtX71xbVRhJEq8w: folds
5Y+ZGWLI4gnlpApDX5vy1A: folds
ubtx4Z5L+AcK71MTvYiGVw: raises $6 to $8
UaZ5yj+6LjtWqMQg2QskUw: folds
sTPOWERd9HWPCNrDBwsVjA: folds
mfy7uGZcqA2PVQqEVbJ7+g: folds
ubtx4Z5L+AcK71MTvYiGVw collected $5 from pot
ubtx4Z5L+AcK71MTvYiGVw: doesn't show hand
*** SUMMARY ***
Total pot $5 | Rake $0
Seat 1: 6fLdOUCRtX71xbVRhJEq8w folded before Flop (didn't bet)
Seat 2: 5Y+ZGWLI4gnlpApDX5vy1A folded before Flop (didn't bet)
Seat 3: ubtx4Z5L+AcK71MTvYiGVw collected ($5)
Seat 4: UaZ5yj+6LjtWqMQg2QskUw (button) folded before Flop (didn't bet)
Seat 5: sTPOWERd9HWPCNrDBwsVjA (small blind) folded before Flop
Seat 6: mfy7uGZcqA2PVQqEVbJ7+g (big blind) folded before Flop



PokerStars Game #59941641814:  Hold'em No Limit ($1/$2) - 2009/07/01 1:41:36 ET
Table 'UGLAZZyv+cXmnKjYin0etA' 6-max Seat #3 is the button
Seat 1: vkfxu8f/jMYKUk6Ly4eujw ($203 in chips)
Seat 2: eDLH1PUXFpvJBNMXBVQcGA ($310.10 in chips)
Seat 3: ygTTt5ehT4aF86q1a8/R+w ($111.20 in chips)
Seat 4: SiGJDsvRViJX05vHhA80GQ ($232.85 in chips)
Seat 5: 54yWzRRgS0oZ+S6LwZBxMQ ($33.75 in chips)
Seat 6: sTPOWERd9HWPCNrDBwsVjA ($218.15 in chips)
SiGJDsvRViJX05vHhA80GQ: posts small blind $1
54yWzRRgS0oZ+S6LwZBxMQ: posts big blind $2
*** HOLE CARDS ***
sTPOWERd9HWPCNrDBwsVjA: raises $4 to $6
vkfxu8f/jMYKUk6Ly4eujw: folds
eDLH1PUXFpvJBNMXBVQcGA: folds
ygTTt5ehT4aF86q1a8/R+w: folds
SiGJDsvRViJX05vHhA80GQ: folds
54yWzRRgS0oZ+S6LwZBxMQ: folds
sTPOWERd9HWPCNrDBwsVjA collected $5 from pot
*** SUMMARY ***
Total pot $5 | Rake $0
Seat 1: vkfxu8f/jMYKUk6Ly4eujw folded before Flop (didn't bet)
Seat 2: eDLH1PUXFpvJBNMXBVQcGA folded before Flop (didn't bet)
Seat 3: ygTTt5ehT4aF86q1a8/R+w (button) folded before Flop (didn't bet)
Seat 4: SiGJDsvRViJX05vHhA80GQ (small blind) folded before Flop
Seat 5: 54yWzRRgS0oZ+S6LwZBxMQ (big blind) folded before Flop
Seat 6: sTPOWERd9HWPCNrDBwsVjA collected ($5)



PokerStars Game #59941642328:  Hold'em No Limit ($1/$2) - 2009/07/01 1:41:37 ET
Table 'gnHBqWll9O3fxG7Ojkz/ng' 9-max Seat #9 is the button
Seat 1: TAfo4veNRaRlzDXMMYS3Jg ($34 in chips)
Seat 2: H6Z4+qu8gR0VUiPOijndVg ($331.95 in chips)
Seat 3: 5Q8U6iZbeO7xJSS4qvDP5g ($218.05 in chips)
Seat 4: nXDI8Y/S6POzRwANu3d8hQ ($19 in chips)
Seat 5: rBQDMkKm9cZn6M9NPsiVew ($220.15 in chips)
Seat 6: KqHysDSpCPaPyK3tJC1aEw ($200 in chips)
Seat 7: jqui3xAWCkcdPW36a6BD+w ($342.55 in chips)
Seat 8: cM6efHzdxoqYm0EQKP4TTQ ($114.20 in chips)
Seat 9: GX1heJ+DSsvm7gzSPsYhhQ ($45.35 in chips)
TAfo4veNRaRlzDXMMYS3Jg: posts small blind $1
H6Z4+qu8gR0VUiPOijndVg: posts big blind $2
*** HOLE CARDS ***
5Q8U6iZbeO7xJSS4qvDP5g: folds
nXDI8Y/S6POzRwANu3d8hQ: folds
rBQDMkKm9cZn6M9NPsiVew: folds
KqHysDSpCPaPyK3tJC1aEw: folds
jqui3xAWCkcdPW36a6BD+w: folds
cM6efHzdxoqYm0EQKP4TTQ: folds
GX1heJ+DSsvm7gzSPsYhhQ: folds
TAfo4veNRaRlzDXMMYS3Jg: raises $32 to $34 and is all-in
H6Z4+qu8gR0VUiPOijndVg: folds
TAfo4veNRaRlzDXMMYS3Jg collected $4 from pot
TAfo4veNRaRlzDXMMYS3Jg: doesn't show hand
*** SUMMARY ***
Total pot $4 | Rake $0
Seat 1: TAfo4veNRaRlzDXMMYS3Jg (small blind) collected ($4)
Seat 2: H6Z4+qu8gR0VUiPOijndVg (big blind) folded before Flop
Seat 3: 5Q8U6iZbeO7xJSS4qvDP5g folded before Flop (didn't bet)
Seat 4: nXDI8Y/S6POzRwANu3d8hQ folded before Flop (didn't bet)
Seat 5: rBQDMkKm9cZn6M9NPsiVew folded before Flop (didn't bet)
Seat 6: KqHysDSpCPaPyK3tJC1aEw folded before Flop (didn't bet)
Seat 7: jqui3xAWCkcdPW36a6BD+w folded before Flop (didn't bet)
Seat 8: cM6efHzdxoqYm0EQKP4TTQ folded before Flop (didn't bet)
Seat 9: GX1heJ+DSsvm7gzSPsYhhQ (button) folded before Flop (didn't bet)



PokerStars Game #59941643012:  Hold'em No Limit ($1/$2) - 2009/07/01 1:41:38 ET
Table 'uJ9juaXXg9yIcSU8amxaXQ' 6-max Seat #4 is the button
Seat 1: JsqOjN/eHz0uYVf/PyUJ6Q ($150.25 in chips)
Seat 2: VvdR9F3I+2yELkfTVvC1dg ($219.10 in chips)
Seat 3: qXDd0ZyMIse0OBu8pxeQ3Q ($243.40 in chips)
Seat 4: zNjJ/y4emmF+vzrCDd+ooA ($228.45 in chips)
Seat 5: YsLQ3BAvgQHWXMAv3Wv6Hg ($206.70 in chips)
Seat 6: /PH6Ffnho4Ysm8S3V/oa+w ($43 in chips)
YsLQ3BAvgQHWXMAv3Wv6Hg: posts small blind $1
/PH6Ffnho4Ysm8S3V/oa+w: posts big blind $2
*** HOLE CARDS ***
JsqOjN/eHz0uYVf/PyUJ6Q: folds
VvdR9F3I+2yELkfTVvC1dg: raises $2 to $4
qXDd0ZyMIse0OBu8pxeQ3Q: folds
zNjJ/y4emmF+vzrCDd+ooA: folds
YsLQ3BAvgQHWXMAv3Wv6Hg: raises $12 to $16
/PH6Ffnho4Ysm8S3V/oa+w: folds
VvdR9F3I+2yELkfTVvC1dg: folds
YsLQ3BAvgQHWXMAv3Wv6Hg collected $10 from pot
YsLQ3BAvgQHWXMAv3Wv6Hg: doesn't show hand
*** SUMMARY ***
Total pot $10 | Rake $0
Seat 1: JsqOjN/eHz0uYVf/PyUJ6Q folded before Flop (didn't bet)
Seat 2: VvdR9F3I+2yELkfTVvC1dg folded before Flop
Seat 3: qXDd0ZyMIse0OBu8pxeQ3Q folded before Flop (didn't bet)
Seat 4: zNjJ/y4emmF+vzrCDd+ooA (button) folded before Flop (didn't bet)
Seat 5: YsLQ3BAvgQHWXMAv3Wv6Hg (small blind) collected ($10)
Seat 6: /PH6Ffnho4Ysm8S3V/oa+w (big blind) folded before Flop



PokerStars Game #59941642872:  Hold'em No Limit ($1/$2) - 2009/07/01 1:41:38 ET
Table 'jlrIxbrVIG+gjaUYT4za8g' 6-max Seat #2 is the button
Seat 1: ygTTt5ehT4aF86q1a8/R+w ($232.30 in chips)
Seat 2: /PH6Ffnho4Ysm8S3V/oa+w ($60 in chips)
Seat 3: gnYme0DNFflnMhrdbxe1Ag ($201 in chips)
Seat 4: 8srN1dKQePlsv0GyTada+Q ($266.95 in chips)
Seat 5: AyBB0k3Dcl7xbXUeGMw06g ($40.40 in chips)
gnYme0DNFflnMhrdbxe1Ag: posts small blind $1
8srN1dKQePlsv0GyTada+Q: posts big blind $2
BWhgxe7gWiYobRbwdG+d2Q: sits out
*** HOLE CARDS ***
AyBB0k3Dcl7xbXUeGMw06g: folds
ygTTt5ehT4aF86q1a8/R+w: raises $4 to $6
/PH6Ffnho4Ysm8S3V/oa+w: folds
gnYme0DNFflnMhrdbxe1Ag: folds
8srN1dKQePlsv0GyTada+Q: folds
ygTTt5ehT4aF86q1a8/R+w collected $5 from pot
*** SUMMARY ***
Total pot $5 | Rake $0
Seat 1: ygTTt5ehT4aF86q1a8/R+w collected ($5)
Seat 2: /PH6Ffnho4Ysm8S3V/oa+w (button) folded before Flop (didn't bet)
Seat 3: gnYme0DNFflnMhrdbxe1Ag (small blind) folded before Flop
Seat 4: 8srN1dKQePlsv0GyTada+Q (big blind) folded before Flop
Seat 5: AyBB0k3Dcl7xbXUeGMw06g folded before Flop (didn't bet)



PokerStars Game #59941643816:  Hold'em No Limit ($1/$2) - 2009/07/01 1:41:39 ET
Table 'NmY84NAf9Mh0ckAckHnh5g' 2-max Seat #2 is the button
Seat 1: 6hvg964TSqZ3AL/0XK9aVQ ($516.70 in chips)
Seat 2: RwDoM55ZeQuI2ADyJhOb2Q ($475 in chips)
RwDoM55ZeQuI2ADyJhOb2Q: posts small blind $1
6hvg964TSqZ3AL/0XK9aVQ: posts big blind $2
*** HOLE CARDS ***
RwDoM55ZeQuI2ADyJhOb2Q: raises $4 to $6
6hvg964TSqZ3AL/0XK9aVQ: calls $4
*** FLOP *** [8c 4s 3c]
6hvg964TSqZ3AL/0XK9aVQ: checks
RwDoM55ZeQuI2ADyJhOb2Q: bets $15
6hvg964TSqZ3AL/0XK9aVQ: calls $15
*** TURN *** [8c 4s 3c] [4d]
6hvg964TSqZ3AL/0XK9aVQ: checks
RwDoM55ZeQuI2ADyJhOb2Q: bets $82
6hvg964TSqZ3AL/0XK9aVQ: folds
RwDoM55ZeQuI2ADyJhOb2Q collected $41.50 from pot
RwDoM55ZeQuI2ADyJhOb2Q: doesn't show hand
*** SUMMARY ***
Total pot $42 | Rake $0.50
Board [8c 4s 3c 4d]
Seat 1: 6hvg964TSqZ3AL/0XK9aVQ (big blind) folded on the Turn
Seat 2: RwDoM55ZeQuI2ADyJhOb2Q (button) (small blind) collected ($41.50)



PokerStars Game #59941643564:  Hold'em No Limit ($1/$2) - 2009/07/01 1:41:39 ET
Table 'P/yCfYl1GfGsu/e6DxDy/A' 2-max Seat #2 is the button
Seat 1: 7fOCUy3x9hdkmXkkDNolGQ ($440.50 in chips)
Seat 2: RwDoM55ZeQuI2ADyJhOb2Q ($1036 in chips)
RwDoM55ZeQuI2ADyJhOb2Q: posts small blind $1
7fOCUy3x9hdkmXkkDNolGQ: posts big blind $2
*** HOLE CARDS ***
RwDoM55ZeQuI2ADyJhOb2Q: folds
7fOCUy3x9hdkmXkkDNolGQ collected $2 from pot
7fOCUy3x9hdkmXkkDNolGQ: doesn't show hand
*** SUMMARY ***
Total pot $2 | Rake $0
Seat 1: 7fOCUy3x9hdkmXkkDNolGQ (big blind) collected ($2)
Seat 2: RwDoM55ZeQuI2ADyJhOb2Q (button) (small blind) folded before Flop



PokerStars Game #59941644434:  Hold'em No Limit ($1/$2) - 2009/07/01 1:41:40 ET
Table 'ZzSIe0zTCDv+n6hfbY5tTg' 6-max Seat #1 is the button
Seat 1: VvdR9F3I+2yELkfTVvC1dg ($254 in chips)
Seat 2: B87ikIyZ/TzAVeXf38Ny0g ($235 in chips)
Seat 3: gsugPj31Hui3Jefl98MBOA ($356 in chips)
Seat 5: 3dAbvkxS5NPQTBAbvpinVg ($503.10 in chips)
Seat 6: 09BNF4quPDzanQzM8vc6WA ($36 in chips)
B87ikIyZ/TzAVeXf38Ny0g: posts small blind $1
gsugPj31Hui3Jefl98MBOA: posts big blind $2
54yWzRRgS0oZ+S6LwZBxMQ: sits out
*** HOLE CARDS ***
3dAbvkxS5NPQTBAbvpinVg: raises $4 to $6
09BNF4quPDzanQzM8vc6WA: folds
VvdR9F3I+2yELkfTVvC1dg: folds
B87ikIyZ/TzAVeXf38Ny0g: folds
gsugPj31Hui3Jefl98MBOA: calls $4
*** FLOP *** [5h Ad Js]
gsugPj31Hui3Jefl98MBOA: checks
3dAbvkxS5NPQTBAbvpinVg: checks
*** TURN *** [5h Ad Js] [7s]
gsugPj31Hui3Jefl98MBOA: checks
3dAbvkxS5NPQTBAbvpinVg: checks
*** RIVER *** [5h Ad Js 7s] [Kh]
gsugPj31Hui3Jefl98MBOA: checks
3dAbvkxS5NPQTBAbvpinVg: checks
*** SHOW DOWN ***
gsugPj31Hui3Jefl98MBOA: shows [8c 6c] (high card Ace)
3dAbvkxS5NPQTBAbvpinVg: shows [6s 6h] (a pair of Sixes)
3dAbvkxS5NPQTBAbvpinVg collected $12.35 from pot
*** SUMMARY ***
Total pot $13 | Rake $0.65
Board [5h Ad Js 7s Kh]
Seat 1: VvdR9F3I+2yELkfTVvC1dg (button) folded before Flop (didn't bet)
Seat 2: B87ikIyZ/TzAVeXf38Ny0g (small blind) folded before Flop
Seat 3: gsugPj31Hui3Jefl98MBOA (big blind) showed [8c 6c] and lost with high card Ace
Seat 5: 3dAbvkxS5NPQTBAbvpinVg showed [6s 6h] and won ($12.35) with a pair of Sixes
Seat 6: 09BNF4quPDzanQzM8vc6WA folded before Flop (didn't bet)



PokerStars Game #59941644122:  Hold'em No Limit ($1/$2) - 2009/07/01 1:41:40 ET
Table 'eyAQSIlgc2o1Jxvbve4WGg' 9-max Seat #2 is the button
Seat 1: UZEsV9yKUMqmpYPiOFpaZw ($63.20 in chips)
Seat 2: kM9CA+2UcdMjbCMbtUCGiA ($200 in chips)
Seat 4: CkE3IyJF1KvdaAOmZY5XqQ ($200 in chips)
Seat 5: mIKx5lhIt13X5eZQH0ZeMA ($131.40 in chips)
Seat 6: nXDI8Y/S6POzRwANu3d8hQ ($70 in chips)
Seat 7: u3OrI5uGx9mx1fE7dgr+EA ($72.50 in chips)
Seat 8: 1CtiZuXDFaJL1dJPQKyi8Q ($152.95 in chips)
Seat 9: WUlHm+ydPPHG7Lb0rePSdA ($143.20 in chips)
CkE3IyJF1KvdaAOmZY5XqQ: posts small blind $1
mIKx5lhIt13X5eZQH0ZeMA: posts big blind $2
*** HOLE CARDS ***
nXDI8Y/S6POzRwANu3d8hQ: folds
u3OrI5uGx9mx1fE7dgr+EA: calls $2
1CtiZuXDFaJL1dJPQKyi8Q: folds
WUlHm+ydPPHG7Lb0rePSdA: folds
UZEsV9yKUMqmpYPiOFpaZw: raises $2 to $4
kM9CA+2UcdMjbCMbtUCGiA: calls $4
CkE3IyJF1KvdaAOmZY5XqQ: folds
mIKx5lhIt13X5eZQH0ZeMA: folds
u3OrI5uGx9mx1fE7dgr+EA: calls $2
*** FLOP *** [5h 4h Ks]
u3OrI5uGx9mx1fE7dgr+EA: bets $2
UZEsV9yKUMqmpYPiOFpaZw: raises $4 to $6
kM9CA+2UcdMjbCMbtUCGiA: raises $16 to $22
u3OrI5uGx9mx1fE7dgr+EA: folds
UZEsV9yKUMqmpYPiOFpaZw: folds
kM9CA+2UcdMjbCMbtUCGiA collected $27.60 from pot
kM9CA+2UcdMjbCMbtUCGiA: doesn't show hand
*** SUMMARY ***
Total pot $29 | Rake $1.40
Board [5h 4h Ks]
Seat 1: UZEsV9yKUMqmpYPiOFpaZw folded on the Flop
Seat 2: kM9CA+2UcdMjbCMbtUCGiA (button) collected ($27.60)
Seat 4: CkE3IyJF1KvdaAOmZY5XqQ (small blind) folded before Flop
Seat 5: mIKx5lhIt13X5eZQH0ZeMA (big blind) folded before Flop
Seat 6: nXDI8Y/S6POzRwANu3d8hQ folded before Flop (didn't bet)
Seat 7: u3OrI5uGx9mx1fE7dgr+EA folded on the Flop
Seat 8: 1CtiZuXDFaJL1dJPQKyi8Q folded before Flop (didn't bet)
Seat 9: WUlHm+ydPPHG7Lb0rePSdA folded before Flop (didn't bet)



PokerStars Game #59941644918:  Hold'em No Limit ($1/$2) - 2009/07/01 1:41:41 ET
Table 'bJQ024BaYSBrW0sXpCZbNQ' 6-max Seat #2 is the button
Seat 1: KfwW5us6tydK81NYTtK1gw ($203 in chips)
Seat 2: 3dAbvkxS5NPQTBAbvpinVg ($200 in chips)
Seat 3: /PH6Ffnho4Ysm8S3V/oa+w ($40 in chips)
Seat 4: TBaQIN+sQ7eb7P99QnaORQ ($85.80 in chips)
Seat 5: VvdR9F3I+2yELkfTVvC1dg ($200 in chips)
Seat 6: 4bqvCfJ0e8CTYnn0Go9hbQ ($146.20 in chips)
/PH6Ffnho4Ysm8S3V/oa+w: posts small blind $1
TBaQIN+sQ7eb7P99QnaORQ: posts big blind $2
*** HOLE CARDS ***
VvdR9F3I+2yELkfTVvC1dg: folds
4bqvCfJ0e8CTYnn0Go9hbQ: folds
KfwW5us6tydK81NYTtK1gw: folds
3dAbvkxS5NPQTBAbvpinVg: raises $4 to $6
/PH6Ffnho4Ysm8S3V/oa+w: folds
TBaQIN+sQ7eb7P99QnaORQ: folds
3dAbvkxS5NPQTBAbvpinVg collected $5 from pot
3dAbvkxS5NPQTBAbvpinVg: doesn't show hand
*** SUMMARY ***
Total pot $5 | Rake $0
Seat 1: KfwW5us6tydK81NYTtK1gw folded before Flop (didn't bet)
Seat 2: 3dAbvkxS5NPQTBAbvpinVg (button) collected ($5)
Seat 3: /PH6Ffnho4Ysm8S3V/oa+w (small blind) folded before Flop
Seat 4: TBaQIN+sQ7eb7P99QnaORQ (big blind) folded before Flop
Seat 5: VvdR9F3I+2yELkfTVvC1dg folded before Flop (didn't bet)
Seat 6: 4bqvCfJ0e8CTYnn0Go9hbQ folded before Flop (didn't bet)



PokerStars Game #59941646210:  Hold'em No Limit ($1/$2) - 2009/07/01 1:41:43 ET
Table 'G1Oqdy4Pqdb5gtx40rUBzA' 6-max Seat #6 is the button
Seat 1: BWhgxe7gWiYobRbwdG+d2Q ($196 in chips)
Seat 2: m7mYVfnCOK5TE/VkN/FhOg ($200 in chips)
Seat 3: VvdR9F3I+2yELkfTVvC1dg ($218.90 in chips)
Seat 4: B87ikIyZ/TzAVeXf38Ny0g ($211.55 in chips)
Seat 5: F1+Ml47qRQWunzPnGhLLzQ ($200.40 in chips)
Seat 6: qCnEYuAE5y5A7bk6fO5/jQ ($211.25 in chips)
BWhgxe7gWiYobRbwdG+d2Q: posts small blind $1
m7mYVfnCOK5TE/VkN/FhOg: posts big blind $2
*** HOLE CARDS ***
VvdR9F3I+2yELkfTVvC1dg: folds
B87ikIyZ/TzAVeXf38Ny0g: folds
F1+Ml47qRQWunzPnGhLLzQ: raises $4 to $6
qCnEYuAE5y5A7bk6fO5/jQ: folds
BWhgxe7gWiYobRbwdG+d2Q: folds
m7mYVfnCOK5TE/VkN/FhOg: folds
F1+Ml47qRQWunzPnGhLLzQ collected $5 from pot
F1+Ml47qRQWunzPnGhLLzQ: doesn't show hand
*** SUMMARY ***
Total pot $5 | Rake $0
Seat 1: BWhgxe7gWiYobRbwdG+d2Q (small blind) folded before Flop
Seat 2: m7mYVfnCOK5TE/VkN/FhOg (big blind) folded before Flop
Seat 3: VvdR9F3I+2yELkfTVvC1dg folded before Flop (didn't bet)
Seat 4: B87ikIyZ/TzAVeXf38Ny0g folded before Flop (didn't bet)
Seat 5: F1+Ml47qRQWunzPnGhLLzQ collected ($5)
Seat 6: qCnEYuAE5y5A7bk6fO5/jQ (button) folded before Flop (didn't bet)



PokerStars Game #59941646546:  Hold'em No Limit ($1/$2) - 2009/07/01 1:41:44 ET
Table 'pPQgcj9XT9CHBsbo1WTBug' 6-max Seat #4 is the button
Seat 1: DFVYDA6dKQy7R7mGIKogZA ($133.75 in chips)
Seat 2: qXDd0ZyMIse0OBu8pxeQ3Q ($200 in chips)
Seat 3: 54yWzRRgS0oZ+S6LwZBxMQ ($114 in chips)
Seat 4: gqlysXCbT8V54f/1lf9h3A ($18.45 in chips)
Seat 5: vkfxu8f/jMYKUk6Ly4eujw ($194.55 in chips)
vkfxu8f/jMYKUk6Ly4eujw: posts small blind $1
DFVYDA6dKQy7R7mGIKogZA: posts big blind $2
*** HOLE CARDS ***
qXDd0ZyMIse0OBu8pxeQ3Q: folds
54yWzRRgS0oZ+S6LwZBxMQ: folds
gqlysXCbT8V54f/1lf9h3A: calls $2
vkfxu8f/jMYKUk6Ly4eujw: folds
DFVYDA6dKQy7R7mGIKogZA: checks
*** FLOP *** [6d 9s 3c]
DFVYDA6dKQy7R7mGIKogZA: checks
gqlysXCbT8V54f/1lf9h3A: bets $6
DFVYDA6dKQy7R7mGIKogZA: raises $14 to $20
gqlysXCbT8V54f/1lf9h3A: calls $10.45 and is all-in
*** TURN *** [6d 9s 3c] [2h]
*** RIVER *** [6d 9s 3c 2h] [Td]
*** SHOW DOWN ***
DFVYDA6dKQy7R7mGIKogZA: shows [6s 8h] (a pair of Sixes)
gqlysXCbT8V54f/1lf9h3A: mucks hand
DFVYDA6dKQy7R7mGIKogZA collected $36.05 from pot
*** SUMMARY ***
Total pot $37.90 | Rake $1.85
Board [6d 9s 3c 2h Td]
Seat 1: DFVYDA6dKQy7R7mGIKogZA (big blind) showed [6s 8h] and won ($36.05) with a pair of Sixes
Seat 2: qXDd0ZyMIse0OBu8pxeQ3Q folded before Flop (didn't bet)
Seat 3: 54yWzRRgS0oZ+S6LwZBxMQ folded before Flop (didn't bet)
Seat 4: gqlysXCbT8V54f/1lf9h3A (button) mucked
Seat 5: vkfxu8f/jMYKUk6Ly4eujw (small blind) folded before Flop



PokerStars Game #59941646674:  Hold'em No Limit ($1/$2) - 2009/07/01 1:41:44 ET
Table '4NGNnZ/osQfNq6abYqkJeA' 6-max Seat #4 is the button
Seat 2: 669iGNwYwgRZg3nhS+aDAQ ($118.70 in chips)
Seat 3: 54yWzRRgS0oZ+S6LwZBxMQ ($22.80 in chips)
Seat 4: sY+4Uuh5z/6AbXXaCS10jw ($230.25 in chips)
Seat 5: VvdR9F3I+2yELkfTVvC1dg ($236.55 in chips)
Seat 6: /PH6Ffnho4Ysm8S3V/oa+w ($40 in chips)
VvdR9F3I+2yELkfTVvC1dg: posts small blind $1
/PH6Ffnho4Ysm8S3V/oa+w: posts big blind $2
*** HOLE CARDS ***
669iGNwYwgRZg3nhS+aDAQ: raises $8 to $10
54yWzRRgS0oZ+S6LwZBxMQ: folds
sY+4Uuh5z/6AbXXaCS10jw: folds
VvdR9F3I+2yELkfTVvC1dg: folds
/PH6Ffnho4Ysm8S3V/oa+w: folds
669iGNwYwgRZg3nhS+aDAQ collected $5 from pot
*** SUMMARY ***
Total pot $5 | Rake $0
Seat 2: 669iGNwYwgRZg3nhS+aDAQ collected ($5)
Seat 3: 54yWzRRgS0oZ+S6LwZBxMQ folded before Flop (didn't bet)
Seat 4: sY+4Uuh5z/6AbXXaCS10jw (button) folded before Flop (didn't bet)
Seat 5: VvdR9F3I+2yELkfTVvC1dg (small blind) folded before Flop
Seat 6: /PH6Ffnho4Ysm8S3V/oa+w (big blind) folded before Flop



PokerStars Game #59941646744:  Hold'em No Limit ($1/$2) - 2009/07/01 1:41:44 ET
Table 'P/yCfYl1GfGsu/e6DxDy/A' 2-max Seat #1 is the button
Seat 1: 7fOCUy3x9hdkmXkkDNolGQ ($441.50 in chips)
Seat 2: RwDoM55ZeQuI2ADyJhOb2Q ($1035 in chips)
7fOCUy3x9hdkmXkkDNolGQ: posts small blind $1
RwDoM55ZeQuI2ADyJhOb2Q: posts big blind $2
*** HOLE CARDS ***
7fOCUy3x9hdkmXkkDNolGQ: raises $4 to $6
RwDoM55ZeQuI2ADyJhOb2Q: calls $4
*** FLOP *** [As 8s Qc]
RwDoM55ZeQuI2ADyJhOb2Q: checks
7fOCUy3x9hdkmXkkDNolGQ: bets $10
RwDoM55ZeQuI2ADyJhOb2Q: calls $10
*** TURN *** [As 8s Qc] [Tc]
RwDoM55ZeQuI2ADyJhOb2Q: checks
7fOCUy3x9hdkmXkkDNolGQ: checks
*** RIVER *** [As 8s Qc Tc] [6h]
RwDoM55ZeQuI2ADyJhOb2Q: checks
7fOCUy3x9hdkmXkkDNolGQ: checks
*** SHOW DOWN ***
RwDoM55ZeQuI2ADyJhOb2Q: shows [8d 9s] (a pair of Eights)
7fOCUy3x9hdkmXkkDNolGQ: mucks hand
RwDoM55ZeQuI2ADyJhOb2Q collected $31.50 from pot
*** SUMMARY ***
Total pot $32 | Rake $0.50
Board [As 8s Qc Tc 6h]
Seat 1: 7fOCUy3x9hdkmXkkDNolGQ (button) (small blind) mucked
Seat 2: RwDoM55ZeQuI2ADyJhOb2Q (big blind) showed [8d 9s] and won ($31.50) with a pair of Eights



PokerStars Game #59941648084:  Hold'em No Limit ($1/$2) - 2009/07/01 1:41:47 ET
Table 'zEOkwFUmNLBlvazOXtwH8w' 2-max Seat #2 is the button
Seat 1: gu6Ee9WAefYH8BG9//A1pw ($14 in chips)
Seat 2: SLKKhEamo9/21wMiSyGsQw ($145 in chips)
SLKKhEamo9/21wMiSyGsQw: posts small blind $1
gu6Ee9WAefYH8BG9//A1pw: posts big blind $2
*** HOLE CARDS ***
SLKKhEamo9/21wMiSyGsQw: calls $1
gu6Ee9WAefYH8BG9//A1pw: raises $12 to $14 and is all-in
SLKKhEamo9/21wMiSyGsQw: calls $12
*** FLOP *** [Ts 7s Ah]
*** TURN *** [Ts 7s Ah] [Kc]
*** RIVER *** [Ts 7s Ah Kc] [9s]
*** SHOW DOWN ***
gu6Ee9WAefYH8BG9//A1pw: shows [Qs 9c] (a pair of Nines)
SLKKhEamo9/21wMiSyGsQw: shows [Ad 6c] (a pair of Aces)
SLKKhEamo9/21wMiSyGsQw collected $27.50 from pot
*** SUMMARY ***
Total pot $28 | Rake $0.50
Board [Ts 7s Ah Kc 9s]
Seat 1: gu6Ee9WAefYH8BG9//A1pw (big blind) showed [Qs 9c] and lost with a pair of Nines
Seat 2: SLKKhEamo9/21wMiSyGsQw (button) (small blind) showed [Ad 6c] and won ($27.50) with a pair of Aces



PokerStars Game #59941650022:  Hold'em No Limit ($1/$2) - 2009/07/01 1:41:50 ET
Table '/dyk+YdRGv90j2box35j8w' 6-max Seat #5 is the button
Seat 1: 8srN1dKQePlsv0GyTada+Q ($200 in chips)
Seat 2: qCnEYuAE5y5A7bk6fO5/jQ ($484.20 in chips)
Seat 3: sTPOWERd9HWPCNrDBwsVjA ($209.50 in chips)
Seat 5: VvdR9F3I+2yELkfTVvC1dg ($250 in chips)
Seat 6: gnYme0DNFflnMhrdbxe1Ag ($200 in chips)
gnYme0DNFflnMhrdbxe1Ag: posts small blind $1
8srN1dKQePlsv0GyTada+Q: posts big blind $2
*** HOLE CARDS ***
qCnEYuAE5y5A7bk6fO5/jQ: folds
sTPOWERd9HWPCNrDBwsVjA: folds
VvdR9F3I+2yELkfTVvC1dg: raises $2 to $4
gnYme0DNFflnMhrdbxe1Ag: folds
8srN1dKQePlsv0GyTada+Q: calls $2
*** FLOP *** [7d Jd Tc]
8srN1dKQePlsv0GyTada+Q: checks
VvdR9F3I+2yELkfTVvC1dg: bets $6.40
8srN1dKQePlsv0GyTada+Q: folds
VvdR9F3I+2yELkfTVvC1dg collected $8.55 from pot
VvdR9F3I+2yELkfTVvC1dg: doesn't show hand
*** SUMMARY ***
Total pot $9 | Rake $0.45
Board [7d Jd Tc]
Seat 1: 8srN1dKQePlsv0GyTada+Q (big blind) folded on the Flop
Seat 2: qCnEYuAE5y5A7bk6fO5/jQ folded before Flop (didn't bet)
Seat 3: sTPOWERd9HWPCNrDBwsVjA folded before Flop (didn't bet)
Seat 5: VvdR9F3I+2yELkfTVvC1dg (button) collected ($8.55)
Seat 6: gnYme0DNFflnMhrdbxe1Ag (small blind) folded before Flop



PokerStars Game #59941649960:  Hold'em No Limit ($1/$2) - 2009/07/01 1:41:50 ET
Table '/ci73fTmzTzmGWzAtqEX2Q' 9-max Seat #7 is the button
Seat 1: 9efVc1cB3yHt4TvBkTusPw ($145.90 in chips)
Seat 2: pN/Ip0ePsUVIdUlGgLrkUw ($225 in chips)
Seat 3: kK1+5ivyJZeA8hQF2pdvvQ ($59.55 in chips)
Seat 4: 2yq7Zp4xmrhAw8+37hTkaA ($161.20 in chips)
Seat 5: 1CtiZuXDFaJL1dJPQKyi8Q ($191.75 in chips)
Seat 6: KqHysDSpCPaPyK3tJC1aEw ($200 in chips)
Seat 7: +T/63sAeZzWyHchahJ36GQ ($37 in chips)
Seat 8: /inIs/z/PcX+TniIFpaxpg ($36.75 in chips)
Seat 9: S8aS+9FTYQ/ICLBNThcrkg ($177 in chips)
/inIs/z/PcX+TniIFpaxpg: posts small blind $1
S8aS+9FTYQ/ICLBNThcrkg: posts big blind $2
*** HOLE CARDS ***
9efVc1cB3yHt4TvBkTusPw: raises $4 to $6
pN/Ip0ePsUVIdUlGgLrkUw: folds
kK1+5ivyJZeA8hQF2pdvvQ: folds
2yq7Zp4xmrhAw8+37hTkaA: folds
1CtiZuXDFaJL1dJPQKyi8Q: folds
KqHysDSpCPaPyK3tJC1aEw: folds
+T/63sAeZzWyHchahJ36GQ: folds
/inIs/z/PcX+TniIFpaxpg: folds
S8aS+9FTYQ/ICLBNThcrkg: folds
9efVc1cB3yHt4TvBkTusPw collected $5 from pot
*** SUMMARY ***
Total pot $5 | Rake $0
Seat 1: 9efVc1cB3yHt4TvBkTusPw collected ($5)
Seat 2: pN/Ip0ePsUVIdUlGgLrkUw folded before Flop (didn't bet)
Seat 3: kK1+5ivyJZeA8hQF2pdvvQ folded before Flop (didn't bet)
Seat 4: 2yq7Zp4xmrhAw8+37hTkaA folded before Flop (didn't bet)
Seat 5: 1CtiZuXDFaJL1dJPQKyi8Q folded before Flop (didn't bet)
Seat 6: KqHysDSpCPaPyK3tJC1aEw folded before Flop (didn't bet)
Seat 7: +T/63sAeZzWyHchahJ36GQ (button) folded before Flop (didn't bet)
Seat 8: /inIs/z/PcX+TniIFpaxpg (small blind) folded before Flop
Seat 9: S8aS+9FTYQ/ICLBNThcrkg (big blind) folded before Flop



PokerStars Game #59941651034:  Hold'em No Limit ($1/$2) - 2009/07/01 1:41:52 ET
Table 'CFkQcfWjKccZaZDf71FK+w' 6-max Seat #5 is the button
Seat 1: vkfxu8f/jMYKUk6Ly4eujw ($242.25 in chips)
Seat 2: ewN/vzF22+/gdzjIKBOlkA ($205.05 in chips)
Seat 3: 09BNF4quPDzanQzM8vc6WA ($40.65 in chips)
Seat 4: ygTTt5ehT4aF86q1a8/R+w ($243.35 in chips)
Seat 5: 2lOU1DcvUZaMcxZ95XfzXw ($184.10 in chips)
Seat 6: ORVqY3rf9X6ANA/8s+On2Q ($42.60 in chips)
ORVqY3rf9X6ANA/8s+On2Q: posts small blind $1
vkfxu8f/jMYKUk6Ly4eujw: posts big blind $2
*** HOLE CARDS ***
ewN/vzF22+/gdzjIKBOlkA: folds
09BNF4quPDzanQzM8vc6WA: folds
ygTTt5ehT4aF86q1a8/R+w: folds
2lOU1DcvUZaMcxZ95XfzXw: calls $2
ORVqY3rf9X6ANA/8s+On2Q: folds
vkfxu8f/jMYKUk6Ly4eujw: checks
*** FLOP *** [9h Ad 5d]
vkfxu8f/jMYKUk6Ly4eujw: bets $4
2lOU1DcvUZaMcxZ95XfzXw: raises $8 to $12
vkfxu8f/jMYKUk6Ly4eujw: calls $8
*** TURN *** [9h Ad 5d] [9d]
vkfxu8f/jMYKUk6Ly4eujw: checks
2lOU1DcvUZaMcxZ95XfzXw: checks
*** RIVER *** [9h Ad 5d 9d] [3d]
vkfxu8f/jMYKUk6Ly4eujw: checks
2lOU1DcvUZaMcxZ95XfzXw: bets $12
vkfxu8f/jMYKUk6Ly4eujw: folds
2lOU1DcvUZaMcxZ95XfzXw collected $27.60 from pot
*** SUMMARY ***
Total pot $29 | Rake $1.40
Board [9h Ad 5d 9d 3d]
Seat 1: vkfxu8f/jMYKUk6Ly4eujw (big blind) folded on the River
Seat 2: ewN/vzF22+/gdzjIKBOlkA folded before Flop (didn't bet)
Seat 3: 09BNF4quPDzanQzM8vc6WA folded before Flop (didn't bet)
Seat 4: ygTTt5ehT4aF86q1a8/R+w folded before Flop (didn't bet)
Seat 5: 2lOU1DcvUZaMcxZ95XfzXw (button) collected ($27.60)
Seat 6: ORVqY3rf9X6ANA/8s+On2Q (small blind) folded before Flop



PokerStars Game #59941651934:  Hold'em No Limit ($1/$2) - 2009/07/01 1:41:54 ET
Table 'kq5zaQ+1hLNf8LZfGnbTAA' 6-max Seat #5 is the button
Seat 1: 8srN1dKQePlsv0GyTada+Q ($417.60 in chips)
Seat 2: nXDI8Y/S6POzRwANu3d8hQ ($139 in chips)
Seat 3: /PH6Ffnho4Ysm8S3V/oa+w ($49.15 in chips)
Seat 4: 3dAbvkxS5NPQTBAbvpinVg ($278.45 in chips)
Seat 5: gnYme0DNFflnMhrdbxe1Ag ($222.35 in chips)
Seat 6: mfy7uGZcqA2PVQqEVbJ7+g ($205.15 in chips)
mfy7uGZcqA2PVQqEVbJ7+g: posts small blind $1
8srN1dKQePlsv0GyTada+Q: posts big blind $2
*** HOLE CARDS ***
nXDI8Y/S6POzRwANu3d8hQ: folds
/PH6Ffnho4Ysm8S3V/oa+w: raises $2 to $4
3dAbvkxS5NPQTBAbvpinVg: folds
gnYme0DNFflnMhrdbxe1Ag: folds
mfy7uGZcqA2PVQqEVbJ7+g: folds
8srN1dKQePlsv0GyTada+Q: folds
/PH6Ffnho4Ysm8S3V/oa+w collected $5 from pot
/PH6Ffnho4Ysm8S3V/oa+w: doesn't show hand
*** SUMMARY ***
Total pot $5 | Rake $0
Seat 1: 8srN1dKQePlsv0GyTada+Q (big blind) folded before Flop
Seat 2: nXDI8Y/S6POzRwANu3d8hQ folded before Flop (didn't bet)
Seat 3: /PH6Ffnho4Ysm8S3V/oa+w collected ($5)
Seat 4: 3dAbvkxS5NPQTBAbvpinVg folded before Flop (didn't bet)
Seat 5: gnYme0DNFflnMhrdbxe1Ag (button) folded before Flop (didn't bet)
Seat 6: mfy7uGZcqA2PVQqEVbJ7+g (small blind) folded before Flop



PokerStars Game #59941653432:  Hold'em No Limit ($1/$2) - 2009/07/01 1:41:57 ET
Table 'qVXak+oTeDXMGbWa4sDU5Q' 9-max Seat #6 is the button
Seat 1: H6Z4+qu8gR0VUiPOijndVg ($230.45 in chips)
Seat 2: CST1bO+CmVQOtNgiT0cKPg ($79.75 in chips)
Seat 3: WUlHm+ydPPHG7Lb0rePSdA ($172.10 in chips)
Seat 4: lQYT23h5QCUVZAKxjOO39Q ($188.10 in chips)
Seat 5: zJtQ1gxyi72XvGYS1tM+DA ($97 in chips)
Seat 6: GX1heJ+DSsvm7gzSPsYhhQ ($40 in chips)
Seat 7: 6oGEJqk9oDy29sSaLs+LGA ($79.65 in chips)
Seat 8: Z0rzUi0y1x80UdIpofoNbA ($109.55 in chips)
Seat 9: CkE3IyJF1KvdaAOmZY5XqQ ($215.55 in chips)
6oGEJqk9oDy29sSaLs+LGA: posts small blind $1
Z0rzUi0y1x80UdIpofoNbA: posts big blind $2
*** HOLE CARDS ***
CkE3IyJF1KvdaAOmZY5XqQ: folds
H6Z4+qu8gR0VUiPOijndVg: raises $4 to $6
CST1bO+CmVQOtNgiT0cKPg: folds
WUlHm+ydPPHG7Lb0rePSdA: folds
lQYT23h5QCUVZAKxjOO39Q: folds
zJtQ1gxyi72XvGYS1tM+DA: folds
GX1heJ+DSsvm7gzSPsYhhQ: folds
6oGEJqk9oDy29sSaLs+LGA: folds
Z0rzUi0y1x80UdIpofoNbA: folds
H6Z4+qu8gR0VUiPOijndVg collected $5 from pot
H6Z4+qu8gR0VUiPOijndVg: doesn't show hand
*** SUMMARY ***
Total pot $5 | Rake $0
Seat 1: H6Z4+qu8gR0VUiPOijndVg collected ($5)
Seat 2: CST1bO+CmVQOtNgiT0cKPg folded before Flop (didn't bet)
Seat 3: WUlHm+ydPPHG7Lb0rePSdA folded before Flop (didn't bet)
Seat 4: lQYT23h5QCUVZAKxjOO39Q folded before Flop (didn't bet)
Seat 5: zJtQ1gxyi72XvGYS1tM+DA folded before Flop (didn't bet)
Seat 6: GX1heJ+DSsvm7gzSPsYhhQ (button) folded before Flop (didn't bet)
Seat 7: 6oGEJqk9oDy29sSaLs+LGA (small blind) folded before Flop
Seat 8: Z0rzUi0y1x80UdIpofoNbA (big blind) folded before Flop
Seat 9: CkE3IyJF1KvdaAOmZY5XqQ folded before Flop (didn't bet)



PokerStars Game #59941654084:  Hold'em No Limit ($1/$2) - 2009/07/01 1:41:58 ET
Table 'TsEDkiO4tzCTCzJ7tNdEqw' 6-max Seat #3 is the button
Seat 2: 4dcDwIHRm96PwtqkpQiuiA ($86.65 in chips)
Seat 3: ubtx4Z5L+AcK71MTvYiGVw ($267.05 in chips)
Seat 5: VvdR9F3I+2yELkfTVvC1dg ($247.35 in chips)
Seat 6: uCqEjnxh2/vFBjKYkfTOkw ($286.80 in chips)
VvdR9F3I+2yELkfTVvC1dg: posts small blind $1
uCqEjnxh2/vFBjKYkfTOkw: posts big blind $2
vkfxu8f/jMYKUk6Ly4eujw: sits out
*** HOLE CARDS ***
4dcDwIHRm96PwtqkpQiuiA: folds
ubtx4Z5L+AcK71MTvYiGVw: folds
K8MXCrNAVYlMnnCeM32Kxw has returned
VvdR9F3I+2yELkfTVvC1dg: folds
uCqEjnxh2/vFBjKYkfTOkw collected $2 from pot
uCqEjnxh2/vFBjKYkfTOkw: doesn't show hand
*** SUMMARY ***
Total pot $2 | Rake $0
Seat 2: 4dcDwIHRm96PwtqkpQiuiA folded before Flop (didn't bet)
Seat 3: ubtx4Z5L+AcK71MTvYiGVw (button) folded before Flop (didn't bet)
Seat 5: VvdR9F3I+2yELkfTVvC1dg (small blind) folded before Flop
Seat 6: uCqEjnxh2/vFBjKYkfTOkw (big blind) collected ($2)



PokerStars Game #59941654974:  Hold'em No Limit ($1/$2) - 2009/07/01 1:42:00 ET
Table 'rKeCh+eBn4RNvybCUYkoTQ' 9-max Seat #5 is the button
Seat 1: /inIs/z/PcX+TniIFpaxpg ($182 in chips)
Seat 2: nXDI8Y/S6POzRwANu3d8hQ ($131.25 in chips)
Seat 3: GX1heJ+DSsvm7gzSPsYhhQ ($40 in chips)
Seat 5: WUlHm+ydPPHG7Lb0rePSdA ($120 in chips)
Seat 6: EBV6OktyeSmh4w6sWmcWOw ($284.80 in chips)
Seat 7: rW/MyplHylMSBRaoRUzWrg ($40 in chips)
Seat 8: pN/Ip0ePsUVIdUlGgLrkUw ($246.35 in chips)
EBV6OktyeSmh4w6sWmcWOw: posts small blind $1
rW/MyplHylMSBRaoRUzWrg: posts big blind $2
31HuO+DQxppUQEedBWukug: sits out
*** HOLE CARDS ***
pN/Ip0ePsUVIdUlGgLrkUw: folds
/inIs/z/PcX+TniIFpaxpg: folds
nXDI8Y/S6POzRwANu3d8hQ: folds
GX1heJ+DSsvm7gzSPsYhhQ: folds
WUlHm+ydPPHG7Lb0rePSdA: folds
EBV6OktyeSmh4w6sWmcWOw: raises $2 to $4
rW/MyplHylMSBRaoRUzWrg: folds
EBV6OktyeSmh4w6sWmcWOw collected $4 from pot
EBV6OktyeSmh4w6sWmcWOw: doesn't show hand
*** SUMMARY ***
Total pot $4 | Rake $0
Seat 1: /inIs/z/PcX+TniIFpaxpg folded before Flop (didn't bet)
Seat 2: nXDI8Y/S6POzRwANu3d8hQ folded before Flop (didn't bet)
Seat 3: GX1heJ+DSsvm7gzSPsYhhQ folded before Flop (didn't bet)
Seat 5: WUlHm+ydPPHG7Lb0rePSdA (button) folded before Flop (didn't bet)
Seat 6: EBV6OktyeSmh4w6sWmcWOw (small blind) collected ($4)
Seat 7: rW/MyplHylMSBRaoRUzWrg (big blind) folded before Flop
Seat 8: pN/Ip0ePsUVIdUlGgLrkUw folded before Flop (didn't bet)



PokerStars Game #59941655640:  Hold'em No Limit ($1/$2) - 2009/07/01 1:42:01 ET
Table 'BSRfGh+QobUe0AgIMtt/fw' 9-max Seat #4 is the button
Seat 1: gDn/rYeNwCyWEgRhyWp4PA ($155.70 in chips)
Seat 2: +SmnXtdmwqXGEJfLeJDIUQ ($37 in chips)
Seat 3: WUlHm+ydPPHG7Lb0rePSdA ($120 in chips)
Seat 4: +T/63sAeZzWyHchahJ36GQ ($40 in chips)
Seat 5: v0q3vrz/d9oDjLrAG8Ausw ($202.75 in chips)
Seat 6: H6Z4+qu8gR0VUiPOijndVg ($203 in chips)
Seat 7: CkE3IyJF1KvdaAOmZY5XqQ ($206.10 in chips)
Seat 8: /XRRUMKiOOItJFbrM26RrA ($83.30 in chips)
Seat 9: /inIs/z/PcX+TniIFpaxpg ($415.25 in chips)
v0q3vrz/d9oDjLrAG8Ausw: posts small blind $1
H6Z4+qu8gR0VUiPOijndVg: posts big blind $2
*** HOLE CARDS ***
CkE3IyJF1KvdaAOmZY5XqQ: folds
/XRRUMKiOOItJFbrM26RrA: folds
/inIs/z/PcX+TniIFpaxpg: folds
gDn/rYeNwCyWEgRhyWp4PA: folds
+SmnXtdmwqXGEJfLeJDIUQ: folds
WUlHm+ydPPHG7Lb0rePSdA: folds
+T/63sAeZzWyHchahJ36GQ: folds
v0q3vrz/d9oDjLrAG8Ausw: calls $1
H6Z4+qu8gR0VUiPOijndVg: checks
*** FLOP *** [3c 6c Kc]
v0q3vrz/d9oDjLrAG8Ausw: bets $4
H6Z4+qu8gR0VUiPOijndVg: folds
v0q3vrz/d9oDjLrAG8Ausw collected $3.80 from pot
*** SUMMARY ***
Total pot $4 | Rake $0.20
Board [3c 6c Kc]
Seat 1: gDn/rYeNwCyWEgRhyWp4PA folded before Flop (didn't bet)
Seat 2: +SmnXtdmwqXGEJfLeJDIUQ folded before Flop (didn't bet)
Seat 3: WUlHm+ydPPHG7Lb0rePSdA folded before Flop (didn't bet)
Seat 4: +T/63sAeZzWyHchahJ36GQ (button) folded before Flop (didn't bet)
Seat 5: v0q3vrz/d9oDjLrAG8Ausw (small blind) collected ($3.80)
Seat 6: H6Z4+qu8gR0VUiPOijndVg (big blind) folded on the Flop
Seat 7: CkE3IyJF1KvdaAOmZY5XqQ folded before Flop (didn't bet)
Seat 8: /XRRUMKiOOItJFbrM26RrA folded before Flop (didn't bet)
Seat 9: /inIs/z/PcX+TniIFpaxpg folded before Flop (didn't bet)



PokerStars Game #59941655450:  Hold'em No Limit ($1/$2) - 2009/07/01 1:42:01 ET
Table 'mGpP9StWRnoeiBDExc6Frg' 6-max Seat #4 is the button
Seat 1: VvdR9F3I+2yELkfTVvC1dg ($309.15 in chips)
Seat 2: vkfxu8f/jMYKUk6Ly4eujw ($204 in chips)
Seat 3: 7acrZUQC3Zc9BNLjoKIcLQ ($27.85 in chips)
Seat 4: 4dcDwIHRm96PwtqkpQiuiA ($66.70 in chips)
Seat 5: d1puGuVBE0fidn+5eRJ0tw ($208.55 in chips)
Seat 6: B2Ih1sr5VZk+8He7rcrMtQ ($416.80 in chips)
d1puGuVBE0fidn+5eRJ0tw: posts small blind $1
B2Ih1sr5VZk+8He7rcrMtQ: posts big blind $2
*** HOLE CARDS ***
VvdR9F3I+2yELkfTVvC1dg: folds
vkfxu8f/jMYKUk6Ly4eujw: folds
7acrZUQC3Zc9BNLjoKIcLQ: raises $4 to $6
4dcDwIHRm96PwtqkpQiuiA: folds
d1puGuVBE0fidn+5eRJ0tw: folds
B2Ih1sr5VZk+8He7rcrMtQ: folds
7acrZUQC3Zc9BNLjoKIcLQ collected $5 from pot
*** SUMMARY ***
Total pot $5 | Rake $0
Seat 1: VvdR9F3I+2yELkfTVvC1dg folded before Flop (didn't bet)
Seat 2: vkfxu8f/jMYKUk6Ly4eujw folded before Flop (didn't bet)
Seat 3: 7acrZUQC3Zc9BNLjoKIcLQ collected ($5)
Seat 4: 4dcDwIHRm96PwtqkpQiuiA (button) folded before Flop (didn't bet)
Seat 5: d1puGuVBE0fidn+5eRJ0tw (small blind) folded before Flop
Seat 6: B2Ih1sr5VZk+8He7rcrMtQ (big blind) folded before Flop



PokerStars Game #59941655338:  Hold'em No Limit ($1/$2) - 2009/07/01 1:42:01 ET
Table '4NGNnZ/osQfNq6abYqkJeA' 6-max Seat #5 is the button
Seat 2: 669iGNwYwgRZg3nhS+aDAQ ($121.70 in chips)
Seat 3: 54yWzRRgS0oZ+S6LwZBxMQ ($22.80 in chips)
Seat 4: sY+4Uuh5z/6AbXXaCS10jw ($230.25 in chips)
Seat 5: VvdR9F3I+2yELkfTVvC1dg ($235.55 in chips)
Seat 6: /PH6Ffnho4Ysm8S3V/oa+w ($40 in chips)
/PH6Ffnho4Ysm8S3V/oa+w: posts small blind $1
669iGNwYwgRZg3nhS+aDAQ: posts big blind $2
*** HOLE CARDS ***
54yWzRRgS0oZ+S6LwZBxMQ: folds
sY+4Uuh5z/6AbXXaCS10jw: folds
VvdR9F3I+2yELkfTVvC1dg: raises $2 to $4
/PH6Ffnho4Ysm8S3V/oa+w: folds
669iGNwYwgRZg3nhS+aDAQ: calls $2
*** FLOP *** [7s 9d Jd]
669iGNwYwgRZg3nhS+aDAQ: bets $4
xUTLK/SDwl6IxZdaKduuFg joins the table at seat #1
VvdR9F3I+2yELkfTVvC1dg: folds
669iGNwYwgRZg3nhS+aDAQ collected $8.55 from pot
*** SUMMARY ***
Total pot $9 | Rake $0.45
Board [7s 9d Jd]
Seat 2: 669iGNwYwgRZg3nhS+aDAQ (big blind) collected ($8.55)
Seat 3: 54yWzRRgS0oZ+S6LwZBxMQ folded before Flop (didn't bet)
Seat 4: sY+4Uuh5z/6AbXXaCS10jw folded before Flop (didn't bet)
Seat 5: VvdR9F3I+2yELkfTVvC1dg (button) folded on the Flop
Seat 6: /PH6Ffnho4Ysm8S3V/oa+w (small blind) folded before Flop



PokerStars Game #59941656450:  Hold'em No Limit ($1/$2) - 2009/07/01 1:42:03 ET
Table 'aSf77Sj8QEnzcc0WaxVD4Q' 6-max Seat #6 is the button
Seat 1: UELtvp+JfwI7XDGVwSxZXA ($246.10 in chips)
Seat 2: vkfxu8f/jMYKUk6Ly4eujw ($200 in chips)
Seat 3: 9dpyyjDTCed6nV7JhaUUpw ($743.75 in chips)
Seat 4: YsLQ3BAvgQHWXMAv3Wv6Hg ($200 in chips)
Seat 5: VvdR9F3I+2yELkfTVvC1dg ($251 in chips)
Seat 6: vkoJRf3gidxY1pPi0AFWww ($140.50 in chips)
UELtvp+JfwI7XDGVwSxZXA: posts small blind $1
vkfxu8f/jMYKUk6Ly4eujw: posts big blind $2
*** HOLE CARDS ***
9dpyyjDTCed6nV7JhaUUpw: folds
YsLQ3BAvgQHWXMAv3Wv6Hg: raises $4 to $6
VvdR9F3I+2yELkfTVvC1dg: folds
vkoJRf3gidxY1pPi0AFWww: folds
UELtvp+JfwI7XDGVwSxZXA: folds
vkfxu8f/jMYKUk6Ly4eujw: folds
YsLQ3BAvgQHWXMAv3Wv6Hg collected $5 from pot
YsLQ3BAvgQHWXMAv3Wv6Hg: doesn't show hand
*** SUMMARY ***
Total pot $5 | Rake $0
Seat 1: UELtvp+JfwI7XDGVwSxZXA (small blind) folded before Flop
Seat 2: vkfxu8f/jMYKUk6Ly4eujw (big blind) folded before Flop
Seat 3: 9dpyyjDTCed6nV7JhaUUpw folded before Flop (didn't bet)
Seat 4: YsLQ3BAvgQHWXMAv3Wv6Hg collected ($5)
Seat 5: VvdR9F3I+2yELkfTVvC1dg folded before Flop (didn't bet)
Seat 6: vkoJRf3gidxY1pPi0AFWww (button) folded before Flop (didn't bet)



PokerStars Game #59941656828:  Hold'em No Limit ($1/$2) - 2009/07/01 1:42:03 ET
Table 'UGLAZZyv+cXmnKjYin0etA' 6-max Seat #4 is the button
Seat 1: vkfxu8f/jMYKUk6Ly4eujw ($203 in chips)
Seat 2: eDLH1PUXFpvJBNMXBVQcGA ($310.10 in chips)
Seat 3: ygTTt5ehT4aF86q1a8/R+w ($111.20 in chips)
Seat 4: SiGJDsvRViJX05vHhA80GQ ($231.85 in chips)
Seat 5: 54yWzRRgS0oZ+S6LwZBxMQ ($31.75 in chips)
Seat 6: sTPOWERd9HWPCNrDBwsVjA ($221.15 in chips)
54yWzRRgS0oZ+S6LwZBxMQ: posts small blind $1
sTPOWERd9HWPCNrDBwsVjA: posts big blind $2
*** HOLE CARDS ***
vkfxu8f/jMYKUk6Ly4eujw: folds
eDLH1PUXFpvJBNMXBVQcGA: raises $4 to $6
ygTTt5ehT4aF86q1a8/R+w: folds
SiGJDsvRViJX05vHhA80GQ: folds
54yWzRRgS0oZ+S6LwZBxMQ: calls $5
sTPOWERd9HWPCNrDBwsVjA: folds
*** FLOP *** [6s Ah 7h]
54yWzRRgS0oZ+S6LwZBxMQ: bets $4
eDLH1PUXFpvJBNMXBVQcGA: folds
54yWzRRgS0oZ+S6LwZBxMQ collected $13.30 from pot
*** SUMMARY ***
Total pot $14 | Rake $0.70
Board [6s Ah 7h]
Seat 1: vkfxu8f/jMYKUk6Ly4eujw folded before Flop (didn't bet)
Seat 2: eDLH1PUXFpvJBNMXBVQcGA folded on the Flop
Seat 3: ygTTt5ehT4aF86q1a8/R+w folded before Flop (didn't bet)
Seat 4: SiGJDsvRViJX05vHhA80GQ (button) folded before Flop (didn't bet)
Seat 5: 54yWzRRgS0oZ+S6LwZBxMQ (small blind) collected ($13.30)
Seat 6: sTPOWERd9HWPCNrDBwsVjA (big blind) folded before Flop



PokerStars Game #59941656734:  Hold'em No Limit ($1/$2) - 2009/07/01 1:42:03 ET
Table 'NmY84NAf9Mh0ckAckHnh5g' 2-max Seat #1 is the button
Seat 1: 6hvg964TSqZ3AL/0XK9aVQ ($495.70 in chips)
Seat 2: RwDoM55ZeQuI2ADyJhOb2Q ($495.50 in chips)
6hvg964TSqZ3AL/0XK9aVQ: posts small blind $1
RwDoM55ZeQuI2ADyJhOb2Q: posts big blind $2
*** HOLE CARDS ***
6hvg964TSqZ3AL/0XK9aVQ: calls $1
RwDoM55ZeQuI2ADyJhOb2Q: raises $8 to $10
6hvg964TSqZ3AL/0XK9aVQ: calls $8
*** FLOP *** [8c 3c Js]
RwDoM55ZeQuI2ADyJhOb2Q: bets $10
6hvg964TSqZ3AL/0XK9aVQ: calls $10
*** TURN *** [8c 3c Js] [2d]
RwDoM55ZeQuI2ADyJhOb2Q: checks
6hvg964TSqZ3AL/0XK9aVQ: checks
*** RIVER *** [8c 3c Js 2d] [6d]
RwDoM55ZeQuI2ADyJhOb2Q: checks
6hvg964TSqZ3AL/0XK9aVQ: bets $18
RwDoM55ZeQuI2ADyJhOb2Q: calls $18
*** SHOW DOWN ***
6hvg964TSqZ3AL/0XK9aVQ: shows [Ks Jh] (a pair of Jacks)
RwDoM55ZeQuI2ADyJhOb2Q: mucks hand
6hvg964TSqZ3AL/0XK9aVQ collected $75.50 from pot
*** SUMMARY ***
Total pot $76 | Rake $0.50
Board [8c 3c Js 2d 6d]
Seat 1: 6hvg964TSqZ3AL/0XK9aVQ (button) (small blind) showed [Ks Jh] and won ($75.50) with a pair of Jacks
Seat 2: RwDoM55ZeQuI2ADyJhOb2Q (big blind) mucked



PokerStars Game #59941657152:  Hold'em No Limit ($1/$2) - 2009/07/01 1:42:04 ET
Table 'ztv6V3FN2bQ9nmJPPdx6nQ' 6-max Seat #5 is the button
Seat 1: 6fLdOUCRtX71xbVRhJEq8w ($238.35 in chips)
Seat 2: 5Y+ZGWLI4gnlpApDX5vy1A ($402.40 in chips)
Seat 3: ubtx4Z5L+AcK71MTvYiGVw ($247.20 in chips)
Seat 4: UaZ5yj+6LjtWqMQg2QskUw ($82.30 in chips)
Seat 5: sTPOWERd9HWPCNrDBwsVjA ($217.60 in chips)
Seat 6: mfy7uGZcqA2PVQqEVbJ7+g ($107.60 in chips)
mfy7uGZcqA2PVQqEVbJ7+g: posts small blind $1
6fLdOUCRtX71xbVRhJEq8w: posts big blind $2
*** HOLE CARDS ***
5Y+ZGWLI4gnlpApDX5vy1A: calls $2
ubtx4Z5L+AcK71MTvYiGVw: folds
UaZ5yj+6LjtWqMQg2QskUw: folds
sTPOWERd9HWPCNrDBwsVjA: folds
mfy7uGZcqA2PVQqEVbJ7+g: folds
6fLdOUCRtX71xbVRhJEq8w: checks
*** FLOP *** [2s 6d 2c]
6fLdOUCRtX71xbVRhJEq8w: checks
5Y+ZGWLI4gnlpApDX5vy1A: bets $4
6fLdOUCRtX71xbVRhJEq8w: folds
5Y+ZGWLI4gnlpApDX5vy1A collected $4.75 from pot
5Y+ZGWLI4gnlpApDX5vy1A: doesn't show hand
*** SUMMARY ***
Total pot $5 | Rake $0.25
Board [2s 6d 2c]
Seat 1: 6fLdOUCRtX71xbVRhJEq8w (big blind) folded on the Flop
Seat 2: 5Y+ZGWLI4gnlpApDX5vy1A collected ($4.75)
Seat 3: ubtx4Z5L+AcK71MTvYiGVw folded before Flop (didn't bet)
Seat 4: UaZ5yj+6LjtWqMQg2QskUw folded before Flop (didn't bet)
Seat 5: sTPOWERd9HWPCNrDBwsVjA (button) folded before Flop (didn't bet)
Seat 6: mfy7uGZcqA2PVQqEVbJ7+g (small blind) folded before Flop



PokerStars Game #59941657762:  Hold'em No Limit ($1/$2) - 2009/07/01 1:42:05 ET
Table 'jlrIxbrVIG+gjaUYT4za8g' 6-max Seat #3 is the button
Seat 1: ygTTt5ehT4aF86q1a8/R+w ($235.30 in chips)
Seat 2: /PH6Ffnho4Ysm8S3V/oa+w ($60 in chips)
Seat 3: gnYme0DNFflnMhrdbxe1Ag ($200 in chips)
Seat 4: 8srN1dKQePlsv0GyTada+Q ($264.95 in chips)
Seat 5: AyBB0k3Dcl7xbXUeGMw06g ($40.40 in chips)
8srN1dKQePlsv0GyTada+Q: posts small blind $1
AyBB0k3Dcl7xbXUeGMw06g: posts big blind $2
BWhgxe7gWiYobRbwdG+d2Q: sits out
*** HOLE CARDS ***
ygTTt5ehT4aF86q1a8/R+w: folds
/PH6Ffnho4Ysm8S3V/oa+w: folds
gnYme0DNFflnMhrdbxe1Ag: folds
8srN1dKQePlsv0GyTada+Q: folds
AyBB0k3Dcl7xbXUeGMw06g collected $2 from pot
*** SUMMARY ***
Total pot $2 | Rake $0
Seat 1: ygTTt5ehT4aF86q1a8/R+w folded before Flop (didn't bet)
Seat 2: /PH6Ffnho4Ysm8S3V/oa+w folded before Flop (didn't bet)
Seat 3: gnYme0DNFflnMhrdbxe1Ag (button) folded before Flop (didn't bet)
Seat 4: 8srN1dKQePlsv0GyTada+Q (small blind) folded before Flop
Seat 5: AyBB0k3Dcl7xbXUeGMw06g (big blind) collected ($2)



PokerStars Game #59941658582:  Hold'em No Limit ($1/$2) - 2009/07/01 1:42:07 ET
Table 'G1Oqdy4Pqdb5gtx40rUBzA' 6-max Seat #1 is the button
Seat 1: BWhgxe7gWiYobRbwdG+d2Q ($196 in chips)
Seat 2: m7mYVfnCOK5TE/VkN/FhOg ($200 in chips)
Seat 3: VvdR9F3I+2yELkfTVvC1dg ($218.90 in chips)
Seat 4: B87ikIyZ/TzAVeXf38Ny0g ($211.55 in chips)
Seat 5: F1+Ml47qRQWunzPnGhLLzQ ($203.40 in chips)
Seat 6: qCnEYuAE5y5A7bk6fO5/jQ ($211.25 in chips)
m7mYVfnCOK5TE/VkN/FhOg: posts small blind $1
VvdR9F3I+2yELkfTVvC1dg: posts big blind $2
*** HOLE CARDS ***
B87ikIyZ/TzAVeXf38Ny0g: folds
F1+Ml47qRQWunzPnGhLLzQ: folds
qCnEYuAE5y5A7bk6fO5/jQ: folds
BWhgxe7gWiYobRbwdG+d2Q: folds
m7mYVfnCOK5TE/VkN/FhOg: raises $4 to $6
VvdR9F3I+2yELkfTVvC1dg: folds
m7mYVfnCOK5TE/VkN/FhOg collected $4 from pot
m7mYVfnCOK5TE/VkN/FhOg: doesn't show hand
*** SUMMARY ***
Total pot $4 | Rake $0
Seat 1: BWhgxe7gWiYobRbwdG+d2Q (button) folded before Flop (didn't bet)
Seat 2: m7mYVfnCOK5TE/VkN/FhOg (small blind) collected ($4)
Seat 3: VvdR9F3I+2yELkfTVvC1dg (big blind) folded before Flop
Seat 4: B87ikIyZ/TzAVeXf38Ny0g folded before Flop (didn't bet)
Seat 5: F1+Ml47qRQWunzPnGhLLzQ folded before Flop (didn't bet)
Seat 6: qCnEYuAE5y5A7bk6fO5/jQ folded before Flop (didn't bet)



PokerStars Game #59941660284:  Hold'em No Limit ($1/$2) - 2009/07/01 1:42:10 ET
Table 'bJQ024BaYSBrW0sXpCZbNQ' 6-max Seat #3 is the button
Seat 1: KfwW5us6tydK81NYTtK1gw ($203 in chips)
Seat 2: 3dAbvkxS5NPQTBAbvpinVg ($203 in chips)
Seat 3: /PH6Ffnho4Ysm8S3V/oa+w ($40 in chips)
Seat 4: TBaQIN+sQ7eb7P99QnaORQ ($83.80 in chips)
Seat 5: VvdR9F3I+2yELkfTVvC1dg ($200 in chips)
Seat 6: 4bqvCfJ0e8CTYnn0Go9hbQ ($146.20 in chips)
TBaQIN+sQ7eb7P99QnaORQ: posts small blind $1
VvdR9F3I+2yELkfTVvC1dg: posts big blind $2
*** HOLE CARDS ***
4bqvCfJ0e8CTYnn0Go9hbQ: folds
KfwW5us6tydK81NYTtK1gw: folds
3dAbvkxS5NPQTBAbvpinVg: raises $4 to $6
/PH6Ffnho4Ysm8S3V/oa+w: raises $34 to $40 and is all-in
TBaQIN+sQ7eb7P99QnaORQ: folds
VvdR9F3I+2yELkfTVvC1dg: folds
3dAbvkxS5NPQTBAbvpinVg: folds
/PH6Ffnho4Ysm8S3V/oa+w collected $15 from pot
/PH6Ffnho4Ysm8S3V/oa+w: doesn't show hand
*** SUMMARY ***
Total pot $15 | Rake $0
Seat 1: KfwW5us6tydK81NYTtK1gw folded before Flop (didn't bet)
Seat 2: 3dAbvkxS5NPQTBAbvpinVg folded before Flop
Seat 3: /PH6Ffnho4Ysm8S3V/oa+w (button) collected ($15)
Seat 4: TBaQIN+sQ7eb7P99QnaORQ (small blind) folded before Flop
Seat 5: VvdR9F3I+2yELkfTVvC1dg (big blind) folded before Flop
Seat 6: 4bqvCfJ0e8CTYnn0Go9hbQ folded before Flop (didn't bet)



PokerStars Game #59941661476:  Hold'em No Limit ($1/$2) - 2009/07/01 1:42:12 ET
Table 'uJ9juaXXg9yIcSU8amxaXQ' 6-max Seat #5 is the button
Seat 1: JsqOjN/eHz0uYVf/PyUJ6Q ($150.25 in chips)
Seat 2: VvdR9F3I+2yELkfTVvC1dg ($215.10 in chips)
Seat 3: qXDd0ZyMIse0OBu8pxeQ3Q ($243.40 in chips)
Seat 4: zNjJ/y4emmF+vzrCDd+ooA ($228.45 in chips)
Seat 5: YsLQ3BAvgQHWXMAv3Wv6Hg ($212.70 in chips)
Seat 6: /PH6Ffnho4Ysm8S3V/oa+w ($41 in chips)
/PH6Ffnho4Ysm8S3V/oa+w: posts small blind $1
JsqOjN/eHz0uYVf/PyUJ6Q: posts big blind $2
*** HOLE CARDS ***
VvdR9F3I+2yELkfTVvC1dg: raises $2 to $4
qXDd0ZyMIse0OBu8pxeQ3Q: folds
zNjJ/y4emmF+vzrCDd+ooA: calls $4
YsLQ3BAvgQHWXMAv3Wv6Hg: folds
/PH6Ffnho4Ysm8S3V/oa+w: folds
JsqOjN/eHz0uYVf/PyUJ6Q: folds
*** FLOP *** [Jh Ac 2d]
VvdR9F3I+2yELkfTVvC1dg: bets $7.80
zNjJ/y4emmF+vzrCDd+ooA: calls $7.80
*** TURN *** [Jh Ac 2d] [Ah]
VvdR9F3I+2yELkfTVvC1dg: checks
zNjJ/y4emmF+vzrCDd+ooA: bets $6
VvdR9F3I+2yELkfTVvC1dg: folds
zNjJ/y4emmF+vzrCDd+ooA collected $25.30 from pot
*** SUMMARY ***
Total pot $26.60 | Rake $1.30
Board [Jh Ac 2d Ah]
Seat 1: JsqOjN/eHz0uYVf/PyUJ6Q (big blind) folded before Flop
Seat 2: VvdR9F3I+2yELkfTVvC1dg folded on the Turn
Seat 3: qXDd0ZyMIse0OBu8pxeQ3Q folded before Flop (didn't bet)
Seat 4: zNjJ/y4emmF+vzrCDd+ooA collected ($25.30)
Seat 5: YsLQ3BAvgQHWXMAv3Wv6Hg (button) folded before Flop (didn't bet)
Seat 6: /PH6Ffnho4Ysm8S3V/oa+w (small blind) folded before Flop



PokerStars Game #59941661832:  Hold'em No Limit ($1/$2) - 2009/07/01 1:42:13 ET
Table 'kq5zaQ+1hLNf8LZfGnbTAA' 6-max Seat #6 is the button
Seat 1: 8srN1dKQePlsv0GyTada+Q ($415.60 in chips)
Seat 2: nXDI8Y/S6POzRwANu3d8hQ ($139 in chips)
Seat 3: /PH6Ffnho4Ysm8S3V/oa+w ($52.15 in chips)
Seat 4: 3dAbvkxS5NPQTBAbvpinVg ($278.45 in chips)
Seat 5: gnYme0DNFflnMhrdbxe1Ag ($222.35 in chips)
Seat 6: mfy7uGZcqA2PVQqEVbJ7+g ($204.15 in chips)
8srN1dKQePlsv0GyTada+Q: posts small blind $1
nXDI8Y/S6POzRwANu3d8hQ: posts big blind $2
*** HOLE CARDS ***
/PH6Ffnho4Ysm8S3V/oa+w: folds
3dAbvkxS5NPQTBAbvpinVg: folds
gnYme0DNFflnMhrdbxe1Ag: folds
mfy7uGZcqA2PVQqEVbJ7+g: folds
8srN1dKQePlsv0GyTada+Q: calls $1
nXDI8Y/S6POzRwANu3d8hQ: raises $10 to $12
8srN1dKQePlsv0GyTada+Q: folds
nXDI8Y/S6POzRwANu3d8hQ collected $4 from pot
nXDI8Y/S6POzRwANu3d8hQ: doesn't show hand
*** SUMMARY ***
Total pot $4 | Rake $0
Seat 1: 8srN1dKQePlsv0GyTada+Q (small blind) folded before Flop
Seat 2: nXDI8Y/S6POzRwANu3d8hQ (big blind) collected ($4)
Seat 3: /PH6Ffnho4Ysm8S3V/oa+w folded before Flop (didn't bet)
Seat 4: 3dAbvkxS5NPQTBAbvpinVg folded before Flop (didn't bet)
Seat 5: gnYme0DNFflnMhrdbxe1Ag folded before Flop (didn't bet)
Seat 6: mfy7uGZcqA2PVQqEVbJ7+g (button) folded before Flop (didn't bet)



PokerStars Game #59941662150:  Hold'em No Limit ($1/$2) - 2009/07/01 1:42:13 ET
Table 'P/yCfYl1GfGsu/e6DxDy/A' 2-max Seat #2 is the button
Seat 1: 7fOCUy3x9hdkmXkkDNolGQ ($425.50 in chips)
Seat 2: RwDoM55ZeQuI2ADyJhOb2Q ($1050.50 in chips)
RwDoM55ZeQuI2ADyJhOb2Q: posts small blind $1
7fOCUy3x9hdkmXkkDNolGQ: posts big blind $2
*** HOLE CARDS ***
RwDoM55ZeQuI2ADyJhOb2Q: folds
7fOCUy3x9hdkmXkkDNolGQ collected $2 from pot
7fOCUy3x9hdkmXkkDNolGQ: doesn't show hand
*** SUMMARY ***
Total pot $2 | Rake $0
Seat 1: 7fOCUy3x9hdkmXkkDNolGQ (big blind) collected ($2)
Seat 2: RwDoM55ZeQuI2ADyJhOb2Q (button) (small blind) folded before Flop



PokerStars Game #59941662852:  Hold'em No Limit ($1/$2) - 2009/07/01 1:42:15 ET
Table 'TsEDkiO4tzCTCzJ7tNdEqw' 6-max Seat #5 is the button
Seat 1: vkfxu8f/jMYKUk6Ly4eujw ($200 in chips)
Seat 2: 4dcDwIHRm96PwtqkpQiuiA ($86.65 in chips)
Seat 3: ubtx4Z5L+AcK71MTvYiGVw ($267.05 in chips)
Seat 5: VvdR9F3I+2yELkfTVvC1dg ($246.35 in chips)
Seat 6: uCqEjnxh2/vFBjKYkfTOkw ($287.80 in chips)
uCqEjnxh2/vFBjKYkfTOkw: posts small blind $1
vkfxu8f/jMYKUk6Ly4eujw: posts big blind $2
K8MXCrNAVYlMnnCeM32Kxw: sits out
*** HOLE CARDS ***
4dcDwIHRm96PwtqkpQiuiA: folds
ubtx4Z5L+AcK71MTvYiGVw: folds
VvdR9F3I+2yELkfTVvC1dg: raises $2 to $4
uCqEjnxh2/vFBjKYkfTOkw: folds
vkfxu8f/jMYKUk6Ly4eujw: folds
VvdR9F3I+2yELkfTVvC1dg collected $5 from pot
VvdR9F3I+2yELkfTVvC1dg: doesn't show hand
*** SUMMARY ***
Total pot $5 | Rake $0
Seat 1: vkfxu8f/jMYKUk6Ly4eujw (big blind) folded before Flop
Seat 2: 4dcDwIHRm96PwtqkpQiuiA folded before Flop (didn't bet)
Seat 3: ubtx4Z5L+AcK71MTvYiGVw folded before Flop (didn't bet)
Seat 5: VvdR9F3I+2yELkfTVvC1dg (button) collected ($5)
Seat 6: uCqEjnxh2/vFBjKYkfTOkw (small blind) folded before Flop



PokerStars Game #59941664790:  Hold'em No Limit ($1/$2) - 2009/07/01 1:42:18 ET
Table '/dyk+YdRGv90j2box35j8w' 6-max Seat #6 is the button
Seat 1: 8srN1dKQePlsv0GyTada+Q ($200 in chips)
Seat 2: qCnEYuAE5y5A7bk6fO5/jQ ($484.20 in chips)
Seat 3: sTPOWERd9HWPCNrDBwsVjA ($209.50 in chips)
Seat 5: VvdR9F3I+2yELkfTVvC1dg ($254.55 in chips)
Seat 6: gnYme0DNFflnMhrdbxe1Ag ($200 in chips)
8srN1dKQePlsv0GyTada+Q: posts small blind $1
qCnEYuAE5y5A7bk6fO5/jQ: posts big blind $2
*** HOLE CARDS ***
sTPOWERd9HWPCNrDBwsVjA: folds
VvdR9F3I+2yELkfTVvC1dg: folds
gnYme0DNFflnMhrdbxe1Ag: folds
8srN1dKQePlsv0GyTada+Q: raises $4 to $6
qCnEYuAE5y5A7bk6fO5/jQ: folds
8srN1dKQePlsv0GyTada+Q collected $4 from pot
8srN1dKQePlsv0GyTada+Q: doesn't show hand
*** SUMMARY ***
Total pot $4 | Rake $0
Seat 1: 8srN1dKQePlsv0GyTada+Q (small blind) collected ($4)
Seat 2: qCnEYuAE5y5A7bk6fO5/jQ (big blind) folded before Flop
Seat 3: sTPOWERd9HWPCNrDBwsVjA folded before Flop (didn't bet)
Seat 5: VvdR9F3I+2yELkfTVvC1dg folded before Flop (didn't bet)
Seat 6: gnYme0DNFflnMhrdbxe1Ag (button) folded before Flop (didn't bet)



PokerStars Game #59941665412:  Hold'em No Limit ($1/$2) - 2009/07/01 1:42:19 ET
Table 'mGpP9StWRnoeiBDExc6Frg' 6-max Seat #5 is the button
Seat 1: VvdR9F3I+2yELkfTVvC1dg ($309.15 in chips)
Seat 2: vkfxu8f/jMYKUk6Ly4eujw ($204 in chips)
Seat 3: 7acrZUQC3Zc9BNLjoKIcLQ ($30.85 in chips)
Seat 4: 4dcDwIHRm96PwtqkpQiuiA ($66.70 in chips)
Seat 5: d1puGuVBE0fidn+5eRJ0tw ($207.55 in chips)
Seat 6: B2Ih1sr5VZk+8He7rcrMtQ ($414.80 in chips)
B2Ih1sr5VZk+8He7rcrMtQ: posts small blind $1
VvdR9F3I+2yELkfTVvC1dg: posts big blind $2
*** HOLE CARDS ***
vkfxu8f/jMYKUk6Ly4eujw: folds
7acrZUQC3Zc9BNLjoKIcLQ: folds
4dcDwIHRm96PwtqkpQiuiA: folds
d1puGuVBE0fidn+5eRJ0tw: folds
B2Ih1sr5VZk+8He7rcrMtQ: folds
VvdR9F3I+2yELkfTVvC1dg collected $2 from pot
VvdR9F3I+2yELkfTVvC1dg: doesn't show hand
*** SUMMARY ***
Total pot $2 | Rake $0
Seat 1: VvdR9F3I+2yELkfTVvC1dg (big blind) collected ($2)
Seat 2: vkfxu8f/jMYKUk6Ly4eujw folded before Flop (didn't bet)
Seat 3: 7acrZUQC3Zc9BNLjoKIcLQ folded before Flop (didn't bet)
Seat 4: 4dcDwIHRm96PwtqkpQiuiA folded before Flop (didn't bet)
Seat 5: d1puGuVBE0fidn+5eRJ0tw (button) folded before Flop (didn't bet)
Seat 6: B2Ih1sr5VZk+8He7rcrMtQ (small blind) folded before Flop



PokerStars Game #59941665318:  Hold'em No Limit ($1/$2) - 2009/07/01 1:42:19 ET
Table 'P/yCfYl1GfGsu/e6DxDy/A' 2-max Seat #1 is the button
Seat 1: 7fOCUy3x9hdkmXkkDNolGQ ($426.50 in chips)
Seat 2: RwDoM55ZeQuI2ADyJhOb2Q ($1049.50 in chips)
7fOCUy3x9hdkmXkkDNolGQ: posts small blind $1
RwDoM55ZeQuI2ADyJhOb2Q: posts big blind $2
*** HOLE CARDS ***
7fOCUy3x9hdkmXkkDNolGQ: raises $4 to $6
RwDoM55ZeQuI2ADyJhOb2Q: folds
7fOCUy3x9hdkmXkkDNolGQ collected $4 from pot
7fOCUy3x9hdkmXkkDNolGQ: doesn't show hand
*** SUMMARY ***
Total pot $4 | Rake $0
Seat 1: 7fOCUy3x9hdkmXkkDNolGQ (button) (small blind) collected ($4)
Seat 2: RwDoM55ZeQuI2ADyJhOb2Q (big blind) folded before Flop



PokerStars Game #59941665860:  Hold'em No Limit ($1/$2) - 2009/07/01 1:42:20 ET
Table '3WCXyaiCAbqSShQu7FIjvA' 9-max Seat #3 is the button
Seat 1: kTCkABD1UUldS9DFRGfCwQ ($150.75 in chips)
Seat 2: TAfo4veNRaRlzDXMMYS3Jg ($39.70 in chips)
Seat 3: 5Q8U6iZbeO7xJSS4qvDP5g ($270.25 in chips)
Seat 4: waEF/+pxZTxNo4FvsORuXg ($104.40 in chips)
Seat 5: CkE3IyJF1KvdaAOmZY5XqQ ($200 in chips)
Seat 6: 5jQlngvMSqM/WoonOcR5kw ($296.80 in chips)
Seat 7: nXDI8Y/S6POzRwANu3d8hQ ($37 in chips)
Seat 8: 1CtiZuXDFaJL1dJPQKyi8Q ($204.05 in chips)
Seat 9: FiXPLJyqb24l32QST2TInw ($107.40 in chips)
waEF/+pxZTxNo4FvsORuXg: posts small blind $1
CkE3IyJF1KvdaAOmZY5XqQ: posts big blind $2
*** HOLE CARDS ***
5jQlngvMSqM/WoonOcR5kw: folds
nXDI8Y/S6POzRwANu3d8hQ: folds
1CtiZuXDFaJL1dJPQKyi8Q: raises $4 to $6
FiXPLJyqb24l32QST2TInw: calls $6
kTCkABD1UUldS9DFRGfCwQ: folds
TAfo4veNRaRlzDXMMYS3Jg: folds
5Q8U6iZbeO7xJSS4qvDP5g: folds
waEF/+pxZTxNo4FvsORuXg: folds
CkE3IyJF1KvdaAOmZY5XqQ: calls $4
*** FLOP *** [8c Kh 8s]
CkE3IyJF1KvdaAOmZY5XqQ: checks
1CtiZuXDFaJL1dJPQKyi8Q: bets $12
FiXPLJyqb24l32QST2TInw: folds
CkE3IyJF1KvdaAOmZY5XqQ: folds
1CtiZuXDFaJL1dJPQKyi8Q collected $18.05 from pot
1CtiZuXDFaJL1dJPQKyi8Q: doesn't show hand
*** SUMMARY ***
Total pot $19 | Rake $0.95
Board [8c Kh 8s]
Seat 1: kTCkABD1UUldS9DFRGfCwQ folded before Flop (didn't bet)
Seat 2: TAfo4veNRaRlzDXMMYS3Jg folded before Flop (didn't bet)
Seat 3: 5Q8U6iZbeO7xJSS4qvDP5g (button) folded before Flop (didn't bet)
Seat 4: waEF/+pxZTxNo4FvsORuXg (small blind) folded before Flop
Seat 5: CkE3IyJF1KvdaAOmZY5XqQ (big blind) folded on the Flop
Seat 6: 5jQlngvMSqM/WoonOcR5kw folded before Flop (didn't bet)
Seat 7: nXDI8Y/S6POzRwANu3d8hQ folded before Flop (didn't bet)
Seat 8: 1CtiZuXDFaJL1dJPQKyi8Q collected ($18.05)
Seat 9: FiXPLJyqb24l32QST2TInw folded on the Flop



PokerStars Game #59941666264:  Hold'em No Limit ($1/$2) - 2009/07/01 1:42:21 ET
Table 'ZzSIe0zTCDv+n6hfbY5tTg' 6-max Seat #2 is the button
Seat 1: VvdR9F3I+2yELkfTVvC1dg ($254 in chips)
Seat 2: B87ikIyZ/TzAVeXf38Ny0g ($234 in chips)
Seat 3: gsugPj31Hui3Jefl98MBOA ($350 in chips)
Seat 4: 54yWzRRgS0oZ+S6LwZBxMQ ($40 in chips)
Seat 5: 3dAbvkxS5NPQTBAbvpinVg ($509.45 in chips)
Seat 6: 09BNF4quPDzanQzM8vc6WA ($36 in chips)
gsugPj31Hui3Jefl98MBOA: posts small blind $1
54yWzRRgS0oZ+S6LwZBxMQ: posts big blind $2
*** HOLE CARDS ***
3dAbvkxS5NPQTBAbvpinVg: folds
09BNF4quPDzanQzM8vc6WA: raises $2 to $4
VvdR9F3I+2yELkfTVvC1dg: folds
B87ikIyZ/TzAVeXf38Ny0g: folds
gsugPj31Hui3Jefl98MBOA: folds
54yWzRRgS0oZ+S6LwZBxMQ: folds
09BNF4quPDzanQzM8vc6WA collected $5 from pot
09BNF4quPDzanQzM8vc6WA: doesn't show hand
*** SUMMARY ***
Total pot $5 | Rake $0
Seat 1: VvdR9F3I+2yELkfTVvC1dg folded before Flop (didn't bet)
Seat 2: B87ikIyZ/TzAVeXf38Ny0g (button) folded before Flop (didn't bet)
Seat 3: gsugPj31Hui3Jefl98MBOA (small blind) folded before Flop
Seat 4: 54yWzRRgS0oZ+S6LwZBxMQ (big blind) folded before Flop
Seat 5: 3dAbvkxS5NPQTBAbvpinVg folded before Flop (didn't bet)
Seat 6: 09BNF4quPDzanQzM8vc6WA collected ($5)



PokerStars Game #59941666838:  Hold'em No Limit ($1/$2) - 2009/07/01 1:42:22 ET
Table 'gnHBqWll9O3fxG7Ojkz/ng' 9-max Seat #1 is the button
Seat 1: TAfo4veNRaRlzDXMMYS3Jg ($36 in chips)
Seat 2: H6Z4+qu8gR0VUiPOijndVg ($329.95 in chips)
Seat 3: 5Q8U6iZbeO7xJSS4qvDP5g ($218.05 in chips)
Seat 4: nXDI8Y/S6POzRwANu3d8hQ ($19 in chips)
Seat 5: rBQDMkKm9cZn6M9NPsiVew ($220.15 in chips)
Seat 6: KqHysDSpCPaPyK3tJC1aEw ($200 in chips)
Seat 7: jqui3xAWCkcdPW36a6BD+w ($342.55 in chips)
Seat 8: cM6efHzdxoqYm0EQKP4TTQ ($114.20 in chips)
Seat 9: GX1heJ+DSsvm7gzSPsYhhQ ($45.35 in chips)
H6Z4+qu8gR0VUiPOijndVg: posts small blind $1
5Q8U6iZbeO7xJSS4qvDP5g: posts big blind $2
*** HOLE CARDS ***
nXDI8Y/S6POzRwANu3d8hQ: folds
rBQDMkKm9cZn6M9NPsiVew: folds
KqHysDSpCPaPyK3tJC1aEw: folds
jqui3xAWCkcdPW36a6BD+w: folds
cM6efHzdxoqYm0EQKP4TTQ: calls $2
GX1heJ+DSsvm7gzSPsYhhQ: folds
TAfo4veNRaRlzDXMMYS3Jg: folds
H6Z4+qu8gR0VUiPOijndVg: folds
5Q8U6iZbeO7xJSS4qvDP5g: checks
*** FLOP *** [5c Kc 2s]
5Q8U6iZbeO7xJSS4qvDP5g: checks
cM6efHzdxoqYm0EQKP4TTQ: bets $6
5Q8U6iZbeO7xJSS4qvDP5g: folds
cM6efHzdxoqYm0EQKP4TTQ collected $4.75 from pot
*** SUMMARY ***
Total pot $5 | Rake $0.25
Board [5c Kc 2s]
Seat 1: TAfo4veNRaRlzDXMMYS3Jg (button) folded before Flop (didn't bet)
Seat 2: H6Z4+qu8gR0VUiPOijndVg (small blind) folded before Flop
Seat 3: 5Q8U6iZbeO7xJSS4qvDP5g (big blind) folded on the Flop
Seat 4: nXDI8Y/S6POzRwANu3d8hQ folded before Flop (didn't bet)
Seat 5: rBQDMkKm9cZn6M9NPsiVew folded before Flop (didn't bet)
Seat 6: KqHysDSpCPaPyK3tJC1aEw folded before Flop (didn't bet)
Seat 7: jqui3xAWCkcdPW36a6BD+w folded before Flop (didn't bet)
Seat 8: cM6efHzdxoqYm0EQKP4TTQ collected ($4.75)
Seat 9: GX1heJ+DSsvm7gzSPsYhhQ folded before Flop (didn't bet)



PokerStars Game #59941666974:  Hold'em No Limit ($1/$2) - 2009/07/01 1:42:22 ET
Table 'pPQgcj9XT9CHBsbo1WTBug' 6-max Seat #5 is the button
Seat 1: DFVYDA6dKQy7R7mGIKogZA ($151.35 in chips)
Seat 2: qXDd0ZyMIse0OBu8pxeQ3Q ($200 in chips)
Seat 3: 54yWzRRgS0oZ+S6LwZBxMQ ($114 in chips)
Seat 5: vkfxu8f/jMYKUk6Ly4eujw ($193.55 in chips)
DFVYDA6dKQy7R7mGIKogZA: posts small blind $1
qXDd0ZyMIse0OBu8pxeQ3Q: posts big blind $2
*** HOLE CARDS ***
54yWzRRgS0oZ+S6LwZBxMQ: folds
gqlysXCbT8V54f/1lf9h3A leaves the table
vkfxu8f/jMYKUk6Ly4eujw: raises $6 to $8
DFVYDA6dKQy7R7mGIKogZA: folds
qXDd0ZyMIse0OBu8pxeQ3Q: folds
vkfxu8f/jMYKUk6Ly4eujw collected $5 from pot
vkfxu8f/jMYKUk6Ly4eujw: doesn't show hand
*** SUMMARY ***
Total pot $5 | Rake $0
Seat 1: DFVYDA6dKQy7R7mGIKogZA (small blind) folded before Flop
Seat 2: qXDd0ZyMIse0OBu8pxeQ3Q (big blind) folded before Flop
Seat 3: 54yWzRRgS0oZ+S6LwZBxMQ folded before Flop (didn't bet)
Seat 5: vkfxu8f/jMYKUk6Ly4eujw (button) collected ($5)



PokerStars Game #59941668018:  Hold'em No Limit ($1/$2) - 2009/07/01 1:42:24 ET
Table 'YqGfR5eHfMeSjb9a+QU9rg' 9-max Seat #2 is the button
Seat 1: rW/MyplHylMSBRaoRUzWrg ($76 in chips)
Seat 2: nXDI8Y/S6POzRwANu3d8hQ ($37 in chips)
Seat 3: /gll27k+xWYV7Fbki0lFDQ ($248.75 in chips)
Seat 4: GX1heJ+DSsvm7gzSPsYhhQ ($40 in chips)
Seat 5: CkE3IyJF1KvdaAOmZY5XqQ ($205.80 in chips)
Seat 6: TAfo4veNRaRlzDXMMYS3Jg ($40 in chips)
Seat 7: 41aZuLBz9nAi2GPVKabmCw ($84.95 in chips)
Seat 8: JnV3SM2D6dAFYyGZHHpvrg ($102.15 in chips)
Seat 9: /inIs/z/PcX+TniIFpaxpg ($204.20 in chips)
/gll27k+xWYV7Fbki0lFDQ: posts small blind $1
GX1heJ+DSsvm7gzSPsYhhQ: posts big blind $2
*** HOLE CARDS ***
CkE3IyJF1KvdaAOmZY5XqQ: folds
TAfo4veNRaRlzDXMMYS3Jg: folds
41aZuLBz9nAi2GPVKabmCw: folds
JnV3SM2D6dAFYyGZHHpvrg: folds
/inIs/z/PcX+TniIFpaxpg: folds
rW/MyplHylMSBRaoRUzWrg: folds
nXDI8Y/S6POzRwANu3d8hQ: folds
/gll27k+xWYV7Fbki0lFDQ: calls $1
GX1heJ+DSsvm7gzSPsYhhQ: checks
*** FLOP *** [Jh 3s Kd]
/gll27k+xWYV7Fbki0lFDQ: bets $4
GX1heJ+DSsvm7gzSPsYhhQ: folds
/gll27k+xWYV7Fbki0lFDQ collected $3.80 from pot
/gll27k+xWYV7Fbki0lFDQ: shows [Js 7d] (a pair of Jacks)
*** SUMMARY ***
Total pot $4 | Rake $0.20
Board [Jh 3s Kd]
Seat 1: rW/MyplHylMSBRaoRUzWrg folded before Flop (didn't bet)
Seat 2: nXDI8Y/S6POzRwANu3d8hQ (button) folded before Flop (didn't bet)
Seat 3: /gll27k+xWYV7Fbki0lFDQ (small blind) collected ($3.80)
Seat 4: GX1heJ+DSsvm7gzSPsYhhQ (big blind) folded on the Flop
Seat 5: CkE3IyJF1KvdaAOmZY5XqQ folded before Flop (didn't bet)
Seat 6: TAfo4veNRaRlzDXMMYS3Jg folded before Flop (didn't bet)
Seat 7: 41aZuLBz9nAi2GPVKabmCw folded before Flop (didn't bet)
Seat 8: JnV3SM2D6dAFYyGZHHpvrg folded before Flop (didn't bet)
Seat 9: /inIs/z/PcX+TniIFpaxpg folded before Flop (didn't bet)



PokerStars Game #59941667710:  Hold'em No Limit ($1/$2) - 2009/07/01 1:42:24 ET
Table 'aSf77Sj8QEnzcc0WaxVD4Q' 6-max Seat #1 is the button
Seat 1: UELtvp+JfwI7XDGVwSxZXA ($245.10 in chips)
Seat 2: vkfxu8f/jMYKUk6Ly4eujw ($198 in chips)
Seat 3: 9dpyyjDTCed6nV7JhaUUpw ($743.75 in chips)
Seat 4: YsLQ3BAvgQHWXMAv3Wv6Hg ($203 in chips)
Seat 5: VvdR9F3I+2yELkfTVvC1dg ($251 in chips)
Seat 6: vkoJRf3gidxY1pPi0AFWww ($140.50 in chips)
vkfxu8f/jMYKUk6Ly4eujw: posts small blind $1
9dpyyjDTCed6nV7JhaUUpw: posts big blind $2
*** HOLE CARDS ***
YsLQ3BAvgQHWXMAv3Wv6Hg: folds
VvdR9F3I+2yELkfTVvC1dg: raises $2 to $4
vkoJRf3gidxY1pPi0AFWww: calls $4
UELtvp+JfwI7XDGVwSxZXA: folds
vkfxu8f/jMYKUk6Ly4eujw: folds
9dpyyjDTCed6nV7JhaUUpw: folds
*** FLOP *** [Kc 6c 2c]
VvdR9F3I+2yELkfTVvC1dg: bets $7.80
vkoJRf3gidxY1pPi0AFWww: folds
VvdR9F3I+2yELkfTVvC1dg collected $10.45 from pot
VvdR9F3I+2yELkfTVvC1dg: doesn't show hand
*** SUMMARY ***
Total pot $11 | Rake $0.55
Board [Kc 6c 2c]
Seat 1: UELtvp+JfwI7XDGVwSxZXA (button) folded before Flop (didn't bet)
Seat 2: vkfxu8f/jMYKUk6Ly4eujw (small blind) folded before Flop
Seat 3: 9dpyyjDTCed6nV7JhaUUpw (big blind) folded before Flop
Seat 4: YsLQ3BAvgQHWXMAv3Wv6Hg folded before Flop (didn't bet)
Seat 5: VvdR9F3I+2yELkfTVvC1dg collected ($10.45)
Seat 6: vkoJRf3gidxY1pPi0AFWww folded on the Flop



PokerStars Game #59941668800:  Hold'em No Limit ($1/$2) - 2009/07/01 1:42:26 ET
Table 'P/yCfYl1GfGsu/e6DxDy/A' 2-max Seat #2 is the button
Seat 1: 7fOCUy3x9hdkmXkkDNolGQ ($428.50 in chips)
Seat 2: RwDoM55ZeQuI2ADyJhOb2Q ($1047.50 in chips)
RwDoM55ZeQuI2ADyJhOb2Q: posts small blind $1
7fOCUy3x9hdkmXkkDNolGQ: posts big blind $2
*** HOLE CARDS ***
RwDoM55ZeQuI2ADyJhOb2Q: raises $4 to $6
7fOCUy3x9hdkmXkkDNolGQ: folds
RwDoM55ZeQuI2ADyJhOb2Q collected $4 from pot
RwDoM55ZeQuI2ADyJhOb2Q: doesn't show hand
*** SUMMARY ***
Total pot $4 | Rake $0
Seat 1: 7fOCUy3x9hdkmXkkDNolGQ (big blind) folded before Flop
Seat 2: RwDoM55ZeQuI2ADyJhOb2Q (button) (small blind) collected ($4)



PokerStars Game #59941669418:  Hold'em No Limit ($1/$2) - 2009/07/01 1:42:27 ET
Table 'jlrIxbrVIG+gjaUYT4za8g' 6-max Seat #4 is the button
Seat 1: ygTTt5ehT4aF86q1a8/R+w ($235.30 in chips)
Seat 2: /PH6Ffnho4Ysm8S3V/oa+w ($60 in chips)
Seat 3: gnYme0DNFflnMhrdbxe1Ag ($200 in chips)
Seat 4: 8srN1dKQePlsv0GyTada+Q ($263.95 in chips)
Seat 5: AyBB0k3Dcl7xbXUeGMw06g ($41.40 in chips)
Seat 6: BWhgxe7gWiYobRbwdG+d2Q ($196 in chips)
AyBB0k3Dcl7xbXUeGMw06g: posts small blind $1
BWhgxe7gWiYobRbwdG+d2Q: posts big blind $2
*** HOLE CARDS ***
ygTTt5ehT4aF86q1a8/R+w: folds
/PH6Ffnho4Ysm8S3V/oa+w: folds
gnYme0DNFflnMhrdbxe1Ag: raises $4 to $6
8srN1dKQePlsv0GyTada+Q: folds
AyBB0k3Dcl7xbXUeGMw06g: folds
BWhgxe7gWiYobRbwdG+d2Q: folds
gnYme0DNFflnMhrdbxe1Ag collected $5 from pot
*** SUMMARY ***
Total pot $5 | Rake $0
Seat 1: ygTTt5ehT4aF86q1a8/R+w folded before Flop (didn't bet)
Seat 2: /PH6Ffnho4Ysm8S3V/oa+w folded before Flop (didn't bet)
Seat 3: gnYme0DNFflnMhrdbxe1Ag collected ($5)
Seat 4: 8srN1dKQePlsv0GyTada+Q (button) folded before Flop (didn't bet)
Seat 5: AyBB0k3Dcl7xbXUeGMw06g (small blind) folded before Flop
Seat 6: BWhgxe7gWiYobRbwdG+d2Q (big blind) folded before Flop



PokerStars Game #59941670580:  Hold'em No Limit ($1/$2) - 2009/07/01 1:42:29 ET
Table 'rKeCh+eBn4RNvybCUYkoTQ' 9-max Seat #6 is the button
Seat 1: /inIs/z/PcX+TniIFpaxpg ($182 in chips)
Seat 2: nXDI8Y/S6POzRwANu3d8hQ ($131.25 in chips)
Seat 3: GX1heJ+DSsvm7gzSPsYhhQ ($40 in chips)
Seat 5: WUlHm+ydPPHG7Lb0rePSdA ($120 in chips)
Seat 6: EBV6OktyeSmh4w6sWmcWOw ($286.80 in chips)
Seat 7: rW/MyplHylMSBRaoRUzWrg ($38 in chips)
Seat 8: pN/Ip0ePsUVIdUlGgLrkUw ($246.35 in chips)
rW/MyplHylMSBRaoRUzWrg: posts small blind $1
pN/Ip0ePsUVIdUlGgLrkUw: posts big blind $2
31HuO+DQxppUQEedBWukug: sits out
*** HOLE CARDS ***
/inIs/z/PcX+TniIFpaxpg: folds
nXDI8Y/S6POzRwANu3d8hQ: raises $4 to $6
GX1heJ+DSsvm7gzSPsYhhQ: folds
WUlHm+ydPPHG7Lb0rePSdA: folds
EBV6OktyeSmh4w6sWmcWOw: folds
rW/MyplHylMSBRaoRUzWrg: folds
pN/Ip0ePsUVIdUlGgLrkUw: folds
nXDI8Y/S6POzRwANu3d8hQ collected $5 from pot
nXDI8Y/S6POzRwANu3d8hQ: doesn't show hand
*** SUMMARY ***
Total pot $5 | Rake $0
Seat 1: /inIs/z/PcX+TniIFpaxpg folded before Flop (didn't bet)
Seat 2: nXDI8Y/S6POzRwANu3d8hQ collected ($5)
Seat 3: GX1heJ+DSsvm7gzSPsYhhQ folded before Flop (didn't bet)
Seat 5: WUlHm+ydPPHG7Lb0rePSdA folded before Flop (didn't bet)
Seat 6: EBV6OktyeSmh4w6sWmcWOw (button) folded before Flop (didn't bet)
Seat 7: rW/MyplHylMSBRaoRUzWrg (small blind) folded before Flop
Seat 8: pN/Ip0ePsUVIdUlGgLrkUw (big blind) folded before Flop



PokerStars Game #59941670948:  Hold'em No Limit ($1/$2) - 2009/07/01 1:42:30 ET
Table '4NGNnZ/osQfNq6abYqkJeA' 6-max Seat #6 is the button
Seat 2: 669iGNwYwgRZg3nhS+aDAQ ($126.25 in chips)
Seat 3: 54yWzRRgS0oZ+S6LwZBxMQ ($40 in chips)
Seat 4: sY+4Uuh5z/6AbXXaCS10jw ($230.25 in chips)
Seat 5: VvdR9F3I+2yELkfTVvC1dg ($231.55 in chips)
Seat 6: /PH6Ffnho4Ysm8S3V/oa+w ($40 in chips)
xUTLK/SDwl6IxZdaKduuFg will be allowed to play after the button
669iGNwYwgRZg3nhS+aDAQ: posts small blind $1
54yWzRRgS0oZ+S6LwZBxMQ: posts big blind $2
*** HOLE CARDS ***
sY+4Uuh5z/6AbXXaCS10jw: folds
VvdR9F3I+2yELkfTVvC1dg: folds
/PH6Ffnho4Ysm8S3V/oa+w: raises $2 to $4
669iGNwYwgRZg3nhS+aDAQ: raises $6 to $10
54yWzRRgS0oZ+S6LwZBxMQ: folds
/PH6Ffnho4Ysm8S3V/oa+w: folds
669iGNwYwgRZg3nhS+aDAQ collected $10 from pot
*** SUMMARY ***
Total pot $10 | Rake $0
Seat 2: 669iGNwYwgRZg3nhS+aDAQ (small blind) collected ($10)
Seat 3: 54yWzRRgS0oZ+S6LwZBxMQ (big blind) folded before Flop
Seat 4: sY+4Uuh5z/6AbXXaCS10jw folded before Flop (didn't bet)
Seat 5: VvdR9F3I+2yELkfTVvC1dg folded before Flop (didn't bet)
Seat 6: /PH6Ffnho4Ysm8S3V/oa+w (button) folded before Flop



PokerStars Game #59941671532:  Hold'em No Limit ($1/$2) - 2009/07/01 1:42:31 ET
Table 'NmY84NAf9Mh0ckAckHnh5g' 2-max Seat #2 is the button
Seat 1: 6hvg964TSqZ3AL/0XK9aVQ ($533.20 in chips)
Seat 2: RwDoM55ZeQuI2ADyJhOb2Q ($457.50 in chips)
RwDoM55ZeQuI2ADyJhOb2Q: posts small blind $1
6hvg964TSqZ3AL/0XK9aVQ: posts big blind $2
*** HOLE CARDS ***
RwDoM55ZeQuI2ADyJhOb2Q: raises $4 to $6
6hvg964TSqZ3AL/0XK9aVQ: folds
RwDoM55ZeQuI2ADyJhOb2Q collected $4 from pot
RwDoM55ZeQuI2ADyJhOb2Q: doesn't show hand
*** SUMMARY ***
Total pot $4 | Rake $0
Seat 1: 6hvg964TSqZ3AL/0XK9aVQ (big blind) folded before Flop
Seat 2: RwDoM55ZeQuI2ADyJhOb2Q (button) (small blind) collected ($4)



PokerStars Game #59941672662:  Hold'em No Limit ($1/$2) - 2009/07/01 1:42:33 ET
Table 'G1Oqdy4Pqdb5gtx40rUBzA' 6-max Seat #2 is the button
Seat 1: BWhgxe7gWiYobRbwdG+d2Q ($196 in chips)
Seat 2: m7mYVfnCOK5TE/VkN/FhOg ($202 in chips)
Seat 3: VvdR9F3I+2yELkfTVvC1dg ($216.90 in chips)
Seat 4: B87ikIyZ/TzAVeXf38Ny0g ($211.55 in chips)
Seat 5: F1+Ml47qRQWunzPnGhLLzQ ($203.40 in chips)
Seat 6: qCnEYuAE5y5A7bk6fO5/jQ ($211.25 in chips)
VvdR9F3I+2yELkfTVvC1dg: posts small blind $1
B87ikIyZ/TzAVeXf38Ny0g: posts big blind $2
*** HOLE CARDS ***
F1+Ml47qRQWunzPnGhLLzQ: calls $2
qCnEYuAE5y5A7bk6fO5/jQ: folds
BWhgxe7gWiYobRbwdG+d2Q: folds
m7mYVfnCOK5TE/VkN/FhOg: raises $6 to $8
VvdR9F3I+2yELkfTVvC1dg: folds
B87ikIyZ/TzAVeXf38Ny0g: folds
F1+Ml47qRQWunzPnGhLLzQ: calls $6
*** FLOP *** [4s Qc Ah]
F1+Ml47qRQWunzPnGhLLzQ: checks
m7mYVfnCOK5TE/VkN/FhOg: bets $12
F1+Ml47qRQWunzPnGhLLzQ: folds
m7mYVfnCOK5TE/VkN/FhOg collected $18.05 from pot
m7mYVfnCOK5TE/VkN/FhOg: doesn't show hand
*** SUMMARY ***
Total pot $19 | Rake $0.95
Board [4s Qc Ah]
Seat 1: BWhgxe7gWiYobRbwdG+d2Q folded before Flop (didn't bet)
Seat 2: m7mYVfnCOK5TE/VkN/FhOg (button) collected ($18.05)
Seat 3: VvdR9F3I+2yELkfTVvC1dg (small blind) folded before Flop
Seat 4: B87ikIyZ/TzAVeXf38Ny0g (big blind) folded before Flop
Seat 5: F1+Ml47qRQWunzPnGhLLzQ folded on the Flop
Seat 6: qCnEYuAE5y5A7bk6fO5/jQ folded before Flop (didn't bet)



PokerStars Game #59941672600:  Hold'em No Limit ($1/$2) - 2009/07/01 1:42:33 ET
Table 'qVXak+oTeDXMGbWa4sDU5Q' 9-max Seat #7 is the button
Seat 1: H6Z4+qu8gR0VUiPOijndVg ($233.45 in chips)
Seat 2: CST1bO+CmVQOtNgiT0cKPg ($79.75 in chips)
Seat 3: WUlHm+ydPPHG7Lb0rePSdA ($172.10 in chips)
Seat 4: lQYT23h5QCUVZAKxjOO39Q ($188.10 in chips)
Seat 5: zJtQ1gxyi72XvGYS1tM+DA ($97 in chips)
Seat 6: GX1heJ+DSsvm7gzSPsYhhQ ($40 in chips)
Seat 7: 6oGEJqk9oDy29sSaLs+LGA ($78.65 in chips)
Seat 8: Z0rzUi0y1x80UdIpofoNbA ($107.55 in chips)
Seat 9: CkE3IyJF1KvdaAOmZY5XqQ ($215.55 in chips)
Z0rzUi0y1x80UdIpofoNbA: posts small blind $1
CkE3IyJF1KvdaAOmZY5XqQ: posts big blind $2
*** HOLE CARDS ***
H6Z4+qu8gR0VUiPOijndVg: folds
CST1bO+CmVQOtNgiT0cKPg: folds
WUlHm+ydPPHG7Lb0rePSdA: folds
lQYT23h5QCUVZAKxjOO39Q: calls $2
zJtQ1gxyi72XvGYS1tM+DA has timed out
zJtQ1gxyi72XvGYS1tM+DA: folds
zJtQ1gxyi72XvGYS1tM+DA is sitting out
GX1heJ+DSsvm7gzSPsYhhQ: raises $6 to $8
6oGEJqk9oDy29sSaLs+LGA: calls $8
Z0rzUi0y1x80UdIpofoNbA: folds
CkE3IyJF1KvdaAOmZY5XqQ: folds
lQYT23h5QCUVZAKxjOO39Q: calls $6
*** FLOP *** [2d 7c 2c]
lQYT23h5QCUVZAKxjOO39Q: checks
GX1heJ+DSsvm7gzSPsYhhQ: bets $10
6oGEJqk9oDy29sSaLs+LGA: raises $24 to $34
lQYT23h5QCUVZAKxjOO39Q: folds
GX1heJ+DSsvm7gzSPsYhhQ: calls $22 and is all-in
*** TURN *** [2d 7c 2c] [6c]
*** RIVER *** [2d 7c 2c 6c] [9d]
*** SHOW DOWN ***
GX1heJ+DSsvm7gzSPsYhhQ: shows [Jc Jh] (two pair, Jacks and Deuces)
6oGEJqk9oDy29sSaLs+LGA: mucks hand
GX1heJ+DSsvm7gzSPsYhhQ collected $88 from pot
*** SUMMARY ***
Total pot $91 | Rake $3
Board [2d 7c 2c 6c 9d]
Seat 1: H6Z4+qu8gR0VUiPOijndVg folded before Flop (didn't bet)
Seat 2: CST1bO+CmVQOtNgiT0cKPg folded before Flop (didn't bet)
Seat 3: WUlHm+ydPPHG7Lb0rePSdA folded before Flop (didn't bet)
Seat 4: lQYT23h5QCUVZAKxjOO39Q folded on the Flop
Seat 5: zJtQ1gxyi72XvGYS1tM+DA folded before Flop (didn't bet)
Seat 6: GX1heJ+DSsvm7gzSPsYhhQ showed [Jc Jh] and won ($88) with two pair, Jacks and Deuces
Seat 7: 6oGEJqk9oDy29sSaLs+LGA (button) mucked
Seat 8: Z0rzUi0y1x80UdIpofoNbA (small blind) folded before Flop
Seat 9: CkE3IyJF1KvdaAOmZY5XqQ (big blind) folded before Flop



PokerStars Game #59941673244:  Hold'em No Limit ($1/$2) - 2009/07/01 1:42:34 ET
Table '/ci73fTmzTzmGWzAtqEX2Q' 9-max Seat #8 is the button
Seat 1: 9efVc1cB3yHt4TvBkTusPw ($148.90 in chips)
Seat 2: pN/Ip0ePsUVIdUlGgLrkUw ($225 in chips)
Seat 3: kK1+5ivyJZeA8hQF2pdvvQ ($59.55 in chips)
Seat 4: 2yq7Zp4xmrhAw8+37hTkaA ($161.20 in chips)
Seat 5: 1CtiZuXDFaJL1dJPQKyi8Q ($191.75 in chips)
Seat 6: KqHysDSpCPaPyK3tJC1aEw ($200 in chips)
Seat 7: +T/63sAeZzWyHchahJ36GQ ($37 in chips)
Seat 8: /inIs/z/PcX+TniIFpaxpg ($35.75 in chips)
Seat 9: S8aS+9FTYQ/ICLBNThcrkg ($175 in chips)
S8aS+9FTYQ/ICLBNThcrkg: posts small blind $1
9efVc1cB3yHt4TvBkTusPw: posts big blind $2
*** HOLE CARDS ***
pN/Ip0ePsUVIdUlGgLrkUw: folds
kK1+5ivyJZeA8hQF2pdvvQ: folds
kK1+5ivyJZeA8hQF2pdvvQ leaves the table
2yq7Zp4xmrhAw8+37hTkaA: folds
1CtiZuXDFaJL1dJPQKyi8Q: folds
KqHysDSpCPaPyK3tJC1aEw: folds
254YPxPJr5Sw58bkD0YqYQ joins the table at seat #3
+T/63sAeZzWyHchahJ36GQ: raises $4 to $6
/inIs/z/PcX+TniIFpaxpg: folds
S8aS+9FTYQ/ICLBNThcrkg: folds
9efVc1cB3yHt4TvBkTusPw: calls $4
*** FLOP *** [5h 7h As]
9efVc1cB3yHt4TvBkTusPw: checks
+T/63sAeZzWyHchahJ36GQ: bets $6
9efVc1cB3yHt4TvBkTusPw: raises $6 to $12
+T/63sAeZzWyHchahJ36GQ: calls $6
*** TURN *** [5h 7h As] [4c]
9efVc1cB3yHt4TvBkTusPw: bets $20
+T/63sAeZzWyHchahJ36GQ: calls $19 and is all-in
*** RIVER *** [5h 7h As 4c] [Qh]
*** SHOW DOWN ***
9efVc1cB3yHt4TvBkTusPw: shows [6s 7s] (a pair of Sevens)
+T/63sAeZzWyHchahJ36GQ: shows [Ah 4s] (two pair, Aces and Fours)
+T/63sAeZzWyHchahJ36GQ collected $72 from pot
*** SUMMARY ***
Total pot $75 | Rake $3
Board [5h 7h As 4c Qh]
Seat 1: 9efVc1cB3yHt4TvBkTusPw (big blind) showed [6s 7s] and lost with a pair of Sevens
Seat 2: pN/Ip0ePsUVIdUlGgLrkUw folded before Flop (didn't bet)
Seat 3: kK1+5ivyJZeA8hQF2pdvvQ folded before Flop (didn't bet)
Seat 4: 2yq7Zp4xmrhAw8+37hTkaA folded before Flop (didn't bet)
Seat 5: 1CtiZuXDFaJL1dJPQKyi8Q folded before Flop (didn't bet)
Seat 6: KqHysDSpCPaPyK3tJC1aEw folded before Flop (didn't bet)
Seat 7: +T/63sAeZzWyHchahJ36GQ showed [Ah 4s] and won ($72) with two pair, Aces and Fours
Seat 8: /inIs/z/PcX+TniIFpaxpg (button) folded before Flop (didn't bet)
Seat 9: S8aS+9FTYQ/ICLBNThcrkg (small blind) folded before Flop



PokerStars Game #59941673324:  Hold'em No Limit ($1/$2) - 2009/07/01 1:42:34 ET
Table 'zEOkwFUmNLBlvazOXtwH8w' 2-max Seat #1 is the button
Seat 1: gu6Ee9WAefYH8BG9//A1pw ($180 in chips)
Seat 2: SLKKhEamo9/21wMiSyGsQw ($158.50 in chips)
gu6Ee9WAefYH8BG9//A1pw: posts small blind $1
SLKKhEamo9/21wMiSyGsQw: posts big blind $2
*** HOLE CARDS ***
SLKKhEamo9/21wMiSyGsQw said, "te voy a ganar"
gu6Ee9WAefYH8BG9//A1pw: raises $62 to $64
SLKKhEamo9/21wMiSyGsQw: raises $94.50 to $158.50 and is all-in
gu6Ee9WAefYH8BG9//A1pw said, "tengo A K"
gu6Ee9WAefYH8BG9//A1pw said, "coÃ¯Â¿Â½o"
gu6Ee9WAefYH8BG9//A1pw: folds
SLKKhEamo9/21wMiSyGsQw said, "jajaja estas cagado"
SLKKhEamo9/21wMiSyGsQw collected $128 from pot
SLKKhEamo9/21wMiSyGsQw: doesn't show hand
*** SUMMARY ***
Total pot $128 | Rake $0
Seat 1: gu6Ee9WAefYH8BG9//A1pw (button) (small blind) folded before Flop
Seat 2: SLKKhEamo9/21wMiSyGsQw (big blind) collected ($128)



PokerStars Game #59941673174:  Hold'em No Limit ($1/$2) - 2009/07/01 1:42:34 ET
Table 'P/yCfYl1GfGsu/e6DxDy/A' 2-max Seat #1 is the button
Seat 1: 7fOCUy3x9hdkmXkkDNolGQ ($426.50 in chips)
Seat 2: RwDoM55ZeQuI2ADyJhOb2Q ($1049.50 in chips)
7fOCUy3x9hdkmXkkDNolGQ: posts small blind $1
RwDoM55ZeQuI2ADyJhOb2Q: posts big blind $2
*** HOLE CARDS ***
7fOCUy3x9hdkmXkkDNolGQ: raises $4 to $6
RwDoM55ZeQuI2ADyJhOb2Q: raises $24 to $30
7fOCUy3x9hdkmXkkDNolGQ: calls $24
*** FLOP *** [8h 5s Qs]
RwDoM55ZeQuI2ADyJhOb2Q: bets $32
7fOCUy3x9hdkmXkkDNolGQ: raises $46 to $78
RwDoM55ZeQuI2ADyJhOb2Q: calls $46
*** TURN *** [8h 5s Qs] [2c]
RwDoM55ZeQuI2ADyJhOb2Q: checks
7fOCUy3x9hdkmXkkDNolGQ: bets $176
RwDoM55ZeQuI2ADyJhOb2Q: folds
7fOCUy3x9hdkmXkkDNolGQ collected $215.50 from pot
7fOCUy3x9hdkmXkkDNolGQ: doesn't show hand
*** SUMMARY ***
Total pot $216 | Rake $0.50
Board [8h 5s Qs 2c]
Seat 1: 7fOCUy3x9hdkmXkkDNolGQ (button) (small blind) collected ($215.50)
Seat 2: RwDoM55ZeQuI2ADyJhOb2Q (big blind) folded on the Turn



PokerStars Game #59941674992:  Hold'em No Limit ($1/$2) - 2009/07/01 1:42:37 ET
Table 'kq5zaQ+1hLNf8LZfGnbTAA' 6-max Seat #1 is the button
Seat 1: 8srN1dKQePlsv0GyTada+Q ($413.60 in chips)
Seat 2: nXDI8Y/S6POzRwANu3d8hQ ($141 in chips)
Seat 3: /PH6Ffnho4Ysm8S3V/oa+w ($52.15 in chips)
Seat 4: 3dAbvkxS5NPQTBAbvpinVg ($278.45 in chips)
Seat 5: gnYme0DNFflnMhrdbxe1Ag ($222.35 in chips)
Seat 6: mfy7uGZcqA2PVQqEVbJ7+g ($204.15 in chips)
nXDI8Y/S6POzRwANu3d8hQ: posts small blind $1
/PH6Ffnho4Ysm8S3V/oa+w: posts big blind $2
*** HOLE CARDS ***
3dAbvkxS5NPQTBAbvpinVg: raises $6 to $8
gnYme0DNFflnMhrdbxe1Ag: folds
mfy7uGZcqA2PVQqEVbJ7+g: folds
8srN1dKQePlsv0GyTada+Q: folds
nXDI8Y/S6POzRwANu3d8hQ: folds
/PH6Ffnho4Ysm8S3V/oa+w: folds
3dAbvkxS5NPQTBAbvpinVg collected $5 from pot
3dAbvkxS5NPQTBAbvpinVg: doesn't show hand
*** SUMMARY ***
Total pot $5 | Rake $0
Seat 1: 8srN1dKQePlsv0GyTada+Q (button) folded before Flop (didn't bet)
Seat 2: nXDI8Y/S6POzRwANu3d8hQ (small blind) folded before Flop
Seat 3: /PH6Ffnho4Ysm8S3V/oa+w (big blind) folded before Flop
Seat 4: 3dAbvkxS5NPQTBAbvpinVg collected ($5)
Seat 5: gnYme0DNFflnMhrdbxe1Ag folded before Flop (didn't bet)
Seat 6: mfy7uGZcqA2PVQqEVbJ7+g folded before Flop (didn't bet)



PokerStars Game #59941675368:  Hold'em No Limit ($1/$2) - 2009/07/01 1:42:38 ET
Table 'NmY84NAf9Mh0ckAckHnh5g' 2-max Seat #1 is the button
Seat 1: 6hvg964TSqZ3AL/0XK9aVQ ($531.20 in chips)
Seat 2: RwDoM55ZeQuI2ADyJhOb2Q ($459.50 in chips)
6hvg964TSqZ3AL/0XK9aVQ: posts small blind $1
RwDoM55ZeQuI2ADyJhOb2Q: posts big blind $2
*** HOLE CARDS ***
6hvg964TSqZ3AL/0XK9aVQ: folds
RwDoM55ZeQuI2ADyJhOb2Q collected $2 from pot
RwDoM55ZeQuI2ADyJhOb2Q: doesn't show hand
*** SUMMARY ***
Total pot $2 | Rake $0
Seat 1: 6hvg964TSqZ3AL/0XK9aVQ (button) (small blind) folded before Flop
Seat 2: RwDoM55ZeQuI2ADyJhOb2Q (big blind) collected ($2)



PokerStars Game #59941676432:  Hold'em No Limit ($1/$2) - 2009/07/01 1:42:40 ET
Table 'bJQ024BaYSBrW0sXpCZbNQ' 6-max Seat #4 is the button
Seat 1: KfwW5us6tydK81NYTtK1gw ($203 in chips)
Seat 2: 3dAbvkxS5NPQTBAbvpinVg ($200 in chips)
Seat 3: /PH6Ffnho4Ysm8S3V/oa+w ($49 in chips)
Seat 4: TBaQIN+sQ7eb7P99QnaORQ ($82.80 in chips)
Seat 5: VvdR9F3I+2yELkfTVvC1dg ($200 in chips)
Seat 6: 4bqvCfJ0e8CTYnn0Go9hbQ ($146.20 in chips)
VvdR9F3I+2yELkfTVvC1dg: posts small blind $1
4bqvCfJ0e8CTYnn0Go9hbQ: posts big blind $2
*** HOLE CARDS ***
KfwW5us6tydK81NYTtK1gw: folds
3dAbvkxS5NPQTBAbvpinVg: raises $4 to $6
/PH6Ffnho4Ysm8S3V/oa+w: folds
TBaQIN+sQ7eb7P99QnaORQ: raises $4 to $10
VvdR9F3I+2yELkfTVvC1dg: folds
4bqvCfJ0e8CTYnn0Go9hbQ: folds
3dAbvkxS5NPQTBAbvpinVg: calls $4
*** FLOP *** [Qd 2h 5c]
3dAbvkxS5NPQTBAbvpinVg: checks
TBaQIN+sQ7eb7P99QnaORQ: bets $10
3dAbvkxS5NPQTBAbvpinVg: calls $10
*** TURN *** [Qd 2h 5c] [Ah]
3dAbvkxS5NPQTBAbvpinVg: checks
TBaQIN+sQ7eb7P99QnaORQ: checks
*** RIVER *** [Qd 2h 5c Ah] [7c]
3dAbvkxS5NPQTBAbvpinVg: bets $13
TBaQIN+sQ7eb7P99QnaORQ: calls $13
*** SHOW DOWN ***
3dAbvkxS5NPQTBAbvpinVg: shows [Qc Jh] (a pair of Queens)
TBaQIN+sQ7eb7P99QnaORQ: mucks hand
3dAbvkxS5NPQTBAbvpinVg collected $66 from pot
*** SUMMARY ***
Total pot $69 | Rake $3
Board [Qd 2h 5c Ah 7c]
Seat 1: KfwW5us6tydK81NYTtK1gw folded before Flop (didn't bet)
Seat 2: 3dAbvkxS5NPQTBAbvpinVg showed [Qc Jh] and won ($66) with a pair of Queens
Seat 3: /PH6Ffnho4Ysm8S3V/oa+w folded before Flop (didn't bet)
Seat 4: TBaQIN+sQ7eb7P99QnaORQ (button) mucked
Seat 5: VvdR9F3I+2yELkfTVvC1dg (small blind) folded before Flop
Seat 6: 4bqvCfJ0e8CTYnn0Go9hbQ (big blind) folded before Flop



PokerStars Game #59941678936:  Hold'em No Limit ($1/$2) - 2009/07/01 1:42:44 ET
Table 'ztv6V3FN2bQ9nmJPPdx6nQ' 6-max Seat #6 is the button
Seat 1: 6fLdOUCRtX71xbVRhJEq8w ($236.35 in chips)
Seat 2: 5Y+ZGWLI4gnlpApDX5vy1A ($405.15 in chips)
Seat 3: ubtx4Z5L+AcK71MTvYiGVw ($247.20 in chips)
Seat 4: UaZ5yj+6LjtWqMQg2QskUw ($82.30 in chips)
Seat 5: sTPOWERd9HWPCNrDBwsVjA ($217.60 in chips)
Seat 6: mfy7uGZcqA2PVQqEVbJ7+g ($106.60 in chips)
6fLdOUCRtX71xbVRhJEq8w: posts small blind $1
5Y+ZGWLI4gnlpApDX5vy1A: posts big blind $2
*** HOLE CARDS ***
ubtx4Z5L+AcK71MTvYiGVw: folds
UaZ5yj+6LjtWqMQg2QskUw: folds
sTPOWERd9HWPCNrDBwsVjA: folds
mfy7uGZcqA2PVQqEVbJ7+g: folds
6fLdOUCRtX71xbVRhJEq8w: raises $4 to $6
5Y+ZGWLI4gnlpApDX5vy1A: raises $13 to $19
6fLdOUCRtX71xbVRhJEq8w: folds
5Y+ZGWLI4gnlpApDX5vy1A collected $12 from pot
5Y+ZGWLI4gnlpApDX5vy1A: doesn't show hand
*** SUMMARY ***
Total pot $12 | Rake $0
Seat 1: 6fLdOUCRtX71xbVRhJEq8w (small blind) folded before Flop
Seat 2: 5Y+ZGWLI4gnlpApDX5vy1A (big blind) collected ($12)
Seat 3: ubtx4Z5L+AcK71MTvYiGVw folded before Flop (didn't bet)
Seat 4: UaZ5yj+6LjtWqMQg2QskUw folded before Flop (didn't bet)
Seat 5: sTPOWERd9HWPCNrDBwsVjA folded before Flop (didn't bet)
Seat 6: mfy7uGZcqA2PVQqEVbJ7+g (button) folded before Flop (didn't bet)



PokerStars Game #59941678530:  Hold'em No Limit ($1/$2) - 2009/07/01 1:42:44 ET
Table 'NmY84NAf9Mh0ckAckHnh5g' 2-max Seat #2 is the button
Seat 1: 6hvg964TSqZ3AL/0XK9aVQ ($530.20 in chips)
Seat 2: RwDoM55ZeQuI2ADyJhOb2Q ($460.50 in chips)
RwDoM55ZeQuI2ADyJhOb2Q: posts small blind $1
6hvg964TSqZ3AL/0XK9aVQ: posts big blind $2
*** HOLE CARDS ***
RwDoM55ZeQuI2ADyJhOb2Q: raises $4 to $6
6hvg964TSqZ3AL/0XK9aVQ: calls $4
*** FLOP *** [Tc 6h 2d]
6hvg964TSqZ3AL/0XK9aVQ: checks
RwDoM55ZeQuI2ADyJhOb2Q: checks
*** TURN *** [Tc 6h 2d] [4c]
6hvg964TSqZ3AL/0XK9aVQ: checks
RwDoM55ZeQuI2ADyJhOb2Q: checks
*** RIVER *** [Tc 6h 2d 4c] [Kh]
6hvg964TSqZ3AL/0XK9aVQ: bets $8
RwDoM55ZeQuI2ADyJhOb2Q: folds
6hvg964TSqZ3AL/0XK9aVQ collected $11.50 from pot
6hvg964TSqZ3AL/0XK9aVQ: doesn't show hand
*** SUMMARY ***
Total pot $12 | Rake $0.50
Board [Tc 6h 2d 4c Kh]
Seat 1: 6hvg964TSqZ3AL/0XK9aVQ (big blind) collected ($11.50)
Seat 2: RwDoM55ZeQuI2ADyJhOb2Q (button) (small blind) folded on the River



PokerStars Game #59941679360:  Hold'em No Limit ($1/$2) - 2009/07/01 1:42:45 ET
Table 'mGpP9StWRnoeiBDExc6Frg' 6-max Seat #6 is the button
Seat 1: VvdR9F3I+2yELkfTVvC1dg ($310.15 in chips)
Seat 2: vkfxu8f/jMYKUk6Ly4eujw ($204 in chips)
Seat 3: 7acrZUQC3Zc9BNLjoKIcLQ ($30.85 in chips)
Seat 4: 4dcDwIHRm96PwtqkpQiuiA ($66.70 in chips)
Seat 5: d1puGuVBE0fidn+5eRJ0tw ($207.55 in chips)
Seat 6: B2Ih1sr5VZk+8He7rcrMtQ ($413.80 in chips)
VvdR9F3I+2yELkfTVvC1dg: posts small blind $1
vkfxu8f/jMYKUk6Ly4eujw: posts big blind $2
*** HOLE CARDS ***
7acrZUQC3Zc9BNLjoKIcLQ: folds
4dcDwIHRm96PwtqkpQiuiA: folds
d1puGuVBE0fidn+5eRJ0tw: calls $2
B2Ih1sr5VZk+8He7rcrMtQ: raises $8 to $10
VvdR9F3I+2yELkfTVvC1dg: folds
vkfxu8f/jMYKUk6Ly4eujw: folds
d1puGuVBE0fidn+5eRJ0tw: calls $8
*** FLOP *** [Ks 9d 2h]
d1puGuVBE0fidn+5eRJ0tw: checks
B2Ih1sr5VZk+8He7rcrMtQ: bets $16
d1puGuVBE0fidn+5eRJ0tw: folds
B2Ih1sr5VZk+8He7rcrMtQ collected $21.85 from pot
*** SUMMARY ***
Total pot $23 | Rake $1.15
Board [Ks 9d 2h]
Seat 1: VvdR9F3I+2yELkfTVvC1dg (small blind) folded before Flop
Seat 2: vkfxu8f/jMYKUk6Ly4eujw (big blind) folded before Flop
Seat 3: 7acrZUQC3Zc9BNLjoKIcLQ folded before Flop (didn't bet)
Seat 4: 4dcDwIHRm96PwtqkpQiuiA folded before Flop (didn't bet)
Seat 5: d1puGuVBE0fidn+5eRJ0tw folded on the Flop
Seat 6: B2Ih1sr5VZk+8He7rcrMtQ (button) collected ($21.85)



PokerStars Game #59941680006:  Hold'em No Limit ($1/$2) - 2009/07/01 1:42:46 ET
Table 'eyAQSIlgc2o1Jxvbve4WGg' 9-max Seat #4 is the button
Seat 1: UZEsV9yKUMqmpYPiOFpaZw ($53.20 in chips)
Seat 2: kM9CA+2UcdMjbCMbtUCGiA ($217.60 in chips)
Seat 4: CkE3IyJF1KvdaAOmZY5XqQ ($200 in chips)
Seat 5: mIKx5lhIt13X5eZQH0ZeMA ($129.40 in chips)
Seat 6: nXDI8Y/S6POzRwANu3d8hQ ($70 in chips)
Seat 7: u3OrI5uGx9mx1fE7dgr+EA ($66.50 in chips)
Seat 8: 1CtiZuXDFaJL1dJPQKyi8Q ($152.95 in chips)
Seat 9: WUlHm+ydPPHG7Lb0rePSdA ($143.20 in chips)
mIKx5lhIt13X5eZQH0ZeMA: posts small blind $1
nXDI8Y/S6POzRwANu3d8hQ: posts big blind $2
*** HOLE CARDS ***
u3OrI5uGx9mx1fE7dgr+EA: folds
1CtiZuXDFaJL1dJPQKyi8Q: folds
WUlHm+ydPPHG7Lb0rePSdA: folds
UZEsV9yKUMqmpYPiOFpaZw: folds
kM9CA+2UcdMjbCMbtUCGiA: raises $3 to $5
CkE3IyJF1KvdaAOmZY5XqQ: folds
mIKx5lhIt13X5eZQH0ZeMA: folds
nXDI8Y/S6POzRwANu3d8hQ: folds
kM9CA+2UcdMjbCMbtUCGiA collected $5 from pot
kM9CA+2UcdMjbCMbtUCGiA: doesn't show hand
*** SUMMARY ***
Total pot $5 | Rake $0
Seat 1: UZEsV9yKUMqmpYPiOFpaZw folded before Flop (didn't bet)
Seat 2: kM9CA+2UcdMjbCMbtUCGiA collected ($5)
Seat 4: CkE3IyJF1KvdaAOmZY5XqQ (button) folded before Flop (didn't bet)
Seat 5: mIKx5lhIt13X5eZQH0ZeMA (small blind) folded before Flop
Seat 6: nXDI8Y/S6POzRwANu3d8hQ (big blind) folded before Flop
Seat 7: u3OrI5uGx9mx1fE7dgr+EA folded before Flop (didn't bet)
Seat 8: 1CtiZuXDFaJL1dJPQKyi8Q folded before Flop (didn't bet)
Seat 9: WUlHm+ydPPHG7Lb0rePSdA folded before Flop (didn't bet)



PokerStars Game #59941680984:  Hold'em No Limit ($1/$2) - 2009/07/01 1:42:48 ET
Table 'TsEDkiO4tzCTCzJ7tNdEqw' 6-max Seat #6 is the button
Seat 1: vkfxu8f/jMYKUk6Ly4eujw ($198 in chips)
Seat 2: 4dcDwIHRm96PwtqkpQiuiA ($86.65 in chips)
Seat 3: ubtx4Z5L+AcK71MTvYiGVw ($267.05 in chips)
Seat 5: VvdR9F3I+2yELkfTVvC1dg ($249.35 in chips)
Seat 6: uCqEjnxh2/vFBjKYkfTOkw ($286.80 in chips)
vkfxu8f/jMYKUk6Ly4eujw: posts small blind $1
4dcDwIHRm96PwtqkpQiuiA: posts big blind $2
K8MXCrNAVYlMnnCeM32Kxw: sits out
*** HOLE CARDS ***
ubtx4Z5L+AcK71MTvYiGVw: folds
VvdR9F3I+2yELkfTVvC1dg: folds
uCqEjnxh2/vFBjKYkfTOkw: raises $4 to $6
vkfxu8f/jMYKUk6Ly4eujw: folds
4dcDwIHRm96PwtqkpQiuiA: folds
uCqEjnxh2/vFBjKYkfTOkw collected $5 from pot
uCqEjnxh2/vFBjKYkfTOkw: doesn't show hand
*** SUMMARY ***
Total pot $5 | Rake $0
Seat 1: vkfxu8f/jMYKUk6Ly4eujw (small blind) folded before Flop
Seat 2: 4dcDwIHRm96PwtqkpQiuiA (big blind) folded before Flop
Seat 3: ubtx4Z5L+AcK71MTvYiGVw folded before Flop (didn't bet)
Seat 5: VvdR9F3I+2yELkfTVvC1dg folded before Flop (didn't bet)
Seat 6: uCqEjnxh2/vFBjKYkfTOkw (button) collected ($5)



PokerStars Game #59941680920:  Hold'em No Limit ($1/$2) - 2009/07/01 1:42:48 ET
Table 'CFkQcfWjKccZaZDf71FK+w' 6-max Seat #6 is the button
Seat 1: vkfxu8f/jMYKUk6Ly4eujw ($228.25 in chips)
Seat 2: ewN/vzF22+/gdzjIKBOlkA ($205.05 in chips)
Seat 3: 09BNF4quPDzanQzM8vc6WA ($40.65 in chips)
Seat 4: ygTTt5ehT4aF86q1a8/R+w ($243.35 in chips)
Seat 5: 2lOU1DcvUZaMcxZ95XfzXw ($197.70 in chips)
Seat 6: ORVqY3rf9X6ANA/8s+On2Q ($41.60 in chips)
vkfxu8f/jMYKUk6Ly4eujw: posts small blind $1
ewN/vzF22+/gdzjIKBOlkA: posts big blind $2
*** HOLE CARDS ***
09BNF4quPDzanQzM8vc6WA: folds
ygTTt5ehT4aF86q1a8/R+w: folds
2lOU1DcvUZaMcxZ95XfzXw: folds
ORVqY3rf9X6ANA/8s+On2Q: folds
vkfxu8f/jMYKUk6Ly4eujw: folds
ewN/vzF22+/gdzjIKBOlkA collected $2 from pot
*** SUMMARY ***
Total pot $2 | Rake $0
Seat 1: vkfxu8f/jMYKUk6Ly4eujw (small blind) folded before Flop
Seat 2: ewN/vzF22+/gdzjIKBOlkA (big blind) collected ($2)
Seat 3: 09BNF4quPDzanQzM8vc6WA folded before Flop (didn't bet)
Seat 4: ygTTt5ehT4aF86q1a8/R+w folded before Flop (didn't bet)
Seat 5: 2lOU1DcvUZaMcxZ95XfzXw folded before Flop (didn't bet)
Seat 6: ORVqY3rf9X6ANA/8s+On2Q (button) folded before Flop (didn't bet)



PokerStars Game #59941681560:  Hold'em No Limit ($1/$2) - 2009/07/01 1:42:49 ET
Table 'ZzSIe0zTCDv+n6hfbY5tTg' 6-max Seat #3 is the button
Seat 1: VvdR9F3I+2yELkfTVvC1dg ($254 in chips)
Seat 2: B87ikIyZ/TzAVeXf38Ny0g ($234 in chips)
Seat 3: gsugPj31Hui3Jefl98MBOA ($349 in chips)
Seat 4: 54yWzRRgS0oZ+S6LwZBxMQ ($38 in chips)
Seat 5: 3dAbvkxS5NPQTBAbvpinVg ($509.45 in chips)
Seat 6: 09BNF4quPDzanQzM8vc6WA ($39 in chips)
54yWzRRgS0oZ+S6LwZBxMQ: posts small blind $1
3dAbvkxS5NPQTBAbvpinVg: posts big blind $2
*** HOLE CARDS ***
09BNF4quPDzanQzM8vc6WA: folds
VvdR9F3I+2yELkfTVvC1dg: folds
B87ikIyZ/TzAVeXf38Ny0g: raises $4 to $6
gsugPj31Hui3Jefl98MBOA: folds
54yWzRRgS0oZ+S6LwZBxMQ: folds
3dAbvkxS5NPQTBAbvpinVg: folds
B87ikIyZ/TzAVeXf38Ny0g collected $5 from pot
B87ikIyZ/TzAVeXf38Ny0g: doesn't show hand
*** SUMMARY ***
Total pot $5 | Rake $0
Seat 1: VvdR9F3I+2yELkfTVvC1dg folded before Flop (didn't bet)
Seat 2: B87ikIyZ/TzAVeXf38Ny0g collected ($5)
Seat 3: gsugPj31Hui3Jefl98MBOA (button) folded before Flop (didn't bet)
Seat 4: 54yWzRRgS0oZ+S6LwZBxMQ (small blind) folded before Flop
Seat 5: 3dAbvkxS5NPQTBAbvpinVg (big blind) folded before Flop
Seat 6: 09BNF4quPDzanQzM8vc6WA folded before Flop (didn't bet)



PokerStars Game #59941682474:  Hold'em No Limit ($1/$2) - 2009/07/01 1:42:51 ET
Table 'uJ9juaXXg9yIcSU8amxaXQ' 6-max Seat #6 is the button
Seat 1: JsqOjN/eHz0uYVf/PyUJ6Q ($148.25 in chips)
Seat 2: VvdR9F3I+2yELkfTVvC1dg ($203.30 in chips)
Seat 3: qXDd0ZyMIse0OBu8pxeQ3Q ($243.40 in chips)
Seat 4: zNjJ/y4emmF+vzrCDd+ooA ($241.95 in chips)
Seat 5: YsLQ3BAvgQHWXMAv3Wv6Hg ($212.70 in chips)
Seat 6: /PH6Ffnho4Ysm8S3V/oa+w ($40 in chips)
JsqOjN/eHz0uYVf/PyUJ6Q: posts small blind $1
VvdR9F3I+2yELkfTVvC1dg: posts big blind $2
*** HOLE CARDS ***
qXDd0ZyMIse0OBu8pxeQ3Q: folds
zNjJ/y4emmF+vzrCDd+ooA: calls $2
YsLQ3BAvgQHWXMAv3Wv6Hg: folds
/PH6Ffnho4Ysm8S3V/oa+w: folds
JsqOjN/eHz0uYVf/PyUJ6Q: calls $1
VvdR9F3I+2yELkfTVvC1dg: checks
*** FLOP *** [5c Ks Qd]
JsqOjN/eHz0uYVf/PyUJ6Q: checks
VvdR9F3I+2yELkfTVvC1dg: checks
zNjJ/y4emmF+vzrCDd+ooA: bets $2
JsqOjN/eHz0uYVf/PyUJ6Q: folds
VvdR9F3I+2yELkfTVvC1dg: folds
zNjJ/y4emmF+vzrCDd+ooA collected $5.70 from pot
*** SUMMARY ***
Total pot $6 | Rake $0.30
Board [5c Ks Qd]
Seat 1: JsqOjN/eHz0uYVf/PyUJ6Q (small blind) folded on the Flop
Seat 2: VvdR9F3I+2yELkfTVvC1dg (big blind) folded on the Flop
Seat 3: qXDd0ZyMIse0OBu8pxeQ3Q folded before Flop (didn't bet)
Seat 4: zNjJ/y4emmF+vzrCDd+ooA collected ($5.70)
Seat 5: YsLQ3BAvgQHWXMAv3Wv6Hg folded before Flop (didn't bet)
Seat 6: /PH6Ffnho4Ysm8S3V/oa+w (button) folded before Flop (didn't bet)



PokerStars Game #59941683170:  Hold'em No Limit ($1/$2) - 2009/07/01 1:42:52 ET
Table '/dyk+YdRGv90j2box35j8w' 6-max Seat #1 is the button
Seat 1: 8srN1dKQePlsv0GyTada+Q ($202 in chips)
Seat 2: qCnEYuAE5y5A7bk6fO5/jQ ($482.20 in chips)
Seat 3: sTPOWERd9HWPCNrDBwsVjA ($209.50 in chips)
Seat 5: VvdR9F3I+2yELkfTVvC1dg ($254.55 in chips)
Seat 6: gnYme0DNFflnMhrdbxe1Ag ($200 in chips)
qCnEYuAE5y5A7bk6fO5/jQ: posts small blind $1
sTPOWERd9HWPCNrDBwsVjA: posts big blind $2
*** HOLE CARDS ***
VvdR9F3I+2yELkfTVvC1dg: folds
gnYme0DNFflnMhrdbxe1Ag: raises $4 to $6
8srN1dKQePlsv0GyTada+Q: folds
qCnEYuAE5y5A7bk6fO5/jQ: raises $16 to $22
sTPOWERd9HWPCNrDBwsVjA: folds
gnYme0DNFflnMhrdbxe1Ag: folds
qCnEYuAE5y5A7bk6fO5/jQ collected $14 from pot
qCnEYuAE5y5A7bk6fO5/jQ: doesn't show hand
*** SUMMARY ***
Total pot $14 | Rake $0
Seat 1: 8srN1dKQePlsv0GyTada+Q (button) folded before Flop (didn't bet)
Seat 2: qCnEYuAE5y5A7bk6fO5/jQ (small blind) collected ($14)
Seat 3: sTPOWERd9HWPCNrDBwsVjA (big blind) folded before Flop
Seat 5: VvdR9F3I+2yELkfTVvC1dg folded before Flop (didn't bet)
Seat 6: gnYme0DNFflnMhrdbxe1Ag folded before Flop



PokerStars Game #59941682708:  Hold'em No Limit ($1/$2) - 2009/07/01 1:42:52 ET
Table 'on4i1U1lCRmxsduFD3xiSg' 9-max Seat #1 is the button
Seat 1: so5k3vFDmokh2q3dImJ1GQ ($173.30 in chips)
Seat 2: NqSvZNzJ4RkR3sCmgQnyLw ($68.05 in chips)
Seat 3: GX1heJ+DSsvm7gzSPsYhhQ ($33 in chips)
Seat 4: DFQVuszLVclqjA46pN4Vvw ($75.80 in chips)
Seat 5: 37j/5DgMG5m9lMfFofEAOg ($90.70 in chips)
Seat 7: /inIs/z/PcX+TniIFpaxpg ($268.05 in chips)
Seat 8: ZYHoLw2lWmRS7CSHi8L8Xg ($200 in chips)
Seat 9: TAfo4veNRaRlzDXMMYS3Jg ($40 in chips)
NqSvZNzJ4RkR3sCmgQnyLw: posts small blind $1
GX1heJ+DSsvm7gzSPsYhhQ: posts big blind $2
KqHysDSpCPaPyK3tJC1aEw: sits out
*** HOLE CARDS ***
DFQVuszLVclqjA46pN4Vvw: calls $2
37j/5DgMG5m9lMfFofEAOg: calls $2
/inIs/z/PcX+TniIFpaxpg: folds
ZYHoLw2lWmRS7CSHi8L8Xg: folds
TAfo4veNRaRlzDXMMYS3Jg: raises $38 to $40 and is all-in
so5k3vFDmokh2q3dImJ1GQ: folds
NqSvZNzJ4RkR3sCmgQnyLw: folds
GX1heJ+DSsvm7gzSPsYhhQ: folds
DFQVuszLVclqjA46pN4Vvw: folds
37j/5DgMG5m9lMfFofEAOg: calls $38
*** FLOP *** [Js 8h Jh]
*** TURN *** [Js 8h Jh] [6d]
*** RIVER *** [Js 8h Jh 6d] [5d]
*** SHOW DOWN ***
37j/5DgMG5m9lMfFofEAOg: shows [Tc Kc] (a pair of Jacks)
TAfo4veNRaRlzDXMMYS3Jg: shows [Ah Kh] (a pair of Jacks - Ace kicker)
TAfo4veNRaRlzDXMMYS3Jg collected $82 from pot
*** SUMMARY ***
Total pot $85 | Rake $3
Board [Js 8h Jh 6d 5d]
Seat 1: so5k3vFDmokh2q3dImJ1GQ (button) folded before Flop (didn't bet)
Seat 2: NqSvZNzJ4RkR3sCmgQnyLw (small blind) folded before Flop
Seat 3: GX1heJ+DSsvm7gzSPsYhhQ (big blind) folded before Flop
Seat 4: DFQVuszLVclqjA46pN4Vvw folded before Flop
Seat 5: 37j/5DgMG5m9lMfFofEAOg showed [Tc Kc] and lost with a pair of Jacks
Seat 7: /inIs/z/PcX+TniIFpaxpg folded before Flop (didn't bet)
Seat 8: ZYHoLw2lWmRS7CSHi8L8Xg folded before Flop (didn't bet)
Seat 9: TAfo4veNRaRlzDXMMYS3Jg showed [Ah Kh] and won ($82) with a pair of Jacks



PokerStars Game #59941683964:  Hold'em No Limit ($1/$2) - 2009/07/01 1:42:54 ET
Table 'jlrIxbrVIG+gjaUYT4za8g' 6-max Seat #5 is the button
Seat 1: ygTTt5ehT4aF86q1a8/R+w ($235.30 in chips)
Seat 2: /PH6Ffnho4Ysm8S3V/oa+w ($60 in chips)
Seat 3: gnYme0DNFflnMhrdbxe1Ag ($203 in chips)
Seat 4: 8srN1dKQePlsv0GyTada+Q ($263.95 in chips)
Seat 5: AyBB0k3Dcl7xbXUeGMw06g ($40.40 in chips)
Seat 6: BWhgxe7gWiYobRbwdG+d2Q ($196 in chips)
BWhgxe7gWiYobRbwdG+d2Q: posts small blind $1
ygTTt5ehT4aF86q1a8/R+w: posts big blind $2
*** HOLE CARDS ***
/PH6Ffnho4Ysm8S3V/oa+w: folds
gnYme0DNFflnMhrdbxe1Ag: folds
8srN1dKQePlsv0GyTada+Q: folds
AyBB0k3Dcl7xbXUeGMw06g: folds
BWhgxe7gWiYobRbwdG+d2Q: folds
ygTTt5ehT4aF86q1a8/R+w collected $2 from pot
*** SUMMARY ***
Total pot $2 | Rake $0
Seat 1: ygTTt5ehT4aF86q1a8/R+w (big blind) collected ($2)
Seat 2: /PH6Ffnho4Ysm8S3V/oa+w folded before Flop (didn't bet)
Seat 3: gnYme0DNFflnMhrdbxe1Ag folded before Flop (didn't bet)
Seat 4: 8srN1dKQePlsv0GyTada+Q folded before Flop (didn't bet)
Seat 5: AyBB0k3Dcl7xbXUeGMw06g (button) folded before Flop (didn't bet)
Seat 6: BWhgxe7gWiYobRbwdG+d2Q (small blind) folded before Flop



PokerStars Game #59941684024:  Hold'em No Limit ($1/$2) - 2009/07/01 1:42:54 ET
Table 'kq5zaQ+1hLNf8LZfGnbTAA' 6-max Seat #2 is the button
Seat 1: 8srN1dKQePlsv0GyTada+Q ($413.60 in chips)
Seat 2: nXDI8Y/S6POzRwANu3d8hQ ($140 in chips)
Seat 3: /PH6Ffnho4Ysm8S3V/oa+w ($50.15 in chips)
Seat 4: 3dAbvkxS5NPQTBAbvpinVg ($281.45 in chips)
Seat 5: gnYme0DNFflnMhrdbxe1Ag ($222.35 in chips)
Seat 6: mfy7uGZcqA2PVQqEVbJ7+g ($204.15 in chips)
/PH6Ffnho4Ysm8S3V/oa+w: posts small blind $1
3dAbvkxS5NPQTBAbvpinVg: posts big blind $2
*** HOLE CARDS ***
gnYme0DNFflnMhrdbxe1Ag: folds
mfy7uGZcqA2PVQqEVbJ7+g: raises $4 to $6
8srN1dKQePlsv0GyTada+Q: raises $13 to $19
nXDI8Y/S6POzRwANu3d8hQ: folds
/PH6Ffnho4Ysm8S3V/oa+w: folds
3dAbvkxS5NPQTBAbvpinVg: folds
mfy7uGZcqA2PVQqEVbJ7+g: folds
8srN1dKQePlsv0GyTada+Q collected $15 from pot
8srN1dKQePlsv0GyTada+Q: doesn't show hand
*** SUMMARY ***
Total pot $15 | Rake $0
Seat 1: 8srN1dKQePlsv0GyTada+Q collected ($15)
Seat 2: nXDI8Y/S6POzRwANu3d8hQ (button) folded before Flop (didn't bet)
Seat 3: /PH6Ffnho4Ysm8S3V/oa+w (small blind) folded before Flop
Seat 4: 3dAbvkxS5NPQTBAbvpinVg (big blind) folded before Flop
Seat 5: gnYme0DNFflnMhrdbxe1Ag folded before Flop (didn't bet)
Seat 6: mfy7uGZcqA2PVQqEVbJ7+g folded before Flop



PokerStars Game #59941685260:  Hold'em No Limit ($1/$2) - 2009/07/01 1:42:56 ET
Table 'aSf77Sj8QEnzcc0WaxVD4Q' 6-max Seat #2 is the button
Seat 1: UELtvp+JfwI7XDGVwSxZXA ($245.10 in chips)
Seat 2: vkfxu8f/jMYKUk6Ly4eujw ($197 in chips)
Seat 3: 9dpyyjDTCed6nV7JhaUUpw ($741.75 in chips)
Seat 4: YsLQ3BAvgQHWXMAv3Wv6Hg ($203 in chips)
Seat 5: VvdR9F3I+2yELkfTVvC1dg ($257.45 in chips)
Seat 6: vkoJRf3gidxY1pPi0AFWww ($136.50 in chips)
9dpyyjDTCed6nV7JhaUUpw: posts small blind $1
YsLQ3BAvgQHWXMAv3Wv6Hg: posts big blind $2
*** HOLE CARDS ***
VvdR9F3I+2yELkfTVvC1dg: folds
vkoJRf3gidxY1pPi0AFWww: folds
UELtvp+JfwI7XDGVwSxZXA: folds
vkfxu8f/jMYKUk6Ly4eujw: raises $6 to $8
9dpyyjDTCed6nV7JhaUUpw: folds
YsLQ3BAvgQHWXMAv3Wv6Hg: calls $6
*** FLOP *** [5h 6c Tc]
YsLQ3BAvgQHWXMAv3Wv6Hg: checks
vkfxu8f/jMYKUk6Ly4eujw: bets $10
YsLQ3BAvgQHWXMAv3Wv6Hg: calls $10
*** TURN *** [5h 6c Tc] [Jd]
YsLQ3BAvgQHWXMAv3Wv6Hg: checks
vkfxu8f/jMYKUk6Ly4eujw: bets $35
YsLQ3BAvgQHWXMAv3Wv6Hg: folds
vkfxu8f/jMYKUk6Ly4eujw collected $35.20 from pot
*** SUMMARY ***
Total pot $37 | Rake $1.80
Board [5h 6c Tc Jd]
Seat 1: UELtvp+JfwI7XDGVwSxZXA folded before Flop (didn't bet)
Seat 2: vkfxu8f/jMYKUk6Ly4eujw (button) collected ($35.20)
Seat 3: 9dpyyjDTCed6nV7JhaUUpw (small blind) folded before Flop
Seat 4: YsLQ3BAvgQHWXMAv3Wv6Hg (big blind) folded on the Turn
Seat 5: VvdR9F3I+2yELkfTVvC1dg folded before Flop (didn't bet)
Seat 6: vkoJRf3gidxY1pPi0AFWww folded before Flop (didn't bet)



PokerStars Game #59941687410:  Hold'em No Limit ($1/$2) - 2009/07/01 1:43:00 ET
Table '4NGNnZ/osQfNq6abYqkJeA' 6-max Seat #2 is the button
Seat 2: 669iGNwYwgRZg3nhS+aDAQ ($132.25 in chips)
Seat 3: 54yWzRRgS0oZ+S6LwZBxMQ ($38 in chips)
Seat 4: sY+4Uuh5z/6AbXXaCS10jw ($230.25 in chips)
Seat 5: VvdR9F3I+2yELkfTVvC1dg ($231.55 in chips)
Seat 6: /PH6Ffnho4Ysm8S3V/oa+w ($40 in chips)
54yWzRRgS0oZ+S6LwZBxMQ: posts small blind $1
sY+4Uuh5z/6AbXXaCS10jw: posts big blind $2
xUTLK/SDwl6IxZdaKduuFg: sits out
*** HOLE CARDS ***
VvdR9F3I+2yELkfTVvC1dg: folds
/PH6Ffnho4Ysm8S3V/oa+w: folds
669iGNwYwgRZg3nhS+aDAQ: raises $6 to $8
54yWzRRgS0oZ+S6LwZBxMQ: folds
sY+4Uuh5z/6AbXXaCS10jw: folds
669iGNwYwgRZg3nhS+aDAQ collected $5 from pot
*** SUMMARY ***
Total pot $5 | Rake $0
Seat 2: 669iGNwYwgRZg3nhS+aDAQ (button) collected ($5)
Seat 3: 54yWzRRgS0oZ+S6LwZBxMQ (small blind) folded before Flop
Seat 4: sY+4Uuh5z/6AbXXaCS10jw (big blind) folded before Flop
Seat 5: VvdR9F3I+2yELkfTVvC1dg folded before Flop (didn't bet)
Seat 6: /PH6Ffnho4Ysm8S3V/oa+w folded before Flop (didn't bet)



PokerStars Game #59941687948:  Hold'em No Limit ($1/$2) - 2009/07/01 1:43:01 ET
Table 'BSRfGh+QobUe0AgIMtt/fw' 9-max Seat #5 is the button
Seat 1: gDn/rYeNwCyWEgRhyWp4PA ($155.70 in chips)
Seat 2: +SmnXtdmwqXGEJfLeJDIUQ ($37 in chips)
Seat 3: WUlHm+ydPPHG7Lb0rePSdA ($120 in chips)
Seat 4: +T/63sAeZzWyHchahJ36GQ ($40 in chips)
Seat 5: v0q3vrz/d9oDjLrAG8Ausw ($204.55 in chips)
Seat 6: H6Z4+qu8gR0VUiPOijndVg ($201 in chips)
Seat 7: CkE3IyJF1KvdaAOmZY5XqQ ($206.10 in chips)
Seat 8: /XRRUMKiOOItJFbrM26RrA ($83.30 in chips)
Seat 9: /inIs/z/PcX+TniIFpaxpg ($415.25 in chips)
H6Z4+qu8gR0VUiPOijndVg: posts small blind $1
CkE3IyJF1KvdaAOmZY5XqQ: posts big blind $2
*** HOLE CARDS ***
/XRRUMKiOOItJFbrM26RrA: folds
/inIs/z/PcX+TniIFpaxpg: folds
gDn/rYeNwCyWEgRhyWp4PA: raises $4 to $6
+SmnXtdmwqXGEJfLeJDIUQ: folds
WUlHm+ydPPHG7Lb0rePSdA: folds
+T/63sAeZzWyHchahJ36GQ: folds
v0q3vrz/d9oDjLrAG8Ausw: folds
H6Z4+qu8gR0VUiPOijndVg: folds
CkE3IyJF1KvdaAOmZY5XqQ: calls $4
*** FLOP *** [9h Jc As]
CkE3IyJF1KvdaAOmZY5XqQ: checks
gDn/rYeNwCyWEgRhyWp4PA: checks
*** TURN *** [9h Jc As] [9d]
CkE3IyJF1KvdaAOmZY5XqQ: checks
gDn/rYeNwCyWEgRhyWp4PA: checks
*** RIVER *** [9h Jc As 9d] [9s]
CkE3IyJF1KvdaAOmZY5XqQ: checks
gDn/rYeNwCyWEgRhyWp4PA: bets $6
CkE3IyJF1KvdaAOmZY5XqQ: folds
gDn/rYeNwCyWEgRhyWp4PA collected $12.35 from pot
*** SUMMARY ***
Total pot $13 | Rake $0.65
Board [9h Jc As 9d 9s]
Seat 1: gDn/rYeNwCyWEgRhyWp4PA collected ($12.35)
Seat 2: +SmnXtdmwqXGEJfLeJDIUQ folded before Flop (didn't bet)
Seat 3: WUlHm+ydPPHG7Lb0rePSdA folded before Flop (didn't bet)
Seat 4: +T/63sAeZzWyHchahJ36GQ folded before Flop (didn't bet)
Seat 5: v0q3vrz/d9oDjLrAG8Ausw (button) folded before Flop (didn't bet)
Seat 6: H6Z4+qu8gR0VUiPOijndVg (small blind) folded before Flop
Seat 7: CkE3IyJF1KvdaAOmZY5XqQ (big blind) folded on the River
Seat 8: /XRRUMKiOOItJFbrM26RrA folded before Flop (didn't bet)
Seat 9: /inIs/z/PcX+TniIFpaxpg folded before Flop (didn't bet)



PokerStars Game #59941688498:  Hold'em No Limit ($1/$2) - 2009/07/01 1:43:02 ET
Table 'zEOkwFUmNLBlvazOXtwH8w' 2-max Seat #2 is the button
Seat 1: gu6Ee9WAefYH8BG9//A1pw ($116 in chips)
Seat 2: SLKKhEamo9/21wMiSyGsQw ($222.50 in chips)
SLKKhEamo9/21wMiSyGsQw: posts small blind $1
gu6Ee9WAefYH8BG9//A1pw: posts big blind $2
*** HOLE CARDS ***
SLKKhEamo9/21wMiSyGsQw: calls $1
gu6Ee9WAefYH8BG9//A1pw: raises $114 to $116 and is all-in
gu6Ee9WAefYH8BG9//A1pw said, "jajajaja"
SLKKhEamo9/21wMiSyGsQw: folds
gu6Ee9WAefYH8BG9//A1pw collected $4 from pot
*** SUMMARY ***
Total pot $4 | Rake $0
Seat 1: gu6Ee9WAefYH8BG9//A1pw (big blind) collected ($4)
Seat 2: SLKKhEamo9/21wMiSyGsQw (button) (small blind) folded before Flop



PokerStars Game #59941688710:  Hold'em No Limit ($1/$2) - 2009/07/01 1:43:03 ET
Table '3WCXyaiCAbqSShQu7FIjvA' 9-max Seat #4 is the button
Seat 1: kTCkABD1UUldS9DFRGfCwQ ($150.75 in chips)
Seat 2: TAfo4veNRaRlzDXMMYS3Jg ($39.70 in chips)
Seat 3: 5Q8U6iZbeO7xJSS4qvDP5g ($270.25 in chips)
Seat 4: waEF/+pxZTxNo4FvsORuXg ($103.40 in chips)
Seat 5: CkE3IyJF1KvdaAOmZY5XqQ ($200 in chips)
Seat 6: 5jQlngvMSqM/WoonOcR5kw ($296.80 in chips)
Seat 7: nXDI8Y/S6POzRwANu3d8hQ ($37 in chips)
Seat 8: 1CtiZuXDFaJL1dJPQKyi8Q ($216.10 in chips)
Seat 9: FiXPLJyqb24l32QST2TInw ($101.40 in chips)
CkE3IyJF1KvdaAOmZY5XqQ: posts small blind $1
5jQlngvMSqM/WoonOcR5kw: posts big blind $2
*** HOLE CARDS ***
nXDI8Y/S6POzRwANu3d8hQ: folds
1CtiZuXDFaJL1dJPQKyi8Q: folds
FiXPLJyqb24l32QST2TInw: calls $2
kTCkABD1UUldS9DFRGfCwQ has timed out
kTCkABD1UUldS9DFRGfCwQ: folds
kTCkABD1UUldS9DFRGfCwQ is sitting out
TAfo4veNRaRlzDXMMYS3Jg: folds
5Q8U6iZbeO7xJSS4qvDP5g: folds
waEF/+pxZTxNo4FvsORuXg: folds
kTCkABD1UUldS9DFRGfCwQ has returned
CkE3IyJF1KvdaAOmZY5XqQ: raises $8 to $10
5jQlngvMSqM/WoonOcR5kw: calls $8
FiXPLJyqb24l32QST2TInw: folds
*** FLOP *** [Kc 8d Kd]
CkE3IyJF1KvdaAOmZY5XqQ: checks
5jQlngvMSqM/WoonOcR5kw: checks
*** TURN *** [Kc 8d Kd] [9d]
CkE3IyJF1KvdaAOmZY5XqQ: checks
5jQlngvMSqM/WoonOcR5kw: checks
*** RIVER *** [Kc 8d Kd 9d] [Tc]
CkE3IyJF1KvdaAOmZY5XqQ: checks
5jQlngvMSqM/WoonOcR5kw: checks
*** SHOW DOWN ***
CkE3IyJF1KvdaAOmZY5XqQ: shows [Jh Jd] (two pair, Kings and Jacks)
5jQlngvMSqM/WoonOcR5kw: mucks hand
CkE3IyJF1KvdaAOmZY5XqQ collected $20.90 from pot
*** SUMMARY ***
Total pot $22 | Rake $1.10
Board [Kc 8d Kd 9d Tc]
Seat 1: kTCkABD1UUldS9DFRGfCwQ folded before Flop (didn't bet)
Seat 2: TAfo4veNRaRlzDXMMYS3Jg folded before Flop (didn't bet)
Seat 3: 5Q8U6iZbeO7xJSS4qvDP5g folded before Flop (didn't bet)
Seat 4: waEF/+pxZTxNo4FvsORuXg (button) folded before Flop (didn't bet)
Seat 5: CkE3IyJF1KvdaAOmZY5XqQ (small blind) showed [Jh Jd] and won ($20.90) with two pair, Kings and Jacks
Seat 6: 5jQlngvMSqM/WoonOcR5kw (big blind) mucked
Seat 7: nXDI8Y/S6POzRwANu3d8hQ folded before Flop (didn't bet)
Seat 8: 1CtiZuXDFaJL1dJPQKyi8Q folded before Flop (didn't bet)
Seat 9: FiXPLJyqb24l32QST2TInw folded before Flop



PokerStars Game #59941690442:  Hold'em No Limit ($1/$2) - 2009/07/01 1:43:06 ET
Table 'CFkQcfWjKccZaZDf71FK+w' 6-max Seat #1 is the button
Seat 1: vkfxu8f/jMYKUk6Ly4eujw ($227.25 in chips)
Seat 2: ewN/vzF22+/gdzjIKBOlkA ($206.05 in chips)
Seat 3: 09BNF4quPDzanQzM8vc6WA ($40.65 in chips)
Seat 4: ygTTt5ehT4aF86q1a8/R+w ($243.35 in chips)
Seat 5: 2lOU1DcvUZaMcxZ95XfzXw ($197.70 in chips)
Seat 6: ORVqY3rf9X6ANA/8s+On2Q ($41.60 in chips)
ewN/vzF22+/gdzjIKBOlkA: posts small blind $1
09BNF4quPDzanQzM8vc6WA: posts big blind $2
*** HOLE CARDS ***
ygTTt5ehT4aF86q1a8/R+w: folds
2lOU1DcvUZaMcxZ95XfzXw: calls $2
ORVqY3rf9X6ANA/8s+On2Q: folds
vkfxu8f/jMYKUk6Ly4eujw: folds
ewN/vzF22+/gdzjIKBOlkA: calls $1
09BNF4quPDzanQzM8vc6WA: raises $38.65 to $40.65 and is all-in
2lOU1DcvUZaMcxZ95XfzXw: calls $38.65
ewN/vzF22+/gdzjIKBOlkA: folds
*** FLOP *** [3c 6c 4s]
*** TURN *** [3c 6c 4s] [9s]
*** RIVER *** [3c 6c 4s 9s] [5h]
*** SHOW DOWN ***
09BNF4quPDzanQzM8vc6WA: shows [Ah Kc] (high card Ace)
2lOU1DcvUZaMcxZ95XfzXw: shows [Qs As] (high card Ace - lower kicker)
09BNF4quPDzanQzM8vc6WA collected $80.30 from pot
*** SUMMARY ***
Total pot $83.30 | Rake $3
Board [3c 6c 4s 9s 5h]
Seat 1: vkfxu8f/jMYKUk6Ly4eujw (button) folded before Flop (didn't bet)
Seat 2: ewN/vzF22+/gdzjIKBOlkA (small blind) folded before Flop
Seat 3: 09BNF4quPDzanQzM8vc6WA (big blind) showed [Ah Kc] and won ($80.30) with high card Ace
Seat 4: ygTTt5ehT4aF86q1a8/R+w folded before Flop (didn't bet)
Seat 5: 2lOU1DcvUZaMcxZ95XfzXw showed [Qs As] and lost with high card Ace
Seat 6: ORVqY3rf9X6ANA/8s+On2Q folded before Flop (didn't bet)



PokerStars Game #59941691834:  Hold'em No Limit ($1/$2) - 2009/07/01 1:43:08 ET
Table 'NmY84NAf9Mh0ckAckHnh5g' 2-max Seat #1 is the button
Seat 1: 6hvg964TSqZ3AL/0XK9aVQ ($535.70 in chips)
Seat 2: RwDoM55ZeQuI2ADyJhOb2Q ($454.50 in chips)
6hvg964TSqZ3AL/0XK9aVQ: posts small blind $1
RwDoM55ZeQuI2ADyJhOb2Q: posts big blind $2
*** HOLE CARDS ***
6hvg964TSqZ3AL/0XK9aVQ: folds
RwDoM55ZeQuI2ADyJhOb2Q collected $2 from pot
RwDoM55ZeQuI2ADyJhOb2Q: doesn't show hand
*** SUMMARY ***
Total pot $2 | Rake $0
Seat 1: 6hvg964TSqZ3AL/0XK9aVQ (button) (small blind) folded before Flop
Seat 2: RwDoM55ZeQuI2ADyJhOb2Q (big blind) collected ($2)



PokerStars Game #59941693044:  Hold'em No Limit ($1/$2) - 2009/07/01 1:43:11 ET
Table 'TsEDkiO4tzCTCzJ7tNdEqw' 6-max Seat #1 is the button
Seat 1: vkfxu8f/jMYKUk6Ly4eujw ($197 in chips)
Seat 2: 4dcDwIHRm96PwtqkpQiuiA ($84.65 in chips)
Seat 3: ubtx4Z5L+AcK71MTvYiGVw ($267.05 in chips)
Seat 5: VvdR9F3I+2yELkfTVvC1dg ($249.35 in chips)
Seat 6: uCqEjnxh2/vFBjKYkfTOkw ($289.80 in chips)
4dcDwIHRm96PwtqkpQiuiA: posts small blind $1
ubtx4Z5L+AcK71MTvYiGVw: posts big blind $2
K8MXCrNAVYlMnnCeM32Kxw: sits out
*** HOLE CARDS ***
VvdR9F3I+2yELkfTVvC1dg: folds
uCqEjnxh2/vFBjKYkfTOkw: folds
vkfxu8f/jMYKUk6Ly4eujw: folds
4dcDwIHRm96PwtqkpQiuiA: calls $1
ubtx4Z5L+AcK71MTvYiGVw: checks
*** FLOP *** [5c Qd 8s]
4dcDwIHRm96PwtqkpQiuiA: checks
ubtx4Z5L+AcK71MTvYiGVw: checks
*** TURN *** [5c Qd 8s] [Tc]
4dcDwIHRm96PwtqkpQiuiA: checks
ubtx4Z5L+AcK71MTvYiGVw: checks
*** RIVER *** [5c Qd 8s Tc] [Ah]
4dcDwIHRm96PwtqkpQiuiA: folds
ubtx4Z5L+AcK71MTvYiGVw collected $3.80 from pot
ubtx4Z5L+AcK71MTvYiGVw: doesn't show hand
*** SUMMARY ***
Total pot $4 | Rake $0.20
Board [5c Qd 8s Tc Ah]
Seat 1: vkfxu8f/jMYKUk6Ly4eujw (button) folded before Flop (didn't bet)
Seat 2: 4dcDwIHRm96PwtqkpQiuiA (small blind) folded on the River
Seat 3: ubtx4Z5L+AcK71MTvYiGVw (big blind) collected ($3.80)
Seat 5: VvdR9F3I+2yELkfTVvC1dg folded before Flop (didn't bet)
Seat 6: uCqEjnxh2/vFBjKYkfTOkw folded before Flop (didn't bet)



PokerStars Game #59941693820:  Hold'em No Limit ($1/$2) - 2009/07/01 1:43:12 ET
Table 'YqGfR5eHfMeSjb9a+QU9rg' 9-max Seat #3 is the button
Seat 1: rW/MyplHylMSBRaoRUzWrg ($76 in chips)
Seat 2: nXDI8Y/S6POzRwANu3d8hQ ($37 in chips)
Seat 3: /gll27k+xWYV7Fbki0lFDQ ($250.55 in chips)
Seat 4: GX1heJ+DSsvm7gzSPsYhhQ ($38 in chips)
Seat 5: CkE3IyJF1KvdaAOmZY5XqQ ($205.80 in chips)
Seat 6: TAfo4veNRaRlzDXMMYS3Jg ($40 in chips)
Seat 7: 41aZuLBz9nAi2GPVKabmCw ($84.95 in chips)
Seat 8: JnV3SM2D6dAFYyGZHHpvrg ($102.15 in chips)
Seat 9: /inIs/z/PcX+TniIFpaxpg ($204.20 in chips)
GX1heJ+DSsvm7gzSPsYhhQ: posts small blind $1
CkE3IyJF1KvdaAOmZY5XqQ: posts big blind $2
*** HOLE CARDS ***
TAfo4veNRaRlzDXMMYS3Jg: folds
41aZuLBz9nAi2GPVKabmCw: calls $2
JnV3SM2D6dAFYyGZHHpvrg: folds
/inIs/z/PcX+TniIFpaxpg: calls $2
rW/MyplHylMSBRaoRUzWrg: folds
nXDI8Y/S6POzRwANu3d8hQ: folds
/gll27k+xWYV7Fbki0lFDQ: folds
/gll27k+xWYV7Fbki0lFDQ leaves the table
GX1heJ+DSsvm7gzSPsYhhQ: calls $1
CkE3IyJF1KvdaAOmZY5XqQ: checks
*** FLOP *** [6s 4h Ac]
GX1heJ+DSsvm7gzSPsYhhQ: checks
KqHysDSpCPaPyK3tJC1aEw joins the table at seat #3
CkE3IyJF1KvdaAOmZY5XqQ: bets $10
41aZuLBz9nAi2GPVKabmCw: folds
/inIs/z/PcX+TniIFpaxpg: folds
GX1heJ+DSsvm7gzSPsYhhQ: folds
CkE3IyJF1KvdaAOmZY5XqQ collected $7.60 from pot
*** SUMMARY ***
Total pot $8 | Rake $0.40
Board [6s 4h Ac]
Seat 1: rW/MyplHylMSBRaoRUzWrg folded before Flop (didn't bet)
Seat 2: nXDI8Y/S6POzRwANu3d8hQ folded before Flop (didn't bet)
Seat 3: /gll27k+xWYV7Fbki0lFDQ (button) folded before Flop (didn't bet)
Seat 4: GX1heJ+DSsvm7gzSPsYhhQ (small blind) folded on the Flop
Seat 5: CkE3IyJF1KvdaAOmZY5XqQ (big blind) collected ($7.60)
Seat 6: TAfo4veNRaRlzDXMMYS3Jg folded before Flop (didn't bet)
Seat 7: 41aZuLBz9nAi2GPVKabmCw folded on the Flop
Seat 8: JnV3SM2D6dAFYyGZHHpvrg folded before Flop (didn't bet)
Seat 9: /inIs/z/PcX+TniIFpaxpg folded on the Flop



PokerStars Game #59941694478:  Hold'em No Limit ($1/$2) - 2009/07/01 1:43:13 ET
Table 'gnHBqWll9O3fxG7Ojkz/ng' 9-max Seat #2 is the button
Seat 1: TAfo4veNRaRlzDXMMYS3Jg ($36 in chips)
Seat 2: H6Z4+qu8gR0VUiPOijndVg ($328.95 in chips)
Seat 3: 5Q8U6iZbeO7xJSS4qvDP5g ($216.05 in chips)
Seat 4: nXDI8Y/S6POzRwANu3d8hQ ($19 in chips)
Seat 5: rBQDMkKm9cZn6M9NPsiVew ($220.15 in chips)
Seat 6: KqHysDSpCPaPyK3tJC1aEw ($200 in chips)
Seat 7: jqui3xAWCkcdPW36a6BD+w ($342.55 in chips)
Seat 8: cM6efHzdxoqYm0EQKP4TTQ ($116.95 in chips)
Seat 9: GX1heJ+DSsvm7gzSPsYhhQ ($45.35 in chips)
5Q8U6iZbeO7xJSS4qvDP5g: posts small blind $1
nXDI8Y/S6POzRwANu3d8hQ: posts big blind $2
*** HOLE CARDS ***
rBQDMkKm9cZn6M9NPsiVew: folds
KqHysDSpCPaPyK3tJC1aEw: folds
jqui3xAWCkcdPW36a6BD+w: folds
cM6efHzdxoqYm0EQKP4TTQ: calls $2
GX1heJ+DSsvm7gzSPsYhhQ: folds
TAfo4veNRaRlzDXMMYS3Jg: folds
H6Z4+qu8gR0VUiPOijndVg: raises $6 to $8
5Q8U6iZbeO7xJSS4qvDP5g: raises $16 to $24
nXDI8Y/S6POzRwANu3d8hQ: folds
cM6efHzdxoqYm0EQKP4TTQ: folds
H6Z4+qu8gR0VUiPOijndVg: folds
5Q8U6iZbeO7xJSS4qvDP5g collected $20 from pot
5Q8U6iZbeO7xJSS4qvDP5g: doesn't show hand
*** SUMMARY ***
Total pot $20 | Rake $0
Seat 1: TAfo4veNRaRlzDXMMYS3Jg folded before Flop (didn't bet)
Seat 2: H6Z4+qu8gR0VUiPOijndVg (button) folded before Flop
Seat 3: 5Q8U6iZbeO7xJSS4qvDP5g (small blind) collected ($20)
Seat 4: nXDI8Y/S6POzRwANu3d8hQ (big blind) folded before Flop
Seat 5: rBQDMkKm9cZn6M9NPsiVew folded before Flop (didn't bet)
Seat 6: KqHysDSpCPaPyK3tJC1aEw folded before Flop (didn't bet)
Seat 7: jqui3xAWCkcdPW36a6BD+w folded before Flop (didn't bet)
Seat 8: cM6efHzdxoqYm0EQKP4TTQ folded before Flop
Seat 9: GX1heJ+DSsvm7gzSPsYhhQ folded before Flop (didn't bet)



PokerStars Game #59941694808:  Hold'em No Limit ($1/$2) - 2009/07/01 1:43:14 ET
Table 'UGLAZZyv+cXmnKjYin0etA' 6-max Seat #5 is the button
Seat 1: vkfxu8f/jMYKUk6Ly4eujw ($203 in chips)
Seat 2: eDLH1PUXFpvJBNMXBVQcGA ($304.10 in chips)
Seat 3: ygTTt5ehT4aF86q1a8/R+w ($111.20 in chips)
Seat 4: SiGJDsvRViJX05vHhA80GQ ($231.85 in chips)
Seat 5: 54yWzRRgS0oZ+S6LwZBxMQ ($39.05 in chips)
Seat 6: sTPOWERd9HWPCNrDBwsVjA ($219.15 in chips)
sTPOWERd9HWPCNrDBwsVjA: posts small blind $1
vkfxu8f/jMYKUk6Ly4eujw: posts big blind $2
*** HOLE CARDS ***
eDLH1PUXFpvJBNMXBVQcGA: folds
ygTTt5ehT4aF86q1a8/R+w: folds
SiGJDsvRViJX05vHhA80GQ: folds
54yWzRRgS0oZ+S6LwZBxMQ: raises $2 to $4
sTPOWERd9HWPCNrDBwsVjA: folds
vkfxu8f/jMYKUk6Ly4eujw: folds
54yWzRRgS0oZ+S6LwZBxMQ collected $5 from pot
*** SUMMARY ***
Total pot $5 | Rake $0
Seat 1: vkfxu8f/jMYKUk6Ly4eujw (big blind) folded before Flop
Seat 2: eDLH1PUXFpvJBNMXBVQcGA folded before Flop (didn't bet)
Seat 3: ygTTt5ehT4aF86q1a8/R+w folded before Flop (didn't bet)
Seat 4: SiGJDsvRViJX05vHhA80GQ folded before Flop (didn't bet)
Seat 5: 54yWzRRgS0oZ+S6LwZBxMQ (button) collected ($5)
Seat 6: sTPOWERd9HWPCNrDBwsVjA (small blind) folded before Flop



PokerStars Game #59941695174:  Hold'em No Limit ($1/$2) - 2009/07/01 1:43:14 ET
Table 'eyAQSIlgc2o1Jxvbve4WGg' 9-max Seat #5 is the button
Seat 1: UZEsV9yKUMqmpYPiOFpaZw ($53.20 in chips)
Seat 2: kM9CA+2UcdMjbCMbtUCGiA ($220.60 in chips)
Seat 4: CkE3IyJF1KvdaAOmZY5XqQ ($200 in chips)
Seat 5: mIKx5lhIt13X5eZQH0ZeMA ($128.40 in chips)
Seat 6: nXDI8Y/S6POzRwANu3d8hQ ($68 in chips)
Seat 7: u3OrI5uGx9mx1fE7dgr+EA ($66.50 in chips)
Seat 8: 1CtiZuXDFaJL1dJPQKyi8Q ($152.95 in chips)
Seat 9: WUlHm+ydPPHG7Lb0rePSdA ($143.20 in chips)
nXDI8Y/S6POzRwANu3d8hQ: posts small blind $1
u3OrI5uGx9mx1fE7dgr+EA: posts big blind $2
*** HOLE CARDS ***
1CtiZuXDFaJL1dJPQKyi8Q: folds
WUlHm+ydPPHG7Lb0rePSdA: folds
UZEsV9yKUMqmpYPiOFpaZw: folds
kM9CA+2UcdMjbCMbtUCGiA: folds
CkE3IyJF1KvdaAOmZY5XqQ: folds
mIKx5lhIt13X5eZQH0ZeMA: folds
nXDI8Y/S6POzRwANu3d8hQ: folds
u3OrI5uGx9mx1fE7dgr+EA collected $2 from pot
u3OrI5uGx9mx1fE7dgr+EA: doesn't show hand
*** SUMMARY ***
Total pot $2 | Rake $0
Seat 1: UZEsV9yKUMqmpYPiOFpaZw folded before Flop (didn't bet)
Seat 2: kM9CA+2UcdMjbCMbtUCGiA folded before Flop (didn't bet)
Seat 4: CkE3IyJF1KvdaAOmZY5XqQ folded before Flop (didn't bet)
Seat 5: mIKx5lhIt13X5eZQH0ZeMA (button) folded before Flop (didn't bet)
Seat 6: nXDI8Y/S6POzRwANu3d8hQ (small blind) folded before Flop
Seat 7: u3OrI5uGx9mx1fE7dgr+EA (big blind) collected ($2)
Seat 8: 1CtiZuXDFaJL1dJPQKyi8Q folded before Flop (didn't bet)
Seat 9: WUlHm+ydPPHG7Lb0rePSdA folded before Flop (didn't bet)



PokerStars Game #59941695214:  Hold'em No Limit ($1/$2) - 2009/07/01 1:43:15 ET
Table 'NmY84NAf9Mh0ckAckHnh5g' 2-max Seat #2 is the button
Seat 1: 6hvg964TSqZ3AL/0XK9aVQ ($534.70 in chips)
Seat 2: RwDoM55ZeQuI2ADyJhOb2Q ($455.50 in chips)
RwDoM55ZeQuI2ADyJhOb2Q: posts small blind $1
6hvg964TSqZ3AL/0XK9aVQ: posts big blind $2
*** HOLE CARDS ***
RwDoM55ZeQuI2ADyJhOb2Q: raises $4 to $6
6hvg964TSqZ3AL/0XK9aVQ: calls $4
*** FLOP *** [Tc Ts 3h]
6hvg964TSqZ3AL/0XK9aVQ: checks
RwDoM55ZeQuI2ADyJhOb2Q: checks
*** TURN *** [Tc Ts 3h] [8c]
6hvg964TSqZ3AL/0XK9aVQ: bets $10
RwDoM55ZeQuI2ADyJhOb2Q: calls $10
*** RIVER *** [Tc Ts 3h 8c] [5s]
6hvg964TSqZ3AL/0XK9aVQ: checks
RwDoM55ZeQuI2ADyJhOb2Q: bets $22
6hvg964TSqZ3AL/0XK9aVQ: raises $62 to $84
RwDoM55ZeQuI2ADyJhOb2Q: calls $62
*** SHOW DOWN ***
6hvg964TSqZ3AL/0XK9aVQ: shows [Ad Th] (three of a kind, Tens)
RwDoM55ZeQuI2ADyJhOb2Q: mucks hand
6hvg964TSqZ3AL/0XK9aVQ collected $199.50 from pot
*** SUMMARY ***
Total pot $200 | Rake $0.50
Board [Tc Ts 3h 8c 5s]
Seat 1: 6hvg964TSqZ3AL/0XK9aVQ (big blind) showed [Ad Th] and won ($199.50) with three of a kind, Tens
Seat 2: RwDoM55ZeQuI2ADyJhOb2Q (button) (small blind) mucked



PokerStars Game #59941696196:  Hold'em No Limit ($1/$2) - 2009/07/01 1:43:16 ET
Table '4NGNnZ/osQfNq6abYqkJeA' 6-max Seat #3 is the button
Seat 2: 669iGNwYwgRZg3nhS+aDAQ ($135.25 in chips)
Seat 3: 54yWzRRgS0oZ+S6LwZBxMQ ($37 in chips)
Seat 4: sY+4Uuh5z/6AbXXaCS10jw ($228.25 in chips)
Seat 5: VvdR9F3I+2yELkfTVvC1dg ($231.55 in chips)
Seat 6: /PH6Ffnho4Ysm8S3V/oa+w ($40 in chips)
sY+4Uuh5z/6AbXXaCS10jw: posts small blind $1
VvdR9F3I+2yELkfTVvC1dg: posts big blind $2
xUTLK/SDwl6IxZdaKduuFg: sits out
*** HOLE CARDS ***
/PH6Ffnho4Ysm8S3V/oa+w: folds
669iGNwYwgRZg3nhS+aDAQ: raises $8 to $10
54yWzRRgS0oZ+S6LwZBxMQ: folds
sY+4Uuh5z/6AbXXaCS10jw: folds
VvdR9F3I+2yELkfTVvC1dg: folds
669iGNwYwgRZg3nhS+aDAQ collected $5 from pot
*** SUMMARY ***
Total pot $5 | Rake $0
Seat 2: 669iGNwYwgRZg3nhS+aDAQ collected ($5)
Seat 3: 54yWzRRgS0oZ+S6LwZBxMQ (button) folded before Flop (didn't bet)
Seat 4: sY+4Uuh5z/6AbXXaCS10jw (small blind) folded before Flop
Seat 5: VvdR9F3I+2yELkfTVvC1dg (big blind) folded before Flop
Seat 6: /PH6Ffnho4Ysm8S3V/oa+w folded before Flop (didn't bet)



PokerStars Game #59941696022:  Hold'em No Limit ($1/$2) - 2009/07/01 1:43:16 ET
Table 'G1Oqdy4Pqdb5gtx40rUBzA' 6-max Seat #3 is the button
Seat 1: BWhgxe7gWiYobRbwdG+d2Q ($196 in chips)
Seat 2: m7mYVfnCOK5TE/VkN/FhOg ($212.05 in chips)
Seat 3: VvdR9F3I+2yELkfTVvC1dg ($215.90 in chips)
Seat 4: B87ikIyZ/TzAVeXf38Ny0g ($209.55 in chips)
Seat 5: F1+Ml47qRQWunzPnGhLLzQ ($195.40 in chips)
Seat 6: qCnEYuAE5y5A7bk6fO5/jQ ($211.25 in chips)
B87ikIyZ/TzAVeXf38Ny0g: posts small blind $1
F1+Ml47qRQWunzPnGhLLzQ: posts big blind $2
*** HOLE CARDS ***
qCnEYuAE5y5A7bk6fO5/jQ: folds
BWhgxe7gWiYobRbwdG+d2Q: raises $5 to $7
m7mYVfnCOK5TE/VkN/FhOg: folds
VvdR9F3I+2yELkfTVvC1dg: folds
B87ikIyZ/TzAVeXf38Ny0g: folds
F1+Ml47qRQWunzPnGhLLzQ: folds
BWhgxe7gWiYobRbwdG+d2Q collected $5 from pot
BWhgxe7gWiYobRbwdG+d2Q: doesn't show hand
*** SUMMARY ***
Total pot $5 | Rake $0
Seat 1: BWhgxe7gWiYobRbwdG+d2Q collected ($5)
Seat 2: m7mYVfnCOK5TE/VkN/FhOg folded before Flop (didn't bet)
Seat 3: VvdR9F3I+2yELkfTVvC1dg (button) folded before Flop (didn't bet)
Seat 4: B87ikIyZ/TzAVeXf38Ny0g (small blind) folded before Flop
Seat 5: F1+Ml47qRQWunzPnGhLLzQ (big blind) folded before Flop
Seat 6: qCnEYuAE5y5A7bk6fO5/jQ folded before Flop (didn't bet)



PokerStars Game #59941696878:  Hold'em No Limit ($1/$2) - 2009/07/01 1:43:18 ET
Table 'ZzSIe0zTCDv+n6hfbY5tTg' 6-max Seat #4 is the button
Seat 1: VvdR9F3I+2yELkfTVvC1dg ($254 in chips)
Seat 2: B87ikIyZ/TzAVeXf38Ny0g ($237 in chips)
Seat 3: gsugPj31Hui3Jefl98MBOA ($349 in chips)
Seat 4: 54yWzRRgS0oZ+S6LwZBxMQ ($37 in chips)
Seat 5: 3dAbvkxS5NPQTBAbvpinVg ($507.45 in chips)
Seat 6: 09BNF4quPDzanQzM8vc6WA ($39 in chips)
3dAbvkxS5NPQTBAbvpinVg: posts small blind $1
09BNF4quPDzanQzM8vc6WA: posts big blind $2
*** HOLE CARDS ***
VvdR9F3I+2yELkfTVvC1dg: folds
B87ikIyZ/TzAVeXf38Ny0g: folds
gsugPj31Hui3Jefl98MBOA: folds
54yWzRRgS0oZ+S6LwZBxMQ: calls $2
3dAbvkxS5NPQTBAbvpinVg: folds
09BNF4quPDzanQzM8vc6WA: checks
*** FLOP *** [4s 2s 5s]
09BNF4quPDzanQzM8vc6WA: checks
54yWzRRgS0oZ+S6LwZBxMQ: bets $4
09BNF4quPDzanQzM8vc6WA: folds
54yWzRRgS0oZ+S6LwZBxMQ collected $4.75 from pot
54yWzRRgS0oZ+S6LwZBxMQ: doesn't show hand
*** SUMMARY ***
Total pot $5 | Rake $0.25
Board [4s 2s 5s]
Seat 1: VvdR9F3I+2yELkfTVvC1dg folded before Flop (didn't bet)
Seat 2: B87ikIyZ/TzAVeXf38Ny0g folded before Flop (didn't bet)
Seat 3: gsugPj31Hui3Jefl98MBOA folded before Flop (didn't bet)
Seat 4: 54yWzRRgS0oZ+S6LwZBxMQ (button) collected ($4.75)
Seat 5: 3dAbvkxS5NPQTBAbvpinVg (small blind) folded before Flop
Seat 6: 09BNF4quPDzanQzM8vc6WA (big blind) folded on the Flop



PokerStars Game #59941697506:  Hold'em No Limit ($1/$2) - 2009/07/01 1:43:19 ET
Table 'mGpP9StWRnoeiBDExc6Frg' 6-max Seat #1 is the button
Seat 1: VvdR9F3I+2yELkfTVvC1dg ($309.15 in chips)
Seat 2: vkfxu8f/jMYKUk6Ly4eujw ($202 in chips)
Seat 4: 4dcDwIHRm96PwtqkpQiuiA ($66.70 in chips)
Seat 5: d1puGuVBE0fidn+5eRJ0tw ($197.55 in chips)
Seat 6: B2Ih1sr5VZk+8He7rcrMtQ ($425.65 in chips)
vkfxu8f/jMYKUk6Ly4eujw: posts small blind $1
7acrZUQC3Zc9BNLjoKIcLQ: is sitting out
4dcDwIHRm96PwtqkpQiuiA: posts big blind $2
*** HOLE CARDS ***
d1puGuVBE0fidn+5eRJ0tw: raises $8 to $10
B2Ih1sr5VZk+8He7rcrMtQ: folds
VvdR9F3I+2yELkfTVvC1dg: folds
vkfxu8f/jMYKUk6Ly4eujw: folds
4dcDwIHRm96PwtqkpQiuiA: folds
d1puGuVBE0fidn+5eRJ0tw collected $5 from pot
d1puGuVBE0fidn+5eRJ0tw: doesn't show hand
*** SUMMARY ***
Total pot $5 | Rake $0
Seat 1: VvdR9F3I+2yELkfTVvC1dg (button) folded before Flop (didn't bet)
Seat 2: vkfxu8f/jMYKUk6Ly4eujw (small blind) folded before Flop
Seat 4: 4dcDwIHRm96PwtqkpQiuiA (big blind) folded before Flop
Seat 5: d1puGuVBE0fidn+5eRJ0tw collected ($5)
Seat 6: B2Ih1sr5VZk+8He7rcrMtQ folded before Flop (didn't bet)



PokerStars Game #59941697818:  Hold'em No Limit ($1/$2) - 2009/07/01 1:43:19 ET
Table 'jlrIxbrVIG+gjaUYT4za8g' 6-max Seat #6 is the button
Seat 1: ygTTt5ehT4aF86q1a8/R+w ($236.30 in chips)
Seat 3: gnYme0DNFflnMhrdbxe1Ag ($203 in chips)
Seat 4: 8srN1dKQePlsv0GyTada+Q ($263.95 in chips)
Seat 5: AyBB0k3Dcl7xbXUeGMw06g ($40.40 in chips)
Seat 6: BWhgxe7gWiYobRbwdG+d2Q ($196 in chips)
ygTTt5ehT4aF86q1a8/R+w: posts small blind $1
/PH6Ffnho4Ysm8S3V/oa+w: is sitting out
gnYme0DNFflnMhrdbxe1Ag: posts big blind $2
*** HOLE CARDS ***
/PH6Ffnho4Ysm8S3V/oa+w leaves the table
8srN1dKQePlsv0GyTada+Q: folds
AyBB0k3Dcl7xbXUeGMw06g: calls $2
BWhgxe7gWiYobRbwdG+d2Q: folds
ygTTt5ehT4aF86q1a8/R+w: folds
gnYme0DNFflnMhrdbxe1Ag: checks
*** FLOP *** [Kd As 8s]
gnYme0DNFflnMhrdbxe1Ag: checks
AyBB0k3Dcl7xbXUeGMw06g: checks
*** TURN *** [Kd As 8s] [2c]
gnYme0DNFflnMhrdbxe1Ag: checks
AyBB0k3Dcl7xbXUeGMw06g: checks
*** RIVER *** [Kd As 8s 2c] [Kc]
cwfuMyvDC7J7SqX2leDC8g joins the table at seat #2
gnYme0DNFflnMhrdbxe1Ag: checks
AyBB0k3Dcl7xbXUeGMw06g: checks
*** SHOW DOWN ***
gnYme0DNFflnMhrdbxe1Ag: shows [4h Jh] (a pair of Kings)
AyBB0k3Dcl7xbXUeGMw06g: shows [6c 8c] (two pair, Kings and Eights)
AyBB0k3Dcl7xbXUeGMw06g collected $4.75 from pot
*** SUMMARY ***
Total pot $5 | Rake $0.25
Board [Kd As 8s 2c Kc]
Seat 1: ygTTt5ehT4aF86q1a8/R+w (small blind) folded before Flop
Seat 3: gnYme0DNFflnMhrdbxe1Ag (big blind) showed [4h Jh] and lost with a pair of Kings
Seat 4: 8srN1dKQePlsv0GyTada+Q folded before Flop (didn't bet)
Seat 5: AyBB0k3Dcl7xbXUeGMw06g showed [6c 8c] and won ($4.75) with two pair, Kings and Eights
Seat 6: BWhgxe7gWiYobRbwdG+d2Q (button) folded before Flop (didn't bet)



PokerStars Game #59941697420:  Hold'em No Limit ($1/$2) - 2009/07/01 1:43:19 ET
Table '/dyk+YdRGv90j2box35j8w' 6-max Seat #2 is the button
Seat 1: 8srN1dKQePlsv0GyTada+Q ($202 in chips)
Seat 2: qCnEYuAE5y5A7bk6fO5/jQ ($490.20 in chips)
Seat 3: sTPOWERd9HWPCNrDBwsVjA ($207.50 in chips)
Seat 5: VvdR9F3I+2yELkfTVvC1dg ($254.55 in chips)
Seat 6: gnYme0DNFflnMhrdbxe1Ag ($200 in chips)
sTPOWERd9HWPCNrDBwsVjA: posts small blind $1
VvdR9F3I+2yELkfTVvC1dg: posts big blind $2
*** HOLE CARDS ***
gnYme0DNFflnMhrdbxe1Ag: folds
8srN1dKQePlsv0GyTada+Q: folds
qCnEYuAE5y5A7bk6fO5/jQ: raises $4 to $6
sTPOWERd9HWPCNrDBwsVjA: folds
VvdR9F3I+2yELkfTVvC1dg: folds
qCnEYuAE5y5A7bk6fO5/jQ collected $5 from pot
qCnEYuAE5y5A7bk6fO5/jQ: doesn't show hand
*** SUMMARY ***
Total pot $5 | Rake $0
Seat 1: 8srN1dKQePlsv0GyTada+Q folded before Flop (didn't bet)
Seat 2: qCnEYuAE5y5A7bk6fO5/jQ (button) collected ($5)
Seat 3: sTPOWERd9HWPCNrDBwsVjA (small blind) folded before Flop
Seat 5: VvdR9F3I+2yELkfTVvC1dg (big blind) folded before Flop
Seat 6: gnYme0DNFflnMhrdbxe1Ag folded before Flop (didn't bet)



PokerStars Game #59941701712:  Hold'em No Limit ($1/$2) - 2009/07/01 1:43:27 ET
Table 'kq5zaQ+1hLNf8LZfGnbTAA' 6-max Seat #3 is the button
Seat 1: 8srN1dKQePlsv0GyTada+Q ($422.60 in chips)
Seat 2: nXDI8Y/S6POzRwANu3d8hQ ($140 in chips)
Seat 3: /PH6Ffnho4Ysm8S3V/oa+w ($49.15 in chips)
Seat 4: 3dAbvkxS5NPQTBAbvpinVg ($279.45 in chips)
Seat 5: gnYme0DNFflnMhrdbxe1Ag ($222.35 in chips)
Seat 6: mfy7uGZcqA2PVQqEVbJ7+g ($198.15 in chips)
3dAbvkxS5NPQTBAbvpinVg: posts small blind $1
gnYme0DNFflnMhrdbxe1Ag: posts big blind $2
*** HOLE CARDS ***
mfy7uGZcqA2PVQqEVbJ7+g: raises $5 to $7
8srN1dKQePlsv0GyTada+Q: folds
nXDI8Y/S6POzRwANu3d8hQ: folds
/PH6Ffnho4Ysm8S3V/oa+w: folds
3dAbvkxS5NPQTBAbvpinVg: calls $6
gnYme0DNFflnMhrdbxe1Ag: folds
*** FLOP *** [7s 6s 5s]
3dAbvkxS5NPQTBAbvpinVg: checks
mfy7uGZcqA2PVQqEVbJ7+g: checks
*** TURN *** [7s 6s 5s] [6h]
3dAbvkxS5NPQTBAbvpinVg: bets $12
mfy7uGZcqA2PVQqEVbJ7+g: folds
3dAbvkxS5NPQTBAbvpinVg collected $15.20 from pot
3dAbvkxS5NPQTBAbvpinVg: doesn't show hand
*** SUMMARY ***
Total pot $16 | Rake $0.80
Board [7s 6s 5s 6h]
Seat 1: 8srN1dKQePlsv0GyTada+Q folded before Flop (didn't bet)
Seat 2: nXDI8Y/S6POzRwANu3d8hQ folded before Flop (didn't bet)
Seat 3: /PH6Ffnho4Ysm8S3V/oa+w (button) folded before Flop (didn't bet)
Seat 4: 3dAbvkxS5NPQTBAbvpinVg (small blind) collected ($15.20)
Seat 5: gnYme0DNFflnMhrdbxe1Ag (big blind) folded before Flop
Seat 6: mfy7uGZcqA2PVQqEVbJ7+g folded on the Turn



PokerStars Game #59941701590:  Hold'em No Limit ($1/$2) - 2009/07/01 1:43:27 ET
Table 'P/yCfYl1GfGsu/e6DxDy/A' 2-max Seat #2 is the button
Seat 1: 7fOCUy3x9hdkmXkkDNolGQ ($534 in chips)
Seat 2: RwDoM55ZeQuI2ADyJhOb2Q ($941.50 in chips)
RwDoM55ZeQuI2ADyJhOb2Q: posts small blind $1
7fOCUy3x9hdkmXkkDNolGQ: posts big blind $2
*** HOLE CARDS ***
RwDoM55ZeQuI2ADyJhOb2Q: raises $4 to $6
7fOCUy3x9hdkmXkkDNolGQ: raises $14 to $20
RwDoM55ZeQuI2ADyJhOb2Q: calls $14
*** FLOP *** [Kc 7h 4d]
7fOCUy3x9hdkmXkkDNolGQ: bets $22
RwDoM55ZeQuI2ADyJhOb2Q: raises $52 to $74
7fOCUy3x9hdkmXkkDNolGQ: folds
RwDoM55ZeQuI2ADyJhOb2Q collected $83.50 from pot
RwDoM55ZeQuI2ADyJhOb2Q: doesn't show hand
*** SUMMARY ***
Total pot $84 | Rake $0.50
Board [Kc 7h 4d]
Seat 1: 7fOCUy3x9hdkmXkkDNolGQ (big blind) folded on the Flop
Seat 2: RwDoM55ZeQuI2ADyJhOb2Q (button) (small blind) collected ($83.50)



PokerStars Game #59941702974:  Hold'em No Limit ($1/$2) - 2009/07/01 1:43:29 ET
Table 'ztv6V3FN2bQ9nmJPPdx6nQ' 6-max Seat #1 is the button
Seat 1: 6fLdOUCRtX71xbVRhJEq8w ($230.35 in chips)
Seat 2: 5Y+ZGWLI4gnlpApDX5vy1A ($411.15 in chips)
Seat 3: ubtx4Z5L+AcK71MTvYiGVw ($247.20 in chips)
Seat 4: UaZ5yj+6LjtWqMQg2QskUw ($82.30 in chips)
Seat 5: sTPOWERd9HWPCNrDBwsVjA ($217.60 in chips)
Seat 6: mfy7uGZcqA2PVQqEVbJ7+g ($106.60 in chips)
5Y+ZGWLI4gnlpApDX5vy1A: posts small blind $1
ubtx4Z5L+AcK71MTvYiGVw: posts big blind $2
*** HOLE CARDS ***
UaZ5yj+6LjtWqMQg2QskUw: folds
sTPOWERd9HWPCNrDBwsVjA: raises $4 to $6
mfy7uGZcqA2PVQqEVbJ7+g: folds
6fLdOUCRtX71xbVRhJEq8w: folds
5Y+ZGWLI4gnlpApDX5vy1A: folds
ubtx4Z5L+AcK71MTvYiGVw: folds
sTPOWERd9HWPCNrDBwsVjA collected $5 from pot
*** SUMMARY ***
Total pot $5 | Rake $0
Seat 1: 6fLdOUCRtX71xbVRhJEq8w (button) folded before Flop (didn't bet)
Seat 2: 5Y+ZGWLI4gnlpApDX5vy1A (small blind) folded before Flop
Seat 3: ubtx4Z5L+AcK71MTvYiGVw (big blind) folded before Flop
Seat 4: UaZ5yj+6LjtWqMQg2QskUw folded before Flop (didn't bet)
Seat 5: sTPOWERd9HWPCNrDBwsVjA collected ($5)
Seat 6: mfy7uGZcqA2PVQqEVbJ7+g folded before Flop (didn't bet)



PokerStars Game #59941704792:  Hold'em No Limit ($1/$2) - 2009/07/01 1:43:33 ET
Table 'mGpP9StWRnoeiBDExc6Frg' 6-max Seat #2 is the button
Seat 1: VvdR9F3I+2yELkfTVvC1dg ($309.15 in chips)
Seat 2: vkfxu8f/jMYKUk6Ly4eujw ($201 in chips)
Seat 4: 4dcDwIHRm96PwtqkpQiuiA ($64.70 in chips)
Seat 5: d1puGuVBE0fidn+5eRJ0tw ($200.55 in chips)
Seat 6: B2Ih1sr5VZk+8He7rcrMtQ ($425.65 in chips)
4dcDwIHRm96PwtqkpQiuiA: posts small blind $1
d1puGuVBE0fidn+5eRJ0tw: posts big blind $2
*** HOLE CARDS ***
B2Ih1sr5VZk+8He7rcrMtQ: folds
VvdR9F3I+2yELkfTVvC1dg: folds
vkfxu8f/jMYKUk6Ly4eujw: folds
4dcDwIHRm96PwtqkpQiuiA: calls $1
d1puGuVBE0fidn+5eRJ0tw: checks
*** FLOP *** [Ks Jc Js]
4dcDwIHRm96PwtqkpQiuiA: checks
d1puGuVBE0fidn+5eRJ0tw: bets $4
4dcDwIHRm96PwtqkpQiuiA: folds
d1puGuVBE0fidn+5eRJ0tw collected $3.80 from pot
d1puGuVBE0fidn+5eRJ0tw: doesn't show hand
*** SUMMARY ***
Total pot $4 | Rake $0.20
Board [Ks Jc Js]
Seat 1: VvdR9F3I+2yELkfTVvC1dg folded before Flop (didn't bet)
Seat 2: vkfxu8f/jMYKUk6Ly4eujw (button) folded before Flop (didn't bet)
Seat 4: 4dcDwIHRm96PwtqkpQiuiA (small blind) folded on the Flop
Seat 5: d1puGuVBE0fidn+5eRJ0tw (big blind) collected ($3.80)
Seat 6: B2Ih1sr5VZk+8He7rcrMtQ folded before Flop (didn't bet)



PokerStars Game #59941705180:  Hold'em No Limit ($1/$2) - 2009/07/01 1:43:33 ET
Table '4NGNnZ/osQfNq6abYqkJeA' 6-max Seat #4 is the button
Seat 2: 669iGNwYwgRZg3nhS+aDAQ ($138.25 in chips)
Seat 3: 54yWzRRgS0oZ+S6LwZBxMQ ($37 in chips)
Seat 4: sY+4Uuh5z/6AbXXaCS10jw ($227.25 in chips)
Seat 5: VvdR9F3I+2yELkfTVvC1dg ($229.55 in chips)
Seat 6: /PH6Ffnho4Ysm8S3V/oa+w ($40 in chips)
VvdR9F3I+2yELkfTVvC1dg: posts small blind $1
/PH6Ffnho4Ysm8S3V/oa+w: posts big blind $2
xUTLK/SDwl6IxZdaKduuFg: sits out
*** HOLE CARDS ***
669iGNwYwgRZg3nhS+aDAQ: raises $8 to $10
54yWzRRgS0oZ+S6LwZBxMQ: folds
sY+4Uuh5z/6AbXXaCS10jw: folds
VvdR9F3I+2yELkfTVvC1dg: folds
/PH6Ffnho4Ysm8S3V/oa+w: folds
669iGNwYwgRZg3nhS+aDAQ collected $5 from pot
*** SUMMARY ***
Total pot $5 | Rake $0
Seat 2: 669iGNwYwgRZg3nhS+aDAQ collected ($5)
Seat 3: 54yWzRRgS0oZ+S6LwZBxMQ folded before Flop (didn't bet)
Seat 4: sY+4Uuh5z/6AbXXaCS10jw (button) folded before Flop (didn't bet)
Seat 5: VvdR9F3I+2yELkfTVvC1dg (small blind) folded before Flop
Seat 6: /PH6Ffnho4Ysm8S3V/oa+w (big blind) folded before Flop



PokerStars Game #59941705710:  Hold'em No Limit ($1/$2) - 2009/07/01 1:43:34 ET
Table 'uJ9juaXXg9yIcSU8amxaXQ' 6-max Seat #1 is the button
Seat 1: JsqOjN/eHz0uYVf/PyUJ6Q ($146.25 in chips)
Seat 2: VvdR9F3I+2yELkfTVvC1dg ($201.30 in chips)
Seat 3: qXDd0ZyMIse0OBu8pxeQ3Q ($243.40 in chips)
Seat 4: zNjJ/y4emmF+vzrCDd+ooA ($245.65 in chips)
Seat 5: YsLQ3BAvgQHWXMAv3Wv6Hg ($212.70 in chips)
Seat 6: /PH6Ffnho4Ysm8S3V/oa+w ($40 in chips)
VvdR9F3I+2yELkfTVvC1dg: posts small blind $1
qXDd0ZyMIse0OBu8pxeQ3Q: posts big blind $2
*** HOLE CARDS ***
zNjJ/y4emmF+vzrCDd+ooA: folds
YsLQ3BAvgQHWXMAv3Wv6Hg: folds
/PH6Ffnho4Ysm8S3V/oa+w: folds
JsqOjN/eHz0uYVf/PyUJ6Q: folds
VvdR9F3I+2yELkfTVvC1dg: folds
qXDd0ZyMIse0OBu8pxeQ3Q collected $2 from pot
*** SUMMARY ***
Total pot $2 | Rake $0
Seat 1: JsqOjN/eHz0uYVf/PyUJ6Q (button) folded before Flop (didn't bet)
Seat 2: VvdR9F3I+2yELkfTVvC1dg (small blind) folded before Flop
Seat 3: qXDd0ZyMIse0OBu8pxeQ3Q (big blind) collected ($2)
Seat 4: zNjJ/y4emmF+vzrCDd+ooA folded before Flop (didn't bet)
Seat 5: YsLQ3BAvgQHWXMAv3Wv6Hg folded before Flop (didn't bet)
Seat 6: /PH6Ffnho4Ysm8S3V/oa+w folded before Flop (didn't bet)



PokerStars Game #59941705506:  Hold'em No Limit ($1/$2) - 2009/07/01 1:43:34 ET
Table 'aSf77Sj8QEnzcc0WaxVD4Q' 6-max Seat #3 is the button
Seat 1: UELtvp+JfwI7XDGVwSxZXA ($245.10 in chips)
Seat 2: vkfxu8f/jMYKUk6Ly4eujw ($214.20 in chips)
Seat 3: 9dpyyjDTCed6nV7JhaUUpw ($740.75 in chips)
Seat 4: YsLQ3BAvgQHWXMAv3Wv6Hg ($200 in chips)
Seat 5: VvdR9F3I+2yELkfTVvC1dg ($257.45 in chips)
Seat 6: vkoJRf3gidxY1pPi0AFWww ($136.50 in chips)
YsLQ3BAvgQHWXMAv3Wv6Hg: posts small blind $1
VvdR9F3I+2yELkfTVvC1dg: posts big blind $2
*** HOLE CARDS ***
vkoJRf3gidxY1pPi0AFWww: calls $2
UELtvp+JfwI7XDGVwSxZXA: raises $4 to $6
vkfxu8f/jMYKUk6Ly4eujw: folds
9dpyyjDTCed6nV7JhaUUpw: folds
YsLQ3BAvgQHWXMAv3Wv6Hg: folds
VvdR9F3I+2yELkfTVvC1dg: folds
vkoJRf3gidxY1pPi0AFWww: calls $4
*** FLOP *** [Ts Ah Ac]
vkoJRf3gidxY1pPi0AFWww: bets $8
UELtvp+JfwI7XDGVwSxZXA: folds
vkoJRf3gidxY1pPi0AFWww collected $14.25 from pot
vkoJRf3gidxY1pPi0AFWww: doesn't show hand
*** SUMMARY ***
Total pot $15 | Rake $0.75
Board [Ts Ah Ac]
Seat 1: UELtvp+JfwI7XDGVwSxZXA folded on the Flop
Seat 2: vkfxu8f/jMYKUk6Ly4eujw folded before Flop (didn't bet)
Seat 3: 9dpyyjDTCed6nV7JhaUUpw (button) folded before Flop (didn't bet)
Seat 4: YsLQ3BAvgQHWXMAv3Wv6Hg (small blind) folded before Flop
Seat 5: VvdR9F3I+2yELkfTVvC1dg (big blind) folded before Flop
Seat 6: vkoJRf3gidxY1pPi0AFWww collected ($14.25)



PokerStars Game #59941706504:  Hold'em No Limit ($1/$2) - 2009/07/01 1:43:36 ET
Table 'bJQ024BaYSBrW0sXpCZbNQ' 6-max Seat #5 is the button
Seat 1: KfwW5us6tydK81NYTtK1gw ($203 in chips)
Seat 2: 3dAbvkxS5NPQTBAbvpinVg ($233 in chips)
Seat 3: /PH6Ffnho4Ysm8S3V/oa+w ($49 in chips)
Seat 4: TBaQIN+sQ7eb7P99QnaORQ ($49.80 in chips)
Seat 5: VvdR9F3I+2yELkfTVvC1dg ($200 in chips)
Seat 6: 4bqvCfJ0e8CTYnn0Go9hbQ ($144.20 in chips)
4bqvCfJ0e8CTYnn0Go9hbQ: posts small blind $1
KfwW5us6tydK81NYTtK1gw: posts big blind $2
*** HOLE CARDS ***
3dAbvkxS5NPQTBAbvpinVg: raises $4 to $6
/PH6Ffnho4Ysm8S3V/oa+w: folds
TBaQIN+sQ7eb7P99QnaORQ: folds
VvdR9F3I+2yELkfTVvC1dg: folds
4bqvCfJ0e8CTYnn0Go9hbQ: folds
KfwW5us6tydK81NYTtK1gw: folds
3dAbvkxS5NPQTBAbvpinVg collected $5 from pot
3dAbvkxS5NPQTBAbvpinVg: doesn't show hand
*** SUMMARY ***
Total pot $5 | Rake $0
Seat 1: KfwW5us6tydK81NYTtK1gw (big blind) folded before Flop
Seat 2: 3dAbvkxS5NPQTBAbvpinVg collected ($5)
Seat 3: /PH6Ffnho4Ysm8S3V/oa+w folded before Flop (didn't bet)
Seat 4: TBaQIN+sQ7eb7P99QnaORQ folded before Flop (didn't bet)
Seat 5: VvdR9F3I+2yELkfTVvC1dg (button) folded before Flop (didn't bet)
Seat 6: 4bqvCfJ0e8CTYnn0Go9hbQ (small blind) folded before Flop



PokerStars Game #59941706378:  Hold'em No Limit ($1/$2) - 2009/07/01 1:43:36 ET
Table 'zEOkwFUmNLBlvazOXtwH8w' 2-max Seat #1 is the button
Seat 1: gu6Ee9WAefYH8BG9//A1pw ($118 in chips)
Seat 2: SLKKhEamo9/21wMiSyGsQw ($220.50 in chips)
gu6Ee9WAefYH8BG9//A1pw: posts small blind $1
SLKKhEamo9/21wMiSyGsQw: posts big blind $2
*** HOLE CARDS ***
gu6Ee9WAefYH8BG9//A1pw: raises $52 to $54
SLKKhEamo9/21wMiSyGsQw: raises $166.50 to $220.50 and is all-in
gu6Ee9WAefYH8BG9//A1pw: folds
SLKKhEamo9/21wMiSyGsQw collected $108 from pot
SLKKhEamo9/21wMiSyGsQw: doesn't show hand
*** SUMMARY ***
Total pot $108 | Rake $0
Seat 1: gu6Ee9WAefYH8BG9//A1pw (button) (small blind) folded before Flop
Seat 2: SLKKhEamo9/21wMiSyGsQw (big blind) collected ($108)



PokerStars Game #59941706952:  Hold'em No Limit ($1/$2) - 2009/07/01 1:43:37 ET
Table '/dyk+YdRGv90j2box35j8w' 6-max Seat #3 is the button
Seat 1: 8srN1dKQePlsv0GyTada+Q ($202 in chips)
Seat 2: qCnEYuAE5y5A7bk6fO5/jQ ($493.20 in chips)
Seat 3: sTPOWERd9HWPCNrDBwsVjA ($206.50 in chips)
Seat 5: VvdR9F3I+2yELkfTVvC1dg ($252.55 in chips)
Seat 6: gnYme0DNFflnMhrdbxe1Ag ($200 in chips)
VvdR9F3I+2yELkfTVvC1dg: posts small blind $1
gnYme0DNFflnMhrdbxe1Ag: posts big blind $2
*** HOLE CARDS ***
8srN1dKQePlsv0GyTada+Q: raises $4 to $6
qCnEYuAE5y5A7bk6fO5/jQ: raises $12 to $18
sTPOWERd9HWPCNrDBwsVjA: folds
VvdR9F3I+2yELkfTVvC1dg: folds
gnYme0DNFflnMhrdbxe1Ag: folds
8srN1dKQePlsv0GyTada+Q: folds
qCnEYuAE5y5A7bk6fO5/jQ collected $15 from pot
qCnEYuAE5y5A7bk6fO5/jQ: doesn't show hand
*** SUMMARY ***
Total pot $15 | Rake $0
Seat 1: 8srN1dKQePlsv0GyTada+Q folded before Flop
Seat 2: qCnEYuAE5y5A7bk6fO5/jQ collected ($15)
Seat 3: sTPOWERd9HWPCNrDBwsVjA (button) folded before Flop (didn't bet)
Seat 5: VvdR9F3I+2yELkfTVvC1dg (small blind) folded before Flop
Seat 6: gnYme0DNFflnMhrdbxe1Ag (big blind) folded before Flop



PokerStars Game #59941709354:  Hold'em No Limit ($1/$2) - 2009/07/01 1:43:41 ET
Table 'eyAQSIlgc2o1Jxvbve4WGg' 9-max Seat #6 is the button
Seat 1: UZEsV9yKUMqmpYPiOFpaZw ($53.20 in chips)
Seat 2: kM9CA+2UcdMjbCMbtUCGiA ($220.60 in chips)
Seat 4: CkE3IyJF1KvdaAOmZY5XqQ ($200 in chips)
Seat 5: mIKx5lhIt13X5eZQH0ZeMA ($128.40 in chips)
Seat 6: nXDI8Y/S6POzRwANu3d8hQ ($67 in chips)
Seat 7: u3OrI5uGx9mx1fE7dgr+EA ($67.50 in chips)
Seat 9: WUlHm+ydPPHG7Lb0rePSdA ($143.20 in chips)
u3OrI5uGx9mx1fE7dgr+EA: posts small blind $1
1CtiZuXDFaJL1dJPQKyi8Q: is sitting out
WUlHm+ydPPHG7Lb0rePSdA: posts big blind $2
*** HOLE CARDS ***
UZEsV9yKUMqmpYPiOFpaZw: folds
kM9CA+2UcdMjbCMbtUCGiA: folds
1CtiZuXDFaJL1dJPQKyi8Q leaves the table
254YPxPJr5Sw58bkD0YqYQ joins the table at seat #8
CkE3IyJF1KvdaAOmZY5XqQ: raises $6 to $8
mIKx5lhIt13X5eZQH0ZeMA: calls $8
nXDI8Y/S6POzRwANu3d8hQ: folds
u3OrI5uGx9mx1fE7dgr+EA: folds
WUlHm+ydPPHG7Lb0rePSdA: folds
*** FLOP *** [9s 2d 5s]
CkE3IyJF1KvdaAOmZY5XqQ: checks
mIKx5lhIt13X5eZQH0ZeMA: bets $6
CkE3IyJF1KvdaAOmZY5XqQ: folds
mIKx5lhIt13X5eZQH0ZeMA collected $18.05 from pot
mIKx5lhIt13X5eZQH0ZeMA: doesn't show hand
*** SUMMARY ***
Total pot $19 | Rake $0.95
Board [9s 2d 5s]
Seat 1: UZEsV9yKUMqmpYPiOFpaZw folded before Flop (didn't bet)
Seat 2: kM9CA+2UcdMjbCMbtUCGiA folded before Flop (didn't bet)
Seat 4: CkE3IyJF1KvdaAOmZY5XqQ folded on the Flop
Seat 5: mIKx5lhIt13X5eZQH0ZeMA collected ($18.05)
Seat 6: nXDI8Y/S6POzRwANu3d8hQ (button) folded before Flop (didn't bet)
Seat 7: u3OrI5uGx9mx1fE7dgr+EA (small blind) folded before Flop
Seat 9: WUlHm+ydPPHG7Lb0rePSdA (big blind) folded before Flop



PokerStars Game #59941709666:  Hold'em No Limit ($1/$2) - 2009/07/01 1:43:42 ET
Table 'G1Oqdy4Pqdb5gtx40rUBzA' 6-max Seat #4 is the button
Seat 1: BWhgxe7gWiYobRbwdG+d2Q ($199 in chips)
Seat 2: m7mYVfnCOK5TE/VkN/FhOg ($212.05 in chips)
Seat 3: VvdR9F3I+2yELkfTVvC1dg ($215.90 in chips)
Seat 4: B87ikIyZ/TzAVeXf38Ny0g ($208.55 in chips)
Seat 5: F1+Ml47qRQWunzPnGhLLzQ ($193.40 in chips)
Seat 6: qCnEYuAE5y5A7bk6fO5/jQ ($211.25 in chips)
F1+Ml47qRQWunzPnGhLLzQ: posts small blind $1
qCnEYuAE5y5A7bk6fO5/jQ: posts big blind $2
*** HOLE CARDS ***
BWhgxe7gWiYobRbwdG+d2Q: folds
m7mYVfnCOK5TE/VkN/FhOg: folds
BWhgxe7gWiYobRbwdG+d2Q leaves the table
VvdR9F3I+2yELkfTVvC1dg: folds
B87ikIyZ/TzAVeXf38Ny0g: raises $4 to $6
F1+Ml47qRQWunzPnGhLLzQ: calls $5
qCnEYuAE5y5A7bk6fO5/jQ: folds
*** FLOP *** [9s Qs 8s]
F1+Ml47qRQWunzPnGhLLzQ: checks
B87ikIyZ/TzAVeXf38Ny0g: checks
*** TURN *** [9s Qs 8s] [Qd]
F1+Ml47qRQWunzPnGhLLzQ: checks
B87ikIyZ/TzAVeXf38Ny0g: checks
*** RIVER *** [9s Qs 8s Qd] [Tc]
F1+Ml47qRQWunzPnGhLLzQ: bets $2
B87ikIyZ/TzAVeXf38Ny0g: calls $2
*** SHOW DOWN ***
F1+Ml47qRQWunzPnGhLLzQ: shows [5s 5h] (two pair, Queens and Fives)
B87ikIyZ/TzAVeXf38Ny0g: shows [7h 7c] (two pair, Queens and Sevens)
B87ikIyZ/TzAVeXf38Ny0g collected $17.15 from pot
*** SUMMARY ***
Total pot $18 | Rake $0.85
Board [9s Qs 8s Qd Tc]
Seat 1: BWhgxe7gWiYobRbwdG+d2Q folded before Flop (didn't bet)
Seat 2: m7mYVfnCOK5TE/VkN/FhOg folded before Flop (didn't bet)
Seat 3: VvdR9F3I+2yELkfTVvC1dg folded before Flop (didn't bet)
Seat 4: B87ikIyZ/TzAVeXf38Ny0g (button) showed [7h 7c] and won ($17.15) with two pair, Queens and Sevens
Seat 5: F1+Ml47qRQWunzPnGhLLzQ (small blind) showed [5s 5h] and lost with two pair, Queens and Fives
Seat 6: qCnEYuAE5y5A7bk6fO5/jQ (big blind) folded before Flop



PokerStars Game #59941711832:  Hold'em No Limit ($1/$2) - 2009/07/01 1:43:46 ET
Table 'CFkQcfWjKccZaZDf71FK+w' 6-max Seat #2 is the button
Seat 1: vkfxu8f/jMYKUk6Ly4eujw ($227.25 in chips)
Seat 2: ewN/vzF22+/gdzjIKBOlkA ($204.05 in chips)
Seat 3: 09BNF4quPDzanQzM8vc6WA ($80.30 in chips)
Seat 4: ygTTt5ehT4aF86q1a8/R+w ($243.35 in chips)
Seat 5: 2lOU1DcvUZaMcxZ95XfzXw ($157.05 in chips)
Seat 6: ORVqY3rf9X6ANA/8s+On2Q ($41.60 in chips)
09BNF4quPDzanQzM8vc6WA: posts small blind $1
ygTTt5ehT4aF86q1a8/R+w: posts big blind $2
*** HOLE CARDS ***
2lOU1DcvUZaMcxZ95XfzXw: folds
ORVqY3rf9X6ANA/8s+On2Q: calls $2
vkfxu8f/jMYKUk6Ly4eujw: folds
ewN/vzF22+/gdzjIKBOlkA: raises $6 to $8
09BNF4quPDzanQzM8vc6WA: folds
ygTTt5ehT4aF86q1a8/R+w: folds
ORVqY3rf9X6ANA/8s+On2Q: calls $6
*** FLOP *** [4c 8h 4h]
ORVqY3rf9X6ANA/8s+On2Q: checks
ewN/vzF22+/gdzjIKBOlkA: checks
*** TURN *** [4c 8h 4h] [2c]
ORVqY3rf9X6ANA/8s+On2Q: checks
ewN/vzF22+/gdzjIKBOlkA: checks
*** RIVER *** [4c 8h 4h 2c] [2d]
ORVqY3rf9X6ANA/8s+On2Q: checks
ewN/vzF22+/gdzjIKBOlkA: bets $6
ORVqY3rf9X6ANA/8s+On2Q: calls $6
*** SHOW DOWN ***
ewN/vzF22+/gdzjIKBOlkA: shows [Qc Ad] (two pair, Fours and Deuces)
ORVqY3rf9X6ANA/8s+On2Q: shows [Ac Ts] (two pair, Fours and Deuces)
ORVqY3rf9X6ANA/8s+On2Q collected $14.75 from pot
ewN/vzF22+/gdzjIKBOlkA collected $14.75 from pot
*** SUMMARY ***
Total pot $31 | Rake $1.50
Board [4c 8h 4h 2c 2d]
Seat 1: vkfxu8f/jMYKUk6Ly4eujw folded before Flop (didn't bet)
Seat 2: ewN/vzF22+/gdzjIKBOlkA (button) showed [Qc Ad] and won ($14.75) with two pair, Fours and Deuces
Seat 3: 09BNF4quPDzanQzM8vc6WA (small blind) folded before Flop
Seat 4: ygTTt5ehT4aF86q1a8/R+w (big blind) folded before Flop
Seat 5: 2lOU1DcvUZaMcxZ95XfzXw folded before Flop (didn't bet)
Seat 6: ORVqY3rf9X6ANA/8s+On2Q showed [Ac Ts] and won ($14.75) with two pair, Fours and Deuces



PokerStars Game #59941712158:  Hold'em No Limit ($1/$2) - 2009/07/01 1:43:46 ET
Table 'on4i1U1lCRmxsduFD3xiSg' 9-max Seat #2 is the button
Seat 1: so5k3vFDmokh2q3dImJ1GQ ($173.30 in chips)
Seat 2: NqSvZNzJ4RkR3sCmgQnyLw ($67.05 in chips)
Seat 3: GX1heJ+DSsvm7gzSPsYhhQ ($40 in chips)
Seat 4: DFQVuszLVclqjA46pN4Vvw ($73.80 in chips)
Seat 5: 37j/5DgMG5m9lMfFofEAOg ($50.70 in chips)
Seat 7: /inIs/z/PcX+TniIFpaxpg ($268.05 in chips)
Seat 8: ZYHoLw2lWmRS7CSHi8L8Xg ($200 in chips)
Seat 9: TAfo4veNRaRlzDXMMYS3Jg ($82 in chips)
GX1heJ+DSsvm7gzSPsYhhQ: posts small blind $1
DFQVuszLVclqjA46pN4Vvw: posts big blind $2
KqHysDSpCPaPyK3tJC1aEw: sits out
*** HOLE CARDS ***
37j/5DgMG5m9lMfFofEAOg: folds
/inIs/z/PcX+TniIFpaxpg: folds
ZYHoLw2lWmRS7CSHi8L8Xg: folds
TAfo4veNRaRlzDXMMYS3Jg: folds
so5k3vFDmokh2q3dImJ1GQ: folds
NqSvZNzJ4RkR3sCmgQnyLw: calls $2
GX1heJ+DSsvm7gzSPsYhhQ: folds
DFQVuszLVclqjA46pN4Vvw: checks
*** FLOP *** [Jd 6s Ad]
DFQVuszLVclqjA46pN4Vvw: checks
NqSvZNzJ4RkR3sCmgQnyLw: bets $2
DFQVuszLVclqjA46pN4Vvw: calls $2
*** TURN *** [Jd 6s Ad] [Th]
DFQVuszLVclqjA46pN4Vvw: checks
NqSvZNzJ4RkR3sCmgQnyLw: bets $4
DFQVuszLVclqjA46pN4Vvw: calls $4
*** RIVER *** [Jd 6s Ad Th] [3h]
DFQVuszLVclqjA46pN4Vvw: folds
NqSvZNzJ4RkR3sCmgQnyLw collected $16.20 from pot
*** SUMMARY ***
Total pot $17 | Rake $0.80
Board [Jd 6s Ad Th 3h]
Seat 1: so5k3vFDmokh2q3dImJ1GQ folded before Flop (didn't bet)
Seat 2: NqSvZNzJ4RkR3sCmgQnyLw (button) collected ($16.20)
Seat 3: GX1heJ+DSsvm7gzSPsYhhQ (small blind) folded before Flop
Seat 4: DFQVuszLVclqjA46pN4Vvw (big blind) folded on the River
Seat 5: 37j/5DgMG5m9lMfFofEAOg folded before Flop (didn't bet)
Seat 7: /inIs/z/PcX+TniIFpaxpg folded before Flop (didn't bet)
Seat 8: ZYHoLw2lWmRS7CSHi8L8Xg folded before Flop (didn't bet)
Seat 9: TAfo4veNRaRlzDXMMYS3Jg folded before Flop (didn't bet)



PokerStars Game #59941713616:  Hold'em No Limit ($1/$2) - 2009/07/01 1:43:49 ET
Table 'bJQ024BaYSBrW0sXpCZbNQ' 6-max Seat #6 is the button
Seat 1: KfwW5us6tydK81NYTtK1gw ($201 in chips)
Seat 2: 3dAbvkxS5NPQTBAbvpinVg ($236 in chips)
Seat 3: /PH6Ffnho4Ysm8S3V/oa+w ($49 in chips)
Seat 4: TBaQIN+sQ7eb7P99QnaORQ ($49.80 in chips)
Seat 5: VvdR9F3I+2yELkfTVvC1dg ($200 in chips)
Seat 6: 4bqvCfJ0e8CTYnn0Go9hbQ ($143.20 in chips)
KfwW5us6tydK81NYTtK1gw: posts small blind $1
3dAbvkxS5NPQTBAbvpinVg: posts big blind $2
*** HOLE CARDS ***
/PH6Ffnho4Ysm8S3V/oa+w: folds
TBaQIN+sQ7eb7P99QnaORQ: raises $6 to $8
VvdR9F3I+2yELkfTVvC1dg: folds
4bqvCfJ0e8CTYnn0Go9hbQ: folds
KfwW5us6tydK81NYTtK1gw: folds
3dAbvkxS5NPQTBAbvpinVg: folds
TBaQIN+sQ7eb7P99QnaORQ collected $5 from pot
*** SUMMARY ***
Total pot $5 | Rake $0
Seat 1: KfwW5us6tydK81NYTtK1gw (small blind) folded before Flop
Seat 2: 3dAbvkxS5NPQTBAbvpinVg (big blind) folded before Flop
Seat 3: /PH6Ffnho4Ysm8S3V/oa+w folded before Flop (didn't bet)
Seat 4: TBaQIN+sQ7eb7P99QnaORQ collected ($5)
Seat 5: VvdR9F3I+2yELkfTVvC1dg folded before Flop (didn't bet)
Seat 6: 4bqvCfJ0e8CTYnn0Go9hbQ (button) folded before Flop (didn't bet)



PokerStars Game #59941713438:  Hold'em No Limit ($1/$2) - 2009/07/01 1:43:49 ET
Table 'ztv6V3FN2bQ9nmJPPdx6nQ' 6-max Seat #2 is the button
Seat 1: 6fLdOUCRtX71xbVRhJEq8w ($230.35 in chips)
Seat 2: 5Y+ZGWLI4gnlpApDX5vy1A ($410.15 in chips)
Seat 3: ubtx4Z5L+AcK71MTvYiGVw ($245.20 in chips)
Seat 4: UaZ5yj+6LjtWqMQg2QskUw ($82.30 in chips)
Seat 5: sTPOWERd9HWPCNrDBwsVjA ($220.60 in chips)
Seat 6: mfy7uGZcqA2PVQqEVbJ7+g ($106.60 in chips)
ubtx4Z5L+AcK71MTvYiGVw: posts small blind $1
UaZ5yj+6LjtWqMQg2QskUw: posts big blind $2
*** HOLE CARDS ***
sTPOWERd9HWPCNrDBwsVjA: folds
mfy7uGZcqA2PVQqEVbJ7+g: folds
6fLdOUCRtX71xbVRhJEq8w: folds
5Y+ZGWLI4gnlpApDX5vy1A: raises $2 to $4
ubtx4Z5L+AcK71MTvYiGVw: calls $3
UaZ5yj+6LjtWqMQg2QskUw: calls $2
*** FLOP *** [8c 2h 9h]
ubtx4Z5L+AcK71MTvYiGVw: checks
UaZ5yj+6LjtWqMQg2QskUw: bets $4
5Y+ZGWLI4gnlpApDX5vy1A: raises $8 to $12
ubtx4Z5L+AcK71MTvYiGVw: folds
UaZ5yj+6LjtWqMQg2QskUw: calls $8
*** TURN *** [8c 2h 9h] [3c]
UaZ5yj+6LjtWqMQg2QskUw: bets $6
5Y+ZGWLI4gnlpApDX5vy1A: calls $6
*** RIVER *** [8c 2h 9h 3c] [6h]
UaZ5yj+6LjtWqMQg2QskUw: checks
5Y+ZGWLI4gnlpApDX5vy1A: bets $36
UaZ5yj+6LjtWqMQg2QskUw: folds
5Y+ZGWLI4gnlpApDX5vy1A collected $45.70 from pot
5Y+ZGWLI4gnlpApDX5vy1A: doesn't show hand
*** SUMMARY ***
Total pot $48 | Rake $2.30
Board [8c 2h 9h 3c 6h]
Seat 1: 6fLdOUCRtX71xbVRhJEq8w folded before Flop (didn't bet)
Seat 2: 5Y+ZGWLI4gnlpApDX5vy1A (button) collected ($45.70)
Seat 3: ubtx4Z5L+AcK71MTvYiGVw (small blind) folded on the Flop
Seat 4: UaZ5yj+6LjtWqMQg2QskUw (big blind) folded on the River
Seat 5: sTPOWERd9HWPCNrDBwsVjA folded before Flop (didn't bet)
Seat 6: mfy7uGZcqA2PVQqEVbJ7+g folded before Flop (didn't bet)



PokerStars Game #59941713722:  Hold'em No Limit ($1/$2) - 2009/07/01 1:43:49 ET
Table 'zEOkwFUmNLBlvazOXtwH8w' 2-max Seat #2 is the button
Seat 1: gu6Ee9WAefYH8BG9//A1pw ($64 in chips)
Seat 2: SLKKhEamo9/21wMiSyGsQw ($274.50 in chips)
SLKKhEamo9/21wMiSyGsQw: posts small blind $1
gu6Ee9WAefYH8BG9//A1pw: posts big blind $2
*** HOLE CARDS ***
SLKKhEamo9/21wMiSyGsQw: calls $1
gu6Ee9WAefYH8BG9//A1pw: raises $54 to $56
SLKKhEamo9/21wMiSyGsQw: raises $54 to $110
gu6Ee9WAefYH8BG9//A1pw: folds
SLKKhEamo9/21wMiSyGsQw collected $112 from pot
SLKKhEamo9/21wMiSyGsQw: doesn't show hand
*** SUMMARY ***
Total pot $112 | Rake $0
Seat 1: gu6Ee9WAefYH8BG9//A1pw (big blind) folded before Flop
Seat 2: SLKKhEamo9/21wMiSyGsQw (button) (small blind) collected ($112)



PokerStars Game #59941715106:  Hold'em No Limit ($1/$2) - 2009/07/01 1:43:52 ET
Table 'P/yCfYl1GfGsu/e6DxDy/A' 2-max Seat #1 is the button
Seat 1: 7fOCUy3x9hdkmXkkDNolGQ ($492 in chips)
Seat 2: RwDoM55ZeQuI2ADyJhOb2Q ($983 in chips)
7fOCUy3x9hdkmXkkDNolGQ: posts small blind $1
RwDoM55ZeQuI2ADyJhOb2Q: posts big blind $2
*** HOLE CARDS ***
7fOCUy3x9hdkmXkkDNolGQ: raises $4 to $6
RwDoM55ZeQuI2ADyJhOb2Q: folds
7fOCUy3x9hdkmXkkDNolGQ collected $4 from pot
7fOCUy3x9hdkmXkkDNolGQ: doesn't show hand
*** SUMMARY ***
Total pot $4 | Rake $0
Seat 1: 7fOCUy3x9hdkmXkkDNolGQ (button) (small blind) collected ($4)
Seat 2: RwDoM55ZeQuI2ADyJhOb2Q (big blind) folded before Flop



PokerStars Game #59941715264:  Hold'em No Limit ($1/$2) - 2009/07/01 1:43:52 ET
Table 'UGLAZZyv+cXmnKjYin0etA' 6-max Seat #6 is the button
Seat 1: vkfxu8f/jMYKUk6Ly4eujw ($201 in chips)
Seat 2: eDLH1PUXFpvJBNMXBVQcGA ($304.10 in chips)
Seat 3: ygTTt5ehT4aF86q1a8/R+w ($111.20 in chips)
Seat 4: SiGJDsvRViJX05vHhA80GQ ($231.85 in chips)
Seat 5: 54yWzRRgS0oZ+S6LwZBxMQ ($42.05 in chips)
Seat 6: sTPOWERd9HWPCNrDBwsVjA ($218.15 in chips)
vkfxu8f/jMYKUk6Ly4eujw: posts small blind $1
eDLH1PUXFpvJBNMXBVQcGA: posts big blind $2
*** HOLE CARDS ***
ygTTt5ehT4aF86q1a8/R+w: folds
SiGJDsvRViJX05vHhA80GQ: folds
54yWzRRgS0oZ+S6LwZBxMQ: folds
sTPOWERd9HWPCNrDBwsVjA: folds
vkfxu8f/jMYKUk6Ly4eujw: folds
eDLH1PUXFpvJBNMXBVQcGA collected $2 from pot
*** SUMMARY ***
Total pot $2 | Rake $0
Seat 1: vkfxu8f/jMYKUk6Ly4eujw (small blind) folded before Flop
Seat 2: eDLH1PUXFpvJBNMXBVQcGA (big blind) collected ($2)
Seat 3: ygTTt5ehT4aF86q1a8/R+w folded before Flop (didn't bet)
Seat 4: SiGJDsvRViJX05vHhA80GQ folded before Flop (didn't bet)
Seat 5: 54yWzRRgS0oZ+S6LwZBxMQ folded before Flop (didn't bet)
Seat 6: sTPOWERd9HWPCNrDBwsVjA (button) folded before Flop (didn't bet)



PokerStars Game #59941715662:  Hold'em No Limit ($1/$2) - 2009/07/01 1:43:53 ET
Table 'NmY84NAf9Mh0ckAckHnh5g' 2-max Seat #1 is the button
Seat 1: 6hvg964TSqZ3AL/0XK9aVQ ($634.20 in chips)
Seat 2: RwDoM55ZeQuI2ADyJhOb2Q ($355.50 in chips)
6hvg964TSqZ3AL/0XK9aVQ: posts small blind $1
RwDoM55ZeQuI2ADyJhOb2Q: posts big blind $2
*** HOLE CARDS ***
6hvg964TSqZ3AL/0XK9aVQ: calls $1
RwDoM55ZeQuI2ADyJhOb2Q: checks
*** FLOP *** [Ac 8d 9c]
RwDoM55ZeQuI2ADyJhOb2Q: bets $12
6hvg964TSqZ3AL/0XK9aVQ: calls $12
*** TURN *** [Ac 8d 9c] [9h]
RwDoM55ZeQuI2ADyJhOb2Q: bets $22
6hvg964TSqZ3AL/0XK9aVQ: calls $22
*** RIVER *** [Ac 8d 9c 9h] [8c]
RwDoM55ZeQuI2ADyJhOb2Q: checks
6hvg964TSqZ3AL/0XK9aVQ: checks
*** SHOW DOWN ***
RwDoM55ZeQuI2ADyJhOb2Q: shows [As 2c] (two pair, Aces and Nines)
6hvg964TSqZ3AL/0XK9aVQ: shows [Ah 4s] (two pair, Aces and Nines)
RwDoM55ZeQuI2ADyJhOb2Q collected $35.75 from pot
6hvg964TSqZ3AL/0XK9aVQ collected $35.75 from pot
*** SUMMARY ***
Total pot $72 | Rake $0.50
Board [Ac 8d 9c 9h 8c]
Seat 1: 6hvg964TSqZ3AL/0XK9aVQ (button) (small blind) showed [Ah 4s] and won ($35.75) with two pair, Aces and Nines
Seat 2: RwDoM55ZeQuI2ADyJhOb2Q (big blind) showed [As 2c] and won ($35.75) with two pair, Aces and Nines



PokerStars Game #59941716728:  Hold'em No Limit ($1/$2) - 2009/07/01 1:43:55 ET
Table 'uJ9juaXXg9yIcSU8amxaXQ' 6-max Seat #2 is the button
Seat 1: JsqOjN/eHz0uYVf/PyUJ6Q ($146.25 in chips)
Seat 2: VvdR9F3I+2yELkfTVvC1dg ($200.30 in chips)
Seat 3: qXDd0ZyMIse0OBu8pxeQ3Q ($244.40 in chips)
Seat 4: zNjJ/y4emmF+vzrCDd+ooA ($245.65 in chips)
Seat 5: YsLQ3BAvgQHWXMAv3Wv6Hg ($212.70 in chips)
Seat 6: /PH6Ffnho4Ysm8S3V/oa+w ($40 in chips)
qXDd0ZyMIse0OBu8pxeQ3Q: posts small blind $1
zNjJ/y4emmF+vzrCDd+ooA: posts big blind $2
*** HOLE CARDS ***
YsLQ3BAvgQHWXMAv3Wv6Hg: folds
/PH6Ffnho4Ysm8S3V/oa+w: folds
JsqOjN/eHz0uYVf/PyUJ6Q: folds
VvdR9F3I+2yELkfTVvC1dg: folds
qXDd0ZyMIse0OBu8pxeQ3Q: folds
zNjJ/y4emmF+vzrCDd+ooA collected $2 from pot
*** SUMMARY ***
Total pot $2 | Rake $0
Seat 1: JsqOjN/eHz0uYVf/PyUJ6Q folded before Flop (didn't bet)
Seat 2: VvdR9F3I+2yELkfTVvC1dg (button) folded before Flop (didn't bet)
Seat 3: qXDd0ZyMIse0OBu8pxeQ3Q (small blind) folded before Flop
Seat 4: zNjJ/y4emmF+vzrCDd+ooA (big blind) collected ($2)
Seat 5: YsLQ3BAvgQHWXMAv3Wv6Hg folded before Flop (didn't bet)
Seat 6: /PH6Ffnho4Ysm8S3V/oa+w folded before Flop (didn't bet)



PokerStars Game #59941716428:  Hold'em No Limit ($1/$2) - 2009/07/01 1:43:55 ET
Table 'qVXak+oTeDXMGbWa4sDU5Q' 9-max Seat #8 is the button
Seat 1: H6Z4+qu8gR0VUiPOijndVg ($233.45 in chips)
Seat 2: CST1bO+CmVQOtNgiT0cKPg ($79.75 in chips)
Seat 3: WUlHm+ydPPHG7Lb0rePSdA ($172.10 in chips)
Seat 4: lQYT23h5QCUVZAKxjOO39Q ($180.10 in chips)
Seat 6: GX1heJ+DSsvm7gzSPsYhhQ ($88 in chips)
Seat 7: 6oGEJqk9oDy29sSaLs+LGA ($38.65 in chips)
Seat 8: Z0rzUi0y1x80UdIpofoNbA ($106.55 in chips)
Seat 9: CkE3IyJF1KvdaAOmZY5XqQ ($213.55 in chips)
CkE3IyJF1KvdaAOmZY5XqQ: posts small blind $1
H6Z4+qu8gR0VUiPOijndVg: posts big blind $2
*** HOLE CARDS ***
CST1bO+CmVQOtNgiT0cKPg: folds
WUlHm+ydPPHG7Lb0rePSdA: raises $4 to $6
lQYT23h5QCUVZAKxjOO39Q: folds
GX1heJ+DSsvm7gzSPsYhhQ: folds
6oGEJqk9oDy29sSaLs+LGA: calls $6
Z0rzUi0y1x80UdIpofoNbA: folds
CkE3IyJF1KvdaAOmZY5XqQ: folds
H6Z4+qu8gR0VUiPOijndVg: folds
*** FLOP *** [5h 9h 3c]
WUlHm+ydPPHG7Lb0rePSdA: bets $10
6oGEJqk9oDy29sSaLs+LGA: folds
WUlHm+ydPPHG7Lb0rePSdA collected $14.25 from pot
WUlHm+ydPPHG7Lb0rePSdA: doesn't show hand
*** SUMMARY ***
Total pot $15 | Rake $0.75
Board [5h 9h 3c]
Seat 1: H6Z4+qu8gR0VUiPOijndVg (big blind) folded before Flop
Seat 2: CST1bO+CmVQOtNgiT0cKPg folded before Flop (didn't bet)
Seat 3: WUlHm+ydPPHG7Lb0rePSdA collected ($14.25)
Seat 4: lQYT23h5QCUVZAKxjOO39Q folded before Flop (didn't bet)
Seat 6: GX1heJ+DSsvm7gzSPsYhhQ folded before Flop (didn't bet)
Seat 7: 6oGEJqk9oDy29sSaLs+LGA folded on the Flop
Seat 8: Z0rzUi0y1x80UdIpofoNbA (button) folded before Flop (didn't bet)
Seat 9: CkE3IyJF1KvdaAOmZY5XqQ (small blind) folded before Flop



PokerStars Game #59941717048:  Hold'em No Limit ($1/$2) - 2009/07/01 1:43:56 ET
Table '/ci73fTmzTzmGWzAtqEX2Q' 9-max Seat #9 is the button
Seat 1: 9efVc1cB3yHt4TvBkTusPw ($111.90 in chips)
Seat 2: pN/Ip0ePsUVIdUlGgLrkUw ($225 in chips)
Seat 4: 2yq7Zp4xmrhAw8+37hTkaA ($161.20 in chips)
Seat 5: 1CtiZuXDFaJL1dJPQKyi8Q ($191.75 in chips)
Seat 6: KqHysDSpCPaPyK3tJC1aEw ($200 in chips)
Seat 7: +T/63sAeZzWyHchahJ36GQ ($72 in chips)
Seat 8: /inIs/z/PcX+TniIFpaxpg ($35.75 in chips)
Seat 9: S8aS+9FTYQ/ICLBNThcrkg ($174 in chips)
9efVc1cB3yHt4TvBkTusPw: posts small blind $1
pN/Ip0ePsUVIdUlGgLrkUw: posts big blind $2
254YPxPJr5Sw58bkD0YqYQ: sits out
*** HOLE CARDS ***
2yq7Zp4xmrhAw8+37hTkaA: raises $4 to $6
1CtiZuXDFaJL1dJPQKyi8Q: folds
KqHysDSpCPaPyK3tJC1aEw: folds
+T/63sAeZzWyHchahJ36GQ: folds
/inIs/z/PcX+TniIFpaxpg: folds
S8aS+9FTYQ/ICLBNThcrkg: folds
9efVc1cB3yHt4TvBkTusPw: raises $8 to $14
pN/Ip0ePsUVIdUlGgLrkUw: folds
2yq7Zp4xmrhAw8+37hTkaA: calls $8
*** FLOP *** [3s 3c 2h]
9efVc1cB3yHt4TvBkTusPw: bets $10
2yq7Zp4xmrhAw8+37hTkaA: calls $10
*** TURN *** [3s 3c 2h] [Ks]
9efVc1cB3yHt4TvBkTusPw: bets $16
2yq7Zp4xmrhAw8+37hTkaA: folds
9efVc1cB3yHt4TvBkTusPw collected $47.60 from pot
*** SUMMARY ***
Total pot $50 | Rake $2.40
Board [3s 3c 2h Ks]
Seat 1: 9efVc1cB3yHt4TvBkTusPw (small blind) collected ($47.60)
Seat 2: pN/Ip0ePsUVIdUlGgLrkUw (big blind) folded before Flop
Seat 4: 2yq7Zp4xmrhAw8+37hTkaA folded on the Turn
Seat 5: 1CtiZuXDFaJL1dJPQKyi8Q folded before Flop (didn't bet)
Seat 6: KqHysDSpCPaPyK3tJC1aEw folded before Flop (didn't bet)
Seat 7: +T/63sAeZzWyHchahJ36GQ folded before Flop (didn't bet)
Seat 8: /inIs/z/PcX+TniIFpaxpg folded before Flop (didn't bet)
Seat 9: S8aS+9FTYQ/ICLBNThcrkg (button) folded before Flop (didn't bet)



PokerStars Game #59941719250:  Hold'em No Limit ($1/$2) - 2009/07/01 1:44:00 ET
Table 'P/yCfYl1GfGsu/e6DxDy/A' 2-max Seat #2 is the button
Seat 1: 7fOCUy3x9hdkmXkkDNolGQ ($494 in chips)
Seat 2: RwDoM55ZeQuI2ADyJhOb2Q ($981 in chips)
RwDoM55ZeQuI2ADyJhOb2Q: posts small blind $1
7fOCUy3x9hdkmXkkDNolGQ: posts big blind $2
*** HOLE CARDS ***
RwDoM55ZeQuI2ADyJhOb2Q: raises $4 to $6
7fOCUy3x9hdkmXkkDNolGQ: raises $16 to $22
RwDoM55ZeQuI2ADyJhOb2Q: calls $16
*** FLOP *** [5h 3h Ts]
7fOCUy3x9hdkmXkkDNolGQ: bets $39
RwDoM55ZeQuI2ADyJhOb2Q: calls $39
*** TURN *** [5h 3h Ts] [8s]
7fOCUy3x9hdkmXkkDNolGQ: bets $109
RwDoM55ZeQuI2ADyJhOb2Q: calls $109
*** RIVER *** [5h 3h Ts 8s] [Kc]
7fOCUy3x9hdkmXkkDNolGQ: bets $228
RwDoM55ZeQuI2ADyJhOb2Q: folds
7fOCUy3x9hdkmXkkDNolGQ collected $339.50 from pot
7fOCUy3x9hdkmXkkDNolGQ: doesn't show hand
*** SUMMARY ***
Total pot $340 | Rake $0.50
Board [5h 3h Ts 8s Kc]
Seat 1: 7fOCUy3x9hdkmXkkDNolGQ (big blind) collected ($339.50)
Seat 2: RwDoM55ZeQuI2ADyJhOb2Q (button) (small blind) folded on the River



PokerStars Game #59941720150:  Hold'em No Limit ($1/$2) - 2009/07/01 1:44:01 ET
Table '4NGNnZ/osQfNq6abYqkJeA' 6-max Seat #5 is the button
Seat 1: xUTLK/SDwl6IxZdaKduuFg ($70.60 in chips)
Seat 2: 669iGNwYwgRZg3nhS+aDAQ ($141.25 in chips)
Seat 3: 54yWzRRgS0oZ+S6LwZBxMQ ($37 in chips)
Seat 4: sY+4Uuh5z/6AbXXaCS10jw ($227.25 in chips)
Seat 5: VvdR9F3I+2yELkfTVvC1dg ($228.55 in chips)
Seat 6: /PH6Ffnho4Ysm8S3V/oa+w ($40 in chips)
/PH6Ffnho4Ysm8S3V/oa+w: posts small blind $1
xUTLK/SDwl6IxZdaKduuFg: posts big blind $2
*** HOLE CARDS ***
669iGNwYwgRZg3nhS+aDAQ: raises $4 to $6
54yWzRRgS0oZ+S6LwZBxMQ: folds
sY+4Uuh5z/6AbXXaCS10jw: calls $6
VvdR9F3I+2yELkfTVvC1dg: folds
/PH6Ffnho4Ysm8S3V/oa+w: folds
xUTLK/SDwl6IxZdaKduuFg: folds
*** FLOP *** [8d 7d Ts]
669iGNwYwgRZg3nhS+aDAQ: bets $4
sY+4Uuh5z/6AbXXaCS10jw: raises $12 to $16
669iGNwYwgRZg3nhS+aDAQ: folds
sY+4Uuh5z/6AbXXaCS10jw collected $21.90 from pot
*** SUMMARY ***
Total pot $23 | Rake $1.10
Board [8d 7d Ts]
Seat 1: xUTLK/SDwl6IxZdaKduuFg (big blind) folded before Flop
Seat 2: 669iGNwYwgRZg3nhS+aDAQ folded on the Flop
Seat 3: 54yWzRRgS0oZ+S6LwZBxMQ folded before Flop (didn't bet)
Seat 4: sY+4Uuh5z/6AbXXaCS10jw collected ($21.90)
Seat 5: VvdR9F3I+2yELkfTVvC1dg (button) folded before Flop (didn't bet)
Seat 6: /PH6Ffnho4Ysm8S3V/oa+w (small blind) folded before Flop



PokerStars Game #59941720360:  Hold'em No Limit ($1/$2) - 2009/07/01 1:44:02 ET
Table 'jlrIxbrVIG+gjaUYT4za8g' 6-max Seat #1 is the button
Seat 1: ygTTt5ehT4aF86q1a8/R+w ($235.30 in chips)
Seat 3: gnYme0DNFflnMhrdbxe1Ag ($201 in chips)
Seat 4: 8srN1dKQePlsv0GyTada+Q ($263.95 in chips)
Seat 5: AyBB0k3Dcl7xbXUeGMw06g ($43.15 in chips)
Seat 6: BWhgxe7gWiYobRbwdG+d2Q ($196 in chips)
cwfuMyvDC7J7SqX2leDC8g will be allowed to play after the button
gnYme0DNFflnMhrdbxe1Ag: posts small blind $1
8srN1dKQePlsv0GyTada+Q: posts big blind $2
*** HOLE CARDS ***
AyBB0k3Dcl7xbXUeGMw06g: calls $2
BWhgxe7gWiYobRbwdG+d2Q: folds
ygTTt5ehT4aF86q1a8/R+w: folds
gnYme0DNFflnMhrdbxe1Ag: folds
8srN1dKQePlsv0GyTada+Q: checks
*** FLOP *** [8d 5c 2h]
8srN1dKQePlsv0GyTada+Q: checks
AyBB0k3Dcl7xbXUeGMw06g: checks
*** TURN *** [8d 5c 2h] [5s]
8srN1dKQePlsv0GyTada+Q: bets $2
AyBB0k3Dcl7xbXUeGMw06g: folds
8srN1dKQePlsv0GyTada+Q collected $4.75 from pot
*** SUMMARY ***
Total pot $5 | Rake $0.25
Board [8d 5c 2h 5s]
Seat 1: ygTTt5ehT4aF86q1a8/R+w (button) folded before Flop (didn't bet)
Seat 3: gnYme0DNFflnMhrdbxe1Ag (small blind) folded before Flop
Seat 4: 8srN1dKQePlsv0GyTada+Q (big blind) collected ($4.75)
Seat 5: AyBB0k3Dcl7xbXUeGMw06g folded on the Turn
Seat 6: BWhgxe7gWiYobRbwdG+d2Q folded before Flop (didn't bet)



PokerStars Game #59941721522:  Hold'em No Limit ($1/$2) - 2009/07/01 1:44:04 ET
Table '/dyk+YdRGv90j2box35j8w' 6-max Seat #5 is the button
Seat 1: 8srN1dKQePlsv0GyTada+Q ($200 in chips)
Seat 2: qCnEYuAE5y5A7bk6fO5/jQ ($502.20 in chips)
Seat 3: sTPOWERd9HWPCNrDBwsVjA ($206.50 in chips)
Seat 5: VvdR9F3I+2yELkfTVvC1dg ($251.55 in chips)
Seat 6: gnYme0DNFflnMhrdbxe1Ag ($200 in chips)
gnYme0DNFflnMhrdbxe1Ag: posts small blind $1
8srN1dKQePlsv0GyTada+Q: posts big blind $2
*** HOLE CARDS ***
qCnEYuAE5y5A7bk6fO5/jQ: raises $4 to $6
sTPOWERd9HWPCNrDBwsVjA: folds
VvdR9F3I+2yELkfTVvC1dg: calls $6
gnYme0DNFflnMhrdbxe1Ag: folds
8srN1dKQePlsv0GyTada+Q: folds
*** FLOP *** [2d 4c 6d]
qCnEYuAE5y5A7bk6fO5/jQ: checks
VvdR9F3I+2yELkfTVvC1dg: bets $10.65
qCnEYuAE5y5A7bk6fO5/jQ: folds
VvdR9F3I+2yELkfTVvC1dg collected $14.25 from pot
VvdR9F3I+2yELkfTVvC1dg: doesn't show hand
*** SUMMARY ***
Total pot $15 | Rake $0.75
Board [2d 4c 6d]
Seat 1: 8srN1dKQePlsv0GyTada+Q (big blind) folded before Flop
Seat 2: qCnEYuAE5y5A7bk6fO5/jQ folded on the Flop
Seat 3: sTPOWERd9HWPCNrDBwsVjA folded before Flop (didn't bet)
Seat 5: VvdR9F3I+2yELkfTVvC1dg (button) collected ($14.25)
Seat 6: gnYme0DNFflnMhrdbxe1Ag (small blind) folded before Flop



PokerStars Game #59941722132:  Hold'em No Limit ($1/$2) - 2009/07/01 1:44:05 ET
Table 'ZzSIe0zTCDv+n6hfbY5tTg' 6-max Seat #5 is the button
Seat 1: VvdR9F3I+2yELkfTVvC1dg ($254 in chips)
Seat 2: B87ikIyZ/TzAVeXf38Ny0g ($237 in chips)
Seat 3: gsugPj31Hui3Jefl98MBOA ($349 in chips)
Seat 4: 54yWzRRgS0oZ+S6LwZBxMQ ($39.75 in chips)
Seat 5: 3dAbvkxS5NPQTBAbvpinVg ($506.45 in chips)
Seat 6: 09BNF4quPDzanQzM8vc6WA ($37 in chips)
09BNF4quPDzanQzM8vc6WA: posts small blind $1
VvdR9F3I+2yELkfTVvC1dg: posts big blind $2
*** HOLE CARDS ***
B87ikIyZ/TzAVeXf38Ny0g: folds
gsugPj31Hui3Jefl98MBOA: folds
54yWzRRgS0oZ+S6LwZBxMQ: folds
3dAbvkxS5NPQTBAbvpinVg: raises $4 to $6
09BNF4quPDzanQzM8vc6WA: folds
VvdR9F3I+2yELkfTVvC1dg: folds
3dAbvkxS5NPQTBAbvpinVg collected $5 from pot
3dAbvkxS5NPQTBAbvpinVg: doesn't show hand
*** SUMMARY ***
Total pot $5 | Rake $0
Seat 1: VvdR9F3I+2yELkfTVvC1dg (big blind) folded before Flop
Seat 2: B87ikIyZ/TzAVeXf38Ny0g folded before Flop (didn't bet)
Seat 3: gsugPj31Hui3Jefl98MBOA folded before Flop (didn't bet)
Seat 4: 54yWzRRgS0oZ+S6LwZBxMQ folded before Flop (didn't bet)
Seat 5: 3dAbvkxS5NPQTBAbvpinVg (button) collected ($5)
Seat 6: 09BNF4quPDzanQzM8vc6WA (small blind) folded before Flop



PokerStars Game #59941722906:  Hold'em No Limit ($1/$2) - 2009/07/01 1:44:06 ET
Table 'mGpP9StWRnoeiBDExc6Frg' 6-max Seat #4 is the button
Seat 1: VvdR9F3I+2yELkfTVvC1dg ($309.15 in chips)
Seat 2: vkfxu8f/jMYKUk6Ly4eujw ($201 in chips)
Seat 4: 4dcDwIHRm96PwtqkpQiuiA ($62.70 in chips)
Seat 5: d1puGuVBE0fidn+5eRJ0tw ($202.35 in chips)
Seat 6: B2Ih1sr5VZk+8He7rcrMtQ ($425.65 in chips)
d1puGuVBE0fidn+5eRJ0tw: posts small blind $1
B2Ih1sr5VZk+8He7rcrMtQ: posts big blind $2
*** HOLE CARDS ***
VvdR9F3I+2yELkfTVvC1dg: folds
vkfxu8f/jMYKUk6Ly4eujw: folds
4dcDwIHRm96PwtqkpQiuiA: folds
d1puGuVBE0fidn+5eRJ0tw: calls $1
B2Ih1sr5VZk+8He7rcrMtQ: checks
*** FLOP *** [5d 9d Ks]
d1puGuVBE0fidn+5eRJ0tw: checks
B2Ih1sr5VZk+8He7rcrMtQ: bets $4
d1puGuVBE0fidn+5eRJ0tw: folds
B2Ih1sr5VZk+8He7rcrMtQ collected $3.80 from pot
*** SUMMARY ***
Total pot $4 | Rake $0.20
Board [5d 9d Ks]
Seat 1: VvdR9F3I+2yELkfTVvC1dg folded before Flop (didn't bet)
Seat 2: vkfxu8f/jMYKUk6Ly4eujw folded before Flop (didn't bet)
Seat 4: 4dcDwIHRm96PwtqkpQiuiA (button) folded before Flop (didn't bet)
Seat 5: d1puGuVBE0fidn+5eRJ0tw (small blind) folded on the Flop
Seat 6: B2Ih1sr5VZk+8He7rcrMtQ (big blind) collected ($3.80)



PokerStars Game #59941724188:  Hold'em No Limit ($1/$2) - 2009/07/01 1:44:09 ET
Table 'bJQ024BaYSBrW0sXpCZbNQ' 6-max Seat #1 is the button
Seat 1: KfwW5us6tydK81NYTtK1gw ($200 in chips)
Seat 2: 3dAbvkxS5NPQTBAbvpinVg ($234 in chips)
Seat 3: /PH6Ffnho4Ysm8S3V/oa+w ($49 in chips)
Seat 4: TBaQIN+sQ7eb7P99QnaORQ ($52.80 in chips)
Seat 5: VvdR9F3I+2yELkfTVvC1dg ($200 in chips)
Seat 6: 4bqvCfJ0e8CTYnn0Go9hbQ ($143.20 in chips)
3dAbvkxS5NPQTBAbvpinVg: posts small blind $1
/PH6Ffnho4Ysm8S3V/oa+w: posts big blind $2
*** HOLE CARDS ***
TBaQIN+sQ7eb7P99QnaORQ: folds
VvdR9F3I+2yELkfTVvC1dg: folds
4bqvCfJ0e8CTYnn0Go9hbQ: folds
KfwW5us6tydK81NYTtK1gw: folds
3dAbvkxS5NPQTBAbvpinVg: raises $4 to $6
/PH6Ffnho4Ysm8S3V/oa+w: raises $9 to $15
3dAbvkxS5NPQTBAbvpinVg: raises $219 to $234 and is all-in
/PH6Ffnho4Ysm8S3V/oa+w: calls $34 and is all-in
*** FLOP *** [9h 8s 3s]
*** TURN *** [9h 8s 3s] [Kh]
*** RIVER *** [9h 8s 3s Kh] [5s]
*** SHOW DOWN ***
3dAbvkxS5NPQTBAbvpinVg: shows [8c 8d] (three of a kind, Eights)
/PH6Ffnho4Ysm8S3V/oa+w: mucks hand
3dAbvkxS5NPQTBAbvpinVg collected $95 from pot
*** SUMMARY ***
Total pot $98 | Rake $3
Board [9h 8s 3s Kh 5s]
Seat 1: KfwW5us6tydK81NYTtK1gw (button) folded before Flop (didn't bet)
Seat 2: 3dAbvkxS5NPQTBAbvpinVg (small blind) showed [8c 8d] and won ($95) with three of a kind, Eights
Seat 3: /PH6Ffnho4Ysm8S3V/oa+w (big blind) mucked
Seat 4: TBaQIN+sQ7eb7P99QnaORQ folded before Flop (didn't bet)
Seat 5: VvdR9F3I+2yELkfTVvC1dg folded before Flop (didn't bet)
Seat 6: 4bqvCfJ0e8CTYnn0Go9hbQ folded before Flop (didn't bet)



PokerStars Game #59941724792:  Hold'em No Limit ($1/$2) - 2009/07/01 1:44:10 ET
Table 'gnHBqWll9O3fxG7Ojkz/ng' 9-max Seat #3 is the button
Seat 1: TAfo4veNRaRlzDXMMYS3Jg ($36 in chips)
Seat 2: H6Z4+qu8gR0VUiPOijndVg ($320.95 in chips)
Seat 3: 5Q8U6iZbeO7xJSS4qvDP5g ($228.05 in chips)
Seat 4: nXDI8Y/S6POzRwANu3d8hQ ($17 in chips)
Seat 5: rBQDMkKm9cZn6M9NPsiVew ($220.15 in chips)
Seat 6: KqHysDSpCPaPyK3tJC1aEw ($200 in chips)
Seat 7: jqui3xAWCkcdPW36a6BD+w ($342.55 in chips)
Seat 8: cM6efHzdxoqYm0EQKP4TTQ ($114.95 in chips)
Seat 9: GX1heJ+DSsvm7gzSPsYhhQ ($45.35 in chips)
nXDI8Y/S6POzRwANu3d8hQ: posts small blind $1
rBQDMkKm9cZn6M9NPsiVew: posts big blind $2
*** HOLE CARDS ***
KqHysDSpCPaPyK3tJC1aEw: folds
jqui3xAWCkcdPW36a6BD+w: folds
cM6efHzdxoqYm0EQKP4TTQ: folds
GX1heJ+DSsvm7gzSPsYhhQ: folds
TAfo4veNRaRlzDXMMYS3Jg: folds
H6Z4+qu8gR0VUiPOijndVg: raises $4 to $6
5Q8U6iZbeO7xJSS4qvDP5g: folds
nXDI8Y/S6POzRwANu3d8hQ: folds
rBQDMkKm9cZn6M9NPsiVew: calls $4
*** FLOP *** [Jd 3d Qh]
rBQDMkKm9cZn6M9NPsiVew: checks
H6Z4+qu8gR0VUiPOijndVg: bets $8
rBQDMkKm9cZn6M9NPsiVew: folds
H6Z4+qu8gR0VUiPOijndVg collected $12.35 from pot
H6Z4+qu8gR0VUiPOijndVg: doesn't show hand
*** SUMMARY ***
Total pot $13 | Rake $0.65
Board [Jd 3d Qh]
Seat 1: TAfo4veNRaRlzDXMMYS3Jg folded before Flop (didn't bet)
Seat 2: H6Z4+qu8gR0VUiPOijndVg collected ($12.35)
Seat 3: 5Q8U6iZbeO7xJSS4qvDP5g (button) folded before Flop (didn't bet)
Seat 4: nXDI8Y/S6POzRwANu3d8hQ (small blind) folded before Flop
Seat 5: rBQDMkKm9cZn6M9NPsiVew (big blind) folded on the Flop
Seat 6: KqHysDSpCPaPyK3tJC1aEw folded before Flop (didn't bet)
Seat 7: jqui3xAWCkcdPW36a6BD+w folded before Flop (didn't bet)
Seat 8: cM6efHzdxoqYm0EQKP4TTQ folded before Flop (didn't bet)
Seat 9: GX1heJ+DSsvm7gzSPsYhhQ folded before Flop (didn't bet)



PokerStars Game #59941725272:  Hold'em No Limit ($1/$2) - 2009/07/01 1:44:11 ET
Table 'uJ9juaXXg9yIcSU8amxaXQ' 6-max Seat #3 is the button
Seat 1: JsqOjN/eHz0uYVf/PyUJ6Q ($146.25 in chips)
Seat 2: VvdR9F3I+2yELkfTVvC1dg ($200.30 in chips)
Seat 3: qXDd0ZyMIse0OBu8pxeQ3Q ($243.40 in chips)
Seat 4: zNjJ/y4emmF+vzrCDd+ooA ($246.65 in chips)
Seat 5: YsLQ3BAvgQHWXMAv3Wv6Hg ($212.70 in chips)
Seat 6: /PH6Ffnho4Ysm8S3V/oa+w ($40 in chips)
zNjJ/y4emmF+vzrCDd+ooA: posts small blind $1
YsLQ3BAvgQHWXMAv3Wv6Hg: posts big blind $2
*** HOLE CARDS ***
/PH6Ffnho4Ysm8S3V/oa+w: raises $2 to $4
JsqOjN/eHz0uYVf/PyUJ6Q: folds
VvdR9F3I+2yELkfTVvC1dg: folds
qXDd0ZyMIse0OBu8pxeQ3Q: folds
zNjJ/y4emmF+vzrCDd+ooA: calls $3
YsLQ3BAvgQHWXMAv3Wv6Hg: folds
*** FLOP *** [8d Td 9s]
zNjJ/y4emmF+vzrCDd+ooA: bets $2
/PH6Ffnho4Ysm8S3V/oa+w: calls $2
*** TURN *** [8d Td 9s] [6s]
zNjJ/y4emmF+vzrCDd+ooA: bets $2
/PH6Ffnho4Ysm8S3V/oa+w: calls $2
*** RIVER *** [8d Td 9s 6s] [6h]
zNjJ/y4emmF+vzrCDd+ooA: bets $8
/PH6Ffnho4Ysm8S3V/oa+w: folds
zNjJ/y4emmF+vzrCDd+ooA collected $17.15 from pot
*** SUMMARY ***
Total pot $18 | Rake $0.85
Board [8d Td 9s 6s 6h]
Seat 1: JsqOjN/eHz0uYVf/PyUJ6Q folded before Flop (didn't bet)
Seat 2: VvdR9F3I+2yELkfTVvC1dg folded before Flop (didn't bet)
Seat 3: qXDd0ZyMIse0OBu8pxeQ3Q (button) folded before Flop (didn't bet)
Seat 4: zNjJ/y4emmF+vzrCDd+ooA (small blind) collected ($17.15)
Seat 5: YsLQ3BAvgQHWXMAv3Wv6Hg (big blind) folded before Flop
Seat 6: /PH6Ffnho4Ysm8S3V/oa+w folded on the River



PokerStars Game #59941726360:  Hold'em No Limit ($1/$2) - 2009/07/01 1:44:13 ET
Table '3WCXyaiCAbqSShQu7FIjvA' 9-max Seat #5 is the button
Seat 1: kTCkABD1UUldS9DFRGfCwQ ($150.75 in chips)
Seat 2: TAfo4veNRaRlzDXMMYS3Jg ($39.70 in chips)
Seat 3: 5Q8U6iZbeO7xJSS4qvDP5g ($270.25 in chips)
Seat 4: waEF/+pxZTxNo4FvsORuXg ($103.40 in chips)
Seat 5: CkE3IyJF1KvdaAOmZY5XqQ ($210.90 in chips)
Seat 6: 5jQlngvMSqM/WoonOcR5kw ($286.80 in chips)
Seat 7: nXDI8Y/S6POzRwANu3d8hQ ($37 in chips)
Seat 8: 1CtiZuXDFaJL1dJPQKyi8Q ($216.10 in chips)
Seat 9: FiXPLJyqb24l32QST2TInw ($99.40 in chips)
5jQlngvMSqM/WoonOcR5kw: posts small blind $1
nXDI8Y/S6POzRwANu3d8hQ: posts big blind $2
*** HOLE CARDS ***
1CtiZuXDFaJL1dJPQKyi8Q: folds
FiXPLJyqb24l32QST2TInw: calls $2
kTCkABD1UUldS9DFRGfCwQ: folds
TAfo4veNRaRlzDXMMYS3Jg: folds
5Q8U6iZbeO7xJSS4qvDP5g: folds
waEF/+pxZTxNo4FvsORuXg: folds
1CtiZuXDFaJL1dJPQKyi8Q leaves the table
CkE3IyJF1KvdaAOmZY5XqQ: folds
5jQlngvMSqM/WoonOcR5kw: calls $1
nXDI8Y/S6POzRwANu3d8hQ: checks
*** FLOP *** [Ad Js 6d]
+T/63sAeZzWyHchahJ36GQ joins the table at seat #8
5jQlngvMSqM/WoonOcR5kw: checks
nXDI8Y/S6POzRwANu3d8hQ: checks
FiXPLJyqb24l32QST2TInw: bets $4
5jQlngvMSqM/WoonOcR5kw: folds
nXDI8Y/S6POzRwANu3d8hQ: folds
FiXPLJyqb24l32QST2TInw collected $5.70 from pot
FiXPLJyqb24l32QST2TInw: doesn't show hand
*** SUMMARY ***
Total pot $6 | Rake $0.30
Board [Ad Js 6d]
Seat 1: kTCkABD1UUldS9DFRGfCwQ folded before Flop (didn't bet)
Seat 2: TAfo4veNRaRlzDXMMYS3Jg folded before Flop (didn't bet)
Seat 3: 5Q8U6iZbeO7xJSS4qvDP5g folded before Flop (didn't bet)
Seat 4: waEF/+pxZTxNo4FvsORuXg folded before Flop (didn't bet)
Seat 5: CkE3IyJF1KvdaAOmZY5XqQ (button) folded before Flop (didn't bet)
Seat 6: 5jQlngvMSqM/WoonOcR5kw (small blind) folded on the Flop
Seat 7: nXDI8Y/S6POzRwANu3d8hQ (big blind) folded on the Flop
Seat 8: 1CtiZuXDFaJL1dJPQKyi8Q folded before Flop (didn't bet)
Seat 9: FiXPLJyqb24l32QST2TInw collected ($5.70)



PokerStars Game #59941727084:  Hold'em No Limit ($1/$2) - 2009/07/01 1:44:14 ET
Table 'aSf77Sj8QEnzcc0WaxVD4Q' 6-max Seat #4 is the button
Seat 1: UELtvp+JfwI7XDGVwSxZXA ($239.10 in chips)
Seat 2: vkfxu8f/jMYKUk6Ly4eujw ($214.20 in chips)
Seat 3: 9dpyyjDTCed6nV7JhaUUpw ($740.75 in chips)
Seat 4: YsLQ3BAvgQHWXMAv3Wv6Hg ($200 in chips)
Seat 5: VvdR9F3I+2yELkfTVvC1dg ($255.45 in chips)
Seat 6: vkoJRf3gidxY1pPi0AFWww ($144.75 in chips)
VvdR9F3I+2yELkfTVvC1dg: posts small blind $1
vkoJRf3gidxY1pPi0AFWww: posts big blind $2
*** HOLE CARDS ***
UELtvp+JfwI7XDGVwSxZXA: calls $2
vkfxu8f/jMYKUk6Ly4eujw: folds
9dpyyjDTCed6nV7JhaUUpw: folds
YsLQ3BAvgQHWXMAv3Wv6Hg: folds
VvdR9F3I+2yELkfTVvC1dg: calls $1
vkoJRf3gidxY1pPi0AFWww: checks
*** FLOP *** [5c 8h 7s]
VvdR9F3I+2yELkfTVvC1dg: checks
vkoJRf3gidxY1pPi0AFWww: checks
UELtvp+JfwI7XDGVwSxZXA: checks
*** TURN *** [5c 8h 7s] [Kd]
VvdR9F3I+2yELkfTVvC1dg: bets $4.15
vkoJRf3gidxY1pPi0AFWww: folds
UELtvp+JfwI7XDGVwSxZXA: calls $4.15
*** RIVER *** [5c 8h 7s Kd] [Ts]
VvdR9F3I+2yELkfTVvC1dg: bets $9.65
UELtvp+JfwI7XDGVwSxZXA: folds
VvdR9F3I+2yELkfTVvC1dg collected $13.60 from pot
VvdR9F3I+2yELkfTVvC1dg: doesn't show hand
*** SUMMARY ***
Total pot $14.30 | Rake $0.70
Board [5c 8h 7s Kd Ts]
Seat 1: UELtvp+JfwI7XDGVwSxZXA folded on the River
Seat 2: vkfxu8f/jMYKUk6Ly4eujw folded before Flop (didn't bet)
Seat 3: 9dpyyjDTCed6nV7JhaUUpw folded before Flop (didn't bet)
Seat 4: YsLQ3BAvgQHWXMAv3Wv6Hg (button) folded before Flop (didn't bet)
Seat 5: VvdR9F3I+2yELkfTVvC1dg (small blind) collected ($13.60)
Seat 6: vkoJRf3gidxY1pPi0AFWww (big blind) folded on the Turn



PokerStars Game #59941726884:  Hold'em No Limit ($1/$2) - 2009/07/01 1:44:14 ET
Table '5/wEe6JmtGD7vufSA2RG7A' 2-max Seat #1 is the button
Seat 1: pVqEzK9wXlRMECnb1Zg4Zw ($122.30 in chips)
Seat 2: aOL8geThaYp2iadSHl1h1g ($118.50 in chips)
pVqEzK9wXlRMECnb1Zg4Zw: posts small blind $1
aOL8geThaYp2iadSHl1h1g: posts big blind $2
*** HOLE CARDS ***
pVqEzK9wXlRMECnb1Zg4Zw: raises $6 to $8
aOL8geThaYp2iadSHl1h1g: folds
pVqEzK9wXlRMECnb1Zg4Zw collected $4 from pot
pVqEzK9wXlRMECnb1Zg4Zw: doesn't show hand
*** SUMMARY ***
Total pot $4 | Rake $0
Seat 1: pVqEzK9wXlRMECnb1Zg4Zw (button) (small blind) collected ($4)
Seat 2: aOL8geThaYp2iadSHl1h1g (big blind) folded before Flop



PokerStars Game #59941728248:  Hold'em No Limit ($1/$2) - 2009/07/01 1:44:16 ET
Table 'NmY84NAf9Mh0ckAckHnh5g' 2-max Seat #2 is the button
Seat 1: 6hvg964TSqZ3AL/0XK9aVQ ($633.95 in chips)
Seat 2: RwDoM55ZeQuI2ADyJhOb2Q ($355.25 in chips)
RwDoM55ZeQuI2ADyJhOb2Q: posts small blind $1
6hvg964TSqZ3AL/0XK9aVQ: posts big blind $2
*** HOLE CARDS ***
RwDoM55ZeQuI2ADyJhOb2Q: raises $8 to $10
6hvg964TSqZ3AL/0XK9aVQ: calls $8
*** FLOP *** [7c Qh 3s]
6hvg964TSqZ3AL/0XK9aVQ: checks
RwDoM55ZeQuI2ADyJhOb2Q: checks
*** TURN *** [7c Qh 3s] [Jh]
6hvg964TSqZ3AL/0XK9aVQ: checks
RwDoM55ZeQuI2ADyJhOb2Q: checks
*** RIVER *** [7c Qh 3s Jh] [6s]
6hvg964TSqZ3AL/0XK9aVQ: bets $26
RwDoM55ZeQuI2ADyJhOb2Q: calls $26
*** SHOW DOWN ***
6hvg964TSqZ3AL/0XK9aVQ: shows [7s Js] (two pair, Jacks and Sevens)
RwDoM55ZeQuI2ADyJhOb2Q: mucks hand
6hvg964TSqZ3AL/0XK9aVQ collected $71.50 from pot
*** SUMMARY ***
Total pot $72 | Rake $0.50
Board [7c Qh 3s Jh 6s]
Seat 1: 6hvg964TSqZ3AL/0XK9aVQ (big blind) showed [7s Js] and won ($71.50) with two pair, Jacks and Sevens
Seat 2: RwDoM55ZeQuI2ADyJhOb2Q (button) (small blind) mucked



PokerStars Game #59941730082:  Hold'em No Limit ($1/$2) - 2009/07/01 1:44:20 ET
Table 'kq5zaQ+1hLNf8LZfGnbTAA' 6-max Seat #4 is the button
Seat 1: 8srN1dKQePlsv0GyTada+Q ($422.60 in chips)
Seat 2: nXDI8Y/S6POzRwANu3d8hQ ($140 in chips)
Seat 3: /PH6Ffnho4Ysm8S3V/oa+w ($49.15 in chips)
Seat 4: 3dAbvkxS5NPQTBAbvpinVg ($287.65 in chips)
Seat 5: gnYme0DNFflnMhrdbxe1Ag ($220.35 in chips)
Seat 6: mfy7uGZcqA2PVQqEVbJ7+g ($191.15 in chips)
gnYme0DNFflnMhrdbxe1Ag: posts small blind $1
mfy7uGZcqA2PVQqEVbJ7+g: posts big blind $2
*** HOLE CARDS ***
8srN1dKQePlsv0GyTada+Q: folds
nXDI8Y/S6POzRwANu3d8hQ: folds
/PH6Ffnho4Ysm8S3V/oa+w: folds
3dAbvkxS5NPQTBAbvpinVg: raises $4 to $6
gnYme0DNFflnMhrdbxe1Ag: folds
mfy7uGZcqA2PVQqEVbJ7+g: folds
3dAbvkxS5NPQTBAbvpinVg collected $5 from pot
3dAbvkxS5NPQTBAbvpinVg: doesn't show hand
*** SUMMARY ***
Total pot $5 | Rake $0
Seat 1: 8srN1dKQePlsv0GyTada+Q folded before Flop (didn't bet)
Seat 2: nXDI8Y/S6POzRwANu3d8hQ folded before Flop (didn't bet)
Seat 3: /PH6Ffnho4Ysm8S3V/oa+w folded before Flop (didn't bet)
Seat 4: 3dAbvkxS5NPQTBAbvpinVg (button) collected ($5)
Seat 5: gnYme0DNFflnMhrdbxe1Ag (small blind) folded before Flop
Seat 6: mfy7uGZcqA2PVQqEVbJ7+g (big blind) folded before Flop



PokerStars Game #59941731046:  Hold'em No Limit ($1/$2) - 2009/07/01 1:44:22 ET
Table 'TsEDkiO4tzCTCzJ7tNdEqw' 6-max Seat #2 is the button
Seat 1: vkfxu8f/jMYKUk6Ly4eujw ($197 in chips)
Seat 2: 4dcDwIHRm96PwtqkpQiuiA ($82.65 in chips)
Seat 3: ubtx4Z5L+AcK71MTvYiGVw ($268.85 in chips)
Seat 4: K8MXCrNAVYlMnnCeM32Kxw ($120 in chips)
Seat 5: VvdR9F3I+2yELkfTVvC1dg ($249.35 in chips)
Seat 6: uCqEjnxh2/vFBjKYkfTOkw ($289.80 in chips)
ubtx4Z5L+AcK71MTvYiGVw: posts small blind $1
K8MXCrNAVYlMnnCeM32Kxw: posts big blind $2
*** HOLE CARDS ***
VvdR9F3I+2yELkfTVvC1dg: folds
uCqEjnxh2/vFBjKYkfTOkw: folds
vkfxu8f/jMYKUk6Ly4eujw: folds
4dcDwIHRm96PwtqkpQiuiA: folds
ubtx4Z5L+AcK71MTvYiGVw: folds
K8MXCrNAVYlMnnCeM32Kxw collected $2 from pot
*** SUMMARY ***
Total pot $2 | Rake $0
Seat 1: vkfxu8f/jMYKUk6Ly4eujw folded before Flop (didn't bet)
Seat 2: 4dcDwIHRm96PwtqkpQiuiA (button) folded before Flop (didn't bet)
Seat 3: ubtx4Z5L+AcK71MTvYiGVw (small blind) folded before Flop
Seat 4: K8MXCrNAVYlMnnCeM32Kxw (big blind) collected ($2)
Seat 5: VvdR9F3I+2yELkfTVvC1dg folded before Flop (didn't bet)
Seat 6: uCqEjnxh2/vFBjKYkfTOkw folded before Flop (didn't bet)



PokerStars Game #59941731652:  Hold'em No Limit ($1/$2) - 2009/07/01 1:44:23 ET
Table '5/wEe6JmtGD7vufSA2RG7A' 2-max Seat #2 is the button
Seat 1: pVqEzK9wXlRMECnb1Zg4Zw ($124.30 in chips)
Seat 2: aOL8geThaYp2iadSHl1h1g ($116.50 in chips)
aOL8geThaYp2iadSHl1h1g: posts small blind $1
pVqEzK9wXlRMECnb1Zg4Zw: posts big blind $2
*** HOLE CARDS ***
aOL8geThaYp2iadSHl1h1g: raises $4 to $6
pVqEzK9wXlRMECnb1Zg4Zw: calls $4
*** FLOP *** [7h 5d Kc]
pVqEzK9wXlRMECnb1Zg4Zw: checks
aOL8geThaYp2iadSHl1h1g: checks
*** TURN *** [7h 5d Kc] [Qs]
pVqEzK9wXlRMECnb1Zg4Zw: checks
aOL8geThaYp2iadSHl1h1g: bets $8
pVqEzK9wXlRMECnb1Zg4Zw: folds
aOL8geThaYp2iadSHl1h1g collected $11.50 from pot
aOL8geThaYp2iadSHl1h1g: doesn't show hand
*** SUMMARY ***
Total pot $12 | Rake $0.50
Board [7h 5d Kc Qs]
Seat 1: pVqEzK9wXlRMECnb1Zg4Zw (big blind) folded on the Turn
Seat 2: aOL8geThaYp2iadSHl1h1g (button) (small blind) collected ($11.50)



PokerStars Game #59941735976:  Hold'em No Limit ($1/$2) - 2009/07/01 1:44:31 ET
Table 'UGLAZZyv+cXmnKjYin0etA' 6-max Seat #1 is the button
Seat 1: vkfxu8f/jMYKUk6Ly4eujw ($200 in chips)
Seat 2: eDLH1PUXFpvJBNMXBVQcGA ($305.10 in chips)
Seat 3: ygTTt5ehT4aF86q1a8/R+w ($111.20 in chips)
Seat 4: SiGJDsvRViJX05vHhA80GQ ($231.85 in chips)
Seat 5: 54yWzRRgS0oZ+S6LwZBxMQ ($42.05 in chips)
Seat 6: sTPOWERd9HWPCNrDBwsVjA ($218.15 in chips)
eDLH1PUXFpvJBNMXBVQcGA: posts small blind $1
ygTTt5ehT4aF86q1a8/R+w: posts big blind $2
*** HOLE CARDS ***
SiGJDsvRViJX05vHhA80GQ: raises $4 to $6
54yWzRRgS0oZ+S6LwZBxMQ: folds
sTPOWERd9HWPCNrDBwsVjA: folds
vkfxu8f/jMYKUk6Ly4eujw: folds
eDLH1PUXFpvJBNMXBVQcGA: folds
ygTTt5ehT4aF86q1a8/R+w: folds
SiGJDsvRViJX05vHhA80GQ collected $5 from pot
*** SUMMARY ***
Total pot $5 | Rake $0
Seat 1: vkfxu8f/jMYKUk6Ly4eujw (button) folded before Flop (didn't bet)
Seat 2: eDLH1PUXFpvJBNMXBVQcGA (small blind) folded before Flop
Seat 3: ygTTt5ehT4aF86q1a8/R+w (big blind) folded before Flop
Seat 4: SiGJDsvRViJX05vHhA80GQ collected ($5)
Seat 5: 54yWzRRgS0oZ+S6LwZBxMQ folded before Flop (didn't bet)
Seat 6: sTPOWERd9HWPCNrDBwsVjA folded before Flop (didn't bet)



PokerStars Game #59941736442:  Hold'em No Limit ($1/$2) - 2009/07/01 1:44:32 ET
Table 'ZzSIe0zTCDv+n6hfbY5tTg' 6-max Seat #6 is the button
Seat 1: VvdR9F3I+2yELkfTVvC1dg ($252 in chips)
Seat 2: B87ikIyZ/TzAVeXf38Ny0g ($237 in chips)
Seat 3: gsugPj31Hui3Jefl98MBOA ($349 in chips)
Seat 4: 54yWzRRgS0oZ+S6LwZBxMQ ($39.75 in chips)
Seat 5: 3dAbvkxS5NPQTBAbvpinVg ($509.45 in chips)
Seat 6: 09BNF4quPDzanQzM8vc6WA ($36 in chips)
VvdR9F3I+2yELkfTVvC1dg: posts small blind $1
B87ikIyZ/TzAVeXf38Ny0g: posts big blind $2
*** HOLE CARDS ***
gsugPj31Hui3Jefl98MBOA: folds
54yWzRRgS0oZ+S6LwZBxMQ: calls $2
3dAbvkxS5NPQTBAbvpinVg: folds
09BNF4quPDzanQzM8vc6WA: folds
VvdR9F3I+2yELkfTVvC1dg: raises $6 to $8
B87ikIyZ/TzAVeXf38Ny0g: folds
54yWzRRgS0oZ+S6LwZBxMQ: calls $6
*** FLOP *** [6h 2s Ac]
VvdR9F3I+2yELkfTVvC1dg: bets $12.80
54yWzRRgS0oZ+S6LwZBxMQ: folds
VvdR9F3I+2yELkfTVvC1dg collected $17.10 from pot
VvdR9F3I+2yELkfTVvC1dg: doesn't show hand
*** SUMMARY ***
Total pot $18 | Rake $0.90
Board [6h 2s Ac]
Seat 1: VvdR9F3I+2yELkfTVvC1dg (small blind) collected ($17.10)
Seat 2: B87ikIyZ/TzAVeXf38Ny0g (big blind) folded before Flop
Seat 3: gsugPj31Hui3Jefl98MBOA folded before Flop (didn't bet)
Seat 4: 54yWzRRgS0oZ+S6LwZBxMQ folded on the Flop
Seat 5: 3dAbvkxS5NPQTBAbvpinVg folded before Flop (didn't bet)
Seat 6: 09BNF4quPDzanQzM8vc6WA (button) folded before Flop (didn't bet)



PokerStars Game #59941737132:  Hold'em No Limit ($1/$2) - 2009/07/01 1:44:33 ET
Table 'QxerF7GUfCbl+4a8XaTB2w' 6-max Seat #6 is the button
Seat 1: ZwvXzkkZ3XpMhKfAmVpahw ($211.75 in chips)
Seat 2: 6UGgYbxwWNc+ohObe8vB9w ($40 in chips)
Seat 3: 8rZGabKe2DEPdZCbCivZ9Q ($38 in chips)
Seat 4: /PH6Ffnho4Ysm8S3V/oa+w ($44 in chips)
Seat 5: gnYme0DNFflnMhrdbxe1Ag ($323.15 in chips)
Seat 6: VvdR9F3I+2yELkfTVvC1dg ($210.15 in chips)
ZwvXzkkZ3XpMhKfAmVpahw: posts small blind $1
6UGgYbxwWNc+ohObe8vB9w: posts big blind $2
*** HOLE CARDS ***
8rZGabKe2DEPdZCbCivZ9Q: folds
/PH6Ffnho4Ysm8S3V/oa+w: folds
gnYme0DNFflnMhrdbxe1Ag: raises $4 to $6
VvdR9F3I+2yELkfTVvC1dg: folds
ZwvXzkkZ3XpMhKfAmVpahw: raises $16 to $22
6UGgYbxwWNc+ohObe8vB9w: folds
gnYme0DNFflnMhrdbxe1Ag: calls $16
*** FLOP *** [3d 3s As]
ZwvXzkkZ3XpMhKfAmVpahw: bets $22
gnYme0DNFflnMhrdbxe1Ag: calls $22
*** TURN *** [3d 3s As] [5h]
ZwvXzkkZ3XpMhKfAmVpahw: bets $22
gnYme0DNFflnMhrdbxe1Ag: calls $22
*** RIVER *** [3d 3s As 5h] [Jh]
ZwvXzkkZ3XpMhKfAmVpahw: bets $22
gnYme0DNFflnMhrdbxe1Ag: folds
ZwvXzkkZ3XpMhKfAmVpahw collected $131 from pot
ZwvXzkkZ3XpMhKfAmVpahw: doesn't show hand
*** SUMMARY ***
Total pot $134 | Rake $3
Board [3d 3s As 5h Jh]
Seat 1: ZwvXzkkZ3XpMhKfAmVpahw (small blind) collected ($131)
Seat 2: 6UGgYbxwWNc+ohObe8vB9w (big blind) folded before Flop
Seat 3: 8rZGabKe2DEPdZCbCivZ9Q folded before Flop (didn't bet)
Seat 4: /PH6Ffnho4Ysm8S3V/oa+w folded before Flop (didn't bet)
Seat 5: gnYme0DNFflnMhrdbxe1Ag folded on the River
Seat 6: VvdR9F3I+2yELkfTVvC1dg (button) folded before Flop (didn't bet)



PokerStars Game #59941738948:  Hold'em No Limit ($1/$2) - 2009/07/01 1:44:36 ET
Table 'CFkQcfWjKccZaZDf71FK+w' 6-max Seat #3 is the button
Seat 1: vkfxu8f/jMYKUk6Ly4eujw ($227.25 in chips)
Seat 2: ewN/vzF22+/gdzjIKBOlkA ($204.80 in chips)
Seat 3: 09BNF4quPDzanQzM8vc6WA ($79.30 in chips)
Seat 4: ygTTt5ehT4aF86q1a8/R+w ($241.35 in chips)
Seat 5: 2lOU1DcvUZaMcxZ95XfzXw ($157.05 in chips)
Seat 6: ORVqY3rf9X6ANA/8s+On2Q ($42.35 in chips)
ygTTt5ehT4aF86q1a8/R+w: posts small blind $1
2lOU1DcvUZaMcxZ95XfzXw: posts big blind $2
*** HOLE CARDS ***
ORVqY3rf9X6ANA/8s+On2Q: folds
vkfxu8f/jMYKUk6Ly4eujw: folds
ewN/vzF22+/gdzjIKBOlkA: raises $4 to $6
09BNF4quPDzanQzM8vc6WA: raises $73.30 to $79.30 and is all-in
ygTTt5ehT4aF86q1a8/R+w: folds
2lOU1DcvUZaMcxZ95XfzXw: folds
ewN/vzF22+/gdzjIKBOlkA: folds
09BNF4quPDzanQzM8vc6WA collected $15 from pot
09BNF4quPDzanQzM8vc6WA: doesn't show hand
*** SUMMARY ***
Total pot $15 | Rake $0
Seat 1: vkfxu8f/jMYKUk6Ly4eujw folded before Flop (didn't bet)
Seat 2: ewN/vzF22+/gdzjIKBOlkA folded before Flop
Seat 3: 09BNF4quPDzanQzM8vc6WA (button) collected ($15)
Seat 4: ygTTt5ehT4aF86q1a8/R+w (small blind) folded before Flop
Seat 5: 2lOU1DcvUZaMcxZ95XfzXw (big blind) folded before Flop
Seat 6: ORVqY3rf9X6ANA/8s+On2Q folded before Flop (didn't bet)



PokerStars Game #59941741526:  Hold'em No Limit ($1/$2) - 2009/07/01 1:44:41 ET
Table 'eyAQSIlgc2o1Jxvbve4WGg' 9-max Seat #7 is the button
Seat 1: UZEsV9yKUMqmpYPiOFpaZw ($53.20 in chips)
Seat 2: kM9CA+2UcdMjbCMbtUCGiA ($220.60 in chips)
Seat 4: CkE3IyJF1KvdaAOmZY5XqQ ($200 in chips)
Seat 5: mIKx5lhIt13X5eZQH0ZeMA ($138.45 in chips)
Seat 6: nXDI8Y/S6POzRwANu3d8hQ ($67 in chips)
Seat 7: u3OrI5uGx9mx1fE7dgr+EA ($66.50 in chips)
Seat 9: WUlHm+ydPPHG7Lb0rePSdA ($141.20 in chips)
254YPxPJr5Sw58bkD0YqYQ will be allowed to play after the button
WUlHm+ydPPHG7Lb0rePSdA: posts small blind $1
UZEsV9yKUMqmpYPiOFpaZw: posts big blind $2
*** HOLE CARDS ***
kM9CA+2UcdMjbCMbtUCGiA: folds
CkE3IyJF1KvdaAOmZY5XqQ: folds
mIKx5lhIt13X5eZQH0ZeMA: folds
nXDI8Y/S6POzRwANu3d8hQ: folds
u3OrI5uGx9mx1fE7dgr+EA: calls $2
WUlHm+ydPPHG7Lb0rePSdA: folds
UZEsV9yKUMqmpYPiOFpaZw: checks
*** FLOP *** [9d 5c 5s]
UZEsV9yKUMqmpYPiOFpaZw: checks
u3OrI5uGx9mx1fE7dgr+EA: bets $2
UZEsV9yKUMqmpYPiOFpaZw: calls $2
*** TURN *** [9d 5c 5s] [Jd]
UZEsV9yKUMqmpYPiOFpaZw: checks
u3OrI5uGx9mx1fE7dgr+EA: bets $2
UZEsV9yKUMqmpYPiOFpaZw: calls $2
*** RIVER *** [9d 5c 5s Jd] [Ah]
UZEsV9yKUMqmpYPiOFpaZw: checks
u3OrI5uGx9mx1fE7dgr+EA: bets $10
UZEsV9yKUMqmpYPiOFpaZw: calls $10
*** SHOW DOWN ***
u3OrI5uGx9mx1fE7dgr+EA: shows [Tc As] (two pair, Aces and Fives)
UZEsV9yKUMqmpYPiOFpaZw: mucks hand
u3OrI5uGx9mx1fE7dgr+EA collected $31.40 from pot
*** SUMMARY ***
Total pot $33 | Rake $1.60
Board [9d 5c 5s Jd Ah]
Seat 1: UZEsV9yKUMqmpYPiOFpaZw (big blind) mucked
Seat 2: kM9CA+2UcdMjbCMbtUCGiA folded before Flop (didn't bet)
Seat 4: CkE3IyJF1KvdaAOmZY5XqQ folded before Flop (didn't bet)
Seat 5: mIKx5lhIt13X5eZQH0ZeMA folded before Flop (didn't bet)
Seat 6: nXDI8Y/S6POzRwANu3d8hQ folded before Flop (didn't bet)
Seat 7: u3OrI5uGx9mx1fE7dgr+EA (button) showed [Tc As] and won ($31.40) with two pair, Aces and Fives
Seat 9: WUlHm+ydPPHG7Lb0rePSdA (small blind) folded before Flop



PokerStars Game #59941742588:  Hold'em No Limit ($1/$2) - 2009/07/01 1:44:43 ET
Table 'TsEDkiO4tzCTCzJ7tNdEqw' 6-max Seat #3 is the button
Seat 1: vkfxu8f/jMYKUk6Ly4eujw ($197 in chips)
Seat 2: 4dcDwIHRm96PwtqkpQiuiA ($82.65 in chips)
Seat 3: ubtx4Z5L+AcK71MTvYiGVw ($267.85 in chips)
Seat 4: K8MXCrNAVYlMnnCeM32Kxw ($121 in chips)
Seat 5: VvdR9F3I+2yELkfTVvC1dg ($249.35 in chips)
Seat 6: uCqEjnxh2/vFBjKYkfTOkw ($289.80 in chips)
K8MXCrNAVYlMnnCeM32Kxw: posts small blind $1
VvdR9F3I+2yELkfTVvC1dg: posts big blind $2
*** HOLE CARDS ***
uCqEjnxh2/vFBjKYkfTOkw: folds
vkfxu8f/jMYKUk6Ly4eujw: folds
4dcDwIHRm96PwtqkpQiuiA: folds
ubtx4Z5L+AcK71MTvYiGVw: folds
K8MXCrNAVYlMnnCeM32Kxw: raises $6 to $8
VvdR9F3I+2yELkfTVvC1dg: folds
K8MXCrNAVYlMnnCeM32Kxw collected $4 from pot
*** SUMMARY ***
Total pot $4 | Rake $0
Seat 1: vkfxu8f/jMYKUk6Ly4eujw folded before Flop (didn't bet)
Seat 2: 4dcDwIHRm96PwtqkpQiuiA folded before Flop (didn't bet)
Seat 3: ubtx4Z5L+AcK71MTvYiGVw (button) folded before Flop (didn't bet)
Seat 4: K8MXCrNAVYlMnnCeM32Kxw (small blind) collected ($4)
Seat 5: VvdR9F3I+2yELkfTVvC1dg (big blind) folded before Flop
Seat 6: uCqEjnxh2/vFBjKYkfTOkw folded before Flop (didn't bet)



PokerStars Game #59941742218:  Hold'em No Limit ($1/$2) - 2009/07/01 1:44:43 ET
Table 'mGpP9StWRnoeiBDExc6Frg' 6-max Seat #5 is the button
Seat 1: VvdR9F3I+2yELkfTVvC1dg ($309.15 in chips)
Seat 2: vkfxu8f/jMYKUk6Ly4eujw ($201 in chips)
Seat 4: 4dcDwIHRm96PwtqkpQiuiA ($62.70 in chips)
Seat 5: d1puGuVBE0fidn+5eRJ0tw ($200.35 in chips)
Seat 6: B2Ih1sr5VZk+8He7rcrMtQ ($427.45 in chips)
B2Ih1sr5VZk+8He7rcrMtQ: posts small blind $1
VvdR9F3I+2yELkfTVvC1dg: posts big blind $2
*** HOLE CARDS ***
vkfxu8f/jMYKUk6Ly4eujw: folds
vkfxu8f/jMYKUk6Ly4eujw leaves the table
4dcDwIHRm96PwtqkpQiuiA: folds
d1puGuVBE0fidn+5eRJ0tw: folds
B2Ih1sr5VZk+8He7rcrMtQ: folds
VvdR9F3I+2yELkfTVvC1dg collected $2 from pot
VvdR9F3I+2yELkfTVvC1dg: doesn't show hand
*** SUMMARY ***
Total pot $2 | Rake $0
Seat 1: VvdR9F3I+2yELkfTVvC1dg (big blind) collected ($2)
Seat 2: vkfxu8f/jMYKUk6Ly4eujw folded before Flop (didn't bet)
Seat 4: 4dcDwIHRm96PwtqkpQiuiA folded before Flop (didn't bet)
Seat 5: d1puGuVBE0fidn+5eRJ0tw (button) folded before Flop (didn't bet)
Seat 6: B2Ih1sr5VZk+8He7rcrMtQ (small blind) folded before Flop



PokerStars Game #59941742190:  Hold'em No Limit ($1/$2) - 2009/07/01 1:44:43 ET
Table '/dyk+YdRGv90j2box35j8w' 6-max Seat #6 is the button
Seat 1: 8srN1dKQePlsv0GyTada+Q ($200 in chips)
Seat 2: qCnEYuAE5y5A7bk6fO5/jQ ($496.20 in chips)
Seat 3: sTPOWERd9HWPCNrDBwsVjA ($206.50 in chips)
Seat 5: VvdR9F3I+2yELkfTVvC1dg ($259.80 in chips)
Seat 6: gnYme0DNFflnMhrdbxe1Ag ($200 in chips)
8srN1dKQePlsv0GyTada+Q: posts small blind $1
qCnEYuAE5y5A7bk6fO5/jQ: posts big blind $2
*** HOLE CARDS ***
sTPOWERd9HWPCNrDBwsVjA: folds
VvdR9F3I+2yELkfTVvC1dg: folds
gnYme0DNFflnMhrdbxe1Ag: folds
8srN1dKQePlsv0GyTada+Q: folds
qCnEYuAE5y5A7bk6fO5/jQ collected $2 from pot
qCnEYuAE5y5A7bk6fO5/jQ: doesn't show hand
*** SUMMARY ***
Total pot $2 | Rake $0
Seat 1: 8srN1dKQePlsv0GyTada+Q (small blind) folded before Flop
Seat 2: qCnEYuAE5y5A7bk6fO5/jQ (big blind) collected ($2)
Seat 3: sTPOWERd9HWPCNrDBwsVjA folded before Flop (didn't bet)
Seat 5: VvdR9F3I+2yELkfTVvC1dg folded before Flop (didn't bet)
Seat 6: gnYme0DNFflnMhrdbxe1Ag (button) folded before Flop (didn't bet)



PokerStars Game #59941742994:  Hold'em No Limit ($1/$2) - 2009/07/01 1:44:44 ET
Table 'jlrIxbrVIG+gjaUYT4za8g' 6-max Seat #3 is the button
Seat 1: ygTTt5ehT4aF86q1a8/R+w ($235.30 in chips)
Seat 3: gnYme0DNFflnMhrdbxe1Ag ($200 in chips)
Seat 4: 8srN1dKQePlsv0GyTada+Q ($266.70 in chips)
Seat 5: AyBB0k3Dcl7xbXUeGMw06g ($41.15 in chips)
Seat 6: BWhgxe7gWiYobRbwdG+d2Q ($196 in chips)
8srN1dKQePlsv0GyTada+Q: posts small blind $1
AyBB0k3Dcl7xbXUeGMw06g: posts big blind $2
cwfuMyvDC7J7SqX2leDC8g: sits out
*** HOLE CARDS ***
BWhgxe7gWiYobRbwdG+d2Q: raises $5 to $7
ygTTt5ehT4aF86q1a8/R+w: folds
gnYme0DNFflnMhrdbxe1Ag: folds
8srN1dKQePlsv0GyTada+Q: folds
AyBB0k3Dcl7xbXUeGMw06g: folds
BWhgxe7gWiYobRbwdG+d2Q collected $5 from pot
*** SUMMARY ***
Total pot $5 | Rake $0
Seat 1: ygTTt5ehT4aF86q1a8/R+w folded before Flop (didn't bet)
Seat 3: gnYme0DNFflnMhrdbxe1Ag (button) folded before Flop (didn't bet)
Seat 4: 8srN1dKQePlsv0GyTada+Q (small blind) folded before Flop
Seat 5: AyBB0k3Dcl7xbXUeGMw06g (big blind) folded before Flop
Seat 6: BWhgxe7gWiYobRbwdG+d2Q collected ($5)



PokerStars Game #59941742836:  Hold'em No Limit ($1/$2) - 2009/07/01 1:44:44 ET
Table '5/wEe6JmtGD7vufSA2RG7A' 2-max Seat #1 is the button
Seat 1: pVqEzK9wXlRMECnb1Zg4Zw ($118.30 in chips)
Seat 2: aOL8geThaYp2iadSHl1h1g ($122 in chips)
pVqEzK9wXlRMECnb1Zg4Zw: posts small blind $1
aOL8geThaYp2iadSHl1h1g: posts big blind $2
*** HOLE CARDS ***
pVqEzK9wXlRMECnb1Zg4Zw: calls $1
aOL8geThaYp2iadSHl1h1g: checks
*** FLOP *** [8c Th 7h]
aOL8geThaYp2iadSHl1h1g: checks
pVqEzK9wXlRMECnb1Zg4Zw: checks
*** TURN *** [8c Th 7h] [Kd]
aOL8geThaYp2iadSHl1h1g: checks
pVqEzK9wXlRMECnb1Zg4Zw: bets $6
aOL8geThaYp2iadSHl1h1g: folds
pVqEzK9wXlRMECnb1Zg4Zw collected $3.80 from pot
pVqEzK9wXlRMECnb1Zg4Zw: doesn't show hand
*** SUMMARY ***
Total pot $4 | Rake $0.20
Board [8c Th 7h Kd]
Seat 1: pVqEzK9wXlRMECnb1Zg4Zw (button) (small blind) collected ($3.80)
Seat 2: aOL8geThaYp2iadSHl1h1g (big blind) folded on the Turn



PokerStars Game #59941743250:  Hold'em No Limit ($1/$2) - 2009/07/01 1:44:45 ET
Table 'G1Oqdy4Pqdb5gtx40rUBzA' 6-max Seat #5 is the button
Seat 2: m7mYVfnCOK5TE/VkN/FhOg ($212.05 in chips)
Seat 3: VvdR9F3I+2yELkfTVvC1dg ($215.90 in chips)
Seat 4: B87ikIyZ/TzAVeXf38Ny0g ($217.70 in chips)
Seat 5: F1+Ml47qRQWunzPnGhLLzQ ($185.40 in chips)
Seat 6: qCnEYuAE5y5A7bk6fO5/jQ ($209.25 in chips)
qCnEYuAE5y5A7bk6fO5/jQ: posts small blind $1
m7mYVfnCOK5TE/VkN/FhOg: posts big blind $2
*** HOLE CARDS ***
VvdR9F3I+2yELkfTVvC1dg: calls $2
B87ikIyZ/TzAVeXf38Ny0g: folds
F1+Ml47qRQWunzPnGhLLzQ: folds
qCnEYuAE5y5A7bk6fO5/jQ: folds
m7mYVfnCOK5TE/VkN/FhOg: checks
*** FLOP *** [Ac 2c 4s]
m7mYVfnCOK5TE/VkN/FhOg: checks
VvdR9F3I+2yELkfTVvC1dg: bets $3.55
m7mYVfnCOK5TE/VkN/FhOg: folds
VvdR9F3I+2yELkfTVvC1dg collected $4.75 from pot
VvdR9F3I+2yELkfTVvC1dg: doesn't show hand
*** SUMMARY ***
Total pot $5 | Rake $0.25
Board [Ac 2c 4s]
Seat 2: m7mYVfnCOK5TE/VkN/FhOg (big blind) folded on the Flop
Seat 3: VvdR9F3I+2yELkfTVvC1dg collected ($4.75)
Seat 4: B87ikIyZ/TzAVeXf38Ny0g folded before Flop (didn't bet)
Seat 5: F1+Ml47qRQWunzPnGhLLzQ (button) folded before Flop (didn't bet)
Seat 6: qCnEYuAE5y5A7bk6fO5/jQ (small blind) folded before Flop



PokerStars Game #59941744328:  Hold'em No Limit ($1/$2) - 2009/07/01 1:44:47 ET
Table 'kq5zaQ+1hLNf8LZfGnbTAA' 6-max Seat #5 is the button
Seat 1: 8srN1dKQePlsv0GyTada+Q ($422.60 in chips)
Seat 2: nXDI8Y/S6POzRwANu3d8hQ ($140 in chips)
Seat 3: /PH6Ffnho4Ysm8S3V/oa+w ($49.15 in chips)
Seat 4: 3dAbvkxS5NPQTBAbvpinVg ($290.65 in chips)
Seat 5: gnYme0DNFflnMhrdbxe1Ag ($219.35 in chips)
Seat 6: mfy7uGZcqA2PVQqEVbJ7+g ($189.15 in chips)
mfy7uGZcqA2PVQqEVbJ7+g: posts small blind $1
8srN1dKQePlsv0GyTada+Q: posts big blind $2
*** HOLE CARDS ***
nXDI8Y/S6POzRwANu3d8hQ: folds
/PH6Ffnho4Ysm8S3V/oa+w: raises $2 to $4
3dAbvkxS5NPQTBAbvpinVg: folds
gnYme0DNFflnMhrdbxe1Ag: folds
mfy7uGZcqA2PVQqEVbJ7+g: folds
8srN1dKQePlsv0GyTada+Q: folds
/PH6Ffnho4Ysm8S3V/oa+w collected $5 from pot
/PH6Ffnho4Ysm8S3V/oa+w: doesn't show hand
*** SUMMARY ***
Total pot $5 | Rake $0
Seat 1: 8srN1dKQePlsv0GyTada+Q (big blind) folded before Flop
Seat 2: nXDI8Y/S6POzRwANu3d8hQ folded before Flop (didn't bet)
Seat 3: /PH6Ffnho4Ysm8S3V/oa+w collected ($5)
Seat 4: 3dAbvkxS5NPQTBAbvpinVg folded before Flop (didn't bet)
Seat 5: gnYme0DNFflnMhrdbxe1Ag (button) folded before Flop (didn't bet)
Seat 6: mfy7uGZcqA2PVQqEVbJ7+g (small blind) folded before Flop



PokerStars Game #59941744202:  Hold'em No Limit ($1/$2) - 2009/07/01 1:44:47 ET
Table 'BSRfGh+QobUe0AgIMtt/fw' 9-max Seat #6 is the button
Seat 1: gDn/rYeNwCyWEgRhyWp4PA ($162.05 in chips)
Seat 2: +SmnXtdmwqXGEJfLeJDIUQ ($75.60 in chips)
Seat 3: WUlHm+ydPPHG7Lb0rePSdA ($120 in chips)
Seat 4: +T/63sAeZzWyHchahJ36GQ ($40 in chips)
Seat 5: v0q3vrz/d9oDjLrAG8Ausw ($204.55 in chips)
Seat 6: H6Z4+qu8gR0VUiPOijndVg ($200 in chips)
Seat 7: CkE3IyJF1KvdaAOmZY5XqQ ($200.10 in chips)
Seat 8: /XRRUMKiOOItJFbrM26RrA ($83.30 in chips)
Seat 9: /inIs/z/PcX+TniIFpaxpg ($415.25 in chips)
CkE3IyJF1KvdaAOmZY5XqQ: posts small blind $1
/XRRUMKiOOItJFbrM26RrA: posts big blind $2
*** HOLE CARDS ***
/inIs/z/PcX+TniIFpaxpg: folds
gDn/rYeNwCyWEgRhyWp4PA: folds
+SmnXtdmwqXGEJfLeJDIUQ: folds
WUlHm+ydPPHG7Lb0rePSdA: folds
+T/63sAeZzWyHchahJ36GQ: folds
v0q3vrz/d9oDjLrAG8Ausw: raises $2 to $4
H6Z4+qu8gR0VUiPOijndVg: folds
CkE3IyJF1KvdaAOmZY5XqQ: folds
/XRRUMKiOOItJFbrM26RrA: calls $2
*** FLOP *** [Jc 3s 8s]
/XRRUMKiOOItJFbrM26RrA: checks
v0q3vrz/d9oDjLrAG8Ausw: bets $6
/XRRUMKiOOItJFbrM26RrA: calls $6
*** TURN *** [Jc 3s 8s] [Kh]
/XRRUMKiOOItJFbrM26RrA: checks
v0q3vrz/d9oDjLrAG8Ausw: bets $8
/XRRUMKiOOItJFbrM26RrA: calls $8
*** RIVER *** [Jc 3s 8s Kh] [9d]
/XRRUMKiOOItJFbrM26RrA: checks
v0q3vrz/d9oDjLrAG8Ausw: checks
*** SHOW DOWN ***
/XRRUMKiOOItJFbrM26RrA: shows [5s 9s] (a pair of Nines)
v0q3vrz/d9oDjLrAG8Ausw: shows [Js 7s] (a pair of Jacks)
v0q3vrz/d9oDjLrAG8Ausw collected $35.20 from pot
*** SUMMARY ***
Total pot $37 | Rake $1.80
Board [Jc 3s 8s Kh 9d]
Seat 1: gDn/rYeNwCyWEgRhyWp4PA folded before Flop (didn't bet)
Seat 2: +SmnXtdmwqXGEJfLeJDIUQ folded before Flop (didn't bet)
Seat 3: WUlHm+ydPPHG7Lb0rePSdA folded before Flop (didn't bet)
Seat 4: +T/63sAeZzWyHchahJ36GQ folded before Flop (didn't bet)
Seat 5: v0q3vrz/d9oDjLrAG8Ausw showed [Js 7s] and won ($35.20) with a pair of Jacks
Seat 6: H6Z4+qu8gR0VUiPOijndVg (button) folded before Flop (didn't bet)
Seat 7: CkE3IyJF1KvdaAOmZY5XqQ (small blind) folded before Flop
Seat 8: /XRRUMKiOOItJFbrM26RrA (big blind) showed [5s 9s] and lost with a pair of Nines
Seat 9: /inIs/z/PcX+TniIFpaxpg folded before Flop (didn't bet)



PokerStars Game #59941744934:  Hold'em No Limit ($1/$2) - 2009/07/01 1:44:48 ET
Table 'bJQ024BaYSBrW0sXpCZbNQ' 6-max Seat #2 is the button
Seat 1: KfwW5us6tydK81NYTtK1gw ($200 in chips)
Seat 2: 3dAbvkxS5NPQTBAbvpinVg ($280 in chips)
Seat 3: /PH6Ffnho4Ysm8S3V/oa+w ($40 in chips)
Seat 4: TBaQIN+sQ7eb7P99QnaORQ ($52.80 in chips)
Seat 5: VvdR9F3I+2yELkfTVvC1dg ($200 in chips)
Seat 6: 4bqvCfJ0e8CTYnn0Go9hbQ ($143.20 in chips)
/PH6Ffnho4Ysm8S3V/oa+w: posts small blind $1
TBaQIN+sQ7eb7P99QnaORQ: posts big blind $2
*** HOLE CARDS ***
VvdR9F3I+2yELkfTVvC1dg: folds
4bqvCfJ0e8CTYnn0Go9hbQ: folds
KfwW5us6tydK81NYTtK1gw: folds
3dAbvkxS5NPQTBAbvpinVg: raises $4 to $6
/PH6Ffnho4Ysm8S3V/oa+w: folds
TBaQIN+sQ7eb7P99QnaORQ: raises $12 to $18
3dAbvkxS5NPQTBAbvpinVg: folds
TBaQIN+sQ7eb7P99QnaORQ collected $13 from pot
*** SUMMARY ***
Total pot $13 | Rake $0
Seat 1: KfwW5us6tydK81NYTtK1gw folded before Flop (didn't bet)
Seat 2: 3dAbvkxS5NPQTBAbvpinVg (button) folded before Flop
Seat 3: /PH6Ffnho4Ysm8S3V/oa+w (small blind) folded before Flop
Seat 4: TBaQIN+sQ7eb7P99QnaORQ (big blind) collected ($13)
Seat 5: VvdR9F3I+2yELkfTVvC1dg folded before Flop (didn't bet)
Seat 6: 4bqvCfJ0e8CTYnn0Go9hbQ folded before Flop (didn't bet)



PokerStars Game #59941745848:  Hold'em No Limit ($1/$2) - 2009/07/01 1:44:50 ET
Table 'YqGfR5eHfMeSjb9a+QU9rg' 9-max Seat #4 is the button
Seat 1: rW/MyplHylMSBRaoRUzWrg ($76 in chips)
Seat 2: nXDI8Y/S6POzRwANu3d8hQ ($37 in chips)
Seat 4: GX1heJ+DSsvm7gzSPsYhhQ ($36 in chips)
Seat 5: CkE3IyJF1KvdaAOmZY5XqQ ($211.40 in chips)
Seat 6: TAfo4veNRaRlzDXMMYS3Jg ($40 in chips)
Seat 7: 41aZuLBz9nAi2GPVKabmCw ($82.95 in chips)
Seat 8: JnV3SM2D6dAFYyGZHHpvrg ($102.15 in chips)
Seat 9: /inIs/z/PcX+TniIFpaxpg ($202.20 in chips)
CkE3IyJF1KvdaAOmZY5XqQ: posts small blind $1
TAfo4veNRaRlzDXMMYS3Jg: posts big blind $2
KqHysDSpCPaPyK3tJC1aEw: sits out
*** HOLE CARDS ***
41aZuLBz9nAi2GPVKabmCw: folds
JnV3SM2D6dAFYyGZHHpvrg: folds
/inIs/z/PcX+TniIFpaxpg: folds
rW/MyplHylMSBRaoRUzWrg: folds
nXDI8Y/S6POzRwANu3d8hQ: folds
GX1heJ+DSsvm7gzSPsYhhQ: folds
CkE3IyJF1KvdaAOmZY5XqQ: raises $6 to $8
TAfo4veNRaRlzDXMMYS3Jg: folds
CkE3IyJF1KvdaAOmZY5XqQ collected $4 from pot
*** SUMMARY ***
Total pot $4 | Rake $0
Seat 1: rW/MyplHylMSBRaoRUzWrg folded before Flop (didn't bet)
Seat 2: nXDI8Y/S6POzRwANu3d8hQ folded before Flop (didn't bet)
Seat 4: GX1heJ+DSsvm7gzSPsYhhQ (button) folded before Flop (didn't bet)
Seat 5: CkE3IyJF1KvdaAOmZY5XqQ (small blind) collected ($4)
Seat 6: TAfo4veNRaRlzDXMMYS3Jg (big blind) folded before Flop
Seat 7: 41aZuLBz9nAi2GPVKabmCw folded before Flop (didn't bet)
Seat 8: JnV3SM2D6dAFYyGZHHpvrg folded before Flop (didn't bet)
Seat 9: /inIs/z/PcX+TniIFpaxpg folded before Flop (didn't bet)



PokerStars Game #59941749292:  Hold'em No Limit ($1/$2) - 2009/07/01 1:44:56 ET
Table '4NGNnZ/osQfNq6abYqkJeA' 6-max Seat #6 is the button
Seat 1: xUTLK/SDwl6IxZdaKduuFg ($68.60 in chips)
Seat 2: 669iGNwYwgRZg3nhS+aDAQ ($131.25 in chips)
Seat 3: 54yWzRRgS0oZ+S6LwZBxMQ ($37 in chips)
Seat 4: sY+4Uuh5z/6AbXXaCS10jw ($239.15 in chips)
Seat 5: VvdR9F3I+2yELkfTVvC1dg ($228.55 in chips)
Seat 6: /PH6Ffnho4Ysm8S3V/oa+w ($40 in chips)
xUTLK/SDwl6IxZdaKduuFg: posts small blind $1
669iGNwYwgRZg3nhS+aDAQ: posts big blind $2
*** HOLE CARDS ***
54yWzRRgS0oZ+S6LwZBxMQ: folds
sY+4Uuh5z/6AbXXaCS10jw: raises $4 to $6
VvdR9F3I+2yELkfTVvC1dg: folds
/PH6Ffnho4Ysm8S3V/oa+w: folds
xUTLK/SDwl6IxZdaKduuFg: calls $5
669iGNwYwgRZg3nhS+aDAQ: folds
*** FLOP *** [Jh 6c Qc]
xUTLK/SDwl6IxZdaKduuFg: checks
sY+4Uuh5z/6AbXXaCS10jw: bets $10
xUTLK/SDwl6IxZdaKduuFg: calls $10
*** TURN *** [Jh 6c Qc] [4h]
xUTLK/SDwl6IxZdaKduuFg: bets $20
sY+4Uuh5z/6AbXXaCS10jw: raises $40 to $60
xUTLK/SDwl6IxZdaKduuFg: calls $32.60 and is all-in
*** RIVER *** [Jh 6c Qc 4h] [Ad]
*** SHOW DOWN ***
xUTLK/SDwl6IxZdaKduuFg: shows [Qs Th] (a pair of Queens)
sY+4Uuh5z/6AbXXaCS10jw: shows [Qh Kh] (a pair of Queens - Ace+King kicker)
sY+4Uuh5z/6AbXXaCS10jw collected $136.20 from pot
*** SUMMARY ***
Total pot $139.20 | Rake $3
Board [Jh 6c Qc 4h Ad]
Seat 1: xUTLK/SDwl6IxZdaKduuFg (small blind) showed [Qs Th] and lost with a pair of Queens
Seat 2: 669iGNwYwgRZg3nhS+aDAQ (big blind) folded before Flop
Seat 3: 54yWzRRgS0oZ+S6LwZBxMQ folded before Flop (didn't bet)
Seat 4: sY+4Uuh5z/6AbXXaCS10jw showed [Qh Kh] and won ($136.20) with a pair of Queens
Seat 5: VvdR9F3I+2yELkfTVvC1dg folded before Flop (didn't bet)
Seat 6: /PH6Ffnho4Ysm8S3V/oa+w (button) folded before Flop (didn't bet)



PokerStars Game #59941749096:  Hold'em No Limit ($1/$2) - 2009/07/01 1:44:56 ET
Table 'gnHBqWll9O3fxG7Ojkz/ng' 9-max Seat #4 is the button
Seat 1: TAfo4veNRaRlzDXMMYS3Jg ($36 in chips)
Seat 2: H6Z4+qu8gR0VUiPOijndVg ($327.30 in chips)
Seat 3: 5Q8U6iZbeO7xJSS4qvDP5g ($228.05 in chips)
Seat 4: nXDI8Y/S6POzRwANu3d8hQ ($16 in chips)
Seat 5: rBQDMkKm9cZn6M9NPsiVew ($214.15 in chips)
Seat 6: KqHysDSpCPaPyK3tJC1aEw ($200 in chips)
Seat 7: jqui3xAWCkcdPW36a6BD+w ($342.55 in chips)
Seat 8: cM6efHzdxoqYm0EQKP4TTQ ($114.95 in chips)
Seat 9: GX1heJ+DSsvm7gzSPsYhhQ ($45.35 in chips)
rBQDMkKm9cZn6M9NPsiVew: posts small blind $1
KqHysDSpCPaPyK3tJC1aEw: posts big blind $2
*** HOLE CARDS ***
jqui3xAWCkcdPW36a6BD+w: folds
jqui3xAWCkcdPW36a6BD+w leaves the table
cM6efHzdxoqYm0EQKP4TTQ: folds
254YPxPJr5Sw58bkD0YqYQ joins the table at seat #7
GX1heJ+DSsvm7gzSPsYhhQ: folds
TAfo4veNRaRlzDXMMYS3Jg: folds
H6Z4+qu8gR0VUiPOijndVg: raises $6 to $8
5Q8U6iZbeO7xJSS4qvDP5g: folds
nXDI8Y/S6POzRwANu3d8hQ: folds
rBQDMkKm9cZn6M9NPsiVew: folds
KqHysDSpCPaPyK3tJC1aEw: folds
H6Z4+qu8gR0VUiPOijndVg collected $5 from pot
H6Z4+qu8gR0VUiPOijndVg: doesn't show hand
*** SUMMARY ***
Total pot $5 | Rake $0
Seat 1: TAfo4veNRaRlzDXMMYS3Jg folded before Flop (didn't bet)
Seat 2: H6Z4+qu8gR0VUiPOijndVg collected ($5)
Seat 3: 5Q8U6iZbeO7xJSS4qvDP5g folded before Flop (didn't bet)
Seat 4: nXDI8Y/S6POzRwANu3d8hQ (button) folded before Flop (didn't bet)
Seat 5: rBQDMkKm9cZn6M9NPsiVew (small blind) folded before Flop
Seat 6: KqHysDSpCPaPyK3tJC1aEw (big blind) folded before Flop
Seat 7: jqui3xAWCkcdPW36a6BD+w folded before Flop (didn't bet)
Seat 8: cM6efHzdxoqYm0EQKP4TTQ folded before Flop (didn't bet)
Seat 9: GX1heJ+DSsvm7gzSPsYhhQ folded before Flop (didn't bet)



PokerStars Game #59941750536:  Hold'em No Limit ($1/$2) - 2009/07/01 1:44:59 ET
Table 'P/yCfYl1GfGsu/e6DxDy/A' 2-max Seat #1 is the button
Seat 1: 7fOCUy3x9hdkmXkkDNolGQ ($663.50 in chips)
Seat 2: RwDoM55ZeQuI2ADyJhOb2Q ($811 in chips)
7fOCUy3x9hdkmXkkDNolGQ: posts small blind $1
RwDoM55ZeQuI2ADyJhOb2Q: posts big blind $2
*** HOLE CARDS ***
7fOCUy3x9hdkmXkkDNolGQ: folds
RwDoM55ZeQuI2ADyJhOb2Q collected $2 from pot
RwDoM55ZeQuI2ADyJhOb2Q: doesn't show hand
*** SUMMARY ***
Total pot $2 | Rake $0
Seat 1: 7fOCUy3x9hdkmXkkDNolGQ (button) (small blind) folded before Flop
Seat 2: RwDoM55ZeQuI2ADyJhOb2Q (big blind) collected ($2)



PokerStars Game #59941751096:  Hold'em No Limit ($1/$2) - 2009/07/01 1:45:00 ET
Table '/dyk+YdRGv90j2box35j8w' 6-max Seat #1 is the button
Seat 1: 8srN1dKQePlsv0GyTada+Q ($200 in chips)
Seat 2: qCnEYuAE5y5A7bk6fO5/jQ ($497.20 in chips)
Seat 3: sTPOWERd9HWPCNrDBwsVjA ($206.50 in chips)
Seat 5: VvdR9F3I+2yELkfTVvC1dg ($259.80 in chips)
Seat 6: gnYme0DNFflnMhrdbxe1Ag ($200 in chips)
qCnEYuAE5y5A7bk6fO5/jQ: posts small blind $1
sTPOWERd9HWPCNrDBwsVjA: posts big blind $2
*** HOLE CARDS ***
VvdR9F3I+2yELkfTVvC1dg: folds
gnYme0DNFflnMhrdbxe1Ag: folds
8srN1dKQePlsv0GyTada+Q: raises $4 to $6
qCnEYuAE5y5A7bk6fO5/jQ: folds
sTPOWERd9HWPCNrDBwsVjA: folds
8srN1dKQePlsv0GyTada+Q collected $5 from pot
8srN1dKQePlsv0GyTada+Q: doesn't show hand
*** SUMMARY ***
Total pot $5 | Rake $0
Seat 1: 8srN1dKQePlsv0GyTada+Q (button) collected ($5)
Seat 2: qCnEYuAE5y5A7bk6fO5/jQ (small blind) folded before Flop
Seat 3: sTPOWERd9HWPCNrDBwsVjA (big blind) folded before Flop
Seat 5: VvdR9F3I+2yELkfTVvC1dg folded before Flop (didn't bet)
Seat 6: gnYme0DNFflnMhrdbxe1Ag folded before Flop (didn't bet)



PokerStars Game #59941751840:  Hold'em No Limit ($1/$2) - 2009/07/01 1:45:01 ET
Table '3WCXyaiCAbqSShQu7FIjvA' 9-max Seat #6 is the button
Seat 1: kTCkABD1UUldS9DFRGfCwQ ($150.75 in chips)
Seat 2: TAfo4veNRaRlzDXMMYS3Jg ($39.70 in chips)
Seat 3: 5Q8U6iZbeO7xJSS4qvDP5g ($270.25 in chips)
Seat 4: waEF/+pxZTxNo4FvsORuXg ($103.40 in chips)
Seat 5: CkE3IyJF1KvdaAOmZY5XqQ ($210.90 in chips)
Seat 6: 5jQlngvMSqM/WoonOcR5kw ($284.80 in chips)
Seat 7: nXDI8Y/S6POzRwANu3d8hQ ($35 in chips)
Seat 8: +T/63sAeZzWyHchahJ36GQ ($40 in chips)
Seat 9: FiXPLJyqb24l32QST2TInw ($103.10 in chips)
nXDI8Y/S6POzRwANu3d8hQ: posts small blind $1
+T/63sAeZzWyHchahJ36GQ: posts big blind $2
*** HOLE CARDS ***
FiXPLJyqb24l32QST2TInw: folds
kTCkABD1UUldS9DFRGfCwQ: folds
TAfo4veNRaRlzDXMMYS3Jg: folds
5Q8U6iZbeO7xJSS4qvDP5g: folds
waEF/+pxZTxNo4FvsORuXg: folds
CkE3IyJF1KvdaAOmZY5XqQ: folds
5jQlngvMSqM/WoonOcR5kw: calls $2
nXDI8Y/S6POzRwANu3d8hQ: raises $6 to $8
+T/63sAeZzWyHchahJ36GQ: folds
5jQlngvMSqM/WoonOcR5kw: calls $6
*** FLOP *** [Kh Qs As]
nXDI8Y/S6POzRwANu3d8hQ: bets $6
5jQlngvMSqM/WoonOcR5kw: folds
nXDI8Y/S6POzRwANu3d8hQ collected $17.10 from pot
nXDI8Y/S6POzRwANu3d8hQ: doesn't show hand
*** SUMMARY ***
Total pot $18 | Rake $0.90
Board [Kh Qs As]
Seat 1: kTCkABD1UUldS9DFRGfCwQ folded before Flop (didn't bet)
Seat 2: TAfo4veNRaRlzDXMMYS3Jg folded before Flop (didn't bet)
Seat 3: 5Q8U6iZbeO7xJSS4qvDP5g folded before Flop (didn't bet)
Seat 4: waEF/+pxZTxNo4FvsORuXg folded before Flop (didn't bet)
Seat 5: CkE3IyJF1KvdaAOmZY5XqQ folded before Flop (didn't bet)
Seat 6: 5jQlngvMSqM/WoonOcR5kw (button) folded on the Flop
Seat 7: nXDI8Y/S6POzRwANu3d8hQ (small blind) collected ($17.10)
Seat 8: +T/63sAeZzWyHchahJ36GQ (big blind) folded before Flop
Seat 9: FiXPLJyqb24l32QST2TInw folded before Flop (didn't bet)



PokerStars Game #59941751782:  Hold'em No Limit ($1/$2) - 2009/07/01 1:45:01 ET
Table 'NmY84NAf9Mh0ckAckHnh5g' 2-max Seat #1 is the button
Seat 1: 6hvg964TSqZ3AL/0XK9aVQ ($669.45 in chips)
Seat 2: RwDoM55ZeQuI2ADyJhOb2Q ($319.25 in chips)
6hvg964TSqZ3AL/0XK9aVQ: posts small blind $1
RwDoM55ZeQuI2ADyJhOb2Q: posts big blind $2
*** HOLE CARDS ***
6hvg964TSqZ3AL/0XK9aVQ: folds
RwDoM55ZeQuI2ADyJhOb2Q collected $2 from pot
RwDoM55ZeQuI2ADyJhOb2Q: doesn't show hand
*** SUMMARY ***
Total pot $2 | Rake $0
Seat 1: 6hvg964TSqZ3AL/0XK9aVQ (button) (small blind) folded before Flop
Seat 2: RwDoM55ZeQuI2ADyJhOb2Q (big blind) collected ($2)



PokerStars Game #59941752300:  Hold'em No Limit ($1/$2) - 2009/07/01 1:45:02 ET
Table 'UGLAZZyv+cXmnKjYin0etA' 6-max Seat #2 is the button
Seat 1: vkfxu8f/jMYKUk6Ly4eujw ($200 in chips)
Seat 2: eDLH1PUXFpvJBNMXBVQcGA ($304.10 in chips)
Seat 3: ygTTt5ehT4aF86q1a8/R+w ($109.20 in chips)
Seat 4: SiGJDsvRViJX05vHhA80GQ ($234.85 in chips)
Seat 5: 54yWzRRgS0oZ+S6LwZBxMQ ($42.05 in chips)
Seat 6: sTPOWERd9HWPCNrDBwsVjA ($218.15 in chips)
ygTTt5ehT4aF86q1a8/R+w: posts small blind $1
SiGJDsvRViJX05vHhA80GQ: posts big blind $2
*** HOLE CARDS ***
54yWzRRgS0oZ+S6LwZBxMQ: folds
sTPOWERd9HWPCNrDBwsVjA: folds
vkfxu8f/jMYKUk6Ly4eujw: folds
eDLH1PUXFpvJBNMXBVQcGA: folds
ygTTt5ehT4aF86q1a8/R+w: folds
SiGJDsvRViJX05vHhA80GQ collected $2 from pot
*** SUMMARY ***
Total pot $2 | Rake $0
Seat 1: vkfxu8f/jMYKUk6Ly4eujw folded before Flop (didn't bet)
Seat 2: eDLH1PUXFpvJBNMXBVQcGA (button) folded before Flop (didn't bet)
Seat 3: ygTTt5ehT4aF86q1a8/R+w (small blind) folded before Flop
Seat 4: SiGJDsvRViJX05vHhA80GQ (big blind) collected ($2)
Seat 5: 54yWzRRgS0oZ+S6LwZBxMQ folded before Flop (didn't bet)
Seat 6: sTPOWERd9HWPCNrDBwsVjA folded before Flop (didn't bet)



PokerStars Game #59941752228:  Hold'em No Limit ($1/$2) - 2009/07/01 1:45:02 ET
Table 'qVXak+oTeDXMGbWa4sDU5Q' 9-max Seat #9 is the button
Seat 1: H6Z4+qu8gR0VUiPOijndVg ($231.45 in chips)
Seat 2: CST1bO+CmVQOtNgiT0cKPg ($107.60 in chips)
Seat 3: WUlHm+ydPPHG7Lb0rePSdA ($180.35 in chips)
Seat 4: lQYT23h5QCUVZAKxjOO39Q ($180.10 in chips)
Seat 6: GX1heJ+DSsvm7gzSPsYhhQ ($88 in chips)
Seat 7: 6oGEJqk9oDy29sSaLs+LGA ($32.65 in chips)
Seat 8: Z0rzUi0y1x80UdIpofoNbA ($106.55 in chips)
Seat 9: CkE3IyJF1KvdaAOmZY5XqQ ($212.55 in chips)
H6Z4+qu8gR0VUiPOijndVg: posts small blind $1
CST1bO+CmVQOtNgiT0cKPg: posts big blind $2
*** HOLE CARDS ***
WUlHm+ydPPHG7Lb0rePSdA: folds
lQYT23h5QCUVZAKxjOO39Q: folds
GX1heJ+DSsvm7gzSPsYhhQ: folds
6oGEJqk9oDy29sSaLs+LGA: raises $4 to $6
Z0rzUi0y1x80UdIpofoNbA: folds
CkE3IyJF1KvdaAOmZY5XqQ: folds
H6Z4+qu8gR0VUiPOijndVg: folds
CST1bO+CmVQOtNgiT0cKPg: calls $4
*** FLOP *** [Kh Ks 8c]
CST1bO+CmVQOtNgiT0cKPg: checks
6oGEJqk9oDy29sSaLs+LGA: bets $8
CST1bO+CmVQOtNgiT0cKPg: raises $22 to $30
zJtQ1gxyi72XvGYS1tM+DA has returned
6oGEJqk9oDy29sSaLs+LGA: folds
CST1bO+CmVQOtNgiT0cKPg collected $27.60 from pot
*** SUMMARY ***
Total pot $29 | Rake $1.40
Board [Kh Ks 8c]
Seat 1: H6Z4+qu8gR0VUiPOijndVg (small blind) folded before Flop
Seat 2: CST1bO+CmVQOtNgiT0cKPg (big blind) collected ($27.60)
Seat 3: WUlHm+ydPPHG7Lb0rePSdA folded before Flop (didn't bet)
Seat 4: lQYT23h5QCUVZAKxjOO39Q folded before Flop (didn't bet)
Seat 6: GX1heJ+DSsvm7gzSPsYhhQ folded before Flop (didn't bet)
Seat 7: 6oGEJqk9oDy29sSaLs+LGA folded on the Flop
Seat 8: Z0rzUi0y1x80UdIpofoNbA folded before Flop (didn't bet)
Seat 9: CkE3IyJF1KvdaAOmZY5XqQ (button) folded before Flop (didn't bet)



PokerStars Game #59941752806:  Hold'em No Limit ($1/$2) - 2009/07/01 1:45:03 ET
Table 'kq5zaQ+1hLNf8LZfGnbTAA' 6-max Seat #6 is the button
Seat 1: 8srN1dKQePlsv0GyTada+Q ($420.60 in chips)
Seat 2: nXDI8Y/S6POzRwANu3d8hQ ($140 in chips)
Seat 3: /PH6Ffnho4Ysm8S3V/oa+w ($52.15 in chips)
Seat 4: 3dAbvkxS5NPQTBAbvpinVg ($290.65 in chips)
Seat 5: gnYme0DNFflnMhrdbxe1Ag ($219.35 in chips)
Seat 6: mfy7uGZcqA2PVQqEVbJ7+g ($188.15 in chips)
8srN1dKQePlsv0GyTada+Q: posts small blind $1
nXDI8Y/S6POzRwANu3d8hQ: posts big blind $2
*** HOLE CARDS ***
/PH6Ffnho4Ysm8S3V/oa+w: folds
3dAbvkxS5NPQTBAbvpinVg: folds
gnYme0DNFflnMhrdbxe1Ag: folds
mfy7uGZcqA2PVQqEVbJ7+g: folds
8srN1dKQePlsv0GyTada+Q: raises $4 to $6
nXDI8Y/S6POzRwANu3d8hQ: folds
8srN1dKQePlsv0GyTada+Q collected $4 from pot
8srN1dKQePlsv0GyTada+Q: doesn't show hand
*** SUMMARY ***
Total pot $4 | Rake $0
Seat 1: 8srN1dKQePlsv0GyTada+Q (small blind) collected ($4)
Seat 2: nXDI8Y/S6POzRwANu3d8hQ (big blind) folded before Flop
Seat 3: /PH6Ffnho4Ysm8S3V/oa+w folded before Flop (didn't bet)
Seat 4: 3dAbvkxS5NPQTBAbvpinVg folded before Flop (didn't bet)
Seat 5: gnYme0DNFflnMhrdbxe1Ag folded before Flop (didn't bet)
Seat 6: mfy7uGZcqA2PVQqEVbJ7+g (button) folded before Flop (didn't bet)



PokerStars Game #59941752576:  Hold'em No Limit ($1/$2) - 2009/07/01 1:45:03 ET
Table '5/wEe6JmtGD7vufSA2RG7A' 2-max Seat #2 is the button
Seat 1: pVqEzK9wXlRMECnb1Zg4Zw ($120.10 in chips)
Seat 2: aOL8geThaYp2iadSHl1h1g ($120 in chips)
aOL8geThaYp2iadSHl1h1g: posts small blind $1
pVqEzK9wXlRMECnb1Zg4Zw: posts big blind $2
*** HOLE CARDS ***
aOL8geThaYp2iadSHl1h1g: raises $4 to $6
pVqEzK9wXlRMECnb1Zg4Zw: folds
aOL8geThaYp2iadSHl1h1g collected $4 from pot
aOL8geThaYp2iadSHl1h1g: doesn't show hand
*** SUMMARY ***
Total pot $4 | Rake $0
Seat 1: pVqEzK9wXlRMECnb1Zg4Zw (big blind) folded before Flop
Seat 2: aOL8geThaYp2iadSHl1h1g (button) (small blind) collected ($4)



PokerStars Game #59941753350:  Hold'em No Limit ($1/$2) - 2009/07/01 1:45:04 ET
Table 'P/yCfYl1GfGsu/e6DxDy/A' 2-max Seat #2 is the button
Seat 1: 7fOCUy3x9hdkmXkkDNolGQ ($662.50 in chips)
Seat 2: RwDoM55ZeQuI2ADyJhOb2Q ($812 in chips)
RwDoM55ZeQuI2ADyJhOb2Q: posts small blind $1
7fOCUy3x9hdkmXkkDNolGQ: posts big blind $2
*** HOLE CARDS ***
RwDoM55ZeQuI2ADyJhOb2Q: raises $4 to $6
7fOCUy3x9hdkmXkkDNolGQ: raises $12 to $18
RwDoM55ZeQuI2ADyJhOb2Q: calls $12
*** FLOP *** [Qh 6c 3s]
7fOCUy3x9hdkmXkkDNolGQ: bets $22
RwDoM55ZeQuI2ADyJhOb2Q: calls $22
*** TURN *** [Qh 6c 3s] [4h]
7fOCUy3x9hdkmXkkDNolGQ: bets $55
RwDoM55ZeQuI2ADyJhOb2Q: calls $55
*** RIVER *** [Qh 6c 3s 4h] [5h]
7fOCUy3x9hdkmXkkDNolGQ: checks
RwDoM55ZeQuI2ADyJhOb2Q: bets $282
7fOCUy3x9hdkmXkkDNolGQ: folds
RwDoM55ZeQuI2ADyJhOb2Q collected $189.50 from pot
RwDoM55ZeQuI2ADyJhOb2Q: doesn't show hand
*** SUMMARY ***
Total pot $190 | Rake $0.50
Board [Qh 6c 3s 4h 5h]
Seat 1: 7fOCUy3x9hdkmXkkDNolGQ (big blind) folded on the River
Seat 2: RwDoM55ZeQuI2ADyJhOb2Q (button) (small blind) collected ($189.50)



PokerStars Game #59941753370:  Hold'em No Limit ($1/$2) - 2009/07/01 1:45:04 ET
Table 'mGpP9StWRnoeiBDExc6Frg' 6-max Seat #6 is the button
Seat 1: VvdR9F3I+2yELkfTVvC1dg ($310.15 in chips)
Seat 4: 4dcDwIHRm96PwtqkpQiuiA ($62.70 in chips)
Seat 5: d1puGuVBE0fidn+5eRJ0tw ($200.35 in chips)
Seat 6: B2Ih1sr5VZk+8He7rcrMtQ ($426.45 in chips)
VvdR9F3I+2yELkfTVvC1dg: posts small blind $1
4dcDwIHRm96PwtqkpQiuiA: posts big blind $2
*** HOLE CARDS ***
d1puGuVBE0fidn+5eRJ0tw: calls $2
B2Ih1sr5VZk+8He7rcrMtQ: calls $2
VvdR9F3I+2yELkfTVvC1dg: folds
4dcDwIHRm96PwtqkpQiuiA: checks
*** FLOP *** [4c 2s 5s]
4dcDwIHRm96PwtqkpQiuiA: bets $2
d1puGuVBE0fidn+5eRJ0tw: calls $2
B2Ih1sr5VZk+8He7rcrMtQ: calls $2
*** TURN *** [4c 2s 5s] [Ac]
4dcDwIHRm96PwtqkpQiuiA: checks
d1puGuVBE0fidn+5eRJ0tw: checks
B2Ih1sr5VZk+8He7rcrMtQ: bets $6
4dcDwIHRm96PwtqkpQiuiA: raises $6 to $12
d1puGuVBE0fidn+5eRJ0tw: calls $12
B2Ih1sr5VZk+8He7rcrMtQ: calls $6
*** RIVER *** [4c 2s 5s Ac] [9d]
4dcDwIHRm96PwtqkpQiuiA: checks
d1puGuVBE0fidn+5eRJ0tw: checks
B2Ih1sr5VZk+8He7rcrMtQ: checks
*** SHOW DOWN ***
4dcDwIHRm96PwtqkpQiuiA: shows [3h As] (a straight, Ace to Five)
d1puGuVBE0fidn+5eRJ0tw: mucks hand
B2Ih1sr5VZk+8He7rcrMtQ: mucks hand
4dcDwIHRm96PwtqkpQiuiA collected $47 from pot
*** SUMMARY ***
Total pot $49 | Rake $2
Board [4c 2s 5s Ac 9d]
Seat 1: VvdR9F3I+2yELkfTVvC1dg (small blind) folded before Flop
Seat 4: 4dcDwIHRm96PwtqkpQiuiA (big blind) showed [3h As] and won ($47) with a straight, Ace to Five
Seat 5: d1puGuVBE0fidn+5eRJ0tw mucked
Seat 6: B2Ih1sr5VZk+8He7rcrMtQ (button) mucked



PokerStars Game #59941753856:  Hold'em No Limit ($1/$2) - 2009/07/01 1:45:05 ET
Table 'aSf77Sj8QEnzcc0WaxVD4Q' 6-max Seat #5 is the button
Seat 1: UELtvp+JfwI7XDGVwSxZXA ($232.95 in chips)
Seat 2: vkfxu8f/jMYKUk6Ly4eujw ($214.20 in chips)
Seat 3: 9dpyyjDTCed6nV7JhaUUpw ($740.75 in chips)
Seat 4: YsLQ3BAvgQHWXMAv3Wv6Hg ($200 in chips)
Seat 5: VvdR9F3I+2yELkfTVvC1dg ($262.90 in chips)
Seat 6: vkoJRf3gidxY1pPi0AFWww ($142.75 in chips)
vkoJRf3gidxY1pPi0AFWww: posts small blind $1
UELtvp+JfwI7XDGVwSxZXA: posts big blind $2
*** HOLE CARDS ***
vkfxu8f/jMYKUk6Ly4eujw: folds
9dpyyjDTCed6nV7JhaUUpw: folds
YsLQ3BAvgQHWXMAv3Wv6Hg: folds
VvdR9F3I+2yELkfTVvC1dg: raises $2 to $4
vkoJRf3gidxY1pPi0AFWww: raises $4 to $8
UELtvp+JfwI7XDGVwSxZXA: folds
VvdR9F3I+2yELkfTVvC1dg: calls $4
*** FLOP *** [Kh 3d 6d]
vkoJRf3gidxY1pPi0AFWww: bets $12
VvdR9F3I+2yELkfTVvC1dg: folds
vkoJRf3gidxY1pPi0AFWww collected $17.10 from pot
vkoJRf3gidxY1pPi0AFWww: doesn't show hand
*** SUMMARY ***
Total pot $18 | Rake $0.90
Board [Kh 3d 6d]
Seat 1: UELtvp+JfwI7XDGVwSxZXA (big blind) folded before Flop
Seat 2: vkfxu8f/jMYKUk6Ly4eujw folded before Flop (didn't bet)
Seat 3: 9dpyyjDTCed6nV7JhaUUpw folded before Flop (didn't bet)
Seat 4: YsLQ3BAvgQHWXMAv3Wv6Hg folded before Flop (didn't bet)
Seat 5: VvdR9F3I+2yELkfTVvC1dg (button) folded on the Flop
Seat 6: vkoJRf3gidxY1pPi0AFWww (small blind) collected ($17.10)



PokerStars Game #59941755636:  Hold'em No Limit ($1/$2) - 2009/07/01 1:45:08 ET
Table 'uJ9juaXXg9yIcSU8amxaXQ' 6-max Seat #4 is the button
Seat 1: JsqOjN/eHz0uYVf/PyUJ6Q ($146.25 in chips)
Seat 2: VvdR9F3I+2yELkfTVvC1dg ($200.30 in chips)
Seat 3: qXDd0ZyMIse0OBu8pxeQ3Q ($243.40 in chips)
Seat 4: zNjJ/y4emmF+vzrCDd+ooA ($255.80 in chips)
Seat 5: YsLQ3BAvgQHWXMAv3Wv6Hg ($210.70 in chips)
Seat 6: /PH6Ffnho4Ysm8S3V/oa+w ($40 in chips)
YsLQ3BAvgQHWXMAv3Wv6Hg: posts small blind $1
/PH6Ffnho4Ysm8S3V/oa+w: posts big blind $2
*** HOLE CARDS ***
JsqOjN/eHz0uYVf/PyUJ6Q: folds
VvdR9F3I+2yELkfTVvC1dg: folds
qXDd0ZyMIse0OBu8pxeQ3Q: folds
zNjJ/y4emmF+vzrCDd+ooA: folds
YsLQ3BAvgQHWXMAv3Wv6Hg: raises $4 to $6
/PH6Ffnho4Ysm8S3V/oa+w: folds
YsLQ3BAvgQHWXMAv3Wv6Hg collected $4 from pot
YsLQ3BAvgQHWXMAv3Wv6Hg: doesn't show hand
*** SUMMARY ***
Total pot $4 | Rake $0
Seat 1: JsqOjN/eHz0uYVf/PyUJ6Q folded before Flop (didn't bet)
Seat 2: VvdR9F3I+2yELkfTVvC1dg folded before Flop (didn't bet)
Seat 3: qXDd0ZyMIse0OBu8pxeQ3Q folded before Flop (didn't bet)
Seat 4: zNjJ/y4emmF+vzrCDd+ooA (button) folded before Flop (didn't bet)
Seat 5: YsLQ3BAvgQHWXMAv3Wv6Hg (small blind) collected ($4)
Seat 6: /PH6Ffnho4Ysm8S3V/oa+w (big blind) folded before Flop



PokerStars Game #59941755194:  Hold'em No Limit ($1/$2) - 2009/07/01 1:45:08 ET
Table 'TsEDkiO4tzCTCzJ7tNdEqw' 6-max Seat #4 is the button
Seat 1: vkfxu8f/jMYKUk6Ly4eujw ($197 in chips)
Seat 2: 4dcDwIHRm96PwtqkpQiuiA ($82.65 in chips)
Seat 3: ubtx4Z5L+AcK71MTvYiGVw ($267.85 in chips)
Seat 4: K8MXCrNAVYlMnnCeM32Kxw ($123 in chips)
Seat 5: VvdR9F3I+2yELkfTVvC1dg ($247.35 in chips)
Seat 6: uCqEjnxh2/vFBjKYkfTOkw ($289.80 in chips)
VvdR9F3I+2yELkfTVvC1dg: posts small blind $1
uCqEjnxh2/vFBjKYkfTOkw: posts big blind $2
*** HOLE CARDS ***
vkfxu8f/jMYKUk6Ly4eujw: folds
4dcDwIHRm96PwtqkpQiuiA has timed out
4dcDwIHRm96PwtqkpQiuiA: folds
4dcDwIHRm96PwtqkpQiuiA is sitting out
ubtx4Z5L+AcK71MTvYiGVw: folds
K8MXCrNAVYlMnnCeM32Kxw: folds
VvdR9F3I+2yELkfTVvC1dg: folds
uCqEjnxh2/vFBjKYkfTOkw collected $2 from pot
uCqEjnxh2/vFBjKYkfTOkw: doesn't show hand
*** SUMMARY ***
Total pot $2 | Rake $0
Seat 1: vkfxu8f/jMYKUk6Ly4eujw folded before Flop (didn't bet)
Seat 2: 4dcDwIHRm96PwtqkpQiuiA folded before Flop (didn't bet)
Seat 3: ubtx4Z5L+AcK71MTvYiGVw folded before Flop (didn't bet)
Seat 4: K8MXCrNAVYlMnnCeM32Kxw (button) folded before Flop (didn't bet)
Seat 5: VvdR9F3I+2yELkfTVvC1dg (small blind) folded before Flop
Seat 6: uCqEjnxh2/vFBjKYkfTOkw (big blind) collected ($2)



PokerStars Game #59941755608:  Hold'em No Limit ($1/$2) - 2009/07/01 1:45:08 ET
Table 'on4i1U1lCRmxsduFD3xiSg' 9-max Seat #3 is the button
Seat 1: so5k3vFDmokh2q3dImJ1GQ ($173.30 in chips)
Seat 2: NqSvZNzJ4RkR3sCmgQnyLw ($75.25 in chips)
Seat 3: GX1heJ+DSsvm7gzSPsYhhQ ($39 in chips)
Seat 4: DFQVuszLVclqjA46pN4Vvw ($65.80 in chips)
Seat 5: 37j/5DgMG5m9lMfFofEAOg ($50.70 in chips)
Seat 7: /inIs/z/PcX+TniIFpaxpg ($268.05 in chips)
Seat 8: ZYHoLw2lWmRS7CSHi8L8Xg ($200 in chips)
Seat 9: TAfo4veNRaRlzDXMMYS3Jg ($82 in chips)
DFQVuszLVclqjA46pN4Vvw: posts small blind $1
37j/5DgMG5m9lMfFofEAOg: posts big blind $2
KqHysDSpCPaPyK3tJC1aEw: sits out
*** HOLE CARDS ***
/inIs/z/PcX+TniIFpaxpg: folds
ZYHoLw2lWmRS7CSHi8L8Xg: folds
TAfo4veNRaRlzDXMMYS3Jg: folds
so5k3vFDmokh2q3dImJ1GQ: raises $2 to $4
NqSvZNzJ4RkR3sCmgQnyLw: folds
GX1heJ+DSsvm7gzSPsYhhQ: folds
DFQVuszLVclqjA46pN4Vvw: folds
37j/5DgMG5m9lMfFofEAOg: calls $2
*** FLOP *** [Td 2h 2s]
37j/5DgMG5m9lMfFofEAOg: checks
so5k3vFDmokh2q3dImJ1GQ: checks
*** TURN *** [Td 2h 2s] [Qs]
37j/5DgMG5m9lMfFofEAOg: bets $4
so5k3vFDmokh2q3dImJ1GQ: raises $8 to $12
37j/5DgMG5m9lMfFofEAOg: folds
so5k3vFDmokh2q3dImJ1GQ collected $16.20 from pot
*** SUMMARY ***
Total pot $17 | Rake $0.80
Board [Td 2h 2s Qs]
Seat 1: so5k3vFDmokh2q3dImJ1GQ collected ($16.20)
Seat 2: NqSvZNzJ4RkR3sCmgQnyLw folded before Flop (didn't bet)
Seat 3: GX1heJ+DSsvm7gzSPsYhhQ (button) folded before Flop (didn't bet)
Seat 4: DFQVuszLVclqjA46pN4Vvw (small blind) folded before Flop
Seat 5: 37j/5DgMG5m9lMfFofEAOg (big blind) folded on the Turn
Seat 7: /inIs/z/PcX+TniIFpaxpg folded before Flop (didn't bet)
Seat 8: ZYHoLw2lWmRS7CSHi8L8Xg folded before Flop (didn't bet)
Seat 9: TAfo4veNRaRlzDXMMYS3Jg folded before Flop (didn't bet)



PokerStars Game #59941755176:  Hold'em No Limit ($1/$2) - 2009/07/01 1:45:08 ET
Table 'NmY84NAf9Mh0ckAckHnh5g' 2-max Seat #2 is the button
Seat 1: 6hvg964TSqZ3AL/0XK9aVQ ($668.45 in chips)
Seat 2: RwDoM55ZeQuI2ADyJhOb2Q ($320.25 in chips)
RwDoM55ZeQuI2ADyJhOb2Q: posts small blind $1
6hvg964TSqZ3AL/0XK9aVQ: posts big blind $2
*** HOLE CARDS ***
RwDoM55ZeQuI2ADyJhOb2Q: raises $4 to $6
6hvg964TSqZ3AL/0XK9aVQ: folds
RwDoM55ZeQuI2ADyJhOb2Q collected $4 from pot
RwDoM55ZeQuI2ADyJhOb2Q: doesn't show hand
*** SUMMARY ***
Total pot $4 | Rake $0
Seat 1: 6hvg964TSqZ3AL/0XK9aVQ (big blind) folded before Flop
Seat 2: RwDoM55ZeQuI2ADyJhOb2Q (button) (small blind) collected ($4)



PokerStars Game #59941755862:  Hold'em No Limit ($1/$2) - 2009/07/01 1:45:09 ET
Table 'jlrIxbrVIG+gjaUYT4za8g' 6-max Seat #4 is the button
Seat 1: ygTTt5ehT4aF86q1a8/R+w ($235.30 in chips)
Seat 3: gnYme0DNFflnMhrdbxe1Ag ($200 in chips)
Seat 4: 8srN1dKQePlsv0GyTada+Q ($265.70 in chips)
Seat 5: AyBB0k3Dcl7xbXUeGMw06g ($39.15 in chips)
Seat 6: BWhgxe7gWiYobRbwdG+d2Q ($199 in chips)
AyBB0k3Dcl7xbXUeGMw06g: posts small blind $1
BWhgxe7gWiYobRbwdG+d2Q: posts big blind $2
cwfuMyvDC7J7SqX2leDC8g: sits out
*** HOLE CARDS ***
ygTTt5ehT4aF86q1a8/R+w: folds
gnYme0DNFflnMhrdbxe1Ag: folds
ygTTt5ehT4aF86q1a8/R+w leaves the table
8srN1dKQePlsv0GyTada+Q: raises $4 to $6
AyBB0k3Dcl7xbXUeGMw06g: folds
BWhgxe7gWiYobRbwdG+d2Q: folds
8srN1dKQePlsv0GyTada+Q collected $5 from pot
*** SUMMARY ***
Total pot $5 | Rake $0
Seat 1: ygTTt5ehT4aF86q1a8/R+w folded before Flop (didn't bet)
Seat 3: gnYme0DNFflnMhrdbxe1Ag folded before Flop (didn't bet)
Seat 4: 8srN1dKQePlsv0GyTada+Q (button) collected ($5)
Seat 5: AyBB0k3Dcl7xbXUeGMw06g (small blind) folded before Flop
Seat 6: BWhgxe7gWiYobRbwdG+d2Q (big blind) folded before Flop



PokerStars Game #59941756796:  Hold'em No Limit ($1/$2) - 2009/07/01 1:45:11 ET
Table '5/wEe6JmtGD7vufSA2RG7A' 2-max Seat #1 is the button
Seat 1: pVqEzK9wXlRMECnb1Zg4Zw ($118.10 in chips)
Seat 2: aOL8geThaYp2iadSHl1h1g ($122 in chips)
pVqEzK9wXlRMECnb1Zg4Zw: posts small blind $1
aOL8geThaYp2iadSHl1h1g: posts big blind $2
*** HOLE CARDS ***
pVqEzK9wXlRMECnb1Zg4Zw: raises $6 to $8
aOL8geThaYp2iadSHl1h1g: folds
pVqEzK9wXlRMECnb1Zg4Zw collected $4 from pot
pVqEzK9wXlRMECnb1Zg4Zw: doesn't show hand
*** SUMMARY ***
Total pot $4 | Rake $0
Seat 1: pVqEzK9wXlRMECnb1Zg4Zw (button) (small blind) collected ($4)
Seat 2: aOL8geThaYp2iadSHl1h1g (big blind) folded before Flop



PokerStars Game #59941758344:  Hold'em No Limit ($1/$2) - 2009/07/01 1:45:13 ET
Table 'CFkQcfWjKccZaZDf71FK+w' 6-max Seat #4 is the button
Seat 1: vkfxu8f/jMYKUk6Ly4eujw ($227.25 in chips)
Seat 2: ewN/vzF22+/gdzjIKBOlkA ($200 in chips)
Seat 3: 09BNF4quPDzanQzM8vc6WA ($88.30 in chips)
Seat 4: ygTTt5ehT4aF86q1a8/R+w ($240.35 in chips)
Seat 5: 2lOU1DcvUZaMcxZ95XfzXw ($155.05 in chips)
Seat 6: ORVqY3rf9X6ANA/8s+On2Q ($42.35 in chips)
2lOU1DcvUZaMcxZ95XfzXw: posts small blind $1
ORVqY3rf9X6ANA/8s+On2Q: posts big blind $2
*** HOLE CARDS ***
vkfxu8f/jMYKUk6Ly4eujw: folds
ewN/vzF22+/gdzjIKBOlkA: folds
09BNF4quPDzanQzM8vc6WA: folds
ygTTt5ehT4aF86q1a8/R+w: raises $4 to $6
2lOU1DcvUZaMcxZ95XfzXw: calls $5
ORVqY3rf9X6ANA/8s+On2Q: folds
*** FLOP *** [Qc Ah 9h]
2lOU1DcvUZaMcxZ95XfzXw: checks
ygTTt5ehT4aF86q1a8/R+w: bets $9
2lOU1DcvUZaMcxZ95XfzXw: folds
ygTTt5ehT4aF86q1a8/R+w collected $13.30 from pot
*** SUMMARY ***
Total pot $14 | Rake $0.70
Board [Qc Ah 9h]
Seat 1: vkfxu8f/jMYKUk6Ly4eujw folded before Flop (didn't bet)
Seat 2: ewN/vzF22+/gdzjIKBOlkA folded before Flop (didn't bet)
Seat 3: 09BNF4quPDzanQzM8vc6WA folded before Flop (didn't bet)
Seat 4: ygTTt5ehT4aF86q1a8/R+w (button) collected ($13.30)
Seat 5: 2lOU1DcvUZaMcxZ95XfzXw (small blind) folded on the Flop
Seat 6: ORVqY3rf9X6ANA/8s+On2Q (big blind) folded before Flop



PokerStars Game #59941758404:  Hold'em No Limit ($1/$2) - 2009/07/01 1:45:14 ET
Table 'ztv6V3FN2bQ9nmJPPdx6nQ' 6-max Seat #3 is the button
Seat 1: 6fLdOUCRtX71xbVRhJEq8w ($230.35 in chips)
Seat 2: 5Y+ZGWLI4gnlpApDX5vy1A ($433.85 in chips)
Seat 3: ubtx4Z5L+AcK71MTvYiGVw ($241.20 in chips)
Seat 4: UaZ5yj+6LjtWqMQg2QskUw ($60.30 in chips)
Seat 5: sTPOWERd9HWPCNrDBwsVjA ($220.60 in chips)
Seat 6: mfy7uGZcqA2PVQqEVbJ7+g ($106.60 in chips)
UaZ5yj+6LjtWqMQg2QskUw: posts small blind $1
sTPOWERd9HWPCNrDBwsVjA: posts big blind $2
*** HOLE CARDS ***
mfy7uGZcqA2PVQqEVbJ7+g: folds
6fLdOUCRtX71xbVRhJEq8w: folds
5Y+ZGWLI4gnlpApDX5vy1A: folds
ubtx4Z5L+AcK71MTvYiGVw: folds
UaZ5yj+6LjtWqMQg2QskUw: folds
sTPOWERd9HWPCNrDBwsVjA collected $2 from pot
*** SUMMARY ***
Total pot $2 | Rake $0
Seat 1: 6fLdOUCRtX71xbVRhJEq8w folded before Flop (didn't bet)
Seat 2: 5Y+ZGWLI4gnlpApDX5vy1A folded before Flop (didn't bet)
Seat 3: ubtx4Z5L+AcK71MTvYiGVw (button) folded before Flop (didn't bet)
Seat 4: UaZ5yj+6LjtWqMQg2QskUw (small blind) folded before Flop
Seat 5: sTPOWERd9HWPCNrDBwsVjA (big blind) collected ($2)
Seat 6: mfy7uGZcqA2PVQqEVbJ7+g folded before Flop (didn't bet)



PokerStars Game #59941759804:  Hold'em No Limit ($1/$2) - 2009/07/01 1:45:16 ET
Table 'NmY84NAf9Mh0ckAckHnh5g' 2-max Seat #1 is the button
Seat 1: 6hvg964TSqZ3AL/0XK9aVQ ($666.45 in chips)
Seat 2: RwDoM55ZeQuI2ADyJhOb2Q ($322.25 in chips)
6hvg964TSqZ3AL/0XK9aVQ: posts small blind $1
RwDoM55ZeQuI2ADyJhOb2Q: posts big blind $2
*** HOLE CARDS ***
6hvg964TSqZ3AL/0XK9aVQ: folds
RwDoM55ZeQuI2ADyJhOb2Q collected $2 from pot
RwDoM55ZeQuI2ADyJhOb2Q: doesn't show hand
*** SUMMARY ***
Total pot $2 | Rake $0
Seat 1: 6hvg964TSqZ3AL/0XK9aVQ (button) (small blind) folded before Flop
Seat 2: RwDoM55ZeQuI2ADyJhOb2Q (big blind) collected ($2)



PokerStars Game #59941760632:  Hold'em No Limit ($1/$2) - 2009/07/01 1:45:18 ET
Table '/dyk+YdRGv90j2box35j8w' 6-max Seat #2 is the button
Seat 1: 8srN1dKQePlsv0GyTada+Q ($203 in chips)
Seat 2: qCnEYuAE5y5A7bk6fO5/jQ ($496.20 in chips)
Seat 3: sTPOWERd9HWPCNrDBwsVjA ($204.50 in chips)
Seat 5: VvdR9F3I+2yELkfTVvC1dg ($259.80 in chips)
Seat 6: gnYme0DNFflnMhrdbxe1Ag ($200 in chips)
sTPOWERd9HWPCNrDBwsVjA: posts small blind $1
VvdR9F3I+2yELkfTVvC1dg: posts big blind $2
*** HOLE CARDS ***
gnYme0DNFflnMhrdbxe1Ag: folds
8srN1dKQePlsv0GyTada+Q: folds
qCnEYuAE5y5A7bk6fO5/jQ: folds
sTPOWERd9HWPCNrDBwsVjA: folds
VvdR9F3I+2yELkfTVvC1dg collected $2 from pot
VvdR9F3I+2yELkfTVvC1dg: doesn't show hand
4dMBh/1VTdeUTPCyhCs3UQ joins the table at seat #4
*** SUMMARY ***
Total pot $2 | Rake $0
Seat 1: 8srN1dKQePlsv0GyTada+Q folded before Flop (didn't bet)
Seat 2: qCnEYuAE5y5A7bk6fO5/jQ (button) folded before Flop (didn't bet)
Seat 3: sTPOWERd9HWPCNrDBwsVjA (small blind) folded before Flop
Seat 5: VvdR9F3I+2yELkfTVvC1dg (big blind) collected ($2)
Seat 6: gnYme0DNFflnMhrdbxe1Ag folded before Flop (didn't bet)



PokerStars Game #59941762064:  Hold'em No Limit ($1/$2) - 2009/07/01 1:45:20 ET
Table '5/wEe6JmtGD7vufSA2RG7A' 2-max Seat #2 is the button
Seat 1: pVqEzK9wXlRMECnb1Zg4Zw ($120.10 in chips)
Seat 2: aOL8geThaYp2iadSHl1h1g ($120 in chips)
aOL8geThaYp2iadSHl1h1g: posts small blind $1
pVqEzK9wXlRMECnb1Zg4Zw: posts big blind $2
*** HOLE CARDS ***
aOL8geThaYp2iadSHl1h1g: raises $4 to $6
pVqEzK9wXlRMECnb1Zg4Zw: raises $16 to $22
aOL8geThaYp2iadSHl1h1g: folds
pVqEzK9wXlRMECnb1Zg4Zw collected $12 from pot
pVqEzK9wXlRMECnb1Zg4Zw: doesn't show hand
*** SUMMARY ***
Total pot $12 | Rake $0
Seat 1: pVqEzK9wXlRMECnb1Zg4Zw (big blind) collected ($12)
Seat 2: aOL8geThaYp2iadSHl1h1g (button) (small blind) folded before Flop



PokerStars Game #59941763142:  Hold'em No Limit ($1/$2) - 2009/07/01 1:45:22 ET
Table 'NmY84NAf9Mh0ckAckHnh5g' 2-max Seat #2 is the button
Seat 1: 6hvg964TSqZ3AL/0XK9aVQ ($665.45 in chips)
Seat 2: RwDoM55ZeQuI2ADyJhOb2Q ($323.25 in chips)
RwDoM55ZeQuI2ADyJhOb2Q: posts small blind $1
6hvg964TSqZ3AL/0XK9aVQ: posts big blind $2
*** HOLE CARDS ***
RwDoM55ZeQuI2ADyJhOb2Q: folds
6hvg964TSqZ3AL/0XK9aVQ collected $2 from pot
6hvg964TSqZ3AL/0XK9aVQ: doesn't show hand
*** SUMMARY ***
Total pot $2 | Rake $0
Seat 1: 6hvg964TSqZ3AL/0XK9aVQ (big blind) collected ($2)
Seat 2: RwDoM55ZeQuI2ADyJhOb2Q (button) (small blind) folded before Flop



PokerStars Game #59941765202:  Hold'em No Limit ($1/$2) - 2009/07/01 1:45:26 ET
Table 'kq5zaQ+1hLNf8LZfGnbTAA' 6-max Seat #1 is the button
Seat 1: 8srN1dKQePlsv0GyTada+Q ($422.60 in chips)
Seat 2: nXDI8Y/S6POzRwANu3d8hQ ($138 in chips)
Seat 3: /PH6Ffnho4Ysm8S3V/oa+w ($52.15 in chips)
Seat 4: 3dAbvkxS5NPQTBAbvpinVg ($290.65 in chips)
Seat 5: gnYme0DNFflnMhrdbxe1Ag ($219.35 in chips)
Seat 6: mfy7uGZcqA2PVQqEVbJ7+g ($188.15 in chips)
nXDI8Y/S6POzRwANu3d8hQ: posts small blind $1
/PH6Ffnho4Ysm8S3V/oa+w: posts big blind $2
*** HOLE CARDS ***
3dAbvkxS5NPQTBAbvpinVg: folds
gnYme0DNFflnMhrdbxe1Ag: folds
mfy7uGZcqA2PVQqEVbJ7+g: folds
8srN1dKQePlsv0GyTada+Q: raises $4 to $6
nXDI8Y/S6POzRwANu3d8hQ: folds
/PH6Ffnho4Ysm8S3V/oa+w: folds
8srN1dKQePlsv0GyTada+Q collected $5 from pot
8srN1dKQePlsv0GyTada+Q: doesn't show hand
*** SUMMARY ***
Total pot $5 | Rake $0
Seat 1: 8srN1dKQePlsv0GyTada+Q (button) collected ($5)
Seat 2: nXDI8Y/S6POzRwANu3d8hQ (small blind) folded before Flop
Seat 3: /PH6Ffnho4Ysm8S3V/oa+w (big blind) folded before Flop
Seat 4: 3dAbvkxS5NPQTBAbvpinVg folded before Flop (didn't bet)
Seat 5: gnYme0DNFflnMhrdbxe1Ag folded before Flop (didn't bet)
Seat 6: mfy7uGZcqA2PVQqEVbJ7+g folded before Flop (didn't bet)



PokerStars Game #59941765582:  Hold'em No Limit ($1/$2) - 2009/07/01 1:45:27 ET
Table 'ztv6V3FN2bQ9nmJPPdx6nQ' 6-max Seat #4 is the button
Seat 1: 6fLdOUCRtX71xbVRhJEq8w ($230.35 in chips)
Seat 2: 5Y+ZGWLI4gnlpApDX5vy1A ($433.85 in chips)
Seat 3: ubtx4Z5L+AcK71MTvYiGVw ($241.20 in chips)
Seat 4: UaZ5yj+6LjtWqMQg2QskUw ($59.30 in chips)
Seat 5: sTPOWERd9HWPCNrDBwsVjA ($221.60 in chips)
Seat 6: mfy7uGZcqA2PVQqEVbJ7+g ($106.60 in chips)
sTPOWERd9HWPCNrDBwsVjA: posts small blind $1
mfy7uGZcqA2PVQqEVbJ7+g: posts big blind $2
*** HOLE CARDS ***
6fLdOUCRtX71xbVRhJEq8w: folds
5Y+ZGWLI4gnlpApDX5vy1A has timed out
5Y+ZGWLI4gnlpApDX5vy1A: folds
5Y+ZGWLI4gnlpApDX5vy1A is sitting out
5Y+ZGWLI4gnlpApDX5vy1A has returned
ubtx4Z5L+AcK71MTvYiGVw: folds
UaZ5yj+6LjtWqMQg2QskUw: calls $2
sTPOWERd9HWPCNrDBwsVjA: calls $1
mfy7uGZcqA2PVQqEVbJ7+g: checks
*** FLOP *** [3s 6c 5c]
sTPOWERd9HWPCNrDBwsVjA: checks
mfy7uGZcqA2PVQqEVbJ7+g: checks
UaZ5yj+6LjtWqMQg2QskUw: checks
*** TURN *** [3s 6c 5c] [7d]
sTPOWERd9HWPCNrDBwsVjA: checks
mfy7uGZcqA2PVQqEVbJ7+g: bets $4
UaZ5yj+6LjtWqMQg2QskUw: calls $4
sTPOWERd9HWPCNrDBwsVjA: folds
*** RIVER *** [3s 6c 5c 7d] [Tc]
mfy7uGZcqA2PVQqEVbJ7+g: checks
UaZ5yj+6LjtWqMQg2QskUw: checks
*** SHOW DOWN ***
mfy7uGZcqA2PVQqEVbJ7+g: shows [9d 5d] (a pair of Fives)
UaZ5yj+6LjtWqMQg2QskUw: shows [7s As] (a pair of Sevens)
UaZ5yj+6LjtWqMQg2QskUw collected $13.35 from pot
*** SUMMARY ***
Total pot $14 | Rake $0.65
Board [3s 6c 5c 7d Tc]
Seat 1: 6fLdOUCRtX71xbVRhJEq8w folded before Flop (didn't bet)
Seat 2: 5Y+ZGWLI4gnlpApDX5vy1A folded before Flop (didn't bet)
Seat 3: ubtx4Z5L+AcK71MTvYiGVw folded before Flop (didn't bet)
Seat 4: UaZ5yj+6LjtWqMQg2QskUw (button) showed [7s As] and won ($13.35) with a pair of Sevens
Seat 5: sTPOWERd9HWPCNrDBwsVjA (small blind) folded on the Turn
Seat 6: mfy7uGZcqA2PVQqEVbJ7+g (big blind) showed [9d 5d] and lost with a pair of Fives



PokerStars Game #59941766152:  Hold'em No Limit ($1/$2) - 2009/07/01 1:45:28 ET
Table 'G1Oqdy4Pqdb5gtx40rUBzA' 6-max Seat #6 is the button
Seat 2: m7mYVfnCOK5TE/VkN/FhOg ($210.05 in chips)
Seat 3: VvdR9F3I+2yELkfTVvC1dg ($218.65 in chips)
Seat 4: B87ikIyZ/TzAVeXf38Ny0g ($217.70 in chips)
Seat 5: F1+Ml47qRQWunzPnGhLLzQ ($200 in chips)
Seat 6: qCnEYuAE5y5A7bk6fO5/jQ ($208.25 in chips)
m7mYVfnCOK5TE/VkN/FhOg: posts small blind $1
VvdR9F3I+2yELkfTVvC1dg: posts big blind $2
*** HOLE CARDS ***
B87ikIyZ/TzAVeXf38Ny0g: folds
F1+Ml47qRQWunzPnGhLLzQ: folds
qCnEYuAE5y5A7bk6fO5/jQ: raises $4 to $6
m7mYVfnCOK5TE/VkN/FhOg: folds
VvdR9F3I+2yELkfTVvC1dg: raises $15 to $21
qCnEYuAE5y5A7bk6fO5/jQ: calls $15
*** FLOP *** [Js 6s 8h]
4dMBh/1VTdeUTPCyhCs3UQ joins the table at seat #1
VvdR9F3I+2yELkfTVvC1dg: bets $32.75
qCnEYuAE5y5A7bk6fO5/jQ: calls $32.75
*** TURN *** [Js 6s 8h] [8c]
VvdR9F3I+2yELkfTVvC1dg: bets $75.75
qCnEYuAE5y5A7bk6fO5/jQ: calls $75.75
*** RIVER *** [Js 6s 8h 8c] [3d]
VvdR9F3I+2yELkfTVvC1dg: bets $89.15 and is all-in
qCnEYuAE5y5A7bk6fO5/jQ: calls $78.75 and is all-in
*** SHOW DOWN ***
VvdR9F3I+2yELkfTVvC1dg: shows [Ac Ah] (two pair, Aces and Eights)
qCnEYuAE5y5A7bk6fO5/jQ: mucks hand
VvdR9F3I+2yELkfTVvC1dg collected $415.50 from pot
*** SUMMARY ***
Total pot $417.50 | Rake $2
Board [Js 6s 8h 8c 3d]
Seat 2: m7mYVfnCOK5TE/VkN/FhOg (small blind) folded before Flop
Seat 3: VvdR9F3I+2yELkfTVvC1dg (big blind) showed [Ac Ah] and won ($415.50) with two pair, Aces and Eights
Seat 4: B87ikIyZ/TzAVeXf38Ny0g folded before Flop (didn't bet)
Seat 5: F1+Ml47qRQWunzPnGhLLzQ folded before Flop (didn't bet)
Seat 6: qCnEYuAE5y5A7bk6fO5/jQ (button) mucked



PokerStars Game #59941766466:  Hold'em No Limit ($1/$2) - 2009/07/01 1:45:29 ET
Table 'YqGfR5eHfMeSjb9a+QU9rg' 9-max Seat #5 is the button
Seat 1: rW/MyplHylMSBRaoRUzWrg ($76 in chips)
Seat 2: nXDI8Y/S6POzRwANu3d8hQ ($37 in chips)
Seat 4: GX1heJ+DSsvm7gzSPsYhhQ ($36 in chips)
Seat 5: CkE3IyJF1KvdaAOmZY5XqQ ($213.40 in chips)
Seat 6: TAfo4veNRaRlzDXMMYS3Jg ($38 in chips)
Seat 7: 41aZuLBz9nAi2GPVKabmCw ($82.95 in chips)
Seat 8: JnV3SM2D6dAFYyGZHHpvrg ($102.15 in chips)
Seat 9: /inIs/z/PcX+TniIFpaxpg ($202.20 in chips)
TAfo4veNRaRlzDXMMYS3Jg: posts small blind $1
41aZuLBz9nAi2GPVKabmCw: posts big blind $2
KqHysDSpCPaPyK3tJC1aEw: sits out
*** HOLE CARDS ***
JnV3SM2D6dAFYyGZHHpvrg: folds
/inIs/z/PcX+TniIFpaxpg: folds
rW/MyplHylMSBRaoRUzWrg: folds
nXDI8Y/S6POzRwANu3d8hQ: folds
GX1heJ+DSsvm7gzSPsYhhQ: folds
CkE3IyJF1KvdaAOmZY5XqQ: folds
TAfo4veNRaRlzDXMMYS3Jg: raises $36 to $38 and is all-in
41aZuLBz9nAi2GPVKabmCw: folds
TAfo4veNRaRlzDXMMYS3Jg collected $4 from pot
TAfo4veNRaRlzDXMMYS3Jg: doesn't show hand
*** SUMMARY ***
Total pot $4 | Rake $0
Seat 1: rW/MyplHylMSBRaoRUzWrg folded before Flop (didn't bet)
Seat 2: nXDI8Y/S6POzRwANu3d8hQ folded before Flop (didn't bet)
Seat 4: GX1heJ+DSsvm7gzSPsYhhQ folded before Flop (didn't bet)
Seat 5: CkE3IyJF1KvdaAOmZY5XqQ (button) folded before Flop (didn't bet)
Seat 6: TAfo4veNRaRlzDXMMYS3Jg (small blind) collected ($4)
Seat 7: 41aZuLBz9nAi2GPVKabmCw (big blind) folded before Flop
Seat 8: JnV3SM2D6dAFYyGZHHpvrg folded before Flop (didn't bet)
Seat 9: /inIs/z/PcX+TniIFpaxpg folded before Flop (didn't bet)



PokerStars Game #59941766492:  Hold'em No Limit ($1/$2) - 2009/07/01 1:45:29 ET
Table 'NmY84NAf9Mh0ckAckHnh5g' 2-max Seat #1 is the button
Seat 1: 6hvg964TSqZ3AL/0XK9aVQ ($666.45 in chips)
Seat 2: RwDoM55ZeQuI2ADyJhOb2Q ($322.25 in chips)
6hvg964TSqZ3AL/0XK9aVQ: posts small blind $1
RwDoM55ZeQuI2ADyJhOb2Q: posts big blind $2
*** HOLE CARDS ***
6hvg964TSqZ3AL/0XK9aVQ: calls $1
RwDoM55ZeQuI2ADyJhOb2Q: checks
*** FLOP *** [9d 3c Ac]
RwDoM55ZeQuI2ADyJhOb2Q: checks
6hvg964TSqZ3AL/0XK9aVQ: checks
*** TURN *** [9d 3c Ac] [9s]
RwDoM55ZeQuI2ADyJhOb2Q: checks
6hvg964TSqZ3AL/0XK9aVQ: checks
*** RIVER *** [9d 3c Ac 9s] [8d]
RwDoM55ZeQuI2ADyJhOb2Q: checks
6hvg964TSqZ3AL/0XK9aVQ: checks
*** SHOW DOWN ***
RwDoM55ZeQuI2ADyJhOb2Q: shows [Tc 5h] (a pair of Nines)
6hvg964TSqZ3AL/0XK9aVQ: shows [2h 2s] (two pair, Nines and Deuces)
6hvg964TSqZ3AL/0XK9aVQ collected $3.80 from pot
*** SUMMARY ***
Total pot $4 | Rake $0.20
Board [9d 3c Ac 9s 8d]
Seat 1: 6hvg964TSqZ3AL/0XK9aVQ (button) (small blind) showed [2h 2s] and won ($3.80) with two pair, Nines and Deuces
Seat 2: RwDoM55ZeQuI2ADyJhOb2Q (big blind) showed [Tc 5h] and lost with a pair of Nines



PokerStars Game #59941767396:  Hold'em No Limit ($1/$2) - 2009/07/01 1:45:30 ET
Table 'bJQ024BaYSBrW0sXpCZbNQ' 6-max Seat #3 is the button
Seat 1: KfwW5us6tydK81NYTtK1gw ($200 in chips)
Seat 2: 3dAbvkxS5NPQTBAbvpinVg ($274 in chips)
Seat 3: /PH6Ffnho4Ysm8S3V/oa+w ($40 in chips)
Seat 4: TBaQIN+sQ7eb7P99QnaORQ ($59.80 in chips)
Seat 5: VvdR9F3I+2yELkfTVvC1dg ($200 in chips)
Seat 6: 4bqvCfJ0e8CTYnn0Go9hbQ ($143.20 in chips)
TBaQIN+sQ7eb7P99QnaORQ: posts small blind $1
VvdR9F3I+2yELkfTVvC1dg: posts big blind $2
*** HOLE CARDS ***
4bqvCfJ0e8CTYnn0Go9hbQ: folds
KfwW5us6tydK81NYTtK1gw: raises $2 to $4
3dAbvkxS5NPQTBAbvpinVg: calls $4
/PH6Ffnho4Ysm8S3V/oa+w: raises $36 to $40 and is all-in
TBaQIN+sQ7eb7P99QnaORQ: raises $19.80 to $59.80 and is all-in
VvdR9F3I+2yELkfTVvC1dg: folds
KfwW5us6tydK81NYTtK1gw: raises $140.20 to $200 and is all-in
3dAbvkxS5NPQTBAbvpinVg: folds
*** FLOP *** [8h 9c Jc]
*** TURN *** [8h 9c Jc] [3s]
*** RIVER *** [8h 9c Jc 3s] [4h]
*** SHOW DOWN ***
TBaQIN+sQ7eb7P99QnaORQ: shows [Kd Qh] (high card King)
KfwW5us6tydK81NYTtK1gw: shows [Ad Kh] (high card Ace)
KfwW5us6tydK81NYTtK1gw collected $39.60 from side pot
/PH6Ffnho4Ysm8S3V/oa+w: shows [7d 7h] (a pair of Sevens)
/PH6Ffnho4Ysm8S3V/oa+w collected $123 from main pot
*** SUMMARY ***
Total pot $165.60 Main pot $123. Side pot $39.60. | Rake $3
Board [8h 9c Jc 3s 4h]
Seat 1: KfwW5us6tydK81NYTtK1gw showed [Ad Kh] and won ($39.60) with high card Ace
Seat 2: 3dAbvkxS5NPQTBAbvpinVg folded before Flop
Seat 3: /PH6Ffnho4Ysm8S3V/oa+w (button) showed [7d 7h] and won ($123) with a pair of Sevens
Seat 4: TBaQIN+sQ7eb7P99QnaORQ (small blind) showed [Kd Qh] and lost with high card King
Seat 5: VvdR9F3I+2yELkfTVvC1dg (big blind) folded before Flop
Seat 6: 4bqvCfJ0e8CTYnn0Go9hbQ folded before Flop (didn't bet)



PokerStars Game #59941767730:  Hold'em No Limit ($1/$2) - 2009/07/01 1:45:31 ET
Table 'ZzSIe0zTCDv+n6hfbY5tTg' 6-max Seat #1 is the button
Seat 1: VvdR9F3I+2yELkfTVvC1dg ($261.10 in chips)
Seat 2: B87ikIyZ/TzAVeXf38Ny0g ($235 in chips)
Seat 3: gsugPj31Hui3Jefl98MBOA ($349 in chips)
Seat 4: 54yWzRRgS0oZ+S6LwZBxMQ ($31.75 in chips)
Seat 5: 3dAbvkxS5NPQTBAbvpinVg ($509.45 in chips)
Seat 6: 09BNF4quPDzanQzM8vc6WA ($36 in chips)
B87ikIyZ/TzAVeXf38Ny0g: posts small blind $1
gsugPj31Hui3Jefl98MBOA: posts big blind $2
*** HOLE CARDS ***
54yWzRRgS0oZ+S6LwZBxMQ: folds
3dAbvkxS5NPQTBAbvpinVg: folds
09BNF4quPDzanQzM8vc6WA: folds
VvdR9F3I+2yELkfTVvC1dg: folds
B87ikIyZ/TzAVeXf38Ny0g: folds
gsugPj31Hui3Jefl98MBOA collected $2 from pot
*** SUMMARY ***
Total pot $2 | Rake $0
Seat 1: VvdR9F3I+2yELkfTVvC1dg (button) folded before Flop (didn't bet)
Seat 2: B87ikIyZ/TzAVeXf38Ny0g (small blind) folded before Flop
Seat 3: gsugPj31Hui3Jefl98MBOA (big blind) collected ($2)
Seat 4: 54yWzRRgS0oZ+S6LwZBxMQ folded before Flop (didn't bet)
Seat 5: 3dAbvkxS5NPQTBAbvpinVg folded before Flop (didn't bet)
Seat 6: 09BNF4quPDzanQzM8vc6WA folded before Flop (didn't bet)



PokerStars Game #59941768740:  Hold'em No Limit ($1/$2) - 2009/07/01 1:45:33 ET
Table '5/wEe6JmtGD7vufSA2RG7A' 2-max Seat #1 is the button
Seat 1: pVqEzK9wXlRMECnb1Zg4Zw ($126.10 in chips)
Seat 2: aOL8geThaYp2iadSHl1h1g ($114 in chips)
pVqEzK9wXlRMECnb1Zg4Zw: posts small blind $1
aOL8geThaYp2iadSHl1h1g: posts big blind $2
*** HOLE CARDS ***
pVqEzK9wXlRMECnb1Zg4Zw: raises $6 to $8
aOL8geThaYp2iadSHl1h1g: calls $6
*** FLOP *** [4h Jc Qs]
aOL8geThaYp2iadSHl1h1g: bets $12
pVqEzK9wXlRMECnb1Zg4Zw: folds
aOL8geThaYp2iadSHl1h1g collected $15.50 from pot
aOL8geThaYp2iadSHl1h1g: doesn't show hand
*** SUMMARY ***
Total pot $16 | Rake $0.50
Board [4h Jc Qs]
Seat 1: pVqEzK9wXlRMECnb1Zg4Zw (button) (small blind) folded on the Flop
Seat 2: aOL8geThaYp2iadSHl1h1g (big blind) collected ($15.50)



PokerStars Game #59941769792:  Hold'em No Limit ($1/$2) - 2009/07/01 1:45:35 ET
Table 'UGLAZZyv+cXmnKjYin0etA' 6-max Seat #3 is the button
Seat 1: vkfxu8f/jMYKUk6Ly4eujw ($200 in chips)
Seat 2: eDLH1PUXFpvJBNMXBVQcGA ($304.10 in chips)
Seat 3: ygTTt5ehT4aF86q1a8/R+w ($108.20 in chips)
Seat 4: SiGJDsvRViJX05vHhA80GQ ($235.85 in chips)
Seat 5: 54yWzRRgS0oZ+S6LwZBxMQ ($42.05 in chips)
Seat 6: sTPOWERd9HWPCNrDBwsVjA ($218.15 in chips)
SiGJDsvRViJX05vHhA80GQ: posts small blind $1
54yWzRRgS0oZ+S6LwZBxMQ: posts big blind $2
*** HOLE CARDS ***
sTPOWERd9HWPCNrDBwsVjA: folds
vkfxu8f/jMYKUk6Ly4eujw: folds
eDLH1PUXFpvJBNMXBVQcGA: raises $6 to $8
ygTTt5ehT4aF86q1a8/R+w: folds
SiGJDsvRViJX05vHhA80GQ: folds
54yWzRRgS0oZ+S6LwZBxMQ: folds
eDLH1PUXFpvJBNMXBVQcGA collected $5 from pot
*** SUMMARY ***
Total pot $5 | Rake $0
Seat 1: vkfxu8f/jMYKUk6Ly4eujw folded before Flop (didn't bet)
Seat 2: eDLH1PUXFpvJBNMXBVQcGA collected ($5)
Seat 3: ygTTt5ehT4aF86q1a8/R+w (button) folded before Flop (didn't bet)
Seat 4: SiGJDsvRViJX05vHhA80GQ (small blind) folded before Flop
Seat 5: 54yWzRRgS0oZ+S6LwZBxMQ (big blind) folded before Flop
Seat 6: sTPOWERd9HWPCNrDBwsVjA folded before Flop (didn't bet)



PokerStars Game #59941770348:  Hold'em No Limit ($1/$2) - 2009/07/01 1:45:36 ET
Table 'jlrIxbrVIG+gjaUYT4za8g' 6-max Seat #5 is the button
Seat 2: cwfuMyvDC7J7SqX2leDC8g ($50 in chips)
Seat 3: gnYme0DNFflnMhrdbxe1Ag ($200 in chips)
Seat 4: 8srN1dKQePlsv0GyTada+Q ($268.70 in chips)
Seat 5: AyBB0k3Dcl7xbXUeGMw06g ($38.15 in chips)
Seat 6: BWhgxe7gWiYobRbwdG+d2Q ($197 in chips)
BWhgxe7gWiYobRbwdG+d2Q: posts small blind $1
cwfuMyvDC7J7SqX2leDC8g: posts big blind $2
*** HOLE CARDS ***
gnYme0DNFflnMhrdbxe1Ag: folds
8srN1dKQePlsv0GyTada+Q: folds
AyBB0k3Dcl7xbXUeGMw06g: raises $4 to $6
BWhgxe7gWiYobRbwdG+d2Q: folds
cwfuMyvDC7J7SqX2leDC8g: folds
AyBB0k3Dcl7xbXUeGMw06g collected $5 from pot
*** SUMMARY ***
Total pot $5 | Rake $0
Seat 2: cwfuMyvDC7J7SqX2leDC8g (big blind) folded before Flop
Seat 3: gnYme0DNFflnMhrdbxe1Ag folded before Flop (didn't bet)
Seat 4: 8srN1dKQePlsv0GyTada+Q folded before Flop (didn't bet)
Seat 5: AyBB0k3Dcl7xbXUeGMw06g (button) collected ($5)
Seat 6: BWhgxe7gWiYobRbwdG+d2Q (small blind) folded before Flop



PokerStars Game #59941771230:  Hold'em No Limit ($1/$2) - 2009/07/01 1:45:38 ET
Table '/dyk+YdRGv90j2box35j8w' 6-max Seat #3 is the button
Seat 1: 8srN1dKQePlsv0GyTada+Q ($203 in chips)
Seat 2: qCnEYuAE5y5A7bk6fO5/jQ ($496.20 in chips)
Seat 3: sTPOWERd9HWPCNrDBwsVjA ($203.50 in chips)
Seat 5: VvdR9F3I+2yELkfTVvC1dg ($260.80 in chips)
Seat 6: gnYme0DNFflnMhrdbxe1Ag ($200 in chips)
4dMBh/1VTdeUTPCyhCs3UQ will be allowed to play after the button
VvdR9F3I+2yELkfTVvC1dg: posts small blind $1
gnYme0DNFflnMhrdbxe1Ag: posts big blind $2
*** HOLE CARDS ***
8srN1dKQePlsv0GyTada+Q: folds
qCnEYuAE5y5A7bk6fO5/jQ: raises $4 to $6
sTPOWERd9HWPCNrDBwsVjA: folds
VvdR9F3I+2yELkfTVvC1dg: folds
gnYme0DNFflnMhrdbxe1Ag: folds
qCnEYuAE5y5A7bk6fO5/jQ collected $5 from pot
qCnEYuAE5y5A7bk6fO5/jQ: doesn't show hand
*** SUMMARY ***
Total pot $5 | Rake $0
Seat 1: 8srN1dKQePlsv0GyTada+Q folded before Flop (didn't bet)
Seat 2: qCnEYuAE5y5A7bk6fO5/jQ collected ($5)
Seat 3: sTPOWERd9HWPCNrDBwsVjA (button) folded before Flop (didn't bet)
Seat 5: VvdR9F3I+2yELkfTVvC1dg (small blind) folded before Flop
Seat 6: gnYme0DNFflnMhrdbxe1Ag (big blind) folded before Flop



PokerStars Game #59941772208:  Hold'em No Limit ($1/$2) - 2009/07/01 1:45:40 ET
Table '/ci73fTmzTzmGWzAtqEX2Q' 9-max Seat #1 is the button
Seat 1: 9efVc1cB3yHt4TvBkTusPw ($135.50 in chips)
Seat 2: pN/Ip0ePsUVIdUlGgLrkUw ($223 in chips)
Seat 3: 254YPxPJr5Sw58bkD0YqYQ ($200 in chips)
Seat 4: 2yq7Zp4xmrhAw8+37hTkaA ($137.20 in chips)
Seat 5: 1CtiZuXDFaJL1dJPQKyi8Q ($191.75 in chips)
Seat 6: KqHysDSpCPaPyK3tJC1aEw ($200 in chips)
Seat 7: +T/63sAeZzWyHchahJ36GQ ($72 in chips)
Seat 8: /inIs/z/PcX+TniIFpaxpg ($35.75 in chips)
Seat 9: S8aS+9FTYQ/ICLBNThcrkg ($174 in chips)
pN/Ip0ePsUVIdUlGgLrkUw: posts small blind $1
254YPxPJr5Sw58bkD0YqYQ: posts big blind $2
*** HOLE CARDS ***
2yq7Zp4xmrhAw8+37hTkaA: calls $2
1CtiZuXDFaJL1dJPQKyi8Q: folds
KqHysDSpCPaPyK3tJC1aEw: folds
+T/63sAeZzWyHchahJ36GQ: folds
/inIs/z/PcX+TniIFpaxpg: folds
S8aS+9FTYQ/ICLBNThcrkg: folds
9efVc1cB3yHt4TvBkTusPw: folds
pN/Ip0ePsUVIdUlGgLrkUw: calls $1
254YPxPJr5Sw58bkD0YqYQ: checks
*** FLOP *** [Kd Kh Ad]
pN/Ip0ePsUVIdUlGgLrkUw: checks
254YPxPJr5Sw58bkD0YqYQ: checks
2yq7Zp4xmrhAw8+37hTkaA: checks
*** TURN *** [Kd Kh Ad] [Qc]
pN/Ip0ePsUVIdUlGgLrkUw: checks
254YPxPJr5Sw58bkD0YqYQ: checks
2yq7Zp4xmrhAw8+37hTkaA: checks
*** RIVER *** [Kd Kh Ad Qc] [Jd]
pN/Ip0ePsUVIdUlGgLrkUw: checks
254YPxPJr5Sw58bkD0YqYQ: checks
2yq7Zp4xmrhAw8+37hTkaA: bets $6
pN/Ip0ePsUVIdUlGgLrkUw: folds
254YPxPJr5Sw58bkD0YqYQ: folds
2yq7Zp4xmrhAw8+37hTkaA collected $5.70 from pot
*** SUMMARY ***
Total pot $6 | Rake $0.30
Board [Kd Kh Ad Qc Jd]
Seat 1: 9efVc1cB3yHt4TvBkTusPw (button) folded before Flop (didn't bet)
Seat 2: pN/Ip0ePsUVIdUlGgLrkUw (small blind) folded on the River
Seat 3: 254YPxPJr5Sw58bkD0YqYQ (big blind) folded on the River
Seat 4: 2yq7Zp4xmrhAw8+37hTkaA collected ($5.70)
Seat 5: 1CtiZuXDFaJL1dJPQKyi8Q folded before Flop (didn't bet)
Seat 6: KqHysDSpCPaPyK3tJC1aEw folded before Flop (didn't bet)
Seat 7: +T/63sAeZzWyHchahJ36GQ folded before Flop (didn't bet)
Seat 8: /inIs/z/PcX+TniIFpaxpg folded before Flop (didn't bet)
Seat 9: S8aS+9FTYQ/ICLBNThcrkg folded before Flop (didn't bet)



PokerStars Game #59941773336:  Hold'em No Limit ($1/$2) - 2009/07/01 1:45:42 ET
Table 'TsEDkiO4tzCTCzJ7tNdEqw' 6-max Seat #5 is the button
Seat 1: vkfxu8f/jMYKUk6Ly4eujw ($197 in chips)
Seat 3: ubtx4Z5L+AcK71MTvYiGVw ($267.85 in chips)
Seat 4: K8MXCrNAVYlMnnCeM32Kxw ($123 in chips)
Seat 5: VvdR9F3I+2yELkfTVvC1dg ($246.35 in chips)
Seat 6: uCqEjnxh2/vFBjKYkfTOkw ($290.80 in chips)
uCqEjnxh2/vFBjKYkfTOkw: posts small blind $1
vkfxu8f/jMYKUk6Ly4eujw: posts big blind $2
*** HOLE CARDS ***
ubtx4Z5L+AcK71MTvYiGVw: raises $6 to $8
K8MXCrNAVYlMnnCeM32Kxw: folds
VvdR9F3I+2yELkfTVvC1dg: folds
uCqEjnxh2/vFBjKYkfTOkw: folds
vkfxu8f/jMYKUk6Ly4eujw: calls $6
*** FLOP *** [Jh Ad 2c]
vkfxu8f/jMYKUk6Ly4eujw: checks
ubtx4Z5L+AcK71MTvYiGVw: checks
*** TURN *** [Jh Ad 2c] [4d]
vkfxu8f/jMYKUk6Ly4eujw: bets $16
4dcDwIHRm96PwtqkpQiuiA has returned
ubtx4Z5L+AcK71MTvYiGVw: calls $16
*** RIVER *** [Jh Ad 2c 4d] [9d]
vkfxu8f/jMYKUk6Ly4eujw: bets $47
ubtx4Z5L+AcK71MTvYiGVw: calls $47
*** SHOW DOWN ***
vkfxu8f/jMYKUk6Ly4eujw: shows [Kd Td] (a flush, Ace high)
ubtx4Z5L+AcK71MTvYiGVw: mucks hand
vkfxu8f/jMYKUk6Ly4eujw collected $141 from pot
*** SUMMARY ***
Total pot $143 | Rake $2
Board [Jh Ad 2c 4d 9d]
Seat 1: vkfxu8f/jMYKUk6Ly4eujw (big blind) showed [Kd Td] and won ($141) with a flush, Ace high
Seat 3: ubtx4Z5L+AcK71MTvYiGVw mucked
Seat 4: K8MXCrNAVYlMnnCeM32Kxw folded before Flop (didn't bet)
Seat 5: VvdR9F3I+2yELkfTVvC1dg (button) folded before Flop (didn't bet)
Seat 6: uCqEjnxh2/vFBjKYkfTOkw (small blind) folded before Flop



PokerStars Game #59941774994:  Hold'em No Limit ($1/$2) - 2009/07/01 1:45:45 ET
Table 'kq5zaQ+1hLNf8LZfGnbTAA' 6-max Seat #2 is the button
Seat 1: 8srN1dKQePlsv0GyTada+Q ($425.60 in chips)
Seat 2: nXDI8Y/S6POzRwANu3d8hQ ($137 in chips)
Seat 3: /PH6Ffnho4Ysm8S3V/oa+w ($50.15 in chips)
Seat 4: 3dAbvkxS5NPQTBAbvpinVg ($290.65 in chips)
Seat 5: gnYme0DNFflnMhrdbxe1Ag ($219.35 in chips)
Seat 6: mfy7uGZcqA2PVQqEVbJ7+g ($188.15 in chips)
/PH6Ffnho4Ysm8S3V/oa+w: posts small blind $1
3dAbvkxS5NPQTBAbvpinVg: posts big blind $2
*** HOLE CARDS ***
gnYme0DNFflnMhrdbxe1Ag: folds
mfy7uGZcqA2PVQqEVbJ7+g: folds
8srN1dKQePlsv0GyTada+Q: raises $4 to $6
nXDI8Y/S6POzRwANu3d8hQ: folds
/PH6Ffnho4Ysm8S3V/oa+w: raises $44.15 to $50.15 and is all-in
3dAbvkxS5NPQTBAbvpinVg: folds
8srN1dKQePlsv0GyTada+Q: folds
/PH6Ffnho4Ysm8S3V/oa+w collected $14 from pot
*** SUMMARY ***
Total pot $14 | Rake $0
Seat 1: 8srN1dKQePlsv0GyTada+Q folded before Flop
Seat 2: nXDI8Y/S6POzRwANu3d8hQ (button) folded before Flop (didn't bet)
Seat 3: /PH6Ffnho4Ysm8S3V/oa+w (small blind) collected ($14)
Seat 4: 3dAbvkxS5NPQTBAbvpinVg (big blind) folded before Flop
Seat 5: gnYme0DNFflnMhrdbxe1Ag folded before Flop (didn't bet)
Seat 6: mfy7uGZcqA2PVQqEVbJ7+g folded before Flop (didn't bet)



PokerStars Game #59941775958:  Hold'em No Limit ($1/$2) - 2009/07/01 1:45:47 ET
Table 'uJ9juaXXg9yIcSU8amxaXQ' 6-max Seat #5 is the button
Seat 1: JsqOjN/eHz0uYVf/PyUJ6Q ($146.25 in chips)
Seat 2: VvdR9F3I+2yELkfTVvC1dg ($200.30 in chips)
Seat 3: qXDd0ZyMIse0OBu8pxeQ3Q ($243.40 in chips)
Seat 4: zNjJ/y4emmF+vzrCDd+ooA ($255.80 in chips)
Seat 5: YsLQ3BAvgQHWXMAv3Wv6Hg ($212.70 in chips)
Seat 6: /PH6Ffnho4Ysm8S3V/oa+w ($40 in chips)
/PH6Ffnho4Ysm8S3V/oa+w: posts small blind $1
JsqOjN/eHz0uYVf/PyUJ6Q: posts big blind $2
*** HOLE CARDS ***
VvdR9F3I+2yELkfTVvC1dg: folds
qXDd0ZyMIse0OBu8pxeQ3Q: folds
zNjJ/y4emmF+vzrCDd+ooA: calls $2
YsLQ3BAvgQHWXMAv3Wv6Hg: folds
/PH6Ffnho4Ysm8S3V/oa+w: folds
JsqOjN/eHz0uYVf/PyUJ6Q: raises $4 to $6
zNjJ/y4emmF+vzrCDd+ooA: calls $4
*** FLOP *** [8d 5h 7s]
JsqOjN/eHz0uYVf/PyUJ6Q: bets $8
zNjJ/y4emmF+vzrCDd+ooA: calls $8
*** TURN *** [8d 5h 7s] [6h]
JsqOjN/eHz0uYVf/PyUJ6Q: checks
zNjJ/y4emmF+vzrCDd+ooA: checks
*** RIVER *** [8d 5h 7s 6h] [Jc]
JsqOjN/eHz0uYVf/PyUJ6Q: checks
zNjJ/y4emmF+vzrCDd+ooA: bets $6
JsqOjN/eHz0uYVf/PyUJ6Q: folds
zNjJ/y4emmF+vzrCDd+ooA collected $27.60 from pot
*** SUMMARY ***
Total pot $29 | Rake $1.40
Board [8d 5h 7s 6h Jc]
Seat 1: JsqOjN/eHz0uYVf/PyUJ6Q (big blind) folded on the River
Seat 2: VvdR9F3I+2yELkfTVvC1dg folded before Flop (didn't bet)
Seat 3: qXDd0ZyMIse0OBu8pxeQ3Q folded before Flop (didn't bet)
Seat 4: zNjJ/y4emmF+vzrCDd+ooA collected ($27.60)
Seat 5: YsLQ3BAvgQHWXMAv3Wv6Hg (button) folded before Flop (didn't bet)
Seat 6: /PH6Ffnho4Ysm8S3V/oa+w (small blind) folded before Flop



PokerStars Game #59941776624:  Hold'em No Limit ($1/$2) - 2009/07/01 1:45:48 ET
Table '5/wEe6JmtGD7vufSA2RG7A' 2-max Seat #2 is the button
Seat 1: pVqEzK9wXlRMECnb1Zg4Zw ($118.10 in chips)
Seat 2: aOL8geThaYp2iadSHl1h1g ($121.50 in chips)
aOL8geThaYp2iadSHl1h1g: posts small blind $1
pVqEzK9wXlRMECnb1Zg4Zw: posts big blind $2
*** HOLE CARDS ***
aOL8geThaYp2iadSHl1h1g: raises $4 to $6
pVqEzK9wXlRMECnb1Zg4Zw: folds
aOL8geThaYp2iadSHl1h1g collected $4 from pot
aOL8geThaYp2iadSHl1h1g: doesn't show hand
*** SUMMARY ***
Total pot $4 | Rake $0
Seat 1: pVqEzK9wXlRMECnb1Zg4Zw (big blind) folded before Flop
Seat 2: aOL8geThaYp2iadSHl1h1g (button) (small blind) collected ($4)



PokerStars Game #59941777812:  Hold'em No Limit ($1/$2) - 2009/07/01 1:45:51 ET
Table 'CFkQcfWjKccZaZDf71FK+w' 6-max Seat #5 is the button
Seat 1: vkfxu8f/jMYKUk6Ly4eujw ($227.25 in chips)
Seat 2: ewN/vzF22+/gdzjIKBOlkA ($200 in chips)
Seat 3: 09BNF4quPDzanQzM8vc6WA ($88.30 in chips)
Seat 4: ygTTt5ehT4aF86q1a8/R+w ($247.65 in chips)
Seat 5: 2lOU1DcvUZaMcxZ95XfzXw ($149.05 in chips)
Seat 6: ORVqY3rf9X6ANA/8s+On2Q ($40.35 in chips)
ORVqY3rf9X6ANA/8s+On2Q: posts small blind $1
vkfxu8f/jMYKUk6Ly4eujw: posts big blind $2
*** HOLE CARDS ***
ewN/vzF22+/gdzjIKBOlkA: folds
09BNF4quPDzanQzM8vc6WA: raises $2 to $4
ygTTt5ehT4aF86q1a8/R+w: calls $4
2lOU1DcvUZaMcxZ95XfzXw: calls $4
ORVqY3rf9X6ANA/8s+On2Q: folds
vkfxu8f/jMYKUk6Ly4eujw: folds
*** FLOP *** [3c 5c Td]
09BNF4quPDzanQzM8vc6WA: bets $8
ygTTt5ehT4aF86q1a8/R+w: calls $8
2lOU1DcvUZaMcxZ95XfzXw: folds
*** TURN *** [3c 5c Td] [4h]
09BNF4quPDzanQzM8vc6WA: checks
ygTTt5ehT4aF86q1a8/R+w: bets $18
09BNF4quPDzanQzM8vc6WA: raises $58.30 to $76.30 and is all-in
ygTTt5ehT4aF86q1a8/R+w: folds
09BNF4quPDzanQzM8vc6WA collected $64 from pot
*** SUMMARY ***
Total pot $67 | Rake $3
Board [3c 5c Td 4h]
Seat 1: vkfxu8f/jMYKUk6Ly4eujw (big blind) folded before Flop
Seat 2: ewN/vzF22+/gdzjIKBOlkA folded before Flop (didn't bet)
Seat 3: 09BNF4quPDzanQzM8vc6WA collected ($64)
Seat 4: ygTTt5ehT4aF86q1a8/R+w folded on the Turn
Seat 5: 2lOU1DcvUZaMcxZ95XfzXw (button) folded on the Flop
Seat 6: ORVqY3rf9X6ANA/8s+On2Q (small blind) folded before Flop



PokerStars Game #59941778752:  Hold'em No Limit ($1/$2) - 2009/07/01 1:45:52 ET
Table 'aSf77Sj8QEnzcc0WaxVD4Q' 6-max Seat #6 is the button
Seat 1: UELtvp+JfwI7XDGVwSxZXA ($230.95 in chips)
Seat 2: vkfxu8f/jMYKUk6Ly4eujw ($214.20 in chips)
Seat 3: 9dpyyjDTCed6nV7JhaUUpw ($740.75 in chips)
Seat 4: YsLQ3BAvgQHWXMAv3Wv6Hg ($200 in chips)
Seat 5: VvdR9F3I+2yELkfTVvC1dg ($254.90 in chips)
Seat 6: vkoJRf3gidxY1pPi0AFWww ($151.85 in chips)
UELtvp+JfwI7XDGVwSxZXA: posts small blind $1
vkfxu8f/jMYKUk6Ly4eujw: posts big blind $2
*** HOLE CARDS ***
9dpyyjDTCed6nV7JhaUUpw: folds
YsLQ3BAvgQHWXMAv3Wv6Hg: folds
VvdR9F3I+2yELkfTVvC1dg: folds
vkoJRf3gidxY1pPi0AFWww: folds
UELtvp+JfwI7XDGVwSxZXA: calls $1
vkfxu8f/jMYKUk6Ly4eujw: checks
*** FLOP *** [Ks 6h 2c]
UELtvp+JfwI7XDGVwSxZXA: checks
vkfxu8f/jMYKUk6Ly4eujw: checks
*** TURN *** [Ks 6h 2c] [Qd]
UELtvp+JfwI7XDGVwSxZXA: checks
vkfxu8f/jMYKUk6Ly4eujw: checks
*** RIVER *** [Ks 6h 2c Qd] [9s]
UELtvp+JfwI7XDGVwSxZXA: checks
vkfxu8f/jMYKUk6Ly4eujw: checks
*** SHOW DOWN ***
UELtvp+JfwI7XDGVwSxZXA: shows [5d 4c] (high card King)
vkfxu8f/jMYKUk6Ly4eujw: shows [5s 3d] (high card King)
UELtvp+JfwI7XDGVwSxZXA collected $1.90 from pot
vkfxu8f/jMYKUk6Ly4eujw collected $1.90 from pot
*** SUMMARY ***
Total pot $4 | Rake $0.20
Board [Ks 6h 2c Qd 9s]
Seat 1: UELtvp+JfwI7XDGVwSxZXA (small blind) showed [5d 4c] and won ($1.90) with high card King
Seat 2: vkfxu8f/jMYKUk6Ly4eujw (big blind) showed [5s 3d] and won ($1.90) with high card King
Seat 3: 9dpyyjDTCed6nV7JhaUUpw folded before Flop (didn't bet)
Seat 4: YsLQ3BAvgQHWXMAv3Wv6Hg folded before Flop (didn't bet)
Seat 5: VvdR9F3I+2yELkfTVvC1dg folded before Flop (didn't bet)
Seat 6: vkoJRf3gidxY1pPi0AFWww (button) folded before Flop (didn't bet)



PokerStars Game #59941779130:  Hold'em No Limit ($1/$2) - 2009/07/01 1:45:53 ET
Table 'ZzSIe0zTCDv+n6hfbY5tTg' 6-max Seat #2 is the button
Seat 1: VvdR9F3I+2yELkfTVvC1dg ($261.10 in chips)
Seat 2: B87ikIyZ/TzAVeXf38Ny0g ($234 in chips)
Seat 3: gsugPj31Hui3Jefl98MBOA ($350 in chips)
Seat 4: 54yWzRRgS0oZ+S6LwZBxMQ ($31.75 in chips)
Seat 5: 3dAbvkxS5NPQTBAbvpinVg ($509.45 in chips)
Seat 6: 09BNF4quPDzanQzM8vc6WA ($36 in chips)
gsugPj31Hui3Jefl98MBOA: posts small blind $1
54yWzRRgS0oZ+S6LwZBxMQ: posts big blind $2
*** HOLE CARDS ***
3dAbvkxS5NPQTBAbvpinVg: raises $4 to $6
09BNF4quPDzanQzM8vc6WA has timed out
09BNF4quPDzanQzM8vc6WA: folds
09BNF4quPDzanQzM8vc6WA is sitting out
VvdR9F3I+2yELkfTVvC1dg: folds
09BNF4quPDzanQzM8vc6WA has returned
B87ikIyZ/TzAVeXf38Ny0g: folds
gsugPj31Hui3Jefl98MBOA: folds
54yWzRRgS0oZ+S6LwZBxMQ: calls $4
*** FLOP *** [8h 9s 9c]
54yWzRRgS0oZ+S6LwZBxMQ: checks
3dAbvkxS5NPQTBAbvpinVg: checks
*** TURN *** [8h 9s 9c] [2s]
54yWzRRgS0oZ+S6LwZBxMQ: bets $4
3dAbvkxS5NPQTBAbvpinVg: folds
54yWzRRgS0oZ+S6LwZBxMQ collected $12.35 from pot
54yWzRRgS0oZ+S6LwZBxMQ: doesn't show hand
*** SUMMARY ***
Total pot $13 | Rake $0.65
Board [8h 9s 9c 2s]
Seat 1: VvdR9F3I+2yELkfTVvC1dg folded before Flop (didn't bet)
Seat 2: B87ikIyZ/TzAVeXf38Ny0g (button) folded before Flop (didn't bet)
Seat 3: gsugPj31Hui3Jefl98MBOA (small blind) folded before Flop
Seat 4: 54yWzRRgS0oZ+S6LwZBxMQ (big blind) collected ($12.35)
Seat 5: 3dAbvkxS5NPQTBAbvpinVg folded on the Turn
Seat 6: 09BNF4quPDzanQzM8vc6WA folded before Flop (didn't bet)



PokerStars Game #59941779000:  Hold'em No Limit ($1/$2) - 2009/07/01 1:45:53 ET
Table 'BSRfGh+QobUe0AgIMtt/fw' 9-max Seat #7 is the button
Seat 1: gDn/rYeNwCyWEgRhyWp4PA ($162.05 in chips)
Seat 2: +SmnXtdmwqXGEJfLeJDIUQ ($75.60 in chips)
Seat 3: WUlHm+ydPPHG7Lb0rePSdA ($120 in chips)
Seat 4: +T/63sAeZzWyHchahJ36GQ ($40 in chips)
Seat 5: v0q3vrz/d9oDjLrAG8Ausw ($221.75 in chips)
Seat 6: H6Z4+qu8gR0VUiPOijndVg ($200 in chips)
Seat 7: CkE3IyJF1KvdaAOmZY5XqQ ($200 in chips)
Seat 8: /XRRUMKiOOItJFbrM26RrA ($65.30 in chips)
/XRRUMKiOOItJFbrM26RrA: posts small blind $1
/inIs/z/PcX+TniIFpaxpg: is sitting out
gDn/rYeNwCyWEgRhyWp4PA: posts big blind $2
*** HOLE CARDS ***
/inIs/z/PcX+TniIFpaxpg leaves the table
+SmnXtdmwqXGEJfLeJDIUQ: folds
WUlHm+ydPPHG7Lb0rePSdA: folds
+T/63sAeZzWyHchahJ36GQ: folds
v0q3vrz/d9oDjLrAG8Ausw: raises $2 to $4
H6Z4+qu8gR0VUiPOijndVg: folds
CkE3IyJF1KvdaAOmZY5XqQ: folds
/XRRUMKiOOItJFbrM26RrA: calls $3
gDn/rYeNwCyWEgRhyWp4PA: folds
*** FLOP *** [Jd 8c Kc]
/XRRUMKiOOItJFbrM26RrA: checks
v0q3vrz/d9oDjLrAG8Ausw: bets $6
/XRRUMKiOOItJFbrM26RrA: calls $6
*** TURN *** [Jd 8c Kc] [Js]
/XRRUMKiOOItJFbrM26RrA: checks
v0q3vrz/d9oDjLrAG8Ausw: checks
*** RIVER *** [Jd 8c Kc Js] [2d]
/XRRUMKiOOItJFbrM26RrA: checks
v0q3vrz/d9oDjLrAG8Ausw: bets $10
/XRRUMKiOOItJFbrM26RrA: calls $10
*** SHOW DOWN ***
v0q3vrz/d9oDjLrAG8Ausw: shows [9c Ks] (two pair, Kings and Jacks)
/XRRUMKiOOItJFbrM26RrA: mucks hand
v0q3vrz/d9oDjLrAG8Ausw collected $40 from pot
*** SUMMARY ***
Total pot $42 | Rake $2
Board [Jd 8c Kc Js 2d]
Seat 1: gDn/rYeNwCyWEgRhyWp4PA (big blind) folded before Flop
Seat 2: +SmnXtdmwqXGEJfLeJDIUQ folded before Flop (didn't bet)
Seat 3: WUlHm+ydPPHG7Lb0rePSdA folded before Flop (didn't bet)
Seat 4: +T/63sAeZzWyHchahJ36GQ folded before Flop (didn't bet)
Seat 5: v0q3vrz/d9oDjLrAG8Ausw showed [9c Ks] and won ($40) with two pair, Kings and Jacks
Seat 6: H6Z4+qu8gR0VUiPOijndVg folded before Flop (didn't bet)
Seat 7: CkE3IyJF1KvdaAOmZY5XqQ (button) folded before Flop (didn't bet)
Seat 8: /XRRUMKiOOItJFbrM26RrA (small blind) mucked



PokerStars Game #59941779718:  Hold'em No Limit ($1/$2) - 2009/07/01 1:45:54 ET
Table '4NGNnZ/osQfNq6abYqkJeA' 6-max Seat #2 is the button
Seat 2: 669iGNwYwgRZg3nhS+aDAQ ($129.25 in chips)
Seat 3: 54yWzRRgS0oZ+S6LwZBxMQ ($37 in chips)
Seat 4: sY+4Uuh5z/6AbXXaCS10jw ($306.75 in chips)
Seat 5: VvdR9F3I+2yELkfTVvC1dg ($228.55 in chips)
Seat 6: /PH6Ffnho4Ysm8S3V/oa+w ($40 in chips)
54yWzRRgS0oZ+S6LwZBxMQ: posts small blind $1
sY+4Uuh5z/6AbXXaCS10jw: posts big blind $2
*** HOLE CARDS ***
xUTLK/SDwl6IxZdaKduuFg leaves the table
VvdR9F3I+2yELkfTVvC1dg: folds
/PH6Ffnho4Ysm8S3V/oa+w: folds
669iGNwYwgRZg3nhS+aDAQ: raises $2 to $4
54yWzRRgS0oZ+S6LwZBxMQ: folds
sY+4Uuh5z/6AbXXaCS10jw: folds
669iGNwYwgRZg3nhS+aDAQ collected $5 from pot
*** SUMMARY ***
Total pot $5 | Rake $0
Seat 2: 669iGNwYwgRZg3nhS+aDAQ (button) collected ($5)
Seat 3: 54yWzRRgS0oZ+S6LwZBxMQ (small blind) folded before Flop
Seat 4: sY+4Uuh5z/6AbXXaCS10jw (big blind) folded before Flop
Seat 5: VvdR9F3I+2yELkfTVvC1dg folded before Flop (didn't bet)
Seat 6: /PH6Ffnho4Ysm8S3V/oa+w folded before Flop (didn't bet)



PokerStars Game #59941779954:  Hold'em No Limit ($1/$2) - 2009/07/01 1:45:55 ET
Table 'eyAQSIlgc2o1Jxvbve4WGg' 9-max Seat #9 is the button
Seat 1: UZEsV9yKUMqmpYPiOFpaZw ($37.20 in chips)
Seat 2: kM9CA+2UcdMjbCMbtUCGiA ($220.60 in chips)
Seat 4: CkE3IyJF1KvdaAOmZY5XqQ ($200 in chips)
Seat 5: mIKx5lhIt13X5eZQH0ZeMA ($138.45 in chips)
Seat 6: nXDI8Y/S6POzRwANu3d8hQ ($67 in chips)
Seat 7: u3OrI5uGx9mx1fE7dgr+EA ($81.90 in chips)
Seat 9: WUlHm+ydPPHG7Lb0rePSdA ($140.20 in chips)
UZEsV9yKUMqmpYPiOFpaZw: posts small blind $1
kM9CA+2UcdMjbCMbtUCGiA: posts big blind $2
254YPxPJr5Sw58bkD0YqYQ: sits out
*** HOLE CARDS ***
CkE3IyJF1KvdaAOmZY5XqQ: folds
mIKx5lhIt13X5eZQH0ZeMA: calls $2
nXDI8Y/S6POzRwANu3d8hQ: folds
u3OrI5uGx9mx1fE7dgr+EA: calls $2
WUlHm+ydPPHG7Lb0rePSdA: folds
UZEsV9yKUMqmpYPiOFpaZw: calls $1
kM9CA+2UcdMjbCMbtUCGiA: checks
*** FLOP *** [5h Th 4s]
UZEsV9yKUMqmpYPiOFpaZw: checks
kM9CA+2UcdMjbCMbtUCGiA: checks
mIKx5lhIt13X5eZQH0ZeMA: bets $4
u3OrI5uGx9mx1fE7dgr+EA: calls $4
UZEsV9yKUMqmpYPiOFpaZw: calls $4
kM9CA+2UcdMjbCMbtUCGiA: folds
*** TURN *** [5h Th 4s] [4d]
UZEsV9yKUMqmpYPiOFpaZw: checks
mIKx5lhIt13X5eZQH0ZeMA: bets $8
u3OrI5uGx9mx1fE7dgr+EA: calls $8
UZEsV9yKUMqmpYPiOFpaZw: calls $8
*** RIVER *** [5h Th 4s 4d] [Kd]
UZEsV9yKUMqmpYPiOFpaZw: checks
mIKx5lhIt13X5eZQH0ZeMA: checks
u3OrI5uGx9mx1fE7dgr+EA: checks
*** SHOW DOWN ***
UZEsV9yKUMqmpYPiOFpaZw: shows [3d 2d] (a pair of Fours)
mIKx5lhIt13X5eZQH0ZeMA: shows [Ac 5c] (two pair, Fives and Fours)
u3OrI5uGx9mx1fE7dgr+EA: shows [Td Jd] (two pair, Tens and Fours)
u3OrI5uGx9mx1fE7dgr+EA collected $41.85 from pot
*** SUMMARY ***
Total pot $44 | Rake $2.15
Board [5h Th 4s 4d Kd]
Seat 1: UZEsV9yKUMqmpYPiOFpaZw (small blind) showed [3d 2d] and lost with a pair of Fours
Seat 2: kM9CA+2UcdMjbCMbtUCGiA (big blind) folded on the Flop
Seat 4: CkE3IyJF1KvdaAOmZY5XqQ folded before Flop (didn't bet)
Seat 5: mIKx5lhIt13X5eZQH0ZeMA showed [Ac 5c] and lost with two pair, Fives and Fours
Seat 6: nXDI8Y/S6POzRwANu3d8hQ folded before Flop (didn't bet)
Seat 7: u3OrI5uGx9mx1fE7dgr+EA showed [Td Jd] and won ($41.85) with two pair, Tens and Fours
Seat 9: WUlHm+ydPPHG7Lb0rePSdA (button) folded before Flop (didn't bet)



PokerStars Game #59941780414:  Hold'em No Limit ($1/$2) - 2009/07/01 1:45:56 ET
Table '5/wEe6JmtGD7vufSA2RG7A' 2-max Seat #1 is the button
Seat 1: pVqEzK9wXlRMECnb1Zg4Zw ($116.10 in chips)
Seat 2: aOL8geThaYp2iadSHl1h1g ($123.50 in chips)
pVqEzK9wXlRMECnb1Zg4Zw: posts small blind $1
aOL8geThaYp2iadSHl1h1g: posts big blind $2
*** HOLE CARDS ***
pVqEzK9wXlRMECnb1Zg4Zw: raises $6 to $8
aOL8geThaYp2iadSHl1h1g: folds
pVqEzK9wXlRMECnb1Zg4Zw collected $4 from pot
pVqEzK9wXlRMECnb1Zg4Zw: doesn't show hand
*** SUMMARY ***
Total pot $4 | Rake $0
Seat 1: pVqEzK9wXlRMECnb1Zg4Zw (button) (small blind) collected ($4)
Seat 2: aOL8geThaYp2iadSHl1h1g (big blind) folded before Flop



PokerStars Game #59941780742:  Hold'em No Limit ($1/$2) - 2009/07/01 1:45:56 ET
Table 'NmY84NAf9Mh0ckAckHnh5g' 2-max Seat #2 is the button
Seat 1: 6hvg964TSqZ3AL/0XK9aVQ ($668.25 in chips)
Seat 2: RwDoM55ZeQuI2ADyJhOb2Q ($320.25 in chips)
RwDoM55ZeQuI2ADyJhOb2Q: posts small blind $1
6hvg964TSqZ3AL/0XK9aVQ: posts big blind $2
*** HOLE CARDS ***
RwDoM55ZeQuI2ADyJhOb2Q: raises $4 to $6
6hvg964TSqZ3AL/0XK9aVQ: calls $4
*** FLOP *** [3h Ac 2h]
6hvg964TSqZ3AL/0XK9aVQ: checks
RwDoM55ZeQuI2ADyJhOb2Q: bets $10
6hvg964TSqZ3AL/0XK9aVQ: folds
RwDoM55ZeQuI2ADyJhOb2Q collected $11.50 from pot
RwDoM55ZeQuI2ADyJhOb2Q: doesn't show hand
*** SUMMARY ***
Total pot $12 | Rake $0.50
Board [3h Ac 2h]
Seat 1: 6hvg964TSqZ3AL/0XK9aVQ (big blind) folded on the Flop
Seat 2: RwDoM55ZeQuI2ADyJhOb2Q (button) (small blind) collected ($11.50)



PokerStars Game #59941780710:  Hold'em No Limit ($1/$2) - 2009/07/01 1:45:56 ET
Table 'P/yCfYl1GfGsu/e6DxDy/A' 2-max Seat #1 is the button
Seat 1: 7fOCUy3x9hdkmXkkDNolGQ ($567.50 in chips)
Seat 2: RwDoM55ZeQuI2ADyJhOb2Q ($906.50 in chips)
7fOCUy3x9hdkmXkkDNolGQ: posts small blind $1
RwDoM55ZeQuI2ADyJhOb2Q: posts big blind $2
*** HOLE CARDS ***
7fOCUy3x9hdkmXkkDNolGQ: folds
RwDoM55ZeQuI2ADyJhOb2Q collected $2 from pot
RwDoM55ZeQuI2ADyJhOb2Q: doesn't show hand
*** SUMMARY ***
Total pot $2 | Rake $0
Seat 1: 7fOCUy3x9hdkmXkkDNolGQ (button) (small blind) folded before Flop
Seat 2: RwDoM55ZeQuI2ADyJhOb2Q (big blind) collected ($2)



PokerStars Game #59941780934:  Hold'em No Limit ($1/$2) - 2009/07/01 1:45:56 ET
Table 'YqGfR5eHfMeSjb9a+QU9rg' 9-max Seat #6 is the button
Seat 1: rW/MyplHylMSBRaoRUzWrg ($76 in chips)
Seat 2: nXDI8Y/S6POzRwANu3d8hQ ($37 in chips)
Seat 4: GX1heJ+DSsvm7gzSPsYhhQ ($36 in chips)
Seat 5: CkE3IyJF1KvdaAOmZY5XqQ ($213.40 in chips)
Seat 6: TAfo4veNRaRlzDXMMYS3Jg ($40 in chips)
Seat 7: 41aZuLBz9nAi2GPVKabmCw ($80.95 in chips)
Seat 8: JnV3SM2D6dAFYyGZHHpvrg ($102.15 in chips)
Seat 9: /inIs/z/PcX+TniIFpaxpg ($202.20 in chips)
41aZuLBz9nAi2GPVKabmCw: posts small blind $1
JnV3SM2D6dAFYyGZHHpvrg: posts big blind $2
KqHysDSpCPaPyK3tJC1aEw: sits out
*** HOLE CARDS ***
/inIs/z/PcX+TniIFpaxpg: folds
rW/MyplHylMSBRaoRUzWrg: raises $4 to $6
nXDI8Y/S6POzRwANu3d8hQ: folds
GX1heJ+DSsvm7gzSPsYhhQ: folds
CkE3IyJF1KvdaAOmZY5XqQ: folds
TAfo4veNRaRlzDXMMYS3Jg: folds
41aZuLBz9nAi2GPVKabmCw: folds
JnV3SM2D6dAFYyGZHHpvrg: folds
rW/MyplHylMSBRaoRUzWrg collected $5 from pot
*** SUMMARY ***
Total pot $5 | Rake $0
Seat 1: rW/MyplHylMSBRaoRUzWrg collected ($5)
Seat 2: nXDI8Y/S6POzRwANu3d8hQ folded before Flop (didn't bet)
Seat 4: GX1heJ+DSsvm7gzSPsYhhQ folded before Flop (didn't bet)
Seat 5: CkE3IyJF1KvdaAOmZY5XqQ folded before Flop (didn't bet)
Seat 6: TAfo4veNRaRlzDXMMYS3Jg (button) folded before Flop (didn't bet)
Seat 7: 41aZuLBz9nAi2GPVKabmCw (small blind) folded before Flop
Seat 8: JnV3SM2D6dAFYyGZHHpvrg (big blind) folded before Flop
Seat 9: /inIs/z/PcX+TniIFpaxpg folded before Flop (didn't bet)



PokerStars Game #59941780488:  Hold'em No Limit ($1/$2) - 2009/07/01 1:45:56 ET
Table 'gnHBqWll9O3fxG7Ojkz/ng' 9-max Seat #5 is the button
Seat 1: TAfo4veNRaRlzDXMMYS3Jg ($36 in chips)
Seat 2: H6Z4+qu8gR0VUiPOijndVg ($330.30 in chips)
Seat 3: 5Q8U6iZbeO7xJSS4qvDP5g ($228.05 in chips)
Seat 4: nXDI8Y/S6POzRwANu3d8hQ ($16 in chips)
Seat 5: rBQDMkKm9cZn6M9NPsiVew ($213.15 in chips)
Seat 6: KqHysDSpCPaPyK3tJC1aEw ($200 in chips)
Seat 7: 254YPxPJr5Sw58bkD0YqYQ ($200 in chips)
Seat 8: cM6efHzdxoqYm0EQKP4TTQ ($114.95 in chips)
Seat 9: GX1heJ+DSsvm7gzSPsYhhQ ($45.35 in chips)
KqHysDSpCPaPyK3tJC1aEw: posts small blind $1
254YPxPJr5Sw58bkD0YqYQ: posts big blind $2
*** HOLE CARDS ***
cM6efHzdxoqYm0EQKP4TTQ: folds
GX1heJ+DSsvm7gzSPsYhhQ: folds
TAfo4veNRaRlzDXMMYS3Jg: raises $34 to $36 and is all-in
H6Z4+qu8gR0VUiPOijndVg: folds
5Q8U6iZbeO7xJSS4qvDP5g: folds
nXDI8Y/S6POzRwANu3d8hQ: folds
rBQDMkKm9cZn6M9NPsiVew: calls $36
KqHysDSpCPaPyK3tJC1aEw: folds
254YPxPJr5Sw58bkD0YqYQ: folds
*** FLOP *** [4d 7c 7h]
*** TURN *** [4d 7c 7h] [Kd]
*** RIVER *** [4d 7c 7h Kd] [3c]
*** SHOW DOWN ***
TAfo4veNRaRlzDXMMYS3Jg: shows [Ac As] (two pair, Aces and Sevens)
rBQDMkKm9cZn6M9NPsiVew: mucks hand
TAfo4veNRaRlzDXMMYS3Jg collected $72 from pot
*** SUMMARY ***
Total pot $75 | Rake $3
Board [4d 7c 7h Kd 3c]
Seat 1: TAfo4veNRaRlzDXMMYS3Jg showed [Ac As] and won ($72) with two pair, Aces and Sevens
Seat 2: H6Z4+qu8gR0VUiPOijndVg folded before Flop (didn't bet)
Seat 3: 5Q8U6iZbeO7xJSS4qvDP5g folded before Flop (didn't bet)
Seat 4: nXDI8Y/S6POzRwANu3d8hQ folded before Flop (didn't bet)
Seat 5: rBQDMkKm9cZn6M9NPsiVew (button) mucked
Seat 6: KqHysDSpCPaPyK3tJC1aEw (small blind) folded before Flop
Seat 7: 254YPxPJr5Sw58bkD0YqYQ (big blind) folded before Flop
Seat 8: cM6efHzdxoqYm0EQKP4TTQ folded before Flop (didn't bet)
Seat 9: GX1heJ+DSsvm7gzSPsYhhQ folded before Flop (didn't bet)



PokerStars Game #59941782556:  Hold'em No Limit ($1/$2) - 2009/07/01 1:45:59 ET
Table 'rsKRKlGHlxVyqJxzO2a2Ow' 9-max Seat #1 is the button
Seat 1: KqHysDSpCPaPyK3tJC1aEw ($217.30 in chips)
Seat 2: +T/63sAeZzWyHchahJ36GQ ($38 in chips)
Seat 3: kM9CA+2UcdMjbCMbtUCGiA ($228.10 in chips)
Seat 5: 5Q8U6iZbeO7xJSS4qvDP5g ($248.30 in chips)
Seat 6: H6Z4+qu8gR0VUiPOijndVg ($203 in chips)
Seat 7: GX1heJ+DSsvm7gzSPsYhhQ ($56 in chips)
Seat 8: CkE3IyJF1KvdaAOmZY5XqQ ($203.70 in chips)
Seat 9: gRbvhSUVg+TNaTjaJecIRw ($50.60 in chips)
+T/63sAeZzWyHchahJ36GQ: posts small blind $1
kM9CA+2UcdMjbCMbtUCGiA: posts big blind $2
31HuO+DQxppUQEedBWukug: sits out
*** HOLE CARDS ***
5Q8U6iZbeO7xJSS4qvDP5g: folds
H6Z4+qu8gR0VUiPOijndVg: raises $6 to $8
GX1heJ+DSsvm7gzSPsYhhQ: folds
CkE3IyJF1KvdaAOmZY5XqQ: folds
gRbvhSUVg+TNaTjaJecIRw: folds
KqHysDSpCPaPyK3tJC1aEw: calls $8
+T/63sAeZzWyHchahJ36GQ: raises $30 to $38 and is all-in
kM9CA+2UcdMjbCMbtUCGiA: folds
H6Z4+qu8gR0VUiPOijndVg: calls $30
KqHysDSpCPaPyK3tJC1aEw: folds
*** FLOP *** [8d 3d 8c]
*** TURN *** [8d 3d 8c] [Js]
*** RIVER *** [8d 3d 8c Js] [Jh]
*** SHOW DOWN ***
+T/63sAeZzWyHchahJ36GQ: shows [9d 9s] (two pair, Jacks and Nines)
H6Z4+qu8gR0VUiPOijndVg: mucks hand
+T/63sAeZzWyHchahJ36GQ collected $83 from pot
*** SUMMARY ***
Total pot $86 | Rake $3
Board [8d 3d 8c Js Jh]
Seat 1: KqHysDSpCPaPyK3tJC1aEw (button) folded before Flop
Seat 2: +T/63sAeZzWyHchahJ36GQ (small blind) showed [9d 9s] and won ($83) with two pair, Jacks and Nines
Seat 3: kM9CA+2UcdMjbCMbtUCGiA (big blind) folded before Flop
Seat 5: 5Q8U6iZbeO7xJSS4qvDP5g folded before Flop (didn't bet)
Seat 6: H6Z4+qu8gR0VUiPOijndVg mucked
Seat 7: GX1heJ+DSsvm7gzSPsYhhQ folded before Flop (didn't bet)
Seat 8: CkE3IyJF1KvdaAOmZY5XqQ folded before Flop (didn't bet)
Seat 9: gRbvhSUVg+TNaTjaJecIRw folded before Flop (didn't bet)



PokerStars Game #59941782788:  Hold'em No Limit ($1/$2) - 2009/07/01 1:46:00 ET
Table 'QxerF7GUfCbl+4a8XaTB2w' 6-max Seat #1 is the button
Seat 1: ZwvXzkkZ3XpMhKfAmVpahw ($276.75 in chips)
Seat 2: 6UGgYbxwWNc+ohObe8vB9w ($38 in chips)
Seat 3: 8rZGabKe2DEPdZCbCivZ9Q ($38 in chips)
Seat 4: /PH6Ffnho4Ysm8S3V/oa+w ($44 in chips)
Seat 5: gnYme0DNFflnMhrdbxe1Ag ($257.15 in chips)
Seat 6: VvdR9F3I+2yELkfTVvC1dg ($210.15 in chips)
6UGgYbxwWNc+ohObe8vB9w: posts small blind $1
8rZGabKe2DEPdZCbCivZ9Q: posts big blind $2
*** HOLE CARDS ***
/PH6Ffnho4Ysm8S3V/oa+w: folds
gnYme0DNFflnMhrdbxe1Ag: folds
VvdR9F3I+2yELkfTVvC1dg: raises $2 to $4
ZwvXzkkZ3XpMhKfAmVpahw: folds
6UGgYbxwWNc+ohObe8vB9w: folds
8rZGabKe2DEPdZCbCivZ9Q: calls $2
*** FLOP *** [4d 9h 2c]
8rZGabKe2DEPdZCbCivZ9Q: checks
VvdR9F3I+2yELkfTVvC1dg: bets $6.40
8rZGabKe2DEPdZCbCivZ9Q: folds
VvdR9F3I+2yELkfTVvC1dg collected $8.55 from pot
VvdR9F3I+2yELkfTVvC1dg: doesn't show hand
*** SUMMARY ***
Total pot $9 | Rake $0.45
Board [4d 9h 2c]
Seat 1: ZwvXzkkZ3XpMhKfAmVpahw (button) folded before Flop (didn't bet)
Seat 2: 6UGgYbxwWNc+ohObe8vB9w (small blind) folded before Flop
Seat 3: 8rZGabKe2DEPdZCbCivZ9Q (big blind) folded on the Flop
Seat 4: /PH6Ffnho4Ysm8S3V/oa+w folded before Flop (didn't bet)
Seat 5: gnYme0DNFflnMhrdbxe1Ag folded before Flop (didn't bet)
Seat 6: VvdR9F3I+2yELkfTVvC1dg collected ($8.55)



PokerStars Game #59941784004:  Hold'em No Limit ($1/$2) - 2009/07/01 1:46:02 ET
Table 'P/yCfYl1GfGsu/e6DxDy/A' 2-max Seat #2 is the button
Seat 1: 7fOCUy3x9hdkmXkkDNolGQ ($566.50 in chips)
Seat 2: RwDoM55ZeQuI2ADyJhOb2Q ($907.50 in chips)
RwDoM55ZeQuI2ADyJhOb2Q: posts small blind $1
7fOCUy3x9hdkmXkkDNolGQ: posts big blind $2
*** HOLE CARDS ***
RwDoM55ZeQuI2ADyJhOb2Q: folds
7fOCUy3x9hdkmXkkDNolGQ collected $2 from pot
7fOCUy3x9hdkmXkkDNolGQ: doesn't show hand
*** SUMMARY ***
Total pot $2 | Rake $0
Seat 1: 7fOCUy3x9hdkmXkkDNolGQ (big blind) collected ($2)
Seat 2: RwDoM55ZeQuI2ADyJhOb2Q (button) (small blind) folded before Flop



PokerStars Game #59941785444:  Hold'em No Limit ($1/$2) - 2009/07/01 1:46:05 ET
Table '/dyk+YdRGv90j2box35j8w' 6-max Seat #5 is the button
Seat 1: 8srN1dKQePlsv0GyTada+Q ($203 in chips)
Seat 2: qCnEYuAE5y5A7bk6fO5/jQ ($499.20 in chips)
Seat 3: sTPOWERd9HWPCNrDBwsVjA ($203.50 in chips)
Seat 4: 4dMBh/1VTdeUTPCyhCs3UQ ($60 in chips)
Seat 5: VvdR9F3I+2yELkfTVvC1dg ($259.80 in chips)
Seat 6: gnYme0DNFflnMhrdbxe1Ag ($200 in chips)
gnYme0DNFflnMhrdbxe1Ag: posts small blind $1
8srN1dKQePlsv0GyTada+Q: posts big blind $2
4dMBh/1VTdeUTPCyhCs3UQ: posts big blind $2
*** HOLE CARDS ***
qCnEYuAE5y5A7bk6fO5/jQ: folds
sTPOWERd9HWPCNrDBwsVjA: folds
4dMBh/1VTdeUTPCyhCs3UQ: raises $4 to $6
VvdR9F3I+2yELkfTVvC1dg: raises $13 to $19
gnYme0DNFflnMhrdbxe1Ag: folds
8srN1dKQePlsv0GyTada+Q: folds
4dMBh/1VTdeUTPCyhCs3UQ: folds
VvdR9F3I+2yELkfTVvC1dg collected $15 from pot
VvdR9F3I+2yELkfTVvC1dg: doesn't show hand
*** SUMMARY ***
Total pot $15 | Rake $0
Seat 1: 8srN1dKQePlsv0GyTada+Q (big blind) folded before Flop
Seat 2: qCnEYuAE5y5A7bk6fO5/jQ folded before Flop (didn't bet)
Seat 3: sTPOWERd9HWPCNrDBwsVjA folded before Flop (didn't bet)
Seat 4: 4dMBh/1VTdeUTPCyhCs3UQ folded before Flop
Seat 5: VvdR9F3I+2yELkfTVvC1dg (button) collected ($15)
Seat 6: gnYme0DNFflnMhrdbxe1Ag (small blind) folded before Flop



PokerStars Game #59941785856:  Hold'em No Limit ($1/$2) - 2009/07/01 1:46:06 ET
Table '3WCXyaiCAbqSShQu7FIjvA' 9-max Seat #7 is the button
Seat 1: kTCkABD1UUldS9DFRGfCwQ ($150.75 in chips)
Seat 2: TAfo4veNRaRlzDXMMYS3Jg ($39.70 in chips)
Seat 3: 5Q8U6iZbeO7xJSS4qvDP5g ($270.25 in chips)
Seat 4: waEF/+pxZTxNo4FvsORuXg ($103.40 in chips)
Seat 5: CkE3IyJF1KvdaAOmZY5XqQ ($210.90 in chips)
Seat 6: 5jQlngvMSqM/WoonOcR5kw ($276.80 in chips)
Seat 7: nXDI8Y/S6POzRwANu3d8hQ ($44.10 in chips)
Seat 8: +T/63sAeZzWyHchahJ36GQ ($38 in chips)
Seat 9: FiXPLJyqb24l32QST2TInw ($103.10 in chips)
+T/63sAeZzWyHchahJ36GQ: posts small blind $1
FiXPLJyqb24l32QST2TInw: posts big blind $2
*** HOLE CARDS ***
kTCkABD1UUldS9DFRGfCwQ: raises $4 to $6
TAfo4veNRaRlzDXMMYS3Jg: raises $33.70 to $39.70 and is all-in
5Q8U6iZbeO7xJSS4qvDP5g: folds
waEF/+pxZTxNo4FvsORuXg: folds
CkE3IyJF1KvdaAOmZY5XqQ: folds
5jQlngvMSqM/WoonOcR5kw: folds
nXDI8Y/S6POzRwANu3d8hQ: folds
+T/63sAeZzWyHchahJ36GQ: folds
FiXPLJyqb24l32QST2TInw: folds
kTCkABD1UUldS9DFRGfCwQ: folds
TAfo4veNRaRlzDXMMYS3Jg collected $15 from pot
TAfo4veNRaRlzDXMMYS3Jg: doesn't show hand
*** SUMMARY ***
Total pot $15 | Rake $0
Seat 1: kTCkABD1UUldS9DFRGfCwQ folded before Flop
Seat 2: TAfo4veNRaRlzDXMMYS3Jg collected ($15)
Seat 3: 5Q8U6iZbeO7xJSS4qvDP5g folded before Flop (didn't bet)
Seat 4: waEF/+pxZTxNo4FvsORuXg folded before Flop (didn't bet)
Seat 5: CkE3IyJF1KvdaAOmZY5XqQ folded before Flop (didn't bet)
Seat 6: 5jQlngvMSqM/WoonOcR5kw folded before Flop (didn't bet)
Seat 7: nXDI8Y/S6POzRwANu3d8hQ (button) folded before Flop (didn't bet)
Seat 8: +T/63sAeZzWyHchahJ36GQ (small blind) folded before Flop
Seat 9: FiXPLJyqb24l32QST2TInw (big blind) folded before Flop



PokerStars Game #59941787586:  Hold'em No Limit ($1/$2) - 2009/07/01 1:46:09 ET
Table 'NmY84NAf9Mh0ckAckHnh5g' 2-max Seat #1 is the button
Seat 1: 6hvg964TSqZ3AL/0XK9aVQ ($662.25 in chips)
Seat 2: RwDoM55ZeQuI2ADyJhOb2Q ($325.75 in chips)
6hvg964TSqZ3AL/0XK9aVQ: posts small blind $1
RwDoM55ZeQuI2ADyJhOb2Q: posts big blind $2
*** HOLE CARDS ***
6hvg964TSqZ3AL/0XK9aVQ: folds
RwDoM55ZeQuI2ADyJhOb2Q collected $2 from pot
RwDoM55ZeQuI2ADyJhOb2Q: doesn't show hand
*** SUMMARY ***
Total pot $2 | Rake $0
Seat 1: 6hvg964TSqZ3AL/0XK9aVQ (button) (small blind) folded before Flop
Seat 2: RwDoM55ZeQuI2ADyJhOb2Q (big blind) collected ($2)



PokerStars Game #59941787502:  Hold'em No Limit ($1/$2) - 2009/07/01 1:46:09 ET
Table 'P/yCfYl1GfGsu/e6DxDy/A' 2-max Seat #1 is the button
Seat 1: 7fOCUy3x9hdkmXkkDNolGQ ($567.50 in chips)
Seat 2: RwDoM55ZeQuI2ADyJhOb2Q ($906.50 in chips)
7fOCUy3x9hdkmXkkDNolGQ: posts small blind $1
RwDoM55ZeQuI2ADyJhOb2Q: posts big blind $2
*** HOLE CARDS ***
7fOCUy3x9hdkmXkkDNolGQ: raises $4 to $6
RwDoM55ZeQuI2ADyJhOb2Q: raises $24 to $30
7fOCUy3x9hdkmXkkDNolGQ: calls $24
*** FLOP *** [Ts 8c Ac]
RwDoM55ZeQuI2ADyJhOb2Q: bets $32
7fOCUy3x9hdkmXkkDNolGQ: folds
RwDoM55ZeQuI2ADyJhOb2Q collected $59.50 from pot
RwDoM55ZeQuI2ADyJhOb2Q: doesn't show hand
*** SUMMARY ***
Total pot $60 | Rake $0.50
Board [Ts 8c Ac]
Seat 1: 7fOCUy3x9hdkmXkkDNolGQ (button) (small blind) folded on the Flop
Seat 2: RwDoM55ZeQuI2ADyJhOb2Q (big blind) collected ($59.50)



PokerStars Game #59941788440:  Hold'em No Limit ($1/$2) - 2009/07/01 1:46:10 ET
Table 'mGpP9StWRnoeiBDExc6Frg' 6-max Seat #1 is the button
Seat 1: VvdR9F3I+2yELkfTVvC1dg ($309.15 in chips)
Seat 4: 4dcDwIHRm96PwtqkpQiuiA ($93.70 in chips)
Seat 5: d1puGuVBE0fidn+5eRJ0tw ($184.35 in chips)
Seat 6: B2Ih1sr5VZk+8He7rcrMtQ ($410.45 in chips)
4dcDwIHRm96PwtqkpQiuiA: posts small blind $1
d1puGuVBE0fidn+5eRJ0tw: posts big blind $2
*** HOLE CARDS ***
B2Ih1sr5VZk+8He7rcrMtQ: folds
VvdR9F3I+2yELkfTVvC1dg: folds
4dcDwIHRm96PwtqkpQiuiA: calls $1
d1puGuVBE0fidn+5eRJ0tw: checks
*** FLOP *** [Td 9s 3h]
4dcDwIHRm96PwtqkpQiuiA: checks
d1puGuVBE0fidn+5eRJ0tw: bets $2
4dcDwIHRm96PwtqkpQiuiA: folds
d1puGuVBE0fidn+5eRJ0tw collected $3.80 from pot
d1puGuVBE0fidn+5eRJ0tw: doesn't show hand
*** SUMMARY ***
Total pot $4 | Rake $0.20
Board [Td 9s 3h]
Seat 1: VvdR9F3I+2yELkfTVvC1dg (button) folded before Flop (didn't bet)
Seat 4: 4dcDwIHRm96PwtqkpQiuiA (small blind) folded on the Flop
Seat 5: d1puGuVBE0fidn+5eRJ0tw (big blind) collected ($3.80)
Seat 6: B2Ih1sr5VZk+8He7rcrMtQ folded before Flop (didn't bet)



PokerStars Game #59941788706:  Hold'em No Limit ($1/$2) - 2009/07/01 1:46:11 ET
Table 'jlrIxbrVIG+gjaUYT4za8g' 6-max Seat #6 is the button
Seat 2: cwfuMyvDC7J7SqX2leDC8g ($48 in chips)
Seat 3: gnYme0DNFflnMhrdbxe1Ag ($200 in chips)
Seat 4: 8srN1dKQePlsv0GyTada+Q ($268.70 in chips)
Seat 5: AyBB0k3Dcl7xbXUeGMw06g ($41.15 in chips)
Seat 6: BWhgxe7gWiYobRbwdG+d2Q ($196 in chips)
cwfuMyvDC7J7SqX2leDC8g: posts small blind $1
gnYme0DNFflnMhrdbxe1Ag: posts big blind $2
*** HOLE CARDS ***
8srN1dKQePlsv0GyTada+Q: folds
AyBB0k3Dcl7xbXUeGMw06g: folds
BWhgxe7gWiYobRbwdG+d2Q: folds
cwfuMyvDC7J7SqX2leDC8g: calls $1
gnYme0DNFflnMhrdbxe1Ag: checks
*** FLOP *** [6c 7d Qd]
cwfuMyvDC7J7SqX2leDC8g: checks
gnYme0DNFflnMhrdbxe1Ag: bets $4
cwfuMyvDC7J7SqX2leDC8g: folds
gnYme0DNFflnMhrdbxe1Ag collected $3.80 from pot
*** SUMMARY ***
Total pot $4 | Rake $0.20
Board [6c 7d Qd]
Seat 2: cwfuMyvDC7J7SqX2leDC8g (small blind) folded on the Flop
Seat 3: gnYme0DNFflnMhrdbxe1Ag (big blind) collected ($3.80)
Seat 4: 8srN1dKQePlsv0GyTada+Q folded before Flop (didn't bet)
Seat 5: AyBB0k3Dcl7xbXUeGMw06g folded before Flop (didn't bet)
Seat 6: BWhgxe7gWiYobRbwdG+d2Q (button) folded before Flop (didn't bet)



PokerStars Game #59941788620:  Hold'em No Limit ($1/$2) - 2009/07/01 1:46:11 ET
Table '5/wEe6JmtGD7vufSA2RG7A' 2-max Seat #2 is the button
Seat 1: pVqEzK9wXlRMECnb1Zg4Zw ($118.10 in chips)
Seat 2: aOL8geThaYp2iadSHl1h1g ($121.50 in chips)
aOL8geThaYp2iadSHl1h1g: posts small blind $1
pVqEzK9wXlRMECnb1Zg4Zw: posts big blind $2
*** HOLE CARDS ***
aOL8geThaYp2iadSHl1h1g: raises $4 to $6
pVqEzK9wXlRMECnb1Zg4Zw: raises $14 to $20
aOL8geThaYp2iadSHl1h1g: folds
pVqEzK9wXlRMECnb1Zg4Zw collected $12 from pot
pVqEzK9wXlRMECnb1Zg4Zw: doesn't show hand
*** SUMMARY ***
Total pot $12 | Rake $0
Seat 1: pVqEzK9wXlRMECnb1Zg4Zw (big blind) collected ($12)
Seat 2: aOL8geThaYp2iadSHl1h1g (button) (small blind) folded before Flop



PokerStars Game #59941790674:  Hold'em No Limit ($1/$2) - 2009/07/01 1:46:15 ET
Table 'NmY84NAf9Mh0ckAckHnh5g' 2-max Seat #2 is the button
Seat 1: 6hvg964TSqZ3AL/0XK9aVQ ($661.25 in chips)
Seat 2: RwDoM55ZeQuI2ADyJhOb2Q ($326.75 in chips)
RwDoM55ZeQuI2ADyJhOb2Q: posts small blind $1
6hvg964TSqZ3AL/0XK9aVQ: posts big blind $2
*** HOLE CARDS ***
RwDoM55ZeQuI2ADyJhOb2Q: raises $4 to $6
6hvg964TSqZ3AL/0XK9aVQ: calls $4
*** FLOP *** [7s Jd 8d]
6hvg964TSqZ3AL/0XK9aVQ: checks
RwDoM55ZeQuI2ADyJhOb2Q: checks
*** TURN *** [7s Jd 8d] [Qd]
6hvg964TSqZ3AL/0XK9aVQ: checks
RwDoM55ZeQuI2ADyJhOb2Q: checks
*** RIVER *** [7s Jd 8d Qd] [4s]
6hvg964TSqZ3AL/0XK9aVQ: bets $12
RwDoM55ZeQuI2ADyJhOb2Q: calls $12
*** SHOW DOWN ***
6hvg964TSqZ3AL/0XK9aVQ: shows [8h Qh] (two pair, Queens and Eights)
RwDoM55ZeQuI2ADyJhOb2Q: mucks hand
6hvg964TSqZ3AL/0XK9aVQ collected $35.50 from pot
*** SUMMARY ***
Total pot $36 | Rake $0.50
Board [7s Jd 8d Qd 4s]
Seat 1: 6hvg964TSqZ3AL/0XK9aVQ (big blind) showed [8h Qh] and won ($35.50) with two pair, Queens and Eights
Seat 2: RwDoM55ZeQuI2ADyJhOb2Q (button) (small blind) mucked



PokerStars Game #59941792134:  Hold'em No Limit ($1/$2) - 2009/07/01 1:46:17 ET
Table 'UGLAZZyv+cXmnKjYin0etA' 6-max Seat #4 is the button
Seat 1: vkfxu8f/jMYKUk6Ly4eujw ($200 in chips)
Seat 2: eDLH1PUXFpvJBNMXBVQcGA ($307.10 in chips)
Seat 3: ygTTt5ehT4aF86q1a8/R+w ($108.20 in chips)
Seat 4: SiGJDsvRViJX05vHhA80GQ ($234.85 in chips)
Seat 5: 54yWzRRgS0oZ+S6LwZBxMQ ($40.05 in chips)
Seat 6: sTPOWERd9HWPCNrDBwsVjA ($218.15 in chips)
54yWzRRgS0oZ+S6LwZBxMQ: posts small blind $1
sTPOWERd9HWPCNrDBwsVjA: posts big blind $2
*** HOLE CARDS ***
vkfxu8f/jMYKUk6Ly4eujw: folds
eDLH1PUXFpvJBNMXBVQcGA: folds
ygTTt5ehT4aF86q1a8/R+w: folds
SiGJDsvRViJX05vHhA80GQ: folds
54yWzRRgS0oZ+S6LwZBxMQ: calls $1
sTPOWERd9HWPCNrDBwsVjA: checks
*** FLOP *** [3h Ah 3s]
54yWzRRgS0oZ+S6LwZBxMQ: checks
sTPOWERd9HWPCNrDBwsVjA: bets $2
54yWzRRgS0oZ+S6LwZBxMQ: folds
sTPOWERd9HWPCNrDBwsVjA collected $3.80 from pot
sTPOWERd9HWPCNrDBwsVjA: doesn't show hand
*** SUMMARY ***
Total pot $4 | Rake $0.20
Board [3h Ah 3s]
Seat 1: vkfxu8f/jMYKUk6Ly4eujw folded before Flop (didn't bet)
Seat 2: eDLH1PUXFpvJBNMXBVQcGA folded before Flop (didn't bet)
Seat 3: ygTTt5ehT4aF86q1a8/R+w folded before Flop (didn't bet)
Seat 4: SiGJDsvRViJX05vHhA80GQ (button) folded before Flop (didn't bet)
Seat 5: 54yWzRRgS0oZ+S6LwZBxMQ (small blind) folded on the Flop
Seat 6: sTPOWERd9HWPCNrDBwsVjA (big blind) collected ($3.80)



PokerStars Game #59941793540:  Hold'em No Limit ($1/$2) - 2009/07/01 1:46:20 ET
Table 'qVXak+oTeDXMGbWa4sDU5Q' 9-max Seat #1 is the button
Seat 1: H6Z4+qu8gR0VUiPOijndVg ($230.45 in chips)
Seat 2: CST1bO+CmVQOtNgiT0cKPg ($121.20 in chips)
Seat 3: WUlHm+ydPPHG7Lb0rePSdA ($180.35 in chips)
Seat 4: lQYT23h5QCUVZAKxjOO39Q ($180.10 in chips)
Seat 5: zJtQ1gxyi72XvGYS1tM+DA ($97 in chips)
Seat 6: GX1heJ+DSsvm7gzSPsYhhQ ($88 in chips)
Seat 7: 6oGEJqk9oDy29sSaLs+LGA ($18.65 in chips)
Seat 8: Z0rzUi0y1x80UdIpofoNbA ($106.55 in chips)
Seat 9: CkE3IyJF1KvdaAOmZY5XqQ ($212.55 in chips)
CST1bO+CmVQOtNgiT0cKPg: posts small blind $1
WUlHm+ydPPHG7Lb0rePSdA: posts big blind $2
*** HOLE CARDS ***
lQYT23h5QCUVZAKxjOO39Q: folds
zJtQ1gxyi72XvGYS1tM+DA: folds
GX1heJ+DSsvm7gzSPsYhhQ: folds
6oGEJqk9oDy29sSaLs+LGA: folds
Z0rzUi0y1x80UdIpofoNbA: folds
CkE3IyJF1KvdaAOmZY5XqQ: folds
H6Z4+qu8gR0VUiPOijndVg has timed out
H6Z4+qu8gR0VUiPOijndVg: folds
H6Z4+qu8gR0VUiPOijndVg is sitting out
H6Z4+qu8gR0VUiPOijndVg has returned
CST1bO+CmVQOtNgiT0cKPg: raises $6 to $8
WUlHm+ydPPHG7Lb0rePSdA: folds
CST1bO+CmVQOtNgiT0cKPg collected $4 from pot
*** SUMMARY ***
Total pot $4 | Rake $0
Seat 1: H6Z4+qu8gR0VUiPOijndVg (button) folded before Flop (didn't bet)
Seat 2: CST1bO+CmVQOtNgiT0cKPg (small blind) collected ($4)
Seat 3: WUlHm+ydPPHG7Lb0rePSdA (big blind) folded before Flop
Seat 4: lQYT23h5QCUVZAKxjOO39Q folded before Flop (didn't bet)
Seat 5: zJtQ1gxyi72XvGYS1tM+DA folded before Flop (didn't bet)
Seat 6: GX1heJ+DSsvm7gzSPsYhhQ folded before Flop (didn't bet)
Seat 7: 6oGEJqk9oDy29sSaLs+LGA folded before Flop (didn't bet)
Seat 8: Z0rzUi0y1x80UdIpofoNbA folded before Flop (didn't bet)
Seat 9: CkE3IyJF1KvdaAOmZY5XqQ folded before Flop (didn't bet)



PokerStars Game #59941793376:  Hold'em No Limit ($1/$2) - 2009/07/01 1:46:20 ET
Table '4NGNnZ/osQfNq6abYqkJeA' 6-max Seat #3 is the button
Seat 2: 669iGNwYwgRZg3nhS+aDAQ ($132.25 in chips)
Seat 3: 54yWzRRgS0oZ+S6LwZBxMQ ($36 in chips)
Seat 4: sY+4Uuh5z/6AbXXaCS10jw ($304.75 in chips)
Seat 5: VvdR9F3I+2yELkfTVvC1dg ($228.55 in chips)
Seat 6: /PH6Ffnho4Ysm8S3V/oa+w ($40 in chips)
sY+4Uuh5z/6AbXXaCS10jw: posts small blind $1
VvdR9F3I+2yELkfTVvC1dg: posts big blind $2
*** HOLE CARDS ***
/PH6Ffnho4Ysm8S3V/oa+w: folds
669iGNwYwgRZg3nhS+aDAQ: folds
54yWzRRgS0oZ+S6LwZBxMQ: raises $4 to $6
sY+4Uuh5z/6AbXXaCS10jw: folds
VvdR9F3I+2yELkfTVvC1dg: folds
54yWzRRgS0oZ+S6LwZBxMQ collected $5 from pot
54yWzRRgS0oZ+S6LwZBxMQ: doesn't show hand
*** SUMMARY ***
Total pot $5 | Rake $0
Seat 2: 669iGNwYwgRZg3nhS+aDAQ folded before Flop (didn't bet)
Seat 3: 54yWzRRgS0oZ+S6LwZBxMQ (button) collected ($5)
Seat 4: sY+4Uuh5z/6AbXXaCS10jw (small blind) folded before Flop
Seat 5: VvdR9F3I+2yELkfTVvC1dg (big blind) folded before Flop
Seat 6: /PH6Ffnho4Ysm8S3V/oa+w folded before Flop (didn't bet)



PokerStars Game #59941795524:  Hold'em No Limit ($1/$2) - 2009/07/01 1:46:24 ET
Table 'kq5zaQ+1hLNf8LZfGnbTAA' 6-max Seat #3 is the button
Seat 1: 8srN1dKQePlsv0GyTada+Q ($419.60 in chips)
Seat 2: nXDI8Y/S6POzRwANu3d8hQ ($137 in chips)
Seat 3: /PH6Ffnho4Ysm8S3V/oa+w ($58.15 in chips)
Seat 4: 3dAbvkxS5NPQTBAbvpinVg ($288.65 in chips)
Seat 5: gnYme0DNFflnMhrdbxe1Ag ($219.35 in chips)
Seat 6: mfy7uGZcqA2PVQqEVbJ7+g ($188.15 in chips)
3dAbvkxS5NPQTBAbvpinVg: posts small blind $1
gnYme0DNFflnMhrdbxe1Ag: posts big blind $2
*** HOLE CARDS ***
mfy7uGZcqA2PVQqEVbJ7+g: folds
8srN1dKQePlsv0GyTada+Q: folds
nXDI8Y/S6POzRwANu3d8hQ: folds
/PH6Ffnho4Ysm8S3V/oa+w: folds
3dAbvkxS5NPQTBAbvpinVg: folds
gnYme0DNFflnMhrdbxe1Ag collected $2 from pot
*** SUMMARY ***
Total pot $2 | Rake $0
Seat 1: 8srN1dKQePlsv0GyTada+Q folded before Flop (didn't bet)
Seat 2: nXDI8Y/S6POzRwANu3d8hQ folded before Flop (didn't bet)
Seat 3: /PH6Ffnho4Ysm8S3V/oa+w (button) folded before Flop (didn't bet)
Seat 4: 3dAbvkxS5NPQTBAbvpinVg (small blind) folded before Flop
Seat 5: gnYme0DNFflnMhrdbxe1Ag (big blind) collected ($2)
Seat 6: mfy7uGZcqA2PVQqEVbJ7+g folded before Flop (didn't bet)



PokerStars Game #59941795612:  Hold'em No Limit ($1/$2) - 2009/07/01 1:46:24 ET
Table 'C4lkCXY2PWy6z4vsAe5NGQ' 6-max Seat #3 is the button
Seat 1: gnYme0DNFflnMhrdbxe1Ag ($273.05 in chips)
Seat 2: 6hRJ68JkbJq6MYI9o5bUnQ ($78.95 in chips)
Seat 3: sTPOWERd9HWPCNrDBwsVjA ($133.80 in chips)
Seat 4: VvdR9F3I+2yELkfTVvC1dg ($208 in chips)
Seat 5: /PH6Ffnho4Ysm8S3V/oa+w ($50 in chips)
Seat 6: B87ikIyZ/TzAVeXf38Ny0g ($696.70 in chips)
VvdR9F3I+2yELkfTVvC1dg: posts small blind $1
/PH6Ffnho4Ysm8S3V/oa+w: posts big blind $2
*** HOLE CARDS ***
B87ikIyZ/TzAVeXf38Ny0g: raises $4 to $6
gnYme0DNFflnMhrdbxe1Ag: calls $6
6hRJ68JkbJq6MYI9o5bUnQ: folds
sTPOWERd9HWPCNrDBwsVjA: folds
VvdR9F3I+2yELkfTVvC1dg: folds
/PH6Ffnho4Ysm8S3V/oa+w: folds
*** FLOP *** [Qd 6h 2d]
B87ikIyZ/TzAVeXf38Ny0g: checks
gnYme0DNFflnMhrdbxe1Ag: bets $8
B87ikIyZ/TzAVeXf38Ny0g: calls $8
*** TURN *** [Qd 6h 2d] [9s]
B87ikIyZ/TzAVeXf38Ny0g: checks
gnYme0DNFflnMhrdbxe1Ag: checks
*** RIVER *** [Qd 6h 2d 9s] [5s]
B87ikIyZ/TzAVeXf38Ny0g: bets $20
gnYme0DNFflnMhrdbxe1Ag: folds
gnYme0DNFflnMhrdbxe1Ag leaves the table
B87ikIyZ/TzAVeXf38Ny0g collected $29.50 from pot
B87ikIyZ/TzAVeXf38Ny0g: doesn't show hand
*** SUMMARY ***
Total pot $31 | Rake $1.50
Board [Qd 6h 2d 9s 5s]
Seat 1: gnYme0DNFflnMhrdbxe1Ag folded on the River
Seat 2: 6hRJ68JkbJq6MYI9o5bUnQ folded before Flop (didn't bet)
Seat 3: sTPOWERd9HWPCNrDBwsVjA (button) folded before Flop (didn't bet)
Seat 4: VvdR9F3I+2yELkfTVvC1dg (small blind) folded before Flop
Seat 5: /PH6Ffnho4Ysm8S3V/oa+w (big blind) folded before Flop
Seat 6: B87ikIyZ/TzAVeXf38Ny0g collected ($29.50)



PokerStars Game #59941796676:  Hold'em No Limit ($1/$2) - 2009/07/01 1:46:26 ET
Table 'bJQ024BaYSBrW0sXpCZbNQ' 6-max Seat #5 is the button
Seat 1: KfwW5us6tydK81NYTtK1gw ($200 in chips)
Seat 2: 3dAbvkxS5NPQTBAbvpinVg ($270 in chips)
Seat 3: /PH6Ffnho4Ysm8S3V/oa+w ($123 in chips)
Seat 5: VvdR9F3I+2yELkfTVvC1dg ($200 in chips)
Seat 6: 4bqvCfJ0e8CTYnn0Go9hbQ ($143.20 in chips)
4bqvCfJ0e8CTYnn0Go9hbQ: posts small blind $1
KfwW5us6tydK81NYTtK1gw: posts big blind $2
*** HOLE CARDS ***
3dAbvkxS5NPQTBAbvpinVg: folds
/PH6Ffnho4Ysm8S3V/oa+w: folds
TBaQIN+sQ7eb7P99QnaORQ leaves the table
VvdR9F3I+2yELkfTVvC1dg: folds
4bqvCfJ0e8CTYnn0Go9hbQ: calls $1
KfwW5us6tydK81NYTtK1gw: raises $4 to $6
4bqvCfJ0e8CTYnn0Go9hbQ: calls $4
*** FLOP *** [As 2d 6s]
4bqvCfJ0e8CTYnn0Go9hbQ: checks
KfwW5us6tydK81NYTtK1gw: bets $8
4bqvCfJ0e8CTYnn0Go9hbQ: folds
KfwW5us6tydK81NYTtK1gw collected $11.40 from pot
KfwW5us6tydK81NYTtK1gw: doesn't show hand
*** SUMMARY ***
Total pot $12 | Rake $0.60
Board [As 2d 6s]
Seat 1: KfwW5us6tydK81NYTtK1gw (big blind) collected ($11.40)
Seat 2: 3dAbvkxS5NPQTBAbvpinVg folded before Flop (didn't bet)
Seat 3: /PH6Ffnho4Ysm8S3V/oa+w folded before Flop (didn't bet)
Seat 5: VvdR9F3I+2yELkfTVvC1dg (button) folded before Flop (didn't bet)
Seat 6: 4bqvCfJ0e8CTYnn0Go9hbQ (small blind) folded on the Flop



PokerStars Game #59941797708:  Hold'em No Limit ($1/$2) - 2009/07/01 1:46:28 ET
Table 'QxerF7GUfCbl+4a8XaTB2w' 6-max Seat #2 is the button
Seat 1: ZwvXzkkZ3XpMhKfAmVpahw ($276.75 in chips)
Seat 2: 6UGgYbxwWNc+ohObe8vB9w ($37 in chips)
Seat 3: 8rZGabKe2DEPdZCbCivZ9Q ($34 in chips)
Seat 4: /PH6Ffnho4Ysm8S3V/oa+w ($44 in chips)
Seat 5: gnYme0DNFflnMhrdbxe1Ag ($257.15 in chips)
Seat 6: VvdR9F3I+2yELkfTVvC1dg ($214.70 in chips)
8rZGabKe2DEPdZCbCivZ9Q: posts small blind $1
/PH6Ffnho4Ysm8S3V/oa+w: posts big blind $2
*** HOLE CARDS ***
gnYme0DNFflnMhrdbxe1Ag: folds
VvdR9F3I+2yELkfTVvC1dg: folds
ZwvXzkkZ3XpMhKfAmVpahw: folds
6UGgYbxwWNc+ohObe8vB9w: calls $2
8rZGabKe2DEPdZCbCivZ9Q: folds
/PH6Ffnho4Ysm8S3V/oa+w: checks
*** FLOP *** [Tc 4d 9d]
/PH6Ffnho4Ysm8S3V/oa+w: checks
6UGgYbxwWNc+ohObe8vB9w: bets $4
/PH6Ffnho4Ysm8S3V/oa+w: folds
6UGgYbxwWNc+ohObe8vB9w collected $4.75 from pot
*** SUMMARY ***
Total pot $5 | Rake $0.25
Board [Tc 4d 9d]
Seat 1: ZwvXzkkZ3XpMhKfAmVpahw folded before Flop (didn't bet)
Seat 2: 6UGgYbxwWNc+ohObe8vB9w (button) collected ($4.75)
Seat 3: 8rZGabKe2DEPdZCbCivZ9Q (small blind) folded before Flop
Seat 4: /PH6Ffnho4Ysm8S3V/oa+w (big blind) folded on the Flop
Seat 5: gnYme0DNFflnMhrdbxe1Ag folded before Flop (didn't bet)
Seat 6: VvdR9F3I+2yELkfTVvC1dg folded before Flop (didn't bet)



PokerStars Game #59941798664:  Hold'em No Limit ($1/$2) - 2009/07/01 1:46:30 ET
Table '5/wEe6JmtGD7vufSA2RG7A' 2-max Seat #1 is the button
Seat 1: pVqEzK9wXlRMECnb1Zg4Zw ($124.10 in chips)
Seat 2: aOL8geThaYp2iadSHl1h1g ($115.50 in chips)
pVqEzK9wXlRMECnb1Zg4Zw: posts small blind $1
aOL8geThaYp2iadSHl1h1g: posts big blind $2
*** HOLE CARDS ***
pVqEzK9wXlRMECnb1Zg4Zw: folds
aOL8geThaYp2iadSHl1h1g collected $2 from pot
aOL8geThaYp2iadSHl1h1g: doesn't show hand
*** SUMMARY ***
Total pot $2 | Rake $0
Seat 1: pVqEzK9wXlRMECnb1Zg4Zw (button) (small blind) folded before Flop
Seat 2: aOL8geThaYp2iadSHl1h1g (big blind) collected ($2)



PokerStars Game #59941798790:  Hold'em No Limit ($1/$2) - 2009/07/01 1:46:30 ET
Table 'P/yCfYl1GfGsu/e6DxDy/A' 2-max Seat #2 is the button
Seat 1: 7fOCUy3x9hdkmXkkDNolGQ ($537.50 in chips)
Seat 2: RwDoM55ZeQuI2ADyJhOb2Q ($936 in chips)
RwDoM55ZeQuI2ADyJhOb2Q: posts small blind $1
7fOCUy3x9hdkmXkkDNolGQ: posts big blind $2
*** HOLE CARDS ***
RwDoM55ZeQuI2ADyJhOb2Q: raises $4 to $6
7fOCUy3x9hdkmXkkDNolGQ: calls $4
*** FLOP *** [3h 9d Ks]
7fOCUy3x9hdkmXkkDNolGQ: checks
RwDoM55ZeQuI2ADyJhOb2Q: bets $10
7fOCUy3x9hdkmXkkDNolGQ: folds
RwDoM55ZeQuI2ADyJhOb2Q collected $11.50 from pot
RwDoM55ZeQuI2ADyJhOb2Q: doesn't show hand
*** SUMMARY ***
Total pot $12 | Rake $0.50
Board [3h 9d Ks]
Seat 1: 7fOCUy3x9hdkmXkkDNolGQ (big blind) folded on the Flop
Seat 2: RwDoM55ZeQuI2ADyJhOb2Q (button) (small blind) collected ($11.50)



PokerStars Game #59941801540:  Hold'em No Limit ($1/$2) - 2009/07/01 1:46:35 ET
Table 'mGpP9StWRnoeiBDExc6Frg' 6-max Seat #4 is the button
Seat 1: VvdR9F3I+2yELkfTVvC1dg ($309.15 in chips)
Seat 4: 4dcDwIHRm96PwtqkpQiuiA ($91.70 in chips)
Seat 5: d1puGuVBE0fidn+5eRJ0tw ($186.15 in chips)
Seat 6: B2Ih1sr5VZk+8He7rcrMtQ ($410.45 in chips)
d1puGuVBE0fidn+5eRJ0tw: posts small blind $1
B2Ih1sr5VZk+8He7rcrMtQ: posts big blind $2
*** HOLE CARDS ***
VvdR9F3I+2yELkfTVvC1dg: folds
4dcDwIHRm96PwtqkpQiuiA: folds
d1puGuVBE0fidn+5eRJ0tw: calls $1
B2Ih1sr5VZk+8He7rcrMtQ: raises $4 to $6
d1puGuVBE0fidn+5eRJ0tw: calls $4
*** FLOP *** [Jd Kh 9s]
d1puGuVBE0fidn+5eRJ0tw: checks
6hRJ68JkbJq6MYI9o5bUnQ joins the table at seat #2
B2Ih1sr5VZk+8He7rcrMtQ: checks
*** TURN *** [Jd Kh 9s] [5h]
d1puGuVBE0fidn+5eRJ0tw: bets $4
B2Ih1sr5VZk+8He7rcrMtQ: folds
d1puGuVBE0fidn+5eRJ0tw collected $11.40 from pot
d1puGuVBE0fidn+5eRJ0tw: doesn't show hand
*** SUMMARY ***
Total pot $12 | Rake $0.60
Board [Jd Kh 9s 5h]
Seat 1: VvdR9F3I+2yELkfTVvC1dg folded before Flop (didn't bet)
Seat 4: 4dcDwIHRm96PwtqkpQiuiA (button) folded before Flop (didn't bet)
Seat 5: d1puGuVBE0fidn+5eRJ0tw (small blind) collected ($11.40)
Seat 6: B2Ih1sr5VZk+8He7rcrMtQ (big blind) folded on the Turn



PokerStars Game #59941802454:  Hold'em No Limit ($1/$2) - 2009/07/01 1:46:37 ET
Table '5/wEe6JmtGD7vufSA2RG7A' 2-max Seat #2 is the button
Seat 1: pVqEzK9wXlRMECnb1Zg4Zw ($123.10 in chips)
Seat 2: aOL8geThaYp2iadSHl1h1g ($116.50 in chips)
aOL8geThaYp2iadSHl1h1g: posts small blind $1
pVqEzK9wXlRMECnb1Zg4Zw: posts big blind $2
*** HOLE CARDS ***
aOL8geThaYp2iadSHl1h1g: raises $4 to $6
pVqEzK9wXlRMECnb1Zg4Zw: folds
aOL8geThaYp2iadSHl1h1g collected $4 from pot
*** SUMMARY ***
Total pot $4 | Rake $0
Seat 1: pVqEzK9wXlRMECnb1Zg4Zw (big blind) folded before Flop
Seat 2: aOL8geThaYp2iadSHl1h1g (button) (small blind) collected ($4)



PokerStars Game #59941802976:  Hold'em No Limit ($1/$2) - 2009/07/01 1:46:38 ET
Table 'NmY84NAf9Mh0ckAckHnh5g' 2-max Seat #1 is the button
Seat 1: 6hvg964TSqZ3AL/0XK9aVQ ($678.75 in chips)
Seat 2: RwDoM55ZeQuI2ADyJhOb2Q ($308.75 in chips)
6hvg964TSqZ3AL/0XK9aVQ: posts small blind $1
RwDoM55ZeQuI2ADyJhOb2Q: posts big blind $2
*** HOLE CARDS ***
6hvg964TSqZ3AL/0XK9aVQ: calls $1
RwDoM55ZeQuI2ADyJhOb2Q: raises $6 to $8
6hvg964TSqZ3AL/0XK9aVQ: calls $6
*** FLOP *** [9s 3d 8d]
RwDoM55ZeQuI2ADyJhOb2Q: bets $10
6hvg964TSqZ3AL/0XK9aVQ: calls $10
*** TURN *** [9s 3d 8d] [4d]
RwDoM55ZeQuI2ADyJhOb2Q: bets $32
6hvg964TSqZ3AL/0XK9aVQ: calls $32
*** RIVER *** [9s 3d 8d 4d] [Ac]
RwDoM55ZeQuI2ADyJhOb2Q: bets $52
6hvg964TSqZ3AL/0XK9aVQ: folds
RwDoM55ZeQuI2ADyJhOb2Q collected $99.50 from pot
RwDoM55ZeQuI2ADyJhOb2Q: doesn't show hand
*** SUMMARY ***
Total pot $100 | Rake $0.50
Board [9s 3d 8d 4d Ac]
Seat 1: 6hvg964TSqZ3AL/0XK9aVQ (button) (small blind) folded on the River
Seat 2: RwDoM55ZeQuI2ADyJhOb2Q (big blind) collected ($99.50)



PokerStars Game #59941803746:  Hold'em No Limit ($1/$2) - 2009/07/01 1:46:39 ET
Table 'TsEDkiO4tzCTCzJ7tNdEqw' 6-max Seat #6 is the button
Seat 1: vkfxu8f/jMYKUk6Ly4eujw ($267 in chips)
Seat 2: 4dcDwIHRm96PwtqkpQiuiA ($82.65 in chips)
Seat 3: ubtx4Z5L+AcK71MTvYiGVw ($200 in chips)
Seat 4: K8MXCrNAVYlMnnCeM32Kxw ($123 in chips)
Seat 5: VvdR9F3I+2yELkfTVvC1dg ($246.35 in chips)
Seat 6: uCqEjnxh2/vFBjKYkfTOkw ($289.80 in chips)
vkfxu8f/jMYKUk6Ly4eujw: posts small blind $1
4dcDwIHRm96PwtqkpQiuiA: posts big blind $2
*** HOLE CARDS ***
ubtx4Z5L+AcK71MTvYiGVw: folds
K8MXCrNAVYlMnnCeM32Kxw: folds
VvdR9F3I+2yELkfTVvC1dg: folds
uCqEjnxh2/vFBjKYkfTOkw: raises $4 to $6
vkfxu8f/jMYKUk6Ly4eujw: folds
4dcDwIHRm96PwtqkpQiuiA: folds
uCqEjnxh2/vFBjKYkfTOkw collected $5 from pot
uCqEjnxh2/vFBjKYkfTOkw: doesn't show hand
*** SUMMARY ***
Total pot $5 | Rake $0
Seat 1: vkfxu8f/jMYKUk6Ly4eujw (small blind) folded before Flop
Seat 2: 4dcDwIHRm96PwtqkpQiuiA (big blind) folded before Flop
Seat 3: ubtx4Z5L+AcK71MTvYiGVw folded before Flop (didn't bet)
Seat 4: K8MXCrNAVYlMnnCeM32Kxw folded before Flop (didn't bet)
Seat 5: VvdR9F3I+2yELkfTVvC1dg folded before Flop (didn't bet)
Seat 6: uCqEjnxh2/vFBjKYkfTOkw (button) collected ($5)



PokerStars Game #59941804200:  Hold'em No Limit ($1/$2) - 2009/07/01 1:46:40 ET
Table 'kq5zaQ+1hLNf8LZfGnbTAA' 6-max Seat #4 is the button
Seat 1: 8srN1dKQePlsv0GyTada+Q ($419.60 in chips)
Seat 2: nXDI8Y/S6POzRwANu3d8hQ ($137 in chips)
Seat 3: /PH6Ffnho4Ysm8S3V/oa+w ($58.15 in chips)
Seat 4: 3dAbvkxS5NPQTBAbvpinVg ($287.65 in chips)
Seat 5: gnYme0DNFflnMhrdbxe1Ag ($220.35 in chips)
Seat 6: mfy7uGZcqA2PVQqEVbJ7+g ($188.15 in chips)
gnYme0DNFflnMhrdbxe1Ag: posts small blind $1
mfy7uGZcqA2PVQqEVbJ7+g: posts big blind $2
*** HOLE CARDS ***
8srN1dKQePlsv0GyTada+Q: folds
nXDI8Y/S6POzRwANu3d8hQ: folds
/PH6Ffnho4Ysm8S3V/oa+w: folds
3dAbvkxS5NPQTBAbvpinVg: raises $4 to $6
gnYme0DNFflnMhrdbxe1Ag: raises $16 to $22
mfy7uGZcqA2PVQqEVbJ7+g: folds
3dAbvkxS5NPQTBAbvpinVg: folds
gnYme0DNFflnMhrdbxe1Ag collected $14 from pot
gnYme0DNFflnMhrdbxe1Ag: doesn't show hand
*** SUMMARY ***
Total pot $14 | Rake $0
Seat 1: 8srN1dKQePlsv0GyTada+Q folded before Flop (didn't bet)
Seat 2: nXDI8Y/S6POzRwANu3d8hQ folded before Flop (didn't bet)
Seat 3: /PH6Ffnho4Ysm8S3V/oa+w folded before Flop (didn't bet)
Seat 4: 3dAbvkxS5NPQTBAbvpinVg (button) folded before Flop
Seat 5: gnYme0DNFflnMhrdbxe1Ag (small blind) collected ($14)
Seat 6: mfy7uGZcqA2PVQqEVbJ7+g (big blind) folded before Flop



PokerStars Game #59941804804:  Hold'em No Limit ($1/$2) - 2009/07/01 1:46:41 ET
Table 'ZzSIe0zTCDv+n6hfbY5tTg' 6-max Seat #3 is the button
Seat 1: VvdR9F3I+2yELkfTVvC1dg ($261.10 in chips)
Seat 2: B87ikIyZ/TzAVeXf38Ny0g ($234 in chips)
Seat 3: gsugPj31Hui3Jefl98MBOA ($349 in chips)
Seat 4: 54yWzRRgS0oZ+S6LwZBxMQ ($38.10 in chips)
Seat 5: 3dAbvkxS5NPQTBAbvpinVg ($503.45 in chips)
Seat 6: 09BNF4quPDzanQzM8vc6WA ($36 in chips)
54yWzRRgS0oZ+S6LwZBxMQ: posts small blind $1
3dAbvkxS5NPQTBAbvpinVg: posts big blind $2
*** HOLE CARDS ***
09BNF4quPDzanQzM8vc6WA: folds
VvdR9F3I+2yELkfTVvC1dg: folds
B87ikIyZ/TzAVeXf38Ny0g: raises $4 to $6
gsugPj31Hui3Jefl98MBOA: folds
54yWzRRgS0oZ+S6LwZBxMQ: raises $32.10 to $38.10 and is all-in
3dAbvkxS5NPQTBAbvpinVg: folds
B87ikIyZ/TzAVeXf38Ny0g: folds
54yWzRRgS0oZ+S6LwZBxMQ collected $14 from pot
54yWzRRgS0oZ+S6LwZBxMQ: doesn't show hand
*** SUMMARY ***
Total pot $14 | Rake $0
Seat 1: VvdR9F3I+2yELkfTVvC1dg folded before Flop (didn't bet)
Seat 2: B87ikIyZ/TzAVeXf38Ny0g folded before Flop
Seat 3: gsugPj31Hui3Jefl98MBOA (button) folded before Flop (didn't bet)
Seat 4: 54yWzRRgS0oZ+S6LwZBxMQ (small blind) collected ($14)
Seat 5: 3dAbvkxS5NPQTBAbvpinVg (big blind) folded before Flop
Seat 6: 09BNF4quPDzanQzM8vc6WA folded before Flop (didn't bet)



PokerStars Game #59941805948:  Hold'em No Limit ($1/$2) - 2009/07/01 1:46:44 ET
Table 'P/yCfYl1GfGsu/e6DxDy/A' 2-max Seat #1 is the button
Seat 1: 7fOCUy3x9hdkmXkkDNolGQ ($531.50 in chips)
Seat 2: RwDoM55ZeQuI2ADyJhOb2Q ($941.50 in chips)
7fOCUy3x9hdkmXkkDNolGQ: posts small blind $1
RwDoM55ZeQuI2ADyJhOb2Q: posts big blind $2
*** HOLE CARDS ***
7fOCUy3x9hdkmXkkDNolGQ: raises $4 to $6
RwDoM55ZeQuI2ADyJhOb2Q: folds
7fOCUy3x9hdkmXkkDNolGQ collected $4 from pot
7fOCUy3x9hdkmXkkDNolGQ: doesn't show hand
*** SUMMARY ***
Total pot $4 | Rake $0
Seat 1: 7fOCUy3x9hdkmXkkDNolGQ (button) (small blind) collected ($4)
Seat 2: RwDoM55ZeQuI2ADyJhOb2Q (big blind) folded before Flop



PokerStars Game #59941806674:  Hold'em No Limit ($1/$2) - 2009/07/01 1:46:45 ET
Table '5/wEe6JmtGD7vufSA2RG7A' 2-max Seat #1 is the button
Seat 1: pVqEzK9wXlRMECnb1Zg4Zw ($121.10 in chips)
Seat 2: aOL8geThaYp2iadSHl1h1g ($118.50 in chips)
pVqEzK9wXlRMECnb1Zg4Zw: posts small blind $1
aOL8geThaYp2iadSHl1h1g: posts big blind $2
*** HOLE CARDS ***
pVqEzK9wXlRMECnb1Zg4Zw: raises $6 to $8
aOL8geThaYp2iadSHl1h1g: raises $110.50 to $118.50 and is all-in
pVqEzK9wXlRMECnb1Zg4Zw: folds
aOL8geThaYp2iadSHl1h1g collected $16 from pot
aOL8geThaYp2iadSHl1h1g: doesn't show hand
*** SUMMARY ***
Total pot $16 | Rake $0
Seat 1: pVqEzK9wXlRMECnb1Zg4Zw (button) (small blind) folded before Flop
Seat 2: aOL8geThaYp2iadSHl1h1g (big blind) collected ($16)



PokerStars Game #59941806798:  Hold'em No Limit ($1/$2) - 2009/07/01 1:46:45 ET
Table '/dyk+YdRGv90j2box35j8w' 6-max Seat #6 is the button
Seat 1: 8srN1dKQePlsv0GyTada+Q ($201 in chips)
Seat 2: qCnEYuAE5y5A7bk6fO5/jQ ($499.20 in chips)
Seat 3: sTPOWERd9HWPCNrDBwsVjA ($203.50 in chips)
Seat 4: 4dMBh/1VTdeUTPCyhCs3UQ ($54 in chips)
Seat 5: VvdR9F3I+2yELkfTVvC1dg ($268.80 in chips)
Seat 6: gnYme0DNFflnMhrdbxe1Ag ($200 in chips)
8srN1dKQePlsv0GyTada+Q: posts small blind $1
qCnEYuAE5y5A7bk6fO5/jQ: posts big blind $2
*** HOLE CARDS ***
sTPOWERd9HWPCNrDBwsVjA: folds
4dMBh/1VTdeUTPCyhCs3UQ: folds
VvdR9F3I+2yELkfTVvC1dg: folds
gnYme0DNFflnMhrdbxe1Ag: folds
gnYme0DNFflnMhrdbxe1Ag leaves the table
8srN1dKQePlsv0GyTada+Q: folds
qCnEYuAE5y5A7bk6fO5/jQ collected $2 from pot
qCnEYuAE5y5A7bk6fO5/jQ: doesn't show hand
*** SUMMARY ***
Total pot $2 | Rake $0
Seat 1: 8srN1dKQePlsv0GyTada+Q (small blind) folded before Flop
Seat 2: qCnEYuAE5y5A7bk6fO5/jQ (big blind) collected ($2)
Seat 3: sTPOWERd9HWPCNrDBwsVjA folded before Flop (didn't bet)
Seat 4: 4dMBh/1VTdeUTPCyhCs3UQ folded before Flop (didn't bet)
Seat 5: VvdR9F3I+2yELkfTVvC1dg folded before Flop (didn't bet)
Seat 6: gnYme0DNFflnMhrdbxe1Ag (button) folded before Flop (didn't bet)



PokerStars Game #59941806718:  Hold'em No Limit ($1/$2) - 2009/07/01 1:46:45 ET
Table '/ci73fTmzTzmGWzAtqEX2Q' 9-max Seat #2 is the button
Seat 1: 9efVc1cB3yHt4TvBkTusPw ($135.50 in chips)
Seat 2: pN/Ip0ePsUVIdUlGgLrkUw ($221 in chips)
Seat 3: 254YPxPJr5Sw58bkD0YqYQ ($200 in chips)
Seat 4: 2yq7Zp4xmrhAw8+37hTkaA ($140.90 in chips)
Seat 5: 1CtiZuXDFaJL1dJPQKyi8Q ($191.75 in chips)
Seat 6: KqHysDSpCPaPyK3tJC1aEw ($200 in chips)
Seat 7: +T/63sAeZzWyHchahJ36GQ ($72 in chips)
Seat 8: /inIs/z/PcX+TniIFpaxpg ($35.75 in chips)
Seat 9: S8aS+9FTYQ/ICLBNThcrkg ($174 in chips)
254YPxPJr5Sw58bkD0YqYQ: posts small blind $1
2yq7Zp4xmrhAw8+37hTkaA: posts big blind $2
*** HOLE CARDS ***
1CtiZuXDFaJL1dJPQKyi8Q: folds
KqHysDSpCPaPyK3tJC1aEw: folds
1CtiZuXDFaJL1dJPQKyi8Q is sitting out
+T/63sAeZzWyHchahJ36GQ: folds
/inIs/z/PcX+TniIFpaxpg: folds
S8aS+9FTYQ/ICLBNThcrkg: folds
9efVc1cB3yHt4TvBkTusPw: raises $2 to $4
pN/Ip0ePsUVIdUlGgLrkUw: folds
254YPxPJr5Sw58bkD0YqYQ: folds
2yq7Zp4xmrhAw8+37hTkaA: folds
9efVc1cB3yHt4TvBkTusPw collected $5 from pot
*** SUMMARY ***
Total pot $5 | Rake $0
Seat 1: 9efVc1cB3yHt4TvBkTusPw collected ($5)
Seat 2: pN/Ip0ePsUVIdUlGgLrkUw (button) folded before Flop (didn't bet)
Seat 3: 254YPxPJr5Sw58bkD0YqYQ (small blind) folded before Flop
Seat 4: 2yq7Zp4xmrhAw8+37hTkaA (big blind) folded before Flop
Seat 5: 1CtiZuXDFaJL1dJPQKyi8Q folded before Flop (didn't bet)
Seat 6: KqHysDSpCPaPyK3tJC1aEw folded before Flop (didn't bet)
Seat 7: +T/63sAeZzWyHchahJ36GQ folded before Flop (didn't bet)
Seat 8: /inIs/z/PcX+TniIFpaxpg folded before Flop (didn't bet)
Seat 9: S8aS+9FTYQ/ICLBNThcrkg folded before Flop (didn't bet)



PokerStars Game #59941806998:  Hold'em No Limit ($1/$2) - 2009/07/01 1:46:46 ET
Table 'ztv6V3FN2bQ9nmJPPdx6nQ' 6-max Seat #5 is the button
Seat 1: 6fLdOUCRtX71xbVRhJEq8w ($230.35 in chips)
Seat 2: 5Y+ZGWLI4gnlpApDX5vy1A ($433.85 in chips)
Seat 3: ubtx4Z5L+AcK71MTvYiGVw ($241.20 in chips)
Seat 4: UaZ5yj+6LjtWqMQg2QskUw ($66.65 in chips)
Seat 5: sTPOWERd9HWPCNrDBwsVjA ($219.60 in chips)
Seat 6: mfy7uGZcqA2PVQqEVbJ7+g ($100.60 in chips)
mfy7uGZcqA2PVQqEVbJ7+g: posts small blind $1
6fLdOUCRtX71xbVRhJEq8w: posts big blind $2
*** HOLE CARDS ***
5Y+ZGWLI4gnlpApDX5vy1A has timed out
5Y+ZGWLI4gnlpApDX5vy1A: folds
5Y+ZGWLI4gnlpApDX5vy1A is sitting out
ubtx4Z5L+AcK71MTvYiGVw: folds
UaZ5yj+6LjtWqMQg2QskUw: folds
5Y+ZGWLI4gnlpApDX5vy1A has returned
sTPOWERd9HWPCNrDBwsVjA: folds
mfy7uGZcqA2PVQqEVbJ7+g: folds
6fLdOUCRtX71xbVRhJEq8w collected $2 from pot
*** SUMMARY ***
Total pot $2 | Rake $0
Seat 1: 6fLdOUCRtX71xbVRhJEq8w (big blind) collected ($2)
Seat 2: 5Y+ZGWLI4gnlpApDX5vy1A folded before Flop (didn't bet)
Seat 3: ubtx4Z5L+AcK71MTvYiGVw folded before Flop (didn't bet)
Seat 4: UaZ5yj+6LjtWqMQg2QskUw folded before Flop (didn't bet)
Seat 5: sTPOWERd9HWPCNrDBwsVjA (button) folded before Flop (didn't bet)
Seat 6: mfy7uGZcqA2PVQqEVbJ7+g (small blind) folded before Flop



PokerStars Game #59941807450:  Hold'em No Limit ($1/$2) - 2009/07/01 1:46:46 ET
Table 'aSf77Sj8QEnzcc0WaxVD4Q' 6-max Seat #1 is the button
Seat 1: UELtvp+JfwI7XDGVwSxZXA ($230.85 in chips)
Seat 2: vkfxu8f/jMYKUk6Ly4eujw ($214.10 in chips)
Seat 3: 9dpyyjDTCed6nV7JhaUUpw ($740.75 in chips)
Seat 4: YsLQ3BAvgQHWXMAv3Wv6Hg ($200 in chips)
Seat 5: VvdR9F3I+2yELkfTVvC1dg ($254.90 in chips)
Seat 6: vkoJRf3gidxY1pPi0AFWww ($151.85 in chips)
vkfxu8f/jMYKUk6Ly4eujw: posts small blind $1
9dpyyjDTCed6nV7JhaUUpw: posts big blind $2
*** HOLE CARDS ***
YsLQ3BAvgQHWXMAv3Wv6Hg: folds
VvdR9F3I+2yELkfTVvC1dg: folds
vkoJRf3gidxY1pPi0AFWww: folds
UELtvp+JfwI7XDGVwSxZXA: folds
vkfxu8f/jMYKUk6Ly4eujw: raises $6 to $8
9dpyyjDTCed6nV7JhaUUpw: calls $6
*** FLOP *** [8d Kc Kh]
vkfxu8f/jMYKUk6Ly4eujw: bets $15
9dpyyjDTCed6nV7JhaUUpw: calls $15
*** TURN *** [8d Kc Kh] [2c]
vkfxu8f/jMYKUk6Ly4eujw: checks
9dpyyjDTCed6nV7JhaUUpw: checks
*** RIVER *** [8d Kc Kh 2c] [2d]
vkfxu8f/jMYKUk6Ly4eujw: checks
9dpyyjDTCed6nV7JhaUUpw: bets $11
vkfxu8f/jMYKUk6Ly4eujw: folds
9dpyyjDTCed6nV7JhaUUpw collected $43.75 from pot
9dpyyjDTCed6nV7JhaUUpw: doesn't show hand
*** SUMMARY ***
Total pot $46 | Rake $2.25
Board [8d Kc Kh 2c 2d]
Seat 1: UELtvp+JfwI7XDGVwSxZXA (button) folded before Flop (didn't bet)
Seat 2: vkfxu8f/jMYKUk6Ly4eujw (small blind) folded on the River
Seat 3: 9dpyyjDTCed6nV7JhaUUpw (big blind) collected ($43.75)
Seat 4: YsLQ3BAvgQHWXMAv3Wv6Hg folded before Flop (didn't bet)
Seat 5: VvdR9F3I+2yELkfTVvC1dg folded before Flop (didn't bet)
Seat 6: vkoJRf3gidxY1pPi0AFWww folded before Flop (didn't bet)



PokerStars Game #59941808464:  Hold'em No Limit ($1/$2) - 2009/07/01 1:46:48 ET
Table 'gnHBqWll9O3fxG7Ojkz/ng' 9-max Seat #6 is the button
Seat 1: TAfo4veNRaRlzDXMMYS3Jg ($72 in chips)
Seat 2: H6Z4+qu8gR0VUiPOijndVg ($330.30 in chips)
Seat 3: 5Q8U6iZbeO7xJSS4qvDP5g ($228.05 in chips)
Seat 4: nXDI8Y/S6POzRwANu3d8hQ ($16 in chips)
Seat 5: rBQDMkKm9cZn6M9NPsiVew ($177.15 in chips)
Seat 6: KqHysDSpCPaPyK3tJC1aEw ($200 in chips)
Seat 7: 254YPxPJr5Sw58bkD0YqYQ ($200 in chips)
Seat 8: cM6efHzdxoqYm0EQKP4TTQ ($114.95 in chips)
Seat 9: GX1heJ+DSsvm7gzSPsYhhQ ($45.35 in chips)
254YPxPJr5Sw58bkD0YqYQ: posts small blind $1
cM6efHzdxoqYm0EQKP4TTQ: posts big blind $2
*** HOLE CARDS ***
GX1heJ+DSsvm7gzSPsYhhQ: folds
TAfo4veNRaRlzDXMMYS3Jg: folds
H6Z4+qu8gR0VUiPOijndVg has timed out
H6Z4+qu8gR0VUiPOijndVg: folds
H6Z4+qu8gR0VUiPOijndVg is sitting out
H6Z4+qu8gR0VUiPOijndVg has returned
5Q8U6iZbeO7xJSS4qvDP5g: raises $6 to $8
nXDI8Y/S6POzRwANu3d8hQ: folds
rBQDMkKm9cZn6M9NPsiVew: calls $8
KqHysDSpCPaPyK3tJC1aEw: folds
254YPxPJr5Sw58bkD0YqYQ: folds
cM6efHzdxoqYm0EQKP4TTQ: folds
*** FLOP *** [3h Qd 4c]
5Q8U6iZbeO7xJSS4qvDP5g: bets $13
rBQDMkKm9cZn6M9NPsiVew: folds
5Q8U6iZbeO7xJSS4qvDP5g collected $18.05 from pot
5Q8U6iZbeO7xJSS4qvDP5g: doesn't show hand
*** SUMMARY ***
Total pot $19 | Rake $0.95
Board [3h Qd 4c]
Seat 1: TAfo4veNRaRlzDXMMYS3Jg folded before Flop (didn't bet)
Seat 2: H6Z4+qu8gR0VUiPOijndVg folded before Flop (didn't bet)
Seat 3: 5Q8U6iZbeO7xJSS4qvDP5g collected ($18.05)
Seat 4: nXDI8Y/S6POzRwANu3d8hQ folded before Flop (didn't bet)
Seat 5: rBQDMkKm9cZn6M9NPsiVew folded on the Flop
Seat 6: KqHysDSpCPaPyK3tJC1aEw (button) folded before Flop (didn't bet)
Seat 7: 254YPxPJr5Sw58bkD0YqYQ (small blind) folded before Flop
Seat 8: cM6efHzdxoqYm0EQKP4TTQ (big blind) folded before Flop
Seat 9: GX1heJ+DSsvm7gzSPsYhhQ folded before Flop (didn't bet)



PokerStars Game #59941808028:  Hold'em No Limit ($1/$2) - 2009/07/01 1:46:48 ET
Table '4NGNnZ/osQfNq6abYqkJeA' 6-max Seat #4 is the button
Seat 2: 669iGNwYwgRZg3nhS+aDAQ ($132.25 in chips)
Seat 3: 54yWzRRgS0oZ+S6LwZBxMQ ($39 in chips)
Seat 4: sY+4Uuh5z/6AbXXaCS10jw ($303.75 in chips)
Seat 5: VvdR9F3I+2yELkfTVvC1dg ($226.55 in chips)
Seat 6: /PH6Ffnho4Ysm8S3V/oa+w ($40 in chips)
VvdR9F3I+2yELkfTVvC1dg: posts small blind $1
/PH6Ffnho4Ysm8S3V/oa+w: posts big blind $2
*** HOLE CARDS ***
669iGNwYwgRZg3nhS+aDAQ: folds
54yWzRRgS0oZ+S6LwZBxMQ: folds
sY+4Uuh5z/6AbXXaCS10jw: folds
VvdR9F3I+2yELkfTVvC1dg: folds
/PH6Ffnho4Ysm8S3V/oa+w collected $2 from pot
/PH6Ffnho4Ysm8S3V/oa+w: doesn't show hand
*** SUMMARY ***
Total pot $2 | Rake $0
Seat 2: 669iGNwYwgRZg3nhS+aDAQ folded before Flop (didn't bet)
Seat 3: 54yWzRRgS0oZ+S6LwZBxMQ folded before Flop (didn't bet)
Seat 4: sY+4Uuh5z/6AbXXaCS10jw (button) folded before Flop (didn't bet)
Seat 5: VvdR9F3I+2yELkfTVvC1dg (small blind) folded before Flop
Seat 6: /PH6Ffnho4Ysm8S3V/oa+w (big blind) collected ($2)



PokerStars Game #59941808950:  Hold'em No Limit ($1/$2) - 2009/07/01 1:46:49 ET
Table 'uJ9juaXXg9yIcSU8amxaXQ' 6-max Seat #6 is the button
Seat 1: JsqOjN/eHz0uYVf/PyUJ6Q ($132.25 in chips)
Seat 2: VvdR9F3I+2yELkfTVvC1dg ($200.30 in chips)
Seat 3: qXDd0ZyMIse0OBu8pxeQ3Q ($243.40 in chips)
Seat 4: zNjJ/y4emmF+vzrCDd+ooA ($269.40 in chips)
Seat 5: YsLQ3BAvgQHWXMAv3Wv6Hg ($212.70 in chips)
Seat 6: /PH6Ffnho4Ysm8S3V/oa+w ($40 in chips)
JsqOjN/eHz0uYVf/PyUJ6Q: posts small blind $1
VvdR9F3I+2yELkfTVvC1dg: posts big blind $2
*** HOLE CARDS ***
qXDd0ZyMIse0OBu8pxeQ3Q: folds
zNjJ/y4emmF+vzrCDd+ooA: folds
YsLQ3BAvgQHWXMAv3Wv6Hg: raises $4 to $6
/PH6Ffnho4Ysm8S3V/oa+w: folds
JsqOjN/eHz0uYVf/PyUJ6Q: folds
VvdR9F3I+2yELkfTVvC1dg: folds
YsLQ3BAvgQHWXMAv3Wv6Hg collected $5 from pot
YsLQ3BAvgQHWXMAv3Wv6Hg: doesn't show hand
*** SUMMARY ***
Total pot $5 | Rake $0
Seat 1: JsqOjN/eHz0uYVf/PyUJ6Q (small blind) folded before Flop
Seat 2: VvdR9F3I+2yELkfTVvC1dg (big blind) folded before Flop
Seat 3: qXDd0ZyMIse0OBu8pxeQ3Q folded before Flop (didn't bet)
Seat 4: zNjJ/y4emmF+vzrCDd+ooA folded before Flop (didn't bet)
Seat 5: YsLQ3BAvgQHWXMAv3Wv6Hg collected ($5)
Seat 6: /PH6Ffnho4Ysm8S3V/oa+w (button) folded before Flop (didn't bet)



PokerStars Game #59941809490:  Hold'em No Limit ($1/$2) - 2009/07/01 1:46:50 ET
Table 'jlrIxbrVIG+gjaUYT4za8g' 6-max Seat #2 is the button
Seat 2: cwfuMyvDC7J7SqX2leDC8g ($46 in chips)
Seat 3: gnYme0DNFflnMhrdbxe1Ag ($201.80 in chips)
Seat 4: 8srN1dKQePlsv0GyTada+Q ($268.70 in chips)
Seat 5: AyBB0k3Dcl7xbXUeGMw06g ($41.15 in chips)
Seat 6: BWhgxe7gWiYobRbwdG+d2Q ($196 in chips)
gnYme0DNFflnMhrdbxe1Ag: posts small blind $1
8srN1dKQePlsv0GyTada+Q: posts big blind $2
*** HOLE CARDS ***
AyBB0k3Dcl7xbXUeGMw06g: calls $2
BWhgxe7gWiYobRbwdG+d2Q: folds
cwfuMyvDC7J7SqX2leDC8g: folds
gnYme0DNFflnMhrdbxe1Ag: folds
8srN1dKQePlsv0GyTada+Q: raises $6 to $8
AyBB0k3Dcl7xbXUeGMw06g: calls $6
*** FLOP *** [Ad Qs 4d]
gnYme0DNFflnMhrdbxe1Ag leaves the table
8srN1dKQePlsv0GyTada+Q: checks
AyBB0k3Dcl7xbXUeGMw06g: bets $6
8srN1dKQePlsv0GyTada+Q: folds
AyBB0k3Dcl7xbXUeGMw06g collected $16.15 from pot
*** SUMMARY ***
Total pot $17 | Rake $0.85
Board [Ad Qs 4d]
Seat 2: cwfuMyvDC7J7SqX2leDC8g (button) folded before Flop (didn't bet)
Seat 3: gnYme0DNFflnMhrdbxe1Ag (small blind) folded before Flop
Seat 4: 8srN1dKQePlsv0GyTada+Q (big blind) folded on the Flop
Seat 5: AyBB0k3Dcl7xbXUeGMw06g collected ($16.15)
Seat 6: BWhgxe7gWiYobRbwdG+d2Q folded before Flop (didn't bet)



PokerStars Game #59941809800:  Hold'em No Limit ($1/$2) - 2009/07/01 1:46:51 ET
Table 'P/yCfYl1GfGsu/e6DxDy/A' 2-max Seat #2 is the button
Seat 1: 7fOCUy3x9hdkmXkkDNolGQ ($533.50 in chips)
Seat 2: RwDoM55ZeQuI2ADyJhOb2Q ($939.50 in chips)
RwDoM55ZeQuI2ADyJhOb2Q: posts small blind $1
7fOCUy3x9hdkmXkkDNolGQ: posts big blind $2
*** HOLE CARDS ***
RwDoM55ZeQuI2ADyJhOb2Q: folds
7fOCUy3x9hdkmXkkDNolGQ collected $2 from pot
7fOCUy3x9hdkmXkkDNolGQ: doesn't show hand
*** SUMMARY ***
Total pot $2 | Rake $0
Seat 1: 7fOCUy3x9hdkmXkkDNolGQ (big blind) collected ($2)
Seat 2: RwDoM55ZeQuI2ADyJhOb2Q (button) (small blind) folded before Flop



PokerStars Game #59941812252:  Hold'em No Limit ($1/$2) - 2009/07/01 1:46:56 ET
Table 'G1Oqdy4Pqdb5gtx40rUBzA' 6-max Seat #2 is the button
Seat 1: 4dMBh/1VTdeUTPCyhCs3UQ ($60 in chips)
Seat 2: m7mYVfnCOK5TE/VkN/FhOg ($209.05 in chips)
Seat 3: VvdR9F3I+2yELkfTVvC1dg ($425.90 in chips)
Seat 4: B87ikIyZ/TzAVeXf38Ny0g ($217.70 in chips)
Seat 5: F1+Ml47qRQWunzPnGhLLzQ ($200 in chips)
Seat 6: qCnEYuAE5y5A7bk6fO5/jQ ($200 in chips)
VvdR9F3I+2yELkfTVvC1dg: posts small blind $1
B87ikIyZ/TzAVeXf38Ny0g: posts big blind $2
4dMBh/1VTdeUTPCyhCs3UQ: posts big blind $2
*** HOLE CARDS ***
F1+Ml47qRQWunzPnGhLLzQ: folds
qCnEYuAE5y5A7bk6fO5/jQ: folds
4dMBh/1VTdeUTPCyhCs3UQ: checks
m7mYVfnCOK5TE/VkN/FhOg: folds
VvdR9F3I+2yELkfTVvC1dg: calls $1
B87ikIyZ/TzAVeXf38Ny0g: checks
*** FLOP *** [6s 3c 4d]
VvdR9F3I+2yELkfTVvC1dg: checks
B87ikIyZ/TzAVeXf38Ny0g: checks
4dMBh/1VTdeUTPCyhCs3UQ: checks
*** TURN *** [6s 3c 4d] [7c]
VvdR9F3I+2yELkfTVvC1dg: checks
B87ikIyZ/TzAVeXf38Ny0g: checks
4dMBh/1VTdeUTPCyhCs3UQ: checks
*** RIVER *** [6s 3c 4d 7c] [5s]
VvdR9F3I+2yELkfTVvC1dg: checks
B87ikIyZ/TzAVeXf38Ny0g: checks
4dMBh/1VTdeUTPCyhCs3UQ: bets $4
VvdR9F3I+2yELkfTVvC1dg: folds
B87ikIyZ/TzAVeXf38Ny0g: folds
4dMBh/1VTdeUTPCyhCs3UQ collected $5.70 from pot
4dMBh/1VTdeUTPCyhCs3UQ: doesn't show hand
*** SUMMARY ***
Total pot $6 | Rake $0.30
Board [6s 3c 4d 7c 5s]
Seat 1: 4dMBh/1VTdeUTPCyhCs3UQ collected ($5.70)
Seat 2: m7mYVfnCOK5TE/VkN/FhOg (button) folded before Flop (didn't bet)
Seat 3: VvdR9F3I+2yELkfTVvC1dg (small blind) folded on the River
Seat 4: B87ikIyZ/TzAVeXf38Ny0g (big blind) folded on the River
Seat 5: F1+Ml47qRQWunzPnGhLLzQ folded before Flop (didn't bet)
Seat 6: qCnEYuAE5y5A7bk6fO5/jQ folded before Flop (didn't bet)



PokerStars Game #59941812814:  Hold'em No Limit ($1/$2) - 2009/07/01 1:46:57 ET
Table 'P/yCfYl1GfGsu/e6DxDy/A' 2-max Seat #1 is the button
Seat 1: 7fOCUy3x9hdkmXkkDNolGQ ($534.50 in chips)
Seat 2: RwDoM55ZeQuI2ADyJhOb2Q ($938.50 in chips)
7fOCUy3x9hdkmXkkDNolGQ: posts small blind $1
RwDoM55ZeQuI2ADyJhOb2Q: posts big blind $2
*** HOLE CARDS ***
7fOCUy3x9hdkmXkkDNolGQ: folds
RwDoM55ZeQuI2ADyJhOb2Q collected $2 from pot
RwDoM55ZeQuI2ADyJhOb2Q: doesn't show hand
*** SUMMARY ***
Total pot $2 | Rake $0
Seat 1: 7fOCUy3x9hdkmXkkDNolGQ (button) (small blind) folded before Flop
Seat 2: RwDoM55ZeQuI2ADyJhOb2Q (big blind) collected ($2)



PokerStars Game #59941815116:  Hold'em No Limit ($1/$2) - 2009/07/01 1:47:01 ET
Table '5/wEe6JmtGD7vufSA2RG7A' 2-max Seat #2 is the button
Seat 1: pVqEzK9wXlRMECnb1Zg4Zw ($113.10 in chips)
Seat 2: aOL8geThaYp2iadSHl1h1g ($126.50 in chips)
aOL8geThaYp2iadSHl1h1g: posts small blind $1
pVqEzK9wXlRMECnb1Zg4Zw: posts big blind $2
*** HOLE CARDS ***
aOL8geThaYp2iadSHl1h1g: raises $4 to $6
pVqEzK9wXlRMECnb1Zg4Zw: calls $4
*** FLOP *** [Jh 5s Ts]
pVqEzK9wXlRMECnb1Zg4Zw: checks
aOL8geThaYp2iadSHl1h1g: bets $8
pVqEzK9wXlRMECnb1Zg4Zw: folds
aOL8geThaYp2iadSHl1h1g collected $11.50 from pot
aOL8geThaYp2iadSHl1h1g: doesn't show hand
*** SUMMARY ***
Total pot $12 | Rake $0.50
Board [Jh 5s Ts]
Seat 1: pVqEzK9wXlRMECnb1Zg4Zw (big blind) folded on the Flop
Seat 2: aOL8geThaYp2iadSHl1h1g (button) (small blind) collected ($11.50)



PokerStars Game #59941816050:  Hold'em No Limit ($1/$2) - 2009/07/01 1:47:03 ET
Table 'P/yCfYl1GfGsu/e6DxDy/A' 2-max Seat #2 is the button
Seat 1: 7fOCUy3x9hdkmXkkDNolGQ ($533.50 in chips)
Seat 2: RwDoM55ZeQuI2ADyJhOb2Q ($939.50 in chips)
RwDoM55ZeQuI2ADyJhOb2Q: posts small blind $1
7fOCUy3x9hdkmXkkDNolGQ: posts big blind $2
*** HOLE CARDS ***
RwDoM55ZeQuI2ADyJhOb2Q: raises $4 to $6
7fOCUy3x9hdkmXkkDNolGQ: calls $4
*** FLOP *** [Tc 3s 4c]
7fOCUy3x9hdkmXkkDNolGQ: checks
RwDoM55ZeQuI2ADyJhOb2Q: bets $8
7fOCUy3x9hdkmXkkDNolGQ: calls $8
*** TURN *** [Tc 3s 4c] [2d]
7fOCUy3x9hdkmXkkDNolGQ: checks
RwDoM55ZeQuI2ADyJhOb2Q: bets $22
7fOCUy3x9hdkmXkkDNolGQ: calls $22
*** RIVER *** [Tc 3s 4c 2d] [Jd]
7fOCUy3x9hdkmXkkDNolGQ: checks
RwDoM55ZeQuI2ADyJhOb2Q: checks
*** SHOW DOWN ***
7fOCUy3x9hdkmXkkDNolGQ: shows [5h 3h] (a pair of Threes)
RwDoM55ZeQuI2ADyJhOb2Q: mucks hand
7fOCUy3x9hdkmXkkDNolGQ collected $71.50 from pot
*** SUMMARY ***
Total pot $72 | Rake $0.50
Board [Tc 3s 4c 2d Jd]
Seat 1: 7fOCUy3x9hdkmXkkDNolGQ (big blind) showed [5h 3h] and won ($71.50) with a pair of Threes
Seat 2: RwDoM55ZeQuI2ADyJhOb2Q (button) (small blind) mucked



PokerStars Game #59941815766:  Hold'em No Limit ($1/$2) - 2009/07/01 1:47:03 ET
Table 'TsEDkiO4tzCTCzJ7tNdEqw' 6-max Seat #1 is the button
Seat 1: vkfxu8f/jMYKUk6Ly4eujw ($266 in chips)
Seat 2: 4dcDwIHRm96PwtqkpQiuiA ($80.65 in chips)
Seat 3: ubtx4Z5L+AcK71MTvYiGVw ($200 in chips)
Seat 4: K8MXCrNAVYlMnnCeM32Kxw ($123 in chips)
Seat 5: VvdR9F3I+2yELkfTVvC1dg ($246.35 in chips)
Seat 6: uCqEjnxh2/vFBjKYkfTOkw ($292.80 in chips)
4dcDwIHRm96PwtqkpQiuiA: posts small blind $1
ubtx4Z5L+AcK71MTvYiGVw: posts big blind $2
*** HOLE CARDS ***
K8MXCrNAVYlMnnCeM32Kxw: folds
VvdR9F3I+2yELkfTVvC1dg: raises $2 to $4
uCqEjnxh2/vFBjKYkfTOkw: folds
vkfxu8f/jMYKUk6Ly4eujw: folds
4dcDwIHRm96PwtqkpQiuiA: folds
ubtx4Z5L+AcK71MTvYiGVw: folds
VvdR9F3I+2yELkfTVvC1dg collected $5 from pot
VvdR9F3I+2yELkfTVvC1dg: doesn't show hand
*** SUMMARY ***
Total pot $5 | Rake $0
Seat 1: vkfxu8f/jMYKUk6Ly4eujw (button) folded before Flop (didn't bet)
Seat 2: 4dcDwIHRm96PwtqkpQiuiA (small blind) folded before Flop
Seat 3: ubtx4Z5L+AcK71MTvYiGVw (big blind) folded before Flop
Seat 4: K8MXCrNAVYlMnnCeM32Kxw folded before Flop (didn't bet)
Seat 5: VvdR9F3I+2yELkfTVvC1dg collected ($5)
Seat 6: uCqEjnxh2/vFBjKYkfTOkw folded before Flop (didn't bet)



PokerStars Game #59941816364:  Hold'em No Limit ($1/$2) - 2009/07/01 1:47:04 ET
Table 'UGLAZZyv+cXmnKjYin0etA' 6-max Seat #5 is the button
Seat 2: eDLH1PUXFpvJBNMXBVQcGA ($307.10 in chips)
Seat 3: ygTTt5ehT4aF86q1a8/R+w ($108.20 in chips)
Seat 4: SiGJDsvRViJX05vHhA80GQ ($234.85 in chips)
Seat 5: 54yWzRRgS0oZ+S6LwZBxMQ ($38.05 in chips)
Seat 6: sTPOWERd9HWPCNrDBwsVjA ($219.95 in chips)
sTPOWERd9HWPCNrDBwsVjA: posts small blind $1
vkfxu8f/jMYKUk6Ly4eujw: is sitting out
eDLH1PUXFpvJBNMXBVQcGA: posts big blind $2
*** HOLE CARDS ***
vkfxu8f/jMYKUk6Ly4eujw leaves the table
ygTTt5ehT4aF86q1a8/R+w: raises $4 to $6
SiGJDsvRViJX05vHhA80GQ: folds
54yWzRRgS0oZ+S6LwZBxMQ: folds
sTPOWERd9HWPCNrDBwsVjA: folds
eDLH1PUXFpvJBNMXBVQcGA: folds
ygTTt5ehT4aF86q1a8/R+w collected $5 from pot
*** SUMMARY ***
Total pot $5 | Rake $0
Seat 2: eDLH1PUXFpvJBNMXBVQcGA (big blind) folded before Flop
Seat 3: ygTTt5ehT4aF86q1a8/R+w collected ($5)
Seat 4: SiGJDsvRViJX05vHhA80GQ folded before Flop (didn't bet)
Seat 5: 54yWzRRgS0oZ+S6LwZBxMQ (button) folded before Flop (didn't bet)
Seat 6: sTPOWERd9HWPCNrDBwsVjA (small blind) folded before Flop



PokerStars Game #59941818352:  Hold'em No Limit ($1/$2) - 2009/07/01 1:47:07 ET
Table 'qVXak+oTeDXMGbWa4sDU5Q' 9-max Seat #2 is the button
Seat 1: H6Z4+qu8gR0VUiPOijndVg ($230.45 in chips)
Seat 2: CST1bO+CmVQOtNgiT0cKPg ($123.20 in chips)
Seat 3: WUlHm+ydPPHG7Lb0rePSdA ($178.35 in chips)
Seat 4: lQYT23h5QCUVZAKxjOO39Q ($180.10 in chips)
Seat 5: zJtQ1gxyi72XvGYS1tM+DA ($97 in chips)
Seat 6: GX1heJ+DSsvm7gzSPsYhhQ ($88 in chips)
Seat 7: 6oGEJqk9oDy29sSaLs+LGA ($18.65 in chips)
Seat 8: Z0rzUi0y1x80UdIpofoNbA ($106.55 in chips)
Seat 9: CkE3IyJF1KvdaAOmZY5XqQ ($212.55 in chips)
WUlHm+ydPPHG7Lb0rePSdA: posts small blind $1
lQYT23h5QCUVZAKxjOO39Q: posts big blind $2
*** HOLE CARDS ***
zJtQ1gxyi72XvGYS1tM+DA has timed out
zJtQ1gxyi72XvGYS1tM+DA: folds
zJtQ1gxyi72XvGYS1tM+DA is sitting out
GX1heJ+DSsvm7gzSPsYhhQ: raises $4 to $6
6oGEJqk9oDy29sSaLs+LGA: folds
Z0rzUi0y1x80UdIpofoNbA: folds
CkE3IyJF1KvdaAOmZY5XqQ: folds
H6Z4+qu8gR0VUiPOijndVg: folds
CST1bO+CmVQOtNgiT0cKPg: raises $12 to $18
WUlHm+ydPPHG7Lb0rePSdA: folds
lQYT23h5QCUVZAKxjOO39Q: folds
GX1heJ+DSsvm7gzSPsYhhQ: calls $12
*** FLOP *** [7d Kd 5d]
GX1heJ+DSsvm7gzSPsYhhQ: checks
CST1bO+CmVQOtNgiT0cKPg: bets $20
GX1heJ+DSsvm7gzSPsYhhQ: folds
CST1bO+CmVQOtNgiT0cKPg collected $37.05 from pot
*** SUMMARY ***
Total pot $39 | Rake $1.95
Board [7d Kd 5d]
Seat 1: H6Z4+qu8gR0VUiPOijndVg folded before Flop (didn't bet)
Seat 2: CST1bO+CmVQOtNgiT0cKPg (button) collected ($37.05)
Seat 3: WUlHm+ydPPHG7Lb0rePSdA (small blind) folded before Flop
Seat 4: lQYT23h5QCUVZAKxjOO39Q (big blind) folded before Flop
Seat 5: zJtQ1gxyi72XvGYS1tM+DA folded before Flop (didn't bet)
Seat 6: GX1heJ+DSsvm7gzSPsYhhQ folded on the Flop
Seat 7: 6oGEJqk9oDy29sSaLs+LGA folded before Flop (didn't bet)
Seat 8: Z0rzUi0y1x80UdIpofoNbA folded before Flop (didn't bet)
Seat 9: CkE3IyJF1KvdaAOmZY5XqQ folded before Flop (didn't bet)



PokerStars Game #59941818758:  Hold'em No Limit ($1/$2) - 2009/07/01 1:47:08 ET
Table 'NmY84NAf9Mh0ckAckHnh5g' 2-max Seat #2 is the button
Seat 1: 6hvg964TSqZ3AL/0XK9aVQ ($628.75 in chips)
Seat 2: RwDoM55ZeQuI2ADyJhOb2Q ($358.25 in chips)
RwDoM55ZeQuI2ADyJhOb2Q: posts small blind $1
6hvg964TSqZ3AL/0XK9aVQ: posts big blind $2
*** HOLE CARDS ***
RwDoM55ZeQuI2ADyJhOb2Q: raises $4 to $6
6hvg964TSqZ3AL/0XK9aVQ: calls $4
*** FLOP *** [4d 8c 9h]
6hvg964TSqZ3AL/0XK9aVQ: checks
RwDoM55ZeQuI2ADyJhOb2Q: bets $14
6hvg964TSqZ3AL/0XK9aVQ: folds
RwDoM55ZeQuI2ADyJhOb2Q collected $11.50 from pot
RwDoM55ZeQuI2ADyJhOb2Q: doesn't show hand
*** SUMMARY ***
Total pot $12 | Rake $0.50
Board [4d 8c 9h]
Seat 1: 6hvg964TSqZ3AL/0XK9aVQ (big blind) folded on the Flop
Seat 2: RwDoM55ZeQuI2ADyJhOb2Q (button) (small blind) collected ($11.50)



PokerStars Game #59941820402:  Hold'em No Limit ($1/$2) - 2009/07/01 1:47:11 ET
Table 'bJQ024BaYSBrW0sXpCZbNQ' 6-max Seat #6 is the button
Seat 1: KfwW5us6tydK81NYTtK1gw ($205.40 in chips)
Seat 2: 3dAbvkxS5NPQTBAbvpinVg ($270 in chips)
Seat 3: /PH6Ffnho4Ysm8S3V/oa+w ($123 in chips)
Seat 5: VvdR9F3I+2yELkfTVvC1dg ($200 in chips)
Seat 6: 4bqvCfJ0e8CTYnn0Go9hbQ ($137.20 in chips)
KfwW5us6tydK81NYTtK1gw: posts small blind $1
3dAbvkxS5NPQTBAbvpinVg: posts big blind $2
*** HOLE CARDS ***
vkfxu8f/jMYKUk6Ly4eujw joins the table at seat #4
/PH6Ffnho4Ysm8S3V/oa+w: folds
VvdR9F3I+2yELkfTVvC1dg: folds
4bqvCfJ0e8CTYnn0Go9hbQ: calls $2
KfwW5us6tydK81NYTtK1gw: folds
3dAbvkxS5NPQTBAbvpinVg: checks
*** FLOP *** [9c 9d 2s]
3dAbvkxS5NPQTBAbvpinVg: checks
4bqvCfJ0e8CTYnn0Go9hbQ: checks
*** TURN *** [9c 9d 2s] [3h]
3dAbvkxS5NPQTBAbvpinVg: checks
4bqvCfJ0e8CTYnn0Go9hbQ: bets $4
3dAbvkxS5NPQTBAbvpinVg: folds
4bqvCfJ0e8CTYnn0Go9hbQ collected $4.75 from pot
4bqvCfJ0e8CTYnn0Go9hbQ: doesn't show hand
*** SUMMARY ***
Total pot $5 | Rake $0.25
Board [9c 9d 2s 3h]
Seat 1: KfwW5us6tydK81NYTtK1gw (small blind) folded before Flop
Seat 2: 3dAbvkxS5NPQTBAbvpinVg (big blind) folded on the Turn
Seat 3: /PH6Ffnho4Ysm8S3V/oa+w folded before Flop (didn't bet)
Seat 5: VvdR9F3I+2yELkfTVvC1dg folded before Flop (didn't bet)
Seat 6: 4bqvCfJ0e8CTYnn0Go9hbQ (button) collected ($4.75)



PokerStars Game #59941820446:  Hold'em No Limit ($1/$2) - 2009/07/01 1:47:11 ET
Table '/dyk+YdRGv90j2box35j8w' 6-max Seat #1 is the button
Seat 1: 8srN1dKQePlsv0GyTada+Q ($200 in chips)
Seat 2: qCnEYuAE5y5A7bk6fO5/jQ ($500.20 in chips)
Seat 3: sTPOWERd9HWPCNrDBwsVjA ($203.50 in chips)
Seat 4: 4dMBh/1VTdeUTPCyhCs3UQ ($54 in chips)
Seat 5: VvdR9F3I+2yELkfTVvC1dg ($268.80 in chips)
qCnEYuAE5y5A7bk6fO5/jQ: posts small blind $1
sTPOWERd9HWPCNrDBwsVjA: posts big blind $2
*** HOLE CARDS ***
4dMBh/1VTdeUTPCyhCs3UQ: calls $2
VvdR9F3I+2yELkfTVvC1dg: folds
8srN1dKQePlsv0GyTada+Q: folds
qCnEYuAE5y5A7bk6fO5/jQ: folds
sTPOWERd9HWPCNrDBwsVjA: checks
*** FLOP *** [7d 6d 2h]
sTPOWERd9HWPCNrDBwsVjA: checks
4dMBh/1VTdeUTPCyhCs3UQ: checks
*** TURN *** [7d 6d 2h] [8d]
sTPOWERd9HWPCNrDBwsVjA: checks
4dMBh/1VTdeUTPCyhCs3UQ: bets $4
sTPOWERd9HWPCNrDBwsVjA: folds
4dMBh/1VTdeUTPCyhCs3UQ collected $4.75 from pot
4dMBh/1VTdeUTPCyhCs3UQ: doesn't show hand
*** SUMMARY ***
Total pot $5 | Rake $0.25
Board [7d 6d 2h 8d]
Seat 1: 8srN1dKQePlsv0GyTada+Q (button) folded before Flop (didn't bet)
Seat 2: qCnEYuAE5y5A7bk6fO5/jQ (small blind) folded before Flop
Seat 3: sTPOWERd9HWPCNrDBwsVjA (big blind) folded on the Turn
Seat 4: 4dMBh/1VTdeUTPCyhCs3UQ collected ($4.75)
Seat 5: VvdR9F3I+2yELkfTVvC1dg folded before Flop (didn't bet)



PokerStars Game #59941820220:  Hold'em No Limit ($1/$2) - 2009/07/01 1:47:11 ET
Table '/ci73fTmzTzmGWzAtqEX2Q' 9-max Seat #3 is the button
Seat 1: 9efVc1cB3yHt4TvBkTusPw ($138.50 in chips)
Seat 2: pN/Ip0ePsUVIdUlGgLrkUw ($221 in chips)
Seat 3: 254YPxPJr5Sw58bkD0YqYQ ($200 in chips)
Seat 4: 2yq7Zp4xmrhAw8+37hTkaA ($138.90 in chips)
Seat 6: KqHysDSpCPaPyK3tJC1aEw ($200 in chips)
Seat 7: +T/63sAeZzWyHchahJ36GQ ($72 in chips)
Seat 8: /inIs/z/PcX+TniIFpaxpg ($35.75 in chips)
Seat 9: S8aS+9FTYQ/ICLBNThcrkg ($174 in chips)
2yq7Zp4xmrhAw8+37hTkaA: posts small blind $1
KqHysDSpCPaPyK3tJC1aEw: posts big blind $2
*** HOLE CARDS ***
+T/63sAeZzWyHchahJ36GQ: folds
/inIs/z/PcX+TniIFpaxpg: folds
S8aS+9FTYQ/ICLBNThcrkg: folds
9efVc1cB3yHt4TvBkTusPw: folds
pN/Ip0ePsUVIdUlGgLrkUw: folds
254YPxPJr5Sw58bkD0YqYQ: folds
2yq7Zp4xmrhAw8+37hTkaA: calls $1
KqHysDSpCPaPyK3tJC1aEw: raises $4 to $6
2yq7Zp4xmrhAw8+37hTkaA: calls $4
*** FLOP *** [Ts Js 6c]
2yq7Zp4xmrhAw8+37hTkaA: checks
KqHysDSpCPaPyK3tJC1aEw: checks
*** TURN *** [Ts Js 6c] [4d]
/inIs/z/PcX+TniIFpaxpg leaves the table
2yq7Zp4xmrhAw8+37hTkaA: bets $6
KqHysDSpCPaPyK3tJC1aEw: folds
2yq7Zp4xmrhAw8+37hTkaA collected $11.40 from pot
*** SUMMARY ***
Total pot $12 | Rake $0.60
Board [Ts Js 6c 4d]
Seat 1: 9efVc1cB3yHt4TvBkTusPw folded before Flop (didn't bet)
Seat 2: pN/Ip0ePsUVIdUlGgLrkUw folded before Flop (didn't bet)
Seat 3: 254YPxPJr5Sw58bkD0YqYQ (button) folded before Flop (didn't bet)
Seat 4: 2yq7Zp4xmrhAw8+37hTkaA (small blind) collected ($11.40)
Seat 6: KqHysDSpCPaPyK3tJC1aEw (big blind) folded on the Turn
Seat 7: +T/63sAeZzWyHchahJ36GQ folded before Flop (didn't bet)
Seat 8: /inIs/z/PcX+TniIFpaxpg folded before Flop (didn't bet)
Seat 9: S8aS+9FTYQ/ICLBNThcrkg folded before Flop (didn't bet)



PokerStars Game #59941820722:  Hold'em No Limit ($1/$2) - 2009/07/01 1:47:12 ET
Table '3WCXyaiCAbqSShQu7FIjvA' 9-max Seat #8 is the button
Seat 1: kTCkABD1UUldS9DFRGfCwQ ($144.75 in chips)
Seat 2: TAfo4veNRaRlzDXMMYS3Jg ($48.70 in chips)
Seat 3: 5Q8U6iZbeO7xJSS4qvDP5g ($270.25 in chips)
Seat 4: waEF/+pxZTxNo4FvsORuXg ($103.40 in chips)
Seat 5: CkE3IyJF1KvdaAOmZY5XqQ ($210.90 in chips)
Seat 6: 5jQlngvMSqM/WoonOcR5kw ($276.80 in chips)
Seat 7: nXDI8Y/S6POzRwANu3d8hQ ($44.10 in chips)
Seat 8: +T/63sAeZzWyHchahJ36GQ ($37 in chips)
Seat 9: FiXPLJyqb24l32QST2TInw ($101.10 in chips)
FiXPLJyqb24l32QST2TInw: posts small blind $1
kTCkABD1UUldS9DFRGfCwQ: posts big blind $2
*** HOLE CARDS ***
TAfo4veNRaRlzDXMMYS3Jg: folds
5Q8U6iZbeO7xJSS4qvDP5g: folds
waEF/+pxZTxNo4FvsORuXg: folds
CkE3IyJF1KvdaAOmZY5XqQ: folds
5jQlngvMSqM/WoonOcR5kw: raises $2 to $4
nXDI8Y/S6POzRwANu3d8hQ: folds
+T/63sAeZzWyHchahJ36GQ: folds
FiXPLJyqb24l32QST2TInw: folds
kTCkABD1UUldS9DFRGfCwQ: calls $2
*** FLOP *** [2h 7c 4h]
kTCkABD1UUldS9DFRGfCwQ: bets $4
5jQlngvMSqM/WoonOcR5kw: calls $4
*** TURN *** [2h 7c 4h] [Tc]
kTCkABD1UUldS9DFRGfCwQ: checks
5jQlngvMSqM/WoonOcR5kw: bets $2
kTCkABD1UUldS9DFRGfCwQ: folds
5jQlngvMSqM/WoonOcR5kw collected $16.20 from pot
*** SUMMARY ***
Total pot $17 | Rake $0.80
Board [2h 7c 4h Tc]
Seat 1: kTCkABD1UUldS9DFRGfCwQ (big blind) folded on the Turn
Seat 2: TAfo4veNRaRlzDXMMYS3Jg folded before Flop (didn't bet)
Seat 3: 5Q8U6iZbeO7xJSS4qvDP5g folded before Flop (didn't bet)
Seat 4: waEF/+pxZTxNo4FvsORuXg folded before Flop (didn't bet)
Seat 5: CkE3IyJF1KvdaAOmZY5XqQ folded before Flop (didn't bet)
Seat 6: 5jQlngvMSqM/WoonOcR5kw collected ($16.20)
Seat 7: nXDI8Y/S6POzRwANu3d8hQ folded before Flop (didn't bet)
Seat 8: +T/63sAeZzWyHchahJ36GQ (button) folded before Flop (didn't bet)
Seat 9: FiXPLJyqb24l32QST2TInw (small blind) folded before Flop



PokerStars Game #59941821018:  Hold'em No Limit ($1/$2) - 2009/07/01 1:47:12 ET
Table 'ZzSIe0zTCDv+n6hfbY5tTg' 6-max Seat #4 is the button
Seat 1: VvdR9F3I+2yELkfTVvC1dg ($261.10 in chips)
Seat 2: B87ikIyZ/TzAVeXf38Ny0g ($228 in chips)
Seat 3: gsugPj31Hui3Jefl98MBOA ($349 in chips)
Seat 4: 54yWzRRgS0oZ+S6LwZBxMQ ($46.10 in chips)
Seat 5: 3dAbvkxS5NPQTBAbvpinVg ($501.45 in chips)
Seat 6: 09BNF4quPDzanQzM8vc6WA ($36 in chips)
3dAbvkxS5NPQTBAbvpinVg: posts small blind $1
09BNF4quPDzanQzM8vc6WA: posts big blind $2
*** HOLE CARDS ***
VvdR9F3I+2yELkfTVvC1dg: folds
B87ikIyZ/TzAVeXf38Ny0g: folds
gsugPj31Hui3Jefl98MBOA: raises $5 to $7
54yWzRRgS0oZ+S6LwZBxMQ: folds
3dAbvkxS5NPQTBAbvpinVg: folds
09BNF4quPDzanQzM8vc6WA: folds
gsugPj31Hui3Jefl98MBOA collected $5 from pot
*** SUMMARY ***
Total pot $5 | Rake $0
Seat 1: VvdR9F3I+2yELkfTVvC1dg folded before Flop (didn't bet)
Seat 2: B87ikIyZ/TzAVeXf38Ny0g folded before Flop (didn't bet)
Seat 3: gsugPj31Hui3Jefl98MBOA collected ($5)
Seat 4: 54yWzRRgS0oZ+S6LwZBxMQ (button) folded before Flop (didn't bet)
Seat 5: 3dAbvkxS5NPQTBAbvpinVg (small blind) folded before Flop
Seat 6: 09BNF4quPDzanQzM8vc6WA (big blind) folded before Flop



PokerStars Game #59941820892:  Hold'em No Limit ($1/$2) - 2009/07/01 1:47:12 ET
Table 'ztv6V3FN2bQ9nmJPPdx6nQ' 6-max Seat #6 is the button
Seat 1: 6fLdOUCRtX71xbVRhJEq8w ($231.35 in chips)
Seat 2: 5Y+ZGWLI4gnlpApDX5vy1A ($433.85 in chips)
Seat 3: ubtx4Z5L+AcK71MTvYiGVw ($241.20 in chips)
Seat 4: UaZ5yj+6LjtWqMQg2QskUw ($66.65 in chips)
Seat 5: sTPOWERd9HWPCNrDBwsVjA ($219.60 in chips)
Seat 6: mfy7uGZcqA2PVQqEVbJ7+g ($99.60 in chips)
6fLdOUCRtX71xbVRhJEq8w: posts small blind $1
5Y+ZGWLI4gnlpApDX5vy1A: posts big blind $2
*** HOLE CARDS ***
ubtx4Z5L+AcK71MTvYiGVw: folds
UaZ5yj+6LjtWqMQg2QskUw: folds
sTPOWERd9HWPCNrDBwsVjA: folds
mfy7uGZcqA2PVQqEVbJ7+g: raises $4 to $6
6fLdOUCRtX71xbVRhJEq8w: calls $5
5Y+ZGWLI4gnlpApDX5vy1A: calls $4
*** FLOP *** [Ts Th Ks]
6fLdOUCRtX71xbVRhJEq8w: checks
5Y+ZGWLI4gnlpApDX5vy1A: checks
mfy7uGZcqA2PVQqEVbJ7+g: checks
*** TURN *** [Ts Th Ks] [3d]
6fLdOUCRtX71xbVRhJEq8w: bets $10
5Y+ZGWLI4gnlpApDX5vy1A: calls $10
mfy7uGZcqA2PVQqEVbJ7+g: calls $10
*** RIVER *** [Ts Th Ks 3d] [8h]
6fLdOUCRtX71xbVRhJEq8w: bets $40
5Y+ZGWLI4gnlpApDX5vy1A: folds
5Y+ZGWLI4gnlpApDX5vy1A is sitting out
5Y+ZGWLI4gnlpApDX5vy1A has returned
mfy7uGZcqA2PVQqEVbJ7+g: calls $40
ubtx4Z5L+AcK71MTvYiGVw is sitting out
*** SHOW DOWN ***
6fLdOUCRtX71xbVRhJEq8w: shows [3s 3h] (a full house, Threes full of Tens)
mfy7uGZcqA2PVQqEVbJ7+g: mucks hand
6fLdOUCRtX71xbVRhJEq8w collected $125 from pot
*** SUMMARY ***
Total pot $128 | Rake $3
Board [Ts Th Ks 3d 8h]
Seat 1: 6fLdOUCRtX71xbVRhJEq8w (small blind) showed [3s 3h] and won ($125) with a full house, Threes full of Tens
Seat 2: 5Y+ZGWLI4gnlpApDX5vy1A (big blind) folded on the River
Seat 3: ubtx4Z5L+AcK71MTvYiGVw folded before Flop (didn't bet)
Seat 4: UaZ5yj+6LjtWqMQg2QskUw folded before Flop (didn't bet)
Seat 5: sTPOWERd9HWPCNrDBwsVjA folded before Flop (didn't bet)
Seat 6: mfy7uGZcqA2PVQqEVbJ7+g (button) mucked



PokerStars Game #59941822184:  Hold'em No Limit ($1/$2) - 2009/07/01 1:47:14 ET
Table 'QxerF7GUfCbl+4a8XaTB2w' 6-max Seat #3 is the button
Seat 1: ZwvXzkkZ3XpMhKfAmVpahw ($276.75 in chips)
Seat 2: 6UGgYbxwWNc+ohObe8vB9w ($39.75 in chips)
Seat 3: 8rZGabKe2DEPdZCbCivZ9Q ($33 in chips)
Seat 4: /PH6Ffnho4Ysm8S3V/oa+w ($42 in chips)
Seat 5: gnYme0DNFflnMhrdbxe1Ag ($257.15 in chips)
Seat 6: VvdR9F3I+2yELkfTVvC1dg ($214.70 in chips)
/PH6Ffnho4Ysm8S3V/oa+w: posts small blind $1
gnYme0DNFflnMhrdbxe1Ag: posts big blind $2
*** HOLE CARDS ***
VvdR9F3I+2yELkfTVvC1dg: folds
ZwvXzkkZ3XpMhKfAmVpahw: folds
6UGgYbxwWNc+ohObe8vB9w: folds
8rZGabKe2DEPdZCbCivZ9Q: raises $4 to $6
/PH6Ffnho4Ysm8S3V/oa+w: raises $36 to $42 and is all-in
gnYme0DNFflnMhrdbxe1Ag: folds
8rZGabKe2DEPdZCbCivZ9Q: folds
gnYme0DNFflnMhrdbxe1Ag leaves the table
/PH6Ffnho4Ysm8S3V/oa+w collected $14 from pot
/PH6Ffnho4Ysm8S3V/oa+w: doesn't show hand
*** SUMMARY ***
Total pot $14 | Rake $0
Seat 1: ZwvXzkkZ3XpMhKfAmVpahw folded before Flop (didn't bet)
Seat 2: 6UGgYbxwWNc+ohObe8vB9w folded before Flop (didn't bet)
Seat 3: 8rZGabKe2DEPdZCbCivZ9Q (button) folded before Flop
Seat 4: /PH6Ffnho4Ysm8S3V/oa+w (small blind) collected ($14)
Seat 5: gnYme0DNFflnMhrdbxe1Ag (big blind) folded before Flop
Seat 6: VvdR9F3I+2yELkfTVvC1dg folded before Flop (didn't bet)



PokerStars Game #59941822272:  Hold'em No Limit ($1/$2) - 2009/07/01 1:47:15 ET
Table 'CFkQcfWjKccZaZDf71FK+w' 6-max Seat #6 is the button
Seat 1: vkfxu8f/jMYKUk6Ly4eujw ($225.25 in chips)
Seat 2: ewN/vzF22+/gdzjIKBOlkA ($200 in chips)
Seat 3: 09BNF4quPDzanQzM8vc6WA ($122.30 in chips)
Seat 4: ygTTt5ehT4aF86q1a8/R+w ($217.65 in chips)
Seat 5: 2lOU1DcvUZaMcxZ95XfzXw ($145.05 in chips)
Seat 6: ORVqY3rf9X6ANA/8s+On2Q ($39.35 in chips)
vkfxu8f/jMYKUk6Ly4eujw: posts small blind $1
ewN/vzF22+/gdzjIKBOlkA: posts big blind $2
*** HOLE CARDS ***
09BNF4quPDzanQzM8vc6WA: folds
ygTTt5ehT4aF86q1a8/R+w: folds
2lOU1DcvUZaMcxZ95XfzXw: folds
ORVqY3rf9X6ANA/8s+On2Q: calls $2
vkfxu8f/jMYKUk6Ly4eujw: folds
ewN/vzF22+/gdzjIKBOlkA: checks
*** FLOP *** [8c 9s Jh]
ewN/vzF22+/gdzjIKBOlkA: checks
ORVqY3rf9X6ANA/8s+On2Q: checks
*** TURN *** [8c 9s Jh] [9h]
ewN/vzF22+/gdzjIKBOlkA: checks
ORVqY3rf9X6ANA/8s+On2Q: checks
*** RIVER *** [8c 9s Jh 9h] [Ks]
ewN/vzF22+/gdzjIKBOlkA: checks
ORVqY3rf9X6ANA/8s+On2Q: checks
*** SHOW DOWN ***
ewN/vzF22+/gdzjIKBOlkA: shows [7s 6d] (a pair of Nines)
ORVqY3rf9X6ANA/8s+On2Q: shows [Qd Qc] (two pair, Queens and Nines)
ORVqY3rf9X6ANA/8s+On2Q collected $4.75 from pot
*** SUMMARY ***
Total pot $5 | Rake $0.25
Board [8c 9s Jh 9h Ks]
Seat 1: vkfxu8f/jMYKUk6Ly4eujw (small blind) folded before Flop
Seat 2: ewN/vzF22+/gdzjIKBOlkA (big blind) showed [7s 6d] and lost with a pair of Nines
Seat 3: 09BNF4quPDzanQzM8vc6WA folded before Flop (didn't bet)
Seat 4: ygTTt5ehT4aF86q1a8/R+w folded before Flop (didn't bet)
Seat 5: 2lOU1DcvUZaMcxZ95XfzXw folded before Flop (didn't bet)
Seat 6: ORVqY3rf9X6ANA/8s+On2Q (button) showed [Qd Qc] and won ($4.75) with two pair, Queens and Nines



PokerStars Game #59941823906:  Hold'em No Limit ($1/$2) - 2009/07/01 1:47:18 ET
Table 'kq5zaQ+1hLNf8LZfGnbTAA' 6-max Seat #5 is the button
Seat 1: 8srN1dKQePlsv0GyTada+Q ($419.60 in chips)
Seat 2: nXDI8Y/S6POzRwANu3d8hQ ($137 in chips)
Seat 3: /PH6Ffnho4Ysm8S3V/oa+w ($58.15 in chips)
Seat 4: 3dAbvkxS5NPQTBAbvpinVg ($281.65 in chips)
Seat 5: gnYme0DNFflnMhrdbxe1Ag ($228.35 in chips)
Seat 6: mfy7uGZcqA2PVQqEVbJ7+g ($186.15 in chips)
mfy7uGZcqA2PVQqEVbJ7+g: posts small blind $1
8srN1dKQePlsv0GyTada+Q: posts big blind $2
*** HOLE CARDS ***
nXDI8Y/S6POzRwANu3d8hQ: folds
/PH6Ffnho4Ysm8S3V/oa+w: folds
3dAbvkxS5NPQTBAbvpinVg: raises $4 to $6
gnYme0DNFflnMhrdbxe1Ag: folds
gnYme0DNFflnMhrdbxe1Ag leaves the table
mfy7uGZcqA2PVQqEVbJ7+g: raises $15 to $21
8srN1dKQePlsv0GyTada+Q: folds
3dAbvkxS5NPQTBAbvpinVg: folds
mfy7uGZcqA2PVQqEVbJ7+g collected $14 from pot
*** SUMMARY ***
Total pot $14 | Rake $0
Seat 1: 8srN1dKQePlsv0GyTada+Q (big blind) folded before Flop
Seat 2: nXDI8Y/S6POzRwANu3d8hQ folded before Flop (didn't bet)
Seat 3: /PH6Ffnho4Ysm8S3V/oa+w folded before Flop (didn't bet)
Seat 4: 3dAbvkxS5NPQTBAbvpinVg folded before Flop
Seat 5: gnYme0DNFflnMhrdbxe1Ag (button) folded before Flop (didn't bet)
Seat 6: mfy7uGZcqA2PVQqEVbJ7+g (small blind) collected ($14)



PokerStars Game #59941824508:  Hold'em No Limit ($1/$2) - 2009/07/01 1:47:19 ET
Table 'uJ9juaXXg9yIcSU8amxaXQ' 6-max Seat #1 is the button
Seat 1: JsqOjN/eHz0uYVf/PyUJ6Q ($131.25 in chips)
Seat 2: VvdR9F3I+2yELkfTVvC1dg ($200 in chips)
Seat 3: qXDd0ZyMIse0OBu8pxeQ3Q ($243.40 in chips)
Seat 4: zNjJ/y4emmF+vzrCDd+ooA ($269.40 in chips)
Seat 5: YsLQ3BAvgQHWXMAv3Wv6Hg ($215.70 in chips)
Seat 6: /PH6Ffnho4Ysm8S3V/oa+w ($40 in chips)
VvdR9F3I+2yELkfTVvC1dg: posts small blind $1
qXDd0ZyMIse0OBu8pxeQ3Q: posts big blind $2
*** HOLE CARDS ***
zNjJ/y4emmF+vzrCDd+ooA: calls $2
YsLQ3BAvgQHWXMAv3Wv6Hg: folds
/PH6Ffnho4Ysm8S3V/oa+w: folds
JsqOjN/eHz0uYVf/PyUJ6Q: calls $2
VvdR9F3I+2yELkfTVvC1dg: folds
qXDd0ZyMIse0OBu8pxeQ3Q: checks
*** FLOP *** [8h As Kd]
qXDd0ZyMIse0OBu8pxeQ3Q: checks
zNjJ/y4emmF+vzrCDd+ooA: checks
JsqOjN/eHz0uYVf/PyUJ6Q: checks
*** TURN *** [8h As Kd] [9s]
qXDd0ZyMIse0OBu8pxeQ3Q: checks
zNjJ/y4emmF+vzrCDd+ooA: bets $4
JsqOjN/eHz0uYVf/PyUJ6Q: calls $4
qXDd0ZyMIse0OBu8pxeQ3Q: folds
*** RIVER *** [8h As Kd 9s] [4d]
zNjJ/y4emmF+vzrCDd+ooA: bets $4
JsqOjN/eHz0uYVf/PyUJ6Q: calls $4
*** SHOW DOWN ***
zNjJ/y4emmF+vzrCDd+ooA: shows [Ks Js] (a pair of Kings)
JsqOjN/eHz0uYVf/PyUJ6Q: mucks hand
zNjJ/y4emmF+vzrCDd+ooA collected $21.90 from pot
*** SUMMARY ***
Total pot $23 | Rake $1.10
Board [8h As Kd 9s 4d]
Seat 1: JsqOjN/eHz0uYVf/PyUJ6Q (button) mucked
Seat 2: VvdR9F3I+2yELkfTVvC1dg (small blind) folded before Flop
Seat 3: qXDd0ZyMIse0OBu8pxeQ3Q (big blind) folded on the Turn
Seat 4: zNjJ/y4emmF+vzrCDd+ooA showed [Ks Js] and won ($21.90) with a pair of Kings
Seat 5: YsLQ3BAvgQHWXMAv3Wv6Hg folded before Flop (didn't bet)
Seat 6: /PH6Ffnho4Ysm8S3V/oa+w folded before Flop (didn't bet)



PokerStars Game #59941826000:  Hold'em No Limit ($1/$2) - 2009/07/01 1:47:21 ET
Table 'mGpP9StWRnoeiBDExc6Frg' 6-max Seat #5 is the button
Seat 1: VvdR9F3I+2yELkfTVvC1dg ($309.15 in chips)
Seat 4: 4dcDwIHRm96PwtqkpQiuiA ($91.70 in chips)
Seat 5: d1puGuVBE0fidn+5eRJ0tw ($191.55 in chips)
Seat 6: B2Ih1sr5VZk+8He7rcrMtQ ($404.45 in chips)
B2Ih1sr5VZk+8He7rcrMtQ: posts small blind $1
VvdR9F3I+2yELkfTVvC1dg: posts big blind $2
6hRJ68JkbJq6MYI9o5bUnQ: sits out
*** HOLE CARDS ***
4dcDwIHRm96PwtqkpQiuiA: folds
d1puGuVBE0fidn+5eRJ0tw: folds
B2Ih1sr5VZk+8He7rcrMtQ: folds
VvdR9F3I+2yELkfTVvC1dg collected $2 from pot
VvdR9F3I+2yELkfTVvC1dg: doesn't show hand
*** SUMMARY ***
Total pot $2 | Rake $0
Seat 1: VvdR9F3I+2yELkfTVvC1dg (big blind) collected ($2)
Seat 4: 4dcDwIHRm96PwtqkpQiuiA folded before Flop (didn't bet)
Seat 5: d1puGuVBE0fidn+5eRJ0tw (button) folded before Flop (didn't bet)
Seat 6: B2Ih1sr5VZk+8He7rcrMtQ (small blind) folded before Flop



PokerStars Game #59941826010:  Hold'em No Limit ($1/$2) - 2009/07/01 1:47:21 ET
Table '4NGNnZ/osQfNq6abYqkJeA' 6-max Seat #5 is the button
Seat 2: 669iGNwYwgRZg3nhS+aDAQ ($132.25 in chips)
Seat 3: 54yWzRRgS0oZ+S6LwZBxMQ ($39 in chips)
Seat 4: sY+4Uuh5z/6AbXXaCS10jw ($303.75 in chips)
Seat 5: VvdR9F3I+2yELkfTVvC1dg ($225.55 in chips)
Seat 6: /PH6Ffnho4Ysm8S3V/oa+w ($41 in chips)
/PH6Ffnho4Ysm8S3V/oa+w: posts small blind $1
669iGNwYwgRZg3nhS+aDAQ: posts big blind $2
*** HOLE CARDS ***
54yWzRRgS0oZ+S6LwZBxMQ: calls $2
sY+4Uuh5z/6AbXXaCS10jw: folds
VvdR9F3I+2yELkfTVvC1dg: calls $2
/PH6Ffnho4Ysm8S3V/oa+w: folds
669iGNwYwgRZg3nhS+aDAQ: checks
*** FLOP *** [4s 4d 8c]
669iGNwYwgRZg3nhS+aDAQ: checks
54yWzRRgS0oZ+S6LwZBxMQ: checks
VvdR9F3I+2yELkfTVvC1dg: checks
*** TURN *** [4s 4d 8c] [7s]
669iGNwYwgRZg3nhS+aDAQ: checks
54yWzRRgS0oZ+S6LwZBxMQ: bets $6
VvdR9F3I+2yELkfTVvC1dg: folds
669iGNwYwgRZg3nhS+aDAQ: folds
54yWzRRgS0oZ+S6LwZBxMQ collected $6.65 from pot
54yWzRRgS0oZ+S6LwZBxMQ: doesn't show hand
*** SUMMARY ***
Total pot $7 | Rake $0.35
Board [4s 4d 8c 7s]
Seat 2: 669iGNwYwgRZg3nhS+aDAQ (big blind) folded on the Turn
Seat 3: 54yWzRRgS0oZ+S6LwZBxMQ collected ($6.65)
Seat 4: sY+4Uuh5z/6AbXXaCS10jw folded before Flop (didn't bet)
Seat 5: VvdR9F3I+2yELkfTVvC1dg (button) folded on the Turn
Seat 6: /PH6Ffnho4Ysm8S3V/oa+w (small blind) folded before Flop



PokerStars Game #59941827052:  Hold'em No Limit ($1/$2) - 2009/07/01 1:47:23 ET
Table 'TsEDkiO4tzCTCzJ7tNdEqw' 6-max Seat #2 is the button
Seat 1: vkfxu8f/jMYKUk6Ly4eujw ($266 in chips)
Seat 2: 4dcDwIHRm96PwtqkpQiuiA ($79.65 in chips)
Seat 3: ubtx4Z5L+AcK71MTvYiGVw ($200 in chips)
Seat 4: K8MXCrNAVYlMnnCeM32Kxw ($123 in chips)
Seat 5: VvdR9F3I+2yELkfTVvC1dg ($249.35 in chips)
Seat 6: uCqEjnxh2/vFBjKYkfTOkw ($292.80 in chips)
ubtx4Z5L+AcK71MTvYiGVw: posts small blind $1
K8MXCrNAVYlMnnCeM32Kxw: posts big blind $2
*** HOLE CARDS ***
VvdR9F3I+2yELkfTVvC1dg: folds
uCqEjnxh2/vFBjKYkfTOkw: folds
vkfxu8f/jMYKUk6Ly4eujw: raises $6 to $8
4dcDwIHRm96PwtqkpQiuiA: folds
ubtx4Z5L+AcK71MTvYiGVw: folds
K8MXCrNAVYlMnnCeM32Kxw: folds
vkfxu8f/jMYKUk6Ly4eujw collected $5 from pot
vkfxu8f/jMYKUk6Ly4eujw: doesn't show hand
*** SUMMARY ***
Total pot $5 | Rake $0
Seat 1: vkfxu8f/jMYKUk6Ly4eujw collected ($5)
Seat 2: 4dcDwIHRm96PwtqkpQiuiA (button) folded before Flop (didn't bet)
Seat 3: ubtx4Z5L+AcK71MTvYiGVw (small blind) folded before Flop
Seat 4: K8MXCrNAVYlMnnCeM32Kxw (big blind) folded before Flop
Seat 5: VvdR9F3I+2yELkfTVvC1dg folded before Flop (didn't bet)
Seat 6: uCqEjnxh2/vFBjKYkfTOkw folded before Flop (didn't bet)



PokerStars Game #59941826586:  Hold'em No Limit ($1/$2) - 2009/07/01 1:47:23 ET
Table 'NmY84NAf9Mh0ckAckHnh5g' 2-max Seat #1 is the button
Seat 1: 6hvg964TSqZ3AL/0XK9aVQ ($622.75 in chips)
Seat 2: RwDoM55ZeQuI2ADyJhOb2Q ($363.75 in chips)
6hvg964TSqZ3AL/0XK9aVQ: posts small blind $1
RwDoM55ZeQuI2ADyJhOb2Q: posts big blind $2
*** HOLE CARDS ***
6hvg964TSqZ3AL/0XK9aVQ: calls $1
RwDoM55ZeQuI2ADyJhOb2Q: checks
*** FLOP *** [8d 9s Td]
RwDoM55ZeQuI2ADyJhOb2Q: bets $6
6hvg964TSqZ3AL/0XK9aVQ: folds
RwDoM55ZeQuI2ADyJhOb2Q collected $3.80 from pot
RwDoM55ZeQuI2ADyJhOb2Q: doesn't show hand
*** SUMMARY ***
Total pot $4 | Rake $0.20
Board [8d 9s Td]
Seat 1: 6hvg964TSqZ3AL/0XK9aVQ (button) (small blind) folded on the Flop
Seat 2: RwDoM55ZeQuI2ADyJhOb2Q (big blind) collected ($3.80)



PokerStars Game #59941829580:  Hold'em No Limit ($1/$2) - 2009/07/01 1:47:28 ET
Table 'P/yCfYl1GfGsu/e6DxDy/A' 2-max Seat #1 is the button
Seat 1: 7fOCUy3x9hdkmXkkDNolGQ ($569 in chips)
Seat 2: RwDoM55ZeQuI2ADyJhOb2Q ($903.50 in chips)
7fOCUy3x9hdkmXkkDNolGQ: posts small blind $1
RwDoM55ZeQuI2ADyJhOb2Q: posts big blind $2
*** HOLE CARDS ***
7fOCUy3x9hdkmXkkDNolGQ: raises $4 to $6
RwDoM55ZeQuI2ADyJhOb2Q: folds
7fOCUy3x9hdkmXkkDNolGQ collected $4 from pot
7fOCUy3x9hdkmXkkDNolGQ: doesn't show hand
*** SUMMARY ***
Total pot $4 | Rake $0
Seat 1: 7fOCUy3x9hdkmXkkDNolGQ (button) (small blind) collected ($4)
Seat 2: RwDoM55ZeQuI2ADyJhOb2Q (big blind) folded before Flop



PokerStars Game #59941829762:  Hold'em No Limit ($1/$2) - 2009/07/01 1:47:29 ET
Table '5/wEe6JmtGD7vufSA2RG7A' 2-max Seat #1 is the button
Seat 1: pVqEzK9wXlRMECnb1Zg4Zw ($107.10 in chips)
Seat 2: aOL8geThaYp2iadSHl1h1g ($132 in chips)
pVqEzK9wXlRMECnb1Zg4Zw: posts small blind $1
aOL8geThaYp2iadSHl1h1g: posts big blind $2
*** HOLE CARDS ***
pVqEzK9wXlRMECnb1Zg4Zw: raises $6 to $8
aOL8geThaYp2iadSHl1h1g: raises $124 to $132 and is all-in
pVqEzK9wXlRMECnb1Zg4Zw: folds
aOL8geThaYp2iadSHl1h1g collected $16 from pot
*** SUMMARY ***
Total pot $16 | Rake $0
Seat 1: pVqEzK9wXlRMECnb1Zg4Zw (button) (small blind) folded before Flop
Seat 2: aOL8geThaYp2iadSHl1h1g (big blind) collected ($16)



PokerStars Game #59941830094:  Hold'em No Limit ($1/$2) - 2009/07/01 1:47:29 ET
Table 'BSRfGh+QobUe0AgIMtt/fw' 9-max Seat #8 is the button
Seat 1: gDn/rYeNwCyWEgRhyWp4PA ($160.05 in chips)
Seat 2: +SmnXtdmwqXGEJfLeJDIUQ ($75.60 in chips)
Seat 3: WUlHm+ydPPHG7Lb0rePSdA ($120 in chips)
Seat 4: +T/63sAeZzWyHchahJ36GQ ($40 in chips)
Seat 5: v0q3vrz/d9oDjLrAG8Ausw ($241.75 in chips)
Seat 6: H6Z4+qu8gR0VUiPOijndVg ($200 in chips)
Seat 7: CkE3IyJF1KvdaAOmZY5XqQ ($200 in chips)
Seat 8: /XRRUMKiOOItJFbrM26RrA ($45.30 in chips)
gDn/rYeNwCyWEgRhyWp4PA: posts small blind $1
+SmnXtdmwqXGEJfLeJDIUQ: posts big blind $2
*** HOLE CARDS ***
WUlHm+ydPPHG7Lb0rePSdA: folds
+T/63sAeZzWyHchahJ36GQ: raises $4 to $6
v0q3vrz/d9oDjLrAG8Ausw: folds
H6Z4+qu8gR0VUiPOijndVg: folds
CkE3IyJF1KvdaAOmZY5XqQ: folds
/XRRUMKiOOItJFbrM26RrA: calls $6
gDn/rYeNwCyWEgRhyWp4PA: folds
+SmnXtdmwqXGEJfLeJDIUQ: raises $14 to $20
tjgwwDmi+N2H4I7hx8useQ joins the table at seat #9
+T/63sAeZzWyHchahJ36GQ: folds
/XRRUMKiOOItJFbrM26RrA: calls $14
*** FLOP *** [2c 2d Ac]
+SmnXtdmwqXGEJfLeJDIUQ: bets $42
/XRRUMKiOOItJFbrM26RrA: calls $25.30 and is all-in
*** TURN *** [2c 2d Ac] [Ts]
*** RIVER *** [2c 2d Ac Ts] [5d]
*** SHOW DOWN ***
+SmnXtdmwqXGEJfLeJDIUQ: shows [Qh Ah] (two pair, Aces and Deuces)
/XRRUMKiOOItJFbrM26RrA: mucks hand
+SmnXtdmwqXGEJfLeJDIUQ collected $94.60 from pot
*** SUMMARY ***
Total pot $97.60 | Rake $3
Board [2c 2d Ac Ts 5d]
Seat 1: gDn/rYeNwCyWEgRhyWp4PA (small blind) folded before Flop
Seat 2: +SmnXtdmwqXGEJfLeJDIUQ (big blind) showed [Qh Ah] and won ($94.60) with two pair, Aces and Deuces
Seat 3: WUlHm+ydPPHG7Lb0rePSdA folded before Flop (didn't bet)
Seat 4: +T/63sAeZzWyHchahJ36GQ folded before Flop
Seat 5: v0q3vrz/d9oDjLrAG8Ausw folded before Flop (didn't bet)
Seat 6: H6Z4+qu8gR0VUiPOijndVg folded before Flop (didn't bet)
Seat 7: CkE3IyJF1KvdaAOmZY5XqQ folded before Flop (didn't bet)
Seat 8: /XRRUMKiOOItJFbrM26RrA (button) mucked



PokerStars Game #59941833518:  Hold'em No Limit ($1/$2) - 2009/07/01 1:47:36 ET
Table 'mGpP9StWRnoeiBDExc6Frg' 6-max Seat #6 is the button
Seat 1: VvdR9F3I+2yELkfTVvC1dg ($310.15 in chips)
Seat 2: 6hRJ68JkbJq6MYI9o5bUnQ ($100 in chips)
Seat 4: 4dcDwIHRm96PwtqkpQiuiA ($91.70 in chips)
Seat 5: d1puGuVBE0fidn+5eRJ0tw ($191.55 in chips)
Seat 6: B2Ih1sr5VZk+8He7rcrMtQ ($403.45 in chips)
VvdR9F3I+2yELkfTVvC1dg: posts small blind $1
6hRJ68JkbJq6MYI9o5bUnQ: posts big blind $2
*** HOLE CARDS ***
4dcDwIHRm96PwtqkpQiuiA: folds
d1puGuVBE0fidn+5eRJ0tw: folds
B2Ih1sr5VZk+8He7rcrMtQ: folds
VvdR9F3I+2yELkfTVvC1dg: folds
6hRJ68JkbJq6MYI9o5bUnQ collected $2 from pot
*** SUMMARY ***
Total pot $2 | Rake $0
Seat 1: VvdR9F3I+2yELkfTVvC1dg (small blind) folded before Flop
Seat 2: 6hRJ68JkbJq6MYI9o5bUnQ (big blind) collected ($2)
Seat 4: 4dcDwIHRm96PwtqkpQiuiA folded before Flop (didn't bet)
Seat 5: d1puGuVBE0fidn+5eRJ0tw folded before Flop (didn't bet)
Seat 6: B2Ih1sr5VZk+8He7rcrMtQ (button) folded before Flop (didn't bet)



PokerStars Game #59941833952:  Hold'em No Limit ($1/$2) - 2009/07/01 1:47:37 ET
Table 'P/yCfYl1GfGsu/e6DxDy/A' 2-max Seat #2 is the button
Seat 1: 7fOCUy3x9hdkmXkkDNolGQ ($571 in chips)
Seat 2: RwDoM55ZeQuI2ADyJhOb2Q ($901.50 in chips)
RwDoM55ZeQuI2ADyJhOb2Q: posts small blind $1
7fOCUy3x9hdkmXkkDNolGQ: posts big blind $2
*** HOLE CARDS ***
RwDoM55ZeQuI2ADyJhOb2Q: raises $4 to $6
7fOCUy3x9hdkmXkkDNolGQ: calls $4
*** FLOP *** [4c 8h 2s]
7fOCUy3x9hdkmXkkDNolGQ: checks
RwDoM55ZeQuI2ADyJhOb2Q: bets $10
7fOCUy3x9hdkmXkkDNolGQ: calls $10
*** TURN *** [4c 8h 2s] [Tc]
7fOCUy3x9hdkmXkkDNolGQ: checks
RwDoM55ZeQuI2ADyJhOb2Q: bets $32
7fOCUy3x9hdkmXkkDNolGQ: folds
RwDoM55ZeQuI2ADyJhOb2Q collected $31.50 from pot
RwDoM55ZeQuI2ADyJhOb2Q: doesn't show hand
*** SUMMARY ***
Total pot $32 | Rake $0.50
Board [4c 8h 2s Tc]
Seat 1: 7fOCUy3x9hdkmXkkDNolGQ (big blind) folded on the Turn
Seat 2: RwDoM55ZeQuI2ADyJhOb2Q (button) (small blind) collected ($31.50)



PokerStars Game #59941834354:  Hold'em No Limit ($1/$2) - 2009/07/01 1:47:38 ET
Table 'NmY84NAf9Mh0ckAckHnh5g' 2-max Seat #2 is the button
Seat 1: 6hvg964TSqZ3AL/0XK9aVQ ($620.75 in chips)
Seat 2: RwDoM55ZeQuI2ADyJhOb2Q ($365.55 in chips)
RwDoM55ZeQuI2ADyJhOb2Q: posts small blind $1
6hvg964TSqZ3AL/0XK9aVQ: posts big blind $2
*** HOLE CARDS ***
RwDoM55ZeQuI2ADyJhOb2Q: raises $4 to $6
6hvg964TSqZ3AL/0XK9aVQ: calls $4
*** FLOP *** [3c Jh 4h]
6hvg964TSqZ3AL/0XK9aVQ: checks
RwDoM55ZeQuI2ADyJhOb2Q: bets $12
6hvg964TSqZ3AL/0XK9aVQ: folds
RwDoM55ZeQuI2ADyJhOb2Q collected $11.50 from pot
RwDoM55ZeQuI2ADyJhOb2Q: doesn't show hand
*** SUMMARY ***
Total pot $12 | Rake $0.50
Board [3c Jh 4h]
Seat 1: 6hvg964TSqZ3AL/0XK9aVQ (big blind) folded on the Flop
Seat 2: RwDoM55ZeQuI2ADyJhOb2Q (button) (small blind) collected ($11.50)



PokerStars Game #59941834580:  Hold'em No Limit ($1/$2) - 2009/07/01 1:47:38 ET
Table 'ZzSIe0zTCDv+n6hfbY5tTg' 6-max Seat #5 is the button
Seat 1: VvdR9F3I+2yELkfTVvC1dg ($261.10 in chips)
Seat 2: B87ikIyZ/TzAVeXf38Ny0g ($228 in chips)
Seat 3: gsugPj31Hui3Jefl98MBOA ($352 in chips)
Seat 4: 54yWzRRgS0oZ+S6LwZBxMQ ($46.10 in chips)
Seat 5: 3dAbvkxS5NPQTBAbvpinVg ($500.45 in chips)
Seat 6: 09BNF4quPDzanQzM8vc6WA ($34 in chips)
09BNF4quPDzanQzM8vc6WA: posts small blind $1
VvdR9F3I+2yELkfTVvC1dg: posts big blind $2
*** HOLE CARDS ***
B87ikIyZ/TzAVeXf38Ny0g: folds
gsugPj31Hui3Jefl98MBOA: folds
54yWzRRgS0oZ+S6LwZBxMQ: folds
3dAbvkxS5NPQTBAbvpinVg: folds
09BNF4quPDzanQzM8vc6WA: raises $2 to $4
VvdR9F3I+2yELkfTVvC1dg: folds
09BNF4quPDzanQzM8vc6WA collected $4 from pot
09BNF4quPDzanQzM8vc6WA: doesn't show hand
*** SUMMARY ***
Total pot $4 | Rake $0
Seat 1: VvdR9F3I+2yELkfTVvC1dg (big blind) folded before Flop
Seat 2: B87ikIyZ/TzAVeXf38Ny0g folded before Flop (didn't bet)
Seat 3: gsugPj31Hui3Jefl98MBOA folded before Flop (didn't bet)
Seat 4: 54yWzRRgS0oZ+S6LwZBxMQ folded before Flop (didn't bet)
Seat 5: 3dAbvkxS5NPQTBAbvpinVg (button) folded before Flop (didn't bet)
Seat 6: 09BNF4quPDzanQzM8vc6WA (small blind) collected ($4)



PokerStars Game #59941834324:  Hold'em No Limit ($1/$2) - 2009/07/01 1:47:38 ET
Table 'rsKRKlGHlxVyqJxzO2a2Ow' 9-max Seat #2 is the button
Seat 1: KqHysDSpCPaPyK3tJC1aEw ($209.30 in chips)
Seat 2: +T/63sAeZzWyHchahJ36GQ ($83 in chips)
Seat 3: kM9CA+2UcdMjbCMbtUCGiA ($226.10 in chips)
Seat 4: 31HuO+DQxppUQEedBWukug ($111.85 in chips)
Seat 5: 5Q8U6iZbeO7xJSS4qvDP5g ($248.30 in chips)
Seat 6: H6Z4+qu8gR0VUiPOijndVg ($200 in chips)
Seat 7: GX1heJ+DSsvm7gzSPsYhhQ ($56 in chips)
Seat 8: CkE3IyJF1KvdaAOmZY5XqQ ($203.70 in chips)
Seat 9: gRbvhSUVg+TNaTjaJecIRw ($50.60 in chips)
kM9CA+2UcdMjbCMbtUCGiA: posts small blind $1
31HuO+DQxppUQEedBWukug: posts big blind $2
*** HOLE CARDS ***
5Q8U6iZbeO7xJSS4qvDP5g: folds
H6Z4+qu8gR0VUiPOijndVg: folds
GX1heJ+DSsvm7gzSPsYhhQ: folds
CkE3IyJF1KvdaAOmZY5XqQ: folds
gRbvhSUVg+TNaTjaJecIRw: folds
KqHysDSpCPaPyK3tJC1aEw: raises $4 to $6
+T/63sAeZzWyHchahJ36GQ: folds
kM9CA+2UcdMjbCMbtUCGiA: folds
31HuO+DQxppUQEedBWukug: folds
KqHysDSpCPaPyK3tJC1aEw collected $5 from pot
*** SUMMARY ***
Total pot $5 | Rake $0
Seat 1: KqHysDSpCPaPyK3tJC1aEw collected ($5)
Seat 2: +T/63sAeZzWyHchahJ36GQ (button) folded before Flop (didn't bet)
Seat 3: kM9CA+2UcdMjbCMbtUCGiA (small blind) folded before Flop
Seat 4: 31HuO+DQxppUQEedBWukug (big blind) folded before Flop
Seat 5: 5Q8U6iZbeO7xJSS4qvDP5g folded before Flop (didn't bet)
Seat 6: H6Z4+qu8gR0VUiPOijndVg folded before Flop (didn't bet)
Seat 7: GX1heJ+DSsvm7gzSPsYhhQ folded before Flop (didn't bet)
Seat 8: CkE3IyJF1KvdaAOmZY5XqQ folded before Flop (didn't bet)
Seat 9: gRbvhSUVg+TNaTjaJecIRw folded before Flop (didn't bet)



PokerStars Game #59941835796:  Hold'em No Limit ($1/$2) - 2009/07/01 1:47:40 ET
Table 'jlrIxbrVIG+gjaUYT4za8g' 6-max Seat #4 is the button
Seat 2: cwfuMyvDC7J7SqX2leDC8g ($46 in chips)
Seat 4: 8srN1dKQePlsv0GyTada+Q ($260.70 in chips)
Seat 5: AyBB0k3Dcl7xbXUeGMw06g ($49.30 in chips)
Seat 6: BWhgxe7gWiYobRbwdG+d2Q ($196 in chips)
AyBB0k3Dcl7xbXUeGMw06g: posts small blind $1
BWhgxe7gWiYobRbwdG+d2Q: posts big blind $2
*** HOLE CARDS ***
cwfuMyvDC7J7SqX2leDC8g: folds
8srN1dKQePlsv0GyTada+Q: folds
AyBB0k3Dcl7xbXUeGMw06g: calls $1
BWhgxe7gWiYobRbwdG+d2Q: checks
*** FLOP *** [6h Qs 3h]
AyBB0k3Dcl7xbXUeGMw06g: checks
BWhgxe7gWiYobRbwdG+d2Q: bets $4
AyBB0k3Dcl7xbXUeGMw06g: calls $4
*** TURN *** [6h Qs 3h] [8c]
AyBB0k3Dcl7xbXUeGMw06g: checks
BWhgxe7gWiYobRbwdG+d2Q: checks
*** RIVER *** [6h Qs 3h 8c] [2h]
AyBB0k3Dcl7xbXUeGMw06g: checks
BWhgxe7gWiYobRbwdG+d2Q: checks
*** SHOW DOWN ***
AyBB0k3Dcl7xbXUeGMw06g: shows [3s Ts] (a pair of Threes)
BWhgxe7gWiYobRbwdG+d2Q: mucks hand
AyBB0k3Dcl7xbXUeGMw06g collected $11.45 from pot
*** SUMMARY ***
Total pot $12 | Rake $0.55
Board [6h Qs 3h 8c 2h]
Seat 2: cwfuMyvDC7J7SqX2leDC8g folded before Flop (didn't bet)
Seat 4: 8srN1dKQePlsv0GyTada+Q (button) folded before Flop (didn't bet)
Seat 5: AyBB0k3Dcl7xbXUeGMw06g (small blind) showed [3s Ts] and won ($11.45) with a pair of Threes
Seat 6: BWhgxe7gWiYobRbwdG+d2Q (big blind) mucked



PokerStars Game #59941835440:  Hold'em No Limit ($1/$2) - 2009/07/01 1:47:40 ET
Table 'C4lkCXY2PWy6z4vsAe5NGQ' 6-max Seat #4 is the button
Seat 2: 6hRJ68JkbJq6MYI9o5bUnQ ($78.95 in chips)
Seat 3: sTPOWERd9HWPCNrDBwsVjA ($133.80 in chips)
Seat 4: VvdR9F3I+2yELkfTVvC1dg ($207 in chips)
Seat 5: /PH6Ffnho4Ysm8S3V/oa+w ($48 in chips)
Seat 6: B87ikIyZ/TzAVeXf38Ny0g ($712.20 in chips)
/PH6Ffnho4Ysm8S3V/oa+w: posts small blind $1
B87ikIyZ/TzAVeXf38Ny0g: posts big blind $2
*** HOLE CARDS ***
6hRJ68JkbJq6MYI9o5bUnQ: folds
sTPOWERd9HWPCNrDBwsVjA: folds
VvdR9F3I+2yELkfTVvC1dg: folds
/PH6Ffnho4Ysm8S3V/oa+w: raises $2 to $4
B87ikIyZ/TzAVeXf38Ny0g: calls $2
*** FLOP *** [7d 5s 9h]
/PH6Ffnho4Ysm8S3V/oa+w: checks
B87ikIyZ/TzAVeXf38Ny0g: checks
*** TURN *** [7d 5s 9h] [2d]
/PH6Ffnho4Ysm8S3V/oa+w: checks
B87ikIyZ/TzAVeXf38Ny0g: checks
*** RIVER *** [7d 5s 9h 2d] [5h]
/PH6Ffnho4Ysm8S3V/oa+w: checks
B87ikIyZ/TzAVeXf38Ny0g: checks
*** SHOW DOWN ***
/PH6Ffnho4Ysm8S3V/oa+w: shows [3d Qh] (a pair of Fives)
B87ikIyZ/TzAVeXf38Ny0g: mucks hand
/PH6Ffnho4Ysm8S3V/oa+w collected $7.60 from pot
*** SUMMARY ***
Total pot $8 | Rake $0.40
Board [7d 5s 9h 2d 5h]
Seat 2: 6hRJ68JkbJq6MYI9o5bUnQ folded before Flop (didn't bet)
Seat 3: sTPOWERd9HWPCNrDBwsVjA folded before Flop (didn't bet)
Seat 4: VvdR9F3I+2yELkfTVvC1dg (button) folded before Flop (didn't bet)
Seat 5: /PH6Ffnho4Ysm8S3V/oa+w (small blind) showed [3d Qh] and won ($7.60) with a pair of Fives
Seat 6: B87ikIyZ/TzAVeXf38Ny0g (big blind) mucked



PokerStars Game #59941836556:  Hold'em No Limit ($1/$2) - 2009/07/01 1:47:42 ET
Table 'TsEDkiO4tzCTCzJ7tNdEqw' 6-max Seat #3 is the button
Seat 1: vkfxu8f/jMYKUk6Ly4eujw ($269 in chips)
Seat 2: 4dcDwIHRm96PwtqkpQiuiA ($79.65 in chips)
Seat 3: ubtx4Z5L+AcK71MTvYiGVw ($200 in chips)
Seat 4: K8MXCrNAVYlMnnCeM32Kxw ($121 in chips)
Seat 5: VvdR9F3I+2yELkfTVvC1dg ($249.35 in chips)
Seat 6: uCqEjnxh2/vFBjKYkfTOkw ($292.80 in chips)
K8MXCrNAVYlMnnCeM32Kxw: posts small blind $1
VvdR9F3I+2yELkfTVvC1dg: posts big blind $2
*** HOLE CARDS ***
uCqEjnxh2/vFBjKYkfTOkw: folds
vkfxu8f/jMYKUk6Ly4eujw: folds
4dcDwIHRm96PwtqkpQiuiA: folds
ubtx4Z5L+AcK71MTvYiGVw: folds
K8MXCrNAVYlMnnCeM32Kxw: raises $2 to $4
VvdR9F3I+2yELkfTVvC1dg: folds
K8MXCrNAVYlMnnCeM32Kxw collected $4 from pot
*** SUMMARY ***
Total pot $4 | Rake $0
Seat 1: vkfxu8f/jMYKUk6Ly4eujw folded before Flop (didn't bet)
Seat 2: 4dcDwIHRm96PwtqkpQiuiA folded before Flop (didn't bet)
Seat 3: ubtx4Z5L+AcK71MTvYiGVw (button) folded before Flop (didn't bet)
Seat 4: K8MXCrNAVYlMnnCeM32Kxw (small blind) collected ($4)
Seat 5: VvdR9F3I+2yELkfTVvC1dg (big blind) folded before Flop
Seat 6: uCqEjnxh2/vFBjKYkfTOkw folded before Flop (didn't bet)



PokerStars Game #59941838172:  Hold'em No Limit ($1/$2) - 2009/07/01 1:47:45 ET
Table 'UGLAZZyv+cXmnKjYin0etA' 6-max Seat #6 is the button
Seat 2: eDLH1PUXFpvJBNMXBVQcGA ($305.10 in chips)
Seat 4: SiGJDsvRViJX05vHhA80GQ ($234.85 in chips)
Seat 5: 54yWzRRgS0oZ+S6LwZBxMQ ($38.05 in chips)
Seat 6: sTPOWERd9HWPCNrDBwsVjA ($218.95 in chips)
eDLH1PUXFpvJBNMXBVQcGA: posts small blind $1
ygTTt5ehT4aF86q1a8/R+w: is sitting out
SiGJDsvRViJX05vHhA80GQ: posts big blind $2
*** HOLE CARDS ***
ygTTt5ehT4aF86q1a8/R+w leaves the table
54yWzRRgS0oZ+S6LwZBxMQ: calls $2
sTPOWERd9HWPCNrDBwsVjA: folds
eDLH1PUXFpvJBNMXBVQcGA: folds
SiGJDsvRViJX05vHhA80GQ: checks
*** FLOP *** [5d 5c Kh]
SiGJDsvRViJX05vHhA80GQ: checks
54yWzRRgS0oZ+S6LwZBxMQ: bets $4
SiGJDsvRViJX05vHhA80GQ: folds
54yWzRRgS0oZ+S6LwZBxMQ collected $4.75 from pot
*** SUMMARY ***
Total pot $5 | Rake $0.25
Board [5d 5c Kh]
Seat 2: eDLH1PUXFpvJBNMXBVQcGA (small blind) folded before Flop
Seat 4: SiGJDsvRViJX05vHhA80GQ (big blind) folded on the Flop
Seat 5: 54yWzRRgS0oZ+S6LwZBxMQ collected ($4.75)
Seat 6: sTPOWERd9HWPCNrDBwsVjA (button) folded before Flop (didn't bet)



PokerStars Game #59941837922:  Hold'em No Limit ($1/$2) - 2009/07/01 1:47:45 ET
Table 'kq5zaQ+1hLNf8LZfGnbTAA' 6-max Seat #6 is the button
Seat 1: 8srN1dKQePlsv0GyTada+Q ($417.60 in chips)
Seat 2: nXDI8Y/S6POzRwANu3d8hQ ($137 in chips)
Seat 3: /PH6Ffnho4Ysm8S3V/oa+w ($58.15 in chips)
Seat 4: 3dAbvkxS5NPQTBAbvpinVg ($275.65 in chips)
Seat 6: mfy7uGZcqA2PVQqEVbJ7+g ($194.15 in chips)
8srN1dKQePlsv0GyTada+Q: posts small blind $1
nXDI8Y/S6POzRwANu3d8hQ: posts big blind $2
*** HOLE CARDS ***
/PH6Ffnho4Ysm8S3V/oa+w: folds
3dAbvkxS5NPQTBAbvpinVg: folds
mfy7uGZcqA2PVQqEVbJ7+g: folds
8srN1dKQePlsv0GyTada+Q: raises $4 to $6
nXDI8Y/S6POzRwANu3d8hQ: folds
8srN1dKQePlsv0GyTada+Q collected $4 from pot
8srN1dKQePlsv0GyTada+Q: doesn't show hand
*** SUMMARY ***
Total pot $4 | Rake $0
Seat 1: 8srN1dKQePlsv0GyTada+Q (small blind) collected ($4)
Seat 2: nXDI8Y/S6POzRwANu3d8hQ (big blind) folded before Flop
Seat 3: /PH6Ffnho4Ysm8S3V/oa+w folded before Flop (didn't bet)
Seat 4: 3dAbvkxS5NPQTBAbvpinVg folded before Flop (didn't bet)
Seat 6: mfy7uGZcqA2PVQqEVbJ7+g (button) folded before Flop (didn't bet)



PokerStars Game #59941839352:  Hold'em No Limit ($1/$2) - 2009/07/01 1:47:47 ET
Table 'bJQ024BaYSBrW0sXpCZbNQ' 6-max Seat #1 is the button
Seat 1: KfwW5us6tydK81NYTtK1gw ($204.40 in chips)
Seat 2: 3dAbvkxS5NPQTBAbvpinVg ($268 in chips)
Seat 4: vkfxu8f/jMYKUk6Ly4eujw ($230.05 in chips)
Seat 5: VvdR9F3I+2yELkfTVvC1dg ($200 in chips)
Seat 6: 4bqvCfJ0e8CTYnn0Go9hbQ ($139.95 in chips)
3dAbvkxS5NPQTBAbvpinVg: posts small blind $1
/PH6Ffnho4Ysm8S3V/oa+w: is sitting out
vkfxu8f/jMYKUk6Ly4eujw: posts big blind $2
*** HOLE CARDS ***
VvdR9F3I+2yELkfTVvC1dg: folds
4bqvCfJ0e8CTYnn0Go9hbQ: calls $2
KfwW5us6tydK81NYTtK1gw: folds
/PH6Ffnho4Ysm8S3V/oa+w leaves the table
3dAbvkxS5NPQTBAbvpinVg: folds
vkfxu8f/jMYKUk6Ly4eujw: checks
*** FLOP *** [Ac Td 6c]
vkfxu8f/jMYKUk6Ly4eujw: checks
4bqvCfJ0e8CTYnn0Go9hbQ: bets $4
vkfxu8f/jMYKUk6Ly4eujw: folds
4bqvCfJ0e8CTYnn0Go9hbQ collected $4.75 from pot
4bqvCfJ0e8CTYnn0Go9hbQ: doesn't show hand
*** SUMMARY ***
Total pot $5 | Rake $0.25
Board [Ac Td 6c]
Seat 1: KfwW5us6tydK81NYTtK1gw (button) folded before Flop (didn't bet)
Seat 2: 3dAbvkxS5NPQTBAbvpinVg (small blind) folded before Flop
Seat 4: vkfxu8f/jMYKUk6Ly4eujw (big blind) folded on the Flop
Seat 5: VvdR9F3I+2yELkfTVvC1dg folded before Flop (didn't bet)
Seat 6: 4bqvCfJ0e8CTYnn0Go9hbQ collected ($4.75)



PokerStars Game #59941840820:  Hold'em No Limit ($1/$2) - 2009/07/01 1:47:50 ET
Table 'gnHBqWll9O3fxG7Ojkz/ng' 9-max Seat #7 is the button
Seat 1: TAfo4veNRaRlzDXMMYS3Jg ($72 in chips)
Seat 2: H6Z4+qu8gR0VUiPOijndVg ($330.30 in chips)
Seat 3: 5Q8U6iZbeO7xJSS4qvDP5g ($238.10 in chips)
Seat 4: nXDI8Y/S6POzRwANu3d8hQ ($16 in chips)
Seat 5: rBQDMkKm9cZn6M9NPsiVew ($169.15 in chips)
Seat 6: KqHysDSpCPaPyK3tJC1aEw ($200 in chips)
Seat 7: 254YPxPJr5Sw58bkD0YqYQ ($200 in chips)
Seat 8: cM6efHzdxoqYm0EQKP4TTQ ($112.95 in chips)
Seat 9: GX1heJ+DSsvm7gzSPsYhhQ ($45.35 in chips)
cM6efHzdxoqYm0EQKP4TTQ: posts small blind $1
GX1heJ+DSsvm7gzSPsYhhQ: posts big blind $2
*** HOLE CARDS ***
TAfo4veNRaRlzDXMMYS3Jg: folds
H6Z4+qu8gR0VUiPOijndVg: folds
5Q8U6iZbeO7xJSS4qvDP5g: folds
nXDI8Y/S6POzRwANu3d8hQ: folds
rBQDMkKm9cZn6M9NPsiVew: folds
KqHysDSpCPaPyK3tJC1aEw: folds
254YPxPJr5Sw58bkD0YqYQ: folds
cM6efHzdxoqYm0EQKP4TTQ: calls $1
GX1heJ+DSsvm7gzSPsYhhQ: checks
*** FLOP *** [3c Js Jh]
cM6efHzdxoqYm0EQKP4TTQ: checks
GX1heJ+DSsvm7gzSPsYhhQ: checks
*** TURN *** [3c Js Jh] [5h]
cM6efHzdxoqYm0EQKP4TTQ: checks
GX1heJ+DSsvm7gzSPsYhhQ: checks
*** RIVER *** [3c Js Jh 5h] [7d]
cM6efHzdxoqYm0EQKP4TTQ: checks
GX1heJ+DSsvm7gzSPsYhhQ: bets $2
cM6efHzdxoqYm0EQKP4TTQ: folds
GX1heJ+DSsvm7gzSPsYhhQ collected $3.80 from pot
GX1heJ+DSsvm7gzSPsYhhQ: doesn't show hand
*** SUMMARY ***
Total pot $4 | Rake $0.20
Board [3c Js Jh 5h 7d]
Seat 1: TAfo4veNRaRlzDXMMYS3Jg folded before Flop (didn't bet)
Seat 2: H6Z4+qu8gR0VUiPOijndVg folded before Flop (didn't bet)
Seat 3: 5Q8U6iZbeO7xJSS4qvDP5g folded before Flop (didn't bet)
Seat 4: nXDI8Y/S6POzRwANu3d8hQ folded before Flop (didn't bet)
Seat 5: rBQDMkKm9cZn6M9NPsiVew folded before Flop (didn't bet)
Seat 6: KqHysDSpCPaPyK3tJC1aEw folded before Flop (didn't bet)
Seat 7: 254YPxPJr5Sw58bkD0YqYQ (button) folded before Flop (didn't bet)
Seat 8: cM6efHzdxoqYm0EQKP4TTQ (small blind) folded on the River
Seat 9: GX1heJ+DSsvm7gzSPsYhhQ (big blind) collected ($3.80)



PokerStars Game #59941841004:  Hold'em No Limit ($1/$2) - 2009/07/01 1:47:51 ET
Table '5/wEe6JmtGD7vufSA2RG7A' 2-max Seat #2 is the button
Seat 1: pVqEzK9wXlRMECnb1Zg4Zw ($99.10 in chips)
Seat 2: aOL8geThaYp2iadSHl1h1g ($140 in chips)
aOL8geThaYp2iadSHl1h1g: posts small blind $1
pVqEzK9wXlRMECnb1Zg4Zw: posts big blind $2
*** HOLE CARDS ***
aOL8geThaYp2iadSHl1h1g: raises $4 to $6
pVqEzK9wXlRMECnb1Zg4Zw: calls $4
*** FLOP *** [9h Jc 8h]
pVqEzK9wXlRMECnb1Zg4Zw: checks
aOL8geThaYp2iadSHl1h1g: checks
*** TURN *** [9h Jc 8h] [7c]
pVqEzK9wXlRMECnb1Zg4Zw: folds
aOL8geThaYp2iadSHl1h1g collected $11.50 from pot
*** SUMMARY ***
Total pot $12 | Rake $0.50
Board [9h Jc 8h 7c]
Seat 1: pVqEzK9wXlRMECnb1Zg4Zw (big blind) folded on the Turn
Seat 2: aOL8geThaYp2iadSHl1h1g (button) (small blind) collected ($11.50)



PokerStars Game #59941841960:  Hold'em No Limit ($1/$2) - 2009/07/01 1:47:52 ET
Table 'QxerF7GUfCbl+4a8XaTB2w' 6-max Seat #4 is the button
Seat 1: ZwvXzkkZ3XpMhKfAmVpahw ($276.75 in chips)
Seat 2: 6UGgYbxwWNc+ohObe8vB9w ($39.75 in chips)
Seat 3: 8rZGabKe2DEPdZCbCivZ9Q ($27 in chips)
Seat 4: /PH6Ffnho4Ysm8S3V/oa+w ($50 in chips)
Seat 6: VvdR9F3I+2yELkfTVvC1dg ($214.70 in chips)
VvdR9F3I+2yELkfTVvC1dg: posts small blind $1
ZwvXzkkZ3XpMhKfAmVpahw: posts big blind $2
*** HOLE CARDS ***
vkfxu8f/jMYKUk6Ly4eujw joins the table at seat #5
6UGgYbxwWNc+ohObe8vB9w: folds
8rZGabKe2DEPdZCbCivZ9Q: folds
/PH6Ffnho4Ysm8S3V/oa+w: raises $2 to $4
VvdR9F3I+2yELkfTVvC1dg: folds
ZwvXzkkZ3XpMhKfAmVpahw: folds
/PH6Ffnho4Ysm8S3V/oa+w collected $5 from pot
/PH6Ffnho4Ysm8S3V/oa+w: doesn't show hand
*** SUMMARY ***
Total pot $5 | Rake $0
Seat 1: ZwvXzkkZ3XpMhKfAmVpahw (big blind) folded before Flop
Seat 2: 6UGgYbxwWNc+ohObe8vB9w folded before Flop (didn't bet)
Seat 3: 8rZGabKe2DEPdZCbCivZ9Q folded before Flop (didn't bet)
Seat 4: /PH6Ffnho4Ysm8S3V/oa+w (button) collected ($5)
Seat 6: VvdR9F3I+2yELkfTVvC1dg (small blind) folded before Flop



PokerStars Game #59941842486:  Hold'em No Limit ($1/$2) - 2009/07/01 1:47:53 ET
Table 'eyAQSIlgc2o1Jxvbve4WGg' 9-max Seat #1 is the button
Seat 1: UZEsV9yKUMqmpYPiOFpaZw ($23.20 in chips)
Seat 2: kM9CA+2UcdMjbCMbtUCGiA ($218.60 in chips)
Seat 4: CkE3IyJF1KvdaAOmZY5XqQ ($200 in chips)
Seat 5: mIKx5lhIt13X5eZQH0ZeMA ($124.45 in chips)
Seat 6: nXDI8Y/S6POzRwANu3d8hQ ($67 in chips)
Seat 7: u3OrI5uGx9mx1fE7dgr+EA ($109.75 in chips)
Seat 9: WUlHm+ydPPHG7Lb0rePSdA ($140.20 in chips)
kM9CA+2UcdMjbCMbtUCGiA: posts small blind $1
CkE3IyJF1KvdaAOmZY5XqQ: posts big blind $2
254YPxPJr5Sw58bkD0YqYQ: sits out
*** HOLE CARDS ***
mIKx5lhIt13X5eZQH0ZeMA: calls $2
nXDI8Y/S6POzRwANu3d8hQ: folds
u3OrI5uGx9mx1fE7dgr+EA: folds
WUlHm+ydPPHG7Lb0rePSdA: folds
UZEsV9yKUMqmpYPiOFpaZw: folds
kM9CA+2UcdMjbCMbtUCGiA: raises $8 to $10
CkE3IyJF1KvdaAOmZY5XqQ: folds
mIKx5lhIt13X5eZQH0ZeMA: calls $8
*** FLOP *** [Ah Qd Kd]
kM9CA+2UcdMjbCMbtUCGiA: checks
mIKx5lhIt13X5eZQH0ZeMA: bets $4
kM9CA+2UcdMjbCMbtUCGiA: folds
mIKx5lhIt13X5eZQH0ZeMA collected $20.90 from pot
*** SUMMARY ***
Total pot $22 | Rake $1.10
Board [Ah Qd Kd]
Seat 1: UZEsV9yKUMqmpYPiOFpaZw (button) folded before Flop (didn't bet)
Seat 2: kM9CA+2UcdMjbCMbtUCGiA (small blind) folded on the Flop
Seat 4: CkE3IyJF1KvdaAOmZY5XqQ (big blind) folded before Flop
Seat 5: mIKx5lhIt13X5eZQH0ZeMA collected ($20.90)
Seat 6: nXDI8Y/S6POzRwANu3d8hQ folded before Flop (didn't bet)
Seat 7: u3OrI5uGx9mx1fE7dgr+EA folded before Flop (didn't bet)
Seat 9: WUlHm+ydPPHG7Lb0rePSdA folded before Flop (didn't bet)



PokerStars Game #59941843086:  Hold'em No Limit ($1/$2) - 2009/07/01 1:47:54 ET
Table 'aSf77Sj8QEnzcc0WaxVD4Q' 6-max Seat #2 is the button
Seat 1: UELtvp+JfwI7XDGVwSxZXA ($230.85 in chips)
Seat 2: vkfxu8f/jMYKUk6Ly4eujw ($191.10 in chips)
Seat 3: 9dpyyjDTCed6nV7JhaUUpw ($761.50 in chips)
Seat 4: YsLQ3BAvgQHWXMAv3Wv6Hg ($200 in chips)
Seat 5: VvdR9F3I+2yELkfTVvC1dg ($254.90 in chips)
Seat 6: vkoJRf3gidxY1pPi0AFWww ($151.85 in chips)
9dpyyjDTCed6nV7JhaUUpw: posts small blind $1
YsLQ3BAvgQHWXMAv3Wv6Hg: posts big blind $2
*** HOLE CARDS ***
VvdR9F3I+2yELkfTVvC1dg: raises $2 to $4
vkoJRf3gidxY1pPi0AFWww: folds
UELtvp+JfwI7XDGVwSxZXA: calls $4
vkfxu8f/jMYKUk6Ly4eujw: folds
9dpyyjDTCed6nV7JhaUUpw: folds
YsLQ3BAvgQHWXMAv3Wv6Hg: folds
*** FLOP *** [7d 9s 3s]
VvdR9F3I+2yELkfTVvC1dg: bets $7.80
UELtvp+JfwI7XDGVwSxZXA: calls $7.80
*** TURN *** [7d 9s 3s] [5h]
VvdR9F3I+2yELkfTVvC1dg: checks
YsLQ3BAvgQHWXMAv3Wv6Hg is sitting out
UELtvp+JfwI7XDGVwSxZXA: bets $14
VvdR9F3I+2yELkfTVvC1dg: calls $14
*** RIVER *** [7d 9s 3s 5h] [7h]
VvdR9F3I+2yELkfTVvC1dg: checks
UELtvp+JfwI7XDGVwSxZXA: bets $22
VvdR9F3I+2yELkfTVvC1dg: calls $22
*** SHOW DOWN ***
UELtvp+JfwI7XDGVwSxZXA: shows [Jh Kd] (a pair of Sevens)
VvdR9F3I+2yELkfTVvC1dg: shows [9h 8h] (two pair, Nines and Sevens)
VvdR9F3I+2yELkfTVvC1dg collected $95.60 from pot
*** SUMMARY ***
Total pot $98.60 | Rake $3
Board [7d 9s 3s 5h 7h]
Seat 1: UELtvp+JfwI7XDGVwSxZXA showed [Jh Kd] and lost with a pair of Sevens
Seat 2: vkfxu8f/jMYKUk6Ly4eujw (button) folded before Flop (didn't bet)
Seat 3: 9dpyyjDTCed6nV7JhaUUpw (small blind) folded before Flop
Seat 4: YsLQ3BAvgQHWXMAv3Wv6Hg (big blind) folded before Flop
Seat 5: VvdR9F3I+2yELkfTVvC1dg showed [9h 8h] and won ($95.60) with two pair, Nines and Sevens
Seat 6: vkoJRf3gidxY1pPi0AFWww folded before Flop (didn't bet)



PokerStars Game #59941843116:  Hold'em No Limit ($1/$2) - 2009/07/01 1:47:55 ET
Table 'NmY84NAf9Mh0ckAckHnh5g' 2-max Seat #1 is the button
Seat 1: 6hvg964TSqZ3AL/0XK9aVQ ($614.75 in chips)
Seat 2: RwDoM55ZeQuI2ADyJhOb2Q ($371.05 in chips)
6hvg964TSqZ3AL/0XK9aVQ: posts small blind $1
RwDoM55ZeQuI2ADyJhOb2Q: posts big blind $2
*** HOLE CARDS ***
6hvg964TSqZ3AL/0XK9aVQ: calls $1
RwDoM55ZeQuI2ADyJhOb2Q: checks
*** FLOP *** [9c 3c 6s]
RwDoM55ZeQuI2ADyJhOb2Q: checks
6hvg964TSqZ3AL/0XK9aVQ: checks
*** TURN *** [9c 3c 6s] [4s]
RwDoM55ZeQuI2ADyJhOb2Q: checks
6hvg964TSqZ3AL/0XK9aVQ: bets $4
RwDoM55ZeQuI2ADyJhOb2Q: calls $4
*** RIVER *** [9c 3c 6s 4s] [6c]
RwDoM55ZeQuI2ADyJhOb2Q: checks
6hvg964TSqZ3AL/0XK9aVQ: checks
*** SHOW DOWN ***
RwDoM55ZeQuI2ADyJhOb2Q: shows [4h 7c] (two pair, Sixes and Fours)
6hvg964TSqZ3AL/0XK9aVQ: shows [Qh 4d] (two pair, Sixes and Fours - Queen kicker)
6hvg964TSqZ3AL/0XK9aVQ collected $11.50 from pot
*** SUMMARY ***
Total pot $12 | Rake $0.50
Board [9c 3c 6s 4s 6c]
Seat 1: 6hvg964TSqZ3AL/0XK9aVQ (button) (small blind) showed [Qh 4d] and won ($11.50) with two pair, Sixes and Fours
Seat 2: RwDoM55ZeQuI2ADyJhOb2Q (big blind) showed [4h 7c] and lost with two pair, Sixes and Fours



PokerStars Game #59941843798:  Hold'em No Limit ($1/$2) - 2009/07/01 1:47:56 ET
Table 'mGpP9StWRnoeiBDExc6Frg' 6-max Seat #1 is the button
Seat 1: VvdR9F3I+2yELkfTVvC1dg ($309.15 in chips)
Seat 2: 6hRJ68JkbJq6MYI9o5bUnQ ($101 in chips)
Seat 4: 4dcDwIHRm96PwtqkpQiuiA ($91.70 in chips)
Seat 5: d1puGuVBE0fidn+5eRJ0tw ($191.55 in chips)
Seat 6: B2Ih1sr5VZk+8He7rcrMtQ ($403.45 in chips)
6hRJ68JkbJq6MYI9o5bUnQ: posts small blind $1
4dcDwIHRm96PwtqkpQiuiA: posts big blind $2
*** HOLE CARDS ***
d1puGuVBE0fidn+5eRJ0tw: folds
B2Ih1sr5VZk+8He7rcrMtQ: folds
VvdR9F3I+2yELkfTVvC1dg: folds
6hRJ68JkbJq6MYI9o5bUnQ: folds
4dcDwIHRm96PwtqkpQiuiA collected $2 from pot
*** SUMMARY ***
Total pot $2 | Rake $0
Seat 1: VvdR9F3I+2yELkfTVvC1dg (button) folded before Flop (didn't bet)
Seat 2: 6hRJ68JkbJq6MYI9o5bUnQ (small blind) folded before Flop
Seat 4: 4dcDwIHRm96PwtqkpQiuiA (big blind) collected ($2)
Seat 5: d1puGuVBE0fidn+5eRJ0tw folded before Flop (didn't bet)
Seat 6: B2Ih1sr5VZk+8He7rcrMtQ folded before Flop (didn't bet)



PokerStars Game #59941845250:  Hold'em No Limit ($1/$2) - 2009/07/01 1:47:58 ET
Table 'G1Oqdy4Pqdb5gtx40rUBzA' 6-max Seat #3 is the button
Seat 1: 4dMBh/1VTdeUTPCyhCs3UQ ($63.70 in chips)
Seat 2: m7mYVfnCOK5TE/VkN/FhOg ($209.05 in chips)
Seat 3: VvdR9F3I+2yELkfTVvC1dg ($423.90 in chips)
Seat 4: B87ikIyZ/TzAVeXf38Ny0g ($215.70 in chips)
Seat 5: F1+Ml47qRQWunzPnGhLLzQ ($200 in chips)
Seat 6: qCnEYuAE5y5A7bk6fO5/jQ ($200 in chips)
B87ikIyZ/TzAVeXf38Ny0g: posts small blind $1
F1+Ml47qRQWunzPnGhLLzQ: posts big blind $2
*** HOLE CARDS ***
qCnEYuAE5y5A7bk6fO5/jQ: folds
4dMBh/1VTdeUTPCyhCs3UQ: folds
m7mYVfnCOK5TE/VkN/FhOg: raises $4 to $6
VvdR9F3I+2yELkfTVvC1dg: folds
B87ikIyZ/TzAVeXf38Ny0g: folds
F1+Ml47qRQWunzPnGhLLzQ: folds
m7mYVfnCOK5TE/VkN/FhOg collected $5 from pot
m7mYVfnCOK5TE/VkN/FhOg: doesn't show hand
*** SUMMARY ***
Total pot $5 | Rake $0
Seat 1: 4dMBh/1VTdeUTPCyhCs3UQ folded before Flop (didn't bet)
Seat 2: m7mYVfnCOK5TE/VkN/FhOg collected ($5)
Seat 3: VvdR9F3I+2yELkfTVvC1dg (button) folded before Flop (didn't bet)
Seat 4: B87ikIyZ/TzAVeXf38Ny0g (small blind) folded before Flop
Seat 5: F1+Ml47qRQWunzPnGhLLzQ (big blind) folded before Flop
Seat 6: qCnEYuAE5y5A7bk6fO5/jQ folded before Flop (didn't bet)



PokerStars Game #59941845604:  Hold'em No Limit ($1/$2) - 2009/07/01 1:47:59 ET
Table 'P/yCfYl1GfGsu/e6DxDy/A' 2-max Seat #1 is the button
Seat 1: 7fOCUy3x9hdkmXkkDNolGQ ($555 in chips)
Seat 2: RwDoM55ZeQuI2ADyJhOb2Q ($917 in chips)
7fOCUy3x9hdkmXkkDNolGQ: posts small blind $1
RwDoM55ZeQuI2ADyJhOb2Q: posts big blind $2
*** HOLE CARDS ***
7fOCUy3x9hdkmXkkDNolGQ: raises $4 to $6
RwDoM55ZeQuI2ADyJhOb2Q: raises $30 to $36
7fOCUy3x9hdkmXkkDNolGQ: folds
RwDoM55ZeQuI2ADyJhOb2Q collected $12 from pot
RwDoM55ZeQuI2ADyJhOb2Q: doesn't show hand
*** SUMMARY ***
Total pot $12 | Rake $0
Seat 1: 7fOCUy3x9hdkmXkkDNolGQ (button) (small blind) folded before Flop
Seat 2: RwDoM55ZeQuI2ADyJhOb2Q (big blind) collected ($12)



PokerStars Game #59941846008:  Hold'em No Limit ($1/$2) - 2009/07/01 1:48:00 ET
Table 'CFkQcfWjKccZaZDf71FK+w' 6-max Seat #1 is the button
Seat 1: vkfxu8f/jMYKUk6Ly4eujw ($224.25 in chips)
Seat 2: ewN/vzF22+/gdzjIKBOlkA ($198 in chips)
Seat 5: 2lOU1DcvUZaMcxZ95XfzXw ($145.05 in chips)
Seat 6: ORVqY3rf9X6ANA/8s+On2Q ($42.10 in chips)
ewN/vzF22+/gdzjIKBOlkA: posts small blind $1
09BNF4quPDzanQzM8vc6WA: is sitting out
09BNF4quPDzanQzM8vc6WA leaves the table
ygTTt5ehT4aF86q1a8/R+w: is sitting out
2lOU1DcvUZaMcxZ95XfzXw: posts big blind $2
*** HOLE CARDS ***
ORVqY3rf9X6ANA/8s+On2Q: folds
ygTTt5ehT4aF86q1a8/R+w leaves the table
vkfxu8f/jMYKUk6Ly4eujw: folds
ewN/vzF22+/gdzjIKBOlkA: raises $4 to $6
2lOU1DcvUZaMcxZ95XfzXw: calls $4
*** FLOP *** [Jh 9s 8h]
ewN/vzF22+/gdzjIKBOlkA: bets $8
2lOU1DcvUZaMcxZ95XfzXw: folds
ewN/vzF22+/gdzjIKBOlkA collected $11.40 from pot
*** SUMMARY ***
Total pot $12 | Rake $0.60
Board [Jh 9s 8h]
Seat 1: vkfxu8f/jMYKUk6Ly4eujw (button) folded before Flop (didn't bet)
Seat 2: ewN/vzF22+/gdzjIKBOlkA (small blind) collected ($11.40)
Seat 5: 2lOU1DcvUZaMcxZ95XfzXw (big blind) folded on the Flop
Seat 6: ORVqY3rf9X6ANA/8s+On2Q folded before Flop (didn't bet)



PokerStars Game #59941846490:  Hold'em No Limit ($1/$2) - 2009/07/01 1:48:01 ET
Table '4NGNnZ/osQfNq6abYqkJeA' 6-max Seat #6 is the button
Seat 2: 669iGNwYwgRZg3nhS+aDAQ ($130.25 in chips)
Seat 3: 54yWzRRgS0oZ+S6LwZBxMQ ($43.65 in chips)
Seat 4: sY+4Uuh5z/6AbXXaCS10jw ($303.75 in chips)
Seat 5: VvdR9F3I+2yELkfTVvC1dg ($223.55 in chips)
Seat 6: /PH6Ffnho4Ysm8S3V/oa+w ($40 in chips)
669iGNwYwgRZg3nhS+aDAQ: posts small blind $1
54yWzRRgS0oZ+S6LwZBxMQ: posts big blind $2
*** HOLE CARDS ***
sY+4Uuh5z/6AbXXaCS10jw: raises $4 to $6
VvdR9F3I+2yELkfTVvC1dg: calls $6
/PH6Ffnho4Ysm8S3V/oa+w: folds
669iGNwYwgRZg3nhS+aDAQ: folds
54yWzRRgS0oZ+S6LwZBxMQ: folds
*** FLOP *** [6c 3h 4d]
sY+4Uuh5z/6AbXXaCS10jw: checks
VvdR9F3I+2yELkfTVvC1dg: bets $10.65
sY+4Uuh5z/6AbXXaCS10jw: folds
VvdR9F3I+2yELkfTVvC1dg collected $14.25 from pot
VvdR9F3I+2yELkfTVvC1dg: doesn't show hand
*** SUMMARY ***
Total pot $15 | Rake $0.75
Board [6c 3h 4d]
Seat 2: 669iGNwYwgRZg3nhS+aDAQ (small blind) folded before Flop
Seat 3: 54yWzRRgS0oZ+S6LwZBxMQ (big blind) folded before Flop
Seat 4: sY+4Uuh5z/6AbXXaCS10jw folded on the Flop
Seat 5: VvdR9F3I+2yELkfTVvC1dg collected ($14.25)
Seat 6: /PH6Ffnho4Ysm8S3V/oa+w (button) folded before Flop (didn't bet)



PokerStars Game #59941847840:  Hold'em No Limit ($1/$2) - 2009/07/01 1:48:04 ET
Table 'TsEDkiO4tzCTCzJ7tNdEqw' 6-max Seat #4 is the button
Seat 1: vkfxu8f/jMYKUk6Ly4eujw ($269 in chips)
Seat 2: 4dcDwIHRm96PwtqkpQiuiA ($79.65 in chips)
Seat 3: ubtx4Z5L+AcK71MTvYiGVw ($200 in chips)
Seat 4: K8MXCrNAVYlMnnCeM32Kxw ($123 in chips)
Seat 5: VvdR9F3I+2yELkfTVvC1dg ($247.35 in chips)
Seat 6: uCqEjnxh2/vFBjKYkfTOkw ($292.80 in chips)
VvdR9F3I+2yELkfTVvC1dg: posts small blind $1
uCqEjnxh2/vFBjKYkfTOkw: posts big blind $2
*** HOLE CARDS ***
vkfxu8f/jMYKUk6Ly4eujw: folds
4dcDwIHRm96PwtqkpQiuiA: folds
vkfxu8f/jMYKUk6Ly4eujw leaves the table
ubtx4Z5L+AcK71MTvYiGVw: folds
K8MXCrNAVYlMnnCeM32Kxw: raises $2 to $4
VvdR9F3I+2yELkfTVvC1dg: folds
uCqEjnxh2/vFBjKYkfTOkw: calls $2
*** FLOP *** [6s Qh 7s]
uCqEjnxh2/vFBjKYkfTOkw: checks
K8MXCrNAVYlMnnCeM32Kxw: checks
*** TURN *** [6s Qh 7s] [4h]
uCqEjnxh2/vFBjKYkfTOkw: checks
K8MXCrNAVYlMnnCeM32Kxw: checks
*** RIVER *** [6s Qh 7s 4h] [Ac]
uCqEjnxh2/vFBjKYkfTOkw: checks
K8MXCrNAVYlMnnCeM32Kxw: checks
*** SHOW DOWN ***
uCqEjnxh2/vFBjKYkfTOkw: shows [7h Kd] (a pair of Sevens)
K8MXCrNAVYlMnnCeM32Kxw: shows [Ks Kc] (a pair of Kings)
K8MXCrNAVYlMnnCeM32Kxw collected $8.55 from pot
*** SUMMARY ***
Total pot $9 | Rake $0.45
Board [6s Qh 7s 4h Ac]
Seat 1: vkfxu8f/jMYKUk6Ly4eujw folded before Flop (didn't bet)
Seat 2: 4dcDwIHRm96PwtqkpQiuiA folded before Flop (didn't bet)
Seat 3: ubtx4Z5L+AcK71MTvYiGVw folded before Flop (didn't bet)
Seat 4: K8MXCrNAVYlMnnCeM32Kxw (button) showed [Ks Kc] and won ($8.55) with a pair of Kings
Seat 5: VvdR9F3I+2yELkfTVvC1dg (small blind) folded before Flop
Seat 6: uCqEjnxh2/vFBjKYkfTOkw (big blind) showed [7h Kd] and lost with a pair of Sevens



PokerStars Game #59941849818:  Hold'em No Limit ($1/$2) - 2009/07/01 1:48:07 ET
Table 'kq5zaQ+1hLNf8LZfGnbTAA' 6-max Seat #1 is the button
Seat 1: 8srN1dKQePlsv0GyTada+Q ($419.60 in chips)
Seat 2: nXDI8Y/S6POzRwANu3d8hQ ($135 in chips)
Seat 3: /PH6Ffnho4Ysm8S3V/oa+w ($58.15 in chips)
Seat 4: 3dAbvkxS5NPQTBAbvpinVg ($275.65 in chips)
Seat 6: mfy7uGZcqA2PVQqEVbJ7+g ($194.15 in chips)
nXDI8Y/S6POzRwANu3d8hQ: posts small blind $1
/PH6Ffnho4Ysm8S3V/oa+w: posts big blind $2
*** HOLE CARDS ***
3dAbvkxS5NPQTBAbvpinVg: folds
mfy7uGZcqA2PVQqEVbJ7+g: folds
8srN1dKQePlsv0GyTada+Q: folds
BWhgxe7gWiYobRbwdG+d2Q joins the table at seat #5
nXDI8Y/S6POzRwANu3d8hQ: folds
/PH6Ffnho4Ysm8S3V/oa+w collected $2 from pot
/PH6Ffnho4Ysm8S3V/oa+w: doesn't show hand
*** SUMMARY ***
Total pot $2 | Rake $0
Seat 1: 8srN1dKQePlsv0GyTada+Q (button) folded before Flop (didn't bet)
Seat 2: nXDI8Y/S6POzRwANu3d8hQ (small blind) folded before Flop
Seat 3: /PH6Ffnho4Ysm8S3V/oa+w (big blind) collected ($2)
Seat 4: 3dAbvkxS5NPQTBAbvpinVg folded before Flop (didn't bet)
Seat 6: mfy7uGZcqA2PVQqEVbJ7+g folded before Flop (didn't bet)



PokerStars Game #59941851302:  Hold'em No Limit ($1/$2) - 2009/07/01 1:48:10 ET
Table 'bJQ024BaYSBrW0sXpCZbNQ' 6-max Seat #2 is the button
Seat 1: KfwW5us6tydK81NYTtK1gw ($204.40 in chips)
Seat 2: 3dAbvkxS5NPQTBAbvpinVg ($267 in chips)
Seat 4: vkfxu8f/jMYKUk6Ly4eujw ($228.05 in chips)
Seat 5: VvdR9F3I+2yELkfTVvC1dg ($200 in chips)
Seat 6: 4bqvCfJ0e8CTYnn0Go9hbQ ($142.70 in chips)
vkfxu8f/jMYKUk6Ly4eujw: posts small blind $1
VvdR9F3I+2yELkfTVvC1dg: posts big blind $2
*** HOLE CARDS ***
4bqvCfJ0e8CTYnn0Go9hbQ: folds
KfwW5us6tydK81NYTtK1gw: folds
3dAbvkxS5NPQTBAbvpinVg: folds
vkfxu8f/jMYKUk6Ly4eujw: folds
VvdR9F3I+2yELkfTVvC1dg collected $2 from pot
VvdR9F3I+2yELkfTVvC1dg: doesn't show hand
*** SUMMARY ***
Total pot $2 | Rake $0
Seat 1: KfwW5us6tydK81NYTtK1gw folded before Flop (didn't bet)
Seat 2: 3dAbvkxS5NPQTBAbvpinVg (button) folded before Flop (didn't bet)
Seat 4: vkfxu8f/jMYKUk6Ly4eujw (small blind) folded before Flop
Seat 5: VvdR9F3I+2yELkfTVvC1dg (big blind) collected ($2)
Seat 6: 4bqvCfJ0e8CTYnn0Go9hbQ folded before Flop (didn't bet)



PokerStars Game #59941851250:  Hold'em No Limit ($1/$2) - 2009/07/01 1:48:10 ET
Table 'uJ9juaXXg9yIcSU8amxaXQ' 6-max Seat #2 is the button
Seat 1: JsqOjN/eHz0uYVf/PyUJ6Q ($121.25 in chips)
Seat 2: VvdR9F3I+2yELkfTVvC1dg ($200 in chips)
Seat 3: qXDd0ZyMIse0OBu8pxeQ3Q ($241.40 in chips)
Seat 4: zNjJ/y4emmF+vzrCDd+ooA ($281.30 in chips)
Seat 5: YsLQ3BAvgQHWXMAv3Wv6Hg ($215.70 in chips)
Seat 6: /PH6Ffnho4Ysm8S3V/oa+w ($40 in chips)
qXDd0ZyMIse0OBu8pxeQ3Q: posts small blind $1
zNjJ/y4emmF+vzrCDd+ooA: posts big blind $2
*** HOLE CARDS ***
YsLQ3BAvgQHWXMAv3Wv6Hg: folds
YsLQ3BAvgQHWXMAv3Wv6Hg is sitting out
/PH6Ffnho4Ysm8S3V/oa+w: folds
JsqOjN/eHz0uYVf/PyUJ6Q: folds
VvdR9F3I+2yELkfTVvC1dg: raises $2 to $4
qXDd0ZyMIse0OBu8pxeQ3Q: calls $3
zNjJ/y4emmF+vzrCDd+ooA: folds
*** FLOP *** [5h Jc 8d]
qXDd0ZyMIse0OBu8pxeQ3Q: checks
VvdR9F3I+2yELkfTVvC1dg: bets $7.10
qXDd0ZyMIse0OBu8pxeQ3Q: folds
VvdR9F3I+2yELkfTVvC1dg collected $9.50 from pot
VvdR9F3I+2yELkfTVvC1dg: doesn't show hand
*** SUMMARY ***
Total pot $10 | Rake $0.50
Board [5h Jc 8d]
Seat 1: JsqOjN/eHz0uYVf/PyUJ6Q folded before Flop (didn't bet)
Seat 2: VvdR9F3I+2yELkfTVvC1dg (button) collected ($9.50)
Seat 3: qXDd0ZyMIse0OBu8pxeQ3Q (small blind) folded on the Flop
Seat 4: zNjJ/y4emmF+vzrCDd+ooA (big blind) folded before Flop
Seat 5: YsLQ3BAvgQHWXMAv3Wv6Hg folded before Flop (didn't bet)
Seat 6: /PH6Ffnho4Ysm8S3V/oa+w folded before Flop (didn't bet)



PokerStars Game #59941852458:  Hold'em No Limit ($1/$2) - 2009/07/01 1:48:12 ET
Table 'ZzSIe0zTCDv+n6hfbY5tTg' 6-max Seat #6 is the button
Seat 1: VvdR9F3I+2yELkfTVvC1dg ($259.10 in chips)
Seat 2: B87ikIyZ/TzAVeXf38Ny0g ($228 in chips)
Seat 3: gsugPj31Hui3Jefl98MBOA ($352 in chips)
Seat 4: 54yWzRRgS0oZ+S6LwZBxMQ ($46.10 in chips)
Seat 5: 3dAbvkxS5NPQTBAbvpinVg ($500.45 in chips)
Seat 6: 09BNF4quPDzanQzM8vc6WA ($36 in chips)
VvdR9F3I+2yELkfTVvC1dg: posts small blind $1
B87ikIyZ/TzAVeXf38Ny0g: posts big blind $2
*** HOLE CARDS ***
gsugPj31Hui3Jefl98MBOA: calls $2
54yWzRRgS0oZ+S6LwZBxMQ: folds
3dAbvkxS5NPQTBAbvpinVg: raises $8 to $10
09BNF4quPDzanQzM8vc6WA: folds
VvdR9F3I+2yELkfTVvC1dg: folds
B87ikIyZ/TzAVeXf38Ny0g: folds
gsugPj31Hui3Jefl98MBOA: raises $342 to $352 and is all-in
3dAbvkxS5NPQTBAbvpinVg: folds
gsugPj31Hui3Jefl98MBOA collected $23 from pot
*** SUMMARY ***
Total pot $23 | Rake $0
Seat 1: VvdR9F3I+2yELkfTVvC1dg (small blind) folded before Flop
Seat 2: B87ikIyZ/TzAVeXf38Ny0g (big blind) folded before Flop
Seat 3: gsugPj31Hui3Jefl98MBOA collected ($23)
Seat 4: 54yWzRRgS0oZ+S6LwZBxMQ folded before Flop (didn't bet)
Seat 5: 3dAbvkxS5NPQTBAbvpinVg folded before Flop
Seat 6: 09BNF4quPDzanQzM8vc6WA (button) folded before Flop (didn't bet)



PokerStars Game #59941852318:  Hold'em No Limit ($1/$2) - 2009/07/01 1:48:12 ET
Table 'qVXak+oTeDXMGbWa4sDU5Q' 9-max Seat #3 is the button
Seat 1: H6Z4+qu8gR0VUiPOijndVg ($230.45 in chips)
Seat 2: CST1bO+CmVQOtNgiT0cKPg ($142.25 in chips)
Seat 3: WUlHm+ydPPHG7Lb0rePSdA ($177.35 in chips)
Seat 4: lQYT23h5QCUVZAKxjOO39Q ($178.10 in chips)
Seat 7: 6oGEJqk9oDy29sSaLs+LGA ($18.65 in chips)
Seat 8: Z0rzUi0y1x80UdIpofoNbA ($106.55 in chips)
Seat 9: CkE3IyJF1KvdaAOmZY5XqQ ($212.55 in chips)
lQYT23h5QCUVZAKxjOO39Q: posts small blind $1
GX1heJ+DSsvm7gzSPsYhhQ: is sitting out
6oGEJqk9oDy29sSaLs+LGA: posts big blind $2
*** HOLE CARDS ***
GX1heJ+DSsvm7gzSPsYhhQ leaves the table
Z0rzUi0y1x80UdIpofoNbA: folds
zJtQ1gxyi72XvGYS1tM+DA has returned
CkE3IyJF1KvdaAOmZY5XqQ has timed out
CkE3IyJF1KvdaAOmZY5XqQ: folds
CkE3IyJF1KvdaAOmZY5XqQ is sitting out
CkE3IyJF1KvdaAOmZY5XqQ has returned
H6Z4+qu8gR0VUiPOijndVg: folds
CST1bO+CmVQOtNgiT0cKPg: folds
WUlHm+ydPPHG7Lb0rePSdA: folds
lQYT23h5QCUVZAKxjOO39Q: folds
6oGEJqk9oDy29sSaLs+LGA collected $2 from pot
*** SUMMARY ***
Total pot $2 | Rake $0
Seat 1: H6Z4+qu8gR0VUiPOijndVg folded before Flop (didn't bet)
Seat 2: CST1bO+CmVQOtNgiT0cKPg folded before Flop (didn't bet)
Seat 3: WUlHm+ydPPHG7Lb0rePSdA (button) folded before Flop (didn't bet)
Seat 4: lQYT23h5QCUVZAKxjOO39Q (small blind) folded before Flop
Seat 7: 6oGEJqk9oDy29sSaLs+LGA (big blind) collected ($2)
Seat 8: Z0rzUi0y1x80UdIpofoNbA folded before Flop (didn't bet)
Seat 9: CkE3IyJF1KvdaAOmZY5XqQ folded before Flop (didn't bet)



PokerStars Game #59941853134:  Hold'em No Limit ($1/$2) - 2009/07/01 1:48:14 ET
Table 'mGpP9StWRnoeiBDExc6Frg' 6-max Seat #2 is the button
Seat 1: VvdR9F3I+2yELkfTVvC1dg ($309.15 in chips)
Seat 2: 6hRJ68JkbJq6MYI9o5bUnQ ($100 in chips)
Seat 4: 4dcDwIHRm96PwtqkpQiuiA ($92.70 in chips)
Seat 5: d1puGuVBE0fidn+5eRJ0tw ($191.55 in chips)
Seat 6: B2Ih1sr5VZk+8He7rcrMtQ ($403.45 in chips)
4dcDwIHRm96PwtqkpQiuiA: posts small blind $1
d1puGuVBE0fidn+5eRJ0tw: posts big blind $2
*** HOLE CARDS ***
B2Ih1sr5VZk+8He7rcrMtQ: folds
VvdR9F3I+2yELkfTVvC1dg: folds
6hRJ68JkbJq6MYI9o5bUnQ: raises $4 to $6
4dcDwIHRm96PwtqkpQiuiA: folds
d1puGuVBE0fidn+5eRJ0tw: folds
6hRJ68JkbJq6MYI9o5bUnQ collected $5 from pot
*** SUMMARY ***
Total pot $5 | Rake $0
Seat 1: VvdR9F3I+2yELkfTVvC1dg folded before Flop (didn't bet)
Seat 2: 6hRJ68JkbJq6MYI9o5bUnQ (button) collected ($5)
Seat 4: 4dcDwIHRm96PwtqkpQiuiA (small blind) folded before Flop
Seat 5: d1puGuVBE0fidn+5eRJ0tw (big blind) folded before Flop
Seat 6: B2Ih1sr5VZk+8He7rcrMtQ folded before Flop (didn't bet)



PokerStars Game #59941853560:  Hold'em No Limit ($1/$2) - 2009/07/01 1:48:14 ET
Table '/dyk+YdRGv90j2box35j8w' 6-max Seat #2 is the button
Seat 1: 8srN1dKQePlsv0GyTada+Q ($200 in chips)
Seat 2: qCnEYuAE5y5A7bk6fO5/jQ ($499.20 in chips)
Seat 3: sTPOWERd9HWPCNrDBwsVjA ($201.50 in chips)
Seat 4: 4dMBh/1VTdeUTPCyhCs3UQ ($56.75 in chips)
Seat 5: VvdR9F3I+2yELkfTVvC1dg ($268.80 in chips)
sTPOWERd9HWPCNrDBwsVjA: posts small blind $1
4dMBh/1VTdeUTPCyhCs3UQ: posts big blind $2
*** HOLE CARDS ***
VvdR9F3I+2yELkfTVvC1dg: folds
8srN1dKQePlsv0GyTada+Q: folds
qCnEYuAE5y5A7bk6fO5/jQ: raises $4 to $6
sTPOWERd9HWPCNrDBwsVjA: folds
4dMBh/1VTdeUTPCyhCs3UQ: folds
qCnEYuAE5y5A7bk6fO5/jQ collected $5 from pot
qCnEYuAE5y5A7bk6fO5/jQ: doesn't show hand
*** SUMMARY ***
Total pot $5 | Rake $0
Seat 1: 8srN1dKQePlsv0GyTada+Q folded before Flop (didn't bet)
Seat 2: qCnEYuAE5y5A7bk6fO5/jQ (button) collected ($5)
Seat 3: sTPOWERd9HWPCNrDBwsVjA (small blind) folded before Flop
Seat 4: 4dMBh/1VTdeUTPCyhCs3UQ (big blind) folded before Flop
Seat 5: VvdR9F3I+2yELkfTVvC1dg folded before Flop (didn't bet)



PokerStars Game #59941853698:  Hold'em No Limit ($1/$2) - 2009/07/01 1:48:15 ET
Table 'QxerF7GUfCbl+4a8XaTB2w' 6-max Seat #6 is the button
Seat 1: ZwvXzkkZ3XpMhKfAmVpahw ($274.75 in chips)
Seat 2: 6UGgYbxwWNc+ohObe8vB9w ($39.75 in chips)
Seat 3: 8rZGabKe2DEPdZCbCivZ9Q ($27 in chips)
Seat 4: /PH6Ffnho4Ysm8S3V/oa+w ($53 in chips)
Seat 6: VvdR9F3I+2yELkfTVvC1dg ($213.70 in chips)
ZwvXzkkZ3XpMhKfAmVpahw: posts small blind $1
6UGgYbxwWNc+ohObe8vB9w: posts big blind $2
vkfxu8f/jMYKUk6Ly4eujw: sits out
*** HOLE CARDS ***
8rZGabKe2DEPdZCbCivZ9Q: folds
/PH6Ffnho4Ysm8S3V/oa+w: folds
VvdR9F3I+2yELkfTVvC1dg: folds
ZwvXzkkZ3XpMhKfAmVpahw: folds
6UGgYbxwWNc+ohObe8vB9w collected $2 from pot
*** SUMMARY ***
Total pot $2 | Rake $0
Seat 1: ZwvXzkkZ3XpMhKfAmVpahw (small blind) folded before Flop
Seat 2: 6UGgYbxwWNc+ohObe8vB9w (big blind) collected ($2)
Seat 3: 8rZGabKe2DEPdZCbCivZ9Q folded before Flop (didn't bet)
Seat 4: /PH6Ffnho4Ysm8S3V/oa+w folded before Flop (didn't bet)
Seat 6: VvdR9F3I+2yELkfTVvC1dg (button) folded before Flop (didn't bet)



PokerStars Game #59941855878:  Hold'em No Limit ($1/$2) - 2009/07/01 1:48:19 ET
Table '5/wEe6JmtGD7vufSA2RG7A' 2-max Seat #1 is the button
Seat 1: pVqEzK9wXlRMECnb1Zg4Zw ($194 in chips)
Seat 2: aOL8geThaYp2iadSHl1h1g ($145.50 in chips)
pVqEzK9wXlRMECnb1Zg4Zw: posts small blind $1
aOL8geThaYp2iadSHl1h1g: posts big blind $2
*** HOLE CARDS ***
pVqEzK9wXlRMECnb1Zg4Zw: raises $6 to $8
aOL8geThaYp2iadSHl1h1g: folds
pVqEzK9wXlRMECnb1Zg4Zw collected $4 from pot
pVqEzK9wXlRMECnb1Zg4Zw: doesn't show hand
*** SUMMARY ***
Total pot $4 | Rake $0
Seat 1: pVqEzK9wXlRMECnb1Zg4Zw (button) (small blind) collected ($4)
Seat 2: aOL8geThaYp2iadSHl1h1g (big blind) folded before Flop



PokerStars Game #59941857330:  Hold'em No Limit ($1/$2) - 2009/07/01 1:48:22 ET
Table '3WCXyaiCAbqSShQu7FIjvA' 9-max Seat #9 is the button
Seat 1: kTCkABD1UUldS9DFRGfCwQ ($136.75 in chips)
Seat 3: 5Q8U6iZbeO7xJSS4qvDP5g ($270.25 in chips)
Seat 4: waEF/+pxZTxNo4FvsORuXg ($103.40 in chips)
Seat 5: CkE3IyJF1KvdaAOmZY5XqQ ($210.90 in chips)
Seat 6: 5jQlngvMSqM/WoonOcR5kw ($285 in chips)
Seat 7: nXDI8Y/S6POzRwANu3d8hQ ($44.10 in chips)
Seat 8: +T/63sAeZzWyHchahJ36GQ ($37 in chips)
Seat 9: FiXPLJyqb24l32QST2TInw ($100.10 in chips)
kTCkABD1UUldS9DFRGfCwQ: posts small blind $1
TAfo4veNRaRlzDXMMYS3Jg: is sitting out
5Q8U6iZbeO7xJSS4qvDP5g: posts big blind $2
*** HOLE CARDS ***
waEF/+pxZTxNo4FvsORuXg: folds
TAfo4veNRaRlzDXMMYS3Jg leaves the table
CkE3IyJF1KvdaAOmZY5XqQ: folds
5jQlngvMSqM/WoonOcR5kw: folds
nXDI8Y/S6POzRwANu3d8hQ: folds
+T/63sAeZzWyHchahJ36GQ: folds
FiXPLJyqb24l32QST2TInw: calls $2
kTCkABD1UUldS9DFRGfCwQ: calls $1
254YPxPJr5Sw58bkD0YqYQ joins the table at seat #2
5Q8U6iZbeO7xJSS4qvDP5g: checks
*** FLOP *** [4s Qc 7h]
kTCkABD1UUldS9DFRGfCwQ: checks
5Q8U6iZbeO7xJSS4qvDP5g: checks
FiXPLJyqb24l32QST2TInw: bets $4
kTCkABD1UUldS9DFRGfCwQ: folds
5Q8U6iZbeO7xJSS4qvDP5g: folds
FiXPLJyqb24l32QST2TInw collected $5.70 from pot
FiXPLJyqb24l32QST2TInw: doesn't show hand
*** SUMMARY ***
Total pot $6 | Rake $0.30
Board [4s Qc 7h]
Seat 1: kTCkABD1UUldS9DFRGfCwQ (small blind) folded on the Flop
Seat 3: 5Q8U6iZbeO7xJSS4qvDP5g (big blind) folded on the Flop
Seat 4: waEF/+pxZTxNo4FvsORuXg folded before Flop (didn't bet)
Seat 5: CkE3IyJF1KvdaAOmZY5XqQ folded before Flop (didn't bet)
Seat 6: 5jQlngvMSqM/WoonOcR5kw folded before Flop (didn't bet)
Seat 7: nXDI8Y/S6POzRwANu3d8hQ folded before Flop (didn't bet)
Seat 8: +T/63sAeZzWyHchahJ36GQ folded before Flop (didn't bet)
Seat 9: FiXPLJyqb24l32QST2TInw (button) collected ($5.70)



PokerStars Game #59941858650:  Hold'em No Limit ($1/$2) - 2009/07/01 1:48:24 ET
Table 'bJQ024BaYSBrW0sXpCZbNQ' 6-max Seat #4 is the button
Seat 1: KfwW5us6tydK81NYTtK1gw ($204.40 in chips)
Seat 2: 3dAbvkxS5NPQTBAbvpinVg ($267 in chips)
Seat 4: vkfxu8f/jMYKUk6Ly4eujw ($227.05 in chips)
Seat 5: VvdR9F3I+2yELkfTVvC1dg ($201 in chips)
Seat 6: 4bqvCfJ0e8CTYnn0Go9hbQ ($142.70 in chips)
VvdR9F3I+2yELkfTVvC1dg: posts small blind $1
4bqvCfJ0e8CTYnn0Go9hbQ: posts big blind $2
*** HOLE CARDS ***
KfwW5us6tydK81NYTtK1gw: raises $4 to $6
3dAbvkxS5NPQTBAbvpinVg: folds
vkfxu8f/jMYKUk6Ly4eujw: folds
VvdR9F3I+2yELkfTVvC1dg: folds
4bqvCfJ0e8CTYnn0Go9hbQ: calls $4
*** FLOP *** [Tc 6s 2c]
4bqvCfJ0e8CTYnn0Go9hbQ: checks
KfwW5us6tydK81NYTtK1gw: bets $10
4bqvCfJ0e8CTYnn0Go9hbQ: folds
KfwW5us6tydK81NYTtK1gw collected $12.35 from pot
KfwW5us6tydK81NYTtK1gw: doesn't show hand
*** SUMMARY ***
Total pot $13 | Rake $0.65
Board [Tc 6s 2c]
Seat 1: KfwW5us6tydK81NYTtK1gw collected ($12.35)
Seat 2: 3dAbvkxS5NPQTBAbvpinVg folded before Flop (didn't bet)
Seat 4: vkfxu8f/jMYKUk6Ly4eujw (button) folded before Flop (didn't bet)
Seat 5: VvdR9F3I+2yELkfTVvC1dg (small blind) folded before Flop
Seat 6: 4bqvCfJ0e8CTYnn0Go9hbQ (big blind) folded on the Flop



PokerStars Game #59941859208:  Hold'em No Limit ($1/$2) - 2009/07/01 1:48:25 ET
Table 'P/yCfYl1GfGsu/e6DxDy/A' 2-max Seat #2 is the button
Seat 1: 7fOCUy3x9hdkmXkkDNolGQ ($549 in chips)
Seat 2: RwDoM55ZeQuI2ADyJhOb2Q ($923 in chips)
RwDoM55ZeQuI2ADyJhOb2Q: posts small blind $1
7fOCUy3x9hdkmXkkDNolGQ: posts big blind $2
*** HOLE CARDS ***
RwDoM55ZeQuI2ADyJhOb2Q: raises $4 to $6
7fOCUy3x9hdkmXkkDNolGQ: raises $16 to $22
RwDoM55ZeQuI2ADyJhOb2Q: folds
7fOCUy3x9hdkmXkkDNolGQ collected $12 from pot
7fOCUy3x9hdkmXkkDNolGQ: doesn't show hand
*** SUMMARY ***
Total pot $12 | Rake $0
Seat 1: 7fOCUy3x9hdkmXkkDNolGQ (big blind) collected ($12)
Seat 2: RwDoM55ZeQuI2ADyJhOb2Q (button) (small blind) folded before Flop



PokerStars Game #59941859536:  Hold'em No Limit ($1/$2) - 2009/07/01 1:48:26 ET
Table 'G1Oqdy4Pqdb5gtx40rUBzA' 6-max Seat #4 is the button
Seat 1: 4dMBh/1VTdeUTPCyhCs3UQ ($63.70 in chips)
Seat 2: m7mYVfnCOK5TE/VkN/FhOg ($212.05 in chips)
Seat 3: VvdR9F3I+2yELkfTVvC1dg ($423.90 in chips)
Seat 4: B87ikIyZ/TzAVeXf38Ny0g ($214.70 in chips)
Seat 5: F1+Ml47qRQWunzPnGhLLzQ ($198 in chips)
Seat 6: qCnEYuAE5y5A7bk6fO5/jQ ($200 in chips)
F1+Ml47qRQWunzPnGhLLzQ: posts small blind $1
qCnEYuAE5y5A7bk6fO5/jQ: posts big blind $2
*** HOLE CARDS ***
4dMBh/1VTdeUTPCyhCs3UQ: raises $5 to $7
m7mYVfnCOK5TE/VkN/FhOg: folds
VvdR9F3I+2yELkfTVvC1dg: folds
B87ikIyZ/TzAVeXf38Ny0g: folds
F1+Ml47qRQWunzPnGhLLzQ: folds
qCnEYuAE5y5A7bk6fO5/jQ: folds
4dMBh/1VTdeUTPCyhCs3UQ collected $5 from pot
4dMBh/1VTdeUTPCyhCs3UQ: doesn't show hand
*** SUMMARY ***
Total pot $5 | Rake $0
Seat 1: 4dMBh/1VTdeUTPCyhCs3UQ collected ($5)
Seat 2: m7mYVfnCOK5TE/VkN/FhOg folded before Flop (didn't bet)
Seat 3: VvdR9F3I+2yELkfTVvC1dg folded before Flop (didn't bet)
Seat 4: B87ikIyZ/TzAVeXf38Ny0g (button) folded before Flop (didn't bet)
Seat 5: F1+Ml47qRQWunzPnGhLLzQ (small blind) folded before Flop
Seat 6: qCnEYuAE5y5A7bk6fO5/jQ (big blind) folded before Flop



PokerStars Game #59941859894:  Hold'em No Limit ($1/$2) - 2009/07/01 1:48:27 ET
Table 'ztv6V3FN2bQ9nmJPPdx6nQ' 6-max Seat #1 is the button
Seat 1: 6fLdOUCRtX71xbVRhJEq8w ($300.35 in chips)
Seat 2: 5Y+ZGWLI4gnlpApDX5vy1A ($417.85 in chips)
Seat 4: UaZ5yj+6LjtWqMQg2QskUw ($66.65 in chips)
Seat 5: sTPOWERd9HWPCNrDBwsVjA ($219.60 in chips)
Seat 6: mfy7uGZcqA2PVQqEVbJ7+g ($43.60 in chips)
5Y+ZGWLI4gnlpApDX5vy1A: posts small blind $1
UaZ5yj+6LjtWqMQg2QskUw: posts big blind $2
*** HOLE CARDS ***
mfy7uGZcqA2PVQqEVbJ7+g said, "nice catch"
sTPOWERd9HWPCNrDBwsVjA: folds
mfy7uGZcqA2PVQqEVbJ7+g: folds
6fLdOUCRtX71xbVRhJEq8w: folds
5Y+ZGWLI4gnlpApDX5vy1A: calls $1
UaZ5yj+6LjtWqMQg2QskUw: checks
*** FLOP *** [Kh 5c Kc]
5Y+ZGWLI4gnlpApDX5vy1A: bets $4
6fLdOUCRtX71xbVRhJEq8w said, "nice call"
UaZ5yj+6LjtWqMQg2QskUw: folds
5Y+ZGWLI4gnlpApDX5vy1A collected $3.80 from pot
5Y+ZGWLI4gnlpApDX5vy1A: doesn't show hand
*** SUMMARY ***
Total pot $4 | Rake $0.20
Board [Kh 5c Kc]
Seat 1: 6fLdOUCRtX71xbVRhJEq8w (button) folded before Flop (didn't bet)
Seat 2: 5Y+ZGWLI4gnlpApDX5vy1A (small blind) collected ($3.80)
Seat 4: UaZ5yj+6LjtWqMQg2QskUw (big blind) folded on the Flop
Seat 5: sTPOWERd9HWPCNrDBwsVjA folded before Flop (didn't bet)
Seat 6: mfy7uGZcqA2PVQqEVbJ7+g folded before Flop (didn't bet)



PokerStars Game #59941860860:  Hold'em No Limit ($1/$2) - 2009/07/01 1:48:28 ET
Table 'kq5zaQ+1hLNf8LZfGnbTAA' 6-max Seat #2 is the button
Seat 1: 8srN1dKQePlsv0GyTada+Q ($419.60 in chips)
Seat 2: nXDI8Y/S6POzRwANu3d8hQ ($134 in chips)
Seat 3: /PH6Ffnho4Ysm8S3V/oa+w ($59.15 in chips)
Seat 4: 3dAbvkxS5NPQTBAbvpinVg ($275.65 in chips)
Seat 6: mfy7uGZcqA2PVQqEVbJ7+g ($194.15 in chips)
/PH6Ffnho4Ysm8S3V/oa+w: posts small blind $1
3dAbvkxS5NPQTBAbvpinVg: posts big blind $2
BWhgxe7gWiYobRbwdG+d2Q: sits out
*** HOLE CARDS ***
mfy7uGZcqA2PVQqEVbJ7+g: folds
8srN1dKQePlsv0GyTada+Q: folds
nXDI8Y/S6POzRwANu3d8hQ: raises $6 to $8
/PH6Ffnho4Ysm8S3V/oa+w: folds
3dAbvkxS5NPQTBAbvpinVg: folds
nXDI8Y/S6POzRwANu3d8hQ collected $5 from pot
nXDI8Y/S6POzRwANu3d8hQ: doesn't show hand
*** SUMMARY ***
Total pot $5 | Rake $0
Seat 1: 8srN1dKQePlsv0GyTada+Q folded before Flop (didn't bet)
Seat 2: nXDI8Y/S6POzRwANu3d8hQ (button) collected ($5)
Seat 3: /PH6Ffnho4Ysm8S3V/oa+w (small blind) folded before Flop
Seat 4: 3dAbvkxS5NPQTBAbvpinVg (big blind) folded before Flop
Seat 6: mfy7uGZcqA2PVQqEVbJ7+g folded before Flop (didn't bet)



PokerStars Game #59941860584:  Hold'em No Limit ($1/$2) - 2009/07/01 1:48:28 ET
Table 'NmY84NAf9Mh0ckAckHnh5g' 2-max Seat #2 is the button
Seat 1: 6hvg964TSqZ3AL/0XK9aVQ ($620.25 in chips)
Seat 2: RwDoM55ZeQuI2ADyJhOb2Q ($365.05 in chips)
RwDoM55ZeQuI2ADyJhOb2Q: posts small blind $1
6hvg964TSqZ3AL/0XK9aVQ: posts big blind $2
*** HOLE CARDS ***
RwDoM55ZeQuI2ADyJhOb2Q: raises $4 to $6
6hvg964TSqZ3AL/0XK9aVQ: calls $4
*** FLOP *** [Td Ac Kd]
6hvg964TSqZ3AL/0XK9aVQ: checks
RwDoM55ZeQuI2ADyJhOb2Q: bets $12
6hvg964TSqZ3AL/0XK9aVQ: folds
RwDoM55ZeQuI2ADyJhOb2Q collected $11.50 from pot
RwDoM55ZeQuI2ADyJhOb2Q: doesn't show hand
*** SUMMARY ***
Total pot $12 | Rake $0.50
Board [Td Ac Kd]
Seat 1: 6hvg964TSqZ3AL/0XK9aVQ (big blind) folded on the Flop
Seat 2: RwDoM55ZeQuI2ADyJhOb2Q (button) (small blind) collected ($11.50)



PokerStars Game #59941861160:  Hold'em No Limit ($1/$2) - 2009/07/01 1:48:29 ET
Table '5/wEe6JmtGD7vufSA2RG7A' 2-max Seat #2 is the button
Seat 1: pVqEzK9wXlRMECnb1Zg4Zw ($196 in chips)
Seat 2: aOL8geThaYp2iadSHl1h1g ($143.50 in chips)
aOL8geThaYp2iadSHl1h1g: posts small blind $1
pVqEzK9wXlRMECnb1Zg4Zw: posts big blind $2
*** HOLE CARDS ***
aOL8geThaYp2iadSHl1h1g: raises $4 to $6
pVqEzK9wXlRMECnb1Zg4Zw: folds
aOL8geThaYp2iadSHl1h1g collected $4 from pot
*** SUMMARY ***
Total pot $4 | Rake $0
Seat 1: pVqEzK9wXlRMECnb1Zg4Zw (big blind) folded before Flop
Seat 2: aOL8geThaYp2iadSHl1h1g (button) (small blind) collected ($4)



PokerStars Game #59941862184:  Hold'em No Limit ($1/$2) - 2009/07/01 1:48:31 ET
Table 'C4lkCXY2PWy6z4vsAe5NGQ' 6-max Seat #5 is the button
Seat 2: 6hRJ68JkbJq6MYI9o5bUnQ ($78.95 in chips)
Seat 3: sTPOWERd9HWPCNrDBwsVjA ($133.80 in chips)
Seat 4: VvdR9F3I+2yELkfTVvC1dg ($207 in chips)
Seat 5: /PH6Ffnho4Ysm8S3V/oa+w ($51.60 in chips)
Seat 6: B87ikIyZ/TzAVeXf38Ny0g ($708.20 in chips)
B87ikIyZ/TzAVeXf38Ny0g: posts small blind $1
6hRJ68JkbJq6MYI9o5bUnQ: posts big blind $2
*** HOLE CARDS ***
sTPOWERd9HWPCNrDBwsVjA: folds
VvdR9F3I+2yELkfTVvC1dg: folds
/PH6Ffnho4Ysm8S3V/oa+w: raises $2 to $4
B87ikIyZ/TzAVeXf38Ny0g: folds
6hRJ68JkbJq6MYI9o5bUnQ: calls $2
*** FLOP *** [4h Ac 4c]
6hRJ68JkbJq6MYI9o5bUnQ: checks
/PH6Ffnho4Ysm8S3V/oa+w: bets $4
6hRJ68JkbJq6MYI9o5bUnQ: folds
/PH6Ffnho4Ysm8S3V/oa+w collected $8.55 from pot
/PH6Ffnho4Ysm8S3V/oa+w: doesn't show hand
*** SUMMARY ***
Total pot $9 | Rake $0.45
Board [4h Ac 4c]
Seat 2: 6hRJ68JkbJq6MYI9o5bUnQ (big blind) folded on the Flop
Seat 3: sTPOWERd9HWPCNrDBwsVjA folded before Flop (didn't bet)
Seat 4: VvdR9F3I+2yELkfTVvC1dg folded before Flop (didn't bet)
Seat 5: /PH6Ffnho4Ysm8S3V/oa+w (button) collected ($8.55)
Seat 6: B87ikIyZ/TzAVeXf38Ny0g (small blind) folded before Flop



PokerStars Game #59941862566:  Hold'em No Limit ($1/$2) - 2009/07/01 1:48:32 ET
Table 'BSRfGh+QobUe0AgIMtt/fw' 9-max Seat #1 is the button
Seat 1: gDn/rYeNwCyWEgRhyWp4PA ($159.05 in chips)
Seat 2: +SmnXtdmwqXGEJfLeJDIUQ ($124.90 in chips)
Seat 3: WUlHm+ydPPHG7Lb0rePSdA ($120 in chips)
Seat 4: +T/63sAeZzWyHchahJ36GQ ($34 in chips)
Seat 5: v0q3vrz/d9oDjLrAG8Ausw ($241.75 in chips)
Seat 6: H6Z4+qu8gR0VUiPOijndVg ($200 in chips)
Seat 7: CkE3IyJF1KvdaAOmZY5XqQ ($200 in chips)
+SmnXtdmwqXGEJfLeJDIUQ: posts small blind $1
WUlHm+ydPPHG7Lb0rePSdA: posts big blind $2
tjgwwDmi+N2H4I7hx8useQ: sits out
*** HOLE CARDS ***
+T/63sAeZzWyHchahJ36GQ: folds
v0q3vrz/d9oDjLrAG8Ausw: raises $4 to $6
H6Z4+qu8gR0VUiPOijndVg: folds
CkE3IyJF1KvdaAOmZY5XqQ: folds
gDn/rYeNwCyWEgRhyWp4PA: folds
+SmnXtdmwqXGEJfLeJDIUQ: folds
GG5lTuGt3+kwNYSbqeB6yw joins the table at seat #8
WUlHm+ydPPHG7Lb0rePSdA: folds
v0q3vrz/d9oDjLrAG8Ausw collected $5 from pot
*** SUMMARY ***
Total pot $5 | Rake $0
Seat 1: gDn/rYeNwCyWEgRhyWp4PA (button) folded before Flop (didn't bet)
Seat 2: +SmnXtdmwqXGEJfLeJDIUQ (small blind) folded before Flop
Seat 3: WUlHm+ydPPHG7Lb0rePSdA (big blind) folded before Flop
Seat 4: +T/63sAeZzWyHchahJ36GQ folded before Flop (didn't bet)
Seat 5: v0q3vrz/d9oDjLrAG8Ausw collected ($5)
Seat 6: H6Z4+qu8gR0VUiPOijndVg folded before Flop (didn't bet)
Seat 7: CkE3IyJF1KvdaAOmZY5XqQ folded before Flop (didn't bet)



PokerStars Game #59941863926:  Hold'em No Limit ($1/$2) - 2009/07/01 1:48:34 ET
Table 'mGpP9StWRnoeiBDExc6Frg' 6-max Seat #4 is the button
Seat 1: VvdR9F3I+2yELkfTVvC1dg ($309.15 in chips)
Seat 2: 6hRJ68JkbJq6MYI9o5bUnQ ($103 in chips)
Seat 4: 4dcDwIHRm96PwtqkpQiuiA ($91.70 in chips)
Seat 5: d1puGuVBE0fidn+5eRJ0tw ($189.55 in chips)
Seat 6: B2Ih1sr5VZk+8He7rcrMtQ ($403.45 in chips)
d1puGuVBE0fidn+5eRJ0tw: posts small blind $1
B2Ih1sr5VZk+8He7rcrMtQ: posts big blind $2
*** HOLE CARDS ***
VvdR9F3I+2yELkfTVvC1dg: folds
6hRJ68JkbJq6MYI9o5bUnQ: folds
4dcDwIHRm96PwtqkpQiuiA: folds
d1puGuVBE0fidn+5eRJ0tw: folds
B2Ih1sr5VZk+8He7rcrMtQ collected $2 from pot
*** SUMMARY ***
Total pot $2 | Rake $0
Seat 1: VvdR9F3I+2yELkfTVvC1dg folded before Flop (didn't bet)
Seat 2: 6hRJ68JkbJq6MYI9o5bUnQ folded before Flop (didn't bet)
Seat 4: 4dcDwIHRm96PwtqkpQiuiA (button) folded before Flop (didn't bet)
Seat 5: d1puGuVBE0fidn+5eRJ0tw (small blind) folded before Flop
Seat 6: B2Ih1sr5VZk+8He7rcrMtQ (big blind) collected ($2)



PokerStars Game #59941864392:  Hold'em No Limit ($1/$2) - 2009/07/01 1:48:35 ET
Table 'QxerF7GUfCbl+4a8XaTB2w' 6-max Seat #1 is the button
Seat 1: ZwvXzkkZ3XpMhKfAmVpahw ($273.75 in chips)
Seat 2: 6UGgYbxwWNc+ohObe8vB9w ($40.75 in chips)
Seat 3: 8rZGabKe2DEPdZCbCivZ9Q ($27 in chips)
Seat 4: /PH6Ffnho4Ysm8S3V/oa+w ($53 in chips)
Seat 6: VvdR9F3I+2yELkfTVvC1dg ($213.70 in chips)
6UGgYbxwWNc+ohObe8vB9w: posts small blind $1
8rZGabKe2DEPdZCbCivZ9Q: posts big blind $2
vkfxu8f/jMYKUk6Ly4eujw: sits out
*** HOLE CARDS ***
/PH6Ffnho4Ysm8S3V/oa+w: folds
VvdR9F3I+2yELkfTVvC1dg: folds
ZwvXzkkZ3XpMhKfAmVpahw: folds
6UGgYbxwWNc+ohObe8vB9w: folds
8rZGabKe2DEPdZCbCivZ9Q collected $2 from pot
8rZGabKe2DEPdZCbCivZ9Q: doesn't show hand
*** SUMMARY ***
Total pot $2 | Rake $0
Seat 1: ZwvXzkkZ3XpMhKfAmVpahw (button) folded before Flop (didn't bet)
Seat 2: 6UGgYbxwWNc+ohObe8vB9w (small blind) folded before Flop
Seat 3: 8rZGabKe2DEPdZCbCivZ9Q (big blind) collected ($2)
Seat 4: /PH6Ffnho4Ysm8S3V/oa+w folded before Flop (didn't bet)
Seat 6: VvdR9F3I+2yELkfTVvC1dg folded before Flop (didn't bet)



PokerStars Game #59941864120:  Hold'em No Limit ($1/$2) - 2009/07/01 1:48:35 ET
Table '4NGNnZ/osQfNq6abYqkJeA' 6-max Seat #2 is the button
Seat 2: 669iGNwYwgRZg3nhS+aDAQ ($129.25 in chips)
Seat 3: 54yWzRRgS0oZ+S6LwZBxMQ ($41.65 in chips)
Seat 4: sY+4Uuh5z/6AbXXaCS10jw ($297.75 in chips)
Seat 5: VvdR9F3I+2yELkfTVvC1dg ($231.80 in chips)
Seat 6: /PH6Ffnho4Ysm8S3V/oa+w ($40 in chips)
54yWzRRgS0oZ+S6LwZBxMQ: posts small blind $1
sY+4Uuh5z/6AbXXaCS10jw: posts big blind $2
*** HOLE CARDS ***
VvdR9F3I+2yELkfTVvC1dg: folds
/PH6Ffnho4Ysm8S3V/oa+w: folds
669iGNwYwgRZg3nhS+aDAQ: raises $4 to $6
54yWzRRgS0oZ+S6LwZBxMQ: folds
sY+4Uuh5z/6AbXXaCS10jw: calls $4
*** FLOP *** [8d Qh 5c]
sY+4Uuh5z/6AbXXaCS10jw: checks
669iGNwYwgRZg3nhS+aDAQ: checks
*** TURN *** [8d Qh 5c] [2c]
sY+4Uuh5z/6AbXXaCS10jw: bets $8
669iGNwYwgRZg3nhS+aDAQ: folds
sY+4Uuh5z/6AbXXaCS10jw collected $12.35 from pot
*** SUMMARY ***
Total pot $13 | Rake $0.65
Board [8d Qh 5c 2c]
Seat 2: 669iGNwYwgRZg3nhS+aDAQ (button) folded on the Turn
Seat 3: 54yWzRRgS0oZ+S6LwZBxMQ (small blind) folded before Flop
Seat 4: sY+4Uuh5z/6AbXXaCS10jw (big blind) collected ($12.35)
Seat 5: VvdR9F3I+2yELkfTVvC1dg folded before Flop (didn't bet)
Seat 6: /PH6Ffnho4Ysm8S3V/oa+w folded before Flop (didn't bet)



PokerStars Game #59941866854:  Hold'em No Limit ($1/$2) - 2009/07/01 1:48:40 ET
Table 'TsEDkiO4tzCTCzJ7tNdEqw' 6-max Seat #5 is the button
Seat 2: 4dcDwIHRm96PwtqkpQiuiA ($79.65 in chips)
Seat 3: ubtx4Z5L+AcK71MTvYiGVw ($200 in chips)
Seat 4: K8MXCrNAVYlMnnCeM32Kxw ($127.55 in chips)
Seat 5: VvdR9F3I+2yELkfTVvC1dg ($246.35 in chips)
Seat 6: uCqEjnxh2/vFBjKYkfTOkw ($288.80 in chips)
uCqEjnxh2/vFBjKYkfTOkw: posts small blind $1
4dcDwIHRm96PwtqkpQiuiA: posts big blind $2
*** HOLE CARDS ***
ubtx4Z5L+AcK71MTvYiGVw: raises $6 to $8
K8MXCrNAVYlMnnCeM32Kxw: folds
VvdR9F3I+2yELkfTVvC1dg: folds
uCqEjnxh2/vFBjKYkfTOkw: folds
4dcDwIHRm96PwtqkpQiuiA: folds
ubtx4Z5L+AcK71MTvYiGVw collected $5 from pot
ubtx4Z5L+AcK71MTvYiGVw: doesn't show hand
*** SUMMARY ***
Total pot $5 | Rake $0
Seat 2: 4dcDwIHRm96PwtqkpQiuiA (big blind) folded before Flop
Seat 3: ubtx4Z5L+AcK71MTvYiGVw collected ($5)
Seat 4: K8MXCrNAVYlMnnCeM32Kxw folded before Flop (didn't bet)
Seat 5: VvdR9F3I+2yELkfTVvC1dg (button) folded before Flop (didn't bet)
Seat 6: uCqEjnxh2/vFBjKYkfTOkw (small blind) folded before Flop



PokerStars Game #59941866706:  Hold'em No Limit ($1/$2) - 2009/07/01 1:48:40 ET
Table 'P/yCfYl1GfGsu/e6DxDy/A' 2-max Seat #1 is the button
Seat 1: 7fOCUy3x9hdkmXkkDNolGQ ($555 in chips)
Seat 2: RwDoM55ZeQuI2ADyJhOb2Q ($917 in chips)
7fOCUy3x9hdkmXkkDNolGQ: posts small blind $1
RwDoM55ZeQuI2ADyJhOb2Q: posts big blind $2
*** HOLE CARDS ***
7fOCUy3x9hdkmXkkDNolGQ: folds
RwDoM55ZeQuI2ADyJhOb2Q collected $2 from pot
RwDoM55ZeQuI2ADyJhOb2Q: doesn't show hand
*** SUMMARY ***
Total pot $2 | Rake $0
Seat 1: 7fOCUy3x9hdkmXkkDNolGQ (button) (small blind) folded before Flop
Seat 2: RwDoM55ZeQuI2ADyJhOb2Q (big blind) collected ($2)



PokerStars Game #59941867742:  Hold'em No Limit ($1/$2) - 2009/07/01 1:48:42 ET
Table 'uJ9juaXXg9yIcSU8amxaXQ' 6-max Seat #3 is the button
Seat 1: JsqOjN/eHz0uYVf/PyUJ6Q ($121.25 in chips)
Seat 2: VvdR9F3I+2yELkfTVvC1dg ($205.50 in chips)
Seat 3: qXDd0ZyMIse0OBu8pxeQ3Q ($237.40 in chips)
Seat 4: zNjJ/y4emmF+vzrCDd+ooA ($279.30 in chips)
Seat 6: /PH6Ffnho4Ysm8S3V/oa+w ($40 in chips)
zNjJ/y4emmF+vzrCDd+ooA: posts small blind $1
/PH6Ffnho4Ysm8S3V/oa+w: posts big blind $2
*** HOLE CARDS ***
JsqOjN/eHz0uYVf/PyUJ6Q: folds
VvdR9F3I+2yELkfTVvC1dg: raises $2 to $4
qXDd0ZyMIse0OBu8pxeQ3Q: folds
zNjJ/y4emmF+vzrCDd+ooA: calls $3
/PH6Ffnho4Ysm8S3V/oa+w: folds
*** FLOP *** [7d Kh 6h]
zNjJ/y4emmF+vzrCDd+ooA: bets $2
VvdR9F3I+2yELkfTVvC1dg: calls $2
*** TURN *** [7d Kh 6h] [6d]
zNjJ/y4emmF+vzrCDd+ooA: bets $2
VvdR9F3I+2yELkfTVvC1dg: calls $2
*** RIVER *** [7d Kh 6h 6d] [8d]
zNjJ/y4emmF+vzrCDd+ooA: bets $6
VvdR9F3I+2yELkfTVvC1dg: raises $12.70 to $18.70
zNjJ/y4emmF+vzrCDd+ooA: folds
VvdR9F3I+2yELkfTVvC1dg collected $28.55 from pot
VvdR9F3I+2yELkfTVvC1dg: doesn't show hand
*** SUMMARY ***
Total pot $30 | Rake $1.45
Board [7d Kh 6h 6d 8d]
Seat 1: JsqOjN/eHz0uYVf/PyUJ6Q folded before Flop (didn't bet)
Seat 2: VvdR9F3I+2yELkfTVvC1dg collected ($28.55)
Seat 3: qXDd0ZyMIse0OBu8pxeQ3Q (button) folded before Flop (didn't bet)
Seat 4: zNjJ/y4emmF+vzrCDd+ooA (small blind) folded on the River
Seat 6: /PH6Ffnho4Ysm8S3V/oa+w (big blind) folded before Flop



PokerStars Game #59941868084:  Hold'em No Limit ($1/$2) - 2009/07/01 1:48:42 ET
Table 'UGLAZZyv+cXmnKjYin0etA' 6-max Seat #2 is the button
Seat 2: eDLH1PUXFpvJBNMXBVQcGA ($304.10 in chips)
Seat 4: SiGJDsvRViJX05vHhA80GQ ($232.85 in chips)
Seat 5: 54yWzRRgS0oZ+S6LwZBxMQ ($40.80 in chips)
Seat 6: sTPOWERd9HWPCNrDBwsVjA ($218.95 in chips)
SiGJDsvRViJX05vHhA80GQ: posts small blind $1
54yWzRRgS0oZ+S6LwZBxMQ: posts big blind $2
*** HOLE CARDS ***
sTPOWERd9HWPCNrDBwsVjA: folds
eDLH1PUXFpvJBNMXBVQcGA: folds
SiGJDsvRViJX05vHhA80GQ: raises $6 to $8
54yWzRRgS0oZ+S6LwZBxMQ: folds
SiGJDsvRViJX05vHhA80GQ collected $4 from pot
*** SUMMARY ***
Total pot $4 | Rake $0
Seat 2: eDLH1PUXFpvJBNMXBVQcGA (button) folded before Flop (didn't bet)
Seat 4: SiGJDsvRViJX05vHhA80GQ (small blind) collected ($4)
Seat 5: 54yWzRRgS0oZ+S6LwZBxMQ (big blind) folded before Flop
Seat 6: sTPOWERd9HWPCNrDBwsVjA folded before Flop (didn't bet)



PokerStars Game #59941867714:  Hold'em No Limit ($1/$2) - 2009/07/01 1:48:42 ET
Table 'rsKRKlGHlxVyqJxzO2a2Ow' 9-max Seat #3 is the button
Seat 1: KqHysDSpCPaPyK3tJC1aEw ($212.30 in chips)
Seat 2: +T/63sAeZzWyHchahJ36GQ ($83 in chips)
Seat 3: kM9CA+2UcdMjbCMbtUCGiA ($225.10 in chips)
Seat 4: 31HuO+DQxppUQEedBWukug ($109.85 in chips)
Seat 5: 5Q8U6iZbeO7xJSS4qvDP5g ($248.30 in chips)
Seat 6: H6Z4+qu8gR0VUiPOijndVg ($200 in chips)
Seat 7: GX1heJ+DSsvm7gzSPsYhhQ ($56 in chips)
Seat 8: CkE3IyJF1KvdaAOmZY5XqQ ($203.70 in chips)
Seat 9: gRbvhSUVg+TNaTjaJecIRw ($50.60 in chips)
31HuO+DQxppUQEedBWukug: posts small blind $1
5Q8U6iZbeO7xJSS4qvDP5g: posts big blind $2
*** HOLE CARDS ***
H6Z4+qu8gR0VUiPOijndVg: folds
GX1heJ+DSsvm7gzSPsYhhQ: folds
CkE3IyJF1KvdaAOmZY5XqQ: raises $6 to $8
gRbvhSUVg+TNaTjaJecIRw: folds
KqHysDSpCPaPyK3tJC1aEw: folds
+T/63sAeZzWyHchahJ36GQ: folds
kM9CA+2UcdMjbCMbtUCGiA: folds
31HuO+DQxppUQEedBWukug: folds
5Q8U6iZbeO7xJSS4qvDP5g: folds
CkE3IyJF1KvdaAOmZY5XqQ collected $5 from pot
*** SUMMARY ***
Total pot $5 | Rake $0
Seat 1: KqHysDSpCPaPyK3tJC1aEw folded before Flop (didn't bet)
Seat 2: +T/63sAeZzWyHchahJ36GQ folded before Flop (didn't bet)
Seat 3: kM9CA+2UcdMjbCMbtUCGiA (button) folded before Flop (didn't bet)
Seat 4: 31HuO+DQxppUQEedBWukug (small blind) folded before Flop
Seat 5: 5Q8U6iZbeO7xJSS4qvDP5g (big blind) folded before Flop
Seat 6: H6Z4+qu8gR0VUiPOijndVg folded before Flop (didn't bet)
Seat 7: GX1heJ+DSsvm7gzSPsYhhQ folded before Flop (didn't bet)
Seat 8: CkE3IyJF1KvdaAOmZY5XqQ collected ($5)
Seat 9: gRbvhSUVg+TNaTjaJecIRw folded before Flop (didn't bet)



PokerStars Game #59941868446:  Hold'em No Limit ($1/$2) - 2009/07/01 1:48:43 ET
Table 'aSf77Sj8QEnzcc0WaxVD4Q' 6-max Seat #3 is the button
Seat 1: UELtvp+JfwI7XDGVwSxZXA ($183.05 in chips)
Seat 2: vkfxu8f/jMYKUk6Ly4eujw ($191.10 in chips)
Seat 3: 9dpyyjDTCed6nV7JhaUUpw ($760.50 in chips)
Seat 5: VvdR9F3I+2yELkfTVvC1dg ($302.70 in chips)
Seat 6: vkoJRf3gidxY1pPi0AFWww ($151.85 in chips)
VvdR9F3I+2yELkfTVvC1dg: posts small blind $1
vkoJRf3gidxY1pPi0AFWww: posts big blind $2
*** HOLE CARDS ***
UELtvp+JfwI7XDGVwSxZXA: calls $2
vkfxu8f/jMYKUk6Ly4eujw: folds
9dpyyjDTCed6nV7JhaUUpw: folds
VvdR9F3I+2yELkfTVvC1dg: folds
vkoJRf3gidxY1pPi0AFWww: checks
*** FLOP *** [3h Kc 5s]
vkoJRf3gidxY1pPi0AFWww: checks
UELtvp+JfwI7XDGVwSxZXA: checks
*** TURN *** [3h Kc 5s] [9s]
vkoJRf3gidxY1pPi0AFWww: checks
UELtvp+JfwI7XDGVwSxZXA: checks
*** RIVER *** [3h Kc 5s 9s] [Ts]
YsLQ3BAvgQHWXMAv3Wv6Hg has returned
vkoJRf3gidxY1pPi0AFWww: checks
UELtvp+JfwI7XDGVwSxZXA: checks
*** SHOW DOWN ***
vkoJRf3gidxY1pPi0AFWww: shows [Qd Th] (a pair of Tens)
UELtvp+JfwI7XDGVwSxZXA: mucks hand
vkoJRf3gidxY1pPi0AFWww collected $4.75 from pot
*** SUMMARY ***
Total pot $5 | Rake $0.25
Board [3h Kc 5s 9s Ts]
Seat 1: UELtvp+JfwI7XDGVwSxZXA mucked
Seat 2: vkfxu8f/jMYKUk6Ly4eujw folded before Flop (didn't bet)
Seat 3: 9dpyyjDTCed6nV7JhaUUpw (button) folded before Flop (didn't bet)
Seat 5: VvdR9F3I+2yELkfTVvC1dg (small blind) folded before Flop
Seat 6: vkoJRf3gidxY1pPi0AFWww (big blind) showed [Qd Th] and won ($4.75) with a pair of Tens



PokerStars Game #59941868572:  Hold'em No Limit ($1/$2) - 2009/07/01 1:48:43 ET
Table 'NmY84NAf9Mh0ckAckHnh5g' 2-max Seat #1 is the button
Seat 1: 6hvg964TSqZ3AL/0XK9aVQ ($614.25 in chips)
Seat 2: RwDoM55ZeQuI2ADyJhOb2Q ($370.55 in chips)
6hvg964TSqZ3AL/0XK9aVQ: posts small blind $1
RwDoM55ZeQuI2ADyJhOb2Q: posts big blind $2
*** HOLE CARDS ***
6hvg964TSqZ3AL/0XK9aVQ: calls $1
RwDoM55ZeQuI2ADyJhOb2Q: raises $6 to $8
6hvg964TSqZ3AL/0XK9aVQ: calls $6
*** FLOP *** [2c Qc 4c]
RwDoM55ZeQuI2ADyJhOb2Q: checks
6hvg964TSqZ3AL/0XK9aVQ: checks
*** TURN *** [2c Qc 4c] [Tc]
RwDoM55ZeQuI2ADyJhOb2Q: checks
6hvg964TSqZ3AL/0XK9aVQ: checks
*** RIVER *** [2c Qc 4c Tc] [7c]
RwDoM55ZeQuI2ADyJhOb2Q: checks
6hvg964TSqZ3AL/0XK9aVQ: bets $28
RwDoM55ZeQuI2ADyJhOb2Q: folds
6hvg964TSqZ3AL/0XK9aVQ collected $15.50 from pot
6hvg964TSqZ3AL/0XK9aVQ: doesn't show hand
*** SUMMARY ***
Total pot $16 | Rake $0.50
Board [2c Qc 4c Tc 7c]
Seat 1: 6hvg964TSqZ3AL/0XK9aVQ (button) (small blind) collected ($15.50)
Seat 2: RwDoM55ZeQuI2ADyJhOb2Q (big blind) folded on the River



PokerStars Game #59941868944:  Hold'em No Limit ($1/$2) - 2009/07/01 1:48:44 ET
Table 'mGpP9StWRnoeiBDExc6Frg' 6-max Seat #5 is the button
Seat 1: VvdR9F3I+2yELkfTVvC1dg ($309.15 in chips)
Seat 2: 6hRJ68JkbJq6MYI9o5bUnQ ($103 in chips)
Seat 4: 4dcDwIHRm96PwtqkpQiuiA ($91.70 in chips)
Seat 5: d1puGuVBE0fidn+5eRJ0tw ($188.55 in chips)
Seat 6: B2Ih1sr5VZk+8He7rcrMtQ ($404.45 in chips)
B2Ih1sr5VZk+8He7rcrMtQ: posts small blind $1
VvdR9F3I+2yELkfTVvC1dg: posts big blind $2
*** HOLE CARDS ***
6hRJ68JkbJq6MYI9o5bUnQ: folds
4dcDwIHRm96PwtqkpQiuiA: folds
d1puGuVBE0fidn+5eRJ0tw: calls $2
B2Ih1sr5VZk+8He7rcrMtQ: calls $1
VvdR9F3I+2yELkfTVvC1dg: checks
*** FLOP *** [Qh Th 9h]
B2Ih1sr5VZk+8He7rcrMtQ: checks
VvdR9F3I+2yELkfTVvC1dg: bets $4.25
d1puGuVBE0fidn+5eRJ0tw: folds
B2Ih1sr5VZk+8He7rcrMtQ: folds
VvdR9F3I+2yELkfTVvC1dg collected $5.70 from pot
VvdR9F3I+2yELkfTVvC1dg: doesn't show hand
*** SUMMARY ***
Total pot $6 | Rake $0.30
Board [Qh Th 9h]
Seat 1: VvdR9F3I+2yELkfTVvC1dg (big blind) collected ($5.70)
Seat 2: 6hRJ68JkbJq6MYI9o5bUnQ folded before Flop (didn't bet)
Seat 4: 4dcDwIHRm96PwtqkpQiuiA folded before Flop (didn't bet)
Seat 5: d1puGuVBE0fidn+5eRJ0tw (button) folded on the Flop
Seat 6: B2Ih1sr5VZk+8He7rcrMtQ (small blind) folded on the Flop



PokerStars Game #59941868912:  Hold'em No Limit ($1/$2) - 2009/07/01 1:48:44 ET
Table 'o63a8j70meKHUtgLFryQvg' 9-max Seat #8 is the button
Seat 1: +1R0op5O3Gf6aUPJTw7jjA ($200 in chips)
Seat 2: SgA0Zfa/3yhNp7ILXcXcCg ($68.15 in chips)
Seat 3: IYBKVnE2Basnr88BAhH+bQ ($268.40 in chips)
Seat 4: ZYHoLw2lWmRS7CSHi8L8Xg ($209.90 in chips)
Seat 5: g3ZVTc1EbSNXYYMO82jL7Q ($197 in chips)
Seat 6: CUZwDpLTQKhzarPe+JCLOQ ($200 in chips)
Seat 8: ItDFe9gh5QYPQB9vC4ntUA ($275.75 in chips)
Seat 9: z89zAYE4dlPgjkofBKII0Q ($87.30 in chips)
z89zAYE4dlPgjkofBKII0Q: posts small blind $1
+1R0op5O3Gf6aUPJTw7jjA: posts big blind $2
kM9CA+2UcdMjbCMbtUCGiA: sits out
*** HOLE CARDS ***
SgA0Zfa/3yhNp7ILXcXcCg: folds
IYBKVnE2Basnr88BAhH+bQ: folds
ZYHoLw2lWmRS7CSHi8L8Xg: folds
g3ZVTc1EbSNXYYMO82jL7Q: folds
CUZwDpLTQKhzarPe+JCLOQ: folds
ItDFe9gh5QYPQB9vC4ntUA: raises $4 to $6
z89zAYE4dlPgjkofBKII0Q: folds
+1R0op5O3Gf6aUPJTw7jjA: folds
ItDFe9gh5QYPQB9vC4ntUA collected $5 from pot
*** SUMMARY ***
Total pot $5 | Rake $0
Seat 1: +1R0op5O3Gf6aUPJTw7jjA (big blind) folded before Flop
Seat 2: SgA0Zfa/3yhNp7ILXcXcCg folded before Flop (didn't bet)
Seat 3: IYBKVnE2Basnr88BAhH+bQ folded before Flop (didn't bet)
Seat 4: ZYHoLw2lWmRS7CSHi8L8Xg folded before Flop (didn't bet)
Seat 5: g3ZVTc1EbSNXYYMO82jL7Q folded before Flop (didn't bet)
Seat 6: CUZwDpLTQKhzarPe+JCLOQ folded before Flop (didn't bet)
Seat 8: ItDFe9gh5QYPQB9vC4ntUA (button) collected ($5)
Seat 9: z89zAYE4dlPgjkofBKII0Q (small blind) folded before Flop



PokerStars Game #59941869664:  Hold'em No Limit ($1/$2) - 2009/07/01 1:48:45 ET
Table 'P/yCfYl1GfGsu/e6DxDy/A' 2-max Seat #2 is the button
Seat 1: 7fOCUy3x9hdkmXkkDNolGQ ($554 in chips)
Seat 2: RwDoM55ZeQuI2ADyJhOb2Q ($918 in chips)
RwDoM55ZeQuI2ADyJhOb2Q: posts small blind $1
7fOCUy3x9hdkmXkkDNolGQ: posts big blind $2
*** HOLE CARDS ***
RwDoM55ZeQuI2ADyJhOb2Q: raises $4 to $6
7fOCUy3x9hdkmXkkDNolGQ: raises $16 to $22
RwDoM55ZeQuI2ADyJhOb2Q: folds
7fOCUy3x9hdkmXkkDNolGQ collected $12 from pot
7fOCUy3x9hdkmXkkDNolGQ: doesn't show hand
*** SUMMARY ***
Total pot $12 | Rake $0
Seat 1: 7fOCUy3x9hdkmXkkDNolGQ (big blind) collected ($12)
Seat 2: RwDoM55ZeQuI2ADyJhOb2Q (button) (small blind) folded before Flop



PokerStars Game #59941870084:  Hold'em No Limit ($1/$2) - 2009/07/01 1:48:46 ET
Table '5/wEe6JmtGD7vufSA2RG7A' 2-max Seat #1 is the button
Seat 1: pVqEzK9wXlRMECnb1Zg4Zw ($194 in chips)
Seat 2: aOL8geThaYp2iadSHl1h1g ($145.50 in chips)
pVqEzK9wXlRMECnb1Zg4Zw: posts small blind $1
aOL8geThaYp2iadSHl1h1g: posts big blind $2
*** HOLE CARDS ***
pVqEzK9wXlRMECnb1Zg4Zw: calls $1
aOL8geThaYp2iadSHl1h1g: raises $6 to $8
pVqEzK9wXlRMECnb1Zg4Zw: calls $6
*** FLOP *** [8c Js 3h]
aOL8geThaYp2iadSHl1h1g: bets $14
pVqEzK9wXlRMECnb1Zg4Zw: folds
aOL8geThaYp2iadSHl1h1g collected $15.50 from pot
aOL8geThaYp2iadSHl1h1g: doesn't show hand
*** SUMMARY ***
Total pot $16 | Rake $0.50
Board [8c Js 3h]
Seat 1: pVqEzK9wXlRMECnb1Zg4Zw (button) (small blind) folded on the Flop
Seat 2: aOL8geThaYp2iadSHl1h1g (big blind) collected ($15.50)



PokerStars Game #59941870632:  Hold'em No Limit ($1/$2) - 2009/07/01 1:48:47 ET
Table 'qVXak+oTeDXMGbWa4sDU5Q' 9-max Seat #4 is the button
Seat 1: H6Z4+qu8gR0VUiPOijndVg ($230.45 in chips)
Seat 2: CST1bO+CmVQOtNgiT0cKPg ($142.25 in chips)
Seat 3: WUlHm+ydPPHG7Lb0rePSdA ($177.35 in chips)
Seat 4: lQYT23h5QCUVZAKxjOO39Q ($177.10 in chips)
Seat 7: 6oGEJqk9oDy29sSaLs+LGA ($19.65 in chips)
Seat 8: Z0rzUi0y1x80UdIpofoNbA ($106.55 in chips)
Seat 9: CkE3IyJF1KvdaAOmZY5XqQ ($212.55 in chips)
zJtQ1gxyi72XvGYS1tM+DA will be allowed to play after the button
6oGEJqk9oDy29sSaLs+LGA: posts small blind $1
Z0rzUi0y1x80UdIpofoNbA: posts big blind $2
*** HOLE CARDS ***
CkE3IyJF1KvdaAOmZY5XqQ: folds
H6Z4+qu8gR0VUiPOijndVg: folds
CST1bO+CmVQOtNgiT0cKPg: folds
WUlHm+ydPPHG7Lb0rePSdA: folds
lQYT23h5QCUVZAKxjOO39Q: folds
6oGEJqk9oDy29sSaLs+LGA: folds
Z0rzUi0y1x80UdIpofoNbA collected $2 from pot
Z0rzUi0y1x80UdIpofoNbA: doesn't show hand
*** SUMMARY ***
Total pot $2 | Rake $0
Seat 1: H6Z4+qu8gR0VUiPOijndVg folded before Flop (didn't bet)
Seat 2: CST1bO+CmVQOtNgiT0cKPg folded before Flop (didn't bet)
Seat 3: WUlHm+ydPPHG7Lb0rePSdA folded before Flop (didn't bet)
Seat 4: lQYT23h5QCUVZAKxjOO39Q (button) folded before Flop (didn't bet)
Seat 7: 6oGEJqk9oDy29sSaLs+LGA (small blind) folded before Flop
Seat 8: Z0rzUi0y1x80UdIpofoNbA (big blind) collected ($2)
Seat 9: CkE3IyJF1KvdaAOmZY5XqQ folded before Flop (didn't bet)



PokerStars Game #59941871128:  Hold'em No Limit ($1/$2) - 2009/07/01 1:48:48 ET
Table 'ZzSIe0zTCDv+n6hfbY5tTg' 6-max Seat #1 is the button
Seat 1: VvdR9F3I+2yELkfTVvC1dg ($258.10 in chips)
Seat 2: B87ikIyZ/TzAVeXf38Ny0g ($226 in chips)
Seat 3: gsugPj31Hui3Jefl98MBOA ($365 in chips)
Seat 4: 54yWzRRgS0oZ+S6LwZBxMQ ($46.10 in chips)
Seat 5: 3dAbvkxS5NPQTBAbvpinVg ($490.45 in chips)
Seat 6: 09BNF4quPDzanQzM8vc6WA ($36 in chips)
B87ikIyZ/TzAVeXf38Ny0g: posts small blind $1
gsugPj31Hui3Jefl98MBOA: posts big blind $2
*** HOLE CARDS ***
54yWzRRgS0oZ+S6LwZBxMQ: folds
3dAbvkxS5NPQTBAbvpinVg: raises $4 to $6
09BNF4quPDzanQzM8vc6WA: folds
VvdR9F3I+2yELkfTVvC1dg: calls $6
B87ikIyZ/TzAVeXf38Ny0g: folds
gsugPj31Hui3Jefl98MBOA: folds
*** FLOP *** [5d Jd Jh]
3dAbvkxS5NPQTBAbvpinVg: checks
VvdR9F3I+2yELkfTVvC1dg: checks
*** TURN *** [5d Jd Jh] [7d]
3dAbvkxS5NPQTBAbvpinVg: checks
VvdR9F3I+2yELkfTVvC1dg: checks
*** RIVER *** [5d Jd Jh 7d] [2h]
3dAbvkxS5NPQTBAbvpinVg: checks
VvdR9F3I+2yELkfTVvC1dg: bets $8.10
3dAbvkxS5NPQTBAbvpinVg: folds
VvdR9F3I+2yELkfTVvC1dg collected $14.25 from pot
VvdR9F3I+2yELkfTVvC1dg: doesn't show hand
*** SUMMARY ***
Total pot $15 | Rake $0.75
Board [5d Jd Jh 7d 2h]
Seat 1: VvdR9F3I+2yELkfTVvC1dg (button) collected ($14.25)
Seat 2: B87ikIyZ/TzAVeXf38Ny0g (small blind) folded before Flop
Seat 3: gsugPj31Hui3Jefl98MBOA (big blind) folded before Flop
Seat 4: 54yWzRRgS0oZ+S6LwZBxMQ folded before Flop (didn't bet)
Seat 5: 3dAbvkxS5NPQTBAbvpinVg folded on the River
Seat 6: 09BNF4quPDzanQzM8vc6WA folded before Flop (didn't bet)



PokerStars Game #59941871292:  Hold'em No Limit ($1/$2) - 2009/07/01 1:48:48 ET
Table 'G1Oqdy4Pqdb5gtx40rUBzA' 6-max Seat #5 is the button
Seat 1: 4dMBh/1VTdeUTPCyhCs3UQ ($66.70 in chips)
Seat 2: m7mYVfnCOK5TE/VkN/FhOg ($212.05 in chips)
Seat 3: VvdR9F3I+2yELkfTVvC1dg ($423.90 in chips)
Seat 4: B87ikIyZ/TzAVeXf38Ny0g ($214.70 in chips)
Seat 5: F1+Ml47qRQWunzPnGhLLzQ ($197 in chips)
Seat 6: qCnEYuAE5y5A7bk6fO5/jQ ($200 in chips)
qCnEYuAE5y5A7bk6fO5/jQ: posts small blind $1
4dMBh/1VTdeUTPCyhCs3UQ: posts big blind $2
*** HOLE CARDS ***
m7mYVfnCOK5TE/VkN/FhOg: folds
VvdR9F3I+2yELkfTVvC1dg: raises $2 to $4
B87ikIyZ/TzAVeXf38Ny0g: raises $12 to $16
F1+Ml47qRQWunzPnGhLLzQ: folds
qCnEYuAE5y5A7bk6fO5/jQ: folds
4dMBh/1VTdeUTPCyhCs3UQ: folds
VvdR9F3I+2yELkfTVvC1dg: folds
B87ikIyZ/TzAVeXf38Ny0g collected $11 from pot
B87ikIyZ/TzAVeXf38Ny0g: doesn't show hand
*** SUMMARY ***
Total pot $11 | Rake $0
Seat 1: 4dMBh/1VTdeUTPCyhCs3UQ (big blind) folded before Flop
Seat 2: m7mYVfnCOK5TE/VkN/FhOg folded before Flop (didn't bet)
Seat 3: VvdR9F3I+2yELkfTVvC1dg folded before Flop
Seat 4: B87ikIyZ/TzAVeXf38Ny0g collected ($11)
Seat 5: F1+Ml47qRQWunzPnGhLLzQ (button) folded before Flop (didn't bet)
Seat 6: qCnEYuAE5y5A7bk6fO5/jQ (small blind) folded before Flop



PokerStars Game #59941872052:  Hold'em No Limit ($1/$2) - 2009/07/01 1:48:50 ET
Table 'kq5zaQ+1hLNf8LZfGnbTAA' 6-max Seat #3 is the button
Seat 1: 8srN1dKQePlsv0GyTada+Q ($419.60 in chips)
Seat 2: nXDI8Y/S6POzRwANu3d8hQ ($137 in chips)
Seat 3: /PH6Ffnho4Ysm8S3V/oa+w ($58.15 in chips)
Seat 4: 3dAbvkxS5NPQTBAbvpinVg ($273.65 in chips)
Seat 5: BWhgxe7gWiYobRbwdG+d2Q ($196 in chips)
Seat 6: mfy7uGZcqA2PVQqEVbJ7+g ($194.15 in chips)
3dAbvkxS5NPQTBAbvpinVg: posts small blind $1
BWhgxe7gWiYobRbwdG+d2Q: posts big blind $2
*** HOLE CARDS ***
mfy7uGZcqA2PVQqEVbJ7+g: folds
8srN1dKQePlsv0GyTada+Q: folds
nXDI8Y/S6POzRwANu3d8hQ: raises $6 to $8
/PH6Ffnho4Ysm8S3V/oa+w: folds
3dAbvkxS5NPQTBAbvpinVg: folds
BWhgxe7gWiYobRbwdG+d2Q: folds
nXDI8Y/S6POzRwANu3d8hQ collected $5 from pot
nXDI8Y/S6POzRwANu3d8hQ: doesn't show hand
*** SUMMARY ***
Total pot $5 | Rake $0
Seat 1: 8srN1dKQePlsv0GyTada+Q folded before Flop (didn't bet)
Seat 2: nXDI8Y/S6POzRwANu3d8hQ collected ($5)
Seat 3: /PH6Ffnho4Ysm8S3V/oa+w (button) folded before Flop (didn't bet)
Seat 4: 3dAbvkxS5NPQTBAbvpinVg (small blind) folded before Flop
Seat 5: BWhgxe7gWiYobRbwdG+d2Q (big blind) folded before Flop
Seat 6: mfy7uGZcqA2PVQqEVbJ7+g folded before Flop (didn't bet)



PokerStars Game #59941872002:  Hold'em No Limit ($1/$2) - 2009/07/01 1:48:50 ET
Table '/dyk+YdRGv90j2box35j8w' 6-max Seat #3 is the button
Seat 1: 8srN1dKQePlsv0GyTada+Q ($200 in chips)
Seat 2: qCnEYuAE5y5A7bk6fO5/jQ ($502.20 in chips)
Seat 3: sTPOWERd9HWPCNrDBwsVjA ($200.50 in chips)
Seat 4: 4dMBh/1VTdeUTPCyhCs3UQ ($54.75 in chips)
Seat 5: VvdR9F3I+2yELkfTVvC1dg ($268.80 in chips)
4dMBh/1VTdeUTPCyhCs3UQ: posts small blind $1
VvdR9F3I+2yELkfTVvC1dg: posts big blind $2
*** HOLE CARDS ***
8srN1dKQePlsv0GyTada+Q: folds
qCnEYuAE5y5A7bk6fO5/jQ: folds
sTPOWERd9HWPCNrDBwsVjA: folds
4dMBh/1VTdeUTPCyhCs3UQ: folds
VvdR9F3I+2yELkfTVvC1dg collected $2 from pot
VvdR9F3I+2yELkfTVvC1dg: doesn't show hand
*** SUMMARY ***
Total pot $2 | Rake $0
Seat 1: 8srN1dKQePlsv0GyTada+Q folded before Flop (didn't bet)
Seat 2: qCnEYuAE5y5A7bk6fO5/jQ folded before Flop (didn't bet)
Seat 3: sTPOWERd9HWPCNrDBwsVjA (button) folded before Flop (didn't bet)
Seat 4: 4dMBh/1VTdeUTPCyhCs3UQ (small blind) folded before Flop
Seat 5: VvdR9F3I+2yELkfTVvC1dg (big blind) collected ($2)



PokerStars Game #59941872582:  Hold'em No Limit ($1/$2) - 2009/07/01 1:48:51 ET
Table 'CFkQcfWjKccZaZDf71FK+w' 6-max Seat #2 is the button
Seat 1: vkfxu8f/jMYKUk6Ly4eujw ($224.25 in chips)
Seat 2: ewN/vzF22+/gdzjIKBOlkA ($203.40 in chips)
Seat 5: 2lOU1DcvUZaMcxZ95XfzXw ($139.05 in chips)
Seat 6: ORVqY3rf9X6ANA/8s+On2Q ($42.10 in chips)
2lOU1DcvUZaMcxZ95XfzXw: posts small blind $1
ORVqY3rf9X6ANA/8s+On2Q: posts big blind $2
*** HOLE CARDS ***
vkfxu8f/jMYKUk6Ly4eujw: folds
ewN/vzF22+/gdzjIKBOlkA: folds
2lOU1DcvUZaMcxZ95XfzXw: calls $1
ORVqY3rf9X6ANA/8s+On2Q: checks
*** FLOP *** [Js 2d 9s]
2lOU1DcvUZaMcxZ95XfzXw: checks
ORVqY3rf9X6ANA/8s+On2Q: checks
*** TURN *** [Js 2d 9s] [As]
2lOU1DcvUZaMcxZ95XfzXw: checks
ORVqY3rf9X6ANA/8s+On2Q: checks
*** RIVER *** [Js 2d 9s As] [9h]
2lOU1DcvUZaMcxZ95XfzXw: bets $6
ORVqY3rf9X6ANA/8s+On2Q: calls $6
*** SHOW DOWN ***
2lOU1DcvUZaMcxZ95XfzXw: shows [3c Th] (a pair of Nines)
ORVqY3rf9X6ANA/8s+On2Q: shows [4d Kh] (a pair of Nines - Ace+King kicker)
ORVqY3rf9X6ANA/8s+On2Q collected $15.25 from pot
*** SUMMARY ***
Total pot $16 | Rake $0.75
Board [Js 2d 9s As 9h]
Seat 1: vkfxu8f/jMYKUk6Ly4eujw folded before Flop (didn't bet)
Seat 2: ewN/vzF22+/gdzjIKBOlkA (button) folded before Flop (didn't bet)
Seat 5: 2lOU1DcvUZaMcxZ95XfzXw (small blind) showed [3c Th] and lost with a pair of Nines
Seat 6: ORVqY3rf9X6ANA/8s+On2Q (big blind) showed [4d Kh] and won ($15.25) with a pair of Nines



PokerStars Game #59941872992:  Hold'em No Limit ($1/$2) - 2009/07/01 1:48:52 ET
Table 'ztv6V3FN2bQ9nmJPPdx6nQ' 6-max Seat #2 is the button
Seat 1: 6fLdOUCRtX71xbVRhJEq8w ($300.35 in chips)
Seat 2: 5Y+ZGWLI4gnlpApDX5vy1A ($419.65 in chips)
Seat 4: UaZ5yj+6LjtWqMQg2QskUw ($64.65 in chips)
Seat 5: sTPOWERd9HWPCNrDBwsVjA ($219.60 in chips)
Seat 6: mfy7uGZcqA2PVQqEVbJ7+g ($43.60 in chips)
UaZ5yj+6LjtWqMQg2QskUw: posts small blind $1
sTPOWERd9HWPCNrDBwsVjA: posts big blind $2
*** HOLE CARDS ***
mfy7uGZcqA2PVQqEVbJ7+g: folds
mfy7uGZcqA2PVQqEVbJ7+g said, "thx"
6fLdOUCRtX71xbVRhJEq8w: folds
5Y+ZGWLI4gnlpApDX5vy1A: raises $2 to $4
UaZ5yj+6LjtWqMQg2QskUw: raises $6 to $10
sTPOWERd9HWPCNrDBwsVjA: folds
5Y+ZGWLI4gnlpApDX5vy1A: calls $6
*** FLOP *** [8d Jc Ts]
UaZ5yj+6LjtWqMQg2QskUw: bets $12
5Y+ZGWLI4gnlpApDX5vy1A: folds
UaZ5yj+6LjtWqMQg2QskUw collected $20.90 from pot
*** SUMMARY ***
Total pot $22 | Rake $1.10
Board [8d Jc Ts]
Seat 1: 6fLdOUCRtX71xbVRhJEq8w folded before Flop (didn't bet)
Seat 2: 5Y+ZGWLI4gnlpApDX5vy1A (button) folded on the Flop
Seat 4: UaZ5yj+6LjtWqMQg2QskUw (small blind) collected ($20.90)
Seat 5: sTPOWERd9HWPCNrDBwsVjA (big blind) folded before Flop
Seat 6: mfy7uGZcqA2PVQqEVbJ7+g folded before Flop (didn't bet)



PokerStars Game #59941874774:  Hold'em No Limit ($1/$2) - 2009/07/01 1:48:55 ET
Table 'eyAQSIlgc2o1Jxvbve4WGg' 9-max Seat #2 is the button
Seat 1: UZEsV9yKUMqmpYPiOFpaZw ($75 in chips)
Seat 2: kM9CA+2UcdMjbCMbtUCGiA ($208.60 in chips)
Seat 4: CkE3IyJF1KvdaAOmZY5XqQ ($200 in chips)
Seat 5: mIKx5lhIt13X5eZQH0ZeMA ($135.35 in chips)
Seat 6: nXDI8Y/S6POzRwANu3d8hQ ($67 in chips)
Seat 7: u3OrI5uGx9mx1fE7dgr+EA ($109.75 in chips)
Seat 9: WUlHm+ydPPHG7Lb0rePSdA ($140.20 in chips)
CkE3IyJF1KvdaAOmZY5XqQ: posts small blind $1
mIKx5lhIt13X5eZQH0ZeMA: posts big blind $2
254YPxPJr5Sw58bkD0YqYQ: sits out
*** HOLE CARDS ***
nXDI8Y/S6POzRwANu3d8hQ: folds
u3OrI5uGx9mx1fE7dgr+EA: calls $2
WUlHm+ydPPHG7Lb0rePSdA: folds
UZEsV9yKUMqmpYPiOFpaZw: folds
kM9CA+2UcdMjbCMbtUCGiA: folds
CkE3IyJF1KvdaAOmZY5XqQ: folds
mIKx5lhIt13X5eZQH0ZeMA: raises $2 to $4
u3OrI5uGx9mx1fE7dgr+EA: calls $2
*** FLOP *** [Td 4d Ad]
mIKx5lhIt13X5eZQH0ZeMA: bets $6
u3OrI5uGx9mx1fE7dgr+EA: folds
mIKx5lhIt13X5eZQH0ZeMA collected $8.55 from pot
mIKx5lhIt13X5eZQH0ZeMA: doesn't show hand
*** SUMMARY ***
Total pot $9 | Rake $0.45
Board [Td 4d Ad]
Seat 1: UZEsV9yKUMqmpYPiOFpaZw folded before Flop (didn't bet)
Seat 2: kM9CA+2UcdMjbCMbtUCGiA (button) folded before Flop (didn't bet)
Seat 4: CkE3IyJF1KvdaAOmZY5XqQ (small blind) folded before Flop
Seat 5: mIKx5lhIt13X5eZQH0ZeMA (big blind) collected ($8.55)
Seat 6: nXDI8Y/S6POzRwANu3d8hQ folded before Flop (didn't bet)
Seat 7: u3OrI5uGx9mx1fE7dgr+EA folded on the Flop
Seat 9: WUlHm+ydPPHG7Lb0rePSdA folded before Flop (didn't bet)



PokerStars Game #59941875446:  Hold'em No Limit ($1/$2) - 2009/07/01 1:48:56 ET
Table 'TsEDkiO4tzCTCzJ7tNdEqw' 6-max Seat #6 is the button
Seat 2: 4dcDwIHRm96PwtqkpQiuiA ($77.65 in chips)
Seat 3: ubtx4Z5L+AcK71MTvYiGVw ($203 in chips)
Seat 4: K8MXCrNAVYlMnnCeM32Kxw ($127.55 in chips)
Seat 5: VvdR9F3I+2yELkfTVvC1dg ($246.35 in chips)
Seat 6: uCqEjnxh2/vFBjKYkfTOkw ($287.80 in chips)
4dcDwIHRm96PwtqkpQiuiA: posts small blind $1
ubtx4Z5L+AcK71MTvYiGVw: posts big blind $2
*** HOLE CARDS ***
K8MXCrNAVYlMnnCeM32Kxw: folds
VvdR9F3I+2yELkfTVvC1dg: folds
uCqEjnxh2/vFBjKYkfTOkw: folds
4dcDwIHRm96PwtqkpQiuiA: folds
ubtx4Z5L+AcK71MTvYiGVw collected $2 from pot
ubtx4Z5L+AcK71MTvYiGVw: doesn't show hand
*** SUMMARY ***
Total pot $2 | Rake $0
Seat 2: 4dcDwIHRm96PwtqkpQiuiA (small blind) folded before Flop
Seat 3: ubtx4Z5L+AcK71MTvYiGVw (big blind) collected ($2)
Seat 4: K8MXCrNAVYlMnnCeM32Kxw folded before Flop (didn't bet)
Seat 5: VvdR9F3I+2yELkfTVvC1dg folded before Flop (didn't bet)
Seat 6: uCqEjnxh2/vFBjKYkfTOkw (button) folded before Flop (didn't bet)



PokerStars Game #59941875660:  Hold'em No Limit ($1/$2) - 2009/07/01 1:48:57 ET
Table 'P/yCfYl1GfGsu/e6DxDy/A' 2-max Seat #1 is the button
Seat 1: 7fOCUy3x9hdkmXkkDNolGQ ($560 in chips)
Seat 2: RwDoM55ZeQuI2ADyJhOb2Q ($912 in chips)
7fOCUy3x9hdkmXkkDNolGQ: posts small blind $1
RwDoM55ZeQuI2ADyJhOb2Q: posts big blind $2
*** HOLE CARDS ***
7fOCUy3x9hdkmXkkDNolGQ: raises $4 to $6
RwDoM55ZeQuI2ADyJhOb2Q: calls $4
*** FLOP *** [6d 4c 2c]
RwDoM55ZeQuI2ADyJhOb2Q: bets $8
7fOCUy3x9hdkmXkkDNolGQ: folds
RwDoM55ZeQuI2ADyJhOb2Q collected $11.50 from pot
RwDoM55ZeQuI2ADyJhOb2Q: doesn't show hand
*** SUMMARY ***
Total pot $12 | Rake $0.50
Board [6d 4c 2c]
Seat 1: 7fOCUy3x9hdkmXkkDNolGQ (button) (small blind) folded on the Flop
Seat 2: RwDoM55ZeQuI2ADyJhOb2Q (big blind) collected ($11.50)



PokerStars Game #59941876688:  Hold'em No Limit ($1/$2) - 2009/07/01 1:48:59 ET
Table '+hSnXFQrGw1PlVgTnuj+sA' 6-max Seat #2 is the button
Seat 1: fb8ooqw9ZsZtBsZTZQLNrQ ($54.70 in chips)
Seat 2: 54yWzRRgS0oZ+S6LwZBxMQ ($29.10 in chips)
Seat 3: cupOBdycmBLQKdVftyAksg ($53.10 in chips)
Seat 4: TRSUrOQh3x1NGeD+dH4yoA ($90.70 in chips)
Seat 5: PZzUwZiFNhCLi6Ouh5ZlmQ ($200 in chips)
cupOBdycmBLQKdVftyAksg: posts small blind $1
TRSUrOQh3x1NGeD+dH4yoA: posts big blind $2
*** HOLE CARDS ***
PZzUwZiFNhCLi6Ouh5ZlmQ: folds
fb8ooqw9ZsZtBsZTZQLNrQ: folds
54yWzRRgS0oZ+S6LwZBxMQ: raises $2 to $4
cupOBdycmBLQKdVftyAksg: calls $3
7zM38baFvmCNB/F80oE0cQ has returned
TRSUrOQh3x1NGeD+dH4yoA: calls $2
*** FLOP *** [5s 2h 4h]
cupOBdycmBLQKdVftyAksg: checks
TRSUrOQh3x1NGeD+dH4yoA: bets $6
54yWzRRgS0oZ+S6LwZBxMQ: folds
cupOBdycmBLQKdVftyAksg: folds
TRSUrOQh3x1NGeD+dH4yoA collected $11.40 from pot
TRSUrOQh3x1NGeD+dH4yoA: doesn't show hand
*** SUMMARY ***
Total pot $12 | Rake $0.60
Board [5s 2h 4h]
Seat 1: fb8ooqw9ZsZtBsZTZQLNrQ folded before Flop (didn't bet)
Seat 2: 54yWzRRgS0oZ+S6LwZBxMQ (button) folded on the Flop
Seat 3: cupOBdycmBLQKdVftyAksg (small blind) folded on the Flop
Seat 4: TRSUrOQh3x1NGeD+dH4yoA (big blind) collected ($11.40)
Seat 5: PZzUwZiFNhCLi6Ouh5ZlmQ folded before Flop (didn't bet)



PokerStars Game #59941877172:  Hold'em No Limit ($1/$2) - 2009/07/01 1:49:00 ET
Table 'QxerF7GUfCbl+4a8XaTB2w' 6-max Seat #2 is the button
Seat 1: ZwvXzkkZ3XpMhKfAmVpahw ($273.75 in chips)
Seat 2: 6UGgYbxwWNc+ohObe8vB9w ($39.75 in chips)
Seat 3: 8rZGabKe2DEPdZCbCivZ9Q ($28 in chips)
Seat 4: /PH6Ffnho4Ysm8S3V/oa+w ($53 in chips)
Seat 6: VvdR9F3I+2yELkfTVvC1dg ($213.70 in chips)
8rZGabKe2DEPdZCbCivZ9Q: posts small blind $1
/PH6Ffnho4Ysm8S3V/oa+w: posts big blind $2
vkfxu8f/jMYKUk6Ly4eujw: sits out
*** HOLE CARDS ***
VvdR9F3I+2yELkfTVvC1dg: folds
ZwvXzkkZ3XpMhKfAmVpahw: folds
6UGgYbxwWNc+ohObe8vB9w: folds
8rZGabKe2DEPdZCbCivZ9Q: folds
/PH6Ffnho4Ysm8S3V/oa+w collected $2 from pot
/PH6Ffnho4Ysm8S3V/oa+w: doesn't show hand
*** SUMMARY ***
Total pot $2 | Rake $0
Seat 1: ZwvXzkkZ3XpMhKfAmVpahw folded before Flop (didn't bet)
Seat 2: 6UGgYbxwWNc+ohObe8vB9w (button) folded before Flop (didn't bet)
Seat 3: 8rZGabKe2DEPdZCbCivZ9Q (small blind) folded before Flop
Seat 4: /PH6Ffnho4Ysm8S3V/oa+w (big blind) collected ($2)
Seat 6: VvdR9F3I+2yELkfTVvC1dg folded before Flop (didn't bet)



PokerStars Game #59941878278:  Hold'em No Limit ($1/$2) - 2009/07/01 1:49:02 ET
Table 'jlrIxbrVIG+gjaUYT4za8g' 6-max Seat #5 is the button
Seat 2: cwfuMyvDC7J7SqX2leDC8g ($46 in chips)
Seat 4: 8srN1dKQePlsv0GyTada+Q ($260.70 in chips)
Seat 5: AyBB0k3Dcl7xbXUeGMw06g ($54.75 in chips)
Seat 6: BWhgxe7gWiYobRbwdG+d2Q ($196 in chips)
BWhgxe7gWiYobRbwdG+d2Q: posts small blind $1
cwfuMyvDC7J7SqX2leDC8g: posts big blind $2
*** HOLE CARDS ***
8srN1dKQePlsv0GyTada+Q: folds
AyBB0k3Dcl7xbXUeGMw06g: folds
BWhgxe7gWiYobRbwdG+d2Q: folds
cwfuMyvDC7J7SqX2leDC8g collected $2 from pot
*** SUMMARY ***
Total pot $2 | Rake $0
Seat 2: cwfuMyvDC7J7SqX2leDC8g (big blind) collected ($2)
Seat 4: 8srN1dKQePlsv0GyTada+Q folded before Flop (didn't bet)
Seat 5: AyBB0k3Dcl7xbXUeGMw06g (button) folded before Flop (didn't bet)
Seat 6: BWhgxe7gWiYobRbwdG+d2Q (small blind) folded before Flop



PokerStars Game #59941879404:  Hold'em No Limit ($1/$2) - 2009/07/01 1:49:04 ET
Table 'UGLAZZyv+cXmnKjYin0etA' 6-max Seat #4 is the button
Seat 2: eDLH1PUXFpvJBNMXBVQcGA ($304.10 in chips)
Seat 4: SiGJDsvRViJX05vHhA80GQ ($234.85 in chips)
Seat 5: 54yWzRRgS0oZ+S6LwZBxMQ ($38.80 in chips)
Seat 6: sTPOWERd9HWPCNrDBwsVjA ($218.95 in chips)
54yWzRRgS0oZ+S6LwZBxMQ: posts small blind $1
sTPOWERd9HWPCNrDBwsVjA: posts big blind $2
*** HOLE CARDS ***
eDLH1PUXFpvJBNMXBVQcGA: folds
SiGJDsvRViJX05vHhA80GQ: raises $3 to $5
54yWzRRgS0oZ+S6LwZBxMQ: folds
sTPOWERd9HWPCNrDBwsVjA: calls $3
*** FLOP *** [6h 7s Kd]
PaPaDoC719 joins the table at seat #1
sTPOWERd9HWPCNrDBwsVjA: checks
PaPaDoC719 is sitting out
PaPaDoC719 leaves the table
SiGJDsvRViJX05vHhA80GQ: bets $10
sTPOWERd9HWPCNrDBwsVjA: folds
SiGJDsvRViJX05vHhA80GQ collected $10.45 from pot
*** SUMMARY ***
Total pot $11 | Rake $0.55
Board [6h 7s Kd]
Seat 2: eDLH1PUXFpvJBNMXBVQcGA folded before Flop (didn't bet)
Seat 4: SiGJDsvRViJX05vHhA80GQ (button) collected ($10.45)
Seat 5: 54yWzRRgS0oZ+S6LwZBxMQ (small blind) folded before Flop
Seat 6: sTPOWERd9HWPCNrDBwsVjA (big blind) folded on the Flop



PokerStars Game #59941879820:  Hold'em No Limit ($1/$2) - 2009/07/01 1:49:05 ET
Table 'qVXak+oTeDXMGbWa4sDU5Q' 9-max Seat #7 is the button
Seat 1: H6Z4+qu8gR0VUiPOijndVg ($230.45 in chips)
Seat 2: CST1bO+CmVQOtNgiT0cKPg ($142.25 in chips)
Seat 3: WUlHm+ydPPHG7Lb0rePSdA ($177.35 in chips)
Seat 4: lQYT23h5QCUVZAKxjOO39Q ($177.10 in chips)
Seat 7: 6oGEJqk9oDy29sSaLs+LGA ($18.65 in chips)
Seat 8: Z0rzUi0y1x80UdIpofoNbA ($107.55 in chips)
Seat 9: CkE3IyJF1KvdaAOmZY5XqQ ($212.55 in chips)
Z0rzUi0y1x80UdIpofoNbA: posts small blind $1
CkE3IyJF1KvdaAOmZY5XqQ: posts big blind $2
zJtQ1gxyi72XvGYS1tM+DA: sits out
*** HOLE CARDS ***
H6Z4+qu8gR0VUiPOijndVg: folds
CST1bO+CmVQOtNgiT0cKPg: folds
WUlHm+ydPPHG7Lb0rePSdA: folds
lQYT23h5QCUVZAKxjOO39Q: folds
6oGEJqk9oDy29sSaLs+LGA: folds
Z0rzUi0y1x80UdIpofoNbA: raises $2 to $4
CkE3IyJF1KvdaAOmZY5XqQ: calls $2
*** FLOP *** [Js 3c Jh]
Z0rzUi0y1x80UdIpofoNbA: bets $4
CkE3IyJF1KvdaAOmZY5XqQ: folds
Z0rzUi0y1x80UdIpofoNbA collected $7.60 from pot
Z0rzUi0y1x80UdIpofoNbA: doesn't show hand
*** SUMMARY ***
Total pot $8 | Rake $0.40
Board [Js 3c Jh]
Seat 1: H6Z4+qu8gR0VUiPOijndVg folded before Flop (didn't bet)
Seat 2: CST1bO+CmVQOtNgiT0cKPg folded before Flop (didn't bet)
Seat 3: WUlHm+ydPPHG7Lb0rePSdA folded before Flop (didn't bet)
Seat 4: lQYT23h5QCUVZAKxjOO39Q folded before Flop (didn't bet)
Seat 7: 6oGEJqk9oDy29sSaLs+LGA (button) folded before Flop (didn't bet)
Seat 8: Z0rzUi0y1x80UdIpofoNbA (small blind) collected ($7.60)
Seat 9: CkE3IyJF1KvdaAOmZY5XqQ (big blind) folded on the Flop



PokerStars Game #59941880332:  Hold'em No Limit ($1/$2) - 2009/07/01 1:49:06 ET
Table '5/wEe6JmtGD7vufSA2RG7A' 2-max Seat #2 is the button
Seat 1: pVqEzK9wXlRMECnb1Zg4Zw ($186 in chips)
Seat 2: aOL8geThaYp2iadSHl1h1g ($153 in chips)
aOL8geThaYp2iadSHl1h1g: posts small blind $1
pVqEzK9wXlRMECnb1Zg4Zw: posts big blind $2
*** HOLE CARDS ***
aOL8geThaYp2iadSHl1h1g: folds
pVqEzK9wXlRMECnb1Zg4Zw collected $2 from pot
pVqEzK9wXlRMECnb1Zg4Zw: doesn't show hand
*** SUMMARY ***
Total pot $2 | Rake $0
Seat 1: pVqEzK9wXlRMECnb1Zg4Zw (big blind) collected ($2)
Seat 2: aOL8geThaYp2iadSHl1h1g (button) (small blind) folded before Flop



PokerStars Game #59941880276:  Hold'em No Limit ($1/$2) - 2009/07/01 1:49:06 ET
Table '/dyk+YdRGv90j2box35j8w' 6-max Seat #4 is the button
Seat 1: 8srN1dKQePlsv0GyTada+Q ($200 in chips)
Seat 2: qCnEYuAE5y5A7bk6fO5/jQ ($502.20 in chips)
Seat 3: sTPOWERd9HWPCNrDBwsVjA ($200.50 in chips)
Seat 4: 4dMBh/1VTdeUTPCyhCs3UQ ($53.75 in chips)
Seat 5: VvdR9F3I+2yELkfTVvC1dg ($269.80 in chips)
VvdR9F3I+2yELkfTVvC1dg: posts small blind $1
8srN1dKQePlsv0GyTada+Q: posts big blind $2
*** HOLE CARDS ***
qCnEYuAE5y5A7bk6fO5/jQ: folds
sTPOWERd9HWPCNrDBwsVjA: folds
4dMBh/1VTdeUTPCyhCs3UQ: raises $5 to $7
VvdR9F3I+2yELkfTVvC1dg: raises $15 to $22
8srN1dKQePlsv0GyTada+Q: folds
4dMBh/1VTdeUTPCyhCs3UQ: calls $15
*** FLOP *** [Ks 4d 5d]
VvdR9F3I+2yELkfTVvC1dg: bets $33
4dMBh/1VTdeUTPCyhCs3UQ: folds
VvdR9F3I+2yELkfTVvC1dg collected $44 from pot
VvdR9F3I+2yELkfTVvC1dg: doesn't show hand
*** SUMMARY ***
Total pot $46 | Rake $2
Board [Ks 4d 5d]
Seat 1: 8srN1dKQePlsv0GyTada+Q (big blind) folded before Flop
Seat 2: qCnEYuAE5y5A7bk6fO5/jQ folded before Flop (didn't bet)
Seat 3: sTPOWERd9HWPCNrDBwsVjA folded before Flop (didn't bet)
Seat 4: 4dMBh/1VTdeUTPCyhCs3UQ (button) folded on the Flop
Seat 5: VvdR9F3I+2yELkfTVvC1dg (small blind) collected ($44)



PokerStars Game #59941881280:  Hold'em No Limit ($1/$2) - 2009/07/01 1:49:08 ET
Table 'NmY84NAf9Mh0ckAckHnh5g' 2-max Seat #2 is the button
Seat 1: 6hvg964TSqZ3AL/0XK9aVQ ($621.75 in chips)
Seat 2: RwDoM55ZeQuI2ADyJhOb2Q ($362.55 in chips)
RwDoM55ZeQuI2ADyJhOb2Q: posts small blind $1
6hvg964TSqZ3AL/0XK9aVQ: posts big blind $2
*** HOLE CARDS ***
RwDoM55ZeQuI2ADyJhOb2Q: raises $4 to $6
6hvg964TSqZ3AL/0XK9aVQ: folds
RwDoM55ZeQuI2ADyJhOb2Q collected $4 from pot
RwDoM55ZeQuI2ADyJhOb2Q: doesn't show hand
*** SUMMARY ***
Total pot $4 | Rake $0
Seat 1: 6hvg964TSqZ3AL/0XK9aVQ (big blind) folded before Flop
Seat 2: RwDoM55ZeQuI2ADyJhOb2Q (button) (small blind) collected ($4)



PokerStars Game #59941881906:  Hold'em No Limit ($1/$2) - 2009/07/01 1:49:09 ET
Table 'bJQ024BaYSBrW0sXpCZbNQ' 6-max Seat #5 is the button
Seat 1: KfwW5us6tydK81NYTtK1gw ($210.75 in chips)
Seat 2: 3dAbvkxS5NPQTBAbvpinVg ($267 in chips)
Seat 4: vkfxu8f/jMYKUk6Ly4eujw ($227.05 in chips)
Seat 5: VvdR9F3I+2yELkfTVvC1dg ($200 in chips)
Seat 6: 4bqvCfJ0e8CTYnn0Go9hbQ ($136.70 in chips)
4bqvCfJ0e8CTYnn0Go9hbQ: posts small blind $1
KfwW5us6tydK81NYTtK1gw: posts big blind $2
*** HOLE CARDS ***
3dAbvkxS5NPQTBAbvpinVg: folds
vkfxu8f/jMYKUk6Ly4eujw: folds
VvdR9F3I+2yELkfTVvC1dg: folds
4bqvCfJ0e8CTYnn0Go9hbQ: calls $1
KfwW5us6tydK81NYTtK1gw: checks
*** FLOP *** [Kd 4c Qd]
4bqvCfJ0e8CTYnn0Go9hbQ: checks
KfwW5us6tydK81NYTtK1gw: checks
*** TURN *** [Kd 4c Qd] [3s]
4bqvCfJ0e8CTYnn0Go9hbQ: bets $4
KfwW5us6tydK81NYTtK1gw: folds
4bqvCfJ0e8CTYnn0Go9hbQ collected $3.80 from pot
4bqvCfJ0e8CTYnn0Go9hbQ: doesn't show hand
*** SUMMARY ***
Total pot $4 | Rake $0.20
Board [Kd 4c Qd 3s]
Seat 1: KfwW5us6tydK81NYTtK1gw (big blind) folded on the Turn
Seat 2: 3dAbvkxS5NPQTBAbvpinVg folded before Flop (didn't bet)
Seat 4: vkfxu8f/jMYKUk6Ly4eujw folded before Flop (didn't bet)
Seat 5: VvdR9F3I+2yELkfTVvC1dg (button) folded before Flop (didn't bet)
Seat 6: 4bqvCfJ0e8CTYnn0Go9hbQ (small blind) collected ($3.80)



PokerStars Game #59941882570:  Hold'em No Limit ($1/$2) - 2009/07/01 1:49:10 ET
Table '4NGNnZ/osQfNq6abYqkJeA' 6-max Seat #3 is the button
Seat 2: 669iGNwYwgRZg3nhS+aDAQ ($123.25 in chips)
Seat 3: 54yWzRRgS0oZ+S6LwZBxMQ ($40.65 in chips)
Seat 4: sY+4Uuh5z/6AbXXaCS10jw ($304.10 in chips)
Seat 5: VvdR9F3I+2yELkfTVvC1dg ($231.80 in chips)
Seat 6: /PH6Ffnho4Ysm8S3V/oa+w ($40 in chips)
sY+4Uuh5z/6AbXXaCS10jw: posts small blind $1
VvdR9F3I+2yELkfTVvC1dg: posts big blind $2
*** HOLE CARDS ***
/PH6Ffnho4Ysm8S3V/oa+w: folds
669iGNwYwgRZg3nhS+aDAQ: folds
54yWzRRgS0oZ+S6LwZBxMQ: folds
sY+4Uuh5z/6AbXXaCS10jw: raises $4 to $6
VvdR9F3I+2yELkfTVvC1dg: folds
sY+4Uuh5z/6AbXXaCS10jw collected $4 from pot
*** SUMMARY ***
Total pot $4 | Rake $0
Seat 2: 669iGNwYwgRZg3nhS+aDAQ folded before Flop (didn't bet)
Seat 3: 54yWzRRgS0oZ+S6LwZBxMQ (button) folded before Flop (didn't bet)
Seat 4: sY+4Uuh5z/6AbXXaCS10jw (small blind) collected ($4)
Seat 5: VvdR9F3I+2yELkfTVvC1dg (big blind) folded before Flop
Seat 6: /PH6Ffnho4Ysm8S3V/oa+w folded before Flop (didn't bet)



PokerStars Game #59941882276:  Hold'em No Limit ($1/$2) - 2009/07/01 1:49:10 ET
Table 'BSRfGh+QobUe0AgIMtt/fw' 9-max Seat #2 is the button
Seat 1: gDn/rYeNwCyWEgRhyWp4PA ($159.05 in chips)
Seat 2: +SmnXtdmwqXGEJfLeJDIUQ ($123.90 in chips)
Seat 3: WUlHm+ydPPHG7Lb0rePSdA ($120 in chips)
Seat 4: +T/63sAeZzWyHchahJ36GQ ($34 in chips)
Seat 5: v0q3vrz/d9oDjLrAG8Ausw ($244.75 in chips)
Seat 6: H6Z4+qu8gR0VUiPOijndVg ($200 in chips)
Seat 7: CkE3IyJF1KvdaAOmZY5XqQ ($200 in chips)
Seat 8: GG5lTuGt3+kwNYSbqeB6yw ($80.85 in chips)
WUlHm+ydPPHG7Lb0rePSdA: posts small blind $1
+T/63sAeZzWyHchahJ36GQ: posts big blind $2
GG5lTuGt3+kwNYSbqeB6yw: posts big blind $2
tjgwwDmi+N2H4I7hx8useQ: sits out
*** HOLE CARDS ***
v0q3vrz/d9oDjLrAG8Ausw: folds
H6Z4+qu8gR0VUiPOijndVg: raises $8 to $10
CkE3IyJF1KvdaAOmZY5XqQ: folds
v0q3vrz/d9oDjLrAG8Ausw leaves the table
GG5lTuGt3+kwNYSbqeB6yw: folds
gDn/rYeNwCyWEgRhyWp4PA: folds
+SmnXtdmwqXGEJfLeJDIUQ: folds
WUlHm+ydPPHG7Lb0rePSdA: folds
ThVDqrMpsvd7Ax6KINfuew joins the table at seat #5
+T/63sAeZzWyHchahJ36GQ: folds
H6Z4+qu8gR0VUiPOijndVg collected $7 from pot
*** SUMMARY ***
Total pot $7 | Rake $0
Seat 1: gDn/rYeNwCyWEgRhyWp4PA folded before Flop (didn't bet)
Seat 2: +SmnXtdmwqXGEJfLeJDIUQ (button) folded before Flop (didn't bet)
Seat 3: WUlHm+ydPPHG7Lb0rePSdA (small blind) folded before Flop
Seat 4: +T/63sAeZzWyHchahJ36GQ (big blind) folded before Flop
Seat 5: v0q3vrz/d9oDjLrAG8Ausw folded before Flop (didn't bet)
Seat 6: H6Z4+qu8gR0VUiPOijndVg collected ($7)
Seat 7: CkE3IyJF1KvdaAOmZY5XqQ folded before Flop (didn't bet)
Seat 8: GG5lTuGt3+kwNYSbqeB6yw folded before Flop



PokerStars Game #59941882762:  Hold'em No Limit ($1/$2) - 2009/07/01 1:49:10 ET
Table 'WCA60bDA8ecovUgFSIZkTQ' 9-max Seat #5 is the button
Seat 1: 3RFwE6igZ1BGKOGuab6iiw ($62 in chips)
Seat 2: TAfo4veNRaRlzDXMMYS3Jg ($37 in chips)
Seat 3: g7gL2NLJCdZPPV399WKT1w ($50.65 in chips)
Seat 4: IYBKVnE2Basnr88BAhH+bQ ($202.80 in chips)
Seat 5: A+9gcmwAl0eFxxbAwRY1OA ($269.10 in chips)
Seat 7: tsTv4D+ne2W0qhUt9HlcMw ($195 in chips)
Seat 8: mJhwEVg7F695DiO+RIhM5g ($236.05 in chips)
tsTv4D+ne2W0qhUt9HlcMw: posts small blind $1
mJhwEVg7F695DiO+RIhM5g: posts big blind $2
ItDFe9gh5QYPQB9vC4ntUA: sits out
*** HOLE CARDS ***
3RFwE6igZ1BGKOGuab6iiw: calls $2
TAfo4veNRaRlzDXMMYS3Jg: folds
g7gL2NLJCdZPPV399WKT1w: folds
IYBKVnE2Basnr88BAhH+bQ: folds
A+9gcmwAl0eFxxbAwRY1OA: folds
tsTv4D+ne2W0qhUt9HlcMw: calls $1
mJhwEVg7F695DiO+RIhM5g: checks
*** FLOP *** [4d 2d Kh]
YoKKKdDDs7gFzP1Z65Sdaw joins the table at seat #6
tsTv4D+ne2W0qhUt9HlcMw: checks
mJhwEVg7F695DiO+RIhM5g: checks
3RFwE6igZ1BGKOGuab6iiw: bets $4
tsTv4D+ne2W0qhUt9HlcMw: folds
mJhwEVg7F695DiO+RIhM5g: folds
3RFwE6igZ1BGKOGuab6iiw collected $5.70 from pot
*** SUMMARY ***
Total pot $6 | Rake $0.30
Board [4d 2d Kh]
Seat 1: 3RFwE6igZ1BGKOGuab6iiw collected ($5.70)
Seat 2: TAfo4veNRaRlzDXMMYS3Jg folded before Flop (didn't bet)
Seat 3: g7gL2NLJCdZPPV399WKT1w folded before Flop (didn't bet)
Seat 4: IYBKVnE2Basnr88BAhH+bQ folded before Flop (didn't bet)
Seat 5: A+9gcmwAl0eFxxbAwRY1OA (button) folded before Flop (didn't bet)
Seat 7: tsTv4D+ne2W0qhUt9HlcMw (small blind) folded on the Flop
Seat 8: mJhwEVg7F695DiO+RIhM5g (big blind) folded on the Flop



PokerStars Game #59941883018:  Hold'em No Limit ($1/$2) - 2009/07/01 1:49:11 ET
Table 'kq5zaQ+1hLNf8LZfGnbTAA' 6-max Seat #4 is the button
Seat 1: 8srN1dKQePlsv0GyTada+Q ($419.60 in chips)
Seat 2: nXDI8Y/S6POzRwANu3d8hQ ($140 in chips)
Seat 3: /PH6Ffnho4Ysm8S3V/oa+w ($58.15 in chips)
Seat 4: 3dAbvkxS5NPQTBAbvpinVg ($272.65 in chips)
Seat 5: BWhgxe7gWiYobRbwdG+d2Q ($196 in chips)
Seat 6: mfy7uGZcqA2PVQqEVbJ7+g ($194.15 in chips)
BWhgxe7gWiYobRbwdG+d2Q: posts small blind $1
mfy7uGZcqA2PVQqEVbJ7+g: posts big blind $2
*** HOLE CARDS ***
8srN1dKQePlsv0GyTada+Q: folds
nXDI8Y/S6POzRwANu3d8hQ: raises $6 to $8
/PH6Ffnho4Ysm8S3V/oa+w: folds
3dAbvkxS5NPQTBAbvpinVg: folds
BWhgxe7gWiYobRbwdG+d2Q: folds
mfy7uGZcqA2PVQqEVbJ7+g: folds
nXDI8Y/S6POzRwANu3d8hQ collected $5 from pot
nXDI8Y/S6POzRwANu3d8hQ: doesn't show hand
*** SUMMARY ***
Total pot $5 | Rake $0
Seat 1: 8srN1dKQePlsv0GyTada+Q folded before Flop (didn't bet)
Seat 2: nXDI8Y/S6POzRwANu3d8hQ collected ($5)
Seat 3: /PH6Ffnho4Ysm8S3V/oa+w folded before Flop (didn't bet)
Seat 4: 3dAbvkxS5NPQTBAbvpinVg (button) folded before Flop (didn't bet)
Seat 5: BWhgxe7gWiYobRbwdG+d2Q (small blind) folded before Flop
Seat 6: mfy7uGZcqA2PVQqEVbJ7+g (big blind) folded before Flop



PokerStars Game #59941883698:  Hold'em No Limit ($1/$2) - 2009/07/01 1:49:12 ET
Table 'mGpP9StWRnoeiBDExc6Frg' 6-max Seat #6 is the button
Seat 1: VvdR9F3I+2yELkfTVvC1dg ($312.85 in chips)
Seat 2: 6hRJ68JkbJq6MYI9o5bUnQ ($103 in chips)
Seat 4: 4dcDwIHRm96PwtqkpQiuiA ($91.70 in chips)
Seat 5: d1puGuVBE0fidn+5eRJ0tw ($186.55 in chips)
Seat 6: B2Ih1sr5VZk+8He7rcrMtQ ($402.45 in chips)
VvdR9F3I+2yELkfTVvC1dg: posts small blind $1
6hRJ68JkbJq6MYI9o5bUnQ: posts big blind $2
*** HOLE CARDS ***
4dcDwIHRm96PwtqkpQiuiA: folds
d1puGuVBE0fidn+5eRJ0tw: folds
B2Ih1sr5VZk+8He7rcrMtQ: folds
VvdR9F3I+2yELkfTVvC1dg: folds
6hRJ68JkbJq6MYI9o5bUnQ collected $2 from pot
*** SUMMARY ***
Total pot $2 | Rake $0
Seat 1: VvdR9F3I+2yELkfTVvC1dg (small blind) folded before Flop
Seat 2: 6hRJ68JkbJq6MYI9o5bUnQ (big blind) collected ($2)
Seat 4: 4dcDwIHRm96PwtqkpQiuiA folded before Flop (didn't bet)
Seat 5: d1puGuVBE0fidn+5eRJ0tw folded before Flop (didn't bet)
Seat 6: B2Ih1sr5VZk+8He7rcrMtQ (button) folded before Flop (didn't bet)



PokerStars Game #59941883636:  Hold'em No Limit ($1/$2) - 2009/07/01 1:49:12 ET
Table 'C4lkCXY2PWy6z4vsAe5NGQ' 6-max Seat #6 is the button
Seat 2: 6hRJ68JkbJq6MYI9o5bUnQ ($74.95 in chips)
Seat 3: sTPOWERd9HWPCNrDBwsVjA ($133.80 in chips)
Seat 4: VvdR9F3I+2yELkfTVvC1dg ($207 in chips)
Seat 5: /PH6Ffnho4Ysm8S3V/oa+w ($56.15 in chips)
Seat 6: B87ikIyZ/TzAVeXf38Ny0g ($707.20 in chips)
6hRJ68JkbJq6MYI9o5bUnQ: posts small blind $1
sTPOWERd9HWPCNrDBwsVjA: posts big blind $2
*** HOLE CARDS ***
VvdR9F3I+2yELkfTVvC1dg: folds
/PH6Ffnho4Ysm8S3V/oa+w: folds
B87ikIyZ/TzAVeXf38Ny0g: raises $4 to $6
6hRJ68JkbJq6MYI9o5bUnQ: calls $5
sTPOWERd9HWPCNrDBwsVjA: folds
*** FLOP *** [5s 7d Tc]
6hRJ68JkbJq6MYI9o5bUnQ: checks
B87ikIyZ/TzAVeXf38Ny0g: checks
*** TURN *** [5s 7d Tc] [Th]
6hRJ68JkbJq6MYI9o5bUnQ: checks
B87ikIyZ/TzAVeXf38Ny0g: checks
*** RIVER *** [5s 7d Tc Th] [Kc]
6hRJ68JkbJq6MYI9o5bUnQ: checks
B87ikIyZ/TzAVeXf38Ny0g: bets $8
6hRJ68JkbJq6MYI9o5bUnQ: calls $8
*** SHOW DOWN ***
B87ikIyZ/TzAVeXf38Ny0g: shows [Ac Ks] (two pair, Kings and Tens)
6hRJ68JkbJq6MYI9o5bUnQ: mucks hand
B87ikIyZ/TzAVeXf38Ny0g collected $28.55 from pot
*** SUMMARY ***
Total pot $30 | Rake $1.45
Board [5s 7d Tc Th Kc]
Seat 2: 6hRJ68JkbJq6MYI9o5bUnQ (small blind) mucked
Seat 3: sTPOWERd9HWPCNrDBwsVjA (big blind) folded before Flop
Seat 4: VvdR9F3I+2yELkfTVvC1dg folded before Flop (didn't bet)
Seat 5: /PH6Ffnho4Ysm8S3V/oa+w folded before Flop (didn't bet)
Seat 6: B87ikIyZ/TzAVeXf38Ny0g (button) showed [Ac Ks] and won ($28.55) with two pair, Kings and Tens



PokerStars Game #59941883950:  Hold'em No Limit ($1/$2) - 2009/07/01 1:49:13 ET
Table '5/wEe6JmtGD7vufSA2RG7A' 2-max Seat #1 is the button
Seat 1: pVqEzK9wXlRMECnb1Zg4Zw ($187 in chips)
Seat 2: aOL8geThaYp2iadSHl1h1g ($200 in chips)
pVqEzK9wXlRMECnb1Zg4Zw: posts small blind $1
aOL8geThaYp2iadSHl1h1g: posts big blind $2
*** HOLE CARDS ***
pVqEzK9wXlRMECnb1Zg4Zw: calls $1
aOL8geThaYp2iadSHl1h1g: checks
*** FLOP *** [9h 5h 6h]
aOL8geThaYp2iadSHl1h1g: checks
pVqEzK9wXlRMECnb1Zg4Zw: bets $6
aOL8geThaYp2iadSHl1h1g: folds
pVqEzK9wXlRMECnb1Zg4Zw collected $3.80 from pot
pVqEzK9wXlRMECnb1Zg4Zw: doesn't show hand
*** SUMMARY ***
Total pot $4 | Rake $0.20
Board [9h 5h 6h]
Seat 1: pVqEzK9wXlRMECnb1Zg4Zw (button) (small blind) collected ($3.80)
Seat 2: aOL8geThaYp2iadSHl1h1g (big blind) folded on the Flop



PokerStars Game #59941885178:  Hold'em No Limit ($1/$2) - 2009/07/01 1:49:15 ET
Table 'NmY84NAf9Mh0ckAckHnh5g' 2-max Seat #1 is the button
Seat 1: 6hvg964TSqZ3AL/0XK9aVQ ($619.75 in chips)
Seat 2: RwDoM55ZeQuI2ADyJhOb2Q ($364.55 in chips)
6hvg964TSqZ3AL/0XK9aVQ: posts small blind $1
RwDoM55ZeQuI2ADyJhOb2Q: posts big blind $2
*** HOLE CARDS ***
6hvg964TSqZ3AL/0XK9aVQ: calls $1
RwDoM55ZeQuI2ADyJhOb2Q: checks
*** FLOP *** [6h Kh 4s]
RwDoM55ZeQuI2ADyJhOb2Q: checks
6hvg964TSqZ3AL/0XK9aVQ: checks
*** TURN *** [6h Kh 4s] [2d]
RwDoM55ZeQuI2ADyJhOb2Q: checks
6hvg964TSqZ3AL/0XK9aVQ: bets $6
RwDoM55ZeQuI2ADyJhOb2Q: folds
6hvg964TSqZ3AL/0XK9aVQ collected $3.80 from pot
6hvg964TSqZ3AL/0XK9aVQ: doesn't show hand
*** SUMMARY ***
Total pot $4 | Rake $0.20
Board [6h Kh 4s 2d]
Seat 1: 6hvg964TSqZ3AL/0XK9aVQ (button) (small blind) collected ($3.80)
Seat 2: RwDoM55ZeQuI2ADyJhOb2Q (big blind) folded on the Turn



PokerStars Game #59941885812:  Hold'em No Limit ($1/$2) - 2009/07/01 1:49:16 ET
Table 'o63a8j70meKHUtgLFryQvg' 9-max Seat #9 is the button
Seat 1: +1R0op5O3Gf6aUPJTw7jjA ($198 in chips)
Seat 2: SgA0Zfa/3yhNp7ILXcXcCg ($68.15 in chips)
Seat 3: IYBKVnE2Basnr88BAhH+bQ ($268.40 in chips)
Seat 4: ZYHoLw2lWmRS7CSHi8L8Xg ($209.90 in chips)
Seat 5: g3ZVTc1EbSNXYYMO82jL7Q ($197 in chips)
Seat 6: CUZwDpLTQKhzarPe+JCLOQ ($200 in chips)
Seat 8: ItDFe9gh5QYPQB9vC4ntUA ($278.75 in chips)
Seat 9: z89zAYE4dlPgjkofBKII0Q ($86.30 in chips)
+1R0op5O3Gf6aUPJTw7jjA: posts small blind $1
SgA0Zfa/3yhNp7ILXcXcCg: posts big blind $2
kM9CA+2UcdMjbCMbtUCGiA: sits out
*** HOLE CARDS ***
IYBKVnE2Basnr88BAhH+bQ: folds
ZYHoLw2lWmRS7CSHi8L8Xg: folds
g3ZVTc1EbSNXYYMO82jL7Q: folds
CUZwDpLTQKhzarPe+JCLOQ: folds
ItDFe9gh5QYPQB9vC4ntUA: folds
z89zAYE4dlPgjkofBKII0Q: folds
+1R0op5O3Gf6aUPJTw7jjA: folds
SgA0Zfa/3yhNp7ILXcXcCg collected $2 from pot
SgA0Zfa/3yhNp7ILXcXcCg: doesn't show hand
*** SUMMARY ***
Total pot $2 | Rake $0
Seat 1: +1R0op5O3Gf6aUPJTw7jjA (small blind) folded before Flop
Seat 2: SgA0Zfa/3yhNp7ILXcXcCg (big blind) collected ($2)
Seat 3: IYBKVnE2Basnr88BAhH+bQ folded before Flop (didn't bet)
Seat 4: ZYHoLw2lWmRS7CSHi8L8Xg folded before Flop (didn't bet)
Seat 5: g3ZVTc1EbSNXYYMO82jL7Q folded before Flop (didn't bet)
Seat 6: CUZwDpLTQKhzarPe+JCLOQ folded before Flop (didn't bet)
Seat 8: ItDFe9gh5QYPQB9vC4ntUA folded before Flop (didn't bet)
Seat 9: z89zAYE4dlPgjkofBKII0Q (button) folded before Flop (didn't bet)



PokerStars Game #59941885920:  Hold'em No Limit ($1/$2) - 2009/07/01 1:49:16 ET
Table 'jlrIxbrVIG+gjaUYT4za8g' 6-max Seat #6 is the button
Seat 2: cwfuMyvDC7J7SqX2leDC8g ($47 in chips)
Seat 4: 8srN1dKQePlsv0GyTada+Q ($260.70 in chips)
Seat 5: AyBB0k3Dcl7xbXUeGMw06g ($54.75 in chips)
Seat 6: BWhgxe7gWiYobRbwdG+d2Q ($196 in chips)
cwfuMyvDC7J7SqX2leDC8g: posts small blind $1
8srN1dKQePlsv0GyTada+Q: posts big blind $2
*** HOLE CARDS ***
AyBB0k3Dcl7xbXUeGMw06g: calls $2
BWhgxe7gWiYobRbwdG+d2Q: raises $6 to $8
cwfuMyvDC7J7SqX2leDC8g: folds
8srN1dKQePlsv0GyTada+Q: folds
AyBB0k3Dcl7xbXUeGMw06g: calls $6
*** FLOP *** [Kd 6s Tc]
AyBB0k3Dcl7xbXUeGMw06g: checks
BWhgxe7gWiYobRbwdG+d2Q: bets $14
AyBB0k3Dcl7xbXUeGMw06g: calls $14
*** TURN *** [Kd 6s Tc] [5s]
AyBB0k3Dcl7xbXUeGMw06g: checks
BWhgxe7gWiYobRbwdG+d2Q: checks
*** RIVER *** [Kd 6s Tc 5s] [Qh]
AyBB0k3Dcl7xbXUeGMw06g: bets $18
BWhgxe7gWiYobRbwdG+d2Q: folds
AyBB0k3Dcl7xbXUeGMw06g collected $45 from pot
*** SUMMARY ***
Total pot $47 | Rake $2
Board [Kd 6s Tc 5s Qh]
Seat 2: cwfuMyvDC7J7SqX2leDC8g (small blind) folded before Flop
Seat 4: 8srN1dKQePlsv0GyTada+Q (big blind) folded before Flop
Seat 5: AyBB0k3Dcl7xbXUeGMw06g collected ($45)
Seat 6: BWhgxe7gWiYobRbwdG+d2Q (button) folded on the River



PokerStars Game #59941886202:  Hold'em No Limit ($1/$2) - 2009/07/01 1:49:17 ET
Table 'G1Oqdy4Pqdb5gtx40rUBzA' 6-max Seat #6 is the button
Seat 1: 4dMBh/1VTdeUTPCyhCs3UQ ($64.70 in chips)
Seat 2: m7mYVfnCOK5TE/VkN/FhOg ($212.05 in chips)
Seat 3: VvdR9F3I+2yELkfTVvC1dg ($419.90 in chips)
Seat 4: B87ikIyZ/TzAVeXf38Ny0g ($221.70 in chips)
Seat 5: F1+Ml47qRQWunzPnGhLLzQ ($197 in chips)
Seat 6: qCnEYuAE5y5A7bk6fO5/jQ ($200 in chips)
4dMBh/1VTdeUTPCyhCs3UQ: posts small blind $1
m7mYVfnCOK5TE/VkN/FhOg: posts big blind $2
*** HOLE CARDS ***
VvdR9F3I+2yELkfTVvC1dg: folds
B87ikIyZ/TzAVeXf38Ny0g: raises $4 to $6
F1+Ml47qRQWunzPnGhLLzQ: folds
qCnEYuAE5y5A7bk6fO5/jQ: folds
4dMBh/1VTdeUTPCyhCs3UQ: folds
m7mYVfnCOK5TE/VkN/FhOg: folds
B87ikIyZ/TzAVeXf38Ny0g collected $5 from pot
B87ikIyZ/TzAVeXf38Ny0g: doesn't show hand
*** SUMMARY ***
Total pot $5 | Rake $0
Seat 1: 4dMBh/1VTdeUTPCyhCs3UQ (small blind) folded before Flop
Seat 2: m7mYVfnCOK5TE/VkN/FhOg (big blind) folded before Flop
Seat 3: VvdR9F3I+2yELkfTVvC1dg folded before Flop (didn't bet)
Seat 4: B87ikIyZ/TzAVeXf38Ny0g collected ($5)
Seat 5: F1+Ml47qRQWunzPnGhLLzQ folded before Flop (didn't bet)
Seat 6: qCnEYuAE5y5A7bk6fO5/jQ (button) folded before Flop (didn't bet)



PokerStars Game #59941886360:  Hold'em No Limit ($1/$2) - 2009/07/01 1:49:17 ET
Table 'TsEDkiO4tzCTCzJ7tNdEqw' 6-max Seat #2 is the button
Seat 2: 4dcDwIHRm96PwtqkpQiuiA ($76.65 in chips)
Seat 3: ubtx4Z5L+AcK71MTvYiGVw ($204 in chips)
Seat 4: K8MXCrNAVYlMnnCeM32Kxw ($127.55 in chips)
Seat 5: VvdR9F3I+2yELkfTVvC1dg ($246.35 in chips)
Seat 6: uCqEjnxh2/vFBjKYkfTOkw ($287.80 in chips)
ubtx4Z5L+AcK71MTvYiGVw: posts small blind $1
K8MXCrNAVYlMnnCeM32Kxw: posts big blind $2
*** HOLE CARDS ***
VvdR9F3I+2yELkfTVvC1dg: folds
uCqEjnxh2/vFBjKYkfTOkw: folds
4dcDwIHRm96PwtqkpQiuiA: folds
ubtx4Z5L+AcK71MTvYiGVw: raises $6 to $8
K8MXCrNAVYlMnnCeM32Kxw: calls $6
*** FLOP *** [Kd 2s 5d]
ubtx4Z5L+AcK71MTvYiGVw: bets $10
K8MXCrNAVYlMnnCeM32Kxw: folds
ubtx4Z5L+AcK71MTvYiGVw collected $15.20 from pot
ubtx4Z5L+AcK71MTvYiGVw: doesn't show hand
*** SUMMARY ***
Total pot $16 | Rake $0.80
Board [Kd 2s 5d]
Seat 2: 4dcDwIHRm96PwtqkpQiuiA (button) folded before Flop (didn't bet)
Seat 3: ubtx4Z5L+AcK71MTvYiGVw (small blind) collected ($15.20)
Seat 4: K8MXCrNAVYlMnnCeM32Kxw (big blind) folded on the Flop
Seat 5: VvdR9F3I+2yELkfTVvC1dg folded before Flop (didn't bet)
Seat 6: uCqEjnxh2/vFBjKYkfTOkw folded before Flop (didn't bet)



PokerStars Game #59941886462:  Hold'em No Limit ($1/$2) - 2009/07/01 1:49:17 ET
Table 'P/yCfYl1GfGsu/e6DxDy/A' 2-max Seat #2 is the button
Seat 1: 7fOCUy3x9hdkmXkkDNolGQ ($554 in chips)
Seat 2: RwDoM55ZeQuI2ADyJhOb2Q ($917.50 in chips)
RwDoM55ZeQuI2ADyJhOb2Q: posts small blind $1
7fOCUy3x9hdkmXkkDNolGQ: posts big blind $2
*** HOLE CARDS ***
RwDoM55ZeQuI2ADyJhOb2Q: raises $4 to $6
7fOCUy3x9hdkmXkkDNolGQ: raises $14 to $20
RwDoM55ZeQuI2ADyJhOb2Q: raises $54 to $74
7fOCUy3x9hdkmXkkDNolGQ: calls $54
*** FLOP *** [8s 9c 6s]
7fOCUy3x9hdkmXkkDNolGQ: checks
RwDoM55ZeQuI2ADyJhOb2Q: checks
*** TURN *** [8s 9c 6s] [8h]
7fOCUy3x9hdkmXkkDNolGQ: bets $98
RwDoM55ZeQuI2ADyJhOb2Q: calls $98
*** RIVER *** [8s 9c 6s 8h] [3h]
7fOCUy3x9hdkmXkkDNolGQ: bets $192
RwDoM55ZeQuI2ADyJhOb2Q: folds
7fOCUy3x9hdkmXkkDNolGQ collected $343.50 from pot
7fOCUy3x9hdkmXkkDNolGQ: doesn't show hand
*** SUMMARY ***
Total pot $344 | Rake $0.50
Board [8s 9c 6s 8h 3h]
Seat 1: 7fOCUy3x9hdkmXkkDNolGQ (big blind) collected ($343.50)
Seat 2: RwDoM55ZeQuI2ADyJhOb2Q (button) (small blind) folded on the River



PokerStars Game #59941887204:  Hold'em No Limit ($1/$2) - 2009/07/01 1:49:19 ET
Table 'rsKRKlGHlxVyqJxzO2a2Ow' 9-max Seat #4 is the button
Seat 1: KqHysDSpCPaPyK3tJC1aEw ($212.30 in chips)
Seat 2: +T/63sAeZzWyHchahJ36GQ ($83 in chips)
Seat 3: kM9CA+2UcdMjbCMbtUCGiA ($225.10 in chips)
Seat 4: 31HuO+DQxppUQEedBWukug ($108.85 in chips)
Seat 5: 5Q8U6iZbeO7xJSS4qvDP5g ($246.30 in chips)
Seat 6: H6Z4+qu8gR0VUiPOijndVg ($200 in chips)
Seat 7: GX1heJ+DSsvm7gzSPsYhhQ ($56 in chips)
Seat 8: CkE3IyJF1KvdaAOmZY5XqQ ($206.70 in chips)
Seat 9: gRbvhSUVg+TNaTjaJecIRw ($50.60 in chips)
5Q8U6iZbeO7xJSS4qvDP5g: posts small blind $1
H6Z4+qu8gR0VUiPOijndVg: posts big blind $2
*** HOLE CARDS ***
GX1heJ+DSsvm7gzSPsYhhQ: folds
CkE3IyJF1KvdaAOmZY5XqQ: raises $6 to $8
gRbvhSUVg+TNaTjaJecIRw: folds
KqHysDSpCPaPyK3tJC1aEw: folds
+T/63sAeZzWyHchahJ36GQ: folds
kM9CA+2UcdMjbCMbtUCGiA: folds
31HuO+DQxppUQEedBWukug: folds
5Q8U6iZbeO7xJSS4qvDP5g: folds
H6Z4+qu8gR0VUiPOijndVg: folds
CkE3IyJF1KvdaAOmZY5XqQ collected $5 from pot
*** SUMMARY ***
Total pot $5 | Rake $0
Seat 1: KqHysDSpCPaPyK3tJC1aEw folded before Flop (didn't bet)
Seat 2: +T/63sAeZzWyHchahJ36GQ folded before Flop (didn't bet)
Seat 3: kM9CA+2UcdMjbCMbtUCGiA folded before Flop (didn't bet)
Seat 4: 31HuO+DQxppUQEedBWukug (button) folded before Flop (didn't bet)
Seat 5: 5Q8U6iZbeO7xJSS4qvDP5g (small blind) folded before Flop
Seat 6: H6Z4+qu8gR0VUiPOijndVg (big blind) folded before Flop
Seat 7: GX1heJ+DSsvm7gzSPsYhhQ folded before Flop (didn't bet)
Seat 8: CkE3IyJF1KvdaAOmZY5XqQ collected ($5)
Seat 9: gRbvhSUVg+TNaTjaJecIRw folded before Flop (didn't bet)



PokerStars Game #59941889064:  Hold'em No Limit ($1/$2) - 2009/07/01 1:49:23 ET
Table 'QxerF7GUfCbl+4a8XaTB2w' 6-max Seat #3 is the button
Seat 1: ZwvXzkkZ3XpMhKfAmVpahw ($273.75 in chips)
Seat 2: 6UGgYbxwWNc+ohObe8vB9w ($39.75 in chips)
Seat 3: 8rZGabKe2DEPdZCbCivZ9Q ($27 in chips)
Seat 4: /PH6Ffnho4Ysm8S3V/oa+w ($54 in chips)
Seat 5: vkfxu8f/jMYKUk6Ly4eujw ($208.05 in chips)
Seat 6: VvdR9F3I+2yELkfTVvC1dg ($213.70 in chips)
/PH6Ffnho4Ysm8S3V/oa+w: posts small blind $1
vkfxu8f/jMYKUk6Ly4eujw: posts big blind $2
*** HOLE CARDS ***
VvdR9F3I+2yELkfTVvC1dg: folds
ZwvXzkkZ3XpMhKfAmVpahw: folds
6UGgYbxwWNc+ohObe8vB9w: folds
8rZGabKe2DEPdZCbCivZ9Q: folds
/PH6Ffnho4Ysm8S3V/oa+w: folds
vkfxu8f/jMYKUk6Ly4eujw collected $2 from pot
vkfxu8f/jMYKUk6Ly4eujw: doesn't show hand
*** SUMMARY ***
Total pot $2 | Rake $0
Seat 1: ZwvXzkkZ3XpMhKfAmVpahw folded before Flop (didn't bet)
Seat 2: 6UGgYbxwWNc+ohObe8vB9w folded before Flop (didn't bet)
Seat 3: 8rZGabKe2DEPdZCbCivZ9Q (button) folded before Flop (didn't bet)
Seat 4: /PH6Ffnho4Ysm8S3V/oa+w (small blind) folded before Flop
Seat 5: vkfxu8f/jMYKUk6Ly4eujw (big blind) collected ($2)
Seat 6: VvdR9F3I+2yELkfTVvC1dg folded before Flop (didn't bet)



PokerStars Game #59941892704:  Hold'em No Limit ($1/$2) - 2009/07/01 1:49:29 ET
Table 'mGpP9StWRnoeiBDExc6Frg' 6-max Seat #1 is the button
Seat 1: VvdR9F3I+2yELkfTVvC1dg ($311.85 in chips)
Seat 2: 6hRJ68JkbJq6MYI9o5bUnQ ($104 in chips)
Seat 4: 4dcDwIHRm96PwtqkpQiuiA ($91.70 in chips)
Seat 5: d1puGuVBE0fidn+5eRJ0tw ($186.55 in chips)
Seat 6: B2Ih1sr5VZk+8He7rcrMtQ ($402.45 in chips)
6hRJ68JkbJq6MYI9o5bUnQ: posts small blind $1
4dcDwIHRm96PwtqkpQiuiA: posts big blind $2
*** HOLE CARDS ***
d1puGuVBE0fidn+5eRJ0tw: folds
B2Ih1sr5VZk+8He7rcrMtQ: raises $4 to $6
VvdR9F3I+2yELkfTVvC1dg: folds
6hRJ68JkbJq6MYI9o5bUnQ: folds
4dcDwIHRm96PwtqkpQiuiA: folds
B2Ih1sr5VZk+8He7rcrMtQ collected $5 from pot
*** SUMMARY ***
Total pot $5 | Rake $0
Seat 1: VvdR9F3I+2yELkfTVvC1dg (button) folded before Flop (didn't bet)
Seat 2: 6hRJ68JkbJq6MYI9o5bUnQ (small blind) folded before Flop
Seat 4: 4dcDwIHRm96PwtqkpQiuiA (big blind) folded before Flop
Seat 5: d1puGuVBE0fidn+5eRJ0tw folded before Flop (didn't bet)
Seat 6: B2Ih1sr5VZk+8He7rcrMtQ collected ($5)



PokerStars Game #59941892634:  Hold'em No Limit ($1/$2) - 2009/07/01 1:49:29 ET
Table 'gnHBqWll9O3fxG7Ojkz/ng' 9-max Seat #8 is the button
Seat 2: H6Z4+qu8gR0VUiPOijndVg ($330.30 in chips)
Seat 3: 5Q8U6iZbeO7xJSS4qvDP5g ($238.10 in chips)
Seat 4: nXDI8Y/S6POzRwANu3d8hQ ($16 in chips)
Seat 5: rBQDMkKm9cZn6M9NPsiVew ($169.15 in chips)
Seat 6: KqHysDSpCPaPyK3tJC1aEw ($200 in chips)
Seat 7: 254YPxPJr5Sw58bkD0YqYQ ($200 in chips)
Seat 8: cM6efHzdxoqYm0EQKP4TTQ ($110.95 in chips)
Seat 9: GX1heJ+DSsvm7gzSPsYhhQ ($47.15 in chips)
GX1heJ+DSsvm7gzSPsYhhQ: posts small blind $1
TAfo4veNRaRlzDXMMYS3Jg: is sitting out
H6Z4+qu8gR0VUiPOijndVg: posts big blind $2
*** HOLE CARDS ***
5Q8U6iZbeO7xJSS4qvDP5g: raises $6 to $8
TAfo4veNRaRlzDXMMYS3Jg leaves the table
nXDI8Y/S6POzRwANu3d8hQ: folds
rBQDMkKm9cZn6M9NPsiVew: folds
KqHysDSpCPaPyK3tJC1aEw: folds
254YPxPJr5Sw58bkD0YqYQ: folds
cM6efHzdxoqYm0EQKP4TTQ: folds
GX1heJ+DSsvm7gzSPsYhhQ: folds
MtdNf9cdM7+0CSU0dx4USA joins the table at seat #1
H6Z4+qu8gR0VUiPOijndVg: folds
5Q8U6iZbeO7xJSS4qvDP5g collected $5 from pot
5Q8U6iZbeO7xJSS4qvDP5g: doesn't show hand
*** SUMMARY ***
Total pot $5 | Rake $0
Seat 2: H6Z4+qu8gR0VUiPOijndVg (big blind) folded before Flop
Seat 3: 5Q8U6iZbeO7xJSS4qvDP5g collected ($5)
Seat 4: nXDI8Y/S6POzRwANu3d8hQ folded before Flop (didn't bet)
Seat 5: rBQDMkKm9cZn6M9NPsiVew folded before Flop (didn't bet)
Seat 6: KqHysDSpCPaPyK3tJC1aEw folded before Flop (didn't bet)
Seat 7: 254YPxPJr5Sw58bkD0YqYQ folded before Flop (didn't bet)
Seat 8: cM6efHzdxoqYm0EQKP4TTQ (button) folded before Flop (didn't bet)
Seat 9: GX1heJ+DSsvm7gzSPsYhhQ (small blind) folded before Flop



PokerStars Game #59941894246:  Hold'em No Limit ($1/$2) - 2009/07/01 1:49:33 ET
Table 'CFkQcfWjKccZaZDf71FK+w' 6-max Seat #5 is the button
Seat 1: vkfxu8f/jMYKUk6Ly4eujw ($224.25 in chips)
Seat 2: ewN/vzF22+/gdzjIKBOlkA ($203.40 in chips)
Seat 5: 2lOU1DcvUZaMcxZ95XfzXw ($131.05 in chips)
Seat 6: ORVqY3rf9X6ANA/8s+On2Q ($49.35 in chips)
ORVqY3rf9X6ANA/8s+On2Q: posts small blind $1
vkfxu8f/jMYKUk6Ly4eujw: posts big blind $2
*** HOLE CARDS ***
ewN/vzF22+/gdzjIKBOlkA: folds
2lOU1DcvUZaMcxZ95XfzXw: folds
ORVqY3rf9X6ANA/8s+On2Q: folds
vkfxu8f/jMYKUk6Ly4eujw collected $2 from pot
*** SUMMARY ***
Total pot $2 | Rake $0
Seat 1: vkfxu8f/jMYKUk6Ly4eujw (big blind) collected ($2)
Seat 2: ewN/vzF22+/gdzjIKBOlkA folded before Flop (didn't bet)
Seat 5: 2lOU1DcvUZaMcxZ95XfzXw (button) folded before Flop (didn't bet)
Seat 6: ORVqY3rf9X6ANA/8s+On2Q (small blind) folded before Flop



PokerStars Game #59941894936:  Hold'em No Limit ($1/$2) - 2009/07/01 1:49:34 ET
Table 'NmY84NAf9Mh0ckAckHnh5g' 2-max Seat #2 is the button
Seat 1: 6hvg964TSqZ3AL/0XK9aVQ ($621.55 in chips)
Seat 2: RwDoM55ZeQuI2ADyJhOb2Q ($362.55 in chips)
RwDoM55ZeQuI2ADyJhOb2Q: posts small blind $1
6hvg964TSqZ3AL/0XK9aVQ: posts big blind $2
*** HOLE CARDS ***
RwDoM55ZeQuI2ADyJhOb2Q: folds
6hvg964TSqZ3AL/0XK9aVQ collected $2 from pot
6hvg964TSqZ3AL/0XK9aVQ: doesn't show hand
*** SUMMARY ***
Total pot $2 | Rake $0
Seat 1: 6hvg964TSqZ3AL/0XK9aVQ (big blind) collected ($2)
Seat 2: RwDoM55ZeQuI2ADyJhOb2Q (button) (small blind) folded before Flop



PokerStars Game #59941895916:  Hold'em No Limit ($1/$2) - 2009/07/01 1:49:36 ET
Table '3WCXyaiCAbqSShQu7FIjvA' 9-max Seat #1 is the button
Seat 1: kTCkABD1UUldS9DFRGfCwQ ($134.75 in chips)
Seat 3: 5Q8U6iZbeO7xJSS4qvDP5g ($268.25 in chips)
Seat 4: waEF/+pxZTxNo4FvsORuXg ($103.40 in chips)
Seat 5: CkE3IyJF1KvdaAOmZY5XqQ ($210.90 in chips)
Seat 6: 5jQlngvMSqM/WoonOcR5kw ($285 in chips)
Seat 7: nXDI8Y/S6POzRwANu3d8hQ ($44.10 in chips)
Seat 8: +T/63sAeZzWyHchahJ36GQ ($37 in chips)
Seat 9: FiXPLJyqb24l32QST2TInw ($103.80 in chips)
254YPxPJr5Sw58bkD0YqYQ will be allowed to play after the button
5Q8U6iZbeO7xJSS4qvDP5g: posts small blind $1
waEF/+pxZTxNo4FvsORuXg: posts big blind $2
*** HOLE CARDS ***
CkE3IyJF1KvdaAOmZY5XqQ: folds
5jQlngvMSqM/WoonOcR5kw: folds
nXDI8Y/S6POzRwANu3d8hQ: folds
+T/63sAeZzWyHchahJ36GQ: folds
FiXPLJyqb24l32QST2TInw: folds
kTCkABD1UUldS9DFRGfCwQ: folds
5Q8U6iZbeO7xJSS4qvDP5g: folds
waEF/+pxZTxNo4FvsORuXg collected $2 from pot
waEF/+pxZTxNo4FvsORuXg: doesn't show hand
*** SUMMARY ***
Total pot $2 | Rake $0
Seat 1: kTCkABD1UUldS9DFRGfCwQ (button) folded before Flop (didn't bet)
Seat 3: 5Q8U6iZbeO7xJSS4qvDP5g (small blind) folded before Flop
Seat 4: waEF/+pxZTxNo4FvsORuXg (big blind) collected ($2)
Seat 5: CkE3IyJF1KvdaAOmZY5XqQ folded before Flop (didn't bet)
Seat 6: 5jQlngvMSqM/WoonOcR5kw folded before Flop (didn't bet)
Seat 7: nXDI8Y/S6POzRwANu3d8hQ folded before Flop (didn't bet)
Seat 8: +T/63sAeZzWyHchahJ36GQ folded before Flop (didn't bet)
Seat 9: FiXPLJyqb24l32QST2TInw folded before Flop (didn't bet)



PokerStars Game #59941896236:  Hold'em No Limit ($1/$2) - 2009/07/01 1:49:36 ET
Table '4NGNnZ/osQfNq6abYqkJeA' 6-max Seat #4 is the button
Seat 2: 669iGNwYwgRZg3nhS+aDAQ ($123.25 in chips)
Seat 3: 54yWzRRgS0oZ+S6LwZBxMQ ($40.65 in chips)
Seat 4: sY+4Uuh5z/6AbXXaCS10jw ($306.10 in chips)
Seat 5: VvdR9F3I+2yELkfTVvC1dg ($229.80 in chips)
Seat 6: /PH6Ffnho4Ysm8S3V/oa+w ($40 in chips)
VvdR9F3I+2yELkfTVvC1dg: posts small blind $1
/PH6Ffnho4Ysm8S3V/oa+w: posts big blind $2
*** HOLE CARDS ***
669iGNwYwgRZg3nhS+aDAQ: calls $2
54yWzRRgS0oZ+S6LwZBxMQ: calls $2
sY+4Uuh5z/6AbXXaCS10jw: folds
VvdR9F3I+2yELkfTVvC1dg: raises $10 to $12
/PH6Ffnho4Ysm8S3V/oa+w: folds
669iGNwYwgRZg3nhS+aDAQ: calls $10
54yWzRRgS0oZ+S6LwZBxMQ: calls $10
*** FLOP *** [9c 7s Qc]
VvdR9F3I+2yELkfTVvC1dg: checks
669iGNwYwgRZg3nhS+aDAQ: bets $6
54yWzRRgS0oZ+S6LwZBxMQ: calls $6
VvdR9F3I+2yELkfTVvC1dg: calls $6
*** TURN *** [9c 7s Qc] [5h]
VvdR9F3I+2yELkfTVvC1dg: checks
669iGNwYwgRZg3nhS+aDAQ: checks
54yWzRRgS0oZ+S6LwZBxMQ: bets $12
VvdR9F3I+2yELkfTVvC1dg: folds
669iGNwYwgRZg3nhS+aDAQ: folds
54yWzRRgS0oZ+S6LwZBxMQ collected $54 from pot
54yWzRRgS0oZ+S6LwZBxMQ: doesn't show hand
*** SUMMARY ***
Total pot $56 | Rake $2
Board [9c 7s Qc 5h]
Seat 2: 669iGNwYwgRZg3nhS+aDAQ folded on the Turn
Seat 3: 54yWzRRgS0oZ+S6LwZBxMQ collected ($54)
Seat 4: sY+4Uuh5z/6AbXXaCS10jw (button) folded before Flop (didn't bet)
Seat 5: VvdR9F3I+2yELkfTVvC1dg (small blind) folded on the Turn
Seat 6: /PH6Ffnho4Ysm8S3V/oa+w (big blind) folded before Flop



PokerStars Game #59941896378:  Hold'em No Limit ($1/$2) - 2009/07/01 1:49:37 ET
Table 'uJ9juaXXg9yIcSU8amxaXQ' 6-max Seat #4 is the button
Seat 1: JsqOjN/eHz0uYVf/PyUJ6Q ($121.25 in chips)
Seat 2: VvdR9F3I+2yELkfTVvC1dg ($220.05 in chips)
Seat 3: qXDd0ZyMIse0OBu8pxeQ3Q ($237.40 in chips)
Seat 4: zNjJ/y4emmF+vzrCDd+ooA ($265.30 in chips)
Seat 6: /PH6Ffnho4Ysm8S3V/oa+w ($40 in chips)
/PH6Ffnho4Ysm8S3V/oa+w: posts small blind $1
JsqOjN/eHz0uYVf/PyUJ6Q: posts big blind $2
*** HOLE CARDS ***
YsLQ3BAvgQHWXMAv3Wv6Hg has returned
VvdR9F3I+2yELkfTVvC1dg: raises $2 to $4
qXDd0ZyMIse0OBu8pxeQ3Q: folds
zNjJ/y4emmF+vzrCDd+ooA: raises $2 to $6
/PH6Ffnho4Ysm8S3V/oa+w: folds
JsqOjN/eHz0uYVf/PyUJ6Q: folds
VvdR9F3I+2yELkfTVvC1dg: calls $2
*** FLOP *** [Td Js 7c]
VvdR9F3I+2yELkfTVvC1dg: checks
zNjJ/y4emmF+vzrCDd+ooA: bets $10
VvdR9F3I+2yELkfTVvC1dg: folds
zNjJ/y4emmF+vzrCDd+ooA collected $14.25 from pot
*** SUMMARY ***
Total pot $15 | Rake $0.75
Board [Td Js 7c]
Seat 1: JsqOjN/eHz0uYVf/PyUJ6Q (big blind) folded before Flop
Seat 2: VvdR9F3I+2yELkfTVvC1dg folded on the Flop
Seat 3: qXDd0ZyMIse0OBu8pxeQ3Q folded before Flop (didn't bet)
Seat 4: zNjJ/y4emmF+vzrCDd+ooA (button) collected ($14.25)
Seat 6: /PH6Ffnho4Ysm8S3V/oa+w (small blind) folded before Flop



PokerStars Game #59941896706:  Hold'em No Limit ($1/$2) - 2009/07/01 1:49:37 ET
Table 'qVXak+oTeDXMGbWa4sDU5Q' 9-max Seat #8 is the button
Seat 1: H6Z4+qu8gR0VUiPOijndVg ($230.45 in chips)
Seat 2: CST1bO+CmVQOtNgiT0cKPg ($142.25 in chips)
Seat 3: WUlHm+ydPPHG7Lb0rePSdA ($177.35 in chips)
Seat 4: lQYT23h5QCUVZAKxjOO39Q ($177.10 in chips)
Seat 7: 6oGEJqk9oDy29sSaLs+LGA ($18.65 in chips)
Seat 8: Z0rzUi0y1x80UdIpofoNbA ($111.15 in chips)
Seat 9: CkE3IyJF1KvdaAOmZY5XqQ ($208.55 in chips)
CkE3IyJF1KvdaAOmZY5XqQ: posts small blind $1
H6Z4+qu8gR0VUiPOijndVg: posts big blind $2
zJtQ1gxyi72XvGYS1tM+DA: sits out
*** HOLE CARDS ***
CST1bO+CmVQOtNgiT0cKPg: raises $6 to $8
WUlHm+ydPPHG7Lb0rePSdA: folds
lQYT23h5QCUVZAKxjOO39Q: folds
gxYDp0GZEzKoOg07Km9LaA joins the table at seat #6
6oGEJqk9oDy29sSaLs+LGA: folds
Z0rzUi0y1x80UdIpofoNbA: folds
CkE3IyJF1KvdaAOmZY5XqQ: folds
H6Z4+qu8gR0VUiPOijndVg: raises $16 to $24
CST1bO+CmVQOtNgiT0cKPg: calls $16
*** FLOP *** [2d Kd 5d]
H6Z4+qu8gR0VUiPOijndVg: checks
CST1bO+CmVQOtNgiT0cKPg: bets $118.25 and is all-in
H6Z4+qu8gR0VUiPOijndVg: folds
CST1bO+CmVQOtNgiT0cKPg collected $46.55 from pot
*** SUMMARY ***
Total pot $49 | Rake $2.45
Board [2d Kd 5d]
Seat 1: H6Z4+qu8gR0VUiPOijndVg (big blind) folded on the Flop
Seat 2: CST1bO+CmVQOtNgiT0cKPg collected ($46.55)
Seat 3: WUlHm+ydPPHG7Lb0rePSdA folded before Flop (didn't bet)
Seat 4: lQYT23h5QCUVZAKxjOO39Q folded before Flop (didn't bet)
Seat 7: 6oGEJqk9oDy29sSaLs+LGA folded before Flop (didn't bet)
Seat 8: Z0rzUi0y1x80UdIpofoNbA (button) folded before Flop (didn't bet)
Seat 9: CkE3IyJF1KvdaAOmZY5XqQ (small blind) folded before Flop



PokerStars Game #59941898838:  Hold'em No Limit ($1/$2) - 2009/07/01 1:49:41 ET
Table 'eyAQSIlgc2o1Jxvbve4WGg' 9-max Seat #4 is the button
Seat 1: UZEsV9yKUMqmpYPiOFpaZw ($75 in chips)
Seat 2: kM9CA+2UcdMjbCMbtUCGiA ($208.60 in chips)
Seat 4: CkE3IyJF1KvdaAOmZY5XqQ ($200 in chips)
Seat 5: mIKx5lhIt13X5eZQH0ZeMA ($139.90 in chips)
Seat 6: nXDI8Y/S6POzRwANu3d8hQ ($67 in chips)
Seat 7: u3OrI5uGx9mx1fE7dgr+EA ($105.75 in chips)
Seat 9: WUlHm+ydPPHG7Lb0rePSdA ($140.20 in chips)
mIKx5lhIt13X5eZQH0ZeMA: posts small blind $1
nXDI8Y/S6POzRwANu3d8hQ: posts big blind $2
254YPxPJr5Sw58bkD0YqYQ: sits out
*** HOLE CARDS ***
u3OrI5uGx9mx1fE7dgr+EA: calls $2
WUlHm+ydPPHG7Lb0rePSdA: folds
UZEsV9yKUMqmpYPiOFpaZw: calls $2
kM9CA+2UcdMjbCMbtUCGiA: folds
CkE3IyJF1KvdaAOmZY5XqQ: folds
mIKx5lhIt13X5eZQH0ZeMA: calls $1
nXDI8Y/S6POzRwANu3d8hQ: checks
*** FLOP *** [3c 5d 3d]
mIKx5lhIt13X5eZQH0ZeMA: checks
nXDI8Y/S6POzRwANu3d8hQ: checks
u3OrI5uGx9mx1fE7dgr+EA: bets $2
UZEsV9yKUMqmpYPiOFpaZw: folds
mIKx5lhIt13X5eZQH0ZeMA: calls $2
nXDI8Y/S6POzRwANu3d8hQ: folds
*** TURN *** [3c 5d 3d] [9d]
mIKx5lhIt13X5eZQH0ZeMA: checks
u3OrI5uGx9mx1fE7dgr+EA: bets $6
mIKx5lhIt13X5eZQH0ZeMA: raises $10 to $16
u3OrI5uGx9mx1fE7dgr+EA: calls $10
*** RIVER *** [3c 5d 3d 9d] [2s]
mIKx5lhIt13X5eZQH0ZeMA: bets $30
u3OrI5uGx9mx1fE7dgr+EA has timed out
u3OrI5uGx9mx1fE7dgr+EA: folds
u3OrI5uGx9mx1fE7dgr+EA is sitting out
u3OrI5uGx9mx1fE7dgr+EA has returned
mIKx5lhIt13X5eZQH0ZeMA collected $41.85 from pot
mIKx5lhIt13X5eZQH0ZeMA: doesn't show hand
*** SUMMARY ***
Total pot $44 | Rake $2.15
Board [3c 5d 3d 9d 2s]
Seat 1: UZEsV9yKUMqmpYPiOFpaZw folded on the Flop
Seat 2: kM9CA+2UcdMjbCMbtUCGiA folded before Flop (didn't bet)
Seat 4: CkE3IyJF1KvdaAOmZY5XqQ (button) folded before Flop (didn't bet)
Seat 5: mIKx5lhIt13X5eZQH0ZeMA (small blind) collected ($41.85)
Seat 6: nXDI8Y/S6POzRwANu3d8hQ (big blind) folded on the Flop
Seat 7: u3OrI5uGx9mx1fE7dgr+EA folded on the River
Seat 9: WUlHm+ydPPHG7Lb0rePSdA folded before Flop (didn't bet)



PokerStars Game #59941898372:  Hold'em No Limit ($1/$2) - 2009/07/01 1:49:41 ET
Table 'NmY84NAf9Mh0ckAckHnh5g' 2-max Seat #1 is the button
Seat 1: 6hvg964TSqZ3AL/0XK9aVQ ($622.55 in chips)
Seat 2: RwDoM55ZeQuI2ADyJhOb2Q ($361.55 in chips)
6hvg964TSqZ3AL/0XK9aVQ: posts small blind $1
RwDoM55ZeQuI2ADyJhOb2Q: posts big blind $2
*** HOLE CARDS ***
6hvg964TSqZ3AL/0XK9aVQ: folds
RwDoM55ZeQuI2ADyJhOb2Q collected $2 from pot
RwDoM55ZeQuI2ADyJhOb2Q: doesn't show hand
*** SUMMARY ***
Total pot $2 | Rake $0
Seat 1: 6hvg964TSqZ3AL/0XK9aVQ (button) (small blind) folded before Flop
Seat 2: RwDoM55ZeQuI2ADyJhOb2Q (big blind) collected ($2)



PokerStars Game #59941898328:  Hold'em No Limit ($1/$2) - 2009/07/01 1:49:41 ET
Table 'TsEDkiO4tzCTCzJ7tNdEqw' 6-max Seat #3 is the button
Seat 2: 4dcDwIHRm96PwtqkpQiuiA ($76.65 in chips)
Seat 3: ubtx4Z5L+AcK71MTvYiGVw ($211.20 in chips)
Seat 4: K8MXCrNAVYlMnnCeM32Kxw ($119.55 in chips)
Seat 5: VvdR9F3I+2yELkfTVvC1dg ($246.35 in chips)
Seat 6: uCqEjnxh2/vFBjKYkfTOkw ($287.80 in chips)
K8MXCrNAVYlMnnCeM32Kxw: posts small blind $1
VvdR9F3I+2yELkfTVvC1dg: posts big blind $2
*** HOLE CARDS ***
uCqEjnxh2/vFBjKYkfTOkw: folds
4dcDwIHRm96PwtqkpQiuiA: folds
ubtx4Z5L+AcK71MTvYiGVw: folds
K8MXCrNAVYlMnnCeM32Kxw: calls $1
VvdR9F3I+2yELkfTVvC1dg: checks
*** FLOP *** [9c 8d 3h]
K8MXCrNAVYlMnnCeM32Kxw: bets $2
VvdR9F3I+2yELkfTVvC1dg: folds
K8MXCrNAVYlMnnCeM32Kxw collected $3.80 from pot
*** SUMMARY ***
Total pot $4 | Rake $0.20
Board [9c 8d 3h]
Seat 2: 4dcDwIHRm96PwtqkpQiuiA folded before Flop (didn't bet)
Seat 3: ubtx4Z5L+AcK71MTvYiGVw (button) folded before Flop (didn't bet)
Seat 4: K8MXCrNAVYlMnnCeM32Kxw (small blind) collected ($3.80)
Seat 5: VvdR9F3I+2yELkfTVvC1dg (big blind) folded on the Flop
Seat 6: uCqEjnxh2/vFBjKYkfTOkw folded before Flop (didn't bet)



PokerStars Game #59941899052:  Hold'em No Limit ($1/$2) - 2009/07/01 1:49:42 ET
Table 'aSf77Sj8QEnzcc0WaxVD4Q' 6-max Seat #5 is the button
Seat 1: UELtvp+JfwI7XDGVwSxZXA ($181.05 in chips)
Seat 2: vkfxu8f/jMYKUk6Ly4eujw ($191.10 in chips)
Seat 3: 9dpyyjDTCed6nV7JhaUUpw ($760.50 in chips)
Seat 5: VvdR9F3I+2yELkfTVvC1dg ($301.70 in chips)
Seat 6: vkoJRf3gidxY1pPi0AFWww ($154.60 in chips)
vkoJRf3gidxY1pPi0AFWww: posts small blind $1
UELtvp+JfwI7XDGVwSxZXA: posts big blind $2
YsLQ3BAvgQHWXMAv3Wv6Hg: sits out
*** HOLE CARDS ***
vkfxu8f/jMYKUk6Ly4eujw: folds
9dpyyjDTCed6nV7JhaUUpw: folds
VvdR9F3I+2yELkfTVvC1dg: folds
vkoJRf3gidxY1pPi0AFWww: calls $1
UELtvp+JfwI7XDGVwSxZXA: checks
*** FLOP *** [9c 2d 8c]
vkoJRf3gidxY1pPi0AFWww: bets $4
UELtvp+JfwI7XDGVwSxZXA: folds
vkoJRf3gidxY1pPi0AFWww collected $3.80 from pot
vkoJRf3gidxY1pPi0AFWww: doesn't show hand
*** SUMMARY ***
Total pot $4 | Rake $0.20
Board [9c 2d 8c]
Seat 1: UELtvp+JfwI7XDGVwSxZXA (big blind) folded on the Flop
Seat 2: vkfxu8f/jMYKUk6Ly4eujw folded before Flop (didn't bet)
Seat 3: 9dpyyjDTCed6nV7JhaUUpw folded before Flop (didn't bet)
Seat 5: VvdR9F3I+2yELkfTVvC1dg (button) folded before Flop (didn't bet)
Seat 6: vkoJRf3gidxY1pPi0AFWww (small blind) collected ($3.80)



PokerStars Game #59941900252:  Hold'em No Limit ($1/$2) - 2009/07/01 1:49:44 ET
Table 'WCA60bDA8ecovUgFSIZkTQ' 9-max Seat #7 is the button
Seat 1: 3RFwE6igZ1BGKOGuab6iiw ($65.70 in chips)
Seat 2: TAfo4veNRaRlzDXMMYS3Jg ($37 in chips)
Seat 3: g7gL2NLJCdZPPV399WKT1w ($50.65 in chips)
Seat 4: IYBKVnE2Basnr88BAhH+bQ ($202.80 in chips)
Seat 5: A+9gcmwAl0eFxxbAwRY1OA ($269.10 in chips)
Seat 7: tsTv4D+ne2W0qhUt9HlcMw ($193 in chips)
Seat 8: mJhwEVg7F695DiO+RIhM5g ($234.05 in chips)
Seat 9: ItDFe9gh5QYPQB9vC4ntUA ($200 in chips)
mJhwEVg7F695DiO+RIhM5g: posts small blind $1
ItDFe9gh5QYPQB9vC4ntUA: posts big blind $2
YoKKKdDDs7gFzP1Z65Sdaw: sits out
*** HOLE CARDS ***
3RFwE6igZ1BGKOGuab6iiw: calls $2
TAfo4veNRaRlzDXMMYS3Jg: folds
g7gL2NLJCdZPPV399WKT1w: folds
IYBKVnE2Basnr88BAhH+bQ: folds
A+9gcmwAl0eFxxbAwRY1OA: calls $2
tsTv4D+ne2W0qhUt9HlcMw: folds
mJhwEVg7F695DiO+RIhM5g: raises $8 to $10
ItDFe9gh5QYPQB9vC4ntUA: calls $8
3RFwE6igZ1BGKOGuab6iiw: calls $8
A+9gcmwAl0eFxxbAwRY1OA: folds
*** FLOP *** [Qc 4s Kd]
mJhwEVg7F695DiO+RIhM5g: bets $20
ItDFe9gh5QYPQB9vC4ntUA: folds
3RFwE6igZ1BGKOGuab6iiw: folds
mJhwEVg7F695DiO+RIhM5g collected $30.40 from pot
mJhwEVg7F695DiO+RIhM5g: doesn't show hand
*** SUMMARY ***
Total pot $32 | Rake $1.60
Board [Qc 4s Kd]
Seat 1: 3RFwE6igZ1BGKOGuab6iiw folded on the Flop
Seat 2: TAfo4veNRaRlzDXMMYS3Jg folded before Flop (didn't bet)
Seat 3: g7gL2NLJCdZPPV399WKT1w folded before Flop (didn't bet)
Seat 4: IYBKVnE2Basnr88BAhH+bQ folded before Flop (didn't bet)
Seat 5: A+9gcmwAl0eFxxbAwRY1OA folded before Flop
Seat 7: tsTv4D+ne2W0qhUt9HlcMw (button) folded before Flop (didn't bet)
Seat 8: mJhwEVg7F695DiO+RIhM5g (small blind) collected ($30.40)
Seat 9: ItDFe9gh5QYPQB9vC4ntUA (big blind) folded on the Flop



PokerStars Game #59941900424:  Hold'em No Limit ($1/$2) - 2009/07/01 1:49:44 ET
Table 'CFkQcfWjKccZaZDf71FK+w' 6-max Seat #6 is the button
Seat 1: vkfxu8f/jMYKUk6Ly4eujw ($225.25 in chips)
Seat 2: ewN/vzF22+/gdzjIKBOlkA ($203.40 in chips)
Seat 5: 2lOU1DcvUZaMcxZ95XfzXw ($131.05 in chips)
Seat 6: ORVqY3rf9X6ANA/8s+On2Q ($48.35 in chips)
vkfxu8f/jMYKUk6Ly4eujw: posts small blind $1
ewN/vzF22+/gdzjIKBOlkA: posts big blind $2
*** HOLE CARDS ***
2lOU1DcvUZaMcxZ95XfzXw: folds
ORVqY3rf9X6ANA/8s+On2Q: calls $2
vkfxu8f/jMYKUk6Ly4eujw: folds
ewN/vzF22+/gdzjIKBOlkA: checks
*** FLOP *** [5d Jd 3c]
ewN/vzF22+/gdzjIKBOlkA: checks
ORVqY3rf9X6ANA/8s+On2Q: checks
*** TURN *** [5d Jd 3c] [8h]
ewN/vzF22+/gdzjIKBOlkA: bets $4
ORVqY3rf9X6ANA/8s+On2Q: calls $4
*** RIVER *** [5d Jd 3c 8h] [7h]
ewN/vzF22+/gdzjIKBOlkA: bets $10
ORVqY3rf9X6ANA/8s+On2Q: folds
ewN/vzF22+/gdzjIKBOlkA collected $12.40 from pot
*** SUMMARY ***
Total pot $13 | Rake $0.60
Board [5d Jd 3c 8h 7h]
Seat 1: vkfxu8f/jMYKUk6Ly4eujw (small blind) folded before Flop
Seat 2: ewN/vzF22+/gdzjIKBOlkA (big blind) collected ($12.40)
Seat 5: 2lOU1DcvUZaMcxZ95XfzXw folded before Flop (didn't bet)
Seat 6: ORVqY3rf9X6ANA/8s+On2Q (button) folded on the River



PokerStars Game #59941901442:  Hold'em No Limit ($1/$2) - 2009/07/01 1:49:46 ET
Table 'QxerF7GUfCbl+4a8XaTB2w' 6-max Seat #4 is the button
Seat 1: ZwvXzkkZ3XpMhKfAmVpahw ($273.75 in chips)
Seat 2: 6UGgYbxwWNc+ohObe8vB9w ($39.75 in chips)
Seat 3: 8rZGabKe2DEPdZCbCivZ9Q ($27 in chips)
Seat 4: /PH6Ffnho4Ysm8S3V/oa+w ($53 in chips)
Seat 5: vkfxu8f/jMYKUk6Ly4eujw ($209.05 in chips)
Seat 6: VvdR9F3I+2yELkfTVvC1dg ($213.70 in chips)
vkfxu8f/jMYKUk6Ly4eujw: posts small blind $1
VvdR9F3I+2yELkfTVvC1dg: posts big blind $2
*** HOLE CARDS ***
ZwvXzkkZ3XpMhKfAmVpahw: raises $4 to $6
6UGgYbxwWNc+ohObe8vB9w: folds
8rZGabKe2DEPdZCbCivZ9Q: folds
/PH6Ffnho4Ysm8S3V/oa+w: folds
vkfxu8f/jMYKUk6Ly4eujw: calls $5
VvdR9F3I+2yELkfTVvC1dg: folds
*** FLOP *** [7s Ah 9h]
vkfxu8f/jMYKUk6Ly4eujw: checks
ZwvXzkkZ3XpMhKfAmVpahw: checks
*** TURN *** [7s Ah 9h] [2c]
vkfxu8f/jMYKUk6Ly4eujw: bets $13
ZwvXzkkZ3XpMhKfAmVpahw: calls $13
*** RIVER *** [7s Ah 9h 2c] [Js]
vkfxu8f/jMYKUk6Ly4eujw: bets $38
ZwvXzkkZ3XpMhKfAmVpahw: calls $38
*** SHOW DOWN ***
vkfxu8f/jMYKUk6Ly4eujw: shows [Kc Tc] (high card Ace)
ZwvXzkkZ3XpMhKfAmVpahw: shows [Ac 8c] (a pair of Aces)
ZwvXzkkZ3XpMhKfAmVpahw collected $113 from pot
*** SUMMARY ***
Total pot $116 | Rake $3
Board [7s Ah 9h 2c Js]
Seat 1: ZwvXzkkZ3XpMhKfAmVpahw showed [Ac 8c] and won ($113) with a pair of Aces
Seat 2: 6UGgYbxwWNc+ohObe8vB9w folded before Flop (didn't bet)
Seat 3: 8rZGabKe2DEPdZCbCivZ9Q folded before Flop (didn't bet)
Seat 4: /PH6Ffnho4Ysm8S3V/oa+w (button) folded before Flop (didn't bet)
Seat 5: vkfxu8f/jMYKUk6Ly4eujw (small blind) showed [Kc Tc] and lost with high card Ace
Seat 6: VvdR9F3I+2yELkfTVvC1dg (big blind) folded before Flop



PokerStars Game #59941901664:  Hold'em No Limit ($1/$2) - 2009/07/01 1:49:47 ET
Table '5/wEe6JmtGD7vufSA2RG7A' 2-max Seat #2 is the button
Seat 1: pVqEzK9wXlRMECnb1Zg4Zw ($200 in chips)
Seat 2: aOL8geThaYp2iadSHl1h1g ($198 in chips)
aOL8geThaYp2iadSHl1h1g: posts small blind $1
pVqEzK9wXlRMECnb1Zg4Zw: posts big blind $2
*** HOLE CARDS ***
aOL8geThaYp2iadSHl1h1g: raises $4 to $6
pVqEzK9wXlRMECnb1Zg4Zw: calls $4
*** FLOP *** [9d 4d Qc]
pVqEzK9wXlRMECnb1Zg4Zw: checks
aOL8geThaYp2iadSHl1h1g: checks
*** TURN *** [9d 4d Qc] [5s]
pVqEzK9wXlRMECnb1Zg4Zw: bets $6
aOL8geThaYp2iadSHl1h1g: raises $14 to $20
pVqEzK9wXlRMECnb1Zg4Zw: calls $14
*** RIVER *** [9d 4d Qc 5s] [Ac]
pVqEzK9wXlRMECnb1Zg4Zw: checks
aOL8geThaYp2iadSHl1h1g: checks
*** SHOW DOWN ***
pVqEzK9wXlRMECnb1Zg4Zw: shows [7d 4c] (a pair of Fours)
aOL8geThaYp2iadSHl1h1g: mucks hand
pVqEzK9wXlRMECnb1Zg4Zw collected $51.50 from pot
*** SUMMARY ***
Total pot $52 | Rake $0.50
Board [9d 4d Qc 5s Ac]
Seat 1: pVqEzK9wXlRMECnb1Zg4Zw (big blind) showed [7d 4c] and won ($51.50) with a pair of Fours
Seat 2: aOL8geThaYp2iadSHl1h1g (button) (small blind) mucked



PokerStars Game #59941901636:  Hold'em No Limit ($1/$2) - 2009/07/01 1:49:47 ET
Table 'NmY84NAf9Mh0ckAckHnh5g' 2-max Seat #2 is the button
Seat 1: 6hvg964TSqZ3AL/0XK9aVQ ($621.55 in chips)
Seat 2: RwDoM55ZeQuI2ADyJhOb2Q ($362.55 in chips)
RwDoM55ZeQuI2ADyJhOb2Q: posts small blind $1
6hvg964TSqZ3AL/0XK9aVQ: posts big blind $2
*** HOLE CARDS ***
RwDoM55ZeQuI2ADyJhOb2Q: folds
6hvg964TSqZ3AL/0XK9aVQ collected $2 from pot
6hvg964TSqZ3AL/0XK9aVQ: doesn't show hand
*** SUMMARY ***
Total pot $2 | Rake $0
Seat 1: 6hvg964TSqZ3AL/0XK9aVQ (big blind) collected ($2)
Seat 2: RwDoM55ZeQuI2ADyJhOb2Q (button) (small blind) folded before Flop



PokerStars Game #59941902088:  Hold'em No Limit ($1/$2) - 2009/07/01 1:49:48 ET
Table '+hSnXFQrGw1PlVgTnuj+sA' 6-max Seat #3 is the button
Seat 1: fb8ooqw9ZsZtBsZTZQLNrQ ($54.70 in chips)
Seat 2: 54yWzRRgS0oZ+S6LwZBxMQ ($25.10 in chips)
Seat 3: cupOBdycmBLQKdVftyAksg ($49.10 in chips)
Seat 4: TRSUrOQh3x1NGeD+dH4yoA ($98.10 in chips)
Seat 5: PZzUwZiFNhCLi6Ouh5ZlmQ ($200 in chips)
Seat 6: 7zM38baFvmCNB/F80oE0cQ ($40 in chips)
TRSUrOQh3x1NGeD+dH4yoA: posts small blind $1
PZzUwZiFNhCLi6Ouh5ZlmQ: posts big blind $2
*** HOLE CARDS ***
7zM38baFvmCNB/F80oE0cQ: calls $2
fb8ooqw9ZsZtBsZTZQLNrQ: folds
54yWzRRgS0oZ+S6LwZBxMQ: folds
cupOBdycmBLQKdVftyAksg: folds
TRSUrOQh3x1NGeD+dH4yoA: calls $1
PZzUwZiFNhCLi6Ouh5ZlmQ: checks
*** FLOP *** [Ks 3d 8h]
TRSUrOQh3x1NGeD+dH4yoA: checks
PZzUwZiFNhCLi6Ouh5ZlmQ: checks
7zM38baFvmCNB/F80oE0cQ: bets $2
TRSUrOQh3x1NGeD+dH4yoA: calls $2
PZzUwZiFNhCLi6Ouh5ZlmQ: folds
*** TURN *** [Ks 3d 8h] [7s]
TRSUrOQh3x1NGeD+dH4yoA: checks
7zM38baFvmCNB/F80oE0cQ: bets $2
TRSUrOQh3x1NGeD+dH4yoA: folds
7zM38baFvmCNB/F80oE0cQ collected $9.55 from pot
7zM38baFvmCNB/F80oE0cQ: doesn't show hand
*** SUMMARY ***
Total pot $10 | Rake $0.45
Board [Ks 3d 8h 7s]
Seat 1: fb8ooqw9ZsZtBsZTZQLNrQ folded before Flop (didn't bet)
Seat 2: 54yWzRRgS0oZ+S6LwZBxMQ folded before Flop (didn't bet)
Seat 3: cupOBdycmBLQKdVftyAksg (button) folded before Flop (didn't bet)
Seat 4: TRSUrOQh3x1NGeD+dH4yoA (small blind) folded on the Turn
Seat 5: PZzUwZiFNhCLi6Ouh5ZlmQ (big blind) folded on the Flop
Seat 6: 7zM38baFvmCNB/F80oE0cQ collected ($9.55)



PokerStars Game #59941902198:  Hold'em No Limit ($1/$2) - 2009/07/01 1:49:48 ET
Table 'mGpP9StWRnoeiBDExc6Frg' 6-max Seat #2 is the button
Seat 1: VvdR9F3I+2yELkfTVvC1dg ($311.85 in chips)
Seat 2: 6hRJ68JkbJq6MYI9o5bUnQ ($103 in chips)
Seat 4: 4dcDwIHRm96PwtqkpQiuiA ($89.70 in chips)
Seat 5: d1puGuVBE0fidn+5eRJ0tw ($186.55 in chips)
Seat 6: B2Ih1sr5VZk+8He7rcrMtQ ($405.45 in chips)
7acrZUQC3Zc9BNLjoKIcLQ was removed from the table for failing to post
4dcDwIHRm96PwtqkpQiuiA: posts small blind $1
d1puGuVBE0fidn+5eRJ0tw: posts big blind $2
*** HOLE CARDS ***
B2Ih1sr5VZk+8He7rcrMtQ: folds
VvdR9F3I+2yELkfTVvC1dg: folds
6hRJ68JkbJq6MYI9o5bUnQ: folds
4dcDwIHRm96PwtqkpQiuiA: calls $1
d1puGuVBE0fidn+5eRJ0tw: checks
*** FLOP *** [Ah Js 9c]
4dcDwIHRm96PwtqkpQiuiA: checks
d1puGuVBE0fidn+5eRJ0tw: bets $2
4dcDwIHRm96PwtqkpQiuiA: folds
d1puGuVBE0fidn+5eRJ0tw collected $3.80 from pot
d1puGuVBE0fidn+5eRJ0tw: doesn't show hand
*** SUMMARY ***
Total pot $4 | Rake $0.20
Board [Ah Js 9c]
Seat 1: VvdR9F3I+2yELkfTVvC1dg folded before Flop (didn't bet)
Seat 2: 6hRJ68JkbJq6MYI9o5bUnQ (button) folded before Flop (didn't bet)
Seat 4: 4dcDwIHRm96PwtqkpQiuiA (small blind) folded on the Flop
Seat 5: d1puGuVBE0fidn+5eRJ0tw (big blind) collected ($3.80)
Seat 6: B2Ih1sr5VZk+8He7rcrMtQ folded before Flop (didn't bet)



PokerStars Game #59941902814:  Hold'em No Limit ($1/$2) - 2009/07/01 1:49:49 ET
Table 'BSRfGh+QobUe0AgIMtt/fw' 9-max Seat #3 is the button
Seat 1: gDn/rYeNwCyWEgRhyWp4PA ($159.05 in chips)
Seat 2: +SmnXtdmwqXGEJfLeJDIUQ ($123.90 in chips)
Seat 3: WUlHm+ydPPHG7Lb0rePSdA ($120 in chips)
Seat 4: +T/63sAeZzWyHchahJ36GQ ($32 in chips)
Seat 5: ThVDqrMpsvd7Ax6KINfuew ($64.50 in chips)
Seat 6: H6Z4+qu8gR0VUiPOijndVg ($205 in chips)
Seat 7: CkE3IyJF1KvdaAOmZY5XqQ ($200 in chips)
Seat 8: GG5lTuGt3+kwNYSbqeB6yw ($78.85 in chips)
Seat 9: tjgwwDmi+N2H4I7hx8useQ ($80 in chips)
+T/63sAeZzWyHchahJ36GQ: posts small blind $1
ThVDqrMpsvd7Ax6KINfuew: posts big blind $2
tjgwwDmi+N2H4I7hx8useQ: posts big blind $2
*** HOLE CARDS ***
H6Z4+qu8gR0VUiPOijndVg: folds
CkE3IyJF1KvdaAOmZY5XqQ: raises $6 to $8
GG5lTuGt3+kwNYSbqeB6yw: folds
tjgwwDmi+N2H4I7hx8useQ: folds
gDn/rYeNwCyWEgRhyWp4PA: folds
+SmnXtdmwqXGEJfLeJDIUQ: folds
WUlHm+ydPPHG7Lb0rePSdA: folds
+T/63sAeZzWyHchahJ36GQ: folds
ThVDqrMpsvd7Ax6KINfuew: folds
CkE3IyJF1KvdaAOmZY5XqQ collected $7 from pot
*** SUMMARY ***
Total pot $7 | Rake $0
Seat 1: gDn/rYeNwCyWEgRhyWp4PA folded before Flop (didn't bet)
Seat 2: +SmnXtdmwqXGEJfLeJDIUQ folded before Flop (didn't bet)
Seat 3: WUlHm+ydPPHG7Lb0rePSdA (button) folded before Flop (didn't bet)
Seat 4: +T/63sAeZzWyHchahJ36GQ (small blind) folded before Flop
Seat 5: ThVDqrMpsvd7Ax6KINfuew (big blind) folded before Flop
Seat 6: H6Z4+qu8gR0VUiPOijndVg folded before Flop (didn't bet)
Seat 7: CkE3IyJF1KvdaAOmZY5XqQ collected ($7)
Seat 8: GG5lTuGt3+kwNYSbqeB6yw folded before Flop (didn't bet)
Seat 9: tjgwwDmi+N2H4I7hx8useQ folded before Flop



PokerStars Game #59941904490:  Hold'em No Limit ($1/$2) - 2009/07/01 1:49:52 ET
Table 'G1Oqdy4Pqdb5gtx40rUBzA' 6-max Seat #1 is the button
Seat 1: 4dMBh/1VTdeUTPCyhCs3UQ ($63.70 in chips)
Seat 2: m7mYVfnCOK5TE/VkN/FhOg ($210.05 in chips)
Seat 3: VvdR9F3I+2yELkfTVvC1dg ($419.90 in chips)
Seat 4: B87ikIyZ/TzAVeXf38Ny0g ($224.70 in chips)
Seat 5: F1+Ml47qRQWunzPnGhLLzQ ($197 in chips)
Seat 6: qCnEYuAE5y5A7bk6fO5/jQ ($200 in chips)
m7mYVfnCOK5TE/VkN/FhOg: posts small blind $1
VvdR9F3I+2yELkfTVvC1dg: posts big blind $2
*** HOLE CARDS ***
B87ikIyZ/TzAVeXf38Ny0g: folds
F1+Ml47qRQWunzPnGhLLzQ: folds
qCnEYuAE5y5A7bk6fO5/jQ: raises $4 to $6
4dMBh/1VTdeUTPCyhCs3UQ: folds
m7mYVfnCOK5TE/VkN/FhOg: folds
VvdR9F3I+2yELkfTVvC1dg: folds
qCnEYuAE5y5A7bk6fO5/jQ collected $5 from pot
qCnEYuAE5y5A7bk6fO5/jQ: doesn't show hand
*** SUMMARY ***
Total pot $5 | Rake $0
Seat 1: 4dMBh/1VTdeUTPCyhCs3UQ (button) folded before Flop (didn't bet)
Seat 2: m7mYVfnCOK5TE/VkN/FhOg (small blind) folded before Flop
Seat 3: VvdR9F3I+2yELkfTVvC1dg (big blind) folded before Flop
Seat 4: B87ikIyZ/TzAVeXf38Ny0g folded before Flop (didn't bet)
Seat 5: F1+Ml47qRQWunzPnGhLLzQ folded before Flop (didn't bet)
Seat 6: qCnEYuAE5y5A7bk6fO5/jQ collected ($5)



PokerStars Game #59941905006:  Hold'em No Limit ($1/$2) - 2009/07/01 1:49:53 ET
Table 'W9UeSV0aoPjh5SFSxM8jUQ' 9-max Seat #9 is the button
Seat 1: mIKx5lhIt13X5eZQH0ZeMA ($8.85 in chips)
Seat 2: KqHysDSpCPaPyK3tJC1aEw ($217.05 in chips)
Seat 4: 4YA/sQy1Emm680zhbPUjow ($149.60 in chips)
Seat 5: ri8CLkX3e9JF34dQNbsHGA ($82 in chips)
Seat 6: 254YPxPJr5Sw58bkD0YqYQ ($200 in chips)
Seat 7: TAfo4veNRaRlzDXMMYS3Jg ($39 in chips)
Seat 8: odhvI/CZeMsPyo1n1U7+hA ($45.40 in chips)
Seat 9: Q104K4iDGcqOlVrjAkzPEA ($104.55 in chips)
mIKx5lhIt13X5eZQH0ZeMA: posts small blind $1
KqHysDSpCPaPyK3tJC1aEw: posts big blind $2
ItDFe9gh5QYPQB9vC4ntUA: sits out
*** HOLE CARDS ***
4YA/sQy1Emm680zhbPUjow: folds
ri8CLkX3e9JF34dQNbsHGA: folds
254YPxPJr5Sw58bkD0YqYQ: folds
TAfo4veNRaRlzDXMMYS3Jg: folds
odhvI/CZeMsPyo1n1U7+hA: calls $2
Q104K4iDGcqOlVrjAkzPEA: folds
mIKx5lhIt13X5eZQH0ZeMA: calls $1
KqHysDSpCPaPyK3tJC1aEw: checks
*** FLOP *** [6h 4s 9h]
mIKx5lhIt13X5eZQH0ZeMA: checks
KqHysDSpCPaPyK3tJC1aEw: checks
odhvI/CZeMsPyo1n1U7+hA: bets $2
mIKx5lhIt13X5eZQH0ZeMA: folds
KqHysDSpCPaPyK3tJC1aEw: folds
odhvI/CZeMsPyo1n1U7+hA collected $5.70 from pot
*** SUMMARY ***
Total pot $6 | Rake $0.30
Board [6h 4s 9h]
Seat 1: mIKx5lhIt13X5eZQH0ZeMA (small blind) folded on the Flop
Seat 2: KqHysDSpCPaPyK3tJC1aEw (big blind) folded on the Flop
Seat 4: 4YA/sQy1Emm680zhbPUjow folded before Flop (didn't bet)
Seat 5: ri8CLkX3e9JF34dQNbsHGA folded before Flop (didn't bet)
Seat 6: 254YPxPJr5Sw58bkD0YqYQ folded before Flop (didn't bet)
Seat 7: TAfo4veNRaRlzDXMMYS3Jg folded before Flop (didn't bet)
Seat 8: odhvI/CZeMsPyo1n1U7+hA collected ($5.70)
Seat 9: Q104K4iDGcqOlVrjAkzPEA (button) folded before Flop (didn't bet)



PokerStars Game #59941904738:  Hold'em No Limit ($1/$2) - 2009/07/01 1:49:53 ET
Table 'NmY84NAf9Mh0ckAckHnh5g' 2-max Seat #1 is the button
Seat 1: 6hvg964TSqZ3AL/0XK9aVQ ($622.55 in chips)
Seat 2: RwDoM55ZeQuI2ADyJhOb2Q ($361.55 in chips)
6hvg964TSqZ3AL/0XK9aVQ: posts small blind $1
RwDoM55ZeQuI2ADyJhOb2Q: posts big blind $2
*** HOLE CARDS ***
6hvg964TSqZ3AL/0XK9aVQ: calls $1
RwDoM55ZeQuI2ADyJhOb2Q: checks
*** FLOP *** [3d Qh Kh]
RwDoM55ZeQuI2ADyJhOb2Q: checks
6hvg964TSqZ3AL/0XK9aVQ: bets $4
RwDoM55ZeQuI2ADyJhOb2Q: folds
6hvg964TSqZ3AL/0XK9aVQ collected $3.80 from pot
6hvg964TSqZ3AL/0XK9aVQ: doesn't show hand
*** SUMMARY ***
Total pot $4 | Rake $0.20
Board [3d Qh Kh]
Seat 1: 6hvg964TSqZ3AL/0XK9aVQ (button) (small blind) collected ($3.80)
Seat 2: RwDoM55ZeQuI2ADyJhOb2Q (big blind) folded on the Flop



PokerStars Game #59941905338:  Hold'em No Limit ($1/$2) - 2009/07/01 1:49:54 ET
Table '/dyk+YdRGv90j2box35j8w' 6-max Seat #5 is the button
Seat 1: 8srN1dKQePlsv0GyTada+Q ($200 in chips)
Seat 2: qCnEYuAE5y5A7bk6fO5/jQ ($502.20 in chips)
Seat 3: sTPOWERd9HWPCNrDBwsVjA ($200.50 in chips)
Seat 4: 4dMBh/1VTdeUTPCyhCs3UQ ($31.75 in chips)
Seat 5: VvdR9F3I+2yELkfTVvC1dg ($291.80 in chips)
8srN1dKQePlsv0GyTada+Q: posts small blind $1
qCnEYuAE5y5A7bk6fO5/jQ: posts big blind $2
*** HOLE CARDS ***
sTPOWERd9HWPCNrDBwsVjA: folds
4dMBh/1VTdeUTPCyhCs3UQ: folds
VvdR9F3I+2yELkfTVvC1dg: raises $2 to $4
8srN1dKQePlsv0GyTada+Q: folds
qCnEYuAE5y5A7bk6fO5/jQ: folds
VvdR9F3I+2yELkfTVvC1dg collected $5 from pot
VvdR9F3I+2yELkfTVvC1dg: doesn't show hand
*** SUMMARY ***
Total pot $5 | Rake $0
Seat 1: 8srN1dKQePlsv0GyTada+Q (small blind) folded before Flop
Seat 2: qCnEYuAE5y5A7bk6fO5/jQ (big blind) folded before Flop
Seat 3: sTPOWERd9HWPCNrDBwsVjA folded before Flop (didn't bet)
Seat 4: 4dMBh/1VTdeUTPCyhCs3UQ folded before Flop (didn't bet)
Seat 5: VvdR9F3I+2yELkfTVvC1dg (button) collected ($5)



PokerStars Game #59941905962:  Hold'em No Limit ($1/$2) - 2009/07/01 1:49:55 ET
Table 'bJQ024BaYSBrW0sXpCZbNQ' 6-max Seat #6 is the button
Seat 1: KfwW5us6tydK81NYTtK1gw ($208.75 in chips)
Seat 2: 3dAbvkxS5NPQTBAbvpinVg ($267 in chips)
Seat 4: vkfxu8f/jMYKUk6Ly4eujw ($227.05 in chips)
Seat 5: VvdR9F3I+2yELkfTVvC1dg ($200 in chips)
Seat 6: 4bqvCfJ0e8CTYnn0Go9hbQ ($138.50 in chips)
KfwW5us6tydK81NYTtK1gw: posts small blind $1
3dAbvkxS5NPQTBAbvpinVg: posts big blind $2
*** HOLE CARDS ***
qxFMu+hmWxnODLXQBD5Oww joins the table at seat #3
vkfxu8f/jMYKUk6Ly4eujw: folds
VvdR9F3I+2yELkfTVvC1dg: raises $2 to $4
4bqvCfJ0e8CTYnn0Go9hbQ: folds
KfwW5us6tydK81NYTtK1gw: folds
3dAbvkxS5NPQTBAbvpinVg: folds
VvdR9F3I+2yELkfTVvC1dg collected $5 from pot
VvdR9F3I+2yELkfTVvC1dg: doesn't show hand
*** SUMMARY ***
Total pot $5 | Rake $0
Seat 1: KfwW5us6tydK81NYTtK1gw (small blind) folded before Flop
Seat 2: 3dAbvkxS5NPQTBAbvpinVg (big blind) folded before Flop
Seat 4: vkfxu8f/jMYKUk6Ly4eujw folded before Flop (didn't bet)
Seat 5: VvdR9F3I+2yELkfTVvC1dg collected ($5)
Seat 6: 4bqvCfJ0e8CTYnn0Go9hbQ (button) folded before Flop (didn't bet)



PokerStars Game #59941906068:  Hold'em No Limit ($1/$2) - 2009/07/01 1:49:55 ET
Table 'ztv6V3FN2bQ9nmJPPdx6nQ' 6-max Seat #4 is the button
Seat 1: 6fLdOUCRtX71xbVRhJEq8w ($300.35 in chips)
Seat 2: 5Y+ZGWLI4gnlpApDX5vy1A ($409.65 in chips)
Seat 4: UaZ5yj+6LjtWqMQg2QskUw ($75.55 in chips)
Seat 5: sTPOWERd9HWPCNrDBwsVjA ($217.60 in chips)
Seat 6: mfy7uGZcqA2PVQqEVbJ7+g ($43.60 in chips)
sTPOWERd9HWPCNrDBwsVjA: posts small blind $1
mfy7uGZcqA2PVQqEVbJ7+g: posts big blind $2
*** HOLE CARDS ***
6fLdOUCRtX71xbVRhJEq8w: folds
5Y+ZGWLI4gnlpApDX5vy1A: raises $6 to $8
UaZ5yj+6LjtWqMQg2QskUw: folds
sTPOWERd9HWPCNrDBwsVjA: folds
mfy7uGZcqA2PVQqEVbJ7+g: folds
5Y+ZGWLI4gnlpApDX5vy1A collected $5 from pot
5Y+ZGWLI4gnlpApDX5vy1A: doesn't show hand
*** SUMMARY ***
Total pot $5 | Rake $0
Seat 1: 6fLdOUCRtX71xbVRhJEq8w folded before Flop (didn't bet)
Seat 2: 5Y+ZGWLI4gnlpApDX5vy1A collected ($5)
Seat 4: UaZ5yj+6LjtWqMQg2QskUw (button) folded before Flop (didn't bet)
Seat 5: sTPOWERd9HWPCNrDBwsVjA (small blind) folded before Flop
Seat 6: mfy7uGZcqA2PVQqEVbJ7+g (big blind) folded before Flop



PokerStars Game #59941908430:  Hold'em No Limit ($1/$2) - 2009/07/01 1:50:00 ET
Table 'aSf77Sj8QEnzcc0WaxVD4Q' 6-max Seat #6 is the button
Seat 1: UELtvp+JfwI7XDGVwSxZXA ($179.05 in chips)
Seat 2: vkfxu8f/jMYKUk6Ly4eujw ($191.10 in chips)
Seat 3: 9dpyyjDTCed6nV7JhaUUpw ($760.50 in chips)
Seat 5: VvdR9F3I+2yELkfTVvC1dg ($301.70 in chips)
Seat 6: vkoJRf3gidxY1pPi0AFWww ($156.40 in chips)
UELtvp+JfwI7XDGVwSxZXA: posts small blind $1
vkfxu8f/jMYKUk6Ly4eujw: posts big blind $2
YsLQ3BAvgQHWXMAv3Wv6Hg: sits out
*** HOLE CARDS ***
9dpyyjDTCed6nV7JhaUUpw: folds
VvdR9F3I+2yELkfTVvC1dg: folds
vkoJRf3gidxY1pPi0AFWww: raises $2 to $4
UELtvp+JfwI7XDGVwSxZXA: calls $3
vkfxu8f/jMYKUk6Ly4eujw: calls $2
*** FLOP *** [Tc 9c 9s]
UELtvp+JfwI7XDGVwSxZXA: checks
vkfxu8f/jMYKUk6Ly4eujw: checks
vkoJRf3gidxY1pPi0AFWww: checks
*** TURN *** [Tc 9c 9s] [8s]
UELtvp+JfwI7XDGVwSxZXA: checks
vkfxu8f/jMYKUk6Ly4eujw: checks
vkoJRf3gidxY1pPi0AFWww: bets $6
UELtvp+JfwI7XDGVwSxZXA: calls $6
vkfxu8f/jMYKUk6Ly4eujw: folds
*** RIVER *** [Tc 9c 9s 8s] [6h]
UELtvp+JfwI7XDGVwSxZXA: checks
vkoJRf3gidxY1pPi0AFWww: checks
*** SHOW DOWN ***
UELtvp+JfwI7XDGVwSxZXA: shows [Jh 8d] (two pair, Nines and Eights)
vkoJRf3gidxY1pPi0AFWww: shows [Qs 7s] (a straight, Six to Ten)
vkoJRf3gidxY1pPi0AFWww collected $22.85 from pot
*** SUMMARY ***
Total pot $24 | Rake $1.15
Board [Tc 9c 9s 8s 6h]
Seat 1: UELtvp+JfwI7XDGVwSxZXA (small blind) showed [Jh 8d] and lost with two pair, Nines and Eights
Seat 2: vkfxu8f/jMYKUk6Ly4eujw (big blind) folded on the Turn
Seat 3: 9dpyyjDTCed6nV7JhaUUpw folded before Flop (didn't bet)
Seat 5: VvdR9F3I+2yELkfTVvC1dg folded before Flop (didn't bet)
Seat 6: vkoJRf3gidxY1pPi0AFWww (button) showed [Qs 7s] and won ($22.85) with a straight, Six to Ten



PokerStars Game #59941908866:  Hold'em No Limit ($1/$2) - 2009/07/01 1:50:01 ET
Table 'ZzSIe0zTCDv+n6hfbY5tTg' 6-max Seat #2 is the button
Seat 1: VvdR9F3I+2yELkfTVvC1dg ($266.35 in chips)
Seat 2: B87ikIyZ/TzAVeXf38Ny0g ($225 in chips)
Seat 3: gsugPj31Hui3Jefl98MBOA ($363 in chips)
Seat 4: 54yWzRRgS0oZ+S6LwZBxMQ ($46.10 in chips)
Seat 5: 3dAbvkxS5NPQTBAbvpinVg ($484.45 in chips)
Seat 6: 09BNF4quPDzanQzM8vc6WA ($36 in chips)
gsugPj31Hui3Jefl98MBOA: posts small blind $1
54yWzRRgS0oZ+S6LwZBxMQ: posts big blind $2
*** HOLE CARDS ***
3dAbvkxS5NPQTBAbvpinVg: folds
09BNF4quPDzanQzM8vc6WA: folds
VvdR9F3I+2yELkfTVvC1dg: folds
B87ikIyZ/TzAVeXf38Ny0g: folds
gsugPj31Hui3Jefl98MBOA: folds
54yWzRRgS0oZ+S6LwZBxMQ collected $2 from pot
54yWzRRgS0oZ+S6LwZBxMQ: doesn't show hand
*** SUMMARY ***
Total pot $2 | Rake $0
Seat 1: VvdR9F3I+2yELkfTVvC1dg folded before Flop (didn't bet)
Seat 2: B87ikIyZ/TzAVeXf38Ny0g (button) folded before Flop (didn't bet)
Seat 3: gsugPj31Hui3Jefl98MBOA (small blind) folded before Flop
Seat 4: 54yWzRRgS0oZ+S6LwZBxMQ (big blind) collected ($2)
Seat 5: 3dAbvkxS5NPQTBAbvpinVg folded before Flop (didn't bet)
Seat 6: 09BNF4quPDzanQzM8vc6WA folded before Flop (didn't bet)



PokerStars Game #59941908756:  Hold'em No Limit ($1/$2) - 2009/07/01 1:50:01 ET
Table 'rsKRKlGHlxVyqJxzO2a2Ow' 9-max Seat #5 is the button
Seat 1: KqHysDSpCPaPyK3tJC1aEw ($212.30 in chips)
Seat 2: +T/63sAeZzWyHchahJ36GQ ($83 in chips)
Seat 3: kM9CA+2UcdMjbCMbtUCGiA ($225.10 in chips)
Seat 4: 31HuO+DQxppUQEedBWukug ($108.85 in chips)
Seat 5: 5Q8U6iZbeO7xJSS4qvDP5g ($245.30 in chips)
Seat 6: H6Z4+qu8gR0VUiPOijndVg ($200 in chips)
Seat 7: GX1heJ+DSsvm7gzSPsYhhQ ($56 in chips)
Seat 8: CkE3IyJF1KvdaAOmZY5XqQ ($209.70 in chips)
Seat 9: gRbvhSUVg+TNaTjaJecIRw ($50.60 in chips)
H6Z4+qu8gR0VUiPOijndVg: posts small blind $1
GX1heJ+DSsvm7gzSPsYhhQ: posts big blind $2
*** HOLE CARDS ***
CkE3IyJF1KvdaAOmZY5XqQ: folds
gRbvhSUVg+TNaTjaJecIRw: folds
KqHysDSpCPaPyK3tJC1aEw: folds
+T/63sAeZzWyHchahJ36GQ: raises $4 to $6
kM9CA+2UcdMjbCMbtUCGiA: folds
31HuO+DQxppUQEedBWukug: folds
5Q8U6iZbeO7xJSS4qvDP5g: folds
H6Z4+qu8gR0VUiPOijndVg: folds
GX1heJ+DSsvm7gzSPsYhhQ: folds
+T/63sAeZzWyHchahJ36GQ collected $5 from pot
+T/63sAeZzWyHchahJ36GQ: doesn't show hand
*** SUMMARY ***
Total pot $5 | Rake $0
Seat 1: KqHysDSpCPaPyK3tJC1aEw folded before Flop (didn't bet)
Seat 2: +T/63sAeZzWyHchahJ36GQ collected ($5)
Seat 3: kM9CA+2UcdMjbCMbtUCGiA folded before Flop (didn't bet)
Seat 4: 31HuO+DQxppUQEedBWukug folded before Flop (didn't bet)
Seat 5: 5Q8U6iZbeO7xJSS4qvDP5g (button) folded before Flop (didn't bet)
Seat 6: H6Z4+qu8gR0VUiPOijndVg (small blind) folded before Flop
Seat 7: GX1heJ+DSsvm7gzSPsYhhQ (big blind) folded before Flop
Seat 8: CkE3IyJF1KvdaAOmZY5XqQ folded before Flop (didn't bet)
Seat 9: gRbvhSUVg+TNaTjaJecIRw folded before Flop (didn't bet)



PokerStars Game #59941910028:  Hold'em No Limit ($1/$2) - 2009/07/01 1:50:03 ET
Table 'UGLAZZyv+cXmnKjYin0etA' 6-max Seat #5 is the button
Seat 2: eDLH1PUXFpvJBNMXBVQcGA ($304.10 in chips)
Seat 4: SiGJDsvRViJX05vHhA80GQ ($240.30 in chips)
Seat 5: 54yWzRRgS0oZ+S6LwZBxMQ ($37.80 in chips)
Seat 6: sTPOWERd9HWPCNrDBwsVjA ($213.95 in chips)
sTPOWERd9HWPCNrDBwsVjA: posts small blind $1
eDLH1PUXFpvJBNMXBVQcGA: posts big blind $2
*** HOLE CARDS ***
SiGJDsvRViJX05vHhA80GQ: folds
54yWzRRgS0oZ+S6LwZBxMQ: folds
rL+Zpv4/vX2BVHcyfh/NXA joins the table at seat #1
sTPOWERd9HWPCNrDBwsVjA: raises $4 to $6
eDLH1PUXFpvJBNMXBVQcGA: raises $14 to $20
sTPOWERd9HWPCNrDBwsVjA: folds
eDLH1PUXFpvJBNMXBVQcGA collected $12 from pot
*** SUMMARY ***
Total pot $12 | Rake $0
Seat 2: eDLH1PUXFpvJBNMXBVQcGA (big blind) collected ($12)
Seat 4: SiGJDsvRViJX05vHhA80GQ folded before Flop (didn't bet)
Seat 5: 54yWzRRgS0oZ+S6LwZBxMQ (button) folded before Flop (didn't bet)
Seat 6: sTPOWERd9HWPCNrDBwsVjA (small blind) folded before Flop



PokerStars Game #59941911094:  Hold'em No Limit ($1/$2) - 2009/07/01 1:50:05 ET
Table 'kq5zaQ+1hLNf8LZfGnbTAA' 6-max Seat #6 is the button
Seat 1: 8srN1dKQePlsv0GyTada+Q ($417.60 in chips)
Seat 2: nXDI8Y/S6POzRwANu3d8hQ ($143 in chips)
Seat 3: /PH6Ffnho4Ysm8S3V/oa+w ($58.15 in chips)
Seat 4: 3dAbvkxS5NPQTBAbvpinVg ($272.65 in chips)
Seat 5: BWhgxe7gWiYobRbwdG+d2Q ($196 in chips)
Seat 6: mfy7uGZcqA2PVQqEVbJ7+g ($194.15 in chips)
8srN1dKQePlsv0GyTada+Q: posts small blind $1
nXDI8Y/S6POzRwANu3d8hQ: posts big blind $2
*** HOLE CARDS ***
/PH6Ffnho4Ysm8S3V/oa+w: folds
3dAbvkxS5NPQTBAbvpinVg: raises $4 to $6
BWhgxe7gWiYobRbwdG+d2Q: folds
mfy7uGZcqA2PVQqEVbJ7+g: folds
8srN1dKQePlsv0GyTada+Q: folds
nXDI8Y/S6POzRwANu3d8hQ: folds
3dAbvkxS5NPQTBAbvpinVg collected $5 from pot
3dAbvkxS5NPQTBAbvpinVg: doesn't show hand
*** SUMMARY ***
Total pot $5 | Rake $0
Seat 1: 8srN1dKQePlsv0GyTada+Q (small blind) folded before Flop
Seat 2: nXDI8Y/S6POzRwANu3d8hQ (big blind) folded before Flop
Seat 3: /PH6Ffnho4Ysm8S3V/oa+w folded before Flop (didn't bet)
Seat 4: 3dAbvkxS5NPQTBAbvpinVg collected ($5)
Seat 5: BWhgxe7gWiYobRbwdG+d2Q folded before Flop (didn't bet)
Seat 6: mfy7uGZcqA2PVQqEVbJ7+g (button) folded before Flop (didn't bet)



PokerStars Game #59941912384:  Hold'em No Limit ($1/$2) - 2009/07/01 1:50:08 ET
Table 'C4lkCXY2PWy6z4vsAe5NGQ' 6-max Seat #2 is the button
Seat 2: 6hRJ68JkbJq6MYI9o5bUnQ ($60.95 in chips)
Seat 3: sTPOWERd9HWPCNrDBwsVjA ($131.80 in chips)
Seat 4: VvdR9F3I+2yELkfTVvC1dg ($207 in chips)
Seat 5: /PH6Ffnho4Ysm8S3V/oa+w ($56.15 in chips)
Seat 6: B87ikIyZ/TzAVeXf38Ny0g ($721.75 in chips)
sTPOWERd9HWPCNrDBwsVjA: posts small blind $1
VvdR9F3I+2yELkfTVvC1dg: posts big blind $2
*** HOLE CARDS ***
/PH6Ffnho4Ysm8S3V/oa+w: folds
B87ikIyZ/TzAVeXf38Ny0g: folds
6hRJ68JkbJq6MYI9o5bUnQ: calls $2
sTPOWERd9HWPCNrDBwsVjA: calls $1
VvdR9F3I+2yELkfTVvC1dg: checks
*** FLOP *** [Qs Js 2c]
sTPOWERd9HWPCNrDBwsVjA: checks
VvdR9F3I+2yELkfTVvC1dg: checks
6hRJ68JkbJq6MYI9o5bUnQ: checks
*** TURN *** [Qs Js 2c] [8h]
sTPOWERd9HWPCNrDBwsVjA: checks
VvdR9F3I+2yELkfTVvC1dg: checks
6hRJ68JkbJq6MYI9o5bUnQ: checks
*** RIVER *** [Qs Js 2c 8h] [9d]
sTPOWERd9HWPCNrDBwsVjA: checks
VvdR9F3I+2yELkfTVvC1dg: checks
6hRJ68JkbJq6MYI9o5bUnQ: checks
*** SHOW DOWN ***
sTPOWERd9HWPCNrDBwsVjA: shows [6c 6s] (a pair of Sixes)
VvdR9F3I+2yELkfTVvC1dg: mucks hand
6hRJ68JkbJq6MYI9o5bUnQ: mucks hand
sTPOWERd9HWPCNrDBwsVjA collected $5.70 from pot
*** SUMMARY ***
Total pot $6 | Rake $0.30
Board [Qs Js 2c 8h 9d]
Seat 2: 6hRJ68JkbJq6MYI9o5bUnQ (button) mucked
Seat 3: sTPOWERd9HWPCNrDBwsVjA (small blind) showed [6c 6s] and won ($5.70) with a pair of Sixes
Seat 4: VvdR9F3I+2yELkfTVvC1dg (big blind) mucked
Seat 5: /PH6Ffnho4Ysm8S3V/oa+w folded before Flop (didn't bet)
Seat 6: B87ikIyZ/TzAVeXf38Ny0g folded before Flop (didn't bet)



PokerStars Game #59941913068:  Hold'em No Limit ($1/$2) - 2009/07/01 1:50:09 ET
Table '3WCXyaiCAbqSShQu7FIjvA' 9-max Seat #3 is the button
Seat 1: kTCkABD1UUldS9DFRGfCwQ ($134.75 in chips)
Seat 3: 5Q8U6iZbeO7xJSS4qvDP5g ($267.25 in chips)
Seat 4: waEF/+pxZTxNo4FvsORuXg ($104.40 in chips)
Seat 5: CkE3IyJF1KvdaAOmZY5XqQ ($210.90 in chips)
Seat 6: 5jQlngvMSqM/WoonOcR5kw ($285 in chips)
Seat 7: nXDI8Y/S6POzRwANu3d8hQ ($44.10 in chips)
Seat 8: +T/63sAeZzWyHchahJ36GQ ($37 in chips)
Seat 9: FiXPLJyqb24l32QST2TInw ($103.80 in chips)
waEF/+pxZTxNo4FvsORuXg: posts small blind $1
CkE3IyJF1KvdaAOmZY5XqQ: posts big blind $2
254YPxPJr5Sw58bkD0YqYQ: sits out
*** HOLE CARDS ***
5jQlngvMSqM/WoonOcR5kw: folds
nXDI8Y/S6POzRwANu3d8hQ: folds
+T/63sAeZzWyHchahJ36GQ: folds
FiXPLJyqb24l32QST2TInw: folds
kTCkABD1UUldS9DFRGfCwQ: raises $2 to $4
5Q8U6iZbeO7xJSS4qvDP5g: folds
waEF/+pxZTxNo4FvsORuXg: folds
CkE3IyJF1KvdaAOmZY5XqQ: folds
kTCkABD1UUldS9DFRGfCwQ collected $5 from pot
kTCkABD1UUldS9DFRGfCwQ: doesn't show hand
*** SUMMARY ***
Total pot $5 | Rake $0
Seat 1: kTCkABD1UUldS9DFRGfCwQ collected ($5)
Seat 3: 5Q8U6iZbeO7xJSS4qvDP5g (button) folded before Flop (didn't bet)
Seat 4: waEF/+pxZTxNo4FvsORuXg (small blind) folded before Flop
Seat 5: CkE3IyJF1KvdaAOmZY5XqQ (big blind) folded before Flop
Seat 6: 5jQlngvMSqM/WoonOcR5kw folded before Flop (didn't bet)
Seat 7: nXDI8Y/S6POzRwANu3d8hQ folded before Flop (didn't bet)
Seat 8: +T/63sAeZzWyHchahJ36GQ folded before Flop (didn't bet)
Seat 9: FiXPLJyqb24l32QST2TInw folded before Flop (didn't bet)



PokerStars Game #59941913692:  Hold'em No Limit ($1/$2) - 2009/07/01 1:50:10 ET
Table 'TsEDkiO4tzCTCzJ7tNdEqw' 6-max Seat #4 is the button
Seat 2: 4dcDwIHRm96PwtqkpQiuiA ($76.65 in chips)
Seat 3: ubtx4Z5L+AcK71MTvYiGVw ($211.20 in chips)
Seat 4: K8MXCrNAVYlMnnCeM32Kxw ($121.35 in chips)
Seat 5: VvdR9F3I+2yELkfTVvC1dg ($244.35 in chips)
Seat 6: uCqEjnxh2/vFBjKYkfTOkw ($287.80 in chips)
VvdR9F3I+2yELkfTVvC1dg: posts small blind $1
uCqEjnxh2/vFBjKYkfTOkw: posts big blind $2
*** HOLE CARDS ***
4dcDwIHRm96PwtqkpQiuiA: calls $2
ubtx4Z5L+AcK71MTvYiGVw: folds
K8MXCrNAVYlMnnCeM32Kxw: folds
VvdR9F3I+2yELkfTVvC1dg: folds
uCqEjnxh2/vFBjKYkfTOkw: checks
*** FLOP *** [Ac Js 5s]
uCqEjnxh2/vFBjKYkfTOkw: checks
4dcDwIHRm96PwtqkpQiuiA: checks
*** TURN *** [Ac Js 5s] [As]
uCqEjnxh2/vFBjKYkfTOkw: checks
4dcDwIHRm96PwtqkpQiuiA: checks
*** RIVER *** [Ac Js 5s As] [6c]
uCqEjnxh2/vFBjKYkfTOkw: checks
4dcDwIHRm96PwtqkpQiuiA: checks
*** SHOW DOWN ***
uCqEjnxh2/vFBjKYkfTOkw: shows [3h 4c] (a pair of Aces)
4dcDwIHRm96PwtqkpQiuiA: shows [3s 3c] (two pair, Aces and Threes)
4dcDwIHRm96PwtqkpQiuiA collected $4.75 from pot
*** SUMMARY ***
Total pot $5 | Rake $0.25
Board [Ac Js 5s As 6c]
Seat 2: 4dcDwIHRm96PwtqkpQiuiA showed [3s 3c] and won ($4.75) with two pair, Aces and Threes
Seat 3: ubtx4Z5L+AcK71MTvYiGVw folded before Flop (didn't bet)
Seat 4: K8MXCrNAVYlMnnCeM32Kxw (button) folded before Flop (didn't bet)
Seat 5: VvdR9F3I+2yELkfTVvC1dg (small blind) folded before Flop
Seat 6: uCqEjnxh2/vFBjKYkfTOkw (big blind) showed [3h 4c] and lost with a pair of Aces



PokerStars Game #59941913448:  Hold'em No Limit ($1/$2) - 2009/07/01 1:50:10 ET
Table 'NmY84NAf9Mh0ckAckHnh5g' 2-max Seat #2 is the button
Seat 1: 6hvg964TSqZ3AL/0XK9aVQ ($624.35 in chips)
Seat 2: RwDoM55ZeQuI2ADyJhOb2Q ($359.55 in chips)
RwDoM55ZeQuI2ADyJhOb2Q: posts small blind $1
6hvg964TSqZ3AL/0XK9aVQ: posts big blind $2
*** HOLE CARDS ***
RwDoM55ZeQuI2ADyJhOb2Q: raises $4 to $6
6hvg964TSqZ3AL/0XK9aVQ: calls $4
*** FLOP *** [6h 9s 9h]
6hvg964TSqZ3AL/0XK9aVQ: checks
RwDoM55ZeQuI2ADyJhOb2Q: checks
*** TURN *** [6h 9s 9h] [Kh]
6hvg964TSqZ3AL/0XK9aVQ: bets $6
RwDoM55ZeQuI2ADyJhOb2Q: calls $6
*** RIVER *** [6h 9s 9h Kh] [Th]
6hvg964TSqZ3AL/0XK9aVQ: checks
RwDoM55ZeQuI2ADyJhOb2Q: checks
*** SHOW DOWN ***
6hvg964TSqZ3AL/0XK9aVQ: shows [6s Js] (two pair, Nines and Sixes)
RwDoM55ZeQuI2ADyJhOb2Q: shows [7h Qd] (a flush, King high)
RwDoM55ZeQuI2ADyJhOb2Q collected $23.50 from pot
*** SUMMARY ***
Total pot $24 | Rake $0.50
Board [6h 9s 9h Kh Th]
Seat 1: 6hvg964TSqZ3AL/0XK9aVQ (big blind) showed [6s Js] and lost with two pair, Nines and Sixes
Seat 2: RwDoM55ZeQuI2ADyJhOb2Q (button) (small blind) showed [7h Qd] and won ($23.50) with a flush, King high



PokerStars Game #59941915340:  Hold'em No Limit ($1/$2) - 2009/07/01 1:50:14 ET
Table 'gnHBqWll9O3fxG7Ojkz/ng' 9-max Seat #9 is the button
Seat 2: H6Z4+qu8gR0VUiPOijndVg ($328.30 in chips)
Seat 3: 5Q8U6iZbeO7xJSS4qvDP5g ($241.10 in chips)
Seat 4: nXDI8Y/S6POzRwANu3d8hQ ($16 in chips)
Seat 5: rBQDMkKm9cZn6M9NPsiVew ($169.15 in chips)
Seat 6: KqHysDSpCPaPyK3tJC1aEw ($200 in chips)
Seat 7: 254YPxPJr5Sw58bkD0YqYQ ($200 in chips)
Seat 8: cM6efHzdxoqYm0EQKP4TTQ ($110.95 in chips)
Seat 9: GX1heJ+DSsvm7gzSPsYhhQ ($46.15 in chips)
MtdNf9cdM7+0CSU0dx4USA will be allowed to play after the button
H6Z4+qu8gR0VUiPOijndVg: posts small blind $1
5Q8U6iZbeO7xJSS4qvDP5g: posts big blind $2
*** HOLE CARDS ***
nXDI8Y/S6POzRwANu3d8hQ: folds
rBQDMkKm9cZn6M9NPsiVew: folds
KqHysDSpCPaPyK3tJC1aEw: folds
254YPxPJr5Sw58bkD0YqYQ: raises $4 to $6
cM6efHzdxoqYm0EQKP4TTQ has timed out
cM6efHzdxoqYm0EQKP4TTQ: folds
cM6efHzdxoqYm0EQKP4TTQ is sitting out
GX1heJ+DSsvm7gzSPsYhhQ: folds
H6Z4+qu8gR0VUiPOijndVg: folds
5Q8U6iZbeO7xJSS4qvDP5g: folds
254YPxPJr5Sw58bkD0YqYQ collected $5 from pot
254YPxPJr5Sw58bkD0YqYQ: doesn't show hand
*** SUMMARY ***
Total pot $5 | Rake $0
Seat 2: H6Z4+qu8gR0VUiPOijndVg (small blind) folded before Flop
Seat 3: 5Q8U6iZbeO7xJSS4qvDP5g (big blind) folded before Flop
Seat 4: nXDI8Y/S6POzRwANu3d8hQ folded before Flop (didn't bet)
Seat 5: rBQDMkKm9cZn6M9NPsiVew folded before Flop (didn't bet)
Seat 6: KqHysDSpCPaPyK3tJC1aEw folded before Flop (didn't bet)
Seat 7: 254YPxPJr5Sw58bkD0YqYQ collected ($5)
Seat 8: cM6efHzdxoqYm0EQKP4TTQ folded before Flop (didn't bet)
Seat 9: GX1heJ+DSsvm7gzSPsYhhQ (button) folded before Flop (didn't bet)



PokerStars Game #59941915522:  Hold'em No Limit ($1/$2) - 2009/07/01 1:50:14 ET
Table 'bJQ024BaYSBrW0sXpCZbNQ' 6-max Seat #1 is the button
Seat 1: KfwW5us6tydK81NYTtK1gw ($207.75 in chips)
Seat 2: 3dAbvkxS5NPQTBAbvpinVg ($265 in chips)
Seat 3: qxFMu+hmWxnODLXQBD5Oww ($200 in chips)
Seat 4: vkfxu8f/jMYKUk6Ly4eujw ($227.05 in chips)
Seat 5: VvdR9F3I+2yELkfTVvC1dg ($203 in chips)
Seat 6: 4bqvCfJ0e8CTYnn0Go9hbQ ($138.50 in chips)
3dAbvkxS5NPQTBAbvpinVg: posts small blind $1
qxFMu+hmWxnODLXQBD5Oww: posts big blind $2
*** HOLE CARDS ***
vkfxu8f/jMYKUk6Ly4eujw: folds
VvdR9F3I+2yELkfTVvC1dg: folds
4bqvCfJ0e8CTYnn0Go9hbQ: folds
KfwW5us6tydK81NYTtK1gw: raises $2 to $4
3dAbvkxS5NPQTBAbvpinVg: folds
qxFMu+hmWxnODLXQBD5Oww: raises $16 to $20
KfwW5us6tydK81NYTtK1gw: folds
qxFMu+hmWxnODLXQBD5Oww collected $9 from pot
*** SUMMARY ***
Total pot $9 | Rake $0
Seat 1: KfwW5us6tydK81NYTtK1gw (button) folded before Flop
Seat 2: 3dAbvkxS5NPQTBAbvpinVg (small blind) folded before Flop
Seat 3: qxFMu+hmWxnODLXQBD5Oww (big blind) collected ($9)
Seat 4: vkfxu8f/jMYKUk6Ly4eujw folded before Flop (didn't bet)
Seat 5: VvdR9F3I+2yELkfTVvC1dg folded before Flop (didn't bet)
Seat 6: 4bqvCfJ0e8CTYnn0Go9hbQ folded before Flop (didn't bet)



PokerStars Game #59941916114:  Hold'em No Limit ($1/$2) - 2009/07/01 1:50:15 ET
Table 'jlrIxbrVIG+gjaUYT4za8g' 6-max Seat #2 is the button
Seat 2: cwfuMyvDC7J7SqX2leDC8g ($46 in chips)
Seat 4: 8srN1dKQePlsv0GyTada+Q ($258.70 in chips)
Seat 5: AyBB0k3Dcl7xbXUeGMw06g ($77.75 in chips)
Seat 6: BWhgxe7gWiYobRbwdG+d2Q ($196 in chips)
8srN1dKQePlsv0GyTada+Q: posts small blind $1
AyBB0k3Dcl7xbXUeGMw06g: posts big blind $2
*** HOLE CARDS ***
BWhgxe7gWiYobRbwdG+d2Q: folds
cwfuMyvDC7J7SqX2leDC8g: folds
8srN1dKQePlsv0GyTada+Q: calls $1
AyBB0k3Dcl7xbXUeGMw06g: checks
*** FLOP *** [Js 8s Jd]
8srN1dKQePlsv0GyTada+Q: bets $2
AyBB0k3Dcl7xbXUeGMw06g: folds
8srN1dKQePlsv0GyTada+Q collected $3.80 from pot
*** SUMMARY ***
Total pot $4 | Rake $0.20
Board [Js 8s Jd]
Seat 2: cwfuMyvDC7J7SqX2leDC8g (button) folded before Flop (didn't bet)
Seat 4: 8srN1dKQePlsv0GyTada+Q (small blind) collected ($3.80)
Seat 5: AyBB0k3Dcl7xbXUeGMw06g (big blind) folded on the Flop
Seat 6: BWhgxe7gWiYobRbwdG+d2Q folded before Flop (didn't bet)



PokerStars Game #59941915866:  Hold'em No Limit ($1/$2) - 2009/07/01 1:50:15 ET
Table 'ztv6V3FN2bQ9nmJPPdx6nQ' 6-max Seat #5 is the button
Seat 1: 6fLdOUCRtX71xbVRhJEq8w ($300.35 in chips)
Seat 2: 5Y+ZGWLI4gnlpApDX5vy1A ($412.65 in chips)
Seat 4: UaZ5yj+6LjtWqMQg2QskUw ($75.55 in chips)
Seat 5: sTPOWERd9HWPCNrDBwsVjA ($216.60 in chips)
Seat 6: mfy7uGZcqA2PVQqEVbJ7+g ($41.60 in chips)
mfy7uGZcqA2PVQqEVbJ7+g: posts small blind $1
6fLdOUCRtX71xbVRhJEq8w: posts big blind $2
*** HOLE CARDS ***
ubtx4Z5L+AcK71MTvYiGVw leaves the table
5Y+ZGWLI4gnlpApDX5vy1A: raises $6 to $8
UaZ5yj+6LjtWqMQg2QskUw: folds
sTPOWERd9HWPCNrDBwsVjA: folds
mfy7uGZcqA2PVQqEVbJ7+g: raises $33.60 to $41.60 and is all-in
6fLdOUCRtX71xbVRhJEq8w: folds
5Y+ZGWLI4gnlpApDX5vy1A: calls $33.60
*** FLOP *** [Qh Qs Jc]
*** TURN *** [Qh Qs Jc] [6c]
*** RIVER *** [Qh Qs Jc 6c] [4s]
*** SHOW DOWN ***
mfy7uGZcqA2PVQqEVbJ7+g: shows [3s 3h] (two pair, Queens and Threes)
5Y+ZGWLI4gnlpApDX5vy1A: mucks hand
mfy7uGZcqA2PVQqEVbJ7+g collected $83.20 from pot
*** SUMMARY ***
Total pot $85.20 | Rake $2
Board [Qh Qs Jc 6c 4s]
Seat 1: 6fLdOUCRtX71xbVRhJEq8w (big blind) folded before Flop
Seat 2: 5Y+ZGWLI4gnlpApDX5vy1A mucked
Seat 4: UaZ5yj+6LjtWqMQg2QskUw folded before Flop (didn't bet)
Seat 5: sTPOWERd9HWPCNrDBwsVjA (button) folded before Flop (didn't bet)
Seat 6: mfy7uGZcqA2PVQqEVbJ7+g (small blind) showed [3s 3h] and won ($83.20) with two pair, Queens and Threes



PokerStars Game #59941917002:  Hold'em No Limit ($1/$2) - 2009/07/01 1:50:17 ET
Table 'uJ9juaXXg9yIcSU8amxaXQ' 6-max Seat #6 is the button
Seat 1: JsqOjN/eHz0uYVf/PyUJ6Q ($119.25 in chips)
Seat 2: VvdR9F3I+2yELkfTVvC1dg ($214.05 in chips)
Seat 3: qXDd0ZyMIse0OBu8pxeQ3Q ($237.40 in chips)
Seat 4: zNjJ/y4emmF+vzrCDd+ooA ($273.55 in chips)
Seat 6: /PH6Ffnho4Ysm8S3V/oa+w ($40 in chips)
JsqOjN/eHz0uYVf/PyUJ6Q: posts small blind $1
VvdR9F3I+2yELkfTVvC1dg: posts big blind $2
YsLQ3BAvgQHWXMAv3Wv6Hg: sits out
*** HOLE CARDS ***
qXDd0ZyMIse0OBu8pxeQ3Q: folds
zNjJ/y4emmF+vzrCDd+ooA: folds
/PH6Ffnho4Ysm8S3V/oa+w: raises $2 to $4
JsqOjN/eHz0uYVf/PyUJ6Q: folds
VvdR9F3I+2yELkfTVvC1dg: folds
/PH6Ffnho4Ysm8S3V/oa+w collected $5 from pot
/PH6Ffnho4Ysm8S3V/oa+w: doesn't show hand
*** SUMMARY ***
Total pot $5 | Rake $0
Seat 1: JsqOjN/eHz0uYVf/PyUJ6Q (small blind) folded before Flop
Seat 2: VvdR9F3I+2yELkfTVvC1dg (big blind) folded before Flop
Seat 3: qXDd0ZyMIse0OBu8pxeQ3Q folded before Flop (didn't bet)
Seat 4: zNjJ/y4emmF+vzrCDd+ooA folded before Flop (didn't bet)
Seat 6: /PH6Ffnho4Ysm8S3V/oa+w (button) collected ($5)



PokerStars Game #59941917442:  Hold'em No Limit ($1/$2) - 2009/07/01 1:50:18 ET
Table 'G1Oqdy4Pqdb5gtx40rUBzA' 6-max Seat #2 is the button
Seat 1: 4dMBh/1VTdeUTPCyhCs3UQ ($63.70 in chips)
Seat 2: m7mYVfnCOK5TE/VkN/FhOg ($209.05 in chips)
Seat 3: VvdR9F3I+2yELkfTVvC1dg ($417.90 in chips)
Seat 4: B87ikIyZ/TzAVeXf38Ny0g ($224.70 in chips)
Seat 5: F1+Ml47qRQWunzPnGhLLzQ ($197 in chips)
Seat 6: qCnEYuAE5y5A7bk6fO5/jQ ($203 in chips)
VvdR9F3I+2yELkfTVvC1dg: posts small blind $1
B87ikIyZ/TzAVeXf38Ny0g: posts big blind $2
*** HOLE CARDS ***
F1+Ml47qRQWunzPnGhLLzQ: folds
qCnEYuAE5y5A7bk6fO5/jQ: folds
4dMBh/1VTdeUTPCyhCs3UQ: calls $2
m7mYVfnCOK5TE/VkN/FhOg: raises $6 to $8
VvdR9F3I+2yELkfTVvC1dg: folds
B87ikIyZ/TzAVeXf38Ny0g: folds
4dMBh/1VTdeUTPCyhCs3UQ: folds
m7mYVfnCOK5TE/VkN/FhOg collected $7 from pot
m7mYVfnCOK5TE/VkN/FhOg: doesn't show hand
*** SUMMARY ***
Total pot $7 | Rake $0
Seat 1: 4dMBh/1VTdeUTPCyhCs3UQ folded before Flop
Seat 2: m7mYVfnCOK5TE/VkN/FhOg (button) collected ($7)
Seat 3: VvdR9F3I+2yELkfTVvC1dg (small blind) folded before Flop
Seat 4: B87ikIyZ/TzAVeXf38Ny0g (big blind) folded before Flop
Seat 5: F1+Ml47qRQWunzPnGhLLzQ folded before Flop (didn't bet)
Seat 6: qCnEYuAE5y5A7bk6fO5/jQ folded before Flop (didn't bet)



PokerStars Game #59941918164:  Hold'em No Limit ($1/$2) - 2009/07/01 1:50:19 ET
Table '/dyk+YdRGv90j2box35j8w' 6-max Seat #1 is the button
Seat 1: 8srN1dKQePlsv0GyTada+Q ($200 in chips)
Seat 2: qCnEYuAE5y5A7bk6fO5/jQ ($500.20 in chips)
Seat 3: sTPOWERd9HWPCNrDBwsVjA ($200.50 in chips)
Seat 4: 4dMBh/1VTdeUTPCyhCs3UQ ($31.75 in chips)
Seat 5: VvdR9F3I+2yELkfTVvC1dg ($294.80 in chips)
qCnEYuAE5y5A7bk6fO5/jQ: posts small blind $1
sTPOWERd9HWPCNrDBwsVjA: posts big blind $2
*** HOLE CARDS ***
4dMBh/1VTdeUTPCyhCs3UQ: folds
VvdR9F3I+2yELkfTVvC1dg: folds
8srN1dKQePlsv0GyTada+Q: raises $4 to $6
qCnEYuAE5y5A7bk6fO5/jQ: folds
sTPOWERd9HWPCNrDBwsVjA: raises $18 to $24
8srN1dKQePlsv0GyTada+Q: folds
sTPOWERd9HWPCNrDBwsVjA collected $13 from pot
sTPOWERd9HWPCNrDBwsVjA: doesn't show hand
*** SUMMARY ***
Total pot $13 | Rake $0
Seat 1: 8srN1dKQePlsv0GyTada+Q (button) folded before Flop
Seat 2: qCnEYuAE5y5A7bk6fO5/jQ (small blind) folded before Flop
Seat 3: sTPOWERd9HWPCNrDBwsVjA (big blind) collected ($13)
Seat 4: 4dMBh/1VTdeUTPCyhCs3UQ folded before Flop (didn't bet)
Seat 5: VvdR9F3I+2yELkfTVvC1dg folded before Flop (didn't bet)



PokerStars Game #59941919632:  Hold'em No Limit ($1/$2) - 2009/07/01 1:50:22 ET
Table 'P/yCfYl1GfGsu/e6DxDy/A' 2-max Seat #1 is the button
Seat 1: 7fOCUy3x9hdkmXkkDNolGQ ($725.50 in chips)
Seat 2: RwDoM55ZeQuI2ADyJhOb2Q ($745.50 in chips)
7fOCUy3x9hdkmXkkDNolGQ: posts small blind $1
RwDoM55ZeQuI2ADyJhOb2Q: posts big blind $2
*** HOLE CARDS ***
7fOCUy3x9hdkmXkkDNolGQ: folds
RwDoM55ZeQuI2ADyJhOb2Q collected $2 from pot
RwDoM55ZeQuI2ADyJhOb2Q: doesn't show hand
*** SUMMARY ***
Total pot $2 | Rake $0
Seat 1: 7fOCUy3x9hdkmXkkDNolGQ (button) (small blind) folded before Flop
Seat 2: RwDoM55ZeQuI2ADyJhOb2Q (big blind) collected ($2)



PokerStars Game #59941920308:  Hold'em No Limit ($1/$2) - 2009/07/01 1:50:23 ET
Table 'ZzSIe0zTCDv+n6hfbY5tTg' 6-max Seat #3 is the button
Seat 1: VvdR9F3I+2yELkfTVvC1dg ($266.35 in chips)
Seat 2: B87ikIyZ/TzAVeXf38Ny0g ($225 in chips)
Seat 3: gsugPj31Hui3Jefl98MBOA ($362 in chips)
Seat 4: 54yWzRRgS0oZ+S6LwZBxMQ ($47.10 in chips)
Seat 5: 3dAbvkxS5NPQTBAbvpinVg ($484.45 in chips)
Seat 6: 09BNF4quPDzanQzM8vc6WA ($36 in chips)
54yWzRRgS0oZ+S6LwZBxMQ: posts small blind $1
3dAbvkxS5NPQTBAbvpinVg: posts big blind $2
*** HOLE CARDS ***
09BNF4quPDzanQzM8vc6WA: folds
VvdR9F3I+2yELkfTVvC1dg: folds
B87ikIyZ/TzAVeXf38Ny0g: folds
gsugPj31Hui3Jefl98MBOA: calls $2
54yWzRRgS0oZ+S6LwZBxMQ: calls $1
3dAbvkxS5NPQTBAbvpinVg: checks
*** FLOP *** [4h 8d 2h]
54yWzRRgS0oZ+S6LwZBxMQ: checks
3dAbvkxS5NPQTBAbvpinVg: checks
gsugPj31Hui3Jefl98MBOA: bets $5
54yWzRRgS0oZ+S6LwZBxMQ: folds
3dAbvkxS5NPQTBAbvpinVg: folds
gsugPj31Hui3Jefl98MBOA collected $5.70 from pot
*** SUMMARY ***
Total pot $6 | Rake $0.30
Board [4h 8d 2h]
Seat 1: VvdR9F3I+2yELkfTVvC1dg folded before Flop (didn't bet)
Seat 2: B87ikIyZ/TzAVeXf38Ny0g folded before Flop (didn't bet)
Seat 3: gsugPj31Hui3Jefl98MBOA (button) collected ($5.70)
Seat 4: 54yWzRRgS0oZ+S6LwZBxMQ (small blind) folded on the Flop
Seat 5: 3dAbvkxS5NPQTBAbvpinVg (big blind) folded on the Flop
Seat 6: 09BNF4quPDzanQzM8vc6WA folded before Flop (didn't bet)



PokerStars Game #59941920138:  Hold'em No Limit ($1/$2) - 2009/07/01 1:50:23 ET
Table 'CFkQcfWjKccZaZDf71FK+w' 6-max Seat #1 is the button
Seat 1: vkfxu8f/jMYKUk6Ly4eujw ($224.25 in chips)
Seat 2: ewN/vzF22+/gdzjIKBOlkA ($209.80 in chips)
Seat 5: 2lOU1DcvUZaMcxZ95XfzXw ($131.05 in chips)
Seat 6: ORVqY3rf9X6ANA/8s+On2Q ($42.35 in chips)
ewN/vzF22+/gdzjIKBOlkA: posts small blind $1
2lOU1DcvUZaMcxZ95XfzXw: posts big blind $2
*** HOLE CARDS ***
ORVqY3rf9X6ANA/8s+On2Q: calls $2
vkfxu8f/jMYKUk6Ly4eujw: folds
ewN/vzF22+/gdzjIKBOlkA: raises $6 to $8
2lOU1DcvUZaMcxZ95XfzXw: folds
ORVqY3rf9X6ANA/8s+On2Q: calls $6
*** FLOP *** [7h 6c 2c]
ewN/vzF22+/gdzjIKBOlkA: checks
ORVqY3rf9X6ANA/8s+On2Q: checks
*** TURN *** [7h 6c 2c] [9d]
ewN/vzF22+/gdzjIKBOlkA: checks
ORVqY3rf9X6ANA/8s+On2Q: checks
*** RIVER *** [7h 6c 2c 9d] [2h]
ewN/vzF22+/gdzjIKBOlkA: checks
ORVqY3rf9X6ANA/8s+On2Q: checks
*** SHOW DOWN ***
ewN/vzF22+/gdzjIKBOlkA: shows [Jh As] (a pair of Deuces)
ORVqY3rf9X6ANA/8s+On2Q: mucks hand
ewN/vzF22+/gdzjIKBOlkA collected $17.10 from pot
*** SUMMARY ***
Total pot $18 | Rake $0.90
Board [7h 6c 2c 9d 2h]
Seat 1: vkfxu8f/jMYKUk6Ly4eujw (button) folded before Flop (didn't bet)
Seat 2: ewN/vzF22+/gdzjIKBOlkA (small blind) showed [Jh As] and won ($17.10) with a pair of Deuces
Seat 5: 2lOU1DcvUZaMcxZ95XfzXw (big blind) folded before Flop
Seat 6: ORVqY3rf9X6ANA/8s+On2Q mucked



PokerStars Game #59941921382:  Hold'em No Limit ($1/$2) - 2009/07/01 1:50:25 ET
Table '5/wEe6JmtGD7vufSA2RG7A' 2-max Seat #1 is the button
Seat 1: pVqEzK9wXlRMECnb1Zg4Zw ($225.50 in chips)
Seat 2: aOL8geThaYp2iadSHl1h1g ($172 in chips)
pVqEzK9wXlRMECnb1Zg4Zw: posts small blind $1
aOL8geThaYp2iadSHl1h1g: posts big blind $2
*** HOLE CARDS ***
pVqEzK9wXlRMECnb1Zg4Zw: calls $1
aOL8geThaYp2iadSHl1h1g: checks
*** FLOP *** [9s 5h 2c]
aOL8geThaYp2iadSHl1h1g: bets $4
pVqEzK9wXlRMECnb1Zg4Zw: folds
aOL8geThaYp2iadSHl1h1g collected $3.80 from pot
aOL8geThaYp2iadSHl1h1g: doesn't show hand
*** SUMMARY ***
Total pot $4 | Rake $0.20
Board [9s 5h 2c]
Seat 1: pVqEzK9wXlRMECnb1Zg4Zw (button) (small blind) folded on the Flop
Seat 2: aOL8geThaYp2iadSHl1h1g (big blind) collected ($3.80)



PokerStars Game #59941922460:  Hold'em No Limit ($1/$2) - 2009/07/01 1:50:27 ET
Table 'kq5zaQ+1hLNf8LZfGnbTAA' 6-max Seat #1 is the button
Seat 1: 8srN1dKQePlsv0GyTada+Q ($416.60 in chips)
Seat 2: nXDI8Y/S6POzRwANu3d8hQ ($141 in chips)
Seat 3: /PH6Ffnho4Ysm8S3V/oa+w ($58.15 in chips)
Seat 4: 3dAbvkxS5NPQTBAbvpinVg ($275.65 in chips)
Seat 5: BWhgxe7gWiYobRbwdG+d2Q ($196 in chips)
Seat 6: mfy7uGZcqA2PVQqEVbJ7+g ($194.15 in chips)
nXDI8Y/S6POzRwANu3d8hQ: posts small blind $1
/PH6Ffnho4Ysm8S3V/oa+w: posts big blind $2
*** HOLE CARDS ***
3dAbvkxS5NPQTBAbvpinVg: folds
BWhgxe7gWiYobRbwdG+d2Q: folds
mfy7uGZcqA2PVQqEVbJ7+g: raises $5 to $7
8srN1dKQePlsv0GyTada+Q: folds
nXDI8Y/S6POzRwANu3d8hQ: folds
/PH6Ffnho4Ysm8S3V/oa+w: folds
mfy7uGZcqA2PVQqEVbJ7+g collected $5 from pot
mfy7uGZcqA2PVQqEVbJ7+g: doesn't show hand
*** SUMMARY ***
Total pot $5 | Rake $0
Seat 1: 8srN1dKQePlsv0GyTada+Q (button) folded before Flop (didn't bet)
Seat 2: nXDI8Y/S6POzRwANu3d8hQ (small blind) folded before Flop
Seat 3: /PH6Ffnho4Ysm8S3V/oa+w (big blind) folded before Flop
Seat 4: 3dAbvkxS5NPQTBAbvpinVg folded before Flop (didn't bet)
Seat 5: BWhgxe7gWiYobRbwdG+d2Q folded before Flop (didn't bet)
Seat 6: mfy7uGZcqA2PVQqEVbJ7+g collected ($5)



PokerStars Game #59941922904:  Hold'em No Limit ($1/$2) - 2009/07/01 1:50:28 ET
Table 'BSRfGh+QobUe0AgIMtt/fw' 9-max Seat #4 is the button
Seat 1: gDn/rYeNwCyWEgRhyWp4PA ($159.05 in chips)
Seat 2: +SmnXtdmwqXGEJfLeJDIUQ ($123.90 in chips)
Seat 3: WUlHm+ydPPHG7Lb0rePSdA ($120 in chips)
Seat 4: +T/63sAeZzWyHchahJ36GQ ($31 in chips)
Seat 5: ThVDqrMpsvd7Ax6KINfuew ($62.50 in chips)
Seat 6: H6Z4+qu8gR0VUiPOijndVg ($205 in chips)
Seat 7: CkE3IyJF1KvdaAOmZY5XqQ ($205 in chips)
Seat 8: GG5lTuGt3+kwNYSbqeB6yw ($78.85 in chips)
Seat 9: tjgwwDmi+N2H4I7hx8useQ ($78 in chips)
ThVDqrMpsvd7Ax6KINfuew: posts small blind $1
H6Z4+qu8gR0VUiPOijndVg: posts big blind $2
*** HOLE CARDS ***
CkE3IyJF1KvdaAOmZY5XqQ: folds
GG5lTuGt3+kwNYSbqeB6yw: folds
tjgwwDmi+N2H4I7hx8useQ: raises $2 to $4
gDn/rYeNwCyWEgRhyWp4PA: folds
+SmnXtdmwqXGEJfLeJDIUQ: folds
WUlHm+ydPPHG7Lb0rePSdA: folds
+T/63sAeZzWyHchahJ36GQ: folds
ThVDqrMpsvd7Ax6KINfuew: folds
H6Z4+qu8gR0VUiPOijndVg: folds
tjgwwDmi+N2H4I7hx8useQ collected $5 from pot
*** SUMMARY ***
Total pot $5 | Rake $0
Seat 1: gDn/rYeNwCyWEgRhyWp4PA folded before Flop (didn't bet)
Seat 2: +SmnXtdmwqXGEJfLeJDIUQ folded before Flop (didn't bet)
Seat 3: WUlHm+ydPPHG7Lb0rePSdA folded before Flop (didn't bet)
Seat 4: +T/63sAeZzWyHchahJ36GQ (button) folded before Flop (didn't bet)
Seat 5: ThVDqrMpsvd7Ax6KINfuew (small blind) folded before Flop
Seat 6: H6Z4+qu8gR0VUiPOijndVg (big blind) folded before Flop
Seat 7: CkE3IyJF1KvdaAOmZY5XqQ folded before Flop (didn't bet)
Seat 8: GG5lTuGt3+kwNYSbqeB6yw folded before Flop (didn't bet)
Seat 9: tjgwwDmi+N2H4I7hx8useQ collected ($5)



PokerStars Game #59941922574:  Hold'em No Limit ($1/$2) - 2009/07/01 1:50:28 ET
Table 'P/yCfYl1GfGsu/e6DxDy/A' 2-max Seat #2 is the button
Seat 1: 7fOCUy3x9hdkmXkkDNolGQ ($724.50 in chips)
Seat 2: RwDoM55ZeQuI2ADyJhOb2Q ($746.50 in chips)
RwDoM55ZeQuI2ADyJhOb2Q: posts small blind $1
7fOCUy3x9hdkmXkkDNolGQ: posts big blind $2
*** HOLE CARDS ***
RwDoM55ZeQuI2ADyJhOb2Q: raises $4 to $6
7fOCUy3x9hdkmXkkDNolGQ: raises $14 to $20
RwDoM55ZeQuI2ADyJhOb2Q: raises $54 to $74
7fOCUy3x9hdkmXkkDNolGQ: calls $54
*** FLOP *** [8s 2d 5h]
7fOCUy3x9hdkmXkkDNolGQ: checks
RwDoM55ZeQuI2ADyJhOb2Q: bets $52
7fOCUy3x9hdkmXkkDNolGQ: calls $52
*** TURN *** [8s 2d 5h] [8h]
7fOCUy3x9hdkmXkkDNolGQ: checks
RwDoM55ZeQuI2ADyJhOb2Q: bets $202
7fOCUy3x9hdkmXkkDNolGQ: calls $202
*** RIVER *** [8s 2d 5h 8h] [6s]
7fOCUy3x9hdkmXkkDNolGQ: bets $396.50 and is all-in
RwDoM55ZeQuI2ADyJhOb2Q: folds
7fOCUy3x9hdkmXkkDNolGQ collected $655.50 from pot
7fOCUy3x9hdkmXkkDNolGQ: doesn't show hand
*** SUMMARY ***
Total pot $656 | Rake $0.50
Board [8s 2d 5h 8h 6s]
Seat 1: 7fOCUy3x9hdkmXkkDNolGQ (big blind) collected ($655.50)
Seat 2: RwDoM55ZeQuI2ADyJhOb2Q (button) (small blind) folded on the River



PokerStars Game #59941924094:  Hold'em No Limit ($1/$2) - 2009/07/01 1:50:31 ET
Table 'NmY84NAf9Mh0ckAckHnh5g' 2-max Seat #1 is the button
Seat 1: 6hvg964TSqZ3AL/0XK9aVQ ($612.35 in chips)
Seat 2: RwDoM55ZeQuI2ADyJhOb2Q ($371.05 in chips)
6hvg964TSqZ3AL/0XK9aVQ: posts small blind $1
RwDoM55ZeQuI2ADyJhOb2Q: posts big blind $2
*** HOLE CARDS ***
6hvg964TSqZ3AL/0XK9aVQ: calls $1
RwDoM55ZeQuI2ADyJhOb2Q: raises $8 to $10
6hvg964TSqZ3AL/0XK9aVQ: calls $8
*** FLOP *** [7d 9c 8s]
RwDoM55ZeQuI2ADyJhOb2Q: checks
6hvg964TSqZ3AL/0XK9aVQ: checks
*** TURN *** [7d 9c 8s] [Qs]
RwDoM55ZeQuI2ADyJhOb2Q: checks
6hvg964TSqZ3AL/0XK9aVQ: bets $10
RwDoM55ZeQuI2ADyJhOb2Q: calls $10
*** RIVER *** [7d 9c 8s Qs] [Kd]
RwDoM55ZeQuI2ADyJhOb2Q: checks
6hvg964TSqZ3AL/0XK9aVQ: bets $40
RwDoM55ZeQuI2ADyJhOb2Q: calls $40
*** SHOW DOWN ***
6hvg964TSqZ3AL/0XK9aVQ: shows [6s As] (high card Ace)
RwDoM55ZeQuI2ADyJhOb2Q: shows [Ah 8c] (a pair of Eights)
RwDoM55ZeQuI2ADyJhOb2Q collected $119.50 from pot
*** SUMMARY ***
Total pot $120 | Rake $0.50
Board [7d 9c 8s Qs Kd]
Seat 1: 6hvg964TSqZ3AL/0XK9aVQ (button) (small blind) showed [6s As] and lost with high card Ace
Seat 2: RwDoM55ZeQuI2ADyJhOb2Q (big blind) showed [Ah 8c] and won ($119.50) with a pair of Eights



PokerStars Game #59941925272:  Hold'em No Limit ($1/$2) - 2009/07/01 1:50:32 ET
Table 'mGpP9StWRnoeiBDExc6Frg' 6-max Seat #4 is the button
Seat 1: VvdR9F3I+2yELkfTVvC1dg ($311.85 in chips)
Seat 2: 6hRJ68JkbJq6MYI9o5bUnQ ($103 in chips)
Seat 4: 4dcDwIHRm96PwtqkpQiuiA ($87.70 in chips)
Seat 5: d1puGuVBE0fidn+5eRJ0tw ($188.35 in chips)
Seat 6: B2Ih1sr5VZk+8He7rcrMtQ ($405.45 in chips)
mddoKnqZkdOH7AJOJ/i0DA joins the table at seat #3
d1puGuVBE0fidn+5eRJ0tw: posts small blind $1
B2Ih1sr5VZk+8He7rcrMtQ: posts big blind $2
*** HOLE CARDS ***
VvdR9F3I+2yELkfTVvC1dg: folds
6hRJ68JkbJq6MYI9o5bUnQ: folds
4dcDwIHRm96PwtqkpQiuiA: folds
d1puGuVBE0fidn+5eRJ0tw: raises $4 to $6
B2Ih1sr5VZk+8He7rcrMtQ: folds
d1puGuVBE0fidn+5eRJ0tw collected $4 from pot
d1puGuVBE0fidn+5eRJ0tw: doesn't show hand
*** SUMMARY ***
Total pot $4 | Rake $0
Seat 1: VvdR9F3I+2yELkfTVvC1dg folded before Flop (didn't bet)
Seat 2: 6hRJ68JkbJq6MYI9o5bUnQ folded before Flop (didn't bet)
Seat 4: 4dcDwIHRm96PwtqkpQiuiA (button) folded before Flop (didn't bet)
Seat 5: d1puGuVBE0fidn+5eRJ0tw (small blind) collected ($4)
Seat 6: B2Ih1sr5VZk+8He7rcrMtQ (big blind) folded before Flop



PokerStars Game #59941926992:  Hold'em No Limit ($1/$2) - 2009/07/01 1:50:35 ET
Table 'UGLAZZyv+cXmnKjYin0etA' 6-max Seat #6 is the button
Seat 2: eDLH1PUXFpvJBNMXBVQcGA ($310.10 in chips)
Seat 4: SiGJDsvRViJX05vHhA80GQ ($240.30 in chips)
Seat 5: 54yWzRRgS0oZ+S6LwZBxMQ ($37.80 in chips)
Seat 6: sTPOWERd9HWPCNrDBwsVjA ($207.95 in chips)
rL+Zpv4/vX2BVHcyfh/NXA will be allowed to play after the button
eDLH1PUXFpvJBNMXBVQcGA: posts small blind $1
SiGJDsvRViJX05vHhA80GQ: posts big blind $2
*** HOLE CARDS ***
54yWzRRgS0oZ+S6LwZBxMQ: folds
sTPOWERd9HWPCNrDBwsVjA: folds
eDLH1PUXFpvJBNMXBVQcGA: raises $4 to $6
SiGJDsvRViJX05vHhA80GQ: calls $4
*** FLOP *** [Jd 7h 4h]
eDLH1PUXFpvJBNMXBVQcGA: bets $10
SiGJDsvRViJX05vHhA80GQ: calls $10
*** TURN *** [Jd 7h 4h] [2h]
eDLH1PUXFpvJBNMXBVQcGA: checks
SiGJDsvRViJX05vHhA80GQ: bets $18
eDLH1PUXFpvJBNMXBVQcGA: folds
SiGJDsvRViJX05vHhA80GQ collected $30.45 from pot
*** SUMMARY ***
Total pot $32 | Rake $1.55
Board [Jd 7h 4h 2h]
Seat 2: eDLH1PUXFpvJBNMXBVQcGA (small blind) folded on the Turn
Seat 4: SiGJDsvRViJX05vHhA80GQ (big blind) collected ($30.45)
Seat 5: 54yWzRRgS0oZ+S6LwZBxMQ folded before Flop (didn't bet)
Seat 6: sTPOWERd9HWPCNrDBwsVjA (button) folded before Flop (didn't bet)



PokerStars Game #59941928284:  Hold'em No Limit ($1/$2) - 2009/07/01 1:50:37 ET
Table 'jlrIxbrVIG+gjaUYT4za8g' 6-max Seat #4 is the button
Seat 2: cwfuMyvDC7J7SqX2leDC8g ($46 in chips)
Seat 4: 8srN1dKQePlsv0GyTada+Q ($260.50 in chips)
Seat 5: AyBB0k3Dcl7xbXUeGMw06g ($75.75 in chips)
Seat 6: BWhgxe7gWiYobRbwdG+d2Q ($196 in chips)
AyBB0k3Dcl7xbXUeGMw06g: posts small blind $1
BWhgxe7gWiYobRbwdG+d2Q: posts big blind $2
*** HOLE CARDS ***
cwfuMyvDC7J7SqX2leDC8g: folds
8srN1dKQePlsv0GyTada+Q: folds
3LCfF9/CuJ9+kbFOcqmuaQ joins the table at seat #3
AyBB0k3Dcl7xbXUeGMw06g: calls $1
BWhgxe7gWiYobRbwdG+d2Q: raises $5 to $7
AyBB0k3Dcl7xbXUeGMw06g: calls $5
*** FLOP *** [2d 4s 6h]
AyBB0k3Dcl7xbXUeGMw06g: checks
BWhgxe7gWiYobRbwdG+d2Q: checks
*** TURN *** [2d 4s 6h] [Qh]
AyBB0k3Dcl7xbXUeGMw06g: checks
BWhgxe7gWiYobRbwdG+d2Q: bets $13
AyBB0k3Dcl7xbXUeGMw06g: folds
BWhgxe7gWiYobRbwdG+d2Q collected $13.30 from pot
*** SUMMARY ***
Total pot $14 | Rake $0.70
Board [2d 4s 6h Qh]
Seat 2: cwfuMyvDC7J7SqX2leDC8g folded before Flop (didn't bet)
Seat 4: 8srN1dKQePlsv0GyTada+Q (button) folded before Flop (didn't bet)
Seat 5: AyBB0k3Dcl7xbXUeGMw06g (small blind) folded on the Turn
Seat 6: BWhgxe7gWiYobRbwdG+d2Q (big blind) collected ($13.30)



PokerStars Game #59941929370:  Hold'em No Limit ($1/$2) - 2009/07/01 1:50:39 ET
Table 'rsKRKlGHlxVyqJxzO2a2Ow' 9-max Seat #6 is the button
Seat 1: KqHysDSpCPaPyK3tJC1aEw ($212.30 in chips)
Seat 2: +T/63sAeZzWyHchahJ36GQ ($86 in chips)
Seat 3: kM9CA+2UcdMjbCMbtUCGiA ($225.10 in chips)
Seat 4: 31HuO+DQxppUQEedBWukug ($108.85 in chips)
Seat 5: 5Q8U6iZbeO7xJSS4qvDP5g ($245.30 in chips)
Seat 6: H6Z4+qu8gR0VUiPOijndVg ($200 in chips)
Seat 7: GX1heJ+DSsvm7gzSPsYhhQ ($54 in chips)
Seat 8: CkE3IyJF1KvdaAOmZY5XqQ ($209.70 in chips)
Seat 9: gRbvhSUVg+TNaTjaJecIRw ($50.60 in chips)
GX1heJ+DSsvm7gzSPsYhhQ: posts small blind $1
CkE3IyJF1KvdaAOmZY5XqQ: posts big blind $2
*** HOLE CARDS ***
gRbvhSUVg+TNaTjaJecIRw: folds
KqHysDSpCPaPyK3tJC1aEw: folds
+T/63sAeZzWyHchahJ36GQ: folds
kM9CA+2UcdMjbCMbtUCGiA: raises $3 to $5
31HuO+DQxppUQEedBWukug: folds
5Q8U6iZbeO7xJSS4qvDP5g: folds
H6Z4+qu8gR0VUiPOijndVg: folds
GX1heJ+DSsvm7gzSPsYhhQ: folds
CkE3IyJF1KvdaAOmZY5XqQ: folds
kM9CA+2UcdMjbCMbtUCGiA collected $5 from pot
kM9CA+2UcdMjbCMbtUCGiA: doesn't show hand
*** SUMMARY ***
Total pot $5 | Rake $0
Seat 1: KqHysDSpCPaPyK3tJC1aEw folded before Flop (didn't bet)
Seat 2: +T/63sAeZzWyHchahJ36GQ folded before Flop (didn't bet)
Seat 3: kM9CA+2UcdMjbCMbtUCGiA collected ($5)
Seat 4: 31HuO+DQxppUQEedBWukug folded before Flop (didn't bet)
Seat 5: 5Q8U6iZbeO7xJSS4qvDP5g folded before Flop (didn't bet)
Seat 6: H6Z4+qu8gR0VUiPOijndVg (button) folded before Flop (didn't bet)
Seat 7: GX1heJ+DSsvm7gzSPsYhhQ (small blind) folded before Flop
Seat 8: CkE3IyJF1KvdaAOmZY5XqQ (big blind) folded before Flop
Seat 9: gRbvhSUVg+TNaTjaJecIRw folded before Flop (didn't bet)



PokerStars Game #59941928990:  Hold'em No Limit ($1/$2) - 2009/07/01 1:50:39 ET
Table '5/wEe6JmtGD7vufSA2RG7A' 2-max Seat #2 is the button
Seat 1: pVqEzK9wXlRMECnb1Zg4Zw ($223.50 in chips)
Seat 2: aOL8geThaYp2iadSHl1h1g ($200 in chips)
aOL8geThaYp2iadSHl1h1g: posts small blind $1
pVqEzK9wXlRMECnb1Zg4Zw: posts big blind $2
*** HOLE CARDS ***
aOL8geThaYp2iadSHl1h1g: raises $4 to $6
pVqEzK9wXlRMECnb1Zg4Zw: folds
aOL8geThaYp2iadSHl1h1g collected $4 from pot
aOL8geThaYp2iadSHl1h1g: doesn't show hand
*** SUMMARY ***
Total pot $4 | Rake $0
Seat 1: pVqEzK9wXlRMECnb1Zg4Zw (big blind) folded before Flop
Seat 2: aOL8geThaYp2iadSHl1h1g (button) (small blind) collected ($4)



PokerStars Game #59941929496:  Hold'em No Limit ($1/$2) - 2009/07/01 1:50:40 ET
Table 'uJ9juaXXg9yIcSU8amxaXQ' 6-max Seat #1 is the button
Seat 1: JsqOjN/eHz0uYVf/PyUJ6Q ($118.25 in chips)
Seat 2: VvdR9F3I+2yELkfTVvC1dg ($212.05 in chips)
Seat 3: qXDd0ZyMIse0OBu8pxeQ3Q ($237.40 in chips)
Seat 4: zNjJ/y4emmF+vzrCDd+ooA ($273.55 in chips)
Seat 6: /PH6Ffnho4Ysm8S3V/oa+w ($43 in chips)
VvdR9F3I+2yELkfTVvC1dg: posts small blind $1
qXDd0ZyMIse0OBu8pxeQ3Q: posts big blind $2
YsLQ3BAvgQHWXMAv3Wv6Hg: sits out
*** HOLE CARDS ***
zNjJ/y4emmF+vzrCDd+ooA: folds
/PH6Ffnho4Ysm8S3V/oa+w: folds
JsqOjN/eHz0uYVf/PyUJ6Q: calls $2
VvdR9F3I+2yELkfTVvC1dg: calls $1
qXDd0ZyMIse0OBu8pxeQ3Q: checks
*** FLOP *** [6c Ts 3c]
VvdR9F3I+2yELkfTVvC1dg: checks
qXDd0ZyMIse0OBu8pxeQ3Q: checks
JsqOjN/eHz0uYVf/PyUJ6Q: checks
*** TURN *** [6c Ts 3c] [7h]
VvdR9F3I+2yELkfTVvC1dg: checks
qXDd0ZyMIse0OBu8pxeQ3Q: checks
JsqOjN/eHz0uYVf/PyUJ6Q: bets $4
VvdR9F3I+2yELkfTVvC1dg: folds
qXDd0ZyMIse0OBu8pxeQ3Q: folds
JsqOjN/eHz0uYVf/PyUJ6Q collected $5.70 from pot
JsqOjN/eHz0uYVf/PyUJ6Q: doesn't show hand
*** SUMMARY ***
Total pot $6 | Rake $0.30
Board [6c Ts 3c 7h]
Seat 1: JsqOjN/eHz0uYVf/PyUJ6Q (button) collected ($5.70)
Seat 2: VvdR9F3I+2yELkfTVvC1dg (small blind) folded on the Turn
Seat 3: qXDd0ZyMIse0OBu8pxeQ3Q (big blind) folded on the Turn
Seat 4: zNjJ/y4emmF+vzrCDd+ooA folded before Flop (didn't bet)
Seat 6: /PH6Ffnho4Ysm8S3V/oa+w folded before Flop (didn't bet)



PokerStars Game #59941929560:  Hold'em No Limit ($1/$2) - 2009/07/01 1:50:40 ET
Table '3WCXyaiCAbqSShQu7FIjvA' 9-max Seat #4 is the button
Seat 1: kTCkABD1UUldS9DFRGfCwQ ($137.75 in chips)
Seat 3: 5Q8U6iZbeO7xJSS4qvDP5g ($267.25 in chips)
Seat 4: waEF/+pxZTxNo4FvsORuXg ($103.40 in chips)
Seat 5: CkE3IyJF1KvdaAOmZY5XqQ ($208.90 in chips)
Seat 6: 5jQlngvMSqM/WoonOcR5kw ($285 in chips)
Seat 7: nXDI8Y/S6POzRwANu3d8hQ ($44.10 in chips)
Seat 8: +T/63sAeZzWyHchahJ36GQ ($37 in chips)
Seat 9: FiXPLJyqb24l32QST2TInw ($103.80 in chips)
CkE3IyJF1KvdaAOmZY5XqQ: posts small blind $1
5jQlngvMSqM/WoonOcR5kw: posts big blind $2
254YPxPJr5Sw58bkD0YqYQ: sits out
*** HOLE CARDS ***
nXDI8Y/S6POzRwANu3d8hQ: folds
+T/63sAeZzWyHchahJ36GQ: folds
FiXPLJyqb24l32QST2TInw: calls $2
kTCkABD1UUldS9DFRGfCwQ: folds
5Q8U6iZbeO7xJSS4qvDP5g: folds
waEF/+pxZTxNo4FvsORuXg: calls $2
CkE3IyJF1KvdaAOmZY5XqQ: folds
5jQlngvMSqM/WoonOcR5kw: checks
*** FLOP *** [8s 8h 4d]
5jQlngvMSqM/WoonOcR5kw: checks
FiXPLJyqb24l32QST2TInw: bets $4
waEF/+pxZTxNo4FvsORuXg: folds
5jQlngvMSqM/WoonOcR5kw: calls $4
*** TURN *** [8s 8h 4d] [5s]
5jQlngvMSqM/WoonOcR5kw: checks
FiXPLJyqb24l32QST2TInw: bets $6
5jQlngvMSqM/WoonOcR5kw: calls $6
*** RIVER *** [8s 8h 4d 5s] [Tc]
5jQlngvMSqM/WoonOcR5kw: checks
FiXPLJyqb24l32QST2TInw: checks
*** SHOW DOWN ***
5jQlngvMSqM/WoonOcR5kw: shows [Ac Jh] (a pair of Eights)
FiXPLJyqb24l32QST2TInw: shows [6h 5h] (two pair, Eights and Fives)
FiXPLJyqb24l32QST2TInw collected $25.70 from pot
*** SUMMARY ***
Total pot $27 | Rake $1.30
Board [8s 8h 4d 5s Tc]
Seat 1: kTCkABD1UUldS9DFRGfCwQ folded before Flop (didn't bet)
Seat 3: 5Q8U6iZbeO7xJSS4qvDP5g folded before Flop (didn't bet)
Seat 4: waEF/+pxZTxNo4FvsORuXg (button) folded on the Flop
Seat 5: CkE3IyJF1KvdaAOmZY5XqQ (small blind) folded before Flop
Seat 6: 5jQlngvMSqM/WoonOcR5kw (big blind) showed [Ac Jh] and lost with a pair of Eights
Seat 7: nXDI8Y/S6POzRwANu3d8hQ folded before Flop (didn't bet)
Seat 8: +T/63sAeZzWyHchahJ36GQ folded before Flop (didn't bet)
Seat 9: FiXPLJyqb24l32QST2TInw showed [6h 5h] and won ($25.70) with two pair, Eights and Fives



PokerStars Game #59941930538:  Hold'em No Limit ($1/$2) - 2009/07/01 1:50:42 ET
Table 'WCA60bDA8ecovUgFSIZkTQ' 9-max Seat #8 is the button
Seat 1: 3RFwE6igZ1BGKOGuab6iiw ($55.70 in chips)
Seat 2: TAfo4veNRaRlzDXMMYS3Jg ($37 in chips)
Seat 3: g7gL2NLJCdZPPV399WKT1w ($50.65 in chips)
Seat 4: IYBKVnE2Basnr88BAhH+bQ ($202.80 in chips)
Seat 5: A+9gcmwAl0eFxxbAwRY1OA ($267.10 in chips)
Seat 7: tsTv4D+ne2W0qhUt9HlcMw ($193 in chips)
Seat 8: mJhwEVg7F695DiO+RIhM5g ($254.45 in chips)
Seat 9: ItDFe9gh5QYPQB9vC4ntUA ($200 in chips)
ItDFe9gh5QYPQB9vC4ntUA: posts small blind $1
3RFwE6igZ1BGKOGuab6iiw: posts big blind $2
YoKKKdDDs7gFzP1Z65Sdaw: sits out
*** HOLE CARDS ***
TAfo4veNRaRlzDXMMYS3Jg: folds
g7gL2NLJCdZPPV399WKT1w: folds
IYBKVnE2Basnr88BAhH+bQ: raises $4 to $6
A+9gcmwAl0eFxxbAwRY1OA: folds
tsTv4D+ne2W0qhUt9HlcMw: folds
mJhwEVg7F695DiO+RIhM5g: folds
ItDFe9gh5QYPQB9vC4ntUA: folds
3RFwE6igZ1BGKOGuab6iiw: folds
IYBKVnE2Basnr88BAhH+bQ collected $5 from pot
IYBKVnE2Basnr88BAhH+bQ: doesn't show hand
*** SUMMARY ***
Total pot $5 | Rake $0
Seat 1: 3RFwE6igZ1BGKOGuab6iiw (big blind) folded before Flop
Seat 2: TAfo4veNRaRlzDXMMYS3Jg folded before Flop (didn't bet)
Seat 3: g7gL2NLJCdZPPV399WKT1w folded before Flop (didn't bet)
Seat 4: IYBKVnE2Basnr88BAhH+bQ collected ($5)
Seat 5: A+9gcmwAl0eFxxbAwRY1OA folded before Flop (didn't bet)
Seat 7: tsTv4D+ne2W0qhUt9HlcMw folded before Flop (didn't bet)
Seat 8: mJhwEVg7F695DiO+RIhM5g (button) folded before Flop (didn't bet)
Seat 9: ItDFe9gh5QYPQB9vC4ntUA (small blind) folded before Flop



PokerStars Game #59941932296:  Hold'em No Limit ($1/$2) - 2009/07/01 1:50:45 ET
Table 'bJQ024BaYSBrW0sXpCZbNQ' 6-max Seat #2 is the button
Seat 1: KfwW5us6tydK81NYTtK1gw ($203.75 in chips)
Seat 2: 3dAbvkxS5NPQTBAbvpinVg ($264 in chips)
Seat 3: qxFMu+hmWxnODLXQBD5Oww ($205 in chips)
Seat 5: VvdR9F3I+2yELkfTVvC1dg ($203 in chips)
Seat 6: 4bqvCfJ0e8CTYnn0Go9hbQ ($138.50 in chips)
qxFMu+hmWxnODLXQBD5Oww: posts small blind $1
vkfxu8f/jMYKUk6Ly4eujw: is sitting out
VvdR9F3I+2yELkfTVvC1dg: posts big blind $2
*** HOLE CARDS ***
vkfxu8f/jMYKUk6Ly4eujw leaves the table
4bqvCfJ0e8CTYnn0Go9hbQ: calls $2
KfwW5us6tydK81NYTtK1gw: folds
3dAbvkxS5NPQTBAbvpinVg: folds
qxFMu+hmWxnODLXQBD5Oww: calls $1
opJMdoq0E6TRbAQiweyQuA joins the table at seat #4
VvdR9F3I+2yELkfTVvC1dg: checks
*** FLOP *** [2d 8c 4h]
qxFMu+hmWxnODLXQBD5Oww: checks
VvdR9F3I+2yELkfTVvC1dg: checks
4bqvCfJ0e8CTYnn0Go9hbQ: checks
*** TURN *** [2d 8c 4h] [Tc]
qxFMu+hmWxnODLXQBD5Oww: checks
VvdR9F3I+2yELkfTVvC1dg: checks
4bqvCfJ0e8CTYnn0Go9hbQ: bets $4
qxFMu+hmWxnODLXQBD5Oww: folds
qxFMu+hmWxnODLXQBD5Oww is sitting out
VvdR9F3I+2yELkfTVvC1dg: folds
4bqvCfJ0e8CTYnn0Go9hbQ collected $5.70 from pot
4bqvCfJ0e8CTYnn0Go9hbQ is sitting out
*** SUMMARY ***
Total pot $6 | Rake $0.30
Board [2d 8c 4h Tc]
Seat 1: KfwW5us6tydK81NYTtK1gw folded before Flop (didn't bet)
Seat 2: 3dAbvkxS5NPQTBAbvpinVg (button) folded before Flop (didn't bet)
Seat 3: qxFMu+hmWxnODLXQBD5Oww (small blind) folded on the Turn
Seat 5: VvdR9F3I+2yELkfTVvC1dg (big blind) folded on the Turn
Seat 6: 4bqvCfJ0e8CTYnn0Go9hbQ collected ($5.70)



PokerStars Game #59941932282:  Hold'em No Limit ($1/$2) - 2009/07/01 1:50:45 ET
Table '+hSnXFQrGw1PlVgTnuj+sA' 6-max Seat #4 is the button
Seat 1: fb8ooqw9ZsZtBsZTZQLNrQ ($54.70 in chips)
Seat 2: 54yWzRRgS0oZ+S6LwZBxMQ ($25.10 in chips)
Seat 3: cupOBdycmBLQKdVftyAksg ($49.10 in chips)
Seat 4: TRSUrOQh3x1NGeD+dH4yoA ($94.10 in chips)
Seat 5: PZzUwZiFNhCLi6Ouh5ZlmQ ($200 in chips)
Seat 6: 7zM38baFvmCNB/F80oE0cQ ($45.55 in chips)
PZzUwZiFNhCLi6Ouh5ZlmQ: posts small blind $1
7zM38baFvmCNB/F80oE0cQ: posts big blind $2
*** HOLE CARDS ***
fb8ooqw9ZsZtBsZTZQLNrQ: folds
54yWzRRgS0oZ+S6LwZBxMQ: folds
cupOBdycmBLQKdVftyAksg: folds
TRSUrOQh3x1NGeD+dH4yoA: folds
PZzUwZiFNhCLi6Ouh5ZlmQ: folds
7zM38baFvmCNB/F80oE0cQ collected $2 from pot
7zM38baFvmCNB/F80oE0cQ: doesn't show hand
*** SUMMARY ***
Total pot $2 | Rake $0
Seat 1: fb8ooqw9ZsZtBsZTZQLNrQ folded before Flop (didn't bet)
Seat 2: 54yWzRRgS0oZ+S6LwZBxMQ folded before Flop (didn't bet)
Seat 3: cupOBdycmBLQKdVftyAksg folded before Flop (didn't bet)
Seat 4: TRSUrOQh3x1NGeD+dH4yoA (button) folded before Flop (didn't bet)
Seat 5: PZzUwZiFNhCLi6Ouh5ZlmQ (small blind) folded before Flop
Seat 6: 7zM38baFvmCNB/F80oE0cQ (big blind) collected ($2)



PokerStars Game #59941932796:  Hold'em No Limit ($1/$2) - 2009/07/01 1:50:46 ET
Table 'kq5zaQ+1hLNf8LZfGnbTAA' 6-max Seat #2 is the button
Seat 1: 8srN1dKQePlsv0GyTada+Q ($416.60 in chips)
Seat 2: nXDI8Y/S6POzRwANu3d8hQ ($140 in chips)
Seat 3: /PH6Ffnho4Ysm8S3V/oa+w ($56.15 in chips)
Seat 4: 3dAbvkxS5NPQTBAbvpinVg ($275.65 in chips)
Seat 5: BWhgxe7gWiYobRbwdG+d2Q ($196 in chips)
Seat 6: mfy7uGZcqA2PVQqEVbJ7+g ($197.15 in chips)
/PH6Ffnho4Ysm8S3V/oa+w: posts small blind $1
3dAbvkxS5NPQTBAbvpinVg: posts big blind $2
*** HOLE CARDS ***
BWhgxe7gWiYobRbwdG+d2Q: raises $5 to $7
mfy7uGZcqA2PVQqEVbJ7+g: calls $7
8srN1dKQePlsv0GyTada+Q: folds
nXDI8Y/S6POzRwANu3d8hQ: folds
/PH6Ffnho4Ysm8S3V/oa+w: folds
3dAbvkxS5NPQTBAbvpinVg: folds
*** FLOP *** [Kd 6d Ts]
BWhgxe7gWiYobRbwdG+d2Q: bets $14
mfy7uGZcqA2PVQqEVbJ7+g: folds
BWhgxe7gWiYobRbwdG+d2Q collected $16.15 from pot
BWhgxe7gWiYobRbwdG+d2Q: doesn't show hand
*** SUMMARY ***
Total pot $17 | Rake $0.85
Board [Kd 6d Ts]
Seat 1: 8srN1dKQePlsv0GyTada+Q folded before Flop (didn't bet)
Seat 2: nXDI8Y/S6POzRwANu3d8hQ (button) folded before Flop (didn't bet)
Seat 3: /PH6Ffnho4Ysm8S3V/oa+w (small blind) folded before Flop
Seat 4: 3dAbvkxS5NPQTBAbvpinVg (big blind) folded before Flop
Seat 5: BWhgxe7gWiYobRbwdG+d2Q collected ($16.15)
Seat 6: mfy7uGZcqA2PVQqEVbJ7+g folded on the Flop



PokerStars Game #59941933292:  Hold'em No Limit ($1/$2) - 2009/07/01 1:50:47 ET
Table '/dyk+YdRGv90j2box35j8w' 6-max Seat #2 is the button
Seat 1: 8srN1dKQePlsv0GyTada+Q ($200 in chips)
Seat 2: qCnEYuAE5y5A7bk6fO5/jQ ($499.20 in chips)
Seat 3: sTPOWERd9HWPCNrDBwsVjA ($207.50 in chips)
Seat 4: 4dMBh/1VTdeUTPCyhCs3UQ ($60 in chips)
Seat 5: VvdR9F3I+2yELkfTVvC1dg ($294.80 in chips)
sTPOWERd9HWPCNrDBwsVjA: posts small blind $1
4dMBh/1VTdeUTPCyhCs3UQ: posts big blind $2
*** HOLE CARDS ***
VvdR9F3I+2yELkfTVvC1dg: folds
8srN1dKQePlsv0GyTada+Q: raises $4 to $6
C3qJBo7uxfFVDluE1lmK2w joins the table at seat #6
qCnEYuAE5y5A7bk6fO5/jQ: folds
sTPOWERd9HWPCNrDBwsVjA: folds
4dMBh/1VTdeUTPCyhCs3UQ: calls $4
*** FLOP *** [5h Ts 3d]
4dMBh/1VTdeUTPCyhCs3UQ: checks
8srN1dKQePlsv0GyTada+Q: bets $8
4dMBh/1VTdeUTPCyhCs3UQ: calls $8
*** TURN *** [5h Ts 3d] [Js]
4dMBh/1VTdeUTPCyhCs3UQ: checks
8srN1dKQePlsv0GyTada+Q: bets $18
4dMBh/1VTdeUTPCyhCs3UQ: calls $18
*** RIVER *** [5h Ts 3d Js] [7d]
4dMBh/1VTdeUTPCyhCs3UQ: checks
8srN1dKQePlsv0GyTada+Q: checks
*** SHOW DOWN ***
4dMBh/1VTdeUTPCyhCs3UQ: shows [9c 9d] (a pair of Nines)
8srN1dKQePlsv0GyTada+Q: mucks hand
4dMBh/1VTdeUTPCyhCs3UQ collected $63 from pot
*** SUMMARY ***
Total pot $65 | Rake $2
Board [5h Ts 3d Js 7d]
Seat 1: 8srN1dKQePlsv0GyTada+Q mucked
Seat 2: qCnEYuAE5y5A7bk6fO5/jQ (button) folded before Flop (didn't bet)
Seat 3: sTPOWERd9HWPCNrDBwsVjA (small blind) folded before Flop
Seat 4: 4dMBh/1VTdeUTPCyhCs3UQ (big blind) showed [9c 9d] and won ($63) with a pair of Nines
Seat 5: VvdR9F3I+2yELkfTVvC1dg folded before Flop (didn't bet)



PokerStars Game #59941935036:  Hold'em No Limit ($1/$2) - 2009/07/01 1:50:50 ET
Table 'aSf77Sj8QEnzcc0WaxVD4Q' 6-max Seat #1 is the button
Seat 1: UELtvp+JfwI7XDGVwSxZXA ($169.05 in chips)
Seat 2: vkfxu8f/jMYKUk6Ly4eujw ($187.10 in chips)
Seat 3: 9dpyyjDTCed6nV7JhaUUpw ($760.50 in chips)
Seat 5: VvdR9F3I+2yELkfTVvC1dg ($301.70 in chips)
Seat 6: vkoJRf3gidxY1pPi0AFWww ($169.25 in chips)
vkfxu8f/jMYKUk6Ly4eujw: posts small blind $1
9dpyyjDTCed6nV7JhaUUpw: posts big blind $2
YsLQ3BAvgQHWXMAv3Wv6Hg: sits out
*** HOLE CARDS ***
VvdR9F3I+2yELkfTVvC1dg: folds
vkoJRf3gidxY1pPi0AFWww: raises $4 to $6
UELtvp+JfwI7XDGVwSxZXA: folds
vkfxu8f/jMYKUk6Ly4eujw: folds
9dpyyjDTCed6nV7JhaUUpw: folds
vkoJRf3gidxY1pPi0AFWww collected $5 from pot
vkoJRf3gidxY1pPi0AFWww: doesn't show hand
*** SUMMARY ***
Total pot $5 | Rake $0
Seat 1: UELtvp+JfwI7XDGVwSxZXA (button) folded before Flop (didn't bet)
Seat 2: vkfxu8f/jMYKUk6Ly4eujw (small blind) folded before Flop
Seat 3: 9dpyyjDTCed6nV7JhaUUpw (big blind) folded before Flop
Seat 5: VvdR9F3I+2yELkfTVvC1dg folded before Flop (didn't bet)
Seat 6: vkoJRf3gidxY1pPi0AFWww collected ($5)



PokerStars Game #59941935766:  Hold'em No Limit ($1/$2) - 2009/07/01 1:50:52 ET
Table 'TsEDkiO4tzCTCzJ7tNdEqw' 6-max Seat #5 is the button
Seat 2: 4dcDwIHRm96PwtqkpQiuiA ($79.40 in chips)
Seat 3: ubtx4Z5L+AcK71MTvYiGVw ($211.20 in chips)
Seat 4: K8MXCrNAVYlMnnCeM32Kxw ($121.35 in chips)
Seat 5: VvdR9F3I+2yELkfTVvC1dg ($243.35 in chips)
Seat 6: uCqEjnxh2/vFBjKYkfTOkw ($285.80 in chips)
uCqEjnxh2/vFBjKYkfTOkw: posts small blind $1
4dcDwIHRm96PwtqkpQiuiA: posts big blind $2
*** HOLE CARDS ***
ubtx4Z5L+AcK71MTvYiGVw: folds
K8MXCrNAVYlMnnCeM32Kxw: raises $2 to $4
VvdR9F3I+2yELkfTVvC1dg: folds
uCqEjnxh2/vFBjKYkfTOkw: folds
4dcDwIHRm96PwtqkpQiuiA: folds
K8MXCrNAVYlMnnCeM32Kxw collected $5 from pot
*** SUMMARY ***
Total pot $5 | Rake $0
Seat 2: 4dcDwIHRm96PwtqkpQiuiA (big blind) folded before Flop
Seat 3: ubtx4Z5L+AcK71MTvYiGVw folded before Flop (didn't bet)
Seat 4: K8MXCrNAVYlMnnCeM32Kxw collected ($5)
Seat 5: VvdR9F3I+2yELkfTVvC1dg (button) folded before Flop (didn't bet)
Seat 6: uCqEjnxh2/vFBjKYkfTOkw (small blind) folded before Flop



PokerStars Game #59941936278:  Hold'em No Limit ($1/$2) - 2009/07/01 1:50:53 ET
Table 'mGpP9StWRnoeiBDExc6Frg' 6-max Seat #5 is the button
Seat 1: VvdR9F3I+2yELkfTVvC1dg ($311.85 in chips)
Seat 2: 6hRJ68JkbJq6MYI9o5bUnQ ($103 in chips)
Seat 4: 4dcDwIHRm96PwtqkpQiuiA ($87.70 in chips)
Seat 5: d1puGuVBE0fidn+5eRJ0tw ($190.35 in chips)
Seat 6: B2Ih1sr5VZk+8He7rcrMtQ ($403.45 in chips)
B2Ih1sr5VZk+8He7rcrMtQ: posts small blind $1
VvdR9F3I+2yELkfTVvC1dg: posts big blind $2
mddoKnqZkdOH7AJOJ/i0DA: sits out
*** HOLE CARDS ***
6hRJ68JkbJq6MYI9o5bUnQ: folds
4dcDwIHRm96PwtqkpQiuiA: folds
d1puGuVBE0fidn+5eRJ0tw: folds
B2Ih1sr5VZk+8He7rcrMtQ: folds
VvdR9F3I+2yELkfTVvC1dg collected $2 from pot
VvdR9F3I+2yELkfTVvC1dg: doesn't show hand
*** SUMMARY ***
Total pot $2 | Rake $0
Seat 1: VvdR9F3I+2yELkfTVvC1dg (big blind) collected ($2)
Seat 2: 6hRJ68JkbJq6MYI9o5bUnQ folded before Flop (didn't bet)
Seat 4: 4dcDwIHRm96PwtqkpQiuiA folded before Flop (didn't bet)
Seat 5: d1puGuVBE0fidn+5eRJ0tw (button) folded before Flop (didn't bet)
Seat 6: B2Ih1sr5VZk+8He7rcrMtQ (small blind) folded before Flop



PokerStars Game #59941937782:  Hold'em No Limit ($1/$2) - 2009/07/01 1:50:56 ET
Table 'G1Oqdy4Pqdb5gtx40rUBzA' 6-max Seat #3 is the button
Seat 1: 4dMBh/1VTdeUTPCyhCs3UQ ($61.70 in chips)
Seat 2: m7mYVfnCOK5TE/VkN/FhOg ($214.05 in chips)
Seat 3: VvdR9F3I+2yELkfTVvC1dg ($416.90 in chips)
Seat 4: B87ikIyZ/TzAVeXf38Ny0g ($222.70 in chips)
Seat 5: F1+Ml47qRQWunzPnGhLLzQ ($197 in chips)
Seat 6: qCnEYuAE5y5A7bk6fO5/jQ ($203 in chips)
B87ikIyZ/TzAVeXf38Ny0g: posts small blind $1
F1+Ml47qRQWunzPnGhLLzQ: posts big blind $2
*** HOLE CARDS ***
qCnEYuAE5y5A7bk6fO5/jQ: folds
4dMBh/1VTdeUTPCyhCs3UQ: folds
m7mYVfnCOK5TE/VkN/FhOg: folds
VvdR9F3I+2yELkfTVvC1dg: raises $2 to $4
B87ikIyZ/TzAVeXf38Ny0g: folds
F1+Ml47qRQWunzPnGhLLzQ: folds
VvdR9F3I+2yELkfTVvC1dg collected $5 from pot
VvdR9F3I+2yELkfTVvC1dg: doesn't show hand
*** SUMMARY ***
Total pot $5 | Rake $0
Seat 1: 4dMBh/1VTdeUTPCyhCs3UQ folded before Flop (didn't bet)
Seat 2: m7mYVfnCOK5TE/VkN/FhOg folded before Flop (didn't bet)
Seat 3: VvdR9F3I+2yELkfTVvC1dg (button) collected ($5)
Seat 4: B87ikIyZ/TzAVeXf38Ny0g (small blind) folded before Flop
Seat 5: F1+Ml47qRQWunzPnGhLLzQ (big blind) folded before Flop
Seat 6: qCnEYuAE5y5A7bk6fO5/jQ folded before Flop (didn't bet)



PokerStars Game #59941939638:  Hold'em No Limit ($1/$2) - 2009/07/01 1:50:59 ET
Table 'C4lkCXY2PWy6z4vsAe5NGQ' 6-max Seat #3 is the button
Seat 2: 6hRJ68JkbJq6MYI9o5bUnQ ($58.95 in chips)
Seat 3: sTPOWERd9HWPCNrDBwsVjA ($135.50 in chips)
Seat 4: VvdR9F3I+2yELkfTVvC1dg ($205 in chips)
Seat 5: /PH6Ffnho4Ysm8S3V/oa+w ($56.15 in chips)
Seat 6: B87ikIyZ/TzAVeXf38Ny0g ($721.75 in chips)
VvdR9F3I+2yELkfTVvC1dg: posts small blind $1
/PH6Ffnho4Ysm8S3V/oa+w: posts big blind $2
*** HOLE CARDS ***
B87ikIyZ/TzAVeXf38Ny0g: raises $4 to $6
6hRJ68JkbJq6MYI9o5bUnQ: folds
sTPOWERd9HWPCNrDBwsVjA: folds
VvdR9F3I+2yELkfTVvC1dg: folds
/PH6Ffnho4Ysm8S3V/oa+w: folds
B87ikIyZ/TzAVeXf38Ny0g collected $5 from pot
B87ikIyZ/TzAVeXf38Ny0g: doesn't show hand
*** SUMMARY ***
Total pot $5 | Rake $0
Seat 2: 6hRJ68JkbJq6MYI9o5bUnQ folded before Flop (didn't bet)
Seat 3: sTPOWERd9HWPCNrDBwsVjA (button) folded before Flop (didn't bet)
Seat 4: VvdR9F3I+2yELkfTVvC1dg (small blind) folded before Flop
Seat 5: /PH6Ffnho4Ysm8S3V/oa+w (big blind) folded before Flop
Seat 6: B87ikIyZ/TzAVeXf38Ny0g collected ($5)



PokerStars Game #59941940680:  Hold'em No Limit ($1/$2) - 2009/07/01 1:51:01 ET
Table 'CFkQcfWjKccZaZDf71FK+w' 6-max Seat #2 is the button
Seat 1: vkfxu8f/jMYKUk6Ly4eujw ($224.25 in chips)
Seat 2: ewN/vzF22+/gdzjIKBOlkA ($218.90 in chips)
Seat 5: 2lOU1DcvUZaMcxZ95XfzXw ($129.05 in chips)
Seat 6: ORVqY3rf9X6ANA/8s+On2Q ($34.35 in chips)
2lOU1DcvUZaMcxZ95XfzXw: posts small blind $1
ORVqY3rf9X6ANA/8s+On2Q: posts big blind $2
*** HOLE CARDS ***
vkfxu8f/jMYKUk6Ly4eujw: folds
ewN/vzF22+/gdzjIKBOlkA: folds
2lOU1DcvUZaMcxZ95XfzXw: calls $1
ORVqY3rf9X6ANA/8s+On2Q: checks
*** FLOP *** [Kc Td 4c]
2lOU1DcvUZaMcxZ95XfzXw: checks
ORVqY3rf9X6ANA/8s+On2Q: checks
*** TURN *** [Kc Td 4c] [7c]
2lOU1DcvUZaMcxZ95XfzXw: checks
ORVqY3rf9X6ANA/8s+On2Q: checks
*** RIVER *** [Kc Td 4c 7c] [3h]
2lOU1DcvUZaMcxZ95XfzXw: checks
ORVqY3rf9X6ANA/8s+On2Q: checks
*** SHOW DOWN ***
2lOU1DcvUZaMcxZ95XfzXw: shows [Ad 5d] (high card Ace)
opJMdoq0E6TRbAQiweyQuA joins the table at seat #4
ORVqY3rf9X6ANA/8s+On2Q: mucks hand
2lOU1DcvUZaMcxZ95XfzXw collected $3.80 from pot
*** SUMMARY ***
Total pot $4 | Rake $0.20
Board [Kc Td 4c 7c 3h]
Seat 1: vkfxu8f/jMYKUk6Ly4eujw folded before Flop (didn't bet)
Seat 2: ewN/vzF22+/gdzjIKBOlkA (button) folded before Flop (didn't bet)
Seat 5: 2lOU1DcvUZaMcxZ95XfzXw (small blind) showed [Ad 5d] and won ($3.80) with high card Ace
Seat 6: ORVqY3rf9X6ANA/8s+On2Q (big blind) mucked



PokerStars Game #59941941274:  Hold'em No Limit ($1/$2) - 2009/07/01 1:51:02 ET
Table 'WCA60bDA8ecovUgFSIZkTQ' 9-max Seat #9 is the button
Seat 1: 3RFwE6igZ1BGKOGuab6iiw ($53.70 in chips)
Seat 2: TAfo4veNRaRlzDXMMYS3Jg ($37 in chips)
Seat 3: g7gL2NLJCdZPPV399WKT1w ($50.65 in chips)
Seat 4: IYBKVnE2Basnr88BAhH+bQ ($205.80 in chips)
Seat 5: A+9gcmwAl0eFxxbAwRY1OA ($267.10 in chips)
Seat 7: tsTv4D+ne2W0qhUt9HlcMw ($193 in chips)
Seat 8: mJhwEVg7F695DiO+RIhM5g ($254.45 in chips)
Seat 9: ItDFe9gh5QYPQB9vC4ntUA ($200 in chips)
3RFwE6igZ1BGKOGuab6iiw: posts small blind $1
TAfo4veNRaRlzDXMMYS3Jg: posts big blind $2
YoKKKdDDs7gFzP1Z65Sdaw: sits out
*** HOLE CARDS ***
g7gL2NLJCdZPPV399WKT1w: folds
IYBKVnE2Basnr88BAhH+bQ: folds
A+9gcmwAl0eFxxbAwRY1OA: folds
tsTv4D+ne2W0qhUt9HlcMw: folds
mJhwEVg7F695DiO+RIhM5g: folds
ItDFe9gh5QYPQB9vC4ntUA: folds
3RFwE6igZ1BGKOGuab6iiw: folds
TAfo4veNRaRlzDXMMYS3Jg collected $2 from pot
TAfo4veNRaRlzDXMMYS3Jg: doesn't show hand
*** SUMMARY ***
Total pot $2 | Rake $0
Seat 1: 3RFwE6igZ1BGKOGuab6iiw (small blind) folded before Flop
Seat 2: TAfo4veNRaRlzDXMMYS3Jg (big blind) collected ($2)
Seat 3: g7gL2NLJCdZPPV399WKT1w folded before Flop (didn't bet)
Seat 4: IYBKVnE2Basnr88BAhH+bQ folded before Flop (didn't bet)
Seat 5: A+9gcmwAl0eFxxbAwRY1OA folded before Flop (didn't bet)
Seat 7: tsTv4D+ne2W0qhUt9HlcMw folded before Flop (didn't bet)
Seat 8: mJhwEVg7F695DiO+RIhM5g folded before Flop (didn't bet)
Seat 9: ItDFe9gh5QYPQB9vC4ntUA (button) folded before Flop (didn't bet)



PokerStars Game #59941941808:  Hold'em No Limit ($1/$2) - 2009/07/01 1:51:03 ET
Table 'qVXak+oTeDXMGbWa4sDU5Q' 9-max Seat #9 is the button
Seat 1: H6Z4+qu8gR0VUiPOijndVg ($206.45 in chips)
Seat 2: CST1bO+CmVQOtNgiT0cKPg ($164.80 in chips)
Seat 3: WUlHm+ydPPHG7Lb0rePSdA ($177.35 in chips)
Seat 4: lQYT23h5QCUVZAKxjOO39Q ($177.10 in chips)
Seat 7: 6oGEJqk9oDy29sSaLs+LGA ($18.65 in chips)
Seat 8: Z0rzUi0y1x80UdIpofoNbA ($111.15 in chips)
Seat 9: CkE3IyJF1KvdaAOmZY5XqQ ($207.55 in chips)
H6Z4+qu8gR0VUiPOijndVg: posts small blind $1
CST1bO+CmVQOtNgiT0cKPg: posts big blind $2
zJtQ1gxyi72XvGYS1tM+DA: sits out
gxYDp0GZEzKoOg07Km9LaA: sits out
*** HOLE CARDS ***
WUlHm+ydPPHG7Lb0rePSdA: folds
lQYT23h5QCUVZAKxjOO39Q: folds
6oGEJqk9oDy29sSaLs+LGA: raises $6 to $8
Z0rzUi0y1x80UdIpofoNbA: folds
CkE3IyJF1KvdaAOmZY5XqQ: calls $8
H6Z4+qu8gR0VUiPOijndVg: folds
gxYDp0GZEzKoOg07Km9LaA leaves the table
CST1bO+CmVQOtNgiT0cKPg: folds
*** FLOP *** [Jd Kh 6d]
6oGEJqk9oDy29sSaLs+LGA: bets $10.65 and is all-in
CkE3IyJF1KvdaAOmZY5XqQ: calls $10.65
*** TURN *** [Jd Kh 6d] [5d]
*** RIVER *** [Jd Kh 6d 5d] [9s]
*** SHOW DOWN ***
6oGEJqk9oDy29sSaLs+LGA: shows [Ts Js] (a pair of Jacks)
CkE3IyJF1KvdaAOmZY5XqQ: shows [Kd Qd] (a flush, King high)
CkE3IyJF1KvdaAOmZY5XqQ collected $38.35 from pot
*** SUMMARY ***
Total pot $40.30 | Rake $1.95
Board [Jd Kh 6d 5d 9s]
Seat 1: H6Z4+qu8gR0VUiPOijndVg (small blind) folded before Flop
Seat 2: CST1bO+CmVQOtNgiT0cKPg (big blind) folded before Flop
Seat 3: WUlHm+ydPPHG7Lb0rePSdA folded before Flop (didn't bet)
Seat 4: lQYT23h5QCUVZAKxjOO39Q folded before Flop (didn't bet)
Seat 7: 6oGEJqk9oDy29sSaLs+LGA showed [Ts Js] and lost with a pair of Jacks
Seat 8: Z0rzUi0y1x80UdIpofoNbA folded before Flop (didn't bet)
Seat 9: CkE3IyJF1KvdaAOmZY5XqQ (button) showed [Kd Qd] and won ($38.35) with a flush, King high



PokerStars Game #59941943852:  Hold'em No Limit ($1/$2) - 2009/07/01 1:51:07 ET
Table 'mGpP9StWRnoeiBDExc6Frg' 6-max Seat #6 is the button
Seat 1: VvdR9F3I+2yELkfTVvC1dg ($312.85 in chips)
Seat 2: 6hRJ68JkbJq6MYI9o5bUnQ ($103 in chips)
Seat 4: 4dcDwIHRm96PwtqkpQiuiA ($87.70 in chips)
Seat 5: d1puGuVBE0fidn+5eRJ0tw ($190.35 in chips)
Seat 6: B2Ih1sr5VZk+8He7rcrMtQ ($402.45 in chips)
VvdR9F3I+2yELkfTVvC1dg: posts small blind $1
6hRJ68JkbJq6MYI9o5bUnQ: posts big blind $2
mddoKnqZkdOH7AJOJ/i0DA: sits out
*** HOLE CARDS ***
4dcDwIHRm96PwtqkpQiuiA: folds
d1puGuVBE0fidn+5eRJ0tw: folds
B2Ih1sr5VZk+8He7rcrMtQ: folds
VvdR9F3I+2yELkfTVvC1dg: folds
6hRJ68JkbJq6MYI9o5bUnQ collected $2 from pot
*** SUMMARY ***
Total pot $2 | Rake $0
Seat 1: VvdR9F3I+2yELkfTVvC1dg (small blind) folded before Flop
Seat 2: 6hRJ68JkbJq6MYI9o5bUnQ (big blind) collected ($2)
Seat 4: 4dcDwIHRm96PwtqkpQiuiA folded before Flop (didn't bet)
Seat 5: d1puGuVBE0fidn+5eRJ0tw folded before Flop (didn't bet)
Seat 6: B2Ih1sr5VZk+8He7rcrMtQ (button) folded before Flop (didn't bet)



PokerStars Game #59941943822:  Hold'em No Limit ($1/$2) - 2009/07/01 1:51:07 ET
Table '4NGNnZ/osQfNq6abYqkJeA' 6-max Seat #5 is the button
Seat 2: 669iGNwYwgRZg3nhS+aDAQ ($105.25 in chips)
Seat 3: 54yWzRRgS0oZ+S6LwZBxMQ ($76.65 in chips)
Seat 4: sY+4Uuh5z/6AbXXaCS10jw ($306.10 in chips)
Seat 5: VvdR9F3I+2yELkfTVvC1dg ($211.80 in chips)
Seat 6: /PH6Ffnho4Ysm8S3V/oa+w ($40 in chips)
/PH6Ffnho4Ysm8S3V/oa+w: posts small blind $1
669iGNwYwgRZg3nhS+aDAQ: posts big blind $2
*** HOLE CARDS ***
54yWzRRgS0oZ+S6LwZBxMQ: calls $2
sY+4Uuh5z/6AbXXaCS10jw: folds
VvdR9F3I+2yELkfTVvC1dg: folds
/PH6Ffnho4Ysm8S3V/oa+w: folds
669iGNwYwgRZg3nhS+aDAQ: checks
*** FLOP *** [Ks Jd Ah]
669iGNwYwgRZg3nhS+aDAQ: bets $6
54yWzRRgS0oZ+S6LwZBxMQ: folds
669iGNwYwgRZg3nhS+aDAQ collected $4.75 from pot
*** SUMMARY ***
Total pot $5 | Rake $0.25
Board [Ks Jd Ah]
Seat 2: 669iGNwYwgRZg3nhS+aDAQ (big blind) collected ($4.75)
Seat 3: 54yWzRRgS0oZ+S6LwZBxMQ folded on the Flop
Seat 4: sY+4Uuh5z/6AbXXaCS10jw folded before Flop (didn't bet)
Seat 5: VvdR9F3I+2yELkfTVvC1dg (button) folded before Flop (didn't bet)
Seat 6: /PH6Ffnho4Ysm8S3V/oa+w (small blind) folded before Flop



PokerStars Game #59941944200:  Hold'em No Limit ($1/$2) - 2009/07/01 1:51:08 ET
Table '+hSnXFQrGw1PlVgTnuj+sA' 6-max Seat #5 is the button
Seat 1: fb8ooqw9ZsZtBsZTZQLNrQ ($54.70 in chips)
Seat 2: 54yWzRRgS0oZ+S6LwZBxMQ ($25.10 in chips)
Seat 3: cupOBdycmBLQKdVftyAksg ($49.10 in chips)
Seat 4: TRSUrOQh3x1NGeD+dH4yoA ($94.10 in chips)
Seat 5: PZzUwZiFNhCLi6Ouh5ZlmQ ($200 in chips)
Seat 6: 7zM38baFvmCNB/F80oE0cQ ($46.55 in chips)
7zM38baFvmCNB/F80oE0cQ: posts small blind $1
fb8ooqw9ZsZtBsZTZQLNrQ: posts big blind $2
*** HOLE CARDS ***
54yWzRRgS0oZ+S6LwZBxMQ: folds
cupOBdycmBLQKdVftyAksg: folds
TRSUrOQh3x1NGeD+dH4yoA: folds
PZzUwZiFNhCLi6Ouh5ZlmQ: folds
7zM38baFvmCNB/F80oE0cQ: calls $1
fb8ooqw9ZsZtBsZTZQLNrQ: checks
*** FLOP *** [4h Td 3d]
7zM38baFvmCNB/F80oE0cQ: bets $4
fb8ooqw9ZsZtBsZTZQLNrQ: folds
7zM38baFvmCNB/F80oE0cQ collected $3.80 from pot
7zM38baFvmCNB/F80oE0cQ: doesn't show hand
*** SUMMARY ***
Total pot $4 | Rake $0.20
Board [4h Td 3d]
Seat 1: fb8ooqw9ZsZtBsZTZQLNrQ (big blind) folded on the Flop
Seat 2: 54yWzRRgS0oZ+S6LwZBxMQ folded before Flop (didn't bet)
Seat 3: cupOBdycmBLQKdVftyAksg folded before Flop (didn't bet)
Seat 4: TRSUrOQh3x1NGeD+dH4yoA folded before Flop (didn't bet)
Seat 5: PZzUwZiFNhCLi6Ouh5ZlmQ (button) folded before Flop (didn't bet)
Seat 6: 7zM38baFvmCNB/F80oE0cQ (small blind) collected ($3.80)



PokerStars Game #59941944246:  Hold'em No Limit ($1/$2) - 2009/07/01 1:51:08 ET
Table 'NmY84NAf9Mh0ckAckHnh5g' 2-max Seat #2 is the button
Seat 1: 6hvg964TSqZ3AL/0XK9aVQ ($552.35 in chips)
Seat 2: RwDoM55ZeQuI2ADyJhOb2Q ($430.55 in chips)
RwDoM55ZeQuI2ADyJhOb2Q: posts small blind $1
6hvg964TSqZ3AL/0XK9aVQ: posts big blind $2
*** HOLE CARDS ***
RwDoM55ZeQuI2ADyJhOb2Q: raises $4 to $6
6hvg964TSqZ3AL/0XK9aVQ: calls $4
*** FLOP *** [4h Kc 9h]
6hvg964TSqZ3AL/0XK9aVQ: checks
RwDoM55ZeQuI2ADyJhOb2Q: bets $10
6hvg964TSqZ3AL/0XK9aVQ: folds
RwDoM55ZeQuI2ADyJhOb2Q collected $11.50 from pot
RwDoM55ZeQuI2ADyJhOb2Q: doesn't show hand
*** SUMMARY ***
Total pot $12 | Rake $0.50
Board [4h Kc 9h]
Seat 1: 6hvg964TSqZ3AL/0XK9aVQ (big blind) folded on the Flop
Seat 2: RwDoM55ZeQuI2ADyJhOb2Q (button) (small blind) collected ($11.50)



PokerStars Game #59941944598:  Hold'em No Limit ($1/$2) - 2009/07/01 1:51:09 ET
Table 'ZzSIe0zTCDv+n6hfbY5tTg' 6-max Seat #4 is the button
Seat 1: VvdR9F3I+2yELkfTVvC1dg ($266.35 in chips)
Seat 2: B87ikIyZ/TzAVeXf38Ny0g ($225 in chips)
Seat 3: gsugPj31Hui3Jefl98MBOA ($365.70 in chips)
Seat 4: 54yWzRRgS0oZ+S6LwZBxMQ ($45.10 in chips)
Seat 5: 3dAbvkxS5NPQTBAbvpinVg ($482.45 in chips)
Seat 6: 09BNF4quPDzanQzM8vc6WA ($36 in chips)
3dAbvkxS5NPQTBAbvpinVg: posts small blind $1
09BNF4quPDzanQzM8vc6WA: posts big blind $2
*** HOLE CARDS ***
VvdR9F3I+2yELkfTVvC1dg: raises $2 to $4
B87ikIyZ/TzAVeXf38Ny0g: folds
gsugPj31Hui3Jefl98MBOA: calls $4
54yWzRRgS0oZ+S6LwZBxMQ: folds
3dAbvkxS5NPQTBAbvpinVg: folds
09BNF4quPDzanQzM8vc6WA: folds
*** FLOP *** [9h 6s Qc]
VvdR9F3I+2yELkfTVvC1dg: bets $7.80
gsugPj31Hui3Jefl98MBOA: raises $7.80 to $15.60
VvdR9F3I+2yELkfTVvC1dg: calls $7.80
*** TURN *** [9h 6s Qc] [Qh]
VvdR9F3I+2yELkfTVvC1dg: checks
gsugPj31Hui3Jefl98MBOA: checks
*** RIVER *** [9h 6s Qc Qh] [Ks]
VvdR9F3I+2yELkfTVvC1dg: bets $24.50
gsugPj31Hui3Jefl98MBOA: folds
VvdR9F3I+2yELkfTVvC1dg collected $40.15 from pot
VvdR9F3I+2yELkfTVvC1dg: doesn't show hand
*** SUMMARY ***
Total pot $42.20 | Rake $2.05
Board [9h 6s Qc Qh Ks]
Seat 1: VvdR9F3I+2yELkfTVvC1dg collected ($40.15)
Seat 2: B87ikIyZ/TzAVeXf38Ny0g folded before Flop (didn't bet)
Seat 3: gsugPj31Hui3Jefl98MBOA folded on the River
Seat 4: 54yWzRRgS0oZ+S6LwZBxMQ (button) folded before Flop (didn't bet)
Seat 5: 3dAbvkxS5NPQTBAbvpinVg (small blind) folded before Flop
Seat 6: 09BNF4quPDzanQzM8vc6WA (big blind) folded before Flop



PokerStars Game #59941945506:  Hold'em No Limit ($1/$2) - 2009/07/01 1:51:10 ET
Table 'ztv6V3FN2bQ9nmJPPdx6nQ' 6-max Seat #6 is the button
Seat 1: 6fLdOUCRtX71xbVRhJEq8w ($298.35 in chips)
Seat 2: 5Y+ZGWLI4gnlpApDX5vy1A ($371.05 in chips)
Seat 4: UaZ5yj+6LjtWqMQg2QskUw ($75.55 in chips)
Seat 5: sTPOWERd9HWPCNrDBwsVjA ($216.60 in chips)
Seat 6: mfy7uGZcqA2PVQqEVbJ7+g ($83.20 in chips)
6fLdOUCRtX71xbVRhJEq8w: posts small blind $1
5Y+ZGWLI4gnlpApDX5vy1A: posts big blind $2
*** HOLE CARDS ***
UaZ5yj+6LjtWqMQg2QskUw: folds
sTPOWERd9HWPCNrDBwsVjA: folds
mfy7uGZcqA2PVQqEVbJ7+g: folds
6fLdOUCRtX71xbVRhJEq8w: folds
5Y+ZGWLI4gnlpApDX5vy1A collected $2 from pot
5Y+ZGWLI4gnlpApDX5vy1A: doesn't show hand
*** SUMMARY ***
Total pot $2 | Rake $0
Seat 1: 6fLdOUCRtX71xbVRhJEq8w (small blind) folded before Flop
Seat 2: 5Y+ZGWLI4gnlpApDX5vy1A (big blind) collected ($2)
Seat 4: UaZ5yj+6LjtWqMQg2QskUw folded before Flop (didn't bet)
Seat 5: sTPOWERd9HWPCNrDBwsVjA folded before Flop (didn't bet)
Seat 6: mfy7uGZcqA2PVQqEVbJ7+g (button) folded before Flop (didn't bet)



PokerStars Game #59941945376:  Hold'em No Limit ($1/$2) - 2009/07/01 1:51:10 ET
Table 'gnHBqWll9O3fxG7Ojkz/ng' 9-max Seat #2 is the button
Seat 1: MtdNf9cdM7+0CSU0dx4USA ($79.35 in chips)
Seat 2: H6Z4+qu8gR0VUiPOijndVg ($327.30 in chips)
Seat 3: 5Q8U6iZbeO7xJSS4qvDP5g ($239.10 in chips)
Seat 4: nXDI8Y/S6POzRwANu3d8hQ ($16 in chips)
Seat 5: rBQDMkKm9cZn6M9NPsiVew ($169.15 in chips)
Seat 6: KqHysDSpCPaPyK3tJC1aEw ($200 in chips)
Seat 7: 254YPxPJr5Sw58bkD0YqYQ ($203 in chips)
Seat 9: GX1heJ+DSsvm7gzSPsYhhQ ($46.15 in chips)
5Q8U6iZbeO7xJSS4qvDP5g: posts small blind $1
nXDI8Y/S6POzRwANu3d8hQ: posts big blind $2
MtdNf9cdM7+0CSU0dx4USA: posts big blind $2
*** HOLE CARDS ***
rBQDMkKm9cZn6M9NPsiVew: folds
cM6efHzdxoqYm0EQKP4TTQ has returned
KqHysDSpCPaPyK3tJC1aEw: folds
254YPxPJr5Sw58bkD0YqYQ: folds
GX1heJ+DSsvm7gzSPsYhhQ: folds
MtdNf9cdM7+0CSU0dx4USA: checks
H6Z4+qu8gR0VUiPOijndVg: raises $8 to $10
5Q8U6iZbeO7xJSS4qvDP5g: folds
nXDI8Y/S6POzRwANu3d8hQ: folds
MtdNf9cdM7+0CSU0dx4USA: folds
H6Z4+qu8gR0VUiPOijndVg collected $7 from pot
H6Z4+qu8gR0VUiPOijndVg: doesn't show hand
*** SUMMARY ***
Total pot $7 | Rake $0
Seat 1: MtdNf9cdM7+0CSU0dx4USA folded before Flop
Seat 2: H6Z4+qu8gR0VUiPOijndVg (button) collected ($7)
Seat 3: 5Q8U6iZbeO7xJSS4qvDP5g (small blind) folded before Flop
Seat 4: nXDI8Y/S6POzRwANu3d8hQ (big blind) folded before Flop
Seat 5: rBQDMkKm9cZn6M9NPsiVew folded before Flop (didn't bet)
Seat 6: KqHysDSpCPaPyK3tJC1aEw folded before Flop (didn't bet)
Seat 7: 254YPxPJr5Sw58bkD0YqYQ folded before Flop (didn't bet)
Seat 9: GX1heJ+DSsvm7gzSPsYhhQ folded before Flop (didn't bet)



PokerStars Game #59941945978:  Hold'em No Limit ($1/$2) - 2009/07/01 1:51:11 ET
Table 'aSf77Sj8QEnzcc0WaxVD4Q' 6-max Seat #2 is the button
Seat 1: UELtvp+JfwI7XDGVwSxZXA ($169.05 in chips)
Seat 2: vkfxu8f/jMYKUk6Ly4eujw ($186.10 in chips)
Seat 3: 9dpyyjDTCed6nV7JhaUUpw ($758.50 in chips)
Seat 4: YsLQ3BAvgQHWXMAv3Wv6Hg ($200 in chips)
Seat 5: VvdR9F3I+2yELkfTVvC1dg ($301.70 in chips)
Seat 6: vkoJRf3gidxY1pPi0AFWww ($172.25 in chips)
9dpyyjDTCed6nV7JhaUUpw: posts small blind $1
YsLQ3BAvgQHWXMAv3Wv6Hg: posts big blind $2
*** HOLE CARDS ***
VvdR9F3I+2yELkfTVvC1dg: raises $2 to $4
vkoJRf3gidxY1pPi0AFWww: folds
UELtvp+JfwI7XDGVwSxZXA: folds
vkfxu8f/jMYKUk6Ly4eujw: folds
9dpyyjDTCed6nV7JhaUUpw: folds
YsLQ3BAvgQHWXMAv3Wv6Hg: folds
VvdR9F3I+2yELkfTVvC1dg collected $5 from pot
VvdR9F3I+2yELkfTVvC1dg: doesn't show hand
*** SUMMARY ***
Total pot $5 | Rake $0
Seat 1: UELtvp+JfwI7XDGVwSxZXA folded before Flop (didn't bet)
Seat 2: vkfxu8f/jMYKUk6Ly4eujw (button) folded before Flop (didn't bet)
Seat 3: 9dpyyjDTCed6nV7JhaUUpw (small blind) folded before Flop
Seat 4: YsLQ3BAvgQHWXMAv3Wv6Hg (big blind) folded before Flop
Seat 5: VvdR9F3I+2yELkfTVvC1dg collected ($5)
Seat 6: vkoJRf3gidxY1pPi0AFWww folded before Flop (didn't bet)



PokerStars Game #59941945798:  Hold'em No Limit ($1/$2) - 2009/07/01 1:51:11 ET
Table 'o63a8j70meKHUtgLFryQvg' 9-max Seat #3 is the button
Seat 1: +1R0op5O3Gf6aUPJTw7jjA ($197 in chips)
Seat 2: SgA0Zfa/3yhNp7ILXcXcCg ($68.15 in chips)
Seat 3: IYBKVnE2Basnr88BAhH+bQ ($265.40 in chips)
Seat 4: ZYHoLw2lWmRS7CSHi8L8Xg ($207.90 in chips)
Seat 5: g3ZVTc1EbSNXYYMO82jL7Q ($200 in chips)
Seat 6: CUZwDpLTQKhzarPe+JCLOQ ($200 in chips)
Seat 8: ItDFe9gh5QYPQB9vC4ntUA ($365.05 in chips)
ZYHoLw2lWmRS7CSHi8L8Xg: posts small blind $1
g3ZVTc1EbSNXYYMO82jL7Q: posts big blind $2
kM9CA+2UcdMjbCMbtUCGiA: sits out
TAfo4veNRaRlzDXMMYS3Jg: sits out
*** HOLE CARDS ***
CUZwDpLTQKhzarPe+JCLOQ: folds
ItDFe9gh5QYPQB9vC4ntUA: raises $6 to $8
+1R0op5O3Gf6aUPJTw7jjA: folds
SgA0Zfa/3yhNp7ILXcXcCg: folds
IYBKVnE2Basnr88BAhH+bQ: folds
ZYHoLw2lWmRS7CSHi8L8Xg: folds
g3ZVTc1EbSNXYYMO82jL7Q: folds
ItDFe9gh5QYPQB9vC4ntUA collected $5 from pot
*** SUMMARY ***
Total pot $5 | Rake $0
Seat 1: +1R0op5O3Gf6aUPJTw7jjA folded before Flop (didn't bet)
Seat 2: SgA0Zfa/3yhNp7ILXcXcCg folded before Flop (didn't bet)
Seat 3: IYBKVnE2Basnr88BAhH+bQ (button) folded before Flop (didn't bet)
Seat 4: ZYHoLw2lWmRS7CSHi8L8Xg (small blind) folded before Flop
Seat 5: g3ZVTc1EbSNXYYMO82jL7Q (big blind) folded before Flop
Seat 6: CUZwDpLTQKhzarPe+JCLOQ folded before Flop (didn't bet)
Seat 8: ItDFe9gh5QYPQB9vC4ntUA collected ($5)



PokerStars Game #59941946606:  Hold'em No Limit ($1/$2) - 2009/07/01 1:51:12 ET
Table '5/wEe6JmtGD7vufSA2RG7A' 2-max Seat #1 is the button
Seat 1: pVqEzK9wXlRMECnb1Zg4Zw ($221.50 in chips)
Seat 2: aOL8geThaYp2iadSHl1h1g ($202 in chips)
pVqEzK9wXlRMECnb1Zg4Zw: posts small blind $1
aOL8geThaYp2iadSHl1h1g: posts big blind $2
*** HOLE CARDS ***
pVqEzK9wXlRMECnb1Zg4Zw: raises $6 to $8
aOL8geThaYp2iadSHl1h1g: raises $18 to $26
pVqEzK9wXlRMECnb1Zg4Zw: calls $18
*** FLOP *** [7d 2c 4d]
aOL8geThaYp2iadSHl1h1g: bets $24
pVqEzK9wXlRMECnb1Zg4Zw: raises $171.50 to $195.50 and is all-in
aOL8geThaYp2iadSHl1h1g: calls $152 and is all-in
*** TURN *** [7d 2c 4d] [Qd]
*** RIVER *** [7d 2c 4d Qd] [Ks]
*** SHOW DOWN ***
aOL8geThaYp2iadSHl1h1g: shows [Kc Ad] (a pair of Kings)
pVqEzK9wXlRMECnb1Zg4Zw: mucks hand
aOL8geThaYp2iadSHl1h1g collected $403.50 from pot
*** SUMMARY ***
Total pot $404 | Rake $0.50
Board [7d 2c 4d Qd Ks]
Seat 1: pVqEzK9wXlRMECnb1Zg4Zw (button) (small blind) mucked
Seat 2: aOL8geThaYp2iadSHl1h1g (big blind) showed [Kc Ad] and won ($403.50) with a pair of Kings



PokerStars Game #59941948150:  Hold'em No Limit ($1/$2) - 2009/07/01 1:51:15 ET
Table 'TsEDkiO4tzCTCzJ7tNdEqw' 6-max Seat #6 is the button
Seat 2: 4dcDwIHRm96PwtqkpQiuiA ($77.40 in chips)
Seat 3: ubtx4Z5L+AcK71MTvYiGVw ($211.20 in chips)
Seat 4: K8MXCrNAVYlMnnCeM32Kxw ($124.35 in chips)
Seat 5: VvdR9F3I+2yELkfTVvC1dg ($243.35 in chips)
Seat 6: uCqEjnxh2/vFBjKYkfTOkw ($284.80 in chips)
4dcDwIHRm96PwtqkpQiuiA: posts small blind $1
ubtx4Z5L+AcK71MTvYiGVw: posts big blind $2
*** HOLE CARDS ***
K8MXCrNAVYlMnnCeM32Kxw: raises $2 to $4
Nsjun4mjI8q0SSBTIp1dIQ joins the table at seat #1
VvdR9F3I+2yELkfTVvC1dg: folds
uCqEjnxh2/vFBjKYkfTOkw: folds
4dcDwIHRm96PwtqkpQiuiA: folds
ubtx4Z5L+AcK71MTvYiGVw: folds
K8MXCrNAVYlMnnCeM32Kxw collected $5 from pot
*** SUMMARY ***
Total pot $5 | Rake $0
Seat 2: 4dcDwIHRm96PwtqkpQiuiA (small blind) folded before Flop
Seat 3: ubtx4Z5L+AcK71MTvYiGVw (big blind) folded before Flop
Seat 4: K8MXCrNAVYlMnnCeM32Kxw collected ($5)
Seat 5: VvdR9F3I+2yELkfTVvC1dg folded before Flop (didn't bet)
Seat 6: uCqEjnxh2/vFBjKYkfTOkw (button) folded before Flop (didn't bet)



PokerStars Game #59941948742:  Hold'em No Limit ($1/$2) - 2009/07/01 1:51:16 ET
Table 'QxerF7GUfCbl+4a8XaTB2w' 6-max Seat #5 is the button
Seat 1: ZwvXzkkZ3XpMhKfAmVpahw ($329.75 in chips)
Seat 2: 6UGgYbxwWNc+ohObe8vB9w ($39.75 in chips)
Seat 3: 8rZGabKe2DEPdZCbCivZ9Q ($27 in chips)
Seat 4: /PH6Ffnho4Ysm8S3V/oa+w ($53 in chips)
Seat 5: vkfxu8f/jMYKUk6Ly4eujw ($152.05 in chips)
Seat 6: VvdR9F3I+2yELkfTVvC1dg ($211.70 in chips)
VvdR9F3I+2yELkfTVvC1dg: posts small blind $1
ZwvXzkkZ3XpMhKfAmVpahw: posts big blind $2
*** HOLE CARDS ***
6UGgYbxwWNc+ohObe8vB9w: calls $2
8rZGabKe2DEPdZCbCivZ9Q: folds
/PH6Ffnho4Ysm8S3V/oa+w: folds
vkfxu8f/jMYKUk6Ly4eujw: folds
VvdR9F3I+2yELkfTVvC1dg: folds
ZwvXzkkZ3XpMhKfAmVpahw: checks
*** FLOP *** [9s 6h 6d]
ZwvXzkkZ3XpMhKfAmVpahw: checks
6UGgYbxwWNc+ohObe8vB9w: checks
*** TURN *** [9s 6h 6d] [Qc]
ZwvXzkkZ3XpMhKfAmVpahw: checks
6UGgYbxwWNc+ohObe8vB9w: bets $4
ZwvXzkkZ3XpMhKfAmVpahw: folds
6UGgYbxwWNc+ohObe8vB9w collected $4.75 from pot
*** SUMMARY ***
Total pot $5 | Rake $0.25
Board [9s 6h 6d Qc]
Seat 1: ZwvXzkkZ3XpMhKfAmVpahw (big blind) folded on the Turn
Seat 2: 6UGgYbxwWNc+ohObe8vB9w collected ($4.75)
Seat 3: 8rZGabKe2DEPdZCbCivZ9Q folded before Flop (didn't bet)
Seat 4: /PH6Ffnho4Ysm8S3V/oa+w folded before Flop (didn't bet)
Seat 5: vkfxu8f/jMYKUk6Ly4eujw (button) folded before Flop (didn't bet)
Seat 6: VvdR9F3I+2yELkfTVvC1dg (small blind) folded before Flop



PokerStars Game #59941948720:  Hold'em No Limit ($1/$2) - 2009/07/01 1:51:16 ET
Table 'BSRfGh+QobUe0AgIMtt/fw' 9-max Seat #5 is the button
Seat 1: gDn/rYeNwCyWEgRhyWp4PA ($159.05 in chips)
Seat 2: +SmnXtdmwqXGEJfLeJDIUQ ($123.90 in chips)
Seat 3: WUlHm+ydPPHG7Lb0rePSdA ($120 in chips)
Seat 4: +T/63sAeZzWyHchahJ36GQ ($31 in chips)
Seat 5: ThVDqrMpsvd7Ax6KINfuew ($61.50 in chips)
Seat 6: H6Z4+qu8gR0VUiPOijndVg ($203 in chips)
Seat 7: CkE3IyJF1KvdaAOmZY5XqQ ($205 in chips)
Seat 8: GG5lTuGt3+kwNYSbqeB6yw ($78.85 in chips)
Seat 9: tjgwwDmi+N2H4I7hx8useQ ($81 in chips)
H6Z4+qu8gR0VUiPOijndVg: posts small blind $1
CkE3IyJF1KvdaAOmZY5XqQ: posts big blind $2
*** HOLE CARDS ***
GG5lTuGt3+kwNYSbqeB6yw: folds
tjgwwDmi+N2H4I7hx8useQ: folds
gDn/rYeNwCyWEgRhyWp4PA: folds
+SmnXtdmwqXGEJfLeJDIUQ: folds
WUlHm+ydPPHG7Lb0rePSdA: folds
+T/63sAeZzWyHchahJ36GQ: folds
ThVDqrMpsvd7Ax6KINfuew: raises $4 to $6
H6Z4+qu8gR0VUiPOijndVg: folds
CkE3IyJF1KvdaAOmZY5XqQ: folds
ThVDqrMpsvd7Ax6KINfuew collected $5 from pot
*** SUMMARY ***
Total pot $5 | Rake $0
Seat 1: gDn/rYeNwCyWEgRhyWp4PA folded before Flop (didn't bet)
Seat 2: +SmnXtdmwqXGEJfLeJDIUQ folded before Flop (didn't bet)
Seat 3: WUlHm+ydPPHG7Lb0rePSdA folded before Flop (didn't bet)
Seat 4: +T/63sAeZzWyHchahJ36GQ folded before Flop (didn't bet)
Seat 5: ThVDqrMpsvd7Ax6KINfuew (button) collected ($5)
Seat 6: H6Z4+qu8gR0VUiPOijndVg (small blind) folded before Flop
Seat 7: CkE3IyJF1KvdaAOmZY5XqQ (big blind) folded before Flop
Seat 8: GG5lTuGt3+kwNYSbqeB6yw folded before Flop (didn't bet)
Seat 9: tjgwwDmi+N2H4I7hx8useQ folded before Flop (didn't bet)



PokerStars Game #59941950134:  Hold'em No Limit ($1/$2) - 2009/07/01 1:51:19 ET
Table 'uJ9juaXXg9yIcSU8amxaXQ' 6-max Seat #2 is the button
Seat 1: JsqOjN/eHz0uYVf/PyUJ6Q ($121.95 in chips)
Seat 2: VvdR9F3I+2yELkfTVvC1dg ($210.05 in chips)
Seat 3: qXDd0ZyMIse0OBu8pxeQ3Q ($235.40 in chips)
Seat 4: zNjJ/y4emmF+vzrCDd+ooA ($273.55 in chips)
Seat 6: /PH6Ffnho4Ysm8S3V/oa+w ($43 in chips)
qXDd0ZyMIse0OBu8pxeQ3Q: posts small blind $1
zNjJ/y4emmF+vzrCDd+ooA: posts big blind $2
YsLQ3BAvgQHWXMAv3Wv6Hg: sits out
*** HOLE CARDS ***
/PH6Ffnho4Ysm8S3V/oa+w: folds
JsqOjN/eHz0uYVf/PyUJ6Q: calls $2
VvdR9F3I+2yELkfTVvC1dg: folds
qXDd0ZyMIse0OBu8pxeQ3Q: raises $8 to $10
zNjJ/y4emmF+vzrCDd+ooA: folds
JsqOjN/eHz0uYVf/PyUJ6Q: folds
qXDd0ZyMIse0OBu8pxeQ3Q collected $6 from pot
*** SUMMARY ***
Total pot $6 | Rake $0
Seat 1: JsqOjN/eHz0uYVf/PyUJ6Q folded before Flop
Seat 2: VvdR9F3I+2yELkfTVvC1dg (button) folded before Flop (didn't bet)
Seat 3: qXDd0ZyMIse0OBu8pxeQ3Q (small blind) collected ($6)
Seat 4: zNjJ/y4emmF+vzrCDd+ooA (big blind) folded before Flop
Seat 6: /PH6Ffnho4Ysm8S3V/oa+w folded before Flop (didn't bet)



PokerStars Game #59941950748:  Hold'em No Limit ($1/$2) - 2009/07/01 1:51:20 ET
Table 'jlrIxbrVIG+gjaUYT4za8g' 6-max Seat #5 is the button
Seat 2: cwfuMyvDC7J7SqX2leDC8g ($46 in chips)
Seat 3: 3LCfF9/CuJ9+kbFOcqmuaQ ($112.50 in chips)
Seat 4: 8srN1dKQePlsv0GyTada+Q ($260.50 in chips)
Seat 5: AyBB0k3Dcl7xbXUeGMw06g ($68.75 in chips)
Seat 6: BWhgxe7gWiYobRbwdG+d2Q ($202.30 in chips)
BWhgxe7gWiYobRbwdG+d2Q: posts small blind $1
cwfuMyvDC7J7SqX2leDC8g: posts big blind $2
3LCfF9/CuJ9+kbFOcqmuaQ: posts big blind $2
*** HOLE CARDS ***
3LCfF9/CuJ9+kbFOcqmuaQ: checks
8srN1dKQePlsv0GyTada+Q: folds
AyBB0k3Dcl7xbXUeGMw06g: folds
BWhgxe7gWiYobRbwdG+d2Q: folds
cwfuMyvDC7J7SqX2leDC8g: checks
*** FLOP *** [9c 6s 4c]
cwfuMyvDC7J7SqX2leDC8g: checks
opJMdoq0E6TRbAQiweyQuA joins the table at seat #1
3LCfF9/CuJ9+kbFOcqmuaQ: checks
*** TURN *** [9c 6s 4c] [Jd]
cwfuMyvDC7J7SqX2leDC8g: checks
3LCfF9/CuJ9+kbFOcqmuaQ: bets $4
cwfuMyvDC7J7SqX2leDC8g: calls $4
*** RIVER *** [9c 6s 4c Jd] [5h]
cwfuMyvDC7J7SqX2leDC8g: checks
3LCfF9/CuJ9+kbFOcqmuaQ: bets $10
cwfuMyvDC7J7SqX2leDC8g: raises $10 to $20
3LCfF9/CuJ9+kbFOcqmuaQ: calls $10
*** SHOW DOWN ***
cwfuMyvDC7J7SqX2leDC8g: shows [7s 8d] (a straight, Five to Nine)
3LCfF9/CuJ9+kbFOcqmuaQ: mucks hand
cwfuMyvDC7J7SqX2leDC8g collected $51 from pot
*** SUMMARY ***
Total pot $53 | Rake $2
Board [9c 6s 4c Jd 5h]
Seat 2: cwfuMyvDC7J7SqX2leDC8g (big blind) showed [7s 8d] and won ($51) with a straight, Five to Nine
Seat 3: 3LCfF9/CuJ9+kbFOcqmuaQ mucked
Seat 4: 8srN1dKQePlsv0GyTada+Q folded before Flop (didn't bet)
Seat 5: AyBB0k3Dcl7xbXUeGMw06g (button) folded before Flop (didn't bet)
Seat 6: BWhgxe7gWiYobRbwdG+d2Q (small blind) folded before Flop



PokerStars Game #59941950594:  Hold'em No Limit ($1/$2) - 2009/07/01 1:51:20 ET
Table 'P/yCfYl1GfGsu/e6DxDy/A' 2-max Seat #1 is the button
Seat 1: 7fOCUy3x9hdkmXkkDNolGQ ($1052 in chips)
Seat 2: RwDoM55ZeQuI2ADyJhOb2Q ($418.50 in chips)
7fOCUy3x9hdkmXkkDNolGQ: posts small blind $1
RwDoM55ZeQuI2ADyJhOb2Q: posts big blind $2
*** HOLE CARDS ***
7fOCUy3x9hdkmXkkDNolGQ: folds
RwDoM55ZeQuI2ADyJhOb2Q collected $2 from pot
RwDoM55ZeQuI2ADyJhOb2Q: doesn't show hand
*** SUMMARY ***
Total pot $2 | Rake $0
Seat 1: 7fOCUy3x9hdkmXkkDNolGQ (button) (small blind) folded before Flop
Seat 2: RwDoM55ZeQuI2ADyJhOb2Q (big blind) collected ($2)



PokerStars Game #59941951982:  Hold'em No Limit ($1/$2) - 2009/07/01 1:51:23 ET
Table 'NmY84NAf9Mh0ckAckHnh5g' 2-max Seat #1 is the button
Seat 1: 6hvg964TSqZ3AL/0XK9aVQ ($546.35 in chips)
Seat 2: RwDoM55ZeQuI2ADyJhOb2Q ($436.05 in chips)
6hvg964TSqZ3AL/0XK9aVQ: posts small blind $1
RwDoM55ZeQuI2ADyJhOb2Q: posts big blind $2
*** HOLE CARDS ***
6hvg964TSqZ3AL/0XK9aVQ: calls $1
RwDoM55ZeQuI2ADyJhOb2Q: checks
*** FLOP *** [3c Kh 4s]
RwDoM55ZeQuI2ADyJhOb2Q: checks
6hvg964TSqZ3AL/0XK9aVQ: bets $4
RwDoM55ZeQuI2ADyJhOb2Q: folds
6hvg964TSqZ3AL/0XK9aVQ collected $3.80 from pot
6hvg964TSqZ3AL/0XK9aVQ: doesn't show hand
*** SUMMARY ***
Total pot $4 | Rake $0.20
Board [3c Kh 4s]
Seat 1: 6hvg964TSqZ3AL/0XK9aVQ (button) (small blind) collected ($3.80)
Seat 2: RwDoM55ZeQuI2ADyJhOb2Q (big blind) folded on the Flop



PokerStars Game #59941952306:  Hold'em No Limit ($1/$2) - 2009/07/01 1:51:23 ET
Table 'ztv6V3FN2bQ9nmJPPdx6nQ' 6-max Seat #1 is the button
Seat 1: 6fLdOUCRtX71xbVRhJEq8w ($297.35 in chips)
Seat 2: 5Y+ZGWLI4gnlpApDX5vy1A ($372.05 in chips)
Seat 4: UaZ5yj+6LjtWqMQg2QskUw ($75.55 in chips)
Seat 5: sTPOWERd9HWPCNrDBwsVjA ($216.60 in chips)
Seat 6: mfy7uGZcqA2PVQqEVbJ7+g ($83.20 in chips)
5Y+ZGWLI4gnlpApDX5vy1A: posts small blind $1
UaZ5yj+6LjtWqMQg2QskUw: posts big blind $2
*** HOLE CARDS ***
sTPOWERd9HWPCNrDBwsVjA: folds
mfy7uGZcqA2PVQqEVbJ7+g: raises $4 to $6
6fLdOUCRtX71xbVRhJEq8w: folds
5Y+ZGWLI4gnlpApDX5vy1A: folds
UaZ5yj+6LjtWqMQg2QskUw: folds
mfy7uGZcqA2PVQqEVbJ7+g collected $5 from pot
mfy7uGZcqA2PVQqEVbJ7+g: doesn't show hand
*** SUMMARY ***
Total pot $5 | Rake $0
Seat 1: 6fLdOUCRtX71xbVRhJEq8w (button) folded before Flop (didn't bet)
Seat 2: 5Y+ZGWLI4gnlpApDX5vy1A (small blind) folded before Flop
Seat 4: UaZ5yj+6LjtWqMQg2QskUw (big blind) folded before Flop
Seat 5: sTPOWERd9HWPCNrDBwsVjA folded before Flop (didn't bet)
Seat 6: mfy7uGZcqA2PVQqEVbJ7+g collected ($5)



PokerStars Game #59941952650:  Hold'em No Limit ($1/$2) - 2009/07/01 1:51:24 ET
Table 'G1Oqdy4Pqdb5gtx40rUBzA' 6-max Seat #4 is the button
Seat 1: 4dMBh/1VTdeUTPCyhCs3UQ ($61.70 in chips)
Seat 2: m7mYVfnCOK5TE/VkN/FhOg ($214.05 in chips)
Seat 3: VvdR9F3I+2yELkfTVvC1dg ($419.90 in chips)
Seat 4: B87ikIyZ/TzAVeXf38Ny0g ($221.70 in chips)
Seat 5: F1+Ml47qRQWunzPnGhLLzQ ($195 in chips)
Seat 6: qCnEYuAE5y5A7bk6fO5/jQ ($203 in chips)
F1+Ml47qRQWunzPnGhLLzQ: posts small blind $1
qCnEYuAE5y5A7bk6fO5/jQ: posts big blind $2
*** HOLE CARDS ***
4dMBh/1VTdeUTPCyhCs3UQ: raises $6 to $8
m7mYVfnCOK5TE/VkN/FhOg: calls $8
VvdR9F3I+2yELkfTVvC1dg: folds
B87ikIyZ/TzAVeXf38Ny0g: folds
F1+Ml47qRQWunzPnGhLLzQ: folds
qCnEYuAE5y5A7bk6fO5/jQ: folds
*** FLOP *** [5c Ac Qh]
4dMBh/1VTdeUTPCyhCs3UQ: bets $14
m7mYVfnCOK5TE/VkN/FhOg: raises $46 to $60
4dMBh/1VTdeUTPCyhCs3UQ: folds
m7mYVfnCOK5TE/VkN/FhOg collected $44.70 from pot
m7mYVfnCOK5TE/VkN/FhOg: doesn't show hand
*** SUMMARY ***
Total pot $47 | Rake $2.30
Board [5c Ac Qh]
Seat 1: 4dMBh/1VTdeUTPCyhCs3UQ folded on the Flop
Seat 2: m7mYVfnCOK5TE/VkN/FhOg collected ($44.70)
Seat 3: VvdR9F3I+2yELkfTVvC1dg folded before Flop (didn't bet)
Seat 4: B87ikIyZ/TzAVeXf38Ny0g (button) folded before Flop (didn't bet)
Seat 5: F1+Ml47qRQWunzPnGhLLzQ (small blind) folded before Flop
Seat 6: qCnEYuAE5y5A7bk6fO5/jQ (big blind) folded before Flop



PokerStars Game #59941953338:  Hold'em No Limit ($1/$2) - 2009/07/01 1:51:25 ET
Table 'P/yCfYl1GfGsu/e6DxDy/A' 2-max Seat #2 is the button
Seat 1: 7fOCUy3x9hdkmXkkDNolGQ ($1051 in chips)
Seat 2: RwDoM55ZeQuI2ADyJhOb2Q ($419.50 in chips)
RwDoM55ZeQuI2ADyJhOb2Q: posts small blind $1
7fOCUy3x9hdkmXkkDNolGQ: posts big blind $2
*** HOLE CARDS ***
RwDoM55ZeQuI2ADyJhOb2Q: raises $4 to $6
7fOCUy3x9hdkmXkkDNolGQ: raises $14 to $20
RwDoM55ZeQuI2ADyJhOb2Q: calls $14
*** FLOP *** [5s Jh 9h]
7fOCUy3x9hdkmXkkDNolGQ: checks
RwDoM55ZeQuI2ADyJhOb2Q: bets $32
7fOCUy3x9hdkmXkkDNolGQ: calls $32
*** TURN *** [5s Jh 9h] [Ks]
7fOCUy3x9hdkmXkkDNolGQ: checks
RwDoM55ZeQuI2ADyJhOb2Q: checks
*** RIVER *** [5s Jh 9h Ks] [7s]
7fOCUy3x9hdkmXkkDNolGQ: checks
RwDoM55ZeQuI2ADyJhOb2Q: checks
*** SHOW DOWN ***
7fOCUy3x9hdkmXkkDNolGQ: shows [Kd Ac] (a pair of Kings)
RwDoM55ZeQuI2ADyJhOb2Q: mucks hand
7fOCUy3x9hdkmXkkDNolGQ collected $103.50 from pot
*** SUMMARY ***
Total pot $104 | Rake $0.50
Board [5s Jh 9h Ks 7s]
Seat 1: 7fOCUy3x9hdkmXkkDNolGQ (big blind) showed [Kd Ac] and won ($103.50) with a pair of Kings
Seat 2: RwDoM55ZeQuI2ADyJhOb2Q (button) (small blind) mucked



PokerStars Game #59941954078:  Hold'em No Limit ($1/$2) - 2009/07/01 1:51:27 ET
Table 'mGpP9StWRnoeiBDExc6Frg' 6-max Seat #1 is the button
Seat 1: VvdR9F3I+2yELkfTVvC1dg ($311.85 in chips)
Seat 2: 6hRJ68JkbJq6MYI9o5bUnQ ($104 in chips)
Seat 3: mddoKnqZkdOH7AJOJ/i0DA ($200 in chips)
Seat 4: 4dcDwIHRm96PwtqkpQiuiA ($87.70 in chips)
Seat 5: d1puGuVBE0fidn+5eRJ0tw ($190.35 in chips)
Seat 6: B2Ih1sr5VZk+8He7rcrMtQ ($402.45 in chips)
6hRJ68JkbJq6MYI9o5bUnQ: posts small blind $1
mddoKnqZkdOH7AJOJ/i0DA: posts big blind $2
*** HOLE CARDS ***
4dcDwIHRm96PwtqkpQiuiA: folds
d1puGuVBE0fidn+5eRJ0tw: folds
B2Ih1sr5VZk+8He7rcrMtQ: folds
VvdR9F3I+2yELkfTVvC1dg: raises $2 to $4
6hRJ68JkbJq6MYI9o5bUnQ: folds
mddoKnqZkdOH7AJOJ/i0DA: calls $2
*** FLOP *** [Ad 8s Qh]
mddoKnqZkdOH7AJOJ/i0DA: checks
VvdR9F3I+2yELkfTVvC1dg: bets $6.40
mddoKnqZkdOH7AJOJ/i0DA: folds
VvdR9F3I+2yELkfTVvC1dg collected $8.55 from pot
VvdR9F3I+2yELkfTVvC1dg: doesn't show hand
*** SUMMARY ***
Total pot $9 | Rake $0.45
Board [Ad 8s Qh]
Seat 1: VvdR9F3I+2yELkfTVvC1dg (button) collected ($8.55)
Seat 2: 6hRJ68JkbJq6MYI9o5bUnQ (small blind) folded before Flop
Seat 3: mddoKnqZkdOH7AJOJ/i0DA (big blind) folded on the Flop
Seat 4: 4dcDwIHRm96PwtqkpQiuiA folded before Flop (didn't bet)
Seat 5: d1puGuVBE0fidn+5eRJ0tw folded before Flop (didn't bet)
Seat 6: B2Ih1sr5VZk+8He7rcrMtQ folded before Flop (didn't bet)



PokerStars Game #59941954826:  Hold'em No Limit ($1/$2) - 2009/07/01 1:51:28 ET
Table 'aSf77Sj8QEnzcc0WaxVD4Q' 6-max Seat #3 is the button
Seat 1: UELtvp+JfwI7XDGVwSxZXA ($169.05 in chips)
Seat 2: vkfxu8f/jMYKUk6Ly4eujw ($186.10 in chips)
Seat 3: 9dpyyjDTCed6nV7JhaUUpw ($757.50 in chips)
Seat 4: YsLQ3BAvgQHWXMAv3Wv6Hg ($200 in chips)
Seat 5: VvdR9F3I+2yELkfTVvC1dg ($304.70 in chips)
Seat 6: vkoJRf3gidxY1pPi0AFWww ($172.25 in chips)
YsLQ3BAvgQHWXMAv3Wv6Hg: posts small blind $1
VvdR9F3I+2yELkfTVvC1dg: posts big blind $2
*** HOLE CARDS ***
vkoJRf3gidxY1pPi0AFWww: raises $4 to $6
UELtvp+JfwI7XDGVwSxZXA: folds
vkfxu8f/jMYKUk6Ly4eujw: folds
9dpyyjDTCed6nV7JhaUUpw: folds
YsLQ3BAvgQHWXMAv3Wv6Hg: folds
VvdR9F3I+2yELkfTVvC1dg: folds
vkoJRf3gidxY1pPi0AFWww collected $5 from pot
vkoJRf3gidxY1pPi0AFWww: doesn't show hand
*** SUMMARY ***
Total pot $5 | Rake $0
Seat 1: UELtvp+JfwI7XDGVwSxZXA folded before Flop (didn't bet)
Seat 2: vkfxu8f/jMYKUk6Ly4eujw folded before Flop (didn't bet)
Seat 3: 9dpyyjDTCed6nV7JhaUUpw (button) folded before Flop (didn't bet)
Seat 4: YsLQ3BAvgQHWXMAv3Wv6Hg (small blind) folded before Flop
Seat 5: VvdR9F3I+2yELkfTVvC1dg (big blind) folded before Flop
Seat 6: vkoJRf3gidxY1pPi0AFWww collected ($5)



PokerStars Game #59941954886:  Hold'em No Limit ($1/$2) - 2009/07/01 1:51:28 ET
Table 'kq5zaQ+1hLNf8LZfGnbTAA' 6-max Seat #3 is the button
Seat 1: 8srN1dKQePlsv0GyTada+Q ($416.60 in chips)
Seat 2: nXDI8Y/S6POzRwANu3d8hQ ($140 in chips)
Seat 3: /PH6Ffnho4Ysm8S3V/oa+w ($55.15 in chips)
Seat 4: 3dAbvkxS5NPQTBAbvpinVg ($273.65 in chips)
3dAbvkxS5NPQTBAbvpinVg: posts small blind $1
BWhgxe7gWiYobRbwdG+d2Q: is sitting out
mfy7uGZcqA2PVQqEVbJ7+g: is sitting out
8srN1dKQePlsv0GyTada+Q: posts big blind $2
*** HOLE CARDS ***
nXDI8Y/S6POzRwANu3d8hQ: folds
BWhgxe7gWiYobRbwdG+d2Q leaves the table
/PH6Ffnho4Ysm8S3V/oa+w: folds
3dAbvkxS5NPQTBAbvpinVg: folds
8srN1dKQePlsv0GyTada+Q collected $2 from pot
8srN1dKQePlsv0GyTada+Q: doesn't show hand
*** SUMMARY ***
Total pot $2 | Rake $0
Seat 1: 8srN1dKQePlsv0GyTada+Q (big blind) collected ($2)
Seat 2: nXDI8Y/S6POzRwANu3d8hQ folded before Flop (didn't bet)
Seat 3: /PH6Ffnho4Ysm8S3V/oa+w (button) folded before Flop (didn't bet)
Seat 4: 3dAbvkxS5NPQTBAbvpinVg (small blind) folded before Flop



PokerStars Game #59941955316:  Hold'em No Limit ($1/$2) - 2009/07/01 1:51:29 ET
Table 'C4lkCXY2PWy6z4vsAe5NGQ' 6-max Seat #4 is the button
Seat 2: 6hRJ68JkbJq6MYI9o5bUnQ ($58.95 in chips)
Seat 3: sTPOWERd9HWPCNrDBwsVjA ($135.50 in chips)
Seat 4: VvdR9F3I+2yELkfTVvC1dg ($204 in chips)
Seat 5: /PH6Ffnho4Ysm8S3V/oa+w ($54.15 in chips)
Seat 6: B87ikIyZ/TzAVeXf38Ny0g ($724.75 in chips)
/PH6Ffnho4Ysm8S3V/oa+w: posts small blind $1
B87ikIyZ/TzAVeXf38Ny0g: posts big blind $2
*** HOLE CARDS ***
6hRJ68JkbJq6MYI9o5bUnQ: calls $2
sTPOWERd9HWPCNrDBwsVjA: folds
bWbV4MVB/vVpiES1Ut4hew joins the table at seat #1
VvdR9F3I+2yELkfTVvC1dg: folds
/PH6Ffnho4Ysm8S3V/oa+w: folds
B87ikIyZ/TzAVeXf38Ny0g: checks
*** FLOP *** [9d 6c 7h]
B87ikIyZ/TzAVeXf38Ny0g: checks
6hRJ68JkbJq6MYI9o5bUnQ: checks
*** TURN *** [9d 6c 7h] [2s]
B87ikIyZ/TzAVeXf38Ny0g: checks
6hRJ68JkbJq6MYI9o5bUnQ: checks
*** RIVER *** [9d 6c 7h 2s] [9c]
B87ikIyZ/TzAVeXf38Ny0g: checks
6hRJ68JkbJq6MYI9o5bUnQ: checks
*** SHOW DOWN ***
B87ikIyZ/TzAVeXf38Ny0g: shows [5d 2c] (two pair, Nines and Deuces)
6hRJ68JkbJq6MYI9o5bUnQ: mucks hand
B87ikIyZ/TzAVeXf38Ny0g collected $4.75 from pot
*** SUMMARY ***
Total pot $5 | Rake $0.25
Board [9d 6c 7h 2s 9c]
Seat 2: 6hRJ68JkbJq6MYI9o5bUnQ mucked
Seat 3: sTPOWERd9HWPCNrDBwsVjA folded before Flop (didn't bet)
Seat 4: VvdR9F3I+2yELkfTVvC1dg (button) folded before Flop (didn't bet)
Seat 5: /PH6Ffnho4Ysm8S3V/oa+w (small blind) folded before Flop
Seat 6: B87ikIyZ/TzAVeXf38Ny0g (big blind) showed [5d 2c] and won ($4.75) with two pair, Nines and Deuces



PokerStars Game #59941956498:  Hold'em No Limit ($1/$2) - 2009/07/01 1:51:31 ET
Table 'WCA60bDA8ecovUgFSIZkTQ' 9-max Seat #1 is the button
Seat 1: 3RFwE6igZ1BGKOGuab6iiw ($52.70 in chips)
Seat 2: TAfo4veNRaRlzDXMMYS3Jg ($38 in chips)
Seat 3: g7gL2NLJCdZPPV399WKT1w ($50.65 in chips)
Seat 4: IYBKVnE2Basnr88BAhH+bQ ($205.80 in chips)
Seat 5: A+9gcmwAl0eFxxbAwRY1OA ($267.10 in chips)
Seat 7: tsTv4D+ne2W0qhUt9HlcMw ($193 in chips)
Seat 8: mJhwEVg7F695DiO+RIhM5g ($254.45 in chips)
Seat 9: ItDFe9gh5QYPQB9vC4ntUA ($200 in chips)
TAfo4veNRaRlzDXMMYS3Jg: posts small blind $1
g7gL2NLJCdZPPV399WKT1w: posts big blind $2
YoKKKdDDs7gFzP1Z65Sdaw: sits out
*** HOLE CARDS ***
IYBKVnE2Basnr88BAhH+bQ: folds
A+9gcmwAl0eFxxbAwRY1OA: folds
tsTv4D+ne2W0qhUt9HlcMw: folds
mJhwEVg7F695DiO+RIhM5g: raises $4 to $6
ItDFe9gh5QYPQB9vC4ntUA: folds
3RFwE6igZ1BGKOGuab6iiw: folds
TAfo4veNRaRlzDXMMYS3Jg: folds
g7gL2NLJCdZPPV399WKT1w: folds
mJhwEVg7F695DiO+RIhM5g collected $5 from pot
*** SUMMARY ***
Total pot $5 | Rake $0
Seat 1: 3RFwE6igZ1BGKOGuab6iiw (button) folded before Flop (didn't bet)
Seat 2: TAfo4veNRaRlzDXMMYS3Jg (small blind) folded before Flop
Seat 3: g7gL2NLJCdZPPV399WKT1w (big blind) folded before Flop
Seat 4: IYBKVnE2Basnr88BAhH+bQ folded before Flop (didn't bet)
Seat 5: A+9gcmwAl0eFxxbAwRY1OA folded before Flop (didn't bet)
Seat 7: tsTv4D+ne2W0qhUt9HlcMw folded before Flop (didn't bet)
Seat 8: mJhwEVg7F695DiO+RIhM5g collected ($5)
Seat 9: ItDFe9gh5QYPQB9vC4ntUA folded before Flop (didn't bet)



PokerStars Game #59941957532:  Hold'em No Limit ($1/$2) - 2009/07/01 1:51:33 ET
Table '3WCXyaiCAbqSShQu7FIjvA' 9-max Seat #5 is the button
Seat 1: kTCkABD1UUldS9DFRGfCwQ ($137.75 in chips)
Seat 3: 5Q8U6iZbeO7xJSS4qvDP5g ($267.25 in chips)
Seat 4: waEF/+pxZTxNo4FvsORuXg ($101.40 in chips)
Seat 5: CkE3IyJF1KvdaAOmZY5XqQ ($207.90 in chips)
Seat 6: 5jQlngvMSqM/WoonOcR5kw ($273 in chips)
Seat 7: nXDI8Y/S6POzRwANu3d8hQ ($44.10 in chips)
Seat 8: +T/63sAeZzWyHchahJ36GQ ($37 in chips)
Seat 9: FiXPLJyqb24l32QST2TInw ($117.50 in chips)
5jQlngvMSqM/WoonOcR5kw: posts small blind $1
nXDI8Y/S6POzRwANu3d8hQ: posts big blind $2
254YPxPJr5Sw58bkD0YqYQ: sits out
*** HOLE CARDS ***
+T/63sAeZzWyHchahJ36GQ: folds
FiXPLJyqb24l32QST2TInw: calls $2
kTCkABD1UUldS9DFRGfCwQ: folds
5Q8U6iZbeO7xJSS4qvDP5g: folds
waEF/+pxZTxNo4FvsORuXg: folds
CkE3IyJF1KvdaAOmZY5XqQ: folds
5jQlngvMSqM/WoonOcR5kw: calls $1
nXDI8Y/S6POzRwANu3d8hQ: checks
*** FLOP *** [Ad 4h 8s]
5jQlngvMSqM/WoonOcR5kw: checks
nXDI8Y/S6POzRwANu3d8hQ: checks
FiXPLJyqb24l32QST2TInw: checks
*** TURN *** [Ad 4h 8s] [7d]
5jQlngvMSqM/WoonOcR5kw: checks
nXDI8Y/S6POzRwANu3d8hQ: checks
FiXPLJyqb24l32QST2TInw: bets $4
5jQlngvMSqM/WoonOcR5kw: folds
nXDI8Y/S6POzRwANu3d8hQ: folds
FiXPLJyqb24l32QST2TInw collected $5.70 from pot
FiXPLJyqb24l32QST2TInw: doesn't show hand
*** SUMMARY ***
Total pot $6 | Rake $0.30
Board [Ad 4h 8s 7d]
Seat 1: kTCkABD1UUldS9DFRGfCwQ folded before Flop (didn't bet)
Seat 3: 5Q8U6iZbeO7xJSS4qvDP5g folded before Flop (didn't bet)
Seat 4: waEF/+pxZTxNo4FvsORuXg folded before Flop (didn't bet)
Seat 5: CkE3IyJF1KvdaAOmZY5XqQ (button) folded before Flop (didn't bet)
Seat 6: 5jQlngvMSqM/WoonOcR5kw (small blind) folded on the Turn
Seat 7: nXDI8Y/S6POzRwANu3d8hQ (big blind) folded on the Turn
Seat 8: +T/63sAeZzWyHchahJ36GQ folded before Flop (didn't bet)
Seat 9: FiXPLJyqb24l32QST2TInw collected ($5.70)



PokerStars Game #59941958748:  Hold'em No Limit ($1/$2) - 2009/07/01 1:51:35 ET
Table '/dyk+YdRGv90j2box35j8w' 6-max Seat #3 is the button
Seat 1: 8srN1dKQePlsv0GyTada+Q ($200 in chips)
Seat 2: qCnEYuAE5y5A7bk6fO5/jQ ($499.20 in chips)
Seat 3: sTPOWERd9HWPCNrDBwsVjA ($206.50 in chips)
Seat 4: 4dMBh/1VTdeUTPCyhCs3UQ ($91 in chips)
Seat 5: VvdR9F3I+2yELkfTVvC1dg ($294.80 in chips)
4dMBh/1VTdeUTPCyhCs3UQ: posts small blind $1
VvdR9F3I+2yELkfTVvC1dg: posts big blind $2
C3qJBo7uxfFVDluE1lmK2w: sits out
*** HOLE CARDS ***
8srN1dKQePlsv0GyTada+Q: folds
qCnEYuAE5y5A7bk6fO5/jQ: folds
sTPOWERd9HWPCNrDBwsVjA: raises $4 to $6
4dMBh/1VTdeUTPCyhCs3UQ: folds
VvdR9F3I+2yELkfTVvC1dg: folds
sTPOWERd9HWPCNrDBwsVjA collected $5 from pot
*** SUMMARY ***
Total pot $5 | Rake $0
Seat 1: 8srN1dKQePlsv0GyTada+Q folded before Flop (didn't bet)
Seat 2: qCnEYuAE5y5A7bk6fO5/jQ folded before Flop (didn't bet)
Seat 3: sTPOWERd9HWPCNrDBwsVjA (button) collected ($5)
Seat 4: 4dMBh/1VTdeUTPCyhCs3UQ (small blind) folded before Flop
Seat 5: VvdR9F3I+2yELkfTVvC1dg (big blind) folded before Flop



PokerStars Game #59941959284:  Hold'em No Limit ($1/$2) - 2009/07/01 1:51:36 ET
Table 'CFkQcfWjKccZaZDf71FK+w' 6-max Seat #5 is the button
Seat 1: vkfxu8f/jMYKUk6Ly4eujw ($224.25 in chips)
Seat 2: ewN/vzF22+/gdzjIKBOlkA ($218.90 in chips)
Seat 5: 2lOU1DcvUZaMcxZ95XfzXw ($130.85 in chips)
Seat 6: ORVqY3rf9X6ANA/8s+On2Q ($32.35 in chips)
ORVqY3rf9X6ANA/8s+On2Q: posts small blind $1
vkfxu8f/jMYKUk6Ly4eujw: posts big blind $2
opJMdoq0E6TRbAQiweyQuA: sits out
*** HOLE CARDS ***
ewN/vzF22+/gdzjIKBOlkA: folds
2lOU1DcvUZaMcxZ95XfzXw: folds
ORVqY3rf9X6ANA/8s+On2Q: calls $1
vkfxu8f/jMYKUk6Ly4eujw: checks
*** FLOP *** [3h Ad 7h]
ORVqY3rf9X6ANA/8s+On2Q: checks
vkfxu8f/jMYKUk6Ly4eujw: checks
*** TURN *** [3h Ad 7h] [Jh]
ORVqY3rf9X6ANA/8s+On2Q: checks
vkfxu8f/jMYKUk6Ly4eujw: checks
*** RIVER *** [3h Ad 7h Jh] [6c]
ORVqY3rf9X6ANA/8s+On2Q: checks
vkfxu8f/jMYKUk6Ly4eujw: checks
*** SHOW DOWN ***
ORVqY3rf9X6ANA/8s+On2Q: shows [Kd 4c] (high card Ace)
vkfxu8f/jMYKUk6Ly4eujw: shows [3c 4s] (a pair of Threes)
vkfxu8f/jMYKUk6Ly4eujw collected $3.80 from pot
*** SUMMARY ***
Total pot $4 | Rake $0.20
Board [3h Ad 7h Jh 6c]
Seat 1: vkfxu8f/jMYKUk6Ly4eujw (big blind) showed [3c 4s] and won ($3.80) with a pair of Threes
Seat 2: ewN/vzF22+/gdzjIKBOlkA folded before Flop (didn't bet)
Seat 5: 2lOU1DcvUZaMcxZ95XfzXw (button) folded before Flop (didn't bet)
Seat 6: ORVqY3rf9X6ANA/8s+On2Q (small blind) showed [Kd 4c] and lost with high card Ace



PokerStars Game #59941959060:  Hold'em No Limit ($1/$2) - 2009/07/01 1:51:36 ET
Table 'W9UeSV0aoPjh5SFSxM8jUQ' 9-max Seat #1 is the button
Seat 1: mIKx5lhIt13X5eZQH0ZeMA ($6.85 in chips)
Seat 2: KqHysDSpCPaPyK3tJC1aEw ($215.05 in chips)
Seat 3: ItDFe9gh5QYPQB9vC4ntUA ($200 in chips)
Seat 4: 4YA/sQy1Emm680zhbPUjow ($149.60 in chips)
Seat 5: ri8CLkX3e9JF34dQNbsHGA ($82 in chips)
Seat 6: 254YPxPJr5Sw58bkD0YqYQ ($200 in chips)
Seat 7: TAfo4veNRaRlzDXMMYS3Jg ($39 in chips)
Seat 8: odhvI/CZeMsPyo1n1U7+hA ($49.10 in chips)
Seat 9: Q104K4iDGcqOlVrjAkzPEA ($104.55 in chips)
KqHysDSpCPaPyK3tJC1aEw: posts small blind $1
ItDFe9gh5QYPQB9vC4ntUA: posts big blind $2
*** HOLE CARDS ***
4YA/sQy1Emm680zhbPUjow: folds
ri8CLkX3e9JF34dQNbsHGA: folds
254YPxPJr5Sw58bkD0YqYQ: raises $6 to $8
TAfo4veNRaRlzDXMMYS3Jg: folds
odhvI/CZeMsPyo1n1U7+hA: folds
Q104K4iDGcqOlVrjAkzPEA: calls $8
mIKx5lhIt13X5eZQH0ZeMA: folds
KqHysDSpCPaPyK3tJC1aEw: calls $7
ItDFe9gh5QYPQB9vC4ntUA: folds
*** FLOP *** [Kc Jc 7h]
KqHysDSpCPaPyK3tJC1aEw: checks
254YPxPJr5Sw58bkD0YqYQ: checks
Q104K4iDGcqOlVrjAkzPEA: checks
*** TURN *** [Kc Jc 7h] [Kh]
KqHysDSpCPaPyK3tJC1aEw: checks
254YPxPJr5Sw58bkD0YqYQ: checks
Q104K4iDGcqOlVrjAkzPEA: checks
*** RIVER *** [Kc Jc 7h Kh] [9h]
KqHysDSpCPaPyK3tJC1aEw: checks
254YPxPJr5Sw58bkD0YqYQ: checks
Q104K4iDGcqOlVrjAkzPEA: checks
*** SHOW DOWN ***
KqHysDSpCPaPyK3tJC1aEw: shows [5d 5c] (two pair, Kings and Fives)
254YPxPJr5Sw58bkD0YqYQ: shows [Ts Js] (two pair, Kings and Jacks)
Q104K4iDGcqOlVrjAkzPEA: mucks hand
254YPxPJr5Sw58bkD0YqYQ collected $24.70 from pot
*** SUMMARY ***
Total pot $26 | Rake $1.30
Board [Kc Jc 7h Kh 9h]
Seat 1: mIKx5lhIt13X5eZQH0ZeMA (button) folded before Flop (didn't bet)
Seat 2: KqHysDSpCPaPyK3tJC1aEw (small blind) showed [5d 5c] and lost with two pair, Kings and Fives
Seat 3: ItDFe9gh5QYPQB9vC4ntUA (big blind) folded before Flop
Seat 4: 4YA/sQy1Emm680zhbPUjow folded before Flop (didn't bet)
Seat 5: ri8CLkX3e9JF34dQNbsHGA folded before Flop (didn't bet)
Seat 6: 254YPxPJr5Sw58bkD0YqYQ showed [Ts Js] and won ($24.70) with two pair, Kings and Jacks
Seat 7: TAfo4veNRaRlzDXMMYS3Jg folded before Flop (didn't bet)
Seat 8: odhvI/CZeMsPyo1n1U7+hA folded before Flop (didn't bet)
Seat 9: Q104K4iDGcqOlVrjAkzPEA mucked



PokerStars Game #59941959108:  Hold'em No Limit ($1/$2) - 2009/07/01 1:51:36 ET
Table 'eyAQSIlgc2o1Jxvbve4WGg' 9-max Seat #5 is the button
Seat 1: UZEsV9yKUMqmpYPiOFpaZw ($73 in chips)
Seat 2: kM9CA+2UcdMjbCMbtUCGiA ($208.60 in chips)
Seat 4: CkE3IyJF1KvdaAOmZY5XqQ ($200 in chips)
Seat 5: mIKx5lhIt13X5eZQH0ZeMA ($161.75 in chips)
Seat 6: nXDI8Y/S6POzRwANu3d8hQ ($65 in chips)
Seat 7: u3OrI5uGx9mx1fE7dgr+EA ($85.75 in chips)
Seat 9: WUlHm+ydPPHG7Lb0rePSdA ($140.20 in chips)
nXDI8Y/S6POzRwANu3d8hQ: posts small blind $1
u3OrI5uGx9mx1fE7dgr+EA: posts big blind $2
254YPxPJr5Sw58bkD0YqYQ: sits out
*** HOLE CARDS ***
WUlHm+ydPPHG7Lb0rePSdA: folds
UZEsV9yKUMqmpYPiOFpaZw: folds
kM9CA+2UcdMjbCMbtUCGiA: folds
CkE3IyJF1KvdaAOmZY5XqQ: folds
mIKx5lhIt13X5eZQH0ZeMA: folds
nXDI8Y/S6POzRwANu3d8hQ: folds
u3OrI5uGx9mx1fE7dgr+EA collected $2 from pot
u3OrI5uGx9mx1fE7dgr+EA: doesn't show hand
*** SUMMARY ***
Total pot $2 | Rake $0
Seat 1: UZEsV9yKUMqmpYPiOFpaZw folded before Flop (didn't bet)
Seat 2: kM9CA+2UcdMjbCMbtUCGiA folded before Flop (didn't bet)
Seat 4: CkE3IyJF1KvdaAOmZY5XqQ folded before Flop (didn't bet)
Seat 5: mIKx5lhIt13X5eZQH0ZeMA (button) folded before Flop (didn't bet)
Seat 6: nXDI8Y/S6POzRwANu3d8hQ (small blind) folded before Flop
Seat 7: u3OrI5uGx9mx1fE7dgr+EA (big blind) collected ($2)
Seat 9: WUlHm+ydPPHG7Lb0rePSdA folded before Flop (didn't bet)



PokerStars Game #59941960234:  Hold'em No Limit ($1/$2) - 2009/07/01 1:51:38 ET
Table 'NmY84NAf9Mh0ckAckHnh5g' 2-max Seat #2 is the button
Seat 1: 6hvg964TSqZ3AL/0XK9aVQ ($548.15 in chips)
Seat 2: RwDoM55ZeQuI2ADyJhOb2Q ($434.05 in chips)
RwDoM55ZeQuI2ADyJhOb2Q: posts small blind $1
6hvg964TSqZ3AL/0XK9aVQ: posts big blind $2
*** HOLE CARDS ***
RwDoM55ZeQuI2ADyJhOb2Q: raises $4 to $6
6hvg964TSqZ3AL/0XK9aVQ: raises $6 to $12
RwDoM55ZeQuI2ADyJhOb2Q: calls $6
*** FLOP *** [Js 9c 6c]
6hvg964TSqZ3AL/0XK9aVQ: checks
RwDoM55ZeQuI2ADyJhOb2Q: checks
*** TURN *** [Js 9c 6c] [6d]
6hvg964TSqZ3AL/0XK9aVQ: checks
RwDoM55ZeQuI2ADyJhOb2Q: checks
*** RIVER *** [Js 9c 6c 6d] [5h]
6hvg964TSqZ3AL/0XK9aVQ: bets $12
RwDoM55ZeQuI2ADyJhOb2Q: calls $12
*** SHOW DOWN ***
6hvg964TSqZ3AL/0XK9aVQ: shows [Qd As] (a pair of Sixes)
RwDoM55ZeQuI2ADyJhOb2Q: shows [9d Ks] (two pair, Nines and Sixes)
RwDoM55ZeQuI2ADyJhOb2Q collected $47.50 from pot
*** SUMMARY ***
Total pot $48 | Rake $0.50
Board [Js 9c 6c 6d 5h]
Seat 1: 6hvg964TSqZ3AL/0XK9aVQ (big blind) showed [Qd As] and lost with a pair of Sixes
Seat 2: RwDoM55ZeQuI2ADyJhOb2Q (button) (small blind) showed [9d Ks] and won ($47.50) with two pair, Nines and Sixes



PokerStars Game #59941959928:  Hold'em No Limit ($1/$2) - 2009/07/01 1:51:38 ET
Table '+hSnXFQrGw1PlVgTnuj+sA' 6-max Seat #6 is the button
Seat 1: fb8ooqw9ZsZtBsZTZQLNrQ ($52.70 in chips)
Seat 2: 54yWzRRgS0oZ+S6LwZBxMQ ($25.10 in chips)
Seat 3: cupOBdycmBLQKdVftyAksg ($49.10 in chips)
Seat 4: TRSUrOQh3x1NGeD+dH4yoA ($94.10 in chips)
Seat 5: PZzUwZiFNhCLi6Ouh5ZlmQ ($200 in chips)
Seat 6: 7zM38baFvmCNB/F80oE0cQ ($48.35 in chips)
fb8ooqw9ZsZtBsZTZQLNrQ: posts small blind $1
54yWzRRgS0oZ+S6LwZBxMQ: posts big blind $2
*** HOLE CARDS ***
cupOBdycmBLQKdVftyAksg: folds
TRSUrOQh3x1NGeD+dH4yoA: folds
PZzUwZiFNhCLi6Ouh5ZlmQ: folds
7zM38baFvmCNB/F80oE0cQ: calls $2
fb8ooqw9ZsZtBsZTZQLNrQ: calls $1
54yWzRRgS0oZ+S6LwZBxMQ: checks
*** FLOP *** [Js 6d 7h]
fb8ooqw9ZsZtBsZTZQLNrQ: checks
54yWzRRgS0oZ+S6LwZBxMQ: bets $4
7zM38baFvmCNB/F80oE0cQ: calls $4
fb8ooqw9ZsZtBsZTZQLNrQ: folds
*** TURN *** [Js 6d 7h] [Th]
54yWzRRgS0oZ+S6LwZBxMQ: bets $4
7zM38baFvmCNB/F80oE0cQ: raises $4 to $8
54yWzRRgS0oZ+S6LwZBxMQ: folds
7zM38baFvmCNB/F80oE0cQ collected $20.95 from pot
7zM38baFvmCNB/F80oE0cQ: doesn't show hand
*** SUMMARY ***
Total pot $22 | Rake $1.05
Board [Js 6d 7h Th]
Seat 1: fb8ooqw9ZsZtBsZTZQLNrQ (small blind) folded on the Flop
Seat 2: 54yWzRRgS0oZ+S6LwZBxMQ (big blind) folded on the Turn
Seat 3: cupOBdycmBLQKdVftyAksg folded before Flop (didn't bet)
Seat 4: TRSUrOQh3x1NGeD+dH4yoA folded before Flop (didn't bet)
Seat 5: PZzUwZiFNhCLi6Ouh5ZlmQ folded before Flop (didn't bet)
Seat 6: 7zM38baFvmCNB/F80oE0cQ (button) collected ($20.95)



PokerStars Game #59941960558:  Hold'em No Limit ($1/$2) - 2009/07/01 1:51:39 ET
Table 'kq5zaQ+1hLNf8LZfGnbTAA' 6-max Seat #4 is the button
Seat 1: 8srN1dKQePlsv0GyTada+Q ($417.60 in chips)
Seat 2: nXDI8Y/S6POzRwANu3d8hQ ($140 in chips)
Seat 3: /PH6Ffnho4Ysm8S3V/oa+w ($55.15 in chips)
Seat 4: 3dAbvkxS5NPQTBAbvpinVg ($272.65 in chips)
8srN1dKQePlsv0GyTada+Q: posts small blind $1
nXDI8Y/S6POzRwANu3d8hQ: posts big blind $2
*** HOLE CARDS ***
/PH6Ffnho4Ysm8S3V/oa+w: folds
3dAbvkxS5NPQTBAbvpinVg: raises $4 to $6
8srN1dKQePlsv0GyTada+Q: folds
nXDI8Y/S6POzRwANu3d8hQ: folds
3dAbvkxS5NPQTBAbvpinVg collected $5 from pot
mfy7uGZcqA2PVQqEVbJ7+g leaves the table
3dAbvkxS5NPQTBAbvpinVg: doesn't show hand
*** SUMMARY ***
Total pot $5 | Rake $0
Seat 1: 8srN1dKQePlsv0GyTada+Q (small blind) folded before Flop
Seat 2: nXDI8Y/S6POzRwANu3d8hQ (big blind) folded before Flop
Seat 3: /PH6Ffnho4Ysm8S3V/oa+w folded before Flop (didn't bet)
Seat 4: 3dAbvkxS5NPQTBAbvpinVg (button) collected ($5)



PokerStars Game #59941961758:  Hold'em No Limit ($1/$2) - 2009/07/01 1:51:41 ET
Table 'UGLAZZyv+cXmnKjYin0etA' 6-max Seat #2 is the button
Seat 2: eDLH1PUXFpvJBNMXBVQcGA ($294.10 in chips)
Seat 4: SiGJDsvRViJX05vHhA80GQ ($254.75 in chips)
Seat 5: 54yWzRRgS0oZ+S6LwZBxMQ ($37.80 in chips)
Seat 6: sTPOWERd9HWPCNrDBwsVjA ($207.95 in chips)
SiGJDsvRViJX05vHhA80GQ: posts small blind $1
Nsjun4mjI8q0SSBTIp1dIQ joins the table at seat #3
54yWzRRgS0oZ+S6LwZBxMQ: posts big blind $2
rL+Zpv4/vX2BVHcyfh/NXA: sits out
*** HOLE CARDS ***
sTPOWERd9HWPCNrDBwsVjA: folds
eDLH1PUXFpvJBNMXBVQcGA: raises $4 to $6
SiGJDsvRViJX05vHhA80GQ: folds
54yWzRRgS0oZ+S6LwZBxMQ: folds
eDLH1PUXFpvJBNMXBVQcGA collected $5 from pot
*** SUMMARY ***
Total pot $5 | Rake $0
Seat 2: eDLH1PUXFpvJBNMXBVQcGA (button) collected ($5)
Seat 4: SiGJDsvRViJX05vHhA80GQ (small blind) folded before Flop
Seat 5: 54yWzRRgS0oZ+S6LwZBxMQ (big blind) folded before Flop
Seat 6: sTPOWERd9HWPCNrDBwsVjA folded before Flop (didn't bet)



PokerStars Game #59941961660:  Hold'em No Limit ($1/$2) - 2009/07/01 1:51:41 ET
Table '5/wEe6JmtGD7vufSA2RG7A' 2-max Seat #2 is the button
Seat 1: pVqEzK9wXlRMECnb1Zg4Zw ($19.50 in chips)
Seat 2: aOL8geThaYp2iadSHl1h1g ($403.50 in chips)
aOL8geThaYp2iadSHl1h1g: posts small blind $1
pVqEzK9wXlRMECnb1Zg4Zw: posts big blind $2
*** HOLE CARDS ***
aOL8geThaYp2iadSHl1h1g: raises $4 to $6
pVqEzK9wXlRMECnb1Zg4Zw: calls $4
*** FLOP *** [7d 2d Js]
pVqEzK9wXlRMECnb1Zg4Zw: checks
aOL8geThaYp2iadSHl1h1g: bets $6
pVqEzK9wXlRMECnb1Zg4Zw: raises $6 to $12
aOL8geThaYp2iadSHl1h1g: raises $6 to $18
pVqEzK9wXlRMECnb1Zg4Zw: calls $1.50 and is all-in
*** TURN *** [7d 2d Js] [6h]
*** RIVER *** [7d 2d Js 6h] [8s]
*** SHOW DOWN ***
pVqEzK9wXlRMECnb1Zg4Zw: shows [2s Kc] (a pair of Deuces)
aOL8geThaYp2iadSHl1h1g: mucks hand
pVqEzK9wXlRMECnb1Zg4Zw collected $38.50 from pot
*** SUMMARY ***
Total pot $39 | Rake $0.50
Board [7d 2d Js 6h 8s]
Seat 1: pVqEzK9wXlRMECnb1Zg4Zw (big blind) showed [2s Kc] and won ($38.50) with a pair of Deuces
Seat 2: aOL8geThaYp2iadSHl1h1g (button) (small blind) mucked



PokerStars Game #59941962674:  Hold'em No Limit ($1/$2) - 2009/07/01 1:51:43 ET
Table 'ztv6V3FN2bQ9nmJPPdx6nQ' 6-max Seat #2 is the button
Seat 1: 6fLdOUCRtX71xbVRhJEq8w ($297.35 in chips)
Seat 2: 5Y+ZGWLI4gnlpApDX5vy1A ($371.05 in chips)
Seat 4: UaZ5yj+6LjtWqMQg2QskUw ($73.55 in chips)
Seat 5: sTPOWERd9HWPCNrDBwsVjA ($216.60 in chips)
Seat 6: mfy7uGZcqA2PVQqEVbJ7+g ($86.20 in chips)
UaZ5yj+6LjtWqMQg2QskUw: posts small blind $1
sTPOWERd9HWPCNrDBwsVjA: posts big blind $2
*** HOLE CARDS ***
mfy7uGZcqA2PVQqEVbJ7+g: folds
6fLdOUCRtX71xbVRhJEq8w: folds
5Y+ZGWLI4gnlpApDX5vy1A: raises $2 to $4
UaZ5yj+6LjtWqMQg2QskUw: folds
sTPOWERd9HWPCNrDBwsVjA: folds
5Y+ZGWLI4gnlpApDX5vy1A collected $5 from pot
5Y+ZGWLI4gnlpApDX5vy1A: doesn't show hand
*** SUMMARY ***
Total pot $5 | Rake $0
Seat 1: 6fLdOUCRtX71xbVRhJEq8w folded before Flop (didn't bet)
Seat 2: 5Y+ZGWLI4gnlpApDX5vy1A (button) collected ($5)
Seat 4: UaZ5yj+6LjtWqMQg2QskUw (small blind) folded before Flop
Seat 5: sTPOWERd9HWPCNrDBwsVjA (big blind) folded before Flop
Seat 6: mfy7uGZcqA2PVQqEVbJ7+g folded before Flop (didn't bet)



PokerStars Game #59941963412:  Hold'em No Limit ($1/$2) - 2009/07/01 1:51:44 ET
Table 'TsEDkiO4tzCTCzJ7tNdEqw' 6-max Seat #2 is the button
Seat 2: 4dcDwIHRm96PwtqkpQiuiA ($76.40 in chips)
Seat 3: ubtx4Z5L+AcK71MTvYiGVw ($209.20 in chips)
Seat 4: K8MXCrNAVYlMnnCeM32Kxw ($127.35 in chips)
Seat 5: VvdR9F3I+2yELkfTVvC1dg ($243.35 in chips)
Seat 6: uCqEjnxh2/vFBjKYkfTOkw ($284.80 in chips)
ubtx4Z5L+AcK71MTvYiGVw: posts small blind $1
K8MXCrNAVYlMnnCeM32Kxw: posts big blind $2
Nsjun4mjI8q0SSBTIp1dIQ: sits out
*** HOLE CARDS ***
VvdR9F3I+2yELkfTVvC1dg: folds
uCqEjnxh2/vFBjKYkfTOkw: folds
4dcDwIHRm96PwtqkpQiuiA: raises $4 to $6
ubtx4Z5L+AcK71MTvYiGVw: calls $5
K8MXCrNAVYlMnnCeM32Kxw: folds
*** FLOP *** [Ts 8s Qs]
ubtx4Z5L+AcK71MTvYiGVw: checks
Nsjun4mjI8q0SSBTIp1dIQ is sitting out
4dcDwIHRm96PwtqkpQiuiA: bets $6
ubtx4Z5L+AcK71MTvYiGVw: folds
4dcDwIHRm96PwtqkpQiuiA collected $13.30 from pot
*** SUMMARY ***
Total pot $14 | Rake $0.70
Board [Ts 8s Qs]
Seat 2: 4dcDwIHRm96PwtqkpQiuiA (button) collected ($13.30)
Seat 3: ubtx4Z5L+AcK71MTvYiGVw (small blind) folded on the Flop
Seat 4: K8MXCrNAVYlMnnCeM32Kxw (big blind) folded before Flop
Seat 5: VvdR9F3I+2yELkfTVvC1dg folded before Flop (didn't bet)
Seat 6: uCqEjnxh2/vFBjKYkfTOkw folded before Flop (didn't bet)



PokerStars Game #59941963988:  Hold'em No Limit ($1/$2) - 2009/07/01 1:51:45 ET
Table 'o63a8j70meKHUtgLFryQvg' 9-max Seat #4 is the button
Seat 1: +1R0op5O3Gf6aUPJTw7jjA ($197 in chips)
Seat 2: SgA0Zfa/3yhNp7ILXcXcCg ($68.15 in chips)
Seat 3: IYBKVnE2Basnr88BAhH+bQ ($265.40 in chips)
Seat 4: ZYHoLw2lWmRS7CSHi8L8Xg ($206.90 in chips)
Seat 5: g3ZVTc1EbSNXYYMO82jL7Q ($198 in chips)
Seat 6: CUZwDpLTQKhzarPe+JCLOQ ($200 in chips)
Seat 8: ItDFe9gh5QYPQB9vC4ntUA ($368.05 in chips)
g3ZVTc1EbSNXYYMO82jL7Q: posts small blind $1
CUZwDpLTQKhzarPe+JCLOQ: posts big blind $2
kM9CA+2UcdMjbCMbtUCGiA: sits out
TAfo4veNRaRlzDXMMYS3Jg: sits out
*** HOLE CARDS ***
ItDFe9gh5QYPQB9vC4ntUA: raises $6 to $8
+1R0op5O3Gf6aUPJTw7jjA: folds
SgA0Zfa/3yhNp7ILXcXcCg: folds
IYBKVnE2Basnr88BAhH+bQ: folds
ZYHoLw2lWmRS7CSHi8L8Xg: folds
g3ZVTc1EbSNXYYMO82jL7Q: raises $18 to $26
CUZwDpLTQKhzarPe+JCLOQ: folds
ItDFe9gh5QYPQB9vC4ntUA: calls $18
*** FLOP *** [8h 2c 4s]
g3ZVTc1EbSNXYYMO82jL7Q: bets $40
ItDFe9gh5QYPQB9vC4ntUA: folds
g3ZVTc1EbSNXYYMO82jL7Q collected $51.30 from pot
*** SUMMARY ***
Total pot $54 | Rake $2.70
Board [8h 2c 4s]
Seat 1: +1R0op5O3Gf6aUPJTw7jjA folded before Flop (didn't bet)
Seat 2: SgA0Zfa/3yhNp7ILXcXcCg folded before Flop (didn't bet)
Seat 3: IYBKVnE2Basnr88BAhH+bQ folded before Flop (didn't bet)
Seat 4: ZYHoLw2lWmRS7CSHi8L8Xg (button) folded before Flop (didn't bet)
Seat 5: g3ZVTc1EbSNXYYMO82jL7Q (small blind) collected ($51.30)
Seat 6: CUZwDpLTQKhzarPe+JCLOQ (big blind) folded before Flop
Seat 8: ItDFe9gh5QYPQB9vC4ntUA folded on the Flop



PokerStars Game #59941964506:  Hold'em No Limit ($1/$2) - 2009/07/01 1:51:46 ET
Table 'rsKRKlGHlxVyqJxzO2a2Ow' 9-max Seat #7 is the button
Seat 1: KqHysDSpCPaPyK3tJC1aEw ($212.30 in chips)
Seat 2: +T/63sAeZzWyHchahJ36GQ ($86 in chips)
Seat 3: kM9CA+2UcdMjbCMbtUCGiA ($228.10 in chips)
Seat 4: 31HuO+DQxppUQEedBWukug ($108.85 in chips)
Seat 5: 5Q8U6iZbeO7xJSS4qvDP5g ($245.30 in chips)
Seat 6: H6Z4+qu8gR0VUiPOijndVg ($200 in chips)
Seat 7: GX1heJ+DSsvm7gzSPsYhhQ ($53 in chips)
Seat 8: CkE3IyJF1KvdaAOmZY5XqQ ($207.70 in chips)
Seat 9: gRbvhSUVg+TNaTjaJecIRw ($50.60 in chips)
CkE3IyJF1KvdaAOmZY5XqQ: posts small blind $1
gRbvhSUVg+TNaTjaJecIRw: posts big blind $2
*** HOLE CARDS ***
KqHysDSpCPaPyK3tJC1aEw: folds
+T/63sAeZzWyHchahJ36GQ: folds
kM9CA+2UcdMjbCMbtUCGiA: folds
31HuO+DQxppUQEedBWukug: folds
5Q8U6iZbeO7xJSS4qvDP5g: folds
H6Z4+qu8gR0VUiPOijndVg: raises $4 to $6
GX1heJ+DSsvm7gzSPsYhhQ: folds
CkE3IyJF1KvdaAOmZY5XqQ: folds
gRbvhSUVg+TNaTjaJecIRw: folds
H6Z4+qu8gR0VUiPOijndVg collected $5 from pot
H6Z4+qu8gR0VUiPOijndVg: doesn't show hand
*** SUMMARY ***
Total pot $5 | Rake $0
Seat 1: KqHysDSpCPaPyK3tJC1aEw folded before Flop (didn't bet)
Seat 2: +T/63sAeZzWyHchahJ36GQ folded before Flop (didn't bet)
Seat 3: kM9CA+2UcdMjbCMbtUCGiA folded before Flop (didn't bet)
Seat 4: 31HuO+DQxppUQEedBWukug folded before Flop (didn't bet)
Seat 5: 5Q8U6iZbeO7xJSS4qvDP5g folded before Flop (didn't bet)
Seat 6: H6Z4+qu8gR0VUiPOijndVg collected ($5)
Seat 7: GX1heJ+DSsvm7gzSPsYhhQ (button) folded before Flop (didn't bet)
Seat 8: CkE3IyJF1KvdaAOmZY5XqQ (small blind) folded before Flop
Seat 9: gRbvhSUVg+TNaTjaJecIRw (big blind) folded before Flop



PokerStars Game #59941966470:  Hold'em No Limit ($1/$2) - 2009/07/01 1:51:50 ET
Table '4NGNnZ/osQfNq6abYqkJeA' 6-max Seat #6 is the button
Seat 2: 669iGNwYwgRZg3nhS+aDAQ ($108 in chips)
Seat 3: 54yWzRRgS0oZ+S6LwZBxMQ ($74.65 in chips)
Seat 4: sY+4Uuh5z/6AbXXaCS10jw ($306.10 in chips)
Seat 5: VvdR9F3I+2yELkfTVvC1dg ($211.80 in chips)
Seat 6: /PH6Ffnho4Ysm8S3V/oa+w ($40 in chips)
669iGNwYwgRZg3nhS+aDAQ: posts small blind $1
54yWzRRgS0oZ+S6LwZBxMQ: posts big blind $2
*** HOLE CARDS ***
sY+4Uuh5z/6AbXXaCS10jw: folds
VvdR9F3I+2yELkfTVvC1dg: folds
/PH6Ffnho4Ysm8S3V/oa+w: folds
669iGNwYwgRZg3nhS+aDAQ: calls $1
54yWzRRgS0oZ+S6LwZBxMQ: checks
*** FLOP *** [5c 5d 5h]
669iGNwYwgRZg3nhS+aDAQ: checks
54yWzRRgS0oZ+S6LwZBxMQ: bets $4
669iGNwYwgRZg3nhS+aDAQ: calls $4
*** TURN *** [5c 5d 5h] [Ad]
669iGNwYwgRZg3nhS+aDAQ: checks
54yWzRRgS0oZ+S6LwZBxMQ: checks
*** RIVER *** [5c 5d 5h Ad] [2c]
669iGNwYwgRZg3nhS+aDAQ: checks
54yWzRRgS0oZ+S6LwZBxMQ: checks
*** SHOW DOWN ***
669iGNwYwgRZg3nhS+aDAQ: shows [8c Td] (three of a kind, Fives)
54yWzRRgS0oZ+S6LwZBxMQ: shows [9c Tc] (three of a kind, Fives)
669iGNwYwgRZg3nhS+aDAQ collected $5.75 from pot
54yWzRRgS0oZ+S6LwZBxMQ collected $5.70 from pot
*** SUMMARY ***
Total pot $12 | Rake $0.55
Board [5c 5d 5h Ad 2c]
Seat 2: 669iGNwYwgRZg3nhS+aDAQ (small blind) showed [8c Td] and won ($5.75) with three of a kind, Fives
Seat 3: 54yWzRRgS0oZ+S6LwZBxMQ (big blind) showed [9c Tc] and won ($5.70) with three of a kind, Fives
Seat 4: sY+4Uuh5z/6AbXXaCS10jw folded before Flop (didn't bet)
Seat 5: VvdR9F3I+2yELkfTVvC1dg folded before Flop (didn't bet)
Seat 6: /PH6Ffnho4Ysm8S3V/oa+w (button) folded before Flop (didn't bet)



PokerStars Game #59941968688:  Hold'em No Limit ($1/$2) - 2009/07/01 1:51:54 ET
Table 'kq5zaQ+1hLNf8LZfGnbTAA' 6-max Seat #1 is the button
Seat 1: 8srN1dKQePlsv0GyTada+Q ($416.60 in chips)
Seat 2: nXDI8Y/S6POzRwANu3d8hQ ($138 in chips)
Seat 3: /PH6Ffnho4Ysm8S3V/oa+w ($55.15 in chips)
Seat 4: 3dAbvkxS5NPQTBAbvpinVg ($275.65 in chips)
nXDI8Y/S6POzRwANu3d8hQ: posts small blind $1
/PH6Ffnho4Ysm8S3V/oa+w: posts big blind $2
*** HOLE CARDS ***
3dAbvkxS5NPQTBAbvpinVg: folds
8srN1dKQePlsv0GyTada+Q: raises $4 to $6
nXDI8Y/S6POzRwANu3d8hQ: folds
/PH6Ffnho4Ysm8S3V/oa+w: folds
8srN1dKQePlsv0GyTada+Q collected $5 from pot
8srN1dKQePlsv0GyTada+Q: doesn't show hand
*** SUMMARY ***
Total pot $5 | Rake $0
Seat 1: 8srN1dKQePlsv0GyTada+Q (button) collected ($5)
Seat 2: nXDI8Y/S6POzRwANu3d8hQ (small blind) folded before Flop
Seat 3: /PH6Ffnho4Ysm8S3V/oa+w (big blind) folded before Flop
Seat 4: 3dAbvkxS5NPQTBAbvpinVg folded before Flop (didn't bet)



PokerStars Game #59941969238:  Hold'em No Limit ($1/$2) - 2009/07/01 1:51:55 ET
Table 'gnHBqWll9O3fxG7Ojkz/ng' 9-max Seat #3 is the button
Seat 1: MtdNf9cdM7+0CSU0dx4USA ($77.35 in chips)
Seat 2: H6Z4+qu8gR0VUiPOijndVg ($332.30 in chips)
Seat 3: 5Q8U6iZbeO7xJSS4qvDP5g ($238.10 in chips)
Seat 4: nXDI8Y/S6POzRwANu3d8hQ ($14 in chips)
Seat 5: rBQDMkKm9cZn6M9NPsiVew ($169.15 in chips)
Seat 6: KqHysDSpCPaPyK3tJC1aEw ($200 in chips)
Seat 7: 254YPxPJr5Sw58bkD0YqYQ ($203 in chips)
Seat 8: cM6efHzdxoqYm0EQKP4TTQ ($110.95 in chips)
Seat 9: GX1heJ+DSsvm7gzSPsYhhQ ($46.15 in chips)
nXDI8Y/S6POzRwANu3d8hQ: posts small blind $1
rBQDMkKm9cZn6M9NPsiVew: posts big blind $2
*** HOLE CARDS ***
KqHysDSpCPaPyK3tJC1aEw: folds
254YPxPJr5Sw58bkD0YqYQ: folds
cM6efHzdxoqYm0EQKP4TTQ: folds
GX1heJ+DSsvm7gzSPsYhhQ: folds
MtdNf9cdM7+0CSU0dx4USA: folds
H6Z4+qu8gR0VUiPOijndVg: raises $4 to $6
5Q8U6iZbeO7xJSS4qvDP5g: folds
nXDI8Y/S6POzRwANu3d8hQ: folds
rBQDMkKm9cZn6M9NPsiVew: folds
H6Z4+qu8gR0VUiPOijndVg collected $5 from pot
H6Z4+qu8gR0VUiPOijndVg: doesn't show hand
*** SUMMARY ***
Total pot $5 | Rake $0
Seat 1: MtdNf9cdM7+0CSU0dx4USA folded before Flop (didn't bet)
Seat 2: H6Z4+qu8gR0VUiPOijndVg collected ($5)
Seat 3: 5Q8U6iZbeO7xJSS4qvDP5g (button) folded before Flop (didn't bet)
Seat 4: nXDI8Y/S6POzRwANu3d8hQ (small blind) folded before Flop
Seat 5: rBQDMkKm9cZn6M9NPsiVew (big blind) folded before Flop
Seat 6: KqHysDSpCPaPyK3tJC1aEw folded before Flop (didn't bet)
Seat 7: 254YPxPJr5Sw58bkD0YqYQ folded before Flop (didn't bet)
Seat 8: cM6efHzdxoqYm0EQKP4TTQ folded before Flop (didn't bet)
Seat 9: GX1heJ+DSsvm7gzSPsYhhQ folded before Flop (didn't bet)



PokerStars Game #59941971020:  Hold'em No Limit ($1/$2) - 2009/07/01 1:51:59 ET
Table 'BSRfGh+QobUe0AgIMtt/fw' 9-max Seat #6 is the button
Seat 1: gDn/rYeNwCyWEgRhyWp4PA ($159.05 in chips)
Seat 2: +SmnXtdmwqXGEJfLeJDIUQ ($123.90 in chips)
Seat 3: WUlHm+ydPPHG7Lb0rePSdA ($120 in chips)
Seat 4: +T/63sAeZzWyHchahJ36GQ ($31 in chips)
Seat 5: ThVDqrMpsvd7Ax6KINfuew ($64.50 in chips)
Seat 6: H6Z4+qu8gR0VUiPOijndVg ($202 in chips)
Seat 7: CkE3IyJF1KvdaAOmZY5XqQ ($203 in chips)
Seat 8: GG5lTuGt3+kwNYSbqeB6yw ($78.85 in chips)
Seat 9: tjgwwDmi+N2H4I7hx8useQ ($81 in chips)
CkE3IyJF1KvdaAOmZY5XqQ: posts small blind $1
GG5lTuGt3+kwNYSbqeB6yw: posts big blind $2
*** HOLE CARDS ***
tjgwwDmi+N2H4I7hx8useQ: folds
gDn/rYeNwCyWEgRhyWp4PA: folds
+SmnXtdmwqXGEJfLeJDIUQ: raises $6 to $8
WUlHm+ydPPHG7Lb0rePSdA: folds
+T/63sAeZzWyHchahJ36GQ: folds
ThVDqrMpsvd7Ax6KINfuew: folds
H6Z4+qu8gR0VUiPOijndVg: folds
CkE3IyJF1KvdaAOmZY5XqQ: folds
GG5lTuGt3+kwNYSbqeB6yw: folds
+SmnXtdmwqXGEJfLeJDIUQ collected $5 from pot
*** SUMMARY ***
Total pot $5 | Rake $0
Seat 1: gDn/rYeNwCyWEgRhyWp4PA folded before Flop (didn't bet)
Seat 2: +SmnXtdmwqXGEJfLeJDIUQ collected ($5)
Seat 3: WUlHm+ydPPHG7Lb0rePSdA folded before Flop (didn't bet)
Seat 4: +T/63sAeZzWyHchahJ36GQ folded before Flop (didn't bet)
Seat 5: ThVDqrMpsvd7Ax6KINfuew folded before Flop (didn't bet)
Seat 6: H6Z4+qu8gR0VUiPOijndVg (button) folded before Flop (didn't bet)
Seat 7: CkE3IyJF1KvdaAOmZY5XqQ (small blind) folded before Flop
Seat 8: GG5lTuGt3+kwNYSbqeB6yw (big blind) folded before Flop
Seat 9: tjgwwDmi+N2H4I7hx8useQ folded before Flop (didn't bet)



PokerStars Game #59941971116:  Hold'em No Limit ($1/$2) - 2009/07/01 1:51:59 ET
Table 'aSf77Sj8QEnzcc0WaxVD4Q' 6-max Seat #4 is the button
Seat 1: UELtvp+JfwI7XDGVwSxZXA ($169.05 in chips)
Seat 2: vkfxu8f/jMYKUk6Ly4eujw ($186.10 in chips)
Seat 3: 9dpyyjDTCed6nV7JhaUUpw ($757.50 in chips)
Seat 4: YsLQ3BAvgQHWXMAv3Wv6Hg ($200 in chips)
Seat 5: VvdR9F3I+2yELkfTVvC1dg ($302.70 in chips)
Seat 6: vkoJRf3gidxY1pPi0AFWww ($175.25 in chips)
VvdR9F3I+2yELkfTVvC1dg: posts small blind $1
vkoJRf3gidxY1pPi0AFWww: posts big blind $2
*** HOLE CARDS ***
UELtvp+JfwI7XDGVwSxZXA: raises $4 to $6
vkfxu8f/jMYKUk6Ly4eujw: folds
9dpyyjDTCed6nV7JhaUUpw: folds
YsLQ3BAvgQHWXMAv3Wv6Hg: folds
VvdR9F3I+2yELkfTVvC1dg: folds
vkoJRf3gidxY1pPi0AFWww: calls $4
*** FLOP *** [9s 5c 8h]
vkoJRf3gidxY1pPi0AFWww: checks
UELtvp+JfwI7XDGVwSxZXA: checks
*** TURN *** [9s 5c 8h] [2c]
vkoJRf3gidxY1pPi0AFWww: bets $6
UELtvp+JfwI7XDGVwSxZXA: calls $6
*** RIVER *** [9s 5c 8h 2c] [2s]
vkoJRf3gidxY1pPi0AFWww: checks
UELtvp+JfwI7XDGVwSxZXA: checks
*** SHOW DOWN ***
vkoJRf3gidxY1pPi0AFWww: shows [4c 6c] (a pair of Deuces)
UELtvp+JfwI7XDGVwSxZXA: shows [As 6d] (a pair of Deuces - Ace kicker)
UELtvp+JfwI7XDGVwSxZXA collected $23.80 from pot
*** SUMMARY ***
Total pot $25 | Rake $1.20
Board [9s 5c 8h 2c 2s]
Seat 1: UELtvp+JfwI7XDGVwSxZXA showed [As 6d] and won ($23.80) with a pair of Deuces
Seat 2: vkfxu8f/jMYKUk6Ly4eujw folded before Flop (didn't bet)
Seat 3: 9dpyyjDTCed6nV7JhaUUpw folded before Flop (didn't bet)
Seat 4: YsLQ3BAvgQHWXMAv3Wv6Hg (button) folded before Flop (didn't bet)
Seat 5: VvdR9F3I+2yELkfTVvC1dg (small blind) folded before Flop
Seat 6: vkoJRf3gidxY1pPi0AFWww (big blind) showed [4c 6c] and lost with a pair of Deuces



PokerStars Game #59941971316:  Hold'em No Limit ($1/$2) - 2009/07/01 1:51:59 ET
Table 'ztv6V3FN2bQ9nmJPPdx6nQ' 6-max Seat #4 is the button
Seat 1: 6fLdOUCRtX71xbVRhJEq8w ($297.35 in chips)
Seat 2: 5Y+ZGWLI4gnlpApDX5vy1A ($374.05 in chips)
Seat 4: UaZ5yj+6LjtWqMQg2QskUw ($72.55 in chips)
Seat 5: sTPOWERd9HWPCNrDBwsVjA ($214.60 in chips)
Seat 6: mfy7uGZcqA2PVQqEVbJ7+g ($86.20 in chips)
sTPOWERd9HWPCNrDBwsVjA: posts small blind $1
mfy7uGZcqA2PVQqEVbJ7+g: posts big blind $2
*** HOLE CARDS ***
6fLdOUCRtX71xbVRhJEq8w: raises $4 to $6
5Y+ZGWLI4gnlpApDX5vy1A: folds
UaZ5yj+6LjtWqMQg2QskUw: calls $6
sTPOWERd9HWPCNrDBwsVjA: folds
mfy7uGZcqA2PVQqEVbJ7+g: folds
*** FLOP *** [2s Kc 6s]
6fLdOUCRtX71xbVRhJEq8w: bets $10
UaZ5yj+6LjtWqMQg2QskUw: raises $12 to $22
6fLdOUCRtX71xbVRhJEq8w: folds
UaZ5yj+6LjtWqMQg2QskUw collected $33.30 from pot
*** SUMMARY ***
Total pot $35 | Rake $1.70
Board [2s Kc 6s]
Seat 1: 6fLdOUCRtX71xbVRhJEq8w folded on the Flop
Seat 2: 5Y+ZGWLI4gnlpApDX5vy1A folded before Flop (didn't bet)
Seat 4: UaZ5yj+6LjtWqMQg2QskUw (button) collected ($33.30)
Seat 5: sTPOWERd9HWPCNrDBwsVjA (small blind) folded before Flop
Seat 6: mfy7uGZcqA2PVQqEVbJ7+g (big blind) folded before Flop



PokerStars Game #59941971830:  Hold'em No Limit ($1/$2) - 2009/07/01 1:52:00 ET
Table 'P/yCfYl1GfGsu/e6DxDy/A' 2-max Seat #1 is the button
Seat 1: 7fOCUy3x9hdkmXkkDNolGQ ($1102.50 in chips)
Seat 2: RwDoM55ZeQuI2ADyJhOb2Q ($367.50 in chips)
7fOCUy3x9hdkmXkkDNolGQ: posts small blind $1
RwDoM55ZeQuI2ADyJhOb2Q: posts big blind $2
*** HOLE CARDS ***
7fOCUy3x9hdkmXkkDNolGQ: folds
RwDoM55ZeQuI2ADyJhOb2Q collected $2 from pot
RwDoM55ZeQuI2ADyJhOb2Q: doesn't show hand
*** SUMMARY ***
Total pot $2 | Rake $0
Seat 1: 7fOCUy3x9hdkmXkkDNolGQ (button) (small blind) folded before Flop
Seat 2: RwDoM55ZeQuI2ADyJhOb2Q (big blind) collected ($2)



PokerStars Game #59941972632:  Hold'em No Limit ($1/$2) - 2009/07/01 1:52:02 ET
Table 'WCA60bDA8ecovUgFSIZkTQ' 9-max Seat #2 is the button
Seat 1: 3RFwE6igZ1BGKOGuab6iiw ($52.70 in chips)
Seat 2: TAfo4veNRaRlzDXMMYS3Jg ($37 in chips)
Seat 3: g7gL2NLJCdZPPV399WKT1w ($48.65 in chips)
Seat 4: IYBKVnE2Basnr88BAhH+bQ ($205.80 in chips)
Seat 5: A+9gcmwAl0eFxxbAwRY1OA ($267.10 in chips)
Seat 7: tsTv4D+ne2W0qhUt9HlcMw ($193 in chips)
Seat 8: mJhwEVg7F695DiO+RIhM5g ($257.45 in chips)
Seat 9: ItDFe9gh5QYPQB9vC4ntUA ($200 in chips)
g7gL2NLJCdZPPV399WKT1w: posts small blind $1
IYBKVnE2Basnr88BAhH+bQ: posts big blind $2
YoKKKdDDs7gFzP1Z65Sdaw: sits out
*** HOLE CARDS ***
A+9gcmwAl0eFxxbAwRY1OA: folds
tsTv4D+ne2W0qhUt9HlcMw: folds
mJhwEVg7F695DiO+RIhM5g: folds
ItDFe9gh5QYPQB9vC4ntUA: folds
3RFwE6igZ1BGKOGuab6iiw: raises $4 to $6
TAfo4veNRaRlzDXMMYS3Jg: folds
g7gL2NLJCdZPPV399WKT1w: folds
IYBKVnE2Basnr88BAhH+bQ: folds
3RFwE6igZ1BGKOGuab6iiw collected $5 from pot
*** SUMMARY ***
Total pot $5 | Rake $0
Seat 1: 3RFwE6igZ1BGKOGuab6iiw collected ($5)
Seat 2: TAfo4veNRaRlzDXMMYS3Jg (button) folded before Flop (didn't bet)
Seat 3: g7gL2NLJCdZPPV399WKT1w (small blind) folded before Flop
Seat 4: IYBKVnE2Basnr88BAhH+bQ (big blind) folded before Flop
Seat 5: A+9gcmwAl0eFxxbAwRY1OA folded before Flop (didn't bet)
Seat 7: tsTv4D+ne2W0qhUt9HlcMw folded before Flop (didn't bet)
Seat 8: mJhwEVg7F695DiO+RIhM5g folded before Flop (didn't bet)
Seat 9: ItDFe9gh5QYPQB9vC4ntUA folded before Flop (didn't bet)



PokerStars Game #59941973020:  Hold'em No Limit ($1/$2) - 2009/07/01 1:52:02 ET
Table 'uJ9juaXXg9yIcSU8amxaXQ' 6-max Seat #3 is the button
Seat 1: JsqOjN/eHz0uYVf/PyUJ6Q ($119.95 in chips)
Seat 2: VvdR9F3I+2yELkfTVvC1dg ($210.05 in chips)
Seat 3: qXDd0ZyMIse0OBu8pxeQ3Q ($239.40 in chips)
Seat 4: zNjJ/y4emmF+vzrCDd+ooA ($271.55 in chips)
Seat 5: YsLQ3BAvgQHWXMAv3Wv6Hg ($215.70 in chips)
Seat 6: /PH6Ffnho4Ysm8S3V/oa+w ($43 in chips)
zNjJ/y4emmF+vzrCDd+ooA: posts small blind $1
YsLQ3BAvgQHWXMAv3Wv6Hg: posts big blind $2
*** HOLE CARDS ***
/PH6Ffnho4Ysm8S3V/oa+w: folds
JsqOjN/eHz0uYVf/PyUJ6Q: folds
VvdR9F3I+2yELkfTVvC1dg: raises $2 to $4
qXDd0ZyMIse0OBu8pxeQ3Q: folds
zNjJ/y4emmF+vzrCDd+ooA: calls $3
YsLQ3BAvgQHWXMAv3Wv6Hg: calls $2
*** FLOP *** [Jd Qh 2s]
zNjJ/y4emmF+vzrCDd+ooA: checks
YsLQ3BAvgQHWXMAv3Wv6Hg: checks
VvdR9F3I+2yELkfTVvC1dg: bets $8.55
zNjJ/y4emmF+vzrCDd+ooA: folds
YsLQ3BAvgQHWXMAv3Wv6Hg: folds
VvdR9F3I+2yELkfTVvC1dg collected $11.40 from pot
VvdR9F3I+2yELkfTVvC1dg: doesn't show hand
*** SUMMARY ***
Total pot $12 | Rake $0.60
Board [Jd Qh 2s]
Seat 1: JsqOjN/eHz0uYVf/PyUJ6Q folded before Flop (didn't bet)
Seat 2: VvdR9F3I+2yELkfTVvC1dg collected ($11.40)
Seat 3: qXDd0ZyMIse0OBu8pxeQ3Q (button) folded before Flop (didn't bet)
Seat 4: zNjJ/y4emmF+vzrCDd+ooA (small blind) folded on the Flop
Seat 5: YsLQ3BAvgQHWXMAv3Wv6Hg (big blind) folded on the Flop
Seat 6: /PH6Ffnho4Ysm8S3V/oa+w folded before Flop (didn't bet)



PokerStars Game #59941974404:  Hold'em No Limit ($1/$2) - 2009/07/01 1:52:05 ET
Table 'NmY84NAf9Mh0ckAckHnh5g' 2-max Seat #1 is the button
Seat 1: 6hvg964TSqZ3AL/0XK9aVQ ($524.15 in chips)
Seat 2: RwDoM55ZeQuI2ADyJhOb2Q ($457.55 in chips)
6hvg964TSqZ3AL/0XK9aVQ: posts small blind $1
RwDoM55ZeQuI2ADyJhOb2Q: posts big blind $2
*** HOLE CARDS ***
6hvg964TSqZ3AL/0XK9aVQ: calls $1
RwDoM55ZeQuI2ADyJhOb2Q: raises $8 to $10
6hvg964TSqZ3AL/0XK9aVQ: calls $8
*** FLOP *** [Tc 9s Jh]
RwDoM55ZeQuI2ADyJhOb2Q: bets $10
6hvg964TSqZ3AL/0XK9aVQ: calls $10
*** TURN *** [Tc 9s Jh] [Qd]
RwDoM55ZeQuI2ADyJhOb2Q: checks
6hvg964TSqZ3AL/0XK9aVQ: checks
*** RIVER *** [Tc 9s Jh Qd] [5c]
RwDoM55ZeQuI2ADyJhOb2Q: bets $22
6hvg964TSqZ3AL/0XK9aVQ: calls $22
*** SHOW DOWN ***
RwDoM55ZeQuI2ADyJhOb2Q: shows [6c Qc] (a pair of Queens)
6hvg964TSqZ3AL/0XK9aVQ: shows [Qs 6d] (a pair of Queens)
RwDoM55ZeQuI2ADyJhOb2Q collected $41.75 from pot
6hvg964TSqZ3AL/0XK9aVQ collected $41.75 from pot
*** SUMMARY ***
Total pot $84 | Rake $0.50
Board [Tc 9s Jh Qd 5c]
Seat 1: 6hvg964TSqZ3AL/0XK9aVQ (button) (small blind) showed [Qs 6d] and won ($41.75) with a pair of Queens
Seat 2: RwDoM55ZeQuI2ADyJhOb2Q (big blind) showed [6c Qc] and won ($41.75) with a pair of Queens



PokerStars Game #59941975206:  Hold'em No Limit ($1/$2) - 2009/07/01 1:52:06 ET
Table 'P/yCfYl1GfGsu/e6DxDy/A' 2-max Seat #2 is the button
Seat 1: 7fOCUy3x9hdkmXkkDNolGQ ($1101.50 in chips)
Seat 2: RwDoM55ZeQuI2ADyJhOb2Q ($368.50 in chips)
RwDoM55ZeQuI2ADyJhOb2Q: posts small blind $1
7fOCUy3x9hdkmXkkDNolGQ: posts big blind $2
*** HOLE CARDS ***
RwDoM55ZeQuI2ADyJhOb2Q: raises $4 to $6
7fOCUy3x9hdkmXkkDNolGQ: folds
RwDoM55ZeQuI2ADyJhOb2Q collected $4 from pot
RwDoM55ZeQuI2ADyJhOb2Q: doesn't show hand
*** SUMMARY ***
Total pot $4 | Rake $0
Seat 1: 7fOCUy3x9hdkmXkkDNolGQ (big blind) folded before Flop
Seat 2: RwDoM55ZeQuI2ADyJhOb2Q (button) (small blind) collected ($4)



PokerStars Game #59941977596:  Hold'em No Limit ($1/$2) - 2009/07/01 1:52:11 ET
Table '/dyk+YdRGv90j2box35j8w' 6-max Seat #4 is the button
Seat 1: 8srN1dKQePlsv0GyTada+Q ($200 in chips)
Seat 2: qCnEYuAE5y5A7bk6fO5/jQ ($499.20 in chips)
Seat 3: sTPOWERd9HWPCNrDBwsVjA ($209.50 in chips)
Seat 4: 4dMBh/1VTdeUTPCyhCs3UQ ($90 in chips)
Seat 5: VvdR9F3I+2yELkfTVvC1dg ($292.80 in chips)
Seat 6: C3qJBo7uxfFVDluE1lmK2w ($86 in chips)
VvdR9F3I+2yELkfTVvC1dg: posts small blind $1
C3qJBo7uxfFVDluE1lmK2w: posts big blind $2
*** HOLE CARDS ***
8srN1dKQePlsv0GyTada+Q: folds
qCnEYuAE5y5A7bk6fO5/jQ: folds
sTPOWERd9HWPCNrDBwsVjA: folds
4dMBh/1VTdeUTPCyhCs3UQ: raises $5 to $7
VvdR9F3I+2yELkfTVvC1dg: folds
C3qJBo7uxfFVDluE1lmK2w: calls $5
*** FLOP *** [Kc Jd 9h]
C3qJBo7uxfFVDluE1lmK2w: bets $8
4dMBh/1VTdeUTPCyhCs3UQ: folds
C3qJBo7uxfFVDluE1lmK2w collected $14.25 from pot
*** SUMMARY ***
Total pot $15 | Rake $0.75
Board [Kc Jd 9h]
Seat 1: 8srN1dKQePlsv0GyTada+Q folded before Flop (didn't bet)
Seat 2: qCnEYuAE5y5A7bk6fO5/jQ folded before Flop (didn't bet)
Seat 3: sTPOWERd9HWPCNrDBwsVjA folded before Flop (didn't bet)
Seat 4: 4dMBh/1VTdeUTPCyhCs3UQ (button) folded on the Flop
Seat 5: VvdR9F3I+2yELkfTVvC1dg (small blind) folded before Flop
Seat 6: C3qJBo7uxfFVDluE1lmK2w (big blind) collected ($14.25)



PokerStars Game #59941979056:  Hold'em No Limit ($1/$2) - 2009/07/01 1:52:14 ET
Table 'UGLAZZyv+cXmnKjYin0etA' 6-max Seat #4 is the button
Seat 2: eDLH1PUXFpvJBNMXBVQcGA ($297.10 in chips)
Seat 4: SiGJDsvRViJX05vHhA80GQ ($253.75 in chips)
Seat 5: 54yWzRRgS0oZ+S6LwZBxMQ ($35.80 in chips)
Seat 6: sTPOWERd9HWPCNrDBwsVjA ($207.95 in chips)
54yWzRRgS0oZ+S6LwZBxMQ: posts small blind $1
sTPOWERd9HWPCNrDBwsVjA: posts big blind $2
rL+Zpv4/vX2BVHcyfh/NXA: sits out
*** HOLE CARDS ***
eDLH1PUXFpvJBNMXBVQcGA: folds
SiGJDsvRViJX05vHhA80GQ: raises $2 to $4
54yWzRRgS0oZ+S6LwZBxMQ: folds
sTPOWERd9HWPCNrDBwsVjA: raises $16 to $20
SiGJDsvRViJX05vHhA80GQ: folds
sTPOWERd9HWPCNrDBwsVjA collected $9 from pot
*** SUMMARY ***
Total pot $9 | Rake $0
Seat 2: eDLH1PUXFpvJBNMXBVQcGA folded before Flop (didn't bet)
Seat 4: SiGJDsvRViJX05vHhA80GQ (button) folded before Flop
Seat 5: 54yWzRRgS0oZ+S6LwZBxMQ (small blind) folded before Flop
Seat 6: sTPOWERd9HWPCNrDBwsVjA (big blind) collected ($9)



PokerStars Game #59941979682:  Hold'em No Limit ($1/$2) - 2009/07/01 1:52:15 ET
Table 'mGpP9StWRnoeiBDExc6Frg' 6-max Seat #2 is the button
Seat 1: VvdR9F3I+2yELkfTVvC1dg ($316.40 in chips)
Seat 2: 6hRJ68JkbJq6MYI9o5bUnQ ($103 in chips)
Seat 3: mddoKnqZkdOH7AJOJ/i0DA ($200 in chips)
Seat 4: 4dcDwIHRm96PwtqkpQiuiA ($87.70 in chips)
Seat 5: d1puGuVBE0fidn+5eRJ0tw ($190.35 in chips)
Seat 6: B2Ih1sr5VZk+8He7rcrMtQ ($402.45 in chips)
mddoKnqZkdOH7AJOJ/i0DA: posts small blind $1
4dcDwIHRm96PwtqkpQiuiA: posts big blind $2
*** HOLE CARDS ***
d1puGuVBE0fidn+5eRJ0tw: raises $4 to $6
B2Ih1sr5VZk+8He7rcrMtQ: folds
VvdR9F3I+2yELkfTVvC1dg: folds
6hRJ68JkbJq6MYI9o5bUnQ: folds
mddoKnqZkdOH7AJOJ/i0DA: folds
4dcDwIHRm96PwtqkpQiuiA: folds
d1puGuVBE0fidn+5eRJ0tw collected $5 from pot
d1puGuVBE0fidn+5eRJ0tw: doesn't show hand
*** SUMMARY ***
Total pot $5 | Rake $0
Seat 1: VvdR9F3I+2yELkfTVvC1dg folded before Flop (didn't bet)
Seat 2: 6hRJ68JkbJq6MYI9o5bUnQ (button) folded before Flop (didn't bet)
Seat 3: mddoKnqZkdOH7AJOJ/i0DA (small blind) folded before Flop
Seat 4: 4dcDwIHRm96PwtqkpQiuiA (big blind) folded before Flop
Seat 5: d1puGuVBE0fidn+5eRJ0tw collected ($5)
Seat 6: B2Ih1sr5VZk+8He7rcrMtQ folded before Flop (didn't bet)



PokerStars Game #59941979526:  Hold'em No Limit ($1/$2) - 2009/07/01 1:52:15 ET
Table 'eyAQSIlgc2o1Jxvbve4WGg' 9-max Seat #6 is the button
Seat 1: UZEsV9yKUMqmpYPiOFpaZw ($73 in chips)
Seat 2: kM9CA+2UcdMjbCMbtUCGiA ($208.60 in chips)
Seat 4: CkE3IyJF1KvdaAOmZY5XqQ ($200 in chips)
Seat 5: mIKx5lhIt13X5eZQH0ZeMA ($161.75 in chips)
Seat 6: nXDI8Y/S6POzRwANu3d8hQ ($64 in chips)
Seat 7: u3OrI5uGx9mx1fE7dgr+EA ($86.75 in chips)
Seat 8: 254YPxPJr5Sw58bkD0YqYQ ($200 in chips)
Seat 9: WUlHm+ydPPHG7Lb0rePSdA ($140.20 in chips)
u3OrI5uGx9mx1fE7dgr+EA: posts small blind $1
254YPxPJr5Sw58bkD0YqYQ: posts big blind $2
*** HOLE CARDS ***
WUlHm+ydPPHG7Lb0rePSdA: folds
UZEsV9yKUMqmpYPiOFpaZw: folds
kM9CA+2UcdMjbCMbtUCGiA: raises $3 to $5
CkE3IyJF1KvdaAOmZY5XqQ: folds
mIKx5lhIt13X5eZQH0ZeMA: calls $5
ice1Sbe19zWIaKYoSmE5tw has returned
nXDI8Y/S6POzRwANu3d8hQ: folds
u3OrI5uGx9mx1fE7dgr+EA: folds
254YPxPJr5Sw58bkD0YqYQ: calls $3
*** FLOP *** [Ts 5s 8d]
254YPxPJr5Sw58bkD0YqYQ: checks
kM9CA+2UcdMjbCMbtUCGiA: checks
mIKx5lhIt13X5eZQH0ZeMA: bets $8
254YPxPJr5Sw58bkD0YqYQ: folds
kM9CA+2UcdMjbCMbtUCGiA: calls $8
*** TURN *** [Ts 5s 8d] [8c]
kM9CA+2UcdMjbCMbtUCGiA: checks
mIKx5lhIt13X5eZQH0ZeMA: checks
*** RIVER *** [Ts 5s 8d 8c] [9s]
kM9CA+2UcdMjbCMbtUCGiA: bets $8
mIKx5lhIt13X5eZQH0ZeMA: folds
kM9CA+2UcdMjbCMbtUCGiA collected $30.45 from pot
kM9CA+2UcdMjbCMbtUCGiA: doesn't show hand
*** SUMMARY ***
Total pot $32 | Rake $1.55
Board [Ts 5s 8d 8c 9s]
Seat 1: UZEsV9yKUMqmpYPiOFpaZw folded before Flop (didn't bet)
Seat 2: kM9CA+2UcdMjbCMbtUCGiA collected ($30.45)
Seat 4: CkE3IyJF1KvdaAOmZY5XqQ folded before Flop (didn't bet)
Seat 5: mIKx5lhIt13X5eZQH0ZeMA folded on the River
Seat 6: nXDI8Y/S6POzRwANu3d8hQ (button) folded before Flop (didn't bet)
Seat 7: u3OrI5uGx9mx1fE7dgr+EA (small blind) folded before Flop
Seat 8: 254YPxPJr5Sw58bkD0YqYQ (big blind) folded on the Flop
Seat 9: WUlHm+ydPPHG7Lb0rePSdA folded before Flop (didn't bet)



PokerStars Game #59941981124:  Hold'em No Limit ($1/$2) - 2009/07/01 1:52:18 ET
Table 'jlrIxbrVIG+gjaUYT4za8g' 6-max Seat #6 is the button
Seat 2: cwfuMyvDC7J7SqX2leDC8g ($71 in chips)
Seat 3: 3LCfF9/CuJ9+kbFOcqmuaQ ($86.50 in chips)
Seat 4: 8srN1dKQePlsv0GyTada+Q ($260.50 in chips)
Seat 5: AyBB0k3Dcl7xbXUeGMw06g ($68.75 in chips)
Seat 6: BWhgxe7gWiYobRbwdG+d2Q ($201.30 in chips)
opJMdoq0E6TRbAQiweyQuA will be allowed to play after the button
cwfuMyvDC7J7SqX2leDC8g: posts small blind $1
3LCfF9/CuJ9+kbFOcqmuaQ: posts big blind $2
*** HOLE CARDS ***
8srN1dKQePlsv0GyTada+Q: folds
AyBB0k3Dcl7xbXUeGMw06g: folds
BWhgxe7gWiYobRbwdG+d2Q: folds
cwfuMyvDC7J7SqX2leDC8g: calls $1
3LCfF9/CuJ9+kbFOcqmuaQ: checks
*** FLOP *** [6c 5d 6d]
cwfuMyvDC7J7SqX2leDC8g: checks
3LCfF9/CuJ9+kbFOcqmuaQ: checks
*** TURN *** [6c 5d 6d] [9d]
cwfuMyvDC7J7SqX2leDC8g: checks
3LCfF9/CuJ9+kbFOcqmuaQ: bets $4
cwfuMyvDC7J7SqX2leDC8g: folds
3LCfF9/CuJ9+kbFOcqmuaQ collected $3.80 from pot
*** SUMMARY ***
Total pot $4 | Rake $0.20
Board [6c 5d 6d 9d]
Seat 2: cwfuMyvDC7J7SqX2leDC8g (small blind) folded on the Turn
Seat 3: 3LCfF9/CuJ9+kbFOcqmuaQ (big blind) collected ($3.80)
Seat 4: 8srN1dKQePlsv0GyTada+Q folded before Flop (didn't bet)
Seat 5: AyBB0k3Dcl7xbXUeGMw06g folded before Flop (didn't bet)
Seat 6: BWhgxe7gWiYobRbwdG+d2Q (button) folded before Flop (didn't bet)



PokerStars Game #59941981362:  Hold'em No Limit ($1/$2) - 2009/07/01 1:52:18 ET
Table 'P/yCfYl1GfGsu/e6DxDy/A' 2-max Seat #1 is the button
Seat 1: 7fOCUy3x9hdkmXkkDNolGQ ($1099.50 in chips)
Seat 2: RwDoM55ZeQuI2ADyJhOb2Q ($370.50 in chips)
7fOCUy3x9hdkmXkkDNolGQ: posts small blind $1
RwDoM55ZeQuI2ADyJhOb2Q: posts big blind $2
*** HOLE CARDS ***
7fOCUy3x9hdkmXkkDNolGQ: raises $4 to $6
RwDoM55ZeQuI2ADyJhOb2Q: calls $4
*** FLOP *** [Jd 9s 2c]
RwDoM55ZeQuI2ADyJhOb2Q: checks
7fOCUy3x9hdkmXkkDNolGQ: bets $10
RwDoM55ZeQuI2ADyJhOb2Q: folds
7fOCUy3x9hdkmXkkDNolGQ collected $11.50 from pot
7fOCUy3x9hdkmXkkDNolGQ: doesn't show hand
*** SUMMARY ***
Total pot $12 | Rake $0.50
Board [Jd 9s 2c]
Seat 1: 7fOCUy3x9hdkmXkkDNolGQ (button) (small blind) collected ($11.50)
Seat 2: RwDoM55ZeQuI2ADyJhOb2Q (big blind) folded on the Flop



PokerStars Game #59941981642:  Hold'em No Limit ($1/$2) - 2009/07/01 1:52:19 ET
Table 'ZzSIe0zTCDv+n6hfbY5tTg' 6-max Seat #5 is the button
Seat 1: VvdR9F3I+2yELkfTVvC1dg ($286.90 in chips)
Seat 2: B87ikIyZ/TzAVeXf38Ny0g ($225 in chips)
Seat 3: gsugPj31Hui3Jefl98MBOA ($346.10 in chips)
Seat 4: 54yWzRRgS0oZ+S6LwZBxMQ ($45.10 in chips)
Seat 5: 3dAbvkxS5NPQTBAbvpinVg ($481.45 in chips)
Seat 6: 09BNF4quPDzanQzM8vc6WA ($34 in chips)
09BNF4quPDzanQzM8vc6WA: posts small blind $1
VvdR9F3I+2yELkfTVvC1dg: posts big blind $2
*** HOLE CARDS ***
B87ikIyZ/TzAVeXf38Ny0g: folds
gsugPj31Hui3Jefl98MBOA: folds
54yWzRRgS0oZ+S6LwZBxMQ: calls $2
3dAbvkxS5NPQTBAbvpinVg: folds
09BNF4quPDzanQzM8vc6WA: folds
VvdR9F3I+2yELkfTVvC1dg: checks
*** FLOP *** [2h Kc 9c]
VvdR9F3I+2yELkfTVvC1dg: bets $3.55
54yWzRRgS0oZ+S6LwZBxMQ: folds
VvdR9F3I+2yELkfTVvC1dg collected $4.75 from pot
VvdR9F3I+2yELkfTVvC1dg: doesn't show hand
*** SUMMARY ***
Total pot $5 | Rake $0.25
Board [2h Kc 9c]
Seat 1: VvdR9F3I+2yELkfTVvC1dg (big blind) collected ($4.75)
Seat 2: B87ikIyZ/TzAVeXf38Ny0g folded before Flop (didn't bet)
Seat 3: gsugPj31Hui3Jefl98MBOA folded before Flop (didn't bet)
Seat 4: 54yWzRRgS0oZ+S6LwZBxMQ folded on the Flop
Seat 5: 3dAbvkxS5NPQTBAbvpinVg (button) folded before Flop (didn't bet)
Seat 6: 09BNF4quPDzanQzM8vc6WA (small blind) folded before Flop



PokerStars Game #59941983044:  Hold'em No Limit ($1/$2) - 2009/07/01 1:52:21 ET
Table 'TsEDkiO4tzCTCzJ7tNdEqw' 6-max Seat #3 is the button
Seat 2: 4dcDwIHRm96PwtqkpQiuiA ($83.70 in chips)
Seat 3: ubtx4Z5L+AcK71MTvYiGVw ($203.20 in chips)
Seat 4: K8MXCrNAVYlMnnCeM32Kxw ($125.35 in chips)
Seat 5: VvdR9F3I+2yELkfTVvC1dg ($243.35 in chips)
Seat 6: uCqEjnxh2/vFBjKYkfTOkw ($284.80 in chips)
K8MXCrNAVYlMnnCeM32Kxw: posts small blind $1
VvdR9F3I+2yELkfTVvC1dg: posts big blind $2
*** HOLE CARDS ***
uCqEjnxh2/vFBjKYkfTOkw: folds
4dcDwIHRm96PwtqkpQiuiA: folds
ubtx4Z5L+AcK71MTvYiGVw: raises $4 to $6
K8MXCrNAVYlMnnCeM32Kxw: calls $5
VvdR9F3I+2yELkfTVvC1dg: folds
*** FLOP *** [Ts Qh Td]
K8MXCrNAVYlMnnCeM32Kxw: checks
ubtx4Z5L+AcK71MTvYiGVw: bets $10
Nsjun4mjI8q0SSBTIp1dIQ has returned
K8MXCrNAVYlMnnCeM32Kxw: raises $10 to $20
ubtx4Z5L+AcK71MTvYiGVw: calls $10
*** TURN *** [Ts Qh Td] [6s]
K8MXCrNAVYlMnnCeM32Kxw: bets $12
ubtx4Z5L+AcK71MTvYiGVw: calls $12
*** RIVER *** [Ts Qh Td 6s] [6d]
K8MXCrNAVYlMnnCeM32Kxw: bets $12
ubtx4Z5L+AcK71MTvYiGVw: calls $12
*** SHOW DOWN ***
K8MXCrNAVYlMnnCeM32Kxw: shows [Qc Jh] (two pair, Queens and Tens)
ubtx4Z5L+AcK71MTvYiGVw: shows [Ad Qd] (two pair, Queens and Tens - Ace kicker)
ubtx4Z5L+AcK71MTvYiGVw collected $100 from pot
*** SUMMARY ***
Total pot $102 | Rake $2
Board [Ts Qh Td 6s 6d]
Seat 2: 4dcDwIHRm96PwtqkpQiuiA folded before Flop (didn't bet)
Seat 3: ubtx4Z5L+AcK71MTvYiGVw (button) showed [Ad Qd] and won ($100) with two pair, Queens and Tens
Seat 4: K8MXCrNAVYlMnnCeM32Kxw (small blind) showed [Qc Jh] and lost with two pair, Queens and Tens
Seat 5: VvdR9F3I+2yELkfTVvC1dg (big blind) folded before Flop
Seat 6: uCqEjnxh2/vFBjKYkfTOkw folded before Flop (didn't bet)



PokerStars Game #59941983288:  Hold'em No Limit ($1/$2) - 2009/07/01 1:52:22 ET
Table 'G1Oqdy4Pqdb5gtx40rUBzA' 6-max Seat #5 is the button
Seat 1: 4dMBh/1VTdeUTPCyhCs3UQ ($39.70 in chips)
Seat 2: m7mYVfnCOK5TE/VkN/FhOg ($236.75 in chips)
Seat 3: VvdR9F3I+2yELkfTVvC1dg ($419.90 in chips)
Seat 4: B87ikIyZ/TzAVeXf38Ny0g ($221.70 in chips)
Seat 5: F1+Ml47qRQWunzPnGhLLzQ ($194 in chips)
Seat 6: qCnEYuAE5y5A7bk6fO5/jQ ($201 in chips)
qCnEYuAE5y5A7bk6fO5/jQ: posts small blind $1
4dMBh/1VTdeUTPCyhCs3UQ: posts big blind $2
*** HOLE CARDS ***
m7mYVfnCOK5TE/VkN/FhOg: folds
VvdR9F3I+2yELkfTVvC1dg: folds
B87ikIyZ/TzAVeXf38Ny0g: raises $4 to $6
F1+Ml47qRQWunzPnGhLLzQ: folds
qCnEYuAE5y5A7bk6fO5/jQ: folds
4dMBh/1VTdeUTPCyhCs3UQ: calls $4
*** FLOP *** [3d 6h 4h]
4dMBh/1VTdeUTPCyhCs3UQ: checks
B87ikIyZ/TzAVeXf38Ny0g: checks
*** TURN *** [3d 6h 4h] [Ad]
4dMBh/1VTdeUTPCyhCs3UQ: checks
B87ikIyZ/TzAVeXf38Ny0g: checks
*** RIVER *** [3d 6h 4h Ad] [Kh]
4dMBh/1VTdeUTPCyhCs3UQ: bets $8
B87ikIyZ/TzAVeXf38Ny0g: folds
4dMBh/1VTdeUTPCyhCs3UQ collected $12.35 from pot
4dMBh/1VTdeUTPCyhCs3UQ: doesn't show hand
*** SUMMARY ***
Total pot $13 | Rake $0.65
Board [3d 6h 4h Ad Kh]
Seat 1: 4dMBh/1VTdeUTPCyhCs3UQ (big blind) collected ($12.35)
Seat 2: m7mYVfnCOK5TE/VkN/FhOg folded before Flop (didn't bet)
Seat 3: VvdR9F3I+2yELkfTVvC1dg folded before Flop (didn't bet)
Seat 4: B87ikIyZ/TzAVeXf38Ny0g folded on the River
Seat 5: F1+Ml47qRQWunzPnGhLLzQ (button) folded before Flop (didn't bet)
Seat 6: qCnEYuAE5y5A7bk6fO5/jQ (small blind) folded before Flop



PokerStars Game #59941984078:  Hold'em No Limit ($1/$2) - 2009/07/01 1:52:23 ET
Table 'QxerF7GUfCbl+4a8XaTB2w' 6-max Seat #6 is the button
Seat 1: ZwvXzkkZ3XpMhKfAmVpahw ($327.75 in chips)
Seat 2: 6UGgYbxwWNc+ohObe8vB9w ($42.50 in chips)
Seat 3: 8rZGabKe2DEPdZCbCivZ9Q ($27 in chips)
Seat 4: /PH6Ffnho4Ysm8S3V/oa+w ($53 in chips)
Seat 5: vkfxu8f/jMYKUk6Ly4eujw ($152.05 in chips)
Seat 6: VvdR9F3I+2yELkfTVvC1dg ($210.70 in chips)
ZwvXzkkZ3XpMhKfAmVpahw: posts small blind $1
6UGgYbxwWNc+ohObe8vB9w: posts big blind $2
*** HOLE CARDS ***
8rZGabKe2DEPdZCbCivZ9Q: calls $2
/PH6Ffnho4Ysm8S3V/oa+w: folds
vkfxu8f/jMYKUk6Ly4eujw: folds
VvdR9F3I+2yELkfTVvC1dg: folds
ZwvXzkkZ3XpMhKfAmVpahw: raises $8 to $10
6UGgYbxwWNc+ohObe8vB9w: raises $32.50 to $42.50 and is all-in
8rZGabKe2DEPdZCbCivZ9Q: folds
ZwvXzkkZ3XpMhKfAmVpahw: calls $32.50
*** FLOP *** [Ts Qd Jc]
*** TURN *** [Ts Qd Jc] [4h]
*** RIVER *** [Ts Qd Jc 4h] [6c]
*** SHOW DOWN ***
ZwvXzkkZ3XpMhKfAmVpahw: shows [As Qh] (a pair of Queens)
6UGgYbxwWNc+ohObe8vB9w: shows [Ah Ks] (a straight, Ten to Ace)
6UGgYbxwWNc+ohObe8vB9w collected $84 from pot
*** SUMMARY ***
Total pot $87 | Rake $3
Board [Ts Qd Jc 4h 6c]
Seat 1: ZwvXzkkZ3XpMhKfAmVpahw (small blind) showed [As Qh] and lost with a pair of Queens
Seat 2: 6UGgYbxwWNc+ohObe8vB9w (big blind) showed [Ah Ks] and won ($84) with a straight, Ten to Ace
Seat 3: 8rZGabKe2DEPdZCbCivZ9Q folded before Flop
Seat 4: /PH6Ffnho4Ysm8S3V/oa+w folded before Flop (didn't bet)
Seat 5: vkfxu8f/jMYKUk6Ly4eujw folded before Flop (didn't bet)
Seat 6: VvdR9F3I+2yELkfTVvC1dg (button) folded before Flop (didn't bet)



PokerStars Game #59941984004:  Hold'em No Limit ($1/$2) - 2009/07/01 1:52:23 ET
Table '5/wEe6JmtGD7vufSA2RG7A' 2-max Seat #1 is the button
Seat 1: pVqEzK9wXlRMECnb1Zg4Zw ($200 in chips)
Seat 2: aOL8geThaYp2iadSHl1h1g ($384 in chips)
pVqEzK9wXlRMECnb1Zg4Zw: posts small blind $1
aOL8geThaYp2iadSHl1h1g: posts big blind $2
*** HOLE CARDS ***
pVqEzK9wXlRMECnb1Zg4Zw: raises $6 to $8
aOL8geThaYp2iadSHl1h1g: folds
pVqEzK9wXlRMECnb1Zg4Zw collected $4 from pot
pVqEzK9wXlRMECnb1Zg4Zw: doesn't show hand
*** SUMMARY ***
Total pot $4 | Rake $0
Seat 1: pVqEzK9wXlRMECnb1Zg4Zw (button) (small blind) collected ($4)
Seat 2: aOL8geThaYp2iadSHl1h1g (big blind) folded before Flop



PokerStars Game #59941984384:  Hold'em No Limit ($1/$2) - 2009/07/01 1:52:24 ET
Table 'kq5zaQ+1hLNf8LZfGnbTAA' 6-max Seat #2 is the button
Seat 1: 8srN1dKQePlsv0GyTada+Q ($419.60 in chips)
Seat 2: nXDI8Y/S6POzRwANu3d8hQ ($137 in chips)
Seat 3: /PH6Ffnho4Ysm8S3V/oa+w ($53.15 in chips)
Seat 4: 3dAbvkxS5NPQTBAbvpinVg ($275.65 in chips)
/PH6Ffnho4Ysm8S3V/oa+w: posts small blind $1
3dAbvkxS5NPQTBAbvpinVg: posts big blind $2
*** HOLE CARDS ***
8srN1dKQePlsv0GyTada+Q: folds
nXDI8Y/S6POzRwANu3d8hQ: raises $6 to $8
/PH6Ffnho4Ysm8S3V/oa+w: folds
3dAbvkxS5NPQTBAbvpinVg: folds
nXDI8Y/S6POzRwANu3d8hQ collected $5 from pot
nXDI8Y/S6POzRwANu3d8hQ: doesn't show hand
*** SUMMARY ***
Total pot $5 | Rake $0
Seat 1: 8srN1dKQePlsv0GyTada+Q folded before Flop (didn't bet)
Seat 2: nXDI8Y/S6POzRwANu3d8hQ (button) collected ($5)
Seat 3: /PH6Ffnho4Ysm8S3V/oa+w (small blind) folded before Flop
Seat 4: 3dAbvkxS5NPQTBAbvpinVg (big blind) folded before Flop



PokerStars Game #59941984968:  Hold'em No Limit ($1/$2) - 2009/07/01 1:52:25 ET
Table 'CFkQcfWjKccZaZDf71FK+w' 6-max Seat #6 is the button
Seat 1: vkfxu8f/jMYKUk6Ly4eujw ($226.05 in chips)
Seat 2: ewN/vzF22+/gdzjIKBOlkA ($218.90 in chips)
Seat 5: 2lOU1DcvUZaMcxZ95XfzXw ($130.85 in chips)
Seat 6: ORVqY3rf9X6ANA/8s+On2Q ($30.35 in chips)
vkfxu8f/jMYKUk6Ly4eujw: posts small blind $1
ewN/vzF22+/gdzjIKBOlkA: posts big blind $2
opJMdoq0E6TRbAQiweyQuA: sits out
*** HOLE CARDS ***
2lOU1DcvUZaMcxZ95XfzXw: calls $2
ORVqY3rf9X6ANA/8s+On2Q: folds
vkfxu8f/jMYKUk6Ly4eujw: calls $1
ewN/vzF22+/gdzjIKBOlkA: raises $8 to $10
TMPDCBmlFGM9C+H58PC4sQ joins the table at seat #3
2lOU1DcvUZaMcxZ95XfzXw: calls $8
vkfxu8f/jMYKUk6Ly4eujw: folds
*** FLOP *** [5c 4h 3s]
ewN/vzF22+/gdzjIKBOlkA: bets $16
2lOU1DcvUZaMcxZ95XfzXw: folds
ewN/vzF22+/gdzjIKBOlkA collected $20.90 from pot
*** SUMMARY ***
Total pot $22 | Rake $1.10
Board [5c 4h 3s]
Seat 1: vkfxu8f/jMYKUk6Ly4eujw (small blind) folded before Flop
Seat 2: ewN/vzF22+/gdzjIKBOlkA (big blind) collected ($20.90)
Seat 5: 2lOU1DcvUZaMcxZ95XfzXw folded on the Flop
Seat 6: ORVqY3rf9X6ANA/8s+On2Q (button) folded before Flop (didn't bet)



PokerStars Game #59941987950:  Hold'em No Limit ($1/$2) - 2009/07/01 1:52:31 ET
Table '+hSnXFQrGw1PlVgTnuj+sA' 6-max Seat #1 is the button
Seat 1: fb8ooqw9ZsZtBsZTZQLNrQ ($50.70 in chips)
Seat 2: 54yWzRRgS0oZ+S6LwZBxMQ ($15.10 in chips)
Seat 3: cupOBdycmBLQKdVftyAksg ($49.10 in chips)
Seat 4: TRSUrOQh3x1NGeD+dH4yoA ($94.10 in chips)
Seat 5: PZzUwZiFNhCLi6Ouh5ZlmQ ($200 in chips)
Seat 6: 7zM38baFvmCNB/F80oE0cQ ($59.30 in chips)
54yWzRRgS0oZ+S6LwZBxMQ: posts small blind $1
cupOBdycmBLQKdVftyAksg: posts big blind $2
*** HOLE CARDS ***
TRSUrOQh3x1NGeD+dH4yoA: folds
PZzUwZiFNhCLi6Ouh5ZlmQ: folds
7zM38baFvmCNB/F80oE0cQ: calls $2
fb8ooqw9ZsZtBsZTZQLNrQ: folds
54yWzRRgS0oZ+S6LwZBxMQ: folds
cupOBdycmBLQKdVftyAksg: checks
*** FLOP *** [7h Jh As]
cupOBdycmBLQKdVftyAksg: bets $2
7zM38baFvmCNB/F80oE0cQ: calls $2
*** TURN *** [7h Jh As] [8d]
cupOBdycmBLQKdVftyAksg: checks
7zM38baFvmCNB/F80oE0cQ: bets $2
cupOBdycmBLQKdVftyAksg: calls $2
*** RIVER *** [7h Jh As 8d] [5h]
cupOBdycmBLQKdVftyAksg: checks
7zM38baFvmCNB/F80oE0cQ: bets $2
cupOBdycmBLQKdVftyAksg: calls $2
*** SHOW DOWN ***
7zM38baFvmCNB/F80oE0cQ: shows [8s 9s] (a pair of Eights)
cupOBdycmBLQKdVftyAksg: mucks hand
7zM38baFvmCNB/F80oE0cQ collected $16.20 from pot
*** SUMMARY ***
Total pot $17 | Rake $0.80
Board [7h Jh As 8d 5h]
Seat 1: fb8ooqw9ZsZtBsZTZQLNrQ (button) folded before Flop (didn't bet)
Seat 2: 54yWzRRgS0oZ+S6LwZBxMQ (small blind) folded before Flop
Seat 3: cupOBdycmBLQKdVftyAksg (big blind) mucked
Seat 4: TRSUrOQh3x1NGeD+dH4yoA folded before Flop (didn't bet)
Seat 5: PZzUwZiFNhCLi6Ouh5ZlmQ folded before Flop (didn't bet)
Seat 6: 7zM38baFvmCNB/F80oE0cQ showed [8s 9s] and won ($16.20) with a pair of Eights



PokerStars Game #59941988946:  Hold'em No Limit ($1/$2) - 2009/07/01 1:52:33 ET
Table 'P/yCfYl1GfGsu/e6DxDy/A' 2-max Seat #2 is the button
Seat 1: 7fOCUy3x9hdkmXkkDNolGQ ($1105 in chips)
Seat 2: RwDoM55ZeQuI2ADyJhOb2Q ($364.50 in chips)
RwDoM55ZeQuI2ADyJhOb2Q: posts small blind $1
7fOCUy3x9hdkmXkkDNolGQ: posts big blind $2
*** HOLE CARDS ***
RwDoM55ZeQuI2ADyJhOb2Q: raises $4 to $6
7fOCUy3x9hdkmXkkDNolGQ: calls $4
*** FLOP *** [Kh 7d 4s]
7fOCUy3x9hdkmXkkDNolGQ: checks
RwDoM55ZeQuI2ADyJhOb2Q: bets $8
7fOCUy3x9hdkmXkkDNolGQ: raises $14 to $22
RwDoM55ZeQuI2ADyJhOb2Q: folds
7fOCUy3x9hdkmXkkDNolGQ collected $27.50 from pot
7fOCUy3x9hdkmXkkDNolGQ: doesn't show hand
*** SUMMARY ***
Total pot $28 | Rake $0.50
Board [Kh 7d 4s]
Seat 1: 7fOCUy3x9hdkmXkkDNolGQ (big blind) collected ($27.50)
Seat 2: RwDoM55ZeQuI2ADyJhOb2Q (button) (small blind) folded on the Flop



PokerStars Game #59941990572:  Hold'em No Limit ($1/$2) - 2009/07/01 1:52:36 ET
Table '5/wEe6JmtGD7vufSA2RG7A' 2-max Seat #2 is the button
Seat 1: pVqEzK9wXlRMECnb1Zg4Zw ($202 in chips)
Seat 2: aOL8geThaYp2iadSHl1h1g ($382 in chips)
aOL8geThaYp2iadSHl1h1g: posts small blind $1
pVqEzK9wXlRMECnb1Zg4Zw: posts big blind $2
*** HOLE CARDS ***
aOL8geThaYp2iadSHl1h1g: raises $4 to $6
pVqEzK9wXlRMECnb1Zg4Zw: folds
aOL8geThaYp2iadSHl1h1g collected $4 from pot
*** SUMMARY ***
Total pot $4 | Rake $0
Seat 1: pVqEzK9wXlRMECnb1Zg4Zw (big blind) folded before Flop
Seat 2: aOL8geThaYp2iadSHl1h1g (button) (small blind) collected ($4)



PokerStars Game #59941991838:  Hold'em No Limit ($1/$2) - 2009/07/01 1:52:38 ET
Table 'NmY84NAf9Mh0ckAckHnh5g' 2-max Seat #2 is the button
Seat 1: 6hvg964TSqZ3AL/0XK9aVQ ($523.90 in chips)
Seat 2: RwDoM55ZeQuI2ADyJhOb2Q ($457.30 in chips)
RwDoM55ZeQuI2ADyJhOb2Q: posts small blind $1
6hvg964TSqZ3AL/0XK9aVQ: posts big blind $2
*** HOLE CARDS ***
RwDoM55ZeQuI2ADyJhOb2Q: raises $4 to $6
6hvg964TSqZ3AL/0XK9aVQ: calls $4
*** FLOP *** [7h 5c 9c]
6hvg964TSqZ3AL/0XK9aVQ: checks
RwDoM55ZeQuI2ADyJhOb2Q: checks
*** TURN *** [7h 5c 9c] [Jd]
6hvg964TSqZ3AL/0XK9aVQ: bets $8
RwDoM55ZeQuI2ADyJhOb2Q: folds
6hvg964TSqZ3AL/0XK9aVQ collected $11.50 from pot
6hvg964TSqZ3AL/0XK9aVQ: doesn't show hand
*** SUMMARY ***
Total pot $12 | Rake $0.50
Board [7h 5c 9c Jd]
Seat 1: 6hvg964TSqZ3AL/0XK9aVQ (big blind) collected ($11.50)
Seat 2: RwDoM55ZeQuI2ADyJhOb2Q (button) (small blind) folded on the Turn



PokerStars Game #59941992028:  Hold'em No Limit ($1/$2) - 2009/07/01 1:52:38 ET
Table 'aSf77Sj8QEnzcc0WaxVD4Q' 6-max Seat #5 is the button
Seat 1: UELtvp+JfwI7XDGVwSxZXA ($180.85 in chips)
Seat 2: vkfxu8f/jMYKUk6Ly4eujw ($200 in chips)
Seat 3: 9dpyyjDTCed6nV7JhaUUpw ($757.50 in chips)
Seat 4: YsLQ3BAvgQHWXMAv3Wv6Hg ($200 in chips)
Seat 5: VvdR9F3I+2yELkfTVvC1dg ($301.70 in chips)
Seat 6: vkoJRf3gidxY1pPi0AFWww ($163.25 in chips)
vkoJRf3gidxY1pPi0AFWww: posts small blind $1
UELtvp+JfwI7XDGVwSxZXA: posts big blind $2
*** HOLE CARDS ***
vkfxu8f/jMYKUk6Ly4eujw: folds
9dpyyjDTCed6nV7JhaUUpw: folds
YsLQ3BAvgQHWXMAv3Wv6Hg: folds
VvdR9F3I+2yELkfTVvC1dg: raises $2 to $4
vkoJRf3gidxY1pPi0AFWww: calls $3
UELtvp+JfwI7XDGVwSxZXA: calls $2
*** FLOP *** [3c Qd 3d]
vkoJRf3gidxY1pPi0AFWww: checks
UELtvp+JfwI7XDGVwSxZXA: checks
VvdR9F3I+2yELkfTVvC1dg: bets $8.55
vkoJRf3gidxY1pPi0AFWww: calls $8.55
UELtvp+JfwI7XDGVwSxZXA: folds
*** TURN *** [3c Qd 3d] [Ad]
vkoJRf3gidxY1pPi0AFWww: checks
VvdR9F3I+2yELkfTVvC1dg: checks
*** RIVER *** [3c Qd 3d Ad] [Ts]
vkoJRf3gidxY1pPi0AFWww: bets $16
VvdR9F3I+2yELkfTVvC1dg: folds
vkoJRf3gidxY1pPi0AFWww collected $27.70 from pot
vkoJRf3gidxY1pPi0AFWww: doesn't show hand
*** SUMMARY ***
Total pot $29.10 | Rake $1.40
Board [3c Qd 3d Ad Ts]
Seat 1: UELtvp+JfwI7XDGVwSxZXA (big blind) folded on the Flop
Seat 2: vkfxu8f/jMYKUk6Ly4eujw folded before Flop (didn't bet)
Seat 3: 9dpyyjDTCed6nV7JhaUUpw folded before Flop (didn't bet)
Seat 4: YsLQ3BAvgQHWXMAv3Wv6Hg folded before Flop (didn't bet)
Seat 5: VvdR9F3I+2yELkfTVvC1dg (button) folded on the River
Seat 6: vkoJRf3gidxY1pPi0AFWww (small blind) collected ($27.70)



PokerStars Game #59941991674:  Hold'em No Limit ($1/$2) - 2009/07/01 1:52:38 ET
Table 'gnHBqWll9O3fxG7Ojkz/ng' 9-max Seat #4 is the button
Seat 1: MtdNf9cdM7+0CSU0dx4USA ($77.35 in chips)
Seat 2: H6Z4+qu8gR0VUiPOijndVg ($335.30 in chips)
Seat 3: 5Q8U6iZbeO7xJSS4qvDP5g ($238.10 in chips)
Seat 4: nXDI8Y/S6POzRwANu3d8hQ ($13 in chips)
Seat 5: rBQDMkKm9cZn6M9NPsiVew ($167.15 in chips)
Seat 6: KqHysDSpCPaPyK3tJC1aEw ($200 in chips)
Seat 7: 254YPxPJr5Sw58bkD0YqYQ ($203 in chips)
Seat 8: cM6efHzdxoqYm0EQKP4TTQ ($110.95 in chips)
Seat 9: GX1heJ+DSsvm7gzSPsYhhQ ($46.15 in chips)
rBQDMkKm9cZn6M9NPsiVew: posts small blind $1
KqHysDSpCPaPyK3tJC1aEw: posts big blind $2
*** HOLE CARDS ***
254YPxPJr5Sw58bkD0YqYQ: folds
cM6efHzdxoqYm0EQKP4TTQ has timed out
cM6efHzdxoqYm0EQKP4TTQ: folds
cM6efHzdxoqYm0EQKP4TTQ is sitting out
cM6efHzdxoqYm0EQKP4TTQ has returned
GX1heJ+DSsvm7gzSPsYhhQ: raises $4 to $6
MtdNf9cdM7+0CSU0dx4USA: folds
H6Z4+qu8gR0VUiPOijndVg: folds
5Q8U6iZbeO7xJSS4qvDP5g: folds
nXDI8Y/S6POzRwANu3d8hQ: raises $7 to $13 and is all-in
rBQDMkKm9cZn6M9NPsiVew: folds
KqHysDSpCPaPyK3tJC1aEw: folds
GX1heJ+DSsvm7gzSPsYhhQ: calls $7
*** FLOP *** [Kc 8d 5s]
*** TURN *** [Kc 8d 5s] [7c]
*** RIVER *** [Kc 8d 5s 7c] [9c]
*** SHOW DOWN ***
GX1heJ+DSsvm7gzSPsYhhQ: shows [Jh Qh] (high card King)
nXDI8Y/S6POzRwANu3d8hQ: shows [Tc Td] (a pair of Tens)
nXDI8Y/S6POzRwANu3d8hQ collected $27.55 from pot
*** SUMMARY ***
Total pot $29 | Rake $1.45
Board [Kc 8d 5s 7c 9c]
Seat 1: MtdNf9cdM7+0CSU0dx4USA folded before Flop (didn't bet)
Seat 2: H6Z4+qu8gR0VUiPOijndVg folded before Flop (didn't bet)
Seat 3: 5Q8U6iZbeO7xJSS4qvDP5g folded before Flop (didn't bet)
Seat 4: nXDI8Y/S6POzRwANu3d8hQ (button) showed [Tc Td] and won ($27.55) with a pair of Tens
Seat 5: rBQDMkKm9cZn6M9NPsiVew (small blind) folded before Flop
Seat 6: KqHysDSpCPaPyK3tJC1aEw (big blind) folded before Flop
Seat 7: 254YPxPJr5Sw58bkD0YqYQ folded before Flop (didn't bet)
Seat 8: cM6efHzdxoqYm0EQKP4TTQ folded before Flop (didn't bet)
Seat 9: GX1heJ+DSsvm7gzSPsYhhQ showed [Jh Qh] and lost with high card King



PokerStars Game #59941992238:  Hold'em No Limit ($1/$2) - 2009/07/01 1:52:39 ET
Table 'BSRfGh+QobUe0AgIMtt/fw' 9-max Seat #7 is the button
Seat 1: gDn/rYeNwCyWEgRhyWp4PA ($159.05 in chips)
Seat 2: +SmnXtdmwqXGEJfLeJDIUQ ($126.90 in chips)
Seat 3: WUlHm+ydPPHG7Lb0rePSdA ($120 in chips)
Seat 4: +T/63sAeZzWyHchahJ36GQ ($31 in chips)
Seat 5: ThVDqrMpsvd7Ax6KINfuew ($64.50 in chips)
Seat 6: H6Z4+qu8gR0VUiPOijndVg ($202 in chips)
Seat 7: CkE3IyJF1KvdaAOmZY5XqQ ($202 in chips)
Seat 8: GG5lTuGt3+kwNYSbqeB6yw ($76.85 in chips)
Seat 9: tjgwwDmi+N2H4I7hx8useQ ($81 in chips)
GG5lTuGt3+kwNYSbqeB6yw: posts small blind $1
tjgwwDmi+N2H4I7hx8useQ: posts big blind $2
*** HOLE CARDS ***
gDn/rYeNwCyWEgRhyWp4PA: folds
+SmnXtdmwqXGEJfLeJDIUQ: calls $2
WUlHm+ydPPHG7Lb0rePSdA: calls $2
+T/63sAeZzWyHchahJ36GQ: folds
ThVDqrMpsvd7Ax6KINfuew: folds
H6Z4+qu8gR0VUiPOijndVg: folds
CkE3IyJF1KvdaAOmZY5XqQ: folds
GG5lTuGt3+kwNYSbqeB6yw: calls $1
tjgwwDmi+N2H4I7hx8useQ: checks
*** FLOP *** [5d 2h 9s]
GG5lTuGt3+kwNYSbqeB6yw: checks
tjgwwDmi+N2H4I7hx8useQ: checks
+SmnXtdmwqXGEJfLeJDIUQ: checks
WUlHm+ydPPHG7Lb0rePSdA: checks
*** TURN *** [5d 2h 9s] [5h]
GG5lTuGt3+kwNYSbqeB6yw: checks
tjgwwDmi+N2H4I7hx8useQ: checks
+SmnXtdmwqXGEJfLeJDIUQ: checks
WUlHm+ydPPHG7Lb0rePSdA: checks
*** RIVER *** [5d 2h 9s 5h] [Ts]
GG5lTuGt3+kwNYSbqeB6yw: checks
tjgwwDmi+N2H4I7hx8useQ: checks
+SmnXtdmwqXGEJfLeJDIUQ: checks
WUlHm+ydPPHG7Lb0rePSdA: checks
*** SHOW DOWN ***
GG5lTuGt3+kwNYSbqeB6yw: shows [7d Jd] (a pair of Fives)
tjgwwDmi+N2H4I7hx8useQ: mucks hand
+SmnXtdmwqXGEJfLeJDIUQ: shows [Kh Qh] (a pair of Fives - King kicker)
WUlHm+ydPPHG7Lb0rePSdA: mucks hand
+SmnXtdmwqXGEJfLeJDIUQ collected $7.60 from pot
*** SUMMARY ***
Total pot $8 | Rake $0.40
Board [5d 2h 9s 5h Ts]
Seat 1: gDn/rYeNwCyWEgRhyWp4PA folded before Flop (didn't bet)
Seat 2: +SmnXtdmwqXGEJfLeJDIUQ showed [Kh Qh] and won ($7.60) with a pair of Fives
Seat 3: WUlHm+ydPPHG7Lb0rePSdA mucked
Seat 4: +T/63sAeZzWyHchahJ36GQ folded before Flop (didn't bet)
Seat 5: ThVDqrMpsvd7Ax6KINfuew folded before Flop (didn't bet)
Seat 6: H6Z4+qu8gR0VUiPOijndVg folded before Flop (didn't bet)
Seat 7: CkE3IyJF1KvdaAOmZY5XqQ (button) folded before Flop (didn't bet)
Seat 8: GG5lTuGt3+kwNYSbqeB6yw (small blind) showed [7d Jd] and lost with a pair of Fives
Seat 9: tjgwwDmi+N2H4I7hx8useQ (big blind) mucked



PokerStars Game #59941992278:  Hold'em No Limit ($1/$2) - 2009/07/01 1:52:39 ET
Table 'o63a8j70meKHUtgLFryQvg' 9-max Seat #5 is the button
Seat 1: +1R0op5O3Gf6aUPJTw7jjA ($197 in chips)
Seat 2: SgA0Zfa/3yhNp7ILXcXcCg ($68.15 in chips)
Seat 3: IYBKVnE2Basnr88BAhH+bQ ($265.40 in chips)
Seat 4: ZYHoLw2lWmRS7CSHi8L8Xg ($206.90 in chips)
Seat 5: g3ZVTc1EbSNXYYMO82jL7Q ($223.30 in chips)
Seat 6: CUZwDpLTQKhzarPe+JCLOQ ($200 in chips)
Seat 7: kM9CA+2UcdMjbCMbtUCGiA ($200 in chips)
Seat 8: ItDFe9gh5QYPQB9vC4ntUA ($342.05 in chips)
CUZwDpLTQKhzarPe+JCLOQ: posts small blind $1
kM9CA+2UcdMjbCMbtUCGiA: posts big blind $2
TAfo4veNRaRlzDXMMYS3Jg: sits out
*** HOLE CARDS ***
ItDFe9gh5QYPQB9vC4ntUA: folds
+1R0op5O3Gf6aUPJTw7jjA: folds
SgA0Zfa/3yhNp7ILXcXcCg: folds
IYBKVnE2Basnr88BAhH+bQ: folds
ZYHoLw2lWmRS7CSHi8L8Xg: raises $4 to $6
g3ZVTc1EbSNXYYMO82jL7Q: folds
CUZwDpLTQKhzarPe+JCLOQ: folds
kM9CA+2UcdMjbCMbtUCGiA: folds
ZYHoLw2lWmRS7CSHi8L8Xg collected $5 from pot
*** SUMMARY ***
Total pot $5 | Rake $0
Seat 1: +1R0op5O3Gf6aUPJTw7jjA folded before Flop (didn't bet)
Seat 2: SgA0Zfa/3yhNp7ILXcXcCg folded before Flop (didn't bet)
Seat 3: IYBKVnE2Basnr88BAhH+bQ folded before Flop (didn't bet)
Seat 4: ZYHoLw2lWmRS7CSHi8L8Xg collected ($5)
Seat 5: g3ZVTc1EbSNXYYMO82jL7Q (button) folded before Flop (didn't bet)
Seat 6: CUZwDpLTQKhzarPe+JCLOQ (small blind) folded before Flop
Seat 7: kM9CA+2UcdMjbCMbtUCGiA (big blind) folded before Flop
Seat 8: ItDFe9gh5QYPQB9vC4ntUA folded before Flop (didn't bet)



PokerStars Game #59941992752:  Hold'em No Limit ($1/$2) - 2009/07/01 1:52:40 ET
Table '4NGNnZ/osQfNq6abYqkJeA' 6-max Seat #2 is the button
Seat 2: 669iGNwYwgRZg3nhS+aDAQ ($107.75 in chips)
Seat 3: 54yWzRRgS0oZ+S6LwZBxMQ ($74.35 in chips)
Seat 4: sY+4Uuh5z/6AbXXaCS10jw ($306.10 in chips)
Seat 5: VvdR9F3I+2yELkfTVvC1dg ($211.80 in chips)
Seat 6: /PH6Ffnho4Ysm8S3V/oa+w ($40 in chips)
54yWzRRgS0oZ+S6LwZBxMQ: posts small blind $1
sY+4Uuh5z/6AbXXaCS10jw: posts big blind $2
*** HOLE CARDS ***
0Bc+WhbOvaaWIMmmui3q0g joins the table at seat #1
VvdR9F3I+2yELkfTVvC1dg: folds
/PH6Ffnho4Ysm8S3V/oa+w: raises $2 to $4
669iGNwYwgRZg3nhS+aDAQ: folds
54yWzRRgS0oZ+S6LwZBxMQ: folds
sY+4Uuh5z/6AbXXaCS10jw: calls $2
*** FLOP *** [Ks 5c 8s]
sY+4Uuh5z/6AbXXaCS10jw: checks
/PH6Ffnho4Ysm8S3V/oa+w: bets $4
sY+4Uuh5z/6AbXXaCS10jw: calls $4
*** TURN *** [Ks 5c 8s] [3d]
sY+4Uuh5z/6AbXXaCS10jw: checks
/PH6Ffnho4Ysm8S3V/oa+w: checks
*** RIVER *** [Ks 5c 8s 3d] [2h]
sY+4Uuh5z/6AbXXaCS10jw: checks
/PH6Ffnho4Ysm8S3V/oa+w: bets $8
sY+4Uuh5z/6AbXXaCS10jw: folds
/PH6Ffnho4Ysm8S3V/oa+w collected $16.20 from pot
/PH6Ffnho4Ysm8S3V/oa+w: doesn't show hand
*** SUMMARY ***
Total pot $17 | Rake $0.80
Board [Ks 5c 8s 3d 2h]
Seat 2: 669iGNwYwgRZg3nhS+aDAQ (button) folded before Flop (didn't bet)
Seat 3: 54yWzRRgS0oZ+S6LwZBxMQ (small blind) folded before Flop
Seat 4: sY+4Uuh5z/6AbXXaCS10jw (big blind) folded on the River
Seat 5: VvdR9F3I+2yELkfTVvC1dg folded before Flop (didn't bet)
Seat 6: /PH6Ffnho4Ysm8S3V/oa+w collected ($16.20)



PokerStars Game #59941992970:  Hold'em No Limit ($1/$2) - 2009/07/01 1:52:40 ET
Table 'kq5zaQ+1hLNf8LZfGnbTAA' 6-max Seat #3 is the button
Seat 1: 8srN1dKQePlsv0GyTada+Q ($419.60 in chips)
Seat 2: nXDI8Y/S6POzRwANu3d8hQ ($140 in chips)
Seat 3: /PH6Ffnho4Ysm8S3V/oa+w ($52.15 in chips)
Seat 4: 3dAbvkxS5NPQTBAbvpinVg ($273.65 in chips)
3dAbvkxS5NPQTBAbvpinVg: posts small blind $1
8srN1dKQePlsv0GyTada+Q: posts big blind $2
*** HOLE CARDS ***
nXDI8Y/S6POzRwANu3d8hQ: folds
nXDI8Y/S6POzRwANu3d8hQ leaves the table
/PH6Ffnho4Ysm8S3V/oa+w: folds
3dAbvkxS5NPQTBAbvpinVg: folds
8srN1dKQePlsv0GyTada+Q collected $2 from pot
8srN1dKQePlsv0GyTada+Q: doesn't show hand
*** SUMMARY ***
Total pot $2 | Rake $0
Seat 1: 8srN1dKQePlsv0GyTada+Q (big blind) collected ($2)
Seat 2: nXDI8Y/S6POzRwANu3d8hQ folded before Flop (didn't bet)
Seat 3: /PH6Ffnho4Ysm8S3V/oa+w (button) folded before Flop (didn't bet)
Seat 4: 3dAbvkxS5NPQTBAbvpinVg (small blind) folded before Flop



PokerStars Game #59941993116:  Hold'em No Limit ($1/$2) - 2009/07/01 1:52:41 ET
Table 'uJ9juaXXg9yIcSU8amxaXQ' 6-max Seat #4 is the button
Seat 1: JsqOjN/eHz0uYVf/PyUJ6Q ($119.95 in chips)
Seat 2: VvdR9F3I+2yELkfTVvC1dg ($217.45 in chips)
Seat 3: qXDd0ZyMIse0OBu8pxeQ3Q ($239.40 in chips)
Seat 4: zNjJ/y4emmF+vzrCDd+ooA ($267.55 in chips)
Seat 5: YsLQ3BAvgQHWXMAv3Wv6Hg ($211.70 in chips)
Seat 6: /PH6Ffnho4Ysm8S3V/oa+w ($43 in chips)
YsLQ3BAvgQHWXMAv3Wv6Hg: posts small blind $1
/PH6Ffnho4Ysm8S3V/oa+w: posts big blind $2
*** HOLE CARDS ***
JsqOjN/eHz0uYVf/PyUJ6Q: folds
VvdR9F3I+2yELkfTVvC1dg: folds
qXDd0ZyMIse0OBu8pxeQ3Q: folds
zNjJ/y4emmF+vzrCDd+ooA: folds
YsLQ3BAvgQHWXMAv3Wv6Hg: raises $4 to $6
/PH6Ffnho4Ysm8S3V/oa+w: folds
YsLQ3BAvgQHWXMAv3Wv6Hg collected $4 from pot
YsLQ3BAvgQHWXMAv3Wv6Hg: doesn't show hand
*** SUMMARY ***
Total pot $4 | Rake $0
Seat 1: JsqOjN/eHz0uYVf/PyUJ6Q folded before Flop (didn't bet)
Seat 2: VvdR9F3I+2yELkfTVvC1dg folded before Flop (didn't bet)
Seat 3: qXDd0ZyMIse0OBu8pxeQ3Q folded before Flop (didn't bet)
Seat 4: zNjJ/y4emmF+vzrCDd+ooA (button) folded before Flop (didn't bet)
Seat 5: YsLQ3BAvgQHWXMAv3Wv6Hg (small blind) collected ($4)
Seat 6: /PH6Ffnho4Ysm8S3V/oa+w (big blind) folded before Flop



PokerStars Game #59941993552:  Hold'em No Limit ($1/$2) - 2009/07/01 1:52:41 ET
Table 'WCA60bDA8ecovUgFSIZkTQ' 9-max Seat #3 is the button
Seat 1: 3RFwE6igZ1BGKOGuab6iiw ($55.70 in chips)
Seat 2: TAfo4veNRaRlzDXMMYS3Jg ($37 in chips)
Seat 3: g7gL2NLJCdZPPV399WKT1w ($47.65 in chips)
Seat 4: IYBKVnE2Basnr88BAhH+bQ ($203.80 in chips)
Seat 5: A+9gcmwAl0eFxxbAwRY1OA ($267.10 in chips)
Seat 7: tsTv4D+ne2W0qhUt9HlcMw ($193 in chips)
Seat 8: mJhwEVg7F695DiO+RIhM5g ($257.45 in chips)
Seat 9: ItDFe9gh5QYPQB9vC4ntUA ($200 in chips)
IYBKVnE2Basnr88BAhH+bQ: posts small blind $1
A+9gcmwAl0eFxxbAwRY1OA: posts big blind $2
YoKKKdDDs7gFzP1Z65Sdaw: sits out
*** HOLE CARDS ***
tsTv4D+ne2W0qhUt9HlcMw: folds
mJhwEVg7F695DiO+RIhM5g: folds
ItDFe9gh5QYPQB9vC4ntUA: folds
3RFwE6igZ1BGKOGuab6iiw: folds
TAfo4veNRaRlzDXMMYS3Jg: folds
g7gL2NLJCdZPPV399WKT1w: folds
IYBKVnE2Basnr88BAhH+bQ: folds
A+9gcmwAl0eFxxbAwRY1OA collected $2 from pot
A+9gcmwAl0eFxxbAwRY1OA: doesn't show hand
*** SUMMARY ***
Total pot $2 | Rake $0
Seat 1: 3RFwE6igZ1BGKOGuab6iiw folded before Flop (didn't bet)
Seat 2: TAfo4veNRaRlzDXMMYS3Jg folded before Flop (didn't bet)
Seat 3: g7gL2NLJCdZPPV399WKT1w (button) folded before Flop (didn't bet)
Seat 4: IYBKVnE2Basnr88BAhH+bQ (small blind) folded before Flop
Seat 5: A+9gcmwAl0eFxxbAwRY1OA (big blind) collected ($2)
Seat 7: tsTv4D+ne2W0qhUt9HlcMw folded before Flop (didn't bet)
Seat 8: mJhwEVg7F695DiO+RIhM5g folded before Flop (didn't bet)
Seat 9: ItDFe9gh5QYPQB9vC4ntUA folded before Flop (didn't bet)



PokerStars Game #59941994770:  Hold'em No Limit ($1/$2) - 2009/07/01 1:52:44 ET
Table 'C4lkCXY2PWy6z4vsAe5NGQ' 6-max Seat #5 is the button
Seat 1: bWbV4MVB/vVpiES1Ut4hew ($200 in chips)
Seat 2: 6hRJ68JkbJq6MYI9o5bUnQ ($56.95 in chips)
Seat 3: sTPOWERd9HWPCNrDBwsVjA ($135.50 in chips)
Seat 4: VvdR9F3I+2yELkfTVvC1dg ($204 in chips)
Seat 5: /PH6Ffnho4Ysm8S3V/oa+w ($53.15 in chips)
Seat 6: B87ikIyZ/TzAVeXf38Ny0g ($727.50 in chips)
B87ikIyZ/TzAVeXf38Ny0g: posts small blind $1
bWbV4MVB/vVpiES1Ut4hew: posts big blind $2
*** HOLE CARDS ***
6hRJ68JkbJq6MYI9o5bUnQ: folds
sTPOWERd9HWPCNrDBwsVjA: folds
VvdR9F3I+2yELkfTVvC1dg: folds
/PH6Ffnho4Ysm8S3V/oa+w: raises $2 to $4
B87ikIyZ/TzAVeXf38Ny0g: calls $3
bWbV4MVB/vVpiES1Ut4hew: folds
*** FLOP *** [9s Kc 2h]
B87ikIyZ/TzAVeXf38Ny0g: checks
/PH6Ffnho4Ysm8S3V/oa+w: bets $5
B87ikIyZ/TzAVeXf38Ny0g: folds
/PH6Ffnho4Ysm8S3V/oa+w collected $9.50 from pot
/PH6Ffnho4Ysm8S3V/oa+w: doesn't show hand
*** SUMMARY ***
Total pot $10 | Rake $0.50
Board [9s Kc 2h]
Seat 1: bWbV4MVB/vVpiES1Ut4hew (big blind) folded before Flop
Seat 2: 6hRJ68JkbJq6MYI9o5bUnQ folded before Flop (didn't bet)
Seat 3: sTPOWERd9HWPCNrDBwsVjA folded before Flop (didn't bet)
Seat 4: VvdR9F3I+2yELkfTVvC1dg folded before Flop (didn't bet)
Seat 5: /PH6Ffnho4Ysm8S3V/oa+w (button) collected ($9.50)
Seat 6: B87ikIyZ/TzAVeXf38Ny0g (small blind) folded on the Flop



PokerStars Game #59941995870:  Hold'em No Limit ($1/$2) - 2009/07/01 1:52:46 ET
Table 'ztv6V3FN2bQ9nmJPPdx6nQ' 6-max Seat #5 is the button
Seat 1: 6fLdOUCRtX71xbVRhJEq8w ($281.35 in chips)
Seat 2: 5Y+ZGWLI4gnlpApDX5vy1A ($374.05 in chips)
Seat 4: UaZ5yj+6LjtWqMQg2QskUw ($89.85 in chips)
Seat 5: sTPOWERd9HWPCNrDBwsVjA ($213.60 in chips)
Seat 6: mfy7uGZcqA2PVQqEVbJ7+g ($198 in chips)
mfy7uGZcqA2PVQqEVbJ7+g: posts small blind $1
6fLdOUCRtX71xbVRhJEq8w: posts big blind $2
*** HOLE CARDS ***
5Y+ZGWLI4gnlpApDX5vy1A: folds
UaZ5yj+6LjtWqMQg2QskUw: folds
sTPOWERd9HWPCNrDBwsVjA: folds
mfy7uGZcqA2PVQqEVbJ7+g: folds
6fLdOUCRtX71xbVRhJEq8w collected $2 from pot
*** SUMMARY ***
Total pot $2 | Rake $0
Seat 1: 6fLdOUCRtX71xbVRhJEq8w (big blind) collected ($2)
Seat 2: 5Y+ZGWLI4gnlpApDX5vy1A folded before Flop (didn't bet)
Seat 4: UaZ5yj+6LjtWqMQg2QskUw folded before Flop (didn't bet)
Seat 5: sTPOWERd9HWPCNrDBwsVjA (button) folded before Flop (didn't bet)
Seat 6: mfy7uGZcqA2PVQqEVbJ7+g (small blind) folded before Flop



PokerStars Game #59941997062:  Hold'em No Limit ($1/$2) - 2009/07/01 1:52:48 ET
Table 'mGpP9StWRnoeiBDExc6Frg' 6-max Seat #3 is the button
Seat 1: VvdR9F3I+2yELkfTVvC1dg ($316.40 in chips)
Seat 2: 6hRJ68JkbJq6MYI9o5bUnQ ($103 in chips)
Seat 3: mddoKnqZkdOH7AJOJ/i0DA ($200 in chips)
Seat 4: 4dcDwIHRm96PwtqkpQiuiA ($85.70 in chips)
Seat 5: d1puGuVBE0fidn+5eRJ0tw ($193.35 in chips)
Seat 6: B2Ih1sr5VZk+8He7rcrMtQ ($402.45 in chips)
4dcDwIHRm96PwtqkpQiuiA: posts small blind $1
d1puGuVBE0fidn+5eRJ0tw: posts big blind $2
*** HOLE CARDS ***
B2Ih1sr5VZk+8He7rcrMtQ: folds
VvdR9F3I+2yELkfTVvC1dg: folds
6hRJ68JkbJq6MYI9o5bUnQ: folds
mddoKnqZkdOH7AJOJ/i0DA: raises $4 to $6
4dcDwIHRm96PwtqkpQiuiA: folds
d1puGuVBE0fidn+5eRJ0tw: folds
mddoKnqZkdOH7AJOJ/i0DA collected $5 from pot
*** SUMMARY ***
Total pot $5 | Rake $0
Seat 1: VvdR9F3I+2yELkfTVvC1dg folded before Flop (didn't bet)
Seat 2: 6hRJ68JkbJq6MYI9o5bUnQ folded before Flop (didn't bet)
Seat 3: mddoKnqZkdOH7AJOJ/i0DA (button) collected ($5)
Seat 4: 4dcDwIHRm96PwtqkpQiuiA (small blind) folded before Flop
Seat 5: d1puGuVBE0fidn+5eRJ0tw (big blind) folded before Flop
Seat 6: B2Ih1sr5VZk+8He7rcrMtQ folded before Flop (didn't bet)



PokerStars Game #59941997218:  Hold'em No Limit ($1/$2) - 2009/07/01 1:52:48 ET
Table '5/wEe6JmtGD7vufSA2RG7A' 2-max Seat #1 is the button
Seat 1: pVqEzK9wXlRMECnb1Zg4Zw ($200 in chips)
Seat 2: aOL8geThaYp2iadSHl1h1g ($384 in chips)
pVqEzK9wXlRMECnb1Zg4Zw: posts small blind $1
aOL8geThaYp2iadSHl1h1g: posts big blind $2
*** HOLE CARDS ***
pVqEzK9wXlRMECnb1Zg4Zw: calls $1
aOL8geThaYp2iadSHl1h1g: checks
*** FLOP *** [Jc 3d Ts]
aOL8geThaYp2iadSHl1h1g: checks
pVqEzK9wXlRMECnb1Zg4Zw: bets $6
aOL8geThaYp2iadSHl1h1g: folds
pVqEzK9wXlRMECnb1Zg4Zw collected $3.80 from pot
pVqEzK9wXlRMECnb1Zg4Zw: doesn't show hand
*** SUMMARY ***
Total pot $4 | Rake $0.20
Board [Jc 3d Ts]
Seat 1: pVqEzK9wXlRMECnb1Zg4Zw (button) (small blind) collected ($3.80)
Seat 2: aOL8geThaYp2iadSHl1h1g (big blind) folded on the Flop



PokerStars Game #59941998892:  Hold'em No Limit ($1/$2) - 2009/07/01 1:52:52 ET
Table 'UGLAZZyv+cXmnKjYin0etA' 6-max Seat #5 is the button
Seat 1: rL+Zpv4/vX2BVHcyfh/NXA ($200 in chips)
Seat 2: eDLH1PUXFpvJBNMXBVQcGA ($297.10 in chips)
Seat 4: SiGJDsvRViJX05vHhA80GQ ($249.75 in chips)
Seat 5: 54yWzRRgS0oZ+S6LwZBxMQ ($34.80 in chips)
Seat 6: sTPOWERd9HWPCNrDBwsVjA ($212.95 in chips)
sTPOWERd9HWPCNrDBwsVjA: posts small blind $1
rL+Zpv4/vX2BVHcyfh/NXA: posts big blind $2
*** HOLE CARDS ***
eDLH1PUXFpvJBNMXBVQcGA: folds
SiGJDsvRViJX05vHhA80GQ: folds
54yWzRRgS0oZ+S6LwZBxMQ: folds
Nsjun4mjI8q0SSBTIp1dIQ has returned
sTPOWERd9HWPCNrDBwsVjA: folds
rL+Zpv4/vX2BVHcyfh/NXA collected $2 from pot
*** SUMMARY ***
Total pot $2 | Rake $0
Seat 1: rL+Zpv4/vX2BVHcyfh/NXA (big blind) collected ($2)
Seat 2: eDLH1PUXFpvJBNMXBVQcGA folded before Flop (didn't bet)
Seat 4: SiGJDsvRViJX05vHhA80GQ folded before Flop (didn't bet)
Seat 5: 54yWzRRgS0oZ+S6LwZBxMQ (button) folded before Flop (didn't bet)
Seat 6: sTPOWERd9HWPCNrDBwsVjA (small blind) folded before Flop



PokerStars Game #59941999304:  Hold'em No Limit ($1/$2) - 2009/07/01 1:52:53 ET
Table 'pPQgcj9XT9CHBsbo1WTBug' 6-max Seat #5 is the button
Seat 1: DFVYDA6dKQy7R7mGIKogZA ($150.65 in chips)
Seat 2: qXDd0ZyMIse0OBu8pxeQ3Q ($200 in chips)
Seat 3: sSAA879uXOGR+8Mf3zLa6Q ($134.90 in chips)
Seat 4: cwfuMyvDC7J7SqX2leDC8g ($52.20 in chips)
Seat 5: vkfxu8f/jMYKUk6Ly4eujw ($123.60 in chips)
Seat 6: Yr7pZltpy3IUNdKS9PCEiw ($306.80 in chips)
Yr7pZltpy3IUNdKS9PCEiw: posts small blind $1
DFVYDA6dKQy7R7mGIKogZA: posts big blind $2
*** HOLE CARDS ***
qXDd0ZyMIse0OBu8pxeQ3Q: folds
sSAA879uXOGR+8Mf3zLa6Q: folds
cwfuMyvDC7J7SqX2leDC8g: folds
vkfxu8f/jMYKUk6Ly4eujw: folds
Yr7pZltpy3IUNdKS9PCEiw: calls $1
DFVYDA6dKQy7R7mGIKogZA: checks
*** FLOP *** [Qs 8c 5s]
Yr7pZltpy3IUNdKS9PCEiw: checks
DFVYDA6dKQy7R7mGIKogZA: bets $2
Yr7pZltpy3IUNdKS9PCEiw: folds
DFVYDA6dKQy7R7mGIKogZA collected $3.80 from pot
*** SUMMARY ***
Total pot $4 | Rake $0.20
Board [Qs 8c 5s]
Seat 1: DFVYDA6dKQy7R7mGIKogZA (big blind) collected ($3.80)
Seat 2: qXDd0ZyMIse0OBu8pxeQ3Q folded before Flop (didn't bet)
Seat 3: sSAA879uXOGR+8Mf3zLa6Q folded before Flop (didn't bet)
Seat 4: cwfuMyvDC7J7SqX2leDC8g folded before Flop (didn't bet)
Seat 5: vkfxu8f/jMYKUk6Ly4eujw (button) folded before Flop (didn't bet)
Seat 6: Yr7pZltpy3IUNdKS9PCEiw (small blind) folded on the Flop



PokerStars Game #59941999734:  Hold'em No Limit ($1/$2) - 2009/07/01 1:52:53 ET
Table 'rsKRKlGHlxVyqJxzO2a2Ow' 9-max Seat #8 is the button
Seat 1: KqHysDSpCPaPyK3tJC1aEw ($212.30 in chips)
Seat 2: +T/63sAeZzWyHchahJ36GQ ($86 in chips)
Seat 3: kM9CA+2UcdMjbCMbtUCGiA ($228.10 in chips)
Seat 4: 31HuO+DQxppUQEedBWukug ($108.85 in chips)
Seat 5: 5Q8U6iZbeO7xJSS4qvDP5g ($245.30 in chips)
Seat 6: H6Z4+qu8gR0VUiPOijndVg ($203 in chips)
Seat 7: GX1heJ+DSsvm7gzSPsYhhQ ($53 in chips)
Seat 8: CkE3IyJF1KvdaAOmZY5XqQ ($206.70 in chips)
Seat 9: gRbvhSUVg+TNaTjaJecIRw ($48.60 in chips)
gRbvhSUVg+TNaTjaJecIRw: posts small blind $1
KqHysDSpCPaPyK3tJC1aEw: posts big blind $2
*** HOLE CARDS ***
+T/63sAeZzWyHchahJ36GQ: raises $4 to $6
kM9CA+2UcdMjbCMbtUCGiA: folds
31HuO+DQxppUQEedBWukug: folds
5Q8U6iZbeO7xJSS4qvDP5g: calls $6
H6Z4+qu8gR0VUiPOijndVg: folds
GX1heJ+DSsvm7gzSPsYhhQ: folds
CkE3IyJF1KvdaAOmZY5XqQ: folds
gRbvhSUVg+TNaTjaJecIRw: folds
KqHysDSpCPaPyK3tJC1aEw: folds
*** FLOP *** [8c Ah 4s]
+T/63sAeZzWyHchahJ36GQ: checks
5Q8U6iZbeO7xJSS4qvDP5g: checks
*** TURN *** [8c Ah 4s] [Jh]
+T/63sAeZzWyHchahJ36GQ: checks
5Q8U6iZbeO7xJSS4qvDP5g: checks
*** RIVER *** [8c Ah 4s Jh] [2s]
+T/63sAeZzWyHchahJ36GQ: checks
5Q8U6iZbeO7xJSS4qvDP5g: checks
*** SHOW DOWN ***
+T/63sAeZzWyHchahJ36GQ: shows [Ts 9s] (high card Ace)
5Q8U6iZbeO7xJSS4qvDP5g: shows [9c 9h] (a pair of Nines)
5Q8U6iZbeO7xJSS4qvDP5g collected $14.25 from pot
*** SUMMARY ***
Total pot $15 | Rake $0.75
Board [8c Ah 4s Jh 2s]
Seat 1: KqHysDSpCPaPyK3tJC1aEw (big blind) folded before Flop
Seat 2: +T/63sAeZzWyHchahJ36GQ showed [Ts 9s] and lost with high card Ace
Seat 3: kM9CA+2UcdMjbCMbtUCGiA folded before Flop (didn't bet)
Seat 4: 31HuO+DQxppUQEedBWukug folded before Flop (didn't bet)
Seat 5: 5Q8U6iZbeO7xJSS4qvDP5g showed [9c 9h] and won ($14.25) with a pair of Nines
Seat 6: H6Z4+qu8gR0VUiPOijndVg folded before Flop (didn't bet)
Seat 7: GX1heJ+DSsvm7gzSPsYhhQ folded before Flop (didn't bet)
Seat 8: CkE3IyJF1KvdaAOmZY5XqQ (button) folded before Flop (didn't bet)
Seat 9: gRbvhSUVg+TNaTjaJecIRw (small blind) folded before Flop



PokerStars Game #59942000682:  Hold'em No Limit ($1/$2) - 2009/07/01 1:52:55 ET
Table 'P/yCfYl1GfGsu/e6DxDy/A' 2-max Seat #1 is the button
Seat 1: 7fOCUy3x9hdkmXkkDNolGQ ($1118.50 in chips)
Seat 2: RwDoM55ZeQuI2ADyJhOb2Q ($350.50 in chips)
7fOCUy3x9hdkmXkkDNolGQ: posts small blind $1
RwDoM55ZeQuI2ADyJhOb2Q: posts big blind $2
*** HOLE CARDS ***
7fOCUy3x9hdkmXkkDNolGQ: raises $4 to $6
RwDoM55ZeQuI2ADyJhOb2Q: raises $14 to $20
7fOCUy3x9hdkmXkkDNolGQ: folds
RwDoM55ZeQuI2ADyJhOb2Q collected $12 from pot
RwDoM55ZeQuI2ADyJhOb2Q: doesn't show hand
*** SUMMARY ***
Total pot $12 | Rake $0
Seat 1: 7fOCUy3x9hdkmXkkDNolGQ (button) (small blind) folded before Flop
Seat 2: RwDoM55ZeQuI2ADyJhOb2Q (big blind) collected ($12)



PokerStars Game #59942001110:  Hold'em No Limit ($1/$2) - 2009/07/01 1:52:56 ET
Table 'jlrIxbrVIG+gjaUYT4za8g' 6-max Seat #2 is the button
Seat 2: cwfuMyvDC7J7SqX2leDC8g ($69 in chips)
Seat 3: 3LCfF9/CuJ9+kbFOcqmuaQ ($88.30 in chips)
Seat 4: 8srN1dKQePlsv0GyTada+Q ($260.50 in chips)
Seat 5: AyBB0k3Dcl7xbXUeGMw06g ($68.75 in chips)
Seat 6: BWhgxe7gWiYobRbwdG+d2Q ($201.30 in chips)
3LCfF9/CuJ9+kbFOcqmuaQ: posts small blind $1
8srN1dKQePlsv0GyTada+Q: posts big blind $2
opJMdoq0E6TRbAQiweyQuA: sits out
*** HOLE CARDS ***
AyBB0k3Dcl7xbXUeGMw06g: folds
BWhgxe7gWiYobRbwdG+d2Q: folds
cwfuMyvDC7J7SqX2leDC8g: folds
3LCfF9/CuJ9+kbFOcqmuaQ: folds
8srN1dKQePlsv0GyTada+Q collected $2 from pot
*** SUMMARY ***
Total pot $2 | Rake $0
Seat 2: cwfuMyvDC7J7SqX2leDC8g (button) folded before Flop (didn't bet)
Seat 3: 3LCfF9/CuJ9+kbFOcqmuaQ (small blind) folded before Flop
Seat 4: 8srN1dKQePlsv0GyTada+Q (big blind) collected ($2)
Seat 5: AyBB0k3Dcl7xbXUeGMw06g folded before Flop (didn't bet)
Seat 6: BWhgxe7gWiYobRbwdG+d2Q folded before Flop (didn't bet)



PokerStars Game #59942002936:  Hold'em No Limit ($1/$2) - 2009/07/01 1:52:59 ET
Table 'LL4bDFyhj5hsMpzaDugJZg' 6-max Seat #3 is the button
Seat 1: ubtx4Z5L+AcK71MTvYiGVw ($214.40 in chips)
Seat 2: TMPDCBmlFGM9C+H58PC4sQ ($18.75 in chips)
Seat 3: opJMdoq0E6TRbAQiweyQuA ($37 in chips)
Seat 4: 8srN1dKQePlsv0GyTada+Q ($388.85 in chips)
Seat 5: on4ebXPJvUBOcHOBMQsRSg ($67 in chips)
Seat 6: mddoKnqZkdOH7AJOJ/i0DA ($212.30 in chips)
8srN1dKQePlsv0GyTada+Q: posts small blind $1
on4ebXPJvUBOcHOBMQsRSg: posts big blind $2
*** HOLE CARDS ***
mddoKnqZkdOH7AJOJ/i0DA: folds
ubtx4Z5L+AcK71MTvYiGVw: folds
TMPDCBmlFGM9C+H58PC4sQ: raises $4 to $6
opJMdoq0E6TRbAQiweyQuA: folds
8srN1dKQePlsv0GyTada+Q: folds
on4ebXPJvUBOcHOBMQsRSg: folds
TMPDCBmlFGM9C+H58PC4sQ collected $5 from pot
*** SUMMARY ***
Total pot $5 | Rake $0
Seat 1: ubtx4Z5L+AcK71MTvYiGVw folded before Flop (didn't bet)
Seat 2: TMPDCBmlFGM9C+H58PC4sQ collected ($5)
Seat 3: opJMdoq0E6TRbAQiweyQuA (button) folded before Flop (didn't bet)
Seat 4: 8srN1dKQePlsv0GyTada+Q (small blind) folded before Flop
Seat 5: on4ebXPJvUBOcHOBMQsRSg (big blind) folded before Flop
Seat 6: mddoKnqZkdOH7AJOJ/i0DA folded before Flop (didn't bet)



PokerStars Game #59942003420:  Hold'em No Limit ($1/$2) - 2009/07/01 1:53:00 ET
Table 'WCA60bDA8ecovUgFSIZkTQ' 9-max Seat #4 is the button
Seat 1: 3RFwE6igZ1BGKOGuab6iiw ($55.70 in chips)
Seat 2: TAfo4veNRaRlzDXMMYS3Jg ($37 in chips)
Seat 3: g7gL2NLJCdZPPV399WKT1w ($47.65 in chips)
Seat 4: IYBKVnE2Basnr88BAhH+bQ ($202.80 in chips)
Seat 5: A+9gcmwAl0eFxxbAwRY1OA ($268.10 in chips)
Seat 6: YoKKKdDDs7gFzP1Z65Sdaw ($100 in chips)
Seat 7: tsTv4D+ne2W0qhUt9HlcMw ($193 in chips)
Seat 8: mJhwEVg7F695DiO+RIhM5g ($257.45 in chips)
Seat 9: ItDFe9gh5QYPQB9vC4ntUA ($200 in chips)
A+9gcmwAl0eFxxbAwRY1OA: posts small blind $1
YoKKKdDDs7gFzP1Z65Sdaw: posts big blind $2
*** HOLE CARDS ***
tsTv4D+ne2W0qhUt9HlcMw: folds
mJhwEVg7F695DiO+RIhM5g: folds
ItDFe9gh5QYPQB9vC4ntUA: folds
3RFwE6igZ1BGKOGuab6iiw: folds
TAfo4veNRaRlzDXMMYS3Jg: folds
g7gL2NLJCdZPPV399WKT1w: raises $4 to $6
IYBKVnE2Basnr88BAhH+bQ: folds
A+9gcmwAl0eFxxbAwRY1OA: calls $5
YoKKKdDDs7gFzP1Z65Sdaw: folds
*** FLOP *** [As 6s 6c]
A+9gcmwAl0eFxxbAwRY1OA: checks
g7gL2NLJCdZPPV399WKT1w: bets $8
A+9gcmwAl0eFxxbAwRY1OA: folds
g7gL2NLJCdZPPV399WKT1w collected $13.30 from pot
g7gL2NLJCdZPPV399WKT1w: doesn't show hand
*** SUMMARY ***
Total pot $14 | Rake $0.70
Board [As 6s 6c]
Seat 1: 3RFwE6igZ1BGKOGuab6iiw folded before Flop (didn't bet)
Seat 2: TAfo4veNRaRlzDXMMYS3Jg folded before Flop (didn't bet)
Seat 3: g7gL2NLJCdZPPV399WKT1w collected ($13.30)
Seat 4: IYBKVnE2Basnr88BAhH+bQ (button) folded before Flop (didn't bet)
Seat 5: A+9gcmwAl0eFxxbAwRY1OA (small blind) folded on the Flop
Seat 6: YoKKKdDDs7gFzP1Z65Sdaw (big blind) folded before Flop
Seat 7: tsTv4D+ne2W0qhUt9HlcMw folded before Flop (didn't bet)
Seat 8: mJhwEVg7F695DiO+RIhM5g folded before Flop (didn't bet)
Seat 9: ItDFe9gh5QYPQB9vC4ntUA folded before Flop (didn't bet)



PokerStars Game #59942003004:  Hold'em No Limit ($1/$2) - 2009/07/01 1:53:00 ET
Table 'CFkQcfWjKccZaZDf71FK+w' 6-max Seat #1 is the button
Seat 1: vkfxu8f/jMYKUk6Ly4eujw ($224.05 in chips)
Seat 2: ewN/vzF22+/gdzjIKBOlkA ($229.80 in chips)
Seat 3: TMPDCBmlFGM9C+H58PC4sQ ($40 in chips)
Seat 5: 2lOU1DcvUZaMcxZ95XfzXw ($120.85 in chips)
Seat 6: ORVqY3rf9X6ANA/8s+On2Q ($30.35 in chips)
ewN/vzF22+/gdzjIKBOlkA: posts small blind $1
TMPDCBmlFGM9C+H58PC4sQ: posts big blind $2
opJMdoq0E6TRbAQiweyQuA: sits out
*** HOLE CARDS ***
2lOU1DcvUZaMcxZ95XfzXw: folds
ORVqY3rf9X6ANA/8s+On2Q: calls $2
vkfxu8f/jMYKUk6Ly4eujw: folds
ewN/vzF22+/gdzjIKBOlkA: folds
TMPDCBmlFGM9C+H58PC4sQ: checks
*** FLOP *** [3d Ac Kc]
TMPDCBmlFGM9C+H58PC4sQ: bets $2
ORVqY3rf9X6ANA/8s+On2Q: folds
TMPDCBmlFGM9C+H58PC4sQ collected $4.75 from pot
*** SUMMARY ***
Total pot $5 | Rake $0.25
Board [3d Ac Kc]
Seat 1: vkfxu8f/jMYKUk6Ly4eujw (button) folded before Flop (didn't bet)
Seat 2: ewN/vzF22+/gdzjIKBOlkA (small blind) folded before Flop
Seat 3: TMPDCBmlFGM9C+H58PC4sQ (big blind) collected ($4.75)
Seat 5: 2lOU1DcvUZaMcxZ95XfzXw folded before Flop (didn't bet)
Seat 6: ORVqY3rf9X6ANA/8s+On2Q folded on the Flop



PokerStars Game #59942004354:  Hold'em No Limit ($1/$2) - 2009/07/01 1:53:02 ET
Table '7goFpXy7qyiK5mwx+Ucf6A' 6-max Seat #6 is the button
Seat 1: VHmJJYp7TGQwcWROQ8dqXw ($59.10 in chips)
Seat 2: BWhgxe7gWiYobRbwdG+d2Q ($196 in chips)
Seat 4: fE+LHW/7rpfXW14g8LhGjA ($40 in chips)
Seat 5: /PH6Ffnho4Ysm8S3V/oa+w ($85 in chips)
Seat 6: VvdR9F3I+2yELkfTVvC1dg ($210.60 in chips)
VHmJJYp7TGQwcWROQ8dqXw: posts small blind $1
BWhgxe7gWiYobRbwdG+d2Q: posts big blind $2
mfy7uGZcqA2PVQqEVbJ7+g: sits out
*** HOLE CARDS ***
fE+LHW/7rpfXW14g8LhGjA: raises $2 to $4
/PH6Ffnho4Ysm8S3V/oa+w: folds
VvdR9F3I+2yELkfTVvC1dg: folds
VHmJJYp7TGQwcWROQ8dqXw: calls $3
BWhgxe7gWiYobRbwdG+d2Q: folds
*** FLOP *** [7h 8s 2s]
VHmJJYp7TGQwcWROQ8dqXw: checks
fE+LHW/7rpfXW14g8LhGjA: bets $14
VHmJJYp7TGQwcWROQ8dqXw: folds
fE+LHW/7rpfXW14g8LhGjA collected $9.50 from pot
fE+LHW/7rpfXW14g8LhGjA: doesn't show hand
*** SUMMARY ***
Total pot $10 | Rake $0.50
Board [7h 8s 2s]
Seat 1: VHmJJYp7TGQwcWROQ8dqXw (small blind) folded on the Flop
Seat 2: BWhgxe7gWiYobRbwdG+d2Q (big blind) folded before Flop
Seat 4: fE+LHW/7rpfXW14g8LhGjA collected ($9.50)
Seat 5: /PH6Ffnho4Ysm8S3V/oa+w folded before Flop (didn't bet)
Seat 6: VvdR9F3I+2yELkfTVvC1dg (button) folded before Flop (didn't bet)



PokerStars Game #59942004642:  Hold'em No Limit ($1/$2) - 2009/07/01 1:53:03 ET
Table 'ZzSIe0zTCDv+n6hfbY5tTg' 6-max Seat #6 is the button
Seat 1: VvdR9F3I+2yELkfTVvC1dg ($289.65 in chips)
Seat 2: B87ikIyZ/TzAVeXf38Ny0g ($225 in chips)
Seat 3: gsugPj31Hui3Jefl98MBOA ($346.10 in chips)
Seat 4: 54yWzRRgS0oZ+S6LwZBxMQ ($43.10 in chips)
Seat 5: 3dAbvkxS5NPQTBAbvpinVg ($481.45 in chips)
Seat 6: 09BNF4quPDzanQzM8vc6WA ($33 in chips)
VvdR9F3I+2yELkfTVvC1dg: posts small blind $1
B87ikIyZ/TzAVeXf38Ny0g: posts big blind $2
*** HOLE CARDS ***
gsugPj31Hui3Jefl98MBOA: folds
54yWzRRgS0oZ+S6LwZBxMQ: folds
3dAbvkxS5NPQTBAbvpinVg: folds
09BNF4quPDzanQzM8vc6WA: folds
VvdR9F3I+2yELkfTVvC1dg: folds
B87ikIyZ/TzAVeXf38Ny0g collected $2 from pot
B87ikIyZ/TzAVeXf38Ny0g: doesn't show hand
*** SUMMARY ***
Total pot $2 | Rake $0
Seat 1: VvdR9F3I+2yELkfTVvC1dg (small blind) folded before Flop
Seat 2: B87ikIyZ/TzAVeXf38Ny0g (big blind) collected ($2)
Seat 3: gsugPj31Hui3Jefl98MBOA folded before Flop (didn't bet)
Seat 4: 54yWzRRgS0oZ+S6LwZBxMQ folded before Flop (didn't bet)
Seat 5: 3dAbvkxS5NPQTBAbvpinVg folded before Flop (didn't bet)
Seat 6: 09BNF4quPDzanQzM8vc6WA (button) folded before Flop (didn't bet)



PokerStars Game #59942005006:  Hold'em No Limit ($1/$2) - 2009/07/01 1:53:03 ET
Table '/dyk+YdRGv90j2box35j8w' 6-max Seat #5 is the button
Seat 1: 8srN1dKQePlsv0GyTada+Q ($200 in chips)
Seat 2: qCnEYuAE5y5A7bk6fO5/jQ ($499.20 in chips)
Seat 3: sTPOWERd9HWPCNrDBwsVjA ($209.50 in chips)
Seat 4: 4dMBh/1VTdeUTPCyhCs3UQ ($83 in chips)
Seat 5: VvdR9F3I+2yELkfTVvC1dg ($291.80 in chips)
Seat 6: C3qJBo7uxfFVDluE1lmK2w ($93.25 in chips)
C3qJBo7uxfFVDluE1lmK2w: posts small blind $1
8srN1dKQePlsv0GyTada+Q: posts big blind $2
*** HOLE CARDS ***
qCnEYuAE5y5A7bk6fO5/jQ: folds
sTPOWERd9HWPCNrDBwsVjA: folds
4dMBh/1VTdeUTPCyhCs3UQ: folds
VvdR9F3I+2yELkfTVvC1dg: raises $2 to $4
C3qJBo7uxfFVDluE1lmK2w: folds
8srN1dKQePlsv0GyTada+Q: folds
VvdR9F3I+2yELkfTVvC1dg collected $5 from pot
VvdR9F3I+2yELkfTVvC1dg: doesn't show hand
*** SUMMARY ***
Total pot $5 | Rake $0
Seat 1: 8srN1dKQePlsv0GyTada+Q (big blind) folded before Flop
Seat 2: qCnEYuAE5y5A7bk6fO5/jQ folded before Flop (didn't bet)
Seat 3: sTPOWERd9HWPCNrDBwsVjA folded before Flop (didn't bet)
Seat 4: 4dMBh/1VTdeUTPCyhCs3UQ folded before Flop (didn't bet)
Seat 5: VvdR9F3I+2yELkfTVvC1dg (button) collected ($5)
Seat 6: C3qJBo7uxfFVDluE1lmK2w (small blind) folded before Flop



PokerStars Game #59942005588:  Hold'em No Limit ($1/$2) - 2009/07/01 1:53:04 ET
Table 'ztv6V3FN2bQ9nmJPPdx6nQ' 6-max Seat #6 is the button
Seat 1: 6fLdOUCRtX71xbVRhJEq8w ($282.35 in chips)
Seat 2: 5Y+ZGWLI4gnlpApDX5vy1A ($374.05 in chips)
Seat 4: UaZ5yj+6LjtWqMQg2QskUw ($89.85 in chips)
Seat 5: sTPOWERd9HWPCNrDBwsVjA ($213.60 in chips)
Seat 6: mfy7uGZcqA2PVQqEVbJ7+g ($197 in chips)
6fLdOUCRtX71xbVRhJEq8w: posts small blind $1
5Y+ZGWLI4gnlpApDX5vy1A: posts big blind $2
*** HOLE CARDS ***
UaZ5yj+6LjtWqMQg2QskUw: calls $2
sTPOWERd9HWPCNrDBwsVjA: calls $2
mfy7uGZcqA2PVQqEVbJ7+g: raises $10 to $12
6fLdOUCRtX71xbVRhJEq8w: folds
5Y+ZGWLI4gnlpApDX5vy1A: folds
UaZ5yj+6LjtWqMQg2QskUw: calls $10
sTPOWERd9HWPCNrDBwsVjA: folds
*** FLOP *** [Th 8d Td]
XP9UmPc7hfMVafyEiwJMAA joins the table at seat #3
UaZ5yj+6LjtWqMQg2QskUw: bets $8
mfy7uGZcqA2PVQqEVbJ7+g: folds
UaZ5yj+6LjtWqMQg2QskUw collected $27.55 from pot
*** SUMMARY ***
Total pot $29 | Rake $1.45
Board [Th 8d Td]
Seat 1: 6fLdOUCRtX71xbVRhJEq8w (small blind) folded before Flop
Seat 2: 5Y+ZGWLI4gnlpApDX5vy1A (big blind) folded before Flop
Seat 4: UaZ5yj+6LjtWqMQg2QskUw collected ($27.55)
Seat 5: sTPOWERd9HWPCNrDBwsVjA folded before Flop
Seat 6: mfy7uGZcqA2PVQqEVbJ7+g (button) folded on the Flop



PokerStars Game #59942005380:  Hold'em No Limit ($1/$2) - 2009/07/01 1:53:04 ET
Table '3WCXyaiCAbqSShQu7FIjvA' 9-max Seat #6 is the button
Seat 1: kTCkABD1UUldS9DFRGfCwQ ($137.75 in chips)
Seat 3: 5Q8U6iZbeO7xJSS4qvDP5g ($267.25 in chips)
Seat 4: waEF/+pxZTxNo4FvsORuXg ($101.40 in chips)
Seat 5: CkE3IyJF1KvdaAOmZY5XqQ ($207.90 in chips)
Seat 6: 5jQlngvMSqM/WoonOcR5kw ($271 in chips)
Seat 7: nXDI8Y/S6POzRwANu3d8hQ ($42.10 in chips)
Seat 8: +T/63sAeZzWyHchahJ36GQ ($37 in chips)
Seat 9: FiXPLJyqb24l32QST2TInw ($121.20 in chips)
nXDI8Y/S6POzRwANu3d8hQ: posts small blind $1
+T/63sAeZzWyHchahJ36GQ: posts big blind $2
254YPxPJr5Sw58bkD0YqYQ: sits out
*** HOLE CARDS ***
FiXPLJyqb24l32QST2TInw: calls $2
kTCkABD1UUldS9DFRGfCwQ: folds
5Q8U6iZbeO7xJSS4qvDP5g: folds
waEF/+pxZTxNo4FvsORuXg: folds
CkE3IyJF1KvdaAOmZY5XqQ: folds
5jQlngvMSqM/WoonOcR5kw: calls $2
nXDI8Y/S6POzRwANu3d8hQ: folds
+T/63sAeZzWyHchahJ36GQ: checks
*** FLOP *** [3d Jc Qd]
+T/63sAeZzWyHchahJ36GQ: checks
FiXPLJyqb24l32QST2TInw: bets $2
5jQlngvMSqM/WoonOcR5kw: raises $8 to $10
+T/63sAeZzWyHchahJ36GQ: folds
FiXPLJyqb24l32QST2TInw: folds
5jQlngvMSqM/WoonOcR5kw collected $10.50 from pot
*** SUMMARY ***
Total pot $11 | Rake $0.50
Board [3d Jc Qd]
Seat 1: kTCkABD1UUldS9DFRGfCwQ folded before Flop (didn't bet)
Seat 3: 5Q8U6iZbeO7xJSS4qvDP5g folded before Flop (didn't bet)
Seat 4: waEF/+pxZTxNo4FvsORuXg folded before Flop (didn't bet)
Seat 5: CkE3IyJF1KvdaAOmZY5XqQ folded before Flop (didn't bet)
Seat 6: 5jQlngvMSqM/WoonOcR5kw (button) collected ($10.50)
Seat 7: nXDI8Y/S6POzRwANu3d8hQ (small blind) folded before Flop
Seat 8: +T/63sAeZzWyHchahJ36GQ (big blind) folded on the Flop
Seat 9: FiXPLJyqb24l32QST2TInw folded on the Flop



PokerStars Game #59942006436:  Hold'em No Limit ($1/$2) - 2009/07/01 1:53:06 ET
Table 'NmY84NAf9Mh0ckAckHnh5g' 2-max Seat #1 is the button
Seat 1: 6hvg964TSqZ3AL/0XK9aVQ ($529.40 in chips)
Seat 2: RwDoM55ZeQuI2ADyJhOb2Q ($451.30 in chips)
6hvg964TSqZ3AL/0XK9aVQ: posts small blind $1
RwDoM55ZeQuI2ADyJhOb2Q: posts big blind $2
*** HOLE CARDS ***
6hvg964TSqZ3AL/0XK9aVQ: calls $1
RwDoM55ZeQuI2ADyJhOb2Q: checks
*** FLOP *** [Ad As Ac]
RwDoM55ZeQuI2ADyJhOb2Q: checks
6hvg964TSqZ3AL/0XK9aVQ: bets $4
RwDoM55ZeQuI2ADyJhOb2Q: folds
6hvg964TSqZ3AL/0XK9aVQ collected $3.80 from pot
6hvg964TSqZ3AL/0XK9aVQ: doesn't show hand
*** SUMMARY ***
Total pot $4 | Rake $0.20
Board [Ad As Ac]
Seat 1: 6hvg964TSqZ3AL/0XK9aVQ (button) (small blind) collected ($3.80)
Seat 2: RwDoM55ZeQuI2ADyJhOb2Q (big blind) folded on the Flop



PokerStars Game #59942007490:  Hold'em No Limit ($1/$2) - 2009/07/01 1:53:08 ET
Table 'P/yCfYl1GfGsu/e6DxDy/A' 2-max Seat #2 is the button
Seat 1: 7fOCUy3x9hdkmXkkDNolGQ ($1112.50 in chips)
Seat 2: RwDoM55ZeQuI2ADyJhOb2Q ($356.50 in chips)
RwDoM55ZeQuI2ADyJhOb2Q: posts small blind $1
7fOCUy3x9hdkmXkkDNolGQ: posts big blind $2
*** HOLE CARDS ***
RwDoM55ZeQuI2ADyJhOb2Q: raises $4 to $6
7fOCUy3x9hdkmXkkDNolGQ: folds
RwDoM55ZeQuI2ADyJhOb2Q collected $4 from pot
RwDoM55ZeQuI2ADyJhOb2Q: doesn't show hand
*** SUMMARY ***
Total pot $4 | Rake $0
Seat 1: 7fOCUy3x9hdkmXkkDNolGQ (big blind) folded before Flop
Seat 2: RwDoM55ZeQuI2ADyJhOb2Q (button) (small blind) collected ($4)



PokerStars Game #59942008008:  Hold'em No Limit ($1/$2) - 2009/07/01 1:53:09 ET
Table 'mGpP9StWRnoeiBDExc6Frg' 6-max Seat #4 is the button
Seat 1: VvdR9F3I+2yELkfTVvC1dg ($316.40 in chips)
Seat 2: 6hRJ68JkbJq6MYI9o5bUnQ ($103 in chips)
Seat 3: mddoKnqZkdOH7AJOJ/i0DA ($203 in chips)
Seat 4: 4dcDwIHRm96PwtqkpQiuiA ($84.70 in chips)
Seat 5: d1puGuVBE0fidn+5eRJ0tw ($191.35 in chips)
Seat 6: B2Ih1sr5VZk+8He7rcrMtQ ($402.45 in chips)
d1puGuVBE0fidn+5eRJ0tw: posts small blind $1
B2Ih1sr5VZk+8He7rcrMtQ: posts big blind $2
*** HOLE CARDS ***
VvdR9F3I+2yELkfTVvC1dg: folds
6hRJ68JkbJq6MYI9o5bUnQ: calls $2
mddoKnqZkdOH7AJOJ/i0DA: folds
4dcDwIHRm96PwtqkpQiuiA: folds
d1puGuVBE0fidn+5eRJ0tw: folds
B2Ih1sr5VZk+8He7rcrMtQ: checks
*** FLOP *** [Qc Kd 4h]
B2Ih1sr5VZk+8He7rcrMtQ: checks
6hRJ68JkbJq6MYI9o5bUnQ: checks
*** TURN *** [Qc Kd 4h] [6d]
B2Ih1sr5VZk+8He7rcrMtQ: checks
6hRJ68JkbJq6MYI9o5bUnQ: checks
*** RIVER *** [Qc Kd 4h 6d] [2d]
B2Ih1sr5VZk+8He7rcrMtQ: checks
6hRJ68JkbJq6MYI9o5bUnQ: checks
*** SHOW DOWN ***
B2Ih1sr5VZk+8He7rcrMtQ: shows [6h Jh] (a pair of Sixes)
6hRJ68JkbJq6MYI9o5bUnQ: mucks hand
B2Ih1sr5VZk+8He7rcrMtQ collected $4.75 from pot
*** SUMMARY ***
Total pot $5 | Rake $0.25
Board [Qc Kd 4h 6d 2d]
Seat 1: VvdR9F3I+2yELkfTVvC1dg folded before Flop (didn't bet)
Seat 2: 6hRJ68JkbJq6MYI9o5bUnQ mucked
Seat 3: mddoKnqZkdOH7AJOJ/i0DA folded before Flop (didn't bet)
Seat 4: 4dcDwIHRm96PwtqkpQiuiA (button) folded before Flop (didn't bet)
Seat 5: d1puGuVBE0fidn+5eRJ0tw (small blind) folded before Flop
Seat 6: B2Ih1sr5VZk+8He7rcrMtQ (big blind) showed [6h Jh] and won ($4.75) with a pair of Sixes



PokerStars Game #59942008950:  Hold'em No Limit ($1/$2) - 2009/07/01 1:53:11 ET
Table 'jlrIxbrVIG+gjaUYT4za8g' 6-max Seat #3 is the button
Seat 2: cwfuMyvDC7J7SqX2leDC8g ($69 in chips)
Seat 3: 3LCfF9/CuJ9+kbFOcqmuaQ ($87.30 in chips)
Seat 4: 8srN1dKQePlsv0GyTada+Q ($261.50 in chips)
Seat 5: AyBB0k3Dcl7xbXUeGMw06g ($68.75 in chips)
Seat 6: BWhgxe7gWiYobRbwdG+d2Q ($201.30 in chips)
8srN1dKQePlsv0GyTada+Q: posts small blind $1
AyBB0k3Dcl7xbXUeGMw06g: posts big blind $2
opJMdoq0E6TRbAQiweyQuA: sits out
*** HOLE CARDS ***
BWhgxe7gWiYobRbwdG+d2Q: raises $5 to $7
cwfuMyvDC7J7SqX2leDC8g: folds
3LCfF9/CuJ9+kbFOcqmuaQ: calls $7
8srN1dKQePlsv0GyTada+Q: raises $14 to $21
AyBB0k3Dcl7xbXUeGMw06g: folds
BWhgxe7gWiYobRbwdG+d2Q: folds
3LCfF9/CuJ9+kbFOcqmuaQ: calls $14
*** FLOP *** [6d 5d 6c]
8srN1dKQePlsv0GyTada+Q: bets $22
3LCfF9/CuJ9+kbFOcqmuaQ: folds
8srN1dKQePlsv0GyTada+Q collected $49 from pot
*** SUMMARY ***
Total pot $51 | Rake $2
Board [6d 5d 6c]
Seat 2: cwfuMyvDC7J7SqX2leDC8g folded before Flop (didn't bet)
Seat 3: 3LCfF9/CuJ9+kbFOcqmuaQ (button) folded on the Flop
Seat 4: 8srN1dKQePlsv0GyTada+Q (small blind) collected ($49)
Seat 5: AyBB0k3Dcl7xbXUeGMw06g (big blind) folded before Flop
Seat 6: BWhgxe7gWiYobRbwdG+d2Q folded before Flop



PokerStars Game #59942011990:  Hold'em No Limit ($1/$2) - 2009/07/01 1:53:17 ET
Table 'o63a8j70meKHUtgLFryQvg' 9-max Seat #6 is the button
Seat 1: +1R0op5O3Gf6aUPJTw7jjA ($197 in chips)
Seat 2: SgA0Zfa/3yhNp7ILXcXcCg ($68.15 in chips)
Seat 3: IYBKVnE2Basnr88BAhH+bQ ($265.40 in chips)
Seat 4: ZYHoLw2lWmRS7CSHi8L8Xg ($209.90 in chips)
Seat 5: g3ZVTc1EbSNXYYMO82jL7Q ($223.30 in chips)
Seat 6: CUZwDpLTQKhzarPe+JCLOQ ($200 in chips)
Seat 7: kM9CA+2UcdMjbCMbtUCGiA ($200 in chips)
Seat 8: ItDFe9gh5QYPQB9vC4ntUA ($342.05 in chips)
kM9CA+2UcdMjbCMbtUCGiA: posts small blind $1
ItDFe9gh5QYPQB9vC4ntUA: posts big blind $2
TAfo4veNRaRlzDXMMYS3Jg: sits out
*** HOLE CARDS ***
+1R0op5O3Gf6aUPJTw7jjA: folds
SgA0Zfa/3yhNp7ILXcXcCg: calls $2
IYBKVnE2Basnr88BAhH+bQ: folds
ZYHoLw2lWmRS7CSHi8L8Xg: folds
g3ZVTc1EbSNXYYMO82jL7Q: folds
CUZwDpLTQKhzarPe+JCLOQ: raises $8 to $10
kM9CA+2UcdMjbCMbtUCGiA: folds
ItDFe9gh5QYPQB9vC4ntUA: calls $8
SgA0Zfa/3yhNp7ILXcXcCg: calls $8
*** FLOP *** [Qh 7s As]
ItDFe9gh5QYPQB9vC4ntUA: checks
SgA0Zfa/3yhNp7ILXcXcCg: checks
CUZwDpLTQKhzarPe+JCLOQ: checks
*** TURN *** [Qh 7s As] [6d]
ItDFe9gh5QYPQB9vC4ntUA: checks
SgA0Zfa/3yhNp7ILXcXcCg: checks
TAfo4veNRaRlzDXMMYS3Jg is sitting out
CUZwDpLTQKhzarPe+JCLOQ: checks
*** RIVER *** [Qh 7s As 6d] [6c]
TAfo4veNRaRlzDXMMYS3Jg leaves the table
ItDFe9gh5QYPQB9vC4ntUA: checks
SgA0Zfa/3yhNp7ILXcXcCg: checks
rW/MyplHylMSBRaoRUzWrg joins the table at seat #9
CUZwDpLTQKhzarPe+JCLOQ: bets $25
ItDFe9gh5QYPQB9vC4ntUA: calls $25
SgA0Zfa/3yhNp7ILXcXcCg: folds
*** SHOW DOWN ***
CUZwDpLTQKhzarPe+JCLOQ: shows [Jh 9c] (a pair of Sixes)
ItDFe9gh5QYPQB9vC4ntUA: shows [Kd Jc] (a pair of Sixes - Ace+King kicker)
ItDFe9gh5QYPQB9vC4ntUA collected $78 from pot
*** SUMMARY ***
Total pot $81 | Rake $3
Board [Qh 7s As 6d 6c]
Seat 1: +1R0op5O3Gf6aUPJTw7jjA folded before Flop (didn't bet)
Seat 2: SgA0Zfa/3yhNp7ILXcXcCg folded on the River
Seat 3: IYBKVnE2Basnr88BAhH+bQ folded before Flop (didn't bet)
Seat 4: ZYHoLw2lWmRS7CSHi8L8Xg folded before Flop (didn't bet)
Seat 5: g3ZVTc1EbSNXYYMO82jL7Q folded before Flop (didn't bet)
Seat 6: CUZwDpLTQKhzarPe+JCLOQ (button) showed [Jh 9c] and lost with a pair of Sixes
Seat 7: kM9CA+2UcdMjbCMbtUCGiA (small blind) folded before Flop
Seat 8: ItDFe9gh5QYPQB9vC4ntUA (big blind) showed [Kd Jc] and won ($78) with a pair of Sixes



PokerStars Game #59942011900:  Hold'em No Limit ($1/$2) - 2009/07/01 1:53:17 ET
Table 'uJ9juaXXg9yIcSU8amxaXQ' 6-max Seat #5 is the button
Seat 1: JsqOjN/eHz0uYVf/PyUJ6Q ($119.95 in chips)
Seat 2: VvdR9F3I+2yELkfTVvC1dg ($217.45 in chips)
Seat 3: qXDd0ZyMIse0OBu8pxeQ3Q ($239.40 in chips)
Seat 4: zNjJ/y4emmF+vzrCDd+ooA ($267.55 in chips)
Seat 5: YsLQ3BAvgQHWXMAv3Wv6Hg ($213.70 in chips)
Seat 6: /PH6Ffnho4Ysm8S3V/oa+w ($41 in chips)
/PH6Ffnho4Ysm8S3V/oa+w: posts small blind $1
JsqOjN/eHz0uYVf/PyUJ6Q: posts big blind $2
*** HOLE CARDS ***
VvdR9F3I+2yELkfTVvC1dg: folds
qXDd0ZyMIse0OBu8pxeQ3Q: folds
zNjJ/y4emmF+vzrCDd+ooA: calls $2
YsLQ3BAvgQHWXMAv3Wv6Hg: folds
/PH6Ffnho4Ysm8S3V/oa+w: folds
JsqOjN/eHz0uYVf/PyUJ6Q: checks
*** FLOP *** [As 5c Js]
JsqOjN/eHz0uYVf/PyUJ6Q: checks
zNjJ/y4emmF+vzrCDd+ooA: bets $2
JsqOjN/eHz0uYVf/PyUJ6Q: folds
zNjJ/y4emmF+vzrCDd+ooA collected $4.75 from pot
*** SUMMARY ***
Total pot $5 | Rake $0.25
Board [As 5c Js]
Seat 1: JsqOjN/eHz0uYVf/PyUJ6Q (big blind) folded on the Flop
Seat 2: VvdR9F3I+2yELkfTVvC1dg folded before Flop (didn't bet)
Seat 3: qXDd0ZyMIse0OBu8pxeQ3Q folded before Flop (didn't bet)
Seat 4: zNjJ/y4emmF+vzrCDd+ooA collected ($4.75)
Seat 5: YsLQ3BAvgQHWXMAv3Wv6Hg (button) folded before Flop (didn't bet)
Seat 6: /PH6Ffnho4Ysm8S3V/oa+w (small blind) folded before Flop



PokerStars Game #59942011902:  Hold'em No Limit ($1/$2) - 2009/07/01 1:53:17 ET
Table 'QxerF7GUfCbl+4a8XaTB2w' 6-max Seat #1 is the button
Seat 1: ZwvXzkkZ3XpMhKfAmVpahw ($285.25 in chips)
Seat 2: 6UGgYbxwWNc+ohObe8vB9w ($84 in chips)
Seat 3: 8rZGabKe2DEPdZCbCivZ9Q ($25 in chips)
Seat 4: /PH6Ffnho4Ysm8S3V/oa+w ($53 in chips)
Seat 5: vkfxu8f/jMYKUk6Ly4eujw ($152.05 in chips)
Seat 6: VvdR9F3I+2yELkfTVvC1dg ($210.70 in chips)
6UGgYbxwWNc+ohObe8vB9w: posts small blind $1
8rZGabKe2DEPdZCbCivZ9Q: posts big blind $2
*** HOLE CARDS ***
/PH6Ffnho4Ysm8S3V/oa+w: folds
vkfxu8f/jMYKUk6Ly4eujw: folds
VvdR9F3I+2yELkfTVvC1dg: raises $2 to $4
ZwvXzkkZ3XpMhKfAmVpahw: folds
6UGgYbxwWNc+ohObe8vB9w: calls $3
8rZGabKe2DEPdZCbCivZ9Q: calls $2
*** FLOP *** [4c Qc 6d]
6UGgYbxwWNc+ohObe8vB9w: checks
8rZGabKe2DEPdZCbCivZ9Q: checks
VvdR9F3I+2yELkfTVvC1dg: checks
*** TURN *** [4c Qc 6d] [Jd]
6UGgYbxwWNc+ohObe8vB9w: checks
8rZGabKe2DEPdZCbCivZ9Q: checks
VvdR9F3I+2yELkfTVvC1dg: checks
*** RIVER *** [4c Qc 6d Jd] [9d]
6UGgYbxwWNc+ohObe8vB9w: checks
8rZGabKe2DEPdZCbCivZ9Q: checks
VvdR9F3I+2yELkfTVvC1dg: checks
*** SHOW DOWN ***
6UGgYbxwWNc+ohObe8vB9w: shows [5s 6h] (a pair of Sixes)
8rZGabKe2DEPdZCbCivZ9Q: shows [5h 6c] (a pair of Sixes)
VvdR9F3I+2yELkfTVvC1dg: shows [Ac 9s] (a pair of Nines)
VvdR9F3I+2yELkfTVvC1dg collected $11.40 from pot
*** SUMMARY ***
Total pot $12 | Rake $0.60
Board [4c Qc 6d Jd 9d]
Seat 1: ZwvXzkkZ3XpMhKfAmVpahw (button) folded before Flop (didn't bet)
Seat 2: 6UGgYbxwWNc+ohObe8vB9w (small blind) showed [5s 6h] and lost with a pair of Sixes
Seat 3: 8rZGabKe2DEPdZCbCivZ9Q (big blind) showed [5h 6c] and lost with a pair of Sixes
Seat 4: /PH6Ffnho4Ysm8S3V/oa+w folded before Flop (didn't bet)
Seat 5: vkfxu8f/jMYKUk6Ly4eujw folded before Flop (didn't bet)
Seat 6: VvdR9F3I+2yELkfTVvC1dg showed [Ac 9s] and won ($11.40) with a pair of Nines



PokerStars Game #59942012804:  Hold'em No Limit ($1/$2) - 2009/07/01 1:53:18 ET
Table 'G1Oqdy4Pqdb5gtx40rUBzA' 6-max Seat #6 is the button
Seat 1: 4dMBh/1VTdeUTPCyhCs3UQ ($46.05 in chips)
Seat 2: m7mYVfnCOK5TE/VkN/FhOg ($236.75 in chips)
Seat 3: VvdR9F3I+2yELkfTVvC1dg ($419.90 in chips)
Seat 4: B87ikIyZ/TzAVeXf38Ny0g ($215.70 in chips)
Seat 5: F1+Ml47qRQWunzPnGhLLzQ ($194 in chips)
Seat 6: qCnEYuAE5y5A7bk6fO5/jQ ($200 in chips)
4dMBh/1VTdeUTPCyhCs3UQ: posts small blind $1
m7mYVfnCOK5TE/VkN/FhOg: posts big blind $2
*** HOLE CARDS ***
VvdR9F3I+2yELkfTVvC1dg: folds
B87ikIyZ/TzAVeXf38Ny0g: folds
F1+Ml47qRQWunzPnGhLLzQ: raises $6 to $8
qCnEYuAE5y5A7bk6fO5/jQ: folds
4dMBh/1VTdeUTPCyhCs3UQ: folds
m7mYVfnCOK5TE/VkN/FhOg: folds
F1+Ml47qRQWunzPnGhLLzQ collected $5 from pot
F1+Ml47qRQWunzPnGhLLzQ: doesn't show hand
*** SUMMARY ***
Total pot $5 | Rake $0
Seat 1: 4dMBh/1VTdeUTPCyhCs3UQ (small blind) folded before Flop
Seat 2: m7mYVfnCOK5TE/VkN/FhOg (big blind) folded before Flop
Seat 3: VvdR9F3I+2yELkfTVvC1dg folded before Flop (didn't bet)
Seat 4: B87ikIyZ/TzAVeXf38Ny0g folded before Flop (didn't bet)
Seat 5: F1+Ml47qRQWunzPnGhLLzQ collected ($5)
Seat 6: qCnEYuAE5y5A7bk6fO5/jQ (button) folded before Flop (didn't bet)



PokerStars Game #59942012414:  Hold'em No Limit ($1/$2) - 2009/07/01 1:53:18 ET
Table 'P/yCfYl1GfGsu/e6DxDy/A' 2-max Seat #1 is the button
Seat 1: 7fOCUy3x9hdkmXkkDNolGQ ($1110.50 in chips)
Seat 2: RwDoM55ZeQuI2ADyJhOb2Q ($358.50 in chips)
7fOCUy3x9hdkmXkkDNolGQ: posts small blind $1
RwDoM55ZeQuI2ADyJhOb2Q: posts big blind $2
*** HOLE CARDS ***
7fOCUy3x9hdkmXkkDNolGQ: raises $4 to $6
RwDoM55ZeQuI2ADyJhOb2Q: raises $14 to $20
7fOCUy3x9hdkmXkkDNolGQ: calls $14
*** FLOP *** [Th 6s Td]
RwDoM55ZeQuI2ADyJhOb2Q: bets $22
7fOCUy3x9hdkmXkkDNolGQ: calls $22
*** TURN *** [Th 6s Td] [8c]
RwDoM55ZeQuI2ADyJhOb2Q: checks
7fOCUy3x9hdkmXkkDNolGQ: checks
*** RIVER *** [Th 6s Td 8c] [As]
RwDoM55ZeQuI2ADyJhOb2Q: checks
7fOCUy3x9hdkmXkkDNolGQ: bets $77
RwDoM55ZeQuI2ADyJhOb2Q: folds
7fOCUy3x9hdkmXkkDNolGQ collected $83.50 from pot
7fOCUy3x9hdkmXkkDNolGQ: doesn't show hand
*** SUMMARY ***
Total pot $84 | Rake $0.50
Board [Th 6s Td 8c As]
Seat 1: 7fOCUy3x9hdkmXkkDNolGQ (button) (small blind) collected ($83.50)
Seat 2: RwDoM55ZeQuI2ADyJhOb2Q (big blind) folded on the River



PokerStars Game #59942012858:  Hold'em No Limit ($1/$2) - 2009/07/01 1:53:19 ET
Table '5/wEe6JmtGD7vufSA2RG7A' 2-max Seat #2 is the button
Seat 1: pVqEzK9wXlRMECnb1Zg4Zw ($201.80 in chips)
Seat 2: aOL8geThaYp2iadSHl1h1g ($382 in chips)
aOL8geThaYp2iadSHl1h1g: posts small blind $1
pVqEzK9wXlRMECnb1Zg4Zw: posts big blind $2
*** HOLE CARDS ***
aOL8geThaYp2iadSHl1h1g: raises $4 to $6
pVqEzK9wXlRMECnb1Zg4Zw: calls $4
*** FLOP *** [4s Kc Jh]
pVqEzK9wXlRMECnb1Zg4Zw: bets $8
aOL8geThaYp2iadSHl1h1g: raises $18 to $26
pVqEzK9wXlRMECnb1Zg4Zw: calls $18
*** TURN *** [4s Kc Jh] [6h]
pVqEzK9wXlRMECnb1Zg4Zw: bets $6
aOL8geThaYp2iadSHl1h1g: raises $34 to $40
pVqEzK9wXlRMECnb1Zg4Zw: calls $34
*** RIVER *** [4s Kc Jh 6h] [2s]
pVqEzK9wXlRMECnb1Zg4Zw: checks
aOL8geThaYp2iadSHl1h1g: bets $72
pVqEzK9wXlRMECnb1Zg4Zw: folds
aOL8geThaYp2iadSHl1h1g collected $143.50 from pot
aOL8geThaYp2iadSHl1h1g: doesn't show hand
*** SUMMARY ***
Total pot $144 | Rake $0.50
Board [4s Kc Jh 6h 2s]
Seat 1: pVqEzK9wXlRMECnb1Zg4Zw (big blind) folded on the River
Seat 2: aOL8geThaYp2iadSHl1h1g (button) (small blind) collected ($143.50)



PokerStars Game #59942012862:  Hold'em No Limit ($1/$2) - 2009/07/01 1:53:19 ET
Table 'NmY84NAf9Mh0ckAckHnh5g' 2-max Seat #2 is the button
Seat 1: 6hvg964TSqZ3AL/0XK9aVQ ($531.20 in chips)
Seat 2: RwDoM55ZeQuI2ADyJhOb2Q ($449.30 in chips)
RwDoM55ZeQuI2ADyJhOb2Q: posts small blind $1
6hvg964TSqZ3AL/0XK9aVQ: posts big blind $2
*** HOLE CARDS ***
RwDoM55ZeQuI2ADyJhOb2Q: folds
6hvg964TSqZ3AL/0XK9aVQ collected $2 from pot
6hvg964TSqZ3AL/0XK9aVQ: doesn't show hand
*** SUMMARY ***
Total pot $2 | Rake $0
Seat 1: 6hvg964TSqZ3AL/0XK9aVQ (big blind) collected ($2)
Seat 2: RwDoM55ZeQuI2ADyJhOb2Q (button) (small blind) folded before Flop



PokerStars Game #59942015486:  Hold'em No Limit ($1/$2) - 2009/07/01 1:53:23 ET
Table 'UGLAZZyv+cXmnKjYin0etA' 6-max Seat #6 is the button
Seat 1: rL+Zpv4/vX2BVHcyfh/NXA ($201 in chips)
Seat 2: eDLH1PUXFpvJBNMXBVQcGA ($297.10 in chips)
Seat 4: SiGJDsvRViJX05vHhA80GQ ($249.75 in chips)
Seat 5: 54yWzRRgS0oZ+S6LwZBxMQ ($34.80 in chips)
Seat 6: sTPOWERd9HWPCNrDBwsVjA ($211.95 in chips)
rL+Zpv4/vX2BVHcyfh/NXA: posts small blind $1
eDLH1PUXFpvJBNMXBVQcGA: posts big blind $2
Nsjun4mjI8q0SSBTIp1dIQ: sits out
*** HOLE CARDS ***
SiGJDsvRViJX05vHhA80GQ: folds
54yWzRRgS0oZ+S6LwZBxMQ: folds
sTPOWERd9HWPCNrDBwsVjA: folds
rL+Zpv4/vX2BVHcyfh/NXA: folds
eDLH1PUXFpvJBNMXBVQcGA collected $2 from pot
*** SUMMARY ***
Total pot $2 | Rake $0
Seat 1: rL+Zpv4/vX2BVHcyfh/NXA (small blind) folded before Flop
Seat 2: eDLH1PUXFpvJBNMXBVQcGA (big blind) collected ($2)
Seat 4: SiGJDsvRViJX05vHhA80GQ folded before Flop (didn't bet)
Seat 5: 54yWzRRgS0oZ+S6LwZBxMQ folded before Flop (didn't bet)
Seat 6: sTPOWERd9HWPCNrDBwsVjA (button) folded before Flop (didn't bet)



PokerStars Game #59942017036:  Hold'em No Limit ($1/$2) - 2009/07/01 1:53:26 ET
Table 'LL4bDFyhj5hsMpzaDugJZg' 6-max Seat #4 is the button
Seat 1: ubtx4Z5L+AcK71MTvYiGVw ($214.40 in chips)
Seat 2: TMPDCBmlFGM9C+H58PC4sQ ($21.75 in chips)
Seat 3: opJMdoq0E6TRbAQiweyQuA ($37 in chips)
Seat 4: 8srN1dKQePlsv0GyTada+Q ($387.85 in chips)
Seat 5: on4ebXPJvUBOcHOBMQsRSg ($65 in chips)
Seat 6: mddoKnqZkdOH7AJOJ/i0DA ($212.30 in chips)
on4ebXPJvUBOcHOBMQsRSg: posts small blind $1
mddoKnqZkdOH7AJOJ/i0DA: posts big blind $2
*** HOLE CARDS ***
ubtx4Z5L+AcK71MTvYiGVw: folds
TMPDCBmlFGM9C+H58PC4sQ: folds
opJMdoq0E6TRbAQiweyQuA: raises $2 to $4
8srN1dKQePlsv0GyTada+Q: folds
on4ebXPJvUBOcHOBMQsRSg: raises $14 to $18
mddoKnqZkdOH7AJOJ/i0DA: folds
opJMdoq0E6TRbAQiweyQuA: folds
on4ebXPJvUBOcHOBMQsRSg collected $10 from pot
*** SUMMARY ***
Total pot $10 | Rake $0
Seat 1: ubtx4Z5L+AcK71MTvYiGVw folded before Flop (didn't bet)
Seat 2: TMPDCBmlFGM9C+H58PC4sQ folded before Flop (didn't bet)
Seat 3: opJMdoq0E6TRbAQiweyQuA folded before Flop
Seat 4: 8srN1dKQePlsv0GyTada+Q (button) folded before Flop (didn't bet)
Seat 5: on4ebXPJvUBOcHOBMQsRSg (small blind) collected ($10)
Seat 6: mddoKnqZkdOH7AJOJ/i0DA (big blind) folded before Flop



PokerStars Game #59942017850:  Hold'em No Limit ($1/$2) - 2009/07/01 1:53:28 ET
Table 'NmY84NAf9Mh0ckAckHnh5g' 2-max Seat #1 is the button
Seat 1: 6hvg964TSqZ3AL/0XK9aVQ ($532.20 in chips)
Seat 2: RwDoM55ZeQuI2ADyJhOb2Q ($448.30 in chips)
6hvg964TSqZ3AL/0XK9aVQ: posts small blind $1
RwDoM55ZeQuI2ADyJhOb2Q: posts big blind $2
*** HOLE CARDS ***
6hvg964TSqZ3AL/0XK9aVQ: calls $1
RwDoM55ZeQuI2ADyJhOb2Q: checks
*** FLOP *** [9h Th Kc]
RwDoM55ZeQuI2ADyJhOb2Q: checks
6hvg964TSqZ3AL/0XK9aVQ: bets $4
RwDoM55ZeQuI2ADyJhOb2Q: calls $4
*** TURN *** [9h Th Kc] [8c]
RwDoM55ZeQuI2ADyJhOb2Q: checks
6hvg964TSqZ3AL/0XK9aVQ: bets $10
RwDoM55ZeQuI2ADyJhOb2Q: calls $10
*** RIVER *** [9h Th Kc 8c] [2h]
RwDoM55ZeQuI2ADyJhOb2Q: bets $22
6hvg964TSqZ3AL/0XK9aVQ: raises $30 to $52
RwDoM55ZeQuI2ADyJhOb2Q: calls $30
*** SHOW DOWN ***
6hvg964TSqZ3AL/0XK9aVQ: shows [4s Js] (high card King)
RwDoM55ZeQuI2ADyJhOb2Q: shows [2s Ts] (two pair, Tens and Deuces)
RwDoM55ZeQuI2ADyJhOb2Q collected $135.50 from pot
*** SUMMARY ***
Total pot $136 | Rake $0.50
Board [9h Th Kc 8c 2h]
Seat 1: 6hvg964TSqZ3AL/0XK9aVQ (button) (small blind) showed [4s Js] and lost with high card King
Seat 2: RwDoM55ZeQuI2ADyJhOb2Q (big blind) showed [2s Ts] and won ($135.50) with two pair, Tens and Deuces



PokerStars Game #59942020266:  Hold'em No Limit ($1/$2) - 2009/07/01 1:53:32 ET
Table 'ZzSIe0zTCDv+n6hfbY5tTg' 6-max Seat #1 is the button
Seat 1: VvdR9F3I+2yELkfTVvC1dg ($288.65 in chips)
Seat 2: B87ikIyZ/TzAVeXf38Ny0g ($226 in chips)
Seat 3: gsugPj31Hui3Jefl98MBOA ($346.10 in chips)
Seat 4: 54yWzRRgS0oZ+S6LwZBxMQ ($43.10 in chips)
Seat 5: 3dAbvkxS5NPQTBAbvpinVg ($481.45 in chips)
Seat 6: 09BNF4quPDzanQzM8vc6WA ($33 in chips)
B87ikIyZ/TzAVeXf38Ny0g: posts small blind $1
gsugPj31Hui3Jefl98MBOA: posts big blind $2
*** HOLE CARDS ***
54yWzRRgS0oZ+S6LwZBxMQ: folds
3dAbvkxS5NPQTBAbvpinVg: folds
09BNF4quPDzanQzM8vc6WA: raises $2 to $4
VvdR9F3I+2yELkfTVvC1dg: folds
B87ikIyZ/TzAVeXf38Ny0g: folds
gsugPj31Hui3Jefl98MBOA: calls $2
*** FLOP *** [3c Qs 3s]
gsugPj31Hui3Jefl98MBOA: checks
09BNF4quPDzanQzM8vc6WA: bets $4
gsugPj31Hui3Jefl98MBOA: folds
09BNF4quPDzanQzM8vc6WA collected $8.55 from pot
09BNF4quPDzanQzM8vc6WA: doesn't show hand
*** SUMMARY ***
Total pot $9 | Rake $0.45
Board [3c Qs 3s]
Seat 1: VvdR9F3I+2yELkfTVvC1dg (button) folded before Flop (didn't bet)
Seat 2: B87ikIyZ/TzAVeXf38Ny0g (small blind) folded before Flop
Seat 3: gsugPj31Hui3Jefl98MBOA (big blind) folded on the Flop
Seat 4: 54yWzRRgS0oZ+S6LwZBxMQ folded before Flop (didn't bet)
Seat 5: 3dAbvkxS5NPQTBAbvpinVg folded before Flop (didn't bet)
Seat 6: 09BNF4quPDzanQzM8vc6WA collected ($8.55)



PokerStars Game #59942020856:  Hold'em No Limit ($1/$2) - 2009/07/01 1:53:33 ET
Table 'aSf77Sj8QEnzcc0WaxVD4Q' 6-max Seat #6 is the button
Seat 1: UELtvp+JfwI7XDGVwSxZXA ($176.85 in chips)
Seat 2: vkfxu8f/jMYKUk6Ly4eujw ($200 in chips)
Seat 3: 9dpyyjDTCed6nV7JhaUUpw ($757.50 in chips)
Seat 4: YsLQ3BAvgQHWXMAv3Wv6Hg ($200 in chips)
Seat 5: VvdR9F3I+2yELkfTVvC1dg ($289.15 in chips)
Seat 6: vkoJRf3gidxY1pPi0AFWww ($178.40 in chips)
UELtvp+JfwI7XDGVwSxZXA: posts small blind $1
vkfxu8f/jMYKUk6Ly4eujw: posts big blind $2
*** HOLE CARDS ***
9dpyyjDTCed6nV7JhaUUpw: raises $6 to $8
YsLQ3BAvgQHWXMAv3Wv6Hg: folds
VvdR9F3I+2yELkfTVvC1dg: folds
vkoJRf3gidxY1pPi0AFWww: calls $8
UELtvp+JfwI7XDGVwSxZXA: calls $7
vkfxu8f/jMYKUk6Ly4eujw: folds
*** FLOP *** [Kd Qc 2d]
UELtvp+JfwI7XDGVwSxZXA: checks
9dpyyjDTCed6nV7JhaUUpw: checks
vkoJRf3gidxY1pPi0AFWww: checks
*** TURN *** [Kd Qc 2d] [7s]
UELtvp+JfwI7XDGVwSxZXA: checks
9dpyyjDTCed6nV7JhaUUpw: checks
vkoJRf3gidxY1pPi0AFWww: checks
*** RIVER *** [Kd Qc 2d 7s] [Qs]
UELtvp+JfwI7XDGVwSxZXA: checks
9dpyyjDTCed6nV7JhaUUpw: checks
vkoJRf3gidxY1pPi0AFWww: checks
*** SHOW DOWN ***
UELtvp+JfwI7XDGVwSxZXA: shows [Jc Th] (a pair of Queens)
9dpyyjDTCed6nV7JhaUUpw: mucks hand
vkoJRf3gidxY1pPi0AFWww: shows [Ac 4h] (a pair of Queens - Ace kicker)
vkoJRf3gidxY1pPi0AFWww collected $24.70 from pot
*** SUMMARY ***
Total pot $26 | Rake $1.30
Board [Kd Qc 2d 7s Qs]
Seat 1: UELtvp+JfwI7XDGVwSxZXA (small blind) showed [Jc Th] and lost with a pair of Queens
Seat 2: vkfxu8f/jMYKUk6Ly4eujw (big blind) folded before Flop
Seat 3: 9dpyyjDTCed6nV7JhaUUpw mucked
Seat 4: YsLQ3BAvgQHWXMAv3Wv6Hg folded before Flop (didn't bet)
Seat 5: VvdR9F3I+2yELkfTVvC1dg folded before Flop (didn't bet)
Seat 6: vkoJRf3gidxY1pPi0AFWww (button) showed [Ac 4h] and won ($24.70) with a pair of Queens



PokerStars Game #59942021050:  Hold'em No Limit ($1/$2) - 2009/07/01 1:53:34 ET
Table 'WCA60bDA8ecovUgFSIZkTQ' 9-max Seat #5 is the button
Seat 1: 3RFwE6igZ1BGKOGuab6iiw ($55.70 in chips)
Seat 2: TAfo4veNRaRlzDXMMYS3Jg ($37 in chips)
Seat 3: g7gL2NLJCdZPPV399WKT1w ($54.95 in chips)
Seat 4: IYBKVnE2Basnr88BAhH+bQ ($202.80 in chips)
Seat 5: A+9gcmwAl0eFxxbAwRY1OA ($262.10 in chips)
Seat 6: YoKKKdDDs7gFzP1Z65Sdaw ($98 in chips)
Seat 7: tsTv4D+ne2W0qhUt9HlcMw ($193 in chips)
Seat 8: mJhwEVg7F695DiO+RIhM5g ($257.45 in chips)
Seat 9: ItDFe9gh5QYPQB9vC4ntUA ($200 in chips)
YoKKKdDDs7gFzP1Z65Sdaw: posts small blind $1
tsTv4D+ne2W0qhUt9HlcMw: posts big blind $2
*** HOLE CARDS ***
mJhwEVg7F695DiO+RIhM5g: folds
ItDFe9gh5QYPQB9vC4ntUA: folds
3RFwE6igZ1BGKOGuab6iiw: folds
TAfo4veNRaRlzDXMMYS3Jg: folds
g7gL2NLJCdZPPV399WKT1w: folds
IYBKVnE2Basnr88BAhH+bQ: folds
A+9gcmwAl0eFxxbAwRY1OA: folds
YoKKKdDDs7gFzP1Z65Sdaw: calls $1
tsTv4D+ne2W0qhUt9HlcMw: checks
*** FLOP *** [As Jc 6c]
YoKKKdDDs7gFzP1Z65Sdaw: checks
tsTv4D+ne2W0qhUt9HlcMw: bets $4
YoKKKdDDs7gFzP1Z65Sdaw: folds
tsTv4D+ne2W0qhUt9HlcMw collected $3.80 from pot
*** SUMMARY ***
Total pot $4 | Rake $0.20
Board [As Jc 6c]
Seat 1: 3RFwE6igZ1BGKOGuab6iiw folded before Flop (didn't bet)
Seat 2: TAfo4veNRaRlzDXMMYS3Jg folded before Flop (didn't bet)
Seat 3: g7gL2NLJCdZPPV399WKT1w folded before Flop (didn't bet)
Seat 4: IYBKVnE2Basnr88BAhH+bQ folded before Flop (didn't bet)
Seat 5: A+9gcmwAl0eFxxbAwRY1OA (button) folded before Flop (didn't bet)
Seat 6: YoKKKdDDs7gFzP1Z65Sdaw (small blind) folded on the Flop
Seat 7: tsTv4D+ne2W0qhUt9HlcMw (big blind) collected ($3.80)
Seat 8: mJhwEVg7F695DiO+RIhM5g folded before Flop (didn't bet)
Seat 9: ItDFe9gh5QYPQB9vC4ntUA folded before Flop (didn't bet)



PokerStars Game #59942021654:  Hold'em No Limit ($1/$2) - 2009/07/01 1:53:35 ET
Table '/dyk+YdRGv90j2box35j8w' 6-max Seat #6 is the button
Seat 1: 8srN1dKQePlsv0GyTada+Q ($200 in chips)
Seat 2: qCnEYuAE5y5A7bk6fO5/jQ ($499.20 in chips)
Seat 3: sTPOWERd9HWPCNrDBwsVjA ($209.50 in chips)
Seat 4: 4dMBh/1VTdeUTPCyhCs3UQ ($83 in chips)
Seat 5: VvdR9F3I+2yELkfTVvC1dg ($294.80 in chips)
Seat 6: C3qJBo7uxfFVDluE1lmK2w ($92.25 in chips)
8srN1dKQePlsv0GyTada+Q: posts small blind $1
qCnEYuAE5y5A7bk6fO5/jQ: posts big blind $2
*** HOLE CARDS ***
sTPOWERd9HWPCNrDBwsVjA: folds
4dMBh/1VTdeUTPCyhCs3UQ: raises $5 to $7
VvdR9F3I+2yELkfTVvC1dg: folds
C3qJBo7uxfFVDluE1lmK2w: folds
8srN1dKQePlsv0GyTada+Q: folds
qCnEYuAE5y5A7bk6fO5/jQ: calls $5
*** FLOP *** [5d 4d Qc]
qCnEYuAE5y5A7bk6fO5/jQ: checks
4dMBh/1VTdeUTPCyhCs3UQ: bets $12
qCnEYuAE5y5A7bk6fO5/jQ: folds
4dMBh/1VTdeUTPCyhCs3UQ collected $14.25 from pot
*** SUMMARY ***
Total pot $15 | Rake $0.75
Board [5d 4d Qc]
Seat 1: 8srN1dKQePlsv0GyTada+Q (small blind) folded before Flop
Seat 2: qCnEYuAE5y5A7bk6fO5/jQ (big blind) folded on the Flop
Seat 3: sTPOWERd9HWPCNrDBwsVjA folded before Flop (didn't bet)
Seat 4: 4dMBh/1VTdeUTPCyhCs3UQ collected ($14.25)
Seat 5: VvdR9F3I+2yELkfTVvC1dg folded before Flop (didn't bet)
Seat 6: C3qJBo7uxfFVDluE1lmK2w (button) folded before Flop (didn't bet)



PokerStars Game #59942024166:  Hold'em No Limit ($1/$2) - 2009/07/01 1:53:39 ET
Table '7goFpXy7qyiK5mwx+Ucf6A' 6-max Seat #1 is the button
Seat 1: VHmJJYp7TGQwcWROQ8dqXw ($55.10 in chips)
Seat 2: BWhgxe7gWiYobRbwdG+d2Q ($196 in chips)
Seat 3: mfy7uGZcqA2PVQqEVbJ7+g ($146.35 in chips)
Seat 4: fE+LHW/7rpfXW14g8LhGjA ($45.50 in chips)
Seat 5: /PH6Ffnho4Ysm8S3V/oa+w ($85 in chips)
Seat 6: VvdR9F3I+2yELkfTVvC1dg ($210.60 in chips)
BWhgxe7gWiYobRbwdG+d2Q: posts small blind $1
mfy7uGZcqA2PVQqEVbJ7+g: posts big blind $2
*** HOLE CARDS ***
fE+LHW/7rpfXW14g8LhGjA: calls $2
/PH6Ffnho4Ysm8S3V/oa+w: folds
VvdR9F3I+2yELkfTVvC1dg: raises $6 to $8
VHmJJYp7TGQwcWROQ8dqXw: folds
BWhgxe7gWiYobRbwdG+d2Q: folds
mfy7uGZcqA2PVQqEVbJ7+g: calls $6
fE+LHW/7rpfXW14g8LhGjA: folds
*** FLOP *** [Ac 6h 5h]
mfy7uGZcqA2PVQqEVbJ7+g: checks
VvdR9F3I+2yELkfTVvC1dg: bets $13.50
mfy7uGZcqA2PVQqEVbJ7+g: folds
VvdR9F3I+2yELkfTVvC1dg collected $18.05 from pot
VvdR9F3I+2yELkfTVvC1dg: doesn't show hand
*** SUMMARY ***
Total pot $19 | Rake $0.95
Board [Ac 6h 5h]
Seat 1: VHmJJYp7TGQwcWROQ8dqXw (button) folded before Flop (didn't bet)
Seat 2: BWhgxe7gWiYobRbwdG+d2Q (small blind) folded before Flop
Seat 3: mfy7uGZcqA2PVQqEVbJ7+g (big blind) folded on the Flop
Seat 4: fE+LHW/7rpfXW14g8LhGjA folded before Flop
Seat 5: /PH6Ffnho4Ysm8S3V/oa+w folded before Flop (didn't bet)
Seat 6: VvdR9F3I+2yELkfTVvC1dg collected ($18.05)



PokerStars Game #59942024674:  Hold'em No Limit ($1/$2) - 2009/07/01 1:53:40 ET
Table 'eyAQSIlgc2o1Jxvbve4WGg' 9-max Seat #7 is the button
Seat 1: UZEsV9yKUMqmpYPiOFpaZw ($73 in chips)
Seat 2: kM9CA+2UcdMjbCMbtUCGiA ($226.05 in chips)
Seat 4: CkE3IyJF1KvdaAOmZY5XqQ ($200 in chips)
Seat 5: mIKx5lhIt13X5eZQH0ZeMA ($148.75 in chips)
Seat 6: nXDI8Y/S6POzRwANu3d8hQ ($64 in chips)
Seat 7: u3OrI5uGx9mx1fE7dgr+EA ($85.75 in chips)
Seat 8: 254YPxPJr5Sw58bkD0YqYQ ($200 in chips)
Seat 9: WUlHm+ydPPHG7Lb0rePSdA ($140.20 in chips)
254YPxPJr5Sw58bkD0YqYQ: posts small blind $1
WUlHm+ydPPHG7Lb0rePSdA: posts big blind $2
ice1Sbe19zWIaKYoSmE5tw: sits out
*** HOLE CARDS ***
UZEsV9yKUMqmpYPiOFpaZw: folds
kM9CA+2UcdMjbCMbtUCGiA: raises $3 to $5
CkE3IyJF1KvdaAOmZY5XqQ has timed out
CkE3IyJF1KvdaAOmZY5XqQ: folds
CkE3IyJF1KvdaAOmZY5XqQ is sitting out
mIKx5lhIt13X5eZQH0ZeMA: folds
CkE3IyJF1KvdaAOmZY5XqQ has returned
nXDI8Y/S6POzRwANu3d8hQ: folds
u3OrI5uGx9mx1fE7dgr+EA: calls $5
254YPxPJr5Sw58bkD0YqYQ: folds
WUlHm+ydPPHG7Lb0rePSdA: calls $3
*** FLOP *** [8d Js Th]
WUlHm+ydPPHG7Lb0rePSdA: checks
kM9CA+2UcdMjbCMbtUCGiA: checks
u3OrI5uGx9mx1fE7dgr+EA: bets $2
WUlHm+ydPPHG7Lb0rePSdA: calls $2
nXDI8Y/S6POzRwANu3d8hQ is sitting out
kM9CA+2UcdMjbCMbtUCGiA: folds
*** TURN *** [8d Js Th] [6c]
WUlHm+ydPPHG7Lb0rePSdA: checks
u3OrI5uGx9mx1fE7dgr+EA: bets $10
WUlHm+ydPPHG7Lb0rePSdA: calls $10
*** RIVER *** [8d Js Th 6c] [3c]
WUlHm+ydPPHG7Lb0rePSdA: checks
u3OrI5uGx9mx1fE7dgr+EA: bets $28
WUlHm+ydPPHG7Lb0rePSdA: folds
u3OrI5uGx9mx1fE7dgr+EA collected $38.05 from pot
u3OrI5uGx9mx1fE7dgr+EA: doesn't show hand
*** SUMMARY ***
Total pot $40 | Rake $1.95
Board [8d Js Th 6c 3c]
Seat 1: UZEsV9yKUMqmpYPiOFpaZw folded before Flop (didn't bet)
Seat 2: kM9CA+2UcdMjbCMbtUCGiA folded on the Flop
Seat 4: CkE3IyJF1KvdaAOmZY5XqQ folded before Flop (didn't bet)
Seat 5: mIKx5lhIt13X5eZQH0ZeMA folded before Flop (didn't bet)
Seat 6: nXDI8Y/S6POzRwANu3d8hQ folded before Flop (didn't bet)
Seat 7: u3OrI5uGx9mx1fE7dgr+EA (button) collected ($38.05)
Seat 8: 254YPxPJr5Sw58bkD0YqYQ (small blind) folded before Flop
Seat 9: WUlHm+ydPPHG7Lb0rePSdA (big blind) folded on the River



PokerStars Game #59942025182:  Hold'em No Limit ($1/$2) - 2009/07/01 1:53:41 ET
Table 'CFkQcfWjKccZaZDf71FK+w' 6-max Seat #2 is the button
Seat 1: vkfxu8f/jMYKUk6Ly4eujw ($224.05 in chips)
Seat 2: ewN/vzF22+/gdzjIKBOlkA ($228.80 in chips)
Seat 3: TMPDCBmlFGM9C+H58PC4sQ ($42.75 in chips)
Seat 4: opJMdoq0E6TRbAQiweyQuA ($40 in chips)
Seat 5: 2lOU1DcvUZaMcxZ95XfzXw ($120.85 in chips)
Seat 6: ORVqY3rf9X6ANA/8s+On2Q ($28.35 in chips)
TMPDCBmlFGM9C+H58PC4sQ: posts small blind $1
opJMdoq0E6TRbAQiweyQuA: posts big blind $2
*** HOLE CARDS ***
2lOU1DcvUZaMcxZ95XfzXw: folds
ORVqY3rf9X6ANA/8s+On2Q: calls $2
vkfxu8f/jMYKUk6Ly4eujw: folds
ewN/vzF22+/gdzjIKBOlkA: calls $2
TMPDCBmlFGM9C+H58PC4sQ: raises $6 to $8
opJMdoq0E6TRbAQiweyQuA: folds
ORVqY3rf9X6ANA/8s+On2Q: calls $6
ewN/vzF22+/gdzjIKBOlkA: calls $6
*** FLOP *** [2d 5s As]
TMPDCBmlFGM9C+H58PC4sQ: bets $8
ORVqY3rf9X6ANA/8s+On2Q: folds
ewN/vzF22+/gdzjIKBOlkA: calls $8
*** TURN *** [2d 5s As] [8s]
TMPDCBmlFGM9C+H58PC4sQ: bets $20
ewN/vzF22+/gdzjIKBOlkA: folds
TMPDCBmlFGM9C+H58PC4sQ collected $40 from pot
*** SUMMARY ***
Total pot $42 | Rake $2
Board [2d 5s As 8s]
Seat 1: vkfxu8f/jMYKUk6Ly4eujw folded before Flop (didn't bet)
Seat 2: ewN/vzF22+/gdzjIKBOlkA (button) folded on the Turn
Seat 3: TMPDCBmlFGM9C+H58PC4sQ (small blind) collected ($40)
Seat 4: opJMdoq0E6TRbAQiweyQuA (big blind) folded before Flop
Seat 5: 2lOU1DcvUZaMcxZ95XfzXw folded before Flop (didn't bet)
Seat 6: ORVqY3rf9X6ANA/8s+On2Q folded on the Flop



PokerStars Game #59942025852:  Hold'em No Limit ($1/$2) - 2009/07/01 1:53:43 ET
Table 'pPQgcj9XT9CHBsbo1WTBug' 6-max Seat #6 is the button
Seat 1: DFVYDA6dKQy7R7mGIKogZA ($152.45 in chips)
Seat 2: qXDd0ZyMIse0OBu8pxeQ3Q ($200 in chips)
Seat 3: sSAA879uXOGR+8Mf3zLa6Q ($134.90 in chips)
Seat 4: cwfuMyvDC7J7SqX2leDC8g ($52.20 in chips)
Seat 5: vkfxu8f/jMYKUk6Ly4eujw ($123.60 in chips)
Seat 6: Yr7pZltpy3IUNdKS9PCEiw ($304.80 in chips)
DFVYDA6dKQy7R7mGIKogZA: posts small blind $1
qXDd0ZyMIse0OBu8pxeQ3Q: posts big blind $2
*** HOLE CARDS ***
sSAA879uXOGR+8Mf3zLa6Q: folds
cwfuMyvDC7J7SqX2leDC8g: folds
vkfxu8f/jMYKUk6Ly4eujw: folds
Yr7pZltpy3IUNdKS9PCEiw: folds
DFVYDA6dKQy7R7mGIKogZA: folds
qXDd0ZyMIse0OBu8pxeQ3Q collected $2 from pot
*** SUMMARY ***
Total pot $2 | Rake $0
Seat 1: DFVYDA6dKQy7R7mGIKogZA (small blind) folded before Flop
Seat 2: qXDd0ZyMIse0OBu8pxeQ3Q (big blind) collected ($2)
Seat 3: sSAA879uXOGR+8Mf3zLa6Q folded before Flop (didn't bet)
Seat 4: cwfuMyvDC7J7SqX2leDC8g folded before Flop (didn't bet)
Seat 5: vkfxu8f/jMYKUk6Ly4eujw folded before Flop (didn't bet)
Seat 6: Yr7pZltpy3IUNdKS9PCEiw (button) folded before Flop (didn't bet)



PokerStars Game #59942026044:  Hold'em No Limit ($1/$2) - 2009/07/01 1:53:43 ET
Table '4NGNnZ/osQfNq6abYqkJeA' 6-max Seat #3 is the button
Seat 1: 0Bc+WhbOvaaWIMmmui3q0g ($140.35 in chips)
Seat 2: 669iGNwYwgRZg3nhS+aDAQ ($107.75 in chips)
Seat 3: 54yWzRRgS0oZ+S6LwZBxMQ ($73.35 in chips)
Seat 4: sY+4Uuh5z/6AbXXaCS10jw ($298.10 in chips)
Seat 5: VvdR9F3I+2yELkfTVvC1dg ($211.80 in chips)
Seat 6: /PH6Ffnho4Ysm8S3V/oa+w ($48.20 in chips)
sY+4Uuh5z/6AbXXaCS10jw: posts small blind $1
VvdR9F3I+2yELkfTVvC1dg: posts big blind $2
0Bc+WhbOvaaWIMmmui3q0g: posts big blind $2
*** HOLE CARDS ***
/PH6Ffnho4Ysm8S3V/oa+w: folds
0Bc+WhbOvaaWIMmmui3q0g: checks
669iGNwYwgRZg3nhS+aDAQ: folds
54yWzRRgS0oZ+S6LwZBxMQ: folds
sY+4Uuh5z/6AbXXaCS10jw: folds
VvdR9F3I+2yELkfTVvC1dg: checks
*** FLOP *** [Jh 2h Ks]
VvdR9F3I+2yELkfTVvC1dg: checks
0Bc+WhbOvaaWIMmmui3q0g: checks
*** TURN *** [Jh 2h Ks] [Kd]
VvdR9F3I+2yELkfTVvC1dg: checks
0Bc+WhbOvaaWIMmmui3q0g: bets $4
VvdR9F3I+2yELkfTVvC1dg: folds
0Bc+WhbOvaaWIMmmui3q0g collected $4.75 from pot
*** SUMMARY ***
Total pot $5 | Rake $0.25
Board [Jh 2h Ks Kd]
Seat 1: 0Bc+WhbOvaaWIMmmui3q0g collected ($4.75)
Seat 2: 669iGNwYwgRZg3nhS+aDAQ folded before Flop (didn't bet)
Seat 3: 54yWzRRgS0oZ+S6LwZBxMQ (button) folded before Flop (didn't bet)
Seat 4: sY+4Uuh5z/6AbXXaCS10jw (small blind) folded before Flop
Seat 5: VvdR9F3I+2yELkfTVvC1dg (big blind) folded on the Turn
Seat 6: /PH6Ffnho4Ysm8S3V/oa+w folded before Flop (didn't bet)



PokerStars Game #59942026726:  Hold'em No Limit ($1/$2) - 2009/07/01 1:53:44 ET
Table 'gnHBqWll9O3fxG7Ojkz/ng' 9-max Seat #5 is the button
Seat 1: MtdNf9cdM7+0CSU0dx4USA ($77.35 in chips)
Seat 2: H6Z4+qu8gR0VUiPOijndVg ($335.30 in chips)
Seat 3: 5Q8U6iZbeO7xJSS4qvDP5g ($238.10 in chips)
Seat 4: nXDI8Y/S6POzRwANu3d8hQ ($27.55 in chips)
Seat 5: rBQDMkKm9cZn6M9NPsiVew ($166.15 in chips)
Seat 6: KqHysDSpCPaPyK3tJC1aEw ($200 in chips)
Seat 7: 254YPxPJr5Sw58bkD0YqYQ ($203 in chips)
Seat 8: cM6efHzdxoqYm0EQKP4TTQ ($110.95 in chips)
Seat 9: GX1heJ+DSsvm7gzSPsYhhQ ($33.15 in chips)
KqHysDSpCPaPyK3tJC1aEw: posts small blind $1
254YPxPJr5Sw58bkD0YqYQ: posts big blind $2
*** HOLE CARDS ***
cM6efHzdxoqYm0EQKP4TTQ: calls $2
GX1heJ+DSsvm7gzSPsYhhQ: folds
MtdNf9cdM7+0CSU0dx4USA: folds
H6Z4+qu8gR0VUiPOijndVg: folds
5Q8U6iZbeO7xJSS4qvDP5g: folds
nXDI8Y/S6POzRwANu3d8hQ: raises $10 to $12
rBQDMkKm9cZn6M9NPsiVew: folds
KqHysDSpCPaPyK3tJC1aEw: folds
254YPxPJr5Sw58bkD0YqYQ: folds
cM6efHzdxoqYm0EQKP4TTQ: calls $10
*** FLOP *** [7h 2h 8d]
cM6efHzdxoqYm0EQKP4TTQ: checks
nXDI8Y/S6POzRwANu3d8hQ: bets $10
cM6efHzdxoqYm0EQKP4TTQ: raises $14 to $24
nXDI8Y/S6POzRwANu3d8hQ: calls $5.55 and is all-in
*** TURN *** [7h 2h 8d] [Jd]
*** RIVER *** [7h 2h 8d Jd] [Ks]
*** SHOW DOWN ***
cM6efHzdxoqYm0EQKP4TTQ: shows [9c Td] (a straight, Seven to Jack)
nXDI8Y/S6POzRwANu3d8hQ: mucks hand
nXDI8Y/S6POzRwANu3d8hQ is sitting out
cM6efHzdxoqYm0EQKP4TTQ collected $55.30 from pot
*** SUMMARY ***
Total pot $58.10 | Rake $2.80
Board [7h 2h 8d Jd Ks]
Seat 1: MtdNf9cdM7+0CSU0dx4USA folded before Flop (didn't bet)
Seat 2: H6Z4+qu8gR0VUiPOijndVg folded before Flop (didn't bet)
Seat 3: 5Q8U6iZbeO7xJSS4qvDP5g folded before Flop (didn't bet)
Seat 4: nXDI8Y/S6POzRwANu3d8hQ mucked
Seat 5: rBQDMkKm9cZn6M9NPsiVew (button) folded before Flop (didn't bet)
Seat 6: KqHysDSpCPaPyK3tJC1aEw (small blind) folded before Flop
Seat 7: 254YPxPJr5Sw58bkD0YqYQ (big blind) folded before Flop
Seat 8: cM6efHzdxoqYm0EQKP4TTQ showed [9c Td] and won ($55.30) with a straight, Seven to Jack
Seat 9: GX1heJ+DSsvm7gzSPsYhhQ folded before Flop (didn't bet)



PokerStars Game #59942026998:  Hold'em No Limit ($1/$2) - 2009/07/01 1:53:45 ET
Table 'TsEDkiO4tzCTCzJ7tNdEqw' 6-max Seat #4 is the button
Seat 2: 4dcDwIHRm96PwtqkpQiuiA ($83.70 in chips)
Seat 3: ubtx4Z5L+AcK71MTvYiGVw ($253.20 in chips)
Seat 4: K8MXCrNAVYlMnnCeM32Kxw ($75.35 in chips)
Seat 5: VvdR9F3I+2yELkfTVvC1dg ($241.35 in chips)
Seat 6: uCqEjnxh2/vFBjKYkfTOkw ($284.80 in chips)
VvdR9F3I+2yELkfTVvC1dg: posts small blind $1
uCqEjnxh2/vFBjKYkfTOkw: posts big blind $2
Nsjun4mjI8q0SSBTIp1dIQ: sits out
*** HOLE CARDS ***
4dcDwIHRm96PwtqkpQiuiA: folds
ubtx4Z5L+AcK71MTvYiGVw: folds
K8MXCrNAVYlMnnCeM32Kxw: folds
VvdR9F3I+2yELkfTVvC1dg: raises $2 to $4
uCqEjnxh2/vFBjKYkfTOkw: calls $2
*** FLOP *** [9c 5d 7s]
VvdR9F3I+2yELkfTVvC1dg: bets $5.70
uCqEjnxh2/vFBjKYkfTOkw: calls $5.70
*** TURN *** [9c 5d 7s] [Kh]
VvdR9F3I+2yELkfTVvC1dg: bets $13.45
uCqEjnxh2/vFBjKYkfTOkw: folds
VvdR9F3I+2yELkfTVvC1dg collected $18.45 from pot
VvdR9F3I+2yELkfTVvC1dg: doesn't show hand
*** SUMMARY ***
Total pot $19.40 | Rake $0.95
Board [9c 5d 7s Kh]
Seat 2: 4dcDwIHRm96PwtqkpQiuiA folded before Flop (didn't bet)
Seat 3: ubtx4Z5L+AcK71MTvYiGVw folded before Flop (didn't bet)
Seat 4: K8MXCrNAVYlMnnCeM32Kxw (button) folded before Flop (didn't bet)
Seat 5: VvdR9F3I+2yELkfTVvC1dg (small blind) collected ($18.45)
Seat 6: uCqEjnxh2/vFBjKYkfTOkw (big blind) folded on the Turn



PokerStars Game #59942027428:  Hold'em No Limit ($1/$2) - 2009/07/01 1:53:46 ET
Table 'W9UeSV0aoPjh5SFSxM8jUQ' 9-max Seat #2 is the button
Seat 1: mIKx5lhIt13X5eZQH0ZeMA ($6.85 in chips)
Seat 2: KqHysDSpCPaPyK3tJC1aEw ($207.05 in chips)
Seat 3: ItDFe9gh5QYPQB9vC4ntUA ($200 in chips)
Seat 4: 4YA/sQy1Emm680zhbPUjow ($149.60 in chips)
Seat 5: ri8CLkX3e9JF34dQNbsHGA ($82 in chips)
Seat 6: 254YPxPJr5Sw58bkD0YqYQ ($216.70 in chips)
Seat 7: TAfo4veNRaRlzDXMMYS3Jg ($39 in chips)
Seat 8: odhvI/CZeMsPyo1n1U7+hA ($49.10 in chips)
Seat 9: Q104K4iDGcqOlVrjAkzPEA ($96.55 in chips)
ItDFe9gh5QYPQB9vC4ntUA: posts small blind $1
4YA/sQy1Emm680zhbPUjow: posts big blind $2
*** HOLE CARDS ***
ri8CLkX3e9JF34dQNbsHGA: folds
254YPxPJr5Sw58bkD0YqYQ: folds
TAfo4veNRaRlzDXMMYS3Jg: folds
odhvI/CZeMsPyo1n1U7+hA: folds
Q104K4iDGcqOlVrjAkzPEA: folds
mIKx5lhIt13X5eZQH0ZeMA: folds
KqHysDSpCPaPyK3tJC1aEw: folds
ItDFe9gh5QYPQB9vC4ntUA: folds
4YA/sQy1Emm680zhbPUjow collected $2 from pot
*** SUMMARY ***
Total pot $2 | Rake $0
Seat 1: mIKx5lhIt13X5eZQH0ZeMA folded before Flop (didn't bet)
Seat 2: KqHysDSpCPaPyK3tJC1aEw (button) folded before Flop (didn't bet)
Seat 3: ItDFe9gh5QYPQB9vC4ntUA (small blind) folded before Flop
Seat 4: 4YA/sQy1Emm680zhbPUjow (big blind) collected ($2)
Seat 5: ri8CLkX3e9JF34dQNbsHGA folded before Flop (didn't bet)
Seat 6: 254YPxPJr5Sw58bkD0YqYQ folded before Flop (didn't bet)
Seat 7: TAfo4veNRaRlzDXMMYS3Jg folded before Flop (didn't bet)
Seat 8: odhvI/CZeMsPyo1n1U7+hA folded before Flop (didn't bet)
Seat 9: Q104K4iDGcqOlVrjAkzPEA folded before Flop (didn't bet)



PokerStars Game #59942029542:  Hold'em No Limit ($1/$2) - 2009/07/01 1:53:50 ET
Table '+hSnXFQrGw1PlVgTnuj+sA' 6-max Seat #2 is the button
Seat 1: fb8ooqw9ZsZtBsZTZQLNrQ ($50.70 in chips)
Seat 2: 54yWzRRgS0oZ+S6LwZBxMQ ($14.10 in chips)
Seat 3: cupOBdycmBLQKdVftyAksg ($41.10 in chips)
Seat 4: TRSUrOQh3x1NGeD+dH4yoA ($94.10 in chips)
Seat 5: PZzUwZiFNhCLi6Ouh5ZlmQ ($200 in chips)
Seat 6: 7zM38baFvmCNB/F80oE0cQ ($67.50 in chips)
cupOBdycmBLQKdVftyAksg: posts small blind $1
TRSUrOQh3x1NGeD+dH4yoA: posts big blind $2
*** HOLE CARDS ***
PZzUwZiFNhCLi6Ouh5ZlmQ: folds
7zM38baFvmCNB/F80oE0cQ: calls $2
fb8ooqw9ZsZtBsZTZQLNrQ: folds
54yWzRRgS0oZ+S6LwZBxMQ: folds
cupOBdycmBLQKdVftyAksg: raises $4 to $6
TRSUrOQh3x1NGeD+dH4yoA: calls $4
7zM38baFvmCNB/F80oE0cQ: calls $4
*** FLOP *** [Td Kc Ad]
cupOBdycmBLQKdVftyAksg: bets $4
TRSUrOQh3x1NGeD+dH4yoA: calls $4
7zM38baFvmCNB/F80oE0cQ: calls $4
*** TURN *** [Td Kc Ad] [Qs]
cupOBdycmBLQKdVftyAksg: checks
TRSUrOQh3x1NGeD+dH4yoA: bets $6
7zM38baFvmCNB/F80oE0cQ: calls $6
cupOBdycmBLQKdVftyAksg: folds
*** RIVER *** [Td Kc Ad Qs] [Ks]
TRSUrOQh3x1NGeD+dH4yoA: bets $12
7zM38baFvmCNB/F80oE0cQ: folds
TRSUrOQh3x1NGeD+dH4yoA collected $40 from pot
TRSUrOQh3x1NGeD+dH4yoA: doesn't show hand
*** SUMMARY ***
Total pot $42 | Rake $2
Board [Td Kc Ad Qs Ks]
Seat 1: fb8ooqw9ZsZtBsZTZQLNrQ folded before Flop (didn't bet)
Seat 2: 54yWzRRgS0oZ+S6LwZBxMQ (button) folded before Flop (didn't bet)
Seat 3: cupOBdycmBLQKdVftyAksg (small blind) folded on the Turn
Seat 4: TRSUrOQh3x1NGeD+dH4yoA (big blind) collected ($40)
Seat 5: PZzUwZiFNhCLi6Ouh5ZlmQ folded before Flop (didn't bet)
Seat 6: 7zM38baFvmCNB/F80oE0cQ folded on the River



PokerStars Game #59942029798:  Hold'em No Limit ($1/$2) - 2009/07/01 1:53:50 ET
Table 'C4lkCXY2PWy6z4vsAe5NGQ' 6-max Seat #6 is the button
Seat 1: bWbV4MVB/vVpiES1Ut4hew ($198 in chips)
Seat 2: 6hRJ68JkbJq6MYI9o5bUnQ ($56.95 in chips)
Seat 3: sTPOWERd9HWPCNrDBwsVjA ($135.50 in chips)
Seat 4: VvdR9F3I+2yELkfTVvC1dg ($204 in chips)
Seat 5: /PH6Ffnho4Ysm8S3V/oa+w ($58.65 in chips)
Seat 6: B87ikIyZ/TzAVeXf38Ny0g ($723.50 in chips)
bWbV4MVB/vVpiES1Ut4hew: posts small blind $1
6hRJ68JkbJq6MYI9o5bUnQ: posts big blind $2
*** HOLE CARDS ***
sTPOWERd9HWPCNrDBwsVjA: raises $6 to $8
VvdR9F3I+2yELkfTVvC1dg: folds
/PH6Ffnho4Ysm8S3V/oa+w: folds
B87ikIyZ/TzAVeXf38Ny0g: calls $8
bWbV4MVB/vVpiES1Ut4hew: folds
6hRJ68JkbJq6MYI9o5bUnQ: folds
*** FLOP *** [Jc 9d Ac]
sTPOWERd9HWPCNrDBwsVjA: checks
B87ikIyZ/TzAVeXf38Ny0g: bets $12
sTPOWERd9HWPCNrDBwsVjA: calls $12
*** TURN *** [Jc 9d Ac] [4d]
sTPOWERd9HWPCNrDBwsVjA: bets $24
B87ikIyZ/TzAVeXf38Ny0g: raises $679.50 to $703.50 and is all-in
sTPOWERd9HWPCNrDBwsVjA: folds
B87ikIyZ/TzAVeXf38Ny0g collected $88 from pot
B87ikIyZ/TzAVeXf38Ny0g: doesn't show hand
*** SUMMARY ***
Total pot $91 | Rake $3
Board [Jc 9d Ac 4d]
Seat 1: bWbV4MVB/vVpiES1Ut4hew (small blind) folded before Flop
Seat 2: 6hRJ68JkbJq6MYI9o5bUnQ (big blind) folded before Flop
Seat 3: sTPOWERd9HWPCNrDBwsVjA folded on the Turn
Seat 4: VvdR9F3I+2yELkfTVvC1dg folded before Flop (didn't bet)
Seat 5: /PH6Ffnho4Ysm8S3V/oa+w folded before Flop (didn't bet)
Seat 6: B87ikIyZ/TzAVeXf38Ny0g (button) collected ($88)



PokerStars Game #59942030572:  Hold'em No Limit ($1/$2) - 2009/07/01 1:53:52 ET
Table 'uJ9juaXXg9yIcSU8amxaXQ' 6-max Seat #6 is the button
Seat 1: JsqOjN/eHz0uYVf/PyUJ6Q ($117.95 in chips)
Seat 2: VvdR9F3I+2yELkfTVvC1dg ($217.45 in chips)
Seat 3: qXDd0ZyMIse0OBu8pxeQ3Q ($239.40 in chips)
Seat 4: zNjJ/y4emmF+vzrCDd+ooA ($270.30 in chips)
Seat 5: YsLQ3BAvgQHWXMAv3Wv6Hg ($213.70 in chips)
Seat 6: /PH6Ffnho4Ysm8S3V/oa+w ($40 in chips)
JsqOjN/eHz0uYVf/PyUJ6Q: posts small blind $1
VvdR9F3I+2yELkfTVvC1dg: posts big blind $2
*** HOLE CARDS ***
qXDd0ZyMIse0OBu8pxeQ3Q: folds
zNjJ/y4emmF+vzrCDd+ooA: folds
YsLQ3BAvgQHWXMAv3Wv6Hg: folds
/PH6Ffnho4Ysm8S3V/oa+w: folds
JsqOjN/eHz0uYVf/PyUJ6Q: folds
VvdR9F3I+2yELkfTVvC1dg collected $2 from pot
VvdR9F3I+2yELkfTVvC1dg: doesn't show hand
*** SUMMARY ***
Total pot $2 | Rake $0
Seat 1: JsqOjN/eHz0uYVf/PyUJ6Q (small blind) folded before Flop
Seat 2: VvdR9F3I+2yELkfTVvC1dg (big blind) collected ($2)
Seat 3: qXDd0ZyMIse0OBu8pxeQ3Q folded before Flop (didn't bet)
Seat 4: zNjJ/y4emmF+vzrCDd+ooA folded before Flop (didn't bet)
Seat 5: YsLQ3BAvgQHWXMAv3Wv6Hg folded before Flop (didn't bet)
Seat 6: /PH6Ffnho4Ysm8S3V/oa+w (button) folded before Flop (didn't bet)



PokerStars Game #59942030502:  Hold'em No Limit ($1/$2) - 2009/07/01 1:53:52 ET
Table 'G1Oqdy4Pqdb5gtx40rUBzA' 6-max Seat #1 is the button
Seat 1: 4dMBh/1VTdeUTPCyhCs3UQ ($45.05 in chips)
Seat 2: m7mYVfnCOK5TE/VkN/FhOg ($234.75 in chips)
Seat 3: VvdR9F3I+2yELkfTVvC1dg ($419.90 in chips)
Seat 4: B87ikIyZ/TzAVeXf38Ny0g ($215.70 in chips)
Seat 5: F1+Ml47qRQWunzPnGhLLzQ ($197 in chips)
Seat 6: qCnEYuAE5y5A7bk6fO5/jQ ($200 in chips)
m7mYVfnCOK5TE/VkN/FhOg: posts small blind $1
VvdR9F3I+2yELkfTVvC1dg: posts big blind $2
*** HOLE CARDS ***
B87ikIyZ/TzAVeXf38Ny0g: raises $4 to $6
F1+Ml47qRQWunzPnGhLLzQ: raises $6 to $12
qCnEYuAE5y5A7bk6fO5/jQ: folds
4dMBh/1VTdeUTPCyhCs3UQ: folds
m7mYVfnCOK5TE/VkN/FhOg: folds
VvdR9F3I+2yELkfTVvC1dg: folds
B87ikIyZ/TzAVeXf38Ny0g: calls $6
*** FLOP *** [Th 4d 4c]
B87ikIyZ/TzAVeXf38Ny0g: checks
F1+Ml47qRQWunzPnGhLLzQ: bets $12
B87ikIyZ/TzAVeXf38Ny0g: calls $12
*** TURN *** [Th 4d 4c] [2c]
B87ikIyZ/TzAVeXf38Ny0g: checks
F1+Ml47qRQWunzPnGhLLzQ: bets $40
B87ikIyZ/TzAVeXf38Ny0g: folds
F1+Ml47qRQWunzPnGhLLzQ collected $48.55 from pot
F1+Ml47qRQWunzPnGhLLzQ: doesn't show hand
*** SUMMARY ***
Total pot $51 | Rake $2.45
Board [Th 4d 4c 2c]
Seat 1: 4dMBh/1VTdeUTPCyhCs3UQ (button) folded before Flop (didn't bet)
Seat 2: m7mYVfnCOK5TE/VkN/FhOg (small blind) folded before Flop
Seat 3: VvdR9F3I+2yELkfTVvC1dg (big blind) folded before Flop
Seat 4: B87ikIyZ/TzAVeXf38Ny0g folded on the Turn
Seat 5: F1+Ml47qRQWunzPnGhLLzQ collected ($48.55)
Seat 6: qCnEYuAE5y5A7bk6fO5/jQ folded before Flop (didn't bet)



PokerStars Game #59942032648:  Hold'em No Limit ($1/$2) - 2009/07/01 1:53:55 ET
Table '3WCXyaiCAbqSShQu7FIjvA' 9-max Seat #7 is the button
Seat 1: kTCkABD1UUldS9DFRGfCwQ ($137.75 in chips)
Seat 3: 5Q8U6iZbeO7xJSS4qvDP5g ($267.25 in chips)
Seat 4: waEF/+pxZTxNo4FvsORuXg ($101.40 in chips)
Seat 5: CkE3IyJF1KvdaAOmZY5XqQ ($207.90 in chips)
Seat 6: 5jQlngvMSqM/WoonOcR5kw ($277.50 in chips)
Seat 7: nXDI8Y/S6POzRwANu3d8hQ ($41.10 in chips)
Seat 8: +T/63sAeZzWyHchahJ36GQ ($35 in chips)
Seat 9: FiXPLJyqb24l32QST2TInw ($117.20 in chips)
+T/63sAeZzWyHchahJ36GQ: posts small blind $1
FiXPLJyqb24l32QST2TInw: posts big blind $2
254YPxPJr5Sw58bkD0YqYQ: sits out
*** HOLE CARDS ***
kTCkABD1UUldS9DFRGfCwQ: folds
5Q8U6iZbeO7xJSS4qvDP5g: raises $6 to $8
waEF/+pxZTxNo4FvsORuXg: folds
CkE3IyJF1KvdaAOmZY5XqQ has timed out
CkE3IyJF1KvdaAOmZY5XqQ: folds
CkE3IyJF1KvdaAOmZY5XqQ is sitting out
5jQlngvMSqM/WoonOcR5kw: folds
nXDI8Y/S6POzRwANu3d8hQ: folds
nXDI8Y/S6POzRwANu3d8hQ is sitting out
+T/63sAeZzWyHchahJ36GQ: folds
CkE3IyJF1KvdaAOmZY5XqQ has returned
FiXPLJyqb24l32QST2TInw: calls $6
*** FLOP *** [5d Ac 9c]
FiXPLJyqb24l32QST2TInw: checks
5Q8U6iZbeO7xJSS4qvDP5g: bets $12
FiXPLJyqb24l32QST2TInw: calls $12
*** TURN *** [5d Ac 9c] [2d]
FiXPLJyqb24l32QST2TInw: checks
5Q8U6iZbeO7xJSS4qvDP5g: checks
*** RIVER *** [5d Ac 9c 2d] [6d]
FiXPLJyqb24l32QST2TInw: checks
5Q8U6iZbeO7xJSS4qvDP5g: checks
*** SHOW DOWN ***
FiXPLJyqb24l32QST2TInw: shows [Td Th] (a pair of Tens)
5Q8U6iZbeO7xJSS4qvDP5g: mucks hand
FiXPLJyqb24l32QST2TInw collected $39 from pot
*** SUMMARY ***
Total pot $41 | Rake $2
Board [5d Ac 9c 2d 6d]
Seat 1: kTCkABD1UUldS9DFRGfCwQ folded before Flop (didn't bet)
Seat 3: 5Q8U6iZbeO7xJSS4qvDP5g mucked
Seat 4: waEF/+pxZTxNo4FvsORuXg folded before Flop (didn't bet)
Seat 5: CkE3IyJF1KvdaAOmZY5XqQ folded before Flop (didn't bet)
Seat 6: 5jQlngvMSqM/WoonOcR5kw folded before Flop (didn't bet)
Seat 7: nXDI8Y/S6POzRwANu3d8hQ (button) folded before Flop (didn't bet)
Seat 8: +T/63sAeZzWyHchahJ36GQ (small blind) folded before Flop
Seat 9: FiXPLJyqb24l32QST2TInw (big blind) showed [Td Th] and won ($39) with a pair of Tens



PokerStars Game #59942033396:  Hold'em No Limit ($1/$2) - 2009/07/01 1:53:57 ET
Table 'ztv6V3FN2bQ9nmJPPdx6nQ' 6-max Seat #1 is the button
Seat 1: 6fLdOUCRtX71xbVRhJEq8w ($281.35 in chips)
Seat 2: 5Y+ZGWLI4gnlpApDX5vy1A ($372.05 in chips)
Seat 3: XP9UmPc7hfMVafyEiwJMAA ($200 in chips)
Seat 4: UaZ5yj+6LjtWqMQg2QskUw ($105.40 in chips)
Seat 5: sTPOWERd9HWPCNrDBwsVjA ($211.60 in chips)
Seat 6: mfy7uGZcqA2PVQqEVbJ7+g ($185 in chips)
5Y+ZGWLI4gnlpApDX5vy1A: posts small blind $1
XP9UmPc7hfMVafyEiwJMAA: posts big blind $2
*** HOLE CARDS ***
UaZ5yj+6LjtWqMQg2QskUw: folds
sTPOWERd9HWPCNrDBwsVjA: folds
mfy7uGZcqA2PVQqEVbJ7+g: folds
6fLdOUCRtX71xbVRhJEq8w: raises $4 to $6
5Y+ZGWLI4gnlpApDX5vy1A: folds
XP9UmPc7hfMVafyEiwJMAA: folds
6fLdOUCRtX71xbVRhJEq8w collected $5 from pot
*** SUMMARY ***
Total pot $5 | Rake $0
Seat 1: 6fLdOUCRtX71xbVRhJEq8w (button) collected ($5)
Seat 2: 5Y+ZGWLI4gnlpApDX5vy1A (small blind) folded before Flop
Seat 3: XP9UmPc7hfMVafyEiwJMAA (big blind) folded before Flop
Seat 4: UaZ5yj+6LjtWqMQg2QskUw folded before Flop (didn't bet)
Seat 5: sTPOWERd9HWPCNrDBwsVjA folded before Flop (didn't bet)
Seat 6: mfy7uGZcqA2PVQqEVbJ7+g folded before Flop (didn't bet)



PokerStars Game #59942033342:  Hold'em No Limit ($1/$2) - 2009/07/01 1:53:57 ET
Table 'P/yCfYl1GfGsu/e6DxDy/A' 2-max Seat #2 is the button
Seat 1: 7fOCUy3x9hdkmXkkDNolGQ ($1152 in chips)
Seat 2: RwDoM55ZeQuI2ADyJhOb2Q ($316.50 in chips)
RwDoM55ZeQuI2ADyJhOb2Q: posts small blind $1
7fOCUy3x9hdkmXkkDNolGQ: posts big blind $2
*** HOLE CARDS ***
RwDoM55ZeQuI2ADyJhOb2Q: raises $4 to $6
7fOCUy3x9hdkmXkkDNolGQ: calls $4
*** FLOP *** [Ks 5s 8h]
7fOCUy3x9hdkmXkkDNolGQ: checks
RwDoM55ZeQuI2ADyJhOb2Q: checks
*** TURN *** [Ks 5s 8h] [9d]
7fOCUy3x9hdkmXkkDNolGQ: checks
RwDoM55ZeQuI2ADyJhOb2Q: checks
*** RIVER *** [Ks 5s 8h 9d] [2d]
7fOCUy3x9hdkmXkkDNolGQ: checks
RwDoM55ZeQuI2ADyJhOb2Q: checks
*** SHOW DOWN ***
7fOCUy3x9hdkmXkkDNolGQ: shows [6h Jh] (high card King)
RwDoM55ZeQuI2ADyJhOb2Q: mucks hand
7fOCUy3x9hdkmXkkDNolGQ collected $11.50 from pot
*** SUMMARY ***
Total pot $12 | Rake $0.50
Board [Ks 5s 8h 9d 2d]
Seat 1: 7fOCUy3x9hdkmXkkDNolGQ (big blind) showed [6h Jh] and won ($11.50) with high card King
Seat 2: RwDoM55ZeQuI2ADyJhOb2Q (button) (small blind) mucked



PokerStars Game #59942034072:  Hold'em No Limit ($1/$2) - 2009/07/01 1:53:58 ET
Table 'LL4bDFyhj5hsMpzaDugJZg' 6-max Seat #5 is the button
Seat 1: ubtx4Z5L+AcK71MTvYiGVw ($214.40 in chips)
Seat 2: TMPDCBmlFGM9C+H58PC4sQ ($21.75 in chips)
Seat 3: opJMdoq0E6TRbAQiweyQuA ($40 in chips)
Seat 4: 8srN1dKQePlsv0GyTada+Q ($387.85 in chips)
Seat 5: on4ebXPJvUBOcHOBMQsRSg ($71 in chips)
Seat 6: mddoKnqZkdOH7AJOJ/i0DA ($210.30 in chips)
mddoKnqZkdOH7AJOJ/i0DA: posts small blind $1
ubtx4Z5L+AcK71MTvYiGVw: posts big blind $2
*** HOLE CARDS ***
TMPDCBmlFGM9C+H58PC4sQ: folds
opJMdoq0E6TRbAQiweyQuA: folds
8srN1dKQePlsv0GyTada+Q: folds
on4ebXPJvUBOcHOBMQsRSg: raises $4 to $6
mddoKnqZkdOH7AJOJ/i0DA: folds
ubtx4Z5L+AcK71MTvYiGVw: calls $4
*** FLOP *** [Jc 5c 8c]
ubtx4Z5L+AcK71MTvYiGVw: checks
on4ebXPJvUBOcHOBMQsRSg: bets $8
ubtx4Z5L+AcK71MTvYiGVw: folds
on4ebXPJvUBOcHOBMQsRSg collected $12.35 from pot
*** SUMMARY ***
Total pot $13 | Rake $0.65
Board [Jc 5c 8c]
Seat 1: ubtx4Z5L+AcK71MTvYiGVw (big blind) folded on the Flop
Seat 2: TMPDCBmlFGM9C+H58PC4sQ folded before Flop (didn't bet)
Seat 3: opJMdoq0E6TRbAQiweyQuA folded before Flop (didn't bet)
Seat 4: 8srN1dKQePlsv0GyTada+Q folded before Flop (didn't bet)
Seat 5: on4ebXPJvUBOcHOBMQsRSg (button) collected ($12.35)
Seat 6: mddoKnqZkdOH7AJOJ/i0DA (small blind) folded before Flop



PokerStars Game #59942033742:  Hold'em No Limit ($1/$2) - 2009/07/01 1:53:58 ET
Table 'UGLAZZyv+cXmnKjYin0etA' 6-max Seat #1 is the button
Seat 1: rL+Zpv4/vX2BVHcyfh/NXA ($200 in chips)
Seat 2: eDLH1PUXFpvJBNMXBVQcGA ($298.10 in chips)
Seat 3: Nsjun4mjI8q0SSBTIp1dIQ ($200 in chips)
Seat 4: SiGJDsvRViJX05vHhA80GQ ($249.75 in chips)
Seat 5: 54yWzRRgS0oZ+S6LwZBxMQ ($34.80 in chips)
Seat 6: sTPOWERd9HWPCNrDBwsVjA ($211.95 in chips)
eDLH1PUXFpvJBNMXBVQcGA: posts small blind $1
Nsjun4mjI8q0SSBTIp1dIQ: posts big blind $2
*** HOLE CARDS ***
SiGJDsvRViJX05vHhA80GQ: folds
54yWzRRgS0oZ+S6LwZBxMQ: folds
sTPOWERd9HWPCNrDBwsVjA: raises $4 to $6
rL+Zpv4/vX2BVHcyfh/NXA: folds
eDLH1PUXFpvJBNMXBVQcGA: folds
Nsjun4mjI8q0SSBTIp1dIQ: calls $4
*** FLOP *** [7s Jd Ad]
Nsjun4mjI8q0SSBTIp1dIQ: checks
sTPOWERd9HWPCNrDBwsVjA: checks
*** TURN *** [7s Jd Ad] [5h]
Nsjun4mjI8q0SSBTIp1dIQ: bets $8
sTPOWERd9HWPCNrDBwsVjA: calls $8
*** RIVER *** [7s Jd Ad 5h] [5s]
Nsjun4mjI8q0SSBTIp1dIQ: bets $18
sTPOWERd9HWPCNrDBwsVjA: calls $18
*** SHOW DOWN ***
Nsjun4mjI8q0SSBTIp1dIQ: shows [5c 5d] (four of a kind, Fives)
sTPOWERd9HWPCNrDBwsVjA: mucks hand
Nsjun4mjI8q0SSBTIp1dIQ collected $62 from pot
*** SUMMARY ***
Total pot $65 | Rake $3
Board [7s Jd Ad 5h 5s]
Seat 1: rL+Zpv4/vX2BVHcyfh/NXA (button) folded before Flop (didn't bet)
Seat 2: eDLH1PUXFpvJBNMXBVQcGA (small blind) folded before Flop
Seat 3: Nsjun4mjI8q0SSBTIp1dIQ (big blind) showed [5c 5d] and won ($62) with four of a kind, Fives
Seat 4: SiGJDsvRViJX05vHhA80GQ folded before Flop (didn't bet)
Seat 5: 54yWzRRgS0oZ+S6LwZBxMQ folded before Flop (didn't bet)
Seat 6: sTPOWERd9HWPCNrDBwsVjA mucked



PokerStars Game #59942033916:  Hold'em No Limit ($1/$2) - 2009/07/01 1:53:58 ET
Table 'jlrIxbrVIG+gjaUYT4za8g' 6-max Seat #4 is the button
Seat 2: cwfuMyvDC7J7SqX2leDC8g ($69 in chips)
Seat 3: 3LCfF9/CuJ9+kbFOcqmuaQ ($66.30 in chips)
Seat 4: 8srN1dKQePlsv0GyTada+Q ($289.50 in chips)
Seat 5: AyBB0k3Dcl7xbXUeGMw06g ($66.75 in chips)
Seat 6: BWhgxe7gWiYobRbwdG+d2Q ($196 in chips)
AyBB0k3Dcl7xbXUeGMw06g: posts small blind $1
BWhgxe7gWiYobRbwdG+d2Q: posts big blind $2
opJMdoq0E6TRbAQiweyQuA: sits out
*** HOLE CARDS ***
cwfuMyvDC7J7SqX2leDC8g: folds
3LCfF9/CuJ9+kbFOcqmuaQ: folds
8srN1dKQePlsv0GyTada+Q: raises $4 to $6
AyBB0k3Dcl7xbXUeGMw06g: folds
BWhgxe7gWiYobRbwdG+d2Q: folds
BWhgxe7gWiYobRbwdG+d2Q leaves the table
8srN1dKQePlsv0GyTada+Q collected $5 from pot
8srN1dKQePlsv0GyTada+Q: doesn't show hand
*** SUMMARY ***
Total pot $5 | Rake $0
Seat 2: cwfuMyvDC7J7SqX2leDC8g folded before Flop (didn't bet)
Seat 3: 3LCfF9/CuJ9+kbFOcqmuaQ folded before Flop (didn't bet)
Seat 4: 8srN1dKQePlsv0GyTada+Q (button) collected ($5)
Seat 5: AyBB0k3Dcl7xbXUeGMw06g (small blind) folded before Flop
Seat 6: BWhgxe7gWiYobRbwdG+d2Q (big blind) folded before Flop



PokerStars Game #59942035084:  Hold'em No Limit ($1/$2) - 2009/07/01 1:54:00 ET
Table 'ZzSIe0zTCDv+n6hfbY5tTg' 6-max Seat #2 is the button
Seat 1: VvdR9F3I+2yELkfTVvC1dg ($288.65 in chips)
Seat 2: B87ikIyZ/TzAVeXf38Ny0g ($225 in chips)
Seat 3: gsugPj31Hui3Jefl98MBOA ($342.10 in chips)
Seat 4: 54yWzRRgS0oZ+S6LwZBxMQ ($43.10 in chips)
Seat 5: 3dAbvkxS5NPQTBAbvpinVg ($481.45 in chips)
Seat 6: 09BNF4quPDzanQzM8vc6WA ($37.55 in chips)
gsugPj31Hui3Jefl98MBOA: posts small blind $1
54yWzRRgS0oZ+S6LwZBxMQ: posts big blind $2
*** HOLE CARDS ***
3dAbvkxS5NPQTBAbvpinVg: folds
09BNF4quPDzanQzM8vc6WA: folds
VvdR9F3I+2yELkfTVvC1dg: folds
B87ikIyZ/TzAVeXf38Ny0g: raises $4 to $6
gsugPj31Hui3Jefl98MBOA: folds
54yWzRRgS0oZ+S6LwZBxMQ: raises $22 to $28
B87ikIyZ/TzAVeXf38Ny0g: folds
54yWzRRgS0oZ+S6LwZBxMQ collected $13 from pot
54yWzRRgS0oZ+S6LwZBxMQ: doesn't show hand
*** SUMMARY ***
Total pot $13 | Rake $0
Seat 1: VvdR9F3I+2yELkfTVvC1dg folded before Flop (didn't bet)
Seat 2: B87ikIyZ/TzAVeXf38Ny0g (button) folded before Flop
Seat 3: gsugPj31Hui3Jefl98MBOA (small blind) folded before Flop
Seat 4: 54yWzRRgS0oZ+S6LwZBxMQ (big blind) collected ($13)
Seat 5: 3dAbvkxS5NPQTBAbvpinVg folded before Flop (didn't bet)
Seat 6: 09BNF4quPDzanQzM8vc6WA folded before Flop (didn't bet)



PokerStars Game #59942035690:  Hold'em No Limit ($1/$2) - 2009/07/01 1:54:01 ET
Table 'pPQgcj9XT9CHBsbo1WTBug' 6-max Seat #1 is the button
Seat 1: DFVYDA6dKQy7R7mGIKogZA ($151.45 in chips)
Seat 2: qXDd0ZyMIse0OBu8pxeQ3Q ($201 in chips)
Seat 3: sSAA879uXOGR+8Mf3zLa6Q ($134.90 in chips)
Seat 4: cwfuMyvDC7J7SqX2leDC8g ($52.20 in chips)
Seat 5: vkfxu8f/jMYKUk6Ly4eujw ($123.60 in chips)
Seat 6: Yr7pZltpy3IUNdKS9PCEiw ($304.80 in chips)
qXDd0ZyMIse0OBu8pxeQ3Q: posts small blind $1
sSAA879uXOGR+8Mf3zLa6Q: posts big blind $2
*** HOLE CARDS ***
cwfuMyvDC7J7SqX2leDC8g: calls $2
vkfxu8f/jMYKUk6Ly4eujw: calls $2
Yr7pZltpy3IUNdKS9PCEiw: folds
DFVYDA6dKQy7R7mGIKogZA: folds
qXDd0ZyMIse0OBu8pxeQ3Q: folds
sSAA879uXOGR+8Mf3zLa6Q: checks
*** FLOP *** [Kd 9h Td]
sSAA879uXOGR+8Mf3zLa6Q: checks
cwfuMyvDC7J7SqX2leDC8g: bets $6
vkfxu8f/jMYKUk6Ly4eujw: calls $6
sSAA879uXOGR+8Mf3zLa6Q: folds
*** TURN *** [Kd 9h Td] [6s]
cwfuMyvDC7J7SqX2leDC8g: bets $12
vkfxu8f/jMYKUk6Ly4eujw: folds
cwfuMyvDC7J7SqX2leDC8g collected $18.10 from pot
*** SUMMARY ***
Total pot $19 | Rake $0.90
Board [Kd 9h Td 6s]
Seat 1: DFVYDA6dKQy7R7mGIKogZA (button) folded before Flop (didn't bet)
Seat 2: qXDd0ZyMIse0OBu8pxeQ3Q (small blind) folded before Flop
Seat 3: sSAA879uXOGR+8Mf3zLa6Q (big blind) folded on the Flop
Seat 4: cwfuMyvDC7J7SqX2leDC8g collected ($18.10)
Seat 5: vkfxu8f/jMYKUk6Ly4eujw folded on the Turn
Seat 6: Yr7pZltpy3IUNdKS9PCEiw folded before Flop (didn't bet)



PokerStars Game #59942037684:  Hold'em No Limit ($1/$2) - 2009/07/01 1:54:05 ET
Table 'NmY84NAf9Mh0ckAckHnh5g' 2-max Seat #2 is the button
Seat 1: 6hvg964TSqZ3AL/0XK9aVQ ($464.20 in chips)
Seat 2: RwDoM55ZeQuI2ADyJhOb2Q ($515.80 in chips)
RwDoM55ZeQuI2ADyJhOb2Q: posts small blind $1
6hvg964TSqZ3AL/0XK9aVQ: posts big blind $2
*** HOLE CARDS ***
RwDoM55ZeQuI2ADyJhOb2Q: raises $4 to $6
6hvg964TSqZ3AL/0XK9aVQ: calls $4
*** FLOP *** [7s 4h Kh]
6hvg964TSqZ3AL/0XK9aVQ: checks
RwDoM55ZeQuI2ADyJhOb2Q: bets $10
6hvg964TSqZ3AL/0XK9aVQ: calls $10
*** TURN *** [7s 4h Kh] [6d]
6hvg964TSqZ3AL/0XK9aVQ: checks
RwDoM55ZeQuI2ADyJhOb2Q: checks
*** RIVER *** [7s 4h Kh 6d] [7c]
6hvg964TSqZ3AL/0XK9aVQ: bets $66
RwDoM55ZeQuI2ADyJhOb2Q: calls $66
*** SHOW DOWN ***
6hvg964TSqZ3AL/0XK9aVQ: shows [Ah 2s] (a pair of Sevens)
RwDoM55ZeQuI2ADyJhOb2Q: shows [7d 9h] (three of a kind, Sevens)
RwDoM55ZeQuI2ADyJhOb2Q collected $163.50 from pot
*** SUMMARY ***
Total pot $164 | Rake $0.50
Board [7s 4h Kh 6d 7c]
Seat 1: 6hvg964TSqZ3AL/0XK9aVQ (big blind) showed [Ah 2s] and lost with a pair of Sevens
Seat 2: RwDoM55ZeQuI2ADyJhOb2Q (button) (small blind) showed [7d 9h] and won ($163.50) with three of a kind, Sevens



PokerStars Game #59942038652:  Hold'em No Limit ($1/$2) - 2009/07/01 1:54:07 ET
Table 'mGpP9StWRnoeiBDExc6Frg' 6-max Seat #5 is the button
Seat 1: VvdR9F3I+2yELkfTVvC1dg ($316.40 in chips)
Seat 2: 6hRJ68JkbJq6MYI9o5bUnQ ($101 in chips)
Seat 3: mddoKnqZkdOH7AJOJ/i0DA ($203 in chips)
Seat 4: 4dcDwIHRm96PwtqkpQiuiA ($84.70 in chips)
Seat 5: d1puGuVBE0fidn+5eRJ0tw ($190.35 in chips)
Seat 6: B2Ih1sr5VZk+8He7rcrMtQ ($405.20 in chips)
B2Ih1sr5VZk+8He7rcrMtQ: posts small blind $1
VvdR9F3I+2yELkfTVvC1dg: posts big blind $2
*** HOLE CARDS ***
6hRJ68JkbJq6MYI9o5bUnQ: folds
mddoKnqZkdOH7AJOJ/i0DA: raises $4 to $6
4dcDwIHRm96PwtqkpQiuiA: folds
d1puGuVBE0fidn+5eRJ0tw: folds
B2Ih1sr5VZk+8He7rcrMtQ: folds
VvdR9F3I+2yELkfTVvC1dg: folds
mddoKnqZkdOH7AJOJ/i0DA collected $5 from pot
*** SUMMARY ***
Total pot $5 | Rake $0
Seat 1: VvdR9F3I+2yELkfTVvC1dg (big blind) folded before Flop
Seat 2: 6hRJ68JkbJq6MYI9o5bUnQ folded before Flop (didn't bet)
Seat 3: mddoKnqZkdOH7AJOJ/i0DA collected ($5)
Seat 4: 4dcDwIHRm96PwtqkpQiuiA folded before Flop (didn't bet)
Seat 5: d1puGuVBE0fidn+5eRJ0tw (button) folded before Flop (didn't bet)
Seat 6: B2Ih1sr5VZk+8He7rcrMtQ (small blind) folded before Flop



PokerStars Game #59942039274:  Hold'em No Limit ($1/$2) - 2009/07/01 1:54:08 ET
Table 'uJ9juaXXg9yIcSU8amxaXQ' 6-max Seat #1 is the button
Seat 1: JsqOjN/eHz0uYVf/PyUJ6Q ($116.95 in chips)
Seat 2: VvdR9F3I+2yELkfTVvC1dg ($218.45 in chips)
Seat 3: qXDd0ZyMIse0OBu8pxeQ3Q ($239.40 in chips)
Seat 4: zNjJ/y4emmF+vzrCDd+ooA ($270.30 in chips)
Seat 5: YsLQ3BAvgQHWXMAv3Wv6Hg ($213.70 in chips)
Seat 6: /PH6Ffnho4Ysm8S3V/oa+w ($40 in chips)
VvdR9F3I+2yELkfTVvC1dg: posts small blind $1
qXDd0ZyMIse0OBu8pxeQ3Q: posts big blind $2
*** HOLE CARDS ***
zNjJ/y4emmF+vzrCDd+ooA: folds
YsLQ3BAvgQHWXMAv3Wv6Hg: folds
/PH6Ffnho4Ysm8S3V/oa+w: folds
JsqOjN/eHz0uYVf/PyUJ6Q: folds
VvdR9F3I+2yELkfTVvC1dg: folds
qXDd0ZyMIse0OBu8pxeQ3Q collected $2 from pot
*** SUMMARY ***
Total pot $2 | Rake $0
Seat 1: JsqOjN/eHz0uYVf/PyUJ6Q (button) folded before Flop (didn't bet)
Seat 2: VvdR9F3I+2yELkfTVvC1dg (small blind) folded before Flop
Seat 3: qXDd0ZyMIse0OBu8pxeQ3Q (big blind) collected ($2)
Seat 4: zNjJ/y4emmF+vzrCDd+ooA folded before Flop (didn't bet)
Seat 5: YsLQ3BAvgQHWXMAv3Wv6Hg folded before Flop (didn't bet)
Seat 6: /PH6Ffnho4Ysm8S3V/oa+w folded before Flop (didn't bet)



PokerStars Game #59942039296:  Hold'em No Limit ($1/$2) - 2009/07/01 1:54:08 ET
Table 'WCA60bDA8ecovUgFSIZkTQ' 9-max Seat #6 is the button
Seat 1: 3RFwE6igZ1BGKOGuab6iiw ($55.70 in chips)
Seat 2: TAfo4veNRaRlzDXMMYS3Jg ($37 in chips)
Seat 3: g7gL2NLJCdZPPV399WKT1w ($54.95 in chips)
Seat 4: IYBKVnE2Basnr88BAhH+bQ ($202.80 in chips)
Seat 5: A+9gcmwAl0eFxxbAwRY1OA ($262.10 in chips)
Seat 6: YoKKKdDDs7gFzP1Z65Sdaw ($96 in chips)
Seat 7: tsTv4D+ne2W0qhUt9HlcMw ($194.80 in chips)
Seat 8: mJhwEVg7F695DiO+RIhM5g ($257.45 in chips)
Seat 9: ItDFe9gh5QYPQB9vC4ntUA ($200 in chips)
tsTv4D+ne2W0qhUt9HlcMw: posts small blind $1
mJhwEVg7F695DiO+RIhM5g: posts big blind $2
*** HOLE CARDS ***
ItDFe9gh5QYPQB9vC4ntUA: folds
3RFwE6igZ1BGKOGuab6iiw: calls $2
TAfo4veNRaRlzDXMMYS3Jg: folds
g7gL2NLJCdZPPV399WKT1w: folds
IYBKVnE2Basnr88BAhH+bQ: folds
A+9gcmwAl0eFxxbAwRY1OA: raises $4 to $6
YoKKKdDDs7gFzP1Z65Sdaw: folds
tsTv4D+ne2W0qhUt9HlcMw: folds
mJhwEVg7F695DiO+RIhM5g: folds
3RFwE6igZ1BGKOGuab6iiw: calls $4
*** FLOP *** [4s Ts 4c]
3RFwE6igZ1BGKOGuab6iiw: checks
A+9gcmwAl0eFxxbAwRY1OA: bets $10
3RFwE6igZ1BGKOGuab6iiw: calls $10
*** TURN *** [4s Ts 4c] [Td]
3RFwE6igZ1BGKOGuab6iiw: checks
A+9gcmwAl0eFxxbAwRY1OA: checks
*** RIVER *** [4s Ts 4c Td] [Kd]
3RFwE6igZ1BGKOGuab6iiw: bets $18
A+9gcmwAl0eFxxbAwRY1OA: folds
3RFwE6igZ1BGKOGuab6iiw collected $33.30 from pot
*** SUMMARY ***
Total pot $35 | Rake $1.70
Board [4s Ts 4c Td Kd]
Seat 1: 3RFwE6igZ1BGKOGuab6iiw collected ($33.30)
Seat 2: TAfo4veNRaRlzDXMMYS3Jg folded before Flop (didn't bet)
Seat 3: g7gL2NLJCdZPPV399WKT1w folded before Flop (didn't bet)
Seat 4: IYBKVnE2Basnr88BAhH+bQ folded before Flop (didn't bet)
Seat 5: A+9gcmwAl0eFxxbAwRY1OA folded on the River
Seat 6: YoKKKdDDs7gFzP1Z65Sdaw (button) folded before Flop (didn't bet)
Seat 7: tsTv4D+ne2W0qhUt9HlcMw (small blind) folded before Flop
Seat 8: mJhwEVg7F695DiO+RIhM5g (big blind) folded before Flop
Seat 9: ItDFe9gh5QYPQB9vC4ntUA folded before Flop (didn't bet)



PokerStars Game #59942042272:  Hold'em No Limit ($1/$2) - 2009/07/01 1:54:14 ET
Table 'ztv6V3FN2bQ9nmJPPdx6nQ' 6-max Seat #2 is the button
Seat 1: 6fLdOUCRtX71xbVRhJEq8w ($284.35 in chips)
Seat 2: 5Y+ZGWLI4gnlpApDX5vy1A ($371.05 in chips)
Seat 3: XP9UmPc7hfMVafyEiwJMAA ($198 in chips)
Seat 4: UaZ5yj+6LjtWqMQg2QskUw ($105.40 in chips)
Seat 5: sTPOWERd9HWPCNrDBwsVjA ($211.60 in chips)
Seat 6: mfy7uGZcqA2PVQqEVbJ7+g ($185 in chips)
XP9UmPc7hfMVafyEiwJMAA: posts small blind $1
UaZ5yj+6LjtWqMQg2QskUw: posts big blind $2
*** HOLE CARDS ***
sTPOWERd9HWPCNrDBwsVjA: folds
mfy7uGZcqA2PVQqEVbJ7+g: folds
6fLdOUCRtX71xbVRhJEq8w: raises $4 to $6
5Y+ZGWLI4gnlpApDX5vy1A: calls $6
XP9UmPc7hfMVafyEiwJMAA: folds
UaZ5yj+6LjtWqMQg2QskUw: folds
*** FLOP *** [9c 4h 7d]
6fLdOUCRtX71xbVRhJEq8w: bets $12
5Y+ZGWLI4gnlpApDX5vy1A: raises $18 to $30
6fLdOUCRtX71xbVRhJEq8w: calls $18
*** TURN *** [9c 4h 7d] [2c]
6fLdOUCRtX71xbVRhJEq8w: checks
5Y+ZGWLI4gnlpApDX5vy1A: bets $45
6fLdOUCRtX71xbVRhJEq8w: calls $45
*** RIVER *** [9c 4h 7d 2c] [Ad]
6fLdOUCRtX71xbVRhJEq8w: checks
5Y+ZGWLI4gnlpApDX5vy1A: folds
6fLdOUCRtX71xbVRhJEq8w collected $162 from pot
*** SUMMARY ***
Total pot $165 | Rake $3
Board [9c 4h 7d 2c Ad]
Seat 1: 6fLdOUCRtX71xbVRhJEq8w collected ($162)
Seat 2: 5Y+ZGWLI4gnlpApDX5vy1A (button) folded on the River
Seat 3: XP9UmPc7hfMVafyEiwJMAA (small blind) folded before Flop
Seat 4: UaZ5yj+6LjtWqMQg2QskUw (big blind) folded before Flop
Seat 5: sTPOWERd9HWPCNrDBwsVjA folded before Flop (didn't bet)
Seat 6: mfy7uGZcqA2PVQqEVbJ7+g folded before Flop (didn't bet)



PokerStars Game #59942044372:  Hold'em No Limit ($1/$2) - 2009/07/01 1:54:18 ET
Table 'QxerF7GUfCbl+4a8XaTB2w' 6-max Seat #2 is the button
Seat 1: ZwvXzkkZ3XpMhKfAmVpahw ($285.25 in chips)
Seat 2: 6UGgYbxwWNc+ohObe8vB9w ($80 in chips)
Seat 3: 8rZGabKe2DEPdZCbCivZ9Q ($21 in chips)
Seat 4: /PH6Ffnho4Ysm8S3V/oa+w ($53 in chips)
Seat 5: vkfxu8f/jMYKUk6Ly4eujw ($152.05 in chips)
Seat 6: VvdR9F3I+2yELkfTVvC1dg ($218.10 in chips)
8rZGabKe2DEPdZCbCivZ9Q: posts small blind $1
/PH6Ffnho4Ysm8S3V/oa+w: posts big blind $2
*** HOLE CARDS ***
vkfxu8f/jMYKUk6Ly4eujw: folds
VvdR9F3I+2yELkfTVvC1dg: folds
ZwvXzkkZ3XpMhKfAmVpahw: folds
6UGgYbxwWNc+ohObe8vB9w: folds
8rZGabKe2DEPdZCbCivZ9Q: calls $1
/PH6Ffnho4Ysm8S3V/oa+w: checks
*** FLOP *** [9h 3s 4c]
8rZGabKe2DEPdZCbCivZ9Q: checks
/PH6Ffnho4Ysm8S3V/oa+w: checks
*** TURN *** [9h 3s 4c] [7h]
8rZGabKe2DEPdZCbCivZ9Q: checks
/PH6Ffnho4Ysm8S3V/oa+w: checks
*** RIVER *** [9h 3s 4c 7h] [Qh]
8rZGabKe2DEPdZCbCivZ9Q: checks
/PH6Ffnho4Ysm8S3V/oa+w: checks
*** SHOW DOWN ***
8rZGabKe2DEPdZCbCivZ9Q: shows [6h As] (high card Ace)
/PH6Ffnho4Ysm8S3V/oa+w: mucks hand
8rZGabKe2DEPdZCbCivZ9Q collected $3.80 from pot
*** SUMMARY ***
Total pot $4 | Rake $0.20
Board [9h 3s 4c 7h Qh]
Seat 1: ZwvXzkkZ3XpMhKfAmVpahw folded before Flop (didn't bet)
Seat 2: 6UGgYbxwWNc+ohObe8vB9w (button) folded before Flop (didn't bet)
Seat 3: 8rZGabKe2DEPdZCbCivZ9Q (small blind) showed [6h As] and won ($3.80) with high card Ace
Seat 4: /PH6Ffnho4Ysm8S3V/oa+w (big blind) mucked
Seat 5: vkfxu8f/jMYKUk6Ly4eujw folded before Flop (didn't bet)
Seat 6: VvdR9F3I+2yELkfTVvC1dg folded before Flop (didn't bet)



PokerStars Game #59942044762:  Hold'em No Limit ($1/$2) - 2009/07/01 1:54:19 ET
Table '/dyk+YdRGv90j2box35j8w' 6-max Seat #1 is the button
Seat 1: 8srN1dKQePlsv0GyTada+Q ($200 in chips)
Seat 2: qCnEYuAE5y5A7bk6fO5/jQ ($492.20 in chips)
Seat 3: sTPOWERd9HWPCNrDBwsVjA ($209.50 in chips)
Seat 4: 4dMBh/1VTdeUTPCyhCs3UQ ($90.25 in chips)
Seat 5: VvdR9F3I+2yELkfTVvC1dg ($294.80 in chips)
Seat 6: C3qJBo7uxfFVDluE1lmK2w ($92.25 in chips)
qCnEYuAE5y5A7bk6fO5/jQ: posts small blind $1
sTPOWERd9HWPCNrDBwsVjA: posts big blind $2
*** HOLE CARDS ***
4dMBh/1VTdeUTPCyhCs3UQ: folds
VvdR9F3I+2yELkfTVvC1dg: folds
C3qJBo7uxfFVDluE1lmK2w: folds
8srN1dKQePlsv0GyTada+Q: folds
qCnEYuAE5y5A7bk6fO5/jQ: folds
sTPOWERd9HWPCNrDBwsVjA collected $2 from pot
*** SUMMARY ***
Total pot $2 | Rake $0
Seat 1: 8srN1dKQePlsv0GyTada+Q (button) folded before Flop (didn't bet)
Seat 2: qCnEYuAE5y5A7bk6fO5/jQ (small blind) folded before Flop
Seat 3: sTPOWERd9HWPCNrDBwsVjA (big blind) collected ($2)
Seat 4: 4dMBh/1VTdeUTPCyhCs3UQ folded before Flop (didn't bet)
Seat 5: VvdR9F3I+2yELkfTVvC1dg folded before Flop (didn't bet)
Seat 6: C3qJBo7uxfFVDluE1lmK2w folded before Flop (didn't bet)



PokerStars Game #59942045314:  Hold'em No Limit ($1/$2) - 2009/07/01 1:54:20 ET
Table 'BSRfGh+QobUe0AgIMtt/fw' 9-max Seat #8 is the button
Seat 1: gDn/rYeNwCyWEgRhyWp4PA ($159.05 in chips)
Seat 2: +SmnXtdmwqXGEJfLeJDIUQ ($132.50 in chips)
Seat 3: WUlHm+ydPPHG7Lb0rePSdA ($120 in chips)
Seat 4: +T/63sAeZzWyHchahJ36GQ ($31 in chips)
Seat 5: ThVDqrMpsvd7Ax6KINfuew ($64.50 in chips)
Seat 6: H6Z4+qu8gR0VUiPOijndVg ($202 in chips)
Seat 7: CkE3IyJF1KvdaAOmZY5XqQ ($202 in chips)
Seat 8: GG5lTuGt3+kwNYSbqeB6yw ($74.85 in chips)
Seat 9: tjgwwDmi+N2H4I7hx8useQ ($79 in chips)
tjgwwDmi+N2H4I7hx8useQ: posts small blind $1
gDn/rYeNwCyWEgRhyWp4PA: posts big blind $2
*** HOLE CARDS ***
+SmnXtdmwqXGEJfLeJDIUQ: folds
WUlHm+ydPPHG7Lb0rePSdA: folds
+T/63sAeZzWyHchahJ36GQ: folds
ThVDqrMpsvd7Ax6KINfuew: folds
H6Z4+qu8gR0VUiPOijndVg: folds
CkE3IyJF1KvdaAOmZY5XqQ: folds
GG5lTuGt3+kwNYSbqeB6yw: calls $2
tjgwwDmi+N2H4I7hx8useQ: calls $1
gDn/rYeNwCyWEgRhyWp4PA: checks
*** FLOP *** [Js 9d Ks]
tjgwwDmi+N2H4I7hx8useQ: checks
gDn/rYeNwCyWEgRhyWp4PA: checks
GG5lTuGt3+kwNYSbqeB6yw: checks
*** TURN *** [Js 9d Ks] [4d]
tjgwwDmi+N2H4I7hx8useQ: bets $4
gDn/rYeNwCyWEgRhyWp4PA: folds
GG5lTuGt3+kwNYSbqeB6yw: folds
tjgwwDmi+N2H4I7hx8useQ collected $5.70 from pot
*** SUMMARY ***
Total pot $6 | Rake $0.30
Board [Js 9d Ks 4d]
Seat 1: gDn/rYeNwCyWEgRhyWp4PA (big blind) folded on the Turn
Seat 2: +SmnXtdmwqXGEJfLeJDIUQ folded before Flop (didn't bet)
Seat 3: WUlHm+ydPPHG7Lb0rePSdA folded before Flop (didn't bet)
Seat 4: +T/63sAeZzWyHchahJ36GQ folded before Flop (didn't bet)
Seat 5: ThVDqrMpsvd7Ax6KINfuew folded before Flop (didn't bet)
Seat 6: H6Z4+qu8gR0VUiPOijndVg folded before Flop (didn't bet)
Seat 7: CkE3IyJF1KvdaAOmZY5XqQ folded before Flop (didn't bet)
Seat 8: GG5lTuGt3+kwNYSbqeB6yw (button) folded on the Turn
Seat 9: tjgwwDmi+N2H4I7hx8useQ (small blind) collected ($5.70)



PokerStars Game #59942045710:  Hold'em No Limit ($1/$2) - 2009/07/01 1:54:20 ET
Table 'P/yCfYl1GfGsu/e6DxDy/A' 2-max Seat #1 is the button
Seat 1: 7fOCUy3x9hdkmXkkDNolGQ ($1157.50 in chips)
Seat 2: RwDoM55ZeQuI2ADyJhOb2Q ($310.50 in chips)
7fOCUy3x9hdkmXkkDNolGQ: posts small blind $1
RwDoM55ZeQuI2ADyJhOb2Q: posts big blind $2
*** HOLE CARDS ***
7fOCUy3x9hdkmXkkDNolGQ: folds
RwDoM55ZeQuI2ADyJhOb2Q collected $2 from pot
RwDoM55ZeQuI2ADyJhOb2Q: doesn't show hand
*** SUMMARY ***
Total pot $2 | Rake $0
Seat 1: 7fOCUy3x9hdkmXkkDNolGQ (button) (small blind) folded before Flop
Seat 2: RwDoM55ZeQuI2ADyJhOb2Q (big blind) collected ($2)



PokerStars Game #59942045768:  Hold'em No Limit ($1/$2) - 2009/07/01 1:54:21 ET
Table 'W9UeSV0aoPjh5SFSxM8jUQ' 9-max Seat #3 is the button
Seat 1: mIKx5lhIt13X5eZQH0ZeMA ($6.85 in chips)
Seat 2: KqHysDSpCPaPyK3tJC1aEw ($207.05 in chips)
Seat 3: ItDFe9gh5QYPQB9vC4ntUA ($200 in chips)
Seat 4: 4YA/sQy1Emm680zhbPUjow ($150.60 in chips)
Seat 6: 254YPxPJr5Sw58bkD0YqYQ ($216.70 in chips)
Seat 7: TAfo4veNRaRlzDXMMYS3Jg ($39 in chips)
Seat 8: odhvI/CZeMsPyo1n1U7+hA ($49.10 in chips)
Seat 9: Q104K4iDGcqOlVrjAkzPEA ($96.55 in chips)
4YA/sQy1Emm680zhbPUjow: posts small blind $1
ri8CLkX3e9JF34dQNbsHGA: is sitting out
ri8CLkX3e9JF34dQNbsHGA leaves the table
254YPxPJr5Sw58bkD0YqYQ: posts big blind $2
*** HOLE CARDS ***
TAfo4veNRaRlzDXMMYS3Jg: folds
odhvI/CZeMsPyo1n1U7+hA: folds
Q104K4iDGcqOlVrjAkzPEA: folds
ZYHoLw2lWmRS7CSHi8L8Xg joins the table at seat #5
mIKx5lhIt13X5eZQH0ZeMA: folds
KqHysDSpCPaPyK3tJC1aEw: folds
ItDFe9gh5QYPQB9vC4ntUA: raises $2 to $4
4YA/sQy1Emm680zhbPUjow: folds
254YPxPJr5Sw58bkD0YqYQ: folds
ItDFe9gh5QYPQB9vC4ntUA collected $5 from pot
*** SUMMARY ***
Total pot $5 | Rake $0
Seat 1: mIKx5lhIt13X5eZQH0ZeMA folded before Flop (didn't bet)
Seat 2: KqHysDSpCPaPyK3tJC1aEw folded before Flop (didn't bet)
Seat 3: ItDFe9gh5QYPQB9vC4ntUA (button) collected ($5)
Seat 4: 4YA/sQy1Emm680zhbPUjow (small blind) folded before Flop
Seat 6: 254YPxPJr5Sw58bkD0YqYQ (big blind) folded before Flop
Seat 7: TAfo4veNRaRlzDXMMYS3Jg folded before Flop (didn't bet)
Seat 8: odhvI/CZeMsPyo1n1U7+hA folded before Flop (didn't bet)
Seat 9: Q104K4iDGcqOlVrjAkzPEA folded before Flop (didn't bet)



PokerStars Game #59942046706:  Hold'em No Limit ($1/$2) - 2009/07/01 1:54:22 ET
Table 'jlrIxbrVIG+gjaUYT4za8g' 6-max Seat #5 is the button
Seat 2: cwfuMyvDC7J7SqX2leDC8g ($69 in chips)
Seat 3: 3LCfF9/CuJ9+kbFOcqmuaQ ($66.30 in chips)
Seat 4: 8srN1dKQePlsv0GyTada+Q ($292.50 in chips)
Seat 5: AyBB0k3Dcl7xbXUeGMw06g ($65.75 in chips)
opJMdoq0E6TRbAQiweyQuA will be allowed to play after the button
cwfuMyvDC7J7SqX2leDC8g: posts small blind $1
3LCfF9/CuJ9+kbFOcqmuaQ: posts big blind $2
*** HOLE CARDS ***
8srN1dKQePlsv0GyTada+Q: raises $4 to $6
AyBB0k3Dcl7xbXUeGMw06g: calls $6
cwfuMyvDC7J7SqX2leDC8g: calls $5
3LCfF9/CuJ9+kbFOcqmuaQ: folds
*** FLOP *** [8s 8h Jc]
cwfuMyvDC7J7SqX2leDC8g: checks
8srN1dKQePlsv0GyTada+Q: bets $12
AyBB0k3Dcl7xbXUeGMw06g: calls $12
cwfuMyvDC7J7SqX2leDC8g: folds
*** TURN *** [8s 8h Jc] [Ks]
8srN1dKQePlsv0GyTada+Q: checks
AyBB0k3Dcl7xbXUeGMw06g: bets $12
8srN1dKQePlsv0GyTada+Q: calls $12
*** RIVER *** [8s 8h Jc Ks] [3d]
8srN1dKQePlsv0GyTada+Q: checks
AyBB0k3Dcl7xbXUeGMw06g: bets $20
8srN1dKQePlsv0GyTada+Q: calls $20
*** SHOW DOWN ***
AyBB0k3Dcl7xbXUeGMw06g: shows [Kd Ad] (two pair, Kings and Eights)
8srN1dKQePlsv0GyTada+Q: mucks hand
AyBB0k3Dcl7xbXUeGMw06g collected $106 from pot
*** SUMMARY ***
Total pot $108 | Rake $2
Board [8s 8h Jc Ks 3d]
Seat 2: cwfuMyvDC7J7SqX2leDC8g (small blind) folded on the Flop
Seat 3: 3LCfF9/CuJ9+kbFOcqmuaQ (big blind) folded before Flop
Seat 4: 8srN1dKQePlsv0GyTada+Q mucked
Seat 5: AyBB0k3Dcl7xbXUeGMw06g (button) showed [Kd Ad] and won ($106) with two pair, Kings and Eights



PokerStars Game #59942047248:  Hold'em No Limit ($1/$2) - 2009/07/01 1:54:23 ET
Table '5/wEe6JmtGD7vufSA2RG7A' 2-max Seat #1 is the button
Seat 1: pVqEzK9wXlRMECnb1Zg4Zw ($200 in chips)
Seat 2: aOL8geThaYp2iadSHl1h1g ($453.50 in chips)
pVqEzK9wXlRMECnb1Zg4Zw: posts small blind $1
aOL8geThaYp2iadSHl1h1g: posts big blind $2
*** HOLE CARDS ***
pVqEzK9wXlRMECnb1Zg4Zw: raises $6 to $8
aOL8geThaYp2iadSHl1h1g: folds
pVqEzK9wXlRMECnb1Zg4Zw collected $4 from pot
pVqEzK9wXlRMECnb1Zg4Zw: doesn't show hand
*** SUMMARY ***
Total pot $4 | Rake $0
Seat 1: pVqEzK9wXlRMECnb1Zg4Zw (button) (small blind) collected ($4)
Seat 2: aOL8geThaYp2iadSHl1h1g (big blind) folded before Flop



PokerStars Game #59942047372:  Hold'em No Limit ($1/$2) - 2009/07/01 1:54:24 ET
Table 'aSf77Sj8QEnzcc0WaxVD4Q' 6-max Seat #1 is the button
Seat 1: UELtvp+JfwI7XDGVwSxZXA ($168.85 in chips)
Seat 2: vkfxu8f/jMYKUk6Ly4eujw ($198 in chips)
Seat 4: YsLQ3BAvgQHWXMAv3Wv6Hg ($200 in chips)
Seat 5: VvdR9F3I+2yELkfTVvC1dg ($289.15 in chips)
Seat 6: vkoJRf3gidxY1pPi0AFWww ($195.10 in chips)
vkfxu8f/jMYKUk6Ly4eujw: posts small blind $1
9dpyyjDTCed6nV7JhaUUpw: is sitting out
YsLQ3BAvgQHWXMAv3Wv6Hg: posts big blind $2
*** HOLE CARDS ***
VvdR9F3I+2yELkfTVvC1dg: folds
9dpyyjDTCed6nV7JhaUUpw leaves the table
vkoJRf3gidxY1pPi0AFWww: calls $2
UELtvp+JfwI7XDGVwSxZXA: folds
vkfxu8f/jMYKUk6Ly4eujw: folds
YsLQ3BAvgQHWXMAv3Wv6Hg: checks
*** FLOP *** [5c 5h 5s]
YsLQ3BAvgQHWXMAv3Wv6Hg: checks
3cPMpDMgeOMAe4UceUfLsg joins the table at seat #3
vkoJRf3gidxY1pPi0AFWww: bets $4
YsLQ3BAvgQHWXMAv3Wv6Hg: folds
vkoJRf3gidxY1pPi0AFWww collected $4.75 from pot
vkoJRf3gidxY1pPi0AFWww: doesn't show hand
*** SUMMARY ***
Total pot $5 | Rake $0.25
Board [5c 5h 5s]
Seat 1: UELtvp+JfwI7XDGVwSxZXA (button) folded before Flop (didn't bet)
Seat 2: vkfxu8f/jMYKUk6Ly4eujw (small blind) folded before Flop
Seat 4: YsLQ3BAvgQHWXMAv3Wv6Hg (big blind) folded on the Flop
Seat 5: VvdR9F3I+2yELkfTVvC1dg folded before Flop (didn't bet)
Seat 6: vkoJRf3gidxY1pPi0AFWww collected ($4.75)



PokerStars Game #59942048486:  Hold'em No Limit ($1/$2) - 2009/07/01 1:54:26 ET
Table 'TsEDkiO4tzCTCzJ7tNdEqw' 6-max Seat #5 is the button
Seat 1: Nsjun4mjI8q0SSBTIp1dIQ ($200 in chips)
Seat 2: 4dcDwIHRm96PwtqkpQiuiA ($83.70 in chips)
Seat 3: ubtx4Z5L+AcK71MTvYiGVw ($253.20 in chips)
Seat 4: K8MXCrNAVYlMnnCeM32Kxw ($75.35 in chips)
Seat 5: VvdR9F3I+2yELkfTVvC1dg ($250.10 in chips)
Seat 6: uCqEjnxh2/vFBjKYkfTOkw ($275.10 in chips)
uCqEjnxh2/vFBjKYkfTOkw: posts small blind $1
Nsjun4mjI8q0SSBTIp1dIQ: posts big blind $2
*** HOLE CARDS ***
4dcDwIHRm96PwtqkpQiuiA: folds
ubtx4Z5L+AcK71MTvYiGVw: folds
K8MXCrNAVYlMnnCeM32Kxw: folds
VvdR9F3I+2yELkfTVvC1dg: folds
uCqEjnxh2/vFBjKYkfTOkw: raises $6 to $8
Nsjun4mjI8q0SSBTIp1dIQ: folds
uCqEjnxh2/vFBjKYkfTOkw collected $4 from pot
uCqEjnxh2/vFBjKYkfTOkw: doesn't show hand
*** SUMMARY ***
Total pot $4 | Rake $0
Seat 1: Nsjun4mjI8q0SSBTIp1dIQ (big blind) folded before Flop
Seat 2: 4dcDwIHRm96PwtqkpQiuiA folded before Flop (didn't bet)
Seat 3: ubtx4Z5L+AcK71MTvYiGVw folded before Flop (didn't bet)
Seat 4: K8MXCrNAVYlMnnCeM32Kxw folded before Flop (didn't bet)
Seat 5: VvdR9F3I+2yELkfTVvC1dg (button) folded before Flop (didn't bet)
Seat 6: uCqEjnxh2/vFBjKYkfTOkw (small blind) collected ($4)



PokerStars Game #59942048702:  Hold'em No Limit ($1/$2) - 2009/07/01 1:54:26 ET
Table 'P/yCfYl1GfGsu/e6DxDy/A' 2-max Seat #2 is the button
Seat 1: 7fOCUy3x9hdkmXkkDNolGQ ($1156.50 in chips)
Seat 2: RwDoM55ZeQuI2ADyJhOb2Q ($311.50 in chips)
RwDoM55ZeQuI2ADyJhOb2Q: posts small blind $1
7fOCUy3x9hdkmXkkDNolGQ: posts big blind $2
*** HOLE CARDS ***
RwDoM55ZeQuI2ADyJhOb2Q: raises $4 to $6
7fOCUy3x9hdkmXkkDNolGQ: folds
RwDoM55ZeQuI2ADyJhOb2Q collected $4 from pot
RwDoM55ZeQuI2ADyJhOb2Q: doesn't show hand
*** SUMMARY ***
Total pot $4 | Rake $0
Seat 1: 7fOCUy3x9hdkmXkkDNolGQ (big blind) folded before Flop
Seat 2: RwDoM55ZeQuI2ADyJhOb2Q (button) (small blind) collected ($4)



PokerStars Game #59942049510:  Hold'em No Limit ($1/$2) - 2009/07/01 1:54:28 ET
Table '4NGNnZ/osQfNq6abYqkJeA' 6-max Seat #4 is the button
Seat 1: 0Bc+WhbOvaaWIMmmui3q0g ($143.10 in chips)
Seat 2: 669iGNwYwgRZg3nhS+aDAQ ($107.75 in chips)
Seat 3: 54yWzRRgS0oZ+S6LwZBxMQ ($73.35 in chips)
Seat 4: sY+4Uuh5z/6AbXXaCS10jw ($297.10 in chips)
Seat 5: VvdR9F3I+2yELkfTVvC1dg ($209.80 in chips)
Seat 6: /PH6Ffnho4Ysm8S3V/oa+w ($48.20 in chips)
VvdR9F3I+2yELkfTVvC1dg: posts small blind $1
/PH6Ffnho4Ysm8S3V/oa+w: posts big blind $2
*** HOLE CARDS ***
0Bc+WhbOvaaWIMmmui3q0g: folds
669iGNwYwgRZg3nhS+aDAQ: folds
54yWzRRgS0oZ+S6LwZBxMQ: folds
sY+4Uuh5z/6AbXXaCS10jw: folds
VvdR9F3I+2yELkfTVvC1dg: folds
/PH6Ffnho4Ysm8S3V/oa+w collected $2 from pot
/PH6Ffnho4Ysm8S3V/oa+w: doesn't show hand
*** SUMMARY ***
Total pot $2 | Rake $0
Seat 1: 0Bc+WhbOvaaWIMmmui3q0g folded before Flop (didn't bet)
Seat 2: 669iGNwYwgRZg3nhS+aDAQ folded before Flop (didn't bet)
Seat 3: 54yWzRRgS0oZ+S6LwZBxMQ folded before Flop (didn't bet)
Seat 4: sY+4Uuh5z/6AbXXaCS10jw (button) folded before Flop (didn't bet)
Seat 5: VvdR9F3I+2yELkfTVvC1dg (small blind) folded before Flop
Seat 6: /PH6Ffnho4Ysm8S3V/oa+w (big blind) collected ($2)



PokerStars Game #59942049994:  Hold'em No Limit ($1/$2) - 2009/07/01 1:54:29 ET
Table '7goFpXy7qyiK5mwx+Ucf6A' 6-max Seat #2 is the button
Seat 1: VHmJJYp7TGQwcWROQ8dqXw ($55.10 in chips)
Seat 2: BWhgxe7gWiYobRbwdG+d2Q ($196 in chips)
Seat 3: mfy7uGZcqA2PVQqEVbJ7+g ($138.35 in chips)
Seat 4: fE+LHW/7rpfXW14g8LhGjA ($43.50 in chips)
Seat 5: /PH6Ffnho4Ysm8S3V/oa+w ($85 in chips)
Seat 6: VvdR9F3I+2yELkfTVvC1dg ($220.65 in chips)
mfy7uGZcqA2PVQqEVbJ7+g: posts small blind $1
fE+LHW/7rpfXW14g8LhGjA: posts big blind $2
*** HOLE CARDS ***
/PH6Ffnho4Ysm8S3V/oa+w: folds
VvdR9F3I+2yELkfTVvC1dg: raises $2 to $4
VHmJJYp7TGQwcWROQ8dqXw: calls $4
BWhgxe7gWiYobRbwdG+d2Q: folds
mfy7uGZcqA2PVQqEVbJ7+g: folds
fE+LHW/7rpfXW14g8LhGjA: calls $2
*** FLOP *** [Qs 3d 7d]
fE+LHW/7rpfXW14g8LhGjA: bets $2
VvdR9F3I+2yELkfTVvC1dg: folds
VHmJJYp7TGQwcWROQ8dqXw: folds
fE+LHW/7rpfXW14g8LhGjA collected $12.35 from pot
fE+LHW/7rpfXW14g8LhGjA: doesn't show hand
*** SUMMARY ***
Total pot $13 | Rake $0.65
Board [Qs 3d 7d]
Seat 1: VHmJJYp7TGQwcWROQ8dqXw folded on the Flop
Seat 2: BWhgxe7gWiYobRbwdG+d2Q (button) folded before Flop (didn't bet)
Seat 3: mfy7uGZcqA2PVQqEVbJ7+g (small blind) folded before Flop
Seat 4: fE+LHW/7rpfXW14g8LhGjA (big blind) collected ($12.35)
Seat 5: /PH6Ffnho4Ysm8S3V/oa+w folded before Flop (didn't bet)
Seat 6: VvdR9F3I+2yELkfTVvC1dg folded on the Flop



PokerStars Game #59942050894:  Hold'em No Limit ($1/$2) - 2009/07/01 1:54:30 ET
Table 'NmY84NAf9Mh0ckAckHnh5g' 2-max Seat #1 is the button
Seat 1: 6hvg964TSqZ3AL/0XK9aVQ ($382.20 in chips)
Seat 2: RwDoM55ZeQuI2ADyJhOb2Q ($597.30 in chips)
6hvg964TSqZ3AL/0XK9aVQ: posts small blind $1
RwDoM55ZeQuI2ADyJhOb2Q: posts big blind $2
*** HOLE CARDS ***
6hvg964TSqZ3AL/0XK9aVQ: folds
RwDoM55ZeQuI2ADyJhOb2Q collected $2 from pot
RwDoM55ZeQuI2ADyJhOb2Q: doesn't show hand
*** SUMMARY ***
Total pot $2 | Rake $0
Seat 1: 6hvg964TSqZ3AL/0XK9aVQ (button) (small blind) folded before Flop
Seat 2: RwDoM55ZeQuI2ADyJhOb2Q (big blind) collected ($2)



PokerStars Game #59942052450:  Hold'em No Limit ($1/$2) - 2009/07/01 1:54:33 ET
Table '5/wEe6JmtGD7vufSA2RG7A' 2-max Seat #2 is the button
Seat 1: pVqEzK9wXlRMECnb1Zg4Zw ($202 in chips)
Seat 2: aOL8geThaYp2iadSHl1h1g ($451.50 in chips)
aOL8geThaYp2iadSHl1h1g: posts small blind $1
pVqEzK9wXlRMECnb1Zg4Zw: posts big blind $2
*** HOLE CARDS ***
aOL8geThaYp2iadSHl1h1g: raises $4 to $6
pVqEzK9wXlRMECnb1Zg4Zw: raises $24 to $30
aOL8geThaYp2iadSHl1h1g: folds
pVqEzK9wXlRMECnb1Zg4Zw collected $12 from pot
pVqEzK9wXlRMECnb1Zg4Zw: doesn't show hand
*** SUMMARY ***
Total pot $12 | Rake $0
Seat 1: pVqEzK9wXlRMECnb1Zg4Zw (big blind) collected ($12)
Seat 2: aOL8geThaYp2iadSHl1h1g (button) (small blind) folded before Flop



PokerStars Game #59942052808:  Hold'em No Limit ($1/$2) - 2009/07/01 1:54:34 ET
Table 'P/yCfYl1GfGsu/e6DxDy/A' 2-max Seat #1 is the button
Seat 1: 7fOCUy3x9hdkmXkkDNolGQ ($1154.50 in chips)
Seat 2: RwDoM55ZeQuI2ADyJhOb2Q ($313.50 in chips)
7fOCUy3x9hdkmXkkDNolGQ: posts small blind $1
RwDoM55ZeQuI2ADyJhOb2Q: posts big blind $2
*** HOLE CARDS ***
7fOCUy3x9hdkmXkkDNolGQ: raises $4 to $6
RwDoM55ZeQuI2ADyJhOb2Q: folds
7fOCUy3x9hdkmXkkDNolGQ collected $4 from pot
7fOCUy3x9hdkmXkkDNolGQ: doesn't show hand
*** SUMMARY ***
Total pot $4 | Rake $0
Seat 1: 7fOCUy3x9hdkmXkkDNolGQ (button) (small blind) collected ($4)
Seat 2: RwDoM55ZeQuI2ADyJhOb2Q (big blind) folded before Flop



PokerStars Game #59942052576:  Hold'em No Limit ($1/$2) - 2009/07/01 1:54:34 ET
Table '/dyk+YdRGv90j2box35j8w' 6-max Seat #2 is the button
Seat 1: 8srN1dKQePlsv0GyTada+Q ($200 in chips)
Seat 2: qCnEYuAE5y5A7bk6fO5/jQ ($491.20 in chips)
Seat 3: sTPOWERd9HWPCNrDBwsVjA ($210.50 in chips)
Seat 4: 4dMBh/1VTdeUTPCyhCs3UQ ($90.25 in chips)
Seat 5: VvdR9F3I+2yELkfTVvC1dg ($294.80 in chips)
Seat 6: C3qJBo7uxfFVDluE1lmK2w ($92.25 in chips)
sTPOWERd9HWPCNrDBwsVjA: posts small blind $1
4dMBh/1VTdeUTPCyhCs3UQ: posts big blind $2
*** HOLE CARDS ***
VvdR9F3I+2yELkfTVvC1dg: raises $2 to $4
C3qJBo7uxfFVDluE1lmK2w: folds
8srN1dKQePlsv0GyTada+Q has timed out
8srN1dKQePlsv0GyTada+Q: folds
8srN1dKQePlsv0GyTada+Q is sitting out
qCnEYuAE5y5A7bk6fO5/jQ: folds
sTPOWERd9HWPCNrDBwsVjA: folds
4dMBh/1VTdeUTPCyhCs3UQ: calls $2
*** FLOP *** [8c 3s Ad]
4dMBh/1VTdeUTPCyhCs3UQ: checks
VvdR9F3I+2yELkfTVvC1dg: bets $6.40
4dMBh/1VTdeUTPCyhCs3UQ: folds
VvdR9F3I+2yELkfTVvC1dg collected $8.55 from pot
VvdR9F3I+2yELkfTVvC1dg: doesn't show hand
*** SUMMARY ***
Total pot $9 | Rake $0.45
Board [8c 3s Ad]
Seat 1: 8srN1dKQePlsv0GyTada+Q folded before Flop (didn't bet)
Seat 2: qCnEYuAE5y5A7bk6fO5/jQ (button) folded before Flop (didn't bet)
Seat 3: sTPOWERd9HWPCNrDBwsVjA (small blind) folded before Flop
Seat 4: 4dMBh/1VTdeUTPCyhCs3UQ (big blind) folded on the Flop
Seat 5: VvdR9F3I+2yELkfTVvC1dg collected ($8.55)
Seat 6: C3qJBo7uxfFVDluE1lmK2w folded before Flop (didn't bet)



PokerStars Game #59942053992:  Hold'em No Limit ($1/$2) - 2009/07/01 1:54:36 ET
Table 'uJ9juaXXg9yIcSU8amxaXQ' 6-max Seat #2 is the button
Seat 1: JsqOjN/eHz0uYVf/PyUJ6Q ($116.95 in chips)
Seat 2: VvdR9F3I+2yELkfTVvC1dg ($217.45 in chips)
Seat 3: qXDd0ZyMIse0OBu8pxeQ3Q ($240.40 in chips)
Seat 4: zNjJ/y4emmF+vzrCDd+ooA ($270.30 in chips)
Seat 5: YsLQ3BAvgQHWXMAv3Wv6Hg ($213.70 in chips)
Seat 6: /PH6Ffnho4Ysm8S3V/oa+w ($40 in chips)
qXDd0ZyMIse0OBu8pxeQ3Q: posts small blind $1
zNjJ/y4emmF+vzrCDd+ooA: posts big blind $2
*** HOLE CARDS ***
YsLQ3BAvgQHWXMAv3Wv6Hg: raises $4 to $6
/PH6Ffnho4Ysm8S3V/oa+w: folds
JsqOjN/eHz0uYVf/PyUJ6Q: calls $6
VvdR9F3I+2yELkfTVvC1dg: folds
qXDd0ZyMIse0OBu8pxeQ3Q: folds
zNjJ/y4emmF+vzrCDd+ooA: folds
*** FLOP *** [Ac 7h Qs]
YsLQ3BAvgQHWXMAv3Wv6Hg: bets $8
JsqOjN/eHz0uYVf/PyUJ6Q: calls $8
*** TURN *** [Ac 7h Qs] [4c]
YsLQ3BAvgQHWXMAv3Wv6Hg: checks
JsqOjN/eHz0uYVf/PyUJ6Q: bets $14
YsLQ3BAvgQHWXMAv3Wv6Hg: folds
JsqOjN/eHz0uYVf/PyUJ6Q collected $29.50 from pot
JsqOjN/eHz0uYVf/PyUJ6Q: doesn't show hand
*** SUMMARY ***
Total pot $31 | Rake $1.50
Board [Ac 7h Qs 4c]
Seat 1: JsqOjN/eHz0uYVf/PyUJ6Q collected ($29.50)
Seat 2: VvdR9F3I+2yELkfTVvC1dg (button) folded before Flop (didn't bet)
Seat 3: qXDd0ZyMIse0OBu8pxeQ3Q (small blind) folded before Flop
Seat 4: zNjJ/y4emmF+vzrCDd+ooA (big blind) folded before Flop
Seat 5: YsLQ3BAvgQHWXMAv3Wv6Hg folded on the Turn
Seat 6: /PH6Ffnho4Ysm8S3V/oa+w folded before Flop (didn't bet)



PokerStars Game #59942054020:  Hold'em No Limit ($1/$2) - 2009/07/01 1:54:36 ET
Table 'NmY84NAf9Mh0ckAckHnh5g' 2-max Seat #2 is the button
Seat 1: 6hvg964TSqZ3AL/0XK9aVQ ($381.20 in chips)
Seat 2: RwDoM55ZeQuI2ADyJhOb2Q ($598.30 in chips)
RwDoM55ZeQuI2ADyJhOb2Q: posts small blind $1
6hvg964TSqZ3AL/0XK9aVQ: posts big blind $2
*** HOLE CARDS ***
RwDoM55ZeQuI2ADyJhOb2Q: raises $4 to $6
6hvg964TSqZ3AL/0XK9aVQ: calls $4
*** FLOP *** [Qh Ac 3c]
6hvg964TSqZ3AL/0XK9aVQ: checks
RwDoM55ZeQuI2ADyJhOb2Q: checks
*** TURN *** [Qh Ac 3c] [Jc]
6hvg964TSqZ3AL/0XK9aVQ: bets $8
RwDoM55ZeQuI2ADyJhOb2Q: folds
6hvg964TSqZ3AL/0XK9aVQ collected $11.50 from pot
6hvg964TSqZ3AL/0XK9aVQ: doesn't show hand
*** SUMMARY ***
Total pot $12 | Rake $0.50
Board [Qh Ac 3c Jc]
Seat 1: 6hvg964TSqZ3AL/0XK9aVQ (big blind) collected ($11.50)
Seat 2: RwDoM55ZeQuI2ADyJhOb2Q (button) (small blind) folded on the Turn



PokerStars Game #59942054918:  Hold'em No Limit ($1/$2) - 2009/07/01 1:54:38 ET
Table 'ZzSIe0zTCDv+n6hfbY5tTg' 6-max Seat #3 is the button
Seat 1: VvdR9F3I+2yELkfTVvC1dg ($288.65 in chips)
Seat 2: B87ikIyZ/TzAVeXf38Ny0g ($219 in chips)
Seat 3: gsugPj31Hui3Jefl98MBOA ($341.10 in chips)
Seat 4: 54yWzRRgS0oZ+S6LwZBxMQ ($50.10 in chips)
Seat 5: 3dAbvkxS5NPQTBAbvpinVg ($481.45 in chips)
Seat 6: 09BNF4quPDzanQzM8vc6WA ($37.55 in chips)
54yWzRRgS0oZ+S6LwZBxMQ: posts small blind $1
3dAbvkxS5NPQTBAbvpinVg: posts big blind $2
*** HOLE CARDS ***
09BNF4quPDzanQzM8vc6WA: folds
VvdR9F3I+2yELkfTVvC1dg: folds
B87ikIyZ/TzAVeXf38Ny0g: raises $4 to $6
gsugPj31Hui3Jefl98MBOA: folds
54yWzRRgS0oZ+S6LwZBxMQ: folds
3dAbvkxS5NPQTBAbvpinVg: folds
B87ikIyZ/TzAVeXf38Ny0g collected $5 from pot
B87ikIyZ/TzAVeXf38Ny0g: doesn't show hand
*** SUMMARY ***
Total pot $5 | Rake $0
Seat 1: VvdR9F3I+2yELkfTVvC1dg folded before Flop (didn't bet)
Seat 2: B87ikIyZ/TzAVeXf38Ny0g collected ($5)
Seat 3: gsugPj31Hui3Jefl98MBOA (button) folded before Flop (didn't bet)
Seat 4: 54yWzRRgS0oZ+S6LwZBxMQ (small blind) folded before Flop
Seat 5: 3dAbvkxS5NPQTBAbvpinVg (big blind) folded before Flop
Seat 6: 09BNF4quPDzanQzM8vc6WA folded before Flop (didn't bet)



PokerStars Game #59942054976:  Hold'em No Limit ($1/$2) - 2009/07/01 1:54:38 ET
Table 'mGpP9StWRnoeiBDExc6Frg' 6-max Seat #6 is the button
Seat 1: VvdR9F3I+2yELkfTVvC1dg ($314.40 in chips)
Seat 2: 6hRJ68JkbJq6MYI9o5bUnQ ($101 in chips)
Seat 3: mddoKnqZkdOH7AJOJ/i0DA ($206 in chips)
Seat 4: 4dcDwIHRm96PwtqkpQiuiA ($84.70 in chips)
Seat 5: d1puGuVBE0fidn+5eRJ0tw ($190.35 in chips)
Seat 6: B2Ih1sr5VZk+8He7rcrMtQ ($404.20 in chips)
VvdR9F3I+2yELkfTVvC1dg: posts small blind $1
6hRJ68JkbJq6MYI9o5bUnQ: posts big blind $2
*** HOLE CARDS ***
mddoKnqZkdOH7AJOJ/i0DA: folds
4dcDwIHRm96PwtqkpQiuiA: folds
d1puGuVBE0fidn+5eRJ0tw: calls $2
B2Ih1sr5VZk+8He7rcrMtQ: raises $8 to $10
VvdR9F3I+2yELkfTVvC1dg: folds
6hRJ68JkbJq6MYI9o5bUnQ: folds
d1puGuVBE0fidn+5eRJ0tw: calls $8
*** FLOP *** [6s Th 9h]
d1puGuVBE0fidn+5eRJ0tw: bets $10
B2Ih1sr5VZk+8He7rcrMtQ: raises $30 to $40
d1puGuVBE0fidn+5eRJ0tw: folds
B2Ih1sr5VZk+8He7rcrMtQ collected $40.95 from pot
*** SUMMARY ***
Total pot $43 | Rake $2.05
Board [6s Th 9h]
Seat 1: VvdR9F3I+2yELkfTVvC1dg (small blind) folded before Flop
Seat 2: 6hRJ68JkbJq6MYI9o5bUnQ (big blind) folded before Flop
Seat 3: mddoKnqZkdOH7AJOJ/i0DA folded before Flop (didn't bet)
Seat 4: 4dcDwIHRm96PwtqkpQiuiA folded before Flop (didn't bet)
Seat 5: d1puGuVBE0fidn+5eRJ0tw folded on the Flop
Seat 6: B2Ih1sr5VZk+8He7rcrMtQ (button) collected ($40.95)



PokerStars Game #59942055402:  Hold'em No Limit ($1/$2) - 2009/07/01 1:54:39 ET
Table '+hSnXFQrGw1PlVgTnuj+sA' 6-max Seat #3 is the button
Seat 1: fb8ooqw9ZsZtBsZTZQLNrQ ($50.70 in chips)
Seat 2: 54yWzRRgS0oZ+S6LwZBxMQ ($40 in chips)
Seat 3: cupOBdycmBLQKdVftyAksg ($31.10 in chips)
Seat 4: TRSUrOQh3x1NGeD+dH4yoA ($118.10 in chips)
Seat 5: PZzUwZiFNhCLi6Ouh5ZlmQ ($200 in chips)
Seat 6: 7zM38baFvmCNB/F80oE0cQ ($51.50 in chips)
TRSUrOQh3x1NGeD+dH4yoA: posts small blind $1
PZzUwZiFNhCLi6Ouh5ZlmQ: posts big blind $2
*** HOLE CARDS ***
7zM38baFvmCNB/F80oE0cQ: folds
fb8ooqw9ZsZtBsZTZQLNrQ: calls $2
54yWzRRgS0oZ+S6LwZBxMQ: calls $2
cupOBdycmBLQKdVftyAksg: folds
cupOBdycmBLQKdVftyAksg leaves the table
TRSUrOQh3x1NGeD+dH4yoA: raises $6 to $8
vkfxu8f/jMYKUk6Ly4eujw joins the table at seat #3
PZzUwZiFNhCLi6Ouh5ZlmQ: folds
fb8ooqw9ZsZtBsZTZQLNrQ: folds
54yWzRRgS0oZ+S6LwZBxMQ: folds
TRSUrOQh3x1NGeD+dH4yoA collected $8 from pot
TRSUrOQh3x1NGeD+dH4yoA: doesn't show hand
*** SUMMARY ***
Total pot $8 | Rake $0
Seat 1: fb8ooqw9ZsZtBsZTZQLNrQ folded before Flop
Seat 2: 54yWzRRgS0oZ+S6LwZBxMQ folded before Flop
Seat 3: cupOBdycmBLQKdVftyAksg (button) folded before Flop (didn't bet)
Seat 4: TRSUrOQh3x1NGeD+dH4yoA (small blind) collected ($8)
Seat 5: PZzUwZiFNhCLi6Ouh5ZlmQ (big blind) folded before Flop
Seat 6: 7zM38baFvmCNB/F80oE0cQ folded before Flop (didn't bet)



PokerStars Game #59942057164:  Hold'em No Limit ($1/$2) - 2009/07/01 1:54:42 ET
Table 'P/yCfYl1GfGsu/e6DxDy/A' 2-max Seat #2 is the button
Seat 1: 7fOCUy3x9hdkmXkkDNolGQ ($1156.50 in chips)
Seat 2: RwDoM55ZeQuI2ADyJhOb2Q ($311.50 in chips)
RwDoM55ZeQuI2ADyJhOb2Q: posts small blind $1
7fOCUy3x9hdkmXkkDNolGQ: posts big blind $2
*** HOLE CARDS ***
RwDoM55ZeQuI2ADyJhOb2Q: raises $4 to $6
7fOCUy3x9hdkmXkkDNolGQ: folds
RwDoM55ZeQuI2ADyJhOb2Q collected $4 from pot
RwDoM55ZeQuI2ADyJhOb2Q: doesn't show hand
*** SUMMARY ***
Total pot $4 | Rake $0
Seat 1: 7fOCUy3x9hdkmXkkDNolGQ (big blind) folded before Flop
Seat 2: RwDoM55ZeQuI2ADyJhOb2Q (button) (small blind) collected ($4)



PokerStars Game #59942057862:  Hold'em No Limit ($1/$2) - 2009/07/01 1:54:44 ET
Table '4NGNnZ/osQfNq6abYqkJeA' 6-max Seat #5 is the button
Seat 1: 0Bc+WhbOvaaWIMmmui3q0g ($143.10 in chips)
Seat 2: 669iGNwYwgRZg3nhS+aDAQ ($107.75 in chips)
Seat 3: 54yWzRRgS0oZ+S6LwZBxMQ ($73.35 in chips)
Seat 4: sY+4Uuh5z/6AbXXaCS10jw ($297.10 in chips)
Seat 5: VvdR9F3I+2yELkfTVvC1dg ($208.80 in chips)
Seat 6: /PH6Ffnho4Ysm8S3V/oa+w ($49.20 in chips)
/PH6Ffnho4Ysm8S3V/oa+w: posts small blind $1
0Bc+WhbOvaaWIMmmui3q0g: posts big blind $2
*** HOLE CARDS ***
669iGNwYwgRZg3nhS+aDAQ: folds
54yWzRRgS0oZ+S6LwZBxMQ: calls $2
sY+4Uuh5z/6AbXXaCS10jw: folds
VvdR9F3I+2yELkfTVvC1dg: folds
/PH6Ffnho4Ysm8S3V/oa+w: calls $1
0Bc+WhbOvaaWIMmmui3q0g: raises $6 to $8
54yWzRRgS0oZ+S6LwZBxMQ: folds
/PH6Ffnho4Ysm8S3V/oa+w: folds
0Bc+WhbOvaaWIMmmui3q0g collected $6 from pot
*** SUMMARY ***
Total pot $6 | Rake $0
Seat 1: 0Bc+WhbOvaaWIMmmui3q0g (big blind) collected ($6)
Seat 2: 669iGNwYwgRZg3nhS+aDAQ folded before Flop (didn't bet)
Seat 3: 54yWzRRgS0oZ+S6LwZBxMQ folded before Flop
Seat 4: sY+4Uuh5z/6AbXXaCS10jw folded before Flop (didn't bet)
Seat 5: VvdR9F3I+2yELkfTVvC1dg (button) folded before Flop (didn't bet)
Seat 6: /PH6Ffnho4Ysm8S3V/oa+w (small blind) folded before Flop



PokerStars Game #59942059260:  Hold'em No Limit ($1/$2) - 2009/07/01 1:54:46 ET
Table 'CFkQcfWjKccZaZDf71FK+w' 6-max Seat #3 is the button
Seat 1: vkfxu8f/jMYKUk6Ly4eujw ($224.05 in chips)
Seat 2: ewN/vzF22+/gdzjIKBOlkA ($212.80 in chips)
Seat 3: TMPDCBmlFGM9C+H58PC4sQ ($66.75 in chips)
Seat 4: opJMdoq0E6TRbAQiweyQuA ($38 in chips)
Seat 5: 2lOU1DcvUZaMcxZ95XfzXw ($120.85 in chips)
Seat 6: ORVqY3rf9X6ANA/8s+On2Q ($20.35 in chips)
opJMdoq0E6TRbAQiweyQuA: posts small blind $1
2lOU1DcvUZaMcxZ95XfzXw: posts big blind $2
*** HOLE CARDS ***
ORVqY3rf9X6ANA/8s+On2Q: calls $2
vkfxu8f/jMYKUk6Ly4eujw: folds
ewN/vzF22+/gdzjIKBOlkA: folds
TMPDCBmlFGM9C+H58PC4sQ: calls $2
opJMdoq0E6TRbAQiweyQuA: folds
2lOU1DcvUZaMcxZ95XfzXw: checks
*** FLOP *** [6c 9h Tc]
2lOU1DcvUZaMcxZ95XfzXw: checks
ORVqY3rf9X6ANA/8s+On2Q: checks
TMPDCBmlFGM9C+H58PC4sQ: checks
*** TURN *** [6c 9h Tc] [Jh]
2lOU1DcvUZaMcxZ95XfzXw: checks
ORVqY3rf9X6ANA/8s+On2Q: checks
TMPDCBmlFGM9C+H58PC4sQ: checks
*** RIVER *** [6c 9h Tc Jh] [Qh]
2lOU1DcvUZaMcxZ95XfzXw: checks
ORVqY3rf9X6ANA/8s+On2Q: checks
TMPDCBmlFGM9C+H58PC4sQ: checks
*** SHOW DOWN ***
2lOU1DcvUZaMcxZ95XfzXw: shows [4h 4c] (a pair of Fours)
ORVqY3rf9X6ANA/8s+On2Q: shows [Ks Qs] (a straight, Nine to King)
TMPDCBmlFGM9C+H58PC4sQ: mucks hand
ORVqY3rf9X6ANA/8s+On2Q collected $6.65 from pot
*** SUMMARY ***
Total pot $7 | Rake $0.35
Board [6c 9h Tc Jh Qh]
Seat 1: vkfxu8f/jMYKUk6Ly4eujw folded before Flop (didn't bet)
Seat 2: ewN/vzF22+/gdzjIKBOlkA folded before Flop (didn't bet)
Seat 3: TMPDCBmlFGM9C+H58PC4sQ (button) mucked
Seat 4: opJMdoq0E6TRbAQiweyQuA (small blind) folded before Flop
Seat 5: 2lOU1DcvUZaMcxZ95XfzXw (big blind) showed [4h 4c] and lost with a pair of Fours
Seat 6: ORVqY3rf9X6ANA/8s+On2Q showed [Ks Qs] and won ($6.65) with a straight, Nine to King



PokerStars Game #59942060218:  Hold'em No Limit ($1/$2) - 2009/07/01 1:54:48 ET
Table 'gnHBqWll9O3fxG7Ojkz/ng' 9-max Seat #6 is the button
Seat 1: MtdNf9cdM7+0CSU0dx4USA ($77.35 in chips)
Seat 2: H6Z4+qu8gR0VUiPOijndVg ($335.30 in chips)
Seat 3: 5Q8U6iZbeO7xJSS4qvDP5g ($238.10 in chips)
Seat 5: rBQDMkKm9cZn6M9NPsiVew ($166.15 in chips)
Seat 6: KqHysDSpCPaPyK3tJC1aEw ($200 in chips)
Seat 7: 254YPxPJr5Sw58bkD0YqYQ ($201 in chips)
Seat 8: cM6efHzdxoqYm0EQKP4TTQ ($138.70 in chips)
Seat 9: GX1heJ+DSsvm7gzSPsYhhQ ($33.15 in chips)
254YPxPJr5Sw58bkD0YqYQ: posts small blind $1
cM6efHzdxoqYm0EQKP4TTQ: posts big blind $2
*** HOLE CARDS ***
GX1heJ+DSsvm7gzSPsYhhQ: raises $4 to $6
MtdNf9cdM7+0CSU0dx4USA: folds
H6Z4+qu8gR0VUiPOijndVg: folds
5Q8U6iZbeO7xJSS4qvDP5g: calls $6
rBQDMkKm9cZn6M9NPsiVew: folds
KqHysDSpCPaPyK3tJC1aEw: folds
254YPxPJr5Sw58bkD0YqYQ: folds
cM6efHzdxoqYm0EQKP4TTQ: calls $4
*** FLOP *** [6s 4s 7d]
cM6efHzdxoqYm0EQKP4TTQ: checks
GX1heJ+DSsvm7gzSPsYhhQ: checks
5Q8U6iZbeO7xJSS4qvDP5g: bets $14
cM6efHzdxoqYm0EQKP4TTQ: folds
GX1heJ+DSsvm7gzSPsYhhQ: folds
5Q8U6iZbeO7xJSS4qvDP5g collected $18.05 from pot
5Q8U6iZbeO7xJSS4qvDP5g: doesn't show hand
*** SUMMARY ***
Total pot $19 | Rake $0.95
Board [6s 4s 7d]
Seat 1: MtdNf9cdM7+0CSU0dx4USA folded before Flop (didn't bet)
Seat 2: H6Z4+qu8gR0VUiPOijndVg folded before Flop (didn't bet)
Seat 3: 5Q8U6iZbeO7xJSS4qvDP5g collected ($18.05)
Seat 5: rBQDMkKm9cZn6M9NPsiVew folded before Flop (didn't bet)
Seat 6: KqHysDSpCPaPyK3tJC1aEw (button) folded before Flop (didn't bet)
Seat 7: 254YPxPJr5Sw58bkD0YqYQ (small blind) folded before Flop
Seat 8: cM6efHzdxoqYm0EQKP4TTQ (big blind) folded on the Flop
Seat 9: GX1heJ+DSsvm7gzSPsYhhQ folded on the Flop



PokerStars Game #59942060938:  Hold'em No Limit ($1/$2) - 2009/07/01 1:54:49 ET
Table 'LL4bDFyhj5hsMpzaDugJZg' 6-max Seat #6 is the button
Seat 1: ubtx4Z5L+AcK71MTvYiGVw ($208.40 in chips)
Seat 2: TMPDCBmlFGM9C+H58PC4sQ ($21.75 in chips)
Seat 3: opJMdoq0E6TRbAQiweyQuA ($40 in chips)
Seat 4: 8srN1dKQePlsv0GyTada+Q ($387.85 in chips)
Seat 5: on4ebXPJvUBOcHOBMQsRSg ($77.35 in chips)
Seat 6: mddoKnqZkdOH7AJOJ/i0DA ($209.30 in chips)
ubtx4Z5L+AcK71MTvYiGVw: posts small blind $1
TMPDCBmlFGM9C+H58PC4sQ: posts big blind $2
*** HOLE CARDS ***
opJMdoq0E6TRbAQiweyQuA: folds
8srN1dKQePlsv0GyTada+Q: folds
on4ebXPJvUBOcHOBMQsRSg: folds
mddoKnqZkdOH7AJOJ/i0DA: folds
ubtx4Z5L+AcK71MTvYiGVw: raises $38 to $40
TMPDCBmlFGM9C+H58PC4sQ: calls $19.75 and is all-in
*** FLOP *** [6c 7h Tc]
*** TURN *** [6c 7h Tc] [4h]
*** RIVER *** [6c 7h Tc 4h] [8h]
*** SHOW DOWN ***
ubtx4Z5L+AcK71MTvYiGVw: shows [Kh Qs] (high card King)
TMPDCBmlFGM9C+H58PC4sQ: shows [Ts 9h] (a straight, Six to Ten)
TMPDCBmlFGM9C+H58PC4sQ collected $41.35 from pot
*** SUMMARY ***
Total pot $43.50 | Rake $2.15
Board [6c 7h Tc 4h 8h]
Seat 1: ubtx4Z5L+AcK71MTvYiGVw (small blind) showed [Kh Qs] and lost with high card King
Seat 2: TMPDCBmlFGM9C+H58PC4sQ (big blind) showed [Ts 9h] and won ($41.35) with a straight, Six to Ten
Seat 3: opJMdoq0E6TRbAQiweyQuA folded before Flop (didn't bet)
Seat 4: 8srN1dKQePlsv0GyTada+Q folded before Flop (didn't bet)
Seat 5: on4ebXPJvUBOcHOBMQsRSg folded before Flop (didn't bet)
Seat 6: mddoKnqZkdOH7AJOJ/i0DA (button) folded before Flop (didn't bet)



PokerStars Game #59942061318:  Hold'em No Limit ($1/$2) - 2009/07/01 1:54:50 ET
Table 'aSf77Sj8QEnzcc0WaxVD4Q' 6-max Seat #2 is the button
Seat 1: UELtvp+JfwI7XDGVwSxZXA ($168.85 in chips)
Seat 2: vkfxu8f/jMYKUk6Ly4eujw ($197 in chips)
Seat 4: YsLQ3BAvgQHWXMAv3Wv6Hg ($200 in chips)
Seat 5: VvdR9F3I+2yELkfTVvC1dg ($289.15 in chips)
Seat 6: vkoJRf3gidxY1pPi0AFWww ($197.85 in chips)
3cPMpDMgeOMAe4UceUfLsg will be allowed to play after the button
YsLQ3BAvgQHWXMAv3Wv6Hg: posts small blind $1
VvdR9F3I+2yELkfTVvC1dg: posts big blind $2
*** HOLE CARDS ***
vkoJRf3gidxY1pPi0AFWww: calls $2
UELtvp+JfwI7XDGVwSxZXA: calls $2
vkfxu8f/jMYKUk6Ly4eujw: raises $10 to $12
YsLQ3BAvgQHWXMAv3Wv6Hg: folds
VvdR9F3I+2yELkfTVvC1dg: folds
vkoJRf3gidxY1pPi0AFWww: folds
UELtvp+JfwI7XDGVwSxZXA: folds
vkfxu8f/jMYKUk6Ly4eujw collected $9 from pot
vkfxu8f/jMYKUk6Ly4eujw: doesn't show hand
*** SUMMARY ***
Total pot $9 | Rake $0
Seat 1: UELtvp+JfwI7XDGVwSxZXA folded before Flop
Seat 2: vkfxu8f/jMYKUk6Ly4eujw (button) collected ($9)
Seat 4: YsLQ3BAvgQHWXMAv3Wv6Hg (small blind) folded before Flop
Seat 5: VvdR9F3I+2yELkfTVvC1dg (big blind) folded before Flop
Seat 6: vkoJRf3gidxY1pPi0AFWww folded before Flop



PokerStars Game #59942061868:  Hold'em No Limit ($1/$2) - 2009/07/01 1:54:51 ET
Table 'TsEDkiO4tzCTCzJ7tNdEqw' 6-max Seat #6 is the button
Seat 1: Nsjun4mjI8q0SSBTIp1dIQ ($200 in chips)
Seat 2: 4dcDwIHRm96PwtqkpQiuiA ($83.70 in chips)
Seat 3: ubtx4Z5L+AcK71MTvYiGVw ($253.20 in chips)
Seat 4: K8MXCrNAVYlMnnCeM32Kxw ($75.35 in chips)
Seat 5: VvdR9F3I+2yELkfTVvC1dg ($250.10 in chips)
Seat 6: uCqEjnxh2/vFBjKYkfTOkw ($277.10 in chips)
Nsjun4mjI8q0SSBTIp1dIQ: posts small blind $1
4dcDwIHRm96PwtqkpQiuiA: posts big blind $2
*** HOLE CARDS ***
ubtx4Z5L+AcK71MTvYiGVw: folds
K8MXCrNAVYlMnnCeM32Kxw: raises $2 to $4
VvdR9F3I+2yELkfTVvC1dg: folds
uCqEjnxh2/vFBjKYkfTOkw: folds
Nsjun4mjI8q0SSBTIp1dIQ: folds
4dcDwIHRm96PwtqkpQiuiA: folds
K8MXCrNAVYlMnnCeM32Kxw collected $5 from pot
*** SUMMARY ***
Total pot $5 | Rake $0
Seat 1: Nsjun4mjI8q0SSBTIp1dIQ (small blind) folded before Flop
Seat 2: 4dcDwIHRm96PwtqkpQiuiA (big blind) folded before Flop
Seat 3: ubtx4Z5L+AcK71MTvYiGVw folded before Flop (didn't bet)
Seat 4: K8MXCrNAVYlMnnCeM32Kxw collected ($5)
Seat 5: VvdR9F3I+2yELkfTVvC1dg folded before Flop (didn't bet)
Seat 6: uCqEjnxh2/vFBjKYkfTOkw (button) folded before Flop (didn't bet)



PokerStars Game #59942061618:  Hold'em No Limit ($1/$2) - 2009/07/01 1:54:51 ET
Table '5/wEe6JmtGD7vufSA2RG7A' 2-max Seat #1 is the button
Seat 1: pVqEzK9wXlRMECnb1Zg4Zw ($208 in chips)
Seat 2: aOL8geThaYp2iadSHl1h1g ($445.50 in chips)
pVqEzK9wXlRMECnb1Zg4Zw: posts small blind $1
aOL8geThaYp2iadSHl1h1g: posts big blind $2
*** HOLE CARDS ***
pVqEzK9wXlRMECnb1Zg4Zw: folds
aOL8geThaYp2iadSHl1h1g collected $2 from pot
aOL8geThaYp2iadSHl1h1g: doesn't show hand
*** SUMMARY ***
Total pot $2 | Rake $0
Seat 1: pVqEzK9wXlRMECnb1Zg4Zw (button) (small blind) folded before Flop
Seat 2: aOL8geThaYp2iadSHl1h1g (big blind) collected ($2)



PokerStars Game #59942061580:  Hold'em No Limit ($1/$2) - 2009/07/01 1:54:51 ET
Table 'P/yCfYl1GfGsu/e6DxDy/A' 2-max Seat #1 is the button
Seat 1: 7fOCUy3x9hdkmXkkDNolGQ ($1154.50 in chips)
Seat 2: RwDoM55ZeQuI2ADyJhOb2Q ($313.50 in chips)
7fOCUy3x9hdkmXkkDNolGQ: posts small blind $1
RwDoM55ZeQuI2ADyJhOb2Q: posts big blind $2
*** HOLE CARDS ***
7fOCUy3x9hdkmXkkDNolGQ: raises $4 to $6
RwDoM55ZeQuI2ADyJhOb2Q: raises $14 to $20
7fOCUy3x9hdkmXkkDNolGQ: folds
RwDoM55ZeQuI2ADyJhOb2Q collected $12 from pot
RwDoM55ZeQuI2ADyJhOb2Q: doesn't show hand
*** SUMMARY ***
Total pot $12 | Rake $0
Seat 1: 7fOCUy3x9hdkmXkkDNolGQ (button) (small blind) folded before Flop
Seat 2: RwDoM55ZeQuI2ADyJhOb2Q (big blind) collected ($12)



PokerStars Game #59942064826:  Hold'em No Limit ($1/$2) - 2009/07/01 1:54:57 ET
Table '5/wEe6JmtGD7vufSA2RG7A' 2-max Seat #2 is the button
Seat 1: pVqEzK9wXlRMECnb1Zg4Zw ($207 in chips)
Seat 2: aOL8geThaYp2iadSHl1h1g ($446.50 in chips)
aOL8geThaYp2iadSHl1h1g: posts small blind $1
pVqEzK9wXlRMECnb1Zg4Zw: posts big blind $2
*** HOLE CARDS ***
aOL8geThaYp2iadSHl1h1g: raises $4 to $6
pVqEzK9wXlRMECnb1Zg4Zw: calls $4
*** FLOP *** [5c 8h 4h]
pVqEzK9wXlRMECnb1Zg4Zw: checks
aOL8geThaYp2iadSHl1h1g: bets $8
pVqEzK9wXlRMECnb1Zg4Zw: folds
aOL8geThaYp2iadSHl1h1g collected $11.50 from pot
aOL8geThaYp2iadSHl1h1g: doesn't show hand
*** SUMMARY ***
Total pot $12 | Rake $0.50
Board [5c 8h 4h]
Seat 1: pVqEzK9wXlRMECnb1Zg4Zw (big blind) folded on the Flop
Seat 2: aOL8geThaYp2iadSHl1h1g (button) (small blind) collected ($11.50)



PokerStars Game #59942064588:  Hold'em No Limit ($1/$2) - 2009/07/01 1:54:57 ET
Table 'NmY84NAf9Mh0ckAckHnh5g' 2-max Seat #1 is the button
Seat 1: 6hvg964TSqZ3AL/0XK9aVQ ($386.70 in chips)
Seat 2: RwDoM55ZeQuI2ADyJhOb2Q ($592.30 in chips)
6hvg964TSqZ3AL/0XK9aVQ: posts small blind $1
RwDoM55ZeQuI2ADyJhOb2Q: posts big blind $2
*** HOLE CARDS ***
6hvg964TSqZ3AL/0XK9aVQ: calls $1
RwDoM55ZeQuI2ADyJhOb2Q: checks
*** FLOP *** [6s 7s 5s]
RwDoM55ZeQuI2ADyJhOb2Q: bets $4
6hvg964TSqZ3AL/0XK9aVQ: calls $4
*** TURN *** [6s 7s 5s] [Ks]
RwDoM55ZeQuI2ADyJhOb2Q: bets $12
6hvg964TSqZ3AL/0XK9aVQ: raises $12 to $24
RwDoM55ZeQuI2ADyJhOb2Q: calls $12
*** RIVER *** [6s 7s 5s Ks] [3h]
RwDoM55ZeQuI2ADyJhOb2Q: checks
6hvg964TSqZ3AL/0XK9aVQ: checks
*** SHOW DOWN ***
RwDoM55ZeQuI2ADyJhOb2Q: shows [Ts 7c] (a flush, King high)
6hvg964TSqZ3AL/0XK9aVQ: mucks hand
RwDoM55ZeQuI2ADyJhOb2Q collected $59.50 from pot
*** SUMMARY ***
Total pot $60 | Rake $0.50
Board [6s 7s 5s Ks 3h]
Seat 1: 6hvg964TSqZ3AL/0XK9aVQ (button) (small blind) mucked
Seat 2: RwDoM55ZeQuI2ADyJhOb2Q (big blind) showed [Ts 7c] and won ($59.50) with a flush, King high



PokerStars Game #59942065006:  Hold'em No Limit ($1/$2) - 2009/07/01 1:54:57 ET
Table 'pPQgcj9XT9CHBsbo1WTBug' 6-max Seat #2 is the button
Seat 1: DFVYDA6dKQy7R7mGIKogZA ($151.45 in chips)
Seat 2: qXDd0ZyMIse0OBu8pxeQ3Q ($200 in chips)
Seat 3: sSAA879uXOGR+8Mf3zLa6Q ($132.90 in chips)
Seat 4: cwfuMyvDC7J7SqX2leDC8g ($62.30 in chips)
Seat 5: vkfxu8f/jMYKUk6Ly4eujw ($115.60 in chips)
Seat 6: Yr7pZltpy3IUNdKS9PCEiw ($304.80 in chips)
sSAA879uXOGR+8Mf3zLa6Q: posts small blind $1
cwfuMyvDC7J7SqX2leDC8g: posts big blind $2
*** HOLE CARDS ***
vkfxu8f/jMYKUk6Ly4eujw: folds
Yr7pZltpy3IUNdKS9PCEiw: raises $4 to $6
DFVYDA6dKQy7R7mGIKogZA: folds
qXDd0ZyMIse0OBu8pxeQ3Q: folds
sSAA879uXOGR+8Mf3zLa6Q: raises $10 to $16
cwfuMyvDC7J7SqX2leDC8g: folds
Yr7pZltpy3IUNdKS9PCEiw: calls $10
*** FLOP *** [4s Jh 5c]
sSAA879uXOGR+8Mf3zLa6Q: bets $16
Yr7pZltpy3IUNdKS9PCEiw: folds
sSAA879uXOGR+8Mf3zLa6Q collected $32.30 from pot
*** SUMMARY ***
Total pot $34 | Rake $1.70
Board [4s Jh 5c]
Seat 1: DFVYDA6dKQy7R7mGIKogZA folded before Flop (didn't bet)
Seat 2: qXDd0ZyMIse0OBu8pxeQ3Q (button) folded before Flop (didn't bet)
Seat 3: sSAA879uXOGR+8Mf3zLa6Q (small blind) collected ($32.30)
Seat 4: cwfuMyvDC7J7SqX2leDC8g (big blind) folded before Flop
Seat 5: vkfxu8f/jMYKUk6Ly4eujw folded before Flop (didn't bet)
Seat 6: Yr7pZltpy3IUNdKS9PCEiw folded on the Flop



PokerStars Game #59942066132:  Hold'em No Limit ($1/$2) - 2009/07/01 1:55:00 ET
Table '7goFpXy7qyiK5mwx+Ucf6A' 6-max Seat #3 is the button
Seat 1: VHmJJYp7TGQwcWROQ8dqXw ($51.10 in chips)
Seat 2: BWhgxe7gWiYobRbwdG+d2Q ($196 in chips)
Seat 3: mfy7uGZcqA2PVQqEVbJ7+g ($137.35 in chips)
Seat 4: fE+LHW/7rpfXW14g8LhGjA ($51.85 in chips)
Seat 6: VvdR9F3I+2yELkfTVvC1dg ($216.65 in chips)
fE+LHW/7rpfXW14g8LhGjA: posts small blind $1
/PH6Ffnho4Ysm8S3V/oa+w: is sitting out
VvdR9F3I+2yELkfTVvC1dg: posts big blind $2
*** HOLE CARDS ***
/PH6Ffnho4Ysm8S3V/oa+w leaves the table
VHmJJYp7TGQwcWROQ8dqXw: calls $2
BWhgxe7gWiYobRbwdG+d2Q: folds
mfy7uGZcqA2PVQqEVbJ7+g: raises $7 to $9
fE+LHW/7rpfXW14g8LhGjA: calls $8
vkfxu8f/jMYKUk6Ly4eujw joins the table at seat #5
VvdR9F3I+2yELkfTVvC1dg: folds
VHmJJYp7TGQwcWROQ8dqXw: folds
*** FLOP *** [2h 4d 8h]
fE+LHW/7rpfXW14g8LhGjA: checks
mfy7uGZcqA2PVQqEVbJ7+g: bets $21
fE+LHW/7rpfXW14g8LhGjA: folds
mfy7uGZcqA2PVQqEVbJ7+g collected $20.90 from pot
mfy7uGZcqA2PVQqEVbJ7+g: doesn't show hand
*** SUMMARY ***
Total pot $22 | Rake $1.10
Board [2h 4d 8h]
Seat 1: VHmJJYp7TGQwcWROQ8dqXw folded before Flop
Seat 2: BWhgxe7gWiYobRbwdG+d2Q folded before Flop (didn't bet)
Seat 3: mfy7uGZcqA2PVQqEVbJ7+g (button) collected ($20.90)
Seat 4: fE+LHW/7rpfXW14g8LhGjA (small blind) folded on the Flop
Seat 6: VvdR9F3I+2yELkfTVvC1dg (big blind) folded before Flop



PokerStars Game #59942066352:  Hold'em No Limit ($1/$2) - 2009/07/01 1:55:00 ET
Table 'rsKRKlGHlxVyqJxzO2a2Ow' 9-max Seat #1 is the button
Seat 1: KqHysDSpCPaPyK3tJC1aEw ($209.30 in chips)
Seat 3: kM9CA+2UcdMjbCMbtUCGiA ($226.10 in chips)
Seat 4: 31HuO+DQxppUQEedBWukug ($108.85 in chips)
Seat 5: 5Q8U6iZbeO7xJSS4qvDP5g ($253.55 in chips)
Seat 6: H6Z4+qu8gR0VUiPOijndVg ($203 in chips)
Seat 7: GX1heJ+DSsvm7gzSPsYhhQ ($53 in chips)
Seat 8: CkE3IyJF1KvdaAOmZY5XqQ ($206.70 in chips)
Seat 9: gRbvhSUVg+TNaTjaJecIRw ($50.60 in chips)
TAfo4veNRaRlzDXMMYS3Jg will be allowed to play after the button
kM9CA+2UcdMjbCMbtUCGiA: posts small blind $1
31HuO+DQxppUQEedBWukug: posts big blind $2
*** HOLE CARDS ***
5Q8U6iZbeO7xJSS4qvDP5g: folds
TAfo4veNRaRlzDXMMYS3Jg is sitting out
H6Z4+qu8gR0VUiPOijndVg: folds
GX1heJ+DSsvm7gzSPsYhhQ: folds
TAfo4veNRaRlzDXMMYS3Jg leaves the table
CkE3IyJF1KvdaAOmZY5XqQ: folds
gRbvhSUVg+TNaTjaJecIRw: folds
KqHysDSpCPaPyK3tJC1aEw: folds
kM9CA+2UcdMjbCMbtUCGiA: raises $2 to $4
254YPxPJr5Sw58bkD0YqYQ joins the table at seat #2
31HuO+DQxppUQEedBWukug: raises $6 to $10
kM9CA+2UcdMjbCMbtUCGiA: calls $6
*** FLOP *** [7h 6d 8c]
kM9CA+2UcdMjbCMbtUCGiA: checks
31HuO+DQxppUQEedBWukug: bets $18
kM9CA+2UcdMjbCMbtUCGiA: calls $18
*** TURN *** [7h 6d 8c] [Qh]
kM9CA+2UcdMjbCMbtUCGiA: checks
31HuO+DQxppUQEedBWukug: bets $50
kM9CA+2UcdMjbCMbtUCGiA: folds
31HuO+DQxppUQEedBWukug collected $53.25 from pot
31HuO+DQxppUQEedBWukug: doesn't show hand
*** SUMMARY ***
Total pot $56 | Rake $2.75
Board [7h 6d 8c Qh]
Seat 1: KqHysDSpCPaPyK3tJC1aEw (button) folded before Flop (didn't bet)
Seat 3: kM9CA+2UcdMjbCMbtUCGiA (small blind) folded on the Turn
Seat 4: 31HuO+DQxppUQEedBWukug (big blind) collected ($53.25)
Seat 5: 5Q8U6iZbeO7xJSS4qvDP5g folded before Flop (didn't bet)
Seat 6: H6Z4+qu8gR0VUiPOijndVg folded before Flop (didn't bet)
Seat 7: GX1heJ+DSsvm7gzSPsYhhQ folded before Flop (didn't bet)
Seat 8: CkE3IyJF1KvdaAOmZY5XqQ folded before Flop (didn't bet)
Seat 9: gRbvhSUVg+TNaTjaJecIRw folded before Flop (didn't bet)



PokerStars Game #59942068186:  Hold'em No Limit ($1/$2) - 2009/07/01 1:55:04 ET
Table 'P/yCfYl1GfGsu/e6DxDy/A' 2-max Seat #2 is the button
Seat 1: 7fOCUy3x9hdkmXkkDNolGQ ($1148.50 in chips)
Seat 2: RwDoM55ZeQuI2ADyJhOb2Q ($319.50 in chips)
RwDoM55ZeQuI2ADyJhOb2Q: posts small blind $1
7fOCUy3x9hdkmXkkDNolGQ: posts big blind $2
*** HOLE CARDS ***
RwDoM55ZeQuI2ADyJhOb2Q: raises $4 to $6
7fOCUy3x9hdkmXkkDNolGQ: calls $4
*** FLOP *** [4h Qh 4s]
7fOCUy3x9hdkmXkkDNolGQ: checks
RwDoM55ZeQuI2ADyJhOb2Q: bets $10
7fOCUy3x9hdkmXkkDNolGQ: raises $20 to $30
RwDoM55ZeQuI2ADyJhOb2Q: calls $20
*** TURN *** [4h Qh 4s] [Js]
7fOCUy3x9hdkmXkkDNolGQ: checks
RwDoM55ZeQuI2ADyJhOb2Q: checks
*** RIVER *** [4h Qh 4s Js] [3h]
7fOCUy3x9hdkmXkkDNolGQ: checks
RwDoM55ZeQuI2ADyJhOb2Q: checks
*** SHOW DOWN ***
7fOCUy3x9hdkmXkkDNolGQ: shows [2h As] (a pair of Fours)
RwDoM55ZeQuI2ADyJhOb2Q: shows [Qc Ts] (two pair, Queens and Fours)
RwDoM55ZeQuI2ADyJhOb2Q collected $71.50 from pot
*** SUMMARY ***
Total pot $72 | Rake $0.50
Board [4h Qh 4s Js 3h]
Seat 1: 7fOCUy3x9hdkmXkkDNolGQ (big blind) showed [2h As] and lost with a pair of Fours
Seat 2: RwDoM55ZeQuI2ADyJhOb2Q (button) (small blind) showed [Qc Ts] and won ($71.50) with two pair, Queens and Fours



PokerStars Game #59942070116:  Hold'em No Limit ($1/$2) - 2009/07/01 1:55:07 ET
Table '+hSnXFQrGw1PlVgTnuj+sA' 6-max Seat #4 is the button
Seat 1: fb8ooqw9ZsZtBsZTZQLNrQ ($48.70 in chips)
Seat 2: 54yWzRRgS0oZ+S6LwZBxMQ ($38 in chips)
Seat 4: TRSUrOQh3x1NGeD+dH4yoA ($124.10 in chips)
Seat 5: PZzUwZiFNhCLi6Ouh5ZlmQ ($200 in chips)
Seat 6: 7zM38baFvmCNB/F80oE0cQ ($51.50 in chips)
PZzUwZiFNhCLi6Ouh5ZlmQ: posts small blind $1
7zM38baFvmCNB/F80oE0cQ: posts big blind $2
vkfxu8f/jMYKUk6Ly4eujw: sits out
*** HOLE CARDS ***
fb8ooqw9ZsZtBsZTZQLNrQ: folds
54yWzRRgS0oZ+S6LwZBxMQ: folds
TRSUrOQh3x1NGeD+dH4yoA: folds
PZzUwZiFNhCLi6Ouh5ZlmQ: folds
7zM38baFvmCNB/F80oE0cQ collected $2 from pot
7zM38baFvmCNB/F80oE0cQ: doesn't show hand
*** SUMMARY ***
Total pot $2 | Rake $0
Seat 1: fb8ooqw9ZsZtBsZTZQLNrQ folded before Flop (didn't bet)
Seat 2: 54yWzRRgS0oZ+S6LwZBxMQ folded before Flop (didn't bet)
Seat 4: TRSUrOQh3x1NGeD+dH4yoA (button) folded before Flop (didn't bet)
Seat 5: PZzUwZiFNhCLi6Ouh5ZlmQ (small blind) folded before Flop
Seat 6: 7zM38baFvmCNB/F80oE0cQ (big blind) collected ($2)



PokerStars Game #59942069886:  Hold'em No Limit ($1/$2) - 2009/07/01 1:55:07 ET
Table 'QxerF7GUfCbl+4a8XaTB2w' 6-max Seat #3 is the button
Seat 1: ZwvXzkkZ3XpMhKfAmVpahw ($285.25 in chips)
Seat 2: 6UGgYbxwWNc+ohObe8vB9w ($80 in chips)
Seat 3: 8rZGabKe2DEPdZCbCivZ9Q ($22.80 in chips)
Seat 4: /PH6Ffnho4Ysm8S3V/oa+w ($51 in chips)
Seat 5: vkfxu8f/jMYKUk6Ly4eujw ($152.05 in chips)
Seat 6: VvdR9F3I+2yELkfTVvC1dg ($218.10 in chips)
/PH6Ffnho4Ysm8S3V/oa+w: posts small blind $1
vkfxu8f/jMYKUk6Ly4eujw: posts big blind $2
*** HOLE CARDS ***
VvdR9F3I+2yELkfTVvC1dg: raises $2 to $4
ZwvXzkkZ3XpMhKfAmVpahw: folds
6UGgYbxwWNc+ohObe8vB9w: folds
8rZGabKe2DEPdZCbCivZ9Q: folds
/PH6Ffnho4Ysm8S3V/oa+w: folds
vkfxu8f/jMYKUk6Ly4eujw: folds
VvdR9F3I+2yELkfTVvC1dg collected $5 from pot
VvdR9F3I+2yELkfTVvC1dg: doesn't show hand
*** SUMMARY ***
Total pot $5 | Rake $0
Seat 1: ZwvXzkkZ3XpMhKfAmVpahw folded before Flop (didn't bet)
Seat 2: 6UGgYbxwWNc+ohObe8vB9w folded before Flop (didn't bet)
Seat 3: 8rZGabKe2DEPdZCbCivZ9Q (button) folded before Flop (didn't bet)
Seat 4: /PH6Ffnho4Ysm8S3V/oa+w (small blind) folded before Flop
Seat 5: vkfxu8f/jMYKUk6Ly4eujw (big blind) folded before Flop
Seat 6: VvdR9F3I+2yELkfTVvC1dg collected ($5)



PokerStars Game #59942071584:  Hold'em No Limit ($1/$2) - 2009/07/01 1:55:10 ET
Table 'o63a8j70meKHUtgLFryQvg' 9-max Seat #7 is the button
Seat 1: +1R0op5O3Gf6aUPJTw7jjA ($197 in chips)
Seat 2: SgA0Zfa/3yhNp7ILXcXcCg ($58.15 in chips)
Seat 3: IYBKVnE2Basnr88BAhH+bQ ($265.40 in chips)
Seat 4: ZYHoLw2lWmRS7CSHi8L8Xg ($209.90 in chips)
Seat 5: g3ZVTc1EbSNXYYMO82jL7Q ($223.30 in chips)
Seat 6: CUZwDpLTQKhzarPe+JCLOQ ($200 in chips)
Seat 7: kM9CA+2UcdMjbCMbtUCGiA ($200 in chips)
Seat 8: ItDFe9gh5QYPQB9vC4ntUA ($385.05 in chips)
Seat 9: rW/MyplHylMSBRaoRUzWrg ($40 in chips)
ItDFe9gh5QYPQB9vC4ntUA: posts small blind $1
rW/MyplHylMSBRaoRUzWrg: posts big blind $2
*** HOLE CARDS ***
+1R0op5O3Gf6aUPJTw7jjA: folds
SgA0Zfa/3yhNp7ILXcXcCg: calls $2
IYBKVnE2Basnr88BAhH+bQ: folds
ZYHoLw2lWmRS7CSHi8L8Xg: folds
g3ZVTc1EbSNXYYMO82jL7Q: folds
CUZwDpLTQKhzarPe+JCLOQ: raises $8 to $10
kM9CA+2UcdMjbCMbtUCGiA: folds
ItDFe9gh5QYPQB9vC4ntUA: folds
rW/MyplHylMSBRaoRUzWrg: folds
SgA0Zfa/3yhNp7ILXcXcCg: calls $8
*** FLOP *** [Th Ts Qd]
SgA0Zfa/3yhNp7ILXcXcCg: bets $6
CUZwDpLTQKhzarPe+JCLOQ: calls $6
*** TURN *** [Th Ts Qd] [5s]
SgA0Zfa/3yhNp7ILXcXcCg: checks
CUZwDpLTQKhzarPe+JCLOQ: bets $16
SgA0Zfa/3yhNp7ILXcXcCg: calls $16
*** RIVER *** [Th Ts Qd 5s] [8s]
SgA0Zfa/3yhNp7ILXcXcCg: bets $10
CUZwDpLTQKhzarPe+JCLOQ: raises $84 to $94
SgA0Zfa/3yhNp7ILXcXcCg: calls $16.15 and is all-in
*** SHOW DOWN ***
CUZwDpLTQKhzarPe+JCLOQ: shows [Ks Td] (three of a kind, Tens)
SgA0Zfa/3yhNp7ILXcXcCg: shows [Js 9d] (a straight, Eight to Queen)
SgA0Zfa/3yhNp7ILXcXcCg collected $116.30 from pot
*** SUMMARY ***
Total pot $119.30 | Rake $3
Board [Th Ts Qd 5s 8s]
Seat 1: +1R0op5O3Gf6aUPJTw7jjA folded before Flop (didn't bet)
Seat 2: SgA0Zfa/3yhNp7ILXcXcCg showed [Js 9d] and won ($116.30) with a straight, Eight to Queen
Seat 3: IYBKVnE2Basnr88BAhH+bQ folded before Flop (didn't bet)
Seat 4: ZYHoLw2lWmRS7CSHi8L8Xg folded before Flop (didn't bet)
Seat 5: g3ZVTc1EbSNXYYMO82jL7Q folded before Flop (didn't bet)
Seat 6: CUZwDpLTQKhzarPe+JCLOQ showed [Ks Td] and lost with three of a kind, Tens
Seat 7: kM9CA+2UcdMjbCMbtUCGiA (button) folded before Flop (didn't bet)
Seat 8: ItDFe9gh5QYPQB9vC4ntUA (small blind) folded before Flop
Seat 9: rW/MyplHylMSBRaoRUzWrg (big blind) folded before Flop



PokerStars Game #59942072064:  Hold'em No Limit ($1/$2) - 2009/07/01 1:55:11 ET
Table 'mGpP9StWRnoeiBDExc6Frg' 6-max Seat #1 is the button
Seat 1: VvdR9F3I+2yELkfTVvC1dg ($313.40 in chips)
Seat 2: 6hRJ68JkbJq6MYI9o5bUnQ ($99 in chips)
Seat 3: mddoKnqZkdOH7AJOJ/i0DA ($206 in chips)
Seat 4: 4dcDwIHRm96PwtqkpQiuiA ($84.70 in chips)
Seat 5: d1puGuVBE0fidn+5eRJ0tw ($170.35 in chips)
Seat 6: B2Ih1sr5VZk+8He7rcrMtQ ($425.15 in chips)
6hRJ68JkbJq6MYI9o5bUnQ: posts small blind $1
mddoKnqZkdOH7AJOJ/i0DA: posts big blind $2
*** HOLE CARDS ***
4dcDwIHRm96PwtqkpQiuiA: folds
d1puGuVBE0fidn+5eRJ0tw: calls $2
B2Ih1sr5VZk+8He7rcrMtQ: folds
VvdR9F3I+2yELkfTVvC1dg: raises $6 to $8
6hRJ68JkbJq6MYI9o5bUnQ: folds
mddoKnqZkdOH7AJOJ/i0DA: calls $6
d1puGuVBE0fidn+5eRJ0tw: calls $6
*** FLOP *** [Kd Qh 2h]
mddoKnqZkdOH7AJOJ/i0DA: checks
d1puGuVBE0fidn+5eRJ0tw: checks
VvdR9F3I+2yELkfTVvC1dg: bets $17.80
mddoKnqZkdOH7AJOJ/i0DA: folds
d1puGuVBE0fidn+5eRJ0tw: calls $17.80
*** TURN *** [Kd Qh 2h] [3c]
d1puGuVBE0fidn+5eRJ0tw: checks
VvdR9F3I+2yELkfTVvC1dg: bets $42.05
d1puGuVBE0fidn+5eRJ0tw: calls $42.05
*** RIVER *** [Kd Qh 2h 3c] [8s]
d1puGuVBE0fidn+5eRJ0tw: checks
VvdR9F3I+2yELkfTVvC1dg: bets $245.55 and is all-in
d1puGuVBE0fidn+5eRJ0tw: folds
VvdR9F3I+2yELkfTVvC1dg collected $141.70 from pot
VvdR9F3I+2yELkfTVvC1dg: doesn't show hand
*** SUMMARY ***
Total pot $144.70 | Rake $3
Board [Kd Qh 2h 3c 8s]
Seat 1: VvdR9F3I+2yELkfTVvC1dg (button) collected ($141.70)
Seat 2: 6hRJ68JkbJq6MYI9o5bUnQ (small blind) folded before Flop
Seat 3: mddoKnqZkdOH7AJOJ/i0DA (big blind) folded on the Flop
Seat 4: 4dcDwIHRm96PwtqkpQiuiA folded before Flop (didn't bet)
Seat 5: d1puGuVBE0fidn+5eRJ0tw folded on the River
Seat 6: B2Ih1sr5VZk+8He7rcrMtQ folded before Flop (didn't bet)



PokerStars Game #59942072908:  Hold'em No Limit ($1/$2) - 2009/07/01 1:55:12 ET
Table 'xxAXogzmyuZKfe0LOYHaNQ' 2-max Seat #1 is the button
Seat 1: S14rjcU6LEC1LmuUtBK5Bg ($59 in chips)
Seat 2: ItDFe9gh5QYPQB9vC4ntUA ($231.70 in chips)
S14rjcU6LEC1LmuUtBK5Bg: posts small blind $1
ItDFe9gh5QYPQB9vC4ntUA: posts big blind $2
*** HOLE CARDS ***
S14rjcU6LEC1LmuUtBK5Bg: raises $4 to $6
ItDFe9gh5QYPQB9vC4ntUA: folds
S14rjcU6LEC1LmuUtBK5Bg collected $4 from pot
*** SUMMARY ***
Total pot $4 | Rake $0
Seat 1: S14rjcU6LEC1LmuUtBK5Bg (button) (small blind) collected ($4)
Seat 2: ItDFe9gh5QYPQB9vC4ntUA (big blind) folded before Flop



PokerStars Game #59942072976:  Hold'em No Limit ($1/$2) - 2009/07/01 1:55:13 ET
Table 'TsEDkiO4tzCTCzJ7tNdEqw' 6-max Seat #1 is the button
Seat 1: Nsjun4mjI8q0SSBTIp1dIQ ($200 in chips)
Seat 2: 4dcDwIHRm96PwtqkpQiuiA ($81.70 in chips)
Seat 3: ubtx4Z5L+AcK71MTvYiGVw ($253.20 in chips)
Seat 4: K8MXCrNAVYlMnnCeM32Kxw ($78.35 in chips)
Seat 5: VvdR9F3I+2yELkfTVvC1dg ($250.10 in chips)
Seat 6: uCqEjnxh2/vFBjKYkfTOkw ($277.10 in chips)
4dcDwIHRm96PwtqkpQiuiA: posts small blind $1
ubtx4Z5L+AcK71MTvYiGVw: posts big blind $2
*** HOLE CARDS ***
K8MXCrNAVYlMnnCeM32Kxw: calls $2
VvdR9F3I+2yELkfTVvC1dg: folds
uCqEjnxh2/vFBjKYkfTOkw: folds
Nsjun4mjI8q0SSBTIp1dIQ: folds
4dcDwIHRm96PwtqkpQiuiA: calls $1
ubtx4Z5L+AcK71MTvYiGVw: checks
*** FLOP *** [8d 9h Kh]
4dcDwIHRm96PwtqkpQiuiA: checks
ubtx4Z5L+AcK71MTvYiGVw: checks
K8MXCrNAVYlMnnCeM32Kxw: checks
*** TURN *** [8d 9h Kh] [6s]
4dcDwIHRm96PwtqkpQiuiA: checks
ubtx4Z5L+AcK71MTvYiGVw: checks
K8MXCrNAVYlMnnCeM32Kxw: checks
*** RIVER *** [8d 9h Kh 6s] [7h]
4dcDwIHRm96PwtqkpQiuiA: checks
ubtx4Z5L+AcK71MTvYiGVw: bets $10
K8MXCrNAVYlMnnCeM32Kxw: folds
4dcDwIHRm96PwtqkpQiuiA: folds
ubtx4Z5L+AcK71MTvYiGVw collected $5.70 from pot
ubtx4Z5L+AcK71MTvYiGVw: doesn't show hand
*** SUMMARY ***
Total pot $6 | Rake $0.30
Board [8d 9h Kh 6s 7h]
Seat 1: Nsjun4mjI8q0SSBTIp1dIQ (button) folded before Flop (didn't bet)
Seat 2: 4dcDwIHRm96PwtqkpQiuiA (small blind) folded on the River
Seat 3: ubtx4Z5L+AcK71MTvYiGVw (big blind) collected ($5.70)
Seat 4: K8MXCrNAVYlMnnCeM32Kxw folded on the River
Seat 5: VvdR9F3I+2yELkfTVvC1dg folded before Flop (didn't bet)
Seat 6: uCqEjnxh2/vFBjKYkfTOkw folded before Flop (didn't bet)



PokerStars Game #59942076350:  Hold'em No Limit ($1/$2) - 2009/07/01 1:55:19 ET
Table 'C4lkCXY2PWy6z4vsAe5NGQ' 6-max Seat #1 is the button
Seat 1: bWbV4MVB/vVpiES1Ut4hew ($197 in chips)
Seat 2: 6hRJ68JkbJq6MYI9o5bUnQ ($54.95 in chips)
Seat 3: sTPOWERd9HWPCNrDBwsVjA ($103.45 in chips)
Seat 4: VvdR9F3I+2yELkfTVvC1dg ($204 in chips)
Seat 5: /PH6Ffnho4Ysm8S3V/oa+w ($58.65 in chips)
Seat 6: B87ikIyZ/TzAVeXf38Ny0g ($767.50 in chips)
6hRJ68JkbJq6MYI9o5bUnQ: posts small blind $1
sTPOWERd9HWPCNrDBwsVjA: posts big blind $2
*** HOLE CARDS ***
VvdR9F3I+2yELkfTVvC1dg: folds
/PH6Ffnho4Ysm8S3V/oa+w: folds
B87ikIyZ/TzAVeXf38Ny0g: folds
bWbV4MVB/vVpiES1Ut4hew: raises $4 to $6
6hRJ68JkbJq6MYI9o5bUnQ: calls $5
sTPOWERd9HWPCNrDBwsVjA: raises $97.45 to $103.45 and is all-in
bWbV4MVB/vVpiES1Ut4hew: folds
6hRJ68JkbJq6MYI9o5bUnQ: calls $48.95 and is all-in
*** FLOP *** [Ah Th 2h]
*** TURN *** [Ah Th 2h] [7d]
*** RIVER *** [Ah Th 2h 7d] [Ad]
*** SHOW DOWN ***
6hRJ68JkbJq6MYI9o5bUnQ: shows [7s 7h] (a full house, Sevens full of Aces)
sTPOWERd9HWPCNrDBwsVjA: mucks hand
6hRJ68JkbJq6MYI9o5bUnQ collected $112.90 from pot
*** SUMMARY ***
Total pot $115.90 | Rake $3
Board [Ah Th 2h 7d Ad]
Seat 1: bWbV4MVB/vVpiES1Ut4hew (button) folded before Flop
Seat 2: 6hRJ68JkbJq6MYI9o5bUnQ (small blind) showed [7s 7h] and won ($112.90) with a full house, Sevens full of Aces
Seat 3: sTPOWERd9HWPCNrDBwsVjA (big blind) mucked
Seat 4: VvdR9F3I+2yELkfTVvC1dg folded before Flop (didn't bet)
Seat 5: /PH6Ffnho4Ysm8S3V/oa+w folded before Flop (didn't bet)
Seat 6: B87ikIyZ/TzAVeXf38Ny0g folded before Flop (didn't bet)



PokerStars Game #59942076312:  Hold'em No Limit ($1/$2) - 2009/07/01 1:55:19 ET
Table '+hSnXFQrGw1PlVgTnuj+sA' 6-max Seat #5 is the button
Seat 1: fb8ooqw9ZsZtBsZTZQLNrQ ($48.70 in chips)
Seat 2: 54yWzRRgS0oZ+S6LwZBxMQ ($38 in chips)
Seat 4: TRSUrOQh3x1NGeD+dH4yoA ($124.10 in chips)
Seat 5: PZzUwZiFNhCLi6Ouh5ZlmQ ($200 in chips)
Seat 6: 7zM38baFvmCNB/F80oE0cQ ($52.50 in chips)
7zM38baFvmCNB/F80oE0cQ: posts small blind $1
fb8ooqw9ZsZtBsZTZQLNrQ: posts big blind $2
vkfxu8f/jMYKUk6Ly4eujw: sits out
*** HOLE CARDS ***
54yWzRRgS0oZ+S6LwZBxMQ: folds
TRSUrOQh3x1NGeD+dH4yoA: calls $2
PZzUwZiFNhCLi6Ouh5ZlmQ: folds
7zM38baFvmCNB/F80oE0cQ: calls $1
fb8ooqw9ZsZtBsZTZQLNrQ: checks
*** FLOP *** [9c Jh Jc]
7zM38baFvmCNB/F80oE0cQ: bets $4
fb8ooqw9ZsZtBsZTZQLNrQ: folds
TRSUrOQh3x1NGeD+dH4yoA: calls $4
*** TURN *** [9c Jh Jc] [Ac]
7zM38baFvmCNB/F80oE0cQ: bets $6
TRSUrOQh3x1NGeD+dH4yoA: calls $6
*** RIVER *** [9c Jh Jc Ac] [3h]
7zM38baFvmCNB/F80oE0cQ: bets $10
TRSUrOQh3x1NGeD+dH4yoA: raises $10 to $20
7zM38baFvmCNB/F80oE0cQ: calls $10
*** SHOW DOWN ***
TRSUrOQh3x1NGeD+dH4yoA: shows [4c 7c] (a flush, Ace high)
7zM38baFvmCNB/F80oE0cQ: mucks hand
TRSUrOQh3x1NGeD+dH4yoA collected $64 from pot
*** SUMMARY ***
Total pot $66 | Rake $2
Board [9c Jh Jc Ac 3h]
Seat 1: fb8ooqw9ZsZtBsZTZQLNrQ (big blind) folded on the Flop
Seat 2: 54yWzRRgS0oZ+S6LwZBxMQ folded before Flop (didn't bet)
Seat 4: TRSUrOQh3x1NGeD+dH4yoA showed [4c 7c] and won ($64) with a flush, Ace high
Seat 5: PZzUwZiFNhCLi6Ouh5ZlmQ (button) folded before Flop (didn't bet)
Seat 6: 7zM38baFvmCNB/F80oE0cQ (small blind) mucked



PokerStars Game #59942076146:  Hold'em No Limit ($1/$2) - 2009/07/01 1:55:19 ET
Table 'W9UeSV0aoPjh5SFSxM8jUQ' 9-max Seat #4 is the button
Seat 1: mIKx5lhIt13X5eZQH0ZeMA ($6.85 in chips)
Seat 2: KqHysDSpCPaPyK3tJC1aEw ($207.05 in chips)
Seat 3: ItDFe9gh5QYPQB9vC4ntUA ($203 in chips)
Seat 4: 4YA/sQy1Emm680zhbPUjow ($149.60 in chips)
Seat 6: 254YPxPJr5Sw58bkD0YqYQ ($214.70 in chips)
Seat 7: TAfo4veNRaRlzDXMMYS3Jg ($39 in chips)
Seat 8: odhvI/CZeMsPyo1n1U7+hA ($49.10 in chips)
Seat 9: Q104K4iDGcqOlVrjAkzPEA ($96.55 in chips)
ZYHoLw2lWmRS7CSHi8L8Xg will be allowed to play after the button
254YPxPJr5Sw58bkD0YqYQ: posts small blind $1
TAfo4veNRaRlzDXMMYS3Jg: posts big blind $2
*** HOLE CARDS ***
odhvI/CZeMsPyo1n1U7+hA: folds
Q104K4iDGcqOlVrjAkzPEA: calls $2
mIKx5lhIt13X5eZQH0ZeMA: folds
KqHysDSpCPaPyK3tJC1aEw: folds
ItDFe9gh5QYPQB9vC4ntUA: folds
4YA/sQy1Emm680zhbPUjow: folds
254YPxPJr5Sw58bkD0YqYQ: folds
TAfo4veNRaRlzDXMMYS3Jg: checks
*** FLOP *** [Th Kc Js]
TAfo4veNRaRlzDXMMYS3Jg: checks
Q104K4iDGcqOlVrjAkzPEA: bets $4
TAfo4veNRaRlzDXMMYS3Jg: folds
Q104K4iDGcqOlVrjAkzPEA collected $4.75 from pot
*** SUMMARY ***
Total pot $5 | Rake $0.25
Board [Th Kc Js]
Seat 1: mIKx5lhIt13X5eZQH0ZeMA folded before Flop (didn't bet)
Seat 2: KqHysDSpCPaPyK3tJC1aEw folded before Flop (didn't bet)
Seat 3: ItDFe9gh5QYPQB9vC4ntUA folded before Flop (didn't bet)
Seat 4: 4YA/sQy1Emm680zhbPUjow (button) folded before Flop (didn't bet)
Seat 6: 254YPxPJr5Sw58bkD0YqYQ (small blind) folded before Flop
Seat 7: TAfo4veNRaRlzDXMMYS3Jg (big blind) folded on the Flop
Seat 8: odhvI/CZeMsPyo1n1U7+hA folded before Flop (didn't bet)
Seat 9: Q104K4iDGcqOlVrjAkzPEA collected ($4.75)



PokerStars Game #59942076722:  Hold'em No Limit ($1/$2) - 2009/07/01 1:55:20 ET
Table 'ztv6V3FN2bQ9nmJPPdx6nQ' 6-max Seat #3 is the button
Seat 1: 6fLdOUCRtX71xbVRhJEq8w ($365.35 in chips)
Seat 2: 5Y+ZGWLI4gnlpApDX5vy1A ($290.05 in chips)
Seat 3: XP9UmPc7hfMVafyEiwJMAA ($197 in chips)
Seat 4: UaZ5yj+6LjtWqMQg2QskUw ($103.40 in chips)
Seat 5: sTPOWERd9HWPCNrDBwsVjA ($211.60 in chips)
Seat 6: mfy7uGZcqA2PVQqEVbJ7+g ($185 in chips)
UaZ5yj+6LjtWqMQg2QskUw: posts small blind $1
sTPOWERd9HWPCNrDBwsVjA: posts big blind $2
*** HOLE CARDS ***
mfy7uGZcqA2PVQqEVbJ7+g: folds
6fLdOUCRtX71xbVRhJEq8w: folds
5Y+ZGWLI4gnlpApDX5vy1A: raises $4 to $6
XP9UmPc7hfMVafyEiwJMAA: folds
UaZ5yj+6LjtWqMQg2QskUw: folds
sTPOWERd9HWPCNrDBwsVjA: folds
5Y+ZGWLI4gnlpApDX5vy1A collected $5 from pot
5Y+ZGWLI4gnlpApDX5vy1A: doesn't show hand
*** SUMMARY ***
Total pot $5 | Rake $0
Seat 1: 6fLdOUCRtX71xbVRhJEq8w folded before Flop (didn't bet)
Seat 2: 5Y+ZGWLI4gnlpApDX5vy1A collected ($5)
Seat 3: XP9UmPc7hfMVafyEiwJMAA (button) folded before Flop (didn't bet)
Seat 4: UaZ5yj+6LjtWqMQg2QskUw (small blind) folded before Flop
Seat 5: sTPOWERd9HWPCNrDBwsVjA (big blind) folded before Flop
Seat 6: mfy7uGZcqA2PVQqEVbJ7+g folded before Flop (didn't bet)



PokerStars Game #59942077972:  Hold'em No Limit ($1/$2) - 2009/07/01 1:55:22 ET
Table 'LL4bDFyhj5hsMpzaDugJZg' 6-max Seat #1 is the button
Seat 1: ubtx4Z5L+AcK71MTvYiGVw ($200 in chips)
Seat 2: TMPDCBmlFGM9C+H58PC4sQ ($41.35 in chips)
Seat 3: opJMdoq0E6TRbAQiweyQuA ($40 in chips)
Seat 4: 8srN1dKQePlsv0GyTada+Q ($387.85 in chips)
Seat 5: on4ebXPJvUBOcHOBMQsRSg ($77.35 in chips)
Seat 6: mddoKnqZkdOH7AJOJ/i0DA ($209.30 in chips)
TMPDCBmlFGM9C+H58PC4sQ: posts small blind $1
opJMdoq0E6TRbAQiweyQuA: posts big blind $2
*** HOLE CARDS ***
8srN1dKQePlsv0GyTada+Q: folds
on4ebXPJvUBOcHOBMQsRSg: folds
mddoKnqZkdOH7AJOJ/i0DA: folds
ubtx4Z5L+AcK71MTvYiGVw: folds
TMPDCBmlFGM9C+H58PC4sQ: calls $1
opJMdoq0E6TRbAQiweyQuA: checks
*** FLOP *** [Qd 2d Ts]
TMPDCBmlFGM9C+H58PC4sQ: checks
opJMdoq0E6TRbAQiweyQuA: checks
*** TURN *** [Qd 2d Ts] [6s]
TMPDCBmlFGM9C+H58PC4sQ: bets $2
opJMdoq0E6TRbAQiweyQuA: folds
TMPDCBmlFGM9C+H58PC4sQ collected $3.80 from pot
*** SUMMARY ***
Total pot $4 | Rake $0.20
Board [Qd 2d Ts 6s]
Seat 1: ubtx4Z5L+AcK71MTvYiGVw (button) folded before Flop (didn't bet)
Seat 2: TMPDCBmlFGM9C+H58PC4sQ (small blind) collected ($3.80)
Seat 3: opJMdoq0E6TRbAQiweyQuA (big blind) folded on the Turn
Seat 4: 8srN1dKQePlsv0GyTada+Q folded before Flop (didn't bet)
Seat 5: on4ebXPJvUBOcHOBMQsRSg folded before Flop (didn't bet)
Seat 6: mddoKnqZkdOH7AJOJ/i0DA folded before Flop (didn't bet)



PokerStars Game #59942078430:  Hold'em No Limit ($1/$2) - 2009/07/01 1:55:23 ET
Table 'uJ9juaXXg9yIcSU8amxaXQ' 6-max Seat #3 is the button
Seat 1: JsqOjN/eHz0uYVf/PyUJ6Q ($132.45 in chips)
Seat 2: VvdR9F3I+2yELkfTVvC1dg ($217.45 in chips)
Seat 3: qXDd0ZyMIse0OBu8pxeQ3Q ($239.40 in chips)
Seat 4: zNjJ/y4emmF+vzrCDd+ooA ($268.30 in chips)
Seat 5: YsLQ3BAvgQHWXMAv3Wv6Hg ($200 in chips)
Seat 6: /PH6Ffnho4Ysm8S3V/oa+w ($40 in chips)
zNjJ/y4emmF+vzrCDd+ooA: posts small blind $1
YsLQ3BAvgQHWXMAv3Wv6Hg: posts big blind $2
*** HOLE CARDS ***
/PH6Ffnho4Ysm8S3V/oa+w: folds
JsqOjN/eHz0uYVf/PyUJ6Q: calls $2
VvdR9F3I+2yELkfTVvC1dg: folds
qXDd0ZyMIse0OBu8pxeQ3Q: folds
zNjJ/y4emmF+vzrCDd+ooA: calls $1
YsLQ3BAvgQHWXMAv3Wv6Hg: checks
*** FLOP *** [8d 8h 4h]
zNjJ/y4emmF+vzrCDd+ooA: checks
YsLQ3BAvgQHWXMAv3Wv6Hg: checks
JsqOjN/eHz0uYVf/PyUJ6Q: checks
*** TURN *** [8d 8h 4h] [4s]
zNjJ/y4emmF+vzrCDd+ooA: checks
YsLQ3BAvgQHWXMAv3Wv6Hg: checks
JsqOjN/eHz0uYVf/PyUJ6Q: bets $4
zNjJ/y4emmF+vzrCDd+ooA: folds
YsLQ3BAvgQHWXMAv3Wv6Hg: folds
JsqOjN/eHz0uYVf/PyUJ6Q collected $5.70 from pot
JsqOjN/eHz0uYVf/PyUJ6Q: doesn't show hand
*** SUMMARY ***
Total pot $6 | Rake $0.30
Board [8d 8h 4h 4s]
Seat 1: JsqOjN/eHz0uYVf/PyUJ6Q collected ($5.70)
Seat 2: VvdR9F3I+2yELkfTVvC1dg folded before Flop (didn't bet)
Seat 3: qXDd0ZyMIse0OBu8pxeQ3Q (button) folded before Flop (didn't bet)
Seat 4: zNjJ/y4emmF+vzrCDd+ooA (small blind) folded on the Turn
Seat 5: YsLQ3BAvgQHWXMAv3Wv6Hg (big blind) folded on the Turn
Seat 6: /PH6Ffnho4Ysm8S3V/oa+w folded before Flop (didn't bet)



PokerStars Game #59942078436:  Hold'em No Limit ($1/$2) - 2009/07/01 1:55:23 ET
Table 'NmY84NAf9Mh0ckAckHnh5g' 2-max Seat #2 is the button
Seat 1: 6hvg964TSqZ3AL/0XK9aVQ ($356.70 in chips)
Seat 2: RwDoM55ZeQuI2ADyJhOb2Q ($621.80 in chips)
RwDoM55ZeQuI2ADyJhOb2Q: posts small blind $1
6hvg964TSqZ3AL/0XK9aVQ: posts big blind $2
*** HOLE CARDS ***
RwDoM55ZeQuI2ADyJhOb2Q: raises $4 to $6
6hvg964TSqZ3AL/0XK9aVQ: calls $4
*** FLOP *** [4s 9d Ks]
6hvg964TSqZ3AL/0XK9aVQ: checks
RwDoM55ZeQuI2ADyJhOb2Q: bets $8
6hvg964TSqZ3AL/0XK9aVQ: calls $8
*** TURN *** [4s 9d Ks] [Tc]
6hvg964TSqZ3AL/0XK9aVQ: checks
RwDoM55ZeQuI2ADyJhOb2Q: bets $22
6hvg964TSqZ3AL/0XK9aVQ: calls $22
*** RIVER *** [4s 9d Ks Tc] [Qc]
6hvg964TSqZ3AL/0XK9aVQ: checks
RwDoM55ZeQuI2ADyJhOb2Q: checks
*** SHOW DOWN ***
6hvg964TSqZ3AL/0XK9aVQ: shows [8h 4h] (a pair of Fours)
RwDoM55ZeQuI2ADyJhOb2Q: mucks hand
6hvg964TSqZ3AL/0XK9aVQ collected $71.50 from pot
*** SUMMARY ***
Total pot $72 | Rake $0.50
Board [4s 9d Ks Tc Qc]
Seat 1: 6hvg964TSqZ3AL/0XK9aVQ (big blind) showed [8h 4h] and won ($71.50) with a pair of Fours
Seat 2: RwDoM55ZeQuI2ADyJhOb2Q (button) (small blind) mucked



PokerStars Game #59942078704:  Hold'em No Limit ($1/$2) - 2009/07/01 1:55:24 ET
Table '4NGNnZ/osQfNq6abYqkJeA' 6-max Seat #6 is the button
Seat 1: 0Bc+WhbOvaaWIMmmui3q0g ($147.10 in chips)
Seat 2: 669iGNwYwgRZg3nhS+aDAQ ($107.75 in chips)
Seat 3: 54yWzRRgS0oZ+S6LwZBxMQ ($71.35 in chips)
Seat 4: sY+4Uuh5z/6AbXXaCS10jw ($297.10 in chips)
Seat 5: VvdR9F3I+2yELkfTVvC1dg ($208.80 in chips)
Seat 6: /PH6Ffnho4Ysm8S3V/oa+w ($47.20 in chips)
0Bc+WhbOvaaWIMmmui3q0g: posts small blind $1
669iGNwYwgRZg3nhS+aDAQ: posts big blind $2
*** HOLE CARDS ***
54yWzRRgS0oZ+S6LwZBxMQ: folds
sY+4Uuh5z/6AbXXaCS10jw: folds
VvdR9F3I+2yELkfTVvC1dg: raises $2 to $4
/PH6Ffnho4Ysm8S3V/oa+w: raises $10 to $14
0Bc+WhbOvaaWIMmmui3q0g: folds
669iGNwYwgRZg3nhS+aDAQ: folds
VvdR9F3I+2yELkfTVvC1dg: folds
/PH6Ffnho4Ysm8S3V/oa+w collected $11 from pot
/PH6Ffnho4Ysm8S3V/oa+w: doesn't show hand
*** SUMMARY ***
Total pot $11 | Rake $0
Seat 1: 0Bc+WhbOvaaWIMmmui3q0g (small blind) folded before Flop
Seat 2: 669iGNwYwgRZg3nhS+aDAQ (big blind) folded before Flop
Seat 3: 54yWzRRgS0oZ+S6LwZBxMQ folded before Flop (didn't bet)
Seat 4: sY+4Uuh5z/6AbXXaCS10jw folded before Flop (didn't bet)
Seat 5: VvdR9F3I+2yELkfTVvC1dg folded before Flop
Seat 6: /PH6Ffnho4Ysm8S3V/oa+w (button) collected ($11)



PokerStars Game #59942079196:  Hold'em No Limit ($1/$2) - 2009/07/01 1:55:24 ET
Table 'aSf77Sj8QEnzcc0WaxVD4Q' 6-max Seat #4 is the button
Seat 1: UELtvp+JfwI7XDGVwSxZXA ($166.85 in chips)
Seat 2: vkfxu8f/jMYKUk6Ly4eujw ($204 in chips)
Seat 4: YsLQ3BAvgQHWXMAv3Wv6Hg ($200 in chips)
Seat 5: VvdR9F3I+2yELkfTVvC1dg ($287.15 in chips)
Seat 6: vkoJRf3gidxY1pPi0AFWww ($195.85 in chips)
VvdR9F3I+2yELkfTVvC1dg: posts small blind $1
vkoJRf3gidxY1pPi0AFWww: posts big blind $2
3cPMpDMgeOMAe4UceUfLsg: sits out
*** HOLE CARDS ***
UELtvp+JfwI7XDGVwSxZXA: folds
vkfxu8f/jMYKUk6Ly4eujw: folds
YsLQ3BAvgQHWXMAv3Wv6Hg: folds
VvdR9F3I+2yELkfTVvC1dg: folds
vkoJRf3gidxY1pPi0AFWww collected $2 from pot
vkoJRf3gidxY1pPi0AFWww: doesn't show hand
*** SUMMARY ***
Total pot $2 | Rake $0
Seat 1: UELtvp+JfwI7XDGVwSxZXA folded before Flop (didn't bet)
Seat 2: vkfxu8f/jMYKUk6Ly4eujw folded before Flop (didn't bet)
Seat 4: YsLQ3BAvgQHWXMAv3Wv6Hg (button) folded before Flop (didn't bet)
Seat 5: VvdR9F3I+2yELkfTVvC1dg (small blind) folded before Flop
Seat 6: vkoJRf3gidxY1pPi0AFWww (big blind) collected ($2)



PokerStars Game #59942079340:  Hold'em No Limit ($1/$2) - 2009/07/01 1:55:25 ET
Table '/dyk+YdRGv90j2box35j8w' 6-max Seat #3 is the button
Seat 2: qCnEYuAE5y5A7bk6fO5/jQ ($491.20 in chips)
Seat 3: sTPOWERd9HWPCNrDBwsVjA ($209.50 in chips)
Seat 4: 4dMBh/1VTdeUTPCyhCs3UQ ($86.25 in chips)
Seat 5: VvdR9F3I+2yELkfTVvC1dg ($299.35 in chips)
Seat 6: C3qJBo7uxfFVDluE1lmK2w ($92.25 in chips)
4dMBh/1VTdeUTPCyhCs3UQ: posts small blind $1
VvdR9F3I+2yELkfTVvC1dg: posts big blind $2
*** HOLE CARDS ***
C3qJBo7uxfFVDluE1lmK2w: folds
qCnEYuAE5y5A7bk6fO5/jQ: folds
sTPOWERd9HWPCNrDBwsVjA: raises $4 to $6
4dMBh/1VTdeUTPCyhCs3UQ: folds
VvdR9F3I+2yELkfTVvC1dg: folds
sTPOWERd9HWPCNrDBwsVjA collected $5 from pot
*** SUMMARY ***
Total pot $5 | Rake $0
Seat 2: qCnEYuAE5y5A7bk6fO5/jQ folded before Flop (didn't bet)
Seat 3: sTPOWERd9HWPCNrDBwsVjA (button) collected ($5)
Seat 4: 4dMBh/1VTdeUTPCyhCs3UQ (small blind) folded before Flop
Seat 5: VvdR9F3I+2yELkfTVvC1dg (big blind) folded before Flop
Seat 6: C3qJBo7uxfFVDluE1lmK2w folded before Flop (didn't bet)



PokerStars Game #59942079776:  Hold'em No Limit ($1/$2) - 2009/07/01 1:55:26 ET
Table 'xxAXogzmyuZKfe0LOYHaNQ' 2-max Seat #2 is the button
Seat 1: S14rjcU6LEC1LmuUtBK5Bg ($61 in chips)
Seat 2: ItDFe9gh5QYPQB9vC4ntUA ($229.70 in chips)
ItDFe9gh5QYPQB9vC4ntUA: posts small blind $1
S14rjcU6LEC1LmuUtBK5Bg: posts big blind $2
*** HOLE CARDS ***
ItDFe9gh5QYPQB9vC4ntUA: raises $2 to $4
S14rjcU6LEC1LmuUtBK5Bg: calls $2
*** FLOP *** [8s 2s 9s]
S14rjcU6LEC1LmuUtBK5Bg: checks
ItDFe9gh5QYPQB9vC4ntUA: checks
*** TURN *** [8s 2s 9s] [7c]
S14rjcU6LEC1LmuUtBK5Bg: bets $8
ItDFe9gh5QYPQB9vC4ntUA: calls $8
*** RIVER *** [8s 2s 9s 7c] [Jc]
S14rjcU6LEC1LmuUtBK5Bg: bets $18
ItDFe9gh5QYPQB9vC4ntUA: raises $199.70 to $217.70 and is all-in
S14rjcU6LEC1LmuUtBK5Bg: calls $31 and is all-in
*** SHOW DOWN ***
ItDFe9gh5QYPQB9vC4ntUA: shows [Th 4d] (a straight, Seven to Jack)
S14rjcU6LEC1LmuUtBK5Bg: shows [5s 7s] (a flush, Nine high)
S14rjcU6LEC1LmuUtBK5Bg collected $121.50 from pot
*** SUMMARY ***
Total pot $122 | Rake $0.50
Board [8s 2s 9s 7c Jc]
Seat 1: S14rjcU6LEC1LmuUtBK5Bg (big blind) showed [5s 7s] and won ($121.50) with a flush, Nine high
Seat 2: ItDFe9gh5QYPQB9vC4ntUA (button) (small blind) showed [Th 4d] and lost with a straight, Seven to Jack



PokerStars Game #59942081126:  Hold'em No Limit ($1/$2) - 2009/07/01 1:55:28 ET
Table '5/wEe6JmtGD7vufSA2RG7A' 2-max Seat #1 is the button
Seat 1: pVqEzK9wXlRMECnb1Zg4Zw ($201 in chips)
Seat 2: aOL8geThaYp2iadSHl1h1g ($452 in chips)
pVqEzK9wXlRMECnb1Zg4Zw: posts small blind $1
aOL8geThaYp2iadSHl1h1g: posts big blind $2
*** HOLE CARDS ***
pVqEzK9wXlRMECnb1Zg4Zw: calls $1
aOL8geThaYp2iadSHl1h1g: checks
*** FLOP *** [Kc 7c 4h]
aOL8geThaYp2iadSHl1h1g: checks
pVqEzK9wXlRMECnb1Zg4Zw: bets $12
aOL8geThaYp2iadSHl1h1g: folds
pVqEzK9wXlRMECnb1Zg4Zw collected $3.80 from pot
pVqEzK9wXlRMECnb1Zg4Zw: doesn't show hand
*** SUMMARY ***
Total pot $4 | Rake $0.20
Board [Kc 7c 4h]
Seat 1: pVqEzK9wXlRMECnb1Zg4Zw (button) (small blind) collected ($3.80)
Seat 2: aOL8geThaYp2iadSHl1h1g (big blind) folded on the Flop



PokerStars Game #59942081202:  Hold'em No Limit ($1/$2) - 2009/07/01 1:55:28 ET
Table 'QxerF7GUfCbl+4a8XaTB2w' 6-max Seat #4 is the button
Seat 1: ZwvXzkkZ3XpMhKfAmVpahw ($285.25 in chips)
Seat 2: 6UGgYbxwWNc+ohObe8vB9w ($80 in chips)
Seat 3: 8rZGabKe2DEPdZCbCivZ9Q ($22.80 in chips)
Seat 4: /PH6Ffnho4Ysm8S3V/oa+w ($50 in chips)
Seat 5: vkfxu8f/jMYKUk6Ly4eujw ($150.05 in chips)
Seat 6: VvdR9F3I+2yELkfTVvC1dg ($221.10 in chips)
vkfxu8f/jMYKUk6Ly4eujw: posts small blind $1
VvdR9F3I+2yELkfTVvC1dg: posts big blind $2
*** HOLE CARDS ***
ZwvXzkkZ3XpMhKfAmVpahw: folds
6UGgYbxwWNc+ohObe8vB9w: calls $2
8rZGabKe2DEPdZCbCivZ9Q: folds
/PH6Ffnho4Ysm8S3V/oa+w: folds
vkfxu8f/jMYKUk6Ly4eujw: folds
VvdR9F3I+2yELkfTVvC1dg: checks
*** FLOP *** [8s 4s 3c]
VvdR9F3I+2yELkfTVvC1dg: checks
6UGgYbxwWNc+ohObe8vB9w: bets $4
VvdR9F3I+2yELkfTVvC1dg: folds
6UGgYbxwWNc+ohObe8vB9w collected $4.75 from pot
*** SUMMARY ***
Total pot $5 | Rake $0.25
Board [8s 4s 3c]
Seat 1: ZwvXzkkZ3XpMhKfAmVpahw folded before Flop (didn't bet)
Seat 2: 6UGgYbxwWNc+ohObe8vB9w collected ($4.75)
Seat 3: 8rZGabKe2DEPdZCbCivZ9Q folded before Flop (didn't bet)
Seat 4: /PH6Ffnho4Ysm8S3V/oa+w (button) folded before Flop (didn't bet)
Seat 5: vkfxu8f/jMYKUk6Ly4eujw (small blind) folded before Flop
Seat 6: VvdR9F3I+2yELkfTVvC1dg (big blind) folded on the Flop



PokerStars Game #59942080832:  Hold'em No Limit ($1/$2) - 2009/07/01 1:55:28 ET
Table 'G1Oqdy4Pqdb5gtx40rUBzA' 6-max Seat #2 is the button
Seat 1: 4dMBh/1VTdeUTPCyhCs3UQ ($45.05 in chips)
Seat 2: m7mYVfnCOK5TE/VkN/FhOg ($233.75 in chips)
Seat 3: VvdR9F3I+2yELkfTVvC1dg ($417.90 in chips)
Seat 4: B87ikIyZ/TzAVeXf38Ny0g ($200 in chips)
Seat 5: F1+Ml47qRQWunzPnGhLLzQ ($221.55 in chips)
Seat 6: qCnEYuAE5y5A7bk6fO5/jQ ($200 in chips)
VvdR9F3I+2yELkfTVvC1dg: posts small blind $1
B87ikIyZ/TzAVeXf38Ny0g: posts big blind $2
*** HOLE CARDS ***
F1+Ml47qRQWunzPnGhLLzQ: calls $2
qCnEYuAE5y5A7bk6fO5/jQ: folds
4dMBh/1VTdeUTPCyhCs3UQ: folds
m7mYVfnCOK5TE/VkN/FhOg: calls $2
VvdR9F3I+2yELkfTVvC1dg: calls $1
B87ikIyZ/TzAVeXf38Ny0g: checks
*** FLOP *** [Kd Tc Ad]
VvdR9F3I+2yELkfTVvC1dg: checks
B87ikIyZ/TzAVeXf38Ny0g: checks
F1+Ml47qRQWunzPnGhLLzQ: bets $4
m7mYVfnCOK5TE/VkN/FhOg: folds
VvdR9F3I+2yELkfTVvC1dg: folds
B87ikIyZ/TzAVeXf38Ny0g: folds
F1+Ml47qRQWunzPnGhLLzQ collected $7.60 from pot
F1+Ml47qRQWunzPnGhLLzQ: doesn't show hand
*** SUMMARY ***
Total pot $8 | Rake $0.40
Board [Kd Tc Ad]
Seat 1: 4dMBh/1VTdeUTPCyhCs3UQ folded before Flop (didn't bet)
Seat 2: m7mYVfnCOK5TE/VkN/FhOg (button) folded on the Flop
Seat 3: VvdR9F3I+2yELkfTVvC1dg (small blind) folded on the Flop
Seat 4: B87ikIyZ/TzAVeXf38Ny0g (big blind) folded on the Flop
Seat 5: F1+Ml47qRQWunzPnGhLLzQ collected ($7.60)
Seat 6: qCnEYuAE5y5A7bk6fO5/jQ folded before Flop (didn't bet)



PokerStars Game #59942081510:  Hold'em No Limit ($1/$2) - 2009/07/01 1:55:29 ET
Table 'UGLAZZyv+cXmnKjYin0etA' 6-max Seat #2 is the button
Seat 1: rL+Zpv4/vX2BVHcyfh/NXA ($200 in chips)
Seat 2: eDLH1PUXFpvJBNMXBVQcGA ($297.10 in chips)
Seat 3: Nsjun4mjI8q0SSBTIp1dIQ ($230 in chips)
Seat 4: SiGJDsvRViJX05vHhA80GQ ($249.75 in chips)
Seat 5: 54yWzRRgS0oZ+S6LwZBxMQ ($34.80 in chips)
Seat 6: sTPOWERd9HWPCNrDBwsVjA ($179.95 in chips)
Nsjun4mjI8q0SSBTIp1dIQ: posts small blind $1
SiGJDsvRViJX05vHhA80GQ: posts big blind $2
*** HOLE CARDS ***
54yWzRRgS0oZ+S6LwZBxMQ: folds
sTPOWERd9HWPCNrDBwsVjA: folds
rL+Zpv4/vX2BVHcyfh/NXA: raises $4 to $6
eDLH1PUXFpvJBNMXBVQcGA: calls $6
Nsjun4mjI8q0SSBTIp1dIQ: folds
SiGJDsvRViJX05vHhA80GQ: folds
*** FLOP *** [Qd 4c 3h]
rL+Zpv4/vX2BVHcyfh/NXA: bets $10
eDLH1PUXFpvJBNMXBVQcGA: folds
rL+Zpv4/vX2BVHcyfh/NXA collected $14.25 from pot
*** SUMMARY ***
Total pot $15 | Rake $0.75
Board [Qd 4c 3h]
Seat 1: rL+Zpv4/vX2BVHcyfh/NXA collected ($14.25)
Seat 2: eDLH1PUXFpvJBNMXBVQcGA (button) folded on the Flop
Seat 3: Nsjun4mjI8q0SSBTIp1dIQ (small blind) folded before Flop
Seat 4: SiGJDsvRViJX05vHhA80GQ (big blind) folded before Flop
Seat 5: 54yWzRRgS0oZ+S6LwZBxMQ folded before Flop (didn't bet)
Seat 6: sTPOWERd9HWPCNrDBwsVjA folded before Flop (didn't bet)



PokerStars Game #59942081764:  Hold'em No Limit ($1/$2) - 2009/07/01 1:55:29 ET
Table 'WCA60bDA8ecovUgFSIZkTQ' 9-max Seat #7 is the button
Seat 1: 3RFwE6igZ1BGKOGuab6iiw ($73 in chips)
Seat 2: TAfo4veNRaRlzDXMMYS3Jg ($37 in chips)
Seat 3: g7gL2NLJCdZPPV399WKT1w ($54.95 in chips)
Seat 4: IYBKVnE2Basnr88BAhH+bQ ($202.80 in chips)
Seat 5: A+9gcmwAl0eFxxbAwRY1OA ($246.10 in chips)
Seat 6: YoKKKdDDs7gFzP1Z65Sdaw ($96 in chips)
Seat 7: tsTv4D+ne2W0qhUt9HlcMw ($193.80 in chips)
Seat 8: mJhwEVg7F695DiO+RIhM5g ($255.45 in chips)
Seat 9: ItDFe9gh5QYPQB9vC4ntUA ($200 in chips)
mJhwEVg7F695DiO+RIhM5g: posts small blind $1
ItDFe9gh5QYPQB9vC4ntUA: posts big blind $2
*** HOLE CARDS ***
3RFwE6igZ1BGKOGuab6iiw: folds
TAfo4veNRaRlzDXMMYS3Jg: folds
g7gL2NLJCdZPPV399WKT1w: folds
IYBKVnE2Basnr88BAhH+bQ: folds
A+9gcmwAl0eFxxbAwRY1OA: folds
YoKKKdDDs7gFzP1Z65Sdaw: folds
tsTv4D+ne2W0qhUt9HlcMw: raises $3 to $5
mJhwEVg7F695DiO+RIhM5g: calls $4
ItDFe9gh5QYPQB9vC4ntUA: folds
*** FLOP *** [4d 9c 7h]
mJhwEVg7F695DiO+RIhM5g: checks
tsTv4D+ne2W0qhUt9HlcMw: bets $6
mJhwEVg7F695DiO+RIhM5g: calls $6
*** TURN *** [4d 9c 7h] [Ks]
mJhwEVg7F695DiO+RIhM5g: checks
tsTv4D+ne2W0qhUt9HlcMw: bets $14
mJhwEVg7F695DiO+RIhM5g: folds
tsTv4D+ne2W0qhUt9HlcMw collected $22.85 from pot
*** SUMMARY ***
Total pot $24 | Rake $1.15
Board [4d 9c 7h Ks]
Seat 1: 3RFwE6igZ1BGKOGuab6iiw folded before Flop (didn't bet)
Seat 2: TAfo4veNRaRlzDXMMYS3Jg folded before Flop (didn't bet)
Seat 3: g7gL2NLJCdZPPV399WKT1w folded before Flop (didn't bet)
Seat 4: IYBKVnE2Basnr88BAhH+bQ folded before Flop (didn't bet)
Seat 5: A+9gcmwAl0eFxxbAwRY1OA folded before Flop (didn't bet)
Seat 6: YoKKKdDDs7gFzP1Z65Sdaw folded before Flop (didn't bet)
Seat 7: tsTv4D+ne2W0qhUt9HlcMw (button) collected ($22.85)
Seat 8: mJhwEVg7F695DiO+RIhM5g (small blind) folded on the Turn
Seat 9: ItDFe9gh5QYPQB9vC4ntUA (big blind) folded before Flop



PokerStars Game #59942081708:  Hold'em No Limit ($1/$2) - 2009/07/01 1:55:29 ET
Table 'P/yCfYl1GfGsu/e6DxDy/A' 2-max Seat #1 is the button
Seat 1: 7fOCUy3x9hdkmXkkDNolGQ ($1112.50 in chips)
Seat 2: RwDoM55ZeQuI2ADyJhOb2Q ($355 in chips)
7fOCUy3x9hdkmXkkDNolGQ: posts small blind $1
RwDoM55ZeQuI2ADyJhOb2Q: posts big blind $2
*** HOLE CARDS ***
7fOCUy3x9hdkmXkkDNolGQ: folds
RwDoM55ZeQuI2ADyJhOb2Q collected $2 from pot
RwDoM55ZeQuI2ADyJhOb2Q: doesn't show hand
*** SUMMARY ***
Total pot $2 | Rake $0
Seat 1: 7fOCUy3x9hdkmXkkDNolGQ (button) (small blind) folded before Flop
Seat 2: RwDoM55ZeQuI2ADyJhOb2Q (big blind) collected ($2)



PokerStars Game #59942081556:  Hold'em No Limit ($1/$2) - 2009/07/01 1:55:29 ET
Table '3WCXyaiCAbqSShQu7FIjvA' 9-max Seat #8 is the button
Seat 1: kTCkABD1UUldS9DFRGfCwQ ($137.75 in chips)
Seat 3: 5Q8U6iZbeO7xJSS4qvDP5g ($247.25 in chips)
Seat 4: waEF/+pxZTxNo4FvsORuXg ($101.40 in chips)
Seat 5: CkE3IyJF1KvdaAOmZY5XqQ ($207.90 in chips)
Seat 6: 5jQlngvMSqM/WoonOcR5kw ($277.50 in chips)
Seat 8: +T/63sAeZzWyHchahJ36GQ ($34 in chips)
Seat 9: FiXPLJyqb24l32QST2TInw ($136.20 in chips)
FiXPLJyqb24l32QST2TInw: posts small blind $1
kTCkABD1UUldS9DFRGfCwQ: posts big blind $2
254YPxPJr5Sw58bkD0YqYQ: sits out
*** HOLE CARDS ***
5Q8U6iZbeO7xJSS4qvDP5g: folds
waEF/+pxZTxNo4FvsORuXg: folds
CkE3IyJF1KvdaAOmZY5XqQ: folds
5jQlngvMSqM/WoonOcR5kw: folds
+T/63sAeZzWyHchahJ36GQ: folds
FiXPLJyqb24l32QST2TInw: calls $1
kTCkABD1UUldS9DFRGfCwQ: checks
*** FLOP *** [Ks 9s 7h]
FiXPLJyqb24l32QST2TInw: bets $2
kTCkABD1UUldS9DFRGfCwQ: folds
FiXPLJyqb24l32QST2TInw collected $3.80 from pot
FiXPLJyqb24l32QST2TInw: doesn't show hand
*** SUMMARY ***
Total pot $4 | Rake $0.20
Board [Ks 9s 7h]
Seat 1: kTCkABD1UUldS9DFRGfCwQ (big blind) folded on the Flop
Seat 3: 5Q8U6iZbeO7xJSS4qvDP5g folded before Flop (didn't bet)
Seat 4: waEF/+pxZTxNo4FvsORuXg folded before Flop (didn't bet)
Seat 5: CkE3IyJF1KvdaAOmZY5XqQ folded before Flop (didn't bet)
Seat 6: 5jQlngvMSqM/WoonOcR5kw folded before Flop (didn't bet)
Seat 8: +T/63sAeZzWyHchahJ36GQ (button) folded before Flop (didn't bet)
Seat 9: FiXPLJyqb24l32QST2TInw (small blind) collected ($3.80)



PokerStars Game #59942084778:  Hold'em No Limit ($1/$2) - 2009/07/01 1:55:35 ET
Table 'P/yCfYl1GfGsu/e6DxDy/A' 2-max Seat #2 is the button
Seat 1: 7fOCUy3x9hdkmXkkDNolGQ ($1111.50 in chips)
Seat 2: RwDoM55ZeQuI2ADyJhOb2Q ($356 in chips)
RwDoM55ZeQuI2ADyJhOb2Q: posts small blind $1
7fOCUy3x9hdkmXkkDNolGQ: posts big blind $2
*** HOLE CARDS ***
RwDoM55ZeQuI2ADyJhOb2Q: raises $4 to $6
7fOCUy3x9hdkmXkkDNolGQ: calls $4
*** FLOP *** [4h 3d 2h]
7fOCUy3x9hdkmXkkDNolGQ: checks
RwDoM55ZeQuI2ADyJhOb2Q: bets $6
7fOCUy3x9hdkmXkkDNolGQ: folds
RwDoM55ZeQuI2ADyJhOb2Q collected $11.50 from pot
RwDoM55ZeQuI2ADyJhOb2Q: doesn't show hand
*** SUMMARY ***
Total pot $12 | Rake $0.50
Board [4h 3d 2h]
Seat 1: 7fOCUy3x9hdkmXkkDNolGQ (big blind) folded on the Flop
Seat 2: RwDoM55ZeQuI2ADyJhOb2Q (button) (small blind) collected ($11.50)



PokerStars Game #59942086026:  Hold'em No Limit ($1/$2) - 2009/07/01 1:55:38 ET
Table 'jlrIxbrVIG+gjaUYT4za8g' 6-max Seat #2 is the button
Seat 2: cwfuMyvDC7J7SqX2leDC8g ($63 in chips)
Seat 3: 3LCfF9/CuJ9+kbFOcqmuaQ ($64.30 in chips)
Seat 4: 8srN1dKQePlsv0GyTada+Q ($242.50 in chips)
Seat 5: AyBB0k3Dcl7xbXUeGMw06g ($121.75 in chips)
3LCfF9/CuJ9+kbFOcqmuaQ: posts small blind $1
8srN1dKQePlsv0GyTada+Q: posts big blind $2
opJMdoq0E6TRbAQiweyQuA: sits out
*** HOLE CARDS ***
AyBB0k3Dcl7xbXUeGMw06g: folds
cwfuMyvDC7J7SqX2leDC8g: calls $2
3LCfF9/CuJ9+kbFOcqmuaQ: calls $1
8srN1dKQePlsv0GyTada+Q: raises $10 to $12
cwfuMyvDC7J7SqX2leDC8g: folds
3LCfF9/CuJ9+kbFOcqmuaQ: raises $52.30 to $64.30 and is all-in
8srN1dKQePlsv0GyTada+Q: calls $52.30
*** FLOP *** [Jc 7d 6h]
*** TURN *** [Jc 7d 6h] [Qc]
*** RIVER *** [Jc 7d 6h Qc] [4h]
*** SHOW DOWN ***
3LCfF9/CuJ9+kbFOcqmuaQ: shows [Ks As] (high card Ace)
8srN1dKQePlsv0GyTada+Q: shows [5d 5c] (a pair of Fives)
8srN1dKQePlsv0GyTada+Q collected $128.60 from pot
*** SUMMARY ***
Total pot $130.60 | Rake $2
Board [Jc 7d 6h Qc 4h]
Seat 2: cwfuMyvDC7J7SqX2leDC8g (button) folded before Flop
Seat 3: 3LCfF9/CuJ9+kbFOcqmuaQ (small blind) showed [Ks As] and lost with high card Ace
Seat 4: 8srN1dKQePlsv0GyTada+Q (big blind) showed [5d 5c] and won ($128.60) with a pair of Fives
Seat 5: AyBB0k3Dcl7xbXUeGMw06g folded before Flop (didn't bet)



PokerStars Game #59942086112:  Hold'em No Limit ($1/$2) - 2009/07/01 1:55:38 ET
Table '7goFpXy7qyiK5mwx+Ucf6A' 6-max Seat #4 is the button
Seat 1: VHmJJYp7TGQwcWROQ8dqXw ($49.10 in chips)
Seat 2: BWhgxe7gWiYobRbwdG+d2Q ($196 in chips)
Seat 3: mfy7uGZcqA2PVQqEVbJ7+g ($149.25 in chips)
Seat 4: fE+LHW/7rpfXW14g8LhGjA ($42.85 in chips)
Seat 6: VvdR9F3I+2yELkfTVvC1dg ($214.65 in chips)
vkfxu8f/jMYKUk6Ly4eujw will be allowed to play after the button
VvdR9F3I+2yELkfTVvC1dg: posts small blind $1
VHmJJYp7TGQwcWROQ8dqXw: posts big blind $2
*** HOLE CARDS ***
BWhgxe7gWiYobRbwdG+d2Q: folds
mfy7uGZcqA2PVQqEVbJ7+g: folds
fE+LHW/7rpfXW14g8LhGjA: calls $2
VvdR9F3I+2yELkfTVvC1dg: calls $1
VHmJJYp7TGQwcWROQ8dqXw: checks
*** FLOP *** [4d 9d 4s]
VvdR9F3I+2yELkfTVvC1dg: checks
VHmJJYp7TGQwcWROQ8dqXw: bets $2
fE+LHW/7rpfXW14g8LhGjA: raises $2 to $4
VvdR9F3I+2yELkfTVvC1dg: folds
VHmJJYp7TGQwcWROQ8dqXw: folds
fE+LHW/7rpfXW14g8LhGjA collected $9.55 from pot
fE+LHW/7rpfXW14g8LhGjA: doesn't show hand
*** SUMMARY ***
Total pot $10 | Rake $0.45
Board [4d 9d 4s]
Seat 1: VHmJJYp7TGQwcWROQ8dqXw (big blind) folded on the Flop
Seat 2: BWhgxe7gWiYobRbwdG+d2Q folded before Flop (didn't bet)
Seat 3: mfy7uGZcqA2PVQqEVbJ7+g folded before Flop (didn't bet)
Seat 4: fE+LHW/7rpfXW14g8LhGjA (button) collected ($9.55)
Seat 6: VvdR9F3I+2yELkfTVvC1dg (small blind) folded on the Flop



PokerStars Game #59942087426:  Hold'em No Limit ($1/$2) - 2009/07/01 1:55:40 ET
Table 'CFkQcfWjKccZaZDf71FK+w' 6-max Seat #4 is the button
Seat 1: vkfxu8f/jMYKUk6Ly4eujw ($224.05 in chips)
Seat 2: ewN/vzF22+/gdzjIKBOlkA ($212.80 in chips)
Seat 3: TMPDCBmlFGM9C+H58PC4sQ ($64.75 in chips)
Seat 4: opJMdoq0E6TRbAQiweyQuA ($37 in chips)
Seat 5: 2lOU1DcvUZaMcxZ95XfzXw ($118.85 in chips)
Seat 6: ORVqY3rf9X6ANA/8s+On2Q ($25 in chips)
2lOU1DcvUZaMcxZ95XfzXw: posts small blind $1
ORVqY3rf9X6ANA/8s+On2Q: posts big blind $2
*** HOLE CARDS ***
vkfxu8f/jMYKUk6Ly4eujw: folds
ewN/vzF22+/gdzjIKBOlkA: folds
TMPDCBmlFGM9C+H58PC4sQ: calls $2
opJMdoq0E6TRbAQiweyQuA: folds
2lOU1DcvUZaMcxZ95XfzXw: calls $1
ORVqY3rf9X6ANA/8s+On2Q: raises $2 to $4
TMPDCBmlFGM9C+H58PC4sQ: calls $2
2lOU1DcvUZaMcxZ95XfzXw: calls $2
*** FLOP *** [6c 4c Td]
2lOU1DcvUZaMcxZ95XfzXw: checks
ORVqY3rf9X6ANA/8s+On2Q: checks
TMPDCBmlFGM9C+H58PC4sQ: checks
*** TURN *** [6c 4c Td] [Jd]
2lOU1DcvUZaMcxZ95XfzXw: checks
ORVqY3rf9X6ANA/8s+On2Q: checks
TMPDCBmlFGM9C+H58PC4sQ: bets $6
2lOU1DcvUZaMcxZ95XfzXw: folds
ORVqY3rf9X6ANA/8s+On2Q: calls $6
*** RIVER *** [6c 4c Td Jd] [Kd]
ORVqY3rf9X6ANA/8s+On2Q: bets $15 and is all-in
TMPDCBmlFGM9C+H58PC4sQ: folds
ORVqY3rf9X6ANA/8s+On2Q collected $22.85 from pot
*** SUMMARY ***
Total pot $24 | Rake $1.15
Board [6c 4c Td Jd Kd]
Seat 1: vkfxu8f/jMYKUk6Ly4eujw folded before Flop (didn't bet)
Seat 2: ewN/vzF22+/gdzjIKBOlkA folded before Flop (didn't bet)
Seat 3: TMPDCBmlFGM9C+H58PC4sQ folded on the River
Seat 4: opJMdoq0E6TRbAQiweyQuA (button) folded before Flop (didn't bet)
Seat 5: 2lOU1DcvUZaMcxZ95XfzXw (small blind) folded on the Turn
Seat 6: ORVqY3rf9X6ANA/8s+On2Q (big blind) collected ($22.85)



PokerStars Game #59942087428:  Hold'em No Limit ($1/$2) - 2009/07/01 1:55:40 ET
Table 'ztv6V3FN2bQ9nmJPPdx6nQ' 6-max Seat #4 is the button
Seat 1: 6fLdOUCRtX71xbVRhJEq8w ($365.35 in chips)
Seat 2: 5Y+ZGWLI4gnlpApDX5vy1A ($293.05 in chips)
Seat 3: XP9UmPc7hfMVafyEiwJMAA ($197 in chips)
Seat 4: UaZ5yj+6LjtWqMQg2QskUw ($102.40 in chips)
Seat 5: sTPOWERd9HWPCNrDBwsVjA ($209.60 in chips)
Seat 6: mfy7uGZcqA2PVQqEVbJ7+g ($185 in chips)
sTPOWERd9HWPCNrDBwsVjA: posts small blind $1
mfy7uGZcqA2PVQqEVbJ7+g: posts big blind $2
*** HOLE CARDS ***
6fLdOUCRtX71xbVRhJEq8w: folds
5Y+ZGWLI4gnlpApDX5vy1A: folds
XP9UmPc7hfMVafyEiwJMAA: folds
UaZ5yj+6LjtWqMQg2QskUw: calls $2
sTPOWERd9HWPCNrDBwsVjA: calls $1
mfy7uGZcqA2PVQqEVbJ7+g: checks
*** FLOP *** [Qs 7s Jh]
sTPOWERd9HWPCNrDBwsVjA: checks
mfy7uGZcqA2PVQqEVbJ7+g: checks
UaZ5yj+6LjtWqMQg2QskUw: checks
*** TURN *** [Qs 7s Jh] [2c]
sTPOWERd9HWPCNrDBwsVjA: checks
mfy7uGZcqA2PVQqEVbJ7+g: bets $4
UaZ5yj+6LjtWqMQg2QskUw: folds
sTPOWERd9HWPCNrDBwsVjA: folds
mfy7uGZcqA2PVQqEVbJ7+g collected $5.70 from pot
mfy7uGZcqA2PVQqEVbJ7+g: doesn't show hand
*** SUMMARY ***
Total pot $6 | Rake $0.30
Board [Qs 7s Jh 2c]
Seat 1: 6fLdOUCRtX71xbVRhJEq8w folded before Flop (didn't bet)
Seat 2: 5Y+ZGWLI4gnlpApDX5vy1A folded before Flop (didn't bet)
Seat 3: XP9UmPc7hfMVafyEiwJMAA folded before Flop (didn't bet)
Seat 4: UaZ5yj+6LjtWqMQg2QskUw (button) folded on the Turn
Seat 5: sTPOWERd9HWPCNrDBwsVjA (small blind) folded on the Turn
Seat 6: mfy7uGZcqA2PVQqEVbJ7+g (big blind) collected ($5.70)



PokerStars Game #59942087668:  Hold'em No Limit ($1/$2) - 2009/07/01 1:55:41 ET
Table '/8c0X14Gjd7J3pVNocAJrQ' 6-max Seat #1 is the button
Seat 1: AuiGltq875lmaKHBsjZVGg ($88.20 in chips)
Seat 2: mfy7uGZcqA2PVQqEVbJ7+g ($276.60 in chips)
Seat 3: sr/OkkgqNbtgwJf1tmnfNg ($104.30 in chips)
Seat 4: PkzV5n5qRUp0Weu8NcNNhA ($86.40 in chips)
Seat 5: /PH6Ffnho4Ysm8S3V/oa+w ($42 in chips)
Seat 6: VvdR9F3I+2yELkfTVvC1dg ($335.95 in chips)
mfy7uGZcqA2PVQqEVbJ7+g: posts small blind $1
sr/OkkgqNbtgwJf1tmnfNg: posts big blind $2
*** HOLE CARDS ***
PkzV5n5qRUp0Weu8NcNNhA: calls $2
/PH6Ffnho4Ysm8S3V/oa+w: folds
VvdR9F3I+2yELkfTVvC1dg: folds
AuiGltq875lmaKHBsjZVGg: folds
mfy7uGZcqA2PVQqEVbJ7+g: folds
sr/OkkgqNbtgwJf1tmnfNg: checks
*** FLOP *** [2d Ad 8s]
sr/OkkgqNbtgwJf1tmnfNg: checks
PkzV5n5qRUp0Weu8NcNNhA: checks
*** TURN *** [2d Ad 8s] [3d]
sr/OkkgqNbtgwJf1tmnfNg: checks
PkzV5n5qRUp0Weu8NcNNhA: checks
*** RIVER *** [2d Ad 8s 3d] [Qs]
sr/OkkgqNbtgwJf1tmnfNg: checks
PkzV5n5qRUp0Weu8NcNNhA: bets $4
sr/OkkgqNbtgwJf1tmnfNg: folds
PkzV5n5qRUp0Weu8NcNNhA collected $4.75 from pot
PkzV5n5qRUp0Weu8NcNNhA: doesn't show hand
*** SUMMARY ***
Total pot $5 | Rake $0.25
Board [2d Ad 8s 3d Qs]
Seat 1: AuiGltq875lmaKHBsjZVGg (button) folded before Flop (didn't bet)
Seat 2: mfy7uGZcqA2PVQqEVbJ7+g (small blind) folded before Flop
Seat 3: sr/OkkgqNbtgwJf1tmnfNg (big blind) folded on the River
Seat 4: PkzV5n5qRUp0Weu8NcNNhA collected ($4.75)
Seat 5: /PH6Ffnho4Ysm8S3V/oa+w folded before Flop (didn't bet)
Seat 6: VvdR9F3I+2yELkfTVvC1dg folded before Flop (didn't bet)



PokerStars Game #59942087462:  Hold'em No Limit ($1/$2) - 2009/07/01 1:55:41 ET
Table 'aSf77Sj8QEnzcc0WaxVD4Q' 6-max Seat #5 is the button
Seat 1: UELtvp+JfwI7XDGVwSxZXA ($166.85 in chips)
Seat 2: vkfxu8f/jMYKUk6Ly4eujw ($204 in chips)
Seat 4: YsLQ3BAvgQHWXMAv3Wv6Hg ($200 in chips)
Seat 5: VvdR9F3I+2yELkfTVvC1dg ($286.15 in chips)
Seat 6: vkoJRf3gidxY1pPi0AFWww ($196.85 in chips)
vkoJRf3gidxY1pPi0AFWww: posts small blind $1
UELtvp+JfwI7XDGVwSxZXA: posts big blind $2
3cPMpDMgeOMAe4UceUfLsg: sits out
*** HOLE CARDS ***
vkfxu8f/jMYKUk6Ly4eujw: calls $2
YsLQ3BAvgQHWXMAv3Wv6Hg: folds
VvdR9F3I+2yELkfTVvC1dg: folds
vkoJRf3gidxY1pPi0AFWww: calls $1
UELtvp+JfwI7XDGVwSxZXA: checks
*** FLOP *** [7s 8d 8s]
vkoJRf3gidxY1pPi0AFWww: checks
UELtvp+JfwI7XDGVwSxZXA: checks
vkfxu8f/jMYKUk6Ly4eujw: checks
*** TURN *** [7s 8d 8s] [6d]
vkoJRf3gidxY1pPi0AFWww: checks
UELtvp+JfwI7XDGVwSxZXA: checks
vkfxu8f/jMYKUk6Ly4eujw: checks
*** RIVER *** [7s 8d 8s 6d] [Ac]
vkoJRf3gidxY1pPi0AFWww: checks
UELtvp+JfwI7XDGVwSxZXA: bets $4
vkfxu8f/jMYKUk6Ly4eujw: folds
vkoJRf3gidxY1pPi0AFWww: folds
UELtvp+JfwI7XDGVwSxZXA collected $5.70 from pot
*** SUMMARY ***
Total pot $6 | Rake $0.30
Board [7s 8d 8s 6d Ac]
Seat 1: UELtvp+JfwI7XDGVwSxZXA (big blind) collected ($5.70)
Seat 2: vkfxu8f/jMYKUk6Ly4eujw folded on the River
Seat 4: YsLQ3BAvgQHWXMAv3Wv6Hg folded before Flop (didn't bet)
Seat 5: VvdR9F3I+2yELkfTVvC1dg (button) folded before Flop (didn't bet)
Seat 6: vkoJRf3gidxY1pPi0AFWww (small blind) folded on the River



PokerStars Game #59942088778:  Hold'em No Limit ($1/$2) - 2009/07/01 1:55:43 ET
Table '/dyk+YdRGv90j2box35j8w' 6-max Seat #4 is the button
Seat 2: qCnEYuAE5y5A7bk6fO5/jQ ($491.20 in chips)
Seat 3: sTPOWERd9HWPCNrDBwsVjA ($212.50 in chips)
Seat 4: 4dMBh/1VTdeUTPCyhCs3UQ ($85.25 in chips)
Seat 5: VvdR9F3I+2yELkfTVvC1dg ($297.35 in chips)
Seat 6: C3qJBo7uxfFVDluE1lmK2w ($92.25 in chips)
VvdR9F3I+2yELkfTVvC1dg: posts small blind $1
C3qJBo7uxfFVDluE1lmK2w: posts big blind $2
*** HOLE CARDS ***
qCnEYuAE5y5A7bk6fO5/jQ: folds
sTPOWERd9HWPCNrDBwsVjA: folds
4dMBh/1VTdeUTPCyhCs3UQ: calls $2
VvdR9F3I+2yELkfTVvC1dg: calls $1
C3qJBo7uxfFVDluE1lmK2w: checks
*** FLOP *** [Js 4d Tc]
VvdR9F3I+2yELkfTVvC1dg: checks
C3qJBo7uxfFVDluE1lmK2w: checks
4dMBh/1VTdeUTPCyhCs3UQ: bets $4
VvdR9F3I+2yELkfTVvC1dg: folds
C3qJBo7uxfFVDluE1lmK2w: folds
4dMBh/1VTdeUTPCyhCs3UQ collected $5.70 from pot
4dMBh/1VTdeUTPCyhCs3UQ: doesn't show hand
*** SUMMARY ***
Total pot $6 | Rake $0.30
Board [Js 4d Tc]
Seat 2: qCnEYuAE5y5A7bk6fO5/jQ folded before Flop (didn't bet)
Seat 3: sTPOWERd9HWPCNrDBwsVjA folded before Flop (didn't bet)
Seat 4: 4dMBh/1VTdeUTPCyhCs3UQ (button) collected ($5.70)
Seat 5: VvdR9F3I+2yELkfTVvC1dg (small blind) folded on the Flop
Seat 6: C3qJBo7uxfFVDluE1lmK2w (big blind) folded on the Flop



PokerStars Game #59942089170:  Hold'em No Limit ($1/$2) - 2009/07/01 1:55:44 ET
Table 'bIihwBANJSFqlHPPtset+w' 9-max Seat #1 is the button
Seat 1: KqHysDSpCPaPyK3tJC1aEw ($223.25 in chips)
Seat 2: lQYT23h5QCUVZAKxjOO39Q ($205.20 in chips)
Seat 3: 6MRmKcp6RorxqG+mA3KeAw ($173 in chips)
Seat 5: vxbbJLsS1bva6tW2NiFssg ($200 in chips)
Seat 6: CkE3IyJF1KvdaAOmZY5XqQ ($233.15 in chips)
Seat 7: pCmk6FpSOLJ+85o1tLHIag ($134.55 in chips)
Seat 8: 254YPxPJr5Sw58bkD0YqYQ ($200 in chips)
Seat 9: kM9CA+2UcdMjbCMbtUCGiA ($200 in chips)
lQYT23h5QCUVZAKxjOO39Q: posts small blind $1
6MRmKcp6RorxqG+mA3KeAw: posts big blind $2
XmmQKhdZdYwJP9Bfu+Qfuw: sits out
*** HOLE CARDS ***
vxbbJLsS1bva6tW2NiFssg: folds
CkE3IyJF1KvdaAOmZY5XqQ: folds
vxbbJLsS1bva6tW2NiFssg said, "nh"
pCmk6FpSOLJ+85o1tLHIag: calls $2
254YPxPJr5Sw58bkD0YqYQ: folds
lQYT23h5QCUVZAKxjOO39Q said, "t"
kM9CA+2UcdMjbCMbtUCGiA: folds
KqHysDSpCPaPyK3tJC1aEw: folds
lQYT23h5QCUVZAKxjOO39Q: folds
6MRmKcp6RorxqG+mA3KeAw: checks
*** FLOP *** [3d 4d 6d]
6MRmKcp6RorxqG+mA3KeAw: checks
pCmk6FpSOLJ+85o1tLHIag: bets $3
6MRmKcp6RorxqG+mA3KeAw: folds
pCmk6FpSOLJ+85o1tLHIag collected $4.75 from pot
pCmk6FpSOLJ+85o1tLHIag: doesn't show hand
*** SUMMARY ***
Total pot $5 | Rake $0.25
Board [3d 4d 6d]
Seat 1: KqHysDSpCPaPyK3tJC1aEw (button) folded before Flop (didn't bet)
Seat 2: lQYT23h5QCUVZAKxjOO39Q (small blind) folded before Flop
Seat 3: 6MRmKcp6RorxqG+mA3KeAw (big blind) folded on the Flop
Seat 5: vxbbJLsS1bva6tW2NiFssg folded before Flop (didn't bet)
Seat 6: CkE3IyJF1KvdaAOmZY5XqQ folded before Flop (didn't bet)
Seat 7: pCmk6FpSOLJ+85o1tLHIag collected ($4.75)
Seat 8: 254YPxPJr5Sw58bkD0YqYQ folded before Flop (didn't bet)
Seat 9: kM9CA+2UcdMjbCMbtUCGiA folded before Flop (didn't bet)



PokerStars Game #59942089812:  Hold'em No Limit ($1/$2) - 2009/07/01 1:55:45 ET
Table 'NmY84NAf9Mh0ckAckHnh5g' 2-max Seat #1 is the button
Seat 1: 6hvg964TSqZ3AL/0XK9aVQ ($392.20 in chips)
Seat 2: RwDoM55ZeQuI2ADyJhOb2Q ($585.80 in chips)
6hvg964TSqZ3AL/0XK9aVQ: posts small blind $1
RwDoM55ZeQuI2ADyJhOb2Q: posts big blind $2
*** HOLE CARDS ***
6hvg964TSqZ3AL/0XK9aVQ: calls $1
RwDoM55ZeQuI2ADyJhOb2Q: checks
*** FLOP *** [Kh 3c 5c]
RwDoM55ZeQuI2ADyJhOb2Q: checks
6hvg964TSqZ3AL/0XK9aVQ: checks
*** TURN *** [Kh 3c 5c] [As]
RwDoM55ZeQuI2ADyJhOb2Q: checks
6hvg964TSqZ3AL/0XK9aVQ: bets $2
RwDoM55ZeQuI2ADyJhOb2Q: calls $2
*** RIVER *** [Kh 3c 5c As] [5h]
RwDoM55ZeQuI2ADyJhOb2Q: checks
6hvg964TSqZ3AL/0XK9aVQ: bets $26
RwDoM55ZeQuI2ADyJhOb2Q: calls $26
*** SHOW DOWN ***
6hvg964TSqZ3AL/0XK9aVQ: shows [Tc Ac] (two pair, Aces and Fives)
RwDoM55ZeQuI2ADyJhOb2Q: mucks hand
6hvg964TSqZ3AL/0XK9aVQ collected $59.50 from pot
*** SUMMARY ***
Total pot $60 | Rake $0.50
Board [Kh 3c 5c As 5h]
Seat 1: 6hvg964TSqZ3AL/0XK9aVQ (button) (small blind) showed [Tc Ac] and won ($59.50) with two pair, Aces and Fives
Seat 2: RwDoM55ZeQuI2ADyJhOb2Q (big blind) mucked



PokerStars Game #59942090674:  Hold'em No Limit ($1/$2) - 2009/07/01 1:55:47 ET
Table '4NGNnZ/osQfNq6abYqkJeA' 6-max Seat #1 is the button
Seat 1: 0Bc+WhbOvaaWIMmmui3q0g ($146.10 in chips)
Seat 2: 669iGNwYwgRZg3nhS+aDAQ ($105.75 in chips)
Seat 4: sY+4Uuh5z/6AbXXaCS10jw ($297.10 in chips)
Seat 5: VvdR9F3I+2yELkfTVvC1dg ($204.80 in chips)
Seat 6: /PH6Ffnho4Ysm8S3V/oa+w ($54.20 in chips)
669iGNwYwgRZg3nhS+aDAQ: posts small blind $1
54yWzRRgS0oZ+S6LwZBxMQ: is sitting out
sY+4Uuh5z/6AbXXaCS10jw: posts big blind $2
*** HOLE CARDS ***
54yWzRRgS0oZ+S6LwZBxMQ leaves the table
VvdR9F3I+2yELkfTVvC1dg: raises $2 to $4
/PH6Ffnho4Ysm8S3V/oa+w: folds
qXDd0ZyMIse0OBu8pxeQ3Q joins the table at seat #3
0Bc+WhbOvaaWIMmmui3q0g: folds
669iGNwYwgRZg3nhS+aDAQ: folds
sY+4Uuh5z/6AbXXaCS10jw: folds
VvdR9F3I+2yELkfTVvC1dg collected $5 from pot
VvdR9F3I+2yELkfTVvC1dg: doesn't show hand
*** SUMMARY ***
Total pot $5 | Rake $0
Seat 1: 0Bc+WhbOvaaWIMmmui3q0g (button) folded before Flop (didn't bet)
Seat 2: 669iGNwYwgRZg3nhS+aDAQ (small blind) folded before Flop
Seat 4: sY+4Uuh5z/6AbXXaCS10jw (big blind) folded before Flop
Seat 5: VvdR9F3I+2yELkfTVvC1dg collected ($5)
Seat 6: /PH6Ffnho4Ysm8S3V/oa+w folded before Flop (didn't bet)



PokerStars Game #59942093618:  Hold'em No Limit ($1/$2) - 2009/07/01 1:55:52 ET
Table 'BSRfGh+QobUe0AgIMtt/fw' 9-max Seat #9 is the button
Seat 1: gDn/rYeNwCyWEgRhyWp4PA ($157.05 in chips)
Seat 2: +SmnXtdmwqXGEJfLeJDIUQ ($132.50 in chips)
Seat 3: WUlHm+ydPPHG7Lb0rePSdA ($120 in chips)
Seat 4: +T/63sAeZzWyHchahJ36GQ ($31 in chips)
Seat 5: ThVDqrMpsvd7Ax6KINfuew ($64.50 in chips)
Seat 6: H6Z4+qu8gR0VUiPOijndVg ($202 in chips)
Seat 7: CkE3IyJF1KvdaAOmZY5XqQ ($202 in chips)
Seat 8: GG5lTuGt3+kwNYSbqeB6yw ($72.85 in chips)
Seat 9: tjgwwDmi+N2H4I7hx8useQ ($82.70 in chips)
gDn/rYeNwCyWEgRhyWp4PA: posts small blind $1
+SmnXtdmwqXGEJfLeJDIUQ: posts big blind $2
*** HOLE CARDS ***
WUlHm+ydPPHG7Lb0rePSdA: folds
+T/63sAeZzWyHchahJ36GQ: folds
ThVDqrMpsvd7Ax6KINfuew: calls $2
H6Z4+qu8gR0VUiPOijndVg: folds
CkE3IyJF1KvdaAOmZY5XqQ: folds
GG5lTuGt3+kwNYSbqeB6yw: calls $2
tjgwwDmi+N2H4I7hx8useQ: folds
gDn/rYeNwCyWEgRhyWp4PA: folds
+SmnXtdmwqXGEJfLeJDIUQ: checks
*** FLOP *** [8d 6c 7c]
+SmnXtdmwqXGEJfLeJDIUQ: checks
ThVDqrMpsvd7Ax6KINfuew: bets $2
GG5lTuGt3+kwNYSbqeB6yw: calls $2
+SmnXtdmwqXGEJfLeJDIUQ: calls $2
*** TURN *** [8d 6c 7c] [Kh]
+SmnXtdmwqXGEJfLeJDIUQ: checks
ThVDqrMpsvd7Ax6KINfuew: checks
GG5lTuGt3+kwNYSbqeB6yw: bets $6
+SmnXtdmwqXGEJfLeJDIUQ: folds
ThVDqrMpsvd7Ax6KINfuew: folds
GG5lTuGt3+kwNYSbqeB6yw collected $12.40 from pot
*** SUMMARY ***
Total pot $13 | Rake $0.60
Board [8d 6c 7c Kh]
Seat 1: gDn/rYeNwCyWEgRhyWp4PA (small blind) folded before Flop
Seat 2: +SmnXtdmwqXGEJfLeJDIUQ (big blind) folded on the Turn
Seat 3: WUlHm+ydPPHG7Lb0rePSdA folded before Flop (didn't bet)
Seat 4: +T/63sAeZzWyHchahJ36GQ folded before Flop (didn't bet)
Seat 5: ThVDqrMpsvd7Ax6KINfuew folded on the Turn
Seat 6: H6Z4+qu8gR0VUiPOijndVg folded before Flop (didn't bet)
Seat 7: CkE3IyJF1KvdaAOmZY5XqQ folded before Flop (didn't bet)
Seat 8: GG5lTuGt3+kwNYSbqeB6yw collected ($12.40)
Seat 9: tjgwwDmi+N2H4I7hx8useQ (button) folded before Flop (didn't bet)



PokerStars Game #59942094054:  Hold'em No Limit ($1/$2) - 2009/07/01 1:55:53 ET
Table 'TsEDkiO4tzCTCzJ7tNdEqw' 6-max Seat #2 is the button
Seat 1: Nsjun4mjI8q0SSBTIp1dIQ ($200 in chips)
Seat 2: 4dcDwIHRm96PwtqkpQiuiA ($79.70 in chips)
Seat 3: ubtx4Z5L+AcK71MTvYiGVw ($256.90 in chips)
Seat 4: K8MXCrNAVYlMnnCeM32Kxw ($76.35 in chips)
Seat 5: VvdR9F3I+2yELkfTVvC1dg ($250.10 in chips)
Seat 6: uCqEjnxh2/vFBjKYkfTOkw ($277.10 in chips)
ubtx4Z5L+AcK71MTvYiGVw: posts small blind $1
K8MXCrNAVYlMnnCeM32Kxw: posts big blind $2
*** HOLE CARDS ***
VvdR9F3I+2yELkfTVvC1dg: folds
uCqEjnxh2/vFBjKYkfTOkw: raises $6 to $8
Nsjun4mjI8q0SSBTIp1dIQ: folds
4dcDwIHRm96PwtqkpQiuiA: folds
ubtx4Z5L+AcK71MTvYiGVw: folds
K8MXCrNAVYlMnnCeM32Kxw: calls $6
*** FLOP *** [6h 8c 3s]
K8MXCrNAVYlMnnCeM32Kxw: bets $8
uCqEjnxh2/vFBjKYkfTOkw: calls $8
*** TURN *** [6h 8c 3s] [2h]
K8MXCrNAVYlMnnCeM32Kxw: bets $60
uCqEjnxh2/vFBjKYkfTOkw: raises $60 to $120
K8MXCrNAVYlMnnCeM32Kxw: calls $0.35 and is all-in
*** RIVER *** [6h 8c 3s 2h] [Jc]
*** SHOW DOWN ***
K8MXCrNAVYlMnnCeM32Kxw: shows [3c 7c] (a pair of Threes)
uCqEjnxh2/vFBjKYkfTOkw: shows [3h 3d] (three of a kind, Threes)
uCqEjnxh2/vFBjKYkfTOkw collected $150.70 from pot
*** SUMMARY ***
Total pot $153.70 | Rake $3
Board [6h 8c 3s 2h Jc]
Seat 1: Nsjun4mjI8q0SSBTIp1dIQ folded before Flop (didn't bet)
Seat 2: 4dcDwIHRm96PwtqkpQiuiA (button) folded before Flop (didn't bet)
Seat 3: ubtx4Z5L+AcK71MTvYiGVw (small blind) folded before Flop
Seat 4: K8MXCrNAVYlMnnCeM32Kxw (big blind) showed [3c 7c] and lost with a pair of Threes
Seat 5: VvdR9F3I+2yELkfTVvC1dg folded before Flop (didn't bet)
Seat 6: uCqEjnxh2/vFBjKYkfTOkw showed [3h 3d] and won ($150.70) with three of a kind, Threes



PokerStars Game #59942094242:  Hold'em No Limit ($1/$2) - 2009/07/01 1:55:53 ET
Table 'eyAQSIlgc2o1Jxvbve4WGg' 9-max Seat #8 is the button
Seat 1: UZEsV9yKUMqmpYPiOFpaZw ($73 in chips)
Seat 2: kM9CA+2UcdMjbCMbtUCGiA ($221.05 in chips)
Seat 4: CkE3IyJF1KvdaAOmZY5XqQ ($200 in chips)
Seat 5: mIKx5lhIt13X5eZQH0ZeMA ($148.75 in chips)
Seat 7: u3OrI5uGx9mx1fE7dgr+EA ($106.80 in chips)
Seat 8: 254YPxPJr5Sw58bkD0YqYQ ($200 in chips)
Seat 9: WUlHm+ydPPHG7Lb0rePSdA ($123.20 in chips)
WUlHm+ydPPHG7Lb0rePSdA: posts small blind $1
UZEsV9yKUMqmpYPiOFpaZw: posts big blind $2
ice1Sbe19zWIaKYoSmE5tw: sits out
*** HOLE CARDS ***
kM9CA+2UcdMjbCMbtUCGiA: folds
CkE3IyJF1KvdaAOmZY5XqQ: folds
mIKx5lhIt13X5eZQH0ZeMA: calls $2
u3OrI5uGx9mx1fE7dgr+EA: calls $2
254YPxPJr5Sw58bkD0YqYQ: raises $10 to $12
WUlHm+ydPPHG7Lb0rePSdA: folds
UZEsV9yKUMqmpYPiOFpaZw: folds
mIKx5lhIt13X5eZQH0ZeMA: folds
u3OrI5uGx9mx1fE7dgr+EA: folds
254YPxPJr5Sw58bkD0YqYQ collected $9 from pot
254YPxPJr5Sw58bkD0YqYQ: doesn't show hand
*** SUMMARY ***
Total pot $9 | Rake $0
Seat 1: UZEsV9yKUMqmpYPiOFpaZw (big blind) folded before Flop
Seat 2: kM9CA+2UcdMjbCMbtUCGiA folded before Flop (didn't bet)
Seat 4: CkE3IyJF1KvdaAOmZY5XqQ folded before Flop (didn't bet)
Seat 5: mIKx5lhIt13X5eZQH0ZeMA folded before Flop
Seat 7: u3OrI5uGx9mx1fE7dgr+EA folded before Flop
Seat 8: 254YPxPJr5Sw58bkD0YqYQ (button) collected ($9)
Seat 9: WUlHm+ydPPHG7Lb0rePSdA (small blind) folded before Flop



PokerStars Game #59942095776:  Hold'em No Limit ($1/$2) - 2009/07/01 1:55:56 ET
Table 'P/yCfYl1GfGsu/e6DxDy/A' 2-max Seat #1 is the button
Seat 1: 7fOCUy3x9hdkmXkkDNolGQ ($1105.50 in chips)
Seat 2: RwDoM55ZeQuI2ADyJhOb2Q ($361.50 in chips)
7fOCUy3x9hdkmXkkDNolGQ: posts small blind $1
RwDoM55ZeQuI2ADyJhOb2Q: posts big blind $2
*** HOLE CARDS ***
7fOCUy3x9hdkmXkkDNolGQ: folds
RwDoM55ZeQuI2ADyJhOb2Q collected $2 from pot
RwDoM55ZeQuI2ADyJhOb2Q: doesn't show hand
*** SUMMARY ***
Total pot $2 | Rake $0
Seat 1: 7fOCUy3x9hdkmXkkDNolGQ (button) (small blind) folded before Flop
Seat 2: RwDoM55ZeQuI2ADyJhOb2Q (big blind) collected ($2)



PokerStars Game #59942096320:  Hold'em No Limit ($1/$2) - 2009/07/01 1:55:57 ET
Table '3WCXyaiCAbqSShQu7FIjvA' 9-max Seat #9 is the button
Seat 1: kTCkABD1UUldS9DFRGfCwQ ($135.75 in chips)
Seat 2: 254YPxPJr5Sw58bkD0YqYQ ($200 in chips)
Seat 3: 5Q8U6iZbeO7xJSS4qvDP5g ($247.25 in chips)
Seat 4: waEF/+pxZTxNo4FvsORuXg ($101.40 in chips)
Seat 5: CkE3IyJF1KvdaAOmZY5XqQ ($207.90 in chips)
Seat 6: 5jQlngvMSqM/WoonOcR5kw ($277.50 in chips)
Seat 8: +T/63sAeZzWyHchahJ36GQ ($34 in chips)
Seat 9: FiXPLJyqb24l32QST2TInw ($138 in chips)
kTCkABD1UUldS9DFRGfCwQ: posts small blind $1
254YPxPJr5Sw58bkD0YqYQ: posts big blind $2
*** HOLE CARDS ***
5Q8U6iZbeO7xJSS4qvDP5g: folds
waEF/+pxZTxNo4FvsORuXg: folds
CkE3IyJF1KvdaAOmZY5XqQ: folds
5jQlngvMSqM/WoonOcR5kw: folds
+T/63sAeZzWyHchahJ36GQ: folds
FiXPLJyqb24l32QST2TInw: folds
kTCkABD1UUldS9DFRGfCwQ: calls $1
254YPxPJr5Sw58bkD0YqYQ: checks
*** FLOP *** [3s Jh 7d]
kTCkABD1UUldS9DFRGfCwQ: bets $2
254YPxPJr5Sw58bkD0YqYQ: folds
kTCkABD1UUldS9DFRGfCwQ collected $3.80 from pot
kTCkABD1UUldS9DFRGfCwQ: doesn't show hand
*** SUMMARY ***
Total pot $4 | Rake $0.20
Board [3s Jh 7d]
Seat 1: kTCkABD1UUldS9DFRGfCwQ (small blind) collected ($3.80)
Seat 2: 254YPxPJr5Sw58bkD0YqYQ (big blind) folded on the Flop
Seat 3: 5Q8U6iZbeO7xJSS4qvDP5g folded before Flop (didn't bet)
Seat 4: waEF/+pxZTxNo4FvsORuXg folded before Flop (didn't bet)
Seat 5: CkE3IyJF1KvdaAOmZY5XqQ folded before Flop (didn't bet)
Seat 6: 5jQlngvMSqM/WoonOcR5kw folded before Flop (didn't bet)
Seat 8: +T/63sAeZzWyHchahJ36GQ folded before Flop (didn't bet)
Seat 9: FiXPLJyqb24l32QST2TInw (button) folded before Flop (didn't bet)



PokerStars Game #59942097056:  Hold'em No Limit ($1/$2) - 2009/07/01 1:55:59 ET
Table 'gnHBqWll9O3fxG7Ojkz/ng' 9-max Seat #7 is the button
Seat 1: MtdNf9cdM7+0CSU0dx4USA ($77.35 in chips)
Seat 2: H6Z4+qu8gR0VUiPOijndVg ($335.30 in chips)
Seat 3: 5Q8U6iZbeO7xJSS4qvDP5g ($250.15 in chips)
Seat 5: rBQDMkKm9cZn6M9NPsiVew ($166.15 in chips)
Seat 6: KqHysDSpCPaPyK3tJC1aEw ($200 in chips)
Seat 7: 254YPxPJr5Sw58bkD0YqYQ ($200 in chips)
Seat 8: cM6efHzdxoqYm0EQKP4TTQ ($132.70 in chips)
Seat 9: GX1heJ+DSsvm7gzSPsYhhQ ($40 in chips)
cM6efHzdxoqYm0EQKP4TTQ: posts small blind $1
GX1heJ+DSsvm7gzSPsYhhQ: posts big blind $2
*** HOLE CARDS ***
MtdNf9cdM7+0CSU0dx4USA: folds
H6Z4+qu8gR0VUiPOijndVg: folds
5Q8U6iZbeO7xJSS4qvDP5g: folds
rBQDMkKm9cZn6M9NPsiVew: folds
KqHysDSpCPaPyK3tJC1aEw: folds
254YPxPJr5Sw58bkD0YqYQ: calls $2
cM6efHzdxoqYm0EQKP4TTQ: calls $1
GX1heJ+DSsvm7gzSPsYhhQ: checks
*** FLOP *** [Ah 9c 7h]
cM6efHzdxoqYm0EQKP4TTQ: checks
GX1heJ+DSsvm7gzSPsYhhQ: checks
254YPxPJr5Sw58bkD0YqYQ: bets $6
cM6efHzdxoqYm0EQKP4TTQ: folds
GX1heJ+DSsvm7gzSPsYhhQ: raises $6 to $12
254YPxPJr5Sw58bkD0YqYQ: calls $6
*** TURN *** [Ah 9c 7h] [2c]
GX1heJ+DSsvm7gzSPsYhhQ: bets $26 and is all-in
254YPxPJr5Sw58bkD0YqYQ: folds
GX1heJ+DSsvm7gzSPsYhhQ collected $28.55 from pot
GX1heJ+DSsvm7gzSPsYhhQ: doesn't show hand
*** SUMMARY ***
Total pot $30 | Rake $1.45
Board [Ah 9c 7h 2c]
Seat 1: MtdNf9cdM7+0CSU0dx4USA folded before Flop (didn't bet)
Seat 2: H6Z4+qu8gR0VUiPOijndVg folded before Flop (didn't bet)
Seat 3: 5Q8U6iZbeO7xJSS4qvDP5g folded before Flop (didn't bet)
Seat 5: rBQDMkKm9cZn6M9NPsiVew folded before Flop (didn't bet)
Seat 6: KqHysDSpCPaPyK3tJC1aEw folded before Flop (didn't bet)
Seat 7: 254YPxPJr5Sw58bkD0YqYQ (button) folded on the Turn
Seat 8: cM6efHzdxoqYm0EQKP4TTQ (small blind) folded on the Flop
Seat 9: GX1heJ+DSsvm7gzSPsYhhQ (big blind) collected ($28.55)



PokerStars Game #59942097356:  Hold'em No Limit ($1/$2) - 2009/07/01 1:55:59 ET
Table 'rKeCh+eBn4RNvybCUYkoTQ' 9-max Seat #6 is the button
Seat 1: yb4VS5k/eXxPEc0NRsIMJw ($27.80 in chips)
Seat 3: GX1heJ+DSsvm7gzSPsYhhQ ($54.75 in chips)
Seat 4: gxYDp0GZEzKoOg07Km9LaA ($98 in chips)
Seat 5: WUlHm+ydPPHG7Lb0rePSdA ($171.65 in chips)
Seat 6: +WoujR0xbwD7I2jrVmHuXw ($206.35 in chips)
Seat 7: rW/MyplHylMSBRaoRUzWrg ($32.80 in chips)
Seat 8: BkiGibLm0/LgS9GD9TKYJg ($103.45 in chips)
Seat 9: PfmlvZlFiss79a6IoEr11g ($92 in chips)
rW/MyplHylMSBRaoRUzWrg: posts small blind $1
BkiGibLm0/LgS9GD9TKYJg: posts big blind $2
*** HOLE CARDS ***
PfmlvZlFiss79a6IoEr11g: folds
yb4VS5k/eXxPEc0NRsIMJw: folds
GX1heJ+DSsvm7gzSPsYhhQ: folds
gxYDp0GZEzKoOg07Km9LaA: calls $2
WUlHm+ydPPHG7Lb0rePSdA: folds
+WoujR0xbwD7I2jrVmHuXw: folds
rW/MyplHylMSBRaoRUzWrg: folds
BkiGibLm0/LgS9GD9TKYJg: raises $2 to $4
gxYDp0GZEzKoOg07Km9LaA: calls $2
*** FLOP *** [3c 5s Kh]
BkiGibLm0/LgS9GD9TKYJg: bets $6
gxYDp0GZEzKoOg07Km9LaA: folds
BkiGibLm0/LgS9GD9TKYJg collected $8.55 from pot
*** SUMMARY ***
Total pot $9 | Rake $0.45
Board [3c 5s Kh]
Seat 1: yb4VS5k/eXxPEc0NRsIMJw folded before Flop (didn't bet)
Seat 3: GX1heJ+DSsvm7gzSPsYhhQ folded before Flop (didn't bet)
Seat 4: gxYDp0GZEzKoOg07Km9LaA folded on the Flop
Seat 5: WUlHm+ydPPHG7Lb0rePSdA folded before Flop (didn't bet)
Seat 6: +WoujR0xbwD7I2jrVmHuXw (button) folded before Flop (didn't bet)
Seat 7: rW/MyplHylMSBRaoRUzWrg (small blind) folded before Flop
Seat 8: BkiGibLm0/LgS9GD9TKYJg (big blind) collected ($8.55)
Seat 9: PfmlvZlFiss79a6IoEr11g folded before Flop (didn't bet)



PokerStars Game #59942098190:  Hold'em No Limit ($1/$2) - 2009/07/01 1:56:01 ET
Table 'pPQgcj9XT9CHBsbo1WTBug' 6-max Seat #3 is the button
Seat 1: DFVYDA6dKQy7R7mGIKogZA ($151.45 in chips)
Seat 2: qXDd0ZyMIse0OBu8pxeQ3Q ($200 in chips)
Seat 3: sSAA879uXOGR+8Mf3zLa6Q ($149.20 in chips)
Seat 4: cwfuMyvDC7J7SqX2leDC8g ($60.30 in chips)
Seat 5: vkfxu8f/jMYKUk6Ly4eujw ($200 in chips)
Seat 6: Yr7pZltpy3IUNdKS9PCEiw ($288.80 in chips)
cwfuMyvDC7J7SqX2leDC8g: posts small blind $1
vkfxu8f/jMYKUk6Ly4eujw: posts big blind $2
*** HOLE CARDS ***
Yr7pZltpy3IUNdKS9PCEiw: folds
DFVYDA6dKQy7R7mGIKogZA: calls $2
qXDd0ZyMIse0OBu8pxeQ3Q: folds
sSAA879uXOGR+8Mf3zLa6Q: folds
cwfuMyvDC7J7SqX2leDC8g: folds
vkfxu8f/jMYKUk6Ly4eujw: checks
*** FLOP *** [2h 7c Ad]
vkfxu8f/jMYKUk6Ly4eujw: checks
DFVYDA6dKQy7R7mGIKogZA: bets $2
vkfxu8f/jMYKUk6Ly4eujw: folds
DFVYDA6dKQy7R7mGIKogZA collected $4.75 from pot
*** SUMMARY ***
Total pot $5 | Rake $0.25
Board [2h 7c Ad]
Seat 1: DFVYDA6dKQy7R7mGIKogZA collected ($4.75)
Seat 2: qXDd0ZyMIse0OBu8pxeQ3Q folded before Flop (didn't bet)
Seat 3: sSAA879uXOGR+8Mf3zLa6Q (button) folded before Flop (didn't bet)
Seat 4: cwfuMyvDC7J7SqX2leDC8g (small blind) folded before Flop
Seat 5: vkfxu8f/jMYKUk6Ly4eujw (big blind) folded on the Flop
Seat 6: Yr7pZltpy3IUNdKS9PCEiw folded before Flop (didn't bet)



PokerStars Game #59942098968:  Hold'em No Limit ($1/$2) - 2009/07/01 1:56:02 ET
Table 'P/yCfYl1GfGsu/e6DxDy/A' 2-max Seat #2 is the button
Seat 1: 7fOCUy3x9hdkmXkkDNolGQ ($1104.50 in chips)
Seat 2: RwDoM55ZeQuI2ADyJhOb2Q ($362.50 in chips)
RwDoM55ZeQuI2ADyJhOb2Q: posts small blind $1
7fOCUy3x9hdkmXkkDNolGQ: posts big blind $2
*** HOLE CARDS ***
RwDoM55ZeQuI2ADyJhOb2Q: raises $4 to $6
7fOCUy3x9hdkmXkkDNolGQ: calls $4
*** FLOP *** [4s As 9c]
7fOCUy3x9hdkmXkkDNolGQ: checks
RwDoM55ZeQuI2ADyJhOb2Q: bets $8
7fOCUy3x9hdkmXkkDNolGQ: folds
RwDoM55ZeQuI2ADyJhOb2Q collected $11.50 from pot
RwDoM55ZeQuI2ADyJhOb2Q: doesn't show hand
*** SUMMARY ***
Total pot $12 | Rake $0.50
Board [4s As 9c]
Seat 1: 7fOCUy3x9hdkmXkkDNolGQ (big blind) folded on the Flop
Seat 2: RwDoM55ZeQuI2ADyJhOb2Q (button) (small blind) collected ($11.50)



PokerStars Game #59942099358:  Hold'em No Limit ($1/$2) - 2009/07/01 1:56:03 ET
Table '5/wEe6JmtGD7vufSA2RG7A' 2-max Seat #2 is the button
Seat 1: pVqEzK9wXlRMECnb1Zg4Zw ($202.80 in chips)
Seat 2: aOL8geThaYp2iadSHl1h1g ($450 in chips)
aOL8geThaYp2iadSHl1h1g: posts small blind $1
pVqEzK9wXlRMECnb1Zg4Zw: posts big blind $2
*** HOLE CARDS ***
aOL8geThaYp2iadSHl1h1g: raises $4 to $6
pVqEzK9wXlRMECnb1Zg4Zw: raises $30 to $36
aOL8geThaYp2iadSHl1h1g: folds
pVqEzK9wXlRMECnb1Zg4Zw collected $12 from pot
pVqEzK9wXlRMECnb1Zg4Zw: doesn't show hand
*** SUMMARY ***
Total pot $12 | Rake $0
Seat 1: pVqEzK9wXlRMECnb1Zg4Zw (big blind) collected ($12)
Seat 2: aOL8geThaYp2iadSHl1h1g (button) (small blind) folded before Flop



PokerStars Game #59942100134:  Hold'em No Limit ($1/$2) - 2009/07/01 1:56:05 ET
Table 'rsKRKlGHlxVyqJxzO2a2Ow' 9-max Seat #3 is the button
Seat 1: KqHysDSpCPaPyK3tJC1aEw ($209.30 in chips)
Seat 3: kM9CA+2UcdMjbCMbtUCGiA ($200 in chips)
Seat 4: 31HuO+DQxppUQEedBWukug ($134.10 in chips)
Seat 5: 5Q8U6iZbeO7xJSS4qvDP5g ($253.55 in chips)
Seat 6: H6Z4+qu8gR0VUiPOijndVg ($203 in chips)
Seat 7: GX1heJ+DSsvm7gzSPsYhhQ ($53 in chips)
Seat 8: CkE3IyJF1KvdaAOmZY5XqQ ($206.70 in chips)
Seat 9: gRbvhSUVg+TNaTjaJecIRw ($50.60 in chips)
31HuO+DQxppUQEedBWukug: posts small blind $1
5Q8U6iZbeO7xJSS4qvDP5g: posts big blind $2
254YPxPJr5Sw58bkD0YqYQ: sits out
*** HOLE CARDS ***
H6Z4+qu8gR0VUiPOijndVg: folds
GX1heJ+DSsvm7gzSPsYhhQ: folds
CkE3IyJF1KvdaAOmZY5XqQ: folds
gRbvhSUVg+TNaTjaJecIRw: raises $4 to $6
KqHysDSpCPaPyK3tJC1aEw: folds
kM9CA+2UcdMjbCMbtUCGiA: folds
31HuO+DQxppUQEedBWukug: folds
5Q8U6iZbeO7xJSS4qvDP5g: folds
gRbvhSUVg+TNaTjaJecIRw collected $5 from pot
gRbvhSUVg+TNaTjaJecIRw: doesn't show hand
*** SUMMARY ***
Total pot $5 | Rake $0
Seat 1: KqHysDSpCPaPyK3tJC1aEw folded before Flop (didn't bet)
Seat 3: kM9CA+2UcdMjbCMbtUCGiA (button) folded before Flop (didn't bet)
Seat 4: 31HuO+DQxppUQEedBWukug (small blind) folded before Flop
Seat 5: 5Q8U6iZbeO7xJSS4qvDP5g (big blind) folded before Flop
Seat 6: H6Z4+qu8gR0VUiPOijndVg folded before Flop (didn't bet)
Seat 7: GX1heJ+DSsvm7gzSPsYhhQ folded before Flop (didn't bet)
Seat 8: CkE3IyJF1KvdaAOmZY5XqQ folded before Flop (didn't bet)
Seat 9: gRbvhSUVg+TNaTjaJecIRw collected ($5)



PokerStars Game #59942102260:  Hold'em No Limit ($1/$2) - 2009/07/01 1:56:09 ET
Table 'QxerF7GUfCbl+4a8XaTB2w' 6-max Seat #5 is the button
Seat 1: ZwvXzkkZ3XpMhKfAmVpahw ($285.25 in chips)
Seat 2: 6UGgYbxwWNc+ohObe8vB9w ($82.75 in chips)
Seat 3: 8rZGabKe2DEPdZCbCivZ9Q ($22.80 in chips)
Seat 4: /PH6Ffnho4Ysm8S3V/oa+w ($50 in chips)
Seat 5: vkfxu8f/jMYKUk6Ly4eujw ($149.05 in chips)
Seat 6: VvdR9F3I+2yELkfTVvC1dg ($219.10 in chips)
VvdR9F3I+2yELkfTVvC1dg: posts small blind $1
ZwvXzkkZ3XpMhKfAmVpahw: posts big blind $2
*** HOLE CARDS ***
6UGgYbxwWNc+ohObe8vB9w: folds
8rZGabKe2DEPdZCbCivZ9Q: raises $4 to $6
/PH6Ffnho4Ysm8S3V/oa+w: folds
vkfxu8f/jMYKUk6Ly4eujw: folds
VvdR9F3I+2yELkfTVvC1dg: folds
ZwvXzkkZ3XpMhKfAmVpahw: folds
8rZGabKe2DEPdZCbCivZ9Q collected $5 from pot
8rZGabKe2DEPdZCbCivZ9Q: doesn't show hand
*** SUMMARY ***
Total pot $5 | Rake $0
Seat 1: ZwvXzkkZ3XpMhKfAmVpahw (big blind) folded before Flop
Seat 2: 6UGgYbxwWNc+ohObe8vB9w folded before Flop (didn't bet)
Seat 3: 8rZGabKe2DEPdZCbCivZ9Q collected ($5)
Seat 4: /PH6Ffnho4Ysm8S3V/oa+w folded before Flop (didn't bet)
Seat 5: vkfxu8f/jMYKUk6Ly4eujw (button) folded before Flop (didn't bet)
Seat 6: VvdR9F3I+2yELkfTVvC1dg (small blind) folded before Flop



PokerStars Game #59942102916:  Hold'em No Limit ($1/$2) - 2009/07/01 1:56:10 ET
Table 'C4lkCXY2PWy6z4vsAe5NGQ' 6-max Seat #2 is the button
Seat 1: bWbV4MVB/vVpiES1Ut4hew ($191 in chips)
Seat 2: 6hRJ68JkbJq6MYI9o5bUnQ ($112.90 in chips)
Seat 3: sTPOWERd9HWPCNrDBwsVjA ($48.50 in chips)
Seat 4: VvdR9F3I+2yELkfTVvC1dg ($204 in chips)
Seat 5: /PH6Ffnho4Ysm8S3V/oa+w ($58.65 in chips)
Seat 6: B87ikIyZ/TzAVeXf38Ny0g ($767.50 in chips)
sTPOWERd9HWPCNrDBwsVjA: posts small blind $1
VvdR9F3I+2yELkfTVvC1dg: posts big blind $2
*** HOLE CARDS ***
/PH6Ffnho4Ysm8S3V/oa+w: folds
B87ikIyZ/TzAVeXf38Ny0g: raises $4 to $6
bWbV4MVB/vVpiES1Ut4hew: raises $14 to $20
6hRJ68JkbJq6MYI9o5bUnQ: folds
sTPOWERd9HWPCNrDBwsVjA: folds
VvdR9F3I+2yELkfTVvC1dg: calls $18
B87ikIyZ/TzAVeXf38Ny0g: calls $14
*** FLOP *** [4h 3s 8s]
sTPOWERd9HWPCNrDBwsVjA leaves the table
VvdR9F3I+2yELkfTVvC1dg: checks
BWhgxe7gWiYobRbwdG+d2Q joins the table at seat #3
B87ikIyZ/TzAVeXf38Ny0g: checks
bWbV4MVB/vVpiES1Ut4hew: checks
*** TURN *** [4h 3s 8s] [3h]
VvdR9F3I+2yELkfTVvC1dg: bets $32.30
B87ikIyZ/TzAVeXf38Ny0g: folds
bWbV4MVB/vVpiES1Ut4hew: raises $138.70 to $171 and is all-in
VvdR9F3I+2yELkfTVvC1dg: calls $138.70
*** RIVER *** [4h 3s 8s 3h] [3c]
*** SHOW DOWN ***
VvdR9F3I+2yELkfTVvC1dg: shows [Qd Qs] (a full house, Threes full of Queens)
bWbV4MVB/vVpiES1Ut4hew: mucks hand
VvdR9F3I+2yELkfTVvC1dg collected $400 from pot
*** SUMMARY ***
Total pot $403 | Rake $3
Board [4h 3s 8s 3h 3c]
Seat 1: bWbV4MVB/vVpiES1Ut4hew mucked
Seat 2: 6hRJ68JkbJq6MYI9o5bUnQ (button) folded before Flop (didn't bet)
Seat 3: sTPOWERd9HWPCNrDBwsVjA (small blind) folded before Flop
Seat 4: VvdR9F3I+2yELkfTVvC1dg (big blind) showed [Qd Qs] and won ($400) with a full house, Threes full of Queens
Seat 5: /PH6Ffnho4Ysm8S3V/oa+w folded before Flop (didn't bet)
Seat 6: B87ikIyZ/TzAVeXf38Ny0g folded on the Turn



PokerStars Game #59942102756:  Hold'em No Limit ($1/$2) - 2009/07/01 1:56:10 ET
Table 'uJ9juaXXg9yIcSU8amxaXQ' 6-max Seat #4 is the button
Seat 1: JsqOjN/eHz0uYVf/PyUJ6Q ($136.15 in chips)
Seat 2: VvdR9F3I+2yELkfTVvC1dg ($217.45 in chips)
Seat 3: qXDd0ZyMIse0OBu8pxeQ3Q ($239.40 in chips)
Seat 4: zNjJ/y4emmF+vzrCDd+ooA ($266.30 in chips)
Seat 5: YsLQ3BAvgQHWXMAv3Wv6Hg ($200 in chips)
YsLQ3BAvgQHWXMAv3Wv6Hg: posts small blind $1
/PH6Ffnho4Ysm8S3V/oa+w: is sitting out
JsqOjN/eHz0uYVf/PyUJ6Q: posts big blind $2
*** HOLE CARDS ***
/PH6Ffnho4Ysm8S3V/oa+w leaves the table
VvdR9F3I+2yELkfTVvC1dg: folds
qXDd0ZyMIse0OBu8pxeQ3Q: folds
opJMdoq0E6TRbAQiweyQuA joins the table at seat #6
zNjJ/y4emmF+vzrCDd+ooA: folds
YsLQ3BAvgQHWXMAv3Wv6Hg: raises $4 to $6
JsqOjN/eHz0uYVf/PyUJ6Q: folds
YsLQ3BAvgQHWXMAv3Wv6Hg collected $4 from pot
YsLQ3BAvgQHWXMAv3Wv6Hg: doesn't show hand
*** SUMMARY ***
Total pot $4 | Rake $0
Seat 1: JsqOjN/eHz0uYVf/PyUJ6Q (big blind) folded before Flop
Seat 2: VvdR9F3I+2yELkfTVvC1dg folded before Flop (didn't bet)
Seat 3: qXDd0ZyMIse0OBu8pxeQ3Q folded before Flop (didn't bet)
Seat 4: zNjJ/y4emmF+vzrCDd+ooA (button) folded before Flop (didn't bet)
Seat 5: YsLQ3BAvgQHWXMAv3Wv6Hg (small blind) collected ($4)



PokerStars Game #59942103254:  Hold'em No Limit ($1/$2) - 2009/07/01 1:56:11 ET
Table '4NGNnZ/osQfNq6abYqkJeA' 6-max Seat #2 is the button
Seat 1: 0Bc+WhbOvaaWIMmmui3q0g ($146.10 in chips)
Seat 2: 669iGNwYwgRZg3nhS+aDAQ ($104.75 in chips)
Seat 4: sY+4Uuh5z/6AbXXaCS10jw ($295.10 in chips)
Seat 5: VvdR9F3I+2yELkfTVvC1dg ($207.80 in chips)
Seat 6: /PH6Ffnho4Ysm8S3V/oa+w ($54.20 in chips)
qXDd0ZyMIse0OBu8pxeQ3Q will be allowed to play after the button
sY+4Uuh5z/6AbXXaCS10jw: posts small blind $1
VvdR9F3I+2yELkfTVvC1dg: posts big blind $2
*** HOLE CARDS ***
/PH6Ffnho4Ysm8S3V/oa+w: folds
0Bc+WhbOvaaWIMmmui3q0g: raises $4 to $6
669iGNwYwgRZg3nhS+aDAQ: folds
sY+4Uuh5z/6AbXXaCS10jw: folds
VvdR9F3I+2yELkfTVvC1dg: folds
0Bc+WhbOvaaWIMmmui3q0g collected $5 from pot
*** SUMMARY ***
Total pot $5 | Rake $0
Seat 1: 0Bc+WhbOvaaWIMmmui3q0g collected ($5)
Seat 2: 669iGNwYwgRZg3nhS+aDAQ (button) folded before Flop (didn't bet)
Seat 4: sY+4Uuh5z/6AbXXaCS10jw (small blind) folded before Flop
Seat 5: VvdR9F3I+2yELkfTVvC1dg (big blind) folded before Flop
Seat 6: /PH6Ffnho4Ysm8S3V/oa+w folded before Flop (didn't bet)



PokerStars Game #59942104812:  Hold'em No Limit ($1/$2) - 2009/07/01 1:56:14 ET
Table 'UGLAZZyv+cXmnKjYin0etA' 6-max Seat #3 is the button
Seat 1: rL+Zpv4/vX2BVHcyfh/NXA ($208.25 in chips)
Seat 2: eDLH1PUXFpvJBNMXBVQcGA ($291.10 in chips)
Seat 3: Nsjun4mjI8q0SSBTIp1dIQ ($229 in chips)
Seat 4: SiGJDsvRViJX05vHhA80GQ ($247.75 in chips)
Seat 5: 54yWzRRgS0oZ+S6LwZBxMQ ($34.80 in chips)
Seat 6: sTPOWERd9HWPCNrDBwsVjA ($179.95 in chips)
SiGJDsvRViJX05vHhA80GQ: posts small blind $1
54yWzRRgS0oZ+S6LwZBxMQ: posts big blind $2
*** HOLE CARDS ***
sTPOWERd9HWPCNrDBwsVjA: folds
rL+Zpv4/vX2BVHcyfh/NXA: folds
eDLH1PUXFpvJBNMXBVQcGA: folds
Nsjun4mjI8q0SSBTIp1dIQ: folds
SiGJDsvRViJX05vHhA80GQ: folds
54yWzRRgS0oZ+S6LwZBxMQ collected $2 from pot
*** SUMMARY ***
Total pot $2 | Rake $0
Seat 1: rL+Zpv4/vX2BVHcyfh/NXA folded before Flop (didn't bet)
Seat 2: eDLH1PUXFpvJBNMXBVQcGA folded before Flop (didn't bet)
Seat 3: Nsjun4mjI8q0SSBTIp1dIQ (button) folded before Flop (didn't bet)
Seat 4: SiGJDsvRViJX05vHhA80GQ (small blind) folded before Flop
Seat 5: 54yWzRRgS0oZ+S6LwZBxMQ (big blind) collected ($2)
Seat 6: sTPOWERd9HWPCNrDBwsVjA folded before Flop (didn't bet)



PokerStars Game #59942105848:  Hold'em No Limit ($1/$2) - 2009/07/01 1:56:15 ET
Table 'mGpP9StWRnoeiBDExc6Frg' 6-max Seat #2 is the button
Seat 1: VvdR9F3I+2yELkfTVvC1dg ($387.25 in chips)
Seat 2: 6hRJ68JkbJq6MYI9o5bUnQ ($98 in chips)
Seat 3: mddoKnqZkdOH7AJOJ/i0DA ($200 in chips)
Seat 4: 4dcDwIHRm96PwtqkpQiuiA ($84.70 in chips)
Seat 5: d1puGuVBE0fidn+5eRJ0tw ($102.50 in chips)
Seat 6: B2Ih1sr5VZk+8He7rcrMtQ ($425.15 in chips)
mddoKnqZkdOH7AJOJ/i0DA: posts small blind $1
4dcDwIHRm96PwtqkpQiuiA: posts big blind $2
*** HOLE CARDS ***
d1puGuVBE0fidn+5eRJ0tw: folds
B2Ih1sr5VZk+8He7rcrMtQ: folds
VvdR9F3I+2yELkfTVvC1dg: raises $2 to $4
6hRJ68JkbJq6MYI9o5bUnQ: folds
mddoKnqZkdOH7AJOJ/i0DA: raises $14 to $18
4dcDwIHRm96PwtqkpQiuiA: folds
VvdR9F3I+2yELkfTVvC1dg: folds
mddoKnqZkdOH7AJOJ/i0DA collected $10 from pot
*** SUMMARY ***
Total pot $10 | Rake $0
Seat 1: VvdR9F3I+2yELkfTVvC1dg folded before Flop
Seat 2: 6hRJ68JkbJq6MYI9o5bUnQ (button) folded before Flop (didn't bet)
Seat 3: mddoKnqZkdOH7AJOJ/i0DA (small blind) collected ($10)
Seat 4: 4dcDwIHRm96PwtqkpQiuiA (big blind) folded before Flop
Seat 5: d1puGuVBE0fidn+5eRJ0tw folded before Flop (didn't bet)
Seat 6: B2Ih1sr5VZk+8He7rcrMtQ folded before Flop (didn't bet)



PokerStars Game #59942105544:  Hold'em No Limit ($1/$2) - 2009/07/01 1:56:15 ET
Table '+hSnXFQrGw1PlVgTnuj+sA' 6-max Seat #6 is the button
Seat 1: fb8ooqw9ZsZtBsZTZQLNrQ ($46.70 in chips)
Seat 2: 54yWzRRgS0oZ+S6LwZBxMQ ($38 in chips)
Seat 4: TRSUrOQh3x1NGeD+dH4yoA ($156.10 in chips)
Seat 5: PZzUwZiFNhCLi6Ouh5ZlmQ ($200 in chips)
Seat 6: 7zM38baFvmCNB/F80oE0cQ ($20.50 in chips)
fb8ooqw9ZsZtBsZTZQLNrQ: posts small blind $1
54yWzRRgS0oZ+S6LwZBxMQ: posts big blind $2
vkfxu8f/jMYKUk6Ly4eujw: sits out
*** HOLE CARDS ***
TRSUrOQh3x1NGeD+dH4yoA: folds
PZzUwZiFNhCLi6Ouh5ZlmQ: folds
7zM38baFvmCNB/F80oE0cQ: calls $2
fb8ooqw9ZsZtBsZTZQLNrQ: calls $1
54yWzRRgS0oZ+S6LwZBxMQ: checks
*** FLOP *** [4h 5d Ah]
fb8ooqw9ZsZtBsZTZQLNrQ: checks
54yWzRRgS0oZ+S6LwZBxMQ: bets $4
7zM38baFvmCNB/F80oE0cQ: folds
fb8ooqw9ZsZtBsZTZQLNrQ: calls $4
*** TURN *** [4h 5d Ah] [4c]
fb8ooqw9ZsZtBsZTZQLNrQ: bets $4
54yWzRRgS0oZ+S6LwZBxMQ: folds
fb8ooqw9ZsZtBsZTZQLNrQ collected $13.35 from pot
*** SUMMARY ***
Total pot $14 | Rake $0.65
Board [4h 5d Ah 4c]
Seat 1: fb8ooqw9ZsZtBsZTZQLNrQ (small blind) collected ($13.35)
Seat 2: 54yWzRRgS0oZ+S6LwZBxMQ (big blind) folded on the Turn
Seat 4: TRSUrOQh3x1NGeD+dH4yoA folded before Flop (didn't bet)
Seat 5: PZzUwZiFNhCLi6Ouh5ZlmQ folded before Flop (didn't bet)
Seat 6: 7zM38baFvmCNB/F80oE0cQ (button) folded on the Flop



PokerStars Game #59942105592:  Hold'em No Limit ($1/$2) - 2009/07/01 1:56:15 ET
Table 'xxAXogzmyuZKfe0LOYHaNQ' 2-max Seat #1 is the button
Seat 1: S14rjcU6LEC1LmuUtBK5Bg ($121.50 in chips)
Seat 2: ItDFe9gh5QYPQB9vC4ntUA ($200 in chips)
S14rjcU6LEC1LmuUtBK5Bg: posts small blind $1
ItDFe9gh5QYPQB9vC4ntUA: posts big blind $2
*** HOLE CARDS ***
S14rjcU6LEC1LmuUtBK5Bg: folds
ItDFe9gh5QYPQB9vC4ntUA collected $2 from pot
*** SUMMARY ***
Total pot $2 | Rake $0
Seat 1: S14rjcU6LEC1LmuUtBK5Bg (button) (small blind) folded before Flop
Seat 2: ItDFe9gh5QYPQB9vC4ntUA (big blind) collected ($2)



PokerStars Game #59942106022:  Hold'em No Limit ($1/$2) - 2009/07/01 1:56:16 ET
Table 'jlrIxbrVIG+gjaUYT4za8g' 6-max Seat #4 is the button
Seat 1: opJMdoq0E6TRbAQiweyQuA ($40 in chips)
Seat 2: cwfuMyvDC7J7SqX2leDC8g ($61 in chips)
Seat 4: 8srN1dKQePlsv0GyTada+Q ($306.80 in chips)
Seat 5: AyBB0k3Dcl7xbXUeGMw06g ($121.75 in chips)
AyBB0k3Dcl7xbXUeGMw06g: posts small blind $1
opJMdoq0E6TRbAQiweyQuA: posts big blind $2
*** HOLE CARDS ***
cwfuMyvDC7J7SqX2leDC8g: folds
3LCfF9/CuJ9+kbFOcqmuaQ said, "cite de tabarnac de voleur"
8srN1dKQePlsv0GyTada+Q: raises $4 to $6
AyBB0k3Dcl7xbXUeGMw06g: folds
opJMdoq0E6TRbAQiweyQuA: folds
8srN1dKQePlsv0GyTada+Q collected $5 from pot
*** SUMMARY ***
Total pot $5 | Rake $0
Seat 1: opJMdoq0E6TRbAQiweyQuA (big blind) folded before Flop
Seat 2: cwfuMyvDC7J7SqX2leDC8g folded before Flop (didn't bet)
Seat 4: 8srN1dKQePlsv0GyTada+Q (button) collected ($5)
Seat 5: AyBB0k3Dcl7xbXUeGMw06g (small blind) folded before Flop



PokerStars Game #59942106698:  Hold'em No Limit ($1/$2) - 2009/07/01 1:56:17 ET
Table '/8c0X14Gjd7J3pVNocAJrQ' 6-max Seat #2 is the button
Seat 1: AuiGltq875lmaKHBsjZVGg ($88.20 in chips)
Seat 2: mfy7uGZcqA2PVQqEVbJ7+g ($275.60 in chips)
Seat 3: sr/OkkgqNbtgwJf1tmnfNg ($102.30 in chips)
Seat 4: PkzV5n5qRUp0Weu8NcNNhA ($89.15 in chips)
Seat 5: /PH6Ffnho4Ysm8S3V/oa+w ($42 in chips)
Seat 6: VvdR9F3I+2yELkfTVvC1dg ($335.95 in chips)
sr/OkkgqNbtgwJf1tmnfNg: posts small blind $1
PkzV5n5qRUp0Weu8NcNNhA: posts big blind $2
*** HOLE CARDS ***
/PH6Ffnho4Ysm8S3V/oa+w: folds
VvdR9F3I+2yELkfTVvC1dg: folds
AuiGltq875lmaKHBsjZVGg: folds
mfy7uGZcqA2PVQqEVbJ7+g: folds
sr/OkkgqNbtgwJf1tmnfNg: calls $1
PkzV5n5qRUp0Weu8NcNNhA: checks
*** FLOP *** [8c 7h 3c]
sr/OkkgqNbtgwJf1tmnfNg: bets $6
PkzV5n5qRUp0Weu8NcNNhA: calls $6
*** TURN *** [8c 7h 3c] [Ad]
sr/OkkgqNbtgwJf1tmnfNg: bets $10
PkzV5n5qRUp0Weu8NcNNhA: folds
sr/OkkgqNbtgwJf1tmnfNg collected $15.25 from pot
*** SUMMARY ***
Total pot $16 | Rake $0.75
Board [8c 7h 3c Ad]
Seat 1: AuiGltq875lmaKHBsjZVGg folded before Flop (didn't bet)
Seat 2: mfy7uGZcqA2PVQqEVbJ7+g (button) folded before Flop (didn't bet)
Seat 3: sr/OkkgqNbtgwJf1tmnfNg (small blind) collected ($15.25)
Seat 4: PkzV5n5qRUp0Weu8NcNNhA (big blind) folded on the Turn
Seat 5: /PH6Ffnho4Ysm8S3V/oa+w folded before Flop (didn't bet)
Seat 6: VvdR9F3I+2yELkfTVvC1dg folded before Flop (didn't bet)



PokerStars Game #59942106580:  Hold'em No Limit ($1/$2) - 2009/07/01 1:56:17 ET
Table 'P/yCfYl1GfGsu/e6DxDy/A' 2-max Seat #1 is the button
Seat 1: 7fOCUy3x9hdkmXkkDNolGQ ($1098.50 in chips)
Seat 2: RwDoM55ZeQuI2ADyJhOb2Q ($368 in chips)
7fOCUy3x9hdkmXkkDNolGQ: posts small blind $1
RwDoM55ZeQuI2ADyJhOb2Q: posts big blind $2
*** HOLE CARDS ***
7fOCUy3x9hdkmXkkDNolGQ: raises $4 to $6
RwDoM55ZeQuI2ADyJhOb2Q: raises $6 to $12
7fOCUy3x9hdkmXkkDNolGQ: raises $32 to $44
RwDoM55ZeQuI2ADyJhOb2Q: folds
7fOCUy3x9hdkmXkkDNolGQ collected $24 from pot
7fOCUy3x9hdkmXkkDNolGQ: doesn't show hand
*** SUMMARY ***
Total pot $24 | Rake $0
Seat 1: 7fOCUy3x9hdkmXkkDNolGQ (button) (small blind) collected ($24)
Seat 2: RwDoM55ZeQuI2ADyJhOb2Q (big blind) folded before Flop



PokerStars Game #59942107892:  Hold'em No Limit ($1/$2) - 2009/07/01 1:56:19 ET
Table 'G1Oqdy4Pqdb5gtx40rUBzA' 6-max Seat #3 is the button
Seat 1: 4dMBh/1VTdeUTPCyhCs3UQ ($45.05 in chips)
Seat 2: m7mYVfnCOK5TE/VkN/FhOg ($231.75 in chips)
Seat 3: VvdR9F3I+2yELkfTVvC1dg ($415.90 in chips)
Seat 4: B87ikIyZ/TzAVeXf38Ny0g ($200 in chips)
Seat 5: F1+Ml47qRQWunzPnGhLLzQ ($227.15 in chips)
Seat 6: qCnEYuAE5y5A7bk6fO5/jQ ($200 in chips)
B87ikIyZ/TzAVeXf38Ny0g: posts small blind $1
F1+Ml47qRQWunzPnGhLLzQ: posts big blind $2
*** HOLE CARDS ***
qCnEYuAE5y5A7bk6fO5/jQ: raises $4 to $6
4dMBh/1VTdeUTPCyhCs3UQ: folds
m7mYVfnCOK5TE/VkN/FhOg: folds
VvdR9F3I+2yELkfTVvC1dg: folds
B87ikIyZ/TzAVeXf38Ny0g: folds
F1+Ml47qRQWunzPnGhLLzQ: folds
qCnEYuAE5y5A7bk6fO5/jQ collected $5 from pot
qCnEYuAE5y5A7bk6fO5/jQ: doesn't show hand
*** SUMMARY ***
Total pot $5 | Rake $0
Seat 1: 4dMBh/1VTdeUTPCyhCs3UQ folded before Flop (didn't bet)
Seat 2: m7mYVfnCOK5TE/VkN/FhOg folded before Flop (didn't bet)
Seat 3: VvdR9F3I+2yELkfTVvC1dg (button) folded before Flop (didn't bet)
Seat 4: B87ikIyZ/TzAVeXf38Ny0g (small blind) folded before Flop
Seat 5: F1+Ml47qRQWunzPnGhLLzQ (big blind) folded before Flop
Seat 6: qCnEYuAE5y5A7bk6fO5/jQ collected ($5)



PokerStars Game #59942107494:  Hold'em No Limit ($1/$2) - 2009/07/01 1:56:19 ET
Table '7goFpXy7qyiK5mwx+Ucf6A' 6-max Seat #6 is the button
Seat 1: VHmJJYp7TGQwcWROQ8dqXw ($45.10 in chips)
Seat 2: BWhgxe7gWiYobRbwdG+d2Q ($196 in chips)
Seat 3: mfy7uGZcqA2PVQqEVbJ7+g ($149.25 in chips)
Seat 4: fE+LHW/7rpfXW14g8LhGjA ($48.40 in chips)
Seat 6: VvdR9F3I+2yELkfTVvC1dg ($212.65 in chips)
VHmJJYp7TGQwcWROQ8dqXw: posts small blind $1
BWhgxe7gWiYobRbwdG+d2Q: posts big blind $2
vkfxu8f/jMYKUk6Ly4eujw: sits out
*** HOLE CARDS ***
mfy7uGZcqA2PVQqEVbJ7+g: folds
fE+LHW/7rpfXW14g8LhGjA: calls $2
VvdR9F3I+2yELkfTVvC1dg: folds
VHmJJYp7TGQwcWROQ8dqXw: calls $1
BWhgxe7gWiYobRbwdG+d2Q: checks
*** FLOP *** [3c 7h 6s]
VHmJJYp7TGQwcWROQ8dqXw: bets $2
BWhgxe7gWiYobRbwdG+d2Q: calls $2
fE+LHW/7rpfXW14g8LhGjA: calls $2
*** TURN *** [3c 7h 6s] [Js]
VHmJJYp7TGQwcWROQ8dqXw: bets $2
BWhgxe7gWiYobRbwdG+d2Q: folds
fE+LHW/7rpfXW14g8LhGjA: folds
VHmJJYp7TGQwcWROQ8dqXw collected $11.45 from pot
VHmJJYp7TGQwcWROQ8dqXw: doesn't show hand
*** SUMMARY ***
Total pot $12 | Rake $0.55
Board [3c 7h 6s Js]
Seat 1: VHmJJYp7TGQwcWROQ8dqXw (small blind) collected ($11.45)
Seat 2: BWhgxe7gWiYobRbwdG+d2Q (big blind) folded on the Turn
Seat 3: mfy7uGZcqA2PVQqEVbJ7+g folded before Flop (didn't bet)
Seat 4: fE+LHW/7rpfXW14g8LhGjA folded on the Turn
Seat 6: VvdR9F3I+2yELkfTVvC1dg (button) folded before Flop (didn't bet)



PokerStars Game #59942107500:  Hold'em No Limit ($1/$2) - 2009/07/01 1:56:19 ET
Table 'W9UeSV0aoPjh5SFSxM8jUQ' 9-max Seat #6 is the button
Seat 1: mIKx5lhIt13X5eZQH0ZeMA ($6.85 in chips)
Seat 2: KqHysDSpCPaPyK3tJC1aEw ($207.05 in chips)
Seat 3: ItDFe9gh5QYPQB9vC4ntUA ($203 in chips)
Seat 4: 4YA/sQy1Emm680zhbPUjow ($149.60 in chips)
Seat 6: 254YPxPJr5Sw58bkD0YqYQ ($213.70 in chips)
Seat 7: TAfo4veNRaRlzDXMMYS3Jg ($37 in chips)
Seat 8: odhvI/CZeMsPyo1n1U7+hA ($49.10 in chips)
Seat 9: Q104K4iDGcqOlVrjAkzPEA ($99.30 in chips)
TAfo4veNRaRlzDXMMYS3Jg: posts small blind $1
odhvI/CZeMsPyo1n1U7+hA: posts big blind $2
ZYHoLw2lWmRS7CSHi8L8Xg: sits out
*** HOLE CARDS ***
Q104K4iDGcqOlVrjAkzPEA: folds
mIKx5lhIt13X5eZQH0ZeMA: folds
KqHysDSpCPaPyK3tJC1aEw: folds
ItDFe9gh5QYPQB9vC4ntUA: folds
4YA/sQy1Emm680zhbPUjow: folds
254YPxPJr5Sw58bkD0YqYQ: folds
TAfo4veNRaRlzDXMMYS3Jg: raises $35 to $37 and is all-in
odhvI/CZeMsPyo1n1U7+hA: folds
TAfo4veNRaRlzDXMMYS3Jg collected $4 from pot
*** SUMMARY ***
Total pot $4 | Rake $0
Seat 1: mIKx5lhIt13X5eZQH0ZeMA folded before Flop (didn't bet)
Seat 2: KqHysDSpCPaPyK3tJC1aEw folded before Flop (didn't bet)
Seat 3: ItDFe9gh5QYPQB9vC4ntUA folded before Flop (didn't bet)
Seat 4: 4YA/sQy1Emm680zhbPUjow folded before Flop (didn't bet)
Seat 6: 254YPxPJr5Sw58bkD0YqYQ (button) folded before Flop (didn't bet)
Seat 7: TAfo4veNRaRlzDXMMYS3Jg (small blind) collected ($4)
Seat 8: odhvI/CZeMsPyo1n1U7+hA (big blind) folded before Flop
Seat 9: Q104K4iDGcqOlVrjAkzPEA folded before Flop (didn't bet)



PokerStars Game #59942107986:  Hold'em No Limit ($1/$2) - 2009/07/01 1:56:20 ET
Table 'eyAQSIlgc2o1Jxvbve4WGg' 9-max Seat #9 is the button
Seat 1: UZEsV9yKUMqmpYPiOFpaZw ($71 in chips)
Seat 2: kM9CA+2UcdMjbCMbtUCGiA ($221.05 in chips)
Seat 4: CkE3IyJF1KvdaAOmZY5XqQ ($200 in chips)
Seat 5: mIKx5lhIt13X5eZQH0ZeMA ($146.75 in chips)
Seat 7: u3OrI5uGx9mx1fE7dgr+EA ($104.80 in chips)
Seat 8: 254YPxPJr5Sw58bkD0YqYQ ($207 in chips)
Seat 9: WUlHm+ydPPHG7Lb0rePSdA ($122.20 in chips)
UZEsV9yKUMqmpYPiOFpaZw: posts small blind $1
kM9CA+2UcdMjbCMbtUCGiA: posts big blind $2
ice1Sbe19zWIaKYoSmE5tw: sits out
*** HOLE CARDS ***
CkE3IyJF1KvdaAOmZY5XqQ: folds
mIKx5lhIt13X5eZQH0ZeMA: folds
u3OrI5uGx9mx1fE7dgr+EA: folds
254YPxPJr5Sw58bkD0YqYQ: raises $4 to $6
WUlHm+ydPPHG7Lb0rePSdA: folds
UZEsV9yKUMqmpYPiOFpaZw: folds
kM9CA+2UcdMjbCMbtUCGiA: raises $14 to $20
254YPxPJr5Sw58bkD0YqYQ: folds
kM9CA+2UcdMjbCMbtUCGiA collected $13 from pot
kM9CA+2UcdMjbCMbtUCGiA: doesn't show hand
*** SUMMARY ***
Total pot $13 | Rake $0
Seat 1: UZEsV9yKUMqmpYPiOFpaZw (small blind) folded before Flop
Seat 2: kM9CA+2UcdMjbCMbtUCGiA (big blind) collected ($13)
Seat 4: CkE3IyJF1KvdaAOmZY5XqQ folded before Flop (didn't bet)
Seat 5: mIKx5lhIt13X5eZQH0ZeMA folded before Flop (didn't bet)
Seat 7: u3OrI5uGx9mx1fE7dgr+EA folded before Flop (didn't bet)
Seat 8: 254YPxPJr5Sw58bkD0YqYQ folded before Flop
Seat 9: WUlHm+ydPPHG7Lb0rePSdA (button) folded before Flop (didn't bet)



PokerStars Game #59942109058:  Hold'em No Limit ($1/$2) - 2009/07/01 1:56:22 ET
Table 'xxAXogzmyuZKfe0LOYHaNQ' 2-max Seat #2 is the button
Seat 1: S14rjcU6LEC1LmuUtBK5Bg ($120.50 in chips)
Seat 2: ItDFe9gh5QYPQB9vC4ntUA ($201 in chips)
ItDFe9gh5QYPQB9vC4ntUA: posts small blind $1
S14rjcU6LEC1LmuUtBK5Bg: posts big blind $2
*** HOLE CARDS ***
ItDFe9gh5QYPQB9vC4ntUA: raises $2 to $4
S14rjcU6LEC1LmuUtBK5Bg: calls $2
*** FLOP *** [Kd 2d As]
S14rjcU6LEC1LmuUtBK5Bg: checks
ItDFe9gh5QYPQB9vC4ntUA: bets $6
S14rjcU6LEC1LmuUtBK5Bg: folds
ItDFe9gh5QYPQB9vC4ntUA collected $7.60 from pot
*** SUMMARY ***
Total pot $8 | Rake $0.40
Board [Kd 2d As]
Seat 1: S14rjcU6LEC1LmuUtBK5Bg (big blind) folded on the Flop
Seat 2: ItDFe9gh5QYPQB9vC4ntUA (button) (small blind) collected ($7.60)



PokerStars Game #59942110558:  Hold'em No Limit ($1/$2) - 2009/07/01 1:56:24 ET
Table 'NmY84NAf9Mh0ckAckHnh5g' 2-max Seat #2 is the button
Seat 1: 6hvg964TSqZ3AL/0XK9aVQ ($421.70 in chips)
Seat 2: RwDoM55ZeQuI2ADyJhOb2Q ($555.80 in chips)
RwDoM55ZeQuI2ADyJhOb2Q: posts small blind $1
6hvg964TSqZ3AL/0XK9aVQ: posts big blind $2
*** HOLE CARDS ***
RwDoM55ZeQuI2ADyJhOb2Q: raises $4 to $6
6hvg964TSqZ3AL/0XK9aVQ: folds
RwDoM55ZeQuI2ADyJhOb2Q collected $4 from pot
RwDoM55ZeQuI2ADyJhOb2Q: doesn't show hand
*** SUMMARY ***
Total pot $4 | Rake $0
Seat 1: 6hvg964TSqZ3AL/0XK9aVQ (big blind) folded before Flop
Seat 2: RwDoM55ZeQuI2ADyJhOb2Q (button) (small blind) collected ($4)



PokerStars Game #59942110550:  Hold'em No Limit ($1/$2) - 2009/07/01 1:56:24 ET
Table 'ZzSIe0zTCDv+n6hfbY5tTg' 6-max Seat #5 is the button
Seat 1: VvdR9F3I+2yELkfTVvC1dg ($288.65 in chips)
Seat 2: B87ikIyZ/TzAVeXf38Ny0g ($216 in chips)
Seat 3: gsugPj31Hui3Jefl98MBOA ($349.35 in chips)
Seat 4: 54yWzRRgS0oZ+S6LwZBxMQ ($49.10 in chips)
Seat 5: 3dAbvkxS5NPQTBAbvpinVg ($478.45 in chips)
Seat 6: 09BNF4quPDzanQzM8vc6WA ($35.55 in chips)
09BNF4quPDzanQzM8vc6WA: posts small blind $1
VvdR9F3I+2yELkfTVvC1dg: posts big blind $2
*** HOLE CARDS ***
B87ikIyZ/TzAVeXf38Ny0g: folds
gsugPj31Hui3Jefl98MBOA: folds
54yWzRRgS0oZ+S6LwZBxMQ: folds
3dAbvkxS5NPQTBAbvpinVg: raises $4 to $6
09BNF4quPDzanQzM8vc6WA: folds
VvdR9F3I+2yELkfTVvC1dg: folds
3dAbvkxS5NPQTBAbvpinVg collected $5 from pot
3dAbvkxS5NPQTBAbvpinVg: doesn't show hand
*** SUMMARY ***
Total pot $5 | Rake $0
Seat 1: VvdR9F3I+2yELkfTVvC1dg (big blind) folded before Flop
Seat 2: B87ikIyZ/TzAVeXf38Ny0g folded before Flop (didn't bet)
Seat 3: gsugPj31Hui3Jefl98MBOA folded before Flop (didn't bet)
Seat 4: 54yWzRRgS0oZ+S6LwZBxMQ folded before Flop (didn't bet)
Seat 5: 3dAbvkxS5NPQTBAbvpinVg (button) collected ($5)
Seat 6: 09BNF4quPDzanQzM8vc6WA (small blind) folded before Flop



PokerStars Game #59942110866:  Hold'em No Limit ($1/$2) - 2009/07/01 1:56:25 ET
Table '5/wEe6JmtGD7vufSA2RG7A' 2-max Seat #1 is the button
Seat 1: pVqEzK9wXlRMECnb1Zg4Zw ($208.80 in chips)
Seat 2: aOL8geThaYp2iadSHl1h1g ($444 in chips)
pVqEzK9wXlRMECnb1Zg4Zw: posts small blind $1
aOL8geThaYp2iadSHl1h1g: posts big blind $2
*** HOLE CARDS ***
pVqEzK9wXlRMECnb1Zg4Zw: raises $10 to $12
aOL8geThaYp2iadSHl1h1g: folds
pVqEzK9wXlRMECnb1Zg4Zw collected $4 from pot
pVqEzK9wXlRMECnb1Zg4Zw: doesn't show hand
*** SUMMARY ***
Total pot $4 | Rake $0
Seat 1: pVqEzK9wXlRMECnb1Zg4Zw (button) (small blind) collected ($4)
Seat 2: aOL8geThaYp2iadSHl1h1g (big blind) folded before Flop



PokerStars Game #59942111710:  Hold'em No Limit ($1/$2) - 2009/07/01 1:56:27 ET
Table 'WCA60bDA8ecovUgFSIZkTQ' 9-max Seat #8 is the button
Seat 1: 3RFwE6igZ1BGKOGuab6iiw ($73 in chips)
Seat 2: TAfo4veNRaRlzDXMMYS3Jg ($37 in chips)
Seat 3: g7gL2NLJCdZPPV399WKT1w ($54.95 in chips)
Seat 4: IYBKVnE2Basnr88BAhH+bQ ($202.80 in chips)
Seat 5: A+9gcmwAl0eFxxbAwRY1OA ($246.10 in chips)
Seat 6: YoKKKdDDs7gFzP1Z65Sdaw ($96 in chips)
Seat 7: tsTv4D+ne2W0qhUt9HlcMw ($205.65 in chips)
Seat 8: mJhwEVg7F695DiO+RIhM5g ($244.45 in chips)
Seat 9: ItDFe9gh5QYPQB9vC4ntUA ($200 in chips)
ItDFe9gh5QYPQB9vC4ntUA: posts small blind $1
3RFwE6igZ1BGKOGuab6iiw: posts big blind $2
*** HOLE CARDS ***
TAfo4veNRaRlzDXMMYS3Jg: folds
g7gL2NLJCdZPPV399WKT1w: folds
IYBKVnE2Basnr88BAhH+bQ: folds
A+9gcmwAl0eFxxbAwRY1OA: folds
YoKKKdDDs7gFzP1Z65Sdaw: calls $2
tsTv4D+ne2W0qhUt9HlcMw: folds
mJhwEVg7F695DiO+RIhM5g: calls $2
ItDFe9gh5QYPQB9vC4ntUA: folds
3RFwE6igZ1BGKOGuab6iiw: checks
*** FLOP *** [8h 5d 3h]
3RFwE6igZ1BGKOGuab6iiw: bets $4
YoKKKdDDs7gFzP1Z65Sdaw: folds
mJhwEVg7F695DiO+RIhM5g: folds
3RFwE6igZ1BGKOGuab6iiw collected $6.65 from pot
*** SUMMARY ***
Total pot $7 | Rake $0.35
Board [8h 5d 3h]
Seat 1: 3RFwE6igZ1BGKOGuab6iiw (big blind) collected ($6.65)
Seat 2: TAfo4veNRaRlzDXMMYS3Jg folded before Flop (didn't bet)
Seat 3: g7gL2NLJCdZPPV399WKT1w folded before Flop (didn't bet)
Seat 4: IYBKVnE2Basnr88BAhH+bQ folded before Flop (didn't bet)
Seat 5: A+9gcmwAl0eFxxbAwRY1OA folded before Flop (didn't bet)
Seat 6: YoKKKdDDs7gFzP1Z65Sdaw folded on the Flop
Seat 7: tsTv4D+ne2W0qhUt9HlcMw folded before Flop (didn't bet)
Seat 8: mJhwEVg7F695DiO+RIhM5g (button) folded on the Flop
Seat 9: ItDFe9gh5QYPQB9vC4ntUA (small blind) folded before Flop



PokerStars Game #59942112828:  Hold'em No Limit ($1/$2) - 2009/07/01 1:56:29 ET
Table '/dyk+YdRGv90j2box35j8w' 6-max Seat #5 is the button
Seat 2: qCnEYuAE5y5A7bk6fO5/jQ ($491.20 in chips)
Seat 3: sTPOWERd9HWPCNrDBwsVjA ($212.50 in chips)
Seat 4: 4dMBh/1VTdeUTPCyhCs3UQ ($88.95 in chips)
Seat 5: VvdR9F3I+2yELkfTVvC1dg ($295.35 in chips)
Seat 6: C3qJBo7uxfFVDluE1lmK2w ($90.25 in chips)
C3qJBo7uxfFVDluE1lmK2w: posts small blind $1
qCnEYuAE5y5A7bk6fO5/jQ: posts big blind $2
*** HOLE CARDS ***
sTPOWERd9HWPCNrDBwsVjA: raises $6 to $8
4dMBh/1VTdeUTPCyhCs3UQ: folds
VvdR9F3I+2yELkfTVvC1dg: folds
C3qJBo7uxfFVDluE1lmK2w: folds
qCnEYuAE5y5A7bk6fO5/jQ: folds
sTPOWERd9HWPCNrDBwsVjA collected $5 from pot
*** SUMMARY ***
Total pot $5 | Rake $0
Seat 2: qCnEYuAE5y5A7bk6fO5/jQ (big blind) folded before Flop
Seat 3: sTPOWERd9HWPCNrDBwsVjA collected ($5)
Seat 4: 4dMBh/1VTdeUTPCyhCs3UQ folded before Flop (didn't bet)
Seat 5: VvdR9F3I+2yELkfTVvC1dg (button) folded before Flop (didn't bet)
Seat 6: C3qJBo7uxfFVDluE1lmK2w (small blind) folded before Flop



PokerStars Game #59942113236:  Hold'em No Limit ($1/$2) - 2009/07/01 1:56:30 ET
Table '3WCXyaiCAbqSShQu7FIjvA' 9-max Seat #1 is the button
Seat 1: kTCkABD1UUldS9DFRGfCwQ ($137.55 in chips)
Seat 2: 254YPxPJr5Sw58bkD0YqYQ ($200 in chips)
Seat 3: 5Q8U6iZbeO7xJSS4qvDP5g ($247.25 in chips)
Seat 4: waEF/+pxZTxNo4FvsORuXg ($101.40 in chips)
Seat 5: CkE3IyJF1KvdaAOmZY5XqQ ($207.90 in chips)
Seat 6: 5jQlngvMSqM/WoonOcR5kw ($277.50 in chips)
Seat 8: +T/63sAeZzWyHchahJ36GQ ($34 in chips)
Seat 9: FiXPLJyqb24l32QST2TInw ($138 in chips)
254YPxPJr5Sw58bkD0YqYQ: posts small blind $1
5Q8U6iZbeO7xJSS4qvDP5g: posts big blind $2
*** HOLE CARDS ***
waEF/+pxZTxNo4FvsORuXg: folds
CkE3IyJF1KvdaAOmZY5XqQ: folds
5jQlngvMSqM/WoonOcR5kw: folds
+T/63sAeZzWyHchahJ36GQ: folds
FiXPLJyqb24l32QST2TInw: folds
kTCkABD1UUldS9DFRGfCwQ: calls $2
254YPxPJr5Sw58bkD0YqYQ: calls $1
5Q8U6iZbeO7xJSS4qvDP5g: checks
*** FLOP *** [Js 4c 6h]
254YPxPJr5Sw58bkD0YqYQ: checks
5Q8U6iZbeO7xJSS4qvDP5g: checks
kTCkABD1UUldS9DFRGfCwQ: bets $4
254YPxPJr5Sw58bkD0YqYQ: folds
5Q8U6iZbeO7xJSS4qvDP5g: folds
kTCkABD1UUldS9DFRGfCwQ collected $5.70 from pot
kTCkABD1UUldS9DFRGfCwQ: doesn't show hand
*** SUMMARY ***
Total pot $6 | Rake $0.30
Board [Js 4c 6h]
Seat 1: kTCkABD1UUldS9DFRGfCwQ (button) collected ($5.70)
Seat 2: 254YPxPJr5Sw58bkD0YqYQ (small blind) folded on the Flop
Seat 3: 5Q8U6iZbeO7xJSS4qvDP5g (big blind) folded on the Flop
Seat 4: waEF/+pxZTxNo4FvsORuXg folded before Flop (didn't bet)
Seat 5: CkE3IyJF1KvdaAOmZY5XqQ folded before Flop (didn't bet)
Seat 6: 5jQlngvMSqM/WoonOcR5kw folded before Flop (didn't bet)
Seat 8: +T/63sAeZzWyHchahJ36GQ folded before Flop (didn't bet)
Seat 9: FiXPLJyqb24l32QST2TInw folded before Flop (didn't bet)



PokerStars Game #59942113558:  Hold'em No Limit ($1/$2) - 2009/07/01 1:56:31 ET
Table 'bIihwBANJSFqlHPPtset+w' 9-max Seat #2 is the button
Seat 1: KqHysDSpCPaPyK3tJC1aEw ($223.25 in chips)
Seat 2: lQYT23h5QCUVZAKxjOO39Q ($204.20 in chips)
Seat 3: 6MRmKcp6RorxqG+mA3KeAw ($171 in chips)
Seat 4: XmmQKhdZdYwJP9Bfu+Qfuw ($190 in chips)
Seat 5: vxbbJLsS1bva6tW2NiFssg ($200 in chips)
Seat 6: CkE3IyJF1KvdaAOmZY5XqQ ($233.15 in chips)
Seat 7: pCmk6FpSOLJ+85o1tLHIag ($137.30 in chips)
Seat 8: 254YPxPJr5Sw58bkD0YqYQ ($200 in chips)
Seat 9: kM9CA+2UcdMjbCMbtUCGiA ($200 in chips)
6MRmKcp6RorxqG+mA3KeAw: posts small blind $1
XmmQKhdZdYwJP9Bfu+Qfuw: posts big blind $2
*** HOLE CARDS ***
vxbbJLsS1bva6tW2NiFssg: folds
CkE3IyJF1KvdaAOmZY5XqQ: raises $6 to $8
pCmk6FpSOLJ+85o1tLHIag: folds
254YPxPJr5Sw58bkD0YqYQ: folds
kM9CA+2UcdMjbCMbtUCGiA: folds
KqHysDSpCPaPyK3tJC1aEw: folds
lQYT23h5QCUVZAKxjOO39Q: folds
6MRmKcp6RorxqG+mA3KeAw: calls $7
XmmQKhdZdYwJP9Bfu+Qfuw: folds
*** FLOP *** [Tc Ah 3c]
6MRmKcp6RorxqG+mA3KeAw: bets $8
CkE3IyJF1KvdaAOmZY5XqQ: raises $14 to $22
6MRmKcp6RorxqG+mA3KeAw: calls $14
*** TURN *** [Tc Ah 3c] [2h]
6MRmKcp6RorxqG+mA3KeAw: bets $18
CkE3IyJF1KvdaAOmZY5XqQ: raises $28 to $46
6MRmKcp6RorxqG+mA3KeAw: calls $28
*** RIVER *** [Tc Ah 3c 2h] [Qh]
6MRmKcp6RorxqG+mA3KeAw: checks
CkE3IyJF1KvdaAOmZY5XqQ: bets $157.15 and is all-in
6MRmKcp6RorxqG+mA3KeAw: calls $95 and is all-in
*** SHOW DOWN ***
CkE3IyJF1KvdaAOmZY5XqQ: shows [3s 3h] (three of a kind, Threes)
6MRmKcp6RorxqG+mA3KeAw: mucks hand
CkE3IyJF1KvdaAOmZY5XqQ collected $341 from pot
*** SUMMARY ***
Total pot $344 | Rake $3
Board [Tc Ah 3c 2h Qh]
Seat 1: KqHysDSpCPaPyK3tJC1aEw folded before Flop (didn't bet)
Seat 2: lQYT23h5QCUVZAKxjOO39Q (button) folded before Flop (didn't bet)
Seat 3: 6MRmKcp6RorxqG+mA3KeAw (small blind) mucked
Seat 4: XmmQKhdZdYwJP9Bfu+Qfuw (big blind) folded before Flop
Seat 5: vxbbJLsS1bva6tW2NiFssg folded before Flop (didn't bet)
Seat 6: CkE3IyJF1KvdaAOmZY5XqQ showed [3s 3h] and won ($341) with three of a kind, Threes
Seat 7: pCmk6FpSOLJ+85o1tLHIag folded before Flop (didn't bet)
Seat 8: 254YPxPJr5Sw58bkD0YqYQ folded before Flop (didn't bet)
Seat 9: kM9CA+2UcdMjbCMbtUCGiA folded before Flop (didn't bet)



PokerStars Game #59942114230:  Hold'em No Limit ($1/$2) - 2009/07/01 1:56:32 ET
Table 'NmY84NAf9Mh0ckAckHnh5g' 2-max Seat #1 is the button
Seat 1: 6hvg964TSqZ3AL/0XK9aVQ ($419.70 in chips)
Seat 2: RwDoM55ZeQuI2ADyJhOb2Q ($557.80 in chips)
6hvg964TSqZ3AL/0XK9aVQ: posts small blind $1
RwDoM55ZeQuI2ADyJhOb2Q: posts big blind $2
*** HOLE CARDS ***
6hvg964TSqZ3AL/0XK9aVQ: calls $1
RwDoM55ZeQuI2ADyJhOb2Q: checks
*** FLOP *** [6h 9s Kd]
RwDoM55ZeQuI2ADyJhOb2Q: checks
6hvg964TSqZ3AL/0XK9aVQ: checks
*** TURN *** [6h 9s Kd] [9d]
RwDoM55ZeQuI2ADyJhOb2Q: checks
6hvg964TSqZ3AL/0XK9aVQ: checks
*** RIVER *** [6h 9s Kd 9d] [8s]
RwDoM55ZeQuI2ADyJhOb2Q: checks
6hvg964TSqZ3AL/0XK9aVQ: bets $6
RwDoM55ZeQuI2ADyJhOb2Q: calls $6
*** SHOW DOWN ***
6hvg964TSqZ3AL/0XK9aVQ: shows [7d 5h] (a straight, Five to Nine)
RwDoM55ZeQuI2ADyJhOb2Q: mucks hand
6hvg964TSqZ3AL/0XK9aVQ collected $15.50 from pot
*** SUMMARY ***
Total pot $16 | Rake $0.50
Board [6h 9s Kd 9d 8s]
Seat 1: 6hvg964TSqZ3AL/0XK9aVQ (button) (small blind) showed [7d 5h] and won ($15.50) with a straight, Five to Nine
Seat 2: RwDoM55ZeQuI2ADyJhOb2Q (big blind) mucked



PokerStars Game #59942115076:  Hold'em No Limit ($1/$2) - 2009/07/01 1:56:34 ET
Table 'LL4bDFyhj5hsMpzaDugJZg' 6-max Seat #2 is the button
Seat 1: ubtx4Z5L+AcK71MTvYiGVw ($200 in chips)
Seat 2: TMPDCBmlFGM9C+H58PC4sQ ($43.15 in chips)
Seat 3: opJMdoq0E6TRbAQiweyQuA ($38 in chips)
Seat 4: 8srN1dKQePlsv0GyTada+Q ($387.85 in chips)
Seat 5: on4ebXPJvUBOcHOBMQsRSg ($77.35 in chips)
Seat 6: mddoKnqZkdOH7AJOJ/i0DA ($209.30 in chips)
opJMdoq0E6TRbAQiweyQuA: posts small blind $1
8srN1dKQePlsv0GyTada+Q: posts big blind $2
*** HOLE CARDS ***
on4ebXPJvUBOcHOBMQsRSg: folds
on4ebXPJvUBOcHOBMQsRSg leaves the table
mddoKnqZkdOH7AJOJ/i0DA: folds
ubtx4Z5L+AcK71MTvYiGVw: folds
TMPDCBmlFGM9C+H58PC4sQ: calls $2
opJMdoq0E6TRbAQiweyQuA: folds
8srN1dKQePlsv0GyTada+Q: checks
*** FLOP *** [3d 3h As]
SZwM+UmIX32Re10mzQ4w/w joins the table at seat #5
8srN1dKQePlsv0GyTada+Q: checks
TMPDCBmlFGM9C+H58PC4sQ: checks
*** TURN *** [3d 3h As] [Kc]
8srN1dKQePlsv0GyTada+Q: checks
TMPDCBmlFGM9C+H58PC4sQ: checks
*** RIVER *** [3d 3h As Kc] [Qh]
8srN1dKQePlsv0GyTada+Q: checks
TMPDCBmlFGM9C+H58PC4sQ: checks
*** SHOW DOWN ***
8srN1dKQePlsv0GyTada+Q: shows [4h Qs] (two pair, Queens and Threes)
TMPDCBmlFGM9C+H58PC4sQ: mucks hand
8srN1dKQePlsv0GyTada+Q collected $4.75 from pot
*** SUMMARY ***
Total pot $5 | Rake $0.25
Board [3d 3h As Kc Qh]
Seat 1: ubtx4Z5L+AcK71MTvYiGVw folded before Flop (didn't bet)
Seat 2: TMPDCBmlFGM9C+H58PC4sQ (button) mucked
Seat 3: opJMdoq0E6TRbAQiweyQuA (small blind) folded before Flop
Seat 4: 8srN1dKQePlsv0GyTada+Q (big blind) showed [4h Qs] and won ($4.75) with two pair, Queens and Threes
Seat 5: on4ebXPJvUBOcHOBMQsRSg folded before Flop (didn't bet)
Seat 6: mddoKnqZkdOH7AJOJ/i0DA folded before Flop (didn't bet)



PokerStars Game #59942115608:  Hold'em No Limit ($1/$2) - 2009/07/01 1:56:35 ET
Table 'QxerF7GUfCbl+4a8XaTB2w' 6-max Seat #6 is the button
Seat 1: ZwvXzkkZ3XpMhKfAmVpahw ($283.25 in chips)
Seat 2: 6UGgYbxwWNc+ohObe8vB9w ($82.75 in chips)
Seat 3: 8rZGabKe2DEPdZCbCivZ9Q ($25.80 in chips)
Seat 4: /PH6Ffnho4Ysm8S3V/oa+w ($50 in chips)
Seat 5: vkfxu8f/jMYKUk6Ly4eujw ($149.05 in chips)
Seat 6: VvdR9F3I+2yELkfTVvC1dg ($218.10 in chips)
ZwvXzkkZ3XpMhKfAmVpahw: posts small blind $1
6UGgYbxwWNc+ohObe8vB9w: posts big blind $2
*** HOLE CARDS ***
8rZGabKe2DEPdZCbCivZ9Q: folds
/PH6Ffnho4Ysm8S3V/oa+w: raises $2 to $4
vkfxu8f/jMYKUk6Ly4eujw: folds
VvdR9F3I+2yELkfTVvC1dg: folds
ZwvXzkkZ3XpMhKfAmVpahw: folds
6UGgYbxwWNc+ohObe8vB9w: calls $2
*** FLOP *** [7s 9c 8s]
6UGgYbxwWNc+ohObe8vB9w: checks
/PH6Ffnho4Ysm8S3V/oa+w: checks
*** TURN *** [7s 9c 8s] [4s]
6UGgYbxwWNc+ohObe8vB9w: checks
/PH6Ffnho4Ysm8S3V/oa+w: checks
*** RIVER *** [7s 9c 8s 4s] [7c]
6UGgYbxwWNc+ohObe8vB9w: bets $4
/PH6Ffnho4Ysm8S3V/oa+w: folds
6UGgYbxwWNc+ohObe8vB9w collected $8.55 from pot
*** SUMMARY ***
Total pot $9 | Rake $0.45
Board [7s 9c 8s 4s 7c]
Seat 1: ZwvXzkkZ3XpMhKfAmVpahw (small blind) folded before Flop
Seat 2: 6UGgYbxwWNc+ohObe8vB9w (big blind) collected ($8.55)
Seat 3: 8rZGabKe2DEPdZCbCivZ9Q folded before Flop (didn't bet)
Seat 4: /PH6Ffnho4Ysm8S3V/oa+w folded on the River
Seat 5: vkfxu8f/jMYKUk6Ly4eujw folded before Flop (didn't bet)
Seat 6: VvdR9F3I+2yELkfTVvC1dg (button) folded before Flop (didn't bet)



PokerStars Game #59942115544:  Hold'em No Limit ($1/$2) - 2009/07/01 1:56:35 ET
Table '4NGNnZ/osQfNq6abYqkJeA' 6-max Seat #4 is the button
Seat 1: 0Bc+WhbOvaaWIMmmui3q0g ($149.10 in chips)
Seat 2: 669iGNwYwgRZg3nhS+aDAQ ($104.75 in chips)
Seat 4: sY+4Uuh5z/6AbXXaCS10jw ($294.10 in chips)
Seat 5: VvdR9F3I+2yELkfTVvC1dg ($205.80 in chips)
Seat 6: /PH6Ffnho4Ysm8S3V/oa+w ($54.20 in chips)
VvdR9F3I+2yELkfTVvC1dg: posts small blind $1
/PH6Ffnho4Ysm8S3V/oa+w: posts big blind $2
qXDd0ZyMIse0OBu8pxeQ3Q: sits out
*** HOLE CARDS ***
0Bc+WhbOvaaWIMmmui3q0g: folds
669iGNwYwgRZg3nhS+aDAQ: folds
sY+4Uuh5z/6AbXXaCS10jw: folds
VvdR9F3I+2yELkfTVvC1dg: raises $2 to $4
/PH6Ffnho4Ysm8S3V/oa+w: folds
VvdR9F3I+2yELkfTVvC1dg collected $4 from pot
VvdR9F3I+2yELkfTVvC1dg: doesn't show hand
*** SUMMARY ***
Total pot $4 | Rake $0
Seat 1: 0Bc+WhbOvaaWIMmmui3q0g folded before Flop (didn't bet)
Seat 2: 669iGNwYwgRZg3nhS+aDAQ folded before Flop (didn't bet)
Seat 4: sY+4Uuh5z/6AbXXaCS10jw (button) folded before Flop (didn't bet)
Seat 5: VvdR9F3I+2yELkfTVvC1dg (small blind) collected ($4)
Seat 6: /PH6Ffnho4Ysm8S3V/oa+w (big blind) folded before Flop



PokerStars Game #59942116506:  Hold'em No Limit ($1/$2) - 2009/07/01 1:56:36 ET
Table '5/wEe6JmtGD7vufSA2RG7A' 2-max Seat #2 is the button
Seat 1: pVqEzK9wXlRMECnb1Zg4Zw ($210.80 in chips)
Seat 2: aOL8geThaYp2iadSHl1h1g ($442 in chips)
aOL8geThaYp2iadSHl1h1g: posts small blind $1
pVqEzK9wXlRMECnb1Zg4Zw: posts big blind $2
*** HOLE CARDS ***
aOL8geThaYp2iadSHl1h1g: raises $4 to $6
pVqEzK9wXlRMECnb1Zg4Zw: calls $4
*** FLOP *** [9c 8s Qd]
pVqEzK9wXlRMECnb1Zg4Zw: checks
aOL8geThaYp2iadSHl1h1g: checks
*** TURN *** [9c 8s Qd] [8h]
pVqEzK9wXlRMECnb1Zg4Zw: bets $6
aOL8geThaYp2iadSHl1h1g: folds
pVqEzK9wXlRMECnb1Zg4Zw collected $11.50 from pot
pVqEzK9wXlRMECnb1Zg4Zw: doesn't show hand
*** SUMMARY ***
Total pot $12 | Rake $0.50
Board [9c 8s Qd 8h]
Seat 1: pVqEzK9wXlRMECnb1Zg4Zw (big blind) collected ($11.50)
Seat 2: aOL8geThaYp2iadSHl1h1g (button) (small blind) folded on the Turn



PokerStars Game #59942116106:  Hold'em No Limit ($1/$2) - 2009/07/01 1:56:36 ET
Table 'P/yCfYl1GfGsu/e6DxDy/A' 2-max Seat #2 is the button
Seat 1: 7fOCUy3x9hdkmXkkDNolGQ ($1110.50 in chips)
Seat 2: RwDoM55ZeQuI2ADyJhOb2Q ($356 in chips)
RwDoM55ZeQuI2ADyJhOb2Q: posts small blind $1
7fOCUy3x9hdkmXkkDNolGQ: posts big blind $2
*** HOLE CARDS ***
RwDoM55ZeQuI2ADyJhOb2Q: folds
7fOCUy3x9hdkmXkkDNolGQ collected $2 from pot
7fOCUy3x9hdkmXkkDNolGQ: doesn't show hand
*** SUMMARY ***
Total pot $2 | Rake $0
Seat 1: 7fOCUy3x9hdkmXkkDNolGQ (big blind) collected ($2)
Seat 2: RwDoM55ZeQuI2ADyJhOb2Q (button) (small blind) folded before Flop



PokerStars Game #59942116810:  Hold'em No Limit ($1/$2) - 2009/07/01 1:56:37 ET
Table 'xxAXogzmyuZKfe0LOYHaNQ' 2-max Seat #1 is the button
Seat 1: S14rjcU6LEC1LmuUtBK5Bg ($116.50 in chips)
Seat 2: ItDFe9gh5QYPQB9vC4ntUA ($204.60 in chips)
S14rjcU6LEC1LmuUtBK5Bg: posts small blind $1
ItDFe9gh5QYPQB9vC4ntUA: posts big blind $2
*** HOLE CARDS ***
S14rjcU6LEC1LmuUtBK5Bg: raises $4 to $6
ItDFe9gh5QYPQB9vC4ntUA: folds
S14rjcU6LEC1LmuUtBK5Bg collected $4 from pot
*** SUMMARY ***
Total pot $4 | Rake $0
Seat 1: S14rjcU6LEC1LmuUtBK5Bg (button) (small blind) collected ($4)
Seat 2: ItDFe9gh5QYPQB9vC4ntUA (big blind) folded before Flop



PokerStars Game #59942116880:  Hold'em No Limit ($1/$2) - 2009/07/01 1:56:37 ET
Table 'uJ9juaXXg9yIcSU8amxaXQ' 6-max Seat #5 is the button
Seat 1: JsqOjN/eHz0uYVf/PyUJ6Q ($134.15 in chips)
Seat 2: VvdR9F3I+2yELkfTVvC1dg ($217.45 in chips)
Seat 3: qXDd0ZyMIse0OBu8pxeQ3Q ($239.40 in chips)
Seat 4: zNjJ/y4emmF+vzrCDd+ooA ($266.30 in chips)
Seat 5: YsLQ3BAvgQHWXMAv3Wv6Hg ($202 in chips)
opJMdoq0E6TRbAQiweyQuA will be allowed to play after the button
JsqOjN/eHz0uYVf/PyUJ6Q: posts small blind $1
VvdR9F3I+2yELkfTVvC1dg: posts big blind $2
*** HOLE CARDS ***
qXDd0ZyMIse0OBu8pxeQ3Q: folds
zNjJ/y4emmF+vzrCDd+ooA: folds
YsLQ3BAvgQHWXMAv3Wv6Hg: folds
JsqOjN/eHz0uYVf/PyUJ6Q: folds
VvdR9F3I+2yELkfTVvC1dg collected $2 from pot
VvdR9F3I+2yELkfTVvC1dg: doesn't show hand
*** SUMMARY ***
Total pot $2 | Rake $0
Seat 1: JsqOjN/eHz0uYVf/PyUJ6Q (small blind) folded before Flop
Seat 2: VvdR9F3I+2yELkfTVvC1dg (big blind) collected ($2)
Seat 3: qXDd0ZyMIse0OBu8pxeQ3Q folded before Flop (didn't bet)
Seat 4: zNjJ/y4emmF+vzrCDd+ooA folded before Flop (didn't bet)
Seat 5: YsLQ3BAvgQHWXMAv3Wv6Hg (button) folded before Flop (didn't bet)



PokerStars Game #59942118354:  Hold'em No Limit ($1/$2) - 2009/07/01 1:56:40 ET
Table 'UGLAZZyv+cXmnKjYin0etA' 6-max Seat #4 is the button
Seat 1: rL+Zpv4/vX2BVHcyfh/NXA ($208.25 in chips)
Seat 2: eDLH1PUXFpvJBNMXBVQcGA ($291.10 in chips)
Seat 3: Nsjun4mjI8q0SSBTIp1dIQ ($229 in chips)
Seat 4: SiGJDsvRViJX05vHhA80GQ ($246.75 in chips)
Seat 5: 54yWzRRgS0oZ+S6LwZBxMQ ($35.80 in chips)
Seat 6: sTPOWERd9HWPCNrDBwsVjA ($179.95 in chips)
54yWzRRgS0oZ+S6LwZBxMQ: posts small blind $1
sTPOWERd9HWPCNrDBwsVjA: posts big blind $2
*** HOLE CARDS ***
rL+Zpv4/vX2BVHcyfh/NXA: folds
eDLH1PUXFpvJBNMXBVQcGA: raises $4 to $6
Nsjun4mjI8q0SSBTIp1dIQ: folds
SiGJDsvRViJX05vHhA80GQ: folds
54yWzRRgS0oZ+S6LwZBxMQ: folds
sTPOWERd9HWPCNrDBwsVjA: folds
eDLH1PUXFpvJBNMXBVQcGA collected $5 from pot
*** SUMMARY ***
Total pot $5 | Rake $0
Seat 1: rL+Zpv4/vX2BVHcyfh/NXA folded before Flop (didn't bet)
Seat 2: eDLH1PUXFpvJBNMXBVQcGA collected ($5)
Seat 3: Nsjun4mjI8q0SSBTIp1dIQ folded before Flop (didn't bet)
Seat 4: SiGJDsvRViJX05vHhA80GQ (button) folded before Flop (didn't bet)
Seat 5: 54yWzRRgS0oZ+S6LwZBxMQ (small blind) folded before Flop
Seat 6: sTPOWERd9HWPCNrDBwsVjA (big blind) folded before Flop



PokerStars Game #59942119362:  Hold'em No Limit ($1/$2) - 2009/07/01 1:56:42 ET
Table 'rsKRKlGHlxVyqJxzO2a2Ow' 9-max Seat #4 is the button
Seat 1: KqHysDSpCPaPyK3tJC1aEw ($209.30 in chips)
Seat 3: kM9CA+2UcdMjbCMbtUCGiA ($200 in chips)
Seat 4: 31HuO+DQxppUQEedBWukug ($133.10 in chips)
Seat 5: 5Q8U6iZbeO7xJSS4qvDP5g ($251.55 in chips)
Seat 6: H6Z4+qu8gR0VUiPOijndVg ($203 in chips)
Seat 7: GX1heJ+DSsvm7gzSPsYhhQ ($53 in chips)
Seat 8: CkE3IyJF1KvdaAOmZY5XqQ ($206.70 in chips)
Seat 9: gRbvhSUVg+TNaTjaJecIRw ($53.60 in chips)
5Q8U6iZbeO7xJSS4qvDP5g: posts small blind $1
H6Z4+qu8gR0VUiPOijndVg: posts big blind $2
254YPxPJr5Sw58bkD0YqYQ: sits out
*** HOLE CARDS ***
GX1heJ+DSsvm7gzSPsYhhQ: folds
CkE3IyJF1KvdaAOmZY5XqQ has timed out
CkE3IyJF1KvdaAOmZY5XqQ: folds
CkE3IyJF1KvdaAOmZY5XqQ is sitting out
gRbvhSUVg+TNaTjaJecIRw: folds
CkE3IyJF1KvdaAOmZY5XqQ has returned
KqHysDSpCPaPyK3tJC1aEw: raises $4 to $6
kM9CA+2UcdMjbCMbtUCGiA: folds
31HuO+DQxppUQEedBWukug: folds
5Q8U6iZbeO7xJSS4qvDP5g: folds
H6Z4+qu8gR0VUiPOijndVg: folds
KqHysDSpCPaPyK3tJC1aEw collected $5 from pot
KqHysDSpCPaPyK3tJC1aEw: doesn't show hand
*** SUMMARY ***
Total pot $5 | Rake $0
Seat 1: KqHysDSpCPaPyK3tJC1aEw collected ($5)
Seat 3: kM9CA+2UcdMjbCMbtUCGiA folded before Flop (didn't bet)
Seat 4: 31HuO+DQxppUQEedBWukug (button) folded before Flop (didn't bet)
Seat 5: 5Q8U6iZbeO7xJSS4qvDP5g (small blind) folded before Flop
Seat 6: H6Z4+qu8gR0VUiPOijndVg (big blind) folded before Flop
Seat 7: GX1heJ+DSsvm7gzSPsYhhQ folded before Flop (didn't bet)
Seat 8: CkE3IyJF1KvdaAOmZY5XqQ folded before Flop (didn't bet)
Seat 9: gRbvhSUVg+TNaTjaJecIRw folded before Flop (didn't bet)



PokerStars Game #59942119140:  Hold'em No Limit ($1/$2) - 2009/07/01 1:56:42 ET
Table 'P/yCfYl1GfGsu/e6DxDy/A' 2-max Seat #1 is the button
Seat 1: 7fOCUy3x9hdkmXkkDNolGQ ($1111.50 in chips)
Seat 2: RwDoM55ZeQuI2ADyJhOb2Q ($355 in chips)
7fOCUy3x9hdkmXkkDNolGQ: posts small blind $1
RwDoM55ZeQuI2ADyJhOb2Q: posts big blind $2
*** HOLE CARDS ***
7fOCUy3x9hdkmXkkDNolGQ: folds
RwDoM55ZeQuI2ADyJhOb2Q collected $2 from pot
RwDoM55ZeQuI2ADyJhOb2Q: doesn't show hand
*** SUMMARY ***
Total pot $2 | Rake $0
Seat 1: 7fOCUy3x9hdkmXkkDNolGQ (button) (small blind) folded before Flop
Seat 2: RwDoM55ZeQuI2ADyJhOb2Q (big blind) collected ($2)



PokerStars Game #59942121070:  Hold'em No Limit ($1/$2) - 2009/07/01 1:56:45 ET
Table 'ztv6V3FN2bQ9nmJPPdx6nQ' 6-max Seat #5 is the button
Seat 1: 6fLdOUCRtX71xbVRhJEq8w ($365.35 in chips)
Seat 2: 5Y+ZGWLI4gnlpApDX5vy1A ($293.05 in chips)
Seat 3: XP9UmPc7hfMVafyEiwJMAA ($197 in chips)
Seat 4: UaZ5yj+6LjtWqMQg2QskUw ($100.40 in chips)
Seat 5: sTPOWERd9HWPCNrDBwsVjA ($207.60 in chips)
Seat 6: mfy7uGZcqA2PVQqEVbJ7+g ($188.70 in chips)
mfy7uGZcqA2PVQqEVbJ7+g: posts small blind $1
6fLdOUCRtX71xbVRhJEq8w: posts big blind $2
*** HOLE CARDS ***
5Y+ZGWLI4gnlpApDX5vy1A: folds
XP9UmPc7hfMVafyEiwJMAA: folds
UaZ5yj+6LjtWqMQg2QskUw: raises $6 to $8
sTPOWERd9HWPCNrDBwsVjA: calls $8
mfy7uGZcqA2PVQqEVbJ7+g: folds
6fLdOUCRtX71xbVRhJEq8w: folds
*** FLOP *** [2d 5d 9d]
UaZ5yj+6LjtWqMQg2QskUw: bets $8
sTPOWERd9HWPCNrDBwsVjA: raises $22 to $30
UaZ5yj+6LjtWqMQg2QskUw: folds
sTPOWERd9HWPCNrDBwsVjA collected $33.30 from pot
*** SUMMARY ***
Total pot $35 | Rake $1.70
Board [2d 5d 9d]
Seat 1: 6fLdOUCRtX71xbVRhJEq8w (big blind) folded before Flop
Seat 2: 5Y+ZGWLI4gnlpApDX5vy1A folded before Flop (didn't bet)
Seat 3: XP9UmPc7hfMVafyEiwJMAA folded before Flop (didn't bet)
Seat 4: UaZ5yj+6LjtWqMQg2QskUw folded on the Flop
Seat 5: sTPOWERd9HWPCNrDBwsVjA (button) collected ($33.30)
Seat 6: mfy7uGZcqA2PVQqEVbJ7+g (small blind) folded before Flop



PokerStars Game #59942121360:  Hold'em No Limit ($1/$2) - 2009/07/01 1:56:46 ET
Table 'JArEO7oOXEgVwX3NVsRD+A' 9-max Seat #4 is the button
Seat 1: Q104K4iDGcqOlVrjAkzPEA ($87.05 in chips)
Seat 2: g3ZVTc1EbSNXYYMO82jL7Q ($355.55 in chips)
Seat 3: IYBKVnE2Basnr88BAhH+bQ ($226.25 in chips)
Seat 4: 5Q8U6iZbeO7xJSS4qvDP5g ($260.60 in chips)
Seat 5: QCeHcOIuXMfz9IQu0lUQ0w ($16.65 in chips)
Seat 6: GX1heJ+DSsvm7gzSPsYhhQ ($37 in chips)
Seat 7: LQoVc4pQLz/wlryLTs7bRA ($107.15 in chips)
Seat 8: isdXtU9uuSM2LGqOKxtlwA ($108.70 in chips)
QCeHcOIuXMfz9IQu0lUQ0w: posts small blind $1
GX1heJ+DSsvm7gzSPsYhhQ: posts big blind $2
*** HOLE CARDS ***
LQoVc4pQLz/wlryLTs7bRA: calls $2
isdXtU9uuSM2LGqOKxtlwA: calls $2
Q104K4iDGcqOlVrjAkzPEA: folds
g3ZVTc1EbSNXYYMO82jL7Q: raises $10 to $12
IYBKVnE2Basnr88BAhH+bQ: folds
5Q8U6iZbeO7xJSS4qvDP5g: folds
QCeHcOIuXMfz9IQu0lUQ0w: folds
GX1heJ+DSsvm7gzSPsYhhQ: folds
LQoVc4pQLz/wlryLTs7bRA: calls $10
isdXtU9uuSM2LGqOKxtlwA: folds
*** FLOP *** [2c 2d Ac]
isdXtU9uuSM2LGqOKxtlwA leaves the table
LQoVc4pQLz/wlryLTs7bRA: checks
g3ZVTc1EbSNXYYMO82jL7Q: bets $18
LQoVc4pQLz/wlryLTs7bRA: folds
g3ZVTc1EbSNXYYMO82jL7Q collected $27.55 from pot
g3ZVTc1EbSNXYYMO82jL7Q: doesn't show hand
*** SUMMARY ***
Total pot $29 | Rake $1.45
Board [2c 2d Ac]
Seat 1: Q104K4iDGcqOlVrjAkzPEA folded before Flop (didn't bet)
Seat 2: g3ZVTc1EbSNXYYMO82jL7Q collected ($27.55)
Seat 3: IYBKVnE2Basnr88BAhH+bQ folded before Flop (didn't bet)
Seat 4: 5Q8U6iZbeO7xJSS4qvDP5g (button) folded before Flop (didn't bet)
Seat 5: QCeHcOIuXMfz9IQu0lUQ0w (small blind) folded before Flop
Seat 6: GX1heJ+DSsvm7gzSPsYhhQ (big blind) folded before Flop
Seat 7: LQoVc4pQLz/wlryLTs7bRA folded on the Flop
Seat 8: isdXtU9uuSM2LGqOKxtlwA folded before Flop



PokerStars Game #59942121606:  Hold'em No Limit ($1/$2) - 2009/07/01 1:56:46 ET
Table 'xxAXogzmyuZKfe0LOYHaNQ' 2-max Seat #2 is the button
Seat 1: S14rjcU6LEC1LmuUtBK5Bg ($118.50 in chips)
Seat 2: ItDFe9gh5QYPQB9vC4ntUA ($202.60 in chips)
ItDFe9gh5QYPQB9vC4ntUA: posts small blind $1
S14rjcU6LEC1LmuUtBK5Bg: posts big blind $2
*** HOLE CARDS ***
ItDFe9gh5QYPQB9vC4ntUA: raises $2 to $4
S14rjcU6LEC1LmuUtBK5Bg: raises $4 to $8
ItDFe9gh5QYPQB9vC4ntUA: calls $4
*** FLOP *** [3c 7h Js]
S14rjcU6LEC1LmuUtBK5Bg: bets $10
ItDFe9gh5QYPQB9vC4ntUA: folds
S14rjcU6LEC1LmuUtBK5Bg collected $15.50 from pot
*** SUMMARY ***
Total pot $16 | Rake $0.50
Board [3c 7h Js]
Seat 1: S14rjcU6LEC1LmuUtBK5Bg (big blind) collected ($15.50)
Seat 2: ItDFe9gh5QYPQB9vC4ntUA (button) (small blind) folded on the Flop



PokerStars Game #59942122160:  Hold'em No Limit ($1/$2) - 2009/07/01 1:56:47 ET
Table 'P/yCfYl1GfGsu/e6DxDy/A' 2-max Seat #2 is the button
Seat 1: 7fOCUy3x9hdkmXkkDNolGQ ($1110.50 in chips)
Seat 2: RwDoM55ZeQuI2ADyJhOb2Q ($356 in chips)
RwDoM55ZeQuI2ADyJhOb2Q: posts small blind $1
7fOCUy3x9hdkmXkkDNolGQ: posts big blind $2
*** HOLE CARDS ***
RwDoM55ZeQuI2ADyJhOb2Q: raises $4 to $6
7fOCUy3x9hdkmXkkDNolGQ: raises $14 to $20
RwDoM55ZeQuI2ADyJhOb2Q: calls $14
*** FLOP *** [Qd 3s Ah]
7fOCUy3x9hdkmXkkDNolGQ: bets $22
RwDoM55ZeQuI2ADyJhOb2Q: calls $22
*** TURN *** [Qd 3s Ah] [4d]
7fOCUy3x9hdkmXkkDNolGQ: checks
RwDoM55ZeQuI2ADyJhOb2Q: checks
*** RIVER *** [Qd 3s Ah 4d] [8c]
7fOCUy3x9hdkmXkkDNolGQ: checks
RwDoM55ZeQuI2ADyJhOb2Q: checks
*** SHOW DOWN ***
7fOCUy3x9hdkmXkkDNolGQ: shows [5s Ks] (high card Ace)
RwDoM55ZeQuI2ADyJhOb2Q: shows [Qh 7d] (a pair of Queens)
RwDoM55ZeQuI2ADyJhOb2Q collected $83.50 from pot
*** SUMMARY ***
Total pot $84 | Rake $0.50
Board [Qd 3s Ah 4d 8c]
Seat 1: 7fOCUy3x9hdkmXkkDNolGQ (big blind) showed [5s Ks] and lost with high card Ace
Seat 2: RwDoM55ZeQuI2ADyJhOb2Q (button) (small blind) showed [Qh 7d] and won ($83.50) with a pair of Queens



PokerStars Game #59942122434:  Hold'em No Limit ($1/$2) - 2009/07/01 1:56:48 ET
Table 'uJ9juaXXg9yIcSU8amxaXQ' 6-max Seat #1 is the button
Seat 1: JsqOjN/eHz0uYVf/PyUJ6Q ($133.15 in chips)
Seat 2: VvdR9F3I+2yELkfTVvC1dg ($218.45 in chips)
Seat 3: qXDd0ZyMIse0OBu8pxeQ3Q ($239.40 in chips)
Seat 4: zNjJ/y4emmF+vzrCDd+ooA ($266.30 in chips)
Seat 5: YsLQ3BAvgQHWXMAv3Wv6Hg ($202 in chips)
VvdR9F3I+2yELkfTVvC1dg: posts small blind $1
qXDd0ZyMIse0OBu8pxeQ3Q: posts big blind $2
opJMdoq0E6TRbAQiweyQuA: sits out
*** HOLE CARDS ***
zNjJ/y4emmF+vzrCDd+ooA: calls $2
YsLQ3BAvgQHWXMAv3Wv6Hg: folds
JsqOjN/eHz0uYVf/PyUJ6Q: calls $2
VvdR9F3I+2yELkfTVvC1dg: folds
qXDd0ZyMIse0OBu8pxeQ3Q: checks
*** FLOP *** [9h 7c Js]
qXDd0ZyMIse0OBu8pxeQ3Q: checks
zNjJ/y4emmF+vzrCDd+ooA: checks
JsqOjN/eHz0uYVf/PyUJ6Q: checks
*** TURN *** [9h 7c Js] [6c]
qXDd0ZyMIse0OBu8pxeQ3Q: bets $6
zNjJ/y4emmF+vzrCDd+ooA: folds
JsqOjN/eHz0uYVf/PyUJ6Q: folds
qXDd0ZyMIse0OBu8pxeQ3Q collected $6.65 from pot
*** SUMMARY ***
Total pot $7 | Rake $0.35
Board [9h 7c Js 6c]
Seat 1: JsqOjN/eHz0uYVf/PyUJ6Q (button) folded on the Turn
Seat 2: VvdR9F3I+2yELkfTVvC1dg (small blind) folded before Flop
Seat 3: qXDd0ZyMIse0OBu8pxeQ3Q (big blind) collected ($6.65)
Seat 4: zNjJ/y4emmF+vzrCDd+ooA folded on the Turn
Seat 5: YsLQ3BAvgQHWXMAv3Wv6Hg folded before Flop (didn't bet)



PokerStars Game #59942122616:  Hold'em No Limit ($1/$2) - 2009/07/01 1:56:48 ET
Table 'pPQgcj9XT9CHBsbo1WTBug' 6-max Seat #4 is the button
Seat 1: DFVYDA6dKQy7R7mGIKogZA ($154.20 in chips)
Seat 2: qXDd0ZyMIse0OBu8pxeQ3Q ($200 in chips)
Seat 3: sSAA879uXOGR+8Mf3zLa6Q ($149.20 in chips)
Seat 4: cwfuMyvDC7J7SqX2leDC8g ($59.30 in chips)
Seat 5: vkfxu8f/jMYKUk6Ly4eujw ($198 in chips)
Seat 6: Yr7pZltpy3IUNdKS9PCEiw ($288.80 in chips)
vkfxu8f/jMYKUk6Ly4eujw: posts small blind $1
Yr7pZltpy3IUNdKS9PCEiw: posts big blind $2
*** HOLE CARDS ***
DFVYDA6dKQy7R7mGIKogZA: folds
qXDd0ZyMIse0OBu8pxeQ3Q: folds
sSAA879uXOGR+8Mf3zLa6Q: raises $6 to $8
cwfuMyvDC7J7SqX2leDC8g: folds
vkfxu8f/jMYKUk6Ly4eujw: folds
Yr7pZltpy3IUNdKS9PCEiw: raises $10 to $18
sSAA879uXOGR+8Mf3zLa6Q: raises $14 to $32
Yr7pZltpy3IUNdKS9PCEiw: raises $28 to $60
sSAA879uXOGR+8Mf3zLa6Q: calls $28
*** FLOP *** [Ah 2s 6d]
Yr7pZltpy3IUNdKS9PCEiw: checks
sSAA879uXOGR+8Mf3zLa6Q: checks
*** TURN *** [Ah 2s 6d] [5h]
Yr7pZltpy3IUNdKS9PCEiw: checks
sSAA879uXOGR+8Mf3zLa6Q: bets $32
Yr7pZltpy3IUNdKS9PCEiw: calls $32
*** RIVER *** [Ah 2s 6d 5h] [6s]
Yr7pZltpy3IUNdKS9PCEiw: checks
sSAA879uXOGR+8Mf3zLa6Q: bets $57.20 and is all-in
Yr7pZltpy3IUNdKS9PCEiw: calls $57.20
*** SHOW DOWN ***
sSAA879uXOGR+8Mf3zLa6Q: shows [Ad 6c] (a full house, Sixes full of Aces)
Yr7pZltpy3IUNdKS9PCEiw: mucks hand
sSAA879uXOGR+8Mf3zLa6Q collected $296.40 from pot
*** SUMMARY ***
Total pot $299.40 | Rake $3
Board [Ah 2s 6d 5h 6s]
Seat 1: DFVYDA6dKQy7R7mGIKogZA folded before Flop (didn't bet)
Seat 2: qXDd0ZyMIse0OBu8pxeQ3Q folded before Flop (didn't bet)
Seat 3: sSAA879uXOGR+8Mf3zLa6Q showed [Ad 6c] and won ($296.40) with a full house, Sixes full of Aces
Seat 4: cwfuMyvDC7J7SqX2leDC8g (button) folded before Flop (didn't bet)
Seat 5: vkfxu8f/jMYKUk6Ly4eujw (small blind) folded before Flop
Seat 6: Yr7pZltpy3IUNdKS9PCEiw (big blind) mucked



PokerStars Game #59942122798:  Hold'em No Limit ($1/$2) - 2009/07/01 1:56:49 ET
Table 'G1Oqdy4Pqdb5gtx40rUBzA' 6-max Seat #4 is the button
Seat 1: 4dMBh/1VTdeUTPCyhCs3UQ ($45.05 in chips)
Seat 2: m7mYVfnCOK5TE/VkN/FhOg ($231.75 in chips)
Seat 3: VvdR9F3I+2yELkfTVvC1dg ($415.90 in chips)
Seat 4: B87ikIyZ/TzAVeXf38Ny0g ($200 in chips)
Seat 5: F1+Ml47qRQWunzPnGhLLzQ ($225.15 in chips)
Seat 6: qCnEYuAE5y5A7bk6fO5/jQ ($203 in chips)
F1+Ml47qRQWunzPnGhLLzQ: posts small blind $1
qCnEYuAE5y5A7bk6fO5/jQ: posts big blind $2
*** HOLE CARDS ***
4dMBh/1VTdeUTPCyhCs3UQ: folds
m7mYVfnCOK5TE/VkN/FhOg: folds
VvdR9F3I+2yELkfTVvC1dg: folds
B87ikIyZ/TzAVeXf38Ny0g: folds
F1+Ml47qRQWunzPnGhLLzQ: raises $2 to $4
qCnEYuAE5y5A7bk6fO5/jQ: calls $2
*** FLOP *** [Kd 2d 5c]
F1+Ml47qRQWunzPnGhLLzQ: bets $4
qCnEYuAE5y5A7bk6fO5/jQ: folds
F1+Ml47qRQWunzPnGhLLzQ collected $7.60 from pot
F1+Ml47qRQWunzPnGhLLzQ: doesn't show hand
*** SUMMARY ***
Total pot $8 | Rake $0.40
Board [Kd 2d 5c]
Seat 1: 4dMBh/1VTdeUTPCyhCs3UQ folded before Flop (didn't bet)
Seat 2: m7mYVfnCOK5TE/VkN/FhOg folded before Flop (didn't bet)
Seat 3: VvdR9F3I+2yELkfTVvC1dg folded before Flop (didn't bet)
Seat 4: B87ikIyZ/TzAVeXf38Ny0g (button) folded before Flop (didn't bet)
Seat 5: F1+Ml47qRQWunzPnGhLLzQ (small blind) collected ($7.60)
Seat 6: qCnEYuAE5y5A7bk6fO5/jQ (big blind) folded on the Flop



PokerStars Game #59942123700:  Hold'em No Limit ($1/$2) - 2009/07/01 1:56:50 ET
Table 'CFkQcfWjKccZaZDf71FK+w' 6-max Seat #5 is the button
Seat 1: vkfxu8f/jMYKUk6Ly4eujw ($224.05 in chips)
Seat 2: ewN/vzF22+/gdzjIKBOlkA ($212.80 in chips)
Seat 3: TMPDCBmlFGM9C+H58PC4sQ ($54.75 in chips)
Seat 4: opJMdoq0E6TRbAQiweyQuA ($37 in chips)
Seat 5: 2lOU1DcvUZaMcxZ95XfzXw ($114.85 in chips)
Seat 6: ORVqY3rf9X6ANA/8s+On2Q ($37.85 in chips)
ORVqY3rf9X6ANA/8s+On2Q: posts small blind $1
vkfxu8f/jMYKUk6Ly4eujw: posts big blind $2
*** HOLE CARDS ***
ewN/vzF22+/gdzjIKBOlkA: folds
TMPDCBmlFGM9C+H58PC4sQ: raises $4 to $6
opJMdoq0E6TRbAQiweyQuA: folds
2lOU1DcvUZaMcxZ95XfzXw: calls $6
ORVqY3rf9X6ANA/8s+On2Q: folds
vkfxu8f/jMYKUk6Ly4eujw: folds
*** FLOP *** [7h 3d Js]
TMPDCBmlFGM9C+H58PC4sQ: checks
2lOU1DcvUZaMcxZ95XfzXw: checks
*** TURN *** [7h 3d Js] [6d]
TMPDCBmlFGM9C+H58PC4sQ: bets $8
2lOU1DcvUZaMcxZ95XfzXw: calls $8
*** RIVER *** [7h 3d Js 6d] [8c]
TMPDCBmlFGM9C+H58PC4sQ: bets $20
2lOU1DcvUZaMcxZ95XfzXw: folds
TMPDCBmlFGM9C+H58PC4sQ collected $29.50 from pot
*** SUMMARY ***
Total pot $31 | Rake $1.50
Board [7h 3d Js 6d 8c]
Seat 1: vkfxu8f/jMYKUk6Ly4eujw (big blind) folded before Flop
Seat 2: ewN/vzF22+/gdzjIKBOlkA folded before Flop (didn't bet)
Seat 3: TMPDCBmlFGM9C+H58PC4sQ collected ($29.50)
Seat 4: opJMdoq0E6TRbAQiweyQuA folded before Flop (didn't bet)
Seat 5: 2lOU1DcvUZaMcxZ95XfzXw (button) folded on the River
Seat 6: ORVqY3rf9X6ANA/8s+On2Q (small blind) folded before Flop



PokerStars Game #59942123764:  Hold'em No Limit ($1/$2) - 2009/07/01 1:56:51 ET
Table '/8c0X14Gjd7J3pVNocAJrQ' 6-max Seat #3 is the button
Seat 1: AuiGltq875lmaKHBsjZVGg ($88.20 in chips)
Seat 2: mfy7uGZcqA2PVQqEVbJ7+g ($275.60 in chips)
Seat 3: sr/OkkgqNbtgwJf1tmnfNg ($109.55 in chips)
Seat 4: PkzV5n5qRUp0Weu8NcNNhA ($81.15 in chips)
Seat 6: VvdR9F3I+2yELkfTVvC1dg ($335.95 in chips)
PkzV5n5qRUp0Weu8NcNNhA: posts small blind $1
/PH6Ffnho4Ysm8S3V/oa+w: is sitting out
VvdR9F3I+2yELkfTVvC1dg: posts big blind $2
*** HOLE CARDS ***
/PH6Ffnho4Ysm8S3V/oa+w leaves the table
AuiGltq875lmaKHBsjZVGg: folds
mfy7uGZcqA2PVQqEVbJ7+g: folds
sr/OkkgqNbtgwJf1tmnfNg: folds
PkzV5n5qRUp0Weu8NcNNhA: calls $1
opJMdoq0E6TRbAQiweyQuA joins the table at seat #5
VvdR9F3I+2yELkfTVvC1dg: checks
*** FLOP *** [9d 5c 2s]
PkzV5n5qRUp0Weu8NcNNhA: checks
VvdR9F3I+2yELkfTVvC1dg: checks
*** TURN *** [9d 5c 2s] [7c]
PkzV5n5qRUp0Weu8NcNNhA: checks
VvdR9F3I+2yELkfTVvC1dg: checks
*** RIVER *** [9d 5c 2s 7c] [9h]
PkzV5n5qRUp0Weu8NcNNhA: checks
VvdR9F3I+2yELkfTVvC1dg: checks
*** SHOW DOWN ***
PkzV5n5qRUp0Weu8NcNNhA: shows [8s Th] (a pair of Nines)
VvdR9F3I+2yELkfTVvC1dg: shows [7d Ad] (two pair, Nines and Sevens)
VvdR9F3I+2yELkfTVvC1dg collected $3.80 from pot
*** SUMMARY ***
Total pot $4 | Rake $0.20
Board [9d 5c 2s 7c 9h]
Seat 1: AuiGltq875lmaKHBsjZVGg folded before Flop (didn't bet)
Seat 2: mfy7uGZcqA2PVQqEVbJ7+g folded before Flop (didn't bet)
Seat 3: sr/OkkgqNbtgwJf1tmnfNg (button) folded before Flop (didn't bet)
Seat 4: PkzV5n5qRUp0Weu8NcNNhA (small blind) showed [8s Th] and lost with a pair of Nines
Seat 6: VvdR9F3I+2yELkfTVvC1dg (big blind) showed [7d Ad] and won ($3.80) with two pair, Nines and Sevens



PokerStars Game #59942124774:  Hold'em No Limit ($1/$2) - 2009/07/01 1:56:52 ET
Table 'rKeCh+eBn4RNvybCUYkoTQ' 9-max Seat #7 is the button
Seat 1: yb4VS5k/eXxPEc0NRsIMJw ($27.80 in chips)
Seat 3: GX1heJ+DSsvm7gzSPsYhhQ ($54.75 in chips)
Seat 4: gxYDp0GZEzKoOg07Km9LaA ($94 in chips)
Seat 5: WUlHm+ydPPHG7Lb0rePSdA ($171.65 in chips)
Seat 6: +WoujR0xbwD7I2jrVmHuXw ($206.35 in chips)
Seat 7: rW/MyplHylMSBRaoRUzWrg ($31.80 in chips)
Seat 8: BkiGibLm0/LgS9GD9TKYJg ($108 in chips)
Seat 9: PfmlvZlFiss79a6IoEr11g ($92 in chips)
BkiGibLm0/LgS9GD9TKYJg: posts small blind $1
PfmlvZlFiss79a6IoEr11g: posts big blind $2
*** HOLE CARDS ***
yb4VS5k/eXxPEc0NRsIMJw: calls $2
GX1heJ+DSsvm7gzSPsYhhQ: folds
gxYDp0GZEzKoOg07Km9LaA: raises $2 to $4
WUlHm+ydPPHG7Lb0rePSdA: folds
+WoujR0xbwD7I2jrVmHuXw: folds
rW/MyplHylMSBRaoRUzWrg: folds
BkiGibLm0/LgS9GD9TKYJg: folds
PfmlvZlFiss79a6IoEr11g: calls $2
yb4VS5k/eXxPEc0NRsIMJw: calls $2
*** FLOP *** [Ks Js Tc]
PfmlvZlFiss79a6IoEr11g: checks
yb4VS5k/eXxPEc0NRsIMJw: bets $10
gxYDp0GZEzKoOg07Km9LaA: folds
PfmlvZlFiss79a6IoEr11g: calls $10
*** TURN *** [Ks Js Tc] [8s]
PfmlvZlFiss79a6IoEr11g: checks
yb4VS5k/eXxPEc0NRsIMJw: bets $13.80 and is all-in
PfmlvZlFiss79a6IoEr11g: calls $13.80
*** RIVER *** [Ks Js Tc 8s] [6s]
*** SHOW DOWN ***
PfmlvZlFiss79a6IoEr11g: shows [Jd Ah] (a pair of Jacks)
yb4VS5k/eXxPEc0NRsIMJw: shows [Ts Jc] (a flush, King high)
yb4VS5k/eXxPEc0NRsIMJw collected $57.65 from pot
*** SUMMARY ***
Total pot $60.60 | Rake $2.95
Board [Ks Js Tc 8s 6s]
Seat 1: yb4VS5k/eXxPEc0NRsIMJw showed [Ts Jc] and won ($57.65) with a flush, King high
Seat 3: GX1heJ+DSsvm7gzSPsYhhQ folded before Flop (didn't bet)
Seat 4: gxYDp0GZEzKoOg07Km9LaA folded on the Flop
Seat 5: WUlHm+ydPPHG7Lb0rePSdA folded before Flop (didn't bet)
Seat 6: +WoujR0xbwD7I2jrVmHuXw folded before Flop (didn't bet)
Seat 7: rW/MyplHylMSBRaoRUzWrg (button) folded before Flop (didn't bet)
Seat 8: BkiGibLm0/LgS9GD9TKYJg (small blind) folded before Flop
Seat 9: PfmlvZlFiss79a6IoEr11g (big blind) showed [Jd Ah] and lost with a pair of Jacks



PokerStars Game #59942125028:  Hold'em No Limit ($1/$2) - 2009/07/01 1:56:53 ET
Table 'jlrIxbrVIG+gjaUYT4za8g' 6-max Seat #5 is the button
Seat 1: opJMdoq0E6TRbAQiweyQuA ($38 in chips)
Seat 2: cwfuMyvDC7J7SqX2leDC8g ($61 in chips)
Seat 4: 8srN1dKQePlsv0GyTada+Q ($309.80 in chips)
Seat 5: AyBB0k3Dcl7xbXUeGMw06g ($120.75 in chips)
opJMdoq0E6TRbAQiweyQuA: posts small blind $1
cwfuMyvDC7J7SqX2leDC8g: posts big blind $2
*** HOLE CARDS ***
3LCfF9/CuJ9+kbFOcqmuaQ said, "gagne dosti de twit"
8srN1dKQePlsv0GyTada+Q: folds
AyBB0k3Dcl7xbXUeGMw06g: calls $2
3LCfF9/CuJ9+kbFOcqmuaQ leaves the table
opJMdoq0E6TRbAQiweyQuA: folds
cwfuMyvDC7J7SqX2leDC8g: checks
*** FLOP *** [Td Qh Kc]
cwfuMyvDC7J7SqX2leDC8g: checks
AyBB0k3Dcl7xbXUeGMw06g: checks
*** TURN *** [Td Qh Kc] [3c]
cwfuMyvDC7J7SqX2leDC8g: checks
AyBB0k3Dcl7xbXUeGMw06g: checks
*** RIVER *** [Td Qh Kc 3c] [Qd]
cwfuMyvDC7J7SqX2leDC8g: checks
AyBB0k3Dcl7xbXUeGMw06g: checks
*** SHOW DOWN ***
cwfuMyvDC7J7SqX2leDC8g: shows [8c 5s] (a pair of Queens)
AyBB0k3Dcl7xbXUeGMw06g: shows [Ah 4h] (a pair of Queens - Ace kicker)
AyBB0k3Dcl7xbXUeGMw06g collected $4.75 from pot
*** SUMMARY ***
Total pot $5 | Rake $0.25
Board [Td Qh Kc 3c Qd]
Seat 1: opJMdoq0E6TRbAQiweyQuA (small blind) folded before Flop
Seat 2: cwfuMyvDC7J7SqX2leDC8g (big blind) showed [8c 5s] and lost with a pair of Queens
Seat 4: 8srN1dKQePlsv0GyTada+Q folded before Flop (didn't bet)
Seat 5: AyBB0k3Dcl7xbXUeGMw06g (button) showed [Ah 4h] and won ($4.75) with a pair of Queens



PokerStars Game #59942125578:  Hold'em No Limit ($1/$2) - 2009/07/01 1:56:54 ET
Table 'ZzSIe0zTCDv+n6hfbY5tTg' 6-max Seat #6 is the button
Seat 1: VvdR9F3I+2yELkfTVvC1dg ($286.65 in chips)
Seat 2: B87ikIyZ/TzAVeXf38Ny0g ($216 in chips)
Seat 3: gsugPj31Hui3Jefl98MBOA ($349.35 in chips)
Seat 4: 54yWzRRgS0oZ+S6LwZBxMQ ($49.10 in chips)
Seat 5: 3dAbvkxS5NPQTBAbvpinVg ($481.45 in chips)
Seat 6: 09BNF4quPDzanQzM8vc6WA ($34.55 in chips)
VvdR9F3I+2yELkfTVvC1dg: posts small blind $1
B87ikIyZ/TzAVeXf38Ny0g: posts big blind $2
*** HOLE CARDS ***
gsugPj31Hui3Jefl98MBOA: folds
54yWzRRgS0oZ+S6LwZBxMQ: folds
3dAbvkxS5NPQTBAbvpinVg: raises $4 to $6
09BNF4quPDzanQzM8vc6WA: folds
VvdR9F3I+2yELkfTVvC1dg: folds
B87ikIyZ/TzAVeXf38Ny0g: folds
3dAbvkxS5NPQTBAbvpinVg collected $5 from pot
3dAbvkxS5NPQTBAbvpinVg: doesn't show hand
*** SUMMARY ***
Total pot $5 | Rake $0
Seat 1: VvdR9F3I+2yELkfTVvC1dg (small blind) folded before Flop
Seat 2: B87ikIyZ/TzAVeXf38Ny0g (big blind) folded before Flop
Seat 3: gsugPj31Hui3Jefl98MBOA folded before Flop (didn't bet)
Seat 4: 54yWzRRgS0oZ+S6LwZBxMQ folded before Flop (didn't bet)
Seat 5: 3dAbvkxS5NPQTBAbvpinVg collected ($5)
Seat 6: 09BNF4quPDzanQzM8vc6WA (button) folded before Flop (didn't bet)



PokerStars Game #59942126558:  Hold'em No Limit ($1/$2) - 2009/07/01 1:56:56 ET
Table 'mGpP9StWRnoeiBDExc6Frg' 6-max Seat #3 is the button
Seat 1: VvdR9F3I+2yELkfTVvC1dg ($383.25 in chips)
Seat 2: 6hRJ68JkbJq6MYI9o5bUnQ ($98 in chips)
Seat 3: mddoKnqZkdOH7AJOJ/i0DA ($206 in chips)
Seat 4: 4dcDwIHRm96PwtqkpQiuiA ($82.70 in chips)
Seat 5: d1puGuVBE0fidn+5eRJ0tw ($102.50 in chips)
Seat 6: B2Ih1sr5VZk+8He7rcrMtQ ($425.15 in chips)
4dcDwIHRm96PwtqkpQiuiA: posts small blind $1
d1puGuVBE0fidn+5eRJ0tw: posts big blind $2
*** HOLE CARDS ***
B2Ih1sr5VZk+8He7rcrMtQ: folds
VvdR9F3I+2yELkfTVvC1dg: raises $2 to $4
6hRJ68JkbJq6MYI9o5bUnQ: folds
mddoKnqZkdOH7AJOJ/i0DA: folds
4dcDwIHRm96PwtqkpQiuiA: folds
d1puGuVBE0fidn+5eRJ0tw: folds
VvdR9F3I+2yELkfTVvC1dg collected $5 from pot
VvdR9F3I+2yELkfTVvC1dg: doesn't show hand
*** SUMMARY ***
Total pot $5 | Rake $0
Seat 1: VvdR9F3I+2yELkfTVvC1dg collected ($5)
Seat 2: 6hRJ68JkbJq6MYI9o5bUnQ folded before Flop (didn't bet)
Seat 3: mddoKnqZkdOH7AJOJ/i0DA (button) folded before Flop (didn't bet)
Seat 4: 4dcDwIHRm96PwtqkpQiuiA (small blind) folded before Flop
Seat 5: d1puGuVBE0fidn+5eRJ0tw (big blind) folded before Flop
Seat 6: B2Ih1sr5VZk+8He7rcrMtQ folded before Flop (didn't bet)



PokerStars Game #59942126462:  Hold'em No Limit ($1/$2) - 2009/07/01 1:56:56 ET
Table 'BSRfGh+QobUe0AgIMtt/fw' 9-max Seat #1 is the button
Seat 1: gDn/rYeNwCyWEgRhyWp4PA ($156.05 in chips)
Seat 2: +SmnXtdmwqXGEJfLeJDIUQ ($128.50 in chips)
Seat 3: WUlHm+ydPPHG7Lb0rePSdA ($120 in chips)
Seat 4: +T/63sAeZzWyHchahJ36GQ ($31 in chips)
Seat 5: ThVDqrMpsvd7Ax6KINfuew ($60.50 in chips)
Seat 6: H6Z4+qu8gR0VUiPOijndVg ($202 in chips)
Seat 7: CkE3IyJF1KvdaAOmZY5XqQ ($202 in chips)
Seat 8: GG5lTuGt3+kwNYSbqeB6yw ($81.25 in chips)
Seat 9: tjgwwDmi+N2H4I7hx8useQ ($82.70 in chips)
+SmnXtdmwqXGEJfLeJDIUQ: posts small blind $1
WUlHm+ydPPHG7Lb0rePSdA: posts big blind $2
*** HOLE CARDS ***
+T/63sAeZzWyHchahJ36GQ: folds
ThVDqrMpsvd7Ax6KINfuew: folds
H6Z4+qu8gR0VUiPOijndVg: folds
CkE3IyJF1KvdaAOmZY5XqQ: folds
GG5lTuGt3+kwNYSbqeB6yw: raises $4 to $6
tjgwwDmi+N2H4I7hx8useQ: folds
gDn/rYeNwCyWEgRhyWp4PA: folds
+SmnXtdmwqXGEJfLeJDIUQ: folds
WUlHm+ydPPHG7Lb0rePSdA: folds
GG5lTuGt3+kwNYSbqeB6yw collected $5 from pot
*** SUMMARY ***
Total pot $5 | Rake $0
Seat 1: gDn/rYeNwCyWEgRhyWp4PA (button) folded before Flop (didn't bet)
Seat 2: +SmnXtdmwqXGEJfLeJDIUQ (small blind) folded before Flop
Seat 3: WUlHm+ydPPHG7Lb0rePSdA (big blind) folded before Flop
Seat 4: +T/63sAeZzWyHchahJ36GQ folded before Flop (didn't bet)
Seat 5: ThVDqrMpsvd7Ax6KINfuew folded before Flop (didn't bet)
Seat 6: H6Z4+qu8gR0VUiPOijndVg folded before Flop (didn't bet)
Seat 7: CkE3IyJF1KvdaAOmZY5XqQ folded before Flop (didn't bet)
Seat 8: GG5lTuGt3+kwNYSbqeB6yw collected ($5)
Seat 9: tjgwwDmi+N2H4I7hx8useQ folded before Flop (didn't bet)



PokerStars Game #59942126976:  Hold'em No Limit ($1/$2) - 2009/07/01 1:56:56 ET
Table 'TsEDkiO4tzCTCzJ7tNdEqw' 6-max Seat #3 is the button
Seat 1: Nsjun4mjI8q0SSBTIp1dIQ ($200 in chips)
Seat 2: 4dcDwIHRm96PwtqkpQiuiA ($79.70 in chips)
Seat 3: ubtx4Z5L+AcK71MTvYiGVw ($255.90 in chips)
Seat 5: VvdR9F3I+2yELkfTVvC1dg ($250.10 in chips)
Seat 6: uCqEjnxh2/vFBjKYkfTOkw ($351.45 in chips)
VvdR9F3I+2yELkfTVvC1dg: posts small blind $1
uCqEjnxh2/vFBjKYkfTOkw: posts big blind $2
*** HOLE CARDS ***
Nsjun4mjI8q0SSBTIp1dIQ: folds
K8MXCrNAVYlMnnCeM32Kxw has returned
4dcDwIHRm96PwtqkpQiuiA: folds
ubtx4Z5L+AcK71MTvYiGVw: folds
VvdR9F3I+2yELkfTVvC1dg: folds
uCqEjnxh2/vFBjKYkfTOkw collected $2 from pot
uCqEjnxh2/vFBjKYkfTOkw: doesn't show hand
*** SUMMARY ***
Total pot $2 | Rake $0
Seat 1: Nsjun4mjI8q0SSBTIp1dIQ folded before Flop (didn't bet)
Seat 2: 4dcDwIHRm96PwtqkpQiuiA folded before Flop (didn't bet)
Seat 3: ubtx4Z5L+AcK71MTvYiGVw (button) folded before Flop (didn't bet)
Seat 5: VvdR9F3I+2yELkfTVvC1dg (small blind) folded before Flop
Seat 6: uCqEjnxh2/vFBjKYkfTOkw (big blind) collected ($2)



PokerStars Game #59942127248:  Hold'em No Limit ($1/$2) - 2009/07/01 1:56:57 ET
Table 'NmY84NAf9Mh0ckAckHnh5g' 2-max Seat #2 is the button
Seat 1: 6hvg964TSqZ3AL/0XK9aVQ ($427.20 in chips)
Seat 2: RwDoM55ZeQuI2ADyJhOb2Q ($549.80 in chips)
RwDoM55ZeQuI2ADyJhOb2Q: posts small blind $1
6hvg964TSqZ3AL/0XK9aVQ: posts big blind $2
*** HOLE CARDS ***
RwDoM55ZeQuI2ADyJhOb2Q: raises $4 to $6
6hvg964TSqZ3AL/0XK9aVQ: raises $4 to $10
RwDoM55ZeQuI2ADyJhOb2Q: calls $4
*** FLOP *** [3d Ad 9c]
6hvg964TSqZ3AL/0XK9aVQ: checks
RwDoM55ZeQuI2ADyJhOb2Q: bets $12
6hvg964TSqZ3AL/0XK9aVQ: calls $12
*** TURN *** [3d Ad 9c] [Qc]
6hvg964TSqZ3AL/0XK9aVQ: checks
RwDoM55ZeQuI2ADyJhOb2Q: bets $22
6hvg964TSqZ3AL/0XK9aVQ: folds
RwDoM55ZeQuI2ADyJhOb2Q collected $43.50 from pot
RwDoM55ZeQuI2ADyJhOb2Q: doesn't show hand
*** SUMMARY ***
Total pot $44 | Rake $0.50
Board [3d Ad 9c Qc]
Seat 1: 6hvg964TSqZ3AL/0XK9aVQ (big blind) folded on the Turn
Seat 2: RwDoM55ZeQuI2ADyJhOb2Q (button) (small blind) collected ($43.50)



PokerStars Game #59942127880:  Hold'em No Limit ($1/$2) - 2009/07/01 1:56:58 ET
Table '7goFpXy7qyiK5mwx+Ucf6A' 6-max Seat #1 is the button
Seat 1: VHmJJYp7TGQwcWROQ8dqXw ($52.55 in chips)
Seat 2: BWhgxe7gWiYobRbwdG+d2Q ($196 in chips)
Seat 3: mfy7uGZcqA2PVQqEVbJ7+g ($149.25 in chips)
Seat 4: fE+LHW/7rpfXW14g8LhGjA ($44.40 in chips)
Seat 6: VvdR9F3I+2yELkfTVvC1dg ($212.65 in chips)
BWhgxe7gWiYobRbwdG+d2Q: posts small blind $1
mfy7uGZcqA2PVQqEVbJ7+g: posts big blind $2
vkfxu8f/jMYKUk6Ly4eujw: sits out
*** HOLE CARDS ***
fE+LHW/7rpfXW14g8LhGjA: calls $2
VvdR9F3I+2yELkfTVvC1dg: folds
VHmJJYp7TGQwcWROQ8dqXw: calls $2
BWhgxe7gWiYobRbwdG+d2Q: folds
mfy7uGZcqA2PVQqEVbJ7+g: checks
*** FLOP *** [Qd 5h Ac]
mfy7uGZcqA2PVQqEVbJ7+g: checks
fE+LHW/7rpfXW14g8LhGjA: bets $2
VHmJJYp7TGQwcWROQ8dqXw: raises $2 to $4
mfy7uGZcqA2PVQqEVbJ7+g: folds
fE+LHW/7rpfXW14g8LhGjA: raises $14 to $18
VHmJJYp7TGQwcWROQ8dqXw: folds
fE+LHW/7rpfXW14g8LhGjA collected $14.30 from pot
fE+LHW/7rpfXW14g8LhGjA: doesn't show hand
*** SUMMARY ***
Total pot $15 | Rake $0.70
Board [Qd 5h Ac]
Seat 1: VHmJJYp7TGQwcWROQ8dqXw (button) folded on the Flop
Seat 2: BWhgxe7gWiYobRbwdG+d2Q (small blind) folded before Flop
Seat 3: mfy7uGZcqA2PVQqEVbJ7+g (big blind) folded on the Flop
Seat 4: fE+LHW/7rpfXW14g8LhGjA collected ($14.30)
Seat 6: VvdR9F3I+2yELkfTVvC1dg folded before Flop (didn't bet)



PokerStars Game #59942127836:  Hold'em No Limit ($1/$2) - 2009/07/01 1:56:58 ET
Table 'eyAQSIlgc2o1Jxvbve4WGg' 9-max Seat #1 is the button
Seat 1: UZEsV9yKUMqmpYPiOFpaZw ($70 in chips)
Seat 2: kM9CA+2UcdMjbCMbtUCGiA ($228.05 in chips)
Seat 3: ice1Sbe19zWIaKYoSmE5tw ($98.30 in chips)
Seat 4: CkE3IyJF1KvdaAOmZY5XqQ ($200 in chips)
Seat 5: mIKx5lhIt13X5eZQH0ZeMA ($146.75 in chips)
Seat 7: u3OrI5uGx9mx1fE7dgr+EA ($104.80 in chips)
Seat 8: 254YPxPJr5Sw58bkD0YqYQ ($201 in chips)
Seat 9: WUlHm+ydPPHG7Lb0rePSdA ($122.20 in chips)
kM9CA+2UcdMjbCMbtUCGiA: posts small blind $1
ice1Sbe19zWIaKYoSmE5tw: posts big blind $2
*** HOLE CARDS ***
CkE3IyJF1KvdaAOmZY5XqQ: folds
mIKx5lhIt13X5eZQH0ZeMA: folds
u3OrI5uGx9mx1fE7dgr+EA: calls $2
254YPxPJr5Sw58bkD0YqYQ: folds
WUlHm+ydPPHG7Lb0rePSdA: folds
UZEsV9yKUMqmpYPiOFpaZw: folds
kM9CA+2UcdMjbCMbtUCGiA: folds
ice1Sbe19zWIaKYoSmE5tw: checks
*** FLOP *** [Kd 2h Kc]
ice1Sbe19zWIaKYoSmE5tw: checks
u3OrI5uGx9mx1fE7dgr+EA: bets $5
ice1Sbe19zWIaKYoSmE5tw: folds
u3OrI5uGx9mx1fE7dgr+EA collected $4.75 from pot
*** SUMMARY ***
Total pot $5 | Rake $0.25
Board [Kd 2h Kc]
Seat 1: UZEsV9yKUMqmpYPiOFpaZw (button) folded before Flop (didn't bet)
Seat 2: kM9CA+2UcdMjbCMbtUCGiA (small blind) folded before Flop
Seat 3: ice1Sbe19zWIaKYoSmE5tw (big blind) folded on the Flop
Seat 4: CkE3IyJF1KvdaAOmZY5XqQ folded before Flop (didn't bet)
Seat 5: mIKx5lhIt13X5eZQH0ZeMA folded before Flop (didn't bet)
Seat 7: u3OrI5uGx9mx1fE7dgr+EA collected ($4.75)
Seat 8: 254YPxPJr5Sw58bkD0YqYQ folded before Flop (didn't bet)
Seat 9: WUlHm+ydPPHG7Lb0rePSdA folded before Flop (didn't bet)



PokerStars Game #59942128326:  Hold'em No Limit ($1/$2) - 2009/07/01 1:56:59 ET
Table 'o63a8j70meKHUtgLFryQvg' 9-max Seat #8 is the button
Seat 1: +1R0op5O3Gf6aUPJTw7jjA ($197 in chips)
Seat 2: SgA0Zfa/3yhNp7ILXcXcCg ($116.30 in chips)
Seat 3: IYBKVnE2Basnr88BAhH+bQ ($265.40 in chips)
Seat 4: ZYHoLw2lWmRS7CSHi8L8Xg ($209.90 in chips)
Seat 5: g3ZVTc1EbSNXYYMO82jL7Q ($223.30 in chips)
Seat 6: CUZwDpLTQKhzarPe+JCLOQ ($200 in chips)
Seat 7: kM9CA+2UcdMjbCMbtUCGiA ($200 in chips)
Seat 8: ItDFe9gh5QYPQB9vC4ntUA ($384.05 in chips)
Seat 9: rW/MyplHylMSBRaoRUzWrg ($38 in chips)
rW/MyplHylMSBRaoRUzWrg: posts small blind $1
+1R0op5O3Gf6aUPJTw7jjA: posts big blind $2
*** HOLE CARDS ***
SgA0Zfa/3yhNp7ILXcXcCg: folds
IYBKVnE2Basnr88BAhH+bQ: folds
ZYHoLw2lWmRS7CSHi8L8Xg: folds
g3ZVTc1EbSNXYYMO82jL7Q: folds
CUZwDpLTQKhzarPe+JCLOQ: raises $5 to $7
kM9CA+2UcdMjbCMbtUCGiA: folds
ItDFe9gh5QYPQB9vC4ntUA: folds
rW/MyplHylMSBRaoRUzWrg: folds
+1R0op5O3Gf6aUPJTw7jjA: folds
CUZwDpLTQKhzarPe+JCLOQ collected $5 from pot
*** SUMMARY ***
Total pot $5 | Rake $0
Seat 1: +1R0op5O3Gf6aUPJTw7jjA (big blind) folded before Flop
Seat 2: SgA0Zfa/3yhNp7ILXcXcCg folded before Flop (didn't bet)
Seat 3: IYBKVnE2Basnr88BAhH+bQ folded before Flop (didn't bet)
Seat 4: ZYHoLw2lWmRS7CSHi8L8Xg folded before Flop (didn't bet)
Seat 5: g3ZVTc1EbSNXYYMO82jL7Q folded before Flop (didn't bet)
Seat 6: CUZwDpLTQKhzarPe+JCLOQ collected ($5)
Seat 7: kM9CA+2UcdMjbCMbtUCGiA folded before Flop (didn't bet)
Seat 8: ItDFe9gh5QYPQB9vC4ntUA (button) folded before Flop (didn't bet)
Seat 9: rW/MyplHylMSBRaoRUzWrg (small blind) folded before Flop



PokerStars Game #59942129038:  Hold'em No Limit ($1/$2) - 2009/07/01 1:57:01 ET
Table '4NGNnZ/osQfNq6abYqkJeA' 6-max Seat #5 is the button
Seat 1: 0Bc+WhbOvaaWIMmmui3q0g ($149.10 in chips)
Seat 2: 669iGNwYwgRZg3nhS+aDAQ ($104.75 in chips)
Seat 4: sY+4Uuh5z/6AbXXaCS10jw ($294.10 in chips)
Seat 5: VvdR9F3I+2yELkfTVvC1dg ($207.80 in chips)
Seat 6: /PH6Ffnho4Ysm8S3V/oa+w ($52.20 in chips)
/PH6Ffnho4Ysm8S3V/oa+w: posts small blind $1
0Bc+WhbOvaaWIMmmui3q0g: posts big blind $2
qXDd0ZyMIse0OBu8pxeQ3Q: sits out
*** HOLE CARDS ***
669iGNwYwgRZg3nhS+aDAQ: raises $6 to $8
sY+4Uuh5z/6AbXXaCS10jw: folds
VvdR9F3I+2yELkfTVvC1dg: folds
/PH6Ffnho4Ysm8S3V/oa+w: folds
0Bc+WhbOvaaWIMmmui3q0g: folds
669iGNwYwgRZg3nhS+aDAQ collected $5 from pot
*** SUMMARY ***
Total pot $5 | Rake $0
Seat 1: 0Bc+WhbOvaaWIMmmui3q0g (big blind) folded before Flop
Seat 2: 669iGNwYwgRZg3nhS+aDAQ collected ($5)
Seat 4: sY+4Uuh5z/6AbXXaCS10jw folded before Flop (didn't bet)
Seat 5: VvdR9F3I+2yELkfTVvC1dg (button) folded before Flop (didn't bet)
Seat 6: /PH6Ffnho4Ysm8S3V/oa+w (small blind) folded before Flop



PokerStars Game #59942130816:  Hold'em No Limit ($1/$2) - 2009/07/01 1:57:04 ET
Table '+hSnXFQrGw1PlVgTnuj+sA' 6-max Seat #1 is the button
Seat 1: fb8ooqw9ZsZtBsZTZQLNrQ ($54.05 in chips)
Seat 2: 54yWzRRgS0oZ+S6LwZBxMQ ($32 in chips)
Seat 3: vkfxu8f/jMYKUk6Ly4eujw ($200 in chips)
Seat 4: TRSUrOQh3x1NGeD+dH4yoA ($156.10 in chips)
Seat 5: PZzUwZiFNhCLi6Ouh5ZlmQ ($200 in chips)
Seat 6: 7zM38baFvmCNB/F80oE0cQ ($18.50 in chips)
54yWzRRgS0oZ+S6LwZBxMQ: posts small blind $1
vkfxu8f/jMYKUk6Ly4eujw: posts big blind $2
*** HOLE CARDS ***
TRSUrOQh3x1NGeD+dH4yoA: folds
PZzUwZiFNhCLi6Ouh5ZlmQ: folds
7zM38baFvmCNB/F80oE0cQ: calls $2
fb8ooqw9ZsZtBsZTZQLNrQ: folds
54yWzRRgS0oZ+S6LwZBxMQ: calls $1
vkfxu8f/jMYKUk6Ly4eujw: checks
*** FLOP *** [5d 6s Ah]
54yWzRRgS0oZ+S6LwZBxMQ: bets $4
vkfxu8f/jMYKUk6Ly4eujw: calls $4
7zM38baFvmCNB/F80oE0cQ: folds
*** TURN *** [5d 6s Ah] [5s]
54yWzRRgS0oZ+S6LwZBxMQ: bets $6
vkfxu8f/jMYKUk6Ly4eujw: calls $6
*** RIVER *** [5d 6s Ah 5s] [4d]
54yWzRRgS0oZ+S6LwZBxMQ: bets $18
vkfxu8f/jMYKUk6Ly4eujw: folds
54yWzRRgS0oZ+S6LwZBxMQ collected $24.75 from pot
54yWzRRgS0oZ+S6LwZBxMQ: doesn't show hand
*** SUMMARY ***
Total pot $26 | Rake $1.25
Board [5d 6s Ah 5s 4d]
Seat 1: fb8ooqw9ZsZtBsZTZQLNrQ (button) folded before Flop (didn't bet)
Seat 2: 54yWzRRgS0oZ+S6LwZBxMQ (small blind) collected ($24.75)
Seat 3: vkfxu8f/jMYKUk6Ly4eujw (big blind) folded on the River
Seat 4: TRSUrOQh3x1NGeD+dH4yoA folded before Flop (didn't bet)
Seat 5: PZzUwZiFNhCLi6Ouh5ZlmQ folded before Flop (didn't bet)
Seat 6: 7zM38baFvmCNB/F80oE0cQ folded on the Flop



PokerStars Game #59942131770:  Hold'em No Limit ($1/$2) - 2009/07/01 1:57:06 ET
Table 'xxAXogzmyuZKfe0LOYHaNQ' 2-max Seat #1 is the button
Seat 1: S14rjcU6LEC1LmuUtBK5Bg ($126 in chips)
Seat 2: ItDFe9gh5QYPQB9vC4ntUA ($200 in chips)
S14rjcU6LEC1LmuUtBK5Bg: posts small blind $1
ItDFe9gh5QYPQB9vC4ntUA: posts big blind $2
*** HOLE CARDS ***
S14rjcU6LEC1LmuUtBK5Bg: folds
ItDFe9gh5QYPQB9vC4ntUA collected $2 from pot
*** SUMMARY ***
Total pot $2 | Rake $0
Seat 1: S14rjcU6LEC1LmuUtBK5Bg (button) (small blind) folded before Flop
Seat 2: ItDFe9gh5QYPQB9vC4ntUA (big blind) collected ($2)



PokerStars Game #59942132148:  Hold'em No Limit ($1/$2) - 2009/07/01 1:57:07 ET
Table '/dyk+YdRGv90j2box35j8w' 6-max Seat #6 is the button
Seat 2: qCnEYuAE5y5A7bk6fO5/jQ ($489.20 in chips)
Seat 3: sTPOWERd9HWPCNrDBwsVjA ($215.50 in chips)
Seat 4: 4dMBh/1VTdeUTPCyhCs3UQ ($88.95 in chips)
Seat 5: VvdR9F3I+2yELkfTVvC1dg ($295.35 in chips)
Seat 6: C3qJBo7uxfFVDluE1lmK2w ($89.25 in chips)
qCnEYuAE5y5A7bk6fO5/jQ: posts small blind $1
sTPOWERd9HWPCNrDBwsVjA: posts big blind $2
*** HOLE CARDS ***
4dMBh/1VTdeUTPCyhCs3UQ: folds
VvdR9F3I+2yELkfTVvC1dg: folds
C3qJBo7uxfFVDluE1lmK2w: raises $4 to $6
qCnEYuAE5y5A7bk6fO5/jQ: folds
sTPOWERd9HWPCNrDBwsVjA: folds
C3qJBo7uxfFVDluE1lmK2w collected $5 from pot
*** SUMMARY ***
Total pot $5 | Rake $0
Seat 2: qCnEYuAE5y5A7bk6fO5/jQ (small blind) folded before Flop
Seat 3: sTPOWERd9HWPCNrDBwsVjA (big blind) folded before Flop
Seat 4: 4dMBh/1VTdeUTPCyhCs3UQ folded before Flop (didn't bet)
Seat 5: VvdR9F3I+2yELkfTVvC1dg folded before Flop (didn't bet)
Seat 6: C3qJBo7uxfFVDluE1lmK2w (button) collected ($5)



PokerStars Game #59942134514:  Hold'em No Limit ($1/$2) - 2009/07/01 1:57:11 ET
Table 'aSf77Sj8QEnzcc0WaxVD4Q' 6-max Seat #6 is the button
Seat 1: UELtvp+JfwI7XDGVwSxZXA ($170.55 in chips)
Seat 2: vkfxu8f/jMYKUk6Ly4eujw ($202 in chips)
Seat 4: YsLQ3BAvgQHWXMAv3Wv6Hg ($200 in chips)
Seat 5: VvdR9F3I+2yELkfTVvC1dg ($286.15 in chips)
Seat 6: vkoJRf3gidxY1pPi0AFWww ($194.85 in chips)
UELtvp+JfwI7XDGVwSxZXA: posts small blind $1
vkfxu8f/jMYKUk6Ly4eujw: posts big blind $2
3cPMpDMgeOMAe4UceUfLsg: sits out
*** HOLE CARDS ***
YsLQ3BAvgQHWXMAv3Wv6Hg: folds
VvdR9F3I+2yELkfTVvC1dg: raises $2 to $4
vkoJRf3gidxY1pPi0AFWww: folds
UELtvp+JfwI7XDGVwSxZXA: folds
vkfxu8f/jMYKUk6Ly4eujw: folds
VvdR9F3I+2yELkfTVvC1dg collected $5 from pot
VvdR9F3I+2yELkfTVvC1dg: doesn't show hand
*** SUMMARY ***
Total pot $5 | Rake $0
Seat 1: UELtvp+JfwI7XDGVwSxZXA (small blind) folded before Flop
Seat 2: vkfxu8f/jMYKUk6Ly4eujw (big blind) folded before Flop
Seat 4: YsLQ3BAvgQHWXMAv3Wv6Hg folded before Flop (didn't bet)
Seat 5: VvdR9F3I+2yELkfTVvC1dg collected ($5)
Seat 6: vkoJRf3gidxY1pPi0AFWww (button) folded before Flop (didn't bet)



PokerStars Game #59942134298:  Hold'em No Limit ($1/$2) - 2009/07/01 1:57:11 ET
Table 'WCA60bDA8ecovUgFSIZkTQ' 9-max Seat #9 is the button
Seat 1: 3RFwE6igZ1BGKOGuab6iiw ($77.65 in chips)
Seat 3: g7gL2NLJCdZPPV399WKT1w ($54.95 in chips)
Seat 4: IYBKVnE2Basnr88BAhH+bQ ($202.80 in chips)
Seat 5: A+9gcmwAl0eFxxbAwRY1OA ($246.10 in chips)
Seat 6: YoKKKdDDs7gFzP1Z65Sdaw ($94 in chips)
Seat 7: tsTv4D+ne2W0qhUt9HlcMw ($205.65 in chips)
Seat 8: mJhwEVg7F695DiO+RIhM5g ($242.45 in chips)
Seat 9: ItDFe9gh5QYPQB9vC4ntUA ($200 in chips)
3RFwE6igZ1BGKOGuab6iiw: posts small blind $1
TAfo4veNRaRlzDXMMYS3Jg: is sitting out
g7gL2NLJCdZPPV399WKT1w: posts big blind $2
*** HOLE CARDS ***
TAfo4veNRaRlzDXMMYS3Jg leaves the table
IYBKVnE2Basnr88BAhH+bQ: folds
A+9gcmwAl0eFxxbAwRY1OA: folds
YoKKKdDDs7gFzP1Z65Sdaw: folds
rW/MyplHylMSBRaoRUzWrg joins the table at seat #2
tsTv4D+ne2W0qhUt9HlcMw: raises $3 to $5
mJhwEVg7F695DiO+RIhM5g: folds
ItDFe9gh5QYPQB9vC4ntUA: raises $13 to $18
3RFwE6igZ1BGKOGuab6iiw: folds
g7gL2NLJCdZPPV399WKT1w: folds
A+9gcmwAl0eFxxbAwRY1OA leaves the table
+T/63sAeZzWyHchahJ36GQ joins the table at seat #5
tsTv4D+ne2W0qhUt9HlcMw: folds
ItDFe9gh5QYPQB9vC4ntUA collected $13 from pot
*** SUMMARY ***
Total pot $13 | Rake $0
Seat 1: 3RFwE6igZ1BGKOGuab6iiw (small blind) folded before Flop
Seat 3: g7gL2NLJCdZPPV399WKT1w (big blind) folded before Flop
Seat 4: IYBKVnE2Basnr88BAhH+bQ folded before Flop (didn't bet)
Seat 5: A+9gcmwAl0eFxxbAwRY1OA folded before Flop (didn't bet)
Seat 6: YoKKKdDDs7gFzP1Z65Sdaw folded before Flop (didn't bet)
Seat 7: tsTv4D+ne2W0qhUt9HlcMw folded before Flop
Seat 8: mJhwEVg7F695DiO+RIhM5g folded before Flop (didn't bet)
Seat 9: ItDFe9gh5QYPQB9vC4ntUA (button) collected ($13)



PokerStars Game #59942134244:  Hold'em No Limit ($1/$2) - 2009/07/01 1:57:11 ET
Table '5/wEe6JmtGD7vufSA2RG7A' 2-max Seat #1 is the button
Seat 1: pVqEzK9wXlRMECnb1Zg4Zw ($216.30 in chips)
Seat 2: aOL8geThaYp2iadSHl1h1g ($436 in chips)
pVqEzK9wXlRMECnb1Zg4Zw: posts small blind $1
aOL8geThaYp2iadSHl1h1g: posts big blind $2
*** HOLE CARDS ***
pVqEzK9wXlRMECnb1Zg4Zw: folds
aOL8geThaYp2iadSHl1h1g collected $2 from pot
aOL8geThaYp2iadSHl1h1g: doesn't show hand
*** SUMMARY ***
Total pot $2 | Rake $0
Seat 1: pVqEzK9wXlRMECnb1Zg4Zw (button) (small blind) folded before Flop
Seat 2: aOL8geThaYp2iadSHl1h1g (big blind) collected ($2)



PokerStars Game #59942135428:  Hold'em No Limit ($1/$2) - 2009/07/01 1:57:13 ET
Table 'xxAXogzmyuZKfe0LOYHaNQ' 2-max Seat #2 is the button
Seat 1: S14rjcU6LEC1LmuUtBK5Bg ($125 in chips)
Seat 2: ItDFe9gh5QYPQB9vC4ntUA ($201 in chips)
ItDFe9gh5QYPQB9vC4ntUA: posts small blind $1
S14rjcU6LEC1LmuUtBK5Bg: posts big blind $2
*** HOLE CARDS ***
ItDFe9gh5QYPQB9vC4ntUA: raises $2 to $4
S14rjcU6LEC1LmuUtBK5Bg: calls $2
*** FLOP *** [8c Ad Qs]
S14rjcU6LEC1LmuUtBK5Bg: checks
ItDFe9gh5QYPQB9vC4ntUA: bets $6
S14rjcU6LEC1LmuUtBK5Bg: folds
ItDFe9gh5QYPQB9vC4ntUA collected $7.60 from pot
*** SUMMARY ***
Total pot $8 | Rake $0.40
Board [8c Ad Qs]
Seat 1: S14rjcU6LEC1LmuUtBK5Bg (big blind) folded on the Flop
Seat 2: ItDFe9gh5QYPQB9vC4ntUA (button) (small blind) collected ($7.60)



PokerStars Game #59942136954:  Hold'em No Limit ($1/$2) - 2009/07/01 1:57:16 ET
Table 'UGLAZZyv+cXmnKjYin0etA' 6-max Seat #5 is the button
Seat 1: rL+Zpv4/vX2BVHcyfh/NXA ($208.25 in chips)
Seat 2: eDLH1PUXFpvJBNMXBVQcGA ($294.10 in chips)
Seat 3: Nsjun4mjI8q0SSBTIp1dIQ ($229 in chips)
Seat 4: SiGJDsvRViJX05vHhA80GQ ($246.75 in chips)
Seat 5: 54yWzRRgS0oZ+S6LwZBxMQ ($34.80 in chips)
Seat 6: sTPOWERd9HWPCNrDBwsVjA ($177.95 in chips)
sTPOWERd9HWPCNrDBwsVjA: posts small blind $1
rL+Zpv4/vX2BVHcyfh/NXA: posts big blind $2
*** HOLE CARDS ***
eDLH1PUXFpvJBNMXBVQcGA: folds
Nsjun4mjI8q0SSBTIp1dIQ: folds
SiGJDsvRViJX05vHhA80GQ: folds
54yWzRRgS0oZ+S6LwZBxMQ: folds
sTPOWERd9HWPCNrDBwsVjA: raises $4 to $6
rL+Zpv4/vX2BVHcyfh/NXA: folds
sTPOWERd9HWPCNrDBwsVjA collected $4 from pot
*** SUMMARY ***
Total pot $4 | Rake $0
Seat 1: rL+Zpv4/vX2BVHcyfh/NXA (big blind) folded before Flop
Seat 2: eDLH1PUXFpvJBNMXBVQcGA folded before Flop (didn't bet)
Seat 3: Nsjun4mjI8q0SSBTIp1dIQ folded before Flop (didn't bet)
Seat 4: SiGJDsvRViJX05vHhA80GQ folded before Flop (didn't bet)
Seat 5: 54yWzRRgS0oZ+S6LwZBxMQ (button) folded before Flop (didn't bet)
Seat 6: sTPOWERd9HWPCNrDBwsVjA (small blind) collected ($4)



PokerStars Game #59942138018:  Hold'em No Limit ($1/$2) - 2009/07/01 1:57:18 ET
Table '5/wEe6JmtGD7vufSA2RG7A' 2-max Seat #2 is the button
Seat 1: pVqEzK9wXlRMECnb1Zg4Zw ($215.30 in chips)
Seat 2: aOL8geThaYp2iadSHl1h1g ($437 in chips)
aOL8geThaYp2iadSHl1h1g: posts small blind $1
pVqEzK9wXlRMECnb1Zg4Zw: posts big blind $2
*** HOLE CARDS ***
aOL8geThaYp2iadSHl1h1g: folds
pVqEzK9wXlRMECnb1Zg4Zw collected $2 from pot
pVqEzK9wXlRMECnb1Zg4Zw: doesn't show hand
*** SUMMARY ***
Total pot $2 | Rake $0
Seat 1: pVqEzK9wXlRMECnb1Zg4Zw (big blind) collected ($2)
Seat 2: aOL8geThaYp2iadSHl1h1g (button) (small blind) folded before Flop



PokerStars Game #59942138134:  Hold'em No Limit ($1/$2) - 2009/07/01 1:57:18 ET
Table 'P/yCfYl1GfGsu/e6DxDy/A' 2-max Seat #1 is the button
Seat 1: 7fOCUy3x9hdkmXkkDNolGQ ($1068.50 in chips)
Seat 2: RwDoM55ZeQuI2ADyJhOb2Q ($397.50 in chips)
7fOCUy3x9hdkmXkkDNolGQ: posts small blind $1
RwDoM55ZeQuI2ADyJhOb2Q: posts big blind $2
*** HOLE CARDS ***
7fOCUy3x9hdkmXkkDNolGQ: raises $4 to $6
RwDoM55ZeQuI2ADyJhOb2Q: folds
7fOCUy3x9hdkmXkkDNolGQ collected $4 from pot
7fOCUy3x9hdkmXkkDNolGQ: doesn't show hand
*** SUMMARY ***
Total pot $4 | Rake $0
Seat 1: 7fOCUy3x9hdkmXkkDNolGQ (button) (small blind) collected ($4)
Seat 2: RwDoM55ZeQuI2ADyJhOb2Q (big blind) folded before Flop



PokerStars Game #59942138406:  Hold'em No Limit ($1/$2) - 2009/07/01 1:57:19 ET
Table 'gnHBqWll9O3fxG7Ojkz/ng' 9-max Seat #8 is the button
Seat 1: MtdNf9cdM7+0CSU0dx4USA ($77.35 in chips)
Seat 2: H6Z4+qu8gR0VUiPOijndVg ($335.30 in chips)
Seat 3: 5Q8U6iZbeO7xJSS4qvDP5g ($250.15 in chips)
Seat 5: rBQDMkKm9cZn6M9NPsiVew ($166.15 in chips)
Seat 6: KqHysDSpCPaPyK3tJC1aEw ($200 in chips)
Seat 7: 254YPxPJr5Sw58bkD0YqYQ ($200 in chips)
Seat 8: cM6efHzdxoqYm0EQKP4TTQ ($130.70 in chips)
Seat 9: GX1heJ+DSsvm7gzSPsYhhQ ($54.55 in chips)
GX1heJ+DSsvm7gzSPsYhhQ: posts small blind $1
MtdNf9cdM7+0CSU0dx4USA: posts big blind $2
*** HOLE CARDS ***
H6Z4+qu8gR0VUiPOijndVg: folds
5Q8U6iZbeO7xJSS4qvDP5g: folds
rBQDMkKm9cZn6M9NPsiVew: folds
KqHysDSpCPaPyK3tJC1aEw: folds
254YPxPJr5Sw58bkD0YqYQ: folds
cM6efHzdxoqYm0EQKP4TTQ: calls $2
GX1heJ+DSsvm7gzSPsYhhQ: folds
MtdNf9cdM7+0CSU0dx4USA: checks
*** FLOP *** [5d 3h Kd]
MtdNf9cdM7+0CSU0dx4USA: checks
cM6efHzdxoqYm0EQKP4TTQ: checks
*** TURN *** [5d 3h Kd] [3s]
MtdNf9cdM7+0CSU0dx4USA: checks
cM6efHzdxoqYm0EQKP4TTQ: checks
*** RIVER *** [5d 3h Kd 3s] [Qd]
MtdNf9cdM7+0CSU0dx4USA: checks
cM6efHzdxoqYm0EQKP4TTQ: checks
*** SHOW DOWN ***
MtdNf9cdM7+0CSU0dx4USA: shows [9s As] (a pair of Threes)
cM6efHzdxoqYm0EQKP4TTQ: shows [2h Ac] (a pair of Threes)
MtdNf9cdM7+0CSU0dx4USA collected $2.40 from pot
cM6efHzdxoqYm0EQKP4TTQ collected $2.35 from pot
*** SUMMARY ***
Total pot $5 | Rake $0.25
Board [5d 3h Kd 3s Qd]
Seat 1: MtdNf9cdM7+0CSU0dx4USA (big blind) showed [9s As] and won ($2.40) with a pair of Threes
Seat 2: H6Z4+qu8gR0VUiPOijndVg folded before Flop (didn't bet)
Seat 3: 5Q8U6iZbeO7xJSS4qvDP5g folded before Flop (didn't bet)
Seat 5: rBQDMkKm9cZn6M9NPsiVew folded before Flop (didn't bet)
Seat 6: KqHysDSpCPaPyK3tJC1aEw folded before Flop (didn't bet)
Seat 7: 254YPxPJr5Sw58bkD0YqYQ folded before Flop (didn't bet)
Seat 8: cM6efHzdxoqYm0EQKP4TTQ (button) showed [2h Ac] and won ($2.35) with a pair of Threes
Seat 9: GX1heJ+DSsvm7gzSPsYhhQ (small blind) folded before Flop



PokerStars Game #59942140074:  Hold'em No Limit ($1/$2) - 2009/07/01 1:57:22 ET
Table 'QxerF7GUfCbl+4a8XaTB2w' 6-max Seat #1 is the button
Seat 1: ZwvXzkkZ3XpMhKfAmVpahw ($282.25 in chips)
Seat 2: 6UGgYbxwWNc+ohObe8vB9w ($87.30 in chips)
Seat 3: 8rZGabKe2DEPdZCbCivZ9Q ($25.80 in chips)
Seat 4: /PH6Ffnho4Ysm8S3V/oa+w ($46 in chips)
Seat 5: vkfxu8f/jMYKUk6Ly4eujw ($149.05 in chips)
Seat 6: VvdR9F3I+2yELkfTVvC1dg ($218.10 in chips)
6UGgYbxwWNc+ohObe8vB9w: posts small blind $1
8rZGabKe2DEPdZCbCivZ9Q: posts big blind $2
*** HOLE CARDS ***
/PH6Ffnho4Ysm8S3V/oa+w: raises $2 to $4
vkfxu8f/jMYKUk6Ly4eujw: folds
VvdR9F3I+2yELkfTVvC1dg: folds
ZwvXzkkZ3XpMhKfAmVpahw: calls $4
6UGgYbxwWNc+ohObe8vB9w: folds
8rZGabKe2DEPdZCbCivZ9Q: calls $2
*** FLOP *** [Th Ad 4c]
8rZGabKe2DEPdZCbCivZ9Q: checks
/PH6Ffnho4Ysm8S3V/oa+w: checks
ZwvXzkkZ3XpMhKfAmVpahw: bets $8
8rZGabKe2DEPdZCbCivZ9Q: raises $13.80 to $21.80 and is all-in
/PH6Ffnho4Ysm8S3V/oa+w: folds
ZwvXzkkZ3XpMhKfAmVpahw: calls $13.80
*** TURN *** [Th Ad 4c] [9h]
*** RIVER *** [Th Ad 4c 9h] [Ks]
*** SHOW DOWN ***
8rZGabKe2DEPdZCbCivZ9Q: shows [As 4h] (two pair, Aces and Fours)
ZwvXzkkZ3XpMhKfAmVpahw: mucks hand
8rZGabKe2DEPdZCbCivZ9Q collected $53.85 from pot
*** SUMMARY ***
Total pot $56.60 | Rake $2.75
Board [Th Ad 4c 9h Ks]
Seat 1: ZwvXzkkZ3XpMhKfAmVpahw (button) mucked
Seat 2: 6UGgYbxwWNc+ohObe8vB9w (small blind) folded before Flop
Seat 3: 8rZGabKe2DEPdZCbCivZ9Q (big blind) showed [As 4h] and won ($53.85) with two pair, Aces and Fours
Seat 4: /PH6Ffnho4Ysm8S3V/oa+w folded on the Flop
Seat 5: vkfxu8f/jMYKUk6Ly4eujw folded before Flop (didn't bet)
Seat 6: VvdR9F3I+2yELkfTVvC1dg folded before Flop (didn't bet)



PokerStars Game #59942140884:  Hold'em No Limit ($1/$2) - 2009/07/01 1:57:23 ET
Table 'W9UeSV0aoPjh5SFSxM8jUQ' 9-max Seat #7 is the button
Seat 1: mIKx5lhIt13X5eZQH0ZeMA ($6.85 in chips)
Seat 2: KqHysDSpCPaPyK3tJC1aEw ($207.05 in chips)
Seat 3: ItDFe9gh5QYPQB9vC4ntUA ($203 in chips)
Seat 4: 4YA/sQy1Emm680zhbPUjow ($149.60 in chips)
Seat 6: 254YPxPJr5Sw58bkD0YqYQ ($213.70 in chips)
Seat 7: TAfo4veNRaRlzDXMMYS3Jg ($39 in chips)
Seat 8: odhvI/CZeMsPyo1n1U7+hA ($47.10 in chips)
Seat 9: Q104K4iDGcqOlVrjAkzPEA ($99.30 in chips)
odhvI/CZeMsPyo1n1U7+hA: posts small blind $1
Q104K4iDGcqOlVrjAkzPEA: posts big blind $2
ZYHoLw2lWmRS7CSHi8L8Xg: sits out
*** HOLE CARDS ***
mIKx5lhIt13X5eZQH0ZeMA: folds
KqHysDSpCPaPyK3tJC1aEw: folds
ItDFe9gh5QYPQB9vC4ntUA: folds
4YA/sQy1Emm680zhbPUjow: folds
254YPxPJr5Sw58bkD0YqYQ: folds
TAfo4veNRaRlzDXMMYS3Jg: folds
odhvI/CZeMsPyo1n1U7+hA: calls $1
Q104K4iDGcqOlVrjAkzPEA: checks
*** FLOP *** [Qc 3s Kd]
odhvI/CZeMsPyo1n1U7+hA: bets $2
Q104K4iDGcqOlVrjAkzPEA: raises $4 to $6
odhvI/CZeMsPyo1n1U7+hA: folds
Q104K4iDGcqOlVrjAkzPEA collected $7.65 from pot
*** SUMMARY ***
Total pot $8 | Rake $0.35
Board [Qc 3s Kd]
Seat 1: mIKx5lhIt13X5eZQH0ZeMA folded before Flop (didn't bet)
Seat 2: KqHysDSpCPaPyK3tJC1aEw folded before Flop (didn't bet)
Seat 3: ItDFe9gh5QYPQB9vC4ntUA folded before Flop (didn't bet)
Seat 4: 4YA/sQy1Emm680zhbPUjow folded before Flop (didn't bet)
Seat 6: 254YPxPJr5Sw58bkD0YqYQ folded before Flop (didn't bet)
Seat 7: TAfo4veNRaRlzDXMMYS3Jg (button) folded before Flop (didn't bet)
Seat 8: odhvI/CZeMsPyo1n1U7+hA (small blind) folded on the Flop
Seat 9: Q104K4iDGcqOlVrjAkzPEA (big blind) collected ($7.65)



PokerStars Game #59942141932:  Hold'em No Limit ($1/$2) - 2009/07/01 1:57:25 ET
Table '5/wEe6JmtGD7vufSA2RG7A' 2-max Seat #1 is the button
Seat 1: pVqEzK9wXlRMECnb1Zg4Zw ($216.30 in chips)
Seat 2: aOL8geThaYp2iadSHl1h1g ($436 in chips)
pVqEzK9wXlRMECnb1Zg4Zw: posts small blind $1
aOL8geThaYp2iadSHl1h1g: posts big blind $2
*** HOLE CARDS ***
pVqEzK9wXlRMECnb1Zg4Zw: raises $6 to $8
aOL8geThaYp2iadSHl1h1g: folds
pVqEzK9wXlRMECnb1Zg4Zw collected $4 from pot
pVqEzK9wXlRMECnb1Zg4Zw: doesn't show hand
*** SUMMARY ***
Total pot $4 | Rake $0
Seat 1: pVqEzK9wXlRMECnb1Zg4Zw (button) (small blind) collected ($4)
Seat 2: aOL8geThaYp2iadSHl1h1g (big blind) folded before Flop



PokerStars Game #59942142338:  Hold'em No Limit ($1/$2) - 2009/07/01 1:57:26 ET
Table '3WCXyaiCAbqSShQu7FIjvA' 9-max Seat #2 is the button
Seat 1: kTCkABD1UUldS9DFRGfCwQ ($141.25 in chips)
Seat 2: 254YPxPJr5Sw58bkD0YqYQ ($200 in chips)
Seat 3: 5Q8U6iZbeO7xJSS4qvDP5g ($245.25 in chips)
Seat 4: waEF/+pxZTxNo4FvsORuXg ($101.40 in chips)
Seat 5: CkE3IyJF1KvdaAOmZY5XqQ ($207.90 in chips)
Seat 6: 5jQlngvMSqM/WoonOcR5kw ($277.50 in chips)
Seat 8: +T/63sAeZzWyHchahJ36GQ ($34 in chips)
Seat 9: FiXPLJyqb24l32QST2TInw ($138 in chips)
5Q8U6iZbeO7xJSS4qvDP5g: posts small blind $1
waEF/+pxZTxNo4FvsORuXg: posts big blind $2
*** HOLE CARDS ***
CkE3IyJF1KvdaAOmZY5XqQ: folds
5jQlngvMSqM/WoonOcR5kw: folds
+T/63sAeZzWyHchahJ36GQ: folds
FiXPLJyqb24l32QST2TInw: folds
kTCkABD1UUldS9DFRGfCwQ: raises $2 to $4
254YPxPJr5Sw58bkD0YqYQ: folds
5Q8U6iZbeO7xJSS4qvDP5g: folds
waEF/+pxZTxNo4FvsORuXg: folds
kTCkABD1UUldS9DFRGfCwQ collected $5 from pot
kTCkABD1UUldS9DFRGfCwQ: doesn't show hand
*** SUMMARY ***
Total pot $5 | Rake $0
Seat 1: kTCkABD1UUldS9DFRGfCwQ collected ($5)
Seat 2: 254YPxPJr5Sw58bkD0YqYQ (button) folded before Flop (didn't bet)
Seat 3: 5Q8U6iZbeO7xJSS4qvDP5g (small blind) folded before Flop
Seat 4: waEF/+pxZTxNo4FvsORuXg (big blind) folded before Flop
Seat 5: CkE3IyJF1KvdaAOmZY5XqQ folded before Flop (didn't bet)
Seat 6: 5jQlngvMSqM/WoonOcR5kw folded before Flop (didn't bet)
Seat 8: +T/63sAeZzWyHchahJ36GQ folded before Flop (didn't bet)
Seat 9: FiXPLJyqb24l32QST2TInw folded before Flop (didn't bet)



PokerStars Game #59942142488:  Hold'em No Limit ($1/$2) - 2009/07/01 1:57:27 ET
Table 'mGpP9StWRnoeiBDExc6Frg' 6-max Seat #4 is the button
Seat 1: VvdR9F3I+2yELkfTVvC1dg ($386.25 in chips)
Seat 2: 6hRJ68JkbJq6MYI9o5bUnQ ($98 in chips)
Seat 3: mddoKnqZkdOH7AJOJ/i0DA ($206 in chips)
Seat 4: 4dcDwIHRm96PwtqkpQiuiA ($81.70 in chips)
Seat 5: d1puGuVBE0fidn+5eRJ0tw ($100.50 in chips)
Seat 6: B2Ih1sr5VZk+8He7rcrMtQ ($425.15 in chips)
d1puGuVBE0fidn+5eRJ0tw: posts small blind $1
B2Ih1sr5VZk+8He7rcrMtQ: posts big blind $2
*** HOLE CARDS ***
VvdR9F3I+2yELkfTVvC1dg: folds
6hRJ68JkbJq6MYI9o5bUnQ: calls $2
mddoKnqZkdOH7AJOJ/i0DA: raises $6 to $8
4dcDwIHRm96PwtqkpQiuiA: folds
d1puGuVBE0fidn+5eRJ0tw: folds
B2Ih1sr5VZk+8He7rcrMtQ: calls $6
6hRJ68JkbJq6MYI9o5bUnQ: calls $6
*** FLOP *** [Ts Ad 4s]
B2Ih1sr5VZk+8He7rcrMtQ: checks
6hRJ68JkbJq6MYI9o5bUnQ: checks
mddoKnqZkdOH7AJOJ/i0DA: checks
*** TURN *** [Ts Ad 4s] [3h]
B2Ih1sr5VZk+8He7rcrMtQ: bets $20
6hRJ68JkbJq6MYI9o5bUnQ: folds
mddoKnqZkdOH7AJOJ/i0DA: calls $20
*** RIVER *** [Ts Ad 4s 3h] [2s]
B2Ih1sr5VZk+8He7rcrMtQ: checks
mddoKnqZkdOH7AJOJ/i0DA: checks
*** SHOW DOWN ***
B2Ih1sr5VZk+8He7rcrMtQ: shows [5c 5h] (a straight, Ace to Five)
mddoKnqZkdOH7AJOJ/i0DA: mucks hand
B2Ih1sr5VZk+8He7rcrMtQ collected $62 from pot
*** SUMMARY ***
Total pot $65 | Rake $3
Board [Ts Ad 4s 3h 2s]
Seat 1: VvdR9F3I+2yELkfTVvC1dg folded before Flop (didn't bet)
Seat 2: 6hRJ68JkbJq6MYI9o5bUnQ folded on the Turn
Seat 3: mddoKnqZkdOH7AJOJ/i0DA mucked
Seat 4: 4dcDwIHRm96PwtqkpQiuiA (button) folded before Flop (didn't bet)
Seat 5: d1puGuVBE0fidn+5eRJ0tw (small blind) folded before Flop
Seat 6: B2Ih1sr5VZk+8He7rcrMtQ (big blind) showed [5c 5h] and won ($62) with a straight, Ace to Five



PokerStars Game #59942142758:  Hold'em No Limit ($1/$2) - 2009/07/01 1:57:27 ET
Table 'P/yCfYl1GfGsu/e6DxDy/A' 2-max Seat #2 is the button
Seat 1: 7fOCUy3x9hdkmXkkDNolGQ ($1070.50 in chips)
Seat 2: RwDoM55ZeQuI2ADyJhOb2Q ($395.50 in chips)
RwDoM55ZeQuI2ADyJhOb2Q: posts small blind $1
7fOCUy3x9hdkmXkkDNolGQ: posts big blind $2
*** HOLE CARDS ***
RwDoM55ZeQuI2ADyJhOb2Q: raises $4 to $6
7fOCUy3x9hdkmXkkDNolGQ: folds
RwDoM55ZeQuI2ADyJhOb2Q collected $4 from pot
RwDoM55ZeQuI2ADyJhOb2Q: doesn't show hand
*** SUMMARY ***
Total pot $4 | Rake $0
Seat 1: 7fOCUy3x9hdkmXkkDNolGQ (big blind) folded before Flop
Seat 2: RwDoM55ZeQuI2ADyJhOb2Q (button) (small blind) collected ($4)



PokerStars Game #59942143614:  Hold'em No Limit ($1/$2) - 2009/07/01 1:57:29 ET
Table 'G1Oqdy4Pqdb5gtx40rUBzA' 6-max Seat #5 is the button
Seat 1: 4dMBh/1VTdeUTPCyhCs3UQ ($45.05 in chips)
Seat 2: m7mYVfnCOK5TE/VkN/FhOg ($231.75 in chips)
Seat 3: VvdR9F3I+2yELkfTVvC1dg ($415.90 in chips)
Seat 4: B87ikIyZ/TzAVeXf38Ny0g ($200 in chips)
Seat 5: F1+Ml47qRQWunzPnGhLLzQ ($228.75 in chips)
Seat 6: qCnEYuAE5y5A7bk6fO5/jQ ($200 in chips)
qCnEYuAE5y5A7bk6fO5/jQ: posts small blind $1
4dMBh/1VTdeUTPCyhCs3UQ: posts big blind $2
*** HOLE CARDS ***
m7mYVfnCOK5TE/VkN/FhOg: folds
VvdR9F3I+2yELkfTVvC1dg: raises $2 to $4
B87ikIyZ/TzAVeXf38Ny0g: folds
F1+Ml47qRQWunzPnGhLLzQ: raises $8 to $12
qCnEYuAE5y5A7bk6fO5/jQ: folds
4dMBh/1VTdeUTPCyhCs3UQ: folds
VvdR9F3I+2yELkfTVvC1dg: folds
F1+Ml47qRQWunzPnGhLLzQ collected $11 from pot
F1+Ml47qRQWunzPnGhLLzQ: doesn't show hand
*** SUMMARY ***
Total pot $11 | Rake $0
Seat 1: 4dMBh/1VTdeUTPCyhCs3UQ (big blind) folded before Flop
Seat 2: m7mYVfnCOK5TE/VkN/FhOg folded before Flop (didn't bet)
Seat 3: VvdR9F3I+2yELkfTVvC1dg folded before Flop
Seat 4: B87ikIyZ/TzAVeXf38Ny0g folded before Flop (didn't bet)
Seat 5: F1+Ml47qRQWunzPnGhLLzQ (button) collected ($11)
Seat 6: qCnEYuAE5y5A7bk6fO5/jQ (small blind) folded before Flop



PokerStars Game #59942143942:  Hold'em No Limit ($1/$2) - 2009/07/01 1:57:29 ET
Table '4NGNnZ/osQfNq6abYqkJeA' 6-max Seat #6 is the button
Seat 1: 0Bc+WhbOvaaWIMmmui3q0g ($147.10 in chips)
Seat 2: 669iGNwYwgRZg3nhS+aDAQ ($107.75 in chips)
Seat 4: sY+4Uuh5z/6AbXXaCS10jw ($294.10 in chips)
Seat 5: VvdR9F3I+2yELkfTVvC1dg ($207.80 in chips)
Seat 6: /PH6Ffnho4Ysm8S3V/oa+w ($51.20 in chips)
0Bc+WhbOvaaWIMmmui3q0g: posts small blind $1
669iGNwYwgRZg3nhS+aDAQ: posts big blind $2
qXDd0ZyMIse0OBu8pxeQ3Q: sits out
*** HOLE CARDS ***
sY+4Uuh5z/6AbXXaCS10jw: folds
VvdR9F3I+2yELkfTVvC1dg: raises $2 to $4
/PH6Ffnho4Ysm8S3V/oa+w: folds
0Bc+WhbOvaaWIMmmui3q0g: folds
669iGNwYwgRZg3nhS+aDAQ: folds
VvdR9F3I+2yELkfTVvC1dg collected $5 from pot
VvdR9F3I+2yELkfTVvC1dg: doesn't show hand
*** SUMMARY ***
Total pot $5 | Rake $0
Seat 1: 0Bc+WhbOvaaWIMmmui3q0g (small blind) folded before Flop
Seat 2: 669iGNwYwgRZg3nhS+aDAQ (big blind) folded before Flop
Seat 4: sY+4Uuh5z/6AbXXaCS10jw folded before Flop (didn't bet)
Seat 5: VvdR9F3I+2yELkfTVvC1dg collected ($5)
Seat 6: /PH6Ffnho4Ysm8S3V/oa+w (button) folded before Flop (didn't bet)



PokerStars Game #59942146322:  Hold'em No Limit ($1/$2) - 2009/07/01 1:57:34 ET
Table 'rsKRKlGHlxVyqJxzO2a2Ow' 9-max Seat #5 is the button
Seat 1: KqHysDSpCPaPyK3tJC1aEw ($212.30 in chips)
Seat 3: kM9CA+2UcdMjbCMbtUCGiA ($200 in chips)
Seat 4: 31HuO+DQxppUQEedBWukug ($133.10 in chips)
Seat 5: 5Q8U6iZbeO7xJSS4qvDP5g ($250.55 in chips)
Seat 6: H6Z4+qu8gR0VUiPOijndVg ($201 in chips)
Seat 7: GX1heJ+DSsvm7gzSPsYhhQ ($53 in chips)
Seat 8: CkE3IyJF1KvdaAOmZY5XqQ ($206.70 in chips)
Seat 9: gRbvhSUVg+TNaTjaJecIRw ($53.60 in chips)
H6Z4+qu8gR0VUiPOijndVg: posts small blind $1
GX1heJ+DSsvm7gzSPsYhhQ: posts big blind $2
254YPxPJr5Sw58bkD0YqYQ: sits out
*** HOLE CARDS ***
CkE3IyJF1KvdaAOmZY5XqQ has timed out
CkE3IyJF1KvdaAOmZY5XqQ: folds
CkE3IyJF1KvdaAOmZY5XqQ is sitting out
gRbvhSUVg+TNaTjaJecIRw: folds
KqHysDSpCPaPyK3tJC1aEw: folds
kM9CA+2UcdMjbCMbtUCGiA: folds
CkE3IyJF1KvdaAOmZY5XqQ has returned
31HuO+DQxppUQEedBWukug: folds
5Q8U6iZbeO7xJSS4qvDP5g: folds
H6Z4+qu8gR0VUiPOijndVg: folds
GX1heJ+DSsvm7gzSPsYhhQ collected $2 from pot
GX1heJ+DSsvm7gzSPsYhhQ: doesn't show hand
*** SUMMARY ***
Total pot $2 | Rake $0
Seat 1: KqHysDSpCPaPyK3tJC1aEw folded before Flop (didn't bet)
Seat 3: kM9CA+2UcdMjbCMbtUCGiA folded before Flop (didn't bet)
Seat 4: 31HuO+DQxppUQEedBWukug folded before Flop (didn't bet)
Seat 5: 5Q8U6iZbeO7xJSS4qvDP5g (button) folded before Flop (didn't bet)
Seat 6: H6Z4+qu8gR0VUiPOijndVg (small blind) folded before Flop
Seat 7: GX1heJ+DSsvm7gzSPsYhhQ (big blind) collected ($2)
Seat 8: CkE3IyJF1KvdaAOmZY5XqQ folded before Flop (didn't bet)
Seat 9: gRbvhSUVg+TNaTjaJecIRw folded before Flop (didn't bet)



PokerStars Game #59942146472:  Hold'em No Limit ($1/$2) - 2009/07/01 1:57:34 ET
Table 'LL4bDFyhj5hsMpzaDugJZg' 6-max Seat #3 is the button
Seat 1: ubtx4Z5L+AcK71MTvYiGVw ($200 in chips)
Seat 2: TMPDCBmlFGM9C+H58PC4sQ ($41.15 in chips)
Seat 3: opJMdoq0E6TRbAQiweyQuA ($37 in chips)
Seat 4: 8srN1dKQePlsv0GyTada+Q ($390.60 in chips)
Seat 5: SZwM+UmIX32Re10mzQ4w/w ($62.60 in chips)
Seat 6: mddoKnqZkdOH7AJOJ/i0DA ($209.30 in chips)
8srN1dKQePlsv0GyTada+Q: posts small blind $1
SZwM+UmIX32Re10mzQ4w/w: posts big blind $2
*** HOLE CARDS ***
mddoKnqZkdOH7AJOJ/i0DA: folds
ubtx4Z5L+AcK71MTvYiGVw: folds
TMPDCBmlFGM9C+H58PC4sQ: folds
opJMdoq0E6TRbAQiweyQuA: raises $2 to $4
8srN1dKQePlsv0GyTada+Q: folds
SZwM+UmIX32Re10mzQ4w/w: calls $2
*** FLOP *** [Jd Qh 6h]
SZwM+UmIX32Re10mzQ4w/w: checks
opJMdoq0E6TRbAQiweyQuA: bets $4
SZwM+UmIX32Re10mzQ4w/w: folds
opJMdoq0E6TRbAQiweyQuA collected $8.55 from pot
*** SUMMARY ***
Total pot $9 | Rake $0.45
Board [Jd Qh 6h]
Seat 1: ubtx4Z5L+AcK71MTvYiGVw folded before Flop (didn't bet)
Seat 2: TMPDCBmlFGM9C+H58PC4sQ folded before Flop (didn't bet)
Seat 3: opJMdoq0E6TRbAQiweyQuA (button) collected ($8.55)
Seat 4: 8srN1dKQePlsv0GyTada+Q (small blind) folded before Flop
Seat 5: SZwM+UmIX32Re10mzQ4w/w (big blind) folded on the Flop
Seat 6: mddoKnqZkdOH7AJOJ/i0DA folded before Flop (didn't bet)



PokerStars Game #59942146470:  Hold'em No Limit ($1/$2) - 2009/07/01 1:57:34 ET
Table 'jlrIxbrVIG+gjaUYT4za8g' 6-max Seat #1 is the button
Seat 1: opJMdoq0E6TRbAQiweyQuA ($37 in chips)
Seat 2: cwfuMyvDC7J7SqX2leDC8g ($59 in chips)
Seat 4: 8srN1dKQePlsv0GyTada+Q ($309.80 in chips)
Seat 5: AyBB0k3Dcl7xbXUeGMw06g ($123.50 in chips)
cwfuMyvDC7J7SqX2leDC8g: posts small blind $1
8srN1dKQePlsv0GyTada+Q: posts big blind $2
*** HOLE CARDS ***
Bv3000 joins the table at seat #6
AyBB0k3Dcl7xbXUeGMw06g: folds
opJMdoq0E6TRbAQiweyQuA: folds
cwfuMyvDC7J7SqX2leDC8g: calls $1
8srN1dKQePlsv0GyTada+Q: raises $6 to $8
cwfuMyvDC7J7SqX2leDC8g: folds
8srN1dKQePlsv0GyTada+Q collected $4 from pot
*** SUMMARY ***
Total pot $4 | Rake $0
Seat 1: opJMdoq0E6TRbAQiweyQuA (button) folded before Flop (didn't bet)
Seat 2: cwfuMyvDC7J7SqX2leDC8g (small blind) folded before Flop
Seat 4: 8srN1dKQePlsv0GyTada+Q (big blind) collected ($4)
Seat 5: AyBB0k3Dcl7xbXUeGMw06g folded before Flop (didn't bet)



PokerStars Game #59942146278:  Hold'em No Limit ($1/$2) - 2009/07/01 1:57:34 ET
Table 'NmY84NAf9Mh0ckAckHnh5g' 2-max Seat #1 is the button
Seat 1: 6hvg964TSqZ3AL/0XK9aVQ ($405.20 in chips)
Seat 2: RwDoM55ZeQuI2ADyJhOb2Q ($571.30 in chips)
6hvg964TSqZ3AL/0XK9aVQ: posts small blind $1
RwDoM55ZeQuI2ADyJhOb2Q: posts big blind $2
*** HOLE CARDS ***
6hvg964TSqZ3AL/0XK9aVQ: folds
RwDoM55ZeQuI2ADyJhOb2Q collected $2 from pot
RwDoM55ZeQuI2ADyJhOb2Q: doesn't show hand
*** SUMMARY ***
Total pot $2 | Rake $0
Seat 1: 6hvg964TSqZ3AL/0XK9aVQ (button) (small blind) folded before Flop
Seat 2: RwDoM55ZeQuI2ADyJhOb2Q (big blind) collected ($2)



PokerStars Game #59942146498:  Hold'em No Limit ($1/$2) - 2009/07/01 1:57:34 ET
Table 'JArEO7oOXEgVwX3NVsRD+A' 9-max Seat #5 is the button
Seat 1: Q104K4iDGcqOlVrjAkzPEA ($87.05 in chips)
Seat 2: g3ZVTc1EbSNXYYMO82jL7Q ($371.10 in chips)
Seat 3: IYBKVnE2Basnr88BAhH+bQ ($226.25 in chips)
Seat 4: 5Q8U6iZbeO7xJSS4qvDP5g ($260.60 in chips)
Seat 5: QCeHcOIuXMfz9IQu0lUQ0w ($15.65 in chips)
Seat 6: GX1heJ+DSsvm7gzSPsYhhQ ($35 in chips)
Seat 7: LQoVc4pQLz/wlryLTs7bRA ($95.15 in chips)
GX1heJ+DSsvm7gzSPsYhhQ: posts small blind $1
LQoVc4pQLz/wlryLTs7bRA: posts big blind $2
*** HOLE CARDS ***
Q104K4iDGcqOlVrjAkzPEA: folds
g3ZVTc1EbSNXYYMO82jL7Q: folds
IYBKVnE2Basnr88BAhH+bQ: folds
5Q8U6iZbeO7xJSS4qvDP5g: folds
QCeHcOIuXMfz9IQu0lUQ0w: raises $13.65 to $15.65 and is all-in
GX1heJ+DSsvm7gzSPsYhhQ: folds
ik2CQB6kPzJaHCd/C6V0xg joins the table at seat #8
LQoVc4pQLz/wlryLTs7bRA: calls $13.65
*** FLOP *** [Ts Ad 6s]
*** TURN *** [Ts Ad 6s] [Ks]
*** RIVER *** [Ts Ad 6s Ks] [2d]
*** SHOW DOWN ***
LQoVc4pQLz/wlryLTs7bRA: shows [9s Ah] (a pair of Aces)
QCeHcOIuXMfz9IQu0lUQ0w: shows [3s As] (a flush, Ace high)
QCeHcOIuXMfz9IQu0lUQ0w collected $30.70 from pot
*** SUMMARY ***
Total pot $32.30 | Rake $1.60
Board [Ts Ad 6s Ks 2d]
Seat 1: Q104K4iDGcqOlVrjAkzPEA folded before Flop (didn't bet)
Seat 2: g3ZVTc1EbSNXYYMO82jL7Q folded before Flop (didn't bet)
Seat 3: IYBKVnE2Basnr88BAhH+bQ folded before Flop (didn't bet)
Seat 4: 5Q8U6iZbeO7xJSS4qvDP5g folded before Flop (didn't bet)
Seat 5: QCeHcOIuXMfz9IQu0lUQ0w (button) showed [3s As] and won ($30.70) with a flush, Ace high
Seat 6: GX1heJ+DSsvm7gzSPsYhhQ (small blind) folded before Flop
Seat 7: LQoVc4pQLz/wlryLTs7bRA (big blind) showed [9s Ah] and lost with a pair of Aces



PokerStars Game #59942146674:  Hold'em No Limit ($1/$2) - 2009/07/01 1:57:35 ET
Table 'P/yCfYl1GfGsu/e6DxDy/A' 2-max Seat #1 is the button
Seat 1: 7fOCUy3x9hdkmXkkDNolGQ ($1068.50 in chips)
Seat 2: RwDoM55ZeQuI2ADyJhOb2Q ($397.50 in chips)
7fOCUy3x9hdkmXkkDNolGQ: posts small blind $1
RwDoM55ZeQuI2ADyJhOb2Q: posts big blind $2
*** HOLE CARDS ***
7fOCUy3x9hdkmXkkDNolGQ: folds
RwDoM55ZeQuI2ADyJhOb2Q collected $2 from pot
RwDoM55ZeQuI2ADyJhOb2Q: doesn't show hand
*** SUMMARY ***
Total pot $2 | Rake $0
Seat 1: 7fOCUy3x9hdkmXkkDNolGQ (button) (small blind) folded before Flop
Seat 2: RwDoM55ZeQuI2ADyJhOb2Q (big blind) collected ($2)



PokerStars Game #59942146580:  Hold'em No Limit ($1/$2) - 2009/07/01 1:57:35 ET
Table 'o63a8j70meKHUtgLFryQvg' 9-max Seat #9 is the button
Seat 1: +1R0op5O3Gf6aUPJTw7jjA ($195 in chips)
Seat 2: SgA0Zfa/3yhNp7ILXcXcCg ($116.30 in chips)
Seat 3: IYBKVnE2Basnr88BAhH+bQ ($265.40 in chips)
Seat 4: ZYHoLw2lWmRS7CSHi8L8Xg ($209.90 in chips)
Seat 5: g3ZVTc1EbSNXYYMO82jL7Q ($223.30 in chips)
Seat 6: CUZwDpLTQKhzarPe+JCLOQ ($203 in chips)
Seat 7: kM9CA+2UcdMjbCMbtUCGiA ($200 in chips)
Seat 8: ItDFe9gh5QYPQB9vC4ntUA ($384.05 in chips)
Seat 9: rW/MyplHylMSBRaoRUzWrg ($37 in chips)
+1R0op5O3Gf6aUPJTw7jjA: posts small blind $1
SgA0Zfa/3yhNp7ILXcXcCg: posts big blind $2
*** HOLE CARDS ***
IYBKVnE2Basnr88BAhH+bQ: folds
ZYHoLw2lWmRS7CSHi8L8Xg: folds
g3ZVTc1EbSNXYYMO82jL7Q: folds
CUZwDpLTQKhzarPe+JCLOQ: folds
kM9CA+2UcdMjbCMbtUCGiA: folds
ItDFe9gh5QYPQB9vC4ntUA: folds
rW/MyplHylMSBRaoRUzWrg: raises $6 to $8
+1R0op5O3Gf6aUPJTw7jjA: folds
SgA0Zfa/3yhNp7ILXcXcCg: folds
rW/MyplHylMSBRaoRUzWrg collected $5 from pot
*** SUMMARY ***
Total pot $5 | Rake $0
Seat 1: +1R0op5O3Gf6aUPJTw7jjA (small blind) folded before Flop
Seat 2: SgA0Zfa/3yhNp7ILXcXcCg (big blind) folded before Flop
Seat 3: IYBKVnE2Basnr88BAhH+bQ folded before Flop (didn't bet)
Seat 4: ZYHoLw2lWmRS7CSHi8L8Xg folded before Flop (didn't bet)
Seat 5: g3ZVTc1EbSNXYYMO82jL7Q folded before Flop (didn't bet)
Seat 6: CUZwDpLTQKhzarPe+JCLOQ folded before Flop (didn't bet)
Seat 7: kM9CA+2UcdMjbCMbtUCGiA folded before Flop (didn't bet)
Seat 8: ItDFe9gh5QYPQB9vC4ntUA folded before Flop (didn't bet)
Seat 9: rW/MyplHylMSBRaoRUzWrg (button) collected ($5)



PokerStars Game #59942146756:  Hold'em No Limit ($1/$2) - 2009/07/01 1:57:35 ET
Table 'TsEDkiO4tzCTCzJ7tNdEqw' 6-max Seat #5 is the button
Seat 1: Nsjun4mjI8q0SSBTIp1dIQ ($200 in chips)
Seat 2: 4dcDwIHRm96PwtqkpQiuiA ($79.70 in chips)
Seat 3: ubtx4Z5L+AcK71MTvYiGVw ($255.90 in chips)
Seat 4: K8MXCrNAVYlMnnCeM32Kxw ($120 in chips)
Seat 5: VvdR9F3I+2yELkfTVvC1dg ($249.10 in chips)
Seat 6: uCqEjnxh2/vFBjKYkfTOkw ($352.45 in chips)
uCqEjnxh2/vFBjKYkfTOkw: posts small blind $1
Nsjun4mjI8q0SSBTIp1dIQ: posts big blind $2
K8MXCrNAVYlMnnCeM32Kxw: posts small blind $1
*** HOLE CARDS ***
4dcDwIHRm96PwtqkpQiuiA: raises $6 to $8
ubtx4Z5L+AcK71MTvYiGVw: calls $8
K8MXCrNAVYlMnnCeM32Kxw: folds
VvdR9F3I+2yELkfTVvC1dg: folds
uCqEjnxh2/vFBjKYkfTOkw: folds
Nsjun4mjI8q0SSBTIp1dIQ: folds
*** FLOP *** [7d 5h 2s]
uCqEjnxh2/vFBjKYkfTOkw leaves the table
4dcDwIHRm96PwtqkpQiuiA: bets $12
ubtx4Z5L+AcK71MTvYiGVw: calls $12
*** TURN *** [7d 5h 2s] [Th]
4dcDwIHRm96PwtqkpQiuiA: bets $20
mddoKnqZkdOH7AJOJ/i0DA joins the table at seat #6
ubtx4Z5L+AcK71MTvYiGVw: raises $54 to $74
4dcDwIHRm96PwtqkpQiuiA: calls $39.70 and is all-in
*** RIVER *** [7d 5h 2s Th] [Jd]
*** SHOW DOWN ***
4dcDwIHRm96PwtqkpQiuiA: shows [Ks Kd] (a pair of Kings)
ubtx4Z5L+AcK71MTvYiGVw: shows [Jc Js] (three of a kind, Jacks)
ubtx4Z5L+AcK71MTvYiGVw collected $160.40 from pot
*** SUMMARY ***
Total pot $163.40 | Rake $3
Board [7d 5h 2s Th Jd]
Seat 1: Nsjun4mjI8q0SSBTIp1dIQ (big blind) folded before Flop
Seat 2: 4dcDwIHRm96PwtqkpQiuiA showed [Ks Kd] and lost with a pair of Kings
Seat 3: ubtx4Z5L+AcK71MTvYiGVw showed [Jc Js] and won ($160.40) with three of a kind, Jacks
Seat 4: K8MXCrNAVYlMnnCeM32Kxw folded before Flop
Seat 5: VvdR9F3I+2yELkfTVvC1dg (button) folded before Flop (didn't bet)
Seat 6: uCqEjnxh2/vFBjKYkfTOkw (small blind) folded before Flop



PokerStars Game #59942148344:  Hold'em No Limit ($1/$2) - 2009/07/01 1:57:38 ET
Table '5/wEe6JmtGD7vufSA2RG7A' 2-max Seat #2 is the button
Seat 1: pVqEzK9wXlRMECnb1Zg4Zw ($218.30 in chips)
Seat 2: aOL8geThaYp2iadSHl1h1g ($434 in chips)
aOL8geThaYp2iadSHl1h1g: posts small blind $1
pVqEzK9wXlRMECnb1Zg4Zw: posts big blind $2
*** HOLE CARDS ***
aOL8geThaYp2iadSHl1h1g: raises $4 to $6
pVqEzK9wXlRMECnb1Zg4Zw: calls $4
*** FLOP *** [6h 7c Qh]
pVqEzK9wXlRMECnb1Zg4Zw: checks
aOL8geThaYp2iadSHl1h1g: checks
*** TURN *** [6h 7c Qh] [6s]
pVqEzK9wXlRMECnb1Zg4Zw: bets $6
aOL8geThaYp2iadSHl1h1g: raises $12 to $18
pVqEzK9wXlRMECnb1Zg4Zw: calls $12
*** RIVER *** [6h 7c Qh 6s] [8c]
pVqEzK9wXlRMECnb1Zg4Zw: checks
aOL8geThaYp2iadSHl1h1g: checks
*** SHOW DOWN ***
pVqEzK9wXlRMECnb1Zg4Zw: shows [Jc 7s] (two pair, Sevens and Sixes)
aOL8geThaYp2iadSHl1h1g: mucks hand
pVqEzK9wXlRMECnb1Zg4Zw collected $47.50 from pot
*** SUMMARY ***
Total pot $48 | Rake $0.50
Board [6h 7c Qh 6s 8c]
Seat 1: pVqEzK9wXlRMECnb1Zg4Zw (big blind) showed [Jc 7s] and won ($47.50) with two pair, Sevens and Sixes
Seat 2: aOL8geThaYp2iadSHl1h1g (button) (small blind) mucked



PokerStars Game #59942148706:  Hold'em No Limit ($1/$2) - 2009/07/01 1:57:39 ET
Table 'xxAXogzmyuZKfe0LOYHaNQ' 2-max Seat #1 is the button
Seat 1: S14rjcU6LEC1LmuUtBK5Bg ($121 in chips)
Seat 2: ItDFe9gh5QYPQB9vC4ntUA ($204.60 in chips)
S14rjcU6LEC1LmuUtBK5Bg: posts small blind $1
ItDFe9gh5QYPQB9vC4ntUA: posts big blind $2
*** HOLE CARDS ***
S14rjcU6LEC1LmuUtBK5Bg: folds
ItDFe9gh5QYPQB9vC4ntUA collected $2 from pot
*** SUMMARY ***
Total pot $2 | Rake $0
Seat 1: S14rjcU6LEC1LmuUtBK5Bg (button) (small blind) folded before Flop
Seat 2: ItDFe9gh5QYPQB9vC4ntUA (big blind) collected ($2)



PokerStars Game #59942148918:  Hold'em No Limit ($1/$2) - 2009/07/01 1:57:39 ET
Table 'ZzSIe0zTCDv+n6hfbY5tTg' 6-max Seat #1 is the button
Seat 1: VvdR9F3I+2yELkfTVvC1dg ($285.65 in chips)
Seat 2: B87ikIyZ/TzAVeXf38Ny0g ($214 in chips)
Seat 3: gsugPj31Hui3Jefl98MBOA ($349.35 in chips)
Seat 4: 54yWzRRgS0oZ+S6LwZBxMQ ($49.10 in chips)
Seat 5: 3dAbvkxS5NPQTBAbvpinVg ($484.45 in chips)
Seat 6: 09BNF4quPDzanQzM8vc6WA ($34.55 in chips)
B87ikIyZ/TzAVeXf38Ny0g: posts small blind $1
gsugPj31Hui3Jefl98MBOA: posts big blind $2
*** HOLE CARDS ***
54yWzRRgS0oZ+S6LwZBxMQ: folds
3dAbvkxS5NPQTBAbvpinVg: folds
09BNF4quPDzanQzM8vc6WA: raises $2 to $4
VvdR9F3I+2yELkfTVvC1dg: folds
B87ikIyZ/TzAVeXf38Ny0g: folds
gsugPj31Hui3Jefl98MBOA: calls $2
*** FLOP *** [Ks Qd 2h]
gsugPj31Hui3Jefl98MBOA: checks
09BNF4quPDzanQzM8vc6WA: bets $4
gsugPj31Hui3Jefl98MBOA: folds
09BNF4quPDzanQzM8vc6WA collected $8.55 from pot
09BNF4quPDzanQzM8vc6WA: doesn't show hand
*** SUMMARY ***
Total pot $9 | Rake $0.45
Board [Ks Qd 2h]
Seat 1: VvdR9F3I+2yELkfTVvC1dg (button) folded before Flop (didn't bet)
Seat 2: B87ikIyZ/TzAVeXf38Ny0g (small blind) folded before Flop
Seat 3: gsugPj31Hui3Jefl98MBOA (big blind) folded on the Flop
Seat 4: 54yWzRRgS0oZ+S6LwZBxMQ folded before Flop (didn't bet)
Seat 5: 3dAbvkxS5NPQTBAbvpinVg folded before Flop (didn't bet)
Seat 6: 09BNF4quPDzanQzM8vc6WA collected ($8.55)



PokerStars Game #59942148792:  Hold'em No Limit ($1/$2) - 2009/07/01 1:57:39 ET
Table '/dyk+YdRGv90j2box35j8w' 6-max Seat #2 is the button
Seat 2: qCnEYuAE5y5A7bk6fO5/jQ ($488.20 in chips)
Seat 3: sTPOWERd9HWPCNrDBwsVjA ($213.50 in chips)
Seat 4: 4dMBh/1VTdeUTPCyhCs3UQ ($88.95 in chips)
Seat 5: VvdR9F3I+2yELkfTVvC1dg ($295.35 in chips)
Seat 6: C3qJBo7uxfFVDluE1lmK2w ($92.25 in chips)
sTPOWERd9HWPCNrDBwsVjA: posts small blind $1
4dMBh/1VTdeUTPCyhCs3UQ: posts big blind $2
*** HOLE CARDS ***
VvdR9F3I+2yELkfTVvC1dg: folds
C3qJBo7uxfFVDluE1lmK2w: folds
qCnEYuAE5y5A7bk6fO5/jQ: folds
sTPOWERd9HWPCNrDBwsVjA: folds
4dMBh/1VTdeUTPCyhCs3UQ collected $2 from pot
4dMBh/1VTdeUTPCyhCs3UQ: doesn't show hand
*** SUMMARY ***
Total pot $2 | Rake $0
Seat 2: qCnEYuAE5y5A7bk6fO5/jQ (button) folded before Flop (didn't bet)
Seat 3: sTPOWERd9HWPCNrDBwsVjA (small blind) folded before Flop
Seat 4: 4dMBh/1VTdeUTPCyhCs3UQ (big blind) collected ($2)
Seat 5: VvdR9F3I+2yELkfTVvC1dg folded before Flop (didn't bet)
Seat 6: C3qJBo7uxfFVDluE1lmK2w folded before Flop (didn't bet)



PokerStars Game #59942149224:  Hold'em No Limit ($1/$2) - 2009/07/01 1:57:40 ET
Table 'NmY84NAf9Mh0ckAckHnh5g' 2-max Seat #2 is the button
Seat 1: 6hvg964TSqZ3AL/0XK9aVQ ($404.20 in chips)
Seat 2: RwDoM55ZeQuI2ADyJhOb2Q ($572.30 in chips)
RwDoM55ZeQuI2ADyJhOb2Q: posts small blind $1
6hvg964TSqZ3AL/0XK9aVQ: posts big blind $2
*** HOLE CARDS ***
RwDoM55ZeQuI2ADyJhOb2Q: folds
6hvg964TSqZ3AL/0XK9aVQ collected $2 from pot
*** SUMMARY ***
Total pot $2 | Rake $0
Seat 1: 6hvg964TSqZ3AL/0XK9aVQ (big blind) collected ($2)
Seat 2: RwDoM55ZeQuI2ADyJhOb2Q (button) (small blind) folded before Flop



PokerStars Game #59942149760:  Hold'em No Limit ($1/$2) - 2009/07/01 1:57:41 ET
Table 'P/yCfYl1GfGsu/e6DxDy/A' 2-max Seat #2 is the button
Seat 1: 7fOCUy3x9hdkmXkkDNolGQ ($1067.50 in chips)
Seat 2: RwDoM55ZeQuI2ADyJhOb2Q ($398.50 in chips)
RwDoM55ZeQuI2ADyJhOb2Q: posts small blind $1
7fOCUy3x9hdkmXkkDNolGQ: posts big blind $2
*** HOLE CARDS ***
RwDoM55ZeQuI2ADyJhOb2Q: raises $4 to $6
7fOCUy3x9hdkmXkkDNolGQ: folds
RwDoM55ZeQuI2ADyJhOb2Q collected $4 from pot
RwDoM55ZeQuI2ADyJhOb2Q: doesn't show hand
*** SUMMARY ***
Total pot $4 | Rake $0
Seat 1: 7fOCUy3x9hdkmXkkDNolGQ (big blind) folded before Flop
Seat 2: RwDoM55ZeQuI2ADyJhOb2Q (button) (small blind) collected ($4)



PokerStars Game #59942149882:  Hold'em No Limit ($1/$2) - 2009/07/01 1:57:41 ET
Table 'uJ9juaXXg9yIcSU8amxaXQ' 6-max Seat #2 is the button
Seat 1: JsqOjN/eHz0uYVf/PyUJ6Q ($131.15 in chips)
Seat 2: VvdR9F3I+2yELkfTVvC1dg ($217.45 in chips)
Seat 3: qXDd0ZyMIse0OBu8pxeQ3Q ($244.05 in chips)
Seat 4: zNjJ/y4emmF+vzrCDd+ooA ($264.30 in chips)
Seat 5: YsLQ3BAvgQHWXMAv3Wv6Hg ($202 in chips)
qXDd0ZyMIse0OBu8pxeQ3Q: posts small blind $1
zNjJ/y4emmF+vzrCDd+ooA: posts big blind $2
opJMdoq0E6TRbAQiweyQuA: sits out
*** HOLE CARDS ***
YsLQ3BAvgQHWXMAv3Wv6Hg: folds
JsqOjN/eHz0uYVf/PyUJ6Q: folds
VvdR9F3I+2yELkfTVvC1dg: folds
qXDd0ZyMIse0OBu8pxeQ3Q: folds
zNjJ/y4emmF+vzrCDd+ooA collected $2 from pot
*** SUMMARY ***
Total pot $2 | Rake $0
Seat 1: JsqOjN/eHz0uYVf/PyUJ6Q folded before Flop (didn't bet)
Seat 2: VvdR9F3I+2yELkfTVvC1dg (button) folded before Flop (didn't bet)
Seat 3: qXDd0ZyMIse0OBu8pxeQ3Q (small blind) folded before Flop
Seat 4: zNjJ/y4emmF+vzrCDd+ooA (big blind) collected ($2)
Seat 5: YsLQ3BAvgQHWXMAv3Wv6Hg folded before Flop (didn't bet)



PokerStars Game #59942150034:  Hold'em No Limit ($1/$2) - 2009/07/01 1:57:42 ET
Table '7goFpXy7qyiK5mwx+Ucf6A' 6-max Seat #2 is the button
Seat 1: VHmJJYp7TGQwcWROQ8dqXw ($46.55 in chips)
Seat 2: BWhgxe7gWiYobRbwdG+d2Q ($196 in chips)
Seat 3: mfy7uGZcqA2PVQqEVbJ7+g ($147.25 in chips)
Seat 4: fE+LHW/7rpfXW14g8LhGjA ($52.70 in chips)
Seat 6: VvdR9F3I+2yELkfTVvC1dg ($212.65 in chips)
mfy7uGZcqA2PVQqEVbJ7+g: posts small blind $1
fE+LHW/7rpfXW14g8LhGjA: posts big blind $2
vkfxu8f/jMYKUk6Ly4eujw: sits out
*** HOLE CARDS ***
vkfxu8f/jMYKUk6Ly4eujw leaves the table
opJMdoq0E6TRbAQiweyQuA joins the table at seat #5
VvdR9F3I+2yELkfTVvC1dg: folds
VHmJJYp7TGQwcWROQ8dqXw: calls $2
BWhgxe7gWiYobRbwdG+d2Q: raises $6 to $8
mfy7uGZcqA2PVQqEVbJ7+g: folds
fE+LHW/7rpfXW14g8LhGjA: calls $6
VHmJJYp7TGQwcWROQ8dqXw: calls $6
*** FLOP *** [Qc 2h 3s]
fE+LHW/7rpfXW14g8LhGjA: checks
VHmJJYp7TGQwcWROQ8dqXw: bets $2
BWhgxe7gWiYobRbwdG+d2Q: folds
fE+LHW/7rpfXW14g8LhGjA: folds
VHmJJYp7TGQwcWROQ8dqXw collected $23.75 from pot
*** SUMMARY ***
Total pot $25 | Rake $1.25
Board [Qc 2h 3s]
Seat 1: VHmJJYp7TGQwcWROQ8dqXw collected ($23.75)
Seat 2: BWhgxe7gWiYobRbwdG+d2Q (button) folded on the Flop
Seat 3: mfy7uGZcqA2PVQqEVbJ7+g (small blind) folded before Flop
Seat 4: fE+LHW/7rpfXW14g8LhGjA (big blind) folded on the Flop
Seat 6: VvdR9F3I+2yELkfTVvC1dg folded before Flop (didn't bet)



PokerStars Game #59942151118:  Hold'em No Limit ($1/$2) - 2009/07/01 1:57:44 ET
Table 'aSf77Sj8QEnzcc0WaxVD4Q' 6-max Seat #1 is the button
Seat 1: UELtvp+JfwI7XDGVwSxZXA ($169.55 in chips)
Seat 2: vkfxu8f/jMYKUk6Ly4eujw ($200 in chips)
Seat 3: 3cPMpDMgeOMAe4UceUfLsg ($200 in chips)
Seat 4: YsLQ3BAvgQHWXMAv3Wv6Hg ($200 in chips)
Seat 5: VvdR9F3I+2yELkfTVvC1dg ($289.15 in chips)
Seat 6: vkoJRf3gidxY1pPi0AFWww ($194.85 in chips)
vkfxu8f/jMYKUk6Ly4eujw: posts small blind $1
3cPMpDMgeOMAe4UceUfLsg: posts big blind $2
*** HOLE CARDS ***
YsLQ3BAvgQHWXMAv3Wv6Hg: folds
VvdR9F3I+2yELkfTVvC1dg: folds
vkoJRf3gidxY1pPi0AFWww: folds
UELtvp+JfwI7XDGVwSxZXA: raises $4 to $6
vkfxu8f/jMYKUk6Ly4eujw: folds
3cPMpDMgeOMAe4UceUfLsg: raises $14 to $20
UELtvp+JfwI7XDGVwSxZXA: folds
3cPMpDMgeOMAe4UceUfLsg collected $13 from pot
3cPMpDMgeOMAe4UceUfLsg: doesn't show hand
*** SUMMARY ***
Total pot $13 | Rake $0
Seat 1: UELtvp+JfwI7XDGVwSxZXA (button) folded before Flop
Seat 2: vkfxu8f/jMYKUk6Ly4eujw (small blind) folded before Flop
Seat 3: 3cPMpDMgeOMAe4UceUfLsg (big blind) collected ($13)
Seat 4: YsLQ3BAvgQHWXMAv3Wv6Hg folded before Flop (didn't bet)
Seat 5: VvdR9F3I+2yELkfTVvC1dg folded before Flop (didn't bet)
Seat 6: vkoJRf3gidxY1pPi0AFWww folded before Flop (didn't bet)



PokerStars Game #59942152316:  Hold'em No Limit ($1/$2) - 2009/07/01 1:57:46 ET
Table 'xxAXogzmyuZKfe0LOYHaNQ' 2-max Seat #2 is the button
Seat 1: S14rjcU6LEC1LmuUtBK5Bg ($120 in chips)
Seat 2: ItDFe9gh5QYPQB9vC4ntUA ($205.60 in chips)
ItDFe9gh5QYPQB9vC4ntUA: posts small blind $1
S14rjcU6LEC1LmuUtBK5Bg: posts big blind $2
*** HOLE CARDS ***
ItDFe9gh5QYPQB9vC4ntUA: raises $2 to $4
S14rjcU6LEC1LmuUtBK5Bg: raises $2 to $6
ItDFe9gh5QYPQB9vC4ntUA: calls $2
*** FLOP *** [Qs Kh Tc]
S14rjcU6LEC1LmuUtBK5Bg: checks
ItDFe9gh5QYPQB9vC4ntUA: bets $6
S14rjcU6LEC1LmuUtBK5Bg: folds
ItDFe9gh5QYPQB9vC4ntUA collected $11.50 from pot
*** SUMMARY ***
Total pot $12 | Rake $0.50
Board [Qs Kh Tc]
Seat 1: S14rjcU6LEC1LmuUtBK5Bg (big blind) folded on the Flop
Seat 2: ItDFe9gh5QYPQB9vC4ntUA (button) (small blind) collected ($11.50)



PokerStars Game #59942152220:  Hold'em No Limit ($1/$2) - 2009/07/01 1:57:46 ET
Table 'NmY84NAf9Mh0ckAckHnh5g' 2-max Seat #1 is the button
Seat 1: 6hvg964TSqZ3AL/0XK9aVQ ($405.20 in chips)
Seat 2: RwDoM55ZeQuI2ADyJhOb2Q ($571.30 in chips)
6hvg964TSqZ3AL/0XK9aVQ: posts small blind $1
RwDoM55ZeQuI2ADyJhOb2Q: posts big blind $2
*** HOLE CARDS ***
6hvg964TSqZ3AL/0XK9aVQ: calls $1
RwDoM55ZeQuI2ADyJhOb2Q: checks
*** FLOP *** [4s 4c 6h]
RwDoM55ZeQuI2ADyJhOb2Q: checks
6hvg964TSqZ3AL/0XK9aVQ: checks
*** TURN *** [4s 4c 6h] [5h]
RwDoM55ZeQuI2ADyJhOb2Q: checks
6hvg964TSqZ3AL/0XK9aVQ: bets $4
RwDoM55ZeQuI2ADyJhOb2Q: calls $4
*** RIVER *** [4s 4c 6h 5h] [9d]
RwDoM55ZeQuI2ADyJhOb2Q: checks
6hvg964TSqZ3AL/0XK9aVQ: bets $10
RwDoM55ZeQuI2ADyJhOb2Q: calls $10
*** SHOW DOWN ***
6hvg964TSqZ3AL/0XK9aVQ: shows [7c Th] (a pair of Fours)
RwDoM55ZeQuI2ADyJhOb2Q: shows [Ac 5s] (two pair, Fives and Fours)
RwDoM55ZeQuI2ADyJhOb2Q collected $31.50 from pot
*** SUMMARY ***
Total pot $32 | Rake $0.50
Board [4s 4c 6h 5h 9d]
Seat 1: 6hvg964TSqZ3AL/0XK9aVQ (button) (small blind) showed [7c Th] and lost with a pair of Fours
Seat 2: RwDoM55ZeQuI2ADyJhOb2Q (big blind) showed [Ac 5s] and won ($31.50) with two pair, Fives and Fours



PokerStars Game #59942153054:  Hold'em No Limit ($1/$2) - 2009/07/01 1:57:47 ET
Table 'ztv6V3FN2bQ9nmJPPdx6nQ' 6-max Seat #6 is the button
Seat 1: 6fLdOUCRtX71xbVRhJEq8w ($363.35 in chips)
Seat 2: 5Y+ZGWLI4gnlpApDX5vy1A ($293.05 in chips)
Seat 3: XP9UmPc7hfMVafyEiwJMAA ($197 in chips)
Seat 4: UaZ5yj+6LjtWqMQg2QskUw ($84.40 in chips)
Seat 5: sTPOWERd9HWPCNrDBwsVjA ($224.90 in chips)
Seat 6: mfy7uGZcqA2PVQqEVbJ7+g ($187.70 in chips)
6fLdOUCRtX71xbVRhJEq8w: posts small blind $1
5Y+ZGWLI4gnlpApDX5vy1A: posts big blind $2
*** HOLE CARDS ***
XP9UmPc7hfMVafyEiwJMAA: folds
UaZ5yj+6LjtWqMQg2QskUw: folds
sTPOWERd9HWPCNrDBwsVjA: folds
mfy7uGZcqA2PVQqEVbJ7+g: raises $5 to $7
6fLdOUCRtX71xbVRhJEq8w: folds
5Y+ZGWLI4gnlpApDX5vy1A: raises $14 to $21
mfy7uGZcqA2PVQqEVbJ7+g: folds
5Y+ZGWLI4gnlpApDX5vy1A collected $15 from pot
5Y+ZGWLI4gnlpApDX5vy1A: doesn't show hand
*** SUMMARY ***
Total pot $15 | Rake $0
Seat 1: 6fLdOUCRtX71xbVRhJEq8w (small blind) folded before Flop
Seat 2: 5Y+ZGWLI4gnlpApDX5vy1A (big blind) collected ($15)
Seat 3: XP9UmPc7hfMVafyEiwJMAA folded before Flop (didn't bet)
Seat 4: UaZ5yj+6LjtWqMQg2QskUw folded before Flop (didn't bet)
Seat 5: sTPOWERd9HWPCNrDBwsVjA folded before Flop (didn't bet)
Seat 6: mfy7uGZcqA2PVQqEVbJ7+g (button) folded before Flop



PokerStars Game #59942153032:  Hold'em No Limit ($1/$2) - 2009/07/01 1:57:47 ET
Table '3WCXyaiCAbqSShQu7FIjvA' 9-max Seat #3 is the button
Seat 1: kTCkABD1UUldS9DFRGfCwQ ($144.25 in chips)
Seat 2: 254YPxPJr5Sw58bkD0YqYQ ($200 in chips)
Seat 3: 5Q8U6iZbeO7xJSS4qvDP5g ($244.25 in chips)
Seat 4: waEF/+pxZTxNo4FvsORuXg ($99.40 in chips)
Seat 5: CkE3IyJF1KvdaAOmZY5XqQ ($207.90 in chips)
Seat 6: 5jQlngvMSqM/WoonOcR5kw ($277.50 in chips)
Seat 8: +T/63sAeZzWyHchahJ36GQ ($34 in chips)
Seat 9: FiXPLJyqb24l32QST2TInw ($138 in chips)
waEF/+pxZTxNo4FvsORuXg: posts small blind $1
CkE3IyJF1KvdaAOmZY5XqQ: posts big blind $2
*** HOLE CARDS ***
5jQlngvMSqM/WoonOcR5kw: raises $2 to $4
+T/63sAeZzWyHchahJ36GQ: folds
FiXPLJyqb24l32QST2TInw: folds
kTCkABD1UUldS9DFRGfCwQ: folds
254YPxPJr5Sw58bkD0YqYQ: raises $8 to $12
5Q8U6iZbeO7xJSS4qvDP5g: folds
waEF/+pxZTxNo4FvsORuXg: folds
CkE3IyJF1KvdaAOmZY5XqQ: folds
5jQlngvMSqM/WoonOcR5kw: calls $8
*** FLOP *** [9c Kc 2d]
5jQlngvMSqM/WoonOcR5kw: bets $28
254YPxPJr5Sw58bkD0YqYQ: folds
5jQlngvMSqM/WoonOcR5kw collected $25.65 from pot
*** SUMMARY ***
Total pot $27 | Rake $1.35
Board [9c Kc 2d]
Seat 1: kTCkABD1UUldS9DFRGfCwQ folded before Flop (didn't bet)
Seat 2: 254YPxPJr5Sw58bkD0YqYQ folded on the Flop
Seat 3: 5Q8U6iZbeO7xJSS4qvDP5g (button) folded before Flop (didn't bet)
Seat 4: waEF/+pxZTxNo4FvsORuXg (small blind) folded before Flop
Seat 5: CkE3IyJF1KvdaAOmZY5XqQ (big blind) folded before Flop
Seat 6: 5jQlngvMSqM/WoonOcR5kw collected ($25.65)
Seat 8: +T/63sAeZzWyHchahJ36GQ folded before Flop (didn't bet)
Seat 9: FiXPLJyqb24l32QST2TInw folded before Flop (didn't bet)



PokerStars Game #59942154646:  Hold'em No Limit ($1/$2) - 2009/07/01 1:57:50 ET
Table 'UGLAZZyv+cXmnKjYin0etA' 6-max Seat #6 is the button
Seat 1: rL+Zpv4/vX2BVHcyfh/NXA ($206.25 in chips)
Seat 2: eDLH1PUXFpvJBNMXBVQcGA ($294.10 in chips)
Seat 3: Nsjun4mjI8q0SSBTIp1dIQ ($229 in chips)
Seat 4: SiGJDsvRViJX05vHhA80GQ ($246.75 in chips)
Seat 5: 54yWzRRgS0oZ+S6LwZBxMQ ($34.80 in chips)
Seat 6: sTPOWERd9HWPCNrDBwsVjA ($179.95 in chips)
rL+Zpv4/vX2BVHcyfh/NXA: posts small blind $1
eDLH1PUXFpvJBNMXBVQcGA: posts big blind $2
*** HOLE CARDS ***
Nsjun4mjI8q0SSBTIp1dIQ: folds
SiGJDsvRViJX05vHhA80GQ: folds
54yWzRRgS0oZ+S6LwZBxMQ: calls $2
sTPOWERd9HWPCNrDBwsVjA: calls $2
rL+Zpv4/vX2BVHcyfh/NXA: calls $1
eDLH1PUXFpvJBNMXBVQcGA: checks
*** FLOP *** [Kh 9s 2s]
rL+Zpv4/vX2BVHcyfh/NXA: bets $6
eDLH1PUXFpvJBNMXBVQcGA: folds
54yWzRRgS0oZ+S6LwZBxMQ: folds
sTPOWERd9HWPCNrDBwsVjA: folds
rL+Zpv4/vX2BVHcyfh/NXA collected $7.60 from pot
*** SUMMARY ***
Total pot $8 | Rake $0.40
Board [Kh 9s 2s]
Seat 1: rL+Zpv4/vX2BVHcyfh/NXA (small blind) collected ($7.60)
Seat 2: eDLH1PUXFpvJBNMXBVQcGA (big blind) folded on the Flop
Seat 3: Nsjun4mjI8q0SSBTIp1dIQ folded before Flop (didn't bet)
Seat 4: SiGJDsvRViJX05vHhA80GQ folded before Flop (didn't bet)
Seat 5: 54yWzRRgS0oZ+S6LwZBxMQ folded on the Flop
Seat 6: sTPOWERd9HWPCNrDBwsVjA (button) folded on the Flop



PokerStars Game #59942154672:  Hold'em No Limit ($1/$2) - 2009/07/01 1:57:51 ET
Table 'P/yCfYl1GfGsu/e6DxDy/A' 2-max Seat #1 is the button
Seat 1: 7fOCUy3x9hdkmXkkDNolGQ ($1065.50 in chips)
Seat 2: RwDoM55ZeQuI2ADyJhOb2Q ($400.50 in chips)
7fOCUy3x9hdkmXkkDNolGQ: posts small blind $1
RwDoM55ZeQuI2ADyJhOb2Q: posts big blind $2
*** HOLE CARDS ***
7fOCUy3x9hdkmXkkDNolGQ: raises $4 to $6
RwDoM55ZeQuI2ADyJhOb2Q: raises $14 to $20
7fOCUy3x9hdkmXkkDNolGQ: calls $14
*** FLOP *** [Qs 9d 4d]
RwDoM55ZeQuI2ADyJhOb2Q: bets $22
7fOCUy3x9hdkmXkkDNolGQ: calls $22
*** TURN *** [Qs 9d 4d] [8d]
RwDoM55ZeQuI2ADyJhOb2Q: bets $52
7fOCUy3x9hdkmXkkDNolGQ: raises $52 to $104
RwDoM55ZeQuI2ADyJhOb2Q: folds
7fOCUy3x9hdkmXkkDNolGQ collected $187.50 from pot
7fOCUy3x9hdkmXkkDNolGQ: shows [4c Kc] (a pair of Fours)
*** SUMMARY ***
Total pot $188 | Rake $0.50
Board [Qs 9d 4d 8d]
Seat 1: 7fOCUy3x9hdkmXkkDNolGQ (button) (small blind) collected ($187.50)
Seat 2: RwDoM55ZeQuI2ADyJhOb2Q (big blind) folded on the Turn



PokerStars Game #59942155576:  Hold'em No Limit ($1/$2) - 2009/07/01 1:57:52 ET
Table '/8c0X14Gjd7J3pVNocAJrQ' 6-max Seat #4 is the button
Seat 1: AuiGltq875lmaKHBsjZVGg ($88.20 in chips)
Seat 2: mfy7uGZcqA2PVQqEVbJ7+g ($275.60 in chips)
Seat 3: sr/OkkgqNbtgwJf1tmnfNg ($109.55 in chips)
Seat 4: PkzV5n5qRUp0Weu8NcNNhA ($79.15 in chips)
Seat 6: VvdR9F3I+2yELkfTVvC1dg ($337.75 in chips)
opJMdoq0E6TRbAQiweyQuA will be allowed to play after the button
VvdR9F3I+2yELkfTVvC1dg: posts small blind $1
AuiGltq875lmaKHBsjZVGg: posts big blind $2
*** HOLE CARDS ***
mfy7uGZcqA2PVQqEVbJ7+g: folds
sr/OkkgqNbtgwJf1tmnfNg: raises $4 to $6
PkzV5n5qRUp0Weu8NcNNhA: folds
VvdR9F3I+2yELkfTVvC1dg: folds
AuiGltq875lmaKHBsjZVGg: calls $4
*** FLOP *** [Jh Ac Qh]
AuiGltq875lmaKHBsjZVGg: checks
sr/OkkgqNbtgwJf1tmnfNg: bets $12
AuiGltq875lmaKHBsjZVGg: folds
sr/OkkgqNbtgwJf1tmnfNg collected $12.35 from pot
*** SUMMARY ***
Total pot $13 | Rake $0.65
Board [Jh Ac Qh]
Seat 1: AuiGltq875lmaKHBsjZVGg (big blind) folded on the Flop
Seat 2: mfy7uGZcqA2PVQqEVbJ7+g folded before Flop (didn't bet)
Seat 3: sr/OkkgqNbtgwJf1tmnfNg collected ($12.35)
Seat 4: PkzV5n5qRUp0Weu8NcNNhA (button) folded before Flop (didn't bet)
Seat 6: VvdR9F3I+2yELkfTVvC1dg (small blind) folded before Flop



PokerStars Game #59942155928:  Hold'em No Limit ($1/$2) - 2009/07/01 1:57:53 ET
Table 'WCA60bDA8ecovUgFSIZkTQ' 9-max Seat #1 is the button
Seat 1: 3RFwE6igZ1BGKOGuab6iiw ($76.65 in chips)
Seat 3: g7gL2NLJCdZPPV399WKT1w ($52.95 in chips)
Seat 4: IYBKVnE2Basnr88BAhH+bQ ($202.80 in chips)
Seat 6: YoKKKdDDs7gFzP1Z65Sdaw ($94 in chips)
Seat 7: tsTv4D+ne2W0qhUt9HlcMw ($200.65 in chips)
Seat 8: mJhwEVg7F695DiO+RIhM5g ($242.45 in chips)
Seat 9: ItDFe9gh5QYPQB9vC4ntUA ($208 in chips)
rW/MyplHylMSBRaoRUzWrg will be allowed to play after the button
g7gL2NLJCdZPPV399WKT1w: posts small blind $1
IYBKVnE2Basnr88BAhH+bQ: posts big blind $2
+T/63sAeZzWyHchahJ36GQ: sits out
*** HOLE CARDS ***
YoKKKdDDs7gFzP1Z65Sdaw: folds
tsTv4D+ne2W0qhUt9HlcMw: folds
mJhwEVg7F695DiO+RIhM5g: folds
ItDFe9gh5QYPQB9vC4ntUA: folds
3RFwE6igZ1BGKOGuab6iiw: folds
g7gL2NLJCdZPPV399WKT1w: calls $1
IYBKVnE2Basnr88BAhH+bQ: checks
*** FLOP *** [As 8c Ah]
g7gL2NLJCdZPPV399WKT1w: checks
IYBKVnE2Basnr88BAhH+bQ: checks
*** TURN *** [As 8c Ah] [Qc]
g7gL2NLJCdZPPV399WKT1w: checks
IYBKVnE2Basnr88BAhH+bQ: bets $4
g7gL2NLJCdZPPV399WKT1w: folds
IYBKVnE2Basnr88BAhH+bQ collected $3.80 from pot
IYBKVnE2Basnr88BAhH+bQ: doesn't show hand
*** SUMMARY ***
Total pot $4 | Rake $0.20
Board [As 8c Ah Qc]
Seat 1: 3RFwE6igZ1BGKOGuab6iiw (button) folded before Flop (didn't bet)
Seat 3: g7gL2NLJCdZPPV399WKT1w (small blind) folded on the Turn
Seat 4: IYBKVnE2Basnr88BAhH+bQ (big blind) collected ($3.80)
Seat 6: YoKKKdDDs7gFzP1Z65Sdaw folded before Flop (didn't bet)
Seat 7: tsTv4D+ne2W0qhUt9HlcMw folded before Flop (didn't bet)
Seat 8: mJhwEVg7F695DiO+RIhM5g folded before Flop (didn't bet)
Seat 9: ItDFe9gh5QYPQB9vC4ntUA folded before Flop (didn't bet)



PokerStars Game #59942158554:  Hold'em No Limit ($1/$2) - 2009/07/01 1:57:58 ET
Table 'uJ9juaXXg9yIcSU8amxaXQ' 6-max Seat #3 is the button
Seat 1: JsqOjN/eHz0uYVf/PyUJ6Q ($131.15 in chips)
Seat 2: VvdR9F3I+2yELkfTVvC1dg ($217.45 in chips)
Seat 3: qXDd0ZyMIse0OBu8pxeQ3Q ($243.05 in chips)
Seat 4: zNjJ/y4emmF+vzrCDd+ooA ($265.30 in chips)
Seat 5: YsLQ3BAvgQHWXMAv3Wv6Hg ($202 in chips)
zNjJ/y4emmF+vzrCDd+ooA: posts small blind $1
YsLQ3BAvgQHWXMAv3Wv6Hg: posts big blind $2
opJMdoq0E6TRbAQiweyQuA: sits out
*** HOLE CARDS ***
JsqOjN/eHz0uYVf/PyUJ6Q: folds
VvdR9F3I+2yELkfTVvC1dg: raises $2 to $4
qXDd0ZyMIse0OBu8pxeQ3Q: folds
zNjJ/y4emmF+vzrCDd+ooA: calls $3
YsLQ3BAvgQHWXMAv3Wv6Hg: folds
*** FLOP *** [3d Qh 3s]
zNjJ/y4emmF+vzrCDd+ooA: checks
VvdR9F3I+2yELkfTVvC1dg: bets $7.10
zNjJ/y4emmF+vzrCDd+ooA: calls $7.10
*** TURN *** [3d Qh 3s] [6h]
zNjJ/y4emmF+vzrCDd+ooA: checks
VvdR9F3I+2yELkfTVvC1dg: checks
*** RIVER *** [3d Qh 3s 6h] [8d]
zNjJ/y4emmF+vzrCDd+ooA: bets $6
VvdR9F3I+2yELkfTVvC1dg: folds
zNjJ/y4emmF+vzrCDd+ooA collected $23.05 from pot
*** SUMMARY ***
Total pot $24.20 | Rake $1.15
Board [3d Qh 3s 6h 8d]
Seat 1: JsqOjN/eHz0uYVf/PyUJ6Q folded before Flop (didn't bet)
Seat 2: VvdR9F3I+2yELkfTVvC1dg folded on the River
Seat 3: qXDd0ZyMIse0OBu8pxeQ3Q (button) folded before Flop (didn't bet)
Seat 4: zNjJ/y4emmF+vzrCDd+ooA (small blind) collected ($23.05)
Seat 5: YsLQ3BAvgQHWXMAv3Wv6Hg (big blind) folded before Flop



PokerStars Game #59942158302:  Hold'em No Limit ($1/$2) - 2009/07/01 1:57:58 ET
Table 'CFkQcfWjKccZaZDf71FK+w' 6-max Seat #6 is the button
Seat 1: vkfxu8f/jMYKUk6Ly4eujw ($222.05 in chips)
Seat 2: ewN/vzF22+/gdzjIKBOlkA ($212.80 in chips)
Seat 3: TMPDCBmlFGM9C+H58PC4sQ ($70.25 in chips)
Seat 4: opJMdoq0E6TRbAQiweyQuA ($37 in chips)
Seat 5: 2lOU1DcvUZaMcxZ95XfzXw ($100.85 in chips)
Seat 6: ORVqY3rf9X6ANA/8s+On2Q ($36.85 in chips)
vkfxu8f/jMYKUk6Ly4eujw: posts small blind $1
ewN/vzF22+/gdzjIKBOlkA: posts big blind $2
*** HOLE CARDS ***
TMPDCBmlFGM9C+H58PC4sQ: folds
opJMdoq0E6TRbAQiweyQuA: folds
2lOU1DcvUZaMcxZ95XfzXw: folds
ORVqY3rf9X6ANA/8s+On2Q: calls $2
vkfxu8f/jMYKUk6Ly4eujw: raises $8 to $10
ewN/vzF22+/gdzjIKBOlkA: folds
ORVqY3rf9X6ANA/8s+On2Q: calls $8
*** FLOP *** [Jh Jd Kh]
vkfxu8f/jMYKUk6Ly4eujw: checks
ORVqY3rf9X6ANA/8s+On2Q: checks
*** TURN *** [Jh Jd Kh] [Ah]
vkfxu8f/jMYKUk6Ly4eujw: checks
ORVqY3rf9X6ANA/8s+On2Q: checks
*** RIVER *** [Jh Jd Kh Ah] [Qd]
vkfxu8f/jMYKUk6Ly4eujw: checks
ORVqY3rf9X6ANA/8s+On2Q: bets $24
vkfxu8f/jMYKUk6Ly4eujw: folds
ORVqY3rf9X6ANA/8s+On2Q collected $20.90 from pot
*** SUMMARY ***
Total pot $22 | Rake $1.10
Board [Jh Jd Kh Ah Qd]
Seat 1: vkfxu8f/jMYKUk6Ly4eujw (small blind) folded on the River
Seat 2: ewN/vzF22+/gdzjIKBOlkA (big blind) folded before Flop
Seat 3: TMPDCBmlFGM9C+H58PC4sQ folded before Flop (didn't bet)
Seat 4: opJMdoq0E6TRbAQiweyQuA folded before Flop (didn't bet)
Seat 5: 2lOU1DcvUZaMcxZ95XfzXw folded before Flop (didn't bet)
Seat 6: ORVqY3rf9X6ANA/8s+On2Q (button) collected ($20.90)



PokerStars Game #59942158504:  Hold'em No Limit ($1/$2) - 2009/07/01 1:57:58 ET
Table '4NGNnZ/osQfNq6abYqkJeA' 6-max Seat #1 is the button
Seat 1: 0Bc+WhbOvaaWIMmmui3q0g ($146.10 in chips)
Seat 2: 669iGNwYwgRZg3nhS+aDAQ ($105.75 in chips)
Seat 3: qXDd0ZyMIse0OBu8pxeQ3Q ($200 in chips)
Seat 4: sY+4Uuh5z/6AbXXaCS10jw ($294.10 in chips)
Seat 5: VvdR9F3I+2yELkfTVvC1dg ($210.80 in chips)
Seat 6: /PH6Ffnho4Ysm8S3V/oa+w ($51.20 in chips)
669iGNwYwgRZg3nhS+aDAQ: posts small blind $1
qXDd0ZyMIse0OBu8pxeQ3Q: posts big blind $2
*** HOLE CARDS ***
sY+4Uuh5z/6AbXXaCS10jw: folds
VvdR9F3I+2yELkfTVvC1dg: folds
/PH6Ffnho4Ysm8S3V/oa+w: folds
0Bc+WhbOvaaWIMmmui3q0g: folds
669iGNwYwgRZg3nhS+aDAQ: raises $6 to $8
qXDd0ZyMIse0OBu8pxeQ3Q: folds
669iGNwYwgRZg3nhS+aDAQ collected $4 from pot
*** SUMMARY ***
Total pot $4 | Rake $0
Seat 1: 0Bc+WhbOvaaWIMmmui3q0g (button) folded before Flop (didn't bet)
Seat 2: 669iGNwYwgRZg3nhS+aDAQ (small blind) collected ($4)
Seat 3: qXDd0ZyMIse0OBu8pxeQ3Q (big blind) folded before Flop
Seat 4: sY+4Uuh5z/6AbXXaCS10jw folded before Flop (didn't bet)
Seat 5: VvdR9F3I+2yELkfTVvC1dg folded before Flop (didn't bet)
Seat 6: /PH6Ffnho4Ysm8S3V/oa+w folded before Flop (didn't bet)



PokerStars Game #59942159792:  Hold'em No Limit ($1/$2) - 2009/07/01 1:58:01 ET
Table '/dyk+YdRGv90j2box35j8w' 6-max Seat #3 is the button
Seat 2: qCnEYuAE5y5A7bk6fO5/jQ ($488.20 in chips)
Seat 3: sTPOWERd9HWPCNrDBwsVjA ($212.50 in chips)
Seat 4: 4dMBh/1VTdeUTPCyhCs3UQ ($89.95 in chips)
Seat 5: VvdR9F3I+2yELkfTVvC1dg ($295.35 in chips)
Seat 6: C3qJBo7uxfFVDluE1lmK2w ($92.25 in chips)
4dMBh/1VTdeUTPCyhCs3UQ: posts small blind $1
VvdR9F3I+2yELkfTVvC1dg: posts big blind $2
*** HOLE CARDS ***
C3qJBo7uxfFVDluE1lmK2w: folds
qCnEYuAE5y5A7bk6fO5/jQ: folds
sTPOWERd9HWPCNrDBwsVjA: raises $4 to $6
4dMBh/1VTdeUTPCyhCs3UQ: folds
VvdR9F3I+2yELkfTVvC1dg: folds
sTPOWERd9HWPCNrDBwsVjA collected $5 from pot
*** SUMMARY ***
Total pot $5 | Rake $0
Seat 2: qCnEYuAE5y5A7bk6fO5/jQ folded before Flop (didn't bet)
Seat 3: sTPOWERd9HWPCNrDBwsVjA (button) collected ($5)
Seat 4: 4dMBh/1VTdeUTPCyhCs3UQ (small blind) folded before Flop
Seat 5: VvdR9F3I+2yELkfTVvC1dg (big blind) folded before Flop
Seat 6: C3qJBo7uxfFVDluE1lmK2w folded before Flop (didn't bet)



PokerStars Game #59942160612:  Hold'em No Limit ($1/$2) - 2009/07/01 1:58:02 ET
Table 'rKeCh+eBn4RNvybCUYkoTQ' 9-max Seat #8 is the button
Seat 1: yb4VS5k/eXxPEc0NRsIMJw ($57.65 in chips)
Seat 3: GX1heJ+DSsvm7gzSPsYhhQ ($54.75 in chips)
Seat 4: gxYDp0GZEzKoOg07Km9LaA ($90 in chips)
Seat 5: WUlHm+ydPPHG7Lb0rePSdA ($171.65 in chips)
Seat 6: +WoujR0xbwD7I2jrVmHuXw ($206.35 in chips)
Seat 7: rW/MyplHylMSBRaoRUzWrg ($31.80 in chips)
Seat 8: BkiGibLm0/LgS9GD9TKYJg ($107 in chips)
Seat 9: PfmlvZlFiss79a6IoEr11g ($64.20 in chips)
PfmlvZlFiss79a6IoEr11g: posts small blind $1
yb4VS5k/eXxPEc0NRsIMJw: posts big blind $2
*** HOLE CARDS ***
GX1heJ+DSsvm7gzSPsYhhQ: folds
gxYDp0GZEzKoOg07Km9LaA: folds
WUlHm+ydPPHG7Lb0rePSdA: raises $4 to $6
+WoujR0xbwD7I2jrVmHuXw: folds
rW/MyplHylMSBRaoRUzWrg: folds
BkiGibLm0/LgS9GD9TKYJg: calls $6
PfmlvZlFiss79a6IoEr11g: folds
yb4VS5k/eXxPEc0NRsIMJw: folds
*** FLOP *** [2h 3d Th]
PfmlvZlFiss79a6IoEr11g leaves the table
WUlHm+ydPPHG7Lb0rePSdA: bets $10
BkiGibLm0/LgS9GD9TKYJg: folds
WUlHm+ydPPHG7Lb0rePSdA collected $14.25 from pot
WUlHm+ydPPHG7Lb0rePSdA: doesn't show hand
*** SUMMARY ***
Total pot $15 | Rake $0.75
Board [2h 3d Th]
Seat 1: yb4VS5k/eXxPEc0NRsIMJw (big blind) folded before Flop
Seat 3: GX1heJ+DSsvm7gzSPsYhhQ folded before Flop (didn't bet)
Seat 4: gxYDp0GZEzKoOg07Km9LaA folded before Flop (didn't bet)
Seat 5: WUlHm+ydPPHG7Lb0rePSdA collected ($14.25)
Seat 6: +WoujR0xbwD7I2jrVmHuXw folded before Flop (didn't bet)
Seat 7: rW/MyplHylMSBRaoRUzWrg folded before Flop (didn't bet)
Seat 8: BkiGibLm0/LgS9GD9TKYJg (button) folded on the Flop
Seat 9: PfmlvZlFiss79a6IoEr11g (small blind) folded before Flop



PokerStars Game #59942161882:  Hold'em No Limit ($1/$2) - 2009/07/01 1:58:05 ET
Table 'xxAXogzmyuZKfe0LOYHaNQ' 2-max Seat #1 is the button
Seat 1: S14rjcU6LEC1LmuUtBK5Bg ($114 in chips)
Seat 2: ItDFe9gh5QYPQB9vC4ntUA ($211.10 in chips)
S14rjcU6LEC1LmuUtBK5Bg: posts small blind $1
ItDFe9gh5QYPQB9vC4ntUA: posts big blind $2
*** HOLE CARDS ***
S14rjcU6LEC1LmuUtBK5Bg: raises $2 to $4
ItDFe9gh5QYPQB9vC4ntUA: folds
S14rjcU6LEC1LmuUtBK5Bg collected $4 from pot
*** SUMMARY ***
Total pot $4 | Rake $0
Seat 1: S14rjcU6LEC1LmuUtBK5Bg (button) (small blind) collected ($4)
Seat 2: ItDFe9gh5QYPQB9vC4ntUA (big blind) folded before Flop



PokerStars Game #59942162754:  Hold'em No Limit ($1/$2) - 2009/07/01 1:58:06 ET
Table 'eyAQSIlgc2o1Jxvbve4WGg' 9-max Seat #2 is the button
Seat 1: UZEsV9yKUMqmpYPiOFpaZw ($70 in chips)
Seat 2: kM9CA+2UcdMjbCMbtUCGiA ($227.05 in chips)
Seat 3: ice1Sbe19zWIaKYoSmE5tw ($96.30 in chips)
Seat 4: CkE3IyJF1KvdaAOmZY5XqQ ($200 in chips)
Seat 5: mIKx5lhIt13X5eZQH0ZeMA ($146.75 in chips)
Seat 7: u3OrI5uGx9mx1fE7dgr+EA ($107.55 in chips)
Seat 8: 254YPxPJr5Sw58bkD0YqYQ ($201 in chips)
Seat 9: WUlHm+ydPPHG7Lb0rePSdA ($122.20 in chips)
ice1Sbe19zWIaKYoSmE5tw: posts small blind $1
CkE3IyJF1KvdaAOmZY5XqQ: posts big blind $2
*** HOLE CARDS ***
mIKx5lhIt13X5eZQH0ZeMA: folds
u3OrI5uGx9mx1fE7dgr+EA: calls $2
254YPxPJr5Sw58bkD0YqYQ: folds
WUlHm+ydPPHG7Lb0rePSdA: folds
UZEsV9yKUMqmpYPiOFpaZw: calls $2
kM9CA+2UcdMjbCMbtUCGiA: folds
ice1Sbe19zWIaKYoSmE5tw: folds
CkE3IyJF1KvdaAOmZY5XqQ: raises $8 to $10
u3OrI5uGx9mx1fE7dgr+EA: folds
UZEsV9yKUMqmpYPiOFpaZw: folds
CkE3IyJF1KvdaAOmZY5XqQ collected $7 from pot
*** SUMMARY ***
Total pot $7 | Rake $0
Seat 1: UZEsV9yKUMqmpYPiOFpaZw folded before Flop
Seat 2: kM9CA+2UcdMjbCMbtUCGiA (button) folded before Flop (didn't bet)
Seat 3: ice1Sbe19zWIaKYoSmE5tw (small blind) folded before Flop
Seat 4: CkE3IyJF1KvdaAOmZY5XqQ (big blind) collected ($7)
Seat 5: mIKx5lhIt13X5eZQH0ZeMA folded before Flop (didn't bet)
Seat 7: u3OrI5uGx9mx1fE7dgr+EA folded before Flop
Seat 8: 254YPxPJr5Sw58bkD0YqYQ folded before Flop (didn't bet)
Seat 9: WUlHm+ydPPHG7Lb0rePSdA folded before Flop (didn't bet)



PokerStars Game #59942163486:  Hold'em No Limit ($1/$2) - 2009/07/01 1:58:08 ET
Table 'o63a8j70meKHUtgLFryQvg' 9-max Seat #1 is the button
Seat 1: +1R0op5O3Gf6aUPJTw7jjA ($194 in chips)
Seat 2: SgA0Zfa/3yhNp7ILXcXcCg ($114.30 in chips)
Seat 3: IYBKVnE2Basnr88BAhH+bQ ($265.40 in chips)
Seat 4: ZYHoLw2lWmRS7CSHi8L8Xg ($209.90 in chips)
Seat 5: g3ZVTc1EbSNXYYMO82jL7Q ($223.30 in chips)
Seat 6: CUZwDpLTQKhzarPe+JCLOQ ($203 in chips)
Seat 7: kM9CA+2UcdMjbCMbtUCGiA ($200 in chips)
Seat 8: ItDFe9gh5QYPQB9vC4ntUA ($384.05 in chips)
Seat 9: rW/MyplHylMSBRaoRUzWrg ($40 in chips)
SgA0Zfa/3yhNp7ILXcXcCg: posts small blind $1
IYBKVnE2Basnr88BAhH+bQ: posts big blind $2
*** HOLE CARDS ***
ZYHoLw2lWmRS7CSHi8L8Xg: folds
g3ZVTc1EbSNXYYMO82jL7Q: raises $6 to $8
CUZwDpLTQKhzarPe+JCLOQ: folds
kM9CA+2UcdMjbCMbtUCGiA: folds
ItDFe9gh5QYPQB9vC4ntUA: calls $8
rW/MyplHylMSBRaoRUzWrg: folds
+1R0op5O3Gf6aUPJTw7jjA: folds
SgA0Zfa/3yhNp7ILXcXcCg: folds
IYBKVnE2Basnr88BAhH+bQ: folds
*** FLOP *** [Td Qs 5s]
g3ZVTc1EbSNXYYMO82jL7Q: bets $16
ItDFe9gh5QYPQB9vC4ntUA: raises $26 to $42
g3ZVTc1EbSNXYYMO82jL7Q: calls $26
*** TURN *** [Td Qs 5s] [3d]
g3ZVTc1EbSNXYYMO82jL7Q: checks
ItDFe9gh5QYPQB9vC4ntUA: checks
*** RIVER *** [Td Qs 5s 3d] [4d]
g3ZVTc1EbSNXYYMO82jL7Q: bets $75
ItDFe9gh5QYPQB9vC4ntUA: folds
g3ZVTc1EbSNXYYMO82jL7Q collected $100 from pot
*** SUMMARY ***
Total pot $103 | Rake $3
Board [Td Qs 5s 3d 4d]
Seat 1: +1R0op5O3Gf6aUPJTw7jjA (button) folded before Flop (didn't bet)
Seat 2: SgA0Zfa/3yhNp7ILXcXcCg (small blind) folded before Flop
Seat 3: IYBKVnE2Basnr88BAhH+bQ (big blind) folded before Flop
Seat 4: ZYHoLw2lWmRS7CSHi8L8Xg folded before Flop (didn't bet)
Seat 5: g3ZVTc1EbSNXYYMO82jL7Q collected ($100)
Seat 6: CUZwDpLTQKhzarPe+JCLOQ folded before Flop (didn't bet)
Seat 7: kM9CA+2UcdMjbCMbtUCGiA folded before Flop (didn't bet)
Seat 8: ItDFe9gh5QYPQB9vC4ntUA folded on the River
Seat 9: rW/MyplHylMSBRaoRUzWrg folded before Flop (didn't bet)



PokerStars Game #59942164934:  Hold'em No Limit ($1/$2) - 2009/07/01 1:58:10 ET
Table 'JArEO7oOXEgVwX3NVsRD+A' 9-max Seat #6 is the button
Seat 1: Q104K4iDGcqOlVrjAkzPEA ($87.05 in chips)
Seat 2: g3ZVTc1EbSNXYYMO82jL7Q ($371.10 in chips)
Seat 3: IYBKVnE2Basnr88BAhH+bQ ($226.25 in chips)
Seat 4: 5Q8U6iZbeO7xJSS4qvDP5g ($260.60 in chips)
Seat 5: QCeHcOIuXMfz9IQu0lUQ0w ($30.70 in chips)
Seat 6: GX1heJ+DSsvm7gzSPsYhhQ ($34 in chips)
Seat 7: LQoVc4pQLz/wlryLTs7bRA ($79.50 in chips)
Seat 8: ik2CQB6kPzJaHCd/C6V0xg ($100 in chips)
LQoVc4pQLz/wlryLTs7bRA: posts small blind $1
ik2CQB6kPzJaHCd/C6V0xg: posts big blind $2
*** HOLE CARDS ***
Q104K4iDGcqOlVrjAkzPEA: folds
g3ZVTc1EbSNXYYMO82jL7Q: folds
IYBKVnE2Basnr88BAhH+bQ: folds
5Q8U6iZbeO7xJSS4qvDP5g: folds
QCeHcOIuXMfz9IQu0lUQ0w: folds
GX1heJ+DSsvm7gzSPsYhhQ: folds
LQoVc4pQLz/wlryLTs7bRA: calls $1
ik2CQB6kPzJaHCd/C6V0xg: checks
*** FLOP *** [Th 9h 6s]
LQoVc4pQLz/wlryLTs7bRA: checks
ik2CQB6kPzJaHCd/C6V0xg: checks
*** TURN *** [Th 9h 6s] [Kh]
LQoVc4pQLz/wlryLTs7bRA: bets $6
ik2CQB6kPzJaHCd/C6V0xg: folds
LQoVc4pQLz/wlryLTs7bRA collected $3.80 from pot
LQoVc4pQLz/wlryLTs7bRA: doesn't show hand
*** SUMMARY ***
Total pot $4 | Rake $0.20
Board [Th 9h 6s Kh]
Seat 1: Q104K4iDGcqOlVrjAkzPEA folded before Flop (didn't bet)
Seat 2: g3ZVTc1EbSNXYYMO82jL7Q folded before Flop (didn't bet)
Seat 3: IYBKVnE2Basnr88BAhH+bQ folded before Flop (didn't bet)
Seat 4: 5Q8U6iZbeO7xJSS4qvDP5g folded before Flop (didn't bet)
Seat 5: QCeHcOIuXMfz9IQu0lUQ0w folded before Flop (didn't bet)
Seat 6: GX1heJ+DSsvm7gzSPsYhhQ (button) folded before Flop (didn't bet)
Seat 7: LQoVc4pQLz/wlryLTs7bRA (small blind) collected ($3.80)
Seat 8: ik2CQB6kPzJaHCd/C6V0xg (big blind) folded on the Turn



PokerStars Game #59942165210:  Hold'em No Limit ($1/$2) - 2009/07/01 1:58:11 ET
Table 'G1Oqdy4Pqdb5gtx40rUBzA' 6-max Seat #6 is the button
Seat 1: 4dMBh/1VTdeUTPCyhCs3UQ ($43.05 in chips)
Seat 2: m7mYVfnCOK5TE/VkN/FhOg ($231.75 in chips)
Seat 3: VvdR9F3I+2yELkfTVvC1dg ($411.90 in chips)
Seat 4: B87ikIyZ/TzAVeXf38Ny0g ($200 in chips)
Seat 5: F1+Ml47qRQWunzPnGhLLzQ ($235.75 in chips)
Seat 6: qCnEYuAE5y5A7bk6fO5/jQ ($200 in chips)
4dMBh/1VTdeUTPCyhCs3UQ: posts small blind $1
m7mYVfnCOK5TE/VkN/FhOg: posts big blind $2
*** HOLE CARDS ***
VvdR9F3I+2yELkfTVvC1dg: folds
B87ikIyZ/TzAVeXf38Ny0g: folds
F1+Ml47qRQWunzPnGhLLzQ: folds
qCnEYuAE5y5A7bk6fO5/jQ: folds
4dMBh/1VTdeUTPCyhCs3UQ: calls $1
m7mYVfnCOK5TE/VkN/FhOg: raises $6 to $8
4dMBh/1VTdeUTPCyhCs3UQ: calls $6
*** FLOP *** [8c Qc 2s]
4dMBh/1VTdeUTPCyhCs3UQ: bets $12
m7mYVfnCOK5TE/VkN/FhOg: raises $211.75 to $223.75 and is all-in
4dMBh/1VTdeUTPCyhCs3UQ: folds
m7mYVfnCOK5TE/VkN/FhOg collected $38.05 from pot
m7mYVfnCOK5TE/VkN/FhOg: doesn't show hand
*** SUMMARY ***
Total pot $40 | Rake $1.95
Board [8c Qc 2s]
Seat 1: 4dMBh/1VTdeUTPCyhCs3UQ (small blind) folded on the Flop
Seat 2: m7mYVfnCOK5TE/VkN/FhOg (big blind) collected ($38.05)
Seat 3: VvdR9F3I+2yELkfTVvC1dg folded before Flop (didn't bet)
Seat 4: B87ikIyZ/TzAVeXf38Ny0g folded before Flop (didn't bet)
Seat 5: F1+Ml47qRQWunzPnGhLLzQ folded before Flop (didn't bet)
Seat 6: qCnEYuAE5y5A7bk6fO5/jQ (button) folded before Flop (didn't bet)



PokerStars Game #59942166904:  Hold'em No Limit ($1/$2) - 2009/07/01 1:58:14 ET
Table '1MktSAbrFdhtrrteXKmFDA' 2-max Seat #1 is the button
Seat 1: WfaZs12BkYO+BUX5VWpuWQ ($38 in chips)
Seat 2: aOL8geThaYp2iadSHl1h1g ($125 in chips)
WfaZs12BkYO+BUX5VWpuWQ: posts small blind $1
aOL8geThaYp2iadSHl1h1g: posts big blind $2
*** HOLE CARDS ***
WfaZs12BkYO+BUX5VWpuWQ: raises $2 to $4
aOL8geThaYp2iadSHl1h1g: folds
WfaZs12BkYO+BUX5VWpuWQ collected $4 from pot
*** SUMMARY ***
Total pot $4 | Rake $0
Seat 1: WfaZs12BkYO+BUX5VWpuWQ (button) (small blind) collected ($4)
Seat 2: aOL8geThaYp2iadSHl1h1g (big blind) folded before Flop



PokerStars Game #59942167274:  Hold'em No Limit ($1/$2) - 2009/07/01 1:58:15 ET
Table '5/wEe6JmtGD7vufSA2RG7A' 2-max Seat #1 is the button
Seat 1: pVqEzK9wXlRMECnb1Zg4Zw ($241.80 in chips)
Seat 2: aOL8geThaYp2iadSHl1h1g ($410 in chips)
pVqEzK9wXlRMECnb1Zg4Zw: posts small blind $1
aOL8geThaYp2iadSHl1h1g: posts big blind $2
*** HOLE CARDS ***
pVqEzK9wXlRMECnb1Zg4Zw: raises $6 to $8
aOL8geThaYp2iadSHl1h1g: folds
pVqEzK9wXlRMECnb1Zg4Zw collected $4 from pot
pVqEzK9wXlRMECnb1Zg4Zw: doesn't show hand
*** SUMMARY ***
Total pot $4 | Rake $0
Seat 1: pVqEzK9wXlRMECnb1Zg4Zw (button) (small blind) collected ($4)
Seat 2: aOL8geThaYp2iadSHl1h1g (big blind) folded before Flop



PokerStars Game #59942167484:  Hold'em No Limit ($1/$2) - 2009/07/01 1:58:16 ET
Table 'bIihwBANJSFqlHPPtset+w' 9-max Seat #4 is the button
Seat 1: KqHysDSpCPaPyK3tJC1aEw ($223.25 in chips)
Seat 2: lQYT23h5QCUVZAKxjOO39Q ($204.20 in chips)
Seat 4: XmmQKhdZdYwJP9Bfu+Qfuw ($188 in chips)
Seat 5: vxbbJLsS1bva6tW2NiFssg ($200 in chips)
Seat 6: CkE3IyJF1KvdaAOmZY5XqQ ($403.15 in chips)
Seat 7: pCmk6FpSOLJ+85o1tLHIag ($137.30 in chips)
Seat 8: 254YPxPJr5Sw58bkD0YqYQ ($200 in chips)
Seat 9: kM9CA+2UcdMjbCMbtUCGiA ($200 in chips)
vxbbJLsS1bva6tW2NiFssg: posts small blind $1
CkE3IyJF1KvdaAOmZY5XqQ: posts big blind $2
*** HOLE CARDS ***
pCmk6FpSOLJ+85o1tLHIag: folds
254YPxPJr5Sw58bkD0YqYQ: folds
kM9CA+2UcdMjbCMbtUCGiA: folds
KqHysDSpCPaPyK3tJC1aEw: folds
lQYT23h5QCUVZAKxjOO39Q: folds
XmmQKhdZdYwJP9Bfu+Qfuw: folds
vxbbJLsS1bva6tW2NiFssg: calls $1
CkE3IyJF1KvdaAOmZY5XqQ: checks
*** FLOP *** [5s Qs 2d]
/gll27k+xWYV7Fbki0lFDQ joins the table at seat #3
vxbbJLsS1bva6tW2NiFssg: checks
CkE3IyJF1KvdaAOmZY5XqQ: checks
*** TURN *** [5s Qs 2d] [6d]
vxbbJLsS1bva6tW2NiFssg: checks
CkE3IyJF1KvdaAOmZY5XqQ: checks
*** RIVER *** [5s Qs 2d 6d] [3h]
vxbbJLsS1bva6tW2NiFssg: checks
CkE3IyJF1KvdaAOmZY5XqQ: checks
*** SHOW DOWN ***
vxbbJLsS1bva6tW2NiFssg: shows [Jh 9s] (high card Queen)
CkE3IyJF1KvdaAOmZY5XqQ: shows [2h Th] (a pair of Deuces)
CkE3IyJF1KvdaAOmZY5XqQ collected $3.80 from pot
*** SUMMARY ***
Total pot $4 | Rake $0.20
Board [5s Qs 2d 6d 3h]
Seat 1: KqHysDSpCPaPyK3tJC1aEw folded before Flop (didn't bet)
Seat 2: lQYT23h5QCUVZAKxjOO39Q folded before Flop (didn't bet)
Seat 4: XmmQKhdZdYwJP9Bfu+Qfuw (button) folded before Flop (didn't bet)
Seat 5: vxbbJLsS1bva6tW2NiFssg (small blind) showed [Jh 9s] and lost with high card Queen
Seat 6: CkE3IyJF1KvdaAOmZY5XqQ (big blind) showed [2h Th] and won ($3.80) with a pair of Deuces
Seat 7: pCmk6FpSOLJ+85o1tLHIag folded before Flop (didn't bet)
Seat 8: 254YPxPJr5Sw58bkD0YqYQ folded before Flop (didn't bet)
Seat 9: kM9CA+2UcdMjbCMbtUCGiA folded before Flop (didn't bet)



PokerStars Game #59942168470:  Hold'em No Limit ($1/$2) - 2009/07/01 1:58:18 ET
Table 'pPQgcj9XT9CHBsbo1WTBug' 6-max Seat #5 is the button
Seat 1: DFVYDA6dKQy7R7mGIKogZA ($154.20 in chips)
Seat 2: qXDd0ZyMIse0OBu8pxeQ3Q ($200 in chips)
Seat 3: sSAA879uXOGR+8Mf3zLa6Q ($296.40 in chips)
Seat 4: cwfuMyvDC7J7SqX2leDC8g ($59.30 in chips)
Seat 5: vkfxu8f/jMYKUk6Ly4eujw ($197 in chips)
Seat 6: Yr7pZltpy3IUNdKS9PCEiw ($139.60 in chips)
Yr7pZltpy3IUNdKS9PCEiw: posts small blind $1
DFVYDA6dKQy7R7mGIKogZA: posts big blind $2
*** HOLE CARDS ***
qXDd0ZyMIse0OBu8pxeQ3Q: folds
sSAA879uXOGR+8Mf3zLa6Q: folds
cwfuMyvDC7J7SqX2leDC8g: raises $2 to $4
vkfxu8f/jMYKUk6Ly4eujw: folds
Yr7pZltpy3IUNdKS9PCEiw: calls $3
DFVYDA6dKQy7R7mGIKogZA: calls $2
*** FLOP *** [Jc 2h Jh]
Yr7pZltpy3IUNdKS9PCEiw: checks
DFVYDA6dKQy7R7mGIKogZA: bets $2
cwfuMyvDC7J7SqX2leDC8g: calls $2
Yr7pZltpy3IUNdKS9PCEiw: folds
*** TURN *** [Jc 2h Jh] [7c]
DFVYDA6dKQy7R7mGIKogZA: checks
cwfuMyvDC7J7SqX2leDC8g: checks
*** RIVER *** [Jc 2h Jh 7c] [8d]
DFVYDA6dKQy7R7mGIKogZA: checks
cwfuMyvDC7J7SqX2leDC8g: checks
*** SHOW DOWN ***
DFVYDA6dKQy7R7mGIKogZA: shows [Qh 7d] (two pair, Jacks and Sevens)
cwfuMyvDC7J7SqX2leDC8g: mucks hand
DFVYDA6dKQy7R7mGIKogZA collected $15.25 from pot
*** SUMMARY ***
Total pot $16 | Rake $0.75
Board [Jc 2h Jh 7c 8d]
Seat 1: DFVYDA6dKQy7R7mGIKogZA (big blind) showed [Qh 7d] and won ($15.25) with two pair, Jacks and Sevens
Seat 2: qXDd0ZyMIse0OBu8pxeQ3Q folded before Flop (didn't bet)
Seat 3: sSAA879uXOGR+8Mf3zLa6Q folded before Flop (didn't bet)
Seat 4: cwfuMyvDC7J7SqX2leDC8g mucked
Seat 5: vkfxu8f/jMYKUk6Ly4eujw (button) folded before Flop (didn't bet)
Seat 6: Yr7pZltpy3IUNdKS9PCEiw (small blind) folded on the Flop



PokerStars Game #59942168790:  Hold'em No Limit ($1/$2) - 2009/07/01 1:58:18 ET
Table '7goFpXy7qyiK5mwx+Ucf6A' 6-max Seat #3 is the button
Seat 1: VHmJJYp7TGQwcWROQ8dqXw ($62.30 in chips)
Seat 2: BWhgxe7gWiYobRbwdG+d2Q ($196 in chips)
Seat 3: mfy7uGZcqA2PVQqEVbJ7+g ($146.25 in chips)
Seat 4: fE+LHW/7rpfXW14g8LhGjA ($44.70 in chips)
Seat 5: opJMdoq0E6TRbAQiweyQuA ($40 in chips)
Seat 6: VvdR9F3I+2yELkfTVvC1dg ($212.65 in chips)
fE+LHW/7rpfXW14g8LhGjA: posts small blind $1
opJMdoq0E6TRbAQiweyQuA: posts big blind $2
*** HOLE CARDS ***
VvdR9F3I+2yELkfTVvC1dg: raises $2 to $4
VHmJJYp7TGQwcWROQ8dqXw: calls $4
BWhgxe7gWiYobRbwdG+d2Q: folds
mfy7uGZcqA2PVQqEVbJ7+g: calls $4
fE+LHW/7rpfXW14g8LhGjA: calls $3
opJMdoq0E6TRbAQiweyQuA: folds
*** FLOP *** [8d Th 4d]
fE+LHW/7rpfXW14g8LhGjA: bets $2
VvdR9F3I+2yELkfTVvC1dg: folds
VHmJJYp7TGQwcWROQ8dqXw: raises $4 to $6
mfy7uGZcqA2PVQqEVbJ7+g: raises $23 to $29
fE+LHW/7rpfXW14g8LhGjA: folds
VHmJJYp7TGQwcWROQ8dqXw: folds
mfy7uGZcqA2PVQqEVbJ7+g collected $30.45 from pot
mfy7uGZcqA2PVQqEVbJ7+g: doesn't show hand
*** SUMMARY ***
Total pot $32 | Rake $1.55
Board [8d Th 4d]
Seat 1: VHmJJYp7TGQwcWROQ8dqXw folded on the Flop
Seat 2: BWhgxe7gWiYobRbwdG+d2Q folded before Flop (didn't bet)
Seat 3: mfy7uGZcqA2PVQqEVbJ7+g (button) collected ($30.45)
Seat 4: fE+LHW/7rpfXW14g8LhGjA (small blind) folded on the Flop
Seat 5: opJMdoq0E6TRbAQiweyQuA (big blind) folded before Flop
Seat 6: VvdR9F3I+2yELkfTVvC1dg folded on the Flop



PokerStars Game #59942168414:  Hold'em No Limit ($1/$2) - 2009/07/01 1:58:18 ET
Table 'gnHBqWll9O3fxG7Ojkz/ng' 9-max Seat #9 is the button
Seat 1: MtdNf9cdM7+0CSU0dx4USA ($77.75 in chips)
Seat 3: 5Q8U6iZbeO7xJSS4qvDP5g ($250.15 in chips)
Seat 5: rBQDMkKm9cZn6M9NPsiVew ($166.15 in chips)
Seat 6: KqHysDSpCPaPyK3tJC1aEw ($200 in chips)
Seat 7: 254YPxPJr5Sw58bkD0YqYQ ($200 in chips)
Seat 8: cM6efHzdxoqYm0EQKP4TTQ ($131.05 in chips)
Seat 9: GX1heJ+DSsvm7gzSPsYhhQ ($53.55 in chips)
MtdNf9cdM7+0CSU0dx4USA: posts small blind $1
H6Z4+qu8gR0VUiPOijndVg: is sitting out
5Q8U6iZbeO7xJSS4qvDP5g: posts big blind $2
*** HOLE CARDS ***
rBQDMkKm9cZn6M9NPsiVew: folds
KqHysDSpCPaPyK3tJC1aEw: folds
254YPxPJr5Sw58bkD0YqYQ: folds
cM6efHzdxoqYm0EQKP4TTQ: folds
cM6efHzdxoqYm0EQKP4TTQ leaves the table
GX1heJ+DSsvm7gzSPsYhhQ: folds
MtdNf9cdM7+0CSU0dx4USA: calls $1
5Q8U6iZbeO7xJSS4qvDP5g: raises $5 to $7
MtdNf9cdM7+0CSU0dx4USA: calls $5
*** FLOP *** [3h 9s 4s]
MtdNf9cdM7+0CSU0dx4USA: checks
5Q8U6iZbeO7xJSS4qvDP5g: bets $9
MtdNf9cdM7+0CSU0dx4USA: raises $17 to $26
5Q8U6iZbeO7xJSS4qvDP5g: folds
MtdNf9cdM7+0CSU0dx4USA collected $30.45 from pot
*** SUMMARY ***
Total pot $32 | Rake $1.55
Board [3h 9s 4s]
Seat 1: MtdNf9cdM7+0CSU0dx4USA (small blind) collected ($30.45)
Seat 3: 5Q8U6iZbeO7xJSS4qvDP5g (big blind) folded on the Flop
Seat 5: rBQDMkKm9cZn6M9NPsiVew folded before Flop (didn't bet)
Seat 6: KqHysDSpCPaPyK3tJC1aEw folded before Flop (didn't bet)
Seat 7: 254YPxPJr5Sw58bkD0YqYQ folded before Flop (didn't bet)
Seat 8: cM6efHzdxoqYm0EQKP4TTQ folded before Flop (didn't bet)
Seat 9: GX1heJ+DSsvm7gzSPsYhhQ (button) folded before Flop (didn't bet)



PokerStars Game #59942169090:  Hold'em No Limit ($1/$2) - 2009/07/01 1:58:19 ET
Table 'LL4bDFyhj5hsMpzaDugJZg' 6-max Seat #4 is the button
Seat 1: ubtx4Z5L+AcK71MTvYiGVw ($200 in chips)
Seat 2: TMPDCBmlFGM9C+H58PC4sQ ($41.15 in chips)
Seat 3: opJMdoq0E6TRbAQiweyQuA ($41.55 in chips)
Seat 4: 8srN1dKQePlsv0GyTada+Q ($389.60 in chips)
Seat 5: SZwM+UmIX32Re10mzQ4w/w ($58.60 in chips)
Seat 6: mddoKnqZkdOH7AJOJ/i0DA ($209.30 in chips)
SZwM+UmIX32Re10mzQ4w/w: posts small blind $1
mddoKnqZkdOH7AJOJ/i0DA: posts big blind $2
*** HOLE CARDS ***
ubtx4Z5L+AcK71MTvYiGVw: folds
TMPDCBmlFGM9C+H58PC4sQ: folds
opJMdoq0E6TRbAQiweyQuA: folds
8srN1dKQePlsv0GyTada+Q: folds
SZwM+UmIX32Re10mzQ4w/w: folds
mddoKnqZkdOH7AJOJ/i0DA collected $2 from pot
*** SUMMARY ***
Total pot $2 | Rake $0
Seat 1: ubtx4Z5L+AcK71MTvYiGVw folded before Flop (didn't bet)
Seat 2: TMPDCBmlFGM9C+H58PC4sQ folded before Flop (didn't bet)
Seat 3: opJMdoq0E6TRbAQiweyQuA folded before Flop (didn't bet)
Seat 4: 8srN1dKQePlsv0GyTada+Q (button) folded before Flop (didn't bet)
Seat 5: SZwM+UmIX32Re10mzQ4w/w (small blind) folded before Flop
Seat 6: mddoKnqZkdOH7AJOJ/i0DA (big blind) collected ($2)



PokerStars Game #59942170214:  Hold'em No Limit ($1/$2) - 2009/07/01 1:58:21 ET
Table 'WCA60bDA8ecovUgFSIZkTQ' 9-max Seat #3 is the button
Seat 1: 3RFwE6igZ1BGKOGuab6iiw ($76.65 in chips)
Seat 3: g7gL2NLJCdZPPV399WKT1w ($50.95 in chips)
Seat 4: IYBKVnE2Basnr88BAhH+bQ ($204.60 in chips)
Seat 5: +T/63sAeZzWyHchahJ36GQ ($40 in chips)
Seat 6: YoKKKdDDs7gFzP1Z65Sdaw ($94 in chips)
Seat 7: tsTv4D+ne2W0qhUt9HlcMw ($200.65 in chips)
Seat 8: mJhwEVg7F695DiO+RIhM5g ($242.45 in chips)
Seat 9: ItDFe9gh5QYPQB9vC4ntUA ($208 in chips)
IYBKVnE2Basnr88BAhH+bQ: posts small blind $1
+T/63sAeZzWyHchahJ36GQ: posts big blind $2
rW/MyplHylMSBRaoRUzWrg: sits out
*** HOLE CARDS ***
YoKKKdDDs7gFzP1Z65Sdaw: folds
tsTv4D+ne2W0qhUt9HlcMw: folds
mJhwEVg7F695DiO+RIhM5g: folds
ItDFe9gh5QYPQB9vC4ntUA: folds
3RFwE6igZ1BGKOGuab6iiw: folds
g7gL2NLJCdZPPV399WKT1w: folds
IYBKVnE2Basnr88BAhH+bQ: folds
+T/63sAeZzWyHchahJ36GQ collected $2 from pot
+T/63sAeZzWyHchahJ36GQ: doesn't show hand
*** SUMMARY ***
Total pot $2 | Rake $0
Seat 1: 3RFwE6igZ1BGKOGuab6iiw folded before Flop (didn't bet)
Seat 3: g7gL2NLJCdZPPV399WKT1w (button) folded before Flop (didn't bet)
Seat 4: IYBKVnE2Basnr88BAhH+bQ (small blind) folded before Flop
Seat 5: +T/63sAeZzWyHchahJ36GQ (big blind) collected ($2)
Seat 6: YoKKKdDDs7gFzP1Z65Sdaw folded before Flop (didn't bet)
Seat 7: tsTv4D+ne2W0qhUt9HlcMw folded before Flop (didn't bet)
Seat 8: mJhwEVg7F695DiO+RIhM5g folded before Flop (didn't bet)
Seat 9: ItDFe9gh5QYPQB9vC4ntUA folded before Flop (didn't bet)



PokerStars Game #59942170264:  Hold'em No Limit ($1/$2) - 2009/07/01 1:58:21 ET
Table 'rsKRKlGHlxVyqJxzO2a2Ow' 9-max Seat #6 is the button
Seat 1: KqHysDSpCPaPyK3tJC1aEw ($212.30 in chips)
Seat 3: kM9CA+2UcdMjbCMbtUCGiA ($200 in chips)
Seat 4: 31HuO+DQxppUQEedBWukug ($133.10 in chips)
Seat 5: 5Q8U6iZbeO7xJSS4qvDP5g ($250.55 in chips)
Seat 6: H6Z4+qu8gR0VUiPOijndVg ($200 in chips)
Seat 7: GX1heJ+DSsvm7gzSPsYhhQ ($54 in chips)
Seat 8: CkE3IyJF1KvdaAOmZY5XqQ ($206.70 in chips)
Seat 9: gRbvhSUVg+TNaTjaJecIRw ($53.60 in chips)
GX1heJ+DSsvm7gzSPsYhhQ: posts small blind $1
CkE3IyJF1KvdaAOmZY5XqQ: posts big blind $2
254YPxPJr5Sw58bkD0YqYQ: sits out
*** HOLE CARDS ***
gRbvhSUVg+TNaTjaJecIRw: folds
KqHysDSpCPaPyK3tJC1aEw: folds
kM9CA+2UcdMjbCMbtUCGiA: folds
31HuO+DQxppUQEedBWukug: raises $4 to $6
5Q8U6iZbeO7xJSS4qvDP5g: folds
H6Z4+qu8gR0VUiPOijndVg: folds
GX1heJ+DSsvm7gzSPsYhhQ: folds
CkE3IyJF1KvdaAOmZY5XqQ: calls $4
*** FLOP *** [Ks 7d Ah]
CkE3IyJF1KvdaAOmZY5XqQ: checks
31HuO+DQxppUQEedBWukug: bets $8
CkE3IyJF1KvdaAOmZY5XqQ: raises $12 to $20
31HuO+DQxppUQEedBWukug: folds
CkE3IyJF1KvdaAOmZY5XqQ collected $27.60 from pot
*** SUMMARY ***
Total pot $29 | Rake $1.40
Board [Ks 7d Ah]
Seat 1: KqHysDSpCPaPyK3tJC1aEw folded before Flop (didn't bet)
Seat 3: kM9CA+2UcdMjbCMbtUCGiA folded before Flop (didn't bet)
Seat 4: 31HuO+DQxppUQEedBWukug folded on the Flop
Seat 5: 5Q8U6iZbeO7xJSS4qvDP5g folded before Flop (didn't bet)
Seat 6: H6Z4+qu8gR0VUiPOijndVg (button) folded before Flop (didn't bet)
Seat 7: GX1heJ+DSsvm7gzSPsYhhQ (small blind) folded before Flop
Seat 8: CkE3IyJF1KvdaAOmZY5XqQ (big blind) collected ($27.60)
Seat 9: gRbvhSUVg+TNaTjaJecIRw folded before Flop (didn't bet)



PokerStars Game #59942170210:  Hold'em No Limit ($1/$2) - 2009/07/01 1:58:21 ET
Table 'NmY84NAf9Mh0ckAckHnh5g' 2-max Seat #2 is the button
Seat 1: 6hvg964TSqZ3AL/0XK9aVQ ($389.20 in chips)
Seat 2: RwDoM55ZeQuI2ADyJhOb2Q ($586.80 in chips)
RwDoM55ZeQuI2ADyJhOb2Q: posts small blind $1
6hvg964TSqZ3AL/0XK9aVQ: posts big blind $2
*** HOLE CARDS ***
RwDoM55ZeQuI2ADyJhOb2Q: raises $4 to $6
6hvg964TSqZ3AL/0XK9aVQ: raises $4 to $10
RwDoM55ZeQuI2ADyJhOb2Q: calls $4
*** FLOP *** [As Ad 3c]
6hvg964TSqZ3AL/0XK9aVQ: checks
RwDoM55ZeQuI2ADyJhOb2Q: checks
*** TURN *** [As Ad 3c] [Qd]
6hvg964TSqZ3AL/0XK9aVQ: bets $10
RwDoM55ZeQuI2ADyJhOb2Q: raises $20 to $30
6hvg964TSqZ3AL/0XK9aVQ: folds
RwDoM55ZeQuI2ADyJhOb2Q collected $39.50 from pot
RwDoM55ZeQuI2ADyJhOb2Q: doesn't show hand
*** SUMMARY ***
Total pot $40 | Rake $0.50
Board [As Ad 3c Qd]
Seat 1: 6hvg964TSqZ3AL/0XK9aVQ (big blind) folded on the Turn
Seat 2: RwDoM55ZeQuI2ADyJhOb2Q (button) (small blind) collected ($39.50)



PokerStars Game #59942170778:  Hold'em No Limit ($1/$2) - 2009/07/01 1:58:22 ET
Table 'xxAXogzmyuZKfe0LOYHaNQ' 2-max Seat #2 is the button
Seat 1: S14rjcU6LEC1LmuUtBK5Bg ($116 in chips)
Seat 2: ItDFe9gh5QYPQB9vC4ntUA ($209.10 in chips)
ItDFe9gh5QYPQB9vC4ntUA: posts small blind $1
S14rjcU6LEC1LmuUtBK5Bg: posts big blind $2
*** HOLE CARDS ***
ItDFe9gh5QYPQB9vC4ntUA: folds
S14rjcU6LEC1LmuUtBK5Bg collected $2 from pot
*** SUMMARY ***
Total pot $2 | Rake $0
Seat 1: S14rjcU6LEC1LmuUtBK5Bg (big blind) collected ($2)
Seat 2: ItDFe9gh5QYPQB9vC4ntUA (button) (small blind) folded before Flop



PokerStars Game #59942170780:  Hold'em No Limit ($1/$2) - 2009/07/01 1:58:22 ET
Table 'ztv6V3FN2bQ9nmJPPdx6nQ' 6-max Seat #1 is the button
Seat 1: 6fLdOUCRtX71xbVRhJEq8w ($362.35 in chips)
Seat 2: 5Y+ZGWLI4gnlpApDX5vy1A ($301.05 in chips)
Seat 3: XP9UmPc7hfMVafyEiwJMAA ($197 in chips)
Seat 4: UaZ5yj+6LjtWqMQg2QskUw ($84.40 in chips)
Seat 5: sTPOWERd9HWPCNrDBwsVjA ($224.90 in chips)
Seat 6: mfy7uGZcqA2PVQqEVbJ7+g ($180.70 in chips)
5Y+ZGWLI4gnlpApDX5vy1A: posts small blind $1
XP9UmPc7hfMVafyEiwJMAA: posts big blind $2
*** HOLE CARDS ***
UaZ5yj+6LjtWqMQg2QskUw: folds
sTPOWERd9HWPCNrDBwsVjA: folds
mfy7uGZcqA2PVQqEVbJ7+g: folds
6fLdOUCRtX71xbVRhJEq8w: raises $4 to $6
5Y+ZGWLI4gnlpApDX5vy1A: folds
XP9UmPc7hfMVafyEiwJMAA: raises $12 to $18
6fLdOUCRtX71xbVRhJEq8w: calls $12
*** FLOP *** [Kh 3d 2h]
XP9UmPc7hfMVafyEiwJMAA: bets $28
6fLdOUCRtX71xbVRhJEq8w: calls $28
*** TURN *** [Kh 3d 2h] [Td]
XP9UmPc7hfMVafyEiwJMAA: checks
6fLdOUCRtX71xbVRhJEq8w: checks
*** RIVER *** [Kh 3d 2h Td] [6s]
XP9UmPc7hfMVafyEiwJMAA: bets $50
6fLdOUCRtX71xbVRhJEq8w: calls $50
*** SHOW DOWN ***
XP9UmPc7hfMVafyEiwJMAA: shows [7d Tc] (a pair of Tens)
6fLdOUCRtX71xbVRhJEq8w: shows [7c Kc] (a pair of Kings)
6fLdOUCRtX71xbVRhJEq8w collected $190 from pot
*** SUMMARY ***
Total pot $193 | Rake $3
Board [Kh 3d 2h Td 6s]
Seat 1: 6fLdOUCRtX71xbVRhJEq8w (button) showed [7c Kc] and won ($190) with a pair of Kings
Seat 2: 5Y+ZGWLI4gnlpApDX5vy1A (small blind) folded before Flop
Seat 3: XP9UmPc7hfMVafyEiwJMAA (big blind) showed [7d Tc] and lost with a pair of Tens
Seat 4: UaZ5yj+6LjtWqMQg2QskUw folded before Flop (didn't bet)
Seat 5: sTPOWERd9HWPCNrDBwsVjA folded before Flop (didn't bet)
Seat 6: mfy7uGZcqA2PVQqEVbJ7+g folded before Flop (didn't bet)



PokerStars Game #59942170626:  Hold'em No Limit ($1/$2) - 2009/07/01 1:58:22 ET
Table '4NGNnZ/osQfNq6abYqkJeA' 6-max Seat #2 is the button
Seat 1: 0Bc+WhbOvaaWIMmmui3q0g ($146.10 in chips)
Seat 2: 669iGNwYwgRZg3nhS+aDAQ ($107.75 in chips)
Seat 3: qXDd0ZyMIse0OBu8pxeQ3Q ($200 in chips)
Seat 4: sY+4Uuh5z/6AbXXaCS10jw ($294.10 in chips)
Seat 5: VvdR9F3I+2yELkfTVvC1dg ($210.80 in chips)
Seat 6: /PH6Ffnho4Ysm8S3V/oa+w ($51.20 in chips)
qXDd0ZyMIse0OBu8pxeQ3Q: posts small blind $1
sY+4Uuh5z/6AbXXaCS10jw: posts big blind $2
*** HOLE CARDS ***
VvdR9F3I+2yELkfTVvC1dg: folds
/PH6Ffnho4Ysm8S3V/oa+w: folds
0Bc+WhbOvaaWIMmmui3q0g: folds
669iGNwYwgRZg3nhS+aDAQ: folds
qXDd0ZyMIse0OBu8pxeQ3Q: folds
sY+4Uuh5z/6AbXXaCS10jw collected $2 from pot
*** SUMMARY ***
Total pot $2 | Rake $0
Seat 1: 0Bc+WhbOvaaWIMmmui3q0g folded before Flop (didn't bet)
Seat 2: 669iGNwYwgRZg3nhS+aDAQ (button) folded before Flop (didn't bet)
Seat 3: qXDd0ZyMIse0OBu8pxeQ3Q (small blind) folded before Flop
Seat 4: sY+4Uuh5z/6AbXXaCS10jw (big blind) collected ($2)
Seat 5: VvdR9F3I+2yELkfTVvC1dg folded before Flop (didn't bet)
Seat 6: /PH6Ffnho4Ysm8S3V/oa+w folded before Flop (didn't bet)



PokerStars Game #59942171442:  Hold'em No Limit ($1/$2) - 2009/07/01 1:58:24 ET
Table '+hSnXFQrGw1PlVgTnuj+sA' 6-max Seat #2 is the button
Seat 1: fb8ooqw9ZsZtBsZTZQLNrQ ($54.05 in chips)
Seat 2: 54yWzRRgS0oZ+S6LwZBxMQ ($44.75 in chips)
Seat 3: vkfxu8f/jMYKUk6Ly4eujw ($188 in chips)
Seat 4: TRSUrOQh3x1NGeD+dH4yoA ($156.10 in chips)
Seat 5: PZzUwZiFNhCLi6Ouh5ZlmQ ($200 in chips)
Seat 6: 7zM38baFvmCNB/F80oE0cQ ($16.50 in chips)
vkfxu8f/jMYKUk6Ly4eujw: posts small blind $1
TRSUrOQh3x1NGeD+dH4yoA: posts big blind $2
*** HOLE CARDS ***
PZzUwZiFNhCLi6Ouh5ZlmQ: folds
7zM38baFvmCNB/F80oE0cQ: folds
fb8ooqw9ZsZtBsZTZQLNrQ: calls $2
54yWzRRgS0oZ+S6LwZBxMQ: folds
vkfxu8f/jMYKUk6Ly4eujw: raises $8 to $10
TRSUrOQh3x1NGeD+dH4yoA: folds
fb8ooqw9ZsZtBsZTZQLNrQ: calls $8
*** FLOP *** [4d As 3c]
vkfxu8f/jMYKUk6Ly4eujw: bets $20
fb8ooqw9ZsZtBsZTZQLNrQ: folds
vkfxu8f/jMYKUk6Ly4eujw collected $20.90 from pot
vkfxu8f/jMYKUk6Ly4eujw: doesn't show hand
*** SUMMARY ***
Total pot $22 | Rake $1.10
Board [4d As 3c]
Seat 1: fb8ooqw9ZsZtBsZTZQLNrQ folded on the Flop
Seat 2: 54yWzRRgS0oZ+S6LwZBxMQ (button) folded before Flop (didn't bet)
Seat 3: vkfxu8f/jMYKUk6Ly4eujw (small blind) collected ($20.90)
Seat 4: TRSUrOQh3x1NGeD+dH4yoA (big blind) folded before Flop
Seat 5: PZzUwZiFNhCLi6Ouh5ZlmQ folded before Flop (didn't bet)
Seat 6: 7zM38baFvmCNB/F80oE0cQ folded before Flop (didn't bet)



PokerStars Game #59942171530:  Hold'em No Limit ($1/$2) - 2009/07/01 1:58:24 ET
Table 'jlrIxbrVIG+gjaUYT4za8g' 6-max Seat #2 is the button
Seat 1: opJMdoq0E6TRbAQiweyQuA ($37 in chips)
Seat 2: cwfuMyvDC7J7SqX2leDC8g ($57 in chips)
Seat 4: 8srN1dKQePlsv0GyTada+Q ($311.80 in chips)
Seat 5: AyBB0k3Dcl7xbXUeGMw06g ($123.50 in chips)
8srN1dKQePlsv0GyTada+Q: posts small blind $1
AyBB0k3Dcl7xbXUeGMw06g: posts big blind $2
Bv3000: sits out
*** HOLE CARDS ***
opJMdoq0E6TRbAQiweyQuA: folds
cwfuMyvDC7J7SqX2leDC8g: raises $2 to $4
8srN1dKQePlsv0GyTada+Q: folds
AyBB0k3Dcl7xbXUeGMw06g: calls $2
*** FLOP *** [3h 8d 4s]
AyBB0k3Dcl7xbXUeGMw06g: checks
cwfuMyvDC7J7SqX2leDC8g: checks
*** TURN *** [3h 8d 4s] [9h]
AyBB0k3Dcl7xbXUeGMw06g: checks
cwfuMyvDC7J7SqX2leDC8g: bets $2
AyBB0k3Dcl7xbXUeGMw06g: calls $2
*** RIVER *** [3h 8d 4s 9h] [5h]
AyBB0k3Dcl7xbXUeGMw06g: checks
cwfuMyvDC7J7SqX2leDC8g: checks
*** SHOW DOWN ***
AyBB0k3Dcl7xbXUeGMw06g: shows [Kc 4h] (a pair of Fours)
cwfuMyvDC7J7SqX2leDC8g: shows [Tc 9c] (a pair of Nines)
cwfuMyvDC7J7SqX2leDC8g collected $12.40 from pot
*** SUMMARY ***
Total pot $13 | Rake $0.60
Board [3h 8d 4s 9h 5h]
Seat 1: opJMdoq0E6TRbAQiweyQuA folded before Flop (didn't bet)
Seat 2: cwfuMyvDC7J7SqX2leDC8g (button) showed [Tc 9c] and won ($12.40) with a pair of Nines
Seat 4: 8srN1dKQePlsv0GyTada+Q (small blind) folded before Flop
Seat 5: AyBB0k3Dcl7xbXUeGMw06g (big blind) showed [Kc 4h] and lost with a pair of Fours



PokerStars Game #59942171776:  Hold'em No Limit ($1/$2) - 2009/07/01 1:58:24 ET
Table '1MktSAbrFdhtrrteXKmFDA' 2-max Seat #2 is the button
Seat 1: WfaZs12BkYO+BUX5VWpuWQ ($40 in chips)
Seat 2: aOL8geThaYp2iadSHl1h1g ($123 in chips)
aOL8geThaYp2iadSHl1h1g: posts small blind $1
WfaZs12BkYO+BUX5VWpuWQ: posts big blind $2
*** HOLE CARDS ***
aOL8geThaYp2iadSHl1h1g: folds
WfaZs12BkYO+BUX5VWpuWQ collected $2 from pot
*** SUMMARY ***
Total pot $2 | Rake $0
Seat 1: WfaZs12BkYO+BUX5VWpuWQ (big blind) collected ($2)
Seat 2: aOL8geThaYp2iadSHl1h1g (button) (small blind) folded before Flop



PokerStars Game #59942172486:  Hold'em No Limit ($1/$2) - 2009/07/01 1:58:26 ET
Table '/dyk+YdRGv90j2box35j8w' 6-max Seat #4 is the button
Seat 2: qCnEYuAE5y5A7bk6fO5/jQ ($488.20 in chips)
Seat 3: sTPOWERd9HWPCNrDBwsVjA ($215.50 in chips)
Seat 4: 4dMBh/1VTdeUTPCyhCs3UQ ($88.95 in chips)
Seat 5: VvdR9F3I+2yELkfTVvC1dg ($293.35 in chips)
Seat 6: C3qJBo7uxfFVDluE1lmK2w ($92.25 in chips)
VvdR9F3I+2yELkfTVvC1dg: posts small blind $1
C3qJBo7uxfFVDluE1lmK2w: posts big blind $2
*** HOLE CARDS ***
qCnEYuAE5y5A7bk6fO5/jQ: raises $4 to $6
sTPOWERd9HWPCNrDBwsVjA: calls $6
4dMBh/1VTdeUTPCyhCs3UQ: folds
VvdR9F3I+2yELkfTVvC1dg: folds
C3qJBo7uxfFVDluE1lmK2w: calls $4
*** FLOP *** [5d 4c 7h]
C3qJBo7uxfFVDluE1lmK2w: checks
qCnEYuAE5y5A7bk6fO5/jQ: checks
sTPOWERd9HWPCNrDBwsVjA: bets $10
C3qJBo7uxfFVDluE1lmK2w: folds
qCnEYuAE5y5A7bk6fO5/jQ: folds
sTPOWERd9HWPCNrDBwsVjA collected $18.05 from pot
*** SUMMARY ***
Total pot $19 | Rake $0.95
Board [5d 4c 7h]
Seat 2: qCnEYuAE5y5A7bk6fO5/jQ folded on the Flop
Seat 3: sTPOWERd9HWPCNrDBwsVjA collected ($18.05)
Seat 4: 4dMBh/1VTdeUTPCyhCs3UQ (button) folded before Flop (didn't bet)
Seat 5: VvdR9F3I+2yELkfTVvC1dg (small blind) folded before Flop
Seat 6: C3qJBo7uxfFVDluE1lmK2w (big blind) folded on the Flop



PokerStars Game #59942173204:  Hold'em No Limit ($1/$2) - 2009/07/01 1:58:27 ET
Table '/8c0X14Gjd7J3pVNocAJrQ' 6-max Seat #6 is the button
Seat 1: AuiGltq875lmaKHBsjZVGg ($82.20 in chips)
Seat 2: mfy7uGZcqA2PVQqEVbJ7+g ($275.60 in chips)
Seat 3: sr/OkkgqNbtgwJf1tmnfNg ($115.90 in chips)
Seat 4: PkzV5n5qRUp0Weu8NcNNhA ($79.15 in chips)
Seat 6: VvdR9F3I+2yELkfTVvC1dg ($336.75 in chips)
AuiGltq875lmaKHBsjZVGg: posts small blind $1
mfy7uGZcqA2PVQqEVbJ7+g: posts big blind $2
opJMdoq0E6TRbAQiweyQuA: sits out
*** HOLE CARDS ***
sr/OkkgqNbtgwJf1tmnfNg: folds
PkzV5n5qRUp0Weu8NcNNhA: calls $2
VvdR9F3I+2yELkfTVvC1dg: folds
AuiGltq875lmaKHBsjZVGg: raises $4 to $6
mfy7uGZcqA2PVQqEVbJ7+g: folds
PkzV5n5qRUp0Weu8NcNNhA: calls $4
*** FLOP *** [3c Ac Js]
AuiGltq875lmaKHBsjZVGg: bets $6
PkzV5n5qRUp0Weu8NcNNhA: calls $6
*** TURN *** [3c Ac Js] [8h]
AuiGltq875lmaKHBsjZVGg: checks
PkzV5n5qRUp0Weu8NcNNhA: bets $12
AuiGltq875lmaKHBsjZVGg: folds
PkzV5n5qRUp0Weu8NcNNhA collected $24.75 from pot
PkzV5n5qRUp0Weu8NcNNhA: doesn't show hand
*** SUMMARY ***
Total pot $26 | Rake $1.25
Board [3c Ac Js 8h]
Seat 1: AuiGltq875lmaKHBsjZVGg (small blind) folded on the Turn
Seat 2: mfy7uGZcqA2PVQqEVbJ7+g (big blind) folded before Flop
Seat 3: sr/OkkgqNbtgwJf1tmnfNg folded before Flop (didn't bet)
Seat 4: PkzV5n5qRUp0Weu8NcNNhA collected ($24.75)
Seat 6: VvdR9F3I+2yELkfTVvC1dg (button) folded before Flop (didn't bet)



PokerStars Game #59942173214:  Hold'em No Limit ($1/$2) - 2009/07/01 1:58:27 ET
Table '5/wEe6JmtGD7vufSA2RG7A' 2-max Seat #2 is the button
Seat 1: pVqEzK9wXlRMECnb1Zg4Zw ($243.80 in chips)
Seat 2: aOL8geThaYp2iadSHl1h1g ($408 in chips)
aOL8geThaYp2iadSHl1h1g: posts small blind $1
pVqEzK9wXlRMECnb1Zg4Zw: posts big blind $2
*** HOLE CARDS ***
aOL8geThaYp2iadSHl1h1g: folds
pVqEzK9wXlRMECnb1Zg4Zw collected $2 from pot
pVqEzK9wXlRMECnb1Zg4Zw: doesn't show hand
*** SUMMARY ***
Total pot $2 | Rake $0
Seat 1: pVqEzK9wXlRMECnb1Zg4Zw (big blind) collected ($2)
Seat 2: aOL8geThaYp2iadSHl1h1g (button) (small blind) folded before Flop



PokerStars Game #59942174082:  Hold'em No Limit ($1/$2) - 2009/07/01 1:58:29 ET
Table 'QxerF7GUfCbl+4a8XaTB2w' 6-max Seat #2 is the button
Seat 1: ZwvXzkkZ3XpMhKfAmVpahw ($256.45 in chips)
Seat 2: 6UGgYbxwWNc+ohObe8vB9w ($86.30 in chips)
Seat 3: 8rZGabKe2DEPdZCbCivZ9Q ($53.85 in chips)
Seat 6: VvdR9F3I+2yELkfTVvC1dg ($218.10 in chips)
8rZGabKe2DEPdZCbCivZ9Q: posts small blind $1
/PH6Ffnho4Ysm8S3V/oa+w: is sitting out
vkfxu8f/jMYKUk6Ly4eujw: is sitting out
VvdR9F3I+2yELkfTVvC1dg: posts big blind $2
*** HOLE CARDS ***
vkfxu8f/jMYKUk6Ly4eujw leaves the table
ZwvXzkkZ3XpMhKfAmVpahw: raises $4 to $6
/PH6Ffnho4Ysm8S3V/oa+w leaves the table
6UGgYbxwWNc+ohObe8vB9w: folds
8rZGabKe2DEPdZCbCivZ9Q: folds
VvdR9F3I+2yELkfTVvC1dg: folds
ZwvXzkkZ3XpMhKfAmVpahw collected $5 from pot
ZwvXzkkZ3XpMhKfAmVpahw: doesn't show hand
qXDd0ZyMIse0OBu8pxeQ3Q joins the table at seat #4
*** SUMMARY ***
Total pot $5 | Rake $0
Seat 1: ZwvXzkkZ3XpMhKfAmVpahw collected ($5)
Seat 2: 6UGgYbxwWNc+ohObe8vB9w (button) folded before Flop (didn't bet)
Seat 3: 8rZGabKe2DEPdZCbCivZ9Q (small blind) folded before Flop
Seat 6: VvdR9F3I+2yELkfTVvC1dg (big blind) folded before Flop



PokerStars Game #59942174608:  Hold'em No Limit ($1/$2) - 2009/07/01 1:58:30 ET
Table 'xxAXogzmyuZKfe0LOYHaNQ' 2-max Seat #1 is the button
Seat 1: S14rjcU6LEC1LmuUtBK5Bg ($117 in chips)
Seat 2: ItDFe9gh5QYPQB9vC4ntUA ($208.10 in chips)
S14rjcU6LEC1LmuUtBK5Bg: posts small blind $1
ItDFe9gh5QYPQB9vC4ntUA: posts big blind $2
*** HOLE CARDS ***
S14rjcU6LEC1LmuUtBK5Bg: raises $8 to $10
ItDFe9gh5QYPQB9vC4ntUA: folds
S14rjcU6LEC1LmuUtBK5Bg collected $4 from pot
*** SUMMARY ***
Total pot $4 | Rake $0
Seat 1: S14rjcU6LEC1LmuUtBK5Bg (button) (small blind) collected ($4)
Seat 2: ItDFe9gh5QYPQB9vC4ntUA (big blind) folded before Flop



PokerStars Game #59942175956:  Hold'em No Limit ($1/$2) - 2009/07/01 1:58:32 ET
Table 'P/yCfYl1GfGsu/e6DxDy/A' 2-max Seat #2 is the button
Seat 1: 7fOCUy3x9hdkmXkkDNolGQ ($1159 in chips)
Seat 2: RwDoM55ZeQuI2ADyJhOb2Q ($306.50 in chips)
RwDoM55ZeQuI2ADyJhOb2Q: posts small blind $1
7fOCUy3x9hdkmXkkDNolGQ: posts big blind $2
*** HOLE CARDS ***
RwDoM55ZeQuI2ADyJhOb2Q: raises $4 to $6
7fOCUy3x9hdkmXkkDNolGQ: calls $4
*** FLOP *** [2d 8h Qh]
7fOCUy3x9hdkmXkkDNolGQ: checks
RwDoM55ZeQuI2ADyJhOb2Q: bets $12
7fOCUy3x9hdkmXkkDNolGQ: calls $12
*** TURN *** [2d 8h Qh] [4c]
7fOCUy3x9hdkmXkkDNolGQ: checks
RwDoM55ZeQuI2ADyJhOb2Q: checks
*** RIVER *** [2d 8h Qh 4c] [Ad]
7fOCUy3x9hdkmXkkDNolGQ: checks
RwDoM55ZeQuI2ADyJhOb2Q: bets $22
7fOCUy3x9hdkmXkkDNolGQ: folds
RwDoM55ZeQuI2ADyJhOb2Q collected $35.50 from pot
RwDoM55ZeQuI2ADyJhOb2Q: doesn't show hand
*** SUMMARY ***
Total pot $36 | Rake $0.50
Board [2d 8h Qh 4c Ad]
Seat 1: 7fOCUy3x9hdkmXkkDNolGQ (big blind) folded on the River
Seat 2: RwDoM55ZeQuI2ADyJhOb2Q (button) (small blind) collected ($35.50)



