PokerStars Game #59940705728:  Hold'em No Limit ($1/$2) - 2009/07/01 1:14:13 ET
Table '3WCXyaiCAbqSShQu7FIjvA' 9-max Seat #7 is the button
Seat 1: kTCkABD1UUldS9DFRGfCwQ ($118.60 in chips)
Seat 2: 1zQMh8lHgW3t2YhVeA+09A ($17.25 in chips)
Seat 3: 5Q8U6iZbeO7xJSS4qvDP5g ($200 in chips)
Seat 5: CkE3IyJF1KvdaAOmZY5XqQ ($200 in chips)
Seat 6: 5jQlngvMSqM/WoonOcR5kw ($344.35 in chips)
Seat 7: QHxJjpVYwitg9krW6wZgJA ($200 in chips)
Seat 8: 1CtiZuXDFaJL1dJPQKyi8Q ($199.25 in chips)
Seat 9: FiXPLJyqb24l32QST2TInw ($110.60 in chips)
1CtiZuXDFaJL1dJPQKyi8Q: posts small blind $1
FiXPLJyqb24l32QST2TInw: posts big blind $2
*** HOLE CARDS ***
kTCkABD1UUldS9DFRGfCwQ: folds
1zQMh8lHgW3t2YhVeA+09A: folds
5Q8U6iZbeO7xJSS4qvDP5g: folds
CkE3IyJF1KvdaAOmZY5XqQ: folds
5jQlngvMSqM/WoonOcR5kw: folds
waEF/+pxZTxNo4FvsORuXg has returned
QHxJjpVYwitg9krW6wZgJA: raises $2 to $4
1CtiZuXDFaJL1dJPQKyi8Q: calls $3
FiXPLJyqb24l32QST2TInw: raises $2 to $6
QHxJjpVYwitg9krW6wZgJA: calls $2
1CtiZuXDFaJL1dJPQKyi8Q: calls $2
*** FLOP *** [Jh 6h 4s]
1CtiZuXDFaJL1dJPQKyi8Q: checks
FiXPLJyqb24l32QST2TInw: checks
QHxJjpVYwitg9krW6wZgJA: checks
*** TURN *** [Jh 6h 4s] [9s]
1CtiZuXDFaJL1dJPQKyi8Q: checks
FiXPLJyqb24l32QST2TInw: bets $6
QHxJjpVYwitg9krW6wZgJA: calls $6
1CtiZuXDFaJL1dJPQKyi8Q: raises $20 to $26
FiXPLJyqb24l32QST2TInw: folds
QHxJjpVYwitg9krW6wZgJA: calls $20
*** RIVER *** [Jh 6h 4s 9s] [3c]
1CtiZuXDFaJL1dJPQKyi8Q: bets $167.25 and is all-in
QHxJjpVYwitg9krW6wZgJA: folds
1CtiZuXDFaJL1dJPQKyi8Q collected $73 from pot
1CtiZuXDFaJL1dJPQKyi8Q: doesn't show hand
*** SUMMARY ***
Total pot $76 | Rake $3
Board [Jh 6h 4s 9s 3c]
Seat 1: kTCkABD1UUldS9DFRGfCwQ folded before Flop (didn't bet)
Seat 2: 1zQMh8lHgW3t2YhVeA+09A folded before Flop (didn't bet)
Seat 3: 5Q8U6iZbeO7xJSS4qvDP5g folded before Flop (didn't bet)
Seat 5: CkE3IyJF1KvdaAOmZY5XqQ folded before Flop (didn't bet)
Seat 6: 5jQlngvMSqM/WoonOcR5kw folded before Flop (didn't bet)
Seat 7: QHxJjpVYwitg9krW6wZgJA (button) folded on the River
Seat 8: 1CtiZuXDFaJL1dJPQKyi8Q (small blind) collected ($73)
Seat 9: FiXPLJyqb24l32QST2TInw (big blind) folded on the Turn



PokerStars Game #59940706966:  Hold'em No Limit ($1/$2) - 2009/07/01 1:14:15 ET
Table 'P/yCfYl1GfGsu/e6DxDy/A' 2-max Seat #2 is the button
Seat 1: 7fOCUy3x9hdkmXkkDNolGQ ($496.50 in chips)
Seat 2: RwDoM55ZeQuI2ADyJhOb2Q ($995.50 in chips)
RwDoM55ZeQuI2ADyJhOb2Q: posts small blind $1
7fOCUy3x9hdkmXkkDNolGQ: posts big blind $2
*** HOLE CARDS ***
RwDoM55ZeQuI2ADyJhOb2Q: raises $4 to $6
7fOCUy3x9hdkmXkkDNolGQ: folds
RwDoM55ZeQuI2ADyJhOb2Q collected $4 from pot
RwDoM55ZeQuI2ADyJhOb2Q: doesn't show hand
*** SUMMARY ***
Total pot $4 | Rake $0
Seat 1: 7fOCUy3x9hdkmXkkDNolGQ (big blind) folded before Flop
Seat 2: RwDoM55ZeQuI2ADyJhOb2Q (button) (small blind) collected ($4)



PokerStars Game #59940707568:  Hold'em No Limit ($1/$2) - 2009/07/01 1:14:16 ET
Table 'NmY84NAf9Mh0ckAckHnh5g' 2-max Seat #2 is the button
Seat 1: 6hvg964TSqZ3AL/0XK9aVQ ($283.80 in chips)
Seat 2: RwDoM55ZeQuI2ADyJhOb2Q ($530.50 in chips)
RwDoM55ZeQuI2ADyJhOb2Q: posts small blind $1
6hvg964TSqZ3AL/0XK9aVQ: posts big blind $2
*** HOLE CARDS ***
RwDoM55ZeQuI2ADyJhOb2Q: raises $4 to $6
6hvg964TSqZ3AL/0XK9aVQ: calls $4
*** FLOP *** [Qh 9h 6h]
6hvg964TSqZ3AL/0XK9aVQ: checks
RwDoM55ZeQuI2ADyJhOb2Q: checks
*** TURN *** [Qh 9h 6h] [Jc]
6hvg964TSqZ3AL/0XK9aVQ: bets $8
RwDoM55ZeQuI2ADyJhOb2Q: folds
6hvg964TSqZ3AL/0XK9aVQ collected $11.50 from pot
6hvg964TSqZ3AL/0XK9aVQ: doesn't show hand
*** SUMMARY ***
Total pot $12 | Rake $0.50
Board [Qh 9h 6h Jc]
Seat 1: 6hvg964TSqZ3AL/0XK9aVQ (big blind) collected ($11.50)
Seat 2: RwDoM55ZeQuI2ADyJhOb2Q (button) (small blind) folded on the Turn



PokerStars Game #59940707572:  Hold'em No Limit ($1/$2) - 2009/07/01 1:14:16 ET
Table 'aSf77Sj8QEnzcc0WaxVD4Q' 6-max Seat #6 is the button
Seat 1: UELtvp+JfwI7XDGVwSxZXA ($180.75 in chips)
Seat 3: 9dpyyjDTCed6nV7JhaUUpw ($200 in chips)
Seat 4: YsLQ3BAvgQHWXMAv3Wv6Hg ($264.40 in chips)
Seat 5: VvdR9F3I+2yELkfTVvC1dg ($200 in chips)
Seat 6: vkoJRf3gidxY1pPi0AFWww ($161.55 in chips)
UELtvp+JfwI7XDGVwSxZXA: posts small blind $1
9dpyyjDTCed6nV7JhaUUpw: posts big blind $2
*** HOLE CARDS ***
YsLQ3BAvgQHWXMAv3Wv6Hg: folds
vkfxu8f/jMYKUk6Ly4eujw joins the table at seat #2
VvdR9F3I+2yELkfTVvC1dg: folds
vkoJRf3gidxY1pPi0AFWww: folds
UELtvp+JfwI7XDGVwSxZXA: calls $1
9dpyyjDTCed6nV7JhaUUpw: raises $6 to $8
UELtvp+JfwI7XDGVwSxZXA: folds
9dpyyjDTCed6nV7JhaUUpw collected $4 from pot
9dpyyjDTCed6nV7JhaUUpw: doesn't show hand
*** SUMMARY ***
Total pot $4 | Rake $0
Seat 1: UELtvp+JfwI7XDGVwSxZXA (small blind) folded before Flop
Seat 3: 9dpyyjDTCed6nV7JhaUUpw (big blind) collected ($4)
Seat 4: YsLQ3BAvgQHWXMAv3Wv6Hg folded before Flop (didn't bet)
Seat 5: VvdR9F3I+2yELkfTVvC1dg folded before Flop (didn't bet)
Seat 6: vkoJRf3gidxY1pPi0AFWww (button) folded before Flop (didn't bet)



PokerStars Game #59940707678:  Hold'em No Limit ($1/$2) - 2009/07/01 1:14:16 ET
Table 'jlrIxbrVIG+gjaUYT4za8g' 6-max Seat #4 is the button
Seat 1: ygTTt5ehT4aF86q1a8/R+w ($221.90 in chips)
Seat 2: N18PrNGQj43J7TJuQuu+tw ($93.40 in chips)
Seat 3: 342gZYfwWuuNOnZaoysV6A ($41.60 in chips)
Seat 4: 8srN1dKQePlsv0GyTada+Q ($262.50 in chips)
Seat 5: AyBB0k3Dcl7xbXUeGMw06g ($71.20 in chips)
Seat 6: vkfxu8f/jMYKUk6Ly4eujw ($243.75 in chips)
AyBB0k3Dcl7xbXUeGMw06g: posts small blind $1
vkfxu8f/jMYKUk6Ly4eujw: posts big blind $2
*** HOLE CARDS ***
ygTTt5ehT4aF86q1a8/R+w: folds
N18PrNGQj43J7TJuQuu+tw: folds
342gZYfwWuuNOnZaoysV6A: raises $2 to $4
8srN1dKQePlsv0GyTada+Q: calls $4
AyBB0k3Dcl7xbXUeGMw06g: calls $3
vkfxu8f/jMYKUk6Ly4eujw: folds
*** FLOP *** [9s Tc 7d]
AyBB0k3Dcl7xbXUeGMw06g: checks
342gZYfwWuuNOnZaoysV6A: bets $5.85
8srN1dKQePlsv0GyTada+Q: raises $10.15 to $16
AyBB0k3Dcl7xbXUeGMw06g: folds
342gZYfwWuuNOnZaoysV6A: raises $21.60 to $37.60 and is all-in
8srN1dKQePlsv0GyTada+Q: calls $21.60
*** TURN *** [9s Tc 7d] [4s]
*** RIVER *** [9s Tc 7d 4s] [9h]
*** SHOW DOWN ***
342gZYfwWuuNOnZaoysV6A: shows [Ah Td] (two pair, Tens and Nines)
8srN1dKQePlsv0GyTada+Q: shows [9d 8d] (three of a kind, Nines)
8srN1dKQePlsv0GyTada+Q collected $86.20 from pot
*** SUMMARY ***
Total pot $89.20 | Rake $3
Board [9s Tc 7d 4s 9h]
Seat 1: ygTTt5ehT4aF86q1a8/R+w folded before Flop (didn't bet)
Seat 2: N18PrNGQj43J7TJuQuu+tw folded before Flop (didn't bet)
Seat 3: 342gZYfwWuuNOnZaoysV6A showed [Ah Td] and lost with two pair, Tens and Nines
Seat 4: 8srN1dKQePlsv0GyTada+Q (button) showed [9d 8d] and won ($86.20) with three of a kind, Nines
Seat 5: AyBB0k3Dcl7xbXUeGMw06g (small blind) folded on the Flop
Seat 6: vkfxu8f/jMYKUk6Ly4eujw (big blind) folded before Flop



PokerStars Game #59940708112:  Hold'em No Limit ($1/$2) - 2009/07/01 1:14:17 ET
Table 'qVXak+oTeDXMGbWa4sDU5Q' 9-max Seat #7 is the button
Seat 1: H6Z4+qu8gR0VUiPOijndVg ($252.55 in chips)
Seat 3: WUlHm+ydPPHG7Lb0rePSdA ($143 in chips)
Seat 4: lQYT23h5QCUVZAKxjOO39Q ($112.25 in chips)
Seat 5: FWGiDqRwvLeKmHq9t4Jy9w ($288 in chips)
Seat 6: GX1heJ+DSsvm7gzSPsYhhQ ($37 in chips)
Seat 7: PfmlvZlFiss79a6IoEr11g ($121.55 in chips)
Seat 8: TAfo4veNRaRlzDXMMYS3Jg ($42 in chips)
Seat 9: CkE3IyJF1KvdaAOmZY5XqQ ($203 in chips)
TAfo4veNRaRlzDXMMYS3Jg: posts small blind $1
CkE3IyJF1KvdaAOmZY5XqQ: posts big blind $2
rW/MyplHylMSBRaoRUzWrg: sits out
*** HOLE CARDS ***
H6Z4+qu8gR0VUiPOijndVg: folds
WUlHm+ydPPHG7Lb0rePSdA: raises $4 to $6
lQYT23h5QCUVZAKxjOO39Q: calls $6
FWGiDqRwvLeKmHq9t4Jy9w: calls $6
GX1heJ+DSsvm7gzSPsYhhQ: folds
PfmlvZlFiss79a6IoEr11g: folds
TAfo4veNRaRlzDXMMYS3Jg: folds
CkE3IyJF1KvdaAOmZY5XqQ: folds
*** FLOP *** [3h Kh 8d]
WUlHm+ydPPHG7Lb0rePSdA: checks
lQYT23h5QCUVZAKxjOO39Q: checks
FWGiDqRwvLeKmHq9t4Jy9w: bets $14
WUlHm+ydPPHG7Lb0rePSdA: raises $20 to $34
lQYT23h5QCUVZAKxjOO39Q: folds
FWGiDqRwvLeKmHq9t4Jy9w: folds
WUlHm+ydPPHG7Lb0rePSdA collected $46.65 from pot
WUlHm+ydPPHG7Lb0rePSdA: doesn't show hand
*** SUMMARY ***
Total pot $49 | Rake $2.35
Board [3h Kh 8d]
Seat 1: H6Z4+qu8gR0VUiPOijndVg folded before Flop (didn't bet)
Seat 3: WUlHm+ydPPHG7Lb0rePSdA collected ($46.65)
Seat 4: lQYT23h5QCUVZAKxjOO39Q folded on the Flop
Seat 5: FWGiDqRwvLeKmHq9t4Jy9w folded on the Flop
Seat 6: GX1heJ+DSsvm7gzSPsYhhQ folded before Flop (didn't bet)
Seat 7: PfmlvZlFiss79a6IoEr11g (button) folded before Flop (didn't bet)
Seat 8: TAfo4veNRaRlzDXMMYS3Jg (small blind) folded before Flop
Seat 9: CkE3IyJF1KvdaAOmZY5XqQ (big blind) folded before Flop



PokerStars Game #59940708318:  Hold'em No Limit ($1/$2) - 2009/07/01 1:14:18 ET
Table 'rKeCh+eBn4RNvybCUYkoTQ' 9-max Seat #4 is the button
Seat 1: /inIs/z/PcX+TniIFpaxpg ($206 in chips)
Seat 2: 9cBHwK40Tl06vheE7B3LHQ ($78.05 in chips)
Seat 3: R9FzbEg1XYsiOty4kvbqhg ($69.20 in chips)
Seat 4: 31HuO+DQxppUQEedBWukug ($104.10 in chips)
Seat 5: WUlHm+ydPPHG7Lb0rePSdA ($121 in chips)
Seat 6: EBV6OktyeSmh4w6sWmcWOw ($273 in chips)
Seat 8: pN/Ip0ePsUVIdUlGgLrkUw ($209 in chips)
Seat 9: Kzta8yu9vxHT4B70mjBZ+w ($203 in chips)
WUlHm+ydPPHG7Lb0rePSdA: posts small blind $1
EBV6OktyeSmh4w6sWmcWOw: posts big blind $2
rW/MyplHylMSBRaoRUzWrg: sits out
*** HOLE CARDS ***
pN/Ip0ePsUVIdUlGgLrkUw: folds
Kzta8yu9vxHT4B70mjBZ+w: raises $4 to $6
/inIs/z/PcX+TniIFpaxpg: folds
9cBHwK40Tl06vheE7B3LHQ: folds
R9FzbEg1XYsiOty4kvbqhg: folds
31HuO+DQxppUQEedBWukug: calls $6
WUlHm+ydPPHG7Lb0rePSdA: folds
EBV6OktyeSmh4w6sWmcWOw: folds
*** FLOP *** [Ts Kc 9c]
Kzta8yu9vxHT4B70mjBZ+w: bets $10
31HuO+DQxppUQEedBWukug: folds
Kzta8yu9vxHT4B70mjBZ+w collected $14.25 from pot
Kzta8yu9vxHT4B70mjBZ+w: doesn't show hand
*** SUMMARY ***
Total pot $15 | Rake $0.75
Board [Ts Kc 9c]
Seat 1: /inIs/z/PcX+TniIFpaxpg folded before Flop (didn't bet)
Seat 2: 9cBHwK40Tl06vheE7B3LHQ folded before Flop (didn't bet)
Seat 3: R9FzbEg1XYsiOty4kvbqhg folded before Flop (didn't bet)
Seat 4: 31HuO+DQxppUQEedBWukug (button) folded on the Flop
Seat 5: WUlHm+ydPPHG7Lb0rePSdA (small blind) folded before Flop
Seat 6: EBV6OktyeSmh4w6sWmcWOw (big blind) folded before Flop
Seat 8: pN/Ip0ePsUVIdUlGgLrkUw folded before Flop (didn't bet)
Seat 9: Kzta8yu9vxHT4B70mjBZ+w collected ($14.25)



PokerStars Game #59940711096:  Hold'em No Limit ($1/$2) - 2009/07/01 1:14:22 ET
Table 'P/yCfYl1GfGsu/e6DxDy/A' 2-max Seat #1 is the button
Seat 1: 7fOCUy3x9hdkmXkkDNolGQ ($494.50 in chips)
Seat 2: RwDoM55ZeQuI2ADyJhOb2Q ($997.50 in chips)
7fOCUy3x9hdkmXkkDNolGQ: posts small blind $1
RwDoM55ZeQuI2ADyJhOb2Q: posts big blind $2
*** HOLE CARDS ***
7fOCUy3x9hdkmXkkDNolGQ: raises $4 to $6
RwDoM55ZeQuI2ADyJhOb2Q: folds
7fOCUy3x9hdkmXkkDNolGQ collected $4 from pot
7fOCUy3x9hdkmXkkDNolGQ: doesn't show hand
*** SUMMARY ***
Total pot $4 | Rake $0
Seat 1: 7fOCUy3x9hdkmXkkDNolGQ (button) (small blind) collected ($4)
Seat 2: RwDoM55ZeQuI2ADyJhOb2Q (big blind) folded before Flop



PokerStars Game #59940711632:  Hold'em No Limit ($1/$2) - 2009/07/01 1:14:23 ET
Table 'ztv6V3FN2bQ9nmJPPdx6nQ' 6-max Seat #6 is the button
Seat 1: 6fLdOUCRtX71xbVRhJEq8w ($219 in chips)
Seat 2: 5Y+ZGWLI4gnlpApDX5vy1A ($459.85 in chips)
Seat 4: UaZ5yj+6LjtWqMQg2QskUw ($116.80 in chips)
Seat 5: sTPOWERd9HWPCNrDBwsVjA ($150.85 in chips)
Seat 6: mfy7uGZcqA2PVQqEVbJ7+g ($112.45 in chips)
6fLdOUCRtX71xbVRhJEq8w: posts small blind $1
5Y+ZGWLI4gnlpApDX5vy1A: posts big blind $2
342gZYfwWuuNOnZaoysV6A: sits out
*** HOLE CARDS ***
UaZ5yj+6LjtWqMQg2QskUw: folds
sTPOWERd9HWPCNrDBwsVjA: folds
mfy7uGZcqA2PVQqEVbJ7+g: folds
6fLdOUCRtX71xbVRhJEq8w has timed out
6fLdOUCRtX71xbVRhJEq8w: folds
6fLdOUCRtX71xbVRhJEq8w is sitting out
5Y+ZGWLI4gnlpApDX5vy1A collected $2 from pot
5Y+ZGWLI4gnlpApDX5vy1A: doesn't show hand
*** SUMMARY ***
Total pot $2 | Rake $0
Seat 1: 6fLdOUCRtX71xbVRhJEq8w (small blind) folded before Flop
Seat 2: 5Y+ZGWLI4gnlpApDX5vy1A (big blind) collected ($2)
Seat 4: UaZ5yj+6LjtWqMQg2QskUw folded before Flop (didn't bet)
Seat 5: sTPOWERd9HWPCNrDBwsVjA folded before Flop (didn't bet)
Seat 6: mfy7uGZcqA2PVQqEVbJ7+g (button) folded before Flop (didn't bet)



PokerStars Game #59940711870:  Hold'em No Limit ($1/$2) - 2009/07/01 1:14:24 ET
Table 'srul5UFZXTEccVV5fpY91g' 9-max Seat #9 is the button
Seat 1: Kzta8yu9vxHT4B70mjBZ+w ($198 in chips)
Seat 2: CUZwDpLTQKhzarPe+JCLOQ ($200 in chips)
Seat 3: weUZ8S7tgbaeIpzi1gBNxQ ($54.55 in chips)
Seat 4: GG5lTuGt3+kwNYSbqeB6yw ($133.30 in chips)
Seat 5: ri8CLkX3e9JF34dQNbsHGA ($51.65 in chips)
Seat 6: /inIs/z/PcX+TniIFpaxpg ($46.65 in chips)
Seat 8: UZEsV9yKUMqmpYPiOFpaZw ($113.45 in chips)
Seat 9: GgrYze3jkUdSO7a7CuJGDw ($193 in chips)
Kzta8yu9vxHT4B70mjBZ+w: posts small blind $1
CUZwDpLTQKhzarPe+JCLOQ: posts big blind $2
rW/MyplHylMSBRaoRUzWrg: sits out
*** HOLE CARDS ***
weUZ8S7tgbaeIpzi1gBNxQ: folds
GG5lTuGt3+kwNYSbqeB6yw: calls $2
ri8CLkX3e9JF34dQNbsHGA: folds
/inIs/z/PcX+TniIFpaxpg: folds
UZEsV9yKUMqmpYPiOFpaZw: folds
GgrYze3jkUdSO7a7CuJGDw: folds
Kzta8yu9vxHT4B70mjBZ+w: folds
CUZwDpLTQKhzarPe+JCLOQ: checks
*** FLOP *** [Qh Kc 6h]
CUZwDpLTQKhzarPe+JCLOQ: bets $3
GG5lTuGt3+kwNYSbqeB6yw: folds
CUZwDpLTQKhzarPe+JCLOQ collected $4.75 from pot
CUZwDpLTQKhzarPe+JCLOQ: doesn't show hand
*** SUMMARY ***
Total pot $5 | Rake $0.25
Board [Qh Kc 6h]
Seat 1: Kzta8yu9vxHT4B70mjBZ+w (small blind) folded before Flop
Seat 2: CUZwDpLTQKhzarPe+JCLOQ (big blind) collected ($4.75)
Seat 3: weUZ8S7tgbaeIpzi1gBNxQ folded before Flop (didn't bet)
Seat 4: GG5lTuGt3+kwNYSbqeB6yw folded on the Flop
Seat 5: ri8CLkX3e9JF34dQNbsHGA folded before Flop (didn't bet)
Seat 6: /inIs/z/PcX+TniIFpaxpg folded before Flop (didn't bet)
Seat 8: UZEsV9yKUMqmpYPiOFpaZw folded before Flop (didn't bet)
Seat 9: GgrYze3jkUdSO7a7CuJGDw (button) folded before Flop (didn't bet)



PokerStars Game #59940713714:  Hold'em No Limit ($1/$2) - 2009/07/01 1:14:27 ET
Table 'QxerF7GUfCbl+4a8XaTB2w' 6-max Seat #4 is the button
Seat 1: o9jamqIi6sTTRSqudgboRA ($295.50 in chips)
Seat 2: vkfxu8f/jMYKUk6Ly4eujw ($201.80 in chips)
Seat 3: m7mYVfnCOK5TE/VkN/FhOg ($240.70 in chips)
Seat 4: 09BNF4quPDzanQzM8vc6WA ($39 in chips)
Seat 5: YsLQ3BAvgQHWXMAv3Wv6Hg ($202.75 in chips)
Seat 6: VvdR9F3I+2yELkfTVvC1dg ($200 in chips)
YsLQ3BAvgQHWXMAv3Wv6Hg: posts small blind $1
VvdR9F3I+2yELkfTVvC1dg: posts big blind $2
*** HOLE CARDS ***
o9jamqIi6sTTRSqudgboRA: raises $5 to $7
vkfxu8f/jMYKUk6Ly4eujw: folds
m7mYVfnCOK5TE/VkN/FhOg: folds
09BNF4quPDzanQzM8vc6WA: folds
YsLQ3BAvgQHWXMAv3Wv6Hg: folds
VvdR9F3I+2yELkfTVvC1dg: folds
o9jamqIi6sTTRSqudgboRA collected $5 from pot
o9jamqIi6sTTRSqudgboRA: doesn't show hand
*** SUMMARY ***
Total pot $5 | Rake $0
Seat 1: o9jamqIi6sTTRSqudgboRA collected ($5)
Seat 2: vkfxu8f/jMYKUk6Ly4eujw folded before Flop (didn't bet)
Seat 3: m7mYVfnCOK5TE/VkN/FhOg folded before Flop (didn't bet)
Seat 4: 09BNF4quPDzanQzM8vc6WA (button) folded before Flop (didn't bet)
Seat 5: YsLQ3BAvgQHWXMAv3Wv6Hg (small blind) folded before Flop
Seat 6: VvdR9F3I+2yELkfTVvC1dg (big blind) folded before Flop



PokerStars Game #59940713650:  Hold'em No Limit ($1/$2) - 2009/07/01 1:14:27 ET
Table '+hSnXFQrGw1PlVgTnuj+sA' 6-max Seat #2 is the button
Seat 1: 2ccIJhDj+3JapvS7swVZEg ($266.50 in chips)
Seat 2: o9jamqIi6sTTRSqudgboRA ($277.55 in chips)
Seat 3: fE+LHW/7rpfXW14g8LhGjA ($75.65 in chips)
Seat 4: J4iH5epwXbmODnojR/VRxA ($200 in chips)
Seat 5: VvdR9F3I+2yELkfTVvC1dg ($200 in chips)
Seat 6: AuiGltq875lmaKHBsjZVGg ($75 in chips)
fE+LHW/7rpfXW14g8LhGjA: posts small blind $1
J4iH5epwXbmODnojR/VRxA: posts big blind $2
*** HOLE CARDS ***
VvdR9F3I+2yELkfTVvC1dg: raises $2 to $4
AuiGltq875lmaKHBsjZVGg: raises $2 to $6
2ccIJhDj+3JapvS7swVZEg: raises $260.50 to $266.50 and is all-in
o9jamqIi6sTTRSqudgboRA: folds
fE+LHW/7rpfXW14g8LhGjA: folds
J4iH5epwXbmODnojR/VRxA: folds
VvdR9F3I+2yELkfTVvC1dg: folds
AuiGltq875lmaKHBsjZVGg: folds
2ccIJhDj+3JapvS7swVZEg collected $19 from pot
*** SUMMARY ***
Total pot $19 | Rake $0
Seat 1: 2ccIJhDj+3JapvS7swVZEg collected ($19)
Seat 2: o9jamqIi6sTTRSqudgboRA (button) folded before Flop (didn't bet)
Seat 3: fE+LHW/7rpfXW14g8LhGjA (small blind) folded before Flop
Seat 4: J4iH5epwXbmODnojR/VRxA (big blind) folded before Flop
Seat 5: VvdR9F3I+2yELkfTVvC1dg folded before Flop
Seat 6: AuiGltq875lmaKHBsjZVGg folded before Flop



PokerStars Game #59940716154:  Hold'em No Limit ($1/$2) - 2009/07/01 1:14:31 ET
Table 'P/yCfYl1GfGsu/e6DxDy/A' 2-max Seat #2 is the button
Seat 1: 7fOCUy3x9hdkmXkkDNolGQ ($496.50 in chips)
Seat 2: RwDoM55ZeQuI2ADyJhOb2Q ($995.50 in chips)
RwDoM55ZeQuI2ADyJhOb2Q: posts small blind $1
7fOCUy3x9hdkmXkkDNolGQ: posts big blind $2
*** HOLE CARDS ***
RwDoM55ZeQuI2ADyJhOb2Q: raises $4 to $6
7fOCUy3x9hdkmXkkDNolGQ: raises $14 to $20
RwDoM55ZeQuI2ADyJhOb2Q: calls $14
*** FLOP *** [7h Qc 9s]
7fOCUy3x9hdkmXkkDNolGQ: bets $22
RwDoM55ZeQuI2ADyJhOb2Q: calls $22
*** TURN *** [7h Qc 9s] [5s]
7fOCUy3x9hdkmXkkDNolGQ: checks
RwDoM55ZeQuI2ADyJhOb2Q: bets $32
7fOCUy3x9hdkmXkkDNolGQ: calls $32
*** RIVER *** [7h Qc 9s 5s] [Qh]
7fOCUy3x9hdkmXkkDNolGQ: checks
RwDoM55ZeQuI2ADyJhOb2Q: checks
*** SHOW DOWN ***
7fOCUy3x9hdkmXkkDNolGQ: shows [9h Ts] (two pair, Queens and Nines)
RwDoM55ZeQuI2ADyJhOb2Q: mucks hand
7fOCUy3x9hdkmXkkDNolGQ collected $147.50 from pot
*** SUMMARY ***
Total pot $148 | Rake $0.50
Board [7h Qc 9s 5s Qh]
Seat 1: 7fOCUy3x9hdkmXkkDNolGQ (big blind) showed [9h Ts] and won ($147.50) with two pair, Queens and Nines
Seat 2: RwDoM55ZeQuI2ADyJhOb2Q (button) (small blind) mucked



PokerStars Game #59940716890:  Hold'em No Limit ($1/$2) - 2009/07/01 1:14:32 ET
Table 'YqGfR5eHfMeSjb9a+QU9rg' 9-max Seat #1 is the button
Seat 1: rW/MyplHylMSBRaoRUzWrg ($37 in chips)
Seat 2: W3Nqt1GWlTi9tXQXMNEvgw ($390.70 in chips)
Seat 3: /gll27k+xWYV7Fbki0lFDQ ($266.75 in chips)
Seat 4: QHxJjpVYwitg9krW6wZgJA ($208.15 in chips)
Seat 5: CkE3IyJF1KvdaAOmZY5XqQ ($200 in chips)
Seat 6: Fk6evwGYxWHokjvmdiD+6A ($73.35 in chips)
Seat 7: 41aZuLBz9nAi2GPVKabmCw ($120.05 in chips)
Seat 8: JnV3SM2D6dAFYyGZHHpvrg ($77.70 in chips)
Seat 9: /inIs/z/PcX+TniIFpaxpg ($206.05 in chips)
W3Nqt1GWlTi9tXQXMNEvgw: posts small blind $1
/gll27k+xWYV7Fbki0lFDQ: posts big blind $2
*** HOLE CARDS ***
QHxJjpVYwitg9krW6wZgJA: folds
CkE3IyJF1KvdaAOmZY5XqQ has timed out
CkE3IyJF1KvdaAOmZY5XqQ: folds
CkE3IyJF1KvdaAOmZY5XqQ is sitting out
Fk6evwGYxWHokjvmdiD+6A: folds
41aZuLBz9nAi2GPVKabmCw: calls $2
JnV3SM2D6dAFYyGZHHpvrg: folds
CkE3IyJF1KvdaAOmZY5XqQ has returned
/inIs/z/PcX+TniIFpaxpg: folds
rW/MyplHylMSBRaoRUzWrg: folds
W3Nqt1GWlTi9tXQXMNEvgw: calls $1
/gll27k+xWYV7Fbki0lFDQ: checks
*** FLOP *** [2c 6c 2d]
W3Nqt1GWlTi9tXQXMNEvgw: checks
/gll27k+xWYV7Fbki0lFDQ: checks
41aZuLBz9nAi2GPVKabmCw: bets $4
W3Nqt1GWlTi9tXQXMNEvgw: folds
/gll27k+xWYV7Fbki0lFDQ: folds
41aZuLBz9nAi2GPVKabmCw collected $5.70 from pot
*** SUMMARY ***
Total pot $6 | Rake $0.30
Board [2c 6c 2d]
Seat 1: rW/MyplHylMSBRaoRUzWrg (button) folded before Flop (didn't bet)
Seat 2: W3Nqt1GWlTi9tXQXMNEvgw (small blind) folded on the Flop
Seat 3: /gll27k+xWYV7Fbki0lFDQ (big blind) folded on the Flop
Seat 4: QHxJjpVYwitg9krW6wZgJA folded before Flop (didn't bet)
Seat 5: CkE3IyJF1KvdaAOmZY5XqQ folded before Flop (didn't bet)
Seat 6: Fk6evwGYxWHokjvmdiD+6A folded before Flop (didn't bet)
Seat 7: 41aZuLBz9nAi2GPVKabmCw collected ($5.70)
Seat 8: JnV3SM2D6dAFYyGZHHpvrg folded before Flop (didn't bet)
Seat 9: /inIs/z/PcX+TniIFpaxpg folded before Flop (didn't bet)



PokerStars Game #59940718062:  Hold'em No Limit ($1/$2) - 2009/07/01 1:14:34 ET
Table '/dyk+YdRGv90j2box35j8w' 6-max Seat #5 is the button
Seat 1: 8srN1dKQePlsv0GyTada+Q ($200 in chips)
Seat 2: qCnEYuAE5y5A7bk6fO5/jQ ($484.95 in chips)
Seat 3: sTPOWERd9HWPCNrDBwsVjA ($231.50 in chips)
Seat 4: z/u1YTnkiIDrtp/2cA2dBg ($119.20 in chips)
Seat 5: VvdR9F3I+2yELkfTVvC1dg ($200 in chips)
Seat 6: ZwvXzkkZ3XpMhKfAmVpahw ($356.75 in chips)
ZwvXzkkZ3XpMhKfAmVpahw: posts small blind $1
8srN1dKQePlsv0GyTada+Q: posts big blind $2
*** HOLE CARDS ***
qCnEYuAE5y5A7bk6fO5/jQ: folds
sTPOWERd9HWPCNrDBwsVjA: folds
z/u1YTnkiIDrtp/2cA2dBg: raises $2 to $4
VvdR9F3I+2yELkfTVvC1dg: calls $4
ZwvXzkkZ3XpMhKfAmVpahw: folds
8srN1dKQePlsv0GyTada+Q: folds
*** FLOP *** [3s Jh Qs]
z/u1YTnkiIDrtp/2cA2dBg: bets $8
VvdR9F3I+2yELkfTVvC1dg: folds
z/u1YTnkiIDrtp/2cA2dBg collected $10.45 from pot
*** SUMMARY ***
Total pot $11 | Rake $0.55
Board [3s Jh Qs]
Seat 1: 8srN1dKQePlsv0GyTada+Q (big blind) folded before Flop
Seat 2: qCnEYuAE5y5A7bk6fO5/jQ folded before Flop (didn't bet)
Seat 3: sTPOWERd9HWPCNrDBwsVjA folded before Flop (didn't bet)
Seat 4: z/u1YTnkiIDrtp/2cA2dBg collected ($10.45)
Seat 5: VvdR9F3I+2yELkfTVvC1dg (button) folded on the Flop
Seat 6: ZwvXzkkZ3XpMhKfAmVpahw (small blind) folded before Flop



PokerStars Game #59940718540:  Hold'em No Limit ($1/$2) - 2009/07/01 1:14:35 ET
Table 'NmY84NAf9Mh0ckAckHnh5g' 2-max Seat #1 is the button
Seat 1: 6hvg964TSqZ3AL/0XK9aVQ ($289.30 in chips)
Seat 2: RwDoM55ZeQuI2ADyJhOb2Q ($524.50 in chips)
6hvg964TSqZ3AL/0XK9aVQ: posts small blind $1
RwDoM55ZeQuI2ADyJhOb2Q: posts big blind $2
*** HOLE CARDS ***
6hvg964TSqZ3AL/0XK9aVQ: folds
RwDoM55ZeQuI2ADyJhOb2Q collected $2 from pot
RwDoM55ZeQuI2ADyJhOb2Q: doesn't show hand
*** SUMMARY ***
Total pot $2 | Rake $0
Seat 1: 6hvg964TSqZ3AL/0XK9aVQ (button) (small blind) folded before Flop
Seat 2: RwDoM55ZeQuI2ADyJhOb2Q (big blind) collected ($2)



PokerStars Game #59940719322:  Hold'em No Limit ($1/$2) - 2009/07/01 1:14:37 ET
Table 'eyAQSIlgc2o1Jxvbve4WGg' 9-max Seat #7 is the button
Seat 1: UZEsV9yKUMqmpYPiOFpaZw ($76.45 in chips)
Seat 2: g7gL2NLJCdZPPV399WKT1w ($59.65 in chips)
Seat 3: ice1Sbe19zWIaKYoSmE5tw ($96.30 in chips)
Seat 4: CkE3IyJF1KvdaAOmZY5XqQ ($200 in chips)
Seat 5: mIKx5lhIt13X5eZQH0ZeMA ($58.25 in chips)
Seat 6: rW/MyplHylMSBRaoRUzWrg ($50.80 in chips)
Seat 7: QHxJjpVYwitg9krW6wZgJA ($278.45 in chips)
Seat 8: 1CtiZuXDFaJL1dJPQKyi8Q ($198.35 in chips)
Seat 9: WUlHm+ydPPHG7Lb0rePSdA ($137 in chips)
1CtiZuXDFaJL1dJPQKyi8Q: posts small blind $1
WUlHm+ydPPHG7Lb0rePSdA: posts big blind $2
*** HOLE CARDS ***
UZEsV9yKUMqmpYPiOFpaZw: raises $2 to $4
g7gL2NLJCdZPPV399WKT1w: folds
ice1Sbe19zWIaKYoSmE5tw: folds
CkE3IyJF1KvdaAOmZY5XqQ: folds
mIKx5lhIt13X5eZQH0ZeMA: folds
rW/MyplHylMSBRaoRUzWrg: folds
QHxJjpVYwitg9krW6wZgJA: folds
1CtiZuXDFaJL1dJPQKyi8Q: folds
WUlHm+ydPPHG7Lb0rePSdA: raises $10 to $14
UZEsV9yKUMqmpYPiOFpaZw: calls $10
*** FLOP *** [3s 3h Qh]
WUlHm+ydPPHG7Lb0rePSdA: bets $16
UZEsV9yKUMqmpYPiOFpaZw: calls $16
*** TURN *** [3s 3h Qh] [6d]
WUlHm+ydPPHG7Lb0rePSdA: checks
UZEsV9yKUMqmpYPiOFpaZw: bets $16
WUlHm+ydPPHG7Lb0rePSdA: folds
UZEsV9yKUMqmpYPiOFpaZw collected $58.05 from pot
UZEsV9yKUMqmpYPiOFpaZw: doesn't show hand
*** SUMMARY ***
Total pot $61 | Rake $2.95
Board [3s 3h Qh 6d]
Seat 1: UZEsV9yKUMqmpYPiOFpaZw collected ($58.05)
Seat 2: g7gL2NLJCdZPPV399WKT1w folded before Flop (didn't bet)
Seat 3: ice1Sbe19zWIaKYoSmE5tw folded before Flop (didn't bet)
Seat 4: CkE3IyJF1KvdaAOmZY5XqQ folded before Flop (didn't bet)
Seat 5: mIKx5lhIt13X5eZQH0ZeMA folded before Flop (didn't bet)
Seat 6: rW/MyplHylMSBRaoRUzWrg folded before Flop (didn't bet)
Seat 7: QHxJjpVYwitg9krW6wZgJA (button) folded before Flop (didn't bet)
Seat 8: 1CtiZuXDFaJL1dJPQKyi8Q (small blind) folded before Flop
Seat 9: WUlHm+ydPPHG7Lb0rePSdA (big blind) folded on the Turn



PokerStars Game #59940719822:  Hold'em No Limit ($1/$2) - 2009/07/01 1:14:38 ET
Table 'aSf77Sj8QEnzcc0WaxVD4Q' 6-max Seat #1 is the button
Seat 1: UELtvp+JfwI7XDGVwSxZXA ($178.75 in chips)
Seat 3: 9dpyyjDTCed6nV7JhaUUpw ($202 in chips)
Seat 4: YsLQ3BAvgQHWXMAv3Wv6Hg ($264.40 in chips)
Seat 5: VvdR9F3I+2yELkfTVvC1dg ($200 in chips)
Seat 6: vkoJRf3gidxY1pPi0AFWww ($161.55 in chips)
vkfxu8f/jMYKUk6Ly4eujw will be allowed to play after the button
9dpyyjDTCed6nV7JhaUUpw: posts small blind $1
YsLQ3BAvgQHWXMAv3Wv6Hg: posts big blind $2
*** HOLE CARDS ***
VvdR9F3I+2yELkfTVvC1dg: folds
vkoJRf3gidxY1pPi0AFWww: raises $4 to $6
UELtvp+JfwI7XDGVwSxZXA: folds
9dpyyjDTCed6nV7JhaUUpw: folds
YsLQ3BAvgQHWXMAv3Wv6Hg: folds
vkoJRf3gidxY1pPi0AFWww collected $5 from pot
vkoJRf3gidxY1pPi0AFWww: doesn't show hand
*** SUMMARY ***
Total pot $5 | Rake $0
Seat 1: UELtvp+JfwI7XDGVwSxZXA (button) folded before Flop (didn't bet)
Seat 3: 9dpyyjDTCed6nV7JhaUUpw (small blind) folded before Flop
Seat 4: YsLQ3BAvgQHWXMAv3Wv6Hg (big blind) folded before Flop
Seat 5: VvdR9F3I+2yELkfTVvC1dg folded before Flop (didn't bet)
Seat 6: vkoJRf3gidxY1pPi0AFWww collected ($5)



PokerStars Game #59940721378:  Hold'em No Limit ($1/$2) - 2009/07/01 1:14:40 ET
Table 'bJQ024BaYSBrW0sXpCZbNQ' 6-max Seat #2 is the button
Seat 1: PCN5rt4TwI1pQE+rAiqI0Q ($253.50 in chips)
Seat 2: 3dAbvkxS5NPQTBAbvpinVg ($208.85 in chips)
Seat 3: vkfxu8f/jMYKUk6Ly4eujw ($185 in chips)
Seat 4: xu64sls3Oh5UB15fCNA6hg ($83.50 in chips)
Seat 6: 9dpyyjDTCed6nV7JhaUUpw ($387.95 in chips)
vkfxu8f/jMYKUk6Ly4eujw: posts small blind $1
xu64sls3Oh5UB15fCNA6hg: posts big blind $2
VvdR9F3I+2yELkfTVvC1dg: sits out
*** HOLE CARDS ***
9dpyyjDTCed6nV7JhaUUpw: raises $4 to $6
PCN5rt4TwI1pQE+rAiqI0Q: folds
3dAbvkxS5NPQTBAbvpinVg: folds
vkfxu8f/jMYKUk6Ly4eujw: raises $14 to $20
xu64sls3Oh5UB15fCNA6hg: folds
9dpyyjDTCed6nV7JhaUUpw: calls $14
*** FLOP *** [Td 4c Kd]
xu64sls3Oh5UB15fCNA6hg leaves the table
vkfxu8f/jMYKUk6Ly4eujw: bets $26
9dpyyjDTCed6nV7JhaUUpw: calls $26
*** TURN *** [Td 4c Kd] [9s]
vkfxu8f/jMYKUk6Ly4eujw: bets $60
9dpyyjDTCed6nV7JhaUUpw: folds
vkfxu8f/jMYKUk6Ly4eujw collected $92 from pot
vkfxu8f/jMYKUk6Ly4eujw: doesn't show hand
TBaQIN+sQ7eb7P99QnaORQ joins the table at seat #4
*** SUMMARY ***
Total pot $94 | Rake $2
Board [Td 4c Kd 9s]
Seat 1: PCN5rt4TwI1pQE+rAiqI0Q folded before Flop (didn't bet)
Seat 2: 3dAbvkxS5NPQTBAbvpinVg (button) folded before Flop (didn't bet)
Seat 3: vkfxu8f/jMYKUk6Ly4eujw (small blind) collected ($92)
Seat 4: xu64sls3Oh5UB15fCNA6hg (big blind) folded before Flop
Seat 6: 9dpyyjDTCed6nV7JhaUUpw folded on the Turn



PokerStars Game #59940721360:  Hold'em No Limit ($1/$2) - 2009/07/01 1:14:40 ET
Table 'gnHBqWll9O3fxG7Ojkz/ng' 9-max Seat #2 is the button
Seat 2: H6Z4+qu8gR0VUiPOijndVg ($328.25 in chips)
Seat 3: 5Q8U6iZbeO7xJSS4qvDP5g ($219 in chips)
Seat 5: rBQDMkKm9cZn6M9NPsiVew ($242.45 in chips)
Seat 6: /inIs/z/PcX+TniIFpaxpg ($21 in chips)
Seat 7: jqui3xAWCkcdPW36a6BD+w ($344.40 in chips)
Seat 8: cM6efHzdxoqYm0EQKP4TTQ ($105.30 in chips)
Seat 9: sN6yR5I5zFq/WFyIz5UfzQ ($201 in chips)
5Q8U6iZbeO7xJSS4qvDP5g: posts small blind $1
rBQDMkKm9cZn6M9NPsiVew: posts big blind $2
TAfo4veNRaRlzDXMMYS3Jg: sits out
*** HOLE CARDS ***
/inIs/z/PcX+TniIFpaxpg: folds
jqui3xAWCkcdPW36a6BD+w: folds
cM6efHzdxoqYm0EQKP4TTQ: calls $2
sN6yR5I5zFq/WFyIz5UfzQ: folds
H6Z4+qu8gR0VUiPOijndVg: raises $8 to $10
5Q8U6iZbeO7xJSS4qvDP5g: folds
rBQDMkKm9cZn6M9NPsiVew: folds
cM6efHzdxoqYm0EQKP4TTQ: folds
H6Z4+qu8gR0VUiPOijndVg collected $7 from pot
H6Z4+qu8gR0VUiPOijndVg: doesn't show hand
*** SUMMARY ***
Total pot $7 | Rake $0
Seat 2: H6Z4+qu8gR0VUiPOijndVg (button) collected ($7)
Seat 3: 5Q8U6iZbeO7xJSS4qvDP5g (small blind) folded before Flop
Seat 5: rBQDMkKm9cZn6M9NPsiVew (big blind) folded before Flop
Seat 6: /inIs/z/PcX+TniIFpaxpg folded before Flop (didn't bet)
Seat 7: jqui3xAWCkcdPW36a6BD+w folded before Flop (didn't bet)
Seat 8: cM6efHzdxoqYm0EQKP4TTQ folded before Flop
Seat 9: sN6yR5I5zFq/WFyIz5UfzQ folded before Flop (didn't bet)



PokerStars Game #59940721864:  Hold'em No Limit ($1/$2) - 2009/07/01 1:14:41 ET
Table 'NmY84NAf9Mh0ckAckHnh5g' 2-max Seat #2 is the button
Seat 1: 6hvg964TSqZ3AL/0XK9aVQ ($288.30 in chips)
Seat 2: RwDoM55ZeQuI2ADyJhOb2Q ($525.50 in chips)
RwDoM55ZeQuI2ADyJhOb2Q: posts small blind $1
6hvg964TSqZ3AL/0XK9aVQ: posts big blind $2
*** HOLE CARDS ***
RwDoM55ZeQuI2ADyJhOb2Q: raises $4 to $6
6hvg964TSqZ3AL/0XK9aVQ: calls $4
*** FLOP *** [5h 2d 2h]
6hvg964TSqZ3AL/0XK9aVQ: checks
RwDoM55ZeQuI2ADyJhOb2Q: bets $10
6hvg964TSqZ3AL/0XK9aVQ: folds
RwDoM55ZeQuI2ADyJhOb2Q collected $11.50 from pot
RwDoM55ZeQuI2ADyJhOb2Q: doesn't show hand
*** SUMMARY ***
Total pot $12 | Rake $0.50
Board [5h 2d 2h]
Seat 1: 6hvg964TSqZ3AL/0XK9aVQ (big blind) folded on the Flop
Seat 2: RwDoM55ZeQuI2ADyJhOb2Q (button) (small blind) collected ($11.50)



PokerStars Game #59940722114:  Hold'em No Limit ($1/$2) - 2009/07/01 1:14:42 ET
Table 'QxerF7GUfCbl+4a8XaTB2w' 6-max Seat #5 is the button
Seat 1: o9jamqIi6sTTRSqudgboRA ($298.50 in chips)
Seat 2: vkfxu8f/jMYKUk6Ly4eujw ($201.80 in chips)
Seat 3: m7mYVfnCOK5TE/VkN/FhOg ($240.70 in chips)
Seat 4: 09BNF4quPDzanQzM8vc6WA ($39 in chips)
Seat 5: YsLQ3BAvgQHWXMAv3Wv6Hg ($201.75 in chips)
Seat 6: VvdR9F3I+2yELkfTVvC1dg ($200 in chips)
VvdR9F3I+2yELkfTVvC1dg: posts small blind $1
o9jamqIi6sTTRSqudgboRA: posts big blind $2
*** HOLE CARDS ***
vkfxu8f/jMYKUk6Ly4eujw: folds
m7mYVfnCOK5TE/VkN/FhOg: folds
09BNF4quPDzanQzM8vc6WA: folds
YsLQ3BAvgQHWXMAv3Wv6Hg: raises $4 to $6
VvdR9F3I+2yELkfTVvC1dg: calls $5
o9jamqIi6sTTRSqudgboRA: folds
*** FLOP *** [4s 4c 2c]
VvdR9F3I+2yELkfTVvC1dg: checks
YsLQ3BAvgQHWXMAv3Wv6Hg: bets $8
VvdR9F3I+2yELkfTVvC1dg: calls $8
*** TURN *** [4s 4c 2c] [7c]
VvdR9F3I+2yELkfTVvC1dg: checks
YsLQ3BAvgQHWXMAv3Wv6Hg: checks
*** RIVER *** [4s 4c 2c 7c] [8h]
VvdR9F3I+2yELkfTVvC1dg: checks
YsLQ3BAvgQHWXMAv3Wv6Hg: checks
*** SHOW DOWN ***
VvdR9F3I+2yELkfTVvC1dg: shows [9h 9c] (two pair, Nines and Fours)
YsLQ3BAvgQHWXMAv3Wv6Hg: mucks hand
VvdR9F3I+2yELkfTVvC1dg collected $28.55 from pot
*** SUMMARY ***
Total pot $30 | Rake $1.45
Board [4s 4c 2c 7c 8h]
Seat 1: o9jamqIi6sTTRSqudgboRA (big blind) folded before Flop
Seat 2: vkfxu8f/jMYKUk6Ly4eujw folded before Flop (didn't bet)
Seat 3: m7mYVfnCOK5TE/VkN/FhOg folded before Flop (didn't bet)
Seat 4: 09BNF4quPDzanQzM8vc6WA folded before Flop (didn't bet)
Seat 5: YsLQ3BAvgQHWXMAv3Wv6Hg (button) mucked
Seat 6: VvdR9F3I+2yELkfTVvC1dg (small blind) showed [9h 9c] and won ($28.55) with two pair, Nines and Fours



PokerStars Game #59940722834:  Hold'em No Limit ($1/$2) - 2009/07/01 1:14:43 ET
Table 'CFkQcfWjKccZaZDf71FK+w' 6-max Seat #3 is the button
Seat 1: JsC+WvfzqlxVs9G8/gSQAQ ($139.20 in chips)
Seat 2: ewN/vzF22+/gdzjIKBOlkA ($197.45 in chips)
Seat 3: 09BNF4quPDzanQzM8vc6WA ($36 in chips)
Seat 4: ygTTt5ehT4aF86q1a8/R+w ($161.10 in chips)
Seat 5: 2lOU1DcvUZaMcxZ95XfzXw ($76 in chips)
Seat 6: ORVqY3rf9X6ANA/8s+On2Q ($80.75 in chips)
ygTTt5ehT4aF86q1a8/R+w: posts small blind $1
2lOU1DcvUZaMcxZ95XfzXw: posts big blind $2
*** HOLE CARDS ***
ORVqY3rf9X6ANA/8s+On2Q: folds
JsC+WvfzqlxVs9G8/gSQAQ: raises $8 to $10
ewN/vzF22+/gdzjIKBOlkA: folds
09BNF4quPDzanQzM8vc6WA: folds
ygTTt5ehT4aF86q1a8/R+w: folds
2lOU1DcvUZaMcxZ95XfzXw: folds
JsC+WvfzqlxVs9G8/gSQAQ collected $5 from pot
JsC+WvfzqlxVs9G8/gSQAQ: doesn't show hand
*** SUMMARY ***
Total pot $5 | Rake $0
Seat 1: JsC+WvfzqlxVs9G8/gSQAQ collected ($5)
Seat 2: ewN/vzF22+/gdzjIKBOlkA folded before Flop (didn't bet)
Seat 3: 09BNF4quPDzanQzM8vc6WA (button) folded before Flop (didn't bet)
Seat 4: ygTTt5ehT4aF86q1a8/R+w (small blind) folded before Flop
Seat 5: 2lOU1DcvUZaMcxZ95XfzXw (big blind) folded before Flop
Seat 6: ORVqY3rf9X6ANA/8s+On2Q folded before Flop (didn't bet)



PokerStars Game #59940723388:  Hold'em No Limit ($1/$2) - 2009/07/01 1:14:44 ET
Table 'mGpP9StWRnoeiBDExc6Frg' 6-max Seat #2 is the button
Seat 2: dZcLsEI8iXkobBduRJ45Yw ($92 in chips)
Seat 4: 4dcDwIHRm96PwtqkpQiuiA ($38 in chips)
Seat 5: d1puGuVBE0fidn+5eRJ0tw ($230.20 in chips)
Seat 6: B2Ih1sr5VZk+8He7rcrMtQ ($439.35 in chips)
7acrZUQC3Zc9BNLjoKIcLQ will be allowed to play after the button
4dcDwIHRm96PwtqkpQiuiA: posts small blind $1
d1puGuVBE0fidn+5eRJ0tw: posts big blind $2
VvdR9F3I+2yELkfTVvC1dg: sits out
*** HOLE CARDS ***
B2Ih1sr5VZk+8He7rcrMtQ: folds
dZcLsEI8iXkobBduRJ45Yw: folds
4dcDwIHRm96PwtqkpQiuiA: raises $6 to $8
d1puGuVBE0fidn+5eRJ0tw: folds
4dcDwIHRm96PwtqkpQiuiA collected $4 from pot
*** SUMMARY ***
Total pot $4 | Rake $0
Seat 2: dZcLsEI8iXkobBduRJ45Yw (button) folded before Flop (didn't bet)
Seat 4: 4dcDwIHRm96PwtqkpQiuiA (small blind) collected ($4)
Seat 5: d1puGuVBE0fidn+5eRJ0tw (big blind) folded before Flop
Seat 6: B2Ih1sr5VZk+8He7rcrMtQ folded before Flop (didn't bet)



PokerStars Game #59940724818:  Hold'em No Limit ($1/$2) - 2009/07/01 1:14:46 ET
Table 'LL4bDFyhj5hsMpzaDugJZg' 6-max Seat #4 is the button
Seat 1: FwvID/fQGlpY3soi/lMTww ($65.95 in chips)
Seat 2: IZng3w8jiJHHp3LbYKLi4w ($43.50 in chips)
Seat 3: iI/NMpRxMkGieArQEhACSA ($282.70 in chips)
Seat 4: 8srN1dKQePlsv0GyTada+Q ($311.75 in chips)
Seat 5: A2GTwTiwkb1ilNWgW487Vg ($97.05 in chips)
Seat 6: 692Q4sfB0gTElzS0WMeg+A ($220.10 in chips)
A2GTwTiwkb1ilNWgW487Vg: posts small blind $1
692Q4sfB0gTElzS0WMeg+A: posts big blind $2
*** HOLE CARDS ***
FwvID/fQGlpY3soi/lMTww said, "aa and nothing"
FwvID/fQGlpY3soi/lMTww: folds
IZng3w8jiJHHp3LbYKLi4w: folds
iI/NMpRxMkGieArQEhACSA: folds
8srN1dKQePlsv0GyTada+Q: raises $3 to $5
A2GTwTiwkb1ilNWgW487Vg: folds
692Q4sfB0gTElzS0WMeg+A: folds
8srN1dKQePlsv0GyTada+Q collected $5 from pot
*** SUMMARY ***
Total pot $5 | Rake $0
Seat 1: FwvID/fQGlpY3soi/lMTww folded before Flop (didn't bet)
Seat 2: IZng3w8jiJHHp3LbYKLi4w folded before Flop (didn't bet)
Seat 3: iI/NMpRxMkGieArQEhACSA folded before Flop (didn't bet)
Seat 4: 8srN1dKQePlsv0GyTada+Q (button) collected ($5)
Seat 5: A2GTwTiwkb1ilNWgW487Vg (small blind) folded before Flop
Seat 6: 692Q4sfB0gTElzS0WMeg+A (big blind) folded before Flop



PokerStars Game #59940724528:  Hold'em No Limit ($1/$2) - 2009/07/01 1:14:46 ET
Table 'kq5zaQ+1hLNf8LZfGnbTAA' 6-max Seat #5 is the button
Seat 1: 8srN1dKQePlsv0GyTada+Q ($200 in chips)
Seat 3: vkfxu8f/jMYKUk6Ly4eujw ($222.70 in chips)
Seat 4: 3dAbvkxS5NPQTBAbvpinVg ($200 in chips)
Seat 5: kfASJqTbXek+zc8ZKsZL1Q ($137.35 in chips)
Seat 6: mfy7uGZcqA2PVQqEVbJ7+g ($243.25 in chips)
mfy7uGZcqA2PVQqEVbJ7+g: posts small blind $1
8srN1dKQePlsv0GyTada+Q: posts big blind $2
nXDI8Y/S6POzRwANu3d8hQ: sits out
*** HOLE CARDS ***
vkfxu8f/jMYKUk6Ly4eujw: folds
3dAbvkxS5NPQTBAbvpinVg: folds
kfASJqTbXek+zc8ZKsZL1Q: folds
mfy7uGZcqA2PVQqEVbJ7+g: folds
8srN1dKQePlsv0GyTada+Q collected $2 from pot
8srN1dKQePlsv0GyTada+Q: doesn't show hand
*** SUMMARY ***
Total pot $2 | Rake $0
Seat 1: 8srN1dKQePlsv0GyTada+Q (big blind) collected ($2)
Seat 3: vkfxu8f/jMYKUk6Ly4eujw folded before Flop (didn't bet)
Seat 4: 3dAbvkxS5NPQTBAbvpinVg folded before Flop (didn't bet)
Seat 5: kfASJqTbXek+zc8ZKsZL1Q (button) folded before Flop (didn't bet)
Seat 6: mfy7uGZcqA2PVQqEVbJ7+g (small blind) folded before Flop



PokerStars Game #59940727450:  Hold'em No Limit ($1/$2) - 2009/07/01 1:14:51 ET
Table 'gftD4mDF7mIFKvSrIyaRbw' 9-max Seat #9 is the button
Seat 1: 31HuO+DQxppUQEedBWukug ($98 in chips)
Seat 2: GX1heJ+DSsvm7gzSPsYhhQ ($40 in chips)
Seat 3: CUZwDpLTQKhzarPe+JCLOQ ($203 in chips)
Seat 4: rW/MyplHylMSBRaoRUzWrg ($54.50 in chips)
Seat 5: mpsfNtnMVDqQHTe92AhIdw ($123.50 in chips)
Seat 6: 2NvwF8W2nzsbS+G//yLAbQ ($164.50 in chips)
Seat 7: EBV6OktyeSmh4w6sWmcWOw ($217.65 in chips)
Seat 8: MpL4DeEqGQu0H8TJEbEOrg ($40 in chips)
Seat 9: F7m34OOfAQ7annesMHVjKw ($170.10 in chips)
31HuO+DQxppUQEedBWukug: posts small blind $1
GX1heJ+DSsvm7gzSPsYhhQ: posts big blind $2
*** HOLE CARDS ***
CUZwDpLTQKhzarPe+JCLOQ: folds
rW/MyplHylMSBRaoRUzWrg: folds
mpsfNtnMVDqQHTe92AhIdw: folds
2NvwF8W2nzsbS+G//yLAbQ: calls $2
EBV6OktyeSmh4w6sWmcWOw: calls $2
MpL4DeEqGQu0H8TJEbEOrg: folds
F7m34OOfAQ7annesMHVjKw: calls $2
31HuO+DQxppUQEedBWukug: raises $10 to $12
GX1heJ+DSsvm7gzSPsYhhQ: folds
2NvwF8W2nzsbS+G//yLAbQ: folds
EBV6OktyeSmh4w6sWmcWOw: folds
F7m34OOfAQ7annesMHVjKw: folds
31HuO+DQxppUQEedBWukug collected $10 from pot
31HuO+DQxppUQEedBWukug: doesn't show hand
*** SUMMARY ***
Total pot $10 | Rake $0
Seat 1: 31HuO+DQxppUQEedBWukug (small blind) collected ($10)
Seat 2: GX1heJ+DSsvm7gzSPsYhhQ (big blind) folded before Flop
Seat 3: CUZwDpLTQKhzarPe+JCLOQ folded before Flop (didn't bet)
Seat 4: rW/MyplHylMSBRaoRUzWrg folded before Flop (didn't bet)
Seat 5: mpsfNtnMVDqQHTe92AhIdw folded before Flop (didn't bet)
Seat 6: 2NvwF8W2nzsbS+G//yLAbQ folded before Flop
Seat 7: EBV6OktyeSmh4w6sWmcWOw folded before Flop
Seat 8: MpL4DeEqGQu0H8TJEbEOrg folded before Flop (didn't bet)
Seat 9: F7m34OOfAQ7annesMHVjKw (button) folded before Flop



PokerStars Game #59940728230:  Hold'em No Limit ($1/$2) - 2009/07/01 1:14:52 ET
Table 'pPQgcj9XT9CHBsbo1WTBug' 6-max Seat #4 is the button
Seat 1: DFVYDA6dKQy7R7mGIKogZA ($148.85 in chips)
Seat 2: qXDd0ZyMIse0OBu8pxeQ3Q ($200 in chips)
Seat 3: WfaZs12BkYO+BUX5VWpuWQ ($24.85 in chips)
Seat 4: gqlysXCbT8V54f/1lf9h3A ($42 in chips)
Seat 5: vkfxu8f/jMYKUk6Ly4eujw ($217.05 in chips)
Seat 6: Yr7pZltpy3IUNdKS9PCEiw ($288.90 in chips)
vkfxu8f/jMYKUk6Ly4eujw: posts small blind $1
Yr7pZltpy3IUNdKS9PCEiw: posts big blind $2
*** HOLE CARDS ***
DFVYDA6dKQy7R7mGIKogZA: calls $2
qXDd0ZyMIse0OBu8pxeQ3Q: folds
WfaZs12BkYO+BUX5VWpuWQ: folds
gqlysXCbT8V54f/1lf9h3A: folds
vkfxu8f/jMYKUk6Ly4eujw: folds
Yr7pZltpy3IUNdKS9PCEiw: checks
*** FLOP *** [Tc Kd Kh]
Yr7pZltpy3IUNdKS9PCEiw: checks
DFVYDA6dKQy7R7mGIKogZA: checks
*** TURN *** [Tc Kd Kh] [Ah]
Yr7pZltpy3IUNdKS9PCEiw: checks
DFVYDA6dKQy7R7mGIKogZA: bets $4
Yr7pZltpy3IUNdKS9PCEiw: folds
DFVYDA6dKQy7R7mGIKogZA collected $4.75 from pot
*** SUMMARY ***
Total pot $5 | Rake $0.25
Board [Tc Kd Kh Ah]
Seat 1: DFVYDA6dKQy7R7mGIKogZA collected ($4.75)
Seat 2: qXDd0ZyMIse0OBu8pxeQ3Q folded before Flop (didn't bet)
Seat 3: WfaZs12BkYO+BUX5VWpuWQ folded before Flop (didn't bet)
Seat 4: gqlysXCbT8V54f/1lf9h3A (button) folded before Flop (didn't bet)
Seat 5: vkfxu8f/jMYKUk6Ly4eujw (small blind) folded before Flop
Seat 6: Yr7pZltpy3IUNdKS9PCEiw (big blind) folded on the Turn



PokerStars Game #59940728494:  Hold'em No Limit ($1/$2) - 2009/07/01 1:14:52 ET
Table 'aSf77Sj8QEnzcc0WaxVD4Q' 6-max Seat #3 is the button
Seat 1: UELtvp+JfwI7XDGVwSxZXA ($178.75 in chips)
Seat 3: 9dpyyjDTCed6nV7JhaUUpw ($201 in chips)
Seat 4: YsLQ3BAvgQHWXMAv3Wv6Hg ($262.40 in chips)
Seat 5: VvdR9F3I+2yELkfTVvC1dg ($200 in chips)
Seat 6: vkoJRf3gidxY1pPi0AFWww ($164.55 in chips)
YsLQ3BAvgQHWXMAv3Wv6Hg: posts small blind $1
VvdR9F3I+2yELkfTVvC1dg: posts big blind $2
vkfxu8f/jMYKUk6Ly4eujw: sits out
*** HOLE CARDS ***
vkoJRf3gidxY1pPi0AFWww: calls $2
UELtvp+JfwI7XDGVwSxZXA: folds
9dpyyjDTCed6nV7JhaUUpw: raises $6 to $8
YsLQ3BAvgQHWXMAv3Wv6Hg: folds
VvdR9F3I+2yELkfTVvC1dg: folds
vkoJRf3gidxY1pPi0AFWww: calls $6
*** FLOP *** [2s 5h 9s]
vkoJRf3gidxY1pPi0AFWww: bets $8
9dpyyjDTCed6nV7JhaUUpw: raises $20 to $28
vkoJRf3gidxY1pPi0AFWww: folds
9dpyyjDTCed6nV7JhaUUpw collected $33.30 from pot
9dpyyjDTCed6nV7JhaUUpw: doesn't show hand
*** SUMMARY ***
Total pot $35 | Rake $1.70
Board [2s 5h 9s]
Seat 1: UELtvp+JfwI7XDGVwSxZXA folded before Flop (didn't bet)
Seat 3: 9dpyyjDTCed6nV7JhaUUpw (button) collected ($33.30)
Seat 4: YsLQ3BAvgQHWXMAv3Wv6Hg (small blind) folded before Flop
Seat 5: VvdR9F3I+2yELkfTVvC1dg (big blind) folded before Flop
Seat 6: vkoJRf3gidxY1pPi0AFWww folded on the Flop



PokerStars Game #59940729836:  Hold'em No Limit ($1/$2) - 2009/07/01 1:14:55 ET
Table 'kq5zaQ+1hLNf8LZfGnbTAA' 6-max Seat #6 is the button
Seat 1: 8srN1dKQePlsv0GyTada+Q ($201 in chips)
Seat 2: nXDI8Y/S6POzRwANu3d8hQ ($40 in chips)
Seat 3: vkfxu8f/jMYKUk6Ly4eujw ($222.70 in chips)
Seat 4: 3dAbvkxS5NPQTBAbvpinVg ($200 in chips)
Seat 5: kfASJqTbXek+zc8ZKsZL1Q ($137.35 in chips)
Seat 6: mfy7uGZcqA2PVQqEVbJ7+g ($242.25 in chips)
8srN1dKQePlsv0GyTada+Q: posts small blind $1
nXDI8Y/S6POzRwANu3d8hQ: posts big blind $2
*** HOLE CARDS ***
vkfxu8f/jMYKUk6Ly4eujw: folds
3dAbvkxS5NPQTBAbvpinVg: folds
kfASJqTbXek+zc8ZKsZL1Q: calls $2
mfy7uGZcqA2PVQqEVbJ7+g: folds
8srN1dKQePlsv0GyTada+Q: folds
nXDI8Y/S6POzRwANu3d8hQ: checks
*** FLOP *** [3d Jc 4d]
nXDI8Y/S6POzRwANu3d8hQ: checks
kfASJqTbXek+zc8ZKsZL1Q: checks
*** TURN *** [3d Jc 4d] [Kh]
nXDI8Y/S6POzRwANu3d8hQ: bets $6
kfASJqTbXek+zc8ZKsZL1Q: folds
nXDI8Y/S6POzRwANu3d8hQ collected $4.75 from pot
nXDI8Y/S6POzRwANu3d8hQ: doesn't show hand
*** SUMMARY ***
Total pot $5 | Rake $0.25
Board [3d Jc 4d Kh]
Seat 1: 8srN1dKQePlsv0GyTada+Q (small blind) folded before Flop
Seat 2: nXDI8Y/S6POzRwANu3d8hQ (big blind) collected ($4.75)
Seat 3: vkfxu8f/jMYKUk6Ly4eujw folded before Flop (didn't bet)
Seat 4: 3dAbvkxS5NPQTBAbvpinVg folded before Flop (didn't bet)
Seat 5: kfASJqTbXek+zc8ZKsZL1Q folded on the Turn
Seat 6: mfy7uGZcqA2PVQqEVbJ7+g (button) folded before Flop (didn't bet)



PokerStars Game #59940730658:  Hold'em No Limit ($1/$2) - 2009/07/01 1:14:56 ET
Table '+hSnXFQrGw1PlVgTnuj+sA' 6-max Seat #3 is the button
Seat 1: 2ccIJhDj+3JapvS7swVZEg ($279.50 in chips)
Seat 2: o9jamqIi6sTTRSqudgboRA ($277.55 in chips)
Seat 3: fE+LHW/7rpfXW14g8LhGjA ($74.65 in chips)
Seat 4: J4iH5epwXbmODnojR/VRxA ($198 in chips)
Seat 5: VvdR9F3I+2yELkfTVvC1dg ($200 in chips)
Seat 6: AuiGltq875lmaKHBsjZVGg ($69 in chips)
J4iH5epwXbmODnojR/VRxA: posts small blind $1
VvdR9F3I+2yELkfTVvC1dg: posts big blind $2
*** HOLE CARDS ***
AuiGltq875lmaKHBsjZVGg: raises $2 to $4
2ccIJhDj+3JapvS7swVZEg: folds
o9jamqIi6sTTRSqudgboRA: folds
fE+LHW/7rpfXW14g8LhGjA: folds
J4iH5epwXbmODnojR/VRxA: calls $3
VvdR9F3I+2yELkfTVvC1dg: folds
*** FLOP *** [2c Jd Qc]
J4iH5epwXbmODnojR/VRxA: bets $2
AuiGltq875lmaKHBsjZVGg: calls $2
*** TURN *** [2c Jd Qc] [Td]
J4iH5epwXbmODnojR/VRxA: bets $5
AuiGltq875lmaKHBsjZVGg: calls $5
*** RIVER *** [2c Jd Qc Td] [8c]
J4iH5epwXbmODnojR/VRxA: checks
AuiGltq875lmaKHBsjZVGg: checks
*** SHOW DOWN ***
J4iH5epwXbmODnojR/VRxA: shows [4c 2d] (a pair of Deuces)
AuiGltq875lmaKHBsjZVGg: shows [Ks Js] (a pair of Jacks)
AuiGltq875lmaKHBsjZVGg collected $22.85 from pot
*** SUMMARY ***
Total pot $24 | Rake $1.15
Board [2c Jd Qc Td 8c]
Seat 1: 2ccIJhDj+3JapvS7swVZEg folded before Flop (didn't bet)
Seat 2: o9jamqIi6sTTRSqudgboRA folded before Flop (didn't bet)
Seat 3: fE+LHW/7rpfXW14g8LhGjA (button) folded before Flop (didn't bet)
Seat 4: J4iH5epwXbmODnojR/VRxA (small blind) showed [4c 2d] and lost with a pair of Deuces
Seat 5: VvdR9F3I+2yELkfTVvC1dg (big blind) folded before Flop
Seat 6: AuiGltq875lmaKHBsjZVGg showed [Ks Js] and won ($22.85) with a pair of Jacks



PokerStars Game #59940731794:  Hold'em No Limit ($1/$2) - 2009/07/01 1:14:58 ET
Table 'NmY84NAf9Mh0ckAckHnh5g' 2-max Seat #1 is the button
Seat 1: 6hvg964TSqZ3AL/0XK9aVQ ($282.30 in chips)
Seat 2: RwDoM55ZeQuI2ADyJhOb2Q ($531 in chips)
6hvg964TSqZ3AL/0XK9aVQ: posts small blind $1
RwDoM55ZeQuI2ADyJhOb2Q: posts big blind $2
*** HOLE CARDS ***
6hvg964TSqZ3AL/0XK9aVQ: calls $1
RwDoM55ZeQuI2ADyJhOb2Q: checks
*** FLOP *** [Ac 2h 9h]
RwDoM55ZeQuI2ADyJhOb2Q: bets $4
6hvg964TSqZ3AL/0XK9aVQ: calls $4
*** TURN *** [Ac 2h 9h] [Qc]
RwDoM55ZeQuI2ADyJhOb2Q: bets $8
6hvg964TSqZ3AL/0XK9aVQ: raises $10 to $18
RwDoM55ZeQuI2ADyJhOb2Q: calls $10
*** RIVER *** [Ac 2h 9h Qc] [Qh]
RwDoM55ZeQuI2ADyJhOb2Q: checks
6hvg964TSqZ3AL/0XK9aVQ: checks
*** SHOW DOWN ***
RwDoM55ZeQuI2ADyJhOb2Q: shows [Ad 6c] (two pair, Aces and Queens)
6hvg964TSqZ3AL/0XK9aVQ: mucks hand
RwDoM55ZeQuI2ADyJhOb2Q collected $47.50 from pot
*** SUMMARY ***
Total pot $48 | Rake $0.50
Board [Ac 2h 9h Qc Qh]
Seat 1: 6hvg964TSqZ3AL/0XK9aVQ (button) (small blind) mucked
Seat 2: RwDoM55ZeQuI2ADyJhOb2Q (big blind) showed [Ad 6c] and won ($47.50) with two pair, Aces and Queens



PokerStars Game #59940732356:  Hold'em No Limit ($1/$2) - 2009/07/01 1:14:59 ET
Table 'srul5UFZXTEccVV5fpY91g' 9-max Seat #1 is the button
Seat 1: Kzta8yu9vxHT4B70mjBZ+w ($197 in chips)
Seat 2: CUZwDpLTQKhzarPe+JCLOQ ($202.75 in chips)
Seat 3: weUZ8S7tgbaeIpzi1gBNxQ ($54.55 in chips)
Seat 4: GG5lTuGt3+kwNYSbqeB6yw ($131.30 in chips)
Seat 5: ri8CLkX3e9JF34dQNbsHGA ($51.65 in chips)
Seat 6: /inIs/z/PcX+TniIFpaxpg ($46.65 in chips)
Seat 8: UZEsV9yKUMqmpYPiOFpaZw ($113.45 in chips)
Seat 9: GgrYze3jkUdSO7a7CuJGDw ($193 in chips)
CUZwDpLTQKhzarPe+JCLOQ: posts small blind $1
weUZ8S7tgbaeIpzi1gBNxQ: posts big blind $2
rW/MyplHylMSBRaoRUzWrg: sits out
*** HOLE CARDS ***
GG5lTuGt3+kwNYSbqeB6yw: folds
GG5lTuGt3+kwNYSbqeB6yw leaves the table
ri8CLkX3e9JF34dQNbsHGA: raises $2 to $4
/inIs/z/PcX+TniIFpaxpg: folds
UZEsV9yKUMqmpYPiOFpaZw: folds
GgrYze3jkUdSO7a7CuJGDw: calls $4
Kzta8yu9vxHT4B70mjBZ+w: calls $4
CUZwDpLTQKhzarPe+JCLOQ: folds
weUZ8S7tgbaeIpzi1gBNxQ: calls $2
*** FLOP *** [2c Ks 2h]
weUZ8S7tgbaeIpzi1gBNxQ: bets $4
ri8CLkX3e9JF34dQNbsHGA: folds
GgrYze3jkUdSO7a7CuJGDw: folds
Kzta8yu9vxHT4B70mjBZ+w: folds
weUZ8S7tgbaeIpzi1gBNxQ collected $16.15 from pot
*** SUMMARY ***
Total pot $17 | Rake $0.85
Board [2c Ks 2h]
Seat 1: Kzta8yu9vxHT4B70mjBZ+w (button) folded on the Flop
Seat 2: CUZwDpLTQKhzarPe+JCLOQ (small blind) folded before Flop
Seat 3: weUZ8S7tgbaeIpzi1gBNxQ (big blind) collected ($16.15)
Seat 4: GG5lTuGt3+kwNYSbqeB6yw folded before Flop (didn't bet)
Seat 5: ri8CLkX3e9JF34dQNbsHGA folded on the Flop
Seat 6: /inIs/z/PcX+TniIFpaxpg folded before Flop (didn't bet)
Seat 8: UZEsV9yKUMqmpYPiOFpaZw folded before Flop (didn't bet)
Seat 9: GgrYze3jkUdSO7a7CuJGDw folded on the Flop



PokerStars Game #59940733022:  Hold'em No Limit ($1/$2) - 2009/07/01 1:15:00 ET
Table 'ZzSIe0zTCDv+n6hfbY5tTg' 6-max Seat #6 is the button
Seat 1: VvdR9F3I+2yELkfTVvC1dg ($200 in chips)
Seat 2: B87ikIyZ/TzAVeXf38Ny0g ($240 in chips)
Seat 3: gsugPj31Hui3Jefl98MBOA ($143.30 in chips)
Seat 4: qXDd0ZyMIse0OBu8pxeQ3Q ($200 in chips)
Seat 5: 3dAbvkxS5NPQTBAbvpinVg ($481.30 in chips)
Seat 6: 09BNF4quPDzanQzM8vc6WA ($28.50 in chips)
VvdR9F3I+2yELkfTVvC1dg: posts small blind $1
B87ikIyZ/TzAVeXf38Ny0g: posts big blind $2
*** HOLE CARDS ***
gsugPj31Hui3Jefl98MBOA: raises $5 to $7
qXDd0ZyMIse0OBu8pxeQ3Q: folds
3dAbvkxS5NPQTBAbvpinVg: calls $7
09BNF4quPDzanQzM8vc6WA: folds
VvdR9F3I+2yELkfTVvC1dg: folds
B87ikIyZ/TzAVeXf38Ny0g: folds
*** FLOP *** [Qd Jd 6d]
gsugPj31Hui3Jefl98MBOA: bets $12
3dAbvkxS5NPQTBAbvpinVg: calls $12
*** TURN *** [Qd Jd 6d] [Qc]
gsugPj31Hui3Jefl98MBOA: checks
3dAbvkxS5NPQTBAbvpinVg: bets $27
gsugPj31Hui3Jefl98MBOA: folds
3dAbvkxS5NPQTBAbvpinVg collected $39 from pot
3dAbvkxS5NPQTBAbvpinVg: doesn't show hand
*** SUMMARY ***
Total pot $41 | Rake $2
Board [Qd Jd 6d Qc]
Seat 1: VvdR9F3I+2yELkfTVvC1dg (small blind) folded before Flop
Seat 2: B87ikIyZ/TzAVeXf38Ny0g (big blind) folded before Flop
Seat 3: gsugPj31Hui3Jefl98MBOA folded on the Turn
Seat 4: qXDd0ZyMIse0OBu8pxeQ3Q folded before Flop (didn't bet)
Seat 5: 3dAbvkxS5NPQTBAbvpinVg collected ($39)
Seat 6: 09BNF4quPDzanQzM8vc6WA (button) folded before Flop (didn't bet)



PokerStars Game #59940732538:  Hold'em No Limit ($1/$2) - 2009/07/01 1:15:00 ET
Table 'W9UeSV0aoPjh5SFSxM8jUQ' 9-max Seat #3 is the button
Seat 1: mIKx5lhIt13X5eZQH0ZeMA ($39 in chips)
Seat 2: iMe5yhc+1BaiIPHet3NMrA ($249.05 in chips)
Seat 3: /inIs/z/PcX+TniIFpaxpg ($25 in chips)
Seat 4: LjOrlR1DLUQ+KE0gh7hP6Q ($93.40 in chips)
Seat 5: ri8CLkX3e9JF34dQNbsHGA ($45.45 in chips)
Seat 6: j47DM+lqTfzZP8musviQTg ($96.50 in chips)
Seat 7: I2ipWauytvrkEer4XD3Sjg ($118 in chips)
Seat 8: odhvI/CZeMsPyo1n1U7+hA ($51.70 in chips)
Seat 9: Q104K4iDGcqOlVrjAkzPEA ($31 in chips)
LjOrlR1DLUQ+KE0gh7hP6Q: posts small blind $1
ri8CLkX3e9JF34dQNbsHGA: posts big blind $2
*** HOLE CARDS ***
j47DM+lqTfzZP8musviQTg: folds
I2ipWauytvrkEer4XD3Sjg: folds
odhvI/CZeMsPyo1n1U7+hA: calls $2
Q104K4iDGcqOlVrjAkzPEA: folds
mIKx5lhIt13X5eZQH0ZeMA: calls $2
iMe5yhc+1BaiIPHet3NMrA: calls $2
/inIs/z/PcX+TniIFpaxpg: folds
LjOrlR1DLUQ+KE0gh7hP6Q: folds
ri8CLkX3e9JF34dQNbsHGA: checks
*** FLOP *** [6h Kh 6d]
ri8CLkX3e9JF34dQNbsHGA: checks
odhvI/CZeMsPyo1n1U7+hA: checks
mIKx5lhIt13X5eZQH0ZeMA: checks
iMe5yhc+1BaiIPHet3NMrA: checks
*** TURN *** [6h Kh 6d] [9s]
ri8CLkX3e9JF34dQNbsHGA: checks
odhvI/CZeMsPyo1n1U7+hA: checks
mIKx5lhIt13X5eZQH0ZeMA: checks
iMe5yhc+1BaiIPHet3NMrA: bets $6
ri8CLkX3e9JF34dQNbsHGA: folds
odhvI/CZeMsPyo1n1U7+hA: folds
mIKx5lhIt13X5eZQH0ZeMA: folds
iMe5yhc+1BaiIPHet3NMrA collected $8.55 from pot
*** SUMMARY ***
Total pot $9 | Rake $0.45
Board [6h Kh 6d 9s]
Seat 1: mIKx5lhIt13X5eZQH0ZeMA folded on the Turn
Seat 2: iMe5yhc+1BaiIPHet3NMrA collected ($8.55)
Seat 3: /inIs/z/PcX+TniIFpaxpg (button) folded before Flop (didn't bet)
Seat 4: LjOrlR1DLUQ+KE0gh7hP6Q (small blind) folded before Flop
Seat 5: ri8CLkX3e9JF34dQNbsHGA (big blind) folded on the Turn
Seat 6: j47DM+lqTfzZP8musviQTg folded before Flop (didn't bet)
Seat 7: I2ipWauytvrkEer4XD3Sjg folded before Flop (didn't bet)
Seat 8: odhvI/CZeMsPyo1n1U7+hA folded on the Turn
Seat 9: Q104K4iDGcqOlVrjAkzPEA folded before Flop (didn't bet)



PokerStars Game #59940732758:  Hold'em No Limit ($1/$2) - 2009/07/01 1:15:00 ET
Table 'bIihwBANJSFqlHPPtset+w' 9-max Seat #4 is the button
Seat 1: /inIs/z/PcX+TniIFpaxpg ($33 in chips)
Seat 2: lQYT23h5QCUVZAKxjOO39Q ($181.30 in chips)
Seat 3: OipzuP0MueAd8hGaz/kWMQ ($21.15 in chips)
Seat 4: ri8CLkX3e9JF34dQNbsHGA ($42.40 in chips)
Seat 5: vxbbJLsS1bva6tW2NiFssg ($201 in chips)
Seat 6: CkE3IyJF1KvdaAOmZY5XqQ ($189 in chips)
Seat 7: pCmk6FpSOLJ+85o1tLHIag ($119.50 in chips)
Seat 8: iMe5yhc+1BaiIPHet3NMrA ($228.65 in chips)
Seat 9: qn8LDoUFphcG4+r+F+Vhrg ($190 in chips)
vxbbJLsS1bva6tW2NiFssg: posts small blind $1
CkE3IyJF1KvdaAOmZY5XqQ: posts big blind $2
*** HOLE CARDS ***
pCmk6FpSOLJ+85o1tLHIag: raises $4 to $6
iMe5yhc+1BaiIPHet3NMrA: folds
qn8LDoUFphcG4+r+F+Vhrg: calls $6
/inIs/z/PcX+TniIFpaxpg: folds
lQYT23h5QCUVZAKxjOO39Q: calls $6
OipzuP0MueAd8hGaz/kWMQ: folds
ri8CLkX3e9JF34dQNbsHGA: folds
vxbbJLsS1bva6tW2NiFssg: folds
CkE3IyJF1KvdaAOmZY5XqQ: folds
*** FLOP *** [3s Kc 5d]
pCmk6FpSOLJ+85o1tLHIag: bets $12
qn8LDoUFphcG4+r+F+Vhrg: folds
lQYT23h5QCUVZAKxjOO39Q: folds
pCmk6FpSOLJ+85o1tLHIag collected $19.95 from pot
*** SUMMARY ***
Total pot $21 | Rake $1.05
Board [3s Kc 5d]
Seat 1: /inIs/z/PcX+TniIFpaxpg folded before Flop (didn't bet)
Seat 2: lQYT23h5QCUVZAKxjOO39Q folded on the Flop
Seat 3: OipzuP0MueAd8hGaz/kWMQ folded before Flop (didn't bet)
Seat 4: ri8CLkX3e9JF34dQNbsHGA (button) folded before Flop (didn't bet)
Seat 5: vxbbJLsS1bva6tW2NiFssg (small blind) folded before Flop
Seat 6: CkE3IyJF1KvdaAOmZY5XqQ (big blind) folded before Flop
Seat 7: pCmk6FpSOLJ+85o1tLHIag collected ($19.95)
Seat 8: iMe5yhc+1BaiIPHet3NMrA folded before Flop (didn't bet)
Seat 9: qn8LDoUFphcG4+r+F+Vhrg folded on the Flop



PokerStars Game #59940733306:  Hold'em No Limit ($1/$2) - 2009/07/01 1:15:01 ET
Table 'mGpP9StWRnoeiBDExc6Frg' 6-max Seat #4 is the button
Seat 2: dZcLsEI8iXkobBduRJ45Yw ($92 in chips)
Seat 4: 4dcDwIHRm96PwtqkpQiuiA ($40 in chips)
Seat 5: d1puGuVBE0fidn+5eRJ0tw ($228.20 in chips)
Seat 6: B2Ih1sr5VZk+8He7rcrMtQ ($439.35 in chips)
d1puGuVBE0fidn+5eRJ0tw: posts small blind $1
B2Ih1sr5VZk+8He7rcrMtQ: posts big blind $2
VvdR9F3I+2yELkfTVvC1dg: sits out
7acrZUQC3Zc9BNLjoKIcLQ: sits out
*** HOLE CARDS ***
dZcLsEI8iXkobBduRJ45Yw: folds
4dcDwIHRm96PwtqkpQiuiA: folds
d1puGuVBE0fidn+5eRJ0tw: raises $4 to $6
B2Ih1sr5VZk+8He7rcrMtQ: folds
d1puGuVBE0fidn+5eRJ0tw collected $4 from pot
d1puGuVBE0fidn+5eRJ0tw: doesn't show hand
*** SUMMARY ***
Total pot $4 | Rake $0
Seat 2: dZcLsEI8iXkobBduRJ45Yw folded before Flop (didn't bet)
Seat 4: 4dcDwIHRm96PwtqkpQiuiA (button) folded before Flop (didn't bet)
Seat 5: d1puGuVBE0fidn+5eRJ0tw (small blind) collected ($4)
Seat 6: B2Ih1sr5VZk+8He7rcrMtQ (big blind) folded before Flop



PokerStars Game #59940734814:  Hold'em No Limit ($1/$2) - 2009/07/01 1:15:03 ET
Table 'CFkQcfWjKccZaZDf71FK+w' 6-max Seat #4 is the button
Seat 1: JsC+WvfzqlxVs9G8/gSQAQ ($142.20 in chips)
Seat 2: ewN/vzF22+/gdzjIKBOlkA ($200 in chips)
Seat 3: 09BNF4quPDzanQzM8vc6WA ($36 in chips)
Seat 4: ygTTt5ehT4aF86q1a8/R+w ($160.10 in chips)
Seat 5: 2lOU1DcvUZaMcxZ95XfzXw ($74 in chips)
Seat 6: ORVqY3rf9X6ANA/8s+On2Q ($80.75 in chips)
2lOU1DcvUZaMcxZ95XfzXw: posts small blind $1
ORVqY3rf9X6ANA/8s+On2Q: posts big blind $2
*** HOLE CARDS ***
JsC+WvfzqlxVs9G8/gSQAQ: folds
ewN/vzF22+/gdzjIKBOlkA: raises $4 to $6
09BNF4quPDzanQzM8vc6WA: folds
ygTTt5ehT4aF86q1a8/R+w: folds
2lOU1DcvUZaMcxZ95XfzXw: folds
ORVqY3rf9X6ANA/8s+On2Q: calls $4
*** FLOP *** [4s 6h Td]
ORVqY3rf9X6ANA/8s+On2Q: bets $2
ewN/vzF22+/gdzjIKBOlkA: raises $6 to $8
ORVqY3rf9X6ANA/8s+On2Q: calls $6
*** TURN *** [4s 6h Td] [9h]
ORVqY3rf9X6ANA/8s+On2Q: checks
ewN/vzF22+/gdzjIKBOlkA: checks
*** RIVER *** [4s 6h Td 9h] [5d]
ORVqY3rf9X6ANA/8s+On2Q: checks
ewN/vzF22+/gdzjIKBOlkA: checks
*** SHOW DOWN ***
ORVqY3rf9X6ANA/8s+On2Q: shows [5s Jd] (a pair of Fives)
ewN/vzF22+/gdzjIKBOlkA: shows [7h 7s] (a pair of Sevens)
ewN/vzF22+/gdzjIKBOlkA collected $27.60 from pot
*** SUMMARY ***
Total pot $29 | Rake $1.40
Board [4s 6h Td 9h 5d]
Seat 1: JsC+WvfzqlxVs9G8/gSQAQ folded before Flop (didn't bet)
Seat 2: ewN/vzF22+/gdzjIKBOlkA showed [7h 7s] and won ($27.60) with a pair of Sevens
Seat 3: 09BNF4quPDzanQzM8vc6WA folded before Flop (didn't bet)
Seat 4: ygTTt5ehT4aF86q1a8/R+w (button) folded before Flop (didn't bet)
Seat 5: 2lOU1DcvUZaMcxZ95XfzXw (small blind) folded before Flop
Seat 6: ORVqY3rf9X6ANA/8s+On2Q (big blind) showed [5s Jd] and lost with a pair of Fives



PokerStars Game #59940734440:  Hold'em No Limit ($1/$2) - 2009/07/01 1:15:03 ET
Table 'P/yCfYl1GfGsu/e6DxDy/A' 2-max Seat #1 is the button
Seat 1: 7fOCUy3x9hdkmXkkDNolGQ ($570 in chips)
Seat 2: RwDoM55ZeQuI2ADyJhOb2Q ($921.50 in chips)
7fOCUy3x9hdkmXkkDNolGQ: posts small blind $1
RwDoM55ZeQuI2ADyJhOb2Q: posts big blind $2
*** HOLE CARDS ***
7fOCUy3x9hdkmXkkDNolGQ: raises $4 to $6
RwDoM55ZeQuI2ADyJhOb2Q: raises $19 to $25
7fOCUy3x9hdkmXkkDNolGQ: folds
RwDoM55ZeQuI2ADyJhOb2Q collected $12 from pot
RwDoM55ZeQuI2ADyJhOb2Q: doesn't show hand
*** SUMMARY ***
Total pot $12 | Rake $0
Seat 1: 7fOCUy3x9hdkmXkkDNolGQ (button) (small blind) folded before Flop
Seat 2: RwDoM55ZeQuI2ADyJhOb2Q (big blind) collected ($12)



PokerStars Game #59940736538:  Hold'em No Limit ($1/$2) - 2009/07/01 1:15:06 ET
Table 'jlrIxbrVIG+gjaUYT4za8g' 6-max Seat #5 is the button
Seat 1: ygTTt5ehT4aF86q1a8/R+w ($221.90 in chips)
Seat 2: N18PrNGQj43J7TJuQuu+tw ($93.40 in chips)
Seat 3: 342gZYfwWuuNOnZaoysV6A ($40 in chips)
Seat 4: 8srN1dKQePlsv0GyTada+Q ($307.10 in chips)
Seat 5: AyBB0k3Dcl7xbXUeGMw06g ($67.20 in chips)
Seat 6: vkfxu8f/jMYKUk6Ly4eujw ($241.75 in chips)
vkfxu8f/jMYKUk6Ly4eujw: posts small blind $1
ygTTt5ehT4aF86q1a8/R+w: posts big blind $2
*** HOLE CARDS ***
N18PrNGQj43J7TJuQuu+tw: calls $2
342gZYfwWuuNOnZaoysV6A: folds
8srN1dKQePlsv0GyTada+Q: raises $6 to $8
AyBB0k3Dcl7xbXUeGMw06g: raises $10 to $18
vkfxu8f/jMYKUk6Ly4eujw: folds
342gZYfwWuuNOnZaoysV6A is sitting out
ygTTt5ehT4aF86q1a8/R+w: folds
N18PrNGQj43J7TJuQuu+tw: folds
8srN1dKQePlsv0GyTada+Q: folds
AyBB0k3Dcl7xbXUeGMw06g collected $21 from pot
*** SUMMARY ***
Total pot $21 | Rake $0
Seat 1: ygTTt5ehT4aF86q1a8/R+w (big blind) folded before Flop
Seat 2: N18PrNGQj43J7TJuQuu+tw folded before Flop
Seat 3: 342gZYfwWuuNOnZaoysV6A folded before Flop (didn't bet)
Seat 4: 8srN1dKQePlsv0GyTada+Q folded before Flop
Seat 5: AyBB0k3Dcl7xbXUeGMw06g (button) collected ($21)
Seat 6: vkfxu8f/jMYKUk6Ly4eujw (small blind) folded before Flop



PokerStars Game #59940737934:  Hold'em No Limit ($1/$2) - 2009/07/01 1:15:09 ET
Table 'C4lkCXY2PWy6z4vsAe5NGQ' 6-max Seat #2 is the button
Seat 1: AuiGltq875lmaKHBsjZVGg ($80.70 in chips)
Seat 2: 6hRJ68JkbJq6MYI9o5bUnQ ($78.40 in chips)
Seat 3: sTPOWERd9HWPCNrDBwsVjA ($242.35 in chips)
Seat 4: VvdR9F3I+2yELkfTVvC1dg ($200 in chips)
Seat 5: dKvrkfQx2Peke3ikZLUy1w ($274.50 in chips)
Seat 6: B87ikIyZ/TzAVeXf38Ny0g ($209.55 in chips)
sTPOWERd9HWPCNrDBwsVjA: posts small blind $1
VvdR9F3I+2yELkfTVvC1dg: posts big blind $2
*** HOLE CARDS ***
dKvrkfQx2Peke3ikZLUy1w: folds
B87ikIyZ/TzAVeXf38Ny0g: raises $4 to $6
AuiGltq875lmaKHBsjZVGg: calls $6
6hRJ68JkbJq6MYI9o5bUnQ: folds
sTPOWERd9HWPCNrDBwsVjA: folds
VvdR9F3I+2yELkfTVvC1dg: folds
*** FLOP *** [2c Ah 7h]
B87ikIyZ/TzAVeXf38Ny0g: checks
AuiGltq875lmaKHBsjZVGg: bets $6
B87ikIyZ/TzAVeXf38Ny0g: raises $12 to $18
AuiGltq875lmaKHBsjZVGg: calls $12
*** TURN *** [2c Ah 7h] [6s]
B87ikIyZ/TzAVeXf38Ny0g: bets $22
AuiGltq875lmaKHBsjZVGg: calls $22
*** RIVER *** [2c Ah 7h 6s] [5c]
B87ikIyZ/TzAVeXf38Ny0g: bets $36
AuiGltq875lmaKHBsjZVGg: calls $34.70 and is all-in
*** SHOW DOWN ***
B87ikIyZ/TzAVeXf38Ny0g: shows [Ac Kd] (a pair of Aces)
AuiGltq875lmaKHBsjZVGg: mucks hand
B87ikIyZ/TzAVeXf38Ny0g collected $161.40 from pot
*** SUMMARY ***
Total pot $164.40 | Rake $3
Board [2c Ah 7h 6s 5c]
Seat 1: AuiGltq875lmaKHBsjZVGg mucked
Seat 2: 6hRJ68JkbJq6MYI9o5bUnQ (button) folded before Flop (didn't bet)
Seat 3: sTPOWERd9HWPCNrDBwsVjA (small blind) folded before Flop
Seat 4: VvdR9F3I+2yELkfTVvC1dg (big blind) folded before Flop
Seat 5: dKvrkfQx2Peke3ikZLUy1w folded before Flop (didn't bet)
Seat 6: B87ikIyZ/TzAVeXf38Ny0g showed [Ac Kd] and won ($161.40) with a pair of Aces



PokerStars Game #59940739512:  Hold'em No Limit ($1/$2) - 2009/07/01 1:15:11 ET
Table 'rKeCh+eBn4RNvybCUYkoTQ' 9-max Seat #5 is the button
Seat 1: /inIs/z/PcX+TniIFpaxpg ($206 in chips)
Seat 2: 9cBHwK40Tl06vheE7B3LHQ ($78.05 in chips)
Seat 3: R9FzbEg1XYsiOty4kvbqhg ($69.20 in chips)
Seat 4: 31HuO+DQxppUQEedBWukug ($98.10 in chips)
Seat 5: WUlHm+ydPPHG7Lb0rePSdA ($120 in chips)
Seat 6: EBV6OktyeSmh4w6sWmcWOw ($271 in chips)
Seat 7: rW/MyplHylMSBRaoRUzWrg ($40 in chips)
Seat 8: pN/Ip0ePsUVIdUlGgLrkUw ($209 in chips)
Seat 9: Kzta8yu9vxHT4B70mjBZ+w ($211.25 in chips)
EBV6OktyeSmh4w6sWmcWOw: posts small blind $1
rW/MyplHylMSBRaoRUzWrg: posts big blind $2
*** HOLE CARDS ***
pN/Ip0ePsUVIdUlGgLrkUw: folds
Kzta8yu9vxHT4B70mjBZ+w: folds
/inIs/z/PcX+TniIFpaxpg: folds
9cBHwK40Tl06vheE7B3LHQ: raises $4 to $6
R9FzbEg1XYsiOty4kvbqhg: folds
31HuO+DQxppUQEedBWukug: folds
WUlHm+ydPPHG7Lb0rePSdA: folds
EBV6OktyeSmh4w6sWmcWOw: folds
rW/MyplHylMSBRaoRUzWrg: folds
9cBHwK40Tl06vheE7B3LHQ collected $5 from pot
9cBHwK40Tl06vheE7B3LHQ: doesn't show hand
*** SUMMARY ***
Total pot $5 | Rake $0
Seat 1: /inIs/z/PcX+TniIFpaxpg folded before Flop (didn't bet)
Seat 2: 9cBHwK40Tl06vheE7B3LHQ collected ($5)
Seat 3: R9FzbEg1XYsiOty4kvbqhg folded before Flop (didn't bet)
Seat 4: 31HuO+DQxppUQEedBWukug folded before Flop (didn't bet)
Seat 5: WUlHm+ydPPHG7Lb0rePSdA (button) folded before Flop (didn't bet)
Seat 6: EBV6OktyeSmh4w6sWmcWOw (small blind) folded before Flop
Seat 7: rW/MyplHylMSBRaoRUzWrg (big blind) folded before Flop
Seat 8: pN/Ip0ePsUVIdUlGgLrkUw folded before Flop (didn't bet)
Seat 9: Kzta8yu9vxHT4B70mjBZ+w folded before Flop (didn't bet)



PokerStars Game #59940741706:  Hold'em No Limit ($1/$2) - 2009/07/01 1:15:15 ET
Table 'mGpP9StWRnoeiBDExc6Frg' 6-max Seat #5 is the button
Seat 1: VvdR9F3I+2yELkfTVvC1dg ($200 in chips)
Seat 2: dZcLsEI8iXkobBduRJ45Yw ($92 in chips)
Seat 4: 4dcDwIHRm96PwtqkpQiuiA ($40 in chips)
Seat 5: d1puGuVBE0fidn+5eRJ0tw ($230.20 in chips)
Seat 6: B2Ih1sr5VZk+8He7rcrMtQ ($437.35 in chips)
B2Ih1sr5VZk+8He7rcrMtQ: posts small blind $1
VvdR9F3I+2yELkfTVvC1dg: posts big blind $2
7acrZUQC3Zc9BNLjoKIcLQ: sits out
*** HOLE CARDS ***
dZcLsEI8iXkobBduRJ45Yw: raises $4 to $6
4dcDwIHRm96PwtqkpQiuiA: folds
d1puGuVBE0fidn+5eRJ0tw: folds
B2Ih1sr5VZk+8He7rcrMtQ: calls $5
VvdR9F3I+2yELkfTVvC1dg: folds
*** FLOP *** [Jc Th 9h]
B2Ih1sr5VZk+8He7rcrMtQ: checks
dZcLsEI8iXkobBduRJ45Yw: bets $4
B2Ih1sr5VZk+8He7rcrMtQ: calls $4
*** TURN *** [Jc Th 9h] [As]
B2Ih1sr5VZk+8He7rcrMtQ: checks
dZcLsEI8iXkobBduRJ45Yw: bets $12
B2Ih1sr5VZk+8He7rcrMtQ: calls $12
*** RIVER *** [Jc Th 9h As] [4c]
B2Ih1sr5VZk+8He7rcrMtQ: checks
dZcLsEI8iXkobBduRJ45Yw: checks
*** SHOW DOWN ***
B2Ih1sr5VZk+8He7rcrMtQ: shows [Kh Ac] (a pair of Aces)
dZcLsEI8iXkobBduRJ45Yw: mucks hand
B2Ih1sr5VZk+8He7rcrMtQ collected $44 from pot
*** SUMMARY ***
Total pot $46 | Rake $2
Board [Jc Th 9h As 4c]
Seat 1: VvdR9F3I+2yELkfTVvC1dg (big blind) folded before Flop
Seat 2: dZcLsEI8iXkobBduRJ45Yw mucked
Seat 4: 4dcDwIHRm96PwtqkpQiuiA folded before Flop (didn't bet)
Seat 5: d1puGuVBE0fidn+5eRJ0tw (button) folded before Flop (didn't bet)
Seat 6: B2Ih1sr5VZk+8He7rcrMtQ (small blind) showed [Kh Ac] and won ($44) with a pair of Aces



PokerStars Game #59940742518:  Hold'em No Limit ($1/$2) - 2009/07/01 1:15:16 ET
Table 'P/yCfYl1GfGsu/e6DxDy/A' 2-max Seat #2 is the button
Seat 1: 7fOCUy3x9hdkmXkkDNolGQ ($564 in chips)
Seat 2: RwDoM55ZeQuI2ADyJhOb2Q ($927.50 in chips)
RwDoM55ZeQuI2ADyJhOb2Q: posts small blind $1
7fOCUy3x9hdkmXkkDNolGQ: posts big blind $2
*** HOLE CARDS ***
RwDoM55ZeQuI2ADyJhOb2Q: folds
7fOCUy3x9hdkmXkkDNolGQ collected $2 from pot
7fOCUy3x9hdkmXkkDNolGQ: doesn't show hand
*** SUMMARY ***
Total pot $2 | Rake $0
Seat 1: 7fOCUy3x9hdkmXkkDNolGQ (big blind) collected ($2)
Seat 2: RwDoM55ZeQuI2ADyJhOb2Q (button) (small blind) folded before Flop



PokerStars Game #59940743268:  Hold'em No Limit ($1/$2) - 2009/07/01 1:15:18 ET
Table 'LL4bDFyhj5hsMpzaDugJZg' 6-max Seat #5 is the button
Seat 1: FwvID/fQGlpY3soi/lMTww ($65.95 in chips)
Seat 2: IZng3w8jiJHHp3LbYKLi4w ($43.50 in chips)
Seat 3: iI/NMpRxMkGieArQEhACSA ($282.70 in chips)
Seat 4: 8srN1dKQePlsv0GyTada+Q ($314.75 in chips)
Seat 5: A2GTwTiwkb1ilNWgW487Vg ($96.05 in chips)
Seat 6: 692Q4sfB0gTElzS0WMeg+A ($218.10 in chips)
692Q4sfB0gTElzS0WMeg+A: posts small blind $1
FwvID/fQGlpY3soi/lMTww: posts big blind $2
*** HOLE CARDS ***
IZng3w8jiJHHp3LbYKLi4w: folds
iI/NMpRxMkGieArQEhACSA: folds
8srN1dKQePlsv0GyTada+Q: folds
A2GTwTiwkb1ilNWgW487Vg: folds
692Q4sfB0gTElzS0WMeg+A: folds
FwvID/fQGlpY3soi/lMTww collected $2 from pot
*** SUMMARY ***
Total pot $2 | Rake $0
Seat 1: FwvID/fQGlpY3soi/lMTww (big blind) collected ($2)
Seat 2: IZng3w8jiJHHp3LbYKLi4w folded before Flop (didn't bet)
Seat 3: iI/NMpRxMkGieArQEhACSA folded before Flop (didn't bet)
Seat 4: 8srN1dKQePlsv0GyTada+Q folded before Flop (didn't bet)
Seat 5: A2GTwTiwkb1ilNWgW487Vg (button) folded before Flop (didn't bet)
Seat 6: 692Q4sfB0gTElzS0WMeg+A (small blind) folded before Flop



PokerStars Game #59940744616:  Hold'em No Limit ($1/$2) - 2009/07/01 1:15:20 ET
Table 'kq5zaQ+1hLNf8LZfGnbTAA' 6-max Seat #1 is the button
Seat 1: 8srN1dKQePlsv0GyTada+Q ($200 in chips)
Seat 2: nXDI8Y/S6POzRwANu3d8hQ ($42.75 in chips)
Seat 3: vkfxu8f/jMYKUk6Ly4eujw ($222.70 in chips)
Seat 4: 3dAbvkxS5NPQTBAbvpinVg ($200 in chips)
Seat 5: kfASJqTbXek+zc8ZKsZL1Q ($135.35 in chips)
Seat 6: mfy7uGZcqA2PVQqEVbJ7+g ($242.25 in chips)
nXDI8Y/S6POzRwANu3d8hQ: posts small blind $1
vkfxu8f/jMYKUk6Ly4eujw: posts big blind $2
*** HOLE CARDS ***
3dAbvkxS5NPQTBAbvpinVg: folds
kfASJqTbXek+zc8ZKsZL1Q: raises $4 to $6
mfy7uGZcqA2PVQqEVbJ7+g: calls $6
8srN1dKQePlsv0GyTada+Q: raises $13 to $19
nXDI8Y/S6POzRwANu3d8hQ: folds
vkfxu8f/jMYKUk6Ly4eujw: folds
kfASJqTbXek+zc8ZKsZL1Q: folds
mfy7uGZcqA2PVQqEVbJ7+g: calls $13
*** FLOP *** [5d Js 9c]
mfy7uGZcqA2PVQqEVbJ7+g: checks
8srN1dKQePlsv0GyTada+Q: bets $21
mfy7uGZcqA2PVQqEVbJ7+g: calls $21
*** TURN *** [5d Js 9c] [7c]
mfy7uGZcqA2PVQqEVbJ7+g: checks
8srN1dKQePlsv0GyTada+Q: bets $48
mfy7uGZcqA2PVQqEVbJ7+g: folds
8srN1dKQePlsv0GyTada+Q collected $86 from pot
8srN1dKQePlsv0GyTada+Q: doesn't show hand
*** SUMMARY ***
Total pot $89 | Rake $3
Board [5d Js 9c 7c]
Seat 1: 8srN1dKQePlsv0GyTada+Q (button) collected ($86)
Seat 2: nXDI8Y/S6POzRwANu3d8hQ (small blind) folded before Flop
Seat 3: vkfxu8f/jMYKUk6Ly4eujw (big blind) folded before Flop
Seat 4: 3dAbvkxS5NPQTBAbvpinVg folded before Flop (didn't bet)
Seat 5: kfASJqTbXek+zc8ZKsZL1Q folded before Flop
Seat 6: mfy7uGZcqA2PVQqEVbJ7+g folded on the Turn



PokerStars Game #59940744552:  Hold'em No Limit ($1/$2) - 2009/07/01 1:15:20 ET
Table 'ztv6V3FN2bQ9nmJPPdx6nQ' 6-max Seat #2 is the button
Seat 2: 5Y+ZGWLI4gnlpApDX5vy1A ($460.85 in chips)
Seat 4: UaZ5yj+6LjtWqMQg2QskUw ($116.80 in chips)
Seat 5: sTPOWERd9HWPCNrDBwsVjA ($200 in chips)
Seat 6: mfy7uGZcqA2PVQqEVbJ7+g ($112.45 in chips)
342gZYfwWuuNOnZaoysV6A will be allowed to play after the button
UaZ5yj+6LjtWqMQg2QskUw: posts small blind $1
sTPOWERd9HWPCNrDBwsVjA: posts big blind $2
*** HOLE CARDS ***
mfy7uGZcqA2PVQqEVbJ7+g: raises $4 to $6
5Y+ZGWLI4gnlpApDX5vy1A: folds
342gZYfwWuuNOnZaoysV6A is sitting out
UaZ5yj+6LjtWqMQg2QskUw: folds
sTPOWERd9HWPCNrDBwsVjA: folds
mfy7uGZcqA2PVQqEVbJ7+g collected $5 from pot
mfy7uGZcqA2PVQqEVbJ7+g: doesn't show hand
*** SUMMARY ***
Total pot $5 | Rake $0
Seat 2: 5Y+ZGWLI4gnlpApDX5vy1A (button) folded before Flop (didn't bet)
Seat 4: UaZ5yj+6LjtWqMQg2QskUw (small blind) folded before Flop
Seat 5: sTPOWERd9HWPCNrDBwsVjA (big blind) folded before Flop
Seat 6: mfy7uGZcqA2PVQqEVbJ7+g collected ($5)



PokerStars Game #59940744862:  Hold'em No Limit ($1/$2) - 2009/07/01 1:15:21 ET
Table '8Y6PEyoNuepZTai2Q56aHw' 9-max Seat #9 is the button
Seat 1: 5Q8U6iZbeO7xJSS4qvDP5g ($273 in chips)
Seat 2: gDCJIAlovbPnTvMM7Dd1gA ($183.35 in chips)
Seat 3: WUlHm+ydPPHG7Lb0rePSdA ($120 in chips)
Seat 4: xKkwALG38OfLQ9DXuJgR1w ($264 in chips)
Seat 5: QHxJjpVYwitg9krW6wZgJA ($259.65 in chips)
Seat 6: NtLDBSjsJQEKekh5cdinvw ($353.80 in chips)
Seat 7: Kzta8yu9vxHT4B70mjBZ+w ($200 in chips)
Seat 8: rW/MyplHylMSBRaoRUzWrg ($40 in chips)
Seat 9: F7m34OOfAQ7annesMHVjKw ($122.80 in chips)
5Q8U6iZbeO7xJSS4qvDP5g: posts small blind $1
gDCJIAlovbPnTvMM7Dd1gA: posts big blind $2
*** HOLE CARDS ***
WUlHm+ydPPHG7Lb0rePSdA: folds
xKkwALG38OfLQ9DXuJgR1w: raises $4 to $6
QHxJjpVYwitg9krW6wZgJA: folds
NtLDBSjsJQEKekh5cdinvw: folds
Kzta8yu9vxHT4B70mjBZ+w: folds
rW/MyplHylMSBRaoRUzWrg: folds
F7m34OOfAQ7annesMHVjKw: calls $6
5Q8U6iZbeO7xJSS4qvDP5g: folds
gDCJIAlovbPnTvMM7Dd1gA: folds
*** FLOP *** [9s 9c 2d]
xKkwALG38OfLQ9DXuJgR1w: checks
F7m34OOfAQ7annesMHVjKw has timed out
F7m34OOfAQ7annesMHVjKw: checks
*** TURN *** [9s 9c 2d] [3c]
xKkwALG38OfLQ9DXuJgR1w: bets $4
F7m34OOfAQ7annesMHVjKw: calls $4
*** RIVER *** [9s 9c 2d 3c] [As]
xKkwALG38OfLQ9DXuJgR1w: bets $14
F7m34OOfAQ7annesMHVjKw: calls $14
*** SHOW DOWN ***
xKkwALG38OfLQ9DXuJgR1w: shows [Kd 9d] (three of a kind, Nines)
F7m34OOfAQ7annesMHVjKw: mucks hand
xKkwALG38OfLQ9DXuJgR1w collected $48.55 from pot
*** SUMMARY ***
Total pot $51 | Rake $2.45
Board [9s 9c 2d 3c As]
Seat 1: 5Q8U6iZbeO7xJSS4qvDP5g (small blind) folded before Flop
Seat 2: gDCJIAlovbPnTvMM7Dd1gA (big blind) folded before Flop
Seat 3: WUlHm+ydPPHG7Lb0rePSdA folded before Flop (didn't bet)
Seat 4: xKkwALG38OfLQ9DXuJgR1w showed [Kd 9d] and won ($48.55) with three of a kind, Nines
Seat 5: QHxJjpVYwitg9krW6wZgJA folded before Flop (didn't bet)
Seat 6: NtLDBSjsJQEKekh5cdinvw folded before Flop (didn't bet)
Seat 7: Kzta8yu9vxHT4B70mjBZ+w folded before Flop (didn't bet)
Seat 8: rW/MyplHylMSBRaoRUzWrg folded before Flop (didn't bet)
Seat 9: F7m34OOfAQ7annesMHVjKw (button) mucked



PokerStars Game #59940746480:  Hold'em No Limit ($1/$2) - 2009/07/01 1:15:23 ET
Table 'YqGfR5eHfMeSjb9a+QU9rg' 9-max Seat #2 is the button
Seat 1: rW/MyplHylMSBRaoRUzWrg ($37 in chips)
Seat 2: W3Nqt1GWlTi9tXQXMNEvgw ($388.70 in chips)
Seat 3: /gll27k+xWYV7Fbki0lFDQ ($264.75 in chips)
Seat 4: QHxJjpVYwitg9krW6wZgJA ($208.15 in chips)
Seat 5: CkE3IyJF1KvdaAOmZY5XqQ ($200 in chips)
Seat 6: Fk6evwGYxWHokjvmdiD+6A ($73.35 in chips)
Seat 7: 41aZuLBz9nAi2GPVKabmCw ($123.75 in chips)
Seat 8: JnV3SM2D6dAFYyGZHHpvrg ($77.70 in chips)
Seat 9: /inIs/z/PcX+TniIFpaxpg ($206.05 in chips)
/gll27k+xWYV7Fbki0lFDQ: posts small blind $1
QHxJjpVYwitg9krW6wZgJA: posts big blind $2
*** HOLE CARDS ***
CkE3IyJF1KvdaAOmZY5XqQ: folds
Fk6evwGYxWHokjvmdiD+6A: folds
41aZuLBz9nAi2GPVKabmCw: calls $2
JnV3SM2D6dAFYyGZHHpvrg: folds
/inIs/z/PcX+TniIFpaxpg: folds
rW/MyplHylMSBRaoRUzWrg: folds
W3Nqt1GWlTi9tXQXMNEvgw: calls $2
/gll27k+xWYV7Fbki0lFDQ: calls $1
QHxJjpVYwitg9krW6wZgJA: checks
*** FLOP *** [5s 7d As]
/gll27k+xWYV7Fbki0lFDQ: checks
QHxJjpVYwitg9krW6wZgJA: checks
41aZuLBz9nAi2GPVKabmCw: checks
W3Nqt1GWlTi9tXQXMNEvgw: bets $2
/gll27k+xWYV7Fbki0lFDQ: calls $2
QHxJjpVYwitg9krW6wZgJA: folds
41aZuLBz9nAi2GPVKabmCw: calls $2
*** TURN *** [5s 7d As] [Qh]
/gll27k+xWYV7Fbki0lFDQ: checks
41aZuLBz9nAi2GPVKabmCw: checks
W3Nqt1GWlTi9tXQXMNEvgw: checks
*** RIVER *** [5s 7d As Qh] [Js]
/gll27k+xWYV7Fbki0lFDQ: checks
41aZuLBz9nAi2GPVKabmCw: checks
W3Nqt1GWlTi9tXQXMNEvgw: checks
*** SHOW DOWN ***
/gll27k+xWYV7Fbki0lFDQ: shows [Qs 3s] (a flush, Ace high)
41aZuLBz9nAi2GPVKabmCw: mucks hand
W3Nqt1GWlTi9tXQXMNEvgw: mucks hand
/gll27k+xWYV7Fbki0lFDQ collected $13.35 from pot
*** SUMMARY ***
Total pot $14 | Rake $0.65
Board [5s 7d As Qh Js]
Seat 1: rW/MyplHylMSBRaoRUzWrg folded before Flop (didn't bet)
Seat 2: W3Nqt1GWlTi9tXQXMNEvgw (button) mucked
Seat 3: /gll27k+xWYV7Fbki0lFDQ (small blind) showed [Qs 3s] and won ($13.35) with a flush, Ace high
Seat 4: QHxJjpVYwitg9krW6wZgJA (big blind) folded on the Flop
Seat 5: CkE3IyJF1KvdaAOmZY5XqQ folded before Flop (didn't bet)
Seat 6: Fk6evwGYxWHokjvmdiD+6A folded before Flop (didn't bet)
Seat 7: 41aZuLBz9nAi2GPVKabmCw mucked
Seat 8: JnV3SM2D6dAFYyGZHHpvrg folded before Flop (didn't bet)
Seat 9: /inIs/z/PcX+TniIFpaxpg folded before Flop (didn't bet)



PokerStars Game #59940746378:  Hold'em No Limit ($1/$2) - 2009/07/01 1:15:23 ET
Table 'gnHBqWll9O3fxG7Ojkz/ng' 9-max Seat #3 is the button
Seat 2: H6Z4+qu8gR0VUiPOijndVg ($333.25 in chips)
Seat 3: 5Q8U6iZbeO7xJSS4qvDP5g ($218 in chips)
Seat 5: rBQDMkKm9cZn6M9NPsiVew ($240.45 in chips)
Seat 6: /inIs/z/PcX+TniIFpaxpg ($21 in chips)
Seat 7: jqui3xAWCkcdPW36a6BD+w ($344.40 in chips)
Seat 8: cM6efHzdxoqYm0EQKP4TTQ ($103.30 in chips)
Seat 9: sN6yR5I5zFq/WFyIz5UfzQ ($201 in chips)
rBQDMkKm9cZn6M9NPsiVew: posts small blind $1
/inIs/z/PcX+TniIFpaxpg: posts big blind $2
TAfo4veNRaRlzDXMMYS3Jg: sits out
*** HOLE CARDS ***
jqui3xAWCkcdPW36a6BD+w: folds
cM6efHzdxoqYm0EQKP4TTQ: folds
sN6yR5I5zFq/WFyIz5UfzQ: raises $4 to $6
H6Z4+qu8gR0VUiPOijndVg: folds
5Q8U6iZbeO7xJSS4qvDP5g: folds
rBQDMkKm9cZn6M9NPsiVew: folds
/inIs/z/PcX+TniIFpaxpg: folds
sN6yR5I5zFq/WFyIz5UfzQ collected $5 from pot
*** SUMMARY ***
Total pot $5 | Rake $0
Seat 2: H6Z4+qu8gR0VUiPOijndVg folded before Flop (didn't bet)
Seat 3: 5Q8U6iZbeO7xJSS4qvDP5g (button) folded before Flop (didn't bet)
Seat 5: rBQDMkKm9cZn6M9NPsiVew (small blind) folded before Flop
Seat 6: /inIs/z/PcX+TniIFpaxpg (big blind) folded before Flop
Seat 7: jqui3xAWCkcdPW36a6BD+w folded before Flop (didn't bet)
Seat 8: cM6efHzdxoqYm0EQKP4TTQ folded before Flop (didn't bet)
Seat 9: sN6yR5I5zFq/WFyIz5UfzQ collected ($5)



PokerStars Game #59940748362:  Hold'em No Limit ($1/$2) - 2009/07/01 1:15:26 ET
Table 'P/yCfYl1GfGsu/e6DxDy/A' 2-max Seat #1 is the button
Seat 1: 7fOCUy3x9hdkmXkkDNolGQ ($565 in chips)
Seat 2: RwDoM55ZeQuI2ADyJhOb2Q ($926.50 in chips)
7fOCUy3x9hdkmXkkDNolGQ: posts small blind $1
RwDoM55ZeQuI2ADyJhOb2Q: posts big blind $2
*** HOLE CARDS ***
7fOCUy3x9hdkmXkkDNolGQ: raises $4 to $6
RwDoM55ZeQuI2ADyJhOb2Q: raises $12 to $18
7fOCUy3x9hdkmXkkDNolGQ: calls $12
*** FLOP *** [6h Kc 3h]
RwDoM55ZeQuI2ADyJhOb2Q: bets $22
7fOCUy3x9hdkmXkkDNolGQ: calls $22
*** TURN *** [6h Kc 3h] [Kh]
RwDoM55ZeQuI2ADyJhOb2Q: checks
7fOCUy3x9hdkmXkkDNolGQ: bets $49
RwDoM55ZeQuI2ADyJhOb2Q: folds
7fOCUy3x9hdkmXkkDNolGQ collected $79.50 from pot
7fOCUy3x9hdkmXkkDNolGQ: doesn't show hand
*** SUMMARY ***
Total pot $80 | Rake $0.50
Board [6h Kc 3h Kh]
Seat 1: 7fOCUy3x9hdkmXkkDNolGQ (button) (small blind) collected ($79.50)
Seat 2: RwDoM55ZeQuI2ADyJhOb2Q (big blind) folded on the Turn



PokerStars Game #59940748622:  Hold'em No Limit ($1/$2) - 2009/07/01 1:15:27 ET
Table 'SF49/KQm8T4taMp6kb+HXA' 9-max Seat #4 is the button
Seat 1: CUZwDpLTQKhzarPe+JCLOQ ($200 in chips)
Seat 2: rW/MyplHylMSBRaoRUzWrg ($36 in chips)
Seat 3: pCmk6FpSOLJ+85o1tLHIag ($253.05 in chips)
Seat 4: HffgoYm61KgkdMe/DYChIQ ($212.40 in chips)
Seat 5: ri8CLkX3e9JF34dQNbsHGA ($40 in chips)
Seat 6: 31HuO+DQxppUQEedBWukug ($307.95 in chips)
Seat 7: n2VAbLaE5qgKr5mA4W6v4w ($149.70 in chips)
Seat 8: GgrYze3jkUdSO7a7CuJGDw ($183 in chips)
Seat 9: /inIs/z/PcX+TniIFpaxpg ($326.15 in chips)
ri8CLkX3e9JF34dQNbsHGA: posts small blind $1
31HuO+DQxppUQEedBWukug: posts big blind $2
*** HOLE CARDS ***
n2VAbLaE5qgKr5mA4W6v4w: raises $2.70 to $4.70
GgrYze3jkUdSO7a7CuJGDw: folds
/inIs/z/PcX+TniIFpaxpg: folds
CUZwDpLTQKhzarPe+JCLOQ: folds
rW/MyplHylMSBRaoRUzWrg: folds
pCmk6FpSOLJ+85o1tLHIag: calls $4.70
HffgoYm61KgkdMe/DYChIQ is disconnected
HffgoYm61KgkdMe/DYChIQ has timed out while disconnected
HffgoYm61KgkdMe/DYChIQ: folds
HffgoYm61KgkdMe/DYChIQ is sitting out
ri8CLkX3e9JF34dQNbsHGA: folds
31HuO+DQxppUQEedBWukug: folds
*** FLOP *** [6d 2d 4c]
n2VAbLaE5qgKr5mA4W6v4w: bets $8
pCmk6FpSOLJ+85o1tLHIag: calls $8
*** TURN *** [6d 2d 4c] [2s]
n2VAbLaE5qgKr5mA4W6v4w: bets $10
pCmk6FpSOLJ+85o1tLHIag: calls $10
*** RIVER *** [6d 2d 4c 2s] [Kc]
n2VAbLaE5qgKr5mA4W6v4w: bets $10
pCmk6FpSOLJ+85o1tLHIag: calls $10
*** SHOW DOWN ***
n2VAbLaE5qgKr5mA4W6v4w: shows [9h 9c] (two pair, Nines and Deuces)
pCmk6FpSOLJ+85o1tLHIag: shows [Ts Td] (two pair, Tens and Deuces)
pCmk6FpSOLJ+85o1tLHIag collected $65.40 from pot
*** SUMMARY ***
Total pot $68.40 | Rake $3
Board [6d 2d 4c 2s Kc]
Seat 1: CUZwDpLTQKhzarPe+JCLOQ folded before Flop (didn't bet)
Seat 2: rW/MyplHylMSBRaoRUzWrg folded before Flop (didn't bet)
Seat 3: pCmk6FpSOLJ+85o1tLHIag showed [Ts Td] and won ($65.40) with two pair, Tens and Deuces
Seat 4: HffgoYm61KgkdMe/DYChIQ (button) folded before Flop (didn't bet)
Seat 5: ri8CLkX3e9JF34dQNbsHGA (small blind) folded before Flop
Seat 6: 31HuO+DQxppUQEedBWukug (big blind) folded before Flop
Seat 7: n2VAbLaE5qgKr5mA4W6v4w showed [9h 9c] and lost with two pair, Nines and Deuces
Seat 8: GgrYze3jkUdSO7a7CuJGDw folded before Flop (didn't bet)
Seat 9: /inIs/z/PcX+TniIFpaxpg folded before Flop (didn't bet)



PokerStars Game #59940748916:  Hold'em No Limit ($1/$2) - 2009/07/01 1:15:27 ET
Table 'QxerF7GUfCbl+4a8XaTB2w' 6-max Seat #6 is the button
Seat 1: o9jamqIi6sTTRSqudgboRA ($296.50 in chips)
Seat 2: vkfxu8f/jMYKUk6Ly4eujw ($201.80 in chips)
Seat 3: m7mYVfnCOK5TE/VkN/FhOg ($240.70 in chips)
Seat 4: 09BNF4quPDzanQzM8vc6WA ($39 in chips)
Seat 5: YsLQ3BAvgQHWXMAv3Wv6Hg ($200 in chips)
Seat 6: VvdR9F3I+2yELkfTVvC1dg ($214.55 in chips)
o9jamqIi6sTTRSqudgboRA: posts small blind $1
vkfxu8f/jMYKUk6Ly4eujw: posts big blind $2
*** HOLE CARDS ***
m7mYVfnCOK5TE/VkN/FhOg: folds
09BNF4quPDzanQzM8vc6WA: raises $2 to $4
YsLQ3BAvgQHWXMAv3Wv6Hg: folds
VvdR9F3I+2yELkfTVvC1dg: folds
o9jamqIi6sTTRSqudgboRA: folds
vkfxu8f/jMYKUk6Ly4eujw: calls $2
*** FLOP *** [8c Kd Jc]
vkfxu8f/jMYKUk6Ly4eujw: checks
09BNF4quPDzanQzM8vc6WA: checks
*** TURN *** [8c Kd Jc] [5c]
vkfxu8f/jMYKUk6Ly4eujw: checks
09BNF4quPDzanQzM8vc6WA: checks
*** RIVER *** [8c Kd Jc 5c] [Kh]
vkfxu8f/jMYKUk6Ly4eujw: checks
09BNF4quPDzanQzM8vc6WA: checks
*** SHOW DOWN ***
vkfxu8f/jMYKUk6Ly4eujw: shows [6h Ah] (a pair of Kings)
09BNF4quPDzanQzM8vc6WA: shows [Js Ts] (two pair, Kings and Jacks)
09BNF4quPDzanQzM8vc6WA collected $8.55 from pot
*** SUMMARY ***
Total pot $9 | Rake $0.45
Board [8c Kd Jc 5c Kh]
Seat 1: o9jamqIi6sTTRSqudgboRA (small blind) folded before Flop
Seat 2: vkfxu8f/jMYKUk6Ly4eujw (big blind) showed [6h Ah] and lost with a pair of Kings
Seat 3: m7mYVfnCOK5TE/VkN/FhOg folded before Flop (didn't bet)
Seat 4: 09BNF4quPDzanQzM8vc6WA showed [Js Ts] and won ($8.55) with two pair, Kings and Jacks
Seat 5: YsLQ3BAvgQHWXMAv3Wv6Hg folded before Flop (didn't bet)
Seat 6: VvdR9F3I+2yELkfTVvC1dg (button) folded before Flop (didn't bet)



PokerStars Game #59940749346:  Hold'em No Limit ($1/$2) - 2009/07/01 1:15:28 ET
Table 'pPQgcj9XT9CHBsbo1WTBug' 6-max Seat #5 is the button
Seat 1: DFVYDA6dKQy7R7mGIKogZA ($151.60 in chips)
Seat 2: qXDd0ZyMIse0OBu8pxeQ3Q ($200 in chips)
Seat 3: WfaZs12BkYO+BUX5VWpuWQ ($24.85 in chips)
Seat 4: gqlysXCbT8V54f/1lf9h3A ($42 in chips)
Seat 5: vkfxu8f/jMYKUk6Ly4eujw ($216.05 in chips)
Seat 6: Yr7pZltpy3IUNdKS9PCEiw ($286.90 in chips)
Yr7pZltpy3IUNdKS9PCEiw: posts small blind $1
DFVYDA6dKQy7R7mGIKogZA: posts big blind $2
*** HOLE CARDS ***
qXDd0ZyMIse0OBu8pxeQ3Q: raises $5 to $7
WfaZs12BkYO+BUX5VWpuWQ: folds
gqlysXCbT8V54f/1lf9h3A: folds
vkfxu8f/jMYKUk6Ly4eujw: folds
Yr7pZltpy3IUNdKS9PCEiw: calls $6
DFVYDA6dKQy7R7mGIKogZA: calls $5
*** FLOP *** [Ks 4s 4c]
Yr7pZltpy3IUNdKS9PCEiw: checks
DFVYDA6dKQy7R7mGIKogZA: checks
qXDd0ZyMIse0OBu8pxeQ3Q: bets $14
Yr7pZltpy3IUNdKS9PCEiw: folds
DFVYDA6dKQy7R7mGIKogZA: folds
qXDd0ZyMIse0OBu8pxeQ3Q collected $19.95 from pot
*** SUMMARY ***
Total pot $21 | Rake $1.05
Board [Ks 4s 4c]
Seat 1: DFVYDA6dKQy7R7mGIKogZA (big blind) folded on the Flop
Seat 2: qXDd0ZyMIse0OBu8pxeQ3Q collected ($19.95)
Seat 3: WfaZs12BkYO+BUX5VWpuWQ folded before Flop (didn't bet)
Seat 4: gqlysXCbT8V54f/1lf9h3A folded before Flop (didn't bet)
Seat 5: vkfxu8f/jMYKUk6Ly4eujw (button) folded before Flop (didn't bet)
Seat 6: Yr7pZltpy3IUNdKS9PCEiw (small blind) folded on the Flop



PokerStars Game #59940749010:  Hold'em No Limit ($1/$2) - 2009/07/01 1:15:28 ET
Table '/dyk+YdRGv90j2box35j8w' 6-max Seat #6 is the button
Seat 1: 8srN1dKQePlsv0GyTada+Q ($200 in chips)
Seat 2: qCnEYuAE5y5A7bk6fO5/jQ ($484.95 in chips)
Seat 3: sTPOWERd9HWPCNrDBwsVjA ($231.50 in chips)
Seat 4: z/u1YTnkiIDrtp/2cA2dBg ($125.65 in chips)
Seat 5: VvdR9F3I+2yELkfTVvC1dg ($200 in chips)
Seat 6: ZwvXzkkZ3XpMhKfAmVpahw ($355.75 in chips)
8srN1dKQePlsv0GyTada+Q: posts small blind $1
qCnEYuAE5y5A7bk6fO5/jQ: posts big blind $2
*** HOLE CARDS ***
sTPOWERd9HWPCNrDBwsVjA: folds
z/u1YTnkiIDrtp/2cA2dBg: folds
VvdR9F3I+2yELkfTVvC1dg: raises $2 to $4
ZwvXzkkZ3XpMhKfAmVpahw: calls $4
8srN1dKQePlsv0GyTada+Q: folds
qCnEYuAE5y5A7bk6fO5/jQ: folds
*** FLOP *** [6c Ks Jc]
VvdR9F3I+2yELkfTVvC1dg: bets $7.80
ZwvXzkkZ3XpMhKfAmVpahw: raises $16.20 to $24
VvdR9F3I+2yELkfTVvC1dg: folds
ZwvXzkkZ3XpMhKfAmVpahw collected $25.30 from pot
ZwvXzkkZ3XpMhKfAmVpahw: doesn't show hand
*** SUMMARY ***
Total pot $26.60 | Rake $1.30
Board [6c Ks Jc]
Seat 1: 8srN1dKQePlsv0GyTada+Q (small blind) folded before Flop
Seat 2: qCnEYuAE5y5A7bk6fO5/jQ (big blind) folded before Flop
Seat 3: sTPOWERd9HWPCNrDBwsVjA folded before Flop (didn't bet)
Seat 4: z/u1YTnkiIDrtp/2cA2dBg folded before Flop (didn't bet)
Seat 5: VvdR9F3I+2yELkfTVvC1dg folded on the Flop
Seat 6: ZwvXzkkZ3XpMhKfAmVpahw (button) collected ($25.30)



PokerStars Game #59940749086:  Hold'em No Limit ($1/$2) - 2009/07/01 1:15:28 ET
Table '3WCXyaiCAbqSShQu7FIjvA' 9-max Seat #8 is the button
Seat 1: kTCkABD1UUldS9DFRGfCwQ ($118.60 in chips)
Seat 2: 1zQMh8lHgW3t2YhVeA+09A ($17.25 in chips)
Seat 3: 5Q8U6iZbeO7xJSS4qvDP5g ($200 in chips)
Seat 4: waEF/+pxZTxNo4FvsORuXg ($89 in chips)
Seat 5: CkE3IyJF1KvdaAOmZY5XqQ ($200 in chips)
Seat 6: 5jQlngvMSqM/WoonOcR5kw ($344.35 in chips)
Seat 7: QHxJjpVYwitg9krW6wZgJA ($200 in chips)
Seat 8: 1CtiZuXDFaJL1dJPQKyi8Q ($240.25 in chips)
Seat 9: FiXPLJyqb24l32QST2TInw ($98.60 in chips)
FiXPLJyqb24l32QST2TInw: posts small blind $1
kTCkABD1UUldS9DFRGfCwQ: posts big blind $2
waEF/+pxZTxNo4FvsORuXg: posts small & big blinds $3
*** HOLE CARDS ***
1zQMh8lHgW3t2YhVeA+09A: calls $2
5Q8U6iZbeO7xJSS4qvDP5g: folds
waEF/+pxZTxNo4FvsORuXg: checks
CkE3IyJF1KvdaAOmZY5XqQ: folds
5jQlngvMSqM/WoonOcR5kw: folds
QHxJjpVYwitg9krW6wZgJA: folds
1CtiZuXDFaJL1dJPQKyi8Q: folds
FiXPLJyqb24l32QST2TInw: calls $1
kTCkABD1UUldS9DFRGfCwQ: checks
*** FLOP *** [9s Qd Ah]
FiXPLJyqb24l32QST2TInw: checks
kTCkABD1UUldS9DFRGfCwQ: checks
1zQMh8lHgW3t2YhVeA+09A: bets $6
waEF/+pxZTxNo4FvsORuXg: folds
FiXPLJyqb24l32QST2TInw: folds
kTCkABD1UUldS9DFRGfCwQ: folds
1zQMh8lHgW3t2YhVeA+09A collected $8.55 from pot
1zQMh8lHgW3t2YhVeA+09A: doesn't show hand
*** SUMMARY ***
Total pot $9 | Rake $0.45
Board [9s Qd Ah]
Seat 1: kTCkABD1UUldS9DFRGfCwQ (big blind) folded on the Flop
Seat 2: 1zQMh8lHgW3t2YhVeA+09A collected ($8.55)
Seat 3: 5Q8U6iZbeO7xJSS4qvDP5g folded before Flop (didn't bet)
Seat 4: waEF/+pxZTxNo4FvsORuXg folded on the Flop
Seat 5: CkE3IyJF1KvdaAOmZY5XqQ folded before Flop (didn't bet)
Seat 6: 5jQlngvMSqM/WoonOcR5kw folded before Flop (didn't bet)
Seat 7: QHxJjpVYwitg9krW6wZgJA folded before Flop (didn't bet)
Seat 8: 1CtiZuXDFaJL1dJPQKyi8Q (button) folded before Flop (didn't bet)
Seat 9: FiXPLJyqb24l32QST2TInw (small blind) folded on the Flop



PokerStars Game #59940749646:  Hold'em No Limit ($1/$2) - 2009/07/01 1:15:29 ET
Table 'NmY84NAf9Mh0ckAckHnh5g' 2-max Seat #2 is the button
Seat 1: 6hvg964TSqZ3AL/0XK9aVQ ($258.30 in chips)
Seat 2: RwDoM55ZeQuI2ADyJhOb2Q ($554.50 in chips)
RwDoM55ZeQuI2ADyJhOb2Q: posts small blind $1
6hvg964TSqZ3AL/0XK9aVQ: posts big blind $2
*** HOLE CARDS ***
RwDoM55ZeQuI2ADyJhOb2Q: raises $4 to $6
6hvg964TSqZ3AL/0XK9aVQ: folds
RwDoM55ZeQuI2ADyJhOb2Q collected $4 from pot
RwDoM55ZeQuI2ADyJhOb2Q: doesn't show hand
*** SUMMARY ***
Total pot $4 | Rake $0
Seat 1: 6hvg964TSqZ3AL/0XK9aVQ (big blind) folded before Flop
Seat 2: RwDoM55ZeQuI2ADyJhOb2Q (button) (small blind) collected ($4)



PokerStars Game #59940750124:  Hold'em No Limit ($1/$2) - 2009/07/01 1:15:30 ET
Table 'qVXak+oTeDXMGbWa4sDU5Q' 9-max Seat #8 is the button
Seat 1: H6Z4+qu8gR0VUiPOijndVg ($252.55 in chips)
Seat 3: WUlHm+ydPPHG7Lb0rePSdA ($169.65 in chips)
Seat 4: lQYT23h5QCUVZAKxjOO39Q ($106.25 in chips)
Seat 5: FWGiDqRwvLeKmHq9t4Jy9w ($268 in chips)
Seat 6: GX1heJ+DSsvm7gzSPsYhhQ ($37 in chips)
Seat 7: PfmlvZlFiss79a6IoEr11g ($121.55 in chips)
Seat 8: TAfo4veNRaRlzDXMMYS3Jg ($41 in chips)
Seat 9: CkE3IyJF1KvdaAOmZY5XqQ ($201 in chips)
CkE3IyJF1KvdaAOmZY5XqQ: posts small blind $1
H6Z4+qu8gR0VUiPOijndVg: posts big blind $2
rW/MyplHylMSBRaoRUzWrg: sits out
*** HOLE CARDS ***
WUlHm+ydPPHG7Lb0rePSdA: folds
lQYT23h5QCUVZAKxjOO39Q: folds
FWGiDqRwvLeKmHq9t4Jy9w: folds
GX1heJ+DSsvm7gzSPsYhhQ: folds
PfmlvZlFiss79a6IoEr11g: calls $2
TAfo4veNRaRlzDXMMYS3Jg: folds
CkE3IyJF1KvdaAOmZY5XqQ: folds
H6Z4+qu8gR0VUiPOijndVg: checks
*** FLOP *** [8d Qd 7c]
H6Z4+qu8gR0VUiPOijndVg: checks
PfmlvZlFiss79a6IoEr11g: checks
*** TURN *** [8d Qd 7c] [Qs]
H6Z4+qu8gR0VUiPOijndVg: checks
PfmlvZlFiss79a6IoEr11g: checks
*** RIVER *** [8d Qd 7c Qs] [Kc]
H6Z4+qu8gR0VUiPOijndVg: checks
PfmlvZlFiss79a6IoEr11g: checks
*** SHOW DOWN ***
H6Z4+qu8gR0VUiPOijndVg: shows [9s As] (a pair of Queens)
PfmlvZlFiss79a6IoEr11g: shows [6h 7h] (two pair, Queens and Sevens)
PfmlvZlFiss79a6IoEr11g collected $4.75 from pot
*** SUMMARY ***
Total pot $5 | Rake $0.25
Board [8d Qd 7c Qs Kc]
Seat 1: H6Z4+qu8gR0VUiPOijndVg (big blind) showed [9s As] and lost with a pair of Queens
Seat 3: WUlHm+ydPPHG7Lb0rePSdA folded before Flop (didn't bet)
Seat 4: lQYT23h5QCUVZAKxjOO39Q folded before Flop (didn't bet)
Seat 5: FWGiDqRwvLeKmHq9t4Jy9w folded before Flop (didn't bet)
Seat 6: GX1heJ+DSsvm7gzSPsYhhQ folded before Flop (didn't bet)
Seat 7: PfmlvZlFiss79a6IoEr11g showed [6h 7h] and won ($4.75) with two pair, Queens and Sevens
Seat 8: TAfo4veNRaRlzDXMMYS3Jg (button) folded before Flop (didn't bet)
Seat 9: CkE3IyJF1KvdaAOmZY5XqQ (small blind) folded before Flop



PokerStars Game #59940751136:  Hold'em No Limit ($1/$2) - 2009/07/01 1:15:31 ET
Table '+hSnXFQrGw1PlVgTnuj+sA' 6-max Seat #4 is the button
Seat 1: 2ccIJhDj+3JapvS7swVZEg ($279.50 in chips)
Seat 2: o9jamqIi6sTTRSqudgboRA ($277.55 in chips)
Seat 3: fE+LHW/7rpfXW14g8LhGjA ($74.65 in chips)
Seat 4: J4iH5epwXbmODnojR/VRxA ($187 in chips)
Seat 5: VvdR9F3I+2yELkfTVvC1dg ($200 in chips)
Seat 6: AuiGltq875lmaKHBsjZVGg ($80.85 in chips)
VvdR9F3I+2yELkfTVvC1dg: posts small blind $1
AuiGltq875lmaKHBsjZVGg: posts big blind $2
*** HOLE CARDS ***
2ccIJhDj+3JapvS7swVZEg: calls $2
o9jamqIi6sTTRSqudgboRA: folds
fE+LHW/7rpfXW14g8LhGjA: raises $8 to $10
J4iH5epwXbmODnojR/VRxA: folds
VvdR9F3I+2yELkfTVvC1dg: folds
AuiGltq875lmaKHBsjZVGg: calls $8
2ccIJhDj+3JapvS7swVZEg: calls $8
*** FLOP *** [Ts 5c Kc]
AuiGltq875lmaKHBsjZVGg: checks
2ccIJhDj+3JapvS7swVZEg: checks
fE+LHW/7rpfXW14g8LhGjA: bets $10
AuiGltq875lmaKHBsjZVGg: raises $10 to $20
2ccIJhDj+3JapvS7swVZEg: folds
fE+LHW/7rpfXW14g8LhGjA: folds
AuiGltq875lmaKHBsjZVGg collected $48.55 from pot
*** SUMMARY ***
Total pot $51 | Rake $2.45
Board [Ts 5c Kc]
Seat 1: 2ccIJhDj+3JapvS7swVZEg folded on the Flop
Seat 2: o9jamqIi6sTTRSqudgboRA folded before Flop (didn't bet)
Seat 3: fE+LHW/7rpfXW14g8LhGjA folded on the Flop
Seat 4: J4iH5epwXbmODnojR/VRxA (button) folded before Flop (didn't bet)
Seat 5: VvdR9F3I+2yELkfTVvC1dg (small blind) folded before Flop
Seat 6: AuiGltq875lmaKHBsjZVGg (big blind) collected ($48.55)



PokerStars Game #59940754882:  Hold'em No Limit ($1/$2) - 2009/07/01 1:15:38 ET
Table 'NmY84NAf9Mh0ckAckHnh5g' 2-max Seat #1 is the button
Seat 1: 6hvg964TSqZ3AL/0XK9aVQ ($256.30 in chips)
Seat 2: RwDoM55ZeQuI2ADyJhOb2Q ($556.50 in chips)
6hvg964TSqZ3AL/0XK9aVQ: posts small blind $1
RwDoM55ZeQuI2ADyJhOb2Q: posts big blind $2
*** HOLE CARDS ***
6hvg964TSqZ3AL/0XK9aVQ: calls $1
RwDoM55ZeQuI2ADyJhOb2Q: checks
*** FLOP *** [Th 5h 9h]
RwDoM55ZeQuI2ADyJhOb2Q: bets $4
6hvg964TSqZ3AL/0XK9aVQ: folds
RwDoM55ZeQuI2ADyJhOb2Q collected $3.80 from pot
RwDoM55ZeQuI2ADyJhOb2Q: doesn't show hand
*** SUMMARY ***
Total pot $4 | Rake $0.20
Board [Th 5h 9h]
Seat 1: 6hvg964TSqZ3AL/0XK9aVQ (button) (small blind) folded on the Flop
Seat 2: RwDoM55ZeQuI2ADyJhOb2Q (big blind) collected ($3.80)



PokerStars Game #59940756634:  Hold'em No Limit ($1/$2) - 2009/07/01 1:15:41 ET
Table 'TsEDkiO4tzCTCzJ7tNdEqw' 6-max Seat #1 is the button
Seat 1: MfXQsYD8pGeCS7XOtyV+vw ($85.90 in chips)
Seat 2: 4dcDwIHRm96PwtqkpQiuiA ($60.70 in chips)
Seat 3: wgRvjVPZSQvqNGiyR1jwSA ($40 in chips)
Seat 4: K8MXCrNAVYlMnnCeM32Kxw ($57.05 in chips)
Seat 5: VvdR9F3I+2yELkfTVvC1dg ($205.50 in chips)
Seat 6: uCqEjnxh2/vFBjKYkfTOkw ($259.25 in chips)
4dcDwIHRm96PwtqkpQiuiA: posts small blind $1
wgRvjVPZSQvqNGiyR1jwSA: posts big blind $2
*** HOLE CARDS ***
K8MXCrNAVYlMnnCeM32Kxw: folds
VvdR9F3I+2yELkfTVvC1dg: folds
uCqEjnxh2/vFBjKYkfTOkw: raises $6 to $8
MfXQsYD8pGeCS7XOtyV+vw: folds
4dcDwIHRm96PwtqkpQiuiA: folds
wgRvjVPZSQvqNGiyR1jwSA: folds
uCqEjnxh2/vFBjKYkfTOkw collected $5 from pot
uCqEjnxh2/vFBjKYkfTOkw: doesn't show hand
*** SUMMARY ***
Total pot $5 | Rake $0
Seat 1: MfXQsYD8pGeCS7XOtyV+vw (button) folded before Flop (didn't bet)
Seat 2: 4dcDwIHRm96PwtqkpQiuiA (small blind) folded before Flop
Seat 3: wgRvjVPZSQvqNGiyR1jwSA (big blind) folded before Flop
Seat 4: K8MXCrNAVYlMnnCeM32Kxw folded before Flop (didn't bet)
Seat 5: VvdR9F3I+2yELkfTVvC1dg folded before Flop (didn't bet)
Seat 6: uCqEjnxh2/vFBjKYkfTOkw collected ($5)



PokerStars Game #59940758890:  Hold'em No Limit ($1/$2) - 2009/07/01 1:15:45 ET
Table 'ztv6V3FN2bQ9nmJPPdx6nQ' 6-max Seat #4 is the button
Seat 2: 5Y+ZGWLI4gnlpApDX5vy1A ($460.85 in chips)
Seat 4: UaZ5yj+6LjtWqMQg2QskUw ($115.80 in chips)
Seat 5: sTPOWERd9HWPCNrDBwsVjA ($198 in chips)
Seat 6: mfy7uGZcqA2PVQqEVbJ7+g ($115.45 in chips)
sTPOWERd9HWPCNrDBwsVjA: posts small blind $1
mfy7uGZcqA2PVQqEVbJ7+g: posts big blind $2
*** HOLE CARDS ***
5Y+ZGWLI4gnlpApDX5vy1A: raises $6 to $8
UaZ5yj+6LjtWqMQg2QskUw: folds
sTPOWERd9HWPCNrDBwsVjA: folds
mfy7uGZcqA2PVQqEVbJ7+g: folds
5Y+ZGWLI4gnlpApDX5vy1A collected $5 from pot
5Y+ZGWLI4gnlpApDX5vy1A: doesn't show hand
*** SUMMARY ***
Total pot $5 | Rake $0
Seat 2: 5Y+ZGWLI4gnlpApDX5vy1A collected ($5)
Seat 4: UaZ5yj+6LjtWqMQg2QskUw (button) folded before Flop (didn't bet)
Seat 5: sTPOWERd9HWPCNrDBwsVjA (small blind) folded before Flop
Seat 6: mfy7uGZcqA2PVQqEVbJ7+g (big blind) folded before Flop



PokerStars Game #59940759678:  Hold'em No Limit ($1/$2) - 2009/07/01 1:15:46 ET
Table 'CFkQcfWjKccZaZDf71FK+w' 6-max Seat #5 is the button
Seat 1: JsC+WvfzqlxVs9G8/gSQAQ ($142.20 in chips)
Seat 2: ewN/vzF22+/gdzjIKBOlkA ($213.60 in chips)
Seat 3: 09BNF4quPDzanQzM8vc6WA ($36 in chips)
Seat 4: ygTTt5ehT4aF86q1a8/R+w ($160.10 in chips)
Seat 5: 2lOU1DcvUZaMcxZ95XfzXw ($73 in chips)
Seat 6: ORVqY3rf9X6ANA/8s+On2Q ($66.75 in chips)
ORVqY3rf9X6ANA/8s+On2Q: posts small blind $1
JsC+WvfzqlxVs9G8/gSQAQ: posts big blind $2
*** HOLE CARDS ***
ewN/vzF22+/gdzjIKBOlkA: folds
09BNF4quPDzanQzM8vc6WA: folds
ygTTt5ehT4aF86q1a8/R+w: folds
2lOU1DcvUZaMcxZ95XfzXw: calls $2
ORVqY3rf9X6ANA/8s+On2Q: folds
JsC+WvfzqlxVs9G8/gSQAQ: raises $6 to $8
2lOU1DcvUZaMcxZ95XfzXw: folds
JsC+WvfzqlxVs9G8/gSQAQ collected $5 from pot
*** SUMMARY ***
Total pot $5 | Rake $0
Seat 1: JsC+WvfzqlxVs9G8/gSQAQ (big blind) collected ($5)
Seat 2: ewN/vzF22+/gdzjIKBOlkA folded before Flop (didn't bet)
Seat 3: 09BNF4quPDzanQzM8vc6WA folded before Flop (didn't bet)
Seat 4: ygTTt5ehT4aF86q1a8/R+w folded before Flop (didn't bet)
Seat 5: 2lOU1DcvUZaMcxZ95XfzXw (button) folded before Flop
Seat 6: ORVqY3rf9X6ANA/8s+On2Q (small blind) folded before Flop



PokerStars Game #59940760022:  Hold'em No Limit ($1/$2) - 2009/07/01 1:15:47 ET
Table 'jlrIxbrVIG+gjaUYT4za8g' 6-max Seat #6 is the button
Seat 1: ygTTt5ehT4aF86q1a8/R+w ($219.90 in chips)
Seat 2: N18PrNGQj43J7TJuQuu+tw ($91.40 in chips)
Seat 4: 8srN1dKQePlsv0GyTada+Q ($299.10 in chips)
Seat 5: AyBB0k3Dcl7xbXUeGMw06g ($80.20 in chips)
Seat 6: vkfxu8f/jMYKUk6Ly4eujw ($240.75 in chips)
ygTTt5ehT4aF86q1a8/R+w: posts small blind $1
N18PrNGQj43J7TJuQuu+tw: posts big blind $2
*** HOLE CARDS ***
8srN1dKQePlsv0GyTada+Q: folds
AyBB0k3Dcl7xbXUeGMw06g: folds
vkfxu8f/jMYKUk6Ly4eujw: folds
ygTTt5ehT4aF86q1a8/R+w: raises $4 to $6
N18PrNGQj43J7TJuQuu+tw: calls $4
*** FLOP *** [4d Ks Ts]
ygTTt5ehT4aF86q1a8/R+w: bets $6
N18PrNGQj43J7TJuQuu+tw: folds
ygTTt5ehT4aF86q1a8/R+w collected $11.40 from pot
*** SUMMARY ***
Total pot $12 | Rake $0.60
Board [4d Ks Ts]
Seat 1: ygTTt5ehT4aF86q1a8/R+w (small blind) collected ($11.40)
Seat 2: N18PrNGQj43J7TJuQuu+tw (big blind) folded on the Flop
Seat 4: 8srN1dKQePlsv0GyTada+Q folded before Flop (didn't bet)
Seat 5: AyBB0k3Dcl7xbXUeGMw06g folded before Flop (didn't bet)
Seat 6: vkfxu8f/jMYKUk6Ly4eujw (button) folded before Flop (didn't bet)



PokerStars Game #59940760510:  Hold'em No Limit ($1/$2) - 2009/07/01 1:15:48 ET
Table 'gftD4mDF7mIFKvSrIyaRbw' 9-max Seat #1 is the button
Seat 1: 31HuO+DQxppUQEedBWukug ($106 in chips)
Seat 2: GX1heJ+DSsvm7gzSPsYhhQ ($38 in chips)
Seat 3: CUZwDpLTQKhzarPe+JCLOQ ($203 in chips)
Seat 4: rW/MyplHylMSBRaoRUzWrg ($54.50 in chips)
Seat 5: mpsfNtnMVDqQHTe92AhIdw ($123.50 in chips)
Seat 6: 2NvwF8W2nzsbS+G//yLAbQ ($162.50 in chips)
Seat 7: EBV6OktyeSmh4w6sWmcWOw ($215.65 in chips)
Seat 8: MpL4DeEqGQu0H8TJEbEOrg ($40 in chips)
Seat 9: F7m34OOfAQ7annesMHVjKw ($168.10 in chips)
GX1heJ+DSsvm7gzSPsYhhQ: posts small blind $1
CUZwDpLTQKhzarPe+JCLOQ: posts big blind $2
*** HOLE CARDS ***
rW/MyplHylMSBRaoRUzWrg: folds
mpsfNtnMVDqQHTe92AhIdw: folds
2NvwF8W2nzsbS+G//yLAbQ: folds
EBV6OktyeSmh4w6sWmcWOw: folds
MpL4DeEqGQu0H8TJEbEOrg: folds
F7m34OOfAQ7annesMHVjKw: raises $2 to $4
31HuO+DQxppUQEedBWukug: folds
GX1heJ+DSsvm7gzSPsYhhQ: folds
CUZwDpLTQKhzarPe+JCLOQ: calls $2
*** FLOP *** [2s 8c 6s]
CUZwDpLTQKhzarPe+JCLOQ: checks
F7m34OOfAQ7annesMHVjKw: checks
*** TURN *** [2s 8c 6s] [5d]
CUZwDpLTQKhzarPe+JCLOQ: bets $5
F7m34OOfAQ7annesMHVjKw: calls $5
*** RIVER *** [2s 8c 6s 5d] [Ks]
CUZwDpLTQKhzarPe+JCLOQ: checks
F7m34OOfAQ7annesMHVjKw: checks
*** SHOW DOWN ***
CUZwDpLTQKhzarPe+JCLOQ: shows [Ac Jc] (high card Ace)
F7m34OOfAQ7annesMHVjKw: mucks hand
CUZwDpLTQKhzarPe+JCLOQ collected $18.10 from pot
*** SUMMARY ***
Total pot $19 | Rake $0.90
Board [2s 8c 6s 5d Ks]
Seat 1: 31HuO+DQxppUQEedBWukug (button) folded before Flop (didn't bet)
Seat 2: GX1heJ+DSsvm7gzSPsYhhQ (small blind) folded before Flop
Seat 3: CUZwDpLTQKhzarPe+JCLOQ (big blind) showed [Ac Jc] and won ($18.10) with high card Ace
Seat 4: rW/MyplHylMSBRaoRUzWrg folded before Flop (didn't bet)
Seat 5: mpsfNtnMVDqQHTe92AhIdw folded before Flop (didn't bet)
Seat 6: 2NvwF8W2nzsbS+G//yLAbQ folded before Flop (didn't bet)
Seat 7: EBV6OktyeSmh4w6sWmcWOw folded before Flop (didn't bet)
Seat 8: MpL4DeEqGQu0H8TJEbEOrg folded before Flop (didn't bet)
Seat 9: F7m34OOfAQ7annesMHVjKw mucked



PokerStars Game #59940760920:  Hold'em No Limit ($1/$2) - 2009/07/01 1:15:49 ET
Table 'LL4bDFyhj5hsMpzaDugJZg' 6-max Seat #6 is the button
Seat 1: FwvID/fQGlpY3soi/lMTww ($66.95 in chips)
Seat 2: IZng3w8jiJHHp3LbYKLi4w ($43.50 in chips)
Seat 3: iI/NMpRxMkGieArQEhACSA ($282.70 in chips)
Seat 4: 8srN1dKQePlsv0GyTada+Q ($314.75 in chips)
Seat 5: A2GTwTiwkb1ilNWgW487Vg ($96.05 in chips)
Seat 6: 692Q4sfB0gTElzS0WMeg+A ($217.10 in chips)
FwvID/fQGlpY3soi/lMTww: posts small blind $1
IZng3w8jiJHHp3LbYKLi4w: posts big blind $2
*** HOLE CARDS ***
iI/NMpRxMkGieArQEhACSA: folds
8srN1dKQePlsv0GyTada+Q: folds
A2GTwTiwkb1ilNWgW487Vg: raises $2 to $4
692Q4sfB0gTElzS0WMeg+A: folds
FwvID/fQGlpY3soi/lMTww: calls $3
IZng3w8jiJHHp3LbYKLi4w: folds
*** FLOP *** [4s 9d 7h]
FwvID/fQGlpY3soi/lMTww: checks
A2GTwTiwkb1ilNWgW487Vg: bets $2
FwvID/fQGlpY3soi/lMTww: raises $4 to $6
A2GTwTiwkb1ilNWgW487Vg: calls $4
*** TURN *** [4s 9d 7h] [Jc]
FwvID/fQGlpY3soi/lMTww: checks
A2GTwTiwkb1ilNWgW487Vg: checks
*** RIVER *** [4s 9d 7h Jc] [4h]
FwvID/fQGlpY3soi/lMTww: checks
A2GTwTiwkb1ilNWgW487Vg: checks
*** SHOW DOWN ***
FwvID/fQGlpY3soi/lMTww: shows [5c 7c] (two pair, Sevens and Fours)
A2GTwTiwkb1ilNWgW487Vg: mucks hand
FwvID/fQGlpY3soi/lMTww collected $20.95 from pot
*** SUMMARY ***
Total pot $22 | Rake $1.05
Board [4s 9d 7h Jc 4h]
Seat 1: FwvID/fQGlpY3soi/lMTww (small blind) showed [5c 7c] and won ($20.95) with two pair, Sevens and Fours
Seat 2: IZng3w8jiJHHp3LbYKLi4w (big blind) folded before Flop
Seat 3: iI/NMpRxMkGieArQEhACSA folded before Flop (didn't bet)
Seat 4: 8srN1dKQePlsv0GyTada+Q folded before Flop (didn't bet)
Seat 5: A2GTwTiwkb1ilNWgW487Vg mucked
Seat 6: 692Q4sfB0gTElzS0WMeg+A (button) folded before Flop (didn't bet)



PokerStars Game #59940763042:  Hold'em No Limit ($1/$2) - 2009/07/01 1:15:52 ET
Table 'NmY84NAf9Mh0ckAckHnh5g' 2-max Seat #2 is the button
Seat 1: 6hvg964TSqZ3AL/0XK9aVQ ($254.30 in chips)
Seat 2: RwDoM55ZeQuI2ADyJhOb2Q ($558.30 in chips)
RwDoM55ZeQuI2ADyJhOb2Q: posts small blind $1
6hvg964TSqZ3AL/0XK9aVQ: posts big blind $2
*** HOLE CARDS ***
RwDoM55ZeQuI2ADyJhOb2Q: raises $4 to $6
6hvg964TSqZ3AL/0XK9aVQ: raises $8 to $14
RwDoM55ZeQuI2ADyJhOb2Q: calls $8
*** FLOP *** [Ah Qh 6d]
6hvg964TSqZ3AL/0XK9aVQ: checks
RwDoM55ZeQuI2ADyJhOb2Q: bets $22
6hvg964TSqZ3AL/0XK9aVQ: calls $22
*** TURN *** [Ah Qh 6d] [Tc]
6hvg964TSqZ3AL/0XK9aVQ: checks
RwDoM55ZeQuI2ADyJhOb2Q: bets $52
6hvg964TSqZ3AL/0XK9aVQ: calls $52
*** RIVER *** [Ah Qh 6d Tc] [3s]
6hvg964TSqZ3AL/0XK9aVQ: bets $166.30 and is all-in
RwDoM55ZeQuI2ADyJhOb2Q: calls $166.30
*** SHOW DOWN ***
6hvg964TSqZ3AL/0XK9aVQ: shows [Kc Ac] (a pair of Aces)
RwDoM55ZeQuI2ADyJhOb2Q: shows [Th Ad] (two pair, Aces and Tens)
RwDoM55ZeQuI2ADyJhOb2Q collected $508.10 from pot
*** SUMMARY ***
Total pot $508.60 | Rake $0.50
Board [Ah Qh 6d Tc 3s]
Seat 1: 6hvg964TSqZ3AL/0XK9aVQ (big blind) showed [Kc Ac] and lost with a pair of Aces
Seat 2: RwDoM55ZeQuI2ADyJhOb2Q (button) (small blind) showed [Th Ad] and won ($508.10) with two pair, Aces and Tens



PokerStars Game #59940764394:  Hold'em No Limit ($1/$2) - 2009/07/01 1:15:55 ET
Table 'rKeCh+eBn4RNvybCUYkoTQ' 9-max Seat #6 is the button
Seat 1: /inIs/z/PcX+TniIFpaxpg ($206 in chips)
Seat 2: 9cBHwK40Tl06vheE7B3LHQ ($81.05 in chips)
Seat 3: R9FzbEg1XYsiOty4kvbqhg ($69.20 in chips)
Seat 4: 31HuO+DQxppUQEedBWukug ($98.10 in chips)
Seat 5: WUlHm+ydPPHG7Lb0rePSdA ($120 in chips)
Seat 6: EBV6OktyeSmh4w6sWmcWOw ($270 in chips)
Seat 7: rW/MyplHylMSBRaoRUzWrg ($38 in chips)
Seat 8: pN/Ip0ePsUVIdUlGgLrkUw ($209 in chips)
Seat 9: Kzta8yu9vxHT4B70mjBZ+w ($211.25 in chips)
rW/MyplHylMSBRaoRUzWrg: posts small blind $1
pN/Ip0ePsUVIdUlGgLrkUw: posts big blind $2
*** HOLE CARDS ***
Kzta8yu9vxHT4B70mjBZ+w: folds
/inIs/z/PcX+TniIFpaxpg: folds
9cBHwK40Tl06vheE7B3LHQ: raises $4 to $6
R9FzbEg1XYsiOty4kvbqhg: calls $6
31HuO+DQxppUQEedBWukug: folds
WUlHm+ydPPHG7Lb0rePSdA: folds
EBV6OktyeSmh4w6sWmcWOw: folds
rW/MyplHylMSBRaoRUzWrg: folds
pN/Ip0ePsUVIdUlGgLrkUw: folds
*** FLOP *** [3c Ac 7d]
9cBHwK40Tl06vheE7B3LHQ: bets $12
R9FzbEg1XYsiOty4kvbqhg: calls $12
*** TURN *** [3c Ac 7d] [Ad]
9cBHwK40Tl06vheE7B3LHQ: bets $63.05 and is all-in
R9FzbEg1XYsiOty4kvbqhg: calls $51.20 and is all-in
*** RIVER *** [3c Ac 7d Ad] [5d]
*** SHOW DOWN ***
9cBHwK40Tl06vheE7B3LHQ: shows [Qh Ah] (three of a kind, Aces)
R9FzbEg1XYsiOty4kvbqhg: mucks hand
9cBHwK40Tl06vheE7B3LHQ collected $138.40 from pot
*** SUMMARY ***
Total pot $141.40 | Rake $3
Board [3c Ac 7d Ad 5d]
Seat 1: /inIs/z/PcX+TniIFpaxpg folded before Flop (didn't bet)
Seat 2: 9cBHwK40Tl06vheE7B3LHQ showed [Qh Ah] and won ($138.40) with three of a kind, Aces
Seat 3: R9FzbEg1XYsiOty4kvbqhg mucked
Seat 4: 31HuO+DQxppUQEedBWukug folded before Flop (didn't bet)
Seat 5: WUlHm+ydPPHG7Lb0rePSdA folded before Flop (didn't bet)
Seat 6: EBV6OktyeSmh4w6sWmcWOw (button) folded before Flop (didn't bet)
Seat 7: rW/MyplHylMSBRaoRUzWrg (small blind) folded before Flop
Seat 8: pN/Ip0ePsUVIdUlGgLrkUw (big blind) folded before Flop
Seat 9: Kzta8yu9vxHT4B70mjBZ+w folded before Flop (didn't bet)



PokerStars Game #59940767182:  Hold'em No Limit ($1/$2) - 2009/07/01 1:15:59 ET
Table 'ztv6V3FN2bQ9nmJPPdx6nQ' 6-max Seat #5 is the button
Seat 2: 5Y+ZGWLI4gnlpApDX5vy1A ($463.85 in chips)
Seat 4: UaZ5yj+6LjtWqMQg2QskUw ($115.80 in chips)
Seat 5: sTPOWERd9HWPCNrDBwsVjA ($197 in chips)
Seat 6: mfy7uGZcqA2PVQqEVbJ7+g ($113.45 in chips)
mfy7uGZcqA2PVQqEVbJ7+g: posts small blind $1
5Y+ZGWLI4gnlpApDX5vy1A: posts big blind $2
*** HOLE CARDS ***
UaZ5yj+6LjtWqMQg2QskUw: folds
sTPOWERd9HWPCNrDBwsVjA: calls $2
mfy7uGZcqA2PVQqEVbJ7+g: folds
5Y+ZGWLI4gnlpApDX5vy1A: checks
*** FLOP *** [6h 8d 9s]
5Y+ZGWLI4gnlpApDX5vy1A: bets $6
sTPOWERd9HWPCNrDBwsVjA: raises $22 to $28
5Y+ZGWLI4gnlpApDX5vy1A: calls $22
*** TURN *** [6h 8d 9s] [2h]
5Y+ZGWLI4gnlpApDX5vy1A: checks
sTPOWERd9HWPCNrDBwsVjA: bets $38
5Y+ZGWLI4gnlpApDX5vy1A: calls $38
*** RIVER *** [6h 8d 9s 2h] [8c]
5Y+ZGWLI4gnlpApDX5vy1A: checks
sTPOWERd9HWPCNrDBwsVjA: bets $129 and is all-in
5Y+ZGWLI4gnlpApDX5vy1A: folds
sTPOWERd9HWPCNrDBwsVjA collected $135 from pot
sTPOWERd9HWPCNrDBwsVjA: doesn't show hand
*** SUMMARY ***
Total pot $137 | Rake $2
Board [6h 8d 9s 2h 8c]
Seat 2: 5Y+ZGWLI4gnlpApDX5vy1A (big blind) folded on the River
Seat 4: UaZ5yj+6LjtWqMQg2QskUw folded before Flop (didn't bet)
Seat 5: sTPOWERd9HWPCNrDBwsVjA (button) collected ($135)
Seat 6: mfy7uGZcqA2PVQqEVbJ7+g (small blind) folded before Flop



PokerStars Game #59940766906:  Hold'em No Limit ($1/$2) - 2009/07/01 1:15:59 ET
Table 'mGpP9StWRnoeiBDExc6Frg' 6-max Seat #6 is the button
Seat 1: VvdR9F3I+2yELkfTVvC1dg ($200 in chips)
Seat 2: dZcLsEI8iXkobBduRJ45Yw ($70 in chips)
Seat 4: 4dcDwIHRm96PwtqkpQiuiA ($40 in chips)
Seat 5: d1puGuVBE0fidn+5eRJ0tw ($230.20 in chips)
Seat 6: B2Ih1sr5VZk+8He7rcrMtQ ($459.35 in chips)
VvdR9F3I+2yELkfTVvC1dg: posts small blind $1
dZcLsEI8iXkobBduRJ45Yw: posts big blind $2
7acrZUQC3Zc9BNLjoKIcLQ: sits out
*** HOLE CARDS ***
4dcDwIHRm96PwtqkpQiuiA: raises $4 to $6
d1puGuVBE0fidn+5eRJ0tw has timed out
d1puGuVBE0fidn+5eRJ0tw: folds
d1puGuVBE0fidn+5eRJ0tw is sitting out
B2Ih1sr5VZk+8He7rcrMtQ: folds
VvdR9F3I+2yELkfTVvC1dg: folds
dZcLsEI8iXkobBduRJ45Yw: calls $4
*** FLOP *** [6c 5s Ad]
d1puGuVBE0fidn+5eRJ0tw has returned
dZcLsEI8iXkobBduRJ45Yw: checks
4dcDwIHRm96PwtqkpQiuiA: checks
*** TURN *** [6c 5s Ad] [Jh]
dZcLsEI8iXkobBduRJ45Yw: checks
4dcDwIHRm96PwtqkpQiuiA: bets $6
dZcLsEI8iXkobBduRJ45Yw: folds
4dcDwIHRm96PwtqkpQiuiA collected $12.35 from pot
*** SUMMARY ***
Total pot $13 | Rake $0.65
Board [6c 5s Ad Jh]
Seat 1: VvdR9F3I+2yELkfTVvC1dg (small blind) folded before Flop
Seat 2: dZcLsEI8iXkobBduRJ45Yw (big blind) folded on the Turn
Seat 4: 4dcDwIHRm96PwtqkpQiuiA collected ($12.35)
Seat 5: d1puGuVBE0fidn+5eRJ0tw folded before Flop (didn't bet)
Seat 6: B2Ih1sr5VZk+8He7rcrMtQ (button) folded before Flop (didn't bet)



PokerStars Game #59940766904:  Hold'em No Limit ($1/$2) - 2009/07/01 1:15:59 ET
Table 'P/yCfYl1GfGsu/e6DxDy/A' 2-max Seat #2 is the button
Seat 1: 7fOCUy3x9hdkmXkkDNolGQ ($604.50 in chips)
Seat 2: RwDoM55ZeQuI2ADyJhOb2Q ($886.50 in chips)
RwDoM55ZeQuI2ADyJhOb2Q: posts small blind $1
7fOCUy3x9hdkmXkkDNolGQ: posts big blind $2
*** HOLE CARDS ***
RwDoM55ZeQuI2ADyJhOb2Q: raises $4 to $6
7fOCUy3x9hdkmXkkDNolGQ: folds
RwDoM55ZeQuI2ADyJhOb2Q collected $4 from pot
RwDoM55ZeQuI2ADyJhOb2Q: doesn't show hand
*** SUMMARY ***
Total pot $4 | Rake $0
Seat 1: 7fOCUy3x9hdkmXkkDNolGQ (big blind) folded before Flop
Seat 2: RwDoM55ZeQuI2ADyJhOb2Q (button) (small blind) collected ($4)



PokerStars Game #59940767670:  Hold'em No Limit ($1/$2) - 2009/07/01 1:16:00 ET
Table 'bIihwBANJSFqlHPPtset+w' 9-max Seat #5 is the button
Seat 1: /inIs/z/PcX+TniIFpaxpg ($33 in chips)
Seat 2: lQYT23h5QCUVZAKxjOO39Q ($175.30 in chips)
Seat 3: OipzuP0MueAd8hGaz/kWMQ ($21.15 in chips)
Seat 4: ri8CLkX3e9JF34dQNbsHGA ($42.40 in chips)
Seat 5: vxbbJLsS1bva6tW2NiFssg ($200 in chips)
Seat 6: CkE3IyJF1KvdaAOmZY5XqQ ($187 in chips)
Seat 7: pCmk6FpSOLJ+85o1tLHIag ($133.45 in chips)
Seat 8: iMe5yhc+1BaiIPHet3NMrA ($228.65 in chips)
Seat 9: qn8LDoUFphcG4+r+F+Vhrg ($184 in chips)
CkE3IyJF1KvdaAOmZY5XqQ: posts small blind $1
pCmk6FpSOLJ+85o1tLHIag: posts big blind $2
*** HOLE CARDS ***
iMe5yhc+1BaiIPHet3NMrA: calls $2
qn8LDoUFphcG4+r+F+Vhrg: folds
/inIs/z/PcX+TniIFpaxpg: folds
lQYT23h5QCUVZAKxjOO39Q: folds
OipzuP0MueAd8hGaz/kWMQ: raises $4 to $6
ri8CLkX3e9JF34dQNbsHGA: folds
vxbbJLsS1bva6tW2NiFssg: folds
CkE3IyJF1KvdaAOmZY5XqQ: folds
pCmk6FpSOLJ+85o1tLHIag: folds
iMe5yhc+1BaiIPHet3NMrA: calls $4
*** FLOP *** [Tc 7h 9d]
iMe5yhc+1BaiIPHet3NMrA: checks
OipzuP0MueAd8hGaz/kWMQ: checks
*** TURN *** [Tc 7h 9d] [Th]
iMe5yhc+1BaiIPHet3NMrA: bets $8
OipzuP0MueAd8hGaz/kWMQ: raises $7.15 to $15.15 and is all-in
iMe5yhc+1BaiIPHet3NMrA: calls $7.15
*** RIVER *** [Tc 7h 9d Th] [9c]
*** SHOW DOWN ***
iMe5yhc+1BaiIPHet3NMrA: shows [8d 8h] (two pair, Tens and Nines)
OipzuP0MueAd8hGaz/kWMQ: shows [Qh Ah] (two pair, Tens and Nines - Ace kicker)
OipzuP0MueAd8hGaz/kWMQ collected $43.10 from pot
*** SUMMARY ***
Total pot $45.30 | Rake $2.20
Board [Tc 7h 9d Th 9c]
Seat 1: /inIs/z/PcX+TniIFpaxpg folded before Flop (didn't bet)
Seat 2: lQYT23h5QCUVZAKxjOO39Q folded before Flop (didn't bet)
Seat 3: OipzuP0MueAd8hGaz/kWMQ showed [Qh Ah] and won ($43.10) with two pair, Tens and Nines
Seat 4: ri8CLkX3e9JF34dQNbsHGA folded before Flop (didn't bet)
Seat 5: vxbbJLsS1bva6tW2NiFssg (button) folded before Flop (didn't bet)
Seat 6: CkE3IyJF1KvdaAOmZY5XqQ (small blind) folded before Flop
Seat 7: pCmk6FpSOLJ+85o1tLHIag (big blind) folded before Flop
Seat 8: iMe5yhc+1BaiIPHet3NMrA showed [8d 8h] and lost with two pair, Tens and Nines
Seat 9: qn8LDoUFphcG4+r+F+Vhrg folded before Flop (didn't bet)



PokerStars Game #59940767926:  Hold'em No Limit ($1/$2) - 2009/07/01 1:16:01 ET
Table 'rsKRKlGHlxVyqJxzO2a2Ow' 9-max Seat #9 is the button
Seat 1: uYWfQJg2hgHLxri6/uVJiw ($249.85 in chips)
Seat 2: QHxJjpVYwitg9krW6wZgJA ($268.80 in chips)
Seat 3: zTcFtoHqqK4550YMZ8Y14Q ($67.50 in chips)
Seat 4: 31HuO+DQxppUQEedBWukug ($100 in chips)
Seat 5: 5Q8U6iZbeO7xJSS4qvDP5g ($200 in chips)
Seat 6: H6Z4+qu8gR0VUiPOijndVg ($200 in chips)
Seat 7: MPc9Txt5QGkXwb2uAZipEA ($76.25 in chips)
Seat 8: CkE3IyJF1KvdaAOmZY5XqQ ($217.75 in chips)
Seat 9: gRbvhSUVg+TNaTjaJecIRw ($84 in chips)
uYWfQJg2hgHLxri6/uVJiw: posts small blind $1
QHxJjpVYwitg9krW6wZgJA: posts big blind $2
*** HOLE CARDS ***
zTcFtoHqqK4550YMZ8Y14Q: folds
31HuO+DQxppUQEedBWukug: folds
5Q8U6iZbeO7xJSS4qvDP5g: folds
H6Z4+qu8gR0VUiPOijndVg: folds
MPc9Txt5QGkXwb2uAZipEA: folds
CkE3IyJF1KvdaAOmZY5XqQ: folds
gRbvhSUVg+TNaTjaJecIRw: calls $2
uYWfQJg2hgHLxri6/uVJiw: raises $4 to $6
QHxJjpVYwitg9krW6wZgJA: calls $4
gRbvhSUVg+TNaTjaJecIRw: calls $4
*** FLOP *** [7c Qc Ks]
uYWfQJg2hgHLxri6/uVJiw: bets $6
QHxJjpVYwitg9krW6wZgJA: folds
gRbvhSUVg+TNaTjaJecIRw: folds
uYWfQJg2hgHLxri6/uVJiw collected $17.10 from pot
*** SUMMARY ***
Total pot $18 | Rake $0.90
Board [7c Qc Ks]
Seat 1: uYWfQJg2hgHLxri6/uVJiw (small blind) collected ($17.10)
Seat 2: QHxJjpVYwitg9krW6wZgJA (big blind) folded on the Flop
Seat 3: zTcFtoHqqK4550YMZ8Y14Q folded before Flop (didn't bet)
Seat 4: 31HuO+DQxppUQEedBWukug folded before Flop (didn't bet)
Seat 5: 5Q8U6iZbeO7xJSS4qvDP5g folded before Flop (didn't bet)
Seat 6: H6Z4+qu8gR0VUiPOijndVg folded before Flop (didn't bet)
Seat 7: MPc9Txt5QGkXwb2uAZipEA folded before Flop (didn't bet)
Seat 8: CkE3IyJF1KvdaAOmZY5XqQ folded before Flop (didn't bet)
Seat 9: gRbvhSUVg+TNaTjaJecIRw (button) folded on the Flop



PokerStars Game #59940769266:  Hold'em No Limit ($1/$2) - 2009/07/01 1:16:03 ET
Table 'bJQ024BaYSBrW0sXpCZbNQ' 6-max Seat #3 is the button
Seat 1: PCN5rt4TwI1pQE+rAiqI0Q ($253.50 in chips)
Seat 2: 3dAbvkxS5NPQTBAbvpinVg ($208.85 in chips)
Seat 3: vkfxu8f/jMYKUk6Ly4eujw ($231 in chips)
Seat 6: 9dpyyjDTCed6nV7JhaUUpw ($341.95 in chips)
TBaQIN+sQ7eb7P99QnaORQ will be allowed to play after the button
VvdR9F3I+2yELkfTVvC1dg will be allowed to play after the button
9dpyyjDTCed6nV7JhaUUpw: posts small blind $1
PCN5rt4TwI1pQE+rAiqI0Q: posts big blind $2
*** HOLE CARDS ***
3dAbvkxS5NPQTBAbvpinVg: folds
vkfxu8f/jMYKUk6Ly4eujw: folds
9dpyyjDTCed6nV7JhaUUpw: raises $6 to $8
PCN5rt4TwI1pQE+rAiqI0Q: raises $245.50 to $253.50 and is all-in
9dpyyjDTCed6nV7JhaUUpw: folds
PCN5rt4TwI1pQE+rAiqI0Q collected $16 from pot
*** SUMMARY ***
Total pot $16 | Rake $0
Seat 1: PCN5rt4TwI1pQE+rAiqI0Q (big blind) collected ($16)
Seat 2: 3dAbvkxS5NPQTBAbvpinVg folded before Flop (didn't bet)
Seat 3: vkfxu8f/jMYKUk6Ly4eujw (button) folded before Flop (didn't bet)
Seat 6: 9dpyyjDTCed6nV7JhaUUpw (small blind) folded before Flop



PokerStars Game #59940769136:  Hold'em No Limit ($1/$2) - 2009/07/01 1:16:03 ET
Table 'gnHBqWll9O3fxG7Ojkz/ng' 9-max Seat #5 is the button
Seat 2: H6Z4+qu8gR0VUiPOijndVg ($333.25 in chips)
Seat 3: 5Q8U6iZbeO7xJSS4qvDP5g ($218 in chips)
Seat 5: rBQDMkKm9cZn6M9NPsiVew ($239.45 in chips)
Seat 6: /inIs/z/PcX+TniIFpaxpg ($40 in chips)
Seat 7: jqui3xAWCkcdPW36a6BD+w ($344.40 in chips)
Seat 8: cM6efHzdxoqYm0EQKP4TTQ ($103.30 in chips)
Seat 9: sN6yR5I5zFq/WFyIz5UfzQ ($204 in chips)
/inIs/z/PcX+TniIFpaxpg: posts small blind $1
jqui3xAWCkcdPW36a6BD+w: posts big blind $2
TAfo4veNRaRlzDXMMYS3Jg: sits out
*** HOLE CARDS ***
cM6efHzdxoqYm0EQKP4TTQ: folds
sN6yR5I5zFq/WFyIz5UfzQ: folds
H6Z4+qu8gR0VUiPOijndVg: folds
5Q8U6iZbeO7xJSS4qvDP5g: folds
rBQDMkKm9cZn6M9NPsiVew: folds
/inIs/z/PcX+TniIFpaxpg: folds
jqui3xAWCkcdPW36a6BD+w collected $2 from pot
jqui3xAWCkcdPW36a6BD+w: doesn't show hand
*** SUMMARY ***
Total pot $2 | Rake $0
Seat 2: H6Z4+qu8gR0VUiPOijndVg folded before Flop (didn't bet)
Seat 3: 5Q8U6iZbeO7xJSS4qvDP5g folded before Flop (didn't bet)
Seat 5: rBQDMkKm9cZn6M9NPsiVew (button) folded before Flop (didn't bet)
Seat 6: /inIs/z/PcX+TniIFpaxpg (small blind) folded before Flop
Seat 7: jqui3xAWCkcdPW36a6BD+w (big blind) collected ($2)
Seat 8: cM6efHzdxoqYm0EQKP4TTQ folded before Flop (didn't bet)
Seat 9: sN6yR5I5zFq/WFyIz5UfzQ folded before Flop (didn't bet)



PokerStars Game #59940770012:  Hold'em No Limit ($1/$2) - 2009/07/01 1:16:04 ET
Table 'aSf77Sj8QEnzcc0WaxVD4Q' 6-max Seat #4 is the button
Seat 1: UELtvp+JfwI7XDGVwSxZXA ($178.75 in chips)
Seat 3: 9dpyyjDTCed6nV7JhaUUpw ($218.30 in chips)
Seat 4: YsLQ3BAvgQHWXMAv3Wv6Hg ($261.40 in chips)
Seat 5: VvdR9F3I+2yELkfTVvC1dg ($200 in chips)
Seat 6: vkoJRf3gidxY1pPi0AFWww ($148.55 in chips)
VvdR9F3I+2yELkfTVvC1dg: posts small blind $1
vkoJRf3gidxY1pPi0AFWww: posts big blind $2
vkfxu8f/jMYKUk6Ly4eujw: sits out
*** HOLE CARDS ***
UELtvp+JfwI7XDGVwSxZXA: calls $2
9dpyyjDTCed6nV7JhaUUpw: raises $6 to $8
YsLQ3BAvgQHWXMAv3Wv6Hg: folds
VvdR9F3I+2yELkfTVvC1dg: folds
vkoJRf3gidxY1pPi0AFWww: folds
UELtvp+JfwI7XDGVwSxZXA: calls $6
*** FLOP *** [7s Tc Kh]
UELtvp+JfwI7XDGVwSxZXA: checks
9dpyyjDTCed6nV7JhaUUpw: bets $10
UELtvp+JfwI7XDGVwSxZXA: folds
9dpyyjDTCed6nV7JhaUUpw collected $18.05 from pot
9dpyyjDTCed6nV7JhaUUpw: doesn't show hand
*** SUMMARY ***
Total pot $19 | Rake $0.95
Board [7s Tc Kh]
Seat 1: UELtvp+JfwI7XDGVwSxZXA folded on the Flop
Seat 3: 9dpyyjDTCed6nV7JhaUUpw collected ($18.05)
Seat 4: YsLQ3BAvgQHWXMAv3Wv6Hg (button) folded before Flop (didn't bet)
Seat 5: VvdR9F3I+2yELkfTVvC1dg (small blind) folded before Flop
Seat 6: vkoJRf3gidxY1pPi0AFWww (big blind) folded before Flop



PokerStars Game #59940771592:  Hold'em No Limit ($1/$2) - 2009/07/01 1:16:07 ET
Table 'P/yCfYl1GfGsu/e6DxDy/A' 2-max Seat #1 is the button
Seat 1: 7fOCUy3x9hdkmXkkDNolGQ ($602.50 in chips)
Seat 2: RwDoM55ZeQuI2ADyJhOb2Q ($888.50 in chips)
7fOCUy3x9hdkmXkkDNolGQ: posts small blind $1
RwDoM55ZeQuI2ADyJhOb2Q: posts big blind $2
*** HOLE CARDS ***
7fOCUy3x9hdkmXkkDNolGQ: folds
RwDoM55ZeQuI2ADyJhOb2Q collected $2 from pot
RwDoM55ZeQuI2ADyJhOb2Q: doesn't show hand
*** SUMMARY ***
Total pot $2 | Rake $0
Seat 1: 7fOCUy3x9hdkmXkkDNolGQ (button) (small blind) folded before Flop
Seat 2: RwDoM55ZeQuI2ADyJhOb2Q (big blind) collected ($2)



PokerStars Game #59940772704:  Hold'em No Limit ($1/$2) - 2009/07/01 1:16:09 ET
Table 'eyAQSIlgc2o1Jxvbve4WGg' 9-max Seat #8 is the button
Seat 1: UZEsV9yKUMqmpYPiOFpaZw ($104.50 in chips)
Seat 2: g7gL2NLJCdZPPV399WKT1w ($59.65 in chips)
Seat 3: ice1Sbe19zWIaKYoSmE5tw ($96.30 in chips)
Seat 4: CkE3IyJF1KvdaAOmZY5XqQ ($200 in chips)
Seat 5: mIKx5lhIt13X5eZQH0ZeMA ($58.25 in chips)
Seat 6: rW/MyplHylMSBRaoRUzWrg ($50.80 in chips)
Seat 7: QHxJjpVYwitg9krW6wZgJA ($278.45 in chips)
Seat 8: 1CtiZuXDFaJL1dJPQKyi8Q ($197.35 in chips)
Seat 9: WUlHm+ydPPHG7Lb0rePSdA ($120 in chips)
WUlHm+ydPPHG7Lb0rePSdA: posts small blind $1
UZEsV9yKUMqmpYPiOFpaZw: posts big blind $2
*** HOLE CARDS ***
g7gL2NLJCdZPPV399WKT1w: folds
ice1Sbe19zWIaKYoSmE5tw: folds
CkE3IyJF1KvdaAOmZY5XqQ: folds
mIKx5lhIt13X5eZQH0ZeMA: calls $2
rW/MyplHylMSBRaoRUzWrg: folds
QHxJjpVYwitg9krW6wZgJA: folds
1CtiZuXDFaJL1dJPQKyi8Q: folds
WUlHm+ydPPHG7Lb0rePSdA: calls $1
UZEsV9yKUMqmpYPiOFpaZw: checks
*** FLOP *** [Ad 9d 9h]
WUlHm+ydPPHG7Lb0rePSdA: checks
UZEsV9yKUMqmpYPiOFpaZw: checks
mIKx5lhIt13X5eZQH0ZeMA: checks
*** TURN *** [Ad 9d 9h] [Th]
WUlHm+ydPPHG7Lb0rePSdA: bets $4
UZEsV9yKUMqmpYPiOFpaZw: folds
mIKx5lhIt13X5eZQH0ZeMA: folds
WUlHm+ydPPHG7Lb0rePSdA collected $5.70 from pot
WUlHm+ydPPHG7Lb0rePSdA: doesn't show hand
*** SUMMARY ***
Total pot $6 | Rake $0.30
Board [Ad 9d 9h Th]
Seat 1: UZEsV9yKUMqmpYPiOFpaZw (big blind) folded on the Turn
Seat 2: g7gL2NLJCdZPPV399WKT1w folded before Flop (didn't bet)
Seat 3: ice1Sbe19zWIaKYoSmE5tw folded before Flop (didn't bet)
Seat 4: CkE3IyJF1KvdaAOmZY5XqQ folded before Flop (didn't bet)
Seat 5: mIKx5lhIt13X5eZQH0ZeMA folded on the Turn
Seat 6: rW/MyplHylMSBRaoRUzWrg folded before Flop (didn't bet)
Seat 7: QHxJjpVYwitg9krW6wZgJA folded before Flop (didn't bet)
Seat 8: 1CtiZuXDFaJL1dJPQKyi8Q (button) folded before Flop (didn't bet)
Seat 9: WUlHm+ydPPHG7Lb0rePSdA (small blind) collected ($5.70)



PokerStars Game #59940773470:  Hold'em No Limit ($1/$2) - 2009/07/01 1:16:10 ET
Table 'C4lkCXY2PWy6z4vsAe5NGQ' 6-max Seat #3 is the button
Seat 2: 6hRJ68JkbJq6MYI9o5bUnQ ($78.40 in chips)
Seat 3: sTPOWERd9HWPCNrDBwsVjA ($241.35 in chips)
Seat 4: VvdR9F3I+2yELkfTVvC1dg ($200 in chips)
Seat 5: dKvrkfQx2Peke3ikZLUy1w ($274.50 in chips)
Seat 6: B87ikIyZ/TzAVeXf38Ny0g ($290.25 in chips)
VvdR9F3I+2yELkfTVvC1dg: posts small blind $1
dKvrkfQx2Peke3ikZLUy1w: posts big blind $2
*** HOLE CARDS ***
AuiGltq875lmaKHBsjZVGg leaves the table
B87ikIyZ/TzAVeXf38Ny0g: raises $4 to $6
6hRJ68JkbJq6MYI9o5bUnQ: calls $6
4bqvCfJ0e8CTYnn0Go9hbQ joins the table at seat #1
sTPOWERd9HWPCNrDBwsVjA: raises $20 to $26
VvdR9F3I+2yELkfTVvC1dg: folds
dKvrkfQx2Peke3ikZLUy1w: calls $24
B87ikIyZ/TzAVeXf38Ny0g: calls $20
6hRJ68JkbJq6MYI9o5bUnQ: calls $20
*** FLOP *** [7d 6s Ks]
dKvrkfQx2Peke3ikZLUy1w: checks
B87ikIyZ/TzAVeXf38Ny0g: bets $88
6hRJ68JkbJq6MYI9o5bUnQ: folds
sTPOWERd9HWPCNrDBwsVjA: folds
dKvrkfQx2Peke3ikZLUy1w: raises $116 to $204
B87ikIyZ/TzAVeXf38Ny0g: raises $60.25 to $264.25 and is all-in
dKvrkfQx2Peke3ikZLUy1w: calls $44.50 and is all-in
*** TURN *** [7d 6s Ks] [9s]
*** RIVER *** [7d 6s Ks 9s] [8d]
*** SHOW DOWN ***
dKvrkfQx2Peke3ikZLUy1w: shows [Kh Kc] (three of a kind, Kings)
B87ikIyZ/TzAVeXf38Ny0g: shows [5c 8c] (a straight, Five to Nine)
B87ikIyZ/TzAVeXf38Ny0g collected $600 from pot
*** SUMMARY ***
Total pot $602 | Rake $2
Board [7d 6s Ks 9s 8d]
Seat 2: 6hRJ68JkbJq6MYI9o5bUnQ folded on the Flop
Seat 3: sTPOWERd9HWPCNrDBwsVjA (button) folded on the Flop
Seat 4: VvdR9F3I+2yELkfTVvC1dg (small blind) folded before Flop
Seat 5: dKvrkfQx2Peke3ikZLUy1w (big blind) showed [Kh Kc] and lost with three of a kind, Kings
Seat 6: B87ikIyZ/TzAVeXf38Ny0g showed [5c 8c] and won ($600) with a straight, Five to Nine



PokerStars Game #59940773658:  Hold'em No Limit ($1/$2) - 2009/07/01 1:16:11 ET
Table 'CFkQcfWjKccZaZDf71FK+w' 6-max Seat #6 is the button
Seat 1: JsC+WvfzqlxVs9G8/gSQAQ ($145.20 in chips)
Seat 2: ewN/vzF22+/gdzjIKBOlkA ($213.60 in chips)
Seat 3: 09BNF4quPDzanQzM8vc6WA ($36 in chips)
Seat 4: ygTTt5ehT4aF86q1a8/R+w ($160.10 in chips)
Seat 5: 2lOU1DcvUZaMcxZ95XfzXw ($71 in chips)
Seat 6: ORVqY3rf9X6ANA/8s+On2Q ($65.75 in chips)
JsC+WvfzqlxVs9G8/gSQAQ: posts small blind $1
ewN/vzF22+/gdzjIKBOlkA: posts big blind $2
*** HOLE CARDS ***
09BNF4quPDzanQzM8vc6WA: folds
ygTTt5ehT4aF86q1a8/R+w: folds
2lOU1DcvUZaMcxZ95XfzXw: folds
ORVqY3rf9X6ANA/8s+On2Q: folds
JsC+WvfzqlxVs9G8/gSQAQ: raises $4 to $6
ewN/vzF22+/gdzjIKBOlkA: calls $4
*** FLOP *** [6d 5s 3s]
JsC+WvfzqlxVs9G8/gSQAQ: bets $10
ewN/vzF22+/gdzjIKBOlkA: raises $20 to $30
JsC+WvfzqlxVs9G8/gSQAQ: folds
ewN/vzF22+/gdzjIKBOlkA collected $30.45 from pot
*** SUMMARY ***
Total pot $32 | Rake $1.55
Board [6d 5s 3s]
Seat 1: JsC+WvfzqlxVs9G8/gSQAQ (small blind) folded on the Flop
Seat 2: ewN/vzF22+/gdzjIKBOlkA (big blind) collected ($30.45)
Seat 3: 09BNF4quPDzanQzM8vc6WA folded before Flop (didn't bet)
Seat 4: ygTTt5ehT4aF86q1a8/R+w folded before Flop (didn't bet)
Seat 5: 2lOU1DcvUZaMcxZ95XfzXw folded before Flop (didn't bet)
Seat 6: ORVqY3rf9X6ANA/8s+On2Q (button) folded before Flop (didn't bet)



PokerStars Game #59940775114:  Hold'em No Limit ($1/$2) - 2009/07/01 1:16:13 ET
Table '/dyk+YdRGv90j2box35j8w' 6-max Seat #1 is the button
Seat 1: 8srN1dKQePlsv0GyTada+Q ($200 in chips)
Seat 2: qCnEYuAE5y5A7bk6fO5/jQ ($482.95 in chips)
Seat 3: sTPOWERd9HWPCNrDBwsVjA ($231.50 in chips)
Seat 4: z/u1YTnkiIDrtp/2cA2dBg ($125.65 in chips)
Seat 5: VvdR9F3I+2yELkfTVvC1dg ($200 in chips)
Seat 6: ZwvXzkkZ3XpMhKfAmVpahw ($369.25 in chips)
qCnEYuAE5y5A7bk6fO5/jQ: posts small blind $1
sTPOWERd9HWPCNrDBwsVjA: posts big blind $2
*** HOLE CARDS ***
z/u1YTnkiIDrtp/2cA2dBg: raises $4 to $6
VvdR9F3I+2yELkfTVvC1dg: folds
ZwvXzkkZ3XpMhKfAmVpahw: folds
8srN1dKQePlsv0GyTada+Q: folds
qCnEYuAE5y5A7bk6fO5/jQ: folds
sTPOWERd9HWPCNrDBwsVjA: folds
z/u1YTnkiIDrtp/2cA2dBg collected $5 from pot
*** SUMMARY ***
Total pot $5 | Rake $0
Seat 1: 8srN1dKQePlsv0GyTada+Q (button) folded before Flop (didn't bet)
Seat 2: qCnEYuAE5y5A7bk6fO5/jQ (small blind) folded before Flop
Seat 3: sTPOWERd9HWPCNrDBwsVjA (big blind) folded before Flop
Seat 4: z/u1YTnkiIDrtp/2cA2dBg collected ($5)
Seat 5: VvdR9F3I+2yELkfTVvC1dg folded before Flop (didn't bet)
Seat 6: ZwvXzkkZ3XpMhKfAmVpahw folded before Flop (didn't bet)



PokerStars Game #59940775064:  Hold'em No Limit ($1/$2) - 2009/07/01 1:16:13 ET
Table 'P/yCfYl1GfGsu/e6DxDy/A' 2-max Seat #2 is the button
Seat 1: 7fOCUy3x9hdkmXkkDNolGQ ($601.50 in chips)
Seat 2: RwDoM55ZeQuI2ADyJhOb2Q ($889.50 in chips)
RwDoM55ZeQuI2ADyJhOb2Q: posts small blind $1
7fOCUy3x9hdkmXkkDNolGQ: posts big blind $2
*** HOLE CARDS ***
RwDoM55ZeQuI2ADyJhOb2Q: raises $4 to $6
7fOCUy3x9hdkmXkkDNolGQ: calls $4
*** FLOP *** [Ad Jh Kd]
7fOCUy3x9hdkmXkkDNolGQ: checks
RwDoM55ZeQuI2ADyJhOb2Q: bets $10
7fOCUy3x9hdkmXkkDNolGQ: folds
RwDoM55ZeQuI2ADyJhOb2Q collected $11.50 from pot
RwDoM55ZeQuI2ADyJhOb2Q: doesn't show hand
*** SUMMARY ***
Total pot $12 | Rake $0.50
Board [Ad Jh Kd]
Seat 1: 7fOCUy3x9hdkmXkkDNolGQ (big blind) folded on the Flop
Seat 2: RwDoM55ZeQuI2ADyJhOb2Q (button) (small blind) collected ($11.50)



PokerStars Game #59940775688:  Hold'em No Limit ($1/$2) - 2009/07/01 1:16:14 ET
Table 'TsEDkiO4tzCTCzJ7tNdEqw' 6-max Seat #2 is the button
Seat 1: MfXQsYD8pGeCS7XOtyV+vw ($85.90 in chips)
Seat 2: 4dcDwIHRm96PwtqkpQiuiA ($59.70 in chips)
Seat 3: wgRvjVPZSQvqNGiyR1jwSA ($38 in chips)
Seat 4: K8MXCrNAVYlMnnCeM32Kxw ($57.05 in chips)
Seat 5: VvdR9F3I+2yELkfTVvC1dg ($205.50 in chips)
Seat 6: uCqEjnxh2/vFBjKYkfTOkw ($262.25 in chips)
wgRvjVPZSQvqNGiyR1jwSA: posts small blind $1
K8MXCrNAVYlMnnCeM32Kxw: posts big blind $2
*** HOLE CARDS ***
VvdR9F3I+2yELkfTVvC1dg: folds
uCqEjnxh2/vFBjKYkfTOkw: folds
MfXQsYD8pGeCS7XOtyV+vw: raises $6 to $8
4dcDwIHRm96PwtqkpQiuiA: folds
wgRvjVPZSQvqNGiyR1jwSA: folds
K8MXCrNAVYlMnnCeM32Kxw: folds
MfXQsYD8pGeCS7XOtyV+vw collected $5 from pot
MfXQsYD8pGeCS7XOtyV+vw: doesn't show hand
*** SUMMARY ***
Total pot $5 | Rake $0
Seat 1: MfXQsYD8pGeCS7XOtyV+vw collected ($5)
Seat 2: 4dcDwIHRm96PwtqkpQiuiA (button) folded before Flop (didn't bet)
Seat 3: wgRvjVPZSQvqNGiyR1jwSA (small blind) folded before Flop
Seat 4: K8MXCrNAVYlMnnCeM32Kxw (big blind) folded before Flop
Seat 5: VvdR9F3I+2yELkfTVvC1dg folded before Flop (didn't bet)
Seat 6: uCqEjnxh2/vFBjKYkfTOkw folded before Flop (didn't bet)



PokerStars Game #59940779996:  Hold'em No Limit ($1/$2) - 2009/07/01 1:16:22 ET
Table 'qVXak+oTeDXMGbWa4sDU5Q' 9-max Seat #9 is the button
Seat 1: H6Z4+qu8gR0VUiPOijndVg ($250.55 in chips)
Seat 2: rW/MyplHylMSBRaoRUzWrg ($40 in chips)
Seat 3: WUlHm+ydPPHG7Lb0rePSdA ($169.65 in chips)
Seat 4: lQYT23h5QCUVZAKxjOO39Q ($106.25 in chips)
Seat 5: FWGiDqRwvLeKmHq9t4Jy9w ($268 in chips)
Seat 6: GX1heJ+DSsvm7gzSPsYhhQ ($37 in chips)
Seat 7: PfmlvZlFiss79a6IoEr11g ($124.30 in chips)
Seat 8: TAfo4veNRaRlzDXMMYS3Jg ($41 in chips)
Seat 9: CkE3IyJF1KvdaAOmZY5XqQ ($200 in chips)
H6Z4+qu8gR0VUiPOijndVg: posts small blind $1
rW/MyplHylMSBRaoRUzWrg: posts big blind $2
*** HOLE CARDS ***
WUlHm+ydPPHG7Lb0rePSdA: folds
lQYT23h5QCUVZAKxjOO39Q: folds
FWGiDqRwvLeKmHq9t4Jy9w: folds
GX1heJ+DSsvm7gzSPsYhhQ: folds
PfmlvZlFiss79a6IoEr11g: folds
TAfo4veNRaRlzDXMMYS3Jg: folds
CkE3IyJF1KvdaAOmZY5XqQ: folds
H6Z4+qu8gR0VUiPOijndVg: folds
rW/MyplHylMSBRaoRUzWrg collected $2 from pot
*** SUMMARY ***
Total pot $2 | Rake $0
Seat 1: H6Z4+qu8gR0VUiPOijndVg (small blind) folded before Flop
Seat 2: rW/MyplHylMSBRaoRUzWrg (big blind) collected ($2)
Seat 3: WUlHm+ydPPHG7Lb0rePSdA folded before Flop (didn't bet)
Seat 4: lQYT23h5QCUVZAKxjOO39Q folded before Flop (didn't bet)
Seat 5: FWGiDqRwvLeKmHq9t4Jy9w folded before Flop (didn't bet)
Seat 6: GX1heJ+DSsvm7gzSPsYhhQ folded before Flop (didn't bet)
Seat 7: PfmlvZlFiss79a6IoEr11g folded before Flop (didn't bet)
Seat 8: TAfo4veNRaRlzDXMMYS3Jg folded before Flop (didn't bet)
Seat 9: CkE3IyJF1KvdaAOmZY5XqQ (button) folded before Flop (didn't bet)



PokerStars Game #59940780358:  Hold'em No Limit ($1/$2) - 2009/07/01 1:16:22 ET
Table '3WCXyaiCAbqSShQu7FIjvA' 9-max Seat #9 is the button
Seat 1: kTCkABD1UUldS9DFRGfCwQ ($116.60 in chips)
Seat 2: 1zQMh8lHgW3t2YhVeA+09A ($23.80 in chips)
Seat 3: 5Q8U6iZbeO7xJSS4qvDP5g ($200 in chips)
Seat 4: waEF/+pxZTxNo4FvsORuXg ($86 in chips)
Seat 5: CkE3IyJF1KvdaAOmZY5XqQ ($200 in chips)
Seat 6: 5jQlngvMSqM/WoonOcR5kw ($344.35 in chips)
Seat 7: QHxJjpVYwitg9krW6wZgJA ($200 in chips)
Seat 8: 1CtiZuXDFaJL1dJPQKyi8Q ($240.25 in chips)
Seat 9: FiXPLJyqb24l32QST2TInw ($96.60 in chips)
kTCkABD1UUldS9DFRGfCwQ: posts small blind $1
1zQMh8lHgW3t2YhVeA+09A: posts big blind $2
*** HOLE CARDS ***
5Q8U6iZbeO7xJSS4qvDP5g: raises $6 to $8
waEF/+pxZTxNo4FvsORuXg: folds
CkE3IyJF1KvdaAOmZY5XqQ: folds
5jQlngvMSqM/WoonOcR5kw: folds
QHxJjpVYwitg9krW6wZgJA: folds
1CtiZuXDFaJL1dJPQKyi8Q: folds
FiXPLJyqb24l32QST2TInw: folds
kTCkABD1UUldS9DFRGfCwQ: folds
1zQMh8lHgW3t2YhVeA+09A: folds
5Q8U6iZbeO7xJSS4qvDP5g collected $5 from pot
5Q8U6iZbeO7xJSS4qvDP5g: doesn't show hand
*** SUMMARY ***
Total pot $5 | Rake $0
Seat 1: kTCkABD1UUldS9DFRGfCwQ (small blind) folded before Flop
Seat 2: 1zQMh8lHgW3t2YhVeA+09A (big blind) folded before Flop
Seat 3: 5Q8U6iZbeO7xJSS4qvDP5g collected ($5)
Seat 4: waEF/+pxZTxNo4FvsORuXg folded before Flop (didn't bet)
Seat 5: CkE3IyJF1KvdaAOmZY5XqQ folded before Flop (didn't bet)
Seat 6: 5jQlngvMSqM/WoonOcR5kw folded before Flop (didn't bet)
Seat 7: QHxJjpVYwitg9krW6wZgJA folded before Flop (didn't bet)
Seat 8: 1CtiZuXDFaJL1dJPQKyi8Q folded before Flop (didn't bet)
Seat 9: FiXPLJyqb24l32QST2TInw (button) folded before Flop (didn't bet)



PokerStars Game #59940781074:  Hold'em No Limit ($1/$2) - 2009/07/01 1:16:24 ET
Table 'jlrIxbrVIG+gjaUYT4za8g' 6-max Seat #1 is the button
Seat 1: ygTTt5ehT4aF86q1a8/R+w ($225.30 in chips)
Seat 2: N18PrNGQj43J7TJuQuu+tw ($85.40 in chips)
Seat 4: 8srN1dKQePlsv0GyTada+Q ($299.10 in chips)
Seat 5: AyBB0k3Dcl7xbXUeGMw06g ($80.20 in chips)
Seat 6: vkfxu8f/jMYKUk6Ly4eujw ($240.75 in chips)
N18PrNGQj43J7TJuQuu+tw: posts small blind $1
8srN1dKQePlsv0GyTada+Q: posts big blind $2
*** HOLE CARDS ***
AyBB0k3Dcl7xbXUeGMw06g: folds
vkfxu8f/jMYKUk6Ly4eujw: folds
ygTTt5ehT4aF86q1a8/R+w: folds
N18PrNGQj43J7TJuQuu+tw: calls $1
8srN1dKQePlsv0GyTada+Q: raises $4 to $6
N18PrNGQj43J7TJuQuu+tw: calls $4
*** FLOP *** [5c 2c As]
N18PrNGQj43J7TJuQuu+tw: checks
8srN1dKQePlsv0GyTada+Q: bets $6
N18PrNGQj43J7TJuQuu+tw: raises $6 to $12
8srN1dKQePlsv0GyTada+Q: folds
N18PrNGQj43J7TJuQuu+tw collected $22.85 from pot
*** SUMMARY ***
Total pot $24 | Rake $1.15
Board [5c 2c As]
Seat 1: ygTTt5ehT4aF86q1a8/R+w (button) folded before Flop (didn't bet)
Seat 2: N18PrNGQj43J7TJuQuu+tw (small blind) collected ($22.85)
Seat 4: 8srN1dKQePlsv0GyTada+Q (big blind) folded on the Flop
Seat 5: AyBB0k3Dcl7xbXUeGMw06g folded before Flop (didn't bet)
Seat 6: vkfxu8f/jMYKUk6Ly4eujw folded before Flop (didn't bet)



PokerStars Game #59940781952:  Hold'em No Limit ($1/$2) - 2009/07/01 1:16:25 ET
Table 'ZzSIe0zTCDv+n6hfbY5tTg' 6-max Seat #1 is the button
Seat 1: VvdR9F3I+2yELkfTVvC1dg ($200 in chips)
Seat 2: B87ikIyZ/TzAVeXf38Ny0g ($238 in chips)
Seat 3: gsugPj31Hui3Jefl98MBOA ($124.30 in chips)
Seat 4: qXDd0ZyMIse0OBu8pxeQ3Q ($200 in chips)
Seat 5: 3dAbvkxS5NPQTBAbvpinVg ($501.30 in chips)
Seat 6: 09BNF4quPDzanQzM8vc6WA ($28.50 in chips)
B87ikIyZ/TzAVeXf38Ny0g: posts small blind $1
gsugPj31Hui3Jefl98MBOA: posts big blind $2
*** HOLE CARDS ***
qXDd0ZyMIse0OBu8pxeQ3Q: folds
3dAbvkxS5NPQTBAbvpinVg: folds
09BNF4quPDzanQzM8vc6WA: folds
VvdR9F3I+2yELkfTVvC1dg: raises $2 to $4
B87ikIyZ/TzAVeXf38Ny0g: folds
gsugPj31Hui3Jefl98MBOA: calls $2
*** FLOP *** [6d Qh Ad]
gsugPj31Hui3Jefl98MBOA: checks
VvdR9F3I+2yELkfTVvC1dg: checks
*** TURN *** [6d Qh Ad] [Ah]
gsugPj31Hui3Jefl98MBOA: checks
VvdR9F3I+2yELkfTVvC1dg: checks
*** RIVER *** [6d Qh Ad Ah] [5h]
gsugPj31Hui3Jefl98MBOA: checks
VvdR9F3I+2yELkfTVvC1dg: checks
*** SHOW DOWN ***
gsugPj31Hui3Jefl98MBOA: shows [2s 4d] (a pair of Aces)
VvdR9F3I+2yELkfTVvC1dg: shows [Js Tc] (a pair of Aces - Queen+Jack kicker)
VvdR9F3I+2yELkfTVvC1dg collected $8.55 from pot
*** SUMMARY ***
Total pot $9 | Rake $0.45
Board [6d Qh Ad Ah 5h]
Seat 1: VvdR9F3I+2yELkfTVvC1dg (button) showed [Js Tc] and won ($8.55) with a pair of Aces
Seat 2: B87ikIyZ/TzAVeXf38Ny0g (small blind) folded before Flop
Seat 3: gsugPj31Hui3Jefl98MBOA (big blind) showed [2s 4d] and lost with a pair of Aces
Seat 4: qXDd0ZyMIse0OBu8pxeQ3Q folded before Flop (didn't bet)
Seat 5: 3dAbvkxS5NPQTBAbvpinVg folded before Flop (didn't bet)
Seat 6: 09BNF4quPDzanQzM8vc6WA folded before Flop (didn't bet)



PokerStars Game #59940783662:  Hold'em No Limit ($1/$2) - 2009/07/01 1:16:28 ET
Table 'gnHBqWll9O3fxG7Ojkz/ng' 9-max Seat #6 is the button
Seat 2: H6Z4+qu8gR0VUiPOijndVg ($333.25 in chips)
Seat 3: 5Q8U6iZbeO7xJSS4qvDP5g ($218 in chips)
Seat 5: rBQDMkKm9cZn6M9NPsiVew ($239.45 in chips)
Seat 6: /inIs/z/PcX+TniIFpaxpg ($39 in chips)
Seat 7: jqui3xAWCkcdPW36a6BD+w ($345.40 in chips)
Seat 8: cM6efHzdxoqYm0EQKP4TTQ ($103.30 in chips)
Seat 9: sN6yR5I5zFq/WFyIz5UfzQ ($204 in chips)
jqui3xAWCkcdPW36a6BD+w: posts small blind $1
cM6efHzdxoqYm0EQKP4TTQ: posts big blind $2
TAfo4veNRaRlzDXMMYS3Jg: sits out
*** HOLE CARDS ***
sN6yR5I5zFq/WFyIz5UfzQ: folds
H6Z4+qu8gR0VUiPOijndVg: folds
5Q8U6iZbeO7xJSS4qvDP5g: folds
rBQDMkKm9cZn6M9NPsiVew: folds
/inIs/z/PcX+TniIFpaxpg: folds
jqui3xAWCkcdPW36a6BD+w: folds
cM6efHzdxoqYm0EQKP4TTQ collected $2 from pot
*** SUMMARY ***
Total pot $2 | Rake $0
Seat 2: H6Z4+qu8gR0VUiPOijndVg folded before Flop (didn't bet)
Seat 3: 5Q8U6iZbeO7xJSS4qvDP5g folded before Flop (didn't bet)
Seat 5: rBQDMkKm9cZn6M9NPsiVew folded before Flop (didn't bet)
Seat 6: /inIs/z/PcX+TniIFpaxpg (button) folded before Flop (didn't bet)
Seat 7: jqui3xAWCkcdPW36a6BD+w (small blind) folded before Flop
Seat 8: cM6efHzdxoqYm0EQKP4TTQ (big blind) collected ($2)
Seat 9: sN6yR5I5zFq/WFyIz5UfzQ folded before Flop (didn't bet)



PokerStars Game #59940784300:  Hold'em No Limit ($1/$2) - 2009/07/01 1:16:29 ET
Table 'pPQgcj9XT9CHBsbo1WTBug' 6-max Seat #6 is the button
Seat 1: DFVYDA6dKQy7R7mGIKogZA ($144.60 in chips)
Seat 2: qXDd0ZyMIse0OBu8pxeQ3Q ($212.95 in chips)
Seat 3: WfaZs12BkYO+BUX5VWpuWQ ($24.85 in chips)
Seat 4: gqlysXCbT8V54f/1lf9h3A ($42 in chips)
Seat 5: vkfxu8f/jMYKUk6Ly4eujw ($216.05 in chips)
Seat 6: Yr7pZltpy3IUNdKS9PCEiw ($279.90 in chips)
DFVYDA6dKQy7R7mGIKogZA: posts small blind $1
qXDd0ZyMIse0OBu8pxeQ3Q: posts big blind $2
*** HOLE CARDS ***
WfaZs12BkYO+BUX5VWpuWQ: folds
gqlysXCbT8V54f/1lf9h3A: raises $4 to $6
vkfxu8f/jMYKUk6Ly4eujw: folds
Yr7pZltpy3IUNdKS9PCEiw: folds
DFVYDA6dKQy7R7mGIKogZA: folds
qXDd0ZyMIse0OBu8pxeQ3Q: folds
gqlysXCbT8V54f/1lf9h3A collected $5 from pot
gqlysXCbT8V54f/1lf9h3A: doesn't show hand
*** SUMMARY ***
Total pot $5 | Rake $0
Seat 1: DFVYDA6dKQy7R7mGIKogZA (small blind) folded before Flop
Seat 2: qXDd0ZyMIse0OBu8pxeQ3Q (big blind) folded before Flop
Seat 3: WfaZs12BkYO+BUX5VWpuWQ folded before Flop (didn't bet)
Seat 4: gqlysXCbT8V54f/1lf9h3A collected ($5)
Seat 5: vkfxu8f/jMYKUk6Ly4eujw folded before Flop (didn't bet)
Seat 6: Yr7pZltpy3IUNdKS9PCEiw (button) folded before Flop (didn't bet)



PokerStars Game #59940785956:  Hold'em No Limit ($1/$2) - 2009/07/01 1:16:32 ET
Table 'P/yCfYl1GfGsu/e6DxDy/A' 2-max Seat #1 is the button
Seat 1: 7fOCUy3x9hdkmXkkDNolGQ ($595.50 in chips)
Seat 2: RwDoM55ZeQuI2ADyJhOb2Q ($895 in chips)
7fOCUy3x9hdkmXkkDNolGQ: posts small blind $1
RwDoM55ZeQuI2ADyJhOb2Q: posts big blind $2
*** HOLE CARDS ***
7fOCUy3x9hdkmXkkDNolGQ: raises $4 to $6
RwDoM55ZeQuI2ADyJhOb2Q: calls $4
*** FLOP *** [7s 3d 7c]
RwDoM55ZeQuI2ADyJhOb2Q: checks
7fOCUy3x9hdkmXkkDNolGQ: bets $8
RwDoM55ZeQuI2ADyJhOb2Q: raises $14 to $22
7fOCUy3x9hdkmXkkDNolGQ: folds
RwDoM55ZeQuI2ADyJhOb2Q collected $27.50 from pot
RwDoM55ZeQuI2ADyJhOb2Q: doesn't show hand
*** SUMMARY ***
Total pot $28 | Rake $0.50
Board [7s 3d 7c]
Seat 1: 7fOCUy3x9hdkmXkkDNolGQ (button) (small blind) folded on the Flop
Seat 2: RwDoM55ZeQuI2ADyJhOb2Q (big blind) collected ($27.50)



PokerStars Game #59940786896:  Hold'em No Limit ($1/$2) - 2009/07/01 1:16:34 ET
Table '+hSnXFQrGw1PlVgTnuj+sA' 6-max Seat #5 is the button
Seat 1: 2ccIJhDj+3JapvS7swVZEg ($269.50 in chips)
Seat 2: o9jamqIi6sTTRSqudgboRA ($277.55 in chips)
Seat 3: fE+LHW/7rpfXW14g8LhGjA ($54.65 in chips)
Seat 4: J4iH5epwXbmODnojR/VRxA ($187 in chips)
Seat 5: VvdR9F3I+2yELkfTVvC1dg ($200 in chips)
Seat 6: AuiGltq875lmaKHBsjZVGg ($109.40 in chips)
AuiGltq875lmaKHBsjZVGg: posts small blind $1
2ccIJhDj+3JapvS7swVZEg: posts big blind $2
*** HOLE CARDS ***
o9jamqIi6sTTRSqudgboRA: raises $5 to $7
fE+LHW/7rpfXW14g8LhGjA: folds
J4iH5epwXbmODnojR/VRxA: folds
VvdR9F3I+2yELkfTVvC1dg: folds
AuiGltq875lmaKHBsjZVGg: folds
2ccIJhDj+3JapvS7swVZEg: calls $5
*** FLOP *** [9d 6d Qd]
2ccIJhDj+3JapvS7swVZEg: checks
o9jamqIi6sTTRSqudgboRA: bets $12
2ccIJhDj+3JapvS7swVZEg: raises $12 to $24
o9jamqIi6sTTRSqudgboRA: folds
2ccIJhDj+3JapvS7swVZEg collected $37.10 from pot
*** SUMMARY ***
Total pot $39 | Rake $1.90
Board [9d 6d Qd]
Seat 1: 2ccIJhDj+3JapvS7swVZEg (big blind) collected ($37.10)
Seat 2: o9jamqIi6sTTRSqudgboRA folded on the Flop
Seat 3: fE+LHW/7rpfXW14g8LhGjA folded before Flop (didn't bet)
Seat 4: J4iH5epwXbmODnojR/VRxA folded before Flop (didn't bet)
Seat 5: VvdR9F3I+2yELkfTVvC1dg (button) folded before Flop (didn't bet)
Seat 6: AuiGltq875lmaKHBsjZVGg (small blind) folded before Flop



PokerStars Game #59940787088:  Hold'em No Limit ($1/$2) - 2009/07/01 1:16:34 ET
Table 'bJQ024BaYSBrW0sXpCZbNQ' 6-max Seat #6 is the button
Seat 1: PCN5rt4TwI1pQE+rAiqI0Q ($261.50 in chips)
Seat 2: 3dAbvkxS5NPQTBAbvpinVg ($208.85 in chips)
Seat 3: vkfxu8f/jMYKUk6Ly4eujw ($231 in chips)
Seat 6: 9dpyyjDTCed6nV7JhaUUpw ($333.95 in chips)
PCN5rt4TwI1pQE+rAiqI0Q: posts small blind $1
3dAbvkxS5NPQTBAbvpinVg: posts big blind $2
TBaQIN+sQ7eb7P99QnaORQ: sits out
VvdR9F3I+2yELkfTVvC1dg: sits out
*** HOLE CARDS ***
vkfxu8f/jMYKUk6Ly4eujw: folds
9dpyyjDTCed6nV7JhaUUpw: raises $4 to $6
PCN5rt4TwI1pQE+rAiqI0Q: calls $5
3dAbvkxS5NPQTBAbvpinVg: calls $4
*** FLOP *** [Jc 5s Ac]
PCN5rt4TwI1pQE+rAiqI0Q: checks
3dAbvkxS5NPQTBAbvpinVg: bets $12
9dpyyjDTCed6nV7JhaUUpw: folds
PCN5rt4TwI1pQE+rAiqI0Q: calls $12
*** TURN *** [Jc 5s Ac] [Qh]
PCN5rt4TwI1pQE+rAiqI0Q: checks
3dAbvkxS5NPQTBAbvpinVg: checks
*** RIVER *** [Jc 5s Ac Qh] [Ks]
PCN5rt4TwI1pQE+rAiqI0Q: bets $50
3dAbvkxS5NPQTBAbvpinVg: folds
PCN5rt4TwI1pQE+rAiqI0Q collected $40 from pot
*** SUMMARY ***
Total pot $42 | Rake $2
Board [Jc 5s Ac Qh Ks]
Seat 1: PCN5rt4TwI1pQE+rAiqI0Q (small blind) collected ($40)
Seat 2: 3dAbvkxS5NPQTBAbvpinVg (big blind) folded on the River
Seat 3: vkfxu8f/jMYKUk6Ly4eujw folded before Flop (didn't bet)
Seat 6: 9dpyyjDTCed6nV7JhaUUpw (button) folded on the Flop



PokerStars Game #59940787814:  Hold'em No Limit ($1/$2) - 2009/07/01 1:16:35 ET
Table 'aSf77Sj8QEnzcc0WaxVD4Q' 6-max Seat #5 is the button
Seat 1: UELtvp+JfwI7XDGVwSxZXA ($170.75 in chips)
Seat 3: 9dpyyjDTCed6nV7JhaUUpw ($228.35 in chips)
Seat 4: YsLQ3BAvgQHWXMAv3Wv6Hg ($261.40 in chips)
Seat 5: VvdR9F3I+2yELkfTVvC1dg ($200 in chips)
Seat 6: vkoJRf3gidxY1pPi0AFWww ($146.55 in chips)
vkoJRf3gidxY1pPi0AFWww: posts small blind $1
UELtvp+JfwI7XDGVwSxZXA: posts big blind $2
vkfxu8f/jMYKUk6Ly4eujw: sits out
*** HOLE CARDS ***
9dpyyjDTCed6nV7JhaUUpw: folds
YsLQ3BAvgQHWXMAv3Wv6Hg: raises $4 to $6
VvdR9F3I+2yELkfTVvC1dg: folds
vkoJRf3gidxY1pPi0AFWww: calls $5
UELtvp+JfwI7XDGVwSxZXA: folds
*** FLOP *** [7h Th 5h]
vkoJRf3gidxY1pPi0AFWww: checks
YsLQ3BAvgQHWXMAv3Wv6Hg: bets $10
vkoJRf3gidxY1pPi0AFWww: folds
YsLQ3BAvgQHWXMAv3Wv6Hg collected $13.30 from pot
YsLQ3BAvgQHWXMAv3Wv6Hg: doesn't show hand
*** SUMMARY ***
Total pot $14 | Rake $0.70
Board [7h Th 5h]
Seat 1: UELtvp+JfwI7XDGVwSxZXA (big blind) folded before Flop
Seat 3: 9dpyyjDTCed6nV7JhaUUpw folded before Flop (didn't bet)
Seat 4: YsLQ3BAvgQHWXMAv3Wv6Hg collected ($13.30)
Seat 5: VvdR9F3I+2yELkfTVvC1dg (button) folded before Flop (didn't bet)
Seat 6: vkoJRf3gidxY1pPi0AFWww (small blind) folded on the Flop



PokerStars Game #59940787698:  Hold'em No Limit ($1/$2) - 2009/07/01 1:16:35 ET
Table '/ci73fTmzTzmGWzAtqEX2Q' 9-max Seat #6 is the button
Seat 1: 9efVc1cB3yHt4TvBkTusPw ($145.95 in chips)
Seat 2: pN/Ip0ePsUVIdUlGgLrkUw ($233 in chips)
Seat 3: kK1+5ivyJZeA8hQF2pdvvQ ($119.10 in chips)
Seat 4: 2yq7Zp4xmrhAw8+37hTkaA ($97 in chips)
Seat 5: 1CtiZuXDFaJL1dJPQKyi8Q ($240.25 in chips)
Seat 6: GX1heJ+DSsvm7gzSPsYhhQ ($40 in chips)
Seat 7: rW/MyplHylMSBRaoRUzWrg ($41 in chips)
Seat 9: S8aS+9FTYQ/ICLBNThcrkg ($197 in chips)
rW/MyplHylMSBRaoRUzWrg: posts small blind $1
ri8CLkX3e9JF34dQNbsHGA: is sitting out
ri8CLkX3e9JF34dQNbsHGA leaves the table
S8aS+9FTYQ/ICLBNThcrkg: posts big blind $2
kK1+5ivyJZeA8hQF2pdvvQ: posts small & big blinds $3
*** HOLE CARDS ***
/inIs/z/PcX+TniIFpaxpg joins the table at seat #8
9efVc1cB3yHt4TvBkTusPw: folds
pN/Ip0ePsUVIdUlGgLrkUw: folds
kK1+5ivyJZeA8hQF2pdvvQ: checks
2yq7Zp4xmrhAw8+37hTkaA: folds
1CtiZuXDFaJL1dJPQKyi8Q: folds
GX1heJ+DSsvm7gzSPsYhhQ: calls $2
rW/MyplHylMSBRaoRUzWrg: folds
S8aS+9FTYQ/ICLBNThcrkg: checks
*** FLOP *** [Qc 8d Ad]
S8aS+9FTYQ/ICLBNThcrkg: checks
kK1+5ivyJZeA8hQF2pdvvQ: checks
GX1heJ+DSsvm7gzSPsYhhQ: checks
*** TURN *** [Qc 8d Ad] [4h]
S8aS+9FTYQ/ICLBNThcrkg: checks
kK1+5ivyJZeA8hQF2pdvvQ: checks
GX1heJ+DSsvm7gzSPsYhhQ: checks
*** RIVER *** [Qc 8d Ad 4h] [9s]
S8aS+9FTYQ/ICLBNThcrkg: bets $3
kK1+5ivyJZeA8hQF2pdvvQ: folds
GX1heJ+DSsvm7gzSPsYhhQ: raises $7 to $10
S8aS+9FTYQ/ICLBNThcrkg: calls $7
*** SHOW DOWN ***
GX1heJ+DSsvm7gzSPsYhhQ: shows [Js Th] (a straight, Eight to Queen)
S8aS+9FTYQ/ICLBNThcrkg: mucks hand
GX1heJ+DSsvm7gzSPsYhhQ collected $26.65 from pot
*** SUMMARY ***
Total pot $28 | Rake $1.35
Board [Qc 8d Ad 4h 9s]
Seat 1: 9efVc1cB3yHt4TvBkTusPw folded before Flop (didn't bet)
Seat 2: pN/Ip0ePsUVIdUlGgLrkUw folded before Flop (didn't bet)
Seat 3: kK1+5ivyJZeA8hQF2pdvvQ folded on the River
Seat 4: 2yq7Zp4xmrhAw8+37hTkaA folded before Flop (didn't bet)
Seat 5: 1CtiZuXDFaJL1dJPQKyi8Q folded before Flop (didn't bet)
Seat 6: GX1heJ+DSsvm7gzSPsYhhQ (button) showed [Js Th] and won ($26.65) with a straight, Eight to Queen
Seat 7: rW/MyplHylMSBRaoRUzWrg (small blind) folded before Flop
Seat 9: S8aS+9FTYQ/ICLBNThcrkg (big blind) mucked



PokerStars Game #59940788474:  Hold'em No Limit ($1/$2) - 2009/07/01 1:16:36 ET
Table 'QxerF7GUfCbl+4a8XaTB2w' 6-max Seat #1 is the button
Seat 1: o9jamqIi6sTTRSqudgboRA ($295.50 in chips)
Seat 2: vkfxu8f/jMYKUk6Ly4eujw ($197.80 in chips)
Seat 3: m7mYVfnCOK5TE/VkN/FhOg ($240.70 in chips)
Seat 4: 09BNF4quPDzanQzM8vc6WA ($43.55 in chips)
Seat 5: YsLQ3BAvgQHWXMAv3Wv6Hg ($200 in chips)
Seat 6: VvdR9F3I+2yELkfTVvC1dg ($214.55 in chips)
vkfxu8f/jMYKUk6Ly4eujw: posts small blind $1
m7mYVfnCOK5TE/VkN/FhOg: posts big blind $2
*** HOLE CARDS ***
09BNF4quPDzanQzM8vc6WA: folds
YsLQ3BAvgQHWXMAv3Wv6Hg: folds
VvdR9F3I+2yELkfTVvC1dg: raises $2 to $4
o9jamqIi6sTTRSqudgboRA: folds
vkfxu8f/jMYKUk6Ly4eujw: folds
m7mYVfnCOK5TE/VkN/FhOg: calls $2
*** FLOP *** [4d Qd 5s]
m7mYVfnCOK5TE/VkN/FhOg: checks
VvdR9F3I+2yELkfTVvC1dg: bets $6.40
m7mYVfnCOK5TE/VkN/FhOg: folds
VvdR9F3I+2yELkfTVvC1dg collected $8.55 from pot
VvdR9F3I+2yELkfTVvC1dg: doesn't show hand
*** SUMMARY ***
Total pot $9 | Rake $0.45
Board [4d Qd 5s]
Seat 1: o9jamqIi6sTTRSqudgboRA (button) folded before Flop (didn't bet)
Seat 2: vkfxu8f/jMYKUk6Ly4eujw (small blind) folded before Flop
Seat 3: m7mYVfnCOK5TE/VkN/FhOg (big blind) folded on the Flop
Seat 4: 09BNF4quPDzanQzM8vc6WA folded before Flop (didn't bet)
Seat 5: YsLQ3BAvgQHWXMAv3Wv6Hg folded before Flop (didn't bet)
Seat 6: VvdR9F3I+2yELkfTVvC1dg collected ($8.55)



PokerStars Game #59940789066:  Hold'em No Limit ($1/$2) - 2009/07/01 1:16:37 ET
Table 'YqGfR5eHfMeSjb9a+QU9rg' 9-max Seat #3 is the button
Seat 1: rW/MyplHylMSBRaoRUzWrg ($37 in chips)
Seat 2: W3Nqt1GWlTi9tXQXMNEvgw ($384.70 in chips)
Seat 3: /gll27k+xWYV7Fbki0lFDQ ($274.10 in chips)
Seat 4: QHxJjpVYwitg9krW6wZgJA ($206.15 in chips)
Seat 5: CkE3IyJF1KvdaAOmZY5XqQ ($200 in chips)
Seat 6: Fk6evwGYxWHokjvmdiD+6A ($73.35 in chips)
Seat 7: 41aZuLBz9nAi2GPVKabmCw ($119.75 in chips)
Seat 8: JnV3SM2D6dAFYyGZHHpvrg ($77.70 in chips)
Seat 9: /inIs/z/PcX+TniIFpaxpg ($206.05 in chips)
QHxJjpVYwitg9krW6wZgJA: posts small blind $1
CkE3IyJF1KvdaAOmZY5XqQ: posts big blind $2
*** HOLE CARDS ***
Fk6evwGYxWHokjvmdiD+6A: folds
41aZuLBz9nAi2GPVKabmCw: calls $2
JnV3SM2D6dAFYyGZHHpvrg: folds
/inIs/z/PcX+TniIFpaxpg: folds
rW/MyplHylMSBRaoRUzWrg: folds
Fk6evwGYxWHokjvmdiD+6A leaves the table
W3Nqt1GWlTi9tXQXMNEvgw: calls $2
/gll27k+xWYV7Fbki0lFDQ: calls $2
QHxJjpVYwitg9krW6wZgJA: calls $1
TAfo4veNRaRlzDXMMYS3Jg joins the table at seat #6
CkE3IyJF1KvdaAOmZY5XqQ: checks
*** FLOP *** [3d Tc 9s]
QHxJjpVYwitg9krW6wZgJA: checks
CkE3IyJF1KvdaAOmZY5XqQ: checks
41aZuLBz9nAi2GPVKabmCw: checks
W3Nqt1GWlTi9tXQXMNEvgw: checks
/gll27k+xWYV7Fbki0lFDQ: checks
*** TURN *** [3d Tc 9s] [8h]
QHxJjpVYwitg9krW6wZgJA: bets $4
CkE3IyJF1KvdaAOmZY5XqQ: folds
41aZuLBz9nAi2GPVKabmCw: folds
W3Nqt1GWlTi9tXQXMNEvgw: folds
/gll27k+xWYV7Fbki0lFDQ: calls $4
*** RIVER *** [3d Tc 9s 8h] [Kd]
QHxJjpVYwitg9krW6wZgJA: checks
/gll27k+xWYV7Fbki0lFDQ: checks
*** SHOW DOWN ***
QHxJjpVYwitg9krW6wZgJA: shows [As 9h] (a pair of Nines)
/gll27k+xWYV7Fbki0lFDQ: mucks hand
QHxJjpVYwitg9krW6wZgJA collected $17.15 from pot
*** SUMMARY ***
Total pot $18 | Rake $0.85
Board [3d Tc 9s 8h Kd]
Seat 1: rW/MyplHylMSBRaoRUzWrg folded before Flop (didn't bet)
Seat 2: W3Nqt1GWlTi9tXQXMNEvgw folded on the Turn
Seat 3: /gll27k+xWYV7Fbki0lFDQ (button) mucked
Seat 4: QHxJjpVYwitg9krW6wZgJA (small blind) showed [As 9h] and won ($17.15) with a pair of Nines
Seat 5: CkE3IyJF1KvdaAOmZY5XqQ (big blind) folded on the Turn
Seat 6: Fk6evwGYxWHokjvmdiD+6A folded before Flop (didn't bet)
Seat 7: 41aZuLBz9nAi2GPVKabmCw folded on the Turn
Seat 8: JnV3SM2D6dAFYyGZHHpvrg folded before Flop (didn't bet)
Seat 9: /inIs/z/PcX+TniIFpaxpg folded before Flop (didn't bet)



PokerStars Game #59940789512:  Hold'em No Limit ($1/$2) - 2009/07/01 1:16:38 ET
Table 'TsEDkiO4tzCTCzJ7tNdEqw' 6-max Seat #3 is the button
Seat 1: MfXQsYD8pGeCS7XOtyV+vw ($88.90 in chips)
Seat 2: 4dcDwIHRm96PwtqkpQiuiA ($59.70 in chips)
Seat 3: wgRvjVPZSQvqNGiyR1jwSA ($37 in chips)
Seat 4: K8MXCrNAVYlMnnCeM32Kxw ($55.05 in chips)
Seat 5: VvdR9F3I+2yELkfTVvC1dg ($205.50 in chips)
Seat 6: uCqEjnxh2/vFBjKYkfTOkw ($262.25 in chips)
K8MXCrNAVYlMnnCeM32Kxw: posts small blind $1
VvdR9F3I+2yELkfTVvC1dg: posts big blind $2
*** HOLE CARDS ***
uCqEjnxh2/vFBjKYkfTOkw: folds
MfXQsYD8pGeCS7XOtyV+vw: folds
4dcDwIHRm96PwtqkpQiuiA: calls $2
wgRvjVPZSQvqNGiyR1jwSA: folds
K8MXCrNAVYlMnnCeM32Kxw: raises $2 to $4
VvdR9F3I+2yELkfTVvC1dg: folds
4dcDwIHRm96PwtqkpQiuiA: calls $2
*** FLOP *** [Kc 2c Th]
K8MXCrNAVYlMnnCeM32Kxw: checks
4dcDwIHRm96PwtqkpQiuiA: bets $4
K8MXCrNAVYlMnnCeM32Kxw: folds
4dcDwIHRm96PwtqkpQiuiA collected $9.50 from pot
*** SUMMARY ***
Total pot $10 | Rake $0.50
Board [Kc 2c Th]
Seat 1: MfXQsYD8pGeCS7XOtyV+vw folded before Flop (didn't bet)
Seat 2: 4dcDwIHRm96PwtqkpQiuiA collected ($9.50)
Seat 3: wgRvjVPZSQvqNGiyR1jwSA (button) folded before Flop (didn't bet)
Seat 4: K8MXCrNAVYlMnnCeM32Kxw (small blind) folded on the Flop
Seat 5: VvdR9F3I+2yELkfTVvC1dg (big blind) folded before Flop
Seat 6: uCqEjnxh2/vFBjKYkfTOkw folded before Flop (didn't bet)



PokerStars Game #59940790590:  Hold'em No Limit ($1/$2) - 2009/07/01 1:16:40 ET
Table 'LL4bDFyhj5hsMpzaDugJZg' 6-max Seat #1 is the button
Seat 1: FwvID/fQGlpY3soi/lMTww ($77.90 in chips)
Seat 2: IZng3w8jiJHHp3LbYKLi4w ($41.50 in chips)
Seat 3: iI/NMpRxMkGieArQEhACSA ($282.70 in chips)
Seat 4: 8srN1dKQePlsv0GyTada+Q ($314.75 in chips)
Seat 5: A2GTwTiwkb1ilNWgW487Vg ($86.05 in chips)
Seat 6: 692Q4sfB0gTElzS0WMeg+A ($217.10 in chips)
IZng3w8jiJHHp3LbYKLi4w: posts small blind $1
iI/NMpRxMkGieArQEhACSA: posts big blind $2
*** HOLE CARDS ***
8srN1dKQePlsv0GyTada+Q: folds
A2GTwTiwkb1ilNWgW487Vg: calls $2
692Q4sfB0gTElzS0WMeg+A: folds
FwvID/fQGlpY3soi/lMTww: folds
IZng3w8jiJHHp3LbYKLi4w: calls $1
iI/NMpRxMkGieArQEhACSA: checks
*** FLOP *** [8s Td 7h]
IZng3w8jiJHHp3LbYKLi4w: checks
iI/NMpRxMkGieArQEhACSA: checks
A2GTwTiwkb1ilNWgW487Vg: bets $2
IZng3w8jiJHHp3LbYKLi4w: calls $2
iI/NMpRxMkGieArQEhACSA: folds
*** TURN *** [8s Td 7h] [As]
IZng3w8jiJHHp3LbYKLi4w: checks
A2GTwTiwkb1ilNWgW487Vg: bets $2
IZng3w8jiJHHp3LbYKLi4w: calls $2
*** RIVER *** [8s Td 7h As] [Qs]
IZng3w8jiJHHp3LbYKLi4w: checks
A2GTwTiwkb1ilNWgW487Vg: bets $7
IZng3w8jiJHHp3LbYKLi4w: calls $7
*** SHOW DOWN ***
A2GTwTiwkb1ilNWgW487Vg: shows [Ts Tc] (three of a kind, Tens)
IZng3w8jiJHHp3LbYKLi4w: mucks hand
A2GTwTiwkb1ilNWgW487Vg collected $26.65 from pot
*** SUMMARY ***
Total pot $28 | Rake $1.35
Board [8s Td 7h As Qs]
Seat 1: FwvID/fQGlpY3soi/lMTww (button) folded before Flop (didn't bet)
Seat 2: IZng3w8jiJHHp3LbYKLi4w (small blind) mucked
Seat 3: iI/NMpRxMkGieArQEhACSA (big blind) folded on the Flop
Seat 4: 8srN1dKQePlsv0GyTada+Q folded before Flop (didn't bet)
Seat 5: A2GTwTiwkb1ilNWgW487Vg showed [Ts Tc] and won ($26.65) with three of a kind, Tens
Seat 6: 692Q4sfB0gTElzS0WMeg+A folded before Flop (didn't bet)



PokerStars Game #59940791538:  Hold'em No Limit ($1/$2) - 2009/07/01 1:16:42 ET
Table '8Y6PEyoNuepZTai2Q56aHw' 9-max Seat #1 is the button
Seat 1: 5Q8U6iZbeO7xJSS4qvDP5g ($272 in chips)
Seat 2: gDCJIAlovbPnTvMM7Dd1gA ($181.35 in chips)
Seat 3: WUlHm+ydPPHG7Lb0rePSdA ($120 in chips)
Seat 4: xKkwALG38OfLQ9DXuJgR1w ($288.55 in chips)
Seat 5: QHxJjpVYwitg9krW6wZgJA ($259.65 in chips)
Seat 6: NtLDBSjsJQEKekh5cdinvw ($353.80 in chips)
Seat 7: Kzta8yu9vxHT4B70mjBZ+w ($200 in chips)
Seat 8: rW/MyplHylMSBRaoRUzWrg ($40 in chips)
Seat 9: F7m34OOfAQ7annesMHVjKw ($98.80 in chips)
gDCJIAlovbPnTvMM7Dd1gA: posts small blind $1
WUlHm+ydPPHG7Lb0rePSdA: posts big blind $2
*** HOLE CARDS ***
xKkwALG38OfLQ9DXuJgR1w: folds
QHxJjpVYwitg9krW6wZgJA: folds
NtLDBSjsJQEKekh5cdinvw: folds
Kzta8yu9vxHT4B70mjBZ+w: folds
rW/MyplHylMSBRaoRUzWrg: folds
F7m34OOfAQ7annesMHVjKw: folds
5Q8U6iZbeO7xJSS4qvDP5g: raises $4 to $6
gDCJIAlovbPnTvMM7Dd1gA: folds
WUlHm+ydPPHG7Lb0rePSdA: folds
5Q8U6iZbeO7xJSS4qvDP5g collected $5 from pot
5Q8U6iZbeO7xJSS4qvDP5g: doesn't show hand
*** SUMMARY ***
Total pot $5 | Rake $0
Seat 1: 5Q8U6iZbeO7xJSS4qvDP5g (button) collected ($5)
Seat 2: gDCJIAlovbPnTvMM7Dd1gA (small blind) folded before Flop
Seat 3: WUlHm+ydPPHG7Lb0rePSdA (big blind) folded before Flop
Seat 4: xKkwALG38OfLQ9DXuJgR1w folded before Flop (didn't bet)
Seat 5: QHxJjpVYwitg9krW6wZgJA folded before Flop (didn't bet)
Seat 6: NtLDBSjsJQEKekh5cdinvw folded before Flop (didn't bet)
Seat 7: Kzta8yu9vxHT4B70mjBZ+w folded before Flop (didn't bet)
Seat 8: rW/MyplHylMSBRaoRUzWrg folded before Flop (didn't bet)
Seat 9: F7m34OOfAQ7annesMHVjKw folded before Flop (didn't bet)



PokerStars Game #59940792116:  Hold'em No Limit ($1/$2) - 2009/07/01 1:16:43 ET
Table '/dyk+YdRGv90j2box35j8w' 6-max Seat #2 is the button
Seat 1: 8srN1dKQePlsv0GyTada+Q ($200 in chips)
Seat 2: qCnEYuAE5y5A7bk6fO5/jQ ($481.95 in chips)
Seat 3: sTPOWERd9HWPCNrDBwsVjA ($229.50 in chips)
Seat 4: z/u1YTnkiIDrtp/2cA2dBg ($128.65 in chips)
Seat 5: VvdR9F3I+2yELkfTVvC1dg ($200 in chips)
Seat 6: ZwvXzkkZ3XpMhKfAmVpahw ($369.25 in chips)
sTPOWERd9HWPCNrDBwsVjA: posts small blind $1
z/u1YTnkiIDrtp/2cA2dBg: posts big blind $2
*** HOLE CARDS ***
VvdR9F3I+2yELkfTVvC1dg: folds
ZwvXzkkZ3XpMhKfAmVpahw: folds
8srN1dKQePlsv0GyTada+Q has timed out
8srN1dKQePlsv0GyTada+Q: folds
8srN1dKQePlsv0GyTada+Q is sitting out
qCnEYuAE5y5A7bk6fO5/jQ: raises $4 to $6
sTPOWERd9HWPCNrDBwsVjA: folds
z/u1YTnkiIDrtp/2cA2dBg: folds
qCnEYuAE5y5A7bk6fO5/jQ collected $5 from pot
qCnEYuAE5y5A7bk6fO5/jQ: doesn't show hand
*** SUMMARY ***
Total pot $5 | Rake $0
Seat 1: 8srN1dKQePlsv0GyTada+Q folded before Flop (didn't bet)
Seat 2: qCnEYuAE5y5A7bk6fO5/jQ (button) collected ($5)
Seat 3: sTPOWERd9HWPCNrDBwsVjA (small blind) folded before Flop
Seat 4: z/u1YTnkiIDrtp/2cA2dBg (big blind) folded before Flop
Seat 5: VvdR9F3I+2yELkfTVvC1dg folded before Flop (didn't bet)
Seat 6: ZwvXzkkZ3XpMhKfAmVpahw folded before Flop (didn't bet)



PokerStars Game #59940794998:  Hold'em No Limit ($1/$2) - 2009/07/01 1:16:48 ET
Table 'qVXak+oTeDXMGbWa4sDU5Q' 9-max Seat #1 is the button
Seat 1: H6Z4+qu8gR0VUiPOijndVg ($249.55 in chips)
Seat 2: rW/MyplHylMSBRaoRUzWrg ($41 in chips)
Seat 3: WUlHm+ydPPHG7Lb0rePSdA ($169.65 in chips)
Seat 4: lQYT23h5QCUVZAKxjOO39Q ($106.25 in chips)
Seat 5: FWGiDqRwvLeKmHq9t4Jy9w ($268 in chips)
Seat 6: GX1heJ+DSsvm7gzSPsYhhQ ($37 in chips)
Seat 7: PfmlvZlFiss79a6IoEr11g ($124.30 in chips)
Seat 8: TAfo4veNRaRlzDXMMYS3Jg ($41 in chips)
Seat 9: CkE3IyJF1KvdaAOmZY5XqQ ($200 in chips)
rW/MyplHylMSBRaoRUzWrg: posts small blind $1
WUlHm+ydPPHG7Lb0rePSdA: posts big blind $2
*** HOLE CARDS ***
lQYT23h5QCUVZAKxjOO39Q: folds
FWGiDqRwvLeKmHq9t4Jy9w: folds
GX1heJ+DSsvm7gzSPsYhhQ: folds
PfmlvZlFiss79a6IoEr11g: folds
TAfo4veNRaRlzDXMMYS3Jg: folds
CkE3IyJF1KvdaAOmZY5XqQ: folds
H6Z4+qu8gR0VUiPOijndVg: folds
rW/MyplHylMSBRaoRUzWrg: folds
WUlHm+ydPPHG7Lb0rePSdA collected $2 from pot
WUlHm+ydPPHG7Lb0rePSdA: doesn't show hand
*** SUMMARY ***
Total pot $2 | Rake $0
Seat 1: H6Z4+qu8gR0VUiPOijndVg (button) folded before Flop (didn't bet)
Seat 2: rW/MyplHylMSBRaoRUzWrg (small blind) folded before Flop
Seat 3: WUlHm+ydPPHG7Lb0rePSdA (big blind) collected ($2)
Seat 4: lQYT23h5QCUVZAKxjOO39Q folded before Flop (didn't bet)
Seat 5: FWGiDqRwvLeKmHq9t4Jy9w folded before Flop (didn't bet)
Seat 6: GX1heJ+DSsvm7gzSPsYhhQ folded before Flop (didn't bet)
Seat 7: PfmlvZlFiss79a6IoEr11g folded before Flop (didn't bet)
Seat 8: TAfo4veNRaRlzDXMMYS3Jg folded before Flop (didn't bet)
Seat 9: CkE3IyJF1KvdaAOmZY5XqQ folded before Flop (didn't bet)



PokerStars Game #59940796520:  Hold'em No Limit ($1/$2) - 2009/07/01 1:16:50 ET
Table 'NmY84NAf9Mh0ckAckHnh5g' 2-max Seat #1 is the button
Seat 1: 6hvg964TSqZ3AL/0XK9aVQ ($200 in chips)
Seat 2: RwDoM55ZeQuI2ADyJhOb2Q ($812.10 in chips)
6hvg964TSqZ3AL/0XK9aVQ: posts small blind $1
RwDoM55ZeQuI2ADyJhOb2Q: posts big blind $2
*** HOLE CARDS ***
6hvg964TSqZ3AL/0XK9aVQ: calls $1
RwDoM55ZeQuI2ADyJhOb2Q: checks
*** FLOP *** [Kc 9s 4d]
RwDoM55ZeQuI2ADyJhOb2Q: checks
6hvg964TSqZ3AL/0XK9aVQ: checks
*** TURN *** [Kc 9s 4d] [Ah]
RwDoM55ZeQuI2ADyJhOb2Q: bets $4
6hvg964TSqZ3AL/0XK9aVQ: folds
RwDoM55ZeQuI2ADyJhOb2Q collected $3.80 from pot
RwDoM55ZeQuI2ADyJhOb2Q: doesn't show hand
*** SUMMARY ***
Total pot $4 | Rake $0.20
Board [Kc 9s 4d Ah]
Seat 1: 6hvg964TSqZ3AL/0XK9aVQ (button) (small blind) folded on the Turn
Seat 2: RwDoM55ZeQuI2ADyJhOb2Q (big blind) collected ($3.80)



PokerStars Game #59940796638:  Hold'em No Limit ($1/$2) - 2009/07/01 1:16:51 ET
Table 'P/yCfYl1GfGsu/e6DxDy/A' 2-max Seat #2 is the button
Seat 1: 7fOCUy3x9hdkmXkkDNolGQ ($581.50 in chips)
Seat 2: RwDoM55ZeQuI2ADyJhOb2Q ($908.50 in chips)
RwDoM55ZeQuI2ADyJhOb2Q: posts small blind $1
7fOCUy3x9hdkmXkkDNolGQ: posts big blind $2
*** HOLE CARDS ***
RwDoM55ZeQuI2ADyJhOb2Q: raises $4 to $6
7fOCUy3x9hdkmXkkDNolGQ: folds
RwDoM55ZeQuI2ADyJhOb2Q collected $4 from pot
RwDoM55ZeQuI2ADyJhOb2Q: doesn't show hand
*** SUMMARY ***
Total pot $4 | Rake $0
Seat 1: 7fOCUy3x9hdkmXkkDNolGQ (big blind) folded before Flop
Seat 2: RwDoM55ZeQuI2ADyJhOb2Q (button) (small blind) collected ($4)



PokerStars Game #59940797374:  Hold'em No Limit ($1/$2) - 2009/07/01 1:16:52 ET
Table 'kq5zaQ+1hLNf8LZfGnbTAA' 6-max Seat #2 is the button
Seat 1: 8srN1dKQePlsv0GyTada+Q ($246 in chips)
Seat 2: nXDI8Y/S6POzRwANu3d8hQ ($41.75 in chips)
Seat 3: vkfxu8f/jMYKUk6Ly4eujw ($220.70 in chips)
Seat 4: 3dAbvkxS5NPQTBAbvpinVg ($200 in chips)
Seat 5: kfASJqTbXek+zc8ZKsZL1Q ($129.35 in chips)
Seat 6: mfy7uGZcqA2PVQqEVbJ7+g ($202.25 in chips)
vkfxu8f/jMYKUk6Ly4eujw: posts small blind $1
3dAbvkxS5NPQTBAbvpinVg: posts big blind $2
*** HOLE CARDS ***
kfASJqTbXek+zc8ZKsZL1Q: raises $4 to $6
mfy7uGZcqA2PVQqEVbJ7+g: folds
8srN1dKQePlsv0GyTada+Q: calls $6
nXDI8Y/S6POzRwANu3d8hQ: folds
vkfxu8f/jMYKUk6Ly4eujw: folds
3dAbvkxS5NPQTBAbvpinVg: calls $4
*** FLOP *** [Ad 3s 8c]
3dAbvkxS5NPQTBAbvpinVg: checks
kfASJqTbXek+zc8ZKsZL1Q: bets $18
8srN1dKQePlsv0GyTada+Q: folds
3dAbvkxS5NPQTBAbvpinVg: folds
kfASJqTbXek+zc8ZKsZL1Q collected $18.05 from pot
kfASJqTbXek+zc8ZKsZL1Q: doesn't show hand
*** SUMMARY ***
Total pot $19 | Rake $0.95
Board [Ad 3s 8c]
Seat 1: 8srN1dKQePlsv0GyTada+Q folded on the Flop
Seat 2: nXDI8Y/S6POzRwANu3d8hQ (button) folded before Flop (didn't bet)
Seat 3: vkfxu8f/jMYKUk6Ly4eujw (small blind) folded before Flop
Seat 4: 3dAbvkxS5NPQTBAbvpinVg (big blind) folded on the Flop
Seat 5: kfASJqTbXek+zc8ZKsZL1Q collected ($18.05)
Seat 6: mfy7uGZcqA2PVQqEVbJ7+g folded before Flop (didn't bet)



PokerStars Game #59940798080:  Hold'em No Limit ($1/$2) - 2009/07/01 1:16:53 ET
Table 'mGpP9StWRnoeiBDExc6Frg' 6-max Seat #1 is the button
Seat 1: VvdR9F3I+2yELkfTVvC1dg ($200 in chips)
Seat 2: dZcLsEI8iXkobBduRJ45Yw ($64 in chips)
Seat 3: 7acrZUQC3Zc9BNLjoKIcLQ ($40 in chips)
Seat 4: 4dcDwIHRm96PwtqkpQiuiA ($46.35 in chips)
Seat 5: d1puGuVBE0fidn+5eRJ0tw ($230.20 in chips)
Seat 6: B2Ih1sr5VZk+8He7rcrMtQ ($459.35 in chips)
dZcLsEI8iXkobBduRJ45Yw: posts small blind $1
7acrZUQC3Zc9BNLjoKIcLQ: posts big blind $2
*** HOLE CARDS ***
4dcDwIHRm96PwtqkpQiuiA: folds
d1puGuVBE0fidn+5eRJ0tw: folds
B2Ih1sr5VZk+8He7rcrMtQ: raises $6 to $8
VvdR9F3I+2yELkfTVvC1dg: folds
dZcLsEI8iXkobBduRJ45Yw: folds
7acrZUQC3Zc9BNLjoKIcLQ: folds
B2Ih1sr5VZk+8He7rcrMtQ collected $5 from pot
*** SUMMARY ***
Total pot $5 | Rake $0
Seat 1: VvdR9F3I+2yELkfTVvC1dg (button) folded before Flop (didn't bet)
Seat 2: dZcLsEI8iXkobBduRJ45Yw (small blind) folded before Flop
Seat 3: 7acrZUQC3Zc9BNLjoKIcLQ (big blind) folded before Flop
Seat 4: 4dcDwIHRm96PwtqkpQiuiA folded before Flop (didn't bet)
Seat 5: d1puGuVBE0fidn+5eRJ0tw folded before Flop (didn't bet)
Seat 6: B2Ih1sr5VZk+8He7rcrMtQ collected ($5)



PokerStars Game #59940799770:  Hold'em No Limit ($1/$2) - 2009/07/01 1:16:56 ET
Table 'CFkQcfWjKccZaZDf71FK+w' 6-max Seat #1 is the button
Seat 1: JsC+WvfzqlxVs9G8/gSQAQ ($129.20 in chips)
Seat 2: ewN/vzF22+/gdzjIKBOlkA ($228.05 in chips)
Seat 3: 09BNF4quPDzanQzM8vc6WA ($36 in chips)
Seat 4: ygTTt5ehT4aF86q1a8/R+w ($160.10 in chips)
Seat 5: 2lOU1DcvUZaMcxZ95XfzXw ($71 in chips)
Seat 6: ORVqY3rf9X6ANA/8s+On2Q ($65.75 in chips)
ewN/vzF22+/gdzjIKBOlkA: posts small blind $1
09BNF4quPDzanQzM8vc6WA: posts big blind $2
*** HOLE CARDS ***
ygTTt5ehT4aF86q1a8/R+w: folds
2lOU1DcvUZaMcxZ95XfzXw: folds
ORVqY3rf9X6ANA/8s+On2Q: calls $2
JsC+WvfzqlxVs9G8/gSQAQ: calls $2
ewN/vzF22+/gdzjIKBOlkA: folds
09BNF4quPDzanQzM8vc6WA: checks
*** FLOP *** [3h 2d Kd]
09BNF4quPDzanQzM8vc6WA: checks
ORVqY3rf9X6ANA/8s+On2Q: checks
JsC+WvfzqlxVs9G8/gSQAQ: bets $6
09BNF4quPDzanQzM8vc6WA: folds
ORVqY3rf9X6ANA/8s+On2Q: calls $6
*** TURN *** [3h 2d Kd] [6h]
ORVqY3rf9X6ANA/8s+On2Q: checks
JsC+WvfzqlxVs9G8/gSQAQ: bets $10
ORVqY3rf9X6ANA/8s+On2Q: folds
JsC+WvfzqlxVs9G8/gSQAQ collected $18.10 from pot
*** SUMMARY ***
Total pot $19 | Rake $0.90
Board [3h 2d Kd 6h]
Seat 1: JsC+WvfzqlxVs9G8/gSQAQ (button) collected ($18.10)
Seat 2: ewN/vzF22+/gdzjIKBOlkA (small blind) folded before Flop
Seat 3: 09BNF4quPDzanQzM8vc6WA (big blind) folded on the Flop
Seat 4: ygTTt5ehT4aF86q1a8/R+w folded before Flop (didn't bet)
Seat 5: 2lOU1DcvUZaMcxZ95XfzXw folded before Flop (didn't bet)
Seat 6: ORVqY3rf9X6ANA/8s+On2Q folded on the Turn



PokerStars Game #59940799680:  Hold'em No Limit ($1/$2) - 2009/07/01 1:16:56 ET
Table 'pPQgcj9XT9CHBsbo1WTBug' 6-max Seat #1 is the button
Seat 1: DFVYDA6dKQy7R7mGIKogZA ($143.60 in chips)
Seat 2: qXDd0ZyMIse0OBu8pxeQ3Q ($210.95 in chips)
Seat 3: WfaZs12BkYO+BUX5VWpuWQ ($24.85 in chips)
Seat 4: gqlysXCbT8V54f/1lf9h3A ($45 in chips)
Seat 5: vkfxu8f/jMYKUk6Ly4eujw ($216.05 in chips)
Seat 6: Yr7pZltpy3IUNdKS9PCEiw ($279.90 in chips)
qXDd0ZyMIse0OBu8pxeQ3Q: posts small blind $1
WfaZs12BkYO+BUX5VWpuWQ: posts big blind $2
*** HOLE CARDS ***
gqlysXCbT8V54f/1lf9h3A: folds
vkfxu8f/jMYKUk6Ly4eujw: raises $6 to $8
Yr7pZltpy3IUNdKS9PCEiw: calls $8
DFVYDA6dKQy7R7mGIKogZA: folds
qXDd0ZyMIse0OBu8pxeQ3Q: folds
WfaZs12BkYO+BUX5VWpuWQ: folds
*** FLOP *** [2s 5d Qs]
vkfxu8f/jMYKUk6Ly4eujw: bets $18
Yr7pZltpy3IUNdKS9PCEiw: folds
vkfxu8f/jMYKUk6Ly4eujw collected $18.05 from pot
vkfxu8f/jMYKUk6Ly4eujw: doesn't show hand
*** SUMMARY ***
Total pot $19 | Rake $0.95
Board [2s 5d Qs]
Seat 1: DFVYDA6dKQy7R7mGIKogZA (button) folded before Flop (didn't bet)
Seat 2: qXDd0ZyMIse0OBu8pxeQ3Q (small blind) folded before Flop
Seat 3: WfaZs12BkYO+BUX5VWpuWQ (big blind) folded before Flop
Seat 4: gqlysXCbT8V54f/1lf9h3A folded before Flop (didn't bet)
Seat 5: vkfxu8f/jMYKUk6Ly4eujw collected ($18.05)
Seat 6: Yr7pZltpy3IUNdKS9PCEiw folded on the Flop



PokerStars Game #59940799972:  Hold'em No Limit ($1/$2) - 2009/07/01 1:16:57 ET
Table 'rsKRKlGHlxVyqJxzO2a2Ow' 9-max Seat #1 is the button
Seat 1: uYWfQJg2hgHLxri6/uVJiw ($260.95 in chips)
Seat 2: QHxJjpVYwitg9krW6wZgJA ($262.80 in chips)
Seat 3: zTcFtoHqqK4550YMZ8Y14Q ($67.50 in chips)
Seat 4: 31HuO+DQxppUQEedBWukug ($100 in chips)
Seat 5: 5Q8U6iZbeO7xJSS4qvDP5g ($200 in chips)
Seat 6: H6Z4+qu8gR0VUiPOijndVg ($200 in chips)
Seat 7: MPc9Txt5QGkXwb2uAZipEA ($76.25 in chips)
Seat 8: CkE3IyJF1KvdaAOmZY5XqQ ($217.75 in chips)
Seat 9: gRbvhSUVg+TNaTjaJecIRw ($78 in chips)
QHxJjpVYwitg9krW6wZgJA: posts small blind $1
zTcFtoHqqK4550YMZ8Y14Q: posts big blind $2
*** HOLE CARDS ***
31HuO+DQxppUQEedBWukug: folds
5Q8U6iZbeO7xJSS4qvDP5g: folds
H6Z4+qu8gR0VUiPOijndVg: folds
MPc9Txt5QGkXwb2uAZipEA: raises $4 to $6
CkE3IyJF1KvdaAOmZY5XqQ has timed out
CkE3IyJF1KvdaAOmZY5XqQ: folds
CkE3IyJF1KvdaAOmZY5XqQ is sitting out
gRbvhSUVg+TNaTjaJecIRw: calls $6
CkE3IyJF1KvdaAOmZY5XqQ has returned
uYWfQJg2hgHLxri6/uVJiw: calls $6
QHxJjpVYwitg9krW6wZgJA: folds
zTcFtoHqqK4550YMZ8Y14Q: calls $4
*** FLOP *** [Js 6s 8d]
zTcFtoHqqK4550YMZ8Y14Q: checks
MPc9Txt5QGkXwb2uAZipEA: bets $12
gRbvhSUVg+TNaTjaJecIRw: folds
uYWfQJg2hgHLxri6/uVJiw: calls $12
zTcFtoHqqK4550YMZ8Y14Q: folds
*** TURN *** [Js 6s 8d] [Jc]
MPc9Txt5QGkXwb2uAZipEA: bets $30
uYWfQJg2hgHLxri6/uVJiw: raises $30 to $60
MPc9Txt5QGkXwb2uAZipEA: calls $28.25 and is all-in
*** RIVER *** [Js 6s 8d Jc] [6c]
*** SHOW DOWN ***
MPc9Txt5QGkXwb2uAZipEA: shows [Ah Kh] (two pair, Jacks and Sixes)
uYWfQJg2hgHLxri6/uVJiw: shows [Jh 9d] (a full house, Jacks full of Sixes)
uYWfQJg2hgHLxri6/uVJiw collected $162.50 from pot
*** SUMMARY ***
Total pot $165.50 | Rake $3
Board [Js 6s 8d Jc 6c]
Seat 1: uYWfQJg2hgHLxri6/uVJiw (button) showed [Jh 9d] and won ($162.50) with a full house, Jacks full of Sixes
Seat 2: QHxJjpVYwitg9krW6wZgJA (small blind) folded before Flop
Seat 3: zTcFtoHqqK4550YMZ8Y14Q (big blind) folded on the Flop
Seat 4: 31HuO+DQxppUQEedBWukug folded before Flop (didn't bet)
Seat 5: 5Q8U6iZbeO7xJSS4qvDP5g folded before Flop (didn't bet)
Seat 6: H6Z4+qu8gR0VUiPOijndVg folded before Flop (didn't bet)
Seat 7: MPc9Txt5QGkXwb2uAZipEA showed [Ah Kh] and lost with two pair, Jacks and Sixes
Seat 8: CkE3IyJF1KvdaAOmZY5XqQ folded before Flop (didn't bet)
Seat 9: gRbvhSUVg+TNaTjaJecIRw folded on the Flop



PokerStars Game #59940800438:  Hold'em No Limit ($1/$2) - 2009/07/01 1:16:57 ET
Table 'P/yCfYl1GfGsu/e6DxDy/A' 2-max Seat #1 is the button
Seat 1: 7fOCUy3x9hdkmXkkDNolGQ ($579.50 in chips)
Seat 2: RwDoM55ZeQuI2ADyJhOb2Q ($910.50 in chips)
7fOCUy3x9hdkmXkkDNolGQ: posts small blind $1
RwDoM55ZeQuI2ADyJhOb2Q: posts big blind $2
*** HOLE CARDS ***
7fOCUy3x9hdkmXkkDNolGQ: folds
RwDoM55ZeQuI2ADyJhOb2Q collected $2 from pot
RwDoM55ZeQuI2ADyJhOb2Q: doesn't show hand
*** SUMMARY ***
Total pot $2 | Rake $0
Seat 1: 7fOCUy3x9hdkmXkkDNolGQ (button) (small blind) folded before Flop
Seat 2: RwDoM55ZeQuI2ADyJhOb2Q (big blind) collected ($2)



PokerStars Game #59940801294:  Hold'em No Limit ($1/$2) - 2009/07/01 1:16:59 ET
Table '3WCXyaiCAbqSShQu7FIjvA' 9-max Seat #1 is the button
Seat 1: kTCkABD1UUldS9DFRGfCwQ ($115.60 in chips)
Seat 2: 1zQMh8lHgW3t2YhVeA+09A ($21.80 in chips)
Seat 3: 5Q8U6iZbeO7xJSS4qvDP5g ($203 in chips)
Seat 4: waEF/+pxZTxNo4FvsORuXg ($86 in chips)
Seat 5: CkE3IyJF1KvdaAOmZY5XqQ ($200 in chips)
Seat 6: 5jQlngvMSqM/WoonOcR5kw ($344.35 in chips)
Seat 7: QHxJjpVYwitg9krW6wZgJA ($200 in chips)
Seat 8: 1CtiZuXDFaJL1dJPQKyi8Q ($240.25 in chips)
Seat 9: FiXPLJyqb24l32QST2TInw ($96.60 in chips)
1zQMh8lHgW3t2YhVeA+09A: posts small blind $1
5Q8U6iZbeO7xJSS4qvDP5g: posts big blind $2
*** HOLE CARDS ***
waEF/+pxZTxNo4FvsORuXg: calls $2
CkE3IyJF1KvdaAOmZY5XqQ: folds
5jQlngvMSqM/WoonOcR5kw: folds
QHxJjpVYwitg9krW6wZgJA: folds
1CtiZuXDFaJL1dJPQKyi8Q: calls $2
FiXPLJyqb24l32QST2TInw: raises $4 to $6
kTCkABD1UUldS9DFRGfCwQ: folds
1zQMh8lHgW3t2YhVeA+09A: folds
5Q8U6iZbeO7xJSS4qvDP5g: folds
waEF/+pxZTxNo4FvsORuXg: calls $4
1CtiZuXDFaJL1dJPQKyi8Q: calls $4
*** FLOP *** [7c Kc 8d]
waEF/+pxZTxNo4FvsORuXg: checks
1CtiZuXDFaJL1dJPQKyi8Q: checks
FiXPLJyqb24l32QST2TInw: bets $6
waEF/+pxZTxNo4FvsORuXg: folds
1CtiZuXDFaJL1dJPQKyi8Q: folds
FiXPLJyqb24l32QST2TInw collected $19.95 from pot
FiXPLJyqb24l32QST2TInw: doesn't show hand
*** SUMMARY ***
Total pot $21 | Rake $1.05
Board [7c Kc 8d]
Seat 1: kTCkABD1UUldS9DFRGfCwQ (button) folded before Flop (didn't bet)
Seat 2: 1zQMh8lHgW3t2YhVeA+09A (small blind) folded before Flop
Seat 3: 5Q8U6iZbeO7xJSS4qvDP5g (big blind) folded before Flop
Seat 4: waEF/+pxZTxNo4FvsORuXg folded on the Flop
Seat 5: CkE3IyJF1KvdaAOmZY5XqQ folded before Flop (didn't bet)
Seat 6: 5jQlngvMSqM/WoonOcR5kw folded before Flop (didn't bet)
Seat 7: QHxJjpVYwitg9krW6wZgJA folded before Flop (didn't bet)
Seat 8: 1CtiZuXDFaJL1dJPQKyi8Q folded on the Flop
Seat 9: FiXPLJyqb24l32QST2TInw collected ($19.95)



PokerStars Game #59940801950:  Hold'em No Limit ($1/$2) - 2009/07/01 1:17:00 ET
Table 'W9UeSV0aoPjh5SFSxM8jUQ' 9-max Seat #4 is the button
Seat 1: mIKx5lhIt13X5eZQH0ZeMA ($37 in chips)
Seat 2: iMe5yhc+1BaiIPHet3NMrA ($255.60 in chips)
Seat 3: /inIs/z/PcX+TniIFpaxpg ($25 in chips)
Seat 4: LjOrlR1DLUQ+KE0gh7hP6Q ($92.40 in chips)
Seat 5: ri8CLkX3e9JF34dQNbsHGA ($43.45 in chips)
Seat 6: j47DM+lqTfzZP8musviQTg ($96.50 in chips)
Seat 7: I2ipWauytvrkEer4XD3Sjg ($118 in chips)
Seat 8: odhvI/CZeMsPyo1n1U7+hA ($49.70 in chips)
Seat 9: Q104K4iDGcqOlVrjAkzPEA ($31 in chips)
ri8CLkX3e9JF34dQNbsHGA: posts small blind $1
j47DM+lqTfzZP8musviQTg: posts big blind $2
*** HOLE CARDS ***
I2ipWauytvrkEer4XD3Sjg: folds
odhvI/CZeMsPyo1n1U7+hA: raises $6 to $8
Q104K4iDGcqOlVrjAkzPEA: folds
mIKx5lhIt13X5eZQH0ZeMA: folds
iMe5yhc+1BaiIPHet3NMrA: folds
/inIs/z/PcX+TniIFpaxpg: folds
LjOrlR1DLUQ+KE0gh7hP6Q: folds
ri8CLkX3e9JF34dQNbsHGA: folds
j47DM+lqTfzZP8musviQTg: folds
odhvI/CZeMsPyo1n1U7+hA collected $5 from pot
*** SUMMARY ***
Total pot $5 | Rake $0
Seat 1: mIKx5lhIt13X5eZQH0ZeMA folded before Flop (didn't bet)
Seat 2: iMe5yhc+1BaiIPHet3NMrA folded before Flop (didn't bet)
Seat 3: /inIs/z/PcX+TniIFpaxpg folded before Flop (didn't bet)
Seat 4: LjOrlR1DLUQ+KE0gh7hP6Q (button) folded before Flop (didn't bet)
Seat 5: ri8CLkX3e9JF34dQNbsHGA (small blind) folded before Flop
Seat 6: j47DM+lqTfzZP8musviQTg (big blind) folded before Flop
Seat 7: I2ipWauytvrkEer4XD3Sjg folded before Flop (didn't bet)
Seat 8: odhvI/CZeMsPyo1n1U7+hA collected ($5)
Seat 9: Q104K4iDGcqOlVrjAkzPEA folded before Flop (didn't bet)



PokerStars Game #59940803104:  Hold'em No Limit ($1/$2) - 2009/07/01 1:17:02 ET
Table 'ZzSIe0zTCDv+n6hfbY5tTg' 6-max Seat #2 is the button
Seat 1: VvdR9F3I+2yELkfTVvC1dg ($204.55 in chips)
Seat 2: B87ikIyZ/TzAVeXf38Ny0g ($237 in chips)
Seat 3: gsugPj31Hui3Jefl98MBOA ($200 in chips)
Seat 4: qXDd0ZyMIse0OBu8pxeQ3Q ($200 in chips)
Seat 5: 3dAbvkxS5NPQTBAbvpinVg ($501.30 in chips)
Seat 6: 09BNF4quPDzanQzM8vc6WA ($28.50 in chips)
gsugPj31Hui3Jefl98MBOA: posts small blind $1
qXDd0ZyMIse0OBu8pxeQ3Q: posts big blind $2
*** HOLE CARDS ***
3dAbvkxS5NPQTBAbvpinVg: folds
09BNF4quPDzanQzM8vc6WA: folds
VvdR9F3I+2yELkfTVvC1dg: folds
B87ikIyZ/TzAVeXf38Ny0g: raises $4 to $6
gsugPj31Hui3Jefl98MBOA: folds
qXDd0ZyMIse0OBu8pxeQ3Q: folds
B87ikIyZ/TzAVeXf38Ny0g collected $5 from pot
B87ikIyZ/TzAVeXf38Ny0g: doesn't show hand
*** SUMMARY ***
Total pot $5 | Rake $0
Seat 1: VvdR9F3I+2yELkfTVvC1dg folded before Flop (didn't bet)
Seat 2: B87ikIyZ/TzAVeXf38Ny0g (button) collected ($5)
Seat 3: gsugPj31Hui3Jefl98MBOA (small blind) folded before Flop
Seat 4: qXDd0ZyMIse0OBu8pxeQ3Q (big blind) folded before Flop
Seat 5: 3dAbvkxS5NPQTBAbvpinVg folded before Flop (didn't bet)
Seat 6: 09BNF4quPDzanQzM8vc6WA folded before Flop (didn't bet)



PokerStars Game #59940804070:  Hold'em No Limit ($1/$2) - 2009/07/01 1:17:03 ET
Table 'P/yCfYl1GfGsu/e6DxDy/A' 2-max Seat #2 is the button
Seat 1: 7fOCUy3x9hdkmXkkDNolGQ ($578.50 in chips)
Seat 2: RwDoM55ZeQuI2ADyJhOb2Q ($911.50 in chips)
RwDoM55ZeQuI2ADyJhOb2Q: posts small blind $1
7fOCUy3x9hdkmXkkDNolGQ: posts big blind $2
*** HOLE CARDS ***
RwDoM55ZeQuI2ADyJhOb2Q: raises $4 to $6
7fOCUy3x9hdkmXkkDNolGQ: folds
RwDoM55ZeQuI2ADyJhOb2Q collected $4 from pot
RwDoM55ZeQuI2ADyJhOb2Q: doesn't show hand
*** SUMMARY ***
Total pot $4 | Rake $0
Seat 1: 7fOCUy3x9hdkmXkkDNolGQ (big blind) folded before Flop
Seat 2: RwDoM55ZeQuI2ADyJhOb2Q (button) (small blind) collected ($4)



PokerStars Game #59940805504:  Hold'em No Limit ($1/$2) - 2009/07/01 1:17:06 ET
Table 'aSf77Sj8QEnzcc0WaxVD4Q' 6-max Seat #6 is the button
Seat 1: UELtvp+JfwI7XDGVwSxZXA ($168.75 in chips)
Seat 2: vkfxu8f/jMYKUk6Ly4eujw ($200 in chips)
Seat 3: 9dpyyjDTCed6nV7JhaUUpw ($228.35 in chips)
Seat 4: YsLQ3BAvgQHWXMAv3Wv6Hg ($268.70 in chips)
Seat 5: VvdR9F3I+2yELkfTVvC1dg ($200 in chips)
Seat 6: vkoJRf3gidxY1pPi0AFWww ($140.55 in chips)
UELtvp+JfwI7XDGVwSxZXA: posts small blind $1
vkfxu8f/jMYKUk6Ly4eujw: posts big blind $2
*** HOLE CARDS ***
9dpyyjDTCed6nV7JhaUUpw: folds
YsLQ3BAvgQHWXMAv3Wv6Hg: folds
VvdR9F3I+2yELkfTVvC1dg: folds
vkoJRf3gidxY1pPi0AFWww: folds
UELtvp+JfwI7XDGVwSxZXA: calls $1
vkfxu8f/jMYKUk6Ly4eujw: checks
*** FLOP *** [Jh 5c 5s]
UELtvp+JfwI7XDGVwSxZXA: checks
vkfxu8f/jMYKUk6Ly4eujw: checks
*** TURN *** [Jh 5c 5s] [7d]
UELtvp+JfwI7XDGVwSxZXA: checks
vkfxu8f/jMYKUk6Ly4eujw: bets $3
UELtvp+JfwI7XDGVwSxZXA: folds
vkfxu8f/jMYKUk6Ly4eujw collected $3.80 from pot
vkfxu8f/jMYKUk6Ly4eujw: doesn't show hand
*** SUMMARY ***
Total pot $4 | Rake $0.20
Board [Jh 5c 5s 7d]
Seat 1: UELtvp+JfwI7XDGVwSxZXA (small blind) folded on the Turn
Seat 2: vkfxu8f/jMYKUk6Ly4eujw (big blind) collected ($3.80)
Seat 3: 9dpyyjDTCed6nV7JhaUUpw folded before Flop (didn't bet)
Seat 4: YsLQ3BAvgQHWXMAv3Wv6Hg folded before Flop (didn't bet)
Seat 5: VvdR9F3I+2yELkfTVvC1dg folded before Flop (didn't bet)
Seat 6: vkoJRf3gidxY1pPi0AFWww (button) folded before Flop (didn't bet)



PokerStars Game #59940806192:  Hold'em No Limit ($1/$2) - 2009/07/01 1:17:07 ET
Table 'NmY84NAf9Mh0ckAckHnh5g' 2-max Seat #2 is the button
Seat 1: 6hvg964TSqZ3AL/0XK9aVQ ($198 in chips)
Seat 2: RwDoM55ZeQuI2ADyJhOb2Q ($813.90 in chips)
RwDoM55ZeQuI2ADyJhOb2Q: posts small blind $1
6hvg964TSqZ3AL/0XK9aVQ: posts big blind $2
*** HOLE CARDS ***
RwDoM55ZeQuI2ADyJhOb2Q: raises $4 to $6
6hvg964TSqZ3AL/0XK9aVQ: raises $6 to $12
RwDoM55ZeQuI2ADyJhOb2Q: calls $6
*** FLOP *** [4d 2d Qs]
6hvg964TSqZ3AL/0XK9aVQ: checks
RwDoM55ZeQuI2ADyJhOb2Q: bets $10
6hvg964TSqZ3AL/0XK9aVQ: calls $10
*** TURN *** [4d 2d Qs] [5s]
6hvg964TSqZ3AL/0XK9aVQ: checks
RwDoM55ZeQuI2ADyJhOb2Q: bets $22
6hvg964TSqZ3AL/0XK9aVQ: calls $22
*** RIVER *** [4d 2d Qs 5s] [Kc]
6hvg964TSqZ3AL/0XK9aVQ: checks
RwDoM55ZeQuI2ADyJhOb2Q: checks
*** SHOW DOWN ***
6hvg964TSqZ3AL/0XK9aVQ: shows [Ac Kd] (a pair of Kings)
RwDoM55ZeQuI2ADyJhOb2Q: mucks hand
6hvg964TSqZ3AL/0XK9aVQ collected $87.50 from pot
*** SUMMARY ***
Total pot $88 | Rake $0.50
Board [4d 2d Qs 5s Kc]
Seat 1: 6hvg964TSqZ3AL/0XK9aVQ (big blind) showed [Ac Kd] and won ($87.50) with a pair of Kings
Seat 2: RwDoM55ZeQuI2ADyJhOb2Q (button) (small blind) mucked



PokerStars Game #59940806630:  Hold'em No Limit ($1/$2) - 2009/07/01 1:17:08 ET
Table 'QxerF7GUfCbl+4a8XaTB2w' 6-max Seat #2 is the button
Seat 1: o9jamqIi6sTTRSqudgboRA ($295.50 in chips)
Seat 2: vkfxu8f/jMYKUk6Ly4eujw ($196.80 in chips)
Seat 3: m7mYVfnCOK5TE/VkN/FhOg ($236.70 in chips)
Seat 4: 09BNF4quPDzanQzM8vc6WA ($43.55 in chips)
Seat 5: YsLQ3BAvgQHWXMAv3Wv6Hg ($200 in chips)
Seat 6: VvdR9F3I+2yELkfTVvC1dg ($219.10 in chips)
m7mYVfnCOK5TE/VkN/FhOg: posts small blind $1
09BNF4quPDzanQzM8vc6WA: posts big blind $2
*** HOLE CARDS ***
YsLQ3BAvgQHWXMAv3Wv6Hg: folds
VvdR9F3I+2yELkfTVvC1dg: raises $2 to $4
o9jamqIi6sTTRSqudgboRA: folds
vkfxu8f/jMYKUk6Ly4eujw: folds
m7mYVfnCOK5TE/VkN/FhOg: calls $3
09BNF4quPDzanQzM8vc6WA: folds
*** FLOP *** [7d 3h Tc]
m7mYVfnCOK5TE/VkN/FhOg: checks
VvdR9F3I+2yELkfTVvC1dg: bets $7.10
m7mYVfnCOK5TE/VkN/FhOg: folds
VvdR9F3I+2yELkfTVvC1dg collected $9.50 from pot
VvdR9F3I+2yELkfTVvC1dg: doesn't show hand
*** SUMMARY ***
Total pot $10 | Rake $0.50
Board [7d 3h Tc]
Seat 1: o9jamqIi6sTTRSqudgboRA folded before Flop (didn't bet)
Seat 2: vkfxu8f/jMYKUk6Ly4eujw (button) folded before Flop (didn't bet)
Seat 3: m7mYVfnCOK5TE/VkN/FhOg (small blind) folded on the Flop
Seat 4: 09BNF4quPDzanQzM8vc6WA (big blind) folded before Flop
Seat 5: YsLQ3BAvgQHWXMAv3Wv6Hg folded before Flop (didn't bet)
Seat 6: VvdR9F3I+2yELkfTVvC1dg collected ($9.50)



PokerStars Game #59940806528:  Hold'em No Limit ($1/$2) - 2009/07/01 1:17:08 ET
Table 'rKeCh+eBn4RNvybCUYkoTQ' 9-max Seat #7 is the button
Seat 1: /inIs/z/PcX+TniIFpaxpg ($206 in chips)
Seat 2: 9cBHwK40Tl06vheE7B3LHQ ($150.25 in chips)
Seat 4: 31HuO+DQxppUQEedBWukug ($98.10 in chips)
Seat 5: WUlHm+ydPPHG7Lb0rePSdA ($120 in chips)
Seat 6: EBV6OktyeSmh4w6sWmcWOw ($270 in chips)
Seat 7: rW/MyplHylMSBRaoRUzWrg ($37 in chips)
Seat 8: pN/Ip0ePsUVIdUlGgLrkUw ($207 in chips)
Seat 9: Kzta8yu9vxHT4B70mjBZ+w ($211.25 in chips)
pN/Ip0ePsUVIdUlGgLrkUw: posts small blind $1
Kzta8yu9vxHT4B70mjBZ+w: posts big blind $2
*** HOLE CARDS ***
R9FzbEg1XYsiOty4kvbqhg leaves the table
/inIs/z/PcX+TniIFpaxpg: folds
9cBHwK40Tl06vheE7B3LHQ: calls $2
31HuO+DQxppUQEedBWukug: folds
WUlHm+ydPPHG7Lb0rePSdA: folds
EBV6OktyeSmh4w6sWmcWOw: folds
GX1heJ+DSsvm7gzSPsYhhQ joins the table at seat #3
rW/MyplHylMSBRaoRUzWrg: folds
pN/Ip0ePsUVIdUlGgLrkUw: raises $6 to $8
Kzta8yu9vxHT4B70mjBZ+w: folds
9cBHwK40Tl06vheE7B3LHQ: calls $6
*** FLOP *** [Jc As 9c]
pN/Ip0ePsUVIdUlGgLrkUw: bets $10
9cBHwK40Tl06vheE7B3LHQ: folds
pN/Ip0ePsUVIdUlGgLrkUw collected $17.10 from pot
pN/Ip0ePsUVIdUlGgLrkUw: doesn't show hand
*** SUMMARY ***
Total pot $18 | Rake $0.90
Board [Jc As 9c]
Seat 1: /inIs/z/PcX+TniIFpaxpg folded before Flop (didn't bet)
Seat 2: 9cBHwK40Tl06vheE7B3LHQ folded on the Flop
Seat 4: 31HuO+DQxppUQEedBWukug folded before Flop (didn't bet)
Seat 5: WUlHm+ydPPHG7Lb0rePSdA folded before Flop (didn't bet)
Seat 6: EBV6OktyeSmh4w6sWmcWOw folded before Flop (didn't bet)
Seat 7: rW/MyplHylMSBRaoRUzWrg (button) folded before Flop (didn't bet)
Seat 8: pN/Ip0ePsUVIdUlGgLrkUw (small blind) collected ($17.10)
Seat 9: Kzta8yu9vxHT4B70mjBZ+w (big blind) folded before Flop



PokerStars Game #59940807416:  Hold'em No Limit ($1/$2) - 2009/07/01 1:17:09 ET
Table 'dBLpiMEy1cezkSKD+ZpCcw' 2-max Seat #2 is the button
Seat 1: NFRtU1s5+WFh9EKwu+KLOQ ($200 in chips)
Seat 2: 4rrQUikeMSkuWGHgW80++w ($200 in chips)
4rrQUikeMSkuWGHgW80++w: posts small blind $1
NFRtU1s5+WFh9EKwu+KLOQ: posts big blind $2
*** HOLE CARDS ***
4rrQUikeMSkuWGHgW80++w: folds
NFRtU1s5+WFh9EKwu+KLOQ collected $2 from pot
*** SUMMARY ***
Total pot $2 | Rake $0
Seat 1: NFRtU1s5+WFh9EKwu+KLOQ (big blind) collected ($2)
Seat 2: 4rrQUikeMSkuWGHgW80++w (button) (small blind) folded before Flop



PokerStars Game #59940807854:  Hold'em No Limit ($1/$2) - 2009/07/01 1:17:10 ET
Table 'P/yCfYl1GfGsu/e6DxDy/A' 2-max Seat #1 is the button
Seat 1: 7fOCUy3x9hdkmXkkDNolGQ ($576.50 in chips)
Seat 2: RwDoM55ZeQuI2ADyJhOb2Q ($913.50 in chips)
7fOCUy3x9hdkmXkkDNolGQ: posts small blind $1
RwDoM55ZeQuI2ADyJhOb2Q: posts big blind $2
*** HOLE CARDS ***
7fOCUy3x9hdkmXkkDNolGQ: raises $4 to $6
RwDoM55ZeQuI2ADyJhOb2Q: calls $4
*** FLOP *** [7h Th 4s]
RwDoM55ZeQuI2ADyJhOb2Q: checks
7fOCUy3x9hdkmXkkDNolGQ: checks
*** TURN *** [7h Th 4s] [2d]
RwDoM55ZeQuI2ADyJhOb2Q: bets $8
7fOCUy3x9hdkmXkkDNolGQ: calls $8
*** RIVER *** [7h Th 4s 2d] [5h]
RwDoM55ZeQuI2ADyJhOb2Q: bets $22
7fOCUy3x9hdkmXkkDNolGQ: folds
RwDoM55ZeQuI2ADyJhOb2Q collected $27.50 from pot
RwDoM55ZeQuI2ADyJhOb2Q: doesn't show hand
*** SUMMARY ***
Total pot $28 | Rake $0.50
Board [7h Th 4s 2d 5h]
Seat 1: 7fOCUy3x9hdkmXkkDNolGQ (button) (small blind) folded on the River
Seat 2: RwDoM55ZeQuI2ADyJhOb2Q (big blind) collected ($27.50)



PokerStars Game #59940808178:  Hold'em No Limit ($1/$2) - 2009/07/01 1:17:11 ET
Table '8Y6PEyoNuepZTai2Q56aHw' 9-max Seat #2 is the button
Seat 1: 5Q8U6iZbeO7xJSS4qvDP5g ($275 in chips)
Seat 2: gDCJIAlovbPnTvMM7Dd1gA ($180.35 in chips)
Seat 3: WUlHm+ydPPHG7Lb0rePSdA ($120 in chips)
Seat 4: xKkwALG38OfLQ9DXuJgR1w ($288.55 in chips)
Seat 5: QHxJjpVYwitg9krW6wZgJA ($259.65 in chips)
Seat 6: NtLDBSjsJQEKekh5cdinvw ($353.80 in chips)
Seat 7: Kzta8yu9vxHT4B70mjBZ+w ($200 in chips)
Seat 8: rW/MyplHylMSBRaoRUzWrg ($40 in chips)
Seat 9: F7m34OOfAQ7annesMHVjKw ($98.80 in chips)
WUlHm+ydPPHG7Lb0rePSdA: posts small blind $1
xKkwALG38OfLQ9DXuJgR1w: posts big blind $2
*** HOLE CARDS ***
QHxJjpVYwitg9krW6wZgJA: folds
QHxJjpVYwitg9krW6wZgJA is sitting out
NtLDBSjsJQEKekh5cdinvw: folds
Kzta8yu9vxHT4B70mjBZ+w: folds
rW/MyplHylMSBRaoRUzWrg: folds
F7m34OOfAQ7annesMHVjKw: raises $2 to $4
5Q8U6iZbeO7xJSS4qvDP5g: raises $12 to $16
gDCJIAlovbPnTvMM7Dd1gA: folds
WUlHm+ydPPHG7Lb0rePSdA: folds
xKkwALG38OfLQ9DXuJgR1w: folds
F7m34OOfAQ7annesMHVjKw: folds
5Q8U6iZbeO7xJSS4qvDP5g collected $11 from pot
5Q8U6iZbeO7xJSS4qvDP5g: doesn't show hand
*** SUMMARY ***
Total pot $11 | Rake $0
Seat 1: 5Q8U6iZbeO7xJSS4qvDP5g collected ($11)
Seat 2: gDCJIAlovbPnTvMM7Dd1gA (button) folded before Flop (didn't bet)
Seat 3: WUlHm+ydPPHG7Lb0rePSdA (small blind) folded before Flop
Seat 4: xKkwALG38OfLQ9DXuJgR1w (big blind) folded before Flop
Seat 5: QHxJjpVYwitg9krW6wZgJA folded before Flop (didn't bet)
Seat 6: NtLDBSjsJQEKekh5cdinvw folded before Flop (didn't bet)
Seat 7: Kzta8yu9vxHT4B70mjBZ+w folded before Flop (didn't bet)
Seat 8: rW/MyplHylMSBRaoRUzWrg folded before Flop (didn't bet)
Seat 9: F7m34OOfAQ7annesMHVjKw folded before Flop



PokerStars Game #59940810192:  Hold'em No Limit ($1/$2) - 2009/07/01 1:17:14 ET
Table 'ztv6V3FN2bQ9nmJPPdx6nQ' 6-max Seat #6 is the button
Seat 2: 5Y+ZGWLI4gnlpApDX5vy1A ($395.85 in chips)
Seat 4: UaZ5yj+6LjtWqMQg2QskUw ($115.80 in chips)
Seat 5: sTPOWERd9HWPCNrDBwsVjA ($264 in chips)
Seat 6: mfy7uGZcqA2PVQqEVbJ7+g ($112.45 in chips)
5Y+ZGWLI4gnlpApDX5vy1A: posts small blind $1
UaZ5yj+6LjtWqMQg2QskUw: posts big blind $2
*** HOLE CARDS ***
sTPOWERd9HWPCNrDBwsVjA: folds
mfy7uGZcqA2PVQqEVbJ7+g: folds
5Y+ZGWLI4gnlpApDX5vy1A: raises $8 to $10
UaZ5yj+6LjtWqMQg2QskUw: folds
342gZYfwWuuNOnZaoysV6A leaves the table
5Y+ZGWLI4gnlpApDX5vy1A collected $4 from pot
5Y+ZGWLI4gnlpApDX5vy1A: doesn't show hand
*** SUMMARY ***
Total pot $4 | Rake $0
Seat 2: 5Y+ZGWLI4gnlpApDX5vy1A (small blind) collected ($4)
Seat 4: UaZ5yj+6LjtWqMQg2QskUw (big blind) folded before Flop
Seat 5: sTPOWERd9HWPCNrDBwsVjA folded before Flop (didn't bet)
Seat 6: mfy7uGZcqA2PVQqEVbJ7+g (button) folded before Flop (didn't bet)



PokerStars Game #59940811204:  Hold'em No Limit ($1/$2) - 2009/07/01 1:17:16 ET
Table 'mGpP9StWRnoeiBDExc6Frg' 6-max Seat #2 is the button
Seat 1: VvdR9F3I+2yELkfTVvC1dg ($200 in chips)
Seat 2: dZcLsEI8iXkobBduRJ45Yw ($63 in chips)
Seat 3: 7acrZUQC3Zc9BNLjoKIcLQ ($38 in chips)
Seat 4: 4dcDwIHRm96PwtqkpQiuiA ($46.35 in chips)
Seat 5: d1puGuVBE0fidn+5eRJ0tw ($230.20 in chips)
Seat 6: B2Ih1sr5VZk+8He7rcrMtQ ($462.35 in chips)
7acrZUQC3Zc9BNLjoKIcLQ: posts small blind $1
4dcDwIHRm96PwtqkpQiuiA: posts big blind $2
*** HOLE CARDS ***
d1puGuVBE0fidn+5eRJ0tw: folds
B2Ih1sr5VZk+8He7rcrMtQ: folds
VvdR9F3I+2yELkfTVvC1dg: folds
dZcLsEI8iXkobBduRJ45Yw: raises $2 to $4
7acrZUQC3Zc9BNLjoKIcLQ: raises $4 to $8
4dcDwIHRm96PwtqkpQiuiA: folds
dZcLsEI8iXkobBduRJ45Yw: calls $4
*** FLOP *** [Jc Qs Qc]
7acrZUQC3Zc9BNLjoKIcLQ: bets $12
dZcLsEI8iXkobBduRJ45Yw: folds
7acrZUQC3Zc9BNLjoKIcLQ collected $17.10 from pot
*** SUMMARY ***
Total pot $18 | Rake $0.90
Board [Jc Qs Qc]
Seat 1: VvdR9F3I+2yELkfTVvC1dg folded before Flop (didn't bet)
Seat 2: dZcLsEI8iXkobBduRJ45Yw (button) folded on the Flop
Seat 3: 7acrZUQC3Zc9BNLjoKIcLQ (small blind) collected ($17.10)
Seat 4: 4dcDwIHRm96PwtqkpQiuiA (big blind) folded before Flop
Seat 5: d1puGuVBE0fidn+5eRJ0tw folded before Flop (didn't bet)
Seat 6: B2Ih1sr5VZk+8He7rcrMtQ folded before Flop (didn't bet)



PokerStars Game #59940811306:  Hold'em No Limit ($1/$2) - 2009/07/01 1:17:16 ET
Table 'dBLpiMEy1cezkSKD+ZpCcw' 2-max Seat #1 is the button
Seat 1: NFRtU1s5+WFh9EKwu+KLOQ ($201 in chips)
Seat 2: 4rrQUikeMSkuWGHgW80++w ($200 in chips)
NFRtU1s5+WFh9EKwu+KLOQ: posts small blind $1
4rrQUikeMSkuWGHgW80++w: posts big blind $2
*** HOLE CARDS ***
NFRtU1s5+WFh9EKwu+KLOQ: raises $2 to $4
4rrQUikeMSkuWGHgW80++w: raises $2 to $6
NFRtU1s5+WFh9EKwu+KLOQ: calls $2
*** FLOP *** [7c 7h 8c]
4rrQUikeMSkuWGHgW80++w: bets $8
NFRtU1s5+WFh9EKwu+KLOQ: calls $8
*** TURN *** [7c 7h 8c] [2h]
4rrQUikeMSkuWGHgW80++w: bets $16
NFRtU1s5+WFh9EKwu+KLOQ: calls $16
*** RIVER *** [7c 7h 8c 2h] [5c]
4rrQUikeMSkuWGHgW80++w: checks
NFRtU1s5+WFh9EKwu+KLOQ: bets $12
4rrQUikeMSkuWGHgW80++w: calls $12
*** SHOW DOWN ***
NFRtU1s5+WFh9EKwu+KLOQ: shows [2c Qc] (a flush, Queen high)
4rrQUikeMSkuWGHgW80++w: mucks hand
NFRtU1s5+WFh9EKwu+KLOQ collected $83.50 from pot
*** SUMMARY ***
Total pot $84 | Rake $0.50
Board [7c 7h 8c 2h 5c]
Seat 1: NFRtU1s5+WFh9EKwu+KLOQ (button) (small blind) showed [2c Qc] and won ($83.50) with a flush, Queen high
Seat 2: 4rrQUikeMSkuWGHgW80++w (big blind) mucked



PokerStars Game #59940811742:  Hold'em No Limit ($1/$2) - 2009/07/01 1:17:17 ET
Table 'qVXak+oTeDXMGbWa4sDU5Q' 9-max Seat #2 is the button
Seat 1: H6Z4+qu8gR0VUiPOijndVg ($249.55 in chips)
Seat 2: rW/MyplHylMSBRaoRUzWrg ($40 in chips)
Seat 3: WUlHm+ydPPHG7Lb0rePSdA ($170.65 in chips)
Seat 4: lQYT23h5QCUVZAKxjOO39Q ($106.25 in chips)
Seat 5: FWGiDqRwvLeKmHq9t4Jy9w ($268 in chips)
Seat 6: GX1heJ+DSsvm7gzSPsYhhQ ($37 in chips)
Seat 7: PfmlvZlFiss79a6IoEr11g ($124.30 in chips)
Seat 8: TAfo4veNRaRlzDXMMYS3Jg ($41 in chips)
Seat 9: CkE3IyJF1KvdaAOmZY5XqQ ($200 in chips)
WUlHm+ydPPHG7Lb0rePSdA: posts small blind $1
lQYT23h5QCUVZAKxjOO39Q: posts big blind $2
*** HOLE CARDS ***
FWGiDqRwvLeKmHq9t4Jy9w: folds
GX1heJ+DSsvm7gzSPsYhhQ: folds
PfmlvZlFiss79a6IoEr11g: folds
TAfo4veNRaRlzDXMMYS3Jg: folds
CkE3IyJF1KvdaAOmZY5XqQ: folds
H6Z4+qu8gR0VUiPOijndVg: raises $4 to $6
rW/MyplHylMSBRaoRUzWrg: folds
WUlHm+ydPPHG7Lb0rePSdA: folds
lQYT23h5QCUVZAKxjOO39Q: folds
H6Z4+qu8gR0VUiPOijndVg collected $5 from pot
H6Z4+qu8gR0VUiPOijndVg: doesn't show hand
*** SUMMARY ***
Total pot $5 | Rake $0
Seat 1: H6Z4+qu8gR0VUiPOijndVg collected ($5)
Seat 2: rW/MyplHylMSBRaoRUzWrg (button) folded before Flop (didn't bet)
Seat 3: WUlHm+ydPPHG7Lb0rePSdA (small blind) folded before Flop
Seat 4: lQYT23h5QCUVZAKxjOO39Q (big blind) folded before Flop
Seat 5: FWGiDqRwvLeKmHq9t4Jy9w folded before Flop (didn't bet)
Seat 6: GX1heJ+DSsvm7gzSPsYhhQ folded before Flop (didn't bet)
Seat 7: PfmlvZlFiss79a6IoEr11g folded before Flop (didn't bet)
Seat 8: TAfo4veNRaRlzDXMMYS3Jg folded before Flop (didn't bet)
Seat 9: CkE3IyJF1KvdaAOmZY5XqQ folded before Flop (didn't bet)



PokerStars Game #59940811954:  Hold'em No Limit ($1/$2) - 2009/07/01 1:17:17 ET
Table 'eyAQSIlgc2o1Jxvbve4WGg' 9-max Seat #9 is the button
Seat 1: UZEsV9yKUMqmpYPiOFpaZw ($102.50 in chips)
Seat 2: g7gL2NLJCdZPPV399WKT1w ($59.65 in chips)
Seat 3: ice1Sbe19zWIaKYoSmE5tw ($96.30 in chips)
Seat 4: CkE3IyJF1KvdaAOmZY5XqQ ($200 in chips)
Seat 5: mIKx5lhIt13X5eZQH0ZeMA ($56.25 in chips)
Seat 6: rW/MyplHylMSBRaoRUzWrg ($50.80 in chips)
Seat 7: QHxJjpVYwitg9krW6wZgJA ($278.45 in chips)
Seat 8: 1CtiZuXDFaJL1dJPQKyi8Q ($197.35 in chips)
Seat 9: WUlHm+ydPPHG7Lb0rePSdA ($123.70 in chips)
UZEsV9yKUMqmpYPiOFpaZw: posts small blind $1
g7gL2NLJCdZPPV399WKT1w: posts big blind $2
*** HOLE CARDS ***
ice1Sbe19zWIaKYoSmE5tw: folds
CkE3IyJF1KvdaAOmZY5XqQ has timed out
CkE3IyJF1KvdaAOmZY5XqQ: folds
CkE3IyJF1KvdaAOmZY5XqQ is sitting out
CkE3IyJF1KvdaAOmZY5XqQ has returned
mIKx5lhIt13X5eZQH0ZeMA: folds
rW/MyplHylMSBRaoRUzWrg: folds
QHxJjpVYwitg9krW6wZgJA: folds
1CtiZuXDFaJL1dJPQKyi8Q: folds
WUlHm+ydPPHG7Lb0rePSdA: folds
UZEsV9yKUMqmpYPiOFpaZw: folds
g7gL2NLJCdZPPV399WKT1w collected $2 from pot
g7gL2NLJCdZPPV399WKT1w: doesn't show hand
*** SUMMARY ***
Total pot $2 | Rake $0
Seat 1: UZEsV9yKUMqmpYPiOFpaZw (small blind) folded before Flop
Seat 2: g7gL2NLJCdZPPV399WKT1w (big blind) collected ($2)
Seat 3: ice1Sbe19zWIaKYoSmE5tw folded before Flop (didn't bet)
Seat 4: CkE3IyJF1KvdaAOmZY5XqQ folded before Flop (didn't bet)
Seat 5: mIKx5lhIt13X5eZQH0ZeMA folded before Flop (didn't bet)
Seat 6: rW/MyplHylMSBRaoRUzWrg folded before Flop (didn't bet)
Seat 7: QHxJjpVYwitg9krW6wZgJA folded before Flop (didn't bet)
Seat 8: 1CtiZuXDFaJL1dJPQKyi8Q folded before Flop (didn't bet)
Seat 9: WUlHm+ydPPHG7Lb0rePSdA (button) folded before Flop (didn't bet)



PokerStars Game #59940811766:  Hold'em No Limit ($1/$2) - 2009/07/01 1:17:17 ET
Table '/dyk+YdRGv90j2box35j8w' 6-max Seat #3 is the button
Seat 2: qCnEYuAE5y5A7bk6fO5/jQ ($484.95 in chips)
Seat 3: sTPOWERd9HWPCNrDBwsVjA ($228.50 in chips)
Seat 4: z/u1YTnkiIDrtp/2cA2dBg ($126.65 in chips)
Seat 5: VvdR9F3I+2yELkfTVvC1dg ($200 in chips)
Seat 6: ZwvXzkkZ3XpMhKfAmVpahw ($369.25 in chips)
z/u1YTnkiIDrtp/2cA2dBg: posts small blind $1
VvdR9F3I+2yELkfTVvC1dg: posts big blind $2
*** HOLE CARDS ***
ZwvXzkkZ3XpMhKfAmVpahw: folds
qCnEYuAE5y5A7bk6fO5/jQ: raises $4 to $6
sTPOWERd9HWPCNrDBwsVjA: folds
z/u1YTnkiIDrtp/2cA2dBg: folds
VvdR9F3I+2yELkfTVvC1dg: folds
qCnEYuAE5y5A7bk6fO5/jQ collected $5 from pot
qCnEYuAE5y5A7bk6fO5/jQ: doesn't show hand
*** SUMMARY ***
Total pot $5 | Rake $0
Seat 2: qCnEYuAE5y5A7bk6fO5/jQ collected ($5)
Seat 3: sTPOWERd9HWPCNrDBwsVjA (button) folded before Flop (didn't bet)
Seat 4: z/u1YTnkiIDrtp/2cA2dBg (small blind) folded before Flop
Seat 5: VvdR9F3I+2yELkfTVvC1dg (big blind) folded before Flop
Seat 6: ZwvXzkkZ3XpMhKfAmVpahw folded before Flop (didn't bet)



PokerStars Game #59940813800:  Hold'em No Limit ($1/$2) - 2009/07/01 1:17:21 ET
Table 'gnHBqWll9O3fxG7Ojkz/ng' 9-max Seat #7 is the button
Seat 2: H6Z4+qu8gR0VUiPOijndVg ($333.25 in chips)
Seat 3: 5Q8U6iZbeO7xJSS4qvDP5g ($218 in chips)
Seat 5: rBQDMkKm9cZn6M9NPsiVew ($239.45 in chips)
Seat 6: /inIs/z/PcX+TniIFpaxpg ($39 in chips)
Seat 7: jqui3xAWCkcdPW36a6BD+w ($344.40 in chips)
Seat 8: cM6efHzdxoqYm0EQKP4TTQ ($104.30 in chips)
Seat 9: sN6yR5I5zFq/WFyIz5UfzQ ($204 in chips)
cM6efHzdxoqYm0EQKP4TTQ: posts small blind $1
sN6yR5I5zFq/WFyIz5UfzQ: posts big blind $2
TAfo4veNRaRlzDXMMYS3Jg: sits out
*** HOLE CARDS ***
H6Z4+qu8gR0VUiPOijndVg: folds
5Q8U6iZbeO7xJSS4qvDP5g: folds
rBQDMkKm9cZn6M9NPsiVew: folds
/inIs/z/PcX+TniIFpaxpg: raises $4 to $6
jqui3xAWCkcdPW36a6BD+w: folds
cM6efHzdxoqYm0EQKP4TTQ: folds
sN6yR5I5zFq/WFyIz5UfzQ: folds
/inIs/z/PcX+TniIFpaxpg collected $5 from pot
/inIs/z/PcX+TniIFpaxpg: doesn't show hand
*** SUMMARY ***
Total pot $5 | Rake $0
Seat 2: H6Z4+qu8gR0VUiPOijndVg folded before Flop (didn't bet)
Seat 3: 5Q8U6iZbeO7xJSS4qvDP5g folded before Flop (didn't bet)
Seat 5: rBQDMkKm9cZn6M9NPsiVew folded before Flop (didn't bet)
Seat 6: /inIs/z/PcX+TniIFpaxpg collected ($5)
Seat 7: jqui3xAWCkcdPW36a6BD+w (button) folded before Flop (didn't bet)
Seat 8: cM6efHzdxoqYm0EQKP4TTQ (small blind) folded before Flop
Seat 9: sN6yR5I5zFq/WFyIz5UfzQ (big blind) folded before Flop



PokerStars Game #59940814344:  Hold'em No Limit ($1/$2) - 2009/07/01 1:17:22 ET
Table 'BSRfGh+QobUe0AgIMtt/fw' 9-max Seat #3 is the button
Seat 1: gDn/rYeNwCyWEgRhyWp4PA ($147.95 in chips)
Seat 2: TAfo4veNRaRlzDXMMYS3Jg ($49 in chips)
Seat 3: WUlHm+ydPPHG7Lb0rePSdA ($121 in chips)
Seat 6: H6Z4+qu8gR0VUiPOijndVg ($232.15 in chips)
Seat 7: CkE3IyJF1KvdaAOmZY5XqQ ($208.15 in chips)
Seat 8: /XRRUMKiOOItJFbrM26RrA ($100.55 in chips)
Seat 9: /inIs/z/PcX+TniIFpaxpg ($202.60 in chips)
H6Z4+qu8gR0VUiPOijndVg: posts small blind $1
CkE3IyJF1KvdaAOmZY5XqQ: posts big blind $2
*** HOLE CARDS ***
GX1heJ+DSsvm7gzSPsYhhQ joins the table at seat #5
/XRRUMKiOOItJFbrM26RrA: folds
/inIs/z/PcX+TniIFpaxpg: folds
gDn/rYeNwCyWEgRhyWp4PA: folds
TAfo4veNRaRlzDXMMYS3Jg: folds
WUlHm+ydPPHG7Lb0rePSdA: folds
MrNegroni joins the table at seat #4
H6Z4+qu8gR0VUiPOijndVg: raises $4 to $6
CkE3IyJF1KvdaAOmZY5XqQ: calls $4
*** FLOP *** [3d 3c 8d]
H6Z4+qu8gR0VUiPOijndVg: bets $8
CkE3IyJF1KvdaAOmZY5XqQ: folds
H6Z4+qu8gR0VUiPOijndVg collected $11.40 from pot
H6Z4+qu8gR0VUiPOijndVg: doesn't show hand
*** SUMMARY ***
Total pot $12 | Rake $0.60
Board [3d 3c 8d]
Seat 1: gDn/rYeNwCyWEgRhyWp4PA folded before Flop (didn't bet)
Seat 2: TAfo4veNRaRlzDXMMYS3Jg folded before Flop (didn't bet)
Seat 3: WUlHm+ydPPHG7Lb0rePSdA (button) folded before Flop (didn't bet)
Seat 6: H6Z4+qu8gR0VUiPOijndVg (small blind) collected ($11.40)
Seat 7: CkE3IyJF1KvdaAOmZY5XqQ (big blind) folded on the Flop
Seat 8: /XRRUMKiOOItJFbrM26RrA folded before Flop (didn't bet)
Seat 9: /inIs/z/PcX+TniIFpaxpg folded before Flop (didn't bet)



PokerStars Game #59940815944:  Hold'em No Limit ($1/$2) - 2009/07/01 1:17:25 ET
Table 'jlrIxbrVIG+gjaUYT4za8g' 6-max Seat #2 is the button
Seat 1: ygTTt5ehT4aF86q1a8/R+w ($225.30 in chips)
Seat 2: N18PrNGQj43J7TJuQuu+tw ($96.25 in chips)
Seat 4: 8srN1dKQePlsv0GyTada+Q ($287.10 in chips)
Seat 5: AyBB0k3Dcl7xbXUeGMw06g ($80.20 in chips)
Seat 6: vkfxu8f/jMYKUk6Ly4eujw ($240.75 in chips)
8srN1dKQePlsv0GyTada+Q: posts small blind $1
AyBB0k3Dcl7xbXUeGMw06g: posts big blind $2
*** HOLE CARDS ***
vkfxu8f/jMYKUk6Ly4eujw: raises $4 to $6
ygTTt5ehT4aF86q1a8/R+w: folds
N18PrNGQj43J7TJuQuu+tw: folds
8srN1dKQePlsv0GyTada+Q: folds
AyBB0k3Dcl7xbXUeGMw06g: folds
vkfxu8f/jMYKUk6Ly4eujw collected $5 from pot
*** SUMMARY ***
Total pot $5 | Rake $0
Seat 1: ygTTt5ehT4aF86q1a8/R+w folded before Flop (didn't bet)
Seat 2: N18PrNGQj43J7TJuQuu+tw (button) folded before Flop (didn't bet)
Seat 4: 8srN1dKQePlsv0GyTada+Q (small blind) folded before Flop
Seat 5: AyBB0k3Dcl7xbXUeGMw06g (big blind) folded before Flop
Seat 6: vkfxu8f/jMYKUk6Ly4eujw collected ($5)



PokerStars Game #59940816984:  Hold'em No Limit ($1/$2) - 2009/07/01 1:17:26 ET
Table 'pPQgcj9XT9CHBsbo1WTBug' 6-max Seat #2 is the button
Seat 1: DFVYDA6dKQy7R7mGIKogZA ($143.60 in chips)
Seat 2: qXDd0ZyMIse0OBu8pxeQ3Q ($209.95 in chips)
Seat 3: WfaZs12BkYO+BUX5VWpuWQ ($22.85 in chips)
Seat 4: gqlysXCbT8V54f/1lf9h3A ($45 in chips)
Seat 5: vkfxu8f/jMYKUk6Ly4eujw ($226.10 in chips)
Seat 6: Yr7pZltpy3IUNdKS9PCEiw ($271.90 in chips)
WfaZs12BkYO+BUX5VWpuWQ: posts small blind $1
gqlysXCbT8V54f/1lf9h3A: posts big blind $2
*** HOLE CARDS ***
vkfxu8f/jMYKUk6Ly4eujw: raises $6 to $8
Yr7pZltpy3IUNdKS9PCEiw: folds
DFVYDA6dKQy7R7mGIKogZA: folds
qXDd0ZyMIse0OBu8pxeQ3Q: folds
WfaZs12BkYO+BUX5VWpuWQ: folds
gqlysXCbT8V54f/1lf9h3A: folds
vkfxu8f/jMYKUk6Ly4eujw collected $5 from pot
vkfxu8f/jMYKUk6Ly4eujw: doesn't show hand
*** SUMMARY ***
Total pot $5 | Rake $0
Seat 1: DFVYDA6dKQy7R7mGIKogZA folded before Flop (didn't bet)
Seat 2: qXDd0ZyMIse0OBu8pxeQ3Q (button) folded before Flop (didn't bet)
Seat 3: WfaZs12BkYO+BUX5VWpuWQ (small blind) folded before Flop
Seat 4: gqlysXCbT8V54f/1lf9h3A (big blind) folded before Flop
Seat 5: vkfxu8f/jMYKUk6Ly4eujw collected ($5)
Seat 6: Yr7pZltpy3IUNdKS9PCEiw folded before Flop (didn't bet)



PokerStars Game #59940817398:  Hold'em No Limit ($1/$2) - 2009/07/01 1:17:27 ET
Table 'gftD4mDF7mIFKvSrIyaRbw' 9-max Seat #2 is the button
Seat 1: 31HuO+DQxppUQEedBWukug ($106 in chips)
Seat 2: GX1heJ+DSsvm7gzSPsYhhQ ($37 in chips)
Seat 3: CUZwDpLTQKhzarPe+JCLOQ ($212.10 in chips)
Seat 5: mpsfNtnMVDqQHTe92AhIdw ($123.50 in chips)
Seat 6: 2NvwF8W2nzsbS+G//yLAbQ ($162.50 in chips)
Seat 7: EBV6OktyeSmh4w6sWmcWOw ($215.65 in chips)
Seat 8: MpL4DeEqGQu0H8TJEbEOrg ($40 in chips)
Seat 9: F7m34OOfAQ7annesMHVjKw ($159.10 in chips)
CUZwDpLTQKhzarPe+JCLOQ: posts small blind $1
rW/MyplHylMSBRaoRUzWrg: is sitting out
mpsfNtnMVDqQHTe92AhIdw: posts big blind $2
*** HOLE CARDS ***
rW/MyplHylMSBRaoRUzWrg leaves the table
2NvwF8W2nzsbS+G//yLAbQ: folds
EBV6OktyeSmh4w6sWmcWOw: folds
MpL4DeEqGQu0H8TJEbEOrg: folds
F7m34OOfAQ7annesMHVjKw: folds
31HuO+DQxppUQEedBWukug: folds
GX1heJ+DSsvm7gzSPsYhhQ: folds
CUZwDpLTQKhzarPe+JCLOQ: raises $5 to $7
mpsfNtnMVDqQHTe92AhIdw: folds
CUZwDpLTQKhzarPe+JCLOQ collected $4 from pot
CUZwDpLTQKhzarPe+JCLOQ: doesn't show hand
*** SUMMARY ***
Total pot $4 | Rake $0
Seat 1: 31HuO+DQxppUQEedBWukug folded before Flop (didn't bet)
Seat 2: GX1heJ+DSsvm7gzSPsYhhQ (button) folded before Flop (didn't bet)
Seat 3: CUZwDpLTQKhzarPe+JCLOQ (small blind) collected ($4)
Seat 5: mpsfNtnMVDqQHTe92AhIdw (big blind) folded before Flop
Seat 6: 2NvwF8W2nzsbS+G//yLAbQ folded before Flop (didn't bet)
Seat 7: EBV6OktyeSmh4w6sWmcWOw folded before Flop (didn't bet)
Seat 8: MpL4DeEqGQu0H8TJEbEOrg folded before Flop (didn't bet)
Seat 9: F7m34OOfAQ7annesMHVjKw folded before Flop (didn't bet)



PokerStars Game #59940817766:  Hold'em No Limit ($1/$2) - 2009/07/01 1:17:28 ET
Table 'SF49/KQm8T4taMp6kb+HXA' 9-max Seat #5 is the button
Seat 1: CUZwDpLTQKhzarPe+JCLOQ ($200 in chips)
Seat 2: rW/MyplHylMSBRaoRUzWrg ($36 in chips)
Seat 3: pCmk6FpSOLJ+85o1tLHIag ($285.75 in chips)
Seat 5: ri8CLkX3e9JF34dQNbsHGA ($40 in chips)
Seat 6: 31HuO+DQxppUQEedBWukug ($305.95 in chips)
Seat 7: n2VAbLaE5qgKr5mA4W6v4w ($117 in chips)
Seat 8: GgrYze3jkUdSO7a7CuJGDw ($183 in chips)
Seat 9: /inIs/z/PcX+TniIFpaxpg ($326.15 in chips)
31HuO+DQxppUQEedBWukug: posts small blind $1
n2VAbLaE5qgKr5mA4W6v4w: posts big blind $2
*** HOLE CARDS ***
GgrYze3jkUdSO7a7CuJGDw: folds
HffgoYm61KgkdMe/DYChIQ is connected
/inIs/z/PcX+TniIFpaxpg: folds
CUZwDpLTQKhzarPe+JCLOQ: folds
HffgoYm61KgkdMe/DYChIQ has returned
rW/MyplHylMSBRaoRUzWrg: folds
pCmk6FpSOLJ+85o1tLHIag: calls $2
ri8CLkX3e9JF34dQNbsHGA: folds
31HuO+DQxppUQEedBWukug: calls $1
n2VAbLaE5qgKr5mA4W6v4w: raises $5 to $7
pCmk6FpSOLJ+85o1tLHIag: folds
31HuO+DQxppUQEedBWukug: folds
n2VAbLaE5qgKr5mA4W6v4w collected $6 from pot
*** SUMMARY ***
Total pot $6 | Rake $0
Seat 1: CUZwDpLTQKhzarPe+JCLOQ folded before Flop (didn't bet)
Seat 2: rW/MyplHylMSBRaoRUzWrg folded before Flop (didn't bet)
Seat 3: pCmk6FpSOLJ+85o1tLHIag folded before Flop
Seat 5: ri8CLkX3e9JF34dQNbsHGA (button) folded before Flop (didn't bet)
Seat 6: 31HuO+DQxppUQEedBWukug (small blind) folded before Flop
Seat 7: n2VAbLaE5qgKr5mA4W6v4w (big blind) collected ($6)
Seat 8: GgrYze3jkUdSO7a7CuJGDw folded before Flop (didn't bet)
Seat 9: /inIs/z/PcX+TniIFpaxpg folded before Flop (didn't bet)



PokerStars Game #59940818790:  Hold'em No Limit ($1/$2) - 2009/07/01 1:17:29 ET
Table '+hSnXFQrGw1PlVgTnuj+sA' 6-max Seat #6 is the button
Seat 1: 2ccIJhDj+3JapvS7swVZEg ($287.60 in chips)
Seat 2: o9jamqIi6sTTRSqudgboRA ($258.55 in chips)
Seat 3: fE+LHW/7rpfXW14g8LhGjA ($54.65 in chips)
Seat 4: J4iH5epwXbmODnojR/VRxA ($187 in chips)
Seat 5: VvdR9F3I+2yELkfTVvC1dg ($200 in chips)
Seat 6: AuiGltq875lmaKHBsjZVGg ($108.40 in chips)
2ccIJhDj+3JapvS7swVZEg: posts small blind $1
o9jamqIi6sTTRSqudgboRA: posts big blind $2
*** HOLE CARDS ***
fE+LHW/7rpfXW14g8LhGjA: raises $2 to $4
J4iH5epwXbmODnojR/VRxA: folds
VvdR9F3I+2yELkfTVvC1dg: folds
AuiGltq875lmaKHBsjZVGg: folds
2ccIJhDj+3JapvS7swVZEg: calls $3
o9jamqIi6sTTRSqudgboRA: folds
*** FLOP *** [2d As 5d]
2ccIJhDj+3JapvS7swVZEg: checks
fE+LHW/7rpfXW14g8LhGjA: checks
*** TURN *** [2d As 5d] [Kh]
2ccIJhDj+3JapvS7swVZEg: bets $6
fE+LHW/7rpfXW14g8LhGjA: folds
2ccIJhDj+3JapvS7swVZEg collected $9.50 from pot
*** SUMMARY ***
Total pot $10 | Rake $0.50
Board [2d As 5d Kh]
Seat 1: 2ccIJhDj+3JapvS7swVZEg (small blind) collected ($9.50)
Seat 2: o9jamqIi6sTTRSqudgboRA (big blind) folded before Flop
Seat 3: fE+LHW/7rpfXW14g8LhGjA folded on the Turn
Seat 4: J4iH5epwXbmODnojR/VRxA folded before Flop (didn't bet)
Seat 5: VvdR9F3I+2yELkfTVvC1dg folded before Flop (didn't bet)
Seat 6: AuiGltq875lmaKHBsjZVGg (button) folded before Flop (didn't bet)



PokerStars Game #59940818468:  Hold'em No Limit ($1/$2) - 2009/07/01 1:17:29 ET
Table 'TsEDkiO4tzCTCzJ7tNdEqw' 6-max Seat #4 is the button
Seat 1: MfXQsYD8pGeCS7XOtyV+vw ($88.90 in chips)
Seat 2: 4dcDwIHRm96PwtqkpQiuiA ($65.20 in chips)
Seat 3: wgRvjVPZSQvqNGiyR1jwSA ($37 in chips)
Seat 4: K8MXCrNAVYlMnnCeM32Kxw ($51.05 in chips)
Seat 5: VvdR9F3I+2yELkfTVvC1dg ($203.50 in chips)
Seat 6: uCqEjnxh2/vFBjKYkfTOkw ($262.25 in chips)
VvdR9F3I+2yELkfTVvC1dg: posts small blind $1
uCqEjnxh2/vFBjKYkfTOkw: posts big blind $2
*** HOLE CARDS ***
MfXQsYD8pGeCS7XOtyV+vw: folds
4dcDwIHRm96PwtqkpQiuiA: folds
wgRvjVPZSQvqNGiyR1jwSA: raises $2 to $4
K8MXCrNAVYlMnnCeM32Kxw: folds
VvdR9F3I+2yELkfTVvC1dg: folds
uCqEjnxh2/vFBjKYkfTOkw: folds
wgRvjVPZSQvqNGiyR1jwSA collected $5 from pot
*** SUMMARY ***
Total pot $5 | Rake $0
Seat 1: MfXQsYD8pGeCS7XOtyV+vw folded before Flop (didn't bet)
Seat 2: 4dcDwIHRm96PwtqkpQiuiA folded before Flop (didn't bet)
Seat 3: wgRvjVPZSQvqNGiyR1jwSA collected ($5)
Seat 4: K8MXCrNAVYlMnnCeM32Kxw (button) folded before Flop (didn't bet)
Seat 5: VvdR9F3I+2yELkfTVvC1dg (small blind) folded before Flop
Seat 6: uCqEjnxh2/vFBjKYkfTOkw (big blind) folded before Flop



PokerStars Game #59940820262:  Hold'em No Limit ($1/$2) - 2009/07/01 1:17:32 ET
Table 'ztv6V3FN2bQ9nmJPPdx6nQ' 6-max Seat #2 is the button
Seat 2: 5Y+ZGWLI4gnlpApDX5vy1A ($397.85 in chips)
Seat 4: UaZ5yj+6LjtWqMQg2QskUw ($113.80 in chips)
Seat 5: sTPOWERd9HWPCNrDBwsVjA ($264 in chips)
Seat 6: mfy7uGZcqA2PVQqEVbJ7+g ($112.45 in chips)
UaZ5yj+6LjtWqMQg2QskUw: posts small blind $1
sTPOWERd9HWPCNrDBwsVjA: posts big blind $2
*** HOLE CARDS ***
mfy7uGZcqA2PVQqEVbJ7+g: folds
5Y+ZGWLI4gnlpApDX5vy1A: raises $2 to $4
UaZ5yj+6LjtWqMQg2QskUw: folds
sTPOWERd9HWPCNrDBwsVjA: calls $2
*** FLOP *** [Td 2h 7s]
sTPOWERd9HWPCNrDBwsVjA: checks
6fLdOUCRtX71xbVRhJEq8w has returned
5Y+ZGWLI4gnlpApDX5vy1A: bets $8
sTPOWERd9HWPCNrDBwsVjA: folds
5Y+ZGWLI4gnlpApDX5vy1A collected $8.55 from pot
5Y+ZGWLI4gnlpApDX5vy1A: doesn't show hand
*** SUMMARY ***
Total pot $9 | Rake $0.45
Board [Td 2h 7s]
Seat 2: 5Y+ZGWLI4gnlpApDX5vy1A (button) collected ($8.55)
Seat 4: UaZ5yj+6LjtWqMQg2QskUw (small blind) folded before Flop
Seat 5: sTPOWERd9HWPCNrDBwsVjA (big blind) folded on the Flop
Seat 6: mfy7uGZcqA2PVQqEVbJ7+g folded before Flop (didn't bet)



PokerStars Game #59940821636:  Hold'em No Limit ($1/$2) - 2009/07/01 1:17:34 ET
Table 'NmY84NAf9Mh0ckAckHnh5g' 2-max Seat #1 is the button
Seat 1: 6hvg964TSqZ3AL/0XK9aVQ ($241.50 in chips)
Seat 2: RwDoM55ZeQuI2ADyJhOb2Q ($769.90 in chips)
6hvg964TSqZ3AL/0XK9aVQ: posts small blind $1
RwDoM55ZeQuI2ADyJhOb2Q: posts big blind $2
*** HOLE CARDS ***
6hvg964TSqZ3AL/0XK9aVQ: calls $1
RwDoM55ZeQuI2ADyJhOb2Q: checks
*** FLOP *** [9d Qc Ad]
RwDoM55ZeQuI2ADyJhOb2Q: checks
6hvg964TSqZ3AL/0XK9aVQ: bets $4
RwDoM55ZeQuI2ADyJhOb2Q: folds
6hvg964TSqZ3AL/0XK9aVQ collected $3.80 from pot
6hvg964TSqZ3AL/0XK9aVQ: doesn't show hand
*** SUMMARY ***
Total pot $4 | Rake $0.20
Board [9d Qc Ad]
Seat 1: 6hvg964TSqZ3AL/0XK9aVQ (button) (small blind) collected ($3.80)
Seat 2: RwDoM55ZeQuI2ADyJhOb2Q (big blind) folded on the Flop



PokerStars Game #59940822894:  Hold'em No Limit ($1/$2) - 2009/07/01 1:17:37 ET
Table 'aSf77Sj8QEnzcc0WaxVD4Q' 6-max Seat #1 is the button
Seat 1: UELtvp+JfwI7XDGVwSxZXA ($166.75 in chips)
Seat 2: vkfxu8f/jMYKUk6Ly4eujw ($201.80 in chips)
Seat 3: 9dpyyjDTCed6nV7JhaUUpw ($228.35 in chips)
Seat 4: YsLQ3BAvgQHWXMAv3Wv6Hg ($268.70 in chips)
Seat 5: VvdR9F3I+2yELkfTVvC1dg ($200 in chips)
Seat 6: vkoJRf3gidxY1pPi0AFWww ($140.55 in chips)
vkfxu8f/jMYKUk6Ly4eujw: posts small blind $1
9dpyyjDTCed6nV7JhaUUpw: posts big blind $2
*** HOLE CARDS ***
YsLQ3BAvgQHWXMAv3Wv6Hg: folds
VvdR9F3I+2yELkfTVvC1dg: raises $2 to $4
vkoJRf3gidxY1pPi0AFWww: raises $4 to $8
UELtvp+JfwI7XDGVwSxZXA: folds
vkfxu8f/jMYKUk6Ly4eujw: folds
9dpyyjDTCed6nV7JhaUUpw: folds
VvdR9F3I+2yELkfTVvC1dg: calls $4
*** FLOP *** [4h 5d 9d]
VvdR9F3I+2yELkfTVvC1dg: checks
vkoJRf3gidxY1pPi0AFWww: bets $16
VvdR9F3I+2yELkfTVvC1dg: calls $16
*** TURN *** [4h 5d 9d] [2s]
VvdR9F3I+2yELkfTVvC1dg: checks
vkoJRf3gidxY1pPi0AFWww: bets $24
VvdR9F3I+2yELkfTVvC1dg: raises $152 to $176 and is all-in
vkoJRf3gidxY1pPi0AFWww: folds
VvdR9F3I+2yELkfTVvC1dg collected $96 from pot
VvdR9F3I+2yELkfTVvC1dg: doesn't show hand
*** SUMMARY ***
Total pot $99 | Rake $3
Board [4h 5d 9d 2s]
Seat 1: UELtvp+JfwI7XDGVwSxZXA (button) folded before Flop (didn't bet)
Seat 2: vkfxu8f/jMYKUk6Ly4eujw (small blind) folded before Flop
Seat 3: 9dpyyjDTCed6nV7JhaUUpw (big blind) folded before Flop
Seat 4: YsLQ3BAvgQHWXMAv3Wv6Hg folded before Flop (didn't bet)
Seat 5: VvdR9F3I+2yELkfTVvC1dg collected ($96)
Seat 6: vkoJRf3gidxY1pPi0AFWww folded on the Turn



PokerStars Game #59940824712:  Hold'em No Limit ($1/$2) - 2009/07/01 1:17:40 ET
Table '/dyk+YdRGv90j2box35j8w' 6-max Seat #4 is the button
Seat 2: qCnEYuAE5y5A7bk6fO5/jQ ($487.95 in chips)
Seat 3: sTPOWERd9HWPCNrDBwsVjA ($228.50 in chips)
Seat 4: z/u1YTnkiIDrtp/2cA2dBg ($125.65 in chips)
Seat 5: VvdR9F3I+2yELkfTVvC1dg ($200 in chips)
Seat 6: ZwvXzkkZ3XpMhKfAmVpahw ($369.25 in chips)
VvdR9F3I+2yELkfTVvC1dg: posts small blind $1
ZwvXzkkZ3XpMhKfAmVpahw: posts big blind $2
*** HOLE CARDS ***
qCnEYuAE5y5A7bk6fO5/jQ: folds
sTPOWERd9HWPCNrDBwsVjA: folds
z/u1YTnkiIDrtp/2cA2dBg: folds
VvdR9F3I+2yELkfTVvC1dg: folds
ZwvXzkkZ3XpMhKfAmVpahw collected $2 from pot
ZwvXzkkZ3XpMhKfAmVpahw: doesn't show hand
*** SUMMARY ***
Total pot $2 | Rake $0
Seat 2: qCnEYuAE5y5A7bk6fO5/jQ folded before Flop (didn't bet)
Seat 3: sTPOWERd9HWPCNrDBwsVjA folded before Flop (didn't bet)
Seat 4: z/u1YTnkiIDrtp/2cA2dBg (button) folded before Flop (didn't bet)
Seat 5: VvdR9F3I+2yELkfTVvC1dg (small blind) folded before Flop
Seat 6: ZwvXzkkZ3XpMhKfAmVpahw (big blind) collected ($2)



PokerStars Game #59940825532:  Hold'em No Limit ($1/$2) - 2009/07/01 1:17:41 ET
Table 'jlrIxbrVIG+gjaUYT4za8g' 6-max Seat #4 is the button
Seat 1: ygTTt5ehT4aF86q1a8/R+w ($225.30 in chips)
Seat 2: N18PrNGQj43J7TJuQuu+tw ($96.25 in chips)
Seat 4: 8srN1dKQePlsv0GyTada+Q ($286.10 in chips)
Seat 5: AyBB0k3Dcl7xbXUeGMw06g ($78.20 in chips)
Seat 6: vkfxu8f/jMYKUk6Ly4eujw ($243.75 in chips)
AyBB0k3Dcl7xbXUeGMw06g: posts small blind $1
vkfxu8f/jMYKUk6Ly4eujw: posts big blind $2
*** HOLE CARDS ***
ygTTt5ehT4aF86q1a8/R+w: folds
N18PrNGQj43J7TJuQuu+tw: raises $2 to $4
8srN1dKQePlsv0GyTada+Q: folds
AyBB0k3Dcl7xbXUeGMw06g: folds
vkfxu8f/jMYKUk6Ly4eujw: calls $2
*** FLOP *** [3h 2h Jd]
vkfxu8f/jMYKUk6Ly4eujw: bets $8
N18PrNGQj43J7TJuQuu+tw: raises $8 to $16
vkfxu8f/jMYKUk6Ly4eujw: raises $32 to $48
N18PrNGQj43J7TJuQuu+tw: calls $32
*** TURN *** [3h 2h Jd] [7s]
vkfxu8f/jMYKUk6Ly4eujw: bets $103
N18PrNGQj43J7TJuQuu+tw: calls $44.25 and is all-in
*** RIVER *** [3h 2h Jd 7s] [5s]
*** SHOW DOWN ***
vkfxu8f/jMYKUk6Ly4eujw: shows [3d 3s] (three of a kind, Threes)
N18PrNGQj43J7TJuQuu+tw: shows [Jc 9h] (a pair of Jacks)
vkfxu8f/jMYKUk6Ly4eujw collected $191.50 from pot
*** SUMMARY ***
Total pot $193.50 | Rake $2
Board [3h 2h Jd 7s 5s]
Seat 1: ygTTt5ehT4aF86q1a8/R+w folded before Flop (didn't bet)
Seat 2: N18PrNGQj43J7TJuQuu+tw showed [Jc 9h] and lost with a pair of Jacks
Seat 4: 8srN1dKQePlsv0GyTada+Q (button) folded before Flop (didn't bet)
Seat 5: AyBB0k3Dcl7xbXUeGMw06g (small blind) folded before Flop
Seat 6: vkfxu8f/jMYKUk6Ly4eujw (big blind) showed [3d 3s] and won ($191.50) with three of a kind, Threes



PokerStars Game #59940826184:  Hold'em No Limit ($1/$2) - 2009/07/01 1:17:42 ET
Table 'rKeCh+eBn4RNvybCUYkoTQ' 9-max Seat #8 is the button
Seat 1: /inIs/z/PcX+TniIFpaxpg ($206 in chips)
Seat 2: 9cBHwK40Tl06vheE7B3LHQ ($142.25 in chips)
Seat 4: 31HuO+DQxppUQEedBWukug ($98.10 in chips)
Seat 5: WUlHm+ydPPHG7Lb0rePSdA ($120 in chips)
Seat 6: EBV6OktyeSmh4w6sWmcWOw ($270 in chips)
Seat 7: rW/MyplHylMSBRaoRUzWrg ($37 in chips)
Seat 8: pN/Ip0ePsUVIdUlGgLrkUw ($216.10 in chips)
Seat 9: Kzta8yu9vxHT4B70mjBZ+w ($209.25 in chips)
Kzta8yu9vxHT4B70mjBZ+w: posts small blind $1
/inIs/z/PcX+TniIFpaxpg: posts big blind $2
GX1heJ+DSsvm7gzSPsYhhQ: sits out
*** HOLE CARDS ***
9cBHwK40Tl06vheE7B3LHQ: raises $4 to $6
31HuO+DQxppUQEedBWukug: folds
WUlHm+ydPPHG7Lb0rePSdA: folds
EBV6OktyeSmh4w6sWmcWOw: folds
rW/MyplHylMSBRaoRUzWrg: folds
pN/Ip0ePsUVIdUlGgLrkUw: folds
Kzta8yu9vxHT4B70mjBZ+w: folds
/inIs/z/PcX+TniIFpaxpg: folds
9cBHwK40Tl06vheE7B3LHQ collected $5 from pot
9cBHwK40Tl06vheE7B3LHQ: doesn't show hand
*** SUMMARY ***
Total pot $5 | Rake $0
Seat 1: /inIs/z/PcX+TniIFpaxpg (big blind) folded before Flop
Seat 2: 9cBHwK40Tl06vheE7B3LHQ collected ($5)
Seat 4: 31HuO+DQxppUQEedBWukug folded before Flop (didn't bet)
Seat 5: WUlHm+ydPPHG7Lb0rePSdA folded before Flop (didn't bet)
Seat 6: EBV6OktyeSmh4w6sWmcWOw folded before Flop (didn't bet)
Seat 7: rW/MyplHylMSBRaoRUzWrg folded before Flop (didn't bet)
Seat 8: pN/Ip0ePsUVIdUlGgLrkUw (button) folded before Flop (didn't bet)
Seat 9: Kzta8yu9vxHT4B70mjBZ+w (small blind) folded before Flop



PokerStars Game #59940825936:  Hold'em No Limit ($1/$2) - 2009/07/01 1:17:42 ET
Table 'bJQ024BaYSBrW0sXpCZbNQ' 6-max Seat #1 is the button
Seat 1: PCN5rt4TwI1pQE+rAiqI0Q ($283.50 in chips)
Seat 2: 3dAbvkxS5NPQTBAbvpinVg ($200 in chips)
Seat 3: vkfxu8f/jMYKUk6Ly4eujw ($231 in chips)
Seat 6: 9dpyyjDTCed6nV7JhaUUpw ($327.95 in chips)
3dAbvkxS5NPQTBAbvpinVg: posts small blind $1
vkfxu8f/jMYKUk6Ly4eujw: posts big blind $2
TBaQIN+sQ7eb7P99QnaORQ: sits out
VvdR9F3I+2yELkfTVvC1dg: sits out
*** HOLE CARDS ***
9dpyyjDTCed6nV7JhaUUpw: folds
PCN5rt4TwI1pQE+rAiqI0Q: calls $2
TBaQIN+sQ7eb7P99QnaORQ is sitting out
3dAbvkxS5NPQTBAbvpinVg: folds
vkfxu8f/jMYKUk6Ly4eujw: checks
*** FLOP *** [5s 7h 5d]
vkfxu8f/jMYKUk6Ly4eujw: checks
PCN5rt4TwI1pQE+rAiqI0Q: checks
*** TURN *** [5s 7h 5d] [6c]
vkfxu8f/jMYKUk6Ly4eujw: checks
PCN5rt4TwI1pQE+rAiqI0Q: checks
*** RIVER *** [5s 7h 5d 6c] [8d]
vkfxu8f/jMYKUk6Ly4eujw: checks
PCN5rt4TwI1pQE+rAiqI0Q: bets $6
vkfxu8f/jMYKUk6Ly4eujw: calls $6
*** SHOW DOWN ***
PCN5rt4TwI1pQE+rAiqI0Q: shows [4h Qh] (a straight, Four to Eight)
vkfxu8f/jMYKUk6Ly4eujw: shows [4c Ah] (a straight, Four to Eight)
vkfxu8f/jMYKUk6Ly4eujw collected $8.10 from pot
PCN5rt4TwI1pQE+rAiqI0Q collected $8.10 from pot
*** SUMMARY ***
Total pot $17 | Rake $0.80
Board [5s 7h 5d 6c 8d]
Seat 1: PCN5rt4TwI1pQE+rAiqI0Q (button) showed [4h Qh] and won ($8.10) with a straight, Four to Eight
Seat 2: 3dAbvkxS5NPQTBAbvpinVg (small blind) folded before Flop
Seat 3: vkfxu8f/jMYKUk6Ly4eujw (big blind) showed [4c Ah] and won ($8.10) with a straight, Four to Eight
Seat 6: 9dpyyjDTCed6nV7JhaUUpw folded before Flop (didn't bet)



PokerStars Game #59940825918:  Hold'em No Limit ($1/$2) - 2009/07/01 1:17:42 ET
Table 'bIihwBANJSFqlHPPtset+w' 9-max Seat #6 is the button
Seat 1: /inIs/z/PcX+TniIFpaxpg ($33 in chips)
Seat 2: lQYT23h5QCUVZAKxjOO39Q ($175.30 in chips)
Seat 3: OipzuP0MueAd8hGaz/kWMQ ($43.10 in chips)
Seat 4: ri8CLkX3e9JF34dQNbsHGA ($42.40 in chips)
Seat 5: vxbbJLsS1bva6tW2NiFssg ($200 in chips)
Seat 6: CkE3IyJF1KvdaAOmZY5XqQ ($186 in chips)
Seat 7: pCmk6FpSOLJ+85o1tLHIag ($131.45 in chips)
Seat 8: iMe5yhc+1BaiIPHet3NMrA ($207.50 in chips)
Seat 9: qn8LDoUFphcG4+r+F+Vhrg ($184 in chips)
pCmk6FpSOLJ+85o1tLHIag: posts small blind $1
iMe5yhc+1BaiIPHet3NMrA: posts big blind $2
*** HOLE CARDS ***
qn8LDoUFphcG4+r+F+Vhrg: folds
/inIs/z/PcX+TniIFpaxpg: folds
lQYT23h5QCUVZAKxjOO39Q: folds
OipzuP0MueAd8hGaz/kWMQ: calls $2
ri8CLkX3e9JF34dQNbsHGA: folds
vxbbJLsS1bva6tW2NiFssg: folds
CkE3IyJF1KvdaAOmZY5XqQ: folds
pCmk6FpSOLJ+85o1tLHIag: folds
iMe5yhc+1BaiIPHet3NMrA: checks
*** FLOP *** [Kh Tc Td]
iMe5yhc+1BaiIPHet3NMrA: checks
OipzuP0MueAd8hGaz/kWMQ: checks
*** TURN *** [Kh Tc Td] [Qh]
iMe5yhc+1BaiIPHet3NMrA: checks
OipzuP0MueAd8hGaz/kWMQ: bets $2
iMe5yhc+1BaiIPHet3NMrA: folds
OipzuP0MueAd8hGaz/kWMQ collected $4.75 from pot
OipzuP0MueAd8hGaz/kWMQ: doesn't show hand
*** SUMMARY ***
Total pot $5 | Rake $0.25
Board [Kh Tc Td Qh]
Seat 1: /inIs/z/PcX+TniIFpaxpg folded before Flop (didn't bet)
Seat 2: lQYT23h5QCUVZAKxjOO39Q folded before Flop (didn't bet)
Seat 3: OipzuP0MueAd8hGaz/kWMQ collected ($4.75)
Seat 4: ri8CLkX3e9JF34dQNbsHGA folded before Flop (didn't bet)
Seat 5: vxbbJLsS1bva6tW2NiFssg folded before Flop (didn't bet)
Seat 6: CkE3IyJF1KvdaAOmZY5XqQ (button) folded before Flop (didn't bet)
Seat 7: pCmk6FpSOLJ+85o1tLHIag (small blind) folded before Flop
Seat 8: iMe5yhc+1BaiIPHet3NMrA (big blind) folded on the Turn
Seat 9: qn8LDoUFphcG4+r+F+Vhrg folded before Flop (didn't bet)



PokerStars Game #59940826410:  Hold'em No Limit ($1/$2) - 2009/07/01 1:17:43 ET
Table 'pPQgcj9XT9CHBsbo1WTBug' 6-max Seat #3 is the button
Seat 1: DFVYDA6dKQy7R7mGIKogZA ($143.60 in chips)
Seat 2: qXDd0ZyMIse0OBu8pxeQ3Q ($209.95 in chips)
Seat 3: WfaZs12BkYO+BUX5VWpuWQ ($21.85 in chips)
Seat 4: gqlysXCbT8V54f/1lf9h3A ($43 in chips)
Seat 5: vkfxu8f/jMYKUk6Ly4eujw ($229.10 in chips)
Seat 6: Yr7pZltpy3IUNdKS9PCEiw ($271.90 in chips)
gqlysXCbT8V54f/1lf9h3A: posts small blind $1
vkfxu8f/jMYKUk6Ly4eujw: posts big blind $2
*** HOLE CARDS ***
Yr7pZltpy3IUNdKS9PCEiw: folds
DFVYDA6dKQy7R7mGIKogZA: raises $4 to $6
qXDd0ZyMIse0OBu8pxeQ3Q: folds
WfaZs12BkYO+BUX5VWpuWQ: raises $15.85 to $21.85 and is all-in
gqlysXCbT8V54f/1lf9h3A: folds
vkfxu8f/jMYKUk6Ly4eujw: folds
DFVYDA6dKQy7R7mGIKogZA: calls $15.85
*** FLOP *** [Jc 6c 4d]
*** TURN *** [Jc 6c 4d] [5h]
*** RIVER *** [Jc 6c 4d 5h] [4s]
*** SHOW DOWN ***
DFVYDA6dKQy7R7mGIKogZA: shows [As Qc] (a pair of Fours)
WfaZs12BkYO+BUX5VWpuWQ: shows [Qh Qd] (two pair, Queens and Fours)
WfaZs12BkYO+BUX5VWpuWQ collected $44.40 from pot
*** SUMMARY ***
Total pot $46.70 | Rake $2.30
Board [Jc 6c 4d 5h 4s]
Seat 1: DFVYDA6dKQy7R7mGIKogZA showed [As Qc] and lost with a pair of Fours
Seat 2: qXDd0ZyMIse0OBu8pxeQ3Q folded before Flop (didn't bet)
Seat 3: WfaZs12BkYO+BUX5VWpuWQ (button) showed [Qh Qd] and won ($44.40) with two pair, Queens and Fours
Seat 4: gqlysXCbT8V54f/1lf9h3A (small blind) folded before Flop
Seat 5: vkfxu8f/jMYKUk6Ly4eujw (big blind) folded before Flop
Seat 6: Yr7pZltpy3IUNdKS9PCEiw folded before Flop (didn't bet)



PokerStars Game #59940827690:  Hold'em No Limit ($1/$2) - 2009/07/01 1:17:45 ET
Table 'gnHBqWll9O3fxG7Ojkz/ng' 9-max Seat #8 is the button
Seat 1: TAfo4veNRaRlzDXMMYS3Jg ($40 in chips)
Seat 2: H6Z4+qu8gR0VUiPOijndVg ($333.25 in chips)
Seat 3: 5Q8U6iZbeO7xJSS4qvDP5g ($218 in chips)
Seat 5: rBQDMkKm9cZn6M9NPsiVew ($239.45 in chips)
Seat 6: /inIs/z/PcX+TniIFpaxpg ($42 in chips)
Seat 7: jqui3xAWCkcdPW36a6BD+w ($344.40 in chips)
Seat 8: cM6efHzdxoqYm0EQKP4TTQ ($103.30 in chips)
Seat 9: sN6yR5I5zFq/WFyIz5UfzQ ($202 in chips)
sN6yR5I5zFq/WFyIz5UfzQ: posts small blind $1
TAfo4veNRaRlzDXMMYS3Jg: posts big blind $2
*** HOLE CARDS ***
H6Z4+qu8gR0VUiPOijndVg: folds
5Q8U6iZbeO7xJSS4qvDP5g: folds
rBQDMkKm9cZn6M9NPsiVew: folds
/inIs/z/PcX+TniIFpaxpg: raises $6 to $8
jqui3xAWCkcdPW36a6BD+w: folds
cM6efHzdxoqYm0EQKP4TTQ: folds
sN6yR5I5zFq/WFyIz5UfzQ: folds
TAfo4veNRaRlzDXMMYS3Jg: folds
/inIs/z/PcX+TniIFpaxpg collected $5 from pot
/inIs/z/PcX+TniIFpaxpg: doesn't show hand
*** SUMMARY ***
Total pot $5 | Rake $0
Seat 1: TAfo4veNRaRlzDXMMYS3Jg (big blind) folded before Flop
Seat 2: H6Z4+qu8gR0VUiPOijndVg folded before Flop (didn't bet)
Seat 3: 5Q8U6iZbeO7xJSS4qvDP5g folded before Flop (didn't bet)
Seat 5: rBQDMkKm9cZn6M9NPsiVew folded before Flop (didn't bet)
Seat 6: /inIs/z/PcX+TniIFpaxpg collected ($5)
Seat 7: jqui3xAWCkcdPW36a6BD+w folded before Flop (didn't bet)
Seat 8: cM6efHzdxoqYm0EQKP4TTQ (button) folded before Flop (didn't bet)
Seat 9: sN6yR5I5zFq/WFyIz5UfzQ (small blind) folded before Flop



PokerStars Game #59940828434:  Hold'em No Limit ($1/$2) - 2009/07/01 1:17:46 ET
Table 'W9UeSV0aoPjh5SFSxM8jUQ' 9-max Seat #5 is the button
Seat 1: mIKx5lhIt13X5eZQH0ZeMA ($37 in chips)
Seat 2: iMe5yhc+1BaiIPHet3NMrA ($255.60 in chips)
Seat 3: /inIs/z/PcX+TniIFpaxpg ($25 in chips)
Seat 4: LjOrlR1DLUQ+KE0gh7hP6Q ($92.40 in chips)
Seat 5: ri8CLkX3e9JF34dQNbsHGA ($42.45 in chips)
Seat 6: j47DM+lqTfzZP8musviQTg ($94.50 in chips)
Seat 7: I2ipWauytvrkEer4XD3Sjg ($118 in chips)
Seat 8: odhvI/CZeMsPyo1n1U7+hA ($52.70 in chips)
Seat 9: Q104K4iDGcqOlVrjAkzPEA ($31 in chips)
j47DM+lqTfzZP8musviQTg: posts small blind $1
I2ipWauytvrkEer4XD3Sjg: posts big blind $2
*** HOLE CARDS ***
odhvI/CZeMsPyo1n1U7+hA: folds
Q104K4iDGcqOlVrjAkzPEA: folds
mIKx5lhIt13X5eZQH0ZeMA: raises $2 to $4
iMe5yhc+1BaiIPHet3NMrA: folds
/inIs/z/PcX+TniIFpaxpg: folds
LjOrlR1DLUQ+KE0gh7hP6Q: calls $4
ri8CLkX3e9JF34dQNbsHGA: folds
j47DM+lqTfzZP8musviQTg: calls $3
I2ipWauytvrkEer4XD3Sjg: folds
*** FLOP *** [4c Tc Kd]
j47DM+lqTfzZP8musviQTg: checks
mIKx5lhIt13X5eZQH0ZeMA: bets $4
LjOrlR1DLUQ+KE0gh7hP6Q: calls $4
j47DM+lqTfzZP8musviQTg: folds
*** TURN *** [4c Tc Kd] [Ah]
mIKx5lhIt13X5eZQH0ZeMA: bets $4
LjOrlR1DLUQ+KE0gh7hP6Q: raises $4 to $8
mIKx5lhIt13X5eZQH0ZeMA: folds
LjOrlR1DLUQ+KE0gh7hP6Q collected $28.60 from pot
*** SUMMARY ***
Total pot $30 | Rake $1.40
Board [4c Tc Kd Ah]
Seat 1: mIKx5lhIt13X5eZQH0ZeMA folded on the Turn
Seat 2: iMe5yhc+1BaiIPHet3NMrA folded before Flop (didn't bet)
Seat 3: /inIs/z/PcX+TniIFpaxpg folded before Flop (didn't bet)
Seat 4: LjOrlR1DLUQ+KE0gh7hP6Q collected ($28.60)
Seat 5: ri8CLkX3e9JF34dQNbsHGA (button) folded before Flop (didn't bet)
Seat 6: j47DM+lqTfzZP8musviQTg (small blind) folded on the Flop
Seat 7: I2ipWauytvrkEer4XD3Sjg (big blind) folded before Flop
Seat 8: odhvI/CZeMsPyo1n1U7+hA folded before Flop (didn't bet)
Seat 9: Q104K4iDGcqOlVrjAkzPEA folded before Flop (didn't bet)



PokerStars Game #59940829012:  Hold'em No Limit ($1/$2) - 2009/07/01 1:17:47 ET
Table 'QxerF7GUfCbl+4a8XaTB2w' 6-max Seat #3 is the button
Seat 1: o9jamqIi6sTTRSqudgboRA ($295.50 in chips)
Seat 2: vkfxu8f/jMYKUk6Ly4eujw ($196.80 in chips)
Seat 3: m7mYVfnCOK5TE/VkN/FhOg ($232.70 in chips)
Seat 4: 09BNF4quPDzanQzM8vc6WA ($41.55 in chips)
Seat 5: YsLQ3BAvgQHWXMAv3Wv6Hg ($200 in chips)
Seat 6: VvdR9F3I+2yELkfTVvC1dg ($224.60 in chips)
09BNF4quPDzanQzM8vc6WA: posts small blind $1
YsLQ3BAvgQHWXMAv3Wv6Hg: posts big blind $2
*** HOLE CARDS ***
VvdR9F3I+2yELkfTVvC1dg: folds
o9jamqIi6sTTRSqudgboRA: folds
vkfxu8f/jMYKUk6Ly4eujw: folds
m7mYVfnCOK5TE/VkN/FhOg: calls $2
09BNF4quPDzanQzM8vc6WA: folds
YsLQ3BAvgQHWXMAv3Wv6Hg: checks
*** FLOP *** [2c 9s 2h]
YsLQ3BAvgQHWXMAv3Wv6Hg: bets $4
m7mYVfnCOK5TE/VkN/FhOg: folds
YsLQ3BAvgQHWXMAv3Wv6Hg collected $4.75 from pot
YsLQ3BAvgQHWXMAv3Wv6Hg: doesn't show hand
*** SUMMARY ***
Total pot $5 | Rake $0.25
Board [2c 9s 2h]
Seat 1: o9jamqIi6sTTRSqudgboRA folded before Flop (didn't bet)
Seat 2: vkfxu8f/jMYKUk6Ly4eujw folded before Flop (didn't bet)
Seat 3: m7mYVfnCOK5TE/VkN/FhOg (button) folded on the Flop
Seat 4: 09BNF4quPDzanQzM8vc6WA (small blind) folded before Flop
Seat 5: YsLQ3BAvgQHWXMAv3Wv6Hg (big blind) collected ($4.75)
Seat 6: VvdR9F3I+2yELkfTVvC1dg folded before Flop (didn't bet)



PokerStars Game #59940829346:  Hold'em No Limit ($1/$2) - 2009/07/01 1:17:48 ET
Table 'C4lkCXY2PWy6z4vsAe5NGQ' 6-max Seat #4 is the button
Seat 1: 4bqvCfJ0e8CTYnn0Go9hbQ ($49.85 in chips)
Seat 2: 6hRJ68JkbJq6MYI9o5bUnQ ($52.40 in chips)
Seat 3: sTPOWERd9HWPCNrDBwsVjA ($215.35 in chips)
Seat 4: VvdR9F3I+2yELkfTVvC1dg ($200 in chips)
Seat 6: B87ikIyZ/TzAVeXf38Ny0g ($615.75 in chips)
B87ikIyZ/TzAVeXf38Ny0g: posts small blind $1
4bqvCfJ0e8CTYnn0Go9hbQ: posts big blind $2
*** HOLE CARDS ***
6hRJ68JkbJq6MYI9o5bUnQ: calls $2
sTPOWERd9HWPCNrDBwsVjA: folds
VvdR9F3I+2yELkfTVvC1dg: raises $6 to $8
B87ikIyZ/TzAVeXf38Ny0g: folds
4bqvCfJ0e8CTYnn0Go9hbQ: calls $6
6hRJ68JkbJq6MYI9o5bUnQ: calls $6
*** FLOP *** [Td 2c 8c]
4bqvCfJ0e8CTYnn0Go9hbQ: checks
dKvrkfQx2Peke3ikZLUy1w said, "****in donk"
6hRJ68JkbJq6MYI9o5bUnQ: checks
dKvrkfQx2Peke3ikZLUy1w said, "dkhead"
VvdR9F3I+2yELkfTVvC1dg: checks
*** TURN *** [Td 2c 8c] [Th]
4bqvCfJ0e8CTYnn0Go9hbQ: bets $41.85 and is all-in
6hRJ68JkbJq6MYI9o5bUnQ: folds
dKvrkfQx2Peke3ikZLUy1w said, "****IN SPASTIC"
VvdR9F3I+2yELkfTVvC1dg: folds
dKvrkfQx2Peke3ikZLUy1w said, "all in on a ****in draw"
4bqvCfJ0e8CTYnn0Go9hbQ collected $23.75 from pot
4bqvCfJ0e8CTYnn0Go9hbQ: doesn't show hand
*** SUMMARY ***
Total pot $25 | Rake $1.25
Board [Td 2c 8c Th]
Seat 1: 4bqvCfJ0e8CTYnn0Go9hbQ (big blind) collected ($23.75)
Seat 2: 6hRJ68JkbJq6MYI9o5bUnQ folded on the Turn
Seat 3: sTPOWERd9HWPCNrDBwsVjA folded before Flop (didn't bet)
Seat 4: VvdR9F3I+2yELkfTVvC1dg (button) folded on the Turn
Seat 6: B87ikIyZ/TzAVeXf38Ny0g (small blind) folded before Flop



PokerStars Game #59940829508:  Hold'em No Limit ($1/$2) - 2009/07/01 1:17:48 ET
Table 'P/yCfYl1GfGsu/e6DxDy/A' 2-max Seat #2 is the button
Seat 1: 7fOCUy3x9hdkmXkkDNolGQ ($562.50 in chips)
Seat 2: RwDoM55ZeQuI2ADyJhOb2Q ($927 in chips)
RwDoM55ZeQuI2ADyJhOb2Q: posts small blind $1
7fOCUy3x9hdkmXkkDNolGQ: posts big blind $2
*** HOLE CARDS ***
RwDoM55ZeQuI2ADyJhOb2Q: raises $4 to $6
7fOCUy3x9hdkmXkkDNolGQ: raises $14 to $20
RwDoM55ZeQuI2ADyJhOb2Q: calls $14
*** FLOP *** [4h 5d Kc]
7fOCUy3x9hdkmXkkDNolGQ: bets $22
RwDoM55ZeQuI2ADyJhOb2Q: raises $22 to $44
7fOCUy3x9hdkmXkkDNolGQ: calls $22
*** TURN *** [4h 5d Kc] [5s]
7fOCUy3x9hdkmXkkDNolGQ: checks
RwDoM55ZeQuI2ADyJhOb2Q: bets $102
7fOCUy3x9hdkmXkkDNolGQ: calls $102
*** RIVER *** [4h 5d Kc 5s] [Qs]
7fOCUy3x9hdkmXkkDNolGQ: checks
RwDoM55ZeQuI2ADyJhOb2Q: checks
*** SHOW DOWN ***
7fOCUy3x9hdkmXkkDNolGQ: shows [3h Kh] (two pair, Kings and Fives)
RwDoM55ZeQuI2ADyJhOb2Q: mucks hand
7fOCUy3x9hdkmXkkDNolGQ collected $331.50 from pot
*** SUMMARY ***
Total pot $332 | Rake $0.50
Board [4h 5d Kc 5s Qs]
Seat 1: 7fOCUy3x9hdkmXkkDNolGQ (big blind) showed [3h Kh] and won ($331.50) with two pair, Kings and Fives
Seat 2: RwDoM55ZeQuI2ADyJhOb2Q (button) (small blind) mucked



PokerStars Game #59940830034:  Hold'em No Limit ($1/$2) - 2009/07/01 1:17:49 ET
Table 'NmY84NAf9Mh0ckAckHnh5g' 2-max Seat #2 is the button
Seat 1: 6hvg964TSqZ3AL/0XK9aVQ ($243.30 in chips)
Seat 2: RwDoM55ZeQuI2ADyJhOb2Q ($767.90 in chips)
RwDoM55ZeQuI2ADyJhOb2Q: posts small blind $1
6hvg964TSqZ3AL/0XK9aVQ: posts big blind $2
*** HOLE CARDS ***
RwDoM55ZeQuI2ADyJhOb2Q: raises $4 to $6
6hvg964TSqZ3AL/0XK9aVQ: calls $4
*** FLOP *** [Jd Ks 9s]
6hvg964TSqZ3AL/0XK9aVQ: checks
RwDoM55ZeQuI2ADyJhOb2Q: bets $8
6hvg964TSqZ3AL/0XK9aVQ: calls $8
*** TURN *** [Jd Ks 9s] [9d]
6hvg964TSqZ3AL/0XK9aVQ: checks
RwDoM55ZeQuI2ADyJhOb2Q: checks
*** RIVER *** [Jd Ks 9s 9d] [Qc]
6hvg964TSqZ3AL/0XK9aVQ: checks
RwDoM55ZeQuI2ADyJhOb2Q: bets $22
6hvg964TSqZ3AL/0XK9aVQ: calls $22
*** SHOW DOWN ***
RwDoM55ZeQuI2ADyJhOb2Q: shows [2h Kd] (two pair, Kings and Nines)
6hvg964TSqZ3AL/0XK9aVQ: mucks hand
RwDoM55ZeQuI2ADyJhOb2Q collected $71.50 from pot
*** SUMMARY ***
Total pot $72 | Rake $0.50
Board [Jd Ks 9s 9d Qc]
Seat 1: 6hvg964TSqZ3AL/0XK9aVQ (big blind) mucked
Seat 2: RwDoM55ZeQuI2ADyJhOb2Q (button) (small blind) showed [2h Kd] and won ($71.50) with two pair, Kings and Nines



PokerStars Game #59940829920:  Hold'em No Limit ($1/$2) - 2009/07/01 1:17:49 ET
Table 'CFkQcfWjKccZaZDf71FK+w' 6-max Seat #2 is the button
Seat 1: JsC+WvfzqlxVs9G8/gSQAQ ($139.30 in chips)
Seat 2: ewN/vzF22+/gdzjIKBOlkA ($227.05 in chips)
Seat 3: 09BNF4quPDzanQzM8vc6WA ($34 in chips)
Seat 4: ygTTt5ehT4aF86q1a8/R+w ($160.10 in chips)
Seat 5: 2lOU1DcvUZaMcxZ95XfzXw ($71 in chips)
Seat 6: ORVqY3rf9X6ANA/8s+On2Q ($57.75 in chips)
09BNF4quPDzanQzM8vc6WA: posts small blind $1
ygTTt5ehT4aF86q1a8/R+w: posts big blind $2
*** HOLE CARDS ***
2lOU1DcvUZaMcxZ95XfzXw: calls $2
ORVqY3rf9X6ANA/8s+On2Q: folds
JsC+WvfzqlxVs9G8/gSQAQ: raises $2 to $4
ewN/vzF22+/gdzjIKBOlkA: folds
09BNF4quPDzanQzM8vc6WA: folds
ygTTt5ehT4aF86q1a8/R+w: raises $14 to $18
2lOU1DcvUZaMcxZ95XfzXw: folds
JsC+WvfzqlxVs9G8/gSQAQ: calls $14
*** FLOP *** [2h 6s Ac]
ygTTt5ehT4aF86q1a8/R+w: checks
JsC+WvfzqlxVs9G8/gSQAQ: checks
*** TURN *** [2h 6s Ac] [9h]
ygTTt5ehT4aF86q1a8/R+w: bets $18
JsC+WvfzqlxVs9G8/gSQAQ: calls $18
*** RIVER *** [2h 6s Ac 9h] [4d]
ygTTt5ehT4aF86q1a8/R+w: bets $40
JsC+WvfzqlxVs9G8/gSQAQ: folds
ygTTt5ehT4aF86q1a8/R+w collected $72 from pot
*** SUMMARY ***
Total pot $75 | Rake $3
Board [2h 6s Ac 9h 4d]
Seat 1: JsC+WvfzqlxVs9G8/gSQAQ folded on the River
Seat 2: ewN/vzF22+/gdzjIKBOlkA (button) folded before Flop (didn't bet)
Seat 3: 09BNF4quPDzanQzM8vc6WA (small blind) folded before Flop
Seat 4: ygTTt5ehT4aF86q1a8/R+w (big blind) collected ($72)
Seat 5: 2lOU1DcvUZaMcxZ95XfzXw folded before Flop
Seat 6: ORVqY3rf9X6ANA/8s+On2Q folded before Flop (didn't bet)



PokerStars Game #59940830588:  Hold'em No Limit ($1/$2) - 2009/07/01 1:17:50 ET
Table 'mGpP9StWRnoeiBDExc6Frg' 6-max Seat #3 is the button
Seat 1: VvdR9F3I+2yELkfTVvC1dg ($200 in chips)
Seat 2: dZcLsEI8iXkobBduRJ45Yw ($55 in chips)
Seat 3: 7acrZUQC3Zc9BNLjoKIcLQ ($47.10 in chips)
Seat 4: 4dcDwIHRm96PwtqkpQiuiA ($44.35 in chips)
Seat 5: d1puGuVBE0fidn+5eRJ0tw ($230.20 in chips)
Seat 6: B2Ih1sr5VZk+8He7rcrMtQ ($462.35 in chips)
4dcDwIHRm96PwtqkpQiuiA: posts small blind $1
d1puGuVBE0fidn+5eRJ0tw: posts big blind $2
*** HOLE CARDS ***
B2Ih1sr5VZk+8He7rcrMtQ: folds
VvdR9F3I+2yELkfTVvC1dg: folds
dZcLsEI8iXkobBduRJ45Yw: calls $2
7acrZUQC3Zc9BNLjoKIcLQ: folds
4dcDwIHRm96PwtqkpQiuiA: folds
d1puGuVBE0fidn+5eRJ0tw: checks
*** FLOP *** [8c 6h Kd]
d1puGuVBE0fidn+5eRJ0tw: checks
dZcLsEI8iXkobBduRJ45Yw: bets $2
d1puGuVBE0fidn+5eRJ0tw: folds
dZcLsEI8iXkobBduRJ45Yw collected $4.75 from pot
dZcLsEI8iXkobBduRJ45Yw: doesn't show hand
*** SUMMARY ***
Total pot $5 | Rake $0.25
Board [8c 6h Kd]
Seat 1: VvdR9F3I+2yELkfTVvC1dg folded before Flop (didn't bet)
Seat 2: dZcLsEI8iXkobBduRJ45Yw collected ($4.75)
Seat 3: 7acrZUQC3Zc9BNLjoKIcLQ (button) folded before Flop (didn't bet)
Seat 4: 4dcDwIHRm96PwtqkpQiuiA (small blind) folded before Flop
Seat 5: d1puGuVBE0fidn+5eRJ0tw (big blind) folded on the Flop
Seat 6: B2Ih1sr5VZk+8He7rcrMtQ folded before Flop (didn't bet)



PokerStars Game #59940832522:  Hold'em No Limit ($1/$2) - 2009/07/01 1:17:53 ET
Table '8Y6PEyoNuepZTai2Q56aHw' 9-max Seat #3 is the button
Seat 1: 5Q8U6iZbeO7xJSS4qvDP5g ($282 in chips)
Seat 2: gDCJIAlovbPnTvMM7Dd1gA ($180.35 in chips)
Seat 3: WUlHm+ydPPHG7Lb0rePSdA ($120 in chips)
Seat 4: xKkwALG38OfLQ9DXuJgR1w ($286.55 in chips)
Seat 6: NtLDBSjsJQEKekh5cdinvw ($353.80 in chips)
Seat 7: Kzta8yu9vxHT4B70mjBZ+w ($200 in chips)
Seat 8: rW/MyplHylMSBRaoRUzWrg ($40 in chips)
Seat 9: F7m34OOfAQ7annesMHVjKw ($94.80 in chips)
xKkwALG38OfLQ9DXuJgR1w: posts small blind $1
NtLDBSjsJQEKekh5cdinvw: posts big blind $2
*** HOLE CARDS ***
Kzta8yu9vxHT4B70mjBZ+w: folds
rW/MyplHylMSBRaoRUzWrg: folds
F7m34OOfAQ7annesMHVjKw has timed out
F7m34OOfAQ7annesMHVjKw: folds
F7m34OOfAQ7annesMHVjKw is sitting out
F7m34OOfAQ7annesMHVjKw has returned
5Q8U6iZbeO7xJSS4qvDP5g: folds
gDCJIAlovbPnTvMM7Dd1gA: calls $2
WUlHm+ydPPHG7Lb0rePSdA: folds
xKkwALG38OfLQ9DXuJgR1w: calls $1
NtLDBSjsJQEKekh5cdinvw: checks
*** FLOP *** [Tc 3s 5d]
xKkwALG38OfLQ9DXuJgR1w: checks
NtLDBSjsJQEKekh5cdinvw: bets $4
gDCJIAlovbPnTvMM7Dd1gA: folds
xKkwALG38OfLQ9DXuJgR1w: folds
NtLDBSjsJQEKekh5cdinvw collected $5.70 from pot
NtLDBSjsJQEKekh5cdinvw: doesn't show hand
*** SUMMARY ***
Total pot $6 | Rake $0.30
Board [Tc 3s 5d]
Seat 1: 5Q8U6iZbeO7xJSS4qvDP5g folded before Flop (didn't bet)
Seat 2: gDCJIAlovbPnTvMM7Dd1gA folded on the Flop
Seat 3: WUlHm+ydPPHG7Lb0rePSdA (button) folded before Flop (didn't bet)
Seat 4: xKkwALG38OfLQ9DXuJgR1w (small blind) folded on the Flop
Seat 6: NtLDBSjsJQEKekh5cdinvw (big blind) collected ($5.70)
Seat 7: Kzta8yu9vxHT4B70mjBZ+w folded before Flop (didn't bet)
Seat 8: rW/MyplHylMSBRaoRUzWrg folded before Flop (didn't bet)
Seat 9: F7m34OOfAQ7annesMHVjKw folded before Flop (didn't bet)



PokerStars Game #59940833984:  Hold'em No Limit ($1/$2) - 2009/07/01 1:17:56 ET
Table '+hSnXFQrGw1PlVgTnuj+sA' 6-max Seat #1 is the button
Seat 1: 2ccIJhDj+3JapvS7swVZEg ($293.10 in chips)
Seat 2: o9jamqIi6sTTRSqudgboRA ($256.55 in chips)
Seat 3: fE+LHW/7rpfXW14g8LhGjA ($50.65 in chips)
Seat 4: J4iH5epwXbmODnojR/VRxA ($187 in chips)
Seat 5: VvdR9F3I+2yELkfTVvC1dg ($200 in chips)
Seat 6: AuiGltq875lmaKHBsjZVGg ($108.40 in chips)
o9jamqIi6sTTRSqudgboRA: posts small blind $1
fE+LHW/7rpfXW14g8LhGjA: posts big blind $2
*** HOLE CARDS ***
J4iH5epwXbmODnojR/VRxA: folds
VvdR9F3I+2yELkfTVvC1dg: folds
AuiGltq875lmaKHBsjZVGg: raises $4 to $6
2ccIJhDj+3JapvS7swVZEg: folds
o9jamqIi6sTTRSqudgboRA: folds
fE+LHW/7rpfXW14g8LhGjA: calls $4
*** FLOP *** [6c 8h 7c]
fE+LHW/7rpfXW14g8LhGjA: checks
AuiGltq875lmaKHBsjZVGg: bets $4
fE+LHW/7rpfXW14g8LhGjA: folds
AuiGltq875lmaKHBsjZVGg collected $12.35 from pot
*** SUMMARY ***
Total pot $13 | Rake $0.65
Board [6c 8h 7c]
Seat 1: 2ccIJhDj+3JapvS7swVZEg (button) folded before Flop (didn't bet)
Seat 2: o9jamqIi6sTTRSqudgboRA (small blind) folded before Flop
Seat 3: fE+LHW/7rpfXW14g8LhGjA (big blind) folded on the Flop
Seat 4: J4iH5epwXbmODnojR/VRxA folded before Flop (didn't bet)
Seat 5: VvdR9F3I+2yELkfTVvC1dg folded before Flop (didn't bet)
Seat 6: AuiGltq875lmaKHBsjZVGg collected ($12.35)



PokerStars Game #59940834486:  Hold'em No Limit ($1/$2) - 2009/07/01 1:17:57 ET
Table 'ZzSIe0zTCDv+n6hfbY5tTg' 6-max Seat #3 is the button
Seat 1: VvdR9F3I+2yELkfTVvC1dg ($204.55 in chips)
Seat 2: B87ikIyZ/TzAVeXf38Ny0g ($240 in chips)
Seat 3: gsugPj31Hui3Jefl98MBOA ($199 in chips)
Seat 4: qXDd0ZyMIse0OBu8pxeQ3Q ($200 in chips)
Seat 5: 3dAbvkxS5NPQTBAbvpinVg ($501.30 in chips)
Seat 6: 09BNF4quPDzanQzM8vc6WA ($28.50 in chips)
qXDd0ZyMIse0OBu8pxeQ3Q: posts small blind $1
3dAbvkxS5NPQTBAbvpinVg: posts big blind $2
*** HOLE CARDS ***
09BNF4quPDzanQzM8vc6WA: folds
VvdR9F3I+2yELkfTVvC1dg: raises $2 to $4
B87ikIyZ/TzAVeXf38Ny0g: folds
gsugPj31Hui3Jefl98MBOA: folds
qXDd0ZyMIse0OBu8pxeQ3Q: folds
3dAbvkxS5NPQTBAbvpinVg: calls $2
*** FLOP *** [As 6h 2s]
3dAbvkxS5NPQTBAbvpinVg: checks
VvdR9F3I+2yELkfTVvC1dg: bets $6.40
3dAbvkxS5NPQTBAbvpinVg: folds
VvdR9F3I+2yELkfTVvC1dg collected $8.55 from pot
VvdR9F3I+2yELkfTVvC1dg: doesn't show hand
*** SUMMARY ***
Total pot $9 | Rake $0.45
Board [As 6h 2s]
Seat 1: VvdR9F3I+2yELkfTVvC1dg collected ($8.55)
Seat 2: B87ikIyZ/TzAVeXf38Ny0g folded before Flop (didn't bet)
Seat 3: gsugPj31Hui3Jefl98MBOA (button) folded before Flop (didn't bet)
Seat 4: qXDd0ZyMIse0OBu8pxeQ3Q (small blind) folded before Flop
Seat 5: 3dAbvkxS5NPQTBAbvpinVg (big blind) folded on the Flop
Seat 6: 09BNF4quPDzanQzM8vc6WA folded before Flop (didn't bet)



PokerStars Game #59940835768:  Hold'em No Limit ($1/$2) - 2009/07/01 1:17:59 ET
Table 'dBLpiMEy1cezkSKD+ZpCcw' 2-max Seat #2 is the button
Seat 1: NFRtU1s5+WFh9EKwu+KLOQ ($242.50 in chips)
Seat 2: 4rrQUikeMSkuWGHgW80++w ($200 in chips)
4rrQUikeMSkuWGHgW80++w: posts small blind $1
NFRtU1s5+WFh9EKwu+KLOQ: posts big blind $2
*** HOLE CARDS ***
4rrQUikeMSkuWGHgW80++w: raises $4 to $6
NFRtU1s5+WFh9EKwu+KLOQ: folds
4rrQUikeMSkuWGHgW80++w collected $4 from pot
4rrQUikeMSkuWGHgW80++w: doesn't show hand
*** SUMMARY ***
Total pot $4 | Rake $0
Seat 1: NFRtU1s5+WFh9EKwu+KLOQ (big blind) folded before Flop
Seat 2: 4rrQUikeMSkuWGHgW80++w (button) (small blind) collected ($4)



PokerStars Game #59940836464:  Hold'em No Limit ($1/$2) - 2009/07/01 1:18:00 ET
Table 'TsEDkiO4tzCTCzJ7tNdEqw' 6-max Seat #5 is the button
Seat 1: MfXQsYD8pGeCS7XOtyV+vw ($88.90 in chips)
Seat 2: 4dcDwIHRm96PwtqkpQiuiA ($65.20 in chips)
Seat 3: wgRvjVPZSQvqNGiyR1jwSA ($40 in chips)
Seat 4: K8MXCrNAVYlMnnCeM32Kxw ($51.05 in chips)
Seat 5: VvdR9F3I+2yELkfTVvC1dg ($202.50 in chips)
Seat 6: uCqEjnxh2/vFBjKYkfTOkw ($260.25 in chips)
uCqEjnxh2/vFBjKYkfTOkw: posts small blind $1
MfXQsYD8pGeCS7XOtyV+vw: posts big blind $2
*** HOLE CARDS ***
4dcDwIHRm96PwtqkpQiuiA: folds
wgRvjVPZSQvqNGiyR1jwSA: raises $2 to $4
K8MXCrNAVYlMnnCeM32Kxw: folds
VvdR9F3I+2yELkfTVvC1dg: folds
uCqEjnxh2/vFBjKYkfTOkw: folds
MfXQsYD8pGeCS7XOtyV+vw: calls $2
*** FLOP *** [3c 4h Qh]
MfXQsYD8pGeCS7XOtyV+vw: checks
wgRvjVPZSQvqNGiyR1jwSA: bets $6
MfXQsYD8pGeCS7XOtyV+vw: calls $6
*** TURN *** [3c 4h Qh] [Ks]
MfXQsYD8pGeCS7XOtyV+vw: checks
wgRvjVPZSQvqNGiyR1jwSA: bets $12
MfXQsYD8pGeCS7XOtyV+vw: calls $12
*** RIVER *** [3c 4h Qh Ks] [8c]
MfXQsYD8pGeCS7XOtyV+vw: checks
wgRvjVPZSQvqNGiyR1jwSA: bets $18 and is all-in
MfXQsYD8pGeCS7XOtyV+vw: calls $18
*** SHOW DOWN ***
wgRvjVPZSQvqNGiyR1jwSA: shows [Jc Js] (a pair of Jacks)
MfXQsYD8pGeCS7XOtyV+vw: mucks hand
wgRvjVPZSQvqNGiyR1jwSA collected $78 from pot
*** SUMMARY ***
Total pot $81 | Rake $3
Board [3c 4h Qh Ks 8c]
Seat 1: MfXQsYD8pGeCS7XOtyV+vw (big blind) mucked
Seat 2: 4dcDwIHRm96PwtqkpQiuiA folded before Flop (didn't bet)
Seat 3: wgRvjVPZSQvqNGiyR1jwSA showed [Jc Js] and won ($78) with a pair of Jacks
Seat 4: K8MXCrNAVYlMnnCeM32Kxw folded before Flop (didn't bet)
Seat 5: VvdR9F3I+2yELkfTVvC1dg (button) folded before Flop (didn't bet)
Seat 6: uCqEjnxh2/vFBjKYkfTOkw (small blind) folded before Flop



PokerStars Game #59940836248:  Hold'em No Limit ($1/$2) - 2009/07/01 1:18:00 ET
Table 'qVXak+oTeDXMGbWa4sDU5Q' 9-max Seat #3 is the button
Seat 1: H6Z4+qu8gR0VUiPOijndVg ($252.55 in chips)
Seat 2: rW/MyplHylMSBRaoRUzWrg ($40 in chips)
Seat 3: WUlHm+ydPPHG7Lb0rePSdA ($169.65 in chips)
Seat 4: lQYT23h5QCUVZAKxjOO39Q ($104.25 in chips)
Seat 5: FWGiDqRwvLeKmHq9t4Jy9w ($268 in chips)
Seat 6: GX1heJ+DSsvm7gzSPsYhhQ ($37 in chips)
Seat 7: PfmlvZlFiss79a6IoEr11g ($124.30 in chips)
Seat 8: TAfo4veNRaRlzDXMMYS3Jg ($41 in chips)
Seat 9: CkE3IyJF1KvdaAOmZY5XqQ ($200 in chips)
lQYT23h5QCUVZAKxjOO39Q: posts small blind $1
FWGiDqRwvLeKmHq9t4Jy9w: posts big blind $2
*** HOLE CARDS ***
GX1heJ+DSsvm7gzSPsYhhQ: folds
PfmlvZlFiss79a6IoEr11g: folds
TAfo4veNRaRlzDXMMYS3Jg: folds
CkE3IyJF1KvdaAOmZY5XqQ: folds
H6Z4+qu8gR0VUiPOijndVg: folds
rW/MyplHylMSBRaoRUzWrg: folds
WUlHm+ydPPHG7Lb0rePSdA: folds
lQYT23h5QCUVZAKxjOO39Q: calls $1
FWGiDqRwvLeKmHq9t4Jy9w: checks
*** FLOP *** [6s Js 7s]
lQYT23h5QCUVZAKxjOO39Q: checks
FWGiDqRwvLeKmHq9t4Jy9w: checks
*** TURN *** [6s Js 7s] [6h]
lQYT23h5QCUVZAKxjOO39Q: checks
FWGiDqRwvLeKmHq9t4Jy9w: bets $4
lQYT23h5QCUVZAKxjOO39Q: folds
FWGiDqRwvLeKmHq9t4Jy9w collected $3.80 from pot
FWGiDqRwvLeKmHq9t4Jy9w: doesn't show hand
*** SUMMARY ***
Total pot $4 | Rake $0.20
Board [6s Js 7s 6h]
Seat 1: H6Z4+qu8gR0VUiPOijndVg folded before Flop (didn't bet)
Seat 2: rW/MyplHylMSBRaoRUzWrg folded before Flop (didn't bet)
Seat 3: WUlHm+ydPPHG7Lb0rePSdA (button) folded before Flop (didn't bet)
Seat 4: lQYT23h5QCUVZAKxjOO39Q (small blind) folded on the Turn
Seat 5: FWGiDqRwvLeKmHq9t4Jy9w (big blind) collected ($3.80)
Seat 6: GX1heJ+DSsvm7gzSPsYhhQ folded before Flop (didn't bet)
Seat 7: PfmlvZlFiss79a6IoEr11g folded before Flop (didn't bet)
Seat 8: TAfo4veNRaRlzDXMMYS3Jg folded before Flop (didn't bet)
Seat 9: CkE3IyJF1KvdaAOmZY5XqQ folded before Flop (didn't bet)



PokerStars Game #59940835964:  Hold'em No Limit ($1/$2) - 2009/07/01 1:18:00 ET
Table '/dyk+YdRGv90j2box35j8w' 6-max Seat #5 is the button
Seat 2: qCnEYuAE5y5A7bk6fO5/jQ ($487.95 in chips)
Seat 3: sTPOWERd9HWPCNrDBwsVjA ($228.50 in chips)
Seat 4: z/u1YTnkiIDrtp/2cA2dBg ($125.65 in chips)
Seat 5: VvdR9F3I+2yELkfTVvC1dg ($200 in chips)
Seat 6: ZwvXzkkZ3XpMhKfAmVpahw ($370.25 in chips)
ZwvXzkkZ3XpMhKfAmVpahw: posts small blind $1
qCnEYuAE5y5A7bk6fO5/jQ: posts big blind $2
*** HOLE CARDS ***
sTPOWERd9HWPCNrDBwsVjA: folds
z/u1YTnkiIDrtp/2cA2dBg: folds
VvdR9F3I+2yELkfTVvC1dg: folds
ZwvXzkkZ3XpMhKfAmVpahw: raises $4 to $6
qCnEYuAE5y5A7bk6fO5/jQ: calls $4
*** FLOP *** [Ac 5h 9h]
ZwvXzkkZ3XpMhKfAmVpahw: bets $8
qCnEYuAE5y5A7bk6fO5/jQ: calls $8
*** TURN *** [Ac 5h 9h] [5d]
ZwvXzkkZ3XpMhKfAmVpahw: checks
qCnEYuAE5y5A7bk6fO5/jQ: checks
*** RIVER *** [Ac 5h 9h 5d] [6h]
ZwvXzkkZ3XpMhKfAmVpahw: checks
qCnEYuAE5y5A7bk6fO5/jQ: checks
*** SHOW DOWN ***
ZwvXzkkZ3XpMhKfAmVpahw: shows [Qh Js] (a pair of Fives)
qCnEYuAE5y5A7bk6fO5/jQ: shows [7s As] (two pair, Aces and Fives)
qCnEYuAE5y5A7bk6fO5/jQ collected $26.65 from pot
*** SUMMARY ***
Total pot $28 | Rake $1.35
Board [Ac 5h 9h 5d 6h]
Seat 2: qCnEYuAE5y5A7bk6fO5/jQ (big blind) showed [7s As] and won ($26.65) with two pair, Aces and Fives
Seat 3: sTPOWERd9HWPCNrDBwsVjA folded before Flop (didn't bet)
Seat 4: z/u1YTnkiIDrtp/2cA2dBg folded before Flop (didn't bet)
Seat 5: VvdR9F3I+2yELkfTVvC1dg (button) folded before Flop (didn't bet)
Seat 6: ZwvXzkkZ3XpMhKfAmVpahw (small blind) showed [Qh Js] and lost with a pair of Fives



PokerStars Game #59940837874:  Hold'em No Limit ($1/$2) - 2009/07/01 1:18:03 ET
Table 'ztv6V3FN2bQ9nmJPPdx6nQ' 6-max Seat #4 is the button
Seat 2: 5Y+ZGWLI4gnlpApDX5vy1A ($402.40 in chips)
Seat 4: UaZ5yj+6LjtWqMQg2QskUw ($112.80 in chips)
Seat 5: sTPOWERd9HWPCNrDBwsVjA ($260 in chips)
Seat 6: mfy7uGZcqA2PVQqEVbJ7+g ($112.45 in chips)
sTPOWERd9HWPCNrDBwsVjA: posts small blind $1
ubtx4Z5L+AcK71MTvYiGVw joins the table at seat #3
mfy7uGZcqA2PVQqEVbJ7+g: posts big blind $2
6fLdOUCRtX71xbVRhJEq8w: sits out
*** HOLE CARDS ***
5Y+ZGWLI4gnlpApDX5vy1A: folds
UaZ5yj+6LjtWqMQg2QskUw: folds
sTPOWERd9HWPCNrDBwsVjA: raises $4 to $6
mfy7uGZcqA2PVQqEVbJ7+g: raises $16 to $22
sTPOWERd9HWPCNrDBwsVjA: folds
mfy7uGZcqA2PVQqEVbJ7+g collected $12 from pot
mfy7uGZcqA2PVQqEVbJ7+g: doesn't show hand
*** SUMMARY ***
Total pot $12 | Rake $0
Seat 2: 5Y+ZGWLI4gnlpApDX5vy1A folded before Flop (didn't bet)
Seat 4: UaZ5yj+6LjtWqMQg2QskUw (button) folded before Flop (didn't bet)
Seat 5: sTPOWERd9HWPCNrDBwsVjA (small blind) folded before Flop
Seat 6: mfy7uGZcqA2PVQqEVbJ7+g (big blind) collected ($12)



PokerStars Game #59940838160:  Hold'em No Limit ($1/$2) - 2009/07/01 1:18:03 ET
Table 'kq5zaQ+1hLNf8LZfGnbTAA' 6-max Seat #3 is the button
Seat 1: 8srN1dKQePlsv0GyTada+Q ($240 in chips)
Seat 2: nXDI8Y/S6POzRwANu3d8hQ ($41.75 in chips)
Seat 3: vkfxu8f/jMYKUk6Ly4eujw ($219.70 in chips)
Seat 4: 3dAbvkxS5NPQTBAbvpinVg ($200 in chips)
Seat 5: kfASJqTbXek+zc8ZKsZL1Q ($141.40 in chips)
Seat 6: mfy7uGZcqA2PVQqEVbJ7+g ($202.25 in chips)
3dAbvkxS5NPQTBAbvpinVg: posts small blind $1
kfASJqTbXek+zc8ZKsZL1Q: posts big blind $2
*** HOLE CARDS ***
mfy7uGZcqA2PVQqEVbJ7+g: folds
8srN1dKQePlsv0GyTada+Q: raises $4 to $6
nXDI8Y/S6POzRwANu3d8hQ: folds
vkfxu8f/jMYKUk6Ly4eujw: calls $6
3dAbvkxS5NPQTBAbvpinVg: folds
kfASJqTbXek+zc8ZKsZL1Q: folds
*** FLOP *** [Jd 9h 2c]
8srN1dKQePlsv0GyTada+Q: checks
vkfxu8f/jMYKUk6Ly4eujw: bets $14
8srN1dKQePlsv0GyTada+Q: folds
vkfxu8f/jMYKUk6Ly4eujw collected $14.25 from pot
vkfxu8f/jMYKUk6Ly4eujw: doesn't show hand
*** SUMMARY ***
Total pot $15 | Rake $0.75
Board [Jd 9h 2c]
Seat 1: 8srN1dKQePlsv0GyTada+Q folded on the Flop
Seat 2: nXDI8Y/S6POzRwANu3d8hQ folded before Flop (didn't bet)
Seat 3: vkfxu8f/jMYKUk6Ly4eujw (button) collected ($14.25)
Seat 4: 3dAbvkxS5NPQTBAbvpinVg (small blind) folded before Flop
Seat 5: kfASJqTbXek+zc8ZKsZL1Q (big blind) folded before Flop
Seat 6: mfy7uGZcqA2PVQqEVbJ7+g folded before Flop (didn't bet)



PokerStars Game #59940839542:  Hold'em No Limit ($1/$2) - 2009/07/01 1:18:06 ET
Table 'YqGfR5eHfMeSjb9a+QU9rg' 9-max Seat #4 is the button
Seat 1: rW/MyplHylMSBRaoRUzWrg ($37 in chips)
Seat 2: W3Nqt1GWlTi9tXQXMNEvgw ($382.70 in chips)
Seat 3: /gll27k+xWYV7Fbki0lFDQ ($268.10 in chips)
Seat 4: QHxJjpVYwitg9krW6wZgJA ($217.30 in chips)
Seat 5: CkE3IyJF1KvdaAOmZY5XqQ ($200 in chips)
Seat 6: TAfo4veNRaRlzDXMMYS3Jg ($40 in chips)
Seat 7: 41aZuLBz9nAi2GPVKabmCw ($117.75 in chips)
Seat 8: JnV3SM2D6dAFYyGZHHpvrg ($77.70 in chips)
Seat 9: /inIs/z/PcX+TniIFpaxpg ($206.05 in chips)
CkE3IyJF1KvdaAOmZY5XqQ: posts small blind $1
TAfo4veNRaRlzDXMMYS3Jg: posts big blind $2
*** HOLE CARDS ***
41aZuLBz9nAi2GPVKabmCw: raises $4 to $6
JnV3SM2D6dAFYyGZHHpvrg: raises $14 to $20
/inIs/z/PcX+TniIFpaxpg: folds
rW/MyplHylMSBRaoRUzWrg: folds
W3Nqt1GWlTi9tXQXMNEvgw: folds
/gll27k+xWYV7Fbki0lFDQ: folds
QHxJjpVYwitg9krW6wZgJA: folds
CkE3IyJF1KvdaAOmZY5XqQ: folds
TAfo4veNRaRlzDXMMYS3Jg: folds
41aZuLBz9nAi2GPVKabmCw: calls $14
*** FLOP *** [2s 9d 9s]
41aZuLBz9nAi2GPVKabmCw: checks
JnV3SM2D6dAFYyGZHHpvrg: bets $24
41aZuLBz9nAi2GPVKabmCw: folds
JnV3SM2D6dAFYyGZHHpvrg collected $40.85 from pot
*** SUMMARY ***
Total pot $43 | Rake $2.15
Board [2s 9d 9s]
Seat 1: rW/MyplHylMSBRaoRUzWrg folded before Flop (didn't bet)
Seat 2: W3Nqt1GWlTi9tXQXMNEvgw folded before Flop (didn't bet)
Seat 3: /gll27k+xWYV7Fbki0lFDQ folded before Flop (didn't bet)
Seat 4: QHxJjpVYwitg9krW6wZgJA (button) folded before Flop (didn't bet)
Seat 5: CkE3IyJF1KvdaAOmZY5XqQ (small blind) folded before Flop
Seat 6: TAfo4veNRaRlzDXMMYS3Jg (big blind) folded before Flop
Seat 7: 41aZuLBz9nAi2GPVKabmCw folded on the Flop
Seat 8: JnV3SM2D6dAFYyGZHHpvrg collected ($40.85)
Seat 9: /inIs/z/PcX+TniIFpaxpg folded before Flop (didn't bet)



PokerStars Game #59940839510:  Hold'em No Limit ($1/$2) - 2009/07/01 1:18:06 ET
Table 'eyAQSIlgc2o1Jxvbve4WGg' 9-max Seat #1 is the button
Seat 1: UZEsV9yKUMqmpYPiOFpaZw ($101.50 in chips)
Seat 2: g7gL2NLJCdZPPV399WKT1w ($60.65 in chips)
Seat 3: ice1Sbe19zWIaKYoSmE5tw ($96.30 in chips)
Seat 4: CkE3IyJF1KvdaAOmZY5XqQ ($200 in chips)
Seat 5: mIKx5lhIt13X5eZQH0ZeMA ($56.25 in chips)
Seat 6: rW/MyplHylMSBRaoRUzWrg ($50.80 in chips)
Seat 7: QHxJjpVYwitg9krW6wZgJA ($278.45 in chips)
Seat 8: 1CtiZuXDFaJL1dJPQKyi8Q ($197.35 in chips)
Seat 9: WUlHm+ydPPHG7Lb0rePSdA ($123.70 in chips)
g7gL2NLJCdZPPV399WKT1w: posts small blind $1
ice1Sbe19zWIaKYoSmE5tw: posts big blind $2
*** HOLE CARDS ***
CkE3IyJF1KvdaAOmZY5XqQ: folds
mIKx5lhIt13X5eZQH0ZeMA: calls $2
rW/MyplHylMSBRaoRUzWrg: folds
QHxJjpVYwitg9krW6wZgJA: folds
1CtiZuXDFaJL1dJPQKyi8Q: folds
WUlHm+ydPPHG7Lb0rePSdA: folds
UZEsV9yKUMqmpYPiOFpaZw: folds
g7gL2NLJCdZPPV399WKT1w: raises $8 to $10
ice1Sbe19zWIaKYoSmE5tw: folds
mIKx5lhIt13X5eZQH0ZeMA: folds
g7gL2NLJCdZPPV399WKT1w collected $6 from pot
g7gL2NLJCdZPPV399WKT1w: doesn't show hand
*** SUMMARY ***
Total pot $6 | Rake $0
Seat 1: UZEsV9yKUMqmpYPiOFpaZw (button) folded before Flop (didn't bet)
Seat 2: g7gL2NLJCdZPPV399WKT1w (small blind) collected ($6)
Seat 3: ice1Sbe19zWIaKYoSmE5tw (big blind) folded before Flop
Seat 4: CkE3IyJF1KvdaAOmZY5XqQ folded before Flop (didn't bet)
Seat 5: mIKx5lhIt13X5eZQH0ZeMA folded before Flop
Seat 6: rW/MyplHylMSBRaoRUzWrg folded before Flop (didn't bet)
Seat 7: QHxJjpVYwitg9krW6wZgJA folded before Flop (didn't bet)
Seat 8: 1CtiZuXDFaJL1dJPQKyi8Q folded before Flop (didn't bet)
Seat 9: WUlHm+ydPPHG7Lb0rePSdA folded before Flop (didn't bet)



PokerStars Game #59940839878:  Hold'em No Limit ($1/$2) - 2009/07/01 1:18:06 ET
Table '3WCXyaiCAbqSShQu7FIjvA' 9-max Seat #2 is the button
Seat 1: kTCkABD1UUldS9DFRGfCwQ ($115.60 in chips)
Seat 2: 1zQMh8lHgW3t2YhVeA+09A ($20.80 in chips)
Seat 3: 5Q8U6iZbeO7xJSS4qvDP5g ($201 in chips)
Seat 4: waEF/+pxZTxNo4FvsORuXg ($80 in chips)
Seat 5: CkE3IyJF1KvdaAOmZY5XqQ ($200 in chips)
Seat 6: 5jQlngvMSqM/WoonOcR5kw ($344.35 in chips)
Seat 7: QHxJjpVYwitg9krW6wZgJA ($200 in chips)
Seat 8: 1CtiZuXDFaJL1dJPQKyi8Q ($234.25 in chips)
Seat 9: FiXPLJyqb24l32QST2TInw ($110.55 in chips)
5Q8U6iZbeO7xJSS4qvDP5g: posts small blind $1
waEF/+pxZTxNo4FvsORuXg: posts big blind $2
*** HOLE CARDS ***
CkE3IyJF1KvdaAOmZY5XqQ: folds
5jQlngvMSqM/WoonOcR5kw: calls $2
QHxJjpVYwitg9krW6wZgJA: folds
1CtiZuXDFaJL1dJPQKyi8Q: folds
FiXPLJyqb24l32QST2TInw: folds
kTCkABD1UUldS9DFRGfCwQ: raises $4 to $6
1zQMh8lHgW3t2YhVeA+09A: calls $6
5Q8U6iZbeO7xJSS4qvDP5g: folds
waEF/+pxZTxNo4FvsORuXg: folds
5jQlngvMSqM/WoonOcR5kw: calls $4
*** FLOP *** [Ks 3h 2d]
5jQlngvMSqM/WoonOcR5kw: bets $2
kTCkABD1UUldS9DFRGfCwQ: raises $4 to $6
1zQMh8lHgW3t2YhVeA+09A: folds
5jQlngvMSqM/WoonOcR5kw: calls $4
*** TURN *** [Ks 3h 2d] [Qd]
5jQlngvMSqM/WoonOcR5kw: checks
kTCkABD1UUldS9DFRGfCwQ: bets $18
5jQlngvMSqM/WoonOcR5kw: calls $18
*** RIVER *** [Ks 3h 2d Qd] [5c]
5jQlngvMSqM/WoonOcR5kw: checks
kTCkABD1UUldS9DFRGfCwQ: checks
*** SHOW DOWN ***
5jQlngvMSqM/WoonOcR5kw: shows [Ac Js] (high card Ace)
kTCkABD1UUldS9DFRGfCwQ: shows [Ah Kc] (a pair of Kings)
kTCkABD1UUldS9DFRGfCwQ collected $66 from pot
*** SUMMARY ***
Total pot $69 | Rake $3
Board [Ks 3h 2d Qd 5c]
Seat 1: kTCkABD1UUldS9DFRGfCwQ showed [Ah Kc] and won ($66) with a pair of Kings
Seat 2: 1zQMh8lHgW3t2YhVeA+09A (button) folded on the Flop
Seat 3: 5Q8U6iZbeO7xJSS4qvDP5g (small blind) folded before Flop
Seat 4: waEF/+pxZTxNo4FvsORuXg (big blind) folded before Flop
Seat 5: CkE3IyJF1KvdaAOmZY5XqQ folded before Flop (didn't bet)
Seat 6: 5jQlngvMSqM/WoonOcR5kw showed [Ac Js] and lost with high card Ace
Seat 7: QHxJjpVYwitg9krW6wZgJA folded before Flop (didn't bet)
Seat 8: 1CtiZuXDFaJL1dJPQKyi8Q folded before Flop (didn't bet)
Seat 9: FiXPLJyqb24l32QST2TInw folded before Flop (didn't bet)



PokerStars Game #59940839644:  Hold'em No Limit ($1/$2) - 2009/07/01 1:18:06 ET
Table 'dBLpiMEy1cezkSKD+ZpCcw' 2-max Seat #1 is the button
Seat 1: NFRtU1s5+WFh9EKwu+KLOQ ($240.50 in chips)
Seat 2: 4rrQUikeMSkuWGHgW80++w ($202 in chips)
NFRtU1s5+WFh9EKwu+KLOQ: posts small blind $1
4rrQUikeMSkuWGHgW80++w: posts big blind $2
*** HOLE CARDS ***
NFRtU1s5+WFh9EKwu+KLOQ: calls $1
4rrQUikeMSkuWGHgW80++w: checks
*** FLOP *** [8h Ks 3s]
4rrQUikeMSkuWGHgW80++w: checks
NFRtU1s5+WFh9EKwu+KLOQ: checks
*** TURN *** [8h Ks 3s] [Ad]
4rrQUikeMSkuWGHgW80++w: checks
NFRtU1s5+WFh9EKwu+KLOQ: bets $6
4rrQUikeMSkuWGHgW80++w: folds
NFRtU1s5+WFh9EKwu+KLOQ collected $3.80 from pot
*** SUMMARY ***
Total pot $4 | Rake $0.20
Board [8h Ks 3s Ad]
Seat 1: NFRtU1s5+WFh9EKwu+KLOQ (button) (small blind) collected ($3.80)
Seat 2: 4rrQUikeMSkuWGHgW80++w (big blind) folded on the Turn



PokerStars Game #59940843398:  Hold'em No Limit ($1/$2) - 2009/07/01 1:18:13 ET
Table 'gftD4mDF7mIFKvSrIyaRbw' 9-max Seat #3 is the button
Seat 1: 31HuO+DQxppUQEedBWukug ($106 in chips)
Seat 2: GX1heJ+DSsvm7gzSPsYhhQ ($37 in chips)
Seat 3: CUZwDpLTQKhzarPe+JCLOQ ($214.10 in chips)
Seat 5: mpsfNtnMVDqQHTe92AhIdw ($121.50 in chips)
Seat 6: 2NvwF8W2nzsbS+G//yLAbQ ($162.50 in chips)
Seat 7: EBV6OktyeSmh4w6sWmcWOw ($215.65 in chips)
Seat 8: MpL4DeEqGQu0H8TJEbEOrg ($40 in chips)
Seat 9: F7m34OOfAQ7annesMHVjKw ($159.10 in chips)
mpsfNtnMVDqQHTe92AhIdw: posts small blind $1
2NvwF8W2nzsbS+G//yLAbQ: posts big blind $2
*** HOLE CARDS ***
EBV6OktyeSmh4w6sWmcWOw: folds
MpL4DeEqGQu0H8TJEbEOrg: folds
F7m34OOfAQ7annesMHVjKw: folds
31HuO+DQxppUQEedBWukug: folds
GX1heJ+DSsvm7gzSPsYhhQ: folds
/inIs/z/PcX+TniIFpaxpg joins the table at seat #4
CUZwDpLTQKhzarPe+JCLOQ: folds
mpsfNtnMVDqQHTe92AhIdw: folds
2NvwF8W2nzsbS+G//yLAbQ collected $2 from pot
*** SUMMARY ***
Total pot $2 | Rake $0
Seat 1: 31HuO+DQxppUQEedBWukug folded before Flop (didn't bet)
Seat 2: GX1heJ+DSsvm7gzSPsYhhQ folded before Flop (didn't bet)
Seat 3: CUZwDpLTQKhzarPe+JCLOQ (button) folded before Flop (didn't bet)
Seat 5: mpsfNtnMVDqQHTe92AhIdw (small blind) folded before Flop
Seat 6: 2NvwF8W2nzsbS+G//yLAbQ (big blind) collected ($2)
Seat 7: EBV6OktyeSmh4w6sWmcWOw folded before Flop (didn't bet)
Seat 8: MpL4DeEqGQu0H8TJEbEOrg folded before Flop (didn't bet)
Seat 9: F7m34OOfAQ7annesMHVjKw folded before Flop (didn't bet)



PokerStars Game #59940843974:  Hold'em No Limit ($1/$2) - 2009/07/01 1:18:14 ET
Table 'uJ9juaXXg9yIcSU8amxaXQ' 6-max Seat #4 is the button
Seat 1: JsqOjN/eHz0uYVf/PyUJ6Q ($152.85 in chips)
Seat 2: VvdR9F3I+2yELkfTVvC1dg ($200 in chips)
Seat 3: qXDd0ZyMIse0OBu8pxeQ3Q ($202 in chips)
Seat 4: zNjJ/y4emmF+vzrCDd+ooA ($226.05 in chips)
Seat 5: YsLQ3BAvgQHWXMAv3Wv6Hg ($231.75 in chips)
Seat 6: 2DFp9Veq1xxq64dCjwNuUw ($46.10 in chips)
YsLQ3BAvgQHWXMAv3Wv6Hg: posts small blind $1
2DFp9Veq1xxq64dCjwNuUw: posts big blind $2
*** HOLE CARDS ***
JsqOjN/eHz0uYVf/PyUJ6Q: folds
VvdR9F3I+2yELkfTVvC1dg: folds
qXDd0ZyMIse0OBu8pxeQ3Q: folds
zNjJ/y4emmF+vzrCDd+ooA: folds
YsLQ3BAvgQHWXMAv3Wv6Hg: folds
2DFp9Veq1xxq64dCjwNuUw collected $2 from pot
*** SUMMARY ***
Total pot $2 | Rake $0
Seat 1: JsqOjN/eHz0uYVf/PyUJ6Q folded before Flop (didn't bet)
Seat 2: VvdR9F3I+2yELkfTVvC1dg folded before Flop (didn't bet)
Seat 3: qXDd0ZyMIse0OBu8pxeQ3Q folded before Flop (didn't bet)
Seat 4: zNjJ/y4emmF+vzrCDd+ooA (button) folded before Flop (didn't bet)
Seat 5: YsLQ3BAvgQHWXMAv3Wv6Hg (small blind) folded before Flop
Seat 6: 2DFp9Veq1xxq64dCjwNuUw (big blind) collected ($2)



PokerStars Game #59940844792:  Hold'em No Limit ($1/$2) - 2009/07/01 1:18:15 ET
Table 'LL4bDFyhj5hsMpzaDugJZg' 6-max Seat #2 is the button
Seat 1: FwvID/fQGlpY3soi/lMTww ($77.90 in chips)
Seat 2: IZng3w8jiJHHp3LbYKLi4w ($28.50 in chips)
Seat 3: iI/NMpRxMkGieArQEhACSA ($280.70 in chips)
Seat 4: 8srN1dKQePlsv0GyTada+Q ($314.75 in chips)
Seat 5: A2GTwTiwkb1ilNWgW487Vg ($99.70 in chips)
Seat 6: 692Q4sfB0gTElzS0WMeg+A ($217.10 in chips)
iI/NMpRxMkGieArQEhACSA: posts small blind $1
8srN1dKQePlsv0GyTada+Q: posts big blind $2
*** HOLE CARDS ***
A2GTwTiwkb1ilNWgW487Vg: folds
692Q4sfB0gTElzS0WMeg+A: folds
FwvID/fQGlpY3soi/lMTww is connected
FwvID/fQGlpY3soi/lMTww: folds
IZng3w8jiJHHp3LbYKLi4w: folds
iI/NMpRxMkGieArQEhACSA: folds
8srN1dKQePlsv0GyTada+Q collected $2 from pot
*** SUMMARY ***
Total pot $2 | Rake $0
Seat 1: FwvID/fQGlpY3soi/lMTww folded before Flop (didn't bet)
Seat 2: IZng3w8jiJHHp3LbYKLi4w (button) folded before Flop (didn't bet)
Seat 3: iI/NMpRxMkGieArQEhACSA (small blind) folded before Flop
Seat 4: 8srN1dKQePlsv0GyTada+Q (big blind) collected ($2)
Seat 5: A2GTwTiwkb1ilNWgW487Vg folded before Flop (didn't bet)
Seat 6: 692Q4sfB0gTElzS0WMeg+A folded before Flop (didn't bet)



PokerStars Game #59940844724:  Hold'em No Limit ($1/$2) - 2009/07/01 1:18:15 ET
Table 'QxerF7GUfCbl+4a8XaTB2w' 6-max Seat #4 is the button
Seat 1: o9jamqIi6sTTRSqudgboRA ($295.50 in chips)
Seat 2: vkfxu8f/jMYKUk6Ly4eujw ($196.80 in chips)
Seat 3: m7mYVfnCOK5TE/VkN/FhOg ($230.70 in chips)
Seat 4: 09BNF4quPDzanQzM8vc6WA ($40.55 in chips)
Seat 5: YsLQ3BAvgQHWXMAv3Wv6Hg ($202.75 in chips)
Seat 6: VvdR9F3I+2yELkfTVvC1dg ($224.60 in chips)
YsLQ3BAvgQHWXMAv3Wv6Hg: posts small blind $1
VvdR9F3I+2yELkfTVvC1dg: posts big blind $2
*** HOLE CARDS ***
o9jamqIi6sTTRSqudgboRA: raises $5 to $7
vkfxu8f/jMYKUk6Ly4eujw: folds
m7mYVfnCOK5TE/VkN/FhOg: folds
09BNF4quPDzanQzM8vc6WA: folds
YsLQ3BAvgQHWXMAv3Wv6Hg: folds
VvdR9F3I+2yELkfTVvC1dg: folds
o9jamqIi6sTTRSqudgboRA collected $5 from pot
o9jamqIi6sTTRSqudgboRA: doesn't show hand
*** SUMMARY ***
Total pot $5 | Rake $0
Seat 1: o9jamqIi6sTTRSqudgboRA collected ($5)
Seat 2: vkfxu8f/jMYKUk6Ly4eujw folded before Flop (didn't bet)
Seat 3: m7mYVfnCOK5TE/VkN/FhOg folded before Flop (didn't bet)
Seat 4: 09BNF4quPDzanQzM8vc6WA (button) folded before Flop (didn't bet)
Seat 5: YsLQ3BAvgQHWXMAv3Wv6Hg (small blind) folded before Flop
Seat 6: VvdR9F3I+2yELkfTVvC1dg (big blind) folded before Flop



PokerStars Game #59940846538:  Hold'em No Limit ($1/$2) - 2009/07/01 1:18:18 ET
Table 'pPQgcj9XT9CHBsbo1WTBug' 6-max Seat #4 is the button
Seat 1: DFVYDA6dKQy7R7mGIKogZA ($121.75 in chips)
Seat 2: qXDd0ZyMIse0OBu8pxeQ3Q ($209.95 in chips)
Seat 3: WfaZs12BkYO+BUX5VWpuWQ ($44.40 in chips)
Seat 4: gqlysXCbT8V54f/1lf9h3A ($42 in chips)
Seat 5: vkfxu8f/jMYKUk6Ly4eujw ($227.10 in chips)
Seat 6: Yr7pZltpy3IUNdKS9PCEiw ($271.90 in chips)
vkfxu8f/jMYKUk6Ly4eujw: posts small blind $1
Yr7pZltpy3IUNdKS9PCEiw: posts big blind $2
*** HOLE CARDS ***
DFVYDA6dKQy7R7mGIKogZA: folds
qXDd0ZyMIse0OBu8pxeQ3Q: folds
WfaZs12BkYO+BUX5VWpuWQ: raises $4 to $6
gqlysXCbT8V54f/1lf9h3A: folds
vkfxu8f/jMYKUk6Ly4eujw: folds
Yr7pZltpy3IUNdKS9PCEiw: raises $8 to $14
WfaZs12BkYO+BUX5VWpuWQ: calls $8
*** FLOP *** [Qs Ah 2c]
Yr7pZltpy3IUNdKS9PCEiw: checks
WfaZs12BkYO+BUX5VWpuWQ: bets $30.40 and is all-in
Yr7pZltpy3IUNdKS9PCEiw: calls $30.40
*** TURN *** [Qs Ah 2c] [6s]
*** RIVER *** [Qs Ah 2c 6s] [2s]
*** SHOW DOWN ***
Yr7pZltpy3IUNdKS9PCEiw: shows [Qd Ad] (two pair, Aces and Queens)
WfaZs12BkYO+BUX5VWpuWQ: mucks hand
Yr7pZltpy3IUNdKS9PCEiw collected $86.80 from pot
*** SUMMARY ***
Total pot $89.80 | Rake $3
Board [Qs Ah 2c 6s 2s]
Seat 1: DFVYDA6dKQy7R7mGIKogZA folded before Flop (didn't bet)
Seat 2: qXDd0ZyMIse0OBu8pxeQ3Q folded before Flop (didn't bet)
Seat 3: WfaZs12BkYO+BUX5VWpuWQ mucked
Seat 4: gqlysXCbT8V54f/1lf9h3A (button) folded before Flop (didn't bet)
Seat 5: vkfxu8f/jMYKUk6Ly4eujw (small blind) folded before Flop
Seat 6: Yr7pZltpy3IUNdKS9PCEiw (big blind) showed [Qd Ad] and won ($86.80) with two pair, Aces and Queens



PokerStars Game #59940846184:  Hold'em No Limit ($1/$2) - 2009/07/01 1:18:18 ET
Table 'gnHBqWll9O3fxG7Ojkz/ng' 9-max Seat #9 is the button
Seat 1: TAfo4veNRaRlzDXMMYS3Jg ($38 in chips)
Seat 2: H6Z4+qu8gR0VUiPOijndVg ($333.25 in chips)
Seat 3: 5Q8U6iZbeO7xJSS4qvDP5g ($218 in chips)
Seat 5: rBQDMkKm9cZn6M9NPsiVew ($239.45 in chips)
Seat 6: /inIs/z/PcX+TniIFpaxpg ($45 in chips)
Seat 7: jqui3xAWCkcdPW36a6BD+w ($344.40 in chips)
Seat 8: cM6efHzdxoqYm0EQKP4TTQ ($103.30 in chips)
Seat 9: sN6yR5I5zFq/WFyIz5UfzQ ($201 in chips)
TAfo4veNRaRlzDXMMYS3Jg: posts small blind $1
H6Z4+qu8gR0VUiPOijndVg: posts big blind $2
*** HOLE CARDS ***
5Q8U6iZbeO7xJSS4qvDP5g: folds
rBQDMkKm9cZn6M9NPsiVew: folds
/inIs/z/PcX+TniIFpaxpg: folds
jqui3xAWCkcdPW36a6BD+w: calls $2
cM6efHzdxoqYm0EQKP4TTQ: raises $6 to $8
sN6yR5I5zFq/WFyIz5UfzQ: folds
TAfo4veNRaRlzDXMMYS3Jg: folds
H6Z4+qu8gR0VUiPOijndVg: folds
jqui3xAWCkcdPW36a6BD+w: folds
cM6efHzdxoqYm0EQKP4TTQ collected $7 from pot
*** SUMMARY ***
Total pot $7 | Rake $0
Seat 1: TAfo4veNRaRlzDXMMYS3Jg (small blind) folded before Flop
Seat 2: H6Z4+qu8gR0VUiPOijndVg (big blind) folded before Flop
Seat 3: 5Q8U6iZbeO7xJSS4qvDP5g folded before Flop (didn't bet)
Seat 5: rBQDMkKm9cZn6M9NPsiVew folded before Flop (didn't bet)
Seat 6: /inIs/z/PcX+TniIFpaxpg folded before Flop (didn't bet)
Seat 7: jqui3xAWCkcdPW36a6BD+w folded before Flop
Seat 8: cM6efHzdxoqYm0EQKP4TTQ collected ($7)
Seat 9: sN6yR5I5zFq/WFyIz5UfzQ (button) folded before Flop (didn't bet)



PokerStars Game #59940848636:  Hold'em No Limit ($1/$2) - 2009/07/01 1:18:22 ET
Table 'mGpP9StWRnoeiBDExc6Frg' 6-max Seat #4 is the button
Seat 1: VvdR9F3I+2yELkfTVvC1dg ($200 in chips)
Seat 2: dZcLsEI8iXkobBduRJ45Yw ($57.75 in chips)
Seat 3: 7acrZUQC3Zc9BNLjoKIcLQ ($47.10 in chips)
Seat 4: 4dcDwIHRm96PwtqkpQiuiA ($43.35 in chips)
Seat 5: d1puGuVBE0fidn+5eRJ0tw ($228.20 in chips)
Seat 6: B2Ih1sr5VZk+8He7rcrMtQ ($462.35 in chips)
d1puGuVBE0fidn+5eRJ0tw: posts small blind $1
B2Ih1sr5VZk+8He7rcrMtQ: posts big blind $2
*** HOLE CARDS ***
VvdR9F3I+2yELkfTVvC1dg: raises $2 to $4
dZcLsEI8iXkobBduRJ45Yw: folds
7acrZUQC3Zc9BNLjoKIcLQ: folds
4dcDwIHRm96PwtqkpQiuiA: folds
d1puGuVBE0fidn+5eRJ0tw: folds
B2Ih1sr5VZk+8He7rcrMtQ: folds
VvdR9F3I+2yELkfTVvC1dg collected $5 from pot
VvdR9F3I+2yELkfTVvC1dg: doesn't show hand
*** SUMMARY ***
Total pot $5 | Rake $0
Seat 1: VvdR9F3I+2yELkfTVvC1dg collected ($5)
Seat 2: dZcLsEI8iXkobBduRJ45Yw folded before Flop (didn't bet)
Seat 3: 7acrZUQC3Zc9BNLjoKIcLQ folded before Flop (didn't bet)
Seat 4: 4dcDwIHRm96PwtqkpQiuiA (button) folded before Flop (didn't bet)
Seat 5: d1puGuVBE0fidn+5eRJ0tw (small blind) folded before Flop
Seat 6: B2Ih1sr5VZk+8He7rcrMtQ (big blind) folded before Flop



PokerStars Game #59940848318:  Hold'em No Limit ($1/$2) - 2009/07/01 1:18:22 ET
Table 'SF49/KQm8T4taMp6kb+HXA' 9-max Seat #6 is the button
Seat 1: CUZwDpLTQKhzarPe+JCLOQ ($200 in chips)
Seat 2: rW/MyplHylMSBRaoRUzWrg ($36 in chips)
Seat 3: pCmk6FpSOLJ+85o1tLHIag ($283.75 in chips)
Seat 4: HffgoYm61KgkdMe/DYChIQ ($212.40 in chips)
Seat 5: ri8CLkX3e9JF34dQNbsHGA ($40 in chips)
Seat 6: 31HuO+DQxppUQEedBWukug ($303.95 in chips)
Seat 7: n2VAbLaE5qgKr5mA4W6v4w ($121 in chips)
Seat 8: GgrYze3jkUdSO7a7CuJGDw ($183 in chips)
Seat 9: /inIs/z/PcX+TniIFpaxpg ($326.15 in chips)
n2VAbLaE5qgKr5mA4W6v4w: posts small blind $1
GgrYze3jkUdSO7a7CuJGDw: posts big blind $2
*** HOLE CARDS ***
/inIs/z/PcX+TniIFpaxpg: folds
CUZwDpLTQKhzarPe+JCLOQ: folds
rW/MyplHylMSBRaoRUzWrg: folds
pCmk6FpSOLJ+85o1tLHIag: folds
HffgoYm61KgkdMe/DYChIQ: raises $4 to $6
ri8CLkX3e9JF34dQNbsHGA: folds
31HuO+DQxppUQEedBWukug: folds
n2VAbLaE5qgKr5mA4W6v4w: calls $5
GgrYze3jkUdSO7a7CuJGDw: calls $4
*** FLOP *** [6d Kh 8d]
n2VAbLaE5qgKr5mA4W6v4w: checks
GgrYze3jkUdSO7a7CuJGDw: checks
HffgoYm61KgkdMe/DYChIQ: bets $6
n2VAbLaE5qgKr5mA4W6v4w: folds
GgrYze3jkUdSO7a7CuJGDw: folds
HffgoYm61KgkdMe/DYChIQ collected $17.10 from pot
*** SUMMARY ***
Total pot $18 | Rake $0.90
Board [6d Kh 8d]
Seat 1: CUZwDpLTQKhzarPe+JCLOQ folded before Flop (didn't bet)
Seat 2: rW/MyplHylMSBRaoRUzWrg folded before Flop (didn't bet)
Seat 3: pCmk6FpSOLJ+85o1tLHIag folded before Flop (didn't bet)
Seat 4: HffgoYm61KgkdMe/DYChIQ collected ($17.10)
Seat 5: ri8CLkX3e9JF34dQNbsHGA folded before Flop (didn't bet)
Seat 6: 31HuO+DQxppUQEedBWukug (button) folded before Flop (didn't bet)
Seat 7: n2VAbLaE5qgKr5mA4W6v4w (small blind) folded on the Flop
Seat 8: GgrYze3jkUdSO7a7CuJGDw (big blind) folded on the Flop
Seat 9: /inIs/z/PcX+TniIFpaxpg folded before Flop (didn't bet)



PokerStars Game #59940850802:  Hold'em No Limit ($1/$2) - 2009/07/01 1:18:26 ET
Table '+hSnXFQrGw1PlVgTnuj+sA' 6-max Seat #2 is the button
Seat 1: 2ccIJhDj+3JapvS7swVZEg ($293.10 in chips)
Seat 2: o9jamqIi6sTTRSqudgboRA ($255.55 in chips)
Seat 3: fE+LHW/7rpfXW14g8LhGjA ($44.65 in chips)
Seat 4: J4iH5epwXbmODnojR/VRxA ($187 in chips)
Seat 5: VvdR9F3I+2yELkfTVvC1dg ($200 in chips)
Seat 6: AuiGltq875lmaKHBsjZVGg ($114.75 in chips)
fE+LHW/7rpfXW14g8LhGjA: posts small blind $1
J4iH5epwXbmODnojR/VRxA: posts big blind $2
*** HOLE CARDS ***
VvdR9F3I+2yELkfTVvC1dg: folds
AuiGltq875lmaKHBsjZVGg: raises $4 to $6
2ccIJhDj+3JapvS7swVZEg: folds
o9jamqIi6sTTRSqudgboRA: calls $6
fE+LHW/7rpfXW14g8LhGjA: folds
J4iH5epwXbmODnojR/VRxA: folds
*** FLOP *** [6d 2c Td]
AuiGltq875lmaKHBsjZVGg: bets $10
o9jamqIi6sTTRSqudgboRA: calls $10
*** TURN *** [6d 2c Td] [5c]
AuiGltq875lmaKHBsjZVGg: bets $10
o9jamqIi6sTTRSqudgboRA: calls $10
*** RIVER *** [6d 2c Td 5c] [9s]
AuiGltq875lmaKHBsjZVGg: checks
o9jamqIi6sTTRSqudgboRA: checks
*** SHOW DOWN ***
AuiGltq875lmaKHBsjZVGg: shows [Kd Ad] (high card Ace)
o9jamqIi6sTTRSqudgboRA: shows [8d 8h] (a pair of Eights)
o9jamqIi6sTTRSqudgboRA collected $52.35 from pot
*** SUMMARY ***
Total pot $55 | Rake $2.65
Board [6d 2c Td 5c 9s]
Seat 1: 2ccIJhDj+3JapvS7swVZEg folded before Flop (didn't bet)
Seat 2: o9jamqIi6sTTRSqudgboRA (button) showed [8d 8h] and won ($52.35) with a pair of Eights
Seat 3: fE+LHW/7rpfXW14g8LhGjA (small blind) folded before Flop
Seat 4: J4iH5epwXbmODnojR/VRxA (big blind) folded before Flop
Seat 5: VvdR9F3I+2yELkfTVvC1dg folded before Flop (didn't bet)
Seat 6: AuiGltq875lmaKHBsjZVGg showed [Kd Ad] and lost with high card Ace



PokerStars Game #59940850828:  Hold'em No Limit ($1/$2) - 2009/07/01 1:18:26 ET
Table 'ztv6V3FN2bQ9nmJPPdx6nQ' 6-max Seat #5 is the button
Seat 1: 6fLdOUCRtX71xbVRhJEq8w ($218 in chips)
Seat 2: 5Y+ZGWLI4gnlpApDX5vy1A ($402.40 in chips)
Seat 4: UaZ5yj+6LjtWqMQg2QskUw ($112.80 in chips)
Seat 5: sTPOWERd9HWPCNrDBwsVjA ($254 in chips)
Seat 6: mfy7uGZcqA2PVQqEVbJ7+g ($118.45 in chips)
mfy7uGZcqA2PVQqEVbJ7+g: posts small blind $1
6fLdOUCRtX71xbVRhJEq8w: posts big blind $2
ubtx4Z5L+AcK71MTvYiGVw: sits out
*** HOLE CARDS ***
5Y+ZGWLI4gnlpApDX5vy1A: folds
UaZ5yj+6LjtWqMQg2QskUw: raises $2 to $4
sTPOWERd9HWPCNrDBwsVjA: folds
mfy7uGZcqA2PVQqEVbJ7+g: folds
6fLdOUCRtX71xbVRhJEq8w: folds
UaZ5yj+6LjtWqMQg2QskUw collected $5 from pot
*** SUMMARY ***
Total pot $5 | Rake $0
Seat 1: 6fLdOUCRtX71xbVRhJEq8w (big blind) folded before Flop
Seat 2: 5Y+ZGWLI4gnlpApDX5vy1A folded before Flop (didn't bet)
Seat 4: UaZ5yj+6LjtWqMQg2QskUw collected ($5)
Seat 5: sTPOWERd9HWPCNrDBwsVjA (button) folded before Flop (didn't bet)
Seat 6: mfy7uGZcqA2PVQqEVbJ7+g (small blind) folded before Flop



PokerStars Game #59940850674:  Hold'em No Limit ($1/$2) - 2009/07/01 1:18:26 ET
Table 'dBLpiMEy1cezkSKD+ZpCcw' 2-max Seat #2 is the button
Seat 1: NFRtU1s5+WFh9EKwu+KLOQ ($242.30 in chips)
Seat 2: 4rrQUikeMSkuWGHgW80++w ($200 in chips)
4rrQUikeMSkuWGHgW80++w: posts small blind $1
NFRtU1s5+WFh9EKwu+KLOQ: posts big blind $2
*** HOLE CARDS ***
4rrQUikeMSkuWGHgW80++w: raises $4 to $6
NFRtU1s5+WFh9EKwu+KLOQ: calls $4
*** FLOP *** [2d 9c Qc]
NFRtU1s5+WFh9EKwu+KLOQ: checks
4rrQUikeMSkuWGHgW80++w: bets $8
NFRtU1s5+WFh9EKwu+KLOQ: folds
4rrQUikeMSkuWGHgW80++w collected $11.50 from pot
4rrQUikeMSkuWGHgW80++w: doesn't show hand
*** SUMMARY ***
Total pot $12 | Rake $0.50
Board [2d 9c Qc]
Seat 1: NFRtU1s5+WFh9EKwu+KLOQ (big blind) folded on the Flop
Seat 2: 4rrQUikeMSkuWGHgW80++w (button) (small blind) collected ($11.50)



PokerStars Game #59940852334:  Hold'em No Limit ($1/$2) - 2009/07/01 1:18:28 ET
Table 'NmY84NAf9Mh0ckAckHnh5g' 2-max Seat #1 is the button
Seat 1: 6hvg964TSqZ3AL/0XK9aVQ ($207.30 in chips)
Seat 2: RwDoM55ZeQuI2ADyJhOb2Q ($803.40 in chips)
6hvg964TSqZ3AL/0XK9aVQ: posts small blind $1
RwDoM55ZeQuI2ADyJhOb2Q: posts big blind $2
*** HOLE CARDS ***
6hvg964TSqZ3AL/0XK9aVQ: folds
RwDoM55ZeQuI2ADyJhOb2Q collected $2 from pot
RwDoM55ZeQuI2ADyJhOb2Q: doesn't show hand
*** SUMMARY ***
Total pot $2 | Rake $0
Seat 1: 6hvg964TSqZ3AL/0XK9aVQ (button) (small blind) folded before Flop
Seat 2: RwDoM55ZeQuI2ADyJhOb2Q (big blind) collected ($2)



PokerStars Game #59940856078:  Hold'em No Limit ($1/$2) - 2009/07/01 1:18:35 ET
Table 'NmY84NAf9Mh0ckAckHnh5g' 2-max Seat #2 is the button
Seat 1: 6hvg964TSqZ3AL/0XK9aVQ ($206.30 in chips)
Seat 2: RwDoM55ZeQuI2ADyJhOb2Q ($804.40 in chips)
RwDoM55ZeQuI2ADyJhOb2Q: posts small blind $1
6hvg964TSqZ3AL/0XK9aVQ: posts big blind $2
*** HOLE CARDS ***
RwDoM55ZeQuI2ADyJhOb2Q: raises $4 to $6
6hvg964TSqZ3AL/0XK9aVQ: calls $4
*** FLOP *** [3h 2d 5d]
6hvg964TSqZ3AL/0XK9aVQ: checks
RwDoM55ZeQuI2ADyJhOb2Q: bets $12
6hvg964TSqZ3AL/0XK9aVQ: calls $12
*** TURN *** [3h 2d 5d] [8c]
6hvg964TSqZ3AL/0XK9aVQ: checks
RwDoM55ZeQuI2ADyJhOb2Q: bets $32
6hvg964TSqZ3AL/0XK9aVQ: calls $32
*** RIVER *** [3h 2d 5d 8c] [Qh]
6hvg964TSqZ3AL/0XK9aVQ: checks
RwDoM55ZeQuI2ADyJhOb2Q: checks
*** SHOW DOWN ***
6hvg964TSqZ3AL/0XK9aVQ: shows [5c 4d] (a pair of Fives)
RwDoM55ZeQuI2ADyJhOb2Q: mucks hand
6hvg964TSqZ3AL/0XK9aVQ collected $99.50 from pot
*** SUMMARY ***
Total pot $100 | Rake $0.50
Board [3h 2d 5d 8c Qh]
Seat 1: 6hvg964TSqZ3AL/0XK9aVQ (big blind) showed [5c 4d] and won ($99.50) with a pair of Fives
Seat 2: RwDoM55ZeQuI2ADyJhOb2Q (button) (small blind) mucked



PokerStars Game #59940857352:  Hold'em No Limit ($1/$2) - 2009/07/01 1:18:37 ET
Table 'P/yCfYl1GfGsu/e6DxDy/A' 2-max Seat #2 is the button
Seat 1: 7fOCUy3x9hdkmXkkDNolGQ ($730 in chips)
Seat 2: RwDoM55ZeQuI2ADyJhOb2Q ($759 in chips)
RwDoM55ZeQuI2ADyJhOb2Q: posts small blind $1
7fOCUy3x9hdkmXkkDNolGQ: posts big blind $2
*** HOLE CARDS ***
RwDoM55ZeQuI2ADyJhOb2Q: raises $4 to $6
7fOCUy3x9hdkmXkkDNolGQ: folds
RwDoM55ZeQuI2ADyJhOb2Q collected $4 from pot
*** SUMMARY ***
Total pot $4 | Rake $0
Seat 1: 7fOCUy3x9hdkmXkkDNolGQ (big blind) folded before Flop
Seat 2: RwDoM55ZeQuI2ADyJhOb2Q (button) (small blind) collected ($4)



PokerStars Game #59940857548:  Hold'em No Limit ($1/$2) - 2009/07/01 1:18:37 ET
Table 'ZzSIe0zTCDv+n6hfbY5tTg' 6-max Seat #4 is the button
Seat 1: VvdR9F3I+2yELkfTVvC1dg ($209.10 in chips)
Seat 2: B87ikIyZ/TzAVeXf38Ny0g ($240 in chips)
Seat 3: gsugPj31Hui3Jefl98MBOA ($199 in chips)
Seat 4: qXDd0ZyMIse0OBu8pxeQ3Q ($200 in chips)
Seat 5: 3dAbvkxS5NPQTBAbvpinVg ($497.30 in chips)
Seat 6: 09BNF4quPDzanQzM8vc6WA ($28.50 in chips)
3dAbvkxS5NPQTBAbvpinVg: posts small blind $1
09BNF4quPDzanQzM8vc6WA: posts big blind $2
*** HOLE CARDS ***
VvdR9F3I+2yELkfTVvC1dg: raises $2 to $4
B87ikIyZ/TzAVeXf38Ny0g: folds
gsugPj31Hui3Jefl98MBOA: folds
qXDd0ZyMIse0OBu8pxeQ3Q: folds
3dAbvkxS5NPQTBAbvpinVg: folds
09BNF4quPDzanQzM8vc6WA: folds
VvdR9F3I+2yELkfTVvC1dg collected $5 from pot
VvdR9F3I+2yELkfTVvC1dg: doesn't show hand
*** SUMMARY ***
Total pot $5 | Rake $0
Seat 1: VvdR9F3I+2yELkfTVvC1dg collected ($5)
Seat 2: B87ikIyZ/TzAVeXf38Ny0g folded before Flop (didn't bet)
Seat 3: gsugPj31Hui3Jefl98MBOA folded before Flop (didn't bet)
Seat 4: qXDd0ZyMIse0OBu8pxeQ3Q (button) folded before Flop (didn't bet)
Seat 5: 3dAbvkxS5NPQTBAbvpinVg (small blind) folded before Flop
Seat 6: 09BNF4quPDzanQzM8vc6WA (big blind) folded before Flop



PokerStars Game #59940857304:  Hold'em No Limit ($1/$2) - 2009/07/01 1:18:37 ET
Table 'QxerF7GUfCbl+4a8XaTB2w' 6-max Seat #5 is the button
Seat 1: o9jamqIi6sTTRSqudgboRA ($298.50 in chips)
Seat 2: vkfxu8f/jMYKUk6Ly4eujw ($196.80 in chips)
Seat 3: m7mYVfnCOK5TE/VkN/FhOg ($230.70 in chips)
Seat 4: 09BNF4quPDzanQzM8vc6WA ($40.55 in chips)
Seat 5: YsLQ3BAvgQHWXMAv3Wv6Hg ($201.75 in chips)
Seat 6: VvdR9F3I+2yELkfTVvC1dg ($222.60 in chips)
VvdR9F3I+2yELkfTVvC1dg: posts small blind $1
o9jamqIi6sTTRSqudgboRA: posts big blind $2
*** HOLE CARDS ***
vkfxu8f/jMYKUk6Ly4eujw: raises $6 to $8
m7mYVfnCOK5TE/VkN/FhOg: folds
09BNF4quPDzanQzM8vc6WA: folds
YsLQ3BAvgQHWXMAv3Wv6Hg: folds
VvdR9F3I+2yELkfTVvC1dg: folds
o9jamqIi6sTTRSqudgboRA: folds
vkfxu8f/jMYKUk6Ly4eujw collected $5 from pot
vkfxu8f/jMYKUk6Ly4eujw: doesn't show hand
*** SUMMARY ***
Total pot $5 | Rake $0
Seat 1: o9jamqIi6sTTRSqudgboRA (big blind) folded before Flop
Seat 2: vkfxu8f/jMYKUk6Ly4eujw collected ($5)
Seat 3: m7mYVfnCOK5TE/VkN/FhOg folded before Flop (didn't bet)
Seat 4: 09BNF4quPDzanQzM8vc6WA folded before Flop (didn't bet)
Seat 5: YsLQ3BAvgQHWXMAv3Wv6Hg (button) folded before Flop (didn't bet)
Seat 6: VvdR9F3I+2yELkfTVvC1dg (small blind) folded before Flop



PokerStars Game #59940858258:  Hold'em No Limit ($1/$2) - 2009/07/01 1:18:39 ET
Table 'uJ9juaXXg9yIcSU8amxaXQ' 6-max Seat #5 is the button
Seat 1: JsqOjN/eHz0uYVf/PyUJ6Q ($152.85 in chips)
Seat 2: VvdR9F3I+2yELkfTVvC1dg ($200 in chips)
Seat 3: qXDd0ZyMIse0OBu8pxeQ3Q ($202 in chips)
Seat 4: zNjJ/y4emmF+vzrCDd+ooA ($226.05 in chips)
Seat 5: YsLQ3BAvgQHWXMAv3Wv6Hg ($230.75 in chips)
Seat 6: 2DFp9Veq1xxq64dCjwNuUw ($47.10 in chips)
2DFp9Veq1xxq64dCjwNuUw: posts small blind $1
JsqOjN/eHz0uYVf/PyUJ6Q: posts big blind $2
*** HOLE CARDS ***
VvdR9F3I+2yELkfTVvC1dg: folds
qXDd0ZyMIse0OBu8pxeQ3Q: folds
zNjJ/y4emmF+vzrCDd+ooA: folds
YsLQ3BAvgQHWXMAv3Wv6Hg: folds
zNjJ/y4emmF+vzrCDd+ooA is sitting out
2DFp9Veq1xxq64dCjwNuUw: calls $1
JsqOjN/eHz0uYVf/PyUJ6Q: checks
*** FLOP *** [Jc Ks Qh]
2DFp9Veq1xxq64dCjwNuUw: bets $2
JsqOjN/eHz0uYVf/PyUJ6Q: folds
2DFp9Veq1xxq64dCjwNuUw collected $3.80 from pot
2DFp9Veq1xxq64dCjwNuUw: doesn't show hand
*** SUMMARY ***
Total pot $4 | Rake $0.20
Board [Jc Ks Qh]
Seat 1: JsqOjN/eHz0uYVf/PyUJ6Q (big blind) folded on the Flop
Seat 2: VvdR9F3I+2yELkfTVvC1dg folded before Flop (didn't bet)
Seat 3: qXDd0ZyMIse0OBu8pxeQ3Q folded before Flop (didn't bet)
Seat 4: zNjJ/y4emmF+vzrCDd+ooA folded before Flop (didn't bet)
Seat 5: YsLQ3BAvgQHWXMAv3Wv6Hg (button) folded before Flop (didn't bet)
Seat 6: 2DFp9Veq1xxq64dCjwNuUw (small blind) collected ($3.80)



PokerStars Game #59940858820:  Hold'em No Limit ($1/$2) - 2009/07/01 1:18:39 ET
Table 'W9UeSV0aoPjh5SFSxM8jUQ' 9-max Seat #6 is the button
Seat 1: mIKx5lhIt13X5eZQH0ZeMA ($25 in chips)
Seat 2: iMe5yhc+1BaiIPHet3NMrA ($255.60 in chips)
Seat 3: /inIs/z/PcX+TniIFpaxpg ($25 in chips)
Seat 4: LjOrlR1DLUQ+KE0gh7hP6Q ($109 in chips)
Seat 5: ri8CLkX3e9JF34dQNbsHGA ($42.45 in chips)
Seat 6: j47DM+lqTfzZP8musviQTg ($90.50 in chips)
Seat 7: I2ipWauytvrkEer4XD3Sjg ($116 in chips)
Seat 8: odhvI/CZeMsPyo1n1U7+hA ($52.70 in chips)
Seat 9: Q104K4iDGcqOlVrjAkzPEA ($31 in chips)
I2ipWauytvrkEer4XD3Sjg: posts small blind $1
odhvI/CZeMsPyo1n1U7+hA: posts big blind $2
*** HOLE CARDS ***
Q104K4iDGcqOlVrjAkzPEA: calls $2
mIKx5lhIt13X5eZQH0ZeMA: folds
iMe5yhc+1BaiIPHet3NMrA: folds
/inIs/z/PcX+TniIFpaxpg: folds
LjOrlR1DLUQ+KE0gh7hP6Q: folds
ri8CLkX3e9JF34dQNbsHGA: folds
j47DM+lqTfzZP8musviQTg: calls $2
I2ipWauytvrkEer4XD3Sjg: raises $8 to $10
odhvI/CZeMsPyo1n1U7+hA: folds
Q104K4iDGcqOlVrjAkzPEA: calls $8
j47DM+lqTfzZP8musviQTg: calls $8
*** FLOP *** [Qc 9d Ac]
I2ipWauytvrkEer4XD3Sjg: checks
Q104K4iDGcqOlVrjAkzPEA: checks
j47DM+lqTfzZP8musviQTg: bets $22
I2ipWauytvrkEer4XD3Sjg: folds
Q104K4iDGcqOlVrjAkzPEA: folds
j47DM+lqTfzZP8musviQTg collected $30.40 from pot
*** SUMMARY ***
Total pot $32 | Rake $1.60
Board [Qc 9d Ac]
Seat 1: mIKx5lhIt13X5eZQH0ZeMA folded before Flop (didn't bet)
Seat 2: iMe5yhc+1BaiIPHet3NMrA folded before Flop (didn't bet)
Seat 3: /inIs/z/PcX+TniIFpaxpg folded before Flop (didn't bet)
Seat 4: LjOrlR1DLUQ+KE0gh7hP6Q folded before Flop (didn't bet)
Seat 5: ri8CLkX3e9JF34dQNbsHGA folded before Flop (didn't bet)
Seat 6: j47DM+lqTfzZP8musviQTg (button) collected ($30.40)
Seat 7: I2ipWauytvrkEer4XD3Sjg (small blind) folded on the Flop
Seat 8: odhvI/CZeMsPyo1n1U7+hA (big blind) folded before Flop
Seat 9: Q104K4iDGcqOlVrjAkzPEA folded on the Flop



PokerStars Game #59940858238:  Hold'em No Limit ($1/$2) - 2009/07/01 1:18:39 ET
Table 'rKeCh+eBn4RNvybCUYkoTQ' 9-max Seat #9 is the button
Seat 1: /inIs/z/PcX+TniIFpaxpg ($204 in chips)
Seat 2: 9cBHwK40Tl06vheE7B3LHQ ($145.25 in chips)
Seat 4: 31HuO+DQxppUQEedBWukug ($98.10 in chips)
Seat 5: WUlHm+ydPPHG7Lb0rePSdA ($120 in chips)
Seat 6: EBV6OktyeSmh4w6sWmcWOw ($270 in chips)
Seat 7: rW/MyplHylMSBRaoRUzWrg ($37 in chips)
Seat 8: pN/Ip0ePsUVIdUlGgLrkUw ($216.10 in chips)
Seat 9: Kzta8yu9vxHT4B70mjBZ+w ($208.25 in chips)
/inIs/z/PcX+TniIFpaxpg: posts small blind $1
9cBHwK40Tl06vheE7B3LHQ: posts big blind $2
GX1heJ+DSsvm7gzSPsYhhQ: sits out
*** HOLE CARDS ***
31HuO+DQxppUQEedBWukug: folds
WUlHm+ydPPHG7Lb0rePSdA: folds
EBV6OktyeSmh4w6sWmcWOw: folds
rW/MyplHylMSBRaoRUzWrg: folds
pN/Ip0ePsUVIdUlGgLrkUw: folds
Kzta8yu9vxHT4B70mjBZ+w: raises $4 to $6
/inIs/z/PcX+TniIFpaxpg: folds
9cBHwK40Tl06vheE7B3LHQ: folds
Kzta8yu9vxHT4B70mjBZ+w collected $5 from pot
Kzta8yu9vxHT4B70mjBZ+w: doesn't show hand
*** SUMMARY ***
Total pot $5 | Rake $0
Seat 1: /inIs/z/PcX+TniIFpaxpg (small blind) folded before Flop
Seat 2: 9cBHwK40Tl06vheE7B3LHQ (big blind) folded before Flop
Seat 4: 31HuO+DQxppUQEedBWukug folded before Flop (didn't bet)
Seat 5: WUlHm+ydPPHG7Lb0rePSdA folded before Flop (didn't bet)
Seat 6: EBV6OktyeSmh4w6sWmcWOw folded before Flop (didn't bet)
Seat 7: rW/MyplHylMSBRaoRUzWrg folded before Flop (didn't bet)
Seat 8: pN/Ip0ePsUVIdUlGgLrkUw folded before Flop (didn't bet)
Seat 9: Kzta8yu9vxHT4B70mjBZ+w (button) collected ($5)



PokerStars Game #59940859320:  Hold'em No Limit ($1/$2) - 2009/07/01 1:18:40 ET
Table 'dBLpiMEy1cezkSKD+ZpCcw' 2-max Seat #1 is the button
Seat 1: NFRtU1s5+WFh9EKwu+KLOQ ($236.30 in chips)
Seat 2: 4rrQUikeMSkuWGHgW80++w ($205.50 in chips)
NFRtU1s5+WFh9EKwu+KLOQ: posts small blind $1
4rrQUikeMSkuWGHgW80++w: posts big blind $2
*** HOLE CARDS ***
NFRtU1s5+WFh9EKwu+KLOQ: calls $1
4rrQUikeMSkuWGHgW80++w: raises $6 to $8
NFRtU1s5+WFh9EKwu+KLOQ: folds
4rrQUikeMSkuWGHgW80++w collected $4 from pot
4rrQUikeMSkuWGHgW80++w: doesn't show hand
*** SUMMARY ***
Total pot $4 | Rake $0
Seat 1: NFRtU1s5+WFh9EKwu+KLOQ (button) (small blind) folded before Flop
Seat 2: 4rrQUikeMSkuWGHgW80++w (big blind) collected ($4)



PokerStars Game #59940859586:  Hold'em No Limit ($1/$2) - 2009/07/01 1:18:41 ET
Table 'bJQ024BaYSBrW0sXpCZbNQ' 6-max Seat #2 is the button
Seat 1: PCN5rt4TwI1pQE+rAiqI0Q ($283.60 in chips)
Seat 2: 3dAbvkxS5NPQTBAbvpinVg ($200 in chips)
Seat 3: vkfxu8f/jMYKUk6Ly4eujw ($231.10 in chips)
Seat 5: VvdR9F3I+2yELkfTVvC1dg ($200 in chips)
Seat 6: 9dpyyjDTCed6nV7JhaUUpw ($327.95 in chips)
vkfxu8f/jMYKUk6Ly4eujw: posts small blind $1
VvdR9F3I+2yELkfTVvC1dg: posts big blind $2
*** HOLE CARDS ***
9dpyyjDTCed6nV7JhaUUpw: folds
PCN5rt4TwI1pQE+rAiqI0Q: folds
3dAbvkxS5NPQTBAbvpinVg: raises $4 to $6
vkfxu8f/jMYKUk6Ly4eujw: folds
VvdR9F3I+2yELkfTVvC1dg: folds
3dAbvkxS5NPQTBAbvpinVg collected $5 from pot
3dAbvkxS5NPQTBAbvpinVg: doesn't show hand
*** SUMMARY ***
Total pot $5 | Rake $0
Seat 1: PCN5rt4TwI1pQE+rAiqI0Q folded before Flop (didn't bet)
Seat 2: 3dAbvkxS5NPQTBAbvpinVg (button) collected ($5)
Seat 3: vkfxu8f/jMYKUk6Ly4eujw (small blind) folded before Flop
Seat 5: VvdR9F3I+2yELkfTVvC1dg (big blind) folded before Flop
Seat 6: 9dpyyjDTCed6nV7JhaUUpw folded before Flop (didn't bet)



PokerStars Game #59940859674:  Hold'em No Limit ($1/$2) - 2009/07/01 1:18:41 ET
Table 'CFkQcfWjKccZaZDf71FK+w' 6-max Seat #3 is the button
Seat 1: JsC+WvfzqlxVs9G8/gSQAQ ($103.30 in chips)
Seat 2: ewN/vzF22+/gdzjIKBOlkA ($227.05 in chips)
Seat 3: 09BNF4quPDzanQzM8vc6WA ($33 in chips)
Seat 4: ygTTt5ehT4aF86q1a8/R+w ($196.10 in chips)
Seat 5: 2lOU1DcvUZaMcxZ95XfzXw ($69 in chips)
Seat 6: ORVqY3rf9X6ANA/8s+On2Q ($57.75 in chips)
ygTTt5ehT4aF86q1a8/R+w: posts small blind $1
2lOU1DcvUZaMcxZ95XfzXw: posts big blind $2
*** HOLE CARDS ***
ORVqY3rf9X6ANA/8s+On2Q: folds
JsC+WvfzqlxVs9G8/gSQAQ: calls $2
ewN/vzF22+/gdzjIKBOlkA: folds
09BNF4quPDzanQzM8vc6WA: raises $4 to $6
ygTTt5ehT4aF86q1a8/R+w: folds
2lOU1DcvUZaMcxZ95XfzXw: calls $4
JsC+WvfzqlxVs9G8/gSQAQ: calls $4
*** FLOP *** [3s 3c Qs]
2lOU1DcvUZaMcxZ95XfzXw: checks
JsC+WvfzqlxVs9G8/gSQAQ: bets $6
09BNF4quPDzanQzM8vc6WA: folds
2lOU1DcvUZaMcxZ95XfzXw: raises $16 to $22
JsC+WvfzqlxVs9G8/gSQAQ: calls $16
*** TURN *** [3s 3c Qs] [Ts]
2lOU1DcvUZaMcxZ95XfzXw: checks
JsC+WvfzqlxVs9G8/gSQAQ: checks
*** RIVER *** [3s 3c Qs Ts] [6s]
2lOU1DcvUZaMcxZ95XfzXw: bets $14
JsC+WvfzqlxVs9G8/gSQAQ: folds
2lOU1DcvUZaMcxZ95XfzXw collected $60 from pot
*** SUMMARY ***
Total pot $63 | Rake $3
Board [3s 3c Qs Ts 6s]
Seat 1: JsC+WvfzqlxVs9G8/gSQAQ folded on the River
Seat 2: ewN/vzF22+/gdzjIKBOlkA folded before Flop (didn't bet)
Seat 3: 09BNF4quPDzanQzM8vc6WA (button) folded on the Flop
Seat 4: ygTTt5ehT4aF86q1a8/R+w (small blind) folded before Flop
Seat 5: 2lOU1DcvUZaMcxZ95XfzXw (big blind) collected ($60)
Seat 6: ORVqY3rf9X6ANA/8s+On2Q folded before Flop (didn't bet)



PokerStars Game #59940859598:  Hold'em No Limit ($1/$2) - 2009/07/01 1:18:41 ET
Table 'kq5zaQ+1hLNf8LZfGnbTAA' 6-max Seat #4 is the button
Seat 1: 8srN1dKQePlsv0GyTada+Q ($234 in chips)
Seat 2: nXDI8Y/S6POzRwANu3d8hQ ($41.75 in chips)
Seat 3: vkfxu8f/jMYKUk6Ly4eujw ($227.95 in chips)
Seat 4: 3dAbvkxS5NPQTBAbvpinVg ($200 in chips)
Seat 5: kfASJqTbXek+zc8ZKsZL1Q ($139.40 in chips)
Seat 6: mfy7uGZcqA2PVQqEVbJ7+g ($202.25 in chips)
kfASJqTbXek+zc8ZKsZL1Q: posts small blind $1
mfy7uGZcqA2PVQqEVbJ7+g: posts big blind $2
*** HOLE CARDS ***
8srN1dKQePlsv0GyTada+Q: raises $4 to $6
nXDI8Y/S6POzRwANu3d8hQ: folds
vkfxu8f/jMYKUk6Ly4eujw: folds
3dAbvkxS5NPQTBAbvpinVg: calls $6
kfASJqTbXek+zc8ZKsZL1Q: calls $5
mfy7uGZcqA2PVQqEVbJ7+g: folds
*** FLOP *** [5d 8h 5h]
kfASJqTbXek+zc8ZKsZL1Q: bets $20
8srN1dKQePlsv0GyTada+Q: folds
3dAbvkxS5NPQTBAbvpinVg: folds
kfASJqTbXek+zc8ZKsZL1Q collected $19 from pot
kfASJqTbXek+zc8ZKsZL1Q: doesn't show hand
*** SUMMARY ***
Total pot $20 | Rake $1
Board [5d 8h 5h]
Seat 1: 8srN1dKQePlsv0GyTada+Q folded on the Flop
Seat 2: nXDI8Y/S6POzRwANu3d8hQ folded before Flop (didn't bet)
Seat 3: vkfxu8f/jMYKUk6Ly4eujw folded before Flop (didn't bet)
Seat 4: 3dAbvkxS5NPQTBAbvpinVg (button) folded on the Flop
Seat 5: kfASJqTbXek+zc8ZKsZL1Q (small blind) collected ($19)
Seat 6: mfy7uGZcqA2PVQqEVbJ7+g (big blind) folded before Flop



PokerStars Game #59940860064:  Hold'em No Limit ($1/$2) - 2009/07/01 1:18:42 ET
Table 'ztv6V3FN2bQ9nmJPPdx6nQ' 6-max Seat #6 is the button
Seat 1: 6fLdOUCRtX71xbVRhJEq8w ($216 in chips)
Seat 2: 5Y+ZGWLI4gnlpApDX5vy1A ($402.40 in chips)
Seat 4: UaZ5yj+6LjtWqMQg2QskUw ($115.80 in chips)
Seat 5: sTPOWERd9HWPCNrDBwsVjA ($254 in chips)
Seat 6: mfy7uGZcqA2PVQqEVbJ7+g ($117.45 in chips)
6fLdOUCRtX71xbVRhJEq8w: posts small blind $1
5Y+ZGWLI4gnlpApDX5vy1A: posts big blind $2
ubtx4Z5L+AcK71MTvYiGVw: sits out
*** HOLE CARDS ***
UaZ5yj+6LjtWqMQg2QskUw: folds
sTPOWERd9HWPCNrDBwsVjA: folds
mfy7uGZcqA2PVQqEVbJ7+g: folds
6fLdOUCRtX71xbVRhJEq8w: raises $4 to $6
5Y+ZGWLI4gnlpApDX5vy1A: folds
6fLdOUCRtX71xbVRhJEq8w collected $4 from pot
*** SUMMARY ***
Total pot $4 | Rake $0
Seat 1: 6fLdOUCRtX71xbVRhJEq8w (small blind) collected ($4)
Seat 2: 5Y+ZGWLI4gnlpApDX5vy1A (big blind) folded before Flop
Seat 4: UaZ5yj+6LjtWqMQg2QskUw folded before Flop (didn't bet)
Seat 5: sTPOWERd9HWPCNrDBwsVjA folded before Flop (didn't bet)
Seat 6: mfy7uGZcqA2PVQqEVbJ7+g (button) folded before Flop (didn't bet)



PokerStars Game #59940860658:  Hold'em No Limit ($1/$2) - 2009/07/01 1:18:43 ET
Table 'rsKRKlGHlxVyqJxzO2a2Ow' 9-max Seat #2 is the button
Seat 1: uYWfQJg2hgHLxri6/uVJiw ($347.20 in chips)
Seat 2: QHxJjpVYwitg9krW6wZgJA ($261.80 in chips)
Seat 3: zTcFtoHqqK4550YMZ8Y14Q ($61.50 in chips)
Seat 4: 31HuO+DQxppUQEedBWukug ($100 in chips)
Seat 5: 5Q8U6iZbeO7xJSS4qvDP5g ($200 in chips)
Seat 6: H6Z4+qu8gR0VUiPOijndVg ($200 in chips)
Seat 8: CkE3IyJF1KvdaAOmZY5XqQ ($217.75 in chips)
Seat 9: gRbvhSUVg+TNaTjaJecIRw ($72 in chips)
zTcFtoHqqK4550YMZ8Y14Q: posts small blind $1
31HuO+DQxppUQEedBWukug: posts big blind $2
*** HOLE CARDS ***
5Q8U6iZbeO7xJSS4qvDP5g: folds
H6Z4+qu8gR0VUiPOijndVg: folds
MPc9Txt5QGkXwb2uAZipEA leaves the table
CkE3IyJF1KvdaAOmZY5XqQ: raises $6 to $8
gRbvhSUVg+TNaTjaJecIRw: folds
uYWfQJg2hgHLxri6/uVJiw: folds
QHxJjpVYwitg9krW6wZgJA: folds
zTcFtoHqqK4550YMZ8Y14Q: folds
31HuO+DQxppUQEedBWukug: folds
CkE3IyJF1KvdaAOmZY5XqQ collected $5 from pot
*** SUMMARY ***
Total pot $5 | Rake $0
Seat 1: uYWfQJg2hgHLxri6/uVJiw folded before Flop (didn't bet)
Seat 2: QHxJjpVYwitg9krW6wZgJA (button) folded before Flop (didn't bet)
Seat 3: zTcFtoHqqK4550YMZ8Y14Q (small blind) folded before Flop
Seat 4: 31HuO+DQxppUQEedBWukug (big blind) folded before Flop
Seat 5: 5Q8U6iZbeO7xJSS4qvDP5g folded before Flop (didn't bet)
Seat 6: H6Z4+qu8gR0VUiPOijndVg folded before Flop (didn't bet)
Seat 8: CkE3IyJF1KvdaAOmZY5XqQ collected ($5)
Seat 9: gRbvhSUVg+TNaTjaJecIRw folded before Flop (didn't bet)



PokerStars Game #59940860550:  Hold'em No Limit ($1/$2) - 2009/07/01 1:18:43 ET
Table 'BSRfGh+QobUe0AgIMtt/fw' 9-max Seat #6 is the button
Seat 1: gDn/rYeNwCyWEgRhyWp4PA ($147.95 in chips)
Seat 2: TAfo4veNRaRlzDXMMYS3Jg ($49 in chips)
Seat 3: WUlHm+ydPPHG7Lb0rePSdA ($121 in chips)
Seat 6: H6Z4+qu8gR0VUiPOijndVg ($237.55 in chips)
Seat 7: CkE3IyJF1KvdaAOmZY5XqQ ($202.15 in chips)
Seat 8: /XRRUMKiOOItJFbrM26RrA ($100.55 in chips)
Seat 9: /inIs/z/PcX+TniIFpaxpg ($202.60 in chips)
CkE3IyJF1KvdaAOmZY5XqQ: posts small blind $1
/XRRUMKiOOItJFbrM26RrA: posts big blind $2
MrNegroni: sits out
GX1heJ+DSsvm7gzSPsYhhQ: sits out
*** HOLE CARDS ***
/inIs/z/PcX+TniIFpaxpg: folds
gDn/rYeNwCyWEgRhyWp4PA: folds
TAfo4veNRaRlzDXMMYS3Jg: folds
WUlHm+ydPPHG7Lb0rePSdA: folds
H6Z4+qu8gR0VUiPOijndVg: folds
CkE3IyJF1KvdaAOmZY5XqQ: folds
/XRRUMKiOOItJFbrM26RrA collected $2 from pot
*** SUMMARY ***
Total pot $2 | Rake $0
Seat 1: gDn/rYeNwCyWEgRhyWp4PA folded before Flop (didn't bet)
Seat 2: TAfo4veNRaRlzDXMMYS3Jg folded before Flop (didn't bet)
Seat 3: WUlHm+ydPPHG7Lb0rePSdA folded before Flop (didn't bet)
Seat 6: H6Z4+qu8gR0VUiPOijndVg (button) folded before Flop (didn't bet)
Seat 7: CkE3IyJF1KvdaAOmZY5XqQ (small blind) folded before Flop
Seat 8: /XRRUMKiOOItJFbrM26RrA (big blind) collected ($2)
Seat 9: /inIs/z/PcX+TniIFpaxpg folded before Flop (didn't bet)



PokerStars Game #59940861310:  Hold'em No Limit ($1/$2) - 2009/07/01 1:18:44 ET
Table 'P/yCfYl1GfGsu/e6DxDy/A' 2-max Seat #1 is the button
Seat 1: 7fOCUy3x9hdkmXkkDNolGQ ($728 in chips)
Seat 2: RwDoM55ZeQuI2ADyJhOb2Q ($761 in chips)
7fOCUy3x9hdkmXkkDNolGQ: posts small blind $1
RwDoM55ZeQuI2ADyJhOb2Q: posts big blind $2
*** HOLE CARDS ***
7fOCUy3x9hdkmXkkDNolGQ: folds
RwDoM55ZeQuI2ADyJhOb2Q collected $2 from pot
RwDoM55ZeQuI2ADyJhOb2Q: doesn't show hand
*** SUMMARY ***
Total pot $2 | Rake $0
Seat 1: 7fOCUy3x9hdkmXkkDNolGQ (button) (small blind) folded before Flop
Seat 2: RwDoM55ZeQuI2ADyJhOb2Q (big blind) collected ($2)



PokerStars Game #59940861232:  Hold'em No Limit ($1/$2) - 2009/07/01 1:18:44 ET
Table '8Y6PEyoNuepZTai2Q56aHw' 9-max Seat #4 is the button
Seat 1: 5Q8U6iZbeO7xJSS4qvDP5g ($282 in chips)
Seat 2: gDCJIAlovbPnTvMM7Dd1gA ($178.35 in chips)
Seat 3: WUlHm+ydPPHG7Lb0rePSdA ($120 in chips)
Seat 4: xKkwALG38OfLQ9DXuJgR1w ($284.55 in chips)
Seat 6: NtLDBSjsJQEKekh5cdinvw ($357.50 in chips)
Seat 7: Kzta8yu9vxHT4B70mjBZ+w ($200 in chips)
Seat 8: rW/MyplHylMSBRaoRUzWrg ($40 in chips)
Seat 9: F7m34OOfAQ7annesMHVjKw ($94.80 in chips)
NtLDBSjsJQEKekh5cdinvw: posts small blind $1
Kzta8yu9vxHT4B70mjBZ+w: posts big blind $2
*** HOLE CARDS ***
rW/MyplHylMSBRaoRUzWrg: folds
F7m34OOfAQ7annesMHVjKw: folds
5Q8U6iZbeO7xJSS4qvDP5g: folds
gDCJIAlovbPnTvMM7Dd1gA: calls $2
WUlHm+ydPPHG7Lb0rePSdA: folds
xKkwALG38OfLQ9DXuJgR1w: folds
NtLDBSjsJQEKekh5cdinvw: calls $1
Kzta8yu9vxHT4B70mjBZ+w: checks
*** FLOP *** [Kc Kh Qc]
NtLDBSjsJQEKekh5cdinvw: bets $2
Kzta8yu9vxHT4B70mjBZ+w: folds
gDCJIAlovbPnTvMM7Dd1gA: folds
NtLDBSjsJQEKekh5cdinvw collected $5.70 from pot
NtLDBSjsJQEKekh5cdinvw: doesn't show hand
*** SUMMARY ***
Total pot $6 | Rake $0.30
Board [Kc Kh Qc]
Seat 1: 5Q8U6iZbeO7xJSS4qvDP5g folded before Flop (didn't bet)
Seat 2: gDCJIAlovbPnTvMM7Dd1gA folded on the Flop
Seat 3: WUlHm+ydPPHG7Lb0rePSdA folded before Flop (didn't bet)
Seat 4: xKkwALG38OfLQ9DXuJgR1w (button) folded before Flop (didn't bet)
Seat 6: NtLDBSjsJQEKekh5cdinvw (small blind) collected ($5.70)
Seat 7: Kzta8yu9vxHT4B70mjBZ+w (big blind) folded on the Flop
Seat 8: rW/MyplHylMSBRaoRUzWrg folded before Flop (didn't bet)
Seat 9: F7m34OOfAQ7annesMHVjKw folded before Flop (didn't bet)



PokerStars Game #59940861254:  Hold'em No Limit ($1/$2) - 2009/07/01 1:18:44 ET
Table 'C4lkCXY2PWy6z4vsAe5NGQ' 6-max Seat #6 is the button
Seat 1: 4bqvCfJ0e8CTYnn0Go9hbQ ($65.60 in chips)
Seat 2: 6hRJ68JkbJq6MYI9o5bUnQ ($44.40 in chips)
Seat 3: sTPOWERd9HWPCNrDBwsVjA ($215.35 in chips)
Seat 4: VvdR9F3I+2yELkfTVvC1dg ($200 in chips)
Seat 6: B87ikIyZ/TzAVeXf38Ny0g ($614.75 in chips)
4bqvCfJ0e8CTYnn0Go9hbQ: posts small blind $1
6hRJ68JkbJq6MYI9o5bUnQ: posts big blind $2
*** HOLE CARDS ***
sTPOWERd9HWPCNrDBwsVjA: raises $6 to $8
VvdR9F3I+2yELkfTVvC1dg: folds
B87ikIyZ/TzAVeXf38Ny0g: folds
4bqvCfJ0e8CTYnn0Go9hbQ: folds
6hRJ68JkbJq6MYI9o5bUnQ: folds
sTPOWERd9HWPCNrDBwsVjA collected $5 from pot
*** SUMMARY ***
Total pot $5 | Rake $0
Seat 1: 4bqvCfJ0e8CTYnn0Go9hbQ (small blind) folded before Flop
Seat 2: 6hRJ68JkbJq6MYI9o5bUnQ (big blind) folded before Flop
Seat 3: sTPOWERd9HWPCNrDBwsVjA collected ($5)
Seat 4: VvdR9F3I+2yELkfTVvC1dg folded before Flop (didn't bet)
Seat 6: B87ikIyZ/TzAVeXf38Ny0g (button) folded before Flop (didn't bet)



PokerStars Game #59940862506:  Hold'em No Limit ($1/$2) - 2009/07/01 1:18:46 ET
Table 'gftD4mDF7mIFKvSrIyaRbw' 9-max Seat #5 is the button
Seat 1: 31HuO+DQxppUQEedBWukug ($106 in chips)
Seat 2: GX1heJ+DSsvm7gzSPsYhhQ ($37 in chips)
Seat 3: CUZwDpLTQKhzarPe+JCLOQ ($214.10 in chips)
Seat 5: mpsfNtnMVDqQHTe92AhIdw ($120.50 in chips)
Seat 6: 2NvwF8W2nzsbS+G//yLAbQ ($163.50 in chips)
Seat 8: MpL4DeEqGQu0H8TJEbEOrg ($40 in chips)
Seat 9: F7m34OOfAQ7annesMHVjKw ($159.10 in chips)
2NvwF8W2nzsbS+G//yLAbQ: posts small blind $1
EBV6OktyeSmh4w6sWmcWOw: is sitting out
MpL4DeEqGQu0H8TJEbEOrg: posts big blind $2
/inIs/z/PcX+TniIFpaxpg: sits out
*** HOLE CARDS ***
EBV6OktyeSmh4w6sWmcWOw leaves the table
F7m34OOfAQ7annesMHVjKw: folds
+T/63sAeZzWyHchahJ36GQ joins the table at seat #7
31HuO+DQxppUQEedBWukug: folds
GX1heJ+DSsvm7gzSPsYhhQ: folds
CUZwDpLTQKhzarPe+JCLOQ: raises $4 to $6
mpsfNtnMVDqQHTe92AhIdw: folds
2NvwF8W2nzsbS+G//yLAbQ: calls $5
MpL4DeEqGQu0H8TJEbEOrg: folds
*** FLOP *** [3d As 3c]
2NvwF8W2nzsbS+G//yLAbQ: checks
CUZwDpLTQKhzarPe+JCLOQ: bets $8
2NvwF8W2nzsbS+G//yLAbQ: calls $8
*** TURN *** [3d As 3c] [Ts]
2NvwF8W2nzsbS+G//yLAbQ: bets $12
CUZwDpLTQKhzarPe+JCLOQ: folds
2NvwF8W2nzsbS+G//yLAbQ collected $28.55 from pot
*** SUMMARY ***
Total pot $30 | Rake $1.45
Board [3d As 3c Ts]
Seat 1: 31HuO+DQxppUQEedBWukug folded before Flop (didn't bet)
Seat 2: GX1heJ+DSsvm7gzSPsYhhQ folded before Flop (didn't bet)
Seat 3: CUZwDpLTQKhzarPe+JCLOQ folded on the Turn
Seat 5: mpsfNtnMVDqQHTe92AhIdw (button) folded before Flop (didn't bet)
Seat 6: 2NvwF8W2nzsbS+G//yLAbQ (small blind) collected ($28.55)
Seat 8: MpL4DeEqGQu0H8TJEbEOrg (big blind) folded before Flop
Seat 9: F7m34OOfAQ7annesMHVjKw folded before Flop (didn't bet)



PokerStars Game #59940863458:  Hold'em No Limit ($1/$2) - 2009/07/01 1:18:48 ET
Table 'mGpP9StWRnoeiBDExc6Frg' 6-max Seat #5 is the button
Seat 1: VvdR9F3I+2yELkfTVvC1dg ($203 in chips)
Seat 2: dZcLsEI8iXkobBduRJ45Yw ($57.75 in chips)
Seat 3: 7acrZUQC3Zc9BNLjoKIcLQ ($47.10 in chips)
Seat 4: 4dcDwIHRm96PwtqkpQiuiA ($43.35 in chips)
Seat 5: d1puGuVBE0fidn+5eRJ0tw ($227.20 in chips)
Seat 6: B2Ih1sr5VZk+8He7rcrMtQ ($460.35 in chips)
B2Ih1sr5VZk+8He7rcrMtQ: posts small blind $1
VvdR9F3I+2yELkfTVvC1dg: posts big blind $2
*** HOLE CARDS ***
dZcLsEI8iXkobBduRJ45Yw: raises $4 to $6
7acrZUQC3Zc9BNLjoKIcLQ: folds
4dcDwIHRm96PwtqkpQiuiA: folds
d1puGuVBE0fidn+5eRJ0tw: folds
B2Ih1sr5VZk+8He7rcrMtQ: folds
VvdR9F3I+2yELkfTVvC1dg: folds
dZcLsEI8iXkobBduRJ45Yw collected $5 from pot
dZcLsEI8iXkobBduRJ45Yw: doesn't show hand
*** SUMMARY ***
Total pot $5 | Rake $0
Seat 1: VvdR9F3I+2yELkfTVvC1dg (big blind) folded before Flop
Seat 2: dZcLsEI8iXkobBduRJ45Yw collected ($5)
Seat 3: 7acrZUQC3Zc9BNLjoKIcLQ folded before Flop (didn't bet)
Seat 4: 4dcDwIHRm96PwtqkpQiuiA folded before Flop (didn't bet)
Seat 5: d1puGuVBE0fidn+5eRJ0tw (button) folded before Flop (didn't bet)
Seat 6: B2Ih1sr5VZk+8He7rcrMtQ (small blind) folded before Flop



PokerStars Game #59940864840:  Hold'em No Limit ($1/$2) - 2009/07/01 1:18:50 ET
Table 'jlrIxbrVIG+gjaUYT4za8g' 6-max Seat #5 is the button
Seat 1: ygTTt5ehT4aF86q1a8/R+w ($225.30 in chips)
Seat 4: 8srN1dKQePlsv0GyTada+Q ($286.10 in chips)
Seat 5: AyBB0k3Dcl7xbXUeGMw06g ($77.20 in chips)
Seat 6: vkfxu8f/jMYKUk6Ly4eujw ($339 in chips)
vkfxu8f/jMYKUk6Ly4eujw: posts small blind $1
ygTTt5ehT4aF86q1a8/R+w: posts big blind $2
*** HOLE CARDS ***
342gZYfwWuuNOnZaoysV6A leaves the table
8srN1dKQePlsv0GyTada+Q: raises $4 to $6
N18PrNGQj43J7TJuQuu+tw leaves the table
AyBB0k3Dcl7xbXUeGMw06g: folds
vkfxu8f/jMYKUk6Ly4eujw: folds
ygTTt5ehT4aF86q1a8/R+w: calls $4
*** FLOP *** [9h 4d Jd]
RUZs7P4uzWavoA6iEpDKLw joins the table at seat #3
ygTTt5ehT4aF86q1a8/R+w: checks
8srN1dKQePlsv0GyTada+Q: checks
*** TURN *** [9h 4d Jd] [3h]
ygTTt5ehT4aF86q1a8/R+w: checks
8srN1dKQePlsv0GyTada+Q: checks
*** RIVER *** [9h 4d Jd 3h] [Jc]
ygTTt5ehT4aF86q1a8/R+w: checks
8srN1dKQePlsv0GyTada+Q: bets $8
ygTTt5ehT4aF86q1a8/R+w: calls $8
*** SHOW DOWN ***
8srN1dKQePlsv0GyTada+Q: shows [7c 7h] (two pair, Jacks and Sevens)
ygTTt5ehT4aF86q1a8/R+w: mucks hand
8srN1dKQePlsv0GyTada+Q collected $27.60 from pot
*** SUMMARY ***
Total pot $29 | Rake $1.40
Board [9h 4d Jd 3h Jc]
Seat 1: ygTTt5ehT4aF86q1a8/R+w (big blind) mucked
Seat 4: 8srN1dKQePlsv0GyTada+Q showed [7c 7h] and won ($27.60) with two pair, Jacks and Sevens
Seat 5: AyBB0k3Dcl7xbXUeGMw06g (button) folded before Flop (didn't bet)
Seat 6: vkfxu8f/jMYKUk6Ly4eujw (small blind) folded before Flop



PokerStars Game #59940864694:  Hold'em No Limit ($1/$2) - 2009/07/01 1:18:50 ET
Table 'dBLpiMEy1cezkSKD+ZpCcw' 2-max Seat #2 is the button
Seat 1: NFRtU1s5+WFh9EKwu+KLOQ ($234.30 in chips)
Seat 2: 4rrQUikeMSkuWGHgW80++w ($207.50 in chips)
4rrQUikeMSkuWGHgW80++w: posts small blind $1
NFRtU1s5+WFh9EKwu+KLOQ: posts big blind $2
*** HOLE CARDS ***
4rrQUikeMSkuWGHgW80++w: raises $4 to $6
NFRtU1s5+WFh9EKwu+KLOQ: calls $4
*** FLOP *** [Qh 3c 6s]
NFRtU1s5+WFh9EKwu+KLOQ: checks
4rrQUikeMSkuWGHgW80++w: bets $8
NFRtU1s5+WFh9EKwu+KLOQ: folds
4rrQUikeMSkuWGHgW80++w collected $11.50 from pot
4rrQUikeMSkuWGHgW80++w: doesn't show hand
*** SUMMARY ***
Total pot $12 | Rake $0.50
Board [Qh 3c 6s]
Seat 1: NFRtU1s5+WFh9EKwu+KLOQ (big blind) folded on the Flop
Seat 2: 4rrQUikeMSkuWGHgW80++w (button) (small blind) collected ($11.50)



PokerStars Game #59940864588:  Hold'em No Limit ($1/$2) - 2009/07/01 1:18:50 ET
Table 'P/yCfYl1GfGsu/e6DxDy/A' 2-max Seat #2 is the button
Seat 1: 7fOCUy3x9hdkmXkkDNolGQ ($727 in chips)
Seat 2: RwDoM55ZeQuI2ADyJhOb2Q ($762 in chips)
RwDoM55ZeQuI2ADyJhOb2Q: posts small blind $1
7fOCUy3x9hdkmXkkDNolGQ: posts big blind $2
*** HOLE CARDS ***
RwDoM55ZeQuI2ADyJhOb2Q: raises $4 to $6
7fOCUy3x9hdkmXkkDNolGQ: calls $4
*** FLOP *** [4h 5c Ac]
7fOCUy3x9hdkmXkkDNolGQ: checks
RwDoM55ZeQuI2ADyJhOb2Q: bets $10
7fOCUy3x9hdkmXkkDNolGQ: folds
RwDoM55ZeQuI2ADyJhOb2Q collected $11.50 from pot
*** SUMMARY ***
Total pot $12 | Rake $0.50
Board [4h 5c Ac]
Seat 1: 7fOCUy3x9hdkmXkkDNolGQ (big blind) folded on the Flop
Seat 2: RwDoM55ZeQuI2ADyJhOb2Q (button) (small blind) collected ($11.50)



PokerStars Game #59940867596:  Hold'em No Limit ($1/$2) - 2009/07/01 1:18:55 ET
Table 'gnHBqWll9O3fxG7Ojkz/ng' 9-max Seat #1 is the button
Seat 1: TAfo4veNRaRlzDXMMYS3Jg ($37 in chips)
Seat 2: H6Z4+qu8gR0VUiPOijndVg ($331.25 in chips)
Seat 3: 5Q8U6iZbeO7xJSS4qvDP5g ($218 in chips)
Seat 5: rBQDMkKm9cZn6M9NPsiVew ($239.45 in chips)
Seat 6: /inIs/z/PcX+TniIFpaxpg ($45 in chips)
Seat 7: jqui3xAWCkcdPW36a6BD+w ($342.40 in chips)
Seat 8: cM6efHzdxoqYm0EQKP4TTQ ($108.30 in chips)
Seat 9: sN6yR5I5zFq/WFyIz5UfzQ ($201 in chips)
H6Z4+qu8gR0VUiPOijndVg: posts small blind $1
5Q8U6iZbeO7xJSS4qvDP5g: posts big blind $2
*** HOLE CARDS ***
rBQDMkKm9cZn6M9NPsiVew: folds
/inIs/z/PcX+TniIFpaxpg: folds
jqui3xAWCkcdPW36a6BD+w: folds
cM6efHzdxoqYm0EQKP4TTQ: calls $2
sN6yR5I5zFq/WFyIz5UfzQ: folds
TAfo4veNRaRlzDXMMYS3Jg: folds
H6Z4+qu8gR0VUiPOijndVg: calls $1
5Q8U6iZbeO7xJSS4qvDP5g: checks
*** FLOP *** [9s Jc 6d]
H6Z4+qu8gR0VUiPOijndVg: bets $4
5Q8U6iZbeO7xJSS4qvDP5g: folds
cM6efHzdxoqYm0EQKP4TTQ: calls $4
*** TURN *** [9s Jc 6d] [Jh]
H6Z4+qu8gR0VUiPOijndVg: checks
cM6efHzdxoqYm0EQKP4TTQ: checks
*** RIVER *** [9s Jc 6d Jh] [3c]
H6Z4+qu8gR0VUiPOijndVg: bets $8
cM6efHzdxoqYm0EQKP4TTQ: folds
H6Z4+qu8gR0VUiPOijndVg collected $13.35 from pot
H6Z4+qu8gR0VUiPOijndVg: doesn't show hand
*** SUMMARY ***
Total pot $14 | Rake $0.65
Board [9s Jc 6d Jh 3c]
Seat 1: TAfo4veNRaRlzDXMMYS3Jg (button) folded before Flop (didn't bet)
Seat 2: H6Z4+qu8gR0VUiPOijndVg (small blind) collected ($13.35)
Seat 3: 5Q8U6iZbeO7xJSS4qvDP5g (big blind) folded on the Flop
Seat 5: rBQDMkKm9cZn6M9NPsiVew folded before Flop (didn't bet)
Seat 6: /inIs/z/PcX+TniIFpaxpg folded before Flop (didn't bet)
Seat 7: jqui3xAWCkcdPW36a6BD+w folded before Flop (didn't bet)
Seat 8: cM6efHzdxoqYm0EQKP4TTQ folded on the River
Seat 9: sN6yR5I5zFq/WFyIz5UfzQ folded before Flop (didn't bet)



PokerStars Game #59940868140:  Hold'em No Limit ($1/$2) - 2009/07/01 1:18:56 ET
Table 'bIihwBANJSFqlHPPtset+w' 9-max Seat #7 is the button
Seat 1: /inIs/z/PcX+TniIFpaxpg ($33 in chips)
Seat 2: lQYT23h5QCUVZAKxjOO39Q ($175.30 in chips)
Seat 3: OipzuP0MueAd8hGaz/kWMQ ($45.85 in chips)
Seat 4: ri8CLkX3e9JF34dQNbsHGA ($42.40 in chips)
Seat 5: vxbbJLsS1bva6tW2NiFssg ($200 in chips)
Seat 6: CkE3IyJF1KvdaAOmZY5XqQ ($186 in chips)
Seat 7: pCmk6FpSOLJ+85o1tLHIag ($130.45 in chips)
Seat 8: iMe5yhc+1BaiIPHet3NMrA ($205.50 in chips)
Seat 9: qn8LDoUFphcG4+r+F+Vhrg ($184 in chips)
iMe5yhc+1BaiIPHet3NMrA: posts small blind $1
qn8LDoUFphcG4+r+F+Vhrg: posts big blind $2
*** HOLE CARDS ***
/inIs/z/PcX+TniIFpaxpg: folds
lQYT23h5QCUVZAKxjOO39Q: folds
OipzuP0MueAd8hGaz/kWMQ: folds
ri8CLkX3e9JF34dQNbsHGA: folds
vxbbJLsS1bva6tW2NiFssg: folds
CkE3IyJF1KvdaAOmZY5XqQ: folds
pCmk6FpSOLJ+85o1tLHIag: folds
iMe5yhc+1BaiIPHet3NMrA: folds
qn8LDoUFphcG4+r+F+Vhrg collected $2 from pot
*** SUMMARY ***
Total pot $2 | Rake $0
Seat 1: /inIs/z/PcX+TniIFpaxpg folded before Flop (didn't bet)
Seat 2: lQYT23h5QCUVZAKxjOO39Q folded before Flop (didn't bet)
Seat 3: OipzuP0MueAd8hGaz/kWMQ folded before Flop (didn't bet)
Seat 4: ri8CLkX3e9JF34dQNbsHGA folded before Flop (didn't bet)
Seat 5: vxbbJLsS1bva6tW2NiFssg folded before Flop (didn't bet)
Seat 6: CkE3IyJF1KvdaAOmZY5XqQ folded before Flop (didn't bet)
Seat 7: pCmk6FpSOLJ+85o1tLHIag (button) folded before Flop (didn't bet)
Seat 8: iMe5yhc+1BaiIPHet3NMrA (small blind) folded before Flop
Seat 9: qn8LDoUFphcG4+r+F+Vhrg (big blind) collected ($2)



PokerStars Game #59940869482:  Hold'em No Limit ($1/$2) - 2009/07/01 1:18:58 ET
Table 'QxerF7GUfCbl+4a8XaTB2w' 6-max Seat #6 is the button
Seat 1: o9jamqIi6sTTRSqudgboRA ($296.50 in chips)
Seat 2: vkfxu8f/jMYKUk6Ly4eujw ($199.80 in chips)
Seat 3: m7mYVfnCOK5TE/VkN/FhOg ($230.70 in chips)
Seat 4: 09BNF4quPDzanQzM8vc6WA ($40.55 in chips)
Seat 5: YsLQ3BAvgQHWXMAv3Wv6Hg ($201.75 in chips)
Seat 6: VvdR9F3I+2yELkfTVvC1dg ($221.60 in chips)
o9jamqIi6sTTRSqudgboRA: posts small blind $1
vkfxu8f/jMYKUk6Ly4eujw: posts big blind $2
*** HOLE CARDS ***
m7mYVfnCOK5TE/VkN/FhOg: calls $2
09BNF4quPDzanQzM8vc6WA: folds
YsLQ3BAvgQHWXMAv3Wv6Hg: folds
VvdR9F3I+2yELkfTVvC1dg: raises $6 to $8
o9jamqIi6sTTRSqudgboRA: folds
vkfxu8f/jMYKUk6Ly4eujw: folds
m7mYVfnCOK5TE/VkN/FhOg: calls $6
*** FLOP *** [7s 3h 8s]
m7mYVfnCOK5TE/VkN/FhOg: checks
VvdR9F3I+2yELkfTVvC1dg: bets $13.50
m7mYVfnCOK5TE/VkN/FhOg: calls $13.50
*** TURN *** [7s 3h 8s] [2c]
m7mYVfnCOK5TE/VkN/FhOg: checks
VvdR9F3I+2yELkfTVvC1dg: bets $31.90
m7mYVfnCOK5TE/VkN/FhOg: calls $31.90
*** RIVER *** [7s 3h 8s 2c] [5s]
m7mYVfnCOK5TE/VkN/FhOg: bets $177.30 and is all-in
VvdR9F3I+2yELkfTVvC1dg: folds
m7mYVfnCOK5TE/VkN/FhOg collected $106.80 from pot
m7mYVfnCOK5TE/VkN/FhOg: doesn't show hand
*** SUMMARY ***
Total pot $109.80 | Rake $3
Board [7s 3h 8s 2c 5s]
Seat 1: o9jamqIi6sTTRSqudgboRA (small blind) folded before Flop
Seat 2: vkfxu8f/jMYKUk6Ly4eujw (big blind) folded before Flop
Seat 3: m7mYVfnCOK5TE/VkN/FhOg collected ($106.80)
Seat 4: 09BNF4quPDzanQzM8vc6WA folded before Flop (didn't bet)
Seat 5: YsLQ3BAvgQHWXMAv3Wv6Hg folded before Flop (didn't bet)
Seat 6: VvdR9F3I+2yELkfTVvC1dg (button) folded on the River



PokerStars Game #59940869552:  Hold'em No Limit ($1/$2) - 2009/07/01 1:18:58 ET
Table 'NmY84NAf9Mh0ckAckHnh5g' 2-max Seat #1 is the button
Seat 1: 6hvg964TSqZ3AL/0XK9aVQ ($255.80 in chips)
Seat 2: RwDoM55ZeQuI2ADyJhOb2Q ($754.40 in chips)
6hvg964TSqZ3AL/0XK9aVQ: posts small blind $1
RwDoM55ZeQuI2ADyJhOb2Q: posts big blind $2
*** HOLE CARDS ***
6hvg964TSqZ3AL/0XK9aVQ: calls $1
RwDoM55ZeQuI2ADyJhOb2Q: checks
*** FLOP *** [3c 8d Qh]
RwDoM55ZeQuI2ADyJhOb2Q: checks
6hvg964TSqZ3AL/0XK9aVQ: bets $4
RwDoM55ZeQuI2ADyJhOb2Q: folds
6hvg964TSqZ3AL/0XK9aVQ collected $3.80 from pot
6hvg964TSqZ3AL/0XK9aVQ: doesn't show hand
*** SUMMARY ***
Total pot $4 | Rake $0.20
Board [3c 8d Qh]
Seat 1: 6hvg964TSqZ3AL/0XK9aVQ (button) (small blind) collected ($3.80)
Seat 2: RwDoM55ZeQuI2ADyJhOb2Q (big blind) folded on the Flop



PokerStars Game #59940870952:  Hold'em No Limit ($1/$2) - 2009/07/01 1:19:01 ET
Table 'LL4bDFyhj5hsMpzaDugJZg' 6-max Seat #3 is the button
Seat 1: FwvID/fQGlpY3soi/lMTww ($77.90 in chips)
Seat 2: IZng3w8jiJHHp3LbYKLi4w ($28.50 in chips)
Seat 3: iI/NMpRxMkGieArQEhACSA ($279.70 in chips)
Seat 4: 8srN1dKQePlsv0GyTada+Q ($315.75 in chips)
Seat 5: A2GTwTiwkb1ilNWgW487Vg ($99.70 in chips)
Seat 6: 692Q4sfB0gTElzS0WMeg+A ($217.10 in chips)
8srN1dKQePlsv0GyTada+Q: posts small blind $1
A2GTwTiwkb1ilNWgW487Vg: posts big blind $2
*** HOLE CARDS ***
692Q4sfB0gTElzS0WMeg+A: folds
FwvID/fQGlpY3soi/lMTww: folds
IZng3w8jiJHHp3LbYKLi4w: raises $4 to $6
iI/NMpRxMkGieArQEhACSA: folds
8srN1dKQePlsv0GyTada+Q: folds
A2GTwTiwkb1ilNWgW487Vg: calls $4
*** FLOP *** [2c Qc 6s]
A2GTwTiwkb1ilNWgW487Vg: bets $2
IZng3w8jiJHHp3LbYKLi4w: raises $4 to $6
A2GTwTiwkb1ilNWgW487Vg: raises $34 to $40
IZng3w8jiJHHp3LbYKLi4w: calls $16.50 and is all-in
*** TURN *** [2c Qc 6s] [Ad]
*** RIVER *** [2c Qc 6s Ad] [Qh]
*** SHOW DOWN ***
A2GTwTiwkb1ilNWgW487Vg: shows [4s Qs] (three of a kind, Queens)
IZng3w8jiJHHp3LbYKLi4w: shows [2d 2s] (a full house, Deuces full of Queens)
IZng3w8jiJHHp3LbYKLi4w collected $55.15 from pot
*** SUMMARY ***
Total pot $58 | Rake $2.85
Board [2c Qc 6s Ad Qh]
Seat 1: FwvID/fQGlpY3soi/lMTww folded before Flop (didn't bet)
Seat 2: IZng3w8jiJHHp3LbYKLi4w showed [2d 2s] and won ($55.15) with a full house, Deuces full of Queens
Seat 3: iI/NMpRxMkGieArQEhACSA (button) folded before Flop (didn't bet)
Seat 4: 8srN1dKQePlsv0GyTada+Q (small blind) folded before Flop
Seat 5: A2GTwTiwkb1ilNWgW487Vg (big blind) showed [4s Qs] and lost with three of a kind, Queens
Seat 6: 692Q4sfB0gTElzS0WMeg+A folded before Flop (didn't bet)



PokerStars Game #59940871684:  Hold'em No Limit ($1/$2) - 2009/07/01 1:19:02 ET
Table 'mGpP9StWRnoeiBDExc6Frg' 6-max Seat #6 is the button
Seat 1: VvdR9F3I+2yELkfTVvC1dg ($201 in chips)
Seat 2: dZcLsEI8iXkobBduRJ45Yw ($60.75 in chips)
Seat 3: 7acrZUQC3Zc9BNLjoKIcLQ ($47.10 in chips)
Seat 4: 4dcDwIHRm96PwtqkpQiuiA ($43.35 in chips)
Seat 5: d1puGuVBE0fidn+5eRJ0tw ($227.20 in chips)
Seat 6: B2Ih1sr5VZk+8He7rcrMtQ ($459.35 in chips)
VvdR9F3I+2yELkfTVvC1dg: posts small blind $1
dZcLsEI8iXkobBduRJ45Yw: posts big blind $2
*** HOLE CARDS ***
7acrZUQC3Zc9BNLjoKIcLQ: calls $2
4dcDwIHRm96PwtqkpQiuiA: folds
d1puGuVBE0fidn+5eRJ0tw: folds
B2Ih1sr5VZk+8He7rcrMtQ: calls $2
VvdR9F3I+2yELkfTVvC1dg: calls $1
dZcLsEI8iXkobBduRJ45Yw: checks
*** FLOP *** [5h 4h Ah]
VvdR9F3I+2yELkfTVvC1dg: checks
dZcLsEI8iXkobBduRJ45Yw: checks
7acrZUQC3Zc9BNLjoKIcLQ: bets $6
B2Ih1sr5VZk+8He7rcrMtQ: calls $6
VvdR9F3I+2yELkfTVvC1dg: folds
dZcLsEI8iXkobBduRJ45Yw: raises $12 to $18
7acrZUQC3Zc9BNLjoKIcLQ: folds
B2Ih1sr5VZk+8He7rcrMtQ: folds
dZcLsEI8iXkobBduRJ45Yw collected $24.75 from pot
dZcLsEI8iXkobBduRJ45Yw: doesn't show hand
*** SUMMARY ***
Total pot $26 | Rake $1.25
Board [5h 4h Ah]
Seat 1: VvdR9F3I+2yELkfTVvC1dg (small blind) folded on the Flop
Seat 2: dZcLsEI8iXkobBduRJ45Yw (big blind) collected ($24.75)
Seat 3: 7acrZUQC3Zc9BNLjoKIcLQ folded on the Flop
Seat 4: 4dcDwIHRm96PwtqkpQiuiA folded before Flop (didn't bet)
Seat 5: d1puGuVBE0fidn+5eRJ0tw folded before Flop (didn't bet)
Seat 6: B2Ih1sr5VZk+8He7rcrMtQ (button) folded on the Flop



PokerStars Game #59940871888:  Hold'em No Limit ($1/$2) - 2009/07/01 1:19:02 ET
Table '/dyk+YdRGv90j2box35j8w' 6-max Seat #6 is the button
Seat 2: qCnEYuAE5y5A7bk6fO5/jQ ($500.60 in chips)
Seat 3: sTPOWERd9HWPCNrDBwsVjA ($228.50 in chips)
Seat 4: z/u1YTnkiIDrtp/2cA2dBg ($125.65 in chips)
Seat 5: VvdR9F3I+2yELkfTVvC1dg ($200 in chips)
Seat 6: ZwvXzkkZ3XpMhKfAmVpahw ($356.25 in chips)
qCnEYuAE5y5A7bk6fO5/jQ: posts small blind $1
sTPOWERd9HWPCNrDBwsVjA: posts big blind $2
*** HOLE CARDS ***
z/u1YTnkiIDrtp/2cA2dBg: folds
VvdR9F3I+2yELkfTVvC1dg: folds
8srN1dKQePlsv0GyTada+Q has returned
ZwvXzkkZ3XpMhKfAmVpahw: folds
qCnEYuAE5y5A7bk6fO5/jQ: folds
sTPOWERd9HWPCNrDBwsVjA collected $2 from pot
*** SUMMARY ***
Total pot $2 | Rake $0
Seat 2: qCnEYuAE5y5A7bk6fO5/jQ (small blind) folded before Flop
Seat 3: sTPOWERd9HWPCNrDBwsVjA (big blind) collected ($2)
Seat 4: z/u1YTnkiIDrtp/2cA2dBg folded before Flop (didn't bet)
Seat 5: VvdR9F3I+2yELkfTVvC1dg folded before Flop (didn't bet)
Seat 6: ZwvXzkkZ3XpMhKfAmVpahw (button) folded before Flop (didn't bet)



PokerStars Game #59940872256:  Hold'em No Limit ($1/$2) - 2009/07/01 1:19:03 ET
Table 'uJ9juaXXg9yIcSU8amxaXQ' 6-max Seat #6 is the button
Seat 1: JsqOjN/eHz0uYVf/PyUJ6Q ($150.85 in chips)
Seat 2: VvdR9F3I+2yELkfTVvC1dg ($200 in chips)
Seat 3: qXDd0ZyMIse0OBu8pxeQ3Q ($202 in chips)
Seat 5: YsLQ3BAvgQHWXMAv3Wv6Hg ($230.75 in chips)
Seat 6: 2DFp9Veq1xxq64dCjwNuUw ($48.90 in chips)
JsqOjN/eHz0uYVf/PyUJ6Q: posts small blind $1
VvdR9F3I+2yELkfTVvC1dg: posts big blind $2
*** HOLE CARDS ***
qXDd0ZyMIse0OBu8pxeQ3Q: raises $5 to $7
YsLQ3BAvgQHWXMAv3Wv6Hg: raises $11 to $18
2DFp9Veq1xxq64dCjwNuUw: folds
JsqOjN/eHz0uYVf/PyUJ6Q: folds
VvdR9F3I+2yELkfTVvC1dg: folds
qXDd0ZyMIse0OBu8pxeQ3Q: calls $11
*** FLOP *** [Ad Qs 4c]
qXDd0ZyMIse0OBu8pxeQ3Q: checks
YsLQ3BAvgQHWXMAv3Wv6Hg: bets $28
qXDd0ZyMIse0OBu8pxeQ3Q: calls $28
*** TURN *** [Ad Qs 4c] [Qc]
qXDd0ZyMIse0OBu8pxeQ3Q: checks
YsLQ3BAvgQHWXMAv3Wv6Hg: checks
*** RIVER *** [Ad Qs 4c Qc] [9h]
qXDd0ZyMIse0OBu8pxeQ3Q: checks
YsLQ3BAvgQHWXMAv3Wv6Hg: checks
*** SHOW DOWN ***
qXDd0ZyMIse0OBu8pxeQ3Q: shows [Jc Js] (two pair, Queens and Jacks)
YsLQ3BAvgQHWXMAv3Wv6Hg: mucks hand
qXDd0ZyMIse0OBu8pxeQ3Q collected $93 from pot
*** SUMMARY ***
Total pot $95 | Rake $2
Board [Ad Qs 4c Qc 9h]
Seat 1: JsqOjN/eHz0uYVf/PyUJ6Q (small blind) folded before Flop
Seat 2: VvdR9F3I+2yELkfTVvC1dg (big blind) folded before Flop
Seat 3: qXDd0ZyMIse0OBu8pxeQ3Q showed [Jc Js] and won ($93) with two pair, Queens and Jacks
Seat 5: YsLQ3BAvgQHWXMAv3Wv6Hg mucked
Seat 6: 2DFp9Veq1xxq64dCjwNuUw (button) folded before Flop (didn't bet)



PokerStars Game #59940872342:  Hold'em No Limit ($1/$2) - 2009/07/01 1:19:03 ET
Table '4NGNnZ/osQfNq6abYqkJeA' 6-max Seat #5 is the button
Seat 1: 7zM38baFvmCNB/F80oE0cQ ($62.30 in chips)
Seat 2: 669iGNwYwgRZg3nhS+aDAQ ($113.55 in chips)
Seat 3: 54yWzRRgS0oZ+S6LwZBxMQ ($28 in chips)
Seat 4: sY+4Uuh5z/6AbXXaCS10jw ($207 in chips)
Seat 5: VvdR9F3I+2yELkfTVvC1dg ($202 in chips)
Seat 6: kkgpegLoQkmL6LIsFsvtiQ ($270.15 in chips)
kkgpegLoQkmL6LIsFsvtiQ: posts small blind $1
7zM38baFvmCNB/F80oE0cQ: posts big blind $2
*** HOLE CARDS ***
669iGNwYwgRZg3nhS+aDAQ: folds
54yWzRRgS0oZ+S6LwZBxMQ: calls $2
sY+4Uuh5z/6AbXXaCS10jw: folds
VvdR9F3I+2yELkfTVvC1dg: folds
kkgpegLoQkmL6LIsFsvtiQ: folds
7zM38baFvmCNB/F80oE0cQ: checks
*** FLOP *** [Jd Qs 4s]
7zM38baFvmCNB/F80oE0cQ: checks
54yWzRRgS0oZ+S6LwZBxMQ: bets $4
7zM38baFvmCNB/F80oE0cQ: folds
54yWzRRgS0oZ+S6LwZBxMQ collected $4.75 from pot
54yWzRRgS0oZ+S6LwZBxMQ: doesn't show hand
*** SUMMARY ***
Total pot $5 | Rake $0.25
Board [Jd Qs 4s]
Seat 1: 7zM38baFvmCNB/F80oE0cQ (big blind) folded on the Flop
Seat 2: 669iGNwYwgRZg3nhS+aDAQ folded before Flop (didn't bet)
Seat 3: 54yWzRRgS0oZ+S6LwZBxMQ collected ($4.75)
Seat 4: sY+4Uuh5z/6AbXXaCS10jw folded before Flop (didn't bet)
Seat 5: VvdR9F3I+2yELkfTVvC1dg (button) folded before Flop (didn't bet)
Seat 6: kkgpegLoQkmL6LIsFsvtiQ (small blind) folded before Flop



PokerStars Game #59940872116:  Hold'em No Limit ($1/$2) - 2009/07/01 1:19:03 ET
Table 'qVXak+oTeDXMGbWa4sDU5Q' 9-max Seat #4 is the button
Seat 1: H6Z4+qu8gR0VUiPOijndVg ($252.55 in chips)
Seat 2: rW/MyplHylMSBRaoRUzWrg ($40 in chips)
Seat 3: WUlHm+ydPPHG7Lb0rePSdA ($169.65 in chips)
Seat 4: lQYT23h5QCUVZAKxjOO39Q ($102.25 in chips)
Seat 5: FWGiDqRwvLeKmHq9t4Jy9w ($269.80 in chips)
Seat 6: GX1heJ+DSsvm7gzSPsYhhQ ($37 in chips)
Seat 7: PfmlvZlFiss79a6IoEr11g ($124.30 in chips)
Seat 8: TAfo4veNRaRlzDXMMYS3Jg ($41 in chips)
Seat 9: CkE3IyJF1KvdaAOmZY5XqQ ($200 in chips)
FWGiDqRwvLeKmHq9t4Jy9w: posts small blind $1
GX1heJ+DSsvm7gzSPsYhhQ: posts big blind $2
*** HOLE CARDS ***
PfmlvZlFiss79a6IoEr11g: folds
TAfo4veNRaRlzDXMMYS3Jg: folds
CkE3IyJF1KvdaAOmZY5XqQ: raises $4 to $6
H6Z4+qu8gR0VUiPOijndVg: folds
rW/MyplHylMSBRaoRUzWrg: folds
WUlHm+ydPPHG7Lb0rePSdA: folds
lQYT23h5QCUVZAKxjOO39Q: folds
FWGiDqRwvLeKmHq9t4Jy9w: folds
GX1heJ+DSsvm7gzSPsYhhQ: folds
CkE3IyJF1KvdaAOmZY5XqQ collected $5 from pot
*** SUMMARY ***
Total pot $5 | Rake $0
Seat 1: H6Z4+qu8gR0VUiPOijndVg folded before Flop (didn't bet)
Seat 2: rW/MyplHylMSBRaoRUzWrg folded before Flop (didn't bet)
Seat 3: WUlHm+ydPPHG7Lb0rePSdA folded before Flop (didn't bet)
Seat 4: lQYT23h5QCUVZAKxjOO39Q (button) folded before Flop (didn't bet)
Seat 5: FWGiDqRwvLeKmHq9t4Jy9w (small blind) folded before Flop
Seat 6: GX1heJ+DSsvm7gzSPsYhhQ (big blind) folded before Flop
Seat 7: PfmlvZlFiss79a6IoEr11g folded before Flop (didn't bet)
Seat 8: TAfo4veNRaRlzDXMMYS3Jg folded before Flop (didn't bet)
Seat 9: CkE3IyJF1KvdaAOmZY5XqQ collected ($5)



PokerStars Game #59940872624:  Hold'em No Limit ($1/$2) - 2009/07/01 1:19:04 ET
Table 'dBLpiMEy1cezkSKD+ZpCcw' 2-max Seat #1 is the button
Seat 1: NFRtU1s5+WFh9EKwu+KLOQ ($228.30 in chips)
Seat 2: 4rrQUikeMSkuWGHgW80++w ($213 in chips)
NFRtU1s5+WFh9EKwu+KLOQ: posts small blind $1
4rrQUikeMSkuWGHgW80++w: posts big blind $2
*** HOLE CARDS ***
NFRtU1s5+WFh9EKwu+KLOQ: raises $2 to $4
4rrQUikeMSkuWGHgW80++w: raises $6 to $10
NFRtU1s5+WFh9EKwu+KLOQ: calls $6
*** FLOP *** [9d 6s Ah]
4rrQUikeMSkuWGHgW80++w: checks
NFRtU1s5+WFh9EKwu+KLOQ: checks
*** TURN *** [9d 6s Ah] [Qs]
4rrQUikeMSkuWGHgW80++w: bets $12
NFRtU1s5+WFh9EKwu+KLOQ: calls $12
*** RIVER *** [9d 6s Ah Qs] [3d]
4rrQUikeMSkuWGHgW80++w: bets $50
NFRtU1s5+WFh9EKwu+KLOQ: raises $50 to $100
4rrQUikeMSkuWGHgW80++w: raises $91 to $191 and is all-in
NFRtU1s5+WFh9EKwu+KLOQ: calls $91
*** SHOW DOWN ***
4rrQUikeMSkuWGHgW80++w: shows [6c 6h] (three of a kind, Sixes)
NFRtU1s5+WFh9EKwu+KLOQ: shows [9h Ac] (two pair, Aces and Nines)
4rrQUikeMSkuWGHgW80++w collected $425.50 from pot
*** SUMMARY ***
Total pot $426 | Rake $0.50
Board [9d 6s Ah Qs 3d]
Seat 1: NFRtU1s5+WFh9EKwu+KLOQ (button) (small blind) showed [9h Ac] and lost with two pair, Aces and Nines
Seat 2: 4rrQUikeMSkuWGHgW80++w (big blind) showed [6c 6h] and won ($425.50) with three of a kind, Sixes



PokerStars Game #59940873230:  Hold'em No Limit ($1/$2) - 2009/07/01 1:19:05 ET
Table 'ztv6V3FN2bQ9nmJPPdx6nQ' 6-max Seat #1 is the button
Seat 1: 6fLdOUCRtX71xbVRhJEq8w ($218 in chips)
Seat 2: 5Y+ZGWLI4gnlpApDX5vy1A ($400.40 in chips)
Seat 3: ubtx4Z5L+AcK71MTvYiGVw ($200 in chips)
Seat 4: UaZ5yj+6LjtWqMQg2QskUw ($115.80 in chips)
Seat 5: sTPOWERd9HWPCNrDBwsVjA ($254 in chips)
Seat 6: mfy7uGZcqA2PVQqEVbJ7+g ($117.45 in chips)
5Y+ZGWLI4gnlpApDX5vy1A: posts small blind $1
ubtx4Z5L+AcK71MTvYiGVw: posts big blind $2
*** HOLE CARDS ***
UaZ5yj+6LjtWqMQg2QskUw: folds
sTPOWERd9HWPCNrDBwsVjA: folds
mfy7uGZcqA2PVQqEVbJ7+g: folds
6fLdOUCRtX71xbVRhJEq8w: folds
5Y+ZGWLI4gnlpApDX5vy1A: folds
ubtx4Z5L+AcK71MTvYiGVw collected $2 from pot
ubtx4Z5L+AcK71MTvYiGVw: doesn't show hand
*** SUMMARY ***
Total pot $2 | Rake $0
Seat 1: 6fLdOUCRtX71xbVRhJEq8w (button) folded before Flop (didn't bet)
Seat 2: 5Y+ZGWLI4gnlpApDX5vy1A (small blind) folded before Flop
Seat 3: ubtx4Z5L+AcK71MTvYiGVw (big blind) collected ($2)
Seat 4: UaZ5yj+6LjtWqMQg2QskUw folded before Flop (didn't bet)
Seat 5: sTPOWERd9HWPCNrDBwsVjA folded before Flop (didn't bet)
Seat 6: mfy7uGZcqA2PVQqEVbJ7+g folded before Flop (didn't bet)



PokerStars Game #59940874442:  Hold'em No Limit ($1/$2) - 2009/07/01 1:19:07 ET
Table 'C4lkCXY2PWy6z4vsAe5NGQ' 6-max Seat #1 is the button
Seat 1: 4bqvCfJ0e8CTYnn0Go9hbQ ($64.60 in chips)
Seat 2: 6hRJ68JkbJq6MYI9o5bUnQ ($42.40 in chips)
Seat 3: sTPOWERd9HWPCNrDBwsVjA ($218.35 in chips)
Seat 4: VvdR9F3I+2yELkfTVvC1dg ($200 in chips)
Seat 6: B87ikIyZ/TzAVeXf38Ny0g ($614.75 in chips)
6hRJ68JkbJq6MYI9o5bUnQ: posts small blind $1
sTPOWERd9HWPCNrDBwsVjA: posts big blind $2
*** HOLE CARDS ***
dKvrkfQx2Peke3ikZLUy1w said, "****kn idiot"
dKvrkfQx2Peke3ikZLUy1w said, "i hopef u dkn die"
VvdR9F3I+2yELkfTVvC1dg: raises $2 to $4
dKvrkfQx2Peke3ikZLUy1w said, "u piece of ****"
B87ikIyZ/TzAVeXf38Ny0g: folds
4bqvCfJ0e8CTYnn0Go9hbQ: folds
6hRJ68JkbJq6MYI9o5bUnQ: calls $3
sTPOWERd9HWPCNrDBwsVjA: calls $2
*** FLOP *** [3s 7d 9h]
6hRJ68JkbJq6MYI9o5bUnQ: checks
sTPOWERd9HWPCNrDBwsVjA: checks
VvdR9F3I+2yELkfTVvC1dg: bets $8.55
dKvrkfQx2Peke3ikZLUy1w said, "fkn arsehole"
6hRJ68JkbJq6MYI9o5bUnQ: folds
sTPOWERd9HWPCNrDBwsVjA: calls $8.55
*** TURN *** [3s 7d 9h] [Qd]
dKvrkfQx2Peke3ikZLUy1w said, "bloody donk"
dKvrkfQx2Peke3ikZLUy1w said, "u called 30"
dKvrkfQx2Peke3ikZLUy1w said, "wif 5 8"
dKvrkfQx2Peke3ikZLUy1w said, "u dumb****"
sTPOWERd9HWPCNrDBwsVjA: checks
VvdR9F3I+2yELkfTVvC1dg: checks
*** RIVER *** [3s 7d 9h Qd] [Ts]
sTPOWERd9HWPCNrDBwsVjA: bets $18
VvdR9F3I+2yELkfTVvC1dg: raises $23.20 to $41.20
dKvrkfQx2Peke3ikZLUy1w has returned
sTPOWERd9HWPCNrDBwsVjA: folds
VvdR9F3I+2yELkfTVvC1dg collected $63.10 from pot
VvdR9F3I+2yELkfTVvC1dg: doesn't show hand
*** SUMMARY ***
Total pot $65.10 | Rake $2
Board [3s 7d 9h Qd Ts]
Seat 1: 4bqvCfJ0e8CTYnn0Go9hbQ (button) folded before Flop (didn't bet)
Seat 2: 6hRJ68JkbJq6MYI9o5bUnQ (small blind) folded on the Flop
Seat 3: sTPOWERd9HWPCNrDBwsVjA (big blind) folded on the River
Seat 4: VvdR9F3I+2yELkfTVvC1dg collected ($63.10)
Seat 6: B87ikIyZ/TzAVeXf38Ny0g folded before Flop (didn't bet)



PokerStars Game #59940874364:  Hold'em No Limit ($1/$2) - 2009/07/01 1:19:07 ET
Table 'P/yCfYl1GfGsu/e6DxDy/A' 2-max Seat #1 is the button
Seat 1: 7fOCUy3x9hdkmXkkDNolGQ ($721 in chips)
Seat 2: RwDoM55ZeQuI2ADyJhOb2Q ($767.50 in chips)
7fOCUy3x9hdkmXkkDNolGQ: posts small blind $1
RwDoM55ZeQuI2ADyJhOb2Q: posts big blind $2
*** HOLE CARDS ***
7fOCUy3x9hdkmXkkDNolGQ: raises $4 to $6
RwDoM55ZeQuI2ADyJhOb2Q: folds
7fOCUy3x9hdkmXkkDNolGQ collected $4 from pot
7fOCUy3x9hdkmXkkDNolGQ: doesn't show hand
7fOCUy3x9hdkmXkkDNolGQ said, "brb"
*** SUMMARY ***
Total pot $4 | Rake $0
Seat 1: 7fOCUy3x9hdkmXkkDNolGQ (button) (small blind) collected ($4)
Seat 2: RwDoM55ZeQuI2ADyJhOb2Q (big blind) folded before Flop



PokerStars Game #59940874856:  Hold'em No Limit ($1/$2) - 2009/07/01 1:19:08 ET
Table 'aSf77Sj8QEnzcc0WaxVD4Q' 6-max Seat #2 is the button
Seat 1: UELtvp+JfwI7XDGVwSxZXA ($166.75 in chips)
Seat 2: vkfxu8f/jMYKUk6Ly4eujw ($200.80 in chips)
Seat 3: 9dpyyjDTCed6nV7JhaUUpw ($226.35 in chips)
Seat 4: YsLQ3BAvgQHWXMAv3Wv6Hg ($268.70 in chips)
Seat 5: VvdR9F3I+2yELkfTVvC1dg ($248 in chips)
Seat 6: vkoJRf3gidxY1pPi0AFWww ($92.55 in chips)
9dpyyjDTCed6nV7JhaUUpw: posts small blind $1
YsLQ3BAvgQHWXMAv3Wv6Hg: posts big blind $2
*** HOLE CARDS ***
VvdR9F3I+2yELkfTVvC1dg: folds
vkoJRf3gidxY1pPi0AFWww: calls $2
UELtvp+JfwI7XDGVwSxZXA: calls $2
vkfxu8f/jMYKUk6Ly4eujw: folds
9dpyyjDTCed6nV7JhaUUpw: folds
YsLQ3BAvgQHWXMAv3Wv6Hg: checks
*** FLOP *** [4h Ad Ac]
YsLQ3BAvgQHWXMAv3Wv6Hg: checks
vkoJRf3gidxY1pPi0AFWww: bets $4
UELtvp+JfwI7XDGVwSxZXA: folds
YsLQ3BAvgQHWXMAv3Wv6Hg: folds
vkoJRf3gidxY1pPi0AFWww collected $6.65 from pot
vkoJRf3gidxY1pPi0AFWww: doesn't show hand
*** SUMMARY ***
Total pot $7 | Rake $0.35
Board [4h Ad Ac]
Seat 1: UELtvp+JfwI7XDGVwSxZXA folded on the Flop
Seat 2: vkfxu8f/jMYKUk6Ly4eujw (button) folded before Flop (didn't bet)
Seat 3: 9dpyyjDTCed6nV7JhaUUpw (small blind) folded before Flop
Seat 4: YsLQ3BAvgQHWXMAv3Wv6Hg (big blind) folded on the Flop
Seat 5: VvdR9F3I+2yELkfTVvC1dg folded before Flop (didn't bet)
Seat 6: vkoJRf3gidxY1pPi0AFWww collected ($6.65)



PokerStars Game #59940875742:  Hold'em No Limit ($1/$2) - 2009/07/01 1:19:09 ET
Table 'TsEDkiO4tzCTCzJ7tNdEqw' 6-max Seat #6 is the button
Seat 1: MfXQsYD8pGeCS7XOtyV+vw ($48.90 in chips)
Seat 2: 4dcDwIHRm96PwtqkpQiuiA ($65.20 in chips)
Seat 3: wgRvjVPZSQvqNGiyR1jwSA ($78 in chips)
Seat 4: K8MXCrNAVYlMnnCeM32Kxw ($51.05 in chips)
Seat 5: VvdR9F3I+2yELkfTVvC1dg ($202.50 in chips)
Seat 6: uCqEjnxh2/vFBjKYkfTOkw ($259.25 in chips)
MfXQsYD8pGeCS7XOtyV+vw: posts small blind $1
4dcDwIHRm96PwtqkpQiuiA: posts big blind $2
*** HOLE CARDS ***
wgRvjVPZSQvqNGiyR1jwSA: folds
K8MXCrNAVYlMnnCeM32Kxw: folds
VvdR9F3I+2yELkfTVvC1dg: folds
uCqEjnxh2/vFBjKYkfTOkw: folds
MfXQsYD8pGeCS7XOtyV+vw: calls $1
4dcDwIHRm96PwtqkpQiuiA: raises $4 to $6
MfXQsYD8pGeCS7XOtyV+vw: calls $4
*** FLOP *** [7d Qd Ts]
MfXQsYD8pGeCS7XOtyV+vw: checks
4dcDwIHRm96PwtqkpQiuiA: bets $6
MfXQsYD8pGeCS7XOtyV+vw: calls $6
*** TURN *** [7d Qd Ts] [9d]
MfXQsYD8pGeCS7XOtyV+vw: checks
4dcDwIHRm96PwtqkpQiuiA: checks
*** RIVER *** [7d Qd Ts 9d] [7c]
MfXQsYD8pGeCS7XOtyV+vw: bets $10
4dcDwIHRm96PwtqkpQiuiA: calls $10
*** SHOW DOWN ***
MfXQsYD8pGeCS7XOtyV+vw: shows [9h Jc] (two pair, Nines and Sevens)
4dcDwIHRm96PwtqkpQiuiA: shows [Kc Qc] (two pair, Queens and Sevens)
4dcDwIHRm96PwtqkpQiuiA collected $41.90 from pot
*** SUMMARY ***
Total pot $44 | Rake $2.10
Board [7d Qd Ts 9d 7c]
Seat 1: MfXQsYD8pGeCS7XOtyV+vw (small blind) showed [9h Jc] and lost with two pair, Nines and Sevens
Seat 2: 4dcDwIHRm96PwtqkpQiuiA (big blind) showed [Kc Qc] and won ($41.90) with two pair, Queens and Sevens
Seat 3: wgRvjVPZSQvqNGiyR1jwSA folded before Flop (didn't bet)
Seat 4: K8MXCrNAVYlMnnCeM32Kxw folded before Flop (didn't bet)
Seat 5: VvdR9F3I+2yELkfTVvC1dg folded before Flop (didn't bet)
Seat 6: uCqEjnxh2/vFBjKYkfTOkw (button) folded before Flop (didn't bet)



PokerStars Game #59940875798:  Hold'em No Limit ($1/$2) - 2009/07/01 1:19:09 ET
Table 'eyAQSIlgc2o1Jxvbve4WGg' 9-max Seat #2 is the button
Seat 1: UZEsV9yKUMqmpYPiOFpaZw ($101.50 in chips)
Seat 2: g7gL2NLJCdZPPV399WKT1w ($64.65 in chips)
Seat 3: ice1Sbe19zWIaKYoSmE5tw ($94.30 in chips)
Seat 4: CkE3IyJF1KvdaAOmZY5XqQ ($200 in chips)
Seat 5: mIKx5lhIt13X5eZQH0ZeMA ($54.25 in chips)
Seat 6: rW/MyplHylMSBRaoRUzWrg ($50.80 in chips)
Seat 7: QHxJjpVYwitg9krW6wZgJA ($278.45 in chips)
Seat 8: 1CtiZuXDFaJL1dJPQKyi8Q ($197.35 in chips)
Seat 9: WUlHm+ydPPHG7Lb0rePSdA ($123.70 in chips)
ice1Sbe19zWIaKYoSmE5tw: posts small blind $1
CkE3IyJF1KvdaAOmZY5XqQ: posts big blind $2
*** HOLE CARDS ***
mIKx5lhIt13X5eZQH0ZeMA: raises $4 to $6
rW/MyplHylMSBRaoRUzWrg: folds
QHxJjpVYwitg9krW6wZgJA: folds
1CtiZuXDFaJL1dJPQKyi8Q: folds
WUlHm+ydPPHG7Lb0rePSdA: folds
UZEsV9yKUMqmpYPiOFpaZw: folds
g7gL2NLJCdZPPV399WKT1w: folds
ice1Sbe19zWIaKYoSmE5tw: folds
CkE3IyJF1KvdaAOmZY5XqQ: folds
mIKx5lhIt13X5eZQH0ZeMA collected $5 from pot
*** SUMMARY ***
Total pot $5 | Rake $0
Seat 1: UZEsV9yKUMqmpYPiOFpaZw folded before Flop (didn't bet)
Seat 2: g7gL2NLJCdZPPV399WKT1w (button) folded before Flop (didn't bet)
Seat 3: ice1Sbe19zWIaKYoSmE5tw (small blind) folded before Flop
Seat 4: CkE3IyJF1KvdaAOmZY5XqQ (big blind) folded before Flop
Seat 5: mIKx5lhIt13X5eZQH0ZeMA collected ($5)
Seat 6: rW/MyplHylMSBRaoRUzWrg folded before Flop (didn't bet)
Seat 7: QHxJjpVYwitg9krW6wZgJA folded before Flop (didn't bet)
Seat 8: 1CtiZuXDFaJL1dJPQKyi8Q folded before Flop (didn't bet)
Seat 9: WUlHm+ydPPHG7Lb0rePSdA folded before Flop (didn't bet)



PokerStars Game #59940876318:  Hold'em No Limit ($1/$2) - 2009/07/01 1:19:10 ET
Table 'rKeCh+eBn4RNvybCUYkoTQ' 9-max Seat #1 is the button
Seat 1: /inIs/z/PcX+TniIFpaxpg ($203 in chips)
Seat 2: 9cBHwK40Tl06vheE7B3LHQ ($143.25 in chips)
Seat 3: GX1heJ+DSsvm7gzSPsYhhQ ($40 in chips)
Seat 4: 31HuO+DQxppUQEedBWukug ($98.10 in chips)
Seat 5: WUlHm+ydPPHG7Lb0rePSdA ($120 in chips)
Seat 6: EBV6OktyeSmh4w6sWmcWOw ($270 in chips)
Seat 7: rW/MyplHylMSBRaoRUzWrg ($37 in chips)
Seat 8: pN/Ip0ePsUVIdUlGgLrkUw ($216.10 in chips)
Seat 9: Kzta8yu9vxHT4B70mjBZ+w ($211.25 in chips)
9cBHwK40Tl06vheE7B3LHQ: posts small blind $1
GX1heJ+DSsvm7gzSPsYhhQ: posts big blind $2
*** HOLE CARDS ***
31HuO+DQxppUQEedBWukug: folds
WUlHm+ydPPHG7Lb0rePSdA: folds
EBV6OktyeSmh4w6sWmcWOw: folds
rW/MyplHylMSBRaoRUzWrg: folds
pN/Ip0ePsUVIdUlGgLrkUw: raises $4 to $6
Kzta8yu9vxHT4B70mjBZ+w: folds
/inIs/z/PcX+TniIFpaxpg: folds
9cBHwK40Tl06vheE7B3LHQ: calls $5
GX1heJ+DSsvm7gzSPsYhhQ: folds
*** FLOP *** [4d Jc Jd]
9cBHwK40Tl06vheE7B3LHQ: checks
pN/Ip0ePsUVIdUlGgLrkUw: checks
*** TURN *** [4d Jc Jd] [3c]
9cBHwK40Tl06vheE7B3LHQ: bets $10
pN/Ip0ePsUVIdUlGgLrkUw: folds
9cBHwK40Tl06vheE7B3LHQ collected $13.30 from pot
9cBHwK40Tl06vheE7B3LHQ: doesn't show hand
*** SUMMARY ***
Total pot $14 | Rake $0.70
Board [4d Jc Jd 3c]
Seat 1: /inIs/z/PcX+TniIFpaxpg (button) folded before Flop (didn't bet)
Seat 2: 9cBHwK40Tl06vheE7B3LHQ (small blind) collected ($13.30)
Seat 3: GX1heJ+DSsvm7gzSPsYhhQ (big blind) folded before Flop
Seat 4: 31HuO+DQxppUQEedBWukug folded before Flop (didn't bet)
Seat 5: WUlHm+ydPPHG7Lb0rePSdA folded before Flop (didn't bet)
Seat 6: EBV6OktyeSmh4w6sWmcWOw folded before Flop (didn't bet)
Seat 7: rW/MyplHylMSBRaoRUzWrg folded before Flop (didn't bet)
Seat 8: pN/Ip0ePsUVIdUlGgLrkUw folded on the Turn
Seat 9: Kzta8yu9vxHT4B70mjBZ+w folded before Flop (didn't bet)



PokerStars Game #59940876454:  Hold'em No Limit ($1/$2) - 2009/07/01 1:19:10 ET
Table 'ZzSIe0zTCDv+n6hfbY5tTg' 6-max Seat #5 is the button
Seat 1: VvdR9F3I+2yELkfTVvC1dg ($212.10 in chips)
Seat 2: B87ikIyZ/TzAVeXf38Ny0g ($240 in chips)
Seat 3: gsugPj31Hui3Jefl98MBOA ($199 in chips)
Seat 4: qXDd0ZyMIse0OBu8pxeQ3Q ($200 in chips)
Seat 5: 3dAbvkxS5NPQTBAbvpinVg ($496.30 in chips)
Seat 6: 09BNF4quPDzanQzM8vc6WA ($26.50 in chips)
09BNF4quPDzanQzM8vc6WA: posts small blind $1
VvdR9F3I+2yELkfTVvC1dg: posts big blind $2
*** HOLE CARDS ***
B87ikIyZ/TzAVeXf38Ny0g: folds
gsugPj31Hui3Jefl98MBOA: folds
qXDd0ZyMIse0OBu8pxeQ3Q: folds
3dAbvkxS5NPQTBAbvpinVg: folds
09BNF4quPDzanQzM8vc6WA: raises $2 to $4
VvdR9F3I+2yELkfTVvC1dg: raises $208.10 to $212.10 and is all-in
09BNF4quPDzanQzM8vc6WA: folds
VvdR9F3I+2yELkfTVvC1dg collected $8 from pot
VvdR9F3I+2yELkfTVvC1dg: doesn't show hand
*** SUMMARY ***
Total pot $8 | Rake $0
Seat 1: VvdR9F3I+2yELkfTVvC1dg (big blind) collected ($8)
Seat 2: B87ikIyZ/TzAVeXf38Ny0g folded before Flop (didn't bet)
Seat 3: gsugPj31Hui3Jefl98MBOA folded before Flop (didn't bet)
Seat 4: qXDd0ZyMIse0OBu8pxeQ3Q folded before Flop (didn't bet)
Seat 5: 3dAbvkxS5NPQTBAbvpinVg (button) folded before Flop (didn't bet)
Seat 6: 09BNF4quPDzanQzM8vc6WA (small blind) folded before Flop



PokerStars Game #59940876002:  Hold'em No Limit ($1/$2) - 2009/07/01 1:19:10 ET
Table 'pPQgcj9XT9CHBsbo1WTBug' 6-max Seat #5 is the button
Seat 1: DFVYDA6dKQy7R7mGIKogZA ($121.75 in chips)
Seat 2: qXDd0ZyMIse0OBu8pxeQ3Q ($209.95 in chips)
Seat 4: gqlysXCbT8V54f/1lf9h3A ($42 in chips)
Seat 5: vkfxu8f/jMYKUk6Ly4eujw ($226.10 in chips)
Seat 6: Yr7pZltpy3IUNdKS9PCEiw ($314.30 in chips)
Yr7pZltpy3IUNdKS9PCEiw: posts small blind $1
DFVYDA6dKQy7R7mGIKogZA: posts big blind $2
*** HOLE CARDS ***
qXDd0ZyMIse0OBu8pxeQ3Q: folds
WfaZs12BkYO+BUX5VWpuWQ leaves the table
gqlysXCbT8V54f/1lf9h3A: calls $2
vkfxu8f/jMYKUk6Ly4eujw: folds
Yr7pZltpy3IUNdKS9PCEiw: folds
DFVYDA6dKQy7R7mGIKogZA: checks
*** FLOP *** [5h 9d Td]
DFVYDA6dKQy7R7mGIKogZA: checks
gqlysXCbT8V54f/1lf9h3A: bets $4
DFVYDA6dKQy7R7mGIKogZA: folds
gqlysXCbT8V54f/1lf9h3A collected $4.75 from pot
gqlysXCbT8V54f/1lf9h3A: doesn't show hand
*** SUMMARY ***
Total pot $5 | Rake $0.25
Board [5h 9d Td]
Seat 1: DFVYDA6dKQy7R7mGIKogZA (big blind) folded on the Flop
Seat 2: qXDd0ZyMIse0OBu8pxeQ3Q folded before Flop (didn't bet)
Seat 4: gqlysXCbT8V54f/1lf9h3A collected ($4.75)
Seat 5: vkfxu8f/jMYKUk6Ly4eujw (button) folded before Flop (didn't bet)
Seat 6: Yr7pZltpy3IUNdKS9PCEiw (small blind) folded before Flop



PokerStars Game #59940876922:  Hold'em No Limit ($1/$2) - 2009/07/01 1:19:11 ET
Table 'bJQ024BaYSBrW0sXpCZbNQ' 6-max Seat #3 is the button
Seat 1: PCN5rt4TwI1pQE+rAiqI0Q ($283.60 in chips)
Seat 2: 3dAbvkxS5NPQTBAbvpinVg ($203 in chips)
Seat 3: vkfxu8f/jMYKUk6Ly4eujw ($230.10 in chips)
Seat 5: VvdR9F3I+2yELkfTVvC1dg ($200 in chips)
Seat 6: 9dpyyjDTCed6nV7JhaUUpw ($327.95 in chips)
VvdR9F3I+2yELkfTVvC1dg: posts small blind $1
9dpyyjDTCed6nV7JhaUUpw: posts big blind $2
*** HOLE CARDS ***
PCN5rt4TwI1pQE+rAiqI0Q: folds
3dAbvkxS5NPQTBAbvpinVg: raises $4 to $6
vkfxu8f/jMYKUk6Ly4eujw: calls $6
VvdR9F3I+2yELkfTVvC1dg: folds
9dpyyjDTCed6nV7JhaUUpw: raises $20 to $26
3dAbvkxS5NPQTBAbvpinVg: folds
vkfxu8f/jMYKUk6Ly4eujw: folds
9dpyyjDTCed6nV7JhaUUpw collected $19 from pot
9dpyyjDTCed6nV7JhaUUpw: doesn't show hand
*** SUMMARY ***
Total pot $19 | Rake $0
Seat 1: PCN5rt4TwI1pQE+rAiqI0Q folded before Flop (didn't bet)
Seat 2: 3dAbvkxS5NPQTBAbvpinVg folded before Flop
Seat 3: vkfxu8f/jMYKUk6Ly4eujw (button) folded before Flop
Seat 5: VvdR9F3I+2yELkfTVvC1dg (small blind) folded before Flop
Seat 6: 9dpyyjDTCed6nV7JhaUUpw (big blind) collected ($19)



PokerStars Game #59940877548:  Hold'em No Limit ($1/$2) - 2009/07/01 1:19:12 ET
Table 'NmY84NAf9Mh0ckAckHnh5g' 2-max Seat #2 is the button
Seat 1: 6hvg964TSqZ3AL/0XK9aVQ ($257.60 in chips)
Seat 2: RwDoM55ZeQuI2ADyJhOb2Q ($752.40 in chips)
RwDoM55ZeQuI2ADyJhOb2Q: posts small blind $1
6hvg964TSqZ3AL/0XK9aVQ: posts big blind $2
*** HOLE CARDS ***
RwDoM55ZeQuI2ADyJhOb2Q: folds
6hvg964TSqZ3AL/0XK9aVQ collected $2 from pot
6hvg964TSqZ3AL/0XK9aVQ: doesn't show hand
*** SUMMARY ***
Total pot $2 | Rake $0
Seat 1: 6hvg964TSqZ3AL/0XK9aVQ (big blind) collected ($2)
Seat 2: RwDoM55ZeQuI2ADyJhOb2Q (button) (small blind) folded before Flop



PokerStars Game #59940878158:  Hold'em No Limit ($1/$2) - 2009/07/01 1:19:13 ET
Table 'YqGfR5eHfMeSjb9a+QU9rg' 9-max Seat #5 is the button
Seat 1: rW/MyplHylMSBRaoRUzWrg ($37 in chips)
Seat 2: W3Nqt1GWlTi9tXQXMNEvgw ($382.70 in chips)
Seat 3: /gll27k+xWYV7Fbki0lFDQ ($268.10 in chips)
Seat 4: QHxJjpVYwitg9krW6wZgJA ($217.30 in chips)
Seat 5: CkE3IyJF1KvdaAOmZY5XqQ ($200 in chips)
Seat 6: TAfo4veNRaRlzDXMMYS3Jg ($38 in chips)
Seat 7: 41aZuLBz9nAi2GPVKabmCw ($97.75 in chips)
Seat 8: JnV3SM2D6dAFYyGZHHpvrg ($98.55 in chips)
Seat 9: /inIs/z/PcX+TniIFpaxpg ($206.05 in chips)
TAfo4veNRaRlzDXMMYS3Jg: posts small blind $1
41aZuLBz9nAi2GPVKabmCw: posts big blind $2
*** HOLE CARDS ***
JnV3SM2D6dAFYyGZHHpvrg: folds
/inIs/z/PcX+TniIFpaxpg: folds
rW/MyplHylMSBRaoRUzWrg: folds
W3Nqt1GWlTi9tXQXMNEvgw: calls $2
/gll27k+xWYV7Fbki0lFDQ: folds
QHxJjpVYwitg9krW6wZgJA: folds
CkE3IyJF1KvdaAOmZY5XqQ: folds
TAfo4veNRaRlzDXMMYS3Jg: folds
41aZuLBz9nAi2GPVKabmCw: checks
*** FLOP *** [6c 5s 2h]
41aZuLBz9nAi2GPVKabmCw: checks
W3Nqt1GWlTi9tXQXMNEvgw: checks
*** TURN *** [6c 5s 2h] [Td]
41aZuLBz9nAi2GPVKabmCw: bets $4
W3Nqt1GWlTi9tXQXMNEvgw: folds
41aZuLBz9nAi2GPVKabmCw collected $4.75 from pot
*** SUMMARY ***
Total pot $5 | Rake $0.25
Board [6c 5s 2h Td]
Seat 1: rW/MyplHylMSBRaoRUzWrg folded before Flop (didn't bet)
Seat 2: W3Nqt1GWlTi9tXQXMNEvgw folded on the Turn
Seat 3: /gll27k+xWYV7Fbki0lFDQ folded before Flop (didn't bet)
Seat 4: QHxJjpVYwitg9krW6wZgJA folded before Flop (didn't bet)
Seat 5: CkE3IyJF1KvdaAOmZY5XqQ (button) folded before Flop (didn't bet)
Seat 6: TAfo4veNRaRlzDXMMYS3Jg (small blind) folded before Flop
Seat 7: 41aZuLBz9nAi2GPVKabmCw (big blind) collected ($4.75)
Seat 8: JnV3SM2D6dAFYyGZHHpvrg folded before Flop (didn't bet)
Seat 9: /inIs/z/PcX+TniIFpaxpg folded before Flop (didn't bet)



PokerStars Game #59940878286:  Hold'em No Limit ($1/$2) - 2009/07/01 1:19:14 ET
Table 'P/yCfYl1GfGsu/e6DxDy/A' 2-max Seat #2 is the button
Seat 1: 7fOCUy3x9hdkmXkkDNolGQ ($723 in chips)
Seat 2: RwDoM55ZeQuI2ADyJhOb2Q ($765.50 in chips)
RwDoM55ZeQuI2ADyJhOb2Q: posts small blind $1
7fOCUy3x9hdkmXkkDNolGQ: posts big blind $2
*** HOLE CARDS ***
RwDoM55ZeQuI2ADyJhOb2Q: raises $4 to $6
7fOCUy3x9hdkmXkkDNolGQ: folds
RwDoM55ZeQuI2ADyJhOb2Q collected $4 from pot
RwDoM55ZeQuI2ADyJhOb2Q: doesn't show hand
*** SUMMARY ***
Total pot $4 | Rake $0
Seat 1: 7fOCUy3x9hdkmXkkDNolGQ (big blind) folded before Flop
Seat 2: RwDoM55ZeQuI2ADyJhOb2Q (button) (small blind) collected ($4)



PokerStars Game #59940879170:  Hold'em No Limit ($1/$2) - 2009/07/01 1:19:15 ET
Table 'rsKRKlGHlxVyqJxzO2a2Ow' 9-max Seat #3 is the button
Seat 1: uYWfQJg2hgHLxri6/uVJiw ($347.20 in chips)
Seat 2: QHxJjpVYwitg9krW6wZgJA ($261.80 in chips)
Seat 3: zTcFtoHqqK4550YMZ8Y14Q ($60.50 in chips)
Seat 4: 31HuO+DQxppUQEedBWukug ($98 in chips)
Seat 5: 5Q8U6iZbeO7xJSS4qvDP5g ($200 in chips)
Seat 6: H6Z4+qu8gR0VUiPOijndVg ($200 in chips)
Seat 8: CkE3IyJF1KvdaAOmZY5XqQ ($220.75 in chips)
Seat 9: gRbvhSUVg+TNaTjaJecIRw ($72 in chips)
31HuO+DQxppUQEedBWukug: posts small blind $1
5Q8U6iZbeO7xJSS4qvDP5g: posts big blind $2
*** HOLE CARDS ***
H6Z4+qu8gR0VUiPOijndVg: folds
CkE3IyJF1KvdaAOmZY5XqQ: folds
gRbvhSUVg+TNaTjaJecIRw: folds
uYWfQJg2hgHLxri6/uVJiw: folds
QHxJjpVYwitg9krW6wZgJA: raises $2 to $4
zTcFtoHqqK4550YMZ8Y14Q: folds
31HuO+DQxppUQEedBWukug: calls $3
5Q8U6iZbeO7xJSS4qvDP5g: folds
*** FLOP *** [Ks 4d Qh]
GX1heJ+DSsvm7gzSPsYhhQ joins the table at seat #7
31HuO+DQxppUQEedBWukug: checks
QHxJjpVYwitg9krW6wZgJA: bets $7
31HuO+DQxppUQEedBWukug: folds
QHxJjpVYwitg9krW6wZgJA collected $9.50 from pot
QHxJjpVYwitg9krW6wZgJA: doesn't show hand
*** SUMMARY ***
Total pot $10 | Rake $0.50
Board [Ks 4d Qh]
Seat 1: uYWfQJg2hgHLxri6/uVJiw folded before Flop (didn't bet)
Seat 2: QHxJjpVYwitg9krW6wZgJA collected ($9.50)
Seat 3: zTcFtoHqqK4550YMZ8Y14Q (button) folded before Flop (didn't bet)
Seat 4: 31HuO+DQxppUQEedBWukug (small blind) folded on the Flop
Seat 5: 5Q8U6iZbeO7xJSS4qvDP5g (big blind) folded before Flop
Seat 6: H6Z4+qu8gR0VUiPOijndVg folded before Flop (didn't bet)
Seat 8: CkE3IyJF1KvdaAOmZY5XqQ folded before Flop (didn't bet)
Seat 9: gRbvhSUVg+TNaTjaJecIRw folded before Flop (didn't bet)



PokerStars Game #59940880318:  Hold'em No Limit ($1/$2) - 2009/07/01 1:19:17 ET
Table 'kq5zaQ+1hLNf8LZfGnbTAA' 6-max Seat #5 is the button
Seat 1: 8srN1dKQePlsv0GyTada+Q ($228 in chips)
Seat 2: nXDI8Y/S6POzRwANu3d8hQ ($41.75 in chips)
Seat 3: vkfxu8f/jMYKUk6Ly4eujw ($227.95 in chips)
Seat 4: 3dAbvkxS5NPQTBAbvpinVg ($200 in chips)
Seat 5: kfASJqTbXek+zc8ZKsZL1Q ($152.40 in chips)
Seat 6: mfy7uGZcqA2PVQqEVbJ7+g ($200.25 in chips)
mfy7uGZcqA2PVQqEVbJ7+g: posts small blind $1
8srN1dKQePlsv0GyTada+Q: posts big blind $2
*** HOLE CARDS ***
nXDI8Y/S6POzRwANu3d8hQ: folds
vkfxu8f/jMYKUk6Ly4eujw: raises $6 to $8
3dAbvkxS5NPQTBAbvpinVg: folds
kfASJqTbXek+zc8ZKsZL1Q: folds
mfy7uGZcqA2PVQqEVbJ7+g: folds
8srN1dKQePlsv0GyTada+Q: folds
vkfxu8f/jMYKUk6Ly4eujw collected $5 from pot
vkfxu8f/jMYKUk6Ly4eujw: doesn't show hand
*** SUMMARY ***
Total pot $5 | Rake $0
Seat 1: 8srN1dKQePlsv0GyTada+Q (big blind) folded before Flop
Seat 2: nXDI8Y/S6POzRwANu3d8hQ folded before Flop (didn't bet)
Seat 3: vkfxu8f/jMYKUk6Ly4eujw collected ($5)
Seat 4: 3dAbvkxS5NPQTBAbvpinVg folded before Flop (didn't bet)
Seat 5: kfASJqTbXek+zc8ZKsZL1Q (button) folded before Flop (didn't bet)
Seat 6: mfy7uGZcqA2PVQqEVbJ7+g (small blind) folded before Flop



PokerStars Game #59940881458:  Hold'em No Limit ($1/$2) - 2009/07/01 1:19:19 ET
Table 'SF49/KQm8T4taMp6kb+HXA' 9-max Seat #7 is the button
Seat 1: CUZwDpLTQKhzarPe+JCLOQ ($200 in chips)
Seat 2: rW/MyplHylMSBRaoRUzWrg ($36 in chips)
Seat 3: pCmk6FpSOLJ+85o1tLHIag ($283.75 in chips)
Seat 4: HffgoYm61KgkdMe/DYChIQ ($223.50 in chips)
Seat 5: ri8CLkX3e9JF34dQNbsHGA ($40 in chips)
Seat 6: 31HuO+DQxppUQEedBWukug ($303.95 in chips)
Seat 7: n2VAbLaE5qgKr5mA4W6v4w ($115 in chips)
Seat 8: GgrYze3jkUdSO7a7CuJGDw ($177 in chips)
Seat 9: /inIs/z/PcX+TniIFpaxpg ($326.15 in chips)
GgrYze3jkUdSO7a7CuJGDw: posts small blind $1
/inIs/z/PcX+TniIFpaxpg: posts big blind $2
*** HOLE CARDS ***
CUZwDpLTQKhzarPe+JCLOQ: folds
rW/MyplHylMSBRaoRUzWrg: raises $6 to $8
pCmk6FpSOLJ+85o1tLHIag: folds
HffgoYm61KgkdMe/DYChIQ: folds
ri8CLkX3e9JF34dQNbsHGA: folds
31HuO+DQxppUQEedBWukug: folds
n2VAbLaE5qgKr5mA4W6v4w: folds
GgrYze3jkUdSO7a7CuJGDw: folds
/inIs/z/PcX+TniIFpaxpg: folds
rW/MyplHylMSBRaoRUzWrg collected $5 from pot
*** SUMMARY ***
Total pot $5 | Rake $0
Seat 1: CUZwDpLTQKhzarPe+JCLOQ folded before Flop (didn't bet)
Seat 2: rW/MyplHylMSBRaoRUzWrg collected ($5)
Seat 3: pCmk6FpSOLJ+85o1tLHIag folded before Flop (didn't bet)
Seat 4: HffgoYm61KgkdMe/DYChIQ folded before Flop (didn't bet)
Seat 5: ri8CLkX3e9JF34dQNbsHGA folded before Flop (didn't bet)
Seat 6: 31HuO+DQxppUQEedBWukug folded before Flop (didn't bet)
Seat 7: n2VAbLaE5qgKr5mA4W6v4w (button) folded before Flop (didn't bet)
Seat 8: GgrYze3jkUdSO7a7CuJGDw (small blind) folded before Flop
Seat 9: /inIs/z/PcX+TniIFpaxpg (big blind) folded before Flop



PokerStars Game #59940881054:  Hold'em No Limit ($1/$2) - 2009/07/01 1:19:19 ET
Table 'NmY84NAf9Mh0ckAckHnh5g' 2-max Seat #1 is the button
Seat 1: 6hvg964TSqZ3AL/0XK9aVQ ($258.60 in chips)
Seat 2: RwDoM55ZeQuI2ADyJhOb2Q ($751.40 in chips)
6hvg964TSqZ3AL/0XK9aVQ: posts small blind $1
RwDoM55ZeQuI2ADyJhOb2Q: posts big blind $2
*** HOLE CARDS ***
6hvg964TSqZ3AL/0XK9aVQ: folds
RwDoM55ZeQuI2ADyJhOb2Q collected $2 from pot
RwDoM55ZeQuI2ADyJhOb2Q: doesn't show hand
*** SUMMARY ***
Total pot $2 | Rake $0
Seat 1: 6hvg964TSqZ3AL/0XK9aVQ (button) (small blind) folded before Flop
Seat 2: RwDoM55ZeQuI2ADyJhOb2Q (big blind) collected ($2)



PokerStars Game #59940881728:  Hold'em No Limit ($1/$2) - 2009/07/01 1:19:20 ET
Table 'ztv6V3FN2bQ9nmJPPdx6nQ' 6-max Seat #2 is the button
Seat 1: 6fLdOUCRtX71xbVRhJEq8w ($218 in chips)
Seat 2: 5Y+ZGWLI4gnlpApDX5vy1A ($399.40 in chips)
Seat 3: ubtx4Z5L+AcK71MTvYiGVw ($201 in chips)
Seat 4: UaZ5yj+6LjtWqMQg2QskUw ($115.80 in chips)
Seat 5: sTPOWERd9HWPCNrDBwsVjA ($254 in chips)
Seat 6: mfy7uGZcqA2PVQqEVbJ7+g ($117.45 in chips)
ubtx4Z5L+AcK71MTvYiGVw: posts small blind $1
UaZ5yj+6LjtWqMQg2QskUw: posts big blind $2
*** HOLE CARDS ***
sTPOWERd9HWPCNrDBwsVjA: folds
mfy7uGZcqA2PVQqEVbJ7+g: folds
6fLdOUCRtX71xbVRhJEq8w: folds
5Y+ZGWLI4gnlpApDX5vy1A: folds
ubtx4Z5L+AcK71MTvYiGVw: folds
UaZ5yj+6LjtWqMQg2QskUw collected $2 from pot
*** SUMMARY ***
Total pot $2 | Rake $0
Seat 1: 6fLdOUCRtX71xbVRhJEq8w folded before Flop (didn't bet)
Seat 2: 5Y+ZGWLI4gnlpApDX5vy1A (button) folded before Flop (didn't bet)
Seat 3: ubtx4Z5L+AcK71MTvYiGVw (small blind) folded before Flop
Seat 4: UaZ5yj+6LjtWqMQg2QskUw (big blind) collected ($2)
Seat 5: sTPOWERd9HWPCNrDBwsVjA folded before Flop (didn't bet)
Seat 6: mfy7uGZcqA2PVQqEVbJ7+g folded before Flop (didn't bet)



PokerStars Game #59940883192:  Hold'em No Limit ($1/$2) - 2009/07/01 1:19:22 ET
Table '3WCXyaiCAbqSShQu7FIjvA' 9-max Seat #3 is the button
Seat 1: kTCkABD1UUldS9DFRGfCwQ ($151.60 in chips)
Seat 2: 1zQMh8lHgW3t2YhVeA+09A ($14.80 in chips)
Seat 3: 5Q8U6iZbeO7xJSS4qvDP5g ($200 in chips)
Seat 4: waEF/+pxZTxNo4FvsORuXg ($78 in chips)
Seat 5: CkE3IyJF1KvdaAOmZY5XqQ ($200 in chips)
Seat 6: 5jQlngvMSqM/WoonOcR5kw ($314.35 in chips)
Seat 7: QHxJjpVYwitg9krW6wZgJA ($200 in chips)
Seat 8: 1CtiZuXDFaJL1dJPQKyi8Q ($234.25 in chips)
Seat 9: FiXPLJyqb24l32QST2TInw ($110.55 in chips)
waEF/+pxZTxNo4FvsORuXg: posts small blind $1
CkE3IyJF1KvdaAOmZY5XqQ: posts big blind $2
*** HOLE CARDS ***
5jQlngvMSqM/WoonOcR5kw: calls $2
QHxJjpVYwitg9krW6wZgJA: raises $8 to $10
1CtiZuXDFaJL1dJPQKyi8Q: folds
FiXPLJyqb24l32QST2TInw: calls $10
kTCkABD1UUldS9DFRGfCwQ: folds
1zQMh8lHgW3t2YhVeA+09A: folds
5Q8U6iZbeO7xJSS4qvDP5g: folds
waEF/+pxZTxNo4FvsORuXg: folds
CkE3IyJF1KvdaAOmZY5XqQ: calls $8
5jQlngvMSqM/WoonOcR5kw: calls $8
*** FLOP *** [Jd 3c Jc]
CkE3IyJF1KvdaAOmZY5XqQ: checks
5jQlngvMSqM/WoonOcR5kw: checks
QHxJjpVYwitg9krW6wZgJA: checks
FiXPLJyqb24l32QST2TInw: bets $8
CkE3IyJF1KvdaAOmZY5XqQ: folds
5jQlngvMSqM/WoonOcR5kw: folds
QHxJjpVYwitg9krW6wZgJA: calls $8
*** TURN *** [Jd 3c Jc] [Qc]
QHxJjpVYwitg9krW6wZgJA: bets $5
FiXPLJyqb24l32QST2TInw: calls $5
*** RIVER *** [Jd 3c Jc Qc] [Qd]
QHxJjpVYwitg9krW6wZgJA: checks
FiXPLJyqb24l32QST2TInw: checks
*** SHOW DOWN ***
QHxJjpVYwitg9krW6wZgJA: shows [8h 8s] (two pair, Queens and Jacks)
FiXPLJyqb24l32QST2TInw: shows [9h 9c] (two pair, Queens and Jacks - Nine kicker)
FiXPLJyqb24l32QST2TInw collected $64 from pot
*** SUMMARY ***
Total pot $67 | Rake $3
Board [Jd 3c Jc Qc Qd]
Seat 1: kTCkABD1UUldS9DFRGfCwQ folded before Flop (didn't bet)
Seat 2: 1zQMh8lHgW3t2YhVeA+09A folded before Flop (didn't bet)
Seat 3: 5Q8U6iZbeO7xJSS4qvDP5g (button) folded before Flop (didn't bet)
Seat 4: waEF/+pxZTxNo4FvsORuXg (small blind) folded before Flop
Seat 5: CkE3IyJF1KvdaAOmZY5XqQ (big blind) folded on the Flop
Seat 6: 5jQlngvMSqM/WoonOcR5kw folded on the Flop
Seat 7: QHxJjpVYwitg9krW6wZgJA showed [8h 8s] and lost with two pair, Queens and Jacks
Seat 8: 1CtiZuXDFaJL1dJPQKyi8Q folded before Flop (didn't bet)
Seat 9: FiXPLJyqb24l32QST2TInw showed [9h 9c] and won ($64) with two pair, Queens and Jacks



PokerStars Game #59940884298:  Hold'em No Limit ($1/$2) - 2009/07/01 1:19:24 ET
Table 'NmY84NAf9Mh0ckAckHnh5g' 2-max Seat #2 is the button
Seat 1: 6hvg964TSqZ3AL/0XK9aVQ ($257.60 in chips)
Seat 2: RwDoM55ZeQuI2ADyJhOb2Q ($752.40 in chips)
RwDoM55ZeQuI2ADyJhOb2Q: posts small blind $1
6hvg964TSqZ3AL/0XK9aVQ: posts big blind $2
*** HOLE CARDS ***
RwDoM55ZeQuI2ADyJhOb2Q: folds
6hvg964TSqZ3AL/0XK9aVQ collected $2 from pot
6hvg964TSqZ3AL/0XK9aVQ: doesn't show hand
*** SUMMARY ***
Total pot $2 | Rake $0
Seat 1: 6hvg964TSqZ3AL/0XK9aVQ (big blind) collected ($2)
Seat 2: RwDoM55ZeQuI2ADyJhOb2Q (button) (small blind) folded before Flop



PokerStars Game #59940885682:  Hold'em No Limit ($1/$2) - 2009/07/01 1:19:27 ET
Table '/dyk+YdRGv90j2box35j8w' 6-max Seat #2 is the button
Seat 2: qCnEYuAE5y5A7bk6fO5/jQ ($499.60 in chips)
Seat 3: sTPOWERd9HWPCNrDBwsVjA ($229.50 in chips)
Seat 4: z/u1YTnkiIDrtp/2cA2dBg ($125.65 in chips)
Seat 5: VvdR9F3I+2yELkfTVvC1dg ($200 in chips)
Seat 6: ZwvXzkkZ3XpMhKfAmVpahw ($356.25 in chips)
sTPOWERd9HWPCNrDBwsVjA: posts small blind $1
z/u1YTnkiIDrtp/2cA2dBg: posts big blind $2
8srN1dKQePlsv0GyTada+Q: sits out
*** HOLE CARDS ***
VvdR9F3I+2yELkfTVvC1dg: folds
ZwvXzkkZ3XpMhKfAmVpahw: folds
qCnEYuAE5y5A7bk6fO5/jQ: raises $4 to $6
sTPOWERd9HWPCNrDBwsVjA: raises $18 to $24
z/u1YTnkiIDrtp/2cA2dBg: folds
qCnEYuAE5y5A7bk6fO5/jQ: folds
sTPOWERd9HWPCNrDBwsVjA collected $14 from pot
*** SUMMARY ***
Total pot $14 | Rake $0
Seat 2: qCnEYuAE5y5A7bk6fO5/jQ (button) folded before Flop
Seat 3: sTPOWERd9HWPCNrDBwsVjA (small blind) collected ($14)
Seat 4: z/u1YTnkiIDrtp/2cA2dBg (big blind) folded before Flop
Seat 5: VvdR9F3I+2yELkfTVvC1dg folded before Flop (didn't bet)
Seat 6: ZwvXzkkZ3XpMhKfAmVpahw folded before Flop (didn't bet)



PokerStars Game #59940887928:  Hold'em No Limit ($1/$2) - 2009/07/01 1:19:31 ET
Table 'NmY84NAf9Mh0ckAckHnh5g' 2-max Seat #1 is the button
Seat 1: 6hvg964TSqZ3AL/0XK9aVQ ($258.60 in chips)
Seat 2: RwDoM55ZeQuI2ADyJhOb2Q ($751.40 in chips)
6hvg964TSqZ3AL/0XK9aVQ: posts small blind $1
RwDoM55ZeQuI2ADyJhOb2Q: posts big blind $2
*** HOLE CARDS ***
6hvg964TSqZ3AL/0XK9aVQ: folds
RwDoM55ZeQuI2ADyJhOb2Q collected $2 from pot
RwDoM55ZeQuI2ADyJhOb2Q: doesn't show hand
*** SUMMARY ***
Total pot $2 | Rake $0
Seat 1: 6hvg964TSqZ3AL/0XK9aVQ (button) (small blind) folded before Flop
Seat 2: RwDoM55ZeQuI2ADyJhOb2Q (big blind) collected ($2)



PokerStars Game #59940890582:  Hold'em No Limit ($1/$2) - 2009/07/01 1:19:35 ET
Table 'BSRfGh+QobUe0AgIMtt/fw' 9-max Seat #7 is the button
Seat 1: gDn/rYeNwCyWEgRhyWp4PA ($147.95 in chips)
Seat 2: TAfo4veNRaRlzDXMMYS3Jg ($49 in chips)
Seat 3: WUlHm+ydPPHG7Lb0rePSdA ($121 in chips)
Seat 6: H6Z4+qu8gR0VUiPOijndVg ($237.55 in chips)
Seat 7: CkE3IyJF1KvdaAOmZY5XqQ ($201.15 in chips)
Seat 8: /XRRUMKiOOItJFbrM26RrA ($101.55 in chips)
Seat 9: /inIs/z/PcX+TniIFpaxpg ($202.60 in chips)
/XRRUMKiOOItJFbrM26RrA: posts small blind $1
/inIs/z/PcX+TniIFpaxpg: posts big blind $2
MrNegroni: sits out
GX1heJ+DSsvm7gzSPsYhhQ: sits out
*** HOLE CARDS ***
gDn/rYeNwCyWEgRhyWp4PA: folds
TAfo4veNRaRlzDXMMYS3Jg: folds
WUlHm+ydPPHG7Lb0rePSdA: folds
H6Z4+qu8gR0VUiPOijndVg: raises $4 to $6
CkE3IyJF1KvdaAOmZY5XqQ: folds
/XRRUMKiOOItJFbrM26RrA: folds
/inIs/z/PcX+TniIFpaxpg: calls $4
*** FLOP *** [9c Ac 6c]
/inIs/z/PcX+TniIFpaxpg: checks
H6Z4+qu8gR0VUiPOijndVg: bets $8
/inIs/z/PcX+TniIFpaxpg: calls $8
*** TURN *** [9c Ac 6c] [8h]
/inIs/z/PcX+TniIFpaxpg: checks
H6Z4+qu8gR0VUiPOijndVg: bets $20
/inIs/z/PcX+TniIFpaxpg: raises $30 to $50
H6Z4+qu8gR0VUiPOijndVg: raises $156 to $206
/inIs/z/PcX+TniIFpaxpg: calls $138.60 and is all-in
*** RIVER *** [9c Ac 6c 8h] [8d]
*** SHOW DOWN ***
/inIs/z/PcX+TniIFpaxpg: shows [Qc Kc] (a flush, Ace high)
H6Z4+qu8gR0VUiPOijndVg: mucks hand
/inIs/z/PcX+TniIFpaxpg collected $403.20 from pot
*** SUMMARY ***
Total pot $406.20 | Rake $3
Board [9c Ac 6c 8h 8d]
Seat 1: gDn/rYeNwCyWEgRhyWp4PA folded before Flop (didn't bet)
Seat 2: TAfo4veNRaRlzDXMMYS3Jg folded before Flop (didn't bet)
Seat 3: WUlHm+ydPPHG7Lb0rePSdA folded before Flop (didn't bet)
Seat 6: H6Z4+qu8gR0VUiPOijndVg mucked
Seat 7: CkE3IyJF1KvdaAOmZY5XqQ (button) folded before Flop (didn't bet)
Seat 8: /XRRUMKiOOItJFbrM26RrA (small blind) folded before Flop
Seat 9: /inIs/z/PcX+TniIFpaxpg (big blind) showed [Qc Kc] and won ($403.20) with a flush, Ace high



PokerStars Game #59940890164:  Hold'em No Limit ($1/$2) - 2009/07/01 1:19:35 ET
Table 'ztv6V3FN2bQ9nmJPPdx6nQ' 6-max Seat #3 is the button
Seat 1: 6fLdOUCRtX71xbVRhJEq8w ($218 in chips)
Seat 2: 5Y+ZGWLI4gnlpApDX5vy1A ($399.40 in chips)
Seat 3: ubtx4Z5L+AcK71MTvYiGVw ($200 in chips)
Seat 4: UaZ5yj+6LjtWqMQg2QskUw ($116.80 in chips)
Seat 5: sTPOWERd9HWPCNrDBwsVjA ($254 in chips)
Seat 6: mfy7uGZcqA2PVQqEVbJ7+g ($117.45 in chips)
UaZ5yj+6LjtWqMQg2QskUw: posts small blind $1
sTPOWERd9HWPCNrDBwsVjA: posts big blind $2
*** HOLE CARDS ***
mfy7uGZcqA2PVQqEVbJ7+g: folds
6fLdOUCRtX71xbVRhJEq8w: folds
5Y+ZGWLI4gnlpApDX5vy1A: folds
ubtx4Z5L+AcK71MTvYiGVw: raises $4 to $6
UaZ5yj+6LjtWqMQg2QskUw: folds
sTPOWERd9HWPCNrDBwsVjA: folds
ubtx4Z5L+AcK71MTvYiGVw collected $5 from pot
ubtx4Z5L+AcK71MTvYiGVw: doesn't show hand
*** SUMMARY ***
Total pot $5 | Rake $0
Seat 1: 6fLdOUCRtX71xbVRhJEq8w folded before Flop (didn't bet)
Seat 2: 5Y+ZGWLI4gnlpApDX5vy1A folded before Flop (didn't bet)
Seat 3: ubtx4Z5L+AcK71MTvYiGVw (button) collected ($5)
Seat 4: UaZ5yj+6LjtWqMQg2QskUw (small blind) folded before Flop
Seat 5: sTPOWERd9HWPCNrDBwsVjA (big blind) folded before Flop
Seat 6: mfy7uGZcqA2PVQqEVbJ7+g folded before Flop (didn't bet)



PokerStars Game #59940891144:  Hold'em No Limit ($1/$2) - 2009/07/01 1:19:36 ET
Table 'NmY84NAf9Mh0ckAckHnh5g' 2-max Seat #2 is the button
Seat 1: 6hvg964TSqZ3AL/0XK9aVQ ($257.60 in chips)
Seat 2: RwDoM55ZeQuI2ADyJhOb2Q ($752.40 in chips)
RwDoM55ZeQuI2ADyJhOb2Q: posts small blind $1
6hvg964TSqZ3AL/0XK9aVQ: posts big blind $2
*** HOLE CARDS ***
RwDoM55ZeQuI2ADyJhOb2Q: folds
6hvg964TSqZ3AL/0XK9aVQ collected $2 from pot
6hvg964TSqZ3AL/0XK9aVQ: doesn't show hand
*** SUMMARY ***
Total pot $2 | Rake $0
Seat 1: 6hvg964TSqZ3AL/0XK9aVQ (big blind) collected ($2)
Seat 2: RwDoM55ZeQuI2ADyJhOb2Q (button) (small blind) folded before Flop



PokerStars Game #59940891422:  Hold'em No Limit ($1/$2) - 2009/07/01 1:19:37 ET
Table '+hSnXFQrGw1PlVgTnuj+sA' 6-max Seat #3 is the button
Seat 1: 2ccIJhDj+3JapvS7swVZEg ($293.10 in chips)
Seat 2: o9jamqIi6sTTRSqudgboRA ($281.90 in chips)
Seat 3: fE+LHW/7rpfXW14g8LhGjA ($43.65 in chips)
Seat 4: J4iH5epwXbmODnojR/VRxA ($185 in chips)
Seat 5: VvdR9F3I+2yELkfTVvC1dg ($200 in chips)
Seat 6: AuiGltq875lmaKHBsjZVGg ($88.75 in chips)
J4iH5epwXbmODnojR/VRxA: posts small blind $1
VvdR9F3I+2yELkfTVvC1dg: posts big blind $2
*** HOLE CARDS ***
AuiGltq875lmaKHBsjZVGg: folds
2ccIJhDj+3JapvS7swVZEg: calls $2
o9jamqIi6sTTRSqudgboRA: folds
fE+LHW/7rpfXW14g8LhGjA: folds
J4iH5epwXbmODnojR/VRxA: raises $6 to $8
VvdR9F3I+2yELkfTVvC1dg: folds
2ccIJhDj+3JapvS7swVZEg: calls $6
*** FLOP *** [5c 9h 5s]
J4iH5epwXbmODnojR/VRxA: bets $10
2ccIJhDj+3JapvS7swVZEg: folds
J4iH5epwXbmODnojR/VRxA collected $17.10 from pot
*** SUMMARY ***
Total pot $18 | Rake $0.90
Board [5c 9h 5s]
Seat 1: 2ccIJhDj+3JapvS7swVZEg folded on the Flop
Seat 2: o9jamqIi6sTTRSqudgboRA folded before Flop (didn't bet)
Seat 3: fE+LHW/7rpfXW14g8LhGjA (button) folded before Flop (didn't bet)
Seat 4: J4iH5epwXbmODnojR/VRxA (small blind) collected ($17.10)
Seat 5: VvdR9F3I+2yELkfTVvC1dg (big blind) folded before Flop
Seat 6: AuiGltq875lmaKHBsjZVGg folded before Flop (didn't bet)



PokerStars Game #59940892716:  Hold'em No Limit ($1/$2) - 2009/07/01 1:19:39 ET
Table 'LL4bDFyhj5hsMpzaDugJZg' 6-max Seat #4 is the button
Seat 1: FwvID/fQGlpY3soi/lMTww ($77.90 in chips)
Seat 2: IZng3w8jiJHHp3LbYKLi4w ($55.15 in chips)
Seat 3: iI/NMpRxMkGieArQEhACSA ($279.70 in chips)
Seat 4: 8srN1dKQePlsv0GyTada+Q ($314.75 in chips)
Seat 5: A2GTwTiwkb1ilNWgW487Vg ($71.20 in chips)
Seat 6: 692Q4sfB0gTElzS0WMeg+A ($217.10 in chips)
A2GTwTiwkb1ilNWgW487Vg: posts small blind $1
692Q4sfB0gTElzS0WMeg+A: posts big blind $2
*** HOLE CARDS ***
A2GTwTiwkb1ilNWgW487Vg said, "nh"
FwvID/fQGlpY3soi/lMTww: calls $2
IZng3w8jiJHHp3LbYKLi4w: calls $2
iI/NMpRxMkGieArQEhACSA: folds
8srN1dKQePlsv0GyTada+Q: folds
A2GTwTiwkb1ilNWgW487Vg: calls $1
692Q4sfB0gTElzS0WMeg+A: checks
*** FLOP *** [Qd 8h 9d]
A2GTwTiwkb1ilNWgW487Vg: checks
692Q4sfB0gTElzS0WMeg+A: bets $6
FwvID/fQGlpY3soi/lMTww: calls $6
IZng3w8jiJHHp3LbYKLi4w: folds
A2GTwTiwkb1ilNWgW487Vg: folds
*** TURN *** [Qd 8h 9d] [Kc]
692Q4sfB0gTElzS0WMeg+A: checks
FwvID/fQGlpY3soi/lMTww: checks
*** RIVER *** [Qd 8h 9d Kc] [6s]
692Q4sfB0gTElzS0WMeg+A: checks
FwvID/fQGlpY3soi/lMTww: checks
*** SHOW DOWN ***
692Q4sfB0gTElzS0WMeg+A: shows [4d 7d] (high card King)
FwvID/fQGlpY3soi/lMTww: shows [5d Ad] (high card Ace)
FwvID/fQGlpY3soi/lMTww collected $19.05 from pot
*** SUMMARY ***
Total pot $20 | Rake $0.95
Board [Qd 8h 9d Kc 6s]
Seat 1: FwvID/fQGlpY3soi/lMTww showed [5d Ad] and won ($19.05) with high card Ace
Seat 2: IZng3w8jiJHHp3LbYKLi4w folded on the Flop
Seat 3: iI/NMpRxMkGieArQEhACSA folded before Flop (didn't bet)
Seat 4: 8srN1dKQePlsv0GyTada+Q (button) folded before Flop (didn't bet)
Seat 5: A2GTwTiwkb1ilNWgW487Vg (small blind) folded on the Flop
Seat 6: 692Q4sfB0gTElzS0WMeg+A (big blind) showed [4d 7d] and lost with high card King



PokerStars Game #59940892638:  Hold'em No Limit ($1/$2) - 2009/07/01 1:19:39 ET
Table '4NGNnZ/osQfNq6abYqkJeA' 6-max Seat #6 is the button
Seat 1: 7zM38baFvmCNB/F80oE0cQ ($60.30 in chips)
Seat 2: 669iGNwYwgRZg3nhS+aDAQ ($113.55 in chips)
Seat 3: 54yWzRRgS0oZ+S6LwZBxMQ ($30.75 in chips)
Seat 4: sY+4Uuh5z/6AbXXaCS10jw ($207 in chips)
Seat 5: VvdR9F3I+2yELkfTVvC1dg ($202 in chips)
Seat 6: kkgpegLoQkmL6LIsFsvtiQ ($269.15 in chips)
7zM38baFvmCNB/F80oE0cQ: posts small blind $1
669iGNwYwgRZg3nhS+aDAQ: posts big blind $2
*** HOLE CARDS ***
54yWzRRgS0oZ+S6LwZBxMQ: folds
sY+4Uuh5z/6AbXXaCS10jw: folds
VvdR9F3I+2yELkfTVvC1dg: raises $2 to $4
kkgpegLoQkmL6LIsFsvtiQ: calls $4
7zM38baFvmCNB/F80oE0cQ: calls $3
669iGNwYwgRZg3nhS+aDAQ: calls $2
*** FLOP *** [Kd 8h Th]
7zM38baFvmCNB/F80oE0cQ: checks
669iGNwYwgRZg3nhS+aDAQ: bets $4
VvdR9F3I+2yELkfTVvC1dg: raises $11.40 to $15.40
kkgpegLoQkmL6LIsFsvtiQ: calls $15.40
7zM38baFvmCNB/F80oE0cQ: folds
669iGNwYwgRZg3nhS+aDAQ: calls $11.40
*** TURN *** [Kd 8h Th] [Jc]
669iGNwYwgRZg3nhS+aDAQ: checks
VvdR9F3I+2yELkfTVvC1dg: bets $45.20
kkgpegLoQkmL6LIsFsvtiQ: folds
669iGNwYwgRZg3nhS+aDAQ: folds
VvdR9F3I+2yELkfTVvC1dg collected $59.20 from pot
VvdR9F3I+2yELkfTVvC1dg: doesn't show hand
*** SUMMARY ***
Total pot $62.20 | Rake $3
Board [Kd 8h Th Jc]
Seat 1: 7zM38baFvmCNB/F80oE0cQ (small blind) folded on the Flop
Seat 2: 669iGNwYwgRZg3nhS+aDAQ (big blind) folded on the Turn
Seat 3: 54yWzRRgS0oZ+S6LwZBxMQ folded before Flop (didn't bet)
Seat 4: sY+4Uuh5z/6AbXXaCS10jw folded before Flop (didn't bet)
Seat 5: VvdR9F3I+2yELkfTVvC1dg collected ($59.20)
Seat 6: kkgpegLoQkmL6LIsFsvtiQ (button) folded on the Turn



PokerStars Game #59940892990:  Hold'em No Limit ($1/$2) - 2009/07/01 1:19:40 ET
Table '8Y6PEyoNuepZTai2Q56aHw' 9-max Seat #6 is the button
Seat 1: 5Q8U6iZbeO7xJSS4qvDP5g ($282 in chips)
Seat 2: gDCJIAlovbPnTvMM7Dd1gA ($176.35 in chips)
Seat 3: WUlHm+ydPPHG7Lb0rePSdA ($120 in chips)
Seat 4: xKkwALG38OfLQ9DXuJgR1w ($284.55 in chips)
Seat 6: NtLDBSjsJQEKekh5cdinvw ($361.20 in chips)
Seat 7: Kzta8yu9vxHT4B70mjBZ+w ($200 in chips)
Seat 8: rW/MyplHylMSBRaoRUzWrg ($40 in chips)
Seat 9: F7m34OOfAQ7annesMHVjKw ($94.80 in chips)
Kzta8yu9vxHT4B70mjBZ+w: posts small blind $1
rW/MyplHylMSBRaoRUzWrg: posts big blind $2
*** HOLE CARDS ***
F7m34OOfAQ7annesMHVjKw: calls $2
5Q8U6iZbeO7xJSS4qvDP5g: folds
gDCJIAlovbPnTvMM7Dd1gA: folds
WUlHm+ydPPHG7Lb0rePSdA: calls $2
xKkwALG38OfLQ9DXuJgR1w: folds
NtLDBSjsJQEKekh5cdinvw: folds
Kzta8yu9vxHT4B70mjBZ+w: folds
rW/MyplHylMSBRaoRUzWrg: checks
*** FLOP *** [3d 8h Jd]
rW/MyplHylMSBRaoRUzWrg: checks
F7m34OOfAQ7annesMHVjKw: bets $4
WUlHm+ydPPHG7Lb0rePSdA: calls $4
rW/MyplHylMSBRaoRUzWrg: folds
*** TURN *** [3d 8h Jd] [4h]
F7m34OOfAQ7annesMHVjKw has timed out
F7m34OOfAQ7annesMHVjKw: checks
WUlHm+ydPPHG7Lb0rePSdA: checks
*** RIVER *** [3d 8h Jd 4h] [Jh]
F7m34OOfAQ7annesMHVjKw has timed out
F7m34OOfAQ7annesMHVjKw: checks
WUlHm+ydPPHG7Lb0rePSdA: bets $10
F7m34OOfAQ7annesMHVjKw has timed out
F7m34OOfAQ7annesMHVjKw: folds
F7m34OOfAQ7annesMHVjKw is sitting out
F7m34OOfAQ7annesMHVjKw has returned
WUlHm+ydPPHG7Lb0rePSdA collected $14.30 from pot
WUlHm+ydPPHG7Lb0rePSdA: doesn't show hand
*** SUMMARY ***
Total pot $15 | Rake $0.70
Board [3d 8h Jd 4h Jh]
Seat 1: 5Q8U6iZbeO7xJSS4qvDP5g folded before Flop (didn't bet)
Seat 2: gDCJIAlovbPnTvMM7Dd1gA folded before Flop (didn't bet)
Seat 3: WUlHm+ydPPHG7Lb0rePSdA collected ($14.30)
Seat 4: xKkwALG38OfLQ9DXuJgR1w folded before Flop (didn't bet)
Seat 6: NtLDBSjsJQEKekh5cdinvw (button) folded before Flop (didn't bet)
Seat 7: Kzta8yu9vxHT4B70mjBZ+w (small blind) folded before Flop
Seat 8: rW/MyplHylMSBRaoRUzWrg (big blind) folded on the Flop
Seat 9: F7m34OOfAQ7annesMHVjKw folded on the River



PokerStars Game #59940893686:  Hold'em No Limit ($1/$2) - 2009/07/01 1:19:41 ET
Table 'pPQgcj9XT9CHBsbo1WTBug' 6-max Seat #6 is the button
Seat 1: DFVYDA6dKQy7R7mGIKogZA ($119.75 in chips)
Seat 2: qXDd0ZyMIse0OBu8pxeQ3Q ($209.95 in chips)
Seat 4: gqlysXCbT8V54f/1lf9h3A ($44.75 in chips)
Seat 5: vkfxu8f/jMYKUk6Ly4eujw ($226.10 in chips)
Seat 6: Yr7pZltpy3IUNdKS9PCEiw ($313.30 in chips)
DFVYDA6dKQy7R7mGIKogZA: posts small blind $1
54yWzRRgS0oZ+S6LwZBxMQ joins the table at seat #3
qXDd0ZyMIse0OBu8pxeQ3Q: posts big blind $2
*** HOLE CARDS ***
gqlysXCbT8V54f/1lf9h3A: folds
vkfxu8f/jMYKUk6Ly4eujw: folds
Yr7pZltpy3IUNdKS9PCEiw: raises $4 to $6
DFVYDA6dKQy7R7mGIKogZA: folds
qXDd0ZyMIse0OBu8pxeQ3Q: calls $4
*** FLOP *** [4c 2s 3c]
qXDd0ZyMIse0OBu8pxeQ3Q: checks
Yr7pZltpy3IUNdKS9PCEiw: checks
*** TURN *** [4c 2s 3c] [Kh]
qXDd0ZyMIse0OBu8pxeQ3Q: bets $8
Yr7pZltpy3IUNdKS9PCEiw: folds
qXDd0ZyMIse0OBu8pxeQ3Q collected $12.35 from pot
*** SUMMARY ***
Total pot $13 | Rake $0.65
Board [4c 2s 3c Kh]
Seat 1: DFVYDA6dKQy7R7mGIKogZA (small blind) folded before Flop
Seat 2: qXDd0ZyMIse0OBu8pxeQ3Q (big blind) collected ($12.35)
Seat 4: gqlysXCbT8V54f/1lf9h3A folded before Flop (didn't bet)
Seat 5: vkfxu8f/jMYKUk6Ly4eujw folded before Flop (didn't bet)
Seat 6: Yr7pZltpy3IUNdKS9PCEiw (button) folded on the Turn



PokerStars Game #59940893616:  Hold'em No Limit ($1/$2) - 2009/07/01 1:19:41 ET
Table 'kq5zaQ+1hLNf8LZfGnbTAA' 6-max Seat #6 is the button
Seat 1: 8srN1dKQePlsv0GyTada+Q ($226 in chips)
Seat 2: nXDI8Y/S6POzRwANu3d8hQ ($41.75 in chips)
Seat 3: vkfxu8f/jMYKUk6Ly4eujw ($230.95 in chips)
Seat 4: 3dAbvkxS5NPQTBAbvpinVg ($200 in chips)
Seat 5: kfASJqTbXek+zc8ZKsZL1Q ($152.40 in chips)
Seat 6: mfy7uGZcqA2PVQqEVbJ7+g ($199.25 in chips)
8srN1dKQePlsv0GyTada+Q: posts small blind $1
nXDI8Y/S6POzRwANu3d8hQ: posts big blind $2
*** HOLE CARDS ***
vkfxu8f/jMYKUk6Ly4eujw: folds
3dAbvkxS5NPQTBAbvpinVg: folds
kfASJqTbXek+zc8ZKsZL1Q: folds
mfy7uGZcqA2PVQqEVbJ7+g: folds
8srN1dKQePlsv0GyTada+Q: folds
nXDI8Y/S6POzRwANu3d8hQ collected $2 from pot
nXDI8Y/S6POzRwANu3d8hQ: doesn't show hand
*** SUMMARY ***
Total pot $2 | Rake $0
Seat 1: 8srN1dKQePlsv0GyTada+Q (small blind) folded before Flop
Seat 2: nXDI8Y/S6POzRwANu3d8hQ (big blind) collected ($2)
Seat 3: vkfxu8f/jMYKUk6Ly4eujw folded before Flop (didn't bet)
Seat 4: 3dAbvkxS5NPQTBAbvpinVg folded before Flop (didn't bet)
Seat 5: kfASJqTbXek+zc8ZKsZL1Q folded before Flop (didn't bet)
Seat 6: mfy7uGZcqA2PVQqEVbJ7+g (button) folded before Flop (didn't bet)



PokerStars Game #59940894790:  Hold'em No Limit ($1/$2) - 2009/07/01 1:19:43 ET
Table 'NmY84NAf9Mh0ckAckHnh5g' 2-max Seat #1 is the button
Seat 1: 6hvg964TSqZ3AL/0XK9aVQ ($258.60 in chips)
Seat 2: RwDoM55ZeQuI2ADyJhOb2Q ($751.40 in chips)
6hvg964TSqZ3AL/0XK9aVQ: posts small blind $1
RwDoM55ZeQuI2ADyJhOb2Q: posts big blind $2
*** HOLE CARDS ***
6hvg964TSqZ3AL/0XK9aVQ: folds
RwDoM55ZeQuI2ADyJhOb2Q collected $2 from pot
RwDoM55ZeQuI2ADyJhOb2Q: doesn't show hand
*** SUMMARY ***
Total pot $2 | Rake $0
Seat 1: 6hvg964TSqZ3AL/0XK9aVQ (button) (small blind) folded before Flop
Seat 2: RwDoM55ZeQuI2ADyJhOb2Q (big blind) collected ($2)



PokerStars Game #59940896534:  Hold'em No Limit ($1/$2) - 2009/07/01 1:19:46 ET
Table 'jlrIxbrVIG+gjaUYT4za8g' 6-max Seat #6 is the button
Seat 1: ygTTt5ehT4aF86q1a8/R+w ($211.30 in chips)
Seat 2: on4ebXPJvUBOcHOBMQsRSg ($67 in chips)
Seat 3: RUZs7P4uzWavoA6iEpDKLw ($140 in chips)
Seat 4: 8srN1dKQePlsv0GyTada+Q ($299.70 in chips)
Seat 5: AyBB0k3Dcl7xbXUeGMw06g ($77.20 in chips)
Seat 6: vkfxu8f/jMYKUk6Ly4eujw ($338 in chips)
ygTTt5ehT4aF86q1a8/R+w: posts small blind $1
on4ebXPJvUBOcHOBMQsRSg: posts big blind $2
RUZs7P4uzWavoA6iEpDKLw: posts big blind $2
*** HOLE CARDS ***
RUZs7P4uzWavoA6iEpDKLw: checks
8srN1dKQePlsv0GyTada+Q: folds
AyBB0k3Dcl7xbXUeGMw06g: folds
vkfxu8f/jMYKUk6Ly4eujw: folds
ygTTt5ehT4aF86q1a8/R+w: folds
on4ebXPJvUBOcHOBMQsRSg: checks
*** FLOP *** [2c 6s 7h]
on4ebXPJvUBOcHOBMQsRSg: checks
RUZs7P4uzWavoA6iEpDKLw: bets $4
on4ebXPJvUBOcHOBMQsRSg: folds
RUZs7P4uzWavoA6iEpDKLw collected $4.75 from pot
*** SUMMARY ***
Total pot $5 | Rake $0.25
Board [2c 6s 7h]
Seat 1: ygTTt5ehT4aF86q1a8/R+w (small blind) folded before Flop
Seat 2: on4ebXPJvUBOcHOBMQsRSg (big blind) folded on the Flop
Seat 3: RUZs7P4uzWavoA6iEpDKLw collected ($4.75)
Seat 4: 8srN1dKQePlsv0GyTada+Q folded before Flop (didn't bet)
Seat 5: AyBB0k3Dcl7xbXUeGMw06g folded before Flop (didn't bet)
Seat 6: vkfxu8f/jMYKUk6Ly4eujw (button) folded before Flop (didn't bet)



PokerStars Game #59940897622:  Hold'em No Limit ($1/$2) - 2009/07/01 1:19:48 ET
Table 'SF49/KQm8T4taMp6kb+HXA' 9-max Seat #8 is the button
Seat 1: CUZwDpLTQKhzarPe+JCLOQ ($200 in chips)
Seat 2: rW/MyplHylMSBRaoRUzWrg ($39 in chips)
Seat 3: pCmk6FpSOLJ+85o1tLHIag ($283.75 in chips)
Seat 4: HffgoYm61KgkdMe/DYChIQ ($223.50 in chips)
Seat 5: ri8CLkX3e9JF34dQNbsHGA ($40 in chips)
Seat 6: 31HuO+DQxppUQEedBWukug ($303.95 in chips)
Seat 7: n2VAbLaE5qgKr5mA4W6v4w ($115 in chips)
Seat 8: GgrYze3jkUdSO7a7CuJGDw ($200 in chips)
Seat 9: /inIs/z/PcX+TniIFpaxpg ($324.15 in chips)
/inIs/z/PcX+TniIFpaxpg: posts small blind $1
CUZwDpLTQKhzarPe+JCLOQ: posts big blind $2
*** HOLE CARDS ***
rW/MyplHylMSBRaoRUzWrg: folds
pCmk6FpSOLJ+85o1tLHIag: folds
HffgoYm61KgkdMe/DYChIQ: folds
ri8CLkX3e9JF34dQNbsHGA: raises $4 to $6
31HuO+DQxppUQEedBWukug: folds
n2VAbLaE5qgKr5mA4W6v4w: calls $6
GgrYze3jkUdSO7a7CuJGDw: folds
/inIs/z/PcX+TniIFpaxpg: folds
CUZwDpLTQKhzarPe+JCLOQ: folds
*** FLOP *** [3s Qd 7c]
ri8CLkX3e9JF34dQNbsHGA: checks
n2VAbLaE5qgKr5mA4W6v4w: bets $6
ri8CLkX3e9JF34dQNbsHGA: raises $10 to $16
n2VAbLaE5qgKr5mA4W6v4w: raises $10 to $26
ri8CLkX3e9JF34dQNbsHGA: raises $8 to $34 and is all-in
n2VAbLaE5qgKr5mA4W6v4w: calls $8
*** TURN *** [3s Qd 7c] [5c]
*** RIVER *** [3s Qd 7c 5c] [6d]
*** SHOW DOWN ***
ri8CLkX3e9JF34dQNbsHGA: shows [Ks Kd] (a pair of Kings)
n2VAbLaE5qgKr5mA4W6v4w: mucks hand
ri8CLkX3e9JF34dQNbsHGA collected $80 from pot
*** SUMMARY ***
Total pot $83 | Rake $3
Board [3s Qd 7c 5c 6d]
Seat 1: CUZwDpLTQKhzarPe+JCLOQ (big blind) folded before Flop
Seat 2: rW/MyplHylMSBRaoRUzWrg folded before Flop (didn't bet)
Seat 3: pCmk6FpSOLJ+85o1tLHIag folded before Flop (didn't bet)
Seat 4: HffgoYm61KgkdMe/DYChIQ folded before Flop (didn't bet)
Seat 5: ri8CLkX3e9JF34dQNbsHGA showed [Ks Kd] and won ($80) with a pair of Kings
Seat 6: 31HuO+DQxppUQEedBWukug folded before Flop (didn't bet)
Seat 7: n2VAbLaE5qgKr5mA4W6v4w mucked
Seat 8: GgrYze3jkUdSO7a7CuJGDw (button) folded before Flop (didn't bet)
Seat 9: /inIs/z/PcX+TniIFpaxpg (small blind) folded before Flop



PokerStars Game #59940898014:  Hold'em No Limit ($1/$2) - 2009/07/01 1:19:48 ET
Table 'bIihwBANJSFqlHPPtset+w' 9-max Seat #8 is the button
Seat 1: /inIs/z/PcX+TniIFpaxpg ($33 in chips)
Seat 2: lQYT23h5QCUVZAKxjOO39Q ($175.30 in chips)
Seat 3: OipzuP0MueAd8hGaz/kWMQ ($45.85 in chips)
Seat 4: ri8CLkX3e9JF34dQNbsHGA ($42.40 in chips)
Seat 5: vxbbJLsS1bva6tW2NiFssg ($200 in chips)
Seat 6: CkE3IyJF1KvdaAOmZY5XqQ ($186 in chips)
Seat 7: pCmk6FpSOLJ+85o1tLHIag ($130.45 in chips)
Seat 8: iMe5yhc+1BaiIPHet3NMrA ($204.50 in chips)
Seat 9: qn8LDoUFphcG4+r+F+Vhrg ($185 in chips)
qn8LDoUFphcG4+r+F+Vhrg: posts small blind $1
/inIs/z/PcX+TniIFpaxpg: posts big blind $2
*** HOLE CARDS ***
lQYT23h5QCUVZAKxjOO39Q: raises $2 to $4
OipzuP0MueAd8hGaz/kWMQ: folds
ri8CLkX3e9JF34dQNbsHGA: folds
vxbbJLsS1bva6tW2NiFssg: folds
CkE3IyJF1KvdaAOmZY5XqQ: folds
pCmk6FpSOLJ+85o1tLHIag: folds
iMe5yhc+1BaiIPHet3NMrA: calls $4
qn8LDoUFphcG4+r+F+Vhrg: folds
/inIs/z/PcX+TniIFpaxpg: folds
*** FLOP *** [Kc Tc 8h]
lQYT23h5QCUVZAKxjOO39Q: checks
iMe5yhc+1BaiIPHet3NMrA: checks
*** TURN *** [Kc Tc 8h] [7c]
lQYT23h5QCUVZAKxjOO39Q: bets $4
iMe5yhc+1BaiIPHet3NMrA: folds
lQYT23h5QCUVZAKxjOO39Q collected $10.45 from pot
*** SUMMARY ***
Total pot $11 | Rake $0.55
Board [Kc Tc 8h 7c]
Seat 1: /inIs/z/PcX+TniIFpaxpg (big blind) folded before Flop
Seat 2: lQYT23h5QCUVZAKxjOO39Q collected ($10.45)
Seat 3: OipzuP0MueAd8hGaz/kWMQ folded before Flop (didn't bet)
Seat 4: ri8CLkX3e9JF34dQNbsHGA folded before Flop (didn't bet)
Seat 5: vxbbJLsS1bva6tW2NiFssg folded before Flop (didn't bet)
Seat 6: CkE3IyJF1KvdaAOmZY5XqQ folded before Flop (didn't bet)
Seat 7: pCmk6FpSOLJ+85o1tLHIag folded before Flop (didn't bet)
Seat 8: iMe5yhc+1BaiIPHet3NMrA (button) folded on the Turn
Seat 9: qn8LDoUFphcG4+r+F+Vhrg (small blind) folded before Flop



PokerStars Game #59940898112:  Hold'em No Limit ($1/$2) - 2009/07/01 1:19:49 ET
Table 'NmY84NAf9Mh0ckAckHnh5g' 2-max Seat #2 is the button
Seat 1: 6hvg964TSqZ3AL/0XK9aVQ ($257.60 in chips)
Seat 2: RwDoM55ZeQuI2ADyJhOb2Q ($752.40 in chips)
RwDoM55ZeQuI2ADyJhOb2Q: posts small blind $1
6hvg964TSqZ3AL/0XK9aVQ: posts big blind $2
*** HOLE CARDS ***
RwDoM55ZeQuI2ADyJhOb2Q: raises $4 to $6
6hvg964TSqZ3AL/0XK9aVQ: calls $4
*** FLOP *** [6s 5c Jc]
6hvg964TSqZ3AL/0XK9aVQ: checks
RwDoM55ZeQuI2ADyJhOb2Q: bets $10
6hvg964TSqZ3AL/0XK9aVQ: calls $10
*** TURN *** [6s 5c Jc] [8d]
6hvg964TSqZ3AL/0XK9aVQ: checks
RwDoM55ZeQuI2ADyJhOb2Q: bets $32
6hvg964TSqZ3AL/0XK9aVQ: folds
RwDoM55ZeQuI2ADyJhOb2Q collected $31.50 from pot
RwDoM55ZeQuI2ADyJhOb2Q: doesn't show hand
*** SUMMARY ***
Total pot $32 | Rake $0.50
Board [6s 5c Jc 8d]
Seat 1: 6hvg964TSqZ3AL/0XK9aVQ (big blind) folded on the Turn
Seat 2: RwDoM55ZeQuI2ADyJhOb2Q (button) (small blind) collected ($31.50)



PokerStars Game #59940899226:  Hold'em No Limit ($1/$2) - 2009/07/01 1:19:51 ET
Table 'aSf77Sj8QEnzcc0WaxVD4Q' 6-max Seat #3 is the button
Seat 1: UELtvp+JfwI7XDGVwSxZXA ($164.75 in chips)
Seat 2: vkfxu8f/jMYKUk6Ly4eujw ($200.80 in chips)
Seat 3: 9dpyyjDTCed6nV7JhaUUpw ($225.35 in chips)
Seat 4: YsLQ3BAvgQHWXMAv3Wv6Hg ($266.70 in chips)
Seat 5: VvdR9F3I+2yELkfTVvC1dg ($248 in chips)
Seat 6: vkoJRf3gidxY1pPi0AFWww ($97.20 in chips)
YsLQ3BAvgQHWXMAv3Wv6Hg: posts small blind $1
VvdR9F3I+2yELkfTVvC1dg: posts big blind $2
*** HOLE CARDS ***
vkoJRf3gidxY1pPi0AFWww: folds
UELtvp+JfwI7XDGVwSxZXA: raises $4 to $6
vkfxu8f/jMYKUk6Ly4eujw: folds
9dpyyjDTCed6nV7JhaUUpw: folds
YsLQ3BAvgQHWXMAv3Wv6Hg: folds
VvdR9F3I+2yELkfTVvC1dg: folds
UELtvp+JfwI7XDGVwSxZXA collected $5 from pot
*** SUMMARY ***
Total pot $5 | Rake $0
Seat 1: UELtvp+JfwI7XDGVwSxZXA collected ($5)
Seat 2: vkfxu8f/jMYKUk6Ly4eujw folded before Flop (didn't bet)
Seat 3: 9dpyyjDTCed6nV7JhaUUpw (button) folded before Flop (didn't bet)
Seat 4: YsLQ3BAvgQHWXMAv3Wv6Hg (small blind) folded before Flop
Seat 5: VvdR9F3I+2yELkfTVvC1dg (big blind) folded before Flop
Seat 6: vkoJRf3gidxY1pPi0AFWww folded before Flop (didn't bet)



PokerStars Game #59940900710:  Hold'em No Limit ($1/$2) - 2009/07/01 1:19:53 ET
Table 'qVXak+oTeDXMGbWa4sDU5Q' 9-max Seat #5 is the button
Seat 1: H6Z4+qu8gR0VUiPOijndVg ($252.55 in chips)
Seat 2: rW/MyplHylMSBRaoRUzWrg ($40 in chips)
Seat 3: WUlHm+ydPPHG7Lb0rePSdA ($169.65 in chips)
Seat 4: lQYT23h5QCUVZAKxjOO39Q ($102.25 in chips)
Seat 5: FWGiDqRwvLeKmHq9t4Jy9w ($268.80 in chips)
Seat 6: GX1heJ+DSsvm7gzSPsYhhQ ($35 in chips)
Seat 7: PfmlvZlFiss79a6IoEr11g ($124.30 in chips)
Seat 8: TAfo4veNRaRlzDXMMYS3Jg ($41 in chips)
Seat 9: CkE3IyJF1KvdaAOmZY5XqQ ($203 in chips)
GX1heJ+DSsvm7gzSPsYhhQ: posts small blind $1
PfmlvZlFiss79a6IoEr11g: posts big blind $2
*** HOLE CARDS ***
TAfo4veNRaRlzDXMMYS3Jg: folds
CkE3IyJF1KvdaAOmZY5XqQ: folds
H6Z4+qu8gR0VUiPOijndVg: folds
rW/MyplHylMSBRaoRUzWrg: folds
WUlHm+ydPPHG7Lb0rePSdA: raises $4 to $6
lQYT23h5QCUVZAKxjOO39Q: folds
FWGiDqRwvLeKmHq9t4Jy9w: folds
GX1heJ+DSsvm7gzSPsYhhQ: folds
PfmlvZlFiss79a6IoEr11g: folds
WUlHm+ydPPHG7Lb0rePSdA collected $5 from pot
WUlHm+ydPPHG7Lb0rePSdA: doesn't show hand
*** SUMMARY ***
Total pot $5 | Rake $0
Seat 1: H6Z4+qu8gR0VUiPOijndVg folded before Flop (didn't bet)
Seat 2: rW/MyplHylMSBRaoRUzWrg folded before Flop (didn't bet)
Seat 3: WUlHm+ydPPHG7Lb0rePSdA collected ($5)
Seat 4: lQYT23h5QCUVZAKxjOO39Q folded before Flop (didn't bet)
Seat 5: FWGiDqRwvLeKmHq9t4Jy9w (button) folded before Flop (didn't bet)
Seat 6: GX1heJ+DSsvm7gzSPsYhhQ (small blind) folded before Flop
Seat 7: PfmlvZlFiss79a6IoEr11g (big blind) folded before Flop
Seat 8: TAfo4veNRaRlzDXMMYS3Jg folded before Flop (didn't bet)
Seat 9: CkE3IyJF1KvdaAOmZY5XqQ folded before Flop (didn't bet)



PokerStars Game #59940900836:  Hold'em No Limit ($1/$2) - 2009/07/01 1:19:53 ET
Table 'YqGfR5eHfMeSjb9a+QU9rg' 9-max Seat #6 is the button
Seat 1: rW/MyplHylMSBRaoRUzWrg ($37 in chips)
Seat 2: W3Nqt1GWlTi9tXQXMNEvgw ($380.70 in chips)
Seat 3: /gll27k+xWYV7Fbki0lFDQ ($268.10 in chips)
Seat 4: QHxJjpVYwitg9krW6wZgJA ($217.30 in chips)
Seat 5: CkE3IyJF1KvdaAOmZY5XqQ ($200 in chips)
Seat 6: TAfo4veNRaRlzDXMMYS3Jg ($37 in chips)
Seat 7: 41aZuLBz9nAi2GPVKabmCw ($100.50 in chips)
Seat 8: JnV3SM2D6dAFYyGZHHpvrg ($98.55 in chips)
Seat 9: /inIs/z/PcX+TniIFpaxpg ($206.05 in chips)
41aZuLBz9nAi2GPVKabmCw: posts small blind $1
JnV3SM2D6dAFYyGZHHpvrg: posts big blind $2
*** HOLE CARDS ***
/inIs/z/PcX+TniIFpaxpg: folds
rW/MyplHylMSBRaoRUzWrg: folds
W3Nqt1GWlTi9tXQXMNEvgw: folds
/gll27k+xWYV7Fbki0lFDQ: calls $2
QHxJjpVYwitg9krW6wZgJA: folds
CkE3IyJF1KvdaAOmZY5XqQ: folds
TAfo4veNRaRlzDXMMYS3Jg: folds
41aZuLBz9nAi2GPVKabmCw: calls $1
JnV3SM2D6dAFYyGZHHpvrg: checks
*** FLOP *** [Jd 2h Ts]
41aZuLBz9nAi2GPVKabmCw: checks
JnV3SM2D6dAFYyGZHHpvrg: checks
/gll27k+xWYV7Fbki0lFDQ: checks
*** TURN *** [Jd 2h Ts] [6h]
41aZuLBz9nAi2GPVKabmCw: checks
JnV3SM2D6dAFYyGZHHpvrg: bets $4
/gll27k+xWYV7Fbki0lFDQ: folds
41aZuLBz9nAi2GPVKabmCw: folds
JnV3SM2D6dAFYyGZHHpvrg collected $5.70 from pot
*** SUMMARY ***
Total pot $6 | Rake $0.30
Board [Jd 2h Ts 6h]
Seat 1: rW/MyplHylMSBRaoRUzWrg folded before Flop (didn't bet)
Seat 2: W3Nqt1GWlTi9tXQXMNEvgw folded before Flop (didn't bet)
Seat 3: /gll27k+xWYV7Fbki0lFDQ folded on the Turn
Seat 4: QHxJjpVYwitg9krW6wZgJA folded before Flop (didn't bet)
Seat 5: CkE3IyJF1KvdaAOmZY5XqQ folded before Flop (didn't bet)
Seat 6: TAfo4veNRaRlzDXMMYS3Jg (button) folded before Flop (didn't bet)
Seat 7: 41aZuLBz9nAi2GPVKabmCw (small blind) folded on the Turn
Seat 8: JnV3SM2D6dAFYyGZHHpvrg (big blind) collected ($5.70)
Seat 9: /inIs/z/PcX+TniIFpaxpg folded before Flop (didn't bet)



PokerStars Game #59940901770:  Hold'em No Limit ($1/$2) - 2009/07/01 1:19:55 ET
Table 'QxerF7GUfCbl+4a8XaTB2w' 6-max Seat #1 is the button
Seat 1: o9jamqIi6sTTRSqudgboRA ($295.50 in chips)
Seat 2: vkfxu8f/jMYKUk6Ly4eujw ($197.80 in chips)
Seat 3: m7mYVfnCOK5TE/VkN/FhOg ($284.10 in chips)
Seat 4: 09BNF4quPDzanQzM8vc6WA ($40.55 in chips)
Seat 5: YsLQ3BAvgQHWXMAv3Wv6Hg ($201.75 in chips)
Seat 6: VvdR9F3I+2yELkfTVvC1dg ($200 in chips)
vkfxu8f/jMYKUk6Ly4eujw: posts small blind $1
m7mYVfnCOK5TE/VkN/FhOg: posts big blind $2
*** HOLE CARDS ***
09BNF4quPDzanQzM8vc6WA: folds
YsLQ3BAvgQHWXMAv3Wv6Hg: folds
VvdR9F3I+2yELkfTVvC1dg: folds
o9jamqIi6sTTRSqudgboRA: folds
vkfxu8f/jMYKUk6Ly4eujw: raises $6 to $8
m7mYVfnCOK5TE/VkN/FhOg: folds
vkfxu8f/jMYKUk6Ly4eujw collected $4 from pot
*** SUMMARY ***
Total pot $4 | Rake $0
Seat 1: o9jamqIi6sTTRSqudgboRA (button) folded before Flop (didn't bet)
Seat 2: vkfxu8f/jMYKUk6Ly4eujw (small blind) collected ($4)
Seat 3: m7mYVfnCOK5TE/VkN/FhOg (big blind) folded before Flop
Seat 4: 09BNF4quPDzanQzM8vc6WA folded before Flop (didn't bet)
Seat 5: YsLQ3BAvgQHWXMAv3Wv6Hg folded before Flop (didn't bet)
Seat 6: VvdR9F3I+2yELkfTVvC1dg folded before Flop (didn't bet)



PokerStars Game #59940901674:  Hold'em No Limit ($1/$2) - 2009/07/01 1:19:55 ET
Table 'bJQ024BaYSBrW0sXpCZbNQ' 6-max Seat #5 is the button
Seat 1: PCN5rt4TwI1pQE+rAiqI0Q ($283.60 in chips)
Seat 2: 3dAbvkxS5NPQTBAbvpinVg ($200 in chips)
Seat 3: vkfxu8f/jMYKUk6Ly4eujw ($224.10 in chips)
Seat 5: VvdR9F3I+2yELkfTVvC1dg ($200 in chips)
Seat 6: 9dpyyjDTCed6nV7JhaUUpw ($340.95 in chips)
9dpyyjDTCed6nV7JhaUUpw: posts small blind $1
PCN5rt4TwI1pQE+rAiqI0Q: posts big blind $2
*** HOLE CARDS ***
3dAbvkxS5NPQTBAbvpinVg: folds
vkfxu8f/jMYKUk6Ly4eujw: folds
VvdR9F3I+2yELkfTVvC1dg: folds
9dpyyjDTCed6nV7JhaUUpw: folds
PCN5rt4TwI1pQE+rAiqI0Q collected $2 from pot
PCN5rt4TwI1pQE+rAiqI0Q: doesn't show hand
*** SUMMARY ***
Total pot $2 | Rake $0
Seat 1: PCN5rt4TwI1pQE+rAiqI0Q (big blind) collected ($2)
Seat 2: 3dAbvkxS5NPQTBAbvpinVg folded before Flop (didn't bet)
Seat 3: vkfxu8f/jMYKUk6Ly4eujw folded before Flop (didn't bet)
Seat 5: VvdR9F3I+2yELkfTVvC1dg (button) folded before Flop (didn't bet)
Seat 6: 9dpyyjDTCed6nV7JhaUUpw (small blind) folded before Flop



PokerStars Game #59940902078:  Hold'em No Limit ($1/$2) - 2009/07/01 1:19:56 ET
Table 'TsEDkiO4tzCTCzJ7tNdEqw' 6-max Seat #1 is the button
Seat 1: MfXQsYD8pGeCS7XOtyV+vw ($26.90 in chips)
Seat 2: 4dcDwIHRm96PwtqkpQiuiA ($85.10 in chips)
Seat 3: wgRvjVPZSQvqNGiyR1jwSA ($78 in chips)
Seat 4: K8MXCrNAVYlMnnCeM32Kxw ($51.05 in chips)
Seat 5: VvdR9F3I+2yELkfTVvC1dg ($202.50 in chips)
Seat 6: uCqEjnxh2/vFBjKYkfTOkw ($259.25 in chips)
4dcDwIHRm96PwtqkpQiuiA: posts small blind $1
wgRvjVPZSQvqNGiyR1jwSA: posts big blind $2
*** HOLE CARDS ***
K8MXCrNAVYlMnnCeM32Kxw: calls $2
VvdR9F3I+2yELkfTVvC1dg: folds
uCqEjnxh2/vFBjKYkfTOkw: raises $10 to $12
MfXQsYD8pGeCS7XOtyV+vw: folds
4dcDwIHRm96PwtqkpQiuiA: folds
wgRvjVPZSQvqNGiyR1jwSA: folds
K8MXCrNAVYlMnnCeM32Kxw: folds
uCqEjnxh2/vFBjKYkfTOkw collected $7 from pot
uCqEjnxh2/vFBjKYkfTOkw: doesn't show hand
*** SUMMARY ***
Total pot $7 | Rake $0
Seat 1: MfXQsYD8pGeCS7XOtyV+vw (button) folded before Flop (didn't bet)
Seat 2: 4dcDwIHRm96PwtqkpQiuiA (small blind) folded before Flop
Seat 3: wgRvjVPZSQvqNGiyR1jwSA (big blind) folded before Flop
Seat 4: K8MXCrNAVYlMnnCeM32Kxw folded before Flop
Seat 5: VvdR9F3I+2yELkfTVvC1dg folded before Flop (didn't bet)
Seat 6: uCqEjnxh2/vFBjKYkfTOkw collected ($7)



PokerStars Game #59940902636:  Hold'em No Limit ($1/$2) - 2009/07/01 1:19:57 ET
Table 'eyAQSIlgc2o1Jxvbve4WGg' 9-max Seat #3 is the button
Seat 1: UZEsV9yKUMqmpYPiOFpaZw ($101.50 in chips)
Seat 2: g7gL2NLJCdZPPV399WKT1w ($64.65 in chips)
Seat 3: ice1Sbe19zWIaKYoSmE5tw ($93.30 in chips)
Seat 4: CkE3IyJF1KvdaAOmZY5XqQ ($200 in chips)
Seat 5: mIKx5lhIt13X5eZQH0ZeMA ($57.25 in chips)
Seat 6: rW/MyplHylMSBRaoRUzWrg ($50.80 in chips)
Seat 7: QHxJjpVYwitg9krW6wZgJA ($278.45 in chips)
Seat 8: 1CtiZuXDFaJL1dJPQKyi8Q ($197.35 in chips)
Seat 9: WUlHm+ydPPHG7Lb0rePSdA ($123.70 in chips)
CkE3IyJF1KvdaAOmZY5XqQ: posts small blind $1
mIKx5lhIt13X5eZQH0ZeMA: posts big blind $2
*** HOLE CARDS ***
rW/MyplHylMSBRaoRUzWrg: folds
QHxJjpVYwitg9krW6wZgJA: folds
1CtiZuXDFaJL1dJPQKyi8Q: raises $4 to $6
WUlHm+ydPPHG7Lb0rePSdA: folds
UZEsV9yKUMqmpYPiOFpaZw: folds
g7gL2NLJCdZPPV399WKT1w: folds
ice1Sbe19zWIaKYoSmE5tw: folds
CkE3IyJF1KvdaAOmZY5XqQ: folds
mIKx5lhIt13X5eZQH0ZeMA: calls $4
*** FLOP *** [3s 6c Jc]
mIKx5lhIt13X5eZQH0ZeMA: checks
1CtiZuXDFaJL1dJPQKyi8Q: checks
*** TURN *** [3s 6c Jc] [Tc]
mIKx5lhIt13X5eZQH0ZeMA: bets $6
1CtiZuXDFaJL1dJPQKyi8Q: calls $6
*** RIVER *** [3s 6c Jc Tc] [Ks]
mIKx5lhIt13X5eZQH0ZeMA: bets $10
1CtiZuXDFaJL1dJPQKyi8Q: calls $10
*** SHOW DOWN ***
mIKx5lhIt13X5eZQH0ZeMA: shows [Kh Jh] (two pair, Kings and Jacks)
1CtiZuXDFaJL1dJPQKyi8Q: mucks hand
mIKx5lhIt13X5eZQH0ZeMA collected $42.85 from pot
*** SUMMARY ***
Total pot $45 | Rake $2.15
Board [3s 6c Jc Tc Ks]
Seat 1: UZEsV9yKUMqmpYPiOFpaZw folded before Flop (didn't bet)
Seat 2: g7gL2NLJCdZPPV399WKT1w folded before Flop (didn't bet)
Seat 3: ice1Sbe19zWIaKYoSmE5tw (button) folded before Flop (didn't bet)
Seat 4: CkE3IyJF1KvdaAOmZY5XqQ (small blind) folded before Flop
Seat 5: mIKx5lhIt13X5eZQH0ZeMA (big blind) showed [Kh Jh] and won ($42.85) with two pair, Kings and Jacks
Seat 6: rW/MyplHylMSBRaoRUzWrg folded before Flop (didn't bet)
Seat 7: QHxJjpVYwitg9krW6wZgJA folded before Flop (didn't bet)
Seat 8: 1CtiZuXDFaJL1dJPQKyi8Q mucked
Seat 9: WUlHm+ydPPHG7Lb0rePSdA folded before Flop (didn't bet)



PokerStars Game #59940903904:  Hold'em No Limit ($1/$2) - 2009/07/01 1:19:59 ET
Table 'ZzSIe0zTCDv+n6hfbY5tTg' 6-max Seat #6 is the button
Seat 1: VvdR9F3I+2yELkfTVvC1dg ($216.10 in chips)
Seat 2: B87ikIyZ/TzAVeXf38Ny0g ($240 in chips)
Seat 3: gsugPj31Hui3Jefl98MBOA ($199 in chips)
Seat 4: qXDd0ZyMIse0OBu8pxeQ3Q ($200 in chips)
Seat 5: 3dAbvkxS5NPQTBAbvpinVg ($496.30 in chips)
Seat 6: 09BNF4quPDzanQzM8vc6WA ($22.50 in chips)
VvdR9F3I+2yELkfTVvC1dg: posts small blind $1
B87ikIyZ/TzAVeXf38Ny0g: posts big blind $2
*** HOLE CARDS ***
gsugPj31Hui3Jefl98MBOA: calls $2
qXDd0ZyMIse0OBu8pxeQ3Q: folds
3dAbvkxS5NPQTBAbvpinVg: raises $8 to $10
09BNF4quPDzanQzM8vc6WA: folds
VvdR9F3I+2yELkfTVvC1dg: folds
B87ikIyZ/TzAVeXf38Ny0g: folds
gsugPj31Hui3Jefl98MBOA: calls $8
*** FLOP *** [4d Jh 6d]
gsugPj31Hui3Jefl98MBOA: checks
3dAbvkxS5NPQTBAbvpinVg: checks
*** TURN *** [4d Jh 6d] [Th]
gsugPj31Hui3Jefl98MBOA: bets $15
3dAbvkxS5NPQTBAbvpinVg: folds
gsugPj31Hui3Jefl98MBOA collected $21.85 from pot
*** SUMMARY ***
Total pot $23 | Rake $1.15
Board [4d Jh 6d Th]
Seat 1: VvdR9F3I+2yELkfTVvC1dg (small blind) folded before Flop
Seat 2: B87ikIyZ/TzAVeXf38Ny0g (big blind) folded before Flop
Seat 3: gsugPj31Hui3Jefl98MBOA collected ($21.85)
Seat 4: qXDd0ZyMIse0OBu8pxeQ3Q folded before Flop (didn't bet)
Seat 5: 3dAbvkxS5NPQTBAbvpinVg folded on the Turn
Seat 6: 09BNF4quPDzanQzM8vc6WA (button) folded before Flop (didn't bet)



PokerStars Game #59940904228:  Hold'em No Limit ($1/$2) - 2009/07/01 1:20:00 ET
Table 'mGpP9StWRnoeiBDExc6Frg' 6-max Seat #1 is the button
Seat 1: VvdR9F3I+2yELkfTVvC1dg ($200 in chips)
Seat 2: dZcLsEI8iXkobBduRJ45Yw ($77.50 in chips)
Seat 3: 7acrZUQC3Zc9BNLjoKIcLQ ($39.10 in chips)
Seat 4: 4dcDwIHRm96PwtqkpQiuiA ($43.35 in chips)
Seat 5: d1puGuVBE0fidn+5eRJ0tw ($227.20 in chips)
Seat 6: B2Ih1sr5VZk+8He7rcrMtQ ($451.35 in chips)
dZcLsEI8iXkobBduRJ45Yw: posts small blind $1
7acrZUQC3Zc9BNLjoKIcLQ: posts big blind $2
*** HOLE CARDS ***
4dcDwIHRm96PwtqkpQiuiA: folds
d1puGuVBE0fidn+5eRJ0tw: folds
B2Ih1sr5VZk+8He7rcrMtQ: folds
VvdR9F3I+2yELkfTVvC1dg: folds
dZcLsEI8iXkobBduRJ45Yw: raises $2 to $4
7acrZUQC3Zc9BNLjoKIcLQ: calls $2
*** FLOP *** [2s 7d 8s]
dZcLsEI8iXkobBduRJ45Yw: checks
7acrZUQC3Zc9BNLjoKIcLQ: bets $4
dZcLsEI8iXkobBduRJ45Yw: calls $4
*** TURN *** [2s 7d 8s] [Qs]
dZcLsEI8iXkobBduRJ45Yw: checks
7acrZUQC3Zc9BNLjoKIcLQ: bets $10
dZcLsEI8iXkobBduRJ45Yw: folds
7acrZUQC3Zc9BNLjoKIcLQ collected $15.25 from pot
*** SUMMARY ***
Total pot $16 | Rake $0.75
Board [2s 7d 8s Qs]
Seat 1: VvdR9F3I+2yELkfTVvC1dg (button) folded before Flop (didn't bet)
Seat 2: dZcLsEI8iXkobBduRJ45Yw (small blind) folded on the Turn
Seat 3: 7acrZUQC3Zc9BNLjoKIcLQ (big blind) collected ($15.25)
Seat 4: 4dcDwIHRm96PwtqkpQiuiA folded before Flop (didn't bet)
Seat 5: d1puGuVBE0fidn+5eRJ0tw folded before Flop (didn't bet)
Seat 6: B2Ih1sr5VZk+8He7rcrMtQ folded before Flop (didn't bet)



PokerStars Game #59940904754:  Hold'em No Limit ($1/$2) - 2009/07/01 1:20:00 ET
Table 'gftD4mDF7mIFKvSrIyaRbw' 9-max Seat #6 is the button
Seat 1: 31HuO+DQxppUQEedBWukug ($106 in chips)
Seat 2: GX1heJ+DSsvm7gzSPsYhhQ ($37 in chips)
Seat 3: CUZwDpLTQKhzarPe+JCLOQ ($200.10 in chips)
Seat 5: mpsfNtnMVDqQHTe92AhIdw ($120.50 in chips)
Seat 6: 2NvwF8W2nzsbS+G//yLAbQ ($178.05 in chips)
Seat 8: MpL4DeEqGQu0H8TJEbEOrg ($38 in chips)
Seat 9: F7m34OOfAQ7annesMHVjKw ($159.10 in chips)
+T/63sAeZzWyHchahJ36GQ will be allowed to play after the button
MpL4DeEqGQu0H8TJEbEOrg: posts small blind $1
F7m34OOfAQ7annesMHVjKw: posts big blind $2
/inIs/z/PcX+TniIFpaxpg: sits out
*** HOLE CARDS ***
31HuO+DQxppUQEedBWukug: folds
GX1heJ+DSsvm7gzSPsYhhQ: folds
CUZwDpLTQKhzarPe+JCLOQ: folds
mpsfNtnMVDqQHTe92AhIdw: folds
2NvwF8W2nzsbS+G//yLAbQ: raises $2 to $4
MpL4DeEqGQu0H8TJEbEOrg: raises $34 to $38 and is all-in
F7m34OOfAQ7annesMHVjKw: folds
2NvwF8W2nzsbS+G//yLAbQ: folds
MpL4DeEqGQu0H8TJEbEOrg collected $10 from pot
*** SUMMARY ***
Total pot $10 | Rake $0
Seat 1: 31HuO+DQxppUQEedBWukug folded before Flop (didn't bet)
Seat 2: GX1heJ+DSsvm7gzSPsYhhQ folded before Flop (didn't bet)
Seat 3: CUZwDpLTQKhzarPe+JCLOQ folded before Flop (didn't bet)
Seat 5: mpsfNtnMVDqQHTe92AhIdw folded before Flop (didn't bet)
Seat 6: 2NvwF8W2nzsbS+G//yLAbQ (button) folded before Flop
Seat 8: MpL4DeEqGQu0H8TJEbEOrg (small blind) collected ($10)
Seat 9: F7m34OOfAQ7annesMHVjKw (big blind) folded before Flop



PokerStars Game #59940905562:  Hold'em No Limit ($1/$2) - 2009/07/01 1:20:02 ET
Table 'gnHBqWll9O3fxG7Ojkz/ng' 9-max Seat #2 is the button
Seat 1: TAfo4veNRaRlzDXMMYS3Jg ($37 in chips)
Seat 2: H6Z4+qu8gR0VUiPOijndVg ($338.60 in chips)
Seat 3: 5Q8U6iZbeO7xJSS4qvDP5g ($216 in chips)
Seat 5: rBQDMkKm9cZn6M9NPsiVew ($239.45 in chips)
Seat 6: /inIs/z/PcX+TniIFpaxpg ($45 in chips)
Seat 7: jqui3xAWCkcdPW36a6BD+w ($342.40 in chips)
Seat 8: cM6efHzdxoqYm0EQKP4TTQ ($102.30 in chips)
Seat 9: sN6yR5I5zFq/WFyIz5UfzQ ($201 in chips)
5Q8U6iZbeO7xJSS4qvDP5g: posts small blind $1
rBQDMkKm9cZn6M9NPsiVew: posts big blind $2
*** HOLE CARDS ***
/inIs/z/PcX+TniIFpaxpg: folds
jqui3xAWCkcdPW36a6BD+w: folds
cM6efHzdxoqYm0EQKP4TTQ: calls $2
sN6yR5I5zFq/WFyIz5UfzQ: folds
TAfo4veNRaRlzDXMMYS3Jg: folds
H6Z4+qu8gR0VUiPOijndVg: folds
5Q8U6iZbeO7xJSS4qvDP5g: folds
rBQDMkKm9cZn6M9NPsiVew: checks
*** FLOP *** [4h 8d 5s]
rBQDMkKm9cZn6M9NPsiVew: checks
cM6efHzdxoqYm0EQKP4TTQ: bets $8
rBQDMkKm9cZn6M9NPsiVew: folds
cM6efHzdxoqYm0EQKP4TTQ collected $4.75 from pot
*** SUMMARY ***
Total pot $5 | Rake $0.25
Board [4h 8d 5s]
Seat 1: TAfo4veNRaRlzDXMMYS3Jg folded before Flop (didn't bet)
Seat 2: H6Z4+qu8gR0VUiPOijndVg (button) folded before Flop (didn't bet)
Seat 3: 5Q8U6iZbeO7xJSS4qvDP5g (small blind) folded before Flop
Seat 5: rBQDMkKm9cZn6M9NPsiVew (big blind) folded on the Flop
Seat 6: /inIs/z/PcX+TniIFpaxpg folded before Flop (didn't bet)
Seat 7: jqui3xAWCkcdPW36a6BD+w folded before Flop (didn't bet)
Seat 8: cM6efHzdxoqYm0EQKP4TTQ collected ($4.75)
Seat 9: sN6yR5I5zFq/WFyIz5UfzQ folded before Flop (didn't bet)



PokerStars Game #59940905634:  Hold'em No Limit ($1/$2) - 2009/07/01 1:20:02 ET
Table 'rsKRKlGHlxVyqJxzO2a2Ow' 9-max Seat #4 is the button
Seat 1: uYWfQJg2hgHLxri6/uVJiw ($347.20 in chips)
Seat 2: QHxJjpVYwitg9krW6wZgJA ($267.30 in chips)
Seat 3: zTcFtoHqqK4550YMZ8Y14Q ($60.50 in chips)
Seat 4: 31HuO+DQxppUQEedBWukug ($94 in chips)
Seat 5: 5Q8U6iZbeO7xJSS4qvDP5g ($200 in chips)
Seat 6: H6Z4+qu8gR0VUiPOijndVg ($200 in chips)
Seat 8: CkE3IyJF1KvdaAOmZY5XqQ ($220.75 in chips)
Seat 9: gRbvhSUVg+TNaTjaJecIRw ($72 in chips)
5Q8U6iZbeO7xJSS4qvDP5g: posts small blind $1
H6Z4+qu8gR0VUiPOijndVg: posts big blind $2
GX1heJ+DSsvm7gzSPsYhhQ: sits out
*** HOLE CARDS ***
CkE3IyJF1KvdaAOmZY5XqQ has timed out
CkE3IyJF1KvdaAOmZY5XqQ: folds
CkE3IyJF1KvdaAOmZY5XqQ is sitting out
gRbvhSUVg+TNaTjaJecIRw: folds
uYWfQJg2hgHLxri6/uVJiw: folds
CkE3IyJF1KvdaAOmZY5XqQ has returned
QHxJjpVYwitg9krW6wZgJA: folds
zTcFtoHqqK4550YMZ8Y14Q: folds
31HuO+DQxppUQEedBWukug: folds
5Q8U6iZbeO7xJSS4qvDP5g: raises $4 to $6
H6Z4+qu8gR0VUiPOijndVg: folds
5Q8U6iZbeO7xJSS4qvDP5g collected $4 from pot
5Q8U6iZbeO7xJSS4qvDP5g: doesn't show hand
*** SUMMARY ***
Total pot $4 | Rake $0
Seat 1: uYWfQJg2hgHLxri6/uVJiw folded before Flop (didn't bet)
Seat 2: QHxJjpVYwitg9krW6wZgJA folded before Flop (didn't bet)
Seat 3: zTcFtoHqqK4550YMZ8Y14Q folded before Flop (didn't bet)
Seat 4: 31HuO+DQxppUQEedBWukug (button) folded before Flop (didn't bet)
Seat 5: 5Q8U6iZbeO7xJSS4qvDP5g (small blind) collected ($4)
Seat 6: H6Z4+qu8gR0VUiPOijndVg (big blind) folded before Flop
Seat 8: CkE3IyJF1KvdaAOmZY5XqQ folded before Flop (didn't bet)
Seat 9: gRbvhSUVg+TNaTjaJecIRw folded before Flop (didn't bet)



PokerStars Game #59940906332:  Hold'em No Limit ($1/$2) - 2009/07/01 1:20:03 ET
Table '/dyk+YdRGv90j2box35j8w' 6-max Seat #3 is the button
Seat 2: qCnEYuAE5y5A7bk6fO5/jQ ($493.60 in chips)
Seat 3: sTPOWERd9HWPCNrDBwsVjA ($237.50 in chips)
Seat 4: z/u1YTnkiIDrtp/2cA2dBg ($123.65 in chips)
Seat 5: VvdR9F3I+2yELkfTVvC1dg ($200 in chips)
Seat 6: ZwvXzkkZ3XpMhKfAmVpahw ($356.25 in chips)
z/u1YTnkiIDrtp/2cA2dBg: posts small blind $1
VvdR9F3I+2yELkfTVvC1dg: posts big blind $2
8srN1dKQePlsv0GyTada+Q: sits out
*** HOLE CARDS ***
ZwvXzkkZ3XpMhKfAmVpahw: folds
qCnEYuAE5y5A7bk6fO5/jQ: folds
sTPOWERd9HWPCNrDBwsVjA: folds
z/u1YTnkiIDrtp/2cA2dBg: raises $4 to $6
VvdR9F3I+2yELkfTVvC1dg: folds
z/u1YTnkiIDrtp/2cA2dBg collected $4 from pot
*** SUMMARY ***
Total pot $4 | Rake $0
Seat 2: qCnEYuAE5y5A7bk6fO5/jQ folded before Flop (didn't bet)
Seat 3: sTPOWERd9HWPCNrDBwsVjA (button) folded before Flop (didn't bet)
Seat 4: z/u1YTnkiIDrtp/2cA2dBg (small blind) collected ($4)
Seat 5: VvdR9F3I+2yELkfTVvC1dg (big blind) folded before Flop
Seat 6: ZwvXzkkZ3XpMhKfAmVpahw folded before Flop (didn't bet)



PokerStars Game #59940906250:  Hold'em No Limit ($1/$2) - 2009/07/01 1:20:03 ET
Table 'W9UeSV0aoPjh5SFSxM8jUQ' 9-max Seat #7 is the button
Seat 1: mIKx5lhIt13X5eZQH0ZeMA ($25 in chips)
Seat 2: iMe5yhc+1BaiIPHet3NMrA ($255.60 in chips)
Seat 3: /inIs/z/PcX+TniIFpaxpg ($25 in chips)
Seat 4: LjOrlR1DLUQ+KE0gh7hP6Q ($109 in chips)
Seat 5: ri8CLkX3e9JF34dQNbsHGA ($42.45 in chips)
Seat 6: j47DM+lqTfzZP8musviQTg ($110.90 in chips)
Seat 7: I2ipWauytvrkEer4XD3Sjg ($106 in chips)
Seat 8: odhvI/CZeMsPyo1n1U7+hA ($50.70 in chips)
Seat 9: Q104K4iDGcqOlVrjAkzPEA ($21 in chips)
odhvI/CZeMsPyo1n1U7+hA: posts small blind $1
Q104K4iDGcqOlVrjAkzPEA: posts big blind $2
*** HOLE CARDS ***
mIKx5lhIt13X5eZQH0ZeMA: folds
iMe5yhc+1BaiIPHet3NMrA: folds
/inIs/z/PcX+TniIFpaxpg: folds
LjOrlR1DLUQ+KE0gh7hP6Q: raises $7 to $9
ri8CLkX3e9JF34dQNbsHGA: folds
j47DM+lqTfzZP8musviQTg: folds
I2ipWauytvrkEer4XD3Sjg: folds
odhvI/CZeMsPyo1n1U7+hA: folds
Q104K4iDGcqOlVrjAkzPEA: raises $12 to $21 and is all-in
LjOrlR1DLUQ+KE0gh7hP6Q: calls $12
*** FLOP *** [5d 7d Qs]
*** TURN *** [5d 7d Qs] [8c]
*** RIVER *** [5d 7d Qs 8c] [8d]
*** SHOW DOWN ***
Q104K4iDGcqOlVrjAkzPEA: shows [Kd Kc] (two pair, Kings and Eights)
LjOrlR1DLUQ+KE0gh7hP6Q: mucks hand
LjOrlR1DLUQ+KE0gh7hP6Q leaves the table
Q104K4iDGcqOlVrjAkzPEA collected $40.85 from pot
*** SUMMARY ***
Total pot $43 | Rake $2.15
Board [5d 7d Qs 8c 8d]
Seat 1: mIKx5lhIt13X5eZQH0ZeMA folded before Flop (didn't bet)
Seat 2: iMe5yhc+1BaiIPHet3NMrA folded before Flop (didn't bet)
Seat 3: /inIs/z/PcX+TniIFpaxpg folded before Flop (didn't bet)
Seat 4: LjOrlR1DLUQ+KE0gh7hP6Q mucked
Seat 5: ri8CLkX3e9JF34dQNbsHGA folded before Flop (didn't bet)
Seat 6: j47DM+lqTfzZP8musviQTg folded before Flop (didn't bet)
Seat 7: I2ipWauytvrkEer4XD3Sjg (button) folded before Flop (didn't bet)
Seat 8: odhvI/CZeMsPyo1n1U7+hA (small blind) folded before Flop
Seat 9: Q104K4iDGcqOlVrjAkzPEA (big blind) showed [Kd Kc] and won ($40.85) with two pair, Kings and Eights



PokerStars Game #59940907406:  Hold'em No Limit ($1/$2) - 2009/07/01 1:20:05 ET
Table 'rKeCh+eBn4RNvybCUYkoTQ' 9-max Seat #2 is the button
Seat 1: /inIs/z/PcX+TniIFpaxpg ($203 in chips)
Seat 2: 9cBHwK40Tl06vheE7B3LHQ ($150.55 in chips)
Seat 3: GX1heJ+DSsvm7gzSPsYhhQ ($38 in chips)
Seat 4: 31HuO+DQxppUQEedBWukug ($98.10 in chips)
Seat 5: WUlHm+ydPPHG7Lb0rePSdA ($120 in chips)
Seat 6: EBV6OktyeSmh4w6sWmcWOw ($270 in chips)
Seat 7: rW/MyplHylMSBRaoRUzWrg ($37 in chips)
Seat 8: pN/Ip0ePsUVIdUlGgLrkUw ($210.10 in chips)
Seat 9: Kzta8yu9vxHT4B70mjBZ+w ($211.25 in chips)
GX1heJ+DSsvm7gzSPsYhhQ: posts small blind $1
31HuO+DQxppUQEedBWukug: posts big blind $2
*** HOLE CARDS ***
WUlHm+ydPPHG7Lb0rePSdA: folds
EBV6OktyeSmh4w6sWmcWOw: folds
rW/MyplHylMSBRaoRUzWrg: folds
pN/Ip0ePsUVIdUlGgLrkUw: folds
Kzta8yu9vxHT4B70mjBZ+w: folds
/inIs/z/PcX+TniIFpaxpg: folds
9cBHwK40Tl06vheE7B3LHQ: raises $4 to $6
GX1heJ+DSsvm7gzSPsYhhQ: folds
31HuO+DQxppUQEedBWukug: folds
9cBHwK40Tl06vheE7B3LHQ collected $5 from pot
9cBHwK40Tl06vheE7B3LHQ: doesn't show hand
*** SUMMARY ***
Total pot $5 | Rake $0
Seat 1: /inIs/z/PcX+TniIFpaxpg folded before Flop (didn't bet)
Seat 2: 9cBHwK40Tl06vheE7B3LHQ (button) collected ($5)
Seat 3: GX1heJ+DSsvm7gzSPsYhhQ (small blind) folded before Flop
Seat 4: 31HuO+DQxppUQEedBWukug (big blind) folded before Flop
Seat 5: WUlHm+ydPPHG7Lb0rePSdA folded before Flop (didn't bet)
Seat 6: EBV6OktyeSmh4w6sWmcWOw folded before Flop (didn't bet)
Seat 7: rW/MyplHylMSBRaoRUzWrg folded before Flop (didn't bet)
Seat 8: pN/Ip0ePsUVIdUlGgLrkUw folded before Flop (didn't bet)
Seat 9: Kzta8yu9vxHT4B70mjBZ+w folded before Flop (didn't bet)



PokerStars Game #59940907944:  Hold'em No Limit ($1/$2) - 2009/07/01 1:20:06 ET
Table 'ztv6V3FN2bQ9nmJPPdx6nQ' 6-max Seat #4 is the button
Seat 1: 6fLdOUCRtX71xbVRhJEq8w ($218 in chips)
Seat 2: 5Y+ZGWLI4gnlpApDX5vy1A ($399.40 in chips)
Seat 3: ubtx4Z5L+AcK71MTvYiGVw ($203 in chips)
Seat 4: UaZ5yj+6LjtWqMQg2QskUw ($115.80 in chips)
Seat 5: sTPOWERd9HWPCNrDBwsVjA ($252 in chips)
Seat 6: mfy7uGZcqA2PVQqEVbJ7+g ($117.45 in chips)
sTPOWERd9HWPCNrDBwsVjA: posts small blind $1
mfy7uGZcqA2PVQqEVbJ7+g: posts big blind $2
*** HOLE CARDS ***
6fLdOUCRtX71xbVRhJEq8w: folds
5Y+ZGWLI4gnlpApDX5vy1A: folds
ubtx4Z5L+AcK71MTvYiGVw: folds
UaZ5yj+6LjtWqMQg2QskUw: folds
sTPOWERd9HWPCNrDBwsVjA: folds
mfy7uGZcqA2PVQqEVbJ7+g collected $2 from pot
mfy7uGZcqA2PVQqEVbJ7+g: doesn't show hand
*** SUMMARY ***
Total pot $2 | Rake $0
Seat 1: 6fLdOUCRtX71xbVRhJEq8w folded before Flop (didn't bet)
Seat 2: 5Y+ZGWLI4gnlpApDX5vy1A folded before Flop (didn't bet)
Seat 3: ubtx4Z5L+AcK71MTvYiGVw folded before Flop (didn't bet)
Seat 4: UaZ5yj+6LjtWqMQg2QskUw (button) folded before Flop (didn't bet)
Seat 5: sTPOWERd9HWPCNrDBwsVjA (small blind) folded before Flop
Seat 6: mfy7uGZcqA2PVQqEVbJ7+g (big blind) collected ($2)



PokerStars Game #59940909334:  Hold'em No Limit ($1/$2) - 2009/07/01 1:20:08 ET
Table '+hSnXFQrGw1PlVgTnuj+sA' 6-max Seat #4 is the button
Seat 1: 2ccIJhDj+3JapvS7swVZEg ($285.10 in chips)
Seat 2: o9jamqIi6sTTRSqudgboRA ($281.90 in chips)
Seat 3: fE+LHW/7rpfXW14g8LhGjA ($43.65 in chips)
Seat 4: J4iH5epwXbmODnojR/VRxA ($194.10 in chips)
Seat 5: VvdR9F3I+2yELkfTVvC1dg ($200 in chips)
Seat 6: AuiGltq875lmaKHBsjZVGg ($88.75 in chips)
VvdR9F3I+2yELkfTVvC1dg: posts small blind $1
AuiGltq875lmaKHBsjZVGg: posts big blind $2
*** HOLE CARDS ***
2ccIJhDj+3JapvS7swVZEg: calls $2
o9jamqIi6sTTRSqudgboRA: folds
fE+LHW/7rpfXW14g8LhGjA: folds
J4iH5epwXbmODnojR/VRxA: folds
VvdR9F3I+2yELkfTVvC1dg: folds
AuiGltq875lmaKHBsjZVGg: checks
*** FLOP *** [Jd Td 5s]
AuiGltq875lmaKHBsjZVGg: checks
2ccIJhDj+3JapvS7swVZEg: bets $4
AuiGltq875lmaKHBsjZVGg: folds
2ccIJhDj+3JapvS7swVZEg collected $4.75 from pot
*** SUMMARY ***
Total pot $5 | Rake $0.25
Board [Jd Td 5s]
Seat 1: 2ccIJhDj+3JapvS7swVZEg collected ($4.75)
Seat 2: o9jamqIi6sTTRSqudgboRA folded before Flop (didn't bet)
Seat 3: fE+LHW/7rpfXW14g8LhGjA folded before Flop (didn't bet)
Seat 4: J4iH5epwXbmODnojR/VRxA (button) folded before Flop (didn't bet)
Seat 5: VvdR9F3I+2yELkfTVvC1dg (small blind) folded before Flop
Seat 6: AuiGltq875lmaKHBsjZVGg (big blind) folded on the Flop



PokerStars Game #59940909378:  Hold'em No Limit ($1/$2) - 2009/07/01 1:20:09 ET
Table 'CFkQcfWjKccZaZDf71FK+w' 6-max Seat #4 is the button
Seat 1: JsC+WvfzqlxVs9G8/gSQAQ ($75.30 in chips)
Seat 2: ewN/vzF22+/gdzjIKBOlkA ($227.05 in chips)
Seat 3: 09BNF4quPDzanQzM8vc6WA ($27 in chips)
Seat 4: ygTTt5ehT4aF86q1a8/R+w ($195.10 in chips)
Seat 5: 2lOU1DcvUZaMcxZ95XfzXw ($101 in chips)
Seat 6: ORVqY3rf9X6ANA/8s+On2Q ($57.75 in chips)
2lOU1DcvUZaMcxZ95XfzXw: posts small blind $1
ORVqY3rf9X6ANA/8s+On2Q: posts big blind $2
*** HOLE CARDS ***
JsC+WvfzqlxVs9G8/gSQAQ: raises $8 to $10
ewN/vzF22+/gdzjIKBOlkA: folds
09BNF4quPDzanQzM8vc6WA: folds
ygTTt5ehT4aF86q1a8/R+w: folds
2lOU1DcvUZaMcxZ95XfzXw: folds
ORVqY3rf9X6ANA/8s+On2Q: calls $8
*** FLOP *** [As 6s Qd]
ORVqY3rf9X6ANA/8s+On2Q: checks
JsC+WvfzqlxVs9G8/gSQAQ: bets $14
ORVqY3rf9X6ANA/8s+On2Q: calls $14
*** TURN *** [As 6s Qd] [4d]
ORVqY3rf9X6ANA/8s+On2Q: bets $8
JsC+WvfzqlxVs9G8/gSQAQ: raises $43.30 to $51.30 and is all-in
ORVqY3rf9X6ANA/8s+On2Q: calls $25.75 and is all-in
*** RIVER *** [As 6s Qd 4d] [Th]
*** SHOW DOWN ***
ORVqY3rf9X6ANA/8s+On2Q: shows [Ac Td] (two pair, Aces and Tens)
JsC+WvfzqlxVs9G8/gSQAQ: mucks hand
ORVqY3rf9X6ANA/8s+On2Q collected $113.50 from pot
*** SUMMARY ***
Total pot $116.50 | Rake $3
Board [As 6s Qd 4d Th]
Seat 1: JsC+WvfzqlxVs9G8/gSQAQ mucked
Seat 2: ewN/vzF22+/gdzjIKBOlkA folded before Flop (didn't bet)
Seat 3: 09BNF4quPDzanQzM8vc6WA folded before Flop (didn't bet)
Seat 4: ygTTt5ehT4aF86q1a8/R+w (button) folded before Flop (didn't bet)
Seat 5: 2lOU1DcvUZaMcxZ95XfzXw (small blind) folded before Flop
Seat 6: ORVqY3rf9X6ANA/8s+On2Q (big blind) showed [Ac Td] and won ($113.50) with two pair, Aces and Tens



PokerStars Game #59940909408:  Hold'em No Limit ($1/$2) - 2009/07/01 1:20:09 ET
Table 'NmY84NAf9Mh0ckAckHnh5g' 2-max Seat #1 is the button
Seat 1: 6hvg964TSqZ3AL/0XK9aVQ ($241.60 in chips)
Seat 2: RwDoM55ZeQuI2ADyJhOb2Q ($767.90 in chips)
6hvg964TSqZ3AL/0XK9aVQ: posts small blind $1
RwDoM55ZeQuI2ADyJhOb2Q: posts big blind $2
*** HOLE CARDS ***
6hvg964TSqZ3AL/0XK9aVQ: calls $1
RwDoM55ZeQuI2ADyJhOb2Q: raises $6 to $8
6hvg964TSqZ3AL/0XK9aVQ: calls $6
*** FLOP *** [3s 7h Td]
RwDoM55ZeQuI2ADyJhOb2Q: bets $10
6hvg964TSqZ3AL/0XK9aVQ: raises $10 to $20
RwDoM55ZeQuI2ADyJhOb2Q: calls $10
*** TURN *** [3s 7h Td] [9h]
RwDoM55ZeQuI2ADyJhOb2Q: checks
6hvg964TSqZ3AL/0XK9aVQ: bets $24
RwDoM55ZeQuI2ADyJhOb2Q: folds
6hvg964TSqZ3AL/0XK9aVQ collected $55.50 from pot
6hvg964TSqZ3AL/0XK9aVQ: doesn't show hand
*** SUMMARY ***
Total pot $56 | Rake $0.50
Board [3s 7h Td 9h]
Seat 1: 6hvg964TSqZ3AL/0XK9aVQ (button) (small blind) collected ($55.50)
Seat 2: RwDoM55ZeQuI2ADyJhOb2Q (big blind) folded on the Turn



PokerStars Game #59940911912:  Hold'em No Limit ($1/$2) - 2009/07/01 1:20:13 ET
Table 'uJ9juaXXg9yIcSU8amxaXQ' 6-max Seat #1 is the button
Seat 1: JsqOjN/eHz0uYVf/PyUJ6Q ($149.85 in chips)
Seat 2: VvdR9F3I+2yELkfTVvC1dg ($200 in chips)
Seat 3: qXDd0ZyMIse0OBu8pxeQ3Q ($249 in chips)
Seat 5: YsLQ3BAvgQHWXMAv3Wv6Hg ($200 in chips)
Seat 6: 2DFp9Veq1xxq64dCjwNuUw ($48.90 in chips)
VvdR9F3I+2yELkfTVvC1dg: posts small blind $1
qXDd0ZyMIse0OBu8pxeQ3Q: posts big blind $2
*** HOLE CARDS ***
zNjJ/y4emmF+vzrCDd+ooA has returned
YsLQ3BAvgQHWXMAv3Wv6Hg: folds
2DFp9Veq1xxq64dCjwNuUw: raises $4 to $6
JsqOjN/eHz0uYVf/PyUJ6Q: folds
VvdR9F3I+2yELkfTVvC1dg: folds
qXDd0ZyMIse0OBu8pxeQ3Q: folds
2DFp9Veq1xxq64dCjwNuUw collected $5 from pot
2DFp9Veq1xxq64dCjwNuUw: doesn't show hand
*** SUMMARY ***
Total pot $5 | Rake $0
Seat 1: JsqOjN/eHz0uYVf/PyUJ6Q (button) folded before Flop (didn't bet)
Seat 2: VvdR9F3I+2yELkfTVvC1dg (small blind) folded before Flop
Seat 3: qXDd0ZyMIse0OBu8pxeQ3Q (big blind) folded before Flop
Seat 5: YsLQ3BAvgQHWXMAv3Wv6Hg folded before Flop (didn't bet)
Seat 6: 2DFp9Veq1xxq64dCjwNuUw collected ($5)



PokerStars Game #59940912666:  Hold'em No Limit ($1/$2) - 2009/07/01 1:20:15 ET
Table 'dBLpiMEy1cezkSKD+ZpCcw' 2-max Seat #2 is the button
Seat 1: NFRtU1s5+WFh9EKwu+KLOQ ($15.30 in chips)
Seat 2: 4rrQUikeMSkuWGHgW80++w ($425.50 in chips)
4rrQUikeMSkuWGHgW80++w: posts small blind $1
NFRtU1s5+WFh9EKwu+KLOQ: posts big blind $2
*** HOLE CARDS ***
4rrQUikeMSkuWGHgW80++w: folds
NFRtU1s5+WFh9EKwu+KLOQ collected $2 from pot
*** SUMMARY ***
Total pot $2 | Rake $0
Seat 1: NFRtU1s5+WFh9EKwu+KLOQ (big blind) collected ($2)
Seat 2: 4rrQUikeMSkuWGHgW80++w (button) (small blind) folded before Flop



PokerStars Game #59940913524:  Hold'em No Limit ($1/$2) - 2009/07/01 1:20:16 ET
Table 'kq5zaQ+1hLNf8LZfGnbTAA' 6-max Seat #1 is the button
Seat 1: 8srN1dKQePlsv0GyTada+Q ($225 in chips)
Seat 2: nXDI8Y/S6POzRwANu3d8hQ ($42.75 in chips)
Seat 3: vkfxu8f/jMYKUk6Ly4eujw ($230.95 in chips)
Seat 4: 3dAbvkxS5NPQTBAbvpinVg ($200 in chips)
Seat 5: kfASJqTbXek+zc8ZKsZL1Q ($152.40 in chips)
Seat 6: mfy7uGZcqA2PVQqEVbJ7+g ($199.25 in chips)
nXDI8Y/S6POzRwANu3d8hQ: posts small blind $1
vkfxu8f/jMYKUk6Ly4eujw: posts big blind $2
*** HOLE CARDS ***
3dAbvkxS5NPQTBAbvpinVg: folds
kfASJqTbXek+zc8ZKsZL1Q: folds
mfy7uGZcqA2PVQqEVbJ7+g: folds
8srN1dKQePlsv0GyTada+Q: raises $2 to $4
nXDI8Y/S6POzRwANu3d8hQ: folds
vkfxu8f/jMYKUk6Ly4eujw: folds
8srN1dKQePlsv0GyTada+Q collected $5 from pot
8srN1dKQePlsv0GyTada+Q: doesn't show hand
*** SUMMARY ***
Total pot $5 | Rake $0
Seat 1: 8srN1dKQePlsv0GyTada+Q (button) collected ($5)
Seat 2: nXDI8Y/S6POzRwANu3d8hQ (small blind) folded before Flop
Seat 3: vkfxu8f/jMYKUk6Ly4eujw (big blind) folded before Flop
Seat 4: 3dAbvkxS5NPQTBAbvpinVg folded before Flop (didn't bet)
Seat 5: kfASJqTbXek+zc8ZKsZL1Q folded before Flop (didn't bet)
Seat 6: mfy7uGZcqA2PVQqEVbJ7+g folded before Flop (didn't bet)



PokerStars Game #59940915828:  Hold'em No Limit ($1/$2) - 2009/07/01 1:20:20 ET
Table 'dBLpiMEy1cezkSKD+ZpCcw' 2-max Seat #1 is the button
Seat 1: NFRtU1s5+WFh9EKwu+KLOQ ($16.30 in chips)
Seat 2: 4rrQUikeMSkuWGHgW80++w ($424.50 in chips)
NFRtU1s5+WFh9EKwu+KLOQ: posts small blind $1
4rrQUikeMSkuWGHgW80++w: posts big blind $2
*** HOLE CARDS ***
NFRtU1s5+WFh9EKwu+KLOQ: raises $14.30 to $16.30 and is all-in
4rrQUikeMSkuWGHgW80++w: folds
NFRtU1s5+WFh9EKwu+KLOQ collected $4 from pot
*** SUMMARY ***
Total pot $4 | Rake $0
Seat 1: NFRtU1s5+WFh9EKwu+KLOQ (button) (small blind) collected ($4)
Seat 2: 4rrQUikeMSkuWGHgW80++w (big blind) folded before Flop



PokerStars Game #59940916352:  Hold'em No Limit ($1/$2) - 2009/07/01 1:20:21 ET
Table 'aSf77Sj8QEnzcc0WaxVD4Q' 6-max Seat #4 is the button
Seat 1: UELtvp+JfwI7XDGVwSxZXA ($167.75 in chips)
Seat 2: vkfxu8f/jMYKUk6Ly4eujw ($200.80 in chips)
Seat 3: 9dpyyjDTCed6nV7JhaUUpw ($225.35 in chips)
Seat 4: YsLQ3BAvgQHWXMAv3Wv6Hg ($265.70 in chips)
Seat 5: VvdR9F3I+2yELkfTVvC1dg ($246 in chips)
Seat 6: vkoJRf3gidxY1pPi0AFWww ($97.20 in chips)
VvdR9F3I+2yELkfTVvC1dg: posts small blind $1
vkoJRf3gidxY1pPi0AFWww: posts big blind $2
*** HOLE CARDS ***
UELtvp+JfwI7XDGVwSxZXA: folds
vkfxu8f/jMYKUk6Ly4eujw: folds
9dpyyjDTCed6nV7JhaUUpw: raises $4 to $6
YsLQ3BAvgQHWXMAv3Wv6Hg: folds
VvdR9F3I+2yELkfTVvC1dg: folds
vkoJRf3gidxY1pPi0AFWww: folds
9dpyyjDTCed6nV7JhaUUpw collected $5 from pot
9dpyyjDTCed6nV7JhaUUpw: doesn't show hand
*** SUMMARY ***
Total pot $5 | Rake $0
Seat 1: UELtvp+JfwI7XDGVwSxZXA folded before Flop (didn't bet)
Seat 2: vkfxu8f/jMYKUk6Ly4eujw folded before Flop (didn't bet)
Seat 3: 9dpyyjDTCed6nV7JhaUUpw collected ($5)
Seat 4: YsLQ3BAvgQHWXMAv3Wv6Hg (button) folded before Flop (didn't bet)
Seat 5: VvdR9F3I+2yELkfTVvC1dg (small blind) folded before Flop
Seat 6: vkoJRf3gidxY1pPi0AFWww (big blind) folded before Flop



PokerStars Game #59940915970:  Hold'em No Limit ($1/$2) - 2009/07/01 1:20:21 ET
Table 'bJQ024BaYSBrW0sXpCZbNQ' 6-max Seat #6 is the button
Seat 1: PCN5rt4TwI1pQE+rAiqI0Q ($284.60 in chips)
Seat 2: 3dAbvkxS5NPQTBAbvpinVg ($200 in chips)
Seat 3: vkfxu8f/jMYKUk6Ly4eujw ($224.10 in chips)
Seat 5: VvdR9F3I+2yELkfTVvC1dg ($200 in chips)
Seat 6: 9dpyyjDTCed6nV7JhaUUpw ($339.95 in chips)
PCN5rt4TwI1pQE+rAiqI0Q: posts small blind $1
3dAbvkxS5NPQTBAbvpinVg: posts big blind $2
*** HOLE CARDS ***
vkfxu8f/jMYKUk6Ly4eujw: folds
VvdR9F3I+2yELkfTVvC1dg: raises $2 to $4
9dpyyjDTCed6nV7JhaUUpw: folds
PCN5rt4TwI1pQE+rAiqI0Q: folds
3dAbvkxS5NPQTBAbvpinVg: folds
VvdR9F3I+2yELkfTVvC1dg collected $5 from pot
VvdR9F3I+2yELkfTVvC1dg: doesn't show hand
*** SUMMARY ***
Total pot $5 | Rake $0
Seat 1: PCN5rt4TwI1pQE+rAiqI0Q (small blind) folded before Flop
Seat 2: 3dAbvkxS5NPQTBAbvpinVg (big blind) folded before Flop
Seat 3: vkfxu8f/jMYKUk6Ly4eujw folded before Flop (didn't bet)
Seat 5: VvdR9F3I+2yELkfTVvC1dg collected ($5)
Seat 6: 9dpyyjDTCed6nV7JhaUUpw (button) folded before Flop (didn't bet)



PokerStars Game #59940917246:  Hold'em No Limit ($1/$2) - 2009/07/01 1:20:23 ET
Table '/dyk+YdRGv90j2box35j8w' 6-max Seat #4 is the button
Seat 2: qCnEYuAE5y5A7bk6fO5/jQ ($493.60 in chips)
Seat 3: sTPOWERd9HWPCNrDBwsVjA ($237.50 in chips)
Seat 4: z/u1YTnkiIDrtp/2cA2dBg ($125.65 in chips)
Seat 5: VvdR9F3I+2yELkfTVvC1dg ($200 in chips)
Seat 6: ZwvXzkkZ3XpMhKfAmVpahw ($356.25 in chips)
VvdR9F3I+2yELkfTVvC1dg: posts small blind $1
ZwvXzkkZ3XpMhKfAmVpahw: posts big blind $2
8srN1dKQePlsv0GyTada+Q: sits out
*** HOLE CARDS ***
qCnEYuAE5y5A7bk6fO5/jQ: folds
sTPOWERd9HWPCNrDBwsVjA: raises $6 to $8
z/u1YTnkiIDrtp/2cA2dBg: calls $8
VvdR9F3I+2yELkfTVvC1dg: folds
ZwvXzkkZ3XpMhKfAmVpahw: folds
*** FLOP *** [Ts 4d 8d]
sTPOWERd9HWPCNrDBwsVjA: bets $10
z/u1YTnkiIDrtp/2cA2dBg: calls $10
*** TURN *** [Ts 4d 8d] [Jh]
sTPOWERd9HWPCNrDBwsVjA: checks
z/u1YTnkiIDrtp/2cA2dBg: bets $10
sTPOWERd9HWPCNrDBwsVjA: calls $10
*** RIVER *** [Ts 4d 8d Jh] [7d]
sTPOWERd9HWPCNrDBwsVjA: bets $36
z/u1YTnkiIDrtp/2cA2dBg: calls $36
*** SHOW DOWN ***
sTPOWERd9HWPCNrDBwsVjA: shows [Kc Tc] (a pair of Tens)
z/u1YTnkiIDrtp/2cA2dBg: shows [Ad Jc] (a pair of Jacks)
z/u1YTnkiIDrtp/2cA2dBg collected $129 from pot
*** SUMMARY ***
Total pot $131 | Rake $2
Board [Ts 4d 8d Jh 7d]
Seat 2: qCnEYuAE5y5A7bk6fO5/jQ folded before Flop (didn't bet)
Seat 3: sTPOWERd9HWPCNrDBwsVjA showed [Kc Tc] and lost with a pair of Tens
Seat 4: z/u1YTnkiIDrtp/2cA2dBg (button) showed [Ad Jc] and won ($129) with a pair of Jacks
Seat 5: VvdR9F3I+2yELkfTVvC1dg (small blind) folded before Flop
Seat 6: ZwvXzkkZ3XpMhKfAmVpahw (big blind) folded before Flop



PokerStars Game #59940918224:  Hold'em No Limit ($1/$2) - 2009/07/01 1:20:25 ET
Table 'jlrIxbrVIG+gjaUYT4za8g' 6-max Seat #1 is the button
Seat 1: ygTTt5ehT4aF86q1a8/R+w ($210.30 in chips)
Seat 2: on4ebXPJvUBOcHOBMQsRSg ($65 in chips)
Seat 3: RUZs7P4uzWavoA6iEpDKLw ($142.75 in chips)
Seat 4: 8srN1dKQePlsv0GyTada+Q ($299.70 in chips)
Seat 5: AyBB0k3Dcl7xbXUeGMw06g ($77.20 in chips)
Seat 6: vkfxu8f/jMYKUk6Ly4eujw ($338 in chips)
on4ebXPJvUBOcHOBMQsRSg: posts small blind $1
RUZs7P4uzWavoA6iEpDKLw: posts big blind $2
*** HOLE CARDS ***
8srN1dKQePlsv0GyTada+Q: calls $2
AyBB0k3Dcl7xbXUeGMw06g: calls $2
vkfxu8f/jMYKUk6Ly4eujw: folds
ygTTt5ehT4aF86q1a8/R+w has timed out
ygTTt5ehT4aF86q1a8/R+w: folds
ygTTt5ehT4aF86q1a8/R+w is sitting out
on4ebXPJvUBOcHOBMQsRSg: folds
RUZs7P4uzWavoA6iEpDKLw: checks
*** FLOP *** [5d 7d 2d]
RUZs7P4uzWavoA6iEpDKLw: checks
ygTTt5ehT4aF86q1a8/R+w has returned
8srN1dKQePlsv0GyTada+Q: bets $6
AyBB0k3Dcl7xbXUeGMw06g: folds
RUZs7P4uzWavoA6iEpDKLw: folds
8srN1dKQePlsv0GyTada+Q collected $6.65 from pot
*** SUMMARY ***
Total pot $7 | Rake $0.35
Board [5d 7d 2d]
Seat 1: ygTTt5ehT4aF86q1a8/R+w (button) folded before Flop (didn't bet)
Seat 2: on4ebXPJvUBOcHOBMQsRSg (small blind) folded before Flop
Seat 3: RUZs7P4uzWavoA6iEpDKLw (big blind) folded on the Flop
Seat 4: 8srN1dKQePlsv0GyTada+Q collected ($6.65)
Seat 5: AyBB0k3Dcl7xbXUeGMw06g folded on the Flop
Seat 6: vkfxu8f/jMYKUk6Ly4eujw folded before Flop (didn't bet)



PokerStars Game #59940919644:  Hold'em No Limit ($1/$2) - 2009/07/01 1:20:27 ET
Table 'TsEDkiO4tzCTCzJ7tNdEqw' 6-max Seat #2 is the button
Seat 1: MfXQsYD8pGeCS7XOtyV+vw ($26.90 in chips)
Seat 2: 4dcDwIHRm96PwtqkpQiuiA ($84.10 in chips)
Seat 3: wgRvjVPZSQvqNGiyR1jwSA ($76 in chips)
Seat 4: K8MXCrNAVYlMnnCeM32Kxw ($49.05 in chips)
Seat 5: VvdR9F3I+2yELkfTVvC1dg ($202.50 in chips)
Seat 6: uCqEjnxh2/vFBjKYkfTOkw ($264.25 in chips)
wgRvjVPZSQvqNGiyR1jwSA: posts small blind $1
K8MXCrNAVYlMnnCeM32Kxw: posts big blind $2
*** HOLE CARDS ***
VvdR9F3I+2yELkfTVvC1dg: folds
uCqEjnxh2/vFBjKYkfTOkw: folds
MfXQsYD8pGeCS7XOtyV+vw: calls $2
4dcDwIHRm96PwtqkpQiuiA: folds
wgRvjVPZSQvqNGiyR1jwSA: calls $1
K8MXCrNAVYlMnnCeM32Kxw: raises $10 to $12
MfXQsYD8pGeCS7XOtyV+vw: folds
wgRvjVPZSQvqNGiyR1jwSA: folds
K8MXCrNAVYlMnnCeM32Kxw collected $6 from pot
*** SUMMARY ***
Total pot $6 | Rake $0
Seat 1: MfXQsYD8pGeCS7XOtyV+vw folded before Flop
Seat 2: 4dcDwIHRm96PwtqkpQiuiA (button) folded before Flop (didn't bet)
Seat 3: wgRvjVPZSQvqNGiyR1jwSA (small blind) folded before Flop
Seat 4: K8MXCrNAVYlMnnCeM32Kxw (big blind) collected ($6)
Seat 5: VvdR9F3I+2yELkfTVvC1dg folded before Flop (didn't bet)
Seat 6: uCqEjnxh2/vFBjKYkfTOkw folded before Flop (didn't bet)



PokerStars Game #59940919978:  Hold'em No Limit ($1/$2) - 2009/07/01 1:20:28 ET
Table 'ztv6V3FN2bQ9nmJPPdx6nQ' 6-max Seat #5 is the button
Seat 1: 6fLdOUCRtX71xbVRhJEq8w ($218 in chips)
Seat 2: 5Y+ZGWLI4gnlpApDX5vy1A ($399.40 in chips)
Seat 3: ubtx4Z5L+AcK71MTvYiGVw ($203 in chips)
Seat 4: UaZ5yj+6LjtWqMQg2QskUw ($115.80 in chips)
Seat 5: sTPOWERd9HWPCNrDBwsVjA ($251 in chips)
Seat 6: mfy7uGZcqA2PVQqEVbJ7+g ($118.45 in chips)
mfy7uGZcqA2PVQqEVbJ7+g: posts small blind $1
6fLdOUCRtX71xbVRhJEq8w: posts big blind $2
*** HOLE CARDS ***
5Y+ZGWLI4gnlpApDX5vy1A: calls $2
ubtx4Z5L+AcK71MTvYiGVw: raises $8 to $10
UaZ5yj+6LjtWqMQg2QskUw: folds
sTPOWERd9HWPCNrDBwsVjA: folds
mfy7uGZcqA2PVQqEVbJ7+g: folds
6fLdOUCRtX71xbVRhJEq8w: folds
5Y+ZGWLI4gnlpApDX5vy1A: calls $8
*** FLOP *** [4h 5d 7c]
5Y+ZGWLI4gnlpApDX5vy1A: checks
ubtx4Z5L+AcK71MTvYiGVw: checks
*** TURN *** [4h 5d 7c] [As]
5Y+ZGWLI4gnlpApDX5vy1A: checks
ubtx4Z5L+AcK71MTvYiGVw: checks
*** RIVER *** [4h 5d 7c As] [9d]
5Y+ZGWLI4gnlpApDX5vy1A: checks
ubtx4Z5L+AcK71MTvYiGVw: checks
*** SHOW DOWN ***
5Y+ZGWLI4gnlpApDX5vy1A: shows [Tc Td] (a pair of Tens)
ubtx4Z5L+AcK71MTvYiGVw: mucks hand
5Y+ZGWLI4gnlpApDX5vy1A collected $21.85 from pot
*** SUMMARY ***
Total pot $23 | Rake $1.15
Board [4h 5d 7c As 9d]
Seat 1: 6fLdOUCRtX71xbVRhJEq8w (big blind) folded before Flop
Seat 2: 5Y+ZGWLI4gnlpApDX5vy1A showed [Tc Td] and won ($21.85) with a pair of Tens
Seat 3: ubtx4Z5L+AcK71MTvYiGVw mucked
Seat 4: UaZ5yj+6LjtWqMQg2QskUw folded before Flop (didn't bet)
Seat 5: sTPOWERd9HWPCNrDBwsVjA (button) folded before Flop (didn't bet)
Seat 6: mfy7uGZcqA2PVQqEVbJ7+g (small blind) folded before Flop



PokerStars Game #59940921212:  Hold'em No Limit ($1/$2) - 2009/07/01 1:20:30 ET
Table 'QxerF7GUfCbl+4a8XaTB2w' 6-max Seat #2 is the button
Seat 1: o9jamqIi6sTTRSqudgboRA ($295.50 in chips)
Seat 2: vkfxu8f/jMYKUk6Ly4eujw ($199.80 in chips)
Seat 3: m7mYVfnCOK5TE/VkN/FhOg ($282.10 in chips)
Seat 4: 09BNF4quPDzanQzM8vc6WA ($40.55 in chips)
Seat 5: YsLQ3BAvgQHWXMAv3Wv6Hg ($201.75 in chips)
Seat 6: VvdR9F3I+2yELkfTVvC1dg ($200 in chips)
m7mYVfnCOK5TE/VkN/FhOg: posts small blind $1
09BNF4quPDzanQzM8vc6WA: posts big blind $2
*** HOLE CARDS ***
YsLQ3BAvgQHWXMAv3Wv6Hg: folds
VvdR9F3I+2yELkfTVvC1dg: folds
o9jamqIi6sTTRSqudgboRA: raises $4 to $6
vkfxu8f/jMYKUk6Ly4eujw: calls $6
m7mYVfnCOK5TE/VkN/FhOg: folds
09BNF4quPDzanQzM8vc6WA: folds
*** FLOP *** [Jh 4h 6d]
o9jamqIi6sTTRSqudgboRA: checks
vkfxu8f/jMYKUk6Ly4eujw: bets $9
o9jamqIi6sTTRSqudgboRA: folds
vkfxu8f/jMYKUk6Ly4eujw collected $14.25 from pot
vkfxu8f/jMYKUk6Ly4eujw: doesn't show hand
*** SUMMARY ***
Total pot $15 | Rake $0.75
Board [Jh 4h 6d]
Seat 1: o9jamqIi6sTTRSqudgboRA folded on the Flop
Seat 2: vkfxu8f/jMYKUk6Ly4eujw (button) collected ($14.25)
Seat 3: m7mYVfnCOK5TE/VkN/FhOg (small blind) folded before Flop
Seat 4: 09BNF4quPDzanQzM8vc6WA (big blind) folded before Flop
Seat 5: YsLQ3BAvgQHWXMAv3Wv6Hg folded before Flop (didn't bet)
Seat 6: VvdR9F3I+2yELkfTVvC1dg folded before Flop (didn't bet)



PokerStars Game #59940923220:  Hold'em No Limit ($1/$2) - 2009/07/01 1:20:33 ET
Table 'pPQgcj9XT9CHBsbo1WTBug' 6-max Seat #1 is the button
Seat 1: DFVYDA6dKQy7R7mGIKogZA ($118.75 in chips)
Seat 2: qXDd0ZyMIse0OBu8pxeQ3Q ($216.30 in chips)
Seat 3: 54yWzRRgS0oZ+S6LwZBxMQ ($40 in chips)
Seat 4: gqlysXCbT8V54f/1lf9h3A ($44.75 in chips)
Seat 5: vkfxu8f/jMYKUk6Ly4eujw ($226.10 in chips)
Seat 6: Yr7pZltpy3IUNdKS9PCEiw ($307.30 in chips)
qXDd0ZyMIse0OBu8pxeQ3Q: posts small blind $1
54yWzRRgS0oZ+S6LwZBxMQ: posts big blind $2
*** HOLE CARDS ***
gqlysXCbT8V54f/1lf9h3A: calls $2
vkfxu8f/jMYKUk6Ly4eujw: folds
Yr7pZltpy3IUNdKS9PCEiw: folds
DFVYDA6dKQy7R7mGIKogZA: calls $2
qXDd0ZyMIse0OBu8pxeQ3Q: folds
54yWzRRgS0oZ+S6LwZBxMQ: checks
*** FLOP *** [7s 3s 4c]
54yWzRRgS0oZ+S6LwZBxMQ: checks
gqlysXCbT8V54f/1lf9h3A: bets $4
DFVYDA6dKQy7R7mGIKogZA: calls $4
54yWzRRgS0oZ+S6LwZBxMQ: folds
*** TURN *** [7s 3s 4c] [8d]
gqlysXCbT8V54f/1lf9h3A: bets $4
DFVYDA6dKQy7R7mGIKogZA: calls $4
*** RIVER *** [7s 3s 4c 8d] [Ts]
gqlysXCbT8V54f/1lf9h3A: checks
DFVYDA6dKQy7R7mGIKogZA: bets $16
gqlysXCbT8V54f/1lf9h3A: folds
DFVYDA6dKQy7R7mGIKogZA collected $21.90 from pot
*** SUMMARY ***
Total pot $23 | Rake $1.10
Board [7s 3s 4c 8d Ts]
Seat 1: DFVYDA6dKQy7R7mGIKogZA (button) collected ($21.90)
Seat 2: qXDd0ZyMIse0OBu8pxeQ3Q (small blind) folded before Flop
Seat 3: 54yWzRRgS0oZ+S6LwZBxMQ (big blind) folded on the Flop
Seat 4: gqlysXCbT8V54f/1lf9h3A folded on the River
Seat 5: vkfxu8f/jMYKUk6Ly4eujw folded before Flop (didn't bet)
Seat 6: Yr7pZltpy3IUNdKS9PCEiw folded before Flop (didn't bet)



PokerStars Game #59940922966:  Hold'em No Limit ($1/$2) - 2009/07/01 1:20:33 ET
Table 'LL4bDFyhj5hsMpzaDugJZg' 6-max Seat #5 is the button
Seat 1: FwvID/fQGlpY3soi/lMTww ($88.95 in chips)
Seat 2: IZng3w8jiJHHp3LbYKLi4w ($53.15 in chips)
Seat 3: iI/NMpRxMkGieArQEhACSA ($279.70 in chips)
Seat 4: 8srN1dKQePlsv0GyTada+Q ($314.75 in chips)
Seat 5: A2GTwTiwkb1ilNWgW487Vg ($69.20 in chips)
Seat 6: 692Q4sfB0gTElzS0WMeg+A ($209.10 in chips)
692Q4sfB0gTElzS0WMeg+A: posts small blind $1
FwvID/fQGlpY3soi/lMTww: posts big blind $2
*** HOLE CARDS ***
IZng3w8jiJHHp3LbYKLi4w: folds
iI/NMpRxMkGieArQEhACSA: raises $4 to $6
8srN1dKQePlsv0GyTada+Q: folds
A2GTwTiwkb1ilNWgW487Vg: folds
692Q4sfB0gTElzS0WMeg+A: folds
FwvID/fQGlpY3soi/lMTww: folds
iI/NMpRxMkGieArQEhACSA collected $5 from pot
*** SUMMARY ***
Total pot $5 | Rake $0
Seat 1: FwvID/fQGlpY3soi/lMTww (big blind) folded before Flop
Seat 2: IZng3w8jiJHHp3LbYKLi4w folded before Flop (didn't bet)
Seat 3: iI/NMpRxMkGieArQEhACSA collected ($5)
Seat 4: 8srN1dKQePlsv0GyTada+Q folded before Flop (didn't bet)
Seat 5: A2GTwTiwkb1ilNWgW487Vg (button) folded before Flop (didn't bet)
Seat 6: 692Q4sfB0gTElzS0WMeg+A (small blind) folded before Flop



PokerStars Game #59940923710:  Hold'em No Limit ($1/$2) - 2009/07/01 1:20:34 ET
Table '+hSnXFQrGw1PlVgTnuj+sA' 6-max Seat #5 is the button
Seat 1: 2ccIJhDj+3JapvS7swVZEg ($287.85 in chips)
Seat 2: o9jamqIi6sTTRSqudgboRA ($281.90 in chips)
Seat 3: fE+LHW/7rpfXW14g8LhGjA ($43.65 in chips)
Seat 4: J4iH5epwXbmODnojR/VRxA ($194.10 in chips)
Seat 5: VvdR9F3I+2yELkfTVvC1dg ($200 in chips)
Seat 6: AuiGltq875lmaKHBsjZVGg ($86.75 in chips)
AuiGltq875lmaKHBsjZVGg: posts small blind $1
2ccIJhDj+3JapvS7swVZEg: posts big blind $2
*** HOLE CARDS ***
o9jamqIi6sTTRSqudgboRA: folds
fE+LHW/7rpfXW14g8LhGjA: folds
J4iH5epwXbmODnojR/VRxA: calls $2
VvdR9F3I+2yELkfTVvC1dg: raises $6 to $8
AuiGltq875lmaKHBsjZVGg: folds
2ccIJhDj+3JapvS7swVZEg: folds
J4iH5epwXbmODnojR/VRxA: calls $6
*** FLOP *** [4s 3h Jc]
J4iH5epwXbmODnojR/VRxA: bets $2
VvdR9F3I+2yELkfTVvC1dg: raises $16.50 to $18.50
J4iH5epwXbmODnojR/VRxA: calls $16.50
*** TURN *** [4s 3h Jc] [Qs]
J4iH5epwXbmODnojR/VRxA: checks
VvdR9F3I+2yELkfTVvC1dg: bets $38.85
J4iH5epwXbmODnojR/VRxA: folds
VvdR9F3I+2yELkfTVvC1dg collected $53.25 from pot
VvdR9F3I+2yELkfTVvC1dg: doesn't show hand
*** SUMMARY ***
Total pot $56 | Rake $2.75
Board [4s 3h Jc Qs]
Seat 1: 2ccIJhDj+3JapvS7swVZEg (big blind) folded before Flop
Seat 2: o9jamqIi6sTTRSqudgboRA folded before Flop (didn't bet)
Seat 3: fE+LHW/7rpfXW14g8LhGjA folded before Flop (didn't bet)
Seat 4: J4iH5epwXbmODnojR/VRxA folded on the Turn
Seat 5: VvdR9F3I+2yELkfTVvC1dg (button) collected ($53.25)
Seat 6: AuiGltq875lmaKHBsjZVGg (small blind) folded before Flop



PokerStars Game #59940923424:  Hold'em No Limit ($1/$2) - 2009/07/01 1:20:34 ET
Table 'NmY84NAf9Mh0ckAckHnh5g' 2-max Seat #2 is the button
Seat 1: 6hvg964TSqZ3AL/0XK9aVQ ($269.10 in chips)
Seat 2: RwDoM55ZeQuI2ADyJhOb2Q ($739.90 in chips)
RwDoM55ZeQuI2ADyJhOb2Q: posts small blind $1
6hvg964TSqZ3AL/0XK9aVQ: posts big blind $2
*** HOLE CARDS ***
RwDoM55ZeQuI2ADyJhOb2Q: raises $4 to $6
6hvg964TSqZ3AL/0XK9aVQ: folds
RwDoM55ZeQuI2ADyJhOb2Q collected $4 from pot
RwDoM55ZeQuI2ADyJhOb2Q: doesn't show hand
*** SUMMARY ***
Total pot $4 | Rake $0
Seat 1: 6hvg964TSqZ3AL/0XK9aVQ (big blind) folded before Flop
Seat 2: RwDoM55ZeQuI2ADyJhOb2Q (button) (small blind) collected ($4)



PokerStars Game #59940926162:  Hold'em No Limit ($1/$2) - 2009/07/01 1:20:38 ET
Table 'qVXak+oTeDXMGbWa4sDU5Q' 9-max Seat #6 is the button
Seat 1: H6Z4+qu8gR0VUiPOijndVg ($252.55 in chips)
Seat 2: rW/MyplHylMSBRaoRUzWrg ($40 in chips)
Seat 3: WUlHm+ydPPHG7Lb0rePSdA ($172.65 in chips)
Seat 4: lQYT23h5QCUVZAKxjOO39Q ($102.25 in chips)
Seat 5: FWGiDqRwvLeKmHq9t4Jy9w ($268.80 in chips)
Seat 6: GX1heJ+DSsvm7gzSPsYhhQ ($34 in chips)
Seat 7: PfmlvZlFiss79a6IoEr11g ($122.30 in chips)
Seat 9: CkE3IyJF1KvdaAOmZY5XqQ ($203 in chips)
PfmlvZlFiss79a6IoEr11g: posts small blind $1
TAfo4veNRaRlzDXMMYS3Jg: is sitting out
CkE3IyJF1KvdaAOmZY5XqQ: posts big blind $2
*** HOLE CARDS ***
TAfo4veNRaRlzDXMMYS3Jg leaves the table
H6Z4+qu8gR0VUiPOijndVg: folds
rW/MyplHylMSBRaoRUzWrg: folds
WUlHm+ydPPHG7Lb0rePSdA: folds
lQYT23h5QCUVZAKxjOO39Q: folds
FWGiDqRwvLeKmHq9t4Jy9w: folds
GX1heJ+DSsvm7gzSPsYhhQ: folds
PfmlvZlFiss79a6IoEr11g: folds
CkE3IyJF1KvdaAOmZY5XqQ collected $2 from pot
*** SUMMARY ***
Total pot $2 | Rake $0
Seat 1: H6Z4+qu8gR0VUiPOijndVg folded before Flop (didn't bet)
Seat 2: rW/MyplHylMSBRaoRUzWrg folded before Flop (didn't bet)
Seat 3: WUlHm+ydPPHG7Lb0rePSdA folded before Flop (didn't bet)
Seat 4: lQYT23h5QCUVZAKxjOO39Q folded before Flop (didn't bet)
Seat 5: FWGiDqRwvLeKmHq9t4Jy9w folded before Flop (didn't bet)
Seat 6: GX1heJ+DSsvm7gzSPsYhhQ (button) folded before Flop (didn't bet)
Seat 7: PfmlvZlFiss79a6IoEr11g (small blind) folded before Flop
Seat 9: CkE3IyJF1KvdaAOmZY5XqQ (big blind) collected ($2)



PokerStars Game #59940927254:  Hold'em No Limit ($1/$2) - 2009/07/01 1:20:40 ET
Table '3WCXyaiCAbqSShQu7FIjvA' 9-max Seat #4 is the button
Seat 1: kTCkABD1UUldS9DFRGfCwQ ($151.60 in chips)
Seat 2: 1zQMh8lHgW3t2YhVeA+09A ($14.80 in chips)
Seat 3: 5Q8U6iZbeO7xJSS4qvDP5g ($200 in chips)
Seat 4: waEF/+pxZTxNo4FvsORuXg ($77 in chips)
Seat 5: CkE3IyJF1KvdaAOmZY5XqQ ($200 in chips)
Seat 6: 5jQlngvMSqM/WoonOcR5kw ($304.35 in chips)
Seat 7: QHxJjpVYwitg9krW6wZgJA ($200 in chips)
Seat 8: 1CtiZuXDFaJL1dJPQKyi8Q ($234.25 in chips)
Seat 9: FiXPLJyqb24l32QST2TInw ($151.55 in chips)
CkE3IyJF1KvdaAOmZY5XqQ: posts small blind $1
5jQlngvMSqM/WoonOcR5kw: posts big blind $2
*** HOLE CARDS ***
QHxJjpVYwitg9krW6wZgJA said, "nh"
QHxJjpVYwitg9krW6wZgJA: folds
QHxJjpVYwitg9krW6wZgJA is sitting out
1CtiZuXDFaJL1dJPQKyi8Q: folds
FiXPLJyqb24l32QST2TInw: calls $2
kTCkABD1UUldS9DFRGfCwQ: folds
1zQMh8lHgW3t2YhVeA+09A: calls $2
5Q8U6iZbeO7xJSS4qvDP5g: folds
waEF/+pxZTxNo4FvsORuXg: folds
CkE3IyJF1KvdaAOmZY5XqQ: folds
5jQlngvMSqM/WoonOcR5kw: raises $2 to $4
FiXPLJyqb24l32QST2TInw: calls $2
1zQMh8lHgW3t2YhVeA+09A: calls $2
*** FLOP *** [5h 5c 2d]
5jQlngvMSqM/WoonOcR5kw: checks
FiXPLJyqb24l32QST2TInw: bets $2
1zQMh8lHgW3t2YhVeA+09A: calls $2
5jQlngvMSqM/WoonOcR5kw: calls $2
*** TURN *** [5h 5c 2d] [4s]
5jQlngvMSqM/WoonOcR5kw: checks
FiXPLJyqb24l32QST2TInw: bets $8
1zQMh8lHgW3t2YhVeA+09A: folds
5jQlngvMSqM/WoonOcR5kw: calls $8
*** RIVER *** [5h 5c 2d 4s] [Ks]
5jQlngvMSqM/WoonOcR5kw: bets $6
FiXPLJyqb24l32QST2TInw: calls $6
*** SHOW DOWN ***
5jQlngvMSqM/WoonOcR5kw: shows [4c Qc] (two pair, Fives and Fours)
FiXPLJyqb24l32QST2TInw: shows [7h Kd] (two pair, Kings and Fives)
FiXPLJyqb24l32QST2TInw collected $44.75 from pot
*** SUMMARY ***
Total pot $47 | Rake $2.25
Board [5h 5c 2d 4s Ks]
Seat 1: kTCkABD1UUldS9DFRGfCwQ folded before Flop (didn't bet)
Seat 2: 1zQMh8lHgW3t2YhVeA+09A folded on the Turn
Seat 3: 5Q8U6iZbeO7xJSS4qvDP5g folded before Flop (didn't bet)
Seat 4: waEF/+pxZTxNo4FvsORuXg (button) folded before Flop (didn't bet)
Seat 5: CkE3IyJF1KvdaAOmZY5XqQ (small blind) folded before Flop
Seat 6: 5jQlngvMSqM/WoonOcR5kw (big blind) showed [4c Qc] and lost with two pair, Fives and Fours
Seat 7: QHxJjpVYwitg9krW6wZgJA folded before Flop (didn't bet)
Seat 8: 1CtiZuXDFaJL1dJPQKyi8Q folded before Flop (didn't bet)
Seat 9: FiXPLJyqb24l32QST2TInw showed [7h Kd] and won ($44.75) with two pair, Kings and Fives



PokerStars Game #59940927388:  Hold'em No Limit ($1/$2) - 2009/07/01 1:20:41 ET
Table 'rsKRKlGHlxVyqJxzO2a2Ow' 9-max Seat #5 is the button
Seat 1: uYWfQJg2hgHLxri6/uVJiw ($347.20 in chips)
Seat 2: QHxJjpVYwitg9krW6wZgJA ($267.30 in chips)
Seat 3: zTcFtoHqqK4550YMZ8Y14Q ($60.50 in chips)
Seat 4: 31HuO+DQxppUQEedBWukug ($94 in chips)
Seat 5: 5Q8U6iZbeO7xJSS4qvDP5g ($202 in chips)
Seat 6: H6Z4+qu8gR0VUiPOijndVg ($200 in chips)
Seat 7: GX1heJ+DSsvm7gzSPsYhhQ ($40 in chips)
Seat 8: CkE3IyJF1KvdaAOmZY5XqQ ($220.75 in chips)
Seat 9: gRbvhSUVg+TNaTjaJecIRw ($72 in chips)
H6Z4+qu8gR0VUiPOijndVg: posts small blind $1
GX1heJ+DSsvm7gzSPsYhhQ: posts big blind $2
*** HOLE CARDS ***
CkE3IyJF1KvdaAOmZY5XqQ: folds
gRbvhSUVg+TNaTjaJecIRw: folds
uYWfQJg2hgHLxri6/uVJiw: folds
QHxJjpVYwitg9krW6wZgJA: raises $4 to $6
zTcFtoHqqK4550YMZ8Y14Q: folds
31HuO+DQxppUQEedBWukug: folds
5Q8U6iZbeO7xJSS4qvDP5g: folds
H6Z4+qu8gR0VUiPOijndVg: folds
GX1heJ+DSsvm7gzSPsYhhQ: calls $4
*** FLOP *** [4c Js Kd]
GX1heJ+DSsvm7gzSPsYhhQ: checks
QHxJjpVYwitg9krW6wZgJA: bets $6
GX1heJ+DSsvm7gzSPsYhhQ: folds
QHxJjpVYwitg9krW6wZgJA collected $12.35 from pot
QHxJjpVYwitg9krW6wZgJA: doesn't show hand
*** SUMMARY ***
Total pot $13 | Rake $0.65
Board [4c Js Kd]
Seat 1: uYWfQJg2hgHLxri6/uVJiw folded before Flop (didn't bet)
Seat 2: QHxJjpVYwitg9krW6wZgJA collected ($12.35)
Seat 3: zTcFtoHqqK4550YMZ8Y14Q folded before Flop (didn't bet)
Seat 4: 31HuO+DQxppUQEedBWukug folded before Flop (didn't bet)
Seat 5: 5Q8U6iZbeO7xJSS4qvDP5g (button) folded before Flop (didn't bet)
Seat 6: H6Z4+qu8gR0VUiPOijndVg (small blind) folded before Flop
Seat 7: GX1heJ+DSsvm7gzSPsYhhQ (big blind) folded on the Flop
Seat 8: CkE3IyJF1KvdaAOmZY5XqQ folded before Flop (didn't bet)
Seat 9: gRbvhSUVg+TNaTjaJecIRw folded before Flop (didn't bet)



PokerStars Game #59940927514:  Hold'em No Limit ($1/$2) - 2009/07/01 1:20:41 ET
Table 'NmY84NAf9Mh0ckAckHnh5g' 2-max Seat #1 is the button
Seat 1: 6hvg964TSqZ3AL/0XK9aVQ ($267.10 in chips)
Seat 2: RwDoM55ZeQuI2ADyJhOb2Q ($741.90 in chips)
6hvg964TSqZ3AL/0XK9aVQ: posts small blind $1
RwDoM55ZeQuI2ADyJhOb2Q: posts big blind $2
*** HOLE CARDS ***
6hvg964TSqZ3AL/0XK9aVQ: calls $1
RwDoM55ZeQuI2ADyJhOb2Q: raises $6 to $8
6hvg964TSqZ3AL/0XK9aVQ: calls $6
*** FLOP *** [Qh 5d Ad]
RwDoM55ZeQuI2ADyJhOb2Q: bets $12
6hvg964TSqZ3AL/0XK9aVQ: calls $12
*** TURN *** [Qh 5d Ad] [3s]
RwDoM55ZeQuI2ADyJhOb2Q: checks
6hvg964TSqZ3AL/0XK9aVQ: checks
*** RIVER *** [Qh 5d Ad 3s] [5c]
RwDoM55ZeQuI2ADyJhOb2Q: checks
6hvg964TSqZ3AL/0XK9aVQ: bets $26
RwDoM55ZeQuI2ADyJhOb2Q: calls $26
*** SHOW DOWN ***
6hvg964TSqZ3AL/0XK9aVQ: shows [Ac 2c] (two pair, Aces and Fives)
RwDoM55ZeQuI2ADyJhOb2Q: mucks hand
6hvg964TSqZ3AL/0XK9aVQ collected $91.50 from pot
*** SUMMARY ***
Total pot $92 | Rake $0.50
Board [Qh 5d Ad 3s 5c]
Seat 1: 6hvg964TSqZ3AL/0XK9aVQ (button) (small blind) showed [Ac 2c] and won ($91.50) with two pair, Aces and Fives
Seat 2: RwDoM55ZeQuI2ADyJhOb2Q (big blind) mucked



PokerStars Game #59940928524:  Hold'em No Limit ($1/$2) - 2009/07/01 1:20:42 ET
Table 'kq5zaQ+1hLNf8LZfGnbTAA' 6-max Seat #2 is the button
Seat 1: 8srN1dKQePlsv0GyTada+Q ($228 in chips)
Seat 2: nXDI8Y/S6POzRwANu3d8hQ ($41.75 in chips)
Seat 3: vkfxu8f/jMYKUk6Ly4eujw ($228.95 in chips)
Seat 4: 3dAbvkxS5NPQTBAbvpinVg ($200 in chips)
Seat 5: kfASJqTbXek+zc8ZKsZL1Q ($152.40 in chips)
Seat 6: mfy7uGZcqA2PVQqEVbJ7+g ($199.25 in chips)
vkfxu8f/jMYKUk6Ly4eujw: posts small blind $1
3dAbvkxS5NPQTBAbvpinVg: posts big blind $2
*** HOLE CARDS ***
kfASJqTbXek+zc8ZKsZL1Q: raises $4 to $6
mfy7uGZcqA2PVQqEVbJ7+g: folds
8srN1dKQePlsv0GyTada+Q: folds
nXDI8Y/S6POzRwANu3d8hQ: folds
vkfxu8f/jMYKUk6Ly4eujw: folds
3dAbvkxS5NPQTBAbvpinVg: folds
kfASJqTbXek+zc8ZKsZL1Q collected $5 from pot
kfASJqTbXek+zc8ZKsZL1Q: doesn't show hand
*** SUMMARY ***
Total pot $5 | Rake $0
Seat 1: 8srN1dKQePlsv0GyTada+Q folded before Flop (didn't bet)
Seat 2: nXDI8Y/S6POzRwANu3d8hQ (button) folded before Flop (didn't bet)
Seat 3: vkfxu8f/jMYKUk6Ly4eujw (small blind) folded before Flop
Seat 4: 3dAbvkxS5NPQTBAbvpinVg (big blind) folded before Flop
Seat 5: kfASJqTbXek+zc8ZKsZL1Q collected ($5)
Seat 6: mfy7uGZcqA2PVQqEVbJ7+g folded before Flop (didn't bet)



PokerStars Game #59940929996:  Hold'em No Limit ($1/$2) - 2009/07/01 1:20:45 ET
Table 'gnHBqWll9O3fxG7Ojkz/ng' 9-max Seat #3 is the button
Seat 1: TAfo4veNRaRlzDXMMYS3Jg ($37 in chips)
Seat 2: H6Z4+qu8gR0VUiPOijndVg ($338.60 in chips)
Seat 3: 5Q8U6iZbeO7xJSS4qvDP5g ($215 in chips)
Seat 5: rBQDMkKm9cZn6M9NPsiVew ($237.45 in chips)
Seat 6: /inIs/z/PcX+TniIFpaxpg ($45 in chips)
Seat 7: jqui3xAWCkcdPW36a6BD+w ($342.40 in chips)
Seat 8: cM6efHzdxoqYm0EQKP4TTQ ($105.05 in chips)
Seat 9: sN6yR5I5zFq/WFyIz5UfzQ ($201 in chips)
NoKY4U was removed from the table for failing to post
rBQDMkKm9cZn6M9NPsiVew: posts small blind $1
/inIs/z/PcX+TniIFpaxpg: posts big blind $2
*** HOLE CARDS ***
jqui3xAWCkcdPW36a6BD+w: folds
cM6efHzdxoqYm0EQKP4TTQ: calls $2
sN6yR5I5zFq/WFyIz5UfzQ: folds
TAfo4veNRaRlzDXMMYS3Jg: folds
H6Z4+qu8gR0VUiPOijndVg: folds
5Q8U6iZbeO7xJSS4qvDP5g: folds
rBQDMkKm9cZn6M9NPsiVew: folds
/inIs/z/PcX+TniIFpaxpg: checks
*** FLOP *** [Jd 6c 8h]
/inIs/z/PcX+TniIFpaxpg: checks
cM6efHzdxoqYm0EQKP4TTQ: checks
*** TURN *** [Jd 6c 8h] [Qc]
/inIs/z/PcX+TniIFpaxpg: checks
cM6efHzdxoqYm0EQKP4TTQ: checks
*** RIVER *** [Jd 6c 8h Qc] [8s]
/inIs/z/PcX+TniIFpaxpg: checks
cM6efHzdxoqYm0EQKP4TTQ: checks
*** SHOW DOWN ***
/inIs/z/PcX+TniIFpaxpg: shows [3c 6d] (two pair, Eights and Sixes)
cM6efHzdxoqYm0EQKP4TTQ: mucks hand
/inIs/z/PcX+TniIFpaxpg collected $4.75 from pot
*** SUMMARY ***
Total pot $5 | Rake $0.25
Board [Jd 6c 8h Qc 8s]
Seat 1: TAfo4veNRaRlzDXMMYS3Jg folded before Flop (didn't bet)
Seat 2: H6Z4+qu8gR0VUiPOijndVg folded before Flop (didn't bet)
Seat 3: 5Q8U6iZbeO7xJSS4qvDP5g (button) folded before Flop (didn't bet)
Seat 5: rBQDMkKm9cZn6M9NPsiVew (small blind) folded before Flop
Seat 6: /inIs/z/PcX+TniIFpaxpg (big blind) showed [3c 6d] and won ($4.75) with two pair, Eights and Sixes
Seat 7: jqui3xAWCkcdPW36a6BD+w folded before Flop (didn't bet)
Seat 8: cM6efHzdxoqYm0EQKP4TTQ mucked
Seat 9: sN6yR5I5zFq/WFyIz5UfzQ folded before Flop (didn't bet)



PokerStars Game #59940930244:  Hold'em No Limit ($1/$2) - 2009/07/01 1:20:45 ET
Table 'gftD4mDF7mIFKvSrIyaRbw' 9-max Seat #8 is the button
Seat 1: 31HuO+DQxppUQEedBWukug ($106 in chips)
Seat 2: GX1heJ+DSsvm7gzSPsYhhQ ($37 in chips)
Seat 3: CUZwDpLTQKhzarPe+JCLOQ ($200.10 in chips)
Seat 5: mpsfNtnMVDqQHTe92AhIdw ($120.50 in chips)
Seat 6: 2NvwF8W2nzsbS+G//yLAbQ ($174.05 in chips)
Seat 8: MpL4DeEqGQu0H8TJEbEOrg ($44 in chips)
Seat 9: F7m34OOfAQ7annesMHVjKw ($157.10 in chips)
F7m34OOfAQ7annesMHVjKw: posts small blind $1
31HuO+DQxppUQEedBWukug: posts big blind $2
/inIs/z/PcX+TniIFpaxpg: sits out
+T/63sAeZzWyHchahJ36GQ: sits out
*** HOLE CARDS ***
GX1heJ+DSsvm7gzSPsYhhQ: folds
CUZwDpLTQKhzarPe+JCLOQ: folds
mpsfNtnMVDqQHTe92AhIdw: raises $4 to $6
2NvwF8W2nzsbS+G//yLAbQ: calls $6
MpL4DeEqGQu0H8TJEbEOrg: folds
F7m34OOfAQ7annesMHVjKw has timed out
F7m34OOfAQ7annesMHVjKw: folds
F7m34OOfAQ7annesMHVjKw is sitting out
F7m34OOfAQ7annesMHVjKw has returned
31HuO+DQxppUQEedBWukug: calls $4
*** FLOP *** [Tc As 4d]
31HuO+DQxppUQEedBWukug: checks
mpsfNtnMVDqQHTe92AhIdw: bets $8
2NvwF8W2nzsbS+G//yLAbQ: calls $8
31HuO+DQxppUQEedBWukug: folds
*** TURN *** [Tc As 4d] [3d]
mpsfNtnMVDqQHTe92AhIdw: bets $16
2NvwF8W2nzsbS+G//yLAbQ: calls $16
*** RIVER *** [Tc As 4d 3d] [8h]
mpsfNtnMVDqQHTe92AhIdw: checks
2NvwF8W2nzsbS+G//yLAbQ: checks
*** SHOW DOWN ***
mpsfNtnMVDqQHTe92AhIdw: shows [Kd Qh] (high card Ace)
2NvwF8W2nzsbS+G//yLAbQ: shows [Qs Td] (a pair of Tens)
2NvwF8W2nzsbS+G//yLAbQ collected $64 from pot
*** SUMMARY ***
Total pot $67 | Rake $3
Board [Tc As 4d 3d 8h]
Seat 1: 31HuO+DQxppUQEedBWukug (big blind) folded on the Flop
Seat 2: GX1heJ+DSsvm7gzSPsYhhQ folded before Flop (didn't bet)
Seat 3: CUZwDpLTQKhzarPe+JCLOQ folded before Flop (didn't bet)
Seat 5: mpsfNtnMVDqQHTe92AhIdw showed [Kd Qh] and lost with high card Ace
Seat 6: 2NvwF8W2nzsbS+G//yLAbQ showed [Qs Td] and won ($64) with a pair of Tens
Seat 8: MpL4DeEqGQu0H8TJEbEOrg (button) folded before Flop (didn't bet)
Seat 9: F7m34OOfAQ7annesMHVjKw (small blind) folded before Flop



PokerStars Game #59940930704:  Hold'em No Limit ($1/$2) - 2009/07/01 1:20:46 ET
Table 'C4lkCXY2PWy6z4vsAe5NGQ' 6-max Seat #2 is the button
Seat 1: 4bqvCfJ0e8CTYnn0Go9hbQ ($64.60 in chips)
Seat 2: 6hRJ68JkbJq6MYI9o5bUnQ ($38.40 in chips)
Seat 3: sTPOWERd9HWPCNrDBwsVjA ($187.80 in chips)
Seat 4: VvdR9F3I+2yELkfTVvC1dg ($232.55 in chips)
Seat 6: B87ikIyZ/TzAVeXf38Ny0g ($614.75 in chips)
sTPOWERd9HWPCNrDBwsVjA: posts small blind $1
VvdR9F3I+2yELkfTVvC1dg: posts big blind $2
dKvrkfQx2Peke3ikZLUy1w: sits out
*** HOLE CARDS ***
B87ikIyZ/TzAVeXf38Ny0g: raises $4 to $6
4bqvCfJ0e8CTYnn0Go9hbQ: folds
6hRJ68JkbJq6MYI9o5bUnQ: folds
sTPOWERd9HWPCNrDBwsVjA: raises $14 to $20
VvdR9F3I+2yELkfTVvC1dg: folds
dKvrkfQx2Peke3ikZLUy1w said, "yea **** u"
dKvrkfQx2Peke3ikZLUy1w said, "dikhead"
B87ikIyZ/TzAVeXf38Ny0g: calls $14
*** FLOP *** [5c As 8d]
sTPOWERd9HWPCNrDBwsVjA: checks
B87ikIyZ/TzAVeXf38Ny0g: bets $26
sTPOWERd9HWPCNrDBwsVjA: calls $26
*** TURN *** [5c As 8d] [Qc]
dKvrkfQx2Peke3ikZLUy1w said, "oi fkn ugly ****"
sTPOWERd9HWPCNrDBwsVjA: checks
B87ikIyZ/TzAVeXf38Ny0g: bets $69
sTPOWERd9HWPCNrDBwsVjA: folds
B87ikIyZ/TzAVeXf38Ny0g collected $92 from pot
B87ikIyZ/TzAVeXf38Ny0g: doesn't show hand
*** SUMMARY ***
Total pot $94 | Rake $2
Board [5c As 8d Qc]
Seat 1: 4bqvCfJ0e8CTYnn0Go9hbQ folded before Flop (didn't bet)
Seat 2: 6hRJ68JkbJq6MYI9o5bUnQ (button) folded before Flop (didn't bet)
Seat 3: sTPOWERd9HWPCNrDBwsVjA (small blind) folded on the Turn
Seat 4: VvdR9F3I+2yELkfTVvC1dg (big blind) folded before Flop
Seat 6: B87ikIyZ/TzAVeXf38Ny0g collected ($92)



PokerStars Game #59940930376:  Hold'em No Limit ($1/$2) - 2009/07/01 1:20:46 ET
Table 'aSf77Sj8QEnzcc0WaxVD4Q' 6-max Seat #5 is the button
Seat 1: UELtvp+JfwI7XDGVwSxZXA ($167.75 in chips)
Seat 2: vkfxu8f/jMYKUk6Ly4eujw ($200.80 in chips)
Seat 3: 9dpyyjDTCed6nV7JhaUUpw ($228.35 in chips)
Seat 4: YsLQ3BAvgQHWXMAv3Wv6Hg ($265.70 in chips)
Seat 5: VvdR9F3I+2yELkfTVvC1dg ($245 in chips)
Seat 6: vkoJRf3gidxY1pPi0AFWww ($95.20 in chips)
vkoJRf3gidxY1pPi0AFWww: posts small blind $1
UELtvp+JfwI7XDGVwSxZXA: posts big blind $2
*** HOLE CARDS ***
vkfxu8f/jMYKUk6Ly4eujw: folds
9dpyyjDTCed6nV7JhaUUpw: raises $6 to $8
YsLQ3BAvgQHWXMAv3Wv6Hg: folds
VvdR9F3I+2yELkfTVvC1dg: folds
vkoJRf3gidxY1pPi0AFWww: raises $6 to $14
UELtvp+JfwI7XDGVwSxZXA: folds
9dpyyjDTCed6nV7JhaUUpw: raises $14 to $28
vkoJRf3gidxY1pPi0AFWww: raises $67.20 to $95.20 and is all-in
9dpyyjDTCed6nV7JhaUUpw: calls $67.20
*** FLOP *** [4d 3d 9s]
*** TURN *** [4d 3d 9s] [6h]
*** RIVER *** [4d 3d 9s 6h] [6s]
*** SHOW DOWN ***
vkoJRf3gidxY1pPi0AFWww: shows [Ac Jd] (a pair of Sixes)
9dpyyjDTCed6nV7JhaUUpw: shows [Ks Kd] (two pair, Kings and Sixes)
9dpyyjDTCed6nV7JhaUUpw collected $189.40 from pot
*** SUMMARY ***
Total pot $192.40 | Rake $3
Board [4d 3d 9s 6h 6s]
Seat 1: UELtvp+JfwI7XDGVwSxZXA (big blind) folded before Flop
Seat 2: vkfxu8f/jMYKUk6Ly4eujw folded before Flop (didn't bet)
Seat 3: 9dpyyjDTCed6nV7JhaUUpw showed [Ks Kd] and won ($189.40) with two pair, Kings and Sixes
Seat 4: YsLQ3BAvgQHWXMAv3Wv6Hg folded before Flop (didn't bet)
Seat 5: VvdR9F3I+2yELkfTVvC1dg (button) folded before Flop (didn't bet)
Seat 6: vkoJRf3gidxY1pPi0AFWww (small blind) showed [Ac Jd] and lost with a pair of Sixes



PokerStars Game #59940930582:  Hold'em No Limit ($1/$2) - 2009/07/01 1:20:46 ET
Table 'rKeCh+eBn4RNvybCUYkoTQ' 9-max Seat #3 is the button
Seat 1: /inIs/z/PcX+TniIFpaxpg ($203 in chips)
Seat 2: 9cBHwK40Tl06vheE7B3LHQ ($153.55 in chips)
Seat 3: GX1heJ+DSsvm7gzSPsYhhQ ($37 in chips)
Seat 4: 31HuO+DQxppUQEedBWukug ($96.10 in chips)
Seat 5: WUlHm+ydPPHG7Lb0rePSdA ($120 in chips)
Seat 6: EBV6OktyeSmh4w6sWmcWOw ($270 in chips)
Seat 7: rW/MyplHylMSBRaoRUzWrg ($37 in chips)
Seat 8: pN/Ip0ePsUVIdUlGgLrkUw ($210.10 in chips)
Seat 9: Kzta8yu9vxHT4B70mjBZ+w ($211.25 in chips)
31HuO+DQxppUQEedBWukug: posts small blind $1
WUlHm+ydPPHG7Lb0rePSdA: posts big blind $2
*** HOLE CARDS ***
EBV6OktyeSmh4w6sWmcWOw: folds
rW/MyplHylMSBRaoRUzWrg: folds
pN/Ip0ePsUVIdUlGgLrkUw: folds
Kzta8yu9vxHT4B70mjBZ+w: folds
/inIs/z/PcX+TniIFpaxpg: folds
9cBHwK40Tl06vheE7B3LHQ: raises $4 to $6
GX1heJ+DSsvm7gzSPsYhhQ: folds
31HuO+DQxppUQEedBWukug: folds
WUlHm+ydPPHG7Lb0rePSdA: folds
9cBHwK40Tl06vheE7B3LHQ collected $5 from pot
9cBHwK40Tl06vheE7B3LHQ: doesn't show hand
*** SUMMARY ***
Total pot $5 | Rake $0
Seat 1: /inIs/z/PcX+TniIFpaxpg folded before Flop (didn't bet)
Seat 2: 9cBHwK40Tl06vheE7B3LHQ collected ($5)
Seat 3: GX1heJ+DSsvm7gzSPsYhhQ (button) folded before Flop (didn't bet)
Seat 4: 31HuO+DQxppUQEedBWukug (small blind) folded before Flop
Seat 5: WUlHm+ydPPHG7Lb0rePSdA (big blind) folded before Flop
Seat 6: EBV6OktyeSmh4w6sWmcWOw folded before Flop (didn't bet)
Seat 7: rW/MyplHylMSBRaoRUzWrg folded before Flop (didn't bet)
Seat 8: pN/Ip0ePsUVIdUlGgLrkUw folded before Flop (didn't bet)
Seat 9: Kzta8yu9vxHT4B70mjBZ+w folded before Flop (didn't bet)



PokerStars Game #59940931728:  Hold'em No Limit ($1/$2) - 2009/07/01 1:20:48 ET
Table '4NGNnZ/osQfNq6abYqkJeA' 6-max Seat #1 is the button
Seat 1: 7zM38baFvmCNB/F80oE0cQ ($56.30 in chips)
Seat 2: 669iGNwYwgRZg3nhS+aDAQ ($94.15 in chips)
Seat 3: 54yWzRRgS0oZ+S6LwZBxMQ ($30.75 in chips)
Seat 4: sY+4Uuh5z/6AbXXaCS10jw ($207 in chips)
Seat 5: VvdR9F3I+2yELkfTVvC1dg ($241.80 in chips)
Seat 6: kkgpegLoQkmL6LIsFsvtiQ ($249.75 in chips)
669iGNwYwgRZg3nhS+aDAQ: posts small blind $1
54yWzRRgS0oZ+S6LwZBxMQ: posts big blind $2
*** HOLE CARDS ***
sY+4Uuh5z/6AbXXaCS10jw: raises $4 to $6
VvdR9F3I+2yELkfTVvC1dg: folds
kkgpegLoQkmL6LIsFsvtiQ: calls $6
7zM38baFvmCNB/F80oE0cQ: folds
669iGNwYwgRZg3nhS+aDAQ: folds
54yWzRRgS0oZ+S6LwZBxMQ: folds
*** FLOP *** [6s 5d 2c]
sY+4Uuh5z/6AbXXaCS10jw: checks
kkgpegLoQkmL6LIsFsvtiQ: checks
*** TURN *** [6s 5d 2c] [2h]
sY+4Uuh5z/6AbXXaCS10jw: bets $10
kkgpegLoQkmL6LIsFsvtiQ: calls $10
*** RIVER *** [6s 5d 2c 2h] [4h]
sY+4Uuh5z/6AbXXaCS10jw: checks
kkgpegLoQkmL6LIsFsvtiQ: bets $21
sY+4Uuh5z/6AbXXaCS10jw: folds
kkgpegLoQkmL6LIsFsvtiQ collected $33.30 from pot
*** SUMMARY ***
Total pot $35 | Rake $1.70
Board [6s 5d 2c 2h 4h]
Seat 1: 7zM38baFvmCNB/F80oE0cQ (button) folded before Flop (didn't bet)
Seat 2: 669iGNwYwgRZg3nhS+aDAQ (small blind) folded before Flop
Seat 3: 54yWzRRgS0oZ+S6LwZBxMQ (big blind) folded before Flop
Seat 4: sY+4Uuh5z/6AbXXaCS10jw folded on the River
Seat 5: VvdR9F3I+2yELkfTVvC1dg folded before Flop (didn't bet)
Seat 6: kkgpegLoQkmL6LIsFsvtiQ collected ($33.30)



PokerStars Game #59940932792:  Hold'em No Limit ($1/$2) - 2009/07/01 1:20:50 ET
Table 'uJ9juaXXg9yIcSU8amxaXQ' 6-max Seat #2 is the button
Seat 1: JsqOjN/eHz0uYVf/PyUJ6Q ($149.85 in chips)
Seat 2: VvdR9F3I+2yELkfTVvC1dg ($200 in chips)
Seat 3: qXDd0ZyMIse0OBu8pxeQ3Q ($247 in chips)
Seat 4: zNjJ/y4emmF+vzrCDd+ooA ($226.05 in chips)
Seat 5: YsLQ3BAvgQHWXMAv3Wv6Hg ($200 in chips)
Seat 6: 2DFp9Veq1xxq64dCjwNuUw ($51.90 in chips)
qXDd0ZyMIse0OBu8pxeQ3Q: posts small blind $1
zNjJ/y4emmF+vzrCDd+ooA: posts big blind $2
*** HOLE CARDS ***
YsLQ3BAvgQHWXMAv3Wv6Hg: folds
2DFp9Veq1xxq64dCjwNuUw: folds
JsqOjN/eHz0uYVf/PyUJ6Q: folds
VvdR9F3I+2yELkfTVvC1dg: folds
qXDd0ZyMIse0OBu8pxeQ3Q: raises $4 to $6
zNjJ/y4emmF+vzrCDd+ooA: raises $4 to $10
qXDd0ZyMIse0OBu8pxeQ3Q: calls $4
*** FLOP *** [8h Jh Ts]
qXDd0ZyMIse0OBu8pxeQ3Q: checks
zNjJ/y4emmF+vzrCDd+ooA: checks
*** TURN *** [8h Jh Ts] [9d]
qXDd0ZyMIse0OBu8pxeQ3Q: checks
zNjJ/y4emmF+vzrCDd+ooA: checks
*** RIVER *** [8h Jh Ts 9d] [3s]
qXDd0ZyMIse0OBu8pxeQ3Q: bets $14
zNjJ/y4emmF+vzrCDd+ooA: folds
qXDd0ZyMIse0OBu8pxeQ3Q collected $19 from pot
*** SUMMARY ***
Total pot $20 | Rake $1
Board [8h Jh Ts 9d 3s]
Seat 1: JsqOjN/eHz0uYVf/PyUJ6Q folded before Flop (didn't bet)
Seat 2: VvdR9F3I+2yELkfTVvC1dg (button) folded before Flop (didn't bet)
Seat 3: qXDd0ZyMIse0OBu8pxeQ3Q (small blind) collected ($19)
Seat 4: zNjJ/y4emmF+vzrCDd+ooA (big blind) folded on the River
Seat 5: YsLQ3BAvgQHWXMAv3Wv6Hg folded before Flop (didn't bet)
Seat 6: 2DFp9Veq1xxq64dCjwNuUw folded before Flop (didn't bet)



PokerStars Game #59940932646:  Hold'em No Limit ($1/$2) - 2009/07/01 1:20:50 ET
Table 'bJQ024BaYSBrW0sXpCZbNQ' 6-max Seat #1 is the button
Seat 1: PCN5rt4TwI1pQE+rAiqI0Q ($283.60 in chips)
Seat 2: 3dAbvkxS5NPQTBAbvpinVg ($200 in chips)
Seat 3: vkfxu8f/jMYKUk6Ly4eujw ($224.10 in chips)
Seat 5: VvdR9F3I+2yELkfTVvC1dg ($203 in chips)
Seat 6: 9dpyyjDTCed6nV7JhaUUpw ($339.95 in chips)
3dAbvkxS5NPQTBAbvpinVg: posts small blind $1
vkfxu8f/jMYKUk6Ly4eujw: posts big blind $2
*** HOLE CARDS ***
TBaQIN+sQ7eb7P99QnaORQ is disconnected
VvdR9F3I+2yELkfTVvC1dg: folds
9dpyyjDTCed6nV7JhaUUpw: folds
PCN5rt4TwI1pQE+rAiqI0Q: calls $2
3dAbvkxS5NPQTBAbvpinVg: folds
TBaQIN+sQ7eb7P99QnaORQ is connected
vkfxu8f/jMYKUk6Ly4eujw: raises $8 to $10
PCN5rt4TwI1pQE+rAiqI0Q: calls $8
*** FLOP *** [Kd As Jd]
TBaQIN+sQ7eb7P99QnaORQ has returned
vkfxu8f/jMYKUk6Ly4eujw: bets $19
PCN5rt4TwI1pQE+rAiqI0Q: folds
vkfxu8f/jMYKUk6Ly4eujw collected $19.95 from pot
vkfxu8f/jMYKUk6Ly4eujw: doesn't show hand
*** SUMMARY ***
Total pot $21 | Rake $1.05
Board [Kd As Jd]
Seat 1: PCN5rt4TwI1pQE+rAiqI0Q (button) folded on the Flop
Seat 2: 3dAbvkxS5NPQTBAbvpinVg (small blind) folded before Flop
Seat 3: vkfxu8f/jMYKUk6Ly4eujw (big blind) collected ($19.95)
Seat 5: VvdR9F3I+2yELkfTVvC1dg folded before Flop (didn't bet)
Seat 6: 9dpyyjDTCed6nV7JhaUUpw folded before Flop (didn't bet)



PokerStars Game #59940932930:  Hold'em No Limit ($1/$2) - 2009/07/01 1:20:51 ET
Table 'mGpP9StWRnoeiBDExc6Frg' 6-max Seat #2 is the button
Seat 1: VvdR9F3I+2yELkfTVvC1dg ($200 in chips)
Seat 2: dZcLsEI8iXkobBduRJ45Yw ($69.50 in chips)
Seat 3: 7acrZUQC3Zc9BNLjoKIcLQ ($46.35 in chips)
Seat 4: 4dcDwIHRm96PwtqkpQiuiA ($43.35 in chips)
Seat 5: d1puGuVBE0fidn+5eRJ0tw ($227.20 in chips)
Seat 6: B2Ih1sr5VZk+8He7rcrMtQ ($451.35 in chips)
7acrZUQC3Zc9BNLjoKIcLQ: posts small blind $1
4dcDwIHRm96PwtqkpQiuiA: posts big blind $2
*** HOLE CARDS ***
d1puGuVBE0fidn+5eRJ0tw: calls $2
B2Ih1sr5VZk+8He7rcrMtQ: raises $8 to $10
VvdR9F3I+2yELkfTVvC1dg: folds
dZcLsEI8iXkobBduRJ45Yw: folds
7acrZUQC3Zc9BNLjoKIcLQ: folds
4dcDwIHRm96PwtqkpQiuiA: folds
d1puGuVBE0fidn+5eRJ0tw: calls $8
*** FLOP *** [9s 8h 4c]
d1puGuVBE0fidn+5eRJ0tw: checks
B2Ih1sr5VZk+8He7rcrMtQ: bets $16
d1puGuVBE0fidn+5eRJ0tw: folds
B2Ih1sr5VZk+8He7rcrMtQ collected $21.85 from pot
*** SUMMARY ***
Total pot $23 | Rake $1.15
Board [9s 8h 4c]
Seat 1: VvdR9F3I+2yELkfTVvC1dg folded before Flop (didn't bet)
Seat 2: dZcLsEI8iXkobBduRJ45Yw (button) folded before Flop (didn't bet)
Seat 3: 7acrZUQC3Zc9BNLjoKIcLQ (small blind) folded before Flop
Seat 4: 4dcDwIHRm96PwtqkpQiuiA (big blind) folded before Flop
Seat 5: d1puGuVBE0fidn+5eRJ0tw folded on the Flop
Seat 6: B2Ih1sr5VZk+8He7rcrMtQ collected ($21.85)



PokerStars Game #59940934688:  Hold'em No Limit ($1/$2) - 2009/07/01 1:20:54 ET
Table 'TsEDkiO4tzCTCzJ7tNdEqw' 6-max Seat #3 is the button
Seat 1: MfXQsYD8pGeCS7XOtyV+vw ($24.90 in chips)
Seat 2: 4dcDwIHRm96PwtqkpQiuiA ($84.10 in chips)
Seat 3: wgRvjVPZSQvqNGiyR1jwSA ($74 in chips)
Seat 4: K8MXCrNAVYlMnnCeM32Kxw ($53.05 in chips)
Seat 5: VvdR9F3I+2yELkfTVvC1dg ($202.50 in chips)
Seat 6: uCqEjnxh2/vFBjKYkfTOkw ($264.25 in chips)
K8MXCrNAVYlMnnCeM32Kxw: posts small blind $1
VvdR9F3I+2yELkfTVvC1dg: posts big blind $2
*** HOLE CARDS ***
uCqEjnxh2/vFBjKYkfTOkw: folds
MfXQsYD8pGeCS7XOtyV+vw: calls $2
4dcDwIHRm96PwtqkpQiuiA: folds
wgRvjVPZSQvqNGiyR1jwSA: calls $2
K8MXCrNAVYlMnnCeM32Kxw: raises $2 to $4
VvdR9F3I+2yELkfTVvC1dg: folds
MfXQsYD8pGeCS7XOtyV+vw: calls $2
wgRvjVPZSQvqNGiyR1jwSA: calls $2
*** FLOP *** [6h 4s 6s]
K8MXCrNAVYlMnnCeM32Kxw: checks
MfXQsYD8pGeCS7XOtyV+vw: checks
wgRvjVPZSQvqNGiyR1jwSA: checks
*** TURN *** [6h 4s 6s] [Ah]
K8MXCrNAVYlMnnCeM32Kxw: checks
MfXQsYD8pGeCS7XOtyV+vw: checks
wgRvjVPZSQvqNGiyR1jwSA: bets $6
K8MXCrNAVYlMnnCeM32Kxw: calls $6
MfXQsYD8pGeCS7XOtyV+vw: folds
*** RIVER *** [6h 4s 6s Ah] [Qh]
K8MXCrNAVYlMnnCeM32Kxw: checks
wgRvjVPZSQvqNGiyR1jwSA: bets $24
K8MXCrNAVYlMnnCeM32Kxw: calls $24
*** SHOW DOWN ***
wgRvjVPZSQvqNGiyR1jwSA: shows [7c 8d] (a pair of Sixes)
K8MXCrNAVYlMnnCeM32Kxw: shows [9h Ad] (two pair, Aces and Sixes)
K8MXCrNAVYlMnnCeM32Kxw collected $71 from pot
*** SUMMARY ***
Total pot $74 | Rake $3
Board [6h 4s 6s Ah Qh]
Seat 1: MfXQsYD8pGeCS7XOtyV+vw folded on the Turn
Seat 2: 4dcDwIHRm96PwtqkpQiuiA folded before Flop (didn't bet)
Seat 3: wgRvjVPZSQvqNGiyR1jwSA (button) showed [7c 8d] and lost with a pair of Sixes
Seat 4: K8MXCrNAVYlMnnCeM32Kxw (small blind) showed [9h Ad] and won ($71) with two pair, Aces and Sixes
Seat 5: VvdR9F3I+2yELkfTVvC1dg (big blind) folded before Flop
Seat 6: uCqEjnxh2/vFBjKYkfTOkw folded before Flop (didn't bet)



PokerStars Game #59940935420:  Hold'em No Limit ($1/$2) - 2009/07/01 1:20:55 ET
Table 'LL4bDFyhj5hsMpzaDugJZg' 6-max Seat #6 is the button
Seat 1: FwvID/fQGlpY3soi/lMTww ($86.95 in chips)
Seat 2: IZng3w8jiJHHp3LbYKLi4w ($53.15 in chips)
Seat 3: iI/NMpRxMkGieArQEhACSA ($282.70 in chips)
Seat 4: 8srN1dKQePlsv0GyTada+Q ($314.75 in chips)
Seat 5: A2GTwTiwkb1ilNWgW487Vg ($69.20 in chips)
Seat 6: 692Q4sfB0gTElzS0WMeg+A ($208.10 in chips)
FwvID/fQGlpY3soi/lMTww: posts small blind $1
IZng3w8jiJHHp3LbYKLi4w: posts big blind $2
*** HOLE CARDS ***
iI/NMpRxMkGieArQEhACSA: calls $2
8srN1dKQePlsv0GyTada+Q: folds
A2GTwTiwkb1ilNWgW487Vg: calls $2
692Q4sfB0gTElzS0WMeg+A: folds
FwvID/fQGlpY3soi/lMTww: calls $1
IZng3w8jiJHHp3LbYKLi4w: checks
*** FLOP *** [Th 4s 7c]
FwvID/fQGlpY3soi/lMTww: checks
IZng3w8jiJHHp3LbYKLi4w: checks
iI/NMpRxMkGieArQEhACSA: bets $8
A2GTwTiwkb1ilNWgW487Vg: folds
FwvID/fQGlpY3soi/lMTww: folds
IZng3w8jiJHHp3LbYKLi4w: folds
iI/NMpRxMkGieArQEhACSA collected $7.60 from pot
*** SUMMARY ***
Total pot $8 | Rake $0.40
Board [Th 4s 7c]
Seat 1: FwvID/fQGlpY3soi/lMTww (small blind) folded on the Flop
Seat 2: IZng3w8jiJHHp3LbYKLi4w (big blind) folded on the Flop
Seat 3: iI/NMpRxMkGieArQEhACSA collected ($7.60)
Seat 4: 8srN1dKQePlsv0GyTada+Q folded before Flop (didn't bet)
Seat 5: A2GTwTiwkb1ilNWgW487Vg folded on the Flop
Seat 6: 692Q4sfB0gTElzS0WMeg+A (button) folded before Flop (didn't bet)



PokerStars Game #59940936908:  Hold'em No Limit ($1/$2) - 2009/07/01 1:20:58 ET
Table 'YqGfR5eHfMeSjb9a+QU9rg' 9-max Seat #7 is the button
Seat 1: rW/MyplHylMSBRaoRUzWrg ($37 in chips)
Seat 2: W3Nqt1GWlTi9tXQXMNEvgw ($380.70 in chips)
Seat 3: /gll27k+xWYV7Fbki0lFDQ ($266.10 in chips)
Seat 4: QHxJjpVYwitg9krW6wZgJA ($217.30 in chips)
Seat 5: CkE3IyJF1KvdaAOmZY5XqQ ($200 in chips)
Seat 6: TAfo4veNRaRlzDXMMYS3Jg ($37 in chips)
Seat 7: 41aZuLBz9nAi2GPVKabmCw ($98.50 in chips)
Seat 8: JnV3SM2D6dAFYyGZHHpvrg ($102.25 in chips)
Seat 9: /inIs/z/PcX+TniIFpaxpg ($206.05 in chips)
JnV3SM2D6dAFYyGZHHpvrg: posts small blind $1
/inIs/z/PcX+TniIFpaxpg: posts big blind $2
*** HOLE CARDS ***
rW/MyplHylMSBRaoRUzWrg: folds
W3Nqt1GWlTi9tXQXMNEvgw: folds
/gll27k+xWYV7Fbki0lFDQ: calls $2
QHxJjpVYwitg9krW6wZgJA: folds
CkE3IyJF1KvdaAOmZY5XqQ: folds
TAfo4veNRaRlzDXMMYS3Jg: folds
41aZuLBz9nAi2GPVKabmCw: calls $2
JnV3SM2D6dAFYyGZHHpvrg: folds
/inIs/z/PcX+TniIFpaxpg: checks
*** FLOP *** [5d Ah 5h]
/inIs/z/PcX+TniIFpaxpg: checks
/gll27k+xWYV7Fbki0lFDQ: bets $4
41aZuLBz9nAi2GPVKabmCw: folds
/inIs/z/PcX+TniIFpaxpg: folds
/gll27k+xWYV7Fbki0lFDQ collected $6.65 from pot
*** SUMMARY ***
Total pot $7 | Rake $0.35
Board [5d Ah 5h]
Seat 1: rW/MyplHylMSBRaoRUzWrg folded before Flop (didn't bet)
Seat 2: W3Nqt1GWlTi9tXQXMNEvgw folded before Flop (didn't bet)
Seat 3: /gll27k+xWYV7Fbki0lFDQ collected ($6.65)
Seat 4: QHxJjpVYwitg9krW6wZgJA folded before Flop (didn't bet)
Seat 5: CkE3IyJF1KvdaAOmZY5XqQ folded before Flop (didn't bet)
Seat 6: TAfo4veNRaRlzDXMMYS3Jg folded before Flop (didn't bet)
Seat 7: 41aZuLBz9nAi2GPVKabmCw (button) folded on the Flop
Seat 8: JnV3SM2D6dAFYyGZHHpvrg (small blind) folded before Flop
Seat 9: /inIs/z/PcX+TniIFpaxpg (big blind) folded on the Flop



PokerStars Game #59940936882:  Hold'em No Limit ($1/$2) - 2009/07/01 1:20:58 ET
Table 'AtOXMvcrtQM8yLNcALmfLQ' 2-max Seat #1 is the button
Seat 1: +HlQuAsMqZGYYtjcPO/a3A ($135.90 in chips)
Seat 2: pVqEzK9wXlRMECnb1Zg4Zw ($261.30 in chips)
+HlQuAsMqZGYYtjcPO/a3A: posts small blind $1
pVqEzK9wXlRMECnb1Zg4Zw: posts big blind $2
*** HOLE CARDS ***
+HlQuAsMqZGYYtjcPO/a3A: folds
pVqEzK9wXlRMECnb1Zg4Zw collected $2 from pot
pVqEzK9wXlRMECnb1Zg4Zw: doesn't show hand
*** SUMMARY ***
Total pot $2 | Rake $0
Seat 1: +HlQuAsMqZGYYtjcPO/a3A (button) (small blind) folded before Flop
Seat 2: pVqEzK9wXlRMECnb1Zg4Zw (big blind) collected ($2)



PokerStars Game #59940937262:  Hold'em No Limit ($1/$2) - 2009/07/01 1:20:59 ET
Table 'CFkQcfWjKccZaZDf71FK+w' 6-max Seat #5 is the button
Seat 1: JsC+WvfzqlxVs9G8/gSQAQ ($17.55 in chips)
Seat 2: ewN/vzF22+/gdzjIKBOlkA ($227.05 in chips)
Seat 3: 09BNF4quPDzanQzM8vc6WA ($27 in chips)
Seat 4: ygTTt5ehT4aF86q1a8/R+w ($195.10 in chips)
Seat 5: 2lOU1DcvUZaMcxZ95XfzXw ($100 in chips)
Seat 6: ORVqY3rf9X6ANA/8s+On2Q ($113.50 in chips)
ORVqY3rf9X6ANA/8s+On2Q: posts small blind $1
JsC+WvfzqlxVs9G8/gSQAQ: posts big blind $2
*** HOLE CARDS ***
ewN/vzF22+/gdzjIKBOlkA: raises $6 to $8
09BNF4quPDzanQzM8vc6WA: folds
ygTTt5ehT4aF86q1a8/R+w: folds
2lOU1DcvUZaMcxZ95XfzXw: folds
ORVqY3rf9X6ANA/8s+On2Q: folds
JsC+WvfzqlxVs9G8/gSQAQ: calls $6
*** FLOP *** [5c Ah Tc]
JsC+WvfzqlxVs9G8/gSQAQ: checks
ewN/vzF22+/gdzjIKBOlkA: checks
*** TURN *** [5c Ah Tc] [Ac]
JsC+WvfzqlxVs9G8/gSQAQ: checks
ewN/vzF22+/gdzjIKBOlkA: checks
*** RIVER *** [5c Ah Tc Ac] [2c]
JsC+WvfzqlxVs9G8/gSQAQ: folds
ewN/vzF22+/gdzjIKBOlkA collected $16.15 from pot
ewN/vzF22+/gdzjIKBOlkA: doesn't show hand
*** SUMMARY ***
Total pot $17 | Rake $0.85
Board [5c Ah Tc Ac 2c]
Seat 1: JsC+WvfzqlxVs9G8/gSQAQ (big blind) folded on the River
Seat 2: ewN/vzF22+/gdzjIKBOlkA collected ($16.15)
Seat 3: 09BNF4quPDzanQzM8vc6WA folded before Flop (didn't bet)
Seat 4: ygTTt5ehT4aF86q1a8/R+w folded before Flop (didn't bet)
Seat 5: 2lOU1DcvUZaMcxZ95XfzXw (button) folded before Flop (didn't bet)
Seat 6: ORVqY3rf9X6ANA/8s+On2Q (small blind) folded before Flop



PokerStars Game #59940940478:  Hold'em No Limit ($1/$2) - 2009/07/01 1:21:05 ET
Table 'ZzSIe0zTCDv+n6hfbY5tTg' 6-max Seat #1 is the button
Seat 1: VvdR9F3I+2yELkfTVvC1dg ($215.10 in chips)
Seat 2: B87ikIyZ/TzAVeXf38Ny0g ($238 in chips)
Seat 3: gsugPj31Hui3Jefl98MBOA ($210.85 in chips)
Seat 4: qXDd0ZyMIse0OBu8pxeQ3Q ($200 in chips)
Seat 5: 3dAbvkxS5NPQTBAbvpinVg ($486.30 in chips)
Seat 6: 09BNF4quPDzanQzM8vc6WA ($22.50 in chips)
B87ikIyZ/TzAVeXf38Ny0g: posts small blind $1
gsugPj31Hui3Jefl98MBOA: posts big blind $2
*** HOLE CARDS ***
qXDd0ZyMIse0OBu8pxeQ3Q: folds
3dAbvkxS5NPQTBAbvpinVg: folds
09BNF4quPDzanQzM8vc6WA: folds
VvdR9F3I+2yELkfTVvC1dg: folds
B87ikIyZ/TzAVeXf38Ny0g: folds
gsugPj31Hui3Jefl98MBOA collected $2 from pot
*** SUMMARY ***
Total pot $2 | Rake $0
Seat 1: VvdR9F3I+2yELkfTVvC1dg (button) folded before Flop (didn't bet)
Seat 2: B87ikIyZ/TzAVeXf38Ny0g (small blind) folded before Flop
Seat 3: gsugPj31Hui3Jefl98MBOA (big blind) collected ($2)
Seat 4: qXDd0ZyMIse0OBu8pxeQ3Q folded before Flop (didn't bet)
Seat 5: 3dAbvkxS5NPQTBAbvpinVg folded before Flop (didn't bet)
Seat 6: 09BNF4quPDzanQzM8vc6WA folded before Flop (didn't bet)



PokerStars Game #59940940498:  Hold'em No Limit ($1/$2) - 2009/07/01 1:21:05 ET
Table 'AtOXMvcrtQM8yLNcALmfLQ' 2-max Seat #2 is the button
Seat 1: +HlQuAsMqZGYYtjcPO/a3A ($134.90 in chips)
Seat 2: pVqEzK9wXlRMECnb1Zg4Zw ($262.30 in chips)
pVqEzK9wXlRMECnb1Zg4Zw: posts small blind $1
+HlQuAsMqZGYYtjcPO/a3A: posts big blind $2
*** HOLE CARDS ***
pVqEzK9wXlRMECnb1Zg4Zw: raises $6 to $8
+HlQuAsMqZGYYtjcPO/a3A: folds
pVqEzK9wXlRMECnb1Zg4Zw collected $4 from pot
pVqEzK9wXlRMECnb1Zg4Zw: doesn't show hand
*** SUMMARY ***
Total pot $4 | Rake $0
Seat 1: +HlQuAsMqZGYYtjcPO/a3A (big blind) folded before Flop
Seat 2: pVqEzK9wXlRMECnb1Zg4Zw (button) (small blind) collected ($4)



PokerStars Game #59940941902:  Hold'em No Limit ($1/$2) - 2009/07/01 1:21:07 ET
Table 'kq5zaQ+1hLNf8LZfGnbTAA' 6-max Seat #3 is the button
Seat 1: 8srN1dKQePlsv0GyTada+Q ($228 in chips)
Seat 2: nXDI8Y/S6POzRwANu3d8hQ ($41.75 in chips)
Seat 3: vkfxu8f/jMYKUk6Ly4eujw ($227.95 in chips)
Seat 4: 3dAbvkxS5NPQTBAbvpinVg ($200 in chips)
Seat 5: kfASJqTbXek+zc8ZKsZL1Q ($155.40 in chips)
Seat 6: mfy7uGZcqA2PVQqEVbJ7+g ($199.25 in chips)
3dAbvkxS5NPQTBAbvpinVg: posts small blind $1
kfASJqTbXek+zc8ZKsZL1Q: posts big blind $2
*** HOLE CARDS ***
mfy7uGZcqA2PVQqEVbJ7+g: folds
8srN1dKQePlsv0GyTada+Q: raises $4 to $6
nXDI8Y/S6POzRwANu3d8hQ: folds
vkfxu8f/jMYKUk6Ly4eujw: folds
3dAbvkxS5NPQTBAbvpinVg: folds
kfASJqTbXek+zc8ZKsZL1Q: calls $4
*** FLOP *** [9h Qc 8h]
kfASJqTbXek+zc8ZKsZL1Q: checks
8srN1dKQePlsv0GyTada+Q: checks
*** TURN *** [9h Qc 8h] [5d]
kfASJqTbXek+zc8ZKsZL1Q: checks
8srN1dKQePlsv0GyTada+Q: checks
*** RIVER *** [9h Qc 8h 5d] [Jd]
kfASJqTbXek+zc8ZKsZL1Q: bets $12
8srN1dKQePlsv0GyTada+Q: calls $12
*** SHOW DOWN ***
kfASJqTbXek+zc8ZKsZL1Q: shows [5s 3s] (a pair of Fives)
8srN1dKQePlsv0GyTada+Q: shows [Ad Js] (a pair of Jacks)
8srN1dKQePlsv0GyTada+Q collected $35.20 from pot
*** SUMMARY ***
Total pot $37 | Rake $1.80
Board [9h Qc 8h 5d Jd]
Seat 1: 8srN1dKQePlsv0GyTada+Q showed [Ad Js] and won ($35.20) with a pair of Jacks
Seat 2: nXDI8Y/S6POzRwANu3d8hQ folded before Flop (didn't bet)
Seat 3: vkfxu8f/jMYKUk6Ly4eujw (button) folded before Flop (didn't bet)
Seat 4: 3dAbvkxS5NPQTBAbvpinVg (small blind) folded before Flop
Seat 5: kfASJqTbXek+zc8ZKsZL1Q (big blind) showed [5s 3s] and lost with a pair of Fives
Seat 6: mfy7uGZcqA2PVQqEVbJ7+g folded before Flop (didn't bet)



PokerStars Game #59940942508:  Hold'em No Limit ($1/$2) - 2009/07/01 1:21:08 ET
Table 'NmY84NAf9Mh0ckAckHnh5g' 2-max Seat #2 is the button
Seat 1: 6hvg964TSqZ3AL/0XK9aVQ ($312.60 in chips)
Seat 2: RwDoM55ZeQuI2ADyJhOb2Q ($695.90 in chips)
RwDoM55ZeQuI2ADyJhOb2Q: posts small blind $1
6hvg964TSqZ3AL/0XK9aVQ: posts big blind $2
*** HOLE CARDS ***
RwDoM55ZeQuI2ADyJhOb2Q: folds
6hvg964TSqZ3AL/0XK9aVQ collected $2 from pot
*** SUMMARY ***
Total pot $2 | Rake $0
Seat 1: 6hvg964TSqZ3AL/0XK9aVQ (big blind) collected ($2)
Seat 2: RwDoM55ZeQuI2ADyJhOb2Q (button) (small blind) folded before Flop



PokerStars Game #59940944664:  Hold'em No Limit ($1/$2) - 2009/07/01 1:21:12 ET
Table 'qVXak+oTeDXMGbWa4sDU5Q' 9-max Seat #7 is the button
Seat 1: H6Z4+qu8gR0VUiPOijndVg ($252.55 in chips)
Seat 2: rW/MyplHylMSBRaoRUzWrg ($40 in chips)
Seat 3: WUlHm+ydPPHG7Lb0rePSdA ($172.65 in chips)
Seat 4: lQYT23h5QCUVZAKxjOO39Q ($102.25 in chips)
Seat 5: FWGiDqRwvLeKmHq9t4Jy9w ($268.80 in chips)
Seat 6: GX1heJ+DSsvm7gzSPsYhhQ ($34 in chips)
Seat 7: PfmlvZlFiss79a6IoEr11g ($121.30 in chips)
Seat 9: CkE3IyJF1KvdaAOmZY5XqQ ($204 in chips)
CkE3IyJF1KvdaAOmZY5XqQ: posts small blind $1
H6Z4+qu8gR0VUiPOijndVg: posts big blind $2
*** HOLE CARDS ***
rW/MyplHylMSBRaoRUzWrg: folds
WUlHm+ydPPHG7Lb0rePSdA: folds
lQYT23h5QCUVZAKxjOO39Q: raises $4 to $6
FWGiDqRwvLeKmHq9t4Jy9w: folds
Z0rzUi0y1x80UdIpofoNbA joins the table at seat #8
GX1heJ+DSsvm7gzSPsYhhQ: folds
PfmlvZlFiss79a6IoEr11g: folds
CkE3IyJF1KvdaAOmZY5XqQ: folds
H6Z4+qu8gR0VUiPOijndVg: folds
lQYT23h5QCUVZAKxjOO39Q collected $5 from pot
*** SUMMARY ***
Total pot $5 | Rake $0
Seat 1: H6Z4+qu8gR0VUiPOijndVg (big blind) folded before Flop
Seat 2: rW/MyplHylMSBRaoRUzWrg folded before Flop (didn't bet)
Seat 3: WUlHm+ydPPHG7Lb0rePSdA folded before Flop (didn't bet)
Seat 4: lQYT23h5QCUVZAKxjOO39Q collected ($5)
Seat 5: FWGiDqRwvLeKmHq9t4Jy9w folded before Flop (didn't bet)
Seat 6: GX1heJ+DSsvm7gzSPsYhhQ folded before Flop (didn't bet)
Seat 7: PfmlvZlFiss79a6IoEr11g (button) folded before Flop (didn't bet)
Seat 9: CkE3IyJF1KvdaAOmZY5XqQ (small blind) folded before Flop



PokerStars Game #59940946502:  Hold'em No Limit ($1/$2) - 2009/07/01 1:21:15 ET
Table '+hSnXFQrGw1PlVgTnuj+sA' 6-max Seat #6 is the button
Seat 1: 2ccIJhDj+3JapvS7swVZEg ($285.85 in chips)
Seat 2: o9jamqIi6sTTRSqudgboRA ($281.90 in chips)
Seat 3: fE+LHW/7rpfXW14g8LhGjA ($43.65 in chips)
Seat 4: J4iH5epwXbmODnojR/VRxA ($167.60 in chips)
Seat 5: VvdR9F3I+2yELkfTVvC1dg ($226.75 in chips)
Seat 6: AuiGltq875lmaKHBsjZVGg ($85.75 in chips)
2ccIJhDj+3JapvS7swVZEg: posts small blind $1
o9jamqIi6sTTRSqudgboRA: posts big blind $2
*** HOLE CARDS ***
fE+LHW/7rpfXW14g8LhGjA: calls $2
J4iH5epwXbmODnojR/VRxA: calls $2
VvdR9F3I+2yELkfTVvC1dg: folds
AuiGltq875lmaKHBsjZVGg: folds
2ccIJhDj+3JapvS7swVZEg: raises $7 to $9
o9jamqIi6sTTRSqudgboRA: folds
fE+LHW/7rpfXW14g8LhGjA: calls $7
J4iH5epwXbmODnojR/VRxA: folds
*** FLOP *** [Js 7c 6h]
2ccIJhDj+3JapvS7swVZEg: bets $12
fE+LHW/7rpfXW14g8LhGjA: folds
2ccIJhDj+3JapvS7swVZEg collected $20.90 from pot
*** SUMMARY ***
Total pot $22 | Rake $1.10
Board [Js 7c 6h]
Seat 1: 2ccIJhDj+3JapvS7swVZEg (small blind) collected ($20.90)
Seat 2: o9jamqIi6sTTRSqudgboRA (big blind) folded before Flop
Seat 3: fE+LHW/7rpfXW14g8LhGjA folded on the Flop
Seat 4: J4iH5epwXbmODnojR/VRxA folded before Flop
Seat 5: VvdR9F3I+2yELkfTVvC1dg folded before Flop (didn't bet)
Seat 6: AuiGltq875lmaKHBsjZVGg (button) folded before Flop (didn't bet)



PokerStars Game #59940946530:  Hold'em No Limit ($1/$2) - 2009/07/01 1:21:15 ET
Table 'AtOXMvcrtQM8yLNcALmfLQ' 2-max Seat #1 is the button
Seat 1: +HlQuAsMqZGYYtjcPO/a3A ($132.90 in chips)
Seat 2: pVqEzK9wXlRMECnb1Zg4Zw ($264.30 in chips)
+HlQuAsMqZGYYtjcPO/a3A: posts small blind $1
pVqEzK9wXlRMECnb1Zg4Zw: posts big blind $2
*** HOLE CARDS ***
+HlQuAsMqZGYYtjcPO/a3A: folds
pVqEzK9wXlRMECnb1Zg4Zw collected $2 from pot
pVqEzK9wXlRMECnb1Zg4Zw: doesn't show hand
*** SUMMARY ***
Total pot $2 | Rake $0
Seat 1: +HlQuAsMqZGYYtjcPO/a3A (button) (small blind) folded before Flop
Seat 2: pVqEzK9wXlRMECnb1Zg4Zw (big blind) collected ($2)



PokerStars Game #59940947096:  Hold'em No Limit ($1/$2) - 2009/07/01 1:21:16 ET
Table 'eyAQSIlgc2o1Jxvbve4WGg' 9-max Seat #4 is the button
Seat 1: UZEsV9yKUMqmpYPiOFpaZw ($101.50 in chips)
Seat 2: g7gL2NLJCdZPPV399WKT1w ($64.65 in chips)
Seat 3: ice1Sbe19zWIaKYoSmE5tw ($93.30 in chips)
Seat 4: CkE3IyJF1KvdaAOmZY5XqQ ($200 in chips)
Seat 5: mIKx5lhIt13X5eZQH0ZeMA ($78.10 in chips)
Seat 8: 1CtiZuXDFaJL1dJPQKyi8Q ($175.35 in chips)
Seat 9: WUlHm+ydPPHG7Lb0rePSdA ($123.70 in chips)
mIKx5lhIt13X5eZQH0ZeMA: posts small blind $1
rW/MyplHylMSBRaoRUzWrg: is sitting out
QHxJjpVYwitg9krW6wZgJA: is sitting out
1CtiZuXDFaJL1dJPQKyi8Q: posts big blind $2
*** HOLE CARDS ***
rW/MyplHylMSBRaoRUzWrg leaves the table
WUlHm+ydPPHG7Lb0rePSdA: folds
UZEsV9yKUMqmpYPiOFpaZw: folds
g7gL2NLJCdZPPV399WKT1w: folds
ice1Sbe19zWIaKYoSmE5tw: raises $4 to $6
nXDI8Y/S6POzRwANu3d8hQ joins the table at seat #6
CkE3IyJF1KvdaAOmZY5XqQ: folds
mIKx5lhIt13X5eZQH0ZeMA: folds
1CtiZuXDFaJL1dJPQKyi8Q: folds
ice1Sbe19zWIaKYoSmE5tw collected $5 from pot
*** SUMMARY ***
Total pot $5 | Rake $0
Seat 1: UZEsV9yKUMqmpYPiOFpaZw folded before Flop (didn't bet)
Seat 2: g7gL2NLJCdZPPV399WKT1w folded before Flop (didn't bet)
Seat 3: ice1Sbe19zWIaKYoSmE5tw collected ($5)
Seat 4: CkE3IyJF1KvdaAOmZY5XqQ (button) folded before Flop (didn't bet)
Seat 5: mIKx5lhIt13X5eZQH0ZeMA (small blind) folded before Flop
Seat 8: 1CtiZuXDFaJL1dJPQKyi8Q (big blind) folded before Flop
Seat 9: WUlHm+ydPPHG7Lb0rePSdA folded before Flop (didn't bet)



PokerStars Game #59940947194:  Hold'em No Limit ($1/$2) - 2009/07/01 1:21:16 ET
Table 'QxerF7GUfCbl+4a8XaTB2w' 6-max Seat #3 is the button
Seat 1: o9jamqIi6sTTRSqudgboRA ($289.50 in chips)
Seat 2: vkfxu8f/jMYKUk6Ly4eujw ($208.05 in chips)
Seat 3: m7mYVfnCOK5TE/VkN/FhOg ($281.10 in chips)
Seat 4: 09BNF4quPDzanQzM8vc6WA ($38.55 in chips)
Seat 5: YsLQ3BAvgQHWXMAv3Wv6Hg ($201.75 in chips)
Seat 6: VvdR9F3I+2yELkfTVvC1dg ($200 in chips)
09BNF4quPDzanQzM8vc6WA: posts small blind $1
YsLQ3BAvgQHWXMAv3Wv6Hg: posts big blind $2
*** HOLE CARDS ***
VvdR9F3I+2yELkfTVvC1dg: folds
o9jamqIi6sTTRSqudgboRA: folds
vkfxu8f/jMYKUk6Ly4eujw: raises $6 to $8
m7mYVfnCOK5TE/VkN/FhOg: raises $22 to $30
09BNF4quPDzanQzM8vc6WA: folds
YsLQ3BAvgQHWXMAv3Wv6Hg: folds
vkfxu8f/jMYKUk6Ly4eujw: raises $38 to $68
m7mYVfnCOK5TE/VkN/FhOg: raises $213.10 to $281.10 and is all-in
vkfxu8f/jMYKUk6Ly4eujw: calls $140.05 and is all-in
*** FLOP *** [Ah 9c 8d]
*** TURN *** [Ah 9c 8d] [4c]
*** RIVER *** [Ah 9c 8d 4c] [4s]
*** SHOW DOWN ***
vkfxu8f/jMYKUk6Ly4eujw: shows [Kd Kh] (two pair, Kings and Fours)
m7mYVfnCOK5TE/VkN/FhOg: shows [Kc Ks] (two pair, Kings and Fours)
vkfxu8f/jMYKUk6Ly4eujw collected $208.05 from pot
m7mYVfnCOK5TE/VkN/FhOg collected $208.05 from pot
*** SUMMARY ***
Total pot $419.10 | Rake $3
Board [Ah 9c 8d 4c 4s]
Seat 1: o9jamqIi6sTTRSqudgboRA folded before Flop (didn't bet)
Seat 2: vkfxu8f/jMYKUk6Ly4eujw showed [Kd Kh] and won ($208.05) with two pair, Kings and Fours
Seat 3: m7mYVfnCOK5TE/VkN/FhOg (button) showed [Kc Ks] and won ($208.05) with two pair, Kings and Fours
Seat 4: 09BNF4quPDzanQzM8vc6WA (small blind) folded before Flop
Seat 5: YsLQ3BAvgQHWXMAv3Wv6Hg (big blind) folded before Flop
Seat 6: VvdR9F3I+2yELkfTVvC1dg folded before Flop (didn't bet)



PokerStars Game #59940947614:  Hold'em No Limit ($1/$2) - 2009/07/01 1:21:17 ET
Table 'NmY84NAf9Mh0ckAckHnh5g' 2-max Seat #1 is the button
Seat 1: 6hvg964TSqZ3AL/0XK9aVQ ($313.60 in chips)
Seat 2: RwDoM55ZeQuI2ADyJhOb2Q ($694.90 in chips)
6hvg964TSqZ3AL/0XK9aVQ: posts small blind $1
RwDoM55ZeQuI2ADyJhOb2Q: posts big blind $2
*** HOLE CARDS ***
6hvg964TSqZ3AL/0XK9aVQ: calls $1
RwDoM55ZeQuI2ADyJhOb2Q: raises $6 to $8
6hvg964TSqZ3AL/0XK9aVQ: calls $6
*** FLOP *** [Qd 5h Ks]
RwDoM55ZeQuI2ADyJhOb2Q: bets $10
6hvg964TSqZ3AL/0XK9aVQ: folds
RwDoM55ZeQuI2ADyJhOb2Q collected $15.50 from pot
RwDoM55ZeQuI2ADyJhOb2Q: doesn't show hand
*** SUMMARY ***
Total pot $16 | Rake $0.50
Board [Qd 5h Ks]
Seat 1: 6hvg964TSqZ3AL/0XK9aVQ (button) (small blind) folded on the Flop
Seat 2: RwDoM55ZeQuI2ADyJhOb2Q (big blind) collected ($15.50)



PokerStars Game #59940948156:  Hold'em No Limit ($1/$2) - 2009/07/01 1:21:18 ET
Table 'ztv6V3FN2bQ9nmJPPdx6nQ' 6-max Seat #6 is the button
Seat 1: 6fLdOUCRtX71xbVRhJEq8w ($216 in chips)
Seat 2: 5Y+ZGWLI4gnlpApDX5vy1A ($411.25 in chips)
Seat 3: ubtx4Z5L+AcK71MTvYiGVw ($200 in chips)
Seat 4: UaZ5yj+6LjtWqMQg2QskUw ($115.80 in chips)
Seat 5: sTPOWERd9HWPCNrDBwsVjA ($251 in chips)
Seat 6: mfy7uGZcqA2PVQqEVbJ7+g ($117.45 in chips)
6fLdOUCRtX71xbVRhJEq8w: posts small blind $1
5Y+ZGWLI4gnlpApDX5vy1A: posts big blind $2
*** HOLE CARDS ***
ubtx4Z5L+AcK71MTvYiGVw: folds
UaZ5yj+6LjtWqMQg2QskUw: folds
sTPOWERd9HWPCNrDBwsVjA: raises $6 to $8
mfy7uGZcqA2PVQqEVbJ7+g: folds
6fLdOUCRtX71xbVRhJEq8w: folds
5Y+ZGWLI4gnlpApDX5vy1A: folds
sTPOWERd9HWPCNrDBwsVjA collected $5 from pot
*** SUMMARY ***
Total pot $5 | Rake $0
Seat 1: 6fLdOUCRtX71xbVRhJEq8w (small blind) folded before Flop
Seat 2: 5Y+ZGWLI4gnlpApDX5vy1A (big blind) folded before Flop
Seat 3: ubtx4Z5L+AcK71MTvYiGVw folded before Flop (didn't bet)
Seat 4: UaZ5yj+6LjtWqMQg2QskUw folded before Flop (didn't bet)
Seat 5: sTPOWERd9HWPCNrDBwsVjA collected ($5)
Seat 6: mfy7uGZcqA2PVQqEVbJ7+g (button) folded before Flop (didn't bet)



PokerStars Game #59940950666:  Hold'em No Limit ($1/$2) - 2009/07/01 1:21:22 ET
Table 'ZzSIe0zTCDv+n6hfbY5tTg' 6-max Seat #2 is the button
Seat 1: VvdR9F3I+2yELkfTVvC1dg ($215.10 in chips)
Seat 2: B87ikIyZ/TzAVeXf38Ny0g ($237 in chips)
Seat 3: gsugPj31Hui3Jefl98MBOA ($211.85 in chips)
Seat 4: qXDd0ZyMIse0OBu8pxeQ3Q ($200 in chips)
Seat 5: 3dAbvkxS5NPQTBAbvpinVg ($486.30 in chips)
Seat 6: 09BNF4quPDzanQzM8vc6WA ($22.50 in chips)
gsugPj31Hui3Jefl98MBOA: posts small blind $1
qXDd0ZyMIse0OBu8pxeQ3Q: posts big blind $2
*** HOLE CARDS ***
3dAbvkxS5NPQTBAbvpinVg: folds
09BNF4quPDzanQzM8vc6WA: folds
VvdR9F3I+2yELkfTVvC1dg: folds
B87ikIyZ/TzAVeXf38Ny0g: folds
gsugPj31Hui3Jefl98MBOA: calls $1
qXDd0ZyMIse0OBu8pxeQ3Q: checks
*** FLOP *** [3d Kh 5h]
gsugPj31Hui3Jefl98MBOA: bets $4
qXDd0ZyMIse0OBu8pxeQ3Q: folds
gsugPj31Hui3Jefl98MBOA collected $3.80 from pot
*** SUMMARY ***
Total pot $4 | Rake $0.20
Board [3d Kh 5h]
Seat 1: VvdR9F3I+2yELkfTVvC1dg folded before Flop (didn't bet)
Seat 2: B87ikIyZ/TzAVeXf38Ny0g (button) folded before Flop (didn't bet)
Seat 3: gsugPj31Hui3Jefl98MBOA (small blind) collected ($3.80)
Seat 4: qXDd0ZyMIse0OBu8pxeQ3Q (big blind) folded on the Flop
Seat 5: 3dAbvkxS5NPQTBAbvpinVg folded before Flop (didn't bet)
Seat 6: 09BNF4quPDzanQzM8vc6WA folded before Flop (didn't bet)



PokerStars Game #59940950828:  Hold'em No Limit ($1/$2) - 2009/07/01 1:21:23 ET
Table 'rKeCh+eBn4RNvybCUYkoTQ' 9-max Seat #4 is the button
Seat 1: /inIs/z/PcX+TniIFpaxpg ($203 in chips)
Seat 2: 9cBHwK40Tl06vheE7B3LHQ ($156.55 in chips)
Seat 3: GX1heJ+DSsvm7gzSPsYhhQ ($37 in chips)
Seat 4: 31HuO+DQxppUQEedBWukug ($95.10 in chips)
Seat 5: WUlHm+ydPPHG7Lb0rePSdA ($120 in chips)
Seat 6: EBV6OktyeSmh4w6sWmcWOw ($270 in chips)
Seat 7: rW/MyplHylMSBRaoRUzWrg ($37 in chips)
Seat 8: pN/Ip0ePsUVIdUlGgLrkUw ($210.10 in chips)
Seat 9: Kzta8yu9vxHT4B70mjBZ+w ($211.25 in chips)
WUlHm+ydPPHG7Lb0rePSdA: posts small blind $1
EBV6OktyeSmh4w6sWmcWOw: posts big blind $2
*** HOLE CARDS ***
rW/MyplHylMSBRaoRUzWrg: folds
pN/Ip0ePsUVIdUlGgLrkUw: folds
Kzta8yu9vxHT4B70mjBZ+w: folds
/inIs/z/PcX+TniIFpaxpg: folds
9cBHwK40Tl06vheE7B3LHQ: folds
GX1heJ+DSsvm7gzSPsYhhQ: folds
31HuO+DQxppUQEedBWukug: raises $4 to $6
WUlHm+ydPPHG7Lb0rePSdA: raises $14 to $20
EBV6OktyeSmh4w6sWmcWOw: folds
31HuO+DQxppUQEedBWukug: folds
WUlHm+ydPPHG7Lb0rePSdA collected $14 from pot
WUlHm+ydPPHG7Lb0rePSdA: doesn't show hand
*** SUMMARY ***
Total pot $14 | Rake $0
Seat 1: /inIs/z/PcX+TniIFpaxpg folded before Flop (didn't bet)
Seat 2: 9cBHwK40Tl06vheE7B3LHQ folded before Flop (didn't bet)
Seat 3: GX1heJ+DSsvm7gzSPsYhhQ folded before Flop (didn't bet)
Seat 4: 31HuO+DQxppUQEedBWukug (button) folded before Flop
Seat 5: WUlHm+ydPPHG7Lb0rePSdA (small blind) collected ($14)
Seat 6: EBV6OktyeSmh4w6sWmcWOw (big blind) folded before Flop
Seat 7: rW/MyplHylMSBRaoRUzWrg folded before Flop (didn't bet)
Seat 8: pN/Ip0ePsUVIdUlGgLrkUw folded before Flop (didn't bet)
Seat 9: Kzta8yu9vxHT4B70mjBZ+w folded before Flop (didn't bet)



PokerStars Game #59940950862:  Hold'em No Limit ($1/$2) - 2009/07/01 1:21:23 ET
Table 'AtOXMvcrtQM8yLNcALmfLQ' 2-max Seat #2 is the button
Seat 1: +HlQuAsMqZGYYtjcPO/a3A ($131.90 in chips)
Seat 2: pVqEzK9wXlRMECnb1Zg4Zw ($265.30 in chips)
pVqEzK9wXlRMECnb1Zg4Zw: posts small blind $1
+HlQuAsMqZGYYtjcPO/a3A: posts big blind $2
*** HOLE CARDS ***
pVqEzK9wXlRMECnb1Zg4Zw: raises $6 to $8
+HlQuAsMqZGYYtjcPO/a3A: folds
pVqEzK9wXlRMECnb1Zg4Zw collected $4 from pot
pVqEzK9wXlRMECnb1Zg4Zw: doesn't show hand
*** SUMMARY ***
Total pot $4 | Rake $0
Seat 1: +HlQuAsMqZGYYtjcPO/a3A (big blind) folded before Flop
Seat 2: pVqEzK9wXlRMECnb1Zg4Zw (button) (small blind) collected ($4)



PokerStars Game #59940952160:  Hold'em No Limit ($1/$2) - 2009/07/01 1:21:25 ET
Table 'bJQ024BaYSBrW0sXpCZbNQ' 6-max Seat #2 is the button
Seat 1: PCN5rt4TwI1pQE+rAiqI0Q ($273.60 in chips)
Seat 2: 3dAbvkxS5NPQTBAbvpinVg ($200 in chips)
Seat 3: vkfxu8f/jMYKUk6Ly4eujw ($234.05 in chips)
Seat 4: TBaQIN+sQ7eb7P99QnaORQ ($40 in chips)
Seat 5: VvdR9F3I+2yELkfTVvC1dg ($203 in chips)
Seat 6: 9dpyyjDTCed6nV7JhaUUpw ($339.95 in chips)
vkfxu8f/jMYKUk6Ly4eujw: posts small blind $1
TBaQIN+sQ7eb7P99QnaORQ: posts big blind $2
*** HOLE CARDS ***
VvdR9F3I+2yELkfTVvC1dg: folds
9dpyyjDTCed6nV7JhaUUpw: raises $4 to $6
PCN5rt4TwI1pQE+rAiqI0Q: calls $6
3dAbvkxS5NPQTBAbvpinVg: calls $6
vkfxu8f/jMYKUk6Ly4eujw: folds
TBaQIN+sQ7eb7P99QnaORQ said, "hahaha"
TBaQIN+sQ7eb7P99QnaORQ: raises $34 to $40 and is all-in
9dpyyjDTCed6nV7JhaUUpw: folds
PCN5rt4TwI1pQE+rAiqI0Q: calls $34
3dAbvkxS5NPQTBAbvpinVg: folds
*** FLOP *** [5h Ks 5c]
*** TURN *** [5h Ks 5c] [7h]
*** RIVER *** [5h Ks 5c 7h] [As]
*** SHOW DOWN ***
TBaQIN+sQ7eb7P99QnaORQ: shows [Ah Ts] (two pair, Aces and Fives)
PCN5rt4TwI1pQE+rAiqI0Q: shows [5d Ad] (a full house, Fives full of Aces)
PCN5rt4TwI1pQE+rAiqI0Q collected $90 from pot
*** SUMMARY ***
Total pot $93 | Rake $3
Board [5h Ks 5c 7h As]
Seat 1: PCN5rt4TwI1pQE+rAiqI0Q showed [5d Ad] and won ($90) with a full house, Fives full of Aces
Seat 2: 3dAbvkxS5NPQTBAbvpinVg (button) folded before Flop
Seat 3: vkfxu8f/jMYKUk6Ly4eujw (small blind) folded before Flop
Seat 4: TBaQIN+sQ7eb7P99QnaORQ (big blind) showed [Ah Ts] and lost with two pair, Aces and Fives
Seat 5: VvdR9F3I+2yELkfTVvC1dg folded before Flop (didn't bet)
Seat 6: 9dpyyjDTCed6nV7JhaUUpw folded before Flop



PokerStars Game #59940954634:  Hold'em No Limit ($1/$2) - 2009/07/01 1:21:29 ET
Table 'W9UeSV0aoPjh5SFSxM8jUQ' 9-max Seat #8 is the button
Seat 1: mIKx5lhIt13X5eZQH0ZeMA ($25 in chips)
Seat 2: iMe5yhc+1BaiIPHet3NMrA ($255.60 in chips)
Seat 3: /inIs/z/PcX+TniIFpaxpg ($25 in chips)
Seat 5: ri8CLkX3e9JF34dQNbsHGA ($42.45 in chips)
Seat 6: j47DM+lqTfzZP8musviQTg ($110.90 in chips)
Seat 7: I2ipWauytvrkEer4XD3Sjg ($106 in chips)
Seat 8: odhvI/CZeMsPyo1n1U7+hA ($49.70 in chips)
Seat 9: Q104K4iDGcqOlVrjAkzPEA ($90.85 in chips)
Q104K4iDGcqOlVrjAkzPEA: posts small blind $1
mIKx5lhIt13X5eZQH0ZeMA: posts big blind $2
*** HOLE CARDS ***
iMe5yhc+1BaiIPHet3NMrA: folds
/inIs/z/PcX+TniIFpaxpg: folds
4YA/sQy1Emm680zhbPUjow joins the table at seat #4
ri8CLkX3e9JF34dQNbsHGA: folds
j47DM+lqTfzZP8musviQTg: folds
I2ipWauytvrkEer4XD3Sjg: folds
odhvI/CZeMsPyo1n1U7+hA: folds
Q104K4iDGcqOlVrjAkzPEA: folds
mIKx5lhIt13X5eZQH0ZeMA collected $2 from pot
*** SUMMARY ***
Total pot $2 | Rake $0
Seat 1: mIKx5lhIt13X5eZQH0ZeMA (big blind) collected ($2)
Seat 2: iMe5yhc+1BaiIPHet3NMrA folded before Flop (didn't bet)
Seat 3: /inIs/z/PcX+TniIFpaxpg folded before Flop (didn't bet)
Seat 5: ri8CLkX3e9JF34dQNbsHGA folded before Flop (didn't bet)
Seat 6: j47DM+lqTfzZP8musviQTg folded before Flop (didn't bet)
Seat 7: I2ipWauytvrkEer4XD3Sjg folded before Flop (didn't bet)
Seat 8: odhvI/CZeMsPyo1n1U7+hA (button) folded before Flop (didn't bet)
Seat 9: Q104K4iDGcqOlVrjAkzPEA (small blind) folded before Flop



PokerStars Game #59940955600:  Hold'em No Limit ($1/$2) - 2009/07/01 1:21:31 ET
Table 'jlrIxbrVIG+gjaUYT4za8g' 6-max Seat #2 is the button
Seat 1: ygTTt5ehT4aF86q1a8/R+w ($210.30 in chips)
Seat 2: on4ebXPJvUBOcHOBMQsRSg ($64 in chips)
Seat 3: RUZs7P4uzWavoA6iEpDKLw ($140.75 in chips)
Seat 4: 8srN1dKQePlsv0GyTada+Q ($304.35 in chips)
Seat 5: AyBB0k3Dcl7xbXUeGMw06g ($75.20 in chips)
Seat 6: vkfxu8f/jMYKUk6Ly4eujw ($338 in chips)
RUZs7P4uzWavoA6iEpDKLw: posts small blind $1
8srN1dKQePlsv0GyTada+Q: posts big blind $2
*** HOLE CARDS ***
AyBB0k3Dcl7xbXUeGMw06g: folds
vkfxu8f/jMYKUk6Ly4eujw: folds
ygTTt5ehT4aF86q1a8/R+w: raises $4 to $6
on4ebXPJvUBOcHOBMQsRSg: folds
RUZs7P4uzWavoA6iEpDKLw: calls $5
8srN1dKQePlsv0GyTada+Q: folds
*** FLOP *** [Ah 2h 9c]
RUZs7P4uzWavoA6iEpDKLw: checks
ygTTt5ehT4aF86q1a8/R+w: bets $8
RUZs7P4uzWavoA6iEpDKLw: raises $10 to $18
ygTTt5ehT4aF86q1a8/R+w: calls $10
*** TURN *** [Ah 2h 9c] [Kh]
RUZs7P4uzWavoA6iEpDKLw: checks
ygTTt5ehT4aF86q1a8/R+w: checks
*** RIVER *** [Ah 2h 9c Kh] [5d]
RUZs7P4uzWavoA6iEpDKLw: bets $31
ygTTt5ehT4aF86q1a8/R+w: raises $51 to $82
RUZs7P4uzWavoA6iEpDKLw: folds
ygTTt5ehT4aF86q1a8/R+w collected $109 from pot
*** SUMMARY ***
Total pot $112 | Rake $3
Board [Ah 2h 9c Kh 5d]
Seat 1: ygTTt5ehT4aF86q1a8/R+w collected ($109)
Seat 2: on4ebXPJvUBOcHOBMQsRSg (button) folded before Flop (didn't bet)
Seat 3: RUZs7P4uzWavoA6iEpDKLw (small blind) folded on the River
Seat 4: 8srN1dKQePlsv0GyTada+Q (big blind) folded before Flop
Seat 5: AyBB0k3Dcl7xbXUeGMw06g folded before Flop (didn't bet)
Seat 6: vkfxu8f/jMYKUk6Ly4eujw folded before Flop (didn't bet)



PokerStars Game #59940955412:  Hold'em No Limit ($1/$2) - 2009/07/01 1:21:31 ET
Table 'rsKRKlGHlxVyqJxzO2a2Ow' 9-max Seat #6 is the button
Seat 1: uYWfQJg2hgHLxri6/uVJiw ($347.20 in chips)
Seat 2: QHxJjpVYwitg9krW6wZgJA ($273.65 in chips)
Seat 3: zTcFtoHqqK4550YMZ8Y14Q ($60.50 in chips)
Seat 4: 31HuO+DQxppUQEedBWukug ($94 in chips)
Seat 5: 5Q8U6iZbeO7xJSS4qvDP5g ($202 in chips)
Seat 6: H6Z4+qu8gR0VUiPOijndVg ($200 in chips)
Seat 7: GX1heJ+DSsvm7gzSPsYhhQ ($34 in chips)
Seat 8: CkE3IyJF1KvdaAOmZY5XqQ ($220.75 in chips)
Seat 9: gRbvhSUVg+TNaTjaJecIRw ($72 in chips)
GX1heJ+DSsvm7gzSPsYhhQ: posts small blind $1
CkE3IyJF1KvdaAOmZY5XqQ: posts big blind $2
*** HOLE CARDS ***
gRbvhSUVg+TNaTjaJecIRw: folds
uYWfQJg2hgHLxri6/uVJiw: folds
QHxJjpVYwitg9krW6wZgJA: folds
zTcFtoHqqK4550YMZ8Y14Q: folds
31HuO+DQxppUQEedBWukug: folds
5Q8U6iZbeO7xJSS4qvDP5g: folds
H6Z4+qu8gR0VUiPOijndVg: raises $2 to $4
GX1heJ+DSsvm7gzSPsYhhQ: folds
CkE3IyJF1KvdaAOmZY5XqQ: calls $2
*** FLOP *** [Qs 5c 5d]
CkE3IyJF1KvdaAOmZY5XqQ: checks
H6Z4+qu8gR0VUiPOijndVg: bets $6
CkE3IyJF1KvdaAOmZY5XqQ: folds
H6Z4+qu8gR0VUiPOijndVg collected $8.55 from pot
H6Z4+qu8gR0VUiPOijndVg: doesn't show hand
*** SUMMARY ***
Total pot $9 | Rake $0.45
Board [Qs 5c 5d]
Seat 1: uYWfQJg2hgHLxri6/uVJiw folded before Flop (didn't bet)
Seat 2: QHxJjpVYwitg9krW6wZgJA folded before Flop (didn't bet)
Seat 3: zTcFtoHqqK4550YMZ8Y14Q folded before Flop (didn't bet)
Seat 4: 31HuO+DQxppUQEedBWukug folded before Flop (didn't bet)
Seat 5: 5Q8U6iZbeO7xJSS4qvDP5g folded before Flop (didn't bet)
Seat 6: H6Z4+qu8gR0VUiPOijndVg (button) collected ($8.55)
Seat 7: GX1heJ+DSsvm7gzSPsYhhQ (small blind) folded before Flop
Seat 8: CkE3IyJF1KvdaAOmZY5XqQ (big blind) folded on the Flop
Seat 9: gRbvhSUVg+TNaTjaJecIRw folded before Flop (didn't bet)



PokerStars Game #59940955514:  Hold'em No Limit ($1/$2) - 2009/07/01 1:21:31 ET
Table 'NmY84NAf9Mh0ckAckHnh5g' 2-max Seat #2 is the button
Seat 1: 6hvg964TSqZ3AL/0XK9aVQ ($305.60 in chips)
Seat 2: RwDoM55ZeQuI2ADyJhOb2Q ($702.40 in chips)
RwDoM55ZeQuI2ADyJhOb2Q: posts small blind $1
6hvg964TSqZ3AL/0XK9aVQ: posts big blind $2
*** HOLE CARDS ***
RwDoM55ZeQuI2ADyJhOb2Q: raises $4 to $6
6hvg964TSqZ3AL/0XK9aVQ: calls $4
*** FLOP *** [9h 2d 7s]
6hvg964TSqZ3AL/0XK9aVQ: checks
RwDoM55ZeQuI2ADyJhOb2Q: bets $8
6hvg964TSqZ3AL/0XK9aVQ: calls $8
*** TURN *** [9h 2d 7s] [3h]
6hvg964TSqZ3AL/0XK9aVQ: checks
RwDoM55ZeQuI2ADyJhOb2Q: bets $22
6hvg964TSqZ3AL/0XK9aVQ: calls $22
*** RIVER *** [9h 2d 7s 3h] [8s]
6hvg964TSqZ3AL/0XK9aVQ: checks
RwDoM55ZeQuI2ADyJhOb2Q: checks
*** SHOW DOWN ***
6hvg964TSqZ3AL/0XK9aVQ: shows [6h 5c] (a straight, Five to Nine)
RwDoM55ZeQuI2ADyJhOb2Q: mucks hand
6hvg964TSqZ3AL/0XK9aVQ collected $71.50 from pot
*** SUMMARY ***
Total pot $72 | Rake $0.50
Board [9h 2d 7s 3h 8s]
Seat 1: 6hvg964TSqZ3AL/0XK9aVQ (big blind) showed [6h 5c] and won ($71.50) with a straight, Five to Nine
Seat 2: RwDoM55ZeQuI2ADyJhOb2Q (button) (small blind) mucked



PokerStars Game #59940957288:  Hold'em No Limit ($1/$2) - 2009/07/01 1:21:34 ET
Table 'AtOXMvcrtQM8yLNcALmfLQ' 2-max Seat #1 is the button
Seat 1: +HlQuAsMqZGYYtjcPO/a3A ($129.90 in chips)
Seat 2: pVqEzK9wXlRMECnb1Zg4Zw ($267.30 in chips)
+HlQuAsMqZGYYtjcPO/a3A: posts small blind $1
pVqEzK9wXlRMECnb1Zg4Zw: posts big blind $2
*** HOLE CARDS ***
+HlQuAsMqZGYYtjcPO/a3A: calls $1
pVqEzK9wXlRMECnb1Zg4Zw: raises $8 to $10
+HlQuAsMqZGYYtjcPO/a3A: folds
pVqEzK9wXlRMECnb1Zg4Zw collected $4 from pot
pVqEzK9wXlRMECnb1Zg4Zw: doesn't show hand
*** SUMMARY ***
Total pot $4 | Rake $0
Seat 1: +HlQuAsMqZGYYtjcPO/a3A (button) (small blind) folded before Flop
Seat 2: pVqEzK9wXlRMECnb1Zg4Zw (big blind) collected ($4)



PokerStars Game #59940957272:  Hold'em No Limit ($1/$2) - 2009/07/01 1:21:34 ET
Table 'BSRfGh+QobUe0AgIMtt/fw' 9-max Seat #8 is the button
Seat 1: gDn/rYeNwCyWEgRhyWp4PA ($147.95 in chips)
Seat 2: TAfo4veNRaRlzDXMMYS3Jg ($49 in chips)
Seat 3: WUlHm+ydPPHG7Lb0rePSdA ($121 in chips)
Seat 6: H6Z4+qu8gR0VUiPOijndVg ($200 in chips)
Seat 7: CkE3IyJF1KvdaAOmZY5XqQ ($201.15 in chips)
Seat 8: /XRRUMKiOOItJFbrM26RrA ($100.55 in chips)
Seat 9: /inIs/z/PcX+TniIFpaxpg ($403.20 in chips)
/inIs/z/PcX+TniIFpaxpg: posts small blind $1
gDn/rYeNwCyWEgRhyWp4PA: posts big blind $2
MrNegroni: sits out
GX1heJ+DSsvm7gzSPsYhhQ: sits out
*** HOLE CARDS ***
TAfo4veNRaRlzDXMMYS3Jg: folds
WUlHm+ydPPHG7Lb0rePSdA: folds
H6Z4+qu8gR0VUiPOijndVg: folds
CkE3IyJF1KvdaAOmZY5XqQ: folds
/XRRUMKiOOItJFbrM26RrA: folds
/inIs/z/PcX+TniIFpaxpg: folds
gDn/rYeNwCyWEgRhyWp4PA collected $2 from pot
*** SUMMARY ***
Total pot $2 | Rake $0
Seat 1: gDn/rYeNwCyWEgRhyWp4PA (big blind) collected ($2)
Seat 2: TAfo4veNRaRlzDXMMYS3Jg folded before Flop (didn't bet)
Seat 3: WUlHm+ydPPHG7Lb0rePSdA folded before Flop (didn't bet)
Seat 6: H6Z4+qu8gR0VUiPOijndVg folded before Flop (didn't bet)
Seat 7: CkE3IyJF1KvdaAOmZY5XqQ folded before Flop (didn't bet)
Seat 8: /XRRUMKiOOItJFbrM26RrA (button) folded before Flop (didn't bet)
Seat 9: /inIs/z/PcX+TniIFpaxpg (small blind) folded before Flop



PokerStars Game #59940958586:  Hold'em No Limit ($1/$2) - 2009/07/01 1:21:36 ET
Table 'bIihwBANJSFqlHPPtset+w' 9-max Seat #9 is the button
Seat 1: /inIs/z/PcX+TniIFpaxpg ($31 in chips)
Seat 2: lQYT23h5QCUVZAKxjOO39Q ($181.75 in chips)
Seat 3: OipzuP0MueAd8hGaz/kWMQ ($45.85 in chips)
Seat 4: ri8CLkX3e9JF34dQNbsHGA ($42.40 in chips)
Seat 5: vxbbJLsS1bva6tW2NiFssg ($200 in chips)
Seat 6: CkE3IyJF1KvdaAOmZY5XqQ ($186 in chips)
Seat 7: pCmk6FpSOLJ+85o1tLHIag ($130.45 in chips)
Seat 8: iMe5yhc+1BaiIPHet3NMrA ($200.50 in chips)
Seat 9: qn8LDoUFphcG4+r+F+Vhrg ($184 in chips)
/inIs/z/PcX+TniIFpaxpg: posts small blind $1
lQYT23h5QCUVZAKxjOO39Q: posts big blind $2
*** HOLE CARDS ***
OipzuP0MueAd8hGaz/kWMQ: folds
ri8CLkX3e9JF34dQNbsHGA: folds
OipzuP0MueAd8hGaz/kWMQ leaves the table
vxbbJLsS1bva6tW2NiFssg: folds
CkE3IyJF1KvdaAOmZY5XqQ: folds
pCmk6FpSOLJ+85o1tLHIag: folds
iMe5yhc+1BaiIPHet3NMrA: folds
qn8LDoUFphcG4+r+F+Vhrg: folds
+T/63sAeZzWyHchahJ36GQ joins the table at seat #3
/inIs/z/PcX+TniIFpaxpg: folds
lQYT23h5QCUVZAKxjOO39Q collected $2 from pot
*** SUMMARY ***
Total pot $2 | Rake $0
Seat 1: /inIs/z/PcX+TniIFpaxpg (small blind) folded before Flop
Seat 2: lQYT23h5QCUVZAKxjOO39Q (big blind) collected ($2)
Seat 3: OipzuP0MueAd8hGaz/kWMQ folded before Flop (didn't bet)
Seat 4: ri8CLkX3e9JF34dQNbsHGA folded before Flop (didn't bet)
Seat 5: vxbbJLsS1bva6tW2NiFssg folded before Flop (didn't bet)
Seat 6: CkE3IyJF1KvdaAOmZY5XqQ folded before Flop (didn't bet)
Seat 7: pCmk6FpSOLJ+85o1tLHIag folded before Flop (didn't bet)
Seat 8: iMe5yhc+1BaiIPHet3NMrA folded before Flop (didn't bet)
Seat 9: qn8LDoUFphcG4+r+F+Vhrg (button) folded before Flop (didn't bet)



PokerStars Game #59940958316:  Hold'em No Limit ($1/$2) - 2009/07/01 1:21:36 ET
Table 'ztv6V3FN2bQ9nmJPPdx6nQ' 6-max Seat #1 is the button
Seat 1: 6fLdOUCRtX71xbVRhJEq8w ($215 in chips)
Seat 2: 5Y+ZGWLI4gnlpApDX5vy1A ($409.25 in chips)
Seat 3: ubtx4Z5L+AcK71MTvYiGVw ($200 in chips)
Seat 4: UaZ5yj+6LjtWqMQg2QskUw ($115.80 in chips)
Seat 5: sTPOWERd9HWPCNrDBwsVjA ($254 in chips)
Seat 6: mfy7uGZcqA2PVQqEVbJ7+g ($117.45 in chips)
5Y+ZGWLI4gnlpApDX5vy1A: posts small blind $1
ubtx4Z5L+AcK71MTvYiGVw: posts big blind $2
*** HOLE CARDS ***
UaZ5yj+6LjtWqMQg2QskUw has timed out
UaZ5yj+6LjtWqMQg2QskUw: folds
UaZ5yj+6LjtWqMQg2QskUw is sitting out
UaZ5yj+6LjtWqMQg2QskUw has returned
sTPOWERd9HWPCNrDBwsVjA: folds
mfy7uGZcqA2PVQqEVbJ7+g: folds
6fLdOUCRtX71xbVRhJEq8w: folds
5Y+ZGWLI4gnlpApDX5vy1A: folds
ubtx4Z5L+AcK71MTvYiGVw collected $2 from pot
ubtx4Z5L+AcK71MTvYiGVw: doesn't show hand
*** SUMMARY ***
Total pot $2 | Rake $0
Seat 1: 6fLdOUCRtX71xbVRhJEq8w (button) folded before Flop (didn't bet)
Seat 2: 5Y+ZGWLI4gnlpApDX5vy1A (small blind) folded before Flop
Seat 3: ubtx4Z5L+AcK71MTvYiGVw (big blind) collected ($2)
Seat 4: UaZ5yj+6LjtWqMQg2QskUw folded before Flop (didn't bet)
Seat 5: sTPOWERd9HWPCNrDBwsVjA folded before Flop (didn't bet)
Seat 6: mfy7uGZcqA2PVQqEVbJ7+g folded before Flop (didn't bet)



PokerStars Game #59940958894:  Hold'em No Limit ($1/$2) - 2009/07/01 1:21:37 ET
Table 'eyAQSIlgc2o1Jxvbve4WGg' 9-max Seat #5 is the button
Seat 1: UZEsV9yKUMqmpYPiOFpaZw ($101.50 in chips)
Seat 2: g7gL2NLJCdZPPV399WKT1w ($64.65 in chips)
Seat 3: ice1Sbe19zWIaKYoSmE5tw ($96.30 in chips)
Seat 4: CkE3IyJF1KvdaAOmZY5XqQ ($200 in chips)
Seat 5: mIKx5lhIt13X5eZQH0ZeMA ($77.10 in chips)
Seat 8: 1CtiZuXDFaJL1dJPQKyi8Q ($173.35 in chips)
Seat 9: WUlHm+ydPPHG7Lb0rePSdA ($123.70 in chips)
nXDI8Y/S6POzRwANu3d8hQ will be allowed to play after the button
1CtiZuXDFaJL1dJPQKyi8Q: posts small blind $1
WUlHm+ydPPHG7Lb0rePSdA: posts big blind $2
*** HOLE CARDS ***
UZEsV9yKUMqmpYPiOFpaZw: folds
g7gL2NLJCdZPPV399WKT1w has timed out
g7gL2NLJCdZPPV399WKT1w: folds
g7gL2NLJCdZPPV399WKT1w is sitting out
g7gL2NLJCdZPPV399WKT1w has returned
ice1Sbe19zWIaKYoSmE5tw: raises $4 to $6
CkE3IyJF1KvdaAOmZY5XqQ: folds
mIKx5lhIt13X5eZQH0ZeMA: folds
1CtiZuXDFaJL1dJPQKyi8Q: folds
WUlHm+ydPPHG7Lb0rePSdA: folds
ice1Sbe19zWIaKYoSmE5tw collected $5 from pot
*** SUMMARY ***
Total pot $5 | Rake $0
Seat 1: UZEsV9yKUMqmpYPiOFpaZw folded before Flop (didn't bet)
Seat 2: g7gL2NLJCdZPPV399WKT1w folded before Flop (didn't bet)
Seat 3: ice1Sbe19zWIaKYoSmE5tw collected ($5)
Seat 4: CkE3IyJF1KvdaAOmZY5XqQ folded before Flop (didn't bet)
Seat 5: mIKx5lhIt13X5eZQH0ZeMA (button) folded before Flop (didn't bet)
Seat 8: 1CtiZuXDFaJL1dJPQKyi8Q (small blind) folded before Flop
Seat 9: WUlHm+ydPPHG7Lb0rePSdA (big blind) folded before Flop



PokerStars Game #59940962038:  Hold'em No Limit ($1/$2) - 2009/07/01 1:21:42 ET
Table 'aSf77Sj8QEnzcc0WaxVD4Q' 6-max Seat #1 is the button
Seat 1: UELtvp+JfwI7XDGVwSxZXA ($165.75 in chips)
Seat 2: vkfxu8f/jMYKUk6Ly4eujw ($200.80 in chips)
Seat 3: 9dpyyjDTCed6nV7JhaUUpw ($322.55 in chips)
Seat 4: YsLQ3BAvgQHWXMAv3Wv6Hg ($265.70 in chips)
Seat 5: VvdR9F3I+2yELkfTVvC1dg ($245 in chips)
vkfxu8f/jMYKUk6Ly4eujw: posts small blind $1
9dpyyjDTCed6nV7JhaUUpw: posts big blind $2
*** HOLE CARDS ***
YsLQ3BAvgQHWXMAv3Wv6Hg: folds
VvdR9F3I+2yELkfTVvC1dg: folds
UELtvp+JfwI7XDGVwSxZXA: folds
vkfxu8f/jMYKUk6Ly4eujw: raises $6 to $8
9dpyyjDTCed6nV7JhaUUpw: calls $6
*** FLOP *** [Js 4d 3d]
vkoJRf3gidxY1pPi0AFWww has returned
vkfxu8f/jMYKUk6Ly4eujw: bets $10
9dpyyjDTCed6nV7JhaUUpw: raises $25 to $35
vkfxu8f/jMYKUk6Ly4eujw: calls $25
*** TURN *** [Js 4d 3d] [Qs]
vkfxu8f/jMYKUk6Ly4eujw: checks
9dpyyjDTCed6nV7JhaUUpw: checks
*** RIVER *** [Js 4d 3d Qs] [8c]
vkfxu8f/jMYKUk6Ly4eujw: checks
9dpyyjDTCed6nV7JhaUUpw: bets $64
vkfxu8f/jMYKUk6Ly4eujw: raises $93.80 to $157.80 and is all-in
9dpyyjDTCed6nV7JhaUUpw: calls $93.80
*** SHOW DOWN ***
vkfxu8f/jMYKUk6Ly4eujw: shows [8h 3h] (two pair, Eights and Threes)
9dpyyjDTCed6nV7JhaUUpw: shows [Tc 9h] (a straight, Eight to Queen)
9dpyyjDTCed6nV7JhaUUpw collected $399.60 from pot
*** SUMMARY ***
Total pot $401.60 | Rake $2
Board [Js 4d 3d Qs 8c]
Seat 1: UELtvp+JfwI7XDGVwSxZXA (button) folded before Flop (didn't bet)
Seat 2: vkfxu8f/jMYKUk6Ly4eujw (small blind) showed [8h 3h] and lost with two pair, Eights and Threes
Seat 3: 9dpyyjDTCed6nV7JhaUUpw (big blind) showed [Tc 9h] and won ($399.60) with a straight, Eight to Queen
Seat 4: YsLQ3BAvgQHWXMAv3Wv6Hg folded before Flop (didn't bet)
Seat 5: VvdR9F3I+2yELkfTVvC1dg folded before Flop (didn't bet)



PokerStars Game #59940962768:  Hold'em No Limit ($1/$2) - 2009/07/01 1:21:44 ET
Table 'CFkQcfWjKccZaZDf71FK+w' 6-max Seat #6 is the button
Seat 1: JsC+WvfzqlxVs9G8/gSQAQ ($9.55 in chips)
Seat 2: ewN/vzF22+/gdzjIKBOlkA ($235.20 in chips)
Seat 3: 09BNF4quPDzanQzM8vc6WA ($27 in chips)
Seat 4: ygTTt5ehT4aF86q1a8/R+w ($195.10 in chips)
Seat 5: 2lOU1DcvUZaMcxZ95XfzXw ($100 in chips)
Seat 6: ORVqY3rf9X6ANA/8s+On2Q ($112.50 in chips)
JsC+WvfzqlxVs9G8/gSQAQ: posts small blind $1
ewN/vzF22+/gdzjIKBOlkA: posts big blind $2
*** HOLE CARDS ***
09BNF4quPDzanQzM8vc6WA: folds
ygTTt5ehT4aF86q1a8/R+w: raises $4 to $6
2lOU1DcvUZaMcxZ95XfzXw: folds
ORVqY3rf9X6ANA/8s+On2Q: folds
JsC+WvfzqlxVs9G8/gSQAQ: raises $3.55 to $9.55 and is all-in
ewN/vzF22+/gdzjIKBOlkA: folds
ygTTt5ehT4aF86q1a8/R+w: calls $3.55
*** FLOP *** [7c Kh 8h]
*** TURN *** [7c Kh 8h] [8s]
*** RIVER *** [7c Kh 8h 8s] [8d]
*** SHOW DOWN ***
JsC+WvfzqlxVs9G8/gSQAQ: shows [Kc Ks] (a full house, Kings full of Eights)
ygTTt5ehT4aF86q1a8/R+w: mucks hand
JsC+WvfzqlxVs9G8/gSQAQ collected $20.05 from pot
*** SUMMARY ***
Total pot $21.10 | Rake $1.05
Board [7c Kh 8h 8s 8d]
Seat 1: JsC+WvfzqlxVs9G8/gSQAQ (small blind) showed [Kc Ks] and won ($20.05) with a full house, Kings full of Eights
Seat 2: ewN/vzF22+/gdzjIKBOlkA (big blind) folded before Flop
Seat 3: 09BNF4quPDzanQzM8vc6WA folded before Flop (didn't bet)
Seat 4: ygTTt5ehT4aF86q1a8/R+w mucked
Seat 5: 2lOU1DcvUZaMcxZ95XfzXw folded before Flop (didn't bet)
Seat 6: ORVqY3rf9X6ANA/8s+On2Q (button) folded before Flop (didn't bet)



PokerStars Game #59940962858:  Hold'em No Limit ($1/$2) - 2009/07/01 1:21:44 ET
Table 'kq5zaQ+1hLNf8LZfGnbTAA' 6-max Seat #4 is the button
Seat 1: 8srN1dKQePlsv0GyTada+Q ($245.20 in chips)
Seat 2: nXDI8Y/S6POzRwANu3d8hQ ($41.75 in chips)
Seat 3: vkfxu8f/jMYKUk6Ly4eujw ($227.95 in chips)
Seat 4: 3dAbvkxS5NPQTBAbvpinVg ($200 in chips)
Seat 5: kfASJqTbXek+zc8ZKsZL1Q ($137.40 in chips)
Seat 6: mfy7uGZcqA2PVQqEVbJ7+g ($199.25 in chips)
kfASJqTbXek+zc8ZKsZL1Q: posts small blind $1
mfy7uGZcqA2PVQqEVbJ7+g: posts big blind $2
*** HOLE CARDS ***
8srN1dKQePlsv0GyTada+Q: folds
nXDI8Y/S6POzRwANu3d8hQ: folds
vkfxu8f/jMYKUk6Ly4eujw: folds
3dAbvkxS5NPQTBAbvpinVg: raises $4 to $6
kfASJqTbXek+zc8ZKsZL1Q: calls $5
mfy7uGZcqA2PVQqEVbJ7+g: folds
*** FLOP *** [Kh 2c Jh]
kfASJqTbXek+zc8ZKsZL1Q: checks
3dAbvkxS5NPQTBAbvpinVg: bets $10
kfASJqTbXek+zc8ZKsZL1Q: raises $10 to $20
3dAbvkxS5NPQTBAbvpinVg: folds
kfASJqTbXek+zc8ZKsZL1Q collected $32.35 from pot
kfASJqTbXek+zc8ZKsZL1Q: doesn't show hand
*** SUMMARY ***
Total pot $34 | Rake $1.65
Board [Kh 2c Jh]
Seat 1: 8srN1dKQePlsv0GyTada+Q folded before Flop (didn't bet)
Seat 2: nXDI8Y/S6POzRwANu3d8hQ folded before Flop (didn't bet)
Seat 3: vkfxu8f/jMYKUk6Ly4eujw folded before Flop (didn't bet)
Seat 4: 3dAbvkxS5NPQTBAbvpinVg (button) folded on the Flop
Seat 5: kfASJqTbXek+zc8ZKsZL1Q (small blind) collected ($32.35)
Seat 6: mfy7uGZcqA2PVQqEVbJ7+g (big blind) folded before Flop



PokerStars Game #59940963648:  Hold'em No Limit ($1/$2) - 2009/07/01 1:21:45 ET
Table 'LL4bDFyhj5hsMpzaDugJZg' 6-max Seat #1 is the button
Seat 1: FwvID/fQGlpY3soi/lMTww ($84.95 in chips)
Seat 2: IZng3w8jiJHHp3LbYKLi4w ($51.15 in chips)
Seat 3: iI/NMpRxMkGieArQEhACSA ($288.30 in chips)
Seat 4: 8srN1dKQePlsv0GyTada+Q ($314.75 in chips)
Seat 5: A2GTwTiwkb1ilNWgW487Vg ($67.20 in chips)
Seat 6: 692Q4sfB0gTElzS0WMeg+A ($208.10 in chips)
IZng3w8jiJHHp3LbYKLi4w: posts small blind $1
iI/NMpRxMkGieArQEhACSA: posts big blind $2
*** HOLE CARDS ***
8srN1dKQePlsv0GyTada+Q: folds
A2GTwTiwkb1ilNWgW487Vg: calls $2
692Q4sfB0gTElzS0WMeg+A: folds
FwvID/fQGlpY3soi/lMTww: calls $2
IZng3w8jiJHHp3LbYKLi4w: calls $1
iI/NMpRxMkGieArQEhACSA: checks
*** FLOP *** [Ah 8d 5s]
IZng3w8jiJHHp3LbYKLi4w: checks
iI/NMpRxMkGieArQEhACSA: checks
A2GTwTiwkb1ilNWgW487Vg: bets $5
FwvID/fQGlpY3soi/lMTww: folds
IZng3w8jiJHHp3LbYKLi4w: folds
iI/NMpRxMkGieArQEhACSA: folds
A2GTwTiwkb1ilNWgW487Vg collected $7.60 from pot
*** SUMMARY ***
Total pot $8 | Rake $0.40
Board [Ah 8d 5s]
Seat 1: FwvID/fQGlpY3soi/lMTww (button) folded on the Flop
Seat 2: IZng3w8jiJHHp3LbYKLi4w (small blind) folded on the Flop
Seat 3: iI/NMpRxMkGieArQEhACSA (big blind) folded on the Flop
Seat 4: 8srN1dKQePlsv0GyTada+Q folded before Flop (didn't bet)
Seat 5: A2GTwTiwkb1ilNWgW487Vg collected ($7.60)
Seat 6: 692Q4sfB0gTElzS0WMeg+A folded before Flop (didn't bet)



PokerStars Game #59940964190:  Hold'em No Limit ($1/$2) - 2009/07/01 1:21:46 ET
Table 'uJ9juaXXg9yIcSU8amxaXQ' 6-max Seat #3 is the button
Seat 1: JsqOjN/eHz0uYVf/PyUJ6Q ($149.85 in chips)
Seat 2: VvdR9F3I+2yELkfTVvC1dg ($200 in chips)
Seat 3: qXDd0ZyMIse0OBu8pxeQ3Q ($256 in chips)
Seat 4: zNjJ/y4emmF+vzrCDd+ooA ($216.05 in chips)
Seat 5: YsLQ3BAvgQHWXMAv3Wv6Hg ($200 in chips)
Seat 6: 2DFp9Veq1xxq64dCjwNuUw ($51.90 in chips)
zNjJ/y4emmF+vzrCDd+ooA: posts small blind $1
YsLQ3BAvgQHWXMAv3Wv6Hg: posts big blind $2
*** HOLE CARDS ***
2DFp9Veq1xxq64dCjwNuUw: calls $2
JsqOjN/eHz0uYVf/PyUJ6Q: folds
VvdR9F3I+2yELkfTVvC1dg: folds
qXDd0ZyMIse0OBu8pxeQ3Q: folds
zNjJ/y4emmF+vzrCDd+ooA: calls $1
YsLQ3BAvgQHWXMAv3Wv6Hg: checks
*** FLOP *** [4h 8s 3h]
zNjJ/y4emmF+vzrCDd+ooA: checks
YsLQ3BAvgQHWXMAv3Wv6Hg: checks
2DFp9Veq1xxq64dCjwNuUw: checks
*** TURN *** [4h 8s 3h] [Js]
zNjJ/y4emmF+vzrCDd+ooA: checks
YsLQ3BAvgQHWXMAv3Wv6Hg: checks
2DFp9Veq1xxq64dCjwNuUw: bets $4
zNjJ/y4emmF+vzrCDd+ooA: folds
YsLQ3BAvgQHWXMAv3Wv6Hg: folds
2DFp9Veq1xxq64dCjwNuUw collected $5.70 from pot
2DFp9Veq1xxq64dCjwNuUw: doesn't show hand
*** SUMMARY ***
Total pot $6 | Rake $0.30
Board [4h 8s 3h Js]
Seat 1: JsqOjN/eHz0uYVf/PyUJ6Q folded before Flop (didn't bet)
Seat 2: VvdR9F3I+2yELkfTVvC1dg folded before Flop (didn't bet)
Seat 3: qXDd0ZyMIse0OBu8pxeQ3Q (button) folded before Flop (didn't bet)
Seat 4: zNjJ/y4emmF+vzrCDd+ooA (small blind) folded on the Turn
Seat 5: YsLQ3BAvgQHWXMAv3Wv6Hg (big blind) folded on the Turn
Seat 6: 2DFp9Veq1xxq64dCjwNuUw collected ($5.70)



PokerStars Game #59940964008:  Hold'em No Limit ($1/$2) - 2009/07/01 1:21:46 ET
Table 'qVXak+oTeDXMGbWa4sDU5Q' 9-max Seat #9 is the button
Seat 1: H6Z4+qu8gR0VUiPOijndVg ($250.55 in chips)
Seat 2: rW/MyplHylMSBRaoRUzWrg ($40 in chips)
Seat 3: WUlHm+ydPPHG7Lb0rePSdA ($172.65 in chips)
Seat 4: lQYT23h5QCUVZAKxjOO39Q ($105.25 in chips)
Seat 5: FWGiDqRwvLeKmHq9t4Jy9w ($268.80 in chips)
Seat 6: GX1heJ+DSsvm7gzSPsYhhQ ($34 in chips)
Seat 7: PfmlvZlFiss79a6IoEr11g ($121.30 in chips)
Seat 8: Z0rzUi0y1x80UdIpofoNbA ($64.55 in chips)
Seat 9: CkE3IyJF1KvdaAOmZY5XqQ ($203 in chips)
H6Z4+qu8gR0VUiPOijndVg: posts small blind $1
rW/MyplHylMSBRaoRUzWrg: posts big blind $2
Z0rzUi0y1x80UdIpofoNbA: posts big blind $2
*** HOLE CARDS ***
WUlHm+ydPPHG7Lb0rePSdA: folds
lQYT23h5QCUVZAKxjOO39Q: calls $2
FWGiDqRwvLeKmHq9t4Jy9w: folds
GX1heJ+DSsvm7gzSPsYhhQ: folds
PfmlvZlFiss79a6IoEr11g: folds
Z0rzUi0y1x80UdIpofoNbA: checks
CkE3IyJF1KvdaAOmZY5XqQ: calls $2
H6Z4+qu8gR0VUiPOijndVg: folds
rW/MyplHylMSBRaoRUzWrg: checks
*** FLOP *** [Kd 8d Jc]
rW/MyplHylMSBRaoRUzWrg: checks
lQYT23h5QCUVZAKxjOO39Q: bets $4
Z0rzUi0y1x80UdIpofoNbA: folds
CkE3IyJF1KvdaAOmZY5XqQ: calls $4
rW/MyplHylMSBRaoRUzWrg: folds
*** TURN *** [Kd 8d Jc] [Jh]
lQYT23h5QCUVZAKxjOO39Q: bets $4
CkE3IyJF1KvdaAOmZY5XqQ: folds
lQYT23h5QCUVZAKxjOO39Q collected $16.20 from pot
*** SUMMARY ***
Total pot $17 | Rake $0.80
Board [Kd 8d Jc Jh]
Seat 1: H6Z4+qu8gR0VUiPOijndVg (small blind) folded before Flop
Seat 2: rW/MyplHylMSBRaoRUzWrg (big blind) folded on the Flop
Seat 3: WUlHm+ydPPHG7Lb0rePSdA folded before Flop (didn't bet)
Seat 4: lQYT23h5QCUVZAKxjOO39Q collected ($16.20)
Seat 5: FWGiDqRwvLeKmHq9t4Jy9w folded before Flop (didn't bet)
Seat 6: GX1heJ+DSsvm7gzSPsYhhQ folded before Flop (didn't bet)
Seat 7: PfmlvZlFiss79a6IoEr11g folded before Flop (didn't bet)
Seat 8: Z0rzUi0y1x80UdIpofoNbA folded on the Flop
Seat 9: CkE3IyJF1KvdaAOmZY5XqQ (button) folded on the Turn



PokerStars Game #59940964634:  Hold'em No Limit ($1/$2) - 2009/07/01 1:21:47 ET
Table '/dyk+YdRGv90j2box35j8w' 6-max Seat #5 is the button
Seat 2: qCnEYuAE5y5A7bk6fO5/jQ ($493.60 in chips)
Seat 3: sTPOWERd9HWPCNrDBwsVjA ($173.50 in chips)
Seat 4: z/u1YTnkiIDrtp/2cA2dBg ($190.65 in chips)
Seat 5: VvdR9F3I+2yELkfTVvC1dg ($200 in chips)
ZwvXzkkZ3XpMhKfAmVpahw: is sitting out
8srN1dKQePlsv0GyTada+Q will be allowed to play after the button
qCnEYuAE5y5A7bk6fO5/jQ: posts small blind $1
sTPOWERd9HWPCNrDBwsVjA: posts big blind $2
*** HOLE CARDS ***
z/u1YTnkiIDrtp/2cA2dBg: folds
VvdR9F3I+2yELkfTVvC1dg: folds
qCnEYuAE5y5A7bk6fO5/jQ: raises $6 to $8
sTPOWERd9HWPCNrDBwsVjA: calls $6
*** FLOP *** [Ks Th Ad]
qCnEYuAE5y5A7bk6fO5/jQ: bets $10
sTPOWERd9HWPCNrDBwsVjA: raises $20 to $30
qCnEYuAE5y5A7bk6fO5/jQ: folds
sTPOWERd9HWPCNrDBwsVjA collected $34.25 from pot
*** SUMMARY ***
Total pot $36 | Rake $1.75
Board [Ks Th Ad]
Seat 2: qCnEYuAE5y5A7bk6fO5/jQ (small blind) folded on the Flop
Seat 3: sTPOWERd9HWPCNrDBwsVjA (big blind) collected ($34.25)
Seat 4: z/u1YTnkiIDrtp/2cA2dBg folded before Flop (didn't bet)
Seat 5: VvdR9F3I+2yELkfTVvC1dg (button) folded before Flop (didn't bet)



PokerStars Game #59940964918:  Hold'em No Limit ($1/$2) - 2009/07/01 1:21:47 ET
Table 'mGpP9StWRnoeiBDExc6Frg' 6-max Seat #3 is the button
Seat 1: VvdR9F3I+2yELkfTVvC1dg ($200 in chips)
Seat 2: dZcLsEI8iXkobBduRJ45Yw ($69.50 in chips)
Seat 3: 7acrZUQC3Zc9BNLjoKIcLQ ($45.35 in chips)
Seat 4: 4dcDwIHRm96PwtqkpQiuiA ($41.35 in chips)
Seat 5: d1puGuVBE0fidn+5eRJ0tw ($217.20 in chips)
Seat 6: B2Ih1sr5VZk+8He7rcrMtQ ($463.20 in chips)
4dcDwIHRm96PwtqkpQiuiA: posts small blind $1
d1puGuVBE0fidn+5eRJ0tw: posts big blind $2
*** HOLE CARDS ***
B2Ih1sr5VZk+8He7rcrMtQ: raises $6 to $8
VvdR9F3I+2yELkfTVvC1dg: folds
dZcLsEI8iXkobBduRJ45Yw: folds
7acrZUQC3Zc9BNLjoKIcLQ: folds
4dcDwIHRm96PwtqkpQiuiA: raises $10 to $18
d1puGuVBE0fidn+5eRJ0tw: raises $199.20 to $217.20 and is all-in
B2Ih1sr5VZk+8He7rcrMtQ: folds
4dcDwIHRm96PwtqkpQiuiA: calls $23.35 and is all-in
*** FLOP *** [9h Ah 5c]
*** TURN *** [9h Ah 5c] [4d]
*** RIVER *** [9h Ah 5c 4d] [3h]
B2Ih1sr5VZk+8He7rcrMtQ said, "i layed JJ"
*** SHOW DOWN ***
4dcDwIHRm96PwtqkpQiuiA: shows [Ad Kd] (a pair of Aces)
d1puGuVBE0fidn+5eRJ0tw: mucks hand
4dcDwIHRm96PwtqkpQiuiA collected $87.70 from pot
*** SUMMARY ***
Total pot $90.70 | Rake $3
Board [9h Ah 5c 4d 3h]
Seat 1: VvdR9F3I+2yELkfTVvC1dg folded before Flop (didn't bet)
Seat 2: dZcLsEI8iXkobBduRJ45Yw folded before Flop (didn't bet)
Seat 3: 7acrZUQC3Zc9BNLjoKIcLQ (button) folded before Flop (didn't bet)
Seat 4: 4dcDwIHRm96PwtqkpQiuiA (small blind) showed [Ad Kd] and won ($87.70) with a pair of Aces
Seat 5: d1puGuVBE0fidn+5eRJ0tw (big blind) mucked
Seat 6: B2Ih1sr5VZk+8He7rcrMtQ folded before Flop



PokerStars Game #59940964444:  Hold'em No Limit ($1/$2) - 2009/07/01 1:21:47 ET
Table 'pPQgcj9XT9CHBsbo1WTBug' 6-max Seat #2 is the button
Seat 1: DFVYDA6dKQy7R7mGIKogZA ($130.65 in chips)
Seat 2: qXDd0ZyMIse0OBu8pxeQ3Q ($215.30 in chips)
Seat 3: 54yWzRRgS0oZ+S6LwZBxMQ ($38 in chips)
Seat 4: gqlysXCbT8V54f/1lf9h3A ($34.75 in chips)
Seat 5: vkfxu8f/jMYKUk6Ly4eujw ($226.10 in chips)
Seat 6: Yr7pZltpy3IUNdKS9PCEiw ($307.30 in chips)
54yWzRRgS0oZ+S6LwZBxMQ: posts small blind $1
gqlysXCbT8V54f/1lf9h3A: posts big blind $2
*** HOLE CARDS ***
vkfxu8f/jMYKUk6Ly4eujw: folds
Yr7pZltpy3IUNdKS9PCEiw: folds
DFVYDA6dKQy7R7mGIKogZA: calls $2
qXDd0ZyMIse0OBu8pxeQ3Q: folds
54yWzRRgS0oZ+S6LwZBxMQ: calls $1
gqlysXCbT8V54f/1lf9h3A: checks
*** FLOP *** [Qc Jh 2s]
54yWzRRgS0oZ+S6LwZBxMQ: bets $4
gqlysXCbT8V54f/1lf9h3A: calls $4
DFVYDA6dKQy7R7mGIKogZA: folds
*** TURN *** [Qc Jh 2s] [Qs]
54yWzRRgS0oZ+S6LwZBxMQ: bets $4
gqlysXCbT8V54f/1lf9h3A: calls $4
*** RIVER *** [Qc Jh 2s Qs] [Qd]
54yWzRRgS0oZ+S6LwZBxMQ: bets $6
gqlysXCbT8V54f/1lf9h3A: folds
54yWzRRgS0oZ+S6LwZBxMQ collected $20.95 from pot
54yWzRRgS0oZ+S6LwZBxMQ: doesn't show hand
*** SUMMARY ***
Total pot $22 | Rake $1.05
Board [Qc Jh 2s Qs Qd]
Seat 1: DFVYDA6dKQy7R7mGIKogZA folded on the Flop
Seat 2: qXDd0ZyMIse0OBu8pxeQ3Q (button) folded before Flop (didn't bet)
Seat 3: 54yWzRRgS0oZ+S6LwZBxMQ (small blind) collected ($20.95)
Seat 4: gqlysXCbT8V54f/1lf9h3A (big blind) folded on the River
Seat 5: vkfxu8f/jMYKUk6Ly4eujw folded before Flop (didn't bet)
Seat 6: Yr7pZltpy3IUNdKS9PCEiw folded before Flop (didn't bet)



PokerStars Game #59940967100:  Hold'em No Limit ($1/$2) - 2009/07/01 1:21:51 ET
Table '+hSnXFQrGw1PlVgTnuj+sA' 6-max Seat #1 is the button
Seat 1: 2ccIJhDj+3JapvS7swVZEg ($297.75 in chips)
Seat 2: o9jamqIi6sTTRSqudgboRA ($279.90 in chips)
Seat 3: fE+LHW/7rpfXW14g8LhGjA ($34.65 in chips)
Seat 4: J4iH5epwXbmODnojR/VRxA ($165.60 in chips)
Seat 5: VvdR9F3I+2yELkfTVvC1dg ($226.75 in chips)
Seat 6: AuiGltq875lmaKHBsjZVGg ($85.75 in chips)
o9jamqIi6sTTRSqudgboRA: posts small blind $1
fE+LHW/7rpfXW14g8LhGjA: posts big blind $2
*** HOLE CARDS ***
J4iH5epwXbmODnojR/VRxA: folds
VvdR9F3I+2yELkfTVvC1dg: raises $2 to $4
AuiGltq875lmaKHBsjZVGg: folds
2ccIJhDj+3JapvS7swVZEg: folds
o9jamqIi6sTTRSqudgboRA: folds
fE+LHW/7rpfXW14g8LhGjA: raises $6 to $10
VvdR9F3I+2yELkfTVvC1dg: calls $6
*** FLOP *** [Jd 8h 7d]
fE+LHW/7rpfXW14g8LhGjA: bets $24.65 and is all-in
VvdR9F3I+2yELkfTVvC1dg: calls $24.65
*** TURN *** [Jd 8h 7d] [4h]
*** RIVER *** [Jd 8h 7d 4h] [5s]
*** SHOW DOWN ***
fE+LHW/7rpfXW14g8LhGjA: shows [Th Ts] (a pair of Tens)
VvdR9F3I+2yELkfTVvC1dg: mucks hand
fE+LHW/7rpfXW14g8LhGjA collected $67.30 from pot
*** SUMMARY ***
Total pot $70.30 | Rake $3
Board [Jd 8h 7d 4h 5s]
Seat 1: 2ccIJhDj+3JapvS7swVZEg (button) folded before Flop (didn't bet)
Seat 2: o9jamqIi6sTTRSqudgboRA (small blind) folded before Flop
Seat 3: fE+LHW/7rpfXW14g8LhGjA (big blind) showed [Th Ts] and won ($67.30) with a pair of Tens
Seat 4: J4iH5epwXbmODnojR/VRxA folded before Flop (didn't bet)
Seat 5: VvdR9F3I+2yELkfTVvC1dg mucked
Seat 6: AuiGltq875lmaKHBsjZVGg folded before Flop (didn't bet)



PokerStars Game #59940966894:  Hold'em No Limit ($1/$2) - 2009/07/01 1:21:51 ET
Table 'AtOXMvcrtQM8yLNcALmfLQ' 2-max Seat #2 is the button
Seat 1: +HlQuAsMqZGYYtjcPO/a3A ($127.90 in chips)
Seat 2: pVqEzK9wXlRMECnb1Zg4Zw ($269.30 in chips)
pVqEzK9wXlRMECnb1Zg4Zw: posts small blind $1
+HlQuAsMqZGYYtjcPO/a3A: posts big blind $2
*** HOLE CARDS ***
pVqEzK9wXlRMECnb1Zg4Zw: raises $6 to $8
+HlQuAsMqZGYYtjcPO/a3A: folds
pVqEzK9wXlRMECnb1Zg4Zw collected $4 from pot
pVqEzK9wXlRMECnb1Zg4Zw: doesn't show hand
*** SUMMARY ***
Total pot $4 | Rake $0
Seat 1: +HlQuAsMqZGYYtjcPO/a3A (big blind) folded before Flop
Seat 2: pVqEzK9wXlRMECnb1Zg4Zw (button) (small blind) collected ($4)



PokerStars Game #59940967642:  Hold'em No Limit ($1/$2) - 2009/07/01 1:21:52 ET
Table '8Y6PEyoNuepZTai2Q56aHw' 9-max Seat #7 is the button
Seat 1: 5Q8U6iZbeO7xJSS4qvDP5g ($282 in chips)
Seat 2: gDCJIAlovbPnTvMM7Dd1gA ($176.35 in chips)
Seat 3: WUlHm+ydPPHG7Lb0rePSdA ($128.30 in chips)
Seat 4: xKkwALG38OfLQ9DXuJgR1w ($284.55 in chips)
Seat 6: NtLDBSjsJQEKekh5cdinvw ($361.20 in chips)
Seat 7: Kzta8yu9vxHT4B70mjBZ+w ($200 in chips)
Seat 8: rW/MyplHylMSBRaoRUzWrg ($38 in chips)
Seat 9: F7m34OOfAQ7annesMHVjKw ($88.80 in chips)
rW/MyplHylMSBRaoRUzWrg: posts small blind $1
F7m34OOfAQ7annesMHVjKw: posts big blind $2
*** HOLE CARDS ***
5Q8U6iZbeO7xJSS4qvDP5g: folds
gDCJIAlovbPnTvMM7Dd1gA: folds
WUlHm+ydPPHG7Lb0rePSdA: folds
xKkwALG38OfLQ9DXuJgR1w: folds
NtLDBSjsJQEKekh5cdinvw: folds
Kzta8yu9vxHT4B70mjBZ+w: folds
rW/MyplHylMSBRaoRUzWrg: folds
F7m34OOfAQ7annesMHVjKw collected $2 from pot
*** SUMMARY ***
Total pot $2 | Rake $0
Seat 1: 5Q8U6iZbeO7xJSS4qvDP5g folded before Flop (didn't bet)
Seat 2: gDCJIAlovbPnTvMM7Dd1gA folded before Flop (didn't bet)
Seat 3: WUlHm+ydPPHG7Lb0rePSdA folded before Flop (didn't bet)
Seat 4: xKkwALG38OfLQ9DXuJgR1w folded before Flop (didn't bet)
Seat 6: NtLDBSjsJQEKekh5cdinvw folded before Flop (didn't bet)
Seat 7: Kzta8yu9vxHT4B70mjBZ+w (button) folded before Flop (didn't bet)
Seat 8: rW/MyplHylMSBRaoRUzWrg (small blind) folded before Flop
Seat 9: F7m34OOfAQ7annesMHVjKw (big blind) collected ($2)



PokerStars Game #59940968572:  Hold'em No Limit ($1/$2) - 2009/07/01 1:21:54 ET
Table 'ZzSIe0zTCDv+n6hfbY5tTg' 6-max Seat #3 is the button
Seat 1: VvdR9F3I+2yELkfTVvC1dg ($215.10 in chips)
Seat 2: B87ikIyZ/TzAVeXf38Ny0g ($237 in chips)
Seat 3: gsugPj31Hui3Jefl98MBOA ($213.65 in chips)
Seat 4: qXDd0ZyMIse0OBu8pxeQ3Q ($200 in chips)
Seat 5: 3dAbvkxS5NPQTBAbvpinVg ($486.30 in chips)
Seat 6: 09BNF4quPDzanQzM8vc6WA ($22.50 in chips)
qXDd0ZyMIse0OBu8pxeQ3Q: posts small blind $1
3dAbvkxS5NPQTBAbvpinVg: posts big blind $2
*** HOLE CARDS ***
09BNF4quPDzanQzM8vc6WA: folds
VvdR9F3I+2yELkfTVvC1dg: folds
B87ikIyZ/TzAVeXf38Ny0g: folds
gsugPj31Hui3Jefl98MBOA: calls $2
qXDd0ZyMIse0OBu8pxeQ3Q: raises $10 to $12
3dAbvkxS5NPQTBAbvpinVg: folds
gsugPj31Hui3Jefl98MBOA: calls $10
*** FLOP *** [Kd 7s 7d]
qXDd0ZyMIse0OBu8pxeQ3Q: bets $18
gsugPj31Hui3Jefl98MBOA: folds
qXDd0ZyMIse0OBu8pxeQ3Q collected $24.70 from pot
*** SUMMARY ***
Total pot $26 | Rake $1.30
Board [Kd 7s 7d]
Seat 1: VvdR9F3I+2yELkfTVvC1dg folded before Flop (didn't bet)
Seat 2: B87ikIyZ/TzAVeXf38Ny0g folded before Flop (didn't bet)
Seat 3: gsugPj31Hui3Jefl98MBOA (button) folded on the Flop
Seat 4: qXDd0ZyMIse0OBu8pxeQ3Q (small blind) collected ($24.70)
Seat 5: 3dAbvkxS5NPQTBAbvpinVg (big blind) folded before Flop
Seat 6: 09BNF4quPDzanQzM8vc6WA folded before Flop (didn't bet)



PokerStars Game #59940968324:  Hold'em No Limit ($1/$2) - 2009/07/01 1:21:54 ET
Table '4NGNnZ/osQfNq6abYqkJeA' 6-max Seat #2 is the button
Seat 1: 7zM38baFvmCNB/F80oE0cQ ($56.30 in chips)
Seat 2: 669iGNwYwgRZg3nhS+aDAQ ($93.15 in chips)
Seat 3: 54yWzRRgS0oZ+S6LwZBxMQ ($28.75 in chips)
Seat 4: sY+4Uuh5z/6AbXXaCS10jw ($200 in chips)
Seat 5: VvdR9F3I+2yELkfTVvC1dg ($241.80 in chips)
Seat 6: kkgpegLoQkmL6LIsFsvtiQ ($267.05 in chips)
54yWzRRgS0oZ+S6LwZBxMQ: posts small blind $1
sY+4Uuh5z/6AbXXaCS10jw: posts big blind $2
*** HOLE CARDS ***
VvdR9F3I+2yELkfTVvC1dg: raises $2 to $4
kkgpegLoQkmL6LIsFsvtiQ: calls $4
7zM38baFvmCNB/F80oE0cQ: folds
669iGNwYwgRZg3nhS+aDAQ: folds
54yWzRRgS0oZ+S6LwZBxMQ: folds
sY+4Uuh5z/6AbXXaCS10jw: calls $2
*** FLOP *** [5d 7c 7d]
sY+4Uuh5z/6AbXXaCS10jw: bets $8
VvdR9F3I+2yELkfTVvC1dg: folds
kkgpegLoQkmL6LIsFsvtiQ: folds
sY+4Uuh5z/6AbXXaCS10jw collected $12.35 from pot
*** SUMMARY ***
Total pot $13 | Rake $0.65
Board [5d 7c 7d]
Seat 1: 7zM38baFvmCNB/F80oE0cQ folded before Flop (didn't bet)
Seat 2: 669iGNwYwgRZg3nhS+aDAQ (button) folded before Flop (didn't bet)
Seat 3: 54yWzRRgS0oZ+S6LwZBxMQ (small blind) folded before Flop
Seat 4: sY+4Uuh5z/6AbXXaCS10jw (big blind) collected ($12.35)
Seat 5: VvdR9F3I+2yELkfTVvC1dg folded on the Flop
Seat 6: kkgpegLoQkmL6LIsFsvtiQ folded on the Flop



PokerStars Game #59940968606:  Hold'em No Limit ($1/$2) - 2009/07/01 1:21:54 ET
Table 'NmY84NAf9Mh0ckAckHnh5g' 2-max Seat #1 is the button
Seat 1: 6hvg964TSqZ3AL/0XK9aVQ ($341.10 in chips)
Seat 2: RwDoM55ZeQuI2ADyJhOb2Q ($666.40 in chips)
6hvg964TSqZ3AL/0XK9aVQ: posts small blind $1
RwDoM55ZeQuI2ADyJhOb2Q: posts big blind $2
*** HOLE CARDS ***
6hvg964TSqZ3AL/0XK9aVQ: calls $1
RwDoM55ZeQuI2ADyJhOb2Q: raises $6 to $8
6hvg964TSqZ3AL/0XK9aVQ: calls $6
*** FLOP *** [Jh Tc 6d]
RwDoM55ZeQuI2ADyJhOb2Q: checks
6hvg964TSqZ3AL/0XK9aVQ: checks
*** TURN *** [Jh Tc 6d] [7c]
RwDoM55ZeQuI2ADyJhOb2Q: checks
6hvg964TSqZ3AL/0XK9aVQ: checks
*** RIVER *** [Jh Tc 6d 7c] [4c]
RwDoM55ZeQuI2ADyJhOb2Q: checks
6hvg964TSqZ3AL/0XK9aVQ: bets $10
RwDoM55ZeQuI2ADyJhOb2Q: calls $10
*** SHOW DOWN ***
6hvg964TSqZ3AL/0XK9aVQ: shows [2s 2h] (a pair of Deuces)
RwDoM55ZeQuI2ADyJhOb2Q: shows [Ad 4s] (a pair of Fours)
RwDoM55ZeQuI2ADyJhOb2Q collected $35.50 from pot
*** SUMMARY ***
Total pot $36 | Rake $0.50
Board [Jh Tc 6d 7c 4c]
Seat 1: 6hvg964TSqZ3AL/0XK9aVQ (button) (small blind) showed [2s 2h] and lost with a pair of Deuces
Seat 2: RwDoM55ZeQuI2ADyJhOb2Q (big blind) showed [Ad 4s] and won ($35.50) with a pair of Fours



PokerStars Game #59940969310:  Hold'em No Limit ($1/$2) - 2009/07/01 1:21:55 ET
Table '3WCXyaiCAbqSShQu7FIjvA' 9-max Seat #5 is the button
Seat 1: kTCkABD1UUldS9DFRGfCwQ ($151.60 in chips)
Seat 2: 1zQMh8lHgW3t2YhVeA+09A ($8.80 in chips)
Seat 3: 5Q8U6iZbeO7xJSS4qvDP5g ($200 in chips)
Seat 4: waEF/+pxZTxNo4FvsORuXg ($77 in chips)
Seat 5: CkE3IyJF1KvdaAOmZY5XqQ ($200 in chips)
Seat 6: 5jQlngvMSqM/WoonOcR5kw ($284.35 in chips)
Seat 8: 1CtiZuXDFaJL1dJPQKyi8Q ($234.25 in chips)
Seat 9: FiXPLJyqb24l32QST2TInw ($176.30 in chips)
5jQlngvMSqM/WoonOcR5kw: posts small blind $1
1CtiZuXDFaJL1dJPQKyi8Q: posts big blind $2
*** HOLE CARDS ***
FiXPLJyqb24l32QST2TInw: calls $2
kTCkABD1UUldS9DFRGfCwQ: folds
1zQMh8lHgW3t2YhVeA+09A: folds
5Q8U6iZbeO7xJSS4qvDP5g: folds
waEF/+pxZTxNo4FvsORuXg: folds
CkE3IyJF1KvdaAOmZY5XqQ: folds
5jQlngvMSqM/WoonOcR5kw: calls $1
1CtiZuXDFaJL1dJPQKyi8Q: raises $6 to $8
FiXPLJyqb24l32QST2TInw: calls $6
5jQlngvMSqM/WoonOcR5kw: folds
*** FLOP *** [6h 4c Qs]
1CtiZuXDFaJL1dJPQKyi8Q: bets $12
FiXPLJyqb24l32QST2TInw: folds
1CtiZuXDFaJL1dJPQKyi8Q collected $17.10 from pot
1CtiZuXDFaJL1dJPQKyi8Q: doesn't show hand
*** SUMMARY ***
Total pot $18 | Rake $0.90
Board [6h 4c Qs]
Seat 1: kTCkABD1UUldS9DFRGfCwQ folded before Flop (didn't bet)
Seat 2: 1zQMh8lHgW3t2YhVeA+09A folded before Flop (didn't bet)
Seat 3: 5Q8U6iZbeO7xJSS4qvDP5g folded before Flop (didn't bet)
Seat 4: waEF/+pxZTxNo4FvsORuXg folded before Flop (didn't bet)
Seat 5: CkE3IyJF1KvdaAOmZY5XqQ (button) folded before Flop (didn't bet)
Seat 6: 5jQlngvMSqM/WoonOcR5kw (small blind) folded before Flop
Seat 8: 1CtiZuXDFaJL1dJPQKyi8Q (big blind) collected ($17.10)
Seat 9: FiXPLJyqb24l32QST2TInw folded on the Flop



PokerStars Game #59940973514:  Hold'em No Limit ($1/$2) - 2009/07/01 1:21:59 ET
Table 'AtOXMvcrtQM8yLNcALmfLQ' 2-max Seat #1 is the button
Seat 1: +HlQuAsMqZGYYtjcPO/a3A ($125.90 in chips)
Seat 2: pVqEzK9wXlRMECnb1Zg4Zw ($271.30 in chips)
+HlQuAsMqZGYYtjcPO/a3A: posts small blind $1
pVqEzK9wXlRMECnb1Zg4Zw: posts big blind $2
*** HOLE CARDS ***
+HlQuAsMqZGYYtjcPO/a3A: raises $4 to $6
pVqEzK9wXlRMECnb1Zg4Zw: calls $4
*** FLOP *** [Ks 6c 6d]
pVqEzK9wXlRMECnb1Zg4Zw: checks
+HlQuAsMqZGYYtjcPO/a3A: checks
*** TURN *** [Ks 6c 6d] [3h]
pVqEzK9wXlRMECnb1Zg4Zw: bets $6
+HlQuAsMqZGYYtjcPO/a3A: folds
pVqEzK9wXlRMECnb1Zg4Zw collected $11.50 from pot
pVqEzK9wXlRMECnb1Zg4Zw: doesn't show hand
*** SUMMARY ***
Total pot $12 | Rake $0.50
Board [Ks 6c 6d 3h]
Seat 1: +HlQuAsMqZGYYtjcPO/a3A (button) (small blind) folded on the Turn
Seat 2: pVqEzK9wXlRMECnb1Zg4Zw (big blind) collected ($11.50)



PokerStars Game #59940974318:  Hold'em No Limit ($1/$2) - 2009/07/01 1:22:00 ET
Table 'gnHBqWll9O3fxG7Ojkz/ng' 9-max Seat #5 is the button
Seat 1: TAfo4veNRaRlzDXMMYS3Jg ($37 in chips)
Seat 2: H6Z4+qu8gR0VUiPOijndVg ($338.60 in chips)
Seat 3: 5Q8U6iZbeO7xJSS4qvDP5g ($215 in chips)
Seat 5: rBQDMkKm9cZn6M9NPsiVew ($236.45 in chips)
Seat 6: /inIs/z/PcX+TniIFpaxpg ($47.75 in chips)
Seat 7: jqui3xAWCkcdPW36a6BD+w ($342.40 in chips)
Seat 8: cM6efHzdxoqYm0EQKP4TTQ ($103.05 in chips)
Seat 9: sN6yR5I5zFq/WFyIz5UfzQ ($201 in chips)
/inIs/z/PcX+TniIFpaxpg: posts small blind $1
jqui3xAWCkcdPW36a6BD+w: posts big blind $2
*** HOLE CARDS ***
cM6efHzdxoqYm0EQKP4TTQ: calls $2
sN6yR5I5zFq/WFyIz5UfzQ: folds
TAfo4veNRaRlzDXMMYS3Jg: folds
nXDI8Y/S6POzRwANu3d8hQ joins the table at seat #4
H6Z4+qu8gR0VUiPOijndVg: calls $2
5Q8U6iZbeO7xJSS4qvDP5g: folds
rBQDMkKm9cZn6M9NPsiVew: folds
/inIs/z/PcX+TniIFpaxpg: folds
jqui3xAWCkcdPW36a6BD+w: checks
*** FLOP *** [4h 6s Ac]
jqui3xAWCkcdPW36a6BD+w: checks
cM6efHzdxoqYm0EQKP4TTQ: checks
H6Z4+qu8gR0VUiPOijndVg: checks
*** TURN *** [4h 6s Ac] [Td]
jqui3xAWCkcdPW36a6BD+w: checks
cM6efHzdxoqYm0EQKP4TTQ: checks
H6Z4+qu8gR0VUiPOijndVg: checks
*** RIVER *** [4h 6s Ac Td] [6d]
jqui3xAWCkcdPW36a6BD+w: checks
cM6efHzdxoqYm0EQKP4TTQ: checks
H6Z4+qu8gR0VUiPOijndVg: checks
*** SHOW DOWN ***
jqui3xAWCkcdPW36a6BD+w: shows [3h 2s] (a pair of Sixes)
cM6efHzdxoqYm0EQKP4TTQ: shows [9h Jc] (a pair of Sixes - Ace+Jack kicker)
H6Z4+qu8gR0VUiPOijndVg: shows [8h 8c] (two pair, Eights and Sixes)
H6Z4+qu8gR0VUiPOijndVg collected $6.65 from pot
*** SUMMARY ***
Total pot $7 | Rake $0.35
Board [4h 6s Ac Td 6d]
Seat 1: TAfo4veNRaRlzDXMMYS3Jg folded before Flop (didn't bet)
Seat 2: H6Z4+qu8gR0VUiPOijndVg showed [8h 8c] and won ($6.65) with two pair, Eights and Sixes
Seat 3: 5Q8U6iZbeO7xJSS4qvDP5g folded before Flop (didn't bet)
Seat 5: rBQDMkKm9cZn6M9NPsiVew (button) folded before Flop (didn't bet)
Seat 6: /inIs/z/PcX+TniIFpaxpg (small blind) folded before Flop
Seat 7: jqui3xAWCkcdPW36a6BD+w (big blind) showed [3h 2s] and lost with a pair of Sixes
Seat 8: cM6efHzdxoqYm0EQKP4TTQ showed [9h Jc] and lost with a pair of Sixes
Seat 9: sN6yR5I5zFq/WFyIz5UfzQ folded before Flop (didn't bet)



PokerStars Game #59940974314:  Hold'em No Limit ($1/$2) - 2009/07/01 1:22:00 ET
Table 'TsEDkiO4tzCTCzJ7tNdEqw' 6-max Seat #4 is the button
Seat 1: MfXQsYD8pGeCS7XOtyV+vw ($20.90 in chips)
Seat 2: 4dcDwIHRm96PwtqkpQiuiA ($84.10 in chips)
Seat 3: wgRvjVPZSQvqNGiyR1jwSA ($40 in chips)
Seat 4: K8MXCrNAVYlMnnCeM32Kxw ($90.05 in chips)
Seat 5: VvdR9F3I+2yELkfTVvC1dg ($200.50 in chips)
Seat 6: uCqEjnxh2/vFBjKYkfTOkw ($264.25 in chips)
VvdR9F3I+2yELkfTVvC1dg: posts small blind $1
uCqEjnxh2/vFBjKYkfTOkw: posts big blind $2
*** HOLE CARDS ***
MfXQsYD8pGeCS7XOtyV+vw: raises $8 to $10
4dcDwIHRm96PwtqkpQiuiA: folds
wgRvjVPZSQvqNGiyR1jwSA: folds
K8MXCrNAVYlMnnCeM32Kxw: folds
VvdR9F3I+2yELkfTVvC1dg: folds
uCqEjnxh2/vFBjKYkfTOkw: folds
MfXQsYD8pGeCS7XOtyV+vw collected $5 from pot
*** SUMMARY ***
Total pot $5 | Rake $0
Seat 1: MfXQsYD8pGeCS7XOtyV+vw collected ($5)
Seat 2: 4dcDwIHRm96PwtqkpQiuiA folded before Flop (didn't bet)
Seat 3: wgRvjVPZSQvqNGiyR1jwSA folded before Flop (didn't bet)
Seat 4: K8MXCrNAVYlMnnCeM32Kxw (button) folded before Flop (didn't bet)
Seat 5: VvdR9F3I+2yELkfTVvC1dg (small blind) folded before Flop
Seat 6: uCqEjnxh2/vFBjKYkfTOkw (big blind) folded before Flop



PokerStars Game #59940974680:  Hold'em No Limit ($1/$2) - 2009/07/01 1:22:01 ET
Table 'QxerF7GUfCbl+4a8XaTB2w' 6-max Seat #4 is the button
Seat 1: o9jamqIi6sTTRSqudgboRA ($289.50 in chips)
Seat 2: vkfxu8f/jMYKUk6Ly4eujw ($208.05 in chips)
Seat 3: m7mYVfnCOK5TE/VkN/FhOg ($281.10 in chips)
Seat 4: 09BNF4quPDzanQzM8vc6WA ($37.55 in chips)
Seat 5: YsLQ3BAvgQHWXMAv3Wv6Hg ($200 in chips)
Seat 6: VvdR9F3I+2yELkfTVvC1dg ($200 in chips)
YsLQ3BAvgQHWXMAv3Wv6Hg: posts small blind $1
VvdR9F3I+2yELkfTVvC1dg: posts big blind $2
*** HOLE CARDS ***
o9jamqIi6sTTRSqudgboRA: folds
o9jamqIi6sTTRSqudgboRA leaves the table
vkfxu8f/jMYKUk6Ly4eujw: folds
m7mYVfnCOK5TE/VkN/FhOg: folds
09BNF4quPDzanQzM8vc6WA: folds
YsLQ3BAvgQHWXMAv3Wv6Hg: raises $4 to $6
54yWzRRgS0oZ+S6LwZBxMQ joins the table at seat #1
VvdR9F3I+2yELkfTVvC1dg: folds
YsLQ3BAvgQHWXMAv3Wv6Hg collected $4 from pot
YsLQ3BAvgQHWXMAv3Wv6Hg: doesn't show hand
*** SUMMARY ***
Total pot $4 | Rake $0
Seat 1: o9jamqIi6sTTRSqudgboRA folded before Flop (didn't bet)
Seat 2: vkfxu8f/jMYKUk6Ly4eujw folded before Flop (didn't bet)
Seat 3: m7mYVfnCOK5TE/VkN/FhOg folded before Flop (didn't bet)
Seat 4: 09BNF4quPDzanQzM8vc6WA (button) folded before Flop (didn't bet)
Seat 5: YsLQ3BAvgQHWXMAv3Wv6Hg (small blind) collected ($4)
Seat 6: VvdR9F3I+2yELkfTVvC1dg (big blind) folded before Flop



PokerStars Game #59940975292:  Hold'em No Limit ($1/$2) - 2009/07/01 1:22:02 ET
Table 'ztv6V3FN2bQ9nmJPPdx6nQ' 6-max Seat #2 is the button
Seat 1: 6fLdOUCRtX71xbVRhJEq8w ($215 in chips)
Seat 2: 5Y+ZGWLI4gnlpApDX5vy1A ($408.25 in chips)
Seat 3: ubtx4Z5L+AcK71MTvYiGVw ($201 in chips)
Seat 4: UaZ5yj+6LjtWqMQg2QskUw ($115.80 in chips)
Seat 5: sTPOWERd9HWPCNrDBwsVjA ($254 in chips)
Seat 6: mfy7uGZcqA2PVQqEVbJ7+g ($117.45 in chips)
ubtx4Z5L+AcK71MTvYiGVw: posts small blind $1
UaZ5yj+6LjtWqMQg2QskUw: posts big blind $2
*** HOLE CARDS ***
sTPOWERd9HWPCNrDBwsVjA has timed out
sTPOWERd9HWPCNrDBwsVjA: folds
sTPOWERd9HWPCNrDBwsVjA is sitting out
mfy7uGZcqA2PVQqEVbJ7+g: folds
6fLdOUCRtX71xbVRhJEq8w: folds
sTPOWERd9HWPCNrDBwsVjA has returned
5Y+ZGWLI4gnlpApDX5vy1A: folds
ubtx4Z5L+AcK71MTvYiGVw: folds
UaZ5yj+6LjtWqMQg2QskUw collected $2 from pot
*** SUMMARY ***
Total pot $2 | Rake $0
Seat 1: 6fLdOUCRtX71xbVRhJEq8w folded before Flop (didn't bet)
Seat 2: 5Y+ZGWLI4gnlpApDX5vy1A (button) folded before Flop (didn't bet)
Seat 3: ubtx4Z5L+AcK71MTvYiGVw (small blind) folded before Flop
Seat 4: UaZ5yj+6LjtWqMQg2QskUw (big blind) collected ($2)
Seat 5: sTPOWERd9HWPCNrDBwsVjA folded before Flop (didn't bet)
Seat 6: mfy7uGZcqA2PVQqEVbJ7+g folded before Flop (didn't bet)



PokerStars Game #59940977594:  Hold'em No Limit ($1/$2) - 2009/07/01 1:22:06 ET
Table 'W9UeSV0aoPjh5SFSxM8jUQ' 9-max Seat #9 is the button
Seat 1: mIKx5lhIt13X5eZQH0ZeMA ($26 in chips)
Seat 2: iMe5yhc+1BaiIPHet3NMrA ($255.60 in chips)
Seat 3: /inIs/z/PcX+TniIFpaxpg ($25 in chips)
Seat 5: ri8CLkX3e9JF34dQNbsHGA ($42.45 in chips)
Seat 6: j47DM+lqTfzZP8musviQTg ($110.90 in chips)
Seat 7: I2ipWauytvrkEer4XD3Sjg ($106 in chips)
Seat 8: odhvI/CZeMsPyo1n1U7+hA ($49.70 in chips)
Seat 9: Q104K4iDGcqOlVrjAkzPEA ($89.85 in chips)
mIKx5lhIt13X5eZQH0ZeMA: posts small blind $1
iMe5yhc+1BaiIPHet3NMrA: posts big blind $2
4YA/sQy1Emm680zhbPUjow: sits out
*** HOLE CARDS ***
/inIs/z/PcX+TniIFpaxpg: folds
ri8CLkX3e9JF34dQNbsHGA: folds
j47DM+lqTfzZP8musviQTg: folds
I2ipWauytvrkEer4XD3Sjg: raises $4 to $6
odhvI/CZeMsPyo1n1U7+hA: folds
Q104K4iDGcqOlVrjAkzPEA: calls $6
mIKx5lhIt13X5eZQH0ZeMA: folds
iMe5yhc+1BaiIPHet3NMrA: folds
*** FLOP *** [5c 2d Ks]
I2ipWauytvrkEer4XD3Sjg: checks
Q104K4iDGcqOlVrjAkzPEA: checks
*** TURN *** [5c 2d Ks] [4d]
I2ipWauytvrkEer4XD3Sjg: checks
Q104K4iDGcqOlVrjAkzPEA: checks
*** RIVER *** [5c 2d Ks 4d] [Jh]
I2ipWauytvrkEer4XD3Sjg: checks
Q104K4iDGcqOlVrjAkzPEA: checks
*** SHOW DOWN ***
I2ipWauytvrkEer4XD3Sjg: shows [Ad 6c] (high card Ace)
Q104K4iDGcqOlVrjAkzPEA: shows [As Qd] (high card Ace - King+Queen kicker)
Q104K4iDGcqOlVrjAkzPEA collected $14.25 from pot
*** SUMMARY ***
Total pot $15 | Rake $0.75
Board [5c 2d Ks 4d Jh]
Seat 1: mIKx5lhIt13X5eZQH0ZeMA (small blind) folded before Flop
Seat 2: iMe5yhc+1BaiIPHet3NMrA (big blind) folded before Flop
Seat 3: /inIs/z/PcX+TniIFpaxpg folded before Flop (didn't bet)
Seat 5: ri8CLkX3e9JF34dQNbsHGA folded before Flop (didn't bet)
Seat 6: j47DM+lqTfzZP8musviQTg folded before Flop (didn't bet)
Seat 7: I2ipWauytvrkEer4XD3Sjg showed [Ad 6c] and lost with high card Ace
Seat 8: odhvI/CZeMsPyo1n1U7+hA folded before Flop (didn't bet)
Seat 9: Q104K4iDGcqOlVrjAkzPEA (button) showed [As Qd] and won ($14.25) with high card Ace



PokerStars Game #59940978888:  Hold'em No Limit ($1/$2) - 2009/07/01 1:22:09 ET
Table 'YqGfR5eHfMeSjb9a+QU9rg' 9-max Seat #8 is the button
Seat 1: rW/MyplHylMSBRaoRUzWrg ($37 in chips)
Seat 2: W3Nqt1GWlTi9tXQXMNEvgw ($380.70 in chips)
Seat 3: /gll27k+xWYV7Fbki0lFDQ ($270.75 in chips)
Seat 4: QHxJjpVYwitg9krW6wZgJA ($217.30 in chips)
Seat 5: CkE3IyJF1KvdaAOmZY5XqQ ($200 in chips)
Seat 6: TAfo4veNRaRlzDXMMYS3Jg ($37 in chips)
Seat 7: 41aZuLBz9nAi2GPVKabmCw ($96.50 in chips)
Seat 8: JnV3SM2D6dAFYyGZHHpvrg ($101.25 in chips)
Seat 9: /inIs/z/PcX+TniIFpaxpg ($204.05 in chips)
/inIs/z/PcX+TniIFpaxpg: posts small blind $1
rW/MyplHylMSBRaoRUzWrg: posts big blind $2
*** HOLE CARDS ***
W3Nqt1GWlTi9tXQXMNEvgw: folds
/gll27k+xWYV7Fbki0lFDQ: folds
QHxJjpVYwitg9krW6wZgJA: folds
CkE3IyJF1KvdaAOmZY5XqQ: folds
TAfo4veNRaRlzDXMMYS3Jg: folds
41aZuLBz9nAi2GPVKabmCw: folds
JnV3SM2D6dAFYyGZHHpvrg: folds
/inIs/z/PcX+TniIFpaxpg: raises $4 to $6
rW/MyplHylMSBRaoRUzWrg: folds
/inIs/z/PcX+TniIFpaxpg collected $4 from pot
/inIs/z/PcX+TniIFpaxpg: doesn't show hand
*** SUMMARY ***
Total pot $4 | Rake $0
Seat 1: rW/MyplHylMSBRaoRUzWrg (big blind) folded before Flop
Seat 2: W3Nqt1GWlTi9tXQXMNEvgw folded before Flop (didn't bet)
Seat 3: /gll27k+xWYV7Fbki0lFDQ folded before Flop (didn't bet)
Seat 4: QHxJjpVYwitg9krW6wZgJA folded before Flop (didn't bet)
Seat 5: CkE3IyJF1KvdaAOmZY5XqQ folded before Flop (didn't bet)
Seat 6: TAfo4veNRaRlzDXMMYS3Jg folded before Flop (didn't bet)
Seat 7: 41aZuLBz9nAi2GPVKabmCw folded before Flop (didn't bet)
Seat 8: JnV3SM2D6dAFYyGZHHpvrg (button) folded before Flop (didn't bet)
Seat 9: /inIs/z/PcX+TniIFpaxpg (small blind) collected ($4)



PokerStars Game #59940982394:  Hold'em No Limit ($1/$2) - 2009/07/01 1:22:15 ET
Table 'C4lkCXY2PWy6z4vsAe5NGQ' 6-max Seat #3 is the button
Seat 1: 4bqvCfJ0e8CTYnn0Go9hbQ ($64.60 in chips)
Seat 2: 6hRJ68JkbJq6MYI9o5bUnQ ($38.40 in chips)
Seat 3: sTPOWERd9HWPCNrDBwsVjA ($141.80 in chips)
Seat 4: VvdR9F3I+2yELkfTVvC1dg ($230.55 in chips)
Seat 5: dKvrkfQx2Peke3ikZLUy1w ($57.20 in chips)
Seat 6: B87ikIyZ/TzAVeXf38Ny0g ($660.75 in chips)
VvdR9F3I+2yELkfTVvC1dg: posts small blind $1
dKvrkfQx2Peke3ikZLUy1w: posts big blind $2
*** HOLE CARDS ***
B87ikIyZ/TzAVeXf38Ny0g: folds
4bqvCfJ0e8CTYnn0Go9hbQ: folds
6hRJ68JkbJq6MYI9o5bUnQ: folds
sTPOWERd9HWPCNrDBwsVjA: folds
VvdR9F3I+2yELkfTVvC1dg: raises $2 to $4
dKvrkfQx2Peke3ikZLUy1w said, "****in dikhead"
dKvrkfQx2Peke3ikZLUy1w: calls $2
*** FLOP *** [3h 9s 8s]
VvdR9F3I+2yELkfTVvC1dg: bets $5.70
dKvrkfQx2Peke3ikZLUy1w: folds
VvdR9F3I+2yELkfTVvC1dg collected $7.60 from pot
VvdR9F3I+2yELkfTVvC1dg: doesn't show hand
*** SUMMARY ***
Total pot $8 | Rake $0.40
Board [3h 9s 8s]
Seat 1: 4bqvCfJ0e8CTYnn0Go9hbQ folded before Flop (didn't bet)
Seat 2: 6hRJ68JkbJq6MYI9o5bUnQ folded before Flop (didn't bet)
Seat 3: sTPOWERd9HWPCNrDBwsVjA (button) folded before Flop (didn't bet)
Seat 4: VvdR9F3I+2yELkfTVvC1dg (small blind) collected ($7.60)
Seat 5: dKvrkfQx2Peke3ikZLUy1w (big blind) folded on the Flop
Seat 6: B87ikIyZ/TzAVeXf38Ny0g folded before Flop (didn't bet)



PokerStars Game #59940983574:  Hold'em No Limit ($1/$2) - 2009/07/01 1:22:17 ET
Table 'bJQ024BaYSBrW0sXpCZbNQ' 6-max Seat #3 is the button
Seat 1: PCN5rt4TwI1pQE+rAiqI0Q ($323.60 in chips)
Seat 2: 3dAbvkxS5NPQTBAbvpinVg ($200 in chips)
Seat 3: vkfxu8f/jMYKUk6Ly4eujw ($233.05 in chips)
Seat 5: VvdR9F3I+2yELkfTVvC1dg ($203 in chips)
Seat 6: 9dpyyjDTCed6nV7JhaUUpw ($333.95 in chips)
VvdR9F3I+2yELkfTVvC1dg: posts small blind $1
9dpyyjDTCed6nV7JhaUUpw: posts big blind $2
*** HOLE CARDS ***
TBaQIN+sQ7eb7P99QnaORQ said, "omfg a5"
TBaQIN+sQ7eb7P99QnaORQ said, "****"
3dAbvkxS5NPQTBAbvpinVg said, "nh"
PCN5rt4TwI1pQE+rAiqI0Q has timed out
PCN5rt4TwI1pQE+rAiqI0Q: folds
PCN5rt4TwI1pQE+rAiqI0Q is sitting out
3dAbvkxS5NPQTBAbvpinVg: raises $4 to $6
vkfxu8f/jMYKUk6Ly4eujw: folds
PCN5rt4TwI1pQE+rAiqI0Q has returned
TBaQIN+sQ7eb7P99QnaORQ has returned
VvdR9F3I+2yELkfTVvC1dg: folds
9dpyyjDTCed6nV7JhaUUpw: folds
3dAbvkxS5NPQTBAbvpinVg collected $5 from pot
3dAbvkxS5NPQTBAbvpinVg: doesn't show hand
*** SUMMARY ***
Total pot $5 | Rake $0
Seat 1: PCN5rt4TwI1pQE+rAiqI0Q folded before Flop (didn't bet)
Seat 2: 3dAbvkxS5NPQTBAbvpinVg collected ($5)
Seat 3: vkfxu8f/jMYKUk6Ly4eujw (button) folded before Flop (didn't bet)
Seat 5: VvdR9F3I+2yELkfTVvC1dg (small blind) folded before Flop
Seat 6: 9dpyyjDTCed6nV7JhaUUpw (big blind) folded before Flop



PokerStars Game #59940985012:  Hold'em No Limit ($1/$2) - 2009/07/01 1:22:20 ET
Table 'NmY84NAf9Mh0ckAckHnh5g' 2-max Seat #2 is the button
Seat 1: 6hvg964TSqZ3AL/0XK9aVQ ($323.10 in chips)
Seat 2: RwDoM55ZeQuI2ADyJhOb2Q ($683.90 in chips)
RwDoM55ZeQuI2ADyJhOb2Q: posts small blind $1
6hvg964TSqZ3AL/0XK9aVQ: posts big blind $2
*** HOLE CARDS ***
RwDoM55ZeQuI2ADyJhOb2Q: raises $4 to $6
6hvg964TSqZ3AL/0XK9aVQ: calls $4
*** FLOP *** [Jh 3d 5s]
6hvg964TSqZ3AL/0XK9aVQ: checks
RwDoM55ZeQuI2ADyJhOb2Q: bets $10
6hvg964TSqZ3AL/0XK9aVQ: calls $10
*** TURN *** [Jh 3d 5s] [8h]
6hvg964TSqZ3AL/0XK9aVQ: checks
RwDoM55ZeQuI2ADyJhOb2Q: bets $22
6hvg964TSqZ3AL/0XK9aVQ: calls $22
*** RIVER *** [Jh 3d 5s 8h] [7h]
6hvg964TSqZ3AL/0XK9aVQ: checks
RwDoM55ZeQuI2ADyJhOb2Q: bets $132
6hvg964TSqZ3AL/0XK9aVQ: calls $132
*** SHOW DOWN ***
RwDoM55ZeQuI2ADyJhOb2Q: shows [3h 3c] (three of a kind, Threes)
6hvg964TSqZ3AL/0XK9aVQ: mucks hand
RwDoM55ZeQuI2ADyJhOb2Q collected $339.50 from pot
*** SUMMARY ***
Total pot $340 | Rake $0.50
Board [Jh 3d 5s 8h 7h]
Seat 1: 6hvg964TSqZ3AL/0XK9aVQ (big blind) mucked
Seat 2: RwDoM55ZeQuI2ADyJhOb2Q (button) (small blind) showed [3h 3c] and won ($339.50) with three of a kind, Threes



PokerStars Game #59940985666:  Hold'em No Limit ($1/$2) - 2009/07/01 1:22:21 ET
Table '8Y6PEyoNuepZTai2Q56aHw' 9-max Seat #8 is the button
Seat 1: 5Q8U6iZbeO7xJSS4qvDP5g ($282 in chips)
Seat 2: gDCJIAlovbPnTvMM7Dd1gA ($176.35 in chips)
Seat 3: WUlHm+ydPPHG7Lb0rePSdA ($128.30 in chips)
Seat 4: xKkwALG38OfLQ9DXuJgR1w ($284.55 in chips)
Seat 6: NtLDBSjsJQEKekh5cdinvw ($361.20 in chips)
Seat 7: Kzta8yu9vxHT4B70mjBZ+w ($200 in chips)
Seat 8: rW/MyplHylMSBRaoRUzWrg ($37 in chips)
Seat 9: F7m34OOfAQ7annesMHVjKw ($89.80 in chips)
F7m34OOfAQ7annesMHVjKw: posts small blind $1
5Q8U6iZbeO7xJSS4qvDP5g: posts big blind $2
*** HOLE CARDS ***
gDCJIAlovbPnTvMM7Dd1gA: folds
WUlHm+ydPPHG7Lb0rePSdA: folds
xKkwALG38OfLQ9DXuJgR1w: folds
NtLDBSjsJQEKekh5cdinvw: folds
Kzta8yu9vxHT4B70mjBZ+w: raises $4 to $6
rW/MyplHylMSBRaoRUzWrg: folds
F7m34OOfAQ7annesMHVjKw: calls $5
5Q8U6iZbeO7xJSS4qvDP5g: folds
*** FLOP *** [5h Jh 3d]
F7m34OOfAQ7annesMHVjKw: checks
Kzta8yu9vxHT4B70mjBZ+w: bets $8
F7m34OOfAQ7annesMHVjKw: folds
Kzta8yu9vxHT4B70mjBZ+w collected $13.30 from pot
Kzta8yu9vxHT4B70mjBZ+w: doesn't show hand
*** SUMMARY ***
Total pot $14 | Rake $0.70
Board [5h Jh 3d]
Seat 1: 5Q8U6iZbeO7xJSS4qvDP5g (big blind) folded before Flop
Seat 2: gDCJIAlovbPnTvMM7Dd1gA folded before Flop (didn't bet)
Seat 3: WUlHm+ydPPHG7Lb0rePSdA folded before Flop (didn't bet)
Seat 4: xKkwALG38OfLQ9DXuJgR1w folded before Flop (didn't bet)
Seat 6: NtLDBSjsJQEKekh5cdinvw folded before Flop (didn't bet)
Seat 7: Kzta8yu9vxHT4B70mjBZ+w collected ($13.30)
Seat 8: rW/MyplHylMSBRaoRUzWrg (button) folded before Flop (didn't bet)
Seat 9: F7m34OOfAQ7annesMHVjKw (small blind) folded on the Flop



PokerStars Game #59940985626:  Hold'em No Limit ($1/$2) - 2009/07/01 1:22:21 ET
Table 'CFkQcfWjKccZaZDf71FK+w' 6-max Seat #1 is the button
Seat 1: JsC+WvfzqlxVs9G8/gSQAQ ($20.05 in chips)
Seat 2: ewN/vzF22+/gdzjIKBOlkA ($233.20 in chips)
Seat 3: 09BNF4quPDzanQzM8vc6WA ($27 in chips)
Seat 4: ygTTt5ehT4aF86q1a8/R+w ($185.55 in chips)
Seat 5: 2lOU1DcvUZaMcxZ95XfzXw ($100 in chips)
Seat 6: ORVqY3rf9X6ANA/8s+On2Q ($112.50 in chips)
ewN/vzF22+/gdzjIKBOlkA: posts small blind $1
09BNF4quPDzanQzM8vc6WA: posts big blind $2
*** HOLE CARDS ***
ygTTt5ehT4aF86q1a8/R+w: folds
2lOU1DcvUZaMcxZ95XfzXw: folds
ORVqY3rf9X6ANA/8s+On2Q: calls $2
JsC+WvfzqlxVs9G8/gSQAQ: raises $18.05 to $20.05 and is all-in
ewN/vzF22+/gdzjIKBOlkA: folds
09BNF4quPDzanQzM8vc6WA: folds
ORVqY3rf9X6ANA/8s+On2Q: folds
JsC+WvfzqlxVs9G8/gSQAQ collected $7 from pot
*** SUMMARY ***
Total pot $7 | Rake $0
Seat 1: JsC+WvfzqlxVs9G8/gSQAQ (button) collected ($7)
Seat 2: ewN/vzF22+/gdzjIKBOlkA (small blind) folded before Flop
Seat 3: 09BNF4quPDzanQzM8vc6WA (big blind) folded before Flop
Seat 4: ygTTt5ehT4aF86q1a8/R+w folded before Flop (didn't bet)
Seat 5: 2lOU1DcvUZaMcxZ95XfzXw folded before Flop (didn't bet)
Seat 6: ORVqY3rf9X6ANA/8s+On2Q folded before Flop



PokerStars Game #59940987158:  Hold'em No Limit ($1/$2) - 2009/07/01 1:22:24 ET
Table 'QxerF7GUfCbl+4a8XaTB2w' 6-max Seat #5 is the button
Seat 1: 54yWzRRgS0oZ+S6LwZBxMQ ($40 in chips)
Seat 2: vkfxu8f/jMYKUk6Ly4eujw ($208.05 in chips)
Seat 3: m7mYVfnCOK5TE/VkN/FhOg ($281.10 in chips)
Seat 4: 09BNF4quPDzanQzM8vc6WA ($37.55 in chips)
Seat 5: YsLQ3BAvgQHWXMAv3Wv6Hg ($202 in chips)
Seat 6: VvdR9F3I+2yELkfTVvC1dg ($200 in chips)
VvdR9F3I+2yELkfTVvC1dg: posts small blind $1
54yWzRRgS0oZ+S6LwZBxMQ: posts big blind $2
*** HOLE CARDS ***
vkfxu8f/jMYKUk6Ly4eujw: folds
vkfxu8f/jMYKUk6Ly4eujw leaves the table
m7mYVfnCOK5TE/VkN/FhOg: folds
HiWSAXs6/0w9Jy7ioiiShQ joins the table at seat #2
09BNF4quPDzanQzM8vc6WA: folds
YsLQ3BAvgQHWXMAv3Wv6Hg: folds
VvdR9F3I+2yELkfTVvC1dg: raises $2 to $4
54yWzRRgS0oZ+S6LwZBxMQ: folds
VvdR9F3I+2yELkfTVvC1dg collected $4 from pot
VvdR9F3I+2yELkfTVvC1dg: doesn't show hand
*** SUMMARY ***
Total pot $4 | Rake $0
Seat 1: 54yWzRRgS0oZ+S6LwZBxMQ (big blind) folded before Flop
Seat 2: vkfxu8f/jMYKUk6Ly4eujw folded before Flop (didn't bet)
Seat 3: m7mYVfnCOK5TE/VkN/FhOg folded before Flop (didn't bet)
Seat 4: 09BNF4quPDzanQzM8vc6WA folded before Flop (didn't bet)
Seat 5: YsLQ3BAvgQHWXMAv3Wv6Hg (button) folded before Flop (didn't bet)
Seat 6: VvdR9F3I+2yELkfTVvC1dg (small blind) collected ($4)



PokerStars Game #59940987530:  Hold'em No Limit ($1/$2) - 2009/07/01 1:22:25 ET
Table 'uJ9juaXXg9yIcSU8amxaXQ' 6-max Seat #4 is the button
Seat 1: JsqOjN/eHz0uYVf/PyUJ6Q ($149.85 in chips)
Seat 2: VvdR9F3I+2yELkfTVvC1dg ($200 in chips)
Seat 3: qXDd0ZyMIse0OBu8pxeQ3Q ($256 in chips)
Seat 4: zNjJ/y4emmF+vzrCDd+ooA ($214.05 in chips)
Seat 5: YsLQ3BAvgQHWXMAv3Wv6Hg ($200 in chips)
Seat 6: 2DFp9Veq1xxq64dCjwNuUw ($55.60 in chips)
YsLQ3BAvgQHWXMAv3Wv6Hg: posts small blind $1
2DFp9Veq1xxq64dCjwNuUw: posts big blind $2
*** HOLE CARDS ***
JsqOjN/eHz0uYVf/PyUJ6Q: folds
VvdR9F3I+2yELkfTVvC1dg: folds
qXDd0ZyMIse0OBu8pxeQ3Q: folds
zNjJ/y4emmF+vzrCDd+ooA: folds
YsLQ3BAvgQHWXMAv3Wv6Hg: raises $4 to $6
2DFp9Veq1xxq64dCjwNuUw: folds
YsLQ3BAvgQHWXMAv3Wv6Hg collected $4 from pot
YsLQ3BAvgQHWXMAv3Wv6Hg: doesn't show hand
*** SUMMARY ***
Total pot $4 | Rake $0
Seat 1: JsqOjN/eHz0uYVf/PyUJ6Q folded before Flop (didn't bet)
Seat 2: VvdR9F3I+2yELkfTVvC1dg folded before Flop (didn't bet)
Seat 3: qXDd0ZyMIse0OBu8pxeQ3Q folded before Flop (didn't bet)
Seat 4: zNjJ/y4emmF+vzrCDd+ooA (button) folded before Flop (didn't bet)
Seat 5: YsLQ3BAvgQHWXMAv3Wv6Hg (small blind) collected ($4)
Seat 6: 2DFp9Veq1xxq64dCjwNuUw (big blind) folded before Flop



PokerStars Game #59940987652:  Hold'em No Limit ($1/$2) - 2009/07/01 1:22:25 ET
Table '4NGNnZ/osQfNq6abYqkJeA' 6-max Seat #3 is the button
Seat 1: 7zM38baFvmCNB/F80oE0cQ ($56.30 in chips)
Seat 2: 669iGNwYwgRZg3nhS+aDAQ ($93.15 in chips)
Seat 3: 54yWzRRgS0oZ+S6LwZBxMQ ($27.75 in chips)
Seat 4: sY+4Uuh5z/6AbXXaCS10jw ($208.35 in chips)
Seat 5: VvdR9F3I+2yELkfTVvC1dg ($237.80 in chips)
Seat 6: kkgpegLoQkmL6LIsFsvtiQ ($263.05 in chips)
sY+4Uuh5z/6AbXXaCS10jw: posts small blind $1
VvdR9F3I+2yELkfTVvC1dg: posts big blind $2
*** HOLE CARDS ***
kkgpegLoQkmL6LIsFsvtiQ: folds
7zM38baFvmCNB/F80oE0cQ: folds
669iGNwYwgRZg3nhS+aDAQ: folds
54yWzRRgS0oZ+S6LwZBxMQ: raises $2 to $4
sY+4Uuh5z/6AbXXaCS10jw: raises $8 to $12
VvdR9F3I+2yELkfTVvC1dg: folds
54yWzRRgS0oZ+S6LwZBxMQ: folds
sY+4Uuh5z/6AbXXaCS10jw collected $10 from pot
*** SUMMARY ***
Total pot $10 | Rake $0
Seat 1: 7zM38baFvmCNB/F80oE0cQ folded before Flop (didn't bet)
Seat 2: 669iGNwYwgRZg3nhS+aDAQ folded before Flop (didn't bet)
Seat 3: 54yWzRRgS0oZ+S6LwZBxMQ (button) folded before Flop
Seat 4: sY+4Uuh5z/6AbXXaCS10jw (small blind) collected ($10)
Seat 5: VvdR9F3I+2yELkfTVvC1dg (big blind) folded before Flop
Seat 6: kkgpegLoQkmL6LIsFsvtiQ folded before Flop (didn't bet)



PokerStars Game #59940987470:  Hold'em No Limit ($1/$2) - 2009/07/01 1:22:25 ET
Table 'bIihwBANJSFqlHPPtset+w' 9-max Seat #1 is the button
Seat 1: /inIs/z/PcX+TniIFpaxpg ($30 in chips)
Seat 2: lQYT23h5QCUVZAKxjOO39Q ($182.75 in chips)
Seat 3: +T/63sAeZzWyHchahJ36GQ ($40 in chips)
Seat 4: ri8CLkX3e9JF34dQNbsHGA ($42.40 in chips)
Seat 5: vxbbJLsS1bva6tW2NiFssg ($200 in chips)
Seat 6: CkE3IyJF1KvdaAOmZY5XqQ ($186 in chips)
Seat 7: pCmk6FpSOLJ+85o1tLHIag ($130.45 in chips)
Seat 8: iMe5yhc+1BaiIPHet3NMrA ($200.50 in chips)
Seat 9: qn8LDoUFphcG4+r+F+Vhrg ($184 in chips)
lQYT23h5QCUVZAKxjOO39Q: posts small blind $1
+T/63sAeZzWyHchahJ36GQ: posts big blind $2
*** HOLE CARDS ***
ri8CLkX3e9JF34dQNbsHGA: folds
vxbbJLsS1bva6tW2NiFssg: folds
CkE3IyJF1KvdaAOmZY5XqQ: folds
pCmk6FpSOLJ+85o1tLHIag: folds
iMe5yhc+1BaiIPHet3NMrA: folds
qn8LDoUFphcG4+r+F+Vhrg: calls $2
/inIs/z/PcX+TniIFpaxpg: folds
lQYT23h5QCUVZAKxjOO39Q: calls $1
+T/63sAeZzWyHchahJ36GQ: raises $8 to $10
qn8LDoUFphcG4+r+F+Vhrg: folds
lQYT23h5QCUVZAKxjOO39Q: folds
+T/63sAeZzWyHchahJ36GQ collected $6 from pot
*** SUMMARY ***
Total pot $6 | Rake $0
Seat 1: /inIs/z/PcX+TniIFpaxpg (button) folded before Flop (didn't bet)
Seat 2: lQYT23h5QCUVZAKxjOO39Q (small blind) folded before Flop
Seat 3: +T/63sAeZzWyHchahJ36GQ (big blind) collected ($6)
Seat 4: ri8CLkX3e9JF34dQNbsHGA folded before Flop (didn't bet)
Seat 5: vxbbJLsS1bva6tW2NiFssg folded before Flop (didn't bet)
Seat 6: CkE3IyJF1KvdaAOmZY5XqQ folded before Flop (didn't bet)
Seat 7: pCmk6FpSOLJ+85o1tLHIag folded before Flop (didn't bet)
Seat 8: iMe5yhc+1BaiIPHet3NMrA folded before Flop (didn't bet)
Seat 9: qn8LDoUFphcG4+r+F+Vhrg folded before Flop



PokerStars Game #59940987378:  Hold'em No Limit ($1/$2) - 2009/07/01 1:22:25 ET
Table 'gftD4mDF7mIFKvSrIyaRbw' 9-max Seat #9 is the button
Seat 1: 31HuO+DQxppUQEedBWukug ($100 in chips)
Seat 2: GX1heJ+DSsvm7gzSPsYhhQ ($37 in chips)
Seat 3: CUZwDpLTQKhzarPe+JCLOQ ($200.10 in chips)
Seat 5: mpsfNtnMVDqQHTe92AhIdw ($90.50 in chips)
Seat 6: 2NvwF8W2nzsbS+G//yLAbQ ($208.05 in chips)
Seat 8: MpL4DeEqGQu0H8TJEbEOrg ($44 in chips)
Seat 9: F7m34OOfAQ7annesMHVjKw ($156.10 in chips)
31HuO+DQxppUQEedBWukug: posts small blind $1
GX1heJ+DSsvm7gzSPsYhhQ: posts big blind $2
/inIs/z/PcX+TniIFpaxpg: sits out
+T/63sAeZzWyHchahJ36GQ: sits out
*** HOLE CARDS ***
CUZwDpLTQKhzarPe+JCLOQ: folds
mpsfNtnMVDqQHTe92AhIdw: folds
2NvwF8W2nzsbS+G//yLAbQ: calls $2
MpL4DeEqGQu0H8TJEbEOrg: folds
F7m34OOfAQ7annesMHVjKw: calls $2
31HuO+DQxppUQEedBWukug: calls $1
GX1heJ+DSsvm7gzSPsYhhQ: checks
*** FLOP *** [Jd 5d Ad]
31HuO+DQxppUQEedBWukug: checks
GX1heJ+DSsvm7gzSPsYhhQ: checks
2NvwF8W2nzsbS+G//yLAbQ: checks
F7m34OOfAQ7annesMHVjKw: bets $4
31HuO+DQxppUQEedBWukug: folds
GX1heJ+DSsvm7gzSPsYhhQ: folds
2NvwF8W2nzsbS+G//yLAbQ: calls $4
*** TURN *** [Jd 5d Ad] [9d]
2NvwF8W2nzsbS+G//yLAbQ: bets $6
F7m34OOfAQ7annesMHVjKw: calls $6
*** RIVER *** [Jd 5d Ad 9d] [4d]
2NvwF8W2nzsbS+G//yLAbQ: checks
F7m34OOfAQ7annesMHVjKw: bets $8
2NvwF8W2nzsbS+G//yLAbQ: folds
F7m34OOfAQ7annesMHVjKw collected $26.65 from pot
*** SUMMARY ***
Total pot $28 | Rake $1.35
Board [Jd 5d Ad 9d 4d]
Seat 1: 31HuO+DQxppUQEedBWukug (small blind) folded on the Flop
Seat 2: GX1heJ+DSsvm7gzSPsYhhQ (big blind) folded on the Flop
Seat 3: CUZwDpLTQKhzarPe+JCLOQ folded before Flop (didn't bet)
Seat 5: mpsfNtnMVDqQHTe92AhIdw folded before Flop (didn't bet)
Seat 6: 2NvwF8W2nzsbS+G//yLAbQ folded on the River
Seat 8: MpL4DeEqGQu0H8TJEbEOrg folded before Flop (didn't bet)
Seat 9: F7m34OOfAQ7annesMHVjKw (button) collected ($26.65)



PokerStars Game #59940988954:  Hold'em No Limit ($1/$2) - 2009/07/01 1:22:27 ET
Table 'AtOXMvcrtQM8yLNcALmfLQ' 2-max Seat #2 is the button
Seat 1: +HlQuAsMqZGYYtjcPO/a3A ($119.90 in chips)
Seat 2: pVqEzK9wXlRMECnb1Zg4Zw ($276.80 in chips)
pVqEzK9wXlRMECnb1Zg4Zw: posts small blind $1
+HlQuAsMqZGYYtjcPO/a3A: posts big blind $2
*** HOLE CARDS ***
pVqEzK9wXlRMECnb1Zg4Zw: raises $6 to $8
+HlQuAsMqZGYYtjcPO/a3A: folds
pVqEzK9wXlRMECnb1Zg4Zw collected $4 from pot
pVqEzK9wXlRMECnb1Zg4Zw: doesn't show hand
*** SUMMARY ***
Total pot $4 | Rake $0
Seat 1: +HlQuAsMqZGYYtjcPO/a3A (big blind) folded before Flop
Seat 2: pVqEzK9wXlRMECnb1Zg4Zw (button) (small blind) collected ($4)



PokerStars Game #59940988820:  Hold'em No Limit ($1/$2) - 2009/07/01 1:22:27 ET
Table 'kq5zaQ+1hLNf8LZfGnbTAA' 6-max Seat #5 is the button
Seat 1: 8srN1dKQePlsv0GyTada+Q ($245.20 in chips)
Seat 2: nXDI8Y/S6POzRwANu3d8hQ ($41.75 in chips)
Seat 3: vkfxu8f/jMYKUk6Ly4eujw ($227.95 in chips)
Seat 4: 3dAbvkxS5NPQTBAbvpinVg ($200 in chips)
Seat 5: kfASJqTbXek+zc8ZKsZL1Q ($153.75 in chips)
Seat 6: mfy7uGZcqA2PVQqEVbJ7+g ($197.25 in chips)
mfy7uGZcqA2PVQqEVbJ7+g: posts small blind $1
8srN1dKQePlsv0GyTada+Q: posts big blind $2
*** HOLE CARDS ***
nXDI8Y/S6POzRwANu3d8hQ: raises $4 to $6
vkfxu8f/jMYKUk6Ly4eujw: folds
3dAbvkxS5NPQTBAbvpinVg: folds
kfASJqTbXek+zc8ZKsZL1Q: calls $6
mfy7uGZcqA2PVQqEVbJ7+g: calls $5
8srN1dKQePlsv0GyTada+Q: folds
*** FLOP *** [3c 2h 3d]
mfy7uGZcqA2PVQqEVbJ7+g: checks
nXDI8Y/S6POzRwANu3d8hQ: bets $10
kfASJqTbXek+zc8ZKsZL1Q: calls $10
mfy7uGZcqA2PVQqEVbJ7+g: folds
*** TURN *** [3c 2h 3d] [Qh]
nXDI8Y/S6POzRwANu3d8hQ: checks
kfASJqTbXek+zc8ZKsZL1Q: checks
*** RIVER *** [3c 2h 3d Qh] [As]
nXDI8Y/S6POzRwANu3d8hQ: bets $14
kfASJqTbXek+zc8ZKsZL1Q: folds
nXDI8Y/S6POzRwANu3d8hQ collected $38.05 from pot
nXDI8Y/S6POzRwANu3d8hQ: doesn't show hand
*** SUMMARY ***
Total pot $40 | Rake $1.95
Board [3c 2h 3d Qh As]
Seat 1: 8srN1dKQePlsv0GyTada+Q (big blind) folded before Flop
Seat 2: nXDI8Y/S6POzRwANu3d8hQ collected ($38.05)
Seat 3: vkfxu8f/jMYKUk6Ly4eujw folded before Flop (didn't bet)
Seat 4: 3dAbvkxS5NPQTBAbvpinVg folded before Flop (didn't bet)
Seat 5: kfASJqTbXek+zc8ZKsZL1Q (button) folded on the River
Seat 6: mfy7uGZcqA2PVQqEVbJ7+g (small blind) folded on the Flop



PokerStars Game #59940989768:  Hold'em No Limit ($1/$2) - 2009/07/01 1:22:28 ET
Table 'ztv6V3FN2bQ9nmJPPdx6nQ' 6-max Seat #3 is the button
Seat 1: 6fLdOUCRtX71xbVRhJEq8w ($215 in chips)
Seat 2: 5Y+ZGWLI4gnlpApDX5vy1A ($408.25 in chips)
Seat 3: ubtx4Z5L+AcK71MTvYiGVw ($200 in chips)
Seat 4: UaZ5yj+6LjtWqMQg2QskUw ($116.80 in chips)
Seat 5: sTPOWERd9HWPCNrDBwsVjA ($254 in chips)
Seat 6: mfy7uGZcqA2PVQqEVbJ7+g ($117.45 in chips)
UaZ5yj+6LjtWqMQg2QskUw: posts small blind $1
sTPOWERd9HWPCNrDBwsVjA: posts big blind $2
*** HOLE CARDS ***
mfy7uGZcqA2PVQqEVbJ7+g: folds
6fLdOUCRtX71xbVRhJEq8w: folds
5Y+ZGWLI4gnlpApDX5vy1A: folds
ubtx4Z5L+AcK71MTvYiGVw: raises $4 to $6
UaZ5yj+6LjtWqMQg2QskUw: folds
sTPOWERd9HWPCNrDBwsVjA: folds
ubtx4Z5L+AcK71MTvYiGVw collected $5 from pot
ubtx4Z5L+AcK71MTvYiGVw: doesn't show hand
*** SUMMARY ***
Total pot $5 | Rake $0
Seat 1: 6fLdOUCRtX71xbVRhJEq8w folded before Flop (didn't bet)
Seat 2: 5Y+ZGWLI4gnlpApDX5vy1A folded before Flop (didn't bet)
Seat 3: ubtx4Z5L+AcK71MTvYiGVw (button) collected ($5)
Seat 4: UaZ5yj+6LjtWqMQg2QskUw (small blind) folded before Flop
Seat 5: sTPOWERd9HWPCNrDBwsVjA (big blind) folded before Flop
Seat 6: mfy7uGZcqA2PVQqEVbJ7+g folded before Flop (didn't bet)



PokerStars Game #59940989536:  Hold'em No Limit ($1/$2) - 2009/07/01 1:22:28 ET
Table 'eyAQSIlgc2o1Jxvbve4WGg' 9-max Seat #8 is the button
Seat 1: UZEsV9yKUMqmpYPiOFpaZw ($101.50 in chips)
Seat 2: g7gL2NLJCdZPPV399WKT1w ($64.65 in chips)
Seat 3: ice1Sbe19zWIaKYoSmE5tw ($99.30 in chips)
Seat 4: CkE3IyJF1KvdaAOmZY5XqQ ($200 in chips)
Seat 5: mIKx5lhIt13X5eZQH0ZeMA ($77.10 in chips)
Seat 8: 1CtiZuXDFaJL1dJPQKyi8Q ($172.35 in chips)
Seat 9: WUlHm+ydPPHG7Lb0rePSdA ($121.70 in chips)
WUlHm+ydPPHG7Lb0rePSdA: posts small blind $1
UZEsV9yKUMqmpYPiOFpaZw: posts big blind $2
nXDI8Y/S6POzRwANu3d8hQ: sits out
*** HOLE CARDS ***
g7gL2NLJCdZPPV399WKT1w: folds
ice1Sbe19zWIaKYoSmE5tw: folds
CkE3IyJF1KvdaAOmZY5XqQ: folds
mIKx5lhIt13X5eZQH0ZeMA: folds
1CtiZuXDFaJL1dJPQKyi8Q: folds
WUlHm+ydPPHG7Lb0rePSdA: folds
UZEsV9yKUMqmpYPiOFpaZw collected $2 from pot
UZEsV9yKUMqmpYPiOFpaZw: doesn't show hand
*** SUMMARY ***
Total pot $2 | Rake $0
Seat 1: UZEsV9yKUMqmpYPiOFpaZw (big blind) collected ($2)
Seat 2: g7gL2NLJCdZPPV399WKT1w folded before Flop (didn't bet)
Seat 3: ice1Sbe19zWIaKYoSmE5tw folded before Flop (didn't bet)
Seat 4: CkE3IyJF1KvdaAOmZY5XqQ folded before Flop (didn't bet)
Seat 5: mIKx5lhIt13X5eZQH0ZeMA folded before Flop (didn't bet)
Seat 8: 1CtiZuXDFaJL1dJPQKyi8Q (button) folded before Flop (didn't bet)
Seat 9: WUlHm+ydPPHG7Lb0rePSdA (small blind) folded before Flop



PokerStars Game #59940989916:  Hold'em No Limit ($1/$2) - 2009/07/01 1:22:29 ET
Table 'TsEDkiO4tzCTCzJ7tNdEqw' 6-max Seat #5 is the button
Seat 1: MfXQsYD8pGeCS7XOtyV+vw ($23.90 in chips)
Seat 2: 4dcDwIHRm96PwtqkpQiuiA ($84.10 in chips)
Seat 3: wgRvjVPZSQvqNGiyR1jwSA ($40 in chips)
Seat 4: K8MXCrNAVYlMnnCeM32Kxw ($90.05 in chips)
Seat 5: VvdR9F3I+2yELkfTVvC1dg ($200 in chips)
Seat 6: uCqEjnxh2/vFBjKYkfTOkw ($262.25 in chips)
uCqEjnxh2/vFBjKYkfTOkw: posts small blind $1
MfXQsYD8pGeCS7XOtyV+vw: posts big blind $2
*** HOLE CARDS ***
4dcDwIHRm96PwtqkpQiuiA: folds
wgRvjVPZSQvqNGiyR1jwSA: raises $2 to $4
K8MXCrNAVYlMnnCeM32Kxw: folds
VvdR9F3I+2yELkfTVvC1dg: folds
uCqEjnxh2/vFBjKYkfTOkw: calls $3
MfXQsYD8pGeCS7XOtyV+vw: raises $19.90 to $23.90 and is all-in
wgRvjVPZSQvqNGiyR1jwSA: folds
uCqEjnxh2/vFBjKYkfTOkw: calls $19.90
*** FLOP *** [8s 4c Ad]
*** TURN *** [8s 4c Ad] [6s]
*** RIVER *** [8s 4c Ad 6s] [9s]
*** SHOW DOWN ***
uCqEjnxh2/vFBjKYkfTOkw: shows [Td Kh] (high card Ace)
MfXQsYD8pGeCS7XOtyV+vw: shows [Qh Ac] (a pair of Aces)
MfXQsYD8pGeCS7XOtyV+vw collected $49.25 from pot
*** SUMMARY ***
Total pot $51.80 | Rake $2.55
Board [8s 4c Ad 6s 9s]
Seat 1: MfXQsYD8pGeCS7XOtyV+vw (big blind) showed [Qh Ac] and won ($49.25) with a pair of Aces
Seat 2: 4dcDwIHRm96PwtqkpQiuiA folded before Flop (didn't bet)
Seat 3: wgRvjVPZSQvqNGiyR1jwSA folded before Flop
Seat 4: K8MXCrNAVYlMnnCeM32Kxw folded before Flop (didn't bet)
Seat 5: VvdR9F3I+2yELkfTVvC1dg (button) folded before Flop (didn't bet)
Seat 6: uCqEjnxh2/vFBjKYkfTOkw (small blind) showed [Td Kh] and lost with high card Ace



PokerStars Game #59940989882:  Hold'em No Limit ($1/$2) - 2009/07/01 1:22:29 ET
Table 'rsKRKlGHlxVyqJxzO2a2Ow' 9-max Seat #7 is the button
Seat 1: uYWfQJg2hgHLxri6/uVJiw ($347.20 in chips)
Seat 2: QHxJjpVYwitg9krW6wZgJA ($273.65 in chips)
Seat 3: zTcFtoHqqK4550YMZ8Y14Q ($60.50 in chips)
Seat 4: 31HuO+DQxppUQEedBWukug ($94 in chips)
Seat 5: 5Q8U6iZbeO7xJSS4qvDP5g ($202 in chips)
Seat 6: H6Z4+qu8gR0VUiPOijndVg ($204.55 in chips)
Seat 7: GX1heJ+DSsvm7gzSPsYhhQ ($33 in chips)
Seat 8: CkE3IyJF1KvdaAOmZY5XqQ ($216.75 in chips)
Seat 9: gRbvhSUVg+TNaTjaJecIRw ($72 in chips)
CkE3IyJF1KvdaAOmZY5XqQ: posts small blind $1
gRbvhSUVg+TNaTjaJecIRw: posts big blind $2
*** HOLE CARDS ***
uYWfQJg2hgHLxri6/uVJiw: raises $4 to $6
QHxJjpVYwitg9krW6wZgJA: folds
zTcFtoHqqK4550YMZ8Y14Q: folds
31HuO+DQxppUQEedBWukug: raises $14 to $20
5Q8U6iZbeO7xJSS4qvDP5g: folds
H6Z4+qu8gR0VUiPOijndVg: folds
GX1heJ+DSsvm7gzSPsYhhQ: folds
CkE3IyJF1KvdaAOmZY5XqQ: folds
gRbvhSUVg+TNaTjaJecIRw: folds
uYWfQJg2hgHLxri6/uVJiw: calls $14
*** FLOP *** [5c 4d 9h]
uYWfQJg2hgHLxri6/uVJiw: checks
31HuO+DQxppUQEedBWukug: bets $28
uYWfQJg2hgHLxri6/uVJiw: folds
31HuO+DQxppUQEedBWukug collected $40.85 from pot
31HuO+DQxppUQEedBWukug: doesn't show hand
*** SUMMARY ***
Total pot $43 | Rake $2.15
Board [5c 4d 9h]
Seat 1: uYWfQJg2hgHLxri6/uVJiw folded on the Flop
Seat 2: QHxJjpVYwitg9krW6wZgJA folded before Flop (didn't bet)
Seat 3: zTcFtoHqqK4550YMZ8Y14Q folded before Flop (didn't bet)
Seat 4: 31HuO+DQxppUQEedBWukug collected ($40.85)
Seat 5: 5Q8U6iZbeO7xJSS4qvDP5g folded before Flop (didn't bet)
Seat 6: H6Z4+qu8gR0VUiPOijndVg folded before Flop (didn't bet)
Seat 7: GX1heJ+DSsvm7gzSPsYhhQ (button) folded before Flop (didn't bet)
Seat 8: CkE3IyJF1KvdaAOmZY5XqQ (small blind) folded before Flop
Seat 9: gRbvhSUVg+TNaTjaJecIRw (big blind) folded before Flop



PokerStars Game #59940990618:  Hold'em No Limit ($1/$2) - 2009/07/01 1:22:30 ET
Table 'jlrIxbrVIG+gjaUYT4za8g' 6-max Seat #3 is the button
Seat 1: ygTTt5ehT4aF86q1a8/R+w ($264.30 in chips)
Seat 2: on4ebXPJvUBOcHOBMQsRSg ($64 in chips)
Seat 3: RUZs7P4uzWavoA6iEpDKLw ($85.75 in chips)
Seat 4: 8srN1dKQePlsv0GyTada+Q ($302.35 in chips)
Seat 5: AyBB0k3Dcl7xbXUeGMw06g ($75.20 in chips)
Seat 6: vkfxu8f/jMYKUk6Ly4eujw ($338 in chips)
8srN1dKQePlsv0GyTada+Q: posts small blind $1
AyBB0k3Dcl7xbXUeGMw06g: posts big blind $2
*** HOLE CARDS ***
vkfxu8f/jMYKUk6Ly4eujw: folds
ygTTt5ehT4aF86q1a8/R+w: folds
on4ebXPJvUBOcHOBMQsRSg: folds
RUZs7P4uzWavoA6iEpDKLw: calls $2
8srN1dKQePlsv0GyTada+Q: calls $1
AyBB0k3Dcl7xbXUeGMw06g: checks
*** FLOP *** [8h 4s 9d]
8srN1dKQePlsv0GyTada+Q: checks
AyBB0k3Dcl7xbXUeGMw06g: checks
RUZs7P4uzWavoA6iEpDKLw: bets $4
8srN1dKQePlsv0GyTada+Q: folds
AyBB0k3Dcl7xbXUeGMw06g: folds
RUZs7P4uzWavoA6iEpDKLw collected $5.70 from pot
*** SUMMARY ***
Total pot $6 | Rake $0.30
Board [8h 4s 9d]
Seat 1: ygTTt5ehT4aF86q1a8/R+w folded before Flop (didn't bet)
Seat 2: on4ebXPJvUBOcHOBMQsRSg folded before Flop (didn't bet)
Seat 3: RUZs7P4uzWavoA6iEpDKLw (button) collected ($5.70)
Seat 4: 8srN1dKQePlsv0GyTada+Q (small blind) folded on the Flop
Seat 5: AyBB0k3Dcl7xbXUeGMw06g (big blind) folded on the Flop
Seat 6: vkfxu8f/jMYKUk6Ly4eujw folded before Flop (didn't bet)



PokerStars Game #59940992540:  Hold'em No Limit ($1/$2) - 2009/07/01 1:22:33 ET
Table 'rKeCh+eBn4RNvybCUYkoTQ' 9-max Seat #5 is the button
Seat 1: /inIs/z/PcX+TniIFpaxpg ($203 in chips)
Seat 2: 9cBHwK40Tl06vheE7B3LHQ ($156.55 in chips)
Seat 3: GX1heJ+DSsvm7gzSPsYhhQ ($37 in chips)
Seat 4: 31HuO+DQxppUQEedBWukug ($89.10 in chips)
Seat 5: WUlHm+ydPPHG7Lb0rePSdA ($128 in chips)
Seat 6: EBV6OktyeSmh4w6sWmcWOw ($268 in chips)
Seat 7: rW/MyplHylMSBRaoRUzWrg ($37 in chips)
Seat 8: pN/Ip0ePsUVIdUlGgLrkUw ($210.10 in chips)
Seat 9: Kzta8yu9vxHT4B70mjBZ+w ($211.25 in chips)
EBV6OktyeSmh4w6sWmcWOw: posts small blind $1
rW/MyplHylMSBRaoRUzWrg: posts big blind $2
*** HOLE CARDS ***
pN/Ip0ePsUVIdUlGgLrkUw: raises $4 to $6
Kzta8yu9vxHT4B70mjBZ+w: folds
/inIs/z/PcX+TniIFpaxpg: folds
9cBHwK40Tl06vheE7B3LHQ: folds
GX1heJ+DSsvm7gzSPsYhhQ: calls $6
31HuO+DQxppUQEedBWukug has timed out
31HuO+DQxppUQEedBWukug: folds
31HuO+DQxppUQEedBWukug is sitting out
WUlHm+ydPPHG7Lb0rePSdA: folds
31HuO+DQxppUQEedBWukug has returned
9cBHwK40Tl06vheE7B3LHQ is sitting out
EBV6OktyeSmh4w6sWmcWOw: folds
rW/MyplHylMSBRaoRUzWrg: folds
*** FLOP *** [Qc 5h 7s]
pN/Ip0ePsUVIdUlGgLrkUw: checks
GX1heJ+DSsvm7gzSPsYhhQ: checks
*** TURN *** [Qc 5h 7s] [Ah]
pN/Ip0ePsUVIdUlGgLrkUw: checks
GX1heJ+DSsvm7gzSPsYhhQ: checks
*** RIVER *** [Qc 5h 7s Ah] [4h]
pN/Ip0ePsUVIdUlGgLrkUw: checks
GX1heJ+DSsvm7gzSPsYhhQ: checks
*** SHOW DOWN ***
pN/Ip0ePsUVIdUlGgLrkUw: shows [As Kd] (a pair of Aces)
GX1heJ+DSsvm7gzSPsYhhQ: mucks hand
pN/Ip0ePsUVIdUlGgLrkUw collected $14.25 from pot
*** SUMMARY ***
Total pot $15 | Rake $0.75
Board [Qc 5h 7s Ah 4h]
Seat 1: /inIs/z/PcX+TniIFpaxpg folded before Flop (didn't bet)
Seat 2: 9cBHwK40Tl06vheE7B3LHQ folded before Flop (didn't bet)
Seat 3: GX1heJ+DSsvm7gzSPsYhhQ mucked
Seat 4: 31HuO+DQxppUQEedBWukug folded before Flop (didn't bet)
Seat 5: WUlHm+ydPPHG7Lb0rePSdA (button) folded before Flop (didn't bet)
Seat 6: EBV6OktyeSmh4w6sWmcWOw (small blind) folded before Flop
Seat 7: rW/MyplHylMSBRaoRUzWrg (big blind) folded before Flop
Seat 8: pN/Ip0ePsUVIdUlGgLrkUw showed [As Kd] and won ($14.25) with a pair of Aces
Seat 9: Kzta8yu9vxHT4B70mjBZ+w folded before Flop (didn't bet)



PokerStars Game #59940993422:  Hold'em No Limit ($1/$2) - 2009/07/01 1:22:35 ET
Table '+hSnXFQrGw1PlVgTnuj+sA' 6-max Seat #2 is the button
Seat 1: 2ccIJhDj+3JapvS7swVZEg ($297.75 in chips)
Seat 2: o9jamqIi6sTTRSqudgboRA ($278.90 in chips)
Seat 3: fE+LHW/7rpfXW14g8LhGjA ($67.30 in chips)
Seat 4: J4iH5epwXbmODnojR/VRxA ($165.60 in chips)
Seat 5: VvdR9F3I+2yELkfTVvC1dg ($200 in chips)
Seat 6: AuiGltq875lmaKHBsjZVGg ($85.75 in chips)
fE+LHW/7rpfXW14g8LhGjA: posts small blind $1
J4iH5epwXbmODnojR/VRxA: posts big blind $2
*** HOLE CARDS ***
VvdR9F3I+2yELkfTVvC1dg: raises $2 to $4
AuiGltq875lmaKHBsjZVGg: calls $4
2ccIJhDj+3JapvS7swVZEg: calls $4
o9jamqIi6sTTRSqudgboRA: folds
fE+LHW/7rpfXW14g8LhGjA: calls $3
J4iH5epwXbmODnojR/VRxA: calls $2
*** FLOP *** [Ah 7d 4s]
fE+LHW/7rpfXW14g8LhGjA: checks
J4iH5epwXbmODnojR/VRxA: checks
VvdR9F3I+2yELkfTVvC1dg: checks
AuiGltq875lmaKHBsjZVGg: checks
2ccIJhDj+3JapvS7swVZEg: checks
*** TURN *** [Ah 7d 4s] [Ac]
fE+LHW/7rpfXW14g8LhGjA: bets $2
J4iH5epwXbmODnojR/VRxA: folds
VvdR9F3I+2yELkfTVvC1dg: folds
AuiGltq875lmaKHBsjZVGg: calls $2
2ccIJhDj+3JapvS7swVZEg: raises $6 to $8
fE+LHW/7rpfXW14g8LhGjA: folds
AuiGltq875lmaKHBsjZVGg: folds
2ccIJhDj+3JapvS7swVZEg collected $24.75 from pot
*** SUMMARY ***
Total pot $26 | Rake $1.25
Board [Ah 7d 4s Ac]
Seat 1: 2ccIJhDj+3JapvS7swVZEg collected ($24.75)
Seat 2: o9jamqIi6sTTRSqudgboRA (button) folded before Flop (didn't bet)
Seat 3: fE+LHW/7rpfXW14g8LhGjA (small blind) folded on the Turn
Seat 4: J4iH5epwXbmODnojR/VRxA (big blind) folded on the Turn
Seat 5: VvdR9F3I+2yELkfTVvC1dg folded on the Turn
Seat 6: AuiGltq875lmaKHBsjZVGg folded on the Turn



PokerStars Game #59940993878:  Hold'em No Limit ($1/$2) - 2009/07/01 1:22:36 ET
Table 'AtOXMvcrtQM8yLNcALmfLQ' 2-max Seat #1 is the button
Seat 1: +HlQuAsMqZGYYtjcPO/a3A ($117.90 in chips)
Seat 2: pVqEzK9wXlRMECnb1Zg4Zw ($278.80 in chips)
+HlQuAsMqZGYYtjcPO/a3A: posts small blind $1
pVqEzK9wXlRMECnb1Zg4Zw: posts big blind $2
*** HOLE CARDS ***
+HlQuAsMqZGYYtjcPO/a3A: calls $1
pVqEzK9wXlRMECnb1Zg4Zw: raises $8 to $10
+HlQuAsMqZGYYtjcPO/a3A: raises $20 to $30
pVqEzK9wXlRMECnb1Zg4Zw: folds
+HlQuAsMqZGYYtjcPO/a3A collected $20 from pot
*** SUMMARY ***
Total pot $20 | Rake $0
Seat 1: +HlQuAsMqZGYYtjcPO/a3A (button) (small blind) collected ($20)
Seat 2: pVqEzK9wXlRMECnb1Zg4Zw (big blind) folded before Flop



PokerStars Game #59940994618:  Hold'em No Limit ($1/$2) - 2009/07/01 1:22:37 ET
Table '/dyk+YdRGv90j2box35j8w' 6-max Seat #2 is the button
Seat 2: qCnEYuAE5y5A7bk6fO5/jQ ($475.60 in chips)
Seat 3: sTPOWERd9HWPCNrDBwsVjA ($189.75 in chips)
Seat 4: z/u1YTnkiIDrtp/2cA2dBg ($190.65 in chips)
Seat 5: VvdR9F3I+2yELkfTVvC1dg ($200 in chips)
sTPOWERd9HWPCNrDBwsVjA: posts small blind $1
z/u1YTnkiIDrtp/2cA2dBg: posts big blind $2
8srN1dKQePlsv0GyTada+Q: sits out
*** HOLE CARDS ***
VvdR9F3I+2yELkfTVvC1dg: folds
qCnEYuAE5y5A7bk6fO5/jQ: folds
sTPOWERd9HWPCNrDBwsVjA: folds
z/u1YTnkiIDrtp/2cA2dBg collected $2 from pot
*** SUMMARY ***
Total pot $2 | Rake $0
Seat 2: qCnEYuAE5y5A7bk6fO5/jQ (button) folded before Flop (didn't bet)
Seat 3: sTPOWERd9HWPCNrDBwsVjA (small blind) folded before Flop
Seat 4: z/u1YTnkiIDrtp/2cA2dBg (big blind) collected ($2)
Seat 5: VvdR9F3I+2yELkfTVvC1dg folded before Flop (didn't bet)



PokerStars Game #59940995094:  Hold'em No Limit ($1/$2) - 2009/07/01 1:22:38 ET
Table 'pPQgcj9XT9CHBsbo1WTBug' 6-max Seat #3 is the button
Seat 1: DFVYDA6dKQy7R7mGIKogZA ($128.65 in chips)
Seat 2: qXDd0ZyMIse0OBu8pxeQ3Q ($215.30 in chips)
Seat 3: 54yWzRRgS0oZ+S6LwZBxMQ ($48.95 in chips)
Seat 4: gqlysXCbT8V54f/1lf9h3A ($24.75 in chips)
Seat 5: vkfxu8f/jMYKUk6Ly4eujw ($226.10 in chips)
Seat 6: Yr7pZltpy3IUNdKS9PCEiw ($307.30 in chips)
gqlysXCbT8V54f/1lf9h3A: posts small blind $1
vkfxu8f/jMYKUk6Ly4eujw: posts big blind $2
*** HOLE CARDS ***
Yr7pZltpy3IUNdKS9PCEiw: folds
DFVYDA6dKQy7R7mGIKogZA: folds
qXDd0ZyMIse0OBu8pxeQ3Q: folds
54yWzRRgS0oZ+S6LwZBxMQ: folds
gqlysXCbT8V54f/1lf9h3A: calls $1
vkfxu8f/jMYKUk6Ly4eujw: checks
*** FLOP *** [Ks 8s 5c]
gqlysXCbT8V54f/1lf9h3A: bets $2
vkfxu8f/jMYKUk6Ly4eujw: folds
gqlysXCbT8V54f/1lf9h3A collected $3.80 from pot
gqlysXCbT8V54f/1lf9h3A: doesn't show hand
*** SUMMARY ***
Total pot $4 | Rake $0.20
Board [Ks 8s 5c]
Seat 1: DFVYDA6dKQy7R7mGIKogZA folded before Flop (didn't bet)
Seat 2: qXDd0ZyMIse0OBu8pxeQ3Q folded before Flop (didn't bet)
Seat 3: 54yWzRRgS0oZ+S6LwZBxMQ (button) folded before Flop (didn't bet)
Seat 4: gqlysXCbT8V54f/1lf9h3A (small blind) collected ($3.80)
Seat 5: vkfxu8f/jMYKUk6Ly4eujw (big blind) folded on the Flop
Seat 6: Yr7pZltpy3IUNdKS9PCEiw folded before Flop (didn't bet)



PokerStars Game #59940995674:  Hold'em No Limit ($1/$2) - 2009/07/01 1:22:39 ET
Table '3WCXyaiCAbqSShQu7FIjvA' 9-max Seat #6 is the button
Seat 1: kTCkABD1UUldS9DFRGfCwQ ($151.60 in chips)
Seat 2: 1zQMh8lHgW3t2YhVeA+09A ($8.80 in chips)
Seat 3: 5Q8U6iZbeO7xJSS4qvDP5g ($200 in chips)
Seat 4: waEF/+pxZTxNo4FvsORuXg ($77 in chips)
Seat 5: CkE3IyJF1KvdaAOmZY5XqQ ($200 in chips)
Seat 6: 5jQlngvMSqM/WoonOcR5kw ($282.35 in chips)
Seat 8: 1CtiZuXDFaJL1dJPQKyi8Q ($243.35 in chips)
Seat 9: FiXPLJyqb24l32QST2TInw ($168.30 in chips)
1CtiZuXDFaJL1dJPQKyi8Q: posts small blind $1
FiXPLJyqb24l32QST2TInw: posts big blind $2
*** HOLE CARDS ***
kTCkABD1UUldS9DFRGfCwQ: folds
1zQMh8lHgW3t2YhVeA+09A: folds
5Q8U6iZbeO7xJSS4qvDP5g: folds
waEF/+pxZTxNo4FvsORuXg: folds
CkE3IyJF1KvdaAOmZY5XqQ: folds
5jQlngvMSqM/WoonOcR5kw: calls $2
1CtiZuXDFaJL1dJPQKyi8Q: folds
FiXPLJyqb24l32QST2TInw: checks
*** FLOP *** [7c 8d Ts]
FiXPLJyqb24l32QST2TInw: bets $2
5jQlngvMSqM/WoonOcR5kw: calls $2
*** TURN *** [7c 8d Ts] [Jh]
FiXPLJyqb24l32QST2TInw: bets $2
5jQlngvMSqM/WoonOcR5kw: raises $2 to $4
FiXPLJyqb24l32QST2TInw: calls $2
*** RIVER *** [7c 8d Ts Jh] [5h]
FiXPLJyqb24l32QST2TInw: checks
5jQlngvMSqM/WoonOcR5kw: bets $10
FiXPLJyqb24l32QST2TInw: raises $10 to $20
5jQlngvMSqM/WoonOcR5kw: calls $10
*** SHOW DOWN ***
FiXPLJyqb24l32QST2TInw: shows [9c 3s] (a straight, Seven to Jack)
5jQlngvMSqM/WoonOcR5kw: shows [9h Td] (a straight, Seven to Jack)
FiXPLJyqb24l32QST2TInw collected $27.10 from pot
5jQlngvMSqM/WoonOcR5kw collected $27.10 from pot
*** SUMMARY ***
Total pot $57 | Rake $2.80
Board [7c 8d Ts Jh 5h]
Seat 1: kTCkABD1UUldS9DFRGfCwQ folded before Flop (didn't bet)
Seat 2: 1zQMh8lHgW3t2YhVeA+09A folded before Flop (didn't bet)
Seat 3: 5Q8U6iZbeO7xJSS4qvDP5g folded before Flop (didn't bet)
Seat 4: waEF/+pxZTxNo4FvsORuXg folded before Flop (didn't bet)
Seat 5: CkE3IyJF1KvdaAOmZY5XqQ folded before Flop (didn't bet)
Seat 6: 5jQlngvMSqM/WoonOcR5kw (button) showed [9h Td] and won ($27.10) with a straight, Seven to Jack
Seat 8: 1CtiZuXDFaJL1dJPQKyi8Q (small blind) folded before Flop
Seat 9: FiXPLJyqb24l32QST2TInw (big blind) showed [9c 3s] and won ($27.10) with a straight, Seven to Jack



PokerStars Game #59940998866:  Hold'em No Limit ($1/$2) - 2009/07/01 1:22:45 ET
Table 'ZzSIe0zTCDv+n6hfbY5tTg' 6-max Seat #4 is the button
Seat 1: VvdR9F3I+2yELkfTVvC1dg ($215.10 in chips)
Seat 2: B87ikIyZ/TzAVeXf38Ny0g ($237 in chips)
Seat 3: gsugPj31Hui3Jefl98MBOA ($201.65 in chips)
Seat 4: qXDd0ZyMIse0OBu8pxeQ3Q ($212.70 in chips)
Seat 5: 3dAbvkxS5NPQTBAbvpinVg ($484.30 in chips)
Seat 6: 09BNF4quPDzanQzM8vc6WA ($22.50 in chips)
3dAbvkxS5NPQTBAbvpinVg: posts small blind $1
09BNF4quPDzanQzM8vc6WA: posts big blind $2
*** HOLE CARDS ***
VvdR9F3I+2yELkfTVvC1dg: folds
B87ikIyZ/TzAVeXf38Ny0g: folds
gsugPj31Hui3Jefl98MBOA: folds
qXDd0ZyMIse0OBu8pxeQ3Q: folds
3dAbvkxS5NPQTBAbvpinVg: folds
09BNF4quPDzanQzM8vc6WA collected $2 from pot
09BNF4quPDzanQzM8vc6WA: doesn't show hand
*** SUMMARY ***
Total pot $2 | Rake $0
Seat 1: VvdR9F3I+2yELkfTVvC1dg folded before Flop (didn't bet)
Seat 2: B87ikIyZ/TzAVeXf38Ny0g folded before Flop (didn't bet)
Seat 3: gsugPj31Hui3Jefl98MBOA folded before Flop (didn't bet)
Seat 4: qXDd0ZyMIse0OBu8pxeQ3Q (button) folded before Flop (didn't bet)
Seat 5: 3dAbvkxS5NPQTBAbvpinVg (small blind) folded before Flop
Seat 6: 09BNF4quPDzanQzM8vc6WA (big blind) collected ($2)



PokerStars Game #59941000218:  Hold'em No Limit ($1/$2) - 2009/07/01 1:22:47 ET
Table 'CFkQcfWjKccZaZDf71FK+w' 6-max Seat #2 is the button
Seat 1: JsC+WvfzqlxVs9G8/gSQAQ ($25.05 in chips)
Seat 2: ewN/vzF22+/gdzjIKBOlkA ($232.20 in chips)
Seat 3: 09BNF4quPDzanQzM8vc6WA ($25 in chips)
Seat 4: ygTTt5ehT4aF86q1a8/R+w ($185.55 in chips)
Seat 5: 2lOU1DcvUZaMcxZ95XfzXw ($100 in chips)
Seat 6: ORVqY3rf9X6ANA/8s+On2Q ($110.50 in chips)
09BNF4quPDzanQzM8vc6WA: posts small blind $1
ygTTt5ehT4aF86q1a8/R+w: posts big blind $2
*** HOLE CARDS ***
2lOU1DcvUZaMcxZ95XfzXw: folds
ORVqY3rf9X6ANA/8s+On2Q: calls $2
JsC+WvfzqlxVs9G8/gSQAQ: folds
ewN/vzF22+/gdzjIKBOlkA: folds
09BNF4quPDzanQzM8vc6WA: folds
ygTTt5ehT4aF86q1a8/R+w: checks
*** FLOP *** [2c 3s 9s]
ygTTt5ehT4aF86q1a8/R+w: checks
ORVqY3rf9X6ANA/8s+On2Q: checks
*** TURN *** [2c 3s 9s] [4c]
ygTTt5ehT4aF86q1a8/R+w: bets $2
ORVqY3rf9X6ANA/8s+On2Q: calls $2
*** RIVER *** [2c 3s 9s 4c] [3d]
ygTTt5ehT4aF86q1a8/R+w: bets $4
ORVqY3rf9X6ANA/8s+On2Q: calls $4
*** SHOW DOWN ***
ygTTt5ehT4aF86q1a8/R+w: shows [6h 4s] (two pair, Fours and Threes)
ORVqY3rf9X6ANA/8s+On2Q: mucks hand
ygTTt5ehT4aF86q1a8/R+w collected $16.20 from pot
*** SUMMARY ***
Total pot $17 | Rake $0.80
Board [2c 3s 9s 4c 3d]
Seat 1: JsC+WvfzqlxVs9G8/gSQAQ folded before Flop (didn't bet)
Seat 2: ewN/vzF22+/gdzjIKBOlkA (button) folded before Flop (didn't bet)
Seat 3: 09BNF4quPDzanQzM8vc6WA (small blind) folded before Flop
Seat 4: ygTTt5ehT4aF86q1a8/R+w (big blind) showed [6h 4s] and won ($16.20) with two pair, Fours and Threes
Seat 5: 2lOU1DcvUZaMcxZ95XfzXw folded before Flop (didn't bet)
Seat 6: ORVqY3rf9X6ANA/8s+On2Q mucked



PokerStars Game #59941000354:  Hold'em No Limit ($1/$2) - 2009/07/01 1:22:47 ET
Table 'YqGfR5eHfMeSjb9a+QU9rg' 9-max Seat #9 is the button
Seat 1: rW/MyplHylMSBRaoRUzWrg ($35 in chips)
Seat 2: W3Nqt1GWlTi9tXQXMNEvgw ($380.70 in chips)
Seat 3: /gll27k+xWYV7Fbki0lFDQ ($270.75 in chips)
Seat 4: QHxJjpVYwitg9krW6wZgJA ($217.30 in chips)
Seat 5: CkE3IyJF1KvdaAOmZY5XqQ ($200 in chips)
Seat 6: TAfo4veNRaRlzDXMMYS3Jg ($37 in chips)
Seat 7: 41aZuLBz9nAi2GPVKabmCw ($96.50 in chips)
Seat 8: JnV3SM2D6dAFYyGZHHpvrg ($101.25 in chips)
Seat 9: /inIs/z/PcX+TniIFpaxpg ($206.05 in chips)
rW/MyplHylMSBRaoRUzWrg: posts small blind $1
W3Nqt1GWlTi9tXQXMNEvgw: posts big blind $2
*** HOLE CARDS ***
/gll27k+xWYV7Fbki0lFDQ: folds
QHxJjpVYwitg9krW6wZgJA: folds
CkE3IyJF1KvdaAOmZY5XqQ: folds
TAfo4veNRaRlzDXMMYS3Jg: folds
41aZuLBz9nAi2GPVKabmCw: folds
JnV3SM2D6dAFYyGZHHpvrg: folds
/inIs/z/PcX+TniIFpaxpg: folds
rW/MyplHylMSBRaoRUzWrg: folds
W3Nqt1GWlTi9tXQXMNEvgw collected $2 from pot
*** SUMMARY ***
Total pot $2 | Rake $0
Seat 1: rW/MyplHylMSBRaoRUzWrg (small blind) folded before Flop
Seat 2: W3Nqt1GWlTi9tXQXMNEvgw (big blind) collected ($2)
Seat 3: /gll27k+xWYV7Fbki0lFDQ folded before Flop (didn't bet)
Seat 4: QHxJjpVYwitg9krW6wZgJA folded before Flop (didn't bet)
Seat 5: CkE3IyJF1KvdaAOmZY5XqQ folded before Flop (didn't bet)
Seat 6: TAfo4veNRaRlzDXMMYS3Jg folded before Flop (didn't bet)
Seat 7: 41aZuLBz9nAi2GPVKabmCw folded before Flop (didn't bet)
Seat 8: JnV3SM2D6dAFYyGZHHpvrg folded before Flop (didn't bet)
Seat 9: /inIs/z/PcX+TniIFpaxpg (button) folded before Flop (didn't bet)



PokerStars Game #59941000900:  Hold'em No Limit ($1/$2) - 2009/07/01 1:22:48 ET
Table 'uJ9juaXXg9yIcSU8amxaXQ' 6-max Seat #5 is the button
Seat 1: JsqOjN/eHz0uYVf/PyUJ6Q ($149.85 in chips)
Seat 2: VvdR9F3I+2yELkfTVvC1dg ($200 in chips)
Seat 3: qXDd0ZyMIse0OBu8pxeQ3Q ($256 in chips)
Seat 4: zNjJ/y4emmF+vzrCDd+ooA ($214.05 in chips)
Seat 5: YsLQ3BAvgQHWXMAv3Wv6Hg ($202 in chips)
Seat 6: 2DFp9Veq1xxq64dCjwNuUw ($53.60 in chips)
2DFp9Veq1xxq64dCjwNuUw: posts small blind $1
JsqOjN/eHz0uYVf/PyUJ6Q: posts big blind $2
*** HOLE CARDS ***
VvdR9F3I+2yELkfTVvC1dg: folds
qXDd0ZyMIse0OBu8pxeQ3Q: folds
zNjJ/y4emmF+vzrCDd+ooA: folds
YsLQ3BAvgQHWXMAv3Wv6Hg: folds
2DFp9Veq1xxq64dCjwNuUw: folds
JsqOjN/eHz0uYVf/PyUJ6Q collected $2 from pot
JsqOjN/eHz0uYVf/PyUJ6Q: doesn't show hand
*** SUMMARY ***
Total pot $2 | Rake $0
Seat 1: JsqOjN/eHz0uYVf/PyUJ6Q (big blind) collected ($2)
Seat 2: VvdR9F3I+2yELkfTVvC1dg folded before Flop (didn't bet)
Seat 3: qXDd0ZyMIse0OBu8pxeQ3Q folded before Flop (didn't bet)
Seat 4: zNjJ/y4emmF+vzrCDd+ooA folded before Flop (didn't bet)
Seat 5: YsLQ3BAvgQHWXMAv3Wv6Hg (button) folded before Flop (didn't bet)
Seat 6: 2DFp9Veq1xxq64dCjwNuUw (small blind) folded before Flop



PokerStars Game #59941000866:  Hold'em No Limit ($1/$2) - 2009/07/01 1:22:48 ET
Table 'LL4bDFyhj5hsMpzaDugJZg' 6-max Seat #2 is the button
Seat 1: FwvID/fQGlpY3soi/lMTww ($82.95 in chips)
Seat 2: IZng3w8jiJHHp3LbYKLi4w ($49.15 in chips)
Seat 3: iI/NMpRxMkGieArQEhACSA ($286.30 in chips)
Seat 4: 8srN1dKQePlsv0GyTada+Q ($314.75 in chips)
Seat 5: A2GTwTiwkb1ilNWgW487Vg ($72.80 in chips)
Seat 6: 692Q4sfB0gTElzS0WMeg+A ($208.10 in chips)
iI/NMpRxMkGieArQEhACSA: posts small blind $1
8srN1dKQePlsv0GyTada+Q: posts big blind $2
*** HOLE CARDS ***
A2GTwTiwkb1ilNWgW487Vg: calls $2
692Q4sfB0gTElzS0WMeg+A: folds
FwvID/fQGlpY3soi/lMTww: folds
IZng3w8jiJHHp3LbYKLi4w: folds
iI/NMpRxMkGieArQEhACSA: calls $1
8srN1dKQePlsv0GyTada+Q: checks
*** FLOP *** [8d Qd Ts]
iI/NMpRxMkGieArQEhACSA: checks
8srN1dKQePlsv0GyTada+Q: bets $2
A2GTwTiwkb1ilNWgW487Vg: calls $2
iI/NMpRxMkGieArQEhACSA: calls $2
*** TURN *** [8d Qd Ts] [5c]
iI/NMpRxMkGieArQEhACSA: checks
8srN1dKQePlsv0GyTada+Q: checks
A2GTwTiwkb1ilNWgW487Vg: checks
*** RIVER *** [8d Qd Ts 5c] [Jd]
iI/NMpRxMkGieArQEhACSA: bets $6
8srN1dKQePlsv0GyTada+Q: folds
A2GTwTiwkb1ilNWgW487Vg: folds
iI/NMpRxMkGieArQEhACSA collected $11.45 from pot
*** SUMMARY ***
Total pot $12 | Rake $0.55
Board [8d Qd Ts 5c Jd]
Seat 1: FwvID/fQGlpY3soi/lMTww folded before Flop (didn't bet)
Seat 2: IZng3w8jiJHHp3LbYKLi4w (button) folded before Flop (didn't bet)
Seat 3: iI/NMpRxMkGieArQEhACSA (small blind) collected ($11.45)
Seat 4: 8srN1dKQePlsv0GyTada+Q (big blind) folded on the River
Seat 5: A2GTwTiwkb1ilNWgW487Vg folded on the River
Seat 6: 692Q4sfB0gTElzS0WMeg+A folded before Flop (didn't bet)



PokerStars Game #59941001694:  Hold'em No Limit ($1/$2) - 2009/07/01 1:22:49 ET
Table 'eyAQSIlgc2o1Jxvbve4WGg' 9-max Seat #9 is the button
Seat 1: UZEsV9yKUMqmpYPiOFpaZw ($102.50 in chips)
Seat 2: g7gL2NLJCdZPPV399WKT1w ($64.65 in chips)
Seat 3: ice1Sbe19zWIaKYoSmE5tw ($99.30 in chips)
Seat 4: CkE3IyJF1KvdaAOmZY5XqQ ($200 in chips)
Seat 5: mIKx5lhIt13X5eZQH0ZeMA ($77.10 in chips)
Seat 8: 1CtiZuXDFaJL1dJPQKyi8Q ($172.35 in chips)
Seat 9: WUlHm+ydPPHG7Lb0rePSdA ($120.70 in chips)
UZEsV9yKUMqmpYPiOFpaZw: posts small blind $1
g7gL2NLJCdZPPV399WKT1w: posts big blind $2
nXDI8Y/S6POzRwANu3d8hQ: sits out
*** HOLE CARDS ***
ice1Sbe19zWIaKYoSmE5tw: folds
CkE3IyJF1KvdaAOmZY5XqQ: folds
mIKx5lhIt13X5eZQH0ZeMA: folds
1CtiZuXDFaJL1dJPQKyi8Q: raises $4 to $6
WUlHm+ydPPHG7Lb0rePSdA: folds
UZEsV9yKUMqmpYPiOFpaZw: folds
g7gL2NLJCdZPPV399WKT1w: calls $4
*** FLOP *** [Ts 8s Ac]
g7gL2NLJCdZPPV399WKT1w: checks
1CtiZuXDFaJL1dJPQKyi8Q: bets $8
g7gL2NLJCdZPPV399WKT1w: calls $8
*** TURN *** [Ts 8s Ac] [5s]
g7gL2NLJCdZPPV399WKT1w: checks
1CtiZuXDFaJL1dJPQKyi8Q: checks
*** RIVER *** [Ts 8s Ac 5s] [3h]
g7gL2NLJCdZPPV399WKT1w: checks
1CtiZuXDFaJL1dJPQKyi8Q: checks
*** SHOW DOWN ***
g7gL2NLJCdZPPV399WKT1w: shows [Qs 9s] (a flush, Queen high)
1CtiZuXDFaJL1dJPQKyi8Q: mucks hand
g7gL2NLJCdZPPV399WKT1w collected $27.60 from pot
*** SUMMARY ***
Total pot $29 | Rake $1.40
Board [Ts 8s Ac 5s 3h]
Seat 1: UZEsV9yKUMqmpYPiOFpaZw (small blind) folded before Flop
Seat 2: g7gL2NLJCdZPPV399WKT1w (big blind) showed [Qs 9s] and won ($27.60) with a flush, Queen high
Seat 3: ice1Sbe19zWIaKYoSmE5tw folded before Flop (didn't bet)
Seat 4: CkE3IyJF1KvdaAOmZY5XqQ folded before Flop (didn't bet)
Seat 5: mIKx5lhIt13X5eZQH0ZeMA folded before Flop (didn't bet)
Seat 8: 1CtiZuXDFaJL1dJPQKyi8Q mucked
Seat 9: WUlHm+ydPPHG7Lb0rePSdA (button) folded before Flop (didn't bet)



PokerStars Game #59941002800:  Hold'em No Limit ($1/$2) - 2009/07/01 1:22:51 ET
Table 'QxerF7GUfCbl+4a8XaTB2w' 6-max Seat #6 is the button
Seat 1: 54yWzRRgS0oZ+S6LwZBxMQ ($38 in chips)
Seat 2: HiWSAXs6/0w9Jy7ioiiShQ ($50 in chips)
Seat 3: m7mYVfnCOK5TE/VkN/FhOg ($281.10 in chips)
Seat 4: 09BNF4quPDzanQzM8vc6WA ($37.55 in chips)
Seat 5: YsLQ3BAvgQHWXMAv3Wv6Hg ($202 in chips)
Seat 6: VvdR9F3I+2yELkfTVvC1dg ($202 in chips)
54yWzRRgS0oZ+S6LwZBxMQ: posts small blind $1
HiWSAXs6/0w9Jy7ioiiShQ: posts big blind $2
*** HOLE CARDS ***
m7mYVfnCOK5TE/VkN/FhOg: folds
09BNF4quPDzanQzM8vc6WA: folds
YsLQ3BAvgQHWXMAv3Wv6Hg: raises $4 to $6
VvdR9F3I+2yELkfTVvC1dg: folds
54yWzRRgS0oZ+S6LwZBxMQ: folds
HiWSAXs6/0w9Jy7ioiiShQ: folds
YsLQ3BAvgQHWXMAv3Wv6Hg collected $5 from pot
YsLQ3BAvgQHWXMAv3Wv6Hg: doesn't show hand
*** SUMMARY ***
Total pot $5 | Rake $0
Seat 1: 54yWzRRgS0oZ+S6LwZBxMQ (small blind) folded before Flop
Seat 2: HiWSAXs6/0w9Jy7ioiiShQ (big blind) folded before Flop
Seat 3: m7mYVfnCOK5TE/VkN/FhOg folded before Flop (didn't bet)
Seat 4: 09BNF4quPDzanQzM8vc6WA folded before Flop (didn't bet)
Seat 5: YsLQ3BAvgQHWXMAv3Wv6Hg collected ($5)
Seat 6: VvdR9F3I+2yELkfTVvC1dg (button) folded before Flop (didn't bet)



PokerStars Game #59941002508:  Hold'em No Limit ($1/$2) - 2009/07/01 1:22:51 ET
Table 'qVXak+oTeDXMGbWa4sDU5Q' 9-max Seat #1 is the button
Seat 1: H6Z4+qu8gR0VUiPOijndVg ($249.55 in chips)
Seat 2: rW/MyplHylMSBRaoRUzWrg ($38 in chips)
Seat 3: WUlHm+ydPPHG7Lb0rePSdA ($172.65 in chips)
Seat 4: lQYT23h5QCUVZAKxjOO39Q ($115.45 in chips)
Seat 5: FWGiDqRwvLeKmHq9t4Jy9w ($268.80 in chips)
Seat 6: GX1heJ+DSsvm7gzSPsYhhQ ($34 in chips)
Seat 7: PfmlvZlFiss79a6IoEr11g ($121.30 in chips)
Seat 8: Z0rzUi0y1x80UdIpofoNbA ($126.55 in chips)
Seat 9: CkE3IyJF1KvdaAOmZY5XqQ ($200 in chips)
rW/MyplHylMSBRaoRUzWrg: posts small blind $1
WUlHm+ydPPHG7Lb0rePSdA: posts big blind $2
*** HOLE CARDS ***
lQYT23h5QCUVZAKxjOO39Q: folds
FWGiDqRwvLeKmHq9t4Jy9w: folds
GX1heJ+DSsvm7gzSPsYhhQ: folds
PfmlvZlFiss79a6IoEr11g: folds
Z0rzUi0y1x80UdIpofoNbA: folds
CkE3IyJF1KvdaAOmZY5XqQ: folds
H6Z4+qu8gR0VUiPOijndVg: folds
rW/MyplHylMSBRaoRUzWrg: folds
WUlHm+ydPPHG7Lb0rePSdA collected $2 from pot
WUlHm+ydPPHG7Lb0rePSdA: doesn't show hand
*** SUMMARY ***
Total pot $2 | Rake $0
Seat 1: H6Z4+qu8gR0VUiPOijndVg (button) folded before Flop (didn't bet)
Seat 2: rW/MyplHylMSBRaoRUzWrg (small blind) folded before Flop
Seat 3: WUlHm+ydPPHG7Lb0rePSdA (big blind) collected ($2)
Seat 4: lQYT23h5QCUVZAKxjOO39Q folded before Flop (didn't bet)
Seat 5: FWGiDqRwvLeKmHq9t4Jy9w folded before Flop (didn't bet)
Seat 6: GX1heJ+DSsvm7gzSPsYhhQ folded before Flop (didn't bet)
Seat 7: PfmlvZlFiss79a6IoEr11g folded before Flop (didn't bet)
Seat 8: Z0rzUi0y1x80UdIpofoNbA folded before Flop (didn't bet)
Seat 9: CkE3IyJF1KvdaAOmZY5XqQ folded before Flop (didn't bet)



PokerStars Game #59941002372:  Hold'em No Limit ($1/$2) - 2009/07/01 1:22:51 ET
Table '/dyk+YdRGv90j2box35j8w' 6-max Seat #3 is the button
Seat 2: qCnEYuAE5y5A7bk6fO5/jQ ($475.60 in chips)
Seat 3: sTPOWERd9HWPCNrDBwsVjA ($188.75 in chips)
Seat 4: z/u1YTnkiIDrtp/2cA2dBg ($191.65 in chips)
Seat 5: VvdR9F3I+2yELkfTVvC1dg ($200 in chips)
z/u1YTnkiIDrtp/2cA2dBg: posts small blind $1
VvdR9F3I+2yELkfTVvC1dg: posts big blind $2
8srN1dKQePlsv0GyTada+Q: sits out
*** HOLE CARDS ***
qCnEYuAE5y5A7bk6fO5/jQ: raises $4 to $6
sTPOWERd9HWPCNrDBwsVjA: folds
z/u1YTnkiIDrtp/2cA2dBg: folds
VvdR9F3I+2yELkfTVvC1dg: folds
qCnEYuAE5y5A7bk6fO5/jQ collected $5 from pot
qCnEYuAE5y5A7bk6fO5/jQ: doesn't show hand
*** SUMMARY ***
Total pot $5 | Rake $0
Seat 2: qCnEYuAE5y5A7bk6fO5/jQ collected ($5)
Seat 3: sTPOWERd9HWPCNrDBwsVjA (button) folded before Flop (didn't bet)
Seat 4: z/u1YTnkiIDrtp/2cA2dBg (small blind) folded before Flop
Seat 5: VvdR9F3I+2yELkfTVvC1dg (big blind) folded before Flop



PokerStars Game #59941003286:  Hold'em No Limit ($1/$2) - 2009/07/01 1:22:52 ET
Table 'NmY84NAf9Mh0ckAckHnh5g' 2-max Seat #1 is the button
Seat 1: 6hvg964TSqZ3AL/0XK9aVQ ($153.10 in chips)
Seat 2: RwDoM55ZeQuI2ADyJhOb2Q ($853.40 in chips)
6hvg964TSqZ3AL/0XK9aVQ: posts small blind $1
RwDoM55ZeQuI2ADyJhOb2Q: posts big blind $2
*** HOLE CARDS ***
6hvg964TSqZ3AL/0XK9aVQ: folds
RwDoM55ZeQuI2ADyJhOb2Q collected $2 from pot
RwDoM55ZeQuI2ADyJhOb2Q: doesn't show hand
*** SUMMARY ***
Total pot $2 | Rake $0
Seat 1: 6hvg964TSqZ3AL/0XK9aVQ (button) (small blind) folded before Flop
Seat 2: RwDoM55ZeQuI2ADyJhOb2Q (big blind) collected ($2)



PokerStars Game #59941004522:  Hold'em No Limit ($1/$2) - 2009/07/01 1:22:54 ET
Table 'mGpP9StWRnoeiBDExc6Frg' 6-max Seat #4 is the button
Seat 1: VvdR9F3I+2yELkfTVvC1dg ($200 in chips)
Seat 2: dZcLsEI8iXkobBduRJ45Yw ($69.50 in chips)
Seat 3: 7acrZUQC3Zc9BNLjoKIcLQ ($45.35 in chips)
Seat 4: 4dcDwIHRm96PwtqkpQiuiA ($87.70 in chips)
Seat 5: d1puGuVBE0fidn+5eRJ0tw ($175.85 in chips)
Seat 6: B2Ih1sr5VZk+8He7rcrMtQ ($455.20 in chips)
d1puGuVBE0fidn+5eRJ0tw: posts small blind $1
B2Ih1sr5VZk+8He7rcrMtQ: posts big blind $2
*** HOLE CARDS ***
B2Ih1sr5VZk+8He7rcrMtQ said, "u lucky *******"
VvdR9F3I+2yELkfTVvC1dg: folds
dZcLsEI8iXkobBduRJ45Yw: raises $2 to $4
7acrZUQC3Zc9BNLjoKIcLQ: folds
4dcDwIHRm96PwtqkpQiuiA: folds
d1puGuVBE0fidn+5eRJ0tw: calls $3
B2Ih1sr5VZk+8He7rcrMtQ: calls $2
*** FLOP *** [2h 4d Th]
d1puGuVBE0fidn+5eRJ0tw: checks
B2Ih1sr5VZk+8He7rcrMtQ: checks
dZcLsEI8iXkobBduRJ45Yw: bets $6
d1puGuVBE0fidn+5eRJ0tw: folds
B2Ih1sr5VZk+8He7rcrMtQ: raises $14 to $20
4dcDwIHRm96PwtqkpQiuiA said, "???"
dZcLsEI8iXkobBduRJ45Yw: folds
B2Ih1sr5VZk+8He7rcrMtQ collected $22.85 from pot
*** SUMMARY ***
Total pot $24 | Rake $1.15
Board [2h 4d Th]
Seat 1: VvdR9F3I+2yELkfTVvC1dg folded before Flop (didn't bet)
Seat 2: dZcLsEI8iXkobBduRJ45Yw folded on the Flop
Seat 3: 7acrZUQC3Zc9BNLjoKIcLQ folded before Flop (didn't bet)
Seat 4: 4dcDwIHRm96PwtqkpQiuiA (button) folded before Flop (didn't bet)
Seat 5: d1puGuVBE0fidn+5eRJ0tw (small blind) folded on the Flop
Seat 6: B2Ih1sr5VZk+8He7rcrMtQ (big blind) collected ($22.85)



PokerStars Game #59941004158:  Hold'em No Limit ($1/$2) - 2009/07/01 1:22:54 ET
Table 'ztv6V3FN2bQ9nmJPPdx6nQ' 6-max Seat #4 is the button
Seat 1: 6fLdOUCRtX71xbVRhJEq8w ($215 in chips)
Seat 2: 5Y+ZGWLI4gnlpApDX5vy1A ($408.25 in chips)
Seat 3: ubtx4Z5L+AcK71MTvYiGVw ($203 in chips)
Seat 4: UaZ5yj+6LjtWqMQg2QskUw ($115.80 in chips)
Seat 5: sTPOWERd9HWPCNrDBwsVjA ($252 in chips)
Seat 6: mfy7uGZcqA2PVQqEVbJ7+g ($117.45 in chips)
sTPOWERd9HWPCNrDBwsVjA: posts small blind $1
mfy7uGZcqA2PVQqEVbJ7+g: posts big blind $2
*** HOLE CARDS ***
6fLdOUCRtX71xbVRhJEq8w has timed out
6fLdOUCRtX71xbVRhJEq8w: folds
6fLdOUCRtX71xbVRhJEq8w is sitting out
5Y+ZGWLI4gnlpApDX5vy1A: folds
ubtx4Z5L+AcK71MTvYiGVw: folds
UaZ5yj+6LjtWqMQg2QskUw: folds
6fLdOUCRtX71xbVRhJEq8w has returned
sTPOWERd9HWPCNrDBwsVjA: folds
mfy7uGZcqA2PVQqEVbJ7+g collected $2 from pot
mfy7uGZcqA2PVQqEVbJ7+g: doesn't show hand
*** SUMMARY ***
Total pot $2 | Rake $0
Seat 1: 6fLdOUCRtX71xbVRhJEq8w folded before Flop (didn't bet)
Seat 2: 5Y+ZGWLI4gnlpApDX5vy1A folded before Flop (didn't bet)
Seat 3: ubtx4Z5L+AcK71MTvYiGVw folded before Flop (didn't bet)
Seat 4: UaZ5yj+6LjtWqMQg2QskUw (button) folded before Flop (didn't bet)
Seat 5: sTPOWERd9HWPCNrDBwsVjA (small blind) folded before Flop
Seat 6: mfy7uGZcqA2PVQqEVbJ7+g (big blind) collected ($2)



PokerStars Game #59941004406:  Hold'em No Limit ($1/$2) - 2009/07/01 1:22:54 ET
Table '4NGNnZ/osQfNq6abYqkJeA' 6-max Seat #4 is the button
Seat 1: 7zM38baFvmCNB/F80oE0cQ ($56.30 in chips)
Seat 2: 669iGNwYwgRZg3nhS+aDAQ ($93.15 in chips)
Seat 3: 54yWzRRgS0oZ+S6LwZBxMQ ($23.75 in chips)
Seat 4: sY+4Uuh5z/6AbXXaCS10jw ($214.35 in chips)
Seat 5: VvdR9F3I+2yELkfTVvC1dg ($235.80 in chips)
Seat 6: kkgpegLoQkmL6LIsFsvtiQ ($263.05 in chips)
VvdR9F3I+2yELkfTVvC1dg: posts small blind $1
kkgpegLoQkmL6LIsFsvtiQ: posts big blind $2
*** HOLE CARDS ***
7zM38baFvmCNB/F80oE0cQ: calls $2
669iGNwYwgRZg3nhS+aDAQ: folds
54yWzRRgS0oZ+S6LwZBxMQ: folds
sY+4Uuh5z/6AbXXaCS10jw: folds
VvdR9F3I+2yELkfTVvC1dg: folds
kkgpegLoQkmL6LIsFsvtiQ: checks
*** FLOP *** [Ks Ts 3c]
kkgpegLoQkmL6LIsFsvtiQ: checks
7zM38baFvmCNB/F80oE0cQ: checks
*** TURN *** [Ks Ts 3c] [7h]
kkgpegLoQkmL6LIsFsvtiQ: checks
7zM38baFvmCNB/F80oE0cQ: bets $2
kkgpegLoQkmL6LIsFsvtiQ: calls $2
*** RIVER *** [Ks Ts 3c 7h] [Js]
kkgpegLoQkmL6LIsFsvtiQ: checks
7zM38baFvmCNB/F80oE0cQ: checks
*** SHOW DOWN ***
kkgpegLoQkmL6LIsFsvtiQ: shows [8h 8s] (a pair of Eights)
7zM38baFvmCNB/F80oE0cQ: mucks hand
kkgpegLoQkmL6LIsFsvtiQ collected $8.60 from pot
*** SUMMARY ***
Total pot $9 | Rake $0.40
Board [Ks Ts 3c 7h Js]
Seat 1: 7zM38baFvmCNB/F80oE0cQ mucked
Seat 2: 669iGNwYwgRZg3nhS+aDAQ folded before Flop (didn't bet)
Seat 3: 54yWzRRgS0oZ+S6LwZBxMQ folded before Flop (didn't bet)
Seat 4: sY+4Uuh5z/6AbXXaCS10jw (button) folded before Flop (didn't bet)
Seat 5: VvdR9F3I+2yELkfTVvC1dg (small blind) folded before Flop
Seat 6: kkgpegLoQkmL6LIsFsvtiQ (big blind) showed [8h 8s] and won ($8.60) with a pair of Eights



PokerStars Game #59941004748:  Hold'em No Limit ($1/$2) - 2009/07/01 1:22:55 ET
Table 'C4lkCXY2PWy6z4vsAe5NGQ' 6-max Seat #4 is the button
Seat 1: 4bqvCfJ0e8CTYnn0Go9hbQ ($64.60 in chips)
Seat 2: 6hRJ68JkbJq6MYI9o5bUnQ ($38.40 in chips)
Seat 3: sTPOWERd9HWPCNrDBwsVjA ($141.80 in chips)
Seat 4: VvdR9F3I+2yELkfTVvC1dg ($234.15 in chips)
Seat 5: dKvrkfQx2Peke3ikZLUy1w ($53.20 in chips)
Seat 6: B87ikIyZ/TzAVeXf38Ny0g ($660.75 in chips)
dKvrkfQx2Peke3ikZLUy1w: posts small blind $1
B87ikIyZ/TzAVeXf38Ny0g: posts big blind $2
*** HOLE CARDS ***
4bqvCfJ0e8CTYnn0Go9hbQ: folds
6hRJ68JkbJq6MYI9o5bUnQ: folds
sTPOWERd9HWPCNrDBwsVjA: raises $139.80 to $141.80 and is all-in
VvdR9F3I+2yELkfTVvC1dg: folds
dKvrkfQx2Peke3ikZLUy1w: folds
B87ikIyZ/TzAVeXf38Ny0g: folds
dKvrkfQx2Peke3ikZLUy1w said, "hell prob call wif 2 7"
sTPOWERd9HWPCNrDBwsVjA collected $5 from pot
*** SUMMARY ***
Total pot $5 | Rake $0
Seat 1: 4bqvCfJ0e8CTYnn0Go9hbQ folded before Flop (didn't bet)
Seat 2: 6hRJ68JkbJq6MYI9o5bUnQ folded before Flop (didn't bet)
Seat 3: sTPOWERd9HWPCNrDBwsVjA collected ($5)
Seat 4: VvdR9F3I+2yELkfTVvC1dg (button) folded before Flop (didn't bet)
Seat 5: dKvrkfQx2Peke3ikZLUy1w (small blind) folded before Flop
Seat 6: B87ikIyZ/TzAVeXf38Ny0g (big blind) folded before Flop



PokerStars Game #59941004868:  Hold'em No Limit ($1/$2) - 2009/07/01 1:22:55 ET
Table 'bJQ024BaYSBrW0sXpCZbNQ' 6-max Seat #5 is the button
Seat 1: PCN5rt4TwI1pQE+rAiqI0Q ($323.60 in chips)
Seat 2: 3dAbvkxS5NPQTBAbvpinVg ($203 in chips)
Seat 3: vkfxu8f/jMYKUk6Ly4eujw ($233.05 in chips)
Seat 5: VvdR9F3I+2yELkfTVvC1dg ($202 in chips)
Seat 6: 9dpyyjDTCed6nV7JhaUUpw ($331.95 in chips)
9dpyyjDTCed6nV7JhaUUpw: posts small blind $1
PCN5rt4TwI1pQE+rAiqI0Q: posts big blind $2
TBaQIN+sQ7eb7P99QnaORQ: sits out
*** HOLE CARDS ***
3dAbvkxS5NPQTBAbvpinVg: folds
vkfxu8f/jMYKUk6Ly4eujw: folds
VvdR9F3I+2yELkfTVvC1dg: folds
9dpyyjDTCed6nV7JhaUUpw: folds
PCN5rt4TwI1pQE+rAiqI0Q collected $2 from pot
*** SUMMARY ***
Total pot $2 | Rake $0
Seat 1: PCN5rt4TwI1pQE+rAiqI0Q (big blind) collected ($2)
Seat 2: 3dAbvkxS5NPQTBAbvpinVg folded before Flop (didn't bet)
Seat 3: vkfxu8f/jMYKUk6Ly4eujw folded before Flop (didn't bet)
Seat 5: VvdR9F3I+2yELkfTVvC1dg (button) folded before Flop (didn't bet)
Seat 6: 9dpyyjDTCed6nV7JhaUUpw (small blind) folded before Flop



PokerStars Game #59941006500:  Hold'em No Limit ($1/$2) - 2009/07/01 1:22:58 ET
Table 'ZzSIe0zTCDv+n6hfbY5tTg' 6-max Seat #5 is the button
Seat 1: VvdR9F3I+2yELkfTVvC1dg ($215.10 in chips)
Seat 2: B87ikIyZ/TzAVeXf38Ny0g ($237 in chips)
Seat 3: gsugPj31Hui3Jefl98MBOA ($201.65 in chips)
Seat 4: qXDd0ZyMIse0OBu8pxeQ3Q ($212.70 in chips)
Seat 5: 3dAbvkxS5NPQTBAbvpinVg ($483.30 in chips)
Seat 6: 09BNF4quPDzanQzM8vc6WA ($23.50 in chips)
09BNF4quPDzanQzM8vc6WA: posts small blind $1
VvdR9F3I+2yELkfTVvC1dg: posts big blind $2
*** HOLE CARDS ***
B87ikIyZ/TzAVeXf38Ny0g: folds
gsugPj31Hui3Jefl98MBOA: raises $5 to $7
qXDd0ZyMIse0OBu8pxeQ3Q: folds
3dAbvkxS5NPQTBAbvpinVg: folds
09BNF4quPDzanQzM8vc6WA: folds
VvdR9F3I+2yELkfTVvC1dg: folds
gsugPj31Hui3Jefl98MBOA collected $5 from pot
*** SUMMARY ***
Total pot $5 | Rake $0
Seat 1: VvdR9F3I+2yELkfTVvC1dg (big blind) folded before Flop
Seat 2: B87ikIyZ/TzAVeXf38Ny0g folded before Flop (didn't bet)
Seat 3: gsugPj31Hui3Jefl98MBOA collected ($5)
Seat 4: qXDd0ZyMIse0OBu8pxeQ3Q folded before Flop (didn't bet)
Seat 5: 3dAbvkxS5NPQTBAbvpinVg (button) folded before Flop (didn't bet)
Seat 6: 09BNF4quPDzanQzM8vc6WA (small blind) folded before Flop



PokerStars Game #59941006804:  Hold'em No Limit ($1/$2) - 2009/07/01 1:22:58 ET
Table 'AtOXMvcrtQM8yLNcALmfLQ' 2-max Seat #2 is the button
Seat 1: +HlQuAsMqZGYYtjcPO/a3A ($127.90 in chips)
Seat 2: pVqEzK9wXlRMECnb1Zg4Zw ($268.80 in chips)
pVqEzK9wXlRMECnb1Zg4Zw: posts small blind $1
+HlQuAsMqZGYYtjcPO/a3A: posts big blind $2
*** HOLE CARDS ***
pVqEzK9wXlRMECnb1Zg4Zw: folds
+HlQuAsMqZGYYtjcPO/a3A collected $2 from pot
*** SUMMARY ***
Total pot $2 | Rake $0
Seat 1: +HlQuAsMqZGYYtjcPO/a3A (big blind) collected ($2)
Seat 2: pVqEzK9wXlRMECnb1Zg4Zw (button) (small blind) folded before Flop



PokerStars Game #59941006856:  Hold'em No Limit ($1/$2) - 2009/07/01 1:22:58 ET
Table 'NmY84NAf9Mh0ckAckHnh5g' 2-max Seat #2 is the button
Seat 1: 6hvg964TSqZ3AL/0XK9aVQ ($152.10 in chips)
Seat 2: RwDoM55ZeQuI2ADyJhOb2Q ($854.40 in chips)
RwDoM55ZeQuI2ADyJhOb2Q: posts small blind $1
6hvg964TSqZ3AL/0XK9aVQ: posts big blind $2
*** HOLE CARDS ***
RwDoM55ZeQuI2ADyJhOb2Q: raises $4 to $6
6hvg964TSqZ3AL/0XK9aVQ: calls $4
*** FLOP *** [2s Jc 6d]
6hvg964TSqZ3AL/0XK9aVQ: checks
RwDoM55ZeQuI2ADyJhOb2Q: bets $8
6hvg964TSqZ3AL/0XK9aVQ: calls $8
*** TURN *** [2s Jc 6d] [Kd]
6hvg964TSqZ3AL/0XK9aVQ: checks
RwDoM55ZeQuI2ADyJhOb2Q: checks
*** RIVER *** [2s Jc 6d Kd] [Qd]
6hvg964TSqZ3AL/0XK9aVQ: bets $24
RwDoM55ZeQuI2ADyJhOb2Q: folds
6hvg964TSqZ3AL/0XK9aVQ collected $27.50 from pot
6hvg964TSqZ3AL/0XK9aVQ: doesn't show hand
*** SUMMARY ***
Total pot $28 | Rake $0.50
Board [2s Jc 6d Kd Qd]
Seat 1: 6hvg964TSqZ3AL/0XK9aVQ (big blind) collected ($27.50)
Seat 2: RwDoM55ZeQuI2ADyJhOb2Q (button) (small blind) folded on the River



PokerStars Game #59941008732:  Hold'em No Limit ($1/$2) - 2009/07/01 1:23:02 ET
Table 'uJ9juaXXg9yIcSU8amxaXQ' 6-max Seat #6 is the button
Seat 1: JsqOjN/eHz0uYVf/PyUJ6Q ($150.85 in chips)
Seat 2: VvdR9F3I+2yELkfTVvC1dg ($200 in chips)
Seat 3: qXDd0ZyMIse0OBu8pxeQ3Q ($256 in chips)
Seat 4: zNjJ/y4emmF+vzrCDd+ooA ($214.05 in chips)
Seat 5: YsLQ3BAvgQHWXMAv3Wv6Hg ($202 in chips)
Seat 6: 2DFp9Veq1xxq64dCjwNuUw ($52.60 in chips)
JsqOjN/eHz0uYVf/PyUJ6Q: posts small blind $1
VvdR9F3I+2yELkfTVvC1dg: posts big blind $2
*** HOLE CARDS ***
qXDd0ZyMIse0OBu8pxeQ3Q: folds
zNjJ/y4emmF+vzrCDd+ooA: calls $2
YsLQ3BAvgQHWXMAv3Wv6Hg: folds
2DFp9Veq1xxq64dCjwNuUw: folds
JsqOjN/eHz0uYVf/PyUJ6Q: calls $1
VvdR9F3I+2yELkfTVvC1dg: checks
*** FLOP *** [Kc 2s Td]
JsqOjN/eHz0uYVf/PyUJ6Q: checks
VvdR9F3I+2yELkfTVvC1dg: checks
zNjJ/y4emmF+vzrCDd+ooA: checks
*** TURN *** [Kc 2s Td] [2c]
JsqOjN/eHz0uYVf/PyUJ6Q: checks
VvdR9F3I+2yELkfTVvC1dg: checks
zNjJ/y4emmF+vzrCDd+ooA: bets $4
JsqOjN/eHz0uYVf/PyUJ6Q: folds
VvdR9F3I+2yELkfTVvC1dg: folds
zNjJ/y4emmF+vzrCDd+ooA collected $5.70 from pot
*** SUMMARY ***
Total pot $6 | Rake $0.30
Board [Kc 2s Td 2c]
Seat 1: JsqOjN/eHz0uYVf/PyUJ6Q (small blind) folded on the Turn
Seat 2: VvdR9F3I+2yELkfTVvC1dg (big blind) folded on the Turn
Seat 3: qXDd0ZyMIse0OBu8pxeQ3Q folded before Flop (didn't bet)
Seat 4: zNjJ/y4emmF+vzrCDd+ooA collected ($5.70)
Seat 5: YsLQ3BAvgQHWXMAv3Wv6Hg folded before Flop (didn't bet)
Seat 6: 2DFp9Veq1xxq64dCjwNuUw (button) folded before Flop (didn't bet)



PokerStars Game #59941010360:  Hold'em No Limit ($1/$2) - 2009/07/01 1:23:04 ET
Table 'jlrIxbrVIG+gjaUYT4za8g' 6-max Seat #4 is the button
Seat 1: ygTTt5ehT4aF86q1a8/R+w ($264.30 in chips)
Seat 2: on4ebXPJvUBOcHOBMQsRSg ($64 in chips)
Seat 3: RUZs7P4uzWavoA6iEpDKLw ($89.45 in chips)
Seat 4: 8srN1dKQePlsv0GyTada+Q ($300.35 in chips)
Seat 5: AyBB0k3Dcl7xbXUeGMw06g ($73.20 in chips)
Seat 6: vkfxu8f/jMYKUk6Ly4eujw ($338 in chips)
AyBB0k3Dcl7xbXUeGMw06g: posts small blind $1
vkfxu8f/jMYKUk6Ly4eujw: posts big blind $2
*** HOLE CARDS ***
ygTTt5ehT4aF86q1a8/R+w: folds
on4ebXPJvUBOcHOBMQsRSg: folds
RUZs7P4uzWavoA6iEpDKLw: raises $4 to $6
8srN1dKQePlsv0GyTada+Q: folds
AyBB0k3Dcl7xbXUeGMw06g: calls $5
vkfxu8f/jMYKUk6Ly4eujw: folds
*** FLOP *** [5h Ks 3c]
AyBB0k3Dcl7xbXUeGMw06g: checks
RUZs7P4uzWavoA6iEpDKLw: bets $8
AyBB0k3Dcl7xbXUeGMw06g: folds
RUZs7P4uzWavoA6iEpDKLw collected $13.30 from pot
*** SUMMARY ***
Total pot $14 | Rake $0.70
Board [5h Ks 3c]
Seat 1: ygTTt5ehT4aF86q1a8/R+w folded before Flop (didn't bet)
Seat 2: on4ebXPJvUBOcHOBMQsRSg folded before Flop (didn't bet)
Seat 3: RUZs7P4uzWavoA6iEpDKLw collected ($13.30)
Seat 4: 8srN1dKQePlsv0GyTada+Q (button) folded before Flop (didn't bet)
Seat 5: AyBB0k3Dcl7xbXUeGMw06g (small blind) folded on the Flop
Seat 6: vkfxu8f/jMYKUk6Ly4eujw (big blind) folded before Flop



PokerStars Game #59941012088:  Hold'em No Limit ($1/$2) - 2009/07/01 1:23:08 ET
Table 'gnHBqWll9O3fxG7Ojkz/ng' 9-max Seat #6 is the button
Seat 1: TAfo4veNRaRlzDXMMYS3Jg ($37 in chips)
Seat 2: H6Z4+qu8gR0VUiPOijndVg ($343.25 in chips)
Seat 3: 5Q8U6iZbeO7xJSS4qvDP5g ($215 in chips)
Seat 5: rBQDMkKm9cZn6M9NPsiVew ($236.45 in chips)
Seat 6: /inIs/z/PcX+TniIFpaxpg ($46.75 in chips)
Seat 7: jqui3xAWCkcdPW36a6BD+w ($340.40 in chips)
Seat 8: cM6efHzdxoqYm0EQKP4TTQ ($101.05 in chips)
Seat 9: sN6yR5I5zFq/WFyIz5UfzQ ($201 in chips)
jqui3xAWCkcdPW36a6BD+w: posts small blind $1
cM6efHzdxoqYm0EQKP4TTQ: posts big blind $2
nXDI8Y/S6POzRwANu3d8hQ: sits out
*** HOLE CARDS ***
sN6yR5I5zFq/WFyIz5UfzQ: folds
TAfo4veNRaRlzDXMMYS3Jg: folds
sN6yR5I5zFq/WFyIz5UfzQ leaves the table
H6Z4+qu8gR0VUiPOijndVg: folds
5Q8U6iZbeO7xJSS4qvDP5g: folds
rBQDMkKm9cZn6M9NPsiVew: folds
GX1heJ+DSsvm7gzSPsYhhQ joins the table at seat #9
/inIs/z/PcX+TniIFpaxpg: folds
jqui3xAWCkcdPW36a6BD+w: folds
cM6efHzdxoqYm0EQKP4TTQ collected $2 from pot
*** SUMMARY ***
Total pot $2 | Rake $0
Seat 1: TAfo4veNRaRlzDXMMYS3Jg folded before Flop (didn't bet)
Seat 2: H6Z4+qu8gR0VUiPOijndVg folded before Flop (didn't bet)
Seat 3: 5Q8U6iZbeO7xJSS4qvDP5g folded before Flop (didn't bet)
Seat 5: rBQDMkKm9cZn6M9NPsiVew folded before Flop (didn't bet)
Seat 6: /inIs/z/PcX+TniIFpaxpg (button) folded before Flop (didn't bet)
Seat 7: jqui3xAWCkcdPW36a6BD+w (small blind) folded before Flop
Seat 8: cM6efHzdxoqYm0EQKP4TTQ (big blind) collected ($2)
Seat 9: sN6yR5I5zFq/WFyIz5UfzQ folded before Flop (didn't bet)



PokerStars Game #59941012170:  Hold'em No Limit ($1/$2) - 2009/07/01 1:23:08 ET
Table 'AtOXMvcrtQM8yLNcALmfLQ' 2-max Seat #1 is the button
Seat 1: +HlQuAsMqZGYYtjcPO/a3A ($128.90 in chips)
Seat 2: pVqEzK9wXlRMECnb1Zg4Zw ($267.80 in chips)
+HlQuAsMqZGYYtjcPO/a3A: posts small blind $1
pVqEzK9wXlRMECnb1Zg4Zw: posts big blind $2
*** HOLE CARDS ***
+HlQuAsMqZGYYtjcPO/a3A: folds
pVqEzK9wXlRMECnb1Zg4Zw collected $2 from pot
pVqEzK9wXlRMECnb1Zg4Zw: doesn't show hand
*** SUMMARY ***
Total pot $2 | Rake $0
Seat 1: +HlQuAsMqZGYYtjcPO/a3A (button) (small blind) folded before Flop
Seat 2: pVqEzK9wXlRMECnb1Zg4Zw (big blind) collected ($2)



PokerStars Game #59941012960:  Hold'em No Limit ($1/$2) - 2009/07/01 1:23:09 ET
Table '8Y6PEyoNuepZTai2Q56aHw' 9-max Seat #9 is the button
Seat 1: 5Q8U6iZbeO7xJSS4qvDP5g ($280 in chips)
Seat 2: gDCJIAlovbPnTvMM7Dd1gA ($176.35 in chips)
Seat 3: WUlHm+ydPPHG7Lb0rePSdA ($128.30 in chips)
Seat 4: xKkwALG38OfLQ9DXuJgR1w ($284.55 in chips)
Seat 6: NtLDBSjsJQEKekh5cdinvw ($361.20 in chips)
Seat 7: Kzta8yu9vxHT4B70mjBZ+w ($207.30 in chips)
Seat 8: rW/MyplHylMSBRaoRUzWrg ($37 in chips)
Seat 9: F7m34OOfAQ7annesMHVjKw ($83.80 in chips)
5Q8U6iZbeO7xJSS4qvDP5g: posts small blind $1
gDCJIAlovbPnTvMM7Dd1gA: posts big blind $2
*** HOLE CARDS ***
WUlHm+ydPPHG7Lb0rePSdA: folds
xKkwALG38OfLQ9DXuJgR1w: folds
NtLDBSjsJQEKekh5cdinvw: folds
Kzta8yu9vxHT4B70mjBZ+w: folds
rW/MyplHylMSBRaoRUzWrg: folds
F7m34OOfAQ7annesMHVjKw: raises $4 to $6
5Q8U6iZbeO7xJSS4qvDP5g: raises $12 to $18
gDCJIAlovbPnTvMM7Dd1gA: folds
F7m34OOfAQ7annesMHVjKw: calls $12
*** FLOP *** [Qh 7s Jh]
5Q8U6iZbeO7xJSS4qvDP5g: bets $27
F7m34OOfAQ7annesMHVjKw: folds
5Q8U6iZbeO7xJSS4qvDP5g collected $36.10 from pot
5Q8U6iZbeO7xJSS4qvDP5g: doesn't show hand
*** SUMMARY ***
Total pot $38 | Rake $1.90
Board [Qh 7s Jh]
Seat 1: 5Q8U6iZbeO7xJSS4qvDP5g (small blind) collected ($36.10)
Seat 2: gDCJIAlovbPnTvMM7Dd1gA (big blind) folded before Flop
Seat 3: WUlHm+ydPPHG7Lb0rePSdA folded before Flop (didn't bet)
Seat 4: xKkwALG38OfLQ9DXuJgR1w folded before Flop (didn't bet)
Seat 6: NtLDBSjsJQEKekh5cdinvw folded before Flop (didn't bet)
Seat 7: Kzta8yu9vxHT4B70mjBZ+w folded before Flop (didn't bet)
Seat 8: rW/MyplHylMSBRaoRUzWrg folded before Flop (didn't bet)
Seat 9: F7m34OOfAQ7annesMHVjKw (button) folded on the Flop



PokerStars Game #59941013030:  Hold'em No Limit ($1/$2) - 2009/07/01 1:23:09 ET
Table 'pPQgcj9XT9CHBsbo1WTBug' 6-max Seat #4 is the button
Seat 1: DFVYDA6dKQy7R7mGIKogZA ($128.65 in chips)
Seat 2: qXDd0ZyMIse0OBu8pxeQ3Q ($215.30 in chips)
Seat 3: 54yWzRRgS0oZ+S6LwZBxMQ ($48.95 in chips)
Seat 4: gqlysXCbT8V54f/1lf9h3A ($26.55 in chips)
Seat 5: vkfxu8f/jMYKUk6Ly4eujw ($224.10 in chips)
Seat 6: Yr7pZltpy3IUNdKS9PCEiw ($307.30 in chips)
vkfxu8f/jMYKUk6Ly4eujw: posts small blind $1
Yr7pZltpy3IUNdKS9PCEiw: posts big blind $2
*** HOLE CARDS ***
DFVYDA6dKQy7R7mGIKogZA: folds
qXDd0ZyMIse0OBu8pxeQ3Q: folds
54yWzRRgS0oZ+S6LwZBxMQ: folds
gqlysXCbT8V54f/1lf9h3A: calls $2
vkfxu8f/jMYKUk6Ly4eujw: raises $8 to $10
Yr7pZltpy3IUNdKS9PCEiw: folds
gqlysXCbT8V54f/1lf9h3A: folds
vkfxu8f/jMYKUk6Ly4eujw collected $6 from pot
vkfxu8f/jMYKUk6Ly4eujw: doesn't show hand
*** SUMMARY ***
Total pot $6 | Rake $0
Seat 1: DFVYDA6dKQy7R7mGIKogZA folded before Flop (didn't bet)
Seat 2: qXDd0ZyMIse0OBu8pxeQ3Q folded before Flop (didn't bet)
Seat 3: 54yWzRRgS0oZ+S6LwZBxMQ folded before Flop (didn't bet)
Seat 4: gqlysXCbT8V54f/1lf9h3A (button) folded before Flop
Seat 5: vkfxu8f/jMYKUk6Ly4eujw (small blind) collected ($6)
Seat 6: Yr7pZltpy3IUNdKS9PCEiw (big blind) folded before Flop



PokerStars Game #59941012716:  Hold'em No Limit ($1/$2) - 2009/07/01 1:23:09 ET
Table 'YqGfR5eHfMeSjb9a+QU9rg' 9-max Seat #1 is the button
Seat 1: rW/MyplHylMSBRaoRUzWrg ($34 in chips)
Seat 2: W3Nqt1GWlTi9tXQXMNEvgw ($381.70 in chips)
Seat 3: /gll27k+xWYV7Fbki0lFDQ ($270.75 in chips)
Seat 4: QHxJjpVYwitg9krW6wZgJA ($217.30 in chips)
Seat 5: CkE3IyJF1KvdaAOmZY5XqQ ($200 in chips)
Seat 6: TAfo4veNRaRlzDXMMYS3Jg ($37 in chips)
Seat 7: 41aZuLBz9nAi2GPVKabmCw ($96.50 in chips)
Seat 8: JnV3SM2D6dAFYyGZHHpvrg ($101.25 in chips)
Seat 9: /inIs/z/PcX+TniIFpaxpg ($206.05 in chips)
W3Nqt1GWlTi9tXQXMNEvgw: posts small blind $1
/gll27k+xWYV7Fbki0lFDQ: posts big blind $2
*** HOLE CARDS ***
QHxJjpVYwitg9krW6wZgJA: folds
QHxJjpVYwitg9krW6wZgJA is sitting out
CkE3IyJF1KvdaAOmZY5XqQ: folds
TAfo4veNRaRlzDXMMYS3Jg: folds
41aZuLBz9nAi2GPVKabmCw: folds
JnV3SM2D6dAFYyGZHHpvrg: folds
/inIs/z/PcX+TniIFpaxpg: folds
rW/MyplHylMSBRaoRUzWrg: folds
W3Nqt1GWlTi9tXQXMNEvgw: calls $1
/gll27k+xWYV7Fbki0lFDQ: checks
*** FLOP *** [3d 4c 7c]
W3Nqt1GWlTi9tXQXMNEvgw: bets $2
/gll27k+xWYV7Fbki0lFDQ: folds
W3Nqt1GWlTi9tXQXMNEvgw collected $3.80 from pot
W3Nqt1GWlTi9tXQXMNEvgw: doesn't show hand
*** SUMMARY ***
Total pot $4 | Rake $0.20
Board [3d 4c 7c]
Seat 1: rW/MyplHylMSBRaoRUzWrg (button) folded before Flop (didn't bet)
Seat 2: W3Nqt1GWlTi9tXQXMNEvgw (small blind) collected ($3.80)
Seat 3: /gll27k+xWYV7Fbki0lFDQ (big blind) folded on the Flop
Seat 4: QHxJjpVYwitg9krW6wZgJA folded before Flop (didn't bet)
Seat 5: CkE3IyJF1KvdaAOmZY5XqQ folded before Flop (didn't bet)
Seat 6: TAfo4veNRaRlzDXMMYS3Jg folded before Flop (didn't bet)
Seat 7: 41aZuLBz9nAi2GPVKabmCw folded before Flop (didn't bet)
Seat 8: JnV3SM2D6dAFYyGZHHpvrg folded before Flop (didn't bet)
Seat 9: /inIs/z/PcX+TniIFpaxpg folded before Flop (didn't bet)



PokerStars Game #59941013824:  Hold'em No Limit ($1/$2) - 2009/07/01 1:23:10 ET
Table 'QxerF7GUfCbl+4a8XaTB2w' 6-max Seat #1 is the button
Seat 1: 54yWzRRgS0oZ+S6LwZBxMQ ($37 in chips)
Seat 2: HiWSAXs6/0w9Jy7ioiiShQ ($48 in chips)
Seat 3: m7mYVfnCOK5TE/VkN/FhOg ($281.10 in chips)
Seat 4: 09BNF4quPDzanQzM8vc6WA ($37.55 in chips)
Seat 5: YsLQ3BAvgQHWXMAv3Wv6Hg ($205 in chips)
Seat 6: VvdR9F3I+2yELkfTVvC1dg ($202 in chips)
HiWSAXs6/0w9Jy7ioiiShQ: posts small blind $1
m7mYVfnCOK5TE/VkN/FhOg: posts big blind $2
*** HOLE CARDS ***
09BNF4quPDzanQzM8vc6WA: folds
YsLQ3BAvgQHWXMAv3Wv6Hg: folds
YsLQ3BAvgQHWXMAv3Wv6Hg leaves the table
VvdR9F3I+2yELkfTVvC1dg: raises $2 to $4
gnYme0DNFflnMhrdbxe1Ag joins the table at seat #5
54yWzRRgS0oZ+S6LwZBxMQ: folds
HiWSAXs6/0w9Jy7ioiiShQ: calls $3
m7mYVfnCOK5TE/VkN/FhOg: calls $2
*** FLOP *** [2h 3s 2s]
HiWSAXs6/0w9Jy7ioiiShQ: checks
m7mYVfnCOK5TE/VkN/FhOg: checks
VvdR9F3I+2yELkfTVvC1dg: checks
*** TURN *** [2h 3s 2s] [2d]
HiWSAXs6/0w9Jy7ioiiShQ: checks
m7mYVfnCOK5TE/VkN/FhOg: checks
VvdR9F3I+2yELkfTVvC1dg: checks
*** RIVER *** [2h 3s 2s 2d] [8c]
HiWSAXs6/0w9Jy7ioiiShQ: checks
m7mYVfnCOK5TE/VkN/FhOg: checks
VvdR9F3I+2yELkfTVvC1dg: checks
*** SHOW DOWN ***
HiWSAXs6/0w9Jy7ioiiShQ: shows [Jc 9h] (three of a kind, Deuces)
m7mYVfnCOK5TE/VkN/FhOg: shows [Jh Ks] (three of a kind, Deuces - King kicker)
VvdR9F3I+2yELkfTVvC1dg: shows [Ah Jd] (three of a kind, Deuces - Ace kicker)
VvdR9F3I+2yELkfTVvC1dg collected $11.40 from pot
*** SUMMARY ***
Total pot $12 | Rake $0.60
Board [2h 3s 2s 2d 8c]
Seat 1: 54yWzRRgS0oZ+S6LwZBxMQ (button) folded before Flop (didn't bet)
Seat 2: HiWSAXs6/0w9Jy7ioiiShQ (small blind) showed [Jc 9h] and lost with three of a kind, Deuces
Seat 3: m7mYVfnCOK5TE/VkN/FhOg (big blind) showed [Jh Ks] and lost with three of a kind, Deuces
Seat 4: 09BNF4quPDzanQzM8vc6WA folded before Flop (didn't bet)
Seat 5: YsLQ3BAvgQHWXMAv3Wv6Hg folded before Flop (didn't bet)
Seat 6: VvdR9F3I+2yELkfTVvC1dg showed [Ah Jd] and won ($11.40) with three of a kind, Deuces



PokerStars Game #59941013574:  Hold'em No Limit ($1/$2) - 2009/07/01 1:23:10 ET
Table '/dyk+YdRGv90j2box35j8w' 6-max Seat #4 is the button
Seat 1: 8srN1dKQePlsv0GyTada+Q ($200 in chips)
Seat 2: qCnEYuAE5y5A7bk6fO5/jQ ($478.60 in chips)
Seat 3: sTPOWERd9HWPCNrDBwsVjA ($188.75 in chips)
Seat 4: z/u1YTnkiIDrtp/2cA2dBg ($190.65 in chips)
Seat 5: VvdR9F3I+2yELkfTVvC1dg ($200 in chips)
VvdR9F3I+2yELkfTVvC1dg: posts small blind $1
8srN1dKQePlsv0GyTada+Q: posts big blind $2
*** HOLE CARDS ***
qCnEYuAE5y5A7bk6fO5/jQ: folds
sTPOWERd9HWPCNrDBwsVjA: folds
z/u1YTnkiIDrtp/2cA2dBg: folds
VvdR9F3I+2yELkfTVvC1dg: folds
8srN1dKQePlsv0GyTada+Q collected $2 from pot
8srN1dKQePlsv0GyTada+Q: doesn't show hand
*** SUMMARY ***
Total pot $2 | Rake $0
Seat 1: 8srN1dKQePlsv0GyTada+Q (big blind) collected ($2)
Seat 2: qCnEYuAE5y5A7bk6fO5/jQ folded before Flop (didn't bet)
Seat 3: sTPOWERd9HWPCNrDBwsVjA folded before Flop (didn't bet)
Seat 4: z/u1YTnkiIDrtp/2cA2dBg (button) folded before Flop (didn't bet)
Seat 5: VvdR9F3I+2yELkfTVvC1dg (small blind) folded before Flop



PokerStars Game #59941014578:  Hold'em No Limit ($1/$2) - 2009/07/01 1:23:12 ET
Table 'TsEDkiO4tzCTCzJ7tNdEqw' 6-max Seat #6 is the button
Seat 1: MfXQsYD8pGeCS7XOtyV+vw ($49.25 in chips)
Seat 2: 4dcDwIHRm96PwtqkpQiuiA ($84.10 in chips)
Seat 3: wgRvjVPZSQvqNGiyR1jwSA ($36 in chips)
Seat 4: K8MXCrNAVYlMnnCeM32Kxw ($90.05 in chips)
Seat 5: VvdR9F3I+2yELkfTVvC1dg ($200 in chips)
Seat 6: uCqEjnxh2/vFBjKYkfTOkw ($238.35 in chips)
MfXQsYD8pGeCS7XOtyV+vw: posts small blind $1
4dcDwIHRm96PwtqkpQiuiA: posts big blind $2
*** HOLE CARDS ***
wgRvjVPZSQvqNGiyR1jwSA: calls $2
K8MXCrNAVYlMnnCeM32Kxw: folds
VvdR9F3I+2yELkfTVvC1dg: folds
uCqEjnxh2/vFBjKYkfTOkw: calls $2
MfXQsYD8pGeCS7XOtyV+vw: calls $1
4dcDwIHRm96PwtqkpQiuiA: checks
*** FLOP *** [2c 3h 3c]
MfXQsYD8pGeCS7XOtyV+vw: checks
4dcDwIHRm96PwtqkpQiuiA: checks
wgRvjVPZSQvqNGiyR1jwSA: bets $4
uCqEjnxh2/vFBjKYkfTOkw: raises $8 to $12
MfXQsYD8pGeCS7XOtyV+vw: calls $12
4dcDwIHRm96PwtqkpQiuiA: folds
wgRvjVPZSQvqNGiyR1jwSA: raises $22 to $34 and is all-in
uCqEjnxh2/vFBjKYkfTOkw: folds
MfXQsYD8pGeCS7XOtyV+vw: calls $22
*** TURN *** [2c 3h 3c] [2d]
*** RIVER *** [2c 3h 3c 2d] [Kh]
*** SHOW DOWN ***
MfXQsYD8pGeCS7XOtyV+vw: shows [3s 2s] (a full house, Threes full of Deuces)
wgRvjVPZSQvqNGiyR1jwSA: mucks hand
MfXQsYD8pGeCS7XOtyV+vw collected $85 from pot
*** SUMMARY ***
Total pot $88 | Rake $3
Board [2c 3h 3c 2d Kh]
Seat 1: MfXQsYD8pGeCS7XOtyV+vw (small blind) showed [3s 2s] and won ($85) with a full house, Threes full of Deuces
Seat 2: 4dcDwIHRm96PwtqkpQiuiA (big blind) folded on the Flop
Seat 3: wgRvjVPZSQvqNGiyR1jwSA mucked
Seat 4: K8MXCrNAVYlMnnCeM32Kxw folded before Flop (didn't bet)
Seat 5: VvdR9F3I+2yELkfTVvC1dg folded before Flop (didn't bet)
Seat 6: uCqEjnxh2/vFBjKYkfTOkw (button) folded on the Flop



PokerStars Game #59941016380:  Hold'em No Limit ($1/$2) - 2009/07/01 1:23:15 ET
Table 'bJQ024BaYSBrW0sXpCZbNQ' 6-max Seat #6 is the button
Seat 1: PCN5rt4TwI1pQE+rAiqI0Q ($324.60 in chips)
Seat 2: 3dAbvkxS5NPQTBAbvpinVg ($203 in chips)
Seat 3: vkfxu8f/jMYKUk6Ly4eujw ($233.05 in chips)
Seat 5: VvdR9F3I+2yELkfTVvC1dg ($202 in chips)
Seat 6: 9dpyyjDTCed6nV7JhaUUpw ($330.95 in chips)
PCN5rt4TwI1pQE+rAiqI0Q: posts small blind $1
3dAbvkxS5NPQTBAbvpinVg: posts big blind $2
TBaQIN+sQ7eb7P99QnaORQ: sits out
*** HOLE CARDS ***
vkfxu8f/jMYKUk6Ly4eujw: folds
VvdR9F3I+2yELkfTVvC1dg: folds
9dpyyjDTCed6nV7JhaUUpw: folds
PCN5rt4TwI1pQE+rAiqI0Q: calls $1
3dAbvkxS5NPQTBAbvpinVg: raises $6 to $8
PCN5rt4TwI1pQE+rAiqI0Q: calls $6
*** FLOP *** [4d 3h 7h]
PCN5rt4TwI1pQE+rAiqI0Q: checks
3dAbvkxS5NPQTBAbvpinVg: bets $12
PCN5rt4TwI1pQE+rAiqI0Q: calls $12
*** TURN *** [4d 3h 7h] [Ah]
PCN5rt4TwI1pQE+rAiqI0Q: checks
3dAbvkxS5NPQTBAbvpinVg: bets $27
PCN5rt4TwI1pQE+rAiqI0Q: folds
3dAbvkxS5NPQTBAbvpinVg collected $38.05 from pot
3dAbvkxS5NPQTBAbvpinVg: doesn't show hand
*** SUMMARY ***
Total pot $40 | Rake $1.95
Board [4d 3h 7h Ah]
Seat 1: PCN5rt4TwI1pQE+rAiqI0Q (small blind) folded on the Turn
Seat 2: 3dAbvkxS5NPQTBAbvpinVg (big blind) collected ($38.05)
Seat 3: vkfxu8f/jMYKUk6Ly4eujw folded before Flop (didn't bet)
Seat 5: VvdR9F3I+2yELkfTVvC1dg folded before Flop (didn't bet)
Seat 6: 9dpyyjDTCed6nV7JhaUUpw (button) folded before Flop (didn't bet)



PokerStars Game #59941017328:  Hold'em No Limit ($1/$2) - 2009/07/01 1:23:16 ET
Table 'AtOXMvcrtQM8yLNcALmfLQ' 2-max Seat #2 is the button
Seat 1: +HlQuAsMqZGYYtjcPO/a3A ($127.90 in chips)
Seat 2: pVqEzK9wXlRMECnb1Zg4Zw ($268.80 in chips)
pVqEzK9wXlRMECnb1Zg4Zw: posts small blind $1
+HlQuAsMqZGYYtjcPO/a3A: posts big blind $2
*** HOLE CARDS ***
pVqEzK9wXlRMECnb1Zg4Zw: raises $6 to $8
+HlQuAsMqZGYYtjcPO/a3A: raises $10 to $18
pVqEzK9wXlRMECnb1Zg4Zw: folds
+HlQuAsMqZGYYtjcPO/a3A collected $16 from pot
*** SUMMARY ***
Total pot $16 | Rake $0
Seat 1: +HlQuAsMqZGYYtjcPO/a3A (big blind) collected ($16)
Seat 2: pVqEzK9wXlRMECnb1Zg4Zw (button) (small blind) folded before Flop



PokerStars Game #59941017544:  Hold'em No Limit ($1/$2) - 2009/07/01 1:23:17 ET
Table 'kq5zaQ+1hLNf8LZfGnbTAA' 6-max Seat #6 is the button
Seat 1: 8srN1dKQePlsv0GyTada+Q ($243.20 in chips)
Seat 2: nXDI8Y/S6POzRwANu3d8hQ ($63.80 in chips)
Seat 3: vkfxu8f/jMYKUk6Ly4eujw ($227.95 in chips)
Seat 4: 3dAbvkxS5NPQTBAbvpinVg ($200 in chips)
Seat 5: kfASJqTbXek+zc8ZKsZL1Q ($137.75 in chips)
Seat 6: mfy7uGZcqA2PVQqEVbJ7+g ($191.25 in chips)
8srN1dKQePlsv0GyTada+Q: posts small blind $1
nXDI8Y/S6POzRwANu3d8hQ: posts big blind $2
*** HOLE CARDS ***
vkfxu8f/jMYKUk6Ly4eujw: folds
3dAbvkxS5NPQTBAbvpinVg: folds
kfASJqTbXek+zc8ZKsZL1Q: raises $4 to $6
mfy7uGZcqA2PVQqEVbJ7+g: folds
8srN1dKQePlsv0GyTada+Q: folds
nXDI8Y/S6POzRwANu3d8hQ: folds
kfASJqTbXek+zc8ZKsZL1Q collected $5 from pot
kfASJqTbXek+zc8ZKsZL1Q: doesn't show hand
*** SUMMARY ***
Total pot $5 | Rake $0
Seat 1: 8srN1dKQePlsv0GyTada+Q (small blind) folded before Flop
Seat 2: nXDI8Y/S6POzRwANu3d8hQ (big blind) folded before Flop
Seat 3: vkfxu8f/jMYKUk6Ly4eujw folded before Flop (didn't bet)
Seat 4: 3dAbvkxS5NPQTBAbvpinVg folded before Flop (didn't bet)
Seat 5: kfASJqTbXek+zc8ZKsZL1Q collected ($5)
Seat 6: mfy7uGZcqA2PVQqEVbJ7+g (button) folded before Flop (didn't bet)



PokerStars Game #59941019664:  Hold'em No Limit ($1/$2) - 2009/07/01 1:23:20 ET
Table 'qVXak+oTeDXMGbWa4sDU5Q' 9-max Seat #2 is the button
Seat 1: H6Z4+qu8gR0VUiPOijndVg ($249.55 in chips)
Seat 2: rW/MyplHylMSBRaoRUzWrg ($37 in chips)
Seat 3: WUlHm+ydPPHG7Lb0rePSdA ($173.65 in chips)
Seat 4: lQYT23h5QCUVZAKxjOO39Q ($115.45 in chips)
Seat 5: FWGiDqRwvLeKmHq9t4Jy9w ($268.80 in chips)
Seat 6: GX1heJ+DSsvm7gzSPsYhhQ ($34 in chips)
Seat 7: PfmlvZlFiss79a6IoEr11g ($121.30 in chips)
Seat 8: Z0rzUi0y1x80UdIpofoNbA ($126.55 in chips)
Seat 9: CkE3IyJF1KvdaAOmZY5XqQ ($200 in chips)
WUlHm+ydPPHG7Lb0rePSdA: posts small blind $1
lQYT23h5QCUVZAKxjOO39Q: posts big blind $2
*** HOLE CARDS ***
FWGiDqRwvLeKmHq9t4Jy9w: folds
GX1heJ+DSsvm7gzSPsYhhQ: folds
PfmlvZlFiss79a6IoEr11g: folds
Z0rzUi0y1x80UdIpofoNbA: folds
CkE3IyJF1KvdaAOmZY5XqQ: folds
H6Z4+qu8gR0VUiPOijndVg: raises $4 to $6
rW/MyplHylMSBRaoRUzWrg: raises $12 to $18
WUlHm+ydPPHG7Lb0rePSdA: folds
lQYT23h5QCUVZAKxjOO39Q: folds
H6Z4+qu8gR0VUiPOijndVg: raises $12 to $30
rW/MyplHylMSBRaoRUzWrg: raises $7 to $37 and is all-in
H6Z4+qu8gR0VUiPOijndVg: calls $7
*** FLOP *** [6d 8s 8c]
*** TURN *** [6d 8s 8c] [Jh]
*** RIVER *** [6d 8s 8c Jh] [7h]
*** SHOW DOWN ***
H6Z4+qu8gR0VUiPOijndVg: shows [Ts Ad] (a pair of Eights)
rW/MyplHylMSBRaoRUzWrg: shows [Ah Ks] (a pair of Eights - Ace+King kicker)
rW/MyplHylMSBRaoRUzWrg collected $74 from pot
*** SUMMARY ***
Total pot $77 | Rake $3
Board [6d 8s 8c Jh 7h]
Seat 1: H6Z4+qu8gR0VUiPOijndVg showed [Ts Ad] and lost with a pair of Eights
Seat 2: rW/MyplHylMSBRaoRUzWrg (button) showed [Ah Ks] and won ($74) with a pair of Eights
Seat 3: WUlHm+ydPPHG7Lb0rePSdA (small blind) folded before Flop
Seat 4: lQYT23h5QCUVZAKxjOO39Q (big blind) folded before Flop
Seat 5: FWGiDqRwvLeKmHq9t4Jy9w folded before Flop (didn't bet)
Seat 6: GX1heJ+DSsvm7gzSPsYhhQ folded before Flop (didn't bet)
Seat 7: PfmlvZlFiss79a6IoEr11g folded before Flop (didn't bet)
Seat 8: Z0rzUi0y1x80UdIpofoNbA folded before Flop (didn't bet)
Seat 9: CkE3IyJF1KvdaAOmZY5XqQ folded before Flop (didn't bet)



PokerStars Game #59941021042:  Hold'em No Limit ($1/$2) - 2009/07/01 1:23:23 ET
Table 'NmY84NAf9Mh0ckAckHnh5g' 2-max Seat #1 is the button
Seat 1: 6hvg964TSqZ3AL/0XK9aVQ ($165.60 in chips)
Seat 2: RwDoM55ZeQuI2ADyJhOb2Q ($840.40 in chips)
6hvg964TSqZ3AL/0XK9aVQ: posts small blind $1
RwDoM55ZeQuI2ADyJhOb2Q: posts big blind $2
*** HOLE CARDS ***
6hvg964TSqZ3AL/0XK9aVQ: calls $1
RwDoM55ZeQuI2ADyJhOb2Q: checks
*** FLOP *** [7h 8c 4s]
RwDoM55ZeQuI2ADyJhOb2Q: bets $4
6hvg964TSqZ3AL/0XK9aVQ: calls $4
*** TURN *** [7h 8c 4s] [Th]
RwDoM55ZeQuI2ADyJhOb2Q: bets $10
6hvg964TSqZ3AL/0XK9aVQ: calls $10
*** RIVER *** [7h 8c 4s Th] [5s]
RwDoM55ZeQuI2ADyJhOb2Q: checks
6hvg964TSqZ3AL/0XK9aVQ: bets $44
RwDoM55ZeQuI2ADyJhOb2Q: folds
6hvg964TSqZ3AL/0XK9aVQ collected $31.50 from pot
6hvg964TSqZ3AL/0XK9aVQ: doesn't show hand
*** SUMMARY ***
Total pot $32 | Rake $0.50
Board [7h 8c 4s Th 5s]
Seat 1: 6hvg964TSqZ3AL/0XK9aVQ (button) (small blind) collected ($31.50)
Seat 2: RwDoM55ZeQuI2ADyJhOb2Q (big blind) folded on the River



PokerStars Game #59941021642:  Hold'em No Limit ($1/$2) - 2009/07/01 1:23:24 ET
Table 'C4lkCXY2PWy6z4vsAe5NGQ' 6-max Seat #5 is the button
Seat 1: 4bqvCfJ0e8CTYnn0Go9hbQ ($64.60 in chips)
Seat 2: 6hRJ68JkbJq6MYI9o5bUnQ ($38.40 in chips)
Seat 3: sTPOWERd9HWPCNrDBwsVjA ($144.80 in chips)
Seat 4: VvdR9F3I+2yELkfTVvC1dg ($234.15 in chips)
Seat 5: dKvrkfQx2Peke3ikZLUy1w ($52.20 in chips)
Seat 6: B87ikIyZ/TzAVeXf38Ny0g ($658.75 in chips)
dKvrkfQx2Peke3ikZLUy1w said, "the spastic ****"
B87ikIyZ/TzAVeXf38Ny0g: posts small blind $1
4bqvCfJ0e8CTYnn0Go9hbQ: posts big blind $2
*** HOLE CARDS ***
6hRJ68JkbJq6MYI9o5bUnQ: folds
sTPOWERd9HWPCNrDBwsVjA: folds
VvdR9F3I+2yELkfTVvC1dg: folds
dKvrkfQx2Peke3ikZLUy1w: raises $4 to $6
B87ikIyZ/TzAVeXf38Ny0g: folds
4bqvCfJ0e8CTYnn0Go9hbQ: folds
dKvrkfQx2Peke3ikZLUy1w collected $5 from pot
*** SUMMARY ***
Total pot $5 | Rake $0
Seat 1: 4bqvCfJ0e8CTYnn0Go9hbQ (big blind) folded before Flop
Seat 2: 6hRJ68JkbJq6MYI9o5bUnQ folded before Flop (didn't bet)
Seat 3: sTPOWERd9HWPCNrDBwsVjA folded before Flop (didn't bet)
Seat 4: VvdR9F3I+2yELkfTVvC1dg folded before Flop (didn't bet)
Seat 5: dKvrkfQx2Peke3ikZLUy1w (button) collected ($5)
Seat 6: B87ikIyZ/TzAVeXf38Ny0g (small blind) folded before Flop



PokerStars Game #59941021556:  Hold'em No Limit ($1/$2) - 2009/07/01 1:23:24 ET
Table '/dyk+YdRGv90j2box35j8w' 6-max Seat #5 is the button
Seat 1: 8srN1dKQePlsv0GyTada+Q ($201 in chips)
Seat 2: qCnEYuAE5y5A7bk6fO5/jQ ($478.60 in chips)
Seat 3: sTPOWERd9HWPCNrDBwsVjA ($188.75 in chips)
Seat 4: z/u1YTnkiIDrtp/2cA2dBg ($190.65 in chips)
Seat 5: VvdR9F3I+2yELkfTVvC1dg ($200 in chips)
8srN1dKQePlsv0GyTada+Q: posts small blind $1
qCnEYuAE5y5A7bk6fO5/jQ: posts big blind $2
*** HOLE CARDS ***
sTPOWERd9HWPCNrDBwsVjA: folds
z/u1YTnkiIDrtp/2cA2dBg: raises $5 to $7
VvdR9F3I+2yELkfTVvC1dg: folds
8srN1dKQePlsv0GyTada+Q: folds
qCnEYuAE5y5A7bk6fO5/jQ: folds
z/u1YTnkiIDrtp/2cA2dBg collected $5 from pot
*** SUMMARY ***
Total pot $5 | Rake $0
Seat 1: 8srN1dKQePlsv0GyTada+Q (small blind) folded before Flop
Seat 2: qCnEYuAE5y5A7bk6fO5/jQ (big blind) folded before Flop
Seat 3: sTPOWERd9HWPCNrDBwsVjA folded before Flop (didn't bet)
Seat 4: z/u1YTnkiIDrtp/2cA2dBg collected ($5)
Seat 5: VvdR9F3I+2yELkfTVvC1dg (button) folded before Flop (didn't bet)



PokerStars Game #59941022368:  Hold'em No Limit ($1/$2) - 2009/07/01 1:23:25 ET
Table 'LL4bDFyhj5hsMpzaDugJZg' 6-max Seat #3 is the button
Seat 1: FwvID/fQGlpY3soi/lMTww ($82.95 in chips)
Seat 2: IZng3w8jiJHHp3LbYKLi4w ($49.15 in chips)
Seat 3: iI/NMpRxMkGieArQEhACSA ($293.75 in chips)
Seat 4: 8srN1dKQePlsv0GyTada+Q ($310.75 in chips)
Seat 5: A2GTwTiwkb1ilNWgW487Vg ($68.80 in chips)
Seat 6: 692Q4sfB0gTElzS0WMeg+A ($208.10 in chips)
8srN1dKQePlsv0GyTada+Q: posts small blind $1
A2GTwTiwkb1ilNWgW487Vg: posts big blind $2
*** HOLE CARDS ***
692Q4sfB0gTElzS0WMeg+A: raises $4 to $6
FwvID/fQGlpY3soi/lMTww: folds
IZng3w8jiJHHp3LbYKLi4w: folds
iI/NMpRxMkGieArQEhACSA: folds
8srN1dKQePlsv0GyTada+Q: folds
A2GTwTiwkb1ilNWgW487Vg: folds
692Q4sfB0gTElzS0WMeg+A collected $5 from pot
*** SUMMARY ***
Total pot $5 | Rake $0
Seat 1: FwvID/fQGlpY3soi/lMTww folded before Flop (didn't bet)
Seat 2: IZng3w8jiJHHp3LbYKLi4w folded before Flop (didn't bet)
Seat 3: iI/NMpRxMkGieArQEhACSA (button) folded before Flop (didn't bet)
Seat 4: 8srN1dKQePlsv0GyTada+Q (small blind) folded before Flop
Seat 5: A2GTwTiwkb1ilNWgW487Vg (big blind) folded before Flop
Seat 6: 692Q4sfB0gTElzS0WMeg+A collected ($5)



PokerStars Game #59941023006:  Hold'em No Limit ($1/$2) - 2009/07/01 1:23:26 ET
Table 'ztv6V3FN2bQ9nmJPPdx6nQ' 6-max Seat #5 is the button
Seat 1: 6fLdOUCRtX71xbVRhJEq8w ($215 in chips)
Seat 2: 5Y+ZGWLI4gnlpApDX5vy1A ($408.25 in chips)
Seat 3: ubtx4Z5L+AcK71MTvYiGVw ($203 in chips)
Seat 4: UaZ5yj+6LjtWqMQg2QskUw ($115.80 in chips)
Seat 5: sTPOWERd9HWPCNrDBwsVjA ($251 in chips)
Seat 6: mfy7uGZcqA2PVQqEVbJ7+g ($118.45 in chips)
mfy7uGZcqA2PVQqEVbJ7+g: posts small blind $1
6fLdOUCRtX71xbVRhJEq8w: posts big blind $2
*** HOLE CARDS ***
5Y+ZGWLI4gnlpApDX5vy1A: folds
ubtx4Z5L+AcK71MTvYiGVw: folds
UaZ5yj+6LjtWqMQg2QskUw: folds
sTPOWERd9HWPCNrDBwsVjA: calls $2
mfy7uGZcqA2PVQqEVbJ7+g: folds
6fLdOUCRtX71xbVRhJEq8w: checks
*** FLOP *** [8h Ts Kh]
6fLdOUCRtX71xbVRhJEq8w: checks
sTPOWERd9HWPCNrDBwsVjA: bets $4
6fLdOUCRtX71xbVRhJEq8w: folds
sTPOWERd9HWPCNrDBwsVjA collected $4.75 from pot
*** SUMMARY ***
Total pot $5 | Rake $0.25
Board [8h Ts Kh]
Seat 1: 6fLdOUCRtX71xbVRhJEq8w (big blind) folded on the Flop
Seat 2: 5Y+ZGWLI4gnlpApDX5vy1A folded before Flop (didn't bet)
Seat 3: ubtx4Z5L+AcK71MTvYiGVw folded before Flop (didn't bet)
Seat 4: UaZ5yj+6LjtWqMQg2QskUw folded before Flop (didn't bet)
Seat 5: sTPOWERd9HWPCNrDBwsVjA (button) collected ($4.75)
Seat 6: mfy7uGZcqA2PVQqEVbJ7+g (small blind) folded before Flop



PokerStars Game #59941024290:  Hold'em No Limit ($1/$2) - 2009/07/01 1:23:28 ET
Table 'gnHBqWll9O3fxG7Ojkz/ng' 9-max Seat #7 is the button
Seat 1: TAfo4veNRaRlzDXMMYS3Jg ($37 in chips)
Seat 2: H6Z4+qu8gR0VUiPOijndVg ($343.25 in chips)
Seat 3: 5Q8U6iZbeO7xJSS4qvDP5g ($215 in chips)
Seat 5: rBQDMkKm9cZn6M9NPsiVew ($236.45 in chips)
Seat 6: /inIs/z/PcX+TniIFpaxpg ($46.75 in chips)
Seat 7: jqui3xAWCkcdPW36a6BD+w ($339.40 in chips)
Seat 8: cM6efHzdxoqYm0EQKP4TTQ ($102.05 in chips)
Seat 9: GX1heJ+DSsvm7gzSPsYhhQ ($40 in chips)
cM6efHzdxoqYm0EQKP4TTQ: posts small blind $1
GX1heJ+DSsvm7gzSPsYhhQ: posts big blind $2
nXDI8Y/S6POzRwANu3d8hQ: sits out
*** HOLE CARDS ***
TAfo4veNRaRlzDXMMYS3Jg: folds
H6Z4+qu8gR0VUiPOijndVg: folds
5Q8U6iZbeO7xJSS4qvDP5g: folds
rBQDMkKm9cZn6M9NPsiVew: folds
/inIs/z/PcX+TniIFpaxpg: folds
jqui3xAWCkcdPW36a6BD+w: calls $2
cM6efHzdxoqYm0EQKP4TTQ: calls $1
GX1heJ+DSsvm7gzSPsYhhQ: checks
*** FLOP *** [8d 9h Ks]
cM6efHzdxoqYm0EQKP4TTQ: checks
GX1heJ+DSsvm7gzSPsYhhQ: checks
jqui3xAWCkcdPW36a6BD+w: checks
*** TURN *** [8d 9h Ks] [Ad]
cM6efHzdxoqYm0EQKP4TTQ: checks
GX1heJ+DSsvm7gzSPsYhhQ: checks
jqui3xAWCkcdPW36a6BD+w: bets $2
cM6efHzdxoqYm0EQKP4TTQ: calls $2
GX1heJ+DSsvm7gzSPsYhhQ: folds
*** RIVER *** [8d 9h Ks Ad] [Ts]
cM6efHzdxoqYm0EQKP4TTQ: checks
jqui3xAWCkcdPW36a6BD+w: bets $4
cM6efHzdxoqYm0EQKP4TTQ: folds
jqui3xAWCkcdPW36a6BD+w collected $9.55 from pot
*** SUMMARY ***
Total pot $10 | Rake $0.45
Board [8d 9h Ks Ad Ts]
Seat 1: TAfo4veNRaRlzDXMMYS3Jg folded before Flop (didn't bet)
Seat 2: H6Z4+qu8gR0VUiPOijndVg folded before Flop (didn't bet)
Seat 3: 5Q8U6iZbeO7xJSS4qvDP5g folded before Flop (didn't bet)
Seat 5: rBQDMkKm9cZn6M9NPsiVew folded before Flop (didn't bet)
Seat 6: /inIs/z/PcX+TniIFpaxpg folded before Flop (didn't bet)
Seat 7: jqui3xAWCkcdPW36a6BD+w (button) collected ($9.55)
Seat 8: cM6efHzdxoqYm0EQKP4TTQ (small blind) folded on the River
Seat 9: GX1heJ+DSsvm7gzSPsYhhQ (big blind) folded on the Turn



PokerStars Game #59941026166:  Hold'em No Limit ($1/$2) - 2009/07/01 1:23:31 ET
Table 'ZzSIe0zTCDv+n6hfbY5tTg' 6-max Seat #6 is the button
Seat 1: VvdR9F3I+2yELkfTVvC1dg ($213.10 in chips)
Seat 2: B87ikIyZ/TzAVeXf38Ny0g ($237 in chips)
Seat 3: gsugPj31Hui3Jefl98MBOA ($204.65 in chips)
Seat 4: qXDd0ZyMIse0OBu8pxeQ3Q ($212.70 in chips)
Seat 5: 3dAbvkxS5NPQTBAbvpinVg ($483.30 in chips)
Seat 6: 09BNF4quPDzanQzM8vc6WA ($22.50 in chips)
VvdR9F3I+2yELkfTVvC1dg: posts small blind $1
B87ikIyZ/TzAVeXf38Ny0g: posts big blind $2
*** HOLE CARDS ***
gsugPj31Hui3Jefl98MBOA: folds
qXDd0ZyMIse0OBu8pxeQ3Q: folds
3dAbvkxS5NPQTBAbvpinVg: folds
09BNF4quPDzanQzM8vc6WA: raises $2 to $4
VvdR9F3I+2yELkfTVvC1dg: folds
B87ikIyZ/TzAVeXf38Ny0g: raises $233 to $237 and is all-in
09BNF4quPDzanQzM8vc6WA: folds
B87ikIyZ/TzAVeXf38Ny0g collected $9 from pot
B87ikIyZ/TzAVeXf38Ny0g: doesn't show hand
*** SUMMARY ***
Total pot $9 | Rake $0
Seat 1: VvdR9F3I+2yELkfTVvC1dg (small blind) folded before Flop
Seat 2: B87ikIyZ/TzAVeXf38Ny0g (big blind) collected ($9)
Seat 3: gsugPj31Hui3Jefl98MBOA folded before Flop (didn't bet)
Seat 4: qXDd0ZyMIse0OBu8pxeQ3Q folded before Flop (didn't bet)
Seat 5: 3dAbvkxS5NPQTBAbvpinVg folded before Flop (didn't bet)
Seat 6: 09BNF4quPDzanQzM8vc6WA (button) folded before Flop



PokerStars Game #59941025650:  Hold'em No Limit ($1/$2) - 2009/07/01 1:23:31 ET
Table 'kq5zaQ+1hLNf8LZfGnbTAA' 6-max Seat #1 is the button
Seat 1: 8srN1dKQePlsv0GyTada+Q ($242.20 in chips)
Seat 2: nXDI8Y/S6POzRwANu3d8hQ ($61.80 in chips)
Seat 3: vkfxu8f/jMYKUk6Ly4eujw ($227.95 in chips)
Seat 4: 3dAbvkxS5NPQTBAbvpinVg ($200 in chips)
Seat 5: kfASJqTbXek+zc8ZKsZL1Q ($140.75 in chips)
Seat 6: mfy7uGZcqA2PVQqEVbJ7+g ($191.25 in chips)
nXDI8Y/S6POzRwANu3d8hQ: posts small blind $1
vkfxu8f/jMYKUk6Ly4eujw: posts big blind $2
*** HOLE CARDS ***
3dAbvkxS5NPQTBAbvpinVg: folds
kfASJqTbXek+zc8ZKsZL1Q: folds
mfy7uGZcqA2PVQqEVbJ7+g: folds
8srN1dKQePlsv0GyTada+Q: raises $3 to $5
nXDI8Y/S6POzRwANu3d8hQ: raises $15 to $20
vkfxu8f/jMYKUk6Ly4eujw: folds
8srN1dKQePlsv0GyTada+Q: folds
nXDI8Y/S6POzRwANu3d8hQ collected $12 from pot
nXDI8Y/S6POzRwANu3d8hQ: doesn't show hand
*** SUMMARY ***
Total pot $12 | Rake $0
Seat 1: 8srN1dKQePlsv0GyTada+Q (button) folded before Flop
Seat 2: nXDI8Y/S6POzRwANu3d8hQ (small blind) collected ($12)
Seat 3: vkfxu8f/jMYKUk6Ly4eujw (big blind) folded before Flop
Seat 4: 3dAbvkxS5NPQTBAbvpinVg folded before Flop (didn't bet)
Seat 5: kfASJqTbXek+zc8ZKsZL1Q folded before Flop (didn't bet)
Seat 6: mfy7uGZcqA2PVQqEVbJ7+g folded before Flop (didn't bet)



PokerStars Game #59941027824:  Hold'em No Limit ($1/$2) - 2009/07/01 1:23:34 ET
Table 'CFkQcfWjKccZaZDf71FK+w' 6-max Seat #3 is the button
Seat 1: JsC+WvfzqlxVs9G8/gSQAQ ($25.05 in chips)
Seat 2: ewN/vzF22+/gdzjIKBOlkA ($232.20 in chips)
Seat 3: 09BNF4quPDzanQzM8vc6WA ($24 in chips)
Seat 4: ygTTt5ehT4aF86q1a8/R+w ($193.75 in chips)
Seat 5: 2lOU1DcvUZaMcxZ95XfzXw ($100 in chips)
Seat 6: ORVqY3rf9X6ANA/8s+On2Q ($102.50 in chips)
ygTTt5ehT4aF86q1a8/R+w: posts small blind $1
2lOU1DcvUZaMcxZ95XfzXw: posts big blind $2
*** HOLE CARDS ***
ORVqY3rf9X6ANA/8s+On2Q: calls $2
JsC+WvfzqlxVs9G8/gSQAQ: folds
ewN/vzF22+/gdzjIKBOlkA: raises $6 to $8
09BNF4quPDzanQzM8vc6WA: folds
ygTTt5ehT4aF86q1a8/R+w: folds
2lOU1DcvUZaMcxZ95XfzXw: calls $6
ORVqY3rf9X6ANA/8s+On2Q: calls $6
*** FLOP *** [Js Qc Ac]
2lOU1DcvUZaMcxZ95XfzXw: checks
ORVqY3rf9X6ANA/8s+On2Q: checks
ewN/vzF22+/gdzjIKBOlkA: checks
*** TURN *** [Js Qc Ac] [8h]
2lOU1DcvUZaMcxZ95XfzXw: checks
ORVqY3rf9X6ANA/8s+On2Q: checks
ewN/vzF22+/gdzjIKBOlkA: bets $16
2lOU1DcvUZaMcxZ95XfzXw: calls $16
ORVqY3rf9X6ANA/8s+On2Q: calls $16
*** RIVER *** [Js Qc Ac 8h] [Kd]
2lOU1DcvUZaMcxZ95XfzXw: bets $28
ORVqY3rf9X6ANA/8s+On2Q: folds
ewN/vzF22+/gdzjIKBOlkA: folds
2lOU1DcvUZaMcxZ95XfzXw collected $70 from pot
*** SUMMARY ***
Total pot $73 | Rake $3
Board [Js Qc Ac 8h Kd]
Seat 1: JsC+WvfzqlxVs9G8/gSQAQ folded before Flop (didn't bet)
Seat 2: ewN/vzF22+/gdzjIKBOlkA folded on the River
Seat 3: 09BNF4quPDzanQzM8vc6WA (button) folded before Flop (didn't bet)
Seat 4: ygTTt5ehT4aF86q1a8/R+w (small blind) folded before Flop
Seat 5: 2lOU1DcvUZaMcxZ95XfzXw (big blind) collected ($70)
Seat 6: ORVqY3rf9X6ANA/8s+On2Q folded on the River



PokerStars Game #59941027464:  Hold'em No Limit ($1/$2) - 2009/07/01 1:23:34 ET
Table 'W9UeSV0aoPjh5SFSxM8jUQ' 9-max Seat #1 is the button
Seat 1: mIKx5lhIt13X5eZQH0ZeMA ($25 in chips)
Seat 2: iMe5yhc+1BaiIPHet3NMrA ($253.60 in chips)
Seat 3: /inIs/z/PcX+TniIFpaxpg ($25 in chips)
Seat 5: ri8CLkX3e9JF34dQNbsHGA ($42.45 in chips)
Seat 6: j47DM+lqTfzZP8musviQTg ($110.90 in chips)
Seat 7: I2ipWauytvrkEer4XD3Sjg ($100 in chips)
Seat 8: odhvI/CZeMsPyo1n1U7+hA ($49.70 in chips)
Seat 9: Q104K4iDGcqOlVrjAkzPEA ($98.10 in chips)
iMe5yhc+1BaiIPHet3NMrA: posts small blind $1
/inIs/z/PcX+TniIFpaxpg: posts big blind $2
4YA/sQy1Emm680zhbPUjow: sits out
*** HOLE CARDS ***
ri8CLkX3e9JF34dQNbsHGA: folds
j47DM+lqTfzZP8musviQTg: folds
I2ipWauytvrkEer4XD3Sjg: folds
odhvI/CZeMsPyo1n1U7+hA: folds
Q104K4iDGcqOlVrjAkzPEA: folds
mIKx5lhIt13X5eZQH0ZeMA: folds
iMe5yhc+1BaiIPHet3NMrA: folds
/inIs/z/PcX+TniIFpaxpg collected $2 from pot
*** SUMMARY ***
Total pot $2 | Rake $0
Seat 1: mIKx5lhIt13X5eZQH0ZeMA (button) folded before Flop (didn't bet)
Seat 2: iMe5yhc+1BaiIPHet3NMrA (small blind) folded before Flop
Seat 3: /inIs/z/PcX+TniIFpaxpg (big blind) collected ($2)
Seat 5: ri8CLkX3e9JF34dQNbsHGA folded before Flop (didn't bet)
Seat 6: j47DM+lqTfzZP8musviQTg folded before Flop (didn't bet)
Seat 7: I2ipWauytvrkEer4XD3Sjg folded before Flop (didn't bet)
Seat 8: odhvI/CZeMsPyo1n1U7+hA folded before Flop (didn't bet)
Seat 9: Q104K4iDGcqOlVrjAkzPEA folded before Flop (didn't bet)



PokerStars Game #59941028108:  Hold'em No Limit ($1/$2) - 2009/07/01 1:23:35 ET
Table 'aSf77Sj8QEnzcc0WaxVD4Q' 6-max Seat #2 is the button
Seat 1: UELtvp+JfwI7XDGVwSxZXA ($165.75 in chips)
Seat 2: vkfxu8f/jMYKUk6Ly4eujw ($42.20 in chips)
Seat 3: 9dpyyjDTCed6nV7JhaUUpw ($521.35 in chips)
Seat 4: YsLQ3BAvgQHWXMAv3Wv6Hg ($265.70 in chips)
Seat 5: VvdR9F3I+2yELkfTVvC1dg ($245 in chips)
Seat 6: vkoJRf3gidxY1pPi0AFWww ($120 in chips)
9dpyyjDTCed6nV7JhaUUpw: posts small blind $1
YsLQ3BAvgQHWXMAv3Wv6Hg: posts big blind $2
*** HOLE CARDS ***
VvdR9F3I+2yELkfTVvC1dg: folds
vkoJRf3gidxY1pPi0AFWww: calls $2
UELtvp+JfwI7XDGVwSxZXA: folds
vkfxu8f/jMYKUk6Ly4eujw: folds
9dpyyjDTCed6nV7JhaUUpw: folds
YsLQ3BAvgQHWXMAv3Wv6Hg: checks
*** FLOP *** [5c 9h Ah]
YsLQ3BAvgQHWXMAv3Wv6Hg: checks
vkoJRf3gidxY1pPi0AFWww: checks
*** TURN *** [5c 9h Ah] [7h]
YsLQ3BAvgQHWXMAv3Wv6Hg: checks
vkoJRf3gidxY1pPi0AFWww: checks
*** RIVER *** [5c 9h Ah 7h] [6h]
YsLQ3BAvgQHWXMAv3Wv6Hg: checks
vkoJRf3gidxY1pPi0AFWww: checks
*** SHOW DOWN ***
YsLQ3BAvgQHWXMAv3Wv6Hg: shows [6c 9c] (two pair, Nines and Sixes)
vkoJRf3gidxY1pPi0AFWww: shows [Ks 8d] (a straight, Five to Nine)
vkoJRf3gidxY1pPi0AFWww collected $4.75 from pot
*** SUMMARY ***
Total pot $5 | Rake $0.25
Board [5c 9h Ah 7h 6h]
Seat 1: UELtvp+JfwI7XDGVwSxZXA folded before Flop (didn't bet)
Seat 2: vkfxu8f/jMYKUk6Ly4eujw (button) folded before Flop (didn't bet)
Seat 3: 9dpyyjDTCed6nV7JhaUUpw (small blind) folded before Flop
Seat 4: YsLQ3BAvgQHWXMAv3Wv6Hg (big blind) showed [6c 9c] and lost with two pair, Nines and Sixes
Seat 5: VvdR9F3I+2yELkfTVvC1dg folded before Flop (didn't bet)
Seat 6: vkoJRf3gidxY1pPi0AFWww showed [Ks 8d] and won ($4.75) with a straight, Five to Nine



PokerStars Game #59941030228:  Hold'em No Limit ($1/$2) - 2009/07/01 1:23:38 ET
Table '3WCXyaiCAbqSShQu7FIjvA' 9-max Seat #8 is the button
Seat 1: kTCkABD1UUldS9DFRGfCwQ ($151.60 in chips)
Seat 2: 1zQMh8lHgW3t2YhVeA+09A ($8.80 in chips)
Seat 3: 5Q8U6iZbeO7xJSS4qvDP5g ($200 in chips)
Seat 4: waEF/+pxZTxNo4FvsORuXg ($77 in chips)
Seat 5: CkE3IyJF1KvdaAOmZY5XqQ ($200 in chips)
Seat 6: 5jQlngvMSqM/WoonOcR5kw ($281.45 in chips)
Seat 8: 1CtiZuXDFaJL1dJPQKyi8Q ($242.35 in chips)
Seat 9: FiXPLJyqb24l32QST2TInw ($167.40 in chips)
FiXPLJyqb24l32QST2TInw: posts small blind $1
kTCkABD1UUldS9DFRGfCwQ: posts big blind $2
*** HOLE CARDS ***
1zQMh8lHgW3t2YhVeA+09A: folds
5Q8U6iZbeO7xJSS4qvDP5g: folds
waEF/+pxZTxNo4FvsORuXg: folds
CkE3IyJF1KvdaAOmZY5XqQ: folds
5jQlngvMSqM/WoonOcR5kw: calls $2
1CtiZuXDFaJL1dJPQKyi8Q: folds
FiXPLJyqb24l32QST2TInw: calls $1
kTCkABD1UUldS9DFRGfCwQ: checks
*** FLOP *** [Ah 3c Ad]
FiXPLJyqb24l32QST2TInw: checks
kTCkABD1UUldS9DFRGfCwQ: checks
5jQlngvMSqM/WoonOcR5kw: checks
*** TURN *** [Ah 3c Ad] [3d]
FiXPLJyqb24l32QST2TInw: checks
kTCkABD1UUldS9DFRGfCwQ: checks
5jQlngvMSqM/WoonOcR5kw: checks
*** RIVER *** [Ah 3c Ad 3d] [Qh]
FiXPLJyqb24l32QST2TInw: bets $4
kTCkABD1UUldS9DFRGfCwQ: folds
5jQlngvMSqM/WoonOcR5kw: raises $8 to $12
FiXPLJyqb24l32QST2TInw: calls $8
*** SHOW DOWN ***
5jQlngvMSqM/WoonOcR5kw: shows [7s Ac] (a full house, Aces full of Threes)
FiXPLJyqb24l32QST2TInw: mucks hand
5jQlngvMSqM/WoonOcR5kw collected $28.55 from pot
*** SUMMARY ***
Total pot $30 | Rake $1.45
Board [Ah 3c Ad 3d Qh]
Seat 1: kTCkABD1UUldS9DFRGfCwQ (big blind) folded on the River
Seat 2: 1zQMh8lHgW3t2YhVeA+09A folded before Flop (didn't bet)
Seat 3: 5Q8U6iZbeO7xJSS4qvDP5g folded before Flop (didn't bet)
Seat 4: waEF/+pxZTxNo4FvsORuXg folded before Flop (didn't bet)
Seat 5: CkE3IyJF1KvdaAOmZY5XqQ folded before Flop (didn't bet)
Seat 6: 5jQlngvMSqM/WoonOcR5kw showed [7s Ac] and won ($28.55) with a full house, Aces full of Threes
Seat 8: 1CtiZuXDFaJL1dJPQKyi8Q (button) folded before Flop (didn't bet)
Seat 9: FiXPLJyqb24l32QST2TInw (small blind) mucked



PokerStars Game #59941030604:  Hold'em No Limit ($1/$2) - 2009/07/01 1:23:39 ET
Table 'bIihwBANJSFqlHPPtset+w' 9-max Seat #2 is the button
Seat 1: /inIs/z/PcX+TniIFpaxpg ($30 in chips)
Seat 2: lQYT23h5QCUVZAKxjOO39Q ($180.75 in chips)
Seat 3: +T/63sAeZzWyHchahJ36GQ ($44 in chips)
Seat 4: ri8CLkX3e9JF34dQNbsHGA ($42.40 in chips)
Seat 5: vxbbJLsS1bva6tW2NiFssg ($200 in chips)
Seat 6: CkE3IyJF1KvdaAOmZY5XqQ ($186 in chips)
Seat 7: pCmk6FpSOLJ+85o1tLHIag ($130.45 in chips)
Seat 8: iMe5yhc+1BaiIPHet3NMrA ($200.50 in chips)
Seat 9: qn8LDoUFphcG4+r+F+Vhrg ($182 in chips)
+T/63sAeZzWyHchahJ36GQ: posts small blind $1
ri8CLkX3e9JF34dQNbsHGA: posts big blind $2
*** HOLE CARDS ***
vxbbJLsS1bva6tW2NiFssg: folds
CkE3IyJF1KvdaAOmZY5XqQ: folds
pCmk6FpSOLJ+85o1tLHIag: raises $4 to $6
iMe5yhc+1BaiIPHet3NMrA: folds
qn8LDoUFphcG4+r+F+Vhrg: calls $6
/inIs/z/PcX+TniIFpaxpg: folds
lQYT23h5QCUVZAKxjOO39Q: folds
+T/63sAeZzWyHchahJ36GQ: folds
ri8CLkX3e9JF34dQNbsHGA: folds
*** FLOP *** [Js Tc Jc]
pCmk6FpSOLJ+85o1tLHIag: checks
qn8LDoUFphcG4+r+F+Vhrg: checks
*** TURN *** [Js Tc Jc] [6s]
pCmk6FpSOLJ+85o1tLHIag: bets $8
qn8LDoUFphcG4+r+F+Vhrg: calls $8
*** RIVER *** [Js Tc Jc 6s] [3s]
pCmk6FpSOLJ+85o1tLHIag: checks
qn8LDoUFphcG4+r+F+Vhrg: checks
*** SHOW DOWN ***
pCmk6FpSOLJ+85o1tLHIag: shows [6h 7h] (two pair, Jacks and Sixes)
qn8LDoUFphcG4+r+F+Vhrg: mucks hand
pCmk6FpSOLJ+85o1tLHIag collected $29.50 from pot
*** SUMMARY ***
Total pot $31 | Rake $1.50
Board [Js Tc Jc 6s 3s]
Seat 1: /inIs/z/PcX+TniIFpaxpg folded before Flop (didn't bet)
Seat 2: lQYT23h5QCUVZAKxjOO39Q (button) folded before Flop (didn't bet)
Seat 3: +T/63sAeZzWyHchahJ36GQ (small blind) folded before Flop
Seat 4: ri8CLkX3e9JF34dQNbsHGA (big blind) folded before Flop
Seat 5: vxbbJLsS1bva6tW2NiFssg folded before Flop (didn't bet)
Seat 6: CkE3IyJF1KvdaAOmZY5XqQ folded before Flop (didn't bet)
Seat 7: pCmk6FpSOLJ+85o1tLHIag showed [6h 7h] and won ($29.50) with two pair, Jacks and Sixes
Seat 8: iMe5yhc+1BaiIPHet3NMrA folded before Flop (didn't bet)
Seat 9: qn8LDoUFphcG4+r+F+Vhrg mucked



PokerStars Game #59941031084:  Hold'em No Limit ($1/$2) - 2009/07/01 1:23:40 ET
Table 'pPQgcj9XT9CHBsbo1WTBug' 6-max Seat #5 is the button
Seat 1: DFVYDA6dKQy7R7mGIKogZA ($128.65 in chips)
Seat 2: qXDd0ZyMIse0OBu8pxeQ3Q ($215.30 in chips)
Seat 3: 54yWzRRgS0oZ+S6LwZBxMQ ($48.95 in chips)
Seat 4: gqlysXCbT8V54f/1lf9h3A ($24.55 in chips)
Seat 5: vkfxu8f/jMYKUk6Ly4eujw ($228.10 in chips)
Seat 6: Yr7pZltpy3IUNdKS9PCEiw ($305.30 in chips)
Yr7pZltpy3IUNdKS9PCEiw: posts small blind $1
DFVYDA6dKQy7R7mGIKogZA: posts big blind $2
*** HOLE CARDS ***
qXDd0ZyMIse0OBu8pxeQ3Q: raises $5 to $7
54yWzRRgS0oZ+S6LwZBxMQ: calls $7
gqlysXCbT8V54f/1lf9h3A: calls $7
vkfxu8f/jMYKUk6Ly4eujw: folds
Yr7pZltpy3IUNdKS9PCEiw: folds
DFVYDA6dKQy7R7mGIKogZA: folds
*** FLOP *** [Js 9c 8h]
qXDd0ZyMIse0OBu8pxeQ3Q: checks
54yWzRRgS0oZ+S6LwZBxMQ: checks
gqlysXCbT8V54f/1lf9h3A: checks
*** TURN *** [Js 9c 8h] [4d]
qXDd0ZyMIse0OBu8pxeQ3Q: checks
54yWzRRgS0oZ+S6LwZBxMQ: bets $6
gqlysXCbT8V54f/1lf9h3A: folds
qXDd0ZyMIse0OBu8pxeQ3Q: folds
54yWzRRgS0oZ+S6LwZBxMQ collected $22.80 from pot
54yWzRRgS0oZ+S6LwZBxMQ: doesn't show hand
*** SUMMARY ***
Total pot $24 | Rake $1.20
Board [Js 9c 8h 4d]
Seat 1: DFVYDA6dKQy7R7mGIKogZA (big blind) folded before Flop
Seat 2: qXDd0ZyMIse0OBu8pxeQ3Q folded on the Turn
Seat 3: 54yWzRRgS0oZ+S6LwZBxMQ collected ($22.80)
Seat 4: gqlysXCbT8V54f/1lf9h3A folded on the Turn
Seat 5: vkfxu8f/jMYKUk6Ly4eujw (button) folded before Flop (didn't bet)
Seat 6: Yr7pZltpy3IUNdKS9PCEiw (small blind) folded before Flop



PokerStars Game #59941030890:  Hold'em No Limit ($1/$2) - 2009/07/01 1:23:40 ET
Table 'AtOXMvcrtQM8yLNcALmfLQ' 2-max Seat #1 is the button
Seat 1: +HlQuAsMqZGYYtjcPO/a3A ($135.90 in chips)
Seat 2: pVqEzK9wXlRMECnb1Zg4Zw ($260.80 in chips)
+HlQuAsMqZGYYtjcPO/a3A: posts small blind $1
pVqEzK9wXlRMECnb1Zg4Zw: posts big blind $2
*** HOLE CARDS ***
+HlQuAsMqZGYYtjcPO/a3A: calls $1
pVqEzK9wXlRMECnb1Zg4Zw: raises $10 to $12
+HlQuAsMqZGYYtjcPO/a3A: calls $10
*** FLOP *** [Ks Ah Qh]
pVqEzK9wXlRMECnb1Zg4Zw: bets $14
+HlQuAsMqZGYYtjcPO/a3A: folds
pVqEzK9wXlRMECnb1Zg4Zw collected $23.50 from pot
pVqEzK9wXlRMECnb1Zg4Zw: doesn't show hand
*** SUMMARY ***
Total pot $24 | Rake $0.50
Board [Ks Ah Qh]
Seat 1: +HlQuAsMqZGYYtjcPO/a3A (button) (small blind) folded on the Flop
Seat 2: pVqEzK9wXlRMECnb1Zg4Zw (big blind) collected ($23.50)



PokerStars Game #59941031606:  Hold'em No Limit ($1/$2) - 2009/07/01 1:23:41 ET
Table 'uJ9juaXXg9yIcSU8amxaXQ' 6-max Seat #1 is the button
Seat 1: JsqOjN/eHz0uYVf/PyUJ6Q ($148.85 in chips)
Seat 2: VvdR9F3I+2yELkfTVvC1dg ($200 in chips)
Seat 3: qXDd0ZyMIse0OBu8pxeQ3Q ($256 in chips)
Seat 4: zNjJ/y4emmF+vzrCDd+ooA ($217.75 in chips)
Seat 5: YsLQ3BAvgQHWXMAv3Wv6Hg ($202 in chips)
Seat 6: 2DFp9Veq1xxq64dCjwNuUw ($52.60 in chips)
VvdR9F3I+2yELkfTVvC1dg: posts small blind $1
qXDd0ZyMIse0OBu8pxeQ3Q: posts big blind $2
*** HOLE CARDS ***
zNjJ/y4emmF+vzrCDd+ooA: folds
YsLQ3BAvgQHWXMAv3Wv6Hg: folds
2DFp9Veq1xxq64dCjwNuUw: raises $4 to $6
JsqOjN/eHz0uYVf/PyUJ6Q: folds
VvdR9F3I+2yELkfTVvC1dg: folds
qXDd0ZyMIse0OBu8pxeQ3Q: folds
2DFp9Veq1xxq64dCjwNuUw collected $5 from pot
2DFp9Veq1xxq64dCjwNuUw: doesn't show hand
*** SUMMARY ***
Total pot $5 | Rake $0
Seat 1: JsqOjN/eHz0uYVf/PyUJ6Q (button) folded before Flop (didn't bet)
Seat 2: VvdR9F3I+2yELkfTVvC1dg (small blind) folded before Flop
Seat 3: qXDd0ZyMIse0OBu8pxeQ3Q (big blind) folded before Flop
Seat 4: zNjJ/y4emmF+vzrCDd+ooA folded before Flop (didn't bet)
Seat 5: YsLQ3BAvgQHWXMAv3Wv6Hg folded before Flop (didn't bet)
Seat 6: 2DFp9Veq1xxq64dCjwNuUw collected ($5)



PokerStars Game #59941032608:  Hold'em No Limit ($1/$2) - 2009/07/01 1:23:42 ET
Table 'jlrIxbrVIG+gjaUYT4za8g' 6-max Seat #5 is the button
Seat 1: ygTTt5ehT4aF86q1a8/R+w ($264.30 in chips)
Seat 2: on4ebXPJvUBOcHOBMQsRSg ($64 in chips)
Seat 3: RUZs7P4uzWavoA6iEpDKLw ($96.75 in chips)
Seat 4: 8srN1dKQePlsv0GyTada+Q ($300.35 in chips)
Seat 5: AyBB0k3Dcl7xbXUeGMw06g ($67.20 in chips)
Seat 6: vkfxu8f/jMYKUk6Ly4eujw ($336 in chips)
vkfxu8f/jMYKUk6Ly4eujw: posts small blind $1
ygTTt5ehT4aF86q1a8/R+w: posts big blind $2
*** HOLE CARDS ***
on4ebXPJvUBOcHOBMQsRSg: calls $2
RUZs7P4uzWavoA6iEpDKLw: calls $2
8srN1dKQePlsv0GyTada+Q: calls $2
AyBB0k3Dcl7xbXUeGMw06g: calls $2
vkfxu8f/jMYKUk6Ly4eujw: calls $1
ygTTt5ehT4aF86q1a8/R+w: checks
*** FLOP *** [Jd 4d 2s]
vkfxu8f/jMYKUk6Ly4eujw: checks
ygTTt5ehT4aF86q1a8/R+w: checks
on4ebXPJvUBOcHOBMQsRSg: checks
RUZs7P4uzWavoA6iEpDKLw: checks
8srN1dKQePlsv0GyTada+Q: checks
AyBB0k3Dcl7xbXUeGMw06g: bets $6
vkfxu8f/jMYKUk6Ly4eujw: calls $6
ygTTt5ehT4aF86q1a8/R+w: folds
on4ebXPJvUBOcHOBMQsRSg: folds
RUZs7P4uzWavoA6iEpDKLw: folds
8srN1dKQePlsv0GyTada+Q: folds
*** TURN *** [Jd 4d 2s] [7d]
vkfxu8f/jMYKUk6Ly4eujw: checks
AyBB0k3Dcl7xbXUeGMw06g: bets $12
vkfxu8f/jMYKUk6Ly4eujw: calls $12
*** RIVER *** [Jd 4d 2s 7d] [Td]
vkfxu8f/jMYKUk6Ly4eujw: checks
AyBB0k3Dcl7xbXUeGMw06g: checks
*** SHOW DOWN ***
vkfxu8f/jMYKUk6Ly4eujw: shows [9h Jh] (a pair of Jacks)
AyBB0k3Dcl7xbXUeGMw06g: shows [3d 2d] (a flush, Jack high)
AyBB0k3Dcl7xbXUeGMw06g collected $45.70 from pot
*** SUMMARY ***
Total pot $48 | Rake $2.30
Board [Jd 4d 2s 7d Td]
Seat 1: ygTTt5ehT4aF86q1a8/R+w (big blind) folded on the Flop
Seat 2: on4ebXPJvUBOcHOBMQsRSg folded on the Flop
Seat 3: RUZs7P4uzWavoA6iEpDKLw folded on the Flop
Seat 4: 8srN1dKQePlsv0GyTada+Q folded on the Flop
Seat 5: AyBB0k3Dcl7xbXUeGMw06g (button) showed [3d 2d] and won ($45.70) with a flush, Jack high
Seat 6: vkfxu8f/jMYKUk6Ly4eujw (small blind) showed [9h Jh] and lost with a pair of Jacks



PokerStars Game #59941032718:  Hold'em No Limit ($1/$2) - 2009/07/01 1:23:43 ET
Table 'mGpP9StWRnoeiBDExc6Frg' 6-max Seat #5 is the button
Seat 1: VvdR9F3I+2yELkfTVvC1dg ($200 in chips)
Seat 2: dZcLsEI8iXkobBduRJ45Yw ($59.50 in chips)
Seat 3: 7acrZUQC3Zc9BNLjoKIcLQ ($45.35 in chips)
Seat 4: 4dcDwIHRm96PwtqkpQiuiA ($87.70 in chips)
Seat 5: d1puGuVBE0fidn+5eRJ0tw ($171.85 in chips)
Seat 6: B2Ih1sr5VZk+8He7rcrMtQ ($468.05 in chips)
B2Ih1sr5VZk+8He7rcrMtQ: posts small blind $1
VvdR9F3I+2yELkfTVvC1dg: posts big blind $2
*** HOLE CARDS ***
dZcLsEI8iXkobBduRJ45Yw: calls $2
7acrZUQC3Zc9BNLjoKIcLQ: folds
4dcDwIHRm96PwtqkpQiuiA: folds
d1puGuVBE0fidn+5eRJ0tw: folds
B2Ih1sr5VZk+8He7rcrMtQ: calls $1
VvdR9F3I+2yELkfTVvC1dg: checks
*** FLOP *** [Ad Qs Ks]
B2Ih1sr5VZk+8He7rcrMtQ: checks
VvdR9F3I+2yELkfTVvC1dg: bets $4.25
dZcLsEI8iXkobBduRJ45Yw: calls $4.25
B2Ih1sr5VZk+8He7rcrMtQ: folds
*** TURN *** [Ad Qs Ks] [8s]
VvdR9F3I+2yELkfTVvC1dg: bets $10.05
dZcLsEI8iXkobBduRJ45Yw: calls $10.05
*** RIVER *** [Ad Qs Ks 8s] [5s]
VvdR9F3I+2yELkfTVvC1dg: checks
dZcLsEI8iXkobBduRJ45Yw: bets $20
VvdR9F3I+2yELkfTVvC1dg: folds
dZcLsEI8iXkobBduRJ45Yw collected $32.95 from pot
*** SUMMARY ***
Total pot $34.60 | Rake $1.65
Board [Ad Qs Ks 8s 5s]
Seat 1: VvdR9F3I+2yELkfTVvC1dg (big blind) folded on the River
Seat 2: dZcLsEI8iXkobBduRJ45Yw collected ($32.95)
Seat 3: 7acrZUQC3Zc9BNLjoKIcLQ folded before Flop (didn't bet)
Seat 4: 4dcDwIHRm96PwtqkpQiuiA folded before Flop (didn't bet)
Seat 5: d1puGuVBE0fidn+5eRJ0tw (button) folded before Flop (didn't bet)
Seat 6: B2Ih1sr5VZk+8He7rcrMtQ (small blind) folded on the Flop



PokerStars Game #59941033064:  Hold'em No Limit ($1/$2) - 2009/07/01 1:23:43 ET
Table 'YqGfR5eHfMeSjb9a+QU9rg' 9-max Seat #2 is the button
Seat 1: rW/MyplHylMSBRaoRUzWrg ($34 in chips)
Seat 2: W3Nqt1GWlTi9tXQXMNEvgw ($383.50 in chips)
Seat 3: /gll27k+xWYV7Fbki0lFDQ ($268.75 in chips)
Seat 5: CkE3IyJF1KvdaAOmZY5XqQ ($200 in chips)
Seat 6: TAfo4veNRaRlzDXMMYS3Jg ($37 in chips)
Seat 7: 41aZuLBz9nAi2GPVKabmCw ($96.50 in chips)
Seat 8: JnV3SM2D6dAFYyGZHHpvrg ($101.25 in chips)
Seat 9: /inIs/z/PcX+TniIFpaxpg ($206.05 in chips)
/gll27k+xWYV7Fbki0lFDQ: posts small blind $1
CkE3IyJF1KvdaAOmZY5XqQ: posts big blind $2
*** HOLE CARDS ***
TAfo4veNRaRlzDXMMYS3Jg: folds
41aZuLBz9nAi2GPVKabmCw: folds
JnV3SM2D6dAFYyGZHHpvrg: folds
/inIs/z/PcX+TniIFpaxpg: folds
rW/MyplHylMSBRaoRUzWrg: folds
W3Nqt1GWlTi9tXQXMNEvgw: calls $2
/gll27k+xWYV7Fbki0lFDQ: folds
CkE3IyJF1KvdaAOmZY5XqQ: checks
*** FLOP *** [Kc 7h Tc]
CkE3IyJF1KvdaAOmZY5XqQ: checks
W3Nqt1GWlTi9tXQXMNEvgw: bets $4
CkE3IyJF1KvdaAOmZY5XqQ: folds
W3Nqt1GWlTi9tXQXMNEvgw collected $4.75 from pot
W3Nqt1GWlTi9tXQXMNEvgw: doesn't show hand
*** SUMMARY ***
Total pot $5 | Rake $0.25
Board [Kc 7h Tc]
Seat 1: rW/MyplHylMSBRaoRUzWrg folded before Flop (didn't bet)
Seat 2: W3Nqt1GWlTi9tXQXMNEvgw (button) collected ($4.75)
Seat 3: /gll27k+xWYV7Fbki0lFDQ (small blind) folded before Flop
Seat 5: CkE3IyJF1KvdaAOmZY5XqQ (big blind) folded on the Flop
Seat 6: TAfo4veNRaRlzDXMMYS3Jg folded before Flop (didn't bet)
Seat 7: 41aZuLBz9nAi2GPVKabmCw folded before Flop (didn't bet)
Seat 8: JnV3SM2D6dAFYyGZHHpvrg folded before Flop (didn't bet)
Seat 9: /inIs/z/PcX+TniIFpaxpg folded before Flop (didn't bet)



PokerStars Game #59941033676:  Hold'em No Limit ($1/$2) - 2009/07/01 1:23:44 ET
Table '4NGNnZ/osQfNq6abYqkJeA' 6-max Seat #5 is the button
Seat 1: 7zM38baFvmCNB/F80oE0cQ ($52.30 in chips)
Seat 2: 669iGNwYwgRZg3nhS+aDAQ ($93.15 in chips)
Seat 3: 54yWzRRgS0oZ+S6LwZBxMQ ($23.75 in chips)
Seat 4: sY+4Uuh5z/6AbXXaCS10jw ($214.35 in chips)
Seat 5: VvdR9F3I+2yELkfTVvC1dg ($234.80 in chips)
Seat 6: kkgpegLoQkmL6LIsFsvtiQ ($267.65 in chips)
kkgpegLoQkmL6LIsFsvtiQ: posts small blind $1
7zM38baFvmCNB/F80oE0cQ: posts big blind $2
*** HOLE CARDS ***
669iGNwYwgRZg3nhS+aDAQ: raises $6 to $8
54yWzRRgS0oZ+S6LwZBxMQ: folds
sY+4Uuh5z/6AbXXaCS10jw: folds
VvdR9F3I+2yELkfTVvC1dg: folds
kkgpegLoQkmL6LIsFsvtiQ: folds
7zM38baFvmCNB/F80oE0cQ: folds
669iGNwYwgRZg3nhS+aDAQ collected $5 from pot
*** SUMMARY ***
Total pot $5 | Rake $0
Seat 1: 7zM38baFvmCNB/F80oE0cQ (big blind) folded before Flop
Seat 2: 669iGNwYwgRZg3nhS+aDAQ collected ($5)
Seat 3: 54yWzRRgS0oZ+S6LwZBxMQ folded before Flop (didn't bet)
Seat 4: sY+4Uuh5z/6AbXXaCS10jw folded before Flop (didn't bet)
Seat 5: VvdR9F3I+2yELkfTVvC1dg (button) folded before Flop (didn't bet)
Seat 6: kkgpegLoQkmL6LIsFsvtiQ (small blind) folded before Flop



PokerStars Game #59941033270:  Hold'em No Limit ($1/$2) - 2009/07/01 1:23:44 ET
Table 'eyAQSIlgc2o1Jxvbve4WGg' 9-max Seat #1 is the button
Seat 1: UZEsV9yKUMqmpYPiOFpaZw ($101.50 in chips)
Seat 2: g7gL2NLJCdZPPV399WKT1w ($78.25 in chips)
Seat 3: ice1Sbe19zWIaKYoSmE5tw ($99.30 in chips)
Seat 4: CkE3IyJF1KvdaAOmZY5XqQ ($200 in chips)
Seat 5: mIKx5lhIt13X5eZQH0ZeMA ($77.10 in chips)
Seat 8: 1CtiZuXDFaJL1dJPQKyi8Q ($158.35 in chips)
Seat 9: WUlHm+ydPPHG7Lb0rePSdA ($120.70 in chips)
g7gL2NLJCdZPPV399WKT1w: posts small blind $1
ice1Sbe19zWIaKYoSmE5tw: posts big blind $2
nXDI8Y/S6POzRwANu3d8hQ: sits out
*** HOLE CARDS ***
CkE3IyJF1KvdaAOmZY5XqQ: folds
1CtiZuXDFaJL1dJPQKyi8Q said, "n catch"
mIKx5lhIt13X5eZQH0ZeMA: folds
1CtiZuXDFaJL1dJPQKyi8Q: folds
WUlHm+ydPPHG7Lb0rePSdA: folds
UZEsV9yKUMqmpYPiOFpaZw: calls $2
g7gL2NLJCdZPPV399WKT1w: calls $1
ice1Sbe19zWIaKYoSmE5tw: checks
*** FLOP *** [7s 7h 5d]
g7gL2NLJCdZPPV399WKT1w: checks
ice1Sbe19zWIaKYoSmE5tw: checks
UZEsV9yKUMqmpYPiOFpaZw: checks
*** TURN *** [7s 7h 5d] [Tc]
g7gL2NLJCdZPPV399WKT1w: checks
ice1Sbe19zWIaKYoSmE5tw: checks
UZEsV9yKUMqmpYPiOFpaZw: checks
*** RIVER *** [7s 7h 5d Tc] [2h]
g7gL2NLJCdZPPV399WKT1w: checks
ice1Sbe19zWIaKYoSmE5tw: checks
UZEsV9yKUMqmpYPiOFpaZw: checks
*** SHOW DOWN ***
g7gL2NLJCdZPPV399WKT1w: shows [5s Qs] (two pair, Sevens and Fives)
ice1Sbe19zWIaKYoSmE5tw: mucks hand
UZEsV9yKUMqmpYPiOFpaZw: shows [Ts 8s] (two pair, Tens and Sevens)
UZEsV9yKUMqmpYPiOFpaZw collected $5.70 from pot
*** SUMMARY ***
Total pot $6 | Rake $0.30
Board [7s 7h 5d Tc 2h]
Seat 1: UZEsV9yKUMqmpYPiOFpaZw (button) showed [Ts 8s] and won ($5.70) with two pair, Tens and Sevens
Seat 2: g7gL2NLJCdZPPV399WKT1w (small blind) showed [5s Qs] and lost with two pair, Sevens and Fives
Seat 3: ice1Sbe19zWIaKYoSmE5tw (big blind) mucked
Seat 4: CkE3IyJF1KvdaAOmZY5XqQ folded before Flop (didn't bet)
Seat 5: mIKx5lhIt13X5eZQH0ZeMA folded before Flop (didn't bet)
Seat 8: 1CtiZuXDFaJL1dJPQKyi8Q folded before Flop (didn't bet)
Seat 9: WUlHm+ydPPHG7Lb0rePSdA folded before Flop (didn't bet)



PokerStars Game #59941034248:  Hold'em No Limit ($1/$2) - 2009/07/01 1:23:45 ET
Table '/dyk+YdRGv90j2box35j8w' 6-max Seat #1 is the button
Seat 1: 8srN1dKQePlsv0GyTada+Q ($200 in chips)
Seat 2: qCnEYuAE5y5A7bk6fO5/jQ ($476.60 in chips)
Seat 3: sTPOWERd9HWPCNrDBwsVjA ($188.75 in chips)
Seat 4: z/u1YTnkiIDrtp/2cA2dBg ($193.65 in chips)
Seat 5: VvdR9F3I+2yELkfTVvC1dg ($200 in chips)
qCnEYuAE5y5A7bk6fO5/jQ: posts small blind $1
sTPOWERd9HWPCNrDBwsVjA: posts big blind $2
*** HOLE CARDS ***
z/u1YTnkiIDrtp/2cA2dBg: folds
VvdR9F3I+2yELkfTVvC1dg: folds
8srN1dKQePlsv0GyTada+Q: folds
qCnEYuAE5y5A7bk6fO5/jQ: folds
sTPOWERd9HWPCNrDBwsVjA collected $2 from pot
*** SUMMARY ***
Total pot $2 | Rake $0
Seat 1: 8srN1dKQePlsv0GyTada+Q (button) folded before Flop (didn't bet)
Seat 2: qCnEYuAE5y5A7bk6fO5/jQ (small blind) folded before Flop
Seat 3: sTPOWERd9HWPCNrDBwsVjA (big blind) collected ($2)
Seat 4: z/u1YTnkiIDrtp/2cA2dBg folded before Flop (didn't bet)
Seat 5: VvdR9F3I+2yELkfTVvC1dg folded before Flop (didn't bet)



PokerStars Game #59941034860:  Hold'em No Limit ($1/$2) - 2009/07/01 1:23:46 ET
Table 'QxerF7GUfCbl+4a8XaTB2w' 6-max Seat #2 is the button
Seat 1: 54yWzRRgS0oZ+S6LwZBxMQ ($37 in chips)
Seat 2: HiWSAXs6/0w9Jy7ioiiShQ ($44 in chips)
Seat 3: m7mYVfnCOK5TE/VkN/FhOg ($277.10 in chips)
Seat 4: 09BNF4quPDzanQzM8vc6WA ($37.55 in chips)
Seat 6: VvdR9F3I+2yELkfTVvC1dg ($209.40 in chips)
m7mYVfnCOK5TE/VkN/FhOg: posts small blind $1
09BNF4quPDzanQzM8vc6WA: posts big blind $2
gnYme0DNFflnMhrdbxe1Ag: sits out
*** HOLE CARDS ***
VvdR9F3I+2yELkfTVvC1dg: folds
54yWzRRgS0oZ+S6LwZBxMQ: folds
HiWSAXs6/0w9Jy7ioiiShQ: raises $2 to $4
m7mYVfnCOK5TE/VkN/FhOg: folds
09BNF4quPDzanQzM8vc6WA: raises $33.55 to $37.55 and is all-in
HiWSAXs6/0w9Jy7ioiiShQ: folds
09BNF4quPDzanQzM8vc6WA collected $9 from pot
09BNF4quPDzanQzM8vc6WA: doesn't show hand
*** SUMMARY ***
Total pot $9 | Rake $0
Seat 1: 54yWzRRgS0oZ+S6LwZBxMQ folded before Flop (didn't bet)
Seat 2: HiWSAXs6/0w9Jy7ioiiShQ (button) folded before Flop
Seat 3: m7mYVfnCOK5TE/VkN/FhOg (small blind) folded before Flop
Seat 4: 09BNF4quPDzanQzM8vc6WA (big blind) collected ($9)
Seat 6: VvdR9F3I+2yELkfTVvC1dg folded before Flop (didn't bet)



PokerStars Game #59941034576:  Hold'em No Limit ($1/$2) - 2009/07/01 1:23:46 ET
Table 'LL4bDFyhj5hsMpzaDugJZg' 6-max Seat #4 is the button
Seat 1: FwvID/fQGlpY3soi/lMTww ($82.95 in chips)
Seat 2: IZng3w8jiJHHp3LbYKLi4w ($49.15 in chips)
Seat 3: iI/NMpRxMkGieArQEhACSA ($293.75 in chips)
Seat 4: 8srN1dKQePlsv0GyTada+Q ($309.75 in chips)
Seat 5: A2GTwTiwkb1ilNWgW487Vg ($66.80 in chips)
Seat 6: 692Q4sfB0gTElzS0WMeg+A ($211.10 in chips)
A2GTwTiwkb1ilNWgW487Vg: posts small blind $1
692Q4sfB0gTElzS0WMeg+A: posts big blind $2
*** HOLE CARDS ***
FwvID/fQGlpY3soi/lMTww: raises $2 to $4
IZng3w8jiJHHp3LbYKLi4w: folds
IZng3w8jiJHHp3LbYKLi4w is sitting out
iI/NMpRxMkGieArQEhACSA: folds
8srN1dKQePlsv0GyTada+Q: folds
A2GTwTiwkb1ilNWgW487Vg: folds
692Q4sfB0gTElzS0WMeg+A: calls $2
*** FLOP *** [9d 6c Jc]
692Q4sfB0gTElzS0WMeg+A: checks
FwvID/fQGlpY3soi/lMTww: bets $6
692Q4sfB0gTElzS0WMeg+A: folds
FwvID/fQGlpY3soi/lMTww collected $8.55 from pot
*** SUMMARY ***
Total pot $9 | Rake $0.45
Board [9d 6c Jc]
Seat 1: FwvID/fQGlpY3soi/lMTww collected ($8.55)
Seat 2: IZng3w8jiJHHp3LbYKLi4w folded before Flop (didn't bet)
Seat 3: iI/NMpRxMkGieArQEhACSA folded before Flop (didn't bet)
Seat 4: 8srN1dKQePlsv0GyTada+Q (button) folded before Flop (didn't bet)
Seat 5: A2GTwTiwkb1ilNWgW487Vg (small blind) folded before Flop
Seat 6: 692Q4sfB0gTElzS0WMeg+A (big blind) folded on the Flop



PokerStars Game #59941034570:  Hold'em No Limit ($1/$2) - 2009/07/01 1:23:46 ET
Table 'kq5zaQ+1hLNf8LZfGnbTAA' 6-max Seat #2 is the button
Seat 1: 8srN1dKQePlsv0GyTada+Q ($237.20 in chips)
Seat 2: nXDI8Y/S6POzRwANu3d8hQ ($68.80 in chips)
Seat 3: vkfxu8f/jMYKUk6Ly4eujw ($225.95 in chips)
Seat 4: 3dAbvkxS5NPQTBAbvpinVg ($200 in chips)
Seat 5: kfASJqTbXek+zc8ZKsZL1Q ($140.75 in chips)
Seat 6: mfy7uGZcqA2PVQqEVbJ7+g ($191.25 in chips)
vkfxu8f/jMYKUk6Ly4eujw: posts small blind $1
3dAbvkxS5NPQTBAbvpinVg: posts big blind $2
*** HOLE CARDS ***
kfASJqTbXek+zc8ZKsZL1Q: raises $4 to $6
mfy7uGZcqA2PVQqEVbJ7+g: folds
8srN1dKQePlsv0GyTada+Q: raises $12 to $18
nXDI8Y/S6POzRwANu3d8hQ: folds
vkfxu8f/jMYKUk6Ly4eujw: folds
3dAbvkxS5NPQTBAbvpinVg: folds
kfASJqTbXek+zc8ZKsZL1Q: calls $12
*** FLOP *** [Td Tc 7c]
kfASJqTbXek+zc8ZKsZL1Q: checks
8srN1dKQePlsv0GyTada+Q: bets $24
kfASJqTbXek+zc8ZKsZL1Q: calls $24
*** TURN *** [Td Tc 7c] [Qd]
kfASJqTbXek+zc8ZKsZL1Q: bets $98.75 and is all-in
8srN1dKQePlsv0GyTada+Q: calls $98.75
*** RIVER *** [Td Tc 7c Qd] [7d]
*** SHOW DOWN ***
kfASJqTbXek+zc8ZKsZL1Q: shows [7s 8s] (a full house, Sevens full of Tens)
8srN1dKQePlsv0GyTada+Q: mucks hand
kfASJqTbXek+zc8ZKsZL1Q collected $281.50 from pot
*** SUMMARY ***
Total pot $284.50 | Rake $3
Board [Td Tc 7c Qd 7d]
Seat 1: 8srN1dKQePlsv0GyTada+Q mucked
Seat 2: nXDI8Y/S6POzRwANu3d8hQ (button) folded before Flop (didn't bet)
Seat 3: vkfxu8f/jMYKUk6Ly4eujw (small blind) folded before Flop
Seat 4: 3dAbvkxS5NPQTBAbvpinVg (big blind) folded before Flop
Seat 5: kfASJqTbXek+zc8ZKsZL1Q showed [7s 8s] and won ($281.50) with a full house, Sevens full of Tens
Seat 6: mfy7uGZcqA2PVQqEVbJ7+g folded before Flop (didn't bet)



PokerStars Game #59941035032:  Hold'em No Limit ($1/$2) - 2009/07/01 1:23:47 ET
Table 'C4lkCXY2PWy6z4vsAe5NGQ' 6-max Seat #6 is the button
Seat 1: 4bqvCfJ0e8CTYnn0Go9hbQ ($62.60 in chips)
Seat 2: 6hRJ68JkbJq6MYI9o5bUnQ ($38.40 in chips)
Seat 3: sTPOWERd9HWPCNrDBwsVjA ($144.80 in chips)
Seat 4: VvdR9F3I+2yELkfTVvC1dg ($234.15 in chips)
Seat 5: dKvrkfQx2Peke3ikZLUy1w ($55.20 in chips)
Seat 6: B87ikIyZ/TzAVeXf38Ny0g ($657.75 in chips)
4bqvCfJ0e8CTYnn0Go9hbQ: posts small blind $1
6hRJ68JkbJq6MYI9o5bUnQ: posts big blind $2
*** HOLE CARDS ***
sTPOWERd9HWPCNrDBwsVjA: folds
VvdR9F3I+2yELkfTVvC1dg: folds
dKvrkfQx2Peke3ikZLUy1w: raises $4 to $6
B87ikIyZ/TzAVeXf38Ny0g: folds
4bqvCfJ0e8CTYnn0Go9hbQ: folds
6hRJ68JkbJq6MYI9o5bUnQ: calls $4
*** FLOP *** [Kh Ks 9s]
6hRJ68JkbJq6MYI9o5bUnQ: checks
dKvrkfQx2Peke3ikZLUy1w: bets $49.20 and is all-in
6hRJ68JkbJq6MYI9o5bUnQ: folds
dKvrkfQx2Peke3ikZLUy1w collected $12.35 from pot
*** SUMMARY ***
Total pot $13 | Rake $0.65
Board [Kh Ks 9s]
Seat 1: 4bqvCfJ0e8CTYnn0Go9hbQ (small blind) folded before Flop
Seat 2: 6hRJ68JkbJq6MYI9o5bUnQ (big blind) folded on the Flop
Seat 3: sTPOWERd9HWPCNrDBwsVjA folded before Flop (didn't bet)
Seat 4: VvdR9F3I+2yELkfTVvC1dg folded before Flop (didn't bet)
Seat 5: dKvrkfQx2Peke3ikZLUy1w collected ($12.35)
Seat 6: B87ikIyZ/TzAVeXf38Ny0g (button) folded before Flop (didn't bet)



PokerStars Game #59941038262:  Hold'em No Limit ($1/$2) - 2009/07/01 1:23:52 ET
Table 'ztv6V3FN2bQ9nmJPPdx6nQ' 6-max Seat #6 is the button
Seat 1: 6fLdOUCRtX71xbVRhJEq8w ($213 in chips)
Seat 2: 5Y+ZGWLI4gnlpApDX5vy1A ($408.25 in chips)
Seat 3: ubtx4Z5L+AcK71MTvYiGVw ($203 in chips)
Seat 4: UaZ5yj+6LjtWqMQg2QskUw ($115.80 in chips)
Seat 5: sTPOWERd9HWPCNrDBwsVjA ($253.75 in chips)
Seat 6: mfy7uGZcqA2PVQqEVbJ7+g ($117.45 in chips)
6fLdOUCRtX71xbVRhJEq8w: posts small blind $1
5Y+ZGWLI4gnlpApDX5vy1A: posts big blind $2
*** HOLE CARDS ***
ubtx4Z5L+AcK71MTvYiGVw: folds
UaZ5yj+6LjtWqMQg2QskUw: raises $6 to $8
sTPOWERd9HWPCNrDBwsVjA: folds
mfy7uGZcqA2PVQqEVbJ7+g: folds
6fLdOUCRtX71xbVRhJEq8w: calls $7
5Y+ZGWLI4gnlpApDX5vy1A: calls $6
*** FLOP *** [2s 8s Ah]
6fLdOUCRtX71xbVRhJEq8w: checks
5Y+ZGWLI4gnlpApDX5vy1A: bets $16
UaZ5yj+6LjtWqMQg2QskUw: calls $16
6fLdOUCRtX71xbVRhJEq8w: folds
*** TURN *** [2s 8s Ah] [Jd]
5Y+ZGWLI4gnlpApDX5vy1A: checks
UaZ5yj+6LjtWqMQg2QskUw: bets $18
5Y+ZGWLI4gnlpApDX5vy1A: calls $18
*** RIVER *** [2s 8s Ah Jd] [Kh]
5Y+ZGWLI4gnlpApDX5vy1A: checks
UaZ5yj+6LjtWqMQg2QskUw: checks
*** SHOW DOWN ***
5Y+ZGWLI4gnlpApDX5vy1A: shows [5s As] (a pair of Aces)
UaZ5yj+6LjtWqMQg2QskUw: shows [5d Ac] (a pair of Aces)
5Y+ZGWLI4gnlpApDX5vy1A collected $44.50 from pot
UaZ5yj+6LjtWqMQg2QskUw collected $44.50 from pot
*** SUMMARY ***
Total pot $92 | Rake $3
Board [2s 8s Ah Jd Kh]
Seat 1: 6fLdOUCRtX71xbVRhJEq8w (small blind) folded on the Flop
Seat 2: 5Y+ZGWLI4gnlpApDX5vy1A (big blind) showed [5s As] and won ($44.50) with a pair of Aces
Seat 3: ubtx4Z5L+AcK71MTvYiGVw folded before Flop (didn't bet)
Seat 4: UaZ5yj+6LjtWqMQg2QskUw showed [5d Ac] and won ($44.50) with a pair of Aces
Seat 5: sTPOWERd9HWPCNrDBwsVjA folded before Flop (didn't bet)
Seat 6: mfy7uGZcqA2PVQqEVbJ7+g (button) folded before Flop (didn't bet)



PokerStars Game #59941040018:  Hold'em No Limit ($1/$2) - 2009/07/01 1:23:56 ET
Table 'uJ9juaXXg9yIcSU8amxaXQ' 6-max Seat #2 is the button
Seat 1: JsqOjN/eHz0uYVf/PyUJ6Q ($148.85 in chips)
Seat 2: VvdR9F3I+2yELkfTVvC1dg ($200 in chips)
Seat 3: qXDd0ZyMIse0OBu8pxeQ3Q ($254 in chips)
Seat 4: zNjJ/y4emmF+vzrCDd+ooA ($217.75 in chips)
Seat 5: YsLQ3BAvgQHWXMAv3Wv6Hg ($202 in chips)
Seat 6: 2DFp9Veq1xxq64dCjwNuUw ($55.60 in chips)
qXDd0ZyMIse0OBu8pxeQ3Q: posts small blind $1
zNjJ/y4emmF+vzrCDd+ooA: posts big blind $2
*** HOLE CARDS ***
YsLQ3BAvgQHWXMAv3Wv6Hg: folds
2DFp9Veq1xxq64dCjwNuUw: folds
JsqOjN/eHz0uYVf/PyUJ6Q: folds
VvdR9F3I+2yELkfTVvC1dg: folds
qXDd0ZyMIse0OBu8pxeQ3Q: folds
zNjJ/y4emmF+vzrCDd+ooA collected $2 from pot
*** SUMMARY ***
Total pot $2 | Rake $0
Seat 1: JsqOjN/eHz0uYVf/PyUJ6Q folded before Flop (didn't bet)
Seat 2: VvdR9F3I+2yELkfTVvC1dg (button) folded before Flop (didn't bet)
Seat 3: qXDd0ZyMIse0OBu8pxeQ3Q (small blind) folded before Flop
Seat 4: zNjJ/y4emmF+vzrCDd+ooA (big blind) collected ($2)
Seat 5: YsLQ3BAvgQHWXMAv3Wv6Hg folded before Flop (didn't bet)
Seat 6: 2DFp9Veq1xxq64dCjwNuUw folded before Flop (didn't bet)



PokerStars Game #59941040194:  Hold'em No Limit ($1/$2) - 2009/07/01 1:23:56 ET
Table 'NmY84NAf9Mh0ckAckHnh5g' 2-max Seat #2 is the button
Seat 1: 6hvg964TSqZ3AL/0XK9aVQ ($181.10 in chips)
Seat 2: RwDoM55ZeQuI2ADyJhOb2Q ($824.40 in chips)
RwDoM55ZeQuI2ADyJhOb2Q: posts small blind $1
6hvg964TSqZ3AL/0XK9aVQ: posts big blind $2
*** HOLE CARDS ***
RwDoM55ZeQuI2ADyJhOb2Q: raises $4 to $6
6hvg964TSqZ3AL/0XK9aVQ: calls $4
*** FLOP *** [Kd Jh 8s]
6hvg964TSqZ3AL/0XK9aVQ: checks
RwDoM55ZeQuI2ADyJhOb2Q: bets $10
6hvg964TSqZ3AL/0XK9aVQ: raises $20 to $30
RwDoM55ZeQuI2ADyJhOb2Q: calls $20
*** TURN *** [Kd Jh 8s] [8h]
6hvg964TSqZ3AL/0XK9aVQ: checks
RwDoM55ZeQuI2ADyJhOb2Q: checks
*** RIVER *** [Kd Jh 8s 8h] [Th]
6hvg964TSqZ3AL/0XK9aVQ: bets $145.10 and is all-in
RwDoM55ZeQuI2ADyJhOb2Q: folds
6hvg964TSqZ3AL/0XK9aVQ collected $71.50 from pot
6hvg964TSqZ3AL/0XK9aVQ: doesn't show hand
*** SUMMARY ***
Total pot $72 | Rake $0.50
Board [Kd Jh 8s 8h Th]
Seat 1: 6hvg964TSqZ3AL/0XK9aVQ (big blind) collected ($71.50)
Seat 2: RwDoM55ZeQuI2ADyJhOb2Q (button) (small blind) folded on the River



PokerStars Game #59941040606:  Hold'em No Limit ($1/$2) - 2009/07/01 1:23:57 ET
Table 'rsKRKlGHlxVyqJxzO2a2Ow' 9-max Seat #8 is the button
Seat 1: uYWfQJg2hgHLxri6/uVJiw ($327.20 in chips)
Seat 2: QHxJjpVYwitg9krW6wZgJA ($273.65 in chips)
Seat 3: zTcFtoHqqK4550YMZ8Y14Q ($60.50 in chips)
Seat 4: 31HuO+DQxppUQEedBWukug ($114.85 in chips)
Seat 5: 5Q8U6iZbeO7xJSS4qvDP5g ($202 in chips)
Seat 6: H6Z4+qu8gR0VUiPOijndVg ($204.55 in chips)
Seat 7: GX1heJ+DSsvm7gzSPsYhhQ ($33 in chips)
Seat 8: CkE3IyJF1KvdaAOmZY5XqQ ($215.75 in chips)
Seat 9: gRbvhSUVg+TNaTjaJecIRw ($70 in chips)
gRbvhSUVg+TNaTjaJecIRw: posts small blind $1
uYWfQJg2hgHLxri6/uVJiw: posts big blind $2
*** HOLE CARDS ***
QHxJjpVYwitg9krW6wZgJA: folds
QHxJjpVYwitg9krW6wZgJA is sitting out
zTcFtoHqqK4550YMZ8Y14Q: raises $4 to $6
31HuO+DQxppUQEedBWukug: folds
5Q8U6iZbeO7xJSS4qvDP5g: folds
H6Z4+qu8gR0VUiPOijndVg: folds
GX1heJ+DSsvm7gzSPsYhhQ: folds
CkE3IyJF1KvdaAOmZY5XqQ: folds
gRbvhSUVg+TNaTjaJecIRw: calls $5
uYWfQJg2hgHLxri6/uVJiw: raises $12 to $18
zTcFtoHqqK4550YMZ8Y14Q: calls $12
gRbvhSUVg+TNaTjaJecIRw: calls $12
*** FLOP *** [9s Js 6s]
gRbvhSUVg+TNaTjaJecIRw: checks
uYWfQJg2hgHLxri6/uVJiw: bets $18
zTcFtoHqqK4550YMZ8Y14Q: folds
gRbvhSUVg+TNaTjaJecIRw: folds
uYWfQJg2hgHLxri6/uVJiw collected $51.30 from pot
uYWfQJg2hgHLxri6/uVJiw: shows [Ks Kc] (a pair of Kings)
*** SUMMARY ***
Total pot $54 | Rake $2.70
Board [9s Js 6s]
Seat 1: uYWfQJg2hgHLxri6/uVJiw (big blind) collected ($51.30)
Seat 2: QHxJjpVYwitg9krW6wZgJA folded before Flop (didn't bet)
Seat 3: zTcFtoHqqK4550YMZ8Y14Q folded on the Flop
Seat 4: 31HuO+DQxppUQEedBWukug folded before Flop (didn't bet)
Seat 5: 5Q8U6iZbeO7xJSS4qvDP5g folded before Flop (didn't bet)
Seat 6: H6Z4+qu8gR0VUiPOijndVg folded before Flop (didn't bet)
Seat 7: GX1heJ+DSsvm7gzSPsYhhQ folded before Flop (didn't bet)
Seat 8: CkE3IyJF1KvdaAOmZY5XqQ (button) folded before Flop (didn't bet)
Seat 9: gRbvhSUVg+TNaTjaJecIRw (small blind) folded on the Flop



PokerStars Game #59941041572:  Hold'em No Limit ($1/$2) - 2009/07/01 1:23:58 ET
Table '+hSnXFQrGw1PlVgTnuj+sA' 6-max Seat #3 is the button
Seat 1: 2ccIJhDj+3JapvS7swVZEg ($316.50 in chips)
Seat 2: o9jamqIi6sTTRSqudgboRA ($278.90 in chips)
Seat 3: fE+LHW/7rpfXW14g8LhGjA ($61.30 in chips)
Seat 4: J4iH5epwXbmODnojR/VRxA ($161.60 in chips)
Seat 5: VvdR9F3I+2yELkfTVvC1dg ($200 in chips)
Seat 6: AuiGltq875lmaKHBsjZVGg ($79.75 in chips)
J4iH5epwXbmODnojR/VRxA: posts small blind $1
VvdR9F3I+2yELkfTVvC1dg: posts big blind $2
*** HOLE CARDS ***
AuiGltq875lmaKHBsjZVGg: raises $2 to $4
2ccIJhDj+3JapvS7swVZEg: calls $4
o9jamqIi6sTTRSqudgboRA: folds
fE+LHW/7rpfXW14g8LhGjA: calls $4
J4iH5epwXbmODnojR/VRxA: calls $3
VvdR9F3I+2yELkfTVvC1dg: folds
*** FLOP *** [3h Kc Qc]
J4iH5epwXbmODnojR/VRxA: checks
AuiGltq875lmaKHBsjZVGg: checks
2ccIJhDj+3JapvS7swVZEg: bets $6
fE+LHW/7rpfXW14g8LhGjA: folds
J4iH5epwXbmODnojR/VRxA: folds
AuiGltq875lmaKHBsjZVGg: folds
2ccIJhDj+3JapvS7swVZEg collected $17.10 from pot
*** SUMMARY ***
Total pot $18 | Rake $0.90
Board [3h Kc Qc]
Seat 1: 2ccIJhDj+3JapvS7swVZEg collected ($17.10)
Seat 2: o9jamqIi6sTTRSqudgboRA folded before Flop (didn't bet)
Seat 3: fE+LHW/7rpfXW14g8LhGjA (button) folded on the Flop
Seat 4: J4iH5epwXbmODnojR/VRxA (small blind) folded on the Flop
Seat 5: VvdR9F3I+2yELkfTVvC1dg (big blind) folded before Flop
Seat 6: AuiGltq875lmaKHBsjZVGg folded on the Flop



PokerStars Game #59941041840:  Hold'em No Limit ($1/$2) - 2009/07/01 1:23:59 ET
Table '/dyk+YdRGv90j2box35j8w' 6-max Seat #2 is the button
Seat 1: 8srN1dKQePlsv0GyTada+Q ($200 in chips)
Seat 2: qCnEYuAE5y5A7bk6fO5/jQ ($475.60 in chips)
Seat 3: sTPOWERd9HWPCNrDBwsVjA ($189.75 in chips)
Seat 4: z/u1YTnkiIDrtp/2cA2dBg ($193.65 in chips)
Seat 5: VvdR9F3I+2yELkfTVvC1dg ($200 in chips)
sTPOWERd9HWPCNrDBwsVjA: posts small blind $1
z/u1YTnkiIDrtp/2cA2dBg: posts big blind $2
*** HOLE CARDS ***
VvdR9F3I+2yELkfTVvC1dg: folds
8srN1dKQePlsv0GyTada+Q: folds
qCnEYuAE5y5A7bk6fO5/jQ: folds
sTPOWERd9HWPCNrDBwsVjA: folds
z/u1YTnkiIDrtp/2cA2dBg collected $2 from pot
*** SUMMARY ***
Total pot $2 | Rake $0
Seat 1: 8srN1dKQePlsv0GyTada+Q folded before Flop (didn't bet)
Seat 2: qCnEYuAE5y5A7bk6fO5/jQ (button) folded before Flop (didn't bet)
Seat 3: sTPOWERd9HWPCNrDBwsVjA (small blind) folded before Flop
Seat 4: z/u1YTnkiIDrtp/2cA2dBg (big blind) collected ($2)
Seat 5: VvdR9F3I+2yELkfTVvC1dg folded before Flop (didn't bet)



PokerStars Game #59941044040:  Hold'em No Limit ($1/$2) - 2009/07/01 1:24:03 ET
Table '4NGNnZ/osQfNq6abYqkJeA' 6-max Seat #6 is the button
Seat 1: 7zM38baFvmCNB/F80oE0cQ ($50.30 in chips)
Seat 2: 669iGNwYwgRZg3nhS+aDAQ ($96.15 in chips)
Seat 3: 54yWzRRgS0oZ+S6LwZBxMQ ($23.75 in chips)
Seat 4: sY+4Uuh5z/6AbXXaCS10jw ($214.35 in chips)
Seat 5: VvdR9F3I+2yELkfTVvC1dg ($234.80 in chips)
Seat 6: kkgpegLoQkmL6LIsFsvtiQ ($266.65 in chips)
7zM38baFvmCNB/F80oE0cQ: posts small blind $1
669iGNwYwgRZg3nhS+aDAQ: posts big blind $2
*** HOLE CARDS ***
54yWzRRgS0oZ+S6LwZBxMQ: folds
sY+4Uuh5z/6AbXXaCS10jw: folds
VvdR9F3I+2yELkfTVvC1dg: folds
kkgpegLoQkmL6LIsFsvtiQ: raises $6 to $8
7zM38baFvmCNB/F80oE0cQ: calls $7
669iGNwYwgRZg3nhS+aDAQ: folds
*** FLOP *** [3h 7s Jd]
7zM38baFvmCNB/F80oE0cQ: bets $2
kkgpegLoQkmL6LIsFsvtiQ: calls $2
*** TURN *** [3h 7s Jd] [7h]
7zM38baFvmCNB/F80oE0cQ: bets $2
kkgpegLoQkmL6LIsFsvtiQ: calls $2
*** RIVER *** [3h 7s Jd 7h] [Ad]
7zM38baFvmCNB/F80oE0cQ: bets $18
kkgpegLoQkmL6LIsFsvtiQ: folds
7zM38baFvmCNB/F80oE0cQ collected $24.80 from pot
7zM38baFvmCNB/F80oE0cQ: doesn't show hand
*** SUMMARY ***
Total pot $26 | Rake $1.20
Board [3h 7s Jd 7h Ad]
Seat 1: 7zM38baFvmCNB/F80oE0cQ (small blind) collected ($24.80)
Seat 2: 669iGNwYwgRZg3nhS+aDAQ (big blind) folded before Flop
Seat 3: 54yWzRRgS0oZ+S6LwZBxMQ folded before Flop (didn't bet)
Seat 4: sY+4Uuh5z/6AbXXaCS10jw folded before Flop (didn't bet)
Seat 5: VvdR9F3I+2yELkfTVvC1dg folded before Flop (didn't bet)
Seat 6: kkgpegLoQkmL6LIsFsvtiQ (button) folded on the River



PokerStars Game #59941045112:  Hold'em No Limit ($1/$2) - 2009/07/01 1:24:04 ET
Table 'AtOXMvcrtQM8yLNcALmfLQ' 2-max Seat #2 is the button
Seat 1: +HlQuAsMqZGYYtjcPO/a3A ($123.90 in chips)
Seat 2: pVqEzK9wXlRMECnb1Zg4Zw ($272.30 in chips)
pVqEzK9wXlRMECnb1Zg4Zw: posts small blind $1
+HlQuAsMqZGYYtjcPO/a3A: posts big blind $2
*** HOLE CARDS ***
pVqEzK9wXlRMECnb1Zg4Zw: raises $6 to $8
+HlQuAsMqZGYYtjcPO/a3A: folds
pVqEzK9wXlRMECnb1Zg4Zw collected $4 from pot
pVqEzK9wXlRMECnb1Zg4Zw: doesn't show hand
*** SUMMARY ***
Total pot $4 | Rake $0
Seat 1: +HlQuAsMqZGYYtjcPO/a3A (big blind) folded before Flop
Seat 2: pVqEzK9wXlRMECnb1Zg4Zw (button) (small blind) collected ($4)



PokerStars Game #59941045200:  Hold'em No Limit ($1/$2) - 2009/07/01 1:24:05 ET
Table 'ZzSIe0zTCDv+n6hfbY5tTg' 6-max Seat #1 is the button
Seat 1: VvdR9F3I+2yELkfTVvC1dg ($212.10 in chips)
Seat 2: B87ikIyZ/TzAVeXf38Ny0g ($242 in chips)
Seat 3: gsugPj31Hui3Jefl98MBOA ($204.65 in chips)
Seat 4: qXDd0ZyMIse0OBu8pxeQ3Q ($212.70 in chips)
Seat 5: 3dAbvkxS5NPQTBAbvpinVg ($483.30 in chips)
Seat 6: 09BNF4quPDzanQzM8vc6WA ($18.50 in chips)
B87ikIyZ/TzAVeXf38Ny0g: posts small blind $1
gsugPj31Hui3Jefl98MBOA: posts big blind $2
*** HOLE CARDS ***
qXDd0ZyMIse0OBu8pxeQ3Q: folds
3dAbvkxS5NPQTBAbvpinVg: folds
09BNF4quPDzanQzM8vc6WA: raises $2 to $4
VvdR9F3I+2yELkfTVvC1dg: folds
B87ikIyZ/TzAVeXf38Ny0g: folds
gsugPj31Hui3Jefl98MBOA: calls $2
*** FLOP *** [Td 6s 8s]
gsugPj31Hui3Jefl98MBOA: checks
09BNF4quPDzanQzM8vc6WA: bets $4
gsugPj31Hui3Jefl98MBOA: folds
09BNF4quPDzanQzM8vc6WA collected $8.55 from pot
09BNF4quPDzanQzM8vc6WA: doesn't show hand
*** SUMMARY ***
Total pot $9 | Rake $0.45
Board [Td 6s 8s]
Seat 1: VvdR9F3I+2yELkfTVvC1dg (button) folded before Flop (didn't bet)
Seat 2: B87ikIyZ/TzAVeXf38Ny0g (small blind) folded before Flop
Seat 3: gsugPj31Hui3Jefl98MBOA (big blind) folded on the Flop
Seat 4: qXDd0ZyMIse0OBu8pxeQ3Q folded before Flop (didn't bet)
Seat 5: 3dAbvkxS5NPQTBAbvpinVg folded before Flop (didn't bet)
Seat 6: 09BNF4quPDzanQzM8vc6WA collected ($8.55)



PokerStars Game #59941045252:  Hold'em No Limit ($1/$2) - 2009/07/01 1:24:05 ET
Table 'rKeCh+eBn4RNvybCUYkoTQ' 9-max Seat #6 is the button
Seat 1: /inIs/z/PcX+TniIFpaxpg ($203 in chips)
Seat 3: GX1heJ+DSsvm7gzSPsYhhQ ($31 in chips)
Seat 4: 31HuO+DQxppUQEedBWukug ($89.10 in chips)
Seat 5: WUlHm+ydPPHG7Lb0rePSdA ($128 in chips)
Seat 6: EBV6OktyeSmh4w6sWmcWOw ($267 in chips)
Seat 7: rW/MyplHylMSBRaoRUzWrg ($35 in chips)
Seat 8: pN/Ip0ePsUVIdUlGgLrkUw ($218.35 in chips)
Seat 9: Kzta8yu9vxHT4B70mjBZ+w ($211.25 in chips)
rW/MyplHylMSBRaoRUzWrg: posts small blind $1
pN/Ip0ePsUVIdUlGgLrkUw: posts big blind $2
*** HOLE CARDS ***
Kzta8yu9vxHT4B70mjBZ+w: folds
/inIs/z/PcX+TniIFpaxpg: folds
GX1heJ+DSsvm7gzSPsYhhQ: raises $4 to $6
31HuO+DQxppUQEedBWukug: folds
WUlHm+ydPPHG7Lb0rePSdA: folds
EBV6OktyeSmh4w6sWmcWOw: folds
rW/MyplHylMSBRaoRUzWrg: folds
pN/Ip0ePsUVIdUlGgLrkUw: folds
9cBHwK40Tl06vheE7B3LHQ has returned
GX1heJ+DSsvm7gzSPsYhhQ collected $5 from pot
*** SUMMARY ***
Total pot $5 | Rake $0
Seat 1: /inIs/z/PcX+TniIFpaxpg folded before Flop (didn't bet)
Seat 3: GX1heJ+DSsvm7gzSPsYhhQ collected ($5)
Seat 4: 31HuO+DQxppUQEedBWukug folded before Flop (didn't bet)
Seat 5: WUlHm+ydPPHG7Lb0rePSdA folded before Flop (didn't bet)
Seat 6: EBV6OktyeSmh4w6sWmcWOw (button) folded before Flop (didn't bet)
Seat 7: rW/MyplHylMSBRaoRUzWrg (small blind) folded before Flop
Seat 8: pN/Ip0ePsUVIdUlGgLrkUw (big blind) folded before Flop
Seat 9: Kzta8yu9vxHT4B70mjBZ+w folded before Flop (didn't bet)



PokerStars Game #59941046862:  Hold'em No Limit ($1/$2) - 2009/07/01 1:24:08 ET
Table 'aSf77Sj8QEnzcc0WaxVD4Q' 6-max Seat #3 is the button
Seat 1: UELtvp+JfwI7XDGVwSxZXA ($165.75 in chips)
Seat 2: vkfxu8f/jMYKUk6Ly4eujw ($200 in chips)
Seat 3: 9dpyyjDTCed6nV7JhaUUpw ($520.35 in chips)
Seat 4: YsLQ3BAvgQHWXMAv3Wv6Hg ($263.70 in chips)
Seat 5: VvdR9F3I+2yELkfTVvC1dg ($245 in chips)
Seat 6: vkoJRf3gidxY1pPi0AFWww ($122.75 in chips)
YsLQ3BAvgQHWXMAv3Wv6Hg: posts small blind $1
VvdR9F3I+2yELkfTVvC1dg: posts big blind $2
*** HOLE CARDS ***
vkoJRf3gidxY1pPi0AFWww: folds
UELtvp+JfwI7XDGVwSxZXA: folds
vkfxu8f/jMYKUk6Ly4eujw: folds
9dpyyjDTCed6nV7JhaUUpw: folds
YsLQ3BAvgQHWXMAv3Wv6Hg: folds
VvdR9F3I+2yELkfTVvC1dg collected $2 from pot
VvdR9F3I+2yELkfTVvC1dg: doesn't show hand
*** SUMMARY ***
Total pot $2 | Rake $0
Seat 1: UELtvp+JfwI7XDGVwSxZXA folded before Flop (didn't bet)
Seat 2: vkfxu8f/jMYKUk6Ly4eujw folded before Flop (didn't bet)
Seat 3: 9dpyyjDTCed6nV7JhaUUpw (button) folded before Flop (didn't bet)
Seat 4: YsLQ3BAvgQHWXMAv3Wv6Hg (small blind) folded before Flop
Seat 5: VvdR9F3I+2yELkfTVvC1dg (big blind) collected ($2)
Seat 6: vkoJRf3gidxY1pPi0AFWww folded before Flop (didn't bet)



PokerStars Game #59941048150:  Hold'em No Limit ($1/$2) - 2009/07/01 1:24:10 ET
Table 'qVXak+oTeDXMGbWa4sDU5Q' 9-max Seat #3 is the button
Seat 1: H6Z4+qu8gR0VUiPOijndVg ($212.55 in chips)
Seat 2: rW/MyplHylMSBRaoRUzWrg ($74 in chips)
Seat 3: WUlHm+ydPPHG7Lb0rePSdA ($172.65 in chips)
Seat 4: lQYT23h5QCUVZAKxjOO39Q ($113.45 in chips)
Seat 5: FWGiDqRwvLeKmHq9t4Jy9w ($268.80 in chips)
Seat 6: GX1heJ+DSsvm7gzSPsYhhQ ($34 in chips)
Seat 7: PfmlvZlFiss79a6IoEr11g ($121.30 in chips)
Seat 8: Z0rzUi0y1x80UdIpofoNbA ($126.55 in chips)
Seat 9: CkE3IyJF1KvdaAOmZY5XqQ ($200 in chips)
lQYT23h5QCUVZAKxjOO39Q: posts small blind $1
FWGiDqRwvLeKmHq9t4Jy9w: posts big blind $2
*** HOLE CARDS ***
GX1heJ+DSsvm7gzSPsYhhQ: folds
PfmlvZlFiss79a6IoEr11g: calls $2
Z0rzUi0y1x80UdIpofoNbA: folds
CkE3IyJF1KvdaAOmZY5XqQ: calls $2
H6Z4+qu8gR0VUiPOijndVg: folds
rW/MyplHylMSBRaoRUzWrg: folds
WUlHm+ydPPHG7Lb0rePSdA: calls $2
lQYT23h5QCUVZAKxjOO39Q: calls $1
FWGiDqRwvLeKmHq9t4Jy9w: checks
*** FLOP *** [Qd 7c 7d]
lQYT23h5QCUVZAKxjOO39Q: checks
FWGiDqRwvLeKmHq9t4Jy9w: checks
PfmlvZlFiss79a6IoEr11g: bets $4
CkE3IyJF1KvdaAOmZY5XqQ: calls $4
WUlHm+ydPPHG7Lb0rePSdA: calls $4
lQYT23h5QCUVZAKxjOO39Q: folds
FWGiDqRwvLeKmHq9t4Jy9w: folds
*** TURN *** [Qd 7c 7d] [6s]
PfmlvZlFiss79a6IoEr11g: bets $6
CkE3IyJF1KvdaAOmZY5XqQ: calls $6
WUlHm+ydPPHG7Lb0rePSdA: calls $6
*** RIVER *** [Qd 7c 7d 6s] [6h]
PfmlvZlFiss79a6IoEr11g: bets $10
CkE3IyJF1KvdaAOmZY5XqQ: calls $10
WUlHm+ydPPHG7Lb0rePSdA: calls $10
*** SHOW DOWN ***
PfmlvZlFiss79a6IoEr11g: shows [Ah 7s] (a full house, Sevens full of Sixes)
CkE3IyJF1KvdaAOmZY5XqQ: mucks hand
WUlHm+ydPPHG7Lb0rePSdA: mucks hand
PfmlvZlFiss79a6IoEr11g collected $67 from pot
*** SUMMARY ***
Total pot $70 | Rake $3
Board [Qd 7c 7d 6s 6h]
Seat 1: H6Z4+qu8gR0VUiPOijndVg folded before Flop (didn't bet)
Seat 2: rW/MyplHylMSBRaoRUzWrg folded before Flop (didn't bet)
Seat 3: WUlHm+ydPPHG7Lb0rePSdA (button) mucked
Seat 4: lQYT23h5QCUVZAKxjOO39Q (small blind) folded on the Flop
Seat 5: FWGiDqRwvLeKmHq9t4Jy9w (big blind) folded on the Flop
Seat 6: GX1heJ+DSsvm7gzSPsYhhQ folded before Flop (didn't bet)
Seat 7: PfmlvZlFiss79a6IoEr11g showed [Ah 7s] and won ($67) with a full house, Sevens full of Sixes
Seat 8: Z0rzUi0y1x80UdIpofoNbA folded before Flop (didn't bet)
Seat 9: CkE3IyJF1KvdaAOmZY5XqQ mucked



PokerStars Game #59941049194:  Hold'em No Limit ($1/$2) - 2009/07/01 1:24:11 ET
Table '8Y6PEyoNuepZTai2Q56aHw' 9-max Seat #1 is the button
Seat 1: 5Q8U6iZbeO7xJSS4qvDP5g ($298.10 in chips)
Seat 2: gDCJIAlovbPnTvMM7Dd1gA ($174.35 in chips)
Seat 3: WUlHm+ydPPHG7Lb0rePSdA ($128.30 in chips)
Seat 4: xKkwALG38OfLQ9DXuJgR1w ($284.55 in chips)
Seat 6: NtLDBSjsJQEKekh5cdinvw ($361.20 in chips)
Seat 7: Kzta8yu9vxHT4B70mjBZ+w ($207.30 in chips)
Seat 8: rW/MyplHylMSBRaoRUzWrg ($37 in chips)
Seat 9: F7m34OOfAQ7annesMHVjKw ($65.80 in chips)
gDCJIAlovbPnTvMM7Dd1gA: posts small blind $1
WUlHm+ydPPHG7Lb0rePSdA: posts big blind $2
*** HOLE CARDS ***
xKkwALG38OfLQ9DXuJgR1w: folds
NtLDBSjsJQEKekh5cdinvw: folds
Kzta8yu9vxHT4B70mjBZ+w: raises $4 to $6
rW/MyplHylMSBRaoRUzWrg: folds
F7m34OOfAQ7annesMHVjKw: folds
5Q8U6iZbeO7xJSS4qvDP5g: folds
gDCJIAlovbPnTvMM7Dd1gA: folds
WUlHm+ydPPHG7Lb0rePSdA: folds
Kzta8yu9vxHT4B70mjBZ+w collected $5 from pot
Kzta8yu9vxHT4B70mjBZ+w: doesn't show hand
*** SUMMARY ***
Total pot $5 | Rake $0
Seat 1: 5Q8U6iZbeO7xJSS4qvDP5g (button) folded before Flop (didn't bet)
Seat 2: gDCJIAlovbPnTvMM7Dd1gA (small blind) folded before Flop
Seat 3: WUlHm+ydPPHG7Lb0rePSdA (big blind) folded before Flop
Seat 4: xKkwALG38OfLQ9DXuJgR1w folded before Flop (didn't bet)
Seat 6: NtLDBSjsJQEKekh5cdinvw folded before Flop (didn't bet)
Seat 7: Kzta8yu9vxHT4B70mjBZ+w collected ($5)
Seat 8: rW/MyplHylMSBRaoRUzWrg folded before Flop (didn't bet)
Seat 9: F7m34OOfAQ7annesMHVjKw folded before Flop (didn't bet)



PokerStars Game #59941049030:  Hold'em No Limit ($1/$2) - 2009/07/01 1:24:11 ET
Table 'gftD4mDF7mIFKvSrIyaRbw' 9-max Seat #1 is the button
Seat 1: 31HuO+DQxppUQEedBWukug ($98 in chips)
Seat 2: GX1heJ+DSsvm7gzSPsYhhQ ($35 in chips)
Seat 3: CUZwDpLTQKhzarPe+JCLOQ ($200.10 in chips)
Seat 5: mpsfNtnMVDqQHTe92AhIdw ($90.50 in chips)
Seat 6: 2NvwF8W2nzsbS+G//yLAbQ ($196.05 in chips)
Seat 8: MpL4DeEqGQu0H8TJEbEOrg ($44 in chips)
Seat 9: F7m34OOfAQ7annesMHVjKw ($170.75 in chips)
GX1heJ+DSsvm7gzSPsYhhQ: posts small blind $1
CUZwDpLTQKhzarPe+JCLOQ: posts big blind $2
/inIs/z/PcX+TniIFpaxpg: sits out
+T/63sAeZzWyHchahJ36GQ: sits out
*** HOLE CARDS ***
mpsfNtnMVDqQHTe92AhIdw: raises $4 to $6
2NvwF8W2nzsbS+G//yLAbQ: calls $6
MpL4DeEqGQu0H8TJEbEOrg: folds
F7m34OOfAQ7annesMHVjKw: calls $6
31HuO+DQxppUQEedBWukug: folds
GX1heJ+DSsvm7gzSPsYhhQ: calls $5
CUZwDpLTQKhzarPe+JCLOQ: folds
*** FLOP *** [8s Qs 9d]
GX1heJ+DSsvm7gzSPsYhhQ: checks
mpsfNtnMVDqQHTe92AhIdw: bets $12
2NvwF8W2nzsbS+G//yLAbQ: calls $12
F7m34OOfAQ7annesMHVjKw: folds
GX1heJ+DSsvm7gzSPsYhhQ: folds
*** TURN *** [8s Qs 9d] [5d]
mpsfNtnMVDqQHTe92AhIdw: bets $26
2NvwF8W2nzsbS+G//yLAbQ: folds
mpsfNtnMVDqQHTe92AhIdw collected $47.60 from pot
*** SUMMARY ***
Total pot $50 | Rake $2.40
Board [8s Qs 9d 5d]
Seat 1: 31HuO+DQxppUQEedBWukug (button) folded before Flop (didn't bet)
Seat 2: GX1heJ+DSsvm7gzSPsYhhQ (small blind) folded on the Flop
Seat 3: CUZwDpLTQKhzarPe+JCLOQ (big blind) folded before Flop
Seat 5: mpsfNtnMVDqQHTe92AhIdw collected ($47.60)
Seat 6: 2NvwF8W2nzsbS+G//yLAbQ folded on the Turn
Seat 8: MpL4DeEqGQu0H8TJEbEOrg folded before Flop (didn't bet)
Seat 9: F7m34OOfAQ7annesMHVjKw folded on the Flop



PokerStars Game #59941049726:  Hold'em No Limit ($1/$2) - 2009/07/01 1:24:12 ET
Table 'AtOXMvcrtQM8yLNcALmfLQ' 2-max Seat #1 is the button
Seat 1: +HlQuAsMqZGYYtjcPO/a3A ($121.90 in chips)
Seat 2: pVqEzK9wXlRMECnb1Zg4Zw ($274.30 in chips)
+HlQuAsMqZGYYtjcPO/a3A: posts small blind $1
pVqEzK9wXlRMECnb1Zg4Zw: posts big blind $2
*** HOLE CARDS ***
+HlQuAsMqZGYYtjcPO/a3A: raises $4 to $6
pVqEzK9wXlRMECnb1Zg4Zw: calls $4
*** FLOP *** [Tc 4c Js]
pVqEzK9wXlRMECnb1Zg4Zw: checks
+HlQuAsMqZGYYtjcPO/a3A: checks
*** TURN *** [Tc 4c Js] [9s]
pVqEzK9wXlRMECnb1Zg4Zw: checks
+HlQuAsMqZGYYtjcPO/a3A: bets $6
pVqEzK9wXlRMECnb1Zg4Zw: calls $6
*** RIVER *** [Tc 4c Js 9s] [2s]
pVqEzK9wXlRMECnb1Zg4Zw: checks
+HlQuAsMqZGYYtjcPO/a3A: checks
*** SHOW DOWN ***
pVqEzK9wXlRMECnb1Zg4Zw: shows [4s Ad] (a pair of Fours)
+HlQuAsMqZGYYtjcPO/a3A: mucks hand
pVqEzK9wXlRMECnb1Zg4Zw collected $23.50 from pot
*** SUMMARY ***
Total pot $24 | Rake $0.50
Board [Tc 4c Js 9s 2s]
Seat 1: +HlQuAsMqZGYYtjcPO/a3A (button) (small blind) mucked
Seat 2: pVqEzK9wXlRMECnb1Zg4Zw (big blind) showed [4s Ad] and won ($23.50) with a pair of Fours



PokerStars Game #59941050980:  Hold'em No Limit ($1/$2) - 2009/07/01 1:24:14 ET
Table '/dyk+YdRGv90j2box35j8w' 6-max Seat #3 is the button
Seat 1: 8srN1dKQePlsv0GyTada+Q ($200 in chips)
Seat 2: qCnEYuAE5y5A7bk6fO5/jQ ($475.60 in chips)
Seat 3: sTPOWERd9HWPCNrDBwsVjA ($188.75 in chips)
Seat 4: z/u1YTnkiIDrtp/2cA2dBg ($194.65 in chips)
Seat 5: VvdR9F3I+2yELkfTVvC1dg ($200 in chips)
z/u1YTnkiIDrtp/2cA2dBg: posts small blind $1
VvdR9F3I+2yELkfTVvC1dg: posts big blind $2
*** HOLE CARDS ***
8srN1dKQePlsv0GyTada+Q: folds
qCnEYuAE5y5A7bk6fO5/jQ: folds
sTPOWERd9HWPCNrDBwsVjA: folds
z/u1YTnkiIDrtp/2cA2dBg: raises $2 to $4
VvdR9F3I+2yELkfTVvC1dg: folds
z/u1YTnkiIDrtp/2cA2dBg collected $4 from pot
*** SUMMARY ***
Total pot $4 | Rake $0
Seat 1: 8srN1dKQePlsv0GyTada+Q folded before Flop (didn't bet)
Seat 2: qCnEYuAE5y5A7bk6fO5/jQ folded before Flop (didn't bet)
Seat 3: sTPOWERd9HWPCNrDBwsVjA (button) folded before Flop (didn't bet)
Seat 4: z/u1YTnkiIDrtp/2cA2dBg (small blind) collected ($4)
Seat 5: VvdR9F3I+2yELkfTVvC1dg (big blind) folded before Flop



PokerStars Game #59941051202:  Hold'em No Limit ($1/$2) - 2009/07/01 1:24:15 ET
Table 'uJ9juaXXg9yIcSU8amxaXQ' 6-max Seat #3 is the button
Seat 1: JsqOjN/eHz0uYVf/PyUJ6Q ($148.85 in chips)
Seat 2: VvdR9F3I+2yELkfTVvC1dg ($200 in chips)
Seat 3: qXDd0ZyMIse0OBu8pxeQ3Q ($253 in chips)
Seat 4: zNjJ/y4emmF+vzrCDd+ooA ($218.75 in chips)
Seat 5: YsLQ3BAvgQHWXMAv3Wv6Hg ($202 in chips)
Seat 6: 2DFp9Veq1xxq64dCjwNuUw ($55.60 in chips)
zNjJ/y4emmF+vzrCDd+ooA: posts small blind $1
YsLQ3BAvgQHWXMAv3Wv6Hg: posts big blind $2
*** HOLE CARDS ***
2DFp9Veq1xxq64dCjwNuUw: folds
JsqOjN/eHz0uYVf/PyUJ6Q: folds
VvdR9F3I+2yELkfTVvC1dg: folds
qXDd0ZyMIse0OBu8pxeQ3Q: raises $4 to $6
zNjJ/y4emmF+vzrCDd+ooA: calls $5
YsLQ3BAvgQHWXMAv3Wv6Hg: calls $4
*** FLOP *** [3h 6c 2h]
zNjJ/y4emmF+vzrCDd+ooA: bets $4
YsLQ3BAvgQHWXMAv3Wv6Hg: folds
qXDd0ZyMIse0OBu8pxeQ3Q: folds
zNjJ/y4emmF+vzrCDd+ooA collected $17.10 from pot
*** SUMMARY ***
Total pot $18 | Rake $0.90
Board [3h 6c 2h]
Seat 1: JsqOjN/eHz0uYVf/PyUJ6Q folded before Flop (didn't bet)
Seat 2: VvdR9F3I+2yELkfTVvC1dg folded before Flop (didn't bet)
Seat 3: qXDd0ZyMIse0OBu8pxeQ3Q (button) folded on the Flop
Seat 4: zNjJ/y4emmF+vzrCDd+ooA (small blind) collected ($17.10)
Seat 5: YsLQ3BAvgQHWXMAv3Wv6Hg (big blind) folded on the Flop
Seat 6: 2DFp9Veq1xxq64dCjwNuUw folded before Flop (didn't bet)



PokerStars Game #59941052750:  Hold'em No Limit ($1/$2) - 2009/07/01 1:24:17 ET
Table 'W9UeSV0aoPjh5SFSxM8jUQ' 9-max Seat #2 is the button
Seat 1: mIKx5lhIt13X5eZQH0ZeMA ($25 in chips)
Seat 2: iMe5yhc+1BaiIPHet3NMrA ($252.60 in chips)
Seat 3: /inIs/z/PcX+TniIFpaxpg ($26 in chips)
Seat 4: 4YA/sQy1Emm680zhbPUjow ($120 in chips)
Seat 5: ri8CLkX3e9JF34dQNbsHGA ($42.45 in chips)
Seat 6: j47DM+lqTfzZP8musviQTg ($110.90 in chips)
Seat 7: I2ipWauytvrkEer4XD3Sjg ($100 in chips)
Seat 8: odhvI/CZeMsPyo1n1U7+hA ($49.70 in chips)
Seat 9: Q104K4iDGcqOlVrjAkzPEA ($98.10 in chips)
/inIs/z/PcX+TniIFpaxpg: posts small blind $1
4YA/sQy1Emm680zhbPUjow: posts big blind $2
*** HOLE CARDS ***
ri8CLkX3e9JF34dQNbsHGA: folds
j47DM+lqTfzZP8musviQTg: folds
I2ipWauytvrkEer4XD3Sjg: raises $6 to $8
odhvI/CZeMsPyo1n1U7+hA: folds
Q104K4iDGcqOlVrjAkzPEA: folds
mIKx5lhIt13X5eZQH0ZeMA: folds
iMe5yhc+1BaiIPHet3NMrA: folds
/inIs/z/PcX+TniIFpaxpg: folds
4YA/sQy1Emm680zhbPUjow: raises $8 to $16
I2ipWauytvrkEer4XD3Sjg: calls $8
*** FLOP *** [2c 8d 8c]
4YA/sQy1Emm680zhbPUjow: checks
I2ipWauytvrkEer4XD3Sjg: checks
*** TURN *** [2c 8d 8c] [4c]
4YA/sQy1Emm680zhbPUjow: bets $12
I2ipWauytvrkEer4XD3Sjg: folds
4YA/sQy1Emm680zhbPUjow collected $31.35 from pot
*** SUMMARY ***
Total pot $33 | Rake $1.65
Board [2c 8d 8c 4c]
Seat 1: mIKx5lhIt13X5eZQH0ZeMA folded before Flop (didn't bet)
Seat 2: iMe5yhc+1BaiIPHet3NMrA (button) folded before Flop (didn't bet)
Seat 3: /inIs/z/PcX+TniIFpaxpg (small blind) folded before Flop
Seat 4: 4YA/sQy1Emm680zhbPUjow (big blind) collected ($31.35)
Seat 5: ri8CLkX3e9JF34dQNbsHGA folded before Flop (didn't bet)
Seat 6: j47DM+lqTfzZP8musviQTg folded before Flop (didn't bet)
Seat 7: I2ipWauytvrkEer4XD3Sjg folded on the Turn
Seat 8: odhvI/CZeMsPyo1n1U7+hA folded before Flop (didn't bet)
Seat 9: Q104K4iDGcqOlVrjAkzPEA folded before Flop (didn't bet)



PokerStars Game #59941054398:  Hold'em No Limit ($1/$2) - 2009/07/01 1:24:20 ET
Table 'QxerF7GUfCbl+4a8XaTB2w' 6-max Seat #3 is the button
Seat 1: 54yWzRRgS0oZ+S6LwZBxMQ ($37 in chips)
Seat 2: HiWSAXs6/0w9Jy7ioiiShQ ($40 in chips)
Seat 3: m7mYVfnCOK5TE/VkN/FhOg ($276.10 in chips)
Seat 4: 09BNF4quPDzanQzM8vc6WA ($42.55 in chips)
Seat 5: gnYme0DNFflnMhrdbxe1Ag ($200 in chips)
Seat 6: VvdR9F3I+2yELkfTVvC1dg ($209.40 in chips)
09BNF4quPDzanQzM8vc6WA: posts small blind $1
gnYme0DNFflnMhrdbxe1Ag: posts big blind $2
*** HOLE CARDS ***
VvdR9F3I+2yELkfTVvC1dg: raises $2 to $4
54yWzRRgS0oZ+S6LwZBxMQ: folds
HiWSAXs6/0w9Jy7ioiiShQ: calls $4
m7mYVfnCOK5TE/VkN/FhOg: calls $4
09BNF4quPDzanQzM8vc6WA: folds
gnYme0DNFflnMhrdbxe1Ag: calls $2
*** FLOP *** [9d Js 7h]
gnYme0DNFflnMhrdbxe1Ag: bets $10
VvdR9F3I+2yELkfTVvC1dg: calls $10
HiWSAXs6/0w9Jy7ioiiShQ: folds
m7mYVfnCOK5TE/VkN/FhOg: folds
*** TURN *** [9d Js 7h] [Kh]
gnYme0DNFflnMhrdbxe1Ag: checks
VvdR9F3I+2yELkfTVvC1dg: bets $25.70
gnYme0DNFflnMhrdbxe1Ag: calls $25.70
*** RIVER *** [9d Js 7h Kh] [Jd]
gnYme0DNFflnMhrdbxe1Ag: checks
VvdR9F3I+2yELkfTVvC1dg: checks
*** SHOW DOWN ***
gnYme0DNFflnMhrdbxe1Ag: shows [Th Jh] (three of a kind, Jacks)
VvdR9F3I+2yELkfTVvC1dg: mucks hand
gnYme0DNFflnMhrdbxe1Ag collected $85.40 from pot
*** SUMMARY ***
Total pot $88.40 | Rake $3
Board [9d Js 7h Kh Jd]
Seat 1: 54yWzRRgS0oZ+S6LwZBxMQ folded before Flop (didn't bet)
Seat 2: HiWSAXs6/0w9Jy7ioiiShQ folded on the Flop
Seat 3: m7mYVfnCOK5TE/VkN/FhOg (button) folded on the Flop
Seat 4: 09BNF4quPDzanQzM8vc6WA (small blind) folded before Flop
Seat 5: gnYme0DNFflnMhrdbxe1Ag (big blind) showed [Th Jh] and won ($85.40) with three of a kind, Jacks
Seat 6: VvdR9F3I+2yELkfTVvC1dg mucked



PokerStars Game #59941056148:  Hold'em No Limit ($1/$2) - 2009/07/01 1:24:23 ET
Table 'LL4bDFyhj5hsMpzaDugJZg' 6-max Seat #5 is the button
Seat 1: FwvID/fQGlpY3soi/lMTww ($87.50 in chips)
Seat 3: iI/NMpRxMkGieArQEhACSA ($293.75 in chips)
Seat 4: 8srN1dKQePlsv0GyTada+Q ($309.75 in chips)
Seat 5: A2GTwTiwkb1ilNWgW487Vg ($65.80 in chips)
Seat 6: 692Q4sfB0gTElzS0WMeg+A ($207.10 in chips)
692Q4sfB0gTElzS0WMeg+A: posts small blind $1
FwvID/fQGlpY3soi/lMTww: posts big blind $2
*** HOLE CARDS ***
iI/NMpRxMkGieArQEhACSA: raises $4 to $6
8srN1dKQePlsv0GyTada+Q: folds
A2GTwTiwkb1ilNWgW487Vg: folds
692Q4sfB0gTElzS0WMeg+A: raises $16 to $22
FwvID/fQGlpY3soi/lMTww: folds
iI/NMpRxMkGieArQEhACSA: folds
692Q4sfB0gTElzS0WMeg+A collected $14 from pot
*** SUMMARY ***
Total pot $14 | Rake $0
Seat 1: FwvID/fQGlpY3soi/lMTww (big blind) folded before Flop
Seat 3: iI/NMpRxMkGieArQEhACSA folded before Flop
Seat 4: 8srN1dKQePlsv0GyTada+Q folded before Flop (didn't bet)
Seat 5: A2GTwTiwkb1ilNWgW487Vg (button) folded before Flop (didn't bet)
Seat 6: 692Q4sfB0gTElzS0WMeg+A (small blind) collected ($14)



PokerStars Game #59941058786:  Hold'em No Limit ($1/$2) - 2009/07/01 1:24:28 ET
Table 'aSf77Sj8QEnzcc0WaxVD4Q' 6-max Seat #4 is the button
Seat 1: UELtvp+JfwI7XDGVwSxZXA ($165.75 in chips)
Seat 2: vkfxu8f/jMYKUk6Ly4eujw ($200 in chips)
Seat 3: 9dpyyjDTCed6nV7JhaUUpw ($520.35 in chips)
Seat 4: YsLQ3BAvgQHWXMAv3Wv6Hg ($262.70 in chips)
Seat 5: VvdR9F3I+2yELkfTVvC1dg ($246 in chips)
Seat 6: vkoJRf3gidxY1pPi0AFWww ($122.75 in chips)
VvdR9F3I+2yELkfTVvC1dg: posts small blind $1
vkoJRf3gidxY1pPi0AFWww: posts big blind $2
*** HOLE CARDS ***
UELtvp+JfwI7XDGVwSxZXA: folds
vkfxu8f/jMYKUk6Ly4eujw: folds
9dpyyjDTCed6nV7JhaUUpw: raises $4 to $6
YsLQ3BAvgQHWXMAv3Wv6Hg: folds
VvdR9F3I+2yELkfTVvC1dg: folds
vkoJRf3gidxY1pPi0AFWww: calls $4
*** FLOP *** [Th 3h 9h]
vkoJRf3gidxY1pPi0AFWww: checks
9dpyyjDTCed6nV7JhaUUpw: checks
*** TURN *** [Th 3h 9h] [3d]
vkoJRf3gidxY1pPi0AFWww: checks
9dpyyjDTCed6nV7JhaUUpw: bets $9
vkoJRf3gidxY1pPi0AFWww: folds
9dpyyjDTCed6nV7JhaUUpw collected $12.35 from pot
9dpyyjDTCed6nV7JhaUUpw: doesn't show hand
*** SUMMARY ***
Total pot $13 | Rake $0.65
Board [Th 3h 9h 3d]
Seat 1: UELtvp+JfwI7XDGVwSxZXA folded before Flop (didn't bet)
Seat 2: vkfxu8f/jMYKUk6Ly4eujw folded before Flop (didn't bet)
Seat 3: 9dpyyjDTCed6nV7JhaUUpw collected ($12.35)
Seat 4: YsLQ3BAvgQHWXMAv3Wv6Hg (button) folded before Flop (didn't bet)
Seat 5: VvdR9F3I+2yELkfTVvC1dg (small blind) folded before Flop
Seat 6: vkoJRf3gidxY1pPi0AFWww (big blind) folded on the Turn



PokerStars Game #59941059406:  Hold'em No Limit ($1/$2) - 2009/07/01 1:24:29 ET
Table 'bJQ024BaYSBrW0sXpCZbNQ' 6-max Seat #1 is the button
Seat 1: PCN5rt4TwI1pQE+rAiqI0Q ($304.60 in chips)
Seat 2: 3dAbvkxS5NPQTBAbvpinVg ($221.05 in chips)
Seat 3: vkfxu8f/jMYKUk6Ly4eujw ($233.05 in chips)
Seat 5: VvdR9F3I+2yELkfTVvC1dg ($202 in chips)
Seat 6: 9dpyyjDTCed6nV7JhaUUpw ($330.95 in chips)
3dAbvkxS5NPQTBAbvpinVg: posts small blind $1
vkfxu8f/jMYKUk6Ly4eujw: posts big blind $2
TBaQIN+sQ7eb7P99QnaORQ: sits out
*** HOLE CARDS ***
VvdR9F3I+2yELkfTVvC1dg: folds
9dpyyjDTCed6nV7JhaUUpw: raises $4 to $6
PCN5rt4TwI1pQE+rAiqI0Q has timed out
PCN5rt4TwI1pQE+rAiqI0Q: folds
PCN5rt4TwI1pQE+rAiqI0Q is sitting out
3dAbvkxS5NPQTBAbvpinVg: folds
vkfxu8f/jMYKUk6Ly4eujw: folds
9dpyyjDTCed6nV7JhaUUpw collected $5 from pot
9dpyyjDTCed6nV7JhaUUpw: doesn't show hand
*** SUMMARY ***
Total pot $5 | Rake $0
Seat 1: PCN5rt4TwI1pQE+rAiqI0Q (button) folded before Flop (didn't bet)
Seat 2: 3dAbvkxS5NPQTBAbvpinVg (small blind) folded before Flop
Seat 3: vkfxu8f/jMYKUk6Ly4eujw (big blind) folded before Flop
Seat 5: VvdR9F3I+2yELkfTVvC1dg folded before Flop (didn't bet)
Seat 6: 9dpyyjDTCed6nV7JhaUUpw collected ($5)



PokerStars Game #59941060928:  Hold'em No Limit ($1/$2) - 2009/07/01 1:24:31 ET
Table 'gnHBqWll9O3fxG7Ojkz/ng' 9-max Seat #8 is the button
Seat 1: TAfo4veNRaRlzDXMMYS3Jg ($37 in chips)
Seat 2: H6Z4+qu8gR0VUiPOijndVg ($343.25 in chips)
Seat 3: 5Q8U6iZbeO7xJSS4qvDP5g ($215 in chips)
Seat 5: rBQDMkKm9cZn6M9NPsiVew ($236.45 in chips)
Seat 6: /inIs/z/PcX+TniIFpaxpg ($46.75 in chips)
Seat 7: jqui3xAWCkcdPW36a6BD+w ($344.95 in chips)
Seat 8: cM6efHzdxoqYm0EQKP4TTQ ($98.05 in chips)
Seat 9: GX1heJ+DSsvm7gzSPsYhhQ ($38 in chips)
GX1heJ+DSsvm7gzSPsYhhQ: posts small blind $1
TAfo4veNRaRlzDXMMYS3Jg: posts big blind $2
nXDI8Y/S6POzRwANu3d8hQ: sits out
*** HOLE CARDS ***
H6Z4+qu8gR0VUiPOijndVg: raises $4 to $6
5Q8U6iZbeO7xJSS4qvDP5g: folds
rBQDMkKm9cZn6M9NPsiVew: folds
/inIs/z/PcX+TniIFpaxpg: folds
jqui3xAWCkcdPW36a6BD+w: folds
cM6efHzdxoqYm0EQKP4TTQ: folds
GX1heJ+DSsvm7gzSPsYhhQ: calls $5
TAfo4veNRaRlzDXMMYS3Jg: folds
*** FLOP *** [Jc 2c Ah]
GX1heJ+DSsvm7gzSPsYhhQ: checks
H6Z4+qu8gR0VUiPOijndVg: checks
*** TURN *** [Jc 2c Ah] [7c]
GX1heJ+DSsvm7gzSPsYhhQ: bets $10
H6Z4+qu8gR0VUiPOijndVg: calls $10
*** RIVER *** [Jc 2c Ah 7c] [Td]
GX1heJ+DSsvm7gzSPsYhhQ: bets $22 and is all-in
H6Z4+qu8gR0VUiPOijndVg: folds
GX1heJ+DSsvm7gzSPsYhhQ collected $32.35 from pot
GX1heJ+DSsvm7gzSPsYhhQ: doesn't show hand
*** SUMMARY ***
Total pot $34 | Rake $1.65
Board [Jc 2c Ah 7c Td]
Seat 1: TAfo4veNRaRlzDXMMYS3Jg (big blind) folded before Flop
Seat 2: H6Z4+qu8gR0VUiPOijndVg folded on the River
Seat 3: 5Q8U6iZbeO7xJSS4qvDP5g folded before Flop (didn't bet)
Seat 5: rBQDMkKm9cZn6M9NPsiVew folded before Flop (didn't bet)
Seat 6: /inIs/z/PcX+TniIFpaxpg folded before Flop (didn't bet)
Seat 7: jqui3xAWCkcdPW36a6BD+w folded before Flop (didn't bet)
Seat 8: cM6efHzdxoqYm0EQKP4TTQ (button) folded before Flop (didn't bet)
Seat 9: GX1heJ+DSsvm7gzSPsYhhQ (small blind) collected ($32.35)



PokerStars Game #59941061240:  Hold'em No Limit ($1/$2) - 2009/07/01 1:24:32 ET
Table 'mGpP9StWRnoeiBDExc6Frg' 6-max Seat #6 is the button
Seat 1: VvdR9F3I+2yELkfTVvC1dg ($200 in chips)
Seat 2: dZcLsEI8iXkobBduRJ45Yw ($76.15 in chips)
Seat 3: 7acrZUQC3Zc9BNLjoKIcLQ ($45.35 in chips)
Seat 4: 4dcDwIHRm96PwtqkpQiuiA ($87.70 in chips)
Seat 5: d1puGuVBE0fidn+5eRJ0tw ($171.85 in chips)
Seat 6: B2Ih1sr5VZk+8He7rcrMtQ ($466.05 in chips)
VvdR9F3I+2yELkfTVvC1dg: posts small blind $1
dZcLsEI8iXkobBduRJ45Yw: posts big blind $2
*** HOLE CARDS ***
7acrZUQC3Zc9BNLjoKIcLQ: calls $2
4dcDwIHRm96PwtqkpQiuiA: folds
d1puGuVBE0fidn+5eRJ0tw: calls $2
B2Ih1sr5VZk+8He7rcrMtQ: folds
VvdR9F3I+2yELkfTVvC1dg: folds
dZcLsEI8iXkobBduRJ45Yw: checks
*** FLOP *** [5s 3d Td]
dZcLsEI8iXkobBduRJ45Yw: checks
7acrZUQC3Zc9BNLjoKIcLQ: bets $6
d1puGuVBE0fidn+5eRJ0tw: raises $46 to $52
dZcLsEI8iXkobBduRJ45Yw: folds
7acrZUQC3Zc9BNLjoKIcLQ: folds
d1puGuVBE0fidn+5eRJ0tw collected $18.10 from pot
d1puGuVBE0fidn+5eRJ0tw: doesn't show hand
*** SUMMARY ***
Total pot $19 | Rake $0.90
Board [5s 3d Td]
Seat 1: VvdR9F3I+2yELkfTVvC1dg (small blind) folded before Flop
Seat 2: dZcLsEI8iXkobBduRJ45Yw (big blind) folded on the Flop
Seat 3: 7acrZUQC3Zc9BNLjoKIcLQ folded on the Flop
Seat 4: 4dcDwIHRm96PwtqkpQiuiA folded before Flop (didn't bet)
Seat 5: d1puGuVBE0fidn+5eRJ0tw collected ($18.10)
Seat 6: B2Ih1sr5VZk+8He7rcrMtQ (button) folded before Flop (didn't bet)



PokerStars Game #59941061092:  Hold'em No Limit ($1/$2) - 2009/07/01 1:24:32 ET
Table 'pPQgcj9XT9CHBsbo1WTBug' 6-max Seat #6 is the button
Seat 1: DFVYDA6dKQy7R7mGIKogZA ($126.65 in chips)
Seat 2: qXDd0ZyMIse0OBu8pxeQ3Q ($208.30 in chips)
Seat 3: 54yWzRRgS0oZ+S6LwZBxMQ ($64.75 in chips)
Seat 4: gqlysXCbT8V54f/1lf9h3A ($17.55 in chips)
Seat 5: vkfxu8f/jMYKUk6Ly4eujw ($228.10 in chips)
Seat 6: Yr7pZltpy3IUNdKS9PCEiw ($304.30 in chips)
DFVYDA6dKQy7R7mGIKogZA: posts small blind $1
qXDd0ZyMIse0OBu8pxeQ3Q: posts big blind $2
*** HOLE CARDS ***
54yWzRRgS0oZ+S6LwZBxMQ: folds
gqlysXCbT8V54f/1lf9h3A: calls $2
vkfxu8f/jMYKUk6Ly4eujw: raises $8 to $10
Yr7pZltpy3IUNdKS9PCEiw: folds
DFVYDA6dKQy7R7mGIKogZA: folds
qXDd0ZyMIse0OBu8pxeQ3Q: folds
gqlysXCbT8V54f/1lf9h3A: calls $8
*** FLOP *** [Jc Ts 5d]
gqlysXCbT8V54f/1lf9h3A: checks
vkfxu8f/jMYKUk6Ly4eujw: bets $21
gqlysXCbT8V54f/1lf9h3A: calls $7.55 and is all-in
*** TURN *** [Jc Ts 5d] [5c]
*** RIVER *** [Jc Ts 5d 5c] [Jd]
*** SHOW DOWN ***
gqlysXCbT8V54f/1lf9h3A: shows [Td Js] (a full house, Jacks full of Tens)
vkfxu8f/jMYKUk6Ly4eujw: mucks hand
gqlysXCbT8V54f/1lf9h3A collected $36.30 from pot
*** SUMMARY ***
Total pot $38.10 | Rake $1.80
Board [Jc Ts 5d 5c Jd]
Seat 1: DFVYDA6dKQy7R7mGIKogZA (small blind) folded before Flop
Seat 2: qXDd0ZyMIse0OBu8pxeQ3Q (big blind) folded before Flop
Seat 3: 54yWzRRgS0oZ+S6LwZBxMQ folded before Flop (didn't bet)
Seat 4: gqlysXCbT8V54f/1lf9h3A showed [Td Js] and won ($36.30) with a full house, Jacks full of Tens
Seat 5: vkfxu8f/jMYKUk6Ly4eujw mucked
Seat 6: Yr7pZltpy3IUNdKS9PCEiw (button) folded before Flop (didn't bet)



PokerStars Game #59941061566:  Hold'em No Limit ($1/$2) - 2009/07/01 1:24:32 ET
Table 'C4lkCXY2PWy6z4vsAe5NGQ' 6-max Seat #1 is the button
Seat 1: 4bqvCfJ0e8CTYnn0Go9hbQ ($61.60 in chips)
Seat 2: 6hRJ68JkbJq6MYI9o5bUnQ ($32.40 in chips)
Seat 3: sTPOWERd9HWPCNrDBwsVjA ($144.80 in chips)
Seat 4: VvdR9F3I+2yELkfTVvC1dg ($234.15 in chips)
Seat 5: dKvrkfQx2Peke3ikZLUy1w ($61.55 in chips)
Seat 6: B87ikIyZ/TzAVeXf38Ny0g ($657.75 in chips)
6hRJ68JkbJq6MYI9o5bUnQ: posts small blind $1
sTPOWERd9HWPCNrDBwsVjA: posts big blind $2
*** HOLE CARDS ***
VvdR9F3I+2yELkfTVvC1dg: folds
dKvrkfQx2Peke3ikZLUy1w: raises $4 to $6
B87ikIyZ/TzAVeXf38Ny0g: folds
4bqvCfJ0e8CTYnn0Go9hbQ: calls $6
6hRJ68JkbJq6MYI9o5bUnQ: folds
sTPOWERd9HWPCNrDBwsVjA: folds
*** FLOP *** [3d Ts 7c]
dKvrkfQx2Peke3ikZLUy1w: bets $10
4bqvCfJ0e8CTYnn0Go9hbQ: folds
dKvrkfQx2Peke3ikZLUy1w collected $14.25 from pot
dKvrkfQx2Peke3ikZLUy1w: doesn't show hand
*** SUMMARY ***
Total pot $15 | Rake $0.75
Board [3d Ts 7c]
Seat 1: 4bqvCfJ0e8CTYnn0Go9hbQ (button) folded on the Flop
Seat 2: 6hRJ68JkbJq6MYI9o5bUnQ (small blind) folded before Flop
Seat 3: sTPOWERd9HWPCNrDBwsVjA (big blind) folded before Flop
Seat 4: VvdR9F3I+2yELkfTVvC1dg folded before Flop (didn't bet)
Seat 5: dKvrkfQx2Peke3ikZLUy1w collected ($14.25)
Seat 6: B87ikIyZ/TzAVeXf38Ny0g folded before Flop (didn't bet)



PokerStars Game #59941062304:  Hold'em No Limit ($1/$2) - 2009/07/01 1:24:33 ET
Table 'ZzSIe0zTCDv+n6hfbY5tTg' 6-max Seat #2 is the button
Seat 1: VvdR9F3I+2yELkfTVvC1dg ($212.10 in chips)
Seat 2: B87ikIyZ/TzAVeXf38Ny0g ($241 in chips)
Seat 3: gsugPj31Hui3Jefl98MBOA ($200.65 in chips)
Seat 4: qXDd0ZyMIse0OBu8pxeQ3Q ($212.70 in chips)
Seat 5: 3dAbvkxS5NPQTBAbvpinVg ($483.30 in chips)
Seat 6: 09BNF4quPDzanQzM8vc6WA ($23.05 in chips)
gsugPj31Hui3Jefl98MBOA: posts small blind $1
qXDd0ZyMIse0OBu8pxeQ3Q: posts big blind $2
*** HOLE CARDS ***
3dAbvkxS5NPQTBAbvpinVg: folds
09BNF4quPDzanQzM8vc6WA: folds
VvdR9F3I+2yELkfTVvC1dg: raises $2 to $4
B87ikIyZ/TzAVeXf38Ny0g: folds
gsugPj31Hui3Jefl98MBOA: calls $3
qXDd0ZyMIse0OBu8pxeQ3Q: folds
*** FLOP *** [Kc 5h 7s]
gsugPj31Hui3Jefl98MBOA: checks
VvdR9F3I+2yELkfTVvC1dg: bets $7.10
gsugPj31Hui3Jefl98MBOA: calls $7.10
*** TURN *** [Kc 5h 7s] [2h]
gsugPj31Hui3Jefl98MBOA: checks
VvdR9F3I+2yELkfTVvC1dg: checks
*** RIVER *** [Kc 5h 7s 2h] [2d]
gsugPj31Hui3Jefl98MBOA: bets $15
VvdR9F3I+2yELkfTVvC1dg: folds
gsugPj31Hui3Jefl98MBOA collected $23.05 from pot
*** SUMMARY ***
Total pot $24.20 | Rake $1.15
Board [Kc 5h 7s 2h 2d]
Seat 1: VvdR9F3I+2yELkfTVvC1dg folded on the River
Seat 2: B87ikIyZ/TzAVeXf38Ny0g (button) folded before Flop (didn't bet)
Seat 3: gsugPj31Hui3Jefl98MBOA (small blind) collected ($23.05)
Seat 4: qXDd0ZyMIse0OBu8pxeQ3Q (big blind) folded before Flop
Seat 5: 3dAbvkxS5NPQTBAbvpinVg folded before Flop (didn't bet)
Seat 6: 09BNF4quPDzanQzM8vc6WA folded before Flop (didn't bet)



PokerStars Game #59941062254:  Hold'em No Limit ($1/$2) - 2009/07/01 1:24:33 ET
Table 'eyAQSIlgc2o1Jxvbve4WGg' 9-max Seat #2 is the button
Seat 1: UZEsV9yKUMqmpYPiOFpaZw ($105.20 in chips)
Seat 2: g7gL2NLJCdZPPV399WKT1w ($76.25 in chips)
Seat 3: ice1Sbe19zWIaKYoSmE5tw ($97.30 in chips)
Seat 4: CkE3IyJF1KvdaAOmZY5XqQ ($200 in chips)
Seat 5: mIKx5lhIt13X5eZQH0ZeMA ($77.10 in chips)
Seat 8: 1CtiZuXDFaJL1dJPQKyi8Q ($158.35 in chips)
Seat 9: WUlHm+ydPPHG7Lb0rePSdA ($120.70 in chips)
ice1Sbe19zWIaKYoSmE5tw: posts small blind $1
CkE3IyJF1KvdaAOmZY5XqQ: posts big blind $2
nXDI8Y/S6POzRwANu3d8hQ: sits out
*** HOLE CARDS ***
mIKx5lhIt13X5eZQH0ZeMA: calls $2
1CtiZuXDFaJL1dJPQKyi8Q: folds
WUlHm+ydPPHG7Lb0rePSdA: folds
UZEsV9yKUMqmpYPiOFpaZw: folds
g7gL2NLJCdZPPV399WKT1w: folds
ice1Sbe19zWIaKYoSmE5tw: calls $1
CkE3IyJF1KvdaAOmZY5XqQ: checks
*** FLOP *** [Qh Ts 9s]
ice1Sbe19zWIaKYoSmE5tw: checks
CkE3IyJF1KvdaAOmZY5XqQ: checks
mIKx5lhIt13X5eZQH0ZeMA: bets $4
ice1Sbe19zWIaKYoSmE5tw: folds
CkE3IyJF1KvdaAOmZY5XqQ: folds
mIKx5lhIt13X5eZQH0ZeMA collected $5.70 from pot
mIKx5lhIt13X5eZQH0ZeMA: doesn't show hand
*** SUMMARY ***
Total pot $6 | Rake $0.30
Board [Qh Ts 9s]
Seat 1: UZEsV9yKUMqmpYPiOFpaZw folded before Flop (didn't bet)
Seat 2: g7gL2NLJCdZPPV399WKT1w (button) folded before Flop (didn't bet)
Seat 3: ice1Sbe19zWIaKYoSmE5tw (small blind) folded on the Flop
Seat 4: CkE3IyJF1KvdaAOmZY5XqQ (big blind) folded on the Flop
Seat 5: mIKx5lhIt13X5eZQH0ZeMA collected ($5.70)
Seat 8: 1CtiZuXDFaJL1dJPQKyi8Q folded before Flop (didn't bet)
Seat 9: WUlHm+ydPPHG7Lb0rePSdA folded before Flop (didn't bet)



PokerStars Game #59941063496:  Hold'em No Limit ($1/$2) - 2009/07/01 1:24:35 ET
Table 'kq5zaQ+1hLNf8LZfGnbTAA' 6-max Seat #3 is the button
Seat 1: 8srN1dKQePlsv0GyTada+Q ($200 in chips)
Seat 2: nXDI8Y/S6POzRwANu3d8hQ ($68.80 in chips)
Seat 3: vkfxu8f/jMYKUk6Ly4eujw ($224.95 in chips)
Seat 4: 3dAbvkxS5NPQTBAbvpinVg ($200 in chips)
Seat 5: kfASJqTbXek+zc8ZKsZL1Q ($281.50 in chips)
Seat 6: mfy7uGZcqA2PVQqEVbJ7+g ($191.25 in chips)
3dAbvkxS5NPQTBAbvpinVg: posts small blind $1
kfASJqTbXek+zc8ZKsZL1Q: posts big blind $2
*** HOLE CARDS ***
mfy7uGZcqA2PVQqEVbJ7+g: folds
8srN1dKQePlsv0GyTada+Q: raises $4 to $6
nXDI8Y/S6POzRwANu3d8hQ: folds
vkfxu8f/jMYKUk6Ly4eujw: folds
3dAbvkxS5NPQTBAbvpinVg: folds
kfASJqTbXek+zc8ZKsZL1Q: folds
8srN1dKQePlsv0GyTada+Q collected $5 from pot
8srN1dKQePlsv0GyTada+Q: doesn't show hand
*** SUMMARY ***
Total pot $5 | Rake $0
Seat 1: 8srN1dKQePlsv0GyTada+Q collected ($5)
Seat 2: nXDI8Y/S6POzRwANu3d8hQ folded before Flop (didn't bet)
Seat 3: vkfxu8f/jMYKUk6Ly4eujw (button) folded before Flop (didn't bet)
Seat 4: 3dAbvkxS5NPQTBAbvpinVg (small blind) folded before Flop
Seat 5: kfASJqTbXek+zc8ZKsZL1Q (big blind) folded before Flop
Seat 6: mfy7uGZcqA2PVQqEVbJ7+g folded before Flop (didn't bet)



PokerStars Game #59941063380:  Hold'em No Limit ($1/$2) - 2009/07/01 1:24:35 ET
Table '/dyk+YdRGv90j2box35j8w' 6-max Seat #4 is the button
Seat 1: 8srN1dKQePlsv0GyTada+Q ($200 in chips)
Seat 2: qCnEYuAE5y5A7bk6fO5/jQ ($475.60 in chips)
Seat 3: sTPOWERd9HWPCNrDBwsVjA ($188.75 in chips)
Seat 4: z/u1YTnkiIDrtp/2cA2dBg ($196.65 in chips)
Seat 5: VvdR9F3I+2yELkfTVvC1dg ($200 in chips)
VvdR9F3I+2yELkfTVvC1dg: posts small blind $1
8srN1dKQePlsv0GyTada+Q: posts big blind $2
*** HOLE CARDS ***
qCnEYuAE5y5A7bk6fO5/jQ: folds
sTPOWERd9HWPCNrDBwsVjA: folds
z/u1YTnkiIDrtp/2cA2dBg: folds
VvdR9F3I+2yELkfTVvC1dg: folds
8srN1dKQePlsv0GyTada+Q collected $2 from pot
8srN1dKQePlsv0GyTada+Q: doesn't show hand
*** SUMMARY ***
Total pot $2 | Rake $0
Seat 1: 8srN1dKQePlsv0GyTada+Q (big blind) collected ($2)
Seat 2: qCnEYuAE5y5A7bk6fO5/jQ folded before Flop (didn't bet)
Seat 3: sTPOWERd9HWPCNrDBwsVjA folded before Flop (didn't bet)
Seat 4: z/u1YTnkiIDrtp/2cA2dBg (button) folded before Flop (didn't bet)
Seat 5: VvdR9F3I+2yELkfTVvC1dg (small blind) folded before Flop



PokerStars Game #59941064494:  Hold'em No Limit ($1/$2) - 2009/07/01 1:24:37 ET
Table 'YqGfR5eHfMeSjb9a+QU9rg' 9-max Seat #3 is the button
Seat 1: rW/MyplHylMSBRaoRUzWrg ($34 in chips)
Seat 2: W3Nqt1GWlTi9tXQXMNEvgw ($386.25 in chips)
Seat 3: /gll27k+xWYV7Fbki0lFDQ ($267.75 in chips)
Seat 5: CkE3IyJF1KvdaAOmZY5XqQ ($200 in chips)
Seat 6: TAfo4veNRaRlzDXMMYS3Jg ($37 in chips)
Seat 7: 41aZuLBz9nAi2GPVKabmCw ($96.50 in chips)
Seat 8: JnV3SM2D6dAFYyGZHHpvrg ($101.25 in chips)
Seat 9: /inIs/z/PcX+TniIFpaxpg ($206.05 in chips)
CkE3IyJF1KvdaAOmZY5XqQ: posts small blind $1
TAfo4veNRaRlzDXMMYS3Jg: posts big blind $2
*** HOLE CARDS ***
41aZuLBz9nAi2GPVKabmCw: raises $4 to $6
JnV3SM2D6dAFYyGZHHpvrg: folds
/inIs/z/PcX+TniIFpaxpg: calls $6
rW/MyplHylMSBRaoRUzWrg: folds
W3Nqt1GWlTi9tXQXMNEvgw: folds
/gll27k+xWYV7Fbki0lFDQ: calls $6
CkE3IyJF1KvdaAOmZY5XqQ: folds
TAfo4veNRaRlzDXMMYS3Jg: folds
*** FLOP *** [Kd 4h 9c]
41aZuLBz9nAi2GPVKabmCw: bets $12
/inIs/z/PcX+TniIFpaxpg: folds
/gll27k+xWYV7Fbki0lFDQ: folds
41aZuLBz9nAi2GPVKabmCw collected $19.95 from pot
*** SUMMARY ***
Total pot $21 | Rake $1.05
Board [Kd 4h 9c]
Seat 1: rW/MyplHylMSBRaoRUzWrg folded before Flop (didn't bet)
Seat 2: W3Nqt1GWlTi9tXQXMNEvgw folded before Flop (didn't bet)
Seat 3: /gll27k+xWYV7Fbki0lFDQ (button) folded on the Flop
Seat 5: CkE3IyJF1KvdaAOmZY5XqQ (small blind) folded before Flop
Seat 6: TAfo4veNRaRlzDXMMYS3Jg (big blind) folded before Flop
Seat 7: 41aZuLBz9nAi2GPVKabmCw collected ($19.95)
Seat 8: JnV3SM2D6dAFYyGZHHpvrg folded before Flop (didn't bet)
Seat 9: /inIs/z/PcX+TniIFpaxpg folded on the Flop



PokerStars Game #59941064262:  Hold'em No Limit ($1/$2) - 2009/07/01 1:24:37 ET
Table 'AtOXMvcrtQM8yLNcALmfLQ' 2-max Seat #2 is the button
Seat 1: +HlQuAsMqZGYYtjcPO/a3A ($109.90 in chips)
Seat 2: pVqEzK9wXlRMECnb1Zg4Zw ($285.80 in chips)
pVqEzK9wXlRMECnb1Zg4Zw: posts small blind $1
+HlQuAsMqZGYYtjcPO/a3A: posts big blind $2
*** HOLE CARDS ***
pVqEzK9wXlRMECnb1Zg4Zw: raises $6 to $8
+HlQuAsMqZGYYtjcPO/a3A: folds
pVqEzK9wXlRMECnb1Zg4Zw collected $4 from pot
pVqEzK9wXlRMECnb1Zg4Zw: doesn't show hand
*** SUMMARY ***
Total pot $4 | Rake $0
Seat 1: +HlQuAsMqZGYYtjcPO/a3A (big blind) folded before Flop
Seat 2: pVqEzK9wXlRMECnb1Zg4Zw (button) (small blind) collected ($4)



PokerStars Game #59941065392:  Hold'em No Limit ($1/$2) - 2009/07/01 1:24:39 ET
Table 'TsEDkiO4tzCTCzJ7tNdEqw' 6-max Seat #1 is the button
Seat 1: MfXQsYD8pGeCS7XOtyV+vw ($98.25 in chips)
Seat 2: 4dcDwIHRm96PwtqkpQiuiA ($82.10 in chips)
Seat 4: K8MXCrNAVYlMnnCeM32Kxw ($90.05 in chips)
Seat 5: VvdR9F3I+2yELkfTVvC1dg ($200 in chips)
Seat 6: uCqEjnxh2/vFBjKYkfTOkw ($224.35 in chips)
4dcDwIHRm96PwtqkpQiuiA: posts small blind $1
K8MXCrNAVYlMnnCeM32Kxw: posts big blind $2
*** HOLE CARDS ***
VvdR9F3I+2yELkfTVvC1dg: raises $2 to $4
wgRvjVPZSQvqNGiyR1jwSA leaves the table
uCqEjnxh2/vFBjKYkfTOkw: calls $4
MfXQsYD8pGeCS7XOtyV+vw: folds
4dcDwIHRm96PwtqkpQiuiA: folds
ubtx4Z5L+AcK71MTvYiGVw joins the table at seat #3
K8MXCrNAVYlMnnCeM32Kxw: calls $2
*** FLOP *** [7h 7d Qd]
K8MXCrNAVYlMnnCeM32Kxw: checks
VvdR9F3I+2yELkfTVvC1dg: checks
uCqEjnxh2/vFBjKYkfTOkw: bets $10
MfXQsYD8pGeCS7XOtyV+vw said, "get paid!"
K8MXCrNAVYlMnnCeM32Kxw: calls $10
VvdR9F3I+2yELkfTVvC1dg: folds
*** TURN *** [7h 7d Qd] [5d]
K8MXCrNAVYlMnnCeM32Kxw: checks
uCqEjnxh2/vFBjKYkfTOkw: checks
*** RIVER *** [7h 7d Qd 5d] [2c]
K8MXCrNAVYlMnnCeM32Kxw: checks
uCqEjnxh2/vFBjKYkfTOkw: checks
*** SHOW DOWN ***
K8MXCrNAVYlMnnCeM32Kxw: shows [7s 9c] (three of a kind, Sevens)
uCqEjnxh2/vFBjKYkfTOkw: mucks hand
K8MXCrNAVYlMnnCeM32Kxw collected $31.40 from pot
*** SUMMARY ***
Total pot $33 | Rake $1.60
Board [7h 7d Qd 5d 2c]
Seat 1: MfXQsYD8pGeCS7XOtyV+vw (button) folded before Flop (didn't bet)
Seat 2: 4dcDwIHRm96PwtqkpQiuiA (small blind) folded before Flop
Seat 4: K8MXCrNAVYlMnnCeM32Kxw (big blind) showed [7s 9c] and won ($31.40) with three of a kind, Sevens
Seat 5: VvdR9F3I+2yELkfTVvC1dg folded on the Flop
Seat 6: uCqEjnxh2/vFBjKYkfTOkw mucked



PokerStars Game #59941066170:  Hold'em No Limit ($1/$2) - 2009/07/01 1:24:40 ET
Table 'rKeCh+eBn4RNvybCUYkoTQ' 9-max Seat #7 is the button
Seat 1: /inIs/z/PcX+TniIFpaxpg ($203 in chips)
Seat 2: 9cBHwK40Tl06vheE7B3LHQ ($156.55 in chips)
Seat 3: GX1heJ+DSsvm7gzSPsYhhQ ($34 in chips)
Seat 4: 31HuO+DQxppUQEedBWukug ($89.10 in chips)
Seat 5: WUlHm+ydPPHG7Lb0rePSdA ($128 in chips)
Seat 6: EBV6OktyeSmh4w6sWmcWOw ($267 in chips)
Seat 7: rW/MyplHylMSBRaoRUzWrg ($34 in chips)
Seat 8: pN/Ip0ePsUVIdUlGgLrkUw ($216.35 in chips)
Seat 9: Kzta8yu9vxHT4B70mjBZ+w ($211.25 in chips)
pN/Ip0ePsUVIdUlGgLrkUw: posts small blind $1
Kzta8yu9vxHT4B70mjBZ+w: posts big blind $2
*** HOLE CARDS ***
/inIs/z/PcX+TniIFpaxpg: folds
9cBHwK40Tl06vheE7B3LHQ: raises $4 to $6
GX1heJ+DSsvm7gzSPsYhhQ: folds
31HuO+DQxppUQEedBWukug: folds
WUlHm+ydPPHG7Lb0rePSdA: folds
EBV6OktyeSmh4w6sWmcWOw: folds
rW/MyplHylMSBRaoRUzWrg: folds
pN/Ip0ePsUVIdUlGgLrkUw: folds
Kzta8yu9vxHT4B70mjBZ+w: folds
9cBHwK40Tl06vheE7B3LHQ collected $5 from pot
9cBHwK40Tl06vheE7B3LHQ: doesn't show hand
*** SUMMARY ***
Total pot $5 | Rake $0
Seat 1: /inIs/z/PcX+TniIFpaxpg folded before Flop (didn't bet)
Seat 2: 9cBHwK40Tl06vheE7B3LHQ collected ($5)
Seat 3: GX1heJ+DSsvm7gzSPsYhhQ folded before Flop (didn't bet)
Seat 4: 31HuO+DQxppUQEedBWukug folded before Flop (didn't bet)
Seat 5: WUlHm+ydPPHG7Lb0rePSdA folded before Flop (didn't bet)
Seat 6: EBV6OktyeSmh4w6sWmcWOw folded before Flop (didn't bet)
Seat 7: rW/MyplHylMSBRaoRUzWrg (button) folded before Flop (didn't bet)
Seat 8: pN/Ip0ePsUVIdUlGgLrkUw (small blind) folded before Flop
Seat 9: Kzta8yu9vxHT4B70mjBZ+w (big blind) folded before Flop



PokerStars Game #59941066070:  Hold'em No Limit ($1/$2) - 2009/07/01 1:24:40 ET
Table 'NmY84NAf9Mh0ckAckHnh5g' 2-max Seat #1 is the button
Seat 1: 6hvg964TSqZ3AL/0XK9aVQ ($216.60 in chips)
Seat 2: RwDoM55ZeQuI2ADyJhOb2Q ($788.40 in chips)
6hvg964TSqZ3AL/0XK9aVQ: posts small blind $1
RwDoM55ZeQuI2ADyJhOb2Q: posts big blind $2
*** HOLE CARDS ***
6hvg964TSqZ3AL/0XK9aVQ: calls $1
RwDoM55ZeQuI2ADyJhOb2Q: raises $6 to $8
6hvg964TSqZ3AL/0XK9aVQ: calls $6
*** FLOP *** [Ts Qs Ac]
RwDoM55ZeQuI2ADyJhOb2Q: bets $12
6hvg964TSqZ3AL/0XK9aVQ: folds
RwDoM55ZeQuI2ADyJhOb2Q collected $15.50 from pot
RwDoM55ZeQuI2ADyJhOb2Q: doesn't show hand
*** SUMMARY ***
Total pot $16 | Rake $0.50
Board [Ts Qs Ac]
Seat 1: 6hvg964TSqZ3AL/0XK9aVQ (button) (small blind) folded on the Flop
Seat 2: RwDoM55ZeQuI2ADyJhOb2Q (big blind) collected ($15.50)



PokerStars Game #59941066412:  Hold'em No Limit ($1/$2) - 2009/07/01 1:24:41 ET
Table '8Y6PEyoNuepZTai2Q56aHw' 9-max Seat #2 is the button
Seat 1: 5Q8U6iZbeO7xJSS4qvDP5g ($298.10 in chips)
Seat 2: gDCJIAlovbPnTvMM7Dd1gA ($173.35 in chips)
Seat 3: WUlHm+ydPPHG7Lb0rePSdA ($126.30 in chips)
Seat 4: xKkwALG38OfLQ9DXuJgR1w ($284.55 in chips)
Seat 6: NtLDBSjsJQEKekh5cdinvw ($361.20 in chips)
Seat 7: Kzta8yu9vxHT4B70mjBZ+w ($210.30 in chips)
Seat 8: rW/MyplHylMSBRaoRUzWrg ($37 in chips)
Seat 9: F7m34OOfAQ7annesMHVjKw ($65.80 in chips)
WUlHm+ydPPHG7Lb0rePSdA: posts small blind $1
xKkwALG38OfLQ9DXuJgR1w: posts big blind $2
*** HOLE CARDS ***
NtLDBSjsJQEKekh5cdinvw: folds
Kzta8yu9vxHT4B70mjBZ+w: folds
rW/MyplHylMSBRaoRUzWrg: folds
F7m34OOfAQ7annesMHVjKw: raises $4 to $6
5Q8U6iZbeO7xJSS4qvDP5g: folds
gDCJIAlovbPnTvMM7Dd1gA: calls $6
WUlHm+ydPPHG7Lb0rePSdA: calls $5
xKkwALG38OfLQ9DXuJgR1w: calls $4
*** FLOP *** [9d Jc 6s]
WUlHm+ydPPHG7Lb0rePSdA: bets $16
xKkwALG38OfLQ9DXuJgR1w: calls $16
F7m34OOfAQ7annesMHVjKw: raises $43.80 to $59.80 and is all-in
gDCJIAlovbPnTvMM7Dd1gA: folds
WUlHm+ydPPHG7Lb0rePSdA: raises $60.50 to $120.30 and is all-in
xKkwALG38OfLQ9DXuJgR1w: folds
*** TURN *** [9d Jc 6s] [8s]
*** RIVER *** [9d Jc 6s 8s] [5s]
*** SHOW DOWN ***
WUlHm+ydPPHG7Lb0rePSdA: shows [Js Ad] (a pair of Jacks)
F7m34OOfAQ7annesMHVjKw: mucks hand
WUlHm+ydPPHG7Lb0rePSdA collected $156.60 from pot
*** SUMMARY ***
Total pot $159.60 | Rake $3
Board [9d Jc 6s 8s 5s]
Seat 1: 5Q8U6iZbeO7xJSS4qvDP5g folded before Flop (didn't bet)
Seat 2: gDCJIAlovbPnTvMM7Dd1gA (button) folded on the Flop
Seat 3: WUlHm+ydPPHG7Lb0rePSdA (small blind) showed [Js Ad] and won ($156.60) with a pair of Jacks
Seat 4: xKkwALG38OfLQ9DXuJgR1w (big blind) folded on the Flop
Seat 6: NtLDBSjsJQEKekh5cdinvw folded before Flop (didn't bet)
Seat 7: Kzta8yu9vxHT4B70mjBZ+w folded before Flop (didn't bet)
Seat 8: rW/MyplHylMSBRaoRUzWrg folded before Flop (didn't bet)
Seat 9: F7m34OOfAQ7annesMHVjKw mucked



PokerStars Game #59941068256:  Hold'em No Limit ($1/$2) - 2009/07/01 1:24:44 ET
Table 'CFkQcfWjKccZaZDf71FK+w' 6-max Seat #4 is the button
Seat 1: JsC+WvfzqlxVs9G8/gSQAQ ($25.05 in chips)
Seat 2: ewN/vzF22+/gdzjIKBOlkA ($208.20 in chips)
Seat 3: 09BNF4quPDzanQzM8vc6WA ($24 in chips)
Seat 4: ygTTt5ehT4aF86q1a8/R+w ($192.75 in chips)
Seat 5: 2lOU1DcvUZaMcxZ95XfzXw ($146 in chips)
Seat 6: ORVqY3rf9X6ANA/8s+On2Q ($78.50 in chips)
2lOU1DcvUZaMcxZ95XfzXw: posts small blind $1
ORVqY3rf9X6ANA/8s+On2Q: posts big blind $2
*** HOLE CARDS ***
JsC+WvfzqlxVs9G8/gSQAQ: folds
ewN/vzF22+/gdzjIKBOlkA: raises $6 to $8
09BNF4quPDzanQzM8vc6WA: raises $16 to $24 and is all-in
ygTTt5ehT4aF86q1a8/R+w: folds
2lOU1DcvUZaMcxZ95XfzXw: folds
ORVqY3rf9X6ANA/8s+On2Q: folds
ewN/vzF22+/gdzjIKBOlkA: calls $16
*** FLOP *** [6d 5c 8s]
*** TURN *** [6d 5c 8s] [Ac]
*** RIVER *** [6d 5c 8s Ac] [Tc]
*** SHOW DOWN ***
ewN/vzF22+/gdzjIKBOlkA: shows [Qd Ad] (a pair of Aces)
09BNF4quPDzanQzM8vc6WA: shows [6c 6s] (three of a kind, Sixes)
09BNF4quPDzanQzM8vc6WA collected $48.45 from pot
*** SUMMARY ***
Total pot $51 | Rake $2.55
Board [6d 5c 8s Ac Tc]
Seat 1: JsC+WvfzqlxVs9G8/gSQAQ folded before Flop (didn't bet)
Seat 2: ewN/vzF22+/gdzjIKBOlkA showed [Qd Ad] and lost with a pair of Aces
Seat 3: 09BNF4quPDzanQzM8vc6WA showed [6c 6s] and won ($48.45) with three of a kind, Sixes
Seat 4: ygTTt5ehT4aF86q1a8/R+w (button) folded before Flop (didn't bet)
Seat 5: 2lOU1DcvUZaMcxZ95XfzXw (small blind) folded before Flop
Seat 6: ORVqY3rf9X6ANA/8s+On2Q (big blind) folded before Flop



PokerStars Game #59941068496:  Hold'em No Limit ($1/$2) - 2009/07/01 1:24:44 ET
Table 'AtOXMvcrtQM8yLNcALmfLQ' 2-max Seat #1 is the button
Seat 1: +HlQuAsMqZGYYtjcPO/a3A ($107.90 in chips)
Seat 2: pVqEzK9wXlRMECnb1Zg4Zw ($287.80 in chips)
+HlQuAsMqZGYYtjcPO/a3A: posts small blind $1
pVqEzK9wXlRMECnb1Zg4Zw: posts big blind $2
*** HOLE CARDS ***
+HlQuAsMqZGYYtjcPO/a3A: raises $4 to $6
pVqEzK9wXlRMECnb1Zg4Zw: raises $16 to $22
+HlQuAsMqZGYYtjcPO/a3A: calls $16
*** FLOP *** [Qs 4s 2d]
pVqEzK9wXlRMECnb1Zg4Zw: checks
+HlQuAsMqZGYYtjcPO/a3A: checks
*** TURN *** [Qs 4s 2d] [4c]
pVqEzK9wXlRMECnb1Zg4Zw: checks
+HlQuAsMqZGYYtjcPO/a3A: bets $14
pVqEzK9wXlRMECnb1Zg4Zw: calls $14
*** RIVER *** [Qs 4s 2d 4c] [2c]
pVqEzK9wXlRMECnb1Zg4Zw: checks
+HlQuAsMqZGYYtjcPO/a3A: bets $71.90 and is all-in
pVqEzK9wXlRMECnb1Zg4Zw: folds
+HlQuAsMqZGYYtjcPO/a3A collected $71.50 from pot
*** SUMMARY ***
Total pot $72 | Rake $0.50
Board [Qs 4s 2d 4c 2c]
Seat 1: +HlQuAsMqZGYYtjcPO/a3A (button) (small blind) collected ($71.50)
Seat 2: pVqEzK9wXlRMECnb1Zg4Zw (big blind) folded on the River



PokerStars Game #59941071218:  Hold'em No Limit ($1/$2) - 2009/07/01 1:24:49 ET
Table '/dyk+YdRGv90j2box35j8w' 6-max Seat #5 is the button
Seat 1: 8srN1dKQePlsv0GyTada+Q ($201 in chips)
Seat 2: qCnEYuAE5y5A7bk6fO5/jQ ($475.60 in chips)
Seat 3: sTPOWERd9HWPCNrDBwsVjA ($188.75 in chips)
Seat 4: z/u1YTnkiIDrtp/2cA2dBg ($196.65 in chips)
Seat 5: VvdR9F3I+2yELkfTVvC1dg ($200 in chips)
8srN1dKQePlsv0GyTada+Q: posts small blind $1
qCnEYuAE5y5A7bk6fO5/jQ: posts big blind $2
*** HOLE CARDS ***
sTPOWERd9HWPCNrDBwsVjA: folds
z/u1YTnkiIDrtp/2cA2dBg: folds
VvdR9F3I+2yELkfTVvC1dg: folds
8srN1dKQePlsv0GyTada+Q: calls $1
qCnEYuAE5y5A7bk6fO5/jQ: raises $6 to $8
8srN1dKQePlsv0GyTada+Q: folds
qCnEYuAE5y5A7bk6fO5/jQ collected $4 from pot
qCnEYuAE5y5A7bk6fO5/jQ: doesn't show hand
*** SUMMARY ***
Total pot $4 | Rake $0
Seat 1: 8srN1dKQePlsv0GyTada+Q (small blind) folded before Flop
Seat 2: qCnEYuAE5y5A7bk6fO5/jQ (big blind) collected ($4)
Seat 3: sTPOWERd9HWPCNrDBwsVjA folded before Flop (didn't bet)
Seat 4: z/u1YTnkiIDrtp/2cA2dBg folded before Flop (didn't bet)
Seat 5: VvdR9F3I+2yELkfTVvC1dg (button) folded before Flop (didn't bet)



PokerStars Game #59941071778:  Hold'em No Limit ($1/$2) - 2009/07/01 1:24:50 ET
Table '3WCXyaiCAbqSShQu7FIjvA' 9-max Seat #9 is the button
Seat 1: kTCkABD1UUldS9DFRGfCwQ ($149.60 in chips)
Seat 2: 1zQMh8lHgW3t2YhVeA+09A ($8.80 in chips)
Seat 3: 5Q8U6iZbeO7xJSS4qvDP5g ($200 in chips)
Seat 4: waEF/+pxZTxNo4FvsORuXg ($77 in chips)
Seat 5: CkE3IyJF1KvdaAOmZY5XqQ ($200 in chips)
Seat 6: 5jQlngvMSqM/WoonOcR5kw ($296 in chips)
Seat 8: 1CtiZuXDFaJL1dJPQKyi8Q ($242.35 in chips)
Seat 9: FiXPLJyqb24l32QST2TInw ($153.40 in chips)
kTCkABD1UUldS9DFRGfCwQ: posts small blind $1
1zQMh8lHgW3t2YhVeA+09A: posts big blind $2
*** HOLE CARDS ***
5Q8U6iZbeO7xJSS4qvDP5g: folds
waEF/+pxZTxNo4FvsORuXg: folds
CkE3IyJF1KvdaAOmZY5XqQ: folds
5jQlngvMSqM/WoonOcR5kw: folds
1CtiZuXDFaJL1dJPQKyi8Q: folds
FiXPLJyqb24l32QST2TInw: folds
kTCkABD1UUldS9DFRGfCwQ: calls $1
1zQMh8lHgW3t2YhVeA+09A: checks
*** FLOP *** [Jh Kh Qd]
kTCkABD1UUldS9DFRGfCwQ: bets $2
1zQMh8lHgW3t2YhVeA+09A: folds
kTCkABD1UUldS9DFRGfCwQ collected $3.80 from pot
kTCkABD1UUldS9DFRGfCwQ: doesn't show hand
*** SUMMARY ***
Total pot $4 | Rake $0.20
Board [Jh Kh Qd]
Seat 1: kTCkABD1UUldS9DFRGfCwQ (small blind) collected ($3.80)
Seat 2: 1zQMh8lHgW3t2YhVeA+09A (big blind) folded on the Flop
Seat 3: 5Q8U6iZbeO7xJSS4qvDP5g folded before Flop (didn't bet)
Seat 4: waEF/+pxZTxNo4FvsORuXg folded before Flop (didn't bet)
Seat 5: CkE3IyJF1KvdaAOmZY5XqQ folded before Flop (didn't bet)
Seat 6: 5jQlngvMSqM/WoonOcR5kw folded before Flop (didn't bet)
Seat 8: 1CtiZuXDFaJL1dJPQKyi8Q folded before Flop (didn't bet)
Seat 9: FiXPLJyqb24l32QST2TInw (button) folded before Flop (didn't bet)



PokerStars Game #59941072060:  Hold'em No Limit ($1/$2) - 2009/07/01 1:24:50 ET
Table '+hSnXFQrGw1PlVgTnuj+sA' 6-max Seat #4 is the button
Seat 1: 2ccIJhDj+3JapvS7swVZEg ($329.60 in chips)
Seat 2: o9jamqIi6sTTRSqudgboRA ($278.90 in chips)
Seat 3: fE+LHW/7rpfXW14g8LhGjA ($57.30 in chips)
Seat 4: J4iH5epwXbmODnojR/VRxA ($157.60 in chips)
Seat 5: VvdR9F3I+2yELkfTVvC1dg ($200 in chips)
Seat 6: AuiGltq875lmaKHBsjZVGg ($75.75 in chips)
VvdR9F3I+2yELkfTVvC1dg: posts small blind $1
AuiGltq875lmaKHBsjZVGg: posts big blind $2
*** HOLE CARDS ***
2ccIJhDj+3JapvS7swVZEg: folds
o9jamqIi6sTTRSqudgboRA: raises $5 to $7
fE+LHW/7rpfXW14g8LhGjA: folds
J4iH5epwXbmODnojR/VRxA is disconnected
J4iH5epwXbmODnojR/VRxA is connected
J4iH5epwXbmODnojR/VRxA: folds
VvdR9F3I+2yELkfTVvC1dg: folds
AuiGltq875lmaKHBsjZVGg: folds
o9jamqIi6sTTRSqudgboRA collected $5 from pot
o9jamqIi6sTTRSqudgboRA: doesn't show hand
*** SUMMARY ***
Total pot $5 | Rake $0
Seat 1: 2ccIJhDj+3JapvS7swVZEg folded before Flop (didn't bet)
Seat 2: o9jamqIi6sTTRSqudgboRA collected ($5)
Seat 3: fE+LHW/7rpfXW14g8LhGjA folded before Flop (didn't bet)
Seat 4: J4iH5epwXbmODnojR/VRxA (button) folded before Flop (didn't bet)
Seat 5: VvdR9F3I+2yELkfTVvC1dg (small blind) folded before Flop
Seat 6: AuiGltq875lmaKHBsjZVGg (big blind) folded before Flop



PokerStars Game #59941072554:  Hold'em No Limit ($1/$2) - 2009/07/01 1:24:51 ET
Table 'uJ9juaXXg9yIcSU8amxaXQ' 6-max Seat #4 is the button
Seat 1: JsqOjN/eHz0uYVf/PyUJ6Q ($148.85 in chips)
Seat 2: VvdR9F3I+2yELkfTVvC1dg ($200 in chips)
Seat 3: qXDd0ZyMIse0OBu8pxeQ3Q ($247 in chips)
Seat 4: zNjJ/y4emmF+vzrCDd+ooA ($229.85 in chips)
Seat 5: YsLQ3BAvgQHWXMAv3Wv6Hg ($200 in chips)
Seat 6: 2DFp9Veq1xxq64dCjwNuUw ($55.60 in chips)
YsLQ3BAvgQHWXMAv3Wv6Hg: posts small blind $1
2DFp9Veq1xxq64dCjwNuUw: posts big blind $2
*** HOLE CARDS ***
JsqOjN/eHz0uYVf/PyUJ6Q: calls $2
VvdR9F3I+2yELkfTVvC1dg: calls $2
qXDd0ZyMIse0OBu8pxeQ3Q: folds
zNjJ/y4emmF+vzrCDd+ooA: folds
YsLQ3BAvgQHWXMAv3Wv6Hg: calls $1
2DFp9Veq1xxq64dCjwNuUw: checks
*** FLOP *** [Qc 2c 5s]
YsLQ3BAvgQHWXMAv3Wv6Hg: checks
2DFp9Veq1xxq64dCjwNuUw: checks
JsqOjN/eHz0uYVf/PyUJ6Q: checks
VvdR9F3I+2yELkfTVvC1dg: bets $5.70
YsLQ3BAvgQHWXMAv3Wv6Hg: folds
2DFp9Veq1xxq64dCjwNuUw: folds
JsqOjN/eHz0uYVf/PyUJ6Q: folds
VvdR9F3I+2yELkfTVvC1dg collected $7.60 from pot
VvdR9F3I+2yELkfTVvC1dg: doesn't show hand
*** SUMMARY ***
Total pot $8 | Rake $0.40
Board [Qc 2c 5s]
Seat 1: JsqOjN/eHz0uYVf/PyUJ6Q folded on the Flop
Seat 2: VvdR9F3I+2yELkfTVvC1dg collected ($7.60)
Seat 3: qXDd0ZyMIse0OBu8pxeQ3Q folded before Flop (didn't bet)
Seat 4: zNjJ/y4emmF+vzrCDd+ooA (button) folded before Flop (didn't bet)
Seat 5: YsLQ3BAvgQHWXMAv3Wv6Hg (small blind) folded on the Flop
Seat 6: 2DFp9Veq1xxq64dCjwNuUw (big blind) folded on the Flop



PokerStars Game #59941072848:  Hold'em No Limit ($1/$2) - 2009/07/01 1:24:52 ET
Table 'bIihwBANJSFqlHPPtset+w' 9-max Seat #3 is the button
Seat 1: /inIs/z/PcX+TniIFpaxpg ($30 in chips)
Seat 2: lQYT23h5QCUVZAKxjOO39Q ($180.75 in chips)
Seat 3: +T/63sAeZzWyHchahJ36GQ ($43 in chips)
Seat 4: ri8CLkX3e9JF34dQNbsHGA ($40.40 in chips)
Seat 5: vxbbJLsS1bva6tW2NiFssg ($200 in chips)
Seat 6: CkE3IyJF1KvdaAOmZY5XqQ ($186 in chips)
Seat 7: pCmk6FpSOLJ+85o1tLHIag ($145.95 in chips)
Seat 8: iMe5yhc+1BaiIPHet3NMrA ($200.50 in chips)
Seat 9: qn8LDoUFphcG4+r+F+Vhrg ($168 in chips)
ri8CLkX3e9JF34dQNbsHGA: posts small blind $1
vxbbJLsS1bva6tW2NiFssg: posts big blind $2
*** HOLE CARDS ***
CkE3IyJF1KvdaAOmZY5XqQ: folds
pCmk6FpSOLJ+85o1tLHIag: folds
iMe5yhc+1BaiIPHet3NMrA: folds
qn8LDoUFphcG4+r+F+Vhrg: raises $6 to $8
/inIs/z/PcX+TniIFpaxpg: folds
lQYT23h5QCUVZAKxjOO39Q: folds
+T/63sAeZzWyHchahJ36GQ: folds
ri8CLkX3e9JF34dQNbsHGA: folds
vxbbJLsS1bva6tW2NiFssg: folds
qn8LDoUFphcG4+r+F+Vhrg collected $5 from pot
*** SUMMARY ***
Total pot $5 | Rake $0
Seat 1: /inIs/z/PcX+TniIFpaxpg folded before Flop (didn't bet)
Seat 2: lQYT23h5QCUVZAKxjOO39Q folded before Flop (didn't bet)
Seat 3: +T/63sAeZzWyHchahJ36GQ (button) folded before Flop (didn't bet)
Seat 4: ri8CLkX3e9JF34dQNbsHGA (small blind) folded before Flop
Seat 5: vxbbJLsS1bva6tW2NiFssg (big blind) folded before Flop
Seat 6: CkE3IyJF1KvdaAOmZY5XqQ folded before Flop (didn't bet)
Seat 7: pCmk6FpSOLJ+85o1tLHIag folded before Flop (didn't bet)
Seat 8: iMe5yhc+1BaiIPHet3NMrA folded before Flop (didn't bet)
Seat 9: qn8LDoUFphcG4+r+F+Vhrg collected ($5)



PokerStars Game #59941074174:  Hold'em No Limit ($1/$2) - 2009/07/01 1:24:54 ET
Table 'LL4bDFyhj5hsMpzaDugJZg' 6-max Seat #6 is the button
Seat 1: FwvID/fQGlpY3soi/lMTww ($85.50 in chips)
Seat 3: iI/NMpRxMkGieArQEhACSA ($287.75 in chips)
Seat 4: 8srN1dKQePlsv0GyTada+Q ($309.75 in chips)
Seat 5: A2GTwTiwkb1ilNWgW487Vg ($65.80 in chips)
Seat 6: 692Q4sfB0gTElzS0WMeg+A ($215.10 in chips)
FwvID/fQGlpY3soi/lMTww: posts small blind $1
iI/NMpRxMkGieArQEhACSA: posts big blind $2
*** HOLE CARDS ***
8srN1dKQePlsv0GyTada+Q: raises $4 to $6
A2GTwTiwkb1ilNWgW487Vg: calls $6
692Q4sfB0gTElzS0WMeg+A: folds
FwvID/fQGlpY3soi/lMTww: folds
iI/NMpRxMkGieArQEhACSA: calls $4
*** FLOP *** [9c 4d 4c]
iI/NMpRxMkGieArQEhACSA: checks
8srN1dKQePlsv0GyTada+Q: bets $12
A2GTwTiwkb1ilNWgW487Vg: calls $12
iI/NMpRxMkGieArQEhACSA: folds
*** TURN *** [9c 4d 4c] [Qc]
8srN1dKQePlsv0GyTada+Q: checks
A2GTwTiwkb1ilNWgW487Vg: checks
*** RIVER *** [9c 4d 4c Qc] [Td]
8srN1dKQePlsv0GyTada+Q: bets $12
A2GTwTiwkb1ilNWgW487Vg: raises $22 to $34
8srN1dKQePlsv0GyTada+Q: calls $22
*** SHOW DOWN ***
A2GTwTiwkb1ilNWgW487Vg: shows [Ah 4h] (three of a kind, Fours)
8srN1dKQePlsv0GyTada+Q: mucks hand
A2GTwTiwkb1ilNWgW487Vg collected $109 from pot
*** SUMMARY ***
Total pot $111 | Rake $2
Board [9c 4d 4c Qc Td]
Seat 1: FwvID/fQGlpY3soi/lMTww (small blind) folded before Flop
Seat 3: iI/NMpRxMkGieArQEhACSA (big blind) folded on the Flop
Seat 4: 8srN1dKQePlsv0GyTada+Q mucked
Seat 5: A2GTwTiwkb1ilNWgW487Vg showed [Ah 4h] and won ($109) with three of a kind, Fours
Seat 6: 692Q4sfB0gTElzS0WMeg+A (button) folded before Flop (didn't bet)



PokerStars Game #59941074688:  Hold'em No Limit ($1/$2) - 2009/07/01 1:24:55 ET
Table 'NmY84NAf9Mh0ckAckHnh5g' 2-max Seat #2 is the button
Seat 1: 6hvg964TSqZ3AL/0XK9aVQ ($208.60 in chips)
Seat 2: RwDoM55ZeQuI2ADyJhOb2Q ($795.90 in chips)
RwDoM55ZeQuI2ADyJhOb2Q: posts small blind $1
6hvg964TSqZ3AL/0XK9aVQ: posts big blind $2
*** HOLE CARDS ***
RwDoM55ZeQuI2ADyJhOb2Q: raises $4 to $6
6hvg964TSqZ3AL/0XK9aVQ: calls $4
*** FLOP *** [3d Js Th]
6hvg964TSqZ3AL/0XK9aVQ: checks
RwDoM55ZeQuI2ADyJhOb2Q: bets $8
6hvg964TSqZ3AL/0XK9aVQ: calls $8
*** TURN *** [3d Js Th] [Qh]
6hvg964TSqZ3AL/0XK9aVQ: checks
RwDoM55ZeQuI2ADyJhOb2Q: checks
*** RIVER *** [3d Js Th Qh] [4s]
6hvg964TSqZ3AL/0XK9aVQ: bets $24
RwDoM55ZeQuI2ADyJhOb2Q: calls $24
*** SHOW DOWN ***
6hvg964TSqZ3AL/0XK9aVQ: shows [3s 3h] (three of a kind, Threes)
RwDoM55ZeQuI2ADyJhOb2Q: mucks hand
6hvg964TSqZ3AL/0XK9aVQ collected $75.50 from pot
*** SUMMARY ***
Total pot $76 | Rake $0.50
Board [3d Js Th Qh 4s]
Seat 1: 6hvg964TSqZ3AL/0XK9aVQ (big blind) showed [3s 3h] and won ($75.50) with three of a kind, Threes
Seat 2: RwDoM55ZeQuI2ADyJhOb2Q (button) (small blind) mucked



PokerStars Game #59941075694:  Hold'em No Limit ($1/$2) - 2009/07/01 1:24:57 ET
Table 'C4lkCXY2PWy6z4vsAe5NGQ' 6-max Seat #2 is the button
Seat 1: 4bqvCfJ0e8CTYnn0Go9hbQ ($55.60 in chips)
Seat 2: 6hRJ68JkbJq6MYI9o5bUnQ ($31.40 in chips)
Seat 3: sTPOWERd9HWPCNrDBwsVjA ($142.80 in chips)
Seat 4: VvdR9F3I+2yELkfTVvC1dg ($234.15 in chips)
Seat 5: dKvrkfQx2Peke3ikZLUy1w ($69.80 in chips)
Seat 6: B87ikIyZ/TzAVeXf38Ny0g ($657.75 in chips)
sTPOWERd9HWPCNrDBwsVjA: posts small blind $1
VvdR9F3I+2yELkfTVvC1dg: posts big blind $2
*** HOLE CARDS ***
dKvrkfQx2Peke3ikZLUy1w: folds
B87ikIyZ/TzAVeXf38Ny0g: folds
4bqvCfJ0e8CTYnn0Go9hbQ: folds
6hRJ68JkbJq6MYI9o5bUnQ: folds
sTPOWERd9HWPCNrDBwsVjA: raises $4 to $6
VvdR9F3I+2yELkfTVvC1dg: folds
sTPOWERd9HWPCNrDBwsVjA collected $4 from pot
*** SUMMARY ***
Total pot $4 | Rake $0
Seat 1: 4bqvCfJ0e8CTYnn0Go9hbQ folded before Flop (didn't bet)
Seat 2: 6hRJ68JkbJq6MYI9o5bUnQ (button) folded before Flop (didn't bet)
Seat 3: sTPOWERd9HWPCNrDBwsVjA (small blind) collected ($4)
Seat 4: VvdR9F3I+2yELkfTVvC1dg (big blind) folded before Flop
Seat 5: dKvrkfQx2Peke3ikZLUy1w folded before Flop (didn't bet)
Seat 6: B87ikIyZ/TzAVeXf38Ny0g folded before Flop (didn't bet)



PokerStars Game #59941077156:  Hold'em No Limit ($1/$2) - 2009/07/01 1:24:59 ET
Table 'kq5zaQ+1hLNf8LZfGnbTAA' 6-max Seat #4 is the button
Seat 1: 8srN1dKQePlsv0GyTada+Q ($203 in chips)
Seat 2: nXDI8Y/S6POzRwANu3d8hQ ($200 in chips)
Seat 3: vkfxu8f/jMYKUk6Ly4eujw ($224.95 in chips)
Seat 4: 3dAbvkxS5NPQTBAbvpinVg ($200 in chips)
Seat 5: kfASJqTbXek+zc8ZKsZL1Q ($279.50 in chips)
Seat 6: mfy7uGZcqA2PVQqEVbJ7+g ($191.25 in chips)
kfASJqTbXek+zc8ZKsZL1Q: posts small blind $1
mfy7uGZcqA2PVQqEVbJ7+g: posts big blind $2
*** HOLE CARDS ***
8srN1dKQePlsv0GyTada+Q: folds
nXDI8Y/S6POzRwANu3d8hQ: folds
vkfxu8f/jMYKUk6Ly4eujw: raises $6 to $8
3dAbvkxS5NPQTBAbvpinVg: folds
kfASJqTbXek+zc8ZKsZL1Q: folds
mfy7uGZcqA2PVQqEVbJ7+g: folds
vkfxu8f/jMYKUk6Ly4eujw collected $5 from pot
vkfxu8f/jMYKUk6Ly4eujw: doesn't show hand
*** SUMMARY ***
Total pot $5 | Rake $0
Seat 1: 8srN1dKQePlsv0GyTada+Q folded before Flop (didn't bet)
Seat 2: nXDI8Y/S6POzRwANu3d8hQ folded before Flop (didn't bet)
Seat 3: vkfxu8f/jMYKUk6Ly4eujw collected ($5)
Seat 4: 3dAbvkxS5NPQTBAbvpinVg (button) folded before Flop (didn't bet)
Seat 5: kfASJqTbXek+zc8ZKsZL1Q (small blind) folded before Flop
Seat 6: mfy7uGZcqA2PVQqEVbJ7+g (big blind) folded before Flop



PokerStars Game #59941080804:  Hold'em No Limit ($1/$2) - 2009/07/01 1:25:05 ET
Table 'aSf77Sj8QEnzcc0WaxVD4Q' 6-max Seat #5 is the button
Seat 1: UELtvp+JfwI7XDGVwSxZXA ($165.75 in chips)
Seat 2: vkfxu8f/jMYKUk6Ly4eujw ($200 in chips)
Seat 3: 9dpyyjDTCed6nV7JhaUUpw ($526.70 in chips)
Seat 4: YsLQ3BAvgQHWXMAv3Wv6Hg ($262.70 in chips)
Seat 5: VvdR9F3I+2yELkfTVvC1dg ($245 in chips)
Seat 6: vkoJRf3gidxY1pPi0AFWww ($116.75 in chips)
vkoJRf3gidxY1pPi0AFWww: posts small blind $1
UELtvp+JfwI7XDGVwSxZXA: posts big blind $2
*** HOLE CARDS ***
vkfxu8f/jMYKUk6Ly4eujw: folds
9dpyyjDTCed6nV7JhaUUpw: folds
YsLQ3BAvgQHWXMAv3Wv6Hg: folds
VvdR9F3I+2yELkfTVvC1dg: folds
vkoJRf3gidxY1pPi0AFWww: calls $1
UELtvp+JfwI7XDGVwSxZXA: checks
*** FLOP *** [Ah 5d 4c]
vkoJRf3gidxY1pPi0AFWww: checks
UELtvp+JfwI7XDGVwSxZXA: checks
*** TURN *** [Ah 5d 4c] [Ad]
vkoJRf3gidxY1pPi0AFWww: bets $4
UELtvp+JfwI7XDGVwSxZXA: folds
vkoJRf3gidxY1pPi0AFWww collected $3.80 from pot
vkoJRf3gidxY1pPi0AFWww: doesn't show hand
*** SUMMARY ***
Total pot $4 | Rake $0.20
Board [Ah 5d 4c Ad]
Seat 1: UELtvp+JfwI7XDGVwSxZXA (big blind) folded on the Turn
Seat 2: vkfxu8f/jMYKUk6Ly4eujw folded before Flop (didn't bet)
Seat 3: 9dpyyjDTCed6nV7JhaUUpw folded before Flop (didn't bet)
Seat 4: YsLQ3BAvgQHWXMAv3Wv6Hg folded before Flop (didn't bet)
Seat 5: VvdR9F3I+2yELkfTVvC1dg (button) folded before Flop (didn't bet)
Seat 6: vkoJRf3gidxY1pPi0AFWww (small blind) collected ($3.80)



PokerStars Game #59941082362:  Hold'em No Limit ($1/$2) - 2009/07/01 1:25:08 ET
Table '/dyk+YdRGv90j2box35j8w' 6-max Seat #1 is the button
Seat 1: 8srN1dKQePlsv0GyTada+Q ($200 in chips)
Seat 2: qCnEYuAE5y5A7bk6fO5/jQ ($477.60 in chips)
Seat 3: sTPOWERd9HWPCNrDBwsVjA ($188.75 in chips)
Seat 4: z/u1YTnkiIDrtp/2cA2dBg ($196.65 in chips)
Seat 5: VvdR9F3I+2yELkfTVvC1dg ($200 in chips)
qCnEYuAE5y5A7bk6fO5/jQ: posts small blind $1
sTPOWERd9HWPCNrDBwsVjA: posts big blind $2
*** HOLE CARDS ***
z/u1YTnkiIDrtp/2cA2dBg: folds
VvdR9F3I+2yELkfTVvC1dg: folds
8srN1dKQePlsv0GyTada+Q: raises $4 to $6
qCnEYuAE5y5A7bk6fO5/jQ: folds
sTPOWERd9HWPCNrDBwsVjA: folds
8srN1dKQePlsv0GyTada+Q collected $5 from pot
8srN1dKQePlsv0GyTada+Q: doesn't show hand
*** SUMMARY ***
Total pot $5 | Rake $0
Seat 1: 8srN1dKQePlsv0GyTada+Q (button) collected ($5)
Seat 2: qCnEYuAE5y5A7bk6fO5/jQ (small blind) folded before Flop
Seat 3: sTPOWERd9HWPCNrDBwsVjA (big blind) folded before Flop
Seat 4: z/u1YTnkiIDrtp/2cA2dBg folded before Flop (didn't bet)
Seat 5: VvdR9F3I+2yELkfTVvC1dg folded before Flop (didn't bet)



PokerStars Game #59941083446:  Hold'em No Limit ($1/$2) - 2009/07/01 1:25:10 ET
Table 'ztv6V3FN2bQ9nmJPPdx6nQ' 6-max Seat #1 is the button
Seat 1: 6fLdOUCRtX71xbVRhJEq8w ($205 in chips)
Seat 2: 5Y+ZGWLI4gnlpApDX5vy1A ($410.75 in chips)
Seat 3: ubtx4Z5L+AcK71MTvYiGVw ($203 in chips)
Seat 4: UaZ5yj+6LjtWqMQg2QskUw ($118.30 in chips)
Seat 5: sTPOWERd9HWPCNrDBwsVjA ($253.75 in chips)
Seat 6: mfy7uGZcqA2PVQqEVbJ7+g ($117.45 in chips)
5Y+ZGWLI4gnlpApDX5vy1A: posts small blind $1
ubtx4Z5L+AcK71MTvYiGVw: posts big blind $2
*** HOLE CARDS ***
UaZ5yj+6LjtWqMQg2QskUw: folds
sTPOWERd9HWPCNrDBwsVjA: raises $4 to $6
mfy7uGZcqA2PVQqEVbJ7+g: folds
6fLdOUCRtX71xbVRhJEq8w: folds
5Y+ZGWLI4gnlpApDX5vy1A: calls $5
ubtx4Z5L+AcK71MTvYiGVw: calls $4
*** FLOP *** [Qs 8d Tc]
5Y+ZGWLI4gnlpApDX5vy1A: checks
ubtx4Z5L+AcK71MTvYiGVw: checks
sTPOWERd9HWPCNrDBwsVjA: checks
*** TURN *** [Qs 8d Tc] [8s]
5Y+ZGWLI4gnlpApDX5vy1A: checks
ubtx4Z5L+AcK71MTvYiGVw: bets $10
sTPOWERd9HWPCNrDBwsVjA: calls $10
5Y+ZGWLI4gnlpApDX5vy1A: folds
*** RIVER *** [Qs 8d Tc 8s] [7s]
ubtx4Z5L+AcK71MTvYiGVw: bets $24
sTPOWERd9HWPCNrDBwsVjA: calls $24
*** SHOW DOWN ***
ubtx4Z5L+AcK71MTvYiGVw: shows [Kd Qc] (two pair, Queens and Eights)
sTPOWERd9HWPCNrDBwsVjA: mucks hand
ubtx4Z5L+AcK71MTvYiGVw collected $83 from pot
*** SUMMARY ***
Total pot $86 | Rake $3
Board [Qs 8d Tc 8s 7s]
Seat 1: 6fLdOUCRtX71xbVRhJEq8w (button) folded before Flop (didn't bet)
Seat 2: 5Y+ZGWLI4gnlpApDX5vy1A (small blind) folded on the Turn
Seat 3: ubtx4Z5L+AcK71MTvYiGVw (big blind) showed [Kd Qc] and won ($83) with two pair, Queens and Eights
Seat 4: UaZ5yj+6LjtWqMQg2QskUw folded before Flop (didn't bet)
Seat 5: sTPOWERd9HWPCNrDBwsVjA mucked
Seat 6: mfy7uGZcqA2PVQqEVbJ7+g folded before Flop (didn't bet)



PokerStars Game #59941083650:  Hold'em No Limit ($1/$2) - 2009/07/01 1:25:10 ET
Table 'on4i1U1lCRmxsduFD3xiSg' 9-max Seat #9 is the button
Seat 1: so5k3vFDmokh2q3dImJ1GQ ($180.30 in chips)
Seat 2: NqSvZNzJ4RkR3sCmgQnyLw ($42.45 in chips)
Seat 3: GX1heJ+DSsvm7gzSPsYhhQ ($35 in chips)
Seat 4: DFQVuszLVclqjA46pN4Vvw ($27.85 in chips)
Seat 5: 37j/5DgMG5m9lMfFofEAOg ($115.35 in chips)
Seat 7: /inIs/z/PcX+TniIFpaxpg ($276 in chips)
Seat 9: iMe5yhc+1BaiIPHet3NMrA ($200 in chips)
so5k3vFDmokh2q3dImJ1GQ: posts small blind $1
NqSvZNzJ4RkR3sCmgQnyLw: posts big blind $2
+T/63sAeZzWyHchahJ36GQ: sits out
ZYHoLw2lWmRS7CSHi8L8Xg: sits out
*** HOLE CARDS ***
GX1heJ+DSsvm7gzSPsYhhQ: folds
DFQVuszLVclqjA46pN4Vvw: folds
37j/5DgMG5m9lMfFofEAOg: calls $2
/inIs/z/PcX+TniIFpaxpg: raises $8 to $10
iMe5yhc+1BaiIPHet3NMrA: folds
so5k3vFDmokh2q3dImJ1GQ: folds
NqSvZNzJ4RkR3sCmgQnyLw: folds
37j/5DgMG5m9lMfFofEAOg: calls $8
*** FLOP *** [7c Th Kh]
37j/5DgMG5m9lMfFofEAOg: checks
/inIs/z/PcX+TniIFpaxpg: bets $10
37j/5DgMG5m9lMfFofEAOg: calls $10
*** TURN *** [7c Th Kh] [Ks]
37j/5DgMG5m9lMfFofEAOg: bets $6
/inIs/z/PcX+TniIFpaxpg: raises $24 to $30
37j/5DgMG5m9lMfFofEAOg: folds
/inIs/z/PcX+TniIFpaxpg collected $52.40 from pot
/inIs/z/PcX+TniIFpaxpg: doesn't show hand
*** SUMMARY ***
Total pot $55 | Rake $2.60
Board [7c Th Kh Ks]
Seat 1: so5k3vFDmokh2q3dImJ1GQ (small blind) folded before Flop
Seat 2: NqSvZNzJ4RkR3sCmgQnyLw (big blind) folded before Flop
Seat 3: GX1heJ+DSsvm7gzSPsYhhQ folded before Flop (didn't bet)
Seat 4: DFQVuszLVclqjA46pN4Vvw folded before Flop (didn't bet)
Seat 5: 37j/5DgMG5m9lMfFofEAOg folded on the Turn
Seat 7: /inIs/z/PcX+TniIFpaxpg collected ($52.40)
Seat 9: iMe5yhc+1BaiIPHet3NMrA (button) folded before Flop (didn't bet)



PokerStars Game #59941084034:  Hold'em No Limit ($1/$2) - 2009/07/01 1:25:11 ET
Table 'bJQ024BaYSBrW0sXpCZbNQ' 6-max Seat #2 is the button
Seat 2: 3dAbvkxS5NPQTBAbvpinVg ($220.05 in chips)
Seat 3: vkfxu8f/jMYKUk6Ly4eujw ($231.05 in chips)
Seat 4: TBaQIN+sQ7eb7P99QnaORQ ($40 in chips)
Seat 5: VvdR9F3I+2yELkfTVvC1dg ($202 in chips)
Seat 6: 9dpyyjDTCed6nV7JhaUUpw ($333.95 in chips)
vkfxu8f/jMYKUk6Ly4eujw: posts small blind $1
TBaQIN+sQ7eb7P99QnaORQ: posts big blind $2
*** HOLE CARDS ***
VvdR9F3I+2yELkfTVvC1dg: folds
9dpyyjDTCed6nV7JhaUUpw: raises $4 to $6
3dAbvkxS5NPQTBAbvpinVg: folds
vkfxu8f/jMYKUk6Ly4eujw: folds
TBaQIN+sQ7eb7P99QnaORQ: calls $4
*** FLOP *** [Ts Ac 5s]
TBaQIN+sQ7eb7P99QnaORQ: checks
9dpyyjDTCed6nV7JhaUUpw: bets $8
PCN5rt4TwI1pQE+rAiqI0Q is disconnected
TBaQIN+sQ7eb7P99QnaORQ: folds
9dpyyjDTCed6nV7JhaUUpw collected $12.35 from pot
9dpyyjDTCed6nV7JhaUUpw: doesn't show hand
*** SUMMARY ***
Total pot $13 | Rake $0.65
Board [Ts Ac 5s]
Seat 2: 3dAbvkxS5NPQTBAbvpinVg (button) folded before Flop (didn't bet)
Seat 3: vkfxu8f/jMYKUk6Ly4eujw (small blind) folded before Flop
Seat 4: TBaQIN+sQ7eb7P99QnaORQ (big blind) folded on the Flop
Seat 5: VvdR9F3I+2yELkfTVvC1dg folded before Flop (didn't bet)
Seat 6: 9dpyyjDTCed6nV7JhaUUpw collected ($12.35)



PokerStars Game #59941086310:  Hold'em No Limit ($1/$2) - 2009/07/01 1:25:15 ET
Table 'rKeCh+eBn4RNvybCUYkoTQ' 9-max Seat #8 is the button
Seat 1: /inIs/z/PcX+TniIFpaxpg ($203 in chips)
Seat 2: 9cBHwK40Tl06vheE7B3LHQ ($159.55 in chips)
Seat 3: GX1heJ+DSsvm7gzSPsYhhQ ($34 in chips)
Seat 4: 31HuO+DQxppUQEedBWukug ($89.10 in chips)
Seat 5: WUlHm+ydPPHG7Lb0rePSdA ($128 in chips)
Seat 6: EBV6OktyeSmh4w6sWmcWOw ($267 in chips)
Seat 7: rW/MyplHylMSBRaoRUzWrg ($34 in chips)
Seat 8: pN/Ip0ePsUVIdUlGgLrkUw ($215.35 in chips)
Seat 9: Kzta8yu9vxHT4B70mjBZ+w ($209.25 in chips)
Kzta8yu9vxHT4B70mjBZ+w: posts small blind $1
/inIs/z/PcX+TniIFpaxpg: posts big blind $2
*** HOLE CARDS ***
9cBHwK40Tl06vheE7B3LHQ: folds
GX1heJ+DSsvm7gzSPsYhhQ: folds
31HuO+DQxppUQEedBWukug: raises $4 to $6
WUlHm+ydPPHG7Lb0rePSdA: folds
EBV6OktyeSmh4w6sWmcWOw: folds
rW/MyplHylMSBRaoRUzWrg: folds
pN/Ip0ePsUVIdUlGgLrkUw: folds
Kzta8yu9vxHT4B70mjBZ+w: folds
/inIs/z/PcX+TniIFpaxpg: folds
31HuO+DQxppUQEedBWukug collected $5 from pot
31HuO+DQxppUQEedBWukug: doesn't show hand
*** SUMMARY ***
Total pot $5 | Rake $0
Seat 1: /inIs/z/PcX+TniIFpaxpg (big blind) folded before Flop
Seat 2: 9cBHwK40Tl06vheE7B3LHQ folded before Flop (didn't bet)
Seat 3: GX1heJ+DSsvm7gzSPsYhhQ folded before Flop (didn't bet)
Seat 4: 31HuO+DQxppUQEedBWukug collected ($5)
Seat 5: WUlHm+ydPPHG7Lb0rePSdA folded before Flop (didn't bet)
Seat 6: EBV6OktyeSmh4w6sWmcWOw folded before Flop (didn't bet)
Seat 7: rW/MyplHylMSBRaoRUzWrg folded before Flop (didn't bet)
Seat 8: pN/Ip0ePsUVIdUlGgLrkUw (button) folded before Flop (didn't bet)
Seat 9: Kzta8yu9vxHT4B70mjBZ+w (small blind) folded before Flop



PokerStars Game #59941086894:  Hold'em No Limit ($1/$2) - 2009/07/01 1:25:16 ET
Table 'C4lkCXY2PWy6z4vsAe5NGQ' 6-max Seat #3 is the button
Seat 1: 4bqvCfJ0e8CTYnn0Go9hbQ ($55.60 in chips)
Seat 2: 6hRJ68JkbJq6MYI9o5bUnQ ($31.40 in chips)
Seat 3: sTPOWERd9HWPCNrDBwsVjA ($144.80 in chips)
Seat 4: VvdR9F3I+2yELkfTVvC1dg ($232.15 in chips)
Seat 5: dKvrkfQx2Peke3ikZLUy1w ($69.80 in chips)
Seat 6: B87ikIyZ/TzAVeXf38Ny0g ($657.75 in chips)
VvdR9F3I+2yELkfTVvC1dg: posts small blind $1
dKvrkfQx2Peke3ikZLUy1w: posts big blind $2
*** HOLE CARDS ***
B87ikIyZ/TzAVeXf38Ny0g: raises $4 to $6
4bqvCfJ0e8CTYnn0Go9hbQ: calls $6
6hRJ68JkbJq6MYI9o5bUnQ: folds
sTPOWERd9HWPCNrDBwsVjA: folds
VvdR9F3I+2yELkfTVvC1dg: folds
dKvrkfQx2Peke3ikZLUy1w: raises $63.80 to $69.80 and is all-in
B87ikIyZ/TzAVeXf38Ny0g: calls $63.80
4bqvCfJ0e8CTYnn0Go9hbQ: calls $49.60 and is all-in
*** FLOP *** [Qh 4h 6s]
*** TURN *** [Qh 4h 6s] [2s]
*** RIVER *** [Qh 4h 6s 2s] [9c]
*** SHOW DOWN ***
dKvrkfQx2Peke3ikZLUy1w: shows [4s 4c] (three of a kind, Fours)
B87ikIyZ/TzAVeXf38Ny0g: shows [Qc Qd] (three of a kind, Queens)
B87ikIyZ/TzAVeXf38Ny0g collected $28.40 from side pot
4bqvCfJ0e8CTYnn0Go9hbQ: mucks hand
B87ikIyZ/TzAVeXf38Ny0g collected $164.80 from main pot
*** SUMMARY ***
Total pot $196.20 Main pot $164.80. Side pot $28.40. | Rake $3
Board [Qh 4h 6s 2s 9c]
Seat 1: 4bqvCfJ0e8CTYnn0Go9hbQ mucked
Seat 2: 6hRJ68JkbJq6MYI9o5bUnQ folded before Flop (didn't bet)
Seat 3: sTPOWERd9HWPCNrDBwsVjA (button) folded before Flop (didn't bet)
Seat 4: VvdR9F3I+2yELkfTVvC1dg (small blind) folded before Flop
Seat 5: dKvrkfQx2Peke3ikZLUy1w (big blind) showed [4s 4c] and lost with three of a kind, Fours
Seat 6: B87ikIyZ/TzAVeXf38Ny0g showed [Qc Qd] and won ($193.20) with three of a kind, Queens



PokerStars Game #59941087722:  Hold'em No Limit ($1/$2) - 2009/07/01 1:25:17 ET
Table 'mGpP9StWRnoeiBDExc6Frg' 6-max Seat #1 is the button
Seat 1: VvdR9F3I+2yELkfTVvC1dg ($200 in chips)
Seat 2: dZcLsEI8iXkobBduRJ45Yw ($74.15 in chips)
Seat 3: 7acrZUQC3Zc9BNLjoKIcLQ ($37.35 in chips)
Seat 4: 4dcDwIHRm96PwtqkpQiuiA ($87.70 in chips)
Seat 5: d1puGuVBE0fidn+5eRJ0tw ($181.95 in chips)
Seat 6: B2Ih1sr5VZk+8He7rcrMtQ ($466.05 in chips)
dZcLsEI8iXkobBduRJ45Yw: posts small blind $1
7acrZUQC3Zc9BNLjoKIcLQ: posts big blind $2
*** HOLE CARDS ***
4dcDwIHRm96PwtqkpQiuiA: folds
d1puGuVBE0fidn+5eRJ0tw: calls $2
B2Ih1sr5VZk+8He7rcrMtQ: calls $2
VvdR9F3I+2yELkfTVvC1dg: raises $10 to $12
dZcLsEI8iXkobBduRJ45Yw: folds
7acrZUQC3Zc9BNLjoKIcLQ: folds
d1puGuVBE0fidn+5eRJ0tw: folds
B2Ih1sr5VZk+8He7rcrMtQ: folds
VvdR9F3I+2yELkfTVvC1dg collected $9 from pot
VvdR9F3I+2yELkfTVvC1dg: doesn't show hand
*** SUMMARY ***
Total pot $9 | Rake $0
Seat 1: VvdR9F3I+2yELkfTVvC1dg (button) collected ($9)
Seat 2: dZcLsEI8iXkobBduRJ45Yw (small blind) folded before Flop
Seat 3: 7acrZUQC3Zc9BNLjoKIcLQ (big blind) folded before Flop
Seat 4: 4dcDwIHRm96PwtqkpQiuiA folded before Flop (didn't bet)
Seat 5: d1puGuVBE0fidn+5eRJ0tw folded before Flop
Seat 6: B2Ih1sr5VZk+8He7rcrMtQ folded before Flop



PokerStars Game #59941087420:  Hold'em No Limit ($1/$2) - 2009/07/01 1:25:17 ET
Table 'kq5zaQ+1hLNf8LZfGnbTAA' 6-max Seat #5 is the button
Seat 1: 8srN1dKQePlsv0GyTada+Q ($203 in chips)
Seat 2: nXDI8Y/S6POzRwANu3d8hQ ($200 in chips)
Seat 3: vkfxu8f/jMYKUk6Ly4eujw ($227.95 in chips)
Seat 4: 3dAbvkxS5NPQTBAbvpinVg ($200 in chips)
Seat 5: kfASJqTbXek+zc8ZKsZL1Q ($278.50 in chips)
Seat 6: mfy7uGZcqA2PVQqEVbJ7+g ($189.25 in chips)
mfy7uGZcqA2PVQqEVbJ7+g: posts small blind $1
8srN1dKQePlsv0GyTada+Q: posts big blind $2
*** HOLE CARDS ***
nXDI8Y/S6POzRwANu3d8hQ: folds
vkfxu8f/jMYKUk6Ly4eujw: folds
3dAbvkxS5NPQTBAbvpinVg: folds
kfASJqTbXek+zc8ZKsZL1Q: raises $4 to $6
mfy7uGZcqA2PVQqEVbJ7+g: folds
8srN1dKQePlsv0GyTada+Q: raises $13 to $19
kfASJqTbXek+zc8ZKsZL1Q: folds
8srN1dKQePlsv0GyTada+Q collected $13 from pot
8srN1dKQePlsv0GyTada+Q: doesn't show hand
*** SUMMARY ***
Total pot $13 | Rake $0
Seat 1: 8srN1dKQePlsv0GyTada+Q (big blind) collected ($13)
Seat 2: nXDI8Y/S6POzRwANu3d8hQ folded before Flop (didn't bet)
Seat 3: vkfxu8f/jMYKUk6Ly4eujw folded before Flop (didn't bet)
Seat 4: 3dAbvkxS5NPQTBAbvpinVg folded before Flop (didn't bet)
Seat 5: kfASJqTbXek+zc8ZKsZL1Q (button) folded before Flop
Seat 6: mfy7uGZcqA2PVQqEVbJ7+g (small blind) folded before Flop



PokerStars Game #59941088632:  Hold'em No Limit ($1/$2) - 2009/07/01 1:25:19 ET
Table 'jlrIxbrVIG+gjaUYT4za8g' 6-max Seat #6 is the button
Seat 1: ygTTt5ehT4aF86q1a8/R+w ($262.30 in chips)
Seat 2: on4ebXPJvUBOcHOBMQsRSg ($62 in chips)
Seat 3: RUZs7P4uzWavoA6iEpDKLw ($94.75 in chips)
Seat 4: 8srN1dKQePlsv0GyTada+Q ($298.35 in chips)
Seat 5: AyBB0k3Dcl7xbXUeGMw06g ($92.90 in chips)
Seat 6: vkfxu8f/jMYKUk6Ly4eujw ($316 in chips)
ygTTt5ehT4aF86q1a8/R+w: posts small blind $1
on4ebXPJvUBOcHOBMQsRSg: posts big blind $2
*** HOLE CARDS ***
RUZs7P4uzWavoA6iEpDKLw: calls $2
8srN1dKQePlsv0GyTada+Q: folds
AyBB0k3Dcl7xbXUeGMw06g: folds
vkfxu8f/jMYKUk6Ly4eujw: folds
ygTTt5ehT4aF86q1a8/R+w: folds
on4ebXPJvUBOcHOBMQsRSg: checks
*** FLOP *** [5c 8d Ts]
on4ebXPJvUBOcHOBMQsRSg: checks
RUZs7P4uzWavoA6iEpDKLw: bets $4
on4ebXPJvUBOcHOBMQsRSg: raises $6 to $10
RUZs7P4uzWavoA6iEpDKLw: calls $6
*** TURN *** [5c 8d Ts] [7h]
on4ebXPJvUBOcHOBMQsRSg: bets $18
RUZs7P4uzWavoA6iEpDKLw: folds
on4ebXPJvUBOcHOBMQsRSg collected $23.80 from pot
*** SUMMARY ***
Total pot $25 | Rake $1.20
Board [5c 8d Ts 7h]
Seat 1: ygTTt5ehT4aF86q1a8/R+w (small blind) folded before Flop
Seat 2: on4ebXPJvUBOcHOBMQsRSg (big blind) collected ($23.80)
Seat 3: RUZs7P4uzWavoA6iEpDKLw folded on the Turn
Seat 4: 8srN1dKQePlsv0GyTada+Q folded before Flop (didn't bet)
Seat 5: AyBB0k3Dcl7xbXUeGMw06g folded before Flop (didn't bet)
Seat 6: vkfxu8f/jMYKUk6Ly4eujw (button) folded before Flop (didn't bet)



PokerStars Game #59941089214:  Hold'em No Limit ($1/$2) - 2009/07/01 1:25:20 ET
Table 'uJ9juaXXg9yIcSU8amxaXQ' 6-max Seat #5 is the button
Seat 1: JsqOjN/eHz0uYVf/PyUJ6Q ($146.85 in chips)
Seat 2: VvdR9F3I+2yELkfTVvC1dg ($205.60 in chips)
Seat 3: qXDd0ZyMIse0OBu8pxeQ3Q ($247 in chips)
Seat 4: zNjJ/y4emmF+vzrCDd+ooA ($229.85 in chips)
Seat 5: YsLQ3BAvgQHWXMAv3Wv6Hg ($200 in chips)
Seat 6: 2DFp9Veq1xxq64dCjwNuUw ($53.60 in chips)
2DFp9Veq1xxq64dCjwNuUw: posts small blind $1
JsqOjN/eHz0uYVf/PyUJ6Q: posts big blind $2
*** HOLE CARDS ***
VvdR9F3I+2yELkfTVvC1dg: raises $2 to $4
qXDd0ZyMIse0OBu8pxeQ3Q: folds
zNjJ/y4emmF+vzrCDd+ooA: folds
YsLQ3BAvgQHWXMAv3Wv6Hg: folds
2DFp9Veq1xxq64dCjwNuUw: raises $8 to $12
JsqOjN/eHz0uYVf/PyUJ6Q: folds
VvdR9F3I+2yELkfTVvC1dg: folds
2DFp9Veq1xxq64dCjwNuUw collected $10 from pot
2DFp9Veq1xxq64dCjwNuUw: doesn't show hand
*** SUMMARY ***
Total pot $10 | Rake $0
Seat 1: JsqOjN/eHz0uYVf/PyUJ6Q (big blind) folded before Flop
Seat 2: VvdR9F3I+2yELkfTVvC1dg folded before Flop
Seat 3: qXDd0ZyMIse0OBu8pxeQ3Q folded before Flop (didn't bet)
Seat 4: zNjJ/y4emmF+vzrCDd+ooA folded before Flop (didn't bet)
Seat 5: YsLQ3BAvgQHWXMAv3Wv6Hg (button) folded before Flop (didn't bet)
Seat 6: 2DFp9Veq1xxq64dCjwNuUw (small blind) collected ($10)



PokerStars Game #59941089832:  Hold'em No Limit ($1/$2) - 2009/07/01 1:25:21 ET
Table '4NGNnZ/osQfNq6abYqkJeA' 6-max Seat #1 is the button
Seat 1: 7zM38baFvmCNB/F80oE0cQ ($63.10 in chips)
Seat 2: 669iGNwYwgRZg3nhS+aDAQ ($94.15 in chips)
Seat 3: 54yWzRRgS0oZ+S6LwZBxMQ ($23.75 in chips)
Seat 4: sY+4Uuh5z/6AbXXaCS10jw ($214.35 in chips)
Seat 5: VvdR9F3I+2yELkfTVvC1dg ($234.80 in chips)
Seat 6: kkgpegLoQkmL6LIsFsvtiQ ($254.65 in chips)
669iGNwYwgRZg3nhS+aDAQ: posts small blind $1
54yWzRRgS0oZ+S6LwZBxMQ: posts big blind $2
*** HOLE CARDS ***
sY+4Uuh5z/6AbXXaCS10jw: folds
VvdR9F3I+2yELkfTVvC1dg: folds
kkgpegLoQkmL6LIsFsvtiQ: raises $6 to $8
7zM38baFvmCNB/F80oE0cQ: calls $8
669iGNwYwgRZg3nhS+aDAQ: folds
54yWzRRgS0oZ+S6LwZBxMQ: folds
*** FLOP *** [Jc 3c 9h]
kkgpegLoQkmL6LIsFsvtiQ: checks
7zM38baFvmCNB/F80oE0cQ: bets $4
kkgpegLoQkmL6LIsFsvtiQ: calls $4
*** TURN *** [Jc 3c 9h] [As]
kkgpegLoQkmL6LIsFsvtiQ: checks
7zM38baFvmCNB/F80oE0cQ: bets $4
kkgpegLoQkmL6LIsFsvtiQ: calls $4
*** RIVER *** [Jc 3c 9h As] [3s]
kkgpegLoQkmL6LIsFsvtiQ: checks
7zM38baFvmCNB/F80oE0cQ: bets $16
kkgpegLoQkmL6LIsFsvtiQ: folds
7zM38baFvmCNB/F80oE0cQ collected $33.35 from pot
7zM38baFvmCNB/F80oE0cQ: doesn't show hand
*** SUMMARY ***
Total pot $35 | Rake $1.65
Board [Jc 3c 9h As 3s]
Seat 1: 7zM38baFvmCNB/F80oE0cQ (button) collected ($33.35)
Seat 2: 669iGNwYwgRZg3nhS+aDAQ (small blind) folded before Flop
Seat 3: 54yWzRRgS0oZ+S6LwZBxMQ (big blind) folded before Flop
Seat 4: sY+4Uuh5z/6AbXXaCS10jw folded before Flop (didn't bet)
Seat 5: VvdR9F3I+2yELkfTVvC1dg folded before Flop (didn't bet)
Seat 6: kkgpegLoQkmL6LIsFsvtiQ folded on the River



PokerStars Game #59941090156:  Hold'em No Limit ($1/$2) - 2009/07/01 1:25:21 ET
Table 'YqGfR5eHfMeSjb9a+QU9rg' 9-max Seat #5 is the button
Seat 1: rW/MyplHylMSBRaoRUzWrg ($34 in chips)
Seat 2: W3Nqt1GWlTi9tXQXMNEvgw ($386.25 in chips)
Seat 3: /gll27k+xWYV7Fbki0lFDQ ($261.75 in chips)
Seat 5: CkE3IyJF1KvdaAOmZY5XqQ ($200 in chips)
Seat 6: TAfo4veNRaRlzDXMMYS3Jg ($35 in chips)
Seat 7: 41aZuLBz9nAi2GPVKabmCw ($110.45 in chips)
Seat 8: JnV3SM2D6dAFYyGZHHpvrg ($101.25 in chips)
Seat 9: /inIs/z/PcX+TniIFpaxpg ($200.05 in chips)
TAfo4veNRaRlzDXMMYS3Jg: posts small blind $1
41aZuLBz9nAi2GPVKabmCw: posts big blind $2
*** HOLE CARDS ***
JnV3SM2D6dAFYyGZHHpvrg: folds
/inIs/z/PcX+TniIFpaxpg: folds
rW/MyplHylMSBRaoRUzWrg: folds
W3Nqt1GWlTi9tXQXMNEvgw: folds
/gll27k+xWYV7Fbki0lFDQ: folds
CkE3IyJF1KvdaAOmZY5XqQ: folds
TAfo4veNRaRlzDXMMYS3Jg: raises $33 to $35 and is all-in
41aZuLBz9nAi2GPVKabmCw: folds
TAfo4veNRaRlzDXMMYS3Jg collected $4 from pot
TAfo4veNRaRlzDXMMYS3Jg: doesn't show hand
*** SUMMARY ***
Total pot $4 | Rake $0
Seat 1: rW/MyplHylMSBRaoRUzWrg folded before Flop (didn't bet)
Seat 2: W3Nqt1GWlTi9tXQXMNEvgw folded before Flop (didn't bet)
Seat 3: /gll27k+xWYV7Fbki0lFDQ folded before Flop (didn't bet)
Seat 5: CkE3IyJF1KvdaAOmZY5XqQ (button) folded before Flop (didn't bet)
Seat 6: TAfo4veNRaRlzDXMMYS3Jg (small blind) collected ($4)
Seat 7: 41aZuLBz9nAi2GPVKabmCw (big blind) folded before Flop
Seat 8: JnV3SM2D6dAFYyGZHHpvrg folded before Flop (didn't bet)
Seat 9: /inIs/z/PcX+TniIFpaxpg folded before Flop (didn't bet)



PokerStars Game #59941090048:  Hold'em No Limit ($1/$2) - 2009/07/01 1:25:21 ET
Table 'NmY84NAf9Mh0ckAckHnh5g' 2-max Seat #1 is the button
Seat 1: 6hvg964TSqZ3AL/0XK9aVQ ($246.10 in chips)
Seat 2: RwDoM55ZeQuI2ADyJhOb2Q ($757.90 in chips)
6hvg964TSqZ3AL/0XK9aVQ: posts small blind $1
RwDoM55ZeQuI2ADyJhOb2Q: posts big blind $2
*** HOLE CARDS ***
6hvg964TSqZ3AL/0XK9aVQ: calls $1
RwDoM55ZeQuI2ADyJhOb2Q: checks
*** FLOP *** [3d Jc 5h]
RwDoM55ZeQuI2ADyJhOb2Q: bets $4
6hvg964TSqZ3AL/0XK9aVQ: calls $4
*** TURN *** [3d Jc 5h] [Jd]
RwDoM55ZeQuI2ADyJhOb2Q: bets $12
6hvg964TSqZ3AL/0XK9aVQ: folds
RwDoM55ZeQuI2ADyJhOb2Q collected $11.50 from pot
RwDoM55ZeQuI2ADyJhOb2Q: doesn't show hand
*** SUMMARY ***
Total pot $12 | Rake $0.50
Board [3d Jc 5h Jd]
Seat 1: 6hvg964TSqZ3AL/0XK9aVQ (button) (small blind) folded on the Turn
Seat 2: RwDoM55ZeQuI2ADyJhOb2Q (big blind) collected ($11.50)



PokerStars Game #59941090650:  Hold'em No Limit ($1/$2) - 2009/07/01 1:25:22 ET
Table 'pPQgcj9XT9CHBsbo1WTBug' 6-max Seat #1 is the button
Seat 1: DFVYDA6dKQy7R7mGIKogZA ($125.65 in chips)
Seat 2: qXDd0ZyMIse0OBu8pxeQ3Q ($206.30 in chips)
Seat 3: 54yWzRRgS0oZ+S6LwZBxMQ ($64.75 in chips)
Seat 4: gqlysXCbT8V54f/1lf9h3A ($36.30 in chips)
Seat 5: vkfxu8f/jMYKUk6Ly4eujw ($210.55 in chips)
Seat 6: Yr7pZltpy3IUNdKS9PCEiw ($304.30 in chips)
qXDd0ZyMIse0OBu8pxeQ3Q: posts small blind $1
54yWzRRgS0oZ+S6LwZBxMQ: posts big blind $2
*** HOLE CARDS ***
gqlysXCbT8V54f/1lf9h3A: folds
vkfxu8f/jMYKUk6Ly4eujw: folds
Yr7pZltpy3IUNdKS9PCEiw: folds
DFVYDA6dKQy7R7mGIKogZA: folds
qXDd0ZyMIse0OBu8pxeQ3Q: raises $4 to $6
54yWzRRgS0oZ+S6LwZBxMQ: folds
qXDd0ZyMIse0OBu8pxeQ3Q collected $4 from pot
*** SUMMARY ***
Total pot $4 | Rake $0
Seat 1: DFVYDA6dKQy7R7mGIKogZA (button) folded before Flop (didn't bet)
Seat 2: qXDd0ZyMIse0OBu8pxeQ3Q (small blind) collected ($4)
Seat 3: 54yWzRRgS0oZ+S6LwZBxMQ (big blind) folded before Flop
Seat 4: gqlysXCbT8V54f/1lf9h3A folded before Flop (didn't bet)
Seat 5: vkfxu8f/jMYKUk6Ly4eujw folded before Flop (didn't bet)
Seat 6: Yr7pZltpy3IUNdKS9PCEiw folded before Flop (didn't bet)



PokerStars Game #59941092000:  Hold'em No Limit ($1/$2) - 2009/07/01 1:25:25 ET
Table '+hSnXFQrGw1PlVgTnuj+sA' 6-max Seat #5 is the button
Seat 1: 2ccIJhDj+3JapvS7swVZEg ($329.60 in chips)
Seat 2: o9jamqIi6sTTRSqudgboRA ($281.90 in chips)
Seat 3: fE+LHW/7rpfXW14g8LhGjA ($57.30 in chips)
Seat 4: J4iH5epwXbmODnojR/VRxA ($157.60 in chips)
Seat 5: VvdR9F3I+2yELkfTVvC1dg ($200 in chips)
Seat 6: AuiGltq875lmaKHBsjZVGg ($73.75 in chips)
AuiGltq875lmaKHBsjZVGg: posts small blind $1
2ccIJhDj+3JapvS7swVZEg: posts big blind $2
*** HOLE CARDS ***
o9jamqIi6sTTRSqudgboRA: folds
fE+LHW/7rpfXW14g8LhGjA: folds
o9jamqIi6sTTRSqudgboRA leaves the table
J4iH5epwXbmODnojR/VRxA: folds
VvdR9F3I+2yELkfTVvC1dg: folds
AuiGltq875lmaKHBsjZVGg: raises $2 to $4
2ccIJhDj+3JapvS7swVZEg: raises $2 to $6
AuiGltq875lmaKHBsjZVGg: calls $2
*** FLOP *** [Ad Ac Jh]
AuiGltq875lmaKHBsjZVGg: checks
2ccIJhDj+3JapvS7swVZEg: checks
*** TURN *** [Ad Ac Jh] [4c]
AuiGltq875lmaKHBsjZVGg: checks
2ccIJhDj+3JapvS7swVZEg: checks
*** RIVER *** [Ad Ac Jh 4c] [4s]
AuiGltq875lmaKHBsjZVGg: checks
2ccIJhDj+3JapvS7swVZEg: checks
*** SHOW DOWN ***
AuiGltq875lmaKHBsjZVGg: shows [Qs 3s] (two pair, Aces and Fours)
2ccIJhDj+3JapvS7swVZEg: shows [Qh Kd] (two pair, Aces and Fours - King kicker)
2ccIJhDj+3JapvS7swVZEg collected $11.40 from pot
*** SUMMARY ***
Total pot $12 | Rake $0.60
Board [Ad Ac Jh 4c 4s]
Seat 1: 2ccIJhDj+3JapvS7swVZEg (big blind) showed [Qh Kd] and won ($11.40) with two pair, Aces and Fours
Seat 2: o9jamqIi6sTTRSqudgboRA folded before Flop (didn't bet)
Seat 3: fE+LHW/7rpfXW14g8LhGjA folded before Flop (didn't bet)
Seat 4: J4iH5epwXbmODnojR/VRxA folded before Flop (didn't bet)
Seat 5: VvdR9F3I+2yELkfTVvC1dg (button) folded before Flop (didn't bet)
Seat 6: AuiGltq875lmaKHBsjZVGg (small blind) showed [Qs 3s] and lost with two pair, Aces and Fours



PokerStars Game #59941096348:  Hold'em No Limit ($1/$2) - 2009/07/01 1:25:32 ET
Table 'CFkQcfWjKccZaZDf71FK+w' 6-max Seat #5 is the button
Seat 1: JsC+WvfzqlxVs9G8/gSQAQ ($25.05 in chips)
Seat 2: ewN/vzF22+/gdzjIKBOlkA ($184.20 in chips)
Seat 3: 09BNF4quPDzanQzM8vc6WA ($48.45 in chips)
Seat 4: ygTTt5ehT4aF86q1a8/R+w ($192.75 in chips)
Seat 5: 2lOU1DcvUZaMcxZ95XfzXw ($145 in chips)
Seat 6: ORVqY3rf9X6ANA/8s+On2Q ($76.50 in chips)
ORVqY3rf9X6ANA/8s+On2Q: posts small blind $1
JsC+WvfzqlxVs9G8/gSQAQ: posts big blind $2
*** HOLE CARDS ***
ewN/vzF22+/gdzjIKBOlkA: folds
09BNF4quPDzanQzM8vc6WA: folds
ygTTt5ehT4aF86q1a8/R+w: folds
2lOU1DcvUZaMcxZ95XfzXw: folds
ORVqY3rf9X6ANA/8s+On2Q: folds
JsC+WvfzqlxVs9G8/gSQAQ collected $2 from pot
*** SUMMARY ***
Total pot $2 | Rake $0
Seat 1: JsC+WvfzqlxVs9G8/gSQAQ (big blind) collected ($2)
Seat 2: ewN/vzF22+/gdzjIKBOlkA folded before Flop (didn't bet)
Seat 3: 09BNF4quPDzanQzM8vc6WA folded before Flop (didn't bet)
Seat 4: ygTTt5ehT4aF86q1a8/R+w folded before Flop (didn't bet)
Seat 5: 2lOU1DcvUZaMcxZ95XfzXw (button) folded before Flop (didn't bet)
Seat 6: ORVqY3rf9X6ANA/8s+On2Q (small blind) folded before Flop



PokerStars Game #59941096946:  Hold'em No Limit ($1/$2) - 2009/07/01 1:25:33 ET
Table 'QxerF7GUfCbl+4a8XaTB2w' 6-max Seat #4 is the button
Seat 1: 54yWzRRgS0oZ+S6LwZBxMQ ($37 in chips)
Seat 2: HiWSAXs6/0w9Jy7ioiiShQ ($36 in chips)
Seat 3: m7mYVfnCOK5TE/VkN/FhOg ($272.10 in chips)
Seat 4: 09BNF4quPDzanQzM8vc6WA ($41.55 in chips)
Seat 5: gnYme0DNFflnMhrdbxe1Ag ($245.70 in chips)
Seat 6: VvdR9F3I+2yELkfTVvC1dg ($200 in chips)
gnYme0DNFflnMhrdbxe1Ag: posts small blind $1
VvdR9F3I+2yELkfTVvC1dg: posts big blind $2
*** HOLE CARDS ***
54yWzRRgS0oZ+S6LwZBxMQ: folds
HiWSAXs6/0w9Jy7ioiiShQ: folds
m7mYVfnCOK5TE/VkN/FhOg: raises $4 to $6
09BNF4quPDzanQzM8vc6WA: folds
gnYme0DNFflnMhrdbxe1Ag: folds
VvdR9F3I+2yELkfTVvC1dg: folds
m7mYVfnCOK5TE/VkN/FhOg collected $5 from pot
*** SUMMARY ***
Total pot $5 | Rake $0
Seat 1: 54yWzRRgS0oZ+S6LwZBxMQ folded before Flop (didn't bet)
Seat 2: HiWSAXs6/0w9Jy7ioiiShQ folded before Flop (didn't bet)
Seat 3: m7mYVfnCOK5TE/VkN/FhOg collected ($5)
Seat 4: 09BNF4quPDzanQzM8vc6WA (button) folded before Flop (didn't bet)
Seat 5: gnYme0DNFflnMhrdbxe1Ag (small blind) folded before Flop
Seat 6: VvdR9F3I+2yELkfTVvC1dg (big blind) folded before Flop



PokerStars Game #59941096818:  Hold'em No Limit ($1/$2) - 2009/07/01 1:25:33 ET
Table 'W9UeSV0aoPjh5SFSxM8jUQ' 9-max Seat #3 is the button
Seat 1: mIKx5lhIt13X5eZQH0ZeMA ($25 in chips)
Seat 2: iMe5yhc+1BaiIPHet3NMrA ($252.60 in chips)
Seat 3: /inIs/z/PcX+TniIFpaxpg ($25 in chips)
Seat 4: 4YA/sQy1Emm680zhbPUjow ($135.35 in chips)
Seat 5: ri8CLkX3e9JF34dQNbsHGA ($42.45 in chips)
Seat 6: j47DM+lqTfzZP8musviQTg ($110.90 in chips)
Seat 7: I2ipWauytvrkEer4XD3Sjg ($84 in chips)
Seat 8: odhvI/CZeMsPyo1n1U7+hA ($49.70 in chips)
Seat 9: Q104K4iDGcqOlVrjAkzPEA ($98.10 in chips)
4YA/sQy1Emm680zhbPUjow: posts small blind $1
ri8CLkX3e9JF34dQNbsHGA: posts big blind $2
*** HOLE CARDS ***
j47DM+lqTfzZP8musviQTg: folds
I2ipWauytvrkEer4XD3Sjg: calls $2
odhvI/CZeMsPyo1n1U7+hA: folds
Q104K4iDGcqOlVrjAkzPEA: folds
mIKx5lhIt13X5eZQH0ZeMA: folds
iMe5yhc+1BaiIPHet3NMrA: folds
/inIs/z/PcX+TniIFpaxpg: folds
4YA/sQy1Emm680zhbPUjow: calls $1
ri8CLkX3e9JF34dQNbsHGA: checks
*** FLOP *** [Jc Jd 2h]
4YA/sQy1Emm680zhbPUjow: checks
ri8CLkX3e9JF34dQNbsHGA: checks
I2ipWauytvrkEer4XD3Sjg: checks
*** TURN *** [Jc Jd 2h] [Qd]
4YA/sQy1Emm680zhbPUjow: checks
ri8CLkX3e9JF34dQNbsHGA: checks
I2ipWauytvrkEer4XD3Sjg: bets $6
4YA/sQy1Emm680zhbPUjow: folds
ri8CLkX3e9JF34dQNbsHGA: folds
I2ipWauytvrkEer4XD3Sjg collected $5.70 from pot
*** SUMMARY ***
Total pot $6 | Rake $0.30
Board [Jc Jd 2h Qd]
Seat 1: mIKx5lhIt13X5eZQH0ZeMA folded before Flop (didn't bet)
Seat 2: iMe5yhc+1BaiIPHet3NMrA folded before Flop (didn't bet)
Seat 3: /inIs/z/PcX+TniIFpaxpg (button) folded before Flop (didn't bet)
Seat 4: 4YA/sQy1Emm680zhbPUjow (small blind) folded on the Turn
Seat 5: ri8CLkX3e9JF34dQNbsHGA (big blind) folded on the Turn
Seat 6: j47DM+lqTfzZP8musviQTg folded before Flop (didn't bet)
Seat 7: I2ipWauytvrkEer4XD3Sjg collected ($5.70)
Seat 8: odhvI/CZeMsPyo1n1U7+hA folded before Flop (didn't bet)
Seat 9: Q104K4iDGcqOlVrjAkzPEA folded before Flop (didn't bet)



PokerStars Game #59941099278:  Hold'em No Limit ($1/$2) - 2009/07/01 1:25:37 ET
Table 'ZzSIe0zTCDv+n6hfbY5tTg' 6-max Seat #3 is the button
Seat 1: VvdR9F3I+2yELkfTVvC1dg ($201 in chips)
Seat 2: B87ikIyZ/TzAVeXf38Ny0g ($241 in chips)
Seat 3: gsugPj31Hui3Jefl98MBOA ($212.60 in chips)
Seat 4: qXDd0ZyMIse0OBu8pxeQ3Q ($210.70 in chips)
Seat 5: 3dAbvkxS5NPQTBAbvpinVg ($483.30 in chips)
Seat 6: 09BNF4quPDzanQzM8vc6WA ($23.05 in chips)
qXDd0ZyMIse0OBu8pxeQ3Q: posts small blind $1
3dAbvkxS5NPQTBAbvpinVg: posts big blind $2
*** HOLE CARDS ***
09BNF4quPDzanQzM8vc6WA: folds
VvdR9F3I+2yELkfTVvC1dg: folds
B87ikIyZ/TzAVeXf38Ny0g: raises $4 to $6
gsugPj31Hui3Jefl98MBOA: calls $6
qXDd0ZyMIse0OBu8pxeQ3Q: folds
3dAbvkxS5NPQTBAbvpinVg: folds
*** FLOP *** [5c 3h 9h]
B87ikIyZ/TzAVeXf38Ny0g: bets $8
gsugPj31Hui3Jefl98MBOA: raises $10 to $18
B87ikIyZ/TzAVeXf38Ny0g: calls $10
*** TURN *** [5c 3h 9h] [3c]
B87ikIyZ/TzAVeXf38Ny0g: checks
gsugPj31Hui3Jefl98MBOA: bets $21
B87ikIyZ/TzAVeXf38Ny0g: calls $21
*** RIVER *** [5c 3h 9h 3c] [Jh]
B87ikIyZ/TzAVeXf38Ny0g: checks
gsugPj31Hui3Jefl98MBOA: checks
*** SHOW DOWN ***
B87ikIyZ/TzAVeXf38Ny0g: shows [9c 8d] (two pair, Nines and Threes)
gsugPj31Hui3Jefl98MBOA: mucks hand
B87ikIyZ/TzAVeXf38Ny0g collected $90 from pot
*** SUMMARY ***
Total pot $93 | Rake $3
Board [5c 3h 9h 3c Jh]
Seat 1: VvdR9F3I+2yELkfTVvC1dg folded before Flop (didn't bet)
Seat 2: B87ikIyZ/TzAVeXf38Ny0g showed [9c 8d] and won ($90) with two pair, Nines and Threes
Seat 3: gsugPj31Hui3Jefl98MBOA (button) mucked
Seat 4: qXDd0ZyMIse0OBu8pxeQ3Q (small blind) folded before Flop
Seat 5: 3dAbvkxS5NPQTBAbvpinVg (big blind) folded before Flop
Seat 6: 09BNF4quPDzanQzM8vc6WA folded before Flop (didn't bet)



PokerStars Game #59941098848:  Hold'em No Limit ($1/$2) - 2009/07/01 1:25:37 ET
Table 'aSf77Sj8QEnzcc0WaxVD4Q' 6-max Seat #6 is the button
Seat 1: UELtvp+JfwI7XDGVwSxZXA ($163.75 in chips)
Seat 2: vkfxu8f/jMYKUk6Ly4eujw ($200 in chips)
Seat 3: 9dpyyjDTCed6nV7JhaUUpw ($526.70 in chips)
Seat 4: YsLQ3BAvgQHWXMAv3Wv6Hg ($262.70 in chips)
Seat 5: VvdR9F3I+2yELkfTVvC1dg ($245 in chips)
Seat 6: vkoJRf3gidxY1pPi0AFWww ($118.55 in chips)
UELtvp+JfwI7XDGVwSxZXA: posts small blind $1
vkfxu8f/jMYKUk6Ly4eujw: posts big blind $2
*** HOLE CARDS ***
9dpyyjDTCed6nV7JhaUUpw: folds
YsLQ3BAvgQHWXMAv3Wv6Hg: folds
VvdR9F3I+2yELkfTVvC1dg: folds
vkoJRf3gidxY1pPi0AFWww: folds
UELtvp+JfwI7XDGVwSxZXA: calls $1
vkfxu8f/jMYKUk6Ly4eujw: checks
*** FLOP *** [5c Ah 2c]
UELtvp+JfwI7XDGVwSxZXA: checks
vkfxu8f/jMYKUk6Ly4eujw: checks
*** TURN *** [5c Ah 2c] [8h]
UELtvp+JfwI7XDGVwSxZXA: checks
vkfxu8f/jMYKUk6Ly4eujw: checks
*** RIVER *** [5c Ah 2c 8h] [6c]
UELtvp+JfwI7XDGVwSxZXA: checks
vkfxu8f/jMYKUk6Ly4eujw: checks
*** SHOW DOWN ***
UELtvp+JfwI7XDGVwSxZXA: shows [2s 9s] (a pair of Deuces)
vkfxu8f/jMYKUk6Ly4eujw: mucks hand
UELtvp+JfwI7XDGVwSxZXA collected $3.80 from pot
*** SUMMARY ***
Total pot $4 | Rake $0.20
Board [5c Ah 2c 8h 6c]
Seat 1: UELtvp+JfwI7XDGVwSxZXA (small blind) showed [2s 9s] and won ($3.80) with a pair of Deuces
Seat 2: vkfxu8f/jMYKUk6Ly4eujw (big blind) mucked
Seat 3: 9dpyyjDTCed6nV7JhaUUpw folded before Flop (didn't bet)
Seat 4: YsLQ3BAvgQHWXMAv3Wv6Hg folded before Flop (didn't bet)
Seat 5: VvdR9F3I+2yELkfTVvC1dg folded before Flop (didn't bet)
Seat 6: vkoJRf3gidxY1pPi0AFWww (button) folded before Flop (didn't bet)



PokerStars Game #59941099520:  Hold'em No Limit ($1/$2) - 2009/07/01 1:25:38 ET
Table '3WCXyaiCAbqSShQu7FIjvA' 9-max Seat #1 is the button
Seat 1: kTCkABD1UUldS9DFRGfCwQ ($151.40 in chips)
Seat 2: 1zQMh8lHgW3t2YhVeA+09A ($6.80 in chips)
Seat 3: 5Q8U6iZbeO7xJSS4qvDP5g ($200 in chips)
Seat 4: waEF/+pxZTxNo4FvsORuXg ($77 in chips)
Seat 5: CkE3IyJF1KvdaAOmZY5XqQ ($200 in chips)
Seat 6: 5jQlngvMSqM/WoonOcR5kw ($296 in chips)
Seat 8: 1CtiZuXDFaJL1dJPQKyi8Q ($242.35 in chips)
Seat 9: FiXPLJyqb24l32QST2TInw ($153.40 in chips)
1zQMh8lHgW3t2YhVeA+09A: posts small blind $1
5Q8U6iZbeO7xJSS4qvDP5g: posts big blind $2
*** HOLE CARDS ***
waEF/+pxZTxNo4FvsORuXg: folds
CkE3IyJF1KvdaAOmZY5XqQ: folds
5jQlngvMSqM/WoonOcR5kw: folds
1CtiZuXDFaJL1dJPQKyi8Q: folds
FiXPLJyqb24l32QST2TInw: folds
kTCkABD1UUldS9DFRGfCwQ: folds
1zQMh8lHgW3t2YhVeA+09A: calls $1
5Q8U6iZbeO7xJSS4qvDP5g: raises $7 to $9
1zQMh8lHgW3t2YhVeA+09A: calls $4.80 and is all-in
*** FLOP *** [2d 6h Js]
*** TURN *** [2d 6h Js] [Th]
*** RIVER *** [2d 6h Js Th] [6s]
*** SHOW DOWN ***
1zQMh8lHgW3t2YhVeA+09A: shows [9s 3s] (a pair of Sixes)
5Q8U6iZbeO7xJSS4qvDP5g: shows [4h Ah] (a pair of Sixes - Ace kicker)
5Q8U6iZbeO7xJSS4qvDP5g collected $12.95 from pot
*** SUMMARY ***
Total pot $13.60 | Rake $0.65
Board [2d 6h Js Th 6s]
Seat 1: kTCkABD1UUldS9DFRGfCwQ (button) folded before Flop (didn't bet)
Seat 2: 1zQMh8lHgW3t2YhVeA+09A (small blind) showed [9s 3s] and lost with a pair of Sixes
Seat 3: 5Q8U6iZbeO7xJSS4qvDP5g (big blind) showed [4h Ah] and won ($12.95) with a pair of Sixes
Seat 4: waEF/+pxZTxNo4FvsORuXg folded before Flop (didn't bet)
Seat 5: CkE3IyJF1KvdaAOmZY5XqQ folded before Flop (didn't bet)
Seat 6: 5jQlngvMSqM/WoonOcR5kw folded before Flop (didn't bet)
Seat 8: 1CtiZuXDFaJL1dJPQKyi8Q folded before Flop (didn't bet)
Seat 9: FiXPLJyqb24l32QST2TInw folded before Flop (didn't bet)



PokerStars Game #59941100586:  Hold'em No Limit ($1/$2) - 2009/07/01 1:25:40 ET
Table 'NmY84NAf9Mh0ckAckHnh5g' 2-max Seat #2 is the button
Seat 1: 6hvg964TSqZ3AL/0XK9aVQ ($240.10 in chips)
Seat 2: RwDoM55ZeQuI2ADyJhOb2Q ($763.40 in chips)
RwDoM55ZeQuI2ADyJhOb2Q: posts small blind $1
6hvg964TSqZ3AL/0XK9aVQ: posts big blind $2
*** HOLE CARDS ***
RwDoM55ZeQuI2ADyJhOb2Q: raises $4 to $6
6hvg964TSqZ3AL/0XK9aVQ: folds
RwDoM55ZeQuI2ADyJhOb2Q collected $4 from pot
RwDoM55ZeQuI2ADyJhOb2Q: doesn't show hand
*** SUMMARY ***
Total pot $4 | Rake $0
Seat 1: 6hvg964TSqZ3AL/0XK9aVQ (big blind) folded before Flop
Seat 2: RwDoM55ZeQuI2ADyJhOb2Q (button) (small blind) collected ($4)



PokerStars Game #59941102448:  Hold'em No Limit ($1/$2) - 2009/07/01 1:25:43 ET
Table 'kq5zaQ+1hLNf8LZfGnbTAA' 6-max Seat #6 is the button
Seat 1: 8srN1dKQePlsv0GyTada+Q ($210 in chips)
Seat 2: nXDI8Y/S6POzRwANu3d8hQ ($200 in chips)
Seat 3: vkfxu8f/jMYKUk6Ly4eujw ($227.95 in chips)
Seat 4: 3dAbvkxS5NPQTBAbvpinVg ($200 in chips)
Seat 5: kfASJqTbXek+zc8ZKsZL1Q ($272.50 in chips)
Seat 6: mfy7uGZcqA2PVQqEVbJ7+g ($188.25 in chips)
8srN1dKQePlsv0GyTada+Q: posts small blind $1
nXDI8Y/S6POzRwANu3d8hQ: posts big blind $2
*** HOLE CARDS ***
vkfxu8f/jMYKUk6Ly4eujw: folds
3dAbvkxS5NPQTBAbvpinVg: folds
kfASJqTbXek+zc8ZKsZL1Q: raises $4 to $6
mfy7uGZcqA2PVQqEVbJ7+g: raises $15 to $21
8srN1dKQePlsv0GyTada+Q: folds
nXDI8Y/S6POzRwANu3d8hQ: folds
kfASJqTbXek+zc8ZKsZL1Q: folds
mfy7uGZcqA2PVQqEVbJ7+g collected $15 from pot
mfy7uGZcqA2PVQqEVbJ7+g: doesn't show hand
*** SUMMARY ***
Total pot $15 | Rake $0
Seat 1: 8srN1dKQePlsv0GyTada+Q (small blind) folded before Flop
Seat 2: nXDI8Y/S6POzRwANu3d8hQ (big blind) folded before Flop
Seat 3: vkfxu8f/jMYKUk6Ly4eujw folded before Flop (didn't bet)
Seat 4: 3dAbvkxS5NPQTBAbvpinVg folded before Flop (didn't bet)
Seat 5: kfASJqTbXek+zc8ZKsZL1Q folded before Flop
Seat 6: mfy7uGZcqA2PVQqEVbJ7+g (button) collected ($15)



PokerStars Game #59941103148:  Hold'em No Limit ($1/$2) - 2009/07/01 1:25:44 ET
Table 'uJ9juaXXg9yIcSU8amxaXQ' 6-max Seat #6 is the button
Seat 1: JsqOjN/eHz0uYVf/PyUJ6Q ($144.85 in chips)
Seat 2: VvdR9F3I+2yELkfTVvC1dg ($201.60 in chips)
Seat 3: qXDd0ZyMIse0OBu8pxeQ3Q ($247 in chips)
Seat 4: zNjJ/y4emmF+vzrCDd+ooA ($229.85 in chips)
Seat 5: YsLQ3BAvgQHWXMAv3Wv6Hg ($200 in chips)
Seat 6: 2DFp9Veq1xxq64dCjwNuUw ($59.60 in chips)
JsqOjN/eHz0uYVf/PyUJ6Q: posts small blind $1
VvdR9F3I+2yELkfTVvC1dg: posts big blind $2
*** HOLE CARDS ***
qXDd0ZyMIse0OBu8pxeQ3Q: folds
zNjJ/y4emmF+vzrCDd+ooA: calls $2
YsLQ3BAvgQHWXMAv3Wv6Hg: folds
2DFp9Veq1xxq64dCjwNuUw: folds
JsqOjN/eHz0uYVf/PyUJ6Q: folds
VvdR9F3I+2yELkfTVvC1dg: checks
*** FLOP *** [Qh 2s 3s]
VvdR9F3I+2yELkfTVvC1dg: checks
zNjJ/y4emmF+vzrCDd+ooA: checks
*** TURN *** [Qh 2s 3s] [Ac]
VvdR9F3I+2yELkfTVvC1dg: checks
zNjJ/y4emmF+vzrCDd+ooA: bets $2
VvdR9F3I+2yELkfTVvC1dg: folds
zNjJ/y4emmF+vzrCDd+ooA collected $4.75 from pot
*** SUMMARY ***
Total pot $5 | Rake $0.25
Board [Qh 2s 3s Ac]
Seat 1: JsqOjN/eHz0uYVf/PyUJ6Q (small blind) folded before Flop
Seat 2: VvdR9F3I+2yELkfTVvC1dg (big blind) folded on the Turn
Seat 3: qXDd0ZyMIse0OBu8pxeQ3Q folded before Flop (didn't bet)
Seat 4: zNjJ/y4emmF+vzrCDd+ooA collected ($4.75)
Seat 5: YsLQ3BAvgQHWXMAv3Wv6Hg folded before Flop (didn't bet)
Seat 6: 2DFp9Veq1xxq64dCjwNuUw (button) folded before Flop (didn't bet)



PokerStars Game #59941103188:  Hold'em No Limit ($1/$2) - 2009/07/01 1:25:44 ET
Table '/dyk+YdRGv90j2box35j8w' 6-max Seat #2 is the button
Seat 1: 8srN1dKQePlsv0GyTada+Q ($203 in chips)
Seat 2: qCnEYuAE5y5A7bk6fO5/jQ ($476.60 in chips)
Seat 3: sTPOWERd9HWPCNrDBwsVjA ($186.75 in chips)
Seat 4: z/u1YTnkiIDrtp/2cA2dBg ($196.65 in chips)
Seat 5: VvdR9F3I+2yELkfTVvC1dg ($200 in chips)
sTPOWERd9HWPCNrDBwsVjA: posts small blind $1
z/u1YTnkiIDrtp/2cA2dBg: posts big blind $2
*** HOLE CARDS ***
VvdR9F3I+2yELkfTVvC1dg: raises $2 to $4
8srN1dKQePlsv0GyTada+Q: folds
qCnEYuAE5y5A7bk6fO5/jQ: folds
sTPOWERd9HWPCNrDBwsVjA: folds
z/u1YTnkiIDrtp/2cA2dBg: calls $2
*** FLOP *** [2s 3c 3h]
z/u1YTnkiIDrtp/2cA2dBg: checks
VvdR9F3I+2yELkfTVvC1dg: checks
*** TURN *** [2s 3c 3h] [5h]
z/u1YTnkiIDrtp/2cA2dBg: bets $2
VvdR9F3I+2yELkfTVvC1dg: calls $2
*** RIVER *** [2s 3c 3h 5h] [Jc]
z/u1YTnkiIDrtp/2cA2dBg: bets $10
VvdR9F3I+2yELkfTVvC1dg: folds
z/u1YTnkiIDrtp/2cA2dBg collected $12.40 from pot
*** SUMMARY ***
Total pot $13 | Rake $0.60
Board [2s 3c 3h 5h Jc]
Seat 1: 8srN1dKQePlsv0GyTada+Q folded before Flop (didn't bet)
Seat 2: qCnEYuAE5y5A7bk6fO5/jQ (button) folded before Flop (didn't bet)
Seat 3: sTPOWERd9HWPCNrDBwsVjA (small blind) folded before Flop
Seat 4: z/u1YTnkiIDrtp/2cA2dBg (big blind) collected ($12.40)
Seat 5: VvdR9F3I+2yELkfTVvC1dg folded on the River



PokerStars Game #59941103638:  Hold'em No Limit ($1/$2) - 2009/07/01 1:25:45 ET
Table 'rsKRKlGHlxVyqJxzO2a2Ow' 9-max Seat #9 is the button
Seat 1: uYWfQJg2hgHLxri6/uVJiw ($360.50 in chips)
Seat 3: zTcFtoHqqK4550YMZ8Y14Q ($42.50 in chips)
Seat 4: 31HuO+DQxppUQEedBWukug ($114.85 in chips)
Seat 5: 5Q8U6iZbeO7xJSS4qvDP5g ($202 in chips)
Seat 6: H6Z4+qu8gR0VUiPOijndVg ($204.55 in chips)
Seat 7: GX1heJ+DSsvm7gzSPsYhhQ ($33 in chips)
Seat 8: CkE3IyJF1KvdaAOmZY5XqQ ($215.75 in chips)
Seat 9: gRbvhSUVg+TNaTjaJecIRw ($52 in chips)
uYWfQJg2hgHLxri6/uVJiw: posts small blind $1
zTcFtoHqqK4550YMZ8Y14Q: posts big blind $2
*** HOLE CARDS ***
31HuO+DQxppUQEedBWukug: folds
5Q8U6iZbeO7xJSS4qvDP5g: folds
H6Z4+qu8gR0VUiPOijndVg: folds
GX1heJ+DSsvm7gzSPsYhhQ: folds
CkE3IyJF1KvdaAOmZY5XqQ: folds
gRbvhSUVg+TNaTjaJecIRw: raises $4 to $6
uYWfQJg2hgHLxri6/uVJiw: calls $5
zTcFtoHqqK4550YMZ8Y14Q: folds
*** FLOP *** [Kd Jh Kh]
uYWfQJg2hgHLxri6/uVJiw: checks
gRbvhSUVg+TNaTjaJecIRw: checks
*** TURN *** [Kd Jh Kh] [Qh]
uYWfQJg2hgHLxri6/uVJiw: bets $6
gRbvhSUVg+TNaTjaJecIRw: raises $16 to $22
uYWfQJg2hgHLxri6/uVJiw: calls $16
*** RIVER *** [Kd Jh Kh Qh] [Ad]
uYWfQJg2hgHLxri6/uVJiw: checks
gRbvhSUVg+TNaTjaJecIRw: checks
*** SHOW DOWN ***
uYWfQJg2hgHLxri6/uVJiw: shows [Td 9d] (a straight, Ten to Ace)
gRbvhSUVg+TNaTjaJecIRw: mucks hand
uYWfQJg2hgHLxri6/uVJiw collected $55.15 from pot
*** SUMMARY ***
Total pot $58 | Rake $2.85
Board [Kd Jh Kh Qh Ad]
Seat 1: uYWfQJg2hgHLxri6/uVJiw (small blind) showed [Td 9d] and won ($55.15) with a straight, Ten to Ace
Seat 3: zTcFtoHqqK4550YMZ8Y14Q (big blind) folded before Flop
Seat 4: 31HuO+DQxppUQEedBWukug folded before Flop (didn't bet)
Seat 5: 5Q8U6iZbeO7xJSS4qvDP5g folded before Flop (didn't bet)
Seat 6: H6Z4+qu8gR0VUiPOijndVg folded before Flop (didn't bet)
Seat 7: GX1heJ+DSsvm7gzSPsYhhQ folded before Flop (didn't bet)
Seat 8: CkE3IyJF1KvdaAOmZY5XqQ folded before Flop (didn't bet)
Seat 9: gRbvhSUVg+TNaTjaJecIRw (button) mucked



PokerStars Game #59941103834:  Hold'em No Limit ($1/$2) - 2009/07/01 1:25:45 ET
Table 'rKeCh+eBn4RNvybCUYkoTQ' 9-max Seat #9 is the button
Seat 1: /inIs/z/PcX+TniIFpaxpg ($201 in chips)
Seat 2: 9cBHwK40Tl06vheE7B3LHQ ($159.55 in chips)
Seat 3: GX1heJ+DSsvm7gzSPsYhhQ ($34 in chips)
Seat 4: 31HuO+DQxppUQEedBWukug ($92.10 in chips)
Seat 5: WUlHm+ydPPHG7Lb0rePSdA ($128 in chips)
Seat 6: EBV6OktyeSmh4w6sWmcWOw ($267 in chips)
Seat 7: rW/MyplHylMSBRaoRUzWrg ($34 in chips)
Seat 8: pN/Ip0ePsUVIdUlGgLrkUw ($215.35 in chips)
Seat 9: Kzta8yu9vxHT4B70mjBZ+w ($208.25 in chips)
/inIs/z/PcX+TniIFpaxpg: posts small blind $1
9cBHwK40Tl06vheE7B3LHQ: posts big blind $2
*** HOLE CARDS ***
GX1heJ+DSsvm7gzSPsYhhQ: folds
31HuO+DQxppUQEedBWukug: folds
WUlHm+ydPPHG7Lb0rePSdA: folds
EBV6OktyeSmh4w6sWmcWOw: folds
rW/MyplHylMSBRaoRUzWrg: folds
pN/Ip0ePsUVIdUlGgLrkUw: folds
Kzta8yu9vxHT4B70mjBZ+w: raises $4 to $6
/inIs/z/PcX+TniIFpaxpg: folds
9cBHwK40Tl06vheE7B3LHQ: folds
Kzta8yu9vxHT4B70mjBZ+w collected $5 from pot
Kzta8yu9vxHT4B70mjBZ+w: doesn't show hand
*** SUMMARY ***
Total pot $5 | Rake $0
Seat 1: /inIs/z/PcX+TniIFpaxpg (small blind) folded before Flop
Seat 2: 9cBHwK40Tl06vheE7B3LHQ (big blind) folded before Flop
Seat 3: GX1heJ+DSsvm7gzSPsYhhQ folded before Flop (didn't bet)
Seat 4: 31HuO+DQxppUQEedBWukug folded before Flop (didn't bet)
Seat 5: WUlHm+ydPPHG7Lb0rePSdA folded before Flop (didn't bet)
Seat 6: EBV6OktyeSmh4w6sWmcWOw folded before Flop (didn't bet)
Seat 7: rW/MyplHylMSBRaoRUzWrg folded before Flop (didn't bet)
Seat 8: pN/Ip0ePsUVIdUlGgLrkUw folded before Flop (didn't bet)
Seat 9: Kzta8yu9vxHT4B70mjBZ+w (button) collected ($5)



PokerStars Game #59941105114:  Hold'em No Limit ($1/$2) - 2009/07/01 1:25:47 ET
Table 'NmY84NAf9Mh0ckAckHnh5g' 2-max Seat #1 is the button
Seat 1: 6hvg964TSqZ3AL/0XK9aVQ ($238.10 in chips)
Seat 2: RwDoM55ZeQuI2ADyJhOb2Q ($765.40 in chips)
6hvg964TSqZ3AL/0XK9aVQ: posts small blind $1
RwDoM55ZeQuI2ADyJhOb2Q: posts big blind $2
*** HOLE CARDS ***
6hvg964TSqZ3AL/0XK9aVQ: calls $1
RwDoM55ZeQuI2ADyJhOb2Q: checks
*** FLOP *** [9s Jc 7s]
RwDoM55ZeQuI2ADyJhOb2Q: checks
6hvg964TSqZ3AL/0XK9aVQ: bets $6
RwDoM55ZeQuI2ADyJhOb2Q: calls $6
*** TURN *** [9s Jc 7s] [Ad]
RwDoM55ZeQuI2ADyJhOb2Q: checks
6hvg964TSqZ3AL/0XK9aVQ: bets $38
RwDoM55ZeQuI2ADyJhOb2Q: folds
6hvg964TSqZ3AL/0XK9aVQ collected $15.50 from pot
6hvg964TSqZ3AL/0XK9aVQ: doesn't show hand
*** SUMMARY ***
Total pot $16 | Rake $0.50
Board [9s Jc 7s Ad]
Seat 1: 6hvg964TSqZ3AL/0XK9aVQ (button) (small blind) collected ($15.50)
Seat 2: RwDoM55ZeQuI2ADyJhOb2Q (big blind) folded on the Turn



PokerStars Game #59941105674:  Hold'em No Limit ($1/$2) - 2009/07/01 1:25:48 ET
Table 'bIihwBANJSFqlHPPtset+w' 9-max Seat #4 is the button
Seat 1: /inIs/z/PcX+TniIFpaxpg ($30 in chips)
Seat 2: lQYT23h5QCUVZAKxjOO39Q ($180.75 in chips)
Seat 3: +T/63sAeZzWyHchahJ36GQ ($43 in chips)
Seat 4: ri8CLkX3e9JF34dQNbsHGA ($40 in chips)
Seat 5: vxbbJLsS1bva6tW2NiFssg ($200 in chips)
Seat 6: CkE3IyJF1KvdaAOmZY5XqQ ($186 in chips)
Seat 7: pCmk6FpSOLJ+85o1tLHIag ($145.95 in chips)
Seat 8: iMe5yhc+1BaiIPHet3NMrA ($200.50 in chips)
Seat 9: qn8LDoUFphcG4+r+F+Vhrg ($171 in chips)
vxbbJLsS1bva6tW2NiFssg: posts small blind $1
CkE3IyJF1KvdaAOmZY5XqQ: posts big blind $2
*** HOLE CARDS ***
pCmk6FpSOLJ+85o1tLHIag: folds
iMe5yhc+1BaiIPHet3NMrA: folds
qn8LDoUFphcG4+r+F+Vhrg: folds
/inIs/z/PcX+TniIFpaxpg: folds
lQYT23h5QCUVZAKxjOO39Q: calls $2
+T/63sAeZzWyHchahJ36GQ: folds
ri8CLkX3e9JF34dQNbsHGA: folds
vxbbJLsS1bva6tW2NiFssg: folds
CkE3IyJF1KvdaAOmZY5XqQ: checks
*** FLOP *** [2c 3s 8s]
CkE3IyJF1KvdaAOmZY5XqQ: checks
lQYT23h5QCUVZAKxjOO39Q: bets $2
CkE3IyJF1KvdaAOmZY5XqQ: folds
lQYT23h5QCUVZAKxjOO39Q collected $4.75 from pot
*** SUMMARY ***
Total pot $5 | Rake $0.25
Board [2c 3s 8s]
Seat 1: /inIs/z/PcX+TniIFpaxpg folded before Flop (didn't bet)
Seat 2: lQYT23h5QCUVZAKxjOO39Q collected ($4.75)
Seat 3: +T/63sAeZzWyHchahJ36GQ folded before Flop (didn't bet)
Seat 4: ri8CLkX3e9JF34dQNbsHGA (button) folded before Flop (didn't bet)
Seat 5: vxbbJLsS1bva6tW2NiFssg (small blind) folded before Flop
Seat 6: CkE3IyJF1KvdaAOmZY5XqQ (big blind) folded on the Flop
Seat 7: pCmk6FpSOLJ+85o1tLHIag folded before Flop (didn't bet)
Seat 8: iMe5yhc+1BaiIPHet3NMrA folded before Flop (didn't bet)
Seat 9: qn8LDoUFphcG4+r+F+Vhrg folded before Flop (didn't bet)



PokerStars Game #59941107450:  Hold'em No Limit ($1/$2) - 2009/07/01 1:25:51 ET
Table 'LL4bDFyhj5hsMpzaDugJZg' 6-max Seat #1 is the button
Seat 1: FwvID/fQGlpY3soi/lMTww ($84.50 in chips)
Seat 3: iI/NMpRxMkGieArQEhACSA ($281.75 in chips)
Seat 4: 8srN1dKQePlsv0GyTada+Q ($257.75 in chips)
Seat 5: A2GTwTiwkb1ilNWgW487Vg ($122.80 in chips)
Seat 6: 692Q4sfB0gTElzS0WMeg+A ($215.10 in chips)
iI/NMpRxMkGieArQEhACSA: posts small blind $1
8srN1dKQePlsv0GyTada+Q: posts big blind $2
*** HOLE CARDS ***
A2GTwTiwkb1ilNWgW487Vg: folds
692Q4sfB0gTElzS0WMeg+A: folds
FwvID/fQGlpY3soi/lMTww: folds
iI/NMpRxMkGieArQEhACSA: raises $4 to $6
8srN1dKQePlsv0GyTada+Q: raises $13 to $19
iI/NMpRxMkGieArQEhACSA: calls $13
*** FLOP *** [3h Jd 6s]
iI/NMpRxMkGieArQEhACSA: checks
8srN1dKQePlsv0GyTada+Q: bets $12
iI/NMpRxMkGieArQEhACSA: raises $12 to $24
8srN1dKQePlsv0GyTada+Q: calls $12
*** TURN *** [3h Jd 6s] [6c]
iI/NMpRxMkGieArQEhACSA: checks
8srN1dKQePlsv0GyTada+Q: bets $45
iI/NMpRxMkGieArQEhACSA: calls $45
*** RIVER *** [3h Jd 6s 6c] [9c]
iI/NMpRxMkGieArQEhACSA: checks
8srN1dKQePlsv0GyTada+Q: bets $169.75 and is all-in
iI/NMpRxMkGieArQEhACSA: calls $169.75
*** SHOW DOWN ***
8srN1dKQePlsv0GyTada+Q: shows [Ks 2c] (a pair of Sixes)
iI/NMpRxMkGieArQEhACSA: shows [Jc Kh] (two pair, Jacks and Sixes)
iI/NMpRxMkGieArQEhACSA collected $513.50 from pot
*** SUMMARY ***
Total pot $515.50 | Rake $2
Board [3h Jd 6s 6c 9c]
Seat 1: FwvID/fQGlpY3soi/lMTww (button) folded before Flop (didn't bet)
Seat 3: iI/NMpRxMkGieArQEhACSA (small blind) showed [Jc Kh] and won ($513.50) with two pair, Jacks and Sixes
Seat 4: 8srN1dKQePlsv0GyTada+Q (big blind) showed [Ks 2c] and lost with a pair of Sixes
Seat 5: A2GTwTiwkb1ilNWgW487Vg folded before Flop (didn't bet)
Seat 6: 692Q4sfB0gTElzS0WMeg+A folded before Flop (didn't bet)



PokerStars Game #59941107740:  Hold'em No Limit ($1/$2) - 2009/07/01 1:25:52 ET
Table 'gnHBqWll9O3fxG7Ojkz/ng' 9-max Seat #9 is the button
Seat 1: TAfo4veNRaRlzDXMMYS3Jg ($35 in chips)
Seat 2: H6Z4+qu8gR0VUiPOijndVg ($327.25 in chips)
Seat 3: 5Q8U6iZbeO7xJSS4qvDP5g ($215 in chips)
Seat 5: rBQDMkKm9cZn6M9NPsiVew ($236.45 in chips)
Seat 6: /inIs/z/PcX+TniIFpaxpg ($46.75 in chips)
Seat 7: jqui3xAWCkcdPW36a6BD+w ($344.95 in chips)
Seat 8: cM6efHzdxoqYm0EQKP4TTQ ($98.05 in chips)
Seat 9: GX1heJ+DSsvm7gzSPsYhhQ ($54.35 in chips)
TAfo4veNRaRlzDXMMYS3Jg: posts small blind $1
H6Z4+qu8gR0VUiPOijndVg: posts big blind $2
nXDI8Y/S6POzRwANu3d8hQ: sits out
*** HOLE CARDS ***
5Q8U6iZbeO7xJSS4qvDP5g: folds
rBQDMkKm9cZn6M9NPsiVew: calls $2
/inIs/z/PcX+TniIFpaxpg: raises $8 to $10
jqui3xAWCkcdPW36a6BD+w: folds
cM6efHzdxoqYm0EQKP4TTQ: calls $10
GX1heJ+DSsvm7gzSPsYhhQ: folds
TAfo4veNRaRlzDXMMYS3Jg: folds
H6Z4+qu8gR0VUiPOijndVg: folds
rBQDMkKm9cZn6M9NPsiVew: calls $8
*** FLOP *** [7d 9d Th]
rBQDMkKm9cZn6M9NPsiVew: checks
/inIs/z/PcX+TniIFpaxpg: checks
cM6efHzdxoqYm0EQKP4TTQ: checks
*** TURN *** [7d 9d Th] [6d]
rBQDMkKm9cZn6M9NPsiVew: checks
/inIs/z/PcX+TniIFpaxpg: checks
cM6efHzdxoqYm0EQKP4TTQ: checks
*** RIVER *** [7d 9d Th 6d] [9s]
rBQDMkKm9cZn6M9NPsiVew: checks
/inIs/z/PcX+TniIFpaxpg: checks
cM6efHzdxoqYm0EQKP4TTQ: checks
*** SHOW DOWN ***
rBQDMkKm9cZn6M9NPsiVew: shows [As Js] (a pair of Nines)
/inIs/z/PcX+TniIFpaxpg: shows [Ad Kc] (a pair of Nines - Ace+King kicker)
cM6efHzdxoqYm0EQKP4TTQ: mucks hand
/inIs/z/PcX+TniIFpaxpg collected $31.35 from pot
*** SUMMARY ***
Total pot $33 | Rake $1.65
Board [7d 9d Th 6d 9s]
Seat 1: TAfo4veNRaRlzDXMMYS3Jg (small blind) folded before Flop
Seat 2: H6Z4+qu8gR0VUiPOijndVg (big blind) folded before Flop
Seat 3: 5Q8U6iZbeO7xJSS4qvDP5g folded before Flop (didn't bet)
Seat 5: rBQDMkKm9cZn6M9NPsiVew showed [As Js] and lost with a pair of Nines
Seat 6: /inIs/z/PcX+TniIFpaxpg showed [Ad Kc] and won ($31.35) with a pair of Nines
Seat 7: jqui3xAWCkcdPW36a6BD+w folded before Flop (didn't bet)
Seat 8: cM6efHzdxoqYm0EQKP4TTQ mucked
Seat 9: GX1heJ+DSsvm7gzSPsYhhQ (button) folded before Flop (didn't bet)



PokerStars Game #59941107658:  Hold'em No Limit ($1/$2) - 2009/07/01 1:25:52 ET
Table 'pPQgcj9XT9CHBsbo1WTBug' 6-max Seat #2 is the button
Seat 1: DFVYDA6dKQy7R7mGIKogZA ($125.65 in chips)
Seat 2: qXDd0ZyMIse0OBu8pxeQ3Q ($208.30 in chips)
Seat 3: 54yWzRRgS0oZ+S6LwZBxMQ ($62.75 in chips)
Seat 4: gqlysXCbT8V54f/1lf9h3A ($36.30 in chips)
Seat 5: vkfxu8f/jMYKUk6Ly4eujw ($210.55 in chips)
Seat 6: Yr7pZltpy3IUNdKS9PCEiw ($304.30 in chips)
54yWzRRgS0oZ+S6LwZBxMQ: posts small blind $1
gqlysXCbT8V54f/1lf9h3A: posts big blind $2
*** HOLE CARDS ***
vkfxu8f/jMYKUk6Ly4eujw: raises $6 to $8
Yr7pZltpy3IUNdKS9PCEiw: folds
DFVYDA6dKQy7R7mGIKogZA: calls $8
qXDd0ZyMIse0OBu8pxeQ3Q: folds
54yWzRRgS0oZ+S6LwZBxMQ: folds
gqlysXCbT8V54f/1lf9h3A: folds
*** FLOP *** [4h Ah Th]
vkfxu8f/jMYKUk6Ly4eujw: checks
DFVYDA6dKQy7R7mGIKogZA: bets $12
vkfxu8f/jMYKUk6Ly4eujw: folds
DFVYDA6dKQy7R7mGIKogZA collected $18.05 from pot
*** SUMMARY ***
Total pot $19 | Rake $0.95
Board [4h Ah Th]
Seat 1: DFVYDA6dKQy7R7mGIKogZA collected ($18.05)
Seat 2: qXDd0ZyMIse0OBu8pxeQ3Q (button) folded before Flop (didn't bet)
Seat 3: 54yWzRRgS0oZ+S6LwZBxMQ (small blind) folded before Flop
Seat 4: gqlysXCbT8V54f/1lf9h3A (big blind) folded before Flop
Seat 5: vkfxu8f/jMYKUk6Ly4eujw folded on the Flop
Seat 6: Yr7pZltpy3IUNdKS9PCEiw folded before Flop (didn't bet)



PokerStars Game #59941108166:  Hold'em No Limit ($1/$2) - 2009/07/01 1:25:53 ET
Table 'CFkQcfWjKccZaZDf71FK+w' 6-max Seat #6 is the button
Seat 1: JsC+WvfzqlxVs9G8/gSQAQ ($26.05 in chips)
Seat 2: ewN/vzF22+/gdzjIKBOlkA ($200 in chips)
Seat 3: 09BNF4quPDzanQzM8vc6WA ($48.45 in chips)
Seat 4: ygTTt5ehT4aF86q1a8/R+w ($192.75 in chips)
Seat 5: 2lOU1DcvUZaMcxZ95XfzXw ($145 in chips)
Seat 6: ORVqY3rf9X6ANA/8s+On2Q ($75.50 in chips)
JsC+WvfzqlxVs9G8/gSQAQ: posts small blind $1
ewN/vzF22+/gdzjIKBOlkA: posts big blind $2
*** HOLE CARDS ***
09BNF4quPDzanQzM8vc6WA: folds
ygTTt5ehT4aF86q1a8/R+w: folds
2lOU1DcvUZaMcxZ95XfzXw: calls $2
ORVqY3rf9X6ANA/8s+On2Q: folds
JsC+WvfzqlxVs9G8/gSQAQ: calls $1
ewN/vzF22+/gdzjIKBOlkA: raises $8 to $10
2lOU1DcvUZaMcxZ95XfzXw: calls $8
JsC+WvfzqlxVs9G8/gSQAQ: folds
*** FLOP *** [Tc 3s Ks]
ewN/vzF22+/gdzjIKBOlkA: bets $12
2lOU1DcvUZaMcxZ95XfzXw: calls $12
*** TURN *** [Tc 3s Ks] [4c]
ewN/vzF22+/gdzjIKBOlkA: bets $24
2lOU1DcvUZaMcxZ95XfzXw: folds
ewN/vzF22+/gdzjIKBOlkA collected $43.80 from pot
*** SUMMARY ***
Total pot $46 | Rake $2.20
Board [Tc 3s Ks 4c]
Seat 1: JsC+WvfzqlxVs9G8/gSQAQ (small blind) folded before Flop
Seat 2: ewN/vzF22+/gdzjIKBOlkA (big blind) collected ($43.80)
Seat 3: 09BNF4quPDzanQzM8vc6WA folded before Flop (didn't bet)
Seat 4: ygTTt5ehT4aF86q1a8/R+w folded before Flop (didn't bet)
Seat 5: 2lOU1DcvUZaMcxZ95XfzXw folded on the Turn
Seat 6: ORVqY3rf9X6ANA/8s+On2Q (button) folded before Flop (didn't bet)



PokerStars Game #59941108652:  Hold'em No Limit ($1/$2) - 2009/07/01 1:25:53 ET
Table 'mGpP9StWRnoeiBDExc6Frg' 6-max Seat #2 is the button
Seat 1: VvdR9F3I+2yELkfTVvC1dg ($207 in chips)
Seat 2: dZcLsEI8iXkobBduRJ45Yw ($73.15 in chips)
Seat 3: 7acrZUQC3Zc9BNLjoKIcLQ ($35.35 in chips)
Seat 4: 4dcDwIHRm96PwtqkpQiuiA ($87.70 in chips)
Seat 5: d1puGuVBE0fidn+5eRJ0tw ($179.95 in chips)
Seat 6: B2Ih1sr5VZk+8He7rcrMtQ ($464.05 in chips)
7acrZUQC3Zc9BNLjoKIcLQ: posts small blind $1
4dcDwIHRm96PwtqkpQiuiA: posts big blind $2
*** HOLE CARDS ***
d1puGuVBE0fidn+5eRJ0tw: folds
B2Ih1sr5VZk+8He7rcrMtQ: folds
VvdR9F3I+2yELkfTVvC1dg: raises $2 to $4
dZcLsEI8iXkobBduRJ45Yw: calls $4
7acrZUQC3Zc9BNLjoKIcLQ: folds
4dcDwIHRm96PwtqkpQiuiA: calls $2
*** FLOP *** [2d 3s 4s]
4dcDwIHRm96PwtqkpQiuiA: checks
VvdR9F3I+2yELkfTVvC1dg: bets $9.25
dZcLsEI8iXkobBduRJ45Yw: raises $9.25 to $18.50
4dcDwIHRm96PwtqkpQiuiA: folds
VvdR9F3I+2yELkfTVvC1dg: raises $21.85 to $40.35
dZcLsEI8iXkobBduRJ45Yw: calls $21.85
*** TURN *** [2d 3s 4s] [8d]
VvdR9F3I+2yELkfTVvC1dg: bets $66.20
dZcLsEI8iXkobBduRJ45Yw: calls $28.80 and is all-in
*** RIVER *** [2d 3s 4s 8d] [4d]
*** SHOW DOWN ***
VvdR9F3I+2yELkfTVvC1dg: shows [Qd Qh] (two pair, Queens and Fours)
dZcLsEI8iXkobBduRJ45Yw: mucks hand
VvdR9F3I+2yELkfTVvC1dg collected $148.30 from pot
*** SUMMARY ***
Total pot $151.30 | Rake $3
Board [2d 3s 4s 8d 4d]
Seat 1: VvdR9F3I+2yELkfTVvC1dg showed [Qd Qh] and won ($148.30) with two pair, Queens and Fours
Seat 2: dZcLsEI8iXkobBduRJ45Yw (button) mucked
Seat 3: 7acrZUQC3Zc9BNLjoKIcLQ (small blind) folded before Flop
Seat 4: 4dcDwIHRm96PwtqkpQiuiA (big blind) folded on the Flop
Seat 5: d1puGuVBE0fidn+5eRJ0tw folded before Flop (didn't bet)
Seat 6: B2Ih1sr5VZk+8He7rcrMtQ folded before Flop (didn't bet)



PokerStars Game #59941109352:  Hold'em No Limit ($1/$2) - 2009/07/01 1:25:55 ET
Table 'TsEDkiO4tzCTCzJ7tNdEqw' 6-max Seat #2 is the button
Seat 1: MfXQsYD8pGeCS7XOtyV+vw ($98.25 in chips)
Seat 2: 4dcDwIHRm96PwtqkpQiuiA ($81.10 in chips)
Seat 4: K8MXCrNAVYlMnnCeM32Kxw ($107.45 in chips)
Seat 5: VvdR9F3I+2yELkfTVvC1dg ($200 in chips)
Seat 6: uCqEjnxh2/vFBjKYkfTOkw ($210.35 in chips)
ubtx4Z5L+AcK71MTvYiGVw will be allowed to play after the button
K8MXCrNAVYlMnnCeM32Kxw: posts small blind $1
VvdR9F3I+2yELkfTVvC1dg: posts big blind $2
*** HOLE CARDS ***
uCqEjnxh2/vFBjKYkfTOkw: folds
MfXQsYD8pGeCS7XOtyV+vw: raises $8 to $10
4dcDwIHRm96PwtqkpQiuiA: folds
K8MXCrNAVYlMnnCeM32Kxw: folds
VvdR9F3I+2yELkfTVvC1dg: folds
MfXQsYD8pGeCS7XOtyV+vw collected $5 from pot
MfXQsYD8pGeCS7XOtyV+vw: doesn't show hand
*** SUMMARY ***
Total pot $5 | Rake $0
Seat 1: MfXQsYD8pGeCS7XOtyV+vw collected ($5)
Seat 2: 4dcDwIHRm96PwtqkpQiuiA (button) folded before Flop (didn't bet)
Seat 4: K8MXCrNAVYlMnnCeM32Kxw (small blind) folded before Flop
Seat 5: VvdR9F3I+2yELkfTVvC1dg (big blind) folded before Flop
Seat 6: uCqEjnxh2/vFBjKYkfTOkw folded before Flop (didn't bet)



PokerStars Game #59941110046:  Hold'em No Limit ($1/$2) - 2009/07/01 1:25:56 ET
Table 'bJQ024BaYSBrW0sXpCZbNQ' 6-max Seat #3 is the button
Seat 2: 3dAbvkxS5NPQTBAbvpinVg ($220.05 in chips)
Seat 3: vkfxu8f/jMYKUk6Ly4eujw ($230.05 in chips)
Seat 4: TBaQIN+sQ7eb7P99QnaORQ ($34 in chips)
Seat 5: VvdR9F3I+2yELkfTVvC1dg ($202 in chips)
Seat 6: 9dpyyjDTCed6nV7JhaUUpw ($340.30 in chips)
TBaQIN+sQ7eb7P99QnaORQ: posts small blind $1
VvdR9F3I+2yELkfTVvC1dg: posts big blind $2
*** HOLE CARDS ***
9dpyyjDTCed6nV7JhaUUpw: folds
3dAbvkxS5NPQTBAbvpinVg: folds
vkfxu8f/jMYKUk6Ly4eujw: folds
TBaQIN+sQ7eb7P99QnaORQ: raises $2 to $4
VvdR9F3I+2yELkfTVvC1dg: folds
TBaQIN+sQ7eb7P99QnaORQ collected $4 from pot
*** SUMMARY ***
Total pot $4 | Rake $0
Seat 2: 3dAbvkxS5NPQTBAbvpinVg folded before Flop (didn't bet)
Seat 3: vkfxu8f/jMYKUk6Ly4eujw (button) folded before Flop (didn't bet)
Seat 4: TBaQIN+sQ7eb7P99QnaORQ (small blind) collected ($4)
Seat 5: VvdR9F3I+2yELkfTVvC1dg (big blind) folded before Flop
Seat 6: 9dpyyjDTCed6nV7JhaUUpw folded before Flop (didn't bet)



PokerStars Game #59941110520:  Hold'em No Limit ($1/$2) - 2009/07/01 1:25:57 ET
Table 'eyAQSIlgc2o1Jxvbve4WGg' 9-max Seat #3 is the button
Seat 1: UZEsV9yKUMqmpYPiOFpaZw ($105.20 in chips)
Seat 2: g7gL2NLJCdZPPV399WKT1w ($76.25 in chips)
Seat 3: ice1Sbe19zWIaKYoSmE5tw ($95.30 in chips)
Seat 4: CkE3IyJF1KvdaAOmZY5XqQ ($200 in chips)
Seat 5: mIKx5lhIt13X5eZQH0ZeMA ($80.80 in chips)
Seat 8: 1CtiZuXDFaJL1dJPQKyi8Q ($158.35 in chips)
Seat 9: WUlHm+ydPPHG7Lb0rePSdA ($120.70 in chips)
CkE3IyJF1KvdaAOmZY5XqQ: posts small blind $1
mIKx5lhIt13X5eZQH0ZeMA: posts big blind $2
nXDI8Y/S6POzRwANu3d8hQ: sits out
*** HOLE CARDS ***
1CtiZuXDFaJL1dJPQKyi8Q: folds
WUlHm+ydPPHG7Lb0rePSdA: folds
UZEsV9yKUMqmpYPiOFpaZw: folds
g7gL2NLJCdZPPV399WKT1w: folds
ice1Sbe19zWIaKYoSmE5tw: raises $4 to $6
CkE3IyJF1KvdaAOmZY5XqQ: folds
mIKx5lhIt13X5eZQH0ZeMA: folds
ice1Sbe19zWIaKYoSmE5tw collected $5 from pot
*** SUMMARY ***
Total pot $5 | Rake $0
Seat 1: UZEsV9yKUMqmpYPiOFpaZw folded before Flop (didn't bet)
Seat 2: g7gL2NLJCdZPPV399WKT1w folded before Flop (didn't bet)
Seat 3: ice1Sbe19zWIaKYoSmE5tw (button) collected ($5)
Seat 4: CkE3IyJF1KvdaAOmZY5XqQ (small blind) folded before Flop
Seat 5: mIKx5lhIt13X5eZQH0ZeMA (big blind) folded before Flop
Seat 8: 1CtiZuXDFaJL1dJPQKyi8Q folded before Flop (didn't bet)
Seat 9: WUlHm+ydPPHG7Lb0rePSdA folded before Flop (didn't bet)



PokerStars Game #59941112022:  Hold'em No Limit ($1/$2) - 2009/07/01 1:25:59 ET
Table 'gftD4mDF7mIFKvSrIyaRbw' 9-max Seat #2 is the button
Seat 1: 31HuO+DQxppUQEedBWukug ($98 in chips)
Seat 2: GX1heJ+DSsvm7gzSPsYhhQ ($40 in chips)
Seat 3: CUZwDpLTQKhzarPe+JCLOQ ($200 in chips)
Seat 4: /inIs/z/PcX+TniIFpaxpg ($43 in chips)
Seat 5: mpsfNtnMVDqQHTe92AhIdw ($120.10 in chips)
Seat 6: 2NvwF8W2nzsbS+G//yLAbQ ($178.05 in chips)
Seat 8: MpL4DeEqGQu0H8TJEbEOrg ($44 in chips)
Seat 9: F7m34OOfAQ7annesMHVjKw ($164.75 in chips)
CUZwDpLTQKhzarPe+JCLOQ: posts small blind $1
/inIs/z/PcX+TniIFpaxpg: posts big blind $2
+T/63sAeZzWyHchahJ36GQ: sits out
*** HOLE CARDS ***
mpsfNtnMVDqQHTe92AhIdw: folds
2NvwF8W2nzsbS+G//yLAbQ: folds
MpL4DeEqGQu0H8TJEbEOrg: folds
F7m34OOfAQ7annesMHVjKw: raises $4 to $6
31HuO+DQxppUQEedBWukug: folds
GX1heJ+DSsvm7gzSPsYhhQ: folds
CUZwDpLTQKhzarPe+JCLOQ: folds
/inIs/z/PcX+TniIFpaxpg: folds
F7m34OOfAQ7annesMHVjKw collected $5 from pot
*** SUMMARY ***
Total pot $5 | Rake $0
Seat 1: 31HuO+DQxppUQEedBWukug folded before Flop (didn't bet)
Seat 2: GX1heJ+DSsvm7gzSPsYhhQ (button) folded before Flop (didn't bet)
Seat 3: CUZwDpLTQKhzarPe+JCLOQ (small blind) folded before Flop
Seat 4: /inIs/z/PcX+TniIFpaxpg (big blind) folded before Flop
Seat 5: mpsfNtnMVDqQHTe92AhIdw folded before Flop (didn't bet)
Seat 6: 2NvwF8W2nzsbS+G//yLAbQ folded before Flop (didn't bet)
Seat 8: MpL4DeEqGQu0H8TJEbEOrg folded before Flop (didn't bet)
Seat 9: F7m34OOfAQ7annesMHVjKw collected ($5)



PokerStars Game #59941112266:  Hold'em No Limit ($1/$2) - 2009/07/01 1:26:00 ET
Table '+hSnXFQrGw1PlVgTnuj+sA' 6-max Seat #6 is the button
Seat 1: 2ccIJhDj+3JapvS7swVZEg ($335 in chips)
Seat 3: fE+LHW/7rpfXW14g8LhGjA ($57.30 in chips)
Seat 4: J4iH5epwXbmODnojR/VRxA ($157.60 in chips)
Seat 5: VvdR9F3I+2yELkfTVvC1dg ($200 in chips)
Seat 6: AuiGltq875lmaKHBsjZVGg ($67.75 in chips)
2ccIJhDj+3JapvS7swVZEg: posts small blind $1
fE+LHW/7rpfXW14g8LhGjA: posts big blind $2
*** HOLE CARDS ***
J4iH5epwXbmODnojR/VRxA: folds
VvdR9F3I+2yELkfTVvC1dg: raises $2 to $4
AuiGltq875lmaKHBsjZVGg: folds
2ccIJhDj+3JapvS7swVZEg: folds
fE+LHW/7rpfXW14g8LhGjA: calls $2
*** FLOP *** [8s 4h 8c]
fE+LHW/7rpfXW14g8LhGjA: checks
54yWzRRgS0oZ+S6LwZBxMQ joins the table at seat #2
VvdR9F3I+2yELkfTVvC1dg: bets $6.40
fE+LHW/7rpfXW14g8LhGjA: folds
VvdR9F3I+2yELkfTVvC1dg collected $8.55 from pot
VvdR9F3I+2yELkfTVvC1dg: doesn't show hand
*** SUMMARY ***
Total pot $9 | Rake $0.45
Board [8s 4h 8c]
Seat 1: 2ccIJhDj+3JapvS7swVZEg (small blind) folded before Flop
Seat 3: fE+LHW/7rpfXW14g8LhGjA (big blind) folded on the Flop
Seat 4: J4iH5epwXbmODnojR/VRxA folded before Flop (didn't bet)
Seat 5: VvdR9F3I+2yELkfTVvC1dg collected ($8.55)
Seat 6: AuiGltq875lmaKHBsjZVGg (button) folded before Flop (didn't bet)



PokerStars Game #59941113052:  Hold'em No Limit ($1/$2) - 2009/07/01 1:26:01 ET
Table 'YqGfR5eHfMeSjb9a+QU9rg' 9-max Seat #6 is the button
Seat 1: rW/MyplHylMSBRaoRUzWrg ($34 in chips)
Seat 2: W3Nqt1GWlTi9tXQXMNEvgw ($386.25 in chips)
Seat 3: /gll27k+xWYV7Fbki0lFDQ ($261.75 in chips)
Seat 5: CkE3IyJF1KvdaAOmZY5XqQ ($200 in chips)
Seat 6: TAfo4veNRaRlzDXMMYS3Jg ($37 in chips)
Seat 7: 41aZuLBz9nAi2GPVKabmCw ($108.45 in chips)
Seat 8: JnV3SM2D6dAFYyGZHHpvrg ($101.25 in chips)
Seat 9: /inIs/z/PcX+TniIFpaxpg ($200.05 in chips)
41aZuLBz9nAi2GPVKabmCw: posts small blind $1
JnV3SM2D6dAFYyGZHHpvrg: posts big blind $2
*** HOLE CARDS ***
/inIs/z/PcX+TniIFpaxpg: raises $6 to $8
rW/MyplHylMSBRaoRUzWrg: folds
W3Nqt1GWlTi9tXQXMNEvgw: folds
/gll27k+xWYV7Fbki0lFDQ: folds
CkE3IyJF1KvdaAOmZY5XqQ: folds
TAfo4veNRaRlzDXMMYS3Jg: folds
41aZuLBz9nAi2GPVKabmCw: folds
JnV3SM2D6dAFYyGZHHpvrg: calls $6
*** FLOP *** [2d 7d Kc]
JnV3SM2D6dAFYyGZHHpvrg: checks
/inIs/z/PcX+TniIFpaxpg: bets $8
JnV3SM2D6dAFYyGZHHpvrg: folds
/inIs/z/PcX+TniIFpaxpg collected $16.15 from pot
/inIs/z/PcX+TniIFpaxpg: doesn't show hand
*** SUMMARY ***
Total pot $17 | Rake $0.85
Board [2d 7d Kc]
Seat 1: rW/MyplHylMSBRaoRUzWrg folded before Flop (didn't bet)
Seat 2: W3Nqt1GWlTi9tXQXMNEvgw folded before Flop (didn't bet)
Seat 3: /gll27k+xWYV7Fbki0lFDQ folded before Flop (didn't bet)
Seat 5: CkE3IyJF1KvdaAOmZY5XqQ folded before Flop (didn't bet)
Seat 6: TAfo4veNRaRlzDXMMYS3Jg (button) folded before Flop (didn't bet)
Seat 7: 41aZuLBz9nAi2GPVKabmCw (small blind) folded before Flop
Seat 8: JnV3SM2D6dAFYyGZHHpvrg (big blind) folded on the Flop
Seat 9: /inIs/z/PcX+TniIFpaxpg collected ($16.15)



PokerStars Game #59941114494:  Hold'em No Limit ($1/$2) - 2009/07/01 1:26:03 ET
Table '8Y6PEyoNuepZTai2Q56aHw' 9-max Seat #3 is the button
Seat 1: 5Q8U6iZbeO7xJSS4qvDP5g ($298.10 in chips)
Seat 2: gDCJIAlovbPnTvMM7Dd1gA ($167.35 in chips)
Seat 3: WUlHm+ydPPHG7Lb0rePSdA ($217.10 in chips)
Seat 4: xKkwALG38OfLQ9DXuJgR1w ($262.55 in chips)
Seat 6: NtLDBSjsJQEKekh5cdinvw ($361.20 in chips)
Seat 7: Kzta8yu9vxHT4B70mjBZ+w ($210.30 in chips)
Seat 8: rW/MyplHylMSBRaoRUzWrg ($37 in chips)
xKkwALG38OfLQ9DXuJgR1w: posts small blind $1
NtLDBSjsJQEKekh5cdinvw: posts big blind $2
*** HOLE CARDS ***
Kzta8yu9vxHT4B70mjBZ+w: folds
F7m34OOfAQ7annesMHVjKw has returned
rW/MyplHylMSBRaoRUzWrg: raises $6 to $8
5Q8U6iZbeO7xJSS4qvDP5g: folds
gDCJIAlovbPnTvMM7Dd1gA: folds
WUlHm+ydPPHG7Lb0rePSdA: folds
xKkwALG38OfLQ9DXuJgR1w: folds
NtLDBSjsJQEKekh5cdinvw: folds
rW/MyplHylMSBRaoRUzWrg collected $5 from pot
*** SUMMARY ***
Total pot $5 | Rake $0
Seat 1: 5Q8U6iZbeO7xJSS4qvDP5g folded before Flop (didn't bet)
Seat 2: gDCJIAlovbPnTvMM7Dd1gA folded before Flop (didn't bet)
Seat 3: WUlHm+ydPPHG7Lb0rePSdA (button) folded before Flop (didn't bet)
Seat 4: xKkwALG38OfLQ9DXuJgR1w (small blind) folded before Flop
Seat 6: NtLDBSjsJQEKekh5cdinvw (big blind) folded before Flop
Seat 7: Kzta8yu9vxHT4B70mjBZ+w folded before Flop (didn't bet)
Seat 8: rW/MyplHylMSBRaoRUzWrg collected ($5)



PokerStars Game #59941115696:  Hold'em No Limit ($1/$2) - 2009/07/01 1:26:05 ET
Table 'qVXak+oTeDXMGbWa4sDU5Q' 9-max Seat #4 is the button
Seat 1: H6Z4+qu8gR0VUiPOijndVg ($212.55 in chips)
Seat 2: rW/MyplHylMSBRaoRUzWrg ($74 in chips)
Seat 3: WUlHm+ydPPHG7Lb0rePSdA ($150.65 in chips)
Seat 4: lQYT23h5QCUVZAKxjOO39Q ($111.45 in chips)
Seat 5: FWGiDqRwvLeKmHq9t4Jy9w ($266.80 in chips)
Seat 6: GX1heJ+DSsvm7gzSPsYhhQ ($34 in chips)
Seat 7: PfmlvZlFiss79a6IoEr11g ($166.30 in chips)
Seat 8: Z0rzUi0y1x80UdIpofoNbA ($126.55 in chips)
Seat 9: CkE3IyJF1KvdaAOmZY5XqQ ($200 in chips)
FWGiDqRwvLeKmHq9t4Jy9w: posts small blind $1
GX1heJ+DSsvm7gzSPsYhhQ: posts big blind $2
*** HOLE CARDS ***
PfmlvZlFiss79a6IoEr11g: folds
Z0rzUi0y1x80UdIpofoNbA: folds
CkE3IyJF1KvdaAOmZY5XqQ: folds
H6Z4+qu8gR0VUiPOijndVg: folds
rW/MyplHylMSBRaoRUzWrg: folds
WUlHm+ydPPHG7Lb0rePSdA: folds
lQYT23h5QCUVZAKxjOO39Q: folds
FWGiDqRwvLeKmHq9t4Jy9w: folds
GX1heJ+DSsvm7gzSPsYhhQ collected $2 from pot
GX1heJ+DSsvm7gzSPsYhhQ: doesn't show hand
*** SUMMARY ***
Total pot $2 | Rake $0
Seat 1: H6Z4+qu8gR0VUiPOijndVg folded before Flop (didn't bet)
Seat 2: rW/MyplHylMSBRaoRUzWrg folded before Flop (didn't bet)
Seat 3: WUlHm+ydPPHG7Lb0rePSdA folded before Flop (didn't bet)
Seat 4: lQYT23h5QCUVZAKxjOO39Q (button) folded before Flop (didn't bet)
Seat 5: FWGiDqRwvLeKmHq9t4Jy9w (small blind) folded before Flop
Seat 6: GX1heJ+DSsvm7gzSPsYhhQ (big blind) collected ($2)
Seat 7: PfmlvZlFiss79a6IoEr11g folded before Flop (didn't bet)
Seat 8: Z0rzUi0y1x80UdIpofoNbA folded before Flop (didn't bet)
Seat 9: CkE3IyJF1KvdaAOmZY5XqQ folded before Flop (didn't bet)



PokerStars Game #59941117822:  Hold'em No Limit ($1/$2) - 2009/07/01 1:26:09 ET
Table 'C4lkCXY2PWy6z4vsAe5NGQ' 6-max Seat #4 is the button
Seat 2: 6hRJ68JkbJq6MYI9o5bUnQ ($31.40 in chips)
Seat 3: sTPOWERd9HWPCNrDBwsVjA ($144.80 in chips)
Seat 4: VvdR9F3I+2yELkfTVvC1dg ($231.15 in chips)
Seat 6: B87ikIyZ/TzAVeXf38Ny0g ($781.15 in chips)
B87ikIyZ/TzAVeXf38Ny0g: posts small blind $1
6hRJ68JkbJq6MYI9o5bUnQ: posts big blind $2
*** HOLE CARDS ***
4bqvCfJ0e8CTYnn0Go9hbQ leaves the table
sTPOWERd9HWPCNrDBwsVjA: raises $4 to $6
dKvrkfQx2Peke3ikZLUy1w said, "**** THIS ****"
VvdR9F3I+2yELkfTVvC1dg: folds
dKvrkfQx2Peke3ikZLUy1w said, "UR A ****IN LUCKY ****"
B87ikIyZ/TzAVeXf38Ny0g: folds
6hRJ68JkbJq6MYI9o5bUnQ: folds
sTPOWERd9HWPCNrDBwsVjA collected $5 from pot
*** SUMMARY ***
Total pot $5 | Rake $0
Seat 2: 6hRJ68JkbJq6MYI9o5bUnQ (big blind) folded before Flop
Seat 3: sTPOWERd9HWPCNrDBwsVjA collected ($5)
Seat 4: VvdR9F3I+2yELkfTVvC1dg (button) folded before Flop (didn't bet)
Seat 6: B87ikIyZ/TzAVeXf38Ny0g (small blind) folded before Flop



PokerStars Game #59941118140:  Hold'em No Limit ($1/$2) - 2009/07/01 1:26:09 ET
Table 'jlrIxbrVIG+gjaUYT4za8g' 6-max Seat #1 is the button
Seat 1: ygTTt5ehT4aF86q1a8/R+w ($261.30 in chips)
Seat 2: on4ebXPJvUBOcHOBMQsRSg ($73.80 in chips)
Seat 3: RUZs7P4uzWavoA6iEpDKLw ($82.75 in chips)
Seat 4: 8srN1dKQePlsv0GyTada+Q ($298.35 in chips)
Seat 5: AyBB0k3Dcl7xbXUeGMw06g ($92.90 in chips)
Seat 6: vkfxu8f/jMYKUk6Ly4eujw ($316 in chips)
on4ebXPJvUBOcHOBMQsRSg: posts small blind $1
RUZs7P4uzWavoA6iEpDKLw: posts big blind $2
*** HOLE CARDS ***
8srN1dKQePlsv0GyTada+Q: folds
AyBB0k3Dcl7xbXUeGMw06g: calls $2
vkfxu8f/jMYKUk6Ly4eujw: raises $8 to $10
ygTTt5ehT4aF86q1a8/R+w: folds
on4ebXPJvUBOcHOBMQsRSg: folds
RUZs7P4uzWavoA6iEpDKLw: calls $8
AyBB0k3Dcl7xbXUeGMw06g: calls $8
*** FLOP *** [Qh Ts 8c]
RUZs7P4uzWavoA6iEpDKLw: checks
AyBB0k3Dcl7xbXUeGMw06g: bets $8
vkfxu8f/jMYKUk6Ly4eujw: folds
RUZs7P4uzWavoA6iEpDKLw: calls $8
*** TURN *** [Qh Ts 8c] [9c]
RUZs7P4uzWavoA6iEpDKLw: checks
AyBB0k3Dcl7xbXUeGMw06g: checks
*** RIVER *** [Qh Ts 8c 9c] [4s]
RUZs7P4uzWavoA6iEpDKLw: bets $30
AyBB0k3Dcl7xbXUeGMw06g: folds
RUZs7P4uzWavoA6iEpDKLw collected $44.75 from pot
RUZs7P4uzWavoA6iEpDKLw is sitting out
*** SUMMARY ***
Total pot $47 | Rake $2.25
Board [Qh Ts 8c 9c 4s]
Seat 1: ygTTt5ehT4aF86q1a8/R+w (button) folded before Flop (didn't bet)
Seat 2: on4ebXPJvUBOcHOBMQsRSg (small blind) folded before Flop
Seat 3: RUZs7P4uzWavoA6iEpDKLw (big blind) collected ($44.75)
Seat 4: 8srN1dKQePlsv0GyTada+Q folded before Flop (didn't bet)
Seat 5: AyBB0k3Dcl7xbXUeGMw06g folded on the River
Seat 6: vkfxu8f/jMYKUk6Ly4eujw folded on the Flop



PokerStars Game #59941118952:  Hold'em No Limit ($1/$2) - 2009/07/01 1:26:11 ET
Table 'kq5zaQ+1hLNf8LZfGnbTAA' 6-max Seat #1 is the button
Seat 1: 8srN1dKQePlsv0GyTada+Q ($209 in chips)
Seat 2: nXDI8Y/S6POzRwANu3d8hQ ($198 in chips)
Seat 3: vkfxu8f/jMYKUk6Ly4eujw ($227.95 in chips)
Seat 4: 3dAbvkxS5NPQTBAbvpinVg ($200 in chips)
Seat 5: kfASJqTbXek+zc8ZKsZL1Q ($266.50 in chips)
Seat 6: mfy7uGZcqA2PVQqEVbJ7+g ($197.25 in chips)
nXDI8Y/S6POzRwANu3d8hQ: posts small blind $1
vkfxu8f/jMYKUk6Ly4eujw: posts big blind $2
*** HOLE CARDS ***
3dAbvkxS5NPQTBAbvpinVg: folds
kfASJqTbXek+zc8ZKsZL1Q: raises $4 to $6
mfy7uGZcqA2PVQqEVbJ7+g: folds
8srN1dKQePlsv0GyTada+Q: raises $13 to $19
nXDI8Y/S6POzRwANu3d8hQ: folds
vkfxu8f/jMYKUk6Ly4eujw: folds
kfASJqTbXek+zc8ZKsZL1Q: calls $13
*** FLOP *** [6c 5d Kc]
kfASJqTbXek+zc8ZKsZL1Q: bets $42
8srN1dKQePlsv0GyTada+Q: calls $42
*** TURN *** [6c 5d Kc] [5s]
kfASJqTbXek+zc8ZKsZL1Q: bets $205.50 and is all-in
8srN1dKQePlsv0GyTada+Q: calls $148 and is all-in
*** RIVER *** [6c 5d Kc 5s] [Tc]
*** SHOW DOWN ***
kfASJqTbXek+zc8ZKsZL1Q: shows [4h As] (a pair of Fives)
8srN1dKQePlsv0GyTada+Q: shows [Ks Kd] (a full house, Kings full of Fives)
8srN1dKQePlsv0GyTada+Q collected $418 from pot
*** SUMMARY ***
Total pot $421 | Rake $3
Board [6c 5d Kc 5s Tc]
Seat 1: 8srN1dKQePlsv0GyTada+Q (button) showed [Ks Kd] and won ($418) with a full house, Kings full of Fives
Seat 2: nXDI8Y/S6POzRwANu3d8hQ (small blind) folded before Flop
Seat 3: vkfxu8f/jMYKUk6Ly4eujw (big blind) folded before Flop
Seat 4: 3dAbvkxS5NPQTBAbvpinVg folded before Flop (didn't bet)
Seat 5: kfASJqTbXek+zc8ZKsZL1Q showed [4h As] and lost with a pair of Fives
Seat 6: mfy7uGZcqA2PVQqEVbJ7+g folded before Flop (didn't bet)



PokerStars Game #59941119914:  Hold'em No Limit ($1/$2) - 2009/07/01 1:26:12 ET
Table 'aSf77Sj8QEnzcc0WaxVD4Q' 6-max Seat #1 is the button
Seat 1: UELtvp+JfwI7XDGVwSxZXA ($165.55 in chips)
Seat 2: vkfxu8f/jMYKUk6Ly4eujw ($198 in chips)
Seat 3: 9dpyyjDTCed6nV7JhaUUpw ($526.70 in chips)
Seat 4: YsLQ3BAvgQHWXMAv3Wv6Hg ($262.70 in chips)
Seat 5: VvdR9F3I+2yELkfTVvC1dg ($245 in chips)
Seat 6: vkoJRf3gidxY1pPi0AFWww ($118.55 in chips)
vkfxu8f/jMYKUk6Ly4eujw: posts small blind $1
9dpyyjDTCed6nV7JhaUUpw: posts big blind $2
*** HOLE CARDS ***
YsLQ3BAvgQHWXMAv3Wv6Hg: folds
VvdR9F3I+2yELkfTVvC1dg: folds
vkoJRf3gidxY1pPi0AFWww: folds
UELtvp+JfwI7XDGVwSxZXA: raises $4 to $6
vkfxu8f/jMYKUk6Ly4eujw: raises $14 to $20
9dpyyjDTCed6nV7JhaUUpw: folds
UELtvp+JfwI7XDGVwSxZXA: folds
vkfxu8f/jMYKUk6Ly4eujw collected $14 from pot
vkfxu8f/jMYKUk6Ly4eujw: doesn't show hand
*** SUMMARY ***
Total pot $14 | Rake $0
Seat 1: UELtvp+JfwI7XDGVwSxZXA (button) folded before Flop
Seat 2: vkfxu8f/jMYKUk6Ly4eujw (small blind) collected ($14)
Seat 3: 9dpyyjDTCed6nV7JhaUUpw (big blind) folded before Flop
Seat 4: YsLQ3BAvgQHWXMAv3Wv6Hg folded before Flop (didn't bet)
Seat 5: VvdR9F3I+2yELkfTVvC1dg folded before Flop (didn't bet)
Seat 6: vkoJRf3gidxY1pPi0AFWww folded before Flop (didn't bet)



PokerStars Game #59941119818:  Hold'em No Limit ($1/$2) - 2009/07/01 1:26:12 ET
Table '4NGNnZ/osQfNq6abYqkJeA' 6-max Seat #2 is the button
Seat 1: 7zM38baFvmCNB/F80oE0cQ ($80.45 in chips)
Seat 2: 669iGNwYwgRZg3nhS+aDAQ ($93.15 in chips)
Seat 3: 54yWzRRgS0oZ+S6LwZBxMQ ($21.75 in chips)
Seat 4: sY+4Uuh5z/6AbXXaCS10jw ($214.35 in chips)
Seat 5: VvdR9F3I+2yELkfTVvC1dg ($234.80 in chips)
Seat 6: kkgpegLoQkmL6LIsFsvtiQ ($238.65 in chips)
54yWzRRgS0oZ+S6LwZBxMQ: posts small blind $1
sY+4Uuh5z/6AbXXaCS10jw: posts big blind $2
*** HOLE CARDS ***
VvdR9F3I+2yELkfTVvC1dg: folds
kkgpegLoQkmL6LIsFsvtiQ: raises $6 to $8
7zM38baFvmCNB/F80oE0cQ: folds
669iGNwYwgRZg3nhS+aDAQ: folds
54yWzRRgS0oZ+S6LwZBxMQ: folds
sY+4Uuh5z/6AbXXaCS10jw: folds
7zM38baFvmCNB/F80oE0cQ leaves the table
kkgpegLoQkmL6LIsFsvtiQ collected $5 from pot
*** SUMMARY ***
Total pot $5 | Rake $0
Seat 1: 7zM38baFvmCNB/F80oE0cQ folded before Flop (didn't bet)
Seat 2: 669iGNwYwgRZg3nhS+aDAQ (button) folded before Flop (didn't bet)
Seat 3: 54yWzRRgS0oZ+S6LwZBxMQ (small blind) folded before Flop
Seat 4: sY+4Uuh5z/6AbXXaCS10jw (big blind) folded before Flop
Seat 5: VvdR9F3I+2yELkfTVvC1dg folded before Flop (didn't bet)
Seat 6: kkgpegLoQkmL6LIsFsvtiQ collected ($5)



PokerStars Game #59941120168:  Hold'em No Limit ($1/$2) - 2009/07/01 1:26:13 ET
Table 'TsEDkiO4tzCTCzJ7tNdEqw' 6-max Seat #4 is the button
Seat 1: MfXQsYD8pGeCS7XOtyV+vw ($101.25 in chips)
Seat 2: 4dcDwIHRm96PwtqkpQiuiA ($81.10 in chips)
Seat 4: K8MXCrNAVYlMnnCeM32Kxw ($106.45 in chips)
Seat 5: VvdR9F3I+2yELkfTVvC1dg ($200 in chips)
Seat 6: uCqEjnxh2/vFBjKYkfTOkw ($210.35 in chips)
VvdR9F3I+2yELkfTVvC1dg: posts small blind $1
uCqEjnxh2/vFBjKYkfTOkw: posts big blind $2
ubtx4Z5L+AcK71MTvYiGVw: sits out
*** HOLE CARDS ***
MfXQsYD8pGeCS7XOtyV+vw: calls $2
4dcDwIHRm96PwtqkpQiuiA has timed out
4dcDwIHRm96PwtqkpQiuiA: folds
4dcDwIHRm96PwtqkpQiuiA is sitting out
K8MXCrNAVYlMnnCeM32Kxw: folds
VvdR9F3I+2yELkfTVvC1dg: raises $6 to $8
uCqEjnxh2/vFBjKYkfTOkw: raises $18 to $26
MfXQsYD8pGeCS7XOtyV+vw: folds
4dcDwIHRm96PwtqkpQiuiA has returned
VvdR9F3I+2yELkfTVvC1dg: calls $18
*** FLOP *** [Ah 6s Tc]
VvdR9F3I+2yELkfTVvC1dg: checks
uCqEjnxh2/vFBjKYkfTOkw: bets $40
VvdR9F3I+2yELkfTVvC1dg: raises $43 to $83
uCqEjnxh2/vFBjKYkfTOkw: folds
VvdR9F3I+2yELkfTVvC1dg collected $132 from pot
VvdR9F3I+2yELkfTVvC1dg: doesn't show hand
*** SUMMARY ***
Total pot $134 | Rake $2
Board [Ah 6s Tc]
Seat 1: MfXQsYD8pGeCS7XOtyV+vw folded before Flop
Seat 2: 4dcDwIHRm96PwtqkpQiuiA folded before Flop (didn't bet)
Seat 4: K8MXCrNAVYlMnnCeM32Kxw (button) folded before Flop (didn't bet)
Seat 5: VvdR9F3I+2yELkfTVvC1dg (small blind) collected ($132)
Seat 6: uCqEjnxh2/vFBjKYkfTOkw (big blind) folded on the Flop



PokerStars Game #59941123236:  Hold'em No Limit ($1/$2) - 2009/07/01 1:26:18 ET
Table 'NmY84NAf9Mh0ckAckHnh5g' 2-max Seat #2 is the button
Seat 1: 6hvg964TSqZ3AL/0XK9aVQ ($245.60 in chips)
Seat 2: RwDoM55ZeQuI2ADyJhOb2Q ($757.40 in chips)
RwDoM55ZeQuI2ADyJhOb2Q: posts small blind $1
6hvg964TSqZ3AL/0XK9aVQ: posts big blind $2
*** HOLE CARDS ***
RwDoM55ZeQuI2ADyJhOb2Q: raises $4 to $6
6hvg964TSqZ3AL/0XK9aVQ: calls $4
*** FLOP *** [9s Jc Ad]
6hvg964TSqZ3AL/0XK9aVQ: checks
RwDoM55ZeQuI2ADyJhOb2Q: checks
*** TURN *** [9s Jc Ad] [Kd]
6hvg964TSqZ3AL/0XK9aVQ: bets $8
RwDoM55ZeQuI2ADyJhOb2Q: folds
6hvg964TSqZ3AL/0XK9aVQ collected $11.50 from pot
*** SUMMARY ***
Total pot $12 | Rake $0.50
Board [9s Jc Ad Kd]
Seat 1: 6hvg964TSqZ3AL/0XK9aVQ (big blind) collected ($11.50)
Seat 2: RwDoM55ZeQuI2ADyJhOb2Q (button) (small blind) folded on the Turn



PokerStars Game #59941123548:  Hold'em No Limit ($1/$2) - 2009/07/01 1:26:19 ET
Table 'uJ9juaXXg9yIcSU8amxaXQ' 6-max Seat #1 is the button
Seat 1: JsqOjN/eHz0uYVf/PyUJ6Q ($143.85 in chips)
Seat 2: VvdR9F3I+2yELkfTVvC1dg ($200 in chips)
Seat 3: qXDd0ZyMIse0OBu8pxeQ3Q ($247 in chips)
Seat 4: zNjJ/y4emmF+vzrCDd+ooA ($232.60 in chips)
Seat 5: YsLQ3BAvgQHWXMAv3Wv6Hg ($200 in chips)
Seat 6: 2DFp9Veq1xxq64dCjwNuUw ($59.60 in chips)
VvdR9F3I+2yELkfTVvC1dg: posts small blind $1
qXDd0ZyMIse0OBu8pxeQ3Q: posts big blind $2
*** HOLE CARDS ***
zNjJ/y4emmF+vzrCDd+ooA: calls $2
YsLQ3BAvgQHWXMAv3Wv6Hg: folds
2DFp9Veq1xxq64dCjwNuUw: folds
JsqOjN/eHz0uYVf/PyUJ6Q: calls $2
VvdR9F3I+2yELkfTVvC1dg: folds
qXDd0ZyMIse0OBu8pxeQ3Q: checks
*** FLOP *** [2s 7h 3s]
qXDd0ZyMIse0OBu8pxeQ3Q: checks
zNjJ/y4emmF+vzrCDd+ooA: checks
JsqOjN/eHz0uYVf/PyUJ6Q: bets $6
qXDd0ZyMIse0OBu8pxeQ3Q: folds
zNjJ/y4emmF+vzrCDd+ooA: folds
JsqOjN/eHz0uYVf/PyUJ6Q collected $6.65 from pot
JsqOjN/eHz0uYVf/PyUJ6Q: doesn't show hand
*** SUMMARY ***
Total pot $7 | Rake $0.35
Board [2s 7h 3s]
Seat 1: JsqOjN/eHz0uYVf/PyUJ6Q (button) collected ($6.65)
Seat 2: VvdR9F3I+2yELkfTVvC1dg (small blind) folded before Flop
Seat 3: qXDd0ZyMIse0OBu8pxeQ3Q (big blind) folded on the Flop
Seat 4: zNjJ/y4emmF+vzrCDd+ooA folded on the Flop
Seat 5: YsLQ3BAvgQHWXMAv3Wv6Hg folded before Flop (didn't bet)
Seat 6: 2DFp9Veq1xxq64dCjwNuUw folded before Flop (didn't bet)



PokerStars Game #59941123666:  Hold'em No Limit ($1/$2) - 2009/07/01 1:26:19 ET
Table 'QxerF7GUfCbl+4a8XaTB2w' 6-max Seat #6 is the button
Seat 1: 54yWzRRgS0oZ+S6LwZBxMQ ($35 in chips)
Seat 2: HiWSAXs6/0w9Jy7ioiiShQ ($36 in chips)
Seat 3: m7mYVfnCOK5TE/VkN/FhOg ($278.10 in chips)
Seat 4: 09BNF4quPDzanQzM8vc6WA ($41.55 in chips)
Seat 5: gnYme0DNFflnMhrdbxe1Ag ($244.70 in chips)
Seat 6: VvdR9F3I+2yELkfTVvC1dg ($200 in chips)
54yWzRRgS0oZ+S6LwZBxMQ: posts small blind $1
HiWSAXs6/0w9Jy7ioiiShQ: posts big blind $2
*** HOLE CARDS ***
m7mYVfnCOK5TE/VkN/FhOg: folds
09BNF4quPDzanQzM8vc6WA: folds
gnYme0DNFflnMhrdbxe1Ag: folds
VvdR9F3I+2yELkfTVvC1dg: folds
54yWzRRgS0oZ+S6LwZBxMQ: folds
HiWSAXs6/0w9Jy7ioiiShQ collected $2 from pot
HiWSAXs6/0w9Jy7ioiiShQ: doesn't show hand
*** SUMMARY ***
Total pot $2 | Rake $0
Seat 1: 54yWzRRgS0oZ+S6LwZBxMQ (small blind) folded before Flop
Seat 2: HiWSAXs6/0w9Jy7ioiiShQ (big blind) collected ($2)
Seat 3: m7mYVfnCOK5TE/VkN/FhOg folded before Flop (didn't bet)
Seat 4: 09BNF4quPDzanQzM8vc6WA folded before Flop (didn't bet)
Seat 5: gnYme0DNFflnMhrdbxe1Ag folded before Flop (didn't bet)
Seat 6: VvdR9F3I+2yELkfTVvC1dg (button) folded before Flop (didn't bet)



PokerStars Game #59941124522:  Hold'em No Limit ($1/$2) - 2009/07/01 1:26:21 ET
Table 'bJQ024BaYSBrW0sXpCZbNQ' 6-max Seat #4 is the button
Seat 2: 3dAbvkxS5NPQTBAbvpinVg ($220.05 in chips)
Seat 3: vkfxu8f/jMYKUk6Ly4eujw ($230.05 in chips)
Seat 4: TBaQIN+sQ7eb7P99QnaORQ ($36 in chips)
Seat 5: VvdR9F3I+2yELkfTVvC1dg ($200 in chips)
VvdR9F3I+2yELkfTVvC1dg: posts small blind $1
9dpyyjDTCed6nV7JhaUUpw: is sitting out
3dAbvkxS5NPQTBAbvpinVg: posts big blind $2
*** HOLE CARDS ***
vkfxu8f/jMYKUk6Ly4eujw: folds
TBaQIN+sQ7eb7P99QnaORQ: folds
vkfxu8f/jMYKUk6Ly4eujw leaves the table
9dpyyjDTCed6nV7JhaUUpw leaves the table
VvdR9F3I+2yELkfTVvC1dg: raises $2 to $4
3dAbvkxS5NPQTBAbvpinVg: raises $10 to $14
VvdR9F3I+2yELkfTVvC1dg: folds
3dAbvkxS5NPQTBAbvpinVg collected $8 from pot
3dAbvkxS5NPQTBAbvpinVg: doesn't show hand
*** SUMMARY ***
Total pot $8 | Rake $0
Seat 2: 3dAbvkxS5NPQTBAbvpinVg (big blind) collected ($8)
Seat 3: vkfxu8f/jMYKUk6Ly4eujw folded before Flop (didn't bet)
Seat 4: TBaQIN+sQ7eb7P99QnaORQ (button) folded before Flop (didn't bet)
Seat 5: VvdR9F3I+2yELkfTVvC1dg (small blind) folded before Flop



PokerStars Game #59941128178:  Hold'em No Limit ($1/$2) - 2009/07/01 1:26:27 ET
Table 'pPQgcj9XT9CHBsbo1WTBug' 6-max Seat #3 is the button
Seat 1: DFVYDA6dKQy7R7mGIKogZA ($135.70 in chips)
Seat 2: qXDd0ZyMIse0OBu8pxeQ3Q ($208.30 in chips)
Seat 3: 54yWzRRgS0oZ+S6LwZBxMQ ($61.75 in chips)
Seat 4: gqlysXCbT8V54f/1lf9h3A ($34.30 in chips)
Seat 5: vkfxu8f/jMYKUk6Ly4eujw ($202.55 in chips)
Seat 6: Yr7pZltpy3IUNdKS9PCEiw ($304.30 in chips)
gqlysXCbT8V54f/1lf9h3A: posts small blind $1
vkfxu8f/jMYKUk6Ly4eujw: posts big blind $2
*** HOLE CARDS ***
Yr7pZltpy3IUNdKS9PCEiw: folds
DFVYDA6dKQy7R7mGIKogZA: folds
qXDd0ZyMIse0OBu8pxeQ3Q: folds
54yWzRRgS0oZ+S6LwZBxMQ: folds
gqlysXCbT8V54f/1lf9h3A: calls $1
vkfxu8f/jMYKUk6Ly4eujw: checks
*** FLOP *** [Tc Th Jc]
gqlysXCbT8V54f/1lf9h3A: checks
vkfxu8f/jMYKUk6Ly4eujw: checks
*** TURN *** [Tc Th Jc] [Td]
gqlysXCbT8V54f/1lf9h3A: bets $2
vkfxu8f/jMYKUk6Ly4eujw: folds
gqlysXCbT8V54f/1lf9h3A collected $3.80 from pot
gqlysXCbT8V54f/1lf9h3A: doesn't show hand
*** SUMMARY ***
Total pot $4 | Rake $0.20
Board [Tc Th Jc Td]
Seat 1: DFVYDA6dKQy7R7mGIKogZA folded before Flop (didn't bet)
Seat 2: qXDd0ZyMIse0OBu8pxeQ3Q folded before Flop (didn't bet)
Seat 3: 54yWzRRgS0oZ+S6LwZBxMQ (button) folded before Flop (didn't bet)
Seat 4: gqlysXCbT8V54f/1lf9h3A (small blind) collected ($3.80)
Seat 5: vkfxu8f/jMYKUk6Ly4eujw (big blind) folded on the Turn
Seat 6: Yr7pZltpy3IUNdKS9PCEiw folded before Flop (didn't bet)



PokerStars Game #59941129592:  Hold'em No Limit ($1/$2) - 2009/07/01 1:26:29 ET
Table 'ztv6V3FN2bQ9nmJPPdx6nQ' 6-max Seat #2 is the button
Seat 1: 6fLdOUCRtX71xbVRhJEq8w ($205 in chips)
Seat 2: 5Y+ZGWLI4gnlpApDX5vy1A ($404.75 in chips)
Seat 3: ubtx4Z5L+AcK71MTvYiGVw ($246 in chips)
Seat 4: UaZ5yj+6LjtWqMQg2QskUw ($118.30 in chips)
Seat 5: sTPOWERd9HWPCNrDBwsVjA ($213.75 in chips)
Seat 6: mfy7uGZcqA2PVQqEVbJ7+g ($117.45 in chips)
ubtx4Z5L+AcK71MTvYiGVw: posts small blind $1
UaZ5yj+6LjtWqMQg2QskUw: posts big blind $2
*** HOLE CARDS ***
sTPOWERd9HWPCNrDBwsVjA: folds
mfy7uGZcqA2PVQqEVbJ7+g: folds
6fLdOUCRtX71xbVRhJEq8w: folds
5Y+ZGWLI4gnlpApDX5vy1A: raises $2 to $4
ubtx4Z5L+AcK71MTvYiGVw: folds
UaZ5yj+6LjtWqMQg2QskUw: folds
5Y+ZGWLI4gnlpApDX5vy1A collected $5 from pot
5Y+ZGWLI4gnlpApDX5vy1A: doesn't show hand
*** SUMMARY ***
Total pot $5 | Rake $0
Seat 1: 6fLdOUCRtX71xbVRhJEq8w folded before Flop (didn't bet)
Seat 2: 5Y+ZGWLI4gnlpApDX5vy1A (button) collected ($5)
Seat 3: ubtx4Z5L+AcK71MTvYiGVw (small blind) folded before Flop
Seat 4: UaZ5yj+6LjtWqMQg2QskUw (big blind) folded before Flop
Seat 5: sTPOWERd9HWPCNrDBwsVjA folded before Flop (didn't bet)
Seat 6: mfy7uGZcqA2PVQqEVbJ7+g folded before Flop (didn't bet)



PokerStars Game #59941130892:  Hold'em No Limit ($1/$2) - 2009/07/01 1:26:31 ET
Table '+hSnXFQrGw1PlVgTnuj+sA' 6-max Seat #1 is the button
Seat 1: 2ccIJhDj+3JapvS7swVZEg ($334 in chips)
Seat 3: fE+LHW/7rpfXW14g8LhGjA ($53.30 in chips)
Seat 4: J4iH5epwXbmODnojR/VRxA ($157.60 in chips)
Seat 5: VvdR9F3I+2yELkfTVvC1dg ($204.55 in chips)
Seat 6: AuiGltq875lmaKHBsjZVGg ($67.75 in chips)
54yWzRRgS0oZ+S6LwZBxMQ will be allowed to play after the button
fE+LHW/7rpfXW14g8LhGjA: posts small blind $1
J4iH5epwXbmODnojR/VRxA: posts big blind $2
*** HOLE CARDS ***
VvdR9F3I+2yELkfTVvC1dg: folds
AuiGltq875lmaKHBsjZVGg: folds
2ccIJhDj+3JapvS7swVZEg: folds
fE+LHW/7rpfXW14g8LhGjA: calls $1
J4iH5epwXbmODnojR/VRxA: checks
*** FLOP *** [Qc 4d 9h]
fE+LHW/7rpfXW14g8LhGjA: bets $2
J4iH5epwXbmODnojR/VRxA: raises $2 to $4
fE+LHW/7rpfXW14g8LhGjA: folds
J4iH5epwXbmODnojR/VRxA collected $7.65 from pot
*** SUMMARY ***
Total pot $8 | Rake $0.35
Board [Qc 4d 9h]
Seat 1: 2ccIJhDj+3JapvS7swVZEg (button) folded before Flop (didn't bet)
Seat 3: fE+LHW/7rpfXW14g8LhGjA (small blind) folded on the Flop
Seat 4: J4iH5epwXbmODnojR/VRxA (big blind) collected ($7.65)
Seat 5: VvdR9F3I+2yELkfTVvC1dg folded before Flop (didn't bet)
Seat 6: AuiGltq875lmaKHBsjZVGg folded before Flop (didn't bet)



PokerStars Game #59941131150:  Hold'em No Limit ($1/$2) - 2009/07/01 1:26:32 ET
Table 'C4lkCXY2PWy6z4vsAe5NGQ' 6-max Seat #6 is the button
Seat 2: 6hRJ68JkbJq6MYI9o5bUnQ ($29.40 in chips)
Seat 3: sTPOWERd9HWPCNrDBwsVjA ($147.80 in chips)
Seat 4: VvdR9F3I+2yELkfTVvC1dg ($231.15 in chips)
Seat 6: B87ikIyZ/TzAVeXf38Ny0g ($780.15 in chips)
6hRJ68JkbJq6MYI9o5bUnQ: posts small blind $1
sTPOWERd9HWPCNrDBwsVjA: posts big blind $2
*** HOLE CARDS ***
dKvrkfQx2Peke3ikZLUy1w said, "**** U PIECE OF ****"
VvdR9F3I+2yELkfTVvC1dg: folds
gnYme0DNFflnMhrdbxe1Ag joins the table at seat #1
B87ikIyZ/TzAVeXf38Ny0g: raises $4 to $6
6hRJ68JkbJq6MYI9o5bUnQ: raises $23.40 to $29.40 and is all-in
dKvrkfQx2Peke3ikZLUy1w said, "**** U WNAKER"
sTPOWERd9HWPCNrDBwsVjA: folds
sTPOWERd9HWPCNrDBwsVjA is sitting out
dKvrkfQx2Peke3ikZLUy1w said, "no wonder u hav no mates"
B87ikIyZ/TzAVeXf38Ny0g: calls $23.40
*** FLOP *** [6s Jc Ad]
*** TURN *** [6s Jc Ad] [9h]
*** RIVER *** [6s Jc Ad 9h] [Th]
*** SHOW DOWN ***
6hRJ68JkbJq6MYI9o5bUnQ: shows [Ah 4h] (a pair of Aces)
B87ikIyZ/TzAVeXf38Ny0g: mucks hand
6hRJ68JkbJq6MYI9o5bUnQ collected $58.80 from pot
*** SUMMARY ***
Total pot $60.80 | Rake $2
Board [6s Jc Ad 9h Th]
Seat 2: 6hRJ68JkbJq6MYI9o5bUnQ (small blind) showed [Ah 4h] and won ($58.80) with a pair of Aces
Seat 3: sTPOWERd9HWPCNrDBwsVjA (big blind) folded before Flop
Seat 4: VvdR9F3I+2yELkfTVvC1dg folded before Flop (didn't bet)
Seat 6: B87ikIyZ/TzAVeXf38Ny0g (button) mucked



PokerStars Game #59941130942:  Hold'em No Limit ($1/$2) - 2009/07/01 1:26:32 ET
Table 'AtOXMvcrtQM8yLNcALmfLQ' 2-max Seat #2 is the button
Seat 1: +HlQuAsMqZGYYtjcPO/a3A ($143.40 in chips)
Seat 2: pVqEzK9wXlRMECnb1Zg4Zw ($251.80 in chips)
pVqEzK9wXlRMECnb1Zg4Zw: posts small blind $1
+HlQuAsMqZGYYtjcPO/a3A: posts big blind $2
*** HOLE CARDS ***
pVqEzK9wXlRMECnb1Zg4Zw: raises $6 to $8
+HlQuAsMqZGYYtjcPO/a3A: folds
pVqEzK9wXlRMECnb1Zg4Zw collected $4 from pot
pVqEzK9wXlRMECnb1Zg4Zw: doesn't show hand
*** SUMMARY ***
Total pot $4 | Rake $0
Seat 1: +HlQuAsMqZGYYtjcPO/a3A (big blind) folded before Flop
Seat 2: pVqEzK9wXlRMECnb1Zg4Zw (button) (small blind) collected ($4)



PokerStars Game #59941132046:  Hold'em No Limit ($1/$2) - 2009/07/01 1:26:33 ET
Table '3WCXyaiCAbqSShQu7FIjvA' 9-max Seat #3 is the button
Seat 1: kTCkABD1UUldS9DFRGfCwQ ($151.40 in chips)
Seat 3: 5Q8U6iZbeO7xJSS4qvDP5g ($206.15 in chips)
Seat 4: waEF/+pxZTxNo4FvsORuXg ($77 in chips)
Seat 5: CkE3IyJF1KvdaAOmZY5XqQ ($200 in chips)
Seat 6: 5jQlngvMSqM/WoonOcR5kw ($296 in chips)
Seat 8: 1CtiZuXDFaJL1dJPQKyi8Q ($242.35 in chips)
Seat 9: FiXPLJyqb24l32QST2TInw ($153.40 in chips)
waEF/+pxZTxNo4FvsORuXg: posts small blind $1
CkE3IyJF1KvdaAOmZY5XqQ: posts big blind $2
*** HOLE CARDS ***
5jQlngvMSqM/WoonOcR5kw: calls $2
1zQMh8lHgW3t2YhVeA+09A leaves the table
1CtiZuXDFaJL1dJPQKyi8Q: folds
FiXPLJyqb24l32QST2TInw: folds
kTCkABD1UUldS9DFRGfCwQ: folds
TAfo4veNRaRlzDXMMYS3Jg joins the table at seat #2
5Q8U6iZbeO7xJSS4qvDP5g: raises $8 to $10
waEF/+pxZTxNo4FvsORuXg: folds
CkE3IyJF1KvdaAOmZY5XqQ: calls $8
5jQlngvMSqM/WoonOcR5kw: raises $8 to $18
5Q8U6iZbeO7xJSS4qvDP5g: calls $8
CkE3IyJF1KvdaAOmZY5XqQ: calls $8
*** FLOP *** [6c 6s 2d]
CkE3IyJF1KvdaAOmZY5XqQ: checks
5jQlngvMSqM/WoonOcR5kw: checks
5Q8U6iZbeO7xJSS4qvDP5g: checks
*** TURN *** [6c 6s 2d] [Jh]
CkE3IyJF1KvdaAOmZY5XqQ: checks
5jQlngvMSqM/WoonOcR5kw: checks
5Q8U6iZbeO7xJSS4qvDP5g: bets $32
CkE3IyJF1KvdaAOmZY5XqQ: folds
5jQlngvMSqM/WoonOcR5kw: calls $32
*** RIVER *** [6c 6s 2d Jh] [5s]
5jQlngvMSqM/WoonOcR5kw: checks
5Q8U6iZbeO7xJSS4qvDP5g: checks
*** SHOW DOWN ***
5jQlngvMSqM/WoonOcR5kw: shows [Qc Qh] (two pair, Queens and Sixes)
5Q8U6iZbeO7xJSS4qvDP5g: shows [Kc Kh] (two pair, Kings and Sixes)
5Q8U6iZbeO7xJSS4qvDP5g collected $116 from pot
*** SUMMARY ***
Total pot $119 | Rake $3
Board [6c 6s 2d Jh 5s]
Seat 1: kTCkABD1UUldS9DFRGfCwQ folded before Flop (didn't bet)
Seat 3: 5Q8U6iZbeO7xJSS4qvDP5g (button) showed [Kc Kh] and won ($116) with two pair, Kings and Sixes
Seat 4: waEF/+pxZTxNo4FvsORuXg (small blind) folded before Flop
Seat 5: CkE3IyJF1KvdaAOmZY5XqQ (big blind) folded on the Turn
Seat 6: 5jQlngvMSqM/WoonOcR5kw showed [Qc Qh] and lost with two pair, Queens and Sixes
Seat 8: 1CtiZuXDFaJL1dJPQKyi8Q folded before Flop (didn't bet)
Seat 9: FiXPLJyqb24l32QST2TInw folded before Flop (didn't bet)



PokerStars Game #59941132776:  Hold'em No Limit ($1/$2) - 2009/07/01 1:26:35 ET
Table '4NGNnZ/osQfNq6abYqkJeA' 6-max Seat #3 is the button
Seat 2: 669iGNwYwgRZg3nhS+aDAQ ($93.15 in chips)
Seat 3: 54yWzRRgS0oZ+S6LwZBxMQ ($20.75 in chips)
Seat 4: sY+4Uuh5z/6AbXXaCS10jw ($212.35 in chips)
Seat 5: VvdR9F3I+2yELkfTVvC1dg ($234.80 in chips)
Seat 6: kkgpegLoQkmL6LIsFsvtiQ ($241.65 in chips)
sY+4Uuh5z/6AbXXaCS10jw: posts small blind $1
VvdR9F3I+2yELkfTVvC1dg: posts big blind $2
*** HOLE CARDS ***
kkgpegLoQkmL6LIsFsvtiQ: folds
669iGNwYwgRZg3nhS+aDAQ: folds
vkfxu8f/jMYKUk6Ly4eujw joins the table at seat #1
54yWzRRgS0oZ+S6LwZBxMQ: folds
sY+4Uuh5z/6AbXXaCS10jw: folds
VvdR9F3I+2yELkfTVvC1dg collected $2 from pot
VvdR9F3I+2yELkfTVvC1dg: doesn't show hand
*** SUMMARY ***
Total pot $2 | Rake $0
Seat 2: 669iGNwYwgRZg3nhS+aDAQ folded before Flop (didn't bet)
Seat 3: 54yWzRRgS0oZ+S6LwZBxMQ (button) folded before Flop (didn't bet)
Seat 4: sY+4Uuh5z/6AbXXaCS10jw (small blind) folded before Flop
Seat 5: VvdR9F3I+2yELkfTVvC1dg (big blind) collected ($2)
Seat 6: kkgpegLoQkmL6LIsFsvtiQ folded before Flop (didn't bet)



PokerStars Game #59941135078:  Hold'em No Limit ($1/$2) - 2009/07/01 1:26:39 ET
Table '8Y6PEyoNuepZTai2Q56aHw' 9-max Seat #4 is the button
Seat 1: 5Q8U6iZbeO7xJSS4qvDP5g ($298.10 in chips)
Seat 2: gDCJIAlovbPnTvMM7Dd1gA ($167.35 in chips)
Seat 3: WUlHm+ydPPHG7Lb0rePSdA ($217.10 in chips)
Seat 4: xKkwALG38OfLQ9DXuJgR1w ($261.55 in chips)
Seat 6: NtLDBSjsJQEKekh5cdinvw ($359.20 in chips)
Seat 7: Kzta8yu9vxHT4B70mjBZ+w ($210.30 in chips)
Seat 8: rW/MyplHylMSBRaoRUzWrg ($40 in chips)
Seat 9: F7m34OOfAQ7annesMHVjKw ($200 in chips)
NtLDBSjsJQEKekh5cdinvw: posts small blind $1
Kzta8yu9vxHT4B70mjBZ+w: posts big blind $2
*** HOLE CARDS ***
rW/MyplHylMSBRaoRUzWrg: folds
F7m34OOfAQ7annesMHVjKw: folds
5Q8U6iZbeO7xJSS4qvDP5g: folds
gDCJIAlovbPnTvMM7Dd1gA: folds
WUlHm+ydPPHG7Lb0rePSdA: folds
xKkwALG38OfLQ9DXuJgR1w: raises $6 to $8
NtLDBSjsJQEKekh5cdinvw: calls $7
Kzta8yu9vxHT4B70mjBZ+w: folds
*** FLOP *** [Qd 6s 7h]
NtLDBSjsJQEKekh5cdinvw: checks
xKkwALG38OfLQ9DXuJgR1w: checks
*** TURN *** [Qd 6s 7h] [9s]
NtLDBSjsJQEKekh5cdinvw: bets $10
xKkwALG38OfLQ9DXuJgR1w: calls $10
*** RIVER *** [Qd 6s 7h 9s] [9h]
NtLDBSjsJQEKekh5cdinvw: checks
xKkwALG38OfLQ9DXuJgR1w: checks
*** SHOW DOWN ***
NtLDBSjsJQEKekh5cdinvw: shows [Ks Qh] (two pair, Queens and Nines)
xKkwALG38OfLQ9DXuJgR1w: mucks hand
NtLDBSjsJQEKekh5cdinvw collected $36.15 from pot
*** SUMMARY ***
Total pot $38 | Rake $1.85
Board [Qd 6s 7h 9s 9h]
Seat 1: 5Q8U6iZbeO7xJSS4qvDP5g folded before Flop (didn't bet)
Seat 2: gDCJIAlovbPnTvMM7Dd1gA folded before Flop (didn't bet)
Seat 3: WUlHm+ydPPHG7Lb0rePSdA folded before Flop (didn't bet)
Seat 4: xKkwALG38OfLQ9DXuJgR1w (button) mucked
Seat 6: NtLDBSjsJQEKekh5cdinvw (small blind) showed [Ks Qh] and won ($36.15) with two pair, Queens and Nines
Seat 7: Kzta8yu9vxHT4B70mjBZ+w (big blind) folded before Flop
Seat 8: rW/MyplHylMSBRaoRUzWrg folded before Flop (didn't bet)
Seat 9: F7m34OOfAQ7annesMHVjKw folded before Flop (didn't bet)



PokerStars Game #59941135780:  Hold'em No Limit ($1/$2) - 2009/07/01 1:26:40 ET
Table 'rKeCh+eBn4RNvybCUYkoTQ' 9-max Seat #1 is the button
Seat 1: /inIs/z/PcX+TniIFpaxpg ($200 in chips)
Seat 2: 9cBHwK40Tl06vheE7B3LHQ ($157.55 in chips)
Seat 3: GX1heJ+DSsvm7gzSPsYhhQ ($34 in chips)
Seat 4: 31HuO+DQxppUQEedBWukug ($92.10 in chips)
Seat 5: WUlHm+ydPPHG7Lb0rePSdA ($128 in chips)
Seat 6: EBV6OktyeSmh4w6sWmcWOw ($267 in chips)
Seat 7: rW/MyplHylMSBRaoRUzWrg ($34 in chips)
Seat 8: pN/Ip0ePsUVIdUlGgLrkUw ($215.35 in chips)
Seat 9: Kzta8yu9vxHT4B70mjBZ+w ($211.25 in chips)
9cBHwK40Tl06vheE7B3LHQ: posts small blind $1
GX1heJ+DSsvm7gzSPsYhhQ: posts big blind $2
*** HOLE CARDS ***
31HuO+DQxppUQEedBWukug: folds
WUlHm+ydPPHG7Lb0rePSdA: folds
EBV6OktyeSmh4w6sWmcWOw: folds
rW/MyplHylMSBRaoRUzWrg: folds
pN/Ip0ePsUVIdUlGgLrkUw: folds
Kzta8yu9vxHT4B70mjBZ+w: folds
/inIs/z/PcX+TniIFpaxpg: folds
9cBHwK40Tl06vheE7B3LHQ: raises $4 to $6
GX1heJ+DSsvm7gzSPsYhhQ: folds
9cBHwK40Tl06vheE7B3LHQ collected $4 from pot
9cBHwK40Tl06vheE7B3LHQ: doesn't show hand
*** SUMMARY ***
Total pot $4 | Rake $0
Seat 1: /inIs/z/PcX+TniIFpaxpg (button) folded before Flop (didn't bet)
Seat 2: 9cBHwK40Tl06vheE7B3LHQ (small blind) collected ($4)
Seat 3: GX1heJ+DSsvm7gzSPsYhhQ (big blind) folded before Flop
Seat 4: 31HuO+DQxppUQEedBWukug folded before Flop (didn't bet)
Seat 5: WUlHm+ydPPHG7Lb0rePSdA folded before Flop (didn't bet)
Seat 6: EBV6OktyeSmh4w6sWmcWOw folded before Flop (didn't bet)
Seat 7: rW/MyplHylMSBRaoRUzWrg folded before Flop (didn't bet)
Seat 8: pN/Ip0ePsUVIdUlGgLrkUw folded before Flop (didn't bet)
Seat 9: Kzta8yu9vxHT4B70mjBZ+w folded before Flop (didn't bet)



PokerStars Game #59941136344:  Hold'em No Limit ($1/$2) - 2009/07/01 1:26:41 ET
Table 'aSf77Sj8QEnzcc0WaxVD4Q' 6-max Seat #2 is the button
Seat 1: UELtvp+JfwI7XDGVwSxZXA ($159.55 in chips)
Seat 2: vkfxu8f/jMYKUk6Ly4eujw ($206 in chips)
Seat 3: 9dpyyjDTCed6nV7JhaUUpw ($524.70 in chips)
Seat 4: YsLQ3BAvgQHWXMAv3Wv6Hg ($262.70 in chips)
Seat 5: VvdR9F3I+2yELkfTVvC1dg ($245 in chips)
Seat 6: vkoJRf3gidxY1pPi0AFWww ($118.55 in chips)
9dpyyjDTCed6nV7JhaUUpw: posts small blind $1
YsLQ3BAvgQHWXMAv3Wv6Hg: posts big blind $2
*** HOLE CARDS ***
VvdR9F3I+2yELkfTVvC1dg: folds
vkoJRf3gidxY1pPi0AFWww: raises $6 to $8
UELtvp+JfwI7XDGVwSxZXA: folds
vkfxu8f/jMYKUk6Ly4eujw: folds
9dpyyjDTCed6nV7JhaUUpw: folds
YsLQ3BAvgQHWXMAv3Wv6Hg: folds
vkoJRf3gidxY1pPi0AFWww collected $5 from pot
vkoJRf3gidxY1pPi0AFWww: doesn't show hand
*** SUMMARY ***
Total pot $5 | Rake $0
Seat 1: UELtvp+JfwI7XDGVwSxZXA folded before Flop (didn't bet)
Seat 2: vkfxu8f/jMYKUk6Ly4eujw (button) folded before Flop (didn't bet)
Seat 3: 9dpyyjDTCed6nV7JhaUUpw (small blind) folded before Flop
Seat 4: YsLQ3BAvgQHWXMAv3Wv6Hg (big blind) folded before Flop
Seat 5: VvdR9F3I+2yELkfTVvC1dg folded before Flop (didn't bet)
Seat 6: vkoJRf3gidxY1pPi0AFWww collected ($5)



PokerStars Game #59941137550:  Hold'em No Limit ($1/$2) - 2009/07/01 1:26:43 ET
Table 'gftD4mDF7mIFKvSrIyaRbw' 9-max Seat #3 is the button
Seat 1: 31HuO+DQxppUQEedBWukug ($98 in chips)
Seat 2: GX1heJ+DSsvm7gzSPsYhhQ ($40 in chips)
Seat 3: CUZwDpLTQKhzarPe+JCLOQ ($200 in chips)
Seat 4: /inIs/z/PcX+TniIFpaxpg ($41 in chips)
Seat 5: mpsfNtnMVDqQHTe92AhIdw ($120.10 in chips)
Seat 6: 2NvwF8W2nzsbS+G//yLAbQ ($178.05 in chips)
Seat 8: MpL4DeEqGQu0H8TJEbEOrg ($44 in chips)
Seat 9: F7m34OOfAQ7annesMHVjKw ($167.75 in chips)
/inIs/z/PcX+TniIFpaxpg: posts small blind $1
mpsfNtnMVDqQHTe92AhIdw: posts big blind $2
+T/63sAeZzWyHchahJ36GQ: sits out
*** HOLE CARDS ***
2NvwF8W2nzsbS+G//yLAbQ: folds
MpL4DeEqGQu0H8TJEbEOrg: folds
F7m34OOfAQ7annesMHVjKw: folds
31HuO+DQxppUQEedBWukug: folds
GX1heJ+DSsvm7gzSPsYhhQ: folds
CUZwDpLTQKhzarPe+JCLOQ: folds
/inIs/z/PcX+TniIFpaxpg: folds
mpsfNtnMVDqQHTe92AhIdw collected $2 from pot
*** SUMMARY ***
Total pot $2 | Rake $0
Seat 1: 31HuO+DQxppUQEedBWukug folded before Flop (didn't bet)
Seat 2: GX1heJ+DSsvm7gzSPsYhhQ folded before Flop (didn't bet)
Seat 3: CUZwDpLTQKhzarPe+JCLOQ (button) folded before Flop (didn't bet)
Seat 4: /inIs/z/PcX+TniIFpaxpg (small blind) folded before Flop
Seat 5: mpsfNtnMVDqQHTe92AhIdw (big blind) collected ($2)
Seat 6: 2NvwF8W2nzsbS+G//yLAbQ folded before Flop (didn't bet)
Seat 8: MpL4DeEqGQu0H8TJEbEOrg folded before Flop (didn't bet)
Seat 9: F7m34OOfAQ7annesMHVjKw folded before Flop (didn't bet)



PokerStars Game #59941138456:  Hold'em No Limit ($1/$2) - 2009/07/01 1:26:44 ET
Table 'on4i1U1lCRmxsduFD3xiSg' 9-max Seat #1 is the button
Seat 1: so5k3vFDmokh2q3dImJ1GQ ($179.30 in chips)
Seat 2: NqSvZNzJ4RkR3sCmgQnyLw ($40.45 in chips)
Seat 3: GX1heJ+DSsvm7gzSPsYhhQ ($35 in chips)
Seat 4: DFQVuszLVclqjA46pN4Vvw ($27.85 in chips)
Seat 5: 37j/5DgMG5m9lMfFofEAOg ($89.35 in chips)
Seat 7: /inIs/z/PcX+TniIFpaxpg ($302.40 in chips)
Seat 9: iMe5yhc+1BaiIPHet3NMrA ($200 in chips)
NqSvZNzJ4RkR3sCmgQnyLw: posts small blind $1
GX1heJ+DSsvm7gzSPsYhhQ: posts big blind $2
+T/63sAeZzWyHchahJ36GQ: sits out
ZYHoLw2lWmRS7CSHi8L8Xg: sits out
*** HOLE CARDS ***
DFQVuszLVclqjA46pN4Vvw: folds
37j/5DgMG5m9lMfFofEAOg: calls $2
/inIs/z/PcX+TniIFpaxpg: folds
iMe5yhc+1BaiIPHet3NMrA: folds
so5k3vFDmokh2q3dImJ1GQ: folds
NqSvZNzJ4RkR3sCmgQnyLw: calls $1
GX1heJ+DSsvm7gzSPsYhhQ: checks
*** FLOP *** [9h 6h Ts]
NqSvZNzJ4RkR3sCmgQnyLw: checks
GX1heJ+DSsvm7gzSPsYhhQ: bets $4
37j/5DgMG5m9lMfFofEAOg: folds
NqSvZNzJ4RkR3sCmgQnyLw: folds
GX1heJ+DSsvm7gzSPsYhhQ collected $5.70 from pot
*** SUMMARY ***
Total pot $6 | Rake $0.30
Board [9h 6h Ts]
Seat 1: so5k3vFDmokh2q3dImJ1GQ (button) folded before Flop (didn't bet)
Seat 2: NqSvZNzJ4RkR3sCmgQnyLw (small blind) folded on the Flop
Seat 3: GX1heJ+DSsvm7gzSPsYhhQ (big blind) collected ($5.70)
Seat 4: DFQVuszLVclqjA46pN4Vvw folded before Flop (didn't bet)
Seat 5: 37j/5DgMG5m9lMfFofEAOg folded on the Flop
Seat 7: /inIs/z/PcX+TniIFpaxpg folded before Flop (didn't bet)
Seat 9: iMe5yhc+1BaiIPHet3NMrA folded before Flop (didn't bet)



PokerStars Game #59941139094:  Hold'em No Limit ($1/$2) - 2009/07/01 1:26:45 ET
Table 'AtOXMvcrtQM8yLNcALmfLQ' 2-max Seat #1 is the button
Seat 1: +HlQuAsMqZGYYtjcPO/a3A ($141.40 in chips)
Seat 2: pVqEzK9wXlRMECnb1Zg4Zw ($253.80 in chips)
+HlQuAsMqZGYYtjcPO/a3A: posts small blind $1
pVqEzK9wXlRMECnb1Zg4Zw: posts big blind $2
*** HOLE CARDS ***
+HlQuAsMqZGYYtjcPO/a3A: folds
pVqEzK9wXlRMECnb1Zg4Zw collected $2 from pot
pVqEzK9wXlRMECnb1Zg4Zw: doesn't show hand
*** SUMMARY ***
Total pot $2 | Rake $0
Seat 1: +HlQuAsMqZGYYtjcPO/a3A (button) (small blind) folded before Flop
Seat 2: pVqEzK9wXlRMECnb1Zg4Zw (big blind) collected ($2)



PokerStars Game #59941138934:  Hold'em No Limit ($1/$2) - 2009/07/01 1:26:45 ET
Table 'CFkQcfWjKccZaZDf71FK+w' 6-max Seat #1 is the button
Seat 1: JsC+WvfzqlxVs9G8/gSQAQ ($24.05 in chips)
Seat 2: ewN/vzF22+/gdzjIKBOlkA ($221.80 in chips)
Seat 3: 09BNF4quPDzanQzM8vc6WA ($48.45 in chips)
Seat 4: ygTTt5ehT4aF86q1a8/R+w ($192.75 in chips)
Seat 5: 2lOU1DcvUZaMcxZ95XfzXw ($123 in chips)
Seat 6: ORVqY3rf9X6ANA/8s+On2Q ($75.50 in chips)
ewN/vzF22+/gdzjIKBOlkA: posts small blind $1
09BNF4quPDzanQzM8vc6WA: posts big blind $2
*** HOLE CARDS ***
ygTTt5ehT4aF86q1a8/R+w: raises $4 to $6
2lOU1DcvUZaMcxZ95XfzXw: folds
ORVqY3rf9X6ANA/8s+On2Q: calls $6
JsC+WvfzqlxVs9G8/gSQAQ: calls $6
ewN/vzF22+/gdzjIKBOlkA: calls $5
09BNF4quPDzanQzM8vc6WA: folds
*** FLOP *** [Qd 7s 6s]
ewN/vzF22+/gdzjIKBOlkA: checks
ygTTt5ehT4aF86q1a8/R+w: checks
ORVqY3rf9X6ANA/8s+On2Q: bets $8
JsC+WvfzqlxVs9G8/gSQAQ: folds
ewN/vzF22+/gdzjIKBOlkA: calls $8
ygTTt5ehT4aF86q1a8/R+w: raises $24 to $32
ORVqY3rf9X6ANA/8s+On2Q: calls $24
ewN/vzF22+/gdzjIKBOlkA: folds
*** TURN *** [Qd 7s 6s] [7h]
ygTTt5ehT4aF86q1a8/R+w: bets $46
ORVqY3rf9X6ANA/8s+On2Q: calls $37.50 and is all-in
*** RIVER *** [Qd 7s 6s 7h] [8h]
*** SHOW DOWN ***
ygTTt5ehT4aF86q1a8/R+w: shows [Ah Qc] (two pair, Queens and Sevens)
ORVqY3rf9X6ANA/8s+On2Q: mucks hand
ygTTt5ehT4aF86q1a8/R+w collected $170 from pot
*** SUMMARY ***
Total pot $173 | Rake $3
Board [Qd 7s 6s 7h 8h]
Seat 1: JsC+WvfzqlxVs9G8/gSQAQ (button) folded on the Flop
Seat 2: ewN/vzF22+/gdzjIKBOlkA (small blind) folded on the Flop
Seat 3: 09BNF4quPDzanQzM8vc6WA (big blind) folded before Flop
Seat 4: ygTTt5ehT4aF86q1a8/R+w showed [Ah Qc] and won ($170) with two pair, Queens and Sevens
Seat 5: 2lOU1DcvUZaMcxZ95XfzXw folded before Flop (didn't bet)
Seat 6: ORVqY3rf9X6ANA/8s+On2Q mucked



PokerStars Game #59941138846:  Hold'em No Limit ($1/$2) - 2009/07/01 1:26:45 ET
Table 'qVXak+oTeDXMGbWa4sDU5Q' 9-max Seat #5 is the button
Seat 1: H6Z4+qu8gR0VUiPOijndVg ($212.55 in chips)
Seat 2: rW/MyplHylMSBRaoRUzWrg ($74 in chips)
Seat 3: WUlHm+ydPPHG7Lb0rePSdA ($150.65 in chips)
Seat 4: lQYT23h5QCUVZAKxjOO39Q ($111.45 in chips)
Seat 5: FWGiDqRwvLeKmHq9t4Jy9w ($265.80 in chips)
Seat 6: GX1heJ+DSsvm7gzSPsYhhQ ($35 in chips)
Seat 7: PfmlvZlFiss79a6IoEr11g ($166.30 in chips)
Seat 8: Z0rzUi0y1x80UdIpofoNbA ($126.55 in chips)
Seat 9: CkE3IyJF1KvdaAOmZY5XqQ ($200 in chips)
GX1heJ+DSsvm7gzSPsYhhQ: posts small blind $1
PfmlvZlFiss79a6IoEr11g: posts big blind $2
*** HOLE CARDS ***
Z0rzUi0y1x80UdIpofoNbA: folds
CkE3IyJF1KvdaAOmZY5XqQ: folds
H6Z4+qu8gR0VUiPOijndVg: folds
rW/MyplHylMSBRaoRUzWrg: folds
WUlHm+ydPPHG7Lb0rePSdA: raises $4 to $6
lQYT23h5QCUVZAKxjOO39Q: folds
FWGiDqRwvLeKmHq9t4Jy9w: folds
GX1heJ+DSsvm7gzSPsYhhQ: folds
PfmlvZlFiss79a6IoEr11g: folds
WUlHm+ydPPHG7Lb0rePSdA collected $5 from pot
WUlHm+ydPPHG7Lb0rePSdA: doesn't show hand
*** SUMMARY ***
Total pot $5 | Rake $0
Seat 1: H6Z4+qu8gR0VUiPOijndVg folded before Flop (didn't bet)
Seat 2: rW/MyplHylMSBRaoRUzWrg folded before Flop (didn't bet)
Seat 3: WUlHm+ydPPHG7Lb0rePSdA collected ($5)
Seat 4: lQYT23h5QCUVZAKxjOO39Q folded before Flop (didn't bet)
Seat 5: FWGiDqRwvLeKmHq9t4Jy9w (button) folded before Flop (didn't bet)
Seat 6: GX1heJ+DSsvm7gzSPsYhhQ (small blind) folded before Flop
Seat 7: PfmlvZlFiss79a6IoEr11g (big blind) folded before Flop
Seat 8: Z0rzUi0y1x80UdIpofoNbA folded before Flop (didn't bet)
Seat 9: CkE3IyJF1KvdaAOmZY5XqQ folded before Flop (didn't bet)



PokerStars Game #59941139634:  Hold'em No Limit ($1/$2) - 2009/07/01 1:26:46 ET
Table '/dyk+YdRGv90j2box35j8w' 6-max Seat #3 is the button
Seat 1: 8srN1dKQePlsv0GyTada+Q ($203 in chips)
Seat 2: qCnEYuAE5y5A7bk6fO5/jQ ($476.60 in chips)
Seat 3: sTPOWERd9HWPCNrDBwsVjA ($185.75 in chips)
Seat 4: z/u1YTnkiIDrtp/2cA2dBg ($203.05 in chips)
Seat 5: VvdR9F3I+2yELkfTVvC1dg ($200 in chips)
z/u1YTnkiIDrtp/2cA2dBg: posts small blind $1
VvdR9F3I+2yELkfTVvC1dg: posts big blind $2
*** HOLE CARDS ***
8srN1dKQePlsv0GyTada+Q: folds
qCnEYuAE5y5A7bk6fO5/jQ: folds
sTPOWERd9HWPCNrDBwsVjA: calls $2
z/u1YTnkiIDrtp/2cA2dBg: folds
VvdR9F3I+2yELkfTVvC1dg: checks
*** FLOP *** [4h 3s Ks]
VvdR9F3I+2yELkfTVvC1dg: checks
sTPOWERd9HWPCNrDBwsVjA: bets $4
VvdR9F3I+2yELkfTVvC1dg: folds
sTPOWERd9HWPCNrDBwsVjA collected $4.75 from pot
sTPOWERd9HWPCNrDBwsVjA is sitting out
*** SUMMARY ***
Total pot $5 | Rake $0.25
Board [4h 3s Ks]
Seat 1: 8srN1dKQePlsv0GyTada+Q folded before Flop (didn't bet)
Seat 2: qCnEYuAE5y5A7bk6fO5/jQ folded before Flop (didn't bet)
Seat 3: sTPOWERd9HWPCNrDBwsVjA (button) collected ($4.75)
Seat 4: z/u1YTnkiIDrtp/2cA2dBg (small blind) folded before Flop
Seat 5: VvdR9F3I+2yELkfTVvC1dg (big blind) folded on the Flop



PokerStars Game #59941139926:  Hold'em No Limit ($1/$2) - 2009/07/01 1:26:47 ET
Table 'eyAQSIlgc2o1Jxvbve4WGg' 9-max Seat #4 is the button
Seat 1: UZEsV9yKUMqmpYPiOFpaZw ($105.20 in chips)
Seat 2: g7gL2NLJCdZPPV399WKT1w ($76.25 in chips)
Seat 3: ice1Sbe19zWIaKYoSmE5tw ($98.30 in chips)
Seat 4: CkE3IyJF1KvdaAOmZY5XqQ ($200 in chips)
Seat 5: mIKx5lhIt13X5eZQH0ZeMA ($78.80 in chips)
Seat 6: nXDI8Y/S6POzRwANu3d8hQ ($40 in chips)
Seat 8: 1CtiZuXDFaJL1dJPQKyi8Q ($158.35 in chips)
Seat 9: WUlHm+ydPPHG7Lb0rePSdA ($120.70 in chips)
mIKx5lhIt13X5eZQH0ZeMA: posts small blind $1
nXDI8Y/S6POzRwANu3d8hQ: posts big blind $2
*** HOLE CARDS ***
1CtiZuXDFaJL1dJPQKyi8Q: folds
WUlHm+ydPPHG7Lb0rePSdA: raises $4 to $6
UZEsV9yKUMqmpYPiOFpaZw: folds
g7gL2NLJCdZPPV399WKT1w: calls $6
ice1Sbe19zWIaKYoSmE5tw: folds
QHxJjpVYwitg9krW6wZgJA leaves the table
CkE3IyJF1KvdaAOmZY5XqQ: folds
mIKx5lhIt13X5eZQH0ZeMA: folds
u3OrI5uGx9mx1fE7dgr+EA joins the table at seat #7
nXDI8Y/S6POzRwANu3d8hQ: folds
*** FLOP *** [8s 3s Kc]
WUlHm+ydPPHG7Lb0rePSdA: bets $10
g7gL2NLJCdZPPV399WKT1w: folds
WUlHm+ydPPHG7Lb0rePSdA collected $14.25 from pot
WUlHm+ydPPHG7Lb0rePSdA: doesn't show hand
*** SUMMARY ***
Total pot $15 | Rake $0.75
Board [8s 3s Kc]
Seat 1: UZEsV9yKUMqmpYPiOFpaZw folded before Flop (didn't bet)
Seat 2: g7gL2NLJCdZPPV399WKT1w folded on the Flop
Seat 3: ice1Sbe19zWIaKYoSmE5tw folded before Flop (didn't bet)
Seat 4: CkE3IyJF1KvdaAOmZY5XqQ (button) folded before Flop (didn't bet)
Seat 5: mIKx5lhIt13X5eZQH0ZeMA (small blind) folded before Flop
Seat 6: nXDI8Y/S6POzRwANu3d8hQ (big blind) folded before Flop
Seat 8: 1CtiZuXDFaJL1dJPQKyi8Q folded before Flop (didn't bet)
Seat 9: WUlHm+ydPPHG7Lb0rePSdA collected ($14.25)



PokerStars Game #59941140050:  Hold'em No Limit ($1/$2) - 2009/07/01 1:26:47 ET
Table 'ztv6V3FN2bQ9nmJPPdx6nQ' 6-max Seat #3 is the button
Seat 1: 6fLdOUCRtX71xbVRhJEq8w ($205 in chips)
Seat 2: 5Y+ZGWLI4gnlpApDX5vy1A ($407.75 in chips)
Seat 3: ubtx4Z5L+AcK71MTvYiGVw ($245 in chips)
Seat 4: UaZ5yj+6LjtWqMQg2QskUw ($116.30 in chips)
Seat 5: sTPOWERd9HWPCNrDBwsVjA ($213.75 in chips)
Seat 6: mfy7uGZcqA2PVQqEVbJ7+g ($117.45 in chips)
UaZ5yj+6LjtWqMQg2QskUw: posts small blind $1
sTPOWERd9HWPCNrDBwsVjA: posts big blind $2
*** HOLE CARDS ***
mfy7uGZcqA2PVQqEVbJ7+g: folds
6fLdOUCRtX71xbVRhJEq8w: folds
5Y+ZGWLI4gnlpApDX5vy1A: folds
ubtx4Z5L+AcK71MTvYiGVw: folds
UaZ5yj+6LjtWqMQg2QskUw: calls $1
sTPOWERd9HWPCNrDBwsVjA: checks
*** FLOP *** [8s 7h Qc]
UaZ5yj+6LjtWqMQg2QskUw: bets $2
sTPOWERd9HWPCNrDBwsVjA: calls $2
*** TURN *** [8s 7h Qc] [5s]
UaZ5yj+6LjtWqMQg2QskUw: bets $6
sTPOWERd9HWPCNrDBwsVjA: raises $18 to $24
UaZ5yj+6LjtWqMQg2QskUw: folds
sTPOWERd9HWPCNrDBwsVjA collected $19.05 from pot
sTPOWERd9HWPCNrDBwsVjA is sitting out
*** SUMMARY ***
Total pot $20 | Rake $0.95
Board [8s 7h Qc 5s]
Seat 1: 6fLdOUCRtX71xbVRhJEq8w folded before Flop (didn't bet)
Seat 2: 5Y+ZGWLI4gnlpApDX5vy1A folded before Flop (didn't bet)
Seat 3: ubtx4Z5L+AcK71MTvYiGVw (button) folded before Flop (didn't bet)
Seat 4: UaZ5yj+6LjtWqMQg2QskUw (small blind) folded on the Turn
Seat 5: sTPOWERd9HWPCNrDBwsVjA (big blind) collected ($19.05)
Seat 6: mfy7uGZcqA2PVQqEVbJ7+g folded before Flop (didn't bet)



PokerStars Game #59941140912:  Hold'em No Limit ($1/$2) - 2009/07/01 1:26:48 ET
Table 'QxerF7GUfCbl+4a8XaTB2w' 6-max Seat #1 is the button
Seat 1: 54yWzRRgS0oZ+S6LwZBxMQ ($34 in chips)
Seat 2: HiWSAXs6/0w9Jy7ioiiShQ ($37 in chips)
Seat 3: m7mYVfnCOK5TE/VkN/FhOg ($278.10 in chips)
Seat 4: 09BNF4quPDzanQzM8vc6WA ($41.55 in chips)
Seat 5: gnYme0DNFflnMhrdbxe1Ag ($244.70 in chips)
Seat 6: VvdR9F3I+2yELkfTVvC1dg ($200 in chips)
HiWSAXs6/0w9Jy7ioiiShQ: posts small blind $1
m7mYVfnCOK5TE/VkN/FhOg: posts big blind $2
*** HOLE CARDS ***
09BNF4quPDzanQzM8vc6WA: folds
gnYme0DNFflnMhrdbxe1Ag: folds
VvdR9F3I+2yELkfTVvC1dg: folds
54yWzRRgS0oZ+S6LwZBxMQ: calls $2
HiWSAXs6/0w9Jy7ioiiShQ: calls $1
m7mYVfnCOK5TE/VkN/FhOg: raises $10 to $12
54yWzRRgS0oZ+S6LwZBxMQ: folds
HiWSAXs6/0w9Jy7ioiiShQ: folds
m7mYVfnCOK5TE/VkN/FhOg collected $6 from pot
m7mYVfnCOK5TE/VkN/FhOg: doesn't show hand
*** SUMMARY ***
Total pot $6 | Rake $0
Seat 1: 54yWzRRgS0oZ+S6LwZBxMQ (button) folded before Flop
Seat 2: HiWSAXs6/0w9Jy7ioiiShQ (small blind) folded before Flop
Seat 3: m7mYVfnCOK5TE/VkN/FhOg (big blind) collected ($6)
Seat 4: 09BNF4quPDzanQzM8vc6WA folded before Flop (didn't bet)
Seat 5: gnYme0DNFflnMhrdbxe1Ag folded before Flop (didn't bet)
Seat 6: VvdR9F3I+2yELkfTVvC1dg folded before Flop (didn't bet)



PokerStars Game #59941141692:  Hold'em No Limit ($1/$2) - 2009/07/01 1:26:50 ET
Table 'LL4bDFyhj5hsMpzaDugJZg' 6-max Seat #3 is the button
Seat 1: FwvID/fQGlpY3soi/lMTww ($84.50 in chips)
Seat 3: iI/NMpRxMkGieArQEhACSA ($537.50 in chips)
Seat 4: 8srN1dKQePlsv0GyTada+Q ($200 in chips)
Seat 5: A2GTwTiwkb1ilNWgW487Vg ($122.80 in chips)
Seat 6: 692Q4sfB0gTElzS0WMeg+A ($215.10 in chips)
8srN1dKQePlsv0GyTada+Q: posts small blind $1
A2GTwTiwkb1ilNWgW487Vg: posts big blind $2
*** HOLE CARDS ***
iI/NMpRxMkGieArQEhACSA said, "dont play with me"
692Q4sfB0gTElzS0WMeg+A: folds
FwvID/fQGlpY3soi/lMTww: folds
8srN1dKQePlsv0GyTada+Q said, "nh"
iI/NMpRxMkGieArQEhACSA said, "marcin i learn from you my man"
iI/NMpRxMkGieArQEhACSA said, "thanks"
iI/NMpRxMkGieArQEhACSA: folds
8srN1dKQePlsv0GyTada+Q: calls $1
A2GTwTiwkb1ilNWgW487Vg: checks
*** FLOP *** [9c 5c Qd]
8srN1dKQePlsv0GyTada+Q: bets $2
A2GTwTiwkb1ilNWgW487Vg: folds
8srN1dKQePlsv0GyTada+Q collected $3.80 from pot
*** SUMMARY ***
Total pot $4 | Rake $0.20
Board [9c 5c Qd]
Seat 1: FwvID/fQGlpY3soi/lMTww folded before Flop (didn't bet)
Seat 3: iI/NMpRxMkGieArQEhACSA (button) folded before Flop (didn't bet)
Seat 4: 8srN1dKQePlsv0GyTada+Q (small blind) collected ($3.80)
Seat 5: A2GTwTiwkb1ilNWgW487Vg (big blind) folded on the Flop
Seat 6: 692Q4sfB0gTElzS0WMeg+A folded before Flop (didn't bet)



PokerStars Game #59941141658:  Hold'em No Limit ($1/$2) - 2009/07/01 1:26:50 ET
Table '4NGNnZ/osQfNq6abYqkJeA' 6-max Seat #4 is the button
Seat 1: vkfxu8f/jMYKUk6Ly4eujw ($200 in chips)
Seat 2: 669iGNwYwgRZg3nhS+aDAQ ($93.15 in chips)
Seat 3: 54yWzRRgS0oZ+S6LwZBxMQ ($20.75 in chips)
Seat 4: sY+4Uuh5z/6AbXXaCS10jw ($211.35 in chips)
Seat 5: VvdR9F3I+2yELkfTVvC1dg ($235.80 in chips)
VvdR9F3I+2yELkfTVvC1dg: posts small blind $1
kkgpegLoQkmL6LIsFsvtiQ: is sitting out
vkfxu8f/jMYKUk6Ly4eujw: posts big blind $2
*** HOLE CARDS ***
669iGNwYwgRZg3nhS+aDAQ: folds
kkgpegLoQkmL6LIsFsvtiQ leaves the table
54yWzRRgS0oZ+S6LwZBxMQ has timed out
54yWzRRgS0oZ+S6LwZBxMQ: folds
54yWzRRgS0oZ+S6LwZBxMQ is sitting out
54yWzRRgS0oZ+S6LwZBxMQ has returned
3cPMpDMgeOMAe4UceUfLsg joins the table at seat #6
sY+4Uuh5z/6AbXXaCS10jw: raises $4 to $6
VvdR9F3I+2yELkfTVvC1dg: folds
vkfxu8f/jMYKUk6Ly4eujw: folds
sY+4Uuh5z/6AbXXaCS10jw collected $5 from pot
*** SUMMARY ***
Total pot $5 | Rake $0
Seat 1: vkfxu8f/jMYKUk6Ly4eujw (big blind) folded before Flop
Seat 2: 669iGNwYwgRZg3nhS+aDAQ folded before Flop (didn't bet)
Seat 3: 54yWzRRgS0oZ+S6LwZBxMQ folded before Flop (didn't bet)
Seat 4: sY+4Uuh5z/6AbXXaCS10jw (button) collected ($5)
Seat 5: VvdR9F3I+2yELkfTVvC1dg (small blind) folded before Flop



PokerStars Game #59941143086:  Hold'em No Limit ($1/$2) - 2009/07/01 1:26:52 ET
Table 'AtOXMvcrtQM8yLNcALmfLQ' 2-max Seat #2 is the button
Seat 1: +HlQuAsMqZGYYtjcPO/a3A ($140.40 in chips)
Seat 2: pVqEzK9wXlRMECnb1Zg4Zw ($254.80 in chips)
pVqEzK9wXlRMECnb1Zg4Zw: posts small blind $1
+HlQuAsMqZGYYtjcPO/a3A: posts big blind $2
*** HOLE CARDS ***
pVqEzK9wXlRMECnb1Zg4Zw: raises $6 to $8
+HlQuAsMqZGYYtjcPO/a3A: raises $14 to $22
pVqEzK9wXlRMECnb1Zg4Zw: calls $14
*** FLOP *** [Qh Th 5s]
+HlQuAsMqZGYYtjcPO/a3A: bets $16
pVqEzK9wXlRMECnb1Zg4Zw: calls $16
*** TURN *** [Qh Th 5s] [5d]
+HlQuAsMqZGYYtjcPO/a3A: bets $52
pVqEzK9wXlRMECnb1Zg4Zw: raises $52 to $104
+HlQuAsMqZGYYtjcPO/a3A: calls $50.40 and is all-in
*** RIVER *** [Qh Th 5s 5d] [7d]
*** SHOW DOWN ***
+HlQuAsMqZGYYtjcPO/a3A: shows [Qd 9h] (two pair, Queens and Fives)
pVqEzK9wXlRMECnb1Zg4Zw: mucks hand
+HlQuAsMqZGYYtjcPO/a3A collected $280.30 from pot
*** SUMMARY ***
Total pot $280.80 | Rake $0.50
Board [Qh Th 5s 5d 7d]
Seat 1: +HlQuAsMqZGYYtjcPO/a3A (big blind) showed [Qd 9h] and won ($280.30) with two pair, Queens and Fives
Seat 2: pVqEzK9wXlRMECnb1Zg4Zw (button) (small blind) mucked



PokerStars Game #59941145030:  Hold'em No Limit ($1/$2) - 2009/07/01 1:26:55 ET
Table 'mGpP9StWRnoeiBDExc6Frg' 6-max Seat #3 is the button
Seat 1: VvdR9F3I+2yELkfTVvC1dg ($282.15 in chips)
Seat 3: 7acrZUQC3Zc9BNLjoKIcLQ ($34.35 in chips)
Seat 4: 4dcDwIHRm96PwtqkpQiuiA ($83.70 in chips)
Seat 5: d1puGuVBE0fidn+5eRJ0tw ($179.95 in chips)
Seat 6: B2Ih1sr5VZk+8He7rcrMtQ ($464.05 in chips)
4dcDwIHRm96PwtqkpQiuiA: posts small blind $1
d1puGuVBE0fidn+5eRJ0tw: posts big blind $2
*** HOLE CARDS ***
dZcLsEI8iXkobBduRJ45Yw leaves the table
B2Ih1sr5VZk+8He7rcrMtQ: raises $4 to $6
VvdR9F3I+2yELkfTVvC1dg: folds
7acrZUQC3Zc9BNLjoKIcLQ: folds
4dcDwIHRm96PwtqkpQiuiA: folds
d1puGuVBE0fidn+5eRJ0tw: folds
B2Ih1sr5VZk+8He7rcrMtQ collected $5 from pot
B2Ih1sr5VZk+8He7rcrMtQ: doesn't show hand
*** SUMMARY ***
Total pot $5 | Rake $0
Seat 1: VvdR9F3I+2yELkfTVvC1dg folded before Flop (didn't bet)
Seat 3: 7acrZUQC3Zc9BNLjoKIcLQ (button) folded before Flop (didn't bet)
Seat 4: 4dcDwIHRm96PwtqkpQiuiA (small blind) folded before Flop
Seat 5: d1puGuVBE0fidn+5eRJ0tw (big blind) folded before Flop
Seat 6: B2Ih1sr5VZk+8He7rcrMtQ collected ($5)



PokerStars Game #59941144976:  Hold'em No Limit ($1/$2) - 2009/07/01 1:26:55 ET
Table 'gnHBqWll9O3fxG7Ojkz/ng' 9-max Seat #1 is the button
Seat 1: TAfo4veNRaRlzDXMMYS3Jg ($34 in chips)
Seat 2: H6Z4+qu8gR0VUiPOijndVg ($325.25 in chips)
Seat 3: 5Q8U6iZbeO7xJSS4qvDP5g ($215 in chips)
Seat 5: rBQDMkKm9cZn6M9NPsiVew ($226.45 in chips)
Seat 6: /inIs/z/PcX+TniIFpaxpg ($68.10 in chips)
Seat 7: jqui3xAWCkcdPW36a6BD+w ($344.95 in chips)
Seat 8: cM6efHzdxoqYm0EQKP4TTQ ($88.05 in chips)
Seat 9: GX1heJ+DSsvm7gzSPsYhhQ ($54.35 in chips)
H6Z4+qu8gR0VUiPOijndVg: posts small blind $1
5Q8U6iZbeO7xJSS4qvDP5g: posts big blind $2
nXDI8Y/S6POzRwANu3d8hQ: sits out
*** HOLE CARDS ***
rBQDMkKm9cZn6M9NPsiVew: folds
/inIs/z/PcX+TniIFpaxpg: folds
jqui3xAWCkcdPW36a6BD+w: folds
cM6efHzdxoqYm0EQKP4TTQ: calls $2
GX1heJ+DSsvm7gzSPsYhhQ: folds
TAfo4veNRaRlzDXMMYS3Jg: folds
H6Z4+qu8gR0VUiPOijndVg: folds
5Q8U6iZbeO7xJSS4qvDP5g: checks
*** FLOP *** [Qd 9c 7h]
5Q8U6iZbeO7xJSS4qvDP5g: bets $4
cM6efHzdxoqYm0EQKP4TTQ: calls $4
*** TURN *** [Qd 9c 7h] [Ac]
5Q8U6iZbeO7xJSS4qvDP5g: checks
cM6efHzdxoqYm0EQKP4TTQ: bets $10
5Q8U6iZbeO7xJSS4qvDP5g: folds
cM6efHzdxoqYm0EQKP4TTQ collected $12.40 from pot
cM6efHzdxoqYm0EQKP4TTQ: doesn't show hand
*** SUMMARY ***
Total pot $13 | Rake $0.60
Board [Qd 9c 7h Ac]
Seat 1: TAfo4veNRaRlzDXMMYS3Jg (button) folded before Flop (didn't bet)
Seat 2: H6Z4+qu8gR0VUiPOijndVg (small blind) folded before Flop
Seat 3: 5Q8U6iZbeO7xJSS4qvDP5g (big blind) folded on the Turn
Seat 5: rBQDMkKm9cZn6M9NPsiVew folded before Flop (didn't bet)
Seat 6: /inIs/z/PcX+TniIFpaxpg folded before Flop (didn't bet)
Seat 7: jqui3xAWCkcdPW36a6BD+w folded before Flop (didn't bet)
Seat 8: cM6efHzdxoqYm0EQKP4TTQ collected ($12.40)
Seat 9: GX1heJ+DSsvm7gzSPsYhhQ folded before Flop (didn't bet)



PokerStars Game #59941144826:  Hold'em No Limit ($1/$2) - 2009/07/01 1:26:55 ET
Table 'YqGfR5eHfMeSjb9a+QU9rg' 9-max Seat #7 is the button
Seat 1: rW/MyplHylMSBRaoRUzWrg ($34 in chips)
Seat 2: W3Nqt1GWlTi9tXQXMNEvgw ($386.25 in chips)
Seat 3: /gll27k+xWYV7Fbki0lFDQ ($261.75 in chips)
Seat 5: CkE3IyJF1KvdaAOmZY5XqQ ($200 in chips)
Seat 6: TAfo4veNRaRlzDXMMYS3Jg ($37 in chips)
Seat 7: 41aZuLBz9nAi2GPVKabmCw ($107.45 in chips)
Seat 8: JnV3SM2D6dAFYyGZHHpvrg ($93.25 in chips)
Seat 9: /inIs/z/PcX+TniIFpaxpg ($208.20 in chips)
JnV3SM2D6dAFYyGZHHpvrg: posts small blind $1
/inIs/z/PcX+TniIFpaxpg: posts big blind $2
*** HOLE CARDS ***
rW/MyplHylMSBRaoRUzWrg: folds
W3Nqt1GWlTi9tXQXMNEvgw: folds
QHxJjpVYwitg9krW6wZgJA leaves the table
/gll27k+xWYV7Fbki0lFDQ: folds
CkE3IyJF1KvdaAOmZY5XqQ: folds
TAfo4veNRaRlzDXMMYS3Jg: folds
41aZuLBz9nAi2GPVKabmCw: folds
JnV3SM2D6dAFYyGZHHpvrg: raises $6 to $8
/inIs/z/PcX+TniIFpaxpg: folds
JnV3SM2D6dAFYyGZHHpvrg collected $4 from pot
*** SUMMARY ***
Total pot $4 | Rake $0
Seat 1: rW/MyplHylMSBRaoRUzWrg folded before Flop (didn't bet)
Seat 2: W3Nqt1GWlTi9tXQXMNEvgw folded before Flop (didn't bet)
Seat 3: /gll27k+xWYV7Fbki0lFDQ folded before Flop (didn't bet)
Seat 5: CkE3IyJF1KvdaAOmZY5XqQ folded before Flop (didn't bet)
Seat 6: TAfo4veNRaRlzDXMMYS3Jg folded before Flop (didn't bet)
Seat 7: 41aZuLBz9nAi2GPVKabmCw (button) folded before Flop (didn't bet)
Seat 8: JnV3SM2D6dAFYyGZHHpvrg (small blind) collected ($4)
Seat 9: /inIs/z/PcX+TniIFpaxpg (big blind) folded before Flop



PokerStars Game #59941144834:  Hold'em No Limit ($1/$2) - 2009/07/01 1:26:55 ET
Table 'uJ9juaXXg9yIcSU8amxaXQ' 6-max Seat #2 is the button
Seat 1: JsqOjN/eHz0uYVf/PyUJ6Q ($148.50 in chips)
Seat 2: VvdR9F3I+2yELkfTVvC1dg ($200 in chips)
Seat 3: qXDd0ZyMIse0OBu8pxeQ3Q ($245 in chips)
Seat 4: zNjJ/y4emmF+vzrCDd+ooA ($230.60 in chips)
Seat 5: YsLQ3BAvgQHWXMAv3Wv6Hg ($200 in chips)
Seat 6: 2DFp9Veq1xxq64dCjwNuUw ($59.60 in chips)
qXDd0ZyMIse0OBu8pxeQ3Q: posts small blind $1
zNjJ/y4emmF+vzrCDd+ooA: posts big blind $2
*** HOLE CARDS ***
YsLQ3BAvgQHWXMAv3Wv6Hg: folds
2DFp9Veq1xxq64dCjwNuUw: folds
JsqOjN/eHz0uYVf/PyUJ6Q: calls $2
VvdR9F3I+2yELkfTVvC1dg: folds
qXDd0ZyMIse0OBu8pxeQ3Q: folds
zNjJ/y4emmF+vzrCDd+ooA: checks
*** FLOP *** [6s Tc Kc]
zNjJ/y4emmF+vzrCDd+ooA: bets $4
JsqOjN/eHz0uYVf/PyUJ6Q: folds
zNjJ/y4emmF+vzrCDd+ooA collected $4.75 from pot
*** SUMMARY ***
Total pot $5 | Rake $0.25
Board [6s Tc Kc]
Seat 1: JsqOjN/eHz0uYVf/PyUJ6Q folded on the Flop
Seat 2: VvdR9F3I+2yELkfTVvC1dg (button) folded before Flop (didn't bet)
Seat 3: qXDd0ZyMIse0OBu8pxeQ3Q (small blind) folded before Flop
Seat 4: zNjJ/y4emmF+vzrCDd+ooA (big blind) collected ($4.75)
Seat 5: YsLQ3BAvgQHWXMAv3Wv6Hg folded before Flop (didn't bet)
Seat 6: 2DFp9Veq1xxq64dCjwNuUw folded before Flop (didn't bet)



PokerStars Game #59941144624:  Hold'em No Limit ($1/$2) - 2009/07/01 1:26:55 ET
Table 'pPQgcj9XT9CHBsbo1WTBug' 6-max Seat #4 is the button
Seat 1: DFVYDA6dKQy7R7mGIKogZA ($135.70 in chips)
Seat 2: qXDd0ZyMIse0OBu8pxeQ3Q ($208.30 in chips)
Seat 3: 54yWzRRgS0oZ+S6LwZBxMQ ($61.75 in chips)
Seat 4: gqlysXCbT8V54f/1lf9h3A ($36.10 in chips)
Seat 5: vkfxu8f/jMYKUk6Ly4eujw ($200.55 in chips)
Seat 6: Yr7pZltpy3IUNdKS9PCEiw ($304.30 in chips)
vkfxu8f/jMYKUk6Ly4eujw: posts small blind $1
Yr7pZltpy3IUNdKS9PCEiw: posts big blind $2
*** HOLE CARDS ***
DFVYDA6dKQy7R7mGIKogZA: calls $2
qXDd0ZyMIse0OBu8pxeQ3Q: raises $7 to $9
54yWzRRgS0oZ+S6LwZBxMQ: calls $9
gqlysXCbT8V54f/1lf9h3A: folds
vkfxu8f/jMYKUk6Ly4eujw: folds
Yr7pZltpy3IUNdKS9PCEiw: folds
DFVYDA6dKQy7R7mGIKogZA: calls $7
*** FLOP *** [Kd 2c 7c]
DFVYDA6dKQy7R7mGIKogZA: bets $10
qXDd0ZyMIse0OBu8pxeQ3Q: folds
54yWzRRgS0oZ+S6LwZBxMQ: folds
DFVYDA6dKQy7R7mGIKogZA collected $28.50 from pot
*** SUMMARY ***
Total pot $30 | Rake $1.50
Board [Kd 2c 7c]
Seat 1: DFVYDA6dKQy7R7mGIKogZA collected ($28.50)
Seat 2: qXDd0ZyMIse0OBu8pxeQ3Q folded on the Flop
Seat 3: 54yWzRRgS0oZ+S6LwZBxMQ folded on the Flop
Seat 4: gqlysXCbT8V54f/1lf9h3A (button) folded before Flop (didn't bet)
Seat 5: vkfxu8f/jMYKUk6Ly4eujw (small blind) folded before Flop
Seat 6: Yr7pZltpy3IUNdKS9PCEiw (big blind) folded before Flop



PokerStars Game #59941145144:  Hold'em No Limit ($1/$2) - 2009/07/01 1:26:56 ET
Table 'rsKRKlGHlxVyqJxzO2a2Ow' 9-max Seat #1 is the button
Seat 1: uYWfQJg2hgHLxri6/uVJiw ($387.65 in chips)
Seat 3: zTcFtoHqqK4550YMZ8Y14Q ($40.50 in chips)
Seat 4: 31HuO+DQxppUQEedBWukug ($114.85 in chips)
Seat 5: 5Q8U6iZbeO7xJSS4qvDP5g ($202 in chips)
Seat 6: H6Z4+qu8gR0VUiPOijndVg ($204.55 in chips)
Seat 7: GX1heJ+DSsvm7gzSPsYhhQ ($33 in chips)
Seat 8: CkE3IyJF1KvdaAOmZY5XqQ ($215.75 in chips)
Seat 9: gRbvhSUVg+TNaTjaJecIRw ($24 in chips)
zTcFtoHqqK4550YMZ8Y14Q: posts small blind $1
31HuO+DQxppUQEedBWukug: posts big blind $2
*** HOLE CARDS ***
5Q8U6iZbeO7xJSS4qvDP5g: folds
H6Z4+qu8gR0VUiPOijndVg: folds
GX1heJ+DSsvm7gzSPsYhhQ: folds
CkE3IyJF1KvdaAOmZY5XqQ: folds
gRbvhSUVg+TNaTjaJecIRw: folds
uYWfQJg2hgHLxri6/uVJiw: folds
zTcFtoHqqK4550YMZ8Y14Q: calls $1
31HuO+DQxppUQEedBWukug: checks
*** FLOP *** [2h 4s Kh]
zTcFtoHqqK4550YMZ8Y14Q: checks
31HuO+DQxppUQEedBWukug: checks
*** TURN *** [2h 4s Kh] [7s]
zTcFtoHqqK4550YMZ8Y14Q: bets $4
31HuO+DQxppUQEedBWukug: folds
zTcFtoHqqK4550YMZ8Y14Q collected $3.80 from pot
zTcFtoHqqK4550YMZ8Y14Q: doesn't show hand
*** SUMMARY ***
Total pot $4 | Rake $0.20
Board [2h 4s Kh 7s]
Seat 1: uYWfQJg2hgHLxri6/uVJiw (button) folded before Flop (didn't bet)
Seat 3: zTcFtoHqqK4550YMZ8Y14Q (small blind) collected ($3.80)
Seat 4: 31HuO+DQxppUQEedBWukug (big blind) folded on the Turn
Seat 5: 5Q8U6iZbeO7xJSS4qvDP5g folded before Flop (didn't bet)
Seat 6: H6Z4+qu8gR0VUiPOijndVg folded before Flop (didn't bet)
Seat 7: GX1heJ+DSsvm7gzSPsYhhQ folded before Flop (didn't bet)
Seat 8: CkE3IyJF1KvdaAOmZY5XqQ folded before Flop (didn't bet)
Seat 9: gRbvhSUVg+TNaTjaJecIRw folded before Flop (didn't bet)



PokerStars Game #59941147082:  Hold'em No Limit ($1/$2) - 2009/07/01 1:26:59 ET
Table '+hSnXFQrGw1PlVgTnuj+sA' 6-max Seat #3 is the button
Seat 1: 2ccIJhDj+3JapvS7swVZEg ($334 in chips)
Seat 3: fE+LHW/7rpfXW14g8LhGjA ($49.30 in chips)
Seat 4: J4iH5epwXbmODnojR/VRxA ($161.25 in chips)
Seat 5: VvdR9F3I+2yELkfTVvC1dg ($204.55 in chips)
Seat 6: AuiGltq875lmaKHBsjZVGg ($67.75 in chips)
J4iH5epwXbmODnojR/VRxA: posts small blind $1
VvdR9F3I+2yELkfTVvC1dg: posts big blind $2
54yWzRRgS0oZ+S6LwZBxMQ: sits out
*** HOLE CARDS ***
AuiGltq875lmaKHBsjZVGg: folds
2ccIJhDj+3JapvS7swVZEg: folds
fE+LHW/7rpfXW14g8LhGjA: folds
J4iH5epwXbmODnojR/VRxA: raises $2 to $4
fE+LHW/7rpfXW14g8LhGjA leaves the table
VvdR9F3I+2yELkfTVvC1dg: folds
J4iH5epwXbmODnojR/VRxA collected $4 from pot
*** SUMMARY ***
Total pot $4 | Rake $0
Seat 1: 2ccIJhDj+3JapvS7swVZEg folded before Flop (didn't bet)
Seat 3: fE+LHW/7rpfXW14g8LhGjA (button) folded before Flop (didn't bet)
Seat 4: J4iH5epwXbmODnojR/VRxA (small blind) collected ($4)
Seat 5: VvdR9F3I+2yELkfTVvC1dg (big blind) folded before Flop
Seat 6: AuiGltq875lmaKHBsjZVGg folded before Flop (didn't bet)



PokerStars Game #59941146946:  Hold'em No Limit ($1/$2) - 2009/07/01 1:26:59 ET
Table 'NmY84NAf9Mh0ckAckHnh5g' 2-max Seat #1 is the button
Seat 1: 6hvg964TSqZ3AL/0XK9aVQ ($251.10 in chips)
Seat 2: RwDoM55ZeQuI2ADyJhOb2Q ($751.40 in chips)
6hvg964TSqZ3AL/0XK9aVQ: posts small blind $1
RwDoM55ZeQuI2ADyJhOb2Q: posts big blind $2
*** HOLE CARDS ***
6hvg964TSqZ3AL/0XK9aVQ: folds
RwDoM55ZeQuI2ADyJhOb2Q collected $2 from pot
RwDoM55ZeQuI2ADyJhOb2Q: doesn't show hand
*** SUMMARY ***
Total pot $2 | Rake $0
Seat 1: 6hvg964TSqZ3AL/0XK9aVQ (button) (small blind) folded before Flop
Seat 2: RwDoM55ZeQuI2ADyJhOb2Q (big blind) collected ($2)



PokerStars Game #59941147566:  Hold'em No Limit ($1/$2) - 2009/07/01 1:27:00 ET
Table 'kq5zaQ+1hLNf8LZfGnbTAA' 6-max Seat #2 is the button
Seat 1: 8srN1dKQePlsv0GyTada+Q ($418 in chips)
Seat 2: nXDI8Y/S6POzRwANu3d8hQ ($197 in chips)
Seat 3: vkfxu8f/jMYKUk6Ly4eujw ($225.95 in chips)
Seat 4: 3dAbvkxS5NPQTBAbvpinVg ($200 in chips)
Seat 5: kfASJqTbXek+zc8ZKsZL1Q ($57.50 in chips)
Seat 6: mfy7uGZcqA2PVQqEVbJ7+g ($197.25 in chips)
vkfxu8f/jMYKUk6Ly4eujw: posts small blind $1
3dAbvkxS5NPQTBAbvpinVg: posts big blind $2
*** HOLE CARDS ***
kfASJqTbXek+zc8ZKsZL1Q: folds
mfy7uGZcqA2PVQqEVbJ7+g: folds
8srN1dKQePlsv0GyTada+Q: folds
nXDI8Y/S6POzRwANu3d8hQ: folds
vkfxu8f/jMYKUk6Ly4eujw: folds
3dAbvkxS5NPQTBAbvpinVg collected $2 from pot
3dAbvkxS5NPQTBAbvpinVg: doesn't show hand
*** SUMMARY ***
Total pot $2 | Rake $0
Seat 1: 8srN1dKQePlsv0GyTada+Q folded before Flop (didn't bet)
Seat 2: nXDI8Y/S6POzRwANu3d8hQ (button) folded before Flop (didn't bet)
Seat 3: vkfxu8f/jMYKUk6Ly4eujw (small blind) folded before Flop
Seat 4: 3dAbvkxS5NPQTBAbvpinVg (big blind) collected ($2)
Seat 5: kfASJqTbXek+zc8ZKsZL1Q folded before Flop (didn't bet)
Seat 6: mfy7uGZcqA2PVQqEVbJ7+g folded before Flop (didn't bet)



PokerStars Game #59941150630:  Hold'em No Limit ($1/$2) - 2009/07/01 1:27:05 ET
Table 'NmY84NAf9Mh0ckAckHnh5g' 2-max Seat #2 is the button
Seat 1: 6hvg964TSqZ3AL/0XK9aVQ ($250.10 in chips)
Seat 2: RwDoM55ZeQuI2ADyJhOb2Q ($752.40 in chips)
RwDoM55ZeQuI2ADyJhOb2Q: posts small blind $1
6hvg964TSqZ3AL/0XK9aVQ: posts big blind $2
*** HOLE CARDS ***
RwDoM55ZeQuI2ADyJhOb2Q: raises $4 to $6
6hvg964TSqZ3AL/0XK9aVQ: folds
RwDoM55ZeQuI2ADyJhOb2Q collected $4 from pot
RwDoM55ZeQuI2ADyJhOb2Q: doesn't show hand
*** SUMMARY ***
Total pot $4 | Rake $0
Seat 1: 6hvg964TSqZ3AL/0XK9aVQ (big blind) folded before Flop
Seat 2: RwDoM55ZeQuI2ADyJhOb2Q (button) (small blind) collected ($4)



PokerStars Game #59941151154:  Hold'em No Limit ($1/$2) - 2009/07/01 1:27:06 ET
Table 'aSf77Sj8QEnzcc0WaxVD4Q' 6-max Seat #3 is the button
Seat 1: UELtvp+JfwI7XDGVwSxZXA ($159.55 in chips)
Seat 2: vkfxu8f/jMYKUk6Ly4eujw ($206 in chips)
Seat 3: 9dpyyjDTCed6nV7JhaUUpw ($523.70 in chips)
Seat 4: YsLQ3BAvgQHWXMAv3Wv6Hg ($260.70 in chips)
Seat 5: VvdR9F3I+2yELkfTVvC1dg ($245 in chips)
Seat 6: vkoJRf3gidxY1pPi0AFWww ($121.55 in chips)
YsLQ3BAvgQHWXMAv3Wv6Hg: posts small blind $1
VvdR9F3I+2yELkfTVvC1dg: posts big blind $2
*** HOLE CARDS ***
vkoJRf3gidxY1pPi0AFWww: calls $2
UELtvp+JfwI7XDGVwSxZXA: folds
vkfxu8f/jMYKUk6Ly4eujw: folds
9dpyyjDTCed6nV7JhaUUpw: folds
YsLQ3BAvgQHWXMAv3Wv6Hg: folds
VvdR9F3I+2yELkfTVvC1dg: checks
*** FLOP *** [5s 9c Kc]
VvdR9F3I+2yELkfTVvC1dg: checks
vkoJRf3gidxY1pPi0AFWww: bets $2
VvdR9F3I+2yELkfTVvC1dg: calls $2
*** TURN *** [5s 9c Kc] [Qh]
VvdR9F3I+2yELkfTVvC1dg: checks
vkoJRf3gidxY1pPi0AFWww: checks
*** RIVER *** [5s 9c Kc Qh] [4s]
VvdR9F3I+2yELkfTVvC1dg: checks
vkoJRf3gidxY1pPi0AFWww: bets $10
VvdR9F3I+2yELkfTVvC1dg: folds
vkoJRf3gidxY1pPi0AFWww collected $8.60 from pot
vkoJRf3gidxY1pPi0AFWww: doesn't show hand
*** SUMMARY ***
Total pot $9 | Rake $0.40
Board [5s 9c Kc Qh 4s]
Seat 1: UELtvp+JfwI7XDGVwSxZXA folded before Flop (didn't bet)
Seat 2: vkfxu8f/jMYKUk6Ly4eujw folded before Flop (didn't bet)
Seat 3: 9dpyyjDTCed6nV7JhaUUpw (button) folded before Flop (didn't bet)
Seat 4: YsLQ3BAvgQHWXMAv3Wv6Hg (small blind) folded before Flop
Seat 5: VvdR9F3I+2yELkfTVvC1dg (big blind) folded on the River
Seat 6: vkoJRf3gidxY1pPi0AFWww collected ($8.60)



PokerStars Game #59941154784:  Hold'em No Limit ($1/$2) - 2009/07/01 1:27:12 ET
Table 'kq5zaQ+1hLNf8LZfGnbTAA' 6-max Seat #3 is the button
Seat 1: 8srN1dKQePlsv0GyTada+Q ($418 in chips)
Seat 2: nXDI8Y/S6POzRwANu3d8hQ ($197 in chips)
Seat 3: vkfxu8f/jMYKUk6Ly4eujw ($224.95 in chips)
Seat 4: 3dAbvkxS5NPQTBAbvpinVg ($201 in chips)
Seat 5: kfASJqTbXek+zc8ZKsZL1Q ($57.50 in chips)
Seat 6: mfy7uGZcqA2PVQqEVbJ7+g ($197.25 in chips)
3dAbvkxS5NPQTBAbvpinVg: posts small blind $1
kfASJqTbXek+zc8ZKsZL1Q: posts big blind $2
*** HOLE CARDS ***
mfy7uGZcqA2PVQqEVbJ7+g: folds
8srN1dKQePlsv0GyTada+Q: raises $4 to $6
nXDI8Y/S6POzRwANu3d8hQ has timed out
nXDI8Y/S6POzRwANu3d8hQ: folds
nXDI8Y/S6POzRwANu3d8hQ is sitting out
vkfxu8f/jMYKUk6Ly4eujw: folds
3dAbvkxS5NPQTBAbvpinVg: folds
kfASJqTbXek+zc8ZKsZL1Q: raises $4 to $10
8srN1dKQePlsv0GyTada+Q: calls $4
*** FLOP *** [8c 2h 5h]
kfASJqTbXek+zc8ZKsZL1Q: bets $47.50 and is all-in
nXDI8Y/S6POzRwANu3d8hQ has returned
8srN1dKQePlsv0GyTada+Q: folds
kfASJqTbXek+zc8ZKsZL1Q collected $19.95 from pot
kfASJqTbXek+zc8ZKsZL1Q: doesn't show hand
*** SUMMARY ***
Total pot $21 | Rake $1.05
Board [8c 2h 5h]
Seat 1: 8srN1dKQePlsv0GyTada+Q folded on the Flop
Seat 2: nXDI8Y/S6POzRwANu3d8hQ folded before Flop (didn't bet)
Seat 3: vkfxu8f/jMYKUk6Ly4eujw (button) folded before Flop (didn't bet)
Seat 4: 3dAbvkxS5NPQTBAbvpinVg (small blind) folded before Flop
Seat 5: kfASJqTbXek+zc8ZKsZL1Q (big blind) collected ($19.95)
Seat 6: mfy7uGZcqA2PVQqEVbJ7+g folded before Flop (didn't bet)



PokerStars Game #59941154416:  Hold'em No Limit ($1/$2) - 2009/07/01 1:27:12 ET
Table 'mGpP9StWRnoeiBDExc6Frg' 6-max Seat #4 is the button
Seat 1: VvdR9F3I+2yELkfTVvC1dg ($282.15 in chips)
Seat 3: 7acrZUQC3Zc9BNLjoKIcLQ ($34.35 in chips)
Seat 4: 4dcDwIHRm96PwtqkpQiuiA ($82.70 in chips)
Seat 5: d1puGuVBE0fidn+5eRJ0tw ($177.95 in chips)
Seat 6: B2Ih1sr5VZk+8He7rcrMtQ ($467.05 in chips)
d1puGuVBE0fidn+5eRJ0tw: posts small blind $1
B2Ih1sr5VZk+8He7rcrMtQ: posts big blind $2
*** HOLE CARDS ***
VvdR9F3I+2yELkfTVvC1dg: folds
7acrZUQC3Zc9BNLjoKIcLQ: raises $4 to $6
4dcDwIHRm96PwtqkpQiuiA: folds
d1puGuVBE0fidn+5eRJ0tw: folds
B2Ih1sr5VZk+8He7rcrMtQ: folds
7acrZUQC3Zc9BNLjoKIcLQ collected $5 from pot
*** SUMMARY ***
Total pot $5 | Rake $0
Seat 1: VvdR9F3I+2yELkfTVvC1dg folded before Flop (didn't bet)
Seat 3: 7acrZUQC3Zc9BNLjoKIcLQ collected ($5)
Seat 4: 4dcDwIHRm96PwtqkpQiuiA (button) folded before Flop (didn't bet)
Seat 5: d1puGuVBE0fidn+5eRJ0tw (small blind) folded before Flop
Seat 6: B2Ih1sr5VZk+8He7rcrMtQ (big blind) folded before Flop



PokerStars Game #59941155038:  Hold'em No Limit ($1/$2) - 2009/07/01 1:27:13 ET
Table 'W9UeSV0aoPjh5SFSxM8jUQ' 9-max Seat #4 is the button
Seat 1: mIKx5lhIt13X5eZQH0ZeMA ($25 in chips)
Seat 2: iMe5yhc+1BaiIPHet3NMrA ($252.60 in chips)
Seat 3: /inIs/z/PcX+TniIFpaxpg ($25 in chips)
Seat 4: 4YA/sQy1Emm680zhbPUjow ($133.35 in chips)
Seat 5: ri8CLkX3e9JF34dQNbsHGA ($40.45 in chips)
Seat 6: j47DM+lqTfzZP8musviQTg ($110.90 in chips)
Seat 7: I2ipWauytvrkEer4XD3Sjg ($87.70 in chips)
Seat 8: odhvI/CZeMsPyo1n1U7+hA ($49.70 in chips)
Seat 9: Q104K4iDGcqOlVrjAkzPEA ($98.10 in chips)
ri8CLkX3e9JF34dQNbsHGA: posts small blind $1
j47DM+lqTfzZP8musviQTg: posts big blind $2
*** HOLE CARDS ***
I2ipWauytvrkEer4XD3Sjg: folds
odhvI/CZeMsPyo1n1U7+hA: calls $2
Q104K4iDGcqOlVrjAkzPEA: folds
mIKx5lhIt13X5eZQH0ZeMA: folds
iMe5yhc+1BaiIPHet3NMrA: folds
/inIs/z/PcX+TniIFpaxpg: folds
4YA/sQy1Emm680zhbPUjow: folds
ri8CLkX3e9JF34dQNbsHGA: calls $1
j47DM+lqTfzZP8musviQTg: checks
*** FLOP *** [Js Qh 5s]
ri8CLkX3e9JF34dQNbsHGA: bets $4
j47DM+lqTfzZP8musviQTg: folds
odhvI/CZeMsPyo1n1U7+hA: folds
ri8CLkX3e9JF34dQNbsHGA collected $5.70 from pot
*** SUMMARY ***
Total pot $6 | Rake $0.30
Board [Js Qh 5s]
Seat 1: mIKx5lhIt13X5eZQH0ZeMA folded before Flop (didn't bet)
Seat 2: iMe5yhc+1BaiIPHet3NMrA folded before Flop (didn't bet)
Seat 3: /inIs/z/PcX+TniIFpaxpg folded before Flop (didn't bet)
Seat 4: 4YA/sQy1Emm680zhbPUjow (button) folded before Flop (didn't bet)
Seat 5: ri8CLkX3e9JF34dQNbsHGA (small blind) collected ($5.70)
Seat 6: j47DM+lqTfzZP8musviQTg (big blind) folded on the Flop
Seat 7: I2ipWauytvrkEer4XD3Sjg folded before Flop (didn't bet)
Seat 8: odhvI/CZeMsPyo1n1U7+hA folded on the Flop
Seat 9: Q104K4iDGcqOlVrjAkzPEA folded before Flop (didn't bet)



PokerStars Game #59941155432:  Hold'em No Limit ($1/$2) - 2009/07/01 1:27:13 ET
Table 'NmY84NAf9Mh0ckAckHnh5g' 2-max Seat #1 is the button
Seat 1: 6hvg964TSqZ3AL/0XK9aVQ ($248.10 in chips)
Seat 2: RwDoM55ZeQuI2ADyJhOb2Q ($754.40 in chips)
6hvg964TSqZ3AL/0XK9aVQ: posts small blind $1
RwDoM55ZeQuI2ADyJhOb2Q: posts big blind $2
*** HOLE CARDS ***
6hvg964TSqZ3AL/0XK9aVQ: calls $1
RwDoM55ZeQuI2ADyJhOb2Q: checks
*** FLOP *** [Ah 9d 3d]
RwDoM55ZeQuI2ADyJhOb2Q: checks
6hvg964TSqZ3AL/0XK9aVQ: checks
*** TURN *** [Ah 9d 3d] [3h]
RwDoM55ZeQuI2ADyJhOb2Q: checks
6hvg964TSqZ3AL/0XK9aVQ: checks
*** RIVER *** [Ah 9d 3d 3h] [Tc]
RwDoM55ZeQuI2ADyJhOb2Q: checks
6hvg964TSqZ3AL/0XK9aVQ: checks
*** SHOW DOWN ***
RwDoM55ZeQuI2ADyJhOb2Q: shows [8d Qs] (a pair of Threes)
6hvg964TSqZ3AL/0XK9aVQ: mucks hand
RwDoM55ZeQuI2ADyJhOb2Q collected $3.80 from pot
*** SUMMARY ***
Total pot $4 | Rake $0.20
Board [Ah 9d 3d 3h Tc]
Seat 1: 6hvg964TSqZ3AL/0XK9aVQ (button) (small blind) mucked
Seat 2: RwDoM55ZeQuI2ADyJhOb2Q (big blind) showed [8d Qs] and won ($3.80) with a pair of Threes



PokerStars Game #59941155622:  Hold'em No Limit ($1/$2) - 2009/07/01 1:27:14 ET
Table '+hSnXFQrGw1PlVgTnuj+sA' 6-max Seat #4 is the button
Seat 1: 2ccIJhDj+3JapvS7swVZEg ($334 in chips)
Seat 4: J4iH5epwXbmODnojR/VRxA ($163.25 in chips)
Seat 5: VvdR9F3I+2yELkfTVvC1dg ($202.55 in chips)
Seat 6: AuiGltq875lmaKHBsjZVGg ($67.75 in chips)
VvdR9F3I+2yELkfTVvC1dg: posts small blind $1
AuiGltq875lmaKHBsjZVGg: posts big blind $2
54yWzRRgS0oZ+S6LwZBxMQ: sits out
*** HOLE CARDS ***
2ccIJhDj+3JapvS7swVZEg: folds
ubtx4Z5L+AcK71MTvYiGVw joins the table at seat #3
J4iH5epwXbmODnojR/VRxA has timed out while being disconnected
J4iH5epwXbmODnojR/VRxA: folds
J4iH5epwXbmODnojR/VRxA is sitting out
J4iH5epwXbmODnojR/VRxA is disconnected
VvdR9F3I+2yELkfTVvC1dg: folds
AuiGltq875lmaKHBsjZVGg collected $2 from pot
J4iH5epwXbmODnojR/VRxA is connected
*** SUMMARY ***
Total pot $2 | Rake $0
Seat 1: 2ccIJhDj+3JapvS7swVZEg folded before Flop (didn't bet)
Seat 4: J4iH5epwXbmODnojR/VRxA (button) folded before Flop (didn't bet)
Seat 5: VvdR9F3I+2yELkfTVvC1dg (small blind) folded before Flop
Seat 6: AuiGltq875lmaKHBsjZVGg (big blind) collected ($2)



PokerStars Game #59941156214:  Hold'em No Limit ($1/$2) - 2009/07/01 1:27:15 ET
Table 'gftD4mDF7mIFKvSrIyaRbw' 9-max Seat #4 is the button
Seat 1: 31HuO+DQxppUQEedBWukug ($98 in chips)
Seat 2: GX1heJ+DSsvm7gzSPsYhhQ ($40 in chips)
Seat 3: CUZwDpLTQKhzarPe+JCLOQ ($200 in chips)
Seat 4: /inIs/z/PcX+TniIFpaxpg ($40 in chips)
Seat 5: mpsfNtnMVDqQHTe92AhIdw ($121.10 in chips)
Seat 6: 2NvwF8W2nzsbS+G//yLAbQ ($178.05 in chips)
Seat 8: MpL4DeEqGQu0H8TJEbEOrg ($44 in chips)
Seat 9: F7m34OOfAQ7annesMHVjKw ($167.75 in chips)
mpsfNtnMVDqQHTe92AhIdw: posts small blind $1
2NvwF8W2nzsbS+G//yLAbQ: posts big blind $2
+T/63sAeZzWyHchahJ36GQ: sits out
*** HOLE CARDS ***
MpL4DeEqGQu0H8TJEbEOrg: folds
F7m34OOfAQ7annesMHVjKw: calls $2
31HuO+DQxppUQEedBWukug: calls $2
GX1heJ+DSsvm7gzSPsYhhQ: folds
CUZwDpLTQKhzarPe+JCLOQ: folds
/inIs/z/PcX+TniIFpaxpg: folds
mpsfNtnMVDqQHTe92AhIdw: calls $1
2NvwF8W2nzsbS+G//yLAbQ: checks
*** FLOP *** [5c 6h 6d]
mpsfNtnMVDqQHTe92AhIdw: checks
2NvwF8W2nzsbS+G//yLAbQ: bets $3
F7m34OOfAQ7annesMHVjKw: folds
31HuO+DQxppUQEedBWukug: raises $3 to $6
mpsfNtnMVDqQHTe92AhIdw: folds
2NvwF8W2nzsbS+G//yLAbQ: calls $3
*** TURN *** [5c 6h 6d] [9s]
2NvwF8W2nzsbS+G//yLAbQ: checks
31HuO+DQxppUQEedBWukug: bets $16
2NvwF8W2nzsbS+G//yLAbQ: calls $16
*** RIVER *** [5c 6h 6d 9s] [4s]
2NvwF8W2nzsbS+G//yLAbQ: checks
31HuO+DQxppUQEedBWukug: bets $40
2NvwF8W2nzsbS+G//yLAbQ: calls $40
*** SHOW DOWN ***
31HuO+DQxppUQEedBWukug: shows [6s 8s] (three of a kind, Sixes)
2NvwF8W2nzsbS+G//yLAbQ: mucks hand
31HuO+DQxppUQEedBWukug collected $129 from pot
*** SUMMARY ***
Total pot $132 | Rake $3
Board [5c 6h 6d 9s 4s]
Seat 1: 31HuO+DQxppUQEedBWukug showed [6s 8s] and won ($129) with three of a kind, Sixes
Seat 2: GX1heJ+DSsvm7gzSPsYhhQ folded before Flop (didn't bet)
Seat 3: CUZwDpLTQKhzarPe+JCLOQ folded before Flop (didn't bet)
Seat 4: /inIs/z/PcX+TniIFpaxpg (button) folded before Flop (didn't bet)
Seat 5: mpsfNtnMVDqQHTe92AhIdw (small blind) folded on the Flop
Seat 6: 2NvwF8W2nzsbS+G//yLAbQ (big blind) mucked
Seat 8: MpL4DeEqGQu0H8TJEbEOrg folded before Flop (didn't bet)
Seat 9: F7m34OOfAQ7annesMHVjKw folded on the Flop



PokerStars Game #59941157764:  Hold'em No Limit ($1/$2) - 2009/07/01 1:27:17 ET
Table 'qVXak+oTeDXMGbWa4sDU5Q' 9-max Seat #6 is the button
Seat 1: H6Z4+qu8gR0VUiPOijndVg ($212.55 in chips)
Seat 2: rW/MyplHylMSBRaoRUzWrg ($74 in chips)
Seat 3: WUlHm+ydPPHG7Lb0rePSdA ($153.65 in chips)
Seat 4: lQYT23h5QCUVZAKxjOO39Q ($200 in chips)
Seat 5: FWGiDqRwvLeKmHq9t4Jy9w ($265.80 in chips)
Seat 6: GX1heJ+DSsvm7gzSPsYhhQ ($34 in chips)
Seat 7: PfmlvZlFiss79a6IoEr11g ($164.30 in chips)
Seat 8: Z0rzUi0y1x80UdIpofoNbA ($126.55 in chips)
Seat 9: CkE3IyJF1KvdaAOmZY5XqQ ($200 in chips)
PfmlvZlFiss79a6IoEr11g: posts small blind $1
Z0rzUi0y1x80UdIpofoNbA: posts big blind $2
*** HOLE CARDS ***
CkE3IyJF1KvdaAOmZY5XqQ: folds
H6Z4+qu8gR0VUiPOijndVg: folds
rW/MyplHylMSBRaoRUzWrg: folds
WUlHm+ydPPHG7Lb0rePSdA: folds
lQYT23h5QCUVZAKxjOO39Q: folds
FWGiDqRwvLeKmHq9t4Jy9w: raises $4.50 to $6.50
GX1heJ+DSsvm7gzSPsYhhQ: folds
PfmlvZlFiss79a6IoEr11g: folds
Z0rzUi0y1x80UdIpofoNbA: folds
FWGiDqRwvLeKmHq9t4Jy9w collected $5 from pot
FWGiDqRwvLeKmHq9t4Jy9w: doesn't show hand
*** SUMMARY ***
Total pot $5 | Rake $0
Seat 1: H6Z4+qu8gR0VUiPOijndVg folded before Flop (didn't bet)
Seat 2: rW/MyplHylMSBRaoRUzWrg folded before Flop (didn't bet)
Seat 3: WUlHm+ydPPHG7Lb0rePSdA folded before Flop (didn't bet)
Seat 4: lQYT23h5QCUVZAKxjOO39Q folded before Flop (didn't bet)
Seat 5: FWGiDqRwvLeKmHq9t4Jy9w collected ($5)
Seat 6: GX1heJ+DSsvm7gzSPsYhhQ (button) folded before Flop (didn't bet)
Seat 7: PfmlvZlFiss79a6IoEr11g (small blind) folded before Flop
Seat 8: Z0rzUi0y1x80UdIpofoNbA (big blind) folded before Flop
Seat 9: CkE3IyJF1KvdaAOmZY5XqQ folded before Flop (didn't bet)



PokerStars Game #59941157388:  Hold'em No Limit ($1/$2) - 2009/07/01 1:27:17 ET
Table 'rKeCh+eBn4RNvybCUYkoTQ' 9-max Seat #2 is the button
Seat 1: /inIs/z/PcX+TniIFpaxpg ($200 in chips)
Seat 2: 9cBHwK40Tl06vheE7B3LHQ ($159.55 in chips)
Seat 3: GX1heJ+DSsvm7gzSPsYhhQ ($32 in chips)
Seat 4: 31HuO+DQxppUQEedBWukug ($92.10 in chips)
Seat 5: WUlHm+ydPPHG7Lb0rePSdA ($128 in chips)
Seat 6: EBV6OktyeSmh4w6sWmcWOw ($267 in chips)
Seat 7: rW/MyplHylMSBRaoRUzWrg ($34 in chips)
Seat 8: pN/Ip0ePsUVIdUlGgLrkUw ($215.35 in chips)
Seat 9: Kzta8yu9vxHT4B70mjBZ+w ($211.25 in chips)
GX1heJ+DSsvm7gzSPsYhhQ: posts small blind $1
31HuO+DQxppUQEedBWukug: posts big blind $2
*** HOLE CARDS ***
WUlHm+ydPPHG7Lb0rePSdA: folds
EBV6OktyeSmh4w6sWmcWOw: raises $2 to $4
rW/MyplHylMSBRaoRUzWrg: folds
pN/Ip0ePsUVIdUlGgLrkUw: folds
Kzta8yu9vxHT4B70mjBZ+w: folds
/inIs/z/PcX+TniIFpaxpg: folds
9cBHwK40Tl06vheE7B3LHQ: folds
GX1heJ+DSsvm7gzSPsYhhQ: folds
31HuO+DQxppUQEedBWukug: folds
EBV6OktyeSmh4w6sWmcWOw collected $5 from pot
EBV6OktyeSmh4w6sWmcWOw: doesn't show hand
*** SUMMARY ***
Total pot $5 | Rake $0
Seat 1: /inIs/z/PcX+TniIFpaxpg folded before Flop (didn't bet)
Seat 2: 9cBHwK40Tl06vheE7B3LHQ (button) folded before Flop (didn't bet)
Seat 3: GX1heJ+DSsvm7gzSPsYhhQ (small blind) folded before Flop
Seat 4: 31HuO+DQxppUQEedBWukug (big blind) folded before Flop
Seat 5: WUlHm+ydPPHG7Lb0rePSdA folded before Flop (didn't bet)
Seat 6: EBV6OktyeSmh4w6sWmcWOw collected ($5)
Seat 7: rW/MyplHylMSBRaoRUzWrg folded before Flop (didn't bet)
Seat 8: pN/Ip0ePsUVIdUlGgLrkUw folded before Flop (didn't bet)
Seat 9: Kzta8yu9vxHT4B70mjBZ+w folded before Flop (didn't bet)



PokerStars Game #59941158376:  Hold'em No Limit ($1/$2) - 2009/07/01 1:27:19 ET
Table 'YqGfR5eHfMeSjb9a+QU9rg' 9-max Seat #8 is the button
Seat 1: rW/MyplHylMSBRaoRUzWrg ($34 in chips)
Seat 2: W3Nqt1GWlTi9tXQXMNEvgw ($386.25 in chips)
Seat 3: /gll27k+xWYV7Fbki0lFDQ ($261.75 in chips)
Seat 5: CkE3IyJF1KvdaAOmZY5XqQ ($200 in chips)
Seat 6: TAfo4veNRaRlzDXMMYS3Jg ($37 in chips)
Seat 7: 41aZuLBz9nAi2GPVKabmCw ($107.45 in chips)
Seat 8: JnV3SM2D6dAFYyGZHHpvrg ($95.25 in chips)
Seat 9: /inIs/z/PcX+TniIFpaxpg ($206.20 in chips)
/inIs/z/PcX+TniIFpaxpg: posts small blind $1
GX1heJ+DSsvm7gzSPsYhhQ joins the table at seat #4
rW/MyplHylMSBRaoRUzWrg: posts big blind $2
*** HOLE CARDS ***
W3Nqt1GWlTi9tXQXMNEvgw: folds
/gll27k+xWYV7Fbki0lFDQ: folds
CkE3IyJF1KvdaAOmZY5XqQ: folds
TAfo4veNRaRlzDXMMYS3Jg: folds
41aZuLBz9nAi2GPVKabmCw: folds
JnV3SM2D6dAFYyGZHHpvrg: folds
/inIs/z/PcX+TniIFpaxpg: folds
rW/MyplHylMSBRaoRUzWrg collected $2 from pot
*** SUMMARY ***
Total pot $2 | Rake $0
Seat 1: rW/MyplHylMSBRaoRUzWrg (big blind) collected ($2)
Seat 2: W3Nqt1GWlTi9tXQXMNEvgw folded before Flop (didn't bet)
Seat 3: /gll27k+xWYV7Fbki0lFDQ folded before Flop (didn't bet)
Seat 5: CkE3IyJF1KvdaAOmZY5XqQ folded before Flop (didn't bet)
Seat 6: TAfo4veNRaRlzDXMMYS3Jg folded before Flop (didn't bet)
Seat 7: 41aZuLBz9nAi2GPVKabmCw folded before Flop (didn't bet)
Seat 8: JnV3SM2D6dAFYyGZHHpvrg (button) folded before Flop (didn't bet)
Seat 9: /inIs/z/PcX+TniIFpaxpg (small blind) folded before Flop



PokerStars Game #59941159418:  Hold'em No Limit ($1/$2) - 2009/07/01 1:27:20 ET
Table 'QxerF7GUfCbl+4a8XaTB2w' 6-max Seat #2 is the button
Seat 1: 54yWzRRgS0oZ+S6LwZBxMQ ($32 in chips)
Seat 2: HiWSAXs6/0w9Jy7ioiiShQ ($35 in chips)
Seat 3: m7mYVfnCOK5TE/VkN/FhOg ($282.10 in chips)
Seat 4: 09BNF4quPDzanQzM8vc6WA ($41.55 in chips)
Seat 5: gnYme0DNFflnMhrdbxe1Ag ($244.70 in chips)
Seat 6: VvdR9F3I+2yELkfTVvC1dg ($200 in chips)
m7mYVfnCOK5TE/VkN/FhOg: posts small blind $1
09BNF4quPDzanQzM8vc6WA: posts big blind $2
*** HOLE CARDS ***
gnYme0DNFflnMhrdbxe1Ag: folds
VvdR9F3I+2yELkfTVvC1dg: raises $2 to $4
54yWzRRgS0oZ+S6LwZBxMQ: folds
HiWSAXs6/0w9Jy7ioiiShQ: folds
m7mYVfnCOK5TE/VkN/FhOg: folds
09BNF4quPDzanQzM8vc6WA: raises $37.55 to $41.55 and is all-in
VvdR9F3I+2yELkfTVvC1dg: folds
09BNF4quPDzanQzM8vc6WA collected $9 from pot
09BNF4quPDzanQzM8vc6WA: doesn't show hand
*** SUMMARY ***
Total pot $9 | Rake $0
Seat 1: 54yWzRRgS0oZ+S6LwZBxMQ folded before Flop (didn't bet)
Seat 2: HiWSAXs6/0w9Jy7ioiiShQ (button) folded before Flop (didn't bet)
Seat 3: m7mYVfnCOK5TE/VkN/FhOg (small blind) folded before Flop
Seat 4: 09BNF4quPDzanQzM8vc6WA (big blind) collected ($9)
Seat 5: gnYme0DNFflnMhrdbxe1Ag folded before Flop (didn't bet)
Seat 6: VvdR9F3I+2yELkfTVvC1dg folded before Flop



PokerStars Game #59941160306:  Hold'em No Limit ($1/$2) - 2009/07/01 1:27:22 ET
Table 'uJ9juaXXg9yIcSU8amxaXQ' 6-max Seat #3 is the button
Seat 1: JsqOjN/eHz0uYVf/PyUJ6Q ($146.50 in chips)
Seat 2: VvdR9F3I+2yELkfTVvC1dg ($200 in chips)
Seat 3: qXDd0ZyMIse0OBu8pxeQ3Q ($244 in chips)
Seat 4: zNjJ/y4emmF+vzrCDd+ooA ($233.35 in chips)
Seat 5: YsLQ3BAvgQHWXMAv3Wv6Hg ($200 in chips)
Seat 6: 2DFp9Veq1xxq64dCjwNuUw ($59.60 in chips)
zNjJ/y4emmF+vzrCDd+ooA: posts small blind $1
YsLQ3BAvgQHWXMAv3Wv6Hg: posts big blind $2
*** HOLE CARDS ***
2DFp9Veq1xxq64dCjwNuUw: folds
JsqOjN/eHz0uYVf/PyUJ6Q: calls $2
VvdR9F3I+2yELkfTVvC1dg: folds
qXDd0ZyMIse0OBu8pxeQ3Q: folds
zNjJ/y4emmF+vzrCDd+ooA: calls $1
YsLQ3BAvgQHWXMAv3Wv6Hg: checks
*** FLOP *** [9s Kh 4d]
zNjJ/y4emmF+vzrCDd+ooA: checks
YsLQ3BAvgQHWXMAv3Wv6Hg: checks
JsqOjN/eHz0uYVf/PyUJ6Q: checks
*** TURN *** [9s Kh 4d] [7h]
zNjJ/y4emmF+vzrCDd+ooA: checks
YsLQ3BAvgQHWXMAv3Wv6Hg: checks
JsqOjN/eHz0uYVf/PyUJ6Q: checks
*** RIVER *** [9s Kh 4d 7h] [5c]
zNjJ/y4emmF+vzrCDd+ooA: checks
YsLQ3BAvgQHWXMAv3Wv6Hg: checks
JsqOjN/eHz0uYVf/PyUJ6Q: checks
*** SHOW DOWN ***
zNjJ/y4emmF+vzrCDd+ooA: shows [As Qs] (high card Ace)
YsLQ3BAvgQHWXMAv3Wv6Hg: mucks hand
JsqOjN/eHz0uYVf/PyUJ6Q: mucks hand
zNjJ/y4emmF+vzrCDd+ooA collected $5.70 from pot
*** SUMMARY ***
Total pot $6 | Rake $0.30
Board [9s Kh 4d 7h 5c]
Seat 1: JsqOjN/eHz0uYVf/PyUJ6Q mucked
Seat 2: VvdR9F3I+2yELkfTVvC1dg folded before Flop (didn't bet)
Seat 3: qXDd0ZyMIse0OBu8pxeQ3Q (button) folded before Flop (didn't bet)
Seat 4: zNjJ/y4emmF+vzrCDd+ooA (small blind) showed [As Qs] and won ($5.70) with high card Ace
Seat 5: YsLQ3BAvgQHWXMAv3Wv6Hg (big blind) mucked
Seat 6: 2DFp9Veq1xxq64dCjwNuUw folded before Flop (didn't bet)



PokerStars Game #59941162562:  Hold'em No Limit ($1/$2) - 2009/07/01 1:27:26 ET
Table 'bIihwBANJSFqlHPPtset+w' 9-max Seat #5 is the button
Seat 1: /inIs/z/PcX+TniIFpaxpg ($30 in chips)
Seat 2: lQYT23h5QCUVZAKxjOO39Q ($200 in chips)
Seat 3: +T/63sAeZzWyHchahJ36GQ ($43 in chips)
Seat 4: ri8CLkX3e9JF34dQNbsHGA ($40 in chips)
Seat 5: vxbbJLsS1bva6tW2NiFssg ($200 in chips)
Seat 6: CkE3IyJF1KvdaAOmZY5XqQ ($184 in chips)
Seat 7: pCmk6FpSOLJ+85o1tLHIag ($145.95 in chips)
Seat 8: iMe5yhc+1BaiIPHet3NMrA ($200.50 in chips)
Seat 9: qn8LDoUFphcG4+r+F+Vhrg ($171 in chips)
CkE3IyJF1KvdaAOmZY5XqQ: posts small blind $1
pCmk6FpSOLJ+85o1tLHIag: posts big blind $2
*** HOLE CARDS ***
iMe5yhc+1BaiIPHet3NMrA: folds
qn8LDoUFphcG4+r+F+Vhrg: folds
/inIs/z/PcX+TniIFpaxpg: folds
lQYT23h5QCUVZAKxjOO39Q: folds
+T/63sAeZzWyHchahJ36GQ: raises $4 to $6
ri8CLkX3e9JF34dQNbsHGA: folds
vxbbJLsS1bva6tW2NiFssg: folds
CkE3IyJF1KvdaAOmZY5XqQ: folds
pCmk6FpSOLJ+85o1tLHIag: folds
+T/63sAeZzWyHchahJ36GQ collected $5 from pot
*** SUMMARY ***
Total pot $5 | Rake $0
Seat 1: /inIs/z/PcX+TniIFpaxpg folded before Flop (didn't bet)
Seat 2: lQYT23h5QCUVZAKxjOO39Q folded before Flop (didn't bet)
Seat 3: +T/63sAeZzWyHchahJ36GQ collected ($5)
Seat 4: ri8CLkX3e9JF34dQNbsHGA folded before Flop (didn't bet)
Seat 5: vxbbJLsS1bva6tW2NiFssg (button) folded before Flop (didn't bet)
Seat 6: CkE3IyJF1KvdaAOmZY5XqQ (small blind) folded before Flop
Seat 7: pCmk6FpSOLJ+85o1tLHIag (big blind) folded before Flop
Seat 8: iMe5yhc+1BaiIPHet3NMrA folded before Flop (didn't bet)
Seat 9: qn8LDoUFphcG4+r+F+Vhrg folded before Flop (didn't bet)



PokerStars Game #59941162506:  Hold'em No Limit ($1/$2) - 2009/07/01 1:27:26 ET
Table '/dyk+YdRGv90j2box35j8w' 6-max Seat #4 is the button
Seat 1: 8srN1dKQePlsv0GyTada+Q ($203 in chips)
Seat 2: qCnEYuAE5y5A7bk6fO5/jQ ($476.60 in chips)
Seat 4: z/u1YTnkiIDrtp/2cA2dBg ($202.05 in chips)
Seat 5: VvdR9F3I+2yELkfTVvC1dg ($200 in chips)
VvdR9F3I+2yELkfTVvC1dg: posts small blind $1
8srN1dKQePlsv0GyTada+Q: posts big blind $2
*** HOLE CARDS ***
qCnEYuAE5y5A7bk6fO5/jQ: folds
z/u1YTnkiIDrtp/2cA2dBg: folds
VvdR9F3I+2yELkfTVvC1dg: folds
8srN1dKQePlsv0GyTada+Q collected $2 from pot
8srN1dKQePlsv0GyTada+Q: doesn't show hand
*** SUMMARY ***
Total pot $2 | Rake $0
Seat 1: 8srN1dKQePlsv0GyTada+Q (big blind) collected ($2)
Seat 2: qCnEYuAE5y5A7bk6fO5/jQ folded before Flop (didn't bet)
Seat 4: z/u1YTnkiIDrtp/2cA2dBg (button) folded before Flop (didn't bet)
Seat 5: VvdR9F3I+2yELkfTVvC1dg (small blind) folded before Flop



PokerStars Game #59941163814:  Hold'em No Limit ($1/$2) - 2009/07/01 1:27:28 ET
Table '4NGNnZ/osQfNq6abYqkJeA' 6-max Seat #5 is the button
Seat 1: vkfxu8f/jMYKUk6Ly4eujw ($198 in chips)
Seat 2: 669iGNwYwgRZg3nhS+aDAQ ($93.15 in chips)
Seat 3: 54yWzRRgS0oZ+S6LwZBxMQ ($20.75 in chips)
Seat 4: sY+4Uuh5z/6AbXXaCS10jw ($214.35 in chips)
Seat 5: VvdR9F3I+2yELkfTVvC1dg ($234.80 in chips)
3cPMpDMgeOMAe4UceUfLsg will be allowed to play after the button
vkfxu8f/jMYKUk6Ly4eujw: posts small blind $1
669iGNwYwgRZg3nhS+aDAQ: posts big blind $2
*** HOLE CARDS ***
54yWzRRgS0oZ+S6LwZBxMQ: folds
sY+4Uuh5z/6AbXXaCS10jw: folds
VvdR9F3I+2yELkfTVvC1dg: folds
vkfxu8f/jMYKUk6Ly4eujw: folds
669iGNwYwgRZg3nhS+aDAQ collected $2 from pot
*** SUMMARY ***
Total pot $2 | Rake $0
Seat 1: vkfxu8f/jMYKUk6Ly4eujw (small blind) folded before Flop
Seat 2: 669iGNwYwgRZg3nhS+aDAQ (big blind) collected ($2)
Seat 3: 54yWzRRgS0oZ+S6LwZBxMQ folded before Flop (didn't bet)
Seat 4: sY+4Uuh5z/6AbXXaCS10jw folded before Flop (didn't bet)
Seat 5: VvdR9F3I+2yELkfTVvC1dg (button) folded before Flop (didn't bet)



PokerStars Game #59941164130:  Hold'em No Limit ($1/$2) - 2009/07/01 1:27:28 ET
Table 'eLiKDgGuglnpCC8SYOPV/Q' 2-max Seat #1 is the button
Seat 1: 05+IW2KIkjP8ztSBO87NBQ ($175.50 in chips)
Seat 2: yG1b3AA8MBKywUzWu5p6Qg ($8.85 in chips)
05+IW2KIkjP8ztSBO87NBQ: posts small blind $1
yG1b3AA8MBKywUzWu5p6Qg: posts big blind $2
*** HOLE CARDS ***
05+IW2KIkjP8ztSBO87NBQ: calls $1
yG1b3AA8MBKywUzWu5p6Qg: raises $2 to $4
05+IW2KIkjP8ztSBO87NBQ: calls $2
*** FLOP *** [8d Jd Qc]
yG1b3AA8MBKywUzWu5p6Qg: bets $2
05+IW2KIkjP8ztSBO87NBQ: calls $2
*** TURN *** [8d Jd Qc] [9c]
yG1b3AA8MBKywUzWu5p6Qg: bets $2
05+IW2KIkjP8ztSBO87NBQ: calls $2
*** RIVER *** [8d Jd Qc 9c] [Tc]
yG1b3AA8MBKywUzWu5p6Qg: bets $0.85 and is all-in
05+IW2KIkjP8ztSBO87NBQ: calls $0.85
*** SHOW DOWN ***
yG1b3AA8MBKywUzWu5p6Qg: shows [Ah 3s] (a straight, Eight to Queen)
05+IW2KIkjP8ztSBO87NBQ: shows [6c 8c] (a flush, Queen high)
05+IW2KIkjP8ztSBO87NBQ collected $17.20 from pot
*** SUMMARY ***
Total pot $17.70 | Rake $0.50
Board [8d Jd Qc 9c Tc]
Seat 1: 05+IW2KIkjP8ztSBO87NBQ (button) (small blind) showed [6c 8c] and won ($17.20) with a flush, Queen high
Seat 2: yG1b3AA8MBKywUzWu5p6Qg (big blind) showed [Ah 3s] and lost with a straight, Eight to Queen



PokerStars Game #59941164352:  Hold'em No Limit ($1/$2) - 2009/07/01 1:27:29 ET
Table 'jlrIxbrVIG+gjaUYT4za8g' 6-max Seat #2 is the button
Seat 1: ygTTt5ehT4aF86q1a8/R+w ($261.30 in chips)
Seat 2: on4ebXPJvUBOcHOBMQsRSg ($72.80 in chips)
Seat 4: 8srN1dKQePlsv0GyTada+Q ($298.35 in chips)
Seat 5: AyBB0k3Dcl7xbXUeGMw06g ($74.90 in chips)
Seat 6: vkfxu8f/jMYKUk6Ly4eujw ($306 in chips)
8srN1dKQePlsv0GyTada+Q: posts small blind $1
AyBB0k3Dcl7xbXUeGMw06g: posts big blind $2
*** HOLE CARDS ***
RUZs7P4uzWavoA6iEpDKLw leaves the table
vkfxu8f/jMYKUk6Ly4eujw: raises $6 to $8
ygTTt5ehT4aF86q1a8/R+w: folds
on4ebXPJvUBOcHOBMQsRSg: folds
8srN1dKQePlsv0GyTada+Q: folds
AyBB0k3Dcl7xbXUeGMw06g: folds
vkfxu8f/jMYKUk6Ly4eujw collected $5 from pot
*** SUMMARY ***
Total pot $5 | Rake $0
Seat 1: ygTTt5ehT4aF86q1a8/R+w folded before Flop (didn't bet)
Seat 2: on4ebXPJvUBOcHOBMQsRSg (button) folded before Flop (didn't bet)
Seat 4: 8srN1dKQePlsv0GyTada+Q (small blind) folded before Flop
Seat 5: AyBB0k3Dcl7xbXUeGMw06g (big blind) folded before Flop
Seat 6: vkfxu8f/jMYKUk6Ly4eujw collected ($5)



PokerStars Game #59941166194:  Hold'em No Limit ($1/$2) - 2009/07/01 1:27:32 ET
Table 'LL4bDFyhj5hsMpzaDugJZg' 6-max Seat #4 is the button
Seat 1: FwvID/fQGlpY3soi/lMTww ($84.50 in chips)
Seat 3: iI/NMpRxMkGieArQEhACSA ($537.50 in chips)
Seat 4: 8srN1dKQePlsv0GyTada+Q ($201.80 in chips)
Seat 5: A2GTwTiwkb1ilNWgW487Vg ($120.80 in chips)
Seat 6: 692Q4sfB0gTElzS0WMeg+A ($215.10 in chips)
A2GTwTiwkb1ilNWgW487Vg: posts small blind $1
692Q4sfB0gTElzS0WMeg+A: posts big blind $2
*** HOLE CARDS ***
FwvID/fQGlpY3soi/lMTww: folds
iI/NMpRxMkGieArQEhACSA: folds
8srN1dKQePlsv0GyTada+Q: raises $3 to $5
A2GTwTiwkb1ilNWgW487Vg: calls $4
692Q4sfB0gTElzS0WMeg+A: calls $3
*** FLOP *** [7d Qd 6s]
A2GTwTiwkb1ilNWgW487Vg: checks
692Q4sfB0gTElzS0WMeg+A: checks
8srN1dKQePlsv0GyTada+Q: bets $4
A2GTwTiwkb1ilNWgW487Vg: folds
692Q4sfB0gTElzS0WMeg+A: folds
8srN1dKQePlsv0GyTada+Q collected $14.25 from pot
*** SUMMARY ***
Total pot $15 | Rake $0.75
Board [7d Qd 6s]
Seat 1: FwvID/fQGlpY3soi/lMTww folded before Flop (didn't bet)
Seat 3: iI/NMpRxMkGieArQEhACSA folded before Flop (didn't bet)
Seat 4: 8srN1dKQePlsv0GyTada+Q (button) collected ($14.25)
Seat 5: A2GTwTiwkb1ilNWgW487Vg (small blind) folded on the Flop
Seat 6: 692Q4sfB0gTElzS0WMeg+A (big blind) folded on the Flop



PokerStars Game #59941166366:  Hold'em No Limit ($1/$2) - 2009/07/01 1:27:32 ET
Table 'ZzSIe0zTCDv+n6hfbY5tTg' 6-max Seat #4 is the button
Seat 1: VvdR9F3I+2yELkfTVvC1dg ($201 in chips)
Seat 2: B87ikIyZ/TzAVeXf38Ny0g ($286 in chips)
Seat 3: gsugPj31Hui3Jefl98MBOA ($167.60 in chips)
Seat 4: qXDd0ZyMIse0OBu8pxeQ3Q ($209.70 in chips)
Seat 5: 3dAbvkxS5NPQTBAbvpinVg ($481.30 in chips)
Seat 6: 09BNF4quPDzanQzM8vc6WA ($23.05 in chips)
3dAbvkxS5NPQTBAbvpinVg: posts small blind $1
09BNF4quPDzanQzM8vc6WA: posts big blind $2
*** HOLE CARDS ***
VvdR9F3I+2yELkfTVvC1dg: folds
B87ikIyZ/TzAVeXf38Ny0g: folds
gsugPj31Hui3Jefl98MBOA: folds
qXDd0ZyMIse0OBu8pxeQ3Q: folds
3dAbvkxS5NPQTBAbvpinVg: folds
09BNF4quPDzanQzM8vc6WA collected $2 from pot
09BNF4quPDzanQzM8vc6WA: doesn't show hand
*** SUMMARY ***
Total pot $2 | Rake $0
Seat 1: VvdR9F3I+2yELkfTVvC1dg folded before Flop (didn't bet)
Seat 2: B87ikIyZ/TzAVeXf38Ny0g folded before Flop (didn't bet)
Seat 3: gsugPj31Hui3Jefl98MBOA folded before Flop (didn't bet)
Seat 4: qXDd0ZyMIse0OBu8pxeQ3Q (button) folded before Flop (didn't bet)
Seat 5: 3dAbvkxS5NPQTBAbvpinVg (small blind) folded before Flop
Seat 6: 09BNF4quPDzanQzM8vc6WA (big blind) collected ($2)



PokerStars Game #59941167902:  Hold'em No Limit ($1/$2) - 2009/07/01 1:27:35 ET
Table 'TsEDkiO4tzCTCzJ7tNdEqw' 6-max Seat #5 is the button
Seat 1: MfXQsYD8pGeCS7XOtyV+vw ($99.25 in chips)
Seat 2: 4dcDwIHRm96PwtqkpQiuiA ($81.10 in chips)
Seat 4: K8MXCrNAVYlMnnCeM32Kxw ($106.45 in chips)
Seat 5: VvdR9F3I+2yELkfTVvC1dg ($266 in chips)
Seat 6: uCqEjnxh2/vFBjKYkfTOkw ($144.35 in chips)
uCqEjnxh2/vFBjKYkfTOkw: posts small blind $1
MfXQsYD8pGeCS7XOtyV+vw: posts big blind $2
ubtx4Z5L+AcK71MTvYiGVw: sits out
*** HOLE CARDS ***
4dcDwIHRm96PwtqkpQiuiA: folds
K8MXCrNAVYlMnnCeM32Kxw: folds
VvdR9F3I+2yELkfTVvC1dg: folds
uCqEjnxh2/vFBjKYkfTOkw: calls $1
MfXQsYD8pGeCS7XOtyV+vw: checks
*** FLOP *** [4s Js Ts]
uCqEjnxh2/vFBjKYkfTOkw: checks
MfXQsYD8pGeCS7XOtyV+vw: bets $2
uCqEjnxh2/vFBjKYkfTOkw: folds
MfXQsYD8pGeCS7XOtyV+vw collected $3.80 from pot
MfXQsYD8pGeCS7XOtyV+vw: doesn't show hand
*** SUMMARY ***
Total pot $4 | Rake $0.20
Board [4s Js Ts]
Seat 1: MfXQsYD8pGeCS7XOtyV+vw (big blind) collected ($3.80)
Seat 2: 4dcDwIHRm96PwtqkpQiuiA folded before Flop (didn't bet)
Seat 4: K8MXCrNAVYlMnnCeM32Kxw folded before Flop (didn't bet)
Seat 5: VvdR9F3I+2yELkfTVvC1dg (button) folded before Flop (didn't bet)
Seat 6: uCqEjnxh2/vFBjKYkfTOkw (small blind) folded on the Flop



PokerStars Game #59941168010:  Hold'em No Limit ($1/$2) - 2009/07/01 1:27:35 ET
Table 'NmY84NAf9Mh0ckAckHnh5g' 2-max Seat #2 is the button
Seat 1: 6hvg964TSqZ3AL/0XK9aVQ ($246.10 in chips)
Seat 2: RwDoM55ZeQuI2ADyJhOb2Q ($756.20 in chips)
RwDoM55ZeQuI2ADyJhOb2Q: posts small blind $1
6hvg964TSqZ3AL/0XK9aVQ: posts big blind $2
*** HOLE CARDS ***
RwDoM55ZeQuI2ADyJhOb2Q: raises $4 to $6
6hvg964TSqZ3AL/0XK9aVQ: calls $4
*** FLOP *** [5s Js 9d]
6hvg964TSqZ3AL/0XK9aVQ: checks
RwDoM55ZeQuI2ADyJhOb2Q: bets $8
6hvg964TSqZ3AL/0XK9aVQ: calls $8
*** TURN *** [5s Js 9d] [5h]
6hvg964TSqZ3AL/0XK9aVQ: checks
RwDoM55ZeQuI2ADyJhOb2Q: bets $22
6hvg964TSqZ3AL/0XK9aVQ: calls $22
*** RIVER *** [5s Js 9d 5h] [Qh]
6hvg964TSqZ3AL/0XK9aVQ: checks
RwDoM55ZeQuI2ADyJhOb2Q: bets $52
6hvg964TSqZ3AL/0XK9aVQ: folds
RwDoM55ZeQuI2ADyJhOb2Q collected $71.50 from pot
RwDoM55ZeQuI2ADyJhOb2Q: doesn't show hand
*** SUMMARY ***
Total pot $72 | Rake $0.50
Board [5s Js 9d 5h Qh]
Seat 1: 6hvg964TSqZ3AL/0XK9aVQ (big blind) folded on the River
Seat 2: RwDoM55ZeQuI2ADyJhOb2Q (button) (small blind) collected ($71.50)



PokerStars Game #59941168628:  Hold'em No Limit ($1/$2) - 2009/07/01 1:27:36 ET
Table 'UGLAZZyv+cXmnKjYin0etA' 6-max Seat #1 is the button
Seat 1: vkfxu8f/jMYKUk6Ly4eujw ($196.05 in chips)
Seat 2: eDLH1PUXFpvJBNMXBVQcGA ($277.35 in chips)
Seat 3: ygTTt5ehT4aF86q1a8/R+w ($100 in chips)
Seat 5: 54yWzRRgS0oZ+S6LwZBxMQ ($29 in chips)
eDLH1PUXFpvJBNMXBVQcGA: posts small blind $1
ygTTt5ehT4aF86q1a8/R+w: posts big blind $2
*** HOLE CARDS ***
54yWzRRgS0oZ+S6LwZBxMQ: calls $2
vkfxu8f/jMYKUk6Ly4eujw: folds
eDLH1PUXFpvJBNMXBVQcGA: folds
ygTTt5ehT4aF86q1a8/R+w: checks
*** FLOP *** [Kc Kh 5s]
ygTTt5ehT4aF86q1a8/R+w: checks
SiGJDsvRViJX05vHhA80GQ joins the table at seat #4
54yWzRRgS0oZ+S6LwZBxMQ: bets $4
ygTTt5ehT4aF86q1a8/R+w: folds
54yWzRRgS0oZ+S6LwZBxMQ collected $4.75 from pot
54yWzRRgS0oZ+S6LwZBxMQ: doesn't show hand
*** SUMMARY ***
Total pot $5 | Rake $0.25
Board [Kc Kh 5s]
Seat 1: vkfxu8f/jMYKUk6Ly4eujw (button) folded before Flop (didn't bet)
Seat 2: eDLH1PUXFpvJBNMXBVQcGA (small blind) folded before Flop
Seat 3: ygTTt5ehT4aF86q1a8/R+w (big blind) folded on the Flop
Seat 5: 54yWzRRgS0oZ+S6LwZBxMQ collected ($4.75)



PokerStars Game #59941168952:  Hold'em No Limit ($1/$2) - 2009/07/01 1:27:37 ET
Table 'YqGfR5eHfMeSjb9a+QU9rg' 9-max Seat #9 is the button
Seat 1: rW/MyplHylMSBRaoRUzWrg ($35 in chips)
Seat 2: W3Nqt1GWlTi9tXQXMNEvgw ($386.25 in chips)
Seat 3: /gll27k+xWYV7Fbki0lFDQ ($261.75 in chips)
Seat 5: CkE3IyJF1KvdaAOmZY5XqQ ($200 in chips)
Seat 6: TAfo4veNRaRlzDXMMYS3Jg ($37 in chips)
Seat 7: 41aZuLBz9nAi2GPVKabmCw ($107.45 in chips)
Seat 8: JnV3SM2D6dAFYyGZHHpvrg ($95.25 in chips)
Seat 9: /inIs/z/PcX+TniIFpaxpg ($205.20 in chips)
rW/MyplHylMSBRaoRUzWrg: posts small blind $1
W3Nqt1GWlTi9tXQXMNEvgw: posts big blind $2
GX1heJ+DSsvm7gzSPsYhhQ: sits out
*** HOLE CARDS ***
/gll27k+xWYV7Fbki0lFDQ: folds
CkE3IyJF1KvdaAOmZY5XqQ: folds
TAfo4veNRaRlzDXMMYS3Jg: folds
41aZuLBz9nAi2GPVKabmCw: calls $2
JnV3SM2D6dAFYyGZHHpvrg: folds
/inIs/z/PcX+TniIFpaxpg: folds
rW/MyplHylMSBRaoRUzWrg: folds
W3Nqt1GWlTi9tXQXMNEvgw: raises $4 to $6
41aZuLBz9nAi2GPVKabmCw: calls $4
*** FLOP *** [2d Td Ac]
W3Nqt1GWlTi9tXQXMNEvgw: checks
41aZuLBz9nAi2GPVKabmCw: checks
*** TURN *** [2d Td Ac] [Qs]
W3Nqt1GWlTi9tXQXMNEvgw: bets $4
41aZuLBz9nAi2GPVKabmCw: calls $4
*** RIVER *** [2d Td Ac Qs] [7h]
W3Nqt1GWlTi9tXQXMNEvgw: bets $8
41aZuLBz9nAi2GPVKabmCw: folds
W3Nqt1GWlTi9tXQXMNEvgw collected $20 from pot
*** SUMMARY ***
Total pot $21 | Rake $1
Board [2d Td Ac Qs 7h]
Seat 1: rW/MyplHylMSBRaoRUzWrg (small blind) folded before Flop
Seat 2: W3Nqt1GWlTi9tXQXMNEvgw (big blind) collected ($20)
Seat 3: /gll27k+xWYV7Fbki0lFDQ folded before Flop (didn't bet)
Seat 5: CkE3IyJF1KvdaAOmZY5XqQ folded before Flop (didn't bet)
Seat 6: TAfo4veNRaRlzDXMMYS3Jg folded before Flop (didn't bet)
Seat 7: 41aZuLBz9nAi2GPVKabmCw folded on the River
Seat 8: JnV3SM2D6dAFYyGZHHpvrg folded before Flop (didn't bet)
Seat 9: /inIs/z/PcX+TniIFpaxpg (button) folded before Flop (didn't bet)



PokerStars Game #59941169900:  Hold'em No Limit ($1/$2) - 2009/07/01 1:27:38 ET
Table 'mGpP9StWRnoeiBDExc6Frg' 6-max Seat #5 is the button
Seat 1: VvdR9F3I+2yELkfTVvC1dg ($282.15 in chips)
Seat 3: 7acrZUQC3Zc9BNLjoKIcLQ ($37.35 in chips)
Seat 4: 4dcDwIHRm96PwtqkpQiuiA ($82.70 in chips)
Seat 5: d1puGuVBE0fidn+5eRJ0tw ($176.95 in chips)
Seat 6: B2Ih1sr5VZk+8He7rcrMtQ ($465.05 in chips)
B2Ih1sr5VZk+8He7rcrMtQ: posts small blind $1
VvdR9F3I+2yELkfTVvC1dg: posts big blind $2
*** HOLE CARDS ***
7acrZUQC3Zc9BNLjoKIcLQ: calls $2
4dcDwIHRm96PwtqkpQiuiA: folds
d1puGuVBE0fidn+5eRJ0tw: folds
B2Ih1sr5VZk+8He7rcrMtQ: calls $1
VvdR9F3I+2yELkfTVvC1dg: checks
*** FLOP *** [Kh Ad 6s]
vkfxu8f/jMYKUk6Ly4eujw joins the table at seat #2
B2Ih1sr5VZk+8He7rcrMtQ: checks
VvdR9F3I+2yELkfTVvC1dg: checks
7acrZUQC3Zc9BNLjoKIcLQ: bets $4
B2Ih1sr5VZk+8He7rcrMtQ: folds
VvdR9F3I+2yELkfTVvC1dg: folds
7acrZUQC3Zc9BNLjoKIcLQ collected $5.70 from pot
*** SUMMARY ***
Total pot $6 | Rake $0.30
Board [Kh Ad 6s]
Seat 1: VvdR9F3I+2yELkfTVvC1dg (big blind) folded on the Flop
Seat 3: 7acrZUQC3Zc9BNLjoKIcLQ collected ($5.70)
Seat 4: 4dcDwIHRm96PwtqkpQiuiA folded before Flop (didn't bet)
Seat 5: d1puGuVBE0fidn+5eRJ0tw (button) folded before Flop (didn't bet)
Seat 6: B2Ih1sr5VZk+8He7rcrMtQ (small blind) folded on the Flop



PokerStars Game #59941171570:  Hold'em No Limit ($1/$2) - 2009/07/01 1:27:41 ET
Table '4NGNnZ/osQfNq6abYqkJeA' 6-max Seat #1 is the button
Seat 1: vkfxu8f/jMYKUk6Ly4eujw ($197 in chips)
Seat 2: 669iGNwYwgRZg3nhS+aDAQ ($94.15 in chips)
Seat 3: 54yWzRRgS0oZ+S6LwZBxMQ ($20.75 in chips)
Seat 4: sY+4Uuh5z/6AbXXaCS10jw ($214.35 in chips)
Seat 5: VvdR9F3I+2yELkfTVvC1dg ($234.80 in chips)
669iGNwYwgRZg3nhS+aDAQ: posts small blind $1
54yWzRRgS0oZ+S6LwZBxMQ: posts big blind $2
3cPMpDMgeOMAe4UceUfLsg: sits out
*** HOLE CARDS ***
sY+4Uuh5z/6AbXXaCS10jw: folds
VvdR9F3I+2yELkfTVvC1dg: raises $2 to $4
vkfxu8f/jMYKUk6Ly4eujw: folds
669iGNwYwgRZg3nhS+aDAQ: calls $3
54yWzRRgS0oZ+S6LwZBxMQ: folds
*** FLOP *** [9c Td Jh]
669iGNwYwgRZg3nhS+aDAQ: checks
VvdR9F3I+2yELkfTVvC1dg: bets $7.10
669iGNwYwgRZg3nhS+aDAQ: folds
VvdR9F3I+2yELkfTVvC1dg collected $9.50 from pot
VvdR9F3I+2yELkfTVvC1dg: doesn't show hand
*** SUMMARY ***
Total pot $10 | Rake $0.50
Board [9c Td Jh]
Seat 1: vkfxu8f/jMYKUk6Ly4eujw (button) folded before Flop (didn't bet)
Seat 2: 669iGNwYwgRZg3nhS+aDAQ (small blind) folded on the Flop
Seat 3: 54yWzRRgS0oZ+S6LwZBxMQ (big blind) folded before Flop
Seat 4: sY+4Uuh5z/6AbXXaCS10jw folded before Flop (didn't bet)
Seat 5: VvdR9F3I+2yELkfTVvC1dg collected ($9.50)



PokerStars Game #59941171728:  Hold'em No Limit ($1/$2) - 2009/07/01 1:27:41 ET
Table '8Y6PEyoNuepZTai2Q56aHw' 9-max Seat #6 is the button
Seat 1: 5Q8U6iZbeO7xJSS4qvDP5g ($298.10 in chips)
Seat 2: gDCJIAlovbPnTvMM7Dd1gA ($167.35 in chips)
Seat 3: WUlHm+ydPPHG7Lb0rePSdA ($217.10 in chips)
Seat 4: xKkwALG38OfLQ9DXuJgR1w ($243.55 in chips)
Seat 6: NtLDBSjsJQEKekh5cdinvw ($377.35 in chips)
Seat 7: Kzta8yu9vxHT4B70mjBZ+w ($208.30 in chips)
Seat 8: rW/MyplHylMSBRaoRUzWrg ($40 in chips)
Seat 9: F7m34OOfAQ7annesMHVjKw ($200 in chips)
Kzta8yu9vxHT4B70mjBZ+w: posts small blind $1
rW/MyplHylMSBRaoRUzWrg: posts big blind $2
*** HOLE CARDS ***
F7m34OOfAQ7annesMHVjKw: folds
5Q8U6iZbeO7xJSS4qvDP5g: raises $6 to $8
gDCJIAlovbPnTvMM7Dd1gA: calls $8
WUlHm+ydPPHG7Lb0rePSdA: folds
xKkwALG38OfLQ9DXuJgR1w: folds
NtLDBSjsJQEKekh5cdinvw: folds
Kzta8yu9vxHT4B70mjBZ+w: calls $7
rW/MyplHylMSBRaoRUzWrg: folds
*** FLOP *** [Ah 5h 7h]
Kzta8yu9vxHT4B70mjBZ+w: checks
5Q8U6iZbeO7xJSS4qvDP5g: checks
gDCJIAlovbPnTvMM7Dd1gA: checks
*** TURN *** [Ah 5h 7h] [4c]
Kzta8yu9vxHT4B70mjBZ+w: checks
5Q8U6iZbeO7xJSS4qvDP5g: checks
gDCJIAlovbPnTvMM7Dd1gA: checks
*** RIVER *** [Ah 5h 7h 4c] [Ks]
Kzta8yu9vxHT4B70mjBZ+w: checks
5Q8U6iZbeO7xJSS4qvDP5g: bets $20
gDCJIAlovbPnTvMM7Dd1gA: folds
Kzta8yu9vxHT4B70mjBZ+w: folds
5Q8U6iZbeO7xJSS4qvDP5g collected $24.70 from pot
5Q8U6iZbeO7xJSS4qvDP5g: doesn't show hand
*** SUMMARY ***
Total pot $26 | Rake $1.30
Board [Ah 5h 7h 4c Ks]
Seat 1: 5Q8U6iZbeO7xJSS4qvDP5g collected ($24.70)
Seat 2: gDCJIAlovbPnTvMM7Dd1gA folded on the River
Seat 3: WUlHm+ydPPHG7Lb0rePSdA folded before Flop (didn't bet)
Seat 4: xKkwALG38OfLQ9DXuJgR1w folded before Flop (didn't bet)
Seat 6: NtLDBSjsJQEKekh5cdinvw (button) folded before Flop (didn't bet)
Seat 7: Kzta8yu9vxHT4B70mjBZ+w (small blind) folded on the River
Seat 8: rW/MyplHylMSBRaoRUzWrg (big blind) folded before Flop
Seat 9: F7m34OOfAQ7annesMHVjKw folded before Flop (didn't bet)



PokerStars Game #59941171902:  Hold'em No Limit ($1/$2) - 2009/07/01 1:27:42 ET
Table '/dyk+YdRGv90j2box35j8w' 6-max Seat #5 is the button
Seat 1: 8srN1dKQePlsv0GyTada+Q ($204 in chips)
Seat 2: qCnEYuAE5y5A7bk6fO5/jQ ($476.60 in chips)
Seat 4: z/u1YTnkiIDrtp/2cA2dBg ($202.05 in chips)
Seat 5: VvdR9F3I+2yELkfTVvC1dg ($200 in chips)
8srN1dKQePlsv0GyTada+Q: posts small blind $1
qCnEYuAE5y5A7bk6fO5/jQ: posts big blind $2
*** HOLE CARDS ***
z/u1YTnkiIDrtp/2cA2dBg: folds
VvdR9F3I+2yELkfTVvC1dg: folds
8srN1dKQePlsv0GyTada+Q: calls $1
qCnEYuAE5y5A7bk6fO5/jQ: checks
*** FLOP *** [Jh 9s 2h]
8srN1dKQePlsv0GyTada+Q: bets $4
qCnEYuAE5y5A7bk6fO5/jQ: folds
8srN1dKQePlsv0GyTada+Q collected $3.80 from pot
8srN1dKQePlsv0GyTada+Q: doesn't show hand
*** SUMMARY ***
Total pot $4 | Rake $0.20
Board [Jh 9s 2h]
Seat 1: 8srN1dKQePlsv0GyTada+Q (small blind) collected ($3.80)
Seat 2: qCnEYuAE5y5A7bk6fO5/jQ (big blind) folded on the Flop
Seat 4: z/u1YTnkiIDrtp/2cA2dBg folded before Flop (didn't bet)
Seat 5: VvdR9F3I+2yELkfTVvC1dg (button) folded before Flop (didn't bet)



PokerStars Game #59941175780:  Hold'em No Limit ($1/$2) - 2009/07/01 1:27:48 ET
Table 'eyAQSIlgc2o1Jxvbve4WGg' 9-max Seat #5 is the button
Seat 1: UZEsV9yKUMqmpYPiOFpaZw ($105.20 in chips)
Seat 2: g7gL2NLJCdZPPV399WKT1w ($70.25 in chips)
Seat 3: ice1Sbe19zWIaKYoSmE5tw ($98.30 in chips)
Seat 4: CkE3IyJF1KvdaAOmZY5XqQ ($200 in chips)
Seat 5: mIKx5lhIt13X5eZQH0ZeMA ($77.80 in chips)
Seat 6: nXDI8Y/S6POzRwANu3d8hQ ($38 in chips)
Seat 7: u3OrI5uGx9mx1fE7dgr+EA ($80.20 in chips)
Seat 8: 1CtiZuXDFaJL1dJPQKyi8Q ($158.35 in chips)
Seat 9: WUlHm+ydPPHG7Lb0rePSdA ($128.95 in chips)
nXDI8Y/S6POzRwANu3d8hQ: posts small blind $1
u3OrI5uGx9mx1fE7dgr+EA: posts big blind $2
*** HOLE CARDS ***
1CtiZuXDFaJL1dJPQKyi8Q: folds
WUlHm+ydPPHG7Lb0rePSdA: folds
UZEsV9yKUMqmpYPiOFpaZw: folds
g7gL2NLJCdZPPV399WKT1w: raises $4 to $6
ice1Sbe19zWIaKYoSmE5tw: folds
CkE3IyJF1KvdaAOmZY5XqQ: folds
mIKx5lhIt13X5eZQH0ZeMA: folds
nXDI8Y/S6POzRwANu3d8hQ: raises $14 to $20
u3OrI5uGx9mx1fE7dgr+EA: folds
g7gL2NLJCdZPPV399WKT1w: folds
nXDI8Y/S6POzRwANu3d8hQ collected $14 from pot
nXDI8Y/S6POzRwANu3d8hQ: doesn't show hand
*** SUMMARY ***
Total pot $14 | Rake $0
Seat 1: UZEsV9yKUMqmpYPiOFpaZw folded before Flop (didn't bet)
Seat 2: g7gL2NLJCdZPPV399WKT1w folded before Flop
Seat 3: ice1Sbe19zWIaKYoSmE5tw folded before Flop (didn't bet)
Seat 4: CkE3IyJF1KvdaAOmZY5XqQ folded before Flop (didn't bet)
Seat 5: mIKx5lhIt13X5eZQH0ZeMA (button) folded before Flop (didn't bet)
Seat 6: nXDI8Y/S6POzRwANu3d8hQ (small blind) collected ($14)
Seat 7: u3OrI5uGx9mx1fE7dgr+EA (big blind) folded before Flop
Seat 8: 1CtiZuXDFaJL1dJPQKyi8Q folded before Flop (didn't bet)
Seat 9: WUlHm+ydPPHG7Lb0rePSdA folded before Flop (didn't bet)



PokerStars Game #59941176032:  Hold'em No Limit ($1/$2) - 2009/07/01 1:27:49 ET
Table 'gnHBqWll9O3fxG7Ojkz/ng' 9-max Seat #2 is the button
Seat 1: TAfo4veNRaRlzDXMMYS3Jg ($34 in chips)
Seat 2: H6Z4+qu8gR0VUiPOijndVg ($324.25 in chips)
Seat 3: 5Q8U6iZbeO7xJSS4qvDP5g ($209 in chips)
Seat 4: nXDI8Y/S6POzRwANu3d8hQ ($40 in chips)
Seat 5: rBQDMkKm9cZn6M9NPsiVew ($226.45 in chips)
Seat 6: /inIs/z/PcX+TniIFpaxpg ($68.10 in chips)
Seat 7: jqui3xAWCkcdPW36a6BD+w ($344.95 in chips)
Seat 8: cM6efHzdxoqYm0EQKP4TTQ ($94.45 in chips)
Seat 9: GX1heJ+DSsvm7gzSPsYhhQ ($54.35 in chips)
5Q8U6iZbeO7xJSS4qvDP5g: posts small blind $1
nXDI8Y/S6POzRwANu3d8hQ: posts big blind $2
*** HOLE CARDS ***
rBQDMkKm9cZn6M9NPsiVew: folds
/inIs/z/PcX+TniIFpaxpg: folds
jqui3xAWCkcdPW36a6BD+w: folds
cM6efHzdxoqYm0EQKP4TTQ: folds
GX1heJ+DSsvm7gzSPsYhhQ: folds
TAfo4veNRaRlzDXMMYS3Jg: folds
H6Z4+qu8gR0VUiPOijndVg: folds
5Q8U6iZbeO7xJSS4qvDP5g: raises $6 to $8
nXDI8Y/S6POzRwANu3d8hQ: folds
5Q8U6iZbeO7xJSS4qvDP5g collected $4 from pot
5Q8U6iZbeO7xJSS4qvDP5g: doesn't show hand
*** SUMMARY ***
Total pot $4 | Rake $0
Seat 1: TAfo4veNRaRlzDXMMYS3Jg folded before Flop (didn't bet)
Seat 2: H6Z4+qu8gR0VUiPOijndVg (button) folded before Flop (didn't bet)
Seat 3: 5Q8U6iZbeO7xJSS4qvDP5g (small blind) collected ($4)
Seat 4: nXDI8Y/S6POzRwANu3d8hQ (big blind) folded before Flop
Seat 5: rBQDMkKm9cZn6M9NPsiVew folded before Flop (didn't bet)
Seat 6: /inIs/z/PcX+TniIFpaxpg folded before Flop (didn't bet)
Seat 7: jqui3xAWCkcdPW36a6BD+w folded before Flop (didn't bet)
Seat 8: cM6efHzdxoqYm0EQKP4TTQ folded before Flop (didn't bet)
Seat 9: GX1heJ+DSsvm7gzSPsYhhQ folded before Flop (didn't bet)



PokerStars Game #59941176838:  Hold'em No Limit ($1/$2) - 2009/07/01 1:27:50 ET
Table 'aSf77Sj8QEnzcc0WaxVD4Q' 6-max Seat #4 is the button
Seat 1: UELtvp+JfwI7XDGVwSxZXA ($159.55 in chips)
Seat 2: vkfxu8f/jMYKUk6Ly4eujw ($206 in chips)
Seat 3: 9dpyyjDTCed6nV7JhaUUpw ($523.70 in chips)
Seat 4: YsLQ3BAvgQHWXMAv3Wv6Hg ($259.70 in chips)
Seat 5: VvdR9F3I+2yELkfTVvC1dg ($241 in chips)
Seat 6: vkoJRf3gidxY1pPi0AFWww ($126.15 in chips)
VvdR9F3I+2yELkfTVvC1dg: posts small blind $1
vkoJRf3gidxY1pPi0AFWww: posts big blind $2
*** HOLE CARDS ***
UELtvp+JfwI7XDGVwSxZXA: folds
vkfxu8f/jMYKUk6Ly4eujw: folds
9dpyyjDTCed6nV7JhaUUpw: raises $4 to $6
YsLQ3BAvgQHWXMAv3Wv6Hg: folds
VvdR9F3I+2yELkfTVvC1dg: folds
vkoJRf3gidxY1pPi0AFWww: folds
9dpyyjDTCed6nV7JhaUUpw collected $5 from pot
9dpyyjDTCed6nV7JhaUUpw: doesn't show hand
*** SUMMARY ***
Total pot $5 | Rake $0
Seat 1: UELtvp+JfwI7XDGVwSxZXA folded before Flop (didn't bet)
Seat 2: vkfxu8f/jMYKUk6Ly4eujw folded before Flop (didn't bet)
Seat 3: 9dpyyjDTCed6nV7JhaUUpw collected ($5)
Seat 4: YsLQ3BAvgQHWXMAv3Wv6Hg (button) folded before Flop (didn't bet)
Seat 5: VvdR9F3I+2yELkfTVvC1dg (small blind) folded before Flop
Seat 6: vkoJRf3gidxY1pPi0AFWww (big blind) folded before Flop



PokerStars Game #59941176786:  Hold'em No Limit ($1/$2) - 2009/07/01 1:27:50 ET
Table 'on4i1U1lCRmxsduFD3xiSg' 9-max Seat #2 is the button
Seat 1: so5k3vFDmokh2q3dImJ1GQ ($179.30 in chips)
Seat 2: NqSvZNzJ4RkR3sCmgQnyLw ($38.45 in chips)
Seat 3: GX1heJ+DSsvm7gzSPsYhhQ ($38.70 in chips)
Seat 4: DFQVuszLVclqjA46pN4Vvw ($27.85 in chips)
Seat 5: 37j/5DgMG5m9lMfFofEAOg ($87.35 in chips)
Seat 7: /inIs/z/PcX+TniIFpaxpg ($302.40 in chips)
Seat 9: iMe5yhc+1BaiIPHet3NMrA ($200 in chips)
GX1heJ+DSsvm7gzSPsYhhQ: posts small blind $1
DFQVuszLVclqjA46pN4Vvw: posts big blind $2
+T/63sAeZzWyHchahJ36GQ: sits out
ZYHoLw2lWmRS7CSHi8L8Xg: sits out
*** HOLE CARDS ***
37j/5DgMG5m9lMfFofEAOg: folds
/inIs/z/PcX+TniIFpaxpg: folds
iMe5yhc+1BaiIPHet3NMrA: raises $4 to $6
so5k3vFDmokh2q3dImJ1GQ: folds
NqSvZNzJ4RkR3sCmgQnyLw: calls $6
GX1heJ+DSsvm7gzSPsYhhQ: folds
DFQVuszLVclqjA46pN4Vvw: folds
*** FLOP *** [Jd 3s Jh]
iMe5yhc+1BaiIPHet3NMrA: bets $8
NqSvZNzJ4RkR3sCmgQnyLw: folds
iMe5yhc+1BaiIPHet3NMrA collected $14.25 from pot
*** SUMMARY ***
Total pot $15 | Rake $0.75
Board [Jd 3s Jh]
Seat 1: so5k3vFDmokh2q3dImJ1GQ folded before Flop (didn't bet)
Seat 2: NqSvZNzJ4RkR3sCmgQnyLw (button) folded on the Flop
Seat 3: GX1heJ+DSsvm7gzSPsYhhQ (small blind) folded before Flop
Seat 4: DFQVuszLVclqjA46pN4Vvw (big blind) folded before Flop
Seat 5: 37j/5DgMG5m9lMfFofEAOg folded before Flop (didn't bet)
Seat 7: /inIs/z/PcX+TniIFpaxpg folded before Flop (didn't bet)
Seat 9: iMe5yhc+1BaiIPHet3NMrA collected ($14.25)



PokerStars Game #59941178320:  Hold'em No Limit ($1/$2) - 2009/07/01 1:27:53 ET
Table 'rKeCh+eBn4RNvybCUYkoTQ' 9-max Seat #3 is the button
Seat 1: /inIs/z/PcX+TniIFpaxpg ($200 in chips)
Seat 2: 9cBHwK40Tl06vheE7B3LHQ ($159.55 in chips)
Seat 3: GX1heJ+DSsvm7gzSPsYhhQ ($31 in chips)
Seat 4: 31HuO+DQxppUQEedBWukug ($90.10 in chips)
Seat 5: WUlHm+ydPPHG7Lb0rePSdA ($128 in chips)
Seat 6: EBV6OktyeSmh4w6sWmcWOw ($270 in chips)
Seat 7: rW/MyplHylMSBRaoRUzWrg ($34 in chips)
Seat 8: pN/Ip0ePsUVIdUlGgLrkUw ($215.35 in chips)
Seat 9: Kzta8yu9vxHT4B70mjBZ+w ($211.25 in chips)
31HuO+DQxppUQEedBWukug: posts small blind $1
WUlHm+ydPPHG7Lb0rePSdA: posts big blind $2
*** HOLE CARDS ***
EBV6OktyeSmh4w6sWmcWOw: folds
rW/MyplHylMSBRaoRUzWrg: folds
pN/Ip0ePsUVIdUlGgLrkUw: folds
Kzta8yu9vxHT4B70mjBZ+w: folds
/inIs/z/PcX+TniIFpaxpg: folds
9cBHwK40Tl06vheE7B3LHQ: folds
GX1heJ+DSsvm7gzSPsYhhQ: folds
31HuO+DQxppUQEedBWukug: folds
WUlHm+ydPPHG7Lb0rePSdA collected $2 from pot
WUlHm+ydPPHG7Lb0rePSdA: doesn't show hand
*** SUMMARY ***
Total pot $2 | Rake $0
Seat 1: /inIs/z/PcX+TniIFpaxpg folded before Flop (didn't bet)
Seat 2: 9cBHwK40Tl06vheE7B3LHQ folded before Flop (didn't bet)
Seat 3: GX1heJ+DSsvm7gzSPsYhhQ (button) folded before Flop (didn't bet)
Seat 4: 31HuO+DQxppUQEedBWukug (small blind) folded before Flop
Seat 5: WUlHm+ydPPHG7Lb0rePSdA (big blind) collected ($2)
Seat 6: EBV6OktyeSmh4w6sWmcWOw folded before Flop (didn't bet)
Seat 7: rW/MyplHylMSBRaoRUzWrg folded before Flop (didn't bet)
Seat 8: pN/Ip0ePsUVIdUlGgLrkUw folded before Flop (didn't bet)
Seat 9: Kzta8yu9vxHT4B70mjBZ+w folded before Flop (didn't bet)



PokerStars Game #59941178718:  Hold'em No Limit ($1/$2) - 2009/07/01 1:27:53 ET
Table 'jlrIxbrVIG+gjaUYT4za8g' 6-max Seat #4 is the button
Seat 1: ygTTt5ehT4aF86q1a8/R+w ($261.30 in chips)
Seat 2: on4ebXPJvUBOcHOBMQsRSg ($72.80 in chips)
Seat 4: 8srN1dKQePlsv0GyTada+Q ($297.35 in chips)
Seat 5: AyBB0k3Dcl7xbXUeGMw06g ($72.90 in chips)
Seat 6: vkfxu8f/jMYKUk6Ly4eujw ($309 in chips)
AyBB0k3Dcl7xbXUeGMw06g: posts small blind $1
vkfxu8f/jMYKUk6Ly4eujw: posts big blind $2
*** HOLE CARDS ***
ygTTt5ehT4aF86q1a8/R+w: folds
on4ebXPJvUBOcHOBMQsRSg: folds
gnYme0DNFflnMhrdbxe1Ag joins the table at seat #3
8srN1dKQePlsv0GyTada+Q: folds
AyBB0k3Dcl7xbXUeGMw06g: folds
vkfxu8f/jMYKUk6Ly4eujw collected $2 from pot
*** SUMMARY ***
Total pot $2 | Rake $0
Seat 1: ygTTt5ehT4aF86q1a8/R+w folded before Flop (didn't bet)
Seat 2: on4ebXPJvUBOcHOBMQsRSg folded before Flop (didn't bet)
Seat 4: 8srN1dKQePlsv0GyTada+Q (button) folded before Flop (didn't bet)
Seat 5: AyBB0k3Dcl7xbXUeGMw06g (small blind) folded before Flop
Seat 6: vkfxu8f/jMYKUk6Ly4eujw (big blind) collected ($2)



PokerStars Game #59941179374:  Hold'em No Limit ($1/$2) - 2009/07/01 1:27:55 ET
Table 'ZzSIe0zTCDv+n6hfbY5tTg' 6-max Seat #5 is the button
Seat 1: VvdR9F3I+2yELkfTVvC1dg ($201 in chips)
Seat 2: B87ikIyZ/TzAVeXf38Ny0g ($286 in chips)
Seat 3: gsugPj31Hui3Jefl98MBOA ($200 in chips)
Seat 4: qXDd0ZyMIse0OBu8pxeQ3Q ($209.70 in chips)
Seat 5: 3dAbvkxS5NPQTBAbvpinVg ($480.30 in chips)
Seat 6: 09BNF4quPDzanQzM8vc6WA ($24.05 in chips)
09BNF4quPDzanQzM8vc6WA: posts small blind $1
VvdR9F3I+2yELkfTVvC1dg: posts big blind $2
*** HOLE CARDS ***
B87ikIyZ/TzAVeXf38Ny0g: folds
gsugPj31Hui3Jefl98MBOA: raises $5 to $7
qXDd0ZyMIse0OBu8pxeQ3Q: folds
3dAbvkxS5NPQTBAbvpinVg: folds
09BNF4quPDzanQzM8vc6WA: folds
VvdR9F3I+2yELkfTVvC1dg: folds
gsugPj31Hui3Jefl98MBOA collected $5 from pot
*** SUMMARY ***
Total pot $5 | Rake $0
Seat 1: VvdR9F3I+2yELkfTVvC1dg (big blind) folded before Flop
Seat 2: B87ikIyZ/TzAVeXf38Ny0g folded before Flop (didn't bet)
Seat 3: gsugPj31Hui3Jefl98MBOA collected ($5)
Seat 4: qXDd0ZyMIse0OBu8pxeQ3Q folded before Flop (didn't bet)
Seat 5: 3dAbvkxS5NPQTBAbvpinVg (button) folded before Flop (didn't bet)
Seat 6: 09BNF4quPDzanQzM8vc6WA (small blind) folded before Flop



PokerStars Game #59941179590:  Hold'em No Limit ($1/$2) - 2009/07/01 1:27:55 ET
Table 'AtOXMvcrtQM8yLNcALmfLQ' 2-max Seat #1 is the button
Seat 1: +HlQuAsMqZGYYtjcPO/a3A ($280.30 in chips)
Seat 2: pVqEzK9wXlRMECnb1Zg4Zw ($114.40 in chips)
+HlQuAsMqZGYYtjcPO/a3A: posts small blind $1
pVqEzK9wXlRMECnb1Zg4Zw: posts big blind $2
*** HOLE CARDS ***
+HlQuAsMqZGYYtjcPO/a3A: folds
pVqEzK9wXlRMECnb1Zg4Zw collected $2 from pot
pVqEzK9wXlRMECnb1Zg4Zw: doesn't show hand
*** SUMMARY ***
Total pot $2 | Rake $0
Seat 1: +HlQuAsMqZGYYtjcPO/a3A (button) (small blind) folded before Flop
Seat 2: pVqEzK9wXlRMECnb1Zg4Zw (big blind) collected ($2)



PokerStars Game #59941180390:  Hold'em No Limit ($1/$2) - 2009/07/01 1:27:56 ET
Table 'kq5zaQ+1hLNf8LZfGnbTAA' 6-max Seat #4 is the button
Seat 1: 8srN1dKQePlsv0GyTada+Q ($408 in chips)
Seat 2: nXDI8Y/S6POzRwANu3d8hQ ($197 in chips)
Seat 3: vkfxu8f/jMYKUk6Ly4eujw ($224.95 in chips)
Seat 4: 3dAbvkxS5NPQTBAbvpinVg ($200 in chips)
Seat 5: kfASJqTbXek+zc8ZKsZL1Q ($67.45 in chips)
Seat 6: mfy7uGZcqA2PVQqEVbJ7+g ($197.25 in chips)
kfASJqTbXek+zc8ZKsZL1Q: posts small blind $1
mfy7uGZcqA2PVQqEVbJ7+g: posts big blind $2
*** HOLE CARDS ***
8srN1dKQePlsv0GyTada+Q: folds
nXDI8Y/S6POzRwANu3d8hQ: folds
vkfxu8f/jMYKUk6Ly4eujw: folds
3dAbvkxS5NPQTBAbvpinVg: raises $4 to $6
kfASJqTbXek+zc8ZKsZL1Q: folds
mfy7uGZcqA2PVQqEVbJ7+g: folds
3dAbvkxS5NPQTBAbvpinVg collected $5 from pot
3dAbvkxS5NPQTBAbvpinVg: doesn't show hand
*** SUMMARY ***
Total pot $5 | Rake $0
Seat 1: 8srN1dKQePlsv0GyTada+Q folded before Flop (didn't bet)
Seat 2: nXDI8Y/S6POzRwANu3d8hQ folded before Flop (didn't bet)
Seat 3: vkfxu8f/jMYKUk6Ly4eujw folded before Flop (didn't bet)
Seat 4: 3dAbvkxS5NPQTBAbvpinVg (button) collected ($5)
Seat 5: kfASJqTbXek+zc8ZKsZL1Q (small blind) folded before Flop
Seat 6: mfy7uGZcqA2PVQqEVbJ7+g (big blind) folded before Flop



PokerStars Game #59941180476:  Hold'em No Limit ($1/$2) - 2009/07/01 1:27:57 ET
Table 'rsKRKlGHlxVyqJxzO2a2Ow' 9-max Seat #3 is the button
Seat 1: uYWfQJg2hgHLxri6/uVJiw ($387.65 in chips)
Seat 3: zTcFtoHqqK4550YMZ8Y14Q ($42.30 in chips)
Seat 4: 31HuO+DQxppUQEedBWukug ($112.85 in chips)
Seat 5: 5Q8U6iZbeO7xJSS4qvDP5g ($202 in chips)
Seat 6: H6Z4+qu8gR0VUiPOijndVg ($204.55 in chips)
Seat 7: GX1heJ+DSsvm7gzSPsYhhQ ($33 in chips)
Seat 8: CkE3IyJF1KvdaAOmZY5XqQ ($215.75 in chips)
Seat 9: gRbvhSUVg+TNaTjaJecIRw ($24 in chips)
31HuO+DQxppUQEedBWukug: posts small blind $1
5Q8U6iZbeO7xJSS4qvDP5g: posts big blind $2
*** HOLE CARDS ***
H6Z4+qu8gR0VUiPOijndVg: folds
GX1heJ+DSsvm7gzSPsYhhQ: folds
CkE3IyJF1KvdaAOmZY5XqQ: raises $6 to $8
gRbvhSUVg+TNaTjaJecIRw: folds
uYWfQJg2hgHLxri6/uVJiw: folds
zTcFtoHqqK4550YMZ8Y14Q: folds
31HuO+DQxppUQEedBWukug: folds
QHxJjpVYwitg9krW6wZgJA leaves the table
+T/63sAeZzWyHchahJ36GQ joins the table at seat #2
5Q8U6iZbeO7xJSS4qvDP5g: raises $16 to $24
CkE3IyJF1KvdaAOmZY5XqQ: calls $16
*** FLOP *** [Ts Tc Kd]
5Q8U6iZbeO7xJSS4qvDP5g: bets $34
CkE3IyJF1KvdaAOmZY5XqQ: folds
5Q8U6iZbeO7xJSS4qvDP5g collected $46.55 from pot
5Q8U6iZbeO7xJSS4qvDP5g: doesn't show hand
*** SUMMARY ***
Total pot $49 | Rake $2.45
Board [Ts Tc Kd]
Seat 1: uYWfQJg2hgHLxri6/uVJiw folded before Flop (didn't bet)
Seat 3: zTcFtoHqqK4550YMZ8Y14Q (button) folded before Flop (didn't bet)
Seat 4: 31HuO+DQxppUQEedBWukug (small blind) folded before Flop
Seat 5: 5Q8U6iZbeO7xJSS4qvDP5g (big blind) collected ($46.55)
Seat 6: H6Z4+qu8gR0VUiPOijndVg folded before Flop (didn't bet)
Seat 7: GX1heJ+DSsvm7gzSPsYhhQ folded before Flop (didn't bet)
Seat 8: CkE3IyJF1KvdaAOmZY5XqQ folded on the Flop
Seat 9: gRbvhSUVg+TNaTjaJecIRw folded before Flop (didn't bet)



PokerStars Game #59941181372:  Hold'em No Limit ($1/$2) - 2009/07/01 1:27:58 ET
Table 'pPQgcj9XT9CHBsbo1WTBug' 6-max Seat #5 is the button
Seat 1: DFVYDA6dKQy7R7mGIKogZA ($155.20 in chips)
Seat 2: qXDd0ZyMIse0OBu8pxeQ3Q ($200 in chips)
Seat 3: 54yWzRRgS0oZ+S6LwZBxMQ ($52.75 in chips)
Seat 4: gqlysXCbT8V54f/1lf9h3A ($36.10 in chips)
Seat 5: vkfxu8f/jMYKUk6Ly4eujw ($199.55 in chips)
Seat 6: Yr7pZltpy3IUNdKS9PCEiw ($302.30 in chips)
Yr7pZltpy3IUNdKS9PCEiw: posts small blind $1
DFVYDA6dKQy7R7mGIKogZA: posts big blind $2
*** HOLE CARDS ***
qXDd0ZyMIse0OBu8pxeQ3Q: folds
54yWzRRgS0oZ+S6LwZBxMQ: folds
gqlysXCbT8V54f/1lf9h3A: folds
vkfxu8f/jMYKUk6Ly4eujw: folds
Yr7pZltpy3IUNdKS9PCEiw: folds
DFVYDA6dKQy7R7mGIKogZA collected $2 from pot
*** SUMMARY ***
Total pot $2 | Rake $0
Seat 1: DFVYDA6dKQy7R7mGIKogZA (big blind) collected ($2)
Seat 2: qXDd0ZyMIse0OBu8pxeQ3Q folded before Flop (didn't bet)
Seat 3: 54yWzRRgS0oZ+S6LwZBxMQ folded before Flop (didn't bet)
Seat 4: gqlysXCbT8V54f/1lf9h3A folded before Flop (didn't bet)
Seat 5: vkfxu8f/jMYKUk6Ly4eujw (button) folded before Flop (didn't bet)
Seat 6: Yr7pZltpy3IUNdKS9PCEiw (small blind) folded before Flop



PokerStars Game #59941182646:  Hold'em No Limit ($1/$2) - 2009/07/01 1:28:00 ET
Table 'CFkQcfWjKccZaZDf71FK+w' 6-max Seat #2 is the button
Seat 1: JsC+WvfzqlxVs9G8/gSQAQ ($18.05 in chips)
Seat 2: ewN/vzF22+/gdzjIKBOlkA ($207.80 in chips)
Seat 3: 09BNF4quPDzanQzM8vc6WA ($46.45 in chips)
Seat 4: ygTTt5ehT4aF86q1a8/R+w ($287.25 in chips)
Seat 5: 2lOU1DcvUZaMcxZ95XfzXw ($123 in chips)
09BNF4quPDzanQzM8vc6WA: posts small blind $1
ygTTt5ehT4aF86q1a8/R+w: posts big blind $2
*** HOLE CARDS ***
2lOU1DcvUZaMcxZ95XfzXw: calls $2
ORVqY3rf9X6ANA/8s+On2Q has returned
JsC+WvfzqlxVs9G8/gSQAQ: raises $6 to $8
ewN/vzF22+/gdzjIKBOlkA: folds
09BNF4quPDzanQzM8vc6WA: folds
ygTTt5ehT4aF86q1a8/R+w: folds
2lOU1DcvUZaMcxZ95XfzXw: calls $6
*** FLOP *** [Th 6h 6c]
2lOU1DcvUZaMcxZ95XfzXw: checks
JsC+WvfzqlxVs9G8/gSQAQ: bets $10.05 and is all-in
2lOU1DcvUZaMcxZ95XfzXw: calls $10.05
*** TURN *** [Th 6h 6c] [3s]
*** RIVER *** [Th 6h 6c 3s] [5c]
*** SHOW DOWN ***
2lOU1DcvUZaMcxZ95XfzXw: shows [Ad Jc] (a pair of Sixes)
JsC+WvfzqlxVs9G8/gSQAQ: mucks hand
2lOU1DcvUZaMcxZ95XfzXw collected $37.20 from pot
*** SUMMARY ***
Total pot $39.10 | Rake $1.90
Board [Th 6h 6c 3s 5c]
Seat 1: JsC+WvfzqlxVs9G8/gSQAQ mucked
Seat 2: ewN/vzF22+/gdzjIKBOlkA (button) folded before Flop (didn't bet)
Seat 3: 09BNF4quPDzanQzM8vc6WA (small blind) folded before Flop
Seat 4: ygTTt5ehT4aF86q1a8/R+w (big blind) folded before Flop
Seat 5: 2lOU1DcvUZaMcxZ95XfzXw showed [Ad Jc] and won ($37.20) with a pair of Sixes



PokerStars Game #59941183130:  Hold'em No Limit ($1/$2) - 2009/07/01 1:28:01 ET
Table 'qVXak+oTeDXMGbWa4sDU5Q' 9-max Seat #7 is the button
Seat 1: H6Z4+qu8gR0VUiPOijndVg ($212.55 in chips)
Seat 2: rW/MyplHylMSBRaoRUzWrg ($74 in chips)
Seat 3: WUlHm+ydPPHG7Lb0rePSdA ($153.65 in chips)
Seat 4: lQYT23h5QCUVZAKxjOO39Q ($200 in chips)
Seat 5: FWGiDqRwvLeKmHq9t4Jy9w ($268.80 in chips)
Seat 6: GX1heJ+DSsvm7gzSPsYhhQ ($34 in chips)
Seat 7: PfmlvZlFiss79a6IoEr11g ($163.30 in chips)
Seat 8: Z0rzUi0y1x80UdIpofoNbA ($124.55 in chips)
Seat 9: CkE3IyJF1KvdaAOmZY5XqQ ($200 in chips)
Z0rzUi0y1x80UdIpofoNbA: posts small blind $1
CkE3IyJF1KvdaAOmZY5XqQ: posts big blind $2
*** HOLE CARDS ***
H6Z4+qu8gR0VUiPOijndVg: folds
rW/MyplHylMSBRaoRUzWrg: folds
WUlHm+ydPPHG7Lb0rePSdA: folds
lQYT23h5QCUVZAKxjOO39Q: calls $2
FWGiDqRwvLeKmHq9t4Jy9w: folds
GX1heJ+DSsvm7gzSPsYhhQ: folds
PfmlvZlFiss79a6IoEr11g: folds
Z0rzUi0y1x80UdIpofoNbA: calls $1
CkE3IyJF1KvdaAOmZY5XqQ: checks
*** FLOP *** [4c Ad 6d]
Z0rzUi0y1x80UdIpofoNbA: checks
CkE3IyJF1KvdaAOmZY5XqQ: checks
lQYT23h5QCUVZAKxjOO39Q: bets $4
Z0rzUi0y1x80UdIpofoNbA: folds
CkE3IyJF1KvdaAOmZY5XqQ: folds
lQYT23h5QCUVZAKxjOO39Q collected $5.70 from pot
*** SUMMARY ***
Total pot $6 | Rake $0.30
Board [4c Ad 6d]
Seat 1: H6Z4+qu8gR0VUiPOijndVg folded before Flop (didn't bet)
Seat 2: rW/MyplHylMSBRaoRUzWrg folded before Flop (didn't bet)
Seat 3: WUlHm+ydPPHG7Lb0rePSdA folded before Flop (didn't bet)
Seat 4: lQYT23h5QCUVZAKxjOO39Q collected ($5.70)
Seat 5: FWGiDqRwvLeKmHq9t4Jy9w folded before Flop (didn't bet)
Seat 6: GX1heJ+DSsvm7gzSPsYhhQ folded before Flop (didn't bet)
Seat 7: PfmlvZlFiss79a6IoEr11g (button) folded before Flop (didn't bet)
Seat 8: Z0rzUi0y1x80UdIpofoNbA (small blind) folded on the Flop
Seat 9: CkE3IyJF1KvdaAOmZY5XqQ (big blind) folded on the Flop



PokerStars Game #59941183482:  Hold'em No Limit ($1/$2) - 2009/07/01 1:28:02 ET
Table 'QxerF7GUfCbl+4a8XaTB2w' 6-max Seat #3 is the button
Seat 1: 54yWzRRgS0oZ+S6LwZBxMQ ($32 in chips)
Seat 2: HiWSAXs6/0w9Jy7ioiiShQ ($35 in chips)
Seat 3: m7mYVfnCOK5TE/VkN/FhOg ($281.10 in chips)
Seat 4: 09BNF4quPDzanQzM8vc6WA ($46.55 in chips)
Seat 5: gnYme0DNFflnMhrdbxe1Ag ($244.70 in chips)
Seat 6: VvdR9F3I+2yELkfTVvC1dg ($200 in chips)
09BNF4quPDzanQzM8vc6WA: posts small blind $1
gnYme0DNFflnMhrdbxe1Ag: posts big blind $2
*** HOLE CARDS ***
VvdR9F3I+2yELkfTVvC1dg: folds
54yWzRRgS0oZ+S6LwZBxMQ: folds
HiWSAXs6/0w9Jy7ioiiShQ: calls $2
m7mYVfnCOK5TE/VkN/FhOg: calls $2
09BNF4quPDzanQzM8vc6WA: folds
gnYme0DNFflnMhrdbxe1Ag: checks
*** FLOP *** [4s As 4d]
gnYme0DNFflnMhrdbxe1Ag: checks
HiWSAXs6/0w9Jy7ioiiShQ: bets $4
m7mYVfnCOK5TE/VkN/FhOg: folds
gnYme0DNFflnMhrdbxe1Ag: folds
HiWSAXs6/0w9Jy7ioiiShQ collected $6.65 from pot
HiWSAXs6/0w9Jy7ioiiShQ: doesn't show hand
*** SUMMARY ***
Total pot $7 | Rake $0.35
Board [4s As 4d]
Seat 1: 54yWzRRgS0oZ+S6LwZBxMQ folded before Flop (didn't bet)
Seat 2: HiWSAXs6/0w9Jy7ioiiShQ collected ($6.65)
Seat 3: m7mYVfnCOK5TE/VkN/FhOg (button) folded on the Flop
Seat 4: 09BNF4quPDzanQzM8vc6WA (small blind) folded before Flop
Seat 5: gnYme0DNFflnMhrdbxe1Ag (big blind) folded on the Flop
Seat 6: VvdR9F3I+2yELkfTVvC1dg folded before Flop (didn't bet)



PokerStars Game #59941184878:  Hold'em No Limit ($1/$2) - 2009/07/01 1:28:04 ET
Table 'uJ9juaXXg9yIcSU8amxaXQ' 6-max Seat #4 is the button
Seat 1: JsqOjN/eHz0uYVf/PyUJ6Q ($144.50 in chips)
Seat 2: VvdR9F3I+2yELkfTVvC1dg ($200 in chips)
Seat 3: qXDd0ZyMIse0OBu8pxeQ3Q ($244 in chips)
Seat 4: zNjJ/y4emmF+vzrCDd+ooA ($237.05 in chips)
Seat 5: YsLQ3BAvgQHWXMAv3Wv6Hg ($200 in chips)
Seat 6: 2DFp9Veq1xxq64dCjwNuUw ($59.60 in chips)
YsLQ3BAvgQHWXMAv3Wv6Hg: posts small blind $1
2DFp9Veq1xxq64dCjwNuUw: posts big blind $2
*** HOLE CARDS ***
JsqOjN/eHz0uYVf/PyUJ6Q: folds
VvdR9F3I+2yELkfTVvC1dg: raises $2 to $4
qXDd0ZyMIse0OBu8pxeQ3Q: folds
zNjJ/y4emmF+vzrCDd+ooA: folds
YsLQ3BAvgQHWXMAv3Wv6Hg: calls $3
2DFp9Veq1xxq64dCjwNuUw: calls $2
*** FLOP *** [4h 2d 5d]
YsLQ3BAvgQHWXMAv3Wv6Hg: bets $8
2DFp9Veq1xxq64dCjwNuUw: folds
VvdR9F3I+2yELkfTVvC1dg: calls $8
*** TURN *** [4h 2d 5d] [4d]
YsLQ3BAvgQHWXMAv3Wv6Hg: bets $16
VvdR9F3I+2yELkfTVvC1dg: calls $16
*** RIVER *** [4h 2d 5d 4d] [Ah]
YsLQ3BAvgQHWXMAv3Wv6Hg: checks
VvdR9F3I+2yELkfTVvC1dg: checks
*** SHOW DOWN ***
YsLQ3BAvgQHWXMAv3Wv6Hg: shows [9d 9c] (two pair, Nines and Fours)
VvdR9F3I+2yELkfTVvC1dg: shows [Js Jh] (two pair, Jacks and Fours)
VvdR9F3I+2yELkfTVvC1dg collected $57.10 from pot
*** SUMMARY ***
Total pot $60 | Rake $2.90
Board [4h 2d 5d 4d Ah]
Seat 1: JsqOjN/eHz0uYVf/PyUJ6Q folded before Flop (didn't bet)
Seat 2: VvdR9F3I+2yELkfTVvC1dg showed [Js Jh] and won ($57.10) with two pair, Jacks and Fours
Seat 3: qXDd0ZyMIse0OBu8pxeQ3Q folded before Flop (didn't bet)
Seat 4: zNjJ/y4emmF+vzrCDd+ooA (button) folded before Flop (didn't bet)
Seat 5: YsLQ3BAvgQHWXMAv3Wv6Hg (small blind) showed [9d 9c] and lost with two pair, Nines and Fours
Seat 6: 2DFp9Veq1xxq64dCjwNuUw (big blind) folded on the Flop



PokerStars Game #59941184930:  Hold'em No Limit ($1/$2) - 2009/07/01 1:28:04 ET
Table 'bIihwBANJSFqlHPPtset+w' 9-max Seat #6 is the button
Seat 1: /inIs/z/PcX+TniIFpaxpg ($30 in chips)
Seat 2: lQYT23h5QCUVZAKxjOO39Q ($200 in chips)
Seat 3: +T/63sAeZzWyHchahJ36GQ ($46 in chips)
Seat 4: ri8CLkX3e9JF34dQNbsHGA ($40 in chips)
Seat 5: vxbbJLsS1bva6tW2NiFssg ($200 in chips)
Seat 6: CkE3IyJF1KvdaAOmZY5XqQ ($183 in chips)
Seat 7: pCmk6FpSOLJ+85o1tLHIag ($143.95 in chips)
Seat 9: qn8LDoUFphcG4+r+F+Vhrg ($171 in chips)
pCmk6FpSOLJ+85o1tLHIag: posts small blind $1
iMe5yhc+1BaiIPHet3NMrA: is sitting out
qn8LDoUFphcG4+r+F+Vhrg: posts big blind $2
*** HOLE CARDS ***
/inIs/z/PcX+TniIFpaxpg: raises $6 to $8
lQYT23h5QCUVZAKxjOO39Q: raises $10 to $18
+T/63sAeZzWyHchahJ36GQ: folds
ri8CLkX3e9JF34dQNbsHGA: folds
vxbbJLsS1bva6tW2NiFssg: folds
CkE3IyJF1KvdaAOmZY5XqQ: folds
pCmk6FpSOLJ+85o1tLHIag: folds
qn8LDoUFphcG4+r+F+Vhrg: folds
/inIs/z/PcX+TniIFpaxpg: raises $12 to $30 and is all-in
lQYT23h5QCUVZAKxjOO39Q: calls $12
*** FLOP *** [6s Ah 8s]
*** TURN *** [6s Ah 8s] [4s]
*** RIVER *** [6s Ah 8s 4s] [Jd]
*** SHOW DOWN ***
/inIs/z/PcX+TniIFpaxpg: shows [Ac Kc] (a pair of Aces)
lQYT23h5QCUVZAKxjOO39Q: mucks hand
/inIs/z/PcX+TniIFpaxpg collected $60 from pot
*** SUMMARY ***
Total pot $63 | Rake $3
Board [6s Ah 8s 4s Jd]
Seat 1: /inIs/z/PcX+TniIFpaxpg showed [Ac Kc] and won ($60) with a pair of Aces
Seat 2: lQYT23h5QCUVZAKxjOO39Q mucked
Seat 3: +T/63sAeZzWyHchahJ36GQ folded before Flop (didn't bet)
Seat 4: ri8CLkX3e9JF34dQNbsHGA folded before Flop (didn't bet)
Seat 5: vxbbJLsS1bva6tW2NiFssg folded before Flop (didn't bet)
Seat 6: CkE3IyJF1KvdaAOmZY5XqQ (button) folded before Flop (didn't bet)
Seat 7: pCmk6FpSOLJ+85o1tLHIag (small blind) folded before Flop
Seat 9: qn8LDoUFphcG4+r+F+Vhrg (big blind) folded before Flop



PokerStars Game #59941185268:  Hold'em No Limit ($1/$2) - 2009/07/01 1:28:05 ET
Table 'TsEDkiO4tzCTCzJ7tNdEqw' 6-max Seat #6 is the button
Seat 1: MfXQsYD8pGeCS7XOtyV+vw ($101.05 in chips)
Seat 2: 4dcDwIHRm96PwtqkpQiuiA ($81.10 in chips)
Seat 4: K8MXCrNAVYlMnnCeM32Kxw ($106.45 in chips)
Seat 5: VvdR9F3I+2yELkfTVvC1dg ($266 in chips)
Seat 6: uCqEjnxh2/vFBjKYkfTOkw ($142.35 in chips)
MfXQsYD8pGeCS7XOtyV+vw: posts small blind $1
4dcDwIHRm96PwtqkpQiuiA: posts big blind $2
ubtx4Z5L+AcK71MTvYiGVw: sits out
*** HOLE CARDS ***
K8MXCrNAVYlMnnCeM32Kxw: calls $2
VvdR9F3I+2yELkfTVvC1dg: raises $6 to $8
uCqEjnxh2/vFBjKYkfTOkw: folds
MfXQsYD8pGeCS7XOtyV+vw: folds
4dcDwIHRm96PwtqkpQiuiA: folds
K8MXCrNAVYlMnnCeM32Kxw: calls $6
*** FLOP *** [Ac 5d 6h]
K8MXCrNAVYlMnnCeM32Kxw: bets $6
VvdR9F3I+2yELkfTVvC1dg: folds
K8MXCrNAVYlMnnCeM32Kxw collected $18.05 from pot
K8MXCrNAVYlMnnCeM32Kxw: doesn't show hand
*** SUMMARY ***
Total pot $19 | Rake $0.95
Board [Ac 5d 6h]
Seat 1: MfXQsYD8pGeCS7XOtyV+vw (small blind) folded before Flop
Seat 2: 4dcDwIHRm96PwtqkpQiuiA (big blind) folded before Flop
Seat 4: K8MXCrNAVYlMnnCeM32Kxw collected ($18.05)
Seat 5: VvdR9F3I+2yELkfTVvC1dg folded on the Flop
Seat 6: uCqEjnxh2/vFBjKYkfTOkw (button) folded before Flop (didn't bet)



PokerStars Game #59941185076:  Hold'em No Limit ($1/$2) - 2009/07/01 1:28:05 ET
Table 'NmY84NAf9Mh0ckAckHnh5g' 2-max Seat #1 is the button
Seat 1: 6hvg964TSqZ3AL/0XK9aVQ ($210.10 in chips)
Seat 2: RwDoM55ZeQuI2ADyJhOb2Q ($791.70 in chips)
6hvg964TSqZ3AL/0XK9aVQ: posts small blind $1
RwDoM55ZeQuI2ADyJhOb2Q: posts big blind $2
*** HOLE CARDS ***
6hvg964TSqZ3AL/0XK9aVQ: folds
RwDoM55ZeQuI2ADyJhOb2Q collected $2 from pot
RwDoM55ZeQuI2ADyJhOb2Q: doesn't show hand
*** SUMMARY ***
Total pot $2 | Rake $0
Seat 1: 6hvg964TSqZ3AL/0XK9aVQ (button) (small blind) folded before Flop
Seat 2: RwDoM55ZeQuI2ADyJhOb2Q (big blind) collected ($2)



PokerStars Game #59941186212:  Hold'em No Limit ($1/$2) - 2009/07/01 1:28:07 ET
Table 'AtOXMvcrtQM8yLNcALmfLQ' 2-max Seat #2 is the button
Seat 1: +HlQuAsMqZGYYtjcPO/a3A ($279.30 in chips)
Seat 2: pVqEzK9wXlRMECnb1Zg4Zw ($200 in chips)
pVqEzK9wXlRMECnb1Zg4Zw: posts small blind $1
+HlQuAsMqZGYYtjcPO/a3A: posts big blind $2
*** HOLE CARDS ***
pVqEzK9wXlRMECnb1Zg4Zw: raises $6 to $8
+HlQuAsMqZGYYtjcPO/a3A: raises $20 to $28
pVqEzK9wXlRMECnb1Zg4Zw: folds
+HlQuAsMqZGYYtjcPO/a3A collected $16 from pot
*** SUMMARY ***
Total pot $16 | Rake $0
Seat 1: +HlQuAsMqZGYYtjcPO/a3A (big blind) collected ($16)
Seat 2: pVqEzK9wXlRMECnb1Zg4Zw (button) (small blind) folded before Flop



PokerStars Game #59941186468:  Hold'em No Limit ($1/$2) - 2009/07/01 1:28:07 ET
Table '/dyk+YdRGv90j2box35j8w' 6-max Seat #1 is the button
Seat 1: 8srN1dKQePlsv0GyTada+Q ($205.80 in chips)
Seat 2: qCnEYuAE5y5A7bk6fO5/jQ ($474.60 in chips)
Seat 4: z/u1YTnkiIDrtp/2cA2dBg ($202.05 in chips)
Seat 5: VvdR9F3I+2yELkfTVvC1dg ($200 in chips)
qCnEYuAE5y5A7bk6fO5/jQ: posts small blind $1
z/u1YTnkiIDrtp/2cA2dBg: posts big blind $2
*** HOLE CARDS ***
VvdR9F3I+2yELkfTVvC1dg: folds
8srN1dKQePlsv0GyTada+Q: raises $2 to $4
qCnEYuAE5y5A7bk6fO5/jQ: folds
z/u1YTnkiIDrtp/2cA2dBg: calls $2
*** FLOP *** [9h 6d Jc]
z/u1YTnkiIDrtp/2cA2dBg: checks
8srN1dKQePlsv0GyTada+Q: checks
*** TURN *** [9h 6d Jc] [7h]
z/u1YTnkiIDrtp/2cA2dBg: bets $5
8srN1dKQePlsv0GyTada+Q: folds
z/u1YTnkiIDrtp/2cA2dBg collected $8.55 from pot
*** SUMMARY ***
Total pot $9 | Rake $0.45
Board [9h 6d Jc 7h]
Seat 1: 8srN1dKQePlsv0GyTada+Q (button) folded on the Turn
Seat 2: qCnEYuAE5y5A7bk6fO5/jQ (small blind) folded before Flop
Seat 4: z/u1YTnkiIDrtp/2cA2dBg (big blind) collected ($8.55)
Seat 5: VvdR9F3I+2yELkfTVvC1dg folded before Flop (didn't bet)



PokerStars Game #59941187024:  Hold'em No Limit ($1/$2) - 2009/07/01 1:28:08 ET
Table 'W9UeSV0aoPjh5SFSxM8jUQ' 9-max Seat #5 is the button
Seat 1: mIKx5lhIt13X5eZQH0ZeMA ($25 in chips)
Seat 2: iMe5yhc+1BaiIPHet3NMrA ($252.60 in chips)
Seat 3: /inIs/z/PcX+TniIFpaxpg ($25 in chips)
Seat 4: 4YA/sQy1Emm680zhbPUjow ($133.35 in chips)
Seat 5: ri8CLkX3e9JF34dQNbsHGA ($44.15 in chips)
Seat 6: j47DM+lqTfzZP8musviQTg ($108.90 in chips)
Seat 7: I2ipWauytvrkEer4XD3Sjg ($87.70 in chips)
Seat 8: odhvI/CZeMsPyo1n1U7+hA ($47.70 in chips)
Seat 9: Q104K4iDGcqOlVrjAkzPEA ($98.10 in chips)
j47DM+lqTfzZP8musviQTg: posts small blind $1
I2ipWauytvrkEer4XD3Sjg: posts big blind $2
*** HOLE CARDS ***
odhvI/CZeMsPyo1n1U7+hA: calls $2
Q104K4iDGcqOlVrjAkzPEA: folds
mIKx5lhIt13X5eZQH0ZeMA: folds
iMe5yhc+1BaiIPHet3NMrA: folds
/inIs/z/PcX+TniIFpaxpg: folds
4YA/sQy1Emm680zhbPUjow: folds
ri8CLkX3e9JF34dQNbsHGA: calls $2
j47DM+lqTfzZP8musviQTg: raises $8 to $10
I2ipWauytvrkEer4XD3Sjg: folds
odhvI/CZeMsPyo1n1U7+hA: calls $8
ri8CLkX3e9JF34dQNbsHGA: calls $8
*** FLOP *** [9c 9s 4s]
j47DM+lqTfzZP8musviQTg: bets $25
odhvI/CZeMsPyo1n1U7+hA: folds
ri8CLkX3e9JF34dQNbsHGA: folds
j47DM+lqTfzZP8musviQTg collected $30.40 from pot
*** SUMMARY ***
Total pot $32 | Rake $1.60
Board [9c 9s 4s]
Seat 1: mIKx5lhIt13X5eZQH0ZeMA folded before Flop (didn't bet)
Seat 2: iMe5yhc+1BaiIPHet3NMrA folded before Flop (didn't bet)
Seat 3: /inIs/z/PcX+TniIFpaxpg folded before Flop (didn't bet)
Seat 4: 4YA/sQy1Emm680zhbPUjow folded before Flop (didn't bet)
Seat 5: ri8CLkX3e9JF34dQNbsHGA (button) folded on the Flop
Seat 6: j47DM+lqTfzZP8musviQTg (small blind) collected ($30.40)
Seat 7: I2ipWauytvrkEer4XD3Sjg (big blind) folded before Flop
Seat 8: odhvI/CZeMsPyo1n1U7+hA folded on the Flop
Seat 9: Q104K4iDGcqOlVrjAkzPEA folded before Flop (didn't bet)



PokerStars Game #59941188136:  Hold'em No Limit ($1/$2) - 2009/07/01 1:28:10 ET
Table 'aSf77Sj8QEnzcc0WaxVD4Q' 6-max Seat #5 is the button
Seat 1: UELtvp+JfwI7XDGVwSxZXA ($159.55 in chips)
Seat 2: vkfxu8f/jMYKUk6Ly4eujw ($206 in chips)
Seat 3: 9dpyyjDTCed6nV7JhaUUpw ($526.70 in chips)
Seat 4: YsLQ3BAvgQHWXMAv3Wv6Hg ($259.70 in chips)
Seat 5: VvdR9F3I+2yELkfTVvC1dg ($240 in chips)
Seat 6: vkoJRf3gidxY1pPi0AFWww ($124.15 in chips)
vkoJRf3gidxY1pPi0AFWww: posts small blind $1
UELtvp+JfwI7XDGVwSxZXA: posts big blind $2
*** HOLE CARDS ***
vkfxu8f/jMYKUk6Ly4eujw: folds
9dpyyjDTCed6nV7JhaUUpw: folds
YsLQ3BAvgQHWXMAv3Wv6Hg: folds
VvdR9F3I+2yELkfTVvC1dg: folds
vkoJRf3gidxY1pPi0AFWww: calls $1
UELtvp+JfwI7XDGVwSxZXA: checks
*** FLOP *** [8s 6h Kd]
vkoJRf3gidxY1pPi0AFWww: checks
UELtvp+JfwI7XDGVwSxZXA: checks
*** TURN *** [8s 6h Kd] [9s]
vkoJRf3gidxY1pPi0AFWww: bets $4
UELtvp+JfwI7XDGVwSxZXA: calls $4
*** RIVER *** [8s 6h Kd 9s] [Ah]
vkoJRf3gidxY1pPi0AFWww: checks
UELtvp+JfwI7XDGVwSxZXA: checks
*** SHOW DOWN ***
vkoJRf3gidxY1pPi0AFWww: shows [Kh Ts] (a pair of Kings)
UELtvp+JfwI7XDGVwSxZXA: mucks hand
vkoJRf3gidxY1pPi0AFWww collected $11.45 from pot
*** SUMMARY ***
Total pot $12 | Rake $0.55
Board [8s 6h Kd 9s Ah]
Seat 1: UELtvp+JfwI7XDGVwSxZXA (big blind) mucked
Seat 2: vkfxu8f/jMYKUk6Ly4eujw folded before Flop (didn't bet)
Seat 3: 9dpyyjDTCed6nV7JhaUUpw folded before Flop (didn't bet)
Seat 4: YsLQ3BAvgQHWXMAv3Wv6Hg folded before Flop (didn't bet)
Seat 5: VvdR9F3I+2yELkfTVvC1dg (button) folded before Flop (didn't bet)
Seat 6: vkoJRf3gidxY1pPi0AFWww (small blind) showed [Kh Ts] and won ($11.45) with a pair of Kings



PokerStars Game #59941188506:  Hold'em No Limit ($1/$2) - 2009/07/01 1:28:10 ET
Table 'LL4bDFyhj5hsMpzaDugJZg' 6-max Seat #5 is the button
Seat 1: FwvID/fQGlpY3soi/lMTww ($84.50 in chips)
Seat 3: iI/NMpRxMkGieArQEhACSA ($537.50 in chips)
Seat 4: 8srN1dKQePlsv0GyTada+Q ($211.05 in chips)
Seat 5: A2GTwTiwkb1ilNWgW487Vg ($115.80 in chips)
Seat 6: 692Q4sfB0gTElzS0WMeg+A ($210.10 in chips)
692Q4sfB0gTElzS0WMeg+A: posts small blind $1
FwvID/fQGlpY3soi/lMTww: posts big blind $2
*** HOLE CARDS ***
iI/NMpRxMkGieArQEhACSA: folds
8srN1dKQePlsv0GyTada+Q: folds
A2GTwTiwkb1ilNWgW487Vg: folds
692Q4sfB0gTElzS0WMeg+A: folds
FwvID/fQGlpY3soi/lMTww collected $2 from pot
*** SUMMARY ***
Total pot $2 | Rake $0
Seat 1: FwvID/fQGlpY3soi/lMTww (big blind) collected ($2)
Seat 3: iI/NMpRxMkGieArQEhACSA folded before Flop (didn't bet)
Seat 4: 8srN1dKQePlsv0GyTada+Q folded before Flop (didn't bet)
Seat 5: A2GTwTiwkb1ilNWgW487Vg (button) folded before Flop (didn't bet)
Seat 6: 692Q4sfB0gTElzS0WMeg+A (small blind) folded before Flop



PokerStars Game #59941188278:  Hold'em No Limit ($1/$2) - 2009/07/01 1:28:10 ET
Table 'NmY84NAf9Mh0ckAckHnh5g' 2-max Seat #2 is the button
Seat 1: 6hvg964TSqZ3AL/0XK9aVQ ($209.10 in chips)
Seat 2: RwDoM55ZeQuI2ADyJhOb2Q ($792.70 in chips)
RwDoM55ZeQuI2ADyJhOb2Q: posts small blind $1
6hvg964TSqZ3AL/0XK9aVQ: posts big blind $2
*** HOLE CARDS ***
RwDoM55ZeQuI2ADyJhOb2Q: raises $4 to $6
6hvg964TSqZ3AL/0XK9aVQ: calls $4
*** FLOP *** [5c 8c Ks]
6hvg964TSqZ3AL/0XK9aVQ: checks
RwDoM55ZeQuI2ADyJhOb2Q: checks
*** TURN *** [5c 8c Ks] [5s]
6hvg964TSqZ3AL/0XK9aVQ: bets $8
RwDoM55ZeQuI2ADyJhOb2Q: calls $8
*** RIVER *** [5c 8c Ks 5s] [Jc]
6hvg964TSqZ3AL/0XK9aVQ: checks
RwDoM55ZeQuI2ADyJhOb2Q: checks
*** SHOW DOWN ***
6hvg964TSqZ3AL/0XK9aVQ: shows [7h 8h] (two pair, Eights and Fives)
RwDoM55ZeQuI2ADyJhOb2Q: mucks hand
6hvg964TSqZ3AL/0XK9aVQ collected $27.50 from pot
*** SUMMARY ***
Total pot $28 | Rake $0.50
Board [5c 8c Ks 5s Jc]
Seat 1: 6hvg964TSqZ3AL/0XK9aVQ (big blind) showed [7h 8h] and won ($27.50) with two pair, Eights and Fives
Seat 2: RwDoM55ZeQuI2ADyJhOb2Q (button) (small blind) mucked



PokerStars Game #59941190148:  Hold'em No Limit ($1/$2) - 2009/07/01 1:28:13 ET
Table 'ztv6V3FN2bQ9nmJPPdx6nQ' 6-max Seat #4 is the button
Seat 1: 6fLdOUCRtX71xbVRhJEq8w ($205 in chips)
Seat 2: 5Y+ZGWLI4gnlpApDX5vy1A ($407.75 in chips)
Seat 3: ubtx4Z5L+AcK71MTvYiGVw ($245 in chips)
Seat 4: UaZ5yj+6LjtWqMQg2QskUw ($106.30 in chips)
Seat 6: mfy7uGZcqA2PVQqEVbJ7+g ($117.45 in chips)
mfy7uGZcqA2PVQqEVbJ7+g: posts small blind $1
6fLdOUCRtX71xbVRhJEq8w: posts big blind $2
*** HOLE CARDS ***
5Y+ZGWLI4gnlpApDX5vy1A: raises $6 to $8
ubtx4Z5L+AcK71MTvYiGVw: folds
UaZ5yj+6LjtWqMQg2QskUw: folds
mfy7uGZcqA2PVQqEVbJ7+g: folds
6fLdOUCRtX71xbVRhJEq8w: folds
5Y+ZGWLI4gnlpApDX5vy1A collected $5 from pot
5Y+ZGWLI4gnlpApDX5vy1A: doesn't show hand
*** SUMMARY ***
Total pot $5 | Rake $0
Seat 1: 6fLdOUCRtX71xbVRhJEq8w (big blind) folded before Flop
Seat 2: 5Y+ZGWLI4gnlpApDX5vy1A collected ($5)
Seat 3: ubtx4Z5L+AcK71MTvYiGVw folded before Flop (didn't bet)
Seat 4: UaZ5yj+6LjtWqMQg2QskUw (button) folded before Flop (didn't bet)
Seat 6: mfy7uGZcqA2PVQqEVbJ7+g (small blind) folded before Flop



PokerStars Game #59941189690:  Hold'em No Limit ($1/$2) - 2009/07/01 1:28:13 ET
Table 'jlrIxbrVIG+gjaUYT4za8g' 6-max Seat #5 is the button
Seat 1: ygTTt5ehT4aF86q1a8/R+w ($261.30 in chips)
Seat 2: on4ebXPJvUBOcHOBMQsRSg ($72.80 in chips)
Seat 4: 8srN1dKQePlsv0GyTada+Q ($297.35 in chips)
Seat 5: AyBB0k3Dcl7xbXUeGMw06g ($71.90 in chips)
Seat 6: vkfxu8f/jMYKUk6Ly4eujw ($310 in chips)
vkfxu8f/jMYKUk6Ly4eujw: posts small blind $1
ygTTt5ehT4aF86q1a8/R+w: posts big blind $2
gnYme0DNFflnMhrdbxe1Ag: sits out
*** HOLE CARDS ***
on4ebXPJvUBOcHOBMQsRSg: calls $2
8srN1dKQePlsv0GyTada+Q: raises $6 to $8
AyBB0k3Dcl7xbXUeGMw06g: folds
vkfxu8f/jMYKUk6Ly4eujw: folds
ygTTt5ehT4aF86q1a8/R+w: folds
on4ebXPJvUBOcHOBMQsRSg: raises $46 to $54
8srN1dKQePlsv0GyTada+Q: raises $46 to $100
on4ebXPJvUBOcHOBMQsRSg: calls $18.80 and is all-in
*** FLOP *** [4d 3c 6d]
*** TURN *** [4d 3c 6d] [Js]
*** RIVER *** [4d 3c 6d Js] [Ks]
*** SHOW DOWN ***
on4ebXPJvUBOcHOBMQsRSg: shows [4c 4h] (three of a kind, Fours)
8srN1dKQePlsv0GyTada+Q: mucks hand
on4ebXPJvUBOcHOBMQsRSg collected $146.60 from pot
*** SUMMARY ***
Total pot $148.60 | Rake $2
Board [4d 3c 6d Js Ks]
Seat 1: ygTTt5ehT4aF86q1a8/R+w (big blind) folded before Flop
Seat 2: on4ebXPJvUBOcHOBMQsRSg showed [4c 4h] and won ($146.60) with three of a kind, Fours
Seat 4: 8srN1dKQePlsv0GyTada+Q mucked
Seat 5: AyBB0k3Dcl7xbXUeGMw06g (button) folded before Flop (didn't bet)
Seat 6: vkfxu8f/jMYKUk6Ly4eujw (small blind) folded before Flop



PokerStars Game #59941190828:  Hold'em No Limit ($1/$2) - 2009/07/01 1:28:15 ET
Table 'UGLAZZyv+cXmnKjYin0etA' 6-max Seat #2 is the button
Seat 1: vkfxu8f/jMYKUk6Ly4eujw ($196.05 in chips)
Seat 2: eDLH1PUXFpvJBNMXBVQcGA ($276.35 in chips)
Seat 3: ygTTt5ehT4aF86q1a8/R+w ($100 in chips)
Seat 4: SiGJDsvRViJX05vHhA80GQ ($200 in chips)
Seat 5: 54yWzRRgS0oZ+S6LwZBxMQ ($31.75 in chips)
ygTTt5ehT4aF86q1a8/R+w: posts small blind $1
SiGJDsvRViJX05vHhA80GQ: posts big blind $2
*** HOLE CARDS ***
54yWzRRgS0oZ+S6LwZBxMQ: calls $2
vkfxu8f/jMYKUk6Ly4eujw: folds
eDLH1PUXFpvJBNMXBVQcGA: folds
ygTTt5ehT4aF86q1a8/R+w: calls $1
SiGJDsvRViJX05vHhA80GQ: checks
*** FLOP *** [2d 6h 6s]
ygTTt5ehT4aF86q1a8/R+w: checks
SiGJDsvRViJX05vHhA80GQ: checks
54yWzRRgS0oZ+S6LwZBxMQ: bets $6
ygTTt5ehT4aF86q1a8/R+w: folds
SiGJDsvRViJX05vHhA80GQ: folds
54yWzRRgS0oZ+S6LwZBxMQ collected $5.70 from pot
*** SUMMARY ***
Total pot $6 | Rake $0.30
Board [2d 6h 6s]
Seat 1: vkfxu8f/jMYKUk6Ly4eujw folded before Flop (didn't bet)
Seat 2: eDLH1PUXFpvJBNMXBVQcGA (button) folded before Flop (didn't bet)
Seat 3: ygTTt5ehT4aF86q1a8/R+w (small blind) folded on the Flop
Seat 4: SiGJDsvRViJX05vHhA80GQ (big blind) folded on the Flop
Seat 5: 54yWzRRgS0oZ+S6LwZBxMQ collected ($5.70)



PokerStars Game #59941192300:  Hold'em No Limit ($1/$2) - 2009/07/01 1:28:17 ET
Table 'pPQgcj9XT9CHBsbo1WTBug' 6-max Seat #6 is the button
Seat 1: DFVYDA6dKQy7R7mGIKogZA ($156.20 in chips)
Seat 2: qXDd0ZyMIse0OBu8pxeQ3Q ($200 in chips)
Seat 3: 54yWzRRgS0oZ+S6LwZBxMQ ($52.75 in chips)
Seat 4: gqlysXCbT8V54f/1lf9h3A ($36.10 in chips)
Seat 5: vkfxu8f/jMYKUk6Ly4eujw ($199.55 in chips)
Seat 6: Yr7pZltpy3IUNdKS9PCEiw ($301.30 in chips)
DFVYDA6dKQy7R7mGIKogZA: posts small blind $1
qXDd0ZyMIse0OBu8pxeQ3Q: posts big blind $2
*** HOLE CARDS ***
54yWzRRgS0oZ+S6LwZBxMQ: folds
gqlysXCbT8V54f/1lf9h3A: raises $4 to $6
vkfxu8f/jMYKUk6Ly4eujw: folds
Yr7pZltpy3IUNdKS9PCEiw: folds
DFVYDA6dKQy7R7mGIKogZA: folds
qXDd0ZyMIse0OBu8pxeQ3Q: folds
gqlysXCbT8V54f/1lf9h3A collected $5 from pot
gqlysXCbT8V54f/1lf9h3A: doesn't show hand
*** SUMMARY ***
Total pot $5 | Rake $0
Seat 1: DFVYDA6dKQy7R7mGIKogZA (small blind) folded before Flop
Seat 2: qXDd0ZyMIse0OBu8pxeQ3Q (big blind) folded before Flop
Seat 3: 54yWzRRgS0oZ+S6LwZBxMQ folded before Flop (didn't bet)
Seat 4: gqlysXCbT8V54f/1lf9h3A collected ($5)
Seat 5: vkfxu8f/jMYKUk6Ly4eujw folded before Flop (didn't bet)
Seat 6: Yr7pZltpy3IUNdKS9PCEiw (button) folded before Flop (didn't bet)



PokerStars Game #59941195600:  Hold'em No Limit ($1/$2) - 2009/07/01 1:28:23 ET
Table 'rKeCh+eBn4RNvybCUYkoTQ' 9-max Seat #4 is the button
Seat 1: /inIs/z/PcX+TniIFpaxpg ($200 in chips)
Seat 2: 9cBHwK40Tl06vheE7B3LHQ ($159.55 in chips)
Seat 3: GX1heJ+DSsvm7gzSPsYhhQ ($31 in chips)
Seat 4: 31HuO+DQxppUQEedBWukug ($89.10 in chips)
Seat 5: WUlHm+ydPPHG7Lb0rePSdA ($129 in chips)
Seat 6: EBV6OktyeSmh4w6sWmcWOw ($270 in chips)
Seat 7: rW/MyplHylMSBRaoRUzWrg ($34 in chips)
Seat 8: pN/Ip0ePsUVIdUlGgLrkUw ($215.35 in chips)
Seat 9: Kzta8yu9vxHT4B70mjBZ+w ($211.25 in chips)
WUlHm+ydPPHG7Lb0rePSdA: posts small blind $1
EBV6OktyeSmh4w6sWmcWOw: posts big blind $2
*** HOLE CARDS ***
rW/MyplHylMSBRaoRUzWrg: folds
pN/Ip0ePsUVIdUlGgLrkUw: folds
Kzta8yu9vxHT4B70mjBZ+w: folds
/inIs/z/PcX+TniIFpaxpg: folds
9cBHwK40Tl06vheE7B3LHQ: raises $4 to $6
GX1heJ+DSsvm7gzSPsYhhQ: folds
31HuO+DQxppUQEedBWukug: calls $6
WUlHm+ydPPHG7Lb0rePSdA: calls $5
EBV6OktyeSmh4w6sWmcWOw: folds
*** FLOP *** [9c Ts Qd]
WUlHm+ydPPHG7Lb0rePSdA: checks
9cBHwK40Tl06vheE7B3LHQ: bets $12
31HuO+DQxppUQEedBWukug: raises $12 to $24
WUlHm+ydPPHG7Lb0rePSdA: folds
9cBHwK40Tl06vheE7B3LHQ: calls $12
*** TURN *** [9c Ts Qd] [3h]
9cBHwK40Tl06vheE7B3LHQ: checks
31HuO+DQxppUQEedBWukug: bets $59.10 and is all-in
9cBHwK40Tl06vheE7B3LHQ: folds
31HuO+DQxppUQEedBWukug collected $65 from pot
31HuO+DQxppUQEedBWukug: doesn't show hand
*** SUMMARY ***
Total pot $68 | Rake $3
Board [9c Ts Qd 3h]
Seat 1: /inIs/z/PcX+TniIFpaxpg folded before Flop (didn't bet)
Seat 2: 9cBHwK40Tl06vheE7B3LHQ folded on the Turn
Seat 3: GX1heJ+DSsvm7gzSPsYhhQ folded before Flop (didn't bet)
Seat 4: 31HuO+DQxppUQEedBWukug (button) collected ($65)
Seat 5: WUlHm+ydPPHG7Lb0rePSdA (small blind) folded on the Flop
Seat 6: EBV6OktyeSmh4w6sWmcWOw (big blind) folded before Flop
Seat 7: rW/MyplHylMSBRaoRUzWrg folded before Flop (didn't bet)
Seat 8: pN/Ip0ePsUVIdUlGgLrkUw folded before Flop (didn't bet)
Seat 9: Kzta8yu9vxHT4B70mjBZ+w folded before Flop (didn't bet)



PokerStars Game #59941195556:  Hold'em No Limit ($1/$2) - 2009/07/01 1:28:23 ET
Table '3WCXyaiCAbqSShQu7FIjvA' 9-max Seat #4 is the button
Seat 1: kTCkABD1UUldS9DFRGfCwQ ($151.40 in chips)
Seat 3: 5Q8U6iZbeO7xJSS4qvDP5g ($272.15 in chips)
Seat 4: waEF/+pxZTxNo4FvsORuXg ($76 in chips)
Seat 5: CkE3IyJF1KvdaAOmZY5XqQ ($200 in chips)
Seat 6: 5jQlngvMSqM/WoonOcR5kw ($246 in chips)
Seat 8: 1CtiZuXDFaJL1dJPQKyi8Q ($242.35 in chips)
Seat 9: FiXPLJyqb24l32QST2TInw ($153.40 in chips)
CkE3IyJF1KvdaAOmZY5XqQ: posts small blind $1
5jQlngvMSqM/WoonOcR5kw: posts big blind $2
TAfo4veNRaRlzDXMMYS3Jg: sits out
*** HOLE CARDS ***
1CtiZuXDFaJL1dJPQKyi8Q: folds
FiXPLJyqb24l32QST2TInw: folds
kTCkABD1UUldS9DFRGfCwQ: folds
5Q8U6iZbeO7xJSS4qvDP5g: folds
waEF/+pxZTxNo4FvsORuXg: calls $2
CkE3IyJF1KvdaAOmZY5XqQ: folds
5jQlngvMSqM/WoonOcR5kw: checks
*** FLOP *** [8c 8h Th]
5jQlngvMSqM/WoonOcR5kw: checks
waEF/+pxZTxNo4FvsORuXg: checks
*** TURN *** [8c 8h Th] [4d]
5jQlngvMSqM/WoonOcR5kw: checks
waEF/+pxZTxNo4FvsORuXg: bets $4
5jQlngvMSqM/WoonOcR5kw: calls $4
*** RIVER *** [8c 8h Th 4d] [As]
5jQlngvMSqM/WoonOcR5kw: checks
waEF/+pxZTxNo4FvsORuXg: bets $4
5jQlngvMSqM/WoonOcR5kw: folds
waEF/+pxZTxNo4FvsORuXg collected $12.40 from pot
waEF/+pxZTxNo4FvsORuXg: doesn't show hand
*** SUMMARY ***
Total pot $13 | Rake $0.60
Board [8c 8h Th 4d As]
Seat 1: kTCkABD1UUldS9DFRGfCwQ folded before Flop (didn't bet)
Seat 3: 5Q8U6iZbeO7xJSS4qvDP5g folded before Flop (didn't bet)
Seat 4: waEF/+pxZTxNo4FvsORuXg (button) collected ($12.40)
Seat 5: CkE3IyJF1KvdaAOmZY5XqQ (small blind) folded before Flop
Seat 6: 5jQlngvMSqM/WoonOcR5kw (big blind) folded on the River
Seat 8: 1CtiZuXDFaJL1dJPQKyi8Q folded before Flop (didn't bet)
Seat 9: FiXPLJyqb24l32QST2TInw folded before Flop (didn't bet)



PokerStars Game #59941197256:  Hold'em No Limit ($1/$2) - 2009/07/01 1:28:26 ET
Table 'mGpP9StWRnoeiBDExc6Frg' 6-max Seat #6 is the button
Seat 1: VvdR9F3I+2yELkfTVvC1dg ($280.15 in chips)
Seat 2: vkfxu8f/jMYKUk6Ly4eujw ($200 in chips)
Seat 3: 7acrZUQC3Zc9BNLjoKIcLQ ($41.05 in chips)
Seat 4: 4dcDwIHRm96PwtqkpQiuiA ($82.70 in chips)
Seat 5: d1puGuVBE0fidn+5eRJ0tw ($176.95 in chips)
Seat 6: B2Ih1sr5VZk+8He7rcrMtQ ($463.05 in chips)
VvdR9F3I+2yELkfTVvC1dg: posts small blind $1
vkfxu8f/jMYKUk6Ly4eujw: posts big blind $2
*** HOLE CARDS ***
7acrZUQC3Zc9BNLjoKIcLQ: folds
4dcDwIHRm96PwtqkpQiuiA: folds
d1puGuVBE0fidn+5eRJ0tw: folds
B2Ih1sr5VZk+8He7rcrMtQ: folds
VvdR9F3I+2yELkfTVvC1dg: folds
vkfxu8f/jMYKUk6Ly4eujw collected $2 from pot
*** SUMMARY ***
Total pot $2 | Rake $0
Seat 1: VvdR9F3I+2yELkfTVvC1dg (small blind) folded before Flop
Seat 2: vkfxu8f/jMYKUk6Ly4eujw (big blind) collected ($2)
Seat 3: 7acrZUQC3Zc9BNLjoKIcLQ folded before Flop (didn't bet)
Seat 4: 4dcDwIHRm96PwtqkpQiuiA folded before Flop (didn't bet)
Seat 5: d1puGuVBE0fidn+5eRJ0tw folded before Flop (didn't bet)
Seat 6: B2Ih1sr5VZk+8He7rcrMtQ (button) folded before Flop (didn't bet)



PokerStars Game #59941198066:  Hold'em No Limit ($1/$2) - 2009/07/01 1:28:27 ET
Table '4NGNnZ/osQfNq6abYqkJeA' 6-max Seat #2 is the button
Seat 1: vkfxu8f/jMYKUk6Ly4eujw ($197 in chips)
Seat 2: 669iGNwYwgRZg3nhS+aDAQ ($90.15 in chips)
Seat 3: 54yWzRRgS0oZ+S6LwZBxMQ ($18.75 in chips)
Seat 4: sY+4Uuh5z/6AbXXaCS10jw ($214.35 in chips)
Seat 5: VvdR9F3I+2yELkfTVvC1dg ($240.30 in chips)
54yWzRRgS0oZ+S6LwZBxMQ: posts small blind $1
sY+4Uuh5z/6AbXXaCS10jw: posts big blind $2
3cPMpDMgeOMAe4UceUfLsg: sits out
*** HOLE CARDS ***
VvdR9F3I+2yELkfTVvC1dg: raises $2 to $4
vkfxu8f/jMYKUk6Ly4eujw: folds
669iGNwYwgRZg3nhS+aDAQ: folds
54yWzRRgS0oZ+S6LwZBxMQ: folds
sY+4Uuh5z/6AbXXaCS10jw: calls $2
*** FLOP *** [2s 5c 2h]
sY+4Uuh5z/6AbXXaCS10jw: checks
VvdR9F3I+2yELkfTVvC1dg: checks
*** TURN *** [2s 5c 2h] [Ah]
sY+4Uuh5z/6AbXXaCS10jw: checks
VvdR9F3I+2yELkfTVvC1dg: bets $6.20
sY+4Uuh5z/6AbXXaCS10jw: folds
VvdR9F3I+2yELkfTVvC1dg collected $8.55 from pot
VvdR9F3I+2yELkfTVvC1dg: doesn't show hand
*** SUMMARY ***
Total pot $9 | Rake $0.45
Board [2s 5c 2h Ah]
Seat 1: vkfxu8f/jMYKUk6Ly4eujw folded before Flop (didn't bet)
Seat 2: 669iGNwYwgRZg3nhS+aDAQ (button) folded before Flop (didn't bet)
Seat 3: 54yWzRRgS0oZ+S6LwZBxMQ (small blind) folded before Flop
Seat 4: sY+4Uuh5z/6AbXXaCS10jw (big blind) folded on the Turn
Seat 5: VvdR9F3I+2yELkfTVvC1dg collected ($8.55)



PokerStars Game #59941198728:  Hold'em No Limit ($1/$2) - 2009/07/01 1:28:28 ET
Table 'ztv6V3FN2bQ9nmJPPdx6nQ' 6-max Seat #6 is the button
Seat 1: 6fLdOUCRtX71xbVRhJEq8w ($203 in chips)
Seat 2: 5Y+ZGWLI4gnlpApDX5vy1A ($410.75 in chips)
Seat 3: ubtx4Z5L+AcK71MTvYiGVw ($245 in chips)
Seat 4: UaZ5yj+6LjtWqMQg2QskUw ($106.30 in chips)
Seat 6: mfy7uGZcqA2PVQqEVbJ7+g ($116.45 in chips)
6fLdOUCRtX71xbVRhJEq8w: posts small blind $1
5Y+ZGWLI4gnlpApDX5vy1A: posts big blind $2
*** HOLE CARDS ***
ubtx4Z5L+AcK71MTvYiGVw: folds
UaZ5yj+6LjtWqMQg2QskUw: folds
mfy7uGZcqA2PVQqEVbJ7+g: folds
6fLdOUCRtX71xbVRhJEq8w: raises $4 to $6
5Y+ZGWLI4gnlpApDX5vy1A: folds
6fLdOUCRtX71xbVRhJEq8w collected $4 from pot
*** SUMMARY ***
Total pot $4 | Rake $0
Seat 1: 6fLdOUCRtX71xbVRhJEq8w (small blind) collected ($4)
Seat 2: 5Y+ZGWLI4gnlpApDX5vy1A (big blind) folded before Flop
Seat 3: ubtx4Z5L+AcK71MTvYiGVw folded before Flop (didn't bet)
Seat 4: UaZ5yj+6LjtWqMQg2QskUw folded before Flop (didn't bet)
Seat 6: mfy7uGZcqA2PVQqEVbJ7+g (button) folded before Flop (didn't bet)



PokerStars Game #59941198676:  Hold'em No Limit ($1/$2) - 2009/07/01 1:28:28 ET
Table 'LL4bDFyhj5hsMpzaDugJZg' 6-max Seat #6 is the button
Seat 1: FwvID/fQGlpY3soi/lMTww ($85.50 in chips)
Seat 3: iI/NMpRxMkGieArQEhACSA ($537.50 in chips)
Seat 4: 8srN1dKQePlsv0GyTada+Q ($211.05 in chips)
Seat 5: A2GTwTiwkb1ilNWgW487Vg ($115.80 in chips)
Seat 6: 692Q4sfB0gTElzS0WMeg+A ($209.10 in chips)
FwvID/fQGlpY3soi/lMTww: posts small blind $1
iI/NMpRxMkGieArQEhACSA: posts big blind $2
*** HOLE CARDS ***
8srN1dKQePlsv0GyTada+Q: raises $4 to $6
A2GTwTiwkb1ilNWgW487Vg: folds
692Q4sfB0gTElzS0WMeg+A: folds
FwvID/fQGlpY3soi/lMTww: calls $5
iI/NMpRxMkGieArQEhACSA: folds
*** FLOP *** [4s Js Td]
FwvID/fQGlpY3soi/lMTww: bets $10
8srN1dKQePlsv0GyTada+Q: raises $14 to $24
FwvID/fQGlpY3soi/lMTww said, "88 no good"
IZng3w8jiJHHp3LbYKLi4w has returned
FwvID/fQGlpY3soi/lMTww: folds
8srN1dKQePlsv0GyTada+Q collected $32.35 from pot
*** SUMMARY ***
Total pot $34 | Rake $1.65
Board [4s Js Td]
Seat 1: FwvID/fQGlpY3soi/lMTww (small blind) folded on the Flop
Seat 3: iI/NMpRxMkGieArQEhACSA (big blind) folded before Flop
Seat 4: 8srN1dKQePlsv0GyTada+Q collected ($32.35)
Seat 5: A2GTwTiwkb1ilNWgW487Vg folded before Flop (didn't bet)
Seat 6: 692Q4sfB0gTElzS0WMeg+A (button) folded before Flop (didn't bet)



PokerStars Game #59941198456:  Hold'em No Limit ($1/$2) - 2009/07/01 1:28:28 ET
Table 'AtOXMvcrtQM8yLNcALmfLQ' 2-max Seat #1 is the button
Seat 1: +HlQuAsMqZGYYtjcPO/a3A ($287.30 in chips)
Seat 2: pVqEzK9wXlRMECnb1Zg4Zw ($192 in chips)
+HlQuAsMqZGYYtjcPO/a3A: posts small blind $1
pVqEzK9wXlRMECnb1Zg4Zw: posts big blind $2
*** HOLE CARDS ***
+HlQuAsMqZGYYtjcPO/a3A: raises $4 to $6
pVqEzK9wXlRMECnb1Zg4Zw: calls $4
*** FLOP *** [2c 3s 2d]
pVqEzK9wXlRMECnb1Zg4Zw: checks
+HlQuAsMqZGYYtjcPO/a3A: checks
*** TURN *** [2c 3s 2d] [4d]
pVqEzK9wXlRMECnb1Zg4Zw: bets $12
+HlQuAsMqZGYYtjcPO/a3A: calls $12
*** RIVER *** [2c 3s 2d 4d] [Ts]
pVqEzK9wXlRMECnb1Zg4Zw: checks
+HlQuAsMqZGYYtjcPO/a3A: checks
*** SHOW DOWN ***
pVqEzK9wXlRMECnb1Zg4Zw: shows [8d Jd] (a pair of Deuces)
+HlQuAsMqZGYYtjcPO/a3A: mucks hand
pVqEzK9wXlRMECnb1Zg4Zw collected $35.50 from pot
*** SUMMARY ***
Total pot $36 | Rake $0.50
Board [2c 3s 2d 4d Ts]
Seat 1: +HlQuAsMqZGYYtjcPO/a3A (button) (small blind) mucked
Seat 2: pVqEzK9wXlRMECnb1Zg4Zw (big blind) showed [8d Jd] and won ($35.50) with a pair of Deuces



PokerStars Game #59941200026:  Hold'em No Limit ($1/$2) - 2009/07/01 1:28:30 ET
Table 'QxerF7GUfCbl+4a8XaTB2w' 6-max Seat #4 is the button
Seat 1: 54yWzRRgS0oZ+S6LwZBxMQ ($32 in chips)
Seat 2: HiWSAXs6/0w9Jy7ioiiShQ ($39.65 in chips)
Seat 3: m7mYVfnCOK5TE/VkN/FhOg ($279.10 in chips)
Seat 4: 09BNF4quPDzanQzM8vc6WA ($45.55 in chips)
Seat 5: gnYme0DNFflnMhrdbxe1Ag ($242.70 in chips)
Seat 6: VvdR9F3I+2yELkfTVvC1dg ($200 in chips)
gnYme0DNFflnMhrdbxe1Ag: posts small blind $1
VvdR9F3I+2yELkfTVvC1dg: posts big blind $2
*** HOLE CARDS ***
54yWzRRgS0oZ+S6LwZBxMQ: folds
HiWSAXs6/0w9Jy7ioiiShQ: calls $2
m7mYVfnCOK5TE/VkN/FhOg: calls $2
09BNF4quPDzanQzM8vc6WA: raises $6 to $8
gnYme0DNFflnMhrdbxe1Ag: folds
VvdR9F3I+2yELkfTVvC1dg: folds
HiWSAXs6/0w9Jy7ioiiShQ: folds
m7mYVfnCOK5TE/VkN/FhOg: calls $6
*** FLOP *** [8d 3s Qs]
m7mYVfnCOK5TE/VkN/FhOg: checks
09BNF4quPDzanQzM8vc6WA: bets $10
m7mYVfnCOK5TE/VkN/FhOg: folds
09BNF4quPDzanQzM8vc6WA collected $19.95 from pot
09BNF4quPDzanQzM8vc6WA: doesn't show hand
*** SUMMARY ***
Total pot $21 | Rake $1.05
Board [8d 3s Qs]
Seat 1: 54yWzRRgS0oZ+S6LwZBxMQ folded before Flop (didn't bet)
Seat 2: HiWSAXs6/0w9Jy7ioiiShQ folded before Flop
Seat 3: m7mYVfnCOK5TE/VkN/FhOg folded on the Flop
Seat 4: 09BNF4quPDzanQzM8vc6WA (button) collected ($19.95)
Seat 5: gnYme0DNFflnMhrdbxe1Ag (small blind) folded before Flop
Seat 6: VvdR9F3I+2yELkfTVvC1dg (big blind) folded before Flop



PokerStars Game #59941200038:  Hold'em No Limit ($1/$2) - 2009/07/01 1:28:30 ET
Table 'gnHBqWll9O3fxG7Ojkz/ng' 9-max Seat #3 is the button
Seat 1: TAfo4veNRaRlzDXMMYS3Jg ($34 in chips)
Seat 2: H6Z4+qu8gR0VUiPOijndVg ($324.25 in chips)
Seat 3: 5Q8U6iZbeO7xJSS4qvDP5g ($211 in chips)
Seat 4: nXDI8Y/S6POzRwANu3d8hQ ($38 in chips)
Seat 5: rBQDMkKm9cZn6M9NPsiVew ($226.45 in chips)
Seat 6: /inIs/z/PcX+TniIFpaxpg ($68.10 in chips)
Seat 7: jqui3xAWCkcdPW36a6BD+w ($344.95 in chips)
Seat 8: cM6efHzdxoqYm0EQKP4TTQ ($94.45 in chips)
Seat 9: GX1heJ+DSsvm7gzSPsYhhQ ($54.35 in chips)
nXDI8Y/S6POzRwANu3d8hQ: posts small blind $1
rBQDMkKm9cZn6M9NPsiVew: posts big blind $2
*** HOLE CARDS ***
/inIs/z/PcX+TniIFpaxpg: folds
jqui3xAWCkcdPW36a6BD+w: folds
cM6efHzdxoqYm0EQKP4TTQ: calls $2
GX1heJ+DSsvm7gzSPsYhhQ: folds
TAfo4veNRaRlzDXMMYS3Jg: folds
H6Z4+qu8gR0VUiPOijndVg: folds
5Q8U6iZbeO7xJSS4qvDP5g: folds
nXDI8Y/S6POzRwANu3d8hQ: calls $1
rBQDMkKm9cZn6M9NPsiVew: checks
*** FLOP *** [Td 6c 7c]
nXDI8Y/S6POzRwANu3d8hQ: checks
rBQDMkKm9cZn6M9NPsiVew: checks
cM6efHzdxoqYm0EQKP4TTQ: bets $8
nXDI8Y/S6POzRwANu3d8hQ: folds
rBQDMkKm9cZn6M9NPsiVew: folds
cM6efHzdxoqYm0EQKP4TTQ collected $5.70 from pot
*** SUMMARY ***
Total pot $6 | Rake $0.30
Board [Td 6c 7c]
Seat 1: TAfo4veNRaRlzDXMMYS3Jg folded before Flop (didn't bet)
Seat 2: H6Z4+qu8gR0VUiPOijndVg folded before Flop (didn't bet)
Seat 3: 5Q8U6iZbeO7xJSS4qvDP5g (button) folded before Flop (didn't bet)
Seat 4: nXDI8Y/S6POzRwANu3d8hQ (small blind) folded on the Flop
Seat 5: rBQDMkKm9cZn6M9NPsiVew (big blind) folded on the Flop
Seat 6: /inIs/z/PcX+TniIFpaxpg folded before Flop (didn't bet)
Seat 7: jqui3xAWCkcdPW36a6BD+w folded before Flop (didn't bet)
Seat 8: cM6efHzdxoqYm0EQKP4TTQ collected ($5.70)
Seat 9: GX1heJ+DSsvm7gzSPsYhhQ folded before Flop (didn't bet)



PokerStars Game #59941200572:  Hold'em No Limit ($1/$2) - 2009/07/01 1:28:31 ET
Table 'kq5zaQ+1hLNf8LZfGnbTAA' 6-max Seat #5 is the button
Seat 1: 8srN1dKQePlsv0GyTada+Q ($408 in chips)
Seat 2: nXDI8Y/S6POzRwANu3d8hQ ($197 in chips)
Seat 3: vkfxu8f/jMYKUk6Ly4eujw ($224.95 in chips)
Seat 4: 3dAbvkxS5NPQTBAbvpinVg ($203 in chips)
Seat 5: kfASJqTbXek+zc8ZKsZL1Q ($66.45 in chips)
Seat 6: mfy7uGZcqA2PVQqEVbJ7+g ($195.25 in chips)
mfy7uGZcqA2PVQqEVbJ7+g: posts small blind $1
8srN1dKQePlsv0GyTada+Q: posts big blind $2
*** HOLE CARDS ***
nXDI8Y/S6POzRwANu3d8hQ: folds
vkfxu8f/jMYKUk6Ly4eujw: raises $4 to $6
3dAbvkxS5NPQTBAbvpinVg: folds
kfASJqTbXek+zc8ZKsZL1Q: raises $24 to $30
mfy7uGZcqA2PVQqEVbJ7+g: folds
8srN1dKQePlsv0GyTada+Q: folds
vkfxu8f/jMYKUk6Ly4eujw: folds
kfASJqTbXek+zc8ZKsZL1Q collected $15 from pot
kfASJqTbXek+zc8ZKsZL1Q: doesn't show hand
*** SUMMARY ***
Total pot $15 | Rake $0
Seat 1: 8srN1dKQePlsv0GyTada+Q (big blind) folded before Flop
Seat 2: nXDI8Y/S6POzRwANu3d8hQ folded before Flop (didn't bet)
Seat 3: vkfxu8f/jMYKUk6Ly4eujw folded before Flop
Seat 4: 3dAbvkxS5NPQTBAbvpinVg folded before Flop (didn't bet)
Seat 5: kfASJqTbXek+zc8ZKsZL1Q (button) collected ($15)
Seat 6: mfy7uGZcqA2PVQqEVbJ7+g (small blind) folded before Flop



PokerStars Game #59941203168:  Hold'em No Limit ($1/$2) - 2009/07/01 1:28:36 ET
Table 'NmY84NAf9Mh0ckAckHnh5g' 2-max Seat #1 is the button
Seat 1: 6hvg964TSqZ3AL/0XK9aVQ ($222.60 in chips)
Seat 2: RwDoM55ZeQuI2ADyJhOb2Q ($778.70 in chips)
6hvg964TSqZ3AL/0XK9aVQ: posts small blind $1
RwDoM55ZeQuI2ADyJhOb2Q: posts big blind $2
*** HOLE CARDS ***
6hvg964TSqZ3AL/0XK9aVQ: calls $1
RwDoM55ZeQuI2ADyJhOb2Q: checks
*** FLOP *** [5c 8d 7c]
RwDoM55ZeQuI2ADyJhOb2Q: bets $4
6hvg964TSqZ3AL/0XK9aVQ: calls $4
*** TURN *** [5c 8d 7c] [7d]
RwDoM55ZeQuI2ADyJhOb2Q: checks
6hvg964TSqZ3AL/0XK9aVQ: checks
*** RIVER *** [5c 8d 7c 7d] [6d]
RwDoM55ZeQuI2ADyJhOb2Q: bets $6
6hvg964TSqZ3AL/0XK9aVQ: raises $24 to $30
RwDoM55ZeQuI2ADyJhOb2Q: folds
6hvg964TSqZ3AL/0XK9aVQ collected $23.50 from pot
6hvg964TSqZ3AL/0XK9aVQ: doesn't show hand
*** SUMMARY ***
Total pot $24 | Rake $0.50
Board [5c 8d 7c 7d 6d]
Seat 1: 6hvg964TSqZ3AL/0XK9aVQ (button) (small blind) collected ($23.50)
Seat 2: RwDoM55ZeQuI2ADyJhOb2Q (big blind) folded on the River



PokerStars Game #59941205834:  Hold'em No Limit ($1/$2) - 2009/07/01 1:28:41 ET
Table 'gftD4mDF7mIFKvSrIyaRbw' 9-max Seat #5 is the button
Seat 1: 31HuO+DQxppUQEedBWukug ($163 in chips)
Seat 2: GX1heJ+DSsvm7gzSPsYhhQ ($40 in chips)
Seat 3: CUZwDpLTQKhzarPe+JCLOQ ($200 in chips)
Seat 4: /inIs/z/PcX+TniIFpaxpg ($40 in chips)
Seat 5: mpsfNtnMVDqQHTe92AhIdw ($119.10 in chips)
Seat 6: 2NvwF8W2nzsbS+G//yLAbQ ($114.05 in chips)
Seat 7: +T/63sAeZzWyHchahJ36GQ ($40 in chips)
Seat 8: MpL4DeEqGQu0H8TJEbEOrg ($44 in chips)
Seat 9: F7m34OOfAQ7annesMHVjKw ($165.75 in chips)
2NvwF8W2nzsbS+G//yLAbQ: posts small blind $1
+T/63sAeZzWyHchahJ36GQ: posts big blind $2
*** HOLE CARDS ***
MpL4DeEqGQu0H8TJEbEOrg: folds
F7m34OOfAQ7annesMHVjKw: folds
31HuO+DQxppUQEedBWukug: folds
GX1heJ+DSsvm7gzSPsYhhQ: folds
CUZwDpLTQKhzarPe+JCLOQ: folds
/inIs/z/PcX+TniIFpaxpg: folds
mpsfNtnMVDqQHTe92AhIdw: folds
2NvwF8W2nzsbS+G//yLAbQ: calls $1
+T/63sAeZzWyHchahJ36GQ: checks
*** FLOP *** [Js 6d Ad]
2NvwF8W2nzsbS+G//yLAbQ: bets $2
+T/63sAeZzWyHchahJ36GQ: folds
2NvwF8W2nzsbS+G//yLAbQ collected $3.80 from pot
*** SUMMARY ***
Total pot $4 | Rake $0.20
Board [Js 6d Ad]
Seat 1: 31HuO+DQxppUQEedBWukug folded before Flop (didn't bet)
Seat 2: GX1heJ+DSsvm7gzSPsYhhQ folded before Flop (didn't bet)
Seat 3: CUZwDpLTQKhzarPe+JCLOQ folded before Flop (didn't bet)
Seat 4: /inIs/z/PcX+TniIFpaxpg folded before Flop (didn't bet)
Seat 5: mpsfNtnMVDqQHTe92AhIdw (button) folded before Flop (didn't bet)
Seat 6: 2NvwF8W2nzsbS+G//yLAbQ (small blind) collected ($3.80)
Seat 7: +T/63sAeZzWyHchahJ36GQ (big blind) folded on the Flop
Seat 8: MpL4DeEqGQu0H8TJEbEOrg folded before Flop (didn't bet)
Seat 9: F7m34OOfAQ7annesMHVjKw folded before Flop (didn't bet)



PokerStars Game #59941207180:  Hold'em No Limit ($1/$2) - 2009/07/01 1:28:43 ET
Table 'eyAQSIlgc2o1Jxvbve4WGg' 9-max Seat #6 is the button
Seat 1: UZEsV9yKUMqmpYPiOFpaZw ($105.20 in chips)
Seat 2: g7gL2NLJCdZPPV399WKT1w ($64.25 in chips)
Seat 3: ice1Sbe19zWIaKYoSmE5tw ($98.30 in chips)
Seat 4: CkE3IyJF1KvdaAOmZY5XqQ ($200 in chips)
Seat 5: mIKx5lhIt13X5eZQH0ZeMA ($77.80 in chips)
Seat 6: nXDI8Y/S6POzRwANu3d8hQ ($46 in chips)
Seat 7: u3OrI5uGx9mx1fE7dgr+EA ($78.20 in chips)
Seat 8: 1CtiZuXDFaJL1dJPQKyi8Q ($158.35 in chips)
Seat 9: WUlHm+ydPPHG7Lb0rePSdA ($128.95 in chips)
u3OrI5uGx9mx1fE7dgr+EA: posts small blind $1
1CtiZuXDFaJL1dJPQKyi8Q: posts big blind $2
*** HOLE CARDS ***
WUlHm+ydPPHG7Lb0rePSdA: folds
UZEsV9yKUMqmpYPiOFpaZw: folds
g7gL2NLJCdZPPV399WKT1w: folds
ice1Sbe19zWIaKYoSmE5tw has timed out
ice1Sbe19zWIaKYoSmE5tw: folds
ice1Sbe19zWIaKYoSmE5tw is sitting out
CkE3IyJF1KvdaAOmZY5XqQ: folds
mIKx5lhIt13X5eZQH0ZeMA: calls $2
nXDI8Y/S6POzRwANu3d8hQ: raises $6 to $8
u3OrI5uGx9mx1fE7dgr+EA: folds
1CtiZuXDFaJL1dJPQKyi8Q: folds
mIKx5lhIt13X5eZQH0ZeMA: calls $6
*** FLOP *** [4h Td 7d]
mIKx5lhIt13X5eZQH0ZeMA: bets $8
nXDI8Y/S6POzRwANu3d8hQ: calls $8
*** TURN *** [4h Td 7d] [2c]
mIKx5lhIt13X5eZQH0ZeMA: bets $12
nXDI8Y/S6POzRwANu3d8hQ: calls $12
*** RIVER *** [4h Td 7d 2c] [Kc]
mIKx5lhIt13X5eZQH0ZeMA: bets $12
nXDI8Y/S6POzRwANu3d8hQ: calls $12
*** SHOW DOWN ***
mIKx5lhIt13X5eZQH0ZeMA: shows [As Kh] (a pair of Kings)
nXDI8Y/S6POzRwANu3d8hQ: mucks hand
mIKx5lhIt13X5eZQH0ZeMA collected $80 from pot
*** SUMMARY ***
Total pot $83 | Rake $3
Board [4h Td 7d 2c Kc]
Seat 1: UZEsV9yKUMqmpYPiOFpaZw folded before Flop (didn't bet)
Seat 2: g7gL2NLJCdZPPV399WKT1w folded before Flop (didn't bet)
Seat 3: ice1Sbe19zWIaKYoSmE5tw folded before Flop (didn't bet)
Seat 4: CkE3IyJF1KvdaAOmZY5XqQ folded before Flop (didn't bet)
Seat 5: mIKx5lhIt13X5eZQH0ZeMA showed [As Kh] and won ($80) with a pair of Kings
Seat 6: nXDI8Y/S6POzRwANu3d8hQ (button) mucked
Seat 7: u3OrI5uGx9mx1fE7dgr+EA (small blind) folded before Flop
Seat 8: 1CtiZuXDFaJL1dJPQKyi8Q (big blind) folded before Flop
Seat 9: WUlHm+ydPPHG7Lb0rePSdA folded before Flop (didn't bet)



PokerStars Game #59941207072:  Hold'em No Limit ($1/$2) - 2009/07/01 1:28:43 ET
Table 'ztv6V3FN2bQ9nmJPPdx6nQ' 6-max Seat #1 is the button
Seat 1: 6fLdOUCRtX71xbVRhJEq8w ($205 in chips)
Seat 2: 5Y+ZGWLI4gnlpApDX5vy1A ($408.75 in chips)
Seat 3: ubtx4Z5L+AcK71MTvYiGVw ($245 in chips)
Seat 4: UaZ5yj+6LjtWqMQg2QskUw ($106.30 in chips)
Seat 6: mfy7uGZcqA2PVQqEVbJ7+g ($116.45 in chips)
5Y+ZGWLI4gnlpApDX5vy1A: posts small blind $1
ubtx4Z5L+AcK71MTvYiGVw: posts big blind $2
*** HOLE CARDS ***
UaZ5yj+6LjtWqMQg2QskUw: folds
mfy7uGZcqA2PVQqEVbJ7+g: folds
6fLdOUCRtX71xbVRhJEq8w: raises $4 to $6
5Y+ZGWLI4gnlpApDX5vy1A: raises $13 to $19
ubtx4Z5L+AcK71MTvYiGVw: folds
6fLdOUCRtX71xbVRhJEq8w: calls $13
*** FLOP *** [Qs Qd 9d]
5Y+ZGWLI4gnlpApDX5vy1A: checks
6fLdOUCRtX71xbVRhJEq8w: checks
*** TURN *** [Qs Qd 9d] [Js]
5Y+ZGWLI4gnlpApDX5vy1A: checks
6fLdOUCRtX71xbVRhJEq8w: checks
*** RIVER *** [Qs Qd 9d Js] [Qh]
5Y+ZGWLI4gnlpApDX5vy1A: checks
6fLdOUCRtX71xbVRhJEq8w: checks
*** SHOW DOWN ***
5Y+ZGWLI4gnlpApDX5vy1A: shows [Ac Kh] (three of a kind, Queens)
6fLdOUCRtX71xbVRhJEq8w: shows [2h 2s] (a full house, Queens full of Deuces)
6fLdOUCRtX71xbVRhJEq8w collected $38 from pot
*** SUMMARY ***
Total pot $40 | Rake $2
Board [Qs Qd 9d Js Qh]
Seat 1: 6fLdOUCRtX71xbVRhJEq8w (button) showed [2h 2s] and won ($38) with a full house, Queens full of Deuces
Seat 2: 5Y+ZGWLI4gnlpApDX5vy1A (small blind) showed [Ac Kh] and lost with three of a kind, Queens
Seat 3: ubtx4Z5L+AcK71MTvYiGVw (big blind) folded before Flop
Seat 4: UaZ5yj+6LjtWqMQg2QskUw folded before Flop (didn't bet)
Seat 6: mfy7uGZcqA2PVQqEVbJ7+g folded before Flop (didn't bet)



PokerStars Game #59941207412:  Hold'em No Limit ($1/$2) - 2009/07/01 1:28:43 ET
Table '8Y6PEyoNuepZTai2Q56aHw' 9-max Seat #7 is the button
Seat 1: 5Q8U6iZbeO7xJSS4qvDP5g ($314.80 in chips)
Seat 2: gDCJIAlovbPnTvMM7Dd1gA ($159.35 in chips)
Seat 3: WUlHm+ydPPHG7Lb0rePSdA ($217.10 in chips)
Seat 4: xKkwALG38OfLQ9DXuJgR1w ($243.55 in chips)
Seat 6: NtLDBSjsJQEKekh5cdinvw ($377.35 in chips)
Seat 7: Kzta8yu9vxHT4B70mjBZ+w ($200.30 in chips)
Seat 8: rW/MyplHylMSBRaoRUzWrg ($38 in chips)
Seat 9: F7m34OOfAQ7annesMHVjKw ($200 in chips)
rW/MyplHylMSBRaoRUzWrg: posts small blind $1
F7m34OOfAQ7annesMHVjKw: posts big blind $2
*** HOLE CARDS ***
5Q8U6iZbeO7xJSS4qvDP5g: folds
gDCJIAlovbPnTvMM7Dd1gA: folds
WUlHm+ydPPHG7Lb0rePSdA: folds
xKkwALG38OfLQ9DXuJgR1w: calls $2
NtLDBSjsJQEKekh5cdinvw: folds
Kzta8yu9vxHT4B70mjBZ+w: folds
rW/MyplHylMSBRaoRUzWrg: calls $1
F7m34OOfAQ7annesMHVjKw: checks
*** FLOP *** [7s 9c 2d]
rW/MyplHylMSBRaoRUzWrg: checks
F7m34OOfAQ7annesMHVjKw: checks
xKkwALG38OfLQ9DXuJgR1w: bets $6
rW/MyplHylMSBRaoRUzWrg: folds
F7m34OOfAQ7annesMHVjKw: folds
xKkwALG38OfLQ9DXuJgR1w collected $5.70 from pot
xKkwALG38OfLQ9DXuJgR1w: doesn't show hand
*** SUMMARY ***
Total pot $6 | Rake $0.30
Board [7s 9c 2d]
Seat 1: 5Q8U6iZbeO7xJSS4qvDP5g folded before Flop (didn't bet)
Seat 2: gDCJIAlovbPnTvMM7Dd1gA folded before Flop (didn't bet)
Seat 3: WUlHm+ydPPHG7Lb0rePSdA folded before Flop (didn't bet)
Seat 4: xKkwALG38OfLQ9DXuJgR1w collected ($5.70)
Seat 6: NtLDBSjsJQEKekh5cdinvw folded before Flop (didn't bet)
Seat 7: Kzta8yu9vxHT4B70mjBZ+w (button) folded before Flop (didn't bet)
Seat 8: rW/MyplHylMSBRaoRUzWrg (small blind) folded on the Flop
Seat 9: F7m34OOfAQ7annesMHVjKw (big blind) folded on the Flop



PokerStars Game #59941208334:  Hold'em No Limit ($1/$2) - 2009/07/01 1:28:45 ET
Table 'pPQgcj9XT9CHBsbo1WTBug' 6-max Seat #1 is the button
Seat 1: DFVYDA6dKQy7R7mGIKogZA ($155.20 in chips)
Seat 2: qXDd0ZyMIse0OBu8pxeQ3Q ($200 in chips)
Seat 3: 54yWzRRgS0oZ+S6LwZBxMQ ($52.75 in chips)
Seat 4: gqlysXCbT8V54f/1lf9h3A ($39.10 in chips)
Seat 5: vkfxu8f/jMYKUk6Ly4eujw ($199.55 in chips)
Seat 6: Yr7pZltpy3IUNdKS9PCEiw ($301.30 in chips)
qXDd0ZyMIse0OBu8pxeQ3Q: posts small blind $1
54yWzRRgS0oZ+S6LwZBxMQ: posts big blind $2
*** HOLE CARDS ***
gqlysXCbT8V54f/1lf9h3A: calls $2
vkfxu8f/jMYKUk6Ly4eujw: folds
Yr7pZltpy3IUNdKS9PCEiw: folds
DFVYDA6dKQy7R7mGIKogZA: folds
qXDd0ZyMIse0OBu8pxeQ3Q: folds
54yWzRRgS0oZ+S6LwZBxMQ: checks
*** FLOP *** [7h 2s 4d]
54yWzRRgS0oZ+S6LwZBxMQ: bets $4
gqlysXCbT8V54f/1lf9h3A: folds
54yWzRRgS0oZ+S6LwZBxMQ collected $4.75 from pot
54yWzRRgS0oZ+S6LwZBxMQ: doesn't show hand
*** SUMMARY ***
Total pot $5 | Rake $0.25
Board [7h 2s 4d]
Seat 1: DFVYDA6dKQy7R7mGIKogZA (button) folded before Flop (didn't bet)
Seat 2: qXDd0ZyMIse0OBu8pxeQ3Q (small blind) folded before Flop
Seat 3: 54yWzRRgS0oZ+S6LwZBxMQ (big blind) collected ($4.75)
Seat 4: gqlysXCbT8V54f/1lf9h3A folded on the Flop
Seat 5: vkfxu8f/jMYKUk6Ly4eujw folded before Flop (didn't bet)
Seat 6: Yr7pZltpy3IUNdKS9PCEiw folded before Flop (didn't bet)



PokerStars Game #59941209012:  Hold'em No Limit ($1/$2) - 2009/07/01 1:28:46 ET
Table 'uJ9juaXXg9yIcSU8amxaXQ' 6-max Seat #5 is the button
Seat 1: JsqOjN/eHz0uYVf/PyUJ6Q ($144.50 in chips)
Seat 2: VvdR9F3I+2yELkfTVvC1dg ($229.10 in chips)
Seat 3: qXDd0ZyMIse0OBu8pxeQ3Q ($244 in chips)
Seat 4: zNjJ/y4emmF+vzrCDd+ooA ($237.05 in chips)
Seat 5: YsLQ3BAvgQHWXMAv3Wv6Hg ($200 in chips)
Seat 6: 2DFp9Veq1xxq64dCjwNuUw ($55.60 in chips)
2DFp9Veq1xxq64dCjwNuUw: posts small blind $1
JsqOjN/eHz0uYVf/PyUJ6Q: posts big blind $2
*** HOLE CARDS ***
VvdR9F3I+2yELkfTVvC1dg: folds
qXDd0ZyMIse0OBu8pxeQ3Q: folds
zNjJ/y4emmF+vzrCDd+ooA: folds
YsLQ3BAvgQHWXMAv3Wv6Hg: folds
2DFp9Veq1xxq64dCjwNuUw: folds
JsqOjN/eHz0uYVf/PyUJ6Q collected $2 from pot
JsqOjN/eHz0uYVf/PyUJ6Q: doesn't show hand
*** SUMMARY ***
Total pot $2 | Rake $0
Seat 1: JsqOjN/eHz0uYVf/PyUJ6Q (big blind) collected ($2)
Seat 2: VvdR9F3I+2yELkfTVvC1dg folded before Flop (didn't bet)
Seat 3: qXDd0ZyMIse0OBu8pxeQ3Q folded before Flop (didn't bet)
Seat 4: zNjJ/y4emmF+vzrCDd+ooA folded before Flop (didn't bet)
Seat 5: YsLQ3BAvgQHWXMAv3Wv6Hg (button) folded before Flop (didn't bet)
Seat 6: 2DFp9Veq1xxq64dCjwNuUw (small blind) folded before Flop



PokerStars Game #59941209098:  Hold'em No Limit ($1/$2) - 2009/07/01 1:28:46 ET
Table 'on4i1U1lCRmxsduFD3xiSg' 9-max Seat #3 is the button
Seat 1: so5k3vFDmokh2q3dImJ1GQ ($179.30 in chips)
Seat 2: NqSvZNzJ4RkR3sCmgQnyLw ($32.45 in chips)
Seat 3: GX1heJ+DSsvm7gzSPsYhhQ ($37.70 in chips)
Seat 4: DFQVuszLVclqjA46pN4Vvw ($25.85 in chips)
Seat 5: 37j/5DgMG5m9lMfFofEAOg ($87.35 in chips)
Seat 7: /inIs/z/PcX+TniIFpaxpg ($302.40 in chips)
Seat 9: iMe5yhc+1BaiIPHet3NMrA ($208.25 in chips)
DFQVuszLVclqjA46pN4Vvw: posts small blind $1
37j/5DgMG5m9lMfFofEAOg: posts big blind $2
+T/63sAeZzWyHchahJ36GQ: sits out
ZYHoLw2lWmRS7CSHi8L8Xg: sits out
*** HOLE CARDS ***
/inIs/z/PcX+TniIFpaxpg: folds
iMe5yhc+1BaiIPHet3NMrA: folds
so5k3vFDmokh2q3dImJ1GQ: folds
NqSvZNzJ4RkR3sCmgQnyLw: raises $2 to $4
GX1heJ+DSsvm7gzSPsYhhQ: folds
DFQVuszLVclqjA46pN4Vvw: calls $3
37j/5DgMG5m9lMfFofEAOg: calls $2
*** FLOP *** [4d Ac 5c]
DFQVuszLVclqjA46pN4Vvw: checks
37j/5DgMG5m9lMfFofEAOg: checks
NqSvZNzJ4RkR3sCmgQnyLw: bets $10
DFQVuszLVclqjA46pN4Vvw: calls $10
37j/5DgMG5m9lMfFofEAOg: folds
*** TURN *** [4d Ac 5c] [Ad]
DFQVuszLVclqjA46pN4Vvw: checks
NqSvZNzJ4RkR3sCmgQnyLw: bets $18.45 and is all-in
DFQVuszLVclqjA46pN4Vvw: calls $11.85 and is all-in
*** RIVER *** [4d Ac 5c Ad] [7h]
*** SHOW DOWN ***
DFQVuszLVclqjA46pN4Vvw: shows [4s 3s] (two pair, Aces and Fours)
NqSvZNzJ4RkR3sCmgQnyLw: mucks hand
DFQVuszLVclqjA46pN4Vvw collected $53 from pot
*** SUMMARY ***
Total pot $55.70 | Rake $2.70
Board [4d Ac 5c Ad 7h]
Seat 1: so5k3vFDmokh2q3dImJ1GQ folded before Flop (didn't bet)
Seat 2: NqSvZNzJ4RkR3sCmgQnyLw mucked
Seat 3: GX1heJ+DSsvm7gzSPsYhhQ (button) folded before Flop (didn't bet)
Seat 4: DFQVuszLVclqjA46pN4Vvw (small blind) showed [4s 3s] and won ($53) with two pair, Aces and Fours
Seat 5: 37j/5DgMG5m9lMfFofEAOg (big blind) folded on the Flop
Seat 7: /inIs/z/PcX+TniIFpaxpg folded before Flop (didn't bet)
Seat 9: iMe5yhc+1BaiIPHet3NMrA folded before Flop (didn't bet)



PokerStars Game #59941210322:  Hold'em No Limit ($1/$2) - 2009/07/01 1:28:48 ET
Table 'CFkQcfWjKccZaZDf71FK+w' 6-max Seat #3 is the button
Seat 2: ewN/vzF22+/gdzjIKBOlkA ($207.80 in chips)
Seat 3: 09BNF4quPDzanQzM8vc6WA ($45.45 in chips)
Seat 4: ygTTt5ehT4aF86q1a8/R+w ($285.25 in chips)
Seat 5: 2lOU1DcvUZaMcxZ95XfzXw ($142.15 in chips)
Seat 6: ORVqY3rf9X6ANA/8s+On2Q ($94.60 in chips)
ygTTt5ehT4aF86q1a8/R+w: posts small blind $1
2lOU1DcvUZaMcxZ95XfzXw: posts big blind $2
*** HOLE CARDS ***
ORVqY3rf9X6ANA/8s+On2Q: folds
ewN/vzF22+/gdzjIKBOlkA: folds
JsC+WvfzqlxVs9G8/gSQAQ leaves the table
09BNF4quPDzanQzM8vc6WA: folds
ygTTt5ehT4aF86q1a8/R+w: folds
2lOU1DcvUZaMcxZ95XfzXw collected $2 from pot
*** SUMMARY ***
Total pot $2 | Rake $0
Seat 2: ewN/vzF22+/gdzjIKBOlkA folded before Flop (didn't bet)
Seat 3: 09BNF4quPDzanQzM8vc6WA (button) folded before Flop (didn't bet)
Seat 4: ygTTt5ehT4aF86q1a8/R+w (small blind) folded before Flop
Seat 5: 2lOU1DcvUZaMcxZ95XfzXw (big blind) collected ($2)
Seat 6: ORVqY3rf9X6ANA/8s+On2Q folded before Flop (didn't bet)



PokerStars Game #59941210586:  Hold'em No Limit ($1/$2) - 2009/07/01 1:28:49 ET
Table 'mGpP9StWRnoeiBDExc6Frg' 6-max Seat #1 is the button
Seat 1: VvdR9F3I+2yELkfTVvC1dg ($279.15 in chips)
Seat 2: vkfxu8f/jMYKUk6Ly4eujw ($201 in chips)
Seat 3: 7acrZUQC3Zc9BNLjoKIcLQ ($41.05 in chips)
Seat 4: 4dcDwIHRm96PwtqkpQiuiA ($82.70 in chips)
Seat 5: d1puGuVBE0fidn+5eRJ0tw ($176.95 in chips)
Seat 6: B2Ih1sr5VZk+8He7rcrMtQ ($463.05 in chips)
vkfxu8f/jMYKUk6Ly4eujw: posts small blind $1
7acrZUQC3Zc9BNLjoKIcLQ: posts big blind $2
*** HOLE CARDS ***
4dcDwIHRm96PwtqkpQiuiA: folds
d1puGuVBE0fidn+5eRJ0tw: folds
B2Ih1sr5VZk+8He7rcrMtQ: folds
VvdR9F3I+2yELkfTVvC1dg: raises $2 to $4
vkfxu8f/jMYKUk6Ly4eujw: folds
7acrZUQC3Zc9BNLjoKIcLQ: calls $2
*** FLOP *** [Js 9s Jh]
7acrZUQC3Zc9BNLjoKIcLQ: checks
VvdR9F3I+2yELkfTVvC1dg: bets $6.40
7acrZUQC3Zc9BNLjoKIcLQ: folds
VvdR9F3I+2yELkfTVvC1dg collected $8.55 from pot
VvdR9F3I+2yELkfTVvC1dg: doesn't show hand
*** SUMMARY ***
Total pot $9 | Rake $0.45
Board [Js 9s Jh]
Seat 1: VvdR9F3I+2yELkfTVvC1dg (button) collected ($8.55)
Seat 2: vkfxu8f/jMYKUk6Ly4eujw (small blind) folded before Flop
Seat 3: 7acrZUQC3Zc9BNLjoKIcLQ (big blind) folded on the Flop
Seat 4: 4dcDwIHRm96PwtqkpQiuiA folded before Flop (didn't bet)
Seat 5: d1puGuVBE0fidn+5eRJ0tw folded before Flop (didn't bet)
Seat 6: B2Ih1sr5VZk+8He7rcrMtQ folded before Flop (didn't bet)



PokerStars Game #59941210792:  Hold'em No Limit ($1/$2) - 2009/07/01 1:28:49 ET
Table '/dyk+YdRGv90j2box35j8w' 6-max Seat #2 is the button
Seat 1: 8srN1dKQePlsv0GyTada+Q ($201.80 in chips)
Seat 2: qCnEYuAE5y5A7bk6fO5/jQ ($473.60 in chips)
Seat 4: z/u1YTnkiIDrtp/2cA2dBg ($206.60 in chips)
Seat 5: VvdR9F3I+2yELkfTVvC1dg ($200 in chips)
z/u1YTnkiIDrtp/2cA2dBg: posts small blind $1
VvdR9F3I+2yELkfTVvC1dg: posts big blind $2
*** HOLE CARDS ***
8srN1dKQePlsv0GyTada+Q: folds
qCnEYuAE5y5A7bk6fO5/jQ: raises $4 to $6
z/u1YTnkiIDrtp/2cA2dBg: folds
VvdR9F3I+2yELkfTVvC1dg: folds
qCnEYuAE5y5A7bk6fO5/jQ collected $5 from pot
qCnEYuAE5y5A7bk6fO5/jQ: doesn't show hand
*** SUMMARY ***
Total pot $5 | Rake $0
Seat 1: 8srN1dKQePlsv0GyTada+Q folded before Flop (didn't bet)
Seat 2: qCnEYuAE5y5A7bk6fO5/jQ (button) collected ($5)
Seat 4: z/u1YTnkiIDrtp/2cA2dBg (small blind) folded before Flop
Seat 5: VvdR9F3I+2yELkfTVvC1dg (big blind) folded before Flop



PokerStars Game #59941212620:  Hold'em No Limit ($1/$2) - 2009/07/01 1:28:52 ET
Table 'ZzSIe0zTCDv+n6hfbY5tTg' 6-max Seat #6 is the button
Seat 1: VvdR9F3I+2yELkfTVvC1dg ($200 in chips)
Seat 2: B87ikIyZ/TzAVeXf38Ny0g ($286 in chips)
Seat 3: gsugPj31Hui3Jefl98MBOA ($203 in chips)
Seat 4: qXDd0ZyMIse0OBu8pxeQ3Q ($209.70 in chips)
Seat 5: 3dAbvkxS5NPQTBAbvpinVg ($480.30 in chips)
Seat 6: 09BNF4quPDzanQzM8vc6WA ($23.05 in chips)
VvdR9F3I+2yELkfTVvC1dg: posts small blind $1
B87ikIyZ/TzAVeXf38Ny0g: posts big blind $2
*** HOLE CARDS ***
gsugPj31Hui3Jefl98MBOA: calls $2
qXDd0ZyMIse0OBu8pxeQ3Q: raises $7 to $9
3dAbvkxS5NPQTBAbvpinVg: folds
09BNF4quPDzanQzM8vc6WA: folds
VvdR9F3I+2yELkfTVvC1dg: folds
B87ikIyZ/TzAVeXf38Ny0g: folds
gsugPj31Hui3Jefl98MBOA: folds
qXDd0ZyMIse0OBu8pxeQ3Q collected $7 from pot
*** SUMMARY ***
Total pot $7 | Rake $0
Seat 1: VvdR9F3I+2yELkfTVvC1dg (small blind) folded before Flop
Seat 2: B87ikIyZ/TzAVeXf38Ny0g (big blind) folded before Flop
Seat 3: gsugPj31Hui3Jefl98MBOA folded before Flop
Seat 4: qXDd0ZyMIse0OBu8pxeQ3Q collected ($7)
Seat 5: 3dAbvkxS5NPQTBAbvpinVg folded before Flop (didn't bet)
Seat 6: 09BNF4quPDzanQzM8vc6WA (button) folded before Flop (didn't bet)



PokerStars Game #59941215208:  Hold'em No Limit ($1/$2) - 2009/07/01 1:28:57 ET
Table 'aSf77Sj8QEnzcc0WaxVD4Q' 6-max Seat #6 is the button
Seat 1: UELtvp+JfwI7XDGVwSxZXA ($153.55 in chips)
Seat 2: vkfxu8f/jMYKUk6Ly4eujw ($206 in chips)
Seat 3: 9dpyyjDTCed6nV7JhaUUpw ($526.70 in chips)
Seat 4: YsLQ3BAvgQHWXMAv3Wv6Hg ($259.70 in chips)
Seat 5: VvdR9F3I+2yELkfTVvC1dg ($240 in chips)
Seat 6: vkoJRf3gidxY1pPi0AFWww ($129.60 in chips)
UELtvp+JfwI7XDGVwSxZXA: posts small blind $1
vkfxu8f/jMYKUk6Ly4eujw: posts big blind $2
*** HOLE CARDS ***
9dpyyjDTCed6nV7JhaUUpw: folds
YsLQ3BAvgQHWXMAv3Wv6Hg: folds
VvdR9F3I+2yELkfTVvC1dg: folds
vkoJRf3gidxY1pPi0AFWww: folds
UELtvp+JfwI7XDGVwSxZXA: calls $1
vkfxu8f/jMYKUk6Ly4eujw: checks
*** FLOP *** [Tc 2d 5c]
UELtvp+JfwI7XDGVwSxZXA: checks
vkfxu8f/jMYKUk6Ly4eujw: checks
*** TURN *** [Tc 2d 5c] [Kd]
UELtvp+JfwI7XDGVwSxZXA: checks
vkfxu8f/jMYKUk6Ly4eujw: checks
*** RIVER *** [Tc 2d 5c Kd] [9s]
UELtvp+JfwI7XDGVwSxZXA: checks
vkfxu8f/jMYKUk6Ly4eujw: checks
*** SHOW DOWN ***
UELtvp+JfwI7XDGVwSxZXA: shows [6d 7h] (high card King)
vkfxu8f/jMYKUk6Ly4eujw: shows [Ad 8c] (high card Ace)
vkfxu8f/jMYKUk6Ly4eujw collected $3.80 from pot
*** SUMMARY ***
Total pot $4 | Rake $0.20
Board [Tc 2d 5c Kd 9s]
Seat 1: UELtvp+JfwI7XDGVwSxZXA (small blind) showed [6d 7h] and lost with high card King
Seat 2: vkfxu8f/jMYKUk6Ly4eujw (big blind) showed [Ad 8c] and won ($3.80) with high card Ace
Seat 3: 9dpyyjDTCed6nV7JhaUUpw folded before Flop (didn't bet)
Seat 4: YsLQ3BAvgQHWXMAv3Wv6Hg folded before Flop (didn't bet)
Seat 5: VvdR9F3I+2yELkfTVvC1dg folded before Flop (didn't bet)
Seat 6: vkoJRf3gidxY1pPi0AFWww (button) folded before Flop (didn't bet)



PokerStars Game #59941215000:  Hold'em No Limit ($1/$2) - 2009/07/01 1:28:57 ET
Table 'UGLAZZyv+cXmnKjYin0etA' 6-max Seat #3 is the button
Seat 1: vkfxu8f/jMYKUk6Ly4eujw ($196.05 in chips)
Seat 2: eDLH1PUXFpvJBNMXBVQcGA ($276.35 in chips)
Seat 3: ygTTt5ehT4aF86q1a8/R+w ($100 in chips)
Seat 4: SiGJDsvRViJX05vHhA80GQ ($198 in chips)
Seat 5: 54yWzRRgS0oZ+S6LwZBxMQ ($35.45 in chips)
SiGJDsvRViJX05vHhA80GQ: posts small blind $1
54yWzRRgS0oZ+S6LwZBxMQ: posts big blind $2
*** HOLE CARDS ***
vkfxu8f/jMYKUk6Ly4eujw: folds
eDLH1PUXFpvJBNMXBVQcGA: folds
ygTTt5ehT4aF86q1a8/R+w: folds
SiGJDsvRViJX05vHhA80GQ: folds
54yWzRRgS0oZ+S6LwZBxMQ collected $2 from pot
*** SUMMARY ***
Total pot $2 | Rake $0
Seat 1: vkfxu8f/jMYKUk6Ly4eujw folded before Flop (didn't bet)
Seat 2: eDLH1PUXFpvJBNMXBVQcGA folded before Flop (didn't bet)
Seat 3: ygTTt5ehT4aF86q1a8/R+w (button) folded before Flop (didn't bet)
Seat 4: SiGJDsvRViJX05vHhA80GQ (small blind) folded before Flop
Seat 5: 54yWzRRgS0oZ+S6LwZBxMQ (big blind) collected ($2)



PokerStars Game #59941215678:  Hold'em No Limit ($1/$2) - 2009/07/01 1:28:58 ET
Table 'qVXak+oTeDXMGbWa4sDU5Q' 9-max Seat #8 is the button
Seat 1: H6Z4+qu8gR0VUiPOijndVg ($212.55 in chips)
Seat 2: rW/MyplHylMSBRaoRUzWrg ($74 in chips)
Seat 3: WUlHm+ydPPHG7Lb0rePSdA ($153.65 in chips)
Seat 4: lQYT23h5QCUVZAKxjOO39Q ($203.70 in chips)
Seat 5: FWGiDqRwvLeKmHq9t4Jy9w ($268.80 in chips)
Seat 6: GX1heJ+DSsvm7gzSPsYhhQ ($34 in chips)
Seat 7: PfmlvZlFiss79a6IoEr11g ($163.30 in chips)
Seat 8: Z0rzUi0y1x80UdIpofoNbA ($122.55 in chips)
Seat 9: CkE3IyJF1KvdaAOmZY5XqQ ($200 in chips)
CkE3IyJF1KvdaAOmZY5XqQ: posts small blind $1
H6Z4+qu8gR0VUiPOijndVg: posts big blind $2
*** HOLE CARDS ***
rW/MyplHylMSBRaoRUzWrg: folds
WUlHm+ydPPHG7Lb0rePSdA: folds
lQYT23h5QCUVZAKxjOO39Q: folds
FWGiDqRwvLeKmHq9t4Jy9w: folds
GX1heJ+DSsvm7gzSPsYhhQ: folds
PfmlvZlFiss79a6IoEr11g: folds
Z0rzUi0y1x80UdIpofoNbA: raises $2 to $4
CkE3IyJF1KvdaAOmZY5XqQ: folds
H6Z4+qu8gR0VUiPOijndVg: folds
Z0rzUi0y1x80UdIpofoNbA collected $5 from pot
Z0rzUi0y1x80UdIpofoNbA: doesn't show hand
*** SUMMARY ***
Total pot $5 | Rake $0
Seat 1: H6Z4+qu8gR0VUiPOijndVg (big blind) folded before Flop
Seat 2: rW/MyplHylMSBRaoRUzWrg folded before Flop (didn't bet)
Seat 3: WUlHm+ydPPHG7Lb0rePSdA folded before Flop (didn't bet)
Seat 4: lQYT23h5QCUVZAKxjOO39Q folded before Flop (didn't bet)
Seat 5: FWGiDqRwvLeKmHq9t4Jy9w folded before Flop (didn't bet)
Seat 6: GX1heJ+DSsvm7gzSPsYhhQ folded before Flop (didn't bet)
Seat 7: PfmlvZlFiss79a6IoEr11g folded before Flop (didn't bet)
Seat 8: Z0rzUi0y1x80UdIpofoNbA (button) collected ($5)
Seat 9: CkE3IyJF1KvdaAOmZY5XqQ (small blind) folded before Flop



PokerStars Game #59941216400:  Hold'em No Limit ($1/$2) - 2009/07/01 1:28:59 ET
Table 'jlrIxbrVIG+gjaUYT4za8g' 6-max Seat #6 is the button
Seat 1: ygTTt5ehT4aF86q1a8/R+w ($259.30 in chips)
Seat 3: gnYme0DNFflnMhrdbxe1Ag ($200 in chips)
Seat 4: 8srN1dKQePlsv0GyTada+Q ($224.55 in chips)
Seat 5: AyBB0k3Dcl7xbXUeGMw06g ($71.90 in chips)
Seat 6: vkfxu8f/jMYKUk6Ly4eujw ($309 in chips)
ygTTt5ehT4aF86q1a8/R+w: posts small blind $1
on4ebXPJvUBOcHOBMQsRSg: is sitting out
gnYme0DNFflnMhrdbxe1Ag: posts big blind $2
*** HOLE CARDS ***
8srN1dKQePlsv0GyTada+Q: folds
AyBB0k3Dcl7xbXUeGMw06g: calls $2
vkfxu8f/jMYKUk6Ly4eujw: folds
ygTTt5ehT4aF86q1a8/R+w: folds
gnYme0DNFflnMhrdbxe1Ag: checks
*** FLOP *** [7c 4c Jc]
on4ebXPJvUBOcHOBMQsRSg leaves the table
gnYme0DNFflnMhrdbxe1Ag: bets $4
/PH6Ffnho4Ysm8S3V/oa+w joins the table at seat #2
AyBB0k3Dcl7xbXUeGMw06g: folds
gnYme0DNFflnMhrdbxe1Ag collected $4.75 from pot
*** SUMMARY ***
Total pot $5 | Rake $0.25
Board [7c 4c Jc]
Seat 1: ygTTt5ehT4aF86q1a8/R+w (small blind) folded before Flop
Seat 3: gnYme0DNFflnMhrdbxe1Ag (big blind) collected ($4.75)
Seat 4: 8srN1dKQePlsv0GyTada+Q folded before Flop (didn't bet)
Seat 5: AyBB0k3Dcl7xbXUeGMw06g folded on the Flop
Seat 6: vkfxu8f/jMYKUk6Ly4eujw (button) folded before Flop (didn't bet)



PokerStars Game #59941217056:  Hold'em No Limit ($1/$2) - 2009/07/01 1:29:00 ET
Table 'YqGfR5eHfMeSjb9a+QU9rg' 9-max Seat #1 is the button
Seat 1: rW/MyplHylMSBRaoRUzWrg ($34 in chips)
Seat 2: W3Nqt1GWlTi9tXQXMNEvgw ($396.25 in chips)
Seat 3: /gll27k+xWYV7Fbki0lFDQ ($261.75 in chips)
Seat 5: CkE3IyJF1KvdaAOmZY5XqQ ($200 in chips)
Seat 6: TAfo4veNRaRlzDXMMYS3Jg ($37 in chips)
Seat 7: 41aZuLBz9nAi2GPVKabmCw ($97.45 in chips)
Seat 8: JnV3SM2D6dAFYyGZHHpvrg ($95.25 in chips)
Seat 9: /inIs/z/PcX+TniIFpaxpg ($205.20 in chips)
W3Nqt1GWlTi9tXQXMNEvgw: posts small blind $1
/gll27k+xWYV7Fbki0lFDQ: posts big blind $2
GX1heJ+DSsvm7gzSPsYhhQ: sits out
*** HOLE CARDS ***
CkE3IyJF1KvdaAOmZY5XqQ: folds
TAfo4veNRaRlzDXMMYS3Jg: folds
41aZuLBz9nAi2GPVKabmCw: calls $2
JnV3SM2D6dAFYyGZHHpvrg: calls $2
/inIs/z/PcX+TniIFpaxpg: folds
rW/MyplHylMSBRaoRUzWrg: folds
W3Nqt1GWlTi9tXQXMNEvgw: calls $1
/gll27k+xWYV7Fbki0lFDQ: checks
*** FLOP *** [2s Th 6c]
W3Nqt1GWlTi9tXQXMNEvgw: checks
/gll27k+xWYV7Fbki0lFDQ: checks
41aZuLBz9nAi2GPVKabmCw: checks
JnV3SM2D6dAFYyGZHHpvrg: checks
*** TURN *** [2s Th 6c] [Ac]
W3Nqt1GWlTi9tXQXMNEvgw: bets $4
/gll27k+xWYV7Fbki0lFDQ: folds
41aZuLBz9nAi2GPVKabmCw: folds
JnV3SM2D6dAFYyGZHHpvrg: folds
W3Nqt1GWlTi9tXQXMNEvgw collected $7.60 from pot
W3Nqt1GWlTi9tXQXMNEvgw: doesn't show hand
*** SUMMARY ***
Total pot $8 | Rake $0.40
Board [2s Th 6c Ac]
Seat 1: rW/MyplHylMSBRaoRUzWrg (button) folded before Flop (didn't bet)
Seat 2: W3Nqt1GWlTi9tXQXMNEvgw (small blind) collected ($7.60)
Seat 3: /gll27k+xWYV7Fbki0lFDQ (big blind) folded on the Turn
Seat 5: CkE3IyJF1KvdaAOmZY5XqQ folded before Flop (didn't bet)
Seat 6: TAfo4veNRaRlzDXMMYS3Jg folded before Flop (didn't bet)
Seat 7: 41aZuLBz9nAi2GPVKabmCw folded on the Turn
Seat 8: JnV3SM2D6dAFYyGZHHpvrg folded on the Turn
Seat 9: /inIs/z/PcX+TniIFpaxpg folded before Flop (didn't bet)



PokerStars Game #59941217324:  Hold'em No Limit ($1/$2) - 2009/07/01 1:29:01 ET
Table 'TsEDkiO4tzCTCzJ7tNdEqw' 6-max Seat #1 is the button
Seat 1: MfXQsYD8pGeCS7XOtyV+vw ($100.05 in chips)
Seat 2: 4dcDwIHRm96PwtqkpQiuiA ($79.10 in chips)
Seat 3: ubtx4Z5L+AcK71MTvYiGVw ($200 in chips)
Seat 4: K8MXCrNAVYlMnnCeM32Kxw ($116.50 in chips)
Seat 5: VvdR9F3I+2yELkfTVvC1dg ($258 in chips)
Seat 6: uCqEjnxh2/vFBjKYkfTOkw ($142.35 in chips)
4dcDwIHRm96PwtqkpQiuiA: posts small blind $1
ubtx4Z5L+AcK71MTvYiGVw: posts big blind $2
*** HOLE CARDS ***
K8MXCrNAVYlMnnCeM32Kxw: folds
VvdR9F3I+2yELkfTVvC1dg: raises $2 to $4
uCqEjnxh2/vFBjKYkfTOkw: folds
MfXQsYD8pGeCS7XOtyV+vw: calls $4
4dcDwIHRm96PwtqkpQiuiA: folds
ubtx4Z5L+AcK71MTvYiGVw: calls $2
*** FLOP *** [9s 2d 9d]
ubtx4Z5L+AcK71MTvYiGVw: checks
VvdR9F3I+2yELkfTVvC1dg: bets $9.25
MfXQsYD8pGeCS7XOtyV+vw: folds
ubtx4Z5L+AcK71MTvYiGVw: folds
VvdR9F3I+2yELkfTVvC1dg collected $12.35 from pot
VvdR9F3I+2yELkfTVvC1dg: doesn't show hand
*** SUMMARY ***
Total pot $13 | Rake $0.65
Board [9s 2d 9d]
Seat 1: MfXQsYD8pGeCS7XOtyV+vw (button) folded on the Flop
Seat 2: 4dcDwIHRm96PwtqkpQiuiA (small blind) folded before Flop
Seat 3: ubtx4Z5L+AcK71MTvYiGVw (big blind) folded on the Flop
Seat 4: K8MXCrNAVYlMnnCeM32Kxw folded before Flop (didn't bet)
Seat 5: VvdR9F3I+2yELkfTVvC1dg collected ($12.35)
Seat 6: uCqEjnxh2/vFBjKYkfTOkw folded before Flop (didn't bet)



PokerStars Game #59941220732:  Hold'em No Limit ($1/$2) - 2009/07/01 1:29:06 ET
Table 'kq5zaQ+1hLNf8LZfGnbTAA' 6-max Seat #6 is the button
Seat 1: 8srN1dKQePlsv0GyTada+Q ($406 in chips)
Seat 2: nXDI8Y/S6POzRwANu3d8hQ ($197 in chips)
Seat 3: vkfxu8f/jMYKUk6Ly4eujw ($218.95 in chips)
Seat 4: 3dAbvkxS5NPQTBAbvpinVg ($203 in chips)
Seat 5: kfASJqTbXek+zc8ZKsZL1Q ($75.45 in chips)
Seat 6: mfy7uGZcqA2PVQqEVbJ7+g ($194.25 in chips)
8srN1dKQePlsv0GyTada+Q: posts small blind $1
nXDI8Y/S6POzRwANu3d8hQ: posts big blind $2
*** HOLE CARDS ***
vkfxu8f/jMYKUk6Ly4eujw: folds
3dAbvkxS5NPQTBAbvpinVg: raises $4 to $6
kfASJqTbXek+zc8ZKsZL1Q: raises $24 to $30
mfy7uGZcqA2PVQqEVbJ7+g: folds
8srN1dKQePlsv0GyTada+Q: folds
nXDI8Y/S6POzRwANu3d8hQ: folds
3dAbvkxS5NPQTBAbvpinVg: raises $173 to $203 and is all-in
kfASJqTbXek+zc8ZKsZL1Q: calls $45.45 and is all-in
*** FLOP *** [8s 9d Ah]
*** TURN *** [8s 9d Ah] [Kc]
*** RIVER *** [8s 9d Ah Kc] [8d]
*** SHOW DOWN ***
3dAbvkxS5NPQTBAbvpinVg: shows [Qh Qd] (two pair, Queens and Eights)
kfASJqTbXek+zc8ZKsZL1Q: mucks hand
3dAbvkxS5NPQTBAbvpinVg collected $150.90 from pot
*** SUMMARY ***
Total pot $153.90 | Rake $3
Board [8s 9d Ah Kc 8d]
Seat 1: 8srN1dKQePlsv0GyTada+Q (small blind) folded before Flop
Seat 2: nXDI8Y/S6POzRwANu3d8hQ (big blind) folded before Flop
Seat 3: vkfxu8f/jMYKUk6Ly4eujw folded before Flop (didn't bet)
Seat 4: 3dAbvkxS5NPQTBAbvpinVg showed [Qh Qd] and won ($150.90) with two pair, Queens and Eights
Seat 5: kfASJqTbXek+zc8ZKsZL1Q mucked
Seat 6: mfy7uGZcqA2PVQqEVbJ7+g (button) folded before Flop (didn't bet)



PokerStars Game #59941220590:  Hold'em No Limit ($1/$2) - 2009/07/01 1:29:06 ET
Table 'NmY84NAf9Mh0ckAckHnh5g' 2-max Seat #2 is the button
Seat 1: 6hvg964TSqZ3AL/0XK9aVQ ($234.10 in chips)
Seat 2: RwDoM55ZeQuI2ADyJhOb2Q ($766.70 in chips)
RwDoM55ZeQuI2ADyJhOb2Q: posts small blind $1
6hvg964TSqZ3AL/0XK9aVQ: posts big blind $2
*** HOLE CARDS ***
RwDoM55ZeQuI2ADyJhOb2Q: folds
6hvg964TSqZ3AL/0XK9aVQ collected $2 from pot
6hvg964TSqZ3AL/0XK9aVQ: doesn't show hand
*** SUMMARY ***
Total pot $2 | Rake $0
Seat 1: 6hvg964TSqZ3AL/0XK9aVQ (big blind) collected ($2)
Seat 2: RwDoM55ZeQuI2ADyJhOb2Q (button) (small blind) folded before Flop



PokerStars Game #59941224156:  Hold'em No Limit ($1/$2) - 2009/07/01 1:29:12 ET
Table 'NmY84NAf9Mh0ckAckHnh5g' 2-max Seat #1 is the button
Seat 1: 6hvg964TSqZ3AL/0XK9aVQ ($235.10 in chips)
Seat 2: RwDoM55ZeQuI2ADyJhOb2Q ($765.70 in chips)
6hvg964TSqZ3AL/0XK9aVQ: posts small blind $1
RwDoM55ZeQuI2ADyJhOb2Q: posts big blind $2
*** HOLE CARDS ***
6hvg964TSqZ3AL/0XK9aVQ: folds
RwDoM55ZeQuI2ADyJhOb2Q collected $2 from pot
RwDoM55ZeQuI2ADyJhOb2Q: doesn't show hand
*** SUMMARY ***
Total pot $2 | Rake $0
Seat 1: 6hvg964TSqZ3AL/0XK9aVQ (button) (small blind) folded before Flop
Seat 2: RwDoM55ZeQuI2ADyJhOb2Q (big blind) collected ($2)



PokerStars Game #59941224290:  Hold'em No Limit ($1/$2) - 2009/07/01 1:29:12 ET
Table 'QxerF7GUfCbl+4a8XaTB2w' 6-max Seat #5 is the button
Seat 1: 54yWzRRgS0oZ+S6LwZBxMQ ($32 in chips)
Seat 2: HiWSAXs6/0w9Jy7ioiiShQ ($37.65 in chips)
Seat 3: m7mYVfnCOK5TE/VkN/FhOg ($271.10 in chips)
Seat 4: 09BNF4quPDzanQzM8vc6WA ($57.50 in chips)
Seat 5: gnYme0DNFflnMhrdbxe1Ag ($241.70 in chips)
Seat 6: VvdR9F3I+2yELkfTVvC1dg ($200 in chips)
VvdR9F3I+2yELkfTVvC1dg: posts small blind $1
54yWzRRgS0oZ+S6LwZBxMQ: posts big blind $2
*** HOLE CARDS ***
HiWSAXs6/0w9Jy7ioiiShQ: calls $2
m7mYVfnCOK5TE/VkN/FhOg: calls $2
09BNF4quPDzanQzM8vc6WA: folds
gnYme0DNFflnMhrdbxe1Ag: folds
VvdR9F3I+2yELkfTVvC1dg: folds
54yWzRRgS0oZ+S6LwZBxMQ: checks
*** FLOP *** [8s Qc 3d]
54yWzRRgS0oZ+S6LwZBxMQ: checks
HiWSAXs6/0w9Jy7ioiiShQ: checks
m7mYVfnCOK5TE/VkN/FhOg: bets $6
54yWzRRgS0oZ+S6LwZBxMQ: folds
HiWSAXs6/0w9Jy7ioiiShQ: folds
m7mYVfnCOK5TE/VkN/FhOg collected $6.65 from pot
*** SUMMARY ***
Total pot $7 | Rake $0.35
Board [8s Qc 3d]
Seat 1: 54yWzRRgS0oZ+S6LwZBxMQ (big blind) folded on the Flop
Seat 2: HiWSAXs6/0w9Jy7ioiiShQ folded on the Flop
Seat 3: m7mYVfnCOK5TE/VkN/FhOg collected ($6.65)
Seat 4: 09BNF4quPDzanQzM8vc6WA folded before Flop (didn't bet)
Seat 5: gnYme0DNFflnMhrdbxe1Ag (button) folded before Flop (didn't bet)
Seat 6: VvdR9F3I+2yELkfTVvC1dg (small blind) folded before Flop



PokerStars Game #59941223794:  Hold'em No Limit ($1/$2) - 2009/07/01 1:29:12 ET
Table 'CFkQcfWjKccZaZDf71FK+w' 6-max Seat #4 is the button
Seat 2: ewN/vzF22+/gdzjIKBOlkA ($207.80 in chips)
Seat 3: 09BNF4quPDzanQzM8vc6WA ($45.45 in chips)
Seat 4: ygTTt5ehT4aF86q1a8/R+w ($284.25 in chips)
Seat 5: 2lOU1DcvUZaMcxZ95XfzXw ($143.15 in chips)
Seat 6: ORVqY3rf9X6ANA/8s+On2Q ($94.60 in chips)
2lOU1DcvUZaMcxZ95XfzXw: posts small blind $1
ORVqY3rf9X6ANA/8s+On2Q: posts big blind $2
*** HOLE CARDS ***
ewN/vzF22+/gdzjIKBOlkA: folds
09BNF4quPDzanQzM8vc6WA: folds
ygTTt5ehT4aF86q1a8/R+w: raises $4 to $6
2lOU1DcvUZaMcxZ95XfzXw: folds
ORVqY3rf9X6ANA/8s+On2Q: calls $4
*** FLOP *** [2s 5s 4d]
ORVqY3rf9X6ANA/8s+On2Q: checks
ygTTt5ehT4aF86q1a8/R+w: bets $8
ORVqY3rf9X6ANA/8s+On2Q: calls $8
*** TURN *** [2s 5s 4d] [3s]
ORVqY3rf9X6ANA/8s+On2Q: checks
ygTTt5ehT4aF86q1a8/R+w: bets $16
ORVqY3rf9X6ANA/8s+On2Q: calls $16
*** RIVER *** [2s 5s 4d 3s] [9c]
ORVqY3rf9X6ANA/8s+On2Q: checks
ygTTt5ehT4aF86q1a8/R+w: checks
*** SHOW DOWN ***
ORVqY3rf9X6ANA/8s+On2Q: shows [7c As] (a straight, Ace to Five)
ygTTt5ehT4aF86q1a8/R+w: mucks hand
ORVqY3rf9X6ANA/8s+On2Q collected $59 from pot
*** SUMMARY ***
Total pot $61 | Rake $2
Board [2s 5s 4d 3s 9c]
Seat 2: ewN/vzF22+/gdzjIKBOlkA folded before Flop (didn't bet)
Seat 3: 09BNF4quPDzanQzM8vc6WA folded before Flop (didn't bet)
Seat 4: ygTTt5ehT4aF86q1a8/R+w (button) mucked
Seat 5: 2lOU1DcvUZaMcxZ95XfzXw (small blind) folded before Flop
Seat 6: ORVqY3rf9X6ANA/8s+On2Q (big blind) showed [7c As] and won ($59) with a straight, Ace to Five



PokerStars Game #59941224624:  Hold'em No Limit ($1/$2) - 2009/07/01 1:29:13 ET
Table 'bIihwBANJSFqlHPPtset+w' 9-max Seat #7 is the button
Seat 2: lQYT23h5QCUVZAKxjOO39Q ($170 in chips)
Seat 3: +T/63sAeZzWyHchahJ36GQ ($46 in chips)
Seat 4: ri8CLkX3e9JF34dQNbsHGA ($40 in chips)
Seat 5: vxbbJLsS1bva6tW2NiFssg ($200 in chips)
Seat 6: CkE3IyJF1KvdaAOmZY5XqQ ($183 in chips)
Seat 7: pCmk6FpSOLJ+85o1tLHIag ($142.95 in chips)
Seat 9: qn8LDoUFphcG4+r+F+Vhrg ($169 in chips)
qn8LDoUFphcG4+r+F+Vhrg: posts small blind $1
/inIs/z/PcX+TniIFpaxpg: is sitting out
lQYT23h5QCUVZAKxjOO39Q: posts big blind $2
*** HOLE CARDS ***
/inIs/z/PcX+TniIFpaxpg leaves the table
+T/63sAeZzWyHchahJ36GQ: folds
MeleaB joins the table at seat #1
ri8CLkX3e9JF34dQNbsHGA: folds
vxbbJLsS1bva6tW2NiFssg: folds
CkE3IyJF1KvdaAOmZY5XqQ: raises $6 to $8
pCmk6FpSOLJ+85o1tLHIag: folds
qn8LDoUFphcG4+r+F+Vhrg: folds
lQYT23h5QCUVZAKxjOO39Q: calls $6
*** FLOP *** [9c 6c As]
lQYT23h5QCUVZAKxjOO39Q: checks
CkE3IyJF1KvdaAOmZY5XqQ: bets $10
lQYT23h5QCUVZAKxjOO39Q: folds
CkE3IyJF1KvdaAOmZY5XqQ collected $16.15 from pot
*** SUMMARY ***
Total pot $17 | Rake $0.85
Board [9c 6c As]
Seat 2: lQYT23h5QCUVZAKxjOO39Q (big blind) folded on the Flop
Seat 3: +T/63sAeZzWyHchahJ36GQ folded before Flop (didn't bet)
Seat 4: ri8CLkX3e9JF34dQNbsHGA folded before Flop (didn't bet)
Seat 5: vxbbJLsS1bva6tW2NiFssg folded before Flop (didn't bet)
Seat 6: CkE3IyJF1KvdaAOmZY5XqQ collected ($16.15)
Seat 7: pCmk6FpSOLJ+85o1tLHIag (button) folded before Flop (didn't bet)
Seat 9: qn8LDoUFphcG4+r+F+Vhrg (small blind) folded before Flop



PokerStars Game #59941225086:  Hold'em No Limit ($1/$2) - 2009/07/01 1:29:14 ET
Table '4NGNnZ/osQfNq6abYqkJeA' 6-max Seat #3 is the button
Seat 1: vkfxu8f/jMYKUk6Ly4eujw ($197 in chips)
Seat 2: 669iGNwYwgRZg3nhS+aDAQ ($90.15 in chips)
Seat 3: 54yWzRRgS0oZ+S6LwZBxMQ ($17.75 in chips)
Seat 4: sY+4Uuh5z/6AbXXaCS10jw ($210.35 in chips)
Seat 5: VvdR9F3I+2yELkfTVvC1dg ($244.85 in chips)
sY+4Uuh5z/6AbXXaCS10jw: posts small blind $1
VvdR9F3I+2yELkfTVvC1dg: posts big blind $2
3cPMpDMgeOMAe4UceUfLsg: sits out
*** HOLE CARDS ***
vkfxu8f/jMYKUk6Ly4eujw: raises $6 to $8
669iGNwYwgRZg3nhS+aDAQ: folds
54yWzRRgS0oZ+S6LwZBxMQ: folds
sY+4Uuh5z/6AbXXaCS10jw: folds
VvdR9F3I+2yELkfTVvC1dg: folds
vkfxu8f/jMYKUk6Ly4eujw collected $5 from pot
vkfxu8f/jMYKUk6Ly4eujw: doesn't show hand
*** SUMMARY ***
Total pot $5 | Rake $0
Seat 1: vkfxu8f/jMYKUk6Ly4eujw collected ($5)
Seat 2: 669iGNwYwgRZg3nhS+aDAQ folded before Flop (didn't bet)
Seat 3: 54yWzRRgS0oZ+S6LwZBxMQ (button) folded before Flop (didn't bet)
Seat 4: sY+4Uuh5z/6AbXXaCS10jw (small blind) folded before Flop
Seat 5: VvdR9F3I+2yELkfTVvC1dg (big blind) folded before Flop



PokerStars Game #59941225456:  Hold'em No Limit ($1/$2) - 2009/07/01 1:29:14 ET
Table '/dyk+YdRGv90j2box35j8w' 6-max Seat #4 is the button
Seat 1: 8srN1dKQePlsv0GyTada+Q ($201.80 in chips)
Seat 2: qCnEYuAE5y5A7bk6fO5/jQ ($476.60 in chips)
Seat 4: z/u1YTnkiIDrtp/2cA2dBg ($205.60 in chips)
Seat 5: VvdR9F3I+2yELkfTVvC1dg ($200 in chips)
VvdR9F3I+2yELkfTVvC1dg: posts small blind $1
8srN1dKQePlsv0GyTada+Q: posts big blind $2
*** HOLE CARDS ***
qCnEYuAE5y5A7bk6fO5/jQ: folds
z/u1YTnkiIDrtp/2cA2dBg: folds
VvdR9F3I+2yELkfTVvC1dg: folds
8srN1dKQePlsv0GyTada+Q collected $2 from pot
8srN1dKQePlsv0GyTada+Q: doesn't show hand
*** SUMMARY ***
Total pot $2 | Rake $0
Seat 1: 8srN1dKQePlsv0GyTada+Q (big blind) collected ($2)
Seat 2: qCnEYuAE5y5A7bk6fO5/jQ folded before Flop (didn't bet)
Seat 4: z/u1YTnkiIDrtp/2cA2dBg (button) folded before Flop (didn't bet)
Seat 5: VvdR9F3I+2yELkfTVvC1dg (small blind) folded before Flop



PokerStars Game #59941225948:  Hold'em No Limit ($1/$2) - 2009/07/01 1:29:15 ET
Table 'uJ9juaXXg9yIcSU8amxaXQ' 6-max Seat #6 is the button
Seat 1: JsqOjN/eHz0uYVf/PyUJ6Q ($145.50 in chips)
Seat 2: VvdR9F3I+2yELkfTVvC1dg ($229.10 in chips)
Seat 3: qXDd0ZyMIse0OBu8pxeQ3Q ($244 in chips)
Seat 4: zNjJ/y4emmF+vzrCDd+ooA ($237.05 in chips)
Seat 5: YsLQ3BAvgQHWXMAv3Wv6Hg ($200 in chips)
Seat 6: 2DFp9Veq1xxq64dCjwNuUw ($54.60 in chips)
JsqOjN/eHz0uYVf/PyUJ6Q: posts small blind $1
VvdR9F3I+2yELkfTVvC1dg: posts big blind $2
*** HOLE CARDS ***
qXDd0ZyMIse0OBu8pxeQ3Q: folds
zNjJ/y4emmF+vzrCDd+ooA: folds
YsLQ3BAvgQHWXMAv3Wv6Hg: folds
2DFp9Veq1xxq64dCjwNuUw: folds
JsqOjN/eHz0uYVf/PyUJ6Q: folds
VvdR9F3I+2yELkfTVvC1dg collected $2 from pot
VvdR9F3I+2yELkfTVvC1dg: doesn't show hand
*** SUMMARY ***
Total pot $2 | Rake $0
Seat 1: JsqOjN/eHz0uYVf/PyUJ6Q (small blind) folded before Flop
Seat 2: VvdR9F3I+2yELkfTVvC1dg (big blind) collected ($2)
Seat 3: qXDd0ZyMIse0OBu8pxeQ3Q folded before Flop (didn't bet)
Seat 4: zNjJ/y4emmF+vzrCDd+ooA folded before Flop (didn't bet)
Seat 5: YsLQ3BAvgQHWXMAv3Wv6Hg folded before Flop (didn't bet)
Seat 6: 2DFp9Veq1xxq64dCjwNuUw (button) folded before Flop (didn't bet)



PokerStars Game #59941227780:  Hold'em No Limit ($1/$2) - 2009/07/01 1:29:18 ET
Table 'NmY84NAf9Mh0ckAckHnh5g' 2-max Seat #2 is the button
Seat 1: 6hvg964TSqZ3AL/0XK9aVQ ($234.10 in chips)
Seat 2: RwDoM55ZeQuI2ADyJhOb2Q ($766.70 in chips)
RwDoM55ZeQuI2ADyJhOb2Q: posts small blind $1
6hvg964TSqZ3AL/0XK9aVQ: posts big blind $2
*** HOLE CARDS ***
RwDoM55ZeQuI2ADyJhOb2Q: raises $4 to $6
6hvg964TSqZ3AL/0XK9aVQ: folds
RwDoM55ZeQuI2ADyJhOb2Q collected $4 from pot
RwDoM55ZeQuI2ADyJhOb2Q: doesn't show hand
*** SUMMARY ***
Total pot $4 | Rake $0
Seat 1: 6hvg964TSqZ3AL/0XK9aVQ (big blind) folded before Flop
Seat 2: RwDoM55ZeQuI2ADyJhOb2Q (button) (small blind) collected ($4)



PokerStars Game #59941230026:  Hold'em No Limit ($1/$2) - 2009/07/01 1:29:22 ET
Table 'pPQgcj9XT9CHBsbo1WTBug' 6-max Seat #2 is the button
Seat 1: DFVYDA6dKQy7R7mGIKogZA ($155.20 in chips)
Seat 2: qXDd0ZyMIse0OBu8pxeQ3Q ($200 in chips)
Seat 3: 54yWzRRgS0oZ+S6LwZBxMQ ($55.50 in chips)
Seat 4: gqlysXCbT8V54f/1lf9h3A ($37.10 in chips)
Seat 5: vkfxu8f/jMYKUk6Ly4eujw ($199.55 in chips)
Seat 6: Yr7pZltpy3IUNdKS9PCEiw ($301.30 in chips)
54yWzRRgS0oZ+S6LwZBxMQ: posts small blind $1
gqlysXCbT8V54f/1lf9h3A: posts big blind $2
*** HOLE CARDS ***
vkfxu8f/jMYKUk6Ly4eujw: raises $4 to $6
Yr7pZltpy3IUNdKS9PCEiw: folds
DFVYDA6dKQy7R7mGIKogZA: folds
qXDd0ZyMIse0OBu8pxeQ3Q: folds
54yWzRRgS0oZ+S6LwZBxMQ: folds
gqlysXCbT8V54f/1lf9h3A: calls $4
*** FLOP *** [Jh Jc Qd]
gqlysXCbT8V54f/1lf9h3A: checks
vkfxu8f/jMYKUk6Ly4eujw: checks
*** TURN *** [Jh Jc Qd] [Js]
gqlysXCbT8V54f/1lf9h3A: bets $4
vkfxu8f/jMYKUk6Ly4eujw: folds
gqlysXCbT8V54f/1lf9h3A collected $12.35 from pot
gqlysXCbT8V54f/1lf9h3A: doesn't show hand
*** SUMMARY ***
Total pot $13 | Rake $0.65
Board [Jh Jc Qd Js]
Seat 1: DFVYDA6dKQy7R7mGIKogZA folded before Flop (didn't bet)
Seat 2: qXDd0ZyMIse0OBu8pxeQ3Q (button) folded before Flop (didn't bet)
Seat 3: 54yWzRRgS0oZ+S6LwZBxMQ (small blind) folded before Flop
Seat 4: gqlysXCbT8V54f/1lf9h3A (big blind) collected ($12.35)
Seat 5: vkfxu8f/jMYKUk6Ly4eujw folded on the Turn
Seat 6: Yr7pZltpy3IUNdKS9PCEiw folded before Flop (didn't bet)



PokerStars Game #59941232372:  Hold'em No Limit ($1/$2) - 2009/07/01 1:29:26 ET
Table 'uJ9juaXXg9yIcSU8amxaXQ' 6-max Seat #1 is the button
Seat 1: JsqOjN/eHz0uYVf/PyUJ6Q ($144.50 in chips)
Seat 2: VvdR9F3I+2yELkfTVvC1dg ($230.10 in chips)
Seat 3: qXDd0ZyMIse0OBu8pxeQ3Q ($244 in chips)
Seat 4: zNjJ/y4emmF+vzrCDd+ooA ($237.05 in chips)
Seat 5: YsLQ3BAvgQHWXMAv3Wv6Hg ($200 in chips)
Seat 6: 2DFp9Veq1xxq64dCjwNuUw ($54.60 in chips)
VvdR9F3I+2yELkfTVvC1dg: posts small blind $1
qXDd0ZyMIse0OBu8pxeQ3Q: posts big blind $2
*** HOLE CARDS ***
zNjJ/y4emmF+vzrCDd+ooA: folds
YsLQ3BAvgQHWXMAv3Wv6Hg: folds
2DFp9Veq1xxq64dCjwNuUw: raises $4 to $6
JsqOjN/eHz0uYVf/PyUJ6Q: folds
VvdR9F3I+2yELkfTVvC1dg: folds
qXDd0ZyMIse0OBu8pxeQ3Q: folds
2DFp9Veq1xxq64dCjwNuUw collected $5 from pot
2DFp9Veq1xxq64dCjwNuUw: doesn't show hand
*** SUMMARY ***
Total pot $5 | Rake $0
Seat 1: JsqOjN/eHz0uYVf/PyUJ6Q (button) folded before Flop (didn't bet)
Seat 2: VvdR9F3I+2yELkfTVvC1dg (small blind) folded before Flop
Seat 3: qXDd0ZyMIse0OBu8pxeQ3Q (big blind) folded before Flop
Seat 4: zNjJ/y4emmF+vzrCDd+ooA folded before Flop (didn't bet)
Seat 5: YsLQ3BAvgQHWXMAv3Wv6Hg folded before Flop (didn't bet)
Seat 6: 2DFp9Veq1xxq64dCjwNuUw collected ($5)



PokerStars Game #59941232378:  Hold'em No Limit ($1/$2) - 2009/07/01 1:29:26 ET
Table '8Y6PEyoNuepZTai2Q56aHw' 9-max Seat #8 is the button
Seat 1: 5Q8U6iZbeO7xJSS4qvDP5g ($314.80 in chips)
Seat 2: gDCJIAlovbPnTvMM7Dd1gA ($159.35 in chips)
Seat 3: WUlHm+ydPPHG7Lb0rePSdA ($217.10 in chips)
Seat 4: xKkwALG38OfLQ9DXuJgR1w ($247.25 in chips)
Seat 6: NtLDBSjsJQEKekh5cdinvw ($377.35 in chips)
Seat 7: Kzta8yu9vxHT4B70mjBZ+w ($200.30 in chips)
Seat 8: rW/MyplHylMSBRaoRUzWrg ($36 in chips)
Seat 9: F7m34OOfAQ7annesMHVjKw ($198 in chips)
F7m34OOfAQ7annesMHVjKw: posts small blind $1
5Q8U6iZbeO7xJSS4qvDP5g: posts big blind $2
*** HOLE CARDS ***
gDCJIAlovbPnTvMM7Dd1gA: raises $2 to $4
WUlHm+ydPPHG7Lb0rePSdA: folds
xKkwALG38OfLQ9DXuJgR1w: folds
NtLDBSjsJQEKekh5cdinvw: folds
Kzta8yu9vxHT4B70mjBZ+w: folds
rW/MyplHylMSBRaoRUzWrg: folds
F7m34OOfAQ7annesMHVjKw: calls $3
5Q8U6iZbeO7xJSS4qvDP5g: folds
*** FLOP *** [4c 6c Th]
F7m34OOfAQ7annesMHVjKw: checks
gDCJIAlovbPnTvMM7Dd1gA: bets $5
F7m34OOfAQ7annesMHVjKw: folds
gDCJIAlovbPnTvMM7Dd1gA collected $9.50 from pot
*** SUMMARY ***
Total pot $10 | Rake $0.50
Board [4c 6c Th]
Seat 1: 5Q8U6iZbeO7xJSS4qvDP5g (big blind) folded before Flop
Seat 2: gDCJIAlovbPnTvMM7Dd1gA collected ($9.50)
Seat 3: WUlHm+ydPPHG7Lb0rePSdA folded before Flop (didn't bet)
Seat 4: xKkwALG38OfLQ9DXuJgR1w folded before Flop (didn't bet)
Seat 6: NtLDBSjsJQEKekh5cdinvw folded before Flop (didn't bet)
Seat 7: Kzta8yu9vxHT4B70mjBZ+w folded before Flop (didn't bet)
Seat 8: rW/MyplHylMSBRaoRUzWrg (button) folded before Flop (didn't bet)
Seat 9: F7m34OOfAQ7annesMHVjKw (small blind) folded on the Flop



PokerStars Game #59941232492:  Hold'em No Limit ($1/$2) - 2009/07/01 1:29:27 ET
Table 'UGLAZZyv+cXmnKjYin0etA' 6-max Seat #4 is the button
Seat 1: vkfxu8f/jMYKUk6Ly4eujw ($196.05 in chips)
Seat 2: eDLH1PUXFpvJBNMXBVQcGA ($276.35 in chips)
Seat 3: ygTTt5ehT4aF86q1a8/R+w ($100 in chips)
Seat 4: SiGJDsvRViJX05vHhA80GQ ($197 in chips)
Seat 5: 54yWzRRgS0oZ+S6LwZBxMQ ($36.45 in chips)
54yWzRRgS0oZ+S6LwZBxMQ: posts small blind $1
vkfxu8f/jMYKUk6Ly4eujw: posts big blind $2
*** HOLE CARDS ***
eDLH1PUXFpvJBNMXBVQcGA: folds
ygTTt5ehT4aF86q1a8/R+w: raises $4 to $6
SiGJDsvRViJX05vHhA80GQ: folds
54yWzRRgS0oZ+S6LwZBxMQ: folds
vkfxu8f/jMYKUk6Ly4eujw: calls $4
*** FLOP *** [Th Kd 4d]
vkfxu8f/jMYKUk6Ly4eujw: bets $12
ygTTt5ehT4aF86q1a8/R+w: calls $12
*** TURN *** [Th Kd 4d] [3s]
vkfxu8f/jMYKUk6Ly4eujw: checks
ygTTt5ehT4aF86q1a8/R+w: bets $22
vkfxu8f/jMYKUk6Ly4eujw: folds
ygTTt5ehT4aF86q1a8/R+w collected $35.20 from pot
*** SUMMARY ***
Total pot $37 | Rake $1.80
Board [Th Kd 4d 3s]
Seat 1: vkfxu8f/jMYKUk6Ly4eujw (big blind) folded on the Turn
Seat 2: eDLH1PUXFpvJBNMXBVQcGA folded before Flop (didn't bet)
Seat 3: ygTTt5ehT4aF86q1a8/R+w collected ($35.20)
Seat 4: SiGJDsvRViJX05vHhA80GQ (button) folded before Flop (didn't bet)
Seat 5: 54yWzRRgS0oZ+S6LwZBxMQ (small blind) folded before Flop



PokerStars Game #59941232904:  Hold'em No Limit ($1/$2) - 2009/07/01 1:29:27 ET
Table 'rKeCh+eBn4RNvybCUYkoTQ' 9-max Seat #5 is the button
Seat 1: /inIs/z/PcX+TniIFpaxpg ($200 in chips)
Seat 2: 9cBHwK40Tl06vheE7B3LHQ ($129.55 in chips)
Seat 3: GX1heJ+DSsvm7gzSPsYhhQ ($31 in chips)
Seat 4: 31HuO+DQxppUQEedBWukug ($124.10 in chips)
Seat 5: WUlHm+ydPPHG7Lb0rePSdA ($123 in chips)
Seat 6: EBV6OktyeSmh4w6sWmcWOw ($268 in chips)
Seat 7: rW/MyplHylMSBRaoRUzWrg ($34 in chips)
Seat 8: pN/Ip0ePsUVIdUlGgLrkUw ($215.35 in chips)
Seat 9: Kzta8yu9vxHT4B70mjBZ+w ($211.25 in chips)
EBV6OktyeSmh4w6sWmcWOw: posts small blind $1
rW/MyplHylMSBRaoRUzWrg: posts big blind $2
*** HOLE CARDS ***
pN/Ip0ePsUVIdUlGgLrkUw: folds
Kzta8yu9vxHT4B70mjBZ+w: folds
/inIs/z/PcX+TniIFpaxpg: folds
9cBHwK40Tl06vheE7B3LHQ: calls $2
GX1heJ+DSsvm7gzSPsYhhQ: calls $2
31HuO+DQxppUQEedBWukug has timed out while being disconnected
31HuO+DQxppUQEedBWukug: folds
31HuO+DQxppUQEedBWukug is sitting out
WUlHm+ydPPHG7Lb0rePSdA: raises $8 to $10
EBV6OktyeSmh4w6sWmcWOw: folds
31HuO+DQxppUQEedBWukug is disconnected
rW/MyplHylMSBRaoRUzWrg: folds
9cBHwK40Tl06vheE7B3LHQ: calls $8
GX1heJ+DSsvm7gzSPsYhhQ: folds
*** FLOP *** [3s 2h 7s]
9cBHwK40Tl06vheE7B3LHQ: checks
WUlHm+ydPPHG7Lb0rePSdA: bets $16
9cBHwK40Tl06vheE7B3LHQ: calls $16
*** TURN *** [3s 2h 7s] [8s]
9cBHwK40Tl06vheE7B3LHQ: checks
WUlHm+ydPPHG7Lb0rePSdA: checks
*** RIVER *** [3s 2h 7s 8s] [Th]
9cBHwK40Tl06vheE7B3LHQ: bets $24
WUlHm+ydPPHG7Lb0rePSdA: folds
9cBHwK40Tl06vheE7B3LHQ collected $54.25 from pot
9cBHwK40Tl06vheE7B3LHQ: doesn't show hand
*** SUMMARY ***
Total pot $57 | Rake $2.75
Board [3s 2h 7s 8s Th]
Seat 1: /inIs/z/PcX+TniIFpaxpg folded before Flop (didn't bet)
Seat 2: 9cBHwK40Tl06vheE7B3LHQ collected ($54.25)
Seat 3: GX1heJ+DSsvm7gzSPsYhhQ folded before Flop
Seat 4: 31HuO+DQxppUQEedBWukug folded before Flop (didn't bet)
Seat 5: WUlHm+ydPPHG7Lb0rePSdA (button) folded on the River
Seat 6: EBV6OktyeSmh4w6sWmcWOw (small blind) folded before Flop
Seat 7: rW/MyplHylMSBRaoRUzWrg (big blind) folded before Flop
Seat 8: pN/Ip0ePsUVIdUlGgLrkUw folded before Flop (didn't bet)
Seat 9: Kzta8yu9vxHT4B70mjBZ+w folded before Flop (didn't bet)



PokerStars Game #59941233468:  Hold'em No Limit ($1/$2) - 2009/07/01 1:29:28 ET
Table 'rsKRKlGHlxVyqJxzO2a2Ow' 9-max Seat #4 is the button
Seat 1: uYWfQJg2hgHLxri6/uVJiw ($387.65 in chips)
Seat 3: zTcFtoHqqK4550YMZ8Y14Q ($42.30 in chips)
Seat 4: 31HuO+DQxppUQEedBWukug ($111.85 in chips)
Seat 5: 5Q8U6iZbeO7xJSS4qvDP5g ($224.55 in chips)
Seat 6: H6Z4+qu8gR0VUiPOijndVg ($204.55 in chips)
Seat 7: GX1heJ+DSsvm7gzSPsYhhQ ($33 in chips)
Seat 8: CkE3IyJF1KvdaAOmZY5XqQ ($200 in chips)
Seat 9: gRbvhSUVg+TNaTjaJecIRw ($24 in chips)
5Q8U6iZbeO7xJSS4qvDP5g: posts small blind $1
H6Z4+qu8gR0VUiPOijndVg: posts big blind $2
+T/63sAeZzWyHchahJ36GQ: sits out
*** HOLE CARDS ***
GX1heJ+DSsvm7gzSPsYhhQ: folds
CkE3IyJF1KvdaAOmZY5XqQ: folds
gRbvhSUVg+TNaTjaJecIRw: folds
uYWfQJg2hgHLxri6/uVJiw: calls $2
zTcFtoHqqK4550YMZ8Y14Q: folds
31HuO+DQxppUQEedBWukug has timed out while being disconnected
31HuO+DQxppUQEedBWukug: folds
31HuO+DQxppUQEedBWukug is sitting out
5Q8U6iZbeO7xJSS4qvDP5g: folds
H6Z4+qu8gR0VUiPOijndVg: checks
*** FLOP *** [Qs 9h 2h]
H6Z4+qu8gR0VUiPOijndVg: checks
uYWfQJg2hgHLxri6/uVJiw: checks
*** TURN *** [Qs 9h 2h] [Ts]
H6Z4+qu8gR0VUiPOijndVg: checks
31HuO+DQxppUQEedBWukug is disconnected
uYWfQJg2hgHLxri6/uVJiw: bets $4
H6Z4+qu8gR0VUiPOijndVg: folds
uYWfQJg2hgHLxri6/uVJiw collected $4.75 from pot
*** SUMMARY ***
Total pot $5 | Rake $0.25
Board [Qs 9h 2h Ts]
Seat 1: uYWfQJg2hgHLxri6/uVJiw collected ($4.75)
Seat 3: zTcFtoHqqK4550YMZ8Y14Q folded before Flop (didn't bet)
Seat 4: 31HuO+DQxppUQEedBWukug (button) folded before Flop (didn't bet)
Seat 5: 5Q8U6iZbeO7xJSS4qvDP5g (small blind) folded before Flop
Seat 6: H6Z4+qu8gR0VUiPOijndVg (big blind) folded on the Turn
Seat 7: GX1heJ+DSsvm7gzSPsYhhQ folded before Flop (didn't bet)
Seat 8: CkE3IyJF1KvdaAOmZY5XqQ folded before Flop (didn't bet)
Seat 9: gRbvhSUVg+TNaTjaJecIRw folded before Flop (didn't bet)



PokerStars Game #59941233104:  Hold'em No Limit ($1/$2) - 2009/07/01 1:29:28 ET
Table 'NmY84NAf9Mh0ckAckHnh5g' 2-max Seat #1 is the button
Seat 1: 6hvg964TSqZ3AL/0XK9aVQ ($232.10 in chips)
Seat 2: RwDoM55ZeQuI2ADyJhOb2Q ($768.70 in chips)
6hvg964TSqZ3AL/0XK9aVQ: posts small blind $1
RwDoM55ZeQuI2ADyJhOb2Q: posts big blind $2
*** HOLE CARDS ***
6hvg964TSqZ3AL/0XK9aVQ: calls $1
RwDoM55ZeQuI2ADyJhOb2Q: checks
*** FLOP *** [9d Kh Qs]
RwDoM55ZeQuI2ADyJhOb2Q: checks
6hvg964TSqZ3AL/0XK9aVQ: bets $4
RwDoM55ZeQuI2ADyJhOb2Q: folds
6hvg964TSqZ3AL/0XK9aVQ collected $3.80 from pot
*** SUMMARY ***
Total pot $4 | Rake $0.20
Board [9d Kh Qs]
Seat 1: 6hvg964TSqZ3AL/0XK9aVQ (button) (small blind) collected ($3.80)
Seat 2: RwDoM55ZeQuI2ADyJhOb2Q (big blind) folded on the Flop



PokerStars Game #59941233868:  Hold'em No Limit ($1/$2) - 2009/07/01 1:29:29 ET
Table '/dyk+YdRGv90j2box35j8w' 6-max Seat #5 is the button
Seat 1: 8srN1dKQePlsv0GyTada+Q ($202.80 in chips)
Seat 2: qCnEYuAE5y5A7bk6fO5/jQ ($476.60 in chips)
Seat 4: z/u1YTnkiIDrtp/2cA2dBg ($205.60 in chips)
Seat 5: VvdR9F3I+2yELkfTVvC1dg ($200 in chips)
ZwvXzkkZ3XpMhKfAmVpahw was removed from the table for failing to post
8srN1dKQePlsv0GyTada+Q: posts small blind $1
qCnEYuAE5y5A7bk6fO5/jQ: posts big blind $2
*** HOLE CARDS ***
z/u1YTnkiIDrtp/2cA2dBg: folds
VvdR9F3I+2yELkfTVvC1dg: raises $2 to $4
8srN1dKQePlsv0GyTada+Q: folds
qCnEYuAE5y5A7bk6fO5/jQ: folds
VvdR9F3I+2yELkfTVvC1dg collected $5 from pot
VvdR9F3I+2yELkfTVvC1dg: doesn't show hand
*** SUMMARY ***
Total pot $5 | Rake $0
Seat 1: 8srN1dKQePlsv0GyTada+Q (small blind) folded before Flop
Seat 2: qCnEYuAE5y5A7bk6fO5/jQ (big blind) folded before Flop
Seat 4: z/u1YTnkiIDrtp/2cA2dBg folded before Flop (didn't bet)
Seat 5: VvdR9F3I+2yELkfTVvC1dg (button) collected ($5)



PokerStars Game #59941234408:  Hold'em No Limit ($1/$2) - 2009/07/01 1:29:30 ET
Table 'ZzSIe0zTCDv+n6hfbY5tTg' 6-max Seat #1 is the button
Seat 1: VvdR9F3I+2yELkfTVvC1dg ($200 in chips)
Seat 2: B87ikIyZ/TzAVeXf38Ny0g ($284 in chips)
Seat 3: gsugPj31Hui3Jefl98MBOA ($201 in chips)
Seat 4: qXDd0ZyMIse0OBu8pxeQ3Q ($214.70 in chips)
Seat 5: 3dAbvkxS5NPQTBAbvpinVg ($480.30 in chips)
Seat 6: 09BNF4quPDzanQzM8vc6WA ($23.05 in chips)
B87ikIyZ/TzAVeXf38Ny0g: posts small blind $1
gsugPj31Hui3Jefl98MBOA: posts big blind $2
*** HOLE CARDS ***
qXDd0ZyMIse0OBu8pxeQ3Q: raises $4 to $6
3dAbvkxS5NPQTBAbvpinVg: folds
09BNF4quPDzanQzM8vc6WA: folds
VvdR9F3I+2yELkfTVvC1dg: raises $13 to $19
B87ikIyZ/TzAVeXf38Ny0g: folds
gsugPj31Hui3Jefl98MBOA: calls $17
qXDd0ZyMIse0OBu8pxeQ3Q: calls $13
*** FLOP *** [7h Js Qd]
gsugPj31Hui3Jefl98MBOA: checks
qXDd0ZyMIse0OBu8pxeQ3Q: checks
VvdR9F3I+2yELkfTVvC1dg: checks
*** TURN *** [7h Js Qd] [Tc]
gsugPj31Hui3Jefl98MBOA: checks
qXDd0ZyMIse0OBu8pxeQ3Q: checks
VvdR9F3I+2yELkfTVvC1dg: bets $32.20
gsugPj31Hui3Jefl98MBOA: calls $32.20
qXDd0ZyMIse0OBu8pxeQ3Q: folds
*** RIVER *** [7h Js Qd Tc] [7d]
gsugPj31Hui3Jefl98MBOA: bets $149.80 and is all-in
VvdR9F3I+2yELkfTVvC1dg: calls $148.80 and is all-in
*** SHOW DOWN ***
gsugPj31Hui3Jefl98MBOA: shows [Ts Td] (a full house, Tens full of Sevens)
VvdR9F3I+2yELkfTVvC1dg: mucks hand
gsugPj31Hui3Jefl98MBOA collected $417 from pot
*** SUMMARY ***
Total pot $420 | Rake $3
Board [7h Js Qd Tc 7d]
Seat 1: VvdR9F3I+2yELkfTVvC1dg (button) mucked
Seat 2: B87ikIyZ/TzAVeXf38Ny0g (small blind) folded before Flop
Seat 3: gsugPj31Hui3Jefl98MBOA (big blind) showed [Ts Td] and won ($417) with a full house, Tens full of Sevens
Seat 4: qXDd0ZyMIse0OBu8pxeQ3Q folded on the Turn
Seat 5: 3dAbvkxS5NPQTBAbvpinVg folded before Flop (didn't bet)
Seat 6: 09BNF4quPDzanQzM8vc6WA folded before Flop (didn't bet)



PokerStars Game #59941235034:  Hold'em No Limit ($1/$2) - 2009/07/01 1:29:31 ET
Table 'mGpP9StWRnoeiBDExc6Frg' 6-max Seat #2 is the button
Seat 1: VvdR9F3I+2yELkfTVvC1dg ($283.70 in chips)
Seat 2: vkfxu8f/jMYKUk6Ly4eujw ($200 in chips)
Seat 3: 7acrZUQC3Zc9BNLjoKIcLQ ($37.05 in chips)
Seat 4: 4dcDwIHRm96PwtqkpQiuiA ($82.70 in chips)
Seat 5: d1puGuVBE0fidn+5eRJ0tw ($176.95 in chips)
Seat 6: B2Ih1sr5VZk+8He7rcrMtQ ($463.05 in chips)
7acrZUQC3Zc9BNLjoKIcLQ: posts small blind $1
4dcDwIHRm96PwtqkpQiuiA: posts big blind $2
*** HOLE CARDS ***
d1puGuVBE0fidn+5eRJ0tw: folds
B2Ih1sr5VZk+8He7rcrMtQ: raises $6 to $8
VvdR9F3I+2yELkfTVvC1dg: raises $17 to $25
vkfxu8f/jMYKUk6Ly4eujw: folds
7acrZUQC3Zc9BNLjoKIcLQ: folds
4dcDwIHRm96PwtqkpQiuiA: folds
B2Ih1sr5VZk+8He7rcrMtQ: calls $17
*** FLOP *** [9s Kc 8d]
B2Ih1sr5VZk+8He7rcrMtQ: checks
VvdR9F3I+2yELkfTVvC1dg: bets $35.75
B2Ih1sr5VZk+8He7rcrMtQ: folds
VvdR9F3I+2yELkfTVvC1dg collected $50.35 from pot
VvdR9F3I+2yELkfTVvC1dg: doesn't show hand
*** SUMMARY ***
Total pot $53 | Rake $2.65
Board [9s Kc 8d]
Seat 1: VvdR9F3I+2yELkfTVvC1dg collected ($50.35)
Seat 2: vkfxu8f/jMYKUk6Ly4eujw (button) folded before Flop (didn't bet)
Seat 3: 7acrZUQC3Zc9BNLjoKIcLQ (small blind) folded before Flop
Seat 4: 4dcDwIHRm96PwtqkpQiuiA (big blind) folded before Flop
Seat 5: d1puGuVBE0fidn+5eRJ0tw folded before Flop (didn't bet)
Seat 6: B2Ih1sr5VZk+8He7rcrMtQ folded on the Flop



PokerStars Game #59941234868:  Hold'em No Limit ($1/$2) - 2009/07/01 1:29:31 ET
Table '4NGNnZ/osQfNq6abYqkJeA' 6-max Seat #4 is the button
Seat 1: vkfxu8f/jMYKUk6Ly4eujw ($200 in chips)
Seat 2: 669iGNwYwgRZg3nhS+aDAQ ($90.15 in chips)
Seat 3: 54yWzRRgS0oZ+S6LwZBxMQ ($17.75 in chips)
Seat 4: sY+4Uuh5z/6AbXXaCS10jw ($209.35 in chips)
Seat 5: VvdR9F3I+2yELkfTVvC1dg ($242.85 in chips)
Seat 6: 3cPMpDMgeOMAe4UceUfLsg ($200 in chips)
VvdR9F3I+2yELkfTVvC1dg: posts small blind $1
3cPMpDMgeOMAe4UceUfLsg: posts big blind $2
*** HOLE CARDS ***
vkfxu8f/jMYKUk6Ly4eujw: folds
669iGNwYwgRZg3nhS+aDAQ: folds
54yWzRRgS0oZ+S6LwZBxMQ: calls $2
sY+4Uuh5z/6AbXXaCS10jw: raises $6 to $8
VvdR9F3I+2yELkfTVvC1dg: folds
3cPMpDMgeOMAe4UceUfLsg: folds
54yWzRRgS0oZ+S6LwZBxMQ: calls $6
*** FLOP *** [5d 7d Qc]
54yWzRRgS0oZ+S6LwZBxMQ: checks
sY+4Uuh5z/6AbXXaCS10jw: bets $10
54yWzRRgS0oZ+S6LwZBxMQ: calls $9.75 and is all-in
*** TURN *** [5d 7d Qc] [3d]
*** RIVER *** [5d 7d Qc 3d] [Jh]
*** SHOW DOWN ***
54yWzRRgS0oZ+S6LwZBxMQ: shows [4s 4h] (a pair of Fours)
sY+4Uuh5z/6AbXXaCS10jw: shows [Ks Kh] (a pair of Kings)
sY+4Uuh5z/6AbXXaCS10jw collected $36.65 from pot
*** SUMMARY ***
Total pot $38.50 | Rake $1.85
Board [5d 7d Qc 3d Jh]
Seat 1: vkfxu8f/jMYKUk6Ly4eujw folded before Flop (didn't bet)
Seat 2: 669iGNwYwgRZg3nhS+aDAQ folded before Flop (didn't bet)
Seat 3: 54yWzRRgS0oZ+S6LwZBxMQ showed [4s 4h] and lost with a pair of Fours
Seat 4: sY+4Uuh5z/6AbXXaCS10jw (button) showed [Ks Kh] and won ($36.65) with a pair of Kings
Seat 5: VvdR9F3I+2yELkfTVvC1dg (small blind) folded before Flop
Seat 6: 3cPMpDMgeOMAe4UceUfLsg (big blind) folded before Flop



PokerStars Game #59941235566:  Hold'em No Limit ($1/$2) - 2009/07/01 1:29:32 ET
Table 'AtOXMvcrtQM8yLNcALmfLQ' 2-max Seat #2 is the button
Seat 1: +HlQuAsMqZGYYtjcPO/a3A ($269.30 in chips)
Seat 2: pVqEzK9wXlRMECnb1Zg4Zw ($209.50 in chips)
pVqEzK9wXlRMECnb1Zg4Zw: posts small blind $1
+HlQuAsMqZGYYtjcPO/a3A: posts big blind $2
*** HOLE CARDS ***
pVqEzK9wXlRMECnb1Zg4Zw: calls $1
+HlQuAsMqZGYYtjcPO/a3A: checks
*** FLOP *** [4s 6h Js]
+HlQuAsMqZGYYtjcPO/a3A: checks
pVqEzK9wXlRMECnb1Zg4Zw: bets $8
+HlQuAsMqZGYYtjcPO/a3A: folds
pVqEzK9wXlRMECnb1Zg4Zw collected $3.80 from pot
pVqEzK9wXlRMECnb1Zg4Zw: doesn't show hand
*** SUMMARY ***
Total pot $4 | Rake $0.20
Board [4s 6h Js]
Seat 1: +HlQuAsMqZGYYtjcPO/a3A (big blind) folded on the Flop
Seat 2: pVqEzK9wXlRMECnb1Zg4Zw (button) (small blind) collected ($3.80)



PokerStars Game #59941235604:  Hold'em No Limit ($1/$2) - 2009/07/01 1:29:32 ET
Table '3WCXyaiCAbqSShQu7FIjvA' 9-max Seat #5 is the button
Seat 1: kTCkABD1UUldS9DFRGfCwQ ($151.40 in chips)
Seat 3: 5Q8U6iZbeO7xJSS4qvDP5g ($272.15 in chips)
Seat 4: waEF/+pxZTxNo4FvsORuXg ($82.40 in chips)
Seat 5: CkE3IyJF1KvdaAOmZY5XqQ ($200 in chips)
Seat 6: 5jQlngvMSqM/WoonOcR5kw ($240 in chips)
Seat 8: 1CtiZuXDFaJL1dJPQKyi8Q ($242.35 in chips)
Seat 9: FiXPLJyqb24l32QST2TInw ($153.40 in chips)
5jQlngvMSqM/WoonOcR5kw: posts small blind $1
1CtiZuXDFaJL1dJPQKyi8Q: posts big blind $2
TAfo4veNRaRlzDXMMYS3Jg: sits out
*** HOLE CARDS ***
FiXPLJyqb24l32QST2TInw: calls $2
kTCkABD1UUldS9DFRGfCwQ: folds
5Q8U6iZbeO7xJSS4qvDP5g: folds
waEF/+pxZTxNo4FvsORuXg: folds
QHxJjpVYwitg9krW6wZgJA leaves the table
CkE3IyJF1KvdaAOmZY5XqQ: folds
5jQlngvMSqM/WoonOcR5kw: calls $1
1CtiZuXDFaJL1dJPQKyi8Q: checks
*** FLOP *** [8d Qd Js]
5jQlngvMSqM/WoonOcR5kw: bets $2
1CtiZuXDFaJL1dJPQKyi8Q: folds
FiXPLJyqb24l32QST2TInw: raises $2 to $4
5jQlngvMSqM/WoonOcR5kw: calls $2
*** TURN *** [8d Qd Js] [2h]
5jQlngvMSqM/WoonOcR5kw: checks
FiXPLJyqb24l32QST2TInw: checks
*** RIVER *** [8d Qd Js 2h] [6s]
5jQlngvMSqM/WoonOcR5kw: checks
FiXPLJyqb24l32QST2TInw: checks
*** SHOW DOWN ***
5jQlngvMSqM/WoonOcR5kw: shows [Jh Th] (a pair of Jacks)
FiXPLJyqb24l32QST2TInw: mucks hand
5jQlngvMSqM/WoonOcR5kw collected $13.35 from pot
*** SUMMARY ***
Total pot $14 | Rake $0.65
Board [8d Qd Js 2h 6s]
Seat 1: kTCkABD1UUldS9DFRGfCwQ folded before Flop (didn't bet)
Seat 3: 5Q8U6iZbeO7xJSS4qvDP5g folded before Flop (didn't bet)
Seat 4: waEF/+pxZTxNo4FvsORuXg folded before Flop (didn't bet)
Seat 5: CkE3IyJF1KvdaAOmZY5XqQ (button) folded before Flop (didn't bet)
Seat 6: 5jQlngvMSqM/WoonOcR5kw (small blind) showed [Jh Th] and won ($13.35) with a pair of Jacks
Seat 8: 1CtiZuXDFaJL1dJPQKyi8Q (big blind) folded on the Flop
Seat 9: FiXPLJyqb24l32QST2TInw mucked



PokerStars Game #59941236758:  Hold'em No Limit ($1/$2) - 2009/07/01 1:29:34 ET
Table 'gftD4mDF7mIFKvSrIyaRbw' 9-max Seat #6 is the button
Seat 1: 31HuO+DQxppUQEedBWukug ($163 in chips)
Seat 2: GX1heJ+DSsvm7gzSPsYhhQ ($40 in chips)
Seat 3: CUZwDpLTQKhzarPe+JCLOQ ($200 in chips)
Seat 4: /inIs/z/PcX+TniIFpaxpg ($40 in chips)
Seat 5: mpsfNtnMVDqQHTe92AhIdw ($119.10 in chips)
Seat 6: 2NvwF8W2nzsbS+G//yLAbQ ($115.85 in chips)
Seat 7: +T/63sAeZzWyHchahJ36GQ ($38 in chips)
Seat 8: MpL4DeEqGQu0H8TJEbEOrg ($44 in chips)
Seat 9: F7m34OOfAQ7annesMHVjKw ($165.75 in chips)
+T/63sAeZzWyHchahJ36GQ: posts small blind $1
MpL4DeEqGQu0H8TJEbEOrg: posts big blind $2
*** HOLE CARDS ***
F7m34OOfAQ7annesMHVjKw: folds
31HuO+DQxppUQEedBWukug has timed out
31HuO+DQxppUQEedBWukug: folds
31HuO+DQxppUQEedBWukug is sitting out
GX1heJ+DSsvm7gzSPsYhhQ: folds
CUZwDpLTQKhzarPe+JCLOQ: folds
/inIs/z/PcX+TniIFpaxpg: folds
mpsfNtnMVDqQHTe92AhIdw: folds
2NvwF8W2nzsbS+G//yLAbQ: calls $2
+T/63sAeZzWyHchahJ36GQ: raises $8 to $10
MpL4DeEqGQu0H8TJEbEOrg: folds
2NvwF8W2nzsbS+G//yLAbQ: folds
+T/63sAeZzWyHchahJ36GQ collected $6 from pot
+T/63sAeZzWyHchahJ36GQ: doesn't show hand
*** SUMMARY ***
Total pot $6 | Rake $0
Seat 1: 31HuO+DQxppUQEedBWukug folded before Flop (didn't bet)
Seat 2: GX1heJ+DSsvm7gzSPsYhhQ folded before Flop (didn't bet)
Seat 3: CUZwDpLTQKhzarPe+JCLOQ folded before Flop (didn't bet)
Seat 4: /inIs/z/PcX+TniIFpaxpg folded before Flop (didn't bet)
Seat 5: mpsfNtnMVDqQHTe92AhIdw folded before Flop (didn't bet)
Seat 6: 2NvwF8W2nzsbS+G//yLAbQ (button) folded before Flop
Seat 7: +T/63sAeZzWyHchahJ36GQ (small blind) collected ($6)
Seat 8: MpL4DeEqGQu0H8TJEbEOrg (big blind) folded before Flop
Seat 9: F7m34OOfAQ7annesMHVjKw folded before Flop (didn't bet)



PokerStars Game #59941237304:  Hold'em No Limit ($1/$2) - 2009/07/01 1:29:35 ET
Table 'G1Oqdy4Pqdb5gtx40rUBzA' 6-max Seat #4 is the button
Seat 2: 4uqU0dG67owXuPz303Al4w ($495.20 in chips)
Seat 3: VvdR9F3I+2yELkfTVvC1dg ($247.25 in chips)
Seat 4: B87ikIyZ/TzAVeXf38Ny0g ($200 in chips)
Seat 5: F1+Ml47qRQWunzPnGhLLzQ ($187.50 in chips)
Seat 6: qCnEYuAE5y5A7bk6fO5/jQ ($200 in chips)
F1+Ml47qRQWunzPnGhLLzQ: posts small blind $1
qCnEYuAE5y5A7bk6fO5/jQ: posts big blind $2
ubtx4Z5L+AcK71MTvYiGVw: sits out
*** HOLE CARDS ***
4uqU0dG67owXuPz303Al4w: raises $4 to $6
VvdR9F3I+2yELkfTVvC1dg: calls $6
B87ikIyZ/TzAVeXf38Ny0g: calls $6
F1+Ml47qRQWunzPnGhLLzQ: folds
qCnEYuAE5y5A7bk6fO5/jQ: folds
*** FLOP *** [Kc 7h Qc]
4uqU0dG67owXuPz303Al4w: bets $10
VvdR9F3I+2yELkfTVvC1dg: folds
B87ikIyZ/TzAVeXf38Ny0g: calls $10
*** TURN *** [Kc 7h Qc] [5h]
4uqU0dG67owXuPz303Al4w: bets $26
B87ikIyZ/TzAVeXf38Ny0g: folds
4uqU0dG67owXuPz303Al4w collected $39.05 from pot
*** SUMMARY ***
Total pot $41 | Rake $1.95
Board [Kc 7h Qc 5h]
Seat 2: 4uqU0dG67owXuPz303Al4w collected ($39.05)
Seat 3: VvdR9F3I+2yELkfTVvC1dg folded on the Flop
Seat 4: B87ikIyZ/TzAVeXf38Ny0g (button) folded on the Turn
Seat 5: F1+Ml47qRQWunzPnGhLLzQ (small blind) folded before Flop
Seat 6: qCnEYuAE5y5A7bk6fO5/jQ (big blind) folded before Flop



PokerStars Game #59941238482:  Hold'em No Limit ($1/$2) - 2009/07/01 1:29:37 ET
Table 'qVXak+oTeDXMGbWa4sDU5Q' 9-max Seat #9 is the button
Seat 1: H6Z4+qu8gR0VUiPOijndVg ($210.55 in chips)
Seat 2: rW/MyplHylMSBRaoRUzWrg ($74 in chips)
Seat 3: WUlHm+ydPPHG7Lb0rePSdA ($153.65 in chips)
Seat 4: lQYT23h5QCUVZAKxjOO39Q ($203.70 in chips)
Seat 5: FWGiDqRwvLeKmHq9t4Jy9w ($268.80 in chips)
Seat 6: GX1heJ+DSsvm7gzSPsYhhQ ($34 in chips)
Seat 7: PfmlvZlFiss79a6IoEr11g ($163.30 in chips)
Seat 8: Z0rzUi0y1x80UdIpofoNbA ($125.55 in chips)
Seat 9: CkE3IyJF1KvdaAOmZY5XqQ ($200 in chips)
H6Z4+qu8gR0VUiPOijndVg: posts small blind $1
rW/MyplHylMSBRaoRUzWrg: posts big blind $2
*** HOLE CARDS ***
WUlHm+ydPPHG7Lb0rePSdA: folds
lQYT23h5QCUVZAKxjOO39Q: folds
FWGiDqRwvLeKmHq9t4Jy9w: folds
GX1heJ+DSsvm7gzSPsYhhQ: raises $4 to $6
PfmlvZlFiss79a6IoEr11g: folds
Z0rzUi0y1x80UdIpofoNbA: folds
CkE3IyJF1KvdaAOmZY5XqQ has timed out
CkE3IyJF1KvdaAOmZY5XqQ: folds
CkE3IyJF1KvdaAOmZY5XqQ is sitting out
CkE3IyJF1KvdaAOmZY5XqQ has returned
H6Z4+qu8gR0VUiPOijndVg: folds
rW/MyplHylMSBRaoRUzWrg: folds
GX1heJ+DSsvm7gzSPsYhhQ collected $5 from pot
GX1heJ+DSsvm7gzSPsYhhQ: doesn't show hand
*** SUMMARY ***
Total pot $5 | Rake $0
Seat 1: H6Z4+qu8gR0VUiPOijndVg (small blind) folded before Flop
Seat 2: rW/MyplHylMSBRaoRUzWrg (big blind) folded before Flop
Seat 3: WUlHm+ydPPHG7Lb0rePSdA folded before Flop (didn't bet)
Seat 4: lQYT23h5QCUVZAKxjOO39Q folded before Flop (didn't bet)
Seat 5: FWGiDqRwvLeKmHq9t4Jy9w folded before Flop (didn't bet)
Seat 6: GX1heJ+DSsvm7gzSPsYhhQ collected ($5)
Seat 7: PfmlvZlFiss79a6IoEr11g folded before Flop (didn't bet)
Seat 8: Z0rzUi0y1x80UdIpofoNbA folded before Flop (didn't bet)
Seat 9: CkE3IyJF1KvdaAOmZY5XqQ (button) folded before Flop (didn't bet)



PokerStars Game #59941238458:  Hold'em No Limit ($1/$2) - 2009/07/01 1:29:37 ET
Table 'W9UeSV0aoPjh5SFSxM8jUQ' 9-max Seat #6 is the button
Seat 1: mIKx5lhIt13X5eZQH0ZeMA ($25 in chips)
Seat 2: iMe5yhc+1BaiIPHet3NMrA ($252.60 in chips)
Seat 3: /inIs/z/PcX+TniIFpaxpg ($25 in chips)
Seat 4: 4YA/sQy1Emm680zhbPUjow ($133.35 in chips)
Seat 5: ri8CLkX3e9JF34dQNbsHGA ($40 in chips)
Seat 6: j47DM+lqTfzZP8musviQTg ($129.30 in chips)
Seat 7: I2ipWauytvrkEer4XD3Sjg ($85.70 in chips)
Seat 8: odhvI/CZeMsPyo1n1U7+hA ($37.70 in chips)
Seat 9: Q104K4iDGcqOlVrjAkzPEA ($98.10 in chips)
I2ipWauytvrkEer4XD3Sjg: posts small blind $1
odhvI/CZeMsPyo1n1U7+hA: posts big blind $2
*** HOLE CARDS ***
Q104K4iDGcqOlVrjAkzPEA: folds
mIKx5lhIt13X5eZQH0ZeMA: calls $2
iMe5yhc+1BaiIPHet3NMrA: folds
/inIs/z/PcX+TniIFpaxpg: folds
4YA/sQy1Emm680zhbPUjow: folds
ri8CLkX3e9JF34dQNbsHGA: folds
j47DM+lqTfzZP8musviQTg: folds
I2ipWauytvrkEer4XD3Sjg: calls $1
odhvI/CZeMsPyo1n1U7+hA: checks
*** FLOP *** [5c 8c 4d]
I2ipWauytvrkEer4XD3Sjg: checks
odhvI/CZeMsPyo1n1U7+hA: bets $4
mIKx5lhIt13X5eZQH0ZeMA: folds
I2ipWauytvrkEer4XD3Sjg: folds
odhvI/CZeMsPyo1n1U7+hA collected $5.70 from pot
*** SUMMARY ***
Total pot $6 | Rake $0.30
Board [5c 8c 4d]
Seat 1: mIKx5lhIt13X5eZQH0ZeMA folded on the Flop
Seat 2: iMe5yhc+1BaiIPHet3NMrA folded before Flop (didn't bet)
Seat 3: /inIs/z/PcX+TniIFpaxpg folded before Flop (didn't bet)
Seat 4: 4YA/sQy1Emm680zhbPUjow folded before Flop (didn't bet)
Seat 5: ri8CLkX3e9JF34dQNbsHGA folded before Flop (didn't bet)
Seat 6: j47DM+lqTfzZP8musviQTg (button) folded before Flop (didn't bet)
Seat 7: I2ipWauytvrkEer4XD3Sjg (small blind) folded on the Flop
Seat 8: odhvI/CZeMsPyo1n1U7+hA (big blind) collected ($5.70)
Seat 9: Q104K4iDGcqOlVrjAkzPEA folded before Flop (didn't bet)



PokerStars Game #59941240064:  Hold'em No Limit ($1/$2) - 2009/07/01 1:29:40 ET
Table 'TsEDkiO4tzCTCzJ7tNdEqw' 6-max Seat #2 is the button
Seat 1: MfXQsYD8pGeCS7XOtyV+vw ($96.05 in chips)
Seat 2: 4dcDwIHRm96PwtqkpQiuiA ($78.10 in chips)
Seat 3: ubtx4Z5L+AcK71MTvYiGVw ($200 in chips)
Seat 4: K8MXCrNAVYlMnnCeM32Kxw ($116.50 in chips)
Seat 5: VvdR9F3I+2yELkfTVvC1dg ($266.35 in chips)
Seat 6: uCqEjnxh2/vFBjKYkfTOkw ($142.35 in chips)
ubtx4Z5L+AcK71MTvYiGVw: posts small blind $1
K8MXCrNAVYlMnnCeM32Kxw: posts big blind $2
*** HOLE CARDS ***
VvdR9F3I+2yELkfTVvC1dg: folds
uCqEjnxh2/vFBjKYkfTOkw: folds
MfXQsYD8pGeCS7XOtyV+vw: folds
4dcDwIHRm96PwtqkpQiuiA: folds
ubtx4Z5L+AcK71MTvYiGVw: calls $1
K8MXCrNAVYlMnnCeM32Kxw: raises $6 to $8
ubtx4Z5L+AcK71MTvYiGVw: folds
K8MXCrNAVYlMnnCeM32Kxw collected $4 from pot
*** SUMMARY ***
Total pot $4 | Rake $0
Seat 1: MfXQsYD8pGeCS7XOtyV+vw folded before Flop (didn't bet)
Seat 2: 4dcDwIHRm96PwtqkpQiuiA (button) folded before Flop (didn't bet)
Seat 3: ubtx4Z5L+AcK71MTvYiGVw (small blind) folded before Flop
Seat 4: K8MXCrNAVYlMnnCeM32Kxw (big blind) collected ($4)
Seat 5: VvdR9F3I+2yELkfTVvC1dg folded before Flop (didn't bet)
Seat 6: uCqEjnxh2/vFBjKYkfTOkw folded before Flop (didn't bet)



PokerStars Game #59941240922:  Hold'em No Limit ($1/$2) - 2009/07/01 1:29:42 ET
Table 'uJ9juaXXg9yIcSU8amxaXQ' 6-max Seat #2 is the button
Seat 1: JsqOjN/eHz0uYVf/PyUJ6Q ($144.50 in chips)
Seat 2: VvdR9F3I+2yELkfTVvC1dg ($229.10 in chips)
Seat 3: qXDd0ZyMIse0OBu8pxeQ3Q ($242 in chips)
Seat 4: zNjJ/y4emmF+vzrCDd+ooA ($237.05 in chips)
Seat 5: YsLQ3BAvgQHWXMAv3Wv6Hg ($200 in chips)
Seat 6: 2DFp9Veq1xxq64dCjwNuUw ($57.60 in chips)
qXDd0ZyMIse0OBu8pxeQ3Q: posts small blind $1
zNjJ/y4emmF+vzrCDd+ooA: posts big blind $2
*** HOLE CARDS ***
YsLQ3BAvgQHWXMAv3Wv6Hg: folds
2DFp9Veq1xxq64dCjwNuUw: folds
JsqOjN/eHz0uYVf/PyUJ6Q: folds
VvdR9F3I+2yELkfTVvC1dg: folds
qXDd0ZyMIse0OBu8pxeQ3Q: raises $4 to $6
zNjJ/y4emmF+vzrCDd+ooA: calls $4
*** FLOP *** [6s Ks 7d]
qXDd0ZyMIse0OBu8pxeQ3Q: bets $8
zNjJ/y4emmF+vzrCDd+ooA: folds
qXDd0ZyMIse0OBu8pxeQ3Q collected $11.40 from pot
*** SUMMARY ***
Total pot $12 | Rake $0.60
Board [6s Ks 7d]
Seat 1: JsqOjN/eHz0uYVf/PyUJ6Q folded before Flop (didn't bet)
Seat 2: VvdR9F3I+2yELkfTVvC1dg (button) folded before Flop (didn't bet)
Seat 3: qXDd0ZyMIse0OBu8pxeQ3Q (small blind) collected ($11.40)
Seat 4: zNjJ/y4emmF+vzrCDd+ooA (big blind) folded on the Flop
Seat 5: YsLQ3BAvgQHWXMAv3Wv6Hg folded before Flop (didn't bet)
Seat 6: 2DFp9Veq1xxq64dCjwNuUw folded before Flop (didn't bet)



PokerStars Game #59941243294:  Hold'em No Limit ($1/$2) - 2009/07/01 1:29:46 ET
Table 'jlrIxbrVIG+gjaUYT4za8g' 6-max Seat #1 is the button
Seat 1: ygTTt5ehT4aF86q1a8/R+w ($258.30 in chips)
Seat 3: gnYme0DNFflnMhrdbxe1Ag ($202.75 in chips)
Seat 4: 8srN1dKQePlsv0GyTada+Q ($224.55 in chips)
Seat 5: AyBB0k3Dcl7xbXUeGMw06g ($69.90 in chips)
Seat 6: vkfxu8f/jMYKUk6Ly4eujw ($309 in chips)
/PH6Ffnho4Ysm8S3V/oa+w will be allowed to play after the button
gnYme0DNFflnMhrdbxe1Ag: posts small blind $1
8srN1dKQePlsv0GyTada+Q: posts big blind $2
*** HOLE CARDS ***
AyBB0k3Dcl7xbXUeGMw06g: raises $4 to $6
vkfxu8f/jMYKUk6Ly4eujw: folds
ygTTt5ehT4aF86q1a8/R+w: folds
gnYme0DNFflnMhrdbxe1Ag: folds
8srN1dKQePlsv0GyTada+Q: folds
AyBB0k3Dcl7xbXUeGMw06g collected $5 from pot
*** SUMMARY ***
Total pot $5 | Rake $0
Seat 1: ygTTt5ehT4aF86q1a8/R+w (button) folded before Flop (didn't bet)
Seat 3: gnYme0DNFflnMhrdbxe1Ag (small blind) folded before Flop
Seat 4: 8srN1dKQePlsv0GyTada+Q (big blind) folded before Flop
Seat 5: AyBB0k3Dcl7xbXUeGMw06g collected ($5)
Seat 6: vkfxu8f/jMYKUk6Ly4eujw folded before Flop (didn't bet)



PokerStars Game #59941244558:  Hold'em No Limit ($1/$2) - 2009/07/01 1:29:48 ET
Table '/dyk+YdRGv90j2box35j8w' 6-max Seat #1 is the button
Seat 1: 8srN1dKQePlsv0GyTada+Q ($201.80 in chips)
Seat 2: qCnEYuAE5y5A7bk6fO5/jQ ($474.60 in chips)
Seat 4: z/u1YTnkiIDrtp/2cA2dBg ($205.60 in chips)
Seat 5: VvdR9F3I+2yELkfTVvC1dg ($203 in chips)
qCnEYuAE5y5A7bk6fO5/jQ: posts small blind $1
z/u1YTnkiIDrtp/2cA2dBg: posts big blind $2
*** HOLE CARDS ***
VvdR9F3I+2yELkfTVvC1dg: folds
8srN1dKQePlsv0GyTada+Q: raises $3 to $5
qCnEYuAE5y5A7bk6fO5/jQ: folds
z/u1YTnkiIDrtp/2cA2dBg: calls $3
*** FLOP *** [8h 4s 9c]
z/u1YTnkiIDrtp/2cA2dBg: bets $5
8srN1dKQePlsv0GyTada+Q: raises $9 to $14
z/u1YTnkiIDrtp/2cA2dBg: calls $9
*** TURN *** [8h 4s 9c] [Ks]
z/u1YTnkiIDrtp/2cA2dBg: checks
8srN1dKQePlsv0GyTada+Q: bets $28
gnYme0DNFflnMhrdbxe1Ag joins the table at seat #6
z/u1YTnkiIDrtp/2cA2dBg: folds
8srN1dKQePlsv0GyTada+Q collected $37.10 from pot
8srN1dKQePlsv0GyTada+Q: doesn't show hand
*** SUMMARY ***
Total pot $39 | Rake $1.90
Board [8h 4s 9c Ks]
Seat 1: 8srN1dKQePlsv0GyTada+Q (button) collected ($37.10)
Seat 2: qCnEYuAE5y5A7bk6fO5/jQ (small blind) folded before Flop
Seat 4: z/u1YTnkiIDrtp/2cA2dBg (big blind) folded on the Turn
Seat 5: VvdR9F3I+2yELkfTVvC1dg folded before Flop (didn't bet)



PokerStars Game #59941245472:  Hold'em No Limit ($1/$2) - 2009/07/01 1:29:49 ET
Table 'ztv6V3FN2bQ9nmJPPdx6nQ' 6-max Seat #2 is the button
Seat 1: 6fLdOUCRtX71xbVRhJEq8w ($224 in chips)
Seat 2: 5Y+ZGWLI4gnlpApDX5vy1A ($389.75 in chips)
Seat 3: ubtx4Z5L+AcK71MTvYiGVw ($243 in chips)
Seat 6: mfy7uGZcqA2PVQqEVbJ7+g ($116.45 in chips)
ubtx4Z5L+AcK71MTvYiGVw: posts small blind $1
UaZ5yj+6LjtWqMQg2QskUw: is sitting out
mfy7uGZcqA2PVQqEVbJ7+g: posts big blind $2
*** HOLE CARDS ***
6fLdOUCRtX71xbVRhJEq8w: raises $4 to $6
5Y+ZGWLI4gnlpApDX5vy1A: folds
ubtx4Z5L+AcK71MTvYiGVw: folds
mfy7uGZcqA2PVQqEVbJ7+g: folds
6fLdOUCRtX71xbVRhJEq8w collected $5 from pot
*** SUMMARY ***
Total pot $5 | Rake $0
Seat 1: 6fLdOUCRtX71xbVRhJEq8w collected ($5)
Seat 2: 5Y+ZGWLI4gnlpApDX5vy1A (button) folded before Flop (didn't bet)
Seat 3: ubtx4Z5L+AcK71MTvYiGVw (small blind) folded before Flop
Seat 6: mfy7uGZcqA2PVQqEVbJ7+g (big blind) folded before Flop



PokerStars Game #59941246012:  Hold'em No Limit ($1/$2) - 2009/07/01 1:29:50 ET
Table 'AtOXMvcrtQM8yLNcALmfLQ' 2-max Seat #1 is the button
Seat 1: +HlQuAsMqZGYYtjcPO/a3A ($267.30 in chips)
Seat 2: pVqEzK9wXlRMECnb1Zg4Zw ($211.30 in chips)
+HlQuAsMqZGYYtjcPO/a3A: posts small blind $1
pVqEzK9wXlRMECnb1Zg4Zw: posts big blind $2
*** HOLE CARDS ***
+HlQuAsMqZGYYtjcPO/a3A: calls $1
pVqEzK9wXlRMECnb1Zg4Zw: checks
*** FLOP *** [5s 9s Th]
pVqEzK9wXlRMECnb1Zg4Zw: checks
+HlQuAsMqZGYYtjcPO/a3A: bets $4
pVqEzK9wXlRMECnb1Zg4Zw: folds
+HlQuAsMqZGYYtjcPO/a3A collected $3.80 from pot
*** SUMMARY ***
Total pot $4 | Rake $0.20
Board [5s 9s Th]
Seat 1: +HlQuAsMqZGYYtjcPO/a3A (button) (small blind) collected ($3.80)
Seat 2: pVqEzK9wXlRMECnb1Zg4Zw (big blind) folded on the Flop



PokerStars Game #59941245924:  Hold'em No Limit ($1/$2) - 2009/07/01 1:29:50 ET
Table 'NmY84NAf9Mh0ckAckHnh5g' 2-max Seat #2 is the button
Seat 1: 6hvg964TSqZ3AL/0XK9aVQ ($233.90 in chips)
Seat 2: RwDoM55ZeQuI2ADyJhOb2Q ($766.70 in chips)
RwDoM55ZeQuI2ADyJhOb2Q: posts small blind $1
6hvg964TSqZ3AL/0XK9aVQ: posts big blind $2
*** HOLE CARDS ***
RwDoM55ZeQuI2ADyJhOb2Q: raises $4 to $6
6hvg964TSqZ3AL/0XK9aVQ: calls $4
*** FLOP *** [5d 9s 2s]
6hvg964TSqZ3AL/0XK9aVQ: checks
RwDoM55ZeQuI2ADyJhOb2Q: bets $8
6hvg964TSqZ3AL/0XK9aVQ: calls $8
*** TURN *** [5d 9s 2s] [6c]
6hvg964TSqZ3AL/0XK9aVQ: checks
RwDoM55ZeQuI2ADyJhOb2Q: bets $22
6hvg964TSqZ3AL/0XK9aVQ: calls $22
*** RIVER *** [5d 9s 2s 6c] [2d]
6hvg964TSqZ3AL/0XK9aVQ: checks
RwDoM55ZeQuI2ADyJhOb2Q: bets $52
6hvg964TSqZ3AL/0XK9aVQ: calls $52
*** SHOW DOWN ***
RwDoM55ZeQuI2ADyJhOb2Q: shows [7d Tc] (a pair of Deuces)
6hvg964TSqZ3AL/0XK9aVQ: shows [3c 6d] (two pair, Sixes and Deuces)
6hvg964TSqZ3AL/0XK9aVQ collected $175.50 from pot
*** SUMMARY ***
Total pot $176 | Rake $0.50
Board [5d 9s 2s 6c 2d]
Seat 1: 6hvg964TSqZ3AL/0XK9aVQ (big blind) showed [3c 6d] and won ($175.50) with two pair, Sixes and Deuces
Seat 2: RwDoM55ZeQuI2ADyJhOb2Q (button) (small blind) showed [7d Tc] and lost with a pair of Deuces



PokerStars Game #59941246684:  Hold'em No Limit ($1/$2) - 2009/07/01 1:29:51 ET
Table 'kq5zaQ+1hLNf8LZfGnbTAA' 6-max Seat #1 is the button
Seat 1: 8srN1dKQePlsv0GyTada+Q ($405 in chips)
Seat 2: nXDI8Y/S6POzRwANu3d8hQ ($195 in chips)
Seat 3: vkfxu8f/jMYKUk6Ly4eujw ($218.95 in chips)
Seat 4: 3dAbvkxS5NPQTBAbvpinVg ($278.45 in chips)
Seat 6: mfy7uGZcqA2PVQqEVbJ7+g ($194.25 in chips)
nXDI8Y/S6POzRwANu3d8hQ: posts small blind $1
vkfxu8f/jMYKUk6Ly4eujw: posts big blind $2
*** HOLE CARDS ***
3dAbvkxS5NPQTBAbvpinVg: folds
kfASJqTbXek+zc8ZKsZL1Q leaves the table
mfy7uGZcqA2PVQqEVbJ7+g: folds
8srN1dKQePlsv0GyTada+Q: folds
gnYme0DNFflnMhrdbxe1Ag joins the table at seat #5
nXDI8Y/S6POzRwANu3d8hQ: raises $6 to $8
vkfxu8f/jMYKUk6Ly4eujw: raises $15 to $23
nXDI8Y/S6POzRwANu3d8hQ: folds
vkfxu8f/jMYKUk6Ly4eujw collected $16 from pot
vkfxu8f/jMYKUk6Ly4eujw: doesn't show hand
*** SUMMARY ***
Total pot $16 | Rake $0
Seat 1: 8srN1dKQePlsv0GyTada+Q (button) folded before Flop (didn't bet)
Seat 2: nXDI8Y/S6POzRwANu3d8hQ (small blind) folded before Flop
Seat 3: vkfxu8f/jMYKUk6Ly4eujw (big blind) collected ($16)
Seat 4: 3dAbvkxS5NPQTBAbvpinVg folded before Flop (didn't bet)
Seat 6: mfy7uGZcqA2PVQqEVbJ7+g folded before Flop (didn't bet)



PokerStars Game #59941248306:  Hold'em No Limit ($1/$2) - 2009/07/01 1:29:54 ET
Table 'CFkQcfWjKccZaZDf71FK+w' 6-max Seat #5 is the button
Seat 2: ewN/vzF22+/gdzjIKBOlkA ($207.80 in chips)
Seat 3: 09BNF4quPDzanQzM8vc6WA ($45.45 in chips)
Seat 4: ygTTt5ehT4aF86q1a8/R+w ($254.25 in chips)
Seat 5: 2lOU1DcvUZaMcxZ95XfzXw ($142.15 in chips)
Seat 6: ORVqY3rf9X6ANA/8s+On2Q ($123.60 in chips)
ORVqY3rf9X6ANA/8s+On2Q: posts small blind $1
ewN/vzF22+/gdzjIKBOlkA: posts big blind $2
*** HOLE CARDS ***
09BNF4quPDzanQzM8vc6WA: folds
ygTTt5ehT4aF86q1a8/R+w: folds
2lOU1DcvUZaMcxZ95XfzXw: folds
ORVqY3rf9X6ANA/8s+On2Q: folds
ewN/vzF22+/gdzjIKBOlkA collected $2 from pot
*** SUMMARY ***
Total pot $2 | Rake $0
Seat 2: ewN/vzF22+/gdzjIKBOlkA (big blind) collected ($2)
Seat 3: 09BNF4quPDzanQzM8vc6WA folded before Flop (didn't bet)
Seat 4: ygTTt5ehT4aF86q1a8/R+w folded before Flop (didn't bet)
Seat 5: 2lOU1DcvUZaMcxZ95XfzXw (button) folded before Flop (didn't bet)
Seat 6: ORVqY3rf9X6ANA/8s+On2Q (small blind) folded before Flop



PokerStars Game #59941248108:  Hold'em No Limit ($1/$2) - 2009/07/01 1:29:54 ET
Table 'gnHBqWll9O3fxG7Ojkz/ng' 9-max Seat #4 is the button
Seat 1: TAfo4veNRaRlzDXMMYS3Jg ($34 in chips)
Seat 2: H6Z4+qu8gR0VUiPOijndVg ($324.25 in chips)
Seat 3: 5Q8U6iZbeO7xJSS4qvDP5g ($211 in chips)
Seat 4: nXDI8Y/S6POzRwANu3d8hQ ($36 in chips)
Seat 5: rBQDMkKm9cZn6M9NPsiVew ($224.45 in chips)
Seat 7: jqui3xAWCkcdPW36a6BD+w ($344.95 in chips)
Seat 8: cM6efHzdxoqYm0EQKP4TTQ ($98.15 in chips)
Seat 9: GX1heJ+DSsvm7gzSPsYhhQ ($54.35 in chips)
rBQDMkKm9cZn6M9NPsiVew: posts small blind $1
/inIs/z/PcX+TniIFpaxpg: is sitting out
jqui3xAWCkcdPW36a6BD+w: posts big blind $2
*** HOLE CARDS ***
/inIs/z/PcX+TniIFpaxpg leaves the table
cM6efHzdxoqYm0EQKP4TTQ: folds
GX1heJ+DSsvm7gzSPsYhhQ: folds
TAfo4veNRaRlzDXMMYS3Jg: folds
H6Z4+qu8gR0VUiPOijndVg: folds
MeleaB joins the table at seat #6
5Q8U6iZbeO7xJSS4qvDP5g: folds
nXDI8Y/S6POzRwANu3d8hQ: raises $6 to $8
rBQDMkKm9cZn6M9NPsiVew: folds
jqui3xAWCkcdPW36a6BD+w: folds
nXDI8Y/S6POzRwANu3d8hQ collected $5 from pot
nXDI8Y/S6POzRwANu3d8hQ: doesn't show hand
*** SUMMARY ***
Total pot $5 | Rake $0
Seat 1: TAfo4veNRaRlzDXMMYS3Jg folded before Flop (didn't bet)
Seat 2: H6Z4+qu8gR0VUiPOijndVg folded before Flop (didn't bet)
Seat 3: 5Q8U6iZbeO7xJSS4qvDP5g folded before Flop (didn't bet)
Seat 4: nXDI8Y/S6POzRwANu3d8hQ (button) collected ($5)
Seat 5: rBQDMkKm9cZn6M9NPsiVew (small blind) folded before Flop
Seat 7: jqui3xAWCkcdPW36a6BD+w (big blind) folded before Flop
Seat 8: cM6efHzdxoqYm0EQKP4TTQ folded before Flop (didn't bet)
Seat 9: GX1heJ+DSsvm7gzSPsYhhQ folded before Flop (didn't bet)



PokerStars Game #59941250004:  Hold'em No Limit ($1/$2) - 2009/07/01 1:29:57 ET
Table 'YqGfR5eHfMeSjb9a+QU9rg' 9-max Seat #2 is the button
Seat 1: rW/MyplHylMSBRaoRUzWrg ($34 in chips)
Seat 2: W3Nqt1GWlTi9tXQXMNEvgw ($401.85 in chips)
Seat 3: /gll27k+xWYV7Fbki0lFDQ ($259.75 in chips)
Seat 4: GX1heJ+DSsvm7gzSPsYhhQ ($40 in chips)
Seat 5: CkE3IyJF1KvdaAOmZY5XqQ ($200 in chips)
Seat 6: TAfo4veNRaRlzDXMMYS3Jg ($37 in chips)
Seat 7: 41aZuLBz9nAi2GPVKabmCw ($95.45 in chips)
Seat 8: JnV3SM2D6dAFYyGZHHpvrg ($93.25 in chips)
Seat 9: /inIs/z/PcX+TniIFpaxpg ($205.20 in chips)
/gll27k+xWYV7Fbki0lFDQ: posts small blind $1
GX1heJ+DSsvm7gzSPsYhhQ: posts big blind $2
*** HOLE CARDS ***
CkE3IyJF1KvdaAOmZY5XqQ: raises $6 to $8
TAfo4veNRaRlzDXMMYS3Jg: folds
41aZuLBz9nAi2GPVKabmCw: folds
JnV3SM2D6dAFYyGZHHpvrg: folds
/inIs/z/PcX+TniIFpaxpg: folds
rW/MyplHylMSBRaoRUzWrg: folds
W3Nqt1GWlTi9tXQXMNEvgw: folds
/gll27k+xWYV7Fbki0lFDQ: folds
GX1heJ+DSsvm7gzSPsYhhQ: folds
CkE3IyJF1KvdaAOmZY5XqQ collected $5 from pot
*** SUMMARY ***
Total pot $5 | Rake $0
Seat 1: rW/MyplHylMSBRaoRUzWrg folded before Flop (didn't bet)
Seat 2: W3Nqt1GWlTi9tXQXMNEvgw (button) folded before Flop (didn't bet)
Seat 3: /gll27k+xWYV7Fbki0lFDQ (small blind) folded before Flop
Seat 4: GX1heJ+DSsvm7gzSPsYhhQ (big blind) folded before Flop
Seat 5: CkE3IyJF1KvdaAOmZY5XqQ collected ($5)
Seat 6: TAfo4veNRaRlzDXMMYS3Jg folded before Flop (didn't bet)
Seat 7: 41aZuLBz9nAi2GPVKabmCw folded before Flop (didn't bet)
Seat 8: JnV3SM2D6dAFYyGZHHpvrg folded before Flop (didn't bet)
Seat 9: /inIs/z/PcX+TniIFpaxpg folded before Flop (didn't bet)



PokerStars Game #59941253046:  Hold'em No Limit ($1/$2) - 2009/07/01 1:30:03 ET
Table 'TsEDkiO4tzCTCzJ7tNdEqw' 6-max Seat #3 is the button
Seat 1: MfXQsYD8pGeCS7XOtyV+vw ($96.05 in chips)
Seat 2: 4dcDwIHRm96PwtqkpQiuiA ($78.10 in chips)
Seat 3: ubtx4Z5L+AcK71MTvYiGVw ($200 in chips)
Seat 4: K8MXCrNAVYlMnnCeM32Kxw ($118.50 in chips)
Seat 5: VvdR9F3I+2yELkfTVvC1dg ($266.35 in chips)
Seat 6: uCqEjnxh2/vFBjKYkfTOkw ($142.35 in chips)
K8MXCrNAVYlMnnCeM32Kxw: posts small blind $1
VvdR9F3I+2yELkfTVvC1dg: posts big blind $2
*** HOLE CARDS ***
uCqEjnxh2/vFBjKYkfTOkw: folds
MfXQsYD8pGeCS7XOtyV+vw: calls $2
4dcDwIHRm96PwtqkpQiuiA: folds
ubtx4Z5L+AcK71MTvYiGVw: raises $8 to $10
K8MXCrNAVYlMnnCeM32Kxw: folds
VvdR9F3I+2yELkfTVvC1dg: folds
MfXQsYD8pGeCS7XOtyV+vw: folds
ubtx4Z5L+AcK71MTvYiGVw collected $7 from pot
ubtx4Z5L+AcK71MTvYiGVw: doesn't show hand
*** SUMMARY ***
Total pot $7 | Rake $0
Seat 1: MfXQsYD8pGeCS7XOtyV+vw folded before Flop
Seat 2: 4dcDwIHRm96PwtqkpQiuiA folded before Flop (didn't bet)
Seat 3: ubtx4Z5L+AcK71MTvYiGVw (button) collected ($7)
Seat 4: K8MXCrNAVYlMnnCeM32Kxw (small blind) folded before Flop
Seat 5: VvdR9F3I+2yELkfTVvC1dg (big blind) folded before Flop
Seat 6: uCqEjnxh2/vFBjKYkfTOkw folded before Flop (didn't bet)



PokerStars Game #59941253610:  Hold'em No Limit ($1/$2) - 2009/07/01 1:30:04 ET
Table 'aSf77Sj8QEnzcc0WaxVD4Q' 6-max Seat #1 is the button
Seat 1: UELtvp+JfwI7XDGVwSxZXA ($151.55 in chips)
Seat 2: vkfxu8f/jMYKUk6Ly4eujw ($207.80 in chips)
Seat 3: 9dpyyjDTCed6nV7JhaUUpw ($526.70 in chips)
Seat 4: YsLQ3BAvgQHWXMAv3Wv6Hg ($259.70 in chips)
Seat 5: VvdR9F3I+2yELkfTVvC1dg ($240 in chips)
Seat 6: vkoJRf3gidxY1pPi0AFWww ($129.60 in chips)
vkfxu8f/jMYKUk6Ly4eujw: posts small blind $1
9dpyyjDTCed6nV7JhaUUpw: posts big blind $2
*** HOLE CARDS ***
YsLQ3BAvgQHWXMAv3Wv6Hg: folds
VvdR9F3I+2yELkfTVvC1dg: folds
vkoJRf3gidxY1pPi0AFWww: folds
UELtvp+JfwI7XDGVwSxZXA: calls $2
vkfxu8f/jMYKUk6Ly4eujw: raises $8 to $10
9dpyyjDTCed6nV7JhaUUpw: folds
UELtvp+JfwI7XDGVwSxZXA: folds
vkfxu8f/jMYKUk6Ly4eujw collected $6 from pot
vkfxu8f/jMYKUk6Ly4eujw: doesn't show hand
*** SUMMARY ***
Total pot $6 | Rake $0
Seat 1: UELtvp+JfwI7XDGVwSxZXA (button) folded before Flop
Seat 2: vkfxu8f/jMYKUk6Ly4eujw (small blind) collected ($6)
Seat 3: 9dpyyjDTCed6nV7JhaUUpw (big blind) folded before Flop
Seat 4: YsLQ3BAvgQHWXMAv3Wv6Hg folded before Flop (didn't bet)
Seat 5: VvdR9F3I+2yELkfTVvC1dg folded before Flop (didn't bet)
Seat 6: vkoJRf3gidxY1pPi0AFWww folded before Flop (didn't bet)



PokerStars Game #59941253958:  Hold'em No Limit ($1/$2) - 2009/07/01 1:30:04 ET
Table 'LL4bDFyhj5hsMpzaDugJZg' 6-max Seat #1 is the button
Seat 1: FwvID/fQGlpY3soi/lMTww ($69.50 in chips)
Seat 3: iI/NMpRxMkGieArQEhACSA ($535.50 in chips)
Seat 4: 8srN1dKQePlsv0GyTada+Q ($227.40 in chips)
Seat 5: A2GTwTiwkb1ilNWgW487Vg ($115.80 in chips)
Seat 6: 692Q4sfB0gTElzS0WMeg+A ($209.10 in chips)
IZng3w8jiJHHp3LbYKLi4w will be allowed to play after the button
iI/NMpRxMkGieArQEhACSA: posts small blind $1
8srN1dKQePlsv0GyTada+Q: posts big blind $2
*** HOLE CARDS ***
A2GTwTiwkb1ilNWgW487Vg: folds
FwvID/fQGlpY3soi/lMTww said, "push nex 1"
692Q4sfB0gTElzS0WMeg+A: raises $4 to $6
FwvID/fQGlpY3soi/lMTww: folds
iI/NMpRxMkGieArQEhACSA: folds
8srN1dKQePlsv0GyTada+Q: folds
692Q4sfB0gTElzS0WMeg+A collected $5 from pot
*** SUMMARY ***
Total pot $5 | Rake $0
Seat 1: FwvID/fQGlpY3soi/lMTww (button) folded before Flop (didn't bet)
Seat 3: iI/NMpRxMkGieArQEhACSA (small blind) folded before Flop
Seat 4: 8srN1dKQePlsv0GyTada+Q (big blind) folded before Flop
Seat 5: A2GTwTiwkb1ilNWgW487Vg folded before Flop (didn't bet)
Seat 6: 692Q4sfB0gTElzS0WMeg+A collected ($5)



PokerStars Game #59941255610:  Hold'em No Limit ($1/$2) - 2009/07/01 1:30:07 ET
Table 'CFkQcfWjKccZaZDf71FK+w' 6-max Seat #6 is the button
Seat 2: ewN/vzF22+/gdzjIKBOlkA ($208.80 in chips)
Seat 3: 09BNF4quPDzanQzM8vc6WA ($45.45 in chips)
Seat 4: ygTTt5ehT4aF86q1a8/R+w ($254.25 in chips)
Seat 5: 2lOU1DcvUZaMcxZ95XfzXw ($142.15 in chips)
Seat 6: ORVqY3rf9X6ANA/8s+On2Q ($122.60 in chips)
vkfxu8f/jMYKUk6Ly4eujw will be allowed to play after the button
ewN/vzF22+/gdzjIKBOlkA: posts small blind $1
09BNF4quPDzanQzM8vc6WA: posts big blind $2
*** HOLE CARDS ***
ygTTt5ehT4aF86q1a8/R+w: folds
2lOU1DcvUZaMcxZ95XfzXw: folds
ORVqY3rf9X6ANA/8s+On2Q: calls $2
ewN/vzF22+/gdzjIKBOlkA: folds
09BNF4quPDzanQzM8vc6WA: checks
*** FLOP *** [9d 7s 2d]
09BNF4quPDzanQzM8vc6WA: bets $2
ORVqY3rf9X6ANA/8s+On2Q: calls $2
*** TURN *** [9d 7s 2d] [Ts]
09BNF4quPDzanQzM8vc6WA: bets $4
ORVqY3rf9X6ANA/8s+On2Q: calls $4
*** RIVER *** [9d 7s 2d Ts] [Qh]
09BNF4quPDzanQzM8vc6WA: checks
ORVqY3rf9X6ANA/8s+On2Q: checks
*** SHOW DOWN ***
09BNF4quPDzanQzM8vc6WA: shows [4d 9h] (a pair of Nines)
ORVqY3rf9X6ANA/8s+On2Q: mucks hand
09BNF4quPDzanQzM8vc6WA collected $16.20 from pot
*** SUMMARY ***
Total pot $17 | Rake $0.80
Board [9d 7s 2d Ts Qh]
Seat 2: ewN/vzF22+/gdzjIKBOlkA (small blind) folded before Flop
Seat 3: 09BNF4quPDzanQzM8vc6WA (big blind) showed [4d 9h] and won ($16.20) with a pair of Nines
Seat 4: ygTTt5ehT4aF86q1a8/R+w folded before Flop (didn't bet)
Seat 5: 2lOU1DcvUZaMcxZ95XfzXw folded before Flop (didn't bet)
Seat 6: ORVqY3rf9X6ANA/8s+On2Q (button) mucked



PokerStars Game #59941255570:  Hold'em No Limit ($1/$2) - 2009/07/01 1:30:07 ET
Table 'QxerF7GUfCbl+4a8XaTB2w' 6-max Seat #6 is the button
Seat 1: 54yWzRRgS0oZ+S6LwZBxMQ ($30 in chips)
Seat 2: HiWSAXs6/0w9Jy7ioiiShQ ($35.65 in chips)
Seat 3: m7mYVfnCOK5TE/VkN/FhOg ($275.75 in chips)
Seat 4: 09BNF4quPDzanQzM8vc6WA ($57.50 in chips)
Seat 5: gnYme0DNFflnMhrdbxe1Ag ($241.70 in chips)
Seat 6: VvdR9F3I+2yELkfTVvC1dg ($200 in chips)
54yWzRRgS0oZ+S6LwZBxMQ: posts small blind $1
HiWSAXs6/0w9Jy7ioiiShQ: posts big blind $2
*** HOLE CARDS ***
m7mYVfnCOK5TE/VkN/FhOg: folds
09BNF4quPDzanQzM8vc6WA: folds
gnYme0DNFflnMhrdbxe1Ag: folds
VvdR9F3I+2yELkfTVvC1dg: raises $2 to $4
54yWzRRgS0oZ+S6LwZBxMQ: calls $3
HiWSAXs6/0w9Jy7ioiiShQ: calls $2
*** FLOP *** [3h 6h Kd]
54yWzRRgS0oZ+S6LwZBxMQ: checks
HiWSAXs6/0w9Jy7ioiiShQ: checks
VvdR9F3I+2yELkfTVvC1dg: checks
*** TURN *** [3h 6h Kd] [4c]
54yWzRRgS0oZ+S6LwZBxMQ: bets $8
HiWSAXs6/0w9Jy7ioiiShQ: calls $8
VvdR9F3I+2yELkfTVvC1dg: folds
*** RIVER *** [3h 6h Kd 4c] [Kc]
54yWzRRgS0oZ+S6LwZBxMQ: bets $18 and is all-in
HiWSAXs6/0w9Jy7ioiiShQ: calls $18
*** SHOW DOWN ***
54yWzRRgS0oZ+S6LwZBxMQ: shows [Qs Kh] (three of a kind, Kings)
HiWSAXs6/0w9Jy7ioiiShQ: mucks hand
54yWzRRgS0oZ+S6LwZBxMQ collected $61 from pot
*** SUMMARY ***
Total pot $64 | Rake $3
Board [3h 6h Kd 4c Kc]
Seat 1: 54yWzRRgS0oZ+S6LwZBxMQ (small blind) showed [Qs Kh] and won ($61) with three of a kind, Kings
Seat 2: HiWSAXs6/0w9Jy7ioiiShQ (big blind) mucked
Seat 3: m7mYVfnCOK5TE/VkN/FhOg folded before Flop (didn't bet)
Seat 4: 09BNF4quPDzanQzM8vc6WA folded before Flop (didn't bet)
Seat 5: gnYme0DNFflnMhrdbxe1Ag folded before Flop (didn't bet)
Seat 6: VvdR9F3I+2yELkfTVvC1dg (button) folded on the Turn



PokerStars Game #59941256702:  Hold'em No Limit ($1/$2) - 2009/07/01 1:30:09 ET
Table 'ztv6V3FN2bQ9nmJPPdx6nQ' 6-max Seat #3 is the button
Seat 1: 6fLdOUCRtX71xbVRhJEq8w ($227 in chips)
Seat 2: 5Y+ZGWLI4gnlpApDX5vy1A ($389.75 in chips)
Seat 3: ubtx4Z5L+AcK71MTvYiGVw ($242 in chips)
Seat 6: mfy7uGZcqA2PVQqEVbJ7+g ($114.45 in chips)
mfy7uGZcqA2PVQqEVbJ7+g: posts small blind $1
6fLdOUCRtX71xbVRhJEq8w: posts big blind $2
*** HOLE CARDS ***
5Y+ZGWLI4gnlpApDX5vy1A: folds
ubtx4Z5L+AcK71MTvYiGVw: folds
mfy7uGZcqA2PVQqEVbJ7+g: raises $5 to $7
6fLdOUCRtX71xbVRhJEq8w: calls $5
*** FLOP *** [Qh Tc 4c]
mfy7uGZcqA2PVQqEVbJ7+g: checks
6fLdOUCRtX71xbVRhJEq8w: checks
*** TURN *** [Qh Tc 4c] [Qc]
mfy7uGZcqA2PVQqEVbJ7+g: checks
6fLdOUCRtX71xbVRhJEq8w: bets $10
mfy7uGZcqA2PVQqEVbJ7+g: calls $10
*** RIVER *** [Qh Tc 4c Qc] [9h]
mfy7uGZcqA2PVQqEVbJ7+g: checks
6fLdOUCRtX71xbVRhJEq8w: checks
*** SHOW DOWN ***
mfy7uGZcqA2PVQqEVbJ7+g: shows [3c 3h] (two pair, Queens and Threes)
6fLdOUCRtX71xbVRhJEq8w: shows [Kh Td] (two pair, Queens and Tens)
6fLdOUCRtX71xbVRhJEq8w collected $32.35 from pot
*** SUMMARY ***
Total pot $34 | Rake $1.65
Board [Qh Tc 4c Qc 9h]
Seat 1: 6fLdOUCRtX71xbVRhJEq8w (big blind) showed [Kh Td] and won ($32.35) with two pair, Queens and Tens
Seat 2: 5Y+ZGWLI4gnlpApDX5vy1A folded before Flop (didn't bet)
Seat 3: ubtx4Z5L+AcK71MTvYiGVw (button) folded before Flop (didn't bet)
Seat 6: mfy7uGZcqA2PVQqEVbJ7+g (small blind) showed [3c 3h] and lost with two pair, Queens and Threes



PokerStars Game #59941256668:  Hold'em No Limit ($1/$2) - 2009/07/01 1:30:09 ET
Table 'jlrIxbrVIG+gjaUYT4za8g' 6-max Seat #3 is the button
Seat 1: ygTTt5ehT4aF86q1a8/R+w ($258.30 in chips)
Seat 3: gnYme0DNFflnMhrdbxe1Ag ($201.75 in chips)
Seat 4: 8srN1dKQePlsv0GyTada+Q ($222.55 in chips)
Seat 5: AyBB0k3Dcl7xbXUeGMw06g ($72.90 in chips)
Seat 6: vkfxu8f/jMYKUk6Ly4eujw ($309 in chips)
8srN1dKQePlsv0GyTada+Q: posts small blind $1
AyBB0k3Dcl7xbXUeGMw06g: posts big blind $2
/PH6Ffnho4Ysm8S3V/oa+w: sits out
*** HOLE CARDS ***
vkfxu8f/jMYKUk6Ly4eujw: folds
ygTTt5ehT4aF86q1a8/R+w: folds
gnYme0DNFflnMhrdbxe1Ag: folds
8srN1dKQePlsv0GyTada+Q: calls $1
AyBB0k3Dcl7xbXUeGMw06g: raises $4 to $6
8srN1dKQePlsv0GyTada+Q: folds
AyBB0k3Dcl7xbXUeGMw06g collected $4 from pot
*** SUMMARY ***
Total pot $4 | Rake $0
Seat 1: ygTTt5ehT4aF86q1a8/R+w folded before Flop (didn't bet)
Seat 3: gnYme0DNFflnMhrdbxe1Ag (button) folded before Flop (didn't bet)
Seat 4: 8srN1dKQePlsv0GyTada+Q (small blind) folded before Flop
Seat 5: AyBB0k3Dcl7xbXUeGMw06g (big blind) collected ($4)
Seat 6: vkfxu8f/jMYKUk6Ly4eujw folded before Flop (didn't bet)



PokerStars Game #59941257286:  Hold'em No Limit ($1/$2) - 2009/07/01 1:30:10 ET
Table 'mGpP9StWRnoeiBDExc6Frg' 6-max Seat #3 is the button
Seat 1: VvdR9F3I+2yELkfTVvC1dg ($309.05 in chips)
Seat 2: vkfxu8f/jMYKUk6Ly4eujw ($200 in chips)
Seat 3: 7acrZUQC3Zc9BNLjoKIcLQ ($36.05 in chips)
Seat 4: 4dcDwIHRm96PwtqkpQiuiA ($80.70 in chips)
Seat 5: d1puGuVBE0fidn+5eRJ0tw ($176.95 in chips)
Seat 6: B2Ih1sr5VZk+8He7rcrMtQ ($438.05 in chips)
4dcDwIHRm96PwtqkpQiuiA: posts small blind $1
d1puGuVBE0fidn+5eRJ0tw: posts big blind $2
*** HOLE CARDS ***
B2Ih1sr5VZk+8He7rcrMtQ: folds
VvdR9F3I+2yELkfTVvC1dg: folds
vkfxu8f/jMYKUk6Ly4eujw: folds
7acrZUQC3Zc9BNLjoKIcLQ: raises $4 to $6
4dcDwIHRm96PwtqkpQiuiA: folds
d1puGuVBE0fidn+5eRJ0tw: calls $4
*** FLOP *** [5s Jc 2c]
d1puGuVBE0fidn+5eRJ0tw: checks
7acrZUQC3Zc9BNLjoKIcLQ: bets $8
d1puGuVBE0fidn+5eRJ0tw: folds
7acrZUQC3Zc9BNLjoKIcLQ collected $12.35 from pot
*** SUMMARY ***
Total pot $13 | Rake $0.65
Board [5s Jc 2c]
Seat 1: VvdR9F3I+2yELkfTVvC1dg folded before Flop (didn't bet)
Seat 2: vkfxu8f/jMYKUk6Ly4eujw folded before Flop (didn't bet)
Seat 3: 7acrZUQC3Zc9BNLjoKIcLQ (button) collected ($12.35)
Seat 4: 4dcDwIHRm96PwtqkpQiuiA (small blind) folded before Flop
Seat 5: d1puGuVBE0fidn+5eRJ0tw (big blind) folded on the Flop
Seat 6: B2Ih1sr5VZk+8He7rcrMtQ folded before Flop (didn't bet)



PokerStars Game #59941258468:  Hold'em No Limit ($1/$2) - 2009/07/01 1:30:12 ET
Table 'AtOXMvcrtQM8yLNcALmfLQ' 2-max Seat #2 is the button
Seat 1: +HlQuAsMqZGYYtjcPO/a3A ($269.10 in chips)
Seat 2: pVqEzK9wXlRMECnb1Zg4Zw ($209.30 in chips)
pVqEzK9wXlRMECnb1Zg4Zw: posts small blind $1
+HlQuAsMqZGYYtjcPO/a3A: posts big blind $2
*** HOLE CARDS ***
pVqEzK9wXlRMECnb1Zg4Zw: raises $6 to $8
+HlQuAsMqZGYYtjcPO/a3A: folds
pVqEzK9wXlRMECnb1Zg4Zw collected $4 from pot
pVqEzK9wXlRMECnb1Zg4Zw: doesn't show hand
*** SUMMARY ***
Total pot $4 | Rake $0
Seat 1: +HlQuAsMqZGYYtjcPO/a3A (big blind) folded before Flop
Seat 2: pVqEzK9wXlRMECnb1Zg4Zw (button) (small blind) collected ($4)



PokerStars Game #59941258706:  Hold'em No Limit ($1/$2) - 2009/07/01 1:30:13 ET
Table 'uJ9juaXXg9yIcSU8amxaXQ' 6-max Seat #3 is the button
Seat 1: JsqOjN/eHz0uYVf/PyUJ6Q ($144.50 in chips)
Seat 2: VvdR9F3I+2yELkfTVvC1dg ($229.10 in chips)
Seat 3: qXDd0ZyMIse0OBu8pxeQ3Q ($247.40 in chips)
Seat 4: zNjJ/y4emmF+vzrCDd+ooA ($231.05 in chips)
Seat 5: YsLQ3BAvgQHWXMAv3Wv6Hg ($200 in chips)
Seat 6: 2DFp9Veq1xxq64dCjwNuUw ($57.60 in chips)
zNjJ/y4emmF+vzrCDd+ooA: posts small blind $1
YsLQ3BAvgQHWXMAv3Wv6Hg: posts big blind $2
*** HOLE CARDS ***
2DFp9Veq1xxq64dCjwNuUw: raises $2 to $4
JsqOjN/eHz0uYVf/PyUJ6Q: folds
VvdR9F3I+2yELkfTVvC1dg: folds
qXDd0ZyMIse0OBu8pxeQ3Q: folds
zNjJ/y4emmF+vzrCDd+ooA: calls $3
YsLQ3BAvgQHWXMAv3Wv6Hg: folds
*** FLOP *** [4s 9s Th]
zNjJ/y4emmF+vzrCDd+ooA: checks
2DFp9Veq1xxq64dCjwNuUw: checks
*** TURN *** [4s 9s Th] [2d]
zNjJ/y4emmF+vzrCDd+ooA: bets $6
2DFp9Veq1xxq64dCjwNuUw: folds
zNjJ/y4emmF+vzrCDd+ooA collected $9.50 from pot
*** SUMMARY ***
Total pot $10 | Rake $0.50
Board [4s 9s Th 2d]
Seat 1: JsqOjN/eHz0uYVf/PyUJ6Q folded before Flop (didn't bet)
Seat 2: VvdR9F3I+2yELkfTVvC1dg folded before Flop (didn't bet)
Seat 3: qXDd0ZyMIse0OBu8pxeQ3Q (button) folded before Flop (didn't bet)
Seat 4: zNjJ/y4emmF+vzrCDd+ooA (small blind) collected ($9.50)
Seat 5: YsLQ3BAvgQHWXMAv3Wv6Hg (big blind) folded before Flop
Seat 6: 2DFp9Veq1xxq64dCjwNuUw folded on the Turn



PokerStars Game #59941259300:  Hold'em No Limit ($1/$2) - 2009/07/01 1:30:14 ET
Table 'gnHBqWll9O3fxG7Ojkz/ng' 9-max Seat #5 is the button
Seat 1: TAfo4veNRaRlzDXMMYS3Jg ($34 in chips)
Seat 2: H6Z4+qu8gR0VUiPOijndVg ($324.25 in chips)
Seat 3: 5Q8U6iZbeO7xJSS4qvDP5g ($211 in chips)
Seat 4: nXDI8Y/S6POzRwANu3d8hQ ($39 in chips)
Seat 5: rBQDMkKm9cZn6M9NPsiVew ($223.45 in chips)
Seat 7: jqui3xAWCkcdPW36a6BD+w ($342.95 in chips)
Seat 8: cM6efHzdxoqYm0EQKP4TTQ ($98.15 in chips)
Seat 9: GX1heJ+DSsvm7gzSPsYhhQ ($54.35 in chips)
MeleaB will be allowed to play after the button
jqui3xAWCkcdPW36a6BD+w: posts small blind $1
cM6efHzdxoqYm0EQKP4TTQ: posts big blind $2
*** HOLE CARDS ***
GX1heJ+DSsvm7gzSPsYhhQ: folds
TAfo4veNRaRlzDXMMYS3Jg: folds
H6Z4+qu8gR0VUiPOijndVg: raises $6 to $8
5Q8U6iZbeO7xJSS4qvDP5g: folds
nXDI8Y/S6POzRwANu3d8hQ: folds
rBQDMkKm9cZn6M9NPsiVew: folds
jqui3xAWCkcdPW36a6BD+w: folds
cM6efHzdxoqYm0EQKP4TTQ: folds
H6Z4+qu8gR0VUiPOijndVg collected $5 from pot
H6Z4+qu8gR0VUiPOijndVg: doesn't show hand
*** SUMMARY ***
Total pot $5 | Rake $0
Seat 1: TAfo4veNRaRlzDXMMYS3Jg folded before Flop (didn't bet)
Seat 2: H6Z4+qu8gR0VUiPOijndVg collected ($5)
Seat 3: 5Q8U6iZbeO7xJSS4qvDP5g folded before Flop (didn't bet)
Seat 4: nXDI8Y/S6POzRwANu3d8hQ folded before Flop (didn't bet)
Seat 5: rBQDMkKm9cZn6M9NPsiVew (button) folded before Flop (didn't bet)
Seat 7: jqui3xAWCkcdPW36a6BD+w (small blind) folded before Flop
Seat 8: cM6efHzdxoqYm0EQKP4TTQ (big blind) folded before Flop
Seat 9: GX1heJ+DSsvm7gzSPsYhhQ folded before Flop (didn't bet)



PokerStars Game #59941260082:  Hold'em No Limit ($1/$2) - 2009/07/01 1:30:15 ET
Table 'on4i1U1lCRmxsduFD3xiSg' 9-max Seat #4 is the button
Seat 1: so5k3vFDmokh2q3dImJ1GQ ($179.30 in chips)
Seat 2: NqSvZNzJ4RkR3sCmgQnyLw ($6.60 in chips)
Seat 3: GX1heJ+DSsvm7gzSPsYhhQ ($37.70 in chips)
Seat 4: DFQVuszLVclqjA46pN4Vvw ($53 in chips)
Seat 5: 37j/5DgMG5m9lMfFofEAOg ($83.35 in chips)
Seat 6: +T/63sAeZzWyHchahJ36GQ ($40 in chips)
Seat 7: /inIs/z/PcX+TniIFpaxpg ($302.40 in chips)
Seat 9: iMe5yhc+1BaiIPHet3NMrA ($208.25 in chips)
37j/5DgMG5m9lMfFofEAOg: posts small blind $1
+T/63sAeZzWyHchahJ36GQ: posts big blind $2
ZYHoLw2lWmRS7CSHi8L8Xg: sits out
*** HOLE CARDS ***
/inIs/z/PcX+TniIFpaxpg: folds
iMe5yhc+1BaiIPHet3NMrA: folds
so5k3vFDmokh2q3dImJ1GQ: folds
NqSvZNzJ4RkR3sCmgQnyLw: raises $4.60 to $6.60 and is all-in
GX1heJ+DSsvm7gzSPsYhhQ: folds
DFQVuszLVclqjA46pN4Vvw: folds
37j/5DgMG5m9lMfFofEAOg: folds
+T/63sAeZzWyHchahJ36GQ: folds
NqSvZNzJ4RkR3sCmgQnyLw collected $5 from pot
*** SUMMARY ***
Total pot $5 | Rake $0
Seat 1: so5k3vFDmokh2q3dImJ1GQ folded before Flop (didn't bet)
Seat 2: NqSvZNzJ4RkR3sCmgQnyLw collected ($5)
Seat 3: GX1heJ+DSsvm7gzSPsYhhQ folded before Flop (didn't bet)
Seat 4: DFQVuszLVclqjA46pN4Vvw (button) folded before Flop (didn't bet)
Seat 5: 37j/5DgMG5m9lMfFofEAOg (small blind) folded before Flop
Seat 6: +T/63sAeZzWyHchahJ36GQ (big blind) folded before Flop
Seat 7: /inIs/z/PcX+TniIFpaxpg folded before Flop (didn't bet)
Seat 9: iMe5yhc+1BaiIPHet3NMrA folded before Flop (didn't bet)



PokerStars Game #59941260384:  Hold'em No Limit ($1/$2) - 2009/07/01 1:30:16 ET
Table '8Y6PEyoNuepZTai2Q56aHw' 9-max Seat #9 is the button
Seat 1: 5Q8U6iZbeO7xJSS4qvDP5g ($312.80 in chips)
Seat 2: gDCJIAlovbPnTvMM7Dd1gA ($164.85 in chips)
Seat 3: WUlHm+ydPPHG7Lb0rePSdA ($217.10 in chips)
Seat 4: xKkwALG38OfLQ9DXuJgR1w ($247.25 in chips)
Seat 6: NtLDBSjsJQEKekh5cdinvw ($377.35 in chips)
Seat 7: Kzta8yu9vxHT4B70mjBZ+w ($200.30 in chips)
Seat 8: rW/MyplHylMSBRaoRUzWrg ($36 in chips)
Seat 9: F7m34OOfAQ7annesMHVjKw ($194 in chips)
5Q8U6iZbeO7xJSS4qvDP5g: posts small blind $1
gDCJIAlovbPnTvMM7Dd1gA: posts big blind $2
*** HOLE CARDS ***
WUlHm+ydPPHG7Lb0rePSdA: folds
xKkwALG38OfLQ9DXuJgR1w: folds
NtLDBSjsJQEKekh5cdinvw: folds
Kzta8yu9vxHT4B70mjBZ+w: folds
rW/MyplHylMSBRaoRUzWrg: folds
F7m34OOfAQ7annesMHVjKw: raises $4 to $6
5Q8U6iZbeO7xJSS4qvDP5g: folds
gDCJIAlovbPnTvMM7Dd1gA: folds
F7m34OOfAQ7annesMHVjKw collected $5 from pot
*** SUMMARY ***
Total pot $5 | Rake $0
Seat 1: 5Q8U6iZbeO7xJSS4qvDP5g (small blind) folded before Flop
Seat 2: gDCJIAlovbPnTvMM7Dd1gA (big blind) folded before Flop
Seat 3: WUlHm+ydPPHG7Lb0rePSdA folded before Flop (didn't bet)
Seat 4: xKkwALG38OfLQ9DXuJgR1w folded before Flop (didn't bet)
Seat 6: NtLDBSjsJQEKekh5cdinvw folded before Flop (didn't bet)
Seat 7: Kzta8yu9vxHT4B70mjBZ+w folded before Flop (didn't bet)
Seat 8: rW/MyplHylMSBRaoRUzWrg folded before Flop (didn't bet)
Seat 9: F7m34OOfAQ7annesMHVjKw (button) collected ($5)



PokerStars Game #59941260298:  Hold'em No Limit ($1/$2) - 2009/07/01 1:30:16 ET
Table 'pPQgcj9XT9CHBsbo1WTBug' 6-max Seat #3 is the button
Seat 1: DFVYDA6dKQy7R7mGIKogZA ($155.20 in chips)
Seat 2: qXDd0ZyMIse0OBu8pxeQ3Q ($200 in chips)
Seat 3: 54yWzRRgS0oZ+S6LwZBxMQ ($54.50 in chips)
Seat 4: gqlysXCbT8V54f/1lf9h3A ($43.45 in chips)
Seat 5: vkfxu8f/jMYKUk6Ly4eujw ($193.55 in chips)
Seat 6: Yr7pZltpy3IUNdKS9PCEiw ($301.30 in chips)
gqlysXCbT8V54f/1lf9h3A: posts small blind $1
vkfxu8f/jMYKUk6Ly4eujw: posts big blind $2
*** HOLE CARDS ***
Yr7pZltpy3IUNdKS9PCEiw: folds
DFVYDA6dKQy7R7mGIKogZA: calls $2
qXDd0ZyMIse0OBu8pxeQ3Q: raises $8 to $10
54yWzRRgS0oZ+S6LwZBxMQ: folds
gqlysXCbT8V54f/1lf9h3A: calls $9
vkfxu8f/jMYKUk6Ly4eujw: folds
DFVYDA6dKQy7R7mGIKogZA: folds
*** FLOP *** [Js 7s 8h]
gqlysXCbT8V54f/1lf9h3A: checks
qXDd0ZyMIse0OBu8pxeQ3Q: checks
*** TURN *** [Js 7s 8h] [Kc]
gqlysXCbT8V54f/1lf9h3A: checks
qXDd0ZyMIse0OBu8pxeQ3Q: bets $16
gqlysXCbT8V54f/1lf9h3A: raises $16 to $32
qXDd0ZyMIse0OBu8pxeQ3Q: folds
gqlysXCbT8V54f/1lf9h3A collected $53.30 from pot
gqlysXCbT8V54f/1lf9h3A: doesn't show hand
*** SUMMARY ***
Total pot $56 | Rake $2.70
Board [Js 7s 8h Kc]
Seat 1: DFVYDA6dKQy7R7mGIKogZA folded before Flop
Seat 2: qXDd0ZyMIse0OBu8pxeQ3Q folded on the Turn
Seat 3: 54yWzRRgS0oZ+S6LwZBxMQ (button) folded before Flop (didn't bet)
Seat 4: gqlysXCbT8V54f/1lf9h3A (small blind) collected ($53.30)
Seat 5: vkfxu8f/jMYKUk6Ly4eujw (big blind) folded before Flop
Seat 6: Yr7pZltpy3IUNdKS9PCEiw folded before Flop (didn't bet)



PokerStars Game #59941261464:  Hold'em No Limit ($1/$2) - 2009/07/01 1:30:18 ET
Table 'YqGfR5eHfMeSjb9a+QU9rg' 9-max Seat #3 is the button
Seat 1: rW/MyplHylMSBRaoRUzWrg ($34 in chips)
Seat 2: W3Nqt1GWlTi9tXQXMNEvgw ($401.85 in chips)
Seat 3: /gll27k+xWYV7Fbki0lFDQ ($258.75 in chips)
Seat 4: GX1heJ+DSsvm7gzSPsYhhQ ($38 in chips)
Seat 5: CkE3IyJF1KvdaAOmZY5XqQ ($203 in chips)
Seat 6: TAfo4veNRaRlzDXMMYS3Jg ($37 in chips)
Seat 7: 41aZuLBz9nAi2GPVKabmCw ($95.45 in chips)
Seat 8: JnV3SM2D6dAFYyGZHHpvrg ($93.25 in chips)
Seat 9: /inIs/z/PcX+TniIFpaxpg ($205.20 in chips)
GX1heJ+DSsvm7gzSPsYhhQ: posts small blind $1
CkE3IyJF1KvdaAOmZY5XqQ: posts big blind $2
*** HOLE CARDS ***
TAfo4veNRaRlzDXMMYS3Jg: folds
41aZuLBz9nAi2GPVKabmCw: calls $2
JnV3SM2D6dAFYyGZHHpvrg: folds
/inIs/z/PcX+TniIFpaxpg: folds
rW/MyplHylMSBRaoRUzWrg: folds
W3Nqt1GWlTi9tXQXMNEvgw: folds
/gll27k+xWYV7Fbki0lFDQ: folds
GX1heJ+DSsvm7gzSPsYhhQ: folds
CkE3IyJF1KvdaAOmZY5XqQ: checks
*** FLOP *** [8s Jc Ah]
CkE3IyJF1KvdaAOmZY5XqQ: checks
41aZuLBz9nAi2GPVKabmCw: bets $4
CkE3IyJF1KvdaAOmZY5XqQ: folds
41aZuLBz9nAi2GPVKabmCw collected $4.75 from pot
*** SUMMARY ***
Total pot $5 | Rake $0.25
Board [8s Jc Ah]
Seat 1: rW/MyplHylMSBRaoRUzWrg folded before Flop (didn't bet)
Seat 2: W3Nqt1GWlTi9tXQXMNEvgw folded before Flop (didn't bet)
Seat 3: /gll27k+xWYV7Fbki0lFDQ (button) folded before Flop (didn't bet)
Seat 4: GX1heJ+DSsvm7gzSPsYhhQ (small blind) folded before Flop
Seat 5: CkE3IyJF1KvdaAOmZY5XqQ (big blind) folded on the Flop
Seat 6: TAfo4veNRaRlzDXMMYS3Jg folded before Flop (didn't bet)
Seat 7: 41aZuLBz9nAi2GPVKabmCw collected ($4.75)
Seat 8: JnV3SM2D6dAFYyGZHHpvrg folded before Flop (didn't bet)
Seat 9: /inIs/z/PcX+TniIFpaxpg folded before Flop (didn't bet)



PokerStars Game #59941263130:  Hold'em No Limit ($1/$2) - 2009/07/01 1:30:21 ET
Table 'eyAQSIlgc2o1Jxvbve4WGg' 9-max Seat #7 is the button
Seat 1: UZEsV9yKUMqmpYPiOFpaZw ($105.20 in chips)
Seat 2: g7gL2NLJCdZPPV399WKT1w ($64.25 in chips)
Seat 4: CkE3IyJF1KvdaAOmZY5XqQ ($200 in chips)
Seat 5: mIKx5lhIt13X5eZQH0ZeMA ($117.80 in chips)
Seat 6: nXDI8Y/S6POzRwANu3d8hQ ($6 in chips)
Seat 7: u3OrI5uGx9mx1fE7dgr+EA ($77.20 in chips)
Seat 8: 1CtiZuXDFaJL1dJPQKyi8Q ($156.35 in chips)
Seat 9: WUlHm+ydPPHG7Lb0rePSdA ($128.95 in chips)
1CtiZuXDFaJL1dJPQKyi8Q: posts small blind $1
WUlHm+ydPPHG7Lb0rePSdA: posts big blind $2
*** HOLE CARDS ***
UZEsV9yKUMqmpYPiOFpaZw: folds
g7gL2NLJCdZPPV399WKT1w: folds
CkE3IyJF1KvdaAOmZY5XqQ: folds
mIKx5lhIt13X5eZQH0ZeMA: calls $2
nXDI8Y/S6POzRwANu3d8hQ: folds
u3OrI5uGx9mx1fE7dgr+EA: calls $2
1CtiZuXDFaJL1dJPQKyi8Q: calls $1
WUlHm+ydPPHG7Lb0rePSdA: checks
*** FLOP *** [7d 2c Th]
1CtiZuXDFaJL1dJPQKyi8Q: bets $4
WUlHm+ydPPHG7Lb0rePSdA: folds
mIKx5lhIt13X5eZQH0ZeMA: folds
u3OrI5uGx9mx1fE7dgr+EA is disconnected
u3OrI5uGx9mx1fE7dgr+EA is connected
u3OrI5uGx9mx1fE7dgr+EA: folds
1CtiZuXDFaJL1dJPQKyi8Q collected $7.60 from pot
1CtiZuXDFaJL1dJPQKyi8Q: doesn't show hand
*** SUMMARY ***
Total pot $8 | Rake $0.40
Board [7d 2c Th]
Seat 1: UZEsV9yKUMqmpYPiOFpaZw folded before Flop (didn't bet)
Seat 2: g7gL2NLJCdZPPV399WKT1w folded before Flop (didn't bet)
Seat 4: CkE3IyJF1KvdaAOmZY5XqQ folded before Flop (didn't bet)
Seat 5: mIKx5lhIt13X5eZQH0ZeMA folded on the Flop
Seat 6: nXDI8Y/S6POzRwANu3d8hQ folded before Flop (didn't bet)
Seat 7: u3OrI5uGx9mx1fE7dgr+EA (button) folded on the Flop
Seat 8: 1CtiZuXDFaJL1dJPQKyi8Q (small blind) collected ($7.60)
Seat 9: WUlHm+ydPPHG7Lb0rePSdA (big blind) folded on the Flop



PokerStars Game #59941263418:  Hold'em No Limit ($1/$2) - 2009/07/01 1:30:21 ET
Table 'kq5zaQ+1hLNf8LZfGnbTAA' 6-max Seat #2 is the button
Seat 1: 8srN1dKQePlsv0GyTada+Q ($405 in chips)
Seat 2: nXDI8Y/S6POzRwANu3d8hQ ($187 in chips)
Seat 3: vkfxu8f/jMYKUk6Ly4eujw ($226.95 in chips)
Seat 4: 3dAbvkxS5NPQTBAbvpinVg ($278.45 in chips)
Seat 6: mfy7uGZcqA2PVQqEVbJ7+g ($194.25 in chips)
vkfxu8f/jMYKUk6Ly4eujw: posts small blind $1
3dAbvkxS5NPQTBAbvpinVg: posts big blind $2
gnYme0DNFflnMhrdbxe1Ag: sits out
*** HOLE CARDS ***
mfy7uGZcqA2PVQqEVbJ7+g: folds
8srN1dKQePlsv0GyTada+Q: folds
nXDI8Y/S6POzRwANu3d8hQ: folds
vkfxu8f/jMYKUk6Ly4eujw: folds
3dAbvkxS5NPQTBAbvpinVg collected $2 from pot
3dAbvkxS5NPQTBAbvpinVg: doesn't show hand
*** SUMMARY ***
Total pot $2 | Rake $0
Seat 1: 8srN1dKQePlsv0GyTada+Q folded before Flop (didn't bet)
Seat 2: nXDI8Y/S6POzRwANu3d8hQ (button) folded before Flop (didn't bet)
Seat 3: vkfxu8f/jMYKUk6Ly4eujw (small blind) folded before Flop
Seat 4: 3dAbvkxS5NPQTBAbvpinVg (big blind) collected ($2)
Seat 6: mfy7uGZcqA2PVQqEVbJ7+g folded before Flop (didn't bet)



PokerStars Game #59941263136:  Hold'em No Limit ($1/$2) - 2009/07/01 1:30:21 ET
Table 'NmY84NAf9Mh0ckAckHnh5g' 2-max Seat #1 is the button
Seat 1: 6hvg964TSqZ3AL/0XK9aVQ ($321.40 in chips)
Seat 2: RwDoM55ZeQuI2ADyJhOb2Q ($678.70 in chips)
6hvg964TSqZ3AL/0XK9aVQ: posts small blind $1
RwDoM55ZeQuI2ADyJhOb2Q: posts big blind $2
*** HOLE CARDS ***
6hvg964TSqZ3AL/0XK9aVQ: calls $1
RwDoM55ZeQuI2ADyJhOb2Q: checks
*** FLOP *** [3d As Ad]
RwDoM55ZeQuI2ADyJhOb2Q: checks
6hvg964TSqZ3AL/0XK9aVQ: checks
*** TURN *** [3d As Ad] [Kh]
RwDoM55ZeQuI2ADyJhOb2Q: checks
6hvg964TSqZ3AL/0XK9aVQ: bets $4
RwDoM55ZeQuI2ADyJhOb2Q: calls $4
*** RIVER *** [3d As Ad Kh] [4c]
RwDoM55ZeQuI2ADyJhOb2Q: checks
6hvg964TSqZ3AL/0XK9aVQ: bets $10
RwDoM55ZeQuI2ADyJhOb2Q: calls $10
*** SHOW DOWN ***
6hvg964TSqZ3AL/0XK9aVQ: shows [6d 6h] (two pair, Aces and Sixes)
RwDoM55ZeQuI2ADyJhOb2Q: mucks hand
6hvg964TSqZ3AL/0XK9aVQ collected $31.50 from pot
*** SUMMARY ***
Total pot $32 | Rake $0.50
Board [3d As Ad Kh 4c]
Seat 1: 6hvg964TSqZ3AL/0XK9aVQ (button) (small blind) showed [6d 6h] and won ($31.50) with two pair, Aces and Sixes
Seat 2: RwDoM55ZeQuI2ADyJhOb2Q (big blind) mucked



PokerStars Game #59941264744:  Hold'em No Limit ($1/$2) - 2009/07/01 1:30:24 ET
Table 'gftD4mDF7mIFKvSrIyaRbw' 9-max Seat #7 is the button
Seat 2: GX1heJ+DSsvm7gzSPsYhhQ ($40 in chips)
Seat 3: CUZwDpLTQKhzarPe+JCLOQ ($200 in chips)
Seat 4: /inIs/z/PcX+TniIFpaxpg ($40 in chips)
Seat 5: mpsfNtnMVDqQHTe92AhIdw ($119.10 in chips)
Seat 6: 2NvwF8W2nzsbS+G//yLAbQ ($113.85 in chips)
Seat 7: +T/63sAeZzWyHchahJ36GQ ($42 in chips)
Seat 8: MpL4DeEqGQu0H8TJEbEOrg ($42 in chips)
Seat 9: F7m34OOfAQ7annesMHVjKw ($165.75 in chips)
MpL4DeEqGQu0H8TJEbEOrg: posts small blind $1
F7m34OOfAQ7annesMHVjKw: posts big blind $2
*** HOLE CARDS ***
31HuO+DQxppUQEedBWukug is disconnected
GX1heJ+DSsvm7gzSPsYhhQ: raises $4 to $6
CUZwDpLTQKhzarPe+JCLOQ: folds
/inIs/z/PcX+TniIFpaxpg: folds
mpsfNtnMVDqQHTe92AhIdw: folds
2NvwF8W2nzsbS+G//yLAbQ: folds
+T/63sAeZzWyHchahJ36GQ: folds
MpL4DeEqGQu0H8TJEbEOrg: folds
F7m34OOfAQ7annesMHVjKw has timed out
F7m34OOfAQ7annesMHVjKw: folds
F7m34OOfAQ7annesMHVjKw is sitting out
GX1heJ+DSsvm7gzSPsYhhQ collected $5 from pot
*** SUMMARY ***
Total pot $5 | Rake $0
Seat 2: GX1heJ+DSsvm7gzSPsYhhQ collected ($5)
Seat 3: CUZwDpLTQKhzarPe+JCLOQ folded before Flop (didn't bet)
Seat 4: /inIs/z/PcX+TniIFpaxpg folded before Flop (didn't bet)
Seat 5: mpsfNtnMVDqQHTe92AhIdw folded before Flop (didn't bet)
Seat 6: 2NvwF8W2nzsbS+G//yLAbQ folded before Flop (didn't bet)
Seat 7: +T/63sAeZzWyHchahJ36GQ (button) folded before Flop (didn't bet)
Seat 8: MpL4DeEqGQu0H8TJEbEOrg (small blind) folded before Flop
Seat 9: F7m34OOfAQ7annesMHVjKw (big blind) folded before Flop



PokerStars Game #59941265544:  Hold'em No Limit ($1/$2) - 2009/07/01 1:30:25 ET
Table 'LL4bDFyhj5hsMpzaDugJZg' 6-max Seat #3 is the button
Seat 1: FwvID/fQGlpY3soi/lMTww ($69.50 in chips)
Seat 2: IZng3w8jiJHHp3LbYKLi4w ($49.15 in chips)
Seat 3: iI/NMpRxMkGieArQEhACSA ($534.50 in chips)
Seat 4: 8srN1dKQePlsv0GyTada+Q ($225.40 in chips)
Seat 5: A2GTwTiwkb1ilNWgW487Vg ($115.80 in chips)
Seat 6: 692Q4sfB0gTElzS0WMeg+A ($212.10 in chips)
8srN1dKQePlsv0GyTada+Q: posts small blind $1
A2GTwTiwkb1ilNWgW487Vg: posts big blind $2
IZng3w8jiJHHp3LbYKLi4w: posts small & big blinds $3
*** HOLE CARDS ***
692Q4sfB0gTElzS0WMeg+A: raises $8 to $10
FwvID/fQGlpY3soi/lMTww: folds
IZng3w8jiJHHp3LbYKLi4w: folds
iI/NMpRxMkGieArQEhACSA: calls $10
8srN1dKQePlsv0GyTada+Q: folds
A2GTwTiwkb1ilNWgW487Vg: folds
*** FLOP *** [3c 7c 8s]
692Q4sfB0gTElzS0WMeg+A: bets $14
iI/NMpRxMkGieArQEhACSA: calls $14
*** TURN *** [3c 7c 8s] [8c]
692Q4sfB0gTElzS0WMeg+A: checks
FwvID/fQGlpY3soi/lMTww is connected
iI/NMpRxMkGieArQEhACSA: checks
*** RIVER *** [3c 7c 8s 8c] [7s]
692Q4sfB0gTElzS0WMeg+A: checks
iI/NMpRxMkGieArQEhACSA: checks
*** SHOW DOWN ***
692Q4sfB0gTElzS0WMeg+A: shows [As 9s] (two pair, Eights and Sevens)
iI/NMpRxMkGieArQEhACSA: shows [Ts Td] (two pair, Tens and Eights)
iI/NMpRxMkGieArQEhACSA collected $51.40 from pot
*** SUMMARY ***
Total pot $54 | Rake $2.60
Board [3c 7c 8s 8c 7s]
Seat 1: FwvID/fQGlpY3soi/lMTww folded before Flop (didn't bet)
Seat 2: IZng3w8jiJHHp3LbYKLi4w folded before Flop
Seat 3: iI/NMpRxMkGieArQEhACSA (button) showed [Ts Td] and won ($51.40) with two pair, Tens and Eights
Seat 4: 8srN1dKQePlsv0GyTada+Q (small blind) folded before Flop
Seat 5: A2GTwTiwkb1ilNWgW487Vg (big blind) folded before Flop
Seat 6: 692Q4sfB0gTElzS0WMeg+A showed [As 9s] and lost with two pair, Eights and Sevens



PokerStars Game #59941265796:  Hold'em No Limit ($1/$2) - 2009/07/01 1:30:26 ET
Table 'AtOXMvcrtQM8yLNcALmfLQ' 2-max Seat #1 is the button
Seat 1: +HlQuAsMqZGYYtjcPO/a3A ($267.10 in chips)
Seat 2: pVqEzK9wXlRMECnb1Zg4Zw ($211.30 in chips)
+HlQuAsMqZGYYtjcPO/a3A: posts small blind $1
pVqEzK9wXlRMECnb1Zg4Zw: posts big blind $2
*** HOLE CARDS ***
+HlQuAsMqZGYYtjcPO/a3A: calls $1
pVqEzK9wXlRMECnb1Zg4Zw: checks
*** FLOP *** [Jh Qh Ts]
pVqEzK9wXlRMECnb1Zg4Zw: checks
+HlQuAsMqZGYYtjcPO/a3A: bets $4
pVqEzK9wXlRMECnb1Zg4Zw: folds
+HlQuAsMqZGYYtjcPO/a3A collected $3.80 from pot
*** SUMMARY ***
Total pot $4 | Rake $0.20
Board [Jh Qh Ts]
Seat 1: +HlQuAsMqZGYYtjcPO/a3A (button) (small blind) collected ($3.80)
Seat 2: pVqEzK9wXlRMECnb1Zg4Zw (big blind) folded on the Flop



PokerStars Game #59941267496:  Hold'em No Limit ($1/$2) - 2009/07/01 1:30:29 ET
Table 'eTkRjRjsYr567snmNk8kNQ' 2-max Seat #2 is the button
Seat 1: t6Jd836OSEMbcRi7rfGp5g ($239.50 in chips)
Seat 2: UNpnKQk0gkkyFJen8upqag ($257 in chips)
UNpnKQk0gkkyFJen8upqag: posts small blind $1
t6Jd836OSEMbcRi7rfGp5g: posts big blind $2
*** HOLE CARDS ***
UNpnKQk0gkkyFJen8upqag: raises $4 to $6
t6Jd836OSEMbcRi7rfGp5g: raises $14 to $20
UNpnKQk0gkkyFJen8upqag: folds
t6Jd836OSEMbcRi7rfGp5g collected $12 from pot
*** SUMMARY ***
Total pot $12 | Rake $0
Seat 1: t6Jd836OSEMbcRi7rfGp5g (big blind) collected ($12)
Seat 2: UNpnKQk0gkkyFJen8upqag (button) (small blind) folded before Flop



PokerStars Game #59941267762:  Hold'em No Limit ($1/$2) - 2009/07/01 1:30:29 ET
Table '3WCXyaiCAbqSShQu7FIjvA' 9-max Seat #6 is the button
Seat 1: kTCkABD1UUldS9DFRGfCwQ ($151.40 in chips)
Seat 3: 5Q8U6iZbeO7xJSS4qvDP5g ($272.15 in chips)
Seat 4: waEF/+pxZTxNo4FvsORuXg ($82.40 in chips)
Seat 5: CkE3IyJF1KvdaAOmZY5XqQ ($200 in chips)
Seat 6: 5jQlngvMSqM/WoonOcR5kw ($247.35 in chips)
Seat 8: 1CtiZuXDFaJL1dJPQKyi8Q ($240.35 in chips)
Seat 9: FiXPLJyqb24l32QST2TInw ($147.40 in chips)
1CtiZuXDFaJL1dJPQKyi8Q: posts small blind $1
FiXPLJyqb24l32QST2TInw: posts big blind $2
TAfo4veNRaRlzDXMMYS3Jg: sits out
*** HOLE CARDS ***
kTCkABD1UUldS9DFRGfCwQ: folds
5Q8U6iZbeO7xJSS4qvDP5g: folds
waEF/+pxZTxNo4FvsORuXg: folds
CkE3IyJF1KvdaAOmZY5XqQ: folds
5jQlngvMSqM/WoonOcR5kw: calls $2
1CtiZuXDFaJL1dJPQKyi8Q: calls $1
FiXPLJyqb24l32QST2TInw: checks
*** FLOP *** [6d 4c 5s]
1CtiZuXDFaJL1dJPQKyi8Q: checks
FiXPLJyqb24l32QST2TInw: checks
5jQlngvMSqM/WoonOcR5kw: checks
*** TURN *** [6d 4c 5s] [3c]
1CtiZuXDFaJL1dJPQKyi8Q: checks
FiXPLJyqb24l32QST2TInw: checks
5jQlngvMSqM/WoonOcR5kw: checks
*** RIVER *** [6d 4c 5s 3c] [Kc]
1CtiZuXDFaJL1dJPQKyi8Q: checks
FiXPLJyqb24l32QST2TInw: checks
5jQlngvMSqM/WoonOcR5kw: checks
*** SHOW DOWN ***
1CtiZuXDFaJL1dJPQKyi8Q: shows [4s As] (a pair of Fours)
FiXPLJyqb24l32QST2TInw: mucks hand
5jQlngvMSqM/WoonOcR5kw: mucks hand
1CtiZuXDFaJL1dJPQKyi8Q collected $5.70 from pot
*** SUMMARY ***
Total pot $6 | Rake $0.30
Board [6d 4c 5s 3c Kc]
Seat 1: kTCkABD1UUldS9DFRGfCwQ folded before Flop (didn't bet)
Seat 3: 5Q8U6iZbeO7xJSS4qvDP5g folded before Flop (didn't bet)
Seat 4: waEF/+pxZTxNo4FvsORuXg folded before Flop (didn't bet)
Seat 5: CkE3IyJF1KvdaAOmZY5XqQ folded before Flop (didn't bet)
Seat 6: 5jQlngvMSqM/WoonOcR5kw (button) mucked
Seat 8: 1CtiZuXDFaJL1dJPQKyi8Q (small blind) showed [4s As] and won ($5.70) with a pair of Fours
Seat 9: FiXPLJyqb24l32QST2TInw (big blind) mucked



PokerStars Game #59941267630:  Hold'em No Limit ($1/$2) - 2009/07/01 1:30:29 ET
Table '4NGNnZ/osQfNq6abYqkJeA' 6-max Seat #5 is the button
Seat 1: vkfxu8f/jMYKUk6Ly4eujw ($200 in chips)
Seat 2: 669iGNwYwgRZg3nhS+aDAQ ($90.15 in chips)
Seat 3: 54yWzRRgS0oZ+S6LwZBxMQ ($40 in chips)
Seat 4: sY+4Uuh5z/6AbXXaCS10jw ($228.25 in chips)
Seat 5: VvdR9F3I+2yELkfTVvC1dg ($241.85 in chips)
Seat 6: 3cPMpDMgeOMAe4UceUfLsg ($200 in chips)
3cPMpDMgeOMAe4UceUfLsg: posts small blind $1
vkfxu8f/jMYKUk6Ly4eujw: posts big blind $2
*** HOLE CARDS ***
669iGNwYwgRZg3nhS+aDAQ: folds
54yWzRRgS0oZ+S6LwZBxMQ: folds
sY+4Uuh5z/6AbXXaCS10jw: folds
VvdR9F3I+2yELkfTVvC1dg: folds
3cPMpDMgeOMAe4UceUfLsg: folds
vkfxu8f/jMYKUk6Ly4eujw collected $2 from pot
vkfxu8f/jMYKUk6Ly4eujw: doesn't show hand
*** SUMMARY ***
Total pot $2 | Rake $0
Seat 1: vkfxu8f/jMYKUk6Ly4eujw (big blind) collected ($2)
Seat 2: 669iGNwYwgRZg3nhS+aDAQ folded before Flop (didn't bet)
Seat 3: 54yWzRRgS0oZ+S6LwZBxMQ folded before Flop (didn't bet)
Seat 4: sY+4Uuh5z/6AbXXaCS10jw folded before Flop (didn't bet)
Seat 5: VvdR9F3I+2yELkfTVvC1dg (button) folded before Flop (didn't bet)
Seat 6: 3cPMpDMgeOMAe4UceUfLsg (small blind) folded before Flop



PokerStars Game #59941267414:  Hold'em No Limit ($1/$2) - 2009/07/01 1:30:29 ET
Table 'TsEDkiO4tzCTCzJ7tNdEqw' 6-max Seat #4 is the button
Seat 1: MfXQsYD8pGeCS7XOtyV+vw ($94.05 in chips)
Seat 2: 4dcDwIHRm96PwtqkpQiuiA ($78.10 in chips)
Seat 3: ubtx4Z5L+AcK71MTvYiGVw ($205 in chips)
Seat 4: K8MXCrNAVYlMnnCeM32Kxw ($117.50 in chips)
Seat 5: VvdR9F3I+2yELkfTVvC1dg ($264.35 in chips)
Seat 6: uCqEjnxh2/vFBjKYkfTOkw ($142.35 in chips)
VvdR9F3I+2yELkfTVvC1dg: posts small blind $1
uCqEjnxh2/vFBjKYkfTOkw: posts big blind $2
*** HOLE CARDS ***
MfXQsYD8pGeCS7XOtyV+vw: raises $6 to $8
4dcDwIHRm96PwtqkpQiuiA: folds
ubtx4Z5L+AcK71MTvYiGVw: folds
K8MXCrNAVYlMnnCeM32Kxw: folds
VvdR9F3I+2yELkfTVvC1dg: folds
uCqEjnxh2/vFBjKYkfTOkw: folds
MfXQsYD8pGeCS7XOtyV+vw collected $5 from pot
MfXQsYD8pGeCS7XOtyV+vw: doesn't show hand
*** SUMMARY ***
Total pot $5 | Rake $0
Seat 1: MfXQsYD8pGeCS7XOtyV+vw collected ($5)
Seat 2: 4dcDwIHRm96PwtqkpQiuiA folded before Flop (didn't bet)
Seat 3: ubtx4Z5L+AcK71MTvYiGVw folded before Flop (didn't bet)
Seat 4: K8MXCrNAVYlMnnCeM32Kxw (button) folded before Flop (didn't bet)
Seat 5: VvdR9F3I+2yELkfTVvC1dg (small blind) folded before Flop
Seat 6: uCqEjnxh2/vFBjKYkfTOkw (big blind) folded before Flop



PokerStars Game #59941268154:  Hold'em No Limit ($1/$2) - 2009/07/01 1:30:30 ET
Table 'qVXak+oTeDXMGbWa4sDU5Q' 9-max Seat #1 is the button
Seat 1: H6Z4+qu8gR0VUiPOijndVg ($209.55 in chips)
Seat 2: rW/MyplHylMSBRaoRUzWrg ($72 in chips)
Seat 3: WUlHm+ydPPHG7Lb0rePSdA ($153.65 in chips)
Seat 4: lQYT23h5QCUVZAKxjOO39Q ($203.70 in chips)
Seat 5: FWGiDqRwvLeKmHq9t4Jy9w ($268.80 in chips)
Seat 6: GX1heJ+DSsvm7gzSPsYhhQ ($37 in chips)
Seat 7: PfmlvZlFiss79a6IoEr11g ($163.30 in chips)
Seat 8: Z0rzUi0y1x80UdIpofoNbA ($125.55 in chips)
Seat 9: CkE3IyJF1KvdaAOmZY5XqQ ($200 in chips)
rW/MyplHylMSBRaoRUzWrg: posts small blind $1
WUlHm+ydPPHG7Lb0rePSdA: posts big blind $2
*** HOLE CARDS ***
lQYT23h5QCUVZAKxjOO39Q: folds
FWGiDqRwvLeKmHq9t4Jy9w: folds
GX1heJ+DSsvm7gzSPsYhhQ: folds
PfmlvZlFiss79a6IoEr11g: folds
Z0rzUi0y1x80UdIpofoNbA: folds
CkE3IyJF1KvdaAOmZY5XqQ: folds
H6Z4+qu8gR0VUiPOijndVg: raises $2 to $4
rW/MyplHylMSBRaoRUzWrg: raises $8 to $12
WUlHm+ydPPHG7Lb0rePSdA: folds
H6Z4+qu8gR0VUiPOijndVg: folds
rW/MyplHylMSBRaoRUzWrg collected $10 from pot
*** SUMMARY ***
Total pot $10 | Rake $0
Seat 1: H6Z4+qu8gR0VUiPOijndVg (button) folded before Flop
Seat 2: rW/MyplHylMSBRaoRUzWrg (small blind) collected ($10)
Seat 3: WUlHm+ydPPHG7Lb0rePSdA (big blind) folded before Flop
Seat 4: lQYT23h5QCUVZAKxjOO39Q folded before Flop (didn't bet)
Seat 5: FWGiDqRwvLeKmHq9t4Jy9w folded before Flop (didn't bet)
Seat 6: GX1heJ+DSsvm7gzSPsYhhQ folded before Flop (didn't bet)
Seat 7: PfmlvZlFiss79a6IoEr11g folded before Flop (didn't bet)
Seat 8: Z0rzUi0y1x80UdIpofoNbA folded before Flop (didn't bet)
Seat 9: CkE3IyJF1KvdaAOmZY5XqQ folded before Flop (didn't bet)



PokerStars Game #59941271270:  Hold'em No Limit ($1/$2) - 2009/07/01 1:30:35 ET
Table 'W9UeSV0aoPjh5SFSxM8jUQ' 9-max Seat #7 is the button
Seat 1: mIKx5lhIt13X5eZQH0ZeMA ($23 in chips)
Seat 2: iMe5yhc+1BaiIPHet3NMrA ($252.60 in chips)
Seat 3: /inIs/z/PcX+TniIFpaxpg ($25 in chips)
Seat 4: 4YA/sQy1Emm680zhbPUjow ($133.35 in chips)
Seat 5: ri8CLkX3e9JF34dQNbsHGA ($40 in chips)
Seat 6: j47DM+lqTfzZP8musviQTg ($129.30 in chips)
Seat 7: I2ipWauytvrkEer4XD3Sjg ($83.70 in chips)
Seat 8: odhvI/CZeMsPyo1n1U7+hA ($41.40 in chips)
Seat 9: Q104K4iDGcqOlVrjAkzPEA ($98.10 in chips)
odhvI/CZeMsPyo1n1U7+hA: posts small blind $1
Q104K4iDGcqOlVrjAkzPEA: posts big blind $2
*** HOLE CARDS ***
mIKx5lhIt13X5eZQH0ZeMA: folds
iMe5yhc+1BaiIPHet3NMrA: folds
/inIs/z/PcX+TniIFpaxpg: folds
4YA/sQy1Emm680zhbPUjow: raises $2 to $4
ri8CLkX3e9JF34dQNbsHGA: folds
j47DM+lqTfzZP8musviQTg: folds
I2ipWauytvrkEer4XD3Sjg: folds
odhvI/CZeMsPyo1n1U7+hA: folds
Q104K4iDGcqOlVrjAkzPEA: folds
4YA/sQy1Emm680zhbPUjow collected $5 from pot
*** SUMMARY ***
Total pot $5 | Rake $0
Seat 1: mIKx5lhIt13X5eZQH0ZeMA folded before Flop (didn't bet)
Seat 2: iMe5yhc+1BaiIPHet3NMrA folded before Flop (didn't bet)
Seat 3: /inIs/z/PcX+TniIFpaxpg folded before Flop (didn't bet)
Seat 4: 4YA/sQy1Emm680zhbPUjow collected ($5)
Seat 5: ri8CLkX3e9JF34dQNbsHGA folded before Flop (didn't bet)
Seat 6: j47DM+lqTfzZP8musviQTg folded before Flop (didn't bet)
Seat 7: I2ipWauytvrkEer4XD3Sjg (button) folded before Flop (didn't bet)
Seat 8: odhvI/CZeMsPyo1n1U7+hA (small blind) folded before Flop
Seat 9: Q104K4iDGcqOlVrjAkzPEA (big blind) folded before Flop



PokerStars Game #59941273276:  Hold'em No Limit ($1/$2) - 2009/07/01 1:30:38 ET
Table 'aSf77Sj8QEnzcc0WaxVD4Q' 6-max Seat #2 is the button
Seat 1: UELtvp+JfwI7XDGVwSxZXA ($149.55 in chips)
Seat 2: vkfxu8f/jMYKUk6Ly4eujw ($211.80 in chips)
Seat 3: 9dpyyjDTCed6nV7JhaUUpw ($524.70 in chips)
Seat 4: YsLQ3BAvgQHWXMAv3Wv6Hg ($259.70 in chips)
Seat 5: VvdR9F3I+2yELkfTVvC1dg ($240 in chips)
Seat 6: vkoJRf3gidxY1pPi0AFWww ($129.60 in chips)
9dpyyjDTCed6nV7JhaUUpw: posts small blind $1
YsLQ3BAvgQHWXMAv3Wv6Hg: posts big blind $2
*** HOLE CARDS ***
VvdR9F3I+2yELkfTVvC1dg: folds
vkoJRf3gidxY1pPi0AFWww: folds
UELtvp+JfwI7XDGVwSxZXA: folds
vkfxu8f/jMYKUk6Ly4eujw: folds
9dpyyjDTCed6nV7JhaUUpw: raises $6 to $8
YsLQ3BAvgQHWXMAv3Wv6Hg: folds
9dpyyjDTCed6nV7JhaUUpw collected $4 from pot
9dpyyjDTCed6nV7JhaUUpw: doesn't show hand
*** SUMMARY ***
Total pot $4 | Rake $0
Seat 1: UELtvp+JfwI7XDGVwSxZXA folded before Flop (didn't bet)
Seat 2: vkfxu8f/jMYKUk6Ly4eujw (button) folded before Flop (didn't bet)
Seat 3: 9dpyyjDTCed6nV7JhaUUpw (small blind) collected ($4)
Seat 4: YsLQ3BAvgQHWXMAv3Wv6Hg (big blind) folded before Flop
Seat 5: VvdR9F3I+2yELkfTVvC1dg folded before Flop (didn't bet)
Seat 6: vkoJRf3gidxY1pPi0AFWww folded before Flop (didn't bet)



PokerStars Game #59941275086:  Hold'em No Limit ($1/$2) - 2009/07/01 1:30:41 ET
Table 'rsKRKlGHlxVyqJxzO2a2Ow' 9-max Seat #5 is the button
Seat 1: uYWfQJg2hgHLxri6/uVJiw ($390.40 in chips)
Seat 3: zTcFtoHqqK4550YMZ8Y14Q ($42.30 in chips)
Seat 5: 5Q8U6iZbeO7xJSS4qvDP5g ($223.55 in chips)
Seat 6: H6Z4+qu8gR0VUiPOijndVg ($202.55 in chips)
Seat 7: GX1heJ+DSsvm7gzSPsYhhQ ($33 in chips)
Seat 8: CkE3IyJF1KvdaAOmZY5XqQ ($200 in chips)
Seat 9: gRbvhSUVg+TNaTjaJecIRw ($24 in chips)
H6Z4+qu8gR0VUiPOijndVg: posts small blind $1
GX1heJ+DSsvm7gzSPsYhhQ: posts big blind $2
+T/63sAeZzWyHchahJ36GQ: sits out
*** HOLE CARDS ***
CkE3IyJF1KvdaAOmZY5XqQ: folds
gRbvhSUVg+TNaTjaJecIRw: folds
uYWfQJg2hgHLxri6/uVJiw: folds
zTcFtoHqqK4550YMZ8Y14Q: folds
5Q8U6iZbeO7xJSS4qvDP5g: folds
H6Z4+qu8gR0VUiPOijndVg: raises $2 to $4
GX1heJ+DSsvm7gzSPsYhhQ: folds
H6Z4+qu8gR0VUiPOijndVg collected $4 from pot
H6Z4+qu8gR0VUiPOijndVg: doesn't show hand
*** SUMMARY ***
Total pot $4 | Rake $0
Seat 1: uYWfQJg2hgHLxri6/uVJiw folded before Flop (didn't bet)
Seat 3: zTcFtoHqqK4550YMZ8Y14Q folded before Flop (didn't bet)
Seat 5: 5Q8U6iZbeO7xJSS4qvDP5g (button) folded before Flop (didn't bet)
Seat 6: H6Z4+qu8gR0VUiPOijndVg (small blind) collected ($4)
Seat 7: GX1heJ+DSsvm7gzSPsYhhQ (big blind) folded before Flop
Seat 8: CkE3IyJF1KvdaAOmZY5XqQ folded before Flop (didn't bet)
Seat 9: gRbvhSUVg+TNaTjaJecIRw folded before Flop (didn't bet)



PokerStars Game #59941275256:  Hold'em No Limit ($1/$2) - 2009/07/01 1:30:42 ET
Table '8Y6PEyoNuepZTai2Q56aHw' 9-max Seat #1 is the button
Seat 1: 5Q8U6iZbeO7xJSS4qvDP5g ($311.80 in chips)
Seat 2: gDCJIAlovbPnTvMM7Dd1gA ($162.85 in chips)
Seat 3: WUlHm+ydPPHG7Lb0rePSdA ($217.10 in chips)
Seat 4: xKkwALG38OfLQ9DXuJgR1w ($247.25 in chips)
Seat 6: NtLDBSjsJQEKekh5cdinvw ($377.35 in chips)
Seat 7: Kzta8yu9vxHT4B70mjBZ+w ($200.30 in chips)
Seat 8: rW/MyplHylMSBRaoRUzWrg ($36 in chips)
Seat 9: F7m34OOfAQ7annesMHVjKw ($197 in chips)
gDCJIAlovbPnTvMM7Dd1gA: posts small blind $1
WUlHm+ydPPHG7Lb0rePSdA: posts big blind $2
*** HOLE CARDS ***
xKkwALG38OfLQ9DXuJgR1w: folds
NtLDBSjsJQEKekh5cdinvw: raises $2 to $4
Kzta8yu9vxHT4B70mjBZ+w: calls $4
rW/MyplHylMSBRaoRUzWrg: folds
QHxJjpVYwitg9krW6wZgJA leaves the table
F7m34OOfAQ7annesMHVjKw has timed out
F7m34OOfAQ7annesMHVjKw: folds
F7m34OOfAQ7annesMHVjKw is sitting out
5Q8U6iZbeO7xJSS4qvDP5g: folds
gDCJIAlovbPnTvMM7Dd1gA: calls $3
WUlHm+ydPPHG7Lb0rePSdA: folds
*** FLOP *** [7h 6c 3c]
/inIs/z/PcX+TniIFpaxpg joins the table at seat #5
gDCJIAlovbPnTvMM7Dd1gA: bets $7
NtLDBSjsJQEKekh5cdinvw: folds
Kzta8yu9vxHT4B70mjBZ+w: calls $7
*** TURN *** [7h 6c 3c] [9c]
gDCJIAlovbPnTvMM7Dd1gA: bets $7
F7m34OOfAQ7annesMHVjKw has returned
Kzta8yu9vxHT4B70mjBZ+w: calls $7
*** RIVER *** [7h 6c 3c 9c] [Jh]
gDCJIAlovbPnTvMM7Dd1gA: bets $7
Kzta8yu9vxHT4B70mjBZ+w: calls $7
*** SHOW DOWN ***
gDCJIAlovbPnTvMM7Dd1gA: shows [8c Kc] (a flush, King high)
Kzta8yu9vxHT4B70mjBZ+w: mucks hand
gDCJIAlovbPnTvMM7Dd1gA collected $53.30 from pot
*** SUMMARY ***
Total pot $56 | Rake $2.70
Board [7h 6c 3c 9c Jh]
Seat 1: 5Q8U6iZbeO7xJSS4qvDP5g (button) folded before Flop (didn't bet)
Seat 2: gDCJIAlovbPnTvMM7Dd1gA (small blind) showed [8c Kc] and won ($53.30) with a flush, King high
Seat 3: WUlHm+ydPPHG7Lb0rePSdA (big blind) folded before Flop
Seat 4: xKkwALG38OfLQ9DXuJgR1w folded before Flop (didn't bet)
Seat 6: NtLDBSjsJQEKekh5cdinvw folded on the Flop
Seat 7: Kzta8yu9vxHT4B70mjBZ+w mucked
Seat 8: rW/MyplHylMSBRaoRUzWrg folded before Flop (didn't bet)
Seat 9: F7m34OOfAQ7annesMHVjKw folded before Flop (didn't bet)



PokerStars Game #59941277290:  Hold'em No Limit ($1/$2) - 2009/07/01 1:30:45 ET
Table 'eTkRjRjsYr567snmNk8kNQ' 2-max Seat #1 is the button
Seat 1: t6Jd836OSEMbcRi7rfGp5g ($245.50 in chips)
Seat 2: UNpnKQk0gkkyFJen8upqag ($251 in chips)
t6Jd836OSEMbcRi7rfGp5g: posts small blind $1
UNpnKQk0gkkyFJen8upqag: posts big blind $2
*** HOLE CARDS ***
t6Jd836OSEMbcRi7rfGp5g: raises $4 to $6
UNpnKQk0gkkyFJen8upqag: folds
t6Jd836OSEMbcRi7rfGp5g collected $4 from pot
*** SUMMARY ***
Total pot $4 | Rake $0
Seat 1: t6Jd836OSEMbcRi7rfGp5g (button) (small blind) collected ($4)
Seat 2: UNpnKQk0gkkyFJen8upqag (big blind) folded before Flop



PokerStars Game #59941277942:  Hold'em No Limit ($1/$2) - 2009/07/01 1:30:46 ET
Table 'G1Oqdy4Pqdb5gtx40rUBzA' 6-max Seat #5 is the button
Seat 1: ubtx4Z5L+AcK71MTvYiGVw ($200 in chips)
Seat 2: 4uqU0dG67owXuPz303Al4w ($518.25 in chips)
Seat 3: VvdR9F3I+2yELkfTVvC1dg ($241.25 in chips)
Seat 4: B87ikIyZ/TzAVeXf38Ny0g ($200 in chips)
Seat 5: F1+Ml47qRQWunzPnGhLLzQ ($186.50 in chips)
Seat 6: qCnEYuAE5y5A7bk6fO5/jQ ($200 in chips)
qCnEYuAE5y5A7bk6fO5/jQ: posts small blind $1
ubtx4Z5L+AcK71MTvYiGVw: posts big blind $2
*** HOLE CARDS ***
4uqU0dG67owXuPz303Al4w: folds
VvdR9F3I+2yELkfTVvC1dg: folds
B87ikIyZ/TzAVeXf38Ny0g: folds
F1+Ml47qRQWunzPnGhLLzQ: folds
qCnEYuAE5y5A7bk6fO5/jQ: folds
ubtx4Z5L+AcK71MTvYiGVw collected $2 from pot
ubtx4Z5L+AcK71MTvYiGVw: doesn't show hand
*** SUMMARY ***
Total pot $2 | Rake $0
Seat 1: ubtx4Z5L+AcK71MTvYiGVw (big blind) collected ($2)
Seat 2: 4uqU0dG67owXuPz303Al4w folded before Flop (didn't bet)
Seat 3: VvdR9F3I+2yELkfTVvC1dg folded before Flop (didn't bet)
Seat 4: B87ikIyZ/TzAVeXf38Ny0g folded before Flop (didn't bet)
Seat 5: F1+Ml47qRQWunzPnGhLLzQ (button) folded before Flop (didn't bet)
Seat 6: qCnEYuAE5y5A7bk6fO5/jQ (small blind) folded before Flop



PokerStars Game #59941278544:  Hold'em No Limit ($1/$2) - 2009/07/01 1:30:47 ET
Table 'kq5zaQ+1hLNf8LZfGnbTAA' 6-max Seat #3 is the button
Seat 1: 8srN1dKQePlsv0GyTada+Q ($405 in chips)
Seat 2: nXDI8Y/S6POzRwANu3d8hQ ($187 in chips)
Seat 3: vkfxu8f/jMYKUk6Ly4eujw ($225.95 in chips)
Seat 4: 3dAbvkxS5NPQTBAbvpinVg ($279.45 in chips)
Seat 5: gnYme0DNFflnMhrdbxe1Ag ($200 in chips)
Seat 6: mfy7uGZcqA2PVQqEVbJ7+g ($194.25 in chips)
3dAbvkxS5NPQTBAbvpinVg: posts small blind $1
gnYme0DNFflnMhrdbxe1Ag: posts big blind $2
*** HOLE CARDS ***
mfy7uGZcqA2PVQqEVbJ7+g: folds
8srN1dKQePlsv0GyTada+Q: raises $4 to $6
nXDI8Y/S6POzRwANu3d8hQ: folds
vkfxu8f/jMYKUk6Ly4eujw: folds
3dAbvkxS5NPQTBAbvpinVg: folds
gnYme0DNFflnMhrdbxe1Ag: folds
8srN1dKQePlsv0GyTada+Q collected $5 from pot
8srN1dKQePlsv0GyTada+Q: doesn't show hand
*** SUMMARY ***
Total pot $5 | Rake $0
Seat 1: 8srN1dKQePlsv0GyTada+Q collected ($5)
Seat 2: nXDI8Y/S6POzRwANu3d8hQ folded before Flop (didn't bet)
Seat 3: vkfxu8f/jMYKUk6Ly4eujw (button) folded before Flop (didn't bet)
Seat 4: 3dAbvkxS5NPQTBAbvpinVg (small blind) folded before Flop
Seat 5: gnYme0DNFflnMhrdbxe1Ag (big blind) folded before Flop
Seat 6: mfy7uGZcqA2PVQqEVbJ7+g folded before Flop (didn't bet)



PokerStars Game #59941278814:  Hold'em No Limit ($1/$2) - 2009/07/01 1:30:48 ET
Table '/dyk+YdRGv90j2box35j8w' 6-max Seat #2 is the button
Seat 1: 8srN1dKQePlsv0GyTada+Q ($219.90 in chips)
Seat 2: qCnEYuAE5y5A7bk6fO5/jQ ($473.60 in chips)
Seat 4: z/u1YTnkiIDrtp/2cA2dBg ($186.60 in chips)
Seat 5: VvdR9F3I+2yELkfTVvC1dg ($203 in chips)
z/u1YTnkiIDrtp/2cA2dBg: posts small blind $1
VvdR9F3I+2yELkfTVvC1dg: posts big blind $2
gnYme0DNFflnMhrdbxe1Ag: sits out
*** HOLE CARDS ***
8srN1dKQePlsv0GyTada+Q: raises $4 to $6
qCnEYuAE5y5A7bk6fO5/jQ: folds
z/u1YTnkiIDrtp/2cA2dBg: folds
VvdR9F3I+2yELkfTVvC1dg: calls $4
*** FLOP *** [Qs 6h 3d]
VvdR9F3I+2yELkfTVvC1dg: checks
8srN1dKQePlsv0GyTada+Q: checks
*** TURN *** [Qs 6h 3d] [9d]
VvdR9F3I+2yELkfTVvC1dg: checks
8srN1dKQePlsv0GyTada+Q: bets $8
VvdR9F3I+2yELkfTVvC1dg: folds
8srN1dKQePlsv0GyTada+Q collected $12.35 from pot
8srN1dKQePlsv0GyTada+Q: doesn't show hand
*** SUMMARY ***
Total pot $13 | Rake $0.65
Board [Qs 6h 3d 9d]
Seat 1: 8srN1dKQePlsv0GyTada+Q collected ($12.35)
Seat 2: qCnEYuAE5y5A7bk6fO5/jQ (button) folded before Flop (didn't bet)
Seat 4: z/u1YTnkiIDrtp/2cA2dBg (small blind) folded before Flop
Seat 5: VvdR9F3I+2yELkfTVvC1dg (big blind) folded on the Turn



PokerStars Game #59941279270:  Hold'em No Limit ($1/$2) - 2009/07/01 1:30:49 ET
Table '4NGNnZ/osQfNq6abYqkJeA' 6-max Seat #6 is the button
Seat 1: vkfxu8f/jMYKUk6Ly4eujw ($201 in chips)
Seat 2: 669iGNwYwgRZg3nhS+aDAQ ($90.15 in chips)
Seat 3: 54yWzRRgS0oZ+S6LwZBxMQ ($40 in chips)
Seat 4: sY+4Uuh5z/6AbXXaCS10jw ($228.25 in chips)
Seat 5: VvdR9F3I+2yELkfTVvC1dg ($241.85 in chips)
Seat 6: 3cPMpDMgeOMAe4UceUfLsg ($200 in chips)
vkfxu8f/jMYKUk6Ly4eujw: posts small blind $1
669iGNwYwgRZg3nhS+aDAQ: posts big blind $2
*** HOLE CARDS ***
54yWzRRgS0oZ+S6LwZBxMQ: folds
sY+4Uuh5z/6AbXXaCS10jw: folds
VvdR9F3I+2yELkfTVvC1dg: folds
3cPMpDMgeOMAe4UceUfLsg: raises $3 to $5
vkfxu8f/jMYKUk6Ly4eujw: folds
669iGNwYwgRZg3nhS+aDAQ: folds
3cPMpDMgeOMAe4UceUfLsg collected $5 from pot
3cPMpDMgeOMAe4UceUfLsg: doesn't show hand
*** SUMMARY ***
Total pot $5 | Rake $0
Seat 1: vkfxu8f/jMYKUk6Ly4eujw (small blind) folded before Flop
Seat 2: 669iGNwYwgRZg3nhS+aDAQ (big blind) folded before Flop
Seat 3: 54yWzRRgS0oZ+S6LwZBxMQ folded before Flop (didn't bet)
Seat 4: sY+4Uuh5z/6AbXXaCS10jw folded before Flop (didn't bet)
Seat 5: VvdR9F3I+2yELkfTVvC1dg folded before Flop (didn't bet)
Seat 6: 3cPMpDMgeOMAe4UceUfLsg (button) collected ($5)



PokerStars Game #59941279974:  Hold'em No Limit ($1/$2) - 2009/07/01 1:30:50 ET
Table 'NmY84NAf9Mh0ckAckHnh5g' 2-max Seat #2 is the button
Seat 1: 6hvg964TSqZ3AL/0XK9aVQ ($336.90 in chips)
Seat 2: RwDoM55ZeQuI2ADyJhOb2Q ($662.70 in chips)
RwDoM55ZeQuI2ADyJhOb2Q: posts small blind $1
6hvg964TSqZ3AL/0XK9aVQ: posts big blind $2
*** HOLE CARDS ***
RwDoM55ZeQuI2ADyJhOb2Q: folds
6hvg964TSqZ3AL/0XK9aVQ collected $2 from pot
6hvg964TSqZ3AL/0XK9aVQ: doesn't show hand
*** SUMMARY ***
Total pot $2 | Rake $0
Seat 1: 6hvg964TSqZ3AL/0XK9aVQ (big blind) collected ($2)
Seat 2: RwDoM55ZeQuI2ADyJhOb2Q (button) (small blind) folded before Flop



PokerStars Game #59941280722:  Hold'em No Limit ($1/$2) - 2009/07/01 1:30:51 ET
Table 'TsEDkiO4tzCTCzJ7tNdEqw' 6-max Seat #5 is the button
Seat 1: MfXQsYD8pGeCS7XOtyV+vw ($97.05 in chips)
Seat 2: 4dcDwIHRm96PwtqkpQiuiA ($78.10 in chips)
Seat 3: ubtx4Z5L+AcK71MTvYiGVw ($205 in chips)
Seat 4: K8MXCrNAVYlMnnCeM32Kxw ($117.50 in chips)
Seat 5: VvdR9F3I+2yELkfTVvC1dg ($263.35 in chips)
Seat 6: uCqEjnxh2/vFBjKYkfTOkw ($140.35 in chips)
uCqEjnxh2/vFBjKYkfTOkw: posts small blind $1
MfXQsYD8pGeCS7XOtyV+vw: posts big blind $2
*** HOLE CARDS ***
4dcDwIHRm96PwtqkpQiuiA: folds
ubtx4Z5L+AcK71MTvYiGVw: folds
K8MXCrNAVYlMnnCeM32Kxw: folds
VvdR9F3I+2yELkfTVvC1dg: folds
uCqEjnxh2/vFBjKYkfTOkw: raises $6 to $8
MfXQsYD8pGeCS7XOtyV+vw: calls $6
*** FLOP *** [Jd 4d 3s]
uCqEjnxh2/vFBjKYkfTOkw: bets $12
MfXQsYD8pGeCS7XOtyV+vw: folds
uCqEjnxh2/vFBjKYkfTOkw collected $15.20 from pot
uCqEjnxh2/vFBjKYkfTOkw: doesn't show hand
*** SUMMARY ***
Total pot $16 | Rake $0.80
Board [Jd 4d 3s]
Seat 1: MfXQsYD8pGeCS7XOtyV+vw (big blind) folded on the Flop
Seat 2: 4dcDwIHRm96PwtqkpQiuiA folded before Flop (didn't bet)
Seat 3: ubtx4Z5L+AcK71MTvYiGVw folded before Flop (didn't bet)
Seat 4: K8MXCrNAVYlMnnCeM32Kxw folded before Flop (didn't bet)
Seat 5: VvdR9F3I+2yELkfTVvC1dg (button) folded before Flop (didn't bet)
Seat 6: uCqEjnxh2/vFBjKYkfTOkw (small blind) collected ($15.20)



PokerStars Game #59941281946:  Hold'em No Limit ($1/$2) - 2009/07/01 1:30:53 ET
Table 'mGpP9StWRnoeiBDExc6Frg' 6-max Seat #4 is the button
Seat 1: VvdR9F3I+2yELkfTVvC1dg ($309.05 in chips)
Seat 2: vkfxu8f/jMYKUk6Ly4eujw ($200 in chips)
Seat 3: 7acrZUQC3Zc9BNLjoKIcLQ ($42.40 in chips)
Seat 4: 4dcDwIHRm96PwtqkpQiuiA ($79.70 in chips)
Seat 5: d1puGuVBE0fidn+5eRJ0tw ($170.95 in chips)
Seat 6: B2Ih1sr5VZk+8He7rcrMtQ ($438.05 in chips)
d1puGuVBE0fidn+5eRJ0tw: posts small blind $1
B2Ih1sr5VZk+8He7rcrMtQ: posts big blind $2
*** HOLE CARDS ***
VvdR9F3I+2yELkfTVvC1dg: folds
vkfxu8f/jMYKUk6Ly4eujw: folds
7acrZUQC3Zc9BNLjoKIcLQ: raises $4 to $6
4dcDwIHRm96PwtqkpQiuiA: folds
d1puGuVBE0fidn+5eRJ0tw: calls $5
B2Ih1sr5VZk+8He7rcrMtQ: calls $4
*** FLOP *** [8d 6h Th]
d1puGuVBE0fidn+5eRJ0tw: bets $4
B2Ih1sr5VZk+8He7rcrMtQ: folds
7acrZUQC3Zc9BNLjoKIcLQ: calls $4
*** TURN *** [8d 6h Th] [Ts]
d1puGuVBE0fidn+5eRJ0tw: checks
7acrZUQC3Zc9BNLjoKIcLQ: bets $8
d1puGuVBE0fidn+5eRJ0tw: raises $46 to $54
7acrZUQC3Zc9BNLjoKIcLQ: folds
d1puGuVBE0fidn+5eRJ0tw collected $40 from pot
d1puGuVBE0fidn+5eRJ0tw: doesn't show hand
*** SUMMARY ***
Total pot $42 | Rake $2
Board [8d 6h Th Ts]
Seat 1: VvdR9F3I+2yELkfTVvC1dg folded before Flop (didn't bet)
Seat 2: vkfxu8f/jMYKUk6Ly4eujw folded before Flop (didn't bet)
Seat 3: 7acrZUQC3Zc9BNLjoKIcLQ folded on the Turn
Seat 4: 4dcDwIHRm96PwtqkpQiuiA (button) folded before Flop (didn't bet)
Seat 5: d1puGuVBE0fidn+5eRJ0tw (small blind) collected ($40)
Seat 6: B2Ih1sr5VZk+8He7rcrMtQ (big blind) folded on the Flop



PokerStars Game #59941281686:  Hold'em No Limit ($1/$2) - 2009/07/01 1:30:53 ET
Table 'gnHBqWll9O3fxG7Ojkz/ng' 9-max Seat #7 is the button
Seat 1: TAfo4veNRaRlzDXMMYS3Jg ($34 in chips)
Seat 2: H6Z4+qu8gR0VUiPOijndVg ($327.25 in chips)
Seat 3: 5Q8U6iZbeO7xJSS4qvDP5g ($211 in chips)
Seat 4: nXDI8Y/S6POzRwANu3d8hQ ($39 in chips)
Seat 5: rBQDMkKm9cZn6M9NPsiVew ($223.45 in chips)
Seat 7: jqui3xAWCkcdPW36a6BD+w ($341.95 in chips)
Seat 8: cM6efHzdxoqYm0EQKP4TTQ ($96.15 in chips)
Seat 9: GX1heJ+DSsvm7gzSPsYhhQ ($54.35 in chips)
cM6efHzdxoqYm0EQKP4TTQ: posts small blind $1
GX1heJ+DSsvm7gzSPsYhhQ: posts big blind $2
MeleaB: sits out
*** HOLE CARDS ***
TAfo4veNRaRlzDXMMYS3Jg: folds
H6Z4+qu8gR0VUiPOijndVg: folds
5Q8U6iZbeO7xJSS4qvDP5g: folds
nXDI8Y/S6POzRwANu3d8hQ has timed out
nXDI8Y/S6POzRwANu3d8hQ: folds
nXDI8Y/S6POzRwANu3d8hQ is sitting out
rBQDMkKm9cZn6M9NPsiVew: calls $2
jqui3xAWCkcdPW36a6BD+w: folds
cM6efHzdxoqYm0EQKP4TTQ: calls $1
GX1heJ+DSsvm7gzSPsYhhQ: checks
*** FLOP *** [3s 6d Ad]
cM6efHzdxoqYm0EQKP4TTQ: checks
GX1heJ+DSsvm7gzSPsYhhQ: checks
rBQDMkKm9cZn6M9NPsiVew: bets $6
nXDI8Y/S6POzRwANu3d8hQ has returned
cM6efHzdxoqYm0EQKP4TTQ: folds
GX1heJ+DSsvm7gzSPsYhhQ: folds
rBQDMkKm9cZn6M9NPsiVew collected $5.70 from pot
rBQDMkKm9cZn6M9NPsiVew: doesn't show hand
*** SUMMARY ***
Total pot $6 | Rake $0.30
Board [3s 6d Ad]
Seat 1: TAfo4veNRaRlzDXMMYS3Jg folded before Flop (didn't bet)
Seat 2: H6Z4+qu8gR0VUiPOijndVg folded before Flop (didn't bet)
Seat 3: 5Q8U6iZbeO7xJSS4qvDP5g folded before Flop (didn't bet)
Seat 4: nXDI8Y/S6POzRwANu3d8hQ folded before Flop (didn't bet)
Seat 5: rBQDMkKm9cZn6M9NPsiVew collected ($5.70)
Seat 7: jqui3xAWCkcdPW36a6BD+w (button) folded before Flop (didn't bet)
Seat 8: cM6efHzdxoqYm0EQKP4TTQ (small blind) folded on the Flop
Seat 9: GX1heJ+DSsvm7gzSPsYhhQ (big blind) folded on the Flop



PokerStars Game #59941281808:  Hold'em No Limit ($1/$2) - 2009/07/01 1:30:53 ET
Table 'AtOXMvcrtQM8yLNcALmfLQ' 2-max Seat #2 is the button
Seat 1: +HlQuAsMqZGYYtjcPO/a3A ($268.90 in chips)
Seat 2: pVqEzK9wXlRMECnb1Zg4Zw ($209.30 in chips)
pVqEzK9wXlRMECnb1Zg4Zw: posts small blind $1
+HlQuAsMqZGYYtjcPO/a3A: posts big blind $2
*** HOLE CARDS ***
pVqEzK9wXlRMECnb1Zg4Zw: raises $6 to $8
+HlQuAsMqZGYYtjcPO/a3A: calls $6
*** FLOP *** [2s 3c 9d]
+HlQuAsMqZGYYtjcPO/a3A: checks
pVqEzK9wXlRMECnb1Zg4Zw: bets $16
+HlQuAsMqZGYYtjcPO/a3A: raises $24 to $40
pVqEzK9wXlRMECnb1Zg4Zw: calls $24
*** TURN *** [2s 3c 9d] [Jh]
+HlQuAsMqZGYYtjcPO/a3A: bets $48
pVqEzK9wXlRMECnb1Zg4Zw: calls $48
*** RIVER *** [2s 3c 9d Jh] [Td]
+HlQuAsMqZGYYtjcPO/a3A: checks
pVqEzK9wXlRMECnb1Zg4Zw: checks
*** SHOW DOWN ***
+HlQuAsMqZGYYtjcPO/a3A: shows [As 9c] (a pair of Nines)
pVqEzK9wXlRMECnb1Zg4Zw: mucks hand
+HlQuAsMqZGYYtjcPO/a3A collected $191.50 from pot
*** SUMMARY ***
Total pot $192 | Rake $0.50
Board [2s 3c 9d Jh Td]
Seat 1: +HlQuAsMqZGYYtjcPO/a3A (big blind) showed [As 9c] and won ($191.50) with a pair of Nines
Seat 2: pVqEzK9wXlRMECnb1Zg4Zw (button) (small blind) mucked



PokerStars Game #59941282444:  Hold'em No Limit ($1/$2) - 2009/07/01 1:30:54 ET
Table 'jlrIxbrVIG+gjaUYT4za8g' 6-max Seat #4 is the button
Seat 1: ygTTt5ehT4aF86q1a8/R+w ($258.30 in chips)
Seat 3: gnYme0DNFflnMhrdbxe1Ag ($201.75 in chips)
Seat 4: 8srN1dKQePlsv0GyTada+Q ($220.55 in chips)
Seat 5: AyBB0k3Dcl7xbXUeGMw06g ($74.90 in chips)
Seat 6: vkfxu8f/jMYKUk6Ly4eujw ($309 in chips)
AyBB0k3Dcl7xbXUeGMw06g: posts small blind $1
vkfxu8f/jMYKUk6Ly4eujw: posts big blind $2
/PH6Ffnho4Ysm8S3V/oa+w: sits out
*** HOLE CARDS ***
ygTTt5ehT4aF86q1a8/R+w: folds
gnYme0DNFflnMhrdbxe1Ag: raises $4 to $6
8srN1dKQePlsv0GyTada+Q: raises $13 to $19
AyBB0k3Dcl7xbXUeGMw06g: folds
vkfxu8f/jMYKUk6Ly4eujw: folds
gnYme0DNFflnMhrdbxe1Ag: folds
8srN1dKQePlsv0GyTada+Q collected $15 from pot
*** SUMMARY ***
Total pot $15 | Rake $0
Seat 1: ygTTt5ehT4aF86q1a8/R+w folded before Flop (didn't bet)
Seat 3: gnYme0DNFflnMhrdbxe1Ag folded before Flop
Seat 4: 8srN1dKQePlsv0GyTada+Q (button) collected ($15)
Seat 5: AyBB0k3Dcl7xbXUeGMw06g (small blind) folded before Flop
Seat 6: vkfxu8f/jMYKUk6Ly4eujw (big blind) folded before Flop



PokerStars Game #59941282694:  Hold'em No Limit ($1/$2) - 2009/07/01 1:30:55 ET
Table 'ZzSIe0zTCDv+n6hfbY5tTg' 6-max Seat #2 is the button
Seat 1: VvdR9F3I+2yELkfTVvC1dg ($200 in chips)
Seat 2: B87ikIyZ/TzAVeXf38Ny0g ($283 in chips)
Seat 3: gsugPj31Hui3Jefl98MBOA ($418 in chips)
Seat 4: qXDd0ZyMIse0OBu8pxeQ3Q ($200 in chips)
Seat 5: 3dAbvkxS5NPQTBAbvpinVg ($480.30 in chips)
Seat 6: 09BNF4quPDzanQzM8vc6WA ($23.05 in chips)
gsugPj31Hui3Jefl98MBOA: posts small blind $1
qXDd0ZyMIse0OBu8pxeQ3Q: posts big blind $2
*** HOLE CARDS ***
3dAbvkxS5NPQTBAbvpinVg: folds
09BNF4quPDzanQzM8vc6WA: raises $2 to $4
VvdR9F3I+2yELkfTVvC1dg: folds
B87ikIyZ/TzAVeXf38Ny0g: folds
gsugPj31Hui3Jefl98MBOA: folds
qXDd0ZyMIse0OBu8pxeQ3Q: folds
09BNF4quPDzanQzM8vc6WA collected $5 from pot
09BNF4quPDzanQzM8vc6WA: doesn't show hand
*** SUMMARY ***
Total pot $5 | Rake $0
Seat 1: VvdR9F3I+2yELkfTVvC1dg folded before Flop (didn't bet)
Seat 2: B87ikIyZ/TzAVeXf38Ny0g (button) folded before Flop (didn't bet)
Seat 3: gsugPj31Hui3Jefl98MBOA (small blind) folded before Flop
Seat 4: qXDd0ZyMIse0OBu8pxeQ3Q (big blind) folded before Flop
Seat 5: 3dAbvkxS5NPQTBAbvpinVg folded before Flop (didn't bet)
Seat 6: 09BNF4quPDzanQzM8vc6WA collected ($5)



PokerStars Game #59941283742:  Hold'em No Limit ($1/$2) - 2009/07/01 1:30:57 ET
Table 'uJ9juaXXg9yIcSU8amxaXQ' 6-max Seat #4 is the button
Seat 1: JsqOjN/eHz0uYVf/PyUJ6Q ($144.50 in chips)
Seat 2: VvdR9F3I+2yELkfTVvC1dg ($229.10 in chips)
Seat 3: qXDd0ZyMIse0OBu8pxeQ3Q ($247.40 in chips)
Seat 4: zNjJ/y4emmF+vzrCDd+ooA ($236.55 in chips)
Seat 5: YsLQ3BAvgQHWXMAv3Wv6Hg ($200 in chips)
Seat 6: 2DFp9Veq1xxq64dCjwNuUw ($53.60 in chips)
YsLQ3BAvgQHWXMAv3Wv6Hg: posts small blind $1
2DFp9Veq1xxq64dCjwNuUw: posts big blind $2
*** HOLE CARDS ***
JsqOjN/eHz0uYVf/PyUJ6Q: folds
VvdR9F3I+2yELkfTVvC1dg: folds
qXDd0ZyMIse0OBu8pxeQ3Q: folds
zNjJ/y4emmF+vzrCDd+ooA: folds
YsLQ3BAvgQHWXMAv3Wv6Hg: folds
2DFp9Veq1xxq64dCjwNuUw collected $2 from pot
*** SUMMARY ***
Total pot $2 | Rake $0
Seat 1: JsqOjN/eHz0uYVf/PyUJ6Q folded before Flop (didn't bet)
Seat 2: VvdR9F3I+2yELkfTVvC1dg folded before Flop (didn't bet)
Seat 3: qXDd0ZyMIse0OBu8pxeQ3Q folded before Flop (didn't bet)
Seat 4: zNjJ/y4emmF+vzrCDd+ooA (button) folded before Flop (didn't bet)
Seat 5: YsLQ3BAvgQHWXMAv3Wv6Hg (small blind) folded before Flop
Seat 6: 2DFp9Veq1xxq64dCjwNuUw (big blind) collected ($2)



PokerStars Game #59941283782:  Hold'em No Limit ($1/$2) - 2009/07/01 1:30:57 ET
Table 'NmY84NAf9Mh0ckAckHnh5g' 2-max Seat #1 is the button
Seat 1: 6hvg964TSqZ3AL/0XK9aVQ ($337.90 in chips)
Seat 2: RwDoM55ZeQuI2ADyJhOb2Q ($661.70 in chips)
6hvg964TSqZ3AL/0XK9aVQ: posts small blind $1
RwDoM55ZeQuI2ADyJhOb2Q: posts big blind $2
*** HOLE CARDS ***
6hvg964TSqZ3AL/0XK9aVQ: calls $1
RwDoM55ZeQuI2ADyJhOb2Q: checks
*** FLOP *** [Ad Qh 4s]
RwDoM55ZeQuI2ADyJhOb2Q: checks
6hvg964TSqZ3AL/0XK9aVQ: checks
*** TURN *** [Ad Qh 4s] [7c]
RwDoM55ZeQuI2ADyJhOb2Q: checks
6hvg964TSqZ3AL/0XK9aVQ: checks
*** RIVER *** [Ad Qh 4s 7c] [9h]
RwDoM55ZeQuI2ADyJhOb2Q: checks
6hvg964TSqZ3AL/0XK9aVQ: checks
*** SHOW DOWN ***
RwDoM55ZeQuI2ADyJhOb2Q: shows [8s 3c] (high card Ace)
6hvg964TSqZ3AL/0XK9aVQ: shows [Kh Jh] (high card Ace - King kicker)
6hvg964TSqZ3AL/0XK9aVQ collected $3.80 from pot
*** SUMMARY ***
Total pot $4 | Rake $0.20
Board [Ad Qh 4s 7c 9h]
Seat 1: 6hvg964TSqZ3AL/0XK9aVQ (button) (small blind) showed [Kh Jh] and won ($3.80) with high card Ace
Seat 2: RwDoM55ZeQuI2ADyJhOb2Q (big blind) showed [8s 3c] and lost with high card Ace



PokerStars Game #59941284100:  Hold'em No Limit ($1/$2) - 2009/07/01 1:30:57 ET
Table 'eTkRjRjsYr567snmNk8kNQ' 2-max Seat #2 is the button
Seat 1: t6Jd836OSEMbcRi7rfGp5g ($247.50 in chips)
Seat 2: UNpnKQk0gkkyFJen8upqag ($249 in chips)
UNpnKQk0gkkyFJen8upqag: posts small blind $1
t6Jd836OSEMbcRi7rfGp5g: posts big blind $2
*** HOLE CARDS ***
UNpnKQk0gkkyFJen8upqag: raises $4 to $6
t6Jd836OSEMbcRi7rfGp5g: raises $14 to $20
UNpnKQk0gkkyFJen8upqag: calls $14
*** FLOP *** [8c 4c 5h]
t6Jd836OSEMbcRi7rfGp5g: bets $22
UNpnKQk0gkkyFJen8upqag: raises $38 to $60
t6Jd836OSEMbcRi7rfGp5g: folds
UNpnKQk0gkkyFJen8upqag collected $83.50 from pot
*** SUMMARY ***
Total pot $84 | Rake $0.50
Board [8c 4c 5h]
Seat 1: t6Jd836OSEMbcRi7rfGp5g (big blind) folded on the Flop
Seat 2: UNpnKQk0gkkyFJen8upqag (button) (small blind) collected ($83.50)



PokerStars Game #59941284856:  Hold'em No Limit ($1/$2) - 2009/07/01 1:30:59 ET
Table 'aSf77Sj8QEnzcc0WaxVD4Q' 6-max Seat #3 is the button
Seat 1: UELtvp+JfwI7XDGVwSxZXA ($149.55 in chips)
Seat 2: vkfxu8f/jMYKUk6Ly4eujw ($211.80 in chips)
Seat 3: 9dpyyjDTCed6nV7JhaUUpw ($526.70 in chips)
Seat 4: YsLQ3BAvgQHWXMAv3Wv6Hg ($257.70 in chips)
Seat 5: VvdR9F3I+2yELkfTVvC1dg ($240 in chips)
Seat 6: vkoJRf3gidxY1pPi0AFWww ($129.60 in chips)
YsLQ3BAvgQHWXMAv3Wv6Hg: posts small blind $1
VvdR9F3I+2yELkfTVvC1dg: posts big blind $2
*** HOLE CARDS ***
vkoJRf3gidxY1pPi0AFWww: folds
UELtvp+JfwI7XDGVwSxZXA: calls $2
vkfxu8f/jMYKUk6Ly4eujw: raises $8 to $10
9dpyyjDTCed6nV7JhaUUpw: folds
YsLQ3BAvgQHWXMAv3Wv6Hg: raises $16 to $26
VvdR9F3I+2yELkfTVvC1dg: folds
UELtvp+JfwI7XDGVwSxZXA: folds
vkfxu8f/jMYKUk6Ly4eujw: folds
YsLQ3BAvgQHWXMAv3Wv6Hg collected $24 from pot
YsLQ3BAvgQHWXMAv3Wv6Hg: doesn't show hand
*** SUMMARY ***
Total pot $24 | Rake $0
Seat 1: UELtvp+JfwI7XDGVwSxZXA folded before Flop
Seat 2: vkfxu8f/jMYKUk6Ly4eujw folded before Flop
Seat 3: 9dpyyjDTCed6nV7JhaUUpw (button) folded before Flop (didn't bet)
Seat 4: YsLQ3BAvgQHWXMAv3Wv6Hg (small blind) collected ($24)
Seat 5: VvdR9F3I+2yELkfTVvC1dg (big blind) folded before Flop
Seat 6: vkoJRf3gidxY1pPi0AFWww folded before Flop (didn't bet)



PokerStars Game #59941285086:  Hold'em No Limit ($1/$2) - 2009/07/01 1:30:59 ET
Table 'on4i1U1lCRmxsduFD3xiSg' 9-max Seat #5 is the button
Seat 1: so5k3vFDmokh2q3dImJ1GQ ($179.30 in chips)
Seat 2: NqSvZNzJ4RkR3sCmgQnyLw ($9.60 in chips)
Seat 3: GX1heJ+DSsvm7gzSPsYhhQ ($37.70 in chips)
Seat 4: DFQVuszLVclqjA46pN4Vvw ($53 in chips)
Seat 5: 37j/5DgMG5m9lMfFofEAOg ($82.35 in chips)
Seat 6: +T/63sAeZzWyHchahJ36GQ ($38 in chips)
Seat 7: /inIs/z/PcX+TniIFpaxpg ($302.40 in chips)
Seat 9: iMe5yhc+1BaiIPHet3NMrA ($208.25 in chips)
+T/63sAeZzWyHchahJ36GQ: posts small blind $1
/inIs/z/PcX+TniIFpaxpg: posts big blind $2
ZYHoLw2lWmRS7CSHi8L8Xg: sits out
*** HOLE CARDS ***
iMe5yhc+1BaiIPHet3NMrA: folds
so5k3vFDmokh2q3dImJ1GQ: folds
NqSvZNzJ4RkR3sCmgQnyLw: folds
GX1heJ+DSsvm7gzSPsYhhQ: calls $2
DFQVuszLVclqjA46pN4Vvw: raises $6 to $8
37j/5DgMG5m9lMfFofEAOg: calls $8
+T/63sAeZzWyHchahJ36GQ: folds
/inIs/z/PcX+TniIFpaxpg: folds
GX1heJ+DSsvm7gzSPsYhhQ: calls $6
*** FLOP *** [Jd Kc Qh]
GX1heJ+DSsvm7gzSPsYhhQ: checks
DFQVuszLVclqjA46pN4Vvw: bets $12
37j/5DgMG5m9lMfFofEAOg: raises $12 to $24
GX1heJ+DSsvm7gzSPsYhhQ: folds
DFQVuszLVclqjA46pN4Vvw: calls $12
*** TURN *** [Jd Kc Qh] [7s]
DFQVuszLVclqjA46pN4Vvw: checks
37j/5DgMG5m9lMfFofEAOg: bets $22
DFQVuszLVclqjA46pN4Vvw: calls $21 and is all-in
*** RIVER *** [Jd Kc Qh 7s] [4d]
*** SHOW DOWN ***
DFQVuszLVclqjA46pN4Vvw: shows [Ah Ac] (a pair of Aces)
37j/5DgMG5m9lMfFofEAOg: mucks hand
DFQVuszLVclqjA46pN4Vvw collected $114 from pot
*** SUMMARY ***
Total pot $117 | Rake $3
Board [Jd Kc Qh 7s 4d]
Seat 1: so5k3vFDmokh2q3dImJ1GQ folded before Flop (didn't bet)
Seat 2: NqSvZNzJ4RkR3sCmgQnyLw folded before Flop (didn't bet)
Seat 3: GX1heJ+DSsvm7gzSPsYhhQ folded on the Flop
Seat 4: DFQVuszLVclqjA46pN4Vvw showed [Ah Ac] and won ($114) with a pair of Aces
Seat 5: 37j/5DgMG5m9lMfFofEAOg (button) mucked
Seat 6: +T/63sAeZzWyHchahJ36GQ (small blind) folded before Flop
Seat 7: /inIs/z/PcX+TniIFpaxpg (big blind) folded before Flop
Seat 9: iMe5yhc+1BaiIPHet3NMrA folded before Flop (didn't bet)



PokerStars Game #59941285422:  Hold'em No Limit ($1/$2) - 2009/07/01 1:31:00 ET
Table 'UGLAZZyv+cXmnKjYin0etA' 6-max Seat #5 is the button
Seat 1: vkfxu8f/jMYKUk6Ly4eujw ($200 in chips)
Seat 2: eDLH1PUXFpvJBNMXBVQcGA ($276.35 in chips)
Seat 3: ygTTt5ehT4aF86q1a8/R+w ($117.20 in chips)
Seat 4: SiGJDsvRViJX05vHhA80GQ ($197 in chips)
Seat 5: 54yWzRRgS0oZ+S6LwZBxMQ ($35.45 in chips)
vkfxu8f/jMYKUk6Ly4eujw: posts small blind $1
eDLH1PUXFpvJBNMXBVQcGA: posts big blind $2
*** HOLE CARDS ***
ygTTt5ehT4aF86q1a8/R+w: folds
SiGJDsvRViJX05vHhA80GQ: folds
54yWzRRgS0oZ+S6LwZBxMQ: folds
vkfxu8f/jMYKUk6Ly4eujw: folds
eDLH1PUXFpvJBNMXBVQcGA collected $2 from pot
*** SUMMARY ***
Total pot $2 | Rake $0
Seat 1: vkfxu8f/jMYKUk6Ly4eujw (small blind) folded before Flop
Seat 2: eDLH1PUXFpvJBNMXBVQcGA (big blind) collected ($2)
Seat 3: ygTTt5ehT4aF86q1a8/R+w folded before Flop (didn't bet)
Seat 4: SiGJDsvRViJX05vHhA80GQ folded before Flop (didn't bet)
Seat 5: 54yWzRRgS0oZ+S6LwZBxMQ (button) folded before Flop (didn't bet)



PokerStars Game #59941287796:  Hold'em No Limit ($1/$2) - 2009/07/01 1:31:04 ET
Table 'gftD4mDF7mIFKvSrIyaRbw' 9-max Seat #8 is the button
Seat 2: GX1heJ+DSsvm7gzSPsYhhQ ($43 in chips)
Seat 3: CUZwDpLTQKhzarPe+JCLOQ ($200 in chips)
Seat 4: /inIs/z/PcX+TniIFpaxpg ($40 in chips)
Seat 5: mpsfNtnMVDqQHTe92AhIdw ($119.10 in chips)
Seat 6: 2NvwF8W2nzsbS+G//yLAbQ ($113.85 in chips)
Seat 7: +T/63sAeZzWyHchahJ36GQ ($42 in chips)
Seat 8: MpL4DeEqGQu0H8TJEbEOrg ($41 in chips)
GX1heJ+DSsvm7gzSPsYhhQ: posts small blind $1
CUZwDpLTQKhzarPe+JCLOQ: posts big blind $2
*** HOLE CARDS ***
/inIs/z/PcX+TniIFpaxpg: folds
mpsfNtnMVDqQHTe92AhIdw: calls $2
2NvwF8W2nzsbS+G//yLAbQ: folds
+T/63sAeZzWyHchahJ36GQ: folds
MpL4DeEqGQu0H8TJEbEOrg: folds
GX1heJ+DSsvm7gzSPsYhhQ: folds
CUZwDpLTQKhzarPe+JCLOQ: checks
*** FLOP *** [Kc 9d 8c]
CUZwDpLTQKhzarPe+JCLOQ: checks
mpsfNtnMVDqQHTe92AhIdw: checks
*** TURN *** [Kc 9d 8c] [2d]
CUZwDpLTQKhzarPe+JCLOQ: checks
mpsfNtnMVDqQHTe92AhIdw: checks
*** RIVER *** [Kc 9d 8c 2d] [4d]
CUZwDpLTQKhzarPe+JCLOQ: bets $2
mpsfNtnMVDqQHTe92AhIdw: folds
CUZwDpLTQKhzarPe+JCLOQ collected $4.75 from pot
CUZwDpLTQKhzarPe+JCLOQ: doesn't show hand
*** SUMMARY ***
Total pot $5 | Rake $0.25
Board [Kc 9d 8c 2d 4d]
Seat 2: GX1heJ+DSsvm7gzSPsYhhQ (small blind) folded before Flop
Seat 3: CUZwDpLTQKhzarPe+JCLOQ (big blind) collected ($4.75)
Seat 4: /inIs/z/PcX+TniIFpaxpg folded before Flop (didn't bet)
Seat 5: mpsfNtnMVDqQHTe92AhIdw folded on the River
Seat 6: 2NvwF8W2nzsbS+G//yLAbQ folded before Flop (didn't bet)
Seat 7: +T/63sAeZzWyHchahJ36GQ folded before Flop (didn't bet)
Seat 8: MpL4DeEqGQu0H8TJEbEOrg (button) folded before Flop (didn't bet)



PokerStars Game #59941290106:  Hold'em No Limit ($1/$2) - 2009/07/01 1:31:08 ET
Table 'G1Oqdy4Pqdb5gtx40rUBzA' 6-max Seat #6 is the button
Seat 1: ubtx4Z5L+AcK71MTvYiGVw ($201 in chips)
Seat 2: 4uqU0dG67owXuPz303Al4w ($518.25 in chips)
Seat 3: VvdR9F3I+2yELkfTVvC1dg ($241.25 in chips)
Seat 4: B87ikIyZ/TzAVeXf38Ny0g ($200 in chips)
Seat 5: F1+Ml47qRQWunzPnGhLLzQ ($186.50 in chips)
Seat 6: qCnEYuAE5y5A7bk6fO5/jQ ($200 in chips)
ubtx4Z5L+AcK71MTvYiGVw: posts small blind $1
4uqU0dG67owXuPz303Al4w: posts big blind $2
*** HOLE CARDS ***
VvdR9F3I+2yELkfTVvC1dg: folds
B87ikIyZ/TzAVeXf38Ny0g: raises $4 to $6
F1+Ml47qRQWunzPnGhLLzQ: folds
qCnEYuAE5y5A7bk6fO5/jQ: folds
ubtx4Z5L+AcK71MTvYiGVw: calls $5
4uqU0dG67owXuPz303Al4w: folds
*** FLOP *** [5s 5d 2d]
ubtx4Z5L+AcK71MTvYiGVw: checks
B87ikIyZ/TzAVeXf38Ny0g: bets $8
ubtx4Z5L+AcK71MTvYiGVw: calls $8
*** TURN *** [5s 5d 2d] [3h]
ubtx4Z5L+AcK71MTvYiGVw: checks
B87ikIyZ/TzAVeXf38Ny0g: bets $20
ubtx4Z5L+AcK71MTvYiGVw: folds
B87ikIyZ/TzAVeXf38Ny0g collected $28.55 from pot
B87ikIyZ/TzAVeXf38Ny0g: doesn't show hand
*** SUMMARY ***
Total pot $30 | Rake $1.45
Board [5s 5d 2d 3h]
Seat 1: ubtx4Z5L+AcK71MTvYiGVw (small blind) folded on the Turn
Seat 2: 4uqU0dG67owXuPz303Al4w (big blind) folded before Flop
Seat 3: VvdR9F3I+2yELkfTVvC1dg folded before Flop (didn't bet)
Seat 4: B87ikIyZ/TzAVeXf38Ny0g collected ($28.55)
Seat 5: F1+Ml47qRQWunzPnGhLLzQ folded before Flop (didn't bet)
Seat 6: qCnEYuAE5y5A7bk6fO5/jQ (button) folded before Flop (didn't bet)



PokerStars Game #59941291504:  Hold'em No Limit ($1/$2) - 2009/07/01 1:31:10 ET
Table '/ci73fTmzTzmGWzAtqEX2Q' 9-max Seat #1 is the button
Seat 1: 9efVc1cB3yHt4TvBkTusPw ($146.90 in chips)
Seat 2: pN/Ip0ePsUVIdUlGgLrkUw ($226 in chips)
Seat 3: kK1+5ivyJZeA8hQF2pdvvQ ($74.55 in chips)
Seat 4: 2yq7Zp4xmrhAw8+37hTkaA ($165.40 in chips)
Seat 5: 1CtiZuXDFaJL1dJPQKyi8Q ($215 in chips)
Seat 6: GX1heJ+DSsvm7gzSPsYhhQ ($47.65 in chips)
Seat 7: rW/MyplHylMSBRaoRUzWrg ($49 in chips)
Seat 8: /inIs/z/PcX+TniIFpaxpg ($37 in chips)
Seat 9: S8aS+9FTYQ/ICLBNThcrkg ($183 in chips)
pN/Ip0ePsUVIdUlGgLrkUw: posts small blind $1
kK1+5ivyJZeA8hQF2pdvvQ: posts big blind $2
*** HOLE CARDS ***
2yq7Zp4xmrhAw8+37hTkaA: folds
1CtiZuXDFaJL1dJPQKyi8Q: folds
GX1heJ+DSsvm7gzSPsYhhQ: folds
rW/MyplHylMSBRaoRUzWrg: raises $6 to $8
/inIs/z/PcX+TniIFpaxpg: folds
S8aS+9FTYQ/ICLBNThcrkg: folds
9efVc1cB3yHt4TvBkTusPw: folds
pN/Ip0ePsUVIdUlGgLrkUw: folds
kK1+5ivyJZeA8hQF2pdvvQ: calls $6
*** FLOP *** [6h Jd 2c]
kK1+5ivyJZeA8hQF2pdvvQ: checks
rW/MyplHylMSBRaoRUzWrg: bets $8
kK1+5ivyJZeA8hQF2pdvvQ: folds
rW/MyplHylMSBRaoRUzWrg collected $16.15 from pot
rW/MyplHylMSBRaoRUzWrg: doesn't show hand
*** SUMMARY ***
Total pot $17 | Rake $0.85
Board [6h Jd 2c]
Seat 1: 9efVc1cB3yHt4TvBkTusPw (button) folded before Flop (didn't bet)
Seat 2: pN/Ip0ePsUVIdUlGgLrkUw (small blind) folded before Flop
Seat 3: kK1+5ivyJZeA8hQF2pdvvQ (big blind) folded on the Flop
Seat 4: 2yq7Zp4xmrhAw8+37hTkaA folded before Flop (didn't bet)
Seat 5: 1CtiZuXDFaJL1dJPQKyi8Q folded before Flop (didn't bet)
Seat 6: GX1heJ+DSsvm7gzSPsYhhQ folded before Flop (didn't bet)
Seat 7: rW/MyplHylMSBRaoRUzWrg collected ($16.15)
Seat 8: /inIs/z/PcX+TniIFpaxpg folded before Flop (didn't bet)
Seat 9: S8aS+9FTYQ/ICLBNThcrkg folded before Flop (didn't bet)



PokerStars Game #59941291742:  Hold'em No Limit ($1/$2) - 2009/07/01 1:31:11 ET
Table 'rKeCh+eBn4RNvybCUYkoTQ' 9-max Seat #6 is the button
Seat 1: /inIs/z/PcX+TniIFpaxpg ($200 in chips)
Seat 2: 9cBHwK40Tl06vheE7B3LHQ ($157.80 in chips)
Seat 3: GX1heJ+DSsvm7gzSPsYhhQ ($40 in chips)
Seat 5: WUlHm+ydPPHG7Lb0rePSdA ($120 in chips)
Seat 6: EBV6OktyeSmh4w6sWmcWOw ($267 in chips)
Seat 7: rW/MyplHylMSBRaoRUzWrg ($32 in chips)
Seat 8: pN/Ip0ePsUVIdUlGgLrkUw ($215.35 in chips)
Seat 9: Kzta8yu9vxHT4B70mjBZ+w ($211.25 in chips)
rW/MyplHylMSBRaoRUzWrg: posts small blind $1
pN/Ip0ePsUVIdUlGgLrkUw: posts big blind $2
*** HOLE CARDS ***
Kzta8yu9vxHT4B70mjBZ+w: folds
/inIs/z/PcX+TniIFpaxpg: folds
9cBHwK40Tl06vheE7B3LHQ: raises $4 to $6
GX1heJ+DSsvm7gzSPsYhhQ: folds
WUlHm+ydPPHG7Lb0rePSdA: calls $6
EBV6OktyeSmh4w6sWmcWOw: folds
rW/MyplHylMSBRaoRUzWrg: folds
pN/Ip0ePsUVIdUlGgLrkUw: calls $4
*** FLOP *** [Tc 4h Qs]
pN/Ip0ePsUVIdUlGgLrkUw: checks
9cBHwK40Tl06vheE7B3LHQ: bets $6
WUlHm+ydPPHG7Lb0rePSdA: folds
pN/Ip0ePsUVIdUlGgLrkUw: calls $6
*** TURN *** [Tc 4h Qs] [Kc]
pN/Ip0ePsUVIdUlGgLrkUw: checks
9cBHwK40Tl06vheE7B3LHQ: bets $6
pN/Ip0ePsUVIdUlGgLrkUw: raises $10 to $16
9cBHwK40Tl06vheE7B3LHQ: calls $10
*** RIVER *** [Tc 4h Qs Kc] [6c]
pN/Ip0ePsUVIdUlGgLrkUw: bets $22
9cBHwK40Tl06vheE7B3LHQ: folds
pN/Ip0ePsUVIdUlGgLrkUw collected $60 from pot
pN/Ip0ePsUVIdUlGgLrkUw: doesn't show hand
*** SUMMARY ***
Total pot $63 | Rake $3
Board [Tc 4h Qs Kc 6c]
Seat 1: /inIs/z/PcX+TniIFpaxpg folded before Flop (didn't bet)
Seat 2: 9cBHwK40Tl06vheE7B3LHQ folded on the River
Seat 3: GX1heJ+DSsvm7gzSPsYhhQ folded before Flop (didn't bet)
Seat 5: WUlHm+ydPPHG7Lb0rePSdA folded on the Flop
Seat 6: EBV6OktyeSmh4w6sWmcWOw (button) folded before Flop (didn't bet)
Seat 7: rW/MyplHylMSBRaoRUzWrg (small blind) folded before Flop
Seat 8: pN/Ip0ePsUVIdUlGgLrkUw (big blind) collected ($60)
Seat 9: Kzta8yu9vxHT4B70mjBZ+w folded before Flop (didn't bet)



PokerStars Game #59941292606:  Hold'em No Limit ($1/$2) - 2009/07/01 1:31:12 ET
Table 'W9UeSV0aoPjh5SFSxM8jUQ' 9-max Seat #8 is the button
Seat 1: mIKx5lhIt13X5eZQH0ZeMA ($23 in chips)
Seat 2: iMe5yhc+1BaiIPHet3NMrA ($252.60 in chips)
Seat 3: /inIs/z/PcX+TniIFpaxpg ($25 in chips)
Seat 4: 4YA/sQy1Emm680zhbPUjow ($136.35 in chips)
Seat 5: ri8CLkX3e9JF34dQNbsHGA ($40 in chips)
Seat 6: j47DM+lqTfzZP8musviQTg ($129.30 in chips)
Seat 7: I2ipWauytvrkEer4XD3Sjg ($83.70 in chips)
Seat 8: odhvI/CZeMsPyo1n1U7+hA ($40.40 in chips)
Seat 9: Q104K4iDGcqOlVrjAkzPEA ($96.10 in chips)
Q104K4iDGcqOlVrjAkzPEA: posts small blind $1
mIKx5lhIt13X5eZQH0ZeMA: posts big blind $2
*** HOLE CARDS ***
iMe5yhc+1BaiIPHet3NMrA: folds
/inIs/z/PcX+TniIFpaxpg: folds
4YA/sQy1Emm680zhbPUjow: folds
ri8CLkX3e9JF34dQNbsHGA: folds
j47DM+lqTfzZP8musviQTg: folds
I2ipWauytvrkEer4XD3Sjg: calls $2
odhvI/CZeMsPyo1n1U7+hA: folds
Q104K4iDGcqOlVrjAkzPEA: folds
mIKx5lhIt13X5eZQH0ZeMA: checks
*** FLOP *** [Js 2s 2c]
mIKx5lhIt13X5eZQH0ZeMA: checks
I2ipWauytvrkEer4XD3Sjg: bets $4
mIKx5lhIt13X5eZQH0ZeMA: raises $6 to $10
I2ipWauytvrkEer4XD3Sjg: folds
mIKx5lhIt13X5eZQH0ZeMA collected $12.40 from pot
*** SUMMARY ***
Total pot $13 | Rake $0.60
Board [Js 2s 2c]
Seat 1: mIKx5lhIt13X5eZQH0ZeMA (big blind) collected ($12.40)
Seat 2: iMe5yhc+1BaiIPHet3NMrA folded before Flop (didn't bet)
Seat 3: /inIs/z/PcX+TniIFpaxpg folded before Flop (didn't bet)
Seat 4: 4YA/sQy1Emm680zhbPUjow folded before Flop (didn't bet)
Seat 5: ri8CLkX3e9JF34dQNbsHGA folded before Flop (didn't bet)
Seat 6: j47DM+lqTfzZP8musviQTg folded before Flop (didn't bet)
Seat 7: I2ipWauytvrkEer4XD3Sjg folded on the Flop
Seat 8: odhvI/CZeMsPyo1n1U7+hA (button) folded before Flop (didn't bet)
Seat 9: Q104K4iDGcqOlVrjAkzPEA (small blind) folded before Flop



PokerStars Game #59941293156:  Hold'em No Limit ($1/$2) - 2009/07/01 1:31:13 ET
Table 'YqGfR5eHfMeSjb9a+QU9rg' 9-max Seat #4 is the button
Seat 1: rW/MyplHylMSBRaoRUzWrg ($34 in chips)
Seat 2: W3Nqt1GWlTi9tXQXMNEvgw ($401.85 in chips)
Seat 3: /gll27k+xWYV7Fbki0lFDQ ($258.75 in chips)
Seat 4: GX1heJ+DSsvm7gzSPsYhhQ ($37 in chips)
Seat 5: CkE3IyJF1KvdaAOmZY5XqQ ($201 in chips)
Seat 6: TAfo4veNRaRlzDXMMYS3Jg ($37 in chips)
Seat 7: 41aZuLBz9nAi2GPVKabmCw ($98.20 in chips)
Seat 8: JnV3SM2D6dAFYyGZHHpvrg ($93.25 in chips)
Seat 9: /inIs/z/PcX+TniIFpaxpg ($205.20 in chips)
CkE3IyJF1KvdaAOmZY5XqQ: posts small blind $1
TAfo4veNRaRlzDXMMYS3Jg: posts big blind $2
*** HOLE CARDS ***
41aZuLBz9nAi2GPVKabmCw: calls $2
JnV3SM2D6dAFYyGZHHpvrg: folds
/inIs/z/PcX+TniIFpaxpg: folds
rW/MyplHylMSBRaoRUzWrg: folds
W3Nqt1GWlTi9tXQXMNEvgw: folds
/gll27k+xWYV7Fbki0lFDQ: folds
GX1heJ+DSsvm7gzSPsYhhQ: folds
CkE3IyJF1KvdaAOmZY5XqQ: folds
TAfo4veNRaRlzDXMMYS3Jg: checks
*** FLOP *** [6c 2h Jd]
TAfo4veNRaRlzDXMMYS3Jg: checks
41aZuLBz9nAi2GPVKabmCw: checks
*** TURN *** [6c 2h Jd] [As]
TAfo4veNRaRlzDXMMYS3Jg: checks
41aZuLBz9nAi2GPVKabmCw: checks
*** RIVER *** [6c 2h Jd As] [7s]
TAfo4veNRaRlzDXMMYS3Jg: checks
41aZuLBz9nAi2GPVKabmCw: bets $2
TAfo4veNRaRlzDXMMYS3Jg: folds
41aZuLBz9nAi2GPVKabmCw collected $4.75 from pot
*** SUMMARY ***
Total pot $5 | Rake $0.25
Board [6c 2h Jd As 7s]
Seat 1: rW/MyplHylMSBRaoRUzWrg folded before Flop (didn't bet)
Seat 2: W3Nqt1GWlTi9tXQXMNEvgw folded before Flop (didn't bet)
Seat 3: /gll27k+xWYV7Fbki0lFDQ folded before Flop (didn't bet)
Seat 4: GX1heJ+DSsvm7gzSPsYhhQ (button) folded before Flop (didn't bet)
Seat 5: CkE3IyJF1KvdaAOmZY5XqQ (small blind) folded before Flop
Seat 6: TAfo4veNRaRlzDXMMYS3Jg (big blind) folded on the River
Seat 7: 41aZuLBz9nAi2GPVKabmCw collected ($4.75)
Seat 8: JnV3SM2D6dAFYyGZHHpvrg folded before Flop (didn't bet)
Seat 9: /inIs/z/PcX+TniIFpaxpg folded before Flop (didn't bet)



PokerStars Game #59941292990:  Hold'em No Limit ($1/$2) - 2009/07/01 1:31:13 ET
Table 'ztv6V3FN2bQ9nmJPPdx6nQ' 6-max Seat #6 is the button
Seat 1: 6fLdOUCRtX71xbVRhJEq8w ($242.35 in chips)
Seat 2: 5Y+ZGWLI4gnlpApDX5vy1A ($389.75 in chips)
Seat 3: ubtx4Z5L+AcK71MTvYiGVw ($242 in chips)
Seat 6: mfy7uGZcqA2PVQqEVbJ7+g ($97.45 in chips)
6fLdOUCRtX71xbVRhJEq8w: posts small blind $1
5Y+ZGWLI4gnlpApDX5vy1A: posts big blind $2
*** HOLE CARDS ***
ubtx4Z5L+AcK71MTvYiGVw: raises $6 to $8
mfy7uGZcqA2PVQqEVbJ7+g: folds
6fLdOUCRtX71xbVRhJEq8w: folds
5Y+ZGWLI4gnlpApDX5vy1A: folds
ubtx4Z5L+AcK71MTvYiGVw collected $5 from pot
ubtx4Z5L+AcK71MTvYiGVw: doesn't show hand
*** SUMMARY ***
Total pot $5 | Rake $0
Seat 1: 6fLdOUCRtX71xbVRhJEq8w (small blind) folded before Flop
Seat 2: 5Y+ZGWLI4gnlpApDX5vy1A (big blind) folded before Flop
Seat 3: ubtx4Z5L+AcK71MTvYiGVw collected ($5)
Seat 6: mfy7uGZcqA2PVQqEVbJ7+g (button) folded before Flop (didn't bet)



PokerStars Game #59941294006:  Hold'em No Limit ($1/$2) - 2009/07/01 1:31:15 ET
Table 'TsEDkiO4tzCTCzJ7tNdEqw' 6-max Seat #6 is the button
Seat 1: MfXQsYD8pGeCS7XOtyV+vw ($89.05 in chips)
Seat 2: 4dcDwIHRm96PwtqkpQiuiA ($78.10 in chips)
Seat 3: ubtx4Z5L+AcK71MTvYiGVw ($205 in chips)
Seat 4: K8MXCrNAVYlMnnCeM32Kxw ($117.50 in chips)
Seat 5: VvdR9F3I+2yELkfTVvC1dg ($263.35 in chips)
Seat 6: uCqEjnxh2/vFBjKYkfTOkw ($147.55 in chips)
MfXQsYD8pGeCS7XOtyV+vw: posts small blind $1
4dcDwIHRm96PwtqkpQiuiA: posts big blind $2
*** HOLE CARDS ***
ubtx4Z5L+AcK71MTvYiGVw: folds
K8MXCrNAVYlMnnCeM32Kxw: folds
VvdR9F3I+2yELkfTVvC1dg: folds
uCqEjnxh2/vFBjKYkfTOkw: raises $6 to $8
MfXQsYD8pGeCS7XOtyV+vw: folds
4dcDwIHRm96PwtqkpQiuiA: folds
uCqEjnxh2/vFBjKYkfTOkw collected $5 from pot
uCqEjnxh2/vFBjKYkfTOkw: doesn't show hand
*** SUMMARY ***
Total pot $5 | Rake $0
Seat 1: MfXQsYD8pGeCS7XOtyV+vw (small blind) folded before Flop
Seat 2: 4dcDwIHRm96PwtqkpQiuiA (big blind) folded before Flop
Seat 3: ubtx4Z5L+AcK71MTvYiGVw folded before Flop (didn't bet)
Seat 4: K8MXCrNAVYlMnnCeM32Kxw folded before Flop (didn't bet)
Seat 5: VvdR9F3I+2yELkfTVvC1dg folded before Flop (didn't bet)
Seat 6: uCqEjnxh2/vFBjKYkfTOkw (button) collected ($5)



PokerStars Game #59941295090:  Hold'em No Limit ($1/$2) - 2009/07/01 1:31:17 ET
Table 'LL4bDFyhj5hsMpzaDugJZg' 6-max Seat #4 is the button
Seat 1: FwvID/fQGlpY3soi/lMTww ($69.50 in chips)
Seat 2: IZng3w8jiJHHp3LbYKLi4w ($46.15 in chips)
Seat 3: iI/NMpRxMkGieArQEhACSA ($561.90 in chips)
Seat 4: 8srN1dKQePlsv0GyTada+Q ($224.40 in chips)
Seat 5: A2GTwTiwkb1ilNWgW487Vg ($113.80 in chips)
Seat 6: 692Q4sfB0gTElzS0WMeg+A ($200 in chips)
A2GTwTiwkb1ilNWgW487Vg: posts small blind $1
692Q4sfB0gTElzS0WMeg+A: posts big blind $2
*** HOLE CARDS ***
FwvID/fQGlpY3soi/lMTww: folds
IZng3w8jiJHHp3LbYKLi4w: folds
iI/NMpRxMkGieArQEhACSA: folds
8srN1dKQePlsv0GyTada+Q: raises $3 to $5
A2GTwTiwkb1ilNWgW487Vg: calls $4
692Q4sfB0gTElzS0WMeg+A: calls $3
*** FLOP *** [7d 8s 5s]
A2GTwTiwkb1ilNWgW487Vg: checks
692Q4sfB0gTElzS0WMeg+A: checks
8srN1dKQePlsv0GyTada+Q: bets $4
A2GTwTiwkb1ilNWgW487Vg: calls $4
692Q4sfB0gTElzS0WMeg+A: calls $4
*** TURN *** [7d 8s 5s] [Ks]
A2GTwTiwkb1ilNWgW487Vg: checks
692Q4sfB0gTElzS0WMeg+A: checks
8srN1dKQePlsv0GyTada+Q: checks
*** RIVER *** [7d 8s 5s Ks] [2d]
A2GTwTiwkb1ilNWgW487Vg: checks
692Q4sfB0gTElzS0WMeg+A: checks
8srN1dKQePlsv0GyTada+Q: checks
*** SHOW DOWN ***
A2GTwTiwkb1ilNWgW487Vg: shows [Qs Qd] (a pair of Queens)
692Q4sfB0gTElzS0WMeg+A: mucks hand
8srN1dKQePlsv0GyTada+Q: mucks hand
A2GTwTiwkb1ilNWgW487Vg collected $25.70 from pot
*** SUMMARY ***
Total pot $27 | Rake $1.30
Board [7d 8s 5s Ks 2d]
Seat 1: FwvID/fQGlpY3soi/lMTww folded before Flop (didn't bet)
Seat 2: IZng3w8jiJHHp3LbYKLi4w folded before Flop (didn't bet)
Seat 3: iI/NMpRxMkGieArQEhACSA folded before Flop (didn't bet)
Seat 4: 8srN1dKQePlsv0GyTada+Q (button) mucked
Seat 5: A2GTwTiwkb1ilNWgW487Vg (small blind) showed [Qs Qd] and won ($25.70) with a pair of Queens
Seat 6: 692Q4sfB0gTElzS0WMeg+A (big blind) mucked



PokerStars Game #59941295582:  Hold'em No Limit ($1/$2) - 2009/07/01 1:31:17 ET
Table 'o63a8j70meKHUtgLFryQvg' 9-max Seat #5 is the button
Seat 2: SgA0Zfa/3yhNp7ILXcXcCg ($121.35 in chips)
Seat 3: IYBKVnE2Basnr88BAhH+bQ ($200 in chips)
Seat 4: E/wxCEU7Mermau8PmlwQpQ ($40.55 in chips)
Seat 5: gH6NWmly6CC6es8sLmg5Hw ($54.70 in chips)
Seat 6: +T/63sAeZzWyHchahJ36GQ ($51.80 in chips)
Seat 7: tNMliKNvkBUMdXtfebzegg ($103.50 in chips)
Seat 8: ItDFe9gh5QYPQB9vC4ntUA ($304 in chips)
Seat 9: z89zAYE4dlPgjkofBKII0Q ($38 in chips)
+T/63sAeZzWyHchahJ36GQ: posts small blind $1
tNMliKNvkBUMdXtfebzegg: posts big blind $2
bringitonson: sits out
*** HOLE CARDS ***
ItDFe9gh5QYPQB9vC4ntUA: folds
z89zAYE4dlPgjkofBKII0Q: calls $2
SgA0Zfa/3yhNp7ILXcXcCg: raises $6 to $8
IYBKVnE2Basnr88BAhH+bQ: folds
E/wxCEU7Mermau8PmlwQpQ: folds
gH6NWmly6CC6es8sLmg5Hw: calls $8
+T/63sAeZzWyHchahJ36GQ: folds
tNMliKNvkBUMdXtfebzegg: calls $6
z89zAYE4dlPgjkofBKII0Q: calls $6
*** FLOP *** [2h Th 5c]
tNMliKNvkBUMdXtfebzegg: checks
z89zAYE4dlPgjkofBKII0Q: checks
SgA0Zfa/3yhNp7ILXcXcCg: checks
gH6NWmly6CC6es8sLmg5Hw: checks
*** TURN *** [2h Th 5c] [3s]
tNMliKNvkBUMdXtfebzegg: checks
z89zAYE4dlPgjkofBKII0Q: bets $12
SgA0Zfa/3yhNp7ILXcXcCg: calls $12
gH6NWmly6CC6es8sLmg5Hw: folds
tNMliKNvkBUMdXtfebzegg: folds
*** RIVER *** [2h Th 5c 3s] [6c]
z89zAYE4dlPgjkofBKII0Q: bets $18 and is all-in
SgA0Zfa/3yhNp7ILXcXcCg: folds
z89zAYE4dlPgjkofBKII0Q collected $54.25 from pot
z89zAYE4dlPgjkofBKII0Q: doesn't show hand
*** SUMMARY ***
Total pot $57 | Rake $2.75
Board [2h Th 5c 3s 6c]
Seat 2: SgA0Zfa/3yhNp7ILXcXcCg folded on the River
Seat 3: IYBKVnE2Basnr88BAhH+bQ folded before Flop (didn't bet)
Seat 4: E/wxCEU7Mermau8PmlwQpQ folded before Flop (didn't bet)
Seat 5: gH6NWmly6CC6es8sLmg5Hw (button) folded on the Turn
Seat 6: +T/63sAeZzWyHchahJ36GQ (small blind) folded before Flop
Seat 7: tNMliKNvkBUMdXtfebzegg (big blind) folded on the Turn
Seat 8: ItDFe9gh5QYPQB9vC4ntUA folded before Flop (didn't bet)
Seat 9: z89zAYE4dlPgjkofBKII0Q collected ($54.25)



PokerStars Game #59941296850:  Hold'em No Limit ($1/$2) - 2009/07/01 1:31:20 ET
Table 'NmY84NAf9Mh0ckAckHnh5g' 2-max Seat #2 is the button
Seat 1: 6hvg964TSqZ3AL/0XK9aVQ ($339.70 in chips)
Seat 2: RwDoM55ZeQuI2ADyJhOb2Q ($659.70 in chips)
RwDoM55ZeQuI2ADyJhOb2Q: posts small blind $1
6hvg964TSqZ3AL/0XK9aVQ: posts big blind $2
*** HOLE CARDS ***
RwDoM55ZeQuI2ADyJhOb2Q: folds
6hvg964TSqZ3AL/0XK9aVQ collected $2 from pot
6hvg964TSqZ3AL/0XK9aVQ: doesn't show hand
*** SUMMARY ***
Total pot $2 | Rake $0
Seat 1: 6hvg964TSqZ3AL/0XK9aVQ (big blind) collected ($2)
Seat 2: RwDoM55ZeQuI2ADyJhOb2Q (button) (small blind) folded before Flop



PokerStars Game #59941297722:  Hold'em No Limit ($1/$2) - 2009/07/01 1:31:21 ET
Table 'eLiKDgGuglnpCC8SYOPV/Q' 2-max Seat #2 is the button
Seat 1: 05+IW2KIkjP8ztSBO87NBQ ($183.85 in chips)
Seat 2: nkgQXzLsgyWHtV9qBIybXw ($55 in chips)
nkgQXzLsgyWHtV9qBIybXw: posts small blind $1
05+IW2KIkjP8ztSBO87NBQ: posts big blind $2
*** HOLE CARDS ***
nkgQXzLsgyWHtV9qBIybXw: raises $4 to $6
05+IW2KIkjP8ztSBO87NBQ: raises $10 to $16
nkgQXzLsgyWHtV9qBIybXw: raises $10 to $26
05+IW2KIkjP8ztSBO87NBQ: raises $10 to $36
nkgQXzLsgyWHtV9qBIybXw: raises $10 to $46
05+IW2KIkjP8ztSBO87NBQ: raises $10 to $56
nkgQXzLsgyWHtV9qBIybXw: folds
05+IW2KIkjP8ztSBO87NBQ collected $92 from pot
*** SUMMARY ***
Total pot $92 | Rake $0
Seat 1: 05+IW2KIkjP8ztSBO87NBQ (big blind) collected ($92)
Seat 2: nkgQXzLsgyWHtV9qBIybXw (button) (small blind) folded before Flop



PokerStars Game #59941298494:  Hold'em No Limit ($1/$2) - 2009/07/01 1:31:22 ET
Table 'UGLAZZyv+cXmnKjYin0etA' 6-max Seat #1 is the button
Seat 1: vkfxu8f/jMYKUk6Ly4eujw ($199 in chips)
Seat 2: eDLH1PUXFpvJBNMXBVQcGA ($277.35 in chips)
Seat 3: ygTTt5ehT4aF86q1a8/R+w ($117.20 in chips)
Seat 4: SiGJDsvRViJX05vHhA80GQ ($197 in chips)
Seat 5: 54yWzRRgS0oZ+S6LwZBxMQ ($35.45 in chips)
eDLH1PUXFpvJBNMXBVQcGA: posts small blind $1
ygTTt5ehT4aF86q1a8/R+w: posts big blind $2
*** HOLE CARDS ***
SiGJDsvRViJX05vHhA80GQ: folds
54yWzRRgS0oZ+S6LwZBxMQ: calls $2
vkfxu8f/jMYKUk6Ly4eujw: raises $8 to $10
eDLH1PUXFpvJBNMXBVQcGA: folds
ygTTt5ehT4aF86q1a8/R+w: folds
54yWzRRgS0oZ+S6LwZBxMQ: folds
vkfxu8f/jMYKUk6Ly4eujw collected $7 from pot
*** SUMMARY ***
Total pot $7 | Rake $0
Seat 1: vkfxu8f/jMYKUk6Ly4eujw (button) collected ($7)
Seat 2: eDLH1PUXFpvJBNMXBVQcGA (small blind) folded before Flop
Seat 3: ygTTt5ehT4aF86q1a8/R+w (big blind) folded before Flop
Seat 4: SiGJDsvRViJX05vHhA80GQ folded before Flop (didn't bet)
Seat 5: 54yWzRRgS0oZ+S6LwZBxMQ folded before Flop



PokerStars Game #59941298174:  Hold'em No Limit ($1/$2) - 2009/07/01 1:31:22 ET
Table '4NGNnZ/osQfNq6abYqkJeA' 6-max Seat #1 is the button
Seat 1: vkfxu8f/jMYKUk6Ly4eujw ($200 in chips)
Seat 2: 669iGNwYwgRZg3nhS+aDAQ ($88.15 in chips)
Seat 3: 54yWzRRgS0oZ+S6LwZBxMQ ($40 in chips)
Seat 4: sY+4Uuh5z/6AbXXaCS10jw ($228.25 in chips)
Seat 5: VvdR9F3I+2yELkfTVvC1dg ($241.85 in chips)
Seat 6: 3cPMpDMgeOMAe4UceUfLsg ($203 in chips)
669iGNwYwgRZg3nhS+aDAQ: posts small blind $1
54yWzRRgS0oZ+S6LwZBxMQ: posts big blind $2
*** HOLE CARDS ***
sY+4Uuh5z/6AbXXaCS10jw: raises $4 to $6
VvdR9F3I+2yELkfTVvC1dg: folds
3cPMpDMgeOMAe4UceUfLsg: folds
vkfxu8f/jMYKUk6Ly4eujw: folds
669iGNwYwgRZg3nhS+aDAQ: calls $5
54yWzRRgS0oZ+S6LwZBxMQ: folds
*** FLOP *** [Qs Tc 5d]
669iGNwYwgRZg3nhS+aDAQ: bets $4
sY+4Uuh5z/6AbXXaCS10jw: folds
669iGNwYwgRZg3nhS+aDAQ collected $13.30 from pot
*** SUMMARY ***
Total pot $14 | Rake $0.70
Board [Qs Tc 5d]
Seat 1: vkfxu8f/jMYKUk6Ly4eujw (button) folded before Flop (didn't bet)
Seat 2: 669iGNwYwgRZg3nhS+aDAQ (small blind) collected ($13.30)
Seat 3: 54yWzRRgS0oZ+S6LwZBxMQ (big blind) folded before Flop
Seat 4: sY+4Uuh5z/6AbXXaCS10jw folded on the Flop
Seat 5: VvdR9F3I+2yELkfTVvC1dg folded before Flop (didn't bet)
Seat 6: 3cPMpDMgeOMAe4UceUfLsg folded before Flop (didn't bet)



PokerStars Game #59941298574:  Hold'em No Limit ($1/$2) - 2009/07/01 1:31:23 ET
Table 'qVXak+oTeDXMGbWa4sDU5Q' 9-max Seat #2 is the button
Seat 1: H6Z4+qu8gR0VUiPOijndVg ($205.55 in chips)
Seat 2: rW/MyplHylMSBRaoRUzWrg ($78 in chips)
Seat 3: WUlHm+ydPPHG7Lb0rePSdA ($151.65 in chips)
Seat 4: lQYT23h5QCUVZAKxjOO39Q ($203.70 in chips)
Seat 5: FWGiDqRwvLeKmHq9t4Jy9w ($268.80 in chips)
Seat 6: GX1heJ+DSsvm7gzSPsYhhQ ($37 in chips)
Seat 7: PfmlvZlFiss79a6IoEr11g ($163.30 in chips)
Seat 8: Z0rzUi0y1x80UdIpofoNbA ($125.55 in chips)
Seat 9: CkE3IyJF1KvdaAOmZY5XqQ ($200 in chips)
WUlHm+ydPPHG7Lb0rePSdA: posts small blind $1
lQYT23h5QCUVZAKxjOO39Q: posts big blind $2
*** HOLE CARDS ***
FWGiDqRwvLeKmHq9t4Jy9w: folds
GX1heJ+DSsvm7gzSPsYhhQ: folds
PfmlvZlFiss79a6IoEr11g: folds
Z0rzUi0y1x80UdIpofoNbA: folds
CkE3IyJF1KvdaAOmZY5XqQ: folds
H6Z4+qu8gR0VUiPOijndVg: folds
rW/MyplHylMSBRaoRUzWrg: raises $4 to $6
WUlHm+ydPPHG7Lb0rePSdA: folds
lQYT23h5QCUVZAKxjOO39Q: folds
rW/MyplHylMSBRaoRUzWrg collected $5 from pot
*** SUMMARY ***
Total pot $5 | Rake $0
Seat 1: H6Z4+qu8gR0VUiPOijndVg folded before Flop (didn't bet)
Seat 2: rW/MyplHylMSBRaoRUzWrg (button) collected ($5)
Seat 3: WUlHm+ydPPHG7Lb0rePSdA (small blind) folded before Flop
Seat 4: lQYT23h5QCUVZAKxjOO39Q (big blind) folded before Flop
Seat 5: FWGiDqRwvLeKmHq9t4Jy9w folded before Flop (didn't bet)
Seat 6: GX1heJ+DSsvm7gzSPsYhhQ folded before Flop (didn't bet)
Seat 7: PfmlvZlFiss79a6IoEr11g folded before Flop (didn't bet)
Seat 8: Z0rzUi0y1x80UdIpofoNbA folded before Flop (didn't bet)
Seat 9: CkE3IyJF1KvdaAOmZY5XqQ folded before Flop (didn't bet)



PokerStars Game #59941299294:  Hold'em No Limit ($1/$2) - 2009/07/01 1:31:24 ET
Table 'uJ9juaXXg9yIcSU8amxaXQ' 6-max Seat #5 is the button
Seat 1: JsqOjN/eHz0uYVf/PyUJ6Q ($144.50 in chips)
Seat 2: VvdR9F3I+2yELkfTVvC1dg ($229.10 in chips)
Seat 3: qXDd0ZyMIse0OBu8pxeQ3Q ($247.40 in chips)
Seat 4: zNjJ/y4emmF+vzrCDd+ooA ($236.55 in chips)
Seat 5: YsLQ3BAvgQHWXMAv3Wv6Hg ($200 in chips)
Seat 6: 2DFp9Veq1xxq64dCjwNuUw ($54.60 in chips)
2DFp9Veq1xxq64dCjwNuUw: posts small blind $1
JsqOjN/eHz0uYVf/PyUJ6Q: posts big blind $2
*** HOLE CARDS ***
VvdR9F3I+2yELkfTVvC1dg: folds
qXDd0ZyMIse0OBu8pxeQ3Q: folds
zNjJ/y4emmF+vzrCDd+ooA: folds
YsLQ3BAvgQHWXMAv3Wv6Hg: folds
2DFp9Veq1xxq64dCjwNuUw: folds
JsqOjN/eHz0uYVf/PyUJ6Q collected $2 from pot
JsqOjN/eHz0uYVf/PyUJ6Q: doesn't show hand
*** SUMMARY ***
Total pot $2 | Rake $0
Seat 1: JsqOjN/eHz0uYVf/PyUJ6Q (big blind) collected ($2)
Seat 2: VvdR9F3I+2yELkfTVvC1dg folded before Flop (didn't bet)
Seat 3: qXDd0ZyMIse0OBu8pxeQ3Q folded before Flop (didn't bet)
Seat 4: zNjJ/y4emmF+vzrCDd+ooA folded before Flop (didn't bet)
Seat 5: YsLQ3BAvgQHWXMAv3Wv6Hg (button) folded before Flop (didn't bet)
Seat 6: 2DFp9Veq1xxq64dCjwNuUw (small blind) folded before Flop



PokerStars Game #59941299362:  Hold'em No Limit ($1/$2) - 2009/07/01 1:31:24 ET
Table 'CFkQcfWjKccZaZDf71FK+w' 6-max Seat #2 is the button
Seat 2: ewN/vzF22+/gdzjIKBOlkA ($207.80 in chips)
Seat 3: 09BNF4quPDzanQzM8vc6WA ($53.65 in chips)
Seat 4: ygTTt5ehT4aF86q1a8/R+w ($254.25 in chips)
Seat 5: 2lOU1DcvUZaMcxZ95XfzXw ($142.15 in chips)
Seat 6: ORVqY3rf9X6ANA/8s+On2Q ($114.60 in chips)
09BNF4quPDzanQzM8vc6WA: posts small blind $1
ygTTt5ehT4aF86q1a8/R+w: posts big blind $2
vkfxu8f/jMYKUk6Ly4eujw: sits out
*** HOLE CARDS ***
2lOU1DcvUZaMcxZ95XfzXw: calls $2
ORVqY3rf9X6ANA/8s+On2Q: calls $2
ewN/vzF22+/gdzjIKBOlkA: folds
09BNF4quPDzanQzM8vc6WA: folds
ygTTt5ehT4aF86q1a8/R+w: checks
*** FLOP *** [9d Qd 3c]
ygTTt5ehT4aF86q1a8/R+w: checks
2lOU1DcvUZaMcxZ95XfzXw: checks
ORVqY3rf9X6ANA/8s+On2Q: checks
*** TURN *** [9d Qd 3c] [2d]
ygTTt5ehT4aF86q1a8/R+w: bets $4
2lOU1DcvUZaMcxZ95XfzXw: calls $4
ORVqY3rf9X6ANA/8s+On2Q: calls $4
*** RIVER *** [9d Qd 3c 2d] [Ts]
ygTTt5ehT4aF86q1a8/R+w: bets $12
2lOU1DcvUZaMcxZ95XfzXw: folds
ORVqY3rf9X6ANA/8s+On2Q: raises $12 to $24
ygTTt5ehT4aF86q1a8/R+w: calls $12
*** SHOW DOWN ***
ORVqY3rf9X6ANA/8s+On2Q: shows [Tc Th] (three of a kind, Tens)
ygTTt5ehT4aF86q1a8/R+w: mucks hand
ORVqY3rf9X6ANA/8s+On2Q collected $65 from pot
*** SUMMARY ***
Total pot $67 | Rake $2
Board [9d Qd 3c 2d Ts]
Seat 2: ewN/vzF22+/gdzjIKBOlkA (button) folded before Flop (didn't bet)
Seat 3: 09BNF4quPDzanQzM8vc6WA (small blind) folded before Flop
Seat 4: ygTTt5ehT4aF86q1a8/R+w (big blind) mucked
Seat 5: 2lOU1DcvUZaMcxZ95XfzXw folded on the River
Seat 6: ORVqY3rf9X6ANA/8s+On2Q showed [Tc Th] and won ($65) with three of a kind, Tens



PokerStars Game #59941300094:  Hold'em No Limit ($1/$2) - 2009/07/01 1:31:25 ET
Table 'kq5zaQ+1hLNf8LZfGnbTAA' 6-max Seat #4 is the button
Seat 1: 8srN1dKQePlsv0GyTada+Q ($408 in chips)
Seat 2: nXDI8Y/S6POzRwANu3d8hQ ($187 in chips)
Seat 3: vkfxu8f/jMYKUk6Ly4eujw ($225.95 in chips)
Seat 4: 3dAbvkxS5NPQTBAbvpinVg ($278.45 in chips)
Seat 5: gnYme0DNFflnMhrdbxe1Ag ($200 in chips)
Seat 6: mfy7uGZcqA2PVQqEVbJ7+g ($194.25 in chips)
gnYme0DNFflnMhrdbxe1Ag: posts small blind $1
mfy7uGZcqA2PVQqEVbJ7+g: posts big blind $2
*** HOLE CARDS ***
8srN1dKQePlsv0GyTada+Q: folds
nXDI8Y/S6POzRwANu3d8hQ: folds
vkfxu8f/jMYKUk6Ly4eujw: folds
3dAbvkxS5NPQTBAbvpinVg: raises $4 to $6
gnYme0DNFflnMhrdbxe1Ag: folds
mfy7uGZcqA2PVQqEVbJ7+g: folds
3dAbvkxS5NPQTBAbvpinVg collected $5 from pot
*** SUMMARY ***
Total pot $5 | Rake $0
Seat 1: 8srN1dKQePlsv0GyTada+Q folded before Flop (didn't bet)
Seat 2: nXDI8Y/S6POzRwANu3d8hQ folded before Flop (didn't bet)
Seat 3: vkfxu8f/jMYKUk6Ly4eujw folded before Flop (didn't bet)
Seat 4: 3dAbvkxS5NPQTBAbvpinVg (button) collected ($5)
Seat 5: gnYme0DNFflnMhrdbxe1Ag (small blind) folded before Flop
Seat 6: mfy7uGZcqA2PVQqEVbJ7+g (big blind) folded before Flop



PokerStars Game #59941300254:  Hold'em No Limit ($1/$2) - 2009/07/01 1:31:25 ET
Table 'NmY84NAf9Mh0ckAckHnh5g' 2-max Seat #1 is the button
Seat 1: 6hvg964TSqZ3AL/0XK9aVQ ($340.70 in chips)
Seat 2: RwDoM55ZeQuI2ADyJhOb2Q ($658.70 in chips)
6hvg964TSqZ3AL/0XK9aVQ: posts small blind $1
RwDoM55ZeQuI2ADyJhOb2Q: posts big blind $2
*** HOLE CARDS ***
6hvg964TSqZ3AL/0XK9aVQ: folds
RwDoM55ZeQuI2ADyJhOb2Q collected $2 from pot
RwDoM55ZeQuI2ADyJhOb2Q: doesn't show hand
*** SUMMARY ***
Total pot $2 | Rake $0
Seat 1: 6hvg964TSqZ3AL/0XK9aVQ (button) (small blind) folded before Flop
Seat 2: RwDoM55ZeQuI2ADyJhOb2Q (big blind) collected ($2)



PokerStars Game #59941300602:  Hold'em No Limit ($1/$2) - 2009/07/01 1:31:26 ET
Table '3WCXyaiCAbqSShQu7FIjvA' 9-max Seat #8 is the button
Seat 1: kTCkABD1UUldS9DFRGfCwQ ($151.40 in chips)
Seat 3: 5Q8U6iZbeO7xJSS4qvDP5g ($272.15 in chips)
Seat 4: waEF/+pxZTxNo4FvsORuXg ($82.40 in chips)
Seat 5: CkE3IyJF1KvdaAOmZY5XqQ ($200 in chips)
Seat 6: 5jQlngvMSqM/WoonOcR5kw ($245.35 in chips)
Seat 8: 1CtiZuXDFaJL1dJPQKyi8Q ($244.05 in chips)
Seat 9: FiXPLJyqb24l32QST2TInw ($145.40 in chips)
FiXPLJyqb24l32QST2TInw: posts small blind $1
kTCkABD1UUldS9DFRGfCwQ: posts big blind $2
TAfo4veNRaRlzDXMMYS3Jg: sits out
*** HOLE CARDS ***
nXDI8Y/S6POzRwANu3d8hQ joins the table at seat #7
5Q8U6iZbeO7xJSS4qvDP5g: folds
waEF/+pxZTxNo4FvsORuXg: folds
CkE3IyJF1KvdaAOmZY5XqQ: folds
5jQlngvMSqM/WoonOcR5kw: folds
1CtiZuXDFaJL1dJPQKyi8Q: raises $4 to $6
FiXPLJyqb24l32QST2TInw: folds
kTCkABD1UUldS9DFRGfCwQ: calls $4
*** FLOP *** [Qh Td 2d]
kTCkABD1UUldS9DFRGfCwQ: bets $6
1CtiZuXDFaJL1dJPQKyi8Q: folds
kTCkABD1UUldS9DFRGfCwQ collected $12.35 from pot
kTCkABD1UUldS9DFRGfCwQ: doesn't show hand
*** SUMMARY ***
Total pot $13 | Rake $0.65
Board [Qh Td 2d]
Seat 1: kTCkABD1UUldS9DFRGfCwQ (big blind) collected ($12.35)
Seat 3: 5Q8U6iZbeO7xJSS4qvDP5g folded before Flop (didn't bet)
Seat 4: waEF/+pxZTxNo4FvsORuXg folded before Flop (didn't bet)
Seat 5: CkE3IyJF1KvdaAOmZY5XqQ folded before Flop (didn't bet)
Seat 6: 5jQlngvMSqM/WoonOcR5kw folded before Flop (didn't bet)
Seat 8: 1CtiZuXDFaJL1dJPQKyi8Q (button) folded on the Flop
Seat 9: FiXPLJyqb24l32QST2TInw (small blind) folded before Flop



PokerStars Game #59941303030:  Hold'em No Limit ($1/$2) - 2009/07/01 1:31:30 ET
Table 'pPQgcj9XT9CHBsbo1WTBug' 6-max Seat #4 is the button
Seat 1: DFVYDA6dKQy7R7mGIKogZA ($153.20 in chips)
Seat 2: qXDd0ZyMIse0OBu8pxeQ3Q ($200 in chips)
Seat 3: 54yWzRRgS0oZ+S6LwZBxMQ ($54.50 in chips)
Seat 4: gqlysXCbT8V54f/1lf9h3A ($70.75 in chips)
Seat 5: vkfxu8f/jMYKUk6Ly4eujw ($191.55 in chips)
Seat 6: Yr7pZltpy3IUNdKS9PCEiw ($301.30 in chips)
vkfxu8f/jMYKUk6Ly4eujw: posts small blind $1
Yr7pZltpy3IUNdKS9PCEiw: posts big blind $2
*** HOLE CARDS ***
DFVYDA6dKQy7R7mGIKogZA: calls $2
qXDd0ZyMIse0OBu8pxeQ3Q: folds
54yWzRRgS0oZ+S6LwZBxMQ: calls $2
gqlysXCbT8V54f/1lf9h3A: folds
vkfxu8f/jMYKUk6Ly4eujw: folds
Yr7pZltpy3IUNdKS9PCEiw: checks
*** FLOP *** [8d Th 3s]
Yr7pZltpy3IUNdKS9PCEiw: checks
DFVYDA6dKQy7R7mGIKogZA: bets $4
54yWzRRgS0oZ+S6LwZBxMQ: folds
Yr7pZltpy3IUNdKS9PCEiw: raises $8 to $12
DFVYDA6dKQy7R7mGIKogZA: calls $8
*** TURN *** [8d Th 3s] [2c]
Yr7pZltpy3IUNdKS9PCEiw: bets $20
DFVYDA6dKQy7R7mGIKogZA: folds
Yr7pZltpy3IUNdKS9PCEiw collected $29.50 from pot
*** SUMMARY ***
Total pot $31 | Rake $1.50
Board [8d Th 3s 2c]
Seat 1: DFVYDA6dKQy7R7mGIKogZA folded on the Turn
Seat 2: qXDd0ZyMIse0OBu8pxeQ3Q folded before Flop (didn't bet)
Seat 3: 54yWzRRgS0oZ+S6LwZBxMQ folded on the Flop
Seat 4: gqlysXCbT8V54f/1lf9h3A (button) folded before Flop (didn't bet)
Seat 5: vkfxu8f/jMYKUk6Ly4eujw (small blind) folded before Flop
Seat 6: Yr7pZltpy3IUNdKS9PCEiw (big blind) collected ($29.50)



PokerStars Game #59941303422:  Hold'em No Limit ($1/$2) - 2009/07/01 1:31:31 ET
Table 'jlrIxbrVIG+gjaUYT4za8g' 6-max Seat #5 is the button
Seat 1: ygTTt5ehT4aF86q1a8/R+w ($258.30 in chips)
Seat 3: gnYme0DNFflnMhrdbxe1Ag ($200 in chips)
Seat 4: 8srN1dKQePlsv0GyTada+Q ($229.55 in chips)
Seat 5: AyBB0k3Dcl7xbXUeGMw06g ($73.90 in chips)
Seat 6: vkfxu8f/jMYKUk6Ly4eujw ($307 in chips)
vkfxu8f/jMYKUk6Ly4eujw: posts small blind $1
ygTTt5ehT4aF86q1a8/R+w: posts big blind $2
/PH6Ffnho4Ysm8S3V/oa+w: sits out
*** HOLE CARDS ***
gnYme0DNFflnMhrdbxe1Ag: folds
8srN1dKQePlsv0GyTada+Q: folds
AyBB0k3Dcl7xbXUeGMw06g: folds
vkfxu8f/jMYKUk6Ly4eujw: folds
ygTTt5ehT4aF86q1a8/R+w collected $2 from pot
*** SUMMARY ***
Total pot $2 | Rake $0
Seat 1: ygTTt5ehT4aF86q1a8/R+w (big blind) collected ($2)
Seat 3: gnYme0DNFflnMhrdbxe1Ag folded before Flop (didn't bet)
Seat 4: 8srN1dKQePlsv0GyTada+Q folded before Flop (didn't bet)
Seat 5: AyBB0k3Dcl7xbXUeGMw06g (button) folded before Flop (didn't bet)
Seat 6: vkfxu8f/jMYKUk6Ly4eujw (small blind) folded before Flop



PokerStars Game #59941303508:  Hold'em No Limit ($1/$2) - 2009/07/01 1:31:31 ET
Table 'NmY84NAf9Mh0ckAckHnh5g' 2-max Seat #2 is the button
Seat 1: 6hvg964TSqZ3AL/0XK9aVQ ($339.70 in chips)
Seat 2: RwDoM55ZeQuI2ADyJhOb2Q ($659.70 in chips)
RwDoM55ZeQuI2ADyJhOb2Q: posts small blind $1
6hvg964TSqZ3AL/0XK9aVQ: posts big blind $2
*** HOLE CARDS ***
RwDoM55ZeQuI2ADyJhOb2Q: folds
6hvg964TSqZ3AL/0XK9aVQ collected $2 from pot
6hvg964TSqZ3AL/0XK9aVQ: doesn't show hand
*** SUMMARY ***
Total pot $2 | Rake $0
Seat 1: 6hvg964TSqZ3AL/0XK9aVQ (big blind) collected ($2)
Seat 2: RwDoM55ZeQuI2ADyJhOb2Q (button) (small blind) folded before Flop



PokerStars Game #59941304228:  Hold'em No Limit ($1/$2) - 2009/07/01 1:31:33 ET
Table 'QxerF7GUfCbl+4a8XaTB2w' 6-max Seat #1 is the button
Seat 1: 54yWzRRgS0oZ+S6LwZBxMQ ($61 in chips)
Seat 2: HiWSAXs6/0w9Jy7ioiiShQ ($5.65 in chips)
Seat 5: gnYme0DNFflnMhrdbxe1Ag ($241.70 in chips)
Seat 6: VvdR9F3I+2yELkfTVvC1dg ($200 in chips)
HiWSAXs6/0w9Jy7ioiiShQ: posts small blind $1
m7mYVfnCOK5TE/VkN/FhOg: is sitting out
09BNF4quPDzanQzM8vc6WA: is sitting out
gnYme0DNFflnMhrdbxe1Ag: posts big blind $2
*** HOLE CARDS ***
09BNF4quPDzanQzM8vc6WA leaves the table
VvdR9F3I+2yELkfTVvC1dg: folds
54yWzRRgS0oZ+S6LwZBxMQ: raises $2 to $4
/PH6Ffnho4Ysm8S3V/oa+w joins the table at seat #4
HiWSAXs6/0w9Jy7ioiiShQ: folds
gnYme0DNFflnMhrdbxe1Ag: folds
54yWzRRgS0oZ+S6LwZBxMQ collected $5 from pot
54yWzRRgS0oZ+S6LwZBxMQ: doesn't show hand
*** SUMMARY ***
Total pot $5 | Rake $0
Seat 1: 54yWzRRgS0oZ+S6LwZBxMQ (button) collected ($5)
Seat 2: HiWSAXs6/0w9Jy7ioiiShQ (small blind) folded before Flop
Seat 5: gnYme0DNFflnMhrdbxe1Ag (big blind) folded before Flop
Seat 6: VvdR9F3I+2yELkfTVvC1dg folded before Flop (didn't bet)



PokerStars Game #59941305254:  Hold'em No Limit ($1/$2) - 2009/07/01 1:31:34 ET
Table 'ztv6V3FN2bQ9nmJPPdx6nQ' 6-max Seat #1 is the button
Seat 1: 6fLdOUCRtX71xbVRhJEq8w ($241.35 in chips)
Seat 2: 5Y+ZGWLI4gnlpApDX5vy1A ($387.75 in chips)
Seat 3: ubtx4Z5L+AcK71MTvYiGVw ($245 in chips)
Seat 6: mfy7uGZcqA2PVQqEVbJ7+g ($97.45 in chips)
5Y+ZGWLI4gnlpApDX5vy1A: posts small blind $1
ubtx4Z5L+AcK71MTvYiGVw: posts big blind $2
*** HOLE CARDS ***
mfy7uGZcqA2PVQqEVbJ7+g: folds
6fLdOUCRtX71xbVRhJEq8w: folds
5Y+ZGWLI4gnlpApDX5vy1A: folds
sTPOWERd9HWPCNrDBwsVjA has returned
ubtx4Z5L+AcK71MTvYiGVw collected $2 from pot
ubtx4Z5L+AcK71MTvYiGVw: doesn't show hand
*** SUMMARY ***
Total pot $2 | Rake $0
Seat 1: 6fLdOUCRtX71xbVRhJEq8w (button) folded before Flop (didn't bet)
Seat 2: 5Y+ZGWLI4gnlpApDX5vy1A (small blind) folded before Flop
Seat 3: ubtx4Z5L+AcK71MTvYiGVw (big blind) collected ($2)
Seat 6: mfy7uGZcqA2PVQqEVbJ7+g folded before Flop (didn't bet)



PokerStars Game #59941305166:  Hold'em No Limit ($1/$2) - 2009/07/01 1:31:34 ET
Table 'aSf77Sj8QEnzcc0WaxVD4Q' 6-max Seat #4 is the button
Seat 1: UELtvp+JfwI7XDGVwSxZXA ($147.55 in chips)
Seat 2: vkfxu8f/jMYKUk6Ly4eujw ($201.80 in chips)
Seat 3: 9dpyyjDTCed6nV7JhaUUpw ($526.70 in chips)
Seat 4: YsLQ3BAvgQHWXMAv3Wv6Hg ($271.70 in chips)
Seat 5: VvdR9F3I+2yELkfTVvC1dg ($238 in chips)
Seat 6: vkoJRf3gidxY1pPi0AFWww ($129.60 in chips)
VvdR9F3I+2yELkfTVvC1dg: posts small blind $1
vkoJRf3gidxY1pPi0AFWww: posts big blind $2
*** HOLE CARDS ***
UELtvp+JfwI7XDGVwSxZXA: calls $2
vkfxu8f/jMYKUk6Ly4eujw: folds
9dpyyjDTCed6nV7JhaUUpw: folds
YsLQ3BAvgQHWXMAv3Wv6Hg: folds
VvdR9F3I+2yELkfTVvC1dg: folds
vkoJRf3gidxY1pPi0AFWww: checks
*** FLOP *** [3h 2c 6h]
vkoJRf3gidxY1pPi0AFWww: checks
UELtvp+JfwI7XDGVwSxZXA: checks
*** TURN *** [3h 2c 6h] [Qs]
vkoJRf3gidxY1pPi0AFWww: bets $4
UELtvp+JfwI7XDGVwSxZXA: folds
vkoJRf3gidxY1pPi0AFWww collected $4.75 from pot
vkoJRf3gidxY1pPi0AFWww: doesn't show hand
*** SUMMARY ***
Total pot $5 | Rake $0.25
Board [3h 2c 6h Qs]
Seat 1: UELtvp+JfwI7XDGVwSxZXA folded on the Turn
Seat 2: vkfxu8f/jMYKUk6Ly4eujw folded before Flop (didn't bet)
Seat 3: 9dpyyjDTCed6nV7JhaUUpw folded before Flop (didn't bet)
Seat 4: YsLQ3BAvgQHWXMAv3Wv6Hg (button) folded before Flop (didn't bet)
Seat 5: VvdR9F3I+2yELkfTVvC1dg (small blind) folded before Flop
Seat 6: vkoJRf3gidxY1pPi0AFWww (big blind) collected ($4.75)



PokerStars Game #59941307004:  Hold'em No Limit ($1/$2) - 2009/07/01 1:31:37 ET
Table 'rsKRKlGHlxVyqJxzO2a2Ow' 9-max Seat #6 is the button
Seat 1: uYWfQJg2hgHLxri6/uVJiw ($390.40 in chips)
Seat 3: zTcFtoHqqK4550YMZ8Y14Q ($42.30 in chips)
Seat 5: 5Q8U6iZbeO7xJSS4qvDP5g ($223.55 in chips)
Seat 6: H6Z4+qu8gR0VUiPOijndVg ($204.55 in chips)
Seat 7: GX1heJ+DSsvm7gzSPsYhhQ ($31 in chips)
Seat 8: CkE3IyJF1KvdaAOmZY5XqQ ($200 in chips)
Seat 9: gRbvhSUVg+TNaTjaJecIRw ($24 in chips)
GX1heJ+DSsvm7gzSPsYhhQ: posts small blind $1
CkE3IyJF1KvdaAOmZY5XqQ: posts big blind $2
+T/63sAeZzWyHchahJ36GQ: sits out
*** HOLE CARDS ***
gRbvhSUVg+TNaTjaJecIRw: folds
uYWfQJg2hgHLxri6/uVJiw: folds
zTcFtoHqqK4550YMZ8Y14Q: folds
uYWfQJg2hgHLxri6/uVJiw leaves the table
5Q8U6iZbeO7xJSS4qvDP5g: folds
MeleaB joins the table at seat #1
H6Z4+qu8gR0VUiPOijndVg: raises $2 to $4
GX1heJ+DSsvm7gzSPsYhhQ: raises $27 to $31 and is all-in
CkE3IyJF1KvdaAOmZY5XqQ: folds
H6Z4+qu8gR0VUiPOijndVg: calls $27
*** FLOP *** [Kh 6d 4d]
*** TURN *** [Kh 6d 4d] [9s]
*** RIVER *** [Kh 6d 4d 9s] [3c]
*** SHOW DOWN ***
GX1heJ+DSsvm7gzSPsYhhQ: shows [As Ad] (a pair of Aces)
H6Z4+qu8gR0VUiPOijndVg: mucks hand
GX1heJ+DSsvm7gzSPsYhhQ collected $61 from pot
*** SUMMARY ***
Total pot $64 | Rake $3
Board [Kh 6d 4d 9s 3c]
Seat 1: uYWfQJg2hgHLxri6/uVJiw folded before Flop (didn't bet)
Seat 3: zTcFtoHqqK4550YMZ8Y14Q folded before Flop (didn't bet)
Seat 5: 5Q8U6iZbeO7xJSS4qvDP5g folded before Flop (didn't bet)
Seat 6: H6Z4+qu8gR0VUiPOijndVg (button) mucked
Seat 7: GX1heJ+DSsvm7gzSPsYhhQ (small blind) showed [As Ad] and won ($61) with a pair of Aces
Seat 8: CkE3IyJF1KvdaAOmZY5XqQ (big blind) folded before Flop
Seat 9: gRbvhSUVg+TNaTjaJecIRw folded before Flop (didn't bet)



PokerStars Game #59941307906:  Hold'em No Limit ($1/$2) - 2009/07/01 1:31:39 ET
Table 'NmY84NAf9Mh0ckAckHnh5g' 2-max Seat #1 is the button
Seat 1: 6hvg964TSqZ3AL/0XK9aVQ ($340.70 in chips)
Seat 2: RwDoM55ZeQuI2ADyJhOb2Q ($658.70 in chips)
6hvg964TSqZ3AL/0XK9aVQ: posts small blind $1
RwDoM55ZeQuI2ADyJhOb2Q: posts big blind $2
*** HOLE CARDS ***
6hvg964TSqZ3AL/0XK9aVQ: calls $1
RwDoM55ZeQuI2ADyJhOb2Q: checks
*** FLOP *** [3c 6s 4c]
RwDoM55ZeQuI2ADyJhOb2Q: checks
6hvg964TSqZ3AL/0XK9aVQ: bets $4
RwDoM55ZeQuI2ADyJhOb2Q: calls $4
*** TURN *** [3c 6s 4c] [3d]
RwDoM55ZeQuI2ADyJhOb2Q: checks
6hvg964TSqZ3AL/0XK9aVQ: bets $10
RwDoM55ZeQuI2ADyJhOb2Q: calls $10
*** RIVER *** [3c 6s 4c 3d] [Ac]
RwDoM55ZeQuI2ADyJhOb2Q: checks
6hvg964TSqZ3AL/0XK9aVQ: bets $10
RwDoM55ZeQuI2ADyJhOb2Q: calls $10
*** SHOW DOWN ***
6hvg964TSqZ3AL/0XK9aVQ: shows [Kh Ks] (two pair, Kings and Threes)
RwDoM55ZeQuI2ADyJhOb2Q: mucks hand
6hvg964TSqZ3AL/0XK9aVQ collected $51.50 from pot
*** SUMMARY ***
Total pot $52 | Rake $0.50
Board [3c 6s 4c 3d Ac]
Seat 1: 6hvg964TSqZ3AL/0XK9aVQ (button) (small blind) showed [Kh Ks] and won ($51.50) with two pair, Kings and Threes
Seat 2: RwDoM55ZeQuI2ADyJhOb2Q (big blind) mucked



PokerStars Game #59941308520:  Hold'em No Limit ($1/$2) - 2009/07/01 1:31:40 ET
Table 'uJ9juaXXg9yIcSU8amxaXQ' 6-max Seat #6 is the button
Seat 1: JsqOjN/eHz0uYVf/PyUJ6Q ($145.50 in chips)
Seat 2: VvdR9F3I+2yELkfTVvC1dg ($229.10 in chips)
Seat 3: qXDd0ZyMIse0OBu8pxeQ3Q ($247.40 in chips)
Seat 4: zNjJ/y4emmF+vzrCDd+ooA ($236.55 in chips)
Seat 5: YsLQ3BAvgQHWXMAv3Wv6Hg ($200 in chips)
Seat 6: 2DFp9Veq1xxq64dCjwNuUw ($53.60 in chips)
JsqOjN/eHz0uYVf/PyUJ6Q: posts small blind $1
VvdR9F3I+2yELkfTVvC1dg: posts big blind $2
*** HOLE CARDS ***
qXDd0ZyMIse0OBu8pxeQ3Q: folds
zNjJ/y4emmF+vzrCDd+ooA: calls $2
YsLQ3BAvgQHWXMAv3Wv6Hg: folds
2DFp9Veq1xxq64dCjwNuUw: calls $2
JsqOjN/eHz0uYVf/PyUJ6Q: folds
VvdR9F3I+2yELkfTVvC1dg: checks
*** FLOP *** [Ad Qc Ac]
VvdR9F3I+2yELkfTVvC1dg: checks
zNjJ/y4emmF+vzrCDd+ooA: checks
2DFp9Veq1xxq64dCjwNuUw: checks
*** TURN *** [Ad Qc Ac] [5h]
VvdR9F3I+2yELkfTVvC1dg: checks
zNjJ/y4emmF+vzrCDd+ooA: checks
2DFp9Veq1xxq64dCjwNuUw: checks
*** RIVER *** [Ad Qc Ac 5h] [7d]
VvdR9F3I+2yELkfTVvC1dg: checks
zNjJ/y4emmF+vzrCDd+ooA: checks
2DFp9Veq1xxq64dCjwNuUw: checks
*** SHOW DOWN ***
VvdR9F3I+2yELkfTVvC1dg: shows [Jc 2s] (a pair of Aces)
zNjJ/y4emmF+vzrCDd+ooA: shows [Ks Jd] (a pair of Aces - King kicker)
2DFp9Veq1xxq64dCjwNuUw: mucks hand
zNjJ/y4emmF+vzrCDd+ooA collected $6.65 from pot
*** SUMMARY ***
Total pot $7 | Rake $0.35
Board [Ad Qc Ac 5h 7d]
Seat 1: JsqOjN/eHz0uYVf/PyUJ6Q (small blind) folded before Flop
Seat 2: VvdR9F3I+2yELkfTVvC1dg (big blind) showed [Jc 2s] and lost with a pair of Aces
Seat 3: qXDd0ZyMIse0OBu8pxeQ3Q folded before Flop (didn't bet)
Seat 4: zNjJ/y4emmF+vzrCDd+ooA showed [Ks Jd] and won ($6.65) with a pair of Aces
Seat 5: YsLQ3BAvgQHWXMAv3Wv6Hg folded before Flop (didn't bet)
Seat 6: 2DFp9Veq1xxq64dCjwNuUw (button) mucked



PokerStars Game #59941308756:  Hold'em No Limit ($1/$2) - 2009/07/01 1:31:41 ET
Table 'ZzSIe0zTCDv+n6hfbY5tTg' 6-max Seat #3 is the button
Seat 1: VvdR9F3I+2yELkfTVvC1dg ($200 in chips)
Seat 2: B87ikIyZ/TzAVeXf38Ny0g ($283 in chips)
Seat 3: gsugPj31Hui3Jefl98MBOA ($417 in chips)
Seat 4: qXDd0ZyMIse0OBu8pxeQ3Q ($200 in chips)
Seat 5: 3dAbvkxS5NPQTBAbvpinVg ($480.30 in chips)
Seat 6: 09BNF4quPDzanQzM8vc6WA ($26.05 in chips)
qXDd0ZyMIse0OBu8pxeQ3Q: posts small blind $1
3dAbvkxS5NPQTBAbvpinVg: posts big blind $2
*** HOLE CARDS ***
09BNF4quPDzanQzM8vc6WA: folds
VvdR9F3I+2yELkfTVvC1dg: folds
B87ikIyZ/TzAVeXf38Ny0g: folds
gsugPj31Hui3Jefl98MBOA: folds
qXDd0ZyMIse0OBu8pxeQ3Q: raises $4 to $6
3dAbvkxS5NPQTBAbvpinVg: folds
qXDd0ZyMIse0OBu8pxeQ3Q collected $4 from pot
*** SUMMARY ***
Total pot $4 | Rake $0
Seat 1: VvdR9F3I+2yELkfTVvC1dg folded before Flop (didn't bet)
Seat 2: B87ikIyZ/TzAVeXf38Ny0g folded before Flop (didn't bet)
Seat 3: gsugPj31Hui3Jefl98MBOA (button) folded before Flop (didn't bet)
Seat 4: qXDd0ZyMIse0OBu8pxeQ3Q (small blind) collected ($4)
Seat 5: 3dAbvkxS5NPQTBAbvpinVg (big blind) folded before Flop
Seat 6: 09BNF4quPDzanQzM8vc6WA folded before Flop (didn't bet)



PokerStars Game #59941308928:  Hold'em No Limit ($1/$2) - 2009/07/01 1:31:41 ET
Table '/dyk+YdRGv90j2box35j8w' 6-max Seat #4 is the button
Seat 1: 8srN1dKQePlsv0GyTada+Q ($226.25 in chips)
Seat 2: qCnEYuAE5y5A7bk6fO5/jQ ($473.60 in chips)
Seat 4: z/u1YTnkiIDrtp/2cA2dBg ($185.60 in chips)
Seat 5: VvdR9F3I+2yELkfTVvC1dg ($200 in chips)
Seat 6: gnYme0DNFflnMhrdbxe1Ag ($200 in chips)
VvdR9F3I+2yELkfTVvC1dg: posts small blind $1
gnYme0DNFflnMhrdbxe1Ag: posts big blind $2
*** HOLE CARDS ***
8srN1dKQePlsv0GyTada+Q: raises $4 to $6
qCnEYuAE5y5A7bk6fO5/jQ: folds
sTPOWERd9HWPCNrDBwsVjA has returned
z/u1YTnkiIDrtp/2cA2dBg: calls $6
VvdR9F3I+2yELkfTVvC1dg: folds
gnYme0DNFflnMhrdbxe1Ag: folds
*** FLOP *** [2s 2c 9c]
8srN1dKQePlsv0GyTada+Q: checks
z/u1YTnkiIDrtp/2cA2dBg: bets $10
8srN1dKQePlsv0GyTada+Q: folds
z/u1YTnkiIDrtp/2cA2dBg collected $14.25 from pot
*** SUMMARY ***
Total pot $15 | Rake $0.75
Board [2s 2c 9c]
Seat 1: 8srN1dKQePlsv0GyTada+Q folded on the Flop
Seat 2: qCnEYuAE5y5A7bk6fO5/jQ folded before Flop (didn't bet)
Seat 4: z/u1YTnkiIDrtp/2cA2dBg (button) collected ($14.25)
Seat 5: VvdR9F3I+2yELkfTVvC1dg (small blind) folded before Flop
Seat 6: gnYme0DNFflnMhrdbxe1Ag (big blind) folded before Flop



PokerStars Game #59941308904:  Hold'em No Limit ($1/$2) - 2009/07/01 1:31:41 ET
Table 'eTkRjRjsYr567snmNk8kNQ' 2-max Seat #1 is the button
Seat 1: t6Jd836OSEMbcRi7rfGp5g ($205.50 in chips)
Seat 2: UNpnKQk0gkkyFJen8upqag ($290.50 in chips)
t6Jd836OSEMbcRi7rfGp5g: posts small blind $1
UNpnKQk0gkkyFJen8upqag: posts big blind $2
*** HOLE CARDS ***
t6Jd836OSEMbcRi7rfGp5g: raises $4 to $6
UNpnKQk0gkkyFJen8upqag: folds
t6Jd836OSEMbcRi7rfGp5g collected $4 from pot
*** SUMMARY ***
Total pot $4 | Rake $0
Seat 1: t6Jd836OSEMbcRi7rfGp5g (button) (small blind) collected ($4)
Seat 2: UNpnKQk0gkkyFJen8upqag (big blind) folded before Flop



PokerStars Game #59941309910:  Hold'em No Limit ($1/$2) - 2009/07/01 1:31:43 ET
Table 'TsEDkiO4tzCTCzJ7tNdEqw' 6-max Seat #1 is the button
Seat 1: MfXQsYD8pGeCS7XOtyV+vw ($88.05 in chips)
Seat 2: 4dcDwIHRm96PwtqkpQiuiA ($76.10 in chips)
Seat 3: ubtx4Z5L+AcK71MTvYiGVw ($205 in chips)
Seat 4: K8MXCrNAVYlMnnCeM32Kxw ($117.50 in chips)
Seat 5: VvdR9F3I+2yELkfTVvC1dg ($263.35 in chips)
Seat 6: uCqEjnxh2/vFBjKYkfTOkw ($150.55 in chips)
4dcDwIHRm96PwtqkpQiuiA: posts small blind $1
ubtx4Z5L+AcK71MTvYiGVw: posts big blind $2
*** HOLE CARDS ***
K8MXCrNAVYlMnnCeM32Kxw: folds
VvdR9F3I+2yELkfTVvC1dg: raises $2 to $4
uCqEjnxh2/vFBjKYkfTOkw: calls $4
MfXQsYD8pGeCS7XOtyV+vw: calls $4
4dcDwIHRm96PwtqkpQiuiA: folds
ubtx4Z5L+AcK71MTvYiGVw: calls $2
*** FLOP *** [4d Kd 9h]
ubtx4Z5L+AcK71MTvYiGVw: checks
VvdR9F3I+2yELkfTVvC1dg: checks
uCqEjnxh2/vFBjKYkfTOkw: checks
MfXQsYD8pGeCS7XOtyV+vw: checks
*** TURN *** [4d Kd 9h] [Jd]
ubtx4Z5L+AcK71MTvYiGVw: checks
VvdR9F3I+2yELkfTVvC1dg: checks
uCqEjnxh2/vFBjKYkfTOkw: bets $12
MfXQsYD8pGeCS7XOtyV+vw: folds
ubtx4Z5L+AcK71MTvYiGVw: folds
VvdR9F3I+2yELkfTVvC1dg: folds
uCqEjnxh2/vFBjKYkfTOkw collected $16.15 from pot
uCqEjnxh2/vFBjKYkfTOkw: doesn't show hand
*** SUMMARY ***
Total pot $17 | Rake $0.85
Board [4d Kd 9h Jd]
Seat 1: MfXQsYD8pGeCS7XOtyV+vw (button) folded on the Turn
Seat 2: 4dcDwIHRm96PwtqkpQiuiA (small blind) folded before Flop
Seat 3: ubtx4Z5L+AcK71MTvYiGVw (big blind) folded on the Turn
Seat 4: K8MXCrNAVYlMnnCeM32Kxw folded before Flop (didn't bet)
Seat 5: VvdR9F3I+2yELkfTVvC1dg folded on the Turn
Seat 6: uCqEjnxh2/vFBjKYkfTOkw collected ($16.15)



PokerStars Game #59941312476:  Hold'em No Limit ($1/$2) - 2009/07/01 1:31:47 ET
Table 'QxerF7GUfCbl+4a8XaTB2w' 6-max Seat #2 is the button
Seat 1: 54yWzRRgS0oZ+S6LwZBxMQ ($64 in chips)
Seat 2: HiWSAXs6/0w9Jy7ioiiShQ ($4.65 in chips)
Seat 5: gnYme0DNFflnMhrdbxe1Ag ($239.70 in chips)
Seat 6: VvdR9F3I+2yELkfTVvC1dg ($200 in chips)
/PH6Ffnho4Ysm8S3V/oa+w will be allowed to play after the button
gnYme0DNFflnMhrdbxe1Ag: posts small blind $1
VvdR9F3I+2yELkfTVvC1dg: posts big blind $2
*** HOLE CARDS ***
54yWzRRgS0oZ+S6LwZBxMQ: folds
HiWSAXs6/0w9Jy7ioiiShQ: folds
gnYme0DNFflnMhrdbxe1Ag: folds
VvdR9F3I+2yELkfTVvC1dg collected $2 from pot
VvdR9F3I+2yELkfTVvC1dg: doesn't show hand
*** SUMMARY ***
Total pot $2 | Rake $0
Seat 1: 54yWzRRgS0oZ+S6LwZBxMQ folded before Flop (didn't bet)
Seat 2: HiWSAXs6/0w9Jy7ioiiShQ (button) folded before Flop (didn't bet)
Seat 5: gnYme0DNFflnMhrdbxe1Ag (small blind) folded before Flop
Seat 6: VvdR9F3I+2yELkfTVvC1dg (big blind) collected ($2)



PokerStars Game #59941313838:  Hold'em No Limit ($1/$2) - 2009/07/01 1:31:50 ET
Table 'jlrIxbrVIG+gjaUYT4za8g' 6-max Seat #6 is the button
Seat 1: ygTTt5ehT4aF86q1a8/R+w ($259.30 in chips)
Seat 2: /PH6Ffnho4Ysm8S3V/oa+w ($40 in chips)
Seat 3: gnYme0DNFflnMhrdbxe1Ag ($200 in chips)
Seat 4: 8srN1dKQePlsv0GyTada+Q ($229.55 in chips)
Seat 5: AyBB0k3Dcl7xbXUeGMw06g ($73.90 in chips)
Seat 6: vkfxu8f/jMYKUk6Ly4eujw ($306 in chips)
ygTTt5ehT4aF86q1a8/R+w: posts small blind $1
/PH6Ffnho4Ysm8S3V/oa+w: posts big blind $2
*** HOLE CARDS ***
gnYme0DNFflnMhrdbxe1Ag: raises $4 to $6
8srN1dKQePlsv0GyTada+Q: folds
AyBB0k3Dcl7xbXUeGMw06g: folds
vkfxu8f/jMYKUk6Ly4eujw: folds
ygTTt5ehT4aF86q1a8/R+w: folds
/PH6Ffnho4Ysm8S3V/oa+w: folds
gnYme0DNFflnMhrdbxe1Ag collected $5 from pot
*** SUMMARY ***
Total pot $5 | Rake $0
Seat 1: ygTTt5ehT4aF86q1a8/R+w (small blind) folded before Flop
Seat 2: /PH6Ffnho4Ysm8S3V/oa+w (big blind) folded before Flop
Seat 3: gnYme0DNFflnMhrdbxe1Ag collected ($5)
Seat 4: 8srN1dKQePlsv0GyTada+Q folded before Flop (didn't bet)
Seat 5: AyBB0k3Dcl7xbXUeGMw06g folded before Flop (didn't bet)
Seat 6: vkfxu8f/jMYKUk6Ly4eujw (button) folded before Flop (didn't bet)



PokerStars Game #59941313904:  Hold'em No Limit ($1/$2) - 2009/07/01 1:31:50 ET
Table 'UGLAZZyv+cXmnKjYin0etA' 6-max Seat #2 is the button
Seat 1: vkfxu8f/jMYKUk6Ly4eujw ($204 in chips)
Seat 2: eDLH1PUXFpvJBNMXBVQcGA ($276.35 in chips)
Seat 3: ygTTt5ehT4aF86q1a8/R+w ($115.20 in chips)
Seat 4: SiGJDsvRViJX05vHhA80GQ ($197 in chips)
Seat 5: 54yWzRRgS0oZ+S6LwZBxMQ ($33.45 in chips)
ygTTt5ehT4aF86q1a8/R+w: posts small blind $1
SiGJDsvRViJX05vHhA80GQ: posts big blind $2
*** HOLE CARDS ***
54yWzRRgS0oZ+S6LwZBxMQ: calls $2
vkfxu8f/jMYKUk6Ly4eujw: folds
sTPOWERd9HWPCNrDBwsVjA has returned
eDLH1PUXFpvJBNMXBVQcGA: folds
ygTTt5ehT4aF86q1a8/R+w: folds
SiGJDsvRViJX05vHhA80GQ: checks
*** FLOP *** [Jc Qc Qh]
SiGJDsvRViJX05vHhA80GQ: checks
54yWzRRgS0oZ+S6LwZBxMQ: bets $6
SiGJDsvRViJX05vHhA80GQ: raises $8 to $14
54yWzRRgS0oZ+S6LwZBxMQ: calls $8
*** TURN *** [Jc Qc Qh] [5c]
SiGJDsvRViJX05vHhA80GQ: bets $20
54yWzRRgS0oZ+S6LwZBxMQ: calls $17.45 and is all-in
*** RIVER *** [Jc Qc Qh 5c] [3h]
*** SHOW DOWN ***
SiGJDsvRViJX05vHhA80GQ: shows [4c 6c] (a flush, Queen high)
54yWzRRgS0oZ+S6LwZBxMQ: mucks hand
SiGJDsvRViJX05vHhA80GQ collected $65.90 from pot
*** SUMMARY ***
Total pot $67.90 | Rake $2
Board [Jc Qc Qh 5c 3h]
Seat 1: vkfxu8f/jMYKUk6Ly4eujw folded before Flop (didn't bet)
Seat 2: eDLH1PUXFpvJBNMXBVQcGA (button) folded before Flop (didn't bet)
Seat 3: ygTTt5ehT4aF86q1a8/R+w (small blind) folded before Flop
Seat 4: SiGJDsvRViJX05vHhA80GQ (big blind) showed [4c 6c] and won ($65.90) with a flush, Queen high
Seat 5: 54yWzRRgS0oZ+S6LwZBxMQ mucked



PokerStars Game #59941313880:  Hold'em No Limit ($1/$2) - 2009/07/01 1:31:50 ET
Table 'gftD4mDF7mIFKvSrIyaRbw' 9-max Seat #2 is the button
Seat 2: GX1heJ+DSsvm7gzSPsYhhQ ($42 in chips)
Seat 3: CUZwDpLTQKhzarPe+JCLOQ ($202.75 in chips)
Seat 4: /inIs/z/PcX+TniIFpaxpg ($40 in chips)
Seat 5: mpsfNtnMVDqQHTe92AhIdw ($117.10 in chips)
Seat 6: 2NvwF8W2nzsbS+G//yLAbQ ($113.85 in chips)
Seat 7: +T/63sAeZzWyHchahJ36GQ ($42 in chips)
Seat 8: MpL4DeEqGQu0H8TJEbEOrg ($41 in chips)
CUZwDpLTQKhzarPe+JCLOQ: posts small blind $1
/inIs/z/PcX+TniIFpaxpg: posts big blind $2
*** HOLE CARDS ***
mpsfNtnMVDqQHTe92AhIdw: folds
2NvwF8W2nzsbS+G//yLAbQ: folds
+T/63sAeZzWyHchahJ36GQ: folds
MpL4DeEqGQu0H8TJEbEOrg: folds
GX1heJ+DSsvm7gzSPsYhhQ: raises $4 to $6
CUZwDpLTQKhzarPe+JCLOQ: raises $18 to $24
/inIs/z/PcX+TniIFpaxpg: folds
GX1heJ+DSsvm7gzSPsYhhQ: folds
CUZwDpLTQKhzarPe+JCLOQ collected $14 from pot
CUZwDpLTQKhzarPe+JCLOQ: doesn't show hand
*** SUMMARY ***
Total pot $14 | Rake $0
Seat 2: GX1heJ+DSsvm7gzSPsYhhQ (button) folded before Flop
Seat 3: CUZwDpLTQKhzarPe+JCLOQ (small blind) collected ($14)
Seat 4: /inIs/z/PcX+TniIFpaxpg (big blind) folded before Flop
Seat 5: mpsfNtnMVDqQHTe92AhIdw folded before Flop (didn't bet)
Seat 6: 2NvwF8W2nzsbS+G//yLAbQ folded before Flop (didn't bet)
Seat 7: +T/63sAeZzWyHchahJ36GQ folded before Flop (didn't bet)
Seat 8: MpL4DeEqGQu0H8TJEbEOrg folded before Flop (didn't bet)



PokerStars Game #59941315526:  Hold'em No Limit ($1/$2) - 2009/07/01 1:31:53 ET
Table 'mGpP9StWRnoeiBDExc6Frg' 6-max Seat #5 is the button
Seat 1: VvdR9F3I+2yELkfTVvC1dg ($309.05 in chips)
Seat 2: vkfxu8f/jMYKUk6Ly4eujw ($200 in chips)
Seat 3: 7acrZUQC3Zc9BNLjoKIcLQ ($24.40 in chips)
Seat 4: 4dcDwIHRm96PwtqkpQiuiA ($79.70 in chips)
Seat 5: d1puGuVBE0fidn+5eRJ0tw ($192.95 in chips)
Seat 6: B2Ih1sr5VZk+8He7rcrMtQ ($432.05 in chips)
B2Ih1sr5VZk+8He7rcrMtQ: posts small blind $1
VvdR9F3I+2yELkfTVvC1dg: posts big blind $2
*** HOLE CARDS ***
vkfxu8f/jMYKUk6Ly4eujw: folds
7acrZUQC3Zc9BNLjoKIcLQ: folds
4dcDwIHRm96PwtqkpQiuiA: folds
d1puGuVBE0fidn+5eRJ0tw: folds
B2Ih1sr5VZk+8He7rcrMtQ: folds
VvdR9F3I+2yELkfTVvC1dg collected $2 from pot
VvdR9F3I+2yELkfTVvC1dg: doesn't show hand
*** SUMMARY ***
Total pot $2 | Rake $0
Seat 1: VvdR9F3I+2yELkfTVvC1dg (big blind) collected ($2)
Seat 2: vkfxu8f/jMYKUk6Ly4eujw folded before Flop (didn't bet)
Seat 3: 7acrZUQC3Zc9BNLjoKIcLQ folded before Flop (didn't bet)
Seat 4: 4dcDwIHRm96PwtqkpQiuiA folded before Flop (didn't bet)
Seat 5: d1puGuVBE0fidn+5eRJ0tw (button) folded before Flop (didn't bet)
Seat 6: B2Ih1sr5VZk+8He7rcrMtQ (small blind) folded before Flop



PokerStars Game #59941316100:  Hold'em No Limit ($1/$2) - 2009/07/01 1:31:54 ET
Table 'kq5zaQ+1hLNf8LZfGnbTAA' 6-max Seat #5 is the button
Seat 1: 8srN1dKQePlsv0GyTada+Q ($408 in chips)
Seat 2: nXDI8Y/S6POzRwANu3d8hQ ($187 in chips)
Seat 3: vkfxu8f/jMYKUk6Ly4eujw ($225.95 in chips)
Seat 4: 3dAbvkxS5NPQTBAbvpinVg ($281.45 in chips)
Seat 5: gnYme0DNFflnMhrdbxe1Ag ($200 in chips)
Seat 6: mfy7uGZcqA2PVQqEVbJ7+g ($192.25 in chips)
mfy7uGZcqA2PVQqEVbJ7+g: posts small blind $1
8srN1dKQePlsv0GyTada+Q: posts big blind $2
*** HOLE CARDS ***
nXDI8Y/S6POzRwANu3d8hQ: folds
vkfxu8f/jMYKUk6Ly4eujw: folds
3dAbvkxS5NPQTBAbvpinVg: folds
gnYme0DNFflnMhrdbxe1Ag: raises $4 to $6
mfy7uGZcqA2PVQqEVbJ7+g: folds
8srN1dKQePlsv0GyTada+Q: raises $13 to $19
gnYme0DNFflnMhrdbxe1Ag: folds
8srN1dKQePlsv0GyTada+Q collected $13 from pot
8srN1dKQePlsv0GyTada+Q: doesn't show hand
*** SUMMARY ***
Total pot $13 | Rake $0
Seat 1: 8srN1dKQePlsv0GyTada+Q (big blind) collected ($13)
Seat 2: nXDI8Y/S6POzRwANu3d8hQ folded before Flop (didn't bet)
Seat 3: vkfxu8f/jMYKUk6Ly4eujw folded before Flop (didn't bet)
Seat 4: 3dAbvkxS5NPQTBAbvpinVg folded before Flop (didn't bet)
Seat 5: gnYme0DNFflnMhrdbxe1Ag (button) folded before Flop
Seat 6: mfy7uGZcqA2PVQqEVbJ7+g (small blind) folded before Flop



PokerStars Game #59941316348:  Hold'em No Limit ($1/$2) - 2009/07/01 1:31:54 ET
Table '4NGNnZ/osQfNq6abYqkJeA' 6-max Seat #2 is the button
Seat 1: vkfxu8f/jMYKUk6Ly4eujw ($200 in chips)
Seat 2: 669iGNwYwgRZg3nhS+aDAQ ($95.45 in chips)
Seat 3: 54yWzRRgS0oZ+S6LwZBxMQ ($38 in chips)
Seat 4: sY+4Uuh5z/6AbXXaCS10jw ($222.25 in chips)
Seat 5: VvdR9F3I+2yELkfTVvC1dg ($241.85 in chips)
Seat 6: 3cPMpDMgeOMAe4UceUfLsg ($203 in chips)
54yWzRRgS0oZ+S6LwZBxMQ: posts small blind $1
sY+4Uuh5z/6AbXXaCS10jw: posts big blind $2
*** HOLE CARDS ***
VvdR9F3I+2yELkfTVvC1dg: folds
3cPMpDMgeOMAe4UceUfLsg: folds
vkfxu8f/jMYKUk6Ly4eujw: folds
669iGNwYwgRZg3nhS+aDAQ: folds
54yWzRRgS0oZ+S6LwZBxMQ: folds
sY+4Uuh5z/6AbXXaCS10jw collected $2 from pot
*** SUMMARY ***
Total pot $2 | Rake $0
Seat 1: vkfxu8f/jMYKUk6Ly4eujw folded before Flop (didn't bet)
Seat 2: 669iGNwYwgRZg3nhS+aDAQ (button) folded before Flop (didn't bet)
Seat 3: 54yWzRRgS0oZ+S6LwZBxMQ (small blind) folded before Flop
Seat 4: sY+4Uuh5z/6AbXXaCS10jw (big blind) collected ($2)
Seat 5: VvdR9F3I+2yELkfTVvC1dg folded before Flop (didn't bet)
Seat 6: 3cPMpDMgeOMAe4UceUfLsg folded before Flop (didn't bet)



PokerStars Game #59941316324:  Hold'em No Limit ($1/$2) - 2009/07/01 1:31:54 ET
Table 'eTkRjRjsYr567snmNk8kNQ' 2-max Seat #2 is the button
Seat 1: t6Jd836OSEMbcRi7rfGp5g ($207.50 in chips)
Seat 2: UNpnKQk0gkkyFJen8upqag ($288.50 in chips)
UNpnKQk0gkkyFJen8upqag: posts small blind $1
t6Jd836OSEMbcRi7rfGp5g: posts big blind $2
*** HOLE CARDS ***
UNpnKQk0gkkyFJen8upqag: raises $4 to $6
t6Jd836OSEMbcRi7rfGp5g: folds
UNpnKQk0gkkyFJen8upqag collected $4 from pot
*** SUMMARY ***
Total pot $4 | Rake $0
Seat 1: t6Jd836OSEMbcRi7rfGp5g (big blind) folded before Flop
Seat 2: UNpnKQk0gkkyFJen8upqag (button) (small blind) collected ($4)



PokerStars Game #59941319460:  Hold'em No Limit ($1/$2) - 2009/07/01 1:31:59 ET
Table 'ztv6V3FN2bQ9nmJPPdx6nQ' 6-max Seat #2 is the button
Seat 1: 6fLdOUCRtX71xbVRhJEq8w ($241.35 in chips)
Seat 2: 5Y+ZGWLI4gnlpApDX5vy1A ($386.75 in chips)
Seat 3: ubtx4Z5L+AcK71MTvYiGVw ($246 in chips)
Seat 5: sTPOWERd9HWPCNrDBwsVjA ($222.80 in chips)
Seat 6: mfy7uGZcqA2PVQqEVbJ7+g ($97.45 in chips)
ubtx4Z5L+AcK71MTvYiGVw: posts small blind $1
sTPOWERd9HWPCNrDBwsVjA: posts big blind $2
*** HOLE CARDS ***
mfy7uGZcqA2PVQqEVbJ7+g: folds
6fLdOUCRtX71xbVRhJEq8w: folds
5Y+ZGWLI4gnlpApDX5vy1A has timed out
5Y+ZGWLI4gnlpApDX5vy1A: folds
5Y+ZGWLI4gnlpApDX5vy1A is sitting out
5Y+ZGWLI4gnlpApDX5vy1A has returned
ubtx4Z5L+AcK71MTvYiGVw: folds
sTPOWERd9HWPCNrDBwsVjA collected $2 from pot
*** SUMMARY ***
Total pot $2 | Rake $0
Seat 1: 6fLdOUCRtX71xbVRhJEq8w folded before Flop (didn't bet)
Seat 2: 5Y+ZGWLI4gnlpApDX5vy1A (button) folded before Flop (didn't bet)
Seat 3: ubtx4Z5L+AcK71MTvYiGVw (small blind) folded before Flop
Seat 5: sTPOWERd9HWPCNrDBwsVjA (big blind) collected ($2)
Seat 6: mfy7uGZcqA2PVQqEVbJ7+g folded before Flop (didn't bet)



PokerStars Game #59941320942:  Hold'em No Limit ($1/$2) - 2009/07/01 1:32:02 ET
Table 'eTkRjRjsYr567snmNk8kNQ' 2-max Seat #1 is the button
Seat 1: t6Jd836OSEMbcRi7rfGp5g ($205.50 in chips)
Seat 2: UNpnKQk0gkkyFJen8upqag ($290.50 in chips)
t6Jd836OSEMbcRi7rfGp5g: posts small blind $1
UNpnKQk0gkkyFJen8upqag: posts big blind $2
*** HOLE CARDS ***
t6Jd836OSEMbcRi7rfGp5g: raises $4 to $6
UNpnKQk0gkkyFJen8upqag: folds
t6Jd836OSEMbcRi7rfGp5g collected $4 from pot
*** SUMMARY ***
Total pot $4 | Rake $0
Seat 1: t6Jd836OSEMbcRi7rfGp5g (button) (small blind) collected ($4)
Seat 2: UNpnKQk0gkkyFJen8upqag (big blind) folded before Flop



PokerStars Game #59941321544:  Hold'em No Limit ($1/$2) - 2009/07/01 1:32:03 ET
Table 'W9UeSV0aoPjh5SFSxM8jUQ' 9-max Seat #9 is the button
Seat 1: mIKx5lhIt13X5eZQH0ZeMA ($29.40 in chips)
Seat 3: /inIs/z/PcX+TniIFpaxpg ($25 in chips)
Seat 4: 4YA/sQy1Emm680zhbPUjow ($136.35 in chips)
Seat 5: ri8CLkX3e9JF34dQNbsHGA ($40 in chips)
Seat 6: j47DM+lqTfzZP8musviQTg ($129.30 in chips)
Seat 7: I2ipWauytvrkEer4XD3Sjg ($77.70 in chips)
Seat 8: odhvI/CZeMsPyo1n1U7+hA ($40.40 in chips)
Seat 9: Q104K4iDGcqOlVrjAkzPEA ($95.10 in chips)
mIKx5lhIt13X5eZQH0ZeMA: posts small blind $1
iMe5yhc+1BaiIPHet3NMrA: is sitting out
/inIs/z/PcX+TniIFpaxpg: posts big blind $2
*** HOLE CARDS ***
4YA/sQy1Emm680zhbPUjow: folds
ri8CLkX3e9JF34dQNbsHGA: folds
j47DM+lqTfzZP8musviQTg: folds
I2ipWauytvrkEer4XD3Sjg: folds
odhvI/CZeMsPyo1n1U7+hA: calls $2
Q104K4iDGcqOlVrjAkzPEA: raises $4 to $6
mIKx5lhIt13X5eZQH0ZeMA: folds
/inIs/z/PcX+TniIFpaxpg: folds
odhvI/CZeMsPyo1n1U7+hA: calls $4
*** FLOP *** [As Th 3c]
odhvI/CZeMsPyo1n1U7+hA: checks
Q104K4iDGcqOlVrjAkzPEA: bets $8
odhvI/CZeMsPyo1n1U7+hA: folds
Q104K4iDGcqOlVrjAkzPEA collected $14.25 from pot
*** SUMMARY ***
Total pot $15 | Rake $0.75
Board [As Th 3c]
Seat 1: mIKx5lhIt13X5eZQH0ZeMA (small blind) folded before Flop
Seat 3: /inIs/z/PcX+TniIFpaxpg (big blind) folded before Flop
Seat 4: 4YA/sQy1Emm680zhbPUjow folded before Flop (didn't bet)
Seat 5: ri8CLkX3e9JF34dQNbsHGA folded before Flop (didn't bet)
Seat 6: j47DM+lqTfzZP8musviQTg folded before Flop (didn't bet)
Seat 7: I2ipWauytvrkEer4XD3Sjg folded before Flop (didn't bet)
Seat 8: odhvI/CZeMsPyo1n1U7+hA folded on the Flop
Seat 9: Q104K4iDGcqOlVrjAkzPEA (button) collected ($14.25)



PokerStars Game #59941322118:  Hold'em No Limit ($1/$2) - 2009/07/01 1:32:04 ET
Table 'aSf77Sj8QEnzcc0WaxVD4Q' 6-max Seat #5 is the button
Seat 1: UELtvp+JfwI7XDGVwSxZXA ($145.55 in chips)
Seat 2: vkfxu8f/jMYKUk6Ly4eujw ($201.80 in chips)
Seat 3: 9dpyyjDTCed6nV7JhaUUpw ($526.70 in chips)
Seat 4: YsLQ3BAvgQHWXMAv3Wv6Hg ($271.70 in chips)
Seat 5: VvdR9F3I+2yELkfTVvC1dg ($237 in chips)
Seat 6: vkoJRf3gidxY1pPi0AFWww ($132.35 in chips)
vkoJRf3gidxY1pPi0AFWww: posts small blind $1
UELtvp+JfwI7XDGVwSxZXA: posts big blind $2
*** HOLE CARDS ***
vkfxu8f/jMYKUk6Ly4eujw: folds
9dpyyjDTCed6nV7JhaUUpw: raises $4 to $6
YsLQ3BAvgQHWXMAv3Wv6Hg: raises $12 to $18
VvdR9F3I+2yELkfTVvC1dg: folds
vkoJRf3gidxY1pPi0AFWww: folds
UELtvp+JfwI7XDGVwSxZXA: calls $16
9dpyyjDTCed6nV7JhaUUpw: folds
*** FLOP *** [Ts Qc 3c]
UELtvp+JfwI7XDGVwSxZXA: checks
YsLQ3BAvgQHWXMAv3Wv6Hg: bets $36
UELtvp+JfwI7XDGVwSxZXA: raises $36 to $72
YsLQ3BAvgQHWXMAv3Wv6Hg: raises $181.70 to $253.70 and is all-in
UELtvp+JfwI7XDGVwSxZXA: calls $55.55 and is all-in
*** TURN *** [Ts Qc 3c] [2s]
*** RIVER *** [Ts Qc 3c 2s] [6d]
*** SHOW DOWN ***
UELtvp+JfwI7XDGVwSxZXA: shows [Ad Ac] (a pair of Aces)
YsLQ3BAvgQHWXMAv3Wv6Hg: mucks hand
UELtvp+JfwI7XDGVwSxZXA collected $295.10 from pot
*** SUMMARY ***
Total pot $298.10 | Rake $3
Board [Ts Qc 3c 2s 6d]
Seat 1: UELtvp+JfwI7XDGVwSxZXA (big blind) showed [Ad Ac] and won ($295.10) with a pair of Aces
Seat 2: vkfxu8f/jMYKUk6Ly4eujw folded before Flop (didn't bet)
Seat 3: 9dpyyjDTCed6nV7JhaUUpw folded before Flop
Seat 4: YsLQ3BAvgQHWXMAv3Wv6Hg mucked
Seat 5: VvdR9F3I+2yELkfTVvC1dg (button) folded before Flop (didn't bet)
Seat 6: vkoJRf3gidxY1pPi0AFWww (small blind) folded before Flop



PokerStars Game #59941322566:  Hold'em No Limit ($1/$2) - 2009/07/01 1:32:05 ET
Table 'qVXak+oTeDXMGbWa4sDU5Q' 9-max Seat #3 is the button
Seat 1: H6Z4+qu8gR0VUiPOijndVg ($205.55 in chips)
Seat 2: rW/MyplHylMSBRaoRUzWrg ($81 in chips)
Seat 3: WUlHm+ydPPHG7Lb0rePSdA ($150.65 in chips)
Seat 4: lQYT23h5QCUVZAKxjOO39Q ($201.70 in chips)
Seat 5: FWGiDqRwvLeKmHq9t4Jy9w ($268.80 in chips)
Seat 6: GX1heJ+DSsvm7gzSPsYhhQ ($37 in chips)
Seat 7: PfmlvZlFiss79a6IoEr11g ($163.30 in chips)
Seat 8: Z0rzUi0y1x80UdIpofoNbA ($125.55 in chips)
Seat 9: CkE3IyJF1KvdaAOmZY5XqQ ($200 in chips)
lQYT23h5QCUVZAKxjOO39Q: posts small blind $1
FWGiDqRwvLeKmHq9t4Jy9w: posts big blind $2
*** HOLE CARDS ***
GX1heJ+DSsvm7gzSPsYhhQ: raises $4 to $6
PfmlvZlFiss79a6IoEr11g: folds
Z0rzUi0y1x80UdIpofoNbA: folds
CkE3IyJF1KvdaAOmZY5XqQ: folds
H6Z4+qu8gR0VUiPOijndVg: folds
rW/MyplHylMSBRaoRUzWrg: folds
WUlHm+ydPPHG7Lb0rePSdA: folds
lQYT23h5QCUVZAKxjOO39Q: folds
FWGiDqRwvLeKmHq9t4Jy9w: folds
GX1heJ+DSsvm7gzSPsYhhQ collected $5 from pot
GX1heJ+DSsvm7gzSPsYhhQ: doesn't show hand
*** SUMMARY ***
Total pot $5 | Rake $0
Seat 1: H6Z4+qu8gR0VUiPOijndVg folded before Flop (didn't bet)
Seat 2: rW/MyplHylMSBRaoRUzWrg folded before Flop (didn't bet)
Seat 3: WUlHm+ydPPHG7Lb0rePSdA (button) folded before Flop (didn't bet)
Seat 4: lQYT23h5QCUVZAKxjOO39Q (small blind) folded before Flop
Seat 5: FWGiDqRwvLeKmHq9t4Jy9w (big blind) folded before Flop
Seat 6: GX1heJ+DSsvm7gzSPsYhhQ collected ($5)
Seat 7: PfmlvZlFiss79a6IoEr11g folded before Flop (didn't bet)
Seat 8: Z0rzUi0y1x80UdIpofoNbA folded before Flop (didn't bet)
Seat 9: CkE3IyJF1KvdaAOmZY5XqQ folded before Flop (didn't bet)



PokerStars Game #59941323622:  Hold'em No Limit ($1/$2) - 2009/07/01 1:32:06 ET
Table 'YqGfR5eHfMeSjb9a+QU9rg' 9-max Seat #5 is the button
Seat 1: rW/MyplHylMSBRaoRUzWrg ($34 in chips)
Seat 2: W3Nqt1GWlTi9tXQXMNEvgw ($401.85 in chips)
Seat 3: /gll27k+xWYV7Fbki0lFDQ ($258.75 in chips)
Seat 4: GX1heJ+DSsvm7gzSPsYhhQ ($37 in chips)
Seat 5: CkE3IyJF1KvdaAOmZY5XqQ ($200 in chips)
Seat 6: TAfo4veNRaRlzDXMMYS3Jg ($35 in chips)
Seat 7: 41aZuLBz9nAi2GPVKabmCw ($100.95 in chips)
Seat 8: JnV3SM2D6dAFYyGZHHpvrg ($93.25 in chips)
Seat 9: /inIs/z/PcX+TniIFpaxpg ($205.20 in chips)
TAfo4veNRaRlzDXMMYS3Jg: posts small blind $1
41aZuLBz9nAi2GPVKabmCw: posts big blind $2
*** HOLE CARDS ***
JnV3SM2D6dAFYyGZHHpvrg: folds
/inIs/z/PcX+TniIFpaxpg: folds
rW/MyplHylMSBRaoRUzWrg: folds
W3Nqt1GWlTi9tXQXMNEvgw: folds
/gll27k+xWYV7Fbki0lFDQ: folds
GX1heJ+DSsvm7gzSPsYhhQ: folds
CkE3IyJF1KvdaAOmZY5XqQ: folds
TAfo4veNRaRlzDXMMYS3Jg: folds
41aZuLBz9nAi2GPVKabmCw collected $2 from pot
*** SUMMARY ***
Total pot $2 | Rake $0
Seat 1: rW/MyplHylMSBRaoRUzWrg folded before Flop (didn't bet)
Seat 2: W3Nqt1GWlTi9tXQXMNEvgw folded before Flop (didn't bet)
Seat 3: /gll27k+xWYV7Fbki0lFDQ folded before Flop (didn't bet)
Seat 4: GX1heJ+DSsvm7gzSPsYhhQ folded before Flop (didn't bet)
Seat 5: CkE3IyJF1KvdaAOmZY5XqQ (button) folded before Flop (didn't bet)
Seat 6: TAfo4veNRaRlzDXMMYS3Jg (small blind) folded before Flop
Seat 7: 41aZuLBz9nAi2GPVKabmCw (big blind) collected ($2)
Seat 8: JnV3SM2D6dAFYyGZHHpvrg folded before Flop (didn't bet)
Seat 9: /inIs/z/PcX+TniIFpaxpg folded before Flop (didn't bet)



PokerStars Game #59941324060:  Hold'em No Limit ($1/$2) - 2009/07/01 1:32:07 ET
Table 'ZzSIe0zTCDv+n6hfbY5tTg' 6-max Seat #4 is the button
Seat 1: VvdR9F3I+2yELkfTVvC1dg ($200 in chips)
Seat 2: B87ikIyZ/TzAVeXf38Ny0g ($283 in chips)
Seat 3: gsugPj31Hui3Jefl98MBOA ($417 in chips)
Seat 4: qXDd0ZyMIse0OBu8pxeQ3Q ($202 in chips)
Seat 5: 3dAbvkxS5NPQTBAbvpinVg ($478.30 in chips)
Seat 6: 09BNF4quPDzanQzM8vc6WA ($26.05 in chips)
3dAbvkxS5NPQTBAbvpinVg: posts small blind $1
09BNF4quPDzanQzM8vc6WA: posts big blind $2
*** HOLE CARDS ***
VvdR9F3I+2yELkfTVvC1dg: folds
B87ikIyZ/TzAVeXf38Ny0g: folds
gsugPj31Hui3Jefl98MBOA: calls $2
qXDd0ZyMIse0OBu8pxeQ3Q: raises $8 to $10
3dAbvkxS5NPQTBAbvpinVg: folds
09BNF4quPDzanQzM8vc6WA: folds
gsugPj31Hui3Jefl98MBOA: calls $8
*** FLOP *** [Kd 7c Qh]
gsugPj31Hui3Jefl98MBOA: checks
qXDd0ZyMIse0OBu8pxeQ3Q: bets $16
gsugPj31Hui3Jefl98MBOA: calls $16
*** TURN *** [Kd 7c Qh] [5c]
gsugPj31Hui3Jefl98MBOA: checks
qXDd0ZyMIse0OBu8pxeQ3Q: bets $38
gsugPj31Hui3Jefl98MBOA: calls $38
*** RIVER *** [Kd 7c Qh 5c] [8h]
gsugPj31Hui3Jefl98MBOA: checks
qXDd0ZyMIse0OBu8pxeQ3Q: bets $78
gsugPj31Hui3Jefl98MBOA: folds
qXDd0ZyMIse0OBu8pxeQ3Q collected $128 from pot
*** SUMMARY ***
Total pot $131 | Rake $3
Board [Kd 7c Qh 5c 8h]
Seat 1: VvdR9F3I+2yELkfTVvC1dg folded before Flop (didn't bet)
Seat 2: B87ikIyZ/TzAVeXf38Ny0g folded before Flop (didn't bet)
Seat 3: gsugPj31Hui3Jefl98MBOA folded on the River
Seat 4: qXDd0ZyMIse0OBu8pxeQ3Q (button) collected ($128)
Seat 5: 3dAbvkxS5NPQTBAbvpinVg (small blind) folded before Flop
Seat 6: 09BNF4quPDzanQzM8vc6WA (big blind) folded before Flop



PokerStars Game #59941324040:  Hold'em No Limit ($1/$2) - 2009/07/01 1:32:07 ET
Table 'eyAQSIlgc2o1Jxvbve4WGg' 9-max Seat #8 is the button
Seat 1: UZEsV9yKUMqmpYPiOFpaZw ($105.20 in chips)
Seat 2: g7gL2NLJCdZPPV399WKT1w ($64.25 in chips)
Seat 4: CkE3IyJF1KvdaAOmZY5XqQ ($200 in chips)
Seat 5: mIKx5lhIt13X5eZQH0ZeMA ($115.80 in chips)
Seat 6: nXDI8Y/S6POzRwANu3d8hQ ($6 in chips)
Seat 7: u3OrI5uGx9mx1fE7dgr+EA ($75.20 in chips)
Seat 8: 1CtiZuXDFaJL1dJPQKyi8Q ($161.95 in chips)
Seat 9: WUlHm+ydPPHG7Lb0rePSdA ($126.95 in chips)
WUlHm+ydPPHG7Lb0rePSdA: posts small blind $1
UZEsV9yKUMqmpYPiOFpaZw: posts big blind $2
*** HOLE CARDS ***
g7gL2NLJCdZPPV399WKT1w: folds
g7gL2NLJCdZPPV399WKT1w leaves the table
CkE3IyJF1KvdaAOmZY5XqQ has timed out
CkE3IyJF1KvdaAOmZY5XqQ: folds
CkE3IyJF1KvdaAOmZY5XqQ is sitting out
kM9CA+2UcdMjbCMbtUCGiA joins the table at seat #2
mIKx5lhIt13X5eZQH0ZeMA: folds
nXDI8Y/S6POzRwANu3d8hQ: folds
u3OrI5uGx9mx1fE7dgr+EA: folds
1CtiZuXDFaJL1dJPQKyi8Q: folds
CkE3IyJF1KvdaAOmZY5XqQ has returned
WUlHm+ydPPHG7Lb0rePSdA: folds
UZEsV9yKUMqmpYPiOFpaZw collected $2 from pot
UZEsV9yKUMqmpYPiOFpaZw: doesn't show hand
*** SUMMARY ***
Total pot $2 | Rake $0
Seat 1: UZEsV9yKUMqmpYPiOFpaZw (big blind) collected ($2)
Seat 2: g7gL2NLJCdZPPV399WKT1w folded before Flop (didn't bet)
Seat 4: CkE3IyJF1KvdaAOmZY5XqQ folded before Flop (didn't bet)
Seat 5: mIKx5lhIt13X5eZQH0ZeMA folded before Flop (didn't bet)
Seat 6: nXDI8Y/S6POzRwANu3d8hQ folded before Flop (didn't bet)
Seat 7: u3OrI5uGx9mx1fE7dgr+EA folded before Flop (didn't bet)
Seat 8: 1CtiZuXDFaJL1dJPQKyi8Q (button) folded before Flop (didn't bet)
Seat 9: WUlHm+ydPPHG7Lb0rePSdA (small blind) folded before Flop



PokerStars Game #59941325198:  Hold'em No Limit ($1/$2) - 2009/07/01 1:32:09 ET
Table 'CFkQcfWjKccZaZDf71FK+w' 6-max Seat #3 is the button
Seat 2: ewN/vzF22+/gdzjIKBOlkA ($207.80 in chips)
Seat 3: 09BNF4quPDzanQzM8vc6WA ($52.65 in chips)
Seat 4: ygTTt5ehT4aF86q1a8/R+w ($224.25 in chips)
Seat 5: 2lOU1DcvUZaMcxZ95XfzXw ($136.15 in chips)
Seat 6: ORVqY3rf9X6ANA/8s+On2Q ($149.60 in chips)
ygTTt5ehT4aF86q1a8/R+w: posts small blind $1
2lOU1DcvUZaMcxZ95XfzXw: posts big blind $2
vkfxu8f/jMYKUk6Ly4eujw: sits out
*** HOLE CARDS ***
ORVqY3rf9X6ANA/8s+On2Q: calls $2
ewN/vzF22+/gdzjIKBOlkA: folds
09BNF4quPDzanQzM8vc6WA: raises $4 to $6
ygTTt5ehT4aF86q1a8/R+w: calls $5
2lOU1DcvUZaMcxZ95XfzXw: calls $4
ORVqY3rf9X6ANA/8s+On2Q: folds
*** FLOP *** [2d Kc 5h]
ygTTt5ehT4aF86q1a8/R+w: checks
2lOU1DcvUZaMcxZ95XfzXw: checks
09BNF4quPDzanQzM8vc6WA: checks
*** TURN *** [2d Kc 5h] [4h]
ygTTt5ehT4aF86q1a8/R+w: checks
2lOU1DcvUZaMcxZ95XfzXw: checks
09BNF4quPDzanQzM8vc6WA: checks
*** RIVER *** [2d Kc 5h 4h] [7c]
ygTTt5ehT4aF86q1a8/R+w: checks
2lOU1DcvUZaMcxZ95XfzXw: bets $4
09BNF4quPDzanQzM8vc6WA: folds
ygTTt5ehT4aF86q1a8/R+w: calls $4
*** SHOW DOWN ***
2lOU1DcvUZaMcxZ95XfzXw: shows [Tc Th] (a pair of Tens)
ygTTt5ehT4aF86q1a8/R+w: mucks hand
2lOU1DcvUZaMcxZ95XfzXw collected $26.65 from pot
*** SUMMARY ***
Total pot $28 | Rake $1.35
Board [2d Kc 5h 4h 7c]
Seat 2: ewN/vzF22+/gdzjIKBOlkA folded before Flop (didn't bet)
Seat 3: 09BNF4quPDzanQzM8vc6WA (button) folded on the River
Seat 4: ygTTt5ehT4aF86q1a8/R+w (small blind) mucked
Seat 5: 2lOU1DcvUZaMcxZ95XfzXw (big blind) showed [Tc Th] and won ($26.65) with a pair of Tens
Seat 6: ORVqY3rf9X6ANA/8s+On2Q folded before Flop



PokerStars Game #59941325492:  Hold'em No Limit ($1/$2) - 2009/07/01 1:32:10 ET
Table 'AtOXMvcrtQM8yLNcALmfLQ' 2-max Seat #1 is the button
Seat 1: +HlQuAsMqZGYYtjcPO/a3A ($364.40 in chips)
Seat 2: pVqEzK9wXlRMECnb1Zg4Zw ($200 in chips)
+HlQuAsMqZGYYtjcPO/a3A: posts small blind $1
pVqEzK9wXlRMECnb1Zg4Zw: posts big blind $2
*** HOLE CARDS ***
+HlQuAsMqZGYYtjcPO/a3A: raises $4 to $6
pVqEzK9wXlRMECnb1Zg4Zw: folds
+HlQuAsMqZGYYtjcPO/a3A collected $4 from pot
*** SUMMARY ***
Total pot $4 | Rake $0
Seat 1: +HlQuAsMqZGYYtjcPO/a3A (button) (small blind) collected ($4)
Seat 2: pVqEzK9wXlRMECnb1Zg4Zw (big blind) folded before Flop



PokerStars Game #59941326356:  Hold'em No Limit ($1/$2) - 2009/07/01 1:32:11 ET
Table '8Y6PEyoNuepZTai2Q56aHw' 9-max Seat #2 is the button
Seat 1: 5Q8U6iZbeO7xJSS4qvDP5g ($311.80 in chips)
Seat 2: gDCJIAlovbPnTvMM7Dd1gA ($191.15 in chips)
Seat 3: WUlHm+ydPPHG7Lb0rePSdA ($215.10 in chips)
Seat 4: xKkwALG38OfLQ9DXuJgR1w ($247.25 in chips)
Seat 6: NtLDBSjsJQEKekh5cdinvw ($373.35 in chips)
Seat 7: Kzta8yu9vxHT4B70mjBZ+w ($200 in chips)
Seat 8: rW/MyplHylMSBRaoRUzWrg ($36 in chips)
Seat 9: F7m34OOfAQ7annesMHVjKw ($197 in chips)
WUlHm+ydPPHG7Lb0rePSdA: posts small blind $1
xKkwALG38OfLQ9DXuJgR1w: posts big blind $2
/inIs/z/PcX+TniIFpaxpg: sits out
*** HOLE CARDS ***
NtLDBSjsJQEKekh5cdinvw: folds
Kzta8yu9vxHT4B70mjBZ+w: folds
rW/MyplHylMSBRaoRUzWrg: raises $6 to $8
F7m34OOfAQ7annesMHVjKw: folds
5Q8U6iZbeO7xJSS4qvDP5g: folds
gDCJIAlovbPnTvMM7Dd1gA: folds
WUlHm+ydPPHG7Lb0rePSdA: folds
xKkwALG38OfLQ9DXuJgR1w: calls $6
*** FLOP *** [Ks 6c Td]
xKkwALG38OfLQ9DXuJgR1w: checks
rW/MyplHylMSBRaoRUzWrg: bets $8
xKkwALG38OfLQ9DXuJgR1w: calls $8
*** TURN *** [Ks 6c Td] [Qd]
xKkwALG38OfLQ9DXuJgR1w: checks
rW/MyplHylMSBRaoRUzWrg: bets $20 and is all-in
xKkwALG38OfLQ9DXuJgR1w: calls $20
*** RIVER *** [Ks 6c Td Qd] [7c]
*** SHOW DOWN ***
xKkwALG38OfLQ9DXuJgR1w: shows [As Ts] (a pair of Tens)
rW/MyplHylMSBRaoRUzWrg: shows [Qs Kh] (two pair, Kings and Queens)
rW/MyplHylMSBRaoRUzWrg collected $70 from pot
*** SUMMARY ***
Total pot $73 | Rake $3
Board [Ks 6c Td Qd 7c]
Seat 1: 5Q8U6iZbeO7xJSS4qvDP5g folded before Flop (didn't bet)
Seat 2: gDCJIAlovbPnTvMM7Dd1gA (button) folded before Flop (didn't bet)
Seat 3: WUlHm+ydPPHG7Lb0rePSdA (small blind) folded before Flop
Seat 4: xKkwALG38OfLQ9DXuJgR1w (big blind) showed [As Ts] and lost with a pair of Tens
Seat 6: NtLDBSjsJQEKekh5cdinvw folded before Flop (didn't bet)
Seat 7: Kzta8yu9vxHT4B70mjBZ+w folded before Flop (didn't bet)
Seat 8: rW/MyplHylMSBRaoRUzWrg showed [Qs Kh] and won ($70) with two pair, Kings and Queens
Seat 9: F7m34OOfAQ7annesMHVjKw folded before Flop (didn't bet)



PokerStars Game #59941327140:  Hold'em No Limit ($1/$2) - 2009/07/01 1:32:13 ET
Table '3WCXyaiCAbqSShQu7FIjvA' 9-max Seat #9 is the button
Seat 1: kTCkABD1UUldS9DFRGfCwQ ($157.75 in chips)
Seat 2: TAfo4veNRaRlzDXMMYS3Jg ($40 in chips)
Seat 3: 5Q8U6iZbeO7xJSS4qvDP5g ($272.15 in chips)
Seat 4: waEF/+pxZTxNo4FvsORuXg ($82.40 in chips)
Seat 5: CkE3IyJF1KvdaAOmZY5XqQ ($200 in chips)
Seat 6: 5jQlngvMSqM/WoonOcR5kw ($245.35 in chips)
Seat 8: 1CtiZuXDFaJL1dJPQKyi8Q ($238.05 in chips)
Seat 9: FiXPLJyqb24l32QST2TInw ($144.40 in chips)
kTCkABD1UUldS9DFRGfCwQ: posts small blind $1
TAfo4veNRaRlzDXMMYS3Jg: posts big blind $2
nXDI8Y/S6POzRwANu3d8hQ: sits out
*** HOLE CARDS ***
5Q8U6iZbeO7xJSS4qvDP5g: folds
waEF/+pxZTxNo4FvsORuXg: folds
CkE3IyJF1KvdaAOmZY5XqQ: folds
5jQlngvMSqM/WoonOcR5kw: folds
1CtiZuXDFaJL1dJPQKyi8Q: raises $4 to $6
FiXPLJyqb24l32QST2TInw: folds
kTCkABD1UUldS9DFRGfCwQ: folds
TAfo4veNRaRlzDXMMYS3Jg: folds
1CtiZuXDFaJL1dJPQKyi8Q collected $5 from pot
1CtiZuXDFaJL1dJPQKyi8Q: doesn't show hand
*** SUMMARY ***
Total pot $5 | Rake $0
Seat 1: kTCkABD1UUldS9DFRGfCwQ (small blind) folded before Flop
Seat 2: TAfo4veNRaRlzDXMMYS3Jg (big blind) folded before Flop
Seat 3: 5Q8U6iZbeO7xJSS4qvDP5g folded before Flop (didn't bet)
Seat 4: waEF/+pxZTxNo4FvsORuXg folded before Flop (didn't bet)
Seat 5: CkE3IyJF1KvdaAOmZY5XqQ folded before Flop (didn't bet)
Seat 6: 5jQlngvMSqM/WoonOcR5kw folded before Flop (didn't bet)
Seat 8: 1CtiZuXDFaJL1dJPQKyi8Q collected ($5)
Seat 9: FiXPLJyqb24l32QST2TInw (button) folded before Flop (didn't bet)



PokerStars Game #59941327862:  Hold'em No Limit ($1/$2) - 2009/07/01 1:32:14 ET
Table 'LL4bDFyhj5hsMpzaDugJZg' 6-max Seat #5 is the button
Seat 1: FwvID/fQGlpY3soi/lMTww ($69.50 in chips)
Seat 2: IZng3w8jiJHHp3LbYKLi4w ($46.15 in chips)
Seat 3: iI/NMpRxMkGieArQEhACSA ($561.90 in chips)
Seat 4: 8srN1dKQePlsv0GyTada+Q ($215.40 in chips)
Seat 5: A2GTwTiwkb1ilNWgW487Vg ($130.50 in chips)
Seat 6: 692Q4sfB0gTElzS0WMeg+A ($200 in chips)
692Q4sfB0gTElzS0WMeg+A: posts small blind $1
FwvID/fQGlpY3soi/lMTww: posts big blind $2
*** HOLE CARDS ***
IZng3w8jiJHHp3LbYKLi4w: folds
iI/NMpRxMkGieArQEhACSA: folds
8srN1dKQePlsv0GyTada+Q: folds
A2GTwTiwkb1ilNWgW487Vg: folds
692Q4sfB0gTElzS0WMeg+A: folds
FwvID/fQGlpY3soi/lMTww collected $2 from pot
*** SUMMARY ***
Total pot $2 | Rake $0
Seat 1: FwvID/fQGlpY3soi/lMTww (big blind) collected ($2)
Seat 2: IZng3w8jiJHHp3LbYKLi4w folded before Flop (didn't bet)
Seat 3: iI/NMpRxMkGieArQEhACSA folded before Flop (didn't bet)
Seat 4: 8srN1dKQePlsv0GyTada+Q folded before Flop (didn't bet)
Seat 5: A2GTwTiwkb1ilNWgW487Vg (button) folded before Flop (didn't bet)
Seat 6: 692Q4sfB0gTElzS0WMeg+A (small blind) folded before Flop



PokerStars Game #59941328846:  Hold'em No Limit ($1/$2) - 2009/07/01 1:32:16 ET
Table 'eTkRjRjsYr567snmNk8kNQ' 2-max Seat #2 is the button
Seat 1: t6Jd836OSEMbcRi7rfGp5g ($207.50 in chips)
Seat 2: UNpnKQk0gkkyFJen8upqag ($288.50 in chips)
UNpnKQk0gkkyFJen8upqag: posts small blind $1
t6Jd836OSEMbcRi7rfGp5g: posts big blind $2
*** HOLE CARDS ***
UNpnKQk0gkkyFJen8upqag: folds
t6Jd836OSEMbcRi7rfGp5g collected $2 from pot
*** SUMMARY ***
Total pot $2 | Rake $0
Seat 1: t6Jd836OSEMbcRi7rfGp5g (big blind) collected ($2)
Seat 2: UNpnKQk0gkkyFJen8upqag (button) (small blind) folded before Flop



PokerStars Game #59941329524:  Hold'em No Limit ($1/$2) - 2009/07/01 1:32:17 ET
Table '/ci73fTmzTzmGWzAtqEX2Q' 9-max Seat #2 is the button
Seat 1: 9efVc1cB3yHt4TvBkTusPw ($146.90 in chips)
Seat 2: pN/Ip0ePsUVIdUlGgLrkUw ($225 in chips)
Seat 3: kK1+5ivyJZeA8hQF2pdvvQ ($66.55 in chips)
Seat 4: 2yq7Zp4xmrhAw8+37hTkaA ($165.40 in chips)
Seat 5: 1CtiZuXDFaJL1dJPQKyi8Q ($215 in chips)
Seat 6: GX1heJ+DSsvm7gzSPsYhhQ ($47.65 in chips)
Seat 7: rW/MyplHylMSBRaoRUzWrg ($57.15 in chips)
Seat 8: /inIs/z/PcX+TniIFpaxpg ($37 in chips)
Seat 9: S8aS+9FTYQ/ICLBNThcrkg ($183 in chips)
kK1+5ivyJZeA8hQF2pdvvQ: posts small blind $1
2yq7Zp4xmrhAw8+37hTkaA: posts big blind $2
*** HOLE CARDS ***
1CtiZuXDFaJL1dJPQKyi8Q: folds
GX1heJ+DSsvm7gzSPsYhhQ: folds
rW/MyplHylMSBRaoRUzWrg: folds
/inIs/z/PcX+TniIFpaxpg: folds
S8aS+9FTYQ/ICLBNThcrkg: folds
9efVc1cB3yHt4TvBkTusPw: folds
pN/Ip0ePsUVIdUlGgLrkUw: folds
kK1+5ivyJZeA8hQF2pdvvQ: calls $1
2yq7Zp4xmrhAw8+37hTkaA: checks
*** FLOP *** [6h Ks 7d]
kK1+5ivyJZeA8hQF2pdvvQ: checks
2yq7Zp4xmrhAw8+37hTkaA: checks
*** TURN *** [6h Ks 7d] [Td]
kK1+5ivyJZeA8hQF2pdvvQ: checks
2yq7Zp4xmrhAw8+37hTkaA: bets $4
kK1+5ivyJZeA8hQF2pdvvQ: folds
2yq7Zp4xmrhAw8+37hTkaA collected $3.80 from pot
*** SUMMARY ***
Total pot $4 | Rake $0.20
Board [6h Ks 7d Td]
Seat 1: 9efVc1cB3yHt4TvBkTusPw folded before Flop (didn't bet)
Seat 2: pN/Ip0ePsUVIdUlGgLrkUw (button) folded before Flop (didn't bet)
Seat 3: kK1+5ivyJZeA8hQF2pdvvQ (small blind) folded on the Turn
Seat 4: 2yq7Zp4xmrhAw8+37hTkaA (big blind) collected ($3.80)
Seat 5: 1CtiZuXDFaJL1dJPQKyi8Q folded before Flop (didn't bet)
Seat 6: GX1heJ+DSsvm7gzSPsYhhQ folded before Flop (didn't bet)
Seat 7: rW/MyplHylMSBRaoRUzWrg folded before Flop (didn't bet)
Seat 8: /inIs/z/PcX+TniIFpaxpg folded before Flop (didn't bet)
Seat 9: S8aS+9FTYQ/ICLBNThcrkg folded before Flop (didn't bet)



PokerStars Game #59941330782:  Hold'em No Limit ($1/$2) - 2009/07/01 1:32:19 ET
Table 'uJ9juaXXg9yIcSU8amxaXQ' 6-max Seat #1 is the button
Seat 1: JsqOjN/eHz0uYVf/PyUJ6Q ($144.50 in chips)
Seat 2: VvdR9F3I+2yELkfTVvC1dg ($227.10 in chips)
Seat 3: qXDd0ZyMIse0OBu8pxeQ3Q ($247.40 in chips)
Seat 4: zNjJ/y4emmF+vzrCDd+ooA ($241.20 in chips)
Seat 5: YsLQ3BAvgQHWXMAv3Wv6Hg ($200 in chips)
Seat 6: 2DFp9Veq1xxq64dCjwNuUw ($51.60 in chips)
VvdR9F3I+2yELkfTVvC1dg: posts small blind $1
qXDd0ZyMIse0OBu8pxeQ3Q: posts big blind $2
*** HOLE CARDS ***
zNjJ/y4emmF+vzrCDd+ooA: calls $2
YsLQ3BAvgQHWXMAv3Wv6Hg: folds
2DFp9Veq1xxq64dCjwNuUw: folds
JsqOjN/eHz0uYVf/PyUJ6Q: folds
VvdR9F3I+2yELkfTVvC1dg: calls $1
qXDd0ZyMIse0OBu8pxeQ3Q: checks
*** FLOP *** [9d 2h As]
VvdR9F3I+2yELkfTVvC1dg: checks
qXDd0ZyMIse0OBu8pxeQ3Q: checks
zNjJ/y4emmF+vzrCDd+ooA: checks
*** TURN *** [9d 2h As] [3h]
VvdR9F3I+2yELkfTVvC1dg: checks
qXDd0ZyMIse0OBu8pxeQ3Q: checks
zNjJ/y4emmF+vzrCDd+ooA: checks
*** RIVER *** [9d 2h As 3h] [8h]
VvdR9F3I+2yELkfTVvC1dg: checks
qXDd0ZyMIse0OBu8pxeQ3Q: checks
zNjJ/y4emmF+vzrCDd+ooA: checks
*** SHOW DOWN ***
VvdR9F3I+2yELkfTVvC1dg: shows [Kc Qc] (high card Ace)
qXDd0ZyMIse0OBu8pxeQ3Q: shows [8d 5d] (a pair of Eights)
zNjJ/y4emmF+vzrCDd+ooA: shows [7c 8c] (a pair of Eights - Ace+Nine+Seven kicker)
zNjJ/y4emmF+vzrCDd+ooA collected $5.70 from pot
*** SUMMARY ***
Total pot $6 | Rake $0.30
Board [9d 2h As 3h 8h]
Seat 1: JsqOjN/eHz0uYVf/PyUJ6Q (button) folded before Flop (didn't bet)
Seat 2: VvdR9F3I+2yELkfTVvC1dg (small blind) showed [Kc Qc] and lost with high card Ace
Seat 3: qXDd0ZyMIse0OBu8pxeQ3Q (big blind) showed [8d 5d] and lost with a pair of Eights
Seat 4: zNjJ/y4emmF+vzrCDd+ooA showed [7c 8c] and won ($5.70) with a pair of Eights
Seat 5: YsLQ3BAvgQHWXMAv3Wv6Hg folded before Flop (didn't bet)
Seat 6: 2DFp9Veq1xxq64dCjwNuUw folded before Flop (didn't bet)



PokerStars Game #59941331434:  Hold'em No Limit ($1/$2) - 2009/07/01 1:32:20 ET
Table 'NmY84NAf9Mh0ckAckHnh5g' 2-max Seat #2 is the button
Seat 1: 6hvg964TSqZ3AL/0XK9aVQ ($366.20 in chips)
Seat 2: RwDoM55ZeQuI2ADyJhOb2Q ($632.70 in chips)
RwDoM55ZeQuI2ADyJhOb2Q: posts small blind $1
6hvg964TSqZ3AL/0XK9aVQ: posts big blind $2
*** HOLE CARDS ***
RwDoM55ZeQuI2ADyJhOb2Q: raises $4 to $6
6hvg964TSqZ3AL/0XK9aVQ: calls $4
*** FLOP *** [2s 4s 3c]
6hvg964TSqZ3AL/0XK9aVQ: checks
RwDoM55ZeQuI2ADyJhOb2Q: checks
*** TURN *** [2s 4s 3c] [As]
6hvg964TSqZ3AL/0XK9aVQ: bets $8
RwDoM55ZeQuI2ADyJhOb2Q: folds
6hvg964TSqZ3AL/0XK9aVQ collected $11.50 from pot
6hvg964TSqZ3AL/0XK9aVQ: doesn't show hand
*** SUMMARY ***
Total pot $12 | Rake $0.50
Board [2s 4s 3c As]
Seat 1: 6hvg964TSqZ3AL/0XK9aVQ (big blind) collected ($11.50)
Seat 2: RwDoM55ZeQuI2ADyJhOb2Q (button) (small blind) folded on the Turn



PokerStars Game #59941332546:  Hold'em No Limit ($1/$2) - 2009/07/01 1:32:22 ET
Table 'mGpP9StWRnoeiBDExc6Frg' 6-max Seat #6 is the button
Seat 1: VvdR9F3I+2yELkfTVvC1dg ($310.05 in chips)
Seat 2: vkfxu8f/jMYKUk6Ly4eujw ($200 in chips)
Seat 3: 7acrZUQC3Zc9BNLjoKIcLQ ($24.40 in chips)
Seat 4: 4dcDwIHRm96PwtqkpQiuiA ($79.70 in chips)
Seat 5: d1puGuVBE0fidn+5eRJ0tw ($192.95 in chips)
Seat 6: B2Ih1sr5VZk+8He7rcrMtQ ($431.05 in chips)
VvdR9F3I+2yELkfTVvC1dg: posts small blind $1
vkfxu8f/jMYKUk6Ly4eujw: posts big blind $2
*** HOLE CARDS ***
7acrZUQC3Zc9BNLjoKIcLQ: calls $2
4dcDwIHRm96PwtqkpQiuiA: folds
d1puGuVBE0fidn+5eRJ0tw: folds
B2Ih1sr5VZk+8He7rcrMtQ: folds
VvdR9F3I+2yELkfTVvC1dg: folds
vkfxu8f/jMYKUk6Ly4eujw: checks
*** FLOP *** [8h 5h 3s]
vkfxu8f/jMYKUk6Ly4eujw: checks
7acrZUQC3Zc9BNLjoKIcLQ: bets $6
vkfxu8f/jMYKUk6Ly4eujw: folds
7acrZUQC3Zc9BNLjoKIcLQ collected $4.75 from pot
*** SUMMARY ***
Total pot $5 | Rake $0.25
Board [8h 5h 3s]
Seat 1: VvdR9F3I+2yELkfTVvC1dg (small blind) folded before Flop
Seat 2: vkfxu8f/jMYKUk6Ly4eujw (big blind) folded on the Flop
Seat 3: 7acrZUQC3Zc9BNLjoKIcLQ collected ($4.75)
Seat 4: 4dcDwIHRm96PwtqkpQiuiA folded before Flop (didn't bet)
Seat 5: d1puGuVBE0fidn+5eRJ0tw folded before Flop (didn't bet)
Seat 6: B2Ih1sr5VZk+8He7rcrMtQ (button) folded before Flop (didn't bet)



PokerStars Game #59941333258:  Hold'em No Limit ($1/$2) - 2009/07/01 1:32:23 ET
Table '4NGNnZ/osQfNq6abYqkJeA' 6-max Seat #3 is the button
Seat 1: vkfxu8f/jMYKUk6Ly4eujw ($200 in chips)
Seat 2: 669iGNwYwgRZg3nhS+aDAQ ($95.45 in chips)
Seat 3: 54yWzRRgS0oZ+S6LwZBxMQ ($37 in chips)
Seat 4: sY+4Uuh5z/6AbXXaCS10jw ($223.25 in chips)
Seat 5: VvdR9F3I+2yELkfTVvC1dg ($241.85 in chips)
Seat 6: 3cPMpDMgeOMAe4UceUfLsg ($203 in chips)
sY+4Uuh5z/6AbXXaCS10jw: posts small blind $1
VvdR9F3I+2yELkfTVvC1dg: posts big blind $2
*** HOLE CARDS ***
3cPMpDMgeOMAe4UceUfLsg: folds
vkfxu8f/jMYKUk6Ly4eujw: folds
669iGNwYwgRZg3nhS+aDAQ: folds
54yWzRRgS0oZ+S6LwZBxMQ: folds
sY+4Uuh5z/6AbXXaCS10jw: raises $4 to $6
VvdR9F3I+2yELkfTVvC1dg: folds
sY+4Uuh5z/6AbXXaCS10jw collected $4 from pot
*** SUMMARY ***
Total pot $4 | Rake $0
Seat 1: vkfxu8f/jMYKUk6Ly4eujw folded before Flop (didn't bet)
Seat 2: 669iGNwYwgRZg3nhS+aDAQ folded before Flop (didn't bet)
Seat 3: 54yWzRRgS0oZ+S6LwZBxMQ (button) folded before Flop (didn't bet)
Seat 4: sY+4Uuh5z/6AbXXaCS10jw (small blind) collected ($4)
Seat 5: VvdR9F3I+2yELkfTVvC1dg (big blind) folded before Flop
Seat 6: 3cPMpDMgeOMAe4UceUfLsg folded before Flop (didn't bet)



PokerStars Game #59941333854:  Hold'em No Limit ($1/$2) - 2009/07/01 1:32:24 ET
Table 'gnHBqWll9O3fxG7Ojkz/ng' 9-max Seat #8 is the button
Seat 1: TAfo4veNRaRlzDXMMYS3Jg ($34 in chips)
Seat 2: H6Z4+qu8gR0VUiPOijndVg ($327.25 in chips)
Seat 3: 5Q8U6iZbeO7xJSS4qvDP5g ($211 in chips)
Seat 4: nXDI8Y/S6POzRwANu3d8hQ ($39 in chips)
Seat 5: rBQDMkKm9cZn6M9NPsiVew ($227.15 in chips)
Seat 7: jqui3xAWCkcdPW36a6BD+w ($341.95 in chips)
Seat 8: cM6efHzdxoqYm0EQKP4TTQ ($94.15 in chips)
Seat 9: GX1heJ+DSsvm7gzSPsYhhQ ($52.35 in chips)
GX1heJ+DSsvm7gzSPsYhhQ: posts small blind $1
TAfo4veNRaRlzDXMMYS3Jg: posts big blind $2
MeleaB: sits out
*** HOLE CARDS ***
H6Z4+qu8gR0VUiPOijndVg: folds
5Q8U6iZbeO7xJSS4qvDP5g: folds
nXDI8Y/S6POzRwANu3d8hQ: folds
rBQDMkKm9cZn6M9NPsiVew: folds
jqui3xAWCkcdPW36a6BD+w: calls $2
cM6efHzdxoqYm0EQKP4TTQ: calls $2
GX1heJ+DSsvm7gzSPsYhhQ: calls $1
TAfo4veNRaRlzDXMMYS3Jg: checks
*** FLOP *** [Th Kd 9s]
GX1heJ+DSsvm7gzSPsYhhQ: checks
TAfo4veNRaRlzDXMMYS3Jg: checks
jqui3xAWCkcdPW36a6BD+w: bets $4
cM6efHzdxoqYm0EQKP4TTQ: folds
GX1heJ+DSsvm7gzSPsYhhQ: folds
TAfo4veNRaRlzDXMMYS3Jg: folds
jqui3xAWCkcdPW36a6BD+w collected $7.60 from pot
jqui3xAWCkcdPW36a6BD+w: doesn't show hand
*** SUMMARY ***
Total pot $8 | Rake $0.40
Board [Th Kd 9s]
Seat 1: TAfo4veNRaRlzDXMMYS3Jg (big blind) folded on the Flop
Seat 2: H6Z4+qu8gR0VUiPOijndVg folded before Flop (didn't bet)
Seat 3: 5Q8U6iZbeO7xJSS4qvDP5g folded before Flop (didn't bet)
Seat 4: nXDI8Y/S6POzRwANu3d8hQ folded before Flop (didn't bet)
Seat 5: rBQDMkKm9cZn6M9NPsiVew folded before Flop (didn't bet)
Seat 7: jqui3xAWCkcdPW36a6BD+w collected ($7.60)
Seat 8: cM6efHzdxoqYm0EQKP4TTQ (button) folded on the Flop
Seat 9: GX1heJ+DSsvm7gzSPsYhhQ (small blind) folded on the Flop



PokerStars Game #59941333958:  Hold'em No Limit ($1/$2) - 2009/07/01 1:32:25 ET
Table 'AtOXMvcrtQM8yLNcALmfLQ' 2-max Seat #2 is the button
Seat 1: +HlQuAsMqZGYYtjcPO/a3A ($366.40 in chips)
Seat 2: pVqEzK9wXlRMECnb1Zg4Zw ($198 in chips)
pVqEzK9wXlRMECnb1Zg4Zw: posts small blind $1
+HlQuAsMqZGYYtjcPO/a3A: posts big blind $2
*** HOLE CARDS ***
pVqEzK9wXlRMECnb1Zg4Zw: raises $6 to $8
+HlQuAsMqZGYYtjcPO/a3A: calls $6
*** FLOP *** [7s Ts As]
+HlQuAsMqZGYYtjcPO/a3A: checks
pVqEzK9wXlRMECnb1Zg4Zw: checks
*** TURN *** [7s Ts As] [Js]
+HlQuAsMqZGYYtjcPO/a3A: checks
pVqEzK9wXlRMECnb1Zg4Zw: bets $6
+HlQuAsMqZGYYtjcPO/a3A: folds
pVqEzK9wXlRMECnb1Zg4Zw collected $15.50 from pot
pVqEzK9wXlRMECnb1Zg4Zw: doesn't show hand
*** SUMMARY ***
Total pot $16 | Rake $0.50
Board [7s Ts As Js]
Seat 1: +HlQuAsMqZGYYtjcPO/a3A (big blind) folded on the Turn
Seat 2: pVqEzK9wXlRMECnb1Zg4Zw (button) (small blind) collected ($15.50)



PokerStars Game #59941334532:  Hold'em No Limit ($1/$2) - 2009/07/01 1:32:26 ET
Table 'gftD4mDF7mIFKvSrIyaRbw' 9-max Seat #3 is the button
Seat 2: GX1heJ+DSsvm7gzSPsYhhQ ($36 in chips)
Seat 3: CUZwDpLTQKhzarPe+JCLOQ ($210.75 in chips)
Seat 4: /inIs/z/PcX+TniIFpaxpg ($38 in chips)
Seat 5: mpsfNtnMVDqQHTe92AhIdw ($117.10 in chips)
Seat 6: 2NvwF8W2nzsbS+G//yLAbQ ($113.85 in chips)
Seat 7: +T/63sAeZzWyHchahJ36GQ ($42 in chips)
Seat 8: MpL4DeEqGQu0H8TJEbEOrg ($41 in chips)
/inIs/z/PcX+TniIFpaxpg: posts small blind $1
mpsfNtnMVDqQHTe92AhIdw: posts big blind $2
*** HOLE CARDS ***
2NvwF8W2nzsbS+G//yLAbQ: folds
+T/63sAeZzWyHchahJ36GQ: folds
MpL4DeEqGQu0H8TJEbEOrg: folds
GX1heJ+DSsvm7gzSPsYhhQ: folds
CUZwDpLTQKhzarPe+JCLOQ: folds
/inIs/z/PcX+TniIFpaxpg: folds
mpsfNtnMVDqQHTe92AhIdw collected $2 from pot
*** SUMMARY ***
Total pot $2 | Rake $0
Seat 2: GX1heJ+DSsvm7gzSPsYhhQ folded before Flop (didn't bet)
Seat 3: CUZwDpLTQKhzarPe+JCLOQ (button) folded before Flop (didn't bet)
Seat 4: /inIs/z/PcX+TniIFpaxpg (small blind) folded before Flop
Seat 5: mpsfNtnMVDqQHTe92AhIdw (big blind) collected ($2)
Seat 6: 2NvwF8W2nzsbS+G//yLAbQ folded before Flop (didn't bet)
Seat 7: +T/63sAeZzWyHchahJ36GQ folded before Flop (didn't bet)
Seat 8: MpL4DeEqGQu0H8TJEbEOrg folded before Flop (didn't bet)



PokerStars Game #59941335446:  Hold'em No Limit ($1/$2) - 2009/07/01 1:32:27 ET
Table 'eTkRjRjsYr567snmNk8kNQ' 2-max Seat #1 is the button
Seat 1: t6Jd836OSEMbcRi7rfGp5g ($208.50 in chips)
Seat 2: UNpnKQk0gkkyFJen8upqag ($287.50 in chips)
t6Jd836OSEMbcRi7rfGp5g: posts small blind $1
UNpnKQk0gkkyFJen8upqag: posts big blind $2
*** HOLE CARDS ***
t6Jd836OSEMbcRi7rfGp5g: raises $4 to $6
UNpnKQk0gkkyFJen8upqag: raises $14 to $20
t6Jd836OSEMbcRi7rfGp5g: folds
UNpnKQk0gkkyFJen8upqag collected $12 from pot
*** SUMMARY ***
Total pot $12 | Rake $0
Seat 1: t6Jd836OSEMbcRi7rfGp5g (button) (small blind) folded before Flop
Seat 2: UNpnKQk0gkkyFJen8upqag (big blind) collected ($12)



PokerStars Game #59941335838:  Hold'em No Limit ($1/$2) - 2009/07/01 1:32:28 ET
Table 'kq5zaQ+1hLNf8LZfGnbTAA' 6-max Seat #6 is the button
Seat 1: 8srN1dKQePlsv0GyTada+Q ($415 in chips)
Seat 2: nXDI8Y/S6POzRwANu3d8hQ ($187 in chips)
Seat 3: vkfxu8f/jMYKUk6Ly4eujw ($225.95 in chips)
Seat 4: 3dAbvkxS5NPQTBAbvpinVg ($281.45 in chips)
Seat 5: gnYme0DNFflnMhrdbxe1Ag ($200 in chips)
Seat 6: mfy7uGZcqA2PVQqEVbJ7+g ($191.25 in chips)
8srN1dKQePlsv0GyTada+Q: posts small blind $1
nXDI8Y/S6POzRwANu3d8hQ: posts big blind $2
*** HOLE CARDS ***
vkfxu8f/jMYKUk6Ly4eujw: folds
vkfxu8f/jMYKUk6Ly4eujw leaves the table
3dAbvkxS5NPQTBAbvpinVg: folds
gnYme0DNFflnMhrdbxe1Ag: folds
mfy7uGZcqA2PVQqEVbJ7+g: folds
8srN1dKQePlsv0GyTada+Q: raises $4 to $6
nXDI8Y/S6POzRwANu3d8hQ: calls $4
*** FLOP *** [9d Jh 2c]
/PH6Ffnho4Ysm8S3V/oa+w joins the table at seat #3
8srN1dKQePlsv0GyTada+Q: bets $8
nXDI8Y/S6POzRwANu3d8hQ: calls $8
*** TURN *** [9d Jh 2c] [Kh]
8srN1dKQePlsv0GyTada+Q: bets $11
nXDI8Y/S6POzRwANu3d8hQ: calls $11
*** RIVER *** [9d Jh 2c Kh] [Qc]
8srN1dKQePlsv0GyTada+Q: checks
nXDI8Y/S6POzRwANu3d8hQ: checks
*** SHOW DOWN ***
8srN1dKQePlsv0GyTada+Q: shows [Kc As] (a pair of Kings)
nXDI8Y/S6POzRwANu3d8hQ: mucks hand
8srN1dKQePlsv0GyTada+Q collected $47.60 from pot
*** SUMMARY ***
Total pot $50 | Rake $2.40
Board [9d Jh 2c Kh Qc]
Seat 1: 8srN1dKQePlsv0GyTada+Q (small blind) showed [Kc As] and won ($47.60) with a pair of Kings
Seat 2: nXDI8Y/S6POzRwANu3d8hQ (big blind) mucked
Seat 3: vkfxu8f/jMYKUk6Ly4eujw folded before Flop (didn't bet)
Seat 4: 3dAbvkxS5NPQTBAbvpinVg folded before Flop (didn't bet)
Seat 5: gnYme0DNFflnMhrdbxe1Ag folded before Flop (didn't bet)
Seat 6: mfy7uGZcqA2PVQqEVbJ7+g (button) folded before Flop (didn't bet)



PokerStars Game #59941336694:  Hold'em No Limit ($1/$2) - 2009/07/01 1:32:30 ET
Table '/dyk+YdRGv90j2box35j8w' 6-max Seat #5 is the button
Seat 1: 8srN1dKQePlsv0GyTada+Q ($220.25 in chips)
Seat 2: qCnEYuAE5y5A7bk6fO5/jQ ($473.60 in chips)
Seat 4: z/u1YTnkiIDrtp/2cA2dBg ($193.85 in chips)
Seat 5: VvdR9F3I+2yELkfTVvC1dg ($200 in chips)
Seat 6: gnYme0DNFflnMhrdbxe1Ag ($200 in chips)
gnYme0DNFflnMhrdbxe1Ag: posts small blind $1
8srN1dKQePlsv0GyTada+Q: posts big blind $2
sTPOWERd9HWPCNrDBwsVjA: sits out
*** HOLE CARDS ***
qCnEYuAE5y5A7bk6fO5/jQ: folds
z/u1YTnkiIDrtp/2cA2dBg: folds
VvdR9F3I+2yELkfTVvC1dg: folds
gnYme0DNFflnMhrdbxe1Ag: folds
8srN1dKQePlsv0GyTada+Q collected $2 from pot
8srN1dKQePlsv0GyTada+Q: doesn't show hand
*** SUMMARY ***
Total pot $2 | Rake $0
Seat 1: 8srN1dKQePlsv0GyTada+Q (big blind) collected ($2)
Seat 2: qCnEYuAE5y5A7bk6fO5/jQ folded before Flop (didn't bet)
Seat 4: z/u1YTnkiIDrtp/2cA2dBg folded before Flop (didn't bet)
Seat 5: VvdR9F3I+2yELkfTVvC1dg (button) folded before Flop (didn't bet)
Seat 6: gnYme0DNFflnMhrdbxe1Ag (small blind) folded before Flop



PokerStars Game #59941337360:  Hold'em No Limit ($1/$2) - 2009/07/01 1:32:31 ET
Table 'rKeCh+eBn4RNvybCUYkoTQ' 9-max Seat #7 is the button
Seat 1: /inIs/z/PcX+TniIFpaxpg ($200 in chips)
Seat 2: 9cBHwK40Tl06vheE7B3LHQ ($129.80 in chips)
Seat 3: GX1heJ+DSsvm7gzSPsYhhQ ($40 in chips)
Seat 5: WUlHm+ydPPHG7Lb0rePSdA ($120 in chips)
Seat 6: EBV6OktyeSmh4w6sWmcWOw ($267 in chips)
Seat 7: rW/MyplHylMSBRaoRUzWrg ($31 in chips)
Seat 8: pN/Ip0ePsUVIdUlGgLrkUw ($247.35 in chips)
Seat 9: Kzta8yu9vxHT4B70mjBZ+w ($211.25 in chips)
pN/Ip0ePsUVIdUlGgLrkUw: posts small blind $1
Kzta8yu9vxHT4B70mjBZ+w: posts big blind $2
*** HOLE CARDS ***
/inIs/z/PcX+TniIFpaxpg: calls $2
9cBHwK40Tl06vheE7B3LHQ: folds
GX1heJ+DSsvm7gzSPsYhhQ: folds
WUlHm+ydPPHG7Lb0rePSdA: raises $6 to $8
EBV6OktyeSmh4w6sWmcWOw: folds
rW/MyplHylMSBRaoRUzWrg: folds
pN/Ip0ePsUVIdUlGgLrkUw: folds
Kzta8yu9vxHT4B70mjBZ+w: folds
/inIs/z/PcX+TniIFpaxpg: folds
WUlHm+ydPPHG7Lb0rePSdA collected $7 from pot
WUlHm+ydPPHG7Lb0rePSdA: doesn't show hand
*** SUMMARY ***
Total pot $7 | Rake $0
Seat 1: /inIs/z/PcX+TniIFpaxpg folded before Flop
Seat 2: 9cBHwK40Tl06vheE7B3LHQ folded before Flop (didn't bet)
Seat 3: GX1heJ+DSsvm7gzSPsYhhQ folded before Flop (didn't bet)
Seat 5: WUlHm+ydPPHG7Lb0rePSdA collected ($7)
Seat 6: EBV6OktyeSmh4w6sWmcWOw folded before Flop (didn't bet)
Seat 7: rW/MyplHylMSBRaoRUzWrg (button) folded before Flop (didn't bet)
Seat 8: pN/Ip0ePsUVIdUlGgLrkUw (small blind) folded before Flop
Seat 9: Kzta8yu9vxHT4B70mjBZ+w (big blind) folded before Flop



PokerStars Game #59941338458:  Hold'em No Limit ($1/$2) - 2009/07/01 1:32:33 ET
Table 'ztv6V3FN2bQ9nmJPPdx6nQ' 6-max Seat #3 is the button
Seat 1: 6fLdOUCRtX71xbVRhJEq8w ($241.35 in chips)
Seat 2: 5Y+ZGWLI4gnlpApDX5vy1A ($386.75 in chips)
Seat 3: ubtx4Z5L+AcK71MTvYiGVw ($245 in chips)
Seat 5: sTPOWERd9HWPCNrDBwsVjA ($223.80 in chips)
Seat 6: mfy7uGZcqA2PVQqEVbJ7+g ($97.45 in chips)
sTPOWERd9HWPCNrDBwsVjA: posts small blind $1
mfy7uGZcqA2PVQqEVbJ7+g: posts big blind $2
*** HOLE CARDS ***
6fLdOUCRtX71xbVRhJEq8w: folds
5Y+ZGWLI4gnlpApDX5vy1A: folds
ubtx4Z5L+AcK71MTvYiGVw: folds
sTPOWERd9HWPCNrDBwsVjA: folds
mfy7uGZcqA2PVQqEVbJ7+g collected $2 from pot
mfy7uGZcqA2PVQqEVbJ7+g: doesn't show hand
*** SUMMARY ***
Total pot $2 | Rake $0
Seat 1: 6fLdOUCRtX71xbVRhJEq8w folded before Flop (didn't bet)
Seat 2: 5Y+ZGWLI4gnlpApDX5vy1A folded before Flop (didn't bet)
Seat 3: ubtx4Z5L+AcK71MTvYiGVw (button) folded before Flop (didn't bet)
Seat 5: sTPOWERd9HWPCNrDBwsVjA (small blind) folded before Flop
Seat 6: mfy7uGZcqA2PVQqEVbJ7+g (big blind) collected ($2)



PokerStars Game #59941339716:  Hold'em No Limit ($1/$2) - 2009/07/01 1:32:35 ET
Table 'G1Oqdy4Pqdb5gtx40rUBzA' 6-max Seat #1 is the button
Seat 1: ubtx4Z5L+AcK71MTvYiGVw ($200 in chips)
Seat 2: 4uqU0dG67owXuPz303Al4w ($516.25 in chips)
Seat 3: VvdR9F3I+2yELkfTVvC1dg ($241.25 in chips)
Seat 4: B87ikIyZ/TzAVeXf38Ny0g ($214.55 in chips)
Seat 5: F1+Ml47qRQWunzPnGhLLzQ ($186.50 in chips)
Seat 6: qCnEYuAE5y5A7bk6fO5/jQ ($200 in chips)
4uqU0dG67owXuPz303Al4w: posts small blind $1
VvdR9F3I+2yELkfTVvC1dg: posts big blind $2
*** HOLE CARDS ***
B87ikIyZ/TzAVeXf38Ny0g: folds
F1+Ml47qRQWunzPnGhLLzQ: folds
qCnEYuAE5y5A7bk6fO5/jQ: raises $4 to $6
ubtx4Z5L+AcK71MTvYiGVw: folds
4uqU0dG67owXuPz303Al4w: folds
VvdR9F3I+2yELkfTVvC1dg: folds
qCnEYuAE5y5A7bk6fO5/jQ collected $5 from pot
qCnEYuAE5y5A7bk6fO5/jQ: doesn't show hand
*** SUMMARY ***
Total pot $5 | Rake $0
Seat 1: ubtx4Z5L+AcK71MTvYiGVw (button) folded before Flop (didn't bet)
Seat 2: 4uqU0dG67owXuPz303Al4w (small blind) folded before Flop
Seat 3: VvdR9F3I+2yELkfTVvC1dg (big blind) folded before Flop
Seat 4: B87ikIyZ/TzAVeXf38Ny0g folded before Flop (didn't bet)
Seat 5: F1+Ml47qRQWunzPnGhLLzQ folded before Flop (didn't bet)
Seat 6: qCnEYuAE5y5A7bk6fO5/jQ collected ($5)



PokerStars Game #59941340936:  Hold'em No Limit ($1/$2) - 2009/07/01 1:32:37 ET
Table 'jlrIxbrVIG+gjaUYT4za8g' 6-max Seat #1 is the button
Seat 1: ygTTt5ehT4aF86q1a8/R+w ($258.30 in chips)
Seat 2: /PH6Ffnho4Ysm8S3V/oa+w ($40 in chips)
Seat 3: gnYme0DNFflnMhrdbxe1Ag ($203 in chips)
Seat 4: 8srN1dKQePlsv0GyTada+Q ($229.55 in chips)
Seat 5: AyBB0k3Dcl7xbXUeGMw06g ($73.90 in chips)
Seat 6: vkfxu8f/jMYKUk6Ly4eujw ($306 in chips)
/PH6Ffnho4Ysm8S3V/oa+w: posts small blind $1
gnYme0DNFflnMhrdbxe1Ag: posts big blind $2
*** HOLE CARDS ***
8srN1dKQePlsv0GyTada+Q: raises $4 to $6
AyBB0k3Dcl7xbXUeGMw06g: folds
vkfxu8f/jMYKUk6Ly4eujw: folds
ygTTt5ehT4aF86q1a8/R+w: folds
/PH6Ffnho4Ysm8S3V/oa+w: folds
gnYme0DNFflnMhrdbxe1Ag: folds
8srN1dKQePlsv0GyTada+Q collected $5 from pot
*** SUMMARY ***
Total pot $5 | Rake $0
Seat 1: ygTTt5ehT4aF86q1a8/R+w (button) folded before Flop (didn't bet)
Seat 2: /PH6Ffnho4Ysm8S3V/oa+w (small blind) folded before Flop
Seat 3: gnYme0DNFflnMhrdbxe1Ag (big blind) folded before Flop
Seat 4: 8srN1dKQePlsv0GyTada+Q collected ($5)
Seat 5: AyBB0k3Dcl7xbXUeGMw06g folded before Flop (didn't bet)
Seat 6: vkfxu8f/jMYKUk6Ly4eujw folded before Flop (didn't bet)



PokerStars Game #59941341256:  Hold'em No Limit ($1/$2) - 2009/07/01 1:32:38 ET
Table 'TsEDkiO4tzCTCzJ7tNdEqw' 6-max Seat #2 is the button
Seat 1: MfXQsYD8pGeCS7XOtyV+vw ($84.05 in chips)
Seat 2: 4dcDwIHRm96PwtqkpQiuiA ($75.10 in chips)
Seat 3: ubtx4Z5L+AcK71MTvYiGVw ($201 in chips)
Seat 4: K8MXCrNAVYlMnnCeM32Kxw ($117.50 in chips)
Seat 5: VvdR9F3I+2yELkfTVvC1dg ($259.35 in chips)
Seat 6: uCqEjnxh2/vFBjKYkfTOkw ($162.70 in chips)
ubtx4Z5L+AcK71MTvYiGVw: posts small blind $1
K8MXCrNAVYlMnnCeM32Kxw: posts big blind $2
*** HOLE CARDS ***
VvdR9F3I+2yELkfTVvC1dg: folds
uCqEjnxh2/vFBjKYkfTOkw: folds
MfXQsYD8pGeCS7XOtyV+vw: folds
4dcDwIHRm96PwtqkpQiuiA: folds
ubtx4Z5L+AcK71MTvYiGVw: folds
K8MXCrNAVYlMnnCeM32Kxw collected $2 from pot
*** SUMMARY ***
Total pot $2 | Rake $0
Seat 1: MfXQsYD8pGeCS7XOtyV+vw folded before Flop (didn't bet)
Seat 2: 4dcDwIHRm96PwtqkpQiuiA (button) folded before Flop (didn't bet)
Seat 3: ubtx4Z5L+AcK71MTvYiGVw (small blind) folded before Flop
Seat 4: K8MXCrNAVYlMnnCeM32Kxw (big blind) collected ($2)
Seat 5: VvdR9F3I+2yELkfTVvC1dg folded before Flop (didn't bet)
Seat 6: uCqEjnxh2/vFBjKYkfTOkw folded before Flop (didn't bet)



PokerStars Game #59941341218:  Hold'em No Limit ($1/$2) - 2009/07/01 1:32:38 ET
Table 'on4i1U1lCRmxsduFD3xiSg' 9-max Seat #6 is the button
Seat 1: so5k3vFDmokh2q3dImJ1GQ ($179.30 in chips)
Seat 2: NqSvZNzJ4RkR3sCmgQnyLw ($9.60 in chips)
Seat 3: GX1heJ+DSsvm7gzSPsYhhQ ($29.70 in chips)
Seat 4: DFQVuszLVclqjA46pN4Vvw ($114 in chips)
Seat 5: 37j/5DgMG5m9lMfFofEAOg ($29.35 in chips)
Seat 6: +T/63sAeZzWyHchahJ36GQ ($37 in chips)
Seat 7: /inIs/z/PcX+TniIFpaxpg ($300.40 in chips)
Seat 8: ZYHoLw2lWmRS7CSHi8L8Xg ($200 in chips)
Seat 9: iMe5yhc+1BaiIPHet3NMrA ($208.25 in chips)
/inIs/z/PcX+TniIFpaxpg: posts small blind $1
ZYHoLw2lWmRS7CSHi8L8Xg: posts big blind $2
*** HOLE CARDS ***
iMe5yhc+1BaiIPHet3NMrA: folds
so5k3vFDmokh2q3dImJ1GQ: folds
NqSvZNzJ4RkR3sCmgQnyLw: folds
GX1heJ+DSsvm7gzSPsYhhQ: folds
DFQVuszLVclqjA46pN4Vvw: folds
37j/5DgMG5m9lMfFofEAOg: calls $2
+T/63sAeZzWyHchahJ36GQ: folds
DFQVuszLVclqjA46pN4Vvw said, " sry herpes"
iMe5yhc+1BaiIPHet3NMrA leaves the table
/inIs/z/PcX+TniIFpaxpg: raises $8 to $10
ZYHoLw2lWmRS7CSHi8L8Xg: folds
37j/5DgMG5m9lMfFofEAOg: raises $19.35 to $29.35 and is all-in
TAfo4veNRaRlzDXMMYS3Jg joins the table at seat #9
/inIs/z/PcX+TniIFpaxpg: calls $19.35
*** FLOP *** [8d Tc 4c]
*** TURN *** [8d Tc 4c] [3s]
*** RIVER *** [8d Tc 4c 3s] [5c]
*** SHOW DOWN ***
/inIs/z/PcX+TniIFpaxpg: shows [Ah Kh] (high card Ace)
37j/5DgMG5m9lMfFofEAOg: shows [Kc Ac] (a flush, Ace high)
37j/5DgMG5m9lMfFofEAOg collected $57.70 from pot
*** SUMMARY ***
Total pot $60.70 | Rake $3
Board [8d Tc 4c 3s 5c]
Seat 1: so5k3vFDmokh2q3dImJ1GQ folded before Flop (didn't bet)
Seat 2: NqSvZNzJ4RkR3sCmgQnyLw folded before Flop (didn't bet)
Seat 3: GX1heJ+DSsvm7gzSPsYhhQ folded before Flop (didn't bet)
Seat 4: DFQVuszLVclqjA46pN4Vvw folded before Flop (didn't bet)
Seat 5: 37j/5DgMG5m9lMfFofEAOg showed [Kc Ac] and won ($57.70) with a flush, Ace high
Seat 6: +T/63sAeZzWyHchahJ36GQ (button) folded before Flop (didn't bet)
Seat 7: /inIs/z/PcX+TniIFpaxpg (small blind) showed [Ah Kh] and lost with high card Ace
Seat 8: ZYHoLw2lWmRS7CSHi8L8Xg (big blind) folded before Flop
Seat 9: iMe5yhc+1BaiIPHet3NMrA folded before Flop (didn't bet)



PokerStars Game #59941341510:  Hold'em No Limit ($1/$2) - 2009/07/01 1:32:39 ET
Table 'LL4bDFyhj5hsMpzaDugJZg' 6-max Seat #6 is the button
Seat 1: FwvID/fQGlpY3soi/lMTww ($70.50 in chips)
Seat 2: IZng3w8jiJHHp3LbYKLi4w ($46.15 in chips)
Seat 3: iI/NMpRxMkGieArQEhACSA ($561.90 in chips)
Seat 4: 8srN1dKQePlsv0GyTada+Q ($215.40 in chips)
Seat 5: A2GTwTiwkb1ilNWgW487Vg ($130.50 in chips)
Seat 6: 692Q4sfB0gTElzS0WMeg+A ($200 in chips)
FwvID/fQGlpY3soi/lMTww: posts small blind $1
IZng3w8jiJHHp3LbYKLi4w: posts big blind $2
*** HOLE CARDS ***
iI/NMpRxMkGieArQEhACSA: folds
8srN1dKQePlsv0GyTada+Q: folds
A2GTwTiwkb1ilNWgW487Vg: folds
692Q4sfB0gTElzS0WMeg+A: raises $4 to $6
FwvID/fQGlpY3soi/lMTww: calls $5
IZng3w8jiJHHp3LbYKLi4w: folds
*** FLOP *** [Kc 9s 3h]
FwvID/fQGlpY3soi/lMTww: checks
692Q4sfB0gTElzS0WMeg+A: bets $8
FwvID/fQGlpY3soi/lMTww: calls $8
*** TURN *** [Kc 9s 3h] [4h]
FwvID/fQGlpY3soi/lMTww: checks
692Q4sfB0gTElzS0WMeg+A: checks
*** RIVER *** [Kc 9s 3h 4h] [4c]
FwvID/fQGlpY3soi/lMTww: checks
692Q4sfB0gTElzS0WMeg+A: checks
*** SHOW DOWN ***
FwvID/fQGlpY3soi/lMTww: shows [Qd Jc] (a pair of Fours)
692Q4sfB0gTElzS0WMeg+A: mucks hand
FwvID/fQGlpY3soi/lMTww collected $28.55 from pot
*** SUMMARY ***
Total pot $30 | Rake $1.45
Board [Kc 9s 3h 4h 4c]
Seat 1: FwvID/fQGlpY3soi/lMTww (small blind) showed [Qd Jc] and won ($28.55) with a pair of Fours
Seat 2: IZng3w8jiJHHp3LbYKLi4w (big blind) folded before Flop
Seat 3: iI/NMpRxMkGieArQEhACSA folded before Flop (didn't bet)
Seat 4: 8srN1dKQePlsv0GyTada+Q folded before Flop (didn't bet)
Seat 5: A2GTwTiwkb1ilNWgW487Vg folded before Flop (didn't bet)
Seat 6: 692Q4sfB0gTElzS0WMeg+A (button) mucked



PokerStars Game #59941342476:  Hold'em No Limit ($1/$2) - 2009/07/01 1:32:40 ET
Table 'eyAQSIlgc2o1Jxvbve4WGg' 9-max Seat #9 is the button
Seat 1: UZEsV9yKUMqmpYPiOFpaZw ($106.20 in chips)
Seat 2: kM9CA+2UcdMjbCMbtUCGiA ($200 in chips)
Seat 4: CkE3IyJF1KvdaAOmZY5XqQ ($200 in chips)
Seat 5: mIKx5lhIt13X5eZQH0ZeMA ($115.80 in chips)
Seat 6: nXDI8Y/S6POzRwANu3d8hQ ($6 in chips)
Seat 7: u3OrI5uGx9mx1fE7dgr+EA ($75.20 in chips)
Seat 8: 1CtiZuXDFaJL1dJPQKyi8Q ($161.95 in chips)
Seat 9: WUlHm+ydPPHG7Lb0rePSdA ($125.95 in chips)
UZEsV9yKUMqmpYPiOFpaZw: posts small blind $1
kM9CA+2UcdMjbCMbtUCGiA: posts big blind $2
*** HOLE CARDS ***
CkE3IyJF1KvdaAOmZY5XqQ: folds
mIKx5lhIt13X5eZQH0ZeMA: calls $2
nXDI8Y/S6POzRwANu3d8hQ: folds
u3OrI5uGx9mx1fE7dgr+EA: folds
1CtiZuXDFaJL1dJPQKyi8Q: folds
WUlHm+ydPPHG7Lb0rePSdA: folds
UZEsV9yKUMqmpYPiOFpaZw: calls $1
kM9CA+2UcdMjbCMbtUCGiA: checks
*** FLOP *** [Jc 6c 2h]
UZEsV9yKUMqmpYPiOFpaZw: checks
kM9CA+2UcdMjbCMbtUCGiA: checks
mIKx5lhIt13X5eZQH0ZeMA: bets $4
UZEsV9yKUMqmpYPiOFpaZw: calls $4
kM9CA+2UcdMjbCMbtUCGiA: folds
*** TURN *** [Jc 6c 2h] [Qh]
UZEsV9yKUMqmpYPiOFpaZw: checks
mIKx5lhIt13X5eZQH0ZeMA: bets $14
UZEsV9yKUMqmpYPiOFpaZw: folds
mIKx5lhIt13X5eZQH0ZeMA collected $13.35 from pot
mIKx5lhIt13X5eZQH0ZeMA: doesn't show hand
*** SUMMARY ***
Total pot $14 | Rake $0.65
Board [Jc 6c 2h Qh]
Seat 1: UZEsV9yKUMqmpYPiOFpaZw (small blind) folded on the Turn
Seat 2: kM9CA+2UcdMjbCMbtUCGiA (big blind) folded on the Flop
Seat 4: CkE3IyJF1KvdaAOmZY5XqQ folded before Flop (didn't bet)
Seat 5: mIKx5lhIt13X5eZQH0ZeMA collected ($13.35)
Seat 6: nXDI8Y/S6POzRwANu3d8hQ folded before Flop (didn't bet)
Seat 7: u3OrI5uGx9mx1fE7dgr+EA folded before Flop (didn't bet)
Seat 8: 1CtiZuXDFaJL1dJPQKyi8Q folded before Flop (didn't bet)
Seat 9: WUlHm+ydPPHG7Lb0rePSdA (button) folded before Flop (didn't bet)



PokerStars Game #59941343990:  Hold'em No Limit ($1/$2) - 2009/07/01 1:32:43 ET
Table '/dyk+YdRGv90j2box35j8w' 6-max Seat #6 is the button
Seat 1: 8srN1dKQePlsv0GyTada+Q ($221.25 in chips)
Seat 2: qCnEYuAE5y5A7bk6fO5/jQ ($473.60 in chips)
Seat 4: z/u1YTnkiIDrtp/2cA2dBg ($193.85 in chips)
Seat 5: VvdR9F3I+2yELkfTVvC1dg ($200 in chips)
Seat 6: gnYme0DNFflnMhrdbxe1Ag ($200 in chips)
8srN1dKQePlsv0GyTada+Q: posts small blind $1
qCnEYuAE5y5A7bk6fO5/jQ: posts big blind $2
sTPOWERd9HWPCNrDBwsVjA: sits out
*** HOLE CARDS ***
z/u1YTnkiIDrtp/2cA2dBg: raises $4 to $6
VvdR9F3I+2yELkfTVvC1dg: folds
gnYme0DNFflnMhrdbxe1Ag: folds
8srN1dKQePlsv0GyTada+Q: folds
qCnEYuAE5y5A7bk6fO5/jQ: folds
z/u1YTnkiIDrtp/2cA2dBg collected $5 from pot
*** SUMMARY ***
Total pot $5 | Rake $0
Seat 1: 8srN1dKQePlsv0GyTada+Q (small blind) folded before Flop
Seat 2: qCnEYuAE5y5A7bk6fO5/jQ (big blind) folded before Flop
Seat 4: z/u1YTnkiIDrtp/2cA2dBg collected ($5)
Seat 5: VvdR9F3I+2yELkfTVvC1dg folded before Flop (didn't bet)
Seat 6: gnYme0DNFflnMhrdbxe1Ag (button) folded before Flop (didn't bet)



PokerStars Game #59941344244:  Hold'em No Limit ($1/$2) - 2009/07/01 1:32:44 ET
Table '3WCXyaiCAbqSShQu7FIjvA' 9-max Seat #1 is the button
Seat 1: kTCkABD1UUldS9DFRGfCwQ ($156.75 in chips)
Seat 2: TAfo4veNRaRlzDXMMYS3Jg ($38 in chips)
Seat 3: 5Q8U6iZbeO7xJSS4qvDP5g ($272.15 in chips)
Seat 4: waEF/+pxZTxNo4FvsORuXg ($82.40 in chips)
Seat 5: CkE3IyJF1KvdaAOmZY5XqQ ($200 in chips)
Seat 6: 5jQlngvMSqM/WoonOcR5kw ($245.35 in chips)
Seat 8: 1CtiZuXDFaJL1dJPQKyi8Q ($241.05 in chips)
Seat 9: FiXPLJyqb24l32QST2TInw ($144.40 in chips)
TAfo4veNRaRlzDXMMYS3Jg: posts small blind $1
5Q8U6iZbeO7xJSS4qvDP5g: posts big blind $2
nXDI8Y/S6POzRwANu3d8hQ: sits out
*** HOLE CARDS ***
waEF/+pxZTxNo4FvsORuXg: folds
CkE3IyJF1KvdaAOmZY5XqQ: raises $6 to $8
5jQlngvMSqM/WoonOcR5kw: folds
1CtiZuXDFaJL1dJPQKyi8Q: folds
FiXPLJyqb24l32QST2TInw: folds
kTCkABD1UUldS9DFRGfCwQ: folds
TAfo4veNRaRlzDXMMYS3Jg: folds
5Q8U6iZbeO7xJSS4qvDP5g: folds
CkE3IyJF1KvdaAOmZY5XqQ collected $5 from pot
*** SUMMARY ***
Total pot $5 | Rake $0
Seat 1: kTCkABD1UUldS9DFRGfCwQ (button) folded before Flop (didn't bet)
Seat 2: TAfo4veNRaRlzDXMMYS3Jg (small blind) folded before Flop
Seat 3: 5Q8U6iZbeO7xJSS4qvDP5g (big blind) folded before Flop
Seat 4: waEF/+pxZTxNo4FvsORuXg folded before Flop (didn't bet)
Seat 5: CkE3IyJF1KvdaAOmZY5XqQ collected ($5)
Seat 6: 5jQlngvMSqM/WoonOcR5kw folded before Flop (didn't bet)
Seat 8: 1CtiZuXDFaJL1dJPQKyi8Q folded before Flop (didn't bet)
Seat 9: FiXPLJyqb24l32QST2TInw folded before Flop (didn't bet)



PokerStars Game #59941345050:  Hold'em No Limit ($1/$2) - 2009/07/01 1:32:45 ET
Table 'NmY84NAf9Mh0ckAckHnh5g' 2-max Seat #1 is the button
Seat 1: 6hvg964TSqZ3AL/0XK9aVQ ($371.70 in chips)
Seat 2: RwDoM55ZeQuI2ADyJhOb2Q ($626.70 in chips)
6hvg964TSqZ3AL/0XK9aVQ: posts small blind $1
RwDoM55ZeQuI2ADyJhOb2Q: posts big blind $2
*** HOLE CARDS ***
6hvg964TSqZ3AL/0XK9aVQ: folds
RwDoM55ZeQuI2ADyJhOb2Q collected $2 from pot
RwDoM55ZeQuI2ADyJhOb2Q: doesn't show hand
*** SUMMARY ***
Total pot $2 | Rake $0
Seat 1: 6hvg964TSqZ3AL/0XK9aVQ (button) (small blind) folded before Flop
Seat 2: RwDoM55ZeQuI2ADyJhOb2Q (big blind) collected ($2)



PokerStars Game #59941345174:  Hold'em No Limit ($1/$2) - 2009/07/01 1:32:46 ET
Table 'YqGfR5eHfMeSjb9a+QU9rg' 9-max Seat #6 is the button
Seat 1: rW/MyplHylMSBRaoRUzWrg ($34 in chips)
Seat 2: W3Nqt1GWlTi9tXQXMNEvgw ($401.85 in chips)
Seat 3: /gll27k+xWYV7Fbki0lFDQ ($258.75 in chips)
Seat 4: GX1heJ+DSsvm7gzSPsYhhQ ($37 in chips)
Seat 5: CkE3IyJF1KvdaAOmZY5XqQ ($200 in chips)
Seat 6: TAfo4veNRaRlzDXMMYS3Jg ($34 in chips)
Seat 7: 41aZuLBz9nAi2GPVKabmCw ($101.95 in chips)
Seat 8: JnV3SM2D6dAFYyGZHHpvrg ($93.25 in chips)
Seat 9: /inIs/z/PcX+TniIFpaxpg ($205.20 in chips)
41aZuLBz9nAi2GPVKabmCw: posts small blind $1
JnV3SM2D6dAFYyGZHHpvrg: posts big blind $2
*** HOLE CARDS ***
/inIs/z/PcX+TniIFpaxpg: folds
rW/MyplHylMSBRaoRUzWrg: folds
W3Nqt1GWlTi9tXQXMNEvgw: folds
/gll27k+xWYV7Fbki0lFDQ: folds
GX1heJ+DSsvm7gzSPsYhhQ: folds
CkE3IyJF1KvdaAOmZY5XqQ: folds
TAfo4veNRaRlzDXMMYS3Jg: raises $32 to $34 and is all-in
41aZuLBz9nAi2GPVKabmCw: folds
JnV3SM2D6dAFYyGZHHpvrg: folds
TAfo4veNRaRlzDXMMYS3Jg collected $5 from pot
TAfo4veNRaRlzDXMMYS3Jg: doesn't show hand
*** SUMMARY ***
Total pot $5 | Rake $0
Seat 1: rW/MyplHylMSBRaoRUzWrg folded before Flop (didn't bet)
Seat 2: W3Nqt1GWlTi9tXQXMNEvgw folded before Flop (didn't bet)
Seat 3: /gll27k+xWYV7Fbki0lFDQ folded before Flop (didn't bet)
Seat 4: GX1heJ+DSsvm7gzSPsYhhQ folded before Flop (didn't bet)
Seat 5: CkE3IyJF1KvdaAOmZY5XqQ folded before Flop (didn't bet)
Seat 6: TAfo4veNRaRlzDXMMYS3Jg (button) collected ($5)
Seat 7: 41aZuLBz9nAi2GPVKabmCw (small blind) folded before Flop
Seat 8: JnV3SM2D6dAFYyGZHHpvrg (big blind) folded before Flop
Seat 9: /inIs/z/PcX+TniIFpaxpg folded before Flop (didn't bet)



PokerStars Game #59941347380:  Hold'em No Limit ($1/$2) - 2009/07/01 1:32:49 ET
Table 'eTkRjRjsYr567snmNk8kNQ' 2-max Seat #2 is the button
Seat 1: t6Jd836OSEMbcRi7rfGp5g ($202.50 in chips)
Seat 2: UNpnKQk0gkkyFJen8upqag ($293.50 in chips)
UNpnKQk0gkkyFJen8upqag: posts small blind $1
t6Jd836OSEMbcRi7rfGp5g: posts big blind $2
*** HOLE CARDS ***
UNpnKQk0gkkyFJen8upqag: raises $4 to $6
t6Jd836OSEMbcRi7rfGp5g: folds
UNpnKQk0gkkyFJen8upqag collected $4 from pot
*** SUMMARY ***
Total pot $4 | Rake $0
Seat 1: t6Jd836OSEMbcRi7rfGp5g (big blind) folded before Flop
Seat 2: UNpnKQk0gkkyFJen8upqag (button) (small blind) collected ($4)



PokerStars Game #59941348312:  Hold'em No Limit ($1/$2) - 2009/07/01 1:32:50 ET
Table '4NGNnZ/osQfNq6abYqkJeA' 6-max Seat #4 is the button
Seat 2: 669iGNwYwgRZg3nhS+aDAQ ($95.45 in chips)
Seat 3: 54yWzRRgS0oZ+S6LwZBxMQ ($37 in chips)
Seat 4: sY+4Uuh5z/6AbXXaCS10jw ($225.25 in chips)
Seat 5: VvdR9F3I+2yELkfTVvC1dg ($239.85 in chips)
VvdR9F3I+2yELkfTVvC1dg: posts small blind $1
3cPMpDMgeOMAe4UceUfLsg: is sitting out
vkfxu8f/jMYKUk6Ly4eujw: is sitting out
669iGNwYwgRZg3nhS+aDAQ: posts big blind $2
*** HOLE CARDS ***
3cPMpDMgeOMAe4UceUfLsg leaves the table
54yWzRRgS0oZ+S6LwZBxMQ: folds
sY+4Uuh5z/6AbXXaCS10jw: folds
VvdR9F3I+2yELkfTVvC1dg: folds
669iGNwYwgRZg3nhS+aDAQ collected $2 from pot
*** SUMMARY ***
Total pot $2 | Rake $0
Seat 2: 669iGNwYwgRZg3nhS+aDAQ (big blind) collected ($2)
Seat 3: 54yWzRRgS0oZ+S6LwZBxMQ folded before Flop (didn't bet)
Seat 4: sY+4Uuh5z/6AbXXaCS10jw (button) folded before Flop (didn't bet)
Seat 5: VvdR9F3I+2yELkfTVvC1dg (small blind) folded before Flop



PokerStars Game #59941348678:  Hold'em No Limit ($1/$2) - 2009/07/01 1:32:51 ET
Table 'NmY84NAf9Mh0ckAckHnh5g' 2-max Seat #2 is the button
Seat 1: 6hvg964TSqZ3AL/0XK9aVQ ($370.70 in chips)
Seat 2: RwDoM55ZeQuI2ADyJhOb2Q ($627.70 in chips)
RwDoM55ZeQuI2ADyJhOb2Q: posts small blind $1
6hvg964TSqZ3AL/0XK9aVQ: posts big blind $2
*** HOLE CARDS ***
RwDoM55ZeQuI2ADyJhOb2Q: folds
6hvg964TSqZ3AL/0XK9aVQ collected $2 from pot
6hvg964TSqZ3AL/0XK9aVQ: doesn't show hand
*** SUMMARY ***
Total pot $2 | Rake $0
Seat 1: 6hvg964TSqZ3AL/0XK9aVQ (big blind) collected ($2)
Seat 2: RwDoM55ZeQuI2ADyJhOb2Q (button) (small blind) folded before Flop



PokerStars Game #59941349900:  Hold'em No Limit ($1/$2) - 2009/07/01 1:32:53 ET
Table 'pPQgcj9XT9CHBsbo1WTBug' 6-max Seat #5 is the button
Seat 1: DFVYDA6dKQy7R7mGIKogZA ($139.20 in chips)
Seat 2: qXDd0ZyMIse0OBu8pxeQ3Q ($200 in chips)
Seat 3: 54yWzRRgS0oZ+S6LwZBxMQ ($52.50 in chips)
Seat 4: gqlysXCbT8V54f/1lf9h3A ($70.75 in chips)
Seat 5: vkfxu8f/jMYKUk6Ly4eujw ($190.55 in chips)
Seat 6: Yr7pZltpy3IUNdKS9PCEiw ($316.80 in chips)
Yr7pZltpy3IUNdKS9PCEiw: posts small blind $1
DFVYDA6dKQy7R7mGIKogZA: posts big blind $2
*** HOLE CARDS ***
qXDd0ZyMIse0OBu8pxeQ3Q: folds
54yWzRRgS0oZ+S6LwZBxMQ: folds
gqlysXCbT8V54f/1lf9h3A: folds
vkfxu8f/jMYKUk6Ly4eujw: folds
Yr7pZltpy3IUNdKS9PCEiw: folds
DFVYDA6dKQy7R7mGIKogZA collected $2 from pot
*** SUMMARY ***
Total pot $2 | Rake $0
Seat 1: DFVYDA6dKQy7R7mGIKogZA (big blind) collected ($2)
Seat 2: qXDd0ZyMIse0OBu8pxeQ3Q folded before Flop (didn't bet)
Seat 3: 54yWzRRgS0oZ+S6LwZBxMQ folded before Flop (didn't bet)
Seat 4: gqlysXCbT8V54f/1lf9h3A folded before Flop (didn't bet)
Seat 5: vkfxu8f/jMYKUk6Ly4eujw (button) folded before Flop (didn't bet)
Seat 6: Yr7pZltpy3IUNdKS9PCEiw (small blind) folded before Flop



PokerStars Game #59941350206:  Hold'em No Limit ($1/$2) - 2009/07/01 1:32:54 ET
Table 'AtOXMvcrtQM8yLNcALmfLQ' 2-max Seat #1 is the button
Seat 1: +HlQuAsMqZGYYtjcPO/a3A ($358.40 in chips)
Seat 2: pVqEzK9wXlRMECnb1Zg4Zw ($205.50 in chips)
+HlQuAsMqZGYYtjcPO/a3A: posts small blind $1
pVqEzK9wXlRMECnb1Zg4Zw: posts big blind $2
*** HOLE CARDS ***
+HlQuAsMqZGYYtjcPO/a3A: calls $1
pVqEzK9wXlRMECnb1Zg4Zw: checks
*** FLOP *** [9s 5d 5h]
pVqEzK9wXlRMECnb1Zg4Zw: checks
+HlQuAsMqZGYYtjcPO/a3A: bets $4
pVqEzK9wXlRMECnb1Zg4Zw: folds
+HlQuAsMqZGYYtjcPO/a3A collected $3.80 from pot
*** SUMMARY ***
Total pot $4 | Rake $0.20
Board [9s 5d 5h]
Seat 1: +HlQuAsMqZGYYtjcPO/a3A (button) (small blind) collected ($3.80)
Seat 2: pVqEzK9wXlRMECnb1Zg4Zw (big blind) folded on the Flop



PokerStars Game #59941351030:  Hold'em No Limit ($1/$2) - 2009/07/01 1:32:55 ET
Table 'UGLAZZyv+cXmnKjYin0etA' 6-max Seat #3 is the button
Seat 1: vkfxu8f/jMYKUk6Ly4eujw ($204 in chips)
Seat 2: eDLH1PUXFpvJBNMXBVQcGA ($276.35 in chips)
Seat 3: ygTTt5ehT4aF86q1a8/R+w ($114.20 in chips)
Seat 4: SiGJDsvRViJX05vHhA80GQ ($229.45 in chips)
Seat 5: 54yWzRRgS0oZ+S6LwZBxMQ ($40 in chips)
SiGJDsvRViJX05vHhA80GQ: posts small blind $1
54yWzRRgS0oZ+S6LwZBxMQ: posts big blind $2
sTPOWERd9HWPCNrDBwsVjA: sits out
*** HOLE CARDS ***
vkfxu8f/jMYKUk6Ly4eujw: folds
eDLH1PUXFpvJBNMXBVQcGA: folds
ygTTt5ehT4aF86q1a8/R+w: folds
SiGJDsvRViJX05vHhA80GQ: raises $4 to $6
54yWzRRgS0oZ+S6LwZBxMQ: calls $4
*** FLOP *** [8h Js 8s]
SiGJDsvRViJX05vHhA80GQ: bets $12
54yWzRRgS0oZ+S6LwZBxMQ: folds
SiGJDsvRViJX05vHhA80GQ collected $11.40 from pot
*** SUMMARY ***
Total pot $12 | Rake $0.60
Board [8h Js 8s]
Seat 1: vkfxu8f/jMYKUk6Ly4eujw folded before Flop (didn't bet)
Seat 2: eDLH1PUXFpvJBNMXBVQcGA folded before Flop (didn't bet)
Seat 3: ygTTt5ehT4aF86q1a8/R+w (button) folded before Flop (didn't bet)
Seat 4: SiGJDsvRViJX05vHhA80GQ (small blind) collected ($11.40)
Seat 5: 54yWzRRgS0oZ+S6LwZBxMQ (big blind) folded on the Flop



PokerStars Game #59941351620:  Hold'em No Limit ($1/$2) - 2009/07/01 1:32:56 ET
Table 'jlrIxbrVIG+gjaUYT4za8g' 6-max Seat #2 is the button
Seat 1: ygTTt5ehT4aF86q1a8/R+w ($258.30 in chips)
Seat 2: /PH6Ffnho4Ysm8S3V/oa+w ($40 in chips)
Seat 3: gnYme0DNFflnMhrdbxe1Ag ($201 in chips)
Seat 4: 8srN1dKQePlsv0GyTada+Q ($232.55 in chips)
Seat 5: AyBB0k3Dcl7xbXUeGMw06g ($73.90 in chips)
Seat 6: vkfxu8f/jMYKUk6Ly4eujw ($306 in chips)
gnYme0DNFflnMhrdbxe1Ag: posts small blind $1
8srN1dKQePlsv0GyTada+Q: posts big blind $2
*** HOLE CARDS ***
AyBB0k3Dcl7xbXUeGMw06g: folds
vkfxu8f/jMYKUk6Ly4eujw: folds
ygTTt5ehT4aF86q1a8/R+w: folds
/PH6Ffnho4Ysm8S3V/oa+w: folds
gnYme0DNFflnMhrdbxe1Ag: raises $4 to $6
8srN1dKQePlsv0GyTada+Q: calls $4
*** FLOP *** [Ac 6d 7c]
gnYme0DNFflnMhrdbxe1Ag: bets $8
8srN1dKQePlsv0GyTada+Q: raises $14 to $22
gnYme0DNFflnMhrdbxe1Ag: folds
8srN1dKQePlsv0GyTada+Q collected $26.65 from pot
*** SUMMARY ***
Total pot $28 | Rake $1.35
Board [Ac 6d 7c]
Seat 1: ygTTt5ehT4aF86q1a8/R+w folded before Flop (didn't bet)
Seat 2: /PH6Ffnho4Ysm8S3V/oa+w (button) folded before Flop (didn't bet)
Seat 3: gnYme0DNFflnMhrdbxe1Ag (small blind) folded on the Flop
Seat 4: 8srN1dKQePlsv0GyTada+Q (big blind) collected ($26.65)
Seat 5: AyBB0k3Dcl7xbXUeGMw06g folded before Flop (didn't bet)
Seat 6: vkfxu8f/jMYKUk6Ly4eujw folded before Flop (didn't bet)



PokerStars Game #59941351404:  Hold'em No Limit ($1/$2) - 2009/07/01 1:32:56 ET
Table 'G1Oqdy4Pqdb5gtx40rUBzA' 6-max Seat #2 is the button
Seat 1: ubtx4Z5L+AcK71MTvYiGVw ($200 in chips)
Seat 2: 4uqU0dG67owXuPz303Al4w ($515.25 in chips)
Seat 3: VvdR9F3I+2yELkfTVvC1dg ($239.25 in chips)
Seat 4: B87ikIyZ/TzAVeXf38Ny0g ($214.55 in chips)
Seat 5: F1+Ml47qRQWunzPnGhLLzQ ($186.50 in chips)
Seat 6: qCnEYuAE5y5A7bk6fO5/jQ ($203 in chips)
VvdR9F3I+2yELkfTVvC1dg: posts small blind $1
B87ikIyZ/TzAVeXf38Ny0g: posts big blind $2
*** HOLE CARDS ***
F1+Ml47qRQWunzPnGhLLzQ: folds
qCnEYuAE5y5A7bk6fO5/jQ: folds
ubtx4Z5L+AcK71MTvYiGVw: folds
4uqU0dG67owXuPz303Al4w: folds
VvdR9F3I+2yELkfTVvC1dg: folds
B87ikIyZ/TzAVeXf38Ny0g collected $2 from pot
B87ikIyZ/TzAVeXf38Ny0g: doesn't show hand
*** SUMMARY ***
Total pot $2 | Rake $0
Seat 1: ubtx4Z5L+AcK71MTvYiGVw folded before Flop (didn't bet)
Seat 2: 4uqU0dG67owXuPz303Al4w (button) folded before Flop (didn't bet)
Seat 3: VvdR9F3I+2yELkfTVvC1dg (small blind) folded before Flop
Seat 4: B87ikIyZ/TzAVeXf38Ny0g (big blind) collected ($2)
Seat 5: F1+Ml47qRQWunzPnGhLLzQ folded before Flop (didn't bet)
Seat 6: qCnEYuAE5y5A7bk6fO5/jQ folded before Flop (didn't bet)



PokerStars Game #59941351880:  Hold'em No Limit ($1/$2) - 2009/07/01 1:32:57 ET
Table 'W9UeSV0aoPjh5SFSxM8jUQ' 9-max Seat #1 is the button
Seat 1: mIKx5lhIt13X5eZQH0ZeMA ($28.40 in chips)
Seat 3: /inIs/z/PcX+TniIFpaxpg ($23 in chips)
Seat 4: 4YA/sQy1Emm680zhbPUjow ($136.35 in chips)
Seat 5: ri8CLkX3e9JF34dQNbsHGA ($40 in chips)
Seat 6: j47DM+lqTfzZP8musviQTg ($129.30 in chips)
Seat 7: I2ipWauytvrkEer4XD3Sjg ($77.70 in chips)
Seat 8: odhvI/CZeMsPyo1n1U7+hA ($34.40 in chips)
Seat 9: Q104K4iDGcqOlVrjAkzPEA ($103.35 in chips)
/inIs/z/PcX+TniIFpaxpg: posts small blind $1
4YA/sQy1Emm680zhbPUjow: posts big blind $2
*** HOLE CARDS ***
ri8CLkX3e9JF34dQNbsHGA: folds
j47DM+lqTfzZP8musviQTg: folds
I2ipWauytvrkEer4XD3Sjg: calls $2
odhvI/CZeMsPyo1n1U7+hA: folds
iMe5yhc+1BaiIPHet3NMrA leaves the table
Q104K4iDGcqOlVrjAkzPEA: calls $2
mIKx5lhIt13X5eZQH0ZeMA: folds
/inIs/z/PcX+TniIFpaxpg: folds
4YA/sQy1Emm680zhbPUjow: checks
*** FLOP *** [Th Qs Kd]
4YA/sQy1Emm680zhbPUjow: checks
I2ipWauytvrkEer4XD3Sjg: checks
MeleaB joins the table at seat #2
Q104K4iDGcqOlVrjAkzPEA: bets $6
4YA/sQy1Emm680zhbPUjow: folds
I2ipWauytvrkEer4XD3Sjg: folds
Q104K4iDGcqOlVrjAkzPEA collected $6.65 from pot
*** SUMMARY ***
Total pot $7 | Rake $0.35
Board [Th Qs Kd]
Seat 1: mIKx5lhIt13X5eZQH0ZeMA (button) folded before Flop (didn't bet)
Seat 3: /inIs/z/PcX+TniIFpaxpg (small blind) folded before Flop
Seat 4: 4YA/sQy1Emm680zhbPUjow (big blind) folded on the Flop
Seat 5: ri8CLkX3e9JF34dQNbsHGA folded before Flop (didn't bet)
Seat 6: j47DM+lqTfzZP8musviQTg folded before Flop (didn't bet)
Seat 7: I2ipWauytvrkEer4XD3Sjg folded on the Flop
Seat 8: odhvI/CZeMsPyo1n1U7+hA folded before Flop (didn't bet)
Seat 9: Q104K4iDGcqOlVrjAkzPEA collected ($6.65)



PokerStars Game #59941352614:  Hold'em No Limit ($1/$2) - 2009/07/01 1:32:58 ET
Table 'TsEDkiO4tzCTCzJ7tNdEqw' 6-max Seat #3 is the button
Seat 1: MfXQsYD8pGeCS7XOtyV+vw ($84.05 in chips)
Seat 2: 4dcDwIHRm96PwtqkpQiuiA ($75.10 in chips)
Seat 3: ubtx4Z5L+AcK71MTvYiGVw ($200 in chips)
Seat 4: K8MXCrNAVYlMnnCeM32Kxw ($118.50 in chips)
Seat 5: VvdR9F3I+2yELkfTVvC1dg ($259.35 in chips)
Seat 6: uCqEjnxh2/vFBjKYkfTOkw ($162.70 in chips)
K8MXCrNAVYlMnnCeM32Kxw: posts small blind $1
VvdR9F3I+2yELkfTVvC1dg: posts big blind $2
*** HOLE CARDS ***
uCqEjnxh2/vFBjKYkfTOkw: folds
MfXQsYD8pGeCS7XOtyV+vw: folds
4dcDwIHRm96PwtqkpQiuiA: folds
ubtx4Z5L+AcK71MTvYiGVw: raises $4 to $6
K8MXCrNAVYlMnnCeM32Kxw: folds
VvdR9F3I+2yELkfTVvC1dg: folds
ubtx4Z5L+AcK71MTvYiGVw collected $5 from pot
ubtx4Z5L+AcK71MTvYiGVw: doesn't show hand
*** SUMMARY ***
Total pot $5 | Rake $0
Seat 1: MfXQsYD8pGeCS7XOtyV+vw folded before Flop (didn't bet)
Seat 2: 4dcDwIHRm96PwtqkpQiuiA folded before Flop (didn't bet)
Seat 3: ubtx4Z5L+AcK71MTvYiGVw (button) collected ($5)
Seat 4: K8MXCrNAVYlMnnCeM32Kxw (small blind) folded before Flop
Seat 5: VvdR9F3I+2yELkfTVvC1dg (big blind) folded before Flop
Seat 6: uCqEjnxh2/vFBjKYkfTOkw folded before Flop (didn't bet)



PokerStars Game #59941352976:  Hold'em No Limit ($1/$2) - 2009/07/01 1:32:58 ET
Table 'NmY84NAf9Mh0ckAckHnh5g' 2-max Seat #1 is the button
Seat 1: 6hvg964TSqZ3AL/0XK9aVQ ($371.70 in chips)
Seat 2: RwDoM55ZeQuI2ADyJhOb2Q ($626.70 in chips)
6hvg964TSqZ3AL/0XK9aVQ: posts small blind $1
RwDoM55ZeQuI2ADyJhOb2Q: posts big blind $2
*** HOLE CARDS ***
6hvg964TSqZ3AL/0XK9aVQ: folds
RwDoM55ZeQuI2ADyJhOb2Q collected $2 from pot
RwDoM55ZeQuI2ADyJhOb2Q: doesn't show hand
*** SUMMARY ***
Total pot $2 | Rake $0
Seat 1: 6hvg964TSqZ3AL/0XK9aVQ (button) (small blind) folded before Flop
Seat 2: RwDoM55ZeQuI2ADyJhOb2Q (big blind) collected ($2)



PokerStars Game #59941353228:  Hold'em No Limit ($1/$2) - 2009/07/01 1:32:59 ET
Table 'qVXak+oTeDXMGbWa4sDU5Q' 9-max Seat #4 is the button
Seat 1: H6Z4+qu8gR0VUiPOijndVg ($205.55 in chips)
Seat 2: rW/MyplHylMSBRaoRUzWrg ($81 in chips)
Seat 3: WUlHm+ydPPHG7Lb0rePSdA ($150.65 in chips)
Seat 4: lQYT23h5QCUVZAKxjOO39Q ($200.70 in chips)
Seat 5: FWGiDqRwvLeKmHq9t4Jy9w ($266.80 in chips)
Seat 6: GX1heJ+DSsvm7gzSPsYhhQ ($40 in chips)
Seat 7: PfmlvZlFiss79a6IoEr11g ($163.30 in chips)
Seat 8: Z0rzUi0y1x80UdIpofoNbA ($125.55 in chips)
Seat 9: CkE3IyJF1KvdaAOmZY5XqQ ($200 in chips)
FWGiDqRwvLeKmHq9t4Jy9w: posts small blind $1
GX1heJ+DSsvm7gzSPsYhhQ: posts big blind $2
*** HOLE CARDS ***
PfmlvZlFiss79a6IoEr11g: folds
Z0rzUi0y1x80UdIpofoNbA: folds
CkE3IyJF1KvdaAOmZY5XqQ: folds
H6Z4+qu8gR0VUiPOijndVg: folds
rW/MyplHylMSBRaoRUzWrg: folds
WUlHm+ydPPHG7Lb0rePSdA: folds
lQYT23h5QCUVZAKxjOO39Q: folds
FWGiDqRwvLeKmHq9t4Jy9w: folds
GX1heJ+DSsvm7gzSPsYhhQ collected $2 from pot
GX1heJ+DSsvm7gzSPsYhhQ: doesn't show hand
*** SUMMARY ***
Total pot $2 | Rake $0
Seat 1: H6Z4+qu8gR0VUiPOijndVg folded before Flop (didn't bet)
Seat 2: rW/MyplHylMSBRaoRUzWrg folded before Flop (didn't bet)
Seat 3: WUlHm+ydPPHG7Lb0rePSdA folded before Flop (didn't bet)
Seat 4: lQYT23h5QCUVZAKxjOO39Q (button) folded before Flop (didn't bet)
Seat 5: FWGiDqRwvLeKmHq9t4Jy9w (small blind) folded before Flop
Seat 6: GX1heJ+DSsvm7gzSPsYhhQ (big blind) collected ($2)
Seat 7: PfmlvZlFiss79a6IoEr11g folded before Flop (didn't bet)
Seat 8: Z0rzUi0y1x80UdIpofoNbA folded before Flop (didn't bet)
Seat 9: CkE3IyJF1KvdaAOmZY5XqQ folded before Flop (didn't bet)



PokerStars Game #59941354214:  Hold'em No Limit ($1/$2) - 2009/07/01 1:33:01 ET
Table 'gftD4mDF7mIFKvSrIyaRbw' 9-max Seat #4 is the button
Seat 2: GX1heJ+DSsvm7gzSPsYhhQ ($36 in chips)
Seat 3: CUZwDpLTQKhzarPe+JCLOQ ($210.75 in chips)
Seat 4: /inIs/z/PcX+TniIFpaxpg ($37 in chips)
Seat 5: mpsfNtnMVDqQHTe92AhIdw ($118.10 in chips)
Seat 6: 2NvwF8W2nzsbS+G//yLAbQ ($113.85 in chips)
Seat 7: +T/63sAeZzWyHchahJ36GQ ($42 in chips)
Seat 8: MpL4DeEqGQu0H8TJEbEOrg ($41 in chips)
mpsfNtnMVDqQHTe92AhIdw: posts small blind $1
2NvwF8W2nzsbS+G//yLAbQ: posts big blind $2
*** HOLE CARDS ***
+T/63sAeZzWyHchahJ36GQ: folds
MpL4DeEqGQu0H8TJEbEOrg: folds
GX1heJ+DSsvm7gzSPsYhhQ: folds
CUZwDpLTQKhzarPe+JCLOQ: raises $4 to $6
/inIs/z/PcX+TniIFpaxpg: folds
mpsfNtnMVDqQHTe92AhIdw: folds
2NvwF8W2nzsbS+G//yLAbQ: calls $4
*** FLOP *** [9s 6s 4d]
2NvwF8W2nzsbS+G//yLAbQ: bets $6
CUZwDpLTQKhzarPe+JCLOQ: folds
2NvwF8W2nzsbS+G//yLAbQ collected $12.35 from pot
*** SUMMARY ***
Total pot $13 | Rake $0.65
Board [9s 6s 4d]
Seat 2: GX1heJ+DSsvm7gzSPsYhhQ folded before Flop (didn't bet)
Seat 3: CUZwDpLTQKhzarPe+JCLOQ folded on the Flop
Seat 4: /inIs/z/PcX+TniIFpaxpg (button) folded before Flop (didn't bet)
Seat 5: mpsfNtnMVDqQHTe92AhIdw (small blind) folded before Flop
Seat 6: 2NvwF8W2nzsbS+G//yLAbQ (big blind) collected ($12.35)
Seat 7: +T/63sAeZzWyHchahJ36GQ folded before Flop (didn't bet)
Seat 8: MpL4DeEqGQu0H8TJEbEOrg folded before Flop (didn't bet)



PokerStars Game #59941355334:  Hold'em No Limit ($1/$2) - 2009/07/01 1:33:03 ET
Table '4NGNnZ/osQfNq6abYqkJeA' 6-max Seat #5 is the button
Seat 2: 669iGNwYwgRZg3nhS+aDAQ ($96.45 in chips)
Seat 3: 54yWzRRgS0oZ+S6LwZBxMQ ($37 in chips)
Seat 4: sY+4Uuh5z/6AbXXaCS10jw ($225.25 in chips)
Seat 5: VvdR9F3I+2yELkfTVvC1dg ($238.85 in chips)
/PH6Ffnho4Ysm8S3V/oa+w joins the table at seat #6
669iGNwYwgRZg3nhS+aDAQ: posts small blind $1
54yWzRRgS0oZ+S6LwZBxMQ: posts big blind $2
*** HOLE CARDS ***
sY+4Uuh5z/6AbXXaCS10jw: folds
VvdR9F3I+2yELkfTVvC1dg: folds
vkfxu8f/jMYKUk6Ly4eujw has returned
669iGNwYwgRZg3nhS+aDAQ: calls $1
54yWzRRgS0oZ+S6LwZBxMQ: checks
*** FLOP *** [Ts Ah 8h]
669iGNwYwgRZg3nhS+aDAQ: checks
54yWzRRgS0oZ+S6LwZBxMQ: checks
*** TURN *** [Ts Ah 8h] [9h]
669iGNwYwgRZg3nhS+aDAQ: checks
54yWzRRgS0oZ+S6LwZBxMQ: checks
*** RIVER *** [Ts Ah 8h 9h] [Kh]
669iGNwYwgRZg3nhS+aDAQ: bets $6
54yWzRRgS0oZ+S6LwZBxMQ: folds
669iGNwYwgRZg3nhS+aDAQ collected $3.80 from pot
*** SUMMARY ***
Total pot $4 | Rake $0.20
Board [Ts Ah 8h 9h Kh]
Seat 2: 669iGNwYwgRZg3nhS+aDAQ (small blind) collected ($3.80)
Seat 3: 54yWzRRgS0oZ+S6LwZBxMQ (big blind) folded on the River
Seat 4: sY+4Uuh5z/6AbXXaCS10jw folded before Flop (didn't bet)
Seat 5: VvdR9F3I+2yELkfTVvC1dg (button) folded before Flop (didn't bet)



PokerStars Game #59941356274:  Hold'em No Limit ($1/$2) - 2009/07/01 1:33:04 ET
Table 'eTkRjRjsYr567snmNk8kNQ' 2-max Seat #1 is the button
Seat 1: t6Jd836OSEMbcRi7rfGp5g ($200.50 in chips)
Seat 2: UNpnKQk0gkkyFJen8upqag ($295.50 in chips)
t6Jd836OSEMbcRi7rfGp5g: posts small blind $1
UNpnKQk0gkkyFJen8upqag: posts big blind $2
*** HOLE CARDS ***
t6Jd836OSEMbcRi7rfGp5g: raises $4 to $6
UNpnKQk0gkkyFJen8upqag: folds
t6Jd836OSEMbcRi7rfGp5g collected $4 from pot
*** SUMMARY ***
Total pot $4 | Rake $0
Seat 1: t6Jd836OSEMbcRi7rfGp5g (button) (small blind) collected ($4)
Seat 2: UNpnKQk0gkkyFJen8upqag (big blind) folded before Flop



PokerStars Game #59941356316:  Hold'em No Limit ($1/$2) - 2009/07/01 1:33:05 ET
Table 'NmY84NAf9Mh0ckAckHnh5g' 2-max Seat #2 is the button
Seat 1: 6hvg964TSqZ3AL/0XK9aVQ ($370.70 in chips)
Seat 2: RwDoM55ZeQuI2ADyJhOb2Q ($627.70 in chips)
RwDoM55ZeQuI2ADyJhOb2Q: posts small blind $1
6hvg964TSqZ3AL/0XK9aVQ: posts big blind $2
*** HOLE CARDS ***
RwDoM55ZeQuI2ADyJhOb2Q: raises $4 to $6
6hvg964TSqZ3AL/0XK9aVQ: calls $4
*** FLOP *** [2c 2d Th]
6hvg964TSqZ3AL/0XK9aVQ: checks
RwDoM55ZeQuI2ADyJhOb2Q: bets $8
6hvg964TSqZ3AL/0XK9aVQ: calls $8
*** TURN *** [2c 2d Th] [5h]
6hvg964TSqZ3AL/0XK9aVQ: checks
RwDoM55ZeQuI2ADyJhOb2Q: bets $22
6hvg964TSqZ3AL/0XK9aVQ: folds
RwDoM55ZeQuI2ADyJhOb2Q collected $27.50 from pot
RwDoM55ZeQuI2ADyJhOb2Q: doesn't show hand
*** SUMMARY ***
Total pot $28 | Rake $0.50
Board [2c 2d Th 5h]
Seat 1: 6hvg964TSqZ3AL/0XK9aVQ (big blind) folded on the Turn
Seat 2: RwDoM55ZeQuI2ADyJhOb2Q (button) (small blind) collected ($27.50)



PokerStars Game #59941357016:  Hold'em No Limit ($1/$2) - 2009/07/01 1:33:06 ET
Table 'ztv6V3FN2bQ9nmJPPdx6nQ' 6-max Seat #5 is the button
Seat 1: 6fLdOUCRtX71xbVRhJEq8w ($241.35 in chips)
Seat 2: 5Y+ZGWLI4gnlpApDX5vy1A ($386.75 in chips)
Seat 3: ubtx4Z5L+AcK71MTvYiGVw ($245 in chips)
Seat 5: sTPOWERd9HWPCNrDBwsVjA ($222.80 in chips)
Seat 6: mfy7uGZcqA2PVQqEVbJ7+g ($98.45 in chips)
mfy7uGZcqA2PVQqEVbJ7+g: posts small blind $1
6fLdOUCRtX71xbVRhJEq8w: posts big blind $2
*** HOLE CARDS ***
5Y+ZGWLI4gnlpApDX5vy1A: folds
ubtx4Z5L+AcK71MTvYiGVw: folds
sTPOWERd9HWPCNrDBwsVjA: folds
mfy7uGZcqA2PVQqEVbJ7+g: folds
6fLdOUCRtX71xbVRhJEq8w collected $2 from pot
*** SUMMARY ***
Total pot $2 | Rake $0
Seat 1: 6fLdOUCRtX71xbVRhJEq8w (big blind) collected ($2)
Seat 2: 5Y+ZGWLI4gnlpApDX5vy1A folded before Flop (didn't bet)
Seat 3: ubtx4Z5L+AcK71MTvYiGVw folded before Flop (didn't bet)
Seat 5: sTPOWERd9HWPCNrDBwsVjA (button) folded before Flop (didn't bet)
Seat 6: mfy7uGZcqA2PVQqEVbJ7+g (small blind) folded before Flop



PokerStars Game #59941358350:  Hold'em No Limit ($1/$2) - 2009/07/01 1:33:08 ET
Table '/dyk+YdRGv90j2box35j8w' 6-max Seat #1 is the button
Seat 1: 8srN1dKQePlsv0GyTada+Q ($220.25 in chips)
Seat 2: qCnEYuAE5y5A7bk6fO5/jQ ($471.60 in chips)
Seat 3: sTPOWERd9HWPCNrDBwsVjA ($188.50 in chips)
Seat 4: z/u1YTnkiIDrtp/2cA2dBg ($196.85 in chips)
Seat 5: VvdR9F3I+2yELkfTVvC1dg ($200 in chips)
Seat 6: gnYme0DNFflnMhrdbxe1Ag ($200 in chips)
qCnEYuAE5y5A7bk6fO5/jQ: posts small blind $1
sTPOWERd9HWPCNrDBwsVjA: posts big blind $2
*** HOLE CARDS ***
z/u1YTnkiIDrtp/2cA2dBg: raises $2 to $4
VvdR9F3I+2yELkfTVvC1dg: calls $4
gnYme0DNFflnMhrdbxe1Ag: folds
8srN1dKQePlsv0GyTada+Q: raises $10 to $14
qCnEYuAE5y5A7bk6fO5/jQ: folds
sTPOWERd9HWPCNrDBwsVjA: folds
z/u1YTnkiIDrtp/2cA2dBg: calls $10
VvdR9F3I+2yELkfTVvC1dg: calls $10
*** FLOP *** [4s 2d 3s]
z/u1YTnkiIDrtp/2cA2dBg: checks
VvdR9F3I+2yELkfTVvC1dg: checks
8srN1dKQePlsv0GyTada+Q: checks
*** TURN *** [4s 2d 3s] [5d]
z/u1YTnkiIDrtp/2cA2dBg: checks
VvdR9F3I+2yELkfTVvC1dg: checks
8srN1dKQePlsv0GyTada+Q: checks
*** RIVER *** [4s 2d 3s 5d] [7s]
z/u1YTnkiIDrtp/2cA2dBg: bets $15
VvdR9F3I+2yELkfTVvC1dg: raises $25.65 to $40.65
8srN1dKQePlsv0GyTada+Q: folds
z/u1YTnkiIDrtp/2cA2dBg: folds
VvdR9F3I+2yELkfTVvC1dg collected $72 from pot
VvdR9F3I+2yELkfTVvC1dg: doesn't show hand
*** SUMMARY ***
Total pot $75 | Rake $3
Board [4s 2d 3s 5d 7s]
Seat 1: 8srN1dKQePlsv0GyTada+Q (button) folded on the River
Seat 2: qCnEYuAE5y5A7bk6fO5/jQ (small blind) folded before Flop
Seat 3: sTPOWERd9HWPCNrDBwsVjA (big blind) folded before Flop
Seat 4: z/u1YTnkiIDrtp/2cA2dBg folded on the River
Seat 5: VvdR9F3I+2yELkfTVvC1dg collected ($72)
Seat 6: gnYme0DNFflnMhrdbxe1Ag folded before Flop (didn't bet)



PokerStars Game #59941358868:  Hold'em No Limit ($1/$2) - 2009/07/01 1:33:09 ET
Table 'uJ9juaXXg9yIcSU8amxaXQ' 6-max Seat #2 is the button
Seat 1: JsqOjN/eHz0uYVf/PyUJ6Q ($144.50 in chips)
Seat 2: VvdR9F3I+2yELkfTVvC1dg ($225.10 in chips)
Seat 3: qXDd0ZyMIse0OBu8pxeQ3Q ($245.40 in chips)
Seat 4: zNjJ/y4emmF+vzrCDd+ooA ($244.90 in chips)
Seat 5: YsLQ3BAvgQHWXMAv3Wv6Hg ($200 in chips)
Seat 6: 2DFp9Veq1xxq64dCjwNuUw ($51.60 in chips)
qXDd0ZyMIse0OBu8pxeQ3Q: posts small blind $1
zNjJ/y4emmF+vzrCDd+ooA: posts big blind $2
*** HOLE CARDS ***
YsLQ3BAvgQHWXMAv3Wv6Hg: folds
2DFp9Veq1xxq64dCjwNuUw: raises $4 to $6
JsqOjN/eHz0uYVf/PyUJ6Q: raises $10 to $16
VvdR9F3I+2yELkfTVvC1dg: folds
qXDd0ZyMIse0OBu8pxeQ3Q: folds
zNjJ/y4emmF+vzrCDd+ooA: folds
2DFp9Veq1xxq64dCjwNuUw: folds
JsqOjN/eHz0uYVf/PyUJ6Q collected $15 from pot
JsqOjN/eHz0uYVf/PyUJ6Q: doesn't show hand
*** SUMMARY ***
Total pot $15 | Rake $0
Seat 1: JsqOjN/eHz0uYVf/PyUJ6Q collected ($15)
Seat 2: VvdR9F3I+2yELkfTVvC1dg (button) folded before Flop (didn't bet)
Seat 3: qXDd0ZyMIse0OBu8pxeQ3Q (small blind) folded before Flop
Seat 4: zNjJ/y4emmF+vzrCDd+ooA (big blind) folded before Flop
Seat 5: YsLQ3BAvgQHWXMAv3Wv6Hg folded before Flop (didn't bet)
Seat 6: 2DFp9Veq1xxq64dCjwNuUw folded before Flop



PokerStars Game #59941358720:  Hold'em No Limit ($1/$2) - 2009/07/01 1:33:09 ET
Table 'rKeCh+eBn4RNvybCUYkoTQ' 9-max Seat #8 is the button
Seat 1: /inIs/z/PcX+TniIFpaxpg ($198 in chips)
Seat 2: 9cBHwK40Tl06vheE7B3LHQ ($129.80 in chips)
Seat 3: GX1heJ+DSsvm7gzSPsYhhQ ($40 in chips)
Seat 5: WUlHm+ydPPHG7Lb0rePSdA ($125 in chips)
Seat 6: EBV6OktyeSmh4w6sWmcWOw ($267 in chips)
Seat 7: rW/MyplHylMSBRaoRUzWrg ($31 in chips)
Seat 8: pN/Ip0ePsUVIdUlGgLrkUw ($246.35 in chips)
Seat 9: Kzta8yu9vxHT4B70mjBZ+w ($209.25 in chips)
Kzta8yu9vxHT4B70mjBZ+w: posts small blind $1
/inIs/z/PcX+TniIFpaxpg: posts big blind $2
*** HOLE CARDS ***
9cBHwK40Tl06vheE7B3LHQ: folds
GX1heJ+DSsvm7gzSPsYhhQ: folds
WUlHm+ydPPHG7Lb0rePSdA: folds
EBV6OktyeSmh4w6sWmcWOw: folds
rW/MyplHylMSBRaoRUzWrg: folds
pN/Ip0ePsUVIdUlGgLrkUw: folds
Kzta8yu9vxHT4B70mjBZ+w: folds
/inIs/z/PcX+TniIFpaxpg collected $2 from pot
/inIs/z/PcX+TniIFpaxpg: doesn't show hand
*** SUMMARY ***
Total pot $2 | Rake $0
Seat 1: /inIs/z/PcX+TniIFpaxpg (big blind) collected ($2)
Seat 2: 9cBHwK40Tl06vheE7B3LHQ folded before Flop (didn't bet)
Seat 3: GX1heJ+DSsvm7gzSPsYhhQ folded before Flop (didn't bet)
Seat 5: WUlHm+ydPPHG7Lb0rePSdA folded before Flop (didn't bet)
Seat 6: EBV6OktyeSmh4w6sWmcWOw folded before Flop (didn't bet)
Seat 7: rW/MyplHylMSBRaoRUzWrg folded before Flop (didn't bet)
Seat 8: pN/Ip0ePsUVIdUlGgLrkUw (button) folded before Flop (didn't bet)
Seat 9: Kzta8yu9vxHT4B70mjBZ+w (small blind) folded before Flop



PokerStars Game #59941359344:  Hold'em No Limit ($1/$2) - 2009/07/01 1:33:10 ET
Table '/ci73fTmzTzmGWzAtqEX2Q' 9-max Seat #3 is the button
Seat 1: 9efVc1cB3yHt4TvBkTusPw ($146.90 in chips)
Seat 2: pN/Ip0ePsUVIdUlGgLrkUw ($225 in chips)
Seat 3: kK1+5ivyJZeA8hQF2pdvvQ ($64.55 in chips)
Seat 4: 2yq7Zp4xmrhAw8+37hTkaA ($167.20 in chips)
Seat 5: 1CtiZuXDFaJL1dJPQKyi8Q ($215 in chips)
Seat 6: GX1heJ+DSsvm7gzSPsYhhQ ($47.65 in chips)
Seat 7: rW/MyplHylMSBRaoRUzWrg ($57.15 in chips)
Seat 8: /inIs/z/PcX+TniIFpaxpg ($37 in chips)
Seat 9: S8aS+9FTYQ/ICLBNThcrkg ($183 in chips)
2yq7Zp4xmrhAw8+37hTkaA: posts small blind $1
1CtiZuXDFaJL1dJPQKyi8Q: posts big blind $2
*** HOLE CARDS ***
GX1heJ+DSsvm7gzSPsYhhQ: folds
rW/MyplHylMSBRaoRUzWrg: folds
/inIs/z/PcX+TniIFpaxpg: folds
S8aS+9FTYQ/ICLBNThcrkg: folds
9efVc1cB3yHt4TvBkTusPw: raises $6 to $8
pN/Ip0ePsUVIdUlGgLrkUw: folds
kK1+5ivyJZeA8hQF2pdvvQ: folds
2yq7Zp4xmrhAw8+37hTkaA: folds
1CtiZuXDFaJL1dJPQKyi8Q: folds
9efVc1cB3yHt4TvBkTusPw collected $5 from pot
*** SUMMARY ***
Total pot $5 | Rake $0
Seat 1: 9efVc1cB3yHt4TvBkTusPw collected ($5)
Seat 2: pN/Ip0ePsUVIdUlGgLrkUw folded before Flop (didn't bet)
Seat 3: kK1+5ivyJZeA8hQF2pdvvQ (button) folded before Flop (didn't bet)
Seat 4: 2yq7Zp4xmrhAw8+37hTkaA (small blind) folded before Flop
Seat 5: 1CtiZuXDFaJL1dJPQKyi8Q (big blind) folded before Flop
Seat 6: GX1heJ+DSsvm7gzSPsYhhQ folded before Flop (didn't bet)
Seat 7: rW/MyplHylMSBRaoRUzWrg folded before Flop (didn't bet)
Seat 8: /inIs/z/PcX+TniIFpaxpg folded before Flop (didn't bet)
Seat 9: S8aS+9FTYQ/ICLBNThcrkg folded before Flop (didn't bet)



PokerStars Game #59941359784:  Hold'em No Limit ($1/$2) - 2009/07/01 1:33:11 ET
Table 'kq5zaQ+1hLNf8LZfGnbTAA' 6-max Seat #1 is the button
Seat 1: 8srN1dKQePlsv0GyTada+Q ($437.60 in chips)
Seat 2: nXDI8Y/S6POzRwANu3d8hQ ($162 in chips)
Seat 3: /PH6Ffnho4Ysm8S3V/oa+w ($40 in chips)
Seat 4: 3dAbvkxS5NPQTBAbvpinVg ($281.45 in chips)
Seat 5: gnYme0DNFflnMhrdbxe1Ag ($200 in chips)
Seat 6: mfy7uGZcqA2PVQqEVbJ7+g ($191.25 in chips)
nXDI8Y/S6POzRwANu3d8hQ: posts small blind $1
/PH6Ffnho4Ysm8S3V/oa+w: posts big blind $2
*** HOLE CARDS ***
3dAbvkxS5NPQTBAbvpinVg: folds
gnYme0DNFflnMhrdbxe1Ag: folds
mfy7uGZcqA2PVQqEVbJ7+g: folds
8srN1dKQePlsv0GyTada+Q: folds
nXDI8Y/S6POzRwANu3d8hQ: raises $4 to $6
/PH6Ffnho4Ysm8S3V/oa+w: folds
nXDI8Y/S6POzRwANu3d8hQ collected $4 from pot
nXDI8Y/S6POzRwANu3d8hQ: doesn't show hand
*** SUMMARY ***
Total pot $4 | Rake $0
Seat 1: 8srN1dKQePlsv0GyTada+Q (button) folded before Flop (didn't bet)
Seat 2: nXDI8Y/S6POzRwANu3d8hQ (small blind) collected ($4)
Seat 3: /PH6Ffnho4Ysm8S3V/oa+w (big blind) folded before Flop
Seat 4: 3dAbvkxS5NPQTBAbvpinVg folded before Flop (didn't bet)
Seat 5: gnYme0DNFflnMhrdbxe1Ag folded before Flop (didn't bet)
Seat 6: mfy7uGZcqA2PVQqEVbJ7+g folded before Flop (didn't bet)



PokerStars Game #59941360276:  Hold'em No Limit ($1/$2) - 2009/07/01 1:33:12 ET
Table 'P/yCfYl1GfGsu/e6DxDy/A' 2-max Seat #1 is the button
Seat 1: 7fOCUy3x9hdkmXkkDNolGQ ($550.50 in chips)
Seat 2: RwDoM55ZeQuI2ADyJhOb2Q ($930.50 in chips)
7fOCUy3x9hdkmXkkDNolGQ: posts small blind $1
RwDoM55ZeQuI2ADyJhOb2Q: posts big blind $2
*** HOLE CARDS ***
7fOCUy3x9hdkmXkkDNolGQ: raises $4 to $6
RwDoM55ZeQuI2ADyJhOb2Q: raises $14 to $20
7fOCUy3x9hdkmXkkDNolGQ: calls $14
*** FLOP *** [As Ad 2c]
RwDoM55ZeQuI2ADyJhOb2Q: bets $22
7fOCUy3x9hdkmXkkDNolGQ: folds
RwDoM55ZeQuI2ADyJhOb2Q collected $39.50 from pot
RwDoM55ZeQuI2ADyJhOb2Q: doesn't show hand
*** SUMMARY ***
Total pot $40 | Rake $0.50
Board [As Ad 2c]
Seat 1: 7fOCUy3x9hdkmXkkDNolGQ (button) (small blind) folded on the Flop
Seat 2: RwDoM55ZeQuI2ADyJhOb2Q (big blind) collected ($39.50)



PokerStars Game #59941360786:  Hold'em No Limit ($1/$2) - 2009/07/01 1:33:13 ET
Table 'aSf77Sj8QEnzcc0WaxVD4Q' 6-max Seat #6 is the button
Seat 1: UELtvp+JfwI7XDGVwSxZXA ($295.10 in chips)
Seat 2: vkfxu8f/jMYKUk6Ly4eujw ($201.80 in chips)
Seat 3: 9dpyyjDTCed6nV7JhaUUpw ($520.70 in chips)
Seat 4: YsLQ3BAvgQHWXMAv3Wv6Hg ($200 in chips)
Seat 5: VvdR9F3I+2yELkfTVvC1dg ($237 in chips)
Seat 6: vkoJRf3gidxY1pPi0AFWww ($131.35 in chips)
UELtvp+JfwI7XDGVwSxZXA: posts small blind $1
vkfxu8f/jMYKUk6Ly4eujw: posts big blind $2
*** HOLE CARDS ***
9dpyyjDTCed6nV7JhaUUpw: folds
YsLQ3BAvgQHWXMAv3Wv6Hg: folds
VvdR9F3I+2yELkfTVvC1dg: raises $2 to $4
vkoJRf3gidxY1pPi0AFWww: folds
UELtvp+JfwI7XDGVwSxZXA: calls $3
vkfxu8f/jMYKUk6Ly4eujw: raises $15 to $19
VvdR9F3I+2yELkfTVvC1dg: folds
UELtvp+JfwI7XDGVwSxZXA: folds
vkfxu8f/jMYKUk6Ly4eujw collected $12 from pot
vkfxu8f/jMYKUk6Ly4eujw: doesn't show hand
*** SUMMARY ***
Total pot $12 | Rake $0
Seat 1: UELtvp+JfwI7XDGVwSxZXA (small blind) folded before Flop
Seat 2: vkfxu8f/jMYKUk6Ly4eujw (big blind) collected ($12)
Seat 3: 9dpyyjDTCed6nV7JhaUUpw folded before Flop (didn't bet)
Seat 4: YsLQ3BAvgQHWXMAv3Wv6Hg folded before Flop (didn't bet)
Seat 5: VvdR9F3I+2yELkfTVvC1dg folded before Flop
Seat 6: vkoJRf3gidxY1pPi0AFWww (button) folded before Flop (didn't bet)



PokerStars Game #59941360830:  Hold'em No Limit ($1/$2) - 2009/07/01 1:33:13 ET
Table '8Y6PEyoNuepZTai2Q56aHw' 9-max Seat #3 is the button
Seat 1: 5Q8U6iZbeO7xJSS4qvDP5g ($311.80 in chips)
Seat 2: gDCJIAlovbPnTvMM7Dd1gA ($191.15 in chips)
Seat 3: WUlHm+ydPPHG7Lb0rePSdA ($214.10 in chips)
Seat 4: xKkwALG38OfLQ9DXuJgR1w ($211.25 in chips)
Seat 5: /inIs/z/PcX+TniIFpaxpg ($40 in chips)
Seat 6: NtLDBSjsJQEKekh5cdinvw ($373.35 in chips)
Seat 7: Kzta8yu9vxHT4B70mjBZ+w ($200 in chips)
Seat 8: rW/MyplHylMSBRaoRUzWrg ($70 in chips)
Seat 9: F7m34OOfAQ7annesMHVjKw ($197 in chips)
xKkwALG38OfLQ9DXuJgR1w: posts small blind $1
/inIs/z/PcX+TniIFpaxpg: posts big blind $2
*** HOLE CARDS ***
NtLDBSjsJQEKekh5cdinvw: folds
Kzta8yu9vxHT4B70mjBZ+w: folds
rW/MyplHylMSBRaoRUzWrg: folds
F7m34OOfAQ7annesMHVjKw has timed out
F7m34OOfAQ7annesMHVjKw: folds
F7m34OOfAQ7annesMHVjKw is sitting out
5Q8U6iZbeO7xJSS4qvDP5g: folds
gDCJIAlovbPnTvMM7Dd1gA: folds
WUlHm+ydPPHG7Lb0rePSdA: folds
xKkwALG38OfLQ9DXuJgR1w: folds
/inIs/z/PcX+TniIFpaxpg collected $2 from pot
/inIs/z/PcX+TniIFpaxpg: doesn't show hand
*** SUMMARY ***
Total pot $2 | Rake $0
Seat 1: 5Q8U6iZbeO7xJSS4qvDP5g folded before Flop (didn't bet)
Seat 2: gDCJIAlovbPnTvMM7Dd1gA folded before Flop (didn't bet)
Seat 3: WUlHm+ydPPHG7Lb0rePSdA (button) folded before Flop (didn't bet)
Seat 4: xKkwALG38OfLQ9DXuJgR1w (small blind) folded before Flop
Seat 5: /inIs/z/PcX+TniIFpaxpg (big blind) collected ($2)
Seat 6: NtLDBSjsJQEKekh5cdinvw folded before Flop (didn't bet)
Seat 7: Kzta8yu9vxHT4B70mjBZ+w folded before Flop (didn't bet)
Seat 8: rW/MyplHylMSBRaoRUzWrg folded before Flop (didn't bet)
Seat 9: F7m34OOfAQ7annesMHVjKw folded before Flop (didn't bet)



PokerStars Game #59941361578:  Hold'em No Limit ($1/$2) - 2009/07/01 1:33:14 ET
Table 'pPQgcj9XT9CHBsbo1WTBug' 6-max Seat #6 is the button
Seat 1: DFVYDA6dKQy7R7mGIKogZA ($140.20 in chips)
Seat 2: qXDd0ZyMIse0OBu8pxeQ3Q ($200 in chips)
Seat 3: 54yWzRRgS0oZ+S6LwZBxMQ ($52.50 in chips)
Seat 4: gqlysXCbT8V54f/1lf9h3A ($70.75 in chips)
Seat 5: vkfxu8f/jMYKUk6Ly4eujw ($190.55 in chips)
Seat 6: Yr7pZltpy3IUNdKS9PCEiw ($315.80 in chips)
DFVYDA6dKQy7R7mGIKogZA: posts small blind $1
qXDd0ZyMIse0OBu8pxeQ3Q: posts big blind $2
*** HOLE CARDS ***
54yWzRRgS0oZ+S6LwZBxMQ: folds
gqlysXCbT8V54f/1lf9h3A: calls $2
vkfxu8f/jMYKUk6Ly4eujw: folds
Yr7pZltpy3IUNdKS9PCEiw: folds
DFVYDA6dKQy7R7mGIKogZA: calls $1
qXDd0ZyMIse0OBu8pxeQ3Q: checks
*** FLOP *** [Kc 9h Th]
DFVYDA6dKQy7R7mGIKogZA: checks
qXDd0ZyMIse0OBu8pxeQ3Q: checks
gqlysXCbT8V54f/1lf9h3A: bets $4
DFVYDA6dKQy7R7mGIKogZA: folds
qXDd0ZyMIse0OBu8pxeQ3Q: folds
gqlysXCbT8V54f/1lf9h3A collected $5.70 from pot
gqlysXCbT8V54f/1lf9h3A: doesn't show hand
*** SUMMARY ***
Total pot $6 | Rake $0.30
Board [Kc 9h Th]
Seat 1: DFVYDA6dKQy7R7mGIKogZA (small blind) folded on the Flop
Seat 2: qXDd0ZyMIse0OBu8pxeQ3Q (big blind) folded on the Flop
Seat 3: 54yWzRRgS0oZ+S6LwZBxMQ folded before Flop (didn't bet)
Seat 4: gqlysXCbT8V54f/1lf9h3A collected ($5.70)
Seat 5: vkfxu8f/jMYKUk6Ly4eujw folded before Flop (didn't bet)
Seat 6: Yr7pZltpy3IUNdKS9PCEiw (button) folded before Flop (didn't bet)



PokerStars Game #59941361968:  Hold'em No Limit ($1/$2) - 2009/07/01 1:33:15 ET
Table 'CFkQcfWjKccZaZDf71FK+w' 6-max Seat #4 is the button
Seat 2: ewN/vzF22+/gdzjIKBOlkA ($207.80 in chips)
Seat 3: 09BNF4quPDzanQzM8vc6WA ($46.65 in chips)
Seat 4: ygTTt5ehT4aF86q1a8/R+w ($214.25 in chips)
Seat 5: 2lOU1DcvUZaMcxZ95XfzXw ($152.80 in chips)
Seat 6: ORVqY3rf9X6ANA/8s+On2Q ($147.60 in chips)
2lOU1DcvUZaMcxZ95XfzXw: posts small blind $1
ORVqY3rf9X6ANA/8s+On2Q: posts big blind $2
vkfxu8f/jMYKUk6Ly4eujw: sits out
*** HOLE CARDS ***
ewN/vzF22+/gdzjIKBOlkA: folds
09BNF4quPDzanQzM8vc6WA: folds
ygTTt5ehT4aF86q1a8/R+w: folds
2lOU1DcvUZaMcxZ95XfzXw: calls $1
ORVqY3rf9X6ANA/8s+On2Q: checks
*** FLOP *** [9h Kc 4d]
2lOU1DcvUZaMcxZ95XfzXw: bets $2
ORVqY3rf9X6ANA/8s+On2Q: folds
2lOU1DcvUZaMcxZ95XfzXw collected $3.80 from pot
*** SUMMARY ***
Total pot $4 | Rake $0.20
Board [9h Kc 4d]
Seat 2: ewN/vzF22+/gdzjIKBOlkA folded before Flop (didn't bet)
Seat 3: 09BNF4quPDzanQzM8vc6WA folded before Flop (didn't bet)
Seat 4: ygTTt5ehT4aF86q1a8/R+w (button) folded before Flop (didn't bet)
Seat 5: 2lOU1DcvUZaMcxZ95XfzXw (small blind) collected ($3.80)
Seat 6: ORVqY3rf9X6ANA/8s+On2Q (big blind) folded on the Flop



PokerStars Game #59941362714:  Hold'em No Limit ($1/$2) - 2009/07/01 1:33:16 ET
Table 'mGpP9StWRnoeiBDExc6Frg' 6-max Seat #1 is the button
Seat 1: VvdR9F3I+2yELkfTVvC1dg ($309.05 in chips)
Seat 2: vkfxu8f/jMYKUk6Ly4eujw ($198 in chips)
Seat 3: 7acrZUQC3Zc9BNLjoKIcLQ ($27.15 in chips)
Seat 4: 4dcDwIHRm96PwtqkpQiuiA ($79.70 in chips)
Seat 5: d1puGuVBE0fidn+5eRJ0tw ($192.95 in chips)
Seat 6: B2Ih1sr5VZk+8He7rcrMtQ ($431.05 in chips)
vkfxu8f/jMYKUk6Ly4eujw: posts small blind $1
7acrZUQC3Zc9BNLjoKIcLQ: posts big blind $2
*** HOLE CARDS ***
4dcDwIHRm96PwtqkpQiuiA: folds
d1puGuVBE0fidn+5eRJ0tw: folds
B2Ih1sr5VZk+8He7rcrMtQ: folds
VvdR9F3I+2yELkfTVvC1dg: raises $2 to $4
vkfxu8f/jMYKUk6Ly4eujw: folds
7acrZUQC3Zc9BNLjoKIcLQ: calls $2
*** FLOP *** [4s Qc Qs]
7acrZUQC3Zc9BNLjoKIcLQ: checks
VvdR9F3I+2yELkfTVvC1dg: bets $6.40
7acrZUQC3Zc9BNLjoKIcLQ: folds
VvdR9F3I+2yELkfTVvC1dg collected $8.55 from pot
VvdR9F3I+2yELkfTVvC1dg: doesn't show hand
*** SUMMARY ***
Total pot $9 | Rake $0.45
Board [4s Qc Qs]
Seat 1: VvdR9F3I+2yELkfTVvC1dg (button) collected ($8.55)
Seat 2: vkfxu8f/jMYKUk6Ly4eujw (small blind) folded before Flop
Seat 3: 7acrZUQC3Zc9BNLjoKIcLQ (big blind) folded on the Flop
Seat 4: 4dcDwIHRm96PwtqkpQiuiA folded before Flop (didn't bet)
Seat 5: d1puGuVBE0fidn+5eRJ0tw folded before Flop (didn't bet)
Seat 6: B2Ih1sr5VZk+8He7rcrMtQ folded before Flop (didn't bet)



PokerStars Game #59941363278:  Hold'em No Limit ($1/$2) - 2009/07/01 1:33:17 ET
Table '3WCXyaiCAbqSShQu7FIjvA' 9-max Seat #2 is the button
Seat 1: kTCkABD1UUldS9DFRGfCwQ ($156.75 in chips)
Seat 2: TAfo4veNRaRlzDXMMYS3Jg ($37 in chips)
Seat 3: 5Q8U6iZbeO7xJSS4qvDP5g ($270.15 in chips)
Seat 4: waEF/+pxZTxNo4FvsORuXg ($82.40 in chips)
Seat 5: CkE3IyJF1KvdaAOmZY5XqQ ($203 in chips)
Seat 6: 5jQlngvMSqM/WoonOcR5kw ($245.35 in chips)
Seat 8: 1CtiZuXDFaJL1dJPQKyi8Q ($241.05 in chips)
Seat 9: FiXPLJyqb24l32QST2TInw ($144.40 in chips)
5Q8U6iZbeO7xJSS4qvDP5g: posts small blind $1
waEF/+pxZTxNo4FvsORuXg: posts big blind $2
nXDI8Y/S6POzRwANu3d8hQ: sits out
*** HOLE CARDS ***
CkE3IyJF1KvdaAOmZY5XqQ: folds
5jQlngvMSqM/WoonOcR5kw: folds
1CtiZuXDFaJL1dJPQKyi8Q: calls $2
FiXPLJyqb24l32QST2TInw: folds
kTCkABD1UUldS9DFRGfCwQ: folds
TAfo4veNRaRlzDXMMYS3Jg: folds
5Q8U6iZbeO7xJSS4qvDP5g: calls $1
waEF/+pxZTxNo4FvsORuXg: checks
*** FLOP *** [6d Qc Qs]
5Q8U6iZbeO7xJSS4qvDP5g: checks
waEF/+pxZTxNo4FvsORuXg: checks
1CtiZuXDFaJL1dJPQKyi8Q: checks
*** TURN *** [6d Qc Qs] [5h]
5Q8U6iZbeO7xJSS4qvDP5g: checks
waEF/+pxZTxNo4FvsORuXg: checks
1CtiZuXDFaJL1dJPQKyi8Q: checks
*** RIVER *** [6d Qc Qs 5h] [7d]
5Q8U6iZbeO7xJSS4qvDP5g: checks
waEF/+pxZTxNo4FvsORuXg: checks
1CtiZuXDFaJL1dJPQKyi8Q: checks
*** SHOW DOWN ***
5Q8U6iZbeO7xJSS4qvDP5g: shows [3h 3c] (two pair, Queens and Threes)
waEF/+pxZTxNo4FvsORuXg: mucks hand
1CtiZuXDFaJL1dJPQKyi8Q: mucks hand
5Q8U6iZbeO7xJSS4qvDP5g collected $5.70 from pot
*** SUMMARY ***
Total pot $6 | Rake $0.30
Board [6d Qc Qs 5h 7d]
Seat 1: kTCkABD1UUldS9DFRGfCwQ folded before Flop (didn't bet)
Seat 2: TAfo4veNRaRlzDXMMYS3Jg (button) folded before Flop (didn't bet)
Seat 3: 5Q8U6iZbeO7xJSS4qvDP5g (small blind) showed [3h 3c] and won ($5.70) with two pair, Queens and Threes
Seat 4: waEF/+pxZTxNo4FvsORuXg (big blind) mucked
Seat 5: CkE3IyJF1KvdaAOmZY5XqQ folded before Flop (didn't bet)
Seat 6: 5jQlngvMSqM/WoonOcR5kw folded before Flop (didn't bet)
Seat 8: 1CtiZuXDFaJL1dJPQKyi8Q mucked
Seat 9: FiXPLJyqb24l32QST2TInw folded before Flop (didn't bet)



PokerStars Game #59941363986:  Hold'em No Limit ($1/$2) - 2009/07/01 1:33:18 ET
Table 'eTkRjRjsYr567snmNk8kNQ' 2-max Seat #2 is the button
Seat 1: t6Jd836OSEMbcRi7rfGp5g ($202.50 in chips)
Seat 2: UNpnKQk0gkkyFJen8upqag ($293.50 in chips)
UNpnKQk0gkkyFJen8upqag: posts small blind $1
t6Jd836OSEMbcRi7rfGp5g: posts big blind $2
*** HOLE CARDS ***
UNpnKQk0gkkyFJen8upqag: folds
t6Jd836OSEMbcRi7rfGp5g collected $2 from pot
*** SUMMARY ***
Total pot $2 | Rake $0
Seat 1: t6Jd836OSEMbcRi7rfGp5g (big blind) collected ($2)
Seat 2: UNpnKQk0gkkyFJen8upqag (button) (small blind) folded before Flop



PokerStars Game #59941365194:  Hold'em No Limit ($1/$2) - 2009/07/01 1:33:21 ET
Table 'G1Oqdy4Pqdb5gtx40rUBzA' 6-max Seat #3 is the button
Seat 1: ubtx4Z5L+AcK71MTvYiGVw ($200 in chips)
Seat 2: 4uqU0dG67owXuPz303Al4w ($515.25 in chips)
Seat 3: VvdR9F3I+2yELkfTVvC1dg ($238.25 in chips)
Seat 4: B87ikIyZ/TzAVeXf38Ny0g ($215.55 in chips)
Seat 5: F1+Ml47qRQWunzPnGhLLzQ ($186.50 in chips)
Seat 6: qCnEYuAE5y5A7bk6fO5/jQ ($203 in chips)
B87ikIyZ/TzAVeXf38Ny0g: posts small blind $1
F1+Ml47qRQWunzPnGhLLzQ: posts big blind $2
*** HOLE CARDS ***
qCnEYuAE5y5A7bk6fO5/jQ: folds
ubtx4Z5L+AcK71MTvYiGVw: folds
4uqU0dG67owXuPz303Al4w: folds
VvdR9F3I+2yELkfTVvC1dg: folds
B87ikIyZ/TzAVeXf38Ny0g: folds
F1+Ml47qRQWunzPnGhLLzQ collected $2 from pot
F1+Ml47qRQWunzPnGhLLzQ: doesn't show hand
*** SUMMARY ***
Total pot $2 | Rake $0
Seat 1: ubtx4Z5L+AcK71MTvYiGVw folded before Flop (didn't bet)
Seat 2: 4uqU0dG67owXuPz303Al4w folded before Flop (didn't bet)
Seat 3: VvdR9F3I+2yELkfTVvC1dg (button) folded before Flop (didn't bet)
Seat 4: B87ikIyZ/TzAVeXf38Ny0g (small blind) folded before Flop
Seat 5: F1+Ml47qRQWunzPnGhLLzQ (big blind) collected ($2)
Seat 6: qCnEYuAE5y5A7bk6fO5/jQ folded before Flop (didn't bet)



PokerStars Game #59941367800:  Hold'em No Limit ($1/$2) - 2009/07/01 1:33:25 ET
Table 'NmY84NAf9Mh0ckAckHnh5g' 2-max Seat #1 is the button
Seat 1: 6hvg964TSqZ3AL/0XK9aVQ ($356.70 in chips)
Seat 2: RwDoM55ZeQuI2ADyJhOb2Q ($641.20 in chips)
6hvg964TSqZ3AL/0XK9aVQ: posts small blind $1
RwDoM55ZeQuI2ADyJhOb2Q: posts big blind $2
*** HOLE CARDS ***
6hvg964TSqZ3AL/0XK9aVQ: folds
RwDoM55ZeQuI2ADyJhOb2Q collected $2 from pot
RwDoM55ZeQuI2ADyJhOb2Q: doesn't show hand
*** SUMMARY ***
Total pot $2 | Rake $0
Seat 1: 6hvg964TSqZ3AL/0XK9aVQ (button) (small blind) folded before Flop
Seat 2: RwDoM55ZeQuI2ADyJhOb2Q (big blind) collected ($2)



PokerStars Game #59941368796:  Hold'em No Limit ($1/$2) - 2009/07/01 1:33:27 ET
Table 'YqGfR5eHfMeSjb9a+QU9rg' 9-max Seat #7 is the button
Seat 1: rW/MyplHylMSBRaoRUzWrg ($34 in chips)
Seat 2: W3Nqt1GWlTi9tXQXMNEvgw ($401.85 in chips)
Seat 3: /gll27k+xWYV7Fbki0lFDQ ($258.75 in chips)
Seat 4: GX1heJ+DSsvm7gzSPsYhhQ ($37 in chips)
Seat 5: CkE3IyJF1KvdaAOmZY5XqQ ($200 in chips)
Seat 6: TAfo4veNRaRlzDXMMYS3Jg ($37 in chips)
Seat 7: 41aZuLBz9nAi2GPVKabmCw ($100.95 in chips)
Seat 8: JnV3SM2D6dAFYyGZHHpvrg ($91.25 in chips)
Seat 9: /inIs/z/PcX+TniIFpaxpg ($205.20 in chips)
JnV3SM2D6dAFYyGZHHpvrg: posts small blind $1
/inIs/z/PcX+TniIFpaxpg: posts big blind $2
*** HOLE CARDS ***
rW/MyplHylMSBRaoRUzWrg: folds
W3Nqt1GWlTi9tXQXMNEvgw: folds
/gll27k+xWYV7Fbki0lFDQ: raises $4 to $6
GX1heJ+DSsvm7gzSPsYhhQ: folds
CkE3IyJF1KvdaAOmZY5XqQ: folds
TAfo4veNRaRlzDXMMYS3Jg: folds
41aZuLBz9nAi2GPVKabmCw: folds
JnV3SM2D6dAFYyGZHHpvrg: folds
/inIs/z/PcX+TniIFpaxpg: folds
/gll27k+xWYV7Fbki0lFDQ collected $5 from pot
*** SUMMARY ***
Total pot $5 | Rake $0
Seat 1: rW/MyplHylMSBRaoRUzWrg folded before Flop (didn't bet)
Seat 2: W3Nqt1GWlTi9tXQXMNEvgw folded before Flop (didn't bet)
Seat 3: /gll27k+xWYV7Fbki0lFDQ collected ($5)
Seat 4: GX1heJ+DSsvm7gzSPsYhhQ folded before Flop (didn't bet)
Seat 5: CkE3IyJF1KvdaAOmZY5XqQ folded before Flop (didn't bet)
Seat 6: TAfo4veNRaRlzDXMMYS3Jg folded before Flop (didn't bet)
Seat 7: 41aZuLBz9nAi2GPVKabmCw (button) folded before Flop (didn't bet)
Seat 8: JnV3SM2D6dAFYyGZHHpvrg (small blind) folded before Flop
Seat 9: /inIs/z/PcX+TniIFpaxpg (big blind) folded before Flop



PokerStars Game #59941369558:  Hold'em No Limit ($1/$2) - 2009/07/01 1:33:28 ET
Table 'eTkRjRjsYr567snmNk8kNQ' 2-max Seat #1 is the button
Seat 1: t6Jd836OSEMbcRi7rfGp5g ($203.50 in chips)
Seat 2: UNpnKQk0gkkyFJen8upqag ($292.50 in chips)
t6Jd836OSEMbcRi7rfGp5g: posts small blind $1
UNpnKQk0gkkyFJen8upqag: posts big blind $2
*** HOLE CARDS ***
t6Jd836OSEMbcRi7rfGp5g: raises $4 to $6
UNpnKQk0gkkyFJen8upqag: folds
t6Jd836OSEMbcRi7rfGp5g collected $4 from pot
*** SUMMARY ***
Total pot $4 | Rake $0
Seat 1: t6Jd836OSEMbcRi7rfGp5g (button) (small blind) collected ($4)
Seat 2: UNpnKQk0gkkyFJen8upqag (big blind) folded before Flop



PokerStars Game #59941369676:  Hold'em No Limit ($1/$2) - 2009/07/01 1:33:29 ET
Table 'P/yCfYl1GfGsu/e6DxDy/A' 2-max Seat #2 is the button
Seat 1: 7fOCUy3x9hdkmXkkDNolGQ ($530.50 in chips)
Seat 2: RwDoM55ZeQuI2ADyJhOb2Q ($950 in chips)
RwDoM55ZeQuI2ADyJhOb2Q: posts small blind $1
7fOCUy3x9hdkmXkkDNolGQ: posts big blind $2
*** HOLE CARDS ***
RwDoM55ZeQuI2ADyJhOb2Q: folds
7fOCUy3x9hdkmXkkDNolGQ collected $2 from pot
7fOCUy3x9hdkmXkkDNolGQ: doesn't show hand
*** SUMMARY ***
Total pot $2 | Rake $0
Seat 1: 7fOCUy3x9hdkmXkkDNolGQ (big blind) collected ($2)
Seat 2: RwDoM55ZeQuI2ADyJhOb2Q (button) (small blind) folded before Flop



PokerStars Game #59941369736:  Hold'em No Limit ($1/$2) - 2009/07/01 1:33:29 ET
Table 'qVXak+oTeDXMGbWa4sDU5Q' 9-max Seat #5 is the button
Seat 1: H6Z4+qu8gR0VUiPOijndVg ($205.55 in chips)
Seat 2: rW/MyplHylMSBRaoRUzWrg ($81 in chips)
Seat 3: WUlHm+ydPPHG7Lb0rePSdA ($150.65 in chips)
Seat 4: lQYT23h5QCUVZAKxjOO39Q ($200.70 in chips)
Seat 5: FWGiDqRwvLeKmHq9t4Jy9w ($265.80 in chips)
Seat 6: GX1heJ+DSsvm7gzSPsYhhQ ($41 in chips)
Seat 7: PfmlvZlFiss79a6IoEr11g ($163.30 in chips)
Seat 8: Z0rzUi0y1x80UdIpofoNbA ($125.55 in chips)
Seat 9: CkE3IyJF1KvdaAOmZY5XqQ ($200 in chips)
GX1heJ+DSsvm7gzSPsYhhQ: posts small blind $1
PfmlvZlFiss79a6IoEr11g: posts big blind $2
*** HOLE CARDS ***
Z0rzUi0y1x80UdIpofoNbA: folds
CkE3IyJF1KvdaAOmZY5XqQ: raises $6 to $8
H6Z4+qu8gR0VUiPOijndVg: folds
rW/MyplHylMSBRaoRUzWrg: folds
WUlHm+ydPPHG7Lb0rePSdA: raises $16 to $24
lQYT23h5QCUVZAKxjOO39Q: folds
FWGiDqRwvLeKmHq9t4Jy9w: folds
GX1heJ+DSsvm7gzSPsYhhQ: folds
PfmlvZlFiss79a6IoEr11g: folds
CkE3IyJF1KvdaAOmZY5XqQ: calls $16
*** FLOP *** [Td 5h 3d]
CkE3IyJF1KvdaAOmZY5XqQ: checks
WUlHm+ydPPHG7Lb0rePSdA: bets $32
CkE3IyJF1KvdaAOmZY5XqQ: folds
WUlHm+ydPPHG7Lb0rePSdA collected $48.45 from pot
WUlHm+ydPPHG7Lb0rePSdA: doesn't show hand
*** SUMMARY ***
Total pot $51 | Rake $2.55
Board [Td 5h 3d]
Seat 1: H6Z4+qu8gR0VUiPOijndVg folded before Flop (didn't bet)
Seat 2: rW/MyplHylMSBRaoRUzWrg folded before Flop (didn't bet)
Seat 3: WUlHm+ydPPHG7Lb0rePSdA collected ($48.45)
Seat 4: lQYT23h5QCUVZAKxjOO39Q folded before Flop (didn't bet)
Seat 5: FWGiDqRwvLeKmHq9t4Jy9w (button) folded before Flop (didn't bet)
Seat 6: GX1heJ+DSsvm7gzSPsYhhQ (small blind) folded before Flop
Seat 7: PfmlvZlFiss79a6IoEr11g (big blind) folded before Flop
Seat 8: Z0rzUi0y1x80UdIpofoNbA folded before Flop (didn't bet)
Seat 9: CkE3IyJF1KvdaAOmZY5XqQ folded on the Flop



PokerStars Game #59941370246:  Hold'em No Limit ($1/$2) - 2009/07/01 1:33:29 ET
Table 'kq5zaQ+1hLNf8LZfGnbTAA' 6-max Seat #2 is the button
Seat 1: 8srN1dKQePlsv0GyTada+Q ($437.60 in chips)
Seat 2: nXDI8Y/S6POzRwANu3d8hQ ($164 in chips)
Seat 3: /PH6Ffnho4Ysm8S3V/oa+w ($40 in chips)
Seat 4: 3dAbvkxS5NPQTBAbvpinVg ($281.45 in chips)
Seat 5: gnYme0DNFflnMhrdbxe1Ag ($200 in chips)
Seat 6: mfy7uGZcqA2PVQqEVbJ7+g ($191.25 in chips)
/PH6Ffnho4Ysm8S3V/oa+w: posts small blind $1
3dAbvkxS5NPQTBAbvpinVg: posts big blind $2
*** HOLE CARDS ***
gnYme0DNFflnMhrdbxe1Ag: folds
mfy7uGZcqA2PVQqEVbJ7+g: folds
8srN1dKQePlsv0GyTada+Q: raises $4 to $6
nXDI8Y/S6POzRwANu3d8hQ: folds
/PH6Ffnho4Ysm8S3V/oa+w: folds
3dAbvkxS5NPQTBAbvpinVg: folds
8srN1dKQePlsv0GyTada+Q collected $5 from pot
8srN1dKQePlsv0GyTada+Q: doesn't show hand
*** SUMMARY ***
Total pot $5 | Rake $0
Seat 1: 8srN1dKQePlsv0GyTada+Q collected ($5)
Seat 2: nXDI8Y/S6POzRwANu3d8hQ (button) folded before Flop (didn't bet)
Seat 3: /PH6Ffnho4Ysm8S3V/oa+w (small blind) folded before Flop
Seat 4: 3dAbvkxS5NPQTBAbvpinVg (big blind) folded before Flop
Seat 5: gnYme0DNFflnMhrdbxe1Ag folded before Flop (didn't bet)
Seat 6: mfy7uGZcqA2PVQqEVbJ7+g folded before Flop (didn't bet)



PokerStars Game #59941370684:  Hold'em No Limit ($1/$2) - 2009/07/01 1:33:30 ET
Table 'gnHBqWll9O3fxG7Ojkz/ng' 9-max Seat #9 is the button
Seat 1: TAfo4veNRaRlzDXMMYS3Jg ($32 in chips)
Seat 2: H6Z4+qu8gR0VUiPOijndVg ($327.25 in chips)
Seat 3: 5Q8U6iZbeO7xJSS4qvDP5g ($211 in chips)
Seat 4: nXDI8Y/S6POzRwANu3d8hQ ($39 in chips)
Seat 5: rBQDMkKm9cZn6M9NPsiVew ($227.15 in chips)
Seat 7: jqui3xAWCkcdPW36a6BD+w ($347.55 in chips)
Seat 8: cM6efHzdxoqYm0EQKP4TTQ ($92.15 in chips)
Seat 9: GX1heJ+DSsvm7gzSPsYhhQ ($50.35 in chips)
TAfo4veNRaRlzDXMMYS3Jg: posts small blind $1
H6Z4+qu8gR0VUiPOijndVg: posts big blind $2
MeleaB: sits out
*** HOLE CARDS ***
5Q8U6iZbeO7xJSS4qvDP5g: raises $6 to $8
nXDI8Y/S6POzRwANu3d8hQ: folds
rBQDMkKm9cZn6M9NPsiVew: folds
jqui3xAWCkcdPW36a6BD+w: folds
cM6efHzdxoqYm0EQKP4TTQ: calls $8
GX1heJ+DSsvm7gzSPsYhhQ: folds
TAfo4veNRaRlzDXMMYS3Jg: folds
H6Z4+qu8gR0VUiPOijndVg: folds
*** FLOP *** [Qc As 9d]
5Q8U6iZbeO7xJSS4qvDP5g: bets $13
cM6efHzdxoqYm0EQKP4TTQ: folds
5Q8U6iZbeO7xJSS4qvDP5g collected $18.05 from pot
5Q8U6iZbeO7xJSS4qvDP5g: doesn't show hand
*** SUMMARY ***
Total pot $19 | Rake $0.95
Board [Qc As 9d]
Seat 1: TAfo4veNRaRlzDXMMYS3Jg (small blind) folded before Flop
Seat 2: H6Z4+qu8gR0VUiPOijndVg (big blind) folded before Flop
Seat 3: 5Q8U6iZbeO7xJSS4qvDP5g collected ($18.05)
Seat 4: nXDI8Y/S6POzRwANu3d8hQ folded before Flop (didn't bet)
Seat 5: rBQDMkKm9cZn6M9NPsiVew folded before Flop (didn't bet)
Seat 7: jqui3xAWCkcdPW36a6BD+w folded before Flop (didn't bet)
Seat 8: cM6efHzdxoqYm0EQKP4TTQ folded on the Flop
Seat 9: GX1heJ+DSsvm7gzSPsYhhQ (button) folded before Flop (didn't bet)



PokerStars Game #59941371150:  Hold'em No Limit ($1/$2) - 2009/07/01 1:33:31 ET
Table 'LL4bDFyhj5hsMpzaDugJZg' 6-max Seat #1 is the button
Seat 1: FwvID/fQGlpY3soi/lMTww ($85.05 in chips)
Seat 2: IZng3w8jiJHHp3LbYKLi4w ($44.15 in chips)
Seat 3: iI/NMpRxMkGieArQEhACSA ($561.90 in chips)
Seat 4: 8srN1dKQePlsv0GyTada+Q ($215.40 in chips)
Seat 5: A2GTwTiwkb1ilNWgW487Vg ($130.50 in chips)
Seat 6: 692Q4sfB0gTElzS0WMeg+A ($200 in chips)
IZng3w8jiJHHp3LbYKLi4w: posts small blind $1
iI/NMpRxMkGieArQEhACSA: posts big blind $2
*** HOLE CARDS ***
8srN1dKQePlsv0GyTada+Q: folds
A2GTwTiwkb1ilNWgW487Vg: calls $2
692Q4sfB0gTElzS0WMeg+A: folds
FwvID/fQGlpY3soi/lMTww: folds
IZng3w8jiJHHp3LbYKLi4w: calls $1
iI/NMpRxMkGieArQEhACSA: raises $12 to $14
A2GTwTiwkb1ilNWgW487Vg: folds
IZng3w8jiJHHp3LbYKLi4w: folds
iI/NMpRxMkGieArQEhACSA collected $6 from pot
*** SUMMARY ***
Total pot $6 | Rake $0
Seat 1: FwvID/fQGlpY3soi/lMTww (button) folded before Flop (didn't bet)
Seat 2: IZng3w8jiJHHp3LbYKLi4w (small blind) folded before Flop
Seat 3: iI/NMpRxMkGieArQEhACSA (big blind) collected ($6)
Seat 4: 8srN1dKQePlsv0GyTada+Q folded before Flop (didn't bet)
Seat 5: A2GTwTiwkb1ilNWgW487Vg folded before Flop
Seat 6: 692Q4sfB0gTElzS0WMeg+A folded before Flop (didn't bet)



PokerStars Game #59941371544:  Hold'em No Limit ($1/$2) - 2009/07/01 1:33:32 ET
Table 'NmY84NAf9Mh0ckAckHnh5g' 2-max Seat #2 is the button
Seat 1: 6hvg964TSqZ3AL/0XK9aVQ ($355.70 in chips)
Seat 2: RwDoM55ZeQuI2ADyJhOb2Q ($642.20 in chips)
RwDoM55ZeQuI2ADyJhOb2Q: posts small blind $1
6hvg964TSqZ3AL/0XK9aVQ: posts big blind $2
*** HOLE CARDS ***
RwDoM55ZeQuI2ADyJhOb2Q: folds
6hvg964TSqZ3AL/0XK9aVQ collected $2 from pot
6hvg964TSqZ3AL/0XK9aVQ: doesn't show hand
*** SUMMARY ***
Total pot $2 | Rake $0
Seat 1: 6hvg964TSqZ3AL/0XK9aVQ (big blind) collected ($2)
Seat 2: RwDoM55ZeQuI2ADyJhOb2Q (button) (small blind) folded before Flop



PokerStars Game #59941372022:  Hold'em No Limit ($1/$2) - 2009/07/01 1:33:33 ET
Table 'G1Oqdy4Pqdb5gtx40rUBzA' 6-max Seat #4 is the button
Seat 1: ubtx4Z5L+AcK71MTvYiGVw ($200 in chips)
Seat 2: 4uqU0dG67owXuPz303Al4w ($515.25 in chips)
Seat 3: VvdR9F3I+2yELkfTVvC1dg ($238.25 in chips)
Seat 4: B87ikIyZ/TzAVeXf38Ny0g ($214.55 in chips)
Seat 5: F1+Ml47qRQWunzPnGhLLzQ ($187.50 in chips)
Seat 6: qCnEYuAE5y5A7bk6fO5/jQ ($203 in chips)
F1+Ml47qRQWunzPnGhLLzQ: posts small blind $1
qCnEYuAE5y5A7bk6fO5/jQ: posts big blind $2
*** HOLE CARDS ***
ubtx4Z5L+AcK71MTvYiGVw: folds
4uqU0dG67owXuPz303Al4w: folds
VvdR9F3I+2yELkfTVvC1dg: raises $2 to $4
B87ikIyZ/TzAVeXf38Ny0g: folds
F1+Ml47qRQWunzPnGhLLzQ: folds
qCnEYuAE5y5A7bk6fO5/jQ: folds
VvdR9F3I+2yELkfTVvC1dg collected $5 from pot
VvdR9F3I+2yELkfTVvC1dg: doesn't show hand
*** SUMMARY ***
Total pot $5 | Rake $0
Seat 1: ubtx4Z5L+AcK71MTvYiGVw folded before Flop (didn't bet)
Seat 2: 4uqU0dG67owXuPz303Al4w folded before Flop (didn't bet)
Seat 3: VvdR9F3I+2yELkfTVvC1dg collected ($5)
Seat 4: B87ikIyZ/TzAVeXf38Ny0g (button) folded before Flop (didn't bet)
Seat 5: F1+Ml47qRQWunzPnGhLLzQ (small blind) folded before Flop
Seat 6: qCnEYuAE5y5A7bk6fO5/jQ (big blind) folded before Flop



PokerStars Game #59941372702:  Hold'em No Limit ($1/$2) - 2009/07/01 1:33:34 ET
Table 'aSf77Sj8QEnzcc0WaxVD4Q' 6-max Seat #1 is the button
Seat 1: UELtvp+JfwI7XDGVwSxZXA ($291.10 in chips)
Seat 2: vkfxu8f/jMYKUk6Ly4eujw ($209.80 in chips)
Seat 3: 9dpyyjDTCed6nV7JhaUUpw ($520.70 in chips)
Seat 4: YsLQ3BAvgQHWXMAv3Wv6Hg ($200 in chips)
Seat 5: VvdR9F3I+2yELkfTVvC1dg ($233 in chips)
Seat 6: vkoJRf3gidxY1pPi0AFWww ($131.35 in chips)
vkfxu8f/jMYKUk6Ly4eujw: posts small blind $1
9dpyyjDTCed6nV7JhaUUpw: posts big blind $2
*** HOLE CARDS ***
YsLQ3BAvgQHWXMAv3Wv6Hg: folds
VvdR9F3I+2yELkfTVvC1dg: raises $2 to $4
vkoJRf3gidxY1pPi0AFWww: folds
UELtvp+JfwI7XDGVwSxZXA: folds
vkfxu8f/jMYKUk6Ly4eujw: folds
9dpyyjDTCed6nV7JhaUUpw: calls $2
*** FLOP *** [Td Kc 6s]
9dpyyjDTCed6nV7JhaUUpw: checks
VvdR9F3I+2yELkfTVvC1dg: bets $6.40
9dpyyjDTCed6nV7JhaUUpw: raises $19.60 to $26
VvdR9F3I+2yELkfTVvC1dg: raises $38.60 to $64.60
9dpyyjDTCed6nV7JhaUUpw: folds
VvdR9F3I+2yELkfTVvC1dg collected $58 from pot
VvdR9F3I+2yELkfTVvC1dg: doesn't show hand
*** SUMMARY ***
Total pot $61 | Rake $3
Board [Td Kc 6s]
Seat 1: UELtvp+JfwI7XDGVwSxZXA (button) folded before Flop (didn't bet)
Seat 2: vkfxu8f/jMYKUk6Ly4eujw (small blind) folded before Flop
Seat 3: 9dpyyjDTCed6nV7JhaUUpw (big blind) folded on the Flop
Seat 4: YsLQ3BAvgQHWXMAv3Wv6Hg folded before Flop (didn't bet)
Seat 5: VvdR9F3I+2yELkfTVvC1dg collected ($58)
Seat 6: vkoJRf3gidxY1pPi0AFWww folded before Flop (didn't bet)



PokerStars Game #59941373474:  Hold'em No Limit ($1/$2) - 2009/07/01 1:33:35 ET
Table 'on4i1U1lCRmxsduFD3xiSg' 9-max Seat #7 is the button
Seat 1: so5k3vFDmokh2q3dImJ1GQ ($179.30 in chips)
Seat 2: NqSvZNzJ4RkR3sCmgQnyLw ($47.85 in chips)
Seat 3: GX1heJ+DSsvm7gzSPsYhhQ ($29.70 in chips)
Seat 4: DFQVuszLVclqjA46pN4Vvw ($114 in chips)
Seat 5: 37j/5DgMG5m9lMfFofEAOg ($57.70 in chips)
Seat 6: +T/63sAeZzWyHchahJ36GQ ($37 in chips)
Seat 7: /inIs/z/PcX+TniIFpaxpg ($271.05 in chips)
Seat 8: ZYHoLw2lWmRS7CSHi8L8Xg ($200 in chips)
Seat 9: TAfo4veNRaRlzDXMMYS3Jg ($40 in chips)
ZYHoLw2lWmRS7CSHi8L8Xg: posts small blind $1
TAfo4veNRaRlzDXMMYS3Jg: posts big blind $2
*** HOLE CARDS ***
so5k3vFDmokh2q3dImJ1GQ: folds
NqSvZNzJ4RkR3sCmgQnyLw: folds
GX1heJ+DSsvm7gzSPsYhhQ: folds
DFQVuszLVclqjA46pN4Vvw: raises $6 to $8
37j/5DgMG5m9lMfFofEAOg: folds
+T/63sAeZzWyHchahJ36GQ: folds
/inIs/z/PcX+TniIFpaxpg: folds
ZYHoLw2lWmRS7CSHi8L8Xg: folds
TAfo4veNRaRlzDXMMYS3Jg: folds
37j/5DgMG5m9lMfFofEAOg is sitting out
DFQVuszLVclqjA46pN4Vvw collected $5 from pot
*** SUMMARY ***
Total pot $5 | Rake $0
Seat 1: so5k3vFDmokh2q3dImJ1GQ folded before Flop (didn't bet)
Seat 2: NqSvZNzJ4RkR3sCmgQnyLw folded before Flop (didn't bet)
Seat 3: GX1heJ+DSsvm7gzSPsYhhQ folded before Flop (didn't bet)
Seat 4: DFQVuszLVclqjA46pN4Vvw collected ($5)
Seat 5: 37j/5DgMG5m9lMfFofEAOg folded before Flop (didn't bet)
Seat 6: +T/63sAeZzWyHchahJ36GQ folded before Flop (didn't bet)
Seat 7: /inIs/z/PcX+TniIFpaxpg (button) folded before Flop (didn't bet)
Seat 8: ZYHoLw2lWmRS7CSHi8L8Xg (small blind) folded before Flop
Seat 9: TAfo4veNRaRlzDXMMYS3Jg (big blind) folded before Flop



PokerStars Game #59941373940:  Hold'em No Limit ($1/$2) - 2009/07/01 1:33:36 ET
Table 'rKeCh+eBn4RNvybCUYkoTQ' 9-max Seat #9 is the button
Seat 1: /inIs/z/PcX+TniIFpaxpg ($199 in chips)
Seat 2: 9cBHwK40Tl06vheE7B3LHQ ($129.80 in chips)
Seat 3: GX1heJ+DSsvm7gzSPsYhhQ ($40 in chips)
Seat 5: WUlHm+ydPPHG7Lb0rePSdA ($125 in chips)
Seat 6: EBV6OktyeSmh4w6sWmcWOw ($267 in chips)
Seat 7: rW/MyplHylMSBRaoRUzWrg ($31 in chips)
Seat 8: pN/Ip0ePsUVIdUlGgLrkUw ($246.35 in chips)
Seat 9: Kzta8yu9vxHT4B70mjBZ+w ($208.25 in chips)
/inIs/z/PcX+TniIFpaxpg: posts small blind $1
9cBHwK40Tl06vheE7B3LHQ: posts big blind $2
*** HOLE CARDS ***
GX1heJ+DSsvm7gzSPsYhhQ: raises $4 to $6
WUlHm+ydPPHG7Lb0rePSdA: folds
EBV6OktyeSmh4w6sWmcWOw: folds
rW/MyplHylMSBRaoRUzWrg: folds
pN/Ip0ePsUVIdUlGgLrkUw: folds
Kzta8yu9vxHT4B70mjBZ+w: folds
/inIs/z/PcX+TniIFpaxpg: folds
9cBHwK40Tl06vheE7B3LHQ: folds
GX1heJ+DSsvm7gzSPsYhhQ collected $5 from pot
GX1heJ+DSsvm7gzSPsYhhQ: doesn't show hand
*** SUMMARY ***
Total pot $5 | Rake $0
Seat 1: /inIs/z/PcX+TniIFpaxpg (small blind) folded before Flop
Seat 2: 9cBHwK40Tl06vheE7B3LHQ (big blind) folded before Flop
Seat 3: GX1heJ+DSsvm7gzSPsYhhQ collected ($5)
Seat 5: WUlHm+ydPPHG7Lb0rePSdA folded before Flop (didn't bet)
Seat 6: EBV6OktyeSmh4w6sWmcWOw folded before Flop (didn't bet)
Seat 7: rW/MyplHylMSBRaoRUzWrg folded before Flop (didn't bet)
Seat 8: pN/Ip0ePsUVIdUlGgLrkUw folded before Flop (didn't bet)
Seat 9: Kzta8yu9vxHT4B70mjBZ+w (button) folded before Flop (didn't bet)



PokerStars Game #59941374934:  Hold'em No Limit ($1/$2) - 2009/07/01 1:33:38 ET
Table 'ztv6V3FN2bQ9nmJPPdx6nQ' 6-max Seat #6 is the button
Seat 1: 6fLdOUCRtX71xbVRhJEq8w ($242.35 in chips)
Seat 2: 5Y+ZGWLI4gnlpApDX5vy1A ($386.75 in chips)
Seat 3: ubtx4Z5L+AcK71MTvYiGVw ($245 in chips)
Seat 5: sTPOWERd9HWPCNrDBwsVjA ($222.80 in chips)
Seat 6: mfy7uGZcqA2PVQqEVbJ7+g ($97.45 in chips)
6fLdOUCRtX71xbVRhJEq8w: posts small blind $1
5Y+ZGWLI4gnlpApDX5vy1A: posts big blind $2
*** HOLE CARDS ***
ubtx4Z5L+AcK71MTvYiGVw: folds
sTPOWERd9HWPCNrDBwsVjA: folds
mfy7uGZcqA2PVQqEVbJ7+g: folds
6fLdOUCRtX71xbVRhJEq8w: folds
5Y+ZGWLI4gnlpApDX5vy1A collected $2 from pot
5Y+ZGWLI4gnlpApDX5vy1A: doesn't show hand
*** SUMMARY ***
Total pot $2 | Rake $0
Seat 1: 6fLdOUCRtX71xbVRhJEq8w (small blind) folded before Flop
Seat 2: 5Y+ZGWLI4gnlpApDX5vy1A (big blind) collected ($2)
Seat 3: ubtx4Z5L+AcK71MTvYiGVw folded before Flop (didn't bet)
Seat 5: sTPOWERd9HWPCNrDBwsVjA folded before Flop (didn't bet)
Seat 6: mfy7uGZcqA2PVQqEVbJ7+g (button) folded before Flop (didn't bet)



PokerStars Game #59941377266:  Hold'em No Limit ($1/$2) - 2009/07/01 1:33:42 ET
Table '/ci73fTmzTzmGWzAtqEX2Q' 9-max Seat #4 is the button
Seat 1: 9efVc1cB3yHt4TvBkTusPw ($149.90 in chips)
Seat 2: pN/Ip0ePsUVIdUlGgLrkUw ($225 in chips)
Seat 3: kK1+5ivyJZeA8hQF2pdvvQ ($64.55 in chips)
Seat 4: 2yq7Zp4xmrhAw8+37hTkaA ($166.20 in chips)
Seat 5: 1CtiZuXDFaJL1dJPQKyi8Q ($213 in chips)
Seat 6: GX1heJ+DSsvm7gzSPsYhhQ ($47.65 in chips)
Seat 7: rW/MyplHylMSBRaoRUzWrg ($57.15 in chips)
Seat 8: /inIs/z/PcX+TniIFpaxpg ($37 in chips)
Seat 9: S8aS+9FTYQ/ICLBNThcrkg ($183 in chips)
1CtiZuXDFaJL1dJPQKyi8Q: posts small blind $1
GX1heJ+DSsvm7gzSPsYhhQ: posts big blind $2
*** HOLE CARDS ***
rW/MyplHylMSBRaoRUzWrg: folds
/inIs/z/PcX+TniIFpaxpg: folds
S8aS+9FTYQ/ICLBNThcrkg: folds
9efVc1cB3yHt4TvBkTusPw: folds
pN/Ip0ePsUVIdUlGgLrkUw: folds
kK1+5ivyJZeA8hQF2pdvvQ: folds
2yq7Zp4xmrhAw8+37hTkaA: folds
1CtiZuXDFaJL1dJPQKyi8Q: raises $4 to $6
GX1heJ+DSsvm7gzSPsYhhQ: folds
1CtiZuXDFaJL1dJPQKyi8Q collected $4 from pot
*** SUMMARY ***
Total pot $4 | Rake $0
Seat 1: 9efVc1cB3yHt4TvBkTusPw folded before Flop (didn't bet)
Seat 2: pN/Ip0ePsUVIdUlGgLrkUw folded before Flop (didn't bet)
Seat 3: kK1+5ivyJZeA8hQF2pdvvQ folded before Flop (didn't bet)
Seat 4: 2yq7Zp4xmrhAw8+37hTkaA (button) folded before Flop (didn't bet)
Seat 5: 1CtiZuXDFaJL1dJPQKyi8Q (small blind) collected ($4)
Seat 6: GX1heJ+DSsvm7gzSPsYhhQ (big blind) folded before Flop
Seat 7: rW/MyplHylMSBRaoRUzWrg folded before Flop (didn't bet)
Seat 8: /inIs/z/PcX+TniIFpaxpg folded before Flop (didn't bet)
Seat 9: S8aS+9FTYQ/ICLBNThcrkg folded before Flop (didn't bet)



PokerStars Game #59941378140:  Hold'em No Limit ($1/$2) - 2009/07/01 1:33:43 ET
Table 'CFkQcfWjKccZaZDf71FK+w' 6-max Seat #5 is the button
Seat 1: vkfxu8f/jMYKUk6Ly4eujw ($200 in chips)
Seat 2: ewN/vzF22+/gdzjIKBOlkA ($207.80 in chips)
Seat 3: 09BNF4quPDzanQzM8vc6WA ($46.65 in chips)
Seat 4: ygTTt5ehT4aF86q1a8/R+w ($214.25 in chips)
Seat 5: 2lOU1DcvUZaMcxZ95XfzXw ($154.60 in chips)
Seat 6: ORVqY3rf9X6ANA/8s+On2Q ($145.60 in chips)
ORVqY3rf9X6ANA/8s+On2Q: posts small blind $1
vkfxu8f/jMYKUk6Ly4eujw: posts big blind $2
*** HOLE CARDS ***
ewN/vzF22+/gdzjIKBOlkA: folds
09BNF4quPDzanQzM8vc6WA: folds
ygTTt5ehT4aF86q1a8/R+w: raises $4 to $6
2lOU1DcvUZaMcxZ95XfzXw: folds
ORVqY3rf9X6ANA/8s+On2Q: folds
vkfxu8f/jMYKUk6Ly4eujw: folds
ygTTt5ehT4aF86q1a8/R+w collected $5 from pot
*** SUMMARY ***
Total pot $5 | Rake $0
Seat 1: vkfxu8f/jMYKUk6Ly4eujw (big blind) folded before Flop
Seat 2: ewN/vzF22+/gdzjIKBOlkA folded before Flop (didn't bet)
Seat 3: 09BNF4quPDzanQzM8vc6WA folded before Flop (didn't bet)
Seat 4: ygTTt5ehT4aF86q1a8/R+w collected ($5)
Seat 5: 2lOU1DcvUZaMcxZ95XfzXw (button) folded before Flop (didn't bet)
Seat 6: ORVqY3rf9X6ANA/8s+On2Q (small blind) folded before Flop



PokerStars Game #59941377832:  Hold'em No Limit ($1/$2) - 2009/07/01 1:33:43 ET
Table 'eyAQSIlgc2o1Jxvbve4WGg' 9-max Seat #1 is the button
Seat 1: UZEsV9yKUMqmpYPiOFpaZw ($100.20 in chips)
Seat 2: kM9CA+2UcdMjbCMbtUCGiA ($200 in chips)
Seat 4: CkE3IyJF1KvdaAOmZY5XqQ ($200 in chips)
Seat 5: mIKx5lhIt13X5eZQH0ZeMA ($123.15 in chips)
Seat 6: nXDI8Y/S6POzRwANu3d8hQ ($6 in chips)
Seat 7: u3OrI5uGx9mx1fE7dgr+EA ($75.20 in chips)
Seat 8: 1CtiZuXDFaJL1dJPQKyi8Q ($161.95 in chips)
Seat 9: WUlHm+ydPPHG7Lb0rePSdA ($125.95 in chips)
kM9CA+2UcdMjbCMbtUCGiA: posts small blind $1
CkE3IyJF1KvdaAOmZY5XqQ: posts big blind $2
*** HOLE CARDS ***
mIKx5lhIt13X5eZQH0ZeMA: raises $2 to $4
nXDI8Y/S6POzRwANu3d8hQ: folds
u3OrI5uGx9mx1fE7dgr+EA: folds
1CtiZuXDFaJL1dJPQKyi8Q: folds
WUlHm+ydPPHG7Lb0rePSdA: folds
UZEsV9yKUMqmpYPiOFpaZw: folds
kM9CA+2UcdMjbCMbtUCGiA: folds
CkE3IyJF1KvdaAOmZY5XqQ: folds
mIKx5lhIt13X5eZQH0ZeMA collected $5 from pot
mIKx5lhIt13X5eZQH0ZeMA: doesn't show hand
*** SUMMARY ***
Total pot $5 | Rake $0
Seat 1: UZEsV9yKUMqmpYPiOFpaZw (button) folded before Flop (didn't bet)
Seat 2: kM9CA+2UcdMjbCMbtUCGiA (small blind) folded before Flop
Seat 4: CkE3IyJF1KvdaAOmZY5XqQ (big blind) folded before Flop
Seat 5: mIKx5lhIt13X5eZQH0ZeMA collected ($5)
Seat 6: nXDI8Y/S6POzRwANu3d8hQ folded before Flop (didn't bet)
Seat 7: u3OrI5uGx9mx1fE7dgr+EA folded before Flop (didn't bet)
Seat 8: 1CtiZuXDFaJL1dJPQKyi8Q folded before Flop (didn't bet)
Seat 9: WUlHm+ydPPHG7Lb0rePSdA folded before Flop (didn't bet)



PokerStars Game #59941377804:  Hold'em No Limit ($1/$2) - 2009/07/01 1:33:43 ET
Table 'P/yCfYl1GfGsu/e6DxDy/A' 2-max Seat #1 is the button
Seat 1: 7fOCUy3x9hdkmXkkDNolGQ ($531.50 in chips)
Seat 2: RwDoM55ZeQuI2ADyJhOb2Q ($949 in chips)
7fOCUy3x9hdkmXkkDNolGQ: posts small blind $1
RwDoM55ZeQuI2ADyJhOb2Q: posts big blind $2
*** HOLE CARDS ***
7fOCUy3x9hdkmXkkDNolGQ: folds
RwDoM55ZeQuI2ADyJhOb2Q collected $2 from pot
RwDoM55ZeQuI2ADyJhOb2Q: doesn't show hand
*** SUMMARY ***
Total pot $2 | Rake $0
Seat 1: 7fOCUy3x9hdkmXkkDNolGQ (button) (small blind) folded before Flop
Seat 2: RwDoM55ZeQuI2ADyJhOb2Q (big blind) collected ($2)



PokerStars Game #59941378288:  Hold'em No Limit ($1/$2) - 2009/07/01 1:33:44 ET
Table 'NmY84NAf9Mh0ckAckHnh5g' 2-max Seat #1 is the button
Seat 1: 6hvg964TSqZ3AL/0XK9aVQ ($356.70 in chips)
Seat 2: RwDoM55ZeQuI2ADyJhOb2Q ($641.20 in chips)
6hvg964TSqZ3AL/0XK9aVQ: posts small blind $1
RwDoM55ZeQuI2ADyJhOb2Q: posts big blind $2
*** HOLE CARDS ***
6hvg964TSqZ3AL/0XK9aVQ: calls $1
RwDoM55ZeQuI2ADyJhOb2Q: checks
*** FLOP *** [6s 5d 7h]
RwDoM55ZeQuI2ADyJhOb2Q: checks
6hvg964TSqZ3AL/0XK9aVQ: bets $4
RwDoM55ZeQuI2ADyJhOb2Q: folds
6hvg964TSqZ3AL/0XK9aVQ collected $3.80 from pot
6hvg964TSqZ3AL/0XK9aVQ: doesn't show hand
*** SUMMARY ***
Total pot $4 | Rake $0.20
Board [6s 5d 7h]
Seat 1: 6hvg964TSqZ3AL/0XK9aVQ (button) (small blind) collected ($3.80)
Seat 2: RwDoM55ZeQuI2ADyJhOb2Q (big blind) folded on the Flop



PokerStars Game #59941378626:  Hold'em No Limit ($1/$2) - 2009/07/01 1:33:44 ET
Table 'ZzSIe0zTCDv+n6hfbY5tTg' 6-max Seat #5 is the button
Seat 1: VvdR9F3I+2yELkfTVvC1dg ($200 in chips)
Seat 2: B87ikIyZ/TzAVeXf38Ny0g ($283 in chips)
Seat 3: gsugPj31Hui3Jefl98MBOA ($353 in chips)
Seat 4: qXDd0ZyMIse0OBu8pxeQ3Q ($266 in chips)
Seat 5: 3dAbvkxS5NPQTBAbvpinVg ($477.30 in chips)
Seat 6: 09BNF4quPDzanQzM8vc6WA ($24.05 in chips)
09BNF4quPDzanQzM8vc6WA: posts small blind $1
VvdR9F3I+2yELkfTVvC1dg: posts big blind $2
*** HOLE CARDS ***
B87ikIyZ/TzAVeXf38Ny0g: raises $4 to $6
gsugPj31Hui3Jefl98MBOA: folds
qXDd0ZyMIse0OBu8pxeQ3Q: folds
3dAbvkxS5NPQTBAbvpinVg: folds
09BNF4quPDzanQzM8vc6WA: folds
VvdR9F3I+2yELkfTVvC1dg: folds
B87ikIyZ/TzAVeXf38Ny0g collected $5 from pot
B87ikIyZ/TzAVeXf38Ny0g: doesn't show hand
*** SUMMARY ***
Total pot $5 | Rake $0
Seat 1: VvdR9F3I+2yELkfTVvC1dg (big blind) folded before Flop
Seat 2: B87ikIyZ/TzAVeXf38Ny0g collected ($5)
Seat 3: gsugPj31Hui3Jefl98MBOA folded before Flop (didn't bet)
Seat 4: qXDd0ZyMIse0OBu8pxeQ3Q folded before Flop (didn't bet)
Seat 5: 3dAbvkxS5NPQTBAbvpinVg (button) folded before Flop (didn't bet)
Seat 6: 09BNF4quPDzanQzM8vc6WA (small blind) folded before Flop



PokerStars Game #59941378384:  Hold'em No Limit ($1/$2) - 2009/07/01 1:33:44 ET
Table 'mGpP9StWRnoeiBDExc6Frg' 6-max Seat #2 is the button
Seat 1: VvdR9F3I+2yELkfTVvC1dg ($313.60 in chips)
Seat 2: vkfxu8f/jMYKUk6Ly4eujw ($197 in chips)
Seat 3: 7acrZUQC3Zc9BNLjoKIcLQ ($23.15 in chips)
Seat 4: 4dcDwIHRm96PwtqkpQiuiA ($79.70 in chips)
Seat 5: d1puGuVBE0fidn+5eRJ0tw ($192.95 in chips)
Seat 6: B2Ih1sr5VZk+8He7rcrMtQ ($431.05 in chips)
7acrZUQC3Zc9BNLjoKIcLQ: posts small blind $1
4dcDwIHRm96PwtqkpQiuiA: posts big blind $2
*** HOLE CARDS ***
d1puGuVBE0fidn+5eRJ0tw: folds
B2Ih1sr5VZk+8He7rcrMtQ: raises $6 to $8
VvdR9F3I+2yELkfTVvC1dg: folds
vkfxu8f/jMYKUk6Ly4eujw: folds
7acrZUQC3Zc9BNLjoKIcLQ: folds
4dcDwIHRm96PwtqkpQiuiA: folds
B2Ih1sr5VZk+8He7rcrMtQ collected $5 from pot
*** SUMMARY ***
Total pot $5 | Rake $0
Seat 1: VvdR9F3I+2yELkfTVvC1dg folded before Flop (didn't bet)
Seat 2: vkfxu8f/jMYKUk6Ly4eujw (button) folded before Flop (didn't bet)
Seat 3: 7acrZUQC3Zc9BNLjoKIcLQ (small blind) folded before Flop
Seat 4: 4dcDwIHRm96PwtqkpQiuiA (big blind) folded before Flop
Seat 5: d1puGuVBE0fidn+5eRJ0tw folded before Flop (didn't bet)
Seat 6: B2Ih1sr5VZk+8He7rcrMtQ collected ($5)



PokerStars Game #59941379562:  Hold'em No Limit ($1/$2) - 2009/07/01 1:33:46 ET
Table 'uJ9juaXXg9yIcSU8amxaXQ' 6-max Seat #3 is the button
Seat 1: JsqOjN/eHz0uYVf/PyUJ6Q ($153.50 in chips)
Seat 2: VvdR9F3I+2yELkfTVvC1dg ($225.10 in chips)
Seat 3: qXDd0ZyMIse0OBu8pxeQ3Q ($244.40 in chips)
Seat 4: zNjJ/y4emmF+vzrCDd+ooA ($242.90 in chips)
Seat 5: YsLQ3BAvgQHWXMAv3Wv6Hg ($200 in chips)
Seat 6: 2DFp9Veq1xxq64dCjwNuUw ($45.60 in chips)
zNjJ/y4emmF+vzrCDd+ooA: posts small blind $1
YsLQ3BAvgQHWXMAv3Wv6Hg: posts big blind $2
*** HOLE CARDS ***
2DFp9Veq1xxq64dCjwNuUw: folds
JsqOjN/eHz0uYVf/PyUJ6Q: folds
VvdR9F3I+2yELkfTVvC1dg: raises $2 to $4
qXDd0ZyMIse0OBu8pxeQ3Q: folds
zNjJ/y4emmF+vzrCDd+ooA: folds
YsLQ3BAvgQHWXMAv3Wv6Hg: folds
VvdR9F3I+2yELkfTVvC1dg collected $5 from pot
VvdR9F3I+2yELkfTVvC1dg: doesn't show hand
*** SUMMARY ***
Total pot $5 | Rake $0
Seat 1: JsqOjN/eHz0uYVf/PyUJ6Q folded before Flop (didn't bet)
Seat 2: VvdR9F3I+2yELkfTVvC1dg collected ($5)
Seat 3: qXDd0ZyMIse0OBu8pxeQ3Q (button) folded before Flop (didn't bet)
Seat 4: zNjJ/y4emmF+vzrCDd+ooA (small blind) folded before Flop
Seat 5: YsLQ3BAvgQHWXMAv3Wv6Hg (big blind) folded before Flop
Seat 6: 2DFp9Veq1xxq64dCjwNuUw folded before Flop (didn't bet)



PokerStars Game #59941379534:  Hold'em No Limit ($1/$2) - 2009/07/01 1:33:46 ET
Table 'TsEDkiO4tzCTCzJ7tNdEqw' 6-max Seat #4 is the button
Seat 1: MfXQsYD8pGeCS7XOtyV+vw ($84.05 in chips)
Seat 2: 4dcDwIHRm96PwtqkpQiuiA ($75.10 in chips)
Seat 3: ubtx4Z5L+AcK71MTvYiGVw ($203 in chips)
Seat 4: K8MXCrNAVYlMnnCeM32Kxw ($117.50 in chips)
Seat 5: VvdR9F3I+2yELkfTVvC1dg ($257.35 in chips)
Seat 6: uCqEjnxh2/vFBjKYkfTOkw ($162.70 in chips)
VvdR9F3I+2yELkfTVvC1dg: posts small blind $1
uCqEjnxh2/vFBjKYkfTOkw: posts big blind $2
*** HOLE CARDS ***
MfXQsYD8pGeCS7XOtyV+vw: raises $4 to $6
4dcDwIHRm96PwtqkpQiuiA: folds
ubtx4Z5L+AcK71MTvYiGVw: folds
K8MXCrNAVYlMnnCeM32Kxw: calls $6
VvdR9F3I+2yELkfTVvC1dg: calls $5
uCqEjnxh2/vFBjKYkfTOkw: folds
*** FLOP *** [As 6d 5c]
VvdR9F3I+2yELkfTVvC1dg: checks
MfXQsYD8pGeCS7XOtyV+vw: checks
K8MXCrNAVYlMnnCeM32Kxw: checks
*** TURN *** [As 6d 5c] [Ah]
VvdR9F3I+2yELkfTVvC1dg: checks
MfXQsYD8pGeCS7XOtyV+vw: bets $12
K8MXCrNAVYlMnnCeM32Kxw: folds
VvdR9F3I+2yELkfTVvC1dg: folds
MfXQsYD8pGeCS7XOtyV+vw collected $19 from pot
MfXQsYD8pGeCS7XOtyV+vw: doesn't show hand
*** SUMMARY ***
Total pot $20 | Rake $1
Board [As 6d 5c Ah]
Seat 1: MfXQsYD8pGeCS7XOtyV+vw collected ($19)
Seat 2: 4dcDwIHRm96PwtqkpQiuiA folded before Flop (didn't bet)
Seat 3: ubtx4Z5L+AcK71MTvYiGVw folded before Flop (didn't bet)
Seat 4: K8MXCrNAVYlMnnCeM32Kxw (button) folded on the Turn
Seat 5: VvdR9F3I+2yELkfTVvC1dg (small blind) folded on the Turn
Seat 6: uCqEjnxh2/vFBjKYkfTOkw (big blind) folded before Flop



PokerStars Game #59941379718:  Hold'em No Limit ($1/$2) - 2009/07/01 1:33:46 ET
Table 'eTkRjRjsYr567snmNk8kNQ' 2-max Seat #2 is the button
Seat 1: t6Jd836OSEMbcRi7rfGp5g ($205.50 in chips)
Seat 2: UNpnKQk0gkkyFJen8upqag ($290.50 in chips)
UNpnKQk0gkkyFJen8upqag: posts small blind $1
t6Jd836OSEMbcRi7rfGp5g: posts big blind $2
*** HOLE CARDS ***
UNpnKQk0gkkyFJen8upqag: raises $4 to $6
t6Jd836OSEMbcRi7rfGp5g: folds
UNpnKQk0gkkyFJen8upqag collected $4 from pot
*** SUMMARY ***
Total pot $4 | Rake $0
Seat 1: t6Jd836OSEMbcRi7rfGp5g (big blind) folded before Flop
Seat 2: UNpnKQk0gkkyFJen8upqag (button) (small blind) collected ($4)



PokerStars Game #59941380388:  Hold'em No Limit ($1/$2) - 2009/07/01 1:33:48 ET
Table 'jlrIxbrVIG+gjaUYT4za8g' 6-max Seat #3 is the button
Seat 1: ygTTt5ehT4aF86q1a8/R+w ($258.30 in chips)
Seat 2: /PH6Ffnho4Ysm8S3V/oa+w ($40 in chips)
Seat 3: gnYme0DNFflnMhrdbxe1Ag ($200 in chips)
Seat 4: 8srN1dKQePlsv0GyTada+Q ($245.20 in chips)
Seat 5: AyBB0k3Dcl7xbXUeGMw06g ($73.90 in chips)
Seat 6: vkfxu8f/jMYKUk6Ly4eujw ($306 in chips)
8srN1dKQePlsv0GyTada+Q: posts small blind $1
AyBB0k3Dcl7xbXUeGMw06g: posts big blind $2
*** HOLE CARDS ***
vkfxu8f/jMYKUk6Ly4eujw: folds
ygTTt5ehT4aF86q1a8/R+w: folds
/PH6Ffnho4Ysm8S3V/oa+w: raises $2 to $4
gnYme0DNFflnMhrdbxe1Ag: folds
8srN1dKQePlsv0GyTada+Q: folds
AyBB0k3Dcl7xbXUeGMw06g: folds
/PH6Ffnho4Ysm8S3V/oa+w collected $5 from pot
*** SUMMARY ***
Total pot $5 | Rake $0
Seat 1: ygTTt5ehT4aF86q1a8/R+w folded before Flop (didn't bet)
Seat 2: /PH6Ffnho4Ysm8S3V/oa+w collected ($5)
Seat 3: gnYme0DNFflnMhrdbxe1Ag (button) folded before Flop (didn't bet)
Seat 4: 8srN1dKQePlsv0GyTada+Q (small blind) folded before Flop
Seat 5: AyBB0k3Dcl7xbXUeGMw06g (big blind) folded before Flop
Seat 6: vkfxu8f/jMYKUk6Ly4eujw folded before Flop (didn't bet)



PokerStars Game #59941381170:  Hold'em No Limit ($1/$2) - 2009/07/01 1:33:49 ET
Table 'W9UeSV0aoPjh5SFSxM8jUQ' 9-max Seat #3 is the button
Seat 1: mIKx5lhIt13X5eZQH0ZeMA ($28.40 in chips)
Seat 3: /inIs/z/PcX+TniIFpaxpg ($22 in chips)
Seat 4: 4YA/sQy1Emm680zhbPUjow ($134.35 in chips)
Seat 5: ri8CLkX3e9JF34dQNbsHGA ($40 in chips)
Seat 6: j47DM+lqTfzZP8musviQTg ($129.30 in chips)
Seat 7: I2ipWauytvrkEer4XD3Sjg ($75.70 in chips)
Seat 8: odhvI/CZeMsPyo1n1U7+hA ($34.40 in chips)
Seat 9: Q104K4iDGcqOlVrjAkzPEA ($108 in chips)
4YA/sQy1Emm680zhbPUjow: posts small blind $1
ri8CLkX3e9JF34dQNbsHGA: posts big blind $2
MeleaB: sits out
*** HOLE CARDS ***
j47DM+lqTfzZP8musviQTg: folds
I2ipWauytvrkEer4XD3Sjg: folds
j47DM+lqTfzZP8musviQTg is sitting out
odhvI/CZeMsPyo1n1U7+hA: calls $2
Q104K4iDGcqOlVrjAkzPEA: folds
mIKx5lhIt13X5eZQH0ZeMA: folds
/inIs/z/PcX+TniIFpaxpg: folds
4YA/sQy1Emm680zhbPUjow: raises $4 to $6
ri8CLkX3e9JF34dQNbsHGA: calls $4
odhvI/CZeMsPyo1n1U7+hA: calls $4
*** FLOP *** [4c Jd Kd]
4YA/sQy1Emm680zhbPUjow: bets $6
ri8CLkX3e9JF34dQNbsHGA: calls $6
odhvI/CZeMsPyo1n1U7+hA: calls $6
*** TURN *** [4c Jd Kd] [2s]
4YA/sQy1Emm680zhbPUjow: checks
ri8CLkX3e9JF34dQNbsHGA: checks
odhvI/CZeMsPyo1n1U7+hA: checks
*** RIVER *** [4c Jd Kd 2s] [3h]
4YA/sQy1Emm680zhbPUjow: checks
ri8CLkX3e9JF34dQNbsHGA: checks
odhvI/CZeMsPyo1n1U7+hA: checks
*** SHOW DOWN ***
4YA/sQy1Emm680zhbPUjow: shows [Ac Qh] (high card Ace)
ri8CLkX3e9JF34dQNbsHGA: mucks hand
odhvI/CZeMsPyo1n1U7+hA: mucks hand
4YA/sQy1Emm680zhbPUjow collected $34.25 from pot
*** SUMMARY ***
Total pot $36 | Rake $1.75
Board [4c Jd Kd 2s 3h]
Seat 1: mIKx5lhIt13X5eZQH0ZeMA folded before Flop (didn't bet)
Seat 3: /inIs/z/PcX+TniIFpaxpg (button) folded before Flop (didn't bet)
Seat 4: 4YA/sQy1Emm680zhbPUjow (small blind) showed [Ac Qh] and won ($34.25) with high card Ace
Seat 5: ri8CLkX3e9JF34dQNbsHGA (big blind) mucked
Seat 6: j47DM+lqTfzZP8musviQTg folded before Flop (didn't bet)
Seat 7: I2ipWauytvrkEer4XD3Sjg folded before Flop (didn't bet)
Seat 8: odhvI/CZeMsPyo1n1U7+hA mucked
Seat 9: Q104K4iDGcqOlVrjAkzPEA folded before Flop (didn't bet)



PokerStars Game #59941380924:  Hold'em No Limit ($1/$2) - 2009/07/01 1:33:49 ET
Table 'P/yCfYl1GfGsu/e6DxDy/A' 2-max Seat #2 is the button
Seat 1: 7fOCUy3x9hdkmXkkDNolGQ ($530.50 in chips)
Seat 2: RwDoM55ZeQuI2ADyJhOb2Q ($950 in chips)
RwDoM55ZeQuI2ADyJhOb2Q: posts small blind $1
7fOCUy3x9hdkmXkkDNolGQ: posts big blind $2
*** HOLE CARDS ***
RwDoM55ZeQuI2ADyJhOb2Q: raises $4 to $6
7fOCUy3x9hdkmXkkDNolGQ: folds
RwDoM55ZeQuI2ADyJhOb2Q collected $4 from pot
RwDoM55ZeQuI2ADyJhOb2Q: doesn't show hand
*** SUMMARY ***
Total pot $4 | Rake $0
Seat 1: 7fOCUy3x9hdkmXkkDNolGQ (big blind) folded before Flop
Seat 2: RwDoM55ZeQuI2ADyJhOb2Q (button) (small blind) collected ($4)



PokerStars Game #59941382058:  Hold'em No Limit ($1/$2) - 2009/07/01 1:33:50 ET
Table 'gftD4mDF7mIFKvSrIyaRbw' 9-max Seat #5 is the button
Seat 2: GX1heJ+DSsvm7gzSPsYhhQ ($36 in chips)
Seat 3: CUZwDpLTQKhzarPe+JCLOQ ($204.75 in chips)
Seat 4: /inIs/z/PcX+TniIFpaxpg ($37 in chips)
Seat 5: mpsfNtnMVDqQHTe92AhIdw ($117.10 in chips)
Seat 6: 2NvwF8W2nzsbS+G//yLAbQ ($120.20 in chips)
Seat 7: +T/63sAeZzWyHchahJ36GQ ($42 in chips)
Seat 8: MpL4DeEqGQu0H8TJEbEOrg ($41 in chips)
2NvwF8W2nzsbS+G//yLAbQ: posts small blind $1
+T/63sAeZzWyHchahJ36GQ: posts big blind $2
*** HOLE CARDS ***
MpL4DeEqGQu0H8TJEbEOrg: folds
GX1heJ+DSsvm7gzSPsYhhQ: folds
CUZwDpLTQKhzarPe+JCLOQ: raises $5 to $7
/inIs/z/PcX+TniIFpaxpg: raises $30 to $37 and is all-in
mpsfNtnMVDqQHTe92AhIdw: folds
2NvwF8W2nzsbS+G//yLAbQ: folds
+T/63sAeZzWyHchahJ36GQ: folds
CUZwDpLTQKhzarPe+JCLOQ: calls $30
*** FLOP *** [3c Ad 2s]
*** TURN *** [3c Ad 2s] [5s]
*** RIVER *** [3c Ad 2s 5s] [4h]
*** SHOW DOWN ***
CUZwDpLTQKhzarPe+JCLOQ: shows [9s 9h] (a straight, Ace to Five)
/inIs/z/PcX+TniIFpaxpg: shows [Qs Qd] (a straight, Ace to Five)
CUZwDpLTQKhzarPe+JCLOQ collected $37 from pot
/inIs/z/PcX+TniIFpaxpg collected $37 from pot
*** SUMMARY ***
Total pot $77 | Rake $3
Board [3c Ad 2s 5s 4h]
Seat 2: GX1heJ+DSsvm7gzSPsYhhQ folded before Flop (didn't bet)
Seat 3: CUZwDpLTQKhzarPe+JCLOQ showed [9s 9h] and won ($37) with a straight, Ace to Five
Seat 4: /inIs/z/PcX+TniIFpaxpg showed [Qs Qd] and won ($37) with a straight, Ace to Five
Seat 5: mpsfNtnMVDqQHTe92AhIdw (button) folded before Flop (didn't bet)
Seat 6: 2NvwF8W2nzsbS+G//yLAbQ (small blind) folded before Flop
Seat 7: +T/63sAeZzWyHchahJ36GQ (big blind) folded before Flop
Seat 8: MpL4DeEqGQu0H8TJEbEOrg folded before Flop (didn't bet)



PokerStars Game #59941384420:  Hold'em No Limit ($1/$2) - 2009/07/01 1:33:55 ET
Table 'kq5zaQ+1hLNf8LZfGnbTAA' 6-max Seat #3 is the button
Seat 1: 8srN1dKQePlsv0GyTada+Q ($440.60 in chips)
Seat 2: nXDI8Y/S6POzRwANu3d8hQ ($164 in chips)
Seat 3: /PH6Ffnho4Ysm8S3V/oa+w ($40 in chips)
Seat 4: 3dAbvkxS5NPQTBAbvpinVg ($279.45 in chips)
Seat 5: gnYme0DNFflnMhrdbxe1Ag ($200 in chips)
Seat 6: mfy7uGZcqA2PVQqEVbJ7+g ($191.25 in chips)
3dAbvkxS5NPQTBAbvpinVg: posts small blind $1
gnYme0DNFflnMhrdbxe1Ag: posts big blind $2
*** HOLE CARDS ***
mfy7uGZcqA2PVQqEVbJ7+g: folds
8srN1dKQePlsv0GyTada+Q: folds
nXDI8Y/S6POzRwANu3d8hQ: folds
/PH6Ffnho4Ysm8S3V/oa+w: folds
3dAbvkxS5NPQTBAbvpinVg: folds
gnYme0DNFflnMhrdbxe1Ag collected $2 from pot
gnYme0DNFflnMhrdbxe1Ag: doesn't show hand
*** SUMMARY ***
Total pot $2 | Rake $0
Seat 1: 8srN1dKQePlsv0GyTada+Q folded before Flop (didn't bet)
Seat 2: nXDI8Y/S6POzRwANu3d8hQ folded before Flop (didn't bet)
Seat 3: /PH6Ffnho4Ysm8S3V/oa+w (button) folded before Flop (didn't bet)
Seat 4: 3dAbvkxS5NPQTBAbvpinVg (small blind) folded before Flop
Seat 5: gnYme0DNFflnMhrdbxe1Ag (big blind) collected ($2)
Seat 6: mfy7uGZcqA2PVQqEVbJ7+g folded before Flop (didn't bet)



PokerStars Game #59941385458:  Hold'em No Limit ($1/$2) - 2009/07/01 1:33:57 ET
Table 'eTkRjRjsYr567snmNk8kNQ' 2-max Seat #1 is the button
Seat 1: t6Jd836OSEMbcRi7rfGp5g ($203.50 in chips)
Seat 2: UNpnKQk0gkkyFJen8upqag ($292.50 in chips)
t6Jd836OSEMbcRi7rfGp5g: posts small blind $1
UNpnKQk0gkkyFJen8upqag: posts big blind $2
*** HOLE CARDS ***
t6Jd836OSEMbcRi7rfGp5g: raises $4 to $6
UNpnKQk0gkkyFJen8upqag: folds
t6Jd836OSEMbcRi7rfGp5g collected $4 from pot
*** SUMMARY ***
Total pot $4 | Rake $0
Seat 1: t6Jd836OSEMbcRi7rfGp5g (button) (small blind) collected ($4)
Seat 2: UNpnKQk0gkkyFJen8upqag (big blind) folded before Flop



PokerStars Game #59941386554:  Hold'em No Limit ($1/$2) - 2009/07/01 1:33:59 ET
Table 'G1Oqdy4Pqdb5gtx40rUBzA' 6-max Seat #5 is the button
Seat 1: ubtx4Z5L+AcK71MTvYiGVw ($200 in chips)
Seat 2: 4uqU0dG67owXuPz303Al4w ($515.25 in chips)
Seat 3: VvdR9F3I+2yELkfTVvC1dg ($241.25 in chips)
Seat 4: B87ikIyZ/TzAVeXf38Ny0g ($214.55 in chips)
Seat 5: F1+Ml47qRQWunzPnGhLLzQ ($186.50 in chips)
Seat 6: qCnEYuAE5y5A7bk6fO5/jQ ($201 in chips)
qCnEYuAE5y5A7bk6fO5/jQ: posts small blind $1
ubtx4Z5L+AcK71MTvYiGVw: posts big blind $2
*** HOLE CARDS ***
4uqU0dG67owXuPz303Al4w: folds
VvdR9F3I+2yELkfTVvC1dg: folds
B87ikIyZ/TzAVeXf38Ny0g: folds
F1+Ml47qRQWunzPnGhLLzQ: folds
qCnEYuAE5y5A7bk6fO5/jQ: folds
ubtx4Z5L+AcK71MTvYiGVw collected $2 from pot
ubtx4Z5L+AcK71MTvYiGVw: doesn't show hand
*** SUMMARY ***
Total pot $2 | Rake $0
Seat 1: ubtx4Z5L+AcK71MTvYiGVw (big blind) collected ($2)
Seat 2: 4uqU0dG67owXuPz303Al4w folded before Flop (didn't bet)
Seat 3: VvdR9F3I+2yELkfTVvC1dg folded before Flop (didn't bet)
Seat 4: B87ikIyZ/TzAVeXf38Ny0g folded before Flop (didn't bet)
Seat 5: F1+Ml47qRQWunzPnGhLLzQ (button) folded before Flop (didn't bet)
Seat 6: qCnEYuAE5y5A7bk6fO5/jQ (small blind) folded before Flop



PokerStars Game #59941386832:  Hold'em No Limit ($1/$2) - 2009/07/01 1:33:59 ET
Table 'ztv6V3FN2bQ9nmJPPdx6nQ' 6-max Seat #1 is the button
Seat 1: 6fLdOUCRtX71xbVRhJEq8w ($241.35 in chips)
Seat 2: 5Y+ZGWLI4gnlpApDX5vy1A ($387.75 in chips)
Seat 3: ubtx4Z5L+AcK71MTvYiGVw ($245 in chips)
Seat 5: sTPOWERd9HWPCNrDBwsVjA ($222.80 in chips)
Seat 6: mfy7uGZcqA2PVQqEVbJ7+g ($97.45 in chips)
5Y+ZGWLI4gnlpApDX5vy1A: posts small blind $1
ubtx4Z5L+AcK71MTvYiGVw: posts big blind $2
*** HOLE CARDS ***
sTPOWERd9HWPCNrDBwsVjA: folds
mfy7uGZcqA2PVQqEVbJ7+g: folds
6fLdOUCRtX71xbVRhJEq8w: folds
5Y+ZGWLI4gnlpApDX5vy1A: folds
ubtx4Z5L+AcK71MTvYiGVw collected $2 from pot
ubtx4Z5L+AcK71MTvYiGVw: doesn't show hand
*** SUMMARY ***
Total pot $2 | Rake $0
Seat 1: 6fLdOUCRtX71xbVRhJEq8w (button) folded before Flop (didn't bet)
Seat 2: 5Y+ZGWLI4gnlpApDX5vy1A (small blind) folded before Flop
Seat 3: ubtx4Z5L+AcK71MTvYiGVw (big blind) collected ($2)
Seat 5: sTPOWERd9HWPCNrDBwsVjA folded before Flop (didn't bet)
Seat 6: mfy7uGZcqA2PVQqEVbJ7+g folded before Flop (didn't bet)



PokerStars Game #59941387958:  Hold'em No Limit ($1/$2) - 2009/07/01 1:34:01 ET
Table 'uJ9juaXXg9yIcSU8amxaXQ' 6-max Seat #4 is the button
Seat 1: JsqOjN/eHz0uYVf/PyUJ6Q ($153.50 in chips)
Seat 2: VvdR9F3I+2yELkfTVvC1dg ($228.10 in chips)
Seat 3: qXDd0ZyMIse0OBu8pxeQ3Q ($244.40 in chips)
Seat 4: zNjJ/y4emmF+vzrCDd+ooA ($241.90 in chips)
Seat 5: YsLQ3BAvgQHWXMAv3Wv6Hg ($200 in chips)
Seat 6: 2DFp9Veq1xxq64dCjwNuUw ($45.60 in chips)
YsLQ3BAvgQHWXMAv3Wv6Hg: posts small blind $1
2DFp9Veq1xxq64dCjwNuUw: posts big blind $2
*** HOLE CARDS ***
JsqOjN/eHz0uYVf/PyUJ6Q: folds
JsqOjN/eHz0uYVf/PyUJ6Q is sitting out
VvdR9F3I+2yELkfTVvC1dg: folds
qXDd0ZyMIse0OBu8pxeQ3Q: folds
zNjJ/y4emmF+vzrCDd+ooA: calls $2
YsLQ3BAvgQHWXMAv3Wv6Hg: calls $1
2DFp9Veq1xxq64dCjwNuUw: checks
*** FLOP *** [Ks 6s Jh]
YsLQ3BAvgQHWXMAv3Wv6Hg: checks
2DFp9Veq1xxq64dCjwNuUw: bets $4
zNjJ/y4emmF+vzrCDd+ooA: calls $4
YsLQ3BAvgQHWXMAv3Wv6Hg: folds
*** TURN *** [Ks 6s Jh] [3c]
2DFp9Veq1xxq64dCjwNuUw: checks
zNjJ/y4emmF+vzrCDd+ooA: checks
*** RIVER *** [Ks 6s Jh 3c] [5h]
2DFp9Veq1xxq64dCjwNuUw: bets $8
zNjJ/y4emmF+vzrCDd+ooA: raises $8 to $16
2DFp9Veq1xxq64dCjwNuUw: calls $8
*** SHOW DOWN ***
zNjJ/y4emmF+vzrCDd+ooA: shows [9d 9s] (a pair of Nines)
2DFp9Veq1xxq64dCjwNuUw: shows [Kd Ts] (a pair of Kings)
2DFp9Veq1xxq64dCjwNuUw collected $43.75 from pot
*** SUMMARY ***
Total pot $46 | Rake $2.25
Board [Ks 6s Jh 3c 5h]
Seat 1: JsqOjN/eHz0uYVf/PyUJ6Q folded before Flop (didn't bet)
Seat 2: VvdR9F3I+2yELkfTVvC1dg folded before Flop (didn't bet)
Seat 3: qXDd0ZyMIse0OBu8pxeQ3Q folded before Flop (didn't bet)
Seat 4: zNjJ/y4emmF+vzrCDd+ooA (button) showed [9d 9s] and lost with a pair of Nines
Seat 5: YsLQ3BAvgQHWXMAv3Wv6Hg (small blind) folded on the Flop
Seat 6: 2DFp9Veq1xxq64dCjwNuUw (big blind) showed [Kd Ts] and won ($43.75) with a pair of Kings



PokerStars Game #59941388092:  Hold'em No Limit ($1/$2) - 2009/07/01 1:34:01 ET
Table 'pPQgcj9XT9CHBsbo1WTBug' 6-max Seat #1 is the button
Seat 1: DFVYDA6dKQy7R7mGIKogZA ($138.20 in chips)
Seat 2: qXDd0ZyMIse0OBu8pxeQ3Q ($200 in chips)
Seat 3: 54yWzRRgS0oZ+S6LwZBxMQ ($52.50 in chips)
Seat 4: gqlysXCbT8V54f/1lf9h3A ($74.45 in chips)
Seat 5: vkfxu8f/jMYKUk6Ly4eujw ($190.55 in chips)
Seat 6: Yr7pZltpy3IUNdKS9PCEiw ($315.80 in chips)
qXDd0ZyMIse0OBu8pxeQ3Q: posts small blind $1
54yWzRRgS0oZ+S6LwZBxMQ: posts big blind $2
*** HOLE CARDS ***
gqlysXCbT8V54f/1lf9h3A: folds
vkfxu8f/jMYKUk6Ly4eujw: folds
Yr7pZltpy3IUNdKS9PCEiw: folds
DFVYDA6dKQy7R7mGIKogZA: calls $2
qXDd0ZyMIse0OBu8pxeQ3Q: folds
54yWzRRgS0oZ+S6LwZBxMQ: checks
*** FLOP *** [6h Ac 2c]
54yWzRRgS0oZ+S6LwZBxMQ: checks
DFVYDA6dKQy7R7mGIKogZA: bets $4
54yWzRRgS0oZ+S6LwZBxMQ: folds
DFVYDA6dKQy7R7mGIKogZA collected $4.75 from pot
*** SUMMARY ***
Total pot $5 | Rake $0.25
Board [6h Ac 2c]
Seat 1: DFVYDA6dKQy7R7mGIKogZA (button) collected ($4.75)
Seat 2: qXDd0ZyMIse0OBu8pxeQ3Q (small blind) folded before Flop
Seat 3: 54yWzRRgS0oZ+S6LwZBxMQ (big blind) folded on the Flop
Seat 4: gqlysXCbT8V54f/1lf9h3A folded before Flop (didn't bet)
Seat 5: vkfxu8f/jMYKUk6Ly4eujw folded before Flop (didn't bet)
Seat 6: Yr7pZltpy3IUNdKS9PCEiw folded before Flop (didn't bet)



PokerStars Game #59941388192:  Hold'em No Limit ($1/$2) - 2009/07/01 1:34:02 ET
Table '4NGNnZ/osQfNq6abYqkJeA' 6-max Seat #2 is the button
Seat 2: 669iGNwYwgRZg3nhS+aDAQ ($98.25 in chips)
Seat 3: 54yWzRRgS0oZ+S6LwZBxMQ ($35 in chips)
Seat 4: sY+4Uuh5z/6AbXXaCS10jw ($225.25 in chips)
Seat 5: VvdR9F3I+2yELkfTVvC1dg ($238.85 in chips)
54yWzRRgS0oZ+S6LwZBxMQ: posts small blind $1
sY+4Uuh5z/6AbXXaCS10jw: posts big blind $2
/PH6Ffnho4Ysm8S3V/oa+w: sits out
vkfxu8f/jMYKUk6Ly4eujw: sits out
*** HOLE CARDS ***
VvdR9F3I+2yELkfTVvC1dg: folds
669iGNwYwgRZg3nhS+aDAQ: folds
54yWzRRgS0oZ+S6LwZBxMQ: folds
sY+4Uuh5z/6AbXXaCS10jw collected $2 from pot
*** SUMMARY ***
Total pot $2 | Rake $0
Seat 2: 669iGNwYwgRZg3nhS+aDAQ (button) folded before Flop (didn't bet)
Seat 3: 54yWzRRgS0oZ+S6LwZBxMQ (small blind) folded before Flop
Seat 4: sY+4Uuh5z/6AbXXaCS10jw (big blind) collected ($2)
Seat 5: VvdR9F3I+2yELkfTVvC1dg folded before Flop (didn't bet)



PokerStars Game #59941389574:  Hold'em No Limit ($1/$2) - 2009/07/01 1:34:04 ET
Table 'UGLAZZyv+cXmnKjYin0etA' 6-max Seat #4 is the button
Seat 1: vkfxu8f/jMYKUk6Ly4eujw ($204 in chips)
Seat 2: eDLH1PUXFpvJBNMXBVQcGA ($276.35 in chips)
Seat 3: ygTTt5ehT4aF86q1a8/R+w ($114.20 in chips)
Seat 4: SiGJDsvRViJX05vHhA80GQ ($234.85 in chips)
Seat 5: 54yWzRRgS0oZ+S6LwZBxMQ ($34 in chips)
Seat 6: sTPOWERd9HWPCNrDBwsVjA ($210.10 in chips)
54yWzRRgS0oZ+S6LwZBxMQ: posts small blind $1
sTPOWERd9HWPCNrDBwsVjA: posts big blind $2
*** HOLE CARDS ***
vkfxu8f/jMYKUk6Ly4eujw: folds
eDLH1PUXFpvJBNMXBVQcGA: folds
ygTTt5ehT4aF86q1a8/R+w: raises $4 to $6
SiGJDsvRViJX05vHhA80GQ: folds
54yWzRRgS0oZ+S6LwZBxMQ: folds
sTPOWERd9HWPCNrDBwsVjA: folds
ygTTt5ehT4aF86q1a8/R+w collected $5 from pot
*** SUMMARY ***
Total pot $5 | Rake $0
Seat 1: vkfxu8f/jMYKUk6Ly4eujw folded before Flop (didn't bet)
Seat 2: eDLH1PUXFpvJBNMXBVQcGA folded before Flop (didn't bet)
Seat 3: ygTTt5ehT4aF86q1a8/R+w collected ($5)
Seat 4: SiGJDsvRViJX05vHhA80GQ (button) folded before Flop (didn't bet)
Seat 5: 54yWzRRgS0oZ+S6LwZBxMQ (small blind) folded before Flop
Seat 6: sTPOWERd9HWPCNrDBwsVjA (big blind) folded before Flop



PokerStars Game #59941389728:  Hold'em No Limit ($1/$2) - 2009/07/01 1:34:04 ET
Table 'P/yCfYl1GfGsu/e6DxDy/A' 2-max Seat #1 is the button
Seat 1: 7fOCUy3x9hdkmXkkDNolGQ ($528.50 in chips)
Seat 2: RwDoM55ZeQuI2ADyJhOb2Q ($952 in chips)
7fOCUy3x9hdkmXkkDNolGQ: posts small blind $1
RwDoM55ZeQuI2ADyJhOb2Q: posts big blind $2
*** HOLE CARDS ***
7fOCUy3x9hdkmXkkDNolGQ: folds
RwDoM55ZeQuI2ADyJhOb2Q collected $2 from pot
RwDoM55ZeQuI2ADyJhOb2Q: doesn't show hand
*** SUMMARY ***
Total pot $2 | Rake $0
Seat 1: 7fOCUy3x9hdkmXkkDNolGQ (button) (small blind) folded before Flop
Seat 2: RwDoM55ZeQuI2ADyJhOb2Q (big blind) collected ($2)



PokerStars Game #59941390770:  Hold'em No Limit ($1/$2) - 2009/07/01 1:34:06 ET
Table 'YqGfR5eHfMeSjb9a+QU9rg' 9-max Seat #8 is the button
Seat 1: rW/MyplHylMSBRaoRUzWrg ($34 in chips)
Seat 2: W3Nqt1GWlTi9tXQXMNEvgw ($401.85 in chips)
Seat 3: /gll27k+xWYV7Fbki0lFDQ ($261.75 in chips)
Seat 4: GX1heJ+DSsvm7gzSPsYhhQ ($37 in chips)
Seat 5: CkE3IyJF1KvdaAOmZY5XqQ ($200 in chips)
Seat 6: TAfo4veNRaRlzDXMMYS3Jg ($37 in chips)
Seat 7: 41aZuLBz9nAi2GPVKabmCw ($100.95 in chips)
Seat 8: JnV3SM2D6dAFYyGZHHpvrg ($90.25 in chips)
Seat 9: /inIs/z/PcX+TniIFpaxpg ($203.20 in chips)
/inIs/z/PcX+TniIFpaxpg: posts small blind $1
rW/MyplHylMSBRaoRUzWrg: posts big blind $2
*** HOLE CARDS ***
W3Nqt1GWlTi9tXQXMNEvgw: folds
/gll27k+xWYV7Fbki0lFDQ: folds
GX1heJ+DSsvm7gzSPsYhhQ: folds
CkE3IyJF1KvdaAOmZY5XqQ: folds
TAfo4veNRaRlzDXMMYS3Jg: folds
41aZuLBz9nAi2GPVKabmCw: raises $2 to $4
JnV3SM2D6dAFYyGZHHpvrg: folds
/inIs/z/PcX+TniIFpaxpg: folds
rW/MyplHylMSBRaoRUzWrg: folds
41aZuLBz9nAi2GPVKabmCw collected $5 from pot
*** SUMMARY ***
Total pot $5 | Rake $0
Seat 1: rW/MyplHylMSBRaoRUzWrg (big blind) folded before Flop
Seat 2: W3Nqt1GWlTi9tXQXMNEvgw folded before Flop (didn't bet)
Seat 3: /gll27k+xWYV7Fbki0lFDQ folded before Flop (didn't bet)
Seat 4: GX1heJ+DSsvm7gzSPsYhhQ folded before Flop (didn't bet)
Seat 5: CkE3IyJF1KvdaAOmZY5XqQ folded before Flop (didn't bet)
Seat 6: TAfo4veNRaRlzDXMMYS3Jg folded before Flop (didn't bet)
Seat 7: 41aZuLBz9nAi2GPVKabmCw collected ($5)
Seat 8: JnV3SM2D6dAFYyGZHHpvrg (button) folded before Flop (didn't bet)
Seat 9: /inIs/z/PcX+TniIFpaxpg (small blind) folded before Flop



PokerStars Game #59941391436:  Hold'em No Limit ($1/$2) - 2009/07/01 1:34:07 ET
Table 'jlrIxbrVIG+gjaUYT4za8g' 6-max Seat #4 is the button
Seat 1: ygTTt5ehT4aF86q1a8/R+w ($258.30 in chips)
Seat 2: /PH6Ffnho4Ysm8S3V/oa+w ($43 in chips)
Seat 3: gnYme0DNFflnMhrdbxe1Ag ($200 in chips)
Seat 4: 8srN1dKQePlsv0GyTada+Q ($244.20 in chips)
Seat 5: AyBB0k3Dcl7xbXUeGMw06g ($71.90 in chips)
Seat 6: vkfxu8f/jMYKUk6Ly4eujw ($306 in chips)
AyBB0k3Dcl7xbXUeGMw06g: posts small blind $1
vkfxu8f/jMYKUk6Ly4eujw: posts big blind $2
*** HOLE CARDS ***
ygTTt5ehT4aF86q1a8/R+w: folds
/PH6Ffnho4Ysm8S3V/oa+w: folds
gnYme0DNFflnMhrdbxe1Ag: raises $4 to $6
8srN1dKQePlsv0GyTada+Q: folds
AyBB0k3Dcl7xbXUeGMw06g: folds
vkfxu8f/jMYKUk6Ly4eujw: raises $12 to $18
gnYme0DNFflnMhrdbxe1Ag: calls $12
*** FLOP *** [Kd Ks 3s]
vkfxu8f/jMYKUk6Ly4eujw: bets $23
gnYme0DNFflnMhrdbxe1Ag: folds
vkfxu8f/jMYKUk6Ly4eujw collected $35.15 from pot
vkfxu8f/jMYKUk6Ly4eujw: doesn't show hand
*** SUMMARY ***
Total pot $37 | Rake $1.85
Board [Kd Ks 3s]
Seat 1: ygTTt5ehT4aF86q1a8/R+w folded before Flop (didn't bet)
Seat 2: /PH6Ffnho4Ysm8S3V/oa+w folded before Flop (didn't bet)
Seat 3: gnYme0DNFflnMhrdbxe1Ag folded on the Flop
Seat 4: 8srN1dKQePlsv0GyTada+Q (button) folded before Flop (didn't bet)
Seat 5: AyBB0k3Dcl7xbXUeGMw06g (small blind) folded before Flop
Seat 6: vkfxu8f/jMYKUk6Ly4eujw (big blind) collected ($35.15)



PokerStars Game #59941391386:  Hold'em No Limit ($1/$2) - 2009/07/01 1:34:07 ET
Table 'rKeCh+eBn4RNvybCUYkoTQ' 9-max Seat #1 is the button
Seat 1: /inIs/z/PcX+TniIFpaxpg ($198 in chips)
Seat 2: 9cBHwK40Tl06vheE7B3LHQ ($127.80 in chips)
Seat 3: GX1heJ+DSsvm7gzSPsYhhQ ($43 in chips)
Seat 5: WUlHm+ydPPHG7Lb0rePSdA ($125 in chips)
Seat 6: EBV6OktyeSmh4w6sWmcWOw ($267 in chips)
Seat 7: rW/MyplHylMSBRaoRUzWrg ($31 in chips)
Seat 8: pN/Ip0ePsUVIdUlGgLrkUw ($246.35 in chips)
Seat 9: Kzta8yu9vxHT4B70mjBZ+w ($208.25 in chips)
9cBHwK40Tl06vheE7B3LHQ: posts small blind $1
GX1heJ+DSsvm7gzSPsYhhQ: posts big blind $2
*** HOLE CARDS ***
WUlHm+ydPPHG7Lb0rePSdA: folds
EBV6OktyeSmh4w6sWmcWOw: folds
rW/MyplHylMSBRaoRUzWrg: folds
pN/Ip0ePsUVIdUlGgLrkUw: folds
Kzta8yu9vxHT4B70mjBZ+w: raises $4 to $6
/inIs/z/PcX+TniIFpaxpg: folds
9cBHwK40Tl06vheE7B3LHQ: folds
GX1heJ+DSsvm7gzSPsYhhQ: folds
Kzta8yu9vxHT4B70mjBZ+w collected $5 from pot
Kzta8yu9vxHT4B70mjBZ+w: doesn't show hand
*** SUMMARY ***
Total pot $5 | Rake $0
Seat 1: /inIs/z/PcX+TniIFpaxpg (button) folded before Flop (didn't bet)
Seat 2: 9cBHwK40Tl06vheE7B3LHQ (small blind) folded before Flop
Seat 3: GX1heJ+DSsvm7gzSPsYhhQ (big blind) folded before Flop
Seat 5: WUlHm+ydPPHG7Lb0rePSdA folded before Flop (didn't bet)
Seat 6: EBV6OktyeSmh4w6sWmcWOw folded before Flop (didn't bet)
Seat 7: rW/MyplHylMSBRaoRUzWrg folded before Flop (didn't bet)
Seat 8: pN/Ip0ePsUVIdUlGgLrkUw folded before Flop (didn't bet)
Seat 9: Kzta8yu9vxHT4B70mjBZ+w collected ($5)



PokerStars Game #59941390926:  Hold'em No Limit ($1/$2) - 2009/07/01 1:34:07 ET
Table 'NmY84NAf9Mh0ckAckHnh5g' 2-max Seat #2 is the button
Seat 1: 6hvg964TSqZ3AL/0XK9aVQ ($358.50 in chips)
Seat 2: RwDoM55ZeQuI2ADyJhOb2Q ($639.20 in chips)
RwDoM55ZeQuI2ADyJhOb2Q: posts small blind $1
6hvg964TSqZ3AL/0XK9aVQ: posts big blind $2
*** HOLE CARDS ***
RwDoM55ZeQuI2ADyJhOb2Q: folds
6hvg964TSqZ3AL/0XK9aVQ collected $2 from pot
6hvg964TSqZ3AL/0XK9aVQ: doesn't show hand
*** SUMMARY ***
Total pot $2 | Rake $0
Seat 1: 6hvg964TSqZ3AL/0XK9aVQ (big blind) collected ($2)
Seat 2: RwDoM55ZeQuI2ADyJhOb2Q (button) (small blind) folded before Flop



PokerStars Game #59941391708:  Hold'em No Limit ($1/$2) - 2009/07/01 1:34:08 ET
Table 'AtOXMvcrtQM8yLNcALmfLQ' 2-max Seat #2 is the button
Seat 1: +HlQuAsMqZGYYtjcPO/a3A ($360.20 in chips)
Seat 2: pVqEzK9wXlRMECnb1Zg4Zw ($203.50 in chips)
pVqEzK9wXlRMECnb1Zg4Zw: posts small blind $1
+HlQuAsMqZGYYtjcPO/a3A: posts big blind $2
*** HOLE CARDS ***
pVqEzK9wXlRMECnb1Zg4Zw: raises $6 to $8
+HlQuAsMqZGYYtjcPO/a3A: folds
pVqEzK9wXlRMECnb1Zg4Zw collected $4 from pot
pVqEzK9wXlRMECnb1Zg4Zw: doesn't show hand
*** SUMMARY ***
Total pot $4 | Rake $0
Seat 1: +HlQuAsMqZGYYtjcPO/a3A (big blind) folded before Flop
Seat 2: pVqEzK9wXlRMECnb1Zg4Zw (button) (small blind) collected ($4)



PokerStars Game #59941392444:  Hold'em No Limit ($1/$2) - 2009/07/01 1:34:09 ET
Table '8Y6PEyoNuepZTai2Q56aHw' 9-max Seat #4 is the button
Seat 1: 5Q8U6iZbeO7xJSS4qvDP5g ($311.80 in chips)
Seat 2: gDCJIAlovbPnTvMM7Dd1gA ($191.15 in chips)
Seat 3: WUlHm+ydPPHG7Lb0rePSdA ($214.10 in chips)
Seat 4: xKkwALG38OfLQ9DXuJgR1w ($210.25 in chips)
Seat 5: /inIs/z/PcX+TniIFpaxpg ($41 in chips)
Seat 6: NtLDBSjsJQEKekh5cdinvw ($373.35 in chips)
Seat 7: Kzta8yu9vxHT4B70mjBZ+w ($200 in chips)
Seat 8: rW/MyplHylMSBRaoRUzWrg ($70 in chips)
/inIs/z/PcX+TniIFpaxpg: posts small blind $1
NtLDBSjsJQEKekh5cdinvw: posts big blind $2
*** HOLE CARDS ***
Kzta8yu9vxHT4B70mjBZ+w: folds
rW/MyplHylMSBRaoRUzWrg: folds
5Q8U6iZbeO7xJSS4qvDP5g: folds
gDCJIAlovbPnTvMM7Dd1gA: folds
WUlHm+ydPPHG7Lb0rePSdA: folds
xKkwALG38OfLQ9DXuJgR1w: folds
/inIs/z/PcX+TniIFpaxpg: folds
NtLDBSjsJQEKekh5cdinvw collected $2 from pot
NtLDBSjsJQEKekh5cdinvw: doesn't show hand
*** SUMMARY ***
Total pot $2 | Rake $0
Seat 1: 5Q8U6iZbeO7xJSS4qvDP5g folded before Flop (didn't bet)
Seat 2: gDCJIAlovbPnTvMM7Dd1gA folded before Flop (didn't bet)
Seat 3: WUlHm+ydPPHG7Lb0rePSdA folded before Flop (didn't bet)
Seat 4: xKkwALG38OfLQ9DXuJgR1w (button) folded before Flop (didn't bet)
Seat 5: /inIs/z/PcX+TniIFpaxpg (small blind) folded before Flop
Seat 6: NtLDBSjsJQEKekh5cdinvw (big blind) collected ($2)
Seat 7: Kzta8yu9vxHT4B70mjBZ+w folded before Flop (didn't bet)
Seat 8: rW/MyplHylMSBRaoRUzWrg folded before Flop (didn't bet)



PokerStars Game #59941393976:  Hold'em No Limit ($1/$2) - 2009/07/01 1:34:12 ET
Table 'LL4bDFyhj5hsMpzaDugJZg' 6-max Seat #2 is the button
Seat 1: FwvID/fQGlpY3soi/lMTww ($85.05 in chips)
Seat 2: IZng3w8jiJHHp3LbYKLi4w ($42.15 in chips)
Seat 3: iI/NMpRxMkGieArQEhACSA ($565.90 in chips)
Seat 4: 8srN1dKQePlsv0GyTada+Q ($215.40 in chips)
Seat 5: A2GTwTiwkb1ilNWgW487Vg ($128.50 in chips)
Seat 6: 692Q4sfB0gTElzS0WMeg+A ($200 in chips)
iI/NMpRxMkGieArQEhACSA: posts small blind $1
8srN1dKQePlsv0GyTada+Q: posts big blind $2
*** HOLE CARDS ***
A2GTwTiwkb1ilNWgW487Vg: folds
692Q4sfB0gTElzS0WMeg+A: folds
FwvID/fQGlpY3soi/lMTww: folds
IZng3w8jiJHHp3LbYKLi4w: folds
iI/NMpRxMkGieArQEhACSA: raises $2 to $4
8srN1dKQePlsv0GyTada+Q: calls $2
*** FLOP *** [Td Kh 9c]
iI/NMpRxMkGieArQEhACSA: checks
8srN1dKQePlsv0GyTada+Q: checks
*** TURN *** [Td Kh 9c] [Ad]
iI/NMpRxMkGieArQEhACSA: checks
8srN1dKQePlsv0GyTada+Q: bets $4
iI/NMpRxMkGieArQEhACSA: folds
8srN1dKQePlsv0GyTada+Q collected $7.60 from pot
*** SUMMARY ***
Total pot $8 | Rake $0.40
Board [Td Kh 9c Ad]
Seat 1: FwvID/fQGlpY3soi/lMTww folded before Flop (didn't bet)
Seat 2: IZng3w8jiJHHp3LbYKLi4w (button) folded before Flop (didn't bet)
Seat 3: iI/NMpRxMkGieArQEhACSA (small blind) folded on the Turn
Seat 4: 8srN1dKQePlsv0GyTada+Q (big blind) collected ($7.60)
Seat 5: A2GTwTiwkb1ilNWgW487Vg folded before Flop (didn't bet)
Seat 6: 692Q4sfB0gTElzS0WMeg+A folded before Flop (didn't bet)



PokerStars Game #59941394412:  Hold'em No Limit ($1/$2) - 2009/07/01 1:34:13 ET
Table 'mGpP9StWRnoeiBDExc6Frg' 6-max Seat #3 is the button
Seat 1: VvdR9F3I+2yELkfTVvC1dg ($313.60 in chips)
Seat 2: vkfxu8f/jMYKUk6Ly4eujw ($197 in chips)
Seat 3: 7acrZUQC3Zc9BNLjoKIcLQ ($22.15 in chips)
Seat 4: 4dcDwIHRm96PwtqkpQiuiA ($77.70 in chips)
Seat 5: d1puGuVBE0fidn+5eRJ0tw ($192.95 in chips)
Seat 6: B2Ih1sr5VZk+8He7rcrMtQ ($434.05 in chips)
4dcDwIHRm96PwtqkpQiuiA: posts small blind $1
d1puGuVBE0fidn+5eRJ0tw: posts big blind $2
*** HOLE CARDS ***
B2Ih1sr5VZk+8He7rcrMtQ: folds
VvdR9F3I+2yELkfTVvC1dg: folds
vkfxu8f/jMYKUk6Ly4eujw: folds
7acrZUQC3Zc9BNLjoKIcLQ: raises $4 to $6
4dcDwIHRm96PwtqkpQiuiA: folds
d1puGuVBE0fidn+5eRJ0tw: folds
7acrZUQC3Zc9BNLjoKIcLQ collected $5 from pot
*** SUMMARY ***
Total pot $5 | Rake $0
Seat 1: VvdR9F3I+2yELkfTVvC1dg folded before Flop (didn't bet)
Seat 2: vkfxu8f/jMYKUk6Ly4eujw folded before Flop (didn't bet)
Seat 3: 7acrZUQC3Zc9BNLjoKIcLQ (button) collected ($5)
Seat 4: 4dcDwIHRm96PwtqkpQiuiA (small blind) folded before Flop
Seat 5: d1puGuVBE0fidn+5eRJ0tw (big blind) folded before Flop
Seat 6: B2Ih1sr5VZk+8He7rcrMtQ folded before Flop (didn't bet)



PokerStars Game #59941394360:  Hold'em No Limit ($1/$2) - 2009/07/01 1:34:13 ET
Table 'P/yCfYl1GfGsu/e6DxDy/A' 2-max Seat #2 is the button
Seat 1: 7fOCUy3x9hdkmXkkDNolGQ ($527.50 in chips)
Seat 2: RwDoM55ZeQuI2ADyJhOb2Q ($953 in chips)
RwDoM55ZeQuI2ADyJhOb2Q: posts small blind $1
7fOCUy3x9hdkmXkkDNolGQ: posts big blind $2
*** HOLE CARDS ***
RwDoM55ZeQuI2ADyJhOb2Q: folds
7fOCUy3x9hdkmXkkDNolGQ collected $2 from pot
7fOCUy3x9hdkmXkkDNolGQ: doesn't show hand
*** SUMMARY ***
Total pot $2 | Rake $0
Seat 1: 7fOCUy3x9hdkmXkkDNolGQ (big blind) collected ($2)
Seat 2: RwDoM55ZeQuI2ADyJhOb2Q (button) (small blind) folded before Flop



PokerStars Game #59941396008:  Hold'em No Limit ($1/$2) - 2009/07/01 1:34:16 ET
Table 'ZzSIe0zTCDv+n6hfbY5tTg' 6-max Seat #6 is the button
Seat 1: VvdR9F3I+2yELkfTVvC1dg ($200 in chips)
Seat 2: B87ikIyZ/TzAVeXf38Ny0g ($286 in chips)
Seat 3: gsugPj31Hui3Jefl98MBOA ($353 in chips)
Seat 4: qXDd0ZyMIse0OBu8pxeQ3Q ($266 in chips)
Seat 5: 3dAbvkxS5NPQTBAbvpinVg ($477.30 in chips)
Seat 6: 09BNF4quPDzanQzM8vc6WA ($23.05 in chips)
VvdR9F3I+2yELkfTVvC1dg: posts small blind $1
B87ikIyZ/TzAVeXf38Ny0g: posts big blind $2
*** HOLE CARDS ***
gsugPj31Hui3Jefl98MBOA: folds
qXDd0ZyMIse0OBu8pxeQ3Q: folds
3dAbvkxS5NPQTBAbvpinVg: folds
09BNF4quPDzanQzM8vc6WA: folds
VvdR9F3I+2yELkfTVvC1dg: folds
B87ikIyZ/TzAVeXf38Ny0g collected $2 from pot
B87ikIyZ/TzAVeXf38Ny0g: doesn't show hand
*** SUMMARY ***
Total pot $2 | Rake $0
Seat 1: VvdR9F3I+2yELkfTVvC1dg (small blind) folded before Flop
Seat 2: B87ikIyZ/TzAVeXf38Ny0g (big blind) collected ($2)
Seat 3: gsugPj31Hui3Jefl98MBOA folded before Flop (didn't bet)
Seat 4: qXDd0ZyMIse0OBu8pxeQ3Q folded before Flop (didn't bet)
Seat 5: 3dAbvkxS5NPQTBAbvpinVg folded before Flop (didn't bet)
Seat 6: 09BNF4quPDzanQzM8vc6WA (button) folded before Flop (didn't bet)



PokerStars Game #59941396538:  Hold'em No Limit ($1/$2) - 2009/07/01 1:34:17 ET
Table 'SF49/KQm8T4taMp6kb+HXA' 9-max Seat #5 is the button
Seat 1: CUZwDpLTQKhzarPe+JCLOQ ($303.15 in chips)
Seat 2: rW/MyplHylMSBRaoRUzWrg ($43 in chips)
Seat 3: pCmk6FpSOLJ+85o1tLHIag ($280.75 in chips)
Seat 4: HffgoYm61KgkdMe/DYChIQ ($259.50 in chips)
Seat 5: ri8CLkX3e9JF34dQNbsHGA ($40 in chips)
Seat 7: nXDI8Y/S6POzRwANu3d8hQ ($38 in chips)
Seat 8: GgrYze3jkUdSO7a7CuJGDw ($197 in chips)
Seat 9: /inIs/z/PcX+TniIFpaxpg ($320.15 in chips)
nXDI8Y/S6POzRwANu3d8hQ: posts small blind $1
GgrYze3jkUdSO7a7CuJGDw: posts big blind $2
*** HOLE CARDS ***
/inIs/z/PcX+TniIFpaxpg: folds
CUZwDpLTQKhzarPe+JCLOQ: folds
rW/MyplHylMSBRaoRUzWrg: folds
pCmk6FpSOLJ+85o1tLHIag: folds
HffgoYm61KgkdMe/DYChIQ: calls $2
ri8CLkX3e9JF34dQNbsHGA: folds
nXDI8Y/S6POzRwANu3d8hQ: folds
GgrYze3jkUdSO7a7CuJGDw: checks
*** FLOP *** [4d 8s 2d]
GgrYze3jkUdSO7a7CuJGDw: checks
HffgoYm61KgkdMe/DYChIQ: bets $2
GgrYze3jkUdSO7a7CuJGDw: folds
HffgoYm61KgkdMe/DYChIQ collected $4.75 from pot
HffgoYm61KgkdMe/DYChIQ: doesn't show hand
*** SUMMARY ***
Total pot $5 | Rake $0.25
Board [4d 8s 2d]
Seat 1: CUZwDpLTQKhzarPe+JCLOQ folded before Flop (didn't bet)
Seat 2: rW/MyplHylMSBRaoRUzWrg folded before Flop (didn't bet)
Seat 3: pCmk6FpSOLJ+85o1tLHIag folded before Flop (didn't bet)
Seat 4: HffgoYm61KgkdMe/DYChIQ collected ($4.75)
Seat 5: ri8CLkX3e9JF34dQNbsHGA (button) folded before Flop (didn't bet)
Seat 7: nXDI8Y/S6POzRwANu3d8hQ (small blind) folded before Flop
Seat 8: GgrYze3jkUdSO7a7CuJGDw (big blind) folded on the Flop
Seat 9: /inIs/z/PcX+TniIFpaxpg folded before Flop (didn't bet)



PokerStars Game #59941397258:  Hold'em No Limit ($1/$2) - 2009/07/01 1:34:18 ET
Table 'eTkRjRjsYr567snmNk8kNQ' 2-max Seat #2 is the button
Seat 1: t6Jd836OSEMbcRi7rfGp5g ($205.50 in chips)
Seat 2: UNpnKQk0gkkyFJen8upqag ($290.50 in chips)
UNpnKQk0gkkyFJen8upqag: posts small blind $1
t6Jd836OSEMbcRi7rfGp5g: posts big blind $2
*** HOLE CARDS ***
UNpnKQk0gkkyFJen8upqag: raises $4 to $6
t6Jd836OSEMbcRi7rfGp5g: folds
UNpnKQk0gkkyFJen8upqag collected $4 from pot
*** SUMMARY ***
Total pot $4 | Rake $0
Seat 1: t6Jd836OSEMbcRi7rfGp5g (big blind) folded before Flop
Seat 2: UNpnKQk0gkkyFJen8upqag (button) (small blind) collected ($4)



PokerStars Game #59941397740:  Hold'em No Limit ($1/$2) - 2009/07/01 1:34:19 ET
Table '3WCXyaiCAbqSShQu7FIjvA' 9-max Seat #3 is the button
Seat 1: kTCkABD1UUldS9DFRGfCwQ ($156.75 in chips)
Seat 2: TAfo4veNRaRlzDXMMYS3Jg ($37 in chips)
Seat 3: 5Q8U6iZbeO7xJSS4qvDP5g ($273.85 in chips)
Seat 4: waEF/+pxZTxNo4FvsORuXg ($80.40 in chips)
Seat 5: CkE3IyJF1KvdaAOmZY5XqQ ($203 in chips)
Seat 6: 5jQlngvMSqM/WoonOcR5kw ($245.35 in chips)
Seat 8: 1CtiZuXDFaJL1dJPQKyi8Q ($239.05 in chips)
Seat 9: FiXPLJyqb24l32QST2TInw ($144.40 in chips)
waEF/+pxZTxNo4FvsORuXg: posts small blind $1
CkE3IyJF1KvdaAOmZY5XqQ: posts big blind $2
nXDI8Y/S6POzRwANu3d8hQ: sits out
*** HOLE CARDS ***
5jQlngvMSqM/WoonOcR5kw: calls $2
1CtiZuXDFaJL1dJPQKyi8Q: folds
FiXPLJyqb24l32QST2TInw: calls $2
kTCkABD1UUldS9DFRGfCwQ: calls $2
TAfo4veNRaRlzDXMMYS3Jg: folds
5Q8U6iZbeO7xJSS4qvDP5g: folds
waEF/+pxZTxNo4FvsORuXg: calls $1
CkE3IyJF1KvdaAOmZY5XqQ: checks
*** FLOP *** [Qh Kc 7h]
waEF/+pxZTxNo4FvsORuXg: checks
CkE3IyJF1KvdaAOmZY5XqQ: checks
5jQlngvMSqM/WoonOcR5kw: bets $8
FiXPLJyqb24l32QST2TInw: calls $8
kTCkABD1UUldS9DFRGfCwQ: folds
waEF/+pxZTxNo4FvsORuXg: folds
CkE3IyJF1KvdaAOmZY5XqQ: folds
*** TURN *** [Qh Kc 7h] [Qs]
5jQlngvMSqM/WoonOcR5kw: bets $8
FiXPLJyqb24l32QST2TInw: calls $8
*** RIVER *** [Qh Kc 7h Qs] [3c]
5jQlngvMSqM/WoonOcR5kw: bets $10
FiXPLJyqb24l32QST2TInw: calls $10
*** SHOW DOWN ***
5jQlngvMSqM/WoonOcR5kw: shows [Qc 8h] (three of a kind, Queens)
FiXPLJyqb24l32QST2TInw: mucks hand
5jQlngvMSqM/WoonOcR5kw collected $59 from pot
*** SUMMARY ***
Total pot $62 | Rake $3
Board [Qh Kc 7h Qs 3c]
Seat 1: kTCkABD1UUldS9DFRGfCwQ folded on the Flop
Seat 2: TAfo4veNRaRlzDXMMYS3Jg folded before Flop (didn't bet)
Seat 3: 5Q8U6iZbeO7xJSS4qvDP5g (button) folded before Flop (didn't bet)
Seat 4: waEF/+pxZTxNo4FvsORuXg (small blind) folded on the Flop
Seat 5: CkE3IyJF1KvdaAOmZY5XqQ (big blind) folded on the Flop
Seat 6: 5jQlngvMSqM/WoonOcR5kw showed [Qc 8h] and won ($59) with three of a kind, Queens
Seat 8: 1CtiZuXDFaJL1dJPQKyi8Q folded before Flop (didn't bet)
Seat 9: FiXPLJyqb24l32QST2TInw mucked



PokerStars Game #59941398150:  Hold'em No Limit ($1/$2) - 2009/07/01 1:34:19 ET
Table '4NGNnZ/osQfNq6abYqkJeA' 6-max Seat #3 is the button
Seat 2: 669iGNwYwgRZg3nhS+aDAQ ($98.25 in chips)
Seat 3: 54yWzRRgS0oZ+S6LwZBxMQ ($34 in chips)
Seat 4: sY+4Uuh5z/6AbXXaCS10jw ($226.25 in chips)
Seat 5: VvdR9F3I+2yELkfTVvC1dg ($238.85 in chips)
sY+4Uuh5z/6AbXXaCS10jw: posts small blind $1
VvdR9F3I+2yELkfTVvC1dg: posts big blind $2
/PH6Ffnho4Ysm8S3V/oa+w: sits out
vkfxu8f/jMYKUk6Ly4eujw: sits out
*** HOLE CARDS ***
669iGNwYwgRZg3nhS+aDAQ: folds
54yWzRRgS0oZ+S6LwZBxMQ: folds
sY+4Uuh5z/6AbXXaCS10jw: folds
VvdR9F3I+2yELkfTVvC1dg collected $2 from pot
VvdR9F3I+2yELkfTVvC1dg: doesn't show hand
*** SUMMARY ***
Total pot $2 | Rake $0
Seat 2: 669iGNwYwgRZg3nhS+aDAQ folded before Flop (didn't bet)
Seat 3: 54yWzRRgS0oZ+S6LwZBxMQ (button) folded before Flop (didn't bet)
Seat 4: sY+4Uuh5z/6AbXXaCS10jw (small blind) folded before Flop
Seat 5: VvdR9F3I+2yELkfTVvC1dg (big blind) collected ($2)



PokerStars Game #59941398542:  Hold'em No Limit ($1/$2) - 2009/07/01 1:34:20 ET
Table 'gnHBqWll9O3fxG7Ojkz/ng' 9-max Seat #1 is the button
Seat 1: TAfo4veNRaRlzDXMMYS3Jg ($31 in chips)
Seat 2: H6Z4+qu8gR0VUiPOijndVg ($325.25 in chips)
Seat 3: 5Q8U6iZbeO7xJSS4qvDP5g ($221.05 in chips)
Seat 4: nXDI8Y/S6POzRwANu3d8hQ ($39 in chips)
Seat 5: rBQDMkKm9cZn6M9NPsiVew ($227.15 in chips)
Seat 7: jqui3xAWCkcdPW36a6BD+w ($347.55 in chips)
Seat 8: cM6efHzdxoqYm0EQKP4TTQ ($84.15 in chips)
Seat 9: GX1heJ+DSsvm7gzSPsYhhQ ($50.35 in chips)
H6Z4+qu8gR0VUiPOijndVg: posts small blind $1
5Q8U6iZbeO7xJSS4qvDP5g: posts big blind $2
MeleaB: sits out
*** HOLE CARDS ***
nXDI8Y/S6POzRwANu3d8hQ: folds
rBQDMkKm9cZn6M9NPsiVew: folds
jqui3xAWCkcdPW36a6BD+w: folds
cM6efHzdxoqYm0EQKP4TTQ: calls $2
GX1heJ+DSsvm7gzSPsYhhQ: folds
TAfo4veNRaRlzDXMMYS3Jg: folds
H6Z4+qu8gR0VUiPOijndVg: calls $1
5Q8U6iZbeO7xJSS4qvDP5g: checks
*** FLOP *** [6c Jh 6d]
H6Z4+qu8gR0VUiPOijndVg: bets $4
5Q8U6iZbeO7xJSS4qvDP5g: folds
cM6efHzdxoqYm0EQKP4TTQ: folds
H6Z4+qu8gR0VUiPOijndVg collected $5.70 from pot
H6Z4+qu8gR0VUiPOijndVg: doesn't show hand
*** SUMMARY ***
Total pot $6 | Rake $0.30
Board [6c Jh 6d]
Seat 1: TAfo4veNRaRlzDXMMYS3Jg (button) folded before Flop (didn't bet)
Seat 2: H6Z4+qu8gR0VUiPOijndVg (small blind) collected ($5.70)
Seat 3: 5Q8U6iZbeO7xJSS4qvDP5g (big blind) folded on the Flop
Seat 4: nXDI8Y/S6POzRwANu3d8hQ folded before Flop (didn't bet)
Seat 5: rBQDMkKm9cZn6M9NPsiVew folded before Flop (didn't bet)
Seat 7: jqui3xAWCkcdPW36a6BD+w folded before Flop (didn't bet)
Seat 8: cM6efHzdxoqYm0EQKP4TTQ folded on the Flop
Seat 9: GX1heJ+DSsvm7gzSPsYhhQ folded before Flop (didn't bet)



PokerStars Game #59941398582:  Hold'em No Limit ($1/$2) - 2009/07/01 1:34:20 ET
Table 'ztv6V3FN2bQ9nmJPPdx6nQ' 6-max Seat #2 is the button
Seat 1: 6fLdOUCRtX71xbVRhJEq8w ($241.35 in chips)
Seat 2: 5Y+ZGWLI4gnlpApDX5vy1A ($386.75 in chips)
Seat 3: ubtx4Z5L+AcK71MTvYiGVw ($246 in chips)
Seat 5: sTPOWERd9HWPCNrDBwsVjA ($222.80 in chips)
Seat 6: mfy7uGZcqA2PVQqEVbJ7+g ($97.45 in chips)
ubtx4Z5L+AcK71MTvYiGVw: posts small blind $1
sTPOWERd9HWPCNrDBwsVjA: posts big blind $2
*** HOLE CARDS ***
mfy7uGZcqA2PVQqEVbJ7+g: folds
6fLdOUCRtX71xbVRhJEq8w: folds
5Y+ZGWLI4gnlpApDX5vy1A: raises $2 to $4
ubtx4Z5L+AcK71MTvYiGVw: folds
sTPOWERd9HWPCNrDBwsVjA: folds
5Y+ZGWLI4gnlpApDX5vy1A collected $5 from pot
5Y+ZGWLI4gnlpApDX5vy1A: doesn't show hand
*** SUMMARY ***
Total pot $5 | Rake $0
Seat 1: 6fLdOUCRtX71xbVRhJEq8w folded before Flop (didn't bet)
Seat 2: 5Y+ZGWLI4gnlpApDX5vy1A (button) collected ($5)
Seat 3: ubtx4Z5L+AcK71MTvYiGVw (small blind) folded before Flop
Seat 5: sTPOWERd9HWPCNrDBwsVjA (big blind) folded before Flop
Seat 6: mfy7uGZcqA2PVQqEVbJ7+g folded before Flop (didn't bet)



PokerStars Game #59941399196:  Hold'em No Limit ($1/$2) - 2009/07/01 1:34:21 ET
Table 'NmY84NAf9Mh0ckAckHnh5g' 2-max Seat #1 is the button
Seat 1: 6hvg964TSqZ3AL/0XK9aVQ ($359.50 in chips)
Seat 2: RwDoM55ZeQuI2ADyJhOb2Q ($638.20 in chips)
6hvg964TSqZ3AL/0XK9aVQ: posts small blind $1
RwDoM55ZeQuI2ADyJhOb2Q: posts big blind $2
*** HOLE CARDS ***
6hvg964TSqZ3AL/0XK9aVQ: raises $4 to $6
RwDoM55ZeQuI2ADyJhOb2Q: calls $4
*** FLOP *** [Th Tc 8h]
RwDoM55ZeQuI2ADyJhOb2Q: checks
6hvg964TSqZ3AL/0XK9aVQ: checks
*** TURN *** [Th Tc 8h] [Qs]
RwDoM55ZeQuI2ADyJhOb2Q: bets $8
6hvg964TSqZ3AL/0XK9aVQ: calls $8
*** RIVER *** [Th Tc 8h Qs] [Jd]
RwDoM55ZeQuI2ADyJhOb2Q: bets $22
6hvg964TSqZ3AL/0XK9aVQ: calls $22
*** SHOW DOWN ***
RwDoM55ZeQuI2ADyJhOb2Q: shows [8c Qc] (two pair, Queens and Tens)
6hvg964TSqZ3AL/0XK9aVQ: mucks hand
RwDoM55ZeQuI2ADyJhOb2Q collected $71.50 from pot
*** SUMMARY ***
Total pot $72 | Rake $0.50
Board [Th Tc 8h Qs Jd]
Seat 1: 6hvg964TSqZ3AL/0XK9aVQ (button) (small blind) mucked
Seat 2: RwDoM55ZeQuI2ADyJhOb2Q (big blind) showed [8c Qc] and won ($71.50) with two pair, Queens and Tens



PokerStars Game #59941399688:  Hold'em No Limit ($1/$2) - 2009/07/01 1:34:22 ET
Table 'AtOXMvcrtQM8yLNcALmfLQ' 2-max Seat #1 is the button
Seat 1: +HlQuAsMqZGYYtjcPO/a3A ($358.20 in chips)
Seat 2: pVqEzK9wXlRMECnb1Zg4Zw ($205.50 in chips)
+HlQuAsMqZGYYtjcPO/a3A: posts small blind $1
pVqEzK9wXlRMECnb1Zg4Zw: posts big blind $2
*** HOLE CARDS ***
+HlQuAsMqZGYYtjcPO/a3A: raises $4 to $6
pVqEzK9wXlRMECnb1Zg4Zw: calls $4
*** FLOP *** [2d 9s Js]
pVqEzK9wXlRMECnb1Zg4Zw: checks
+HlQuAsMqZGYYtjcPO/a3A: bets $8
pVqEzK9wXlRMECnb1Zg4Zw: folds
+HlQuAsMqZGYYtjcPO/a3A collected $11.50 from pot
*** SUMMARY ***
Total pot $12 | Rake $0.50
Board [2d 9s Js]
Seat 1: +HlQuAsMqZGYYtjcPO/a3A (button) (small blind) collected ($11.50)
Seat 2: pVqEzK9wXlRMECnb1Zg4Zw (big blind) folded on the Flop



PokerStars Game #59941399690:  Hold'em No Limit ($1/$2) - 2009/07/01 1:34:22 ET
Table 'P/yCfYl1GfGsu/e6DxDy/A' 2-max Seat #1 is the button
Seat 1: 7fOCUy3x9hdkmXkkDNolGQ ($528.50 in chips)
Seat 2: RwDoM55ZeQuI2ADyJhOb2Q ($952 in chips)
7fOCUy3x9hdkmXkkDNolGQ: posts small blind $1
RwDoM55ZeQuI2ADyJhOb2Q: posts big blind $2
*** HOLE CARDS ***
7fOCUy3x9hdkmXkkDNolGQ: folds
RwDoM55ZeQuI2ADyJhOb2Q collected $2 from pot
RwDoM55ZeQuI2ADyJhOb2Q: doesn't show hand
*** SUMMARY ***
Total pot $2 | Rake $0
Seat 1: 7fOCUy3x9hdkmXkkDNolGQ (button) (small blind) folded before Flop
Seat 2: RwDoM55ZeQuI2ADyJhOb2Q (big blind) collected ($2)



PokerStars Game #59941400124:  Hold'em No Limit ($1/$2) - 2009/07/01 1:34:23 ET
Table 'CFkQcfWjKccZaZDf71FK+w' 6-max Seat #6 is the button
Seat 1: vkfxu8f/jMYKUk6Ly4eujw ($198 in chips)
Seat 2: ewN/vzF22+/gdzjIKBOlkA ($207.80 in chips)
Seat 3: 09BNF4quPDzanQzM8vc6WA ($46.65 in chips)
Seat 4: ygTTt5ehT4aF86q1a8/R+w ($217.25 in chips)
Seat 5: 2lOU1DcvUZaMcxZ95XfzXw ($154.60 in chips)
Seat 6: ORVqY3rf9X6ANA/8s+On2Q ($144.60 in chips)
vkfxu8f/jMYKUk6Ly4eujw: posts small blind $1
ewN/vzF22+/gdzjIKBOlkA: posts big blind $2
*** HOLE CARDS ***
09BNF4quPDzanQzM8vc6WA: folds
ygTTt5ehT4aF86q1a8/R+w: raises $5 to $7
2lOU1DcvUZaMcxZ95XfzXw: calls $7
ORVqY3rf9X6ANA/8s+On2Q: folds
vkfxu8f/jMYKUk6Ly4eujw: folds
ewN/vzF22+/gdzjIKBOlkA: folds
*** FLOP *** [4d 3c 9h]
ygTTt5ehT4aF86q1a8/R+w: checks
2lOU1DcvUZaMcxZ95XfzXw: checks
*** TURN *** [4d 3c 9h] [8d]
ygTTt5ehT4aF86q1a8/R+w: bets $8
2lOU1DcvUZaMcxZ95XfzXw: calls $8
*** RIVER *** [4d 3c 9h 8d] [2c]
ygTTt5ehT4aF86q1a8/R+w: bets $32
2lOU1DcvUZaMcxZ95XfzXw: folds
ygTTt5ehT4aF86q1a8/R+w collected $31.40 from pot
*** SUMMARY ***
Total pot $33 | Rake $1.60
Board [4d 3c 9h 8d 2c]
Seat 1: vkfxu8f/jMYKUk6Ly4eujw (small blind) folded before Flop
Seat 2: ewN/vzF22+/gdzjIKBOlkA (big blind) folded before Flop
Seat 3: 09BNF4quPDzanQzM8vc6WA folded before Flop (didn't bet)
Seat 4: ygTTt5ehT4aF86q1a8/R+w collected ($31.40)
Seat 5: 2lOU1DcvUZaMcxZ95XfzXw folded on the River
Seat 6: ORVqY3rf9X6ANA/8s+On2Q (button) folded before Flop (didn't bet)



PokerStars Game #59941400494:  Hold'em No Limit ($1/$2) - 2009/07/01 1:34:24 ET
Table 'aSf77Sj8QEnzcc0WaxVD4Q' 6-max Seat #2 is the button
Seat 1: UELtvp+JfwI7XDGVwSxZXA ($291.10 in chips)
Seat 2: vkfxu8f/jMYKUk6Ly4eujw ($208.80 in chips)
Seat 3: 9dpyyjDTCed6nV7JhaUUpw ($490.70 in chips)
Seat 4: YsLQ3BAvgQHWXMAv3Wv6Hg ($200 in chips)
Seat 5: VvdR9F3I+2yELkfTVvC1dg ($261 in chips)
Seat 6: vkoJRf3gidxY1pPi0AFWww ($131.35 in chips)
9dpyyjDTCed6nV7JhaUUpw: posts small blind $1
YsLQ3BAvgQHWXMAv3Wv6Hg: posts big blind $2
*** HOLE CARDS ***
VvdR9F3I+2yELkfTVvC1dg: folds
vkoJRf3gidxY1pPi0AFWww: calls $2
UELtvp+JfwI7XDGVwSxZXA: calls $2
vkfxu8f/jMYKUk6Ly4eujw: folds
9dpyyjDTCed6nV7JhaUUpw: raises $12 to $14
YsLQ3BAvgQHWXMAv3Wv6Hg: folds
vkoJRf3gidxY1pPi0AFWww: folds
UELtvp+JfwI7XDGVwSxZXA: folds
9dpyyjDTCed6nV7JhaUUpw collected $8 from pot
*** SUMMARY ***
Total pot $8 | Rake $0
Seat 1: UELtvp+JfwI7XDGVwSxZXA folded before Flop
Seat 2: vkfxu8f/jMYKUk6Ly4eujw (button) folded before Flop (didn't bet)
Seat 3: 9dpyyjDTCed6nV7JhaUUpw (small blind) collected ($8)
Seat 4: YsLQ3BAvgQHWXMAv3Wv6Hg (big blind) folded before Flop
Seat 5: VvdR9F3I+2yELkfTVvC1dg folded before Flop (didn't bet)
Seat 6: vkoJRf3gidxY1pPi0AFWww folded before Flop



PokerStars Game #59941400630:  Hold'em No Limit ($1/$2) - 2009/07/01 1:34:24 ET
Table 'G1Oqdy4Pqdb5gtx40rUBzA' 6-max Seat #6 is the button
Seat 1: ubtx4Z5L+AcK71MTvYiGVw ($201 in chips)
Seat 2: 4uqU0dG67owXuPz303Al4w ($515.25 in chips)
Seat 3: VvdR9F3I+2yELkfTVvC1dg ($241.25 in chips)
Seat 4: B87ikIyZ/TzAVeXf38Ny0g ($214.55 in chips)
Seat 5: F1+Ml47qRQWunzPnGhLLzQ ($186.50 in chips)
Seat 6: qCnEYuAE5y5A7bk6fO5/jQ ($200 in chips)
ubtx4Z5L+AcK71MTvYiGVw: posts small blind $1
4uqU0dG67owXuPz303Al4w: posts big blind $2
*** HOLE CARDS ***
VvdR9F3I+2yELkfTVvC1dg: folds
B87ikIyZ/TzAVeXf38Ny0g: folds
F1+Ml47qRQWunzPnGhLLzQ: raises $4 to $6
qCnEYuAE5y5A7bk6fO5/jQ: folds
ubtx4Z5L+AcK71MTvYiGVw: folds
4uqU0dG67owXuPz303Al4w: folds
F1+Ml47qRQWunzPnGhLLzQ collected $5 from pot
F1+Ml47qRQWunzPnGhLLzQ: doesn't show hand
*** SUMMARY ***
Total pot $5 | Rake $0
Seat 1: ubtx4Z5L+AcK71MTvYiGVw (small blind) folded before Flop
Seat 2: 4uqU0dG67owXuPz303Al4w (big blind) folded before Flop
Seat 3: VvdR9F3I+2yELkfTVvC1dg folded before Flop (didn't bet)
Seat 4: B87ikIyZ/TzAVeXf38Ny0g folded before Flop (didn't bet)
Seat 5: F1+Ml47qRQWunzPnGhLLzQ collected ($5)
Seat 6: qCnEYuAE5y5A7bk6fO5/jQ (button) folded before Flop (didn't bet)



PokerStars Game #59941401310:  Hold'em No Limit ($1/$2) - 2009/07/01 1:34:25 ET
Table '/ci73fTmzTzmGWzAtqEX2Q' 9-max Seat #5 is the button
Seat 1: 9efVc1cB3yHt4TvBkTusPw ($149.90 in chips)
Seat 2: pN/Ip0ePsUVIdUlGgLrkUw ($225 in chips)
Seat 3: kK1+5ivyJZeA8hQF2pdvvQ ($64.55 in chips)
Seat 4: 2yq7Zp4xmrhAw8+37hTkaA ($166.20 in chips)
Seat 5: 1CtiZuXDFaJL1dJPQKyi8Q ($215 in chips)
Seat 6: GX1heJ+DSsvm7gzSPsYhhQ ($45.65 in chips)
Seat 8: /inIs/z/PcX+TniIFpaxpg ($37 in chips)
Seat 9: S8aS+9FTYQ/ICLBNThcrkg ($183 in chips)
GX1heJ+DSsvm7gzSPsYhhQ: posts small blind $1
rW/MyplHylMSBRaoRUzWrg: is sitting out
/inIs/z/PcX+TniIFpaxpg: posts big blind $2
*** HOLE CARDS ***
rW/MyplHylMSBRaoRUzWrg leaves the table
S8aS+9FTYQ/ICLBNThcrkg: folds
9efVc1cB3yHt4TvBkTusPw: raises $2 to $4
pN/Ip0ePsUVIdUlGgLrkUw: folds
kK1+5ivyJZeA8hQF2pdvvQ: folds
+T/63sAeZzWyHchahJ36GQ joins the table at seat #7
2yq7Zp4xmrhAw8+37hTkaA: folds
1CtiZuXDFaJL1dJPQKyi8Q: folds
GX1heJ+DSsvm7gzSPsYhhQ: folds
/inIs/z/PcX+TniIFpaxpg: folds
9efVc1cB3yHt4TvBkTusPw collected $5 from pot
*** SUMMARY ***
Total pot $5 | Rake $0
Seat 1: 9efVc1cB3yHt4TvBkTusPw collected ($5)
Seat 2: pN/Ip0ePsUVIdUlGgLrkUw folded before Flop (didn't bet)
Seat 3: kK1+5ivyJZeA8hQF2pdvvQ folded before Flop (didn't bet)
Seat 4: 2yq7Zp4xmrhAw8+37hTkaA folded before Flop (didn't bet)
Seat 5: 1CtiZuXDFaJL1dJPQKyi8Q (button) folded before Flop (didn't bet)
Seat 6: GX1heJ+DSsvm7gzSPsYhhQ (small blind) folded before Flop
Seat 8: /inIs/z/PcX+TniIFpaxpg (big blind) folded before Flop
Seat 9: S8aS+9FTYQ/ICLBNThcrkg folded before Flop (didn't bet)



PokerStars Game #59941401414:  Hold'em No Limit ($1/$2) - 2009/07/01 1:34:25 ET
Table 'on4i1U1lCRmxsduFD3xiSg' 9-max Seat #8 is the button
Seat 1: so5k3vFDmokh2q3dImJ1GQ ($179.30 in chips)
Seat 2: NqSvZNzJ4RkR3sCmgQnyLw ($47.85 in chips)
Seat 3: GX1heJ+DSsvm7gzSPsYhhQ ($29.70 in chips)
Seat 4: DFQVuszLVclqjA46pN4Vvw ($117 in chips)
Seat 6: +T/63sAeZzWyHchahJ36GQ ($37 in chips)
Seat 7: /inIs/z/PcX+TniIFpaxpg ($271.05 in chips)
Seat 8: ZYHoLw2lWmRS7CSHi8L8Xg ($200 in chips)
Seat 9: TAfo4veNRaRlzDXMMYS3Jg ($38 in chips)
TAfo4veNRaRlzDXMMYS3Jg: posts small blind $1
so5k3vFDmokh2q3dImJ1GQ: posts big blind $2
*** HOLE CARDS ***
NqSvZNzJ4RkR3sCmgQnyLw: folds
GX1heJ+DSsvm7gzSPsYhhQ: folds
DFQVuszLVclqjA46pN4Vvw: calls $2
+T/63sAeZzWyHchahJ36GQ: folds
/inIs/z/PcX+TniIFpaxpg: folds
ZYHoLw2lWmRS7CSHi8L8Xg: folds
TAfo4veNRaRlzDXMMYS3Jg: folds
so5k3vFDmokh2q3dImJ1GQ: checks
*** FLOP *** [4d 6s 2c]
so5k3vFDmokh2q3dImJ1GQ: checks
DFQVuszLVclqjA46pN4Vvw: checks
*** TURN *** [4d 6s 2c] [Kd]
so5k3vFDmokh2q3dImJ1GQ: checks
DFQVuszLVclqjA46pN4Vvw: bets $6
so5k3vFDmokh2q3dImJ1GQ: folds
DFQVuszLVclqjA46pN4Vvw collected $4.75 from pot
*** SUMMARY ***
Total pot $5 | Rake $0.25
Board [4d 6s 2c Kd]
Seat 1: so5k3vFDmokh2q3dImJ1GQ (big blind) folded on the Turn
Seat 2: NqSvZNzJ4RkR3sCmgQnyLw folded before Flop (didn't bet)
Seat 3: GX1heJ+DSsvm7gzSPsYhhQ folded before Flop (didn't bet)
Seat 4: DFQVuszLVclqjA46pN4Vvw collected ($4.75)
Seat 6: +T/63sAeZzWyHchahJ36GQ folded before Flop (didn't bet)
Seat 7: /inIs/z/PcX+TniIFpaxpg folded before Flop (didn't bet)
Seat 8: ZYHoLw2lWmRS7CSHi8L8Xg (button) folded before Flop (didn't bet)
Seat 9: TAfo4veNRaRlzDXMMYS3Jg (small blind) folded before Flop



PokerStars Game #59941402974:  Hold'em No Limit ($1/$2) - 2009/07/01 1:34:28 ET
Table 'P/yCfYl1GfGsu/e6DxDy/A' 2-max Seat #2 is the button
Seat 1: 7fOCUy3x9hdkmXkkDNolGQ ($527.50 in chips)
Seat 2: RwDoM55ZeQuI2ADyJhOb2Q ($953 in chips)
RwDoM55ZeQuI2ADyJhOb2Q: posts small blind $1
7fOCUy3x9hdkmXkkDNolGQ: posts big blind $2
*** HOLE CARDS ***
RwDoM55ZeQuI2ADyJhOb2Q: folds
7fOCUy3x9hdkmXkkDNolGQ collected $2 from pot
7fOCUy3x9hdkmXkkDNolGQ: doesn't show hand
*** SUMMARY ***
Total pot $2 | Rake $0
Seat 1: 7fOCUy3x9hdkmXkkDNolGQ (big blind) collected ($2)
Seat 2: RwDoM55ZeQuI2ADyJhOb2Q (button) (small blind) folded before Flop



PokerStars Game #59941403380:  Hold'em No Limit ($1/$2) - 2009/07/01 1:34:29 ET
Table 'qVXak+oTeDXMGbWa4sDU5Q' 9-max Seat #6 is the button
Seat 1: H6Z4+qu8gR0VUiPOijndVg ($205.55 in chips)
Seat 2: rW/MyplHylMSBRaoRUzWrg ($81 in chips)
Seat 3: WUlHm+ydPPHG7Lb0rePSdA ($175.10 in chips)
Seat 4: lQYT23h5QCUVZAKxjOO39Q ($200.70 in chips)
Seat 5: FWGiDqRwvLeKmHq9t4Jy9w ($265.80 in chips)
Seat 6: GX1heJ+DSsvm7gzSPsYhhQ ($40 in chips)
Seat 7: PfmlvZlFiss79a6IoEr11g ($161.30 in chips)
Seat 8: Z0rzUi0y1x80UdIpofoNbA ($125.55 in chips)
Seat 9: CkE3IyJF1KvdaAOmZY5XqQ ($200 in chips)
PfmlvZlFiss79a6IoEr11g: posts small blind $1
Z0rzUi0y1x80UdIpofoNbA: posts big blind $2
*** HOLE CARDS ***
CkE3IyJF1KvdaAOmZY5XqQ: folds
H6Z4+qu8gR0VUiPOijndVg: folds
rW/MyplHylMSBRaoRUzWrg: folds
WUlHm+ydPPHG7Lb0rePSdA: folds
lQYT23h5QCUVZAKxjOO39Q: folds
FWGiDqRwvLeKmHq9t4Jy9w: folds
GX1heJ+DSsvm7gzSPsYhhQ: raises $4 to $6
PfmlvZlFiss79a6IoEr11g: folds
Z0rzUi0y1x80UdIpofoNbA: folds
GX1heJ+DSsvm7gzSPsYhhQ collected $5 from pot
*** SUMMARY ***
Total pot $5 | Rake $0
Seat 1: H6Z4+qu8gR0VUiPOijndVg folded before Flop (didn't bet)
Seat 2: rW/MyplHylMSBRaoRUzWrg folded before Flop (didn't bet)
Seat 3: WUlHm+ydPPHG7Lb0rePSdA folded before Flop (didn't bet)
Seat 4: lQYT23h5QCUVZAKxjOO39Q folded before Flop (didn't bet)
Seat 5: FWGiDqRwvLeKmHq9t4Jy9w folded before Flop (didn't bet)
Seat 6: GX1heJ+DSsvm7gzSPsYhhQ (button) collected ($5)
Seat 7: PfmlvZlFiss79a6IoEr11g (small blind) folded before Flop
Seat 8: Z0rzUi0y1x80UdIpofoNbA (big blind) folded before Flop
Seat 9: CkE3IyJF1KvdaAOmZY5XqQ folded before Flop (didn't bet)



PokerStars Game #59941404528:  Hold'em No Limit ($1/$2) - 2009/07/01 1:34:31 ET
Table 'eyAQSIlgc2o1Jxvbve4WGg' 9-max Seat #2 is the button
Seat 1: UZEsV9yKUMqmpYPiOFpaZw ($100.20 in chips)
Seat 2: kM9CA+2UcdMjbCMbtUCGiA ($200 in chips)
Seat 4: CkE3IyJF1KvdaAOmZY5XqQ ($200 in chips)
Seat 5: mIKx5lhIt13X5eZQH0ZeMA ($126.15 in chips)
Seat 6: nXDI8Y/S6POzRwANu3d8hQ ($6 in chips)
Seat 7: u3OrI5uGx9mx1fE7dgr+EA ($75.20 in chips)
Seat 8: 1CtiZuXDFaJL1dJPQKyi8Q ($161.95 in chips)
Seat 9: WUlHm+ydPPHG7Lb0rePSdA ($125.95 in chips)
CkE3IyJF1KvdaAOmZY5XqQ: posts small blind $1
mIKx5lhIt13X5eZQH0ZeMA: posts big blind $2
*** HOLE CARDS ***
nXDI8Y/S6POzRwANu3d8hQ: raises $4 to $6 and is all-in
u3OrI5uGx9mx1fE7dgr+EA: folds
1CtiZuXDFaJL1dJPQKyi8Q: folds
WUlHm+ydPPHG7Lb0rePSdA: calls $6
UZEsV9yKUMqmpYPiOFpaZw: folds
kM9CA+2UcdMjbCMbtUCGiA: folds
CkE3IyJF1KvdaAOmZY5XqQ: folds
mIKx5lhIt13X5eZQH0ZeMA: folds
*** FLOP *** [3c Qs Jc]
*** TURN *** [3c Qs Jc] [2d]
*** RIVER *** [3c Qs Jc 2d] [3h]
*** SHOW DOWN ***
nXDI8Y/S6POzRwANu3d8hQ: shows [Ts As] (a pair of Threes)
WUlHm+ydPPHG7Lb0rePSdA: shows [4d 4s] (two pair, Fours and Threes)
WUlHm+ydPPHG7Lb0rePSdA collected $14.25 from pot
*** SUMMARY ***
Total pot $15 | Rake $0.75
Board [3c Qs Jc 2d 3h]
Seat 1: UZEsV9yKUMqmpYPiOFpaZw folded before Flop (didn't bet)
Seat 2: kM9CA+2UcdMjbCMbtUCGiA (button) folded before Flop (didn't bet)
Seat 4: CkE3IyJF1KvdaAOmZY5XqQ (small blind) folded before Flop
Seat 5: mIKx5lhIt13X5eZQH0ZeMA (big blind) folded before Flop
Seat 6: nXDI8Y/S6POzRwANu3d8hQ showed [Ts As] and lost with a pair of Threes
Seat 7: u3OrI5uGx9mx1fE7dgr+EA folded before Flop (didn't bet)
Seat 8: 1CtiZuXDFaJL1dJPQKyi8Q folded before Flop (didn't bet)
Seat 9: WUlHm+ydPPHG7Lb0rePSdA showed [4d 4s] and won ($14.25) with two pair, Fours and Threes



PokerStars Game #59941405288:  Hold'em No Limit ($1/$2) - 2009/07/01 1:34:32 ET
Table '4NGNnZ/osQfNq6abYqkJeA' 6-max Seat #4 is the button
Seat 2: 669iGNwYwgRZg3nhS+aDAQ ($98.25 in chips)
Seat 3: 54yWzRRgS0oZ+S6LwZBxMQ ($34 in chips)
Seat 4: sY+4Uuh5z/6AbXXaCS10jw ($225.25 in chips)
Seat 5: VvdR9F3I+2yELkfTVvC1dg ($239.85 in chips)
Seat 6: /PH6Ffnho4Ysm8S3V/oa+w ($40 in chips)
VvdR9F3I+2yELkfTVvC1dg: posts small blind $1
/PH6Ffnho4Ysm8S3V/oa+w: posts big blind $2
vkfxu8f/jMYKUk6Ly4eujw: sits out
*** HOLE CARDS ***
669iGNwYwgRZg3nhS+aDAQ: folds
54yWzRRgS0oZ+S6LwZBxMQ: calls $2
sY+4Uuh5z/6AbXXaCS10jw: folds
VvdR9F3I+2yELkfTVvC1dg: calls $1
/PH6Ffnho4Ysm8S3V/oa+w: checks
*** FLOP *** [7s Jh 5c]
VvdR9F3I+2yELkfTVvC1dg: checks
/PH6Ffnho4Ysm8S3V/oa+w: checks
54yWzRRgS0oZ+S6LwZBxMQ: checks
*** TURN *** [7s Jh 5c] [6c]
VvdR9F3I+2yELkfTVvC1dg: bets $4.15
/PH6Ffnho4Ysm8S3V/oa+w: folds
54yWzRRgS0oZ+S6LwZBxMQ: folds
VvdR9F3I+2yELkfTVvC1dg collected $5.70 from pot
VvdR9F3I+2yELkfTVvC1dg: doesn't show hand
*** SUMMARY ***
Total pot $6 | Rake $0.30
Board [7s Jh 5c 6c]
Seat 2: 669iGNwYwgRZg3nhS+aDAQ folded before Flop (didn't bet)
Seat 3: 54yWzRRgS0oZ+S6LwZBxMQ folded on the Turn
Seat 4: sY+4Uuh5z/6AbXXaCS10jw (button) folded before Flop (didn't bet)
Seat 5: VvdR9F3I+2yELkfTVvC1dg (small blind) collected ($5.70)
Seat 6: /PH6Ffnho4Ysm8S3V/oa+w (big blind) folded on the Turn



PokerStars Game #59941406614:  Hold'em No Limit ($1/$2) - 2009/07/01 1:34:34 ET
Table 'UGLAZZyv+cXmnKjYin0etA' 6-max Seat #5 is the button
Seat 1: vkfxu8f/jMYKUk6Ly4eujw ($204 in chips)
Seat 2: eDLH1PUXFpvJBNMXBVQcGA ($276.35 in chips)
Seat 3: ygTTt5ehT4aF86q1a8/R+w ($117.20 in chips)
Seat 4: SiGJDsvRViJX05vHhA80GQ ($234.85 in chips)
Seat 5: 54yWzRRgS0oZ+S6LwZBxMQ ($33 in chips)
Seat 6: sTPOWERd9HWPCNrDBwsVjA ($208.10 in chips)
sTPOWERd9HWPCNrDBwsVjA: posts small blind $1
vkfxu8f/jMYKUk6Ly4eujw: posts big blind $2
*** HOLE CARDS ***
eDLH1PUXFpvJBNMXBVQcGA: folds
ygTTt5ehT4aF86q1a8/R+w: folds
SiGJDsvRViJX05vHhA80GQ: folds
54yWzRRgS0oZ+S6LwZBxMQ: folds
sTPOWERd9HWPCNrDBwsVjA: raises $4 to $6
vkfxu8f/jMYKUk6Ly4eujw: folds
sTPOWERd9HWPCNrDBwsVjA collected $4 from pot
*** SUMMARY ***
Total pot $4 | Rake $0
Seat 1: vkfxu8f/jMYKUk6Ly4eujw (big blind) folded before Flop
Seat 2: eDLH1PUXFpvJBNMXBVQcGA folded before Flop (didn't bet)
Seat 3: ygTTt5ehT4aF86q1a8/R+w folded before Flop (didn't bet)
Seat 4: SiGJDsvRViJX05vHhA80GQ folded before Flop (didn't bet)
Seat 5: 54yWzRRgS0oZ+S6LwZBxMQ (button) folded before Flop (didn't bet)
Seat 6: sTPOWERd9HWPCNrDBwsVjA (small blind) collected ($4)



PokerStars Game #59941406560:  Hold'em No Limit ($1/$2) - 2009/07/01 1:34:34 ET
Table 'eTkRjRjsYr567snmNk8kNQ' 2-max Seat #1 is the button
Seat 1: t6Jd836OSEMbcRi7rfGp5g ($203.50 in chips)
Seat 2: UNpnKQk0gkkyFJen8upqag ($292.50 in chips)
t6Jd836OSEMbcRi7rfGp5g: posts small blind $1
UNpnKQk0gkkyFJen8upqag: posts big blind $2
*** HOLE CARDS ***
t6Jd836OSEMbcRi7rfGp5g: raises $4 to $6
UNpnKQk0gkkyFJen8upqag: calls $4
*** FLOP *** [3h As Jd]
UNpnKQk0gkkyFJen8upqag: checks
t6Jd836OSEMbcRi7rfGp5g: checks
*** TURN *** [3h As Jd] [Ad]
UNpnKQk0gkkyFJen8upqag: bets $8
t6Jd836OSEMbcRi7rfGp5g: folds
UNpnKQk0gkkyFJen8upqag collected $11.50 from pot
*** SUMMARY ***
Total pot $12 | Rake $0.50
Board [3h As Jd Ad]
Seat 1: t6Jd836OSEMbcRi7rfGp5g (button) (small blind) folded on the Turn
Seat 2: UNpnKQk0gkkyFJen8upqag (big blind) collected ($11.50)



PokerStars Game #59941407388:  Hold'em No Limit ($1/$2) - 2009/07/01 1:34:36 ET
Table 'P/yCfYl1GfGsu/e6DxDy/A' 2-max Seat #1 is the button
Seat 1: 7fOCUy3x9hdkmXkkDNolGQ ($528.50 in chips)
Seat 2: RwDoM55ZeQuI2ADyJhOb2Q ($952 in chips)
7fOCUy3x9hdkmXkkDNolGQ: posts small blind $1
RwDoM55ZeQuI2ADyJhOb2Q: posts big blind $2
*** HOLE CARDS ***
7fOCUy3x9hdkmXkkDNolGQ: folds
RwDoM55ZeQuI2ADyJhOb2Q collected $2 from pot
RwDoM55ZeQuI2ADyJhOb2Q: doesn't show hand
*** SUMMARY ***
Total pot $2 | Rake $0
Seat 1: 7fOCUy3x9hdkmXkkDNolGQ (button) (small blind) folded before Flop
Seat 2: RwDoM55ZeQuI2ADyJhOb2Q (big blind) collected ($2)



PokerStars Game #59941407426:  Hold'em No Limit ($1/$2) - 2009/07/01 1:34:36 ET
Table 'YqGfR5eHfMeSjb9a+QU9rg' 9-max Seat #9 is the button
Seat 1: rW/MyplHylMSBRaoRUzWrg ($32 in chips)
Seat 3: /gll27k+xWYV7Fbki0lFDQ ($261.75 in chips)
Seat 4: GX1heJ+DSsvm7gzSPsYhhQ ($37 in chips)
Seat 5: CkE3IyJF1KvdaAOmZY5XqQ ($200 in chips)
Seat 6: TAfo4veNRaRlzDXMMYS3Jg ($37 in chips)
Seat 7: 41aZuLBz9nAi2GPVKabmCw ($103.95 in chips)
Seat 8: JnV3SM2D6dAFYyGZHHpvrg ($90.25 in chips)
Seat 9: /inIs/z/PcX+TniIFpaxpg ($202.20 in chips)
rW/MyplHylMSBRaoRUzWrg: posts small blind $1
W3Nqt1GWlTi9tXQXMNEvgw: is sitting out
/gll27k+xWYV7Fbki0lFDQ: posts big blind $2
*** HOLE CARDS ***
GX1heJ+DSsvm7gzSPsYhhQ: folds
CkE3IyJF1KvdaAOmZY5XqQ: folds
TAfo4veNRaRlzDXMMYS3Jg: folds
41aZuLBz9nAi2GPVKabmCw: calls $2
JnV3SM2D6dAFYyGZHHpvrg: folds
W3Nqt1GWlTi9tXQXMNEvgw leaves the table
/inIs/z/PcX+TniIFpaxpg: folds
rW/MyplHylMSBRaoRUzWrg: raises $8 to $10
/gll27k+xWYV7Fbki0lFDQ: folds
nXDI8Y/S6POzRwANu3d8hQ joins the table at seat #2
41aZuLBz9nAi2GPVKabmCw: folds
rW/MyplHylMSBRaoRUzWrg collected $6 from pot
*** SUMMARY ***
Total pot $6 | Rake $0
Seat 1: rW/MyplHylMSBRaoRUzWrg (small blind) collected ($6)
Seat 3: /gll27k+xWYV7Fbki0lFDQ (big blind) folded before Flop
Seat 4: GX1heJ+DSsvm7gzSPsYhhQ folded before Flop (didn't bet)
Seat 5: CkE3IyJF1KvdaAOmZY5XqQ folded before Flop (didn't bet)
Seat 6: TAfo4veNRaRlzDXMMYS3Jg folded before Flop (didn't bet)
Seat 7: 41aZuLBz9nAi2GPVKabmCw folded before Flop
Seat 8: JnV3SM2D6dAFYyGZHHpvrg folded before Flop (didn't bet)
Seat 9: /inIs/z/PcX+TniIFpaxpg (button) folded before Flop (didn't bet)



PokerStars Game #59941408146:  Hold'em No Limit ($1/$2) - 2009/07/01 1:34:37 ET
Table 'ztv6V3FN2bQ9nmJPPdx6nQ' 6-max Seat #3 is the button
Seat 1: 6fLdOUCRtX71xbVRhJEq8w ($241.35 in chips)
Seat 2: 5Y+ZGWLI4gnlpApDX5vy1A ($389.75 in chips)
Seat 3: ubtx4Z5L+AcK71MTvYiGVw ($245 in chips)
Seat 5: sTPOWERd9HWPCNrDBwsVjA ($220.80 in chips)
Seat 6: mfy7uGZcqA2PVQqEVbJ7+g ($97.45 in chips)
sTPOWERd9HWPCNrDBwsVjA: posts small blind $1
mfy7uGZcqA2PVQqEVbJ7+g: posts big blind $2
*** HOLE CARDS ***
6fLdOUCRtX71xbVRhJEq8w: folds
UaZ5yj+6LjtWqMQg2QskUw has returned
5Y+ZGWLI4gnlpApDX5vy1A: raises $4 to $6
ubtx4Z5L+AcK71MTvYiGVw: folds
sTPOWERd9HWPCNrDBwsVjA: folds
mfy7uGZcqA2PVQqEVbJ7+g: folds
5Y+ZGWLI4gnlpApDX5vy1A collected $5 from pot
5Y+ZGWLI4gnlpApDX5vy1A: doesn't show hand
*** SUMMARY ***
Total pot $5 | Rake $0
Seat 1: 6fLdOUCRtX71xbVRhJEq8w folded before Flop (didn't bet)
Seat 2: 5Y+ZGWLI4gnlpApDX5vy1A collected ($5)
Seat 3: ubtx4Z5L+AcK71MTvYiGVw (button) folded before Flop (didn't bet)
Seat 5: sTPOWERd9HWPCNrDBwsVjA (small blind) folded before Flop
Seat 6: mfy7uGZcqA2PVQqEVbJ7+g (big blind) folded before Flop



PokerStars Game #59941408110:  Hold'em No Limit ($1/$2) - 2009/07/01 1:34:37 ET
Table '/dyk+YdRGv90j2box35j8w' 6-max Seat #2 is the button
Seat 1: 8srN1dKQePlsv0GyTada+Q ($206.25 in chips)
Seat 2: qCnEYuAE5y5A7bk6fO5/jQ ($470.60 in chips)
Seat 3: sTPOWERd9HWPCNrDBwsVjA ($186.50 in chips)
Seat 4: z/u1YTnkiIDrtp/2cA2dBg ($167.85 in chips)
Seat 5: VvdR9F3I+2yELkfTVvC1dg ($243 in chips)
Seat 6: gnYme0DNFflnMhrdbxe1Ag ($200 in chips)
sTPOWERd9HWPCNrDBwsVjA: posts small blind $1
z/u1YTnkiIDrtp/2cA2dBg: posts big blind $2
*** HOLE CARDS ***
VvdR9F3I+2yELkfTVvC1dg: folds
gnYme0DNFflnMhrdbxe1Ag: folds
8srN1dKQePlsv0GyTada+Q: folds
qCnEYuAE5y5A7bk6fO5/jQ: folds
sTPOWERd9HWPCNrDBwsVjA: folds
z/u1YTnkiIDrtp/2cA2dBg collected $2 from pot
*** SUMMARY ***
Total pot $2 | Rake $0
Seat 1: 8srN1dKQePlsv0GyTada+Q folded before Flop (didn't bet)
Seat 2: qCnEYuAE5y5A7bk6fO5/jQ (button) folded before Flop (didn't bet)
Seat 3: sTPOWERd9HWPCNrDBwsVjA (small blind) folded before Flop
Seat 4: z/u1YTnkiIDrtp/2cA2dBg (big blind) collected ($2)
Seat 5: VvdR9F3I+2yELkfTVvC1dg folded before Flop (didn't bet)
Seat 6: gnYme0DNFflnMhrdbxe1Ag folded before Flop (didn't bet)



PokerStars Game #59941407968:  Hold'em No Limit ($1/$2) - 2009/07/01 1:34:37 ET
Table 'gftD4mDF7mIFKvSrIyaRbw' 9-max Seat #6 is the button
Seat 2: GX1heJ+DSsvm7gzSPsYhhQ ($36 in chips)
Seat 3: CUZwDpLTQKhzarPe+JCLOQ ($204.75 in chips)
Seat 4: /inIs/z/PcX+TniIFpaxpg ($37 in chips)
Seat 5: mpsfNtnMVDqQHTe92AhIdw ($117.10 in chips)
Seat 6: 2NvwF8W2nzsbS+G//yLAbQ ($119.20 in chips)
Seat 7: +T/63sAeZzWyHchahJ36GQ ($40 in chips)
Seat 8: MpL4DeEqGQu0H8TJEbEOrg ($41 in chips)
+T/63sAeZzWyHchahJ36GQ: posts small blind $1
MpL4DeEqGQu0H8TJEbEOrg: posts big blind $2
*** HOLE CARDS ***
GX1heJ+DSsvm7gzSPsYhhQ: folds
CUZwDpLTQKhzarPe+JCLOQ: folds
/inIs/z/PcX+TniIFpaxpg: folds
mpsfNtnMVDqQHTe92AhIdw: folds
2NvwF8W2nzsbS+G//yLAbQ: raises $2 to $4
+T/63sAeZzWyHchahJ36GQ: raises $14 to $18
MpL4DeEqGQu0H8TJEbEOrg: folds
2NvwF8W2nzsbS+G//yLAbQ: folds
+T/63sAeZzWyHchahJ36GQ collected $10 from pot
+T/63sAeZzWyHchahJ36GQ: doesn't show hand
*** SUMMARY ***
Total pot $10 | Rake $0
Seat 2: GX1heJ+DSsvm7gzSPsYhhQ folded before Flop (didn't bet)
Seat 3: CUZwDpLTQKhzarPe+JCLOQ folded before Flop (didn't bet)
Seat 4: /inIs/z/PcX+TniIFpaxpg folded before Flop (didn't bet)
Seat 5: mpsfNtnMVDqQHTe92AhIdw folded before Flop (didn't bet)
Seat 6: 2NvwF8W2nzsbS+G//yLAbQ (button) folded before Flop
Seat 7: +T/63sAeZzWyHchahJ36GQ (small blind) collected ($10)
Seat 8: MpL4DeEqGQu0H8TJEbEOrg (big blind) folded before Flop



PokerStars Game #59941410002:  Hold'em No Limit ($1/$2) - 2009/07/01 1:34:40 ET
Table 'ZzSIe0zTCDv+n6hfbY5tTg' 6-max Seat #1 is the button
Seat 1: VvdR9F3I+2yELkfTVvC1dg ($200 in chips)
Seat 2: B87ikIyZ/TzAVeXf38Ny0g ($287 in chips)
Seat 3: gsugPj31Hui3Jefl98MBOA ($353 in chips)
Seat 4: qXDd0ZyMIse0OBu8pxeQ3Q ($266 in chips)
Seat 5: 3dAbvkxS5NPQTBAbvpinVg ($477.30 in chips)
Seat 6: 09BNF4quPDzanQzM8vc6WA ($23.05 in chips)
B87ikIyZ/TzAVeXf38Ny0g: posts small blind $1
gsugPj31Hui3Jefl98MBOA: posts big blind $2
*** HOLE CARDS ***
qXDd0ZyMIse0OBu8pxeQ3Q: folds
3dAbvkxS5NPQTBAbvpinVg: folds
09BNF4quPDzanQzM8vc6WA: folds
VvdR9F3I+2yELkfTVvC1dg: raises $2 to $4
B87ikIyZ/TzAVeXf38Ny0g: raises $12 to $16
gsugPj31Hui3Jefl98MBOA: folds
VvdR9F3I+2yELkfTVvC1dg: calls $12
*** FLOP *** [Ks 3s Jh]
B87ikIyZ/TzAVeXf38Ny0g: bets $22
VvdR9F3I+2yELkfTVvC1dg: raises $33.20 to $55.20
B87ikIyZ/TzAVeXf38Ny0g: folds
VvdR9F3I+2yELkfTVvC1dg collected $75 from pot
VvdR9F3I+2yELkfTVvC1dg: doesn't show hand
*** SUMMARY ***
Total pot $78 | Rake $3
Board [Ks 3s Jh]
Seat 1: VvdR9F3I+2yELkfTVvC1dg (button) collected ($75)
Seat 2: B87ikIyZ/TzAVeXf38Ny0g (small blind) folded on the Flop
Seat 3: gsugPj31Hui3Jefl98MBOA (big blind) folded before Flop
Seat 4: qXDd0ZyMIse0OBu8pxeQ3Q folded before Flop (didn't bet)
Seat 5: 3dAbvkxS5NPQTBAbvpinVg folded before Flop (didn't bet)
Seat 6: 09BNF4quPDzanQzM8vc6WA folded before Flop (didn't bet)



PokerStars Game #59941409612:  Hold'em No Limit ($1/$2) - 2009/07/01 1:34:40 ET
Table 'kq5zaQ+1hLNf8LZfGnbTAA' 6-max Seat #4 is the button
Seat 1: 8srN1dKQePlsv0GyTada+Q ($440.60 in chips)
Seat 2: nXDI8Y/S6POzRwANu3d8hQ ($164 in chips)
Seat 3: /PH6Ffnho4Ysm8S3V/oa+w ($40 in chips)
Seat 4: 3dAbvkxS5NPQTBAbvpinVg ($278.45 in chips)
Seat 5: gnYme0DNFflnMhrdbxe1Ag ($201 in chips)
Seat 6: mfy7uGZcqA2PVQqEVbJ7+g ($191.25 in chips)
gnYme0DNFflnMhrdbxe1Ag: posts small blind $1
mfy7uGZcqA2PVQqEVbJ7+g: posts big blind $2
*** HOLE CARDS ***
8srN1dKQePlsv0GyTada+Q: folds
nXDI8Y/S6POzRwANu3d8hQ: folds
/PH6Ffnho4Ysm8S3V/oa+w: raises $2 to $4
3dAbvkxS5NPQTBAbvpinVg: folds
gnYme0DNFflnMhrdbxe1Ag: folds
mfy7uGZcqA2PVQqEVbJ7+g: folds
/PH6Ffnho4Ysm8S3V/oa+w collected $5 from pot
/PH6Ffnho4Ysm8S3V/oa+w: doesn't show hand
*** SUMMARY ***
Total pot $5 | Rake $0
Seat 1: 8srN1dKQePlsv0GyTada+Q folded before Flop (didn't bet)
Seat 2: nXDI8Y/S6POzRwANu3d8hQ folded before Flop (didn't bet)
Seat 3: /PH6Ffnho4Ysm8S3V/oa+w collected ($5)
Seat 4: 3dAbvkxS5NPQTBAbvpinVg (button) folded before Flop (didn't bet)
Seat 5: gnYme0DNFflnMhrdbxe1Ag (small blind) folded before Flop
Seat 6: mfy7uGZcqA2PVQqEVbJ7+g (big blind) folded before Flop



PokerStars Game #59941410046:  Hold'em No Limit ($1/$2) - 2009/07/01 1:34:40 ET
Table '8Y6PEyoNuepZTai2Q56aHw' 9-max Seat #5 is the button
Seat 1: 5Q8U6iZbeO7xJSS4qvDP5g ($311.80 in chips)
Seat 2: gDCJIAlovbPnTvMM7Dd1gA ($191.15 in chips)
Seat 3: WUlHm+ydPPHG7Lb0rePSdA ($214.10 in chips)
Seat 4: xKkwALG38OfLQ9DXuJgR1w ($210.25 in chips)
Seat 5: /inIs/z/PcX+TniIFpaxpg ($40 in chips)
Seat 6: NtLDBSjsJQEKekh5cdinvw ($374.35 in chips)
Seat 7: Kzta8yu9vxHT4B70mjBZ+w ($200 in chips)
Seat 8: rW/MyplHylMSBRaoRUzWrg ($70 in chips)
NtLDBSjsJQEKekh5cdinvw: posts small blind $1
Kzta8yu9vxHT4B70mjBZ+w: posts big blind $2
*** HOLE CARDS ***
rW/MyplHylMSBRaoRUzWrg: folds
F7m34OOfAQ7annesMHVjKw has returned
5Q8U6iZbeO7xJSS4qvDP5g: folds
gDCJIAlovbPnTvMM7Dd1gA: folds
WUlHm+ydPPHG7Lb0rePSdA: folds
xKkwALG38OfLQ9DXuJgR1w: folds
/inIs/z/PcX+TniIFpaxpg: folds
NtLDBSjsJQEKekh5cdinvw: folds
Kzta8yu9vxHT4B70mjBZ+w collected $2 from pot
Kzta8yu9vxHT4B70mjBZ+w: doesn't show hand
*** SUMMARY ***
Total pot $2 | Rake $0
Seat 1: 5Q8U6iZbeO7xJSS4qvDP5g folded before Flop (didn't bet)
Seat 2: gDCJIAlovbPnTvMM7Dd1gA folded before Flop (didn't bet)
Seat 3: WUlHm+ydPPHG7Lb0rePSdA folded before Flop (didn't bet)
Seat 4: xKkwALG38OfLQ9DXuJgR1w folded before Flop (didn't bet)
Seat 5: /inIs/z/PcX+TniIFpaxpg (button) folded before Flop (didn't bet)
Seat 6: NtLDBSjsJQEKekh5cdinvw (small blind) folded before Flop
Seat 7: Kzta8yu9vxHT4B70mjBZ+w (big blind) collected ($2)
Seat 8: rW/MyplHylMSBRaoRUzWrg folded before Flop (didn't bet)



PokerStars Game #59941410680:  Hold'em No Limit ($1/$2) - 2009/07/01 1:34:42 ET
Table 'P/yCfYl1GfGsu/e6DxDy/A' 2-max Seat #2 is the button
Seat 1: 7fOCUy3x9hdkmXkkDNolGQ ($527.50 in chips)
Seat 2: RwDoM55ZeQuI2ADyJhOb2Q ($953 in chips)
RwDoM55ZeQuI2ADyJhOb2Q: posts small blind $1
7fOCUy3x9hdkmXkkDNolGQ: posts big blind $2
*** HOLE CARDS ***
RwDoM55ZeQuI2ADyJhOb2Q: folds
7fOCUy3x9hdkmXkkDNolGQ collected $2 from pot
7fOCUy3x9hdkmXkkDNolGQ: doesn't show hand
*** SUMMARY ***
Total pot $2 | Rake $0
Seat 1: 7fOCUy3x9hdkmXkkDNolGQ (big blind) collected ($2)
Seat 2: RwDoM55ZeQuI2ADyJhOb2Q (button) (small blind) folded before Flop



PokerStars Game #59941414132:  Hold'em No Limit ($1/$2) - 2009/07/01 1:34:48 ET
Table 'P/yCfYl1GfGsu/e6DxDy/A' 2-max Seat #1 is the button
Seat 1: 7fOCUy3x9hdkmXkkDNolGQ ($528.50 in chips)
Seat 2: RwDoM55ZeQuI2ADyJhOb2Q ($952 in chips)
7fOCUy3x9hdkmXkkDNolGQ: posts small blind $1
RwDoM55ZeQuI2ADyJhOb2Q: posts big blind $2
*** HOLE CARDS ***
7fOCUy3x9hdkmXkkDNolGQ: raises $4 to $6
RwDoM55ZeQuI2ADyJhOb2Q: folds
7fOCUy3x9hdkmXkkDNolGQ collected $4 from pot
7fOCUy3x9hdkmXkkDNolGQ: doesn't show hand
*** SUMMARY ***
Total pot $4 | Rake $0
Seat 1: 7fOCUy3x9hdkmXkkDNolGQ (button) (small blind) collected ($4)
Seat 2: RwDoM55ZeQuI2ADyJhOb2Q (big blind) folded before Flop



PokerStars Game #59941415094:  Hold'em No Limit ($1/$2) - 2009/07/01 1:34:50 ET
Table 'TsEDkiO4tzCTCzJ7tNdEqw' 6-max Seat #5 is the button
Seat 1: MfXQsYD8pGeCS7XOtyV+vw ($97.05 in chips)
Seat 2: 4dcDwIHRm96PwtqkpQiuiA ($75.10 in chips)
Seat 3: ubtx4Z5L+AcK71MTvYiGVw ($203 in chips)
Seat 4: K8MXCrNAVYlMnnCeM32Kxw ($111.50 in chips)
Seat 5: VvdR9F3I+2yELkfTVvC1dg ($251.35 in chips)
Seat 6: uCqEjnxh2/vFBjKYkfTOkw ($160.70 in chips)
uCqEjnxh2/vFBjKYkfTOkw: posts small blind $1
MfXQsYD8pGeCS7XOtyV+vw: posts big blind $2
*** HOLE CARDS ***
4dcDwIHRm96PwtqkpQiuiA: folds
ubtx4Z5L+AcK71MTvYiGVw: raises $6 to $8
K8MXCrNAVYlMnnCeM32Kxw: folds
VvdR9F3I+2yELkfTVvC1dg: folds
uCqEjnxh2/vFBjKYkfTOkw: folds
MfXQsYD8pGeCS7XOtyV+vw: calls $6
*** FLOP *** [Js Ah 2h]
MfXQsYD8pGeCS7XOtyV+vw: checks
ubtx4Z5L+AcK71MTvYiGVw: checks
*** TURN *** [Js Ah 2h] [6d]
MfXQsYD8pGeCS7XOtyV+vw: bets $9
ubtx4Z5L+AcK71MTvYiGVw: calls $9
*** RIVER *** [Js Ah 2h 6d] [2d]
MfXQsYD8pGeCS7XOtyV+vw: bets $19
ubtx4Z5L+AcK71MTvYiGVw: calls $19
*** SHOW DOWN ***
MfXQsYD8pGeCS7XOtyV+vw: shows [9d 9c] (two pair, Nines and Deuces)
ubtx4Z5L+AcK71MTvYiGVw: shows [3d Ad] (two pair, Aces and Deuces)
ubtx4Z5L+AcK71MTvYiGVw collected $70 from pot
*** SUMMARY ***
Total pot $73 | Rake $3
Board [Js Ah 2h 6d 2d]
Seat 1: MfXQsYD8pGeCS7XOtyV+vw (big blind) showed [9d 9c] and lost with two pair, Nines and Deuces
Seat 2: 4dcDwIHRm96PwtqkpQiuiA folded before Flop (didn't bet)
Seat 3: ubtx4Z5L+AcK71MTvYiGVw showed [3d Ad] and won ($70) with two pair, Aces and Deuces
Seat 4: K8MXCrNAVYlMnnCeM32Kxw folded before Flop (didn't bet)
Seat 5: VvdR9F3I+2yELkfTVvC1dg (button) folded before Flop (didn't bet)
Seat 6: uCqEjnxh2/vFBjKYkfTOkw (small blind) folded before Flop



PokerStars Game #59941415960:  Hold'em No Limit ($1/$2) - 2009/07/01 1:34:51 ET
Table 'LL4bDFyhj5hsMpzaDugJZg' 6-max Seat #3 is the button
Seat 1: FwvID/fQGlpY3soi/lMTww ($85.05 in chips)
Seat 2: IZng3w8jiJHHp3LbYKLi4w ($42.15 in chips)
Seat 3: iI/NMpRxMkGieArQEhACSA ($561.90 in chips)
Seat 4: 8srN1dKQePlsv0GyTada+Q ($219 in chips)
Seat 5: A2GTwTiwkb1ilNWgW487Vg ($128.50 in chips)
Seat 6: 692Q4sfB0gTElzS0WMeg+A ($200 in chips)
8srN1dKQePlsv0GyTada+Q: posts small blind $1
A2GTwTiwkb1ilNWgW487Vg: posts big blind $2
*** HOLE CARDS ***
692Q4sfB0gTElzS0WMeg+A: folds
FwvID/fQGlpY3soi/lMTww: folds
IZng3w8jiJHHp3LbYKLi4w: calls $2
iI/NMpRxMkGieArQEhACSA: folds
8srN1dKQePlsv0GyTada+Q: calls $1
A2GTwTiwkb1ilNWgW487Vg: checks
*** FLOP *** [Ac Jh Qs]
8srN1dKQePlsv0GyTada+Q: bets $4
A2GTwTiwkb1ilNWgW487Vg: folds
IZng3w8jiJHHp3LbYKLi4w: calls $4
*** TURN *** [Ac Jh Qs] [4d]
8srN1dKQePlsv0GyTada+Q: bets $4
IZng3w8jiJHHp3LbYKLi4w: calls $4
*** RIVER *** [Ac Jh Qs 4d] [Qh]
8srN1dKQePlsv0GyTada+Q: bets $4
IZng3w8jiJHHp3LbYKLi4w: raises $6 to $10
8srN1dKQePlsv0GyTada+Q: folds
IZng3w8jiJHHp3LbYKLi4w collected $28.60 from pot
*** SUMMARY ***
Total pot $30 | Rake $1.40
Board [Ac Jh Qs 4d Qh]
Seat 1: FwvID/fQGlpY3soi/lMTww folded before Flop (didn't bet)
Seat 2: IZng3w8jiJHHp3LbYKLi4w collected ($28.60)
Seat 3: iI/NMpRxMkGieArQEhACSA (button) folded before Flop (didn't bet)
Seat 4: 8srN1dKQePlsv0GyTada+Q (small blind) folded on the River
Seat 5: A2GTwTiwkb1ilNWgW487Vg (big blind) folded on the Flop
Seat 6: 692Q4sfB0gTElzS0WMeg+A folded before Flop (didn't bet)



PokerStars Game #59941416602:  Hold'em No Limit ($1/$2) - 2009/07/01 1:34:52 ET
Table 'pPQgcj9XT9CHBsbo1WTBug' 6-max Seat #2 is the button
Seat 1: DFVYDA6dKQy7R7mGIKogZA ($140.95 in chips)
Seat 2: qXDd0ZyMIse0OBu8pxeQ3Q ($200 in chips)
Seat 3: 54yWzRRgS0oZ+S6LwZBxMQ ($50.50 in chips)
Seat 4: gqlysXCbT8V54f/1lf9h3A ($74.45 in chips)
Seat 5: vkfxu8f/jMYKUk6Ly4eujw ($190.55 in chips)
Seat 6: Yr7pZltpy3IUNdKS9PCEiw ($315.80 in chips)
54yWzRRgS0oZ+S6LwZBxMQ: posts small blind $1
gqlysXCbT8V54f/1lf9h3A: posts big blind $2
*** HOLE CARDS ***
vkfxu8f/jMYKUk6Ly4eujw: folds
Yr7pZltpy3IUNdKS9PCEiw: folds
DFVYDA6dKQy7R7mGIKogZA: folds
qXDd0ZyMIse0OBu8pxeQ3Q: folds
54yWzRRgS0oZ+S6LwZBxMQ: folds
gqlysXCbT8V54f/1lf9h3A collected $2 from pot
gqlysXCbT8V54f/1lf9h3A: doesn't show hand
*** SUMMARY ***
Total pot $2 | Rake $0
Seat 1: DFVYDA6dKQy7R7mGIKogZA folded before Flop (didn't bet)
Seat 2: qXDd0ZyMIse0OBu8pxeQ3Q (button) folded before Flop (didn't bet)
Seat 3: 54yWzRRgS0oZ+S6LwZBxMQ (small blind) folded before Flop
Seat 4: gqlysXCbT8V54f/1lf9h3A (big blind) collected ($2)
Seat 5: vkfxu8f/jMYKUk6Ly4eujw folded before Flop (didn't bet)
Seat 6: Yr7pZltpy3IUNdKS9PCEiw folded before Flop (didn't bet)



PokerStars Game #59941417328:  Hold'em No Limit ($1/$2) - 2009/07/01 1:34:54 ET
Table 'eTkRjRjsYr567snmNk8kNQ' 2-max Seat #2 is the button
Seat 1: t6Jd836OSEMbcRi7rfGp5g ($200 in chips)
Seat 2: UNpnKQk0gkkyFJen8upqag ($298 in chips)
UNpnKQk0gkkyFJen8upqag: posts small blind $1
t6Jd836OSEMbcRi7rfGp5g: posts big blind $2
*** HOLE CARDS ***
UNpnKQk0gkkyFJen8upqag: raises $4 to $6
t6Jd836OSEMbcRi7rfGp5g: folds
UNpnKQk0gkkyFJen8upqag collected $4 from pot
*** SUMMARY ***
Total pot $4 | Rake $0
Seat 1: t6Jd836OSEMbcRi7rfGp5g (big blind) folded before Flop
Seat 2: UNpnKQk0gkkyFJen8upqag (button) (small blind) collected ($4)



PokerStars Game #59941418208:  Hold'em No Limit ($1/$2) - 2009/07/01 1:34:55 ET
Table 'NmY84NAf9Mh0ckAckHnh5g' 2-max Seat #2 is the button
Seat 1: 6hvg964TSqZ3AL/0XK9aVQ ($323.50 in chips)
Seat 2: RwDoM55ZeQuI2ADyJhOb2Q ($673.70 in chips)
RwDoM55ZeQuI2ADyJhOb2Q: posts small blind $1
6hvg964TSqZ3AL/0XK9aVQ: posts big blind $2
*** HOLE CARDS ***
RwDoM55ZeQuI2ADyJhOb2Q: raises $4 to $6
6hvg964TSqZ3AL/0XK9aVQ: calls $4
*** FLOP *** [9h 7s Jc]
6hvg964TSqZ3AL/0XK9aVQ: checks
RwDoM55ZeQuI2ADyJhOb2Q: checks
*** TURN *** [9h 7s Jc] [9d]
6hvg964TSqZ3AL/0XK9aVQ: bets $4
RwDoM55ZeQuI2ADyJhOb2Q: calls $4
*** RIVER *** [9h 7s Jc 9d] [9c]
6hvg964TSqZ3AL/0XK9aVQ: bets $30
RwDoM55ZeQuI2ADyJhOb2Q: folds
6hvg964TSqZ3AL/0XK9aVQ collected $19.50 from pot
*** SUMMARY ***
Total pot $20 | Rake $0.50
Board [9h 7s Jc 9d 9c]
Seat 1: 6hvg964TSqZ3AL/0XK9aVQ (big blind) collected ($19.50)
Seat 2: RwDoM55ZeQuI2ADyJhOb2Q (button) (small blind) folded on the River



PokerStars Game #59941418834:  Hold'em No Limit ($1/$2) - 2009/07/01 1:34:56 ET
Table 'P/yCfYl1GfGsu/e6DxDy/A' 2-max Seat #2 is the button
Seat 1: 7fOCUy3x9hdkmXkkDNolGQ ($530.50 in chips)
Seat 2: RwDoM55ZeQuI2ADyJhOb2Q ($950 in chips)
RwDoM55ZeQuI2ADyJhOb2Q: posts small blind $1
7fOCUy3x9hdkmXkkDNolGQ: posts big blind $2
*** HOLE CARDS ***
RwDoM55ZeQuI2ADyJhOb2Q: raises $4 to $6
7fOCUy3x9hdkmXkkDNolGQ: raises $14 to $20
RwDoM55ZeQuI2ADyJhOb2Q: calls $14
*** FLOP *** [Js Kc 8h]
7fOCUy3x9hdkmXkkDNolGQ: bets $28
RwDoM55ZeQuI2ADyJhOb2Q: folds
7fOCUy3x9hdkmXkkDNolGQ collected $39.50 from pot
7fOCUy3x9hdkmXkkDNolGQ: doesn't show hand
*** SUMMARY ***
Total pot $40 | Rake $0.50
Board [Js Kc 8h]
Seat 1: 7fOCUy3x9hdkmXkkDNolGQ (big blind) collected ($39.50)
Seat 2: RwDoM55ZeQuI2ADyJhOb2Q (button) (small blind) folded on the Flop



PokerStars Game #59941418920:  Hold'em No Limit ($1/$2) - 2009/07/01 1:34:56 ET
Table 'mGpP9StWRnoeiBDExc6Frg' 6-max Seat #4 is the button
Seat 1: VvdR9F3I+2yELkfTVvC1dg ($313.60 in chips)
Seat 2: vkfxu8f/jMYKUk6Ly4eujw ($197 in chips)
Seat 3: 7acrZUQC3Zc9BNLjoKIcLQ ($25.15 in chips)
Seat 4: 4dcDwIHRm96PwtqkpQiuiA ($76.70 in chips)
Seat 5: d1puGuVBE0fidn+5eRJ0tw ($190.95 in chips)
Seat 6: B2Ih1sr5VZk+8He7rcrMtQ ($434.05 in chips)
d1puGuVBE0fidn+5eRJ0tw: posts small blind $1
B2Ih1sr5VZk+8He7rcrMtQ: posts big blind $2
*** HOLE CARDS ***
VvdR9F3I+2yELkfTVvC1dg: folds
vkfxu8f/jMYKUk6Ly4eujw: folds
7acrZUQC3Zc9BNLjoKIcLQ: folds
4dcDwIHRm96PwtqkpQiuiA: folds
d1puGuVBE0fidn+5eRJ0tw: raises $8 to $10
B2Ih1sr5VZk+8He7rcrMtQ: calls $8
*** FLOP *** [9s Kc Qh]
d1puGuVBE0fidn+5eRJ0tw: bets $20
B2Ih1sr5VZk+8He7rcrMtQ: folds
d1puGuVBE0fidn+5eRJ0tw collected $19 from pot
d1puGuVBE0fidn+5eRJ0tw: doesn't show hand
*** SUMMARY ***
Total pot $20 | Rake $1
Board [9s Kc Qh]
Seat 1: VvdR9F3I+2yELkfTVvC1dg folded before Flop (didn't bet)
Seat 2: vkfxu8f/jMYKUk6Ly4eujw folded before Flop (didn't bet)
Seat 3: 7acrZUQC3Zc9BNLjoKIcLQ folded before Flop (didn't bet)
Seat 4: 4dcDwIHRm96PwtqkpQiuiA (button) folded before Flop (didn't bet)
Seat 5: d1puGuVBE0fidn+5eRJ0tw (small blind) collected ($19)
Seat 6: B2Ih1sr5VZk+8He7rcrMtQ (big blind) folded on the Flop



PokerStars Game #59941418658:  Hold'em No Limit ($1/$2) - 2009/07/01 1:34:56 ET
Table 'uJ9juaXXg9yIcSU8amxaXQ' 6-max Seat #5 is the button
Seat 2: VvdR9F3I+2yELkfTVvC1dg ($228.10 in chips)
Seat 3: qXDd0ZyMIse0OBu8pxeQ3Q ($244.40 in chips)
Seat 4: zNjJ/y4emmF+vzrCDd+ooA ($219.90 in chips)
Seat 5: YsLQ3BAvgQHWXMAv3Wv6Hg ($200 in chips)
Seat 6: 2DFp9Veq1xxq64dCjwNuUw ($67.35 in chips)
2DFp9Veq1xxq64dCjwNuUw: posts small blind $1
VvdR9F3I+2yELkfTVvC1dg: posts big blind $2
*** HOLE CARDS ***
qXDd0ZyMIse0OBu8pxeQ3Q: folds
zNjJ/y4emmF+vzrCDd+ooA: calls $2
YsLQ3BAvgQHWXMAv3Wv6Hg: folds
2DFp9Veq1xxq64dCjwNuUw: folds
VvdR9F3I+2yELkfTVvC1dg: raises $6 to $8
zNjJ/y4emmF+vzrCDd+ooA: calls $6
*** FLOP *** [7h 6d 8h]
2DFp9Veq1xxq64dCjwNuUw leaves the table
VvdR9F3I+2yELkfTVvC1dg: checks
zNjJ/y4emmF+vzrCDd+ooA: checks
*** TURN *** [7h 6d 8h] [6c]
VvdR9F3I+2yELkfTVvC1dg: checks
JsqOjN/eHz0uYVf/PyUJ6Q has returned
zNjJ/y4emmF+vzrCDd+ooA: checks
*** RIVER *** [7h 6d 8h 6c] [3h]
VvdR9F3I+2yELkfTVvC1dg: checks
zNjJ/y4emmF+vzrCDd+ooA: checks
*** SHOW DOWN ***
VvdR9F3I+2yELkfTVvC1dg: shows [Qh Ad] (a pair of Sixes)
zNjJ/y4emmF+vzrCDd+ooA: shows [4d 4s] (two pair, Sixes and Fours)
zNjJ/y4emmF+vzrCDd+ooA collected $16.15 from pot
*** SUMMARY ***
Total pot $17 | Rake $0.85
Board [7h 6d 8h 6c 3h]
Seat 2: VvdR9F3I+2yELkfTVvC1dg (big blind) showed [Qh Ad] and lost with a pair of Sixes
Seat 3: qXDd0ZyMIse0OBu8pxeQ3Q folded before Flop (didn't bet)
Seat 4: zNjJ/y4emmF+vzrCDd+ooA showed [4d 4s] and won ($16.15) with two pair, Sixes and Fours
Seat 5: YsLQ3BAvgQHWXMAv3Wv6Hg (button) folded before Flop (didn't bet)
Seat 6: 2DFp9Veq1xxq64dCjwNuUw (small blind) folded before Flop



PokerStars Game #59941419478:  Hold'em No Limit ($1/$2) - 2009/07/01 1:34:57 ET
Table 'AtOXMvcrtQM8yLNcALmfLQ' 2-max Seat #2 is the button
Seat 1: +HlQuAsMqZGYYtjcPO/a3A ($363.70 in chips)
Seat 2: pVqEzK9wXlRMECnb1Zg4Zw ($199.50 in chips)
pVqEzK9wXlRMECnb1Zg4Zw: posts small blind $1
+HlQuAsMqZGYYtjcPO/a3A: posts big blind $2
*** HOLE CARDS ***
pVqEzK9wXlRMECnb1Zg4Zw: calls $1
+HlQuAsMqZGYYtjcPO/a3A: checks
*** FLOP *** [7s 9s 8s]
+HlQuAsMqZGYYtjcPO/a3A: checks
pVqEzK9wXlRMECnb1Zg4Zw: checks
*** TURN *** [7s 9s 8s] [6h]
+HlQuAsMqZGYYtjcPO/a3A: bets $4
pVqEzK9wXlRMECnb1Zg4Zw: folds
+HlQuAsMqZGYYtjcPO/a3A collected $3.80 from pot
*** SUMMARY ***
Total pot $4 | Rake $0.20
Board [7s 9s 8s 6h]
Seat 1: +HlQuAsMqZGYYtjcPO/a3A (big blind) collected ($3.80)
Seat 2: pVqEzK9wXlRMECnb1Zg4Zw (button) (small blind) folded on the Turn



PokerStars Game #59941419928:  Hold'em No Limit ($1/$2) - 2009/07/01 1:34:58 ET
Table 'rKeCh+eBn4RNvybCUYkoTQ' 9-max Seat #2 is the button
Seat 1: /inIs/z/PcX+TniIFpaxpg ($198 in chips)
Seat 2: 9cBHwK40Tl06vheE7B3LHQ ($126.80 in chips)
Seat 3: GX1heJ+DSsvm7gzSPsYhhQ ($41 in chips)
Seat 5: WUlHm+ydPPHG7Lb0rePSdA ($125 in chips)
Seat 6: EBV6OktyeSmh4w6sWmcWOw ($267 in chips)
Seat 7: rW/MyplHylMSBRaoRUzWrg ($31 in chips)
Seat 8: pN/Ip0ePsUVIdUlGgLrkUw ($246.35 in chips)
Seat 9: Kzta8yu9vxHT4B70mjBZ+w ($211.25 in chips)
GX1heJ+DSsvm7gzSPsYhhQ: posts small blind $1
WUlHm+ydPPHG7Lb0rePSdA: posts big blind $2
*** HOLE CARDS ***
EBV6OktyeSmh4w6sWmcWOw: folds
rW/MyplHylMSBRaoRUzWrg: folds
pN/Ip0ePsUVIdUlGgLrkUw: folds
Kzta8yu9vxHT4B70mjBZ+w: folds
/inIs/z/PcX+TniIFpaxpg: folds
9cBHwK40Tl06vheE7B3LHQ: raises $4 to $6
GX1heJ+DSsvm7gzSPsYhhQ: raises $35 to $41 and is all-in
WUlHm+ydPPHG7Lb0rePSdA: folds
9cBHwK40Tl06vheE7B3LHQ: folds
GX1heJ+DSsvm7gzSPsYhhQ collected $14 from pot
GX1heJ+DSsvm7gzSPsYhhQ: doesn't show hand
*** SUMMARY ***
Total pot $14 | Rake $0
Seat 1: /inIs/z/PcX+TniIFpaxpg folded before Flop (didn't bet)
Seat 2: 9cBHwK40Tl06vheE7B3LHQ (button) folded before Flop
Seat 3: GX1heJ+DSsvm7gzSPsYhhQ (small blind) collected ($14)
Seat 5: WUlHm+ydPPHG7Lb0rePSdA (big blind) folded before Flop
Seat 6: EBV6OktyeSmh4w6sWmcWOw folded before Flop (didn't bet)
Seat 7: rW/MyplHylMSBRaoRUzWrg folded before Flop (didn't bet)
Seat 8: pN/Ip0ePsUVIdUlGgLrkUw folded before Flop (didn't bet)
Seat 9: Kzta8yu9vxHT4B70mjBZ+w folded before Flop (didn't bet)



PokerStars Game #59941419894:  Hold'em No Limit ($1/$2) - 2009/07/01 1:34:58 ET
Table '/dyk+YdRGv90j2box35j8w' 6-max Seat #3 is the button
Seat 1: 8srN1dKQePlsv0GyTada+Q ($206.25 in chips)
Seat 2: qCnEYuAE5y5A7bk6fO5/jQ ($470.60 in chips)
Seat 3: sTPOWERd9HWPCNrDBwsVjA ($185.50 in chips)
Seat 4: z/u1YTnkiIDrtp/2cA2dBg ($168.85 in chips)
Seat 5: VvdR9F3I+2yELkfTVvC1dg ($243 in chips)
Seat 6: gnYme0DNFflnMhrdbxe1Ag ($200 in chips)
z/u1YTnkiIDrtp/2cA2dBg: posts small blind $1
VvdR9F3I+2yELkfTVvC1dg: posts big blind $2
*** HOLE CARDS ***
gnYme0DNFflnMhrdbxe1Ag: folds
8srN1dKQePlsv0GyTada+Q: raises $3 to $5
qCnEYuAE5y5A7bk6fO5/jQ: folds
sTPOWERd9HWPCNrDBwsVjA has timed out
sTPOWERd9HWPCNrDBwsVjA: folds
sTPOWERd9HWPCNrDBwsVjA is sitting out
sTPOWERd9HWPCNrDBwsVjA has returned
z/u1YTnkiIDrtp/2cA2dBg: folds
VvdR9F3I+2yELkfTVvC1dg: folds
8srN1dKQePlsv0GyTada+Q collected $5 from pot
8srN1dKQePlsv0GyTada+Q: doesn't show hand
*** SUMMARY ***
Total pot $5 | Rake $0
Seat 1: 8srN1dKQePlsv0GyTada+Q collected ($5)
Seat 2: qCnEYuAE5y5A7bk6fO5/jQ folded before Flop (didn't bet)
Seat 3: sTPOWERd9HWPCNrDBwsVjA (button) folded before Flop (didn't bet)
Seat 4: z/u1YTnkiIDrtp/2cA2dBg (small blind) folded before Flop
Seat 5: VvdR9F3I+2yELkfTVvC1dg (big blind) folded before Flop
Seat 6: gnYme0DNFflnMhrdbxe1Ag folded before Flop (didn't bet)



PokerStars Game #59941421340:  Hold'em No Limit ($1/$2) - 2009/07/01 1:35:00 ET
Table 'G1Oqdy4Pqdb5gtx40rUBzA' 6-max Seat #1 is the button
Seat 1: ubtx4Z5L+AcK71MTvYiGVw ($200 in chips)
Seat 2: 4uqU0dG67owXuPz303Al4w ($513.25 in chips)
Seat 3: VvdR9F3I+2yELkfTVvC1dg ($241.25 in chips)
Seat 4: B87ikIyZ/TzAVeXf38Ny0g ($214.55 in chips)
Seat 5: F1+Ml47qRQWunzPnGhLLzQ ($189.50 in chips)
Seat 6: qCnEYuAE5y5A7bk6fO5/jQ ($200 in chips)
4uqU0dG67owXuPz303Al4w: posts small blind $1
VvdR9F3I+2yELkfTVvC1dg: posts big blind $2
*** HOLE CARDS ***
B87ikIyZ/TzAVeXf38Ny0g: folds
F1+Ml47qRQWunzPnGhLLzQ: calls $2
qCnEYuAE5y5A7bk6fO5/jQ: folds
ubtx4Z5L+AcK71MTvYiGVw: folds
4uqU0dG67owXuPz303Al4w: folds
VvdR9F3I+2yELkfTVvC1dg: checks
*** FLOP *** [As 9c Ac]
VvdR9F3I+2yELkfTVvC1dg: checks
F1+Ml47qRQWunzPnGhLLzQ: checks
*** TURN *** [As 9c Ac] [6c]
VvdR9F3I+2yELkfTVvC1dg: checks
F1+Ml47qRQWunzPnGhLLzQ: checks
*** RIVER *** [As 9c Ac 6c] [9s]
VvdR9F3I+2yELkfTVvC1dg: bets $3.35
F1+Ml47qRQWunzPnGhLLzQ: raises $4.65 to $8
VvdR9F3I+2yELkfTVvC1dg: folds
F1+Ml47qRQWunzPnGhLLzQ collected $11.15 from pot
F1+Ml47qRQWunzPnGhLLzQ: doesn't show hand
*** SUMMARY ***
Total pot $11.70 | Rake $0.55
Board [As 9c Ac 6c 9s]
Seat 1: ubtx4Z5L+AcK71MTvYiGVw (button) folded before Flop (didn't bet)
Seat 2: 4uqU0dG67owXuPz303Al4w (small blind) folded before Flop
Seat 3: VvdR9F3I+2yELkfTVvC1dg (big blind) folded on the River
Seat 4: B87ikIyZ/TzAVeXf38Ny0g folded before Flop (didn't bet)
Seat 5: F1+Ml47qRQWunzPnGhLLzQ collected ($11.15)
Seat 6: qCnEYuAE5y5A7bk6fO5/jQ folded before Flop (didn't bet)



PokerStars Game #59941421328:  Hold'em No Limit ($1/$2) - 2009/07/01 1:35:00 ET
Table 'qVXak+oTeDXMGbWa4sDU5Q' 9-max Seat #7 is the button
Seat 1: H6Z4+qu8gR0VUiPOijndVg ($205.55 in chips)
Seat 2: rW/MyplHylMSBRaoRUzWrg ($81 in chips)
Seat 3: WUlHm+ydPPHG7Lb0rePSdA ($175.10 in chips)
Seat 4: lQYT23h5QCUVZAKxjOO39Q ($200.70 in chips)
Seat 5: FWGiDqRwvLeKmHq9t4Jy9w ($265.80 in chips)
Seat 6: GX1heJ+DSsvm7gzSPsYhhQ ($43 in chips)
Seat 7: PfmlvZlFiss79a6IoEr11g ($160.30 in chips)
Seat 8: Z0rzUi0y1x80UdIpofoNbA ($123.55 in chips)
Seat 9: CkE3IyJF1KvdaAOmZY5XqQ ($200 in chips)
Z0rzUi0y1x80UdIpofoNbA: posts small blind $1
CkE3IyJF1KvdaAOmZY5XqQ: posts big blind $2
*** HOLE CARDS ***
H6Z4+qu8gR0VUiPOijndVg: folds
rW/MyplHylMSBRaoRUzWrg: folds
WUlHm+ydPPHG7Lb0rePSdA: folds
lQYT23h5QCUVZAKxjOO39Q: folds
FWGiDqRwvLeKmHq9t4Jy9w: folds
GX1heJ+DSsvm7gzSPsYhhQ: folds
PfmlvZlFiss79a6IoEr11g: calls $2
Z0rzUi0y1x80UdIpofoNbA: calls $1
CkE3IyJF1KvdaAOmZY5XqQ: checks
*** FLOP *** [Td 9c Jc]
Z0rzUi0y1x80UdIpofoNbA: bets $4
CkE3IyJF1KvdaAOmZY5XqQ: calls $4
PfmlvZlFiss79a6IoEr11g: calls $4
*** TURN *** [Td 9c Jc] [2h]
Z0rzUi0y1x80UdIpofoNbA: bets $6
CkE3IyJF1KvdaAOmZY5XqQ: calls $6
PfmlvZlFiss79a6IoEr11g: folds
*** RIVER *** [Td 9c Jc 2h] [8c]
Z0rzUi0y1x80UdIpofoNbA: checks
CkE3IyJF1KvdaAOmZY5XqQ: bets $26
Z0rzUi0y1x80UdIpofoNbA: folds
CkE3IyJF1KvdaAOmZY5XqQ collected $28.55 from pot
*** SUMMARY ***
Total pot $30 | Rake $1.45
Board [Td 9c Jc 2h 8c]
Seat 1: H6Z4+qu8gR0VUiPOijndVg folded before Flop (didn't bet)
Seat 2: rW/MyplHylMSBRaoRUzWrg folded before Flop (didn't bet)
Seat 3: WUlHm+ydPPHG7Lb0rePSdA folded before Flop (didn't bet)
Seat 4: lQYT23h5QCUVZAKxjOO39Q folded before Flop (didn't bet)
Seat 5: FWGiDqRwvLeKmHq9t4Jy9w folded before Flop (didn't bet)
Seat 6: GX1heJ+DSsvm7gzSPsYhhQ folded before Flop (didn't bet)
Seat 7: PfmlvZlFiss79a6IoEr11g (button) folded on the Turn
Seat 8: Z0rzUi0y1x80UdIpofoNbA (small blind) folded on the River
Seat 9: CkE3IyJF1KvdaAOmZY5XqQ (big blind) collected ($28.55)



PokerStars Game #59941422350:  Hold'em No Limit ($1/$2) - 2009/07/01 1:35:02 ET
Table 'ztv6V3FN2bQ9nmJPPdx6nQ' 6-max Seat #5 is the button
Seat 1: 6fLdOUCRtX71xbVRhJEq8w ($241.35 in chips)
Seat 2: 5Y+ZGWLI4gnlpApDX5vy1A ($392.75 in chips)
Seat 3: ubtx4Z5L+AcK71MTvYiGVw ($245 in chips)
Seat 5: sTPOWERd9HWPCNrDBwsVjA ($219.80 in chips)
Seat 6: mfy7uGZcqA2PVQqEVbJ7+g ($95.45 in chips)
mfy7uGZcqA2PVQqEVbJ7+g: posts small blind $1
6fLdOUCRtX71xbVRhJEq8w: posts big blind $2
UaZ5yj+6LjtWqMQg2QskUw: sits out
*** HOLE CARDS ***
5Y+ZGWLI4gnlpApDX5vy1A: raises $6 to $8
ubtx4Z5L+AcK71MTvYiGVw: folds
sTPOWERd9HWPCNrDBwsVjA has timed out
sTPOWERd9HWPCNrDBwsVjA: folds
sTPOWERd9HWPCNrDBwsVjA is sitting out
sTPOWERd9HWPCNrDBwsVjA has returned
mfy7uGZcqA2PVQqEVbJ7+g: folds
6fLdOUCRtX71xbVRhJEq8w: folds
5Y+ZGWLI4gnlpApDX5vy1A collected $5 from pot
5Y+ZGWLI4gnlpApDX5vy1A: doesn't show hand
*** SUMMARY ***
Total pot $5 | Rake $0
Seat 1: 6fLdOUCRtX71xbVRhJEq8w (big blind) folded before Flop
Seat 2: 5Y+ZGWLI4gnlpApDX5vy1A collected ($5)
Seat 3: ubtx4Z5L+AcK71MTvYiGVw folded before Flop (didn't bet)
Seat 5: sTPOWERd9HWPCNrDBwsVjA (button) folded before Flop (didn't bet)
Seat 6: mfy7uGZcqA2PVQqEVbJ7+g (small blind) folded before Flop



PokerStars Game #59941422944:  Hold'em No Limit ($1/$2) - 2009/07/01 1:35:03 ET
Table '8Y6PEyoNuepZTai2Q56aHw' 9-max Seat #6 is the button
Seat 1: 5Q8U6iZbeO7xJSS4qvDP5g ($311.80 in chips)
Seat 2: gDCJIAlovbPnTvMM7Dd1gA ($191.15 in chips)
Seat 3: WUlHm+ydPPHG7Lb0rePSdA ($214.10 in chips)
Seat 4: xKkwALG38OfLQ9DXuJgR1w ($210.25 in chips)
Seat 5: /inIs/z/PcX+TniIFpaxpg ($40 in chips)
Seat 6: NtLDBSjsJQEKekh5cdinvw ($373.35 in chips)
Seat 7: Kzta8yu9vxHT4B70mjBZ+w ($201 in chips)
Seat 9: F7m34OOfAQ7annesMHVjKw ($197 in chips)
Kzta8yu9vxHT4B70mjBZ+w: posts small blind $1
rW/MyplHylMSBRaoRUzWrg: is sitting out
F7m34OOfAQ7annesMHVjKw: posts big blind $2
*** HOLE CARDS ***
rW/MyplHylMSBRaoRUzWrg leaves the table
5Q8U6iZbeO7xJSS4qvDP5g: folds
gDCJIAlovbPnTvMM7Dd1gA: calls $2
+T/63sAeZzWyHchahJ36GQ joins the table at seat #8
WUlHm+ydPPHG7Lb0rePSdA: folds
xKkwALG38OfLQ9DXuJgR1w: folds
/inIs/z/PcX+TniIFpaxpg: folds
NtLDBSjsJQEKekh5cdinvw: folds
Kzta8yu9vxHT4B70mjBZ+w: folds
F7m34OOfAQ7annesMHVjKw: checks
*** FLOP *** [5c 7s 7d]
F7m34OOfAQ7annesMHVjKw: checks
gDCJIAlovbPnTvMM7Dd1gA: checks
*** TURN *** [5c 7s 7d] [2d]
F7m34OOfAQ7annesMHVjKw: bets $2
gDCJIAlovbPnTvMM7Dd1gA: raises $2 to $4
F7m34OOfAQ7annesMHVjKw: calls $2
*** RIVER *** [5c 7s 7d 2d] [9s]
F7m34OOfAQ7annesMHVjKw: checks
gDCJIAlovbPnTvMM7Dd1gA: bets $12
F7m34OOfAQ7annesMHVjKw: folds
gDCJIAlovbPnTvMM7Dd1gA collected $12.40 from pot
*** SUMMARY ***
Total pot $13 | Rake $0.60
Board [5c 7s 7d 2d 9s]
Seat 1: 5Q8U6iZbeO7xJSS4qvDP5g folded before Flop (didn't bet)
Seat 2: gDCJIAlovbPnTvMM7Dd1gA collected ($12.40)
Seat 3: WUlHm+ydPPHG7Lb0rePSdA folded before Flop (didn't bet)
Seat 4: xKkwALG38OfLQ9DXuJgR1w folded before Flop (didn't bet)
Seat 5: /inIs/z/PcX+TniIFpaxpg folded before Flop (didn't bet)
Seat 6: NtLDBSjsJQEKekh5cdinvw (button) folded before Flop (didn't bet)
Seat 7: Kzta8yu9vxHT4B70mjBZ+w (small blind) folded before Flop
Seat 9: F7m34OOfAQ7annesMHVjKw (big blind) folded on the River



PokerStars Game #59941422736:  Hold'em No Limit ($1/$2) - 2009/07/01 1:35:03 ET
Table 'UGLAZZyv+cXmnKjYin0etA' 6-max Seat #6 is the button
Seat 1: vkfxu8f/jMYKUk6Ly4eujw ($202 in chips)
Seat 2: eDLH1PUXFpvJBNMXBVQcGA ($276.35 in chips)
Seat 3: ygTTt5ehT4aF86q1a8/R+w ($117.20 in chips)
Seat 4: SiGJDsvRViJX05vHhA80GQ ($234.85 in chips)
Seat 5: 54yWzRRgS0oZ+S6LwZBxMQ ($33 in chips)
Seat 6: sTPOWERd9HWPCNrDBwsVjA ($210.10 in chips)
vkfxu8f/jMYKUk6Ly4eujw: posts small blind $1
eDLH1PUXFpvJBNMXBVQcGA: posts big blind $2
*** HOLE CARDS ***
ygTTt5ehT4aF86q1a8/R+w: folds
SiGJDsvRViJX05vHhA80GQ: folds
54yWzRRgS0oZ+S6LwZBxMQ: folds
sTPOWERd9HWPCNrDBwsVjA: folds
vkfxu8f/jMYKUk6Ly4eujw: folds
eDLH1PUXFpvJBNMXBVQcGA collected $2 from pot
*** SUMMARY ***
Total pot $2 | Rake $0
Seat 1: vkfxu8f/jMYKUk6Ly4eujw (small blind) folded before Flop
Seat 2: eDLH1PUXFpvJBNMXBVQcGA (big blind) collected ($2)
Seat 3: ygTTt5ehT4aF86q1a8/R+w folded before Flop (didn't bet)
Seat 4: SiGJDsvRViJX05vHhA80GQ folded before Flop (didn't bet)
Seat 5: 54yWzRRgS0oZ+S6LwZBxMQ folded before Flop (didn't bet)
Seat 6: sTPOWERd9HWPCNrDBwsVjA (button) folded before Flop (didn't bet)



PokerStars Game #59941424588:  Hold'em No Limit ($1/$2) - 2009/07/01 1:35:06 ET
Table 'kq5zaQ+1hLNf8LZfGnbTAA' 6-max Seat #5 is the button
Seat 1: 8srN1dKQePlsv0GyTada+Q ($440.60 in chips)
Seat 2: nXDI8Y/S6POzRwANu3d8hQ ($164 in chips)
Seat 3: /PH6Ffnho4Ysm8S3V/oa+w ($43 in chips)
Seat 4: 3dAbvkxS5NPQTBAbvpinVg ($278.45 in chips)
Seat 5: gnYme0DNFflnMhrdbxe1Ag ($200 in chips)
Seat 6: mfy7uGZcqA2PVQqEVbJ7+g ($189.25 in chips)
mfy7uGZcqA2PVQqEVbJ7+g: posts small blind $1
8srN1dKQePlsv0GyTada+Q: posts big blind $2
*** HOLE CARDS ***
nXDI8Y/S6POzRwANu3d8hQ: folds
/PH6Ffnho4Ysm8S3V/oa+w: folds
3dAbvkxS5NPQTBAbvpinVg: folds
gnYme0DNFflnMhrdbxe1Ag: raises $4 to $6
mfy7uGZcqA2PVQqEVbJ7+g: folds
8srN1dKQePlsv0GyTada+Q: calls $4
*** FLOP *** [5h Ac 8h]
8srN1dKQePlsv0GyTada+Q: checks
gnYme0DNFflnMhrdbxe1Ag: bets $8
8srN1dKQePlsv0GyTada+Q: folds
gnYme0DNFflnMhrdbxe1Ag collected $12.35 from pot
gnYme0DNFflnMhrdbxe1Ag: doesn't show hand
*** SUMMARY ***
Total pot $13 | Rake $0.65
Board [5h Ac 8h]
Seat 1: 8srN1dKQePlsv0GyTada+Q (big blind) folded on the Flop
Seat 2: nXDI8Y/S6POzRwANu3d8hQ folded before Flop (didn't bet)
Seat 3: /PH6Ffnho4Ysm8S3V/oa+w folded before Flop (didn't bet)
Seat 4: 3dAbvkxS5NPQTBAbvpinVg folded before Flop (didn't bet)
Seat 5: gnYme0DNFflnMhrdbxe1Ag (button) collected ($12.35)
Seat 6: mfy7uGZcqA2PVQqEVbJ7+g (small blind) folded before Flop



PokerStars Game #59941425022:  Hold'em No Limit ($1/$2) - 2009/07/01 1:35:07 ET
Table 'aSf77Sj8QEnzcc0WaxVD4Q' 6-max Seat #3 is the button
Seat 1: UELtvp+JfwI7XDGVwSxZXA ($289.10 in chips)
Seat 2: vkfxu8f/jMYKUk6Ly4eujw ($208.80 in chips)
Seat 3: 9dpyyjDTCed6nV7JhaUUpw ($496.70 in chips)
Seat 4: YsLQ3BAvgQHWXMAv3Wv6Hg ($200 in chips)
Seat 5: VvdR9F3I+2yELkfTVvC1dg ($261 in chips)
Seat 6: vkoJRf3gidxY1pPi0AFWww ($129.35 in chips)
YsLQ3BAvgQHWXMAv3Wv6Hg: posts small blind $1
VvdR9F3I+2yELkfTVvC1dg: posts big blind $2
*** HOLE CARDS ***
vkoJRf3gidxY1pPi0AFWww: calls $2
UELtvp+JfwI7XDGVwSxZXA: folds
vkfxu8f/jMYKUk6Ly4eujw: folds
9dpyyjDTCed6nV7JhaUUpw: folds
YsLQ3BAvgQHWXMAv3Wv6Hg: folds
VvdR9F3I+2yELkfTVvC1dg: checks
*** FLOP *** [Jh Td 9s]
VvdR9F3I+2yELkfTVvC1dg: checks
vkoJRf3gidxY1pPi0AFWww: bets $6
VvdR9F3I+2yELkfTVvC1dg: folds
vkoJRf3gidxY1pPi0AFWww collected $4.75 from pot
vkoJRf3gidxY1pPi0AFWww: doesn't show hand
*** SUMMARY ***
Total pot $5 | Rake $0.25
Board [Jh Td 9s]
Seat 1: UELtvp+JfwI7XDGVwSxZXA folded before Flop (didn't bet)
Seat 2: vkfxu8f/jMYKUk6Ly4eujw folded before Flop (didn't bet)
Seat 3: 9dpyyjDTCed6nV7JhaUUpw (button) folded before Flop (didn't bet)
Seat 4: YsLQ3BAvgQHWXMAv3Wv6Hg (small blind) folded before Flop
Seat 5: VvdR9F3I+2yELkfTVvC1dg (big blind) folded on the Flop
Seat 6: vkoJRf3gidxY1pPi0AFWww collected ($4.75)



PokerStars Game #59941425038:  Hold'em No Limit ($1/$2) - 2009/07/01 1:35:07 ET
Table 'eyAQSIlgc2o1Jxvbve4WGg' 9-max Seat #4 is the button
Seat 1: UZEsV9yKUMqmpYPiOFpaZw ($100.20 in chips)
Seat 2: kM9CA+2UcdMjbCMbtUCGiA ($200 in chips)
Seat 4: CkE3IyJF1KvdaAOmZY5XqQ ($200 in chips)
Seat 5: mIKx5lhIt13X5eZQH0ZeMA ($124.15 in chips)
Seat 6: nXDI8Y/S6POzRwANu3d8hQ ($40 in chips)
Seat 7: u3OrI5uGx9mx1fE7dgr+EA ($75.20 in chips)
Seat 8: 1CtiZuXDFaJL1dJPQKyi8Q ($161.95 in chips)
Seat 9: WUlHm+ydPPHG7Lb0rePSdA ($134.20 in chips)
mIKx5lhIt13X5eZQH0ZeMA: posts small blind $1
nXDI8Y/S6POzRwANu3d8hQ: posts big blind $2
*** HOLE CARDS ***
u3OrI5uGx9mx1fE7dgr+EA: folds
1CtiZuXDFaJL1dJPQKyi8Q: folds
WUlHm+ydPPHG7Lb0rePSdA: folds
UZEsV9yKUMqmpYPiOFpaZw: folds
kM9CA+2UcdMjbCMbtUCGiA: folds
CkE3IyJF1KvdaAOmZY5XqQ: folds
mIKx5lhIt13X5eZQH0ZeMA: calls $1
nXDI8Y/S6POzRwANu3d8hQ: checks
*** FLOP *** [Ks Tc Qh]
mIKx5lhIt13X5eZQH0ZeMA: checks
nXDI8Y/S6POzRwANu3d8hQ: bets $6
mIKx5lhIt13X5eZQH0ZeMA: raises $6 to $12
nXDI8Y/S6POzRwANu3d8hQ: folds
mIKx5lhIt13X5eZQH0ZeMA collected $15.25 from pot
*** SUMMARY ***
Total pot $16 | Rake $0.75
Board [Ks Tc Qh]
Seat 1: UZEsV9yKUMqmpYPiOFpaZw folded before Flop (didn't bet)
Seat 2: kM9CA+2UcdMjbCMbtUCGiA folded before Flop (didn't bet)
Seat 4: CkE3IyJF1KvdaAOmZY5XqQ (button) folded before Flop (didn't bet)
Seat 5: mIKx5lhIt13X5eZQH0ZeMA (small blind) collected ($15.25)
Seat 6: nXDI8Y/S6POzRwANu3d8hQ (big blind) folded on the Flop
Seat 7: u3OrI5uGx9mx1fE7dgr+EA folded before Flop (didn't bet)
Seat 8: 1CtiZuXDFaJL1dJPQKyi8Q folded before Flop (didn't bet)
Seat 9: WUlHm+ydPPHG7Lb0rePSdA folded before Flop (didn't bet)



PokerStars Game #59941425610:  Hold'em No Limit ($1/$2) - 2009/07/01 1:35:08 ET
Table 'jlrIxbrVIG+gjaUYT4za8g' 6-max Seat #5 is the button
Seat 1: ygTTt5ehT4aF86q1a8/R+w ($258.30 in chips)
Seat 2: /PH6Ffnho4Ysm8S3V/oa+w ($43 in chips)
Seat 3: gnYme0DNFflnMhrdbxe1Ag ($200 in chips)
Seat 4: 8srN1dKQePlsv0GyTada+Q ($244.20 in chips)
Seat 5: AyBB0k3Dcl7xbXUeGMw06g ($70.90 in chips)
Seat 6: vkfxu8f/jMYKUk6Ly4eujw ($323.15 in chips)
vkfxu8f/jMYKUk6Ly4eujw: posts small blind $1
ygTTt5ehT4aF86q1a8/R+w: posts big blind $2
*** HOLE CARDS ***
/PH6Ffnho4Ysm8S3V/oa+w: folds
gnYme0DNFflnMhrdbxe1Ag: folds
8srN1dKQePlsv0GyTada+Q: folds
AyBB0k3Dcl7xbXUeGMw06g: folds
vkfxu8f/jMYKUk6Ly4eujw: raises $6 to $8
ygTTt5ehT4aF86q1a8/R+w: calls $6
*** FLOP *** [Qd 7c Th]
vkfxu8f/jMYKUk6Ly4eujw: checks
ygTTt5ehT4aF86q1a8/R+w: bets $12
vkfxu8f/jMYKUk6Ly4eujw: raises $25 to $37
ygTTt5ehT4aF86q1a8/R+w: folds
vkfxu8f/jMYKUk6Ly4eujw collected $38.05 from pot
vkfxu8f/jMYKUk6Ly4eujw: doesn't show hand
*** SUMMARY ***
Total pot $40 | Rake $1.95
Board [Qd 7c Th]
Seat 1: ygTTt5ehT4aF86q1a8/R+w (big blind) folded on the Flop
Seat 2: /PH6Ffnho4Ysm8S3V/oa+w folded before Flop (didn't bet)
Seat 3: gnYme0DNFflnMhrdbxe1Ag folded before Flop (didn't bet)
Seat 4: 8srN1dKQePlsv0GyTada+Q folded before Flop (didn't bet)
Seat 5: AyBB0k3Dcl7xbXUeGMw06g (button) folded before Flop (didn't bet)
Seat 6: vkfxu8f/jMYKUk6Ly4eujw (small blind) collected ($38.05)



PokerStars Game #59941427076:  Hold'em No Limit ($1/$2) - 2009/07/01 1:35:10 ET
Table 'YqGfR5eHfMeSjb9a+QU9rg' 9-max Seat #1 is the button
Seat 1: rW/MyplHylMSBRaoRUzWrg ($36 in chips)
Seat 3: /gll27k+xWYV7Fbki0lFDQ ($259.75 in chips)
Seat 4: GX1heJ+DSsvm7gzSPsYhhQ ($37 in chips)
Seat 5: CkE3IyJF1KvdaAOmZY5XqQ ($200 in chips)
Seat 6: TAfo4veNRaRlzDXMMYS3Jg ($37 in chips)
Seat 7: 41aZuLBz9nAi2GPVKabmCw ($101.95 in chips)
Seat 8: JnV3SM2D6dAFYyGZHHpvrg ($90.25 in chips)
Seat 9: /inIs/z/PcX+TniIFpaxpg ($202.20 in chips)
nXDI8Y/S6POzRwANu3d8hQ will be allowed to play after the button
/gll27k+xWYV7Fbki0lFDQ: posts small blind $1
GX1heJ+DSsvm7gzSPsYhhQ: posts big blind $2
*** HOLE CARDS ***
CkE3IyJF1KvdaAOmZY5XqQ: folds
TAfo4veNRaRlzDXMMYS3Jg: folds
41aZuLBz9nAi2GPVKabmCw: folds
JnV3SM2D6dAFYyGZHHpvrg: raises $2 to $4
/inIs/z/PcX+TniIFpaxpg: folds
rW/MyplHylMSBRaoRUzWrg: folds
/gll27k+xWYV7Fbki0lFDQ: folds
GX1heJ+DSsvm7gzSPsYhhQ: folds
JnV3SM2D6dAFYyGZHHpvrg collected $5 from pot
*** SUMMARY ***
Total pot $5 | Rake $0
Seat 1: rW/MyplHylMSBRaoRUzWrg (button) folded before Flop (didn't bet)
Seat 3: /gll27k+xWYV7Fbki0lFDQ (small blind) folded before Flop
Seat 4: GX1heJ+DSsvm7gzSPsYhhQ (big blind) folded before Flop
Seat 5: CkE3IyJF1KvdaAOmZY5XqQ folded before Flop (didn't bet)
Seat 6: TAfo4veNRaRlzDXMMYS3Jg folded before Flop (didn't bet)
Seat 7: 41aZuLBz9nAi2GPVKabmCw folded before Flop (didn't bet)
Seat 8: JnV3SM2D6dAFYyGZHHpvrg collected ($5)
Seat 9: /inIs/z/PcX+TniIFpaxpg folded before Flop (didn't bet)



PokerStars Game #59941429492:  Hold'em No Limit ($1/$2) - 2009/07/01 1:35:14 ET
Table 'on4i1U1lCRmxsduFD3xiSg' 9-max Seat #9 is the button
Seat 1: so5k3vFDmokh2q3dImJ1GQ ($177.30 in chips)
Seat 2: NqSvZNzJ4RkR3sCmgQnyLw ($47.85 in chips)
Seat 3: GX1heJ+DSsvm7gzSPsYhhQ ($29.70 in chips)
Seat 4: DFQVuszLVclqjA46pN4Vvw ($119.75 in chips)
Seat 6: +T/63sAeZzWyHchahJ36GQ ($37 in chips)
Seat 7: /inIs/z/PcX+TniIFpaxpg ($271.05 in chips)
Seat 8: ZYHoLw2lWmRS7CSHi8L8Xg ($200 in chips)
Seat 9: TAfo4veNRaRlzDXMMYS3Jg ($37 in chips)
so5k3vFDmokh2q3dImJ1GQ: posts small blind $1
NqSvZNzJ4RkR3sCmgQnyLw: posts big blind $2
*** HOLE CARDS ***
GX1heJ+DSsvm7gzSPsYhhQ: folds
DFQVuszLVclqjA46pN4Vvw: calls $2
+T/63sAeZzWyHchahJ36GQ: folds
/inIs/z/PcX+TniIFpaxpg: folds
ZYHoLw2lWmRS7CSHi8L8Xg: folds
TAfo4veNRaRlzDXMMYS3Jg: folds
so5k3vFDmokh2q3dImJ1GQ: folds
NqSvZNzJ4RkR3sCmgQnyLw: checks
*** FLOP *** [5s Qc Kd]
NqSvZNzJ4RkR3sCmgQnyLw: checks
DFQVuszLVclqjA46pN4Vvw: bets $10
NqSvZNzJ4RkR3sCmgQnyLw: folds
DFQVuszLVclqjA46pN4Vvw collected $4.75 from pot
*** SUMMARY ***
Total pot $5 | Rake $0.25
Board [5s Qc Kd]
Seat 1: so5k3vFDmokh2q3dImJ1GQ (small blind) folded before Flop
Seat 2: NqSvZNzJ4RkR3sCmgQnyLw (big blind) folded on the Flop
Seat 3: GX1heJ+DSsvm7gzSPsYhhQ folded before Flop (didn't bet)
Seat 4: DFQVuszLVclqjA46pN4Vvw collected ($4.75)
Seat 6: +T/63sAeZzWyHchahJ36GQ folded before Flop (didn't bet)
Seat 7: /inIs/z/PcX+TniIFpaxpg folded before Flop (didn't bet)
Seat 8: ZYHoLw2lWmRS7CSHi8L8Xg folded before Flop (didn't bet)
Seat 9: TAfo4veNRaRlzDXMMYS3Jg (button) folded before Flop (didn't bet)



PokerStars Game #59941429866:  Hold'em No Limit ($1/$2) - 2009/07/01 1:35:15 ET
Table 'P/yCfYl1GfGsu/e6DxDy/A' 2-max Seat #1 is the button
Seat 1: 7fOCUy3x9hdkmXkkDNolGQ ($550 in chips)
Seat 2: RwDoM55ZeQuI2ADyJhOb2Q ($930 in chips)
7fOCUy3x9hdkmXkkDNolGQ: posts small blind $1
RwDoM55ZeQuI2ADyJhOb2Q: posts big blind $2
*** HOLE CARDS ***
7fOCUy3x9hdkmXkkDNolGQ: raises $4 to $6
RwDoM55ZeQuI2ADyJhOb2Q: raises $14 to $20
7fOCUy3x9hdkmXkkDNolGQ: calls $14
*** FLOP *** [3d Th Ah]
RwDoM55ZeQuI2ADyJhOb2Q: bets $22
7fOCUy3x9hdkmXkkDNolGQ: calls $22
*** TURN *** [3d Th Ah] [Qs]
RwDoM55ZeQuI2ADyJhOb2Q: bets $62
7fOCUy3x9hdkmXkkDNolGQ: folds
RwDoM55ZeQuI2ADyJhOb2Q collected $83.50 from pot
RwDoM55ZeQuI2ADyJhOb2Q: doesn't show hand
*** SUMMARY ***
Total pot $84 | Rake $0.50
Board [3d Th Ah Qs]
Seat 1: 7fOCUy3x9hdkmXkkDNolGQ (button) (small blind) folded on the Turn
Seat 2: RwDoM55ZeQuI2ADyJhOb2Q (big blind) collected ($83.50)



PokerStars Game #59941429704:  Hold'em No Limit ($1/$2) - 2009/07/01 1:35:15 ET
Table 'gftD4mDF7mIFKvSrIyaRbw' 9-max Seat #7 is the button
Seat 2: GX1heJ+DSsvm7gzSPsYhhQ ($36 in chips)
Seat 3: CUZwDpLTQKhzarPe+JCLOQ ($204.75 in chips)
Seat 4: /inIs/z/PcX+TniIFpaxpg ($37 in chips)
Seat 5: mpsfNtnMVDqQHTe92AhIdw ($117.10 in chips)
Seat 6: 2NvwF8W2nzsbS+G//yLAbQ ($115.20 in chips)
Seat 7: +T/63sAeZzWyHchahJ36GQ ($46 in chips)
Seat 8: MpL4DeEqGQu0H8TJEbEOrg ($39 in chips)
MpL4DeEqGQu0H8TJEbEOrg: posts small blind $1
GX1heJ+DSsvm7gzSPsYhhQ: posts big blind $2
*** HOLE CARDS ***
CUZwDpLTQKhzarPe+JCLOQ: raises $6 to $8
/inIs/z/PcX+TniIFpaxpg: folds
mpsfNtnMVDqQHTe92AhIdw: calls $8
2NvwF8W2nzsbS+G//yLAbQ: folds
+T/63sAeZzWyHchahJ36GQ: folds
MpL4DeEqGQu0H8TJEbEOrg: folds
GX1heJ+DSsvm7gzSPsYhhQ: folds
*** FLOP *** [Qd Td 5c]
CUZwDpLTQKhzarPe+JCLOQ: bets $12
mpsfNtnMVDqQHTe92AhIdw: calls $12
*** TURN *** [Qd Td 5c] [2c]
CUZwDpLTQKhzarPe+JCLOQ: bets $22
mpsfNtnMVDqQHTe92AhIdw: folds
CUZwDpLTQKhzarPe+JCLOQ collected $40.90 from pot
CUZwDpLTQKhzarPe+JCLOQ: doesn't show hand
*** SUMMARY ***
Total pot $43 | Rake $2.10
Board [Qd Td 5c 2c]
Seat 2: GX1heJ+DSsvm7gzSPsYhhQ (big blind) folded before Flop
Seat 3: CUZwDpLTQKhzarPe+JCLOQ collected ($40.90)
Seat 4: /inIs/z/PcX+TniIFpaxpg folded before Flop (didn't bet)
Seat 5: mpsfNtnMVDqQHTe92AhIdw folded on the Turn
Seat 6: 2NvwF8W2nzsbS+G//yLAbQ folded before Flop (didn't bet)
Seat 7: +T/63sAeZzWyHchahJ36GQ (button) folded before Flop (didn't bet)
Seat 8: MpL4DeEqGQu0H8TJEbEOrg (small blind) folded before Flop



PokerStars Game #59941430086:  Hold'em No Limit ($1/$2) - 2009/07/01 1:35:16 ET
Table '/ci73fTmzTzmGWzAtqEX2Q' 9-max Seat #6 is the button
Seat 1: 9efVc1cB3yHt4TvBkTusPw ($152.90 in chips)
Seat 2: pN/Ip0ePsUVIdUlGgLrkUw ($225 in chips)
Seat 3: kK1+5ivyJZeA8hQF2pdvvQ ($64.55 in chips)
Seat 4: 2yq7Zp4xmrhAw8+37hTkaA ($166.20 in chips)
Seat 5: 1CtiZuXDFaJL1dJPQKyi8Q ($215 in chips)
Seat 6: GX1heJ+DSsvm7gzSPsYhhQ ($44.65 in chips)
Seat 8: /inIs/z/PcX+TniIFpaxpg ($35 in chips)
Seat 9: S8aS+9FTYQ/ICLBNThcrkg ($183 in chips)
+T/63sAeZzWyHchahJ36GQ will be allowed to play after the button
/inIs/z/PcX+TniIFpaxpg: posts small blind $1
S8aS+9FTYQ/ICLBNThcrkg: posts big blind $2
*** HOLE CARDS ***
9efVc1cB3yHt4TvBkTusPw: folds
pN/Ip0ePsUVIdUlGgLrkUw: folds
kK1+5ivyJZeA8hQF2pdvvQ: folds
2yq7Zp4xmrhAw8+37hTkaA: raises $4 to $6
1CtiZuXDFaJL1dJPQKyi8Q: folds
GX1heJ+DSsvm7gzSPsYhhQ: folds
/inIs/z/PcX+TniIFpaxpg: folds
S8aS+9FTYQ/ICLBNThcrkg: folds
2yq7Zp4xmrhAw8+37hTkaA collected $5 from pot
*** SUMMARY ***
Total pot $5 | Rake $0
Seat 1: 9efVc1cB3yHt4TvBkTusPw folded before Flop (didn't bet)
Seat 2: pN/Ip0ePsUVIdUlGgLrkUw folded before Flop (didn't bet)
Seat 3: kK1+5ivyJZeA8hQF2pdvvQ folded before Flop (didn't bet)
Seat 4: 2yq7Zp4xmrhAw8+37hTkaA collected ($5)
Seat 5: 1CtiZuXDFaJL1dJPQKyi8Q folded before Flop (didn't bet)
Seat 6: GX1heJ+DSsvm7gzSPsYhhQ (button) folded before Flop (didn't bet)
Seat 8: /inIs/z/PcX+TniIFpaxpg (small blind) folded before Flop
Seat 9: S8aS+9FTYQ/ICLBNThcrkg (big blind) folded before Flop



PokerStars Game #59941431496:  Hold'em No Limit ($1/$2) - 2009/07/01 1:35:18 ET
Table 'SF49/KQm8T4taMp6kb+HXA' 9-max Seat #7 is the button
Seat 1: CUZwDpLTQKhzarPe+JCLOQ ($303.15 in chips)
Seat 2: rW/MyplHylMSBRaoRUzWrg ($43 in chips)
Seat 3: pCmk6FpSOLJ+85o1tLHIag ($280.75 in chips)
Seat 4: HffgoYm61KgkdMe/DYChIQ ($262.25 in chips)
Seat 5: ri8CLkX3e9JF34dQNbsHGA ($40 in chips)
Seat 7: nXDI8Y/S6POzRwANu3d8hQ ($37 in chips)
Seat 8: GgrYze3jkUdSO7a7CuJGDw ($195 in chips)
Seat 9: /inIs/z/PcX+TniIFpaxpg ($320.15 in chips)
GgrYze3jkUdSO7a7CuJGDw: posts small blind $1
/inIs/z/PcX+TniIFpaxpg: posts big blind $2
*** HOLE CARDS ***
CUZwDpLTQKhzarPe+JCLOQ: folds
rW/MyplHylMSBRaoRUzWrg: folds
pCmk6FpSOLJ+85o1tLHIag: folds
HffgoYm61KgkdMe/DYChIQ: raises $4 to $6
ri8CLkX3e9JF34dQNbsHGA: folds
nXDI8Y/S6POzRwANu3d8hQ: folds
GgrYze3jkUdSO7a7CuJGDw: folds
/inIs/z/PcX+TniIFpaxpg: folds
HffgoYm61KgkdMe/DYChIQ collected $5 from pot
*** SUMMARY ***
Total pot $5 | Rake $0
Seat 1: CUZwDpLTQKhzarPe+JCLOQ folded before Flop (didn't bet)
Seat 2: rW/MyplHylMSBRaoRUzWrg folded before Flop (didn't bet)
Seat 3: pCmk6FpSOLJ+85o1tLHIag folded before Flop (didn't bet)
Seat 4: HffgoYm61KgkdMe/DYChIQ collected ($5)
Seat 5: ri8CLkX3e9JF34dQNbsHGA folded before Flop (didn't bet)
Seat 7: nXDI8Y/S6POzRwANu3d8hQ (button) folded before Flop (didn't bet)
Seat 8: GgrYze3jkUdSO7a7CuJGDw (small blind) folded before Flop
Seat 9: /inIs/z/PcX+TniIFpaxpg (big blind) folded before Flop



PokerStars Game #59941431830:  Hold'em No Limit ($1/$2) - 2009/07/01 1:35:19 ET
Table 'gnHBqWll9O3fxG7Ojkz/ng' 9-max Seat #2 is the button
Seat 1: TAfo4veNRaRlzDXMMYS3Jg ($31 in chips)
Seat 2: H6Z4+qu8gR0VUiPOijndVg ($328.95 in chips)
Seat 3: 5Q8U6iZbeO7xJSS4qvDP5g ($219.05 in chips)
Seat 4: nXDI8Y/S6POzRwANu3d8hQ ($39 in chips)
Seat 5: rBQDMkKm9cZn6M9NPsiVew ($227.15 in chips)
Seat 7: jqui3xAWCkcdPW36a6BD+w ($347.55 in chips)
Seat 8: cM6efHzdxoqYm0EQKP4TTQ ($82.15 in chips)
Seat 9: GX1heJ+DSsvm7gzSPsYhhQ ($50.35 in chips)
5Q8U6iZbeO7xJSS4qvDP5g: posts small blind $1
nXDI8Y/S6POzRwANu3d8hQ: posts big blind $2
MeleaB: sits out
*** HOLE CARDS ***
rBQDMkKm9cZn6M9NPsiVew: folds
jqui3xAWCkcdPW36a6BD+w: folds
cM6efHzdxoqYm0EQKP4TTQ: folds
GX1heJ+DSsvm7gzSPsYhhQ: folds
TAfo4veNRaRlzDXMMYS3Jg: folds
H6Z4+qu8gR0VUiPOijndVg: raises $2 to $4
5Q8U6iZbeO7xJSS4qvDP5g: folds
nXDI8Y/S6POzRwANu3d8hQ: folds
H6Z4+qu8gR0VUiPOijndVg collected $5 from pot
H6Z4+qu8gR0VUiPOijndVg: doesn't show hand
*** SUMMARY ***
Total pot $5 | Rake $0
Seat 1: TAfo4veNRaRlzDXMMYS3Jg folded before Flop (didn't bet)
Seat 2: H6Z4+qu8gR0VUiPOijndVg (button) collected ($5)
Seat 3: 5Q8U6iZbeO7xJSS4qvDP5g (small blind) folded before Flop
Seat 4: nXDI8Y/S6POzRwANu3d8hQ (big blind) folded before Flop
Seat 5: rBQDMkKm9cZn6M9NPsiVew folded before Flop (didn't bet)
Seat 7: jqui3xAWCkcdPW36a6BD+w folded before Flop (didn't bet)
Seat 8: cM6efHzdxoqYm0EQKP4TTQ folded before Flop (didn't bet)
Seat 9: GX1heJ+DSsvm7gzSPsYhhQ folded before Flop (didn't bet)



PokerStars Game #59941431774:  Hold'em No Limit ($1/$2) - 2009/07/01 1:35:19 ET
Table '4NGNnZ/osQfNq6abYqkJeA' 6-max Seat #5 is the button
Seat 1: vkfxu8f/jMYKUk6Ly4eujw ($200 in chips)
Seat 2: 669iGNwYwgRZg3nhS+aDAQ ($98.25 in chips)
Seat 3: 54yWzRRgS0oZ+S6LwZBxMQ ($32 in chips)
Seat 4: sY+4Uuh5z/6AbXXaCS10jw ($225.25 in chips)
Seat 5: VvdR9F3I+2yELkfTVvC1dg ($243.55 in chips)
Seat 6: /PH6Ffnho4Ysm8S3V/oa+w ($40 in chips)
/PH6Ffnho4Ysm8S3V/oa+w: posts small blind $1
vkfxu8f/jMYKUk6Ly4eujw: posts big blind $2
*** HOLE CARDS ***
669iGNwYwgRZg3nhS+aDAQ: calls $2
54yWzRRgS0oZ+S6LwZBxMQ: folds
sY+4Uuh5z/6AbXXaCS10jw: folds
VvdR9F3I+2yELkfTVvC1dg: calls $2
/PH6Ffnho4Ysm8S3V/oa+w: folds
vkfxu8f/jMYKUk6Ly4eujw: checks
*** FLOP *** [7c 8c 4c]
vkfxu8f/jMYKUk6Ly4eujw: checks
669iGNwYwgRZg3nhS+aDAQ: checks
VvdR9F3I+2yELkfTVvC1dg: checks
*** TURN *** [7c 8c 4c] [2s]
vkfxu8f/jMYKUk6Ly4eujw: checks
669iGNwYwgRZg3nhS+aDAQ: bets $4
VvdR9F3I+2yELkfTVvC1dg: folds
vkfxu8f/jMYKUk6Ly4eujw: folds
669iGNwYwgRZg3nhS+aDAQ collected $6.65 from pot
*** SUMMARY ***
Total pot $7 | Rake $0.35
Board [7c 8c 4c 2s]
Seat 1: vkfxu8f/jMYKUk6Ly4eujw (big blind) folded on the Turn
Seat 2: 669iGNwYwgRZg3nhS+aDAQ collected ($6.65)
Seat 3: 54yWzRRgS0oZ+S6LwZBxMQ folded before Flop (didn't bet)
Seat 4: sY+4Uuh5z/6AbXXaCS10jw folded before Flop (didn't bet)
Seat 5: VvdR9F3I+2yELkfTVvC1dg (button) folded on the Turn
Seat 6: /PH6Ffnho4Ysm8S3V/oa+w (small blind) folded before Flop



PokerStars Game #59941432416:  Hold'em No Limit ($1/$2) - 2009/07/01 1:35:20 ET
Table 'pPQgcj9XT9CHBsbo1WTBug' 6-max Seat #3 is the button
Seat 1: DFVYDA6dKQy7R7mGIKogZA ($140.95 in chips)
Seat 2: qXDd0ZyMIse0OBu8pxeQ3Q ($200 in chips)
Seat 3: 54yWzRRgS0oZ+S6LwZBxMQ ($49.50 in chips)
Seat 4: gqlysXCbT8V54f/1lf9h3A ($75.45 in chips)
Seat 5: vkfxu8f/jMYKUk6Ly4eujw ($190.55 in chips)
Seat 6: Yr7pZltpy3IUNdKS9PCEiw ($315.80 in chips)
gqlysXCbT8V54f/1lf9h3A: posts small blind $1
vkfxu8f/jMYKUk6Ly4eujw: posts big blind $2
*** HOLE CARDS ***
Yr7pZltpy3IUNdKS9PCEiw: folds
DFVYDA6dKQy7R7mGIKogZA: calls $2
qXDd0ZyMIse0OBu8pxeQ3Q: folds
54yWzRRgS0oZ+S6LwZBxMQ: folds
gqlysXCbT8V54f/1lf9h3A: calls $1
vkfxu8f/jMYKUk6Ly4eujw: raises $9 to $11
DFVYDA6dKQy7R7mGIKogZA: folds
gqlysXCbT8V54f/1lf9h3A: folds
vkfxu8f/jMYKUk6Ly4eujw collected $6 from pot
vkfxu8f/jMYKUk6Ly4eujw: doesn't show hand
*** SUMMARY ***
Total pot $6 | Rake $0
Seat 1: DFVYDA6dKQy7R7mGIKogZA folded before Flop
Seat 2: qXDd0ZyMIse0OBu8pxeQ3Q folded before Flop (didn't bet)
Seat 3: 54yWzRRgS0oZ+S6LwZBxMQ (button) folded before Flop (didn't bet)
Seat 4: gqlysXCbT8V54f/1lf9h3A (small blind) folded before Flop
Seat 5: vkfxu8f/jMYKUk6Ly4eujw (big blind) collected ($6)
Seat 6: Yr7pZltpy3IUNdKS9PCEiw folded before Flop (didn't bet)



PokerStars Game #59941433888:  Hold'em No Limit ($1/$2) - 2009/07/01 1:35:22 ET
Table 'CFkQcfWjKccZaZDf71FK+w' 6-max Seat #1 is the button
Seat 1: vkfxu8f/jMYKUk6Ly4eujw ($197 in chips)
Seat 2: ewN/vzF22+/gdzjIKBOlkA ($205.80 in chips)
Seat 3: 09BNF4quPDzanQzM8vc6WA ($46.65 in chips)
Seat 4: ygTTt5ehT4aF86q1a8/R+w ($233.65 in chips)
Seat 5: 2lOU1DcvUZaMcxZ95XfzXw ($139.60 in chips)
Seat 6: ORVqY3rf9X6ANA/8s+On2Q ($144.60 in chips)
ewN/vzF22+/gdzjIKBOlkA: posts small blind $1
09BNF4quPDzanQzM8vc6WA: posts big blind $2
*** HOLE CARDS ***
ygTTt5ehT4aF86q1a8/R+w: folds
2lOU1DcvUZaMcxZ95XfzXw: folds
ORVqY3rf9X6ANA/8s+On2Q: folds
vkfxu8f/jMYKUk6Ly4eujw: folds
ewN/vzF22+/gdzjIKBOlkA: raises $4 to $6
09BNF4quPDzanQzM8vc6WA: folds
ewN/vzF22+/gdzjIKBOlkA collected $4 from pot
*** SUMMARY ***
Total pot $4 | Rake $0
Seat 1: vkfxu8f/jMYKUk6Ly4eujw (button) folded before Flop (didn't bet)
Seat 2: ewN/vzF22+/gdzjIKBOlkA (small blind) collected ($4)
Seat 3: 09BNF4quPDzanQzM8vc6WA (big blind) folded before Flop
Seat 4: ygTTt5ehT4aF86q1a8/R+w folded before Flop (didn't bet)
Seat 5: 2lOU1DcvUZaMcxZ95XfzXw folded before Flop (didn't bet)
Seat 6: ORVqY3rf9X6ANA/8s+On2Q folded before Flop (didn't bet)



PokerStars Game #59941437634:  Hold'em No Limit ($1/$2) - 2009/07/01 1:35:29 ET
Table 'AtOXMvcrtQM8yLNcALmfLQ' 2-max Seat #1 is the button
Seat 1: +HlQuAsMqZGYYtjcPO/a3A ($365.50 in chips)
Seat 2: pVqEzK9wXlRMECnb1Zg4Zw ($197.50 in chips)
+HlQuAsMqZGYYtjcPO/a3A: posts small blind $1
pVqEzK9wXlRMECnb1Zg4Zw: posts big blind $2
*** HOLE CARDS ***
+HlQuAsMqZGYYtjcPO/a3A: calls $1
pVqEzK9wXlRMECnb1Zg4Zw: raises $8 to $10
+HlQuAsMqZGYYtjcPO/a3A: folds
pVqEzK9wXlRMECnb1Zg4Zw collected $4 from pot
pVqEzK9wXlRMECnb1Zg4Zw: doesn't show hand
*** SUMMARY ***
Total pot $4 | Rake $0
Seat 1: +HlQuAsMqZGYYtjcPO/a3A (button) (small blind) folded before Flop
Seat 2: pVqEzK9wXlRMECnb1Zg4Zw (big blind) collected ($4)



PokerStars Game #59941438046:  Hold'em No Limit ($1/$2) - 2009/07/01 1:35:30 ET
Table '3WCXyaiCAbqSShQu7FIjvA' 9-max Seat #4 is the button
Seat 1: kTCkABD1UUldS9DFRGfCwQ ($154.75 in chips)
Seat 2: TAfo4veNRaRlzDXMMYS3Jg ($37 in chips)
Seat 3: 5Q8U6iZbeO7xJSS4qvDP5g ($273.85 in chips)
Seat 4: waEF/+pxZTxNo4FvsORuXg ($78.40 in chips)
Seat 5: CkE3IyJF1KvdaAOmZY5XqQ ($201 in chips)
Seat 6: 5jQlngvMSqM/WoonOcR5kw ($276.35 in chips)
Seat 8: 1CtiZuXDFaJL1dJPQKyi8Q ($239.05 in chips)
Seat 9: FiXPLJyqb24l32QST2TInw ($116.40 in chips)
CkE3IyJF1KvdaAOmZY5XqQ: posts small blind $1
5jQlngvMSqM/WoonOcR5kw: posts big blind $2
nXDI8Y/S6POzRwANu3d8hQ: sits out
*** HOLE CARDS ***
1CtiZuXDFaJL1dJPQKyi8Q: calls $2
FiXPLJyqb24l32QST2TInw: calls $2
kTCkABD1UUldS9DFRGfCwQ has timed out
kTCkABD1UUldS9DFRGfCwQ: folds
kTCkABD1UUldS9DFRGfCwQ is sitting out
TAfo4veNRaRlzDXMMYS3Jg: folds
5Q8U6iZbeO7xJSS4qvDP5g: folds
kTCkABD1UUldS9DFRGfCwQ has returned
waEF/+pxZTxNo4FvsORuXg: folds
CkE3IyJF1KvdaAOmZY5XqQ: folds
5jQlngvMSqM/WoonOcR5kw: checks
*** FLOP *** [Ac 7c Jh]
5jQlngvMSqM/WoonOcR5kw: checks
1CtiZuXDFaJL1dJPQKyi8Q: checks
FiXPLJyqb24l32QST2TInw: checks
*** TURN *** [Ac 7c Jh] [3h]
5jQlngvMSqM/WoonOcR5kw: checks
1CtiZuXDFaJL1dJPQKyi8Q: checks
FiXPLJyqb24l32QST2TInw: checks
*** RIVER *** [Ac 7c Jh 3h] [9c]
5jQlngvMSqM/WoonOcR5kw: bets $4
1CtiZuXDFaJL1dJPQKyi8Q: folds
FiXPLJyqb24l32QST2TInw: calls $4
*** SHOW DOWN ***
5jQlngvMSqM/WoonOcR5kw: shows [Jc Ad] (two pair, Aces and Jacks)
FiXPLJyqb24l32QST2TInw: mucks hand
5jQlngvMSqM/WoonOcR5kw collected $14.30 from pot
*** SUMMARY ***
Total pot $15 | Rake $0.70
Board [Ac 7c Jh 3h 9c]
Seat 1: kTCkABD1UUldS9DFRGfCwQ folded before Flop (didn't bet)
Seat 2: TAfo4veNRaRlzDXMMYS3Jg folded before Flop (didn't bet)
Seat 3: 5Q8U6iZbeO7xJSS4qvDP5g folded before Flop (didn't bet)
Seat 4: waEF/+pxZTxNo4FvsORuXg (button) folded before Flop (didn't bet)
Seat 5: CkE3IyJF1KvdaAOmZY5XqQ (small blind) folded before Flop
Seat 6: 5jQlngvMSqM/WoonOcR5kw (big blind) showed [Jc Ad] and won ($14.30) with two pair, Aces and Jacks
Seat 8: 1CtiZuXDFaJL1dJPQKyi8Q folded on the River
Seat 9: FiXPLJyqb24l32QST2TInw mucked



PokerStars Game #59941440094:  Hold'em No Limit ($1/$2) - 2009/07/01 1:35:34 ET
Table 'ZzSIe0zTCDv+n6hfbY5tTg' 6-max Seat #2 is the button
Seat 1: VvdR9F3I+2yELkfTVvC1dg ($237 in chips)
Seat 2: B87ikIyZ/TzAVeXf38Ny0g ($249 in chips)
Seat 3: gsugPj31Hui3Jefl98MBOA ($351 in chips)
Seat 4: qXDd0ZyMIse0OBu8pxeQ3Q ($266 in chips)
Seat 5: 3dAbvkxS5NPQTBAbvpinVg ($477.30 in chips)
Seat 6: 09BNF4quPDzanQzM8vc6WA ($23.05 in chips)
gsugPj31Hui3Jefl98MBOA: posts small blind $1
qXDd0ZyMIse0OBu8pxeQ3Q: posts big blind $2
*** HOLE CARDS ***
3dAbvkxS5NPQTBAbvpinVg: raises $4 to $6
09BNF4quPDzanQzM8vc6WA: folds
VvdR9F3I+2yELkfTVvC1dg: folds
B87ikIyZ/TzAVeXf38Ny0g: calls $6
gsugPj31Hui3Jefl98MBOA: folds
qXDd0ZyMIse0OBu8pxeQ3Q: calls $4
*** FLOP *** [Ks 3c 8s]
qXDd0ZyMIse0OBu8pxeQ3Q: checks
3dAbvkxS5NPQTBAbvpinVg: bets $14
B87ikIyZ/TzAVeXf38Ny0g: folds
qXDd0ZyMIse0OBu8pxeQ3Q: folds
3dAbvkxS5NPQTBAbvpinVg collected $18.05 from pot
3dAbvkxS5NPQTBAbvpinVg: doesn't show hand
*** SUMMARY ***
Total pot $19 | Rake $0.95
Board [Ks 3c 8s]
Seat 1: VvdR9F3I+2yELkfTVvC1dg folded before Flop (didn't bet)
Seat 2: B87ikIyZ/TzAVeXf38Ny0g (button) folded on the Flop
Seat 3: gsugPj31Hui3Jefl98MBOA (small blind) folded before Flop
Seat 4: qXDd0ZyMIse0OBu8pxeQ3Q (big blind) folded on the Flop
Seat 5: 3dAbvkxS5NPQTBAbvpinVg collected ($18.05)
Seat 6: 09BNF4quPDzanQzM8vc6WA folded before Flop (didn't bet)



PokerStars Game #59941440958:  Hold'em No Limit ($1/$2) - 2009/07/01 1:35:35 ET
Table 'uJ9juaXXg9yIcSU8amxaXQ' 6-max Seat #2 is the button
Seat 2: VvdR9F3I+2yELkfTVvC1dg ($220.10 in chips)
Seat 3: qXDd0ZyMIse0OBu8pxeQ3Q ($244.40 in chips)
Seat 4: zNjJ/y4emmF+vzrCDd+ooA ($228.05 in chips)
Seat 5: YsLQ3BAvgQHWXMAv3Wv6Hg ($200 in chips)
qXDd0ZyMIse0OBu8pxeQ3Q: posts small blind $1
zNjJ/y4emmF+vzrCDd+ooA: posts big blind $2
JsqOjN/eHz0uYVf/PyUJ6Q: sits out
*** HOLE CARDS ***
YsLQ3BAvgQHWXMAv3Wv6Hg: folds
VvdR9F3I+2yELkfTVvC1dg: raises $2 to $4
qXDd0ZyMIse0OBu8pxeQ3Q: folds
zNjJ/y4emmF+vzrCDd+ooA: folds
VvdR9F3I+2yELkfTVvC1dg collected $5 from pot
VvdR9F3I+2yELkfTVvC1dg: doesn't show hand
*** SUMMARY ***
Total pot $5 | Rake $0
Seat 2: VvdR9F3I+2yELkfTVvC1dg (button) collected ($5)
Seat 3: qXDd0ZyMIse0OBu8pxeQ3Q (small blind) folded before Flop
Seat 4: zNjJ/y4emmF+vzrCDd+ooA (big blind) folded before Flop
Seat 5: YsLQ3BAvgQHWXMAv3Wv6Hg folded before Flop (didn't bet)



PokerStars Game #59941441518:  Hold'em No Limit ($1/$2) - 2009/07/01 1:35:36 ET
Table 'UGLAZZyv+cXmnKjYin0etA' 6-max Seat #1 is the button
Seat 1: vkfxu8f/jMYKUk6Ly4eujw ($201 in chips)
Seat 2: eDLH1PUXFpvJBNMXBVQcGA ($277.35 in chips)
Seat 3: ygTTt5ehT4aF86q1a8/R+w ($117.20 in chips)
Seat 4: SiGJDsvRViJX05vHhA80GQ ($234.85 in chips)
Seat 5: 54yWzRRgS0oZ+S6LwZBxMQ ($33 in chips)
Seat 6: sTPOWERd9HWPCNrDBwsVjA ($210.10 in chips)
eDLH1PUXFpvJBNMXBVQcGA: posts small blind $1
ygTTt5ehT4aF86q1a8/R+w: posts big blind $2
*** HOLE CARDS ***
SiGJDsvRViJX05vHhA80GQ: folds
54yWzRRgS0oZ+S6LwZBxMQ: calls $2
sTPOWERd9HWPCNrDBwsVjA: folds
vkfxu8f/jMYKUk6Ly4eujw: folds
eDLH1PUXFpvJBNMXBVQcGA: folds
ygTTt5ehT4aF86q1a8/R+w: checks
*** FLOP *** [9c 2h 2c]
ygTTt5ehT4aF86q1a8/R+w: checks
54yWzRRgS0oZ+S6LwZBxMQ: bets $4
ygTTt5ehT4aF86q1a8/R+w: folds
54yWzRRgS0oZ+S6LwZBxMQ collected $4.75 from pot
*** SUMMARY ***
Total pot $5 | Rake $0.25
Board [9c 2h 2c]
Seat 1: vkfxu8f/jMYKUk6Ly4eujw (button) folded before Flop (didn't bet)
Seat 2: eDLH1PUXFpvJBNMXBVQcGA (small blind) folded before Flop
Seat 3: ygTTt5ehT4aF86q1a8/R+w (big blind) folded on the Flop
Seat 4: SiGJDsvRViJX05vHhA80GQ folded before Flop (didn't bet)
Seat 5: 54yWzRRgS0oZ+S6LwZBxMQ collected ($4.75)
Seat 6: sTPOWERd9HWPCNrDBwsVjA folded before Flop (didn't bet)



PokerStars Game #59941441584:  Hold'em No Limit ($1/$2) - 2009/07/01 1:35:36 ET
Table 'TsEDkiO4tzCTCzJ7tNdEqw' 6-max Seat #6 is the button
Seat 1: MfXQsYD8pGeCS7XOtyV+vw ($61.05 in chips)
Seat 2: 4dcDwIHRm96PwtqkpQiuiA ($75.10 in chips)
Seat 3: ubtx4Z5L+AcK71MTvYiGVw ($237 in chips)
Seat 4: K8MXCrNAVYlMnnCeM32Kxw ($111.50 in chips)
Seat 5: VvdR9F3I+2yELkfTVvC1dg ($251.35 in chips)
Seat 6: uCqEjnxh2/vFBjKYkfTOkw ($159.70 in chips)
MfXQsYD8pGeCS7XOtyV+vw: posts small blind $1
4dcDwIHRm96PwtqkpQiuiA: posts big blind $2
*** HOLE CARDS ***
ubtx4Z5L+AcK71MTvYiGVw: folds
K8MXCrNAVYlMnnCeM32Kxw: folds
VvdR9F3I+2yELkfTVvC1dg: raises $2 to $4
uCqEjnxh2/vFBjKYkfTOkw: raises $8 to $12
MfXQsYD8pGeCS7XOtyV+vw: folds
4dcDwIHRm96PwtqkpQiuiA: folds
VvdR9F3I+2yELkfTVvC1dg: folds
uCqEjnxh2/vFBjKYkfTOkw collected $11 from pot
uCqEjnxh2/vFBjKYkfTOkw: doesn't show hand
*** SUMMARY ***
Total pot $11 | Rake $0
Seat 1: MfXQsYD8pGeCS7XOtyV+vw (small blind) folded before Flop
Seat 2: 4dcDwIHRm96PwtqkpQiuiA (big blind) folded before Flop
Seat 3: ubtx4Z5L+AcK71MTvYiGVw folded before Flop (didn't bet)
Seat 4: K8MXCrNAVYlMnnCeM32Kxw folded before Flop (didn't bet)
Seat 5: VvdR9F3I+2yELkfTVvC1dg folded before Flop
Seat 6: uCqEjnxh2/vFBjKYkfTOkw (button) collected ($11)



PokerStars Game #59941441710:  Hold'em No Limit ($1/$2) - 2009/07/01 1:35:36 ET
Table 'ztv6V3FN2bQ9nmJPPdx6nQ' 6-max Seat #6 is the button
Seat 1: 6fLdOUCRtX71xbVRhJEq8w ($239.35 in chips)
Seat 2: 5Y+ZGWLI4gnlpApDX5vy1A ($395.75 in chips)
Seat 3: ubtx4Z5L+AcK71MTvYiGVw ($245 in chips)
Seat 5: sTPOWERd9HWPCNrDBwsVjA ($219.80 in chips)
Seat 6: mfy7uGZcqA2PVQqEVbJ7+g ($94.45 in chips)
6fLdOUCRtX71xbVRhJEq8w: posts small blind $1
5Y+ZGWLI4gnlpApDX5vy1A: posts big blind $2
UaZ5yj+6LjtWqMQg2QskUw: sits out
*** HOLE CARDS ***
ubtx4Z5L+AcK71MTvYiGVw: raises $6 to $8
sTPOWERd9HWPCNrDBwsVjA: folds
mfy7uGZcqA2PVQqEVbJ7+g: folds
6fLdOUCRtX71xbVRhJEq8w: folds
5Y+ZGWLI4gnlpApDX5vy1A: folds
ubtx4Z5L+AcK71MTvYiGVw collected $5 from pot
ubtx4Z5L+AcK71MTvYiGVw: doesn't show hand
*** SUMMARY ***
Total pot $5 | Rake $0
Seat 1: 6fLdOUCRtX71xbVRhJEq8w (small blind) folded before Flop
Seat 2: 5Y+ZGWLI4gnlpApDX5vy1A (big blind) folded before Flop
Seat 3: ubtx4Z5L+AcK71MTvYiGVw collected ($5)
Seat 5: sTPOWERd9HWPCNrDBwsVjA folded before Flop (didn't bet)
Seat 6: mfy7uGZcqA2PVQqEVbJ7+g (button) folded before Flop (didn't bet)



PokerStars Game #59941441800:  Hold'em No Limit ($1/$2) - 2009/07/01 1:35:36 ET
Table 'NmY84NAf9Mh0ckAckHnh5g' 2-max Seat #1 is the button
Seat 1: 6hvg964TSqZ3AL/0XK9aVQ ($333 in chips)
Seat 2: RwDoM55ZeQuI2ADyJhOb2Q ($663.70 in chips)
6hvg964TSqZ3AL/0XK9aVQ: posts small blind $1
RwDoM55ZeQuI2ADyJhOb2Q: posts big blind $2
*** HOLE CARDS ***
6hvg964TSqZ3AL/0XK9aVQ: calls $1
RwDoM55ZeQuI2ADyJhOb2Q: checks
*** FLOP *** [As Ks 3d]
RwDoM55ZeQuI2ADyJhOb2Q: bets $4
6hvg964TSqZ3AL/0XK9aVQ: calls $4
*** TURN *** [As Ks 3d] [5h]
RwDoM55ZeQuI2ADyJhOb2Q: bets $12
6hvg964TSqZ3AL/0XK9aVQ: calls $12
*** RIVER *** [As Ks 3d 5h] [Ad]
RwDoM55ZeQuI2ADyJhOb2Q: bets $32
6hvg964TSqZ3AL/0XK9aVQ: calls $32
*** SHOW DOWN ***
RwDoM55ZeQuI2ADyJhOb2Q: shows [7s 4s] (a pair of Aces)
6hvg964TSqZ3AL/0XK9aVQ: shows [4h 4d] (two pair, Aces and Fours)
6hvg964TSqZ3AL/0XK9aVQ collected $99.50 from pot
*** SUMMARY ***
Total pot $100 | Rake $0.50
Board [As Ks 3d 5h Ad]
Seat 1: 6hvg964TSqZ3AL/0XK9aVQ (button) (small blind) showed [4h 4d] and won ($99.50) with two pair, Aces and Fours
Seat 2: RwDoM55ZeQuI2ADyJhOb2Q (big blind) showed [7s 4s] and lost with a pair of Aces



PokerStars Game #59941442934:  Hold'em No Limit ($1/$2) - 2009/07/01 1:35:38 ET
Table '/dyk+YdRGv90j2box35j8w' 6-max Seat #4 is the button
Seat 1: 8srN1dKQePlsv0GyTada+Q ($209.25 in chips)
Seat 2: qCnEYuAE5y5A7bk6fO5/jQ ($470.60 in chips)
Seat 3: sTPOWERd9HWPCNrDBwsVjA ($185.50 in chips)
Seat 4: z/u1YTnkiIDrtp/2cA2dBg ($167.85 in chips)
Seat 5: VvdR9F3I+2yELkfTVvC1dg ($241 in chips)
Seat 6: gnYme0DNFflnMhrdbxe1Ag ($200 in chips)
VvdR9F3I+2yELkfTVvC1dg: posts small blind $1
gnYme0DNFflnMhrdbxe1Ag: posts big blind $2
*** HOLE CARDS ***
8srN1dKQePlsv0GyTada+Q: folds
qCnEYuAE5y5A7bk6fO5/jQ: folds
sTPOWERd9HWPCNrDBwsVjA: folds
z/u1YTnkiIDrtp/2cA2dBg: folds
VvdR9F3I+2yELkfTVvC1dg: raises $2 to $4
gnYme0DNFflnMhrdbxe1Ag: folds
VvdR9F3I+2yELkfTVvC1dg collected $4 from pot
VvdR9F3I+2yELkfTVvC1dg: doesn't show hand
*** SUMMARY ***
Total pot $4 | Rake $0
Seat 1: 8srN1dKQePlsv0GyTada+Q folded before Flop (didn't bet)
Seat 2: qCnEYuAE5y5A7bk6fO5/jQ folded before Flop (didn't bet)
Seat 3: sTPOWERd9HWPCNrDBwsVjA folded before Flop (didn't bet)
Seat 4: z/u1YTnkiIDrtp/2cA2dBg (button) folded before Flop (didn't bet)
Seat 5: VvdR9F3I+2yELkfTVvC1dg (small blind) collected ($4)
Seat 6: gnYme0DNFflnMhrdbxe1Ag (big blind) folded before Flop



PokerStars Game #59941443976:  Hold'em No Limit ($1/$2) - 2009/07/01 1:35:40 ET
Table 'rKeCh+eBn4RNvybCUYkoTQ' 9-max Seat #3 is the button
Seat 1: /inIs/z/PcX+TniIFpaxpg ($198 in chips)
Seat 2: 9cBHwK40Tl06vheE7B3LHQ ($120.80 in chips)
Seat 3: GX1heJ+DSsvm7gzSPsYhhQ ($49 in chips)
Seat 5: WUlHm+ydPPHG7Lb0rePSdA ($123 in chips)
Seat 6: EBV6OktyeSmh4w6sWmcWOw ($267 in chips)
Seat 7: rW/MyplHylMSBRaoRUzWrg ($31 in chips)
Seat 8: pN/Ip0ePsUVIdUlGgLrkUw ($246.35 in chips)
Seat 9: Kzta8yu9vxHT4B70mjBZ+w ($211.25 in chips)
WUlHm+ydPPHG7Lb0rePSdA: posts small blind $1
EBV6OktyeSmh4w6sWmcWOw: posts big blind $2
*** HOLE CARDS ***
rW/MyplHylMSBRaoRUzWrg: folds
pN/Ip0ePsUVIdUlGgLrkUw: folds
Kzta8yu9vxHT4B70mjBZ+w: raises $4 to $6
/inIs/z/PcX+TniIFpaxpg: folds
9cBHwK40Tl06vheE7B3LHQ: folds
GX1heJ+DSsvm7gzSPsYhhQ: folds
WUlHm+ydPPHG7Lb0rePSdA: folds
EBV6OktyeSmh4w6sWmcWOw: folds
Kzta8yu9vxHT4B70mjBZ+w collected $5 from pot
Kzta8yu9vxHT4B70mjBZ+w: doesn't show hand
*** SUMMARY ***
Total pot $5 | Rake $0
Seat 1: /inIs/z/PcX+TniIFpaxpg folded before Flop (didn't bet)
Seat 2: 9cBHwK40Tl06vheE7B3LHQ folded before Flop (didn't bet)
Seat 3: GX1heJ+DSsvm7gzSPsYhhQ (button) folded before Flop (didn't bet)
Seat 5: WUlHm+ydPPHG7Lb0rePSdA (small blind) folded before Flop
Seat 6: EBV6OktyeSmh4w6sWmcWOw (big blind) folded before Flop
Seat 7: rW/MyplHylMSBRaoRUzWrg folded before Flop (didn't bet)
Seat 8: pN/Ip0ePsUVIdUlGgLrkUw folded before Flop (didn't bet)
Seat 9: Kzta8yu9vxHT4B70mjBZ+w collected ($5)



PokerStars Game #59941443842:  Hold'em No Limit ($1/$2) - 2009/07/01 1:35:40 ET
Table 'AtOXMvcrtQM8yLNcALmfLQ' 2-max Seat #2 is the button
Seat 1: +HlQuAsMqZGYYtjcPO/a3A ($363.50 in chips)
Seat 2: pVqEzK9wXlRMECnb1Zg4Zw ($199.50 in chips)
pVqEzK9wXlRMECnb1Zg4Zw: posts small blind $1
+HlQuAsMqZGYYtjcPO/a3A: posts big blind $2
*** HOLE CARDS ***
pVqEzK9wXlRMECnb1Zg4Zw: folds
+HlQuAsMqZGYYtjcPO/a3A collected $2 from pot
*** SUMMARY ***
Total pot $2 | Rake $0
Seat 1: +HlQuAsMqZGYYtjcPO/a3A (big blind) collected ($2)
Seat 2: pVqEzK9wXlRMECnb1Zg4Zw (button) (small blind) folded before Flop



PokerStars Game #59941444058:  Hold'em No Limit ($1/$2) - 2009/07/01 1:35:41 ET
Table 'mGpP9StWRnoeiBDExc6Frg' 6-max Seat #5 is the button
Seat 1: VvdR9F3I+2yELkfTVvC1dg ($313.60 in chips)
Seat 2: vkfxu8f/jMYKUk6Ly4eujw ($197 in chips)
Seat 3: 7acrZUQC3Zc9BNLjoKIcLQ ($25.15 in chips)
Seat 4: 4dcDwIHRm96PwtqkpQiuiA ($76.70 in chips)
Seat 5: d1puGuVBE0fidn+5eRJ0tw ($199.95 in chips)
Seat 6: B2Ih1sr5VZk+8He7rcrMtQ ($424.05 in chips)
B2Ih1sr5VZk+8He7rcrMtQ: posts small blind $1
VvdR9F3I+2yELkfTVvC1dg: posts big blind $2
*** HOLE CARDS ***
vkfxu8f/jMYKUk6Ly4eujw: folds
7acrZUQC3Zc9BNLjoKIcLQ: folds
4dcDwIHRm96PwtqkpQiuiA: folds
d1puGuVBE0fidn+5eRJ0tw: folds
B2Ih1sr5VZk+8He7rcrMtQ: folds
VvdR9F3I+2yELkfTVvC1dg collected $2 from pot
VvdR9F3I+2yELkfTVvC1dg: doesn't show hand
*** SUMMARY ***
Total pot $2 | Rake $0
Seat 1: VvdR9F3I+2yELkfTVvC1dg (big blind) collected ($2)
Seat 2: vkfxu8f/jMYKUk6Ly4eujw folded before Flop (didn't bet)
Seat 3: 7acrZUQC3Zc9BNLjoKIcLQ folded before Flop (didn't bet)
Seat 4: 4dcDwIHRm96PwtqkpQiuiA folded before Flop (didn't bet)
Seat 5: d1puGuVBE0fidn+5eRJ0tw (button) folded before Flop (didn't bet)
Seat 6: B2Ih1sr5VZk+8He7rcrMtQ (small blind) folded before Flop



PokerStars Game #59941445410:  Hold'em No Limit ($1/$2) - 2009/07/01 1:35:43 ET
Table 'CFkQcfWjKccZaZDf71FK+w' 6-max Seat #2 is the button
Seat 1: vkfxu8f/jMYKUk6Ly4eujw ($197 in chips)
Seat 2: ewN/vzF22+/gdzjIKBOlkA ($207.80 in chips)
Seat 3: 09BNF4quPDzanQzM8vc6WA ($44.65 in chips)
Seat 4: ygTTt5ehT4aF86q1a8/R+w ($233.65 in chips)
Seat 5: 2lOU1DcvUZaMcxZ95XfzXw ($139.60 in chips)
Seat 6: ORVqY3rf9X6ANA/8s+On2Q ($144.60 in chips)
09BNF4quPDzanQzM8vc6WA: posts small blind $1
ygTTt5ehT4aF86q1a8/R+w: posts big blind $2
*** HOLE CARDS ***
2lOU1DcvUZaMcxZ95XfzXw: calls $2
ORVqY3rf9X6ANA/8s+On2Q: calls $2
vkfxu8f/jMYKUk6Ly4eujw: folds
ewN/vzF22+/gdzjIKBOlkA: folds
09BNF4quPDzanQzM8vc6WA: folds
ygTTt5ehT4aF86q1a8/R+w: checks
*** FLOP *** [4h 2h Qc]
ygTTt5ehT4aF86q1a8/R+w: checks
2lOU1DcvUZaMcxZ95XfzXw: checks
ORVqY3rf9X6ANA/8s+On2Q: bets $2
ygTTt5ehT4aF86q1a8/R+w: raises $8 to $10
2lOU1DcvUZaMcxZ95XfzXw: folds
ORVqY3rf9X6ANA/8s+On2Q: calls $8
*** TURN *** [4h 2h Qc] [3s]
ygTTt5ehT4aF86q1a8/R+w: bets $18
ORVqY3rf9X6ANA/8s+On2Q: folds
ygTTt5ehT4aF86q1a8/R+w collected $25.70 from pot
*** SUMMARY ***
Total pot $27 | Rake $1.30
Board [4h 2h Qc 3s]
Seat 1: vkfxu8f/jMYKUk6Ly4eujw folded before Flop (didn't bet)
Seat 2: ewN/vzF22+/gdzjIKBOlkA (button) folded before Flop (didn't bet)
Seat 3: 09BNF4quPDzanQzM8vc6WA (small blind) folded before Flop
Seat 4: ygTTt5ehT4aF86q1a8/R+w (big blind) collected ($25.70)
Seat 5: 2lOU1DcvUZaMcxZ95XfzXw folded on the Flop
Seat 6: ORVqY3rf9X6ANA/8s+On2Q folded on the Turn



PokerStars Game #59941445278:  Hold'em No Limit ($1/$2) - 2009/07/01 1:35:43 ET
Table 'aSf77Sj8QEnzcc0WaxVD4Q' 6-max Seat #4 is the button
Seat 1: UELtvp+JfwI7XDGVwSxZXA ($289.10 in chips)
Seat 2: vkfxu8f/jMYKUk6Ly4eujw ($208.80 in chips)
Seat 3: 9dpyyjDTCed6nV7JhaUUpw ($496.70 in chips)
Seat 4: YsLQ3BAvgQHWXMAv3Wv6Hg ($200 in chips)
Seat 5: VvdR9F3I+2yELkfTVvC1dg ($259 in chips)
Seat 6: vkoJRf3gidxY1pPi0AFWww ($132.10 in chips)
VvdR9F3I+2yELkfTVvC1dg: posts small blind $1
vkoJRf3gidxY1pPi0AFWww: posts big blind $2
*** HOLE CARDS ***
UELtvp+JfwI7XDGVwSxZXA: folds
vkfxu8f/jMYKUk6Ly4eujw: folds
9dpyyjDTCed6nV7JhaUUpw: folds
YsLQ3BAvgQHWXMAv3Wv6Hg: folds
VvdR9F3I+2yELkfTVvC1dg: folds
vkoJRf3gidxY1pPi0AFWww collected $2 from pot
vkoJRf3gidxY1pPi0AFWww: doesn't show hand
*** SUMMARY ***
Total pot $2 | Rake $0
Seat 1: UELtvp+JfwI7XDGVwSxZXA folded before Flop (didn't bet)
Seat 2: vkfxu8f/jMYKUk6Ly4eujw folded before Flop (didn't bet)
Seat 3: 9dpyyjDTCed6nV7JhaUUpw folded before Flop (didn't bet)
Seat 4: YsLQ3BAvgQHWXMAv3Wv6Hg (button) folded before Flop (didn't bet)
Seat 5: VvdR9F3I+2yELkfTVvC1dg (small blind) folded before Flop
Seat 6: vkoJRf3gidxY1pPi0AFWww (big blind) collected ($2)



PokerStars Game #59941446146:  Hold'em No Limit ($1/$2) - 2009/07/01 1:35:44 ET
Table 'LL4bDFyhj5hsMpzaDugJZg' 6-max Seat #4 is the button
Seat 1: FwvID/fQGlpY3soi/lMTww ($85.05 in chips)
Seat 2: IZng3w8jiJHHp3LbYKLi4w ($56.75 in chips)
Seat 3: iI/NMpRxMkGieArQEhACSA ($561.90 in chips)
Seat 4: 8srN1dKQePlsv0GyTada+Q ($205 in chips)
Seat 5: A2GTwTiwkb1ilNWgW487Vg ($126.50 in chips)
Seat 6: 692Q4sfB0gTElzS0WMeg+A ($200 in chips)
A2GTwTiwkb1ilNWgW487Vg: posts small blind $1
692Q4sfB0gTElzS0WMeg+A: posts big blind $2
*** HOLE CARDS ***
FwvID/fQGlpY3soi/lMTww has timed out while disconnected
FwvID/fQGlpY3soi/lMTww: folds
FwvID/fQGlpY3soi/lMTww is sitting out
IZng3w8jiJHHp3LbYKLi4w: folds
iI/NMpRxMkGieArQEhACSA: folds
8srN1dKQePlsv0GyTada+Q: raises $4 to $6
A2GTwTiwkb1ilNWgW487Vg: folds
692Q4sfB0gTElzS0WMeg+A: calls $4
*** FLOP *** [Ks Tc 9d]
692Q4sfB0gTElzS0WMeg+A: checks
8srN1dKQePlsv0GyTada+Q: checks
*** TURN *** [Ks Tc 9d] [Js]
692Q4sfB0gTElzS0WMeg+A: bets $8
8srN1dKQePlsv0GyTada+Q: folds
692Q4sfB0gTElzS0WMeg+A collected $12.35 from pot
*** SUMMARY ***
Total pot $13 | Rake $0.65
Board [Ks Tc 9d Js]
Seat 1: FwvID/fQGlpY3soi/lMTww folded before Flop (didn't bet)
Seat 2: IZng3w8jiJHHp3LbYKLi4w folded before Flop (didn't bet)
Seat 3: iI/NMpRxMkGieArQEhACSA folded before Flop (didn't bet)
Seat 4: 8srN1dKQePlsv0GyTada+Q (button) folded on the Turn
Seat 5: A2GTwTiwkb1ilNWgW487Vg (small blind) folded before Flop
Seat 6: 692Q4sfB0gTElzS0WMeg+A (big blind) collected ($12.35)



PokerStars Game #59941446920:  Hold'em No Limit ($1/$2) - 2009/07/01 1:35:46 ET
Table 'gnHBqWll9O3fxG7Ojkz/ng' 9-max Seat #3 is the button
Seat 1: TAfo4veNRaRlzDXMMYS3Jg ($31 in chips)
Seat 2: H6Z4+qu8gR0VUiPOijndVg ($331.95 in chips)
Seat 3: 5Q8U6iZbeO7xJSS4qvDP5g ($218.05 in chips)
Seat 4: nXDI8Y/S6POzRwANu3d8hQ ($37 in chips)
Seat 5: rBQDMkKm9cZn6M9NPsiVew ($227.15 in chips)
Seat 7: jqui3xAWCkcdPW36a6BD+w ($347.55 in chips)
Seat 8: cM6efHzdxoqYm0EQKP4TTQ ($82.15 in chips)
Seat 9: GX1heJ+DSsvm7gzSPsYhhQ ($50.35 in chips)
nXDI8Y/S6POzRwANu3d8hQ: posts small blind $1
rBQDMkKm9cZn6M9NPsiVew: posts big blind $2
MeleaB: sits out
*** HOLE CARDS ***
jqui3xAWCkcdPW36a6BD+w: calls $2
cM6efHzdxoqYm0EQKP4TTQ: calls $2
GX1heJ+DSsvm7gzSPsYhhQ: folds
TAfo4veNRaRlzDXMMYS3Jg: folds
H6Z4+qu8gR0VUiPOijndVg: folds
5Q8U6iZbeO7xJSS4qvDP5g: folds
nXDI8Y/S6POzRwANu3d8hQ: calls $1
rBQDMkKm9cZn6M9NPsiVew: checks
*** FLOP *** [Qh Jh 9h]
nXDI8Y/S6POzRwANu3d8hQ: checks
rBQDMkKm9cZn6M9NPsiVew: checks
jqui3xAWCkcdPW36a6BD+w: checks
cM6efHzdxoqYm0EQKP4TTQ: bets $6
nXDI8Y/S6POzRwANu3d8hQ: folds
rBQDMkKm9cZn6M9NPsiVew: folds
jqui3xAWCkcdPW36a6BD+w: folds
cM6efHzdxoqYm0EQKP4TTQ collected $7.60 from pot
*** SUMMARY ***
Total pot $8 | Rake $0.40
Board [Qh Jh 9h]
Seat 1: TAfo4veNRaRlzDXMMYS3Jg folded before Flop (didn't bet)
Seat 2: H6Z4+qu8gR0VUiPOijndVg folded before Flop (didn't bet)
Seat 3: 5Q8U6iZbeO7xJSS4qvDP5g (button) folded before Flop (didn't bet)
Seat 4: nXDI8Y/S6POzRwANu3d8hQ (small blind) folded on the Flop
Seat 5: rBQDMkKm9cZn6M9NPsiVew (big blind) folded on the Flop
Seat 7: jqui3xAWCkcdPW36a6BD+w folded on the Flop
Seat 8: cM6efHzdxoqYm0EQKP4TTQ collected ($7.60)
Seat 9: GX1heJ+DSsvm7gzSPsYhhQ folded before Flop (didn't bet)



PokerStars Game #59941447480:  Hold'em No Limit ($1/$2) - 2009/07/01 1:35:47 ET
Table 'AtOXMvcrtQM8yLNcALmfLQ' 2-max Seat #1 is the button
Seat 1: +HlQuAsMqZGYYtjcPO/a3A ($364.50 in chips)
Seat 2: pVqEzK9wXlRMECnb1Zg4Zw ($198.50 in chips)
+HlQuAsMqZGYYtjcPO/a3A: posts small blind $1
pVqEzK9wXlRMECnb1Zg4Zw: posts big blind $2
*** HOLE CARDS ***
+HlQuAsMqZGYYtjcPO/a3A: folds
pVqEzK9wXlRMECnb1Zg4Zw collected $2 from pot
pVqEzK9wXlRMECnb1Zg4Zw: doesn't show hand
*** SUMMARY ***
Total pot $2 | Rake $0
Seat 1: +HlQuAsMqZGYYtjcPO/a3A (button) (small blind) folded before Flop
Seat 2: pVqEzK9wXlRMECnb1Zg4Zw (big blind) collected ($2)



PokerStars Game #59941448502:  Hold'em No Limit ($1/$2) - 2009/07/01 1:35:49 ET
Table 'kq5zaQ+1hLNf8LZfGnbTAA' 6-max Seat #6 is the button
Seat 1: 8srN1dKQePlsv0GyTada+Q ($434.60 in chips)
Seat 2: nXDI8Y/S6POzRwANu3d8hQ ($164 in chips)
Seat 3: /PH6Ffnho4Ysm8S3V/oa+w ($43 in chips)
Seat 4: 3dAbvkxS5NPQTBAbvpinVg ($278.45 in chips)
Seat 5: gnYme0DNFflnMhrdbxe1Ag ($206.35 in chips)
Seat 6: mfy7uGZcqA2PVQqEVbJ7+g ($188.25 in chips)
8srN1dKQePlsv0GyTada+Q: posts small blind $1
nXDI8Y/S6POzRwANu3d8hQ: posts big blind $2
*** HOLE CARDS ***
/PH6Ffnho4Ysm8S3V/oa+w: folds
3dAbvkxS5NPQTBAbvpinVg: folds
gnYme0DNFflnMhrdbxe1Ag: folds
mfy7uGZcqA2PVQqEVbJ7+g: raises $5 to $7
8srN1dKQePlsv0GyTada+Q: calls $6
nXDI8Y/S6POzRwANu3d8hQ: folds
*** FLOP *** [As 6c 2d]
8srN1dKQePlsv0GyTada+Q: checks
mfy7uGZcqA2PVQqEVbJ7+g: checks
*** TURN *** [As 6c 2d] [Tc]
8srN1dKQePlsv0GyTada+Q: checks
mfy7uGZcqA2PVQqEVbJ7+g: bets $7
8srN1dKQePlsv0GyTada+Q: folds
mfy7uGZcqA2PVQqEVbJ7+g collected $15.20 from pot
mfy7uGZcqA2PVQqEVbJ7+g: doesn't show hand
*** SUMMARY ***
Total pot $16 | Rake $0.80
Board [As 6c 2d Tc]
Seat 1: 8srN1dKQePlsv0GyTada+Q (small blind) folded on the Turn
Seat 2: nXDI8Y/S6POzRwANu3d8hQ (big blind) folded before Flop
Seat 3: /PH6Ffnho4Ysm8S3V/oa+w folded before Flop (didn't bet)
Seat 4: 3dAbvkxS5NPQTBAbvpinVg folded before Flop (didn't bet)
Seat 5: gnYme0DNFflnMhrdbxe1Ag folded before Flop (didn't bet)
Seat 6: mfy7uGZcqA2PVQqEVbJ7+g (button) collected ($15.20)



PokerStars Game #59941448660:  Hold'em No Limit ($1/$2) - 2009/07/01 1:35:49 ET
Table 'uJ9juaXXg9yIcSU8amxaXQ' 6-max Seat #3 is the button
Seat 2: VvdR9F3I+2yELkfTVvC1dg ($223.10 in chips)
Seat 3: qXDd0ZyMIse0OBu8pxeQ3Q ($243.40 in chips)
Seat 4: zNjJ/y4emmF+vzrCDd+ooA ($226.05 in chips)
Seat 5: YsLQ3BAvgQHWXMAv3Wv6Hg ($200 in chips)
zNjJ/y4emmF+vzrCDd+ooA: posts small blind $1
YsLQ3BAvgQHWXMAv3Wv6Hg: posts big blind $2
JsqOjN/eHz0uYVf/PyUJ6Q: sits out
*** HOLE CARDS ***
VvdR9F3I+2yELkfTVvC1dg: folds
qXDd0ZyMIse0OBu8pxeQ3Q: raises $4 to $6
zNjJ/y4emmF+vzrCDd+ooA: folds
YsLQ3BAvgQHWXMAv3Wv6Hg: folds
qXDd0ZyMIse0OBu8pxeQ3Q collected $5 from pot
*** SUMMARY ***
Total pot $5 | Rake $0
Seat 2: VvdR9F3I+2yELkfTVvC1dg folded before Flop (didn't bet)
Seat 3: qXDd0ZyMIse0OBu8pxeQ3Q (button) collected ($5)
Seat 4: zNjJ/y4emmF+vzrCDd+ooA (small blind) folded before Flop
Seat 5: YsLQ3BAvgQHWXMAv3Wv6Hg (big blind) folded before Flop



PokerStars Game #59941449116:  Hold'em No Limit ($1/$2) - 2009/07/01 1:35:50 ET
Table 'pPQgcj9XT9CHBsbo1WTBug' 6-max Seat #4 is the button
Seat 1: DFVYDA6dKQy7R7mGIKogZA ($138.95 in chips)
Seat 2: qXDd0ZyMIse0OBu8pxeQ3Q ($200 in chips)
Seat 3: 54yWzRRgS0oZ+S6LwZBxMQ ($49.50 in chips)
Seat 4: gqlysXCbT8V54f/1lf9h3A ($73.45 in chips)
Seat 5: vkfxu8f/jMYKUk6Ly4eujw ($194.55 in chips)
Seat 6: Yr7pZltpy3IUNdKS9PCEiw ($315.80 in chips)
vkfxu8f/jMYKUk6Ly4eujw: posts small blind $1
Yr7pZltpy3IUNdKS9PCEiw: posts big blind $2
*** HOLE CARDS ***
DFVYDA6dKQy7R7mGIKogZA: raises $2 to $4
qXDd0ZyMIse0OBu8pxeQ3Q: folds
54yWzRRgS0oZ+S6LwZBxMQ: folds
gqlysXCbT8V54f/1lf9h3A: folds
vkfxu8f/jMYKUk6Ly4eujw: folds
Yr7pZltpy3IUNdKS9PCEiw: calls $2
*** FLOP *** [4s 8s 2c]
Yr7pZltpy3IUNdKS9PCEiw: checks
DFVYDA6dKQy7R7mGIKogZA: checks
*** TURN *** [4s 8s 2c] [8d]
Yr7pZltpy3IUNdKS9PCEiw: checks
DFVYDA6dKQy7R7mGIKogZA: checks
*** RIVER *** [4s 8s 2c 8d] [Td]
Yr7pZltpy3IUNdKS9PCEiw: checks
DFVYDA6dKQy7R7mGIKogZA: bets $8
Yr7pZltpy3IUNdKS9PCEiw: folds
DFVYDA6dKQy7R7mGIKogZA collected $8.55 from pot
*** SUMMARY ***
Total pot $9 | Rake $0.45
Board [4s 8s 2c 8d Td]
Seat 1: DFVYDA6dKQy7R7mGIKogZA collected ($8.55)
Seat 2: qXDd0ZyMIse0OBu8pxeQ3Q folded before Flop (didn't bet)
Seat 3: 54yWzRRgS0oZ+S6LwZBxMQ folded before Flop (didn't bet)
Seat 4: gqlysXCbT8V54f/1lf9h3A (button) folded before Flop (didn't bet)
Seat 5: vkfxu8f/jMYKUk6Ly4eujw (small blind) folded before Flop
Seat 6: Yr7pZltpy3IUNdKS9PCEiw (big blind) folded on the River



PokerStars Game #59941449412:  Hold'em No Limit ($1/$2) - 2009/07/01 1:35:50 ET
Table 'jlrIxbrVIG+gjaUYT4za8g' 6-max Seat #6 is the button
Seat 1: ygTTt5ehT4aF86q1a8/R+w ($238.30 in chips)
Seat 2: /PH6Ffnho4Ysm8S3V/oa+w ($43 in chips)
Seat 3: gnYme0DNFflnMhrdbxe1Ag ($200 in chips)
Seat 4: 8srN1dKQePlsv0GyTada+Q ($244.20 in chips)
Seat 5: AyBB0k3Dcl7xbXUeGMw06g ($70.90 in chips)
Seat 6: vkfxu8f/jMYKUk6Ly4eujw ($341.20 in chips)
ygTTt5ehT4aF86q1a8/R+w: posts small blind $1
/PH6Ffnho4Ysm8S3V/oa+w: posts big blind $2
*** HOLE CARDS ***
gnYme0DNFflnMhrdbxe1Ag: folds
8srN1dKQePlsv0GyTada+Q: raises $4 to $6
AyBB0k3Dcl7xbXUeGMw06g: folds
vkfxu8f/jMYKUk6Ly4eujw: calls $6
ygTTt5ehT4aF86q1a8/R+w: calls $5
/PH6Ffnho4Ysm8S3V/oa+w: folds
*** FLOP *** [7c 9s Ac]
ygTTt5ehT4aF86q1a8/R+w: checks
8srN1dKQePlsv0GyTada+Q: bets $14
vkfxu8f/jMYKUk6Ly4eujw: folds
ygTTt5ehT4aF86q1a8/R+w: folds
8srN1dKQePlsv0GyTada+Q collected $19 from pot
*** SUMMARY ***
Total pot $20 | Rake $1
Board [7c 9s Ac]
Seat 1: ygTTt5ehT4aF86q1a8/R+w (small blind) folded on the Flop
Seat 2: /PH6Ffnho4Ysm8S3V/oa+w (big blind) folded before Flop
Seat 3: gnYme0DNFflnMhrdbxe1Ag folded before Flop (didn't bet)
Seat 4: 8srN1dKQePlsv0GyTada+Q collected ($19)
Seat 5: AyBB0k3Dcl7xbXUeGMw06g folded before Flop (didn't bet)
Seat 6: vkfxu8f/jMYKUk6Ly4eujw (button) folded on the Flop



PokerStars Game #59941449526:  Hold'em No Limit ($1/$2) - 2009/07/01 1:35:50 ET
Table '/ci73fTmzTzmGWzAtqEX2Q' 9-max Seat #8 is the button
Seat 1: 9efVc1cB3yHt4TvBkTusPw ($152.90 in chips)
Seat 2: pN/Ip0ePsUVIdUlGgLrkUw ($225 in chips)
Seat 3: kK1+5ivyJZeA8hQF2pdvvQ ($64.55 in chips)
Seat 4: 2yq7Zp4xmrhAw8+37hTkaA ($169.20 in chips)
Seat 5: 1CtiZuXDFaJL1dJPQKyi8Q ($215 in chips)
Seat 6: GX1heJ+DSsvm7gzSPsYhhQ ($44.65 in chips)
Seat 8: /inIs/z/PcX+TniIFpaxpg ($34 in chips)
Seat 9: S8aS+9FTYQ/ICLBNThcrkg ($181 in chips)
S8aS+9FTYQ/ICLBNThcrkg: posts small blind $1
9efVc1cB3yHt4TvBkTusPw: posts big blind $2
+T/63sAeZzWyHchahJ36GQ: sits out
*** HOLE CARDS ***
pN/Ip0ePsUVIdUlGgLrkUw: folds
kK1+5ivyJZeA8hQF2pdvvQ: folds
2yq7Zp4xmrhAw8+37hTkaA: folds
1CtiZuXDFaJL1dJPQKyi8Q: folds
GX1heJ+DSsvm7gzSPsYhhQ: folds
/inIs/z/PcX+TniIFpaxpg: folds
S8aS+9FTYQ/ICLBNThcrkg: calls $1
9efVc1cB3yHt4TvBkTusPw: raises $4 to $6
S8aS+9FTYQ/ICLBNThcrkg: folds
9efVc1cB3yHt4TvBkTusPw collected $4 from pot
*** SUMMARY ***
Total pot $4 | Rake $0
Seat 1: 9efVc1cB3yHt4TvBkTusPw (big blind) collected ($4)
Seat 2: pN/Ip0ePsUVIdUlGgLrkUw folded before Flop (didn't bet)
Seat 3: kK1+5ivyJZeA8hQF2pdvvQ folded before Flop (didn't bet)
Seat 4: 2yq7Zp4xmrhAw8+37hTkaA folded before Flop (didn't bet)
Seat 5: 1CtiZuXDFaJL1dJPQKyi8Q folded before Flop (didn't bet)
Seat 6: GX1heJ+DSsvm7gzSPsYhhQ folded before Flop (didn't bet)
Seat 8: /inIs/z/PcX+TniIFpaxpg (button) folded before Flop (didn't bet)
Seat 9: S8aS+9FTYQ/ICLBNThcrkg (small blind) folded before Flop



PokerStars Game #59941449138:  Hold'em No Limit ($1/$2) - 2009/07/01 1:35:50 ET
Table 'YqGfR5eHfMeSjb9a+QU9rg' 9-max Seat #3 is the button
Seat 1: rW/MyplHylMSBRaoRUzWrg ($36 in chips)
Seat 3: /gll27k+xWYV7Fbki0lFDQ ($258.75 in chips)
Seat 4: GX1heJ+DSsvm7gzSPsYhhQ ($35 in chips)
Seat 5: CkE3IyJF1KvdaAOmZY5XqQ ($200 in chips)
Seat 6: TAfo4veNRaRlzDXMMYS3Jg ($37 in chips)
Seat 7: 41aZuLBz9nAi2GPVKabmCw ($101.95 in chips)
Seat 8: JnV3SM2D6dAFYyGZHHpvrg ($93.25 in chips)
Seat 9: /inIs/z/PcX+TniIFpaxpg ($202.20 in chips)
GX1heJ+DSsvm7gzSPsYhhQ: posts small blind $1
CkE3IyJF1KvdaAOmZY5XqQ: posts big blind $2
nXDI8Y/S6POzRwANu3d8hQ: sits out
*** HOLE CARDS ***
TAfo4veNRaRlzDXMMYS3Jg: folds
41aZuLBz9nAi2GPVKabmCw: calls $2
JnV3SM2D6dAFYyGZHHpvrg: folds
/inIs/z/PcX+TniIFpaxpg: folds
rW/MyplHylMSBRaoRUzWrg: folds
/gll27k+xWYV7Fbki0lFDQ: folds
GX1heJ+DSsvm7gzSPsYhhQ: folds
CkE3IyJF1KvdaAOmZY5XqQ: checks
*** FLOP *** [Ts Ac Kh]
CkE3IyJF1KvdaAOmZY5XqQ: checks
41aZuLBz9nAi2GPVKabmCw: checks
*** TURN *** [Ts Ac Kh] [3d]
CkE3IyJF1KvdaAOmZY5XqQ: checks
41aZuLBz9nAi2GPVKabmCw: checks
*** RIVER *** [Ts Ac Kh 3d] [7c]
CkE3IyJF1KvdaAOmZY5XqQ: checks
41aZuLBz9nAi2GPVKabmCw: checks
*** SHOW DOWN ***
CkE3IyJF1KvdaAOmZY5XqQ: shows [Qs 9h] (high card Ace)
41aZuLBz9nAi2GPVKabmCw: mucks hand
CkE3IyJF1KvdaAOmZY5XqQ collected $4.75 from pot
*** SUMMARY ***
Total pot $5 | Rake $0.25
Board [Ts Ac Kh 3d 7c]
Seat 1: rW/MyplHylMSBRaoRUzWrg folded before Flop (didn't bet)
Seat 3: /gll27k+xWYV7Fbki0lFDQ (button) folded before Flop (didn't bet)
Seat 4: GX1heJ+DSsvm7gzSPsYhhQ (small blind) folded before Flop
Seat 5: CkE3IyJF1KvdaAOmZY5XqQ (big blind) showed [Qs 9h] and won ($4.75) with high card Ace
Seat 6: TAfo4veNRaRlzDXMMYS3Jg folded before Flop (didn't bet)
Seat 7: 41aZuLBz9nAi2GPVKabmCw mucked
Seat 8: JnV3SM2D6dAFYyGZHHpvrg folded before Flop (didn't bet)
Seat 9: /inIs/z/PcX+TniIFpaxpg folded before Flop (didn't bet)



PokerStars Game #59941451258:  Hold'em No Limit ($1/$2) - 2009/07/01 1:35:53 ET
Table 'AtOXMvcrtQM8yLNcALmfLQ' 2-max Seat #2 is the button
Seat 1: +HlQuAsMqZGYYtjcPO/a3A ($363.50 in chips)
Seat 2: pVqEzK9wXlRMECnb1Zg4Zw ($199.50 in chips)
pVqEzK9wXlRMECnb1Zg4Zw: posts small blind $1
+HlQuAsMqZGYYtjcPO/a3A: posts big blind $2
*** HOLE CARDS ***
pVqEzK9wXlRMECnb1Zg4Zw: raises $6 to $8
+HlQuAsMqZGYYtjcPO/a3A: raises $14 to $22
pVqEzK9wXlRMECnb1Zg4Zw: folds
+HlQuAsMqZGYYtjcPO/a3A collected $16 from pot
*** SUMMARY ***
Total pot $16 | Rake $0
Seat 1: +HlQuAsMqZGYYtjcPO/a3A (big blind) collected ($16)
Seat 2: pVqEzK9wXlRMECnb1Zg4Zw (button) (small blind) folded before Flop



PokerStars Game #59941453042:  Hold'em No Limit ($1/$2) - 2009/07/01 1:35:57 ET
Table 'ztv6V3FN2bQ9nmJPPdx6nQ' 6-max Seat #1 is the button
Seat 1: 6fLdOUCRtX71xbVRhJEq8w ($238.35 in chips)
Seat 2: 5Y+ZGWLI4gnlpApDX5vy1A ($393.75 in chips)
Seat 3: ubtx4Z5L+AcK71MTvYiGVw ($248 in chips)
Seat 5: sTPOWERd9HWPCNrDBwsVjA ($219.80 in chips)
Seat 6: mfy7uGZcqA2PVQqEVbJ7+g ($94.45 in chips)
5Y+ZGWLI4gnlpApDX5vy1A: posts small blind $1
ubtx4Z5L+AcK71MTvYiGVw: posts big blind $2
UaZ5yj+6LjtWqMQg2QskUw: sits out
*** HOLE CARDS ***
sTPOWERd9HWPCNrDBwsVjA: folds
mfy7uGZcqA2PVQqEVbJ7+g: raises $5 to $7
6fLdOUCRtX71xbVRhJEq8w: folds
5Y+ZGWLI4gnlpApDX5vy1A: calls $6
ubtx4Z5L+AcK71MTvYiGVw: folds
*** FLOP *** [9h Qs 2h]
5Y+ZGWLI4gnlpApDX5vy1A: checks
mfy7uGZcqA2PVQqEVbJ7+g: bets $11
5Y+ZGWLI4gnlpApDX5vy1A: calls $11
*** TURN *** [9h Qs 2h] [Ks]
5Y+ZGWLI4gnlpApDX5vy1A: checks
mfy7uGZcqA2PVQqEVbJ7+g: checks
*** RIVER *** [9h Qs 2h Ks] [5s]
5Y+ZGWLI4gnlpApDX5vy1A: checks
mfy7uGZcqA2PVQqEVbJ7+g: checks
*** SHOW DOWN ***
5Y+ZGWLI4gnlpApDX5vy1A: shows [Jh As] (high card Ace)
mfy7uGZcqA2PVQqEVbJ7+g: shows [Qh Ah] (a pair of Queens)
mfy7uGZcqA2PVQqEVbJ7+g collected $36.15 from pot
*** SUMMARY ***
Total pot $38 | Rake $1.85
Board [9h Qs 2h Ks 5s]
Seat 1: 6fLdOUCRtX71xbVRhJEq8w (button) folded before Flop (didn't bet)
Seat 2: 5Y+ZGWLI4gnlpApDX5vy1A (small blind) showed [Jh As] and lost with high card Ace
Seat 3: ubtx4Z5L+AcK71MTvYiGVw (big blind) folded before Flop
Seat 5: sTPOWERd9HWPCNrDBwsVjA folded before Flop (didn't bet)
Seat 6: mfy7uGZcqA2PVQqEVbJ7+g showed [Qh Ah] and won ($36.15) with a pair of Queens



PokerStars Game #59941453088:  Hold'em No Limit ($1/$2) - 2009/07/01 1:35:57 ET
Table 'G1Oqdy4Pqdb5gtx40rUBzA' 6-max Seat #2 is the button
Seat 1: ubtx4Z5L+AcK71MTvYiGVw ($200 in chips)
Seat 2: 4uqU0dG67owXuPz303Al4w ($512.25 in chips)
Seat 3: VvdR9F3I+2yELkfTVvC1dg ($235.90 in chips)
Seat 4: B87ikIyZ/TzAVeXf38Ny0g ($214.55 in chips)
Seat 5: F1+Ml47qRQWunzPnGhLLzQ ($195.30 in chips)
Seat 6: qCnEYuAE5y5A7bk6fO5/jQ ($200 in chips)
VvdR9F3I+2yELkfTVvC1dg: posts small blind $1
B87ikIyZ/TzAVeXf38Ny0g: posts big blind $2
*** HOLE CARDS ***
F1+Ml47qRQWunzPnGhLLzQ: folds
qCnEYuAE5y5A7bk6fO5/jQ: folds
ubtx4Z5L+AcK71MTvYiGVw: folds
4uqU0dG67owXuPz303Al4w: raises $4 to $6
VvdR9F3I+2yELkfTVvC1dg: folds
ubtx4Z5L+AcK71MTvYiGVw is sitting out
B87ikIyZ/TzAVeXf38Ny0g: folds
4uqU0dG67owXuPz303Al4w collected $5 from pot
*** SUMMARY ***
Total pot $5 | Rake $0
Seat 1: ubtx4Z5L+AcK71MTvYiGVw folded before Flop (didn't bet)
Seat 2: 4uqU0dG67owXuPz303Al4w (button) collected ($5)
Seat 3: VvdR9F3I+2yELkfTVvC1dg (small blind) folded before Flop
Seat 4: B87ikIyZ/TzAVeXf38Ny0g (big blind) folded before Flop
Seat 5: F1+Ml47qRQWunzPnGhLLzQ folded before Flop (didn't bet)
Seat 6: qCnEYuAE5y5A7bk6fO5/jQ folded before Flop (didn't bet)



PokerStars Game #59941453724:  Hold'em No Limit ($1/$2) - 2009/07/01 1:35:58 ET
Table 'eyAQSIlgc2o1Jxvbve4WGg' 9-max Seat #5 is the button
Seat 1: UZEsV9yKUMqmpYPiOFpaZw ($100.20 in chips)
Seat 2: kM9CA+2UcdMjbCMbtUCGiA ($200 in chips)
Seat 4: CkE3IyJF1KvdaAOmZY5XqQ ($200 in chips)
Seat 5: mIKx5lhIt13X5eZQH0ZeMA ($131.40 in chips)
Seat 6: nXDI8Y/S6POzRwANu3d8hQ ($32 in chips)
Seat 7: u3OrI5uGx9mx1fE7dgr+EA ($75.20 in chips)
Seat 8: 1CtiZuXDFaJL1dJPQKyi8Q ($161.95 in chips)
Seat 9: WUlHm+ydPPHG7Lb0rePSdA ($134.20 in chips)
nXDI8Y/S6POzRwANu3d8hQ: posts small blind $1
u3OrI5uGx9mx1fE7dgr+EA: posts big blind $2
*** HOLE CARDS ***
1CtiZuXDFaJL1dJPQKyi8Q: raises $4 to $6
WUlHm+ydPPHG7Lb0rePSdA: raises $14 to $20
UZEsV9yKUMqmpYPiOFpaZw: folds
kM9CA+2UcdMjbCMbtUCGiA: folds
CkE3IyJF1KvdaAOmZY5XqQ has timed out
CkE3IyJF1KvdaAOmZY5XqQ: folds
CkE3IyJF1KvdaAOmZY5XqQ is sitting out
mIKx5lhIt13X5eZQH0ZeMA: folds
CkE3IyJF1KvdaAOmZY5XqQ has returned
nXDI8Y/S6POzRwANu3d8hQ: folds
u3OrI5uGx9mx1fE7dgr+EA: folds
1CtiZuXDFaJL1dJPQKyi8Q: folds
WUlHm+ydPPHG7Lb0rePSdA collected $15 from pot
WUlHm+ydPPHG7Lb0rePSdA: doesn't show hand
*** SUMMARY ***
Total pot $15 | Rake $0
Seat 1: UZEsV9yKUMqmpYPiOFpaZw folded before Flop (didn't bet)
Seat 2: kM9CA+2UcdMjbCMbtUCGiA folded before Flop (didn't bet)
Seat 4: CkE3IyJF1KvdaAOmZY5XqQ folded before Flop (didn't bet)
Seat 5: mIKx5lhIt13X5eZQH0ZeMA (button) folded before Flop (didn't bet)
Seat 6: nXDI8Y/S6POzRwANu3d8hQ (small blind) folded before Flop
Seat 7: u3OrI5uGx9mx1fE7dgr+EA (big blind) folded before Flop
Seat 8: 1CtiZuXDFaJL1dJPQKyi8Q folded before Flop
Seat 9: WUlHm+ydPPHG7Lb0rePSdA collected ($15)



PokerStars Game #59941454126:  Hold'em No Limit ($1/$2) - 2009/07/01 1:35:59 ET
Table 'mGpP9StWRnoeiBDExc6Frg' 6-max Seat #6 is the button
Seat 1: VvdR9F3I+2yELkfTVvC1dg ($314.60 in chips)
Seat 2: vkfxu8f/jMYKUk6Ly4eujw ($197 in chips)
Seat 3: 7acrZUQC3Zc9BNLjoKIcLQ ($25.15 in chips)
Seat 4: 4dcDwIHRm96PwtqkpQiuiA ($76.70 in chips)
Seat 5: d1puGuVBE0fidn+5eRJ0tw ($199.95 in chips)
Seat 6: B2Ih1sr5VZk+8He7rcrMtQ ($423.05 in chips)
VvdR9F3I+2yELkfTVvC1dg: posts small blind $1
vkfxu8f/jMYKUk6Ly4eujw: posts big blind $2
*** HOLE CARDS ***
7acrZUQC3Zc9BNLjoKIcLQ: folds
4dcDwIHRm96PwtqkpQiuiA: folds
d1puGuVBE0fidn+5eRJ0tw: folds
B2Ih1sr5VZk+8He7rcrMtQ: folds
VvdR9F3I+2yELkfTVvC1dg: folds
vkfxu8f/jMYKUk6Ly4eujw collected $2 from pot
vkfxu8f/jMYKUk6Ly4eujw: doesn't show hand
*** SUMMARY ***
Total pot $2 | Rake $0
Seat 1: VvdR9F3I+2yELkfTVvC1dg (small blind) folded before Flop
Seat 2: vkfxu8f/jMYKUk6Ly4eujw (big blind) collected ($2)
Seat 3: 7acrZUQC3Zc9BNLjoKIcLQ folded before Flop (didn't bet)
Seat 4: 4dcDwIHRm96PwtqkpQiuiA folded before Flop (didn't bet)
Seat 5: d1puGuVBE0fidn+5eRJ0tw folded before Flop (didn't bet)
Seat 6: B2Ih1sr5VZk+8He7rcrMtQ (button) folded before Flop (didn't bet)



PokerStars Game #59941455358:  Hold'em No Limit ($1/$2) - 2009/07/01 1:36:01 ET
Table 'aSf77Sj8QEnzcc0WaxVD4Q' 6-max Seat #5 is the button
Seat 1: UELtvp+JfwI7XDGVwSxZXA ($289.10 in chips)
Seat 2: vkfxu8f/jMYKUk6Ly4eujw ($208.80 in chips)
Seat 3: 9dpyyjDTCed6nV7JhaUUpw ($496.70 in chips)
Seat 4: YsLQ3BAvgQHWXMAv3Wv6Hg ($200 in chips)
Seat 5: VvdR9F3I+2yELkfTVvC1dg ($258 in chips)
Seat 6: vkoJRf3gidxY1pPi0AFWww ($133.10 in chips)
vkoJRf3gidxY1pPi0AFWww: posts small blind $1
UELtvp+JfwI7XDGVwSxZXA: posts big blind $2
*** HOLE CARDS ***
vkfxu8f/jMYKUk6Ly4eujw: folds
9dpyyjDTCed6nV7JhaUUpw: raises $4 to $6
YsLQ3BAvgQHWXMAv3Wv6Hg: folds
VvdR9F3I+2yELkfTVvC1dg: folds
vkoJRf3gidxY1pPi0AFWww: folds
UELtvp+JfwI7XDGVwSxZXA: calls $4
*** FLOP *** [4h Th Qd]
UELtvp+JfwI7XDGVwSxZXA: checks
9dpyyjDTCed6nV7JhaUUpw: bets $9
UELtvp+JfwI7XDGVwSxZXA: raises $11 to $20
9dpyyjDTCed6nV7JhaUUpw: calls $11
*** TURN *** [4h Th Qd] [Kc]
UELtvp+JfwI7XDGVwSxZXA: checks
9dpyyjDTCed6nV7JhaUUpw: bets $40
UELtvp+JfwI7XDGVwSxZXA: folds
9dpyyjDTCed6nV7JhaUUpw collected $50.40 from pot
9dpyyjDTCed6nV7JhaUUpw: doesn't show hand
*** SUMMARY ***
Total pot $53 | Rake $2.60
Board [4h Th Qd Kc]
Seat 1: UELtvp+JfwI7XDGVwSxZXA (big blind) folded on the Turn
Seat 2: vkfxu8f/jMYKUk6Ly4eujw folded before Flop (didn't bet)
Seat 3: 9dpyyjDTCed6nV7JhaUUpw collected ($50.40)
Seat 4: YsLQ3BAvgQHWXMAv3Wv6Hg folded before Flop (didn't bet)
Seat 5: VvdR9F3I+2yELkfTVvC1dg (button) folded before Flop (didn't bet)
Seat 6: vkoJRf3gidxY1pPi0AFWww (small blind) folded before Flop



PokerStars Game #59941457136:  Hold'em No Limit ($1/$2) - 2009/07/01 1:36:04 ET
Table '/dyk+YdRGv90j2box35j8w' 6-max Seat #5 is the button
Seat 1: 8srN1dKQePlsv0GyTada+Q ($209.25 in chips)
Seat 2: qCnEYuAE5y5A7bk6fO5/jQ ($470.60 in chips)
Seat 3: sTPOWERd9HWPCNrDBwsVjA ($185.50 in chips)
Seat 4: z/u1YTnkiIDrtp/2cA2dBg ($167.85 in chips)
Seat 5: VvdR9F3I+2yELkfTVvC1dg ($243 in chips)
Seat 6: gnYme0DNFflnMhrdbxe1Ag ($200 in chips)
gnYme0DNFflnMhrdbxe1Ag: posts small blind $1
8srN1dKQePlsv0GyTada+Q: posts big blind $2
*** HOLE CARDS ***
qCnEYuAE5y5A7bk6fO5/jQ: folds
sTPOWERd9HWPCNrDBwsVjA: folds
z/u1YTnkiIDrtp/2cA2dBg: calls $2
VvdR9F3I+2yELkfTVvC1dg: folds
gnYme0DNFflnMhrdbxe1Ag: raises $6 to $8
8srN1dKQePlsv0GyTada+Q: folds
z/u1YTnkiIDrtp/2cA2dBg: folds
gnYme0DNFflnMhrdbxe1Ag collected $6 from pot
gnYme0DNFflnMhrdbxe1Ag: doesn't show hand
*** SUMMARY ***
Total pot $6 | Rake $0
Seat 1: 8srN1dKQePlsv0GyTada+Q (big blind) folded before Flop
Seat 2: qCnEYuAE5y5A7bk6fO5/jQ folded before Flop (didn't bet)
Seat 3: sTPOWERd9HWPCNrDBwsVjA folded before Flop (didn't bet)
Seat 4: z/u1YTnkiIDrtp/2cA2dBg folded before Flop
Seat 5: VvdR9F3I+2yELkfTVvC1dg (button) folded before Flop (didn't bet)
Seat 6: gnYme0DNFflnMhrdbxe1Ag (small blind) collected ($6)



PokerStars Game #59941457280:  Hold'em No Limit ($1/$2) - 2009/07/01 1:36:04 ET
Table 'P/yCfYl1GfGsu/e6DxDy/A' 2-max Seat #2 is the button
Seat 1: 7fOCUy3x9hdkmXkkDNolGQ ($508 in chips)
Seat 2: RwDoM55ZeQuI2ADyJhOb2Q ($971.50 in chips)
RwDoM55ZeQuI2ADyJhOb2Q: posts small blind $1
7fOCUy3x9hdkmXkkDNolGQ: posts big blind $2
*** HOLE CARDS ***
RwDoM55ZeQuI2ADyJhOb2Q: raises $4 to $6
7fOCUy3x9hdkmXkkDNolGQ: folds
RwDoM55ZeQuI2ADyJhOb2Q collected $4 from pot
RwDoM55ZeQuI2ADyJhOb2Q: doesn't show hand
*** SUMMARY ***
Total pot $4 | Rake $0
Seat 1: 7fOCUy3x9hdkmXkkDNolGQ (big blind) folded before Flop
Seat 2: RwDoM55ZeQuI2ADyJhOb2Q (button) (small blind) collected ($4)



PokerStars Game #59941457512:  Hold'em No Limit ($1/$2) - 2009/07/01 1:36:05 ET
Table 'NmY84NAf9Mh0ckAckHnh5g' 2-max Seat #2 is the button
Seat 1: 6hvg964TSqZ3AL/0XK9aVQ ($382.50 in chips)
Seat 2: RwDoM55ZeQuI2ADyJhOb2Q ($613.70 in chips)
RwDoM55ZeQuI2ADyJhOb2Q: posts small blind $1
6hvg964TSqZ3AL/0XK9aVQ: posts big blind $2
*** HOLE CARDS ***
RwDoM55ZeQuI2ADyJhOb2Q: folds
6hvg964TSqZ3AL/0XK9aVQ collected $2 from pot
*** SUMMARY ***
Total pot $2 | Rake $0
Seat 1: 6hvg964TSqZ3AL/0XK9aVQ (big blind) collected ($2)
Seat 2: RwDoM55ZeQuI2ADyJhOb2Q (button) (small blind) folded before Flop



PokerStars Game #59941458234:  Hold'em No Limit ($1/$2) - 2009/07/01 1:36:06 ET
Table 'SF49/KQm8T4taMp6kb+HXA' 9-max Seat #8 is the button
Seat 1: CUZwDpLTQKhzarPe+JCLOQ ($303.15 in chips)
Seat 2: rW/MyplHylMSBRaoRUzWrg ($43 in chips)
Seat 3: pCmk6FpSOLJ+85o1tLHIag ($280.75 in chips)
Seat 4: HffgoYm61KgkdMe/DYChIQ ($265.25 in chips)
Seat 5: ri8CLkX3e9JF34dQNbsHGA ($40 in chips)
Seat 7: nXDI8Y/S6POzRwANu3d8hQ ($37 in chips)
Seat 8: GgrYze3jkUdSO7a7CuJGDw ($194 in chips)
Seat 9: /inIs/z/PcX+TniIFpaxpg ($318.15 in chips)
/inIs/z/PcX+TniIFpaxpg: posts small blind $1
CUZwDpLTQKhzarPe+JCLOQ: posts big blind $2
*** HOLE CARDS ***
rW/MyplHylMSBRaoRUzWrg: folds
pCmk6FpSOLJ+85o1tLHIag: folds
HffgoYm61KgkdMe/DYChIQ: folds
ri8CLkX3e9JF34dQNbsHGA: folds
nXDI8Y/S6POzRwANu3d8hQ: folds
GgrYze3jkUdSO7a7CuJGDw: folds
/inIs/z/PcX+TniIFpaxpg: folds
CUZwDpLTQKhzarPe+JCLOQ collected $2 from pot
*** SUMMARY ***
Total pot $2 | Rake $0
Seat 1: CUZwDpLTQKhzarPe+JCLOQ (big blind) collected ($2)
Seat 2: rW/MyplHylMSBRaoRUzWrg folded before Flop (didn't bet)
Seat 3: pCmk6FpSOLJ+85o1tLHIag folded before Flop (didn't bet)
Seat 4: HffgoYm61KgkdMe/DYChIQ folded before Flop (didn't bet)
Seat 5: ri8CLkX3e9JF34dQNbsHGA folded before Flop (didn't bet)
Seat 7: nXDI8Y/S6POzRwANu3d8hQ folded before Flop (didn't bet)
Seat 8: GgrYze3jkUdSO7a7CuJGDw (button) folded before Flop (didn't bet)
Seat 9: /inIs/z/PcX+TniIFpaxpg (small blind) folded before Flop



PokerStars Game #59941458878:  Hold'em No Limit ($1/$2) - 2009/07/01 1:36:07 ET
Table 'TsEDkiO4tzCTCzJ7tNdEqw' 6-max Seat #1 is the button
Seat 1: MfXQsYD8pGeCS7XOtyV+vw ($60.05 in chips)
Seat 2: 4dcDwIHRm96PwtqkpQiuiA ($73.10 in chips)
Seat 3: ubtx4Z5L+AcK71MTvYiGVw ($237 in chips)
Seat 4: K8MXCrNAVYlMnnCeM32Kxw ($111.50 in chips)
Seat 5: VvdR9F3I+2yELkfTVvC1dg ($247.35 in chips)
Seat 6: uCqEjnxh2/vFBjKYkfTOkw ($166.70 in chips)
4dcDwIHRm96PwtqkpQiuiA: posts small blind $1
ubtx4Z5L+AcK71MTvYiGVw: posts big blind $2
*** HOLE CARDS ***
K8MXCrNAVYlMnnCeM32Kxw: calls $2
VvdR9F3I+2yELkfTVvC1dg: folds
uCqEjnxh2/vFBjKYkfTOkw: folds
MfXQsYD8pGeCS7XOtyV+vw: calls $2
4dcDwIHRm96PwtqkpQiuiA: calls $1
ubtx4Z5L+AcK71MTvYiGVw: checks
*** FLOP *** [5c Tc 8c]
4dcDwIHRm96PwtqkpQiuiA: bets $2
ubtx4Z5L+AcK71MTvYiGVw: calls $2
K8MXCrNAVYlMnnCeM32Kxw: calls $2
MfXQsYD8pGeCS7XOtyV+vw: folds
*** TURN *** [5c Tc 8c] [8h]
4dcDwIHRm96PwtqkpQiuiA: checks
ubtx4Z5L+AcK71MTvYiGVw: checks
K8MXCrNAVYlMnnCeM32Kxw: bets $8
4dcDwIHRm96PwtqkpQiuiA: calls $8
ubtx4Z5L+AcK71MTvYiGVw: folds
*** RIVER *** [5c Tc 8c 8h] [9c]
4dcDwIHRm96PwtqkpQiuiA: checks
K8MXCrNAVYlMnnCeM32Kxw: checks
*** SHOW DOWN ***
4dcDwIHRm96PwtqkpQiuiA: shows [3c Ac] (a flush, Ace high)
K8MXCrNAVYlMnnCeM32Kxw: mucks hand
4dcDwIHRm96PwtqkpQiuiA collected $28.55 from pot
*** SUMMARY ***
Total pot $30 | Rake $1.45
Board [5c Tc 8c 8h 9c]
Seat 1: MfXQsYD8pGeCS7XOtyV+vw (button) folded on the Flop
Seat 2: 4dcDwIHRm96PwtqkpQiuiA (small blind) showed [3c Ac] and won ($28.55) with a flush, Ace high
Seat 3: ubtx4Z5L+AcK71MTvYiGVw (big blind) folded on the Turn
Seat 4: K8MXCrNAVYlMnnCeM32Kxw mucked
Seat 5: VvdR9F3I+2yELkfTVvC1dg folded before Flop (didn't bet)
Seat 6: uCqEjnxh2/vFBjKYkfTOkw folded before Flop (didn't bet)



PokerStars Game #59941459058:  Hold'em No Limit ($1/$2) - 2009/07/01 1:36:07 ET
Table 'W9UeSV0aoPjh5SFSxM8jUQ' 9-max Seat #4 is the button
Seat 1: mIKx5lhIt13X5eZQH0ZeMA ($28.40 in chips)
Seat 3: /inIs/z/PcX+TniIFpaxpg ($22 in chips)
Seat 4: 4YA/sQy1Emm680zhbPUjow ($156.60 in chips)
Seat 5: ri8CLkX3e9JF34dQNbsHGA ($40 in chips)
Seat 7: I2ipWauytvrkEer4XD3Sjg ($75.70 in chips)
Seat 8: odhvI/CZeMsPyo1n1U7+hA ($22.40 in chips)
Seat 9: Q104K4iDGcqOlVrjAkzPEA ($108 in chips)
j47DM+lqTfzZP8musviQTg leaves the table
ri8CLkX3e9JF34dQNbsHGA: posts small blind $1
I2ipWauytvrkEer4XD3Sjg: posts big blind $2
MeleaB: sits out
*** HOLE CARDS ***
odhvI/CZeMsPyo1n1U7+hA: folds
Q104K4iDGcqOlVrjAkzPEA: calls $2
mIKx5lhIt13X5eZQH0ZeMA: raises $2 to $4
/inIs/z/PcX+TniIFpaxpg: folds
4YA/sQy1Emm680zhbPUjow: folds
ri8CLkX3e9JF34dQNbsHGA: folds
I2ipWauytvrkEer4XD3Sjg: folds
Q104K4iDGcqOlVrjAkzPEA: calls $2
*** FLOP *** [2d Ah 7s]
Q104K4iDGcqOlVrjAkzPEA: checks
mIKx5lhIt13X5eZQH0ZeMA: bets $8
Q104K4iDGcqOlVrjAkzPEA: folds
mIKx5lhIt13X5eZQH0ZeMA collected $10.45 from pot
*** SUMMARY ***
Total pot $11 | Rake $0.55
Board [2d Ah 7s]
Seat 1: mIKx5lhIt13X5eZQH0ZeMA collected ($10.45)
Seat 3: /inIs/z/PcX+TniIFpaxpg folded before Flop (didn't bet)
Seat 4: 4YA/sQy1Emm680zhbPUjow (button) folded before Flop (didn't bet)
Seat 5: ri8CLkX3e9JF34dQNbsHGA (small blind) folded before Flop
Seat 7: I2ipWauytvrkEer4XD3Sjg (big blind) folded before Flop
Seat 8: odhvI/CZeMsPyo1n1U7+hA folded before Flop (didn't bet)
Seat 9: Q104K4iDGcqOlVrjAkzPEA folded on the Flop



PokerStars Game #59941460988:  Hold'em No Limit ($1/$2) - 2009/07/01 1:36:11 ET
Table 'NmY84NAf9Mh0ckAckHnh5g' 2-max Seat #1 is the button
Seat 1: 6hvg964TSqZ3AL/0XK9aVQ ($383.50 in chips)
Seat 2: RwDoM55ZeQuI2ADyJhOb2Q ($612.70 in chips)
6hvg964TSqZ3AL/0XK9aVQ: posts small blind $1
RwDoM55ZeQuI2ADyJhOb2Q: posts big blind $2
*** HOLE CARDS ***
6hvg964TSqZ3AL/0XK9aVQ: calls $1
RwDoM55ZeQuI2ADyJhOb2Q: checks
*** FLOP *** [Kh Qs 5d]
RwDoM55ZeQuI2ADyJhOb2Q: checks
6hvg964TSqZ3AL/0XK9aVQ: checks
*** TURN *** [Kh Qs 5d] [6c]
RwDoM55ZeQuI2ADyJhOb2Q: bets $4
6hvg964TSqZ3AL/0XK9aVQ: folds
RwDoM55ZeQuI2ADyJhOb2Q collected $3.80 from pot
RwDoM55ZeQuI2ADyJhOb2Q: doesn't show hand
*** SUMMARY ***
Total pot $4 | Rake $0.20
Board [Kh Qs 5d 6c]
Seat 1: 6hvg964TSqZ3AL/0XK9aVQ (button) (small blind) folded on the Turn
Seat 2: RwDoM55ZeQuI2ADyJhOb2Q (big blind) collected ($3.80)



PokerStars Game #59941460894:  Hold'em No Limit ($1/$2) - 2009/07/01 1:36:11 ET
Table 'on4i1U1lCRmxsduFD3xiSg' 9-max Seat #1 is the button
Seat 1: so5k3vFDmokh2q3dImJ1GQ ($176.30 in chips)
Seat 2: NqSvZNzJ4RkR3sCmgQnyLw ($45.85 in chips)
Seat 3: GX1heJ+DSsvm7gzSPsYhhQ ($29.70 in chips)
Seat 4: DFQVuszLVclqjA46pN4Vvw ($122.50 in chips)
Seat 6: +T/63sAeZzWyHchahJ36GQ ($37 in chips)
Seat 7: /inIs/z/PcX+TniIFpaxpg ($271.05 in chips)
Seat 8: ZYHoLw2lWmRS7CSHi8L8Xg ($200 in chips)
Seat 9: TAfo4veNRaRlzDXMMYS3Jg ($37 in chips)
NqSvZNzJ4RkR3sCmgQnyLw: posts small blind $1
GX1heJ+DSsvm7gzSPsYhhQ: posts big blind $2
*** HOLE CARDS ***
DFQVuszLVclqjA46pN4Vvw: calls $2
+T/63sAeZzWyHchahJ36GQ: raises $8 to $10
/inIs/z/PcX+TniIFpaxpg: folds
ZYHoLw2lWmRS7CSHi8L8Xg: folds
TAfo4veNRaRlzDXMMYS3Jg: folds
so5k3vFDmokh2q3dImJ1GQ: folds
NqSvZNzJ4RkR3sCmgQnyLw: folds
GX1heJ+DSsvm7gzSPsYhhQ: folds
DFQVuszLVclqjA46pN4Vvw: calls $8
*** FLOP *** [2c 8c Ks]
DFQVuszLVclqjA46pN4Vvw: checks
+T/63sAeZzWyHchahJ36GQ: bets $12
DFQVuszLVclqjA46pN4Vvw: calls $12
*** TURN *** [2c 8c Ks] [6h]
DFQVuszLVclqjA46pN4Vvw: bets $16
+T/63sAeZzWyHchahJ36GQ: calls $15 and is all-in
*** RIVER *** [2c 8c Ks 6h] [Ad]
*** SHOW DOWN ***
DFQVuszLVclqjA46pN4Vvw: shows [8s 5d] (a pair of Eights)
+T/63sAeZzWyHchahJ36GQ: shows [Ac Qc] (a pair of Aces)
+T/63sAeZzWyHchahJ36GQ collected $74 from pot
*** SUMMARY ***
Total pot $77 | Rake $3
Board [2c 8c Ks 6h Ad]
Seat 1: so5k3vFDmokh2q3dImJ1GQ (button) folded before Flop (didn't bet)
Seat 2: NqSvZNzJ4RkR3sCmgQnyLw (small blind) folded before Flop
Seat 3: GX1heJ+DSsvm7gzSPsYhhQ (big blind) folded before Flop
Seat 4: DFQVuszLVclqjA46pN4Vvw showed [8s 5d] and lost with a pair of Eights
Seat 6: +T/63sAeZzWyHchahJ36GQ showed [Ac Qc] and won ($74) with a pair of Aces
Seat 7: /inIs/z/PcX+TniIFpaxpg folded before Flop (didn't bet)
Seat 8: ZYHoLw2lWmRS7CSHi8L8Xg folded before Flop (didn't bet)
Seat 9: TAfo4veNRaRlzDXMMYS3Jg folded before Flop (didn't bet)



PokerStars Game #59941461030:  Hold'em No Limit ($1/$2) - 2009/07/01 1:36:11 ET
Table 'uJ9juaXXg9yIcSU8amxaXQ' 6-max Seat #4 is the button
Seat 1: JsqOjN/eHz0uYVf/PyUJ6Q ($153.50 in chips)
Seat 2: VvdR9F3I+2yELkfTVvC1dg ($223.10 in chips)
Seat 3: qXDd0ZyMIse0OBu8pxeQ3Q ($246.40 in chips)
Seat 4: zNjJ/y4emmF+vzrCDd+ooA ($225.05 in chips)
Seat 5: YsLQ3BAvgQHWXMAv3Wv6Hg ($200 in chips)
YsLQ3BAvgQHWXMAv3Wv6Hg: posts small blind $1
JsqOjN/eHz0uYVf/PyUJ6Q: posts big blind $2
*** HOLE CARDS ***
VvdR9F3I+2yELkfTVvC1dg: folds
qXDd0ZyMIse0OBu8pxeQ3Q: folds
zNjJ/y4emmF+vzrCDd+ooA: calls $2
YsLQ3BAvgQHWXMAv3Wv6Hg: folds
JsqOjN/eHz0uYVf/PyUJ6Q: checks
*** FLOP *** [9s 3d 8d]
JsqOjN/eHz0uYVf/PyUJ6Q: checks
zNjJ/y4emmF+vzrCDd+ooA: checks
*** TURN *** [9s 3d 8d] [Qc]
JsqOjN/eHz0uYVf/PyUJ6Q: bets $4
zNjJ/y4emmF+vzrCDd+ooA: folds
JsqOjN/eHz0uYVf/PyUJ6Q collected $4.75 from pot
JsqOjN/eHz0uYVf/PyUJ6Q: doesn't show hand
*** SUMMARY ***
Total pot $5 | Rake $0.25
Board [9s 3d 8d Qc]
Seat 1: JsqOjN/eHz0uYVf/PyUJ6Q (big blind) collected ($4.75)
Seat 2: VvdR9F3I+2yELkfTVvC1dg folded before Flop (didn't bet)
Seat 3: qXDd0ZyMIse0OBu8pxeQ3Q folded before Flop (didn't bet)
Seat 4: zNjJ/y4emmF+vzrCDd+ooA (button) folded on the Turn
Seat 5: YsLQ3BAvgQHWXMAv3Wv6Hg (small blind) folded before Flop



PokerStars Game #59941462372:  Hold'em No Limit ($1/$2) - 2009/07/01 1:36:13 ET
Table 'AtOXMvcrtQM8yLNcALmfLQ' 2-max Seat #1 is the button
Seat 1: +HlQuAsMqZGYYtjcPO/a3A ($371.50 in chips)
Seat 2: pVqEzK9wXlRMECnb1Zg4Zw ($200 in chips)
+HlQuAsMqZGYYtjcPO/a3A: posts small blind $1
pVqEzK9wXlRMECnb1Zg4Zw: posts big blind $2
*** HOLE CARDS ***
+HlQuAsMqZGYYtjcPO/a3A: folds
pVqEzK9wXlRMECnb1Zg4Zw collected $2 from pot
pVqEzK9wXlRMECnb1Zg4Zw: doesn't show hand
*** SUMMARY ***
Total pot $2 | Rake $0
Seat 1: +HlQuAsMqZGYYtjcPO/a3A (button) (small blind) folded before Flop
Seat 2: pVqEzK9wXlRMECnb1Zg4Zw (big blind) collected ($2)



PokerStars Game #59941462572:  Hold'em No Limit ($1/$2) - 2009/07/01 1:36:14 ET
Table 'P/yCfYl1GfGsu/e6DxDy/A' 2-max Seat #1 is the button
Seat 1: 7fOCUy3x9hdkmXkkDNolGQ ($506 in chips)
Seat 2: RwDoM55ZeQuI2ADyJhOb2Q ($973.50 in chips)
7fOCUy3x9hdkmXkkDNolGQ: posts small blind $1
RwDoM55ZeQuI2ADyJhOb2Q: posts big blind $2
*** HOLE CARDS ***
7fOCUy3x9hdkmXkkDNolGQ: raises $4 to $6
RwDoM55ZeQuI2ADyJhOb2Q: raises $10 to $16
7fOCUy3x9hdkmXkkDNolGQ: calls $10
*** FLOP *** [3h Kd 3s]
RwDoM55ZeQuI2ADyJhOb2Q: checks
7fOCUy3x9hdkmXkkDNolGQ: checks
*** TURN *** [3h Kd 3s] [7d]
RwDoM55ZeQuI2ADyJhOb2Q: bets $22
7fOCUy3x9hdkmXkkDNolGQ: folds
RwDoM55ZeQuI2ADyJhOb2Q collected $31.50 from pot
RwDoM55ZeQuI2ADyJhOb2Q: doesn't show hand
*** SUMMARY ***
Total pot $32 | Rake $0.50
Board [3h Kd 3s 7d]
Seat 1: 7fOCUy3x9hdkmXkkDNolGQ (button) (small blind) folded on the Turn
Seat 2: RwDoM55ZeQuI2ADyJhOb2Q (big blind) collected ($31.50)



PokerStars Game #59941464808:  Hold'em No Limit ($1/$2) - 2009/07/01 1:36:18 ET
Table 'rKeCh+eBn4RNvybCUYkoTQ' 9-max Seat #5 is the button
Seat 1: /inIs/z/PcX+TniIFpaxpg ($198 in chips)
Seat 2: 9cBHwK40Tl06vheE7B3LHQ ($120.80 in chips)
Seat 3: GX1heJ+DSsvm7gzSPsYhhQ ($49 in chips)
Seat 5: WUlHm+ydPPHG7Lb0rePSdA ($122 in chips)
Seat 6: EBV6OktyeSmh4w6sWmcWOw ($265 in chips)
Seat 7: rW/MyplHylMSBRaoRUzWrg ($31 in chips)
Seat 8: pN/Ip0ePsUVIdUlGgLrkUw ($246.35 in chips)
Seat 9: Kzta8yu9vxHT4B70mjBZ+w ($214.25 in chips)
EBV6OktyeSmh4w6sWmcWOw: posts small blind $1
rW/MyplHylMSBRaoRUzWrg: posts big blind $2
*** HOLE CARDS ***
pN/Ip0ePsUVIdUlGgLrkUw: folds
Kzta8yu9vxHT4B70mjBZ+w: folds
/inIs/z/PcX+TniIFpaxpg: folds
9cBHwK40Tl06vheE7B3LHQ: raises $4 to $6
GX1heJ+DSsvm7gzSPsYhhQ: folds
WUlHm+ydPPHG7Lb0rePSdA: folds
EBV6OktyeSmh4w6sWmcWOw: calls $5
rW/MyplHylMSBRaoRUzWrg: folds
*** FLOP *** [Qd 7s 5s]
EBV6OktyeSmh4w6sWmcWOw: checks
9cBHwK40Tl06vheE7B3LHQ: bets $6
EBV6OktyeSmh4w6sWmcWOw: calls $6
*** TURN *** [Qd 7s 5s] [5c]
EBV6OktyeSmh4w6sWmcWOw: checks
9cBHwK40Tl06vheE7B3LHQ: checks
*** RIVER *** [Qd 7s 5s 5c] [Qc]
EBV6OktyeSmh4w6sWmcWOw: checks
9cBHwK40Tl06vheE7B3LHQ: bets $10
EBV6OktyeSmh4w6sWmcWOw: calls $10
*** SHOW DOWN ***
9cBHwK40Tl06vheE7B3LHQ: shows [3s 9s] (two pair, Queens and Fives)
EBV6OktyeSmh4w6sWmcWOw: shows [Td Th] (two pair, Queens and Tens)
EBV6OktyeSmh4w6sWmcWOw collected $43.80 from pot
*** SUMMARY ***
Total pot $46 | Rake $2.20
Board [Qd 7s 5s 5c Qc]
Seat 1: /inIs/z/PcX+TniIFpaxpg folded before Flop (didn't bet)
Seat 2: 9cBHwK40Tl06vheE7B3LHQ showed [3s 9s] and lost with two pair, Queens and Fives
Seat 3: GX1heJ+DSsvm7gzSPsYhhQ folded before Flop (didn't bet)
Seat 5: WUlHm+ydPPHG7Lb0rePSdA (button) folded before Flop (didn't bet)
Seat 6: EBV6OktyeSmh4w6sWmcWOw (small blind) showed [Td Th] and won ($43.80) with two pair, Queens and Tens
Seat 7: rW/MyplHylMSBRaoRUzWrg (big blind) folded before Flop
Seat 8: pN/Ip0ePsUVIdUlGgLrkUw folded before Flop (didn't bet)
Seat 9: Kzta8yu9vxHT4B70mjBZ+w folded before Flop (didn't bet)



PokerStars Game #59941465612:  Hold'em No Limit ($1/$2) - 2009/07/01 1:36:19 ET
Table 'mGpP9StWRnoeiBDExc6Frg' 6-max Seat #1 is the button
Seat 1: VvdR9F3I+2yELkfTVvC1dg ($313.60 in chips)
Seat 2: vkfxu8f/jMYKUk6Ly4eujw ($198 in chips)
Seat 3: 7acrZUQC3Zc9BNLjoKIcLQ ($25.15 in chips)
Seat 4: 4dcDwIHRm96PwtqkpQiuiA ($76.70 in chips)
Seat 5: d1puGuVBE0fidn+5eRJ0tw ($199.95 in chips)
Seat 6: B2Ih1sr5VZk+8He7rcrMtQ ($423.05 in chips)
vkfxu8f/jMYKUk6Ly4eujw: posts small blind $1
7acrZUQC3Zc9BNLjoKIcLQ: posts big blind $2
*** HOLE CARDS ***
4dcDwIHRm96PwtqkpQiuiA: folds
d1puGuVBE0fidn+5eRJ0tw: calls $2
B2Ih1sr5VZk+8He7rcrMtQ: folds
VvdR9F3I+2yELkfTVvC1dg: folds
vkfxu8f/jMYKUk6Ly4eujw: calls $1
7acrZUQC3Zc9BNLjoKIcLQ: checks
*** FLOP *** [9s 4s 3h]
vkfxu8f/jMYKUk6Ly4eujw: checks
7acrZUQC3Zc9BNLjoKIcLQ: checks
d1puGuVBE0fidn+5eRJ0tw: bets $4
vkfxu8f/jMYKUk6Ly4eujw: folds
7acrZUQC3Zc9BNLjoKIcLQ has timed out
7acrZUQC3Zc9BNLjoKIcLQ: folds
7acrZUQC3Zc9BNLjoKIcLQ is sitting out
d1puGuVBE0fidn+5eRJ0tw collected $5.70 from pot
d1puGuVBE0fidn+5eRJ0tw: doesn't show hand
*** SUMMARY ***
Total pot $6 | Rake $0.30
Board [9s 4s 3h]
Seat 1: VvdR9F3I+2yELkfTVvC1dg (button) folded before Flop (didn't bet)
Seat 2: vkfxu8f/jMYKUk6Ly4eujw (small blind) folded on the Flop
Seat 3: 7acrZUQC3Zc9BNLjoKIcLQ (big blind) folded on the Flop
Seat 4: 4dcDwIHRm96PwtqkpQiuiA folded before Flop (didn't bet)
Seat 5: d1puGuVBE0fidn+5eRJ0tw collected ($5.70)
Seat 6: B2Ih1sr5VZk+8He7rcrMtQ folded before Flop (didn't bet)



PokerStars Game #59941466090:  Hold'em No Limit ($1/$2) - 2009/07/01 1:36:20 ET
Table 'gftD4mDF7mIFKvSrIyaRbw' 9-max Seat #8 is the button
Seat 2: GX1heJ+DSsvm7gzSPsYhhQ ($34 in chips)
Seat 3: CUZwDpLTQKhzarPe+JCLOQ ($225.65 in chips)
Seat 4: /inIs/z/PcX+TniIFpaxpg ($37 in chips)
Seat 5: mpsfNtnMVDqQHTe92AhIdw ($97.10 in chips)
Seat 6: 2NvwF8W2nzsbS+G//yLAbQ ($115.20 in chips)
Seat 7: +T/63sAeZzWyHchahJ36GQ ($46 in chips)
Seat 8: MpL4DeEqGQu0H8TJEbEOrg ($38 in chips)
GX1heJ+DSsvm7gzSPsYhhQ: posts small blind $1
CUZwDpLTQKhzarPe+JCLOQ: posts big blind $2
*** HOLE CARDS ***
/inIs/z/PcX+TniIFpaxpg: folds
mpsfNtnMVDqQHTe92AhIdw: folds
2NvwF8W2nzsbS+G//yLAbQ: raises $2 to $4
+T/63sAeZzWyHchahJ36GQ: folds
MpL4DeEqGQu0H8TJEbEOrg: folds
GX1heJ+DSsvm7gzSPsYhhQ: folds
CUZwDpLTQKhzarPe+JCLOQ: folds
2NvwF8W2nzsbS+G//yLAbQ collected $5 from pot
*** SUMMARY ***
Total pot $5 | Rake $0
Seat 2: GX1heJ+DSsvm7gzSPsYhhQ (small blind) folded before Flop
Seat 3: CUZwDpLTQKhzarPe+JCLOQ (big blind) folded before Flop
Seat 4: /inIs/z/PcX+TniIFpaxpg folded before Flop (didn't bet)
Seat 5: mpsfNtnMVDqQHTe92AhIdw folded before Flop (didn't bet)
Seat 6: 2NvwF8W2nzsbS+G//yLAbQ collected ($5)
Seat 7: +T/63sAeZzWyHchahJ36GQ folded before Flop (didn't bet)
Seat 8: MpL4DeEqGQu0H8TJEbEOrg (button) folded before Flop (didn't bet)



PokerStars Game #59941467160:  Hold'em No Limit ($1/$2) - 2009/07/01 1:36:22 ET
Table '/ci73fTmzTzmGWzAtqEX2Q' 9-max Seat #9 is the button
Seat 1: 9efVc1cB3yHt4TvBkTusPw ($154.90 in chips)
Seat 2: pN/Ip0ePsUVIdUlGgLrkUw ($225 in chips)
Seat 3: kK1+5ivyJZeA8hQF2pdvvQ ($64.55 in chips)
Seat 4: 2yq7Zp4xmrhAw8+37hTkaA ($169.20 in chips)
Seat 5: 1CtiZuXDFaJL1dJPQKyi8Q ($215 in chips)
Seat 6: GX1heJ+DSsvm7gzSPsYhhQ ($44.65 in chips)
Seat 8: /inIs/z/PcX+TniIFpaxpg ($34 in chips)
Seat 9: S8aS+9FTYQ/ICLBNThcrkg ($179 in chips)
9efVc1cB3yHt4TvBkTusPw: posts small blind $1
pN/Ip0ePsUVIdUlGgLrkUw: posts big blind $2
+T/63sAeZzWyHchahJ36GQ: sits out
*** HOLE CARDS ***
kK1+5ivyJZeA8hQF2pdvvQ: folds
2yq7Zp4xmrhAw8+37hTkaA: folds
1CtiZuXDFaJL1dJPQKyi8Q: raises $4 to $6
GX1heJ+DSsvm7gzSPsYhhQ: raises $38.65 to $44.65 and is all-in
/inIs/z/PcX+TniIFpaxpg: folds
S8aS+9FTYQ/ICLBNThcrkg: folds
9efVc1cB3yHt4TvBkTusPw: folds
pN/Ip0ePsUVIdUlGgLrkUw: folds
1CtiZuXDFaJL1dJPQKyi8Q: calls $38.65
*** FLOP *** [Ad 6c 5c]
*** TURN *** [Ad 6c 5c] [4c]
*** RIVER *** [Ad 6c 5c 4c] [5h]
*** SHOW DOWN ***
1CtiZuXDFaJL1dJPQKyi8Q: shows [Ks Ah] (two pair, Aces and Fives)
GX1heJ+DSsvm7gzSPsYhhQ: shows [Ac As] (a full house, Aces full of Fives)
GX1heJ+DSsvm7gzSPsYhhQ collected $89.30 from pot
*** SUMMARY ***
Total pot $92.30 | Rake $3
Board [Ad 6c 5c 4c 5h]
Seat 1: 9efVc1cB3yHt4TvBkTusPw (small blind) folded before Flop
Seat 2: pN/Ip0ePsUVIdUlGgLrkUw (big blind) folded before Flop
Seat 3: kK1+5ivyJZeA8hQF2pdvvQ folded before Flop (didn't bet)
Seat 4: 2yq7Zp4xmrhAw8+37hTkaA folded before Flop (didn't bet)
Seat 5: 1CtiZuXDFaJL1dJPQKyi8Q showed [Ks Ah] and lost with two pair, Aces and Fives
Seat 6: GX1heJ+DSsvm7gzSPsYhhQ showed [Ac As] and won ($89.30) with a full house, Aces full of Fives
Seat 8: /inIs/z/PcX+TniIFpaxpg folded before Flop (didn't bet)
Seat 9: S8aS+9FTYQ/ICLBNThcrkg (button) folded before Flop (didn't bet)



PokerStars Game #59941466770:  Hold'em No Limit ($1/$2) - 2009/07/01 1:36:22 ET
Table 'G1Oqdy4Pqdb5gtx40rUBzA' 6-max Seat #3 is the button
Seat 2: 4uqU0dG67owXuPz303Al4w ($515.25 in chips)
Seat 3: VvdR9F3I+2yELkfTVvC1dg ($234.90 in chips)
Seat 4: B87ikIyZ/TzAVeXf38Ny0g ($212.55 in chips)
Seat 5: F1+Ml47qRQWunzPnGhLLzQ ($195.30 in chips)
Seat 6: qCnEYuAE5y5A7bk6fO5/jQ ($200 in chips)
B87ikIyZ/TzAVeXf38Ny0g: posts small blind $1
F1+Ml47qRQWunzPnGhLLzQ: posts big blind $2
*** HOLE CARDS ***
qCnEYuAE5y5A7bk6fO5/jQ: folds
4uqU0dG67owXuPz303Al4w: folds
VvdR9F3I+2yELkfTVvC1dg: folds
B87ikIyZ/TzAVeXf38Ny0g: folds
F1+Ml47qRQWunzPnGhLLzQ collected $2 from pot
F1+Ml47qRQWunzPnGhLLzQ: doesn't show hand
*** SUMMARY ***
Total pot $2 | Rake $0
Seat 2: 4uqU0dG67owXuPz303Al4w folded before Flop (didn't bet)
Seat 3: VvdR9F3I+2yELkfTVvC1dg (button) folded before Flop (didn't bet)
Seat 4: B87ikIyZ/TzAVeXf38Ny0g (small blind) folded before Flop
Seat 5: F1+Ml47qRQWunzPnGhLLzQ (big blind) collected ($2)
Seat 6: qCnEYuAE5y5A7bk6fO5/jQ folded before Flop (didn't bet)



PokerStars Game #59941467696:  Hold'em No Limit ($1/$2) - 2009/07/01 1:36:23 ET
Table 'CFkQcfWjKccZaZDf71FK+w' 6-max Seat #3 is the button
Seat 1: vkfxu8f/jMYKUk6Ly4eujw ($197 in chips)
Seat 2: ewN/vzF22+/gdzjIKBOlkA ($207.80 in chips)
Seat 3: 09BNF4quPDzanQzM8vc6WA ($43.65 in chips)
Seat 4: ygTTt5ehT4aF86q1a8/R+w ($247.35 in chips)
Seat 5: 2lOU1DcvUZaMcxZ95XfzXw ($137.60 in chips)
Seat 6: ORVqY3rf9X6ANA/8s+On2Q ($132.60 in chips)
ygTTt5ehT4aF86q1a8/R+w: posts small blind $1
2lOU1DcvUZaMcxZ95XfzXw: posts big blind $2
*** HOLE CARDS ***
ORVqY3rf9X6ANA/8s+On2Q: calls $2
vkfxu8f/jMYKUk6Ly4eujw: folds
ewN/vzF22+/gdzjIKBOlkA: raises $4 to $6
09BNF4quPDzanQzM8vc6WA: folds
ygTTt5ehT4aF86q1a8/R+w: folds
2lOU1DcvUZaMcxZ95XfzXw: folds
ORVqY3rf9X6ANA/8s+On2Q: calls $4
*** FLOP *** [6c 2c Ac]
ORVqY3rf9X6ANA/8s+On2Q: checks
ewN/vzF22+/gdzjIKBOlkA: bets $12
ORVqY3rf9X6ANA/8s+On2Q: folds
ewN/vzF22+/gdzjIKBOlkA collected $14.25 from pot
*** SUMMARY ***
Total pot $15 | Rake $0.75
Board [6c 2c Ac]
Seat 1: vkfxu8f/jMYKUk6Ly4eujw folded before Flop (didn't bet)
Seat 2: ewN/vzF22+/gdzjIKBOlkA collected ($14.25)
Seat 3: 09BNF4quPDzanQzM8vc6WA (button) folded before Flop (didn't bet)
Seat 4: ygTTt5ehT4aF86q1a8/R+w (small blind) folded before Flop
Seat 5: 2lOU1DcvUZaMcxZ95XfzXw (big blind) folded before Flop
Seat 6: ORVqY3rf9X6ANA/8s+On2Q folded on the Flop



PokerStars Game #59941468446:  Hold'em No Limit ($1/$2) - 2009/07/01 1:36:24 ET
Table 'qVXak+oTeDXMGbWa4sDU5Q' 9-max Seat #8 is the button
Seat 1: H6Z4+qu8gR0VUiPOijndVg ($205.55 in chips)
Seat 2: rW/MyplHylMSBRaoRUzWrg ($81 in chips)
Seat 3: WUlHm+ydPPHG7Lb0rePSdA ($175.10 in chips)
Seat 4: lQYT23h5QCUVZAKxjOO39Q ($200.70 in chips)
Seat 5: FWGiDqRwvLeKmHq9t4Jy9w ($265.80 in chips)
Seat 6: GX1heJ+DSsvm7gzSPsYhhQ ($43 in chips)
Seat 7: PfmlvZlFiss79a6IoEr11g ($154.30 in chips)
Seat 8: Z0rzUi0y1x80UdIpofoNbA ($111.55 in chips)
Seat 9: CkE3IyJF1KvdaAOmZY5XqQ ($216.55 in chips)
CkE3IyJF1KvdaAOmZY5XqQ: posts small blind $1
H6Z4+qu8gR0VUiPOijndVg: posts big blind $2
*** HOLE CARDS ***
rW/MyplHylMSBRaoRUzWrg: folds
WUlHm+ydPPHG7Lb0rePSdA: folds
lQYT23h5QCUVZAKxjOO39Q: calls $2
FWGiDqRwvLeKmHq9t4Jy9w: folds
GX1heJ+DSsvm7gzSPsYhhQ: folds
PfmlvZlFiss79a6IoEr11g: folds
Z0rzUi0y1x80UdIpofoNbA: calls $2
CkE3IyJF1KvdaAOmZY5XqQ: folds
H6Z4+qu8gR0VUiPOijndVg: raises $8 to $10
lQYT23h5QCUVZAKxjOO39Q: folds
Z0rzUi0y1x80UdIpofoNbA: folds
H6Z4+qu8gR0VUiPOijndVg collected $7 from pot
H6Z4+qu8gR0VUiPOijndVg: doesn't show hand
*** SUMMARY ***
Total pot $7 | Rake $0
Seat 1: H6Z4+qu8gR0VUiPOijndVg (big blind) collected ($7)
Seat 2: rW/MyplHylMSBRaoRUzWrg folded before Flop (didn't bet)
Seat 3: WUlHm+ydPPHG7Lb0rePSdA folded before Flop (didn't bet)
Seat 4: lQYT23h5QCUVZAKxjOO39Q folded before Flop
Seat 5: FWGiDqRwvLeKmHq9t4Jy9w folded before Flop (didn't bet)
Seat 6: GX1heJ+DSsvm7gzSPsYhhQ folded before Flop (didn't bet)
Seat 7: PfmlvZlFiss79a6IoEr11g folded before Flop (didn't bet)
Seat 8: Z0rzUi0y1x80UdIpofoNbA (button) folded before Flop
Seat 9: CkE3IyJF1KvdaAOmZY5XqQ (small blind) folded before Flop



PokerStars Game #59941468822:  Hold'em No Limit ($1/$2) - 2009/07/01 1:36:25 ET
Table '4NGNnZ/osQfNq6abYqkJeA' 6-max Seat #6 is the button
Seat 1: vkfxu8f/jMYKUk6Ly4eujw ($198 in chips)
Seat 2: 669iGNwYwgRZg3nhS+aDAQ ($102.90 in chips)
Seat 3: 54yWzRRgS0oZ+S6LwZBxMQ ($32 in chips)
Seat 4: sY+4Uuh5z/6AbXXaCS10jw ($225.25 in chips)
Seat 5: VvdR9F3I+2yELkfTVvC1dg ($241.55 in chips)
Seat 6: /PH6Ffnho4Ysm8S3V/oa+w ($40 in chips)
vkfxu8f/jMYKUk6Ly4eujw: posts small blind $1
669iGNwYwgRZg3nhS+aDAQ: posts big blind $2
*** HOLE CARDS ***
54yWzRRgS0oZ+S6LwZBxMQ: calls $2
sY+4Uuh5z/6AbXXaCS10jw: raises $6 to $8
VvdR9F3I+2yELkfTVvC1dg: folds
/PH6Ffnho4Ysm8S3V/oa+w: folds
vkfxu8f/jMYKUk6Ly4eujw: calls $7
669iGNwYwgRZg3nhS+aDAQ: folds
54yWzRRgS0oZ+S6LwZBxMQ: folds
*** FLOP *** [Jc Kh 8c]
vkfxu8f/jMYKUk6Ly4eujw: checks
sY+4Uuh5z/6AbXXaCS10jw: bets $13
vkfxu8f/jMYKUk6Ly4eujw: folds
sY+4Uuh5z/6AbXXaCS10jw collected $19 from pot
*** SUMMARY ***
Total pot $20 | Rake $1
Board [Jc Kh 8c]
Seat 1: vkfxu8f/jMYKUk6Ly4eujw (small blind) folded on the Flop
Seat 2: 669iGNwYwgRZg3nhS+aDAQ (big blind) folded before Flop
Seat 3: 54yWzRRgS0oZ+S6LwZBxMQ folded before Flop
Seat 4: sY+4Uuh5z/6AbXXaCS10jw collected ($19)
Seat 5: VvdR9F3I+2yELkfTVvC1dg folded before Flop (didn't bet)
Seat 6: /PH6Ffnho4Ysm8S3V/oa+w (button) folded before Flop (didn't bet)



PokerStars Game #59941469296:  Hold'em No Limit ($1/$2) - 2009/07/01 1:36:26 ET
Table 'jlrIxbrVIG+gjaUYT4za8g' 6-max Seat #1 is the button
Seat 1: ygTTt5ehT4aF86q1a8/R+w ($232.30 in chips)
Seat 2: /PH6Ffnho4Ysm8S3V/oa+w ($41 in chips)
Seat 3: gnYme0DNFflnMhrdbxe1Ag ($200 in chips)
Seat 4: 8srN1dKQePlsv0GyTada+Q ($257.20 in chips)
Seat 5: AyBB0k3Dcl7xbXUeGMw06g ($70.90 in chips)
Seat 6: vkfxu8f/jMYKUk6Ly4eujw ($335.20 in chips)
/PH6Ffnho4Ysm8S3V/oa+w: posts small blind $1
gnYme0DNFflnMhrdbxe1Ag: posts big blind $2
*** HOLE CARDS ***
8srN1dKQePlsv0GyTada+Q: folds
AyBB0k3Dcl7xbXUeGMw06g: calls $2
vkfxu8f/jMYKUk6Ly4eujw: folds
ygTTt5ehT4aF86q1a8/R+w: folds
/PH6Ffnho4Ysm8S3V/oa+w: folds
gnYme0DNFflnMhrdbxe1Ag: checks
*** FLOP *** [4c 7s Kc]
gnYme0DNFflnMhrdbxe1Ag: checks
AyBB0k3Dcl7xbXUeGMw06g: checks
*** TURN *** [4c 7s Kc] [Ac]
gnYme0DNFflnMhrdbxe1Ag: checks
AyBB0k3Dcl7xbXUeGMw06g: checks
*** RIVER *** [4c 7s Kc Ac] [4h]
gnYme0DNFflnMhrdbxe1Ag: checks
AyBB0k3Dcl7xbXUeGMw06g: checks
*** SHOW DOWN ***
gnYme0DNFflnMhrdbxe1Ag: shows [8s 2s] (a pair of Fours)
AyBB0k3Dcl7xbXUeGMw06g: shows [5h 5c] (two pair, Fives and Fours)
AyBB0k3Dcl7xbXUeGMw06g collected $4.75 from pot
*** SUMMARY ***
Total pot $5 | Rake $0.25
Board [4c 7s Kc Ac 4h]
Seat 1: ygTTt5ehT4aF86q1a8/R+w (button) folded before Flop (didn't bet)
Seat 2: /PH6Ffnho4Ysm8S3V/oa+w (small blind) folded before Flop
Seat 3: gnYme0DNFflnMhrdbxe1Ag (big blind) showed [8s 2s] and lost with a pair of Fours
Seat 4: 8srN1dKQePlsv0GyTada+Q folded before Flop (didn't bet)
Seat 5: AyBB0k3Dcl7xbXUeGMw06g showed [5h 5c] and won ($4.75) with two pair, Fives and Fours
Seat 6: vkfxu8f/jMYKUk6Ly4eujw folded before Flop (didn't bet)



PokerStars Game #59941470130:  Hold'em No Limit ($1/$2) - 2009/07/01 1:36:27 ET
Table 'UGLAZZyv+cXmnKjYin0etA' 6-max Seat #2 is the button
Seat 1: vkfxu8f/jMYKUk6Ly4eujw ($201 in chips)
Seat 2: eDLH1PUXFpvJBNMXBVQcGA ($276.35 in chips)
Seat 3: ygTTt5ehT4aF86q1a8/R+w ($115.20 in chips)
Seat 4: SiGJDsvRViJX05vHhA80GQ ($234.85 in chips)
Seat 5: 54yWzRRgS0oZ+S6LwZBxMQ ($35.75 in chips)
Seat 6: sTPOWERd9HWPCNrDBwsVjA ($210.10 in chips)
ygTTt5ehT4aF86q1a8/R+w: posts small blind $1
SiGJDsvRViJX05vHhA80GQ: posts big blind $2
*** HOLE CARDS ***
54yWzRRgS0oZ+S6LwZBxMQ: folds
sTPOWERd9HWPCNrDBwsVjA: folds
vkfxu8f/jMYKUk6Ly4eujw: folds
eDLH1PUXFpvJBNMXBVQcGA: raises $4 to $6
ygTTt5ehT4aF86q1a8/R+w: folds
SiGJDsvRViJX05vHhA80GQ: folds
eDLH1PUXFpvJBNMXBVQcGA collected $5 from pot
*** SUMMARY ***
Total pot $5 | Rake $0
Seat 1: vkfxu8f/jMYKUk6Ly4eujw folded before Flop (didn't bet)
Seat 2: eDLH1PUXFpvJBNMXBVQcGA (button) collected ($5)
Seat 3: ygTTt5ehT4aF86q1a8/R+w (small blind) folded before Flop
Seat 4: SiGJDsvRViJX05vHhA80GQ (big blind) folded before Flop
Seat 5: 54yWzRRgS0oZ+S6LwZBxMQ folded before Flop (didn't bet)
Seat 6: sTPOWERd9HWPCNrDBwsVjA folded before Flop (didn't bet)



PokerStars Game #59941469570:  Hold'em No Limit ($1/$2) - 2009/07/01 1:36:27 ET
Table 'AtOXMvcrtQM8yLNcALmfLQ' 2-max Seat #2 is the button
Seat 1: +HlQuAsMqZGYYtjcPO/a3A ($370.50 in chips)
Seat 2: pVqEzK9wXlRMECnb1Zg4Zw ($201 in chips)
pVqEzK9wXlRMECnb1Zg4Zw: posts small blind $1
+HlQuAsMqZGYYtjcPO/a3A: posts big blind $2
*** HOLE CARDS ***
pVqEzK9wXlRMECnb1Zg4Zw: raises $6 to $8
+HlQuAsMqZGYYtjcPO/a3A: calls $6
*** FLOP *** [4c Ad 2d]
+HlQuAsMqZGYYtjcPO/a3A: checks
pVqEzK9wXlRMECnb1Zg4Zw: bets $12
+HlQuAsMqZGYYtjcPO/a3A: calls $12
*** TURN *** [4c Ad 2d] [5c]
+HlQuAsMqZGYYtjcPO/a3A: checks
pVqEzK9wXlRMECnb1Zg4Zw: checks
*** RIVER *** [4c Ad 2d 5c] [6c]
+HlQuAsMqZGYYtjcPO/a3A: bets $18
pVqEzK9wXlRMECnb1Zg4Zw: raises $100 to $118
+HlQuAsMqZGYYtjcPO/a3A: folds
pVqEzK9wXlRMECnb1Zg4Zw collected $75.50 from pot
pVqEzK9wXlRMECnb1Zg4Zw: doesn't show hand
*** SUMMARY ***
Total pot $76 | Rake $0.50
Board [4c Ad 2d 5c 6c]
Seat 1: +HlQuAsMqZGYYtjcPO/a3A (big blind) folded on the River
Seat 2: pVqEzK9wXlRMECnb1Zg4Zw (button) (small blind) collected ($75.50)



PokerStars Game #59941471680:  Hold'em No Limit ($1/$2) - 2009/07/01 1:36:30 ET
Table 'NmY84NAf9Mh0ckAckHnh5g' 2-max Seat #2 is the button
Seat 1: 6hvg964TSqZ3AL/0XK9aVQ ($381.50 in chips)
Seat 2: RwDoM55ZeQuI2ADyJhOb2Q ($614.50 in chips)
RwDoM55ZeQuI2ADyJhOb2Q: posts small blind $1
6hvg964TSqZ3AL/0XK9aVQ: posts big blind $2
*** HOLE CARDS ***
RwDoM55ZeQuI2ADyJhOb2Q: raises $4 to $6
6hvg964TSqZ3AL/0XK9aVQ: calls $4
*** FLOP *** [7d 4c 9h]
6hvg964TSqZ3AL/0XK9aVQ: checks
RwDoM55ZeQuI2ADyJhOb2Q: bets $8
6hvg964TSqZ3AL/0XK9aVQ: calls $8
*** TURN *** [7d 4c 9h] [8c]
6hvg964TSqZ3AL/0XK9aVQ: checks
RwDoM55ZeQuI2ADyJhOb2Q: bets $22
6hvg964TSqZ3AL/0XK9aVQ: calls $22
*** RIVER *** [7d 4c 9h 8c] [4s]
6hvg964TSqZ3AL/0XK9aVQ: checks
RwDoM55ZeQuI2ADyJhOb2Q: bets $32
6hvg964TSqZ3AL/0XK9aVQ: calls $32
*** SHOW DOWN ***
RwDoM55ZeQuI2ADyJhOb2Q: shows [Jc 7c] (two pair, Sevens and Fours)
6hvg964TSqZ3AL/0XK9aVQ: shows [9c 3c] (two pair, Nines and Fours)
6hvg964TSqZ3AL/0XK9aVQ collected $135.50 from pot
*** SUMMARY ***
Total pot $136 | Rake $0.50
Board [7d 4c 9h 8c 4s]
Seat 1: 6hvg964TSqZ3AL/0XK9aVQ (big blind) showed [9c 3c] and won ($135.50) with two pair, Nines and Fours
Seat 2: RwDoM55ZeQuI2ADyJhOb2Q (button) (small blind) showed [Jc 7c] and lost with two pair, Sevens and Fours



PokerStars Game #59941472744:  Hold'em No Limit ($1/$2) - 2009/07/01 1:36:32 ET
Table 'SF49/KQm8T4taMp6kb+HXA' 9-max Seat #9 is the button
Seat 1: CUZwDpLTQKhzarPe+JCLOQ ($304.15 in chips)
Seat 2: rW/MyplHylMSBRaoRUzWrg ($43 in chips)
Seat 3: pCmk6FpSOLJ+85o1tLHIag ($280.75 in chips)
Seat 4: HffgoYm61KgkdMe/DYChIQ ($265.25 in chips)
Seat 5: ri8CLkX3e9JF34dQNbsHGA ($40 in chips)
Seat 7: nXDI8Y/S6POzRwANu3d8hQ ($37 in chips)
Seat 8: GgrYze3jkUdSO7a7CuJGDw ($194 in chips)
Seat 9: /inIs/z/PcX+TniIFpaxpg ($317.15 in chips)
CUZwDpLTQKhzarPe+JCLOQ: posts small blind $1
rW/MyplHylMSBRaoRUzWrg: posts big blind $2
*** HOLE CARDS ***
pCmk6FpSOLJ+85o1tLHIag: folds
HffgoYm61KgkdMe/DYChIQ: raises $4 to $6
ri8CLkX3e9JF34dQNbsHGA: folds
nXDI8Y/S6POzRwANu3d8hQ: folds
GgrYze3jkUdSO7a7CuJGDw: folds
/inIs/z/PcX+TniIFpaxpg: folds
CUZwDpLTQKhzarPe+JCLOQ: folds
rW/MyplHylMSBRaoRUzWrg: folds
HffgoYm61KgkdMe/DYChIQ collected $5 from pot
*** SUMMARY ***
Total pot $5 | Rake $0
Seat 1: CUZwDpLTQKhzarPe+JCLOQ (small blind) folded before Flop
Seat 2: rW/MyplHylMSBRaoRUzWrg (big blind) folded before Flop
Seat 3: pCmk6FpSOLJ+85o1tLHIag folded before Flop (didn't bet)
Seat 4: HffgoYm61KgkdMe/DYChIQ collected ($5)
Seat 5: ri8CLkX3e9JF34dQNbsHGA folded before Flop (didn't bet)
Seat 7: nXDI8Y/S6POzRwANu3d8hQ folded before Flop (didn't bet)
Seat 8: GgrYze3jkUdSO7a7CuJGDw folded before Flop (didn't bet)
Seat 9: /inIs/z/PcX+TniIFpaxpg (button) folded before Flop (didn't bet)



PokerStars Game #59941474814:  Hold'em No Limit ($1/$2) - 2009/07/01 1:36:36 ET
Table 'ZzSIe0zTCDv+n6hfbY5tTg' 6-max Seat #3 is the button
Seat 1: VvdR9F3I+2yELkfTVvC1dg ($237 in chips)
Seat 2: B87ikIyZ/TzAVeXf38Ny0g ($243 in chips)
Seat 3: gsugPj31Hui3Jefl98MBOA ($350 in chips)
Seat 4: qXDd0ZyMIse0OBu8pxeQ3Q ($260 in chips)
Seat 5: 3dAbvkxS5NPQTBAbvpinVg ($489.35 in chips)
Seat 6: 09BNF4quPDzanQzM8vc6WA ($23.05 in chips)
qXDd0ZyMIse0OBu8pxeQ3Q: posts small blind $1
3dAbvkxS5NPQTBAbvpinVg: posts big blind $2
*** HOLE CARDS ***
09BNF4quPDzanQzM8vc6WA: folds
VvdR9F3I+2yELkfTVvC1dg: folds
B87ikIyZ/TzAVeXf38Ny0g: raises $4 to $6
gsugPj31Hui3Jefl98MBOA: calls $6
qXDd0ZyMIse0OBu8pxeQ3Q: folds
3dAbvkxS5NPQTBAbvpinVg: folds
*** FLOP *** [3d 8h 6s]
B87ikIyZ/TzAVeXf38Ny0g: checks
gsugPj31Hui3Jefl98MBOA: bets $9
B87ikIyZ/TzAVeXf38Ny0g: folds
gsugPj31Hui3Jefl98MBOA collected $14.25 from pot
*** SUMMARY ***
Total pot $15 | Rake $0.75
Board [3d 8h 6s]
Seat 1: VvdR9F3I+2yELkfTVvC1dg folded before Flop (didn't bet)
Seat 2: B87ikIyZ/TzAVeXf38Ny0g folded on the Flop
Seat 3: gsugPj31Hui3Jefl98MBOA (button) collected ($14.25)
Seat 4: qXDd0ZyMIse0OBu8pxeQ3Q (small blind) folded before Flop
Seat 5: 3dAbvkxS5NPQTBAbvpinVg (big blind) folded before Flop
Seat 6: 09BNF4quPDzanQzM8vc6WA folded before Flop (didn't bet)



PokerStars Game #59941475234:  Hold'em No Limit ($1/$2) - 2009/07/01 1:36:37 ET
Table '/dyk+YdRGv90j2box35j8w' 6-max Seat #6 is the button
Seat 1: 8srN1dKQePlsv0GyTada+Q ($207.25 in chips)
Seat 2: qCnEYuAE5y5A7bk6fO5/jQ ($470.60 in chips)
Seat 3: sTPOWERd9HWPCNrDBwsVjA ($185.50 in chips)
Seat 4: z/u1YTnkiIDrtp/2cA2dBg ($165.85 in chips)
Seat 5: VvdR9F3I+2yELkfTVvC1dg ($243 in chips)
Seat 6: gnYme0DNFflnMhrdbxe1Ag ($204 in chips)
8srN1dKQePlsv0GyTada+Q: posts small blind $1
qCnEYuAE5y5A7bk6fO5/jQ: posts big blind $2
*** HOLE CARDS ***
sTPOWERd9HWPCNrDBwsVjA: folds
z/u1YTnkiIDrtp/2cA2dBg: folds
VvdR9F3I+2yELkfTVvC1dg: folds
gnYme0DNFflnMhrdbxe1Ag: folds
8srN1dKQePlsv0GyTada+Q: raises $4 to $6
qCnEYuAE5y5A7bk6fO5/jQ: folds
8srN1dKQePlsv0GyTada+Q collected $4 from pot
8srN1dKQePlsv0GyTada+Q: doesn't show hand
*** SUMMARY ***
Total pot $4 | Rake $0
Seat 1: 8srN1dKQePlsv0GyTada+Q (small blind) collected ($4)
Seat 2: qCnEYuAE5y5A7bk6fO5/jQ (big blind) folded before Flop
Seat 3: sTPOWERd9HWPCNrDBwsVjA folded before Flop (didn't bet)
Seat 4: z/u1YTnkiIDrtp/2cA2dBg folded before Flop (didn't bet)
Seat 5: VvdR9F3I+2yELkfTVvC1dg folded before Flop (didn't bet)
Seat 6: gnYme0DNFflnMhrdbxe1Ag (button) folded before Flop (didn't bet)



PokerStars Game #59941475774:  Hold'em No Limit ($1/$2) - 2009/07/01 1:36:38 ET
Table 'kq5zaQ+1hLNf8LZfGnbTAA' 6-max Seat #1 is the button
Seat 1: 8srN1dKQePlsv0GyTada+Q ($427.60 in chips)
Seat 2: nXDI8Y/S6POzRwANu3d8hQ ($162 in chips)
Seat 3: /PH6Ffnho4Ysm8S3V/oa+w ($43 in chips)
Seat 4: 3dAbvkxS5NPQTBAbvpinVg ($278.45 in chips)
Seat 5: gnYme0DNFflnMhrdbxe1Ag ($206.35 in chips)
Seat 6: mfy7uGZcqA2PVQqEVbJ7+g ($196.45 in chips)
nXDI8Y/S6POzRwANu3d8hQ: posts small blind $1
/PH6Ffnho4Ysm8S3V/oa+w: posts big blind $2
*** HOLE CARDS ***
3dAbvkxS5NPQTBAbvpinVg: folds
gnYme0DNFflnMhrdbxe1Ag: raises $4 to $6
mfy7uGZcqA2PVQqEVbJ7+g: folds
8srN1dKQePlsv0GyTada+Q: folds
nXDI8Y/S6POzRwANu3d8hQ: raises $12 to $18
/PH6Ffnho4Ysm8S3V/oa+w: folds
gnYme0DNFflnMhrdbxe1Ag: raises $34 to $52
nXDI8Y/S6POzRwANu3d8hQ: folds
gnYme0DNFflnMhrdbxe1Ag collected $38 from pot
gnYme0DNFflnMhrdbxe1Ag: doesn't show hand
*** SUMMARY ***
Total pot $38 | Rake $0
Seat 1: 8srN1dKQePlsv0GyTada+Q (button) folded before Flop (didn't bet)
Seat 2: nXDI8Y/S6POzRwANu3d8hQ (small blind) folded before Flop
Seat 3: /PH6Ffnho4Ysm8S3V/oa+w (big blind) folded before Flop
Seat 4: 3dAbvkxS5NPQTBAbvpinVg folded before Flop (didn't bet)
Seat 5: gnYme0DNFflnMhrdbxe1Ag collected ($38)
Seat 6: mfy7uGZcqA2PVQqEVbJ7+g folded before Flop (didn't bet)



PokerStars Game #59941477884:  Hold'em No Limit ($1/$2) - 2009/07/01 1:36:41 ET
Table 'uJ9juaXXg9yIcSU8amxaXQ' 6-max Seat #5 is the button
Seat 1: JsqOjN/eHz0uYVf/PyUJ6Q ($156.25 in chips)
Seat 2: VvdR9F3I+2yELkfTVvC1dg ($223.10 in chips)
Seat 3: qXDd0ZyMIse0OBu8pxeQ3Q ($246.40 in chips)
Seat 4: zNjJ/y4emmF+vzrCDd+ooA ($223.05 in chips)
Seat 5: YsLQ3BAvgQHWXMAv3Wv6Hg ($200 in chips)
/PH6Ffnho4Ysm8S3V/oa+w joins the table at seat #6
JsqOjN/eHz0uYVf/PyUJ6Q: posts small blind $1
VvdR9F3I+2yELkfTVvC1dg: posts big blind $2
*** HOLE CARDS ***
qXDd0ZyMIse0OBu8pxeQ3Q: folds
zNjJ/y4emmF+vzrCDd+ooA: folds
YsLQ3BAvgQHWXMAv3Wv6Hg: folds
JsqOjN/eHz0uYVf/PyUJ6Q: folds
VvdR9F3I+2yELkfTVvC1dg collected $2 from pot
VvdR9F3I+2yELkfTVvC1dg: doesn't show hand
*** SUMMARY ***
Total pot $2 | Rake $0
Seat 1: JsqOjN/eHz0uYVf/PyUJ6Q (small blind) folded before Flop
Seat 2: VvdR9F3I+2yELkfTVvC1dg (big blind) collected ($2)
Seat 3: qXDd0ZyMIse0OBu8pxeQ3Q folded before Flop (didn't bet)
Seat 4: zNjJ/y4emmF+vzrCDd+ooA folded before Flop (didn't bet)
Seat 5: YsLQ3BAvgQHWXMAv3Wv6Hg (button) folded before Flop (didn't bet)



