PokerStars Game #59938582908:  Hold'em No Limit ($0.25/$0.50) - 2009/07/01 0:18:28 ET
Table 'kgbJRsxfv64KrErDRBAkcw' 6-max Seat #3 is the button
Seat 1: N7O9jUEx2YiQn1+yRYTHmw ($19.50 in chips)
Seat 2: Q+thC23WCv1kJUJtH/+4Jw ($39.80 in chips)
Seat 3: T0Gx/FcQ5VH9u7XaOMX97A ($60.25 in chips)
Seat 4: qanMEqjABjWxC/JgQ/0l7w ($56.95 in chips)
Seat 5: +Pf9jTVizYlIo+woPvptfA ($50 in chips)
Seat 6: DDfYzIrYT0t5R/hAJngtsg ($26.55 in chips)
qanMEqjABjWxC/JgQ/0l7w: posts small blind $0.25
+Pf9jTVizYlIo+woPvptfA: posts big blind $0.50
*** HOLE CARDS ***
DDfYzIrYT0t5R/hAJngtsg: folds
N7O9jUEx2YiQn1+yRYTHmw: calls $0.50
Q+thC23WCv1kJUJtH/+4Jw: folds
T0Gx/FcQ5VH9u7XaOMX97A: folds
qanMEqjABjWxC/JgQ/0l7w: folds
+Pf9jTVizYlIo+woPvptfA: checks
*** FLOP *** [7s 8d Th]
+Pf9jTVizYlIo+woPvptfA: checks
N7O9jUEx2YiQn1+yRYTHmw: checks
*** TURN *** [7s 8d Th] [4d]
+Pf9jTVizYlIo+woPvptfA: checks
N7O9jUEx2YiQn1+yRYTHmw: checks
*** RIVER *** [7s 8d Th 4d] [As]
+Pf9jTVizYlIo+woPvptfA: checks
N7O9jUEx2YiQn1+yRYTHmw: bets $0.50
+Pf9jTVizYlIo+woPvptfA: folds
N7O9jUEx2YiQn1+yRYTHmw collected $1.20 from pot
*** SUMMARY ***
Total pot $1.25 | Rake $0.05
Board [7s 8d Th 4d As]
Seat 1: N7O9jUEx2YiQn1+yRYTHmw collected ($1.20)
Seat 2: Q+thC23WCv1kJUJtH/+4Jw folded before Flop (didn't bet)
Seat 3: T0Gx/FcQ5VH9u7XaOMX97A (button) folded before Flop (didn't bet)
Seat 4: qanMEqjABjWxC/JgQ/0l7w (small blind) folded before Flop
Seat 5: +Pf9jTVizYlIo+woPvptfA (big blind) folded on the River
Seat 6: DDfYzIrYT0t5R/hAJngtsg folded before Flop (didn't bet)



PokerStars Game #59938584688:  Hold'em No Limit ($0.25/$0.50) - 2009/07/01 0:18:31 ET
Table 'E7bWJ45aoFXRpyRv2gw+Ig' 2-max Seat #1 is the button
Seat 1: FRkiRasEGlHUeLrEl+k/nA ($60.85 in chips)
Seat 2: 3Wro85I7472vJ4Wkpneo9A ($119.80 in chips)
FRkiRasEGlHUeLrEl+k/nA: posts small blind $0.25
3Wro85I7472vJ4Wkpneo9A: posts big blind $0.50
*** HOLE CARDS ***
FRkiRasEGlHUeLrEl+k/nA: raises $1 to $1.50
3Wro85I7472vJ4Wkpneo9A: calls $1
*** FLOP *** [4d 7h 2s]
3Wro85I7472vJ4Wkpneo9A: checks
FRkiRasEGlHUeLrEl+k/nA: checks
*** TURN *** [4d 7h 2s] [Th]
3Wro85I7472vJ4Wkpneo9A: checks
FRkiRasEGlHUeLrEl+k/nA: bets $1.50
3Wro85I7472vJ4Wkpneo9A: raises $3.50 to $5
FRkiRasEGlHUeLrEl+k/nA: folds
3Wro85I7472vJ4Wkpneo9A collected $5.75 from pot
3Wro85I7472vJ4Wkpneo9A: doesn't show hand
*** SUMMARY ***
Total pot $6 | Rake $0.25
Board [4d 7h 2s Th]
Seat 1: FRkiRasEGlHUeLrEl+k/nA (button) (small blind) folded on the Turn
Seat 2: 3Wro85I7472vJ4Wkpneo9A (big blind) collected ($5.75)



PokerStars Game #59938585296:  Hold'em No Limit ($0.25/$0.50) - 2009/07/01 0:18:32 ET
Table 'ZYwMb9E6tY50Qm+iNbXRYw' 2-max Seat #1 is the button
Seat 1: DXLfRb8KDZWmrztw2bwtFw ($7.55 in chips)
Seat 2: 16tvT7AYgZ2LgiGFcvFKQg ($27 in chips)
DXLfRb8KDZWmrztw2bwtFw: posts small blind $0.25
16tvT7AYgZ2LgiGFcvFKQg: posts big blind $0.50
*** HOLE CARDS ***
DXLfRb8KDZWmrztw2bwtFw: raises $1.50 to $2
16tvT7AYgZ2LgiGFcvFKQg: calls $1.50
*** FLOP *** [As Js 7s]
16tvT7AYgZ2LgiGFcvFKQg: checks
DXLfRb8KDZWmrztw2bwtFw: bets $5.55 and is all-in
16tvT7AYgZ2LgiGFcvFKQg: calls $5.55
*** TURN *** [As Js 7s] [8d]
*** RIVER *** [As Js 7s 8d] [7h]
*** SHOW DOWN ***
16tvT7AYgZ2LgiGFcvFKQg: shows [6d Jc] (two pair, Jacks and Sevens)
DXLfRb8KDZWmrztw2bwtFw: shows [Kh Kc] (two pair, Kings and Sevens)
DXLfRb8KDZWmrztw2bwtFw collected $14.60 from pot
*** SUMMARY ***
Total pot $15.10 | Rake $0.50
Board [As Js 7s 8d 7h]
Seat 1: DXLfRb8KDZWmrztw2bwtFw (button) (small blind) showed [Kh Kc] and won ($14.60) with two pair, Kings and Sevens
Seat 2: 16tvT7AYgZ2LgiGFcvFKQg (big blind) showed [6d Jc] and lost with two pair, Jacks and Sevens



PokerStars Game #59938586062:  Hold'em No Limit ($0.25/$0.50) - 2009/07/01 0:18:33 ET
Table 'raOT4/ipuZgzjfKHC+jD9g' 2-max Seat #1 is the button
Seat 1: IuwLemwLhc9fvrwBGs0AMA ($12.85 in chips)
Seat 2: Udr5juWSWUgTu1NlRhjMdA ($9.65 in chips)
IuwLemwLhc9fvrwBGs0AMA: posts small blind $0.25
Udr5juWSWUgTu1NlRhjMdA: posts big blind $0.50
*** HOLE CARDS ***
IuwLemwLhc9fvrwBGs0AMA: calls $0.25
Udr5juWSWUgTu1NlRhjMdA: checks
*** FLOP *** [8h As Qc]
Udr5juWSWUgTu1NlRhjMdA: checks
IuwLemwLhc9fvrwBGs0AMA: checks
*** TURN *** [8h As Qc] [Ah]
Udr5juWSWUgTu1NlRhjMdA: checks
IuwLemwLhc9fvrwBGs0AMA: bets $0.50
Udr5juWSWUgTu1NlRhjMdA: folds
IuwLemwLhc9fvrwBGs0AMA collected $0.95 from pot
*** SUMMARY ***
Total pot $1 | Rake $0.05
Board [8h As Qc Ah]
Seat 1: IuwLemwLhc9fvrwBGs0AMA (button) (small blind) collected ($0.95)
Seat 2: Udr5juWSWUgTu1NlRhjMdA (big blind) folded on the Turn



PokerStars Game #59938586526:  Hold'em No Limit ($0.25/$0.50) - 2009/07/01 0:18:34 ET
Table '37qXEp3oe+er5q4CZip9eQ' 6-max Seat #3 is the button
Seat 1: oqOqoO2AyCZenUghCxMDxw ($50 in chips)
Seat 2: g12O9qXTybyo2C0B2bXgjg ($33.25 in chips)
Seat 3: Rt6KgtZ8YaJoTc3FPim00w ($98.15 in chips)
Seat 4: AYb7QG0KzyicbOC0ZROE3Q ($9 in chips)
Seat 5: VOmI0x4dDPnTESZd5B4d1Q ($41.05 in chips)
Seat 6: f7zPpUQp9hHZgqhEvrUWQw ($51.65 in chips)
AYb7QG0KzyicbOC0ZROE3Q: posts small blind $0.25
VOmI0x4dDPnTESZd5B4d1Q: posts big blind $0.50
*** HOLE CARDS ***
f7zPpUQp9hHZgqhEvrUWQw: raises $1.50 to $2
oqOqoO2AyCZenUghCxMDxw: folds
g12O9qXTybyo2C0B2bXgjg: folds
Rt6KgtZ8YaJoTc3FPim00w: folds
AYb7QG0KzyicbOC0ZROE3Q: folds
VOmI0x4dDPnTESZd5B4d1Q: calls $1.50
*** FLOP *** [Kd 3s Ts]
VOmI0x4dDPnTESZd5B4d1Q: checks
f7zPpUQp9hHZgqhEvrUWQw: bets $3
VOmI0x4dDPnTESZd5B4d1Q: calls $3
*** TURN *** [Kd 3s Ts] [6d]
VOmI0x4dDPnTESZd5B4d1Q: checks
f7zPpUQp9hHZgqhEvrUWQw: checks
*** RIVER *** [Kd 3s Ts 6d] [Qd]
VOmI0x4dDPnTESZd5B4d1Q: bets $3
f7zPpUQp9hHZgqhEvrUWQw: calls $3
*** SHOW DOWN ***
VOmI0x4dDPnTESZd5B4d1Q: shows [Kc Jc] (a pair of Kings)
f7zPpUQp9hHZgqhEvrUWQw: shows [Jh Kh] (a pair of Kings)
VOmI0x4dDPnTESZd5B4d1Q collected $7.75 from pot
f7zPpUQp9hHZgqhEvrUWQw collected $7.75 from pot
*** SUMMARY ***
Total pot $16.25 | Rake $0.75
Board [Kd 3s Ts 6d Qd]
Seat 1: oqOqoO2AyCZenUghCxMDxw folded before Flop (didn't bet)
Seat 2: g12O9qXTybyo2C0B2bXgjg folded before Flop (didn't bet)
Seat 3: Rt6KgtZ8YaJoTc3FPim00w (button) folded before Flop (didn't bet)
Seat 4: AYb7QG0KzyicbOC0ZROE3Q (small blind) folded before Flop
Seat 5: VOmI0x4dDPnTESZd5B4d1Q (big blind) showed [Kc Jc] and won ($7.75) with a pair of Kings
Seat 6: f7zPpUQp9hHZgqhEvrUWQw showed [Jh Kh] and won ($7.75) with a pair of Kings



PokerStars Game #59938588288:  Hold'em No Limit ($0.25/$0.50) - 2009/07/01 0:18:37 ET
Table 'mTxf8gPLgffN3Iwfm7Icfg' 2-max Seat #2 is the button
Seat 1: Do9Rlu1R5u/AcRtMTl8SYg ($51.60 in chips)
Seat 2: EMc5LPgVaded4Qc77vm0fw ($110.90 in chips)
EMc5LPgVaded4Qc77vm0fw: posts small blind $0.25
Do9Rlu1R5u/AcRtMTl8SYg: posts big blind $0.50
*** HOLE CARDS ***
EMc5LPgVaded4Qc77vm0fw: folds
Do9Rlu1R5u/AcRtMTl8SYg collected $0.50 from pot
Do9Rlu1R5u/AcRtMTl8SYg: doesn't show hand
*** SUMMARY ***
Total pot $0.50 | Rake $0
Seat 1: Do9Rlu1R5u/AcRtMTl8SYg (big blind) collected ($0.50)
Seat 2: EMc5LPgVaded4Qc77vm0fw (button) (small blind) folded before Flop



PokerStars Game #59938588734:  Hold'em No Limit ($0.25/$0.50) - 2009/07/01 0:18:37 ET
Table '+dXkOAQyS8j9PQZusUTMpg' 2-max Seat #2 is the button
Seat 1: XFa6sBGjP2gxoIvxR3fZIg ($50.30 in chips)
Seat 2: 5IBeOgaApY1Bvzv2P8X4EA ($59.20 in chips)
5IBeOgaApY1Bvzv2P8X4EA: posts small blind $0.25
XFa6sBGjP2gxoIvxR3fZIg: posts big blind $0.50
*** HOLE CARDS ***
XFa6sBGjP2gxoIvxR3fZIg said, "mmm, okay"
5IBeOgaApY1Bvzv2P8X4EA: folds
XFa6sBGjP2gxoIvxR3fZIg collected $0.50 from pot
*** SUMMARY ***
Total pot $0.50 | Rake $0
Seat 1: XFa6sBGjP2gxoIvxR3fZIg (big blind) collected ($0.50)
Seat 2: 5IBeOgaApY1Bvzv2P8X4EA (button) (small blind) folded before Flop



PokerStars Game #59938588448:  Hold'em No Limit ($0.25/$0.50) - 2009/07/01 0:18:37 ET
Table 'hSTs/dUsYLgJQuF2Onp0MQ' 6-max Seat #2 is the button
Seat 2: gSCZnZGMgaRWmRw5txyZIA ($13.65 in chips)
Seat 3: vQOrJuXbLC3UZDVklY9bOA ($18.45 in chips)
Seat 4: L0aIPg7qefDQjdJo3HCVEA ($13.70 in chips)
Seat 5: 686aeHikcJlgKkSuIFdcXQ ($60.75 in chips)
Seat 6: +laPa9P7BjZKKnR0n+OmvA ($9.10 in chips)
vQOrJuXbLC3UZDVklY9bOA: posts small blind $0.25
L0aIPg7qefDQjdJo3HCVEA: posts big blind $0.50
+laPa9P7BjZKKnR0n+OmvA: posts small & big blinds $0.75
*** HOLE CARDS ***
686aeHikcJlgKkSuIFdcXQ: folds
+laPa9P7BjZKKnR0n+OmvA: raises $1.50 to $2
gSCZnZGMgaRWmRw5txyZIA: calls $2
vQOrJuXbLC3UZDVklY9bOA: calls $1.75
L0aIPg7qefDQjdJo3HCVEA: folds
*** FLOP *** [6c As Qh]
vQOrJuXbLC3UZDVklY9bOA: checks
+laPa9P7BjZKKnR0n+OmvA: checks
Donj3X7gYzeS5pAl7s9f+Q joins the table at seat #1
gSCZnZGMgaRWmRw5txyZIA: bets $1.50
vQOrJuXbLC3UZDVklY9bOA: calls $1.50
+laPa9P7BjZKKnR0n+OmvA: folds
*** TURN *** [6c As Qh] [9d]
vQOrJuXbLC3UZDVklY9bOA: checks
gSCZnZGMgaRWmRw5txyZIA: bets $2.50
vQOrJuXbLC3UZDVklY9bOA: raises $12.45 to $14.95 and is all-in
gSCZnZGMgaRWmRw5txyZIA: folds
vQOrJuXbLC3UZDVklY9bOA collected $14.05 from pot
*** SUMMARY ***
Total pot $14.75 | Rake $0.70
Board [6c As Qh 9d]
Seat 2: gSCZnZGMgaRWmRw5txyZIA (button) folded on the Turn
Seat 3: vQOrJuXbLC3UZDVklY9bOA (small blind) collected ($14.05)
Seat 4: L0aIPg7qefDQjdJo3HCVEA (big blind) folded before Flop
Seat 5: 686aeHikcJlgKkSuIFdcXQ folded before Flop (didn't bet)
Seat 6: +laPa9P7BjZKKnR0n+OmvA folded on the Flop



PokerStars Game #59938590106:  Hold'em No Limit ($0.25/$0.50) - 2009/07/01 0:18:39 ET
Table 'm95HVfesC/VPgfGEjPuaIA' 2-max Seat #1 is the button
Seat 1: Fp/oksNpipCrD2MJ2pH20g ($13.90 in chips)
Seat 2: Ag6DvxX4vbRheqsv2zXKTQ ($30.30 in chips)
Fp/oksNpipCrD2MJ2pH20g: posts small blind $0.25
Ag6DvxX4vbRheqsv2zXKTQ: posts big blind $0.50
*** HOLE CARDS ***
Fp/oksNpipCrD2MJ2pH20g: raises $0.50 to $1
Ag6DvxX4vbRheqsv2zXKTQ: folds
Fp/oksNpipCrD2MJ2pH20g collected $1 from pot
Fp/oksNpipCrD2MJ2pH20g: doesn't show hand
*** SUMMARY ***
Total pot $1 | Rake $0
Seat 1: Fp/oksNpipCrD2MJ2pH20g (button) (small blind) collected ($1)
Seat 2: Ag6DvxX4vbRheqsv2zXKTQ (big blind) folded before Flop



PokerStars Game #59938591482:  Hold'em No Limit ($0.25/$0.50) - 2009/07/01 0:18:41 ET
Table 'c/CRn+68J3Y8KxD5g1ek2Q' 2-max Seat #2 is the button
Seat 1: 46qCyJ6evTkHo9al5sBMNA ($273.80 in chips)
Seat 2: BypVLsYQt3ePFm2xQL/dOA ($109.40 in chips)
BypVLsYQt3ePFm2xQL/dOA: posts small blind $0.25
46qCyJ6evTkHo9al5sBMNA: posts big blind $0.50
*** HOLE CARDS ***
BypVLsYQt3ePFm2xQL/dOA: raises $1 to $1.50
46qCyJ6evTkHo9al5sBMNA: folds
BypVLsYQt3ePFm2xQL/dOA collected $1 from pot
BypVLsYQt3ePFm2xQL/dOA: doesn't show hand
*** SUMMARY ***
Total pot $1 | Rake $0
Seat 1: 46qCyJ6evTkHo9al5sBMNA (big blind) folded before Flop
Seat 2: BypVLsYQt3ePFm2xQL/dOA (button) (small blind) collected ($1)



PokerStars Game #59938592454:  Hold'em No Limit ($0.25/$0.50) - 2009/07/01 0:18:43 ET
Table 'mTxf8gPLgffN3Iwfm7Icfg' 2-max Seat #1 is the button
Seat 1: Do9Rlu1R5u/AcRtMTl8SYg ($51.85 in chips)
Seat 2: EMc5LPgVaded4Qc77vm0fw ($110.65 in chips)
Do9Rlu1R5u/AcRtMTl8SYg: posts small blind $0.25
EMc5LPgVaded4Qc77vm0fw: posts big blind $0.50
*** HOLE CARDS ***
Do9Rlu1R5u/AcRtMTl8SYg: raises $1 to $1.50
EMc5LPgVaded4Qc77vm0fw: raises $3 to $4.50
Do9Rlu1R5u/AcRtMTl8SYg: folds
EMc5LPgVaded4Qc77vm0fw collected $3 from pot
EMc5LPgVaded4Qc77vm0fw: doesn't show hand
*** SUMMARY ***
Total pot $3 | Rake $0
Seat 1: Do9Rlu1R5u/AcRtMTl8SYg (button) (small blind) folded before Flop
Seat 2: EMc5LPgVaded4Qc77vm0fw (big blind) collected ($3)



PokerStars Game #59938594214:  Hold'em No Limit ($0.25/$0.50) - 2009/07/01 0:18:45 ET
Table '+dXkOAQyS8j9PQZusUTMpg' 2-max Seat #1 is the button
Seat 1: XFa6sBGjP2gxoIvxR3fZIg ($50.55 in chips)
Seat 2: 5IBeOgaApY1Bvzv2P8X4EA ($58.95 in chips)
XFa6sBGjP2gxoIvxR3fZIg: posts small blind $0.25
5IBeOgaApY1Bvzv2P8X4EA: posts big blind $0.50
*** HOLE CARDS ***
XFa6sBGjP2gxoIvxR3fZIg: raises $1 to $1.50
5IBeOgaApY1Bvzv2P8X4EA: folds
XFa6sBGjP2gxoIvxR3fZIg collected $1 from pot
*** SUMMARY ***
Total pot $1 | Rake $0
Seat 1: XFa6sBGjP2gxoIvxR3fZIg (button) (small blind) collected ($1)
Seat 2: 5IBeOgaApY1Bvzv2P8X4EA (big blind) folded before Flop



PokerStars Game #59938594994:  Hold'em No Limit ($0.25/$0.50) - 2009/07/01 0:18:46 ET
Table 'IeNZOZQ4T6oiaHqFeo6yIA' 2-max Seat #1 is the button
Seat 1: ndd1nfncBkWNitBnsfCoVQ ($62.45 in chips)
Seat 2: A91IUl5JaZROhtfCtnnwYw ($25.10 in chips)
ndd1nfncBkWNitBnsfCoVQ: posts small blind $0.25
A91IUl5JaZROhtfCtnnwYw: posts big blind $0.50
*** HOLE CARDS ***
ndd1nfncBkWNitBnsfCoVQ: raises $1 to $1.50
A91IUl5JaZROhtfCtnnwYw: calls $1
*** FLOP *** [Qh 8s 8c]
A91IUl5JaZROhtfCtnnwYw: checks
ndd1nfncBkWNitBnsfCoVQ: bets $2
A91IUl5JaZROhtfCtnnwYw: folds
ndd1nfncBkWNitBnsfCoVQ collected $2.85 from pot
ndd1nfncBkWNitBnsfCoVQ: doesn't show hand
*** SUMMARY ***
Total pot $3 | Rake $0.15
Board [Qh 8s 8c]
Seat 1: ndd1nfncBkWNitBnsfCoVQ (button) (small blind) collected ($2.85)
Seat 2: A91IUl5JaZROhtfCtnnwYw (big blind) folded on the Flop



PokerStars Game #59938596056:  Hold'em No Limit ($0.25/$0.50) - 2009/07/01 0:18:48 ET
Table 'm95HVfesC/VPgfGEjPuaIA' 2-max Seat #2 is the button
Seat 1: Fp/oksNpipCrD2MJ2pH20g ($14.40 in chips)
Seat 2: Ag6DvxX4vbRheqsv2zXKTQ ($29.80 in chips)
Ag6DvxX4vbRheqsv2zXKTQ: posts small blind $0.25
Fp/oksNpipCrD2MJ2pH20g: posts big blind $0.50
*** HOLE CARDS ***
Ag6DvxX4vbRheqsv2zXKTQ: folds
Fp/oksNpipCrD2MJ2pH20g collected $0.50 from pot
Fp/oksNpipCrD2MJ2pH20g: doesn't show hand
*** SUMMARY ***
Total pot $0.50 | Rake $0
Seat 1: Fp/oksNpipCrD2MJ2pH20g (big blind) collected ($0.50)
Seat 2: Ag6DvxX4vbRheqsv2zXKTQ (button) (small blind) folded before Flop



PokerStars Game #59938596512:  Hold'em No Limit ($0.25/$0.50) - 2009/07/01 0:18:48 ET
Table 'T/PgNWqVyY6lkldcBVXYJQ' 6-max Seat #5 is the button
Seat 1: +Pf9jTVizYlIo+woPvptfA ($54.50 in chips)
Seat 2: oZAeY5rVqNGgt8yyQ0pxbA ($22.05 in chips)
Seat 3: L3OcNO1bgdqDI46j67KQPQ ($56.05 in chips)
Seat 4: jxMvxeUUL9UU0V6wVU+Iyw ($11.20 in chips)
Seat 5: vVQBckETtigfb5mAcyK0OA ($60.25 in chips)
Seat 6: cDzbog6kwmJp+LBeBq+iMQ ($15.10 in chips)
cDzbog6kwmJp+LBeBq+iMQ: posts small blind $0.25
+Pf9jTVizYlIo+woPvptfA: posts big blind $0.50
*** HOLE CARDS ***
oZAeY5rVqNGgt8yyQ0pxbA: raises $1.50 to $2
L3OcNO1bgdqDI46j67KQPQ: folds
vVQBckETtigfb5mAcyK0OA said, "BUFFALO IS GROSS"
jxMvxeUUL9UU0V6wVU+Iyw said, "We should be playing at Niagara instead of this ..."
jxMvxeUUL9UU0V6wVU+Iyw: folds
vVQBckETtigfb5mAcyK0OA: folds
cDzbog6kwmJp+LBeBq+iMQ said, "haha"
cDzbog6kwmJp+LBeBq+iMQ said, "agreed"
vVQBckETtigfb5mAcyK0OA said, "NOTHING BUT CRACK HEADS"
cDzbog6kwmJp+LBeBq+iMQ: calls $1.75
cDzbog6kwmJp+LBeBq+iMQ said, "i just lost $1400"
+Pf9jTVizYlIo+woPvptfA: folds
*** FLOP *** [Jd Ts 8s]
cDzbog6kwmJp+LBeBq+iMQ said, "so im a little tilty"
jxMvxeUUL9UU0V6wVU+Iyw said, "Hey, when was the last time you were in Buffalo?"
vVQBckETtigfb5mAcyK0OA said, "OUCH"
cDzbog6kwmJp+LBeBq+iMQ said, "figured id sit down at a smaller table for acouple min."
cDzbog6kwmJp+LBeBq+iMQ: checks
oZAeY5rVqNGgt8yyQ0pxbA: bets $3.50
vVQBckETtigfb5mAcyK0OA said, "HOW DID U LOSE 1400"
jxMvxeUUL9UU0V6wVU+Iyw said, "is o.k. im down $1100 tonight too."
cDzbog6kwmJp+LBeBq+iMQ: folds
oZAeY5rVqNGgt8yyQ0pxbA collected $4.30 from pot
*** SUMMARY ***
Total pot $4.50 | Rake $0.20
Board [Jd Ts 8s]
Seat 1: +Pf9jTVizYlIo+woPvptfA (big blind) folded before Flop
Seat 2: oZAeY5rVqNGgt8yyQ0pxbA collected ($4.30)
Seat 3: L3OcNO1bgdqDI46j67KQPQ folded before Flop (didn't bet)
Seat 4: jxMvxeUUL9UU0V6wVU+Iyw folded before Flop (didn't bet)
Seat 5: vVQBckETtigfb5mAcyK0OA (button) folded before Flop (didn't bet)
Seat 6: cDzbog6kwmJp+LBeBq+iMQ (small blind) folded on the Flop



PokerStars Game #59938596290:  Hold'em No Limit ($0.25/$0.50) - 2009/07/01 0:18:48 ET
Table '3FhG0gl3kMX3wBEEqj+wnQ' 9-max Seat #7 is the button
Seat 1: e0J9pdCNUDTCG031RnXqLA ($10.75 in chips)
Seat 2: 4dl3YNqZ6Houm2jZAzDmRg ($24.50 in chips)
Seat 4: bz4LMfV0GGl/MJ/ABXuPmg ($26.20 in chips)
Seat 5: XNMDwbXt/Q4jM99AXnbJDw ($55.55 in chips)
Seat 6: 5JJVDlaiMnB004o/RqbZZQ ($24.50 in chips)
Seat 7: mSD1pginDsyHG5PDfqzphw ($10 in chips)
Seat 8: j3K/Jujr7PY4ZM2RZvlH6A ($40.85 in chips)
Seat 9: L5e2lrPLQm1Pqx30IIZ/Fw ($10 in chips)
j3K/Jujr7PY4ZM2RZvlH6A: posts small blind $0.25
L5e2lrPLQm1Pqx30IIZ/Fw: posts big blind $0.50
HZkVla4kK2SI42CVrPZ/ig: sits out
*** HOLE CARDS ***
e0J9pdCNUDTCG031RnXqLA: calls $0.50
4dl3YNqZ6Houm2jZAzDmRg: folds
bz4LMfV0GGl/MJ/ABXuPmg: raises $1.50 to $2
XNMDwbXt/Q4jM99AXnbJDw: folds
5JJVDlaiMnB004o/RqbZZQ: folds
mSD1pginDsyHG5PDfqzphw: folds
j3K/Jujr7PY4ZM2RZvlH6A: raises $4 to $6
L5e2lrPLQm1Pqx30IIZ/Fw: folds
e0J9pdCNUDTCG031RnXqLA: folds
bz4LMfV0GGl/MJ/ABXuPmg: folds
j3K/Jujr7PY4ZM2RZvlH6A collected $5 from pot
j3K/Jujr7PY4ZM2RZvlH6A: doesn't show hand
*** SUMMARY ***
Total pot $5 | Rake $0
Seat 1: e0J9pdCNUDTCG031RnXqLA folded before Flop
Seat 2: 4dl3YNqZ6Houm2jZAzDmRg folded before Flop (didn't bet)
Seat 4: bz4LMfV0GGl/MJ/ABXuPmg folded before Flop
Seat 5: XNMDwbXt/Q4jM99AXnbJDw folded before Flop (didn't bet)
Seat 6: 5JJVDlaiMnB004o/RqbZZQ folded before Flop (didn't bet)
Seat 7: mSD1pginDsyHG5PDfqzphw (button) folded before Flop (didn't bet)
Seat 8: j3K/Jujr7PY4ZM2RZvlH6A (small blind) collected ($5)
Seat 9: L5e2lrPLQm1Pqx30IIZ/Fw (big blind) folded before Flop



PokerStars Game #59938597010:  Hold'em No Limit ($0.25/$0.50) - 2009/07/01 0:18:49 ET
Table 'QOgaEqMcJ73pcUMMxoisUg' 6-max Seat #3 is the button
Seat 1: RFefXIDyFvNtJLq+CloCzA ($40.95 in chips)
Seat 2: Im2p1Nt83UKSqv5c9frm4Q ($50 in chips)
Seat 3: wUZNozoIDYf+16hp4nn6dw ($45.30 in chips)
Seat 4: zAcsDhG/T128Vn7XGVSgKg ($53.90 in chips)
Seat 6: s83dnhZ6VC53vY0/f6OV/g ($49.30 in chips)
zAcsDhG/T128Vn7XGVSgKg: posts small blind $0.25
s83dnhZ6VC53vY0/f6OV/g: posts big blind $0.50
*** HOLE CARDS ***
RFefXIDyFvNtJLq+CloCzA: folds
Im2p1Nt83UKSqv5c9frm4Q: folds
wUZNozoIDYf+16hp4nn6dw: calls $0.50
zAcsDhG/T128Vn7XGVSgKg: folds
s83dnhZ6VC53vY0/f6OV/g: checks
*** FLOP *** [Jc As 9h]
s83dnhZ6VC53vY0/f6OV/g: checks
wUZNozoIDYf+16hp4nn6dw: bets $1.50
s83dnhZ6VC53vY0/f6OV/g: calls $1.50
*** TURN *** [Jc As 9h] [6s]
s83dnhZ6VC53vY0/f6OV/g: checks
wUZNozoIDYf+16hp4nn6dw: bets $2
s83dnhZ6VC53vY0/f6OV/g: calls $2
*** RIVER *** [Jc As 9h 6s] [3c]
s83dnhZ6VC53vY0/f6OV/g: checks
wUZNozoIDYf+16hp4nn6dw: bets $3
s83dnhZ6VC53vY0/f6OV/g: calls $3
*** SHOW DOWN ***
wUZNozoIDYf+16hp4nn6dw: shows [Js 7h] (a pair of Jacks)
s83dnhZ6VC53vY0/f6OV/g: mucks hand
wUZNozoIDYf+16hp4nn6dw collected $13.60 from pot
*** SUMMARY ***
Total pot $14.25 | Rake $0.65
Board [Jc As 9h 6s 3c]
Seat 1: RFefXIDyFvNtJLq+CloCzA folded before Flop (didn't bet)
Seat 2: Im2p1Nt83UKSqv5c9frm4Q folded before Flop (didn't bet)
Seat 3: wUZNozoIDYf+16hp4nn6dw (button) showed [Js 7h] and won ($13.60) with a pair of Jacks
Seat 4: zAcsDhG/T128Vn7XGVSgKg (small blind) folded before Flop
Seat 6: s83dnhZ6VC53vY0/f6OV/g (big blind) mucked



PokerStars Game #59938597688:  Hold'em No Limit ($0.25/$0.50) - 2009/07/01 0:18:50 ET
Table 'c/CRn+68J3Y8KxD5g1ek2Q' 2-max Seat #1 is the button
Seat 1: 46qCyJ6evTkHo9al5sBMNA ($273.30 in chips)
Seat 2: BypVLsYQt3ePFm2xQL/dOA ($109.90 in chips)
46qCyJ6evTkHo9al5sBMNA: posts small blind $0.25
BypVLsYQt3ePFm2xQL/dOA: posts big blind $0.50
*** HOLE CARDS ***
46qCyJ6evTkHo9al5sBMNA: folds
BypVLsYQt3ePFm2xQL/dOA collected $0.50 from pot
BypVLsYQt3ePFm2xQL/dOA: doesn't show hand
*** SUMMARY ***
Total pot $0.50 | Rake $0
Seat 1: 46qCyJ6evTkHo9al5sBMNA (button) (small blind) folded before Flop
Seat 2: BypVLsYQt3ePFm2xQL/dOA (big blind) collected ($0.50)



PokerStars Game #59938598398:  Hold'em No Limit ($0.25/$0.50) - 2009/07/01 0:18:51 ET
Table 'ZYwMb9E6tY50Qm+iNbXRYw' 2-max Seat #2 is the button
Seat 1: DXLfRb8KDZWmrztw2bwtFw ($14.60 in chips)
Seat 2: 16tvT7AYgZ2LgiGFcvFKQg ($19.45 in chips)
16tvT7AYgZ2LgiGFcvFKQg: posts small blind $0.25
DXLfRb8KDZWmrztw2bwtFw: posts big blind $0.50
*** HOLE CARDS ***
16tvT7AYgZ2LgiGFcvFKQg: raises $0.50 to $1
DXLfRb8KDZWmrztw2bwtFw: calls $0.50
*** FLOP *** [4s Td As]
DXLfRb8KDZWmrztw2bwtFw: checks
16tvT7AYgZ2LgiGFcvFKQg: bets $0.50
DXLfRb8KDZWmrztw2bwtFw: folds
16tvT7AYgZ2LgiGFcvFKQg collected $1.90 from pot
*** SUMMARY ***
Total pot $2 | Rake $0.10
Board [4s Td As]
Seat 1: DXLfRb8KDZWmrztw2bwtFw (big blind) folded on the Flop
Seat 2: 16tvT7AYgZ2LgiGFcvFKQg (button) (small blind) collected ($1.90)



PokerStars Game #59938598738:  Hold'em No Limit ($0.25/$0.50) - 2009/07/01 0:18:51 ET
Table 'ibNfFy0bCzuBaUORla0aGw' 9-max Seat #8 is the button
Seat 2: 90Wb75h3W1BRpbqVnuk8gw ($54.10 in chips)
Seat 3: dDaHs3X8+fe3bIkRU0cbrw ($27.25 in chips)
Seat 4: YBN054X4blmis+B2bBlC0g ($18.55 in chips)
Seat 5: FRv75HO8CUsRZ1byEz06mQ ($10.10 in chips)
Seat 6: BmYrv3ec2k5d6pQq6iNaZw ($67.85 in chips)
Seat 7: 9r7ZoBbAJj5IeyZ0q9BdzA ($14 in chips)
Seat 8: xUrN9TWLq4m5V+OXY7KUUA ($50 in chips)
Seat 9: WpvT3OUSiZlpvs+mPXFqtQ ($10.50 in chips)
WpvT3OUSiZlpvs+mPXFqtQ: posts small blind $0.25
90Wb75h3W1BRpbqVnuk8gw: posts big blind $0.50
9r7ZoBbAJj5IeyZ0q9BdzA: posts big blind $0.50
*** HOLE CARDS ***
dDaHs3X8+fe3bIkRU0cbrw: folds
YBN054X4blmis+B2bBlC0g: folds
FRv75HO8CUsRZ1byEz06mQ: folds
BmYrv3ec2k5d6pQq6iNaZw: folds
9r7ZoBbAJj5IeyZ0q9BdzA: checks
xUrN9TWLq4m5V+OXY7KUUA: folds
WpvT3OUSiZlpvs+mPXFqtQ: folds
90Wb75h3W1BRpbqVnuk8gw: checks
*** FLOP *** [6s 2c Kh]
90Wb75h3W1BRpbqVnuk8gw: checks
9r7ZoBbAJj5IeyZ0q9BdzA: checks
*** TURN *** [6s 2c Kh] [6d]
90Wb75h3W1BRpbqVnuk8gw: checks
9r7ZoBbAJj5IeyZ0q9BdzA: checks
*** RIVER *** [6s 2c Kh 6d] [Ad]
90Wb75h3W1BRpbqVnuk8gw: checks
9r7ZoBbAJj5IeyZ0q9BdzA: checks
*** SHOW DOWN ***
90Wb75h3W1BRpbqVnuk8gw: shows [Kd Js] (two pair, Kings and Sixes)
9r7ZoBbAJj5IeyZ0q9BdzA: mucks hand
90Wb75h3W1BRpbqVnuk8gw collected $1.20 from pot
*** SUMMARY ***
Total pot $1.25 | Rake $0.05
Board [6s 2c Kh 6d Ad]
Seat 2: 90Wb75h3W1BRpbqVnuk8gw (big blind) showed [Kd Js] and won ($1.20) with two pair, Kings and Sixes
Seat 3: dDaHs3X8+fe3bIkRU0cbrw folded before Flop (didn't bet)
Seat 4: YBN054X4blmis+B2bBlC0g folded before Flop (didn't bet)
Seat 5: FRv75HO8CUsRZ1byEz06mQ folded before Flop (didn't bet)
Seat 6: BmYrv3ec2k5d6pQq6iNaZw folded before Flop (didn't bet)
Seat 7: 9r7ZoBbAJj5IeyZ0q9BdzA mucked
Seat 8: xUrN9TWLq4m5V+OXY7KUUA (button) folded before Flop (didn't bet)
Seat 9: WpvT3OUSiZlpvs+mPXFqtQ (small blind) folded before Flop



PokerStars Game #59938600926:  Hold'em No Limit ($0.25/$0.50) - 2009/07/01 0:18:54 ET
Table 'E7bWJ45aoFXRpyRv2gw+Ig' 2-max Seat #2 is the button
Seat 1: FRkiRasEGlHUeLrEl+k/nA ($57.85 in chips)
Seat 2: 3Wro85I7472vJ4Wkpneo9A ($122.55 in chips)
3Wro85I7472vJ4Wkpneo9A: posts small blind $0.25
FRkiRasEGlHUeLrEl+k/nA: posts big blind $0.50
*** HOLE CARDS ***
3Wro85I7472vJ4Wkpneo9A: raises $1 to $1.50
FRkiRasEGlHUeLrEl+k/nA: raises $4 to $5.50
3Wro85I7472vJ4Wkpneo9A: calls $4
*** FLOP *** [8h 2c Td]
FRkiRasEGlHUeLrEl+k/nA: bets $2.50
3Wro85I7472vJ4Wkpneo9A: calls $2.50
*** TURN *** [8h 2c Td] [Jc]
FRkiRasEGlHUeLrEl+k/nA: bets $10
3Wro85I7472vJ4Wkpneo9A: folds
FRkiRasEGlHUeLrEl+k/nA collected $15.50 from pot
FRkiRasEGlHUeLrEl+k/nA: doesn't show hand
*** SUMMARY ***
Total pot $16 | Rake $0.50
Board [8h 2c Td Jc]
Seat 1: FRkiRasEGlHUeLrEl+k/nA (big blind) collected ($15.50)
Seat 2: 3Wro85I7472vJ4Wkpneo9A (button) (small blind) folded on the Turn



PokerStars Game #59938600380:  Hold'em No Limit ($0.25/$0.50) - 2009/07/01 0:18:54 ET
Table 'mTxf8gPLgffN3Iwfm7Icfg' 2-max Seat #2 is the button
Seat 1: Do9Rlu1R5u/AcRtMTl8SYg ($50.35 in chips)
Seat 2: EMc5LPgVaded4Qc77vm0fw ($112.15 in chips)
EMc5LPgVaded4Qc77vm0fw: posts small blind $0.25
Do9Rlu1R5u/AcRtMTl8SYg: posts big blind $0.50
*** HOLE CARDS ***
EMc5LPgVaded4Qc77vm0fw: raises $1.50 to $2
Do9Rlu1R5u/AcRtMTl8SYg: folds
EMc5LPgVaded4Qc77vm0fw collected $1 from pot
EMc5LPgVaded4Qc77vm0fw: doesn't show hand
*** SUMMARY ***
Total pot $1 | Rake $0
Seat 1: Do9Rlu1R5u/AcRtMTl8SYg (big blind) folded before Flop
Seat 2: EMc5LPgVaded4Qc77vm0fw (button) (small blind) collected ($1)



PokerStars Game #59938600314:  Hold'em No Limit ($0.25/$0.50) - 2009/07/01 0:18:54 ET
Table 'm95HVfesC/VPgfGEjPuaIA' 2-max Seat #1 is the button
Seat 1: Fp/oksNpipCrD2MJ2pH20g ($14.65 in chips)
Seat 2: Ag6DvxX4vbRheqsv2zXKTQ ($29.55 in chips)
Fp/oksNpipCrD2MJ2pH20g: posts small blind $0.25
Ag6DvxX4vbRheqsv2zXKTQ: posts big blind $0.50
*** HOLE CARDS ***
Fp/oksNpipCrD2MJ2pH20g: raises $1 to $1.50
Ag6DvxX4vbRheqsv2zXKTQ: folds
Fp/oksNpipCrD2MJ2pH20g collected $1 from pot
Fp/oksNpipCrD2MJ2pH20g: doesn't show hand
*** SUMMARY ***
Total pot $1 | Rake $0
Seat 1: Fp/oksNpipCrD2MJ2pH20g (button) (small blind) collected ($1)
Seat 2: Ag6DvxX4vbRheqsv2zXKTQ (big blind) folded before Flop



PokerStars Game #59938602104:  Hold'em No Limit ($0.25/$0.50) - 2009/07/01 0:18:56 ET
Table 'c/CRn+68J3Y8KxD5g1ek2Q' 2-max Seat #2 is the button
Seat 1: 46qCyJ6evTkHo9al5sBMNA ($273.05 in chips)
Seat 2: BypVLsYQt3ePFm2xQL/dOA ($110.15 in chips)
BypVLsYQt3ePFm2xQL/dOA: posts small blind $0.25
46qCyJ6evTkHo9al5sBMNA: posts big blind $0.50
*** HOLE CARDS ***
BypVLsYQt3ePFm2xQL/dOA: raises $0.50 to $1
46qCyJ6evTkHo9al5sBMNA: folds
BypVLsYQt3ePFm2xQL/dOA collected $1 from pot
BypVLsYQt3ePFm2xQL/dOA: doesn't show hand
*** SUMMARY ***
Total pot $1 | Rake $0
Seat 1: 46qCyJ6evTkHo9al5sBMNA (big blind) folded before Flop
Seat 2: BypVLsYQt3ePFm2xQL/dOA (button) (small blind) collected ($1)



PokerStars Game #59938601708:  Hold'em No Limit ($0.25/$0.50) - 2009/07/01 0:18:56 ET
Table '+dXkOAQyS8j9PQZusUTMpg' 2-max Seat #2 is the button
Seat 1: XFa6sBGjP2gxoIvxR3fZIg ($51.05 in chips)
Seat 2: 5IBeOgaApY1Bvzv2P8X4EA ($58.45 in chips)
5IBeOgaApY1Bvzv2P8X4EA: posts small blind $0.25
XFa6sBGjP2gxoIvxR3fZIg: posts big blind $0.50
*** HOLE CARDS ***
5IBeOgaApY1Bvzv2P8X4EA said, "i didnt like your answer"
5IBeOgaApY1Bvzv2P8X4EA said, ":S"
5IBeOgaApY1Bvzv2P8X4EA: calls $0.25
XFa6sBGjP2gxoIvxR3fZIg: checks
*** FLOP *** [5h Ac 7s]
XFa6sBGjP2gxoIvxR3fZIg said, "hahhah, ok"
XFa6sBGjP2gxoIvxR3fZIg: checks
5IBeOgaApY1Bvzv2P8X4EA: checks
*** TURN *** [5h Ac 7s] [3h]
5IBeOgaApY1Bvzv2P8X4EA said, ":D"
XFa6sBGjP2gxoIvxR3fZIg: checks
5IBeOgaApY1Bvzv2P8X4EA: checks
*** RIVER *** [5h Ac 7s 3h] [Td]
XFa6sBGjP2gxoIvxR3fZIg: bets $0.50
5IBeOgaApY1Bvzv2P8X4EA: calls $0.50
*** SHOW DOWN ***
XFa6sBGjP2gxoIvxR3fZIg: shows [6h Ts] (a pair of Tens)
5IBeOgaApY1Bvzv2P8X4EA: mucks hand
XFa6sBGjP2gxoIvxR3fZIg collected $1.95 from pot
*** SUMMARY ***
Total pot $2 | Rake $0.05
Board [5h Ac 7s 3h Td]
Seat 1: XFa6sBGjP2gxoIvxR3fZIg (big blind) showed [6h Ts] and won ($1.95) with a pair of Tens
Seat 2: 5IBeOgaApY1Bvzv2P8X4EA (button) (small blind) mucked



PokerStars Game #59938602758:  Hold'em No Limit ($0.25/$0.50) - 2009/07/01 0:18:57 ET
Table 'raOT4/ipuZgzjfKHC+jD9g' 2-max Seat #2 is the button
Seat 1: IuwLemwLhc9fvrwBGs0AMA ($13.30 in chips)
Seat 2: Udr5juWSWUgTu1NlRhjMdA ($9.15 in chips)
Udr5juWSWUgTu1NlRhjMdA: posts small blind $0.25
IuwLemwLhc9fvrwBGs0AMA: posts big blind $0.50
*** HOLE CARDS ***
Udr5juWSWUgTu1NlRhjMdA: calls $0.25
IuwLemwLhc9fvrwBGs0AMA: checks
*** FLOP *** [8s 3c Kh]
IuwLemwLhc9fvrwBGs0AMA: checks
Udr5juWSWUgTu1NlRhjMdA: bets $1
IuwLemwLhc9fvrwBGs0AMA: folds
Udr5juWSWUgTu1NlRhjMdA collected $0.95 from pot
Udr5juWSWUgTu1NlRhjMdA: doesn't show hand
*** SUMMARY ***
Total pot $1 | Rake $0.05
Board [8s 3c Kh]
Seat 1: IuwLemwLhc9fvrwBGs0AMA (big blind) folded on the Flop
Seat 2: Udr5juWSWUgTu1NlRhjMdA (button) (small blind) collected ($0.95)



PokerStars Game #59938603232:  Hold'em No Limit ($0.25/$0.50) - 2009/07/01 0:18:58 ET
Table 'MJxeZCzYELxiIsyUZyT0jw' 6-max Seat #6 is the button
Seat 1: iKPos8JI094Tomq4tDSgnQ ($34.50 in chips)
Seat 2: r6H1GiZ6QIpMTDhyodKuRQ ($62.30 in chips)
Seat 3: JQZew0FjzS19kTjeNtrE+A ($50 in chips)
Seat 4: lP7Q6pewz4C2RsAfKsjdWw ($28.95 in chips)
Seat 5: 3jvoOXNtXE90w2BdfNZwZQ ($50 in chips)
Seat 6: TTx3CHxyi0SObcHyMJRp5w ($50.50 in chips)
iKPos8JI094Tomq4tDSgnQ: posts small blind $0.25
r6H1GiZ6QIpMTDhyodKuRQ: posts big blind $0.50
*** HOLE CARDS ***
JQZew0FjzS19kTjeNtrE+A: folds
lP7Q6pewz4C2RsAfKsjdWw: calls $0.50
3jvoOXNtXE90w2BdfNZwZQ: folds
TTx3CHxyi0SObcHyMJRp5w: folds
iKPos8JI094Tomq4tDSgnQ: raises $0.50 to $1
r6H1GiZ6QIpMTDhyodKuRQ: calls $0.50
lP7Q6pewz4C2RsAfKsjdWw: calls $0.50
*** FLOP *** [9d 5d 4d]
iKPos8JI094Tomq4tDSgnQ: checks
r6H1GiZ6QIpMTDhyodKuRQ: bets $2
lP7Q6pewz4C2RsAfKsjdWw: folds
iKPos8JI094Tomq4tDSgnQ: folds
r6H1GiZ6QIpMTDhyodKuRQ collected $2.85 from pot
*** SUMMARY ***
Total pot $3 | Rake $0.15
Board [9d 5d 4d]
Seat 1: iKPos8JI094Tomq4tDSgnQ (small blind) folded on the Flop
Seat 2: r6H1GiZ6QIpMTDhyodKuRQ (big blind) collected ($2.85)
Seat 3: JQZew0FjzS19kTjeNtrE+A folded before Flop (didn't bet)
Seat 4: lP7Q6pewz4C2RsAfKsjdWw folded on the Flop
Seat 5: 3jvoOXNtXE90w2BdfNZwZQ folded before Flop (didn't bet)
Seat 6: TTx3CHxyi0SObcHyMJRp5w (button) folded before Flop (didn't bet)



PokerStars Game #59938603136:  Hold'em No Limit ($0.25/$0.50) - 2009/07/01 0:18:58 ET
Table 'lSisgp6H7Fg1hH5VfjEjYQ' 9-max Seat #7 is the button
Seat 1: pEW8B6uXbdR47kfljMQ3+Q ($38.95 in chips)
Seat 2: UrcnkQOiLVk8BlKDPJSy7Q ($51.10 in chips)
Seat 3: aTkyjTh3w5YLWiIERupZOA ($37.75 in chips)
Seat 4: nvw9yQKhJT56lA9k+TLdhw ($11.25 in chips)
Seat 5: mSD1pginDsyHG5PDfqzphw ($10 in chips)
Seat 6: +k7T5ocke8UwavtgUHm+Cg ($26.45 in chips)
Seat 7: dGw5MBstXyXhWHHVFOWOFA ($43 in chips)
Seat 8: a4JDWmpFQkL10XfAyuF51A ($26 in chips)
Seat 9: 5JJVDlaiMnB004o/RqbZZQ ($40.80 in chips)
a4JDWmpFQkL10XfAyuF51A: posts small blind $0.25
5JJVDlaiMnB004o/RqbZZQ: posts big blind $0.50
*** HOLE CARDS ***
pEW8B6uXbdR47kfljMQ3+Q: folds
UrcnkQOiLVk8BlKDPJSy7Q: folds
aTkyjTh3w5YLWiIERupZOA: folds
nvw9yQKhJT56lA9k+TLdhw: folds
mSD1pginDsyHG5PDfqzphw: folds
+k7T5ocke8UwavtgUHm+Cg: raises $1 to $1.50
dGw5MBstXyXhWHHVFOWOFA: folds
a4JDWmpFQkL10XfAyuF51A: calls $1.25
5JJVDlaiMnB004o/RqbZZQ: folds
*** FLOP *** [4d Kh Js]
a4JDWmpFQkL10XfAyuF51A: checks
+k7T5ocke8UwavtgUHm+Cg: checks
*** TURN *** [4d Kh Js] [Kd]
a4JDWmpFQkL10XfAyuF51A: checks
+k7T5ocke8UwavtgUHm+Cg: checks
*** RIVER *** [4d Kh Js Kd] [Jc]
a4JDWmpFQkL10XfAyuF51A: checks
+k7T5ocke8UwavtgUHm+Cg: checks
*** SHOW DOWN ***
a4JDWmpFQkL10XfAyuF51A: shows [6h Ah] (two pair, Kings and Jacks)
+k7T5ocke8UwavtgUHm+Cg: shows [9s As] (two pair, Kings and Jacks)
a4JDWmpFQkL10XfAyuF51A collected $1.70 from pot
+k7T5ocke8UwavtgUHm+Cg collected $1.65 from pot
*** SUMMARY ***
Total pot $3.50 | Rake $0.15
Board [4d Kh Js Kd Jc]
Seat 1: pEW8B6uXbdR47kfljMQ3+Q folded before Flop (didn't bet)
Seat 2: UrcnkQOiLVk8BlKDPJSy7Q folded before Flop (didn't bet)
Seat 3: aTkyjTh3w5YLWiIERupZOA folded before Flop (didn't bet)
Seat 4: nvw9yQKhJT56lA9k+TLdhw folded before Flop (didn't bet)
Seat 5: mSD1pginDsyHG5PDfqzphw folded before Flop (didn't bet)
Seat 6: +k7T5ocke8UwavtgUHm+Cg showed [9s As] and won ($1.65) with two pair, Kings and Jacks
Seat 7: dGw5MBstXyXhWHHVFOWOFA (button) folded before Flop (didn't bet)
Seat 8: a4JDWmpFQkL10XfAyuF51A (small blind) showed [6h Ah] and won ($1.70) with two pair, Kings and Jacks
Seat 9: 5JJVDlaiMnB004o/RqbZZQ (big blind) folded before Flop



PokerStars Game #59938605202:  Hold'em No Limit ($0.25/$0.50) - 2009/07/01 0:19:01 ET
Table 'PALRfuH85dr5IkDfdv6new' 9-max Seat #6 is the button
Seat 1: SKnJuWHScqetA/qG5p+wCg ($32.25 in chips)
Seat 2: 9r7ZoBbAJj5IeyZ0q9BdzA ($9.15 in chips)
Seat 3: 50QWoELmpmHFrFIlWMJo9g ($90.20 in chips)
Seat 4: UqQTn9qxH/IQXP1PWD7Gwg ($33.45 in chips)
Seat 5: jSSGUXdNFAZA3QCvTcUMQw ($40.95 in chips)
Seat 6: EiWj2MAl8RNcPhTkzz24Mw ($36.95 in chips)
Seat 7: 3NcyXvr39gnK+KbTq7ezyA ($34.75 in chips)
Seat 8: NkS+CseUKx4XHszWq0PXEQ ($45.10 in chips)
Seat 9: CIrAX/m6o7jYmKOAjJXv4Q ($37.35 in chips)
3NcyXvr39gnK+KbTq7ezyA: posts small blind $0.25
NkS+CseUKx4XHszWq0PXEQ: posts big blind $0.50
*** HOLE CARDS ***
CIrAX/m6o7jYmKOAjJXv4Q: raises $1 to $1.50
SKnJuWHScqetA/qG5p+wCg: folds
9r7ZoBbAJj5IeyZ0q9BdzA: folds
50QWoELmpmHFrFIlWMJo9g: folds
UqQTn9qxH/IQXP1PWD7Gwg: folds
jSSGUXdNFAZA3QCvTcUMQw: calls $1.50
EiWj2MAl8RNcPhTkzz24Mw: folds
3NcyXvr39gnK+KbTq7ezyA: folds
NkS+CseUKx4XHszWq0PXEQ: folds
*** FLOP *** [3h 2d Ts]
CIrAX/m6o7jYmKOAjJXv4Q: bets $2
jSSGUXdNFAZA3QCvTcUMQw: folds
CIrAX/m6o7jYmKOAjJXv4Q collected $3.60 from pot
*** SUMMARY ***
Total pot $3.75 | Rake $0.15
Board [3h 2d Ts]
Seat 1: SKnJuWHScqetA/qG5p+wCg folded before Flop (didn't bet)
Seat 2: 9r7ZoBbAJj5IeyZ0q9BdzA folded before Flop (didn't bet)
Seat 3: 50QWoELmpmHFrFIlWMJo9g folded before Flop (didn't bet)
Seat 4: UqQTn9qxH/IQXP1PWD7Gwg folded before Flop (didn't bet)
Seat 5: jSSGUXdNFAZA3QCvTcUMQw folded on the Flop
Seat 6: EiWj2MAl8RNcPhTkzz24Mw (button) folded before Flop (didn't bet)
Seat 7: 3NcyXvr39gnK+KbTq7ezyA (small blind) folded before Flop
Seat 8: NkS+CseUKx4XHszWq0PXEQ (big blind) folded before Flop
Seat 9: CIrAX/m6o7jYmKOAjJXv4Q collected ($3.60)



PokerStars Game #59938605396:  Hold'em No Limit ($0.25/$0.50) - 2009/07/01 0:19:01 ET
Table 'mTxf8gPLgffN3Iwfm7Icfg' 2-max Seat #1 is the button
Seat 1: Do9Rlu1R5u/AcRtMTl8SYg ($50 in chips)
Seat 2: EMc5LPgVaded4Qc77vm0fw ($112.65 in chips)
Do9Rlu1R5u/AcRtMTl8SYg: posts small blind $0.25
EMc5LPgVaded4Qc77vm0fw: posts big blind $0.50
*** HOLE CARDS ***
Do9Rlu1R5u/AcRtMTl8SYg: folds
EMc5LPgVaded4Qc77vm0fw collected $0.50 from pot
EMc5LPgVaded4Qc77vm0fw: doesn't show hand
*** SUMMARY ***
Total pot $0.50 | Rake $0
Seat 1: Do9Rlu1R5u/AcRtMTl8SYg (button) (small blind) folded before Flop
Seat 2: EMc5LPgVaded4Qc77vm0fw (big blind) collected ($0.50)



PokerStars Game #59938606596:  Hold'em No Limit ($0.25/$0.50) - 2009/07/01 0:19:03 ET
Table 'ZYwMb9E6tY50Qm+iNbXRYw' 2-max Seat #1 is the button
Seat 1: DXLfRb8KDZWmrztw2bwtFw ($13.60 in chips)
Seat 2: 16tvT7AYgZ2LgiGFcvFKQg ($20.35 in chips)
DXLfRb8KDZWmrztw2bwtFw: posts small blind $0.25
16tvT7AYgZ2LgiGFcvFKQg: posts big blind $0.50
*** HOLE CARDS ***
DXLfRb8KDZWmrztw2bwtFw: calls $0.25
16tvT7AYgZ2LgiGFcvFKQg: checks
*** FLOP *** [Jc 6d 4d]
16tvT7AYgZ2LgiGFcvFKQg: checks
DXLfRb8KDZWmrztw2bwtFw: checks
*** TURN *** [Jc 6d 4d] [2c]
16tvT7AYgZ2LgiGFcvFKQg: checks
DXLfRb8KDZWmrztw2bwtFw: checks
*** RIVER *** [Jc 6d 4d 2c] [3h]
16tvT7AYgZ2LgiGFcvFKQg: bets $2
DXLfRb8KDZWmrztw2bwtFw: raises $5.50 to $7.50
16tvT7AYgZ2LgiGFcvFKQg: raises $6.50 to $14
DXLfRb8KDZWmrztw2bwtFw: calls $5.60 and is all-in
*** SHOW DOWN ***
16tvT7AYgZ2LgiGFcvFKQg: shows [5s Ah] (a straight, Deuce to Six)
DXLfRb8KDZWmrztw2bwtFw: shows [5h Th] (a straight, Deuce to Six)
16tvT7AYgZ2LgiGFcvFKQg collected $13.35 from pot
DXLfRb8KDZWmrztw2bwtFw collected $13.35 from pot
*** SUMMARY ***
Total pot $27.20 | Rake $0.50
Board [Jc 6d 4d 2c 3h]
Seat 1: DXLfRb8KDZWmrztw2bwtFw (button) (small blind) showed [5h Th] and won ($13.35) with a straight, Deuce to Six
Seat 2: 16tvT7AYgZ2LgiGFcvFKQg (big blind) showed [5s Ah] and won ($13.35) with a straight, Deuce to Six



PokerStars Game #59938607042:  Hold'em No Limit ($0.25/$0.50) - 2009/07/01 0:19:03 ET
Table 'c/CRn+68J3Y8KxD5g1ek2Q' 2-max Seat #1 is the button
Seat 1: 46qCyJ6evTkHo9al5sBMNA ($272.55 in chips)
Seat 2: BypVLsYQt3ePFm2xQL/dOA ($110.65 in chips)
46qCyJ6evTkHo9al5sBMNA: posts small blind $0.25
BypVLsYQt3ePFm2xQL/dOA: posts big blind $0.50
*** HOLE CARDS ***
46qCyJ6evTkHo9al5sBMNA: raises $1 to $1.50
BypVLsYQt3ePFm2xQL/dOA: calls $1
*** FLOP *** [Ad 5c 4d]
BypVLsYQt3ePFm2xQL/dOA: checks
46qCyJ6evTkHo9al5sBMNA: checks
*** TURN *** [Ad 5c 4d] [Ah]
BypVLsYQt3ePFm2xQL/dOA: checks
46qCyJ6evTkHo9al5sBMNA: checks
*** RIVER *** [Ad 5c 4d Ah] [As]
BypVLsYQt3ePFm2xQL/dOA: bets $0.50
46qCyJ6evTkHo9al5sBMNA: calls $0.50
*** SHOW DOWN ***
BypVLsYQt3ePFm2xQL/dOA: shows [Jh 4h] (a full house, Aces full of Fours)
46qCyJ6evTkHo9al5sBMNA: mucks hand
BypVLsYQt3ePFm2xQL/dOA collected $3.85 from pot
*** SUMMARY ***
Total pot $4 | Rake $0.15
Board [Ad 5c 4d Ah As]
Seat 1: 46qCyJ6evTkHo9al5sBMNA (button) (small blind) mucked
Seat 2: BypVLsYQt3ePFm2xQL/dOA (big blind) showed [Jh 4h] and won ($3.85) with a full house, Aces full of Fours



PokerStars Game #59938607046:  Hold'em No Limit ($0.25/$0.50) - 2009/07/01 0:19:03 ET
Table 'X6IRCRTh+20gjz8aubWnwA' 9-max Seat #7 is the button
Seat 2: RjBdQ6w31rgcy0o24VLR6w ($10.90 in chips)
Seat 3: mSD1pginDsyHG5PDfqzphw ($10 in chips)
Seat 4: uw9QayAAxLM3Hb+HR7mSkg ($10.25 in chips)
Seat 5: QtFsO51ArDuQ44+KvR2jow ($30.70 in chips)
Seat 6: /6In1zC3WtgwxDcueWzZWg ($58.10 in chips)
Seat 7: VBnpbzn0dIveV55qKvciew ($53.95 in chips)
Seat 9: M+7+BTmX5vZatHVuoRB1nA ($82.10 in chips)
HxeBVq06/3Bh/H986sgdbw will be allowed to play after the button
M+7+BTmX5vZatHVuoRB1nA: posts small blind $0.25
RjBdQ6w31rgcy0o24VLR6w: posts big blind $0.50
*** HOLE CARDS ***
mSD1pginDsyHG5PDfqzphw: folds
uw9QayAAxLM3Hb+HR7mSkg: folds
QtFsO51ArDuQ44+KvR2jow: calls $0.50
/6In1zC3WtgwxDcueWzZWg: folds
VBnpbzn0dIveV55qKvciew: folds
M+7+BTmX5vZatHVuoRB1nA: calls $0.25
RjBdQ6w31rgcy0o24VLR6w: raises $2.50 to $3
QtFsO51ArDuQ44+KvR2jow: folds
M+7+BTmX5vZatHVuoRB1nA: folds
RjBdQ6w31rgcy0o24VLR6w collected $1.50 from pot
RjBdQ6w31rgcy0o24VLR6w: doesn't show hand
*** SUMMARY ***
Total pot $1.50 | Rake $0
Seat 2: RjBdQ6w31rgcy0o24VLR6w (big blind) collected ($1.50)
Seat 3: mSD1pginDsyHG5PDfqzphw folded before Flop (didn't bet)
Seat 4: uw9QayAAxLM3Hb+HR7mSkg folded before Flop (didn't bet)
Seat 5: QtFsO51ArDuQ44+KvR2jow folded before Flop
Seat 6: /6In1zC3WtgwxDcueWzZWg folded before Flop (didn't bet)
Seat 7: VBnpbzn0dIveV55qKvciew (button) folded before Flop (didn't bet)
Seat 9: M+7+BTmX5vZatHVuoRB1nA (small blind) folded before Flop



PokerStars Game #59938607128:  Hold'em No Limit ($0.25/$0.50) - 2009/07/01 0:19:04 ET
Table 'kgbJRsxfv64KrErDRBAkcw' 6-max Seat #4 is the button
Seat 1: N7O9jUEx2YiQn1+yRYTHmw ($20.20 in chips)
Seat 2: Q+thC23WCv1kJUJtH/+4Jw ($39.80 in chips)
Seat 3: T0Gx/FcQ5VH9u7XaOMX97A ($60.25 in chips)
Seat 4: qanMEqjABjWxC/JgQ/0l7w ($56.70 in chips)
Seat 5: +Pf9jTVizYlIo+woPvptfA ($50 in chips)
Seat 6: DDfYzIrYT0t5R/hAJngtsg ($26.55 in chips)
+Pf9jTVizYlIo+woPvptfA: posts small blind $0.25
DDfYzIrYT0t5R/hAJngtsg: posts big blind $0.50
*** HOLE CARDS ***
N7O9jUEx2YiQn1+yRYTHmw: calls $0.50
Q+thC23WCv1kJUJtH/+4Jw: raises $1.50 to $2
T0Gx/FcQ5VH9u7XaOMX97A: folds
qanMEqjABjWxC/JgQ/0l7w: folds
+Pf9jTVizYlIo+woPvptfA: folds
DDfYzIrYT0t5R/hAJngtsg: folds
N7O9jUEx2YiQn1+yRYTHmw: folds
Q+thC23WCv1kJUJtH/+4Jw collected $1.75 from pot
*** SUMMARY ***
Total pot $1.75 | Rake $0
Seat 1: N7O9jUEx2YiQn1+yRYTHmw folded before Flop
Seat 2: Q+thC23WCv1kJUJtH/+4Jw collected ($1.75)
Seat 3: T0Gx/FcQ5VH9u7XaOMX97A folded before Flop (didn't bet)
Seat 4: qanMEqjABjWxC/JgQ/0l7w (button) folded before Flop (didn't bet)
Seat 5: +Pf9jTVizYlIo+woPvptfA (small blind) folded before Flop
Seat 6: DDfYzIrYT0t5R/hAJngtsg (big blind) folded before Flop



PokerStars Game #59938607400:  Hold'em No Limit ($0.25/$0.50) - 2009/07/01 0:19:04 ET
Table 'IeNZOZQ4T6oiaHqFeo6yIA' 2-max Seat #2 is the button
Seat 1: ndd1nfncBkWNitBnsfCoVQ ($63.80 in chips)
Seat 2: A91IUl5JaZROhtfCtnnwYw ($23.60 in chips)
A91IUl5JaZROhtfCtnnwYw: posts small blind $0.25
ndd1nfncBkWNitBnsfCoVQ: posts big blind $0.50
*** HOLE CARDS ***
A91IUl5JaZROhtfCtnnwYw: calls $0.25
ndd1nfncBkWNitBnsfCoVQ: checks
*** FLOP *** [Qh 5d 8c]
ndd1nfncBkWNitBnsfCoVQ: checks
A91IUl5JaZROhtfCtnnwYw: checks
*** TURN *** [Qh 5d 8c] [4s]
ndd1nfncBkWNitBnsfCoVQ: checks
A91IUl5JaZROhtfCtnnwYw: bets $0.50
ndd1nfncBkWNitBnsfCoVQ: folds
A91IUl5JaZROhtfCtnnwYw collected $0.95 from pot
*** SUMMARY ***
Total pot $1 | Rake $0.05
Board [Qh 5d 8c 4s]
Seat 1: ndd1nfncBkWNitBnsfCoVQ (big blind) folded on the Turn
Seat 2: A91IUl5JaZROhtfCtnnwYw (button) (small blind) collected ($0.95)



PokerStars Game #59938609574:  Hold'em No Limit ($0.25/$0.50) - 2009/07/01 0:19:07 ET
Table 'mTxf8gPLgffN3Iwfm7Icfg' 2-max Seat #2 is the button
Seat 1: Do9Rlu1R5u/AcRtMTl8SYg ($50 in chips)
Seat 2: EMc5LPgVaded4Qc77vm0fw ($112.90 in chips)
EMc5LPgVaded4Qc77vm0fw: posts small blind $0.25
Do9Rlu1R5u/AcRtMTl8SYg: posts big blind $0.50
*** HOLE CARDS ***
EMc5LPgVaded4Qc77vm0fw: raises $1 to $1.50
Do9Rlu1R5u/AcRtMTl8SYg: raises $3 to $4.50
EMc5LPgVaded4Qc77vm0fw: calls $3
*** FLOP *** [7h Tc Kh]
Do9Rlu1R5u/AcRtMTl8SYg: bets $6
EMc5LPgVaded4Qc77vm0fw: folds
Do9Rlu1R5u/AcRtMTl8SYg collected $8.55 from pot
Do9Rlu1R5u/AcRtMTl8SYg: doesn't show hand
*** SUMMARY ***
Total pot $9 | Rake $0.45
Board [7h Tc Kh]
Seat 1: Do9Rlu1R5u/AcRtMTl8SYg (big blind) collected ($8.55)
Seat 2: EMc5LPgVaded4Qc77vm0fw (button) (small blind) folded on the Flop



PokerStars Game #59938609206:  Hold'em No Limit ($0.25/$0.50) - 2009/07/01 0:19:07 ET
Table 'eMxdLyFDf28E0wit6gm3Uw' 6-max Seat #3 is the button
Seat 1: tnD/64LagZ9qPaeOQVjVZg ($13.20 in chips)
Seat 2: jwuKQ1S3U4NnzMQn3E3dgw ($68.45 in chips)
Seat 3: dZcLsEI8iXkobBduRJ45Yw ($16.25 in chips)
Seat 4: QM93o65lI8kLzmiB/BILlA ($28 in chips)
Seat 5: X0X97o2fDAPiGx6o1gahsw ($57.10 in chips)
Seat 6: L0aIPg7qefDQjdJo3HCVEA ($9.25 in chips)
QM93o65lI8kLzmiB/BILlA: posts small blind $0.25
X0X97o2fDAPiGx6o1gahsw is disconnected
X0X97o2fDAPiGx6o1gahsw is connected
X0X97o2fDAPiGx6o1gahsw: posts big blind $0.50
*** HOLE CARDS ***
L0aIPg7qefDQjdJo3HCVEA: folds
tnD/64LagZ9qPaeOQVjVZg: folds
jwuKQ1S3U4NnzMQn3E3dgw: folds
dZcLsEI8iXkobBduRJ45Yw: raises $0.50 to $1
QM93o65lI8kLzmiB/BILlA: calls $0.75
X0X97o2fDAPiGx6o1gahsw: folds
*** FLOP *** [Kd Jd As]
QM93o65lI8kLzmiB/BILlA: checks
dZcLsEI8iXkobBduRJ45Yw: checks
*** TURN *** [Kd Jd As] [3c]
QM93o65lI8kLzmiB/BILlA: checks
dZcLsEI8iXkobBduRJ45Yw: checks
*** RIVER *** [Kd Jd As 3c] [4h]
QM93o65lI8kLzmiB/BILlA: checks
dZcLsEI8iXkobBduRJ45Yw: bets $2.50
QM93o65lI8kLzmiB/BILlA: folds
dZcLsEI8iXkobBduRJ45Yw collected $2.40 from pot
*** SUMMARY ***
Total pot $2.50 | Rake $0.10
Board [Kd Jd As 3c 4h]
Seat 1: tnD/64LagZ9qPaeOQVjVZg folded before Flop (didn't bet)
Seat 2: jwuKQ1S3U4NnzMQn3E3dgw folded before Flop (didn't bet)
Seat 3: dZcLsEI8iXkobBduRJ45Yw (button) collected ($2.40)
Seat 4: QM93o65lI8kLzmiB/BILlA (small blind) folded on the River
Seat 5: X0X97o2fDAPiGx6o1gahsw (big blind) folded before Flop
Seat 6: L0aIPg7qefDQjdJo3HCVEA folded before Flop (didn't bet)



PokerStars Game #59938614390:  Hold'em No Limit ($0.25/$0.50) - 2009/07/01 0:19:14 ET
Table '5EmHi+fnatGQQShcNmzOZQ' 6-max Seat #5 is the button
Seat 1: SwPczQo3cOtwEzhJrfO2cQ ($27.70 in chips)
Seat 2: APwvTk5XojDXGoQLb4O5iA ($28.25 in chips)
Seat 3: L9qfLYXrczhAPd/VckgsWw ($58.75 in chips)
Seat 4: wOyVV9M/oyiw3YaOjNZ05w ($50 in chips)
Seat 5: kxPhs4ePFqMy52CInAJ2aw ($49.25 in chips)
Seat 6: 686aeHikcJlgKkSuIFdcXQ ($157.60 in chips)
686aeHikcJlgKkSuIFdcXQ: posts small blind $0.25
SwPczQo3cOtwEzhJrfO2cQ: posts big blind $0.50
*** HOLE CARDS ***
APwvTk5XojDXGoQLb4O5iA has timed out
APwvTk5XojDXGoQLb4O5iA: folds
APwvTk5XojDXGoQLb4O5iA is sitting out
L9qfLYXrczhAPd/VckgsWw: raises $1.50 to $2
wOyVV9M/oyiw3YaOjNZ05w: folds
kxPhs4ePFqMy52CInAJ2aw: folds
686aeHikcJlgKkSuIFdcXQ: folds
SwPczQo3cOtwEzhJrfO2cQ: folds
L9qfLYXrczhAPd/VckgsWw collected $1.25 from pot
L9qfLYXrczhAPd/VckgsWw: doesn't show hand
*** SUMMARY ***
Total pot $1.25 | Rake $0
Seat 1: SwPczQo3cOtwEzhJrfO2cQ (big blind) folded before Flop
Seat 2: APwvTk5XojDXGoQLb4O5iA folded before Flop (didn't bet)
Seat 3: L9qfLYXrczhAPd/VckgsWw collected ($1.25)
Seat 4: wOyVV9M/oyiw3YaOjNZ05w folded before Flop (didn't bet)
Seat 5: kxPhs4ePFqMy52CInAJ2aw (button) folded before Flop (didn't bet)
Seat 6: 686aeHikcJlgKkSuIFdcXQ (small blind) folded before Flop



PokerStars Game #59938615660:  Hold'em No Limit ($0.25/$0.50) - 2009/07/01 0:19:16 ET
Table 'raOT4/ipuZgzjfKHC+jD9g' 2-max Seat #1 is the button
Seat 1: IuwLemwLhc9fvrwBGs0AMA ($12.80 in chips)
Seat 2: Udr5juWSWUgTu1NlRhjMdA ($9.60 in chips)
IuwLemwLhc9fvrwBGs0AMA: posts small blind $0.25
Udr5juWSWUgTu1NlRhjMdA: posts big blind $0.50
*** HOLE CARDS ***
IuwLemwLhc9fvrwBGs0AMA: folds
Udr5juWSWUgTu1NlRhjMdA collected $0.50 from pot
Udr5juWSWUgTu1NlRhjMdA: doesn't show hand
*** SUMMARY ***
Total pot $0.50 | Rake $0
Seat 1: IuwLemwLhc9fvrwBGs0AMA (button) (small blind) folded before Flop
Seat 2: Udr5juWSWUgTu1NlRhjMdA (big blind) collected ($0.50)



PokerStars Game #59938616396:  Hold'em No Limit ($0.25/$0.50) - 2009/07/01 0:19:17 ET
Table 'tyR5AZNKV8Aadbrnrnlg7g' 6-max Seat #5 is the button
Seat 1: R+KjpH/wSjDLhtIy9+edNA ($52.35 in chips)
Seat 2: 58zdeSBSuSFX/qZfhc7YmA ($33.85 in chips)
Seat 3: jUhx+m+V7qfbLZTjgwZByg ($23.60 in chips)
Seat 4: Rt6KgtZ8YaJoTc3FPim00w ($87 in chips)
Seat 5: EIg3r3fRFKG2HhgpDlIJHg ($2.35 in chips)
Seat 6: DMQLAmut/l19xN5STQndFg ($7.65 in chips)
DMQLAmut/l19xN5STQndFg: posts small blind $0.25
R+KjpH/wSjDLhtIy9+edNA: posts big blind $0.50
*** HOLE CARDS ***
58zdeSBSuSFX/qZfhc7YmA: folds
jUhx+m+V7qfbLZTjgwZByg: folds
Rt6KgtZ8YaJoTc3FPim00w: folds
EIg3r3fRFKG2HhgpDlIJHg: calls $0.50
DMQLAmut/l19xN5STQndFg: calls $0.25
R+KjpH/wSjDLhtIy9+edNA: raises $1.50 to $2
EIg3r3fRFKG2HhgpDlIJHg: raises $0.35 to $2.35 and is all-in
DMQLAmut/l19xN5STQndFg: folds
R+KjpH/wSjDLhtIy9+edNA: calls $0.35
*** FLOP *** [Jc 7h 6c]
*** TURN *** [Jc 7h 6c] [3h]
*** RIVER *** [Jc 7h 6c 3h] [6h]
*** SHOW DOWN ***
R+KjpH/wSjDLhtIy9+edNA: shows [As Ac] (two pair, Aces and Sixes)
EIg3r3fRFKG2HhgpDlIJHg: mucks hand
R+KjpH/wSjDLhtIy9+edNA collected $4.95 from pot
*** SUMMARY ***
Total pot $5.20 | Rake $0.25
Board [Jc 7h 6c 3h 6h]
Seat 1: R+KjpH/wSjDLhtIy9+edNA (big blind) showed [As Ac] and won ($4.95) with two pair, Aces and Sixes
Seat 2: 58zdeSBSuSFX/qZfhc7YmA folded before Flop (didn't bet)
Seat 3: jUhx+m+V7qfbLZTjgwZByg folded before Flop (didn't bet)
Seat 4: Rt6KgtZ8YaJoTc3FPim00w folded before Flop (didn't bet)
Seat 5: EIg3r3fRFKG2HhgpDlIJHg (button) mucked
Seat 6: DMQLAmut/l19xN5STQndFg (small blind) folded before Flop



PokerStars Game #59938617634:  Hold'em No Limit ($0.25/$0.50) - 2009/07/01 0:19:19 ET
Table 'fx6MqwfYAj/Rt86hBz2L3Q' 9-max Seat #6 is the button
Seat 1: uW08L3aflsgdboc6oTbC3Q ($35.05 in chips)
Seat 2: C3rGXblctNcWI6JYPHhaEg ($14.50 in chips)
Seat 3: iadBi5AEt7gTBXbDSSnMYQ ($49 in chips)
Seat 4: gPEN9Zp33YTm/mu9/SYP1w ($31.95 in chips)
Seat 5: iAISe3dVeua8PUn2wwgDHw ($30 in chips)
Seat 6: VelaednozEGCpceHSFUsAg ($19.05 in chips)
Seat 7: bkXkL3pmapikPQQRNPZSEA ($9 in chips)
Seat 8: 6ol/q1A4zYU6qXbZnTzPfQ ($14.30 in chips)
Seat 9: NumwTCp9zWfI3q1AFfSt7Q ($9.45 in chips)
bkXkL3pmapikPQQRNPZSEA: posts small blind $0.25
6ol/q1A4zYU6qXbZnTzPfQ: posts big blind $0.50
iAISe3dVeua8PUn2wwgDHw: posts big blind $0.50
*** HOLE CARDS ***
NumwTCp9zWfI3q1AFfSt7Q: folds
uW08L3aflsgdboc6oTbC3Q: raises $1 to $1.50
C3rGXblctNcWI6JYPHhaEg: folds
iadBi5AEt7gTBXbDSSnMYQ: folds
gPEN9Zp33YTm/mu9/SYP1w: folds
iAISe3dVeua8PUn2wwgDHw: folds
VelaednozEGCpceHSFUsAg: raises $3.25 to $4.75
NumwTCp9zWfI3q1AFfSt7Q leaves the table
bkXkL3pmapikPQQRNPZSEA: folds
6ol/q1A4zYU6qXbZnTzPfQ: folds
HZkVla4kK2SI42CVrPZ/ig joins the table at seat #9
uW08L3aflsgdboc6oTbC3Q: folds
VelaednozEGCpceHSFUsAg collected $4.25 from pot
*** SUMMARY ***
Total pot $4.25 | Rake $0
Seat 1: uW08L3aflsgdboc6oTbC3Q folded before Flop
Seat 2: C3rGXblctNcWI6JYPHhaEg folded before Flop (didn't bet)
Seat 3: iadBi5AEt7gTBXbDSSnMYQ folded before Flop (didn't bet)
Seat 4: gPEN9Zp33YTm/mu9/SYP1w folded before Flop (didn't bet)
Seat 5: iAISe3dVeua8PUn2wwgDHw folded before Flop
Seat 6: VelaednozEGCpceHSFUsAg (button) collected ($4.25)
Seat 7: bkXkL3pmapikPQQRNPZSEA (small blind) folded before Flop
Seat 8: 6ol/q1A4zYU6qXbZnTzPfQ (big blind) folded before Flop
Seat 9: NumwTCp9zWfI3q1AFfSt7Q folded before Flop (didn't bet)



PokerStars Game #59938619016:  Hold'em No Limit ($0.25/$0.50) - 2009/07/01 0:19:21 ET
Table '37qXEp3oe+er5q4CZip9eQ' 6-max Seat #4 is the button
Seat 1: oqOqoO2AyCZenUghCxMDxw ($50 in chips)
Seat 2: g12O9qXTybyo2C0B2bXgjg ($33.25 in chips)
Seat 3: Rt6KgtZ8YaJoTc3FPim00w ($98.15 in chips)
Seat 4: AYb7QG0KzyicbOC0ZROE3Q ($8.75 in chips)
Seat 5: VOmI0x4dDPnTESZd5B4d1Q ($40.80 in chips)
Seat 6: f7zPpUQp9hHZgqhEvrUWQw ($51.40 in chips)
VOmI0x4dDPnTESZd5B4d1Q: posts small blind $0.25
f7zPpUQp9hHZgqhEvrUWQw: posts big blind $0.50
*** HOLE CARDS ***
oqOqoO2AyCZenUghCxMDxw: raises $1 to $1.50
g12O9qXTybyo2C0B2bXgjg: folds
Rt6KgtZ8YaJoTc3FPim00w: folds
AYb7QG0KzyicbOC0ZROE3Q: folds
VOmI0x4dDPnTESZd5B4d1Q: folds
f7zPpUQp9hHZgqhEvrUWQw: folds
oqOqoO2AyCZenUghCxMDxw collected $1.25 from pot
*** SUMMARY ***
Total pot $1.25 | Rake $0
Seat 1: oqOqoO2AyCZenUghCxMDxw collected ($1.25)
Seat 2: g12O9qXTybyo2C0B2bXgjg folded before Flop (didn't bet)
Seat 3: Rt6KgtZ8YaJoTc3FPim00w folded before Flop (didn't bet)
Seat 4: AYb7QG0KzyicbOC0ZROE3Q (button) folded before Flop (didn't bet)
Seat 5: VOmI0x4dDPnTESZd5B4d1Q (small blind) folded before Flop
Seat 6: f7zPpUQp9hHZgqhEvrUWQw (big blind) folded before Flop



PokerStars Game #59938619360:  Hold'em No Limit ($0.25/$0.50) - 2009/07/01 0:19:21 ET
Table 'IeNZOZQ4T6oiaHqFeo6yIA' 2-max Seat #1 is the button
Seat 1: ndd1nfncBkWNitBnsfCoVQ ($63.30 in chips)
Seat 2: A91IUl5JaZROhtfCtnnwYw ($24.05 in chips)
ndd1nfncBkWNitBnsfCoVQ: posts small blind $0.25
A91IUl5JaZROhtfCtnnwYw: posts big blind $0.50
*** HOLE CARDS ***
ndd1nfncBkWNitBnsfCoVQ: raises $1 to $1.50
A91IUl5JaZROhtfCtnnwYw: calls $1
*** FLOP *** [6s 3c 5h]
A91IUl5JaZROhtfCtnnwYw: bets $0.50
ndd1nfncBkWNitBnsfCoVQ: raises $3 to $3.50
A91IUl5JaZROhtfCtnnwYw: calls $3
*** TURN *** [6s 3c 5h] [Ac]
A91IUl5JaZROhtfCtnnwYw: checks
ndd1nfncBkWNitBnsfCoVQ: bets $7.50
A91IUl5JaZROhtfCtnnwYw: folds
ndd1nfncBkWNitBnsfCoVQ collected $9.55 from pot
ndd1nfncBkWNitBnsfCoVQ: doesn't show hand
*** SUMMARY ***
Total pot $10 | Rake $0.45
Board [6s 3c 5h Ac]
Seat 1: ndd1nfncBkWNitBnsfCoVQ (button) (small blind) collected ($9.55)
Seat 2: A91IUl5JaZROhtfCtnnwYw (big blind) folded on the Turn



PokerStars Game #59938619230:  Hold'em No Limit ($0.25/$0.50) - 2009/07/01 0:19:21 ET
Table '+dXkOAQyS8j9PQZusUTMpg' 2-max Seat #1 is the button
Seat 1: XFa6sBGjP2gxoIvxR3fZIg ($52 in chips)
Seat 2: 5IBeOgaApY1Bvzv2P8X4EA ($57.45 in chips)
XFa6sBGjP2gxoIvxR3fZIg: posts small blind $0.25
5IBeOgaApY1Bvzv2P8X4EA: posts big blind $0.50
*** HOLE CARDS ***
XFa6sBGjP2gxoIvxR3fZIg: raises $1 to $1.50
5IBeOgaApY1Bvzv2P8X4EA: folds
XFa6sBGjP2gxoIvxR3fZIg collected $1 from pot
XFa6sBGjP2gxoIvxR3fZIg: doesn't show hand
*** SUMMARY ***
Total pot $1 | Rake $0
Seat 1: XFa6sBGjP2gxoIvxR3fZIg (button) (small blind) collected ($1)
Seat 2: 5IBeOgaApY1Bvzv2P8X4EA (big blind) folded before Flop



PokerStars Game #59938620702:  Hold'em No Limit ($0.25/$0.50) - 2009/07/01 0:19:24 ET
Table 'ZYwMb9E6tY50Qm+iNbXRYw' 2-max Seat #2 is the button
Seat 1: DXLfRb8KDZWmrztw2bwtFw ($13.35 in chips)
Seat 2: 16tvT7AYgZ2LgiGFcvFKQg ($20.10 in chips)
16tvT7AYgZ2LgiGFcvFKQg: posts small blind $0.25
DXLfRb8KDZWmrztw2bwtFw: posts big blind $0.50
*** HOLE CARDS ***
16tvT7AYgZ2LgiGFcvFKQg: raises $0.50 to $1
DXLfRb8KDZWmrztw2bwtFw: calls $0.50
*** FLOP *** [8s Kh 3h]
DXLfRb8KDZWmrztw2bwtFw: checks
16tvT7AYgZ2LgiGFcvFKQg: checks
*** TURN *** [8s Kh 3h] [5h]
DXLfRb8KDZWmrztw2bwtFw: checks
16tvT7AYgZ2LgiGFcvFKQg: checks
*** RIVER *** [8s Kh 3h 5h] [9h]
DXLfRb8KDZWmrztw2bwtFw: bets $1.50
16tvT7AYgZ2LgiGFcvFKQg: raises $1.50 to $3
DXLfRb8KDZWmrztw2bwtFw: calls $1.50
*** SHOW DOWN ***
16tvT7AYgZ2LgiGFcvFKQg: shows [Qh Js] (a flush, King high)
DXLfRb8KDZWmrztw2bwtFw: mucks hand
16tvT7AYgZ2LgiGFcvFKQg collected $7.65 from pot
*** SUMMARY ***
Total pot $8 | Rake $0.35
Board [8s Kh 3h 5h 9h]
Seat 1: DXLfRb8KDZWmrztw2bwtFw (big blind) mucked
Seat 2: 16tvT7AYgZ2LgiGFcvFKQg (button) (small blind) showed [Qh Js] and won ($7.65) with a flush, King high



PokerStars Game #59938622620:  Hold'em No Limit ($0.25/$0.50) - 2009/07/01 0:19:26 ET
Table 'mTxf8gPLgffN3Iwfm7Icfg' 2-max Seat #1 is the button
Seat 1: Do9Rlu1R5u/AcRtMTl8SYg ($54.05 in chips)
Seat 2: EMc5LPgVaded4Qc77vm0fw ($108.40 in chips)
Do9Rlu1R5u/AcRtMTl8SYg: posts small blind $0.25
EMc5LPgVaded4Qc77vm0fw: posts big blind $0.50
*** HOLE CARDS ***
Do9Rlu1R5u/AcRtMTl8SYg: raises $1 to $1.50
EMc5LPgVaded4Qc77vm0fw: folds
Do9Rlu1R5u/AcRtMTl8SYg collected $1 from pot
Do9Rlu1R5u/AcRtMTl8SYg: doesn't show hand
*** SUMMARY ***
Total pot $1 | Rake $0
Seat 1: Do9Rlu1R5u/AcRtMTl8SYg (button) (small blind) collected ($1)
Seat 2: EMc5LPgVaded4Qc77vm0fw (big blind) folded before Flop



PokerStars Game #59938622448:  Hold'em No Limit ($0.25/$0.50) - 2009/07/01 0:19:26 ET
Table 'c/CRn+68J3Y8KxD5g1ek2Q' 2-max Seat #2 is the button
Seat 1: 46qCyJ6evTkHo9al5sBMNA ($270.55 in chips)
Seat 2: BypVLsYQt3ePFm2xQL/dOA ($112.50 in chips)
BypVLsYQt3ePFm2xQL/dOA: posts small blind $0.25
46qCyJ6evTkHo9al5sBMNA: posts big blind $0.50
*** HOLE CARDS ***
BypVLsYQt3ePFm2xQL/dOA: raises $1 to $1.50
46qCyJ6evTkHo9al5sBMNA: calls $1
*** FLOP *** [7s 8c 4c]
46qCyJ6evTkHo9al5sBMNA: checks
BypVLsYQt3ePFm2xQL/dOA: checks
*** TURN *** [7s 8c 4c] [4s]
46qCyJ6evTkHo9al5sBMNA: bets $2
BypVLsYQt3ePFm2xQL/dOA: folds
46qCyJ6evTkHo9al5sBMNA collected $2.85 from pot
46qCyJ6evTkHo9al5sBMNA: doesn't show hand
*** SUMMARY ***
Total pot $3 | Rake $0.15
Board [7s 8c 4c 4s]
Seat 1: 46qCyJ6evTkHo9al5sBMNA (big blind) collected ($2.85)
Seat 2: BypVLsYQt3ePFm2xQL/dOA (button) (small blind) folded on the Turn



PokerStars Game #59938622986:  Hold'em No Limit ($0.25/$0.50) - 2009/07/01 0:19:27 ET
Table 'raOT4/ipuZgzjfKHC+jD9g' 2-max Seat #2 is the button
Seat 1: IuwLemwLhc9fvrwBGs0AMA ($12.55 in chips)
Seat 2: Udr5juWSWUgTu1NlRhjMdA ($9.85 in chips)
Udr5juWSWUgTu1NlRhjMdA: posts small blind $0.25
IuwLemwLhc9fvrwBGs0AMA: posts big blind $0.50
*** HOLE CARDS ***
Udr5juWSWUgTu1NlRhjMdA: raises $1 to $1.50
IuwLemwLhc9fvrwBGs0AMA: folds
Udr5juWSWUgTu1NlRhjMdA collected $1 from pot
Udr5juWSWUgTu1NlRhjMdA: doesn't show hand
*** SUMMARY ***
Total pot $1 | Rake $0
Seat 1: IuwLemwLhc9fvrwBGs0AMA (big blind) folded before Flop
Seat 2: Udr5juWSWUgTu1NlRhjMdA (button) (small blind) collected ($1)



PokerStars Game #59938623270:  Hold'em No Limit ($0.25/$0.50) - 2009/07/01 0:19:27 ET
Table 'kgbJRsxfv64KrErDRBAkcw' 6-max Seat #5 is the button
Seat 1: N7O9jUEx2YiQn1+yRYTHmw ($19.70 in chips)
Seat 2: Q+thC23WCv1kJUJtH/+4Jw ($41.05 in chips)
Seat 3: T0Gx/FcQ5VH9u7XaOMX97A ($60.25 in chips)
Seat 4: qanMEqjABjWxC/JgQ/0l7w ($56.70 in chips)
Seat 5: +Pf9jTVizYlIo+woPvptfA ($50 in chips)
Seat 6: DDfYzIrYT0t5R/hAJngtsg ($26.05 in chips)
DDfYzIrYT0t5R/hAJngtsg: posts small blind $0.25
N7O9jUEx2YiQn1+yRYTHmw: posts big blind $0.50
*** HOLE CARDS ***
Q+thC23WCv1kJUJtH/+4Jw: raises $2 to $2.50
T0Gx/FcQ5VH9u7XaOMX97A: folds
qanMEqjABjWxC/JgQ/0l7w: folds
+Pf9jTVizYlIo+woPvptfA: folds
DDfYzIrYT0t5R/hAJngtsg: folds
N7O9jUEx2YiQn1+yRYTHmw: folds
Q+thC23WCv1kJUJtH/+4Jw collected $1.25 from pot
*** SUMMARY ***
Total pot $1.25 | Rake $0
Seat 1: N7O9jUEx2YiQn1+yRYTHmw (big blind) folded before Flop
Seat 2: Q+thC23WCv1kJUJtH/+4Jw collected ($1.25)
Seat 3: T0Gx/FcQ5VH9u7XaOMX97A folded before Flop (didn't bet)
Seat 4: qanMEqjABjWxC/JgQ/0l7w folded before Flop (didn't bet)
Seat 5: +Pf9jTVizYlIo+woPvptfA (button) folded before Flop (didn't bet)
Seat 6: DDfYzIrYT0t5R/hAJngtsg (small blind) folded before Flop



PokerStars Game #59938623648:  Hold'em No Limit ($0.25/$0.50) - 2009/07/01 0:19:28 ET
Table 'GfL/No5u5PoEnU39lP5pQg' 6-max Seat #2 is the button
Seat 2: uVwggSetzp7d+eVgowO3vg ($36.30 in chips)
Seat 3: qNezhXOOUXqwG7b9X5XJAA ($50 in chips)
Seat 4: yqM0AD7MZQd/cEtKdDQY1A ($30.55 in chips)
Seat 6: 3wylWYGeXFXcrE4XVrlPng ($65.10 in chips)
qNezhXOOUXqwG7b9X5XJAA: posts small blind $0.25
yqM0AD7MZQd/cEtKdDQY1A: posts big blind $0.50
1WUCqNG+p+vfWRTXNu4ljw: sits out
*** HOLE CARDS ***
3wylWYGeXFXcrE4XVrlPng: folds
uVwggSetzp7d+eVgowO3vg: raises $1 to $1.50
qNezhXOOUXqwG7b9X5XJAA: folds
yqM0AD7MZQd/cEtKdDQY1A: raises $2.50 to $4
uVwggSetzp7d+eVgowO3vg: calls $2.50
*** FLOP *** [4s 4d 5d]
yqM0AD7MZQd/cEtKdDQY1A: bets $3
uVwggSetzp7d+eVgowO3vg: calls $3
*** TURN *** [4s 4d 5d] [7c]
yqM0AD7MZQd/cEtKdDQY1A: bets $4
crjGpJEzSZgD38FoE3VMGg joins the table at seat #5
uVwggSetzp7d+eVgowO3vg: raises $8 to $12
yqM0AD7MZQd/cEtKdDQY1A: folds
uVwggSetzp7d+eVgowO3vg collected $21.20 from pot
uVwggSetzp7d+eVgowO3vg: shows [Tc Ac] (a pair of Fours)
*** SUMMARY ***
Total pot $22.25 | Rake $1.05
Board [4s 4d 5d 7c]
Seat 2: uVwggSetzp7d+eVgowO3vg (button) collected ($21.20)
Seat 3: qNezhXOOUXqwG7b9X5XJAA (small blind) folded before Flop
Seat 4: yqM0AD7MZQd/cEtKdDQY1A (big blind) folded on the Turn
Seat 6: 3wylWYGeXFXcrE4XVrlPng folded before Flop (didn't bet)



PokerStars Game #59938624284:  Hold'em No Limit ($0.25/$0.50) - 2009/07/01 0:19:29 ET
Table '+dXkOAQyS8j9PQZusUTMpg' 2-max Seat #2 is the button
Seat 1: XFa6sBGjP2gxoIvxR3fZIg ($52.50 in chips)
Seat 2: 5IBeOgaApY1Bvzv2P8X4EA ($56.95 in chips)
5IBeOgaApY1Bvzv2P8X4EA: posts small blind $0.25
XFa6sBGjP2gxoIvxR3fZIg: posts big blind $0.50
*** HOLE CARDS ***
5IBeOgaApY1Bvzv2P8X4EA: folds
XFa6sBGjP2gxoIvxR3fZIg collected $0.50 from pot
XFa6sBGjP2gxoIvxR3fZIg: doesn't show hand
*** SUMMARY ***
Total pot $0.50 | Rake $0
Seat 1: XFa6sBGjP2gxoIvxR3fZIg (big blind) collected ($0.50)
Seat 2: 5IBeOgaApY1Bvzv2P8X4EA (button) (small blind) folded before Flop



PokerStars Game #59938627140:  Hold'em No Limit ($0.25/$0.50) - 2009/07/01 0:19:33 ET
Table 'E7bWJ45aoFXRpyRv2gw+Ig' 2-max Seat #1 is the button
Seat 1: FRkiRasEGlHUeLrEl+k/nA ($65.35 in chips)
Seat 2: 3Wro85I7472vJ4Wkpneo9A ($114.55 in chips)
FRkiRasEGlHUeLrEl+k/nA: posts small blind $0.25
3Wro85I7472vJ4Wkpneo9A: posts big blind $0.50
*** HOLE CARDS ***
FRkiRasEGlHUeLrEl+k/nA: raises $1 to $1.50
3Wro85I7472vJ4Wkpneo9A: folds
FRkiRasEGlHUeLrEl+k/nA collected $1 from pot
FRkiRasEGlHUeLrEl+k/nA: doesn't show hand
*** SUMMARY ***
Total pot $1 | Rake $0
Seat 1: FRkiRasEGlHUeLrEl+k/nA (button) (small blind) collected ($1)
Seat 2: 3Wro85I7472vJ4Wkpneo9A (big blind) folded before Flop



PokerStars Game #59938627090:  Hold'em No Limit ($0.25/$0.50) - 2009/07/01 0:19:33 ET
Table 'mTxf8gPLgffN3Iwfm7Icfg' 2-max Seat #2 is the button
Seat 1: Do9Rlu1R5u/AcRtMTl8SYg ($54.55 in chips)
Seat 2: EMc5LPgVaded4Qc77vm0fw ($107.90 in chips)
EMc5LPgVaded4Qc77vm0fw: posts small blind $0.25
Do9Rlu1R5u/AcRtMTl8SYg: posts big blind $0.50
*** HOLE CARDS ***
EMc5LPgVaded4Qc77vm0fw: folds
Do9Rlu1R5u/AcRtMTl8SYg collected $0.50 from pot
Do9Rlu1R5u/AcRtMTl8SYg: doesn't show hand
*** SUMMARY ***
Total pot $0.50 | Rake $0
Seat 1: Do9Rlu1R5u/AcRtMTl8SYg (big blind) collected ($0.50)
Seat 2: EMc5LPgVaded4Qc77vm0fw (button) (small blind) folded before Flop



PokerStars Game #59938627724:  Hold'em No Limit ($0.25/$0.50) - 2009/07/01 0:19:34 ET
Table 'Nz0Vr7WMHL2g5Uk7dDZjpw' 9-max Seat #5 is the button
Seat 3: 4QTiNH5fteLgJjx/s6Hy6A ($19.90 in chips)
Seat 4: 5JJVDlaiMnB004o/RqbZZQ ($27.50 in chips)
Seat 5: WGW0DgjBUXs1ylURHG8vnQ ($13.60 in chips)
Seat 6: k1f0lS7tlMHCLGs0JT34Tg ($9.50 in chips)
Seat 7: KPLH0gELgFe2OuAnhJFI5w ($20.45 in chips)
Seat 8: HkZI6g4zl83TDTA7SRspmQ ($21.70 in chips)
Seat 9: Ak2W6V2TDVIQrvSAy4eD7Q ($21.40 in chips)
k1f0lS7tlMHCLGs0JT34Tg: posts small blind $0.25
KPLH0gELgFe2OuAnhJFI5w: posts big blind $0.50
XNMDwbXt/Q4jM99AXnbJDw: sits out
*** HOLE CARDS ***
HkZI6g4zl83TDTA7SRspmQ: folds
Ak2W6V2TDVIQrvSAy4eD7Q: raises $1 to $1.50
4QTiNH5fteLgJjx/s6Hy6A: folds
5JJVDlaiMnB004o/RqbZZQ: folds
WGW0DgjBUXs1ylURHG8vnQ: folds
k1f0lS7tlMHCLGs0JT34Tg: folds
KPLH0gELgFe2OuAnhJFI5w: folds
Ak2W6V2TDVIQrvSAy4eD7Q collected $1.25 from pot
*** SUMMARY ***
Total pot $1.25 | Rake $0
Seat 3: 4QTiNH5fteLgJjx/s6Hy6A folded before Flop (didn't bet)
Seat 4: 5JJVDlaiMnB004o/RqbZZQ folded before Flop (didn't bet)
Seat 5: WGW0DgjBUXs1ylURHG8vnQ (button) folded before Flop (didn't bet)
Seat 6: k1f0lS7tlMHCLGs0JT34Tg (small blind) folded before Flop
Seat 7: KPLH0gELgFe2OuAnhJFI5w (big blind) folded before Flop
Seat 8: HkZI6g4zl83TDTA7SRspmQ folded before Flop (didn't bet)
Seat 9: Ak2W6V2TDVIQrvSAy4eD7Q collected ($1.25)



PokerStars Game #59938628604:  Hold'em No Limit ($0.25/$0.50) - 2009/07/01 0:19:35 ET
Table 'X6IRCRTh+20gjz8aubWnwA' 9-max Seat #9 is the button
Seat 2: RjBdQ6w31rgcy0o24VLR6w ($11.90 in chips)
Seat 3: mSD1pginDsyHG5PDfqzphw ($10 in chips)
Seat 4: uw9QayAAxLM3Hb+HR7mSkg ($10.25 in chips)
Seat 5: QtFsO51ArDuQ44+KvR2jow ($30.20 in chips)
Seat 6: /6In1zC3WtgwxDcueWzZWg ($58.10 in chips)
Seat 7: VBnpbzn0dIveV55qKvciew ($53.95 in chips)
Seat 9: M+7+BTmX5vZatHVuoRB1nA ($81.60 in chips)
RjBdQ6w31rgcy0o24VLR6w: posts small blind $0.25
mSD1pginDsyHG5PDfqzphw: posts big blind $0.50
HxeBVq06/3Bh/H986sgdbw: sits out
*** HOLE CARDS ***
uw9QayAAxLM3Hb+HR7mSkg: folds
QtFsO51ArDuQ44+KvR2jow: folds
/6In1zC3WtgwxDcueWzZWg: folds
VBnpbzn0dIveV55qKvciew: folds
M+7+BTmX5vZatHVuoRB1nA: folds
RjBdQ6w31rgcy0o24VLR6w: raises $1 to $1.50
mSD1pginDsyHG5PDfqzphw: folds
RjBdQ6w31rgcy0o24VLR6w collected $1 from pot
RjBdQ6w31rgcy0o24VLR6w: doesn't show hand
*** SUMMARY ***
Total pot $1 | Rake $0
Seat 2: RjBdQ6w31rgcy0o24VLR6w (small blind) collected ($1)
Seat 3: mSD1pginDsyHG5PDfqzphw (big blind) folded before Flop
Seat 4: uw9QayAAxLM3Hb+HR7mSkg folded before Flop (didn't bet)
Seat 5: QtFsO51ArDuQ44+KvR2jow folded before Flop (didn't bet)
Seat 6: /6In1zC3WtgwxDcueWzZWg folded before Flop (didn't bet)
Seat 7: VBnpbzn0dIveV55qKvciew folded before Flop (didn't bet)
Seat 9: M+7+BTmX5vZatHVuoRB1nA (button) folded before Flop (didn't bet)



PokerStars Game #59938628414:  Hold'em No Limit ($0.25/$0.50) - 2009/07/01 0:19:35 ET
Table '+dXkOAQyS8j9PQZusUTMpg' 2-max Seat #1 is the button
Seat 1: XFa6sBGjP2gxoIvxR3fZIg ($52.75 in chips)
Seat 2: 5IBeOgaApY1Bvzv2P8X4EA ($56.70 in chips)
XFa6sBGjP2gxoIvxR3fZIg: posts small blind $0.25
5IBeOgaApY1Bvzv2P8X4EA: posts big blind $0.50
*** HOLE CARDS ***
XFa6sBGjP2gxoIvxR3fZIg: raises $1 to $1.50
5IBeOgaApY1Bvzv2P8X4EA: folds
XFa6sBGjP2gxoIvxR3fZIg collected $1 from pot
*** SUMMARY ***
Total pot $1 | Rake $0
Seat 1: XFa6sBGjP2gxoIvxR3fZIg (button) (small blind) collected ($1)
Seat 2: 5IBeOgaApY1Bvzv2P8X4EA (big blind) folded before Flop



PokerStars Game #59938629900:  Hold'em No Limit ($0.25/$0.50) - 2009/07/01 0:19:37 ET
Table 'raOT4/ipuZgzjfKHC+jD9g' 2-max Seat #1 is the button
Seat 1: IuwLemwLhc9fvrwBGs0AMA ($12.05 in chips)
Seat 2: Udr5juWSWUgTu1NlRhjMdA ($10.35 in chips)
IuwLemwLhc9fvrwBGs0AMA: posts small blind $0.25
Udr5juWSWUgTu1NlRhjMdA: posts big blind $0.50
*** HOLE CARDS ***
IuwLemwLhc9fvrwBGs0AMA: folds
Udr5juWSWUgTu1NlRhjMdA collected $0.50 from pot
Udr5juWSWUgTu1NlRhjMdA: doesn't show hand
*** SUMMARY ***
Total pot $0.50 | Rake $0
Seat 1: IuwLemwLhc9fvrwBGs0AMA (button) (small blind) folded before Flop
Seat 2: Udr5juWSWUgTu1NlRhjMdA (big blind) collected ($0.50)



PokerStars Game #59938630038:  Hold'em No Limit ($0.25/$0.50) - 2009/07/01 0:19:37 ET
Table '37qXEp3oe+er5q4CZip9eQ' 6-max Seat #5 is the button
Seat 1: oqOqoO2AyCZenUghCxMDxw ($50.75 in chips)
Seat 2: g12O9qXTybyo2C0B2bXgjg ($33.25 in chips)
Seat 3: Rt6KgtZ8YaJoTc3FPim00w ($98.15 in chips)
Seat 4: AYb7QG0KzyicbOC0ZROE3Q ($8.75 in chips)
Seat 5: VOmI0x4dDPnTESZd5B4d1Q ($40.55 in chips)
Seat 6: f7zPpUQp9hHZgqhEvrUWQw ($50.90 in chips)
f7zPpUQp9hHZgqhEvrUWQw: posts small blind $0.25
oqOqoO2AyCZenUghCxMDxw: posts big blind $0.50
*** HOLE CARDS ***
g12O9qXTybyo2C0B2bXgjg: folds
Rt6KgtZ8YaJoTc3FPim00w: folds
AYb7QG0KzyicbOC0ZROE3Q: folds
VOmI0x4dDPnTESZd5B4d1Q: folds
f7zPpUQp9hHZgqhEvrUWQw: folds
oqOqoO2AyCZenUghCxMDxw collected $0.50 from pot
*** SUMMARY ***
Total pot $0.50 | Rake $0
Seat 1: oqOqoO2AyCZenUghCxMDxw (big blind) collected ($0.50)
Seat 2: g12O9qXTybyo2C0B2bXgjg folded before Flop (didn't bet)
Seat 3: Rt6KgtZ8YaJoTc3FPim00w folded before Flop (didn't bet)
Seat 4: AYb7QG0KzyicbOC0ZROE3Q folded before Flop (didn't bet)
Seat 5: VOmI0x4dDPnTESZd5B4d1Q (button) folded before Flop (didn't bet)
Seat 6: f7zPpUQp9hHZgqhEvrUWQw (small blind) folded before Flop



PokerStars Game #59938630280:  Hold'em No Limit ($0.25/$0.50) - 2009/07/01 0:19:37 ET
Table 'NCiXr0d5CEKBQr/cZgLhbA' 9-max Seat #4 is the button
Seat 1: RjBdQ6w31rgcy0o24VLR6w ($10 in chips)
Seat 2: ulxuJchBV9iguXg0FUonfg ($40.05 in chips)
Seat 3: xZCXQSXlrZkp3pZizzVXCw ($54.90 in chips)
Seat 4: CL4d+tvzcd4utdQxlPLOmg ($31.05 in chips)
Seat 5: zE9cVigS2nW/Ljy4K4bUQA ($30 in chips)
Seat 6: SKnJuWHScqetA/qG5p+wCg ($31.05 in chips)
Seat 8: 1MJUKc3cc0QmUoz1JZLR2w ($62.35 in chips)
Seat 9: WpvT3OUSiZlpvs+mPXFqtQ ($8.20 in chips)
zE9cVigS2nW/Ljy4K4bUQA: posts small blind $0.25
SKnJuWHScqetA/qG5p+wCg: posts big blind $0.50
M+7+BTmX5vZatHVuoRB1nA: sits out
*** HOLE CARDS ***
1MJUKc3cc0QmUoz1JZLR2w: folds
WpvT3OUSiZlpvs+mPXFqtQ: folds
RjBdQ6w31rgcy0o24VLR6w: folds
ulxuJchBV9iguXg0FUonfg: folds
xZCXQSXlrZkp3pZizzVXCw: raises $1 to $1.50
CL4d+tvzcd4utdQxlPLOmg: folds
zE9cVigS2nW/Ljy4K4bUQA: folds
SKnJuWHScqetA/qG5p+wCg: folds
xZCXQSXlrZkp3pZizzVXCw collected $1.25 from pot
*** SUMMARY ***
Total pot $1.25 | Rake $0
Seat 1: RjBdQ6w31rgcy0o24VLR6w folded before Flop (didn't bet)
Seat 2: ulxuJchBV9iguXg0FUonfg folded before Flop (didn't bet)
Seat 3: xZCXQSXlrZkp3pZizzVXCw collected ($1.25)
Seat 4: CL4d+tvzcd4utdQxlPLOmg (button) folded before Flop (didn't bet)
Seat 5: zE9cVigS2nW/Ljy4K4bUQA (small blind) folded before Flop
Seat 6: SKnJuWHScqetA/qG5p+wCg (big blind) folded before Flop
Seat 8: 1MJUKc3cc0QmUoz1JZLR2w folded before Flop (didn't bet)
Seat 9: WpvT3OUSiZlpvs+mPXFqtQ folded before Flop (didn't bet)



PokerStars Game #59938631762:  Hold'em No Limit ($0.25/$0.50) - 2009/07/01 0:19:40 ET
Table 'mTxf8gPLgffN3Iwfm7Icfg' 2-max Seat #1 is the button
Seat 1: Do9Rlu1R5u/AcRtMTl8SYg ($54.80 in chips)
Seat 2: EMc5LPgVaded4Qc77vm0fw ($107.65 in chips)
Do9Rlu1R5u/AcRtMTl8SYg: posts small blind $0.25
EMc5LPgVaded4Qc77vm0fw: posts big blind $0.50
*** HOLE CARDS ***
Do9Rlu1R5u/AcRtMTl8SYg: raises $1 to $1.50
EMc5LPgVaded4Qc77vm0fw: calls $1
*** FLOP *** [3s Td 2c]
EMc5LPgVaded4Qc77vm0fw: bets $2
Do9Rlu1R5u/AcRtMTl8SYg: folds
EMc5LPgVaded4Qc77vm0fw collected $2.85 from pot
EMc5LPgVaded4Qc77vm0fw: doesn't show hand
*** SUMMARY ***
Total pot $3 | Rake $0.15
Board [3s Td 2c]
Seat 1: Do9Rlu1R5u/AcRtMTl8SYg (button) (small blind) folded on the Flop
Seat 2: EMc5LPgVaded4Qc77vm0fw (big blind) collected ($2.85)



PokerStars Game #59938632866:  Hold'em No Limit ($0.25/$0.50) - 2009/07/01 0:19:41 ET
Table 'ZYwMb9E6tY50Qm+iNbXRYw' 2-max Seat #1 is the button
Seat 1: DXLfRb8KDZWmrztw2bwtFw ($9.35 in chips)
Seat 2: 16tvT7AYgZ2LgiGFcvFKQg ($23.75 in chips)
DXLfRb8KDZWmrztw2bwtFw: posts small blind $0.25
16tvT7AYgZ2LgiGFcvFKQg: posts big blind $0.50
*** HOLE CARDS ***
DXLfRb8KDZWmrztw2bwtFw: calls $0.25
16tvT7AYgZ2LgiGFcvFKQg: checks
*** FLOP *** [Kc 8c 8h]
16tvT7AYgZ2LgiGFcvFKQg: checks
DXLfRb8KDZWmrztw2bwtFw: checks
*** TURN *** [Kc 8c 8h] [2h]
16tvT7AYgZ2LgiGFcvFKQg: checks
DXLfRb8KDZWmrztw2bwtFw: checks
*** RIVER *** [Kc 8c 8h 2h] [3h]
16tvT7AYgZ2LgiGFcvFKQg: checks
DXLfRb8KDZWmrztw2bwtFw: checks
*** SHOW DOWN ***
16tvT7AYgZ2LgiGFcvFKQg: shows [6d Qd] (a pair of Eights)
DXLfRb8KDZWmrztw2bwtFw: mucks hand
16tvT7AYgZ2LgiGFcvFKQg collected $0.95 from pot
*** SUMMARY ***
Total pot $1 | Rake $0.05
Board [Kc 8c 8h 2h 3h]
Seat 1: DXLfRb8KDZWmrztw2bwtFw (button) (small blind) mucked
Seat 2: 16tvT7AYgZ2LgiGFcvFKQg (big blind) showed [6d Qd] and won ($0.95) with a pair of Eights



PokerStars Game #59938632924:  Hold'em No Limit ($0.25/$0.50) - 2009/07/01 0:19:41 ET
Table 'E7bWJ45aoFXRpyRv2gw+Ig' 2-max Seat #2 is the button
Seat 1: FRkiRasEGlHUeLrEl+k/nA ($65.85 in chips)
Seat 2: 3Wro85I7472vJ4Wkpneo9A ($114.05 in chips)
3Wro85I7472vJ4Wkpneo9A: posts small blind $0.25
FRkiRasEGlHUeLrEl+k/nA: posts big blind $0.50
*** HOLE CARDS ***
3Wro85I7472vJ4Wkpneo9A: raises $1 to $1.50
FRkiRasEGlHUeLrEl+k/nA: folds
3Wro85I7472vJ4Wkpneo9A collected $1 from pot
3Wro85I7472vJ4Wkpneo9A: doesn't show hand
*** SUMMARY ***
Total pot $1 | Rake $0
Seat 1: FRkiRasEGlHUeLrEl+k/nA (big blind) folded before Flop
Seat 2: 3Wro85I7472vJ4Wkpneo9A (button) (small blind) collected ($1)



PokerStars Game #59938633082:  Hold'em No Limit ($0.25/$0.50) - 2009/07/01 0:19:41 ET
Table '+dXkOAQyS8j9PQZusUTMpg' 2-max Seat #2 is the button
Seat 1: XFa6sBGjP2gxoIvxR3fZIg ($53.25 in chips)
Seat 2: 5IBeOgaApY1Bvzv2P8X4EA ($56.20 in chips)
5IBeOgaApY1Bvzv2P8X4EA: posts small blind $0.25
XFa6sBGjP2gxoIvxR3fZIg: posts big blind $0.50
*** HOLE CARDS ***
5IBeOgaApY1Bvzv2P8X4EA: calls $0.25
XFa6sBGjP2gxoIvxR3fZIg: raises $2 to $2.50
5IBeOgaApY1Bvzv2P8X4EA: calls $2
*** FLOP *** [6s Kh 9d]
XFa6sBGjP2gxoIvxR3fZIg: bets $3.50
5IBeOgaApY1Bvzv2P8X4EA: folds
XFa6sBGjP2gxoIvxR3fZIg collected $4.75 from pot
XFa6sBGjP2gxoIvxR3fZIg: doesn't show hand
*** SUMMARY ***
Total pot $5 | Rake $0.25
Board [6s Kh 9d]
Seat 1: XFa6sBGjP2gxoIvxR3fZIg (big blind) collected ($4.75)
Seat 2: 5IBeOgaApY1Bvzv2P8X4EA (button) (small blind) folded on the Flop



PokerStars Game #59938633068:  Hold'em No Limit ($0.25/$0.50) - 2009/07/01 0:19:41 ET
Table 'PALRfuH85dr5IkDfdv6new' 9-max Seat #7 is the button
Seat 1: SKnJuWHScqetA/qG5p+wCg ($32.25 in chips)
Seat 2: 9r7ZoBbAJj5IeyZ0q9BdzA ($9.15 in chips)
Seat 3: 50QWoELmpmHFrFIlWMJo9g ($90.20 in chips)
Seat 4: UqQTn9qxH/IQXP1PWD7Gwg ($33.45 in chips)
Seat 5: jSSGUXdNFAZA3QCvTcUMQw ($39.45 in chips)
Seat 6: EiWj2MAl8RNcPhTkzz24Mw ($36.95 in chips)
Seat 7: 3NcyXvr39gnK+KbTq7ezyA ($34.50 in chips)
Seat 8: NkS+CseUKx4XHszWq0PXEQ ($44.60 in chips)
Seat 9: CIrAX/m6o7jYmKOAjJXv4Q ($39.45 in chips)
NkS+CseUKx4XHszWq0PXEQ: posts small blind $0.25
CIrAX/m6o7jYmKOAjJXv4Q: posts big blind $0.50
*** HOLE CARDS ***
SKnJuWHScqetA/qG5p+wCg: folds
9r7ZoBbAJj5IeyZ0q9BdzA: calls $0.50
50QWoELmpmHFrFIlWMJo9g: raises $1.50 to $2
UqQTn9qxH/IQXP1PWD7Gwg: folds
jSSGUXdNFAZA3QCvTcUMQw: folds
EiWj2MAl8RNcPhTkzz24Mw: folds
3NcyXvr39gnK+KbTq7ezyA: calls $2
NkS+CseUKx4XHszWq0PXEQ: folds
CIrAX/m6o7jYmKOAjJXv4Q: calls $1.50
9r7ZoBbAJj5IeyZ0q9BdzA: calls $1.50
*** FLOP *** [7c 9c 3s]
CIrAX/m6o7jYmKOAjJXv4Q: checks
9r7ZoBbAJj5IeyZ0q9BdzA: checks
50QWoELmpmHFrFIlWMJo9g: checks
3NcyXvr39gnK+KbTq7ezyA: checks
*** TURN *** [7c 9c 3s] [8c]
CIrAX/m6o7jYmKOAjJXv4Q: checks
9r7ZoBbAJj5IeyZ0q9BdzA: checks
50QWoELmpmHFrFIlWMJo9g: checks
3NcyXvr39gnK+KbTq7ezyA: checks
*** RIVER *** [7c 9c 3s 8c] [2h]
CIrAX/m6o7jYmKOAjJXv4Q: checks
9r7ZoBbAJj5IeyZ0q9BdzA: checks
50QWoELmpmHFrFIlWMJo9g: checks
3NcyXvr39gnK+KbTq7ezyA: checks
*** SHOW DOWN ***
CIrAX/m6o7jYmKOAjJXv4Q: shows [Ts Ks] (high card King)
9r7ZoBbAJj5IeyZ0q9BdzA: shows [Jc Kh] (high card King - Jack kicker)
50QWoELmpmHFrFIlWMJo9g: shows [Qc As] (high card Ace)
3NcyXvr39gnK+KbTq7ezyA: shows [2c 2d] (three of a kind, Deuces)
3NcyXvr39gnK+KbTq7ezyA collected $7.85 from pot
*** SUMMARY ***
Total pot $8.25 | Rake $0.40
Board [7c 9c 3s 8c 2h]
Seat 1: SKnJuWHScqetA/qG5p+wCg folded before Flop (didn't bet)
Seat 2: 9r7ZoBbAJj5IeyZ0q9BdzA showed [Jc Kh] and lost with high card King
Seat 3: 50QWoELmpmHFrFIlWMJo9g showed [Qc As] and lost with high card Ace
Seat 4: UqQTn9qxH/IQXP1PWD7Gwg folded before Flop (didn't bet)
Seat 5: jSSGUXdNFAZA3QCvTcUMQw folded before Flop (didn't bet)
Seat 6: EiWj2MAl8RNcPhTkzz24Mw folded before Flop (didn't bet)
Seat 7: 3NcyXvr39gnK+KbTq7ezyA (button) showed [2c 2d] and won ($7.85) with three of a kind, Deuces
Seat 8: NkS+CseUKx4XHszWq0PXEQ (small blind) folded before Flop
Seat 9: CIrAX/m6o7jYmKOAjJXv4Q (big blind) showed [Ts Ks] and lost with high card King



PokerStars Game #59938634734:  Hold'em No Limit ($0.25/$0.50) - 2009/07/01 0:19:44 ET
Table 'raOT4/ipuZgzjfKHC+jD9g' 2-max Seat #2 is the button
Seat 1: IuwLemwLhc9fvrwBGs0AMA ($11.80 in chips)
Seat 2: Udr5juWSWUgTu1NlRhjMdA ($10.60 in chips)
Udr5juWSWUgTu1NlRhjMdA: posts small blind $0.25
IuwLemwLhc9fvrwBGs0AMA: posts big blind $0.50
*** HOLE CARDS ***
Udr5juWSWUgTu1NlRhjMdA: folds
IuwLemwLhc9fvrwBGs0AMA collected $0.50 from pot
*** SUMMARY ***
Total pot $0.50 | Rake $0
Seat 1: IuwLemwLhc9fvrwBGs0AMA (big blind) collected ($0.50)
Seat 2: Udr5juWSWUgTu1NlRhjMdA (button) (small blind) folded before Flop



PokerStars Game #59938634914:  Hold'em No Limit ($0.25/$0.50) - 2009/07/01 0:19:44 ET
Table 'T/PgNWqVyY6lkldcBVXYJQ' 6-max Seat #6 is the button
Seat 1: +Pf9jTVizYlIo+woPvptfA ($54 in chips)
Seat 2: oZAeY5rVqNGgt8yyQ0pxbA ($24.35 in chips)
Seat 3: L3OcNO1bgdqDI46j67KQPQ ($56.05 in chips)
Seat 4: jxMvxeUUL9UU0V6wVU+Iyw ($11.20 in chips)
Seat 5: vVQBckETtigfb5mAcyK0OA ($60.25 in chips)
Seat 6: cDzbog6kwmJp+LBeBq+iMQ ($13.10 in chips)
+Pf9jTVizYlIo+woPvptfA: posts small blind $0.25
oZAeY5rVqNGgt8yyQ0pxbA: posts big blind $0.50
*** HOLE CARDS ***
L3OcNO1bgdqDI46j67KQPQ: folds
jxMvxeUUL9UU0V6wVU+Iyw: folds
vVQBckETtigfb5mAcyK0OA: calls $0.50
cDzbog6kwmJp+LBeBq+iMQ said, "in one hand"
cDzbog6kwmJp+LBeBq+iMQ said, "thats how"
cDzbog6kwmJp+LBeBq+iMQ: folds
vVQBckETtigfb5mAcyK0OA said, "I FELT BAD BEING DOWN 80,LOL"
+Pf9jTVizYlIo+woPvptfA: folds
oZAeY5rVqNGgt8yyQ0pxbA: checks
*** FLOP *** [9h 4d 2h]
jxMvxeUUL9UU0V6wVU+Iyw said, "no. tourneys and 4 tables."
oZAeY5rVqNGgt8yyQ0pxbA: checks
vVQBckETtigfb5mAcyK0OA: bets $1
oZAeY5rVqNGgt8yyQ0pxbA: calls $1
*** TURN *** [9h 4d 2h] [8c]
oZAeY5rVqNGgt8yyQ0pxbA: checks
vVQBckETtigfb5mAcyK0OA: bets $2
oZAeY5rVqNGgt8yyQ0pxbA: calls $2
*** RIVER *** [9h 4d 2h 8c] [Qd]
oZAeY5rVqNGgt8yyQ0pxbA: checks
vVQBckETtigfb5mAcyK0OA: checks
*** SHOW DOWN ***
oZAeY5rVqNGgt8yyQ0pxbA: shows [3s As] (high card Ace)
vVQBckETtigfb5mAcyK0OA: shows [Ah 9c] (a pair of Nines)
vVQBckETtigfb5mAcyK0OA collected $6.90 from pot
*** SUMMARY ***
Total pot $7.25 | Rake $0.35
Board [9h 4d 2h 8c Qd]
Seat 1: +Pf9jTVizYlIo+woPvptfA (small blind) folded before Flop
Seat 2: oZAeY5rVqNGgt8yyQ0pxbA (big blind) showed [3s As] and lost with high card Ace
Seat 3: L3OcNO1bgdqDI46j67KQPQ folded before Flop (didn't bet)
Seat 4: jxMvxeUUL9UU0V6wVU+Iyw folded before Flop (didn't bet)
Seat 5: vVQBckETtigfb5mAcyK0OA showed [Ah 9c] and won ($6.90) with a pair of Nines
Seat 6: cDzbog6kwmJp+LBeBq+iMQ (button) folded before Flop (didn't bet)



PokerStars Game #59938636124:  Hold'em No Limit ($0.25/$0.50) - 2009/07/01 0:19:46 ET
Table 'hSTs/dUsYLgJQuF2Onp0MQ' 6-max Seat #3 is the button
Seat 1: Donj3X7gYzeS5pAl7s9f+Q ($26 in chips)
Seat 2: gSCZnZGMgaRWmRw5txyZIA ($7.65 in chips)
Seat 3: vQOrJuXbLC3UZDVklY9bOA ($26.50 in chips)
Seat 4: L0aIPg7qefDQjdJo3HCVEA ($13.20 in chips)
Seat 5: 686aeHikcJlgKkSuIFdcXQ ($60.75 in chips)
Seat 6: +laPa9P7BjZKKnR0n+OmvA ($6.85 in chips)
L0aIPg7qefDQjdJo3HCVEA: posts small blind $0.25
686aeHikcJlgKkSuIFdcXQ: posts big blind $0.50
Donj3X7gYzeS5pAl7s9f+Q: posts big blind $0.50
*** HOLE CARDS ***
+laPa9P7BjZKKnR0n+OmvA: folds
Donj3X7gYzeS5pAl7s9f+Q: checks
gSCZnZGMgaRWmRw5txyZIA: calls $0.50
vQOrJuXbLC3UZDVklY9bOA: folds
L0aIPg7qefDQjdJo3HCVEA: calls $0.25
686aeHikcJlgKkSuIFdcXQ: checks
*** FLOP *** [4h 3d Kh]
L0aIPg7qefDQjdJo3HCVEA: bets $1
686aeHikcJlgKkSuIFdcXQ: raises $3.50 to $4.50
Donj3X7gYzeS5pAl7s9f+Q: folds
gSCZnZGMgaRWmRw5txyZIA: raises $2.65 to $7.15 and is all-in
L0aIPg7qefDQjdJo3HCVEA: calls $6.15
686aeHikcJlgKkSuIFdcXQ: calls $2.65
*** TURN *** [4h 3d Kh] [Qh]
L0aIPg7qefDQjdJo3HCVEA: checks
686aeHikcJlgKkSuIFdcXQ: bets $5.50
L0aIPg7qefDQjdJo3HCVEA: raises $0.05 to $5.55 and is all-in
686aeHikcJlgKkSuIFdcXQ: calls $0.05
*** RIVER *** [4h 3d Kh Qh] [2s]
*** SHOW DOWN ***
L0aIPg7qefDQjdJo3HCVEA: shows [Ks 7s] (a pair of Kings)
686aeHikcJlgKkSuIFdcXQ: shows [Th Kc] (a pair of Kings - Queen+Ten kicker)
686aeHikcJlgKkSuIFdcXQ collected $10.60 from side pot
gSCZnZGMgaRWmRw5txyZIA: mucks hand
686aeHikcJlgKkSuIFdcXQ collected $22.30 from main pot
*** SUMMARY ***
Total pot $34.55 Main pot $22.30. Side pot $10.60. | Rake $1.65
Board [4h 3d Kh Qh 2s]
Seat 1: Donj3X7gYzeS5pAl7s9f+Q folded on the Flop
Seat 2: gSCZnZGMgaRWmRw5txyZIA mucked
Seat 3: vQOrJuXbLC3UZDVklY9bOA (button) folded before Flop (didn't bet)
Seat 4: L0aIPg7qefDQjdJo3HCVEA (small blind) showed [Ks 7s] and lost with a pair of Kings
Seat 5: 686aeHikcJlgKkSuIFdcXQ (big blind) showed [Th Kc] and won ($32.90) with a pair of Kings
Seat 6: +laPa9P7BjZKKnR0n+OmvA folded before Flop (didn't bet)



PokerStars Game #59938637470:  Hold'em No Limit ($0.25/$0.50) - 2009/07/01 0:19:48 ET
Table 'QOgaEqMcJ73pcUMMxoisUg' 6-max Seat #4 is the button
Seat 1: RFefXIDyFvNtJLq+CloCzA ($40.95 in chips)
Seat 2: Im2p1Nt83UKSqv5c9frm4Q ($50 in chips)
Seat 3: wUZNozoIDYf+16hp4nn6dw ($51.90 in chips)
Seat 4: zAcsDhG/T128Vn7XGVSgKg ($53.65 in chips)
Seat 6: s83dnhZ6VC53vY0/f6OV/g ($42.30 in chips)
s83dnhZ6VC53vY0/f6OV/g: posts small blind $0.25
RFefXIDyFvNtJLq+CloCzA: posts big blind $0.50
*** HOLE CARDS ***
Im2p1Nt83UKSqv5c9frm4Q: folds
wUZNozoIDYf+16hp4nn6dw: raises $0.50 to $1
zAcsDhG/T128Vn7XGVSgKg: raises $2.50 to $3.50
s83dnhZ6VC53vY0/f6OV/g: folds
RFefXIDyFvNtJLq+CloCzA: folds
wUZNozoIDYf+16hp4nn6dw: calls $2.50
*** FLOP *** [Qs 2c 5h]
wUZNozoIDYf+16hp4nn6dw: checks
zAcsDhG/T128Vn7XGVSgKg: bets $5
wUZNozoIDYf+16hp4nn6dw: raises $5 to $10
zAcsDhG/T128Vn7XGVSgKg: folds
wUZNozoIDYf+16hp4nn6dw collected $16.90 from pot
*** SUMMARY ***
Total pot $17.75 | Rake $0.85
Board [Qs 2c 5h]
Seat 1: RFefXIDyFvNtJLq+CloCzA (big blind) folded before Flop
Seat 2: Im2p1Nt83UKSqv5c9frm4Q folded before Flop (didn't bet)
Seat 3: wUZNozoIDYf+16hp4nn6dw collected ($16.90)
Seat 4: zAcsDhG/T128Vn7XGVSgKg (button) folded on the Flop
Seat 6: s83dnhZ6VC53vY0/f6OV/g (small blind) folded before Flop



PokerStars Game #59938638372:  Hold'em No Limit ($0.25/$0.50) - 2009/07/01 0:19:49 ET
Table 'lSisgp6H7Fg1hH5VfjEjYQ' 9-max Seat #8 is the button
Seat 1: pEW8B6uXbdR47kfljMQ3+Q ($38.95 in chips)
Seat 2: UrcnkQOiLVk8BlKDPJSy7Q ($51.10 in chips)
Seat 3: aTkyjTh3w5YLWiIERupZOA ($37.75 in chips)
Seat 4: nvw9yQKhJT56lA9k+TLdhw ($11.25 in chips)
Seat 5: mSD1pginDsyHG5PDfqzphw ($10 in chips)
Seat 6: +k7T5ocke8UwavtgUHm+Cg ($26.60 in chips)
Seat 7: dGw5MBstXyXhWHHVFOWOFA ($43 in chips)
Seat 8: a4JDWmpFQkL10XfAyuF51A ($26.20 in chips)
Seat 9: 5JJVDlaiMnB004o/RqbZZQ ($40.30 in chips)
5JJVDlaiMnB004o/RqbZZQ: posts small blind $0.25
pEW8B6uXbdR47kfljMQ3+Q: posts big blind $0.50
*** HOLE CARDS ***
UrcnkQOiLVk8BlKDPJSy7Q has timed out
UrcnkQOiLVk8BlKDPJSy7Q: folds
UrcnkQOiLVk8BlKDPJSy7Q is sitting out
UrcnkQOiLVk8BlKDPJSy7Q has returned
aTkyjTh3w5YLWiIERupZOA: raises $1 to $1.50
nvw9yQKhJT56lA9k+TLdhw: folds
mSD1pginDsyHG5PDfqzphw: folds
+k7T5ocke8UwavtgUHm+Cg: folds
dGw5MBstXyXhWHHVFOWOFA: folds
a4JDWmpFQkL10XfAyuF51A: calls $1.50
5JJVDlaiMnB004o/RqbZZQ: calls $1.25
pEW8B6uXbdR47kfljMQ3+Q: folds
*** FLOP *** [Ah As 9c]
5JJVDlaiMnB004o/RqbZZQ: checks
aTkyjTh3w5YLWiIERupZOA: checks
a4JDWmpFQkL10XfAyuF51A: checks
*** TURN *** [Ah As 9c] [Qs]
5JJVDlaiMnB004o/RqbZZQ: bets $1
aTkyjTh3w5YLWiIERupZOA: calls $1
a4JDWmpFQkL10XfAyuF51A: folds
*** RIVER *** [Ah As 9c Qs] [9s]
5JJVDlaiMnB004o/RqbZZQ: bets $1
pEW8B6uXbdR47kfljMQ3+Q is disconnected
pEW8B6uXbdR47kfljMQ3+Q is connected
aTkyjTh3w5YLWiIERupZOA: raises $2 to $3
5JJVDlaiMnB004o/RqbZZQ: calls $2
*** SHOW DOWN ***
aTkyjTh3w5YLWiIERupZOA: shows [Ac 7s] (a full house, Aces full of Nines)
5JJVDlaiMnB004o/RqbZZQ: shows [4d Ad] (a full house, Aces full of Nines)
5JJVDlaiMnB004o/RqbZZQ collected $6.20 from pot
aTkyjTh3w5YLWiIERupZOA collected $6.20 from pot
*** SUMMARY ***
Total pot $13 | Rake $0.60
Board [Ah As 9c Qs 9s]
Seat 1: pEW8B6uXbdR47kfljMQ3+Q (big blind) folded before Flop
Seat 2: UrcnkQOiLVk8BlKDPJSy7Q folded before Flop (didn't bet)
Seat 3: aTkyjTh3w5YLWiIERupZOA showed [Ac 7s] and won ($6.20) with a full house, Aces full of Nines
Seat 4: nvw9yQKhJT56lA9k+TLdhw folded before Flop (didn't bet)
Seat 5: mSD1pginDsyHG5PDfqzphw folded before Flop (didn't bet)
Seat 6: +k7T5ocke8UwavtgUHm+Cg folded before Flop (didn't bet)
Seat 7: dGw5MBstXyXhWHHVFOWOFA folded before Flop (didn't bet)
Seat 8: a4JDWmpFQkL10XfAyuF51A (button) folded on the Turn
Seat 9: 5JJVDlaiMnB004o/RqbZZQ (small blind) showed [4d Ad] and won ($6.20) with a full house, Aces full of Nines



PokerStars Game #59938638560:  Hold'em No Limit ($0.25/$0.50) - 2009/07/01 0:19:49 ET
Table 'MJxeZCzYELxiIsyUZyT0jw' 6-max Seat #1 is the button
Seat 1: iKPos8JI094Tomq4tDSgnQ ($33.50 in chips)
Seat 2: r6H1GiZ6QIpMTDhyodKuRQ ($64.15 in chips)
Seat 3: JQZew0FjzS19kTjeNtrE+A ($50 in chips)
Seat 4: lP7Q6pewz4C2RsAfKsjdWw ($27.95 in chips)
Seat 5: 3jvoOXNtXE90w2BdfNZwZQ ($50 in chips)
Seat 6: TTx3CHxyi0SObcHyMJRp5w ($50.50 in chips)
r6H1GiZ6QIpMTDhyodKuRQ: posts small blind $0.25
JQZew0FjzS19kTjeNtrE+A: posts big blind $0.50
*** HOLE CARDS ***
lP7Q6pewz4C2RsAfKsjdWw: folds
3jvoOXNtXE90w2BdfNZwZQ: folds
TTx3CHxyi0SObcHyMJRp5w: folds
iKPos8JI094Tomq4tDSgnQ: folds
r6H1GiZ6QIpMTDhyodKuRQ: folds
JQZew0FjzS19kTjeNtrE+A collected $0.50 from pot
*** SUMMARY ***
Total pot $0.50 | Rake $0
Seat 1: iKPos8JI094Tomq4tDSgnQ (button) folded before Flop (didn't bet)
Seat 2: r6H1GiZ6QIpMTDhyodKuRQ (small blind) folded before Flop
Seat 3: JQZew0FjzS19kTjeNtrE+A (big blind) collected ($0.50)
Seat 4: lP7Q6pewz4C2RsAfKsjdWw folded before Flop (didn't bet)
Seat 5: 3jvoOXNtXE90w2BdfNZwZQ folded before Flop (didn't bet)
Seat 6: TTx3CHxyi0SObcHyMJRp5w folded before Flop (didn't bet)



PokerStars Game #59938639278:  Hold'em No Limit ($0.25/$0.50) - 2009/07/01 0:19:50 ET
Table 'kgbJRsxfv64KrErDRBAkcw' 6-max Seat #6 is the button
Seat 1: N7O9jUEx2YiQn1+yRYTHmw ($19.20 in chips)
Seat 2: Q+thC23WCv1kJUJtH/+4Jw ($41.80 in chips)
Seat 3: T0Gx/FcQ5VH9u7XaOMX97A ($60.25 in chips)
Seat 4: qanMEqjABjWxC/JgQ/0l7w ($56.70 in chips)
Seat 5: +Pf9jTVizYlIo+woPvptfA ($50 in chips)
Seat 6: DDfYzIrYT0t5R/hAJngtsg ($25.80 in chips)
N7O9jUEx2YiQn1+yRYTHmw: posts small blind $0.25
Q+thC23WCv1kJUJtH/+4Jw: posts big blind $0.50
*** HOLE CARDS ***
T0Gx/FcQ5VH9u7XaOMX97A: folds
qanMEqjABjWxC/JgQ/0l7w: folds
+Pf9jTVizYlIo+woPvptfA: folds
DDfYzIrYT0t5R/hAJngtsg: calls $0.50
N7O9jUEx2YiQn1+yRYTHmw: calls $0.25
Q+thC23WCv1kJUJtH/+4Jw: checks
*** FLOP *** [Ac 6s 6d]
N7O9jUEx2YiQn1+yRYTHmw: checks
Q+thC23WCv1kJUJtH/+4Jw: checks
DDfYzIrYT0t5R/hAJngtsg: checks
*** TURN *** [Ac 6s 6d] [Js]
N7O9jUEx2YiQn1+yRYTHmw: checks
Q+thC23WCv1kJUJtH/+4Jw: checks
DDfYzIrYT0t5R/hAJngtsg: checks
*** RIVER *** [Ac 6s 6d Js] [5h]
N7O9jUEx2YiQn1+yRYTHmw: bets $1
Q+thC23WCv1kJUJtH/+4Jw: folds
DDfYzIrYT0t5R/hAJngtsg: raises $3.50 to $4.50
N7O9jUEx2YiQn1+yRYTHmw: folds
DDfYzIrYT0t5R/hAJngtsg collected $3.35 from pot
*** SUMMARY ***
Total pot $3.50 | Rake $0.15
Board [Ac 6s 6d Js 5h]
Seat 1: N7O9jUEx2YiQn1+yRYTHmw (small blind) folded on the River
Seat 2: Q+thC23WCv1kJUJtH/+4Jw (big blind) folded on the River
Seat 3: T0Gx/FcQ5VH9u7XaOMX97A folded before Flop (didn't bet)
Seat 4: qanMEqjABjWxC/JgQ/0l7w folded before Flop (didn't bet)
Seat 5: +Pf9jTVizYlIo+woPvptfA folded before Flop (didn't bet)
Seat 6: DDfYzIrYT0t5R/hAJngtsg (button) collected ($3.35)



PokerStars Game #59938638726:  Hold'em No Limit ($0.25/$0.50) - 2009/07/01 0:19:50 ET
Table 'E7bWJ45aoFXRpyRv2gw+Ig' 2-max Seat #1 is the button
Seat 1: FRkiRasEGlHUeLrEl+k/nA ($65.35 in chips)
Seat 2: 3Wro85I7472vJ4Wkpneo9A ($114.55 in chips)
FRkiRasEGlHUeLrEl+k/nA: posts small blind $0.25
3Wro85I7472vJ4Wkpneo9A: posts big blind $0.50
*** HOLE CARDS ***
FRkiRasEGlHUeLrEl+k/nA: folds
3Wro85I7472vJ4Wkpneo9A collected $0.50 from pot
3Wro85I7472vJ4Wkpneo9A: doesn't show hand
*** SUMMARY ***
Total pot $0.50 | Rake $0
Seat 1: FRkiRasEGlHUeLrEl+k/nA (button) (small blind) folded before Flop
Seat 2: 3Wro85I7472vJ4Wkpneo9A (big blind) collected ($0.50)



PokerStars Game #59938639004:  Hold'em No Limit ($0.25/$0.50) - 2009/07/01 0:19:50 ET
Table 'c/CRn+68J3Y8KxD5g1ek2Q' 2-max Seat #1 is the button
Seat 1: 46qCyJ6evTkHo9al5sBMNA ($271.90 in chips)
Seat 2: BypVLsYQt3ePFm2xQL/dOA ($111 in chips)
46qCyJ6evTkHo9al5sBMNA: posts small blind $0.25
BypVLsYQt3ePFm2xQL/dOA: posts big blind $0.50
*** HOLE CARDS ***
46qCyJ6evTkHo9al5sBMNA: folds
BypVLsYQt3ePFm2xQL/dOA collected $0.50 from pot
BypVLsYQt3ePFm2xQL/dOA: doesn't show hand
*** SUMMARY ***
Total pot $0.50 | Rake $0
Seat 1: 46qCyJ6evTkHo9al5sBMNA (button) (small blind) folded before Flop
Seat 2: BypVLsYQt3ePFm2xQL/dOA (big blind) collected ($0.50)



PokerStars Game #59938639236:  Hold'em No Limit ($0.25/$0.50) - 2009/07/01 0:19:50 ET
Table 'raOT4/ipuZgzjfKHC+jD9g' 2-max Seat #1 is the button
Seat 1: IuwLemwLhc9fvrwBGs0AMA ($12.05 in chips)
Seat 2: Udr5juWSWUgTu1NlRhjMdA ($10.35 in chips)
IuwLemwLhc9fvrwBGs0AMA: posts small blind $0.25
Udr5juWSWUgTu1NlRhjMdA: posts big blind $0.50
*** HOLE CARDS ***
IuwLemwLhc9fvrwBGs0AMA: raises $1 to $1.50
Udr5juWSWUgTu1NlRhjMdA: folds
IuwLemwLhc9fvrwBGs0AMA collected $1 from pot
IuwLemwLhc9fvrwBGs0AMA: doesn't show hand
*** SUMMARY ***
Total pot $1 | Rake $0
Seat 1: IuwLemwLhc9fvrwBGs0AMA (button) (small blind) collected ($1)
Seat 2: Udr5juWSWUgTu1NlRhjMdA (big blind) folded before Flop



PokerStars Game #59938640650:  Hold'em No Limit ($0.25/$0.50) - 2009/07/01 0:19:52 ET
Table '5EmHi+fnatGQQShcNmzOZQ' 6-max Seat #6 is the button
Seat 1: SwPczQo3cOtwEzhJrfO2cQ ($27.20 in chips)
Seat 3: L9qfLYXrczhAPd/VckgsWw ($59.50 in chips)
Seat 4: wOyVV9M/oyiw3YaOjNZ05w ($50 in chips)
Seat 5: kxPhs4ePFqMy52CInAJ2aw ($49.25 in chips)
Seat 6: 686aeHikcJlgKkSuIFdcXQ ($157.35 in chips)
SwPczQo3cOtwEzhJrfO2cQ: posts small blind $0.25
L9qfLYXrczhAPd/VckgsWw: posts big blind $0.50
*** HOLE CARDS ***
wOyVV9M/oyiw3YaOjNZ05w: folds
kxPhs4ePFqMy52CInAJ2aw: folds
686aeHikcJlgKkSuIFdcXQ: folds
SwPczQo3cOtwEzhJrfO2cQ: calls $0.25
L9qfLYXrczhAPd/VckgsWw: raises $1.50 to $2
SwPczQo3cOtwEzhJrfO2cQ: folds
L9qfLYXrczhAPd/VckgsWw collected $1 from pot
L9qfLYXrczhAPd/VckgsWw: doesn't show hand
*** SUMMARY ***
Total pot $1 | Rake $0
Seat 1: SwPczQo3cOtwEzhJrfO2cQ (small blind) folded before Flop
Seat 3: L9qfLYXrczhAPd/VckgsWw (big blind) collected ($1)
Seat 4: wOyVV9M/oyiw3YaOjNZ05w folded before Flop (didn't bet)
Seat 5: kxPhs4ePFqMy52CInAJ2aw folded before Flop (didn't bet)
Seat 6: 686aeHikcJlgKkSuIFdcXQ (button) folded before Flop (didn't bet)



PokerStars Game #59938641850:  Hold'em No Limit ($0.25/$0.50) - 2009/07/01 0:19:54 ET
Table 'mTxf8gPLgffN3Iwfm7Icfg' 2-max Seat #2 is the button
Seat 1: Do9Rlu1R5u/AcRtMTl8SYg ($53.30 in chips)
Seat 2: EMc5LPgVaded4Qc77vm0fw ($109 in chips)
EMc5LPgVaded4Qc77vm0fw: posts small blind $0.25
Do9Rlu1R5u/AcRtMTl8SYg: posts big blind $0.50
*** HOLE CARDS ***
EMc5LPgVaded4Qc77vm0fw: folds
Do9Rlu1R5u/AcRtMTl8SYg collected $0.50 from pot
Do9Rlu1R5u/AcRtMTl8SYg: doesn't show hand
*** SUMMARY ***
Total pot $0.50 | Rake $0
Seat 1: Do9Rlu1R5u/AcRtMTl8SYg (big blind) collected ($0.50)
Seat 2: EMc5LPgVaded4Qc77vm0fw (button) (small blind) folded before Flop



PokerStars Game #59938642180:  Hold'em No Limit ($0.25/$0.50) - 2009/07/01 0:19:55 ET
Table '37qXEp3oe+er5q4CZip9eQ' 6-max Seat #6 is the button
Seat 1: oqOqoO2AyCZenUghCxMDxw ($51 in chips)
Seat 3: Rt6KgtZ8YaJoTc3FPim00w ($98.15 in chips)
Seat 4: AYb7QG0KzyicbOC0ZROE3Q ($8.75 in chips)
Seat 5: VOmI0x4dDPnTESZd5B4d1Q ($40.55 in chips)
Seat 6: f7zPpUQp9hHZgqhEvrUWQw ($50.65 in chips)
oqOqoO2AyCZenUghCxMDxw: posts small blind $0.25
g12O9qXTybyo2C0B2bXgjg: is sitting out
Rt6KgtZ8YaJoTc3FPim00w: posts big blind $0.50
*** HOLE CARDS ***
AYb7QG0KzyicbOC0ZROE3Q: folds
VOmI0x4dDPnTESZd5B4d1Q: folds
f7zPpUQp9hHZgqhEvrUWQw: folds
oqOqoO2AyCZenUghCxMDxw: raises $1 to $1.50
Rt6KgtZ8YaJoTc3FPim00w: folds
oqOqoO2AyCZenUghCxMDxw collected $1 from pot
*** SUMMARY ***
Total pot $1 | Rake $0
Seat 1: oqOqoO2AyCZenUghCxMDxw (small blind) collected ($1)
Seat 3: Rt6KgtZ8YaJoTc3FPim00w (big blind) folded before Flop
Seat 4: AYb7QG0KzyicbOC0ZROE3Q folded before Flop (didn't bet)
Seat 5: VOmI0x4dDPnTESZd5B4d1Q folded before Flop (didn't bet)
Seat 6: f7zPpUQp9hHZgqhEvrUWQw (button) folded before Flop (didn't bet)



PokerStars Game #59938643030:  Hold'em No Limit ($0.25/$0.50) - 2009/07/01 0:19:56 ET
Table 'IeNZOZQ4T6oiaHqFeo6yIA' 2-max Seat #2 is the button
Seat 1: ndd1nfncBkWNitBnsfCoVQ ($67.85 in chips)
Seat 2: A91IUl5JaZROhtfCtnnwYw ($19.05 in chips)
A91IUl5JaZROhtfCtnnwYw: posts small blind $0.25
ndd1nfncBkWNitBnsfCoVQ: posts big blind $0.50
*** HOLE CARDS ***
A91IUl5JaZROhtfCtnnwYw: calls $0.25
ndd1nfncBkWNitBnsfCoVQ: raises $1.50 to $2
A91IUl5JaZROhtfCtnnwYw: calls $1.50
*** FLOP *** [5c 4d Jh]
ndd1nfncBkWNitBnsfCoVQ: bets $2.50
A91IUl5JaZROhtfCtnnwYw: calls $2.50
*** TURN *** [5c 4d Jh] [9c]
ndd1nfncBkWNitBnsfCoVQ: checks
A91IUl5JaZROhtfCtnnwYw: folds
ndd1nfncBkWNitBnsfCoVQ collected $8.60 from pot
ndd1nfncBkWNitBnsfCoVQ: doesn't show hand
*** SUMMARY ***
Total pot $9 | Rake $0.40
Board [5c 4d Jh 9c]
Seat 1: ndd1nfncBkWNitBnsfCoVQ (big blind) collected ($8.60)
Seat 2: A91IUl5JaZROhtfCtnnwYw (button) (small blind) folded on the Turn



PokerStars Game #59938643808:  Hold'em No Limit ($0.25/$0.50) - 2009/07/01 0:19:57 ET
Table 'ZYwMb9E6tY50Qm+iNbXRYw' 2-max Seat #2 is the button
Seat 1: DXLfRb8KDZWmrztw2bwtFw ($8.85 in chips)
Seat 2: 16tvT7AYgZ2LgiGFcvFKQg ($24.20 in chips)
16tvT7AYgZ2LgiGFcvFKQg: posts small blind $0.25
DXLfRb8KDZWmrztw2bwtFw: posts big blind $0.50
*** HOLE CARDS ***
16tvT7AYgZ2LgiGFcvFKQg: calls $0.25
DXLfRb8KDZWmrztw2bwtFw: checks
*** FLOP *** [Ad 5d Jd]
DXLfRb8KDZWmrztw2bwtFw: bets $5
16tvT7AYgZ2LgiGFcvFKQg: folds
DXLfRb8KDZWmrztw2bwtFw collected $0.95 from pot
DXLfRb8KDZWmrztw2bwtFw: doesn't show hand
*** SUMMARY ***
Total pot $1 | Rake $0.05
Board [Ad 5d Jd]
Seat 1: DXLfRb8KDZWmrztw2bwtFw (big blind) collected ($0.95)
Seat 2: 16tvT7AYgZ2LgiGFcvFKQg (button) (small blind) folded on the Flop



PokerStars Game #59938644164:  Hold'em No Limit ($0.25/$0.50) - 2009/07/01 0:19:57 ET
Table 'c/CRn+68J3Y8KxD5g1ek2Q' 2-max Seat #2 is the button
Seat 1: 46qCyJ6evTkHo9al5sBMNA ($271.65 in chips)
Seat 2: BypVLsYQt3ePFm2xQL/dOA ($111.25 in chips)
BypVLsYQt3ePFm2xQL/dOA: posts small blind $0.25
46qCyJ6evTkHo9al5sBMNA: posts big blind $0.50
*** HOLE CARDS ***
BypVLsYQt3ePFm2xQL/dOA: raises $1 to $1.50
46qCyJ6evTkHo9al5sBMNA: raises $3.50 to $5
BypVLsYQt3ePFm2xQL/dOA: calls $3.50
*** FLOP *** [Ks Qc 5d]
46qCyJ6evTkHo9al5sBMNA: bets $5
BypVLsYQt3ePFm2xQL/dOA: folds
46qCyJ6evTkHo9al5sBMNA collected $9.50 from pot
46qCyJ6evTkHo9al5sBMNA: doesn't show hand
*** SUMMARY ***
Total pot $10 | Rake $0.50
Board [Ks Qc 5d]
Seat 1: 46qCyJ6evTkHo9al5sBMNA (big blind) collected ($9.50)
Seat 2: BypVLsYQt3ePFm2xQL/dOA (button) (small blind) folded on the Flop



PokerStars Game #59938643594:  Hold'em No Limit ($0.25/$0.50) - 2009/07/01 0:19:57 ET
Table 'X6IRCRTh+20gjz8aubWnwA' 9-max Seat #2 is the button
Seat 2: RjBdQ6w31rgcy0o24VLR6w ($12.40 in chips)
Seat 3: mSD1pginDsyHG5PDfqzphw ($10 in chips)
Seat 4: uw9QayAAxLM3Hb+HR7mSkg ($10.25 in chips)
Seat 5: QtFsO51ArDuQ44+KvR2jow ($30.20 in chips)
Seat 6: /6In1zC3WtgwxDcueWzZWg ($58.10 in chips)
Seat 7: VBnpbzn0dIveV55qKvciew ($53.95 in chips)
Seat 9: M+7+BTmX5vZatHVuoRB1nA ($81.60 in chips)
mSD1pginDsyHG5PDfqzphw: posts small blind $0.25
uw9QayAAxLM3Hb+HR7mSkg: posts big blind $0.50
HxeBVq06/3Bh/H986sgdbw: sits out
*** HOLE CARDS ***
QtFsO51ArDuQ44+KvR2jow: folds
/6In1zC3WtgwxDcueWzZWg: folds
VBnpbzn0dIveV55qKvciew: folds
M+7+BTmX5vZatHVuoRB1nA: folds
RjBdQ6w31rgcy0o24VLR6w: folds
mSD1pginDsyHG5PDfqzphw: folds
uw9QayAAxLM3Hb+HR7mSkg collected $0.50 from pot
uw9QayAAxLM3Hb+HR7mSkg: doesn't show hand
*** SUMMARY ***
Total pot $0.50 | Rake $0
Seat 2: RjBdQ6w31rgcy0o24VLR6w (button) folded before Flop (didn't bet)
Seat 3: mSD1pginDsyHG5PDfqzphw (small blind) folded before Flop
Seat 4: uw9QayAAxLM3Hb+HR7mSkg (big blind) collected ($0.50)
Seat 5: QtFsO51ArDuQ44+KvR2jow folded before Flop (didn't bet)
Seat 6: /6In1zC3WtgwxDcueWzZWg folded before Flop (didn't bet)
Seat 7: VBnpbzn0dIveV55qKvciew folded before Flop (didn't bet)
Seat 9: M+7+BTmX5vZatHVuoRB1nA folded before Flop (didn't bet)



PokerStars Game #59938644710:  Hold'em No Limit ($0.25/$0.50) - 2009/07/01 0:19:58 ET
Table 'E7bWJ45aoFXRpyRv2gw+Ig' 2-max Seat #2 is the button
Seat 1: FRkiRasEGlHUeLrEl+k/nA ($65.10 in chips)
Seat 2: 3Wro85I7472vJ4Wkpneo9A ($114.80 in chips)
3Wro85I7472vJ4Wkpneo9A: posts small blind $0.25
FRkiRasEGlHUeLrEl+k/nA: posts big blind $0.50
*** HOLE CARDS ***
3Wro85I7472vJ4Wkpneo9A: calls $0.25
FRkiRasEGlHUeLrEl+k/nA: raises $1.50 to $2
3Wro85I7472vJ4Wkpneo9A: calls $1.50
*** FLOP *** [Qh 5c Kc]
FRkiRasEGlHUeLrEl+k/nA: checks
3Wro85I7472vJ4Wkpneo9A: bets $2.50
FRkiRasEGlHUeLrEl+k/nA: folds
3Wro85I7472vJ4Wkpneo9A collected $3.80 from pot
3Wro85I7472vJ4Wkpneo9A: doesn't show hand
*** SUMMARY ***
Total pot $4 | Rake $0.20
Board [Qh 5c Kc]
Seat 1: FRkiRasEGlHUeLrEl+k/nA (big blind) folded on the Flop
Seat 2: 3Wro85I7472vJ4Wkpneo9A (button) (small blind) collected ($3.80)



PokerStars Game #59938645278:  Hold'em No Limit ($0.25/$0.50) - 2009/07/01 0:19:59 ET
Table '+dXkOAQyS8j9PQZusUTMpg' 2-max Seat #1 is the button
Seat 1: XFa6sBGjP2gxoIvxR3fZIg ($55.50 in chips)
Seat 2: 5IBeOgaApY1Bvzv2P8X4EA ($53.70 in chips)
XFa6sBGjP2gxoIvxR3fZIg: posts small blind $0.25
5IBeOgaApY1Bvzv2P8X4EA: posts big blind $0.50
*** HOLE CARDS ***
XFa6sBGjP2gxoIvxR3fZIg: raises $1 to $1.50
5IBeOgaApY1Bvzv2P8X4EA: raises $2 to $3.50
XFa6sBGjP2gxoIvxR3fZIg: calls $2
*** FLOP *** [Qs 6d Qh]
5IBeOgaApY1Bvzv2P8X4EA: checks
XFa6sBGjP2gxoIvxR3fZIg: checks
*** TURN *** [Qs 6d Qh] [2s]
5IBeOgaApY1Bvzv2P8X4EA: bets $2.50
XFa6sBGjP2gxoIvxR3fZIg: raises $6 to $8.50
5IBeOgaApY1Bvzv2P8X4EA: calls $6
*** RIVER *** [Qs 6d Qh 2s] [4h]
5IBeOgaApY1Bvzv2P8X4EA: checks
XFa6sBGjP2gxoIvxR3fZIg: checks
*** SHOW DOWN ***
5IBeOgaApY1Bvzv2P8X4EA: shows [7s Ah] (a pair of Queens)
XFa6sBGjP2gxoIvxR3fZIg: shows [As Js] (a pair of Queens - Ace+Jack kicker)
XFa6sBGjP2gxoIvxR3fZIg collected $23.50 from pot
*** SUMMARY ***
Total pot $24 | Rake $0.50
Board [Qs 6d Qh 2s 4h]
Seat 1: XFa6sBGjP2gxoIvxR3fZIg (button) (small blind) showed [As Js] and won ($23.50) with a pair of Queens
Seat 2: 5IBeOgaApY1Bvzv2P8X4EA (big blind) showed [7s Ah] and lost with a pair of Queens



PokerStars Game #59938646242:  Hold'em No Limit ($0.25/$0.50) - 2009/07/01 0:20:00 ET
Table 'mTxf8gPLgffN3Iwfm7Icfg' 2-max Seat #1 is the button
Seat 1: Do9Rlu1R5u/AcRtMTl8SYg ($53.55 in chips)
Seat 2: EMc5LPgVaded4Qc77vm0fw ($108.75 in chips)
Do9Rlu1R5u/AcRtMTl8SYg: posts small blind $0.25
EMc5LPgVaded4Qc77vm0fw: posts big blind $0.50
*** HOLE CARDS ***
Do9Rlu1R5u/AcRtMTl8SYg: raises $1 to $1.50
EMc5LPgVaded4Qc77vm0fw: calls $1
*** FLOP *** [Ah Ks 7h]
EMc5LPgVaded4Qc77vm0fw: bets $2
Do9Rlu1R5u/AcRtMTl8SYg: raises $4 to $6
EMc5LPgVaded4Qc77vm0fw: calls $4
*** TURN *** [Ah Ks 7h] [8s]
EMc5LPgVaded4Qc77vm0fw: checks
Do9Rlu1R5u/AcRtMTl8SYg: bets $11
EMc5LPgVaded4Qc77vm0fw: folds
Do9Rlu1R5u/AcRtMTl8SYg collected $14.50 from pot
Do9Rlu1R5u/AcRtMTl8SYg: doesn't show hand
*** SUMMARY ***
Total pot $15 | Rake $0.50
Board [Ah Ks 7h 8s]
Seat 1: Do9Rlu1R5u/AcRtMTl8SYg (button) (small blind) collected ($14.50)
Seat 2: EMc5LPgVaded4Qc77vm0fw (big blind) folded on the Turn



PokerStars Game #59938646964:  Hold'em No Limit ($0.25/$0.50) - 2009/07/01 0:20:01 ET
Table 'raOT4/ipuZgzjfKHC+jD9g' 2-max Seat #2 is the button
Seat 1: IuwLemwLhc9fvrwBGs0AMA ($12.55 in chips)
Seat 2: Udr5juWSWUgTu1NlRhjMdA ($9.85 in chips)
Udr5juWSWUgTu1NlRhjMdA: posts small blind $0.25
IuwLemwLhc9fvrwBGs0AMA: posts big blind $0.50
*** HOLE CARDS ***
Udr5juWSWUgTu1NlRhjMdA: folds
IuwLemwLhc9fvrwBGs0AMA collected $0.50 from pot
IuwLemwLhc9fvrwBGs0AMA: doesn't show hand
*** SUMMARY ***
Total pot $0.50 | Rake $0
Seat 1: IuwLemwLhc9fvrwBGs0AMA (big blind) collected ($0.50)
Seat 2: Udr5juWSWUgTu1NlRhjMdA (button) (small blind) folded before Flop



PokerStars Game #59938647332:  Hold'em No Limit ($0.25/$0.50) - 2009/07/01 0:20:02 ET
Table 'MJxeZCzYELxiIsyUZyT0jw' 6-max Seat #2 is the button
Seat 1: iKPos8JI094Tomq4tDSgnQ ($33.50 in chips)
Seat 2: r6H1GiZ6QIpMTDhyodKuRQ ($63.90 in chips)
Seat 3: JQZew0FjzS19kTjeNtrE+A ($50.25 in chips)
Seat 4: lP7Q6pewz4C2RsAfKsjdWw ($27.95 in chips)
Seat 5: 3jvoOXNtXE90w2BdfNZwZQ ($50 in chips)
Seat 6: TTx3CHxyi0SObcHyMJRp5w ($50.50 in chips)
JQZew0FjzS19kTjeNtrE+A: posts small blind $0.25
lP7Q6pewz4C2RsAfKsjdWw: posts big blind $0.50
*** HOLE CARDS ***
3jvoOXNtXE90w2BdfNZwZQ: raises $1.50 to $2
TTx3CHxyi0SObcHyMJRp5w: folds
iKPos8JI094Tomq4tDSgnQ: folds
r6H1GiZ6QIpMTDhyodKuRQ: folds
JQZew0FjzS19kTjeNtrE+A: folds
lP7Q6pewz4C2RsAfKsjdWw: calls $1.50
*** FLOP *** [Td 2s 5s]
lP7Q6pewz4C2RsAfKsjdWw: checks
3jvoOXNtXE90w2BdfNZwZQ: bets $2.50
lP7Q6pewz4C2RsAfKsjdWw: calls $2.50
*** TURN *** [Td 2s 5s] [Qh]
lP7Q6pewz4C2RsAfKsjdWw: checks
3jvoOXNtXE90w2BdfNZwZQ: checks
*** RIVER *** [Td 2s 5s Qh] [Qc]
lP7Q6pewz4C2RsAfKsjdWw: checks
3jvoOXNtXE90w2BdfNZwZQ: checks
*** SHOW DOWN ***
lP7Q6pewz4C2RsAfKsjdWw: shows [Ks Qs] (three of a kind, Queens)
3jvoOXNtXE90w2BdfNZwZQ: mucks hand
lP7Q6pewz4C2RsAfKsjdWw collected $8.80 from pot
*** SUMMARY ***
Total pot $9.25 | Rake $0.45
Board [Td 2s 5s Qh Qc]
Seat 1: iKPos8JI094Tomq4tDSgnQ folded before Flop (didn't bet)
Seat 2: r6H1GiZ6QIpMTDhyodKuRQ (button) folded before Flop (didn't bet)
Seat 3: JQZew0FjzS19kTjeNtrE+A (small blind) folded before Flop
Seat 4: lP7Q6pewz4C2RsAfKsjdWw (big blind) showed [Ks Qs] and won ($8.80) with three of a kind, Queens
Seat 5: 3jvoOXNtXE90w2BdfNZwZQ mucked
Seat 6: TTx3CHxyi0SObcHyMJRp5w folded before Flop (didn't bet)



PokerStars Game #59938647296:  Hold'em No Limit ($0.25/$0.50) - 2009/07/01 0:20:02 ET
Table 'ibNfFy0bCzuBaUORla0aGw' 9-max Seat #9 is the button
Seat 2: 90Wb75h3W1BRpbqVnuk8gw ($54.80 in chips)
Seat 3: dDaHs3X8+fe3bIkRU0cbrw ($27.25 in chips)
Seat 4: YBN054X4blmis+B2bBlC0g ($18.55 in chips)
Seat 5: FRv75HO8CUsRZ1byEz06mQ ($10.10 in chips)
Seat 6: BmYrv3ec2k5d6pQq6iNaZw ($67.85 in chips)
Seat 7: 9r7ZoBbAJj5IeyZ0q9BdzA ($13.50 in chips)
Seat 8: xUrN9TWLq4m5V+OXY7KUUA ($50 in chips)
Seat 9: WpvT3OUSiZlpvs+mPXFqtQ ($10.25 in chips)
90Wb75h3W1BRpbqVnuk8gw: posts small blind $0.25
dDaHs3X8+fe3bIkRU0cbrw: posts big blind $0.50
*** HOLE CARDS ***
YBN054X4blmis+B2bBlC0g: calls $0.50
FRv75HO8CUsRZ1byEz06mQ: calls $0.50
BmYrv3ec2k5d6pQq6iNaZw: folds
9r7ZoBbAJj5IeyZ0q9BdzA: raises $0.50 to $1
xUrN9TWLq4m5V+OXY7KUUA: folds
WpvT3OUSiZlpvs+mPXFqtQ: folds
90Wb75h3W1BRpbqVnuk8gw: folds
dDaHs3X8+fe3bIkRU0cbrw: calls $0.50
YBN054X4blmis+B2bBlC0g: folds
FRv75HO8CUsRZ1byEz06mQ: calls $0.50
*** FLOP *** [Th Qd 2d]
dDaHs3X8+fe3bIkRU0cbrw: checks
FRv75HO8CUsRZ1byEz06mQ: checks
9r7ZoBbAJj5IeyZ0q9BdzA: bets $1
dDaHs3X8+fe3bIkRU0cbrw: raises $3 to $4
FRv75HO8CUsRZ1byEz06mQ: folds
9r7ZoBbAJj5IeyZ0q9BdzA: calls $3
*** TURN *** [Th Qd 2d] [7s]
dDaHs3X8+fe3bIkRU0cbrw: checks
9r7ZoBbAJj5IeyZ0q9BdzA: bets $3
dDaHs3X8+fe3bIkRU0cbrw: calls $3
*** RIVER *** [Th Qd 2d 7s] [4d]
dDaHs3X8+fe3bIkRU0cbrw: bets $5.50
9r7ZoBbAJj5IeyZ0q9BdzA: calls $5.50 and is all-in
*** SHOW DOWN ***
dDaHs3X8+fe3bIkRU0cbrw: shows [4h 4c] (three of a kind, Fours)
9r7ZoBbAJj5IeyZ0q9BdzA: mucks hand
dDaHs3X8+fe3bIkRU0cbrw collected $27.40 from pot
*** SUMMARY ***
Total pot $28.75 | Rake $1.35
Board [Th Qd 2d 7s 4d]
Seat 2: 90Wb75h3W1BRpbqVnuk8gw (small blind) folded before Flop
Seat 3: dDaHs3X8+fe3bIkRU0cbrw (big blind) showed [4h 4c] and won ($27.40) with three of a kind, Fours
Seat 4: YBN054X4blmis+B2bBlC0g folded before Flop
Seat 5: FRv75HO8CUsRZ1byEz06mQ folded on the Flop
Seat 6: BmYrv3ec2k5d6pQq6iNaZw folded before Flop (didn't bet)
Seat 7: 9r7ZoBbAJj5IeyZ0q9BdzA mucked
Seat 8: xUrN9TWLq4m5V+OXY7KUUA folded before Flop (didn't bet)
Seat 9: WpvT3OUSiZlpvs+mPXFqtQ (button) folded before Flop (didn't bet)



PokerStars Game #59938649578:  Hold'em No Limit ($0.25/$0.50) - 2009/07/01 0:20:05 ET
Table 'NCiXr0d5CEKBQr/cZgLhbA' 9-max Seat #5 is the button
Seat 1: RjBdQ6w31rgcy0o24VLR6w ($10 in chips)
Seat 2: ulxuJchBV9iguXg0FUonfg ($40.05 in chips)
Seat 3: xZCXQSXlrZkp3pZizzVXCw ($55.65 in chips)
Seat 4: CL4d+tvzcd4utdQxlPLOmg ($31.05 in chips)
Seat 5: zE9cVigS2nW/Ljy4K4bUQA ($30 in chips)
Seat 6: SKnJuWHScqetA/qG5p+wCg ($30.55 in chips)
Seat 7: M+7+BTmX5vZatHVuoRB1nA ($50 in chips)
Seat 8: 1MJUKc3cc0QmUoz1JZLR2w ($62.35 in chips)
Seat 9: WpvT3OUSiZlpvs+mPXFqtQ ($8.20 in chips)
SKnJuWHScqetA/qG5p+wCg: posts small blind $0.25
M+7+BTmX5vZatHVuoRB1nA: posts big blind $0.50
*** HOLE CARDS ***
1MJUKc3cc0QmUoz1JZLR2w: calls $0.50
WpvT3OUSiZlpvs+mPXFqtQ: folds
RjBdQ6w31rgcy0o24VLR6w: folds
ulxuJchBV9iguXg0FUonfg: folds
xZCXQSXlrZkp3pZizzVXCw: folds
CL4d+tvzcd4utdQxlPLOmg: folds
zE9cVigS2nW/Ljy4K4bUQA: folds
SKnJuWHScqetA/qG5p+wCg: raises $1.50 to $2
M+7+BTmX5vZatHVuoRB1nA: folds
1MJUKc3cc0QmUoz1JZLR2w: raises $4 to $6
SKnJuWHScqetA/qG5p+wCg: folds
1MJUKc3cc0QmUoz1JZLR2w collected $4.50 from pot
*** SUMMARY ***
Total pot $4.50 | Rake $0
Seat 1: RjBdQ6w31rgcy0o24VLR6w folded before Flop (didn't bet)
Seat 2: ulxuJchBV9iguXg0FUonfg folded before Flop (didn't bet)
Seat 3: xZCXQSXlrZkp3pZizzVXCw folded before Flop (didn't bet)
Seat 4: CL4d+tvzcd4utdQxlPLOmg folded before Flop (didn't bet)
Seat 5: zE9cVigS2nW/Ljy4K4bUQA (button) folded before Flop (didn't bet)
Seat 6: SKnJuWHScqetA/qG5p+wCg (small blind) folded before Flop
Seat 7: M+7+BTmX5vZatHVuoRB1nA (big blind) folded before Flop
Seat 8: 1MJUKc3cc0QmUoz1JZLR2w collected ($4.50)
Seat 9: WpvT3OUSiZlpvs+mPXFqtQ folded before Flop (didn't bet)



PokerStars Game #59938651168:  Hold'em No Limit ($0.25/$0.50) - 2009/07/01 0:20:08 ET
Table 'raOT4/ipuZgzjfKHC+jD9g' 2-max Seat #1 is the button
Seat 1: IuwLemwLhc9fvrwBGs0AMA ($12.80 in chips)
Seat 2: Udr5juWSWUgTu1NlRhjMdA ($9.60 in chips)
IuwLemwLhc9fvrwBGs0AMA: posts small blind $0.25
Udr5juWSWUgTu1NlRhjMdA: posts big blind $0.50
*** HOLE CARDS ***
IuwLemwLhc9fvrwBGs0AMA: raises $1 to $1.50
Udr5juWSWUgTu1NlRhjMdA: folds
IuwLemwLhc9fvrwBGs0AMA collected $1 from pot
*** SUMMARY ***
Total pot $1 | Rake $0
Seat 1: IuwLemwLhc9fvrwBGs0AMA (button) (small blind) collected ($1)
Seat 2: Udr5juWSWUgTu1NlRhjMdA (big blind) folded before Flop



PokerStars Game #59938651940:  Hold'em No Limit ($0.25/$0.50) - 2009/07/01 0:20:09 ET
Table '3FhG0gl3kMX3wBEEqj+wnQ' 9-max Seat #8 is the button
Seat 1: e0J9pdCNUDTCG031RnXqLA ($10.25 in chips)
Seat 2: 4dl3YNqZ6Houm2jZAzDmRg ($24.50 in chips)
Seat 4: bz4LMfV0GGl/MJ/ABXuPmg ($24.20 in chips)
Seat 5: XNMDwbXt/Q4jM99AXnbJDw ($55.55 in chips)
Seat 6: 5JJVDlaiMnB004o/RqbZZQ ($24.50 in chips)
Seat 7: mSD1pginDsyHG5PDfqzphw ($10 in chips)
Seat 8: j3K/Jujr7PY4ZM2RZvlH6A ($43.85 in chips)
Seat 9: L5e2lrPLQm1Pqx30IIZ/Fw ($10 in chips)
L5e2lrPLQm1Pqx30IIZ/Fw: posts small blind $0.25
e0J9pdCNUDTCG031RnXqLA: posts big blind $0.50
HZkVla4kK2SI42CVrPZ/ig: sits out
*** HOLE CARDS ***
4dl3YNqZ6Houm2jZAzDmRg: folds
bz4LMfV0GGl/MJ/ABXuPmg: calls $0.50
XNMDwbXt/Q4jM99AXnbJDw: folds
5JJVDlaiMnB004o/RqbZZQ: folds
mSD1pginDsyHG5PDfqzphw: folds
j3K/Jujr7PY4ZM2RZvlH6A: raises $1.50 to $2
L5e2lrPLQm1Pqx30IIZ/Fw: folds
e0J9pdCNUDTCG031RnXqLA: folds
bz4LMfV0GGl/MJ/ABXuPmg: calls $1.50
*** FLOP *** [4s 6s Td]
bz4LMfV0GGl/MJ/ABXuPmg: checks
j3K/Jujr7PY4ZM2RZvlH6A: bets $1
bz4LMfV0GGl/MJ/ABXuPmg: folds
j3K/Jujr7PY4ZM2RZvlH6A collected $4.55 from pot
j3K/Jujr7PY4ZM2RZvlH6A: doesn't show hand
*** SUMMARY ***
Total pot $4.75 | Rake $0.20
Board [4s 6s Td]
Seat 1: e0J9pdCNUDTCG031RnXqLA (big blind) folded before Flop
Seat 2: 4dl3YNqZ6Houm2jZAzDmRg folded before Flop (didn't bet)
Seat 4: bz4LMfV0GGl/MJ/ABXuPmg folded on the Flop
Seat 5: XNMDwbXt/Q4jM99AXnbJDw folded before Flop (didn't bet)
Seat 6: 5JJVDlaiMnB004o/RqbZZQ folded before Flop (didn't bet)
Seat 7: mSD1pginDsyHG5PDfqzphw folded before Flop (didn't bet)
Seat 8: j3K/Jujr7PY4ZM2RZvlH6A (button) collected ($4.55)
Seat 9: L5e2lrPLQm1Pqx30IIZ/Fw (small blind) folded before Flop



PokerStars Game #59938652510:  Hold'em No Limit ($0.25/$0.50) - 2009/07/01 0:20:10 ET
Table 'Nz0Vr7WMHL2g5Uk7dDZjpw' 9-max Seat #6 is the button
Seat 3: 4QTiNH5fteLgJjx/s6Hy6A ($19.90 in chips)
Seat 4: 5JJVDlaiMnB004o/RqbZZQ ($27.50 in chips)
Seat 5: WGW0DgjBUXs1ylURHG8vnQ ($13.60 in chips)
Seat 6: k1f0lS7tlMHCLGs0JT34Tg ($9.25 in chips)
Seat 7: KPLH0gELgFe2OuAnhJFI5w ($19.95 in chips)
Seat 8: HkZI6g4zl83TDTA7SRspmQ ($21.70 in chips)
Seat 9: Ak2W6V2TDVIQrvSAy4eD7Q ($22.15 in chips)
KPLH0gELgFe2OuAnhJFI5w: posts small blind $0.25
HkZI6g4zl83TDTA7SRspmQ: posts big blind $0.50
XNMDwbXt/Q4jM99AXnbJDw: sits out
*** HOLE CARDS ***
Ak2W6V2TDVIQrvSAy4eD7Q: raises $1 to $1.50
4QTiNH5fteLgJjx/s6Hy6A: folds
5JJVDlaiMnB004o/RqbZZQ: folds
WGW0DgjBUXs1ylURHG8vnQ: calls $1.50
k1f0lS7tlMHCLGs0JT34Tg: folds
KPLH0gELgFe2OuAnhJFI5w: folds
HkZI6g4zl83TDTA7SRspmQ: folds
*** FLOP *** [3c 4c 8s]
Ak2W6V2TDVIQrvSAy4eD7Q: checks
WGW0DgjBUXs1ylURHG8vnQ: bets $1
Ak2W6V2TDVIQrvSAy4eD7Q: raises $3.50 to $4.50
WGW0DgjBUXs1ylURHG8vnQ: folds
Ak2W6V2TDVIQrvSAy4eD7Q collected $5.50 from pot
Ak2W6V2TDVIQrvSAy4eD7Q: doesn't show hand
*** SUMMARY ***
Total pot $5.75 | Rake $0.25
Board [3c 4c 8s]
Seat 3: 4QTiNH5fteLgJjx/s6Hy6A folded before Flop (didn't bet)
Seat 4: 5JJVDlaiMnB004o/RqbZZQ folded before Flop (didn't bet)
Seat 5: WGW0DgjBUXs1ylURHG8vnQ folded on the Flop
Seat 6: k1f0lS7tlMHCLGs0JT34Tg (button) folded before Flop (didn't bet)
Seat 7: KPLH0gELgFe2OuAnhJFI5w (small blind) folded before Flop
Seat 8: HkZI6g4zl83TDTA7SRspmQ (big blind) folded before Flop
Seat 9: Ak2W6V2TDVIQrvSAy4eD7Q collected ($5.50)



PokerStars Game #59938653216:  Hold'em No Limit ($0.25/$0.50) - 2009/07/01 0:20:11 ET
Table 'ZYwMb9E6tY50Qm+iNbXRYw' 2-max Seat #1 is the button
Seat 1: DXLfRb8KDZWmrztw2bwtFw ($9.30 in chips)
Seat 2: 16tvT7AYgZ2LgiGFcvFKQg ($23.70 in chips)
DXLfRb8KDZWmrztw2bwtFw: posts small blind $0.25
16tvT7AYgZ2LgiGFcvFKQg: posts big blind $0.50
*** HOLE CARDS ***
DXLfRb8KDZWmrztw2bwtFw: calls $0.25
16tvT7AYgZ2LgiGFcvFKQg: checks
*** FLOP *** [6h 2s 5h]
16tvT7AYgZ2LgiGFcvFKQg: bets $0.50
DXLfRb8KDZWmrztw2bwtFw: raises $2 to $2.50
16tvT7AYgZ2LgiGFcvFKQg: calls $2
*** TURN *** [6h 2s 5h] [Qh]
16tvT7AYgZ2LgiGFcvFKQg: checks
DXLfRb8KDZWmrztw2bwtFw: bets $3.50
16tvT7AYgZ2LgiGFcvFKQg: raises $3.50 to $7
DXLfRb8KDZWmrztw2bwtFw: calls $2.80 and is all-in
*** RIVER *** [6h 2s 5h Qh] [4s]
*** SHOW DOWN ***
16tvT7AYgZ2LgiGFcvFKQg: shows [8s 6c] (a pair of Sixes)
DXLfRb8KDZWmrztw2bwtFw: shows [6d Qs] (two pair, Queens and Sixes)
DXLfRb8KDZWmrztw2bwtFw collected $18.10 from pot
*** SUMMARY ***
Total pot $18.60 | Rake $0.50
Board [6h 2s 5h Qh 4s]
Seat 1: DXLfRb8KDZWmrztw2bwtFw (button) (small blind) showed [6d Qs] and won ($18.10) with two pair, Queens and Sixes
Seat 2: 16tvT7AYgZ2LgiGFcvFKQg (big blind) showed [8s 6c] and lost with a pair of Sixes



PokerStars Game #59938654468:  Hold'em No Limit ($0.25/$0.50) - 2009/07/01 0:20:12 ET
Table 'X6IRCRTh+20gjz8aubWnwA' 9-max Seat #3 is the button
Seat 2: RjBdQ6w31rgcy0o24VLR6w ($12.40 in chips)
Seat 3: mSD1pginDsyHG5PDfqzphw ($10 in chips)
Seat 4: uw9QayAAxLM3Hb+HR7mSkg ($10.50 in chips)
Seat 5: QtFsO51ArDuQ44+KvR2jow ($30.20 in chips)
Seat 6: /6In1zC3WtgwxDcueWzZWg ($58.10 in chips)
Seat 7: VBnpbzn0dIveV55qKvciew ($53.95 in chips)
Seat 9: M+7+BTmX5vZatHVuoRB1nA ($81.60 in chips)
uw9QayAAxLM3Hb+HR7mSkg: posts small blind $0.25
QtFsO51ArDuQ44+KvR2jow: posts big blind $0.50
HxeBVq06/3Bh/H986sgdbw: sits out
*** HOLE CARDS ***
/6In1zC3WtgwxDcueWzZWg: folds
VBnpbzn0dIveV55qKvciew: calls $0.50
M+7+BTmX5vZatHVuoRB1nA: folds
RjBdQ6w31rgcy0o24VLR6w: folds
mSD1pginDsyHG5PDfqzphw: raises $1.50 to $2
uw9QayAAxLM3Hb+HR7mSkg: folds
QtFsO51ArDuQ44+KvR2jow: folds
VBnpbzn0dIveV55qKvciew: calls $1.50
*** FLOP *** [6c Kc 8h]
VBnpbzn0dIveV55qKvciew: checks
mSD1pginDsyHG5PDfqzphw: bets $2.50
VBnpbzn0dIveV55qKvciew: raises $5.50 to $8
mSD1pginDsyHG5PDfqzphw: calls $5.50 and is all-in
*** TURN *** [6c Kc 8h] [4h]
*** RIVER *** [6c Kc 8h 4h] [9s]
*** SHOW DOWN ***
VBnpbzn0dIveV55qKvciew: shows [Qd Kh] (a pair of Kings)
mSD1pginDsyHG5PDfqzphw: shows [8d 8s] (three of a kind, Eights)
mSD1pginDsyHG5PDfqzphw collected $19.75 from pot
*** SUMMARY ***
Total pot $20.75 | Rake $1
Board [6c Kc 8h 4h 9s]
Seat 2: RjBdQ6w31rgcy0o24VLR6w folded before Flop (didn't bet)
Seat 3: mSD1pginDsyHG5PDfqzphw (button) showed [8d 8s] and won ($19.75) with three of a kind, Eights
Seat 4: uw9QayAAxLM3Hb+HR7mSkg (small blind) folded before Flop
Seat 5: QtFsO51ArDuQ44+KvR2jow (big blind) folded before Flop
Seat 6: /6In1zC3WtgwxDcueWzZWg folded before Flop (didn't bet)
Seat 7: VBnpbzn0dIveV55qKvciew showed [Qd Kh] and lost with a pair of Kings
Seat 9: M+7+BTmX5vZatHVuoRB1nA folded before Flop (didn't bet)



PokerStars Game #59938656090:  Hold'em No Limit ($0.25/$0.50) - 2009/07/01 0:20:15 ET
Table 'tyR5AZNKV8Aadbrnrnlg7g' 6-max Seat #6 is the button
Seat 1: R+KjpH/wSjDLhtIy9+edNA ($54.95 in chips)
Seat 2: 58zdeSBSuSFX/qZfhc7YmA ($33.85 in chips)
Seat 3: jUhx+m+V7qfbLZTjgwZByg ($23.60 in chips)
Seat 4: Rt6KgtZ8YaJoTc3FPim00w ($87 in chips)
Seat 6: DMQLAmut/l19xN5STQndFg ($7.15 in chips)
R+KjpH/wSjDLhtIy9+edNA: posts small blind $0.25
58zdeSBSuSFX/qZfhc7YmA: posts big blind $0.50
*** HOLE CARDS ***
jUhx+m+V7qfbLZTjgwZByg: calls $0.50
EIg3r3fRFKG2HhgpDlIJHg leaves the table
Rt6KgtZ8YaJoTc3FPim00w: raises $1.50 to $2
DMQLAmut/l19xN5STQndFg: folds
R+KjpH/wSjDLhtIy9+edNA: folds
58zdeSBSuSFX/qZfhc7YmA: folds
jUhx+m+V7qfbLZTjgwZByg: calls $1.50
*** FLOP *** [8d 7s 6s]
wOyVV9M/oyiw3YaOjNZ05w joins the table at seat #5
jUhx+m+V7qfbLZTjgwZByg: checks
Rt6KgtZ8YaJoTc3FPim00w: checks
*** TURN *** [8d 7s 6s] [Ks]
jUhx+m+V7qfbLZTjgwZByg: bets $2
Rt6KgtZ8YaJoTc3FPim00w: folds
jUhx+m+V7qfbLZTjgwZByg collected $4.55 from pot
*** SUMMARY ***
Total pot $4.75 | Rake $0.20
Board [8d 7s 6s Ks]
Seat 1: R+KjpH/wSjDLhtIy9+edNA (small blind) folded before Flop
Seat 2: 58zdeSBSuSFX/qZfhc7YmA (big blind) folded before Flop
Seat 3: jUhx+m+V7qfbLZTjgwZByg collected ($4.55)
Seat 4: Rt6KgtZ8YaJoTc3FPim00w folded on the Turn
Seat 6: DMQLAmut/l19xN5STQndFg (button) folded before Flop (didn't bet)



PokerStars Game #59938656114:  Hold'em No Limit ($0.25/$0.50) - 2009/07/01 0:20:15 ET
Table '+z1aekfHkpp09pc8F9aViw' 6-max Seat #3 is the button
Seat 2: M6xK/VklCvdyyrmvzATlxQ ($30 in chips)
Seat 3: uUznlIMFnRUvwrBhYF73KA ($63.25 in chips)
Seat 5: crjGpJEzSZgD38FoE3VMGg ($59.40 in chips)
Seat 6: 686aeHikcJlgKkSuIFdcXQ ($70.10 in chips)
RowCSpSURHTOL/dcjg/Iug will be allowed to play after the button
crjGpJEzSZgD38FoE3VMGg: posts small blind $0.25
686aeHikcJlgKkSuIFdcXQ: posts big blind $0.50
wOyVV9M/oyiw3YaOjNZ05w: sits out
M6xK/VklCvdyyrmvzATlxQ: posts big blind $0.50
*** HOLE CARDS ***
M6xK/VklCvdyyrmvzATlxQ: checks
uUznlIMFnRUvwrBhYF73KA: folds
crjGpJEzSZgD38FoE3VMGg: folds
686aeHikcJlgKkSuIFdcXQ: checks
*** FLOP *** [8c 3c Ks]
686aeHikcJlgKkSuIFdcXQ: checks
M6xK/VklCvdyyrmvzATlxQ: bets $1
686aeHikcJlgKkSuIFdcXQ: folds
M6xK/VklCvdyyrmvzATlxQ collected $1.20 from pot
*** SUMMARY ***
Total pot $1.25 | Rake $0.05
Board [8c 3c Ks]
Seat 2: M6xK/VklCvdyyrmvzATlxQ collected ($1.20)
Seat 3: uUznlIMFnRUvwrBhYF73KA (button) folded before Flop (didn't bet)
Seat 5: crjGpJEzSZgD38FoE3VMGg (small blind) folded before Flop
Seat 6: 686aeHikcJlgKkSuIFdcXQ (big blind) folded on the Flop



PokerStars Game #59938657384:  Hold'em No Limit ($0.25/$0.50) - 2009/07/01 0:20:17 ET
Table 'GfL/No5u5PoEnU39lP5pQg' 6-max Seat #3 is the button
Seat 2: uVwggSetzp7d+eVgowO3vg ($46.50 in chips)
Seat 3: qNezhXOOUXqwG7b9X5XJAA ($50 in chips)
Seat 4: yqM0AD7MZQd/cEtKdDQY1A ($19.55 in chips)
Seat 5: crjGpJEzSZgD38FoE3VMGg ($50 in chips)
Seat 6: 3wylWYGeXFXcrE4XVrlPng ($65.10 in chips)
yqM0AD7MZQd/cEtKdDQY1A: posts small blind $0.25
crjGpJEzSZgD38FoE3VMGg: posts big blind $0.50
1WUCqNG+p+vfWRTXNu4ljw: sits out
*** HOLE CARDS ***
3wylWYGeXFXcrE4XVrlPng: calls $0.50
uVwggSetzp7d+eVgowO3vg: folds
qNezhXOOUXqwG7b9X5XJAA: folds
yqM0AD7MZQd/cEtKdDQY1A: calls $0.25
crjGpJEzSZgD38FoE3VMGg: checks
*** FLOP *** [4h 6s 8h]
yqM0AD7MZQd/cEtKdDQY1A: bets $1.50
crjGpJEzSZgD38FoE3VMGg: raises $4 to $5.50
yqM0AD7MZQd/cEtKdDQY1A said, "good bet I had you"
3wylWYGeXFXcrE4XVrlPng: folds
yqM0AD7MZQd/cEtKdDQY1A: folds
crjGpJEzSZgD38FoE3VMGg collected $4.30 from pot
crjGpJEzSZgD38FoE3VMGg: doesn't show hand
*** SUMMARY ***
Total pot $4.50 | Rake $0.20
Board [4h 6s 8h]
Seat 2: uVwggSetzp7d+eVgowO3vg folded before Flop (didn't bet)
Seat 3: qNezhXOOUXqwG7b9X5XJAA (button) folded before Flop (didn't bet)
Seat 4: yqM0AD7MZQd/cEtKdDQY1A (small blind) folded on the Flop
Seat 5: crjGpJEzSZgD38FoE3VMGg (big blind) collected ($4.30)
Seat 6: 3wylWYGeXFXcrE4XVrlPng folded on the Flop



PokerStars Game #59938657378:  Hold'em No Limit ($0.25/$0.50) - 2009/07/01 0:20:17 ET
Table 'raOT4/ipuZgzjfKHC+jD9g' 2-max Seat #2 is the button
Seat 1: IuwLemwLhc9fvrwBGs0AMA ($13.30 in chips)
Seat 2: Udr5juWSWUgTu1NlRhjMdA ($9.10 in chips)
Udr5juWSWUgTu1NlRhjMdA: posts small blind $0.25
IuwLemwLhc9fvrwBGs0AMA: posts big blind $0.50
*** HOLE CARDS ***
Udr5juWSWUgTu1NlRhjMdA: raises $0.50 to $1
IuwLemwLhc9fvrwBGs0AMA: calls $0.50
*** FLOP *** [7c Qh 9h]
IuwLemwLhc9fvrwBGs0AMA: checks
Udr5juWSWUgTu1NlRhjMdA: checks
*** TURN *** [7c Qh 9h] [9s]
IuwLemwLhc9fvrwBGs0AMA: checks
Udr5juWSWUgTu1NlRhjMdA: checks
*** RIVER *** [7c Qh 9h 9s] [5s]
IuwLemwLhc9fvrwBGs0AMA: checks
Udr5juWSWUgTu1NlRhjMdA: bets $1
IuwLemwLhc9fvrwBGs0AMA: folds
Udr5juWSWUgTu1NlRhjMdA collected $1.90 from pot
Udr5juWSWUgTu1NlRhjMdA: doesn't show hand
*** SUMMARY ***
Total pot $2 | Rake $0.10
Board [7c Qh 9h 9s 5s]
Seat 1: IuwLemwLhc9fvrwBGs0AMA (big blind) folded on the River
Seat 2: Udr5juWSWUgTu1NlRhjMdA (button) (small blind) collected ($1.90)



PokerStars Game #59938659286:  Hold'em No Limit ($0.25/$0.50) - 2009/07/01 0:20:20 ET
Table '37qXEp3oe+er5q4CZip9eQ' 6-max Seat #1 is the button
Seat 1: oqOqoO2AyCZenUghCxMDxw ($51.50 in chips)
Seat 3: Rt6KgtZ8YaJoTc3FPim00w ($97.65 in chips)
Seat 4: AYb7QG0KzyicbOC0ZROE3Q ($8.75 in chips)
Seat 5: VOmI0x4dDPnTESZd5B4d1Q ($40.55 in chips)
Seat 6: f7zPpUQp9hHZgqhEvrUWQw ($50.65 in chips)
Rt6KgtZ8YaJoTc3FPim00w: posts small blind $0.25
AYb7QG0KzyicbOC0ZROE3Q: posts big blind $0.50
*** HOLE CARDS ***
VOmI0x4dDPnTESZd5B4d1Q has timed out
VOmI0x4dDPnTESZd5B4d1Q: folds
VOmI0x4dDPnTESZd5B4d1Q is sitting out
f7zPpUQp9hHZgqhEvrUWQw: folds
oqOqoO2AyCZenUghCxMDxw: raises $1 to $1.50
Rt6KgtZ8YaJoTc3FPim00w: folds
VOmI0x4dDPnTESZd5B4d1Q has returned
AYb7QG0KzyicbOC0ZROE3Q: raises $7.25 to $8.75 and is all-in
oqOqoO2AyCZenUghCxMDxw: calls $7.25
*** FLOP *** [3c Jc 2d]
*** TURN *** [3c Jc 2d] [6h]
*** RIVER *** [3c Jc 2d 6h] [Ac]
*** SHOW DOWN ***
AYb7QG0KzyicbOC0ZROE3Q: shows [Kc Tc] (a flush, Ace high)
oqOqoO2AyCZenUghCxMDxw: mucks hand
AYb7QG0KzyicbOC0ZROE3Q collected $16.90 from pot
*** SUMMARY ***
Total pot $17.75 | Rake $0.85
Board [3c Jc 2d 6h Ac]
Seat 1: oqOqoO2AyCZenUghCxMDxw (button) mucked
Seat 3: Rt6KgtZ8YaJoTc3FPim00w (small blind) folded before Flop
Seat 4: AYb7QG0KzyicbOC0ZROE3Q (big blind) showed [Kc Tc] and won ($16.90) with a flush, Ace high
Seat 5: VOmI0x4dDPnTESZd5B4d1Q folded before Flop (didn't bet)
Seat 6: f7zPpUQp9hHZgqhEvrUWQw folded before Flop (didn't bet)



PokerStars Game #59938660296:  Hold'em No Limit ($0.25/$0.50) - 2009/07/01 0:20:21 ET
Table 'c/CRn+68J3Y8KxD5g1ek2Q' 2-max Seat #1 is the button
Seat 1: 46qCyJ6evTkHo9al5sBMNA ($276.15 in chips)
Seat 2: BypVLsYQt3ePFm2xQL/dOA ($106.25 in chips)
46qCyJ6evTkHo9al5sBMNA: posts small blind $0.25
BypVLsYQt3ePFm2xQL/dOA: posts big blind $0.50
*** HOLE CARDS ***
46qCyJ6evTkHo9al5sBMNA: folds
BypVLsYQt3ePFm2xQL/dOA collected $0.50 from pot
BypVLsYQt3ePFm2xQL/dOA: doesn't show hand
*** SUMMARY ***
Total pot $0.50 | Rake $0
Seat 1: 46qCyJ6evTkHo9al5sBMNA (button) (small blind) folded before Flop
Seat 2: BypVLsYQt3ePFm2xQL/dOA (big blind) collected ($0.50)



PokerStars Game #59938660828:  Hold'em No Limit ($0.25/$0.50) - 2009/07/01 0:20:22 ET
Table 'IeNZOZQ4T6oiaHqFeo6yIA' 2-max Seat #1 is the button
Seat 1: ndd1nfncBkWNitBnsfCoVQ ($71.95 in chips)
Seat 2: A91IUl5JaZROhtfCtnnwYw ($14.55 in chips)
ndd1nfncBkWNitBnsfCoVQ: posts small blind $0.25
A91IUl5JaZROhtfCtnnwYw: posts big blind $0.50
*** HOLE CARDS ***
ndd1nfncBkWNitBnsfCoVQ: raises $1 to $1.50
A91IUl5JaZROhtfCtnnwYw: calls $1
*** FLOP *** [Th 5s Jh]
A91IUl5JaZROhtfCtnnwYw: checks
ndd1nfncBkWNitBnsfCoVQ: bets $2
A91IUl5JaZROhtfCtnnwYw: calls $2
*** TURN *** [Th 5s Jh] [5c]
A91IUl5JaZROhtfCtnnwYw: checks
ndd1nfncBkWNitBnsfCoVQ: bets $6
A91IUl5JaZROhtfCtnnwYw: calls $6
*** RIVER *** [Th 5s Jh 5c] [4s]
A91IUl5JaZROhtfCtnnwYw: checks
ndd1nfncBkWNitBnsfCoVQ: bets $6
A91IUl5JaZROhtfCtnnwYw: folds
ndd1nfncBkWNitBnsfCoVQ collected $18.50 from pot
ndd1nfncBkWNitBnsfCoVQ: doesn't show hand
*** SUMMARY ***
Total pot $19 | Rake $0.50
Board [Th 5s Jh 5c 4s]
Seat 1: ndd1nfncBkWNitBnsfCoVQ (button) (small blind) collected ($18.50)
Seat 2: A91IUl5JaZROhtfCtnnwYw (big blind) folded on the River



PokerStars Game #59938662352:  Hold'em No Limit ($0.25/$0.50) - 2009/07/01 0:20:24 ET
Table 'E7bWJ45aoFXRpyRv2gw+Ig' 2-max Seat #1 is the button
Seat 1: FRkiRasEGlHUeLrEl+k/nA ($63.10 in chips)
Seat 2: 3Wro85I7472vJ4Wkpneo9A ($116.60 in chips)
FRkiRasEGlHUeLrEl+k/nA: posts small blind $0.25
3Wro85I7472vJ4Wkpneo9A: posts big blind $0.50
*** HOLE CARDS ***
FRkiRasEGlHUeLrEl+k/nA: calls $0.25
3Wro85I7472vJ4Wkpneo9A: checks
*** FLOP *** [5s 3s 3c]
3Wro85I7472vJ4Wkpneo9A: bets $1
FRkiRasEGlHUeLrEl+k/nA: folds
3Wro85I7472vJ4Wkpneo9A collected $0.95 from pot
3Wro85I7472vJ4Wkpneo9A: doesn't show hand
*** SUMMARY ***
Total pot $1 | Rake $0.05
Board [5s 3s 3c]
Seat 1: FRkiRasEGlHUeLrEl+k/nA (button) (small blind) folded on the Flop
Seat 2: 3Wro85I7472vJ4Wkpneo9A (big blind) collected ($0.95)



PokerStars Game #59938662804:  Hold'em No Limit ($0.25/$0.50) - 2009/07/01 0:20:25 ET
Table 'fx6MqwfYAj/Rt86hBz2L3Q' 9-max Seat #7 is the button
Seat 1: uW08L3aflsgdboc6oTbC3Q ($33.55 in chips)
Seat 2: C3rGXblctNcWI6JYPHhaEg ($14.50 in chips)
Seat 3: iadBi5AEt7gTBXbDSSnMYQ ($49 in chips)
Seat 4: gPEN9Zp33YTm/mu9/SYP1w ($31.95 in chips)
Seat 5: iAISe3dVeua8PUn2wwgDHw ($29.50 in chips)
Seat 6: VelaednozEGCpceHSFUsAg ($21.80 in chips)
Seat 7: bkXkL3pmapikPQQRNPZSEA ($8.75 in chips)
Seat 8: 6ol/q1A4zYU6qXbZnTzPfQ ($13.80 in chips)
Seat 9: HZkVla4kK2SI42CVrPZ/ig ($10 in chips)
6ol/q1A4zYU6qXbZnTzPfQ: posts small blind $0.25
HZkVla4kK2SI42CVrPZ/ig: posts big blind $0.50
*** HOLE CARDS ***
uW08L3aflsgdboc6oTbC3Q: folds
uW08L3aflsgdboc6oTbC3Q leaves the table
C3rGXblctNcWI6JYPHhaEg: calls $0.50
iadBi5AEt7gTBXbDSSnMYQ: calls $0.50
gPEN9Zp33YTm/mu9/SYP1w: calls $0.50
iAISe3dVeua8PUn2wwgDHw: folds
VelaednozEGCpceHSFUsAg: folds
bkXkL3pmapikPQQRNPZSEA: folds
6ol/q1A4zYU6qXbZnTzPfQ: folds
jf2c/o9gI7Xj0GleCSMj9g joins the table at seat #1
HZkVla4kK2SI42CVrPZ/ig: checks
*** FLOP *** [7s 2h 9h]
HZkVla4kK2SI42CVrPZ/ig: checks
C3rGXblctNcWI6JYPHhaEg: checks
iadBi5AEt7gTBXbDSSnMYQ: bets $2.50
gPEN9Zp33YTm/mu9/SYP1w: raises $2.50 to $5
HZkVla4kK2SI42CVrPZ/ig: folds
C3rGXblctNcWI6JYPHhaEg: folds
iadBi5AEt7gTBXbDSSnMYQ: calls $2.50
*** TURN *** [7s 2h 9h] [8h]
iadBi5AEt7gTBXbDSSnMYQ: bets $1
gPEN9Zp33YTm/mu9/SYP1w: calls $1
*** RIVER *** [7s 2h 9h 8h] [Ah]
iadBi5AEt7gTBXbDSSnMYQ: bets $3
gPEN9Zp33YTm/mu9/SYP1w: folds
iadBi5AEt7gTBXbDSSnMYQ collected $13.60 from pot
*** SUMMARY ***
Total pot $14.25 | Rake $0.65
Board [7s 2h 9h 8h Ah]
Seat 1: uW08L3aflsgdboc6oTbC3Q folded before Flop (didn't bet)
Seat 2: C3rGXblctNcWI6JYPHhaEg folded on the Flop
Seat 3: iadBi5AEt7gTBXbDSSnMYQ collected ($13.60)
Seat 4: gPEN9Zp33YTm/mu9/SYP1w folded on the River
Seat 5: iAISe3dVeua8PUn2wwgDHw folded before Flop (didn't bet)
Seat 6: VelaednozEGCpceHSFUsAg folded before Flop (didn't bet)
Seat 7: bkXkL3pmapikPQQRNPZSEA (button) folded before Flop (didn't bet)
Seat 8: 6ol/q1A4zYU6qXbZnTzPfQ (small blind) folded before Flop
Seat 9: HZkVla4kK2SI42CVrPZ/ig (big blind) folded on the Flop



PokerStars Game #59938664066:  Hold'em No Limit ($0.25/$0.50) - 2009/07/01 0:20:26 ET
Table 'T/PgNWqVyY6lkldcBVXYJQ' 6-max Seat #1 is the button
Seat 1: +Pf9jTVizYlIo+woPvptfA ($53.75 in chips)
Seat 2: oZAeY5rVqNGgt8yyQ0pxbA ($20.85 in chips)
Seat 3: L3OcNO1bgdqDI46j67KQPQ ($56.05 in chips)
Seat 4: jxMvxeUUL9UU0V6wVU+Iyw ($11.20 in chips)
Seat 5: vVQBckETtigfb5mAcyK0OA ($63.65 in chips)
Seat 6: cDzbog6kwmJp+LBeBq+iMQ ($13.10 in chips)
oZAeY5rVqNGgt8yyQ0pxbA: posts small blind $0.25
L3OcNO1bgdqDI46j67KQPQ: posts big blind $0.50
*** HOLE CARDS ***
jxMvxeUUL9UU0V6wVU+Iyw said, "note to self do not do hold'em while drinking"
jxMvxeUUL9UU0V6wVU+Iyw: folds
vVQBckETtigfb5mAcyK0OA: calls $0.50
cDzbog6kwmJp+LBeBq+iMQ: raises $0.50 to $1
+Pf9jTVizYlIo+woPvptfA: folds
oZAeY5rVqNGgt8yyQ0pxbA: calls $0.75
L3OcNO1bgdqDI46j67KQPQ: folds
vVQBckETtigfb5mAcyK0OA: calls $0.50
*** FLOP *** [3h Qs Qh]
cDzbog6kwmJp+LBeBq+iMQ said, "haha good call man"
vVQBckETtigfb5mAcyK0OA said, "I HERE U BEEN THERE"
oZAeY5rVqNGgt8yyQ0pxbA: bets $1
vVQBckETtigfb5mAcyK0OA: folds
cDzbog6kwmJp+LBeBq+iMQ said, "hear*"
cDzbog6kwmJp+LBeBq+iMQ: calls $1
*** TURN *** [3h Qs Qh] [4s]
jxMvxeUUL9UU0V6wVU+Iyw said, "So how bout it Helen.  come to the cats game?  or are you a wus?"
vVQBckETtigfb5mAcyK0OA said, "HEAR"
oZAeY5rVqNGgt8yyQ0pxbA: checks
cDzbog6kwmJp+LBeBq+iMQ: bets $1.50
oZAeY5rVqNGgt8yyQ0pxbA: calls $1.50
*** RIVER *** [3h Qs Qh 4s] [Td]
oZAeY5rVqNGgt8yyQ0pxbA: bets $3.50
vVQBckETtigfb5mAcyK0OA said, "ARGOS BABY"
cDzbog6kwmJp+LBeBq+iMQ: raises $6 to $9.50
oZAeY5rVqNGgt8yyQ0pxbA: calls $6
*** SHOW DOWN ***
cDzbog6kwmJp+LBeBq+iMQ: shows [Qc Ad] (three of a kind, Queens)
oZAeY5rVqNGgt8yyQ0pxbA: mucks hand
cDzbog6kwmJp+LBeBq+iMQ collected $26.15 from pot
*** SUMMARY ***
Total pot $27.50 | Rake $1.35
Board [3h Qs Qh 4s Td]
Seat 1: +Pf9jTVizYlIo+woPvptfA (button) folded before Flop (didn't bet)
Seat 2: oZAeY5rVqNGgt8yyQ0pxbA (small blind) mucked
Seat 3: L3OcNO1bgdqDI46j67KQPQ (big blind) folded before Flop
Seat 4: jxMvxeUUL9UU0V6wVU+Iyw folded before Flop (didn't bet)
Seat 5: vVQBckETtigfb5mAcyK0OA folded on the Flop
Seat 6: cDzbog6kwmJp+LBeBq+iMQ showed [Qc Ad] and won ($26.15) with three of a kind, Queens



PokerStars Game #59938664850:  Hold'em No Limit ($0.25/$0.50) - 2009/07/01 0:20:28 ET
Table 'c/CRn+68J3Y8KxD5g1ek2Q' 2-max Seat #2 is the button
Seat 1: 46qCyJ6evTkHo9al5sBMNA ($275.90 in chips)
Seat 2: BypVLsYQt3ePFm2xQL/dOA ($106.50 in chips)
BypVLsYQt3ePFm2xQL/dOA: posts small blind $0.25
46qCyJ6evTkHo9al5sBMNA: posts big blind $0.50
*** HOLE CARDS ***
BypVLsYQt3ePFm2xQL/dOA: calls $0.25
46qCyJ6evTkHo9al5sBMNA: raises $1.50 to $2
BypVLsYQt3ePFm2xQL/dOA: calls $1.50
*** FLOP *** [6s Ah 9c]
46qCyJ6evTkHo9al5sBMNA: bets $2.50
BypVLsYQt3ePFm2xQL/dOA: raises $2.50 to $5
46qCyJ6evTkHo9al5sBMNA: folds
BypVLsYQt3ePFm2xQL/dOA collected $8.60 from pot
BypVLsYQt3ePFm2xQL/dOA: doesn't show hand
*** SUMMARY ***
Total pot $9 | Rake $0.40
Board [6s Ah 9c]
Seat 1: 46qCyJ6evTkHo9al5sBMNA (big blind) folded on the Flop
Seat 2: BypVLsYQt3ePFm2xQL/dOA (button) (small blind) collected ($8.60)



PokerStars Game #59938668046:  Hold'em No Limit ($0.25/$0.50) - 2009/07/01 0:20:32 ET
Table 'ZYwMb9E6tY50Qm+iNbXRYw' 2-max Seat #2 is the button
Seat 1: DXLfRb8KDZWmrztw2bwtFw ($18.10 in chips)
Seat 2: 16tvT7AYgZ2LgiGFcvFKQg ($14.40 in chips)
16tvT7AYgZ2LgiGFcvFKQg: posts small blind $0.25
DXLfRb8KDZWmrztw2bwtFw: posts big blind $0.50
*** HOLE CARDS ***
16tvT7AYgZ2LgiGFcvFKQg: raises $0.50 to $1
DXLfRb8KDZWmrztw2bwtFw: calls $0.50
*** FLOP *** [6c Th 2c]
DXLfRb8KDZWmrztw2bwtFw: checks
16tvT7AYgZ2LgiGFcvFKQg: checks
*** TURN *** [6c Th 2c] [7c]
DXLfRb8KDZWmrztw2bwtFw: checks
16tvT7AYgZ2LgiGFcvFKQg: checks
*** RIVER *** [6c Th 2c 7c] [Qh]
DXLfRb8KDZWmrztw2bwtFw: checks
16tvT7AYgZ2LgiGFcvFKQg: bets $1.50
DXLfRb8KDZWmrztw2bwtFw: folds
16tvT7AYgZ2LgiGFcvFKQg collected $1.90 from pot
16tvT7AYgZ2LgiGFcvFKQg: doesn't show hand
*** SUMMARY ***
Total pot $2 | Rake $0.10
Board [6c Th 2c 7c Qh]
Seat 1: DXLfRb8KDZWmrztw2bwtFw (big blind) folded on the River
Seat 2: 16tvT7AYgZ2LgiGFcvFKQg (button) (small blind) collected ($1.90)



PokerStars Game #59938669110:  Hold'em No Limit ($0.25/$0.50) - 2009/07/01 0:20:34 ET
Table 'eMxdLyFDf28E0wit6gm3Uw' 6-max Seat #4 is the button
Seat 1: tnD/64LagZ9qPaeOQVjVZg ($13.20 in chips)
Seat 2: jwuKQ1S3U4NnzMQn3E3dgw ($68.45 in chips)
Seat 3: dZcLsEI8iXkobBduRJ45Yw ($17.65 in chips)
Seat 4: QM93o65lI8kLzmiB/BILlA ($27 in chips)
Seat 5: X0X97o2fDAPiGx6o1gahsw ($56.60 in chips)
Seat 6: L0aIPg7qefDQjdJo3HCVEA ($9.25 in chips)
X0X97o2fDAPiGx6o1gahsw: posts small blind $0.25
L0aIPg7qefDQjdJo3HCVEA: posts big blind $0.50
*** HOLE CARDS ***
tnD/64LagZ9qPaeOQVjVZg: folds
jwuKQ1S3U4NnzMQn3E3dgw: calls $0.50
dZcLsEI8iXkobBduRJ45Yw: folds
QM93o65lI8kLzmiB/BILlA: folds
X0X97o2fDAPiGx6o1gahsw: folds
L0aIPg7qefDQjdJo3HCVEA: raises $0.50 to $1
jwuKQ1S3U4NnzMQn3E3dgw: calls $0.50
*** FLOP *** [Qs 7d Ts]
L0aIPg7qefDQjdJo3HCVEA: checks
jwuKQ1S3U4NnzMQn3E3dgw: checks
*** TURN *** [Qs 7d Ts] [8c]
L0aIPg7qefDQjdJo3HCVEA: checks
jwuKQ1S3U4NnzMQn3E3dgw: bets $4
L0aIPg7qefDQjdJo3HCVEA: folds
jwuKQ1S3U4NnzMQn3E3dgw collected $2.15 from pot
*** SUMMARY ***
Total pot $2.25 | Rake $0.10
Board [Qs 7d Ts 8c]
Seat 1: tnD/64LagZ9qPaeOQVjVZg folded before Flop (didn't bet)
Seat 2: jwuKQ1S3U4NnzMQn3E3dgw collected ($2.15)
Seat 3: dZcLsEI8iXkobBduRJ45Yw folded before Flop (didn't bet)
Seat 4: QM93o65lI8kLzmiB/BILlA (button) folded before Flop (didn't bet)
Seat 5: X0X97o2fDAPiGx6o1gahsw (small blind) folded before Flop
Seat 6: L0aIPg7qefDQjdJo3HCVEA (big blind) folded on the Turn



PokerStars Game #59938668906:  Hold'em No Limit ($0.25/$0.50) - 2009/07/01 0:20:34 ET
Table '5EmHi+fnatGQQShcNmzOZQ' 6-max Seat #1 is the button
Seat 1: SwPczQo3cOtwEzhJrfO2cQ ($26.70 in chips)
Seat 3: L9qfLYXrczhAPd/VckgsWw ($60 in chips)
Seat 4: wOyVV9M/oyiw3YaOjNZ05w ($50 in chips)
Seat 5: kxPhs4ePFqMy52CInAJ2aw ($49.25 in chips)
Seat 6: 686aeHikcJlgKkSuIFdcXQ ($157.35 in chips)
L9qfLYXrczhAPd/VckgsWw: posts small blind $0.25
wOyVV9M/oyiw3YaOjNZ05w: posts big blind $0.50
*** HOLE CARDS ***
kxPhs4ePFqMy52CInAJ2aw: folds
686aeHikcJlgKkSuIFdcXQ: folds
SwPczQo3cOtwEzhJrfO2cQ: folds
L9qfLYXrczhAPd/VckgsWw: folds
wOyVV9M/oyiw3YaOjNZ05w collected $0.50 from pot
wOyVV9M/oyiw3YaOjNZ05w: doesn't show hand
*** SUMMARY ***
Total pot $0.50 | Rake $0
Seat 1: SwPczQo3cOtwEzhJrfO2cQ (button) folded before Flop (didn't bet)
Seat 3: L9qfLYXrczhAPd/VckgsWw (small blind) folded before Flop
Seat 4: wOyVV9M/oyiw3YaOjNZ05w (big blind) collected ($0.50)
Seat 5: kxPhs4ePFqMy52CInAJ2aw folded before Flop (didn't bet)
Seat 6: 686aeHikcJlgKkSuIFdcXQ folded before Flop (didn't bet)



PokerStars Game #59938669434:  Hold'em No Limit ($0.25/$0.50) - 2009/07/01 0:20:34 ET
Table 'QOgaEqMcJ73pcUMMxoisUg' 6-max Seat #6 is the button
Seat 1: RFefXIDyFvNtJLq+CloCzA ($40.45 in chips)
Seat 2: Im2p1Nt83UKSqv5c9frm4Q ($50 in chips)
Seat 3: wUZNozoIDYf+16hp4nn6dw ($60.30 in chips)
Seat 4: zAcsDhG/T128Vn7XGVSgKg ($50 in chips)
Seat 6: s83dnhZ6VC53vY0/f6OV/g ($42.05 in chips)
RFefXIDyFvNtJLq+CloCzA: posts small blind $0.25
Im2p1Nt83UKSqv5c9frm4Q: posts big blind $0.50
*** HOLE CARDS ***
wUZNozoIDYf+16hp4nn6dw: folds
zAcsDhG/T128Vn7XGVSgKg: folds
s83dnhZ6VC53vY0/f6OV/g: folds
RFefXIDyFvNtJLq+CloCzA: raises $1.50 to $2
Im2p1Nt83UKSqv5c9frm4Q: folds
Im2p1Nt83UKSqv5c9frm4Q is sitting out
RFefXIDyFvNtJLq+CloCzA collected $1 from pot
*** SUMMARY ***
Total pot $1 | Rake $0
Seat 1: RFefXIDyFvNtJLq+CloCzA (small blind) collected ($1)
Seat 2: Im2p1Nt83UKSqv5c9frm4Q (big blind) folded before Flop
Seat 3: wUZNozoIDYf+16hp4nn6dw folded before Flop (didn't bet)
Seat 4: zAcsDhG/T128Vn7XGVSgKg folded before Flop (didn't bet)
Seat 6: s83dnhZ6VC53vY0/f6OV/g (button) folded before Flop (didn't bet)



PokerStars Game #59938669758:  Hold'em No Limit ($0.25/$0.50) - 2009/07/01 0:20:35 ET
Table 'mTxf8gPLgffN3Iwfm7Icfg' 2-max Seat #2 is the button
Seat 1: Do9Rlu1R5u/AcRtMTl8SYg ($60.55 in chips)
Seat 2: EMc5LPgVaded4Qc77vm0fw ($101.25 in chips)
EMc5LPgVaded4Qc77vm0fw: posts small blind $0.25
Do9Rlu1R5u/AcRtMTl8SYg: posts big blind $0.50
*** HOLE CARDS ***
EMc5LPgVaded4Qc77vm0fw: raises $1.50 to $2
Do9Rlu1R5u/AcRtMTl8SYg: folds
EMc5LPgVaded4Qc77vm0fw collected $1 from pot
EMc5LPgVaded4Qc77vm0fw: doesn't show hand
*** SUMMARY ***
Total pot $1 | Rake $0
Seat 1: Do9Rlu1R5u/AcRtMTl8SYg (big blind) folded before Flop
Seat 2: EMc5LPgVaded4Qc77vm0fw (button) (small blind) collected ($1)



PokerStars Game #59938671974:  Hold'em No Limit ($0.25/$0.50) - 2009/07/01 0:20:38 ET
Table 'kgbJRsxfv64KrErDRBAkcw' 6-max Seat #1 is the button
Seat 1: N7O9jUEx2YiQn1+yRYTHmw ($17.70 in chips)
Seat 2: Q+thC23WCv1kJUJtH/+4Jw ($41.30 in chips)
Seat 3: T0Gx/FcQ5VH9u7XaOMX97A ($60.25 in chips)
Seat 4: qanMEqjABjWxC/JgQ/0l7w ($56.70 in chips)
Seat 5: +Pf9jTVizYlIo+woPvptfA ($50 in chips)
Seat 6: DDfYzIrYT0t5R/hAJngtsg ($27.65 in chips)
Q+thC23WCv1kJUJtH/+4Jw: posts small blind $0.25
T0Gx/FcQ5VH9u7XaOMX97A: posts big blind $0.50
*** HOLE CARDS ***
qanMEqjABjWxC/JgQ/0l7w: folds
+Pf9jTVizYlIo+woPvptfA: folds
DDfYzIrYT0t5R/hAJngtsg: calls $0.50
N7O9jUEx2YiQn1+yRYTHmw: calls $0.50
Q+thC23WCv1kJUJtH/+4Jw: calls $0.25
T0Gx/FcQ5VH9u7XaOMX97A: checks
*** FLOP *** [6h 7h Th]
Q+thC23WCv1kJUJtH/+4Jw: bets $2.50
T0Gx/FcQ5VH9u7XaOMX97A: folds
DDfYzIrYT0t5R/hAJngtsg: calls $2.50
N7O9jUEx2YiQn1+yRYTHmw: folds
*** TURN *** [6h 7h Th] [Td]
Q+thC23WCv1kJUJtH/+4Jw: checks
N7O9jUEx2YiQn1+yRYTHmw is sitting out
DDfYzIrYT0t5R/hAJngtsg: checks
*** RIVER *** [6h 7h Th Td] [Ah]
Q+thC23WCv1kJUJtH/+4Jw: bets $3.50
DDfYzIrYT0t5R/hAJngtsg: raises $7.50 to $11
Q+thC23WCv1kJUJtH/+4Jw: raises $11 to $22
DDfYzIrYT0t5R/hAJngtsg: raises $2.65 to $24.65 and is all-in
Q+thC23WCv1kJUJtH/+4Jw: calls $2.65
*** SHOW DOWN ***
DDfYzIrYT0t5R/hAJngtsg: shows [9c Kh] (a flush, Ace high)
Q+thC23WCv1kJUJtH/+4Jw: shows [9h 8h] (a straight flush, Six to Ten)
Q+thC23WCv1kJUJtH/+4Jw collected $53.50 from pot
*** SUMMARY ***
Total pot $56.30 | Rake $2.80
Board [6h 7h Th Td Ah]
Seat 1: N7O9jUEx2YiQn1+yRYTHmw (button) folded on the Flop
Seat 2: Q+thC23WCv1kJUJtH/+4Jw (small blind) showed [9h 8h] and won ($53.50) with a straight flush, Six to Ten
Seat 3: T0Gx/FcQ5VH9u7XaOMX97A (big blind) folded on the Flop
Seat 4: qanMEqjABjWxC/JgQ/0l7w folded before Flop (didn't bet)
Seat 5: +Pf9jTVizYlIo+woPvptfA folded before Flop (didn't bet)
Seat 6: DDfYzIrYT0t5R/hAJngtsg showed [9c Kh] and lost with a flush, Ace high



PokerStars Game #59938673644:  Hold'em No Limit ($0.25/$0.50) - 2009/07/01 0:20:41 ET
Table 'E7bWJ45aoFXRpyRv2gw+Ig' 2-max Seat #2 is the button
Seat 1: FRkiRasEGlHUeLrEl+k/nA ($62.60 in chips)
Seat 2: 3Wro85I7472vJ4Wkpneo9A ($117.05 in chips)
3Wro85I7472vJ4Wkpneo9A: posts small blind $0.25
FRkiRasEGlHUeLrEl+k/nA: posts big blind $0.50
*** HOLE CARDS ***
3Wro85I7472vJ4Wkpneo9A: folds
FRkiRasEGlHUeLrEl+k/nA collected $0.50 from pot
FRkiRasEGlHUeLrEl+k/nA: doesn't show hand
*** SUMMARY ***
Total pot $0.50 | Rake $0
Seat 1: FRkiRasEGlHUeLrEl+k/nA (big blind) collected ($0.50)
Seat 2: 3Wro85I7472vJ4Wkpneo9A (button) (small blind) folded before Flop



PokerStars Game #59938674362:  Hold'em No Limit ($0.25/$0.50) - 2009/07/01 0:20:42 ET
Table 'mTxf8gPLgffN3Iwfm7Icfg' 2-max Seat #1 is the button
Seat 1: Do9Rlu1R5u/AcRtMTl8SYg ($60.05 in chips)
Seat 2: EMc5LPgVaded4Qc77vm0fw ($101.75 in chips)
Do9Rlu1R5u/AcRtMTl8SYg: posts small blind $0.25
EMc5LPgVaded4Qc77vm0fw: posts big blind $0.50
*** HOLE CARDS ***
Do9Rlu1R5u/AcRtMTl8SYg: raises $1 to $1.50
EMc5LPgVaded4Qc77vm0fw: raises $4 to $5.50
Do9Rlu1R5u/AcRtMTl8SYg: calls $4
*** FLOP *** [9h Th 3c]
EMc5LPgVaded4Qc77vm0fw: bets $4.50
Do9Rlu1R5u/AcRtMTl8SYg: raises $7.50 to $12
EMc5LPgVaded4Qc77vm0fw: calls $7.50
*** TURN *** [9h Th 3c] [5s]
EMc5LPgVaded4Qc77vm0fw: checks
Do9Rlu1R5u/AcRtMTl8SYg: bets $25
EMc5LPgVaded4Qc77vm0fw: folds
Do9Rlu1R5u/AcRtMTl8SYg collected $34.50 from pot
Do9Rlu1R5u/AcRtMTl8SYg: doesn't show hand
*** SUMMARY ***
Total pot $35 | Rake $0.50
Board [9h Th 3c 5s]
Seat 1: Do9Rlu1R5u/AcRtMTl8SYg (button) (small blind) collected ($34.50)
Seat 2: EMc5LPgVaded4Qc77vm0fw (big blind) folded on the Turn



PokerStars Game #59938676062:  Hold'em No Limit ($0.25/$0.50) - 2009/07/01 0:20:44 ET
Table 'NCiXr0d5CEKBQr/cZgLhbA' 9-max Seat #6 is the button
Seat 1: RjBdQ6w31rgcy0o24VLR6w ($10 in chips)
Seat 2: ulxuJchBV9iguXg0FUonfg ($40.05 in chips)
Seat 3: xZCXQSXlrZkp3pZizzVXCw ($55.65 in chips)
Seat 4: CL4d+tvzcd4utdQxlPLOmg ($31.05 in chips)
Seat 5: zE9cVigS2nW/Ljy4K4bUQA ($30 in chips)
Seat 6: SKnJuWHScqetA/qG5p+wCg ($30 in chips)
Seat 7: M+7+BTmX5vZatHVuoRB1nA ($49.50 in chips)
Seat 8: 1MJUKc3cc0QmUoz1JZLR2w ($64.85 in chips)
Seat 9: WpvT3OUSiZlpvs+mPXFqtQ ($8.20 in chips)
M+7+BTmX5vZatHVuoRB1nA: posts small blind $0.25
1MJUKc3cc0QmUoz1JZLR2w: posts big blind $0.50
*** HOLE CARDS ***
WpvT3OUSiZlpvs+mPXFqtQ: folds
1MJUKc3cc0QmUoz1JZLR2w said, "AA"
RjBdQ6w31rgcy0o24VLR6w: folds
ulxuJchBV9iguXg0FUonfg: folds
xZCXQSXlrZkp3pZizzVXCw: folds
CL4d+tvzcd4utdQxlPLOmg: folds
zE9cVigS2nW/Ljy4K4bUQA: raises $1 to $1.50
SKnJuWHScqetA/qG5p+wCg: folds
M+7+BTmX5vZatHVuoRB1nA: folds
SKnJuWHScqetA/qG5p+wCg said, "strange call"
1MJUKc3cc0QmUoz1JZLR2w: folds
zE9cVigS2nW/Ljy4K4bUQA collected $1.25 from pot
*** SUMMARY ***
Total pot $1.25 | Rake $0
Seat 1: RjBdQ6w31rgcy0o24VLR6w folded before Flop (didn't bet)
Seat 2: ulxuJchBV9iguXg0FUonfg folded before Flop (didn't bet)
Seat 3: xZCXQSXlrZkp3pZizzVXCw folded before Flop (didn't bet)
Seat 4: CL4d+tvzcd4utdQxlPLOmg folded before Flop (didn't bet)
Seat 5: zE9cVigS2nW/Ljy4K4bUQA collected ($1.25)
Seat 6: SKnJuWHScqetA/qG5p+wCg (button) folded before Flop (didn't bet)
Seat 7: M+7+BTmX5vZatHVuoRB1nA (small blind) folded before Flop
Seat 8: 1MJUKc3cc0QmUoz1JZLR2w (big blind) folded before Flop
Seat 9: WpvT3OUSiZlpvs+mPXFqtQ folded before Flop (didn't bet)



PokerStars Game #59938677308:  Hold'em No Limit ($0.25/$0.50) - 2009/07/01 0:20:46 ET
Table 'raOT4/ipuZgzjfKHC+jD9g' 2-max Seat #1 is the button
Seat 1: IuwLemwLhc9fvrwBGs0AMA ($12.30 in chips)
Seat 2: Udr5juWSWUgTu1NlRhjMdA ($10 in chips)
IuwLemwLhc9fvrwBGs0AMA: posts small blind $0.25
Udr5juWSWUgTu1NlRhjMdA: posts big blind $0.50
*** HOLE CARDS ***
IuwLemwLhc9fvrwBGs0AMA: calls $0.25
Udr5juWSWUgTu1NlRhjMdA: checks
*** FLOP *** [9c 2d 5c]
Udr5juWSWUgTu1NlRhjMdA: checks
IuwLemwLhc9fvrwBGs0AMA: checks
*** TURN *** [9c 2d 5c] [Ac]
Udr5juWSWUgTu1NlRhjMdA: checks
IuwLemwLhc9fvrwBGs0AMA: bets $0.50
Udr5juWSWUgTu1NlRhjMdA: calls $0.50
*** RIVER *** [9c 2d 5c Ac] [6c]
Udr5juWSWUgTu1NlRhjMdA: checks
IuwLemwLhc9fvrwBGs0AMA: checks
*** SHOW DOWN ***
Udr5juWSWUgTu1NlRhjMdA: shows [Ad 3c] (a flush, Ace high)
IuwLemwLhc9fvrwBGs0AMA: mucks hand
Udr5juWSWUgTu1NlRhjMdA collected $1.95 from pot
*** SUMMARY ***
Total pot $2 | Rake $0.05
Board [9c 2d 5c Ac 6c]
Seat 1: IuwLemwLhc9fvrwBGs0AMA (button) (small blind) mucked
Seat 2: Udr5juWSWUgTu1NlRhjMdA (big blind) showed [Ad 3c] and won ($1.95) with a flush, Ace high



PokerStars Game #59938679602:  Hold'em No Limit ($0.25/$0.50) - 2009/07/01 0:20:49 ET
Table 'ZYwMb9E6tY50Qm+iNbXRYw' 2-max Seat #1 is the button
Seat 1: DXLfRb8KDZWmrztw2bwtFw ($17.10 in chips)
Seat 2: 16tvT7AYgZ2LgiGFcvFKQg ($15.30 in chips)
DXLfRb8KDZWmrztw2bwtFw: posts small blind $0.25
16tvT7AYgZ2LgiGFcvFKQg: posts big blind $0.50
*** HOLE CARDS ***
DXLfRb8KDZWmrztw2bwtFw: calls $0.25
16tvT7AYgZ2LgiGFcvFKQg: checks
*** FLOP *** [3h 6d Jh]
16tvT7AYgZ2LgiGFcvFKQg: bets $0.50
DXLfRb8KDZWmrztw2bwtFw: calls $0.50
*** TURN *** [3h 6d Jh] [6s]
16tvT7AYgZ2LgiGFcvFKQg: bets $0.50
DXLfRb8KDZWmrztw2bwtFw: calls $0.50
*** RIVER *** [3h 6d Jh 6s] [Kc]
16tvT7AYgZ2LgiGFcvFKQg: bets $1.50
DXLfRb8KDZWmrztw2bwtFw: folds
16tvT7AYgZ2LgiGFcvFKQg collected $2.90 from pot
16tvT7AYgZ2LgiGFcvFKQg: doesn't show hand
*** SUMMARY ***
Total pot $3 | Rake $0.10
Board [3h 6d Jh 6s Kc]
Seat 1: DXLfRb8KDZWmrztw2bwtFw (button) (small blind) folded on the River
Seat 2: 16tvT7AYgZ2LgiGFcvFKQg (big blind) collected ($2.90)



PokerStars Game #59938679876:  Hold'em No Limit ($0.25/$0.50) - 2009/07/01 0:20:49 ET
Table 'E7bWJ45aoFXRpyRv2gw+Ig' 2-max Seat #1 is the button
Seat 1: FRkiRasEGlHUeLrEl+k/nA ($62.85 in chips)
Seat 2: 3Wro85I7472vJ4Wkpneo9A ($116.80 in chips)
FRkiRasEGlHUeLrEl+k/nA: posts small blind $0.25
3Wro85I7472vJ4Wkpneo9A: posts big blind $0.50
*** HOLE CARDS ***
FRkiRasEGlHUeLrEl+k/nA: folds
3Wro85I7472vJ4Wkpneo9A collected $0.50 from pot
3Wro85I7472vJ4Wkpneo9A: doesn't show hand
*** SUMMARY ***
Total pot $0.50 | Rake $0
Seat 1: FRkiRasEGlHUeLrEl+k/nA (button) (small blind) folded before Flop
Seat 2: 3Wro85I7472vJ4Wkpneo9A (big blind) collected ($0.50)



PokerStars Game #59938680232:  Hold'em No Limit ($0.25/$0.50) - 2009/07/01 0:20:50 ET
Table '+dXkOAQyS8j9PQZusUTMpg' 2-max Seat #2 is the button
Seat 1: XFa6sBGjP2gxoIvxR3fZIg ($67 in chips)
Seat 2: 5IBeOgaApY1Bvzv2P8X4EA ($41.70 in chips)
5IBeOgaApY1Bvzv2P8X4EA: posts small blind $0.25
XFa6sBGjP2gxoIvxR3fZIg: posts big blind $0.50
*** HOLE CARDS ***
5IBeOgaApY1Bvzv2P8X4EA: folds
XFa6sBGjP2gxoIvxR3fZIg collected $0.50 from pot
XFa6sBGjP2gxoIvxR3fZIg: doesn't show hand
*** SUMMARY ***
Total pot $0.50 | Rake $0
Seat 1: XFa6sBGjP2gxoIvxR3fZIg (big blind) collected ($0.50)
Seat 2: 5IBeOgaApY1Bvzv2P8X4EA (button) (small blind) folded before Flop



PokerStars Game #59938680120:  Hold'em No Limit ($0.25/$0.50) - 2009/07/01 0:20:50 ET
Table 'MJxeZCzYELxiIsyUZyT0jw' 6-max Seat #3 is the button
Seat 1: iKPos8JI094Tomq4tDSgnQ ($33.50 in chips)
Seat 2: r6H1GiZ6QIpMTDhyodKuRQ ($63.90 in chips)
Seat 3: JQZew0FjzS19kTjeNtrE+A ($50 in chips)
Seat 4: lP7Q6pewz4C2RsAfKsjdWw ($32.25 in chips)
Seat 5: 3jvoOXNtXE90w2BdfNZwZQ ($50 in chips)
Seat 6: TTx3CHxyi0SObcHyMJRp5w ($50.50 in chips)
lP7Q6pewz4C2RsAfKsjdWw: posts small blind $0.25
3jvoOXNtXE90w2BdfNZwZQ: posts big blind $0.50
*** HOLE CARDS ***
TTx3CHxyi0SObcHyMJRp5w: folds
iKPos8JI094Tomq4tDSgnQ: raises $2.50 to $3
r6H1GiZ6QIpMTDhyodKuRQ: folds
JQZew0FjzS19kTjeNtrE+A: calls $3
lP7Q6pewz4C2RsAfKsjdWw: folds
3jvoOXNtXE90w2BdfNZwZQ: folds
*** FLOP *** [Qs Js 7d]
iKPos8JI094Tomq4tDSgnQ: checks
JQZew0FjzS19kTjeNtrE+A: bets $4
iKPos8JI094Tomq4tDSgnQ: folds
JQZew0FjzS19kTjeNtrE+A collected $6.45 from pot
*** SUMMARY ***
Total pot $6.75 | Rake $0.30
Board [Qs Js 7d]
Seat 1: iKPos8JI094Tomq4tDSgnQ folded on the Flop
Seat 2: r6H1GiZ6QIpMTDhyodKuRQ folded before Flop (didn't bet)
Seat 3: JQZew0FjzS19kTjeNtrE+A (button) collected ($6.45)
Seat 4: lP7Q6pewz4C2RsAfKsjdWw (small blind) folded before Flop
Seat 5: 3jvoOXNtXE90w2BdfNZwZQ (big blind) folded before Flop
Seat 6: TTx3CHxyi0SObcHyMJRp5w folded before Flop (didn't bet)



PokerStars Game #59938683292:  Hold'em No Limit ($0.25/$0.50) - 2009/07/01 0:20:54 ET
Table '5EmHi+fnatGQQShcNmzOZQ' 6-max Seat #3 is the button
Seat 1: SwPczQo3cOtwEzhJrfO2cQ ($26.70 in chips)
Seat 3: L9qfLYXrczhAPd/VckgsWw ($59.75 in chips)
Seat 4: wOyVV9M/oyiw3YaOjNZ05w ($50.25 in chips)
Seat 5: kxPhs4ePFqMy52CInAJ2aw ($49.25 in chips)
Seat 6: 686aeHikcJlgKkSuIFdcXQ ($157.35 in chips)
wOyVV9M/oyiw3YaOjNZ05w: posts small blind $0.25
kxPhs4ePFqMy52CInAJ2aw: posts big blind $0.50
*** HOLE CARDS ***
686aeHikcJlgKkSuIFdcXQ: folds
SwPczQo3cOtwEzhJrfO2cQ: folds
L9qfLYXrczhAPd/VckgsWw: folds
wOyVV9M/oyiw3YaOjNZ05w: raises $1.50 to $2
kxPhs4ePFqMy52CInAJ2aw: folds
wOyVV9M/oyiw3YaOjNZ05w collected $1 from pot
wOyVV9M/oyiw3YaOjNZ05w: doesn't show hand
*** SUMMARY ***
Total pot $1 | Rake $0
Seat 1: SwPczQo3cOtwEzhJrfO2cQ folded before Flop (didn't bet)
Seat 3: L9qfLYXrczhAPd/VckgsWw (button) folded before Flop (didn't bet)
Seat 4: wOyVV9M/oyiw3YaOjNZ05w (small blind) collected ($1)
Seat 5: kxPhs4ePFqMy52CInAJ2aw (big blind) folded before Flop
Seat 6: 686aeHikcJlgKkSuIFdcXQ folded before Flop (didn't bet)



PokerStars Game #59938682852:  Hold'em No Limit ($0.25/$0.50) - 2009/07/01 0:20:54 ET
Table 'tyR5AZNKV8Aadbrnrnlg7g' 6-max Seat #1 is the button
Seat 1: R+KjpH/wSjDLhtIy9+edNA ($54.70 in chips)
Seat 2: 58zdeSBSuSFX/qZfhc7YmA ($33.35 in chips)
Seat 3: jUhx+m+V7qfbLZTjgwZByg ($26.15 in chips)
Seat 4: Rt6KgtZ8YaJoTc3FPim00w ($85 in chips)
Seat 6: DMQLAmut/l19xN5STQndFg ($7.15 in chips)
58zdeSBSuSFX/qZfhc7YmA: posts small blind $0.25
jUhx+m+V7qfbLZTjgwZByg: posts big blind $0.50
wOyVV9M/oyiw3YaOjNZ05w: sits out
*** HOLE CARDS ***
Rt6KgtZ8YaJoTc3FPim00w: folds
DMQLAmut/l19xN5STQndFg: calls $0.50
R+KjpH/wSjDLhtIy9+edNA: folds
58zdeSBSuSFX/qZfhc7YmA: folds
jUhx+m+V7qfbLZTjgwZByg: checks
*** FLOP *** [Qs Qc Qd]
jUhx+m+V7qfbLZTjgwZByg: bets $0.50
DMQLAmut/l19xN5STQndFg: raises $0.50 to $1
jUhx+m+V7qfbLZTjgwZByg: folds
DMQLAmut/l19xN5STQndFg collected $2.15 from pot
DMQLAmut/l19xN5STQndFg: doesn't show hand
*** SUMMARY ***
Total pot $2.25 | Rake $0.10
Board [Qs Qc Qd]
Seat 1: R+KjpH/wSjDLhtIy9+edNA (button) folded before Flop (didn't bet)
Seat 2: 58zdeSBSuSFX/qZfhc7YmA (small blind) folded before Flop
Seat 3: jUhx+m+V7qfbLZTjgwZByg (big blind) folded on the Flop
Seat 4: Rt6KgtZ8YaJoTc3FPim00w folded before Flop (didn't bet)
Seat 6: DMQLAmut/l19xN5STQndFg collected ($2.15)



PokerStars Game #59938683774:  Hold'em No Limit ($0.25/$0.50) - 2009/07/01 0:20:55 ET
Table 'E7bWJ45aoFXRpyRv2gw+Ig' 2-max Seat #2 is the button
Seat 1: FRkiRasEGlHUeLrEl+k/nA ($62.60 in chips)
Seat 2: 3Wro85I7472vJ4Wkpneo9A ($117.05 in chips)
3Wro85I7472vJ4Wkpneo9A: posts small blind $0.25
FRkiRasEGlHUeLrEl+k/nA: posts big blind $0.50
*** HOLE CARDS ***
3Wro85I7472vJ4Wkpneo9A: raises $1 to $1.50
FRkiRasEGlHUeLrEl+k/nA: calls $1
*** FLOP *** [4s 5h 2h]
FRkiRasEGlHUeLrEl+k/nA: checks
3Wro85I7472vJ4Wkpneo9A: checks
*** TURN *** [4s 5h 2h] [Td]
FRkiRasEGlHUeLrEl+k/nA: checks
3Wro85I7472vJ4Wkpneo9A: checks
*** RIVER *** [4s 5h 2h Td] [3d]
FRkiRasEGlHUeLrEl+k/nA: bets $7
3Wro85I7472vJ4Wkpneo9A: folds
FRkiRasEGlHUeLrEl+k/nA collected $2.85 from pot
FRkiRasEGlHUeLrEl+k/nA: doesn't show hand
*** SUMMARY ***
Total pot $3 | Rake $0.15
Board [4s 5h 2h Td 3d]
Seat 1: FRkiRasEGlHUeLrEl+k/nA (big blind) collected ($2.85)
Seat 2: 3Wro85I7472vJ4Wkpneo9A (button) (small blind) folded on the River



PokerStars Game #59938684666:  Hold'em No Limit ($0.25/$0.50) - 2009/07/01 0:20:56 ET
Table '+dXkOAQyS8j9PQZusUTMpg' 2-max Seat #1 is the button
Seat 1: XFa6sBGjP2gxoIvxR3fZIg ($67.25 in chips)
Seat 2: 5IBeOgaApY1Bvzv2P8X4EA ($41.45 in chips)
XFa6sBGjP2gxoIvxR3fZIg: posts small blind $0.25
5IBeOgaApY1Bvzv2P8X4EA: posts big blind $0.50
*** HOLE CARDS ***
XFa6sBGjP2gxoIvxR3fZIg: raises $1 to $1.50
5IBeOgaApY1Bvzv2P8X4EA: raises $2 to $3.50
XFa6sBGjP2gxoIvxR3fZIg: calls $2
*** FLOP *** [Qs 5h Ad]
5IBeOgaApY1Bvzv2P8X4EA: checks
XFa6sBGjP2gxoIvxR3fZIg: bets $4.50
5IBeOgaApY1Bvzv2P8X4EA: calls $4.50
*** TURN *** [Qs 5h Ad] [Qc]
5IBeOgaApY1Bvzv2P8X4EA: checks
XFa6sBGjP2gxoIvxR3fZIg: checks
*** RIVER *** [Qs 5h Ad Qc] [6h]
5IBeOgaApY1Bvzv2P8X4EA: bets $10
XFa6sBGjP2gxoIvxR3fZIg: folds
5IBeOgaApY1Bvzv2P8X4EA collected $15.50 from pot
5IBeOgaApY1Bvzv2P8X4EA: doesn't show hand
*** SUMMARY ***
Total pot $16 | Rake $0.50
Board [Qs 5h Ad Qc 6h]
Seat 1: XFa6sBGjP2gxoIvxR3fZIg (button) (small blind) folded on the River
Seat 2: 5IBeOgaApY1Bvzv2P8X4EA (big blind) collected ($15.50)



PokerStars Game #59938684246:  Hold'em No Limit ($0.25/$0.50) - 2009/07/01 0:20:56 ET
Table 'QOgaEqMcJ73pcUMMxoisUg' 6-max Seat #1 is the button
Seat 1: RFefXIDyFvNtJLq+CloCzA ($40.95 in chips)
Seat 3: wUZNozoIDYf+16hp4nn6dw ($60.30 in chips)
Seat 4: zAcsDhG/T128Vn7XGVSgKg ($50 in chips)
Seat 6: s83dnhZ6VC53vY0/f6OV/g ($42.05 in chips)
wUZNozoIDYf+16hp4nn6dw: posts small blind $0.25
zAcsDhG/T128Vn7XGVSgKg: posts big blind $0.50
*** HOLE CARDS ***
s83dnhZ6VC53vY0/f6OV/g: folds
RFefXIDyFvNtJLq+CloCzA: folds
wUZNozoIDYf+16hp4nn6dw: calls $0.25
zAcsDhG/T128Vn7XGVSgKg: checks
*** FLOP *** [9d Qs 5d]
wUZNozoIDYf+16hp4nn6dw: bets $0.50
zAcsDhG/T128Vn7XGVSgKg: calls $0.50
*** TURN *** [9d Qs 5d] [9h]
wUZNozoIDYf+16hp4nn6dw: bets $4
zAcsDhG/T128Vn7XGVSgKg: raises $10 to $14
wUZNozoIDYf+16hp4nn6dw: calls $10
*** RIVER *** [9d Qs 5d 9h] [7h]
wUZNozoIDYf+16hp4nn6dw: checks
zAcsDhG/T128Vn7XGVSgKg: bets $35 and is all-in
6vNxrjjCl6FwfaaymM9jjg joins the table at seat #5
wUZNozoIDYf+16hp4nn6dw: folds
zAcsDhG/T128Vn7XGVSgKg collected $28.55 from pot
*** SUMMARY ***
Total pot $30 | Rake $1.45
Board [9d Qs 5d 9h 7h]
Seat 1: RFefXIDyFvNtJLq+CloCzA (button) folded before Flop (didn't bet)
Seat 3: wUZNozoIDYf+16hp4nn6dw (small blind) folded on the River
Seat 4: zAcsDhG/T128Vn7XGVSgKg (big blind) collected ($28.55)
Seat 6: s83dnhZ6VC53vY0/f6OV/g folded before Flop (didn't bet)



PokerStars Game #59938685062:  Hold'em No Limit ($0.25/$0.50) - 2009/07/01 0:20:57 ET
Table 'c/CRn+68J3Y8KxD5g1ek2Q' 2-max Seat #1 is the button
Seat 1: 46qCyJ6evTkHo9al5sBMNA ($271.40 in chips)
Seat 2: BypVLsYQt3ePFm2xQL/dOA ($110.60 in chips)
46qCyJ6evTkHo9al5sBMNA: posts small blind $0.25
BypVLsYQt3ePFm2xQL/dOA: posts big blind $0.50
*** HOLE CARDS ***
46qCyJ6evTkHo9al5sBMNA: raises $1.50 to $2
BypVLsYQt3ePFm2xQL/dOA: folds
46qCyJ6evTkHo9al5sBMNA collected $1 from pot
46qCyJ6evTkHo9al5sBMNA: doesn't show hand
*** SUMMARY ***
Total pot $1 | Rake $0
Seat 1: 46qCyJ6evTkHo9al5sBMNA (button) (small blind) collected ($1)
Seat 2: BypVLsYQt3ePFm2xQL/dOA (big blind) folded before Flop



PokerStars Game #59938685724:  Hold'em No Limit ($0.25/$0.50) - 2009/07/01 0:20:58 ET
Table '3FhG0gl3kMX3wBEEqj+wnQ' 9-max Seat #9 is the button
Seat 1: e0J9pdCNUDTCG031RnXqLA ($9.75 in chips)
Seat 2: 4dl3YNqZ6Houm2jZAzDmRg ($24.50 in chips)
Seat 4: bz4LMfV0GGl/MJ/ABXuPmg ($22.20 in chips)
Seat 5: XNMDwbXt/Q4jM99AXnbJDw ($55.55 in chips)
Seat 6: 5JJVDlaiMnB004o/RqbZZQ ($24.50 in chips)
Seat 7: mSD1pginDsyHG5PDfqzphw ($10 in chips)
Seat 8: j3K/Jujr7PY4ZM2RZvlH6A ($46.40 in chips)
Seat 9: L5e2lrPLQm1Pqx30IIZ/Fw ($10 in chips)
e0J9pdCNUDTCG031RnXqLA: posts small blind $0.25
4dl3YNqZ6Houm2jZAzDmRg: posts big blind $0.50
HZkVla4kK2SI42CVrPZ/ig: sits out
*** HOLE CARDS ***
bz4LMfV0GGl/MJ/ABXuPmg: folds
XNMDwbXt/Q4jM99AXnbJDw: folds
5JJVDlaiMnB004o/RqbZZQ: folds
mSD1pginDsyHG5PDfqzphw: folds
j3K/Jujr7PY4ZM2RZvlH6A: folds
L5e2lrPLQm1Pqx30IIZ/Fw: folds
e0J9pdCNUDTCG031RnXqLA: folds
4dl3YNqZ6Houm2jZAzDmRg collected $0.50 from pot
*** SUMMARY ***
Total pot $0.50 | Rake $0
Seat 1: e0J9pdCNUDTCG031RnXqLA (small blind) folded before Flop
Seat 2: 4dl3YNqZ6Houm2jZAzDmRg (big blind) collected ($0.50)
Seat 4: bz4LMfV0GGl/MJ/ABXuPmg folded before Flop (didn't bet)
Seat 5: XNMDwbXt/Q4jM99AXnbJDw folded before Flop (didn't bet)
Seat 6: 5JJVDlaiMnB004o/RqbZZQ folded before Flop (didn't bet)
Seat 7: mSD1pginDsyHG5PDfqzphw folded before Flop (didn't bet)
Seat 8: j3K/Jujr7PY4ZM2RZvlH6A folded before Flop (didn't bet)
Seat 9: L5e2lrPLQm1Pqx30IIZ/Fw (button) folded before Flop (didn't bet)



PokerStars Game #59938688118:  Hold'em No Limit ($0.25/$0.50) - 2009/07/01 0:21:02 ET
Table '+z1aekfHkpp09pc8F9aViw' 6-max Seat #5 is the button
Seat 1: wOyVV9M/oyiw3YaOjNZ05w ($50 in chips)
Seat 2: M6xK/VklCvdyyrmvzATlxQ ($30.70 in chips)
Seat 3: uUznlIMFnRUvwrBhYF73KA ($63.25 in chips)
Seat 4: RowCSpSURHTOL/dcjg/Iug ($50 in chips)
Seat 5: crjGpJEzSZgD38FoE3VMGg ($59.15 in chips)
Seat 6: 686aeHikcJlgKkSuIFdcXQ ($69.60 in chips)
686aeHikcJlgKkSuIFdcXQ: posts small blind $0.25
wOyVV9M/oyiw3YaOjNZ05w: posts big blind $0.50
RowCSpSURHTOL/dcjg/Iug: posts big blind $0.50
*** HOLE CARDS ***
M6xK/VklCvdyyrmvzATlxQ: folds
uUznlIMFnRUvwrBhYF73KA: folds
RowCSpSURHTOL/dcjg/Iug: checks
crjGpJEzSZgD38FoE3VMGg: folds
686aeHikcJlgKkSuIFdcXQ: folds
wOyVV9M/oyiw3YaOjNZ05w: checks
*** FLOP *** [7c 8s As]
wOyVV9M/oyiw3YaOjNZ05w: checks
RowCSpSURHTOL/dcjg/Iug: checks
*** TURN *** [7c 8s As] [Th]
wOyVV9M/oyiw3YaOjNZ05w: checks
RowCSpSURHTOL/dcjg/Iug: bets $1
wOyVV9M/oyiw3YaOjNZ05w: folds
RowCSpSURHTOL/dcjg/Iug collected $1.20 from pot
*** SUMMARY ***
Total pot $1.25 | Rake $0.05
Board [7c 8s As Th]
Seat 1: wOyVV9M/oyiw3YaOjNZ05w (big blind) folded on the Turn
Seat 2: M6xK/VklCvdyyrmvzATlxQ folded before Flop (didn't bet)
Seat 3: uUznlIMFnRUvwrBhYF73KA folded before Flop (didn't bet)
Seat 4: RowCSpSURHTOL/dcjg/Iug collected ($1.20)
Seat 5: crjGpJEzSZgD38FoE3VMGg (button) folded before Flop (didn't bet)
Seat 6: 686aeHikcJlgKkSuIFdcXQ (small blind) folded before Flop



PokerStars Game #59938689034:  Hold'em No Limit ($0.25/$0.50) - 2009/07/01 0:21:03 ET
Table 'IeNZOZQ4T6oiaHqFeo6yIA' 2-max Seat #2 is the button
Seat 1: ndd1nfncBkWNitBnsfCoVQ ($80.95 in chips)
Seat 2: A91IUl5JaZROhtfCtnnwYw ($5.05 in chips)
A91IUl5JaZROhtfCtnnwYw: posts small blind $0.25
ndd1nfncBkWNitBnsfCoVQ: posts big blind $0.50
*** HOLE CARDS ***
A91IUl5JaZROhtfCtnnwYw: calls $0.25
ndd1nfncBkWNitBnsfCoVQ: checks
*** FLOP *** [Js 6s Kc]
ndd1nfncBkWNitBnsfCoVQ: bets $1
A91IUl5JaZROhtfCtnnwYw: calls $1
*** TURN *** [Js 6s Kc] [5c]
ndd1nfncBkWNitBnsfCoVQ: bets $9
A91IUl5JaZROhtfCtnnwYw: folds
ndd1nfncBkWNitBnsfCoVQ collected $2.90 from pot
ndd1nfncBkWNitBnsfCoVQ: doesn't show hand
*** SUMMARY ***
Total pot $3 | Rake $0.10
Board [Js 6s Kc 5c]
Seat 1: ndd1nfncBkWNitBnsfCoVQ (big blind) collected ($2.90)
Seat 2: A91IUl5JaZROhtfCtnnwYw (button) (small blind) folded on the Turn



PokerStars Game #59938691120:  Hold'em No Limit ($0.25/$0.50) - 2009/07/01 0:21:06 ET
Table 'ZYwMb9E6tY50Qm+iNbXRYw' 2-max Seat #2 is the button
Seat 1: DXLfRb8KDZWmrztw2bwtFw ($15.60 in chips)
Seat 2: 16tvT7AYgZ2LgiGFcvFKQg ($16.70 in chips)
16tvT7AYgZ2LgiGFcvFKQg: posts small blind $0.25
DXLfRb8KDZWmrztw2bwtFw: posts big blind $0.50
*** HOLE CARDS ***
16tvT7AYgZ2LgiGFcvFKQg: raises $0.50 to $1
DXLfRb8KDZWmrztw2bwtFw: folds
16tvT7AYgZ2LgiGFcvFKQg collected $1 from pot
*** SUMMARY ***
Total pot $1 | Rake $0
Seat 1: DXLfRb8KDZWmrztw2bwtFw (big blind) folded before Flop
Seat 2: 16tvT7AYgZ2LgiGFcvFKQg (button) (small blind) collected ($1)



PokerStars Game #59938691100:  Hold'em No Limit ($0.25/$0.50) - 2009/07/01 0:21:06 ET
Table 'GfL/No5u5PoEnU39lP5pQg' 6-max Seat #4 is the button
Seat 2: uVwggSetzp7d+eVgowO3vg ($46.50 in chips)
Seat 3: qNezhXOOUXqwG7b9X5XJAA ($50 in chips)
Seat 4: yqM0AD7MZQd/cEtKdDQY1A ($17.55 in chips)
Seat 5: crjGpJEzSZgD38FoE3VMGg ($52.30 in chips)
Seat 6: 3wylWYGeXFXcrE4XVrlPng ($64.60 in chips)
crjGpJEzSZgD38FoE3VMGg: posts small blind $0.25
3wylWYGeXFXcrE4XVrlPng: posts big blind $0.50
1WUCqNG+p+vfWRTXNu4ljw: sits out
*** HOLE CARDS ***
uVwggSetzp7d+eVgowO3vg: raises $1.50 to $2
qNezhXOOUXqwG7b9X5XJAA: folds
yqM0AD7MZQd/cEtKdDQY1A: folds
crjGpJEzSZgD38FoE3VMGg: folds
3wylWYGeXFXcrE4XVrlPng: folds
uVwggSetzp7d+eVgowO3vg collected $1.25 from pot
uVwggSetzp7d+eVgowO3vg: doesn't show hand
*** SUMMARY ***
Total pot $1.25 | Rake $0
Seat 2: uVwggSetzp7d+eVgowO3vg collected ($1.25)
Seat 3: qNezhXOOUXqwG7b9X5XJAA folded before Flop (didn't bet)
Seat 4: yqM0AD7MZQd/cEtKdDQY1A (button) folded before Flop (didn't bet)
Seat 5: crjGpJEzSZgD38FoE3VMGg (small blind) folded before Flop
Seat 6: 3wylWYGeXFXcrE4XVrlPng (big blind) folded before Flop



PokerStars Game #59938691642:  Hold'em No Limit ($0.25/$0.50) - 2009/07/01 0:21:07 ET
Table 'c/CRn+68J3Y8KxD5g1ek2Q' 2-max Seat #2 is the button
Seat 1: 46qCyJ6evTkHo9al5sBMNA ($271.90 in chips)
Seat 2: BypVLsYQt3ePFm2xQL/dOA ($110.10 in chips)
BypVLsYQt3ePFm2xQL/dOA: posts small blind $0.25
46qCyJ6evTkHo9al5sBMNA: posts big blind $0.50
*** HOLE CARDS ***
BypVLsYQt3ePFm2xQL/dOA: raises $2 to $2.50
46qCyJ6evTkHo9al5sBMNA: folds
BypVLsYQt3ePFm2xQL/dOA collected $1 from pot
BypVLsYQt3ePFm2xQL/dOA: doesn't show hand
*** SUMMARY ***
Total pot $1 | Rake $0
Seat 1: 46qCyJ6evTkHo9al5sBMNA (big blind) folded before Flop
Seat 2: BypVLsYQt3ePFm2xQL/dOA (button) (small blind) collected ($1)



PokerStars Game #59938691644:  Hold'em No Limit ($0.25/$0.50) - 2009/07/01 0:21:07 ET
Table 'X6IRCRTh+20gjz8aubWnwA' 9-max Seat #4 is the button
Seat 2: RjBdQ6w31rgcy0o24VLR6w ($12.40 in chips)
Seat 3: mSD1pginDsyHG5PDfqzphw ($19.75 in chips)
Seat 4: uw9QayAAxLM3Hb+HR7mSkg ($10.25 in chips)
Seat 5: QtFsO51ArDuQ44+KvR2jow ($29.70 in chips)
Seat 6: /6In1zC3WtgwxDcueWzZWg ($58.10 in chips)
Seat 7: VBnpbzn0dIveV55qKvciew ($43.95 in chips)
Seat 9: M+7+BTmX5vZatHVuoRB1nA ($81.60 in chips)
QtFsO51ArDuQ44+KvR2jow: posts small blind $0.25
/6In1zC3WtgwxDcueWzZWg: posts big blind $0.50
HxeBVq06/3Bh/H986sgdbw: sits out
*** HOLE CARDS ***
VBnpbzn0dIveV55qKvciew: calls $0.50
M+7+BTmX5vZatHVuoRB1nA: folds
RjBdQ6w31rgcy0o24VLR6w: folds
mSD1pginDsyHG5PDfqzphw: folds
VBnpbzn0dIveV55qKvciew said, "vnh"
uw9QayAAxLM3Hb+HR7mSkg: raises $9.75 to $10.25 and is all-in
QtFsO51ArDuQ44+KvR2jow: folds
/6In1zC3WtgwxDcueWzZWg: folds
VBnpbzn0dIveV55qKvciew: folds
uw9QayAAxLM3Hb+HR7mSkg collected $1.75 from pot
uw9QayAAxLM3Hb+HR7mSkg: doesn't show hand
*** SUMMARY ***
Total pot $1.75 | Rake $0
Seat 2: RjBdQ6w31rgcy0o24VLR6w folded before Flop (didn't bet)
Seat 3: mSD1pginDsyHG5PDfqzphw folded before Flop (didn't bet)
Seat 4: uw9QayAAxLM3Hb+HR7mSkg (button) collected ($1.75)
Seat 5: QtFsO51ArDuQ44+KvR2jow (small blind) folded before Flop
Seat 6: /6In1zC3WtgwxDcueWzZWg (big blind) folded before Flop
Seat 7: VBnpbzn0dIveV55qKvciew folded before Flop
Seat 9: M+7+BTmX5vZatHVuoRB1nA folded before Flop (didn't bet)



PokerStars Game #59938692752:  Hold'em No Limit ($0.25/$0.50) - 2009/07/01 0:21:09 ET
Table 'Nz0Vr7WMHL2g5Uk7dDZjpw' 9-max Seat #7 is the button
Seat 3: 4QTiNH5fteLgJjx/s6Hy6A ($19.90 in chips)
Seat 4: 5JJVDlaiMnB004o/RqbZZQ ($27.50 in chips)
Seat 5: WGW0DgjBUXs1ylURHG8vnQ ($11.10 in chips)
Seat 6: k1f0lS7tlMHCLGs0JT34Tg ($9.25 in chips)
Seat 7: KPLH0gELgFe2OuAnhJFI5w ($19.70 in chips)
Seat 8: HkZI6g4zl83TDTA7SRspmQ ($21.20 in chips)
Seat 9: Ak2W6V2TDVIQrvSAy4eD7Q ($25.15 in chips)
HkZI6g4zl83TDTA7SRspmQ: posts small blind $0.25
Ak2W6V2TDVIQrvSAy4eD7Q: posts big blind $0.50
XNMDwbXt/Q4jM99AXnbJDw: sits out
*** HOLE CARDS ***
4QTiNH5fteLgJjx/s6Hy6A: raises $1 to $1.50
5JJVDlaiMnB004o/RqbZZQ: folds
WGW0DgjBUXs1ylURHG8vnQ: folds
k1f0lS7tlMHCLGs0JT34Tg: folds
KPLH0gELgFe2OuAnhJFI5w: folds
HkZI6g4zl83TDTA7SRspmQ: folds
Ak2W6V2TDVIQrvSAy4eD7Q: calls $1
*** FLOP *** [5d 5s 2s]
Ak2W6V2TDVIQrvSAy4eD7Q: checks
4QTiNH5fteLgJjx/s6Hy6A: bets $2.50
Ak2W6V2TDVIQrvSAy4eD7Q: folds
4QTiNH5fteLgJjx/s6Hy6A collected $3.10 from pot
*** SUMMARY ***
Total pot $3.25 | Rake $0.15
Board [5d 5s 2s]
Seat 3: 4QTiNH5fteLgJjx/s6Hy6A collected ($3.10)
Seat 4: 5JJVDlaiMnB004o/RqbZZQ folded before Flop (didn't bet)
Seat 5: WGW0DgjBUXs1ylURHG8vnQ folded before Flop (didn't bet)
Seat 6: k1f0lS7tlMHCLGs0JT34Tg folded before Flop (didn't bet)
Seat 7: KPLH0gELgFe2OuAnhJFI5w (button) folded before Flop (didn't bet)
Seat 8: HkZI6g4zl83TDTA7SRspmQ (small blind) folded before Flop
Seat 9: Ak2W6V2TDVIQrvSAy4eD7Q (big blind) folded on the Flop



PokerStars Game #59938695394:  Hold'em No Limit ($0.25/$0.50) - 2009/07/01 0:21:12 ET
Table 'lSisgp6H7Fg1hH5VfjEjYQ' 9-max Seat #9 is the button
Seat 1: pEW8B6uXbdR47kfljMQ3+Q ($38.45 in chips)
Seat 2: UrcnkQOiLVk8BlKDPJSy7Q ($51.10 in chips)
Seat 3: aTkyjTh3w5YLWiIERupZOA ($38.45 in chips)
Seat 4: nvw9yQKhJT56lA9k+TLdhw ($11.25 in chips)
Seat 5: mSD1pginDsyHG5PDfqzphw ($10 in chips)
Seat 6: +k7T5ocke8UwavtgUHm+Cg ($26.60 in chips)
Seat 7: dGw5MBstXyXhWHHVFOWOFA ($43 in chips)
Seat 8: a4JDWmpFQkL10XfAyuF51A ($24.70 in chips)
Seat 9: 5JJVDlaiMnB004o/RqbZZQ ($41 in chips)
pEW8B6uXbdR47kfljMQ3+Q: posts small blind $0.25
UrcnkQOiLVk8BlKDPJSy7Q: posts big blind $0.50
*** HOLE CARDS ***
aTkyjTh3w5YLWiIERupZOA: folds
nvw9yQKhJT56lA9k+TLdhw: raises $1 to $1.50
mSD1pginDsyHG5PDfqzphw: folds
+k7T5ocke8UwavtgUHm+Cg: folds
dGw5MBstXyXhWHHVFOWOFA: folds
a4JDWmpFQkL10XfAyuF51A: calls $1.50
5JJVDlaiMnB004o/RqbZZQ: folds
pEW8B6uXbdR47kfljMQ3+Q: folds
UrcnkQOiLVk8BlKDPJSy7Q: folds
*** FLOP *** [4s 4c 8s]
nvw9yQKhJT56lA9k+TLdhw: bets $1.50
a4JDWmpFQkL10XfAyuF51A: raises $4 to $5.50
nvw9yQKhJT56lA9k+TLdhw: raises $4.25 to $9.75 and is all-in
a4JDWmpFQkL10XfAyuF51A: calls $4.25
*** TURN *** [4s 4c 8s] [Ad]
*** RIVER *** [4s 4c 8s Ad] [Qs]
*** SHOW DOWN ***
nvw9yQKhJT56lA9k+TLdhw: shows [Ts Ks] (a flush, King high)
a4JDWmpFQkL10XfAyuF51A: shows [Qc Qh] (a full house, Queens full of Fours)
a4JDWmpFQkL10XfAyuF51A collected $22.10 from pot
*** SUMMARY ***
Total pot $23.25 | Rake $1.15
Board [4s 4c 8s Ad Qs]
Seat 1: pEW8B6uXbdR47kfljMQ3+Q (small blind) folded before Flop
Seat 2: UrcnkQOiLVk8BlKDPJSy7Q (big blind) folded before Flop
Seat 3: aTkyjTh3w5YLWiIERupZOA folded before Flop (didn't bet)
Seat 4: nvw9yQKhJT56lA9k+TLdhw showed [Ts Ks] and lost with a flush, King high
Seat 5: mSD1pginDsyHG5PDfqzphw folded before Flop (didn't bet)
Seat 6: +k7T5ocke8UwavtgUHm+Cg folded before Flop (didn't bet)
Seat 7: dGw5MBstXyXhWHHVFOWOFA folded before Flop (didn't bet)
Seat 8: a4JDWmpFQkL10XfAyuF51A showed [Qc Qh] and won ($22.10) with a full house, Queens full of Fours
Seat 9: 5JJVDlaiMnB004o/RqbZZQ (button) folded before Flop (didn't bet)



PokerStars Game #59938695670:  Hold'em No Limit ($0.25/$0.50) - 2009/07/01 0:21:13 ET
Table 'PALRfuH85dr5IkDfdv6new' 9-max Seat #8 is the button
Seat 1: SKnJuWHScqetA/qG5p+wCg ($32.25 in chips)
Seat 2: 9r7ZoBbAJj5IeyZ0q9BdzA ($7.15 in chips)
Seat 3: 50QWoELmpmHFrFIlWMJo9g ($88.20 in chips)
Seat 4: UqQTn9qxH/IQXP1PWD7Gwg ($33.45 in chips)
Seat 5: jSSGUXdNFAZA3QCvTcUMQw ($39.45 in chips)
Seat 6: EiWj2MAl8RNcPhTkzz24Mw ($36.95 in chips)
Seat 7: 3NcyXvr39gnK+KbTq7ezyA ($40.35 in chips)
Seat 8: NkS+CseUKx4XHszWq0PXEQ ($44.35 in chips)
Seat 9: CIrAX/m6o7jYmKOAjJXv4Q ($37.45 in chips)
CIrAX/m6o7jYmKOAjJXv4Q: posts small blind $0.25
SKnJuWHScqetA/qG5p+wCg: posts big blind $0.50
*** HOLE CARDS ***
9r7ZoBbAJj5IeyZ0q9BdzA: folds
50QWoELmpmHFrFIlWMJo9g: folds
UqQTn9qxH/IQXP1PWD7Gwg: folds
jSSGUXdNFAZA3QCvTcUMQw: folds
EiWj2MAl8RNcPhTkzz24Mw: folds
3NcyXvr39gnK+KbTq7ezyA: calls $0.50
NkS+CseUKx4XHszWq0PXEQ: calls $0.50
CIrAX/m6o7jYmKOAjJXv4Q: calls $0.25
SKnJuWHScqetA/qG5p+wCg: checks
*** FLOP *** [8s 5s Qh]
CIrAX/m6o7jYmKOAjJXv4Q: bets $1.50
SKnJuWHScqetA/qG5p+wCg: folds
3NcyXvr39gnK+KbTq7ezyA: folds
NkS+CseUKx4XHszWq0PXEQ: calls $1.50
*** TURN *** [8s 5s Qh] [6s]
CIrAX/m6o7jYmKOAjJXv4Q: checks
NkS+CseUKx4XHszWq0PXEQ: bets $4
CIrAX/m6o7jYmKOAjJXv4Q: folds
NkS+CseUKx4XHszWq0PXEQ collected $4.80 from pot
*** SUMMARY ***
Total pot $5 | Rake $0.20
Board [8s 5s Qh 6s]
Seat 1: SKnJuWHScqetA/qG5p+wCg (big blind) folded on the Flop
Seat 2: 9r7ZoBbAJj5IeyZ0q9BdzA folded before Flop (didn't bet)
Seat 3: 50QWoELmpmHFrFIlWMJo9g folded before Flop (didn't bet)
Seat 4: UqQTn9qxH/IQXP1PWD7Gwg folded before Flop (didn't bet)
Seat 5: jSSGUXdNFAZA3QCvTcUMQw folded before Flop (didn't bet)
Seat 6: EiWj2MAl8RNcPhTkzz24Mw folded before Flop (didn't bet)
Seat 7: 3NcyXvr39gnK+KbTq7ezyA folded on the Flop
Seat 8: NkS+CseUKx4XHszWq0PXEQ (button) collected ($4.80)
Seat 9: CIrAX/m6o7jYmKOAjJXv4Q (small blind) folded on the Turn



PokerStars Game #59938695834:  Hold'em No Limit ($0.25/$0.50) - 2009/07/01 0:21:13 ET
Table 'ZYwMb9E6tY50Qm+iNbXRYw' 2-max Seat #1 is the button
Seat 1: DXLfRb8KDZWmrztw2bwtFw ($15.10 in chips)
Seat 2: 16tvT7AYgZ2LgiGFcvFKQg ($17.20 in chips)
DXLfRb8KDZWmrztw2bwtFw: posts small blind $0.25
16tvT7AYgZ2LgiGFcvFKQg: posts big blind $0.50
*** HOLE CARDS ***
DXLfRb8KDZWmrztw2bwtFw: calls $0.25
16tvT7AYgZ2LgiGFcvFKQg: checks
*** FLOP *** [9c 5d 7c]
16tvT7AYgZ2LgiGFcvFKQg: bets $0.50
DXLfRb8KDZWmrztw2bwtFw: folds
16tvT7AYgZ2LgiGFcvFKQg collected $0.95 from pot
16tvT7AYgZ2LgiGFcvFKQg: doesn't show hand
*** SUMMARY ***
Total pot $1 | Rake $0.05
Board [9c 5d 7c]
Seat 1: DXLfRb8KDZWmrztw2bwtFw (button) (small blind) folded on the Flop
Seat 2: 16tvT7AYgZ2LgiGFcvFKQg (big blind) collected ($0.95)



PokerStars Game #59938697520:  Hold'em No Limit ($0.25/$0.50) - 2009/07/01 0:21:15 ET
Table 'c/CRn+68J3Y8KxD5g1ek2Q' 2-max Seat #1 is the button
Seat 1: 46qCyJ6evTkHo9al5sBMNA ($271.40 in chips)
Seat 2: BypVLsYQt3ePFm2xQL/dOA ($110.60 in chips)
46qCyJ6evTkHo9al5sBMNA: posts small blind $0.25
BypVLsYQt3ePFm2xQL/dOA: posts big blind $0.50
*** HOLE CARDS ***
46qCyJ6evTkHo9al5sBMNA: raises $1.50 to $2
BypVLsYQt3ePFm2xQL/dOA: calls $1.50
*** FLOP *** [5c 2c Jc]
BypVLsYQt3ePFm2xQL/dOA: checks
46qCyJ6evTkHo9al5sBMNA: checks
*** TURN *** [5c 2c Jc] [Td]
BypVLsYQt3ePFm2xQL/dOA: checks
46qCyJ6evTkHo9al5sBMNA: bets $3.50
BypVLsYQt3ePFm2xQL/dOA: folds
46qCyJ6evTkHo9al5sBMNA collected $3.80 from pot
46qCyJ6evTkHo9al5sBMNA: doesn't show hand
*** SUMMARY ***
Total pot $4 | Rake $0.20
Board [5c 2c Jc Td]
Seat 1: 46qCyJ6evTkHo9al5sBMNA (button) (small blind) collected ($3.80)
Seat 2: BypVLsYQt3ePFm2xQL/dOA (big blind) folded on the Turn



PokerStars Game #59938697442:  Hold'em No Limit ($0.25/$0.50) - 2009/07/01 0:21:15 ET
Table '5EmHi+fnatGQQShcNmzOZQ' 6-max Seat #4 is the button
Seat 1: SwPczQo3cOtwEzhJrfO2cQ ($26.70 in chips)
Seat 3: L9qfLYXrczhAPd/VckgsWw ($59.75 in chips)
Seat 4: wOyVV9M/oyiw3YaOjNZ05w ($50.75 in chips)
Seat 5: kxPhs4ePFqMy52CInAJ2aw ($48.75 in chips)
Seat 6: 686aeHikcJlgKkSuIFdcXQ ($157.35 in chips)
kxPhs4ePFqMy52CInAJ2aw: posts small blind $0.25
686aeHikcJlgKkSuIFdcXQ: posts big blind $0.50
*** HOLE CARDS ***
SwPczQo3cOtwEzhJrfO2cQ: calls $0.50
L9qfLYXrczhAPd/VckgsWw: folds
wOyVV9M/oyiw3YaOjNZ05w: folds
kxPhs4ePFqMy52CInAJ2aw: folds
686aeHikcJlgKkSuIFdcXQ: checks
*** FLOP *** [8s 5s 2s]
686aeHikcJlgKkSuIFdcXQ: checks
SwPczQo3cOtwEzhJrfO2cQ: bets $0.50
686aeHikcJlgKkSuIFdcXQ: folds
SwPczQo3cOtwEzhJrfO2cQ collected $1.20 from pot
*** SUMMARY ***
Total pot $1.25 | Rake $0.05
Board [8s 5s 2s]
Seat 1: SwPczQo3cOtwEzhJrfO2cQ collected ($1.20)
Seat 3: L9qfLYXrczhAPd/VckgsWw folded before Flop (didn't bet)
Seat 4: wOyVV9M/oyiw3YaOjNZ05w (button) folded before Flop (didn't bet)
Seat 5: kxPhs4ePFqMy52CInAJ2aw (small blind) folded before Flop
Seat 6: 686aeHikcJlgKkSuIFdcXQ (big blind) folded on the Flop



PokerStars Game #59938698936:  Hold'em No Limit ($0.25/$0.50) - 2009/07/01 0:21:17 ET
Table 'raOT4/ipuZgzjfKHC+jD9g' 2-max Seat #2 is the button
Seat 1: IuwLemwLhc9fvrwBGs0AMA ($11.30 in chips)
Seat 2: Udr5juWSWUgTu1NlRhjMdA ($10.95 in chips)
Udr5juWSWUgTu1NlRhjMdA: posts small blind $0.25
IuwLemwLhc9fvrwBGs0AMA: posts big blind $0.50
*** HOLE CARDS ***
Udr5juWSWUgTu1NlRhjMdA: calls $0.25
IuwLemwLhc9fvrwBGs0AMA: checks
*** FLOP *** [Jh 2d 5c]
IuwLemwLhc9fvrwBGs0AMA: checks
Udr5juWSWUgTu1NlRhjMdA: bets $0.50
IuwLemwLhc9fvrwBGs0AMA: folds
Udr5juWSWUgTu1NlRhjMdA collected $0.95 from pot
Udr5juWSWUgTu1NlRhjMdA: doesn't show hand
*** SUMMARY ***
Total pot $1 | Rake $0.05
Board [Jh 2d 5c]
Seat 1: IuwLemwLhc9fvrwBGs0AMA (big blind) folded on the Flop
Seat 2: Udr5juWSWUgTu1NlRhjMdA (button) (small blind) collected ($0.95)



PokerStars Game #59938700800:  Hold'em No Limit ($0.25/$0.50) - 2009/07/01 0:21:20 ET
Table '0AhP5FLi4ySROVJ/ycT1Qw' 2-max Seat #1 is the button
Seat 1: 38ZztDUK6IU5WCK+BN74Rw ($101 in chips)
Seat 2: 46qCyJ6evTkHo9al5sBMNA ($79.25 in chips)
38ZztDUK6IU5WCK+BN74Rw: posts small blind $0.25
46qCyJ6evTkHo9al5sBMNA: posts big blind $0.50
*** HOLE CARDS ***
38ZztDUK6IU5WCK+BN74Rw: folds
46qCyJ6evTkHo9al5sBMNA collected $0.50 from pot
46qCyJ6evTkHo9al5sBMNA: doesn't show hand
*** SUMMARY ***
Total pot $0.50 | Rake $0
Seat 1: 38ZztDUK6IU5WCK+BN74Rw (button) (small blind) folded before Flop
Seat 2: 46qCyJ6evTkHo9al5sBMNA (big blind) collected ($0.50)



PokerStars Game #59938700926:  Hold'em No Limit ($0.25/$0.50) - 2009/07/01 0:21:20 ET
Table 'IeNZOZQ4T6oiaHqFeo6yIA' 2-max Seat #1 is the button
Seat 1: ndd1nfncBkWNitBnsfCoVQ ($82.35 in chips)
Seat 2: A91IUl5JaZROhtfCtnnwYw ($3.55 in chips)
ndd1nfncBkWNitBnsfCoVQ: posts small blind $0.25
A91IUl5JaZROhtfCtnnwYw: posts big blind $0.50
*** HOLE CARDS ***
ndd1nfncBkWNitBnsfCoVQ: raises $1 to $1.50
A91IUl5JaZROhtfCtnnwYw: calls $1
*** FLOP *** [6d 3h Tc]
A91IUl5JaZROhtfCtnnwYw: checks
ndd1nfncBkWNitBnsfCoVQ: checks
*** TURN *** [6d 3h Tc] [Ah]
A91IUl5JaZROhtfCtnnwYw: checks
ndd1nfncBkWNitBnsfCoVQ: checks
*** RIVER *** [6d 3h Tc Ah] [9s]
A91IUl5JaZROhtfCtnnwYw: bets $0.50
ndd1nfncBkWNitBnsfCoVQ: folds
A91IUl5JaZROhtfCtnnwYw collected $2.85 from pot
A91IUl5JaZROhtfCtnnwYw: doesn't show hand
*** SUMMARY ***
Total pot $3 | Rake $0.15
Board [6d 3h Tc Ah 9s]
Seat 1: ndd1nfncBkWNitBnsfCoVQ (button) (small blind) folded on the River
Seat 2: A91IUl5JaZROhtfCtnnwYw (big blind) collected ($2.85)



PokerStars Game #59938700966:  Hold'em No Limit ($0.25/$0.50) - 2009/07/01 0:21:21 ET
Table 'GfL/No5u5PoEnU39lP5pQg' 6-max Seat #5 is the button
Seat 1: 1WUCqNG+p+vfWRTXNu4ljw ($50 in chips)
Seat 2: uVwggSetzp7d+eVgowO3vg ($47.25 in chips)
Seat 3: qNezhXOOUXqwG7b9X5XJAA ($50 in chips)
Seat 4: yqM0AD7MZQd/cEtKdDQY1A ($17.55 in chips)
Seat 5: crjGpJEzSZgD38FoE3VMGg ($52.05 in chips)
Seat 6: 3wylWYGeXFXcrE4XVrlPng ($64.10 in chips)
3wylWYGeXFXcrE4XVrlPng: posts small blind $0.25
1WUCqNG+p+vfWRTXNu4ljw: posts big blind $0.50
*** HOLE CARDS ***
uVwggSetzp7d+eVgowO3vg: folds
qNezhXOOUXqwG7b9X5XJAA: folds
yqM0AD7MZQd/cEtKdDQY1A: folds
crjGpJEzSZgD38FoE3VMGg: folds
3wylWYGeXFXcrE4XVrlPng: raises $0.50 to $1
1WUCqNG+p+vfWRTXNu4ljw: folds
3wylWYGeXFXcrE4XVrlPng collected $1 from pot
3wylWYGeXFXcrE4XVrlPng: doesn't show hand
*** SUMMARY ***
Total pot $1 | Rake $0
Seat 1: 1WUCqNG+p+vfWRTXNu4ljw (big blind) folded before Flop
Seat 2: uVwggSetzp7d+eVgowO3vg folded before Flop (didn't bet)
Seat 3: qNezhXOOUXqwG7b9X5XJAA folded before Flop (didn't bet)
Seat 4: yqM0AD7MZQd/cEtKdDQY1A folded before Flop (didn't bet)
Seat 5: crjGpJEzSZgD38FoE3VMGg (button) folded before Flop (didn't bet)
Seat 6: 3wylWYGeXFXcrE4XVrlPng (small blind) collected ($1)



PokerStars Game #59938702378:  Hold'em No Limit ($0.25/$0.50) - 2009/07/01 0:21:23 ET
Table '3FhG0gl3kMX3wBEEqj+wnQ' 9-max Seat #1 is the button
Seat 1: e0J9pdCNUDTCG031RnXqLA ($19.50 in chips)
Seat 2: 4dl3YNqZ6Houm2jZAzDmRg ($24.75 in chips)
Seat 3: HZkVla4kK2SI42CVrPZ/ig ($10 in chips)
Seat 4: bz4LMfV0GGl/MJ/ABXuPmg ($22.20 in chips)
Seat 5: XNMDwbXt/Q4jM99AXnbJDw ($55.55 in chips)
Seat 6: 5JJVDlaiMnB004o/RqbZZQ ($24.50 in chips)
Seat 7: mSD1pginDsyHG5PDfqzphw ($10 in chips)
Seat 8: j3K/Jujr7PY4ZM2RZvlH6A ($46.40 in chips)
Seat 9: L5e2lrPLQm1Pqx30IIZ/Fw ($10 in chips)
4dl3YNqZ6Houm2jZAzDmRg: posts small blind $0.25
HZkVla4kK2SI42CVrPZ/ig: posts big blind $0.50
*** HOLE CARDS ***
bz4LMfV0GGl/MJ/ABXuPmg: folds
XNMDwbXt/Q4jM99AXnbJDw: folds
5JJVDlaiMnB004o/RqbZZQ: folds
mSD1pginDsyHG5PDfqzphw: folds
j3K/Jujr7PY4ZM2RZvlH6A: folds
L5e2lrPLQm1Pqx30IIZ/Fw: folds
e0J9pdCNUDTCG031RnXqLA: folds
4dl3YNqZ6Houm2jZAzDmRg: raises $1 to $1.50
HZkVla4kK2SI42CVrPZ/ig: folds
4dl3YNqZ6Houm2jZAzDmRg collected $1 from pot
*** SUMMARY ***
Total pot $1 | Rake $0
Seat 1: e0J9pdCNUDTCG031RnXqLA (button) folded before Flop (didn't bet)
Seat 2: 4dl3YNqZ6Houm2jZAzDmRg (small blind) collected ($1)
Seat 3: HZkVla4kK2SI42CVrPZ/ig (big blind) folded before Flop
Seat 4: bz4LMfV0GGl/MJ/ABXuPmg folded before Flop (didn't bet)
Seat 5: XNMDwbXt/Q4jM99AXnbJDw folded before Flop (didn't bet)
Seat 6: 5JJVDlaiMnB004o/RqbZZQ folded before Flop (didn't bet)
Seat 7: mSD1pginDsyHG5PDfqzphw folded before Flop (didn't bet)
Seat 8: j3K/Jujr7PY4ZM2RZvlH6A folded before Flop (didn't bet)
Seat 9: L5e2lrPLQm1Pqx30IIZ/Fw folded before Flop (didn't bet)



PokerStars Game #59938703350:  Hold'em No Limit ($0.25/$0.50) - 2009/07/01 0:21:24 ET
Table 'E7bWJ45aoFXRpyRv2gw+Ig' 2-max Seat #1 is the button
Seat 1: FRkiRasEGlHUeLrEl+k/nA ($63.95 in chips)
Seat 2: 3Wro85I7472vJ4Wkpneo9A ($115.55 in chips)
FRkiRasEGlHUeLrEl+k/nA: posts small blind $0.25
3Wro85I7472vJ4Wkpneo9A: posts big blind $0.50
*** HOLE CARDS ***
FRkiRasEGlHUeLrEl+k/nA: raises $1 to $1.50
3Wro85I7472vJ4Wkpneo9A: raises $3.50 to $5
FRkiRasEGlHUeLrEl+k/nA: calls $3.50
*** FLOP *** [6h 3h 4d]
3Wro85I7472vJ4Wkpneo9A: checks
FRkiRasEGlHUeLrEl+k/nA: checks
*** TURN *** [6h 3h 4d] [3d]
3Wro85I7472vJ4Wkpneo9A: checks
FRkiRasEGlHUeLrEl+k/nA: bets $4.50
3Wro85I7472vJ4Wkpneo9A: folds
FRkiRasEGlHUeLrEl+k/nA collected $9.50 from pot
FRkiRasEGlHUeLrEl+k/nA: doesn't show hand
*** SUMMARY ***
Total pot $10 | Rake $0.50
Board [6h 3h 4d 3d]
Seat 1: FRkiRasEGlHUeLrEl+k/nA (button) (small blind) collected ($9.50)
Seat 2: 3Wro85I7472vJ4Wkpneo9A (big blind) folded on the Turn



PokerStars Game #59938703750:  Hold'em No Limit ($0.25/$0.50) - 2009/07/01 0:21:25 ET
Table 'ZYwMb9E6tY50Qm+iNbXRYw' 2-max Seat #2 is the button
Seat 1: DXLfRb8KDZWmrztw2bwtFw ($14.60 in chips)
Seat 2: 16tvT7AYgZ2LgiGFcvFKQg ($17.65 in chips)
16tvT7AYgZ2LgiGFcvFKQg: posts small blind $0.25
DXLfRb8KDZWmrztw2bwtFw: posts big blind $0.50
*** HOLE CARDS ***
16tvT7AYgZ2LgiGFcvFKQg: calls $0.25
DXLfRb8KDZWmrztw2bwtFw: raises $2 to $2.50
16tvT7AYgZ2LgiGFcvFKQg: folds
DXLfRb8KDZWmrztw2bwtFw collected $1 from pot
DXLfRb8KDZWmrztw2bwtFw: doesn't show hand
*** SUMMARY ***
Total pot $1 | Rake $0
Seat 1: DXLfRb8KDZWmrztw2bwtFw (big blind) collected ($1)
Seat 2: 16tvT7AYgZ2LgiGFcvFKQg (button) (small blind) folded before Flop



PokerStars Game #59938704952:  Hold'em No Limit ($0.25/$0.50) - 2009/07/01 0:21:26 ET
Table '0AhP5FLi4ySROVJ/ycT1Qw' 2-max Seat #2 is the button
Seat 1: 38ZztDUK6IU5WCK+BN74Rw ($100.75 in chips)
Seat 2: 46qCyJ6evTkHo9al5sBMNA ($79.50 in chips)
46qCyJ6evTkHo9al5sBMNA: posts small blind $0.25
38ZztDUK6IU5WCK+BN74Rw: posts big blind $0.50
*** HOLE CARDS ***
46qCyJ6evTkHo9al5sBMNA: raises $1 to $1.50
38ZztDUK6IU5WCK+BN74Rw: folds
46qCyJ6evTkHo9al5sBMNA collected $1 from pot
46qCyJ6evTkHo9al5sBMNA: doesn't show hand
*** SUMMARY ***
Total pot $1 | Rake $0
Seat 1: 38ZztDUK6IU5WCK+BN74Rw (big blind) folded before Flop
Seat 2: 46qCyJ6evTkHo9al5sBMNA (button) (small blind) collected ($1)



PokerStars Game #59938704718:  Hold'em No Limit ($0.25/$0.50) - 2009/07/01 0:21:26 ET
Table 'T/PgNWqVyY6lkldcBVXYJQ' 6-max Seat #2 is the button
Seat 1: +Pf9jTVizYlIo+woPvptfA ($53.75 in chips)
Seat 2: oZAeY5rVqNGgt8yyQ0pxbA ($7.85 in chips)
Seat 3: L3OcNO1bgdqDI46j67KQPQ ($55.55 in chips)
Seat 4: jxMvxeUUL9UU0V6wVU+Iyw ($11.20 in chips)
Seat 5: vVQBckETtigfb5mAcyK0OA ($62.65 in chips)
Seat 6: cDzbog6kwmJp+LBeBq+iMQ ($26.25 in chips)
L3OcNO1bgdqDI46j67KQPQ: posts small blind $0.25
jxMvxeUUL9UU0V6wVU+Iyw: posts big blind $0.50
*** HOLE CARDS ***
vVQBckETtigfb5mAcyK0OA: folds
cDzbog6kwmJp+LBeBq+iMQ: folds
jxMvxeUUL9UU0V6wVU+Iyw said, "Play it your way.  I got a ticket with your name on it."
+Pf9jTVizYlIo+woPvptfA: folds
oZAeY5rVqNGgt8yyQ0pxbA: calls $0.50
vVQBckETtigfb5mAcyK0OA said, "LOL"
L3OcNO1bgdqDI46j67KQPQ: folds
jxMvxeUUL9UU0V6wVU+Iyw: checks
*** FLOP *** [Qs 7h 2s]
jxMvxeUUL9UU0V6wVU+Iyw: checks
oZAeY5rVqNGgt8yyQ0pxbA: checks
*** TURN *** [Qs 7h 2s] [8c]
jxMvxeUUL9UU0V6wVU+Iyw said, "figured you'd wimp out"
cDzbog6kwmJp+LBeBq+iMQ said, "helen i gotta say... you are a bit obnoxious"
jxMvxeUUL9UU0V6wVU+Iyw: checks
oZAeY5rVqNGgt8yyQ0pxbA: checks
*** RIVER *** [Qs 7h 2s 8c] [4h]
jxMvxeUUL9UU0V6wVU+Iyw: checks
oZAeY5rVqNGgt8yyQ0pxbA: bets $0.50
vVQBckETtigfb5mAcyK0OA said, "SORRY ?"
jxMvxeUUL9UU0V6wVU+Iyw: calls $0.50
*** SHOW DOWN ***
oZAeY5rVqNGgt8yyQ0pxbA: shows [6h 8h] (a pair of Eights)
jxMvxeUUL9UU0V6wVU+Iyw: mucks hand
oZAeY5rVqNGgt8yyQ0pxbA collected $2.15 from pot
*** SUMMARY ***
Total pot $2.25 | Rake $0.10
Board [Qs 7h 2s 8c 4h]
Seat 1: +Pf9jTVizYlIo+woPvptfA folded before Flop (didn't bet)
Seat 2: oZAeY5rVqNGgt8yyQ0pxbA (button) showed [6h 8h] and won ($2.15) with a pair of Eights
Seat 3: L3OcNO1bgdqDI46j67KQPQ (small blind) folded before Flop
Seat 4: jxMvxeUUL9UU0V6wVU+Iyw (big blind) mucked
Seat 5: vVQBckETtigfb5mAcyK0OA folded before Flop (didn't bet)
Seat 6: cDzbog6kwmJp+LBeBq+iMQ folded before Flop (didn't bet)



PokerStars Game #59938704954:  Hold'em No Limit ($0.25/$0.50) - 2009/07/01 0:21:26 ET
Table 'NCiXr0d5CEKBQr/cZgLhbA' 9-max Seat #7 is the button
Seat 1: RjBdQ6w31rgcy0o24VLR6w ($10 in chips)
Seat 2: ulxuJchBV9iguXg0FUonfg ($40.05 in chips)
Seat 3: xZCXQSXlrZkp3pZizzVXCw ($55.65 in chips)
Seat 4: CL4d+tvzcd4utdQxlPLOmg ($31.05 in chips)
Seat 5: zE9cVigS2nW/Ljy4K4bUQA ($30.75 in chips)
Seat 6: SKnJuWHScqetA/qG5p+wCg ($30 in chips)
Seat 7: M+7+BTmX5vZatHVuoRB1nA ($49.25 in chips)
Seat 8: 1MJUKc3cc0QmUoz1JZLR2w ($64.35 in chips)
1MJUKc3cc0QmUoz1JZLR2w: posts small blind $0.25
WpvT3OUSiZlpvs+mPXFqtQ: is sitting out
RjBdQ6w31rgcy0o24VLR6w: posts big blind $0.50
*** HOLE CARDS ***
1MJUKc3cc0QmUoz1JZLR2w said, "sorry?"
SKnJuWHScqetA/qG5p+wCg said, "too strange raise"
WpvT3OUSiZlpvs+mPXFqtQ leaves the table
ulxuJchBV9iguXg0FUonfg: folds
SKnJuWHScqetA/qG5p+wCg said, "easy fold"
1MJUKc3cc0QmUoz1JZLR2w said, "over bet"
1MJUKc3cc0QmUoz1JZLR2w said, "maybe you have hand"
4WLZvqBn5qv5tds5kt5A1Q joins the table at seat #9
xZCXQSXlrZkp3pZizzVXCw: folds
CL4d+tvzcd4utdQxlPLOmg: folds
zE9cVigS2nW/Ljy4K4bUQA: raises $1 to $1.50
SKnJuWHScqetA/qG5p+wCg: folds
M+7+BTmX5vZatHVuoRB1nA: folds
1MJUKc3cc0QmUoz1JZLR2w: calls $1.25
RjBdQ6w31rgcy0o24VLR6w: folds
*** FLOP *** [4s 4d Tc]
1MJUKc3cc0QmUoz1JZLR2w: checks
zE9cVigS2nW/Ljy4K4bUQA: bets $2.50
1MJUKc3cc0QmUoz1JZLR2w: calls $2.50
*** TURN *** [4s 4d Tc] [Ts]
1MJUKc3cc0QmUoz1JZLR2w: checks
zE9cVigS2nW/Ljy4K4bUQA: checks
*** RIVER *** [4s 4d Tc Ts] [5s]
1MJUKc3cc0QmUoz1JZLR2w: bets $6
zE9cVigS2nW/Ljy4K4bUQA: calls $6
*** SHOW DOWN ***
1MJUKc3cc0QmUoz1JZLR2w: shows [9c 9h] (two pair, Tens and Nines)
zE9cVigS2nW/Ljy4K4bUQA: shows [Ks Kd] (two pair, Kings and Tens)
1MJUKc3cc0QmUoz1JZLR2w said, "nh"
zE9cVigS2nW/Ljy4K4bUQA collected $19.50 from pot
*** SUMMARY ***
Total pot $20.50 | Rake $1
Board [4s 4d Tc Ts 5s]
Seat 1: RjBdQ6w31rgcy0o24VLR6w (big blind) folded before Flop
Seat 2: ulxuJchBV9iguXg0FUonfg folded before Flop (didn't bet)
Seat 3: xZCXQSXlrZkp3pZizzVXCw folded before Flop (didn't bet)
Seat 4: CL4d+tvzcd4utdQxlPLOmg folded before Flop (didn't bet)
Seat 5: zE9cVigS2nW/Ljy4K4bUQA showed [Ks Kd] and won ($19.50) with two pair, Kings and Tens
Seat 6: SKnJuWHScqetA/qG5p+wCg folded before Flop (didn't bet)
Seat 7: M+7+BTmX5vZatHVuoRB1nA (button) folded before Flop (didn't bet)
Seat 8: 1MJUKc3cc0QmUoz1JZLR2w (small blind) showed [9c 9h] and lost with two pair, Tens and Nines



PokerStars Game #59938706128:  Hold'em No Limit ($0.25/$0.50) - 2009/07/01 0:21:28 ET
Table '37qXEp3oe+er5q4CZip9eQ' 6-max Seat #3 is the button
Seat 1: oqOqoO2AyCZenUghCxMDxw ($50 in chips)
Seat 3: Rt6KgtZ8YaJoTc3FPim00w ($97.40 in chips)
Seat 4: AYb7QG0KzyicbOC0ZROE3Q ($16.90 in chips)
Seat 5: VOmI0x4dDPnTESZd5B4d1Q ($40.55 in chips)
Seat 6: f7zPpUQp9hHZgqhEvrUWQw ($50.65 in chips)
AYb7QG0KzyicbOC0ZROE3Q: posts small blind $0.25
VOmI0x4dDPnTESZd5B4d1Q: posts big blind $0.50
*** HOLE CARDS ***
f7zPpUQp9hHZgqhEvrUWQw: folds
oqOqoO2AyCZenUghCxMDxw: folds
Rt6KgtZ8YaJoTc3FPim00w: raises $1 to $1.50
AYb7QG0KzyicbOC0ZROE3Q: calls $1.25
VOmI0x4dDPnTESZd5B4d1Q: calls $1
*** FLOP *** [Kc Jd Kd]
AYb7QG0KzyicbOC0ZROE3Q: checks
VOmI0x4dDPnTESZd5B4d1Q: checks
Rt6KgtZ8YaJoTc3FPim00w: bets $3
AYb7QG0KzyicbOC0ZROE3Q: folds
VOmI0x4dDPnTESZd5B4d1Q: calls $3
*** TURN *** [Kc Jd Kd] [Ah]
VOmI0x4dDPnTESZd5B4d1Q: checks
Rt6KgtZ8YaJoTc3FPim00w: checks
*** RIVER *** [Kc Jd Kd Ah] [Jh]
g12O9qXTybyo2C0B2bXgjg leaves the table
VOmI0x4dDPnTESZd5B4d1Q: bets $4
Rt6KgtZ8YaJoTc3FPim00w: folds
VOmI0x4dDPnTESZd5B4d1Q collected $10 from pot
*** SUMMARY ***
Total pot $10.50 | Rake $0.50
Board [Kc Jd Kd Ah Jh]
Seat 1: oqOqoO2AyCZenUghCxMDxw folded before Flop (didn't bet)
Seat 3: Rt6KgtZ8YaJoTc3FPim00w (button) folded on the River
Seat 4: AYb7QG0KzyicbOC0ZROE3Q (small blind) folded on the Flop
Seat 5: VOmI0x4dDPnTESZd5B4d1Q (big blind) collected ($10)
Seat 6: f7zPpUQp9hHZgqhEvrUWQw folded before Flop (didn't bet)



PokerStars Game #59938707380:  Hold'em No Limit ($0.25/$0.50) - 2009/07/01 0:21:30 ET
Table 'mTxf8gPLgffN3Iwfm7Icfg' 2-max Seat #2 is the button
Seat 1: Do9Rlu1R5u/AcRtMTl8SYg ($77.05 in chips)
Seat 2: EMc5LPgVaded4Qc77vm0fw ($84.25 in chips)
EMc5LPgVaded4Qc77vm0fw: posts small blind $0.25
Do9Rlu1R5u/AcRtMTl8SYg: posts big blind $0.50
*** HOLE CARDS ***
EMc5LPgVaded4Qc77vm0fw: folds
Do9Rlu1R5u/AcRtMTl8SYg collected $0.50 from pot
Do9Rlu1R5u/AcRtMTl8SYg: doesn't show hand
*** SUMMARY ***
Total pot $0.50 | Rake $0
Seat 1: Do9Rlu1R5u/AcRtMTl8SYg (big blind) collected ($0.50)
Seat 2: EMc5LPgVaded4Qc77vm0fw (button) (small blind) folded before Flop



PokerStars Game #59938708358:  Hold'em No Limit ($0.25/$0.50) - 2009/07/01 0:21:31 ET
Table '+dXkOAQyS8j9PQZusUTMpg' 2-max Seat #2 is the button
Seat 1: XFa6sBGjP2gxoIvxR3fZIg ($59.25 in chips)
Seat 2: 5IBeOgaApY1Bvzv2P8X4EA ($48.95 in chips)
5IBeOgaApY1Bvzv2P8X4EA: posts small blind $0.25
XFa6sBGjP2gxoIvxR3fZIg: posts big blind $0.50
*** HOLE CARDS ***
5IBeOgaApY1Bvzv2P8X4EA: folds
XFa6sBGjP2gxoIvxR3fZIg collected $0.50 from pot
XFa6sBGjP2gxoIvxR3fZIg: doesn't show hand
*** SUMMARY ***
Total pot $0.50 | Rake $0
Seat 1: XFa6sBGjP2gxoIvxR3fZIg (big blind) collected ($0.50)
Seat 2: 5IBeOgaApY1Bvzv2P8X4EA (button) (small blind) folded before Flop



PokerStars Game #59938709646:  Hold'em No Limit ($0.25/$0.50) - 2009/07/01 0:21:33 ET
Table 'GfL/No5u5PoEnU39lP5pQg' 6-max Seat #6 is the button
Seat 1: 1WUCqNG+p+vfWRTXNu4ljw ($50 in chips)
Seat 2: uVwggSetzp7d+eVgowO3vg ($47.25 in chips)
Seat 3: qNezhXOOUXqwG7b9X5XJAA ($50 in chips)
Seat 4: yqM0AD7MZQd/cEtKdDQY1A ($17.55 in chips)
Seat 5: crjGpJEzSZgD38FoE3VMGg ($52.05 in chips)
Seat 6: 3wylWYGeXFXcrE4XVrlPng ($64.60 in chips)
1WUCqNG+p+vfWRTXNu4ljw: posts small blind $0.25
uVwggSetzp7d+eVgowO3vg: posts big blind $0.50
*** HOLE CARDS ***
qNezhXOOUXqwG7b9X5XJAA: folds
yqM0AD7MZQd/cEtKdDQY1A: folds
crjGpJEzSZgD38FoE3VMGg: folds
3wylWYGeXFXcrE4XVrlPng: folds
1WUCqNG+p+vfWRTXNu4ljw: folds
uVwggSetzp7d+eVgowO3vg collected $0.50 from pot
*** SUMMARY ***
Total pot $0.50 | Rake $0
Seat 1: 1WUCqNG+p+vfWRTXNu4ljw (small blind) folded before Flop
Seat 2: uVwggSetzp7d+eVgowO3vg (big blind) collected ($0.50)
Seat 3: qNezhXOOUXqwG7b9X5XJAA folded before Flop (didn't bet)
Seat 4: yqM0AD7MZQd/cEtKdDQY1A folded before Flop (didn't bet)
Seat 5: crjGpJEzSZgD38FoE3VMGg folded before Flop (didn't bet)
Seat 6: 3wylWYGeXFXcrE4XVrlPng (button) folded before Flop (didn't bet)



PokerStars Game #59938710484:  Hold'em No Limit ($0.25/$0.50) - 2009/07/01 0:21:34 ET
Table 'MJxeZCzYELxiIsyUZyT0jw' 6-max Seat #4 is the button
Seat 1: iKPos8JI094Tomq4tDSgnQ ($30.50 in chips)
Seat 2: r6H1GiZ6QIpMTDhyodKuRQ ($63.90 in chips)
Seat 3: JQZew0FjzS19kTjeNtrE+A ($53.45 in chips)
Seat 4: lP7Q6pewz4C2RsAfKsjdWw ($32 in chips)
Seat 5: 3jvoOXNtXE90w2BdfNZwZQ ($50 in chips)
Seat 6: TTx3CHxyi0SObcHyMJRp5w ($50.50 in chips)
3jvoOXNtXE90w2BdfNZwZQ: posts small blind $0.25
TTx3CHxyi0SObcHyMJRp5w: posts big blind $0.50
*** HOLE CARDS ***
iKPos8JI094Tomq4tDSgnQ: folds
iKPos8JI094Tomq4tDSgnQ leaves the table
r6H1GiZ6QIpMTDhyodKuRQ: folds
JQZew0FjzS19kTjeNtrE+A: folds
lP7Q6pewz4C2RsAfKsjdWw: calls $0.50
3jvoOXNtXE90w2BdfNZwZQ: calls $0.25
TTx3CHxyi0SObcHyMJRp5w: checks
*** FLOP *** [4s 3c 9s]
3jvoOXNtXE90w2BdfNZwZQ: checks
TTx3CHxyi0SObcHyMJRp5w: checks
lP7Q6pewz4C2RsAfKsjdWw: bets $1.50
3jvoOXNtXE90w2BdfNZwZQ: folds
TTx3CHxyi0SObcHyMJRp5w: folds
lP7Q6pewz4C2RsAfKsjdWw collected $1.45 from pot
lP7Q6pewz4C2RsAfKsjdWw: doesn't show hand
*** SUMMARY ***
Total pot $1.50 | Rake $0.05
Board [4s 3c 9s]
Seat 1: iKPos8JI094Tomq4tDSgnQ folded before Flop (didn't bet)
Seat 2: r6H1GiZ6QIpMTDhyodKuRQ folded before Flop (didn't bet)
Seat 3: JQZew0FjzS19kTjeNtrE+A folded before Flop (didn't bet)
Seat 4: lP7Q6pewz4C2RsAfKsjdWw (button) collected ($1.45)
Seat 5: 3jvoOXNtXE90w2BdfNZwZQ (small blind) folded on the Flop
Seat 6: TTx3CHxyi0SObcHyMJRp5w (big blind) folded on the Flop



PokerStars Game #59938710060:  Hold'em No Limit ($0.25/$0.50) - 2009/07/01 0:21:34 ET
Table '0AhP5FLi4ySROVJ/ycT1Qw' 2-max Seat #1 is the button
Seat 1: 38ZztDUK6IU5WCK+BN74Rw ($100.25 in chips)
Seat 2: 46qCyJ6evTkHo9al5sBMNA ($80 in chips)
38ZztDUK6IU5WCK+BN74Rw: posts small blind $0.25
46qCyJ6evTkHo9al5sBMNA: posts big blind $0.50
*** HOLE CARDS ***
38ZztDUK6IU5WCK+BN74Rw: raises $1 to $1.50
46qCyJ6evTkHo9al5sBMNA: calls $1
*** FLOP *** [6c Ks Jd]
46qCyJ6evTkHo9al5sBMNA: checks
38ZztDUK6IU5WCK+BN74Rw: checks
*** TURN *** [6c Ks Jd] [2d]
46qCyJ6evTkHo9al5sBMNA: bets $2
38ZztDUK6IU5WCK+BN74Rw: calls $2
*** RIVER *** [6c Ks Jd 2d] [9c]
46qCyJ6evTkHo9al5sBMNA: bets $4
38ZztDUK6IU5WCK+BN74Rw: calls $4
*** SHOW DOWN ***
46qCyJ6evTkHo9al5sBMNA: shows [Ac Jh] (a pair of Jacks)
38ZztDUK6IU5WCK+BN74Rw: mucks hand
46qCyJ6evTkHo9al5sBMNA collected $14.50 from pot
*** SUMMARY ***
Total pot $15 | Rake $0.50
Board [6c Ks Jd 2d 9c]
Seat 1: 38ZztDUK6IU5WCK+BN74Rw (button) (small blind) mucked
Seat 2: 46qCyJ6evTkHo9al5sBMNA (big blind) showed [Ac Jh] and won ($14.50) with a pair of Jacks



PokerStars Game #59938710300:  Hold'em No Limit ($0.25/$0.50) - 2009/07/01 0:21:34 ET
Table 'ZYwMb9E6tY50Qm+iNbXRYw' 2-max Seat #1 is the button
Seat 1: DXLfRb8KDZWmrztw2bwtFw ($15.10 in chips)
Seat 2: 16tvT7AYgZ2LgiGFcvFKQg ($17.15 in chips)
DXLfRb8KDZWmrztw2bwtFw: posts small blind $0.25
16tvT7AYgZ2LgiGFcvFKQg: posts big blind $0.50
*** HOLE CARDS ***
DXLfRb8KDZWmrztw2bwtFw: raises $1 to $1.50
16tvT7AYgZ2LgiGFcvFKQg: calls $1
*** FLOP *** [As 5h 3d]
16tvT7AYgZ2LgiGFcvFKQg: checks
DXLfRb8KDZWmrztw2bwtFw: checks
*** TURN *** [As 5h 3d] [6h]
16tvT7AYgZ2LgiGFcvFKQg: checks
DXLfRb8KDZWmrztw2bwtFw: checks
*** RIVER *** [As 5h 3d 6h] [Kd]
16tvT7AYgZ2LgiGFcvFKQg: checks
DXLfRb8KDZWmrztw2bwtFw: checks
*** SHOW DOWN ***
16tvT7AYgZ2LgiGFcvFKQg: shows [7h 5c] (a pair of Fives)
DXLfRb8KDZWmrztw2bwtFw: mucks hand
16tvT7AYgZ2LgiGFcvFKQg collected $2.85 from pot
*** SUMMARY ***
Total pot $3 | Rake $0.15
Board [As 5h 3d 6h Kd]
Seat 1: DXLfRb8KDZWmrztw2bwtFw (button) (small blind) mucked
Seat 2: 16tvT7AYgZ2LgiGFcvFKQg (big blind) showed [7h 5c] and won ($2.85) with a pair of Fives



PokerStars Game #59938711068:  Hold'em No Limit ($0.25/$0.50) - 2009/07/01 0:21:35 ET
Table 'raOT4/ipuZgzjfKHC+jD9g' 2-max Seat #1 is the button
Seat 1: IuwLemwLhc9fvrwBGs0AMA ($10.80 in chips)
Seat 2: Udr5juWSWUgTu1NlRhjMdA ($11.40 in chips)
IuwLemwLhc9fvrwBGs0AMA: posts small blind $0.25
Udr5juWSWUgTu1NlRhjMdA: posts big blind $0.50
*** HOLE CARDS ***
IuwLemwLhc9fvrwBGs0AMA: folds
Udr5juWSWUgTu1NlRhjMdA collected $0.50 from pot
Udr5juWSWUgTu1NlRhjMdA: doesn't show hand
*** SUMMARY ***
Total pot $0.50 | Rake $0
Seat 1: IuwLemwLhc9fvrwBGs0AMA (button) (small blind) folded before Flop
Seat 2: Udr5juWSWUgTu1NlRhjMdA (big blind) collected ($0.50)



PokerStars Game #59938711704:  Hold'em No Limit ($0.25/$0.50) - 2009/07/01 0:21:36 ET
Table 'mTxf8gPLgffN3Iwfm7Icfg' 2-max Seat #1 is the button
Seat 1: Do9Rlu1R5u/AcRtMTl8SYg ($77.30 in chips)
Seat 2: EMc5LPgVaded4Qc77vm0fw ($84 in chips)
Do9Rlu1R5u/AcRtMTl8SYg: posts small blind $0.25
EMc5LPgVaded4Qc77vm0fw: posts big blind $0.50
*** HOLE CARDS ***
Do9Rlu1R5u/AcRtMTl8SYg: folds
EMc5LPgVaded4Qc77vm0fw collected $0.50 from pot
EMc5LPgVaded4Qc77vm0fw: doesn't show hand
*** SUMMARY ***
Total pot $0.50 | Rake $0
Seat 1: Do9Rlu1R5u/AcRtMTl8SYg (button) (small blind) folded before Flop
Seat 2: EMc5LPgVaded4Qc77vm0fw (big blind) collected ($0.50)



PokerStars Game #59938712724:  Hold'em No Limit ($0.25/$0.50) - 2009/07/01 0:21:38 ET
Table '+dXkOAQyS8j9PQZusUTMpg' 2-max Seat #1 is the button
Seat 1: XFa6sBGjP2gxoIvxR3fZIg ($59.50 in chips)
Seat 2: 5IBeOgaApY1Bvzv2P8X4EA ($48.70 in chips)
XFa6sBGjP2gxoIvxR3fZIg: posts small blind $0.25
5IBeOgaApY1Bvzv2P8X4EA: posts big blind $0.50
*** HOLE CARDS ***
XFa6sBGjP2gxoIvxR3fZIg: raises $1 to $1.50
5IBeOgaApY1Bvzv2P8X4EA: calls $1
*** FLOP *** [9d 8d 6d]
5IBeOgaApY1Bvzv2P8X4EA: checks
XFa6sBGjP2gxoIvxR3fZIg: bets $3
5IBeOgaApY1Bvzv2P8X4EA: calls $3
*** TURN *** [9d 8d 6d] [5d]
5IBeOgaApY1Bvzv2P8X4EA: checks
XFa6sBGjP2gxoIvxR3fZIg: checks
*** RIVER *** [9d 8d 6d 5d] [Kd]
5IBeOgaApY1Bvzv2P8X4EA: bets $5.50
XFa6sBGjP2gxoIvxR3fZIg: folds
5IBeOgaApY1Bvzv2P8X4EA collected $8.60 from pot
5IBeOgaApY1Bvzv2P8X4EA: doesn't show hand
*** SUMMARY ***
Total pot $9 | Rake $0.40
Board [9d 8d 6d 5d Kd]
Seat 1: XFa6sBGjP2gxoIvxR3fZIg (button) (small blind) folded on the River
Seat 2: 5IBeOgaApY1Bvzv2P8X4EA (big blind) collected ($8.60)



PokerStars Game #59938713440:  Hold'em No Limit ($0.25/$0.50) - 2009/07/01 0:21:39 ET
Table 'ibNfFy0bCzuBaUORla0aGw' 9-max Seat #2 is the button
Seat 2: 90Wb75h3W1BRpbqVnuk8gw ($54.55 in chips)
Seat 3: dDaHs3X8+fe3bIkRU0cbrw ($41.15 in chips)
Seat 4: YBN054X4blmis+B2bBlC0g ($18.05 in chips)
Seat 5: FRv75HO8CUsRZ1byEz06mQ ($9.10 in chips)
Seat 6: BmYrv3ec2k5d6pQq6iNaZw ($67.85 in chips)
Seat 8: xUrN9TWLq4m5V+OXY7KUUA ($50 in chips)
Seat 9: WpvT3OUSiZlpvs+mPXFqtQ ($10.25 in chips)
dDaHs3X8+fe3bIkRU0cbrw: posts small blind $0.25
YBN054X4blmis+B2bBlC0g: posts big blind $0.50
*** HOLE CARDS ***
9r7ZoBbAJj5IeyZ0q9BdzA leaves the table
FRv75HO8CUsRZ1byEz06mQ: folds
BmYrv3ec2k5d6pQq6iNaZw: folds
dDaHs3X8+fe3bIkRU0cbrw said, "nice river"
HZkVla4kK2SI42CVrPZ/ig joins the table at seat #7
xUrN9TWLq4m5V+OXY7KUUA: raises $1 to $1.50
WpvT3OUSiZlpvs+mPXFqtQ: folds
90Wb75h3W1BRpbqVnuk8gw: raises $4.50 to $6
dDaHs3X8+fe3bIkRU0cbrw: folds
YBN054X4blmis+B2bBlC0g: folds
xUrN9TWLq4m5V+OXY7KUUA: folds
90Wb75h3W1BRpbqVnuk8gw collected $3.75 from pot
*** SUMMARY ***
Total pot $3.75 | Rake $0
Seat 2: 90Wb75h3W1BRpbqVnuk8gw (button) collected ($3.75)
Seat 3: dDaHs3X8+fe3bIkRU0cbrw (small blind) folded before Flop
Seat 4: YBN054X4blmis+B2bBlC0g (big blind) folded before Flop
Seat 5: FRv75HO8CUsRZ1byEz06mQ folded before Flop (didn't bet)
Seat 6: BmYrv3ec2k5d6pQq6iNaZw folded before Flop (didn't bet)
Seat 8: xUrN9TWLq4m5V+OXY7KUUA folded before Flop
Seat 9: WpvT3OUSiZlpvs+mPXFqtQ folded before Flop (didn't bet)



PokerStars Game #59938713870:  Hold'em No Limit ($0.25/$0.50) - 2009/07/01 0:21:39 ET
Table 'kgbJRsxfv64KrErDRBAkcw' 6-max Seat #2 is the button
Seat 2: Q+thC23WCv1kJUJtH/+4Jw ($67.15 in chips)
Seat 3: T0Gx/FcQ5VH9u7XaOMX97A ($59.75 in chips)
Seat 4: qanMEqjABjWxC/JgQ/0l7w ($56.70 in chips)
Seat 5: +Pf9jTVizYlIo+woPvptfA ($50 in chips)
T0Gx/FcQ5VH9u7XaOMX97A: posts small blind $0.25
qanMEqjABjWxC/JgQ/0l7w: posts big blind $0.50
*** HOLE CARDS ***
+Pf9jTVizYlIo+woPvptfA: folds
Q+thC23WCv1kJUJtH/+4Jw: folds
T0Gx/FcQ5VH9u7XaOMX97A: raises $1 to $1.50
DDfYzIrYT0t5R/hAJngtsg leaves the table
qanMEqjABjWxC/JgQ/0l7w: folds
T0Gx/FcQ5VH9u7XaOMX97A collected $1 from pot
T0Gx/FcQ5VH9u7XaOMX97A: doesn't show hand
*** SUMMARY ***
Total pot $1 | Rake $0
Seat 2: Q+thC23WCv1kJUJtH/+4Jw (button) folded before Flop (didn't bet)
Seat 3: T0Gx/FcQ5VH9u7XaOMX97A (small blind) collected ($1)
Seat 4: qanMEqjABjWxC/JgQ/0l7w (big blind) folded before Flop
Seat 5: +Pf9jTVizYlIo+woPvptfA folded before Flop (didn't bet)



PokerStars Game #59938714524:  Hold'em No Limit ($0.25/$0.50) - 2009/07/01 0:21:40 ET
Table 'Nz0Vr7WMHL2g5Uk7dDZjpw' 9-max Seat #8 is the button
Seat 2: XNMDwbXt/Q4jM99AXnbJDw ($50 in chips)
Seat 3: 4QTiNH5fteLgJjx/s6Hy6A ($21.50 in chips)
Seat 4: 5JJVDlaiMnB004o/RqbZZQ ($27.50 in chips)
Seat 5: WGW0DgjBUXs1ylURHG8vnQ ($11.10 in chips)
Seat 6: k1f0lS7tlMHCLGs0JT34Tg ($9.25 in chips)
Seat 7: KPLH0gELgFe2OuAnhJFI5w ($19.70 in chips)
Seat 8: HkZI6g4zl83TDTA7SRspmQ ($20.95 in chips)
Seat 9: Ak2W6V2TDVIQrvSAy4eD7Q ($23.65 in chips)
Ak2W6V2TDVIQrvSAy4eD7Q: posts small blind $0.25
XNMDwbXt/Q4jM99AXnbJDw: posts big blind $0.50
*** HOLE CARDS ***
4QTiNH5fteLgJjx/s6Hy6A: calls $0.50
5JJVDlaiMnB004o/RqbZZQ: folds
WGW0DgjBUXs1ylURHG8vnQ: folds
k1f0lS7tlMHCLGs0JT34Tg: folds
KPLH0gELgFe2OuAnhJFI5w: folds
HkZI6g4zl83TDTA7SRspmQ: folds
Ak2W6V2TDVIQrvSAy4eD7Q: calls $0.25
XNMDwbXt/Q4jM99AXnbJDw: checks
*** FLOP *** [Tc Jc 6c]
Ak2W6V2TDVIQrvSAy4eD7Q: bets $1
XNMDwbXt/Q4jM99AXnbJDw: folds
4QTiNH5fteLgJjx/s6Hy6A: folds
Ak2W6V2TDVIQrvSAy4eD7Q collected $1.45 from pot
Ak2W6V2TDVIQrvSAy4eD7Q: doesn't show hand
*** SUMMARY ***
Total pot $1.50 | Rake $0.05
Board [Tc Jc 6c]
Seat 2: XNMDwbXt/Q4jM99AXnbJDw (big blind) folded on the Flop
Seat 3: 4QTiNH5fteLgJjx/s6Hy6A folded on the Flop
Seat 4: 5JJVDlaiMnB004o/RqbZZQ folded before Flop (didn't bet)
Seat 5: WGW0DgjBUXs1ylURHG8vnQ folded before Flop (didn't bet)
Seat 6: k1f0lS7tlMHCLGs0JT34Tg folded before Flop (didn't bet)
Seat 7: KPLH0gELgFe2OuAnhJFI5w folded before Flop (didn't bet)
Seat 8: HkZI6g4zl83TDTA7SRspmQ (button) folded before Flop (didn't bet)
Seat 9: Ak2W6V2TDVIQrvSAy4eD7Q (small blind) collected ($1.45)



PokerStars Game #59938715644:  Hold'em No Limit ($0.25/$0.50) - 2009/07/01 0:21:42 ET
Table 'mTxf8gPLgffN3Iwfm7Icfg' 2-max Seat #2 is the button
Seat 1: Do9Rlu1R5u/AcRtMTl8SYg ($77.05 in chips)
Seat 2: EMc5LPgVaded4Qc77vm0fw ($84.25 in chips)
EMc5LPgVaded4Qc77vm0fw: posts small blind $0.25
Do9Rlu1R5u/AcRtMTl8SYg: posts big blind $0.50
*** HOLE CARDS ***
EMc5LPgVaded4Qc77vm0fw: folds
Do9Rlu1R5u/AcRtMTl8SYg collected $0.50 from pot
Do9Rlu1R5u/AcRtMTl8SYg: doesn't show hand
*** SUMMARY ***
Total pot $0.50 | Rake $0
Seat 1: Do9Rlu1R5u/AcRtMTl8SYg (big blind) collected ($0.50)
Seat 2: EMc5LPgVaded4Qc77vm0fw (button) (small blind) folded before Flop



PokerStars Game #59938715428:  Hold'em No Limit ($0.25/$0.50) - 2009/07/01 0:21:42 ET
Table 'raOT4/ipuZgzjfKHC+jD9g' 2-max Seat #2 is the button
Seat 1: IuwLemwLhc9fvrwBGs0AMA ($10.55 in chips)
Seat 2: Udr5juWSWUgTu1NlRhjMdA ($11.65 in chips)
Udr5juWSWUgTu1NlRhjMdA: posts small blind $0.25
IuwLemwLhc9fvrwBGs0AMA: posts big blind $0.50
*** HOLE CARDS ***
Udr5juWSWUgTu1NlRhjMdA: raises $0.50 to $1
IuwLemwLhc9fvrwBGs0AMA: folds
Udr5juWSWUgTu1NlRhjMdA collected $1 from pot
Udr5juWSWUgTu1NlRhjMdA: doesn't show hand
*** SUMMARY ***
Total pot $1 | Rake $0
Seat 1: IuwLemwLhc9fvrwBGs0AMA (big blind) folded before Flop
Seat 2: Udr5juWSWUgTu1NlRhjMdA (button) (small blind) collected ($1)



PokerStars Game #59938716094:  Hold'em No Limit ($0.25/$0.50) - 2009/07/01 0:21:43 ET
Table 'tyR5AZNKV8Aadbrnrnlg7g' 6-max Seat #2 is the button
Seat 1: R+KjpH/wSjDLhtIy9+edNA ($54.70 in chips)
Seat 2: 58zdeSBSuSFX/qZfhc7YmA ($33.10 in chips)
Seat 3: jUhx+m+V7qfbLZTjgwZByg ($25.15 in chips)
Seat 4: Rt6KgtZ8YaJoTc3FPim00w ($85 in chips)
Seat 6: DMQLAmut/l19xN5STQndFg ($8.30 in chips)
jUhx+m+V7qfbLZTjgwZByg: posts small blind $0.25
Rt6KgtZ8YaJoTc3FPim00w: posts big blind $0.50
wOyVV9M/oyiw3YaOjNZ05w: sits out
*** HOLE CARDS ***
DMQLAmut/l19xN5STQndFg: calls $0.50
R+KjpH/wSjDLhtIy9+edNA: folds
58zdeSBSuSFX/qZfhc7YmA has timed out
58zdeSBSuSFX/qZfhc7YmA: folds
58zdeSBSuSFX/qZfhc7YmA is sitting out
jUhx+m+V7qfbLZTjgwZByg: calls $0.25
Rt6KgtZ8YaJoTc3FPim00w: checks
*** FLOP *** [4h Qc 9h]
58zdeSBSuSFX/qZfhc7YmA has returned
jUhx+m+V7qfbLZTjgwZByg: bets $1
Rt6KgtZ8YaJoTc3FPim00w: folds
DMQLAmut/l19xN5STQndFg: folds
jUhx+m+V7qfbLZTjgwZByg collected $1.45 from pot
*** SUMMARY ***
Total pot $1.50 | Rake $0.05
Board [4h Qc 9h]
Seat 1: R+KjpH/wSjDLhtIy9+edNA folded before Flop (didn't bet)
Seat 2: 58zdeSBSuSFX/qZfhc7YmA (button) folded before Flop (didn't bet)
Seat 3: jUhx+m+V7qfbLZTjgwZByg (small blind) collected ($1.45)
Seat 4: Rt6KgtZ8YaJoTc3FPim00w (big blind) folded on the Flop
Seat 6: DMQLAmut/l19xN5STQndFg folded on the Flop



PokerStars Game #59938717904:  Hold'em No Limit ($0.25/$0.50) - 2009/07/01 0:21:45 ET
Table 'c/CRn+68J3Y8KxD5g1ek2Q' 2-max Seat #2 is the button
Seat 1: 46qCyJ6evTkHo9al5sBMNA ($273.20 in chips)
Seat 2: BypVLsYQt3ePFm2xQL/dOA ($108.60 in chips)
BypVLsYQt3ePFm2xQL/dOA: posts small blind $0.25
46qCyJ6evTkHo9al5sBMNA: posts big blind $0.50
*** HOLE CARDS ***
BypVLsYQt3ePFm2xQL/dOA: raises $1.50 to $2
46qCyJ6evTkHo9al5sBMNA: folds
BypVLsYQt3ePFm2xQL/dOA collected $1 from pot
BypVLsYQt3ePFm2xQL/dOA: doesn't show hand
*** SUMMARY ***
Total pot $1 | Rake $0
Seat 1: 46qCyJ6evTkHo9al5sBMNA (big blind) folded before Flop
Seat 2: BypVLsYQt3ePFm2xQL/dOA (button) (small blind) collected ($1)



PokerStars Game #59938717746:  Hold'em No Limit ($0.25/$0.50) - 2009/07/01 0:21:45 ET
Table 'X6IRCRTh+20gjz8aubWnwA' 9-max Seat #5 is the button
Seat 2: RjBdQ6w31rgcy0o24VLR6w ($12.40 in chips)
Seat 3: mSD1pginDsyHG5PDfqzphw ($19.75 in chips)
Seat 4: uw9QayAAxLM3Hb+HR7mSkg ($11.50 in chips)
Seat 5: QtFsO51ArDuQ44+KvR2jow ($29.45 in chips)
Seat 6: /6In1zC3WtgwxDcueWzZWg ($57.60 in chips)
Seat 7: VBnpbzn0dIveV55qKvciew ($43.45 in chips)
Seat 9: M+7+BTmX5vZatHVuoRB1nA ($81.60 in chips)
/6In1zC3WtgwxDcueWzZWg: posts small blind $0.25
VBnpbzn0dIveV55qKvciew: posts big blind $0.50
HxeBVq06/3Bh/H986sgdbw: sits out
*** HOLE CARDS ***
M+7+BTmX5vZatHVuoRB1nA: folds
RjBdQ6w31rgcy0o24VLR6w: folds
mSD1pginDsyHG5PDfqzphw: folds
uw9QayAAxLM3Hb+HR7mSkg: folds
QtFsO51ArDuQ44+KvR2jow: folds
/6In1zC3WtgwxDcueWzZWg: raises $1 to $1.50
VBnpbzn0dIveV55qKvciew: folds
/6In1zC3WtgwxDcueWzZWg collected $1 from pot
/6In1zC3WtgwxDcueWzZWg: doesn't show hand
*** SUMMARY ***
Total pot $1 | Rake $0
Seat 2: RjBdQ6w31rgcy0o24VLR6w folded before Flop (didn't bet)
Seat 3: mSD1pginDsyHG5PDfqzphw folded before Flop (didn't bet)
Seat 4: uw9QayAAxLM3Hb+HR7mSkg folded before Flop (didn't bet)
Seat 5: QtFsO51ArDuQ44+KvR2jow (button) folded before Flop (didn't bet)
Seat 6: /6In1zC3WtgwxDcueWzZWg (small blind) collected ($1)
Seat 7: VBnpbzn0dIveV55qKvciew (big blind) folded before Flop
Seat 9: M+7+BTmX5vZatHVuoRB1nA folded before Flop (didn't bet)



PokerStars Game #59938717868:  Hold'em No Limit ($0.25/$0.50) - 2009/07/01 0:21:45 ET
Table 'GfL/No5u5PoEnU39lP5pQg' 6-max Seat #1 is the button
Seat 1: 1WUCqNG+p+vfWRTXNu4ljw ($50 in chips)
Seat 2: uVwggSetzp7d+eVgowO3vg ($47.50 in chips)
Seat 3: qNezhXOOUXqwG7b9X5XJAA ($50 in chips)
Seat 4: yqM0AD7MZQd/cEtKdDQY1A ($17.55 in chips)
Seat 5: crjGpJEzSZgD38FoE3VMGg ($52.05 in chips)
Seat 6: 3wylWYGeXFXcrE4XVrlPng ($64.60 in chips)
uVwggSetzp7d+eVgowO3vg: posts small blind $0.25
qNezhXOOUXqwG7b9X5XJAA: posts big blind $0.50
*** HOLE CARDS ***
yqM0AD7MZQd/cEtKdDQY1A: raises $1.50 to $2
crjGpJEzSZgD38FoE3VMGg: folds
3wylWYGeXFXcrE4XVrlPng: raises $1.50 to $3.50
1WUCqNG+p+vfWRTXNu4ljw: folds
uVwggSetzp7d+eVgowO3vg said, "ty just  didn't think you were strong"
uVwggSetzp7d+eVgowO3vg: folds
qNezhXOOUXqwG7b9X5XJAA: folds
yqM0AD7MZQd/cEtKdDQY1A: raises $1.50 to $5
3wylWYGeXFXcrE4XVrlPng: raises $8.50 to $13.50
yqM0AD7MZQd/cEtKdDQY1A: calls $8.50
*** FLOP *** [5s 4d Ks]
yqM0AD7MZQd/cEtKdDQY1A: checks
3wylWYGeXFXcrE4XVrlPng: bets $4
yqM0AD7MZQd/cEtKdDQY1A: calls $4
*** TURN *** [5s 4d Ks] [5d]
yqM0AD7MZQd/cEtKdDQY1A: bets $0.05 and is all-in
3wylWYGeXFXcrE4XVrlPng: calls $0.05
*** RIVER *** [5s 4d Ks 5d] [8c]
*** SHOW DOWN ***
yqM0AD7MZQd/cEtKdDQY1A: shows [2h 2s] (two pair, Fives and Deuces)
3wylWYGeXFXcrE4XVrlPng: shows [Qs Qc] (two pair, Queens and Fives)
3wylWYGeXFXcrE4XVrlPng collected $34.15 from pot
*** SUMMARY ***
Total pot $35.85 | Rake $1.70
Board [5s 4d Ks 5d 8c]
Seat 1: 1WUCqNG+p+vfWRTXNu4ljw (button) folded before Flop (didn't bet)
Seat 2: uVwggSetzp7d+eVgowO3vg (small blind) folded before Flop
Seat 3: qNezhXOOUXqwG7b9X5XJAA (big blind) folded before Flop
Seat 4: yqM0AD7MZQd/cEtKdDQY1A showed [2h 2s] and lost with two pair, Fives and Deuces
Seat 5: crjGpJEzSZgD38FoE3VMGg folded before Flop (didn't bet)
Seat 6: 3wylWYGeXFXcrE4XVrlPng showed [Qs Qc] and won ($34.15) with two pair, Queens and Fives



PokerStars Game #59938719864:  Hold'em No Limit ($0.25/$0.50) - 2009/07/01 0:21:48 ET
Table 'IeNZOZQ4T6oiaHqFeo6yIA' 2-max Seat #2 is the button
Seat 1: ndd1nfncBkWNitBnsfCoVQ ($80.85 in chips)
Seat 2: A91IUl5JaZROhtfCtnnwYw ($4.90 in chips)
A91IUl5JaZROhtfCtnnwYw: posts small blind $0.25
ndd1nfncBkWNitBnsfCoVQ: posts big blind $0.50
*** HOLE CARDS ***
A91IUl5JaZROhtfCtnnwYw: calls $0.25
ndd1nfncBkWNitBnsfCoVQ: checks
*** FLOP *** [8d 7s 6d]
ndd1nfncBkWNitBnsfCoVQ: checks
A91IUl5JaZROhtfCtnnwYw: checks
*** TURN *** [8d 7s 6d] [2s]
ndd1nfncBkWNitBnsfCoVQ: checks
A91IUl5JaZROhtfCtnnwYw: checks
*** RIVER *** [8d 7s 6d 2s] [Ah]
ndd1nfncBkWNitBnsfCoVQ: checks
A91IUl5JaZROhtfCtnnwYw: bets $1
ndd1nfncBkWNitBnsfCoVQ: folds
A91IUl5JaZROhtfCtnnwYw collected $0.95 from pot
A91IUl5JaZROhtfCtnnwYw: doesn't show hand
*** SUMMARY ***
Total pot $1 | Rake $0.05
Board [8d 7s 6d 2s Ah]
Seat 1: ndd1nfncBkWNitBnsfCoVQ (big blind) folded on the River
Seat 2: A91IUl5JaZROhtfCtnnwYw (button) (small blind) collected ($0.95)



PokerStars Game #59938720622:  Hold'em No Limit ($0.25/$0.50) - 2009/07/01 0:21:49 ET
Table 'mTxf8gPLgffN3Iwfm7Icfg' 2-max Seat #1 is the button
Seat 1: Do9Rlu1R5u/AcRtMTl8SYg ($77.30 in chips)
Seat 2: EMc5LPgVaded4Qc77vm0fw ($84 in chips)
Do9Rlu1R5u/AcRtMTl8SYg: posts small blind $0.25
EMc5LPgVaded4Qc77vm0fw: posts big blind $0.50
*** HOLE CARDS ***
Do9Rlu1R5u/AcRtMTl8SYg: folds
EMc5LPgVaded4Qc77vm0fw collected $0.50 from pot
EMc5LPgVaded4Qc77vm0fw: doesn't show hand
*** SUMMARY ***
Total pot $0.50 | Rake $0
Seat 1: Do9Rlu1R5u/AcRtMTl8SYg (button) (small blind) folded before Flop
Seat 2: EMc5LPgVaded4Qc77vm0fw (big blind) collected ($0.50)



PokerStars Game #59938721524:  Hold'em No Limit ($0.25/$0.50) - 2009/07/01 0:21:50 ET
Table 'ZYwMb9E6tY50Qm+iNbXRYw' 2-max Seat #2 is the button
Seat 1: DXLfRb8KDZWmrztw2bwtFw ($13.60 in chips)
Seat 2: 16tvT7AYgZ2LgiGFcvFKQg ($18.50 in chips)
16tvT7AYgZ2LgiGFcvFKQg: posts small blind $0.25
DXLfRb8KDZWmrztw2bwtFw: posts big blind $0.50
*** HOLE CARDS ***
16tvT7AYgZ2LgiGFcvFKQg: raises $0.50 to $1
DXLfRb8KDZWmrztw2bwtFw: calls $0.50
*** FLOP *** [8s 7c Kd]
DXLfRb8KDZWmrztw2bwtFw: checks
16tvT7AYgZ2LgiGFcvFKQg: checks
*** TURN *** [8s 7c Kd] [6d]
DXLfRb8KDZWmrztw2bwtFw: checks
16tvT7AYgZ2LgiGFcvFKQg: checks
*** RIVER *** [8s 7c Kd 6d] [Td]
DXLfRb8KDZWmrztw2bwtFw: checks
16tvT7AYgZ2LgiGFcvFKQg: bets $1.50
DXLfRb8KDZWmrztw2bwtFw: folds
16tvT7AYgZ2LgiGFcvFKQg collected $1.90 from pot
*** SUMMARY ***
Total pot $2 | Rake $0.10
Board [8s 7c Kd 6d Td]
Seat 1: DXLfRb8KDZWmrztw2bwtFw (big blind) folded on the River
Seat 2: 16tvT7AYgZ2LgiGFcvFKQg (button) (small blind) collected ($1.90)



PokerStars Game #59938721242:  Hold'em No Limit ($0.25/$0.50) - 2009/07/01 0:21:50 ET
Table '5EmHi+fnatGQQShcNmzOZQ' 6-max Seat #5 is the button
Seat 1: SwPczQo3cOtwEzhJrfO2cQ ($27.40 in chips)
Seat 3: L9qfLYXrczhAPd/VckgsWw ($59.75 in chips)
Seat 4: wOyVV9M/oyiw3YaOjNZ05w ($50.75 in chips)
Seat 5: kxPhs4ePFqMy52CInAJ2aw ($48.50 in chips)
Seat 6: 686aeHikcJlgKkSuIFdcXQ ($156.85 in chips)
686aeHikcJlgKkSuIFdcXQ: posts small blind $0.25
SwPczQo3cOtwEzhJrfO2cQ: posts big blind $0.50
*** HOLE CARDS ***
L9qfLYXrczhAPd/VckgsWw: raises $1 to $1.50
wOyVV9M/oyiw3YaOjNZ05w: folds
kxPhs4ePFqMy52CInAJ2aw: folds
686aeHikcJlgKkSuIFdcXQ: folds
SwPczQo3cOtwEzhJrfO2cQ: calls $1
*** FLOP *** [7d 3c 2d]
SwPczQo3cOtwEzhJrfO2cQ: bets $1
L9qfLYXrczhAPd/VckgsWw: raises $1.50 to $2.50
SwPczQo3cOtwEzhJrfO2cQ: calls $1.50
*** TURN *** [7d 3c 2d] [Kc]
SwPczQo3cOtwEzhJrfO2cQ: checks
L9qfLYXrczhAPd/VckgsWw: bets $7.50
SwPczQo3cOtwEzhJrfO2cQ: folds
L9qfLYXrczhAPd/VckgsWw collected $7.85 from pot
L9qfLYXrczhAPd/VckgsWw: doesn't show hand
*** SUMMARY ***
Total pot $8.25 | Rake $0.40
Board [7d 3c 2d Kc]
Seat 1: SwPczQo3cOtwEzhJrfO2cQ (big blind) folded on the Turn
Seat 3: L9qfLYXrczhAPd/VckgsWw collected ($7.85)
Seat 4: wOyVV9M/oyiw3YaOjNZ05w folded before Flop (didn't bet)
Seat 5: kxPhs4ePFqMy52CInAJ2aw (button) folded before Flop (didn't bet)
Seat 6: 686aeHikcJlgKkSuIFdcXQ (small blind) folded before Flop



PokerStars Game #59938722310:  Hold'em No Limit ($0.25/$0.50) - 2009/07/01 0:21:52 ET
Table 'raOT4/ipuZgzjfKHC+jD9g' 2-max Seat #1 is the button
Seat 1: IuwLemwLhc9fvrwBGs0AMA ($10.05 in chips)
Seat 2: Udr5juWSWUgTu1NlRhjMdA ($12.15 in chips)
IuwLemwLhc9fvrwBGs0AMA: posts small blind $0.25
Udr5juWSWUgTu1NlRhjMdA: posts big blind $0.50
*** HOLE CARDS ***
IuwLemwLhc9fvrwBGs0AMA: folds
Udr5juWSWUgTu1NlRhjMdA collected $0.50 from pot
Udr5juWSWUgTu1NlRhjMdA: doesn't show hand
*** SUMMARY ***
Total pot $0.50 | Rake $0
Seat 1: IuwLemwLhc9fvrwBGs0AMA (button) (small blind) folded before Flop
Seat 2: Udr5juWSWUgTu1NlRhjMdA (big blind) collected ($0.50)



PokerStars Game #59938724080:  Hold'em No Limit ($0.25/$0.50) - 2009/07/01 0:21:54 ET
Table 'hSTs/dUsYLgJQuF2Onp0MQ' 6-max Seat #4 is the button
Seat 1: Donj3X7gYzeS5pAl7s9f+Q ($25.50 in chips)
Seat 3: vQOrJuXbLC3UZDVklY9bOA ($26.50 in chips)
Seat 4: L0aIPg7qefDQjdJo3HCVEA ($10 in chips)
Seat 5: 686aeHikcJlgKkSuIFdcXQ ($80.45 in chips)
Seat 6: +laPa9P7BjZKKnR0n+OmvA ($6.85 in chips)
686aeHikcJlgKkSuIFdcXQ: posts small blind $0.25
+laPa9P7BjZKKnR0n+OmvA: posts big blind $0.50
*** HOLE CARDS ***
Donj3X7gYzeS5pAl7s9f+Q: folds
vQOrJuXbLC3UZDVklY9bOA: calls $0.50
gSCZnZGMgaRWmRw5txyZIA leaves the table
L0aIPg7qefDQjdJo3HCVEA: folds
686aeHikcJlgKkSuIFdcXQ: folds
+laPa9P7BjZKKnR0n+OmvA: checks
*** FLOP *** [4s 2s Tc]
+laPa9P7BjZKKnR0n+OmvA: checks
vQOrJuXbLC3UZDVklY9bOA: checks
*** TURN *** [4s 2s Tc] [8s]
+laPa9P7BjZKKnR0n+OmvA: bets $1.50
vQOrJuXbLC3UZDVklY9bOA: calls $1.50
*** RIVER *** [4s 2s Tc 8s] [7s]
+laPa9P7BjZKKnR0n+OmvA: checks
vQOrJuXbLC3UZDVklY9bOA: bets $2.50
+laPa9P7BjZKKnR0n+OmvA: folds
vQOrJuXbLC3UZDVklY9bOA collected $4.05 from pot
*** SUMMARY ***
Total pot $4.25 | Rake $0.20
Board [4s 2s Tc 8s 7s]
Seat 1: Donj3X7gYzeS5pAl7s9f+Q folded before Flop (didn't bet)
Seat 3: vQOrJuXbLC3UZDVklY9bOA collected ($4.05)
Seat 4: L0aIPg7qefDQjdJo3HCVEA (button) folded before Flop (didn't bet)
Seat 5: 686aeHikcJlgKkSuIFdcXQ (small blind) folded before Flop
Seat 6: +laPa9P7BjZKKnR0n+OmvA (big blind) folded on the River



PokerStars Game #59938724336:  Hold'em No Limit ($0.25/$0.50) - 2009/07/01 0:21:55 ET
Table 'mTxf8gPLgffN3Iwfm7Icfg' 2-max Seat #2 is the button
Seat 1: Do9Rlu1R5u/AcRtMTl8SYg ($77.05 in chips)
Seat 2: EMc5LPgVaded4Qc77vm0fw ($84.25 in chips)
EMc5LPgVaded4Qc77vm0fw: posts small blind $0.25
Do9Rlu1R5u/AcRtMTl8SYg: posts big blind $0.50
*** HOLE CARDS ***
EMc5LPgVaded4Qc77vm0fw: raises $1.50 to $2
Do9Rlu1R5u/AcRtMTl8SYg: folds
EMc5LPgVaded4Qc77vm0fw collected $1 from pot
EMc5LPgVaded4Qc77vm0fw: doesn't show hand
*** SUMMARY ***
Total pot $1 | Rake $0
Seat 1: Do9Rlu1R5u/AcRtMTl8SYg (big blind) folded before Flop
Seat 2: EMc5LPgVaded4Qc77vm0fw (button) (small blind) collected ($1)



PokerStars Game #59938725122:  Hold'em No Limit ($0.25/$0.50) - 2009/07/01 0:21:56 ET
Table 'E7bWJ45aoFXRpyRv2gw+Ig' 2-max Seat #2 is the button
Seat 1: FRkiRasEGlHUeLrEl+k/nA ($68.45 in chips)
Seat 2: 3Wro85I7472vJ4Wkpneo9A ($110.55 in chips)
3Wro85I7472vJ4Wkpneo9A: posts small blind $0.25
FRkiRasEGlHUeLrEl+k/nA: posts big blind $0.50
*** HOLE CARDS ***
3Wro85I7472vJ4Wkpneo9A: calls $0.25
FRkiRasEGlHUeLrEl+k/nA: checks
*** FLOP *** [Ad 8s 4c]
FRkiRasEGlHUeLrEl+k/nA: checks
3Wro85I7472vJ4Wkpneo9A: bets $1
FRkiRasEGlHUeLrEl+k/nA: folds
3Wro85I7472vJ4Wkpneo9A collected $0.95 from pot
3Wro85I7472vJ4Wkpneo9A: doesn't show hand
*** SUMMARY ***
Total pot $1 | Rake $0.05
Board [Ad 8s 4c]
Seat 1: FRkiRasEGlHUeLrEl+k/nA (big blind) folded on the Flop
Seat 2: 3Wro85I7472vJ4Wkpneo9A (button) (small blind) collected ($0.95)



PokerStars Game #59938726606:  Hold'em No Limit ($0.25/$0.50) - 2009/07/01 0:21:58 ET
Table 'raOT4/ipuZgzjfKHC+jD9g' 2-max Seat #2 is the button
Seat 1: IuwLemwLhc9fvrwBGs0AMA ($9.80 in chips)
Seat 2: Udr5juWSWUgTu1NlRhjMdA ($12.40 in chips)
Udr5juWSWUgTu1NlRhjMdA: posts small blind $0.25
IuwLemwLhc9fvrwBGs0AMA: posts big blind $0.50
*** HOLE CARDS ***
Udr5juWSWUgTu1NlRhjMdA: folds
IuwLemwLhc9fvrwBGs0AMA collected $0.50 from pot
*** SUMMARY ***
Total pot $0.50 | Rake $0
Seat 1: IuwLemwLhc9fvrwBGs0AMA (big blind) collected ($0.50)
Seat 2: Udr5juWSWUgTu1NlRhjMdA (button) (small blind) folded before Flop



PokerStars Game #59938726330:  Hold'em No Limit ($0.25/$0.50) - 2009/07/01 0:21:58 ET
Table 'kgbJRsxfv64KrErDRBAkcw' 6-max Seat #3 is the button
Seat 2: Q+thC23WCv1kJUJtH/+4Jw ($67.15 in chips)
Seat 3: T0Gx/FcQ5VH9u7XaOMX97A ($60.25 in chips)
Seat 4: qanMEqjABjWxC/JgQ/0l7w ($56.20 in chips)
Seat 5: +Pf9jTVizYlIo+woPvptfA ($50 in chips)
qanMEqjABjWxC/JgQ/0l7w: posts small blind $0.25
+Pf9jTVizYlIo+woPvptfA: posts big blind $0.50
*** HOLE CARDS ***
Q+thC23WCv1kJUJtH/+4Jw: folds
T0Gx/FcQ5VH9u7XaOMX97A: folds
qanMEqjABjWxC/JgQ/0l7w: raises $1.50 to $2
+Pf9jTVizYlIo+woPvptfA: folds
ozrlafxxh1HmYdA0/h+MuA joins the table at seat #6
qanMEqjABjWxC/JgQ/0l7w collected $1 from pot
*** SUMMARY ***
Total pot $1 | Rake $0
Seat 2: Q+thC23WCv1kJUJtH/+4Jw folded before Flop (didn't bet)
Seat 3: T0Gx/FcQ5VH9u7XaOMX97A (button) folded before Flop (didn't bet)
Seat 4: qanMEqjABjWxC/JgQ/0l7w (small blind) collected ($1)
Seat 5: +Pf9jTVizYlIo+woPvptfA (big blind) folded before Flop



PokerStars Game #59938727498:  Hold'em No Limit ($0.25/$0.50) - 2009/07/01 0:21:59 ET
Table '+z1aekfHkpp09pc8F9aViw' 6-max Seat #6 is the button
Seat 1: wOyVV9M/oyiw3YaOjNZ05w ($50 in chips)
Seat 2: M6xK/VklCvdyyrmvzATlxQ ($30.70 in chips)
Seat 3: uUznlIMFnRUvwrBhYF73KA ($63.25 in chips)
Seat 4: RowCSpSURHTOL/dcjg/Iug ($50.70 in chips)
Seat 5: crjGpJEzSZgD38FoE3VMGg ($59.15 in chips)
Seat 6: 686aeHikcJlgKkSuIFdcXQ ($69.35 in chips)
wOyVV9M/oyiw3YaOjNZ05w: posts small blind $0.25
M6xK/VklCvdyyrmvzATlxQ: posts big blind $0.50
*** HOLE CARDS ***
uUznlIMFnRUvwrBhYF73KA: folds
RowCSpSURHTOL/dcjg/Iug: folds
crjGpJEzSZgD38FoE3VMGg: folds
686aeHikcJlgKkSuIFdcXQ: raises $1 to $1.50
wOyVV9M/oyiw3YaOjNZ05w: folds
M6xK/VklCvdyyrmvzATlxQ: folds
686aeHikcJlgKkSuIFdcXQ collected $1.25 from pot
*** SUMMARY ***
Total pot $1.25 | Rake $0
Seat 1: wOyVV9M/oyiw3YaOjNZ05w (small blind) folded before Flop
Seat 2: M6xK/VklCvdyyrmvzATlxQ (big blind) folded before Flop
Seat 3: uUznlIMFnRUvwrBhYF73KA folded before Flop (didn't bet)
Seat 4: RowCSpSURHTOL/dcjg/Iug folded before Flop (didn't bet)
Seat 5: crjGpJEzSZgD38FoE3VMGg folded before Flop (didn't bet)
Seat 6: 686aeHikcJlgKkSuIFdcXQ (button) collected ($1.25)



PokerStars Game #59938728846:  Hold'em No Limit ($0.25/$0.50) - 2009/07/01 0:22:01 ET
Table '0AhP5FLi4ySROVJ/ycT1Qw' 2-max Seat #2 is the button
Seat 1: 38ZztDUK6IU5WCK+BN74Rw ($92.75 in chips)
Seat 2: 46qCyJ6evTkHo9al5sBMNA ($87 in chips)
46qCyJ6evTkHo9al5sBMNA: posts small blind $0.25
38ZztDUK6IU5WCK+BN74Rw: posts big blind $0.50
*** HOLE CARDS ***
46qCyJ6evTkHo9al5sBMNA: folds
38ZztDUK6IU5WCK+BN74Rw collected $0.50 from pot
*** SUMMARY ***
Total pot $0.50 | Rake $0
Seat 1: 38ZztDUK6IU5WCK+BN74Rw (big blind) collected ($0.50)
Seat 2: 46qCyJ6evTkHo9al5sBMNA (button) (small blind) folded before Flop



PokerStars Game #59938728844:  Hold'em No Limit ($0.25/$0.50) - 2009/07/01 0:22:01 ET
Table 'mTxf8gPLgffN3Iwfm7Icfg' 2-max Seat #1 is the button
Seat 1: Do9Rlu1R5u/AcRtMTl8SYg ($76.55 in chips)
Seat 2: EMc5LPgVaded4Qc77vm0fw ($84.75 in chips)
Do9Rlu1R5u/AcRtMTl8SYg: posts small blind $0.25
EMc5LPgVaded4Qc77vm0fw: posts big blind $0.50
*** HOLE CARDS ***
Do9Rlu1R5u/AcRtMTl8SYg: folds
EMc5LPgVaded4Qc77vm0fw collected $0.50 from pot
EMc5LPgVaded4Qc77vm0fw: doesn't show hand
*** SUMMARY ***
Total pot $0.50 | Rake $0
Seat 1: Do9Rlu1R5u/AcRtMTl8SYg (button) (small blind) folded before Flop
Seat 2: EMc5LPgVaded4Qc77vm0fw (big blind) collected ($0.50)



PokerStars Game #59938728468:  Hold'em No Limit ($0.25/$0.50) - 2009/07/01 0:22:01 ET
Table 'c/CRn+68J3Y8KxD5g1ek2Q' 2-max Seat #1 is the button
Seat 1: 46qCyJ6evTkHo9al5sBMNA ($272.70 in chips)
Seat 2: BypVLsYQt3ePFm2xQL/dOA ($109.10 in chips)
46qCyJ6evTkHo9al5sBMNA: posts small blind $0.25
BypVLsYQt3ePFm2xQL/dOA: posts big blind $0.50
*** HOLE CARDS ***
46qCyJ6evTkHo9al5sBMNA: folds
BypVLsYQt3ePFm2xQL/dOA collected $0.50 from pot
BypVLsYQt3ePFm2xQL/dOA: doesn't show hand
*** SUMMARY ***
Total pot $0.50 | Rake $0
Seat 1: 46qCyJ6evTkHo9al5sBMNA (button) (small blind) folded before Flop
Seat 2: BypVLsYQt3ePFm2xQL/dOA (big blind) collected ($0.50)



PokerStars Game #59938730448:  Hold'em No Limit ($0.25/$0.50) - 2009/07/01 0:22:04 ET
Table 'X6IRCRTh+20gjz8aubWnwA' 9-max Seat #6 is the button
Seat 2: RjBdQ6w31rgcy0o24VLR6w ($12.40 in chips)
Seat 3: mSD1pginDsyHG5PDfqzphw ($19.75 in chips)
Seat 4: uw9QayAAxLM3Hb+HR7mSkg ($11.50 in chips)
Seat 5: QtFsO51ArDuQ44+KvR2jow ($29.45 in chips)
Seat 6: /6In1zC3WtgwxDcueWzZWg ($58.10 in chips)
Seat 7: VBnpbzn0dIveV55qKvciew ($42.95 in chips)
Seat 8: HxeBVq06/3Bh/H986sgdbw ($13 in chips)
Seat 9: M+7+BTmX5vZatHVuoRB1nA ($81.60 in chips)
VBnpbzn0dIveV55qKvciew: posts small blind $0.25
HxeBVq06/3Bh/H986sgdbw: posts big blind $0.50
*** HOLE CARDS ***
M+7+BTmX5vZatHVuoRB1nA: folds
RjBdQ6w31rgcy0o24VLR6w: folds
mSD1pginDsyHG5PDfqzphw: folds
uw9QayAAxLM3Hb+HR7mSkg: folds
QtFsO51ArDuQ44+KvR2jow: calls $0.50
/6In1zC3WtgwxDcueWzZWg: folds
VBnpbzn0dIveV55qKvciew: calls $0.25
HxeBVq06/3Bh/H986sgdbw: checks
*** FLOP *** [6s 4d 5d]
VBnpbzn0dIveV55qKvciew: checks
HxeBVq06/3Bh/H986sgdbw: checks
QtFsO51ArDuQ44+KvR2jow: bets $1.50
VBnpbzn0dIveV55qKvciew: calls $1.50
HxeBVq06/3Bh/H986sgdbw: folds
*** TURN *** [6s 4d 5d] [9s]
VBnpbzn0dIveV55qKvciew: checks
QtFsO51ArDuQ44+KvR2jow: checks
*** RIVER *** [6s 4d 5d 9s] [Kd]
VBnpbzn0dIveV55qKvciew: bets $3
QtFsO51ArDuQ44+KvR2jow: folds
VBnpbzn0dIveV55qKvciew collected $4.30 from pot
VBnpbzn0dIveV55qKvciew: doesn't show hand
*** SUMMARY ***
Total pot $4.50 | Rake $0.20
Board [6s 4d 5d 9s Kd]
Seat 2: RjBdQ6w31rgcy0o24VLR6w folded before Flop (didn't bet)
Seat 3: mSD1pginDsyHG5PDfqzphw folded before Flop (didn't bet)
Seat 4: uw9QayAAxLM3Hb+HR7mSkg folded before Flop (didn't bet)
Seat 5: QtFsO51ArDuQ44+KvR2jow folded on the River
Seat 6: /6In1zC3WtgwxDcueWzZWg (button) folded before Flop (didn't bet)
Seat 7: VBnpbzn0dIveV55qKvciew (small blind) collected ($4.30)
Seat 8: HxeBVq06/3Bh/H986sgdbw (big blind) folded on the Flop
Seat 9: M+7+BTmX5vZatHVuoRB1nA folded before Flop (didn't bet)



PokerStars Game #59938731136:  Hold'em No Limit ($0.25/$0.50) - 2009/07/01 0:22:05 ET
Table 'raOT4/ipuZgzjfKHC+jD9g' 2-max Seat #1 is the button
Seat 1: IuwLemwLhc9fvrwBGs0AMA ($10.05 in chips)
Seat 2: Udr5juWSWUgTu1NlRhjMdA ($12.15 in chips)
IuwLemwLhc9fvrwBGs0AMA: posts small blind $0.25
Udr5juWSWUgTu1NlRhjMdA: posts big blind $0.50
*** HOLE CARDS ***
IuwLemwLhc9fvrwBGs0AMA: raises $0.50 to $1
Udr5juWSWUgTu1NlRhjMdA: calls $0.50
*** FLOP *** [Kd 3s 7s]
Udr5juWSWUgTu1NlRhjMdA: checks
IuwLemwLhc9fvrwBGs0AMA: checks
*** TURN *** [Kd 3s 7s] [5h]
Udr5juWSWUgTu1NlRhjMdA: checks
IuwLemwLhc9fvrwBGs0AMA: bets $1
Udr5juWSWUgTu1NlRhjMdA: folds
IuwLemwLhc9fvrwBGs0AMA collected $1.90 from pot
*** SUMMARY ***
Total pot $2 | Rake $0.10
Board [Kd 3s 7s 5h]
Seat 1: IuwLemwLhc9fvrwBGs0AMA (button) (small blind) collected ($1.90)
Seat 2: Udr5juWSWUgTu1NlRhjMdA (big blind) folded on the Turn



PokerStars Game #59938731804:  Hold'em No Limit ($0.25/$0.50) - 2009/07/01 0:22:06 ET
Table 'lSisgp6H7Fg1hH5VfjEjYQ' 9-max Seat #1 is the button
Seat 1: pEW8B6uXbdR47kfljMQ3+Q ($38.20 in chips)
Seat 2: UrcnkQOiLVk8BlKDPJSy7Q ($50.60 in chips)
Seat 3: aTkyjTh3w5YLWiIERupZOA ($38.45 in chips)
Seat 5: mSD1pginDsyHG5PDfqzphw ($10 in chips)
Seat 6: +k7T5ocke8UwavtgUHm+Cg ($26.60 in chips)
Seat 7: dGw5MBstXyXhWHHVFOWOFA ($43 in chips)
Seat 8: a4JDWmpFQkL10XfAyuF51A ($35.55 in chips)
Seat 9: 5JJVDlaiMnB004o/RqbZZQ ($41 in chips)
UrcnkQOiLVk8BlKDPJSy7Q: posts small blind $0.25
aTkyjTh3w5YLWiIERupZOA: posts big blind $0.50
*** HOLE CARDS ***
mSD1pginDsyHG5PDfqzphw: folds
+k7T5ocke8UwavtgUHm+Cg: calls $0.50
dGw5MBstXyXhWHHVFOWOFA: folds
a4JDWmpFQkL10XfAyuF51A: folds
nvw9yQKhJT56lA9k+TLdhw leaves the table
5JJVDlaiMnB004o/RqbZZQ: calls $0.50
pEW8B6uXbdR47kfljMQ3+Q: folds
UrcnkQOiLVk8BlKDPJSy7Q: folds
aTkyjTh3w5YLWiIERupZOA: checks
*** FLOP *** [3d 9d Kc]
aTkyjTh3w5YLWiIERupZOA: checks
+k7T5ocke8UwavtgUHm+Cg: checks
5JJVDlaiMnB004o/RqbZZQ: checks
*** TURN *** [3d 9d Kc] [4h]
aTkyjTh3w5YLWiIERupZOA: checks
+k7T5ocke8UwavtgUHm+Cg: checks
bwv/rbH/hHhPhY6u9mu04w joins the table at seat #4
5JJVDlaiMnB004o/RqbZZQ: checks
*** RIVER *** [3d 9d Kc 4h] [7s]
aTkyjTh3w5YLWiIERupZOA: bets $1
+k7T5ocke8UwavtgUHm+Cg: folds
5JJVDlaiMnB004o/RqbZZQ: folds
aTkyjTh3w5YLWiIERupZOA collected $1.70 from pot
*** SUMMARY ***
Total pot $1.75 | Rake $0.05
Board [3d 9d Kc 4h 7s]
Seat 1: pEW8B6uXbdR47kfljMQ3+Q (button) folded before Flop (didn't bet)
Seat 2: UrcnkQOiLVk8BlKDPJSy7Q (small blind) folded before Flop
Seat 3: aTkyjTh3w5YLWiIERupZOA (big blind) collected ($1.70)
Seat 5: mSD1pginDsyHG5PDfqzphw folded before Flop (didn't bet)
Seat 6: +k7T5ocke8UwavtgUHm+Cg folded on the River
Seat 7: dGw5MBstXyXhWHHVFOWOFA folded before Flop (didn't bet)
Seat 8: a4JDWmpFQkL10XfAyuF51A folded before Flop (didn't bet)
Seat 9: 5JJVDlaiMnB004o/RqbZZQ folded on the River



PokerStars Game #59938732544:  Hold'em No Limit ($0.25/$0.50) - 2009/07/01 0:22:07 ET
Table 'c/CRn+68J3Y8KxD5g1ek2Q' 2-max Seat #2 is the button
Seat 1: 46qCyJ6evTkHo9al5sBMNA ($272.45 in chips)
Seat 2: BypVLsYQt3ePFm2xQL/dOA ($109.35 in chips)
BypVLsYQt3ePFm2xQL/dOA: posts small blind $0.25
46qCyJ6evTkHo9al5sBMNA: posts big blind $0.50
*** HOLE CARDS ***
BypVLsYQt3ePFm2xQL/dOA: calls $0.25
46qCyJ6evTkHo9al5sBMNA: checks
*** FLOP *** [3d Jh Jc]
46qCyJ6evTkHo9al5sBMNA: checks
BypVLsYQt3ePFm2xQL/dOA: checks
*** TURN *** [3d Jh Jc] [6h]
46qCyJ6evTkHo9al5sBMNA: checks
BypVLsYQt3ePFm2xQL/dOA: checks
*** RIVER *** [3d Jh Jc 6h] [Ks]
46qCyJ6evTkHo9al5sBMNA: checks
BypVLsYQt3ePFm2xQL/dOA: checks
*** SHOW DOWN ***
46qCyJ6evTkHo9al5sBMNA: shows [Qd 7h] (a pair of Jacks)
BypVLsYQt3ePFm2xQL/dOA: shows [Qs Th] (a pair of Jacks - King+Queen+Ten kicker)
BypVLsYQt3ePFm2xQL/dOA collected $0.95 from pot
*** SUMMARY ***
Total pot $1 | Rake $0.05
Board [3d Jh Jc 6h Ks]
Seat 1: 46qCyJ6evTkHo9al5sBMNA (big blind) showed [Qd 7h] and lost with a pair of Jacks
Seat 2: BypVLsYQt3ePFm2xQL/dOA (button) (small blind) showed [Qs Th] and won ($0.95) with a pair of Jacks



PokerStars Game #59938733362:  Hold'em No Limit ($0.25/$0.50) - 2009/07/01 0:22:08 ET
Table '0AhP5FLi4ySROVJ/ycT1Qw' 2-max Seat #1 is the button
Seat 1: 38ZztDUK6IU5WCK+BN74Rw ($93 in chips)
Seat 2: 46qCyJ6evTkHo9al5sBMNA ($86.75 in chips)
38ZztDUK6IU5WCK+BN74Rw: posts small blind $0.25
46qCyJ6evTkHo9al5sBMNA: posts big blind $0.50
*** HOLE CARDS ***
38ZztDUK6IU5WCK+BN74Rw: folds
46qCyJ6evTkHo9al5sBMNA collected $0.50 from pot
46qCyJ6evTkHo9al5sBMNA: doesn't show hand
*** SUMMARY ***
Total pot $0.50 | Rake $0
Seat 1: 38ZztDUK6IU5WCK+BN74Rw (button) (small blind) folded before Flop
Seat 2: 46qCyJ6evTkHo9al5sBMNA (big blind) collected ($0.50)



PokerStars Game #59938733050:  Hold'em No Limit ($0.25/$0.50) - 2009/07/01 0:22:08 ET
Table 'ZYwMb9E6tY50Qm+iNbXRYw' 2-max Seat #1 is the button
Seat 1: DXLfRb8KDZWmrztw2bwtFw ($12.60 in chips)
Seat 2: 16tvT7AYgZ2LgiGFcvFKQg ($19.40 in chips)
DXLfRb8KDZWmrztw2bwtFw: posts small blind $0.25
16tvT7AYgZ2LgiGFcvFKQg: posts big blind $0.50
*** HOLE CARDS ***
DXLfRb8KDZWmrztw2bwtFw: folds
16tvT7AYgZ2LgiGFcvFKQg collected $0.50 from pot
16tvT7AYgZ2LgiGFcvFKQg: doesn't show hand
*** SUMMARY ***
Total pot $0.50 | Rake $0
Seat 1: DXLfRb8KDZWmrztw2bwtFw (button) (small blind) folded before Flop
Seat 2: 16tvT7AYgZ2LgiGFcvFKQg (big blind) collected ($0.50)



PokerStars Game #59938733074:  Hold'em No Limit ($0.25/$0.50) - 2009/07/01 0:22:08 ET
Table '3FhG0gl3kMX3wBEEqj+wnQ' 9-max Seat #2 is the button
Seat 1: e0J9pdCNUDTCG031RnXqLA ($19.50 in chips)
Seat 2: 4dl3YNqZ6Houm2jZAzDmRg ($25.25 in chips)
Seat 3: HZkVla4kK2SI42CVrPZ/ig ($9.50 in chips)
Seat 4: bz4LMfV0GGl/MJ/ABXuPmg ($22.20 in chips)
Seat 5: XNMDwbXt/Q4jM99AXnbJDw ($55.55 in chips)
Seat 6: 5JJVDlaiMnB004o/RqbZZQ ($24.50 in chips)
Seat 7: mSD1pginDsyHG5PDfqzphw ($10 in chips)
Seat 8: j3K/Jujr7PY4ZM2RZvlH6A ($46.40 in chips)
Seat 9: L5e2lrPLQm1Pqx30IIZ/Fw ($10 in chips)
HZkVla4kK2SI42CVrPZ/ig: posts small blind $0.25
bz4LMfV0GGl/MJ/ABXuPmg: posts big blind $0.50
*** HOLE CARDS ***
XNMDwbXt/Q4jM99AXnbJDw: folds
5JJVDlaiMnB004o/RqbZZQ: folds
mSD1pginDsyHG5PDfqzphw: folds
j3K/Jujr7PY4ZM2RZvlH6A: raises $1 to $1.50
L5e2lrPLQm1Pqx30IIZ/Fw: folds
e0J9pdCNUDTCG031RnXqLA: folds
4dl3YNqZ6Houm2jZAzDmRg: calls $1.50
HZkVla4kK2SI42CVrPZ/ig: folds
bz4LMfV0GGl/MJ/ABXuPmg: folds
*** FLOP *** [Kc Th 6c]
j3K/Jujr7PY4ZM2RZvlH6A: checks
4dl3YNqZ6Houm2jZAzDmRg: bets $2
j3K/Jujr7PY4ZM2RZvlH6A: raises $2 to $4
4dl3YNqZ6Houm2jZAzDmRg: calls $2
*** TURN *** [Kc Th 6c] [Ah]
j3K/Jujr7PY4ZM2RZvlH6A: bets $7
4dl3YNqZ6Houm2jZAzDmRg: folds
j3K/Jujr7PY4ZM2RZvlH6A collected $11.20 from pot
j3K/Jujr7PY4ZM2RZvlH6A: doesn't show hand
*** SUMMARY ***
Total pot $11.75 | Rake $0.55
Board [Kc Th 6c Ah]
Seat 1: e0J9pdCNUDTCG031RnXqLA folded before Flop (didn't bet)
Seat 2: 4dl3YNqZ6Houm2jZAzDmRg (button) folded on the Turn
Seat 3: HZkVla4kK2SI42CVrPZ/ig (small blind) folded before Flop
Seat 4: bz4LMfV0GGl/MJ/ABXuPmg (big blind) folded before Flop
Seat 5: XNMDwbXt/Q4jM99AXnbJDw folded before Flop (didn't bet)
Seat 6: 5JJVDlaiMnB004o/RqbZZQ folded before Flop (didn't bet)
Seat 7: mSD1pginDsyHG5PDfqzphw folded before Flop (didn't bet)
Seat 8: j3K/Jujr7PY4ZM2RZvlH6A collected ($11.20)
Seat 9: L5e2lrPLQm1Pqx30IIZ/Fw folded before Flop (didn't bet)



PokerStars Game #59938734318:  Hold'em No Limit ($0.25/$0.50) - 2009/07/01 0:22:09 ET
Table 'dVmkPtk5nWTfXApFsnhIOg' 2-max Seat #2 is the button
Seat 1: bypIyrYcAAifLfhZpGlKLA ($50 in chips)
Seat 2: rPToQDbLWB+dKnz7fcQSIg ($30 in chips)
rPToQDbLWB+dKnz7fcQSIg: posts small blind $0.25
bypIyrYcAAifLfhZpGlKLA: posts big blind $0.50
*** HOLE CARDS ***
rPToQDbLWB+dKnz7fcQSIg: calls $0.25
bypIyrYcAAifLfhZpGlKLA: checks
*** FLOP *** [Td 3h Jh]
bypIyrYcAAifLfhZpGlKLA: checks
rPToQDbLWB+dKnz7fcQSIg: checks
*** TURN *** [Td 3h Jh] [Kh]
bypIyrYcAAifLfhZpGlKLA: bets $1
rPToQDbLWB+dKnz7fcQSIg: calls $1
*** RIVER *** [Td 3h Jh Kh] [2s]
bypIyrYcAAifLfhZpGlKLA: checks
rPToQDbLWB+dKnz7fcQSIg: bets $1.50
bypIyrYcAAifLfhZpGlKLA: folds
rPToQDbLWB+dKnz7fcQSIg collected $2.90 from pot
*** SUMMARY ***
Total pot $3 | Rake $0.10
Board [Td 3h Jh Kh 2s]
Seat 1: bypIyrYcAAifLfhZpGlKLA (big blind) folded on the River
Seat 2: rPToQDbLWB+dKnz7fcQSIg (button) (small blind) collected ($2.90)



PokerStars Game #59938734078:  Hold'em No Limit ($0.25/$0.50) - 2009/07/01 0:22:09 ET
Table 'mTxf8gPLgffN3Iwfm7Icfg' 2-max Seat #2 is the button
Seat 1: Do9Rlu1R5u/AcRtMTl8SYg ($76.30 in chips)
Seat 2: EMc5LPgVaded4Qc77vm0fw ($85 in chips)
EMc5LPgVaded4Qc77vm0fw: posts small blind $0.25
Do9Rlu1R5u/AcRtMTl8SYg: posts big blind $0.50
*** HOLE CARDS ***
EMc5LPgVaded4Qc77vm0fw: folds
Do9Rlu1R5u/AcRtMTl8SYg collected $0.50 from pot
Do9Rlu1R5u/AcRtMTl8SYg: doesn't show hand
*** SUMMARY ***
Total pot $0.50 | Rake $0
Seat 1: Do9Rlu1R5u/AcRtMTl8SYg (big blind) collected ($0.50)
Seat 2: EMc5LPgVaded4Qc77vm0fw (button) (small blind) folded before Flop



PokerStars Game #59938734104:  Hold'em No Limit ($0.25/$0.50) - 2009/07/01 0:22:09 ET
Table '+dXkOAQyS8j9PQZusUTMpg' 2-max Seat #2 is the button
Seat 1: XFa6sBGjP2gxoIvxR3fZIg ($55 in chips)
Seat 2: 5IBeOgaApY1Bvzv2P8X4EA ($52.80 in chips)
5IBeOgaApY1Bvzv2P8X4EA: posts small blind $0.25
XFa6sBGjP2gxoIvxR3fZIg: posts big blind $0.50
*** HOLE CARDS ***
5IBeOgaApY1Bvzv2P8X4EA: calls $0.25
XFa6sBGjP2gxoIvxR3fZIg: checks
*** FLOP *** [3s Qc 9h]
XFa6sBGjP2gxoIvxR3fZIg: checks
5IBeOgaApY1Bvzv2P8X4EA: checks
*** TURN *** [3s Qc 9h] [Jd]
XFa6sBGjP2gxoIvxR3fZIg: checks
5IBeOgaApY1Bvzv2P8X4EA: checks
*** RIVER *** [3s Qc 9h Jd] [9d]
XFa6sBGjP2gxoIvxR3fZIg: checks
5IBeOgaApY1Bvzv2P8X4EA: checks
*** SHOW DOWN ***
XFa6sBGjP2gxoIvxR3fZIg: shows [2h 4h] (a pair of Nines)
5IBeOgaApY1Bvzv2P8X4EA: shows [Ah 6h] (a pair of Nines - Ace kicker)
5IBeOgaApY1Bvzv2P8X4EA collected $0.95 from pot
*** SUMMARY ***
Total pot $1 | Rake $0.05
Board [3s Qc 9h Jd 9d]
Seat 1: XFa6sBGjP2gxoIvxR3fZIg (big blind) showed [2h 4h] and lost with a pair of Nines
Seat 2: 5IBeOgaApY1Bvzv2P8X4EA (button) (small blind) showed [Ah 6h] and won ($0.95) with a pair of Nines



PokerStars Game #59938735128:  Hold'em No Limit ($0.25/$0.50) - 2009/07/01 0:22:11 ET
Table 'MJxeZCzYELxiIsyUZyT0jw' 6-max Seat #5 is the button
Seat 2: r6H1GiZ6QIpMTDhyodKuRQ ($63.90 in chips)
Seat 3: JQZew0FjzS19kTjeNtrE+A ($53.45 in chips)
Seat 4: lP7Q6pewz4C2RsAfKsjdWw ($32.95 in chips)
Seat 5: 3jvoOXNtXE90w2BdfNZwZQ ($50 in chips)
Seat 6: TTx3CHxyi0SObcHyMJRp5w ($50 in chips)
TTx3CHxyi0SObcHyMJRp5w: posts small blind $0.25
r6H1GiZ6QIpMTDhyodKuRQ: posts big blind $0.50
*** HOLE CARDS ***
JQZew0FjzS19kTjeNtrE+A: folds
lP7Q6pewz4C2RsAfKsjdWw: folds
wOyVV9M/oyiw3YaOjNZ05w joins the table at seat #1
3jvoOXNtXE90w2BdfNZwZQ: raises $1 to $1.50
TTx3CHxyi0SObcHyMJRp5w: folds
r6H1GiZ6QIpMTDhyodKuRQ: folds
3jvoOXNtXE90w2BdfNZwZQ collected $1.25 from pot
3jvoOXNtXE90w2BdfNZwZQ: doesn't show hand
*** SUMMARY ***
Total pot $1.25 | Rake $0
Seat 2: r6H1GiZ6QIpMTDhyodKuRQ (big blind) folded before Flop
Seat 3: JQZew0FjzS19kTjeNtrE+A folded before Flop (didn't bet)
Seat 4: lP7Q6pewz4C2RsAfKsjdWw folded before Flop (didn't bet)
Seat 5: 3jvoOXNtXE90w2BdfNZwZQ (button) collected ($1.25)
Seat 6: TTx3CHxyi0SObcHyMJRp5w (small blind) folded before Flop



PokerStars Game #59938736098:  Hold'em No Limit ($0.25/$0.50) - 2009/07/01 0:22:12 ET
Table 'E7bWJ45aoFXRpyRv2gw+Ig' 2-max Seat #1 is the button
Seat 1: FRkiRasEGlHUeLrEl+k/nA ($67.95 in chips)
Seat 2: 3Wro85I7472vJ4Wkpneo9A ($111 in chips)
FRkiRasEGlHUeLrEl+k/nA: posts small blind $0.25
3Wro85I7472vJ4Wkpneo9A: posts big blind $0.50
*** HOLE CARDS ***
FRkiRasEGlHUeLrEl+k/nA: raises $1 to $1.50
3Wro85I7472vJ4Wkpneo9A: folds
FRkiRasEGlHUeLrEl+k/nA collected $1 from pot
FRkiRasEGlHUeLrEl+k/nA: doesn't show hand
*** SUMMARY ***
Total pot $1 | Rake $0
Seat 1: FRkiRasEGlHUeLrEl+k/nA (button) (small blind) collected ($1)
Seat 2: 3Wro85I7472vJ4Wkpneo9A (big blind) folded before Flop



PokerStars Game #59938736882:  Hold'em No Limit ($0.25/$0.50) - 2009/07/01 0:22:13 ET
Table 'ZYwMb9E6tY50Qm+iNbXRYw' 2-max Seat #2 is the button
Seat 1: DXLfRb8KDZWmrztw2bwtFw ($12.35 in chips)
Seat 2: 16tvT7AYgZ2LgiGFcvFKQg ($19.65 in chips)
16tvT7AYgZ2LgiGFcvFKQg: posts small blind $0.25
DXLfRb8KDZWmrztw2bwtFw: posts big blind $0.50
*** HOLE CARDS ***
16tvT7AYgZ2LgiGFcvFKQg: calls $0.25
DXLfRb8KDZWmrztw2bwtFw: checks
*** FLOP *** [8c 5c 2c]
DXLfRb8KDZWmrztw2bwtFw: checks
16tvT7AYgZ2LgiGFcvFKQg: bets $0.50
DXLfRb8KDZWmrztw2bwtFw: calls $0.50
*** TURN *** [8c 5c 2c] [Ah]
DXLfRb8KDZWmrztw2bwtFw: checks
16tvT7AYgZ2LgiGFcvFKQg: checks
*** RIVER *** [8c 5c 2c Ah] [Th]
DXLfRb8KDZWmrztw2bwtFw: checks
16tvT7AYgZ2LgiGFcvFKQg: checks
*** SHOW DOWN ***
DXLfRb8KDZWmrztw2bwtFw: shows [7h 6h] (high card Ace)
16tvT7AYgZ2LgiGFcvFKQg: shows [9c 6s] (high card Ace - Ten+Nine kicker)
16tvT7AYgZ2LgiGFcvFKQg collected $1.95 from pot
*** SUMMARY ***
Total pot $2 | Rake $0.05
Board [8c 5c 2c Ah Th]
Seat 1: DXLfRb8KDZWmrztw2bwtFw (big blind) showed [7h 6h] and lost with high card Ace
Seat 2: 16tvT7AYgZ2LgiGFcvFKQg (button) (small blind) showed [9c 6s] and won ($1.95) with high card Ace



PokerStars Game #59938736874:  Hold'em No Limit ($0.25/$0.50) - 2009/07/01 0:22:13 ET
Table 'Nz0Vr7WMHL2g5Uk7dDZjpw' 9-max Seat #9 is the button
Seat 2: XNMDwbXt/Q4jM99AXnbJDw ($50 in chips)
Seat 3: 4QTiNH5fteLgJjx/s6Hy6A ($21 in chips)
Seat 4: 5JJVDlaiMnB004o/RqbZZQ ($27.50 in chips)
Seat 5: WGW0DgjBUXs1ylURHG8vnQ ($11.10 in chips)
Seat 6: k1f0lS7tlMHCLGs0JT34Tg ($9.25 in chips)
Seat 7: KPLH0gELgFe2OuAnhJFI5w ($19.70 in chips)
Seat 8: HkZI6g4zl83TDTA7SRspmQ ($20.95 in chips)
Seat 9: Ak2W6V2TDVIQrvSAy4eD7Q ($24.60 in chips)
XNMDwbXt/Q4jM99AXnbJDw: posts small blind $0.25
4QTiNH5fteLgJjx/s6Hy6A: posts big blind $0.50
*** HOLE CARDS ***
5JJVDlaiMnB004o/RqbZZQ: folds
WGW0DgjBUXs1ylURHG8vnQ: folds
k1f0lS7tlMHCLGs0JT34Tg: folds
KPLH0gELgFe2OuAnhJFI5w: folds
HkZI6g4zl83TDTA7SRspmQ: folds
Ak2W6V2TDVIQrvSAy4eD7Q: raises $1 to $1.50
XNMDwbXt/Q4jM99AXnbJDw: folds
4QTiNH5fteLgJjx/s6Hy6A: folds
Ak2W6V2TDVIQrvSAy4eD7Q collected $1.25 from pot
Ak2W6V2TDVIQrvSAy4eD7Q: doesn't show hand
*** SUMMARY ***
Total pot $1.25 | Rake $0
Seat 2: XNMDwbXt/Q4jM99AXnbJDw (small blind) folded before Flop
Seat 3: 4QTiNH5fteLgJjx/s6Hy6A (big blind) folded before Flop
Seat 4: 5JJVDlaiMnB004o/RqbZZQ folded before Flop (didn't bet)
Seat 5: WGW0DgjBUXs1ylURHG8vnQ folded before Flop (didn't bet)
Seat 6: k1f0lS7tlMHCLGs0JT34Tg folded before Flop (didn't bet)
Seat 7: KPLH0gELgFe2OuAnhJFI5w folded before Flop (didn't bet)
Seat 8: HkZI6g4zl83TDTA7SRspmQ folded before Flop (didn't bet)
Seat 9: Ak2W6V2TDVIQrvSAy4eD7Q (button) collected ($1.25)



PokerStars Game #59938737650:  Hold'em No Limit ($0.25/$0.50) - 2009/07/01 0:22:14 ET
Table '0AhP5FLi4ySROVJ/ycT1Qw' 2-max Seat #2 is the button
Seat 1: 38ZztDUK6IU5WCK+BN74Rw ($92.75 in chips)
Seat 2: 46qCyJ6evTkHo9al5sBMNA ($87 in chips)
46qCyJ6evTkHo9al5sBMNA: posts small blind $0.25
38ZztDUK6IU5WCK+BN74Rw: posts big blind $0.50
*** HOLE CARDS ***
46qCyJ6evTkHo9al5sBMNA: raises $1 to $1.50
38ZztDUK6IU5WCK+BN74Rw: calls $1
*** FLOP *** [Jh Th 4h]
38ZztDUK6IU5WCK+BN74Rw: checks
46qCyJ6evTkHo9al5sBMNA: checks
*** TURN *** [Jh Th 4h] [2c]
38ZztDUK6IU5WCK+BN74Rw: checks
46qCyJ6evTkHo9al5sBMNA: checks
*** RIVER *** [Jh Th 4h 2c] [2h]
38ZztDUK6IU5WCK+BN74Rw: checks
46qCyJ6evTkHo9al5sBMNA: checks
*** SHOW DOWN ***
38ZztDUK6IU5WCK+BN74Rw: shows [3s Ks] (a pair of Deuces)
46qCyJ6evTkHo9al5sBMNA: shows [Td 8d] (two pair, Tens and Deuces)
46qCyJ6evTkHo9al5sBMNA collected $2.85 from pot
*** SUMMARY ***
Total pot $3 | Rake $0.15
Board [Jh Th 4h 2c 2h]
Seat 1: 38ZztDUK6IU5WCK+BN74Rw (big blind) showed [3s Ks] and lost with a pair of Deuces
Seat 2: 46qCyJ6evTkHo9al5sBMNA (button) (small blind) showed [Td 8d] and won ($2.85) with two pair, Tens and Deuces



PokerStars Game #59938737438:  Hold'em No Limit ($0.25/$0.50) - 2009/07/01 0:22:14 ET
Table 'QOgaEqMcJ73pcUMMxoisUg' 6-max Seat #3 is the button
Seat 1: RFefXIDyFvNtJLq+CloCzA ($40.95 in chips)
Seat 3: wUZNozoIDYf+16hp4nn6dw ($45.30 in chips)
Seat 4: zAcsDhG/T128Vn7XGVSgKg ($63.55 in chips)
Seat 5: 6vNxrjjCl6FwfaaymM9jjg ($16 in chips)
Seat 6: s83dnhZ6VC53vY0/f6OV/g ($42.05 in chips)
zAcsDhG/T128Vn7XGVSgKg: posts small blind $0.25
6vNxrjjCl6FwfaaymM9jjg: posts big blind $0.50
*** HOLE CARDS ***
s83dnhZ6VC53vY0/f6OV/g: folds
RFefXIDyFvNtJLq+CloCzA: folds
wUZNozoIDYf+16hp4nn6dw: raises $0.50 to $1
zAcsDhG/T128Vn7XGVSgKg: folds
6vNxrjjCl6FwfaaymM9jjg: calls $0.50
*** FLOP *** [Ad 8h As]
6vNxrjjCl6FwfaaymM9jjg: checks
Im2p1Nt83UKSqv5c9frm4Q has returned
wUZNozoIDYf+16hp4nn6dw: bets $3
6vNxrjjCl6FwfaaymM9jjg: folds
wUZNozoIDYf+16hp4nn6dw collected $2.15 from pot
*** SUMMARY ***
Total pot $2.25 | Rake $0.10
Board [Ad 8h As]
Seat 1: RFefXIDyFvNtJLq+CloCzA folded before Flop (didn't bet)
Seat 3: wUZNozoIDYf+16hp4nn6dw (button) collected ($2.15)
Seat 4: zAcsDhG/T128Vn7XGVSgKg (small blind) folded before Flop
Seat 5: 6vNxrjjCl6FwfaaymM9jjg (big blind) folded on the Flop
Seat 6: s83dnhZ6VC53vY0/f6OV/g folded before Flop (didn't bet)



PokerStars Game #59938739342:  Hold'em No Limit ($0.25/$0.50) - 2009/07/01 0:22:17 ET
Table 'kgbJRsxfv64KrErDRBAkcw' 6-max Seat #4 is the button
Seat 2: Q+thC23WCv1kJUJtH/+4Jw ($67.15 in chips)
Seat 3: T0Gx/FcQ5VH9u7XaOMX97A ($60.25 in chips)
Seat 4: qanMEqjABjWxC/JgQ/0l7w ($56.70 in chips)
Seat 5: +Pf9jTVizYlIo+woPvptfA ($50 in chips)
Seat 6: ozrlafxxh1HmYdA0/h+MuA ($10 in chips)
+Pf9jTVizYlIo+woPvptfA: posts small blind $0.25
ozrlafxxh1HmYdA0/h+MuA: posts big blind $0.50
*** HOLE CARDS ***
Q+thC23WCv1kJUJtH/+4Jw: raises $1.50 to $2
N7O9jUEx2YiQn1+yRYTHmw has returned
T0Gx/FcQ5VH9u7XaOMX97A has timed out
T0Gx/FcQ5VH9u7XaOMX97A: folds
T0Gx/FcQ5VH9u7XaOMX97A is sitting out
T0Gx/FcQ5VH9u7XaOMX97A has returned
qanMEqjABjWxC/JgQ/0l7w: folds
+Pf9jTVizYlIo+woPvptfA: folds
ozrlafxxh1HmYdA0/h+MuA: folds
Q+thC23WCv1kJUJtH/+4Jw collected $1.25 from pot
*** SUMMARY ***
Total pot $1.25 | Rake $0
Seat 2: Q+thC23WCv1kJUJtH/+4Jw collected ($1.25)
Seat 3: T0Gx/FcQ5VH9u7XaOMX97A folded before Flop (didn't bet)
Seat 4: qanMEqjABjWxC/JgQ/0l7w (button) folded before Flop (didn't bet)
Seat 5: +Pf9jTVizYlIo+woPvptfA (small blind) folded before Flop
Seat 6: ozrlafxxh1HmYdA0/h+MuA (big blind) folded before Flop



PokerStars Game #59938740440:  Hold'em No Limit ($0.25/$0.50) - 2009/07/01 0:22:19 ET
Table 'IeNZOZQ4T6oiaHqFeo6yIA' 2-max Seat #1 is the button
Seat 1: ndd1nfncBkWNitBnsfCoVQ ($80.35 in chips)
Seat 2: A91IUl5JaZROhtfCtnnwYw ($5.35 in chips)
ndd1nfncBkWNitBnsfCoVQ: posts small blind $0.25
A91IUl5JaZROhtfCtnnwYw: posts big blind $0.50
*** HOLE CARDS ***
ndd1nfncBkWNitBnsfCoVQ: raises $9 to $9.50
A91IUl5JaZROhtfCtnnwYw: calls $4.85 and is all-in
*** FLOP *** [Jh Ad Jc]
*** TURN *** [Jh Ad Jc] [6h]
*** RIVER *** [Jh Ad Jc 6h] [Js]
*** SHOW DOWN ***
A91IUl5JaZROhtfCtnnwYw: shows [2h 5h] (three of a kind, Jacks)
ndd1nfncBkWNitBnsfCoVQ: shows [3c Ah] (a full house, Jacks full of Aces)
ndd1nfncBkWNitBnsfCoVQ collected $10.20 from pot
*** SUMMARY ***
Total pot $10.70 | Rake $0.50
Board [Jh Ad Jc 6h Js]
Seat 1: ndd1nfncBkWNitBnsfCoVQ (button) (small blind) showed [3c Ah] and won ($10.20) with a full house, Jacks full of Aces
Seat 2: A91IUl5JaZROhtfCtnnwYw (big blind) showed [2h 5h] and lost with three of a kind, Jacks



PokerStars Game #59938741150:  Hold'em No Limit ($0.25/$0.50) - 2009/07/01 0:22:20 ET
Table 'E7bWJ45aoFXRpyRv2gw+Ig' 2-max Seat #2 is the button
Seat 1: FRkiRasEGlHUeLrEl+k/nA ($68.45 in chips)
Seat 2: 3Wro85I7472vJ4Wkpneo9A ($110.50 in chips)
3Wro85I7472vJ4Wkpneo9A: posts small blind $0.25
FRkiRasEGlHUeLrEl+k/nA: posts big blind $0.50
*** HOLE CARDS ***
3Wro85I7472vJ4Wkpneo9A: raises $1 to $1.50
FRkiRasEGlHUeLrEl+k/nA: folds
3Wro85I7472vJ4Wkpneo9A collected $1 from pot
3Wro85I7472vJ4Wkpneo9A: doesn't show hand
*** SUMMARY ***
Total pot $1 | Rake $0
Seat 1: FRkiRasEGlHUeLrEl+k/nA (big blind) folded before Flop
Seat 2: 3Wro85I7472vJ4Wkpneo9A (button) (small blind) collected ($1)



PokerStars Game #59938741330:  Hold'em No Limit ($0.25/$0.50) - 2009/07/01 0:22:20 ET
Table 'mTxf8gPLgffN3Iwfm7Icfg' 2-max Seat #1 is the button
Seat 1: Do9Rlu1R5u/AcRtMTl8SYg ($76.55 in chips)
Seat 2: EMc5LPgVaded4Qc77vm0fw ($84.75 in chips)
Do9Rlu1R5u/AcRtMTl8SYg: posts small blind $0.25
EMc5LPgVaded4Qc77vm0fw: posts big blind $0.50
*** HOLE CARDS ***
Do9Rlu1R5u/AcRtMTl8SYg: folds
EMc5LPgVaded4Qc77vm0fw collected $0.50 from pot
EMc5LPgVaded4Qc77vm0fw: doesn't show hand
*** SUMMARY ***
Total pot $0.50 | Rake $0
Seat 1: Do9Rlu1R5u/AcRtMTl8SYg (button) (small blind) folded before Flop
Seat 2: EMc5LPgVaded4Qc77vm0fw (big blind) collected ($0.50)



PokerStars Game #59938741456:  Hold'em No Limit ($0.25/$0.50) - 2009/07/01 0:22:20 ET
Table 'T/PgNWqVyY6lkldcBVXYJQ' 6-max Seat #3 is the button
Seat 1: +Pf9jTVizYlIo+woPvptfA ($53.75 in chips)
Seat 2: oZAeY5rVqNGgt8yyQ0pxbA ($29 in chips)
Seat 3: L3OcNO1bgdqDI46j67KQPQ ($55.30 in chips)
Seat 4: jxMvxeUUL9UU0V6wVU+Iyw ($10.20 in chips)
Seat 5: vVQBckETtigfb5mAcyK0OA ($62.65 in chips)
Seat 6: cDzbog6kwmJp+LBeBq+iMQ ($26.25 in chips)
jxMvxeUUL9UU0V6wVU+Iyw: posts small blind $0.25
vVQBckETtigfb5mAcyK0OA: posts big blind $0.50
*** HOLE CARDS ***
cDzbog6kwmJp+LBeBq+iMQ said, "lose the caps and maybe i could stand you"
cDzbog6kwmJp+LBeBq+iMQ: calls $0.50
+Pf9jTVizYlIo+woPvptfA: folds
oZAeY5rVqNGgt8yyQ0pxbA: calls $0.50
L3OcNO1bgdqDI46j67KQPQ: folds
jxMvxeUUL9UU0V6wVU+Iyw: folds
vVQBckETtigfb5mAcyK0OA: checks
*** FLOP *** [Ad 9d Qs]
cDzbog6kwmJp+LBeBq+iMQ said, "hey big red"
vVQBckETtigfb5mAcyK0OA: checks
cDzbog6kwmJp+LBeBq+iMQ said, "you know a dan zezulisnki"
cDzbog6kwmJp+LBeBq+iMQ: checks
jxMvxeUUL9UU0V6wVU+Iyw said, "Are you telling me that you don't want to see the game????"
vVQBckETtigfb5mAcyK0OA said, "lol,lol"
oZAeY5rVqNGgt8yyQ0pxbA: checks
*** TURN *** [Ad 9d Qs] [7s]
vVQBckETtigfb5mAcyK0OA: bets $0.50
cDzbog6kwmJp+LBeBq+iMQ: folds
oZAeY5rVqNGgt8yyQ0pxbA: folds
vVQBckETtigfb5mAcyK0OA collected $1.70 from pot
*** SUMMARY ***
Total pot $1.75 | Rake $0.05
Board [Ad 9d Qs 7s]
Seat 1: +Pf9jTVizYlIo+woPvptfA folded before Flop (didn't bet)
Seat 2: oZAeY5rVqNGgt8yyQ0pxbA folded on the Turn
Seat 3: L3OcNO1bgdqDI46j67KQPQ (button) folded before Flop (didn't bet)
Seat 4: jxMvxeUUL9UU0V6wVU+Iyw (small blind) folded before Flop
Seat 5: vVQBckETtigfb5mAcyK0OA (big blind) collected ($1.70)
Seat 6: cDzbog6kwmJp+LBeBq+iMQ folded on the Turn



PokerStars Game #59938743472:  Hold'em No Limit ($0.25/$0.50) - 2009/07/01 0:22:23 ET
Table '8YYaUJqyk4NgBvNkL7mj/Q' 2-max Seat #2 is the button
Seat 1: Fp/oksNpipCrD2MJ2pH20g ($10 in chips)
Seat 2: dkC7J+qbyqk0qCcmJbEPPw ($50 in chips)
dkC7J+qbyqk0qCcmJbEPPw: posts small blind $0.25
Fp/oksNpipCrD2MJ2pH20g: posts big blind $0.50
*** HOLE CARDS ***
dkC7J+qbyqk0qCcmJbEPPw: raises $0.50 to $1
Fp/oksNpipCrD2MJ2pH20g: calls $0.50
*** FLOP *** [As Kd 4s]
Fp/oksNpipCrD2MJ2pH20g: checks
dkC7J+qbyqk0qCcmJbEPPw: checks
*** TURN *** [As Kd 4s] [3c]
Fp/oksNpipCrD2MJ2pH20g: checks
dkC7J+qbyqk0qCcmJbEPPw: checks
*** RIVER *** [As Kd 4s 3c] [Tc]
Fp/oksNpipCrD2MJ2pH20g: checks
dkC7J+qbyqk0qCcmJbEPPw: checks
*** SHOW DOWN ***
Fp/oksNpipCrD2MJ2pH20g: shows [8s 6s] (high card Ace)
dkC7J+qbyqk0qCcmJbEPPw: shows [5c 5d] (a pair of Fives)
dkC7J+qbyqk0qCcmJbEPPw collected $1.90 from pot
*** SUMMARY ***
Total pot $2 | Rake $0.10
Board [As Kd 4s 3c Tc]
Seat 1: Fp/oksNpipCrD2MJ2pH20g (big blind) showed [8s 6s] and lost with high card Ace
Seat 2: dkC7J+qbyqk0qCcmJbEPPw (button) (small blind) showed [5c 5d] and won ($1.90) with a pair of Fives



PokerStars Game #59938743758:  Hold'em No Limit ($0.25/$0.50) - 2009/07/01 0:22:24 ET
Table 'fx6MqwfYAj/Rt86hBz2L3Q' 9-max Seat #8 is the button
Seat 1: jf2c/o9gI7Xj0GleCSMj9g ($30 in chips)
Seat 2: C3rGXblctNcWI6JYPHhaEg ($14 in chips)
Seat 3: iadBi5AEt7gTBXbDSSnMYQ ($56.10 in chips)
Seat 4: gPEN9Zp33YTm/mu9/SYP1w ($25.45 in chips)
Seat 5: iAISe3dVeua8PUn2wwgDHw ($29.50 in chips)
Seat 6: VelaednozEGCpceHSFUsAg ($21.80 in chips)
Seat 7: bkXkL3pmapikPQQRNPZSEA ($8.75 in chips)
Seat 8: 6ol/q1A4zYU6qXbZnTzPfQ ($13.55 in chips)
Seat 9: HZkVla4kK2SI42CVrPZ/ig ($9.50 in chips)
HZkVla4kK2SI42CVrPZ/ig: posts small blind $0.25
jf2c/o9gI7Xj0GleCSMj9g: posts big blind $0.50
*** HOLE CARDS ***
C3rGXblctNcWI6JYPHhaEg: calls $0.50
iadBi5AEt7gTBXbDSSnMYQ: folds
gPEN9Zp33YTm/mu9/SYP1w: folds
iAISe3dVeua8PUn2wwgDHw: calls $0.50
VelaednozEGCpceHSFUsAg: folds
bkXkL3pmapikPQQRNPZSEA: calls $0.50
6ol/q1A4zYU6qXbZnTzPfQ: raises $2.50 to $3
HZkVla4kK2SI42CVrPZ/ig: folds
jf2c/o9gI7Xj0GleCSMj9g: folds
C3rGXblctNcWI6JYPHhaEg: calls $2.50
iAISe3dVeua8PUn2wwgDHw: calls $2.50
bkXkL3pmapikPQQRNPZSEA: folds
*** FLOP *** [8d 9h Kd]
C3rGXblctNcWI6JYPHhaEg: checks
iAISe3dVeua8PUn2wwgDHw: checks
6ol/q1A4zYU6qXbZnTzPfQ: bets $10.55 and is all-in
C3rGXblctNcWI6JYPHhaEg: folds
iAISe3dVeua8PUn2wwgDHw: folds
6ol/q1A4zYU6qXbZnTzPfQ collected $9.75 from pot
*** SUMMARY ***
Total pot $10.25 | Rake $0.50
Board [8d 9h Kd]
Seat 1: jf2c/o9gI7Xj0GleCSMj9g (big blind) folded before Flop
Seat 2: C3rGXblctNcWI6JYPHhaEg folded on the Flop
Seat 3: iadBi5AEt7gTBXbDSSnMYQ folded before Flop (didn't bet)
Seat 4: gPEN9Zp33YTm/mu9/SYP1w folded before Flop (didn't bet)
Seat 5: iAISe3dVeua8PUn2wwgDHw folded on the Flop
Seat 6: VelaednozEGCpceHSFUsAg folded before Flop (didn't bet)
Seat 7: bkXkL3pmapikPQQRNPZSEA folded before Flop
Seat 8: 6ol/q1A4zYU6qXbZnTzPfQ (button) collected ($9.75)
Seat 9: HZkVla4kK2SI42CVrPZ/ig (small blind) folded before Flop



PokerStars Game #59938744492:  Hold'em No Limit ($0.25/$0.50) - 2009/07/01 0:22:25 ET
Table 'tyR5AZNKV8Aadbrnrnlg7g' 6-max Seat #3 is the button
Seat 1: R+KjpH/wSjDLhtIy9+edNA ($54.70 in chips)
Seat 2: 58zdeSBSuSFX/qZfhc7YmA ($33.10 in chips)
Seat 3: jUhx+m+V7qfbLZTjgwZByg ($26.10 in chips)
Seat 4: Rt6KgtZ8YaJoTc3FPim00w ($84.50 in chips)
Seat 5: wOyVV9M/oyiw3YaOjNZ05w ($50 in chips)
Seat 6: DMQLAmut/l19xN5STQndFg ($7.80 in chips)
Rt6KgtZ8YaJoTc3FPim00w: posts small blind $0.25
wOyVV9M/oyiw3YaOjNZ05w: posts big blind $0.50
*** HOLE CARDS ***
DMQLAmut/l19xN5STQndFg: folds
R+KjpH/wSjDLhtIy9+edNA has timed out
R+KjpH/wSjDLhtIy9+edNA: folds
R+KjpH/wSjDLhtIy9+edNA is sitting out
58zdeSBSuSFX/qZfhc7YmA: raises $1 to $1.50
jUhx+m+V7qfbLZTjgwZByg: raises $2.50 to $4
Rt6KgtZ8YaJoTc3FPim00w: folds
wOyVV9M/oyiw3YaOjNZ05w: folds
58zdeSBSuSFX/qZfhc7YmA: calls $2.50
*** FLOP *** [4c 8d Ts]
R+KjpH/wSjDLhtIy9+edNA has returned
58zdeSBSuSFX/qZfhc7YmA: checks
jUhx+m+V7qfbLZTjgwZByg: bets $3.50
58zdeSBSuSFX/qZfhc7YmA: folds
jUhx+m+V7qfbLZTjgwZByg collected $8.35 from pot
*** SUMMARY ***
Total pot $8.75 | Rake $0.40
Board [4c 8d Ts]
Seat 1: R+KjpH/wSjDLhtIy9+edNA folded before Flop (didn't bet)
Seat 2: 58zdeSBSuSFX/qZfhc7YmA folded on the Flop
Seat 3: jUhx+m+V7qfbLZTjgwZByg (button) collected ($8.35)
Seat 4: Rt6KgtZ8YaJoTc3FPim00w (small blind) folded before Flop
Seat 5: wOyVV9M/oyiw3YaOjNZ05w (big blind) folded before Flop
Seat 6: DMQLAmut/l19xN5STQndFg folded before Flop (didn't bet)



PokerStars Game #59938745240:  Hold'em No Limit ($0.25/$0.50) - 2009/07/01 0:22:26 ET
Table 'mTxf8gPLgffN3Iwfm7Icfg' 2-max Seat #2 is the button
Seat 1: Do9Rlu1R5u/AcRtMTl8SYg ($76.30 in chips)
Seat 2: EMc5LPgVaded4Qc77vm0fw ($85 in chips)
EMc5LPgVaded4Qc77vm0fw: posts small blind $0.25
Do9Rlu1R5u/AcRtMTl8SYg: posts big blind $0.50
*** HOLE CARDS ***
EMc5LPgVaded4Qc77vm0fw: calls $0.25
Do9Rlu1R5u/AcRtMTl8SYg: checks
*** FLOP *** [Js 6s Jc]
Do9Rlu1R5u/AcRtMTl8SYg: bets $1
EMc5LPgVaded4Qc77vm0fw: raises $2.50 to $3.50
Do9Rlu1R5u/AcRtMTl8SYg: folds
EMc5LPgVaded4Qc77vm0fw collected $2.90 from pot
EMc5LPgVaded4Qc77vm0fw: doesn't show hand
*** SUMMARY ***
Total pot $3 | Rake $0.10
Board [Js 6s Jc]
Seat 1: Do9Rlu1R5u/AcRtMTl8SYg (big blind) folded on the Flop
Seat 2: EMc5LPgVaded4Qc77vm0fw (button) (small blind) collected ($2.90)



PokerStars Game #59938745436:  Hold'em No Limit ($0.25/$0.50) - 2009/07/01 0:22:26 ET
Table '+dXkOAQyS8j9PQZusUTMpg' 2-max Seat #1 is the button
Seat 1: XFa6sBGjP2gxoIvxR3fZIg ($54.50 in chips)
Seat 2: 5IBeOgaApY1Bvzv2P8X4EA ($53.25 in chips)
XFa6sBGjP2gxoIvxR3fZIg: posts small blind $0.25
5IBeOgaApY1Bvzv2P8X4EA: posts big blind $0.50
*** HOLE CARDS ***
XFa6sBGjP2gxoIvxR3fZIg: raises $1 to $1.50
5IBeOgaApY1Bvzv2P8X4EA: folds
XFa6sBGjP2gxoIvxR3fZIg collected $1 from pot
*** SUMMARY ***
Total pot $1 | Rake $0
Seat 1: XFa6sBGjP2gxoIvxR3fZIg (button) (small blind) collected ($1)
Seat 2: 5IBeOgaApY1Bvzv2P8X4EA (big blind) folded before Flop



PokerStars Game #59938745934:  Hold'em No Limit ($0.25/$0.50) - 2009/07/01 0:22:27 ET
Table 'c/CRn+68J3Y8KxD5g1ek2Q' 2-max Seat #1 is the button
Seat 1: 46qCyJ6evTkHo9al5sBMNA ($271.95 in chips)
Seat 2: BypVLsYQt3ePFm2xQL/dOA ($109.80 in chips)
46qCyJ6evTkHo9al5sBMNA: posts small blind $0.25
BypVLsYQt3ePFm2xQL/dOA: posts big blind $0.50
*** HOLE CARDS ***
46qCyJ6evTkHo9al5sBMNA: folds
BypVLsYQt3ePFm2xQL/dOA collected $0.50 from pot
BypVLsYQt3ePFm2xQL/dOA: doesn't show hand
*** SUMMARY ***
Total pot $0.50 | Rake $0
Seat 1: 46qCyJ6evTkHo9al5sBMNA (button) (small blind) folded before Flop
Seat 2: BypVLsYQt3ePFm2xQL/dOA (big blind) collected ($0.50)



PokerStars Game #59938746014:  Hold'em No Limit ($0.25/$0.50) - 2009/07/01 0:22:27 ET
Table 'raOT4/ipuZgzjfKHC+jD9g' 2-max Seat #2 is the button
Seat 1: IuwLemwLhc9fvrwBGs0AMA ($10.95 in chips)
Seat 2: Udr5juWSWUgTu1NlRhjMdA ($11.15 in chips)
Udr5juWSWUgTu1NlRhjMdA: posts small blind $0.25
IuwLemwLhc9fvrwBGs0AMA: posts big blind $0.50
*** HOLE CARDS ***
Udr5juWSWUgTu1NlRhjMdA: folds
IuwLemwLhc9fvrwBGs0AMA collected $0.50 from pot
*** SUMMARY ***
Total pot $0.50 | Rake $0
Seat 1: IuwLemwLhc9fvrwBGs0AMA (big blind) collected ($0.50)
Seat 2: Udr5juWSWUgTu1NlRhjMdA (button) (small blind) folded before Flop



PokerStars Game #59938747290:  Hold'em No Limit ($0.25/$0.50) - 2009/07/01 0:22:29 ET
Table 'E7bWJ45aoFXRpyRv2gw+Ig' 2-max Seat #1 is the button
Seat 1: FRkiRasEGlHUeLrEl+k/nA ($67.95 in chips)
Seat 2: 3Wro85I7472vJ4Wkpneo9A ($111 in chips)
FRkiRasEGlHUeLrEl+k/nA: posts small blind $0.25
3Wro85I7472vJ4Wkpneo9A: posts big blind $0.50
*** HOLE CARDS ***
FRkiRasEGlHUeLrEl+k/nA: folds
3Wro85I7472vJ4Wkpneo9A collected $0.50 from pot
3Wro85I7472vJ4Wkpneo9A: doesn't show hand
*** SUMMARY ***
Total pot $0.50 | Rake $0
Seat 1: FRkiRasEGlHUeLrEl+k/nA (button) (small blind) folded before Flop
Seat 2: 3Wro85I7472vJ4Wkpneo9A (big blind) collected ($0.50)



PokerStars Game #59938747952:  Hold'em No Limit ($0.25/$0.50) - 2009/07/01 0:22:30 ET
Table 'GfL/No5u5PoEnU39lP5pQg' 6-max Seat #2 is the button
Seat 1: 1WUCqNG+p+vfWRTXNu4ljw ($50 in chips)
Seat 2: uVwggSetzp7d+eVgowO3vg ($47.25 in chips)
Seat 3: qNezhXOOUXqwG7b9X5XJAA ($50 in chips)
Seat 5: crjGpJEzSZgD38FoE3VMGg ($52.05 in chips)
Seat 6: 3wylWYGeXFXcrE4XVrlPng ($81.20 in chips)
qNezhXOOUXqwG7b9X5XJAA: posts small blind $0.25
crjGpJEzSZgD38FoE3VMGg: posts big blind $0.50
*** HOLE CARDS ***
3wylWYGeXFXcrE4XVrlPng: folds
1WUCqNG+p+vfWRTXNu4ljw: folds
yqM0AD7MZQd/cEtKdDQY1A leaves the table
uVwggSetzp7d+eVgowO3vg: calls $0.50
qNezhXOOUXqwG7b9X5XJAA: folds
crjGpJEzSZgD38FoE3VMGg: checks
*** FLOP *** [7c Ad 4h]
crjGpJEzSZgD38FoE3VMGg: checks
uVwggSetzp7d+eVgowO3vg: checks
*** TURN *** [7c Ad 4h] [Ac]
crjGpJEzSZgD38FoE3VMGg: bets $1
uVwggSetzp7d+eVgowO3vg: calls $1
*** RIVER *** [7c Ad 4h Ac] [4c]
OZ6OtYh5Y53MCH/p0QTn5g joins the table at seat #4
crjGpJEzSZgD38FoE3VMGg: bets $1
uVwggSetzp7d+eVgowO3vg: calls $1
*** SHOW DOWN ***
crjGpJEzSZgD38FoE3VMGg: shows [4s Qc] (a full house, Fours full of Aces)
uVwggSetzp7d+eVgowO3vg: mucks hand
crjGpJEzSZgD38FoE3VMGg collected $5 from pot
*** SUMMARY ***
Total pot $5.25 | Rake $0.25
Board [7c Ad 4h Ac 4c]
Seat 1: 1WUCqNG+p+vfWRTXNu4ljw folded before Flop (didn't bet)
Seat 2: uVwggSetzp7d+eVgowO3vg (button) mucked
Seat 3: qNezhXOOUXqwG7b9X5XJAA (small blind) folded before Flop
Seat 5: crjGpJEzSZgD38FoE3VMGg (big blind) showed [4s Qc] and won ($5) with a full house, Fours full of Aces
Seat 6: 3wylWYGeXFXcrE4XVrlPng folded before Flop (didn't bet)



PokerStars Game #59938749456:  Hold'em No Limit ($0.25/$0.50) - 2009/07/01 0:22:32 ET
Table 'ZYwMb9E6tY50Qm+iNbXRYw' 2-max Seat #1 is the button
Seat 1: DXLfRb8KDZWmrztw2bwtFw ($11.35 in chips)
Seat 2: 16tvT7AYgZ2LgiGFcvFKQg ($20.60 in chips)
DXLfRb8KDZWmrztw2bwtFw: posts small blind $0.25
16tvT7AYgZ2LgiGFcvFKQg: posts big blind $0.50
*** HOLE CARDS ***
DXLfRb8KDZWmrztw2bwtFw: raises $1.50 to $2
16tvT7AYgZ2LgiGFcvFKQg: calls $1.50
*** FLOP *** [4d Qs As]
16tvT7AYgZ2LgiGFcvFKQg: checks
DXLfRb8KDZWmrztw2bwtFw: bets $3
16tvT7AYgZ2LgiGFcvFKQg: folds
DXLfRb8KDZWmrztw2bwtFw collected $3.80 from pot
DXLfRb8KDZWmrztw2bwtFw: doesn't show hand
*** SUMMARY ***
Total pot $4 | Rake $0.20
Board [4d Qs As]
Seat 1: DXLfRb8KDZWmrztw2bwtFw (button) (small blind) collected ($3.80)
Seat 2: 16tvT7AYgZ2LgiGFcvFKQg (big blind) folded on the Flop



PokerStars Game #59938749074:  Hold'em No Limit ($0.25/$0.50) - 2009/07/01 0:22:32 ET
Table 'ibNfFy0bCzuBaUORla0aGw' 9-max Seat #3 is the button
Seat 2: 90Wb75h3W1BRpbqVnuk8gw ($56.80 in chips)
Seat 3: dDaHs3X8+fe3bIkRU0cbrw ($40.90 in chips)
Seat 4: YBN054X4blmis+B2bBlC0g ($17.55 in chips)
Seat 5: FRv75HO8CUsRZ1byEz06mQ ($9.10 in chips)
Seat 6: BmYrv3ec2k5d6pQq6iNaZw ($67.85 in chips)
Seat 8: xUrN9TWLq4m5V+OXY7KUUA ($50 in chips)
Seat 9: WpvT3OUSiZlpvs+mPXFqtQ ($10.25 in chips)
YBN054X4blmis+B2bBlC0g: posts small blind $0.25
FRv75HO8CUsRZ1byEz06mQ: posts big blind $0.50
HZkVla4kK2SI42CVrPZ/ig: sits out
*** HOLE CARDS ***
BmYrv3ec2k5d6pQq6iNaZw: calls $0.50
xUrN9TWLq4m5V+OXY7KUUA: folds
WpvT3OUSiZlpvs+mPXFqtQ: folds
90Wb75h3W1BRpbqVnuk8gw: raises $2 to $2.50
dDaHs3X8+fe3bIkRU0cbrw: folds
YBN054X4blmis+B2bBlC0g: folds
FRv75HO8CUsRZ1byEz06mQ: folds
BmYrv3ec2k5d6pQq6iNaZw: folds
90Wb75h3W1BRpbqVnuk8gw collected $1.75 from pot
*** SUMMARY ***
Total pot $1.75 | Rake $0
Seat 2: 90Wb75h3W1BRpbqVnuk8gw collected ($1.75)
Seat 3: dDaHs3X8+fe3bIkRU0cbrw (button) folded before Flop (didn't bet)
Seat 4: YBN054X4blmis+B2bBlC0g (small blind) folded before Flop
Seat 5: FRv75HO8CUsRZ1byEz06mQ (big blind) folded before Flop
Seat 6: BmYrv3ec2k5d6pQq6iNaZw folded before Flop
Seat 8: xUrN9TWLq4m5V+OXY7KUUA folded before Flop (didn't bet)
Seat 9: WpvT3OUSiZlpvs+mPXFqtQ folded before Flop (didn't bet)



PokerStars Game #59938750028:  Hold'em No Limit ($0.25/$0.50) - 2009/07/01 0:22:33 ET
Table 'PALRfuH85dr5IkDfdv6new' 9-max Seat #9 is the button
Seat 1: SKnJuWHScqetA/qG5p+wCg ($31.75 in chips)
Seat 2: 9r7ZoBbAJj5IeyZ0q9BdzA ($7.15 in chips)
Seat 3: 50QWoELmpmHFrFIlWMJo9g ($88.20 in chips)
Seat 4: UqQTn9qxH/IQXP1PWD7Gwg ($33.45 in chips)
Seat 5: jSSGUXdNFAZA3QCvTcUMQw ($39.45 in chips)
Seat 6: EiWj2MAl8RNcPhTkzz24Mw ($36.95 in chips)
Seat 7: 3NcyXvr39gnK+KbTq7ezyA ($39.85 in chips)
Seat 8: NkS+CseUKx4XHszWq0PXEQ ($47.15 in chips)
Seat 9: CIrAX/m6o7jYmKOAjJXv4Q ($35.45 in chips)
SKnJuWHScqetA/qG5p+wCg: posts small blind $0.25
9r7ZoBbAJj5IeyZ0q9BdzA: posts big blind $0.50
*** HOLE CARDS ***
50QWoELmpmHFrFIlWMJo9g: folds
UqQTn9qxH/IQXP1PWD7Gwg: folds
jSSGUXdNFAZA3QCvTcUMQw: folds
EiWj2MAl8RNcPhTkzz24Mw: folds
3NcyXvr39gnK+KbTq7ezyA: calls $0.50
NkS+CseUKx4XHszWq0PXEQ: folds
CIrAX/m6o7jYmKOAjJXv4Q: calls $0.50
SKnJuWHScqetA/qG5p+wCg: calls $0.25
9r7ZoBbAJj5IeyZ0q9BdzA: checks
*** FLOP *** [Tc Qh Ah]
SKnJuWHScqetA/qG5p+wCg: checks
9r7ZoBbAJj5IeyZ0q9BdzA: bets $1
3NcyXvr39gnK+KbTq7ezyA: folds
CIrAX/m6o7jYmKOAjJXv4Q: calls $1
SKnJuWHScqetA/qG5p+wCg: folds
*** TURN *** [Tc Qh Ah] [3s]
9r7ZoBbAJj5IeyZ0q9BdzA: bets $1.50
CIrAX/m6o7jYmKOAjJXv4Q: calls $1.50
*** RIVER *** [Tc Qh Ah 3s] [Ac]
9r7ZoBbAJj5IeyZ0q9BdzA: bets $4.15 and is all-in
CIrAX/m6o7jYmKOAjJXv4Q: folds
9r7ZoBbAJj5IeyZ0q9BdzA collected $6.70 from pot
*** SUMMARY ***
Total pot $7 | Rake $0.30
Board [Tc Qh Ah 3s Ac]
Seat 1: SKnJuWHScqetA/qG5p+wCg (small blind) folded on the Flop
Seat 2: 9r7ZoBbAJj5IeyZ0q9BdzA (big blind) collected ($6.70)
Seat 3: 50QWoELmpmHFrFIlWMJo9g folded before Flop (didn't bet)
Seat 4: UqQTn9qxH/IQXP1PWD7Gwg folded before Flop (didn't bet)
Seat 5: jSSGUXdNFAZA3QCvTcUMQw folded before Flop (didn't bet)
Seat 6: EiWj2MAl8RNcPhTkzz24Mw folded before Flop (didn't bet)
Seat 7: 3NcyXvr39gnK+KbTq7ezyA folded on the Flop
Seat 8: NkS+CseUKx4XHszWq0PXEQ folded before Flop (didn't bet)
Seat 9: CIrAX/m6o7jYmKOAjJXv4Q (button) folded on the River



PokerStars Game #59938750714:  Hold'em No Limit ($0.25/$0.50) - 2009/07/01 0:22:34 ET
Table 'c/CRn+68J3Y8KxD5g1ek2Q' 2-max Seat #2 is the button
Seat 1: 46qCyJ6evTkHo9al5sBMNA ($271.70 in chips)
Seat 2: BypVLsYQt3ePFm2xQL/dOA ($110.05 in chips)
BypVLsYQt3ePFm2xQL/dOA: posts small blind $0.25
46qCyJ6evTkHo9al5sBMNA: posts big blind $0.50
*** HOLE CARDS ***
BypVLsYQt3ePFm2xQL/dOA: raises $1 to $1.50
46qCyJ6evTkHo9al5sBMNA: calls $1
*** FLOP *** [Js 7d Ks]
46qCyJ6evTkHo9al5sBMNA: checks
BypVLsYQt3ePFm2xQL/dOA: bets $2.50
46qCyJ6evTkHo9al5sBMNA: folds
BypVLsYQt3ePFm2xQL/dOA collected $2.85 from pot
BypVLsYQt3ePFm2xQL/dOA: doesn't show hand
*** SUMMARY ***
Total pot $3 | Rake $0.15
Board [Js 7d Ks]
Seat 1: 46qCyJ6evTkHo9al5sBMNA (big blind) folded on the Flop
Seat 2: BypVLsYQt3ePFm2xQL/dOA (button) (small blind) collected ($2.85)



PokerStars Game #59938750710:  Hold'em No Limit ($0.25/$0.50) - 2009/07/01 0:22:34 ET
Table '+dXkOAQyS8j9PQZusUTMpg' 2-max Seat #2 is the button
Seat 1: XFa6sBGjP2gxoIvxR3fZIg ($55 in chips)
Seat 2: 5IBeOgaApY1Bvzv2P8X4EA ($52.75 in chips)
5IBeOgaApY1Bvzv2P8X4EA: posts small blind $0.25
XFa6sBGjP2gxoIvxR3fZIg: posts big blind $0.50
*** HOLE CARDS ***
5IBeOgaApY1Bvzv2P8X4EA: folds
XFa6sBGjP2gxoIvxR3fZIg collected $0.50 from pot
XFa6sBGjP2gxoIvxR3fZIg: doesn't show hand
*** SUMMARY ***
Total pot $0.50 | Rake $0
Seat 1: XFa6sBGjP2gxoIvxR3fZIg (big blind) collected ($0.50)
Seat 2: 5IBeOgaApY1Bvzv2P8X4EA (button) (small blind) folded before Flop



PokerStars Game #59938750422:  Hold'em No Limit ($0.25/$0.50) - 2009/07/01 0:22:34 ET
Table 'raOT4/ipuZgzjfKHC+jD9g' 2-max Seat #1 is the button
Seat 1: IuwLemwLhc9fvrwBGs0AMA ($11.20 in chips)
Seat 2: Udr5juWSWUgTu1NlRhjMdA ($10.90 in chips)
IuwLemwLhc9fvrwBGs0AMA: posts small blind $0.25
Udr5juWSWUgTu1NlRhjMdA: posts big blind $0.50
*** HOLE CARDS ***
IuwLemwLhc9fvrwBGs0AMA: folds
Udr5juWSWUgTu1NlRhjMdA collected $0.50 from pot
Udr5juWSWUgTu1NlRhjMdA: doesn't show hand
*** SUMMARY ***
Total pot $0.50 | Rake $0
Seat 1: IuwLemwLhc9fvrwBGs0AMA (button) (small blind) folded before Flop
Seat 2: Udr5juWSWUgTu1NlRhjMdA (big blind) collected ($0.50)



PokerStars Game #59938751270:  Hold'em No Limit ($0.25/$0.50) - 2009/07/01 0:22:35 ET
Table 'E7bWJ45aoFXRpyRv2gw+Ig' 2-max Seat #2 is the button
Seat 1: FRkiRasEGlHUeLrEl+k/nA ($67.70 in chips)
Seat 2: 3Wro85I7472vJ4Wkpneo9A ($111.25 in chips)
3Wro85I7472vJ4Wkpneo9A: posts small blind $0.25
FRkiRasEGlHUeLrEl+k/nA: posts big blind $0.50
*** HOLE CARDS ***
3Wro85I7472vJ4Wkpneo9A: folds
FRkiRasEGlHUeLrEl+k/nA collected $0.50 from pot
FRkiRasEGlHUeLrEl+k/nA: doesn't show hand
*** SUMMARY ***
Total pot $0.50 | Rake $0
Seat 1: FRkiRasEGlHUeLrEl+k/nA (big blind) collected ($0.50)
Seat 2: 3Wro85I7472vJ4Wkpneo9A (button) (small blind) folded before Flop



PokerStars Game #59938751666:  Hold'em No Limit ($0.25/$0.50) - 2009/07/01 0:22:36 ET
Table '0AhP5FLi4ySROVJ/ycT1Qw' 2-max Seat #1 is the button
Seat 1: 38ZztDUK6IU5WCK+BN74Rw ($91.25 in chips)
Seat 2: 46qCyJ6evTkHo9al5sBMNA ($88.35 in chips)
38ZztDUK6IU5WCK+BN74Rw: posts small blind $0.25
46qCyJ6evTkHo9al5sBMNA: posts big blind $0.50
*** HOLE CARDS ***
38ZztDUK6IU5WCK+BN74Rw: folds
46qCyJ6evTkHo9al5sBMNA collected $0.50 from pot
46qCyJ6evTkHo9al5sBMNA: doesn't show hand
*** SUMMARY ***
Total pot $0.50 | Rake $0
Seat 1: 38ZztDUK6IU5WCK+BN74Rw (button) (small blind) folded before Flop
Seat 2: 46qCyJ6evTkHo9al5sBMNA (big blind) collected ($0.50)



PokerStars Game #59938752848:  Hold'em No Limit ($0.25/$0.50) - 2009/07/01 0:22:37 ET
Table '+z1aekfHkpp09pc8F9aViw' 6-max Seat #1 is the button
Seat 1: wOyVV9M/oyiw3YaOjNZ05w ($50 in chips)
Seat 2: M6xK/VklCvdyyrmvzATlxQ ($30.20 in chips)
Seat 3: uUznlIMFnRUvwrBhYF73KA ($63.25 in chips)
Seat 4: RowCSpSURHTOL/dcjg/Iug ($50.70 in chips)
Seat 5: crjGpJEzSZgD38FoE3VMGg ($59.15 in chips)
Seat 6: 686aeHikcJlgKkSuIFdcXQ ($70.10 in chips)
M6xK/VklCvdyyrmvzATlxQ: posts small blind $0.25
uUznlIMFnRUvwrBhYF73KA: posts big blind $0.50
*** HOLE CARDS ***
RowCSpSURHTOL/dcjg/Iug: folds
crjGpJEzSZgD38FoE3VMGg: folds
686aeHikcJlgKkSuIFdcXQ: folds
wOyVV9M/oyiw3YaOjNZ05w: raises $1 to $1.50
M6xK/VklCvdyyrmvzATlxQ: folds
uUznlIMFnRUvwrBhYF73KA: folds
wOyVV9M/oyiw3YaOjNZ05w collected $1.25 from pot
*** SUMMARY ***
Total pot $1.25 | Rake $0
Seat 1: wOyVV9M/oyiw3YaOjNZ05w (button) collected ($1.25)
Seat 2: M6xK/VklCvdyyrmvzATlxQ (small blind) folded before Flop
Seat 3: uUznlIMFnRUvwrBhYF73KA (big blind) folded before Flop
Seat 4: RowCSpSURHTOL/dcjg/Iug folded before Flop (didn't bet)
Seat 5: crjGpJEzSZgD38FoE3VMGg folded before Flop (didn't bet)
Seat 6: 686aeHikcJlgKkSuIFdcXQ folded before Flop (didn't bet)



PokerStars Game #59938753874:  Hold'em No Limit ($0.25/$0.50) - 2009/07/01 0:22:39 ET
Table '8YYaUJqyk4NgBvNkL7mj/Q' 2-max Seat #1 is the button
Seat 1: Fp/oksNpipCrD2MJ2pH20g ($9 in chips)
Seat 2: dkC7J+qbyqk0qCcmJbEPPw ($50.90 in chips)
Fp/oksNpipCrD2MJ2pH20g: posts small blind $0.25
dkC7J+qbyqk0qCcmJbEPPw: posts big blind $0.50
*** HOLE CARDS ***
Fp/oksNpipCrD2MJ2pH20g: raises $1 to $1.50
dkC7J+qbyqk0qCcmJbEPPw: folds
Fp/oksNpipCrD2MJ2pH20g collected $1 from pot
Fp/oksNpipCrD2MJ2pH20g: doesn't show hand
*** SUMMARY ***
Total pot $1 | Rake $0
Seat 1: Fp/oksNpipCrD2MJ2pH20g (button) (small blind) collected ($1)
Seat 2: dkC7J+qbyqk0qCcmJbEPPw (big blind) folded before Flop



PokerStars Game #59938754682:  Hold'em No Limit ($0.25/$0.50) - 2009/07/01 0:22:40 ET
Table '+dXkOAQyS8j9PQZusUTMpg' 2-max Seat #1 is the button
Seat 1: XFa6sBGjP2gxoIvxR3fZIg ($55.25 in chips)
Seat 2: 5IBeOgaApY1Bvzv2P8X4EA ($52.50 in chips)
XFa6sBGjP2gxoIvxR3fZIg: posts small blind $0.25
5IBeOgaApY1Bvzv2P8X4EA: posts big blind $0.50
*** HOLE CARDS ***
XFa6sBGjP2gxoIvxR3fZIg: raises $1 to $1.50
5IBeOgaApY1Bvzv2P8X4EA: folds
XFa6sBGjP2gxoIvxR3fZIg collected $1 from pot
*** SUMMARY ***
Total pot $1 | Rake $0
Seat 1: XFa6sBGjP2gxoIvxR3fZIg (button) (small blind) collected ($1)
Seat 2: 5IBeOgaApY1Bvzv2P8X4EA (big blind) folded before Flop



PokerStars Game #59938755206:  Hold'em No Limit ($0.25/$0.50) - 2009/07/01 0:22:41 ET
Table 'E7bWJ45aoFXRpyRv2gw+Ig' 2-max Seat #1 is the button
Seat 1: FRkiRasEGlHUeLrEl+k/nA ($67.95 in chips)
Seat 2: 3Wro85I7472vJ4Wkpneo9A ($111 in chips)
FRkiRasEGlHUeLrEl+k/nA: posts small blind $0.25
3Wro85I7472vJ4Wkpneo9A: posts big blind $0.50
*** HOLE CARDS ***
FRkiRasEGlHUeLrEl+k/nA: folds
3Wro85I7472vJ4Wkpneo9A collected $0.50 from pot
3Wro85I7472vJ4Wkpneo9A: doesn't show hand
*** SUMMARY ***
Total pot $0.50 | Rake $0
Seat 1: FRkiRasEGlHUeLrEl+k/nA (button) (small blind) folded before Flop
Seat 2: 3Wro85I7472vJ4Wkpneo9A (big blind) collected ($0.50)



PokerStars Game #59938755044:  Hold'em No Limit ($0.25/$0.50) - 2009/07/01 0:22:41 ET
Table 'Nz0Vr7WMHL2g5Uk7dDZjpw' 9-max Seat #2 is the button
Seat 2: XNMDwbXt/Q4jM99AXnbJDw ($50 in chips)
Seat 3: 4QTiNH5fteLgJjx/s6Hy6A ($20.50 in chips)
Seat 4: 5JJVDlaiMnB004o/RqbZZQ ($27.50 in chips)
Seat 5: WGW0DgjBUXs1ylURHG8vnQ ($11.10 in chips)
Seat 6: k1f0lS7tlMHCLGs0JT34Tg ($9.25 in chips)
Seat 7: KPLH0gELgFe2OuAnhJFI5w ($19.70 in chips)
Seat 8: HkZI6g4zl83TDTA7SRspmQ ($20.95 in chips)
Seat 9: Ak2W6V2TDVIQrvSAy4eD7Q ($25.35 in chips)
4QTiNH5fteLgJjx/s6Hy6A: posts small blind $0.25
5JJVDlaiMnB004o/RqbZZQ: posts big blind $0.50
*** HOLE CARDS ***
WGW0DgjBUXs1ylURHG8vnQ: folds
k1f0lS7tlMHCLGs0JT34Tg: calls $0.50
KPLH0gELgFe2OuAnhJFI5w: folds
HkZI6g4zl83TDTA7SRspmQ: folds
Ak2W6V2TDVIQrvSAy4eD7Q: folds
XNMDwbXt/Q4jM99AXnbJDw: folds
4QTiNH5fteLgJjx/s6Hy6A: calls $0.25
5JJVDlaiMnB004o/RqbZZQ: checks
*** FLOP *** [Ac 4s 7s]
4QTiNH5fteLgJjx/s6Hy6A: checks
5JJVDlaiMnB004o/RqbZZQ: checks
k1f0lS7tlMHCLGs0JT34Tg: checks
*** TURN *** [Ac 4s 7s] [2s]
tLkxo7JgV+WWI0UBw44K5A has returned
4QTiNH5fteLgJjx/s6Hy6A: bets $1
5JJVDlaiMnB004o/RqbZZQ: folds
k1f0lS7tlMHCLGs0JT34Tg: folds
4QTiNH5fteLgJjx/s6Hy6A collected $1.45 from pot
*** SUMMARY ***
Total pot $1.50 | Rake $0.05
Board [Ac 4s 7s 2s]
Seat 2: XNMDwbXt/Q4jM99AXnbJDw (button) folded before Flop (didn't bet)
Seat 3: 4QTiNH5fteLgJjx/s6Hy6A (small blind) collected ($1.45)
Seat 4: 5JJVDlaiMnB004o/RqbZZQ (big blind) folded on the Turn
Seat 5: WGW0DgjBUXs1ylURHG8vnQ folded before Flop (didn't bet)
Seat 6: k1f0lS7tlMHCLGs0JT34Tg folded on the Turn
Seat 7: KPLH0gELgFe2OuAnhJFI5w folded before Flop (didn't bet)
Seat 8: HkZI6g4zl83TDTA7SRspmQ folded before Flop (didn't bet)
Seat 9: Ak2W6V2TDVIQrvSAy4eD7Q folded before Flop (didn't bet)



PokerStars Game #59938754950:  Hold'em No Limit ($0.25/$0.50) - 2009/07/01 0:22:41 ET
Table '5EmHi+fnatGQQShcNmzOZQ' 6-max Seat #6 is the button
Seat 1: SwPczQo3cOtwEzhJrfO2cQ ($23.40 in chips)
Seat 3: L9qfLYXrczhAPd/VckgsWw ($63.60 in chips)
Seat 4: wOyVV9M/oyiw3YaOjNZ05w ($50.75 in chips)
Seat 5: kxPhs4ePFqMy52CInAJ2aw ($48.50 in chips)
Seat 6: 686aeHikcJlgKkSuIFdcXQ ($156.60 in chips)
SwPczQo3cOtwEzhJrfO2cQ: posts small blind $0.25
L9qfLYXrczhAPd/VckgsWw: posts big blind $0.50
*** HOLE CARDS ***
wOyVV9M/oyiw3YaOjNZ05w: folds
kxPhs4ePFqMy52CInAJ2aw: raises $1.50 to $2
686aeHikcJlgKkSuIFdcXQ: folds
SwPczQo3cOtwEzhJrfO2cQ: folds
L9qfLYXrczhAPd/VckgsWw: folds
kxPhs4ePFqMy52CInAJ2aw collected $1.25 from pot
kxPhs4ePFqMy52CInAJ2aw: doesn't show hand
*** SUMMARY ***
Total pot $1.25 | Rake $0
Seat 1: SwPczQo3cOtwEzhJrfO2cQ (small blind) folded before Flop
Seat 3: L9qfLYXrczhAPd/VckgsWw (big blind) folded before Flop
Seat 4: wOyVV9M/oyiw3YaOjNZ05w folded before Flop (didn't bet)
Seat 5: kxPhs4ePFqMy52CInAJ2aw collected ($1.25)
Seat 6: 686aeHikcJlgKkSuIFdcXQ (button) folded before Flop (didn't bet)



PokerStars Game #59938755234:  Hold'em No Limit ($0.25/$0.50) - 2009/07/01 0:22:41 ET
Table 'MJxeZCzYELxiIsyUZyT0jw' 6-max Seat #6 is the button
Seat 2: r6H1GiZ6QIpMTDhyodKuRQ ($63.40 in chips)
Seat 3: JQZew0FjzS19kTjeNtrE+A ($53.45 in chips)
Seat 4: lP7Q6pewz4C2RsAfKsjdWw ($32.95 in chips)
Seat 5: 3jvoOXNtXE90w2BdfNZwZQ ($50.75 in chips)
Seat 6: TTx3CHxyi0SObcHyMJRp5w ($49.75 in chips)
wOyVV9M/oyiw3YaOjNZ05w will be allowed to play after the button
r6H1GiZ6QIpMTDhyodKuRQ: posts small blind $0.25
JQZew0FjzS19kTjeNtrE+A: posts big blind $0.50
*** HOLE CARDS ***
lP7Q6pewz4C2RsAfKsjdWw: calls $0.50
3jvoOXNtXE90w2BdfNZwZQ: folds
TTx3CHxyi0SObcHyMJRp5w: folds
r6H1GiZ6QIpMTDhyodKuRQ: folds
JQZew0FjzS19kTjeNtrE+A: checks
*** FLOP *** [Js 4c Ah]
JQZew0FjzS19kTjeNtrE+A: checks
lP7Q6pewz4C2RsAfKsjdWw: bets $0.50
JQZew0FjzS19kTjeNtrE+A: calls $0.50
*** TURN *** [Js 4c Ah] [8s]
JQZew0FjzS19kTjeNtrE+A: checks
lP7Q6pewz4C2RsAfKsjdWw: checks
*** RIVER *** [Js 4c Ah 8s] [7d]
JQZew0FjzS19kTjeNtrE+A: bets $1.50
lP7Q6pewz4C2RsAfKsjdWw: folds
r6H1GiZ6QIpMTDhyodKuRQ leaves the table
JQZew0FjzS19kTjeNtrE+A collected $2.15 from pot
*** SUMMARY ***
Total pot $2.25 | Rake $0.10
Board [Js 4c Ah 8s 7d]
Seat 2: r6H1GiZ6QIpMTDhyodKuRQ (small blind) folded before Flop
Seat 3: JQZew0FjzS19kTjeNtrE+A (big blind) collected ($2.15)
Seat 4: lP7Q6pewz4C2RsAfKsjdWw folded on the River
Seat 5: 3jvoOXNtXE90w2BdfNZwZQ folded before Flop (didn't bet)
Seat 6: TTx3CHxyi0SObcHyMJRp5w (button) folded before Flop (didn't bet)



PokerStars Game #59938756166:  Hold'em No Limit ($0.25/$0.50) - 2009/07/01 0:22:42 ET
Table '0AhP5FLi4ySROVJ/ycT1Qw' 2-max Seat #2 is the button
Seat 1: 38ZztDUK6IU5WCK+BN74Rw ($91 in chips)
Seat 2: 46qCyJ6evTkHo9al5sBMNA ($88.60 in chips)
46qCyJ6evTkHo9al5sBMNA: posts small blind $0.25
38ZztDUK6IU5WCK+BN74Rw: posts big blind $0.50
*** HOLE CARDS ***
46qCyJ6evTkHo9al5sBMNA: folds
38ZztDUK6IU5WCK+BN74Rw collected $0.50 from pot
38ZztDUK6IU5WCK+BN74Rw: doesn't show hand
*** SUMMARY ***
Total pot $0.50 | Rake $0
Seat 1: 38ZztDUK6IU5WCK+BN74Rw (big blind) collected ($0.50)
Seat 2: 46qCyJ6evTkHo9al5sBMNA (button) (small blind) folded before Flop



PokerStars Game #59938756090:  Hold'em No Limit ($0.25/$0.50) - 2009/07/01 0:22:42 ET
Table 'raOT4/ipuZgzjfKHC+jD9g' 2-max Seat #2 is the button
Seat 1: IuwLemwLhc9fvrwBGs0AMA ($10.95 in chips)
Seat 2: Udr5juWSWUgTu1NlRhjMdA ($11.15 in chips)
Udr5juWSWUgTu1NlRhjMdA: posts small blind $0.25
IuwLemwLhc9fvrwBGs0AMA: posts big blind $0.50
*** HOLE CARDS ***
Udr5juWSWUgTu1NlRhjMdA: folds
IuwLemwLhc9fvrwBGs0AMA collected $0.50 from pot
*** SUMMARY ***
Total pot $0.50 | Rake $0
Seat 1: IuwLemwLhc9fvrwBGs0AMA (big blind) collected ($0.50)
Seat 2: Udr5juWSWUgTu1NlRhjMdA (button) (small blind) folded before Flop



PokerStars Game #59938756876:  Hold'em No Limit ($0.25/$0.50) - 2009/07/01 0:22:43 ET
Table 'dVmkPtk5nWTfXApFsnhIOg' 2-max Seat #1 is the button
Seat 1: bypIyrYcAAifLfhZpGlKLA ($50 in chips)
Seat 2: rPToQDbLWB+dKnz7fcQSIg ($31.40 in chips)
bypIyrYcAAifLfhZpGlKLA: posts small blind $0.25
rPToQDbLWB+dKnz7fcQSIg: posts big blind $0.50
*** HOLE CARDS ***
bypIyrYcAAifLfhZpGlKLA: raises $1 to $1.50
rPToQDbLWB+dKnz7fcQSIg: folds
bypIyrYcAAifLfhZpGlKLA collected $1 from pot
bypIyrYcAAifLfhZpGlKLA: doesn't show hand
*** SUMMARY ***
Total pot $1 | Rake $0
Seat 1: bypIyrYcAAifLfhZpGlKLA (button) (small blind) collected ($1)
Seat 2: rPToQDbLWB+dKnz7fcQSIg (big blind) folded before Flop



PokerStars Game #59938757532:  Hold'em No Limit ($0.25/$0.50) - 2009/07/01 0:22:44 ET
Table 'mTxf8gPLgffN3Iwfm7Icfg' 2-max Seat #1 is the button
Seat 1: Do9Rlu1R5u/AcRtMTl8SYg ($74.80 in chips)
Seat 2: EMc5LPgVaded4Qc77vm0fw ($86.40 in chips)
Do9Rlu1R5u/AcRtMTl8SYg: posts small blind $0.25
EMc5LPgVaded4Qc77vm0fw: posts big blind $0.50
*** HOLE CARDS ***
Do9Rlu1R5u/AcRtMTl8SYg: raises $1 to $1.50
EMc5LPgVaded4Qc77vm0fw: folds
Do9Rlu1R5u/AcRtMTl8SYg collected $1 from pot
Do9Rlu1R5u/AcRtMTl8SYg: doesn't show hand
*** SUMMARY ***
Total pot $1 | Rake $0
Seat 1: Do9Rlu1R5u/AcRtMTl8SYg (button) (small blind) collected ($1)
Seat 2: EMc5LPgVaded4Qc77vm0fw (big blind) folded before Flop



PokerStars Game #59938759566:  Hold'em No Limit ($0.25/$0.50) - 2009/07/01 0:22:47 ET
Table 'ZYwMb9E6tY50Qm+iNbXRYw' 2-max Seat #2 is the button
Seat 1: DXLfRb8KDZWmrztw2bwtFw ($13.15 in chips)
Seat 2: 16tvT7AYgZ2LgiGFcvFKQg ($18.60 in chips)
16tvT7AYgZ2LgiGFcvFKQg: posts small blind $0.25
DXLfRb8KDZWmrztw2bwtFw: posts big blind $0.50
*** HOLE CARDS ***
16tvT7AYgZ2LgiGFcvFKQg: raises $0.50 to $1
DXLfRb8KDZWmrztw2bwtFw: calls $0.50
*** FLOP *** [5h Qc Jh]
DXLfRb8KDZWmrztw2bwtFw: checks
16tvT7AYgZ2LgiGFcvFKQg: checks
*** TURN *** [5h Qc Jh] [3s]
DXLfRb8KDZWmrztw2bwtFw: bets $1
16tvT7AYgZ2LgiGFcvFKQg: folds
DXLfRb8KDZWmrztw2bwtFw collected $1.90 from pot
DXLfRb8KDZWmrztw2bwtFw: doesn't show hand
*** SUMMARY ***
Total pot $2 | Rake $0.10
Board [5h Qc Jh 3s]
Seat 1: DXLfRb8KDZWmrztw2bwtFw (big blind) collected ($1.90)
Seat 2: 16tvT7AYgZ2LgiGFcvFKQg (button) (small blind) folded on the Turn



PokerStars Game #59938759020:  Hold'em No Limit ($0.25/$0.50) - 2009/07/01 0:22:47 ET
Table 'E7bWJ45aoFXRpyRv2gw+Ig' 2-max Seat #2 is the button
Seat 1: FRkiRasEGlHUeLrEl+k/nA ($67.70 in chips)
Seat 2: 3Wro85I7472vJ4Wkpneo9A ($111.25 in chips)
3Wro85I7472vJ4Wkpneo9A: posts small blind $0.25
FRkiRasEGlHUeLrEl+k/nA: posts big blind $0.50
*** HOLE CARDS ***
3Wro85I7472vJ4Wkpneo9A: raises $1 to $1.50
FRkiRasEGlHUeLrEl+k/nA: folds
3Wro85I7472vJ4Wkpneo9A collected $1 from pot
3Wro85I7472vJ4Wkpneo9A: doesn't show hand
*** SUMMARY ***
Total pot $1 | Rake $0
Seat 1: FRkiRasEGlHUeLrEl+k/nA (big blind) folded before Flop
Seat 2: 3Wro85I7472vJ4Wkpneo9A (button) (small blind) collected ($1)



PokerStars Game #59938760034:  Hold'em No Limit ($0.25/$0.50) - 2009/07/01 0:22:48 ET
Table '8YYaUJqyk4NgBvNkL7mj/Q' 2-max Seat #2 is the button
Seat 1: Fp/oksNpipCrD2MJ2pH20g ($9.50 in chips)
Seat 2: dkC7J+qbyqk0qCcmJbEPPw ($50.40 in chips)
dkC7J+qbyqk0qCcmJbEPPw: posts small blind $0.25
Fp/oksNpipCrD2MJ2pH20g: posts big blind $0.50
*** HOLE CARDS ***
dkC7J+qbyqk0qCcmJbEPPw: folds
Fp/oksNpipCrD2MJ2pH20g collected $0.50 from pot
Fp/oksNpipCrD2MJ2pH20g: doesn't show hand
*** SUMMARY ***
Total pot $0.50 | Rake $0
Seat 1: Fp/oksNpipCrD2MJ2pH20g (big blind) collected ($0.50)
Seat 2: dkC7J+qbyqk0qCcmJbEPPw (button) (small blind) folded before Flop



PokerStars Game #59938759778:  Hold'em No Limit ($0.25/$0.50) - 2009/07/01 0:22:48 ET
Table '+dXkOAQyS8j9PQZusUTMpg' 2-max Seat #2 is the button
Seat 1: XFa6sBGjP2gxoIvxR3fZIg ($55.75 in chips)
Seat 2: 5IBeOgaApY1Bvzv2P8X4EA ($52 in chips)
5IBeOgaApY1Bvzv2P8X4EA: posts small blind $0.25
XFa6sBGjP2gxoIvxR3fZIg: posts big blind $0.50
*** HOLE CARDS ***
5IBeOgaApY1Bvzv2P8X4EA: folds
XFa6sBGjP2gxoIvxR3fZIg collected $0.50 from pot
*** SUMMARY ***
Total pot $0.50 | Rake $0
Seat 1: XFa6sBGjP2gxoIvxR3fZIg (big blind) collected ($0.50)
Seat 2: 5IBeOgaApY1Bvzv2P8X4EA (button) (small blind) folded before Flop



PokerStars Game #59938760664:  Hold'em No Limit ($0.25/$0.50) - 2009/07/01 0:22:49 ET
Table '0AhP5FLi4ySROVJ/ycT1Qw' 2-max Seat #1 is the button
Seat 1: 38ZztDUK6IU5WCK+BN74Rw ($91.25 in chips)
Seat 2: 46qCyJ6evTkHo9al5sBMNA ($88.35 in chips)
38ZztDUK6IU5WCK+BN74Rw: posts small blind $0.25
46qCyJ6evTkHo9al5sBMNA: posts big blind $0.50
*** HOLE CARDS ***
38ZztDUK6IU5WCK+BN74Rw: raises $1 to $1.50
46qCyJ6evTkHo9al5sBMNA: folds
38ZztDUK6IU5WCK+BN74Rw collected $1 from pot
38ZztDUK6IU5WCK+BN74Rw: doesn't show hand
*** SUMMARY ***
Total pot $1 | Rake $0
Seat 1: 38ZztDUK6IU5WCK+BN74Rw (button) (small blind) collected ($1)
Seat 2: 46qCyJ6evTkHo9al5sBMNA (big blind) folded before Flop



PokerStars Game #59938760318:  Hold'em No Limit ($0.25/$0.50) - 2009/07/01 0:22:49 ET
Table 'raOT4/ipuZgzjfKHC+jD9g' 2-max Seat #1 is the button
Seat 1: IuwLemwLhc9fvrwBGs0AMA ($11.20 in chips)
Seat 2: Udr5juWSWUgTu1NlRhjMdA ($10.90 in chips)
IuwLemwLhc9fvrwBGs0AMA: posts small blind $0.25
Udr5juWSWUgTu1NlRhjMdA: posts big blind $0.50
*** HOLE CARDS ***
IuwLemwLhc9fvrwBGs0AMA: folds
Udr5juWSWUgTu1NlRhjMdA collected $0.50 from pot
Udr5juWSWUgTu1NlRhjMdA: doesn't show hand
*** SUMMARY ***
Total pot $0.50 | Rake $0
Seat 1: IuwLemwLhc9fvrwBGs0AMA (button) (small blind) folded before Flop
Seat 2: Udr5juWSWUgTu1NlRhjMdA (big blind) collected ($0.50)



PokerStars Game #59938761044:  Hold'em No Limit ($0.25/$0.50) - 2009/07/01 0:22:50 ET
Table 'NCiXr0d5CEKBQr/cZgLhbA' 9-max Seat #8 is the button
Seat 1: RjBdQ6w31rgcy0o24VLR6w ($9.50 in chips)
Seat 2: ulxuJchBV9iguXg0FUonfg ($40.05 in chips)
Seat 3: xZCXQSXlrZkp3pZizzVXCw ($55.65 in chips)
Seat 4: CL4d+tvzcd4utdQxlPLOmg ($31.05 in chips)
Seat 5: zE9cVigS2nW/Ljy4K4bUQA ($40.25 in chips)
Seat 6: SKnJuWHScqetA/qG5p+wCg ($30 in chips)
Seat 7: M+7+BTmX5vZatHVuoRB1nA ($49.25 in chips)
Seat 8: 1MJUKc3cc0QmUoz1JZLR2w ($54.35 in chips)
4WLZvqBn5qv5tds5kt5A1Q will be allowed to play after the button
RjBdQ6w31rgcy0o24VLR6w: posts small blind $0.25
ulxuJchBV9iguXg0FUonfg: posts big blind $0.50
*** HOLE CARDS ***
1MJUKc3cc0QmUoz1JZLR2w said, "thought JJ"
xZCXQSXlrZkp3pZizzVXCw: folds
CL4d+tvzcd4utdQxlPLOmg: folds
zE9cVigS2nW/Ljy4K4bUQA: folds
SKnJuWHScqetA/qG5p+wCg: folds
M+7+BTmX5vZatHVuoRB1nA: folds
1MJUKc3cc0QmUoz1JZLR2w: folds
RjBdQ6w31rgcy0o24VLR6w: folds
ulxuJchBV9iguXg0FUonfg collected $0.50 from pot
*** SUMMARY ***
Total pot $0.50 | Rake $0
Seat 1: RjBdQ6w31rgcy0o24VLR6w (small blind) folded before Flop
Seat 2: ulxuJchBV9iguXg0FUonfg (big blind) collected ($0.50)
Seat 3: xZCXQSXlrZkp3pZizzVXCw folded before Flop (didn't bet)
Seat 4: CL4d+tvzcd4utdQxlPLOmg folded before Flop (didn't bet)
Seat 5: zE9cVigS2nW/Ljy4K4bUQA folded before Flop (didn't bet)
Seat 6: SKnJuWHScqetA/qG5p+wCg folded before Flop (didn't bet)
Seat 7: M+7+BTmX5vZatHVuoRB1nA folded before Flop (didn't bet)
Seat 8: 1MJUKc3cc0QmUoz1JZLR2w (button) folded before Flop (didn't bet)



PokerStars Game #59938762128:  Hold'em No Limit ($0.25/$0.50) - 2009/07/01 0:22:51 ET
Table 'EiNh8p/wGJ1FP575iMFnqg' 9-max Seat #6 is the button
Seat 1: r3ZqM1Mi0W3y4hOdssE+Sg ($28.70 in chips)
Seat 2: sSAA879uXOGR+8Mf3zLa6Q ($9.95 in chips)
Seat 3: GszS/McxOSUnOET7MBoHqA ($50 in chips)
Seat 4: HIIPkpiaCQfs5HcPKjlHvg ($40.70 in chips)
Seat 5: M+7+BTmX5vZatHVuoRB1nA ($78.65 in chips)
Seat 6: 3UmXLy3GfjC3EkOebduerQ ($50 in chips)
Seat 7: Wj7mKnRFR90j40wWUu2+Og ($78.80 in chips)
Seat 8: KrPAGRACBg+w0M//SXe8Ag ($13 in chips)
Seat 9: OMwFJ4pF0xk2Ru/AJiFeFw ($70.65 in chips)
Wj7mKnRFR90j40wWUu2+Og: posts small blind $0.25
KrPAGRACBg+w0M//SXe8Ag: posts big blind $0.50
*** HOLE CARDS ***
OMwFJ4pF0xk2Ru/AJiFeFw: folds
r3ZqM1Mi0W3y4hOdssE+Sg: calls $0.50
sSAA879uXOGR+8Mf3zLa6Q: folds
GszS/McxOSUnOET7MBoHqA: calls $0.50
HIIPkpiaCQfs5HcPKjlHvg: folds
M+7+BTmX5vZatHVuoRB1nA: folds
3UmXLy3GfjC3EkOebduerQ: folds
Wj7mKnRFR90j40wWUu2+Og: calls $0.25
KrPAGRACBg+w0M//SXe8Ag: raises $0.50 to $1
r3ZqM1Mi0W3y4hOdssE+Sg: calls $0.50
GszS/McxOSUnOET7MBoHqA: calls $0.50
Wj7mKnRFR90j40wWUu2+Og: calls $0.50
*** FLOP *** [2h Qh 9d]
Wj7mKnRFR90j40wWUu2+Og: checks
KrPAGRACBg+w0M//SXe8Ag: checks
r3ZqM1Mi0W3y4hOdssE+Sg: checks
GszS/McxOSUnOET7MBoHqA: checks
*** TURN *** [2h Qh 9d] [2d]
Wj7mKnRFR90j40wWUu2+Og: checks
KrPAGRACBg+w0M//SXe8Ag: bets $1.50
r3ZqM1Mi0W3y4hOdssE+Sg: folds
GszS/McxOSUnOET7MBoHqA: folds
Wj7mKnRFR90j40wWUu2+Og: folds
KrPAGRACBg+w0M//SXe8Ag collected $3.80 from pot
KrPAGRACBg+w0M//SXe8Ag: doesn't show hand
*** SUMMARY ***
Total pot $4 | Rake $0.20
Board [2h Qh 9d 2d]
Seat 1: r3ZqM1Mi0W3y4hOdssE+Sg folded on the Turn
Seat 2: sSAA879uXOGR+8Mf3zLa6Q folded before Flop (didn't bet)
Seat 3: GszS/McxOSUnOET7MBoHqA folded on the Turn
Seat 4: HIIPkpiaCQfs5HcPKjlHvg folded before Flop (didn't bet)
Seat 5: M+7+BTmX5vZatHVuoRB1nA folded before Flop (didn't bet)
Seat 6: 3UmXLy3GfjC3EkOebduerQ (button) folded before Flop (didn't bet)
Seat 7: Wj7mKnRFR90j40wWUu2+Og (small blind) folded on the Turn
Seat 8: KrPAGRACBg+w0M//SXe8Ag (big blind) collected ($3.80)
Seat 9: OMwFJ4pF0xk2Ru/AJiFeFw folded before Flop (didn't bet)



PokerStars Game #59938763116:  Hold'em No Limit ($0.25/$0.50) - 2009/07/01 0:22:53 ET
Table 'mTxf8gPLgffN3Iwfm7Icfg' 2-max Seat #2 is the button
Seat 1: Do9Rlu1R5u/AcRtMTl8SYg ($75.30 in chips)
Seat 2: EMc5LPgVaded4Qc77vm0fw ($85.90 in chips)
EMc5LPgVaded4Qc77vm0fw: posts small blind $0.25
Do9Rlu1R5u/AcRtMTl8SYg: posts big blind $0.50
*** HOLE CARDS ***
EMc5LPgVaded4Qc77vm0fw: raises $1.50 to $2
Do9Rlu1R5u/AcRtMTl8SYg: folds
EMc5LPgVaded4Qc77vm0fw collected $1 from pot
EMc5LPgVaded4Qc77vm0fw: doesn't show hand
*** SUMMARY ***
Total pot $1 | Rake $0
Seat 1: Do9Rlu1R5u/AcRtMTl8SYg (big blind) folded before Flop
Seat 2: EMc5LPgVaded4Qc77vm0fw (button) (small blind) collected ($1)



PokerStars Game #59938764022:  Hold'em No Limit ($0.25/$0.50) - 2009/07/01 0:22:54 ET
Table '8YYaUJqyk4NgBvNkL7mj/Q' 2-max Seat #1 is the button
Seat 1: Fp/oksNpipCrD2MJ2pH20g ($9.75 in chips)
Seat 2: dkC7J+qbyqk0qCcmJbEPPw ($50.15 in chips)
Fp/oksNpipCrD2MJ2pH20g: posts small blind $0.25
dkC7J+qbyqk0qCcmJbEPPw: posts big blind $0.50
*** HOLE CARDS ***
Fp/oksNpipCrD2MJ2pH20g: raises $1 to $1.50
dkC7J+qbyqk0qCcmJbEPPw: calls $1
*** FLOP *** [Kd Ah 2c]
dkC7J+qbyqk0qCcmJbEPPw: checks
Fp/oksNpipCrD2MJ2pH20g: bets $1
dkC7J+qbyqk0qCcmJbEPPw: folds
Fp/oksNpipCrD2MJ2pH20g collected $2.85 from pot
Fp/oksNpipCrD2MJ2pH20g: doesn't show hand
*** SUMMARY ***
Total pot $3 | Rake $0.15
Board [Kd Ah 2c]
Seat 1: Fp/oksNpipCrD2MJ2pH20g (button) (small blind) collected ($2.85)
Seat 2: dkC7J+qbyqk0qCcmJbEPPw (big blind) folded on the Flop



PokerStars Game #59938763746:  Hold'em No Limit ($0.25/$0.50) - 2009/07/01 0:22:54 ET
Table 'c/CRn+68J3Y8KxD5g1ek2Q' 2-max Seat #1 is the button
Seat 1: 46qCyJ6evTkHo9al5sBMNA ($270.20 in chips)
Seat 2: BypVLsYQt3ePFm2xQL/dOA ($111.40 in chips)
46qCyJ6evTkHo9al5sBMNA: posts small blind $0.25
BypVLsYQt3ePFm2xQL/dOA: posts big blind $0.50
*** HOLE CARDS ***
46qCyJ6evTkHo9al5sBMNA: folds
BypVLsYQt3ePFm2xQL/dOA collected $0.50 from pot
BypVLsYQt3ePFm2xQL/dOA: doesn't show hand
*** SUMMARY ***
Total pot $0.50 | Rake $0
Seat 1: 46qCyJ6evTkHo9al5sBMNA (button) (small blind) folded before Flop
Seat 2: BypVLsYQt3ePFm2xQL/dOA (big blind) collected ($0.50)



PokerStars Game #59938764078:  Hold'em No Limit ($0.25/$0.50) - 2009/07/01 0:22:54 ET
Table '+dXkOAQyS8j9PQZusUTMpg' 2-max Seat #1 is the button
Seat 1: XFa6sBGjP2gxoIvxR3fZIg ($56 in chips)
Seat 2: 5IBeOgaApY1Bvzv2P8X4EA ($51.75 in chips)
XFa6sBGjP2gxoIvxR3fZIg: posts small blind $0.25
5IBeOgaApY1Bvzv2P8X4EA: posts big blind $0.50
*** HOLE CARDS ***
XFa6sBGjP2gxoIvxR3fZIg: raises $1 to $1.50
5IBeOgaApY1Bvzv2P8X4EA: folds
XFa6sBGjP2gxoIvxR3fZIg collected $1 from pot
*** SUMMARY ***
Total pot $1 | Rake $0
Seat 1: XFa6sBGjP2gxoIvxR3fZIg (button) (small blind) collected ($1)
Seat 2: 5IBeOgaApY1Bvzv2P8X4EA (big blind) folded before Flop



PokerStars Game #59938764166:  Hold'em No Limit ($0.25/$0.50) - 2009/07/01 0:22:54 ET
Table 'lSisgp6H7Fg1hH5VfjEjYQ' 9-max Seat #2 is the button
Seat 1: pEW8B6uXbdR47kfljMQ3+Q ($38.20 in chips)
Seat 2: UrcnkQOiLVk8BlKDPJSy7Q ($50.35 in chips)
Seat 3: aTkyjTh3w5YLWiIERupZOA ($39.65 in chips)
Seat 4: bwv/rbH/hHhPhY6u9mu04w ($25 in chips)
Seat 5: mSD1pginDsyHG5PDfqzphw ($10 in chips)
Seat 6: +k7T5ocke8UwavtgUHm+Cg ($26.10 in chips)
Seat 7: dGw5MBstXyXhWHHVFOWOFA ($43 in chips)
Seat 8: a4JDWmpFQkL10XfAyuF51A ($35.55 in chips)
Seat 9: 5JJVDlaiMnB004o/RqbZZQ ($40.50 in chips)
aTkyjTh3w5YLWiIERupZOA: posts small blind $0.25
bwv/rbH/hHhPhY6u9mu04w: posts big blind $0.50
*** HOLE CARDS ***
mSD1pginDsyHG5PDfqzphw: folds
+k7T5ocke8UwavtgUHm+Cg: folds
dGw5MBstXyXhWHHVFOWOFA: raises $1.50 to $2
a4JDWmpFQkL10XfAyuF51A: folds
5JJVDlaiMnB004o/RqbZZQ: folds
pEW8B6uXbdR47kfljMQ3+Q: folds
UrcnkQOiLVk8BlKDPJSy7Q: folds
aTkyjTh3w5YLWiIERupZOA: folds
bwv/rbH/hHhPhY6u9mu04w: folds
dGw5MBstXyXhWHHVFOWOFA collected $1.25 from pot
dGw5MBstXyXhWHHVFOWOFA: doesn't show hand
*** SUMMARY ***
Total pot $1.25 | Rake $0
Seat 1: pEW8B6uXbdR47kfljMQ3+Q folded before Flop (didn't bet)
Seat 2: UrcnkQOiLVk8BlKDPJSy7Q (button) folded before Flop (didn't bet)
Seat 3: aTkyjTh3w5YLWiIERupZOA (small blind) folded before Flop
Seat 4: bwv/rbH/hHhPhY6u9mu04w (big blind) folded before Flop
Seat 5: mSD1pginDsyHG5PDfqzphw folded before Flop (didn't bet)
Seat 6: +k7T5ocke8UwavtgUHm+Cg folded before Flop (didn't bet)
Seat 7: dGw5MBstXyXhWHHVFOWOFA collected ($1.25)
Seat 8: a4JDWmpFQkL10XfAyuF51A folded before Flop (didn't bet)
Seat 9: 5JJVDlaiMnB004o/RqbZZQ folded before Flop (didn't bet)



PokerStars Game #59938764504:  Hold'em No Limit ($0.25/$0.50) - 2009/07/01 0:22:55 ET
Table 'dVmkPtk5nWTfXApFsnhIOg' 2-max Seat #2 is the button
Seat 1: bypIyrYcAAifLfhZpGlKLA ($50.50 in chips)
Seat 2: rPToQDbLWB+dKnz7fcQSIg ($30.90 in chips)
rPToQDbLWB+dKnz7fcQSIg: posts small blind $0.25
bypIyrYcAAifLfhZpGlKLA: posts big blind $0.50
*** HOLE CARDS ***
rPToQDbLWB+dKnz7fcQSIg: raises $1 to $1.50
bypIyrYcAAifLfhZpGlKLA: folds
rPToQDbLWB+dKnz7fcQSIg collected $1 from pot
*** SUMMARY ***
Total pot $1 | Rake $0
Seat 1: bypIyrYcAAifLfhZpGlKLA (big blind) folded before Flop
Seat 2: rPToQDbLWB+dKnz7fcQSIg (button) (small blind) collected ($1)



PokerStars Game #59938765532:  Hold'em No Limit ($0.25/$0.50) - 2009/07/01 0:22:56 ET
Table 'E7bWJ45aoFXRpyRv2gw+Ig' 2-max Seat #1 is the button
Seat 1: FRkiRasEGlHUeLrEl+k/nA ($67.20 in chips)
Seat 2: 3Wro85I7472vJ4Wkpneo9A ($111.75 in chips)
FRkiRasEGlHUeLrEl+k/nA: posts small blind $0.25
3Wro85I7472vJ4Wkpneo9A: posts big blind $0.50
*** HOLE CARDS ***
FRkiRasEGlHUeLrEl+k/nA: raises $1 to $1.50
3Wro85I7472vJ4Wkpneo9A: folds
FRkiRasEGlHUeLrEl+k/nA collected $1 from pot
FRkiRasEGlHUeLrEl+k/nA: doesn't show hand
*** SUMMARY ***
Total pot $1 | Rake $0
Seat 1: FRkiRasEGlHUeLrEl+k/nA (button) (small blind) collected ($1)
Seat 2: 3Wro85I7472vJ4Wkpneo9A (big blind) folded before Flop



PokerStars Game #59938765062:  Hold'em No Limit ($0.25/$0.50) - 2009/07/01 0:22:56 ET
Table 'raOT4/ipuZgzjfKHC+jD9g' 2-max Seat #2 is the button
Seat 1: IuwLemwLhc9fvrwBGs0AMA ($10.95 in chips)
Seat 2: Udr5juWSWUgTu1NlRhjMdA ($11.15 in chips)
Udr5juWSWUgTu1NlRhjMdA: posts small blind $0.25
IuwLemwLhc9fvrwBGs0AMA: posts big blind $0.50
*** HOLE CARDS ***
Udr5juWSWUgTu1NlRhjMdA: calls $0.25
IuwLemwLhc9fvrwBGs0AMA: checks
*** FLOP *** [Tc 8s As]
IuwLemwLhc9fvrwBGs0AMA: checks
Udr5juWSWUgTu1NlRhjMdA: checks
*** TURN *** [Tc 8s As] [Th]
IuwLemwLhc9fvrwBGs0AMA: checks
Udr5juWSWUgTu1NlRhjMdA: checks
*** RIVER *** [Tc 8s As Th] [9c]
IuwLemwLhc9fvrwBGs0AMA: checks
Udr5juWSWUgTu1NlRhjMdA: checks
*** SHOW DOWN ***
IuwLemwLhc9fvrwBGs0AMA: shows [2h 5h] (a pair of Tens)
Udr5juWSWUgTu1NlRhjMdA: shows [8c Qd] (two pair, Tens and Eights)
Udr5juWSWUgTu1NlRhjMdA collected $0.95 from pot
*** SUMMARY ***
Total pot $1 | Rake $0.05
Board [Tc 8s As Th 9c]
Seat 1: IuwLemwLhc9fvrwBGs0AMA (big blind) showed [2h 5h] and lost with a pair of Tens
Seat 2: Udr5juWSWUgTu1NlRhjMdA (button) (small blind) showed [8c Qd] and won ($0.95) with two pair, Tens and Eights



PokerStars Game #59938766134:  Hold'em No Limit ($0.25/$0.50) - 2009/07/01 0:22:57 ET
Table '0AhP5FLi4ySROVJ/ycT1Qw' 2-max Seat #2 is the button
Seat 1: 38ZztDUK6IU5WCK+BN74Rw ($91.75 in chips)
Seat 2: 46qCyJ6evTkHo9al5sBMNA ($87.85 in chips)
46qCyJ6evTkHo9al5sBMNA: posts small blind $0.25
38ZztDUK6IU5WCK+BN74Rw: posts big blind $0.50
*** HOLE CARDS ***
46qCyJ6evTkHo9al5sBMNA: raises $1 to $1.50
38ZztDUK6IU5WCK+BN74Rw: raises $3 to $4.50
46qCyJ6evTkHo9al5sBMNA: folds
38ZztDUK6IU5WCK+BN74Rw collected $3 from pot
*** SUMMARY ***
Total pot $3 | Rake $0
Seat 1: 38ZztDUK6IU5WCK+BN74Rw (big blind) collected ($3)
Seat 2: 46qCyJ6evTkHo9al5sBMNA (button) (small blind) folded before Flop



PokerStars Game #59938766124:  Hold'em No Limit ($0.25/$0.50) - 2009/07/01 0:22:57 ET
Table '5EmHi+fnatGQQShcNmzOZQ' 6-max Seat #1 is the button
Seat 1: SwPczQo3cOtwEzhJrfO2cQ ($23.15 in chips)
Seat 3: L9qfLYXrczhAPd/VckgsWw ($63.10 in chips)
Seat 4: wOyVV9M/oyiw3YaOjNZ05w ($50.75 in chips)
Seat 5: kxPhs4ePFqMy52CInAJ2aw ($49.25 in chips)
Seat 6: 686aeHikcJlgKkSuIFdcXQ ($156.60 in chips)
L9qfLYXrczhAPd/VckgsWw: posts small blind $0.25
wOyVV9M/oyiw3YaOjNZ05w: posts big blind $0.50
*** HOLE CARDS ***
kxPhs4ePFqMy52CInAJ2aw: folds
686aeHikcJlgKkSuIFdcXQ: folds
SwPczQo3cOtwEzhJrfO2cQ: calls $0.50
L9qfLYXrczhAPd/VckgsWw: folds
wOyVV9M/oyiw3YaOjNZ05w: checks
*** FLOP *** [6c Qs Jd]
wOyVV9M/oyiw3YaOjNZ05w: bets $1
SwPczQo3cOtwEzhJrfO2cQ: folds
wOyVV9M/oyiw3YaOjNZ05w collected $1.20 from pot
*** SUMMARY ***
Total pot $1.25 | Rake $0.05
Board [6c Qs Jd]
Seat 1: SwPczQo3cOtwEzhJrfO2cQ (button) folded on the Flop
Seat 3: L9qfLYXrczhAPd/VckgsWw (small blind) folded before Flop
Seat 4: wOyVV9M/oyiw3YaOjNZ05w (big blind) collected ($1.20)
Seat 5: kxPhs4ePFqMy52CInAJ2aw folded before Flop (didn't bet)
Seat 6: 686aeHikcJlgKkSuIFdcXQ folded before Flop (didn't bet)



PokerStars Game #59938766824:  Hold'em No Limit ($0.25/$0.50) - 2009/07/01 0:22:58 ET
Table 'hSTs/dUsYLgJQuF2Onp0MQ' 6-max Seat #5 is the button
Seat 1: Donj3X7gYzeS5pAl7s9f+Q ($25.50 in chips)
Seat 3: vQOrJuXbLC3UZDVklY9bOA ($28.55 in chips)
Seat 4: L0aIPg7qefDQjdJo3HCVEA ($10 in chips)
Seat 5: 686aeHikcJlgKkSuIFdcXQ ($80.20 in chips)
Seat 6: +laPa9P7BjZKKnR0n+OmvA ($4.85 in chips)
+laPa9P7BjZKKnR0n+OmvA: posts small blind $0.25
Donj3X7gYzeS5pAl7s9f+Q: posts big blind $0.50
*** HOLE CARDS ***
vQOrJuXbLC3UZDVklY9bOA: folds
L0aIPg7qefDQjdJo3HCVEA: folds
6vNxrjjCl6FwfaaymM9jjg joins the table at seat #2
686aeHikcJlgKkSuIFdcXQ: raises $1 to $1.50
+laPa9P7BjZKKnR0n+OmvA: raises $3.35 to $4.85 and is all-in
Donj3X7gYzeS5pAl7s9f+Q: folds
686aeHikcJlgKkSuIFdcXQ: calls $3.35
*** FLOP *** [Qd Td 2h]
*** TURN *** [Qd Td 2h] [Ah]
*** RIVER *** [Qd Td 2h Ah] [Ts]
*** SHOW DOWN ***
+laPa9P7BjZKKnR0n+OmvA: shows [As Qc] (two pair, Aces and Queens)
686aeHikcJlgKkSuIFdcXQ: mucks hand
+laPa9P7BjZKKnR0n+OmvA collected $9.70 from pot
*** SUMMARY ***
Total pot $10.20 | Rake $0.50
Board [Qd Td 2h Ah Ts]
Seat 1: Donj3X7gYzeS5pAl7s9f+Q (big blind) folded before Flop
Seat 3: vQOrJuXbLC3UZDVklY9bOA folded before Flop (didn't bet)
Seat 4: L0aIPg7qefDQjdJo3HCVEA folded before Flop (didn't bet)
Seat 5: 686aeHikcJlgKkSuIFdcXQ (button) mucked
Seat 6: +laPa9P7BjZKKnR0n+OmvA (small blind) showed [As Qc] and won ($9.70) with two pair, Aces and Queens



PokerStars Game #59938768140:  Hold'em No Limit ($0.25/$0.50) - 2009/07/01 0:23:00 ET
Table 'c/CRn+68J3Y8KxD5g1ek2Q' 2-max Seat #2 is the button
Seat 1: 46qCyJ6evTkHo9al5sBMNA ($269.95 in chips)
Seat 2: BypVLsYQt3ePFm2xQL/dOA ($111.65 in chips)
BypVLsYQt3ePFm2xQL/dOA: posts small blind $0.25
46qCyJ6evTkHo9al5sBMNA: posts big blind $0.50
*** HOLE CARDS ***
BypVLsYQt3ePFm2xQL/dOA: raises $1 to $1.50
46qCyJ6evTkHo9al5sBMNA: folds
BypVLsYQt3ePFm2xQL/dOA collected $1 from pot
BypVLsYQt3ePFm2xQL/dOA: doesn't show hand
*** SUMMARY ***
Total pot $1 | Rake $0
Seat 1: 46qCyJ6evTkHo9al5sBMNA (big blind) folded before Flop
Seat 2: BypVLsYQt3ePFm2xQL/dOA (button) (small blind) collected ($1)



PokerStars Game #59938768778:  Hold'em No Limit ($0.25/$0.50) - 2009/07/01 0:23:01 ET
Table 'mTxf8gPLgffN3Iwfm7Icfg' 2-max Seat #1 is the button
Seat 1: Do9Rlu1R5u/AcRtMTl8SYg ($74.80 in chips)
Seat 2: EMc5LPgVaded4Qc77vm0fw ($86.40 in chips)
Do9Rlu1R5u/AcRtMTl8SYg: posts small blind $0.25
EMc5LPgVaded4Qc77vm0fw: posts big blind $0.50
*** HOLE CARDS ***
Do9Rlu1R5u/AcRtMTl8SYg: folds
EMc5LPgVaded4Qc77vm0fw collected $0.50 from pot
EMc5LPgVaded4Qc77vm0fw: doesn't show hand
*** SUMMARY ***
Total pot $0.50 | Rake $0
Seat 1: Do9Rlu1R5u/AcRtMTl8SYg (button) (small blind) folded before Flop
Seat 2: EMc5LPgVaded4Qc77vm0fw (big blind) collected ($0.50)



PokerStars Game #59938769620:  Hold'em No Limit ($0.25/$0.50) - 2009/07/01 0:23:02 ET
Table 'ZYwMb9E6tY50Qm+iNbXRYw' 2-max Seat #1 is the button
Seat 1: DXLfRb8KDZWmrztw2bwtFw ($14.05 in chips)
Seat 2: 16tvT7AYgZ2LgiGFcvFKQg ($17.60 in chips)
DXLfRb8KDZWmrztw2bwtFw: posts small blind $0.25
16tvT7AYgZ2LgiGFcvFKQg: posts big blind $0.50
*** HOLE CARDS ***
DXLfRb8KDZWmrztw2bwtFw: calls $0.25
16tvT7AYgZ2LgiGFcvFKQg: checks
*** FLOP *** [7c 7s 5d]
16tvT7AYgZ2LgiGFcvFKQg: checks
DXLfRb8KDZWmrztw2bwtFw: checks
*** TURN *** [7c 7s 5d] [Qh]
16tvT7AYgZ2LgiGFcvFKQg: checks
DXLfRb8KDZWmrztw2bwtFw: checks
*** RIVER *** [7c 7s 5d Qh] [Qd]
16tvT7AYgZ2LgiGFcvFKQg: checks
DXLfRb8KDZWmrztw2bwtFw: checks
*** SHOW DOWN ***
16tvT7AYgZ2LgiGFcvFKQg: shows [Kh 4h] (two pair, Queens and Sevens)
DXLfRb8KDZWmrztw2bwtFw: mucks hand
16tvT7AYgZ2LgiGFcvFKQg collected $0.95 from pot
*** SUMMARY ***
Total pot $1 | Rake $0.05
Board [7c 7s 5d Qh Qd]
Seat 1: DXLfRb8KDZWmrztw2bwtFw (button) (small blind) mucked
Seat 2: 16tvT7AYgZ2LgiGFcvFKQg (big blind) showed [Kh 4h] and won ($0.95) with two pair, Queens and Sevens



PokerStars Game #59938769396:  Hold'em No Limit ($0.25/$0.50) - 2009/07/01 0:23:02 ET
Table '+dXkOAQyS8j9PQZusUTMpg' 2-max Seat #2 is the button
Seat 1: XFa6sBGjP2gxoIvxR3fZIg ($56.50 in chips)
Seat 2: 5IBeOgaApY1Bvzv2P8X4EA ($51.25 in chips)
5IBeOgaApY1Bvzv2P8X4EA: posts small blind $0.25
XFa6sBGjP2gxoIvxR3fZIg: posts big blind $0.50
*** HOLE CARDS ***
5IBeOgaApY1Bvzv2P8X4EA: folds
XFa6sBGjP2gxoIvxR3fZIg collected $0.50 from pot
XFa6sBGjP2gxoIvxR3fZIg: doesn't show hand
*** SUMMARY ***
Total pot $0.50 | Rake $0
Seat 1: XFa6sBGjP2gxoIvxR3fZIg (big blind) collected ($0.50)
Seat 2: 5IBeOgaApY1Bvzv2P8X4EA (button) (small blind) folded before Flop



PokerStars Game #59938769402:  Hold'em No Limit ($0.25/$0.50) - 2009/07/01 0:23:02 ET
Table '37qXEp3oe+er5q4CZip9eQ' 6-max Seat #4 is the button
Seat 1: oqOqoO2AyCZenUghCxMDxw ($50 in chips)
Seat 3: Rt6KgtZ8YaJoTc3FPim00w ($92.90 in chips)
Seat 4: AYb7QG0KzyicbOC0ZROE3Q ($15.40 in chips)
Seat 5: VOmI0x4dDPnTESZd5B4d1Q ($46.05 in chips)
Seat 6: f7zPpUQp9hHZgqhEvrUWQw ($50.65 in chips)
VOmI0x4dDPnTESZd5B4d1Q: posts small blind $0.25
f7zPpUQp9hHZgqhEvrUWQw: posts big blind $0.50
*** HOLE CARDS ***
oqOqoO2AyCZenUghCxMDxw: folds
Rt6KgtZ8YaJoTc3FPim00w: folds
AYb7QG0KzyicbOC0ZROE3Q: folds
VOmI0x4dDPnTESZd5B4d1Q: raises $1.50 to $2
f7zPpUQp9hHZgqhEvrUWQw: folds
VOmI0x4dDPnTESZd5B4d1Q collected $1 from pot
*** SUMMARY ***
Total pot $1 | Rake $0
Seat 1: oqOqoO2AyCZenUghCxMDxw folded before Flop (didn't bet)
Seat 3: Rt6KgtZ8YaJoTc3FPim00w folded before Flop (didn't bet)
Seat 4: AYb7QG0KzyicbOC0ZROE3Q (button) folded before Flop (didn't bet)
Seat 5: VOmI0x4dDPnTESZd5B4d1Q (small blind) collected ($1)
Seat 6: f7zPpUQp9hHZgqhEvrUWQw (big blind) folded before Flop



PokerStars Game #59938770044:  Hold'em No Limit ($0.25/$0.50) - 2009/07/01 0:23:03 ET
Table 'kgbJRsxfv64KrErDRBAkcw' 6-max Seat #5 is the button
Seat 1: N7O9jUEx2YiQn1+yRYTHmw ($17.20 in chips)
Seat 2: Q+thC23WCv1kJUJtH/+4Jw ($67.90 in chips)
Seat 3: T0Gx/FcQ5VH9u7XaOMX97A ($60.25 in chips)
Seat 4: qanMEqjABjWxC/JgQ/0l7w ($56.70 in chips)
Seat 5: +Pf9jTVizYlIo+woPvptfA ($50 in chips)
Seat 6: ozrlafxxh1HmYdA0/h+MuA ($9.50 in chips)
ozrlafxxh1HmYdA0/h+MuA: posts small blind $0.25
N7O9jUEx2YiQn1+yRYTHmw: posts big blind $0.50
*** HOLE CARDS ***
Q+thC23WCv1kJUJtH/+4Jw: folds
T0Gx/FcQ5VH9u7XaOMX97A: folds
qanMEqjABjWxC/JgQ/0l7w: folds
+Pf9jTVizYlIo+woPvptfA: folds
ozrlafxxh1HmYdA0/h+MuA: calls $0.25
N7O9jUEx2YiQn1+yRYTHmw: checks
*** FLOP *** [9c Qc Qs]
ozrlafxxh1HmYdA0/h+MuA: checks
N7O9jUEx2YiQn1+yRYTHmw: checks
*** TURN *** [9c Qc Qs] [Th]
ozrlafxxh1HmYdA0/h+MuA: checks
N7O9jUEx2YiQn1+yRYTHmw: checks
*** RIVER *** [9c Qc Qs Th] [2d]
ozrlafxxh1HmYdA0/h+MuA: checks
N7O9jUEx2YiQn1+yRYTHmw: checks
*** SHOW DOWN ***
ozrlafxxh1HmYdA0/h+MuA: shows [3d 5c] (a pair of Queens)
N7O9jUEx2YiQn1+yRYTHmw: shows [7h Jc] (a pair of Queens - Jack kicker)
N7O9jUEx2YiQn1+yRYTHmw collected $0.95 from pot
*** SUMMARY ***
Total pot $1 | Rake $0.05
Board [9c Qc Qs Th 2d]
Seat 1: N7O9jUEx2YiQn1+yRYTHmw (big blind) showed [7h Jc] and won ($0.95) with a pair of Queens
Seat 2: Q+thC23WCv1kJUJtH/+4Jw folded before Flop (didn't bet)
Seat 3: T0Gx/FcQ5VH9u7XaOMX97A folded before Flop (didn't bet)
Seat 4: qanMEqjABjWxC/JgQ/0l7w folded before Flop (didn't bet)
Seat 5: +Pf9jTVizYlIo+woPvptfA (button) folded before Flop (didn't bet)
Seat 6: ozrlafxxh1HmYdA0/h+MuA (small blind) showed [3d 5c] and lost with a pair of Queens



PokerStars Game #59938770662:  Hold'em No Limit ($0.25/$0.50) - 2009/07/01 0:23:04 ET
Table 'T/PgNWqVyY6lkldcBVXYJQ' 6-max Seat #4 is the button
Seat 1: +Pf9jTVizYlIo+woPvptfA ($53.75 in chips)
Seat 2: oZAeY5rVqNGgt8yyQ0pxbA ($28.50 in chips)
Seat 3: L3OcNO1bgdqDI46j67KQPQ ($55.30 in chips)
Seat 4: jxMvxeUUL9UU0V6wVU+Iyw ($9.95 in chips)
Seat 5: vVQBckETtigfb5mAcyK0OA ($63.85 in chips)
Seat 6: cDzbog6kwmJp+LBeBq+iMQ ($25.75 in chips)
vVQBckETtigfb5mAcyK0OA: posts small blind $0.25
cDzbog6kwmJp+LBeBq+iMQ: posts big blind $0.50
*** HOLE CARDS ***
+Pf9jTVizYlIo+woPvptfA: folds
oZAeY5rVqNGgt8yyQ0pxbA: folds
vVQBckETtigfb5mAcyK0OA said, "are they playing the argos"
L3OcNO1bgdqDI46j67KQPQ: raises $1.50 to $2
jxMvxeUUL9UU0V6wVU+Iyw: folds
vVQBckETtigfb5mAcyK0OA: calls $1.75
cDzbog6kwmJp+LBeBq+iMQ: calls $1.50
*** FLOP *** [4c Jd 2d]
vVQBckETtigfb5mAcyK0OA: bets $1.50
cDzbog6kwmJp+LBeBq+iMQ: calls $1.50
L3OcNO1bgdqDI46j67KQPQ: folds
*** TURN *** [4c Jd 2d] [Th]
vVQBckETtigfb5mAcyK0OA: bets $2
jxMvxeUUL9UU0V6wVU+Iyw said, "? YES? it is the season opener against those nasty double blue *******s."
cDzbog6kwmJp+LBeBq+iMQ: calls $2
*** RIVER *** [4c Jd 2d Th] [3h]
jxMvxeUUL9UU0V6wVU+Iyw said, "B@$t@rd$"
vVQBckETtigfb5mAcyK0OA: bets $1.50
cDzbog6kwmJp+LBeBq+iMQ: raises $13 to $14.50
vVQBckETtigfb5mAcyK0OA: folds
cDzbog6kwmJp+LBeBq+iMQ collected $15.25 from pot
*** SUMMARY ***
Total pot $16 | Rake $0.75
Board [4c Jd 2d Th 3h]
Seat 1: +Pf9jTVizYlIo+woPvptfA folded before Flop (didn't bet)
Seat 2: oZAeY5rVqNGgt8yyQ0pxbA folded before Flop (didn't bet)
Seat 3: L3OcNO1bgdqDI46j67KQPQ folded on the Flop
Seat 4: jxMvxeUUL9UU0V6wVU+Iyw (button) folded before Flop (didn't bet)
Seat 5: vVQBckETtigfb5mAcyK0OA (small blind) folded on the River
Seat 6: cDzbog6kwmJp+LBeBq+iMQ (big blind) collected ($15.25)



PokerStars Game #59938770992:  Hold'em No Limit ($0.25/$0.50) - 2009/07/01 0:23:04 ET
Table 'E7bWJ45aoFXRpyRv2gw+Ig' 2-max Seat #2 is the button
Seat 1: FRkiRasEGlHUeLrEl+k/nA ($67.70 in chips)
Seat 2: 3Wro85I7472vJ4Wkpneo9A ($111.25 in chips)
3Wro85I7472vJ4Wkpneo9A: posts small blind $0.25
FRkiRasEGlHUeLrEl+k/nA: posts big blind $0.50
*** HOLE CARDS ***
3Wro85I7472vJ4Wkpneo9A: calls $0.25
FRkiRasEGlHUeLrEl+k/nA: raises $1.50 to $2
3Wro85I7472vJ4Wkpneo9A: calls $1.50
*** FLOP *** [Ks 6s Ad]
FRkiRasEGlHUeLrEl+k/nA: bets $1
3Wro85I7472vJ4Wkpneo9A: folds
FRkiRasEGlHUeLrEl+k/nA collected $3.80 from pot
FRkiRasEGlHUeLrEl+k/nA: doesn't show hand
*** SUMMARY ***
Total pot $4 | Rake $0.20
Board [Ks 6s Ad]
Seat 1: FRkiRasEGlHUeLrEl+k/nA (big blind) collected ($3.80)
Seat 2: 3Wro85I7472vJ4Wkpneo9A (button) (small blind) folded on the Flop



PokerStars Game #59938770430:  Hold'em No Limit ($0.25/$0.50) - 2009/07/01 0:23:04 ET
Table 'IeNZOZQ4T6oiaHqFeo6yIA' 2-max Seat #2 is the button
Seat 1: ndd1nfncBkWNitBnsfCoVQ ($85.20 in chips)
Seat 2: A91IUl5JaZROhtfCtnnwYw ($50 in chips)
A91IUl5JaZROhtfCtnnwYw: posts small blind $0.25
ndd1nfncBkWNitBnsfCoVQ: posts big blind $0.50
*** HOLE CARDS ***
A91IUl5JaZROhtfCtnnwYw: calls $0.25
ndd1nfncBkWNitBnsfCoVQ: checks
*** FLOP *** [6h Ac 4d]
ndd1nfncBkWNitBnsfCoVQ: checks
A91IUl5JaZROhtfCtnnwYw: checks
*** TURN *** [6h Ac 4d] [7s]
ndd1nfncBkWNitBnsfCoVQ: checks
A91IUl5JaZROhtfCtnnwYw: checks
*** RIVER *** [6h Ac 4d 7s] [5h]
ndd1nfncBkWNitBnsfCoVQ: checks
A91IUl5JaZROhtfCtnnwYw: bets $0.50
ndd1nfncBkWNitBnsfCoVQ: folds
A91IUl5JaZROhtfCtnnwYw collected $0.95 from pot
A91IUl5JaZROhtfCtnnwYw: doesn't show hand
*** SUMMARY ***
Total pot $1 | Rake $0.05
Board [6h Ac 4d 7s 5h]
Seat 1: ndd1nfncBkWNitBnsfCoVQ (big blind) folded on the River
Seat 2: A91IUl5JaZROhtfCtnnwYw (button) (small blind) collected ($0.95)



PokerStars Game #59938771678:  Hold'em No Limit ($0.25/$0.50) - 2009/07/01 0:23:05 ET
Table 'eMxdLyFDf28E0wit6gm3Uw' 6-max Seat #5 is the button
Seat 1: tnD/64LagZ9qPaeOQVjVZg ($13.20 in chips)
Seat 2: jwuKQ1S3U4NnzMQn3E3dgw ($69.60 in chips)
Seat 3: dZcLsEI8iXkobBduRJ45Yw ($17.65 in chips)
Seat 4: QM93o65lI8kLzmiB/BILlA ($27 in chips)
Seat 5: X0X97o2fDAPiGx6o1gahsw ($56.35 in chips)
Seat 6: L0aIPg7qefDQjdJo3HCVEA ($8.25 in chips)
L0aIPg7qefDQjdJo3HCVEA: posts small blind $0.25
tnD/64LagZ9qPaeOQVjVZg: posts big blind $0.50
*** HOLE CARDS ***
jwuKQ1S3U4NnzMQn3E3dgw: folds
dZcLsEI8iXkobBduRJ45Yw: calls $0.50
QM93o65lI8kLzmiB/BILlA: raises $0.50 to $1
X0X97o2fDAPiGx6o1gahsw: folds
L0aIPg7qefDQjdJo3HCVEA: folds
tnD/64LagZ9qPaeOQVjVZg: folds
dZcLsEI8iXkobBduRJ45Yw: calls $0.50
*** FLOP *** [Ac 5h 8d]
dZcLsEI8iXkobBduRJ45Yw: checks
QM93o65lI8kLzmiB/BILlA: bets $2
dZcLsEI8iXkobBduRJ45Yw: calls $2
*** TURN *** [Ac 5h 8d] [2s]
dZcLsEI8iXkobBduRJ45Yw: checks
QM93o65lI8kLzmiB/BILlA: bets $5
dZcLsEI8iXkobBduRJ45Yw: folds
QM93o65lI8kLzmiB/BILlA collected $6.45 from pot
*** SUMMARY ***
Total pot $6.75 | Rake $0.30
Board [Ac 5h 8d 2s]
Seat 1: tnD/64LagZ9qPaeOQVjVZg (big blind) folded before Flop
Seat 2: jwuKQ1S3U4NnzMQn3E3dgw folded before Flop (didn't bet)
Seat 3: dZcLsEI8iXkobBduRJ45Yw folded on the Turn
Seat 4: QM93o65lI8kLzmiB/BILlA collected ($6.45)
Seat 5: X0X97o2fDAPiGx6o1gahsw (button) folded before Flop (didn't bet)
Seat 6: L0aIPg7qefDQjdJo3HCVEA (small blind) folded before Flop



PokerStars Game #59938771706:  Hold'em No Limit ($0.25/$0.50) - 2009/07/01 0:23:05 ET
Table 'GfL/No5u5PoEnU39lP5pQg' 6-max Seat #3 is the button
Seat 1: 1WUCqNG+p+vfWRTXNu4ljw ($50 in chips)
Seat 2: uVwggSetzp7d+eVgowO3vg ($44.75 in chips)
Seat 3: qNezhXOOUXqwG7b9X5XJAA ($50 in chips)
Seat 5: crjGpJEzSZgD38FoE3VMGg ($54.55 in chips)
Seat 6: 3wylWYGeXFXcrE4XVrlPng ($81.20 in chips)
OZ6OtYh5Y53MCH/p0QTn5g will be allowed to play after the button
crjGpJEzSZgD38FoE3VMGg: posts small blind $0.25
3wylWYGeXFXcrE4XVrlPng: posts big blind $0.50
*** HOLE CARDS ***
1WUCqNG+p+vfWRTXNu4ljw: folds
uVwggSetzp7d+eVgowO3vg: folds
qNezhXOOUXqwG7b9X5XJAA: folds
crjGpJEzSZgD38FoE3VMGg: folds
3wylWYGeXFXcrE4XVrlPng collected $0.50 from pot
3wylWYGeXFXcrE4XVrlPng: doesn't show hand
*** SUMMARY ***
Total pot $0.50 | Rake $0
Seat 1: 1WUCqNG+p+vfWRTXNu4ljw folded before Flop (didn't bet)
Seat 2: uVwggSetzp7d+eVgowO3vg folded before Flop (didn't bet)
Seat 3: qNezhXOOUXqwG7b9X5XJAA (button) folded before Flop (didn't bet)
Seat 5: crjGpJEzSZgD38FoE3VMGg (small blind) folded before Flop
Seat 6: 3wylWYGeXFXcrE4XVrlPng (big blind) collected ($0.50)



PokerStars Game #59938772986:  Hold'em No Limit ($0.25/$0.50) - 2009/07/01 0:23:07 ET
Table '8YYaUJqyk4NgBvNkL7mj/Q' 2-max Seat #2 is the button
Seat 1: Fp/oksNpipCrD2MJ2pH20g ($11.10 in chips)
Seat 2: dkC7J+qbyqk0qCcmJbEPPw ($48.65 in chips)
dkC7J+qbyqk0qCcmJbEPPw: posts small blind $0.25
Fp/oksNpipCrD2MJ2pH20g: posts big blind $0.50
*** HOLE CARDS ***
dkC7J+qbyqk0qCcmJbEPPw: raises $1 to $1.50
Fp/oksNpipCrD2MJ2pH20g: calls $1
*** FLOP *** [3h 9h 2c]
Fp/oksNpipCrD2MJ2pH20g: checks
dkC7J+qbyqk0qCcmJbEPPw: bets $2
Fp/oksNpipCrD2MJ2pH20g: raises $7.60 to $9.60 and is all-in
dkC7J+qbyqk0qCcmJbEPPw: calls $7.60
*** TURN *** [3h 9h 2c] [7s]
*** RIVER *** [3h 9h 2c 7s] [8d]
*** SHOW DOWN ***
Fp/oksNpipCrD2MJ2pH20g: shows [6d 9d] (a pair of Nines)
dkC7J+qbyqk0qCcmJbEPPw: mucks hand
Fp/oksNpipCrD2MJ2pH20g collected $21.70 from pot
*** SUMMARY ***
Total pot $22.20 | Rake $0.50
Board [3h 9h 2c 7s 8d]
Seat 1: Fp/oksNpipCrD2MJ2pH20g (big blind) showed [6d 9d] and won ($21.70) with a pair of Nines
Seat 2: dkC7J+qbyqk0qCcmJbEPPw (button) (small blind) mucked



PokerStars Game #59938772534:  Hold'em No Limit ($0.25/$0.50) - 2009/07/01 0:23:07 ET
Table 'dVmkPtk5nWTfXApFsnhIOg' 2-max Seat #1 is the button
Seat 1: bypIyrYcAAifLfhZpGlKLA ($50 in chips)
Seat 2: rPToQDbLWB+dKnz7fcQSIg ($31.40 in chips)
bypIyrYcAAifLfhZpGlKLA: posts small blind $0.25
rPToQDbLWB+dKnz7fcQSIg: posts big blind $0.50
*** HOLE CARDS ***
bypIyrYcAAifLfhZpGlKLA: raises $1 to $1.50
rPToQDbLWB+dKnz7fcQSIg: folds
bypIyrYcAAifLfhZpGlKLA collected $1 from pot
bypIyrYcAAifLfhZpGlKLA: doesn't show hand
*** SUMMARY ***
Total pot $1 | Rake $0
Seat 1: bypIyrYcAAifLfhZpGlKLA (button) (small blind) collected ($1)
Seat 2: rPToQDbLWB+dKnz7fcQSIg (big blind) folded before Flop



PokerStars Game #59938772476:  Hold'em No Limit ($0.25/$0.50) - 2009/07/01 0:23:07 ET
Table 'mTxf8gPLgffN3Iwfm7Icfg' 2-max Seat #2 is the button
Seat 1: Do9Rlu1R5u/AcRtMTl8SYg ($74.55 in chips)
Seat 2: EMc5LPgVaded4Qc77vm0fw ($86.65 in chips)
EMc5LPgVaded4Qc77vm0fw: posts small blind $0.25
Do9Rlu1R5u/AcRtMTl8SYg: posts big blind $0.50
*** HOLE CARDS ***
EMc5LPgVaded4Qc77vm0fw: raises $1 to $1.50
Do9Rlu1R5u/AcRtMTl8SYg: folds
EMc5LPgVaded4Qc77vm0fw collected $1 from pot
EMc5LPgVaded4Qc77vm0fw: doesn't show hand
*** SUMMARY ***
Total pot $1 | Rake $0
Seat 1: Do9Rlu1R5u/AcRtMTl8SYg (big blind) folded before Flop
Seat 2: EMc5LPgVaded4Qc77vm0fw (button) (small blind) collected ($1)



PokerStars Game #59938772598:  Hold'em No Limit ($0.25/$0.50) - 2009/07/01 0:23:07 ET
Table 'c/CRn+68J3Y8KxD5g1ek2Q' 2-max Seat #1 is the button
Seat 1: 46qCyJ6evTkHo9al5sBMNA ($269.45 in chips)
Seat 2: BypVLsYQt3ePFm2xQL/dOA ($112.15 in chips)
46qCyJ6evTkHo9al5sBMNA: posts small blind $0.25
BypVLsYQt3ePFm2xQL/dOA: posts big blind $0.50
*** HOLE CARDS ***
46qCyJ6evTkHo9al5sBMNA: raises $1 to $1.50
BypVLsYQt3ePFm2xQL/dOA: calls $1
*** FLOP *** [Jc 2c 8s]
BypVLsYQt3ePFm2xQL/dOA: checks
46qCyJ6evTkHo9al5sBMNA: bets $2
BypVLsYQt3ePFm2xQL/dOA: calls $2
*** TURN *** [Jc 2c 8s] [9d]
BypVLsYQt3ePFm2xQL/dOA: checks
46qCyJ6evTkHo9al5sBMNA: checks
*** RIVER *** [Jc 2c 8s 9d] [9s]
BypVLsYQt3ePFm2xQL/dOA: bets $13.50
46qCyJ6evTkHo9al5sBMNA: folds
BypVLsYQt3ePFm2xQL/dOA collected $6.70 from pot
BypVLsYQt3ePFm2xQL/dOA: doesn't show hand
*** SUMMARY ***
Total pot $7 | Rake $0.30
Board [Jc 2c 8s 9d 9s]
Seat 1: 46qCyJ6evTkHo9al5sBMNA (button) (small blind) folded on the River
Seat 2: BypVLsYQt3ePFm2xQL/dOA (big blind) collected ($6.70)



PokerStars Game #59938774420:  Hold'em No Limit ($0.25/$0.50) - 2009/07/01 0:23:09 ET
Table '+dXkOAQyS8j9PQZusUTMpg' 2-max Seat #1 is the button
Seat 1: XFa6sBGjP2gxoIvxR3fZIg ($56.75 in chips)
Seat 2: 5IBeOgaApY1Bvzv2P8X4EA ($51 in chips)
XFa6sBGjP2gxoIvxR3fZIg: posts small blind $0.25
5IBeOgaApY1Bvzv2P8X4EA: posts big blind $0.50
*** HOLE CARDS ***
XFa6sBGjP2gxoIvxR3fZIg: raises $1 to $1.50
5IBeOgaApY1Bvzv2P8X4EA: folds
XFa6sBGjP2gxoIvxR3fZIg collected $1 from pot
XFa6sBGjP2gxoIvxR3fZIg: doesn't show hand
*** SUMMARY ***
Total pot $1 | Rake $0
Seat 1: XFa6sBGjP2gxoIvxR3fZIg (button) (small blind) collected ($1)
Seat 2: 5IBeOgaApY1Bvzv2P8X4EA (big blind) folded before Flop



PokerStars Game #59938774700:  Hold'em No Limit ($0.25/$0.50) - 2009/07/01 0:23:10 ET
Table 'ibNfFy0bCzuBaUORla0aGw' 9-max Seat #4 is the button
Seat 2: 90Wb75h3W1BRpbqVnuk8gw ($58.05 in chips)
Seat 3: dDaHs3X8+fe3bIkRU0cbrw ($40.90 in chips)
Seat 4: YBN054X4blmis+B2bBlC0g ($17.30 in chips)
Seat 5: FRv75HO8CUsRZ1byEz06mQ ($8.60 in chips)
Seat 7: HZkVla4kK2SI42CVrPZ/ig ($10 in chips)
Seat 8: xUrN9TWLq4m5V+OXY7KUUA ($50 in chips)
Seat 9: WpvT3OUSiZlpvs+mPXFqtQ ($10.25 in chips)
FRv75HO8CUsRZ1byEz06mQ: posts small blind $0.25
BmYrv3ec2k5d6pQq6iNaZw: is sitting out
BmYrv3ec2k5d6pQq6iNaZw leaves the table
HZkVla4kK2SI42CVrPZ/ig: posts big blind $0.50
*** HOLE CARDS ***
xUrN9TWLq4m5V+OXY7KUUA: folds
WpvT3OUSiZlpvs+mPXFqtQ: raises $1.50 to $2
90Wb75h3W1BRpbqVnuk8gw: folds
dDaHs3X8+fe3bIkRU0cbrw: folds
YBN054X4blmis+B2bBlC0g: folds
FRv75HO8CUsRZ1byEz06mQ: folds
HZkVla4kK2SI42CVrPZ/ig: folds
WpvT3OUSiZlpvs+mPXFqtQ collected $1.25 from pot
*** SUMMARY ***
Total pot $1.25 | Rake $0
Seat 2: 90Wb75h3W1BRpbqVnuk8gw folded before Flop (didn't bet)
Seat 3: dDaHs3X8+fe3bIkRU0cbrw folded before Flop (didn't bet)
Seat 4: YBN054X4blmis+B2bBlC0g (button) folded before Flop (didn't bet)
Seat 5: FRv75HO8CUsRZ1byEz06mQ (small blind) folded before Flop
Seat 7: HZkVla4kK2SI42CVrPZ/ig (big blind) folded before Flop
Seat 8: xUrN9TWLq4m5V+OXY7KUUA folded before Flop (didn't bet)
Seat 9: WpvT3OUSiZlpvs+mPXFqtQ collected ($1.25)



PokerStars Game #59938775226:  Hold'em No Limit ($0.25/$0.50) - 2009/07/01 0:23:11 ET
Table '0AhP5FLi4ySROVJ/ycT1Qw' 2-max Seat #1 is the button
Seat 1: 38ZztDUK6IU5WCK+BN74Rw ($93.25 in chips)
Seat 2: 46qCyJ6evTkHo9al5sBMNA ($86.35 in chips)
38ZztDUK6IU5WCK+BN74Rw: posts small blind $0.25
46qCyJ6evTkHo9al5sBMNA: posts big blind $0.50
*** HOLE CARDS ***
38ZztDUK6IU5WCK+BN74Rw: folds
46qCyJ6evTkHo9al5sBMNA collected $0.50 from pot
46qCyJ6evTkHo9al5sBMNA: doesn't show hand
*** SUMMARY ***
Total pot $0.50 | Rake $0
Seat 1: 38ZztDUK6IU5WCK+BN74Rw (button) (small blind) folded before Flop
Seat 2: 46qCyJ6evTkHo9al5sBMNA (big blind) collected ($0.50)



PokerStars Game #59938777002:  Hold'em No Limit ($0.25/$0.50) - 2009/07/01 0:23:13 ET
Table '3FhG0gl3kMX3wBEEqj+wnQ' 9-max Seat #3 is the button
Seat 1: e0J9pdCNUDTCG031RnXqLA ($19.50 in chips)
Seat 2: 4dl3YNqZ6Houm2jZAzDmRg ($19.75 in chips)
Seat 3: HZkVla4kK2SI42CVrPZ/ig ($9.25 in chips)
Seat 4: bz4LMfV0GGl/MJ/ABXuPmg ($21.70 in chips)
Seat 5: XNMDwbXt/Q4jM99AXnbJDw ($55.55 in chips)
Seat 6: 5JJVDlaiMnB004o/RqbZZQ ($24.50 in chips)
Seat 7: mSD1pginDsyHG5PDfqzphw ($10 in chips)
Seat 8: j3K/Jujr7PY4ZM2RZvlH6A ($52.10 in chips)
Seat 9: L5e2lrPLQm1Pqx30IIZ/Fw ($10 in chips)
bz4LMfV0GGl/MJ/ABXuPmg: posts small blind $0.25
XNMDwbXt/Q4jM99AXnbJDw: posts big blind $0.50
*** HOLE CARDS ***
5JJVDlaiMnB004o/RqbZZQ: folds
mSD1pginDsyHG5PDfqzphw: folds
j3K/Jujr7PY4ZM2RZvlH6A: raises $1 to $1.50
L5e2lrPLQm1Pqx30IIZ/Fw: folds
e0J9pdCNUDTCG031RnXqLA: folds
4dl3YNqZ6Houm2jZAzDmRg: folds
HZkVla4kK2SI42CVrPZ/ig: folds
bz4LMfV0GGl/MJ/ABXuPmg: calls $1.25
XNMDwbXt/Q4jM99AXnbJDw: folds
*** FLOP *** [Jh Qs 9h]
bz4LMfV0GGl/MJ/ABXuPmg: bets $2
j3K/Jujr7PY4ZM2RZvlH6A: calls $2
*** TURN *** [Jh Qs 9h] [Ac]
bz4LMfV0GGl/MJ/ABXuPmg: bets $3
j3K/Jujr7PY4ZM2RZvlH6A: raises $5 to $8
bz4LMfV0GGl/MJ/ABXuPmg: folds
j3K/Jujr7PY4ZM2RZvlH6A collected $12.85 from pot
j3K/Jujr7PY4ZM2RZvlH6A: doesn't show hand
*** SUMMARY ***
Total pot $13.50 | Rake $0.65
Board [Jh Qs 9h Ac]
Seat 1: e0J9pdCNUDTCG031RnXqLA folded before Flop (didn't bet)
Seat 2: 4dl3YNqZ6Houm2jZAzDmRg folded before Flop (didn't bet)
Seat 3: HZkVla4kK2SI42CVrPZ/ig (button) folded before Flop (didn't bet)
Seat 4: bz4LMfV0GGl/MJ/ABXuPmg (small blind) folded on the Turn
Seat 5: XNMDwbXt/Q4jM99AXnbJDw (big blind) folded before Flop
Seat 6: 5JJVDlaiMnB004o/RqbZZQ folded before Flop (didn't bet)
Seat 7: mSD1pginDsyHG5PDfqzphw folded before Flop (didn't bet)
Seat 8: j3K/Jujr7PY4ZM2RZvlH6A collected ($12.85)
Seat 9: L5e2lrPLQm1Pqx30IIZ/Fw folded before Flop (didn't bet)



PokerStars Game #59938777158:  Hold'em No Limit ($0.25/$0.50) - 2009/07/01 0:23:14 ET
Table 'X6IRCRTh+20gjz8aubWnwA' 9-max Seat #7 is the button
Seat 2: RjBdQ6w31rgcy0o24VLR6w ($12.40 in chips)
Seat 3: mSD1pginDsyHG5PDfqzphw ($19.75 in chips)
Seat 4: uw9QayAAxLM3Hb+HR7mSkg ($11.50 in chips)
Seat 5: QtFsO51ArDuQ44+KvR2jow ($27.45 in chips)
Seat 6: /6In1zC3WtgwxDcueWzZWg ($58.10 in chips)
Seat 7: VBnpbzn0dIveV55qKvciew ($45.25 in chips)
Seat 8: HxeBVq06/3Bh/H986sgdbw ($12.50 in chips)
Seat 9: M+7+BTmX5vZatHVuoRB1nA ($81.60 in chips)
HxeBVq06/3Bh/H986sgdbw: posts small blind $0.25
M+7+BTmX5vZatHVuoRB1nA: posts big blind $0.50
*** HOLE CARDS ***
RjBdQ6w31rgcy0o24VLR6w: folds
mSD1pginDsyHG5PDfqzphw: folds
uw9QayAAxLM3Hb+HR7mSkg: folds
QtFsO51ArDuQ44+KvR2jow: raises $0.50 to $1
/6In1zC3WtgwxDcueWzZWg: calls $1
VBnpbzn0dIveV55qKvciew: folds
HxeBVq06/3Bh/H986sgdbw: folds
M+7+BTmX5vZatHVuoRB1nA: calls $0.50
*** FLOP *** [Jd Ac 7h]
M+7+BTmX5vZatHVuoRB1nA: checks
QtFsO51ArDuQ44+KvR2jow: bets $2
/6In1zC3WtgwxDcueWzZWg: calls $2
M+7+BTmX5vZatHVuoRB1nA: folds
*** TURN *** [Jd Ac 7h] [8c]
QtFsO51ArDuQ44+KvR2jow: checks
/6In1zC3WtgwxDcueWzZWg: bets $3
DSM67hHHq1XFoEOi9p8Alw has returned
QtFsO51ArDuQ44+KvR2jow: folds
/6In1zC3WtgwxDcueWzZWg collected $6.90 from pot
/6In1zC3WtgwxDcueWzZWg: doesn't show hand
*** SUMMARY ***
Total pot $7.25 | Rake $0.35
Board [Jd Ac 7h 8c]
Seat 2: RjBdQ6w31rgcy0o24VLR6w folded before Flop (didn't bet)
Seat 3: mSD1pginDsyHG5PDfqzphw folded before Flop (didn't bet)
Seat 4: uw9QayAAxLM3Hb+HR7mSkg folded before Flop (didn't bet)
Seat 5: QtFsO51ArDuQ44+KvR2jow folded on the Turn
Seat 6: /6In1zC3WtgwxDcueWzZWg collected ($6.90)
Seat 7: VBnpbzn0dIveV55qKvciew (button) folded before Flop (didn't bet)
Seat 8: HxeBVq06/3Bh/H986sgdbw (small blind) folded before Flop
Seat 9: M+7+BTmX5vZatHVuoRB1nA (big blind) folded on the Flop



PokerStars Game #59938777584:  Hold'em No Limit ($0.25/$0.50) - 2009/07/01 0:23:14 ET
Table 'NCiXr0d5CEKBQr/cZgLhbA' 9-max Seat #1 is the button
Seat 1: RjBdQ6w31rgcy0o24VLR6w ($9.25 in chips)
Seat 2: ulxuJchBV9iguXg0FUonfg ($40.30 in chips)
Seat 3: xZCXQSXlrZkp3pZizzVXCw ($55.65 in chips)
Seat 4: CL4d+tvzcd4utdQxlPLOmg ($31.05 in chips)
Seat 5: zE9cVigS2nW/Ljy4K4bUQA ($40.25 in chips)
Seat 6: SKnJuWHScqetA/qG5p+wCg ($30 in chips)
Seat 7: M+7+BTmX5vZatHVuoRB1nA ($49.25 in chips)
Seat 8: 1MJUKc3cc0QmUoz1JZLR2w ($54.35 in chips)
ulxuJchBV9iguXg0FUonfg: posts small blind $0.25
xZCXQSXlrZkp3pZizzVXCw: posts big blind $0.50
4WLZvqBn5qv5tds5kt5A1Q: sits out
*** HOLE CARDS ***
CL4d+tvzcd4utdQxlPLOmg: folds
zE9cVigS2nW/Ljy4K4bUQA: folds
SKnJuWHScqetA/qG5p+wCg: calls $0.50
M+7+BTmX5vZatHVuoRB1nA: folds
1MJUKc3cc0QmUoz1JZLR2w: folds
RjBdQ6w31rgcy0o24VLR6w: folds
ulxuJchBV9iguXg0FUonfg: folds
xZCXQSXlrZkp3pZizzVXCw: raises $2 to $2.50
SKnJuWHScqetA/qG5p+wCg: folds
xZCXQSXlrZkp3pZizzVXCw collected $1.25 from pot
*** SUMMARY ***
Total pot $1.25 | Rake $0
Seat 1: RjBdQ6w31rgcy0o24VLR6w (button) folded before Flop (didn't bet)
Seat 2: ulxuJchBV9iguXg0FUonfg (small blind) folded before Flop
Seat 3: xZCXQSXlrZkp3pZizzVXCw (big blind) collected ($1.25)
Seat 4: CL4d+tvzcd4utdQxlPLOmg folded before Flop (didn't bet)
Seat 5: zE9cVigS2nW/Ljy4K4bUQA folded before Flop (didn't bet)
Seat 6: SKnJuWHScqetA/qG5p+wCg folded before Flop
Seat 7: M+7+BTmX5vZatHVuoRB1nA folded before Flop (didn't bet)
Seat 8: 1MJUKc3cc0QmUoz1JZLR2w folded before Flop (didn't bet)



PokerStars Game #59938778520:  Hold'em No Limit ($0.25/$0.50) - 2009/07/01 0:23:16 ET
Table '+z1aekfHkpp09pc8F9aViw' 6-max Seat #2 is the button
Seat 1: wOyVV9M/oyiw3YaOjNZ05w ($50.75 in chips)
Seat 2: M6xK/VklCvdyyrmvzATlxQ ($29.95 in chips)
Seat 3: uUznlIMFnRUvwrBhYF73KA ($62.75 in chips)
Seat 4: RowCSpSURHTOL/dcjg/Iug ($50.70 in chips)
Seat 5: crjGpJEzSZgD38FoE3VMGg ($59.15 in chips)
Seat 6: 686aeHikcJlgKkSuIFdcXQ ($70.10 in chips)
uUznlIMFnRUvwrBhYF73KA: posts small blind $0.25
RowCSpSURHTOL/dcjg/Iug: posts big blind $0.50
*** HOLE CARDS ***
crjGpJEzSZgD38FoE3VMGg: raises $1.50 to $2
686aeHikcJlgKkSuIFdcXQ: folds
wOyVV9M/oyiw3YaOjNZ05w: folds
M6xK/VklCvdyyrmvzATlxQ: folds
uUznlIMFnRUvwrBhYF73KA: folds
RowCSpSURHTOL/dcjg/Iug: folds
crjGpJEzSZgD38FoE3VMGg collected $1.25 from pot
*** SUMMARY ***
Total pot $1.25 | Rake $0
Seat 1: wOyVV9M/oyiw3YaOjNZ05w folded before Flop (didn't bet)
Seat 2: M6xK/VklCvdyyrmvzATlxQ (button) folded before Flop (didn't bet)
Seat 3: uUznlIMFnRUvwrBhYF73KA (small blind) folded before Flop
Seat 4: RowCSpSURHTOL/dcjg/Iug (big blind) folded before Flop
Seat 5: crjGpJEzSZgD38FoE3VMGg collected ($1.25)
Seat 6: 686aeHikcJlgKkSuIFdcXQ folded before Flop (didn't bet)



PokerStars Game #59938779180:  Hold'em No Limit ($0.25/$0.50) - 2009/07/01 0:23:17 ET
Table '0AhP5FLi4ySROVJ/ycT1Qw' 2-max Seat #2 is the button
Seat 1: 38ZztDUK6IU5WCK+BN74Rw ($93 in chips)
Seat 2: 46qCyJ6evTkHo9al5sBMNA ($86.60 in chips)
46qCyJ6evTkHo9al5sBMNA: posts small blind $0.25
38ZztDUK6IU5WCK+BN74Rw: posts big blind $0.50
*** HOLE CARDS ***
46qCyJ6evTkHo9al5sBMNA: raises $1.50 to $2
38ZztDUK6IU5WCK+BN74Rw: folds
46qCyJ6evTkHo9al5sBMNA collected $1 from pot
46qCyJ6evTkHo9al5sBMNA: doesn't show hand
*** SUMMARY ***
Total pot $1 | Rake $0
Seat 1: 38ZztDUK6IU5WCK+BN74Rw (big blind) folded before Flop
Seat 2: 46qCyJ6evTkHo9al5sBMNA (button) (small blind) collected ($1)



PokerStars Game #59938779468:  Hold'em No Limit ($0.25/$0.50) - 2009/07/01 0:23:17 ET
Table 'ZYwMb9E6tY50Qm+iNbXRYw' 2-max Seat #2 is the button
Seat 1: DXLfRb8KDZWmrztw2bwtFw ($13.55 in chips)
Seat 2: 16tvT7AYgZ2LgiGFcvFKQg ($18.05 in chips)
16tvT7AYgZ2LgiGFcvFKQg: posts small blind $0.25
DXLfRb8KDZWmrztw2bwtFw: posts big blind $0.50
*** HOLE CARDS ***
16tvT7AYgZ2LgiGFcvFKQg: raises $0.50 to $1
DXLfRb8KDZWmrztw2bwtFw: calls $0.50
*** FLOP *** [Td 6d 5s]
DXLfRb8KDZWmrztw2bwtFw: bets $2
16tvT7AYgZ2LgiGFcvFKQg: raises $2 to $4
DXLfRb8KDZWmrztw2bwtFw: calls $2
*** TURN *** [Td 6d 5s] [5c]
DXLfRb8KDZWmrztw2bwtFw: bets $2
16tvT7AYgZ2LgiGFcvFKQg: calls $2
*** RIVER *** [Td 6d 5s 5c] [6c]
DXLfRb8KDZWmrztw2bwtFw: bets $2
16tvT7AYgZ2LgiGFcvFKQg: calls $2
*** SHOW DOWN ***
DXLfRb8KDZWmrztw2bwtFw: shows [7h Th] (two pair, Tens and Sixes)
16tvT7AYgZ2LgiGFcvFKQg: shows [Tc 2h] (two pair, Tens and Sixes - lower kicker)
DXLfRb8KDZWmrztw2bwtFw collected $17.50 from pot
*** SUMMARY ***
Total pot $18 | Rake $0.50
Board [Td 6d 5s 5c 6c]
Seat 1: DXLfRb8KDZWmrztw2bwtFw (big blind) showed [7h Th] and won ($17.50) with two pair, Tens and Sixes
Seat 2: 16tvT7AYgZ2LgiGFcvFKQg (button) (small blind) showed [Tc 2h] and lost with two pair, Tens and Sixes



PokerStars Game #59938779428:  Hold'em No Limit ($0.25/$0.50) - 2009/07/01 0:23:17 ET
Table 'dVmkPtk5nWTfXApFsnhIOg' 2-max Seat #2 is the button
Seat 1: bypIyrYcAAifLfhZpGlKLA ($50.50 in chips)
Seat 2: rPToQDbLWB+dKnz7fcQSIg ($30.90 in chips)
rPToQDbLWB+dKnz7fcQSIg: posts small blind $0.25
bypIyrYcAAifLfhZpGlKLA: posts big blind $0.50
*** HOLE CARDS ***
rPToQDbLWB+dKnz7fcQSIg: folds
bypIyrYcAAifLfhZpGlKLA collected $0.50 from pot
bypIyrYcAAifLfhZpGlKLA: doesn't show hand
*** SUMMARY ***
Total pot $0.50 | Rake $0
Seat 1: bypIyrYcAAifLfhZpGlKLA (big blind) collected ($0.50)
Seat 2: rPToQDbLWB+dKnz7fcQSIg (button) (small blind) folded before Flop



PokerStars Game #59938779730:  Hold'em No Limit ($0.25/$0.50) - 2009/07/01 0:23:17 ET
Table '+dXkOAQyS8j9PQZusUTMpg' 2-max Seat #2 is the button
Seat 1: XFa6sBGjP2gxoIvxR3fZIg ($57.25 in chips)
Seat 2: 5IBeOgaApY1Bvzv2P8X4EA ($50.50 in chips)
5IBeOgaApY1Bvzv2P8X4EA: posts small blind $0.25
XFa6sBGjP2gxoIvxR3fZIg: posts big blind $0.50
*** HOLE CARDS ***
5IBeOgaApY1Bvzv2P8X4EA: calls $0.25
XFa6sBGjP2gxoIvxR3fZIg: raises $2 to $2.50
5IBeOgaApY1Bvzv2P8X4EA: raises $3.50 to $6
XFa6sBGjP2gxoIvxR3fZIg: calls $3.50
*** FLOP *** [Ts Kh Ac]
XFa6sBGjP2gxoIvxR3fZIg: checks
5IBeOgaApY1Bvzv2P8X4EA: bets $4.50
XFa6sBGjP2gxoIvxR3fZIg: calls $4.50
*** TURN *** [Ts Kh Ac] [Jc]
XFa6sBGjP2gxoIvxR3fZIg: checks
5IBeOgaApY1Bvzv2P8X4EA: checks
*** RIVER *** [Ts Kh Ac Jc] [Qd]
XFa6sBGjP2gxoIvxR3fZIg: checks
5IBeOgaApY1Bvzv2P8X4EA: checks
*** SHOW DOWN ***
XFa6sBGjP2gxoIvxR3fZIg: shows [Ks Js] (a straight, Ten to Ace)
5IBeOgaApY1Bvzv2P8X4EA: shows [Jh Ah] (a straight, Ten to Ace)
XFa6sBGjP2gxoIvxR3fZIg collected $10.25 from pot
5IBeOgaApY1Bvzv2P8X4EA collected $10.25 from pot
*** SUMMARY ***
Total pot $21 | Rake $0.50
Board [Ts Kh Ac Jc Qd]
Seat 1: XFa6sBGjP2gxoIvxR3fZIg (big blind) showed [Ks Js] and won ($10.25) with a straight, Ten to Ace
Seat 2: 5IBeOgaApY1Bvzv2P8X4EA (button) (small blind) showed [Jh Ah] and won ($10.25) with a straight, Ten to Ace



PokerStars Game #59938779850:  Hold'em No Limit ($0.25/$0.50) - 2009/07/01 0:23:18 ET
Table 'mTxf8gPLgffN3Iwfm7Icfg' 2-max Seat #1 is the button
Seat 1: Do9Rlu1R5u/AcRtMTl8SYg ($74.05 in chips)
Seat 2: EMc5LPgVaded4Qc77vm0fw ($87.15 in chips)
Do9Rlu1R5u/AcRtMTl8SYg: posts small blind $0.25
EMc5LPgVaded4Qc77vm0fw: posts big blind $0.50
*** HOLE CARDS ***
Do9Rlu1R5u/AcRtMTl8SYg: calls $0.25
EMc5LPgVaded4Qc77vm0fw: checks
*** FLOP *** [3h Ad 6s]
EMc5LPgVaded4Qc77vm0fw: checks
Do9Rlu1R5u/AcRtMTl8SYg: checks
*** TURN *** [3h Ad 6s] [Ts]
EMc5LPgVaded4Qc77vm0fw: checks
Do9Rlu1R5u/AcRtMTl8SYg: checks
*** RIVER *** [3h Ad 6s Ts] [3d]
EMc5LPgVaded4Qc77vm0fw: checks
Do9Rlu1R5u/AcRtMTl8SYg: bets $1
EMc5LPgVaded4Qc77vm0fw: calls $1
*** SHOW DOWN ***
Do9Rlu1R5u/AcRtMTl8SYg: shows [2c 3c] (three of a kind, Threes)
EMc5LPgVaded4Qc77vm0fw: mucks hand
Do9Rlu1R5u/AcRtMTl8SYg collected $2.90 from pot
*** SUMMARY ***
Total pot $3 | Rake $0.10
Board [3h Ad 6s Ts 3d]
Seat 1: Do9Rlu1R5u/AcRtMTl8SYg (button) (small blind) showed [2c 3c] and won ($2.90) with three of a kind, Threes
Seat 2: EMc5LPgVaded4Qc77vm0fw (big blind) mucked



PokerStars Game #59938780920:  Hold'em No Limit ($0.25/$0.50) - 2009/07/01 0:23:19 ET
Table 'QOgaEqMcJ73pcUMMxoisUg' 6-max Seat #4 is the button
Seat 1: RFefXIDyFvNtJLq+CloCzA ($40.95 in chips)
Seat 2: Im2p1Nt83UKSqv5c9frm4Q ($50 in chips)
Seat 3: wUZNozoIDYf+16hp4nn6dw ($46.45 in chips)
Seat 4: zAcsDhG/T128Vn7XGVSgKg ($63.30 in chips)
Seat 5: 6vNxrjjCl6FwfaaymM9jjg ($15 in chips)
Seat 6: s83dnhZ6VC53vY0/f6OV/g ($42.05 in chips)
6vNxrjjCl6FwfaaymM9jjg: posts small blind $0.25
s83dnhZ6VC53vY0/f6OV/g: posts big blind $0.50
Im2p1Nt83UKSqv5c9frm4Q: posts small blind $0.25
*** HOLE CARDS ***
RFefXIDyFvNtJLq+CloCzA: folds
RFefXIDyFvNtJLq+CloCzA leaves the table
Im2p1Nt83UKSqv5c9frm4Q: folds
wUZNozoIDYf+16hp4nn6dw: raises $1.50 to $2
zAcsDhG/T128Vn7XGVSgKg: folds
6vNxrjjCl6FwfaaymM9jjg: raises $5.50 to $7.50
s83dnhZ6VC53vY0/f6OV/g: folds
wUZNozoIDYf+16hp4nn6dw: calls $5.50
*** FLOP *** [6d 2d Td]
6vNxrjjCl6FwfaaymM9jjg: bets $7.50 and is all-in
wUZNozoIDYf+16hp4nn6dw: calls $7.50
*** TURN *** [6d 2d Td] [7s]
*** RIVER *** [6d 2d Td 7s] [8d]
*** SHOW DOWN ***
6vNxrjjCl6FwfaaymM9jjg: shows [Kc Ad] (a flush, Ace high)
wUZNozoIDYf+16hp4nn6dw: mucks hand
UaC1G3O4HWbowgSfeYnkog joins the table at seat #1
6vNxrjjCl6FwfaaymM9jjg collected $29.25 from pot
*** SUMMARY ***
Total pot $30.75 | Rake $1.50
Board [6d 2d Td 7s 8d]
Seat 1: RFefXIDyFvNtJLq+CloCzA folded before Flop (didn't bet)
Seat 2: Im2p1Nt83UKSqv5c9frm4Q folded before Flop
Seat 3: wUZNozoIDYf+16hp4nn6dw mucked
Seat 4: zAcsDhG/T128Vn7XGVSgKg (button) folded before Flop (didn't bet)
Seat 5: 6vNxrjjCl6FwfaaymM9jjg (small blind) showed [Kc Ad] and won ($29.25) with a flush, Ace high
Seat 6: s83dnhZ6VC53vY0/f6OV/g (big blind) folded before Flop



PokerStars Game #59938781634:  Hold'em No Limit ($0.25/$0.50) - 2009/07/01 0:23:20 ET
Table 'GfL/No5u5PoEnU39lP5pQg' 6-max Seat #5 is the button
Seat 1: 1WUCqNG+p+vfWRTXNu4ljw ($50 in chips)
Seat 2: uVwggSetzp7d+eVgowO3vg ($44.75 in chips)
Seat 3: qNezhXOOUXqwG7b9X5XJAA ($50 in chips)
Seat 5: crjGpJEzSZgD38FoE3VMGg ($54.30 in chips)
Seat 6: 3wylWYGeXFXcrE4XVrlPng ($81.45 in chips)
3wylWYGeXFXcrE4XVrlPng: posts small blind $0.25
1WUCqNG+p+vfWRTXNu4ljw: posts big blind $0.50
OZ6OtYh5Y53MCH/p0QTn5g: sits out
*** HOLE CARDS ***
uVwggSetzp7d+eVgowO3vg: folds
qNezhXOOUXqwG7b9X5XJAA: folds
crjGpJEzSZgD38FoE3VMGg: folds
3wylWYGeXFXcrE4XVrlPng: raises $0.50 to $1
1WUCqNG+p+vfWRTXNu4ljw: calls $0.50
*** FLOP *** [3h Kh Td]
3wylWYGeXFXcrE4XVrlPng: checks
1WUCqNG+p+vfWRTXNu4ljw: bets $1
3wylWYGeXFXcrE4XVrlPng: folds
1WUCqNG+p+vfWRTXNu4ljw collected $1.90 from pot
*** SUMMARY ***
Total pot $2 | Rake $0.10
Board [3h Kh Td]
Seat 1: 1WUCqNG+p+vfWRTXNu4ljw (big blind) collected ($1.90)
Seat 2: uVwggSetzp7d+eVgowO3vg folded before Flop (didn't bet)
Seat 3: qNezhXOOUXqwG7b9X5XJAA folded before Flop (didn't bet)
Seat 5: crjGpJEzSZgD38FoE3VMGg (button) folded before Flop (didn't bet)
Seat 6: 3wylWYGeXFXcrE4XVrlPng (small blind) folded on the Flop



PokerStars Game #59938781264:  Hold'em No Limit ($0.25/$0.50) - 2009/07/01 0:23:20 ET
Table 'MJxeZCzYELxiIsyUZyT0jw' 6-max Seat #3 is the button
Seat 3: JQZew0FjzS19kTjeNtrE+A ($54.60 in chips)
Seat 4: lP7Q6pewz4C2RsAfKsjdWw ($31.95 in chips)
Seat 5: 3jvoOXNtXE90w2BdfNZwZQ ($50.75 in chips)
Seat 6: TTx3CHxyi0SObcHyMJRp5w ($49.75 in chips)
lP7Q6pewz4C2RsAfKsjdWw: posts small blind $0.25
3jvoOXNtXE90w2BdfNZwZQ: posts big blind $0.50
wOyVV9M/oyiw3YaOjNZ05w: sits out
*** HOLE CARDS ***
TTx3CHxyi0SObcHyMJRp5w: folds
JQZew0FjzS19kTjeNtrE+A: folds
lP7Q6pewz4C2RsAfKsjdWw: calls $0.25
3jvoOXNtXE90w2BdfNZwZQ: raises $1.50 to $2
lP7Q6pewz4C2RsAfKsjdWw: calls $1.50
*** FLOP *** [7s 6h Js]
lP7Q6pewz4C2RsAfKsjdWw: checks
3jvoOXNtXE90w2BdfNZwZQ: checks
*** TURN *** [7s 6h Js] [Td]
lP7Q6pewz4C2RsAfKsjdWw: checks
3jvoOXNtXE90w2BdfNZwZQ: bets $2.50
lP7Q6pewz4C2RsAfKsjdWw: folds
3jvoOXNtXE90w2BdfNZwZQ collected $3.80 from pot
3jvoOXNtXE90w2BdfNZwZQ: doesn't show hand
*** SUMMARY ***
Total pot $4 | Rake $0.20
Board [7s 6h Js Td]
Seat 3: JQZew0FjzS19kTjeNtrE+A (button) folded before Flop (didn't bet)
Seat 4: lP7Q6pewz4C2RsAfKsjdWw (small blind) folded on the Turn
Seat 5: 3jvoOXNtXE90w2BdfNZwZQ (big blind) collected ($3.80)
Seat 6: TTx3CHxyi0SObcHyMJRp5w folded before Flop (didn't bet)



PokerStars Game #59938782364:  Hold'em No Limit ($0.25/$0.50) - 2009/07/01 0:23:21 ET
Table 'raOT4/ipuZgzjfKHC+jD9g' 2-max Seat #1 is the button
Seat 1: IuwLemwLhc9fvrwBGs0AMA ($10.45 in chips)
Seat 2: Udr5juWSWUgTu1NlRhjMdA ($11.60 in chips)
IuwLemwLhc9fvrwBGs0AMA: posts small blind $0.25
Udr5juWSWUgTu1NlRhjMdA: posts big blind $0.50
*** HOLE CARDS ***
IuwLemwLhc9fvrwBGs0AMA: folds
Udr5juWSWUgTu1NlRhjMdA collected $0.50 from pot
Udr5juWSWUgTu1NlRhjMdA: doesn't show hand
*** SUMMARY ***
Total pot $0.50 | Rake $0
Seat 1: IuwLemwLhc9fvrwBGs0AMA (button) (small blind) folded before Flop
Seat 2: Udr5juWSWUgTu1NlRhjMdA (big blind) collected ($0.50)



PokerStars Game #59938782622:  Hold'em No Limit ($0.25/$0.50) - 2009/07/01 0:23:22 ET
Table '37qXEp3oe+er5q4CZip9eQ' 6-max Seat #5 is the button
Seat 1: oqOqoO2AyCZenUghCxMDxw ($50 in chips)
Seat 3: Rt6KgtZ8YaJoTc3FPim00w ($92.90 in chips)
Seat 4: AYb7QG0KzyicbOC0ZROE3Q ($15.40 in chips)
Seat 5: VOmI0x4dDPnTESZd5B4d1Q ($46.55 in chips)
Seat 6: f7zPpUQp9hHZgqhEvrUWQw ($50.15 in chips)
f7zPpUQp9hHZgqhEvrUWQw: posts small blind $0.25
oqOqoO2AyCZenUghCxMDxw: posts big blind $0.50
*** HOLE CARDS ***
Rt6KgtZ8YaJoTc3FPim00w: folds
AYb7QG0KzyicbOC0ZROE3Q: folds
AYb7QG0KzyicbOC0ZROE3Q leaves the table
VOmI0x4dDPnTESZd5B4d1Q: raises $1.50 to $2
f7zPpUQp9hHZgqhEvrUWQw: folds
oqOqoO2AyCZenUghCxMDxw: calls $1.50
*** FLOP *** [As 8s Tc]
oqOqoO2AyCZenUghCxMDxw: bets $3
VOmI0x4dDPnTESZd5B4d1Q: folds
oqOqoO2AyCZenUghCxMDxw collected $4.05 from pot
*** SUMMARY ***
Total pot $4.25 | Rake $0.20
Board [As 8s Tc]
Seat 1: oqOqoO2AyCZenUghCxMDxw (big blind) collected ($4.05)
Seat 3: Rt6KgtZ8YaJoTc3FPim00w folded before Flop (didn't bet)
Seat 4: AYb7QG0KzyicbOC0ZROE3Q folded before Flop (didn't bet)
Seat 5: VOmI0x4dDPnTESZd5B4d1Q (button) folded on the Flop
Seat 6: f7zPpUQp9hHZgqhEvrUWQw (small blind) folded before Flop



PokerStars Game #59938784096:  Hold'em No Limit ($0.25/$0.50) - 2009/07/01 0:23:24 ET
Table 'E7bWJ45aoFXRpyRv2gw+Ig' 2-max Seat #1 is the button
Seat 1: FRkiRasEGlHUeLrEl+k/nA ($69.50 in chips)
Seat 2: 3Wro85I7472vJ4Wkpneo9A ($109.25 in chips)
FRkiRasEGlHUeLrEl+k/nA: posts small blind $0.25
3Wro85I7472vJ4Wkpneo9A: posts big blind $0.50
*** HOLE CARDS ***
FRkiRasEGlHUeLrEl+k/nA: folds
3Wro85I7472vJ4Wkpneo9A collected $0.50 from pot
3Wro85I7472vJ4Wkpneo9A: doesn't show hand
*** SUMMARY ***
Total pot $0.50 | Rake $0
Seat 1: FRkiRasEGlHUeLrEl+k/nA (button) (small blind) folded before Flop
Seat 2: 3Wro85I7472vJ4Wkpneo9A (big blind) collected ($0.50)



PokerStars Game #59938785322:  Hold'em No Limit ($0.25/$0.50) - 2009/07/01 0:23:26 ET
Table '0AhP5FLi4ySROVJ/ycT1Qw' 2-max Seat #1 is the button
Seat 1: 38ZztDUK6IU5WCK+BN74Rw ($92.50 in chips)
Seat 2: 46qCyJ6evTkHo9al5sBMNA ($87.10 in chips)
38ZztDUK6IU5WCK+BN74Rw: posts small blind $0.25
46qCyJ6evTkHo9al5sBMNA: posts big blind $0.50
*** HOLE CARDS ***
38ZztDUK6IU5WCK+BN74Rw: raises $1 to $1.50
46qCyJ6evTkHo9al5sBMNA: folds
38ZztDUK6IU5WCK+BN74Rw collected $1 from pot
*** SUMMARY ***
Total pot $1 | Rake $0
Seat 1: 38ZztDUK6IU5WCK+BN74Rw (button) (small blind) collected ($1)
Seat 2: 46qCyJ6evTkHo9al5sBMNA (big blind) folded before Flop



PokerStars Game #59938786592:  Hold'em No Limit ($0.25/$0.50) - 2009/07/01 0:23:28 ET
Table '8YYaUJqyk4NgBvNkL7mj/Q' 2-max Seat #1 is the button
Seat 1: Fp/oksNpipCrD2MJ2pH20g ($21.70 in chips)
Seat 2: dkC7J+qbyqk0qCcmJbEPPw ($50 in chips)
Fp/oksNpipCrD2MJ2pH20g: posts small blind $0.25
dkC7J+qbyqk0qCcmJbEPPw: posts big blind $0.50
*** HOLE CARDS ***
Fp/oksNpipCrD2MJ2pH20g: raises $1 to $1.50
dkC7J+qbyqk0qCcmJbEPPw: calls $1
*** FLOP *** [7d 2d Ah]
dkC7J+qbyqk0qCcmJbEPPw: checks
Fp/oksNpipCrD2MJ2pH20g: bets $1
dkC7J+qbyqk0qCcmJbEPPw: folds
Fp/oksNpipCrD2MJ2pH20g collected $2.85 from pot
Fp/oksNpipCrD2MJ2pH20g: doesn't show hand
*** SUMMARY ***
Total pot $3 | Rake $0.15
Board [7d 2d Ah]
Seat 1: Fp/oksNpipCrD2MJ2pH20g (button) (small blind) collected ($2.85)
Seat 2: dkC7J+qbyqk0qCcmJbEPPw (big blind) folded on the Flop



PokerStars Game #59938786838:  Hold'em No Limit ($0.25/$0.50) - 2009/07/01 0:23:28 ET
Table 'tyR5AZNKV8Aadbrnrnlg7g' 6-max Seat #4 is the button
Seat 1: R+KjpH/wSjDLhtIy9+edNA ($54.70 in chips)
Seat 2: 58zdeSBSuSFX/qZfhc7YmA ($29.10 in chips)
Seat 3: jUhx+m+V7qfbLZTjgwZByg ($30.45 in chips)
Seat 4: Rt6KgtZ8YaJoTc3FPim00w ($84.25 in chips)
Seat 5: wOyVV9M/oyiw3YaOjNZ05w ($50 in chips)
Seat 6: DMQLAmut/l19xN5STQndFg ($7.80 in chips)
wOyVV9M/oyiw3YaOjNZ05w: posts small blind $0.25
DMQLAmut/l19xN5STQndFg: posts big blind $0.50
*** HOLE CARDS ***
R+KjpH/wSjDLhtIy9+edNA: raises $1 to $1.50
58zdeSBSuSFX/qZfhc7YmA: folds
jUhx+m+V7qfbLZTjgwZByg: folds
Rt6KgtZ8YaJoTc3FPim00w: folds
wOyVV9M/oyiw3YaOjNZ05w: folds
DMQLAmut/l19xN5STQndFg: calls $1
*** FLOP *** [3h 3c 4s]
DMQLAmut/l19xN5STQndFg: checks
R+KjpH/wSjDLhtIy9+edNA: bets $3
DMQLAmut/l19xN5STQndFg: folds
R+KjpH/wSjDLhtIy9+edNA collected $3.10 from pot
R+KjpH/wSjDLhtIy9+edNA: doesn't show hand
*** SUMMARY ***
Total pot $3.25 | Rake $0.15
Board [3h 3c 4s]
Seat 1: R+KjpH/wSjDLhtIy9+edNA collected ($3.10)
Seat 2: 58zdeSBSuSFX/qZfhc7YmA folded before Flop (didn't bet)
Seat 3: jUhx+m+V7qfbLZTjgwZByg folded before Flop (didn't bet)
Seat 4: Rt6KgtZ8YaJoTc3FPim00w (button) folded before Flop (didn't bet)
Seat 5: wOyVV9M/oyiw3YaOjNZ05w (small blind) folded before Flop
Seat 6: DMQLAmut/l19xN5STQndFg (big blind) folded on the Flop



PokerStars Game #59938787352:  Hold'em No Limit ($0.25/$0.50) - 2009/07/01 0:23:29 ET
Table 'raOT4/ipuZgzjfKHC+jD9g' 2-max Seat #2 is the button
Seat 1: IuwLemwLhc9fvrwBGs0AMA ($10.20 in chips)
Seat 2: Udr5juWSWUgTu1NlRhjMdA ($11.85 in chips)
Udr5juWSWUgTu1NlRhjMdA: posts small blind $0.25
IuwLemwLhc9fvrwBGs0AMA: posts big blind $0.50
*** HOLE CARDS ***
Udr5juWSWUgTu1NlRhjMdA: calls $0.25
IuwLemwLhc9fvrwBGs0AMA: checks
*** FLOP *** [9c 2s 9d]
IuwLemwLhc9fvrwBGs0AMA: bets $1
Udr5juWSWUgTu1NlRhjMdA: calls $1
*** TURN *** [9c 2s 9d] [Ks]
IuwLemwLhc9fvrwBGs0AMA: checks
Udr5juWSWUgTu1NlRhjMdA: bets $1
IuwLemwLhc9fvrwBGs0AMA: calls $1
*** RIVER *** [9c 2s 9d Ks] [3d]
IuwLemwLhc9fvrwBGs0AMA: checks
Udr5juWSWUgTu1NlRhjMdA: bets $2
IuwLemwLhc9fvrwBGs0AMA: calls $2
*** SHOW DOWN ***
Udr5juWSWUgTu1NlRhjMdA: shows [9h 6c] (three of a kind, Nines)
IuwLemwLhc9fvrwBGs0AMA: mucks hand
Udr5juWSWUgTu1NlRhjMdA collected $8.60 from pot
*** SUMMARY ***
Total pot $9 | Rake $0.40
Board [9c 2s 9d Ks 3d]
Seat 1: IuwLemwLhc9fvrwBGs0AMA (big blind) mucked
Seat 2: Udr5juWSWUgTu1NlRhjMdA (button) (small blind) showed [9h 6c] and won ($8.60) with three of a kind, Nines



PokerStars Game #59938787820:  Hold'em No Limit ($0.25/$0.50) - 2009/07/01 0:23:29 ET
Table '5EmHi+fnatGQQShcNmzOZQ' 6-max Seat #3 is the button
Seat 1: SwPczQo3cOtwEzhJrfO2cQ ($22.65 in chips)
Seat 3: L9qfLYXrczhAPd/VckgsWw ($62.85 in chips)
Seat 4: wOyVV9M/oyiw3YaOjNZ05w ($51.45 in chips)
Seat 5: kxPhs4ePFqMy52CInAJ2aw ($49.25 in chips)
Seat 6: 686aeHikcJlgKkSuIFdcXQ ($156.60 in chips)
wOyVV9M/oyiw3YaOjNZ05w: posts small blind $0.25
kxPhs4ePFqMy52CInAJ2aw: posts big blind $0.50
*** HOLE CARDS ***
686aeHikcJlgKkSuIFdcXQ: folds
SwPczQo3cOtwEzhJrfO2cQ: raises $0.50 to $1
L9qfLYXrczhAPd/VckgsWw: calls $1
wOyVV9M/oyiw3YaOjNZ05w: calls $0.75
kxPhs4ePFqMy52CInAJ2aw: calls $0.50
*** FLOP *** [6h Qs 4c]
wOyVV9M/oyiw3YaOjNZ05w: checks
kxPhs4ePFqMy52CInAJ2aw: checks
SwPczQo3cOtwEzhJrfO2cQ: bets $1.50
L9qfLYXrczhAPd/VckgsWw: calls $1.50
wOyVV9M/oyiw3YaOjNZ05w: folds
kxPhs4ePFqMy52CInAJ2aw: folds
*** TURN *** [6h Qs 4c] [Jc]
SwPczQo3cOtwEzhJrfO2cQ: bets $1.50
L9qfLYXrczhAPd/VckgsWw: calls $1.50
*** RIVER *** [6h Qs 4c Jc] [3s]
SwPczQo3cOtwEzhJrfO2cQ: bets $7.50
L9qfLYXrczhAPd/VckgsWw: folds
SwPczQo3cOtwEzhJrfO2cQ collected $9.55 from pot
*** SUMMARY ***
Total pot $10 | Rake $0.45
Board [6h Qs 4c Jc 3s]
Seat 1: SwPczQo3cOtwEzhJrfO2cQ collected ($9.55)
Seat 3: L9qfLYXrczhAPd/VckgsWw (button) folded on the River
Seat 4: wOyVV9M/oyiw3YaOjNZ05w (small blind) folded on the Flop
Seat 5: kxPhs4ePFqMy52CInAJ2aw (big blind) folded on the Flop
Seat 6: 686aeHikcJlgKkSuIFdcXQ folded before Flop (didn't bet)



PokerStars Game #59938787824:  Hold'em No Limit ($0.25/$0.50) - 2009/07/01 0:23:29 ET
Table 'fx6MqwfYAj/Rt86hBz2L3Q' 9-max Seat #9 is the button
Seat 1: jf2c/o9gI7Xj0GleCSMj9g ($29.50 in chips)
Seat 2: C3rGXblctNcWI6JYPHhaEg ($11 in chips)
Seat 3: iadBi5AEt7gTBXbDSSnMYQ ($56.10 in chips)
Seat 4: gPEN9Zp33YTm/mu9/SYP1w ($25.45 in chips)
Seat 5: iAISe3dVeua8PUn2wwgDHw ($26.50 in chips)
Seat 6: VelaednozEGCpceHSFUsAg ($21.80 in chips)
Seat 7: bkXkL3pmapikPQQRNPZSEA ($8.25 in chips)
Seat 8: 6ol/q1A4zYU6qXbZnTzPfQ ($20.30 in chips)
Seat 9: HZkVla4kK2SI42CVrPZ/ig ($9.25 in chips)
jf2c/o9gI7Xj0GleCSMj9g: posts small blind $0.25
C3rGXblctNcWI6JYPHhaEg: posts big blind $0.50
*** HOLE CARDS ***
iadBi5AEt7gTBXbDSSnMYQ: folds
gPEN9Zp33YTm/mu9/SYP1w: folds
iAISe3dVeua8PUn2wwgDHw: folds
VelaednozEGCpceHSFUsAg: calls $0.50
bkXkL3pmapikPQQRNPZSEA: raises $0.50 to $1
6ol/q1A4zYU6qXbZnTzPfQ: folds
HZkVla4kK2SI42CVrPZ/ig: folds
jf2c/o9gI7Xj0GleCSMj9g: calls $0.75
C3rGXblctNcWI6JYPHhaEg: calls $0.50
VelaednozEGCpceHSFUsAg: calls $0.50
*** FLOP *** [7h 9s 6d]
jf2c/o9gI7Xj0GleCSMj9g: checks
C3rGXblctNcWI6JYPHhaEg: checks
VelaednozEGCpceHSFUsAg: bets $4
bkXkL3pmapikPQQRNPZSEA: folds
jf2c/o9gI7Xj0GleCSMj9g: raises $7 to $11
C3rGXblctNcWI6JYPHhaEg: folds
VelaednozEGCpceHSFUsAg: raises $9.80 to $20.80 and is all-in
jf2c/o9gI7Xj0GleCSMj9g: calls $9.80
*** TURN *** [7h 9s 6d] [9d]
*** RIVER *** [7h 9s 6d 9d] [Kc]
*** SHOW DOWN ***
jf2c/o9gI7Xj0GleCSMj9g: shows [9c 6c] (a full house, Nines full of Sixes)
VelaednozEGCpceHSFUsAg: mucks hand
jf2c/o9gI7Xj0GleCSMj9g collected $43.35 from pot
*** SUMMARY ***
Total pot $45.60 | Rake $2.25
Board [7h 9s 6d 9d Kc]
Seat 1: jf2c/o9gI7Xj0GleCSMj9g (small blind) showed [9c 6c] and won ($43.35) with a full house, Nines full of Sixes
Seat 2: C3rGXblctNcWI6JYPHhaEg (big blind) folded on the Flop
Seat 3: iadBi5AEt7gTBXbDSSnMYQ folded before Flop (didn't bet)
Seat 4: gPEN9Zp33YTm/mu9/SYP1w folded before Flop (didn't bet)
Seat 5: iAISe3dVeua8PUn2wwgDHw folded before Flop (didn't bet)
Seat 6: VelaednozEGCpceHSFUsAg mucked
Seat 7: bkXkL3pmapikPQQRNPZSEA folded on the Flop
Seat 8: 6ol/q1A4zYU6qXbZnTzPfQ folded before Flop (didn't bet)
Seat 9: HZkVla4kK2SI42CVrPZ/ig (button) folded before Flop (didn't bet)



PokerStars Game #59938788100:  Hold'em No Limit ($0.25/$0.50) - 2009/07/01 0:23:30 ET
Table 'E7bWJ45aoFXRpyRv2gw+Ig' 2-max Seat #2 is the button
Seat 1: FRkiRasEGlHUeLrEl+k/nA ($69.25 in chips)
Seat 2: 3Wro85I7472vJ4Wkpneo9A ($109.50 in chips)
3Wro85I7472vJ4Wkpneo9A: posts small blind $0.25
FRkiRasEGlHUeLrEl+k/nA: posts big blind $0.50
*** HOLE CARDS ***
3Wro85I7472vJ4Wkpneo9A: folds
FRkiRasEGlHUeLrEl+k/nA collected $0.50 from pot
FRkiRasEGlHUeLrEl+k/nA: doesn't show hand
*** SUMMARY ***
Total pot $0.50 | Rake $0
Seat 1: FRkiRasEGlHUeLrEl+k/nA (big blind) collected ($0.50)
Seat 2: 3Wro85I7472vJ4Wkpneo9A (button) (small blind) folded before Flop



PokerStars Game #59938788708:  Hold'em No Limit ($0.25/$0.50) - 2009/07/01 0:23:31 ET
Table 'dVmkPtk5nWTfXApFsnhIOg' 2-max Seat #1 is the button
Seat 1: bypIyrYcAAifLfhZpGlKLA ($50.75 in chips)
Seat 2: rPToQDbLWB+dKnz7fcQSIg ($30.65 in chips)
bypIyrYcAAifLfhZpGlKLA: posts small blind $0.25
rPToQDbLWB+dKnz7fcQSIg: posts big blind $0.50
*** HOLE CARDS ***
bypIyrYcAAifLfhZpGlKLA: raises $1 to $1.50
rPToQDbLWB+dKnz7fcQSIg: folds
bypIyrYcAAifLfhZpGlKLA collected $1 from pot
bypIyrYcAAifLfhZpGlKLA: doesn't show hand
*** SUMMARY ***
Total pot $1 | Rake $0
Seat 1: bypIyrYcAAifLfhZpGlKLA (button) (small blind) collected ($1)
Seat 2: rPToQDbLWB+dKnz7fcQSIg (big blind) folded before Flop



PokerStars Game #59938789860:  Hold'em No Limit ($0.25/$0.50) - 2009/07/01 0:23:33 ET
Table 'IeNZOZQ4T6oiaHqFeo6yIA' 2-max Seat #1 is the button
Seat 1: ndd1nfncBkWNitBnsfCoVQ ($84.70 in chips)
Seat 2: A91IUl5JaZROhtfCtnnwYw ($50.45 in chips)
ndd1nfncBkWNitBnsfCoVQ: posts small blind $0.25
A91IUl5JaZROhtfCtnnwYw: posts big blind $0.50
*** HOLE CARDS ***
ndd1nfncBkWNitBnsfCoVQ: raises $1 to $1.50
A91IUl5JaZROhtfCtnnwYw: calls $1
*** FLOP *** [3h Qc 9h]
A91IUl5JaZROhtfCtnnwYw: checks
ndd1nfncBkWNitBnsfCoVQ: bets $2.50
A91IUl5JaZROhtfCtnnwYw: calls $2.50
*** TURN *** [3h Qc 9h] [7c]
A91IUl5JaZROhtfCtnnwYw: checks
ndd1nfncBkWNitBnsfCoVQ: bets $7.50
A91IUl5JaZROhtfCtnnwYw: calls $7.50
*** RIVER *** [3h Qc 9h 7c] [8s]
A91IUl5JaZROhtfCtnnwYw: checks
ndd1nfncBkWNitBnsfCoVQ: bets $18
A91IUl5JaZROhtfCtnnwYw: folds
ndd1nfncBkWNitBnsfCoVQ collected $22.50 from pot
ndd1nfncBkWNitBnsfCoVQ: doesn't show hand
*** SUMMARY ***
Total pot $23 | Rake $0.50
Board [3h Qc 9h 7c 8s]
Seat 1: ndd1nfncBkWNitBnsfCoVQ (button) (small blind) collected ($22.50)
Seat 2: A91IUl5JaZROhtfCtnnwYw (big blind) folded on the River



PokerStars Game #59938790374:  Hold'em No Limit ($0.25/$0.50) - 2009/07/01 0:23:34 ET
Table '0AhP5FLi4ySROVJ/ycT1Qw' 2-max Seat #2 is the button
Seat 1: 38ZztDUK6IU5WCK+BN74Rw ($93 in chips)
Seat 2: 46qCyJ6evTkHo9al5sBMNA ($86.60 in chips)
46qCyJ6evTkHo9al5sBMNA: posts small blind $0.25
38ZztDUK6IU5WCK+BN74Rw: posts big blind $0.50
*** HOLE CARDS ***
46qCyJ6evTkHo9al5sBMNA: raises $1 to $1.50
38ZztDUK6IU5WCK+BN74Rw: folds
46qCyJ6evTkHo9al5sBMNA collected $1 from pot
46qCyJ6evTkHo9al5sBMNA: doesn't show hand
*** SUMMARY ***
Total pot $1 | Rake $0
Seat 1: 38ZztDUK6IU5WCK+BN74Rw (big blind) folded before Flop
Seat 2: 46qCyJ6evTkHo9al5sBMNA (button) (small blind) collected ($1)



PokerStars Game #59938790574:  Hold'em No Limit ($0.25/$0.50) - 2009/07/01 0:23:34 ET
Table 'Nz0Vr7WMHL2g5Uk7dDZjpw' 9-max Seat #3 is the button
Seat 2: XNMDwbXt/Q4jM99AXnbJDw ($50 in chips)
Seat 3: 4QTiNH5fteLgJjx/s6Hy6A ($21.45 in chips)
Seat 4: 5JJVDlaiMnB004o/RqbZZQ ($27 in chips)
Seat 5: WGW0DgjBUXs1ylURHG8vnQ ($11.10 in chips)
Seat 6: k1f0lS7tlMHCLGs0JT34Tg ($8.75 in chips)
Seat 7: KPLH0gELgFe2OuAnhJFI5w ($19.70 in chips)
Seat 8: HkZI6g4zl83TDTA7SRspmQ ($20.95 in chips)
Seat 9: Ak2W6V2TDVIQrvSAy4eD7Q ($25.35 in chips)
5JJVDlaiMnB004o/RqbZZQ: posts small blind $0.25
WGW0DgjBUXs1ylURHG8vnQ: posts big blind $0.50
tLkxo7JgV+WWI0UBw44K5A: sits out
*** HOLE CARDS ***
k1f0lS7tlMHCLGs0JT34Tg: folds
KPLH0gELgFe2OuAnhJFI5w: folds
HkZI6g4zl83TDTA7SRspmQ: folds
Ak2W6V2TDVIQrvSAy4eD7Q: folds
XNMDwbXt/Q4jM99AXnbJDw: folds
4QTiNH5fteLgJjx/s6Hy6A: raises $0.50 to $1
5JJVDlaiMnB004o/RqbZZQ: raises $2.50 to $3.50
WGW0DgjBUXs1ylURHG8vnQ: folds
4QTiNH5fteLgJjx/s6Hy6A: folds
5JJVDlaiMnB004o/RqbZZQ collected $2.50 from pot
*** SUMMARY ***
Total pot $2.50 | Rake $0
Seat 2: XNMDwbXt/Q4jM99AXnbJDw folded before Flop (didn't bet)
Seat 3: 4QTiNH5fteLgJjx/s6Hy6A (button) folded before Flop
Seat 4: 5JJVDlaiMnB004o/RqbZZQ (small blind) collected ($2.50)
Seat 5: WGW0DgjBUXs1ylURHG8vnQ (big blind) folded before Flop
Seat 6: k1f0lS7tlMHCLGs0JT34Tg folded before Flop (didn't bet)
Seat 7: KPLH0gELgFe2OuAnhJFI5w folded before Flop (didn't bet)
Seat 8: HkZI6g4zl83TDTA7SRspmQ folded before Flop (didn't bet)
Seat 9: Ak2W6V2TDVIQrvSAy4eD7Q folded before Flop (didn't bet)



PokerStars Game #59938791940:  Hold'em No Limit ($0.25/$0.50) - 2009/07/01 0:23:36 ET
Table 'lSisgp6H7Fg1hH5VfjEjYQ' 9-max Seat #3 is the button
Seat 1: pEW8B6uXbdR47kfljMQ3+Q ($38.20 in chips)
Seat 2: UrcnkQOiLVk8BlKDPJSy7Q ($50.35 in chips)
Seat 3: aTkyjTh3w5YLWiIERupZOA ($39.40 in chips)
Seat 4: bwv/rbH/hHhPhY6u9mu04w ($24.50 in chips)
Seat 5: mSD1pginDsyHG5PDfqzphw ($10 in chips)
Seat 6: +k7T5ocke8UwavtgUHm+Cg ($26.10 in chips)
Seat 7: dGw5MBstXyXhWHHVFOWOFA ($43.75 in chips)
Seat 8: a4JDWmpFQkL10XfAyuF51A ($35.55 in chips)
Seat 9: 5JJVDlaiMnB004o/RqbZZQ ($40.50 in chips)
bwv/rbH/hHhPhY6u9mu04w: posts small blind $0.25
mSD1pginDsyHG5PDfqzphw: posts big blind $0.50
*** HOLE CARDS ***
+k7T5ocke8UwavtgUHm+Cg: folds
dGw5MBstXyXhWHHVFOWOFA: folds
a4JDWmpFQkL10XfAyuF51A: calls $0.50
5JJVDlaiMnB004o/RqbZZQ: folds
pEW8B6uXbdR47kfljMQ3+Q: raises $0.50 to $1
UrcnkQOiLVk8BlKDPJSy7Q: folds
aTkyjTh3w5YLWiIERupZOA: folds
bwv/rbH/hHhPhY6u9mu04w: folds
mSD1pginDsyHG5PDfqzphw: folds
a4JDWmpFQkL10XfAyuF51A: calls $0.50
*** FLOP *** [3h Js 9c]
a4JDWmpFQkL10XfAyuF51A: checks
pEW8B6uXbdR47kfljMQ3+Q: bets $1
a4JDWmpFQkL10XfAyuF51A: folds
pEW8B6uXbdR47kfljMQ3+Q collected $2.65 from pot
pEW8B6uXbdR47kfljMQ3+Q: doesn't show hand
*** SUMMARY ***
Total pot $2.75 | Rake $0.10
Board [3h Js 9c]
Seat 1: pEW8B6uXbdR47kfljMQ3+Q collected ($2.65)
Seat 2: UrcnkQOiLVk8BlKDPJSy7Q folded before Flop (didn't bet)
Seat 3: aTkyjTh3w5YLWiIERupZOA (button) folded before Flop (didn't bet)
Seat 4: bwv/rbH/hHhPhY6u9mu04w (small blind) folded before Flop
Seat 5: mSD1pginDsyHG5PDfqzphw (big blind) folded before Flop
Seat 6: +k7T5ocke8UwavtgUHm+Cg folded before Flop (didn't bet)
Seat 7: dGw5MBstXyXhWHHVFOWOFA folded before Flop (didn't bet)
Seat 8: a4JDWmpFQkL10XfAyuF51A folded on the Flop
Seat 9: 5JJVDlaiMnB004o/RqbZZQ folded before Flop (didn't bet)



PokerStars Game #59938792722:  Hold'em No Limit ($0.25/$0.50) - 2009/07/01 0:23:37 ET
Table 'E7bWJ45aoFXRpyRv2gw+Ig' 2-max Seat #1 is the button
Seat 1: FRkiRasEGlHUeLrEl+k/nA ($69.50 in chips)
Seat 2: 3Wro85I7472vJ4Wkpneo9A ($109.25 in chips)
FRkiRasEGlHUeLrEl+k/nA: posts small blind $0.25
3Wro85I7472vJ4Wkpneo9A: posts big blind $0.50
*** HOLE CARDS ***
FRkiRasEGlHUeLrEl+k/nA: folds
3Wro85I7472vJ4Wkpneo9A collected $0.50 from pot
3Wro85I7472vJ4Wkpneo9A: doesn't show hand
*** SUMMARY ***
Total pot $0.50 | Rake $0
Seat 1: FRkiRasEGlHUeLrEl+k/nA (button) (small blind) folded before Flop
Seat 2: 3Wro85I7472vJ4Wkpneo9A (big blind) collected ($0.50)



PokerStars Game #59938793798:  Hold'em No Limit ($0.25/$0.50) - 2009/07/01 0:23:39 ET
Table 'ZYwMb9E6tY50Qm+iNbXRYw' 2-max Seat #1 is the button
Seat 1: DXLfRb8KDZWmrztw2bwtFw ($22.05 in chips)
Seat 2: 16tvT7AYgZ2LgiGFcvFKQg ($9.05 in chips)
DXLfRb8KDZWmrztw2bwtFw: posts small blind $0.25
16tvT7AYgZ2LgiGFcvFKQg: posts big blind $0.50
*** HOLE CARDS ***
DXLfRb8KDZWmrztw2bwtFw: folds
16tvT7AYgZ2LgiGFcvFKQg collected $0.50 from pot
16tvT7AYgZ2LgiGFcvFKQg: doesn't show hand
*** SUMMARY ***
Total pot $0.50 | Rake $0
Seat 1: DXLfRb8KDZWmrztw2bwtFw (button) (small blind) folded before Flop
Seat 2: 16tvT7AYgZ2LgiGFcvFKQg (big blind) collected ($0.50)



PokerStars Game #59938794826:  Hold'em No Limit ($0.25/$0.50) - 2009/07/01 0:23:40 ET
Table 'ibNfFy0bCzuBaUORla0aGw' 9-max Seat #5 is the button
Seat 2: 90Wb75h3W1BRpbqVnuk8gw ($58.05 in chips)
Seat 3: dDaHs3X8+fe3bIkRU0cbrw ($40.90 in chips)
Seat 4: YBN054X4blmis+B2bBlC0g ($17.30 in chips)
Seat 5: FRv75HO8CUsRZ1byEz06mQ ($8.35 in chips)
Seat 7: HZkVla4kK2SI42CVrPZ/ig ($9.50 in chips)
Seat 8: xUrN9TWLq4m5V+OXY7KUUA ($50 in chips)
Seat 9: WpvT3OUSiZlpvs+mPXFqtQ ($11 in chips)
HZkVla4kK2SI42CVrPZ/ig: posts small blind $0.25
xUrN9TWLq4m5V+OXY7KUUA: posts big blind $0.50
*** HOLE CARDS ***
WpvT3OUSiZlpvs+mPXFqtQ: folds
90Wb75h3W1BRpbqVnuk8gw: raises $1.50 to $2
dDaHs3X8+fe3bIkRU0cbrw: folds
YBN054X4blmis+B2bBlC0g: folds
FRv75HO8CUsRZ1byEz06mQ: folds
HZkVla4kK2SI42CVrPZ/ig: folds
xUrN9TWLq4m5V+OXY7KUUA: folds
90Wb75h3W1BRpbqVnuk8gw collected $1.25 from pot
*** SUMMARY ***
Total pot $1.25 | Rake $0
Seat 2: 90Wb75h3W1BRpbqVnuk8gw collected ($1.25)
Seat 3: dDaHs3X8+fe3bIkRU0cbrw folded before Flop (didn't bet)
Seat 4: YBN054X4blmis+B2bBlC0g folded before Flop (didn't bet)
Seat 5: FRv75HO8CUsRZ1byEz06mQ (button) folded before Flop (didn't bet)
Seat 7: HZkVla4kK2SI42CVrPZ/ig (small blind) folded before Flop
Seat 8: xUrN9TWLq4m5V+OXY7KUUA (big blind) folded before Flop
Seat 9: WpvT3OUSiZlpvs+mPXFqtQ folded before Flop (didn't bet)



PokerStars Game #59938795578:  Hold'em No Limit ($0.25/$0.50) - 2009/07/01 0:23:41 ET
Table 'PALRfuH85dr5IkDfdv6new' 9-max Seat #1 is the button
Seat 1: SKnJuWHScqetA/qG5p+wCg ($31.25 in chips)
Seat 2: 9r7ZoBbAJj5IeyZ0q9BdzA ($10.85 in chips)
Seat 3: 50QWoELmpmHFrFIlWMJo9g ($88.20 in chips)
Seat 4: UqQTn9qxH/IQXP1PWD7Gwg ($33.45 in chips)
Seat 5: jSSGUXdNFAZA3QCvTcUMQw ($39.45 in chips)
Seat 6: EiWj2MAl8RNcPhTkzz24Mw ($36.95 in chips)
Seat 7: 3NcyXvr39gnK+KbTq7ezyA ($39.35 in chips)
Seat 8: NkS+CseUKx4XHszWq0PXEQ ($47.15 in chips)
Seat 9: CIrAX/m6o7jYmKOAjJXv4Q ($32.45 in chips)
9r7ZoBbAJj5IeyZ0q9BdzA: posts small blind $0.25
50QWoELmpmHFrFIlWMJo9g: posts big blind $0.50
*** HOLE CARDS ***
UqQTn9qxH/IQXP1PWD7Gwg: folds
jSSGUXdNFAZA3QCvTcUMQw: folds
UqQTn9qxH/IQXP1PWD7Gwg leaves the table
EiWj2MAl8RNcPhTkzz24Mw: folds
3NcyXvr39gnK+KbTq7ezyA: folds
NkS+CseUKx4XHszWq0PXEQ: folds
CIrAX/m6o7jYmKOAjJXv4Q: raises $1 to $1.50
SKnJuWHScqetA/qG5p+wCg: folds
mZNMJI1mY40XTC0U7GZakA joins the table at seat #4
9r7ZoBbAJj5IeyZ0q9BdzA: folds
50QWoELmpmHFrFIlWMJo9g: folds
CIrAX/m6o7jYmKOAjJXv4Q collected $1.25 from pot
*** SUMMARY ***
Total pot $1.25 | Rake $0
Seat 1: SKnJuWHScqetA/qG5p+wCg (button) folded before Flop (didn't bet)
Seat 2: 9r7ZoBbAJj5IeyZ0q9BdzA (small blind) folded before Flop
Seat 3: 50QWoELmpmHFrFIlWMJo9g (big blind) folded before Flop
Seat 4: UqQTn9qxH/IQXP1PWD7Gwg folded before Flop (didn't bet)
Seat 5: jSSGUXdNFAZA3QCvTcUMQw folded before Flop (didn't bet)
Seat 6: EiWj2MAl8RNcPhTkzz24Mw folded before Flop (didn't bet)
Seat 7: 3NcyXvr39gnK+KbTq7ezyA folded before Flop (didn't bet)
Seat 8: NkS+CseUKx4XHszWq0PXEQ folded before Flop (didn't bet)
Seat 9: CIrAX/m6o7jYmKOAjJXv4Q collected ($1.25)



PokerStars Game #59938796420:  Hold'em No Limit ($0.25/$0.50) - 2009/07/01 0:23:43 ET
Table '8YYaUJqyk4NgBvNkL7mj/Q' 2-max Seat #2 is the button
Seat 1: Fp/oksNpipCrD2MJ2pH20g ($23.05 in chips)
Seat 2: dkC7J+qbyqk0qCcmJbEPPw ($48.50 in chips)
dkC7J+qbyqk0qCcmJbEPPw: posts small blind $0.25
Fp/oksNpipCrD2MJ2pH20g: posts big blind $0.50
*** HOLE CARDS ***
dkC7J+qbyqk0qCcmJbEPPw: folds
Fp/oksNpipCrD2MJ2pH20g collected $0.50 from pot
Fp/oksNpipCrD2MJ2pH20g: doesn't show hand
*** SUMMARY ***
Total pot $0.50 | Rake $0
Seat 1: Fp/oksNpipCrD2MJ2pH20g (big blind) collected ($0.50)
Seat 2: dkC7J+qbyqk0qCcmJbEPPw (button) (small blind) folded before Flop



PokerStars Game #59938796682:  Hold'em No Limit ($0.25/$0.50) - 2009/07/01 0:23:43 ET
Table '0AhP5FLi4ySROVJ/ycT1Qw' 2-max Seat #1 is the button
Seat 1: 38ZztDUK6IU5WCK+BN74Rw ($92.50 in chips)
Seat 2: 46qCyJ6evTkHo9al5sBMNA ($87.10 in chips)
38ZztDUK6IU5WCK+BN74Rw: posts small blind $0.25
46qCyJ6evTkHo9al5sBMNA: posts big blind $0.50
*** HOLE CARDS ***
38ZztDUK6IU5WCK+BN74Rw: folds
46qCyJ6evTkHo9al5sBMNA collected $0.50 from pot
46qCyJ6evTkHo9al5sBMNA: doesn't show hand
*** SUMMARY ***
Total pot $0.50 | Rake $0
Seat 1: 38ZztDUK6IU5WCK+BN74Rw (button) (small blind) folded before Flop
Seat 2: 46qCyJ6evTkHo9al5sBMNA (big blind) collected ($0.50)



PokerStars Game #59938796678:  Hold'em No Limit ($0.25/$0.50) - 2009/07/01 0:23:43 ET
Table 'E7bWJ45aoFXRpyRv2gw+Ig' 2-max Seat #2 is the button
Seat 1: FRkiRasEGlHUeLrEl+k/nA ($69.25 in chips)
Seat 2: 3Wro85I7472vJ4Wkpneo9A ($109.50 in chips)
3Wro85I7472vJ4Wkpneo9A: posts small blind $0.25
FRkiRasEGlHUeLrEl+k/nA: posts big blind $0.50
*** HOLE CARDS ***
3Wro85I7472vJ4Wkpneo9A: raises $1 to $1.50
FRkiRasEGlHUeLrEl+k/nA: folds
3Wro85I7472vJ4Wkpneo9A collected $1 from pot
3Wro85I7472vJ4Wkpneo9A: doesn't show hand
*** SUMMARY ***
Total pot $1 | Rake $0
Seat 1: FRkiRasEGlHUeLrEl+k/nA (big blind) folded before Flop
Seat 2: 3Wro85I7472vJ4Wkpneo9A (button) (small blind) collected ($1)



PokerStars Game #59938797074:  Hold'em No Limit ($0.25/$0.50) - 2009/07/01 0:23:44 ET
Table 'mTxf8gPLgffN3Iwfm7Icfg' 2-max Seat #2 is the button
Seat 1: Do9Rlu1R5u/AcRtMTl8SYg ($75.45 in chips)
Seat 2: EMc5LPgVaded4Qc77vm0fw ($85.65 in chips)
EMc5LPgVaded4Qc77vm0fw: posts small blind $0.25
Do9Rlu1R5u/AcRtMTl8SYg: posts big blind $0.50
*** HOLE CARDS ***
EMc5LPgVaded4Qc77vm0fw: calls $0.25
Do9Rlu1R5u/AcRtMTl8SYg: checks
*** FLOP *** [Kh Ks 9h]
Do9Rlu1R5u/AcRtMTl8SYg: checks
EMc5LPgVaded4Qc77vm0fw: checks
*** TURN *** [Kh Ks 9h] [2s]
Do9Rlu1R5u/AcRtMTl8SYg: checks
EMc5LPgVaded4Qc77vm0fw: checks
*** RIVER *** [Kh Ks 9h 2s] [Ad]
Do9Rlu1R5u/AcRtMTl8SYg: checks
EMc5LPgVaded4Qc77vm0fw: checks
*** SHOW DOWN ***
Do9Rlu1R5u/AcRtMTl8SYg: shows [Tc 4c] (a pair of Kings)
EMc5LPgVaded4Qc77vm0fw: shows [5d Td] (a pair of Kings)
Do9Rlu1R5u/AcRtMTl8SYg collected $0.50 from pot
EMc5LPgVaded4Qc77vm0fw collected $0.45 from pot
*** SUMMARY ***
Total pot $1 | Rake $0.05
Board [Kh Ks 9h 2s Ad]
Seat 1: Do9Rlu1R5u/AcRtMTl8SYg (big blind) showed [Tc 4c] and won ($0.50) with a pair of Kings
Seat 2: EMc5LPgVaded4Qc77vm0fw (button) (small blind) showed [5d Td] and won ($0.45) with a pair of Kings



PokerStars Game #59938798194:  Hold'em No Limit ($0.25/$0.50) - 2009/07/01 0:23:45 ET
Table 'ZYwMb9E6tY50Qm+iNbXRYw' 2-max Seat #2 is the button
Seat 1: DXLfRb8KDZWmrztw2bwtFw ($21.80 in chips)
Seat 2: 16tvT7AYgZ2LgiGFcvFKQg ($9.30 in chips)
16tvT7AYgZ2LgiGFcvFKQg: posts small blind $0.25
DXLfRb8KDZWmrztw2bwtFw: posts big blind $0.50
*** HOLE CARDS ***
16tvT7AYgZ2LgiGFcvFKQg: raises $0.50 to $1
DXLfRb8KDZWmrztw2bwtFw: calls $0.50
*** FLOP *** [2h 7h Ac]
DXLfRb8KDZWmrztw2bwtFw: bets $2
16tvT7AYgZ2LgiGFcvFKQg: raises $2 to $4
DXLfRb8KDZWmrztw2bwtFw: raises $2 to $6
16tvT7AYgZ2LgiGFcvFKQg: raises $2.30 to $8.30 and is all-in
DXLfRb8KDZWmrztw2bwtFw: calls $2.30
*** TURN *** [2h 7h Ac] [8c]
*** RIVER *** [2h 7h Ac 8c] [4h]
*** SHOW DOWN ***
DXLfRb8KDZWmrztw2bwtFw: shows [As 3h] (a pair of Aces)
16tvT7AYgZ2LgiGFcvFKQg: shows [2d 2c] (three of a kind, Deuces)
16tvT7AYgZ2LgiGFcvFKQg collected $18.10 from pot
*** SUMMARY ***
Total pot $18.60 | Rake $0.50
Board [2h 7h Ac 8c 4h]
Seat 1: DXLfRb8KDZWmrztw2bwtFw (big blind) showed [As 3h] and lost with a pair of Aces
Seat 2: 16tvT7AYgZ2LgiGFcvFKQg (button) (small blind) showed [2d 2c] and won ($18.10) with three of a kind, Deuces



PokerStars Game #59938799128:  Hold'em No Limit ($0.25/$0.50) - 2009/07/01 0:23:47 ET
Table 'dVmkPtk5nWTfXApFsnhIOg' 2-max Seat #2 is the button
Seat 1: bypIyrYcAAifLfhZpGlKLA ($51.25 in chips)
Seat 2: rPToQDbLWB+dKnz7fcQSIg ($30.15 in chips)
rPToQDbLWB+dKnz7fcQSIg: posts small blind $0.25
bypIyrYcAAifLfhZpGlKLA: posts big blind $0.50
*** HOLE CARDS ***
rPToQDbLWB+dKnz7fcQSIg: folds
bypIyrYcAAifLfhZpGlKLA collected $0.50 from pot
bypIyrYcAAifLfhZpGlKLA: doesn't show hand
*** SUMMARY ***
Total pot $0.50 | Rake $0
Seat 1: bypIyrYcAAifLfhZpGlKLA (big blind) collected ($0.50)
Seat 2: rPToQDbLWB+dKnz7fcQSIg (button) (small blind) folded before Flop



PokerStars Game #59938799104:  Hold'em No Limit ($0.25/$0.50) - 2009/07/01 0:23:47 ET
Table 'hSTs/dUsYLgJQuF2Onp0MQ' 6-max Seat #6 is the button
Seat 1: Donj3X7gYzeS5pAl7s9f+Q ($25 in chips)
Seat 2: 6vNxrjjCl6FwfaaymM9jjg ($15 in chips)
Seat 3: vQOrJuXbLC3UZDVklY9bOA ($28.55 in chips)
Seat 4: L0aIPg7qefDQjdJo3HCVEA ($10 in chips)
Seat 5: 686aeHikcJlgKkSuIFdcXQ ($75.35 in chips)
Seat 6: +laPa9P7BjZKKnR0n+OmvA ($9.70 in chips)
Donj3X7gYzeS5pAl7s9f+Q: posts small blind $0.25
6vNxrjjCl6FwfaaymM9jjg: posts big blind $0.50
*** HOLE CARDS ***
vQOrJuXbLC3UZDVklY9bOA: folds
vQOrJuXbLC3UZDVklY9bOA leaves the table
L0aIPg7qefDQjdJo3HCVEA: folds
686aeHikcJlgKkSuIFdcXQ: raises $1.50 to $2
+laPa9P7BjZKKnR0n+OmvA: folds
Donj3X7gYzeS5pAl7s9f+Q: raises $3.50 to $5.50
6vNxrjjCl6FwfaaymM9jjg: folds
686aeHikcJlgKkSuIFdcXQ: calls $3.50
*** FLOP *** [Ac 4c 3c]
Donj3X7gYzeS5pAl7s9f+Q: checks
686aeHikcJlgKkSuIFdcXQ: checks
*** TURN *** [Ac 4c 3c] [Ah]
Donj3X7gYzeS5pAl7s9f+Q: checks
686aeHikcJlgKkSuIFdcXQ: checks
*** RIVER *** [Ac 4c 3c Ah] [Jd]
Donj3X7gYzeS5pAl7s9f+Q: bets $3
686aeHikcJlgKkSuIFdcXQ: calls $3
*** SHOW DOWN ***
Donj3X7gYzeS5pAl7s9f+Q: shows [9d 9c] (two pair, Aces and Nines)
686aeHikcJlgKkSuIFdcXQ: mucks hand
Donj3X7gYzeS5pAl7s9f+Q collected $16.70 from pot
*** SUMMARY ***
Total pot $17.50 | Rake $0.80
Board [Ac 4c 3c Ah Jd]
Seat 1: Donj3X7gYzeS5pAl7s9f+Q (small blind) showed [9d 9c] and won ($16.70) with two pair, Aces and Nines
Seat 2: 6vNxrjjCl6FwfaaymM9jjg (big blind) folded before Flop
Seat 3: vQOrJuXbLC3UZDVklY9bOA folded before Flop (didn't bet)
Seat 4: L0aIPg7qefDQjdJo3HCVEA folded before Flop (didn't bet)
Seat 5: 686aeHikcJlgKkSuIFdcXQ mucked
Seat 6: +laPa9P7BjZKKnR0n+OmvA (button) folded before Flop (didn't bet)



PokerStars Game #59938800522:  Hold'em No Limit ($0.25/$0.50) - 2009/07/01 0:23:49 ET
Table '8YYaUJqyk4NgBvNkL7mj/Q' 2-max Seat #1 is the button
Seat 1: Fp/oksNpipCrD2MJ2pH20g ($23.30 in chips)
Seat 2: dkC7J+qbyqk0qCcmJbEPPw ($48.25 in chips)
Fp/oksNpipCrD2MJ2pH20g: posts small blind $0.25
dkC7J+qbyqk0qCcmJbEPPw: posts big blind $0.50
*** HOLE CARDS ***
Fp/oksNpipCrD2MJ2pH20g: raises $0.50 to $1
dkC7J+qbyqk0qCcmJbEPPw: calls $0.50
*** FLOP *** [Ts Jc 6d]
dkC7J+qbyqk0qCcmJbEPPw: checks
Fp/oksNpipCrD2MJ2pH20g: bets $2
dkC7J+qbyqk0qCcmJbEPPw: folds
Fp/oksNpipCrD2MJ2pH20g collected $1.90 from pot
Fp/oksNpipCrD2MJ2pH20g: doesn't show hand
*** SUMMARY ***
Total pot $2 | Rake $0.10
Board [Ts Jc 6d]
Seat 1: Fp/oksNpipCrD2MJ2pH20g (button) (small blind) collected ($1.90)
Seat 2: dkC7J+qbyqk0qCcmJbEPPw (big blind) folded on the Flop



PokerStars Game #59938800934:  Hold'em No Limit ($0.25/$0.50) - 2009/07/01 0:23:49 ET
Table '0AhP5FLi4ySROVJ/ycT1Qw' 2-max Seat #2 is the button
Seat 1: 38ZztDUK6IU5WCK+BN74Rw ($92.25 in chips)
Seat 2: 46qCyJ6evTkHo9al5sBMNA ($87.35 in chips)
46qCyJ6evTkHo9al5sBMNA: posts small blind $0.25
38ZztDUK6IU5WCK+BN74Rw: posts big blind $0.50
*** HOLE CARDS ***
46qCyJ6evTkHo9al5sBMNA: folds
38ZztDUK6IU5WCK+BN74Rw collected $0.50 from pot
38ZztDUK6IU5WCK+BN74Rw: doesn't show hand
*** SUMMARY ***
Total pot $0.50 | Rake $0
Seat 1: 38ZztDUK6IU5WCK+BN74Rw (big blind) collected ($0.50)
Seat 2: 46qCyJ6evTkHo9al5sBMNA (button) (small blind) folded before Flop



PokerStars Game #59938802250:  Hold'em No Limit ($0.25/$0.50) - 2009/07/01 0:23:51 ET
Table 'E7bWJ45aoFXRpyRv2gw+Ig' 2-max Seat #1 is the button
Seat 1: FRkiRasEGlHUeLrEl+k/nA ($68.75 in chips)
Seat 2: 3Wro85I7472vJ4Wkpneo9A ($110 in chips)
FRkiRasEGlHUeLrEl+k/nA: posts small blind $0.25
3Wro85I7472vJ4Wkpneo9A: posts big blind $0.50
*** HOLE CARDS ***
FRkiRasEGlHUeLrEl+k/nA: folds
3Wro85I7472vJ4Wkpneo9A collected $0.50 from pot
3Wro85I7472vJ4Wkpneo9A: doesn't show hand
*** SUMMARY ***
Total pot $0.50 | Rake $0
Seat 1: FRkiRasEGlHUeLrEl+k/nA (button) (small blind) folded before Flop
Seat 2: 3Wro85I7472vJ4Wkpneo9A (big blind) collected ($0.50)



PokerStars Game #59938803626:  Hold'em No Limit ($0.25/$0.50) - 2009/07/01 0:23:53 ET
Table 'dVmkPtk5nWTfXApFsnhIOg' 2-max Seat #1 is the button
Seat 1: bypIyrYcAAifLfhZpGlKLA ($51.50 in chips)
Seat 2: rPToQDbLWB+dKnz7fcQSIg ($29.90 in chips)
bypIyrYcAAifLfhZpGlKLA: posts small blind $0.25
rPToQDbLWB+dKnz7fcQSIg: posts big blind $0.50
*** HOLE CARDS ***
bypIyrYcAAifLfhZpGlKLA: folds
rPToQDbLWB+dKnz7fcQSIg collected $0.50 from pot
*** SUMMARY ***
Total pot $0.50 | Rake $0
Seat 1: bypIyrYcAAifLfhZpGlKLA (button) (small blind) folded before Flop
Seat 2: rPToQDbLWB+dKnz7fcQSIg (big blind) collected ($0.50)



PokerStars Game #59938803336:  Hold'em No Limit ($0.25/$0.50) - 2009/07/01 0:23:53 ET
Table '+z1aekfHkpp09pc8F9aViw' 6-max Seat #3 is the button
Seat 1: wOyVV9M/oyiw3YaOjNZ05w ($50.75 in chips)
Seat 2: M6xK/VklCvdyyrmvzATlxQ ($29.95 in chips)
Seat 3: uUznlIMFnRUvwrBhYF73KA ($62.50 in chips)
Seat 4: RowCSpSURHTOL/dcjg/Iug ($50.20 in chips)
Seat 5: crjGpJEzSZgD38FoE3VMGg ($59.90 in chips)
Seat 6: 686aeHikcJlgKkSuIFdcXQ ($70.10 in chips)
RowCSpSURHTOL/dcjg/Iug: posts small blind $0.25
crjGpJEzSZgD38FoE3VMGg: posts big blind $0.50
*** HOLE CARDS ***
686aeHikcJlgKkSuIFdcXQ: folds
wOyVV9M/oyiw3YaOjNZ05w: folds
M6xK/VklCvdyyrmvzATlxQ: folds
uUznlIMFnRUvwrBhYF73KA: raises $0.50 to $1
RowCSpSURHTOL/dcjg/Iug: calls $0.75
crjGpJEzSZgD38FoE3VMGg: folds
*** FLOP *** [Ad 7c 7s]
RowCSpSURHTOL/dcjg/Iug: bets $1.50
uUznlIMFnRUvwrBhYF73KA: raises $2 to $3.50
RowCSpSURHTOL/dcjg/Iug: folds
uUznlIMFnRUvwrBhYF73KA collected $5.25 from pot
*** SUMMARY ***
Total pot $5.50 | Rake $0.25
Board [Ad 7c 7s]
Seat 1: wOyVV9M/oyiw3YaOjNZ05w folded before Flop (didn't bet)
Seat 2: M6xK/VklCvdyyrmvzATlxQ folded before Flop (didn't bet)
Seat 3: uUznlIMFnRUvwrBhYF73KA (button) collected ($5.25)
Seat 4: RowCSpSURHTOL/dcjg/Iug (small blind) folded on the Flop
Seat 5: crjGpJEzSZgD38FoE3VMGg (big blind) folded before Flop
Seat 6: 686aeHikcJlgKkSuIFdcXQ folded before Flop (didn't bet)



PokerStars Game #59938805532:  Hold'em No Limit ($0.25/$0.50) - 2009/07/01 0:23:56 ET
Table '37qXEp3oe+er5q4CZip9eQ' 6-max Seat #6 is the button
Seat 1: oqOqoO2AyCZenUghCxMDxw ($52.05 in chips)
Seat 3: Rt6KgtZ8YaJoTc3FPim00w ($92.90 in chips)
Seat 5: VOmI0x4dDPnTESZd5B4d1Q ($44.55 in chips)
Seat 6: f7zPpUQp9hHZgqhEvrUWQw ($50 in chips)
oqOqoO2AyCZenUghCxMDxw: posts small blind $0.25
Rt6KgtZ8YaJoTc3FPim00w: posts big blind $0.50
*** HOLE CARDS ***
VOmI0x4dDPnTESZd5B4d1Q: folds
f7zPpUQp9hHZgqhEvrUWQw: folds
oqOqoO2AyCZenUghCxMDxw: calls $0.25
Rt6KgtZ8YaJoTc3FPim00w: checks
*** FLOP *** [Qh Qs Qd]
oqOqoO2AyCZenUghCxMDxw: bets $1
Rt6KgtZ8YaJoTc3FPim00w: calls $1
*** TURN *** [Qh Qs Qd] [9s]
oqOqoO2AyCZenUghCxMDxw: bets $1
Rt6KgtZ8YaJoTc3FPim00w: raises $3 to $4
oqOqoO2AyCZenUghCxMDxw: calls $3
*** RIVER *** [Qh Qs Qd 9s] [3c]
oqOqoO2AyCZenUghCxMDxw: checks
Rt6KgtZ8YaJoTc3FPim00w: bets $12
oqOqoO2AyCZenUghCxMDxw: folds
Rt6KgtZ8YaJoTc3FPim00w collected $10.50 from pot
*** SUMMARY ***
Total pot $11 | Rake $0.50
Board [Qh Qs Qd 9s 3c]
Seat 1: oqOqoO2AyCZenUghCxMDxw (small blind) folded on the River
Seat 3: Rt6KgtZ8YaJoTc3FPim00w (big blind) collected ($10.50)
Seat 5: VOmI0x4dDPnTESZd5B4d1Q folded before Flop (didn't bet)
Seat 6: f7zPpUQp9hHZgqhEvrUWQw (button) folded before Flop (didn't bet)



PokerStars Game #59938806270:  Hold'em No Limit ($0.25/$0.50) - 2009/07/01 0:23:57 ET
Table 'E7bWJ45aoFXRpyRv2gw+Ig' 2-max Seat #2 is the button
Seat 1: FRkiRasEGlHUeLrEl+k/nA ($68.50 in chips)
Seat 2: 3Wro85I7472vJ4Wkpneo9A ($110.25 in chips)
3Wro85I7472vJ4Wkpneo9A: posts small blind $0.25
FRkiRasEGlHUeLrEl+k/nA: posts big blind $0.50
*** HOLE CARDS ***
3Wro85I7472vJ4Wkpneo9A: calls $0.25
FRkiRasEGlHUeLrEl+k/nA: checks
*** FLOP *** [5s 5d Tc]
FRkiRasEGlHUeLrEl+k/nA: bets $0.50
3Wro85I7472vJ4Wkpneo9A: calls $0.50
*** TURN *** [5s 5d Tc] [Th]
FRkiRasEGlHUeLrEl+k/nA: bets $1
3Wro85I7472vJ4Wkpneo9A: calls $1
*** RIVER *** [5s 5d Tc Th] [3c]
FRkiRasEGlHUeLrEl+k/nA: checks
3Wro85I7472vJ4Wkpneo9A: checks
*** SHOW DOWN ***
FRkiRasEGlHUeLrEl+k/nA: shows [6s Jd] (two pair, Tens and Fives)
3Wro85I7472vJ4Wkpneo9A: shows [7c 7h] (two pair, Tens and Sevens)
3Wro85I7472vJ4Wkpneo9A collected $3.85 from pot
*** SUMMARY ***
Total pot $4 | Rake $0.15
Board [5s 5d Tc Th 3c]
Seat 1: FRkiRasEGlHUeLrEl+k/nA (big blind) showed [6s Jd] and lost with two pair, Tens and Fives
Seat 2: 3Wro85I7472vJ4Wkpneo9A (button) (small blind) showed [7c 7h] and won ($3.85) with two pair, Tens and Sevens



PokerStars Game #59938806754:  Hold'em No Limit ($0.25/$0.50) - 2009/07/01 0:23:58 ET
Table '0AhP5FLi4ySROVJ/ycT1Qw' 2-max Seat #1 is the button
Seat 1: 38ZztDUK6IU5WCK+BN74Rw ($92.50 in chips)
Seat 2: 46qCyJ6evTkHo9al5sBMNA ($87.10 in chips)
38ZztDUK6IU5WCK+BN74Rw: posts small blind $0.25
46qCyJ6evTkHo9al5sBMNA: posts big blind $0.50
*** HOLE CARDS ***
38ZztDUK6IU5WCK+BN74Rw: folds
46qCyJ6evTkHo9al5sBMNA collected $0.50 from pot
46qCyJ6evTkHo9al5sBMNA: doesn't show hand
*** SUMMARY ***
Total pot $0.50 | Rake $0
Seat 1: 38ZztDUK6IU5WCK+BN74Rw (button) (small blind) folded before Flop
Seat 2: 46qCyJ6evTkHo9al5sBMNA (big blind) collected ($0.50)



PokerStars Game #59938807282:  Hold'em No Limit ($0.25/$0.50) - 2009/07/01 0:23:59 ET
Table 'dVmkPtk5nWTfXApFsnhIOg' 2-max Seat #2 is the button
Seat 1: bypIyrYcAAifLfhZpGlKLA ($51.25 in chips)
Seat 2: rPToQDbLWB+dKnz7fcQSIg ($30.15 in chips)
rPToQDbLWB+dKnz7fcQSIg: posts small blind $0.25
bypIyrYcAAifLfhZpGlKLA: posts big blind $0.50
*** HOLE CARDS ***
rPToQDbLWB+dKnz7fcQSIg: calls $0.25
bypIyrYcAAifLfhZpGlKLA: raises $1.50 to $2
rPToQDbLWB+dKnz7fcQSIg: calls $1.50
*** FLOP *** [2d Jc Qh]
bypIyrYcAAifLfhZpGlKLA: bets $2
rPToQDbLWB+dKnz7fcQSIg: calls $2
*** TURN *** [2d Jc Qh] [4s]
bypIyrYcAAifLfhZpGlKLA: bets $6.50
rPToQDbLWB+dKnz7fcQSIg: folds
bypIyrYcAAifLfhZpGlKLA collected $7.65 from pot
bypIyrYcAAifLfhZpGlKLA: doesn't show hand
*** SUMMARY ***
Total pot $8 | Rake $0.35
Board [2d Jc Qh 4s]
Seat 1: bypIyrYcAAifLfhZpGlKLA (big blind) collected ($7.65)
Seat 2: rPToQDbLWB+dKnz7fcQSIg (button) (small blind) folded on the Turn



PokerStars Game #59938807168:  Hold'em No Limit ($0.25/$0.50) - 2009/07/01 0:23:59 ET
Table 'MJxeZCzYELxiIsyUZyT0jw' 6-max Seat #4 is the button
Seat 3: JQZew0FjzS19kTjeNtrE+A ($54.60 in chips)
Seat 4: lP7Q6pewz4C2RsAfKsjdWw ($29.95 in chips)
Seat 5: 3jvoOXNtXE90w2BdfNZwZQ ($52.55 in chips)
Seat 6: TTx3CHxyi0SObcHyMJRp5w ($49.75 in chips)
3jvoOXNtXE90w2BdfNZwZQ: posts small blind $0.25
TTx3CHxyi0SObcHyMJRp5w: posts big blind $0.50
wOyVV9M/oyiw3YaOjNZ05w: sits out
*** HOLE CARDS ***
JQZew0FjzS19kTjeNtrE+A: calls $0.50
lP7Q6pewz4C2RsAfKsjdWw: calls $0.50
3jvoOXNtXE90w2BdfNZwZQ: folds
TTx3CHxyi0SObcHyMJRp5w: checks
*** FLOP *** [6d 9s 8s]
u4vYQZNWtIzOJre8fvCmvQ joins the table at seat #2
TTx3CHxyi0SObcHyMJRp5w: bets $1.50
JQZew0FjzS19kTjeNtrE+A: calls $1.50
lP7Q6pewz4C2RsAfKsjdWw: calls $1.50
*** TURN *** [6d 9s 8s] [Tc]
TTx3CHxyi0SObcHyMJRp5w: bets $2.50
JQZew0FjzS19kTjeNtrE+A: calls $2.50
lP7Q6pewz4C2RsAfKsjdWw: calls $2.50
*** RIVER *** [6d 9s 8s Tc] [2s]
TTx3CHxyi0SObcHyMJRp5w: checks
JQZew0FjzS19kTjeNtrE+A: checks
lP7Q6pewz4C2RsAfKsjdWw: bets $6.50
TTx3CHxyi0SObcHyMJRp5w: folds
JQZew0FjzS19kTjeNtrE+A: folds
lP7Q6pewz4C2RsAfKsjdWw collected $13.10 from pot
lP7Q6pewz4C2RsAfKsjdWw: doesn't show hand
*** SUMMARY ***
Total pot $13.75 | Rake $0.65
Board [6d 9s 8s Tc 2s]
Seat 3: JQZew0FjzS19kTjeNtrE+A folded on the River
Seat 4: lP7Q6pewz4C2RsAfKsjdWw (button) collected ($13.10)
Seat 5: 3jvoOXNtXE90w2BdfNZwZQ (small blind) folded before Flop
Seat 6: TTx3CHxyi0SObcHyMJRp5w (big blind) folded on the River



PokerStars Game #59938808704:  Hold'em No Limit ($0.25/$0.50) - 2009/07/01 0:24:01 ET
Table '+dXkOAQyS8j9PQZusUTMpg' 2-max Seat #1 is the button
Seat 1: XFa6sBGjP2gxoIvxR3fZIg ($57 in chips)
Seat 2: 5IBeOgaApY1Bvzv2P8X4EA ($50.25 in chips)
XFa6sBGjP2gxoIvxR3fZIg: posts small blind $0.25
5IBeOgaApY1Bvzv2P8X4EA: posts big blind $0.50
*** HOLE CARDS ***
XFa6sBGjP2gxoIvxR3fZIg: raises $1 to $1.50
5IBeOgaApY1Bvzv2P8X4EA said, "lucky you"
5IBeOgaApY1Bvzv2P8X4EA: calls $1
*** FLOP *** [6d Qc Kc]
5IBeOgaApY1Bvzv2P8X4EA: bets $0.50
XFa6sBGjP2gxoIvxR3fZIg said, "yeah, that could have been expensive"
XFa6sBGjP2gxoIvxR3fZIg: raises $3 to $3.50
5IBeOgaApY1Bvzv2P8X4EA said, "jajaja"
5IBeOgaApY1Bvzv2P8X4EA: calls $3
*** TURN *** [6d Qc Kc] [9d]
5IBeOgaApY1Bvzv2P8X4EA: checks
XFa6sBGjP2gxoIvxR3fZIg: bets $7.50
5IBeOgaApY1Bvzv2P8X4EA: calls $7.50
*** RIVER *** [6d Qc Kc 9d] [Ah]
5IBeOgaApY1Bvzv2P8X4EA: checks
XFa6sBGjP2gxoIvxR3fZIg: checks
*** SHOW DOWN ***
5IBeOgaApY1Bvzv2P8X4EA: shows [Qd 3d] (a pair of Queens)
XFa6sBGjP2gxoIvxR3fZIg: mucks hand
5IBeOgaApY1Bvzv2P8X4EA collected $24.50 from pot
*** SUMMARY ***
Total pot $25 | Rake $0.50
Board [6d Qc Kc 9d Ah]
Seat 1: XFa6sBGjP2gxoIvxR3fZIg (button) (small blind) mucked
Seat 2: 5IBeOgaApY1Bvzv2P8X4EA (big blind) showed [Qd 3d] and won ($24.50) with a pair of Queens



PokerStars Game #59938809062:  Hold'em No Limit ($0.25/$0.50) - 2009/07/01 0:24:02 ET
Table '8YYaUJqyk4NgBvNkL7mj/Q' 2-max Seat #2 is the button
Seat 1: Fp/oksNpipCrD2MJ2pH20g ($24.20 in chips)
Seat 2: dkC7J+qbyqk0qCcmJbEPPw ($47.25 in chips)
dkC7J+qbyqk0qCcmJbEPPw: posts small blind $0.25
Fp/oksNpipCrD2MJ2pH20g: posts big blind $0.50
*** HOLE CARDS ***
dkC7J+qbyqk0qCcmJbEPPw: raises $1 to $1.50
Fp/oksNpipCrD2MJ2pH20g: calls $1
*** FLOP *** [6h 3d 6s]
Fp/oksNpipCrD2MJ2pH20g: checks
dkC7J+qbyqk0qCcmJbEPPw: bets $2
Fp/oksNpipCrD2MJ2pH20g: folds
dkC7J+qbyqk0qCcmJbEPPw collected $2.85 from pot
*** SUMMARY ***
Total pot $3 | Rake $0.15
Board [6h 3d 6s]
Seat 1: Fp/oksNpipCrD2MJ2pH20g (big blind) folded on the Flop
Seat 2: dkC7J+qbyqk0qCcmJbEPPw (button) (small blind) collected ($2.85)



PokerStars Game #59938809770:  Hold'em No Limit ($0.25/$0.50) - 2009/07/01 0:24:03 ET
Table 'eMxdLyFDf28E0wit6gm3Uw' 6-max Seat #6 is the button
Seat 1: tnD/64LagZ9qPaeOQVjVZg ($12.70 in chips)
Seat 2: jwuKQ1S3U4NnzMQn3E3dgw ($69.60 in chips)
Seat 3: dZcLsEI8iXkobBduRJ45Yw ($14.65 in chips)
Seat 4: QM93o65lI8kLzmiB/BILlA ($30.45 in chips)
Seat 5: X0X97o2fDAPiGx6o1gahsw ($56.35 in chips)
Seat 6: L0aIPg7qefDQjdJo3HCVEA ($8 in chips)
tnD/64LagZ9qPaeOQVjVZg: posts small blind $0.25
jwuKQ1S3U4NnzMQn3E3dgw: posts big blind $0.50
*** HOLE CARDS ***
dZcLsEI8iXkobBduRJ45Yw: folds
QM93o65lI8kLzmiB/BILlA: calls $0.50
X0X97o2fDAPiGx6o1gahsw: folds
L0aIPg7qefDQjdJo3HCVEA: folds
tnD/64LagZ9qPaeOQVjVZg: raises $12.20 to $12.70 and is all-in
jwuKQ1S3U4NnzMQn3E3dgw: folds
QM93o65lI8kLzmiB/BILlA: calls $12.20
*** FLOP *** [9d 7h 2h]
*** TURN *** [9d 7h 2h] [Qd]
*** RIVER *** [9d 7h 2h Qd] [Ac]
*** SHOW DOWN ***
tnD/64LagZ9qPaeOQVjVZg: shows [Ah Qh] (two pair, Aces and Queens)
QM93o65lI8kLzmiB/BILlA: mucks hand
tnD/64LagZ9qPaeOQVjVZg collected $24.65 from pot
*** SUMMARY ***
Total pot $25.90 | Rake $1.25
Board [9d 7h 2h Qd Ac]
Seat 1: tnD/64LagZ9qPaeOQVjVZg (small blind) showed [Ah Qh] and won ($24.65) with two pair, Aces and Queens
Seat 2: jwuKQ1S3U4NnzMQn3E3dgw (big blind) folded before Flop
Seat 3: dZcLsEI8iXkobBduRJ45Yw folded before Flop (didn't bet)
Seat 4: QM93o65lI8kLzmiB/BILlA mucked
Seat 5: X0X97o2fDAPiGx6o1gahsw folded before Flop (didn't bet)
Seat 6: L0aIPg7qefDQjdJo3HCVEA (button) folded before Flop (didn't bet)



PokerStars Game #59938810580:  Hold'em No Limit ($0.25/$0.50) - 2009/07/01 0:24:04 ET
Table 'c/CRn+68J3Y8KxD5g1ek2Q' 2-max Seat #2 is the button
Seat 1: 46qCyJ6evTkHo9al5sBMNA ($265.95 in chips)
Seat 2: BypVLsYQt3ePFm2xQL/dOA ($115.35 in chips)
BypVLsYQt3ePFm2xQL/dOA: posts small blind $0.25
46qCyJ6evTkHo9al5sBMNA: posts big blind $0.50
*** HOLE CARDS ***
BypVLsYQt3ePFm2xQL/dOA: raises $1.50 to $2
46qCyJ6evTkHo9al5sBMNA: folds
BypVLsYQt3ePFm2xQL/dOA collected $1 from pot
BypVLsYQt3ePFm2xQL/dOA: doesn't show hand
*** SUMMARY ***
Total pot $1 | Rake $0
Seat 1: 46qCyJ6evTkHo9al5sBMNA (big blind) folded before Flop
Seat 2: BypVLsYQt3ePFm2xQL/dOA (button) (small blind) collected ($1)



PokerStars Game #59938811038:  Hold'em No Limit ($0.25/$0.50) - 2009/07/01 0:24:05 ET
Table '0AhP5FLi4ySROVJ/ycT1Qw' 2-max Seat #2 is the button
Seat 1: 38ZztDUK6IU5WCK+BN74Rw ($92.25 in chips)
Seat 2: 46qCyJ6evTkHo9al5sBMNA ($87.35 in chips)
46qCyJ6evTkHo9al5sBMNA: posts small blind $0.25
38ZztDUK6IU5WCK+BN74Rw: posts big blind $0.50
*** HOLE CARDS ***
46qCyJ6evTkHo9al5sBMNA: folds
38ZztDUK6IU5WCK+BN74Rw collected $0.50 from pot
*** SUMMARY ***
Total pot $0.50 | Rake $0
Seat 1: 38ZztDUK6IU5WCK+BN74Rw (big blind) collected ($0.50)
Seat 2: 46qCyJ6evTkHo9al5sBMNA (button) (small blind) folded before Flop



PokerStars Game #59938811080:  Hold'em No Limit ($0.25/$0.50) - 2009/07/01 0:24:05 ET
Table 'QOgaEqMcJ73pcUMMxoisUg' 6-max Seat #5 is the button
Seat 1: UaC1G3O4HWbowgSfeYnkog ($10 in chips)
Seat 2: Im2p1Nt83UKSqv5c9frm4Q ($50 in chips)
Seat 3: wUZNozoIDYf+16hp4nn6dw ($31.45 in chips)
Seat 4: zAcsDhG/T128Vn7XGVSgKg ($63.30 in chips)
Seat 5: 6vNxrjjCl6FwfaaymM9jjg ($29.25 in chips)
Seat 6: s83dnhZ6VC53vY0/f6OV/g ($41.55 in chips)
s83dnhZ6VC53vY0/f6OV/g: posts small blind $0.25
UaC1G3O4HWbowgSfeYnkog: posts big blind $0.50
*** HOLE CARDS ***
Im2p1Nt83UKSqv5c9frm4Q: folds
wUZNozoIDYf+16hp4nn6dw: raises $0.50 to $1
zAcsDhG/T128Vn7XGVSgKg: folds
6vNxrjjCl6FwfaaymM9jjg: calls $1
s83dnhZ6VC53vY0/f6OV/g: folds
UaC1G3O4HWbowgSfeYnkog: calls $0.50
*** FLOP *** [Td 6d 4d]
UaC1G3O4HWbowgSfeYnkog: checks
wUZNozoIDYf+16hp4nn6dw: bets $1.50
6vNxrjjCl6FwfaaymM9jjg: folds
UaC1G3O4HWbowgSfeYnkog: folds
wUZNozoIDYf+16hp4nn6dw collected $3.10 from pot
*** SUMMARY ***
Total pot $3.25 | Rake $0.15
Board [Td 6d 4d]
Seat 1: UaC1G3O4HWbowgSfeYnkog (big blind) folded on the Flop
Seat 2: Im2p1Nt83UKSqv5c9frm4Q folded before Flop (didn't bet)
Seat 3: wUZNozoIDYf+16hp4nn6dw collected ($3.10)
Seat 4: zAcsDhG/T128Vn7XGVSgKg folded before Flop (didn't bet)
Seat 5: 6vNxrjjCl6FwfaaymM9jjg (button) folded on the Flop
Seat 6: s83dnhZ6VC53vY0/f6OV/g (small blind) folded before Flop



PokerStars Game #59938812014:  Hold'em No Limit ($0.25/$0.50) - 2009/07/01 0:24:06 ET
Table 'ZYwMb9E6tY50Qm+iNbXRYw' 2-max Seat #1 is the button
Seat 1: DXLfRb8KDZWmrztw2bwtFw ($12.50 in chips)
Seat 2: 16tvT7AYgZ2LgiGFcvFKQg ($18.10 in chips)
DXLfRb8KDZWmrztw2bwtFw: posts small blind $0.25
16tvT7AYgZ2LgiGFcvFKQg: posts big blind $0.50
*** HOLE CARDS ***
DXLfRb8KDZWmrztw2bwtFw: calls $0.25
16tvT7AYgZ2LgiGFcvFKQg: checks
*** FLOP *** [9c 3s 8d]
16tvT7AYgZ2LgiGFcvFKQg: bets $0.50
DXLfRb8KDZWmrztw2bwtFw: calls $0.50
*** TURN *** [9c 3s 8d] [3h]
16tvT7AYgZ2LgiGFcvFKQg: bets $0.50
DXLfRb8KDZWmrztw2bwtFw: calls $0.50
*** RIVER *** [9c 3s 8d 3h] [Kd]
16tvT7AYgZ2LgiGFcvFKQg: bets $5
DXLfRb8KDZWmrztw2bwtFw: folds
DXLfRb8KDZWmrztw2bwtFw said, "sucker"
16tvT7AYgZ2LgiGFcvFKQg collected $2.90 from pot
16tvT7AYgZ2LgiGFcvFKQg: shows [3d 7s] (three of a kind, Threes)
*** SUMMARY ***
Total pot $3 | Rake $0.10
Board [9c 3s 8d 3h Kd]
Seat 1: DXLfRb8KDZWmrztw2bwtFw (button) (small blind) folded on the River
Seat 2: 16tvT7AYgZ2LgiGFcvFKQg (big blind) collected ($2.90)



PokerStars Game #59938811654:  Hold'em No Limit ($0.25/$0.50) - 2009/07/01 0:24:06 ET
Table 'mTxf8gPLgffN3Iwfm7Icfg' 2-max Seat #1 is the button
Seat 1: Do9Rlu1R5u/AcRtMTl8SYg ($75.45 in chips)
Seat 2: EMc5LPgVaded4Qc77vm0fw ($85.60 in chips)
Do9Rlu1R5u/AcRtMTl8SYg: posts small blind $0.25
EMc5LPgVaded4Qc77vm0fw: posts big blind $0.50
*** HOLE CARDS ***
Do9Rlu1R5u/AcRtMTl8SYg: raises $1 to $1.50
EMc5LPgVaded4Qc77vm0fw: calls $1
*** FLOP *** [Kc 6s Jh]
EMc5LPgVaded4Qc77vm0fw: checks
Do9Rlu1R5u/AcRtMTl8SYg: bets $2
EMc5LPgVaded4Qc77vm0fw: calls $2
*** TURN *** [Kc 6s Jh] [Qc]
EMc5LPgVaded4Qc77vm0fw: checks
Do9Rlu1R5u/AcRtMTl8SYg: bets $4
EMc5LPgVaded4Qc77vm0fw: raises $9 to $13
Do9Rlu1R5u/AcRtMTl8SYg: calls $9
*** RIVER *** [Kc 6s Jh Qc] [8s]
EMc5LPgVaded4Qc77vm0fw: checks
Do9Rlu1R5u/AcRtMTl8SYg: checks
*** SHOW DOWN ***
EMc5LPgVaded4Qc77vm0fw: shows [5c 6d] (a pair of Sixes)
Do9Rlu1R5u/AcRtMTl8SYg: shows [Tc Qs] (a pair of Queens)
Do9Rlu1R5u/AcRtMTl8SYg collected $32.50 from pot
*** SUMMARY ***
Total pot $33 | Rake $0.50
Board [Kc 6s Jh Qc 8s]
Seat 1: Do9Rlu1R5u/AcRtMTl8SYg (button) (small blind) showed [Tc Qs] and won ($32.50) with a pair of Queens
Seat 2: EMc5LPgVaded4Qc77vm0fw (big blind) showed [5c 6d] and lost with a pair of Sixes



PokerStars Game #59938811850:  Hold'em No Limit ($0.25/$0.50) - 2009/07/01 0:24:06 ET
Table 'EiNh8p/wGJ1FP575iMFnqg' 9-max Seat #7 is the button
Seat 1: r3ZqM1Mi0W3y4hOdssE+Sg ($27.70 in chips)
Seat 2: sSAA879uXOGR+8Mf3zLa6Q ($9.95 in chips)
Seat 3: GszS/McxOSUnOET7MBoHqA ($49 in chips)
Seat 4: HIIPkpiaCQfs5HcPKjlHvg ($40.70 in chips)
Seat 5: M+7+BTmX5vZatHVuoRB1nA ($78.65 in chips)
Seat 6: 3UmXLy3GfjC3EkOebduerQ ($50 in chips)
Seat 7: Wj7mKnRFR90j40wWUu2+Og ($77.80 in chips)
Seat 8: KrPAGRACBg+w0M//SXe8Ag ($15.80 in chips)
Seat 9: OMwFJ4pF0xk2Ru/AJiFeFw ($70.65 in chips)
KrPAGRACBg+w0M//SXe8Ag: posts small blind $0.25
OMwFJ4pF0xk2Ru/AJiFeFw: posts big blind $0.50
*** HOLE CARDS ***
r3ZqM1Mi0W3y4hOdssE+Sg: folds
sSAA879uXOGR+8Mf3zLa6Q: calls $0.50
GszS/McxOSUnOET7MBoHqA: raises $1 to $1.50
HIIPkpiaCQfs5HcPKjlHvg: folds
M+7+BTmX5vZatHVuoRB1nA: folds
3UmXLy3GfjC3EkOebduerQ: raises $4.50 to $6
Wj7mKnRFR90j40wWUu2+Og: folds
KrPAGRACBg+w0M//SXe8Ag: folds
OMwFJ4pF0xk2Ru/AJiFeFw: folds
sSAA879uXOGR+8Mf3zLa6Q: folds
GszS/McxOSUnOET7MBoHqA: calls $4.50
*** FLOP *** [6c Kh 5c]
GszS/McxOSUnOET7MBoHqA: checks
3UmXLy3GfjC3EkOebduerQ: bets $7
GszS/McxOSUnOET7MBoHqA: folds
3UmXLy3GfjC3EkOebduerQ collected $12.60 from pot
3UmXLy3GfjC3EkOebduerQ: doesn't show hand
*** SUMMARY ***
Total pot $13.25 | Rake $0.65
Board [6c Kh 5c]
Seat 1: r3ZqM1Mi0W3y4hOdssE+Sg folded before Flop (didn't bet)
Seat 2: sSAA879uXOGR+8Mf3zLa6Q folded before Flop
Seat 3: GszS/McxOSUnOET7MBoHqA folded on the Flop
Seat 4: HIIPkpiaCQfs5HcPKjlHvg folded before Flop (didn't bet)
Seat 5: M+7+BTmX5vZatHVuoRB1nA folded before Flop (didn't bet)
Seat 6: 3UmXLy3GfjC3EkOebduerQ collected ($12.60)
Seat 7: Wj7mKnRFR90j40wWUu2+Og (button) folded before Flop (didn't bet)
Seat 8: KrPAGRACBg+w0M//SXe8Ag (small blind) folded before Flop
Seat 9: OMwFJ4pF0xk2Ru/AJiFeFw (big blind) folded before Flop



PokerStars Game #59938812408:  Hold'em No Limit ($0.25/$0.50) - 2009/07/01 0:24:07 ET
Table 'kgbJRsxfv64KrErDRBAkcw' 6-max Seat #6 is the button
Seat 1: N7O9jUEx2YiQn1+yRYTHmw ($17.65 in chips)
Seat 2: Q+thC23WCv1kJUJtH/+4Jw ($67.90 in chips)
Seat 3: T0Gx/FcQ5VH9u7XaOMX97A ($60.25 in chips)
Seat 4: qanMEqjABjWxC/JgQ/0l7w ($56.70 in chips)
Seat 5: +Pf9jTVizYlIo+woPvptfA ($50 in chips)
Seat 6: ozrlafxxh1HmYdA0/h+MuA ($9 in chips)
N7O9jUEx2YiQn1+yRYTHmw: posts small blind $0.25
Q+thC23WCv1kJUJtH/+4Jw: posts big blind $0.50
*** HOLE CARDS ***
T0Gx/FcQ5VH9u7XaOMX97A: folds
qanMEqjABjWxC/JgQ/0l7w: raises $1 to $1.50
+Pf9jTVizYlIo+woPvptfA: folds
ozrlafxxh1HmYdA0/h+MuA: calls $1.50
N7O9jUEx2YiQn1+yRYTHmw: calls $1.25
Q+thC23WCv1kJUJtH/+4Jw: folds
*** FLOP *** [6d 6h 4d]
N7O9jUEx2YiQn1+yRYTHmw: checks
qanMEqjABjWxC/JgQ/0l7w: checks
ozrlafxxh1HmYdA0/h+MuA: checks
*** TURN *** [6d 6h 4d] [6s]
N7O9jUEx2YiQn1+yRYTHmw: checks
qanMEqjABjWxC/JgQ/0l7w: checks
ozrlafxxh1HmYdA0/h+MuA: checks
*** RIVER *** [6d 6h 4d 6s] [Kc]
N7O9jUEx2YiQn1+yRYTHmw: checks
qanMEqjABjWxC/JgQ/0l7w: checks
ozrlafxxh1HmYdA0/h+MuA: checks
*** SHOW DOWN ***
N7O9jUEx2YiQn1+yRYTHmw: shows [8c 7c] (three of a kind, Sixes)
qanMEqjABjWxC/JgQ/0l7w: shows [2s 2c] (a full house, Sixes full of Deuces)
ozrlafxxh1HmYdA0/h+MuA: mucks hand
qanMEqjABjWxC/JgQ/0l7w collected $4.75 from pot
*** SUMMARY ***
Total pot $5 | Rake $0.25
Board [6d 6h 4d 6s Kc]
Seat 1: N7O9jUEx2YiQn1+yRYTHmw (small blind) showed [8c 7c] and lost with three of a kind, Sixes
Seat 2: Q+thC23WCv1kJUJtH/+4Jw (big blind) folded before Flop
Seat 3: T0Gx/FcQ5VH9u7XaOMX97A folded before Flop (didn't bet)
Seat 4: qanMEqjABjWxC/JgQ/0l7w showed [2s 2c] and won ($4.75) with a full house, Sixes full of Deuces
Seat 5: +Pf9jTVizYlIo+woPvptfA folded before Flop (didn't bet)
Seat 6: ozrlafxxh1HmYdA0/h+MuA (button) mucked



PokerStars Game #59938812816:  Hold'em No Limit ($0.25/$0.50) - 2009/07/01 0:24:07 ET
Table 'NCiXr0d5CEKBQr/cZgLhbA' 9-max Seat #2 is the button
Seat 1: RjBdQ6w31rgcy0o24VLR6w ($9.25 in chips)
Seat 2: ulxuJchBV9iguXg0FUonfg ($40.05 in chips)
Seat 3: xZCXQSXlrZkp3pZizzVXCw ($56.40 in chips)
Seat 5: zE9cVigS2nW/Ljy4K4bUQA ($40.25 in chips)
Seat 6: SKnJuWHScqetA/qG5p+wCg ($30 in chips)
Seat 7: M+7+BTmX5vZatHVuoRB1nA ($49.25 in chips)
Seat 8: 1MJUKc3cc0QmUoz1JZLR2w ($54.35 in chips)
xZCXQSXlrZkp3pZizzVXCw: posts small blind $0.25
zE9cVigS2nW/Ljy4K4bUQA: posts big blind $0.50
4WLZvqBn5qv5tds5kt5A1Q: sits out
*** HOLE CARDS ***
SKnJuWHScqetA/qG5p+wCg: folds
5k9fvXD9suIgCxU4HLQjTw joins the table at seat #4
M+7+BTmX5vZatHVuoRB1nA: folds
1MJUKc3cc0QmUoz1JZLR2w: folds
RjBdQ6w31rgcy0o24VLR6w: raises $1.50 to $2
ulxuJchBV9iguXg0FUonfg: calls $2
xZCXQSXlrZkp3pZizzVXCw: folds
zE9cVigS2nW/Ljy4K4bUQA: folds
*** FLOP *** [4h 5h 9d]
RjBdQ6w31rgcy0o24VLR6w: bets $2.50
ulxuJchBV9iguXg0FUonfg: calls $2.50
*** TURN *** [4h 5h 9d] [2c]
RjBdQ6w31rgcy0o24VLR6w: checks
ulxuJchBV9iguXg0FUonfg: bets $2
RjBdQ6w31rgcy0o24VLR6w: raises $2.75 to $4.75 and is all-in
ulxuJchBV9iguXg0FUonfg: folds
RjBdQ6w31rgcy0o24VLR6w collected $13.10 from pot
*** SUMMARY ***
Total pot $13.75 | Rake $0.65
Board [4h 5h 9d 2c]
Seat 1: RjBdQ6w31rgcy0o24VLR6w collected ($13.10)
Seat 2: ulxuJchBV9iguXg0FUonfg (button) folded on the Turn
Seat 3: xZCXQSXlrZkp3pZizzVXCw (small blind) folded before Flop
Seat 5: zE9cVigS2nW/Ljy4K4bUQA (big blind) folded before Flop
Seat 6: SKnJuWHScqetA/qG5p+wCg folded before Flop (didn't bet)
Seat 7: M+7+BTmX5vZatHVuoRB1nA folded before Flop (didn't bet)
Seat 8: 1MJUKc3cc0QmUoz1JZLR2w folded before Flop (didn't bet)



PokerStars Game #59938815258:  Hold'em No Limit ($0.25/$0.50) - 2009/07/01 0:24:11 ET
Table '0AhP5FLi4ySROVJ/ycT1Qw' 2-max Seat #1 is the button
Seat 1: 38ZztDUK6IU5WCK+BN74Rw ($92.50 in chips)
Seat 2: 46qCyJ6evTkHo9al5sBMNA ($87.10 in chips)
38ZztDUK6IU5WCK+BN74Rw: posts small blind $0.25
46qCyJ6evTkHo9al5sBMNA: posts big blind $0.50
*** HOLE CARDS ***
38ZztDUK6IU5WCK+BN74Rw: raises $1 to $1.50
46qCyJ6evTkHo9al5sBMNA: calls $1
*** FLOP *** [7s 8c Tc]
46qCyJ6evTkHo9al5sBMNA: checks
38ZztDUK6IU5WCK+BN74Rw: checks
*** TURN *** [7s 8c Tc] [9c]
46qCyJ6evTkHo9al5sBMNA: bets $2
38ZztDUK6IU5WCK+BN74Rw: raises $3.50 to $5.50
46qCyJ6evTkHo9al5sBMNA: calls $3.50
*** RIVER *** [7s 8c Tc 9c] [Ah]
46qCyJ6evTkHo9al5sBMNA: checks
38ZztDUK6IU5WCK+BN74Rw: bets $10
46qCyJ6evTkHo9al5sBMNA: calls $10
*** SHOW DOWN ***
38ZztDUK6IU5WCK+BN74Rw: shows [Jh Qh] (a straight, Eight to Queen)
46qCyJ6evTkHo9al5sBMNA: mucks hand
38ZztDUK6IU5WCK+BN74Rw collected $33.50 from pot
*** SUMMARY ***
Total pot $34 | Rake $0.50
Board [7s 8c Tc 9c Ah]
Seat 1: 38ZztDUK6IU5WCK+BN74Rw (button) (small blind) showed [Jh Qh] and won ($33.50) with a straight, Eight to Queen
Seat 2: 46qCyJ6evTkHo9al5sBMNA (big blind) mucked



PokerStars Game #59938815104:  Hold'em No Limit ($0.25/$0.50) - 2009/07/01 0:24:11 ET
Table 'Nz0Vr7WMHL2g5Uk7dDZjpw' 9-max Seat #4 is the button
Seat 2: XNMDwbXt/Q4jM99AXnbJDw ($50 in chips)
Seat 3: 4QTiNH5fteLgJjx/s6Hy6A ($20.45 in chips)
Seat 4: 5JJVDlaiMnB004o/RqbZZQ ($28.50 in chips)
Seat 5: WGW0DgjBUXs1ylURHG8vnQ ($10.60 in chips)
Seat 6: k1f0lS7tlMHCLGs0JT34Tg ($10 in chips)
Seat 7: KPLH0gELgFe2OuAnhJFI5w ($19.70 in chips)
Seat 8: HkZI6g4zl83TDTA7SRspmQ ($20.95 in chips)
Seat 9: Ak2W6V2TDVIQrvSAy4eD7Q ($25.35 in chips)
WGW0DgjBUXs1ylURHG8vnQ: posts small blind $0.25
k1f0lS7tlMHCLGs0JT34Tg: posts big blind $0.50
tLkxo7JgV+WWI0UBw44K5A: sits out
*** HOLE CARDS ***
KPLH0gELgFe2OuAnhJFI5w: folds
HkZI6g4zl83TDTA7SRspmQ: folds
Ak2W6V2TDVIQrvSAy4eD7Q: folds
XNMDwbXt/Q4jM99AXnbJDw: folds
4QTiNH5fteLgJjx/s6Hy6A: calls $0.50
5JJVDlaiMnB004o/RqbZZQ: folds
WGW0DgjBUXs1ylURHG8vnQ: calls $0.25
k1f0lS7tlMHCLGs0JT34Tg: checks
*** FLOP *** [Qd 4s 2s]
WGW0DgjBUXs1ylURHG8vnQ: checks
k1f0lS7tlMHCLGs0JT34Tg: checks
4QTiNH5fteLgJjx/s6Hy6A: bets $1.50
WGW0DgjBUXs1ylURHG8vnQ: folds
k1f0lS7tlMHCLGs0JT34Tg: folds
4QTiNH5fteLgJjx/s6Hy6A collected $1.45 from pot
*** SUMMARY ***
Total pot $1.50 | Rake $0.05
Board [Qd 4s 2s]
Seat 2: XNMDwbXt/Q4jM99AXnbJDw folded before Flop (didn't bet)
Seat 3: 4QTiNH5fteLgJjx/s6Hy6A collected ($1.45)
Seat 4: 5JJVDlaiMnB004o/RqbZZQ (button) folded before Flop (didn't bet)
Seat 5: WGW0DgjBUXs1ylURHG8vnQ (small blind) folded on the Flop
Seat 6: k1f0lS7tlMHCLGs0JT34Tg (big blind) folded on the Flop
Seat 7: KPLH0gELgFe2OuAnhJFI5w folded before Flop (didn't bet)
Seat 8: HkZI6g4zl83TDTA7SRspmQ folded before Flop (didn't bet)
Seat 9: Ak2W6V2TDVIQrvSAy4eD7Q folded before Flop (didn't bet)



PokerStars Game #59938816302:  Hold'em No Limit ($0.25/$0.50) - 2009/07/01 0:24:13 ET
Table 'PALRfuH85dr5IkDfdv6new' 9-max Seat #2 is the button
Seat 1: SKnJuWHScqetA/qG5p+wCg ($31.25 in chips)
Seat 2: 9r7ZoBbAJj5IeyZ0q9BdzA ($10.60 in chips)
Seat 3: 50QWoELmpmHFrFIlWMJo9g ($87.70 in chips)
Seat 4: mZNMJI1mY40XTC0U7GZakA ($50 in chips)
Seat 5: jSSGUXdNFAZA3QCvTcUMQw ($39.45 in chips)
Seat 6: EiWj2MAl8RNcPhTkzz24Mw ($36.95 in chips)
Seat 7: 3NcyXvr39gnK+KbTq7ezyA ($39.35 in chips)
Seat 8: NkS+CseUKx4XHszWq0PXEQ ($47.15 in chips)
Seat 9: CIrAX/m6o7jYmKOAjJXv4Q ($33.20 in chips)
50QWoELmpmHFrFIlWMJo9g: posts small blind $0.25
mZNMJI1mY40XTC0U7GZakA: posts big blind $0.50
*** HOLE CARDS ***
jSSGUXdNFAZA3QCvTcUMQw: folds
EiWj2MAl8RNcPhTkzz24Mw: folds
3NcyXvr39gnK+KbTq7ezyA: folds
NkS+CseUKx4XHszWq0PXEQ: folds
CIrAX/m6o7jYmKOAjJXv4Q: folds
SKnJuWHScqetA/qG5p+wCg: folds
9r7ZoBbAJj5IeyZ0q9BdzA: raises $1 to $1.50
50QWoELmpmHFrFIlWMJo9g: folds
mZNMJI1mY40XTC0U7GZakA: folds
9r7ZoBbAJj5IeyZ0q9BdzA collected $1.25 from pot
*** SUMMARY ***
Total pot $1.25 | Rake $0
Seat 1: SKnJuWHScqetA/qG5p+wCg folded before Flop (didn't bet)
Seat 2: 9r7ZoBbAJj5IeyZ0q9BdzA (button) collected ($1.25)
Seat 3: 50QWoELmpmHFrFIlWMJo9g (small blind) folded before Flop
Seat 4: mZNMJI1mY40XTC0U7GZakA (big blind) folded before Flop
Seat 5: jSSGUXdNFAZA3QCvTcUMQw folded before Flop (didn't bet)
Seat 6: EiWj2MAl8RNcPhTkzz24Mw folded before Flop (didn't bet)
Seat 7: 3NcyXvr39gnK+KbTq7ezyA folded before Flop (didn't bet)
Seat 8: NkS+CseUKx4XHszWq0PXEQ folded before Flop (didn't bet)
Seat 9: CIrAX/m6o7jYmKOAjJXv4Q folded before Flop (didn't bet)



PokerStars Game #59938817124:  Hold'em No Limit ($0.25/$0.50) - 2009/07/01 0:24:14 ET
Table 'c/CRn+68J3Y8KxD5g1ek2Q' 2-max Seat #1 is the button
Seat 1: 46qCyJ6evTkHo9al5sBMNA ($265.45 in chips)
Seat 2: BypVLsYQt3ePFm2xQL/dOA ($115.85 in chips)
46qCyJ6evTkHo9al5sBMNA: posts small blind $0.25
BypVLsYQt3ePFm2xQL/dOA: posts big blind $0.50
*** HOLE CARDS ***
46qCyJ6evTkHo9al5sBMNA: raises $1 to $1.50
BypVLsYQt3ePFm2xQL/dOA: calls $1
*** FLOP *** [3d Ac Th]
BypVLsYQt3ePFm2xQL/dOA: checks
46qCyJ6evTkHo9al5sBMNA: checks
*** TURN *** [3d Ac Th] [3h]
BypVLsYQt3ePFm2xQL/dOA: checks
46qCyJ6evTkHo9al5sBMNA: checks
*** RIVER *** [3d Ac Th 3h] [Ah]
BypVLsYQt3ePFm2xQL/dOA: checks
46qCyJ6evTkHo9al5sBMNA: bets $5
BypVLsYQt3ePFm2xQL/dOA: folds
46qCyJ6evTkHo9al5sBMNA collected $2.85 from pot
46qCyJ6evTkHo9al5sBMNA: doesn't show hand
*** SUMMARY ***
Total pot $3 | Rake $0.15
Board [3d Ac Th 3h Ah]
Seat 1: 46qCyJ6evTkHo9al5sBMNA (button) (small blind) collected ($2.85)
Seat 2: BypVLsYQt3ePFm2xQL/dOA (big blind) folded on the River



PokerStars Game #59938818014:  Hold'em No Limit ($0.25/$0.50) - 2009/07/01 0:24:15 ET
Table 'lSisgp6H7Fg1hH5VfjEjYQ' 9-max Seat #4 is the button
Seat 1: pEW8B6uXbdR47kfljMQ3+Q ($39.85 in chips)
Seat 2: UrcnkQOiLVk8BlKDPJSy7Q ($50.35 in chips)
Seat 3: aTkyjTh3w5YLWiIERupZOA ($39.40 in chips)
Seat 4: bwv/rbH/hHhPhY6u9mu04w ($24.25 in chips)
Seat 5: mSD1pginDsyHG5PDfqzphw ($10 in chips)
Seat 6: +k7T5ocke8UwavtgUHm+Cg ($26.10 in chips)
Seat 7: dGw5MBstXyXhWHHVFOWOFA ($43.75 in chips)
Seat 8: a4JDWmpFQkL10XfAyuF51A ($34.55 in chips)
Seat 9: 5JJVDlaiMnB004o/RqbZZQ ($40.50 in chips)
mSD1pginDsyHG5PDfqzphw: posts small blind $0.25
+k7T5ocke8UwavtgUHm+Cg: posts big blind $0.50
*** HOLE CARDS ***
dGw5MBstXyXhWHHVFOWOFA: folds
a4JDWmpFQkL10XfAyuF51A: folds
5JJVDlaiMnB004o/RqbZZQ: folds
pEW8B6uXbdR47kfljMQ3+Q: raises $1 to $1.50
UrcnkQOiLVk8BlKDPJSy7Q: folds
aTkyjTh3w5YLWiIERupZOA: folds
bwv/rbH/hHhPhY6u9mu04w: folds
mSD1pginDsyHG5PDfqzphw: folds
+k7T5ocke8UwavtgUHm+Cg: folds
pEW8B6uXbdR47kfljMQ3+Q collected $1.25 from pot
pEW8B6uXbdR47kfljMQ3+Q: doesn't show hand
*** SUMMARY ***
Total pot $1.25 | Rake $0
Seat 1: pEW8B6uXbdR47kfljMQ3+Q collected ($1.25)
Seat 2: UrcnkQOiLVk8BlKDPJSy7Q folded before Flop (didn't bet)
Seat 3: aTkyjTh3w5YLWiIERupZOA folded before Flop (didn't bet)
Seat 4: bwv/rbH/hHhPhY6u9mu04w (button) folded before Flop (didn't bet)
Seat 5: mSD1pginDsyHG5PDfqzphw (small blind) folded before Flop
Seat 6: +k7T5ocke8UwavtgUHm+Cg (big blind) folded before Flop
Seat 7: dGw5MBstXyXhWHHVFOWOFA folded before Flop (didn't bet)
Seat 8: a4JDWmpFQkL10XfAyuF51A folded before Flop (didn't bet)
Seat 9: 5JJVDlaiMnB004o/RqbZZQ folded before Flop (didn't bet)



PokerStars Game #59938819320:  Hold'em No Limit ($0.25/$0.50) - 2009/07/01 0:24:17 ET
Table '8YYaUJqyk4NgBvNkL7mj/Q' 2-max Seat #1 is the button
Seat 1: Fp/oksNpipCrD2MJ2pH20g ($22.70 in chips)
Seat 2: dkC7J+qbyqk0qCcmJbEPPw ($50 in chips)
Fp/oksNpipCrD2MJ2pH20g: posts small blind $0.25
dkC7J+qbyqk0qCcmJbEPPw: posts big blind $0.50
*** HOLE CARDS ***
Fp/oksNpipCrD2MJ2pH20g: raises $0.50 to $1
dkC7J+qbyqk0qCcmJbEPPw: calls $0.50
*** FLOP *** [8d Ah 7h]
dkC7J+qbyqk0qCcmJbEPPw: checks
Fp/oksNpipCrD2MJ2pH20g: bets $0.50
dkC7J+qbyqk0qCcmJbEPPw: calls $0.50
*** TURN *** [8d Ah 7h] [Jh]
dkC7J+qbyqk0qCcmJbEPPw: checks
Fp/oksNpipCrD2MJ2pH20g: checks
*** RIVER *** [8d Ah 7h Jh] [6h]
dkC7J+qbyqk0qCcmJbEPPw: checks
Fp/oksNpipCrD2MJ2pH20g: bets $0.50
dkC7J+qbyqk0qCcmJbEPPw: calls $0.50
*** SHOW DOWN ***
Fp/oksNpipCrD2MJ2pH20g: shows [7c Kd] (a pair of Sevens)
dkC7J+qbyqk0qCcmJbEPPw: mucks hand
Fp/oksNpipCrD2MJ2pH20g collected $3.85 from pot
*** SUMMARY ***
Total pot $4 | Rake $0.15
Board [8d Ah 7h Jh 6h]
Seat 1: Fp/oksNpipCrD2MJ2pH20g (button) (small blind) showed [7c Kd] and won ($3.85) with a pair of Sevens
Seat 2: dkC7J+qbyqk0qCcmJbEPPw (big blind) mucked



PokerStars Game #59938819386:  Hold'em No Limit ($0.25/$0.50) - 2009/07/01 0:24:17 ET
Table 'dVmkPtk5nWTfXApFsnhIOg' 2-max Seat #1 is the button
Seat 1: bypIyrYcAAifLfhZpGlKLA ($54.90 in chips)
Seat 2: rPToQDbLWB+dKnz7fcQSIg ($26.15 in chips)
bypIyrYcAAifLfhZpGlKLA: posts small blind $0.25
rPToQDbLWB+dKnz7fcQSIg: posts big blind $0.50
*** HOLE CARDS ***
bypIyrYcAAifLfhZpGlKLA: raises $1 to $1.50
rPToQDbLWB+dKnz7fcQSIg: calls $1
*** FLOP *** [Ac Th 6h]
rPToQDbLWB+dKnz7fcQSIg: checks
bypIyrYcAAifLfhZpGlKLA: checks
*** TURN *** [Ac Th 6h] [Qs]
rPToQDbLWB+dKnz7fcQSIg: checks
bypIyrYcAAifLfhZpGlKLA: checks
*** RIVER *** [Ac Th 6h Qs] [3s]
rPToQDbLWB+dKnz7fcQSIg: bets $2.50
bypIyrYcAAifLfhZpGlKLA: folds
rPToQDbLWB+dKnz7fcQSIg collected $2.85 from pot
*** SUMMARY ***
Total pot $3 | Rake $0.15
Board [Ac Th 6h Qs 3s]
Seat 1: bypIyrYcAAifLfhZpGlKLA (button) (small blind) folded on the River
Seat 2: rPToQDbLWB+dKnz7fcQSIg (big blind) collected ($2.85)



PokerStars Game #59938820614:  Hold'em No Limit ($0.25/$0.50) - 2009/07/01 0:24:19 ET
Table 'GfL/No5u5PoEnU39lP5pQg' 6-max Seat #6 is the button
Seat 1: 1WUCqNG+p+vfWRTXNu4ljw ($50.90 in chips)
Seat 2: uVwggSetzp7d+eVgowO3vg ($44.75 in chips)
Seat 3: qNezhXOOUXqwG7b9X5XJAA ($50 in chips)
Seat 5: crjGpJEzSZgD38FoE3VMGg ($54.30 in chips)
Seat 6: 3wylWYGeXFXcrE4XVrlPng ($80.45 in chips)
1WUCqNG+p+vfWRTXNu4ljw: posts small blind $0.25
uVwggSetzp7d+eVgowO3vg: posts big blind $0.50
OZ6OtYh5Y53MCH/p0QTn5g: sits out
*** HOLE CARDS ***
qNezhXOOUXqwG7b9X5XJAA: folds
crjGpJEzSZgD38FoE3VMGg: folds
3wylWYGeXFXcrE4XVrlPng: folds
3wylWYGeXFXcrE4XVrlPng is sitting out
1WUCqNG+p+vfWRTXNu4ljw: folds
uVwggSetzp7d+eVgowO3vg collected $0.50 from pot
*** SUMMARY ***
Total pot $0.50 | Rake $0
Seat 1: 1WUCqNG+p+vfWRTXNu4ljw (small blind) folded before Flop
Seat 2: uVwggSetzp7d+eVgowO3vg (big blind) collected ($0.50)
Seat 3: qNezhXOOUXqwG7b9X5XJAA folded before Flop (didn't bet)
Seat 5: crjGpJEzSZgD38FoE3VMGg folded before Flop (didn't bet)
Seat 6: 3wylWYGeXFXcrE4XVrlPng (button) folded before Flop (didn't bet)



PokerStars Game #59938821622:  Hold'em No Limit ($0.25/$0.50) - 2009/07/01 0:24:21 ET
Table 'raOT4/ipuZgzjfKHC+jD9g' 2-max Seat #1 is the button
Seat 1: IuwLemwLhc9fvrwBGs0AMA ($5.70 in chips)
Seat 2: Udr5juWSWUgTu1NlRhjMdA ($15.95 in chips)
IuwLemwLhc9fvrwBGs0AMA: posts small blind $0.25
Udr5juWSWUgTu1NlRhjMdA: posts big blind $0.50
*** HOLE CARDS ***
IuwLemwLhc9fvrwBGs0AMA: folds
Udr5juWSWUgTu1NlRhjMdA collected $0.50 from pot
Udr5juWSWUgTu1NlRhjMdA: doesn't show hand
*** SUMMARY ***
Total pot $0.50 | Rake $0
Seat 1: IuwLemwLhc9fvrwBGs0AMA (button) (small blind) folded before Flop
Seat 2: Udr5juWSWUgTu1NlRhjMdA (big blind) collected ($0.50)



PokerStars Game #59938824858:  Hold'em No Limit ($0.25/$0.50) - 2009/07/01 0:24:25 ET
Table 'ZYwMb9E6tY50Qm+iNbXRYw' 2-max Seat #2 is the button
Seat 1: DXLfRb8KDZWmrztw2bwtFw ($11 in chips)
Seat 2: 16tvT7AYgZ2LgiGFcvFKQg ($19.50 in chips)
16tvT7AYgZ2LgiGFcvFKQg: posts small blind $0.25
DXLfRb8KDZWmrztw2bwtFw: posts big blind $0.50
*** HOLE CARDS ***
16tvT7AYgZ2LgiGFcvFKQg: raises $0.50 to $1
DXLfRb8KDZWmrztw2bwtFw: calls $0.50
*** FLOP *** [Jd 5h 9h]
DXLfRb8KDZWmrztw2bwtFw: checks
16tvT7AYgZ2LgiGFcvFKQg: bets $1
DXLfRb8KDZWmrztw2bwtFw: folds
16tvT7AYgZ2LgiGFcvFKQg collected $1.90 from pot
16tvT7AYgZ2LgiGFcvFKQg: doesn't show hand
*** SUMMARY ***
Total pot $2 | Rake $0.10
Board [Jd 5h 9h]
Seat 1: DXLfRb8KDZWmrztw2bwtFw (big blind) folded on the Flop
Seat 2: 16tvT7AYgZ2LgiGFcvFKQg (button) (small blind) collected ($1.90)



PokerStars Game #59938825898:  Hold'em No Limit ($0.25/$0.50) - 2009/07/01 0:24:27 ET
Table 'E7bWJ45aoFXRpyRv2gw+Ig' 2-max Seat #1 is the button
Seat 1: FRkiRasEGlHUeLrEl+k/nA ($66.50 in chips)
Seat 2: 3Wro85I7472vJ4Wkpneo9A ($112.10 in chips)
FRkiRasEGlHUeLrEl+k/nA: posts small blind $0.25
3Wro85I7472vJ4Wkpneo9A: posts big blind $0.50
*** HOLE CARDS ***
FRkiRasEGlHUeLrEl+k/nA: raises $1 to $1.50
3Wro85I7472vJ4Wkpneo9A: folds
FRkiRasEGlHUeLrEl+k/nA collected $1 from pot
FRkiRasEGlHUeLrEl+k/nA: doesn't show hand
*** SUMMARY ***
Total pot $1 | Rake $0
Seat 1: FRkiRasEGlHUeLrEl+k/nA (button) (small blind) collected ($1)
Seat 2: 3Wro85I7472vJ4Wkpneo9A (big blind) folded before Flop



PokerStars Game #59938825992:  Hold'em No Limit ($0.25/$0.50) - 2009/07/01 0:24:27 ET
Table 'raOT4/ipuZgzjfKHC+jD9g' 2-max Seat #2 is the button
Seat 1: IuwLemwLhc9fvrwBGs0AMA ($5.45 in chips)
Seat 2: Udr5juWSWUgTu1NlRhjMdA ($16.20 in chips)
Udr5juWSWUgTu1NlRhjMdA: posts small blind $0.25
IuwLemwLhc9fvrwBGs0AMA: posts big blind $0.50
*** HOLE CARDS ***
Udr5juWSWUgTu1NlRhjMdA: raises $1 to $1.50
IuwLemwLhc9fvrwBGs0AMA: folds
Udr5juWSWUgTu1NlRhjMdA collected $1 from pot
Udr5juWSWUgTu1NlRhjMdA: doesn't show hand
*** SUMMARY ***
Total pot $1 | Rake $0
Seat 1: IuwLemwLhc9fvrwBGs0AMA (big blind) folded before Flop
Seat 2: Udr5juWSWUgTu1NlRhjMdA (button) (small blind) collected ($1)



PokerStars Game #59938827446:  Hold'em No Limit ($0.25/$0.50) - 2009/07/01 0:24:30 ET
Table 'T/PgNWqVyY6lkldcBVXYJQ' 6-max Seat #5 is the button
Seat 1: +Pf9jTVizYlIo+woPvptfA ($53.75 in chips)
Seat 2: oZAeY5rVqNGgt8yyQ0pxbA ($28.50 in chips)
Seat 3: L3OcNO1bgdqDI46j67KQPQ ($53.30 in chips)
Seat 4: jxMvxeUUL9UU0V6wVU+Iyw ($9.95 in chips)
Seat 5: vVQBckETtigfb5mAcyK0OA ($56.85 in chips)
Seat 6: cDzbog6kwmJp+LBeBq+iMQ ($34 in chips)
cDzbog6kwmJp+LBeBq+iMQ said, "boo"
cDzbog6kwmJp+LBeBq+iMQ: posts small blind $0.25
+Pf9jTVizYlIo+woPvptfA: posts big blind $0.50
*** HOLE CARDS ***
oZAeY5rVqNGgt8yyQ0pxbA: raises $1 to $1.50
L3OcNO1bgdqDI46j67KQPQ: folds
jxMvxeUUL9UU0V6wVU+Iyw said, "All you gotta do is drive to Hamilton.  I will look after the rest.  Plus, it's Canada day. Lots of fun."
jxMvxeUUL9UU0V6wVU+Iyw: folds
vVQBckETtigfb5mAcyK0OA: calls $1.50
cDzbog6kwmJp+LBeBq+iMQ: calls $1.25
+Pf9jTVizYlIo+woPvptfA: calls $1
*** FLOP *** [Ad 9d 6d]
cDzbog6kwmJp+LBeBq+iMQ: folds
+Pf9jTVizYlIo+woPvptfA: checks
oZAeY5rVqNGgt8yyQ0pxbA: bets $2.50
vVQBckETtigfb5mAcyK0OA: calls $2.50
+Pf9jTVizYlIo+woPvptfA: folds
*** TURN *** [Ad 9d 6d] [2s]
jxMvxeUUL9UU0V6wVU+Iyw said, "I guarantee you will have an awesome time and will go home safe"
oZAeY5rVqNGgt8yyQ0pxbA: bets $3
vVQBckETtigfb5mAcyK0OA: calls $3
*** RIVER *** [Ad 9d 6d 2s] [Ts]
oZAeY5rVqNGgt8yyQ0pxbA: bets $2
vVQBckETtigfb5mAcyK0OA: folds
oZAeY5rVqNGgt8yyQ0pxbA collected $16.20 from pot
oZAeY5rVqNGgt8yyQ0pxbA: doesn't show hand
*** SUMMARY ***
Total pot $17 | Rake $0.80
Board [Ad 9d 6d 2s Ts]
Seat 1: +Pf9jTVizYlIo+woPvptfA (big blind) folded on the Flop
Seat 2: oZAeY5rVqNGgt8yyQ0pxbA collected ($16.20)
Seat 3: L3OcNO1bgdqDI46j67KQPQ folded before Flop (didn't bet)
Seat 4: jxMvxeUUL9UU0V6wVU+Iyw folded before Flop (didn't bet)
Seat 5: vVQBckETtigfb5mAcyK0OA (button) folded on the River
Seat 6: cDzbog6kwmJp+LBeBq+iMQ (small blind) folded on the Flop



PokerStars Game #59938828558:  Hold'em No Limit ($0.25/$0.50) - 2009/07/01 0:24:31 ET
Table '3FhG0gl3kMX3wBEEqj+wnQ' 9-max Seat #4 is the button
Seat 1: e0J9pdCNUDTCG031RnXqLA ($19.50 in chips)
Seat 2: 4dl3YNqZ6Houm2jZAzDmRg ($19.75 in chips)
Seat 3: HZkVla4kK2SI42CVrPZ/ig ($9.25 in chips)
Seat 4: bz4LMfV0GGl/MJ/ABXuPmg ($15.20 in chips)
Seat 5: XNMDwbXt/Q4jM99AXnbJDw ($55.05 in chips)
Seat 6: 5JJVDlaiMnB004o/RqbZZQ ($24.50 in chips)
Seat 7: mSD1pginDsyHG5PDfqzphw ($10 in chips)
Seat 8: j3K/Jujr7PY4ZM2RZvlH6A ($58.45 in chips)
Seat 9: L5e2lrPLQm1Pqx30IIZ/Fw ($10 in chips)
XNMDwbXt/Q4jM99AXnbJDw: posts small blind $0.25
5JJVDlaiMnB004o/RqbZZQ: posts big blind $0.50
*** HOLE CARDS ***
mSD1pginDsyHG5PDfqzphw: folds
j3K/Jujr7PY4ZM2RZvlH6A: folds
L5e2lrPLQm1Pqx30IIZ/Fw: folds
e0J9pdCNUDTCG031RnXqLA: folds
4dl3YNqZ6Houm2jZAzDmRg: calls $0.50
HZkVla4kK2SI42CVrPZ/ig: folds
bz4LMfV0GGl/MJ/ABXuPmg: calls $0.50
XNMDwbXt/Q4jM99AXnbJDw: folds
5JJVDlaiMnB004o/RqbZZQ: checks
*** FLOP *** [6s 4c 9s]
5JJVDlaiMnB004o/RqbZZQ: checks
4dl3YNqZ6Houm2jZAzDmRg: bets $1
bz4LMfV0GGl/MJ/ABXuPmg: calls $1
5JJVDlaiMnB004o/RqbZZQ: folds
*** TURN *** [6s 4c 9s] [Jd]
4dl3YNqZ6Houm2jZAzDmRg: bets $1.50
bz4LMfV0GGl/MJ/ABXuPmg: calls $1.50
*** RIVER *** [6s 4c 9s Jd] [Js]
4dl3YNqZ6Houm2jZAzDmRg: bets $1.50
bz4LMfV0GGl/MJ/ABXuPmg: raises $1.50 to $3
4dl3YNqZ6Houm2jZAzDmRg: calls $1.50
*** SHOW DOWN ***
bz4LMfV0GGl/MJ/ABXuPmg: shows [8s 7s] (a flush, Jack high)
4dl3YNqZ6Houm2jZAzDmRg: mucks hand
bz4LMfV0GGl/MJ/ABXuPmg collected $12.15 from pot
*** SUMMARY ***
Total pot $12.75 | Rake $0.60
Board [6s 4c 9s Jd Js]
Seat 1: e0J9pdCNUDTCG031RnXqLA folded before Flop (didn't bet)
Seat 2: 4dl3YNqZ6Houm2jZAzDmRg mucked
Seat 3: HZkVla4kK2SI42CVrPZ/ig folded before Flop (didn't bet)
Seat 4: bz4LMfV0GGl/MJ/ABXuPmg (button) showed [8s 7s] and won ($12.15) with a flush, Jack high
Seat 5: XNMDwbXt/Q4jM99AXnbJDw (small blind) folded before Flop
Seat 6: 5JJVDlaiMnB004o/RqbZZQ (big blind) folded on the Flop
Seat 7: mSD1pginDsyHG5PDfqzphw folded before Flop (didn't bet)
Seat 8: j3K/Jujr7PY4ZM2RZvlH6A folded before Flop (didn't bet)
Seat 9: L5e2lrPLQm1Pqx30IIZ/Fw folded before Flop (didn't bet)



PokerStars Game #59938830922:  Hold'em No Limit ($0.25/$0.50) - 2009/07/01 0:24:35 ET
Table 'E7bWJ45aoFXRpyRv2gw+Ig' 2-max Seat #2 is the button
Seat 1: FRkiRasEGlHUeLrEl+k/nA ($67 in chips)
Seat 2: 3Wro85I7472vJ4Wkpneo9A ($111.60 in chips)
3Wro85I7472vJ4Wkpneo9A: posts small blind $0.25
FRkiRasEGlHUeLrEl+k/nA: posts big blind $0.50
*** HOLE CARDS ***
3Wro85I7472vJ4Wkpneo9A: calls $0.25
FRkiRasEGlHUeLrEl+k/nA: checks
*** FLOP *** [Ah Ts 9d]
FRkiRasEGlHUeLrEl+k/nA: checks
3Wro85I7472vJ4Wkpneo9A: bets $1
FRkiRasEGlHUeLrEl+k/nA: calls $1
*** TURN *** [Ah Ts 9d] [2s]
FRkiRasEGlHUeLrEl+k/nA: checks
3Wro85I7472vJ4Wkpneo9A: bets $2
FRkiRasEGlHUeLrEl+k/nA: calls $2
*** RIVER *** [Ah Ts 9d 2s] [8h]
FRkiRasEGlHUeLrEl+k/nA: checks
3Wro85I7472vJ4Wkpneo9A: bets $4.50
FRkiRasEGlHUeLrEl+k/nA: folds
3Wro85I7472vJ4Wkpneo9A collected $6.70 from pot
3Wro85I7472vJ4Wkpneo9A: doesn't show hand
*** SUMMARY ***
Total pot $7 | Rake $0.30
Board [Ah Ts 9d 2s 8h]
Seat 1: FRkiRasEGlHUeLrEl+k/nA (big blind) folded on the River
Seat 2: 3Wro85I7472vJ4Wkpneo9A (button) (small blind) collected ($6.70)



PokerStars Game #59938830876:  Hold'em No Limit ($0.25/$0.50) - 2009/07/01 0:24:35 ET
Table 'fx6MqwfYAj/Rt86hBz2L3Q' 9-max Seat #1 is the button
Seat 1: jf2c/o9gI7Xj0GleCSMj9g ($51.05 in chips)
Seat 2: C3rGXblctNcWI6JYPHhaEg ($10 in chips)
Seat 3: iadBi5AEt7gTBXbDSSnMYQ ($56.10 in chips)
Seat 4: gPEN9Zp33YTm/mu9/SYP1w ($25.45 in chips)
Seat 5: iAISe3dVeua8PUn2wwgDHw ($26.50 in chips)
Seat 7: bkXkL3pmapikPQQRNPZSEA ($7.25 in chips)
Seat 8: 6ol/q1A4zYU6qXbZnTzPfQ ($20.30 in chips)
Seat 9: HZkVla4kK2SI42CVrPZ/ig ($9.25 in chips)
C3rGXblctNcWI6JYPHhaEg: posts small blind $0.25
iadBi5AEt7gTBXbDSSnMYQ: posts big blind $0.50
*** HOLE CARDS ***
gPEN9Zp33YTm/mu9/SYP1w: folds
iAISe3dVeua8PUn2wwgDHw: folds
VelaednozEGCpceHSFUsAg leaves the table
bkXkL3pmapikPQQRNPZSEA: folds
6ol/q1A4zYU6qXbZnTzPfQ: folds
HZkVla4kK2SI42CVrPZ/ig: folds
jf2c/o9gI7Xj0GleCSMj9g: folds
C3rGXblctNcWI6JYPHhaEg: calls $0.25
iadBi5AEt7gTBXbDSSnMYQ: checks
*** FLOP *** [8c 3h 3c]
C3rGXblctNcWI6JYPHhaEg: bets $2
iadBi5AEt7gTBXbDSSnMYQ: calls $2
*** TURN *** [8c 3h 3c] [Ah]
5k9fvXD9suIgCxU4HLQjTw joins the table at seat #6
C3rGXblctNcWI6JYPHhaEg: bets $2.50
iadBi5AEt7gTBXbDSSnMYQ: calls $2.50
*** RIVER *** [8c 3h 3c Ah] [8s]
C3rGXblctNcWI6JYPHhaEg: bets $5 and is all-in
iadBi5AEt7gTBXbDSSnMYQ: folds
C3rGXblctNcWI6JYPHhaEg collected $9.55 from pot
C3rGXblctNcWI6JYPHhaEg: doesn't show hand
*** SUMMARY ***
Total pot $10 | Rake $0.45
Board [8c 3h 3c Ah 8s]
Seat 1: jf2c/o9gI7Xj0GleCSMj9g (button) folded before Flop (didn't bet)
Seat 2: C3rGXblctNcWI6JYPHhaEg (small blind) collected ($9.55)
Seat 3: iadBi5AEt7gTBXbDSSnMYQ (big blind) folded on the River
Seat 4: gPEN9Zp33YTm/mu9/SYP1w folded before Flop (didn't bet)
Seat 5: iAISe3dVeua8PUn2wwgDHw folded before Flop (didn't bet)
Seat 7: bkXkL3pmapikPQQRNPZSEA folded before Flop (didn't bet)
Seat 8: 6ol/q1A4zYU6qXbZnTzPfQ folded before Flop (didn't bet)
Seat 9: HZkVla4kK2SI42CVrPZ/ig folded before Flop (didn't bet)



PokerStars Game #59938831458:  Hold'em No Limit ($0.25/$0.50) - 2009/07/01 0:24:36 ET
Table 'dVmkPtk5nWTfXApFsnhIOg' 2-max Seat #2 is the button
Seat 1: bypIyrYcAAifLfhZpGlKLA ($53.40 in chips)
Seat 2: rPToQDbLWB+dKnz7fcQSIg ($27.50 in chips)
rPToQDbLWB+dKnz7fcQSIg: posts small blind $0.25
bypIyrYcAAifLfhZpGlKLA: posts big blind $0.50
*** HOLE CARDS ***
rPToQDbLWB+dKnz7fcQSIg: calls $0.25
bypIyrYcAAifLfhZpGlKLA: checks
*** FLOP *** [5s Kd 3d]
bypIyrYcAAifLfhZpGlKLA: bets $1
rPToQDbLWB+dKnz7fcQSIg: calls $1
*** TURN *** [5s Kd 3d] [Kh]
bypIyrYcAAifLfhZpGlKLA: bets $2.50
rPToQDbLWB+dKnz7fcQSIg: calls $2.50
*** RIVER *** [5s Kd 3d Kh] [Kc]
bypIyrYcAAifLfhZpGlKLA: bets $49.40 and is all-in
rPToQDbLWB+dKnz7fcQSIg: calls $23.50 and is all-in
*** SHOW DOWN ***
bypIyrYcAAifLfhZpGlKLA: shows [Ks 5d] (four of a kind, Kings)
rPToQDbLWB+dKnz7fcQSIg: mucks hand
bypIyrYcAAifLfhZpGlKLA collected $54.50 from pot
*** SUMMARY ***
Total pot $55 | Rake $0.50
Board [5s Kd 3d Kh Kc]
Seat 1: bypIyrYcAAifLfhZpGlKLA (big blind) showed [Ks 5d] and won ($54.50) with four of a kind, Kings
Seat 2: rPToQDbLWB+dKnz7fcQSIg (button) (small blind) mucked



PokerStars Game #59938831966:  Hold'em No Limit ($0.25/$0.50) - 2009/07/01 0:24:36 ET
Table 'tyR5AZNKV8Aadbrnrnlg7g' 6-max Seat #5 is the button
Seat 1: R+KjpH/wSjDLhtIy9+edNA ($56.30 in chips)
Seat 2: 58zdeSBSuSFX/qZfhc7YmA ($29.10 in chips)
Seat 3: jUhx+m+V7qfbLZTjgwZByg ($30.45 in chips)
Seat 4: Rt6KgtZ8YaJoTc3FPim00w ($84.25 in chips)
Seat 5: wOyVV9M/oyiw3YaOjNZ05w ($50 in chips)
Seat 6: DMQLAmut/l19xN5STQndFg ($6.30 in chips)
DMQLAmut/l19xN5STQndFg: posts small blind $0.25
R+KjpH/wSjDLhtIy9+edNA: posts big blind $0.50
*** HOLE CARDS ***
58zdeSBSuSFX/qZfhc7YmA: folds
jUhx+m+V7qfbLZTjgwZByg: calls $0.50
Rt6KgtZ8YaJoTc3FPim00w: folds
wOyVV9M/oyiw3YaOjNZ05w: folds
DMQLAmut/l19xN5STQndFg: calls $0.25
R+KjpH/wSjDLhtIy9+edNA: raises $1.50 to $2
jUhx+m+V7qfbLZTjgwZByg: calls $1.50
DMQLAmut/l19xN5STQndFg: calls $1.50
*** FLOP *** [7d 4c Jh]
DMQLAmut/l19xN5STQndFg: checks
R+KjpH/wSjDLhtIy9+edNA: checks
jUhx+m+V7qfbLZTjgwZByg: bets $3
DMQLAmut/l19xN5STQndFg: folds
R+KjpH/wSjDLhtIy9+edNA: calls $3
*** TURN *** [7d 4c Jh] [7h]
R+KjpH/wSjDLhtIy9+edNA: checks
jUhx+m+V7qfbLZTjgwZByg: bets $5
R+KjpH/wSjDLhtIy9+edNA: raises $7 to $12
jUhx+m+V7qfbLZTjgwZByg: raises $7 to $19
R+KjpH/wSjDLhtIy9+edNA: raises $11.50 to $30.50
jUhx+m+V7qfbLZTjgwZByg: calls $6.45 and is all-in
*** RIVER *** [7d 4c Jh 7h] [6h]
*** SHOW DOWN ***
R+KjpH/wSjDLhtIy9+edNA: shows [Jc Jd] (a full house, Jacks full of Sevens)
jUhx+m+V7qfbLZTjgwZByg: shows [Ac 7c] (three of a kind, Sevens)
R+KjpH/wSjDLhtIy9+edNA collected $59.90 from pot
*** SUMMARY ***
Total pot $62.90 | Rake $3
Board [7d 4c Jh 7h 6h]
Seat 1: R+KjpH/wSjDLhtIy9+edNA (big blind) showed [Jc Jd] and won ($59.90) with a full house, Jacks full of Sevens
Seat 2: 58zdeSBSuSFX/qZfhc7YmA folded before Flop (didn't bet)
Seat 3: jUhx+m+V7qfbLZTjgwZByg showed [Ac 7c] and lost with three of a kind, Sevens
Seat 4: Rt6KgtZ8YaJoTc3FPim00w folded before Flop (didn't bet)
Seat 5: wOyVV9M/oyiw3YaOjNZ05w (button) folded before Flop (didn't bet)
Seat 6: DMQLAmut/l19xN5STQndFg (small blind) folded on the Flop



PokerStars Game #59938831370:  Hold'em No Limit ($0.25/$0.50) - 2009/07/01 0:24:36 ET
Table 'PALRfuH85dr5IkDfdv6new' 9-max Seat #3 is the button
Seat 1: SKnJuWHScqetA/qG5p+wCg ($31.25 in chips)
Seat 2: 9r7ZoBbAJj5IeyZ0q9BdzA ($11.35 in chips)
Seat 3: 50QWoELmpmHFrFIlWMJo9g ($87.45 in chips)
Seat 4: mZNMJI1mY40XTC0U7GZakA ($50 in chips)
Seat 5: jSSGUXdNFAZA3QCvTcUMQw ($39.45 in chips)
Seat 6: EiWj2MAl8RNcPhTkzz24Mw ($36.95 in chips)
Seat 7: 3NcyXvr39gnK+KbTq7ezyA ($39.35 in chips)
Seat 8: NkS+CseUKx4XHszWq0PXEQ ($47.15 in chips)
Seat 9: CIrAX/m6o7jYmKOAjJXv4Q ($33.20 in chips)
mZNMJI1mY40XTC0U7GZakA: posts small blind $0.25
jSSGUXdNFAZA3QCvTcUMQw: posts big blind $0.50
*** HOLE CARDS ***
EiWj2MAl8RNcPhTkzz24Mw: folds
3NcyXvr39gnK+KbTq7ezyA: folds
NkS+CseUKx4XHszWq0PXEQ: calls $0.50
EiWj2MAl8RNcPhTkzz24Mw leaves the table
CIrAX/m6o7jYmKOAjJXv4Q: folds
SKnJuWHScqetA/qG5p+wCg: folds
E2518gp4aFz1+kAgmGqeEg joins the table at seat #6
9r7ZoBbAJj5IeyZ0q9BdzA: raises $1 to $1.50
50QWoELmpmHFrFIlWMJo9g: folds
mZNMJI1mY40XTC0U7GZakA: folds
jSSGUXdNFAZA3QCvTcUMQw: calls $1
NkS+CseUKx4XHszWq0PXEQ: calls $1
*** FLOP *** [As 7d 3s]
jSSGUXdNFAZA3QCvTcUMQw: checks
NkS+CseUKx4XHszWq0PXEQ: checks
9r7ZoBbAJj5IeyZ0q9BdzA: bets $1.50
jSSGUXdNFAZA3QCvTcUMQw: calls $1.50
NkS+CseUKx4XHszWq0PXEQ: folds
*** TURN *** [As 7d 3s] [8c]
jSSGUXdNFAZA3QCvTcUMQw: checks
9r7ZoBbAJj5IeyZ0q9BdzA: bets $1.50
jSSGUXdNFAZA3QCvTcUMQw: calls $1.50
*** RIVER *** [As 7d 3s 8c] [Ah]
jSSGUXdNFAZA3QCvTcUMQw: checks
9r7ZoBbAJj5IeyZ0q9BdzA: checks
*** SHOW DOWN ***
jSSGUXdNFAZA3QCvTcUMQw: shows [Tc Ad] (three of a kind, Aces)
9r7ZoBbAJj5IeyZ0q9BdzA: mucks hand
jSSGUXdNFAZA3QCvTcUMQw collected $10.25 from pot
*** SUMMARY ***
Total pot $10.75 | Rake $0.50
Board [As 7d 3s 8c Ah]
Seat 1: SKnJuWHScqetA/qG5p+wCg folded before Flop (didn't bet)
Seat 2: 9r7ZoBbAJj5IeyZ0q9BdzA mucked
Seat 3: 50QWoELmpmHFrFIlWMJo9g (button) folded before Flop (didn't bet)
Seat 4: mZNMJI1mY40XTC0U7GZakA (small blind) folded before Flop
Seat 5: jSSGUXdNFAZA3QCvTcUMQw (big blind) showed [Tc Ad] and won ($10.25) with three of a kind, Aces
Seat 6: EiWj2MAl8RNcPhTkzz24Mw folded before Flop (didn't bet)
Seat 7: 3NcyXvr39gnK+KbTq7ezyA folded before Flop (didn't bet)
Seat 8: NkS+CseUKx4XHszWq0PXEQ folded on the Flop
Seat 9: CIrAX/m6o7jYmKOAjJXv4Q folded before Flop (didn't bet)



PokerStars Game #59938832428:  Hold'em No Limit ($0.25/$0.50) - 2009/07/01 0:24:37 ET
Table 'raOT4/ipuZgzjfKHC+jD9g' 2-max Seat #1 is the button
Seat 1: IuwLemwLhc9fvrwBGs0AMA ($4.95 in chips)
Seat 2: Udr5juWSWUgTu1NlRhjMdA ($16.70 in chips)
IuwLemwLhc9fvrwBGs0AMA: posts small blind $0.25
Udr5juWSWUgTu1NlRhjMdA: posts big blind $0.50
*** HOLE CARDS ***
IuwLemwLhc9fvrwBGs0AMA: folds
Udr5juWSWUgTu1NlRhjMdA collected $0.50 from pot
Udr5juWSWUgTu1NlRhjMdA: doesn't show hand
*** SUMMARY ***
Total pot $0.50 | Rake $0
Seat 1: IuwLemwLhc9fvrwBGs0AMA (button) (small blind) folded before Flop
Seat 2: Udr5juWSWUgTu1NlRhjMdA (big blind) collected ($0.50)



PokerStars Game #59938833820:  Hold'em No Limit ($0.25/$0.50) - 2009/07/01 0:24:39 ET
Table 'IeNZOZQ4T6oiaHqFeo6yIA' 2-max Seat #2 is the button
Seat 1: ndd1nfncBkWNitBnsfCoVQ ($95.70 in chips)
Seat 2: A91IUl5JaZROhtfCtnnwYw ($38.95 in chips)
A91IUl5JaZROhtfCtnnwYw: posts small blind $0.25
ndd1nfncBkWNitBnsfCoVQ: posts big blind $0.50
*** HOLE CARDS ***
A91IUl5JaZROhtfCtnnwYw: calls $0.25
ndd1nfncBkWNitBnsfCoVQ: checks
*** FLOP *** [6h Jc 7h]
ndd1nfncBkWNitBnsfCoVQ: checks
A91IUl5JaZROhtfCtnnwYw: checks
*** TURN *** [6h Jc 7h] [8d]
ndd1nfncBkWNitBnsfCoVQ: bets $1
A91IUl5JaZROhtfCtnnwYw: calls $1
*** RIVER *** [6h Jc 7h 8d] [2h]
ndd1nfncBkWNitBnsfCoVQ: checks
A91IUl5JaZROhtfCtnnwYw: checks
*** SHOW DOWN ***
ndd1nfncBkWNitBnsfCoVQ: shows [8h 9c] (a pair of Eights)
A91IUl5JaZROhtfCtnnwYw: mucks hand
ndd1nfncBkWNitBnsfCoVQ collected $2.90 from pot
*** SUMMARY ***
Total pot $3 | Rake $0.10
Board [6h Jc 7h 8d 2h]
Seat 1: ndd1nfncBkWNitBnsfCoVQ (big blind) showed [8h 9c] and won ($2.90) with a pair of Eights
Seat 2: A91IUl5JaZROhtfCtnnwYw (button) (small blind) mucked



PokerStars Game #59938835178:  Hold'em No Limit ($0.25/$0.50) - 2009/07/01 0:24:41 ET
Table 'ZYwMb9E6tY50Qm+iNbXRYw' 2-max Seat #1 is the button
Seat 1: DXLfRb8KDZWmrztw2bwtFw ($10 in chips)
Seat 2: 16tvT7AYgZ2LgiGFcvFKQg ($20.40 in chips)
DXLfRb8KDZWmrztw2bwtFw: posts small blind $0.25
16tvT7AYgZ2LgiGFcvFKQg: posts big blind $0.50
*** HOLE CARDS ***
DXLfRb8KDZWmrztw2bwtFw: calls $0.25
16tvT7AYgZ2LgiGFcvFKQg: checks
*** FLOP *** [As 8c 6c]
16tvT7AYgZ2LgiGFcvFKQg: checks
DXLfRb8KDZWmrztw2bwtFw: checks
*** TURN *** [As 8c 6c] [9h]
16tvT7AYgZ2LgiGFcvFKQg: checks
DXLfRb8KDZWmrztw2bwtFw: checks
*** RIVER *** [As 8c 6c 9h] [6s]
16tvT7AYgZ2LgiGFcvFKQg: bets $3
DXLfRb8KDZWmrztw2bwtFw: folds
16tvT7AYgZ2LgiGFcvFKQg collected $0.95 from pot
*** SUMMARY ***
Total pot $1 | Rake $0.05
Board [As 8c 6c 9h 6s]
Seat 1: DXLfRb8KDZWmrztw2bwtFw (button) (small blind) folded on the River
Seat 2: 16tvT7AYgZ2LgiGFcvFKQg (big blind) collected ($0.95)



PokerStars Game #59938836804:  Hold'em No Limit ($0.25/$0.50) - 2009/07/01 0:24:44 ET
Table '+z1aekfHkpp09pc8F9aViw' 6-max Seat #4 is the button
Seat 1: wOyVV9M/oyiw3YaOjNZ05w ($50.75 in chips)
Seat 2: M6xK/VklCvdyyrmvzATlxQ ($29.95 in chips)
Seat 3: uUznlIMFnRUvwrBhYF73KA ($65.25 in chips)
Seat 4: RowCSpSURHTOL/dcjg/Iug ($47.70 in chips)
Seat 5: crjGpJEzSZgD38FoE3VMGg ($59.40 in chips)
Seat 6: 686aeHikcJlgKkSuIFdcXQ ($70.10 in chips)
crjGpJEzSZgD38FoE3VMGg: posts small blind $0.25
686aeHikcJlgKkSuIFdcXQ: posts big blind $0.50
*** HOLE CARDS ***
wOyVV9M/oyiw3YaOjNZ05w: raises $1.50 to $2
M6xK/VklCvdyyrmvzATlxQ: folds
uUznlIMFnRUvwrBhYF73KA: calls $2
RowCSpSURHTOL/dcjg/Iug: folds
crjGpJEzSZgD38FoE3VMGg: folds
686aeHikcJlgKkSuIFdcXQ: folds
*** FLOP *** [Qc Tc 3c]
wOyVV9M/oyiw3YaOjNZ05w: checks
uUznlIMFnRUvwrBhYF73KA: checks
*** TURN *** [Qc Tc 3c] [Qs]
wOyVV9M/oyiw3YaOjNZ05w: bets $3
uUznlIMFnRUvwrBhYF73KA: folds
wOyVV9M/oyiw3YaOjNZ05w collected $4.55 from pot
*** SUMMARY ***
Total pot $4.75 | Rake $0.20
Board [Qc Tc 3c Qs]
Seat 1: wOyVV9M/oyiw3YaOjNZ05w collected ($4.55)
Seat 2: M6xK/VklCvdyyrmvzATlxQ folded before Flop (didn't bet)
Seat 3: uUznlIMFnRUvwrBhYF73KA folded on the Turn
Seat 4: RowCSpSURHTOL/dcjg/Iug (button) folded before Flop (didn't bet)
Seat 5: crjGpJEzSZgD38FoE3VMGg (small blind) folded before Flop
Seat 6: 686aeHikcJlgKkSuIFdcXQ (big blind) folded before Flop



PokerStars Game #59938836598:  Hold'em No Limit ($0.25/$0.50) - 2009/07/01 0:24:44 ET
Table '37qXEp3oe+er5q4CZip9eQ' 6-max Seat #1 is the button
Seat 1: oqOqoO2AyCZenUghCxMDxw ($50 in chips)
Seat 3: Rt6KgtZ8YaJoTc3FPim00w ($97.90 in chips)
Seat 5: VOmI0x4dDPnTESZd5B4d1Q ($44.55 in chips)
Seat 6: f7zPpUQp9hHZgqhEvrUWQw ($50 in chips)
Rt6KgtZ8YaJoTc3FPim00w: posts small blind $0.25
VOmI0x4dDPnTESZd5B4d1Q: posts big blind $0.50
*** HOLE CARDS ***
f7zPpUQp9hHZgqhEvrUWQw: folds
oqOqoO2AyCZenUghCxMDxw: folds
Rt6KgtZ8YaJoTc3FPim00w: folds
VOmI0x4dDPnTESZd5B4d1Q collected $0.50 from pot
*** SUMMARY ***
Total pot $0.50 | Rake $0
Seat 1: oqOqoO2AyCZenUghCxMDxw (button) folded before Flop (didn't bet)
Seat 3: Rt6KgtZ8YaJoTc3FPim00w (small blind) folded before Flop
Seat 5: VOmI0x4dDPnTESZd5B4d1Q (big blind) collected ($0.50)
Seat 6: f7zPpUQp9hHZgqhEvrUWQw folded before Flop (didn't bet)



PokerStars Game #59938838272:  Hold'em No Limit ($0.25/$0.50) - 2009/07/01 0:24:46 ET
Table 'raOT4/ipuZgzjfKHC+jD9g' 2-max Seat #2 is the button
Seat 1: IuwLemwLhc9fvrwBGs0AMA ($4.70 in chips)
Seat 2: Udr5juWSWUgTu1NlRhjMdA ($16.95 in chips)
Udr5juWSWUgTu1NlRhjMdA: posts small blind $0.25
IuwLemwLhc9fvrwBGs0AMA: posts big blind $0.50
*** HOLE CARDS ***
Udr5juWSWUgTu1NlRhjMdA: calls $0.25
IuwLemwLhc9fvrwBGs0AMA: raises $1 to $1.50
Udr5juWSWUgTu1NlRhjMdA: folds
IuwLemwLhc9fvrwBGs0AMA collected $1 from pot
IuwLemwLhc9fvrwBGs0AMA: doesn't show hand
*** SUMMARY ***
Total pot $1 | Rake $0
Seat 1: IuwLemwLhc9fvrwBGs0AMA (big blind) collected ($1)
Seat 2: Udr5juWSWUgTu1NlRhjMdA (button) (small blind) folded before Flop



PokerStars Game #59938838832:  Hold'em No Limit ($0.25/$0.50) - 2009/07/01 0:24:47 ET
Table 'QOgaEqMcJ73pcUMMxoisUg' 6-max Seat #6 is the button
Seat 1: UaC1G3O4HWbowgSfeYnkog ($9 in chips)
Seat 2: Im2p1Nt83UKSqv5c9frm4Q ($50 in chips)
Seat 3: wUZNozoIDYf+16hp4nn6dw ($33.55 in chips)
Seat 4: zAcsDhG/T128Vn7XGVSgKg ($63.30 in chips)
Seat 5: 6vNxrjjCl6FwfaaymM9jjg ($28.25 in chips)
Seat 6: s83dnhZ6VC53vY0/f6OV/g ($41.30 in chips)
UaC1G3O4HWbowgSfeYnkog: posts small blind $0.25
Im2p1Nt83UKSqv5c9frm4Q: posts big blind $0.50
*** HOLE CARDS ***
wUZNozoIDYf+16hp4nn6dw: calls $0.50
zAcsDhG/T128Vn7XGVSgKg: folds
6vNxrjjCl6FwfaaymM9jjg: folds
s83dnhZ6VC53vY0/f6OV/g: raises $1.50 to $2
UaC1G3O4HWbowgSfeYnkog: folds
Im2p1Nt83UKSqv5c9frm4Q: folds
wUZNozoIDYf+16hp4nn6dw: calls $1.50
*** FLOP *** [8d 4c 4d]
wUZNozoIDYf+16hp4nn6dw: checks
s83dnhZ6VC53vY0/f6OV/g: bets $3
wUZNozoIDYf+16hp4nn6dw: folds
s83dnhZ6VC53vY0/f6OV/g collected $4.55 from pot
*** SUMMARY ***
Total pot $4.75 | Rake $0.20
Board [8d 4c 4d]
Seat 1: UaC1G3O4HWbowgSfeYnkog (small blind) folded before Flop
Seat 2: Im2p1Nt83UKSqv5c9frm4Q (big blind) folded before Flop
Seat 3: wUZNozoIDYf+16hp4nn6dw folded on the Flop
Seat 4: zAcsDhG/T128Vn7XGVSgKg folded before Flop (didn't bet)
Seat 5: 6vNxrjjCl6FwfaaymM9jjg folded before Flop (didn't bet)
Seat 6: s83dnhZ6VC53vY0/f6OV/g (button) collected ($4.55)



PokerStars Game #59938838980:  Hold'em No Limit ($0.25/$0.50) - 2009/07/01 0:24:47 ET
Table 'X6IRCRTh+20gjz8aubWnwA' 9-max Seat #8 is the button
Seat 1: DSM67hHHq1XFoEOi9p8Alw ($51.15 in chips)
Seat 2: RjBdQ6w31rgcy0o24VLR6w ($12.40 in chips)
Seat 3: mSD1pginDsyHG5PDfqzphw ($19.75 in chips)
Seat 4: uw9QayAAxLM3Hb+HR7mSkg ($11.50 in chips)
Seat 5: QtFsO51ArDuQ44+KvR2jow ($24.45 in chips)
Seat 6: /6In1zC3WtgwxDcueWzZWg ($62 in chips)
Seat 7: VBnpbzn0dIveV55qKvciew ($45.25 in chips)
Seat 8: HxeBVq06/3Bh/H986sgdbw ($12.25 in chips)
Seat 9: M+7+BTmX5vZatHVuoRB1nA ($80.60 in chips)
M+7+BTmX5vZatHVuoRB1nA: posts small blind $0.25
DSM67hHHq1XFoEOi9p8Alw: posts big blind $0.50
*** HOLE CARDS ***
RjBdQ6w31rgcy0o24VLR6w: folds
mSD1pginDsyHG5PDfqzphw: folds
uw9QayAAxLM3Hb+HR7mSkg: folds
QtFsO51ArDuQ44+KvR2jow: raises $0.50 to $1
/6In1zC3WtgwxDcueWzZWg: folds
VBnpbzn0dIveV55qKvciew: folds
HxeBVq06/3Bh/H986sgdbw: folds
M+7+BTmX5vZatHVuoRB1nA: folds
DSM67hHHq1XFoEOi9p8Alw: folds
QtFsO51ArDuQ44+KvR2jow collected $1.25 from pot
*** SUMMARY ***
Total pot $1.25 | Rake $0
Seat 1: DSM67hHHq1XFoEOi9p8Alw (big blind) folded before Flop
Seat 2: RjBdQ6w31rgcy0o24VLR6w folded before Flop (didn't bet)
Seat 3: mSD1pginDsyHG5PDfqzphw folded before Flop (didn't bet)
Seat 4: uw9QayAAxLM3Hb+HR7mSkg folded before Flop (didn't bet)
Seat 5: QtFsO51ArDuQ44+KvR2jow collected ($1.25)
Seat 6: /6In1zC3WtgwxDcueWzZWg folded before Flop (didn't bet)
Seat 7: VBnpbzn0dIveV55qKvciew folded before Flop (didn't bet)
Seat 8: HxeBVq06/3Bh/H986sgdbw (button) folded before Flop (didn't bet)
Seat 9: M+7+BTmX5vZatHVuoRB1nA (small blind) folded before Flop



PokerStars Game #59938839866:  Hold'em No Limit ($0.25/$0.50) - 2009/07/01 0:24:48 ET
Table 'lSisgp6H7Fg1hH5VfjEjYQ' 9-max Seat #5 is the button
Seat 1: pEW8B6uXbdR47kfljMQ3+Q ($40.60 in chips)
Seat 2: UrcnkQOiLVk8BlKDPJSy7Q ($50.35 in chips)
Seat 3: aTkyjTh3w5YLWiIERupZOA ($39.40 in chips)
Seat 4: bwv/rbH/hHhPhY6u9mu04w ($24.25 in chips)
Seat 5: mSD1pginDsyHG5PDfqzphw ($10 in chips)
Seat 6: +k7T5ocke8UwavtgUHm+Cg ($25.60 in chips)
Seat 7: dGw5MBstXyXhWHHVFOWOFA ($43.75 in chips)
Seat 8: a4JDWmpFQkL10XfAyuF51A ($34.55 in chips)
Seat 9: 5JJVDlaiMnB004o/RqbZZQ ($40.50 in chips)
+k7T5ocke8UwavtgUHm+Cg: posts small blind $0.25
dGw5MBstXyXhWHHVFOWOFA: posts big blind $0.50
*** HOLE CARDS ***
a4JDWmpFQkL10XfAyuF51A: folds
5JJVDlaiMnB004o/RqbZZQ: folds
pEW8B6uXbdR47kfljMQ3+Q: folds
UrcnkQOiLVk8BlKDPJSy7Q: folds
aTkyjTh3w5YLWiIERupZOA: folds
bwv/rbH/hHhPhY6u9mu04w: folds
mSD1pginDsyHG5PDfqzphw: raises $1 to $1.50
+k7T5ocke8UwavtgUHm+Cg: calls $1.25
dGw5MBstXyXhWHHVFOWOFA: calls $1
*** FLOP *** [Qc 2s 2h]
+k7T5ocke8UwavtgUHm+Cg: checks
dGw5MBstXyXhWHHVFOWOFA: checks
mSD1pginDsyHG5PDfqzphw: checks
*** TURN *** [Qc 2s 2h] [Ah]
+k7T5ocke8UwavtgUHm+Cg: checks
dGw5MBstXyXhWHHVFOWOFA: checks
mSD1pginDsyHG5PDfqzphw: bets $2
+k7T5ocke8UwavtgUHm+Cg: calls $2
dGw5MBstXyXhWHHVFOWOFA: folds
*** RIVER *** [Qc 2s 2h Ah] [Jd]
+k7T5ocke8UwavtgUHm+Cg: bets $7
mSD1pginDsyHG5PDfqzphw: calls $6.50 and is all-in
*** SHOW DOWN ***
+k7T5ocke8UwavtgUHm+Cg: shows [Kd As] (two pair, Aces and Deuces)
mSD1pginDsyHG5PDfqzphw: shows [Ks Ac] (two pair, Aces and Deuces)
+k7T5ocke8UwavtgUHm+Cg collected $10.25 from pot
mSD1pginDsyHG5PDfqzphw collected $10.20 from pot
*** SUMMARY ***
Total pot $21.50 | Rake $1.05
Board [Qc 2s 2h Ah Jd]
Seat 1: pEW8B6uXbdR47kfljMQ3+Q folded before Flop (didn't bet)
Seat 2: UrcnkQOiLVk8BlKDPJSy7Q folded before Flop (didn't bet)
Seat 3: aTkyjTh3w5YLWiIERupZOA folded before Flop (didn't bet)
Seat 4: bwv/rbH/hHhPhY6u9mu04w folded before Flop (didn't bet)
Seat 5: mSD1pginDsyHG5PDfqzphw (button) showed [Ks Ac] and won ($10.20) with two pair, Aces and Deuces
Seat 6: +k7T5ocke8UwavtgUHm+Cg (small blind) showed [Kd As] and won ($10.25) with two pair, Aces and Deuces
Seat 7: dGw5MBstXyXhWHHVFOWOFA (big blind) folded on the Turn
Seat 8: a4JDWmpFQkL10XfAyuF51A folded before Flop (didn't bet)
Seat 9: 5JJVDlaiMnB004o/RqbZZQ folded before Flop (didn't bet)



PokerStars Game #59938839448:  Hold'em No Limit ($0.25/$0.50) - 2009/07/01 0:24:48 ET
Table '+dXkOAQyS8j9PQZusUTMpg' 2-max Seat #2 is the button
Seat 1: XFa6sBGjP2gxoIvxR3fZIg ($44.50 in chips)
Seat 2: 5IBeOgaApY1Bvzv2P8X4EA ($62.25 in chips)
5IBeOgaApY1Bvzv2P8X4EA: posts small blind $0.25
XFa6sBGjP2gxoIvxR3fZIg: posts big blind $0.50
*** HOLE CARDS ***
XFa6sBGjP2gxoIvxR3fZIg said, "argh"
5IBeOgaApY1Bvzv2P8X4EA: folds
XFa6sBGjP2gxoIvxR3fZIg collected $0.50 from pot
*** SUMMARY ***
Total pot $0.50 | Rake $0
Seat 1: XFa6sBGjP2gxoIvxR3fZIg (big blind) collected ($0.50)
Seat 2: 5IBeOgaApY1Bvzv2P8X4EA (button) (small blind) folded before Flop



PokerStars Game #59938840864:  Hold'em No Limit ($0.25/$0.50) - 2009/07/01 0:24:50 ET
Table '0AhP5FLi4ySROVJ/ycT1Qw' 2-max Seat #2 is the button
Seat 1: 38ZztDUK6IU5WCK+BN74Rw ($109 in chips)
Seat 2: 46qCyJ6evTkHo9al5sBMNA ($70.10 in chips)
46qCyJ6evTkHo9al5sBMNA: posts small blind $0.25
38ZztDUK6IU5WCK+BN74Rw: posts big blind $0.50
*** HOLE CARDS ***
46qCyJ6evTkHo9al5sBMNA: folds
38ZztDUK6IU5WCK+BN74Rw collected $0.50 from pot
*** SUMMARY ***
Total pot $0.50 | Rake $0
Seat 1: 38ZztDUK6IU5WCK+BN74Rw (big blind) collected ($0.50)
Seat 2: 46qCyJ6evTkHo9al5sBMNA (button) (small blind) folded before Flop



PokerStars Game #59938840720:  Hold'em No Limit ($0.25/$0.50) - 2009/07/01 0:24:50 ET
Table '5EmHi+fnatGQQShcNmzOZQ' 6-max Seat #4 is the button
Seat 1: SwPczQo3cOtwEzhJrfO2cQ ($28.20 in chips)
Seat 3: L9qfLYXrczhAPd/VckgsWw ($58.85 in chips)
Seat 4: wOyVV9M/oyiw3YaOjNZ05w ($50.45 in chips)
Seat 5: kxPhs4ePFqMy52CInAJ2aw ($48.25 in chips)
Seat 6: 686aeHikcJlgKkSuIFdcXQ ($156.60 in chips)
kxPhs4ePFqMy52CInAJ2aw: posts small blind $0.25
686aeHikcJlgKkSuIFdcXQ: posts big blind $0.50
*** HOLE CARDS ***
SwPczQo3cOtwEzhJrfO2cQ: raises $0.50 to $1
L9qfLYXrczhAPd/VckgsWw: folds
wOyVV9M/oyiw3YaOjNZ05w: folds
kxPhs4ePFqMy52CInAJ2aw: folds
686aeHikcJlgKkSuIFdcXQ: folds
SwPczQo3cOtwEzhJrfO2cQ collected $1.25 from pot
*** SUMMARY ***
Total pot $1.25 | Rake $0
Seat 1: SwPczQo3cOtwEzhJrfO2cQ collected ($1.25)
Seat 3: L9qfLYXrczhAPd/VckgsWw folded before Flop (didn't bet)
Seat 4: wOyVV9M/oyiw3YaOjNZ05w (button) folded before Flop (didn't bet)
Seat 5: kxPhs4ePFqMy52CInAJ2aw (small blind) folded before Flop
Seat 6: 686aeHikcJlgKkSuIFdcXQ (big blind) folded before Flop



PokerStars Game #59938843602:  Hold'em No Limit ($0.25/$0.50) - 2009/07/01 0:24:54 ET
Table '+dXkOAQyS8j9PQZusUTMpg' 2-max Seat #1 is the button
Seat 1: XFa6sBGjP2gxoIvxR3fZIg ($44.75 in chips)
Seat 2: 5IBeOgaApY1Bvzv2P8X4EA ($62 in chips)
XFa6sBGjP2gxoIvxR3fZIg: posts small blind $0.25
5IBeOgaApY1Bvzv2P8X4EA: posts big blind $0.50
*** HOLE CARDS ***
XFa6sBGjP2gxoIvxR3fZIg: raises $1 to $1.50
5IBeOgaApY1Bvzv2P8X4EA: calls $1
*** FLOP *** [2h Tc 8s]
5IBeOgaApY1Bvzv2P8X4EA: checks
XFa6sBGjP2gxoIvxR3fZIg: bets $2
5IBeOgaApY1Bvzv2P8X4EA: folds
XFa6sBGjP2gxoIvxR3fZIg collected $2.85 from pot
*** SUMMARY ***
Total pot $3 | Rake $0.15
Board [2h Tc 8s]
Seat 1: XFa6sBGjP2gxoIvxR3fZIg (button) (small blind) collected ($2.85)
Seat 2: 5IBeOgaApY1Bvzv2P8X4EA (big blind) folded on the Flop



PokerStars Game #59938845646:  Hold'em No Limit ($0.25/$0.50) - 2009/07/01 0:24:57 ET
Table 'ZYwMb9E6tY50Qm+iNbXRYw' 2-max Seat #2 is the button
Seat 1: DXLfRb8KDZWmrztw2bwtFw ($9.50 in chips)
Seat 2: 16tvT7AYgZ2LgiGFcvFKQg ($20.85 in chips)
16tvT7AYgZ2LgiGFcvFKQg: posts small blind $0.25
DXLfRb8KDZWmrztw2bwtFw: posts big blind $0.50
*** HOLE CARDS ***
16tvT7AYgZ2LgiGFcvFKQg: raises $0.50 to $1
DXLfRb8KDZWmrztw2bwtFw: calls $0.50
*** FLOP *** [8d 3c Jd]
DXLfRb8KDZWmrztw2bwtFw: checks
16tvT7AYgZ2LgiGFcvFKQg: checks
*** TURN *** [8d 3c Jd] [6h]
DXLfRb8KDZWmrztw2bwtFw: checks
16tvT7AYgZ2LgiGFcvFKQg: checks
*** RIVER *** [8d 3c Jd 6h] [2d]
DXLfRb8KDZWmrztw2bwtFw: checks
16tvT7AYgZ2LgiGFcvFKQg: checks
*** SHOW DOWN ***
DXLfRb8KDZWmrztw2bwtFw: shows [9h 6d] (a pair of Sixes)
16tvT7AYgZ2LgiGFcvFKQg: shows [Ts Ad] (high card Ace)
DXLfRb8KDZWmrztw2bwtFw collected $1.90 from pot
*** SUMMARY ***
Total pot $2 | Rake $0.10
Board [8d 3c Jd 6h 2d]
Seat 1: DXLfRb8KDZWmrztw2bwtFw (big blind) showed [9h 6d] and won ($1.90) with a pair of Sixes
Seat 2: 16tvT7AYgZ2LgiGFcvFKQg (button) (small blind) showed [Ts Ad] and lost with high card Ace



PokerStars Game #59938846554:  Hold'em No Limit ($0.25/$0.50) - 2009/07/01 0:24:58 ET
Table '0AhP5FLi4ySROVJ/ycT1Qw' 2-max Seat #1 is the button
Seat 1: 38ZztDUK6IU5WCK+BN74Rw ($109.25 in chips)
Seat 2: 46qCyJ6evTkHo9al5sBMNA ($69.85 in chips)
38ZztDUK6IU5WCK+BN74Rw: posts small blind $0.25
46qCyJ6evTkHo9al5sBMNA: posts big blind $0.50
*** HOLE CARDS ***
38ZztDUK6IU5WCK+BN74Rw: folds
46qCyJ6evTkHo9al5sBMNA collected $0.50 from pot
46qCyJ6evTkHo9al5sBMNA: doesn't show hand
*** SUMMARY ***
Total pot $0.50 | Rake $0
Seat 1: 38ZztDUK6IU5WCK+BN74Rw (button) (small blind) folded before Flop
Seat 2: 46qCyJ6evTkHo9al5sBMNA (big blind) collected ($0.50)



PokerStars Game #59938846240:  Hold'em No Limit ($0.25/$0.50) - 2009/07/01 0:24:58 ET
Table 'dVmkPtk5nWTfXApFsnhIOg' 2-max Seat #1 is the button
Seat 1: bypIyrYcAAifLfhZpGlKLA ($80.40 in chips)
Seat 2: rPToQDbLWB+dKnz7fcQSIg ($30 in chips)
bypIyrYcAAifLfhZpGlKLA: posts small blind $0.25
rPToQDbLWB+dKnz7fcQSIg: posts big blind $0.50
*** HOLE CARDS ***
bypIyrYcAAifLfhZpGlKLA: folds
rPToQDbLWB+dKnz7fcQSIg collected $0.50 from pot
*** SUMMARY ***
Total pot $0.50 | Rake $0
Seat 1: bypIyrYcAAifLfhZpGlKLA (button) (small blind) folded before Flop
Seat 2: rPToQDbLWB+dKnz7fcQSIg (big blind) collected ($0.50)



PokerStars Game #59938846462:  Hold'em No Limit ($0.25/$0.50) - 2009/07/01 0:24:58 ET
Table 'c/CRn+68J3Y8KxD5g1ek2Q' 2-max Seat #2 is the button
Seat 1: 46qCyJ6evTkHo9al5sBMNA ($266.80 in chips)
Seat 2: BypVLsYQt3ePFm2xQL/dOA ($114.35 in chips)
BypVLsYQt3ePFm2xQL/dOA: posts small blind $0.25
46qCyJ6evTkHo9al5sBMNA: posts big blind $0.50
*** HOLE CARDS ***
BypVLsYQt3ePFm2xQL/dOA: raises $1 to $1.50
46qCyJ6evTkHo9al5sBMNA: folds
BypVLsYQt3ePFm2xQL/dOA collected $1 from pot
BypVLsYQt3ePFm2xQL/dOA: doesn't show hand
*** SUMMARY ***
Total pot $1 | Rake $0
Seat 1: 46qCyJ6evTkHo9al5sBMNA (big blind) folded before Flop
Seat 2: BypVLsYQt3ePFm2xQL/dOA (button) (small blind) collected ($1)



PokerStars Game #59938846590:  Hold'em No Limit ($0.25/$0.50) - 2009/07/01 0:24:58 ET
Table 'GfL/No5u5PoEnU39lP5pQg' 6-max Seat #1 is the button
Seat 1: 1WUCqNG+p+vfWRTXNu4ljw ($50.65 in chips)
Seat 2: uVwggSetzp7d+eVgowO3vg ($45 in chips)
Seat 3: qNezhXOOUXqwG7b9X5XJAA ($50 in chips)
Seat 5: crjGpJEzSZgD38FoE3VMGg ($54.30 in chips)
uVwggSetzp7d+eVgowO3vg: posts small blind $0.25
qNezhXOOUXqwG7b9X5XJAA: posts big blind $0.50
OZ6OtYh5Y53MCH/p0QTn5g: sits out
*** HOLE CARDS ***
crjGpJEzSZgD38FoE3VMGg: folds
1WUCqNG+p+vfWRTXNu4ljw: raises $1 to $1.50
uVwggSetzp7d+eVgowO3vg: folds
qNezhXOOUXqwG7b9X5XJAA: folds
1WUCqNG+p+vfWRTXNu4ljw collected $1.25 from pot
*** SUMMARY ***
Total pot $1.25 | Rake $0
Seat 1: 1WUCqNG+p+vfWRTXNu4ljw (button) collected ($1.25)
Seat 2: uVwggSetzp7d+eVgowO3vg (small blind) folded before Flop
Seat 3: qNezhXOOUXqwG7b9X5XJAA (big blind) folded before Flop
Seat 5: crjGpJEzSZgD38FoE3VMGg folded before Flop (didn't bet)



PokerStars Game #59938846050:  Hold'em No Limit ($0.25/$0.50) - 2009/07/01 0:24:58 ET
Table '37qXEp3oe+er5q4CZip9eQ' 6-max Seat #3 is the button
Seat 1: oqOqoO2AyCZenUghCxMDxw ($50 in chips)
Seat 3: Rt6KgtZ8YaJoTc3FPim00w ($97.65 in chips)
Seat 5: VOmI0x4dDPnTESZd5B4d1Q ($44.80 in chips)
Seat 6: f7zPpUQp9hHZgqhEvrUWQw ($50 in chips)
VOmI0x4dDPnTESZd5B4d1Q: posts small blind $0.25
f7zPpUQp9hHZgqhEvrUWQw: posts big blind $0.50
*** HOLE CARDS ***
oqOqoO2AyCZenUghCxMDxw: folds
Rt6KgtZ8YaJoTc3FPim00w: folds
VOmI0x4dDPnTESZd5B4d1Q: calls $0.25
f7zPpUQp9hHZgqhEvrUWQw: checks
*** FLOP *** [4d 5d Jd]
VOmI0x4dDPnTESZd5B4d1Q: bets $0.50
f7zPpUQp9hHZgqhEvrUWQw: folds
VOmI0x4dDPnTESZd5B4d1Q collected $0.95 from pot
*** SUMMARY ***
Total pot $1 | Rake $0.05
Board [4d 5d Jd]
Seat 1: oqOqoO2AyCZenUghCxMDxw folded before Flop (didn't bet)
Seat 3: Rt6KgtZ8YaJoTc3FPim00w (button) folded before Flop (didn't bet)
Seat 5: VOmI0x4dDPnTESZd5B4d1Q (small blind) collected ($0.95)
Seat 6: f7zPpUQp9hHZgqhEvrUWQw (big blind) folded on the Flop



PokerStars Game #59938847104:  Hold'em No Limit ($0.25/$0.50) - 2009/07/01 0:24:59 ET
Table 'hSTs/dUsYLgJQuF2Onp0MQ' 6-max Seat #1 is the button
Seat 1: Donj3X7gYzeS5pAl7s9f+Q ($33.20 in chips)
Seat 2: 6vNxrjjCl6FwfaaymM9jjg ($14.50 in chips)
Seat 4: L0aIPg7qefDQjdJo3HCVEA ($10 in chips)
Seat 5: 686aeHikcJlgKkSuIFdcXQ ($66.85 in chips)
Seat 6: +laPa9P7BjZKKnR0n+OmvA ($9.70 in chips)
6vNxrjjCl6FwfaaymM9jjg: posts small blind $0.25
L0aIPg7qefDQjdJo3HCVEA: posts big blind $0.50
*** HOLE CARDS ***
686aeHikcJlgKkSuIFdcXQ: raises $1.50 to $2
+laPa9P7BjZKKnR0n+OmvA: folds
Donj3X7gYzeS5pAl7s9f+Q: calls $2
6vNxrjjCl6FwfaaymM9jjg: calls $1.75
L0aIPg7qefDQjdJo3HCVEA: folds
*** FLOP *** [9s Tc 2d]
6vNxrjjCl6FwfaaymM9jjg: checks
686aeHikcJlgKkSuIFdcXQ: bets $5.50
Donj3X7gYzeS5pAl7s9f+Q: folds
C3qJBo7uxfFVDluE1lmK2w joins the table at seat #3
6vNxrjjCl6FwfaaymM9jjg: calls $5.50
*** TURN *** [9s Tc 2d] [7d]
6vNxrjjCl6FwfaaymM9jjg: checks
686aeHikcJlgKkSuIFdcXQ: checks
*** RIVER *** [9s Tc 2d 7d] [Th]
6vNxrjjCl6FwfaaymM9jjg: checks
686aeHikcJlgKkSuIFdcXQ: checks
*** SHOW DOWN ***
6vNxrjjCl6FwfaaymM9jjg: shows [Jh 8h] (a straight, Seven to Jack)
686aeHikcJlgKkSuIFdcXQ: mucks hand
6vNxrjjCl6FwfaaymM9jjg collected $16.65 from pot
*** SUMMARY ***
Total pot $17.50 | Rake $0.85
Board [9s Tc 2d 7d Th]
Seat 1: Donj3X7gYzeS5pAl7s9f+Q (button) folded on the Flop
Seat 2: 6vNxrjjCl6FwfaaymM9jjg (small blind) showed [Jh 8h] and won ($16.65) with a straight, Seven to Jack
Seat 4: L0aIPg7qefDQjdJo3HCVEA (big blind) folded before Flop
Seat 5: 686aeHikcJlgKkSuIFdcXQ mucked
Seat 6: +laPa9P7BjZKKnR0n+OmvA folded before Flop (didn't bet)



PokerStars Game #59938849166:  Hold'em No Limit ($0.25/$0.50) - 2009/07/01 0:25:02 ET
Table 'IeNZOZQ4T6oiaHqFeo6yIA' 2-max Seat #1 is the button
Seat 1: ndd1nfncBkWNitBnsfCoVQ ($97.10 in chips)
Seat 2: A91IUl5JaZROhtfCtnnwYw ($37.45 in chips)
ndd1nfncBkWNitBnsfCoVQ: posts small blind $0.25
A91IUl5JaZROhtfCtnnwYw: posts big blind $0.50
*** HOLE CARDS ***
ndd1nfncBkWNitBnsfCoVQ: raises $1 to $1.50
A91IUl5JaZROhtfCtnnwYw: calls $1
*** FLOP *** [9d Ad Th]
A91IUl5JaZROhtfCtnnwYw: checks
ndd1nfncBkWNitBnsfCoVQ: checks
*** TURN *** [9d Ad Th] [7d]
A91IUl5JaZROhtfCtnnwYw: bets $3
ndd1nfncBkWNitBnsfCoVQ: folds
A91IUl5JaZROhtfCtnnwYw collected $2.85 from pot
A91IUl5JaZROhtfCtnnwYw: doesn't show hand
*** SUMMARY ***
Total pot $3 | Rake $0.15
Board [9d Ad Th 7d]
Seat 1: ndd1nfncBkWNitBnsfCoVQ (button) (small blind) folded on the Turn
Seat 2: A91IUl5JaZROhtfCtnnwYw (big blind) collected ($2.85)



PokerStars Game #59938849176:  Hold'em No Limit ($0.25/$0.50) - 2009/07/01 0:25:02 ET
Table 'Nz0Vr7WMHL2g5Uk7dDZjpw' 9-max Seat #5 is the button
Seat 2: XNMDwbXt/Q4jM99AXnbJDw ($50 in chips)
Seat 3: 4QTiNH5fteLgJjx/s6Hy6A ($21.40 in chips)
Seat 4: 5JJVDlaiMnB004o/RqbZZQ ($28.50 in chips)
Seat 5: WGW0DgjBUXs1ylURHG8vnQ ($10.10 in chips)
Seat 6: k1f0lS7tlMHCLGs0JT34Tg ($9.50 in chips)
Seat 7: KPLH0gELgFe2OuAnhJFI5w ($19.70 in chips)
Seat 8: HkZI6g4zl83TDTA7SRspmQ ($20.95 in chips)
Seat 9: Ak2W6V2TDVIQrvSAy4eD7Q ($25.35 in chips)
k1f0lS7tlMHCLGs0JT34Tg: posts small blind $0.25
KPLH0gELgFe2OuAnhJFI5w: posts big blind $0.50
tLkxo7JgV+WWI0UBw44K5A: sits out
*** HOLE CARDS ***
HkZI6g4zl83TDTA7SRspmQ: calls $0.50
Ak2W6V2TDVIQrvSAy4eD7Q has timed out
Ak2W6V2TDVIQrvSAy4eD7Q: folds
Ak2W6V2TDVIQrvSAy4eD7Q is sitting out
XNMDwbXt/Q4jM99AXnbJDw: folds
4QTiNH5fteLgJjx/s6Hy6A: folds
5JJVDlaiMnB004o/RqbZZQ: folds
WGW0DgjBUXs1ylURHG8vnQ: raises $0.50 to $1
k1f0lS7tlMHCLGs0JT34Tg: folds
KPLH0gELgFe2OuAnhJFI5w: folds
Ak2W6V2TDVIQrvSAy4eD7Q has returned
tLkxo7JgV+WWI0UBw44K5A is disconnected
HkZI6g4zl83TDTA7SRspmQ: calls $0.50
*** FLOP *** [5d 7s 5s]
HkZI6g4zl83TDTA7SRspmQ: checks
WGW0DgjBUXs1ylURHG8vnQ: bets $1
HkZI6g4zl83TDTA7SRspmQ: folds
WGW0DgjBUXs1ylURHG8vnQ collected $2.65 from pot
WGW0DgjBUXs1ylURHG8vnQ: doesn't show hand
*** SUMMARY ***
Total pot $2.75 | Rake $0.10
Board [5d 7s 5s]
Seat 2: XNMDwbXt/Q4jM99AXnbJDw folded before Flop (didn't bet)
Seat 3: 4QTiNH5fteLgJjx/s6Hy6A folded before Flop (didn't bet)
Seat 4: 5JJVDlaiMnB004o/RqbZZQ folded before Flop (didn't bet)
Seat 5: WGW0DgjBUXs1ylURHG8vnQ (button) collected ($2.65)
Seat 6: k1f0lS7tlMHCLGs0JT34Tg (small blind) folded before Flop
Seat 7: KPLH0gELgFe2OuAnhJFI5w (big blind) folded before Flop
Seat 8: HkZI6g4zl83TDTA7SRspmQ folded on the Flop
Seat 9: Ak2W6V2TDVIQrvSAy4eD7Q folded before Flop (didn't bet)



PokerStars Game #59938849630:  Hold'em No Limit ($0.25/$0.50) - 2009/07/01 0:25:03 ET
Table 'MJxeZCzYELxiIsyUZyT0jw' 6-max Seat #5 is the button
Seat 1: wOyVV9M/oyiw3YaOjNZ05w ($50 in chips)
Seat 2: u4vYQZNWtIzOJre8fvCmvQ ($30 in chips)
Seat 3: JQZew0FjzS19kTjeNtrE+A ($50.10 in chips)
Seat 4: lP7Q6pewz4C2RsAfKsjdWw ($38.55 in chips)
Seat 5: 3jvoOXNtXE90w2BdfNZwZQ ($52.30 in chips)
Seat 6: TTx3CHxyi0SObcHyMJRp5w ($45.25 in chips)
TTx3CHxyi0SObcHyMJRp5w: posts small blind $0.25
wOyVV9M/oyiw3YaOjNZ05w: posts big blind $0.50
u4vYQZNWtIzOJre8fvCmvQ: posts big blind $0.50
*** HOLE CARDS ***
u4vYQZNWtIzOJre8fvCmvQ: checks
JQZew0FjzS19kTjeNtrE+A: folds
lP7Q6pewz4C2RsAfKsjdWw: calls $0.50
3jvoOXNtXE90w2BdfNZwZQ: folds
TTx3CHxyi0SObcHyMJRp5w: folds
wOyVV9M/oyiw3YaOjNZ05w: checks
*** FLOP *** [Qc 5d Jh]
wOyVV9M/oyiw3YaOjNZ05w: checks
u4vYQZNWtIzOJre8fvCmvQ: bets $1
lP7Q6pewz4C2RsAfKsjdWw: folds
wOyVV9M/oyiw3YaOjNZ05w: folds
u4vYQZNWtIzOJre8fvCmvQ collected $1.70 from pot
u4vYQZNWtIzOJre8fvCmvQ: doesn't show hand
*** SUMMARY ***
Total pot $1.75 | Rake $0.05
Board [Qc 5d Jh]
Seat 1: wOyVV9M/oyiw3YaOjNZ05w (big blind) folded on the Flop
Seat 2: u4vYQZNWtIzOJre8fvCmvQ collected ($1.70)
Seat 3: JQZew0FjzS19kTjeNtrE+A folded before Flop (didn't bet)
Seat 4: lP7Q6pewz4C2RsAfKsjdWw folded on the Flop
Seat 5: 3jvoOXNtXE90w2BdfNZwZQ (button) folded before Flop (didn't bet)
Seat 6: TTx3CHxyi0SObcHyMJRp5w (small blind) folded before Flop



PokerStars Game #59938850704:  Hold'em No Limit ($0.25/$0.50) - 2009/07/01 0:25:04 ET
Table '0AhP5FLi4ySROVJ/ycT1Qw' 2-max Seat #2 is the button
Seat 1: 38ZztDUK6IU5WCK+BN74Rw ($109 in chips)
Seat 2: 46qCyJ6evTkHo9al5sBMNA ($70.10 in chips)
46qCyJ6evTkHo9al5sBMNA: posts small blind $0.25
38ZztDUK6IU5WCK+BN74Rw: posts big blind $0.50
*** HOLE CARDS ***
46qCyJ6evTkHo9al5sBMNA: folds
38ZztDUK6IU5WCK+BN74Rw collected $0.50 from pot
*** SUMMARY ***
Total pot $0.50 | Rake $0
Seat 1: 38ZztDUK6IU5WCK+BN74Rw (big blind) collected ($0.50)
Seat 2: 46qCyJ6evTkHo9al5sBMNA (button) (small blind) folded before Flop



PokerStars Game #59938851182:  Hold'em No Limit ($0.25/$0.50) - 2009/07/01 0:25:05 ET
Table 'eMxdLyFDf28E0wit6gm3Uw' 6-max Seat #1 is the button
Seat 1: tnD/64LagZ9qPaeOQVjVZg ($24.65 in chips)
Seat 2: jwuKQ1S3U4NnzMQn3E3dgw ($69.10 in chips)
Seat 3: dZcLsEI8iXkobBduRJ45Yw ($14.65 in chips)
Seat 4: QM93o65lI8kLzmiB/BILlA ($17.75 in chips)
Seat 5: X0X97o2fDAPiGx6o1gahsw ($56.35 in chips)
Seat 6: L0aIPg7qefDQjdJo3HCVEA ($8 in chips)
jwuKQ1S3U4NnzMQn3E3dgw: posts small blind $0.25
jwuKQ1S3U4NnzMQn3E3dgw said, "Damn!"
dZcLsEI8iXkobBduRJ45Yw: posts big blind $0.50
*** HOLE CARDS ***
QM93o65lI8kLzmiB/BILlA: folds
X0X97o2fDAPiGx6o1gahsw: folds
L0aIPg7qefDQjdJo3HCVEA: folds
tnD/64LagZ9qPaeOQVjVZg: folds
jwuKQ1S3U4NnzMQn3E3dgw: calls $0.25
dZcLsEI8iXkobBduRJ45Yw: checks
*** FLOP *** [4c Js 3d]
jwuKQ1S3U4NnzMQn3E3dgw: bets $2
dZcLsEI8iXkobBduRJ45Yw: folds
jwuKQ1S3U4NnzMQn3E3dgw collected $0.95 from pot
jwuKQ1S3U4NnzMQn3E3dgw: doesn't show hand
*** SUMMARY ***
Total pot $1 | Rake $0.05
Board [4c Js 3d]
Seat 1: tnD/64LagZ9qPaeOQVjVZg (button) folded before Flop (didn't bet)
Seat 2: jwuKQ1S3U4NnzMQn3E3dgw (small blind) collected ($0.95)
Seat 3: dZcLsEI8iXkobBduRJ45Yw (big blind) folded on the Flop
Seat 4: QM93o65lI8kLzmiB/BILlA folded before Flop (didn't bet)
Seat 5: X0X97o2fDAPiGx6o1gahsw folded before Flop (didn't bet)
Seat 6: L0aIPg7qefDQjdJo3HCVEA folded before Flop (didn't bet)



PokerStars Game #59938852488:  Hold'em No Limit ($0.25/$0.50) - 2009/07/01 0:25:07 ET
Table 'c/CRn+68J3Y8KxD5g1ek2Q' 2-max Seat #1 is the button
Seat 1: 46qCyJ6evTkHo9al5sBMNA ($266.30 in chips)
Seat 2: BypVLsYQt3ePFm2xQL/dOA ($114.85 in chips)
46qCyJ6evTkHo9al5sBMNA: posts small blind $0.25
BypVLsYQt3ePFm2xQL/dOA: posts big blind $0.50
*** HOLE CARDS ***
46qCyJ6evTkHo9al5sBMNA: raises $1.50 to $2
BypVLsYQt3ePFm2xQL/dOA: calls $1.50
*** FLOP *** [4s 4d Ad]
BypVLsYQt3ePFm2xQL/dOA: checks
46qCyJ6evTkHo9al5sBMNA: checks
*** TURN *** [4s 4d Ad] [8h]
BypVLsYQt3ePFm2xQL/dOA: checks
46qCyJ6evTkHo9al5sBMNA: bets $3
BypVLsYQt3ePFm2xQL/dOA: calls $3
*** RIVER *** [4s 4d Ad 8h] [2h]
BypVLsYQt3ePFm2xQL/dOA: checks
46qCyJ6evTkHo9al5sBMNA: bets $7.50
BypVLsYQt3ePFm2xQL/dOA: folds
46qCyJ6evTkHo9al5sBMNA collected $9.55 from pot
46qCyJ6evTkHo9al5sBMNA: doesn't show hand
*** SUMMARY ***
Total pot $10 | Rake $0.45
Board [4s 4d Ad 8h 2h]
Seat 1: 46qCyJ6evTkHo9al5sBMNA (button) (small blind) collected ($9.55)
Seat 2: BypVLsYQt3ePFm2xQL/dOA (big blind) folded on the River



PokerStars Game #59938853006:  Hold'em No Limit ($0.25/$0.50) - 2009/07/01 0:25:08 ET
Table '+dXkOAQyS8j9PQZusUTMpg' 2-max Seat #2 is the button
Seat 1: XFa6sBGjP2gxoIvxR3fZIg ($46.10 in chips)
Seat 2: 5IBeOgaApY1Bvzv2P8X4EA ($60.50 in chips)
5IBeOgaApY1Bvzv2P8X4EA: posts small blind $0.25
XFa6sBGjP2gxoIvxR3fZIg: posts big blind $0.50
*** HOLE CARDS ***
5IBeOgaApY1Bvzv2P8X4EA: folds
XFa6sBGjP2gxoIvxR3fZIg collected $0.50 from pot
*** SUMMARY ***
Total pot $0.50 | Rake $0
Seat 1: XFa6sBGjP2gxoIvxR3fZIg (big blind) collected ($0.50)
Seat 2: 5IBeOgaApY1Bvzv2P8X4EA (button) (small blind) folded before Flop



PokerStars Game #59938853060:  Hold'em No Limit ($0.25/$0.50) - 2009/07/01 0:25:08 ET
Table 'otvGDROEDdqsabxskT79qg' 9-max Seat #7 is the button
Seat 1: 8ehL7qlZzjgUh2H35iiWLw ($50 in chips)
Seat 2: cCjTzH9jio8607WzjcfXlg ($11.35 in chips)
Seat 3: +k7T5ocke8UwavtgUHm+Cg ($75.70 in chips)
Seat 4: MG90wfSJZnOejs/KD3vlQQ ($51.80 in chips)
Seat 5: XNMDwbXt/Q4jM99AXnbJDw ($50 in chips)
Seat 7: C7+tBppJrKgd/r+tuKUIpA ($42.65 in chips)
Seat 9: KcY3X8YpD74Kw1RHkx/g4A ($64.10 in chips)
zE9cVigS2nW/Ljy4K4bUQA will be allowed to play after the button
KcY3X8YpD74Kw1RHkx/g4A: posts small blind $0.25
8ehL7qlZzjgUh2H35iiWLw: posts big blind $0.50
bxLSulbgr8LmKNjOzw8URg: sits out
*** HOLE CARDS ***
cCjTzH9jio8607WzjcfXlg: calls $0.50
+k7T5ocke8UwavtgUHm+Cg: folds
MG90wfSJZnOejs/KD3vlQQ: folds
XNMDwbXt/Q4jM99AXnbJDw: folds
C7+tBppJrKgd/r+tuKUIpA: folds
KcY3X8YpD74Kw1RHkx/g4A: calls $0.25
8ehL7qlZzjgUh2H35iiWLw: checks
*** FLOP *** [6c 5c As]
KcY3X8YpD74Kw1RHkx/g4A: checks
8ehL7qlZzjgUh2H35iiWLw: checks
cCjTzH9jio8607WzjcfXlg: checks
*** TURN *** [6c 5c As] [Jh]
KcY3X8YpD74Kw1RHkx/g4A: checks
8ehL7qlZzjgUh2H35iiWLw: checks
cCjTzH9jio8607WzjcfXlg: checks
*** RIVER *** [6c 5c As Jh] [Js]
KcY3X8YpD74Kw1RHkx/g4A: checks
8ehL7qlZzjgUh2H35iiWLw: checks
cCjTzH9jio8607WzjcfXlg: bets $1
KcY3X8YpD74Kw1RHkx/g4A: folds
8ehL7qlZzjgUh2H35iiWLw: folds
cCjTzH9jio8607WzjcfXlg collected $1.45 from pot
*** SUMMARY ***
Total pot $1.50 | Rake $0.05
Board [6c 5c As Jh Js]
Seat 1: 8ehL7qlZzjgUh2H35iiWLw (big blind) folded on the River
Seat 2: cCjTzH9jio8607WzjcfXlg collected ($1.45)
Seat 3: +k7T5ocke8UwavtgUHm+Cg folded before Flop (didn't bet)
Seat 4: MG90wfSJZnOejs/KD3vlQQ folded before Flop (didn't bet)
Seat 5: XNMDwbXt/Q4jM99AXnbJDw folded before Flop (didn't bet)
Seat 7: C7+tBppJrKgd/r+tuKUIpA (button) folded before Flop (didn't bet)
Seat 9: KcY3X8YpD74Kw1RHkx/g4A (small blind) folded on the River



PokerStars Game #59938856560:  Hold'em No Limit ($0.25/$0.50) - 2009/07/01 0:25:13 ET
Table 'E7bWJ45aoFXRpyRv2gw+Ig' 2-max Seat #1 is the button
Seat 1: FRkiRasEGlHUeLrEl+k/nA ($63.50 in chips)
Seat 2: 3Wro85I7472vJ4Wkpneo9A ($114.80 in chips)
FRkiRasEGlHUeLrEl+k/nA: posts small blind $0.25
3Wro85I7472vJ4Wkpneo9A: posts big blind $0.50
*** HOLE CARDS ***
FRkiRasEGlHUeLrEl+k/nA: calls $0.25
3Wro85I7472vJ4Wkpneo9A: checks
*** FLOP *** [Jd 2d 3h]
3Wro85I7472vJ4Wkpneo9A: checks
FRkiRasEGlHUeLrEl+k/nA: checks
*** TURN *** [Jd 2d 3h] [Tc]
3Wro85I7472vJ4Wkpneo9A: bets $1
FRkiRasEGlHUeLrEl+k/nA: folds
3Wro85I7472vJ4Wkpneo9A collected $0.95 from pot
3Wro85I7472vJ4Wkpneo9A: doesn't show hand
*** SUMMARY ***
Total pot $1 | Rake $0.05
Board [Jd 2d 3h Tc]
Seat 1: FRkiRasEGlHUeLrEl+k/nA (button) (small blind) folded on the Turn
Seat 2: 3Wro85I7472vJ4Wkpneo9A (big blind) collected ($0.95)



PokerStars Game #59938857184:  Hold'em No Limit ($0.25/$0.50) - 2009/07/01 0:25:14 ET
Table 'ZYwMb9E6tY50Qm+iNbXRYw' 2-max Seat #1 is the button
Seat 1: DXLfRb8KDZWmrztw2bwtFw ($10.40 in chips)
Seat 2: 16tvT7AYgZ2LgiGFcvFKQg ($19.85 in chips)
DXLfRb8KDZWmrztw2bwtFw: posts small blind $0.25
16tvT7AYgZ2LgiGFcvFKQg: posts big blind $0.50
*** HOLE CARDS ***
DXLfRb8KDZWmrztw2bwtFw: calls $0.25
16tvT7AYgZ2LgiGFcvFKQg: checks
*** FLOP *** [2h 6d As]
16tvT7AYgZ2LgiGFcvFKQg: bets $0.50
DXLfRb8KDZWmrztw2bwtFw: calls $0.50
*** TURN *** [2h 6d As] [Th]
16tvT7AYgZ2LgiGFcvFKQg: bets $0.50
DXLfRb8KDZWmrztw2bwtFw: calls $0.50
*** RIVER *** [2h 6d As Th] [8d]
16tvT7AYgZ2LgiGFcvFKQg: checks
DXLfRb8KDZWmrztw2bwtFw: checks
*** SHOW DOWN ***
16tvT7AYgZ2LgiGFcvFKQg: shows [4s 5c] (high card Ace)
DXLfRb8KDZWmrztw2bwtFw: shows [4h 5h] (high card Ace)
16tvT7AYgZ2LgiGFcvFKQg collected $1.45 from pot
DXLfRb8KDZWmrztw2bwtFw collected $1.45 from pot
*** SUMMARY ***
Total pot $3 | Rake $0.10
Board [2h 6d As Th 8d]
Seat 1: DXLfRb8KDZWmrztw2bwtFw (button) (small blind) showed [4h 5h] and won ($1.45) with high card Ace
Seat 2: 16tvT7AYgZ2LgiGFcvFKQg (big blind) showed [4s 5c] and won ($1.45) with high card Ace



PokerStars Game #59938857048:  Hold'em No Limit ($0.25/$0.50) - 2009/07/01 0:25:14 ET
Table '+dXkOAQyS8j9PQZusUTMpg' 2-max Seat #1 is the button
Seat 1: XFa6sBGjP2gxoIvxR3fZIg ($46.35 in chips)
Seat 2: 5IBeOgaApY1Bvzv2P8X4EA ($60.25 in chips)
XFa6sBGjP2gxoIvxR3fZIg: posts small blind $0.25
5IBeOgaApY1Bvzv2P8X4EA: posts big blind $0.50
*** HOLE CARDS ***
XFa6sBGjP2gxoIvxR3fZIg: raises $1 to $1.50
5IBeOgaApY1Bvzv2P8X4EA: folds
XFa6sBGjP2gxoIvxR3fZIg collected $1 from pot
XFa6sBGjP2gxoIvxR3fZIg: doesn't show hand
*** SUMMARY ***
Total pot $1 | Rake $0
Seat 1: XFa6sBGjP2gxoIvxR3fZIg (button) (small blind) collected ($1)
Seat 2: 5IBeOgaApY1Bvzv2P8X4EA (big blind) folded before Flop



PokerStars Game #59938856912:  Hold'em No Limit ($0.25/$0.50) - 2009/07/01 0:25:14 ET
Table 'kgbJRsxfv64KrErDRBAkcw' 6-max Seat #1 is the button
Seat 1: N7O9jUEx2YiQn1+yRYTHmw ($16.15 in chips)
Seat 2: Q+thC23WCv1kJUJtH/+4Jw ($67.40 in chips)
Seat 3: T0Gx/FcQ5VH9u7XaOMX97A ($60.25 in chips)
Seat 4: qanMEqjABjWxC/JgQ/0l7w ($59.95 in chips)
Seat 5: +Pf9jTVizYlIo+woPvptfA ($50 in chips)
Seat 6: ozrlafxxh1HmYdA0/h+MuA ($7.50 in chips)
Q+thC23WCv1kJUJtH/+4Jw: posts small blind $0.25
T0Gx/FcQ5VH9u7XaOMX97A: posts big blind $0.50
*** HOLE CARDS ***
qanMEqjABjWxC/JgQ/0l7w: folds
+Pf9jTVizYlIo+woPvptfA: folds
ozrlafxxh1HmYdA0/h+MuA: calls $0.50
N7O9jUEx2YiQn1+yRYTHmw: folds
Q+thC23WCv1kJUJtH/+4Jw: folds
T0Gx/FcQ5VH9u7XaOMX97A: checks
*** FLOP *** [3s 4c 9c]
T0Gx/FcQ5VH9u7XaOMX97A: checks
ozrlafxxh1HmYdA0/h+MuA: checks
*** TURN *** [3s 4c 9c] [Td]
T0Gx/FcQ5VH9u7XaOMX97A: bets $1
ozrlafxxh1HmYdA0/h+MuA: calls $1
*** RIVER *** [3s 4c 9c Td] [3h]
T0Gx/FcQ5VH9u7XaOMX97A: bets $7
ozrlafxxh1HmYdA0/h+MuA: folds
T0Gx/FcQ5VH9u7XaOMX97A collected $3.10 from pot
T0Gx/FcQ5VH9u7XaOMX97A: doesn't show hand
*** SUMMARY ***
Total pot $3.25 | Rake $0.15
Board [3s 4c 9c Td 3h]
Seat 1: N7O9jUEx2YiQn1+yRYTHmw (button) folded before Flop (didn't bet)
Seat 2: Q+thC23WCv1kJUJtH/+4Jw (small blind) folded before Flop
Seat 3: T0Gx/FcQ5VH9u7XaOMX97A (big blind) collected ($3.10)
Seat 4: qanMEqjABjWxC/JgQ/0l7w folded before Flop (didn't bet)
Seat 5: +Pf9jTVizYlIo+woPvptfA folded before Flop (didn't bet)
Seat 6: ozrlafxxh1HmYdA0/h+MuA folded on the River



PokerStars Game #59938857906:  Hold'em No Limit ($0.25/$0.50) - 2009/07/01 0:25:15 ET
Table 'EiNh8p/wGJ1FP575iMFnqg' 9-max Seat #8 is the button
Seat 1: r3ZqM1Mi0W3y4hOdssE+Sg ($27.70 in chips)
Seat 2: sSAA879uXOGR+8Mf3zLa6Q ($9.45 in chips)
Seat 3: GszS/McxOSUnOET7MBoHqA ($43 in chips)
Seat 4: HIIPkpiaCQfs5HcPKjlHvg ($40.70 in chips)
Seat 5: M+7+BTmX5vZatHVuoRB1nA ($78.65 in chips)
Seat 6: 3UmXLy3GfjC3EkOebduerQ ($56.60 in chips)
Seat 7: Wj7mKnRFR90j40wWUu2+Og ($77.80 in chips)
Seat 8: KrPAGRACBg+w0M//SXe8Ag ($15.55 in chips)
Seat 9: OMwFJ4pF0xk2Ru/AJiFeFw ($70.15 in chips)
OMwFJ4pF0xk2Ru/AJiFeFw: posts small blind $0.25
r3ZqM1Mi0W3y4hOdssE+Sg: posts big blind $0.50
*** HOLE CARDS ***
sSAA879uXOGR+8Mf3zLa6Q: folds
GszS/McxOSUnOET7MBoHqA: folds
HIIPkpiaCQfs5HcPKjlHvg: folds
GszS/McxOSUnOET7MBoHqA leaves the table
ymLPoEIl7UL3TvZYmnadxQ joins the table at seat #3
M+7+BTmX5vZatHVuoRB1nA: folds
3UmXLy3GfjC3EkOebduerQ: folds
Wj7mKnRFR90j40wWUu2+Og: folds
KrPAGRACBg+w0M//SXe8Ag: raises $0.50 to $1
OMwFJ4pF0xk2Ru/AJiFeFw: folds
r3ZqM1Mi0W3y4hOdssE+Sg: folds
KrPAGRACBg+w0M//SXe8Ag collected $1.25 from pot
KrPAGRACBg+w0M//SXe8Ag: doesn't show hand
*** SUMMARY ***
Total pot $1.25 | Rake $0
Seat 1: r3ZqM1Mi0W3y4hOdssE+Sg (big blind) folded before Flop
Seat 2: sSAA879uXOGR+8Mf3zLa6Q folded before Flop (didn't bet)
Seat 3: GszS/McxOSUnOET7MBoHqA folded before Flop (didn't bet)
Seat 4: HIIPkpiaCQfs5HcPKjlHvg folded before Flop (didn't bet)
Seat 5: M+7+BTmX5vZatHVuoRB1nA folded before Flop (didn't bet)
Seat 6: 3UmXLy3GfjC3EkOebduerQ folded before Flop (didn't bet)
Seat 7: Wj7mKnRFR90j40wWUu2+Og folded before Flop (didn't bet)
Seat 8: KrPAGRACBg+w0M//SXe8Ag (button) collected ($1.25)
Seat 9: OMwFJ4pF0xk2Ru/AJiFeFw (small blind) folded before Flop



PokerStars Game #59938858108:  Hold'em No Limit ($0.25/$0.50) - 2009/07/01 0:25:16 ET
Table '5EmHi+fnatGQQShcNmzOZQ' 6-max Seat #5 is the button
Seat 1: SwPczQo3cOtwEzhJrfO2cQ ($28.95 in chips)
Seat 3: L9qfLYXrczhAPd/VckgsWw ($58.85 in chips)
Seat 4: wOyVV9M/oyiw3YaOjNZ05w ($50.45 in chips)
Seat 5: kxPhs4ePFqMy52CInAJ2aw ($48 in chips)
Seat 6: 686aeHikcJlgKkSuIFdcXQ ($156.10 in chips)
686aeHikcJlgKkSuIFdcXQ: posts small blind $0.25
SwPczQo3cOtwEzhJrfO2cQ: posts big blind $0.50
*** HOLE CARDS ***
L9qfLYXrczhAPd/VckgsWw: folds
wOyVV9M/oyiw3YaOjNZ05w: folds
kxPhs4ePFqMy52CInAJ2aw: folds
686aeHikcJlgKkSuIFdcXQ: raises $1.50 to $2
SwPczQo3cOtwEzhJrfO2cQ: calls $1.50
*** FLOP *** [4c Th 6h]
686aeHikcJlgKkSuIFdcXQ: bets $3
SwPczQo3cOtwEzhJrfO2cQ: folds
686aeHikcJlgKkSuIFdcXQ collected $3.80 from pot
*** SUMMARY ***
Total pot $4 | Rake $0.20
Board [4c Th 6h]
Seat 1: SwPczQo3cOtwEzhJrfO2cQ (big blind) folded on the Flop
Seat 3: L9qfLYXrczhAPd/VckgsWw folded before Flop (didn't bet)
Seat 4: wOyVV9M/oyiw3YaOjNZ05w folded before Flop (didn't bet)
Seat 5: kxPhs4ePFqMy52CInAJ2aw (button) folded before Flop (didn't bet)
Seat 6: 686aeHikcJlgKkSuIFdcXQ (small blind) collected ($3.80)



PokerStars Game #59938859040:  Hold'em No Limit ($0.25/$0.50) - 2009/07/01 0:25:17 ET
Table 'GfL/No5u5PoEnU39lP5pQg' 6-max Seat #2 is the button
Seat 1: 1WUCqNG+p+vfWRTXNu4ljw ($51.40 in chips)
Seat 2: uVwggSetzp7d+eVgowO3vg ($44.75 in chips)
Seat 3: qNezhXOOUXqwG7b9X5XJAA ($50 in chips)
Seat 4: OZ6OtYh5Y53MCH/p0QTn5g ($50 in chips)
Seat 5: crjGpJEzSZgD38FoE3VMGg ($54.30 in chips)
qNezhXOOUXqwG7b9X5XJAA: posts small blind $0.25
OZ6OtYh5Y53MCH/p0QTn5g: posts big blind $0.50
*** HOLE CARDS ***
crjGpJEzSZgD38FoE3VMGg: folds
1WUCqNG+p+vfWRTXNu4ljw: raises $1.50 to $2
uVwggSetzp7d+eVgowO3vg: folds
qNezhXOOUXqwG7b9X5XJAA: folds
OZ6OtYh5Y53MCH/p0QTn5g: folds
1WUCqNG+p+vfWRTXNu4ljw collected $1.25 from pot
*** SUMMARY ***
Total pot $1.25 | Rake $0
Seat 1: 1WUCqNG+p+vfWRTXNu4ljw collected ($1.25)
Seat 2: uVwggSetzp7d+eVgowO3vg (button) folded before Flop (didn't bet)
Seat 3: qNezhXOOUXqwG7b9X5XJAA (small blind) folded before Flop
Seat 4: OZ6OtYh5Y53MCH/p0QTn5g (big blind) folded before Flop
Seat 5: crjGpJEzSZgD38FoE3VMGg folded before Flop (didn't bet)



PokerStars Game #59938859054:  Hold'em No Limit ($0.25/$0.50) - 2009/07/01 0:25:17 ET
Table 'fx6MqwfYAj/Rt86hBz2L3Q' 9-max Seat #2 is the button
Seat 1: jf2c/o9gI7Xj0GleCSMj9g ($51.05 in chips)
Seat 2: C3rGXblctNcWI6JYPHhaEg ($14.55 in chips)
Seat 3: iadBi5AEt7gTBXbDSSnMYQ ($51.10 in chips)
Seat 4: gPEN9Zp33YTm/mu9/SYP1w ($25.45 in chips)
Seat 5: iAISe3dVeua8PUn2wwgDHw ($26.50 in chips)
Seat 7: bkXkL3pmapikPQQRNPZSEA ($7.25 in chips)
Seat 8: 6ol/q1A4zYU6qXbZnTzPfQ ($20.30 in chips)
Seat 9: HZkVla4kK2SI42CVrPZ/ig ($9.25 in chips)
iadBi5AEt7gTBXbDSSnMYQ: posts small blind $0.25
gPEN9Zp33YTm/mu9/SYP1w: posts big blind $0.50
5k9fvXD9suIgCxU4HLQjTw: sits out
*** HOLE CARDS ***
iAISe3dVeua8PUn2wwgDHw: folds
bkXkL3pmapikPQQRNPZSEA: calls $0.50
6ol/q1A4zYU6qXbZnTzPfQ: calls $0.50
HZkVla4kK2SI42CVrPZ/ig: folds
jf2c/o9gI7Xj0GleCSMj9g: calls $0.50
C3rGXblctNcWI6JYPHhaEg: calls $0.50
iadBi5AEt7gTBXbDSSnMYQ: calls $0.25
gPEN9Zp33YTm/mu9/SYP1w: checks
*** FLOP *** [Qh Qd Kd]
iadBi5AEt7gTBXbDSSnMYQ: checks
gPEN9Zp33YTm/mu9/SYP1w: checks
bkXkL3pmapikPQQRNPZSEA: checks
6ol/q1A4zYU6qXbZnTzPfQ: checks
jf2c/o9gI7Xj0GleCSMj9g: checks
C3rGXblctNcWI6JYPHhaEg: bets $2.05
iadBi5AEt7gTBXbDSSnMYQ: calls $2.05
gPEN9Zp33YTm/mu9/SYP1w: folds
bkXkL3pmapikPQQRNPZSEA: folds
6ol/q1A4zYU6qXbZnTzPfQ: folds
jf2c/o9gI7Xj0GleCSMj9g: folds
*** TURN *** [Qh Qd Kd] [3h]
iadBi5AEt7gTBXbDSSnMYQ: checks
C3rGXblctNcWI6JYPHhaEg: checks
*** RIVER *** [Qh Qd Kd 3h] [Js]
iadBi5AEt7gTBXbDSSnMYQ: checks
C3rGXblctNcWI6JYPHhaEg: checks
*** SHOW DOWN ***
iadBi5AEt7gTBXbDSSnMYQ: shows [9d 8s] (a pair of Queens)
C3rGXblctNcWI6JYPHhaEg: shows [7c 9c] (a pair of Queens)
iadBi5AEt7gTBXbDSSnMYQ collected $3.40 from pot
C3rGXblctNcWI6JYPHhaEg collected $3.40 from pot
*** SUMMARY ***
Total pot $7.10 | Rake $0.30
Board [Qh Qd Kd 3h Js]
Seat 1: jf2c/o9gI7Xj0GleCSMj9g folded on the Flop
Seat 2: C3rGXblctNcWI6JYPHhaEg (button) showed [7c 9c] and won ($3.40) with a pair of Queens
Seat 3: iadBi5AEt7gTBXbDSSnMYQ (small blind) showed [9d 8s] and won ($3.40) with a pair of Queens
Seat 4: gPEN9Zp33YTm/mu9/SYP1w (big blind) folded on the Flop
Seat 5: iAISe3dVeua8PUn2wwgDHw folded before Flop (didn't bet)
Seat 7: bkXkL3pmapikPQQRNPZSEA folded on the Flop
Seat 8: 6ol/q1A4zYU6qXbZnTzPfQ folded on the Flop
Seat 9: HZkVla4kK2SI42CVrPZ/ig folded before Flop (didn't bet)



PokerStars Game #59938861422:  Hold'em No Limit ($0.25/$0.50) - 2009/07/01 0:25:21 ET
Table 'T/PgNWqVyY6lkldcBVXYJQ' 6-max Seat #6 is the button
Seat 1: +Pf9jTVizYlIo+woPvptfA ($52.25 in chips)
Seat 2: oZAeY5rVqNGgt8yyQ0pxbA ($37.70 in chips)
Seat 3: L3OcNO1bgdqDI46j67KQPQ ($53.30 in chips)
Seat 4: jxMvxeUUL9UU0V6wVU+Iyw ($9.95 in chips)
Seat 5: vVQBckETtigfb5mAcyK0OA ($49.85 in chips)
Seat 6: cDzbog6kwmJp+LBeBq+iMQ ($32.50 in chips)
+Pf9jTVizYlIo+woPvptfA: posts small blind $0.25
oZAeY5rVqNGgt8yyQ0pxbA: posts big blind $0.50
*** HOLE CARDS ***
L3OcNO1bgdqDI46j67KQPQ: folds
jxMvxeUUL9UU0V6wVU+Iyw: folds
vVQBckETtigfb5mAcyK0OA: calls $0.50
cDzbog6kwmJp+LBeBq+iMQ: raises $0.50 to $1
+Pf9jTVizYlIo+woPvptfA: raises $3.25 to $4.25
oZAeY5rVqNGgt8yyQ0pxbA: calls $3.75
vVQBckETtigfb5mAcyK0OA: folds
cDzbog6kwmJp+LBeBq+iMQ: calls $3.25
*** FLOP *** [2s Jc 2d]
+Pf9jTVizYlIo+woPvptfA: checks
jxMvxeUUL9UU0V6wVU+Iyw said, "They'll have CF18's fly over, CForces dropping parachutists in..  some really sweet stuff."
oZAeY5rVqNGgt8yyQ0pxbA: checks
cDzbog6kwmJp+LBeBq+iMQ: bets $7
+Pf9jTVizYlIo+woPvptfA: calls $7
oZAeY5rVqNGgt8yyQ0pxbA: folds
*** TURN *** [2s Jc 2d] [Ac]
+Pf9jTVizYlIo+woPvptfA: checks
cDzbog6kwmJp+LBeBq+iMQ: checks
*** RIVER *** [2s Jc 2d Ac] [Jd]
vVQBckETtigfb5mAcyK0OA said, "sounds like fun.but cant go thank u"
jxMvxeUUL9UU0V6wVU+Iyw said, "Honestly, it is a freaking great event."
+Pf9jTVizYlIo+woPvptfA: checks
cDzbog6kwmJp+LBeBq+iMQ: bets $15
+Pf9jTVizYlIo+woPvptfA: calls $15
*** SHOW DOWN ***
cDzbog6kwmJp+LBeBq+iMQ: shows [Ah Js] (a full house, Jacks full of Aces)
+Pf9jTVizYlIo+woPvptfA: mucks hand
cDzbog6kwmJp+LBeBq+iMQ collected $54.50 from pot
*** SUMMARY ***
Total pot $57.25 | Rake $2.75
Board [2s Jc 2d Ac Jd]
Seat 1: +Pf9jTVizYlIo+woPvptfA (small blind) mucked
Seat 2: oZAeY5rVqNGgt8yyQ0pxbA (big blind) folded on the Flop
Seat 3: L3OcNO1bgdqDI46j67KQPQ folded before Flop (didn't bet)
Seat 4: jxMvxeUUL9UU0V6wVU+Iyw folded before Flop (didn't bet)
Seat 5: vVQBckETtigfb5mAcyK0OA folded before Flop
Seat 6: cDzbog6kwmJp+LBeBq+iMQ (button) showed [Ah Js] and won ($54.50) with a full house, Jacks full of Aces



PokerStars Game #59938861728:  Hold'em No Limit ($0.25/$0.50) - 2009/07/01 0:25:21 ET
Table '+dXkOAQyS8j9PQZusUTMpg' 2-max Seat #2 is the button
Seat 1: XFa6sBGjP2gxoIvxR3fZIg ($46.85 in chips)
Seat 2: 5IBeOgaApY1Bvzv2P8X4EA ($59.75 in chips)
5IBeOgaApY1Bvzv2P8X4EA: posts small blind $0.25
XFa6sBGjP2gxoIvxR3fZIg: posts big blind $0.50
*** HOLE CARDS ***
5IBeOgaApY1Bvzv2P8X4EA: folds
XFa6sBGjP2gxoIvxR3fZIg collected $0.50 from pot
XFa6sBGjP2gxoIvxR3fZIg: doesn't show hand
*** SUMMARY ***
Total pot $0.50 | Rake $0
Seat 1: XFa6sBGjP2gxoIvxR3fZIg (big blind) collected ($0.50)
Seat 2: 5IBeOgaApY1Bvzv2P8X4EA (button) (small blind) folded before Flop



PokerStars Game #59938862450:  Hold'em No Limit ($0.25/$0.50) - 2009/07/01 0:25:22 ET
Table 'QOgaEqMcJ73pcUMMxoisUg' 6-max Seat #1 is the button
Seat 1: UaC1G3O4HWbowgSfeYnkog ($8.75 in chips)
Seat 2: Im2p1Nt83UKSqv5c9frm4Q ($50 in chips)
Seat 3: wUZNozoIDYf+16hp4nn6dw ($31.55 in chips)
Seat 4: zAcsDhG/T128Vn7XGVSgKg ($63.30 in chips)
Seat 5: 6vNxrjjCl6FwfaaymM9jjg ($28.25 in chips)
Seat 6: s83dnhZ6VC53vY0/f6OV/g ($43.85 in chips)
Im2p1Nt83UKSqv5c9frm4Q: posts small blind $0.25
wUZNozoIDYf+16hp4nn6dw: posts big blind $0.50
*** HOLE CARDS ***
zAcsDhG/T128Vn7XGVSgKg: raises $1 to $1.50
6vNxrjjCl6FwfaaymM9jjg: folds
s83dnhZ6VC53vY0/f6OV/g: calls $1.50
UaC1G3O4HWbowgSfeYnkog: folds
Im2p1Nt83UKSqv5c9frm4Q: folds
wUZNozoIDYf+16hp4nn6dw: calls $1
*** FLOP *** [Qs 8s 6d]
wUZNozoIDYf+16hp4nn6dw: bets $2
zAcsDhG/T128Vn7XGVSgKg: folds
s83dnhZ6VC53vY0/f6OV/g: folds
wUZNozoIDYf+16hp4nn6dw collected $4.55 from pot
*** SUMMARY ***
Total pot $4.75 | Rake $0.20
Board [Qs 8s 6d]
Seat 1: UaC1G3O4HWbowgSfeYnkog (button) folded before Flop (didn't bet)
Seat 2: Im2p1Nt83UKSqv5c9frm4Q (small blind) folded before Flop
Seat 3: wUZNozoIDYf+16hp4nn6dw (big blind) collected ($4.55)
Seat 4: zAcsDhG/T128Vn7XGVSgKg folded on the Flop
Seat 5: 6vNxrjjCl6FwfaaymM9jjg folded before Flop (didn't bet)
Seat 6: s83dnhZ6VC53vY0/f6OV/g folded on the Flop



PokerStars Game #59938863636:  Hold'em No Limit ($0.25/$0.50) - 2009/07/01 0:25:24 ET
Table 'mTxf8gPLgffN3Iwfm7Icfg' 2-max Seat #2 is the button
Seat 1: Do9Rlu1R5u/AcRtMTl8SYg ($91.45 in chips)
Seat 2: EMc5LPgVaded4Qc77vm0fw ($69.10 in chips)
EMc5LPgVaded4Qc77vm0fw: posts small blind $0.25
Do9Rlu1R5u/AcRtMTl8SYg: posts big blind $0.50
*** HOLE CARDS ***
EMc5LPgVaded4Qc77vm0fw: folds
Do9Rlu1R5u/AcRtMTl8SYg collected $0.50 from pot
Do9Rlu1R5u/AcRtMTl8SYg: doesn't show hand
*** SUMMARY ***
Total pot $0.50 | Rake $0
Seat 1: Do9Rlu1R5u/AcRtMTl8SYg (big blind) collected ($0.50)
Seat 2: EMc5LPgVaded4Qc77vm0fw (button) (small blind) folded before Flop



PokerStars Game #59938864948:  Hold'em No Limit ($0.25/$0.50) - 2009/07/01 0:25:26 ET
Table '37qXEp3oe+er5q4CZip9eQ' 6-max Seat #5 is the button
Seat 1: oqOqoO2AyCZenUghCxMDxw ($50 in chips)
Seat 3: Rt6KgtZ8YaJoTc3FPim00w ($97.65 in chips)
Seat 5: VOmI0x4dDPnTESZd5B4d1Q ($45.25 in chips)
Seat 6: f7zPpUQp9hHZgqhEvrUWQw ($50 in chips)
f7zPpUQp9hHZgqhEvrUWQw: posts small blind $0.25
oqOqoO2AyCZenUghCxMDxw: posts big blind $0.50
*** HOLE CARDS ***
Rt6KgtZ8YaJoTc3FPim00w: raises $1 to $1.50
VOmI0x4dDPnTESZd5B4d1Q: folds
f7zPpUQp9hHZgqhEvrUWQw: folds
oqOqoO2AyCZenUghCxMDxw: calls $1
*** FLOP *** [3c 8h Qs]
oqOqoO2AyCZenUghCxMDxw: checks
6wzJiRvp8HY6t+MQGnSIzA joins the table at seat #2
Rt6KgtZ8YaJoTc3FPim00w: bets $2
oqOqoO2AyCZenUghCxMDxw: folds
Rt6KgtZ8YaJoTc3FPim00w collected $3.10 from pot
*** SUMMARY ***
Total pot $3.25 | Rake $0.15
Board [3c 8h Qs]
Seat 1: oqOqoO2AyCZenUghCxMDxw (big blind) folded on the Flop
Seat 3: Rt6KgtZ8YaJoTc3FPim00w collected ($3.10)
Seat 5: VOmI0x4dDPnTESZd5B4d1Q (button) folded before Flop (didn't bet)
Seat 6: f7zPpUQp9hHZgqhEvrUWQw (small blind) folded before Flop



PokerStars Game #59938865742:  Hold'em No Limit ($0.25/$0.50) - 2009/07/01 0:25:27 ET
Table '+dXkOAQyS8j9PQZusUTMpg' 2-max Seat #1 is the button
Seat 1: XFa6sBGjP2gxoIvxR3fZIg ($47.10 in chips)
Seat 2: 5IBeOgaApY1Bvzv2P8X4EA ($59.50 in chips)
XFa6sBGjP2gxoIvxR3fZIg: posts small blind $0.25
5IBeOgaApY1Bvzv2P8X4EA: posts big blind $0.50
*** HOLE CARDS ***
XFa6sBGjP2gxoIvxR3fZIg: raises $1 to $1.50
5IBeOgaApY1Bvzv2P8X4EA: raises $1.50 to $3
XFa6sBGjP2gxoIvxR3fZIg: calls $1.50
*** FLOP *** [8d 7c Jd]
5IBeOgaApY1Bvzv2P8X4EA: checks
XFa6sBGjP2gxoIvxR3fZIg: bets $4
5IBeOgaApY1Bvzv2P8X4EA: calls $4
*** TURN *** [8d 7c Jd] [3h]
5IBeOgaApY1Bvzv2P8X4EA: checks
XFa6sBGjP2gxoIvxR3fZIg: checks
*** RIVER *** [8d 7c Jd 3h] [9c]
5IBeOgaApY1Bvzv2P8X4EA: bets $3.50
XFa6sBGjP2gxoIvxR3fZIg: raises $15 to $18.50
5IBeOgaApY1Bvzv2P8X4EA: folds
XFa6sBGjP2gxoIvxR3fZIg collected $20.50 from pot
XFa6sBGjP2gxoIvxR3fZIg: doesn't show hand
*** SUMMARY ***
Total pot $21 | Rake $0.50
Board [8d 7c Jd 3h 9c]
Seat 1: XFa6sBGjP2gxoIvxR3fZIg (button) (small blind) collected ($20.50)
Seat 2: 5IBeOgaApY1Bvzv2P8X4EA (big blind) folded on the River



PokerStars Game #59938866558:  Hold'em No Limit ($0.25/$0.50) - 2009/07/01 0:25:29 ET
Table 'E7bWJ45aoFXRpyRv2gw+Ig' 2-max Seat #2 is the button
Seat 1: FRkiRasEGlHUeLrEl+k/nA ($63 in chips)
Seat 2: 3Wro85I7472vJ4Wkpneo9A ($115.25 in chips)
3Wro85I7472vJ4Wkpneo9A: posts small blind $0.25
FRkiRasEGlHUeLrEl+k/nA: posts big blind $0.50
*** HOLE CARDS ***
3Wro85I7472vJ4Wkpneo9A: raises $1 to $1.50
FRkiRasEGlHUeLrEl+k/nA: raises $2.50 to $4
3Wro85I7472vJ4Wkpneo9A: folds
FRkiRasEGlHUeLrEl+k/nA collected $3 from pot
FRkiRasEGlHUeLrEl+k/nA: doesn't show hand
*** SUMMARY ***
Total pot $3 | Rake $0
Seat 1: FRkiRasEGlHUeLrEl+k/nA (big blind) collected ($3)
Seat 2: 3Wro85I7472vJ4Wkpneo9A (button) (small blind) folded before Flop



PokerStars Game #59938866868:  Hold'em No Limit ($0.25/$0.50) - 2009/07/01 0:25:29 ET
Table 'NCiXr0d5CEKBQr/cZgLhbA' 9-max Seat #3 is the button
Seat 1: RjBdQ6w31rgcy0o24VLR6w ($15.85 in chips)
Seat 2: ulxuJchBV9iguXg0FUonfg ($33.55 in chips)
Seat 3: xZCXQSXlrZkp3pZizzVXCw ($56.15 in chips)
Seat 5: zE9cVigS2nW/Ljy4K4bUQA ($39.75 in chips)
Seat 6: SKnJuWHScqetA/qG5p+wCg ($30 in chips)
Seat 7: M+7+BTmX5vZatHVuoRB1nA ($49.25 in chips)
Seat 8: 1MJUKc3cc0QmUoz1JZLR2w ($54.35 in chips)
5k9fvXD9suIgCxU4HLQjTw will be allowed to play after the button
zE9cVigS2nW/Ljy4K4bUQA: posts small blind $0.25
SKnJuWHScqetA/qG5p+wCg: posts big blind $0.50
4WLZvqBn5qv5tds5kt5A1Q: sits out
*** HOLE CARDS ***
M+7+BTmX5vZatHVuoRB1nA: folds
1MJUKc3cc0QmUoz1JZLR2w: folds
RjBdQ6w31rgcy0o24VLR6w: folds
ulxuJchBV9iguXg0FUonfg: folds
xZCXQSXlrZkp3pZizzVXCw: raises $1 to $1.50
zE9cVigS2nW/Ljy4K4bUQA: folds
SKnJuWHScqetA/qG5p+wCg: folds
xZCXQSXlrZkp3pZizzVXCw collected $1.25 from pot
*** SUMMARY ***
Total pot $1.25 | Rake $0
Seat 1: RjBdQ6w31rgcy0o24VLR6w folded before Flop (didn't bet)
Seat 2: ulxuJchBV9iguXg0FUonfg folded before Flop (didn't bet)
Seat 3: xZCXQSXlrZkp3pZizzVXCw (button) collected ($1.25)
Seat 5: zE9cVigS2nW/Ljy4K4bUQA (small blind) folded before Flop
Seat 6: SKnJuWHScqetA/qG5p+wCg (big blind) folded before Flop
Seat 7: M+7+BTmX5vZatHVuoRB1nA folded before Flop (didn't bet)
Seat 8: 1MJUKc3cc0QmUoz1JZLR2w folded before Flop (didn't bet)



PokerStars Game #59938867710:  Hold'em No Limit ($0.25/$0.50) - 2009/07/01 0:25:30 ET
Table 'mTxf8gPLgffN3Iwfm7Icfg' 2-max Seat #1 is the button
Seat 1: Do9Rlu1R5u/AcRtMTl8SYg ($91.70 in chips)
Seat 2: EMc5LPgVaded4Qc77vm0fw ($68.85 in chips)
Do9Rlu1R5u/AcRtMTl8SYg: posts small blind $0.25
EMc5LPgVaded4Qc77vm0fw: posts big blind $0.50
*** HOLE CARDS ***
Do9Rlu1R5u/AcRtMTl8SYg: folds
EMc5LPgVaded4Qc77vm0fw said, "nh"
EMc5LPgVaded4Qc77vm0fw collected $0.50 from pot
EMc5LPgVaded4Qc77vm0fw: doesn't show hand
*** SUMMARY ***
Total pot $0.50 | Rake $0
Seat 1: Do9Rlu1R5u/AcRtMTl8SYg (button) (small blind) folded before Flop
Seat 2: EMc5LPgVaded4Qc77vm0fw (big blind) collected ($0.50)



PokerStars Game #59938867702:  Hold'em No Limit ($0.25/$0.50) - 2009/07/01 0:25:30 ET
Table 'IeNZOZQ4T6oiaHqFeo6yIA' 2-max Seat #2 is the button
Seat 1: ndd1nfncBkWNitBnsfCoVQ ($95.60 in chips)
Seat 2: A91IUl5JaZROhtfCtnnwYw ($38.80 in chips)
A91IUl5JaZROhtfCtnnwYw: posts small blind $0.25
ndd1nfncBkWNitBnsfCoVQ: posts big blind $0.50
*** HOLE CARDS ***
A91IUl5JaZROhtfCtnnwYw: calls $0.25
ndd1nfncBkWNitBnsfCoVQ: checks
*** FLOP *** [9c Qc 6h]
ndd1nfncBkWNitBnsfCoVQ: bets $1
A91IUl5JaZROhtfCtnnwYw: calls $1
*** TURN *** [9c Qc 6h] [2h]
ndd1nfncBkWNitBnsfCoVQ: bets $2.50
A91IUl5JaZROhtfCtnnwYw: calls $2.50
*** RIVER *** [9c Qc 6h 2h] [9d]
ndd1nfncBkWNitBnsfCoVQ: bets $4
A91IUl5JaZROhtfCtnnwYw: calls $4
*** SHOW DOWN ***
ndd1nfncBkWNitBnsfCoVQ: shows [8s Td] (a pair of Nines)
A91IUl5JaZROhtfCtnnwYw: shows [6s Jh] (two pair, Nines and Sixes)
A91IUl5JaZROhtfCtnnwYw collected $15.50 from pot
*** SUMMARY ***
Total pot $16 | Rake $0.50
Board [9c Qc 6h 2h 9d]
Seat 1: ndd1nfncBkWNitBnsfCoVQ (big blind) showed [8s Td] and lost with a pair of Nines
Seat 2: A91IUl5JaZROhtfCtnnwYw (button) (small blind) showed [6s Jh] and won ($15.50) with two pair, Nines and Sixes



PokerStars Game #59938869004:  Hold'em No Limit ($0.25/$0.50) - 2009/07/01 0:25:32 ET
Table 'ZYwMb9E6tY50Qm+iNbXRYw' 2-max Seat #2 is the button
Seat 1: DXLfRb8KDZWmrztw2bwtFw ($10.35 in chips)
Seat 2: 16tvT7AYgZ2LgiGFcvFKQg ($19.80 in chips)
16tvT7AYgZ2LgiGFcvFKQg: posts small blind $0.25
DXLfRb8KDZWmrztw2bwtFw: posts big blind $0.50
*** HOLE CARDS ***
16tvT7AYgZ2LgiGFcvFKQg: raises $0.50 to $1
DXLfRb8KDZWmrztw2bwtFw: folds
16tvT7AYgZ2LgiGFcvFKQg collected $1 from pot
16tvT7AYgZ2LgiGFcvFKQg: doesn't show hand
*** SUMMARY ***
Total pot $1 | Rake $0
Seat 1: DXLfRb8KDZWmrztw2bwtFw (big blind) folded before Flop
Seat 2: 16tvT7AYgZ2LgiGFcvFKQg (button) (small blind) collected ($1)



PokerStars Game #59938871890:  Hold'em No Limit ($0.25/$0.50) - 2009/07/01 0:25:37 ET
Table 'mTxf8gPLgffN3Iwfm7Icfg' 2-max Seat #2 is the button
Seat 1: Do9Rlu1R5u/AcRtMTl8SYg ($91.45 in chips)
Seat 2: EMc5LPgVaded4Qc77vm0fw ($69.10 in chips)
EMc5LPgVaded4Qc77vm0fw: posts small blind $0.25
Do9Rlu1R5u/AcRtMTl8SYg: posts big blind $0.50
*** HOLE CARDS ***
EMc5LPgVaded4Qc77vm0fw: raises $1.50 to $2
Do9Rlu1R5u/AcRtMTl8SYg: folds
Do9Rlu1R5u/AcRtMTl8SYg said, "ty"
EMc5LPgVaded4Qc77vm0fw collected $1 from pot
EMc5LPgVaded4Qc77vm0fw: doesn't show hand
*** SUMMARY ***
Total pot $1 | Rake $0
Seat 1: Do9Rlu1R5u/AcRtMTl8SYg (big blind) folded before Flop
Seat 2: EMc5LPgVaded4Qc77vm0fw (button) (small blind) collected ($1)



PokerStars Game #59938871864:  Hold'em No Limit ($0.25/$0.50) - 2009/07/01 0:25:37 ET
Table '+z1aekfHkpp09pc8F9aViw' 6-max Seat #5 is the button
Seat 1: wOyVV9M/oyiw3YaOjNZ05w ($53.30 in chips)
Seat 2: M6xK/VklCvdyyrmvzATlxQ ($29.95 in chips)
Seat 3: uUznlIMFnRUvwrBhYF73KA ($63.25 in chips)
Seat 4: RowCSpSURHTOL/dcjg/Iug ($47.70 in chips)
Seat 5: crjGpJEzSZgD38FoE3VMGg ($59.15 in chips)
Seat 6: 686aeHikcJlgKkSuIFdcXQ ($69.60 in chips)
686aeHikcJlgKkSuIFdcXQ: posts small blind $0.25
wOyVV9M/oyiw3YaOjNZ05w: posts big blind $0.50
*** HOLE CARDS ***
M6xK/VklCvdyyrmvzATlxQ: folds
uUznlIMFnRUvwrBhYF73KA: folds
RowCSpSURHTOL/dcjg/Iug: folds
crjGpJEzSZgD38FoE3VMGg: folds
686aeHikcJlgKkSuIFdcXQ: raises $1.50 to $2
wOyVV9M/oyiw3YaOjNZ05w: folds
686aeHikcJlgKkSuIFdcXQ collected $1 from pot
*** SUMMARY ***
Total pot $1 | Rake $0
Seat 1: wOyVV9M/oyiw3YaOjNZ05w (big blind) folded before Flop
Seat 2: M6xK/VklCvdyyrmvzATlxQ folded before Flop (didn't bet)
Seat 3: uUznlIMFnRUvwrBhYF73KA folded before Flop (didn't bet)
Seat 4: RowCSpSURHTOL/dcjg/Iug folded before Flop (didn't bet)
Seat 5: crjGpJEzSZgD38FoE3VMGg (button) folded before Flop (didn't bet)
Seat 6: 686aeHikcJlgKkSuIFdcXQ (small blind) collected ($1)



PokerStars Game #59938872132:  Hold'em No Limit ($0.25/$0.50) - 2009/07/01 0:25:37 ET
Table 'PALRfuH85dr5IkDfdv6new' 9-max Seat #4 is the button
Seat 1: SKnJuWHScqetA/qG5p+wCg ($31.25 in chips)
Seat 2: 9r7ZoBbAJj5IeyZ0q9BdzA ($6.85 in chips)
Seat 3: 50QWoELmpmHFrFIlWMJo9g ($87.45 in chips)
Seat 4: mZNMJI1mY40XTC0U7GZakA ($50 in chips)
Seat 5: jSSGUXdNFAZA3QCvTcUMQw ($45.20 in chips)
Seat 6: E2518gp4aFz1+kAgmGqeEg ($11 in chips)
Seat 7: 3NcyXvr39gnK+KbTq7ezyA ($39.35 in chips)
Seat 8: NkS+CseUKx4XHszWq0PXEQ ($45.65 in chips)
Seat 9: CIrAX/m6o7jYmKOAjJXv4Q ($33.20 in chips)
jSSGUXdNFAZA3QCvTcUMQw: posts small blind $0.25
E2518gp4aFz1+kAgmGqeEg: posts big blind $0.50
*** HOLE CARDS ***
3NcyXvr39gnK+KbTq7ezyA: folds
NkS+CseUKx4XHszWq0PXEQ: folds
CIrAX/m6o7jYmKOAjJXv4Q: folds
SKnJuWHScqetA/qG5p+wCg: folds
9r7ZoBbAJj5IeyZ0q9BdzA: folds
50QWoELmpmHFrFIlWMJo9g: folds
mZNMJI1mY40XTC0U7GZakA: raises $1 to $1.50
jSSGUXdNFAZA3QCvTcUMQw: folds
E2518gp4aFz1+kAgmGqeEg: folds
mZNMJI1mY40XTC0U7GZakA collected $1.25 from pot
mZNMJI1mY40XTC0U7GZakA: doesn't show hand
*** SUMMARY ***
Total pot $1.25 | Rake $0
Seat 1: SKnJuWHScqetA/qG5p+wCg folded before Flop (didn't bet)
Seat 2: 9r7ZoBbAJj5IeyZ0q9BdzA folded before Flop (didn't bet)
Seat 3: 50QWoELmpmHFrFIlWMJo9g folded before Flop (didn't bet)
Seat 4: mZNMJI1mY40XTC0U7GZakA (button) collected ($1.25)
Seat 5: jSSGUXdNFAZA3QCvTcUMQw (small blind) folded before Flop
Seat 6: E2518gp4aFz1+kAgmGqeEg (big blind) folded before Flop
Seat 7: 3NcyXvr39gnK+KbTq7ezyA folded before Flop (didn't bet)
Seat 8: NkS+CseUKx4XHszWq0PXEQ folded before Flop (didn't bet)
Seat 9: CIrAX/m6o7jYmKOAjJXv4Q folded before Flop (didn't bet)



PokerStars Game #59938874084:  Hold'em No Limit ($0.25/$0.50) - 2009/07/01 0:25:40 ET
Table 'ZYwMb9E6tY50Qm+iNbXRYw' 2-max Seat #1 is the button
Seat 1: DXLfRb8KDZWmrztw2bwtFw ($9.85 in chips)
Seat 2: 16tvT7AYgZ2LgiGFcvFKQg ($20.30 in chips)
DXLfRb8KDZWmrztw2bwtFw: posts small blind $0.25
16tvT7AYgZ2LgiGFcvFKQg: posts big blind $0.50
*** HOLE CARDS ***
DXLfRb8KDZWmrztw2bwtFw said, "funny you rais every time you got small blind"
DXLfRb8KDZWmrztw2bwtFw: folds
16tvT7AYgZ2LgiGFcvFKQg collected $0.50 from pot
16tvT7AYgZ2LgiGFcvFKQg: doesn't show hand
*** SUMMARY ***
Total pot $0.50 | Rake $0
Seat 1: DXLfRb8KDZWmrztw2bwtFw (button) (small blind) folded before Flop
Seat 2: 16tvT7AYgZ2LgiGFcvFKQg (big blind) collected ($0.50)



PokerStars Game #59938875074:  Hold'em No Limit ($0.25/$0.50) - 2009/07/01 0:25:41 ET
Table 'c/CRn+68J3Y8KxD5g1ek2Q' 2-max Seat #2 is the button
Seat 1: 46qCyJ6evTkHo9al5sBMNA ($270.85 in chips)
Seat 2: BypVLsYQt3ePFm2xQL/dOA ($109.85 in chips)
BypVLsYQt3ePFm2xQL/dOA: posts small blind $0.25
46qCyJ6evTkHo9al5sBMNA: posts big blind $0.50
*** HOLE CARDS ***
BypVLsYQt3ePFm2xQL/dOA: raises $1 to $1.50
46qCyJ6evTkHo9al5sBMNA: calls $1
*** FLOP *** [Th 2h Qs]
46qCyJ6evTkHo9al5sBMNA: checks
BypVLsYQt3ePFm2xQL/dOA: checks
*** TURN *** [Th 2h Qs] [Kc]
46qCyJ6evTkHo9al5sBMNA: checks
BypVLsYQt3ePFm2xQL/dOA: bets $1.50
46qCyJ6evTkHo9al5sBMNA: calls $1.50
*** RIVER *** [Th 2h Qs Kc] [Qh]
46qCyJ6evTkHo9al5sBMNA: checks
BypVLsYQt3ePFm2xQL/dOA: checks
*** SHOW DOWN ***
46qCyJ6evTkHo9al5sBMNA: shows [Js 5s] (a pair of Queens)
BypVLsYQt3ePFm2xQL/dOA: shows [Kd 3c] (two pair, Kings and Queens)
BypVLsYQt3ePFm2xQL/dOA collected $5.75 from pot
*** SUMMARY ***
Total pot $6 | Rake $0.25
Board [Th 2h Qs Kc Qh]
Seat 1: 46qCyJ6evTkHo9al5sBMNA (big blind) showed [Js 5s] and lost with a pair of Queens
Seat 2: BypVLsYQt3ePFm2xQL/dOA (button) (small blind) showed [Kd 3c] and won ($5.75) with two pair, Kings and Queens



PokerStars Game #59938875138:  Hold'em No Limit ($0.25/$0.50) - 2009/07/01 0:25:42 ET
Table '3FhG0gl3kMX3wBEEqj+wnQ' 9-max Seat #5 is the button
Seat 1: e0J9pdCNUDTCG031RnXqLA ($19.50 in chips)
Seat 2: 4dl3YNqZ6Houm2jZAzDmRg ($13.75 in chips)
Seat 3: HZkVla4kK2SI42CVrPZ/ig ($9.25 in chips)
Seat 4: bz4LMfV0GGl/MJ/ABXuPmg ($21.35 in chips)
Seat 5: XNMDwbXt/Q4jM99AXnbJDw ($54.80 in chips)
Seat 6: 5JJVDlaiMnB004o/RqbZZQ ($24 in chips)
Seat 7: mSD1pginDsyHG5PDfqzphw ($10 in chips)
Seat 8: j3K/Jujr7PY4ZM2RZvlH6A ($58.45 in chips)
Seat 9: L5e2lrPLQm1Pqx30IIZ/Fw ($10 in chips)
5JJVDlaiMnB004o/RqbZZQ: posts small blind $0.25
mSD1pginDsyHG5PDfqzphw: posts big blind $0.50
*** HOLE CARDS ***
j3K/Jujr7PY4ZM2RZvlH6A: raises $1 to $1.50
L5e2lrPLQm1Pqx30IIZ/Fw: folds
e0J9pdCNUDTCG031RnXqLA: folds
4dl3YNqZ6Houm2jZAzDmRg: folds
HZkVla4kK2SI42CVrPZ/ig: folds
bz4LMfV0GGl/MJ/ABXuPmg: folds
XNMDwbXt/Q4jM99AXnbJDw: folds
5JJVDlaiMnB004o/RqbZZQ: folds
mSD1pginDsyHG5PDfqzphw: folds
j3K/Jujr7PY4ZM2RZvlH6A collected $1.25 from pot
j3K/Jujr7PY4ZM2RZvlH6A: doesn't show hand
*** SUMMARY ***
Total pot $1.25 | Rake $0
Seat 1: e0J9pdCNUDTCG031RnXqLA folded before Flop (didn't bet)
Seat 2: 4dl3YNqZ6Houm2jZAzDmRg folded before Flop (didn't bet)
Seat 3: HZkVla4kK2SI42CVrPZ/ig folded before Flop (didn't bet)
Seat 4: bz4LMfV0GGl/MJ/ABXuPmg folded before Flop (didn't bet)
Seat 5: XNMDwbXt/Q4jM99AXnbJDw (button) folded before Flop (didn't bet)
Seat 6: 5JJVDlaiMnB004o/RqbZZQ (small blind) folded before Flop
Seat 7: mSD1pginDsyHG5PDfqzphw (big blind) folded before Flop
Seat 8: j3K/Jujr7PY4ZM2RZvlH6A collected ($1.25)
Seat 9: L5e2lrPLQm1Pqx30IIZ/Fw folded before Flop (didn't bet)



PokerStars Game #59938876258:  Hold'em No Limit ($0.25/$0.50) - 2009/07/01 0:25:43 ET
Table 'GfL/No5u5PoEnU39lP5pQg' 6-max Seat #3 is the button
Seat 1: 1WUCqNG+p+vfWRTXNu4ljw ($52.15 in chips)
Seat 2: uVwggSetzp7d+eVgowO3vg ($44.75 in chips)
Seat 3: qNezhXOOUXqwG7b9X5XJAA ($50 in chips)
Seat 4: OZ6OtYh5Y53MCH/p0QTn5g ($50 in chips)
Seat 5: crjGpJEzSZgD38FoE3VMGg ($54.30 in chips)
OZ6OtYh5Y53MCH/p0QTn5g: posts small blind $0.25
crjGpJEzSZgD38FoE3VMGg: posts big blind $0.50
*** HOLE CARDS ***
1WUCqNG+p+vfWRTXNu4ljw: folds
uVwggSetzp7d+eVgowO3vg: raises $1 to $1.50
qNezhXOOUXqwG7b9X5XJAA: folds
OZ6OtYh5Y53MCH/p0QTn5g: folds
crjGpJEzSZgD38FoE3VMGg: folds
uVwggSetzp7d+eVgowO3vg collected $1.25 from pot
uVwggSetzp7d+eVgowO3vg: doesn't show hand
*** SUMMARY ***
Total pot $1.25 | Rake $0
Seat 1: 1WUCqNG+p+vfWRTXNu4ljw folded before Flop (didn't bet)
Seat 2: uVwggSetzp7d+eVgowO3vg collected ($1.25)
Seat 3: qNezhXOOUXqwG7b9X5XJAA (button) folded before Flop (didn't bet)
Seat 4: OZ6OtYh5Y53MCH/p0QTn5g (small blind) folded before Flop
Seat 5: crjGpJEzSZgD38FoE3VMGg (big blind) folded before Flop



PokerStars Game #59938876396:  Hold'em No Limit ($0.25/$0.50) - 2009/07/01 0:25:43 ET
Table 'mTxf8gPLgffN3Iwfm7Icfg' 2-max Seat #1 is the button
Seat 1: Do9Rlu1R5u/AcRtMTl8SYg ($90.95 in chips)
Seat 2: EMc5LPgVaded4Qc77vm0fw ($69.60 in chips)
Do9Rlu1R5u/AcRtMTl8SYg: posts small blind $0.25
EMc5LPgVaded4Qc77vm0fw: posts big blind $0.50
*** HOLE CARDS ***
Do9Rlu1R5u/AcRtMTl8SYg: folds
EMc5LPgVaded4Qc77vm0fw collected $0.50 from pot
EMc5LPgVaded4Qc77vm0fw: doesn't show hand
*** SUMMARY ***
Total pot $0.50 | Rake $0
Seat 1: Do9Rlu1R5u/AcRtMTl8SYg (button) (small blind) folded before Flop
Seat 2: EMc5LPgVaded4Qc77vm0fw (big blind) collected ($0.50)



PokerStars Game #59938876588:  Hold'em No Limit ($0.25/$0.50) - 2009/07/01 0:25:44 ET
Table 'E7bWJ45aoFXRpyRv2gw+Ig' 2-max Seat #1 is the button
Seat 1: FRkiRasEGlHUeLrEl+k/nA ($64.50 in chips)
Seat 2: 3Wro85I7472vJ4Wkpneo9A ($113.75 in chips)
FRkiRasEGlHUeLrEl+k/nA: posts small blind $0.25
3Wro85I7472vJ4Wkpneo9A: posts big blind $0.50
*** HOLE CARDS ***
FRkiRasEGlHUeLrEl+k/nA: raises $1 to $1.50
3Wro85I7472vJ4Wkpneo9A: calls $1
*** FLOP *** [6s 9s 8h]
3Wro85I7472vJ4Wkpneo9A: bets $2
FRkiRasEGlHUeLrEl+k/nA: calls $2
*** TURN *** [6s 9s 8h] [9d]
3Wro85I7472vJ4Wkpneo9A: bets $4
FRkiRasEGlHUeLrEl+k/nA: folds
3Wro85I7472vJ4Wkpneo9A collected $6.70 from pot
3Wro85I7472vJ4Wkpneo9A: doesn't show hand
*** SUMMARY ***
Total pot $7 | Rake $0.30
Board [6s 9s 8h 9d]
Seat 1: FRkiRasEGlHUeLrEl+k/nA (button) (small blind) folded on the Turn
Seat 2: 3Wro85I7472vJ4Wkpneo9A (big blind) collected ($6.70)



PokerStars Game #59938876558:  Hold'em No Limit ($0.25/$0.50) - 2009/07/01 0:25:44 ET
Table 'MJxeZCzYELxiIsyUZyT0jw' 6-max Seat #6 is the button
Seat 1: wOyVV9M/oyiw3YaOjNZ05w ($50 in chips)
Seat 2: u4vYQZNWtIzOJre8fvCmvQ ($31.20 in chips)
Seat 3: JQZew0FjzS19kTjeNtrE+A ($50.10 in chips)
Seat 4: lP7Q6pewz4C2RsAfKsjdWw ($38.05 in chips)
Seat 5: 3jvoOXNtXE90w2BdfNZwZQ ($52.30 in chips)
Seat 6: TTx3CHxyi0SObcHyMJRp5w ($50 in chips)
wOyVV9M/oyiw3YaOjNZ05w: posts small blind $0.25
u4vYQZNWtIzOJre8fvCmvQ: posts big blind $0.50
*** HOLE CARDS ***
JQZew0FjzS19kTjeNtrE+A: folds
lP7Q6pewz4C2RsAfKsjdWw: folds
3jvoOXNtXE90w2BdfNZwZQ: folds
TTx3CHxyi0SObcHyMJRp5w: folds
wOyVV9M/oyiw3YaOjNZ05w: folds
u4vYQZNWtIzOJre8fvCmvQ collected $0.50 from pot
u4vYQZNWtIzOJre8fvCmvQ: shows [Kd As] (high card Ace)
*** SUMMARY ***
Total pot $0.50 | Rake $0
Seat 1: wOyVV9M/oyiw3YaOjNZ05w (small blind) folded before Flop
Seat 2: u4vYQZNWtIzOJre8fvCmvQ (big blind) collected ($0.50)
Seat 3: JQZew0FjzS19kTjeNtrE+A folded before Flop (didn't bet)
Seat 4: lP7Q6pewz4C2RsAfKsjdWw folded before Flop (didn't bet)
Seat 5: 3jvoOXNtXE90w2BdfNZwZQ folded before Flop (didn't bet)
Seat 6: TTx3CHxyi0SObcHyMJRp5w (button) folded before Flop (didn't bet)



PokerStars Game #59938878666:  Hold'em No Limit ($0.25/$0.50) - 2009/07/01 0:25:47 ET
Table 'eMxdLyFDf28E0wit6gm3Uw' 6-max Seat #2 is the button
Seat 1: tnD/64LagZ9qPaeOQVjVZg ($24.65 in chips)
Seat 2: jwuKQ1S3U4NnzMQn3E3dgw ($69.55 in chips)
Seat 3: dZcLsEI8iXkobBduRJ45Yw ($14.15 in chips)
Seat 4: QM93o65lI8kLzmiB/BILlA ($17.75 in chips)
Seat 5: X0X97o2fDAPiGx6o1gahsw ($56.35 in chips)
Seat 6: L0aIPg7qefDQjdJo3HCVEA ($8 in chips)
dZcLsEI8iXkobBduRJ45Yw: posts small blind $0.25
QM93o65lI8kLzmiB/BILlA: posts big blind $0.50
*** HOLE CARDS ***
X0X97o2fDAPiGx6o1gahsw: raises $1.75 to $2.25
L0aIPg7qefDQjdJo3HCVEA: folds
tnD/64LagZ9qPaeOQVjVZg: folds
jwuKQ1S3U4NnzMQn3E3dgw: folds
dZcLsEI8iXkobBduRJ45Yw: folds
QM93o65lI8kLzmiB/BILlA: calls $1.75
*** FLOP *** [7c 3d Ac]
QM93o65lI8kLzmiB/BILlA: bets $4
X0X97o2fDAPiGx6o1gahsw: folds
X0X97o2fDAPiGx6o1gahsw is sitting out
QM93o65lI8kLzmiB/BILlA collected $4.55 from pot
*** SUMMARY ***
Total pot $4.75 | Rake $0.20
Board [7c 3d Ac]
Seat 1: tnD/64LagZ9qPaeOQVjVZg folded before Flop (didn't bet)
Seat 2: jwuKQ1S3U4NnzMQn3E3dgw (button) folded before Flop (didn't bet)
Seat 3: dZcLsEI8iXkobBduRJ45Yw (small blind) folded before Flop
Seat 4: QM93o65lI8kLzmiB/BILlA (big blind) collected ($4.55)
Seat 5: X0X97o2fDAPiGx6o1gahsw folded on the Flop
Seat 6: L0aIPg7qefDQjdJo3HCVEA folded before Flop (didn't bet)



PokerStars Game #59938880138:  Hold'em No Limit ($0.25/$0.50) - 2009/07/01 0:25:49 ET
Table 'mTxf8gPLgffN3Iwfm7Icfg' 2-max Seat #2 is the button
Seat 1: Do9Rlu1R5u/AcRtMTl8SYg ($90.70 in chips)
Seat 2: EMc5LPgVaded4Qc77vm0fw ($69.85 in chips)
EMc5LPgVaded4Qc77vm0fw: posts small blind $0.25
Do9Rlu1R5u/AcRtMTl8SYg: posts big blind $0.50
*** HOLE CARDS ***
EMc5LPgVaded4Qc77vm0fw: folds
Do9Rlu1R5u/AcRtMTl8SYg collected $0.50 from pot
*** SUMMARY ***
Total pot $0.50 | Rake $0
Seat 1: Do9Rlu1R5u/AcRtMTl8SYg (big blind) collected ($0.50)
Seat 2: EMc5LPgVaded4Qc77vm0fw (button) (small blind) folded before Flop



PokerStars Game #59938880444:  Hold'em No Limit ($0.25/$0.50) - 2009/07/01 0:25:49 ET
Table 'EiNh8p/wGJ1FP575iMFnqg' 9-max Seat #9 is the button
Seat 1: r3ZqM1Mi0W3y4hOdssE+Sg ($27.20 in chips)
Seat 2: sSAA879uXOGR+8Mf3zLa6Q ($9.45 in chips)
Seat 4: HIIPkpiaCQfs5HcPKjlHvg ($40.70 in chips)
Seat 5: M+7+BTmX5vZatHVuoRB1nA ($78.65 in chips)
Seat 6: 3UmXLy3GfjC3EkOebduerQ ($56.60 in chips)
Seat 7: Wj7mKnRFR90j40wWUu2+Og ($77.80 in chips)
Seat 8: KrPAGRACBg+w0M//SXe8Ag ($16.30 in chips)
Seat 9: OMwFJ4pF0xk2Ru/AJiFeFw ($69.90 in chips)
r3ZqM1Mi0W3y4hOdssE+Sg: posts small blind $0.25
sSAA879uXOGR+8Mf3zLa6Q: posts big blind $0.50
ymLPoEIl7UL3TvZYmnadxQ: sits out
*** HOLE CARDS ***
HIIPkpiaCQfs5HcPKjlHvg: folds
M+7+BTmX5vZatHVuoRB1nA: folds
3UmXLy3GfjC3EkOebduerQ: folds
Wj7mKnRFR90j40wWUu2+Og: folds
KrPAGRACBg+w0M//SXe8Ag: calls $0.50
OMwFJ4pF0xk2Ru/AJiFeFw: folds
r3ZqM1Mi0W3y4hOdssE+Sg: calls $0.25
sSAA879uXOGR+8Mf3zLa6Q: checks
*** FLOP *** [6c 7c 9c]
r3ZqM1Mi0W3y4hOdssE+Sg: checks
sSAA879uXOGR+8Mf3zLa6Q: bets $1
KrPAGRACBg+w0M//SXe8Ag: calls $1
r3ZqM1Mi0W3y4hOdssE+Sg: folds
*** TURN *** [6c 7c 9c] [2s]
sSAA879uXOGR+8Mf3zLa6Q: bets $2
KrPAGRACBg+w0M//SXe8Ag: folds
sSAA879uXOGR+8Mf3zLa6Q collected $3.35 from pot
*** SUMMARY ***
Total pot $3.50 | Rake $0.15
Board [6c 7c 9c 2s]
Seat 1: r3ZqM1Mi0W3y4hOdssE+Sg (small blind) folded on the Flop
Seat 2: sSAA879uXOGR+8Mf3zLa6Q (big blind) collected ($3.35)
Seat 4: HIIPkpiaCQfs5HcPKjlHvg folded before Flop (didn't bet)
Seat 5: M+7+BTmX5vZatHVuoRB1nA folded before Flop (didn't bet)
Seat 6: 3UmXLy3GfjC3EkOebduerQ folded before Flop (didn't bet)
Seat 7: Wj7mKnRFR90j40wWUu2+Og folded before Flop (didn't bet)
Seat 8: KrPAGRACBg+w0M//SXe8Ag folded on the Turn
Seat 9: OMwFJ4pF0xk2Ru/AJiFeFw (button) folded before Flop (didn't bet)



PokerStars Game #59938880066:  Hold'em No Limit ($0.25/$0.50) - 2009/07/01 0:25:49 ET
Table '5EmHi+fnatGQQShcNmzOZQ' 6-max Seat #6 is the button
Seat 1: SwPczQo3cOtwEzhJrfO2cQ ($26.95 in chips)
Seat 3: L9qfLYXrczhAPd/VckgsWw ($58.85 in chips)
Seat 4: wOyVV9M/oyiw3YaOjNZ05w ($50.45 in chips)
Seat 5: kxPhs4ePFqMy52CInAJ2aw ($48 in chips)
Seat 6: 686aeHikcJlgKkSuIFdcXQ ($157.90 in chips)
SwPczQo3cOtwEzhJrfO2cQ: posts small blind $0.25
L9qfLYXrczhAPd/VckgsWw: posts big blind $0.50
*** HOLE CARDS ***
wOyVV9M/oyiw3YaOjNZ05w: folds
kxPhs4ePFqMy52CInAJ2aw: folds
686aeHikcJlgKkSuIFdcXQ: raises $1 to $1.50
SwPczQo3cOtwEzhJrfO2cQ: folds
L9qfLYXrczhAPd/VckgsWw: folds
686aeHikcJlgKkSuIFdcXQ collected $1.25 from pot
*** SUMMARY ***
Total pot $1.25 | Rake $0
Seat 1: SwPczQo3cOtwEzhJrfO2cQ (small blind) folded before Flop
Seat 3: L9qfLYXrczhAPd/VckgsWw (big blind) folded before Flop
Seat 4: wOyVV9M/oyiw3YaOjNZ05w folded before Flop (didn't bet)
Seat 5: kxPhs4ePFqMy52CInAJ2aw folded before Flop (didn't bet)
Seat 6: 686aeHikcJlgKkSuIFdcXQ (button) collected ($1.25)



PokerStars Game #59938882394:  Hold'em No Limit ($0.25/$0.50) - 2009/07/01 0:25:52 ET
Table '37qXEp3oe+er5q4CZip9eQ' 6-max Seat #6 is the button
Seat 1: oqOqoO2AyCZenUghCxMDxw ($50 in chips)
Seat 2: 6wzJiRvp8HY6t+MQGnSIzA ($20 in chips)
Seat 3: Rt6KgtZ8YaJoTc3FPim00w ($99.25 in chips)
Seat 5: VOmI0x4dDPnTESZd5B4d1Q ($45.25 in chips)
Seat 6: f7zPpUQp9hHZgqhEvrUWQw ($50 in chips)
oqOqoO2AyCZenUghCxMDxw: posts small blind $0.25
6wzJiRvp8HY6t+MQGnSIzA: posts big blind $0.50
*** HOLE CARDS ***
Rt6KgtZ8YaJoTc3FPim00w: folds
VOmI0x4dDPnTESZd5B4d1Q: folds
f7zPpUQp9hHZgqhEvrUWQw: raises $1 to $1.50
oqOqoO2AyCZenUghCxMDxw: folds
6wzJiRvp8HY6t+MQGnSIzA: raises $2.50 to $4
f7zPpUQp9hHZgqhEvrUWQw: folds
6wzJiRvp8HY6t+MQGnSIzA collected $3.25 from pot
*** SUMMARY ***
Total pot $3.25 | Rake $0
Seat 1: oqOqoO2AyCZenUghCxMDxw (small blind) folded before Flop
Seat 2: 6wzJiRvp8HY6t+MQGnSIzA (big blind) collected ($3.25)
Seat 3: Rt6KgtZ8YaJoTc3FPim00w folded before Flop (didn't bet)
Seat 5: VOmI0x4dDPnTESZd5B4d1Q folded before Flop (didn't bet)
Seat 6: f7zPpUQp9hHZgqhEvrUWQw (button) folded before Flop



PokerStars Game #59938883864:  Hold'em No Limit ($0.25/$0.50) - 2009/07/01 0:25:55 ET
Table 'mTxf8gPLgffN3Iwfm7Icfg' 2-max Seat #1 is the button
Seat 1: Do9Rlu1R5u/AcRtMTl8SYg ($90.95 in chips)
Seat 2: EMc5LPgVaded4Qc77vm0fw ($69.60 in chips)
Do9Rlu1R5u/AcRtMTl8SYg: posts small blind $0.25
EMc5LPgVaded4Qc77vm0fw: posts big blind $0.50
*** HOLE CARDS ***
Do9Rlu1R5u/AcRtMTl8SYg: folds
EMc5LPgVaded4Qc77vm0fw collected $0.50 from pot
EMc5LPgVaded4Qc77vm0fw: doesn't show hand
*** SUMMARY ***
Total pot $0.50 | Rake $0
Seat 1: Do9Rlu1R5u/AcRtMTl8SYg (button) (small blind) folded before Flop
Seat 2: EMc5LPgVaded4Qc77vm0fw (big blind) collected ($0.50)



PokerStars Game #59938885308:  Hold'em No Limit ($0.25/$0.50) - 2009/07/01 0:25:57 ET
Table 'MJxeZCzYELxiIsyUZyT0jw' 6-max Seat #1 is the button
Seat 1: wOyVV9M/oyiw3YaOjNZ05w ($50 in chips)
Seat 2: u4vYQZNWtIzOJre8fvCmvQ ($31.45 in chips)
Seat 3: JQZew0FjzS19kTjeNtrE+A ($50.10 in chips)
Seat 4: lP7Q6pewz4C2RsAfKsjdWw ($38.05 in chips)
Seat 5: 3jvoOXNtXE90w2BdfNZwZQ ($52.30 in chips)
Seat 6: TTx3CHxyi0SObcHyMJRp5w ($50 in chips)
u4vYQZNWtIzOJre8fvCmvQ: posts small blind $0.25
JQZew0FjzS19kTjeNtrE+A: posts big blind $0.50
*** HOLE CARDS ***
lP7Q6pewz4C2RsAfKsjdWw: folds
3jvoOXNtXE90w2BdfNZwZQ: folds
TTx3CHxyi0SObcHyMJRp5w: calls $0.50
wOyVV9M/oyiw3YaOjNZ05w: raises $0.75 to $1.25
u4vYQZNWtIzOJre8fvCmvQ: folds
JQZew0FjzS19kTjeNtrE+A: folds
TTx3CHxyi0SObcHyMJRp5w: calls $0.75
*** FLOP *** [Td Kd Kh]
TTx3CHxyi0SObcHyMJRp5w: checks
wOyVV9M/oyiw3YaOjNZ05w: bets $1.50
TTx3CHxyi0SObcHyMJRp5w: folds
u4vYQZNWtIzOJre8fvCmvQ leaves the table
wOyVV9M/oyiw3YaOjNZ05w collected $3.10 from pot
wOyVV9M/oyiw3YaOjNZ05w: doesn't show hand
*** SUMMARY ***
Total pot $3.25 | Rake $0.15
Board [Td Kd Kh]
Seat 1: wOyVV9M/oyiw3YaOjNZ05w (button) collected ($3.10)
Seat 2: u4vYQZNWtIzOJre8fvCmvQ (small blind) folded before Flop
Seat 3: JQZew0FjzS19kTjeNtrE+A (big blind) folded before Flop
Seat 4: lP7Q6pewz4C2RsAfKsjdWw folded before Flop (didn't bet)
Seat 5: 3jvoOXNtXE90w2BdfNZwZQ folded before Flop (didn't bet)
Seat 6: TTx3CHxyi0SObcHyMJRp5w folded on the Flop



PokerStars Game #59938885940:  Hold'em No Limit ($0.25/$0.50) - 2009/07/01 0:25:58 ET
Table 'ZYwMb9E6tY50Qm+iNbXRYw' 2-max Seat #2 is the button
Seat 1: DXLfRb8KDZWmrztw2bwtFw ($9.60 in chips)
Seat 2: 16tvT7AYgZ2LgiGFcvFKQg ($20.55 in chips)
16tvT7AYgZ2LgiGFcvFKQg: posts small blind $0.25
DXLfRb8KDZWmrztw2bwtFw: posts big blind $0.50
*** HOLE CARDS ***
16tvT7AYgZ2LgiGFcvFKQg: raises $0.50 to $1
DXLfRb8KDZWmrztw2bwtFw: calls $0.50
*** FLOP *** [2c 6h Kh]
DXLfRb8KDZWmrztw2bwtFw: bets $2
16tvT7AYgZ2LgiGFcvFKQg: folds
DXLfRb8KDZWmrztw2bwtFw collected $1.90 from pot
DXLfRb8KDZWmrztw2bwtFw: doesn't show hand
*** SUMMARY ***
Total pot $2 | Rake $0.10
Board [2c 6h Kh]
Seat 1: DXLfRb8KDZWmrztw2bwtFw (big blind) collected ($1.90)
Seat 2: 16tvT7AYgZ2LgiGFcvFKQg (button) (small blind) folded on the Flop



PokerStars Game #59938886364:  Hold'em No Limit ($0.25/$0.50) - 2009/07/01 0:25:58 ET
Table 'IeNZOZQ4T6oiaHqFeo6yIA' 2-max Seat #1 is the button
Seat 1: ndd1nfncBkWNitBnsfCoVQ ($87.60 in chips)
Seat 2: A91IUl5JaZROhtfCtnnwYw ($46.30 in chips)
ndd1nfncBkWNitBnsfCoVQ: posts small blind $0.25
A91IUl5JaZROhtfCtnnwYw: posts big blind $0.50
*** HOLE CARDS ***
ndd1nfncBkWNitBnsfCoVQ: raises $1 to $1.50
A91IUl5JaZROhtfCtnnwYw: calls $1
*** FLOP *** [7d 4d 9s]
A91IUl5JaZROhtfCtnnwYw: checks
ndd1nfncBkWNitBnsfCoVQ: bets $2
A91IUl5JaZROhtfCtnnwYw: calls $2
*** TURN *** [7d 4d 9s] [Ks]
A91IUl5JaZROhtfCtnnwYw: checks
ndd1nfncBkWNitBnsfCoVQ: checks
*** RIVER *** [7d 4d 9s Ks] [Qc]
A91IUl5JaZROhtfCtnnwYw: checks
ndd1nfncBkWNitBnsfCoVQ: bets $5
A91IUl5JaZROhtfCtnnwYw: folds
ndd1nfncBkWNitBnsfCoVQ collected $6.70 from pot
ndd1nfncBkWNitBnsfCoVQ: doesn't show hand
*** SUMMARY ***
Total pot $7 | Rake $0.30
Board [7d 4d 9s Ks Qc]
Seat 1: ndd1nfncBkWNitBnsfCoVQ (button) (small blind) collected ($6.70)
Seat 2: A91IUl5JaZROhtfCtnnwYw (big blind) folded on the River



PokerStars Game #59938886430:  Hold'em No Limit ($0.25/$0.50) - 2009/07/01 0:25:58 ET
Table 'Nz0Vr7WMHL2g5Uk7dDZjpw' 9-max Seat #6 is the button
Seat 2: XNMDwbXt/Q4jM99AXnbJDw ($50 in chips)
Seat 3: 4QTiNH5fteLgJjx/s6Hy6A ($21.40 in chips)
Seat 4: 5JJVDlaiMnB004o/RqbZZQ ($28.50 in chips)
Seat 5: WGW0DgjBUXs1ylURHG8vnQ ($11.75 in chips)
Seat 6: k1f0lS7tlMHCLGs0JT34Tg ($9.25 in chips)
Seat 7: KPLH0gELgFe2OuAnhJFI5w ($19.20 in chips)
Seat 8: HkZI6g4zl83TDTA7SRspmQ ($19.95 in chips)
Seat 9: Ak2W6V2TDVIQrvSAy4eD7Q ($25.35 in chips)
KPLH0gELgFe2OuAnhJFI5w: posts small blind $0.25
HkZI6g4zl83TDTA7SRspmQ: posts big blind $0.50
tLkxo7JgV+WWI0UBw44K5A has timed out while disconnected
tLkxo7JgV+WWI0UBw44K5A: is sitting out
*** HOLE CARDS ***
Ak2W6V2TDVIQrvSAy4eD7Q: folds
XNMDwbXt/Q4jM99AXnbJDw: folds
4QTiNH5fteLgJjx/s6Hy6A: calls $0.50
5JJVDlaiMnB004o/RqbZZQ: folds
WGW0DgjBUXs1ylURHG8vnQ: calls $0.50
k1f0lS7tlMHCLGs0JT34Tg: calls $0.50
KPLH0gELgFe2OuAnhJFI5w: calls $0.25
HkZI6g4zl83TDTA7SRspmQ: checks
*** FLOP *** [3s Jd 7h]
KPLH0gELgFe2OuAnhJFI5w: checks
HkZI6g4zl83TDTA7SRspmQ: checks
4QTiNH5fteLgJjx/s6Hy6A: bets $1.50
WGW0DgjBUXs1ylURHG8vnQ: calls $1.50
k1f0lS7tlMHCLGs0JT34Tg: folds
KPLH0gELgFe2OuAnhJFI5w: folds
HkZI6g4zl83TDTA7SRspmQ: folds
*** TURN *** [3s Jd 7h] [2d]
4QTiNH5fteLgJjx/s6Hy6A: checks
WGW0DgjBUXs1ylURHG8vnQ: bets $1
4QTiNH5fteLgJjx/s6Hy6A: calls $1
*** RIVER *** [3s Jd 7h 2d] [7d]
4QTiNH5fteLgJjx/s6Hy6A: checks
WGW0DgjBUXs1ylURHG8vnQ: checks
*** SHOW DOWN ***
4QTiNH5fteLgJjx/s6Hy6A: shows [8c Qh] (a pair of Sevens)
WGW0DgjBUXs1ylURHG8vnQ: shows [Ah Qs] (a pair of Sevens - Ace kicker)
WGW0DgjBUXs1ylURHG8vnQ collected $7.15 from pot
*** SUMMARY ***
Total pot $7.50 | Rake $0.35
Board [3s Jd 7h 2d 7d]
Seat 2: XNMDwbXt/Q4jM99AXnbJDw folded before Flop (didn't bet)
Seat 3: 4QTiNH5fteLgJjx/s6Hy6A showed [8c Qh] and lost with a pair of Sevens
Seat 4: 5JJVDlaiMnB004o/RqbZZQ folded before Flop (didn't bet)
Seat 5: WGW0DgjBUXs1ylURHG8vnQ showed [Ah Qs] and won ($7.15) with a pair of Sevens
Seat 6: k1f0lS7tlMHCLGs0JT34Tg (button) folded on the Flop
Seat 7: KPLH0gELgFe2OuAnhJFI5w (small blind) folded on the Flop
Seat 8: HkZI6g4zl83TDTA7SRspmQ (big blind) folded on the Flop
Seat 9: Ak2W6V2TDVIQrvSAy4eD7Q folded before Flop (didn't bet)



PokerStars Game #59938886070:  Hold'em No Limit ($0.25/$0.50) - 2009/07/01 0:25:58 ET
Table 'hSTs/dUsYLgJQuF2Onp0MQ' 6-max Seat #2 is the button
Seat 1: Donj3X7gYzeS5pAl7s9f+Q ($31.20 in chips)
Seat 2: 6vNxrjjCl6FwfaaymM9jjg ($23.65 in chips)
Seat 4: L0aIPg7qefDQjdJo3HCVEA ($9.50 in chips)
Seat 5: 686aeHikcJlgKkSuIFdcXQ ($59.35 in chips)
Seat 6: +laPa9P7BjZKKnR0n+OmvA ($9.70 in chips)
C3qJBo7uxfFVDluE1lmK2w will be allowed to play after the button
L0aIPg7qefDQjdJo3HCVEA: posts small blind $0.25
686aeHikcJlgKkSuIFdcXQ: posts big blind $0.50
*** HOLE CARDS ***
+laPa9P7BjZKKnR0n+OmvA: folds
Donj3X7gYzeS5pAl7s9f+Q: raises $1.50 to $2
6vNxrjjCl6FwfaaymM9jjg: folds
L0aIPg7qefDQjdJo3HCVEA: folds
686aeHikcJlgKkSuIFdcXQ: folds
Donj3X7gYzeS5pAl7s9f+Q collected $1.25 from pot
*** SUMMARY ***
Total pot $1.25 | Rake $0
Seat 1: Donj3X7gYzeS5pAl7s9f+Q collected ($1.25)
Seat 2: 6vNxrjjCl6FwfaaymM9jjg (button) folded before Flop (didn't bet)
Seat 4: L0aIPg7qefDQjdJo3HCVEA (small blind) folded before Flop
Seat 5: 686aeHikcJlgKkSuIFdcXQ (big blind) folded before Flop
Seat 6: +laPa9P7BjZKKnR0n+OmvA folded before Flop (didn't bet)



PokerStars Game #59938887530:  Hold'em No Limit ($0.25/$0.50) - 2009/07/01 0:26:00 ET
Table 'otvGDROEDdqsabxskT79qg' 9-max Seat #9 is the button
Seat 1: 8ehL7qlZzjgUh2H35iiWLw ($50 in chips)
Seat 2: cCjTzH9jio8607WzjcfXlg ($12.30 in chips)
Seat 3: +k7T5ocke8UwavtgUHm+Cg ($75.70 in chips)
Seat 4: MG90wfSJZnOejs/KD3vlQQ ($51.80 in chips)
Seat 5: XNMDwbXt/Q4jM99AXnbJDw ($50 in chips)
Seat 7: C7+tBppJrKgd/r+tuKUIpA ($42.65 in chips)
Seat 9: KcY3X8YpD74Kw1RHkx/g4A ($63.60 in chips)
8ehL7qlZzjgUh2H35iiWLw: posts small blind $0.25
cCjTzH9jio8607WzjcfXlg: posts big blind $0.50
bxLSulbgr8LmKNjOzw8URg: sits out
zE9cVigS2nW/Ljy4K4bUQA: sits out
*** HOLE CARDS ***
+k7T5ocke8UwavtgUHm+Cg: folds
MG90wfSJZnOejs/KD3vlQQ: folds
XNMDwbXt/Q4jM99AXnbJDw: raises $1.50 to $2
C7+tBppJrKgd/r+tuKUIpA: calls $2
KcY3X8YpD74Kw1RHkx/g4A: calls $2
8ehL7qlZzjgUh2H35iiWLw: folds
cCjTzH9jio8607WzjcfXlg: folds
*** FLOP *** [9h Qc 6c]
XNMDwbXt/Q4jM99AXnbJDw: checks
C7+tBppJrKgd/r+tuKUIpA: checks
KcY3X8YpD74Kw1RHkx/g4A: checks
*** TURN *** [9h Qc 6c] [5c]
XNMDwbXt/Q4jM99AXnbJDw: checks
C7+tBppJrKgd/r+tuKUIpA: checks
KcY3X8YpD74Kw1RHkx/g4A: checks
*** RIVER *** [9h Qc 6c 5c] [5h]
XNMDwbXt/Q4jM99AXnbJDw: checks
C7+tBppJrKgd/r+tuKUIpA: checks
KcY3X8YpD74Kw1RHkx/g4A: checks
*** SHOW DOWN ***
XNMDwbXt/Q4jM99AXnbJDw: shows [4s 4c] (two pair, Fives and Fours)
C7+tBppJrKgd/r+tuKUIpA: mucks hand
KcY3X8YpD74Kw1RHkx/g4A: mucks hand
XNMDwbXt/Q4jM99AXnbJDw collected $6.45 from pot
*** SUMMARY ***
Total pot $6.75 | Rake $0.30
Board [9h Qc 6c 5c 5h]
Seat 1: 8ehL7qlZzjgUh2H35iiWLw (small blind) folded before Flop
Seat 2: cCjTzH9jio8607WzjcfXlg (big blind) folded before Flop
Seat 3: +k7T5ocke8UwavtgUHm+Cg folded before Flop (didn't bet)
Seat 4: MG90wfSJZnOejs/KD3vlQQ folded before Flop (didn't bet)
Seat 5: XNMDwbXt/Q4jM99AXnbJDw showed [4s 4c] and won ($6.45) with two pair, Fives and Fours
Seat 7: C7+tBppJrKgd/r+tuKUIpA mucked
Seat 9: KcY3X8YpD74Kw1RHkx/g4A (button) mucked



PokerStars Game #59938888258:  Hold'em No Limit ($0.25/$0.50) - 2009/07/01 0:26:01 ET
Table 'mTxf8gPLgffN3Iwfm7Icfg' 2-max Seat #2 is the button
Seat 1: Do9Rlu1R5u/AcRtMTl8SYg ($90.70 in chips)
Seat 2: EMc5LPgVaded4Qc77vm0fw ($69.85 in chips)
EMc5LPgVaded4Qc77vm0fw: posts small blind $0.25
Do9Rlu1R5u/AcRtMTl8SYg: posts big blind $0.50
*** HOLE CARDS ***
EMc5LPgVaded4Qc77vm0fw: raises $1.50 to $2
Do9Rlu1R5u/AcRtMTl8SYg: raises $5 to $7
EMc5LPgVaded4Qc77vm0fw: calls $5
*** FLOP *** [6c Qc 8s]
Do9Rlu1R5u/AcRtMTl8SYg: checks
EMc5LPgVaded4Qc77vm0fw: checks
*** TURN *** [6c Qc 8s] [9h]
Do9Rlu1R5u/AcRtMTl8SYg: checks
EMc5LPgVaded4Qc77vm0fw: checks
*** RIVER *** [6c Qc 8s 9h] [2h]
Do9Rlu1R5u/AcRtMTl8SYg: checks
EMc5LPgVaded4Qc77vm0fw: checks
*** SHOW DOWN ***
Do9Rlu1R5u/AcRtMTl8SYg: shows [Td Ts] (a pair of Tens)
EMc5LPgVaded4Qc77vm0fw: mucks hand
Do9Rlu1R5u/AcRtMTl8SYg collected $13.50 from pot
*** SUMMARY ***
Total pot $14 | Rake $0.50
Board [6c Qc 8s 9h 2h]
Seat 1: Do9Rlu1R5u/AcRtMTl8SYg (big blind) showed [Td Ts] and won ($13.50) with a pair of Tens
Seat 2: EMc5LPgVaded4Qc77vm0fw (button) (small blind) mucked



PokerStars Game #59938889046:  Hold'em No Limit ($0.25/$0.50) - 2009/07/01 0:26:02 ET
Table 'QOgaEqMcJ73pcUMMxoisUg' 6-max Seat #2 is the button
Seat 1: UaC1G3O4HWbowgSfeYnkog ($8.75 in chips)
Seat 2: Im2p1Nt83UKSqv5c9frm4Q ($50 in chips)
Seat 3: wUZNozoIDYf+16hp4nn6dw ($34.60 in chips)
Seat 4: zAcsDhG/T128Vn7XGVSgKg ($61.80 in chips)
Seat 5: 6vNxrjjCl6FwfaaymM9jjg ($28.25 in chips)
Seat 6: s83dnhZ6VC53vY0/f6OV/g ($42.35 in chips)
wUZNozoIDYf+16hp4nn6dw: posts small blind $0.25
zAcsDhG/T128Vn7XGVSgKg: posts big blind $0.50
*** HOLE CARDS ***
6vNxrjjCl6FwfaaymM9jjg: calls $0.50
s83dnhZ6VC53vY0/f6OV/g: folds
UaC1G3O4HWbowgSfeYnkog: calls $0.50
Im2p1Nt83UKSqv5c9frm4Q: folds
wUZNozoIDYf+16hp4nn6dw: calls $0.25
zAcsDhG/T128Vn7XGVSgKg: checks
*** FLOP *** [3s 3d 3c]
wUZNozoIDYf+16hp4nn6dw: checks
zAcsDhG/T128Vn7XGVSgKg: checks
6vNxrjjCl6FwfaaymM9jjg: checks
UaC1G3O4HWbowgSfeYnkog: checks
*** TURN *** [3s 3d 3c] [Jc]
wUZNozoIDYf+16hp4nn6dw: bets $1.50
zAcsDhG/T128Vn7XGVSgKg: folds
6vNxrjjCl6FwfaaymM9jjg: raises $5 to $6.50
UaC1G3O4HWbowgSfeYnkog: folds
wUZNozoIDYf+16hp4nn6dw: folds
6vNxrjjCl6FwfaaymM9jjg collected $4.80 from pot
*** SUMMARY ***
Total pot $5 | Rake $0.20
Board [3s 3d 3c Jc]
Seat 1: UaC1G3O4HWbowgSfeYnkog folded on the Turn
Seat 2: Im2p1Nt83UKSqv5c9frm4Q (button) folded before Flop (didn't bet)
Seat 3: wUZNozoIDYf+16hp4nn6dw (small blind) folded on the Turn
Seat 4: zAcsDhG/T128Vn7XGVSgKg (big blind) folded on the Turn
Seat 5: 6vNxrjjCl6FwfaaymM9jjg collected ($4.80)
Seat 6: s83dnhZ6VC53vY0/f6OV/g folded before Flop (didn't bet)



PokerStars Game #59938890162:  Hold'em No Limit ($0.25/$0.50) - 2009/07/01 0:26:04 ET
Table '+z1aekfHkpp09pc8F9aViw' 6-max Seat #6 is the button
Seat 1: wOyVV9M/oyiw3YaOjNZ05w ($52.80 in chips)
Seat 2: M6xK/VklCvdyyrmvzATlxQ ($29.95 in chips)
Seat 3: uUznlIMFnRUvwrBhYF73KA ($63.25 in chips)
Seat 4: RowCSpSURHTOL/dcjg/Iug ($47.70 in chips)
Seat 5: crjGpJEzSZgD38FoE3VMGg ($59.15 in chips)
Seat 6: 686aeHikcJlgKkSuIFdcXQ ($70.10 in chips)
wOyVV9M/oyiw3YaOjNZ05w: posts small blind $0.25
M6xK/VklCvdyyrmvzATlxQ: posts big blind $0.50
*** HOLE CARDS ***
uUznlIMFnRUvwrBhYF73KA: calls $0.50
RowCSpSURHTOL/dcjg/Iug: raises $1 to $1.50
crjGpJEzSZgD38FoE3VMGg: folds
686aeHikcJlgKkSuIFdcXQ: folds
wOyVV9M/oyiw3YaOjNZ05w: folds
M6xK/VklCvdyyrmvzATlxQ: calls $1
uUznlIMFnRUvwrBhYF73KA: calls $1
*** FLOP *** [Qd 5h Ad]
M6xK/VklCvdyyrmvzATlxQ: checks
uUznlIMFnRUvwrBhYF73KA: checks
RowCSpSURHTOL/dcjg/Iug: bets $1
M6xK/VklCvdyyrmvzATlxQ: calls $1
uUznlIMFnRUvwrBhYF73KA: calls $1
*** TURN *** [Qd 5h Ad] [5d]
M6xK/VklCvdyyrmvzATlxQ: checks
uUznlIMFnRUvwrBhYF73KA: checks
RowCSpSURHTOL/dcjg/Iug: bets $2
M6xK/VklCvdyyrmvzATlxQ: calls $2
uUznlIMFnRUvwrBhYF73KA: calls $2
*** RIVER *** [Qd 5h Ad 5d] [6d]
M6xK/VklCvdyyrmvzATlxQ: bets $3
uUznlIMFnRUvwrBhYF73KA: folds
RowCSpSURHTOL/dcjg/Iug: folds
M6xK/VklCvdyyrmvzATlxQ collected $13.10 from pot
*** SUMMARY ***
Total pot $13.75 | Rake $0.65
Board [Qd 5h Ad 5d 6d]
Seat 1: wOyVV9M/oyiw3YaOjNZ05w (small blind) folded before Flop
Seat 2: M6xK/VklCvdyyrmvzATlxQ (big blind) collected ($13.10)
Seat 3: uUznlIMFnRUvwrBhYF73KA folded on the River
Seat 4: RowCSpSURHTOL/dcjg/Iug folded on the River
Seat 5: crjGpJEzSZgD38FoE3VMGg folded before Flop (didn't bet)
Seat 6: 686aeHikcJlgKkSuIFdcXQ (button) folded before Flop (didn't bet)



PokerStars Game #59938890726:  Hold'em No Limit ($0.25/$0.50) - 2009/07/01 0:26:05 ET
Table 'NCiXr0d5CEKBQr/cZgLhbA' 9-max Seat #5 is the button
Seat 1: RjBdQ6w31rgcy0o24VLR6w ($15.85 in chips)
Seat 2: ulxuJchBV9iguXg0FUonfg ($33.55 in chips)
Seat 3: xZCXQSXlrZkp3pZizzVXCw ($56.90 in chips)
Seat 4: 5k9fvXD9suIgCxU4HLQjTw ($50 in chips)
Seat 5: zE9cVigS2nW/Ljy4K4bUQA ($39.50 in chips)
Seat 6: SKnJuWHScqetA/qG5p+wCg ($30 in chips)
Seat 7: M+7+BTmX5vZatHVuoRB1nA ($49.25 in chips)
Seat 8: 1MJUKc3cc0QmUoz1JZLR2w ($54.35 in chips)
SKnJuWHScqetA/qG5p+wCg: posts small blind $0.25
M+7+BTmX5vZatHVuoRB1nA: posts big blind $0.50
4WLZvqBn5qv5tds5kt5A1Q: sits out
5k9fvXD9suIgCxU4HLQjTw: posts big blind $0.50
*** HOLE CARDS ***
1MJUKc3cc0QmUoz1JZLR2w: calls $0.50
RjBdQ6w31rgcy0o24VLR6w: folds
ulxuJchBV9iguXg0FUonfg: calls $0.50
xZCXQSXlrZkp3pZizzVXCw: folds
5k9fvXD9suIgCxU4HLQjTw: checks
zE9cVigS2nW/Ljy4K4bUQA: folds
SKnJuWHScqetA/qG5p+wCg: folds
M+7+BTmX5vZatHVuoRB1nA: checks
*** FLOP *** [4s 9s 6s]
M+7+BTmX5vZatHVuoRB1nA: checks
1MJUKc3cc0QmUoz1JZLR2w: checks
ulxuJchBV9iguXg0FUonfg: bets $1
5k9fvXD9suIgCxU4HLQjTw: folds
M+7+BTmX5vZatHVuoRB1nA: folds
1MJUKc3cc0QmUoz1JZLR2w: folds
ulxuJchBV9iguXg0FUonfg collected $2.15 from pot
*** SUMMARY ***
Total pot $2.25 | Rake $0.10
Board [4s 9s 6s]
Seat 1: RjBdQ6w31rgcy0o24VLR6w folded before Flop (didn't bet)
Seat 2: ulxuJchBV9iguXg0FUonfg collected ($2.15)
Seat 3: xZCXQSXlrZkp3pZizzVXCw folded before Flop (didn't bet)
Seat 4: 5k9fvXD9suIgCxU4HLQjTw folded on the Flop
Seat 5: zE9cVigS2nW/Ljy4K4bUQA (button) folded before Flop (didn't bet)
Seat 6: SKnJuWHScqetA/qG5p+wCg (small blind) folded before Flop
Seat 7: M+7+BTmX5vZatHVuoRB1nA (big blind) folded on the Flop
Seat 8: 1MJUKc3cc0QmUoz1JZLR2w folded on the Flop



PokerStars Game #59938890754:  Hold'em No Limit ($0.25/$0.50) - 2009/07/01 0:26:05 ET
Table '5EmHi+fnatGQQShcNmzOZQ' 6-max Seat #1 is the button
Seat 1: SwPczQo3cOtwEzhJrfO2cQ ($26.70 in chips)
Seat 3: L9qfLYXrczhAPd/VckgsWw ($58.35 in chips)
Seat 4: wOyVV9M/oyiw3YaOjNZ05w ($50.45 in chips)
Seat 5: kxPhs4ePFqMy52CInAJ2aw ($48 in chips)
Seat 6: 686aeHikcJlgKkSuIFdcXQ ($158.65 in chips)
L9qfLYXrczhAPd/VckgsWw: posts small blind $0.25
wOyVV9M/oyiw3YaOjNZ05w: posts big blind $0.50
*** HOLE CARDS ***
kxPhs4ePFqMy52CInAJ2aw has timed out
kxPhs4ePFqMy52CInAJ2aw: folds
kxPhs4ePFqMy52CInAJ2aw is sitting out
686aeHikcJlgKkSuIFdcXQ: folds
SwPczQo3cOtwEzhJrfO2cQ: folds
L9qfLYXrczhAPd/VckgsWw: calls $0.25
kxPhs4ePFqMy52CInAJ2aw has returned
wOyVV9M/oyiw3YaOjNZ05w: checks
*** FLOP *** [Th 6c Td]
L9qfLYXrczhAPd/VckgsWw: bets $1
wOyVV9M/oyiw3YaOjNZ05w: folds
L9qfLYXrczhAPd/VckgsWw collected $0.95 from pot
L9qfLYXrczhAPd/VckgsWw: doesn't show hand
*** SUMMARY ***
Total pot $1 | Rake $0.05
Board [Th 6c Td]
Seat 1: SwPczQo3cOtwEzhJrfO2cQ (button) folded before Flop (didn't bet)
Seat 3: L9qfLYXrczhAPd/VckgsWw (small blind) collected ($0.95)
Seat 4: wOyVV9M/oyiw3YaOjNZ05w (big blind) folded on the Flop
Seat 5: kxPhs4ePFqMy52CInAJ2aw folded before Flop (didn't bet)
Seat 6: 686aeHikcJlgKkSuIFdcXQ folded before Flop (didn't bet)



PokerStars Game #59938891102:  Hold'em No Limit ($0.25/$0.50) - 2009/07/01 0:26:05 ET
Table 'lSisgp6H7Fg1hH5VfjEjYQ' 9-max Seat #6 is the button
Seat 1: pEW8B6uXbdR47kfljMQ3+Q ($40.60 in chips)
Seat 2: UrcnkQOiLVk8BlKDPJSy7Q ($50.35 in chips)
Seat 3: aTkyjTh3w5YLWiIERupZOA ($39.40 in chips)
Seat 4: bwv/rbH/hHhPhY6u9mu04w ($24.25 in chips)
Seat 5: mSD1pginDsyHG5PDfqzphw ($10.20 in chips)
Seat 6: +k7T5ocke8UwavtgUHm+Cg ($25.85 in chips)
Seat 7: dGw5MBstXyXhWHHVFOWOFA ($42.25 in chips)
Seat 8: a4JDWmpFQkL10XfAyuF51A ($34.55 in chips)
Seat 9: 5JJVDlaiMnB004o/RqbZZQ ($40.50 in chips)
dGw5MBstXyXhWHHVFOWOFA: posts small blind $0.25
a4JDWmpFQkL10XfAyuF51A: posts big blind $0.50
*** HOLE CARDS ***
5JJVDlaiMnB004o/RqbZZQ: folds
pEW8B6uXbdR47kfljMQ3+Q: calls $0.50
UrcnkQOiLVk8BlKDPJSy7Q: folds
aTkyjTh3w5YLWiIERupZOA: folds
bwv/rbH/hHhPhY6u9mu04w: folds
mSD1pginDsyHG5PDfqzphw: raises $1.50 to $2
+k7T5ocke8UwavtgUHm+Cg: folds
dGw5MBstXyXhWHHVFOWOFA: folds
a4JDWmpFQkL10XfAyuF51A: calls $1.50
pEW8B6uXbdR47kfljMQ3+Q: calls $1.50
*** FLOP *** [Qs 5h 4h]
a4JDWmpFQkL10XfAyuF51A: checks
pEW8B6uXbdR47kfljMQ3+Q: checks
mSD1pginDsyHG5PDfqzphw: checks
*** TURN *** [Qs 5h 4h] [2s]
a4JDWmpFQkL10XfAyuF51A: checks
pEW8B6uXbdR47kfljMQ3+Q: checks
mSD1pginDsyHG5PDfqzphw: checks
*** RIVER *** [Qs 5h 4h 2s] [3c]
a4JDWmpFQkL10XfAyuF51A: checks
pEW8B6uXbdR47kfljMQ3+Q: checks
mSD1pginDsyHG5PDfqzphw: checks
*** SHOW DOWN ***
a4JDWmpFQkL10XfAyuF51A: shows [6d 4d] (a straight, Deuce to Six)
pEW8B6uXbdR47kfljMQ3+Q: mucks hand
mSD1pginDsyHG5PDfqzphw: mucks hand
a4JDWmpFQkL10XfAyuF51A collected $5.95 from pot
*** SUMMARY ***
Total pot $6.25 | Rake $0.30
Board [Qs 5h 4h 2s 3c]
Seat 1: pEW8B6uXbdR47kfljMQ3+Q mucked
Seat 2: UrcnkQOiLVk8BlKDPJSy7Q folded before Flop (didn't bet)
Seat 3: aTkyjTh3w5YLWiIERupZOA folded before Flop (didn't bet)
Seat 4: bwv/rbH/hHhPhY6u9mu04w folded before Flop (didn't bet)
Seat 5: mSD1pginDsyHG5PDfqzphw mucked
Seat 6: +k7T5ocke8UwavtgUHm+Cg (button) folded before Flop (didn't bet)
Seat 7: dGw5MBstXyXhWHHVFOWOFA (small blind) folded before Flop
Seat 8: a4JDWmpFQkL10XfAyuF51A (big blind) showed [6d 4d] and won ($5.95) with a straight, Deuce to Six
Seat 9: 5JJVDlaiMnB004o/RqbZZQ folded before Flop (didn't bet)



PokerStars Game #59938891332:  Hold'em No Limit ($0.25/$0.50) - 2009/07/01 0:26:06 ET
Table 'GfL/No5u5PoEnU39lP5pQg' 6-max Seat #4 is the button
Seat 1: 1WUCqNG+p+vfWRTXNu4ljw ($52.15 in chips)
Seat 2: uVwggSetzp7d+eVgowO3vg ($45.50 in chips)
Seat 3: qNezhXOOUXqwG7b9X5XJAA ($50 in chips)
Seat 4: OZ6OtYh5Y53MCH/p0QTn5g ($50 in chips)
Seat 5: crjGpJEzSZgD38FoE3VMGg ($53.80 in chips)
crjGpJEzSZgD38FoE3VMGg: posts small blind $0.25
1WUCqNG+p+vfWRTXNu4ljw: posts big blind $0.50
*** HOLE CARDS ***
uVwggSetzp7d+eVgowO3vg: folds
qNezhXOOUXqwG7b9X5XJAA: folds
OZ6OtYh5Y53MCH/p0QTn5g: raises $1 to $1.50
crjGpJEzSZgD38FoE3VMGg: folds
1WUCqNG+p+vfWRTXNu4ljw: folds
OZ6OtYh5Y53MCH/p0QTn5g collected $1.25 from pot
OZ6OtYh5Y53MCH/p0QTn5g: doesn't show hand
*** SUMMARY ***
Total pot $1.25 | Rake $0
Seat 1: 1WUCqNG+p+vfWRTXNu4ljw (big blind) folded before Flop
Seat 2: uVwggSetzp7d+eVgowO3vg folded before Flop (didn't bet)
Seat 3: qNezhXOOUXqwG7b9X5XJAA folded before Flop (didn't bet)
Seat 4: OZ6OtYh5Y53MCH/p0QTn5g (button) collected ($1.25)
Seat 5: crjGpJEzSZgD38FoE3VMGg (small blind) folded before Flop



PokerStars Game #59938892352:  Hold'em No Limit ($0.25/$0.50) - 2009/07/01 0:26:07 ET
Table 'kgbJRsxfv64KrErDRBAkcw' 6-max Seat #2 is the button
Seat 1: N7O9jUEx2YiQn1+yRYTHmw ($16.15 in chips)
Seat 2: Q+thC23WCv1kJUJtH/+4Jw ($67.15 in chips)
Seat 3: T0Gx/FcQ5VH9u7XaOMX97A ($61.85 in chips)
Seat 4: qanMEqjABjWxC/JgQ/0l7w ($59.95 in chips)
Seat 5: +Pf9jTVizYlIo+woPvptfA ($50 in chips)
Seat 6: ozrlafxxh1HmYdA0/h+MuA ($6 in chips)
T0Gx/FcQ5VH9u7XaOMX97A: posts small blind $0.25
qanMEqjABjWxC/JgQ/0l7w: posts big blind $0.50
*** HOLE CARDS ***
+Pf9jTVizYlIo+woPvptfA: folds
ozrlafxxh1HmYdA0/h+MuA: folds
N7O9jUEx2YiQn1+yRYTHmw: calls $0.50
Q+thC23WCv1kJUJtH/+4Jw: folds
T0Gx/FcQ5VH9u7XaOMX97A: folds
qanMEqjABjWxC/JgQ/0l7w: checks
*** FLOP *** [4s Ad 5h]
qanMEqjABjWxC/JgQ/0l7w: checks
N7O9jUEx2YiQn1+yRYTHmw: bets $1
qanMEqjABjWxC/JgQ/0l7w: folds
N7O9jUEx2YiQn1+yRYTHmw collected $1.20 from pot
N7O9jUEx2YiQn1+yRYTHmw: doesn't show hand
*** SUMMARY ***
Total pot $1.25 | Rake $0.05
Board [4s Ad 5h]
Seat 1: N7O9jUEx2YiQn1+yRYTHmw collected ($1.20)
Seat 2: Q+thC23WCv1kJUJtH/+4Jw (button) folded before Flop (didn't bet)
Seat 3: T0Gx/FcQ5VH9u7XaOMX97A (small blind) folded before Flop
Seat 4: qanMEqjABjWxC/JgQ/0l7w (big blind) folded on the Flop
Seat 5: +Pf9jTVizYlIo+woPvptfA folded before Flop (didn't bet)
Seat 6: ozrlafxxh1HmYdA0/h+MuA folded before Flop (didn't bet)



PokerStars Game #59938893794:  Hold'em No Limit ($0.25/$0.50) - 2009/07/01 0:26:09 ET
Table 'E7bWJ45aoFXRpyRv2gw+Ig' 2-max Seat #2 is the button
Seat 1: FRkiRasEGlHUeLrEl+k/nA ($61 in chips)
Seat 2: 3Wro85I7472vJ4Wkpneo9A ($116.95 in chips)
3Wro85I7472vJ4Wkpneo9A: posts small blind $0.25
FRkiRasEGlHUeLrEl+k/nA: posts big blind $0.50
*** HOLE CARDS ***
3Wro85I7472vJ4Wkpneo9A: raises $1 to $1.50
FRkiRasEGlHUeLrEl+k/nA: folds
3Wro85I7472vJ4Wkpneo9A collected $1 from pot
3Wro85I7472vJ4Wkpneo9A: doesn't show hand
*** SUMMARY ***
Total pot $1 | Rake $0
Seat 1: FRkiRasEGlHUeLrEl+k/nA (big blind) folded before Flop
Seat 2: 3Wro85I7472vJ4Wkpneo9A (button) (small blind) collected ($1)



PokerStars Game #59938894084:  Hold'em No Limit ($0.25/$0.50) - 2009/07/01 0:26:10 ET
Table 'ZYwMb9E6tY50Qm+iNbXRYw' 2-max Seat #1 is the button
Seat 1: DXLfRb8KDZWmrztw2bwtFw ($10.50 in chips)
Seat 2: 16tvT7AYgZ2LgiGFcvFKQg ($19.55 in chips)
DXLfRb8KDZWmrztw2bwtFw: posts small blind $0.25
16tvT7AYgZ2LgiGFcvFKQg: posts big blind $0.50
*** HOLE CARDS ***
DXLfRb8KDZWmrztw2bwtFw: calls $0.25
16tvT7AYgZ2LgiGFcvFKQg: raises $0.50 to $1
DXLfRb8KDZWmrztw2bwtFw: calls $0.50
*** FLOP *** [9d 8s 7d]
16tvT7AYgZ2LgiGFcvFKQg: bets $0.50
DXLfRb8KDZWmrztw2bwtFw: calls $0.50
*** TURN *** [9d 8s 7d] [As]
16tvT7AYgZ2LgiGFcvFKQg: bets $0.50
DXLfRb8KDZWmrztw2bwtFw: raises $0.50 to $1
16tvT7AYgZ2LgiGFcvFKQg: calls $0.50
*** RIVER *** [9d 8s 7d As] [6h]
16tvT7AYgZ2LgiGFcvFKQg: checks
DXLfRb8KDZWmrztw2bwtFw: bets $2.50
16tvT7AYgZ2LgiGFcvFKQg: calls $2.50
*** SHOW DOWN ***
DXLfRb8KDZWmrztw2bwtFw: shows [4d Jc] (high card Ace)
16tvT7AYgZ2LgiGFcvFKQg: shows [Qh Qd] (a pair of Queens)
16tvT7AYgZ2LgiGFcvFKQg collected $9.55 from pot
*** SUMMARY ***
Total pot $10 | Rake $0.45
Board [9d 8s 7d As 6h]
Seat 1: DXLfRb8KDZWmrztw2bwtFw (button) (small blind) showed [4d Jc] and lost with high card Ace
Seat 2: 16tvT7AYgZ2LgiGFcvFKQg (big blind) showed [Qh Qd] and won ($9.55) with a pair of Queens



PokerStars Game #59938895402:  Hold'em No Limit ($0.25/$0.50) - 2009/07/01 0:26:12 ET
Table 'c/CRn+68J3Y8KxD5g1ek2Q' 2-max Seat #1 is the button
Seat 1: 46qCyJ6evTkHo9al5sBMNA ($267.85 in chips)
Seat 2: BypVLsYQt3ePFm2xQL/dOA ($112.60 in chips)
46qCyJ6evTkHo9al5sBMNA: posts small blind $0.25
BypVLsYQt3ePFm2xQL/dOA: posts big blind $0.50
*** HOLE CARDS ***
46qCyJ6evTkHo9al5sBMNA: raises $1 to $1.50
BypVLsYQt3ePFm2xQL/dOA: folds
46qCyJ6evTkHo9al5sBMNA collected $1 from pot
46qCyJ6evTkHo9al5sBMNA: doesn't show hand
*** SUMMARY ***
Total pot $1 | Rake $0
Seat 1: 46qCyJ6evTkHo9al5sBMNA (button) (small blind) collected ($1)
Seat 2: BypVLsYQt3ePFm2xQL/dOA (big blind) folded before Flop



PokerStars Game #59938895790:  Hold'em No Limit ($0.25/$0.50) - 2009/07/01 0:26:12 ET
Table 'PALRfuH85dr5IkDfdv6new' 9-max Seat #5 is the button
Seat 1: SKnJuWHScqetA/qG5p+wCg ($31.25 in chips)
Seat 2: 9r7ZoBbAJj5IeyZ0q9BdzA ($6.85 in chips)
Seat 3: 50QWoELmpmHFrFIlWMJo9g ($87.45 in chips)
Seat 4: mZNMJI1mY40XTC0U7GZakA ($50.75 in chips)
Seat 5: jSSGUXdNFAZA3QCvTcUMQw ($44.95 in chips)
Seat 6: E2518gp4aFz1+kAgmGqeEg ($10.50 in chips)
Seat 7: 3NcyXvr39gnK+KbTq7ezyA ($39.35 in chips)
Seat 8: NkS+CseUKx4XHszWq0PXEQ ($45.65 in chips)
Seat 9: CIrAX/m6o7jYmKOAjJXv4Q ($33.20 in chips)
E2518gp4aFz1+kAgmGqeEg: posts small blind $0.25
3NcyXvr39gnK+KbTq7ezyA: posts big blind $0.50
*** HOLE CARDS ***
NkS+CseUKx4XHszWq0PXEQ: folds
CIrAX/m6o7jYmKOAjJXv4Q: calls $0.50
SKnJuWHScqetA/qG5p+wCg: folds
9r7ZoBbAJj5IeyZ0q9BdzA: folds
50QWoELmpmHFrFIlWMJo9g: folds
mZNMJI1mY40XTC0U7GZakA: folds
jSSGUXdNFAZA3QCvTcUMQw: raises $1 to $1.50
E2518gp4aFz1+kAgmGqeEg: folds
3NcyXvr39gnK+KbTq7ezyA: calls $1
CIrAX/m6o7jYmKOAjJXv4Q: calls $1
*** FLOP *** [5h Kh 9s]
3NcyXvr39gnK+KbTq7ezyA: checks
CIrAX/m6o7jYmKOAjJXv4Q: checks
jSSGUXdNFAZA3QCvTcUMQw: checks
*** TURN *** [5h Kh 9s] [Ks]
3NcyXvr39gnK+KbTq7ezyA: checks
CIrAX/m6o7jYmKOAjJXv4Q: bets $2
jSSGUXdNFAZA3QCvTcUMQw: folds
3NcyXvr39gnK+KbTq7ezyA: folds
CIrAX/m6o7jYmKOAjJXv4Q collected $4.55 from pot
*** SUMMARY ***
Total pot $4.75 | Rake $0.20
Board [5h Kh 9s Ks]
Seat 1: SKnJuWHScqetA/qG5p+wCg folded before Flop (didn't bet)
Seat 2: 9r7ZoBbAJj5IeyZ0q9BdzA folded before Flop (didn't bet)
Seat 3: 50QWoELmpmHFrFIlWMJo9g folded before Flop (didn't bet)
Seat 4: mZNMJI1mY40XTC0U7GZakA folded before Flop (didn't bet)
Seat 5: jSSGUXdNFAZA3QCvTcUMQw (button) folded on the Turn
Seat 6: E2518gp4aFz1+kAgmGqeEg (small blind) folded before Flop
Seat 7: 3NcyXvr39gnK+KbTq7ezyA (big blind) folded on the Turn
Seat 8: NkS+CseUKx4XHszWq0PXEQ folded before Flop (didn't bet)
Seat 9: CIrAX/m6o7jYmKOAjJXv4Q collected ($4.55)



PokerStars Game #59938899382:  Hold'em No Limit ($0.25/$0.50) - 2009/07/01 0:26:18 ET
Table '3FhG0gl3kMX3wBEEqj+wnQ' 9-max Seat #6 is the button
Seat 1: e0J9pdCNUDTCG031RnXqLA ($19.50 in chips)
Seat 2: 4dl3YNqZ6Houm2jZAzDmRg ($16.55 in chips)
Seat 3: HZkVla4kK2SI42CVrPZ/ig ($9.25 in chips)
Seat 4: bz4LMfV0GGl/MJ/ABXuPmg ($21.35 in chips)
Seat 5: XNMDwbXt/Q4jM99AXnbJDw ($54.80 in chips)
Seat 6: 5JJVDlaiMnB004o/RqbZZQ ($23.75 in chips)
Seat 7: mSD1pginDsyHG5PDfqzphw ($10 in chips)
Seat 8: j3K/Jujr7PY4ZM2RZvlH6A ($59.20 in chips)
Seat 9: L5e2lrPLQm1Pqx30IIZ/Fw ($10 in chips)
mSD1pginDsyHG5PDfqzphw: posts small blind $0.25
j3K/Jujr7PY4ZM2RZvlH6A: posts big blind $0.50
*** HOLE CARDS ***
L5e2lrPLQm1Pqx30IIZ/Fw: folds
e0J9pdCNUDTCG031RnXqLA: raises $1 to $1.50
4dl3YNqZ6Houm2jZAzDmRg: folds
HZkVla4kK2SI42CVrPZ/ig: folds
bz4LMfV0GGl/MJ/ABXuPmg: folds
XNMDwbXt/Q4jM99AXnbJDw: raises $3.50 to $5
5JJVDlaiMnB004o/RqbZZQ: folds
mSD1pginDsyHG5PDfqzphw: folds
j3K/Jujr7PY4ZM2RZvlH6A: raises $3.50 to $8.50
e0J9pdCNUDTCG031RnXqLA: folds
XNMDwbXt/Q4jM99AXnbJDw: folds
j3K/Jujr7PY4ZM2RZvlH6A collected $11.75 from pot
j3K/Jujr7PY4ZM2RZvlH6A: doesn't show hand
*** SUMMARY ***
Total pot $11.75 | Rake $0
Seat 1: e0J9pdCNUDTCG031RnXqLA folded before Flop
Seat 2: 4dl3YNqZ6Houm2jZAzDmRg folded before Flop (didn't bet)
Seat 3: HZkVla4kK2SI42CVrPZ/ig folded before Flop (didn't bet)
Seat 4: bz4LMfV0GGl/MJ/ABXuPmg folded before Flop (didn't bet)
Seat 5: XNMDwbXt/Q4jM99AXnbJDw folded before Flop
Seat 6: 5JJVDlaiMnB004o/RqbZZQ (button) folded before Flop (didn't bet)
Seat 7: mSD1pginDsyHG5PDfqzphw (small blind) folded before Flop
Seat 8: j3K/Jujr7PY4ZM2RZvlH6A (big blind) collected ($11.75)
Seat 9: L5e2lrPLQm1Pqx30IIZ/Fw folded before Flop (didn't bet)



PokerStars Game #59938899912:  Hold'em No Limit ($0.25/$0.50) - 2009/07/01 0:26:19 ET
Table 'E7bWJ45aoFXRpyRv2gw+Ig' 2-max Seat #1 is the button
Seat 1: FRkiRasEGlHUeLrEl+k/nA ($60.50 in chips)
Seat 2: 3Wro85I7472vJ4Wkpneo9A ($117.45 in chips)
FRkiRasEGlHUeLrEl+k/nA: posts small blind $0.25
3Wro85I7472vJ4Wkpneo9A: posts big blind $0.50
*** HOLE CARDS ***
FRkiRasEGlHUeLrEl+k/nA: folds
3Wro85I7472vJ4Wkpneo9A collected $0.50 from pot
3Wro85I7472vJ4Wkpneo9A: doesn't show hand
*** SUMMARY ***
Total pot $0.50 | Rake $0
Seat 1: FRkiRasEGlHUeLrEl+k/nA (button) (small blind) folded before Flop
Seat 2: 3Wro85I7472vJ4Wkpneo9A (big blind) collected ($0.50)



PokerStars Game #59938901614:  Hold'em No Limit ($0.25/$0.50) - 2009/07/01 0:26:21 ET
Table 'GfL/No5u5PoEnU39lP5pQg' 6-max Seat #5 is the button
Seat 1: 1WUCqNG+p+vfWRTXNu4ljw ($51.65 in chips)
Seat 2: uVwggSetzp7d+eVgowO3vg ($45.50 in chips)
Seat 3: qNezhXOOUXqwG7b9X5XJAA ($50 in chips)
Seat 4: OZ6OtYh5Y53MCH/p0QTn5g ($50.75 in chips)
Seat 5: crjGpJEzSZgD38FoE3VMGg ($53.55 in chips)
1WUCqNG+p+vfWRTXNu4ljw: posts small blind $0.25
uVwggSetzp7d+eVgowO3vg: posts big blind $0.50
*** HOLE CARDS ***
qNezhXOOUXqwG7b9X5XJAA: folds
OZ6OtYh5Y53MCH/p0QTn5g: raises $1 to $1.50
crjGpJEzSZgD38FoE3VMGg: folds
1WUCqNG+p+vfWRTXNu4ljw: folds
uVwggSetzp7d+eVgowO3vg: calls $1
*** FLOP *** [4c Th 4s]
uVwggSetzp7d+eVgowO3vg: checks
OZ6OtYh5Y53MCH/p0QTn5g: bets $2
uVwggSetzp7d+eVgowO3vg: folds
OZ6OtYh5Y53MCH/p0QTn5g collected $3.10 from pot
OZ6OtYh5Y53MCH/p0QTn5g: doesn't show hand
*** SUMMARY ***
Total pot $3.25 | Rake $0.15
Board [4c Th 4s]
Seat 1: 1WUCqNG+p+vfWRTXNu4ljw (small blind) folded before Flop
Seat 2: uVwggSetzp7d+eVgowO3vg (big blind) folded on the Flop
Seat 3: qNezhXOOUXqwG7b9X5XJAA folded before Flop (didn't bet)
Seat 4: OZ6OtYh5Y53MCH/p0QTn5g collected ($3.10)
Seat 5: crjGpJEzSZgD38FoE3VMGg (button) folded before Flop (didn't bet)



PokerStars Game #59938901200:  Hold'em No Limit ($0.25/$0.50) - 2009/07/01 0:26:21 ET
Table 'tyR5AZNKV8Aadbrnrnlg7g' 6-max Seat #6 is the button
Seat 1: R+KjpH/wSjDLhtIy9+edNA ($85.75 in chips)
Seat 2: 58zdeSBSuSFX/qZfhc7YmA ($29.10 in chips)
Seat 4: Rt6KgtZ8YaJoTc3FPim00w ($84.25 in chips)
Seat 5: wOyVV9M/oyiw3YaOjNZ05w ($50 in chips)
Seat 6: DMQLAmut/l19xN5STQndFg ($4.30 in chips)
R+KjpH/wSjDLhtIy9+edNA: posts small blind $0.25
58zdeSBSuSFX/qZfhc7YmA: posts big blind $0.50
*** HOLE CARDS ***
jUhx+m+V7qfbLZTjgwZByg leaves the table
Rt6KgtZ8YaJoTc3FPim00w: folds
wOyVV9M/oyiw3YaOjNZ05w: raises $1.25 to $1.75
tdOvWynovql5imfooroLMg joins the table at seat #3
DMQLAmut/l19xN5STQndFg: raises $2.55 to $4.30 and is all-in
R+KjpH/wSjDLhtIy9+edNA: folds
58zdeSBSuSFX/qZfhc7YmA: folds
wOyVV9M/oyiw3YaOjNZ05w: calls $2.55
*** FLOP *** [6d 9s 5d]
*** TURN *** [6d 9s 5d] [7s]
*** RIVER *** [6d 9s 5d 7s] [9d]
*** SHOW DOWN ***
wOyVV9M/oyiw3YaOjNZ05w: shows [8h Ah] (a straight, Five to Nine)
DMQLAmut/l19xN5STQndFg: mucks hand
wOyVV9M/oyiw3YaOjNZ05w collected $8.90 from pot
*** SUMMARY ***
Total pot $9.35 | Rake $0.45
Board [6d 9s 5d 7s 9d]
Seat 1: R+KjpH/wSjDLhtIy9+edNA (small blind) folded before Flop
Seat 2: 58zdeSBSuSFX/qZfhc7YmA (big blind) folded before Flop
Seat 4: Rt6KgtZ8YaJoTc3FPim00w folded before Flop (didn't bet)
Seat 5: wOyVV9M/oyiw3YaOjNZ05w showed [8h Ah] and won ($8.90) with a straight, Five to Nine
Seat 6: DMQLAmut/l19xN5STQndFg (button) mucked



PokerStars Game #59938901782:  Hold'em No Limit ($0.25/$0.50) - 2009/07/01 0:26:22 ET
Table '37qXEp3oe+er5q4CZip9eQ' 6-max Seat #1 is the button
Seat 1: oqOqoO2AyCZenUghCxMDxw ($50 in chips)
Seat 2: 6wzJiRvp8HY6t+MQGnSIzA ($21.75 in chips)
Seat 3: Rt6KgtZ8YaJoTc3FPim00w ($99.25 in chips)
Seat 4: XsmE8nXMAAMFJbWaJTmHFw ($10 in chips)
Seat 5: VOmI0x4dDPnTESZd5B4d1Q ($45.25 in chips)
Seat 6: f7zPpUQp9hHZgqhEvrUWQw ($50 in chips)
6wzJiRvp8HY6t+MQGnSIzA: posts small blind $0.25
Rt6KgtZ8YaJoTc3FPim00w: posts big blind $0.50
XsmE8nXMAAMFJbWaJTmHFw: posts big blind $0.50
*** HOLE CARDS ***
XsmE8nXMAAMFJbWaJTmHFw: checks
VOmI0x4dDPnTESZd5B4d1Q: folds
f7zPpUQp9hHZgqhEvrUWQw: folds
oqOqoO2AyCZenUghCxMDxw: folds
6wzJiRvp8HY6t+MQGnSIzA: calls $0.25
Rt6KgtZ8YaJoTc3FPim00w: checks
*** FLOP *** [3h 8d Kh]
6wzJiRvp8HY6t+MQGnSIzA: bets $1
Rt6KgtZ8YaJoTc3FPim00w: folds
XsmE8nXMAAMFJbWaJTmHFw: raises $1 to $2
6wzJiRvp8HY6t+MQGnSIzA: calls $1
*** TURN *** [3h 8d Kh] [Ad]
f7zPpUQp9hHZgqhEvrUWQw leaves the table
6wzJiRvp8HY6t+MQGnSIzA: checks
XsmE8nXMAAMFJbWaJTmHFw: checks
*** RIVER *** [3h 8d Kh Ad] [Td]
6wzJiRvp8HY6t+MQGnSIzA: bets $3
XsmE8nXMAAMFJbWaJTmHFw: raises $3 to $6
6wzJiRvp8HY6t+MQGnSIzA: folds
XsmE8nXMAAMFJbWaJTmHFw collected $10.95 from pot
*** SUMMARY ***
Total pot $11.50 | Rake $0.55
Board [3h 8d Kh Ad Td]
Seat 1: oqOqoO2AyCZenUghCxMDxw (button) folded before Flop (didn't bet)
Seat 2: 6wzJiRvp8HY6t+MQGnSIzA (small blind) folded on the River
Seat 3: Rt6KgtZ8YaJoTc3FPim00w (big blind) folded on the Flop
Seat 4: XsmE8nXMAAMFJbWaJTmHFw collected ($10.95)
Seat 5: VOmI0x4dDPnTESZd5B4d1Q folded before Flop (didn't bet)
Seat 6: f7zPpUQp9hHZgqhEvrUWQw folded before Flop (didn't bet)



PokerStars Game #59938902932:  Hold'em No Limit ($0.25/$0.50) - 2009/07/01 0:26:23 ET
Table 'c/CRn+68J3Y8KxD5g1ek2Q' 2-max Seat #2 is the button
Seat 1: 46qCyJ6evTkHo9al5sBMNA ($268.35 in chips)
Seat 2: BypVLsYQt3ePFm2xQL/dOA ($112.10 in chips)
BypVLsYQt3ePFm2xQL/dOA: posts small blind $0.25
46qCyJ6evTkHo9al5sBMNA: posts big blind $0.50
*** HOLE CARDS ***
BypVLsYQt3ePFm2xQL/dOA: raises $1.50 to $2
46qCyJ6evTkHo9al5sBMNA: calls $1.50
*** FLOP *** [Kc 8h Kh]
46qCyJ6evTkHo9al5sBMNA: checks
BypVLsYQt3ePFm2xQL/dOA: checks
*** TURN *** [Kc 8h Kh] [3h]
46qCyJ6evTkHo9al5sBMNA: checks
BypVLsYQt3ePFm2xQL/dOA: bets $2
46qCyJ6evTkHo9al5sBMNA: calls $2
*** RIVER *** [Kc 8h Kh 3h] [3d]
46qCyJ6evTkHo9al5sBMNA: checks
BypVLsYQt3ePFm2xQL/dOA: checks
*** SHOW DOWN ***
46qCyJ6evTkHo9al5sBMNA: shows [Ah 6d] (two pair, Kings and Threes)
BypVLsYQt3ePFm2xQL/dOA: mucks hand
46qCyJ6evTkHo9al5sBMNA collected $7.65 from pot
*** SUMMARY ***
Total pot $8 | Rake $0.35
Board [Kc 8h Kh 3h 3d]
Seat 1: 46qCyJ6evTkHo9al5sBMNA (big blind) showed [Ah 6d] and won ($7.65) with two pair, Kings and Threes
Seat 2: BypVLsYQt3ePFm2xQL/dOA (button) (small blind) mucked



PokerStars Game #59938903402:  Hold'em No Limit ($0.25/$0.50) - 2009/07/01 0:26:24 ET
Table '+dXkOAQyS8j9PQZusUTMpg' 2-max Seat #2 is the button
Seat 1: XFa6sBGjP2gxoIvxR3fZIg ($57.10 in chips)
Seat 2: 5IBeOgaApY1Bvzv2P8X4EA ($49 in chips)
5IBeOgaApY1Bvzv2P8X4EA: posts small blind $0.25
XFa6sBGjP2gxoIvxR3fZIg: posts big blind $0.50
*** HOLE CARDS ***
5IBeOgaApY1Bvzv2P8X4EA: folds
XFa6sBGjP2gxoIvxR3fZIg collected $0.50 from pot
XFa6sBGjP2gxoIvxR3fZIg: doesn't show hand
*** SUMMARY ***
Total pot $0.50 | Rake $0
Seat 1: XFa6sBGjP2gxoIvxR3fZIg (big blind) collected ($0.50)
Seat 2: 5IBeOgaApY1Bvzv2P8X4EA (button) (small blind) folded before Flop



PokerStars Game #59938904432:  Hold'em No Limit ($0.25/$0.50) - 2009/07/01 0:26:25 ET
Table 'E7bWJ45aoFXRpyRv2gw+Ig' 2-max Seat #2 is the button
Seat 1: FRkiRasEGlHUeLrEl+k/nA ($60.25 in chips)
Seat 2: 3Wro85I7472vJ4Wkpneo9A ($117.70 in chips)
3Wro85I7472vJ4Wkpneo9A: posts small blind $0.25
FRkiRasEGlHUeLrEl+k/nA: posts big blind $0.50
*** HOLE CARDS ***
3Wro85I7472vJ4Wkpneo9A: raises $1 to $1.50
FRkiRasEGlHUeLrEl+k/nA: calls $1
*** FLOP *** [4s Th Kd]
FRkiRasEGlHUeLrEl+k/nA: checks
3Wro85I7472vJ4Wkpneo9A: checks
*** TURN *** [4s Th Kd] [3h]
FRkiRasEGlHUeLrEl+k/nA: checks
3Wro85I7472vJ4Wkpneo9A: bets $2
FRkiRasEGlHUeLrEl+k/nA: calls $2
*** RIVER *** [4s Th Kd 3h] [Jc]
FRkiRasEGlHUeLrEl+k/nA: bets $3
3Wro85I7472vJ4Wkpneo9A: calls $3
*** SHOW DOWN ***
FRkiRasEGlHUeLrEl+k/nA: shows [7c 6c] (high card King)
3Wro85I7472vJ4Wkpneo9A: shows [Tc 9s] (a pair of Tens)
3Wro85I7472vJ4Wkpneo9A collected $12.50 from pot
*** SUMMARY ***
Total pot $13 | Rake $0.50
Board [4s Th Kd 3h Jc]
Seat 1: FRkiRasEGlHUeLrEl+k/nA (big blind) showed [7c 6c] and lost with high card King
Seat 2: 3Wro85I7472vJ4Wkpneo9A (button) (small blind) showed [Tc 9s] and won ($12.50) with a pair of Tens



PokerStars Game #59938905066:  Hold'em No Limit ($0.25/$0.50) - 2009/07/01 0:26:26 ET
Table 'IeNZOZQ4T6oiaHqFeo6yIA' 2-max Seat #2 is the button
Seat 1: ndd1nfncBkWNitBnsfCoVQ ($90.80 in chips)
Seat 2: A91IUl5JaZROhtfCtnnwYw ($42.80 in chips)
A91IUl5JaZROhtfCtnnwYw: posts small blind $0.25
ndd1nfncBkWNitBnsfCoVQ: posts big blind $0.50
*** HOLE CARDS ***
A91IUl5JaZROhtfCtnnwYw: calls $0.25
ndd1nfncBkWNitBnsfCoVQ: checks
*** FLOP *** [Ac As Ts]
ndd1nfncBkWNitBnsfCoVQ: checks
A91IUl5JaZROhtfCtnnwYw: checks
*** TURN *** [Ac As Ts] [5d]
ndd1nfncBkWNitBnsfCoVQ: checks
A91IUl5JaZROhtfCtnnwYw: checks
*** RIVER *** [Ac As Ts 5d] [Ad]
ndd1nfncBkWNitBnsfCoVQ: checks
A91IUl5JaZROhtfCtnnwYw: bets $0.50
ndd1nfncBkWNitBnsfCoVQ: folds
A91IUl5JaZROhtfCtnnwYw collected $0.95 from pot
*** SUMMARY ***
Total pot $1 | Rake $0.05
Board [Ac As Ts 5d Ad]
Seat 1: ndd1nfncBkWNitBnsfCoVQ (big blind) folded on the River
Seat 2: A91IUl5JaZROhtfCtnnwYw (button) (small blind) collected ($0.95)



PokerStars Game #59938906690:  Hold'em No Limit ($0.25/$0.50) - 2009/07/01 0:26:29 ET
Table 'ZYwMb9E6tY50Qm+iNbXRYw' 2-max Seat #2 is the button
Seat 1: DXLfRb8KDZWmrztw2bwtFw ($5.50 in chips)
Seat 2: 16tvT7AYgZ2LgiGFcvFKQg ($24.10 in chips)
16tvT7AYgZ2LgiGFcvFKQg: posts small blind $0.25
DXLfRb8KDZWmrztw2bwtFw: posts big blind $0.50
*** HOLE CARDS ***
16tvT7AYgZ2LgiGFcvFKQg: raises $0.50 to $1
DXLfRb8KDZWmrztw2bwtFw: calls $0.50
*** FLOP *** [2d 3d Ks]
DXLfRb8KDZWmrztw2bwtFw: checks
16tvT7AYgZ2LgiGFcvFKQg: bets $0.50
DXLfRb8KDZWmrztw2bwtFw: folds
16tvT7AYgZ2LgiGFcvFKQg collected $1.90 from pot
16tvT7AYgZ2LgiGFcvFKQg: shows [9h 9d] (a pair of Nines)
*** SUMMARY ***
Total pot $2 | Rake $0.10
Board [2d 3d Ks]
Seat 1: DXLfRb8KDZWmrztw2bwtFw (big blind) folded on the Flop
Seat 2: 16tvT7AYgZ2LgiGFcvFKQg (button) (small blind) collected ($1.90)



PokerStars Game #59938907234:  Hold'em No Limit ($0.25/$0.50) - 2009/07/01 0:26:30 ET
Table '+dXkOAQyS8j9PQZusUTMpg' 2-max Seat #1 is the button
Seat 1: XFa6sBGjP2gxoIvxR3fZIg ($57.35 in chips)
Seat 2: 5IBeOgaApY1Bvzv2P8X4EA ($48.75 in chips)
XFa6sBGjP2gxoIvxR3fZIg: posts small blind $0.25
5IBeOgaApY1Bvzv2P8X4EA: posts big blind $0.50
*** HOLE CARDS ***
XFa6sBGjP2gxoIvxR3fZIg: raises $1 to $1.50
5IBeOgaApY1Bvzv2P8X4EA: folds
XFa6sBGjP2gxoIvxR3fZIg collected $1 from pot
XFa6sBGjP2gxoIvxR3fZIg: doesn't show hand
*** SUMMARY ***
Total pot $1 | Rake $0
Seat 1: XFa6sBGjP2gxoIvxR3fZIg (button) (small blind) collected ($1)
Seat 2: 5IBeOgaApY1Bvzv2P8X4EA (big blind) folded before Flop



PokerStars Game #59938910372:  Hold'em No Limit ($0.25/$0.50) - 2009/07/01 0:26:35 ET
Table 'mTxf8gPLgffN3Iwfm7Icfg' 2-max Seat #1 is the button
Seat 1: Do9Rlu1R5u/AcRtMTl8SYg ($97.20 in chips)
Seat 2: EMc5LPgVaded4Qc77vm0fw ($62.85 in chips)
Do9Rlu1R5u/AcRtMTl8SYg: posts small blind $0.25
EMc5LPgVaded4Qc77vm0fw: posts big blind $0.50
*** HOLE CARDS ***
Do9Rlu1R5u/AcRtMTl8SYg: calls $0.25
EMc5LPgVaded4Qc77vm0fw: raises $1.50 to $2
Do9Rlu1R5u/AcRtMTl8SYg: calls $1.50
*** FLOP *** [7h Qd 5h]
EMc5LPgVaded4Qc77vm0fw: checks
Do9Rlu1R5u/AcRtMTl8SYg: checks
*** TURN *** [7h Qd 5h] [Td]
EMc5LPgVaded4Qc77vm0fw: bets $2
Do9Rlu1R5u/AcRtMTl8SYg: folds
EMc5LPgVaded4Qc77vm0fw collected $3.80 from pot
EMc5LPgVaded4Qc77vm0fw: doesn't show hand
*** SUMMARY ***
Total pot $4 | Rake $0.20
Board [7h Qd 5h Td]
Seat 1: Do9Rlu1R5u/AcRtMTl8SYg (button) (small blind) folded on the Turn
Seat 2: EMc5LPgVaded4Qc77vm0fw (big blind) collected ($3.80)



PokerStars Game #59938912178:  Hold'em No Limit ($0.25/$0.50) - 2009/07/01 0:26:37 ET
Table 'hSTs/dUsYLgJQuF2Onp0MQ' 6-max Seat #4 is the button
Seat 1: Donj3X7gYzeS5pAl7s9f+Q ($31.95 in chips)
Seat 2: 6vNxrjjCl6FwfaaymM9jjg ($23.65 in chips)
Seat 4: L0aIPg7qefDQjdJo3HCVEA ($9.25 in chips)
Seat 5: 686aeHikcJlgKkSuIFdcXQ ($58.85 in chips)
Seat 6: +laPa9P7BjZKKnR0n+OmvA ($9.70 in chips)
686aeHikcJlgKkSuIFdcXQ: posts small blind $0.25
+laPa9P7BjZKKnR0n+OmvA: posts big blind $0.50
C3qJBo7uxfFVDluE1lmK2w: sits out
*** HOLE CARDS ***
Donj3X7gYzeS5pAl7s9f+Q: raises $1.50 to $2
6vNxrjjCl6FwfaaymM9jjg: folds
L0aIPg7qefDQjdJo3HCVEA: folds
686aeHikcJlgKkSuIFdcXQ: folds
+laPa9P7BjZKKnR0n+OmvA: folds
Donj3X7gYzeS5pAl7s9f+Q collected $1.25 from pot
*** SUMMARY ***
Total pot $1.25 | Rake $0
Seat 1: Donj3X7gYzeS5pAl7s9f+Q collected ($1.25)
Seat 2: 6vNxrjjCl6FwfaaymM9jjg folded before Flop (didn't bet)
Seat 4: L0aIPg7qefDQjdJo3HCVEA (button) folded before Flop (didn't bet)
Seat 5: 686aeHikcJlgKkSuIFdcXQ (small blind) folded before Flop
Seat 6: +laPa9P7BjZKKnR0n+OmvA (big blind) folded before Flop



PokerStars Game #59938912160:  Hold'em No Limit ($0.25/$0.50) - 2009/07/01 0:26:37 ET
Table 'EiNh8p/wGJ1FP575iMFnqg' 9-max Seat #1 is the button
Seat 1: r3ZqM1Mi0W3y4hOdssE+Sg ($26.70 in chips)
Seat 2: sSAA879uXOGR+8Mf3zLa6Q ($11.30 in chips)
Seat 3: ymLPoEIl7UL3TvZYmnadxQ ($30 in chips)
Seat 4: HIIPkpiaCQfs5HcPKjlHvg ($40.70 in chips)
Seat 5: M+7+BTmX5vZatHVuoRB1nA ($78.65 in chips)
Seat 6: 3UmXLy3GfjC3EkOebduerQ ($56.60 in chips)
Seat 7: Wj7mKnRFR90j40wWUu2+Og ($77.80 in chips)
Seat 8: KrPAGRACBg+w0M//SXe8Ag ($14.80 in chips)
Seat 9: OMwFJ4pF0xk2Ru/AJiFeFw ($69.90 in chips)
sSAA879uXOGR+8Mf3zLa6Q: posts small blind $0.25
ymLPoEIl7UL3TvZYmnadxQ: posts big blind $0.50
*** HOLE CARDS ***
HIIPkpiaCQfs5HcPKjlHvg: folds
M+7+BTmX5vZatHVuoRB1nA: calls $0.50
3UmXLy3GfjC3EkOebduerQ: folds
Wj7mKnRFR90j40wWUu2+Og: folds
KrPAGRACBg+w0M//SXe8Ag: calls $0.50
OMwFJ4pF0xk2Ru/AJiFeFw: folds
r3ZqM1Mi0W3y4hOdssE+Sg: folds
sSAA879uXOGR+8Mf3zLa6Q: calls $0.25
ymLPoEIl7UL3TvZYmnadxQ: checks
*** FLOP *** [2h 8h 3h]
sSAA879uXOGR+8Mf3zLa6Q: checks
ymLPoEIl7UL3TvZYmnadxQ: checks
M+7+BTmX5vZatHVuoRB1nA: checks
KrPAGRACBg+w0M//SXe8Ag: bets $0.50
sSAA879uXOGR+8Mf3zLa6Q: calls $0.50
ymLPoEIl7UL3TvZYmnadxQ: folds
M+7+BTmX5vZatHVuoRB1nA: folds
*** TURN *** [2h 8h 3h] [2s]
sSAA879uXOGR+8Mf3zLa6Q: checks
KrPAGRACBg+w0M//SXe8Ag: checks
*** RIVER *** [2h 8h 3h 2s] [Qh]
sSAA879uXOGR+8Mf3zLa6Q: checks
KrPAGRACBg+w0M//SXe8Ag: checks
*** SHOW DOWN ***
sSAA879uXOGR+8Mf3zLa6Q: shows [Kd 8c] (two pair, Eights and Deuces)
KrPAGRACBg+w0M//SXe8Ag: mucks hand
sSAA879uXOGR+8Mf3zLa6Q collected $2.90 from pot
*** SUMMARY ***
Total pot $3 | Rake $0.10
Board [2h 8h 3h 2s Qh]
Seat 1: r3ZqM1Mi0W3y4hOdssE+Sg (button) folded before Flop (didn't bet)
Seat 2: sSAA879uXOGR+8Mf3zLa6Q (small blind) showed [Kd 8c] and won ($2.90) with two pair, Eights and Deuces
Seat 3: ymLPoEIl7UL3TvZYmnadxQ (big blind) folded on the Flop
Seat 4: HIIPkpiaCQfs5HcPKjlHvg folded before Flop (didn't bet)
Seat 5: M+7+BTmX5vZatHVuoRB1nA folded on the Flop
Seat 6: 3UmXLy3GfjC3EkOebduerQ folded before Flop (didn't bet)
Seat 7: Wj7mKnRFR90j40wWUu2+Og folded before Flop (didn't bet)
Seat 8: KrPAGRACBg+w0M//SXe8Ag mucked
Seat 9: OMwFJ4pF0xk2Ru/AJiFeFw folded before Flop (didn't bet)



PokerStars Game #59938912672:  Hold'em No Limit ($0.25/$0.50) - 2009/07/01 0:26:38 ET
Table '+dXkOAQyS8j9PQZusUTMpg' 2-max Seat #2 is the button
Seat 1: XFa6sBGjP2gxoIvxR3fZIg ($57.85 in chips)
Seat 2: 5IBeOgaApY1Bvzv2P8X4EA ($48.25 in chips)
5IBeOgaApY1Bvzv2P8X4EA: posts small blind $0.25
XFa6sBGjP2gxoIvxR3fZIg: posts big blind $0.50
*** HOLE CARDS ***
5IBeOgaApY1Bvzv2P8X4EA: folds
XFa6sBGjP2gxoIvxR3fZIg collected $0.50 from pot
XFa6sBGjP2gxoIvxR3fZIg: doesn't show hand
*** SUMMARY ***
Total pot $0.50 | Rake $0
Seat 1: XFa6sBGjP2gxoIvxR3fZIg (big blind) collected ($0.50)
Seat 2: 5IBeOgaApY1Bvzv2P8X4EA (button) (small blind) folded before Flop



PokerStars Game #59938913774:  Hold'em No Limit ($0.25/$0.50) - 2009/07/01 0:26:40 ET
Table 'ZYwMb9E6tY50Qm+iNbXRYw' 2-max Seat #1 is the button
Seat 1: DXLfRb8KDZWmrztw2bwtFw ($4.50 in chips)
Seat 2: 16tvT7AYgZ2LgiGFcvFKQg ($25 in chips)
DXLfRb8KDZWmrztw2bwtFw: posts small blind $0.25
16tvT7AYgZ2LgiGFcvFKQg: posts big blind $0.50
*** HOLE CARDS ***
DXLfRb8KDZWmrztw2bwtFw: calls $0.25
16tvT7AYgZ2LgiGFcvFKQg: raises $1 to $1.50
DXLfRb8KDZWmrztw2bwtFw: raises $3 to $4.50 and is all-in
16tvT7AYgZ2LgiGFcvFKQg: calls $3
*** FLOP *** [Qh 4h Qc]
*** TURN *** [Qh 4h Qc] [8s]
*** RIVER *** [Qh 4h Qc 8s] [Qs]
*** SHOW DOWN ***
16tvT7AYgZ2LgiGFcvFKQg: shows [2h 4s] (a full house, Queens full of Fours)
DXLfRb8KDZWmrztw2bwtFw: shows [Ah 8d] (a full house, Queens full of Eights)
DXLfRb8KDZWmrztw2bwtFw collected $8.55 from pot
*** SUMMARY ***
Total pot $9 | Rake $0.45
Board [Qh 4h Qc 8s Qs]
Seat 1: DXLfRb8KDZWmrztw2bwtFw (button) (small blind) showed [Ah 8d] and won ($8.55) with a full house, Queens full of Eights
Seat 2: 16tvT7AYgZ2LgiGFcvFKQg (big blind) showed [2h 4s] and lost with a full house, Queens full of Fours



PokerStars Game #59938913892:  Hold'em No Limit ($0.25/$0.50) - 2009/07/01 0:26:40 ET
Table 'MJxeZCzYELxiIsyUZyT0jw' 6-max Seat #3 is the button
Seat 1: wOyVV9M/oyiw3YaOjNZ05w ($51.85 in chips)
Seat 3: JQZew0FjzS19kTjeNtrE+A ($50 in chips)
Seat 4: lP7Q6pewz4C2RsAfKsjdWw ($38.05 in chips)
Seat 5: 3jvoOXNtXE90w2BdfNZwZQ ($52.30 in chips)
Seat 6: TTx3CHxyi0SObcHyMJRp5w ($48.75 in chips)
lP7Q6pewz4C2RsAfKsjdWw: posts small blind $0.25
3jvoOXNtXE90w2BdfNZwZQ: posts big blind $0.50
*** HOLE CARDS ***
TTx3CHxyi0SObcHyMJRp5w: folds
dB6jzDlJmET84VMWw1mTRA joins the table at seat #2
wOyVV9M/oyiw3YaOjNZ05w: folds
JQZew0FjzS19kTjeNtrE+A: folds
lP7Q6pewz4C2RsAfKsjdWw: calls $0.25
3jvoOXNtXE90w2BdfNZwZQ: raises $1.50 to $2
lP7Q6pewz4C2RsAfKsjdWw: folds
3jvoOXNtXE90w2BdfNZwZQ collected $1 from pot
3jvoOXNtXE90w2BdfNZwZQ: doesn't show hand
*** SUMMARY ***
Total pot $1 | Rake $0
Seat 1: wOyVV9M/oyiw3YaOjNZ05w folded before Flop (didn't bet)
Seat 3: JQZew0FjzS19kTjeNtrE+A (button) folded before Flop (didn't bet)
Seat 4: lP7Q6pewz4C2RsAfKsjdWw (small blind) folded before Flop
Seat 5: 3jvoOXNtXE90w2BdfNZwZQ (big blind) collected ($1)
Seat 6: TTx3CHxyi0SObcHyMJRp5w folded before Flop (didn't bet)



PokerStars Game #59938914840:  Hold'em No Limit ($0.25/$0.50) - 2009/07/01 0:26:41 ET
Table 'kgbJRsxfv64KrErDRBAkcw' 6-max Seat #3 is the button
Seat 1: N7O9jUEx2YiQn1+yRYTHmw ($16.85 in chips)
Seat 2: Q+thC23WCv1kJUJtH/+4Jw ($67.15 in chips)
Seat 3: T0Gx/FcQ5VH9u7XaOMX97A ($61.60 in chips)
Seat 4: qanMEqjABjWxC/JgQ/0l7w ($59.45 in chips)
Seat 5: +Pf9jTVizYlIo+woPvptfA ($50 in chips)
Seat 6: ozrlafxxh1HmYdA0/h+MuA ($6 in chips)
qanMEqjABjWxC/JgQ/0l7w: posts small blind $0.25
+Pf9jTVizYlIo+woPvptfA: posts big blind $0.50
*** HOLE CARDS ***
ozrlafxxh1HmYdA0/h+MuA: calls $0.50
N7O9jUEx2YiQn1+yRYTHmw: calls $0.50
Q+thC23WCv1kJUJtH/+4Jw: folds
T0Gx/FcQ5VH9u7XaOMX97A: folds
qanMEqjABjWxC/JgQ/0l7w: folds
+Pf9jTVizYlIo+woPvptfA: checks
*** FLOP *** [8s Qh 2d]
+Pf9jTVizYlIo+woPvptfA: checks
ozrlafxxh1HmYdA0/h+MuA: checks
N7O9jUEx2YiQn1+yRYTHmw: checks
*** TURN *** [8s Qh 2d] [Kc]
+Pf9jTVizYlIo+woPvptfA: checks
ozrlafxxh1HmYdA0/h+MuA: checks
N7O9jUEx2YiQn1+yRYTHmw: bets $0.50
+Pf9jTVizYlIo+woPvptfA: folds
ozrlafxxh1HmYdA0/h+MuA: folds
N7O9jUEx2YiQn1+yRYTHmw collected $1.70 from pot
N7O9jUEx2YiQn1+yRYTHmw: doesn't show hand
*** SUMMARY ***
Total pot $1.75 | Rake $0.05
Board [8s Qh 2d Kc]
Seat 1: N7O9jUEx2YiQn1+yRYTHmw collected ($1.70)
Seat 2: Q+thC23WCv1kJUJtH/+4Jw folded before Flop (didn't bet)
Seat 3: T0Gx/FcQ5VH9u7XaOMX97A (button) folded before Flop (didn't bet)
Seat 4: qanMEqjABjWxC/JgQ/0l7w (small blind) folded before Flop
Seat 5: +Pf9jTVizYlIo+woPvptfA (big blind) folded on the Turn
Seat 6: ozrlafxxh1HmYdA0/h+MuA folded on the Turn



PokerStars Game #59938915998:  Hold'em No Limit ($0.25/$0.50) - 2009/07/01 0:26:43 ET
Table 'fx6MqwfYAj/Rt86hBz2L3Q' 9-max Seat #3 is the button
Seat 1: jf2c/o9gI7Xj0GleCSMj9g ($50.55 in chips)
Seat 2: C3rGXblctNcWI6JYPHhaEg ($15.40 in chips)
Seat 3: iadBi5AEt7gTBXbDSSnMYQ ($51.95 in chips)
Seat 4: gPEN9Zp33YTm/mu9/SYP1w ($24.95 in chips)
Seat 5: iAISe3dVeua8PUn2wwgDHw ($26.50 in chips)
Seat 7: bkXkL3pmapikPQQRNPZSEA ($6.75 in chips)
Seat 8: 6ol/q1A4zYU6qXbZnTzPfQ ($19.80 in chips)
Seat 9: HZkVla4kK2SI42CVrPZ/ig ($9.25 in chips)
gPEN9Zp33YTm/mu9/SYP1w: posts small blind $0.25
iAISe3dVeua8PUn2wwgDHw: posts big blind $0.50
5k9fvXD9suIgCxU4HLQjTw: sits out
*** HOLE CARDS ***
bkXkL3pmapikPQQRNPZSEA: raises $1 to $1.50
6ol/q1A4zYU6qXbZnTzPfQ: folds
HZkVla4kK2SI42CVrPZ/ig: folds
jf2c/o9gI7Xj0GleCSMj9g: folds
C3rGXblctNcWI6JYPHhaEg: calls $1.50
iadBi5AEt7gTBXbDSSnMYQ: raises $1 to $2.50
gPEN9Zp33YTm/mu9/SYP1w: folds
iAISe3dVeua8PUn2wwgDHw: folds
bkXkL3pmapikPQQRNPZSEA: calls $1
C3rGXblctNcWI6JYPHhaEg: calls $1
*** FLOP *** [4d 3h 6c]
bkXkL3pmapikPQQRNPZSEA: checks
C3rGXblctNcWI6JYPHhaEg: checks
iadBi5AEt7gTBXbDSSnMYQ: bets $1
bkXkL3pmapikPQQRNPZSEA: raises $3.25 to $4.25 and is all-in
C3rGXblctNcWI6JYPHhaEg: calls $4.25
iadBi5AEt7gTBXbDSSnMYQ: folds
*** TURN *** [4d 3h 6c] [2h]
*** RIVER *** [4d 3h 6c 2h] [9d]
*** SHOW DOWN ***
bkXkL3pmapikPQQRNPZSEA: shows [9c 9h] (three of a kind, Nines)
C3rGXblctNcWI6JYPHhaEg: mucks hand
bkXkL3pmapikPQQRNPZSEA collected $16.90 from pot
*** SUMMARY ***
Total pot $17.75 | Rake $0.85
Board [4d 3h 6c 2h 9d]
Seat 1: jf2c/o9gI7Xj0GleCSMj9g folded before Flop (didn't bet)
Seat 2: C3rGXblctNcWI6JYPHhaEg mucked
Seat 3: iadBi5AEt7gTBXbDSSnMYQ (button) folded on the Flop
Seat 4: gPEN9Zp33YTm/mu9/SYP1w (small blind) folded before Flop
Seat 5: iAISe3dVeua8PUn2wwgDHw (big blind) folded before Flop
Seat 7: bkXkL3pmapikPQQRNPZSEA showed [9c 9h] and won ($16.90) with three of a kind, Nines
Seat 8: 6ol/q1A4zYU6qXbZnTzPfQ folded before Flop (didn't bet)
Seat 9: HZkVla4kK2SI42CVrPZ/ig folded before Flop (didn't bet)



PokerStars Game #59938918302:  Hold'em No Limit ($0.25/$0.50) - 2009/07/01 0:26:47 ET
Table 'c/CRn+68J3Y8KxD5g1ek2Q' 2-max Seat #1 is the button
Seat 1: 46qCyJ6evTkHo9al5sBMNA ($272 in chips)
Seat 2: BypVLsYQt3ePFm2xQL/dOA ($108.10 in chips)
46qCyJ6evTkHo9al5sBMNA: posts small blind $0.25
BypVLsYQt3ePFm2xQL/dOA: posts big blind $0.50
*** HOLE CARDS ***
46qCyJ6evTkHo9al5sBMNA: folds
BypVLsYQt3ePFm2xQL/dOA collected $0.50 from pot
BypVLsYQt3ePFm2xQL/dOA: doesn't show hand
*** SUMMARY ***
Total pot $0.50 | Rake $0
Seat 1: 46qCyJ6evTkHo9al5sBMNA (button) (small blind) folded before Flop
Seat 2: BypVLsYQt3ePFm2xQL/dOA (big blind) collected ($0.50)



PokerStars Game #59938918220:  Hold'em No Limit ($0.25/$0.50) - 2009/07/01 0:26:47 ET
Table '+dXkOAQyS8j9PQZusUTMpg' 2-max Seat #1 is the button
Seat 1: XFa6sBGjP2gxoIvxR3fZIg ($58.10 in chips)
Seat 2: 5IBeOgaApY1Bvzv2P8X4EA ($48 in chips)
XFa6sBGjP2gxoIvxR3fZIg: posts small blind $0.25
5IBeOgaApY1Bvzv2P8X4EA: posts big blind $0.50
*** HOLE CARDS ***
XFa6sBGjP2gxoIvxR3fZIg: raises $1 to $1.50
5IBeOgaApY1Bvzv2P8X4EA: calls $1
*** FLOP *** [6h 5s 3h]
5IBeOgaApY1Bvzv2P8X4EA: checks
XFa6sBGjP2gxoIvxR3fZIg: bets $2
5IBeOgaApY1Bvzv2P8X4EA: calls $2
*** TURN *** [6h 5s 3h] [4s]
5IBeOgaApY1Bvzv2P8X4EA: checks
XFa6sBGjP2gxoIvxR3fZIg: bets $5.50
5IBeOgaApY1Bvzv2P8X4EA: raises $6 to $11.50
XFa6sBGjP2gxoIvxR3fZIg: raises $43.10 to $54.60 and is all-in
5IBeOgaApY1Bvzv2P8X4EA: calls $33 and is all-in
*** RIVER *** [6h 5s 3h 4s] [Qc]
*** SHOW DOWN ***
5IBeOgaApY1Bvzv2P8X4EA: shows [8s 7d] (a straight, Four to Eight)
XFa6sBGjP2gxoIvxR3fZIg: mucks hand
5IBeOgaApY1Bvzv2P8X4EA collected $95.50 from pot
*** SUMMARY ***
Total pot $96 | Rake $0.50
Board [6h 5s 3h 4s Qc]
Seat 1: XFa6sBGjP2gxoIvxR3fZIg (button) (small blind) mucked
Seat 2: 5IBeOgaApY1Bvzv2P8X4EA (big blind) showed [8s 7d] and won ($95.50) with a straight, Four to Eight



PokerStars Game #59938918998:  Hold'em No Limit ($0.25/$0.50) - 2009/07/01 0:26:48 ET
Table '5EmHi+fnatGQQShcNmzOZQ' 6-max Seat #3 is the button
Seat 1: SwPczQo3cOtwEzhJrfO2cQ ($26.70 in chips)
Seat 3: L9qfLYXrczhAPd/VckgsWw ($58.80 in chips)
Seat 4: wOyVV9M/oyiw3YaOjNZ05w ($50 in chips)
Seat 5: kxPhs4ePFqMy52CInAJ2aw ($48 in chips)
Seat 6: 686aeHikcJlgKkSuIFdcXQ ($158.65 in chips)
wOyVV9M/oyiw3YaOjNZ05w: posts small blind $0.25
kxPhs4ePFqMy52CInAJ2aw: posts big blind $0.50
*** HOLE CARDS ***
686aeHikcJlgKkSuIFdcXQ: raises $1.50 to $2
SwPczQo3cOtwEzhJrfO2cQ: folds
L9qfLYXrczhAPd/VckgsWw: folds
wOyVV9M/oyiw3YaOjNZ05w: folds
kxPhs4ePFqMy52CInAJ2aw: raises $4.50 to $6.50
686aeHikcJlgKkSuIFdcXQ: calls $4.50
*** FLOP *** [Jd Qh Ac]
kxPhs4ePFqMy52CInAJ2aw: bets $8
686aeHikcJlgKkSuIFdcXQ: calls $8
*** TURN *** [Jd Qh Ac] [5s]
kxPhs4ePFqMy52CInAJ2aw: bets $18
686aeHikcJlgKkSuIFdcXQ: folds
kxPhs4ePFqMy52CInAJ2aw collected $27.85 from pot
kxPhs4ePFqMy52CInAJ2aw: doesn't show hand
APwvTk5XojDXGoQLb4O5iA leaves the table
*** SUMMARY ***
Total pot $29.25 | Rake $1.40
Board [Jd Qh Ac 5s]
Seat 1: SwPczQo3cOtwEzhJrfO2cQ folded before Flop (didn't bet)
Seat 3: L9qfLYXrczhAPd/VckgsWw (button) folded before Flop (didn't bet)
Seat 4: wOyVV9M/oyiw3YaOjNZ05w (small blind) folded before Flop
Seat 5: kxPhs4ePFqMy52CInAJ2aw (big blind) collected ($27.85)
Seat 6: 686aeHikcJlgKkSuIFdcXQ folded on the Turn



PokerStars Game #59938919556:  Hold'em No Limit ($0.25/$0.50) - 2009/07/01 0:26:49 ET
Table 'T/PgNWqVyY6lkldcBVXYJQ' 6-max Seat #1 is the button
Seat 1: +Pf9jTVizYlIo+woPvptfA ($50 in chips)
Seat 2: oZAeY5rVqNGgt8yyQ0pxbA ($33.45 in chips)
Seat 3: L3OcNO1bgdqDI46j67KQPQ ($53.30 in chips)
Seat 4: jxMvxeUUL9UU0V6wVU+Iyw ($9.95 in chips)
Seat 5: vVQBckETtigfb5mAcyK0OA ($49.35 in chips)
Seat 6: cDzbog6kwmJp+LBeBq+iMQ ($60.75 in chips)
oZAeY5rVqNGgt8yyQ0pxbA: posts small blind $0.25
L3OcNO1bgdqDI46j67KQPQ: posts big blind $0.50
*** HOLE CARDS ***
jxMvxeUUL9UU0V6wVU+Iyw said, "Of course.  Your out of your comfort zone on this. I get it...."
jxMvxeUUL9UU0V6wVU+Iyw: folds
vVQBckETtigfb5mAcyK0OA: calls $0.50
cDzbog6kwmJp+LBeBq+iMQ: calls $0.50
+Pf9jTVizYlIo+woPvptfA: folds
oZAeY5rVqNGgt8yyQ0pxbA: calls $0.25
L3OcNO1bgdqDI46j67KQPQ: checks
*** FLOP *** [5d 4c Jh]
oZAeY5rVqNGgt8yyQ0pxbA: bets $1.50
L3OcNO1bgdqDI46j67KQPQ: folds
vVQBckETtigfb5mAcyK0OA: folds
cDzbog6kwmJp+LBeBq+iMQ: calls $1.50
*** TURN *** [5d 4c Jh] [8d]
oZAeY5rVqNGgt8yyQ0pxbA: bets $2
cDzbog6kwmJp+LBeBq+iMQ: calls $2
*** RIVER *** [5d 4c Jh 8d] [Kd]
oZAeY5rVqNGgt8yyQ0pxbA: bets $3.50
cDzbog6kwmJp+LBeBq+iMQ: folds
oZAeY5rVqNGgt8yyQ0pxbA collected $8.60 from pot
oZAeY5rVqNGgt8yyQ0pxbA: doesn't show hand
*** SUMMARY ***
Total pot $9 | Rake $0.40
Board [5d 4c Jh 8d Kd]
Seat 1: +Pf9jTVizYlIo+woPvptfA (button) folded before Flop (didn't bet)
Seat 2: oZAeY5rVqNGgt8yyQ0pxbA (small blind) collected ($8.60)
Seat 3: L3OcNO1bgdqDI46j67KQPQ (big blind) folded on the Flop
Seat 4: jxMvxeUUL9UU0V6wVU+Iyw folded before Flop (didn't bet)
Seat 5: vVQBckETtigfb5mAcyK0OA folded on the Flop
Seat 6: cDzbog6kwmJp+LBeBq+iMQ folded on the River



PokerStars Game #59938922152:  Hold'em No Limit ($0.25/$0.50) - 2009/07/01 0:26:53 ET
Table 'IeNZOZQ4T6oiaHqFeo6yIA' 2-max Seat #1 is the button
Seat 1: ndd1nfncBkWNitBnsfCoVQ ($90.30 in chips)
Seat 2: A91IUl5JaZROhtfCtnnwYw ($43.25 in chips)
ndd1nfncBkWNitBnsfCoVQ: posts small blind $0.25
A91IUl5JaZROhtfCtnnwYw: posts big blind $0.50
*** HOLE CARDS ***
ndd1nfncBkWNitBnsfCoVQ: raises $1 to $1.50
A91IUl5JaZROhtfCtnnwYw: calls $1
*** FLOP *** [5c 7c 4d]
A91IUl5JaZROhtfCtnnwYw: checks
ndd1nfncBkWNitBnsfCoVQ: bets $2
A91IUl5JaZROhtfCtnnwYw: calls $2
*** TURN *** [5c 7c 4d] [2h]
A91IUl5JaZROhtfCtnnwYw: checks
ndd1nfncBkWNitBnsfCoVQ: checks
*** RIVER *** [5c 7c 4d 2h] [7s]
A91IUl5JaZROhtfCtnnwYw: bets $7.50
ndd1nfncBkWNitBnsfCoVQ: folds
A91IUl5JaZROhtfCtnnwYw collected $6.70 from pot
*** SUMMARY ***
Total pot $7 | Rake $0.30
Board [5c 7c 4d 2h 7s]
Seat 1: ndd1nfncBkWNitBnsfCoVQ (button) (small blind) folded on the River
Seat 2: A91IUl5JaZROhtfCtnnwYw (big blind) collected ($6.70)



PokerStars Game #59938922716:  Hold'em No Limit ($0.25/$0.50) - 2009/07/01 0:26:53 ET
Table 'GfL/No5u5PoEnU39lP5pQg' 6-max Seat #1 is the button
Seat 1: 1WUCqNG+p+vfWRTXNu4ljw ($51.40 in chips)
Seat 2: uVwggSetzp7d+eVgowO3vg ($44 in chips)
Seat 4: OZ6OtYh5Y53MCH/p0QTn5g ($52.35 in chips)
Seat 5: crjGpJEzSZgD38FoE3VMGg ($53.55 in chips)
uVwggSetzp7d+eVgowO3vg: posts small blind $0.25
qNezhXOOUXqwG7b9X5XJAA: is sitting out
OZ6OtYh5Y53MCH/p0QTn5g: posts big blind $0.50
*** HOLE CARDS ***
crjGpJEzSZgD38FoE3VMGg: folds
qNezhXOOUXqwG7b9X5XJAA leaves the table
1WUCqNG+p+vfWRTXNu4ljw: folds
uVwggSetzp7d+eVgowO3vg: calls $0.25
OZ6OtYh5Y53MCH/p0QTn5g: raises $1.50 to $2
uVwggSetzp7d+eVgowO3vg: folds
OZ6OtYh5Y53MCH/p0QTn5g collected $1 from pot
OZ6OtYh5Y53MCH/p0QTn5g: doesn't show hand
*** SUMMARY ***
Total pot $1 | Rake $0
Seat 1: 1WUCqNG+p+vfWRTXNu4ljw (button) folded before Flop (didn't bet)
Seat 2: uVwggSetzp7d+eVgowO3vg (small blind) folded before Flop
Seat 4: OZ6OtYh5Y53MCH/p0QTn5g (big blind) collected ($1)
Seat 5: crjGpJEzSZgD38FoE3VMGg folded before Flop (didn't bet)



PokerStars Game #59938923824:  Hold'em No Limit ($0.25/$0.50) - 2009/07/01 0:26:55 ET
Table 'mTxf8gPLgffN3Iwfm7Icfg' 2-max Seat #2 is the button
Seat 1: Do9Rlu1R5u/AcRtMTl8SYg ($95.20 in chips)
Seat 2: EMc5LPgVaded4Qc77vm0fw ($64.65 in chips)
EMc5LPgVaded4Qc77vm0fw: posts small blind $0.25
Do9Rlu1R5u/AcRtMTl8SYg: posts big blind $0.50
*** HOLE CARDS ***
EMc5LPgVaded4Qc77vm0fw: folds
Do9Rlu1R5u/AcRtMTl8SYg collected $0.50 from pot
Do9Rlu1R5u/AcRtMTl8SYg: doesn't show hand
*** SUMMARY ***
Total pot $0.50 | Rake $0
Seat 1: Do9Rlu1R5u/AcRtMTl8SYg (big blind) collected ($0.50)
Seat 2: EMc5LPgVaded4Qc77vm0fw (button) (small blind) folded before Flop



PokerStars Game #59938923448:  Hold'em No Limit ($0.25/$0.50) - 2009/07/01 0:26:55 ET
Table 'c/CRn+68J3Y8KxD5g1ek2Q' 2-max Seat #2 is the button
Seat 1: 46qCyJ6evTkHo9al5sBMNA ($271.75 in chips)
Seat 2: BypVLsYQt3ePFm2xQL/dOA ($108.35 in chips)
BypVLsYQt3ePFm2xQL/dOA: posts small blind $0.25
46qCyJ6evTkHo9al5sBMNA: posts big blind $0.50
*** HOLE CARDS ***
BypVLsYQt3ePFm2xQL/dOA: raises $0.50 to $1
46qCyJ6evTkHo9al5sBMNA: raises $3 to $4
BypVLsYQt3ePFm2xQL/dOA: raises $6.50 to $10.50
46qCyJ6evTkHo9al5sBMNA: calls $6.50
*** FLOP *** [4s 9c 6s]
46qCyJ6evTkHo9al5sBMNA: checks
BypVLsYQt3ePFm2xQL/dOA: bets $20.50
46qCyJ6evTkHo9al5sBMNA: folds
BypVLsYQt3ePFm2xQL/dOA collected $20.50 from pot
BypVLsYQt3ePFm2xQL/dOA: doesn't show hand
*** SUMMARY ***
Total pot $21 | Rake $0.50
Board [4s 9c 6s]
Seat 1: 46qCyJ6evTkHo9al5sBMNA (big blind) folded on the Flop
Seat 2: BypVLsYQt3ePFm2xQL/dOA (button) (small blind) collected ($20.50)



PokerStars Game #59938924810:  Hold'em No Limit ($0.25/$0.50) - 2009/07/01 0:26:57 ET
Table 'E7bWJ45aoFXRpyRv2gw+Ig' 2-max Seat #1 is the button
Seat 1: FRkiRasEGlHUeLrEl+k/nA ($53.75 in chips)
Seat 2: 3Wro85I7472vJ4Wkpneo9A ($123.70 in chips)
FRkiRasEGlHUeLrEl+k/nA: posts small blind $0.25
3Wro85I7472vJ4Wkpneo9A: posts big blind $0.50
*** HOLE CARDS ***
FRkiRasEGlHUeLrEl+k/nA: calls $0.25
3Wro85I7472vJ4Wkpneo9A: checks
*** FLOP *** [3c Js 6c]
3Wro85I7472vJ4Wkpneo9A: checks
FRkiRasEGlHUeLrEl+k/nA: checks
*** TURN *** [3c Js 6c] [Ac]
3Wro85I7472vJ4Wkpneo9A: checks
FRkiRasEGlHUeLrEl+k/nA: checks
*** RIVER *** [3c Js 6c Ac] [Qh]
3Wro85I7472vJ4Wkpneo9A: bets $1
FRkiRasEGlHUeLrEl+k/nA: folds
3Wro85I7472vJ4Wkpneo9A collected $0.95 from pot
3Wro85I7472vJ4Wkpneo9A: doesn't show hand
*** SUMMARY ***
Total pot $1 | Rake $0.05
Board [3c Js 6c Ac Qh]
Seat 1: FRkiRasEGlHUeLrEl+k/nA (button) (small blind) folded on the River
Seat 2: 3Wro85I7472vJ4Wkpneo9A (big blind) collected ($0.95)



PokerStars Game #59938925036:  Hold'em No Limit ($0.25/$0.50) - 2009/07/01 0:26:57 ET
Table 'eMxdLyFDf28E0wit6gm3Uw' 6-max Seat #3 is the button
Seat 1: tnD/64LagZ9qPaeOQVjVZg ($24.65 in chips)
Seat 2: jwuKQ1S3U4NnzMQn3E3dgw ($69.55 in chips)
Seat 3: dZcLsEI8iXkobBduRJ45Yw ($13.90 in chips)
Seat 4: QM93o65lI8kLzmiB/BILlA ($20.05 in chips)
Seat 6: L0aIPg7qefDQjdJo3HCVEA ($8 in chips)
QM93o65lI8kLzmiB/BILlA: posts small blind $0.25
L0aIPg7qefDQjdJo3HCVEA: posts big blind $0.50
*** HOLE CARDS ***
tnD/64LagZ9qPaeOQVjVZg: folds
jwuKQ1S3U4NnzMQn3E3dgw: calls $0.50
dZcLsEI8iXkobBduRJ45Yw: raises $1 to $1.50
QM93o65lI8kLzmiB/BILlA: folds
L0aIPg7qefDQjdJo3HCVEA: folds
jwuKQ1S3U4NnzMQn3E3dgw: calls $1
*** FLOP *** [7d Qd 5h]
jwuKQ1S3U4NnzMQn3E3dgw: checks
dZcLsEI8iXkobBduRJ45Yw: bets $1.50
jwuKQ1S3U4NnzMQn3E3dgw: calls $1.50
*** TURN *** [7d Qd 5h] [4h]
tnD/64LagZ9qPaeOQVjVZg is sitting out
tnD/64LagZ9qPaeOQVjVZg leaves the table
jwuKQ1S3U4NnzMQn3E3dgw: checks
dZcLsEI8iXkobBduRJ45Yw: bets $2.50
jwuKQ1S3U4NnzMQn3E3dgw: calls $2.50
*** RIVER *** [7d Qd 5h 4h] [2s]
jwuKQ1S3U4NnzMQn3E3dgw: checks
dZcLsEI8iXkobBduRJ45Yw: bets $4
jwuKQ1S3U4NnzMQn3E3dgw: folds
dZcLsEI8iXkobBduRJ45Yw collected $11.20 from pot
*** SUMMARY ***
Total pot $11.75 | Rake $0.55
Board [7d Qd 5h 4h 2s]
Seat 1: tnD/64LagZ9qPaeOQVjVZg folded before Flop (didn't bet)
Seat 2: jwuKQ1S3U4NnzMQn3E3dgw folded on the River
Seat 3: dZcLsEI8iXkobBduRJ45Yw (button) collected ($11.20)
Seat 4: QM93o65lI8kLzmiB/BILlA (small blind) folded before Flop
Seat 6: L0aIPg7qefDQjdJo3HCVEA (big blind) folded before Flop



PokerStars Game #59938926722:  Hold'em No Limit ($0.25/$0.50) - 2009/07/01 0:26:59 ET
Table 'ZYwMb9E6tY50Qm+iNbXRYw' 2-max Seat #2 is the button
Seat 1: DXLfRb8KDZWmrztw2bwtFw ($8.55 in chips)
Seat 2: 16tvT7AYgZ2LgiGFcvFKQg ($20.50 in chips)
16tvT7AYgZ2LgiGFcvFKQg: posts small blind $0.25
DXLfRb8KDZWmrztw2bwtFw: posts big blind $0.50
*** HOLE CARDS ***
16tvT7AYgZ2LgiGFcvFKQg: raises $0.50 to $1
DXLfRb8KDZWmrztw2bwtFw: folds
16tvT7AYgZ2LgiGFcvFKQg collected $1 from pot
16tvT7AYgZ2LgiGFcvFKQg: doesn't show hand
*** SUMMARY ***
Total pot $1 | Rake $0
Seat 1: DXLfRb8KDZWmrztw2bwtFw (big blind) folded before Flop
Seat 2: 16tvT7AYgZ2LgiGFcvFKQg (button) (small blind) collected ($1)



PokerStars Game #59938927402:  Hold'em No Limit ($0.25/$0.50) - 2009/07/01 0:27:00 ET
Table 'QOgaEqMcJ73pcUMMxoisUg' 6-max Seat #3 is the button
Seat 1: UaC1G3O4HWbowgSfeYnkog ($8.25 in chips)
Seat 2: Im2p1Nt83UKSqv5c9frm4Q ($50 in chips)
Seat 3: wUZNozoIDYf+16hp4nn6dw ($32.60 in chips)
Seat 4: zAcsDhG/T128Vn7XGVSgKg ($61.30 in chips)
Seat 5: 6vNxrjjCl6FwfaaymM9jjg ($31.05 in chips)
Seat 6: s83dnhZ6VC53vY0/f6OV/g ($42.35 in chips)
zAcsDhG/T128Vn7XGVSgKg: posts small blind $0.25
6vNxrjjCl6FwfaaymM9jjg: posts big blind $0.50
*** HOLE CARDS ***
s83dnhZ6VC53vY0/f6OV/g: folds
UaC1G3O4HWbowgSfeYnkog: folds
UaC1G3O4HWbowgSfeYnkog leaves the table
Im2p1Nt83UKSqv5c9frm4Q: folds
wUZNozoIDYf+16hp4nn6dw: raises $1 to $1.50
zAcsDhG/T128Vn7XGVSgKg: folds
6vNxrjjCl6FwfaaymM9jjg: calls $1
*** FLOP *** [6d 9c Qh]
6vNxrjjCl6FwfaaymM9jjg: checks
wUZNozoIDYf+16hp4nn6dw: bets $4
6vNxrjjCl6FwfaaymM9jjg: folds
wUZNozoIDYf+16hp4nn6dw collected $3.10 from pot
*** SUMMARY ***
Total pot $3.25 | Rake $0.15
Board [6d 9c Qh]
Seat 1: UaC1G3O4HWbowgSfeYnkog folded before Flop (didn't bet)
Seat 2: Im2p1Nt83UKSqv5c9frm4Q folded before Flop (didn't bet)
Seat 3: wUZNozoIDYf+16hp4nn6dw (button) collected ($3.10)
Seat 4: zAcsDhG/T128Vn7XGVSgKg (small blind) folded before Flop
Seat 5: 6vNxrjjCl6FwfaaymM9jjg (big blind) folded on the Flop
Seat 6: s83dnhZ6VC53vY0/f6OV/g folded before Flop (didn't bet)



PokerStars Game #59938927670:  Hold'em No Limit ($0.25/$0.50) - 2009/07/01 0:27:01 ET
Table 'mTxf8gPLgffN3Iwfm7Icfg' 2-max Seat #1 is the button
Seat 1: Do9Rlu1R5u/AcRtMTl8SYg ($95.45 in chips)
Seat 2: EMc5LPgVaded4Qc77vm0fw ($64.40 in chips)
Do9Rlu1R5u/AcRtMTl8SYg: posts small blind $0.25
EMc5LPgVaded4Qc77vm0fw: posts big blind $0.50
*** HOLE CARDS ***
Do9Rlu1R5u/AcRtMTl8SYg: folds
EMc5LPgVaded4Qc77vm0fw collected $0.50 from pot
EMc5LPgVaded4Qc77vm0fw: doesn't show hand
*** SUMMARY ***
Total pot $0.50 | Rake $0
Seat 1: Do9Rlu1R5u/AcRtMTl8SYg (button) (small blind) folded before Flop
Seat 2: EMc5LPgVaded4Qc77vm0fw (big blind) collected ($0.50)



PokerStars Game #59938927830:  Hold'em No Limit ($0.25/$0.50) - 2009/07/01 0:27:01 ET
Table 'tyR5AZNKV8Aadbrnrnlg7g' 6-max Seat #1 is the button
Seat 1: R+KjpH/wSjDLhtIy9+edNA ($85.50 in chips)
Seat 2: 58zdeSBSuSFX/qZfhc7YmA ($28.60 in chips)
Seat 3: tdOvWynovql5imfooroLMg ($50 in chips)
Seat 4: Rt6KgtZ8YaJoTc3FPim00w ($84.25 in chips)
Seat 5: wOyVV9M/oyiw3YaOjNZ05w ($54.60 in chips)
58zdeSBSuSFX/qZfhc7YmA: posts small blind $0.25
tdOvWynovql5imfooroLMg: posts big blind $0.50
*** HOLE CARDS ***
Rt6KgtZ8YaJoTc3FPim00w: folds
DMQLAmut/l19xN5STQndFg leaves the table
wOyVV9M/oyiw3YaOjNZ05w: folds
R+KjpH/wSjDLhtIy9+edNA: folds
58zdeSBSuSFX/qZfhc7YmA: folds
tdOvWynovql5imfooroLMg collected $0.50 from pot
*** SUMMARY ***
Total pot $0.50 | Rake $0
Seat 1: R+KjpH/wSjDLhtIy9+edNA (button) folded before Flop (didn't bet)
Seat 2: 58zdeSBSuSFX/qZfhc7YmA (small blind) folded before Flop
Seat 3: tdOvWynovql5imfooroLMg (big blind) collected ($0.50)
Seat 4: Rt6KgtZ8YaJoTc3FPim00w folded before Flop (didn't bet)
Seat 5: wOyVV9M/oyiw3YaOjNZ05w folded before Flop (didn't bet)



PokerStars Game #59938931492:  Hold'em No Limit ($0.25/$0.50) - 2009/07/01 0:27:06 ET
Table 'ZYwMb9E6tY50Qm+iNbXRYw' 2-max Seat #1 is the button
Seat 1: DXLfRb8KDZWmrztw2bwtFw ($8.05 in chips)
Seat 2: 16tvT7AYgZ2LgiGFcvFKQg ($21 in chips)
DXLfRb8KDZWmrztw2bwtFw: posts small blind $0.25
16tvT7AYgZ2LgiGFcvFKQg: posts big blind $0.50
*** HOLE CARDS ***
DXLfRb8KDZWmrztw2bwtFw: calls $0.25
16tvT7AYgZ2LgiGFcvFKQg: checks
*** FLOP *** [4c Ac 8h]
16tvT7AYgZ2LgiGFcvFKQg: checks
DXLfRb8KDZWmrztw2bwtFw: bets $1
16tvT7AYgZ2LgiGFcvFKQg: folds
DXLfRb8KDZWmrztw2bwtFw collected $0.95 from pot
DXLfRb8KDZWmrztw2bwtFw: doesn't show hand
*** SUMMARY ***
Total pot $1 | Rake $0.05
Board [4c Ac 8h]
Seat 1: DXLfRb8KDZWmrztw2bwtFw (button) (small blind) collected ($0.95)
Seat 2: 16tvT7AYgZ2LgiGFcvFKQg (big blind) folded on the Flop



PokerStars Game #59938931682:  Hold'em No Limit ($0.25/$0.50) - 2009/07/01 0:27:07 ET
Table 'mTxf8gPLgffN3Iwfm7Icfg' 2-max Seat #2 is the button
Seat 1: Do9Rlu1R5u/AcRtMTl8SYg ($95.20 in chips)
Seat 2: EMc5LPgVaded4Qc77vm0fw ($64.65 in chips)
EMc5LPgVaded4Qc77vm0fw: posts small blind $0.25
Do9Rlu1R5u/AcRtMTl8SYg: posts big blind $0.50
*** HOLE CARDS ***
EMc5LPgVaded4Qc77vm0fw: raises $1 to $1.50
Do9Rlu1R5u/AcRtMTl8SYg: folds
EMc5LPgVaded4Qc77vm0fw collected $1 from pot
EMc5LPgVaded4Qc77vm0fw: doesn't show hand
*** SUMMARY ***
Total pot $1 | Rake $0
Seat 1: Do9Rlu1R5u/AcRtMTl8SYg (big blind) folded before Flop
Seat 2: EMc5LPgVaded4Qc77vm0fw (button) (small blind) collected ($1)



PokerStars Game #59938932192:  Hold'em No Limit ($0.25/$0.50) - 2009/07/01 0:27:08 ET
Table 'otvGDROEDdqsabxskT79qg' 9-max Seat #1 is the button
Seat 1: 8ehL7qlZzjgUh2H35iiWLw ($50 in chips)
Seat 2: cCjTzH9jio8607WzjcfXlg ($11.80 in chips)
Seat 3: +k7T5ocke8UwavtgUHm+Cg ($75.70 in chips)
Seat 4: MG90wfSJZnOejs/KD3vlQQ ($51.80 in chips)
Seat 5: XNMDwbXt/Q4jM99AXnbJDw ($54.45 in chips)
Seat 7: C7+tBppJrKgd/r+tuKUIpA ($40.65 in chips)
Seat 9: KcY3X8YpD74Kw1RHkx/g4A ($61.60 in chips)
cCjTzH9jio8607WzjcfXlg: posts small blind $0.25
+k7T5ocke8UwavtgUHm+Cg: posts big blind $0.50
bxLSulbgr8LmKNjOzw8URg: sits out
zE9cVigS2nW/Ljy4K4bUQA: sits out
*** HOLE CARDS ***
MG90wfSJZnOejs/KD3vlQQ: folds
XNMDwbXt/Q4jM99AXnbJDw: folds
C7+tBppJrKgd/r+tuKUIpA: calls $0.50
KcY3X8YpD74Kw1RHkx/g4A: folds
8ehL7qlZzjgUh2H35iiWLw: folds
cCjTzH9jio8607WzjcfXlg: calls $0.25
+k7T5ocke8UwavtgUHm+Cg: checks
*** FLOP *** [Tc 9h 5s]
cCjTzH9jio8607WzjcfXlg: checks
+k7T5ocke8UwavtgUHm+Cg: checks
C7+tBppJrKgd/r+tuKUIpA: checks
*** TURN *** [Tc 9h 5s] [4d]
cCjTzH9jio8607WzjcfXlg: checks
+k7T5ocke8UwavtgUHm+Cg: checks
C7+tBppJrKgd/r+tuKUIpA: checks
*** RIVER *** [Tc 9h 5s 4d] [Ts]
cCjTzH9jio8607WzjcfXlg: checks
+k7T5ocke8UwavtgUHm+Cg: checks
C7+tBppJrKgd/r+tuKUIpA: checks
*** SHOW DOWN ***
cCjTzH9jio8607WzjcfXlg: shows [6d 8d] (a pair of Tens)
+k7T5ocke8UwavtgUHm+Cg: shows [7c Ac] (a pair of Tens - Ace kicker)
C7+tBppJrKgd/r+tuKUIpA: mucks hand
+k7T5ocke8UwavtgUHm+Cg collected $1.45 from pot
*** SUMMARY ***
Total pot $1.50 | Rake $0.05
Board [Tc 9h 5s 4d Ts]
Seat 1: 8ehL7qlZzjgUh2H35iiWLw (button) folded before Flop (didn't bet)
Seat 2: cCjTzH9jio8607WzjcfXlg (small blind) showed [6d 8d] and lost with a pair of Tens
Seat 3: +k7T5ocke8UwavtgUHm+Cg (big blind) showed [7c Ac] and won ($1.45) with a pair of Tens
Seat 4: MG90wfSJZnOejs/KD3vlQQ folded before Flop (didn't bet)
Seat 5: XNMDwbXt/Q4jM99AXnbJDw folded before Flop (didn't bet)
Seat 7: C7+tBppJrKgd/r+tuKUIpA mucked
Seat 9: KcY3X8YpD74Kw1RHkx/g4A folded before Flop (didn't bet)



PokerStars Game #59938933412:  Hold'em No Limit ($0.25/$0.50) - 2009/07/01 0:27:09 ET
Table 'GfL/No5u5PoEnU39lP5pQg' 6-max Seat #2 is the button
Seat 1: 1WUCqNG+p+vfWRTXNu4ljw ($51.40 in chips)
Seat 2: uVwggSetzp7d+eVgowO3vg ($43.50 in chips)
Seat 4: OZ6OtYh5Y53MCH/p0QTn5g ($52.85 in chips)
Seat 5: crjGpJEzSZgD38FoE3VMGg ($53.55 in chips)
OZ6OtYh5Y53MCH/p0QTn5g: posts small blind $0.25
crjGpJEzSZgD38FoE3VMGg: posts big blind $0.50
*** HOLE CARDS ***
1WUCqNG+p+vfWRTXNu4ljw: folds
uVwggSetzp7d+eVgowO3vg: calls $0.50
OZ6OtYh5Y53MCH/p0QTn5g: calls $0.25
crjGpJEzSZgD38FoE3VMGg: checks
*** FLOP *** [8h 2c 6s]
OZ6OtYh5Y53MCH/p0QTn5g: bets $1.50
crjGpJEzSZgD38FoE3VMGg: folds
uVwggSetzp7d+eVgowO3vg: calls $1.50
*** TURN *** [8h 2c 6s] [9s]
OZ6OtYh5Y53MCH/p0QTn5g: bets $3.50
uVwggSetzp7d+eVgowO3vg: calls $3.50
*** RIVER *** [8h 2c 6s 9s] [Kh]
OZ6OtYh5Y53MCH/p0QTn5g: bets $6
uVwggSetzp7d+eVgowO3vg: calls $6
*** SHOW DOWN ***
OZ6OtYh5Y53MCH/p0QTn5g: shows [9c 8c] (two pair, Nines and Eights)
uVwggSetzp7d+eVgowO3vg: shows [Kd 8d] (two pair, Kings and Eights)
uVwggSetzp7d+eVgowO3vg collected $22.40 from pot
*** SUMMARY ***
Total pot $23.50 | Rake $1.10
Board [8h 2c 6s 9s Kh]
Seat 1: 1WUCqNG+p+vfWRTXNu4ljw folded before Flop (didn't bet)
Seat 2: uVwggSetzp7d+eVgowO3vg (button) showed [Kd 8d] and won ($22.40) with two pair, Kings and Eights
Seat 4: OZ6OtYh5Y53MCH/p0QTn5g (small blind) showed [9c 8c] and lost with two pair, Nines and Eights
Seat 5: crjGpJEzSZgD38FoE3VMGg (big blind) folded on the Flop



PokerStars Game #59938934346:  Hold'em No Limit ($0.25/$0.50) - 2009/07/01 0:27:11 ET
Table 'hSTs/dUsYLgJQuF2Onp0MQ' 6-max Seat #5 is the button
Seat 1: Donj3X7gYzeS5pAl7s9f+Q ($32.70 in chips)
Seat 2: 6vNxrjjCl6FwfaaymM9jjg ($23.65 in chips)
Seat 4: L0aIPg7qefDQjdJo3HCVEA ($9.25 in chips)
Seat 5: 686aeHikcJlgKkSuIFdcXQ ($58.60 in chips)
Seat 6: +laPa9P7BjZKKnR0n+OmvA ($9.20 in chips)
+laPa9P7BjZKKnR0n+OmvA: posts small blind $0.25
Donj3X7gYzeS5pAl7s9f+Q: posts big blind $0.50
C3qJBo7uxfFVDluE1lmK2w: sits out
*** HOLE CARDS ***
6vNxrjjCl6FwfaaymM9jjg: folds
L0aIPg7qefDQjdJo3HCVEA: folds
686aeHikcJlgKkSuIFdcXQ: raises $1.50 to $2
+laPa9P7BjZKKnR0n+OmvA: folds
Donj3X7gYzeS5pAl7s9f+Q: calls $1.50
*** FLOP *** [9s As 8c]
Donj3X7gYzeS5pAl7s9f+Q: checks
686aeHikcJlgKkSuIFdcXQ: bets $4
Donj3X7gYzeS5pAl7s9f+Q: folds
686aeHikcJlgKkSuIFdcXQ collected $4.05 from pot
*** SUMMARY ***
Total pot $4.25 | Rake $0.20
Board [9s As 8c]
Seat 1: Donj3X7gYzeS5pAl7s9f+Q (big blind) folded on the Flop
Seat 2: 6vNxrjjCl6FwfaaymM9jjg folded before Flop (didn't bet)
Seat 4: L0aIPg7qefDQjdJo3HCVEA folded before Flop (didn't bet)
Seat 5: 686aeHikcJlgKkSuIFdcXQ (button) collected ($4.05)
Seat 6: +laPa9P7BjZKKnR0n+OmvA (small blind) folded before Flop



PokerStars Game #59938934262:  Hold'em No Limit ($0.25/$0.50) - 2009/07/01 0:27:11 ET
Table 'lSisgp6H7Fg1hH5VfjEjYQ' 9-max Seat #7 is the button
Seat 1: pEW8B6uXbdR47kfljMQ3+Q ($38.60 in chips)
Seat 2: UrcnkQOiLVk8BlKDPJSy7Q ($50.35 in chips)
Seat 3: aTkyjTh3w5YLWiIERupZOA ($39.40 in chips)
Seat 4: bwv/rbH/hHhPhY6u9mu04w ($24.25 in chips)
Seat 5: mSD1pginDsyHG5PDfqzphw ($10 in chips)
Seat 6: +k7T5ocke8UwavtgUHm+Cg ($25.85 in chips)
Seat 7: dGw5MBstXyXhWHHVFOWOFA ($42 in chips)
Seat 8: a4JDWmpFQkL10XfAyuF51A ($38.50 in chips)
Seat 9: 5JJVDlaiMnB004o/RqbZZQ ($40.50 in chips)
a4JDWmpFQkL10XfAyuF51A: posts small blind $0.25
5JJVDlaiMnB004o/RqbZZQ: posts big blind $0.50
*** HOLE CARDS ***
pEW8B6uXbdR47kfljMQ3+Q: folds
UrcnkQOiLVk8BlKDPJSy7Q: folds
aTkyjTh3w5YLWiIERupZOA: folds
bwv/rbH/hHhPhY6u9mu04w: calls $0.50
mSD1pginDsyHG5PDfqzphw: folds
+k7T5ocke8UwavtgUHm+Cg: calls $0.50
dGw5MBstXyXhWHHVFOWOFA: folds
a4JDWmpFQkL10XfAyuF51A: calls $0.25
5JJVDlaiMnB004o/RqbZZQ: checks
*** FLOP *** [2s 6d Kc]
a4JDWmpFQkL10XfAyuF51A: checks
5JJVDlaiMnB004o/RqbZZQ: checks
bwv/rbH/hHhPhY6u9mu04w: bets $0.50
+k7T5ocke8UwavtgUHm+Cg: folds
a4JDWmpFQkL10XfAyuF51A: folds
5JJVDlaiMnB004o/RqbZZQ: folds
pEW8B6uXbdR47kfljMQ3+Q is disconnected
bwv/rbH/hHhPhY6u9mu04w collected $1.90 from pot
*** SUMMARY ***
Total pot $2 | Rake $0.10
Board [2s 6d Kc]
Seat 1: pEW8B6uXbdR47kfljMQ3+Q folded before Flop (didn't bet)
Seat 2: UrcnkQOiLVk8BlKDPJSy7Q folded before Flop (didn't bet)
Seat 3: aTkyjTh3w5YLWiIERupZOA folded before Flop (didn't bet)
Seat 4: bwv/rbH/hHhPhY6u9mu04w collected ($1.90)
Seat 5: mSD1pginDsyHG5PDfqzphw folded before Flop (didn't bet)
Seat 6: +k7T5ocke8UwavtgUHm+Cg folded on the Flop
Seat 7: dGw5MBstXyXhWHHVFOWOFA (button) folded before Flop (didn't bet)
Seat 8: a4JDWmpFQkL10XfAyuF51A (small blind) folded on the Flop
Seat 9: 5JJVDlaiMnB004o/RqbZZQ (big blind) folded on the Flop



PokerStars Game #59938935722:  Hold'em No Limit ($0.25/$0.50) - 2009/07/01 0:27:13 ET
Table 'NCiXr0d5CEKBQr/cZgLhbA' 9-max Seat #6 is the button
Seat 1: RjBdQ6w31rgcy0o24VLR6w ($15.85 in chips)
Seat 2: ulxuJchBV9iguXg0FUonfg ($35.20 in chips)
Seat 3: xZCXQSXlrZkp3pZizzVXCw ($56.90 in chips)
Seat 4: 5k9fvXD9suIgCxU4HLQjTw ($50 in chips)
Seat 5: zE9cVigS2nW/Ljy4K4bUQA ($39.50 in chips)
Seat 6: SKnJuWHScqetA/qG5p+wCg ($30 in chips)
Seat 7: M+7+BTmX5vZatHVuoRB1nA ($48.75 in chips)
Seat 8: 1MJUKc3cc0QmUoz1JZLR2w ($53.85 in chips)
M+7+BTmX5vZatHVuoRB1nA: posts small blind $0.25
1MJUKc3cc0QmUoz1JZLR2w: posts big blind $0.50
4WLZvqBn5qv5tds5kt5A1Q: sits out
*** HOLE CARDS ***
RjBdQ6w31rgcy0o24VLR6w: folds
ulxuJchBV9iguXg0FUonfg: folds
xZCXQSXlrZkp3pZizzVXCw: raises $1 to $1.50
5k9fvXD9suIgCxU4HLQjTw: folds
zE9cVigS2nW/Ljy4K4bUQA: folds
SKnJuWHScqetA/qG5p+wCg: folds
M+7+BTmX5vZatHVuoRB1nA: folds
1MJUKc3cc0QmUoz1JZLR2w: folds
xZCXQSXlrZkp3pZizzVXCw collected $1.25 from pot
xZCXQSXlrZkp3pZizzVXCw: doesn't show hand
*** SUMMARY ***
Total pot $1.25 | Rake $0
Seat 1: RjBdQ6w31rgcy0o24VLR6w folded before Flop (didn't bet)
Seat 2: ulxuJchBV9iguXg0FUonfg folded before Flop (didn't bet)
Seat 3: xZCXQSXlrZkp3pZizzVXCw collected ($1.25)
Seat 4: 5k9fvXD9suIgCxU4HLQjTw folded before Flop (didn't bet)
Seat 5: zE9cVigS2nW/Ljy4K4bUQA folded before Flop (didn't bet)
Seat 6: SKnJuWHScqetA/qG5p+wCg (button) folded before Flop (didn't bet)
Seat 7: M+7+BTmX5vZatHVuoRB1nA (small blind) folded before Flop
Seat 8: 1MJUKc3cc0QmUoz1JZLR2w (big blind) folded before Flop



PokerStars Game #59938937060:  Hold'em No Limit ($0.25/$0.50) - 2009/07/01 0:27:15 ET
Table 'mTxf8gPLgffN3Iwfm7Icfg' 2-max Seat #1 is the button
Seat 1: Do9Rlu1R5u/AcRtMTl8SYg ($94.70 in chips)
Seat 2: EMc5LPgVaded4Qc77vm0fw ($65.15 in chips)
Do9Rlu1R5u/AcRtMTl8SYg: posts small blind $0.25
EMc5LPgVaded4Qc77vm0fw: posts big blind $0.50
*** HOLE CARDS ***
Do9Rlu1R5u/AcRtMTl8SYg: folds
EMc5LPgVaded4Qc77vm0fw collected $0.50 from pot
EMc5LPgVaded4Qc77vm0fw: doesn't show hand
*** SUMMARY ***
Total pot $0.50 | Rake $0
Seat 1: Do9Rlu1R5u/AcRtMTl8SYg (button) (small blind) folded before Flop
Seat 2: EMc5LPgVaded4Qc77vm0fw (big blind) collected ($0.50)



PokerStars Game #59938937768:  Hold'em No Limit ($0.25/$0.50) - 2009/07/01 0:27:16 ET
Table 'E7bWJ45aoFXRpyRv2gw+Ig' 2-max Seat #2 is the button
Seat 1: FRkiRasEGlHUeLrEl+k/nA ($53.25 in chips)
Seat 2: 3Wro85I7472vJ4Wkpneo9A ($124.15 in chips)
3Wro85I7472vJ4Wkpneo9A: posts small blind $0.25
FRkiRasEGlHUeLrEl+k/nA: posts big blind $0.50
*** HOLE CARDS ***
3Wro85I7472vJ4Wkpneo9A: calls $0.25
FRkiRasEGlHUeLrEl+k/nA: checks
*** FLOP *** [Ah 3c As]
FRkiRasEGlHUeLrEl+k/nA: checks
3Wro85I7472vJ4Wkpneo9A: bets $1
FRkiRasEGlHUeLrEl+k/nA: calls $1
*** TURN *** [Ah 3c As] [9s]
FRkiRasEGlHUeLrEl+k/nA: checks
3Wro85I7472vJ4Wkpneo9A: checks
*** RIVER *** [Ah 3c As 9s] [6h]
FRkiRasEGlHUeLrEl+k/nA: bets $4
3Wro85I7472vJ4Wkpneo9A: folds
FRkiRasEGlHUeLrEl+k/nA collected $2.90 from pot
FRkiRasEGlHUeLrEl+k/nA: doesn't show hand
*** SUMMARY ***
Total pot $3 | Rake $0.10
Board [Ah 3c As 9s 6h]
Seat 1: FRkiRasEGlHUeLrEl+k/nA (big blind) collected ($2.90)
Seat 2: 3Wro85I7472vJ4Wkpneo9A (button) (small blind) folded on the River



PokerStars Game #59938938106:  Hold'em No Limit ($0.25/$0.50) - 2009/07/01 0:27:17 ET
Table '3FhG0gl3kMX3wBEEqj+wnQ' 9-max Seat #7 is the button
Seat 1: e0J9pdCNUDTCG031RnXqLA ($18 in chips)
Seat 2: 4dl3YNqZ6Houm2jZAzDmRg ($16.55 in chips)
Seat 3: HZkVla4kK2SI42CVrPZ/ig ($9.25 in chips)
Seat 4: bz4LMfV0GGl/MJ/ABXuPmg ($21.35 in chips)
Seat 5: XNMDwbXt/Q4jM99AXnbJDw ($50 in chips)
Seat 6: 5JJVDlaiMnB004o/RqbZZQ ($23.75 in chips)
Seat 7: mSD1pginDsyHG5PDfqzphw ($10 in chips)
Seat 8: j3K/Jujr7PY4ZM2RZvlH6A ($65.95 in chips)
Seat 9: L5e2lrPLQm1Pqx30IIZ/Fw ($10 in chips)
j3K/Jujr7PY4ZM2RZvlH6A: posts small blind $0.25
L5e2lrPLQm1Pqx30IIZ/Fw: posts big blind $0.50
*** HOLE CARDS ***
e0J9pdCNUDTCG031RnXqLA: calls $0.50
4dl3YNqZ6Houm2jZAzDmRg: calls $0.50
HZkVla4kK2SI42CVrPZ/ig: folds
bz4LMfV0GGl/MJ/ABXuPmg: folds
XNMDwbXt/Q4jM99AXnbJDw: folds
5JJVDlaiMnB004o/RqbZZQ: folds
mSD1pginDsyHG5PDfqzphw: folds
j3K/Jujr7PY4ZM2RZvlH6A: folds
L5e2lrPLQm1Pqx30IIZ/Fw: checks
*** FLOP *** [6c 4d 4h]
L5e2lrPLQm1Pqx30IIZ/Fw: checks
e0J9pdCNUDTCG031RnXqLA: checks
4dl3YNqZ6Houm2jZAzDmRg: bets $0.50
L5e2lrPLQm1Pqx30IIZ/Fw: calls $0.50
e0J9pdCNUDTCG031RnXqLA: calls $0.50
*** TURN *** [6c 4d 4h] [8h]
L5e2lrPLQm1Pqx30IIZ/Fw: bets $1.50
e0J9pdCNUDTCG031RnXqLA: folds
4dl3YNqZ6Houm2jZAzDmRg: folds
L5e2lrPLQm1Pqx30IIZ/Fw collected $3.10 from pot
*** SUMMARY ***
Total pot $3.25 | Rake $0.15
Board [6c 4d 4h 8h]
Seat 1: e0J9pdCNUDTCG031RnXqLA folded on the Turn
Seat 2: 4dl3YNqZ6Houm2jZAzDmRg folded on the Turn
Seat 3: HZkVla4kK2SI42CVrPZ/ig folded before Flop (didn't bet)
Seat 4: bz4LMfV0GGl/MJ/ABXuPmg folded before Flop (didn't bet)
Seat 5: XNMDwbXt/Q4jM99AXnbJDw folded before Flop (didn't bet)
Seat 6: 5JJVDlaiMnB004o/RqbZZQ folded before Flop (didn't bet)
Seat 7: mSD1pginDsyHG5PDfqzphw (button) folded before Flop (didn't bet)
Seat 8: j3K/Jujr7PY4ZM2RZvlH6A (small blind) folded before Flop
Seat 9: L5e2lrPLQm1Pqx30IIZ/Fw (big blind) collected ($3.10)



PokerStars Game #59938938172:  Hold'em No Limit ($0.25/$0.50) - 2009/07/01 0:27:17 ET
Table 'MJxeZCzYELxiIsyUZyT0jw' 6-max Seat #4 is the button
Seat 1: wOyVV9M/oyiw3YaOjNZ05w ($51.85 in chips)
Seat 3: JQZew0FjzS19kTjeNtrE+A ($50 in chips)
Seat 4: lP7Q6pewz4C2RsAfKsjdWw ($37.55 in chips)
Seat 5: 3jvoOXNtXE90w2BdfNZwZQ ($52.80 in chips)
Seat 6: TTx3CHxyi0SObcHyMJRp5w ($48.75 in chips)
3jvoOXNtXE90w2BdfNZwZQ: posts small blind $0.25
TTx3CHxyi0SObcHyMJRp5w: posts big blind $0.50
dB6jzDlJmET84VMWw1mTRA: sits out
*** HOLE CARDS ***
wOyVV9M/oyiw3YaOjNZ05w: folds
JQZew0FjzS19kTjeNtrE+A: raises $1.50 to $2
lP7Q6pewz4C2RsAfKsjdWw: calls $2
3jvoOXNtXE90w2BdfNZwZQ: folds
TTx3CHxyi0SObcHyMJRp5w: folds
*** FLOP *** [5s 7c 3s]
JQZew0FjzS19kTjeNtrE+A: bets $4
lP7Q6pewz4C2RsAfKsjdWw: folds
JQZew0FjzS19kTjeNtrE+A collected $4.55 from pot
*** SUMMARY ***
Total pot $4.75 | Rake $0.20
Board [5s 7c 3s]
Seat 1: wOyVV9M/oyiw3YaOjNZ05w folded before Flop (didn't bet)
Seat 3: JQZew0FjzS19kTjeNtrE+A collected ($4.55)
Seat 4: lP7Q6pewz4C2RsAfKsjdWw (button) folded on the Flop
Seat 5: 3jvoOXNtXE90w2BdfNZwZQ (small blind) folded before Flop
Seat 6: TTx3CHxyi0SObcHyMJRp5w (big blind) folded before Flop



PokerStars Game #59938938354:  Hold'em No Limit ($0.25/$0.50) - 2009/07/01 0:27:17 ET
Table 'tyR5AZNKV8Aadbrnrnlg7g' 6-max Seat #2 is the button
Seat 1: R+KjpH/wSjDLhtIy9+edNA ($85.50 in chips)
Seat 2: 58zdeSBSuSFX/qZfhc7YmA ($28.35 in chips)
Seat 3: tdOvWynovql5imfooroLMg ($50.25 in chips)
Seat 4: Rt6KgtZ8YaJoTc3FPim00w ($84.25 in chips)
Seat 5: wOyVV9M/oyiw3YaOjNZ05w ($54.60 in chips)
tdOvWynovql5imfooroLMg: posts small blind $0.25
Rt6KgtZ8YaJoTc3FPim00w: posts big blind $0.50
*** HOLE CARDS ***
wOyVV9M/oyiw3YaOjNZ05w: folds
R+KjpH/wSjDLhtIy9+edNA: raises $1 to $1.50
58zdeSBSuSFX/qZfhc7YmA: folds
tdOvWynovql5imfooroLMg: folds
Rt6KgtZ8YaJoTc3FPim00w: folds
R+KjpH/wSjDLhtIy9+edNA collected $1.25 from pot
R+KjpH/wSjDLhtIy9+edNA: doesn't show hand
*** SUMMARY ***
Total pot $1.25 | Rake $0
Seat 1: R+KjpH/wSjDLhtIy9+edNA collected ($1.25)
Seat 2: 58zdeSBSuSFX/qZfhc7YmA (button) folded before Flop (didn't bet)
Seat 3: tdOvWynovql5imfooroLMg (small blind) folded before Flop
Seat 4: Rt6KgtZ8YaJoTc3FPim00w (big blind) folded before Flop
Seat 5: wOyVV9M/oyiw3YaOjNZ05w folded before Flop (didn't bet)



PokerStars Game #59938939256:  Hold'em No Limit ($0.25/$0.50) - 2009/07/01 0:27:18 ET
Table 'Nz0Vr7WMHL2g5Uk7dDZjpw' 9-max Seat #7 is the button
Seat 2: XNMDwbXt/Q4jM99AXnbJDw ($50 in chips)
Seat 3: 4QTiNH5fteLgJjx/s6Hy6A ($18.40 in chips)
Seat 4: 5JJVDlaiMnB004o/RqbZZQ ($28.50 in chips)
Seat 5: WGW0DgjBUXs1ylURHG8vnQ ($15.90 in chips)
Seat 6: k1f0lS7tlMHCLGs0JT34Tg ($10 in chips)
Seat 7: KPLH0gELgFe2OuAnhJFI5w ($18.70 in chips)
Seat 8: HkZI6g4zl83TDTA7SRspmQ ($19.45 in chips)
Seat 9: Ak2W6V2TDVIQrvSAy4eD7Q ($25.35 in chips)
HkZI6g4zl83TDTA7SRspmQ: posts small blind $0.25
Ak2W6V2TDVIQrvSAy4eD7Q: posts big blind $0.50
*** HOLE CARDS ***
XNMDwbXt/Q4jM99AXnbJDw: folds
4QTiNH5fteLgJjx/s6Hy6A: folds
5JJVDlaiMnB004o/RqbZZQ: folds
WGW0DgjBUXs1ylURHG8vnQ: folds
k1f0lS7tlMHCLGs0JT34Tg: calls $0.50
KPLH0gELgFe2OuAnhJFI5w: calls $0.50
HkZI6g4zl83TDTA7SRspmQ: calls $0.25
Ak2W6V2TDVIQrvSAy4eD7Q: checks
*** FLOP *** [3s 7c Td]
HkZI6g4zl83TDTA7SRspmQ: checks
Ak2W6V2TDVIQrvSAy4eD7Q: bets $1
k1f0lS7tlMHCLGs0JT34Tg: folds
KPLH0gELgFe2OuAnhJFI5w: folds
HkZI6g4zl83TDTA7SRspmQ: folds
Ak2W6V2TDVIQrvSAy4eD7Q collected $1.90 from pot
*** SUMMARY ***
Total pot $2 | Rake $0.10
Board [3s 7c Td]
Seat 2: XNMDwbXt/Q4jM99AXnbJDw folded before Flop (didn't bet)
Seat 3: 4QTiNH5fteLgJjx/s6Hy6A folded before Flop (didn't bet)
Seat 4: 5JJVDlaiMnB004o/RqbZZQ folded before Flop (didn't bet)
Seat 5: WGW0DgjBUXs1ylURHG8vnQ folded before Flop (didn't bet)
Seat 6: k1f0lS7tlMHCLGs0JT34Tg folded on the Flop
Seat 7: KPLH0gELgFe2OuAnhJFI5w (button) folded on the Flop
Seat 8: HkZI6g4zl83TDTA7SRspmQ (small blind) folded on the Flop
Seat 9: Ak2W6V2TDVIQrvSAy4eD7Q (big blind) collected ($1.90)



PokerStars Game #59938941558:  Hold'em No Limit ($0.25/$0.50) - 2009/07/01 0:27:22 ET
Table 'mTxf8gPLgffN3Iwfm7Icfg' 2-max Seat #2 is the button
Seat 1: Do9Rlu1R5u/AcRtMTl8SYg ($94.45 in chips)
Seat 2: EMc5LPgVaded4Qc77vm0fw ($65.40 in chips)
EMc5LPgVaded4Qc77vm0fw: posts small blind $0.25
Do9Rlu1R5u/AcRtMTl8SYg: posts big blind $0.50
*** HOLE CARDS ***
EMc5LPgVaded4Qc77vm0fw: folds
Do9Rlu1R5u/AcRtMTl8SYg collected $0.50 from pot
Do9Rlu1R5u/AcRtMTl8SYg: doesn't show hand
*** SUMMARY ***
Total pot $0.50 | Rake $0
Seat 1: Do9Rlu1R5u/AcRtMTl8SYg (big blind) collected ($0.50)
Seat 2: EMc5LPgVaded4Qc77vm0fw (button) (small blind) folded before Flop



PokerStars Game #59938942520:  Hold'em No Limit ($0.25/$0.50) - 2009/07/01 0:27:23 ET
Table 'kgbJRsxfv64KrErDRBAkcw' 6-max Seat #4 is the button
Seat 1: N7O9jUEx2YiQn1+yRYTHmw ($18.05 in chips)
Seat 2: Q+thC23WCv1kJUJtH/+4Jw ($67.15 in chips)
Seat 3: T0Gx/FcQ5VH9u7XaOMX97A ($61.60 in chips)
Seat 4: qanMEqjABjWxC/JgQ/0l7w ($59.20 in chips)
Seat 5: +Pf9jTVizYlIo+woPvptfA ($50 in chips)
Seat 6: ozrlafxxh1HmYdA0/h+MuA ($5.50 in chips)
+Pf9jTVizYlIo+woPvptfA: posts small blind $0.25
ozrlafxxh1HmYdA0/h+MuA: posts big blind $0.50
*** HOLE CARDS ***
N7O9jUEx2YiQn1+yRYTHmw: folds
Q+thC23WCv1kJUJtH/+4Jw: folds
T0Gx/FcQ5VH9u7XaOMX97A: folds
qanMEqjABjWxC/JgQ/0l7w: raises $1 to $1.50
+Pf9jTVizYlIo+woPvptfA: folds
ozrlafxxh1HmYdA0/h+MuA: folds
qanMEqjABjWxC/JgQ/0l7w collected $1.25 from pot
*** SUMMARY ***
Total pot $1.25 | Rake $0
Seat 1: N7O9jUEx2YiQn1+yRYTHmw folded before Flop (didn't bet)
Seat 2: Q+thC23WCv1kJUJtH/+4Jw folded before Flop (didn't bet)
Seat 3: T0Gx/FcQ5VH9u7XaOMX97A folded before Flop (didn't bet)
Seat 4: qanMEqjABjWxC/JgQ/0l7w (button) collected ($1.25)
Seat 5: +Pf9jTVizYlIo+woPvptfA (small blind) folded before Flop
Seat 6: ozrlafxxh1HmYdA0/h+MuA (big blind) folded before Flop



PokerStars Game #59938943924:  Hold'em No Limit ($0.25/$0.50) - 2009/07/01 0:27:25 ET
Table 'IeNZOZQ4T6oiaHqFeo6yIA' 2-max Seat #2 is the button
Seat 1: ndd1nfncBkWNitBnsfCoVQ ($86.80 in chips)
Seat 2: A91IUl5JaZROhtfCtnnwYw ($46.45 in chips)
A91IUl5JaZROhtfCtnnwYw: posts small blind $0.25
ndd1nfncBkWNitBnsfCoVQ: posts big blind $0.50
*** HOLE CARDS ***
A91IUl5JaZROhtfCtnnwYw: calls $0.25
ndd1nfncBkWNitBnsfCoVQ: raises $1.50 to $2
A91IUl5JaZROhtfCtnnwYw: calls $1.50
*** FLOP *** [4h 6s 7d]
ndd1nfncBkWNitBnsfCoVQ: bets $2.50
A91IUl5JaZROhtfCtnnwYw: calls $2.50
*** TURN *** [4h 6s 7d] [6c]
ndd1nfncBkWNitBnsfCoVQ: checks
A91IUl5JaZROhtfCtnnwYw: bets $8
ndd1nfncBkWNitBnsfCoVQ: folds
A91IUl5JaZROhtfCtnnwYw collected $8.60 from pot
A91IUl5JaZROhtfCtnnwYw: doesn't show hand
*** SUMMARY ***
Total pot $9 | Rake $0.40
Board [4h 6s 7d 6c]
Seat 1: ndd1nfncBkWNitBnsfCoVQ (big blind) folded on the Turn
Seat 2: A91IUl5JaZROhtfCtnnwYw (button) (small blind) collected ($8.60)



PokerStars Game #59938944220:  Hold'em No Limit ($0.25/$0.50) - 2009/07/01 0:27:26 ET
Table '37qXEp3oe+er5q4CZip9eQ' 6-max Seat #2 is the button
Seat 1: oqOqoO2AyCZenUghCxMDxw ($50 in chips)
Seat 2: 6wzJiRvp8HY6t+MQGnSIzA ($16.25 in chips)
Seat 3: Rt6KgtZ8YaJoTc3FPim00w ($98.75 in chips)
Seat 4: XsmE8nXMAAMFJbWaJTmHFw ($15.45 in chips)
Seat 5: VOmI0x4dDPnTESZd5B4d1Q ($45.25 in chips)
Rt6KgtZ8YaJoTc3FPim00w: posts small blind $0.25
XsmE8nXMAAMFJbWaJTmHFw: posts big blind $0.50
*** HOLE CARDS ***
l4m/wWPs22DSP5xpszjXKA joins the table at seat #6
VOmI0x4dDPnTESZd5B4d1Q: folds
oqOqoO2AyCZenUghCxMDxw: folds
6wzJiRvp8HY6t+MQGnSIzA: folds
Rt6KgtZ8YaJoTc3FPim00w: folds
XsmE8nXMAAMFJbWaJTmHFw collected $0.50 from pot
*** SUMMARY ***
Total pot $0.50 | Rake $0
Seat 1: oqOqoO2AyCZenUghCxMDxw folded before Flop (didn't bet)
Seat 2: 6wzJiRvp8HY6t+MQGnSIzA (button) folded before Flop (didn't bet)
Seat 3: Rt6KgtZ8YaJoTc3FPim00w (small blind) folded before Flop
Seat 4: XsmE8nXMAAMFJbWaJTmHFw (big blind) collected ($0.50)
Seat 5: VOmI0x4dDPnTESZd5B4d1Q folded before Flop (didn't bet)



PokerStars Game #59938945522:  Hold'em No Limit ($0.25/$0.50) - 2009/07/01 0:27:28 ET
Table 'mTxf8gPLgffN3Iwfm7Icfg' 2-max Seat #1 is the button
Seat 1: Do9Rlu1R5u/AcRtMTl8SYg ($94.70 in chips)
Seat 2: EMc5LPgVaded4Qc77vm0fw ($65.15 in chips)
Do9Rlu1R5u/AcRtMTl8SYg: posts small blind $0.25
EMc5LPgVaded4Qc77vm0fw: posts big blind $0.50
*** HOLE CARDS ***
Do9Rlu1R5u/AcRtMTl8SYg: calls $0.25
EMc5LPgVaded4Qc77vm0fw: checks
*** FLOP *** [Tc Jh Ks]
EMc5LPgVaded4Qc77vm0fw: checks
Do9Rlu1R5u/AcRtMTl8SYg: checks
*** TURN *** [Tc Jh Ks] [Qs]
EMc5LPgVaded4Qc77vm0fw: checks
Do9Rlu1R5u/AcRtMTl8SYg: checks
*** RIVER *** [Tc Jh Ks Qs] [8h]
EMc5LPgVaded4Qc77vm0fw: checks
Do9Rlu1R5u/AcRtMTl8SYg: checks
*** SHOW DOWN ***
EMc5LPgVaded4Qc77vm0fw: shows [2h 2c] (a pair of Deuces)
Do9Rlu1R5u/AcRtMTl8SYg: mucks hand
EMc5LPgVaded4Qc77vm0fw collected $0.95 from pot
*** SUMMARY ***
Total pot $1 | Rake $0.05
Board [Tc Jh Ks Qs 8h]
Seat 1: Do9Rlu1R5u/AcRtMTl8SYg (button) (small blind) mucked
Seat 2: EMc5LPgVaded4Qc77vm0fw (big blind) showed [2h 2c] and won ($0.95) with a pair of Deuces



PokerStars Game #59938947560:  Hold'em No Limit ($0.25/$0.50) - 2009/07/01 0:27:31 ET
Table '+dXkOAQyS8j9PQZusUTMpg' 2-max Seat #2 is the button
Seat 1: XFa6sBGjP2gxoIvxR3fZIg ($10.10 in chips)
Seat 2: 5IBeOgaApY1Bvzv2P8X4EA ($95.50 in chips)
XFa6sBGjP2gxoIvxR3fZIg said, "ouch"
5IBeOgaApY1Bvzv2P8X4EA: posts small blind $0.25
XFa6sBGjP2gxoIvxR3fZIg: posts big blind $0.50
*** HOLE CARDS ***
5IBeOgaApY1Bvzv2P8X4EA said, ":D"
XFa6sBGjP2gxoIvxR3fZIg said, "nh"
5IBeOgaApY1Bvzv2P8X4EA said, "bad time"
5IBeOgaApY1Bvzv2P8X4EA: folds
XFa6sBGjP2gxoIvxR3fZIg collected $0.50 from pot
XFa6sBGjP2gxoIvxR3fZIg: doesn't show hand
*** SUMMARY ***
Total pot $0.50 | Rake $0
Seat 1: XFa6sBGjP2gxoIvxR3fZIg (big blind) collected ($0.50)
Seat 2: 5IBeOgaApY1Bvzv2P8X4EA (button) (small blind) folded before Flop



PokerStars Game #59938947406:  Hold'em No Limit ($0.25/$0.50) - 2009/07/01 0:27:31 ET
Table 'EiNh8p/wGJ1FP575iMFnqg' 9-max Seat #2 is the button
Seat 1: r3ZqM1Mi0W3y4hOdssE+Sg ($50 in chips)
Seat 2: sSAA879uXOGR+8Mf3zLa6Q ($13.20 in chips)
Seat 3: ymLPoEIl7UL3TvZYmnadxQ ($50 in chips)
Seat 4: HIIPkpiaCQfs5HcPKjlHvg ($40.70 in chips)
Seat 5: M+7+BTmX5vZatHVuoRB1nA ($78.15 in chips)
Seat 6: 3UmXLy3GfjC3EkOebduerQ ($56.60 in chips)
Seat 7: Wj7mKnRFR90j40wWUu2+Og ($77.80 in chips)
Seat 8: KrPAGRACBg+w0M//SXe8Ag ($13.80 in chips)
Seat 9: OMwFJ4pF0xk2Ru/AJiFeFw ($69.90 in chips)
ymLPoEIl7UL3TvZYmnadxQ: posts small blind $0.25
HIIPkpiaCQfs5HcPKjlHvg: posts big blind $0.50
*** HOLE CARDS ***
M+7+BTmX5vZatHVuoRB1nA: folds
3UmXLy3GfjC3EkOebduerQ: folds
Wj7mKnRFR90j40wWUu2+Og: folds
KrPAGRACBg+w0M//SXe8Ag: calls $0.50
OMwFJ4pF0xk2Ru/AJiFeFw: folds
r3ZqM1Mi0W3y4hOdssE+Sg: folds
sSAA879uXOGR+8Mf3zLa6Q: calls $0.50
ymLPoEIl7UL3TvZYmnadxQ: calls $0.25
HIIPkpiaCQfs5HcPKjlHvg: checks
*** FLOP *** [6d 8h Kc]
ymLPoEIl7UL3TvZYmnadxQ: checks
HIIPkpiaCQfs5HcPKjlHvg: checks
KrPAGRACBg+w0M//SXe8Ag: checks
sSAA879uXOGR+8Mf3zLa6Q: bets $2.50
ymLPoEIl7UL3TvZYmnadxQ: folds
HIIPkpiaCQfs5HcPKjlHvg: folds
KrPAGRACBg+w0M//SXe8Ag: folds
sSAA879uXOGR+8Mf3zLa6Q collected $1.90 from pot
sSAA879uXOGR+8Mf3zLa6Q: doesn't show hand
*** SUMMARY ***
Total pot $2 | Rake $0.10
Board [6d 8h Kc]
Seat 1: r3ZqM1Mi0W3y4hOdssE+Sg folded before Flop (didn't bet)
Seat 2: sSAA879uXOGR+8Mf3zLa6Q (button) collected ($1.90)
Seat 3: ymLPoEIl7UL3TvZYmnadxQ (small blind) folded on the Flop
Seat 4: HIIPkpiaCQfs5HcPKjlHvg (big blind) folded on the Flop
Seat 5: M+7+BTmX5vZatHVuoRB1nA folded before Flop (didn't bet)
Seat 6: 3UmXLy3GfjC3EkOebduerQ folded before Flop (didn't bet)
Seat 7: Wj7mKnRFR90j40wWUu2+Og folded before Flop (didn't bet)
Seat 8: KrPAGRACBg+w0M//SXe8Ag folded on the Flop
Seat 9: OMwFJ4pF0xk2Ru/AJiFeFw folded before Flop (didn't bet)



PokerStars Game #59938948764:  Hold'em No Limit ($0.25/$0.50) - 2009/07/01 0:27:32 ET
Table 'PALRfuH85dr5IkDfdv6new' 9-max Seat #6 is the button
Seat 1: SKnJuWHScqetA/qG5p+wCg ($31.25 in chips)
Seat 2: 9r7ZoBbAJj5IeyZ0q9BdzA ($6.85 in chips)
Seat 3: 50QWoELmpmHFrFIlWMJo9g ($87.45 in chips)
Seat 4: mZNMJI1mY40XTC0U7GZakA ($50.75 in chips)
Seat 5: jSSGUXdNFAZA3QCvTcUMQw ($43.45 in chips)
Seat 6: E2518gp4aFz1+kAgmGqeEg ($10.25 in chips)
Seat 7: 3NcyXvr39gnK+KbTq7ezyA ($37.85 in chips)
Seat 8: NkS+CseUKx4XHszWq0PXEQ ($45.65 in chips)
Seat 9: CIrAX/m6o7jYmKOAjJXv4Q ($36.25 in chips)
3NcyXvr39gnK+KbTq7ezyA: posts small blind $0.25
NkS+CseUKx4XHszWq0PXEQ: posts big blind $0.50
*** HOLE CARDS ***
CIrAX/m6o7jYmKOAjJXv4Q: folds
SKnJuWHScqetA/qG5p+wCg: calls $0.50
9r7ZoBbAJj5IeyZ0q9BdzA: folds
50QWoELmpmHFrFIlWMJo9g: folds
mZNMJI1mY40XTC0U7GZakA: folds
jSSGUXdNFAZA3QCvTcUMQw: folds
E2518gp4aFz1+kAgmGqeEg: folds
3NcyXvr39gnK+KbTq7ezyA: calls $0.25
NkS+CseUKx4XHszWq0PXEQ: checks
*** FLOP *** [5h 5d Qd]
3NcyXvr39gnK+KbTq7ezyA: checks
NkS+CseUKx4XHszWq0PXEQ: checks
SKnJuWHScqetA/qG5p+wCg: bets $0.50
3NcyXvr39gnK+KbTq7ezyA: calls $0.50
NkS+CseUKx4XHszWq0PXEQ: folds
*** TURN *** [5h 5d Qd] [2d]
3NcyXvr39gnK+KbTq7ezyA: checks
SKnJuWHScqetA/qG5p+wCg: checks
*** RIVER *** [5h 5d Qd 2d] [Kh]
3NcyXvr39gnK+KbTq7ezyA: checks
SKnJuWHScqetA/qG5p+wCg: checks
*** SHOW DOWN ***
3NcyXvr39gnK+KbTq7ezyA: shows [Ad Ah] (two pair, Aces and Fives)
SKnJuWHScqetA/qG5p+wCg: mucks hand
3NcyXvr39gnK+KbTq7ezyA collected $2.40 from pot
*** SUMMARY ***
Total pot $2.50 | Rake $0.10
Board [5h 5d Qd 2d Kh]
Seat 1: SKnJuWHScqetA/qG5p+wCg mucked
Seat 2: 9r7ZoBbAJj5IeyZ0q9BdzA folded before Flop (didn't bet)
Seat 3: 50QWoELmpmHFrFIlWMJo9g folded before Flop (didn't bet)
Seat 4: mZNMJI1mY40XTC0U7GZakA folded before Flop (didn't bet)
Seat 5: jSSGUXdNFAZA3QCvTcUMQw folded before Flop (didn't bet)
Seat 6: E2518gp4aFz1+kAgmGqeEg (button) folded before Flop (didn't bet)
Seat 7: 3NcyXvr39gnK+KbTq7ezyA (small blind) showed [Ad Ah] and won ($2.40) with two pair, Aces and Fives
Seat 8: NkS+CseUKx4XHszWq0PXEQ (big blind) folded on the Flop
Seat 9: CIrAX/m6o7jYmKOAjJXv4Q folded before Flop (didn't bet)



PokerStars Game #59938951710:  Hold'em No Limit ($0.25/$0.50) - 2009/07/01 0:27:37 ET
Table 'tyR5AZNKV8Aadbrnrnlg7g' 6-max Seat #3 is the button
Seat 1: R+KjpH/wSjDLhtIy9+edNA ($86.25 in chips)
Seat 2: 58zdeSBSuSFX/qZfhc7YmA ($28.35 in chips)
Seat 3: tdOvWynovql5imfooroLMg ($50 in chips)
Seat 4: Rt6KgtZ8YaJoTc3FPim00w ($83.75 in chips)
Seat 5: wOyVV9M/oyiw3YaOjNZ05w ($54.60 in chips)
Rt6KgtZ8YaJoTc3FPim00w: posts small blind $0.25
wOyVV9M/oyiw3YaOjNZ05w: posts big blind $0.50
*** HOLE CARDS ***
R+KjpH/wSjDLhtIy9+edNA: folds
58zdeSBSuSFX/qZfhc7YmA: folds
tdOvWynovql5imfooroLMg: folds
ZKazl1hGaPiapDXincgi2Q joins the table at seat #6
Rt6KgtZ8YaJoTc3FPim00w: folds
wOyVV9M/oyiw3YaOjNZ05w collected $0.50 from pot
*** SUMMARY ***
Total pot $0.50 | Rake $0
Seat 1: R+KjpH/wSjDLhtIy9+edNA folded before Flop (didn't bet)
Seat 2: 58zdeSBSuSFX/qZfhc7YmA folded before Flop (didn't bet)
Seat 3: tdOvWynovql5imfooroLMg (button) folded before Flop (didn't bet)
Seat 4: Rt6KgtZ8YaJoTc3FPim00w (small blind) folded before Flop
Seat 5: wOyVV9M/oyiw3YaOjNZ05w (big blind) collected ($0.50)



PokerStars Game #59938952444:  Hold'em No Limit ($0.25/$0.50) - 2009/07/01 0:27:38 ET
Table 'T/PgNWqVyY6lkldcBVXYJQ' 6-max Seat #2 is the button
Seat 1: +Pf9jTVizYlIo+woPvptfA ($50 in chips)
Seat 2: oZAeY5rVqNGgt8yyQ0pxbA ($38.05 in chips)
Seat 3: L3OcNO1bgdqDI46j67KQPQ ($52.80 in chips)
Seat 4: jxMvxeUUL9UU0V6wVU+Iyw ($9.95 in chips)
Seat 5: vVQBckETtigfb5mAcyK0OA ($48.85 in chips)
Seat 6: cDzbog6kwmJp+LBeBq+iMQ ($56.75 in chips)
L3OcNO1bgdqDI46j67KQPQ: posts small blind $0.25
jxMvxeUUL9UU0V6wVU+Iyw: posts big blind $0.50
*** HOLE CARDS ***
vVQBckETtigfb5mAcyK0OA: calls $0.50
cDzbog6kwmJp+LBeBq+iMQ: folds
+Pf9jTVizYlIo+woPvptfA: raises $2 to $2.50
oZAeY5rVqNGgt8yyQ0pxbA: folds
L3OcNO1bgdqDI46j67KQPQ: folds
jxMvxeUUL9UU0V6wVU+Iyw: folds
vVQBckETtigfb5mAcyK0OA: calls $2
*** FLOP *** [2c Qc 4h]
vVQBckETtigfb5mAcyK0OA: checks
+Pf9jTVizYlIo+woPvptfA: checks
*** TURN *** [2c Qc 4h] [3d]
vVQBckETtigfb5mAcyK0OA: bets $3
+Pf9jTVizYlIo+woPvptfA: calls $3
*** RIVER *** [2c Qc 4h 3d] [6c]
vVQBckETtigfb5mAcyK0OA: bets $1
+Pf9jTVizYlIo+woPvptfA: raises $7.25 to $8.25
vVQBckETtigfb5mAcyK0OA: folds
+Pf9jTVizYlIo+woPvptfA collected $13.10 from pot
+Pf9jTVizYlIo+woPvptfA: doesn't show hand
*** SUMMARY ***
Total pot $13.75 | Rake $0.65
Board [2c Qc 4h 3d 6c]
Seat 1: +Pf9jTVizYlIo+woPvptfA collected ($13.10)
Seat 2: oZAeY5rVqNGgt8yyQ0pxbA (button) folded before Flop (didn't bet)
Seat 3: L3OcNO1bgdqDI46j67KQPQ (small blind) folded before Flop
Seat 4: jxMvxeUUL9UU0V6wVU+Iyw (big blind) folded before Flop
Seat 5: vVQBckETtigfb5mAcyK0OA folded on the River
Seat 6: cDzbog6kwmJp+LBeBq+iMQ folded before Flop (didn't bet)



PokerStars Game #59938954914:  Hold'em No Limit ($0.25/$0.50) - 2009/07/01 0:27:42 ET
Table 'kgbJRsxfv64KrErDRBAkcw' 6-max Seat #5 is the button
Seat 1: N7O9jUEx2YiQn1+yRYTHmw ($18.05 in chips)
Seat 2: Q+thC23WCv1kJUJtH/+4Jw ($67.15 in chips)
Seat 3: T0Gx/FcQ5VH9u7XaOMX97A ($61.60 in chips)
Seat 4: qanMEqjABjWxC/JgQ/0l7w ($59.95 in chips)
Seat 5: +Pf9jTVizYlIo+woPvptfA ($50 in chips)
Seat 6: ozrlafxxh1HmYdA0/h+MuA ($5 in chips)
ozrlafxxh1HmYdA0/h+MuA: posts small blind $0.25
N7O9jUEx2YiQn1+yRYTHmw: posts big blind $0.50
*** HOLE CARDS ***
Q+thC23WCv1kJUJtH/+4Jw: folds
T0Gx/FcQ5VH9u7XaOMX97A: folds
qanMEqjABjWxC/JgQ/0l7w: folds
+Pf9jTVizYlIo+woPvptfA: raises $1 to $1.50
ozrlafxxh1HmYdA0/h+MuA: calls $1.25
N7O9jUEx2YiQn1+yRYTHmw: folds
*** FLOP *** [5c 3d 2c]
ozrlafxxh1HmYdA0/h+MuA: bets $3.50 and is all-in
+Pf9jTVizYlIo+woPvptfA: folds
ozrlafxxh1HmYdA0/h+MuA collected $3.35 from pot
*** SUMMARY ***
Total pot $3.50 | Rake $0.15
Board [5c 3d 2c]
Seat 1: N7O9jUEx2YiQn1+yRYTHmw (big blind) folded before Flop
Seat 2: Q+thC23WCv1kJUJtH/+4Jw folded before Flop (didn't bet)
Seat 3: T0Gx/FcQ5VH9u7XaOMX97A folded before Flop (didn't bet)
Seat 4: qanMEqjABjWxC/JgQ/0l7w folded before Flop (didn't bet)
Seat 5: +Pf9jTVizYlIo+woPvptfA (button) folded on the Flop
Seat 6: ozrlafxxh1HmYdA0/h+MuA (small blind) collected ($3.35)



PokerStars Game #59938956598:  Hold'em No Limit ($0.25/$0.50) - 2009/07/01 0:27:44 ET
Table '+dXkOAQyS8j9PQZusUTMpg' 2-max Seat #1 is the button
Seat 1: XFa6sBGjP2gxoIvxR3fZIg ($10.35 in chips)
Seat 2: 5IBeOgaApY1Bvzv2P8X4EA ($95.25 in chips)
XFa6sBGjP2gxoIvxR3fZIg: posts small blind $0.25
5IBeOgaApY1Bvzv2P8X4EA said, "tks"
5IBeOgaApY1Bvzv2P8X4EA: posts big blind $0.50
*** HOLE CARDS ***
XFa6sBGjP2gxoIvxR3fZIg: raises $1 to $1.50
5IBeOgaApY1Bvzv2P8X4EA: folds
XFa6sBGjP2gxoIvxR3fZIg collected $1 from pot
*** SUMMARY ***
Total pot $1 | Rake $0
Seat 1: XFa6sBGjP2gxoIvxR3fZIg (button) (small blind) collected ($1)
Seat 2: 5IBeOgaApY1Bvzv2P8X4EA (big blind) folded before Flop



PokerStars Game #59938956702:  Hold'em No Limit ($0.25/$0.50) - 2009/07/01 0:27:45 ET
Table 'c/CRn+68J3Y8KxD5g1ek2Q' 2-max Seat #1 is the button
Seat 1: 46qCyJ6evTkHo9al5sBMNA ($261.25 in chips)
Seat 2: BypVLsYQt3ePFm2xQL/dOA ($118.35 in chips)
46qCyJ6evTkHo9al5sBMNA: posts small blind $0.25
BypVLsYQt3ePFm2xQL/dOA: posts big blind $0.50
*** HOLE CARDS ***
46qCyJ6evTkHo9al5sBMNA: raises $1 to $1.50
BypVLsYQt3ePFm2xQL/dOA: calls $1
*** FLOP *** [Tc 3d 6d]
BypVLsYQt3ePFm2xQL/dOA: checks
46qCyJ6evTkHo9al5sBMNA: checks
*** TURN *** [Tc 3d 6d] [Ac]
BypVLsYQt3ePFm2xQL/dOA: checks
46qCyJ6evTkHo9al5sBMNA: checks
*** RIVER *** [Tc 3d 6d Ac] [9d]
BypVLsYQt3ePFm2xQL/dOA: checks
46qCyJ6evTkHo9al5sBMNA: checks
*** SHOW DOWN ***
BypVLsYQt3ePFm2xQL/dOA: shows [8d Ks] (high card Ace)
46qCyJ6evTkHo9al5sBMNA: mucks hand
BypVLsYQt3ePFm2xQL/dOA collected $2.85 from pot
*** SUMMARY ***
Total pot $3 | Rake $0.15
Board [Tc 3d 6d Ac 9d]
Seat 1: 46qCyJ6evTkHo9al5sBMNA (button) (small blind) mucked
Seat 2: BypVLsYQt3ePFm2xQL/dOA (big blind) showed [8d Ks] and won ($2.85) with high card Ace



PokerStars Game #59938956704:  Hold'em No Limit ($0.25/$0.50) - 2009/07/01 0:27:45 ET
Table '5EmHi+fnatGQQShcNmzOZQ' 6-max Seat #4 is the button
Seat 1: SwPczQo3cOtwEzhJrfO2cQ ($26.70 in chips)
Seat 3: L9qfLYXrczhAPd/VckgsWw ($58.80 in chips)
Seat 4: wOyVV9M/oyiw3YaOjNZ05w ($50 in chips)
Seat 5: kxPhs4ePFqMy52CInAJ2aw ($61.35 in chips)
Seat 6: 686aeHikcJlgKkSuIFdcXQ ($144.15 in chips)
kxPhs4ePFqMy52CInAJ2aw: posts small blind $0.25
686aeHikcJlgKkSuIFdcXQ: posts big blind $0.50
*** HOLE CARDS ***
SwPczQo3cOtwEzhJrfO2cQ: calls $0.50
L9qfLYXrczhAPd/VckgsWw: raises $1.50 to $2
wOyVV9M/oyiw3YaOjNZ05w: folds
kxPhs4ePFqMy52CInAJ2aw: folds
686aeHikcJlgKkSuIFdcXQ: folds
SwPczQo3cOtwEzhJrfO2cQ: calls $1.50
*** FLOP *** [Ac 4s 8d]
vXIHnZ+dv/hwSBxyvGw7bQ joins the table at seat #2
SwPczQo3cOtwEzhJrfO2cQ: checks
L9qfLYXrczhAPd/VckgsWw: bets $0.50
SwPczQo3cOtwEzhJrfO2cQ: folds
L9qfLYXrczhAPd/VckgsWw collected $4.55 from pot
L9qfLYXrczhAPd/VckgsWw: doesn't show hand
*** SUMMARY ***
Total pot $4.75 | Rake $0.20
Board [Ac 4s 8d]
Seat 1: SwPczQo3cOtwEzhJrfO2cQ folded on the Flop
Seat 3: L9qfLYXrczhAPd/VckgsWw collected ($4.55)
Seat 4: wOyVV9M/oyiw3YaOjNZ05w (button) folded before Flop (didn't bet)
Seat 5: kxPhs4ePFqMy52CInAJ2aw (small blind) folded before Flop
Seat 6: 686aeHikcJlgKkSuIFdcXQ (big blind) folded before Flop



PokerStars Game #59938957732:  Hold'em No Limit ($0.25/$0.50) - 2009/07/01 0:27:46 ET
Table '37qXEp3oe+er5q4CZip9eQ' 6-max Seat #3 is the button
Seat 1: oqOqoO2AyCZenUghCxMDxw ($50 in chips)
Seat 2: 6wzJiRvp8HY6t+MQGnSIzA ($16.25 in chips)
Seat 3: Rt6KgtZ8YaJoTc3FPim00w ($98.50 in chips)
Seat 4: XsmE8nXMAAMFJbWaJTmHFw ($15.70 in chips)
Seat 5: VOmI0x4dDPnTESZd5B4d1Q ($45.25 in chips)
XsmE8nXMAAMFJbWaJTmHFw: posts small blind $0.25
VOmI0x4dDPnTESZd5B4d1Q: posts big blind $0.50
l4m/wWPs22DSP5xpszjXKA: sits out
*** HOLE CARDS ***
oqOqoO2AyCZenUghCxMDxw: folds
6wzJiRvp8HY6t+MQGnSIzA: calls $0.50
Rt6KgtZ8YaJoTc3FPim00w: raises $1.50 to $2
XsmE8nXMAAMFJbWaJTmHFw: folds
VOmI0x4dDPnTESZd5B4d1Q: folds
6wzJiRvp8HY6t+MQGnSIzA: calls $1.50
*** FLOP *** [9d Th 9c]
6wzJiRvp8HY6t+MQGnSIzA: checks
Rt6KgtZ8YaJoTc3FPim00w: checks
*** TURN *** [9d Th 9c] [4c]
6wzJiRvp8HY6t+MQGnSIzA: bets $1.50
Rt6KgtZ8YaJoTc3FPim00w: folds
6wzJiRvp8HY6t+MQGnSIzA collected $4.55 from pot
*** SUMMARY ***
Total pot $4.75 | Rake $0.20
Board [9d Th 9c 4c]
Seat 1: oqOqoO2AyCZenUghCxMDxw folded before Flop (didn't bet)
Seat 2: 6wzJiRvp8HY6t+MQGnSIzA collected ($4.55)
Seat 3: Rt6KgtZ8YaJoTc3FPim00w (button) folded on the Turn
Seat 4: XsmE8nXMAAMFJbWaJTmHFw (small blind) folded before Flop
Seat 5: VOmI0x4dDPnTESZd5B4d1Q (big blind) folded before Flop



PokerStars Game #59938957696:  Hold'em No Limit ($0.25/$0.50) - 2009/07/01 0:27:46 ET
Table 'E7bWJ45aoFXRpyRv2gw+Ig' 2-max Seat #1 is the button
Seat 1: FRkiRasEGlHUeLrEl+k/nA ($54.65 in chips)
Seat 2: 3Wro85I7472vJ4Wkpneo9A ($122.65 in chips)
FRkiRasEGlHUeLrEl+k/nA: posts small blind $0.25
3Wro85I7472vJ4Wkpneo9A: posts big blind $0.50
*** HOLE CARDS ***
FRkiRasEGlHUeLrEl+k/nA: calls $0.25
3Wro85I7472vJ4Wkpneo9A: checks
*** FLOP *** [7d 3s 9d]
3Wro85I7472vJ4Wkpneo9A: checks
FRkiRasEGlHUeLrEl+k/nA: checks
*** TURN *** [7d 3s 9d] [Kh]
3Wro85I7472vJ4Wkpneo9A: checks
FRkiRasEGlHUeLrEl+k/nA: checks
*** RIVER *** [7d 3s 9d Kh] [Jd]
3Wro85I7472vJ4Wkpneo9A: checks
FRkiRasEGlHUeLrEl+k/nA: checks
*** SHOW DOWN ***
3Wro85I7472vJ4Wkpneo9A: shows [3c 8s] (a pair of Threes)
FRkiRasEGlHUeLrEl+k/nA: shows [3h 4h] (a pair of Threes)
3Wro85I7472vJ4Wkpneo9A collected $0.50 from pot
FRkiRasEGlHUeLrEl+k/nA collected $0.45 from pot
*** SUMMARY ***
Total pot $1 | Rake $0.05
Board [7d 3s 9d Kh Jd]
Seat 1: FRkiRasEGlHUeLrEl+k/nA (button) (small blind) showed [3h 4h] and won ($0.45) with a pair of Threes
Seat 2: 3Wro85I7472vJ4Wkpneo9A (big blind) showed [3c 8s] and won ($0.50) with a pair of Threes



PokerStars Game #59938960206:  Hold'em No Limit ($0.25/$0.50) - 2009/07/01 0:27:50 ET
Table 'tyR5AZNKV8Aadbrnrnlg7g' 6-max Seat #4 is the button
Seat 1: R+KjpH/wSjDLhtIy9+edNA ($86.25 in chips)
Seat 2: 58zdeSBSuSFX/qZfhc7YmA ($28.35 in chips)
Seat 3: tdOvWynovql5imfooroLMg ($50 in chips)
Seat 4: Rt6KgtZ8YaJoTc3FPim00w ($83.50 in chips)
Seat 5: wOyVV9M/oyiw3YaOjNZ05w ($54.85 in chips)
Seat 6: ZKazl1hGaPiapDXincgi2Q ($30 in chips)
wOyVV9M/oyiw3YaOjNZ05w: posts small blind $0.25
ZKazl1hGaPiapDXincgi2Q: posts big blind $0.50
*** HOLE CARDS ***
R+KjpH/wSjDLhtIy9+edNA: raises $1 to $1.50
58zdeSBSuSFX/qZfhc7YmA: folds
tdOvWynovql5imfooroLMg: folds
Rt6KgtZ8YaJoTc3FPim00w: folds
wOyVV9M/oyiw3YaOjNZ05w: folds
ZKazl1hGaPiapDXincgi2Q: folds
R+KjpH/wSjDLhtIy9+edNA collected $1.25 from pot
R+KjpH/wSjDLhtIy9+edNA: doesn't show hand
*** SUMMARY ***
Total pot $1.25 | Rake $0
Seat 1: R+KjpH/wSjDLhtIy9+edNA collected ($1.25)
Seat 2: 58zdeSBSuSFX/qZfhc7YmA folded before Flop (didn't bet)
Seat 3: tdOvWynovql5imfooroLMg folded before Flop (didn't bet)
Seat 4: Rt6KgtZ8YaJoTc3FPim00w (button) folded before Flop (didn't bet)
Seat 5: wOyVV9M/oyiw3YaOjNZ05w (small blind) folded before Flop
Seat 6: ZKazl1hGaPiapDXincgi2Q (big blind) folded before Flop



PokerStars Game #59938961106:  Hold'em No Limit ($0.25/$0.50) - 2009/07/01 0:27:51 ET
Table 'QOgaEqMcJ73pcUMMxoisUg' 6-max Seat #4 is the button
Seat 2: Im2p1Nt83UKSqv5c9frm4Q ($50 in chips)
Seat 3: wUZNozoIDYf+16hp4nn6dw ($34.20 in chips)
Seat 4: zAcsDhG/T128Vn7XGVSgKg ($61.05 in chips)
Seat 5: 6vNxrjjCl6FwfaaymM9jjg ($29.55 in chips)
Seat 6: s83dnhZ6VC53vY0/f6OV/g ($42.35 in chips)
6vNxrjjCl6FwfaaymM9jjg: posts small blind $0.25
s83dnhZ6VC53vY0/f6OV/g: posts big blind $0.50
*** HOLE CARDS ***
Im2p1Nt83UKSqv5c9frm4Q: folds
wUZNozoIDYf+16hp4nn6dw: raises $3 to $3.50
zAcsDhG/T128Vn7XGVSgKg: folds
6vNxrjjCl6FwfaaymM9jjg: folds
s83dnhZ6VC53vY0/f6OV/g: folds
wUZNozoIDYf+16hp4nn6dw collected $1.25 from pot
*** SUMMARY ***
Total pot $1.25 | Rake $0
Seat 2: Im2p1Nt83UKSqv5c9frm4Q folded before Flop (didn't bet)
Seat 3: wUZNozoIDYf+16hp4nn6dw collected ($1.25)
Seat 4: zAcsDhG/T128Vn7XGVSgKg (button) folded before Flop (didn't bet)
Seat 5: 6vNxrjjCl6FwfaaymM9jjg (small blind) folded before Flop
Seat 6: s83dnhZ6VC53vY0/f6OV/g (big blind) folded before Flop



PokerStars Game #59938961570:  Hold'em No Limit ($0.25/$0.50) - 2009/07/01 0:27:52 ET
Table 'MJxeZCzYELxiIsyUZyT0jw' 6-max Seat #5 is the button
Seat 1: wOyVV9M/oyiw3YaOjNZ05w ($51.85 in chips)
Seat 3: JQZew0FjzS19kTjeNtrE+A ($52.55 in chips)
Seat 4: lP7Q6pewz4C2RsAfKsjdWw ($35.55 in chips)
Seat 5: 3jvoOXNtXE90w2BdfNZwZQ ($52.55 in chips)
Seat 6: TTx3CHxyi0SObcHyMJRp5w ($48.25 in chips)
TTx3CHxyi0SObcHyMJRp5w: posts small blind $0.25
wOyVV9M/oyiw3YaOjNZ05w: posts big blind $0.50
dB6jzDlJmET84VMWw1mTRA: sits out
*** HOLE CARDS ***
JQZew0FjzS19kTjeNtrE+A: folds
lP7Q6pewz4C2RsAfKsjdWw: calls $0.50
3jvoOXNtXE90w2BdfNZwZQ: raises $2 to $2.50
TTx3CHxyi0SObcHyMJRp5w: folds
wOyVV9M/oyiw3YaOjNZ05w: folds
lP7Q6pewz4C2RsAfKsjdWw: folds
3jvoOXNtXE90w2BdfNZwZQ collected $1.75 from pot
3jvoOXNtXE90w2BdfNZwZQ: doesn't show hand
*** SUMMARY ***
Total pot $1.75 | Rake $0
Seat 1: wOyVV9M/oyiw3YaOjNZ05w (big blind) folded before Flop
Seat 3: JQZew0FjzS19kTjeNtrE+A folded before Flop (didn't bet)
Seat 4: lP7Q6pewz4C2RsAfKsjdWw folded before Flop
Seat 5: 3jvoOXNtXE90w2BdfNZwZQ (button) collected ($1.75)
Seat 6: TTx3CHxyi0SObcHyMJRp5w (small blind) folded before Flop



PokerStars Game #59938961408:  Hold'em No Limit ($0.25/$0.50) - 2009/07/01 0:27:52 ET
Table '+z1aekfHkpp09pc8F9aViw' 6-max Seat #1 is the button
Seat 1: wOyVV9M/oyiw3YaOjNZ05w ($52.55 in chips)
Seat 2: M6xK/VklCvdyyrmvzATlxQ ($38.55 in chips)
Seat 3: uUznlIMFnRUvwrBhYF73KA ($58.75 in chips)
Seat 4: RowCSpSURHTOL/dcjg/Iug ($43.20 in chips)
Seat 5: crjGpJEzSZgD38FoE3VMGg ($59.15 in chips)
Seat 6: 686aeHikcJlgKkSuIFdcXQ ($70.10 in chips)
M6xK/VklCvdyyrmvzATlxQ: posts small blind $0.25
uUznlIMFnRUvwrBhYF73KA: posts big blind $0.50
*** HOLE CARDS ***
RowCSpSURHTOL/dcjg/Iug: folds
crjGpJEzSZgD38FoE3VMGg: folds
686aeHikcJlgKkSuIFdcXQ: folds
wOyVV9M/oyiw3YaOjNZ05w: folds
M6xK/VklCvdyyrmvzATlxQ: folds
uUznlIMFnRUvwrBhYF73KA collected $0.50 from pot
*** SUMMARY ***
Total pot $0.50 | Rake $0
Seat 1: wOyVV9M/oyiw3YaOjNZ05w (button) folded before Flop (didn't bet)
Seat 2: M6xK/VklCvdyyrmvzATlxQ (small blind) folded before Flop
Seat 3: uUznlIMFnRUvwrBhYF73KA (big blind) collected ($0.50)
Seat 4: RowCSpSURHTOL/dcjg/Iug folded before Flop (didn't bet)
Seat 5: crjGpJEzSZgD38FoE3VMGg folded before Flop (didn't bet)
Seat 6: 686aeHikcJlgKkSuIFdcXQ folded before Flop (didn't bet)



PokerStars Game #59938963168:  Hold'em No Limit ($0.25/$0.50) - 2009/07/01 0:27:54 ET
Table '+dXkOAQyS8j9PQZusUTMpg' 2-max Seat #2 is the button
Seat 1: XFa6sBGjP2gxoIvxR3fZIg ($50 in chips)
Seat 2: 5IBeOgaApY1Bvzv2P8X4EA ($94.75 in chips)
5IBeOgaApY1Bvzv2P8X4EA: posts small blind $0.25
XFa6sBGjP2gxoIvxR3fZIg: posts big blind $0.50
*** HOLE CARDS ***
5IBeOgaApY1Bvzv2P8X4EA: calls $0.25
XFa6sBGjP2gxoIvxR3fZIg: checks
*** FLOP *** [3s 6d 9d]
XFa6sBGjP2gxoIvxR3fZIg: bets $1
5IBeOgaApY1Bvzv2P8X4EA: calls $1
*** TURN *** [3s 6d 9d] [Qh]
XFa6sBGjP2gxoIvxR3fZIg: checks
5IBeOgaApY1Bvzv2P8X4EA: checks
*** RIVER *** [3s 6d 9d Qh] [9h]
XFa6sBGjP2gxoIvxR3fZIg: checks
5IBeOgaApY1Bvzv2P8X4EA: checks
*** SHOW DOWN ***
XFa6sBGjP2gxoIvxR3fZIg: shows [3h Tc] (two pair, Nines and Threes)
5IBeOgaApY1Bvzv2P8X4EA: mucks hand
XFa6sBGjP2gxoIvxR3fZIg collected $2.90 from pot
*** SUMMARY ***
Total pot $3 | Rake $0.10
Board [3s 6d 9d Qh 9h]
Seat 1: XFa6sBGjP2gxoIvxR3fZIg (big blind) showed [3h Tc] and won ($2.90) with two pair, Nines and Threes
Seat 2: 5IBeOgaApY1Bvzv2P8X4EA (button) (small blind) mucked



PokerStars Game #59938963428:  Hold'em No Limit ($0.25/$0.50) - 2009/07/01 0:27:55 ET
Table 'mTxf8gPLgffN3Iwfm7Icfg' 2-max Seat #2 is the button
Seat 1: Do9Rlu1R5u/AcRtMTl8SYg ($94.20 in chips)
Seat 2: EMc5LPgVaded4Qc77vm0fw ($65.60 in chips)
EMc5LPgVaded4Qc77vm0fw: posts small blind $0.25
Do9Rlu1R5u/AcRtMTl8SYg: posts big blind $0.50
*** HOLE CARDS ***
EMc5LPgVaded4Qc77vm0fw: folds
Do9Rlu1R5u/AcRtMTl8SYg collected $0.50 from pot
Do9Rlu1R5u/AcRtMTl8SYg: doesn't show hand
*** SUMMARY ***
Total pot $0.50 | Rake $0
Seat 1: Do9Rlu1R5u/AcRtMTl8SYg (big blind) collected ($0.50)
Seat 2: EMc5LPgVaded4Qc77vm0fw (button) (small blind) folded before Flop



PokerStars Game #59938966156:  Hold'em No Limit ($0.25/$0.50) - 2009/07/01 0:27:59 ET
Table 'fx6MqwfYAj/Rt86hBz2L3Q' 9-max Seat #4 is the button
Seat 1: jf2c/o9gI7Xj0GleCSMj9g ($50.55 in chips)
Seat 2: C3rGXblctNcWI6JYPHhaEg ($8.65 in chips)
Seat 3: iadBi5AEt7gTBXbDSSnMYQ ($48.45 in chips)
Seat 4: gPEN9Zp33YTm/mu9/SYP1w ($24.70 in chips)
Seat 5: iAISe3dVeua8PUn2wwgDHw ($26 in chips)
Seat 6: 5k9fvXD9suIgCxU4HLQjTw ($50 in chips)
Seat 7: bkXkL3pmapikPQQRNPZSEA ($16.90 in chips)
Seat 8: 6ol/q1A4zYU6qXbZnTzPfQ ($19.80 in chips)
Seat 9: HZkVla4kK2SI42CVrPZ/ig ($9.25 in chips)
iAISe3dVeua8PUn2wwgDHw: posts small blind $0.25
5k9fvXD9suIgCxU4HLQjTw: posts big blind $0.50
*** HOLE CARDS ***
bkXkL3pmapikPQQRNPZSEA: folds
6ol/q1A4zYU6qXbZnTzPfQ: folds
6ol/q1A4zYU6qXbZnTzPfQ leaves the table
HZkVla4kK2SI42CVrPZ/ig: folds
jf2c/o9gI7Xj0GleCSMj9g: folds
C3rGXblctNcWI6JYPHhaEg: folds
iadBi5AEt7gTBXbDSSnMYQ: folds
gPEN9Zp33YTm/mu9/SYP1w: folds
iAISe3dVeua8PUn2wwgDHw: calls $0.25
5k9fvXD9suIgCxU4HLQjTw: checks
*** FLOP *** [9s 6d 3c]
CAuekkxPVzBL9SK4Tjjbuw joins the table at seat #8
iAISe3dVeua8PUn2wwgDHw: checks
5k9fvXD9suIgCxU4HLQjTw: bets $1
iAISe3dVeua8PUn2wwgDHw: calls $1
*** TURN *** [9s 6d 3c] [8d]
iAISe3dVeua8PUn2wwgDHw: checks
5k9fvXD9suIgCxU4HLQjTw: checks
*** RIVER *** [9s 6d 3c 8d] [6s]
iAISe3dVeua8PUn2wwgDHw: checks
5k9fvXD9suIgCxU4HLQjTw: checks
*** SHOW DOWN ***
iAISe3dVeua8PUn2wwgDHw: shows [5s Qs] (a pair of Sixes)
5k9fvXD9suIgCxU4HLQjTw: mucks hand
iAISe3dVeua8PUn2wwgDHw collected $2.90 from pot
*** SUMMARY ***
Total pot $3 | Rake $0.10
Board [9s 6d 3c 8d 6s]
Seat 1: jf2c/o9gI7Xj0GleCSMj9g folded before Flop (didn't bet)
Seat 2: C3rGXblctNcWI6JYPHhaEg folded before Flop (didn't bet)
Seat 3: iadBi5AEt7gTBXbDSSnMYQ folded before Flop (didn't bet)
Seat 4: gPEN9Zp33YTm/mu9/SYP1w (button) folded before Flop (didn't bet)
Seat 5: iAISe3dVeua8PUn2wwgDHw (small blind) showed [5s Qs] and won ($2.90) with a pair of Sixes
Seat 6: 5k9fvXD9suIgCxU4HLQjTw (big blind) mucked
Seat 7: bkXkL3pmapikPQQRNPZSEA folded before Flop (didn't bet)
Seat 8: 6ol/q1A4zYU6qXbZnTzPfQ folded before Flop (didn't bet)
Seat 9: HZkVla4kK2SI42CVrPZ/ig folded before Flop (didn't bet)



PokerStars Game #59938966106:  Hold'em No Limit ($0.25/$0.50) - 2009/07/01 0:27:59 ET
Table 'GfL/No5u5PoEnU39lP5pQg' 6-max Seat #4 is the button
Seat 1: 1WUCqNG+p+vfWRTXNu4ljw ($51.40 in chips)
Seat 2: uVwggSetzp7d+eVgowO3vg ($54.40 in chips)
Seat 4: OZ6OtYh5Y53MCH/p0QTn5g ($50 in chips)
Seat 5: crjGpJEzSZgD38FoE3VMGg ($53.05 in chips)
crjGpJEzSZgD38FoE3VMGg: posts small blind $0.25
1WUCqNG+p+vfWRTXNu4ljw: posts big blind $0.50
*** HOLE CARDS ***
uVwggSetzp7d+eVgowO3vg: raises $1 to $1.50
OZ6OtYh5Y53MCH/p0QTn5g: folds
crjGpJEzSZgD38FoE3VMGg: folds
1WUCqNG+p+vfWRTXNu4ljw: calls $1
*** FLOP *** [7c Kh 9h]
1WUCqNG+p+vfWRTXNu4ljw: checks
uVwggSetzp7d+eVgowO3vg: bets $2
1WUCqNG+p+vfWRTXNu4ljw: calls $2
*** TURN *** [7c Kh 9h] [Ah]
1WUCqNG+p+vfWRTXNu4ljw: checks
uVwggSetzp7d+eVgowO3vg: checks
*** RIVER *** [7c Kh 9h Ah] [6d]
1WUCqNG+p+vfWRTXNu4ljw: checks
uVwggSetzp7d+eVgowO3vg: checks
*** SHOW DOWN ***
1WUCqNG+p+vfWRTXNu4ljw: shows [Ts Tc] (a pair of Tens)
uVwggSetzp7d+eVgowO3vg: shows [7h 7s] (three of a kind, Sevens)
uVwggSetzp7d+eVgowO3vg collected $6.90 from pot
*** SUMMARY ***
Total pot $7.25 | Rake $0.35
Board [7c Kh 9h Ah 6d]
Seat 1: 1WUCqNG+p+vfWRTXNu4ljw (big blind) showed [Ts Tc] and lost with a pair of Tens
Seat 2: uVwggSetzp7d+eVgowO3vg showed [7h 7s] and won ($6.90) with three of a kind, Sevens
Seat 4: OZ6OtYh5Y53MCH/p0QTn5g (button) folded before Flop (didn't bet)
Seat 5: crjGpJEzSZgD38FoE3VMGg (small blind) folded before Flop



PokerStars Game #59938967528:  Hold'em No Limit ($0.25/$0.50) - 2009/07/01 0:28:01 ET
Table '/cQuAT3ef4t+PGrXiNhGaQ' 9-max Seat #3 is the button
Seat 1: mMPPugoX87YtMYMtcxQcoA ($13.95 in chips)
Seat 2: jXGruyaMqirTaTXNOvBdew ($51.90 in chips)
Seat 3: g4k0NXISyLCqaSWZDBjfEg ($55.40 in chips)
Seat 4: OWP/DOu+PlPK6ZZ3zYa0HA ($41.90 in chips)
Seat 5: 5SgaHdWixdClWvaEG+KUjQ ($26.70 in chips)
Seat 6: APYIOyK/4AGb+kIwlOUNBQ ($47.25 in chips)
Seat 7: J0W5D97jl5VLky+IoPvDeA ($111.80 in chips)
Seat 8: W3ingbA178eb7J5rt1PuIQ ($22.65 in chips)
Seat 9: E2518gp4aFz1+kAgmGqeEg ($14.65 in chips)
OWP/DOu+PlPK6ZZ3zYa0HA: posts small blind $0.25
5SgaHdWixdClWvaEG+KUjQ: posts big blind $0.50
*** HOLE CARDS ***
APYIOyK/4AGb+kIwlOUNBQ: folds
J0W5D97jl5VLky+IoPvDeA: folds
W3ingbA178eb7J5rt1PuIQ: folds
E2518gp4aFz1+kAgmGqeEg: folds
mMPPugoX87YtMYMtcxQcoA: calls $0.50
jXGruyaMqirTaTXNOvBdew: raises $1 to $1.50
g4k0NXISyLCqaSWZDBjfEg: calls $1.50
OWP/DOu+PlPK6ZZ3zYa0HA: folds
5SgaHdWixdClWvaEG+KUjQ: calls $1
mMPPugoX87YtMYMtcxQcoA: calls $1
*** FLOP *** [Qc 5c 7c]
5SgaHdWixdClWvaEG+KUjQ: checks
mMPPugoX87YtMYMtcxQcoA: bets $1
jXGruyaMqirTaTXNOvBdew: calls $1
g4k0NXISyLCqaSWZDBjfEg: folds
5SgaHdWixdClWvaEG+KUjQ: calls $1
*** TURN *** [Qc 5c 7c] [8s]
5SgaHdWixdClWvaEG+KUjQ: bets $3
mMPPugoX87YtMYMtcxQcoA: calls $3
jXGruyaMqirTaTXNOvBdew: raises $6 to $9
5SgaHdWixdClWvaEG+KUjQ: folds
mMPPugoX87YtMYMtcxQcoA: raises $2.45 to $11.45 and is all-in
jXGruyaMqirTaTXNOvBdew: calls $2.45
*** RIVER *** [Qc 5c 7c 8s] [Ts]
*** SHOW DOWN ***
mMPPugoX87YtMYMtcxQcoA: shows [Jh Qs] (a pair of Queens)
jXGruyaMqirTaTXNOvBdew: shows [6c Kc] (a flush, King high)
jXGruyaMqirTaTXNOvBdew collected $33.45 from pot
*** SUMMARY ***
Total pot $35.15 | Rake $1.70
Board [Qc 5c 7c 8s Ts]
Seat 1: mMPPugoX87YtMYMtcxQcoA showed [Jh Qs] and lost with a pair of Queens
Seat 2: jXGruyaMqirTaTXNOvBdew showed [6c Kc] and won ($33.45) with a flush, King high
Seat 3: g4k0NXISyLCqaSWZDBjfEg (button) folded on the Flop
Seat 4: OWP/DOu+PlPK6ZZ3zYa0HA (small blind) folded before Flop
Seat 5: 5SgaHdWixdClWvaEG+KUjQ (big blind) folded on the Turn
Seat 6: APYIOyK/4AGb+kIwlOUNBQ folded before Flop (didn't bet)
Seat 7: J0W5D97jl5VLky+IoPvDeA folded before Flop (didn't bet)
Seat 8: W3ingbA178eb7J5rt1PuIQ folded before Flop (didn't bet)
Seat 9: E2518gp4aFz1+kAgmGqeEg folded before Flop (didn't bet)



PokerStars Game #59938968040:  Hold'em No Limit ($0.25/$0.50) - 2009/07/01 0:28:02 ET
Table 'hSTs/dUsYLgJQuF2Onp0MQ' 6-max Seat #6 is the button
Seat 1: Donj3X7gYzeS5pAl7s9f+Q ($30.70 in chips)
Seat 2: 6vNxrjjCl6FwfaaymM9jjg ($23.65 in chips)
Seat 4: L0aIPg7qefDQjdJo3HCVEA ($9.25 in chips)
Seat 5: 686aeHikcJlgKkSuIFdcXQ ($60.65 in chips)
Seat 6: +laPa9P7BjZKKnR0n+OmvA ($8.95 in chips)
Donj3X7gYzeS5pAl7s9f+Q: posts small blind $0.25
6vNxrjjCl6FwfaaymM9jjg: posts big blind $0.50
C3qJBo7uxfFVDluE1lmK2w: sits out
*** HOLE CARDS ***
L0aIPg7qefDQjdJo3HCVEA: raises $0.50 to $1
686aeHikcJlgKkSuIFdcXQ: folds
+laPa9P7BjZKKnR0n+OmvA: folds
Donj3X7gYzeS5pAl7s9f+Q: calls $0.75
6vNxrjjCl6FwfaaymM9jjg: calls $0.50
*** FLOP *** [Qc 3d 9h]
Donj3X7gYzeS5pAl7s9f+Q: bets $2
6vNxrjjCl6FwfaaymM9jjg: raises $2 to $4
L0aIPg7qefDQjdJo3HCVEA: folds
Donj3X7gYzeS5pAl7s9f+Q: folds
6vNxrjjCl6FwfaaymM9jjg collected $6.70 from pot
*** SUMMARY ***
Total pot $7 | Rake $0.30
Board [Qc 3d 9h]
Seat 1: Donj3X7gYzeS5pAl7s9f+Q (small blind) folded on the Flop
Seat 2: 6vNxrjjCl6FwfaaymM9jjg (big blind) collected ($6.70)
Seat 4: L0aIPg7qefDQjdJo3HCVEA folded on the Flop
Seat 5: 686aeHikcJlgKkSuIFdcXQ folded before Flop (didn't bet)
Seat 6: +laPa9P7BjZKKnR0n+OmvA (button) folded before Flop (didn't bet)



PokerStars Game #59938968848:  Hold'em No Limit ($0.25/$0.50) - 2009/07/01 0:28:03 ET
Table 'mTxf8gPLgffN3Iwfm7Icfg' 2-max Seat #1 is the button
Seat 1: Do9Rlu1R5u/AcRtMTl8SYg ($94.45 in chips)
Seat 2: EMc5LPgVaded4Qc77vm0fw ($65.35 in chips)
Do9Rlu1R5u/AcRtMTl8SYg: posts small blind $0.25
EMc5LPgVaded4Qc77vm0fw: posts big blind $0.50
*** HOLE CARDS ***
Do9Rlu1R5u/AcRtMTl8SYg: raises $1 to $1.50
EMc5LPgVaded4Qc77vm0fw: calls $1
*** FLOP *** [As 2d 8d]
EMc5LPgVaded4Qc77vm0fw: checks
Do9Rlu1R5u/AcRtMTl8SYg: bets $2
EMc5LPgVaded4Qc77vm0fw: folds
Do9Rlu1R5u/AcRtMTl8SYg collected $2.85 from pot
Do9Rlu1R5u/AcRtMTl8SYg: doesn't show hand
*** SUMMARY ***
Total pot $3 | Rake $0.15
Board [As 2d 8d]
Seat 1: Do9Rlu1R5u/AcRtMTl8SYg (button) (small blind) collected ($2.85)
Seat 2: EMc5LPgVaded4Qc77vm0fw (big blind) folded on the Flop



PokerStars Game #59938970260:  Hold'em No Limit ($0.25/$0.50) - 2009/07/01 0:28:05 ET
Table 'E7bWJ45aoFXRpyRv2gw+Ig' 2-max Seat #2 is the button
Seat 1: FRkiRasEGlHUeLrEl+k/nA ($54.60 in chips)
Seat 2: 3Wro85I7472vJ4Wkpneo9A ($122.65 in chips)
3Wro85I7472vJ4Wkpneo9A: posts small blind $0.25
FRkiRasEGlHUeLrEl+k/nA: posts big blind $0.50
*** HOLE CARDS ***
3Wro85I7472vJ4Wkpneo9A: raises $1 to $1.50
FRkiRasEGlHUeLrEl+k/nA: calls $1
*** FLOP *** [Kd Ts Th]
FRkiRasEGlHUeLrEl+k/nA: checks
3Wro85I7472vJ4Wkpneo9A: checks
*** TURN *** [Kd Ts Th] [7d]
FRkiRasEGlHUeLrEl+k/nA: checks
3Wro85I7472vJ4Wkpneo9A: checks
*** RIVER *** [Kd Ts Th 7d] [Jd]
FRkiRasEGlHUeLrEl+k/nA: checks
3Wro85I7472vJ4Wkpneo9A: checks
*** SHOW DOWN ***
FRkiRasEGlHUeLrEl+k/nA: shows [Qh 7s] (two pair, Tens and Sevens)
3Wro85I7472vJ4Wkpneo9A: shows [7h 4d] (two pair, Tens and Sevens)
FRkiRasEGlHUeLrEl+k/nA collected $1.45 from pot
3Wro85I7472vJ4Wkpneo9A collected $1.40 from pot
*** SUMMARY ***
Total pot $3 | Rake $0.15
Board [Kd Ts Th 7d Jd]
Seat 1: FRkiRasEGlHUeLrEl+k/nA (big blind) showed [Qh 7s] and won ($1.45) with two pair, Tens and Sevens
Seat 2: 3Wro85I7472vJ4Wkpneo9A (button) (small blind) showed [7h 4d] and won ($1.40) with two pair, Tens and Sevens



PokerStars Game #59938970146:  Hold'em No Limit ($0.25/$0.50) - 2009/07/01 0:28:05 ET
Table 'otvGDROEDdqsabxskT79qg' 9-max Seat #2 is the button
Seat 1: 8ehL7qlZzjgUh2H35iiWLw ($50 in chips)
Seat 2: cCjTzH9jio8607WzjcfXlg ($11.30 in chips)
Seat 3: +k7T5ocke8UwavtgUHm+Cg ($76.65 in chips)
Seat 4: MG90wfSJZnOejs/KD3vlQQ ($51.80 in chips)
Seat 5: XNMDwbXt/Q4jM99AXnbJDw ($54.45 in chips)
Seat 7: C7+tBppJrKgd/r+tuKUIpA ($40.15 in chips)
Seat 9: KcY3X8YpD74Kw1RHkx/g4A ($61.60 in chips)
+k7T5ocke8UwavtgUHm+Cg: posts small blind $0.25
MG90wfSJZnOejs/KD3vlQQ: posts big blind $0.50
bxLSulbgr8LmKNjOzw8URg: sits out
zE9cVigS2nW/Ljy4K4bUQA: sits out
*** HOLE CARDS ***
XNMDwbXt/Q4jM99AXnbJDw: folds
C7+tBppJrKgd/r+tuKUIpA: folds
KcY3X8YpD74Kw1RHkx/g4A: folds
8ehL7qlZzjgUh2H35iiWLw: raises $1.50 to $2
cCjTzH9jio8607WzjcfXlg: folds
+k7T5ocke8UwavtgUHm+Cg: calls $1.75
MG90wfSJZnOejs/KD3vlQQ: folds
*** FLOP *** [2h Qc 4d]
+k7T5ocke8UwavtgUHm+Cg: checks
8ehL7qlZzjgUh2H35iiWLw: bets $3
+k7T5ocke8UwavtgUHm+Cg: folds
8ehL7qlZzjgUh2H35iiWLw collected $4.30 from pot
8ehL7qlZzjgUh2H35iiWLw: doesn't show hand
*** SUMMARY ***
Total pot $4.50 | Rake $0.20
Board [2h Qc 4d]
Seat 1: 8ehL7qlZzjgUh2H35iiWLw collected ($4.30)
Seat 2: cCjTzH9jio8607WzjcfXlg (button) folded before Flop (didn't bet)
Seat 3: +k7T5ocke8UwavtgUHm+Cg (small blind) folded on the Flop
Seat 4: MG90wfSJZnOejs/KD3vlQQ (big blind) folded before Flop
Seat 5: XNMDwbXt/Q4jM99AXnbJDw folded before Flop (didn't bet)
Seat 7: C7+tBppJrKgd/r+tuKUIpA folded before Flop (didn't bet)
Seat 9: KcY3X8YpD74Kw1RHkx/g4A folded before Flop (didn't bet)



PokerStars Game #59938970862:  Hold'em No Limit ($0.25/$0.50) - 2009/07/01 0:28:06 ET
Table 'lSisgp6H7Fg1hH5VfjEjYQ' 9-max Seat #8 is the button
Seat 1: pEW8B6uXbdR47kfljMQ3+Q ($38.60 in chips)
Seat 2: UrcnkQOiLVk8BlKDPJSy7Q ($50.35 in chips)
Seat 3: aTkyjTh3w5YLWiIERupZOA ($39.40 in chips)
Seat 4: bwv/rbH/hHhPhY6u9mu04w ($25.65 in chips)
Seat 5: mSD1pginDsyHG5PDfqzphw ($10 in chips)
Seat 6: +k7T5ocke8UwavtgUHm+Cg ($25.35 in chips)
Seat 7: dGw5MBstXyXhWHHVFOWOFA ($42 in chips)
Seat 8: a4JDWmpFQkL10XfAyuF51A ($38 in chips)
Seat 9: 5JJVDlaiMnB004o/RqbZZQ ($40 in chips)
pEW8B6uXbdR47kfljMQ3+Q is connected
5JJVDlaiMnB004o/RqbZZQ: posts small blind $0.25
pEW8B6uXbdR47kfljMQ3+Q: posts big blind $0.50
*** HOLE CARDS ***
UrcnkQOiLVk8BlKDPJSy7Q: folds
aTkyjTh3w5YLWiIERupZOA: folds
bwv/rbH/hHhPhY6u9mu04w: folds
mSD1pginDsyHG5PDfqzphw: folds
+k7T5ocke8UwavtgUHm+Cg: folds
dGw5MBstXyXhWHHVFOWOFA: folds
a4JDWmpFQkL10XfAyuF51A: folds
5JJVDlaiMnB004o/RqbZZQ: calls $0.25
pEW8B6uXbdR47kfljMQ3+Q: checks
*** FLOP *** [2d 9d 8c]
5JJVDlaiMnB004o/RqbZZQ: bets $1.50
pEW8B6uXbdR47kfljMQ3+Q: folds
5JJVDlaiMnB004o/RqbZZQ collected $0.95 from pot
*** SUMMARY ***
Total pot $1 | Rake $0.05
Board [2d 9d 8c]
Seat 1: pEW8B6uXbdR47kfljMQ3+Q (big blind) folded on the Flop
Seat 2: UrcnkQOiLVk8BlKDPJSy7Q folded before Flop (didn't bet)
Seat 3: aTkyjTh3w5YLWiIERupZOA folded before Flop (didn't bet)
Seat 4: bwv/rbH/hHhPhY6u9mu04w folded before Flop (didn't bet)
Seat 5: mSD1pginDsyHG5PDfqzphw folded before Flop (didn't bet)
Seat 6: +k7T5ocke8UwavtgUHm+Cg folded before Flop (didn't bet)
Seat 7: dGw5MBstXyXhWHHVFOWOFA folded before Flop (didn't bet)
Seat 8: a4JDWmpFQkL10XfAyuF51A (button) folded before Flop (didn't bet)
Seat 9: 5JJVDlaiMnB004o/RqbZZQ (small blind) collected ($0.95)



PokerStars Game #59938970806:  Hold'em No Limit ($0.25/$0.50) - 2009/07/01 0:28:06 ET
Table 'NCiXr0d5CEKBQr/cZgLhbA' 9-max Seat #7 is the button
Seat 1: RjBdQ6w31rgcy0o24VLR6w ($15.85 in chips)
Seat 2: ulxuJchBV9iguXg0FUonfg ($35.20 in chips)
Seat 3: xZCXQSXlrZkp3pZizzVXCw ($57.65 in chips)
Seat 4: 5k9fvXD9suIgCxU4HLQjTw ($50 in chips)
Seat 5: zE9cVigS2nW/Ljy4K4bUQA ($39.50 in chips)
Seat 6: SKnJuWHScqetA/qG5p+wCg ($30 in chips)
Seat 7: M+7+BTmX5vZatHVuoRB1nA ($48.50 in chips)
Seat 8: 1MJUKc3cc0QmUoz1JZLR2w ($53.35 in chips)
Seat 9: 4WLZvqBn5qv5tds5kt5A1Q ($30 in chips)
1MJUKc3cc0QmUoz1JZLR2w: posts small blind $0.25
4WLZvqBn5qv5tds5kt5A1Q: posts big blind $0.50
*** HOLE CARDS ***
RjBdQ6w31rgcy0o24VLR6w: folds
ulxuJchBV9iguXg0FUonfg: folds
xZCXQSXlrZkp3pZizzVXCw: folds
5k9fvXD9suIgCxU4HLQjTw: folds
zE9cVigS2nW/Ljy4K4bUQA: folds
SKnJuWHScqetA/qG5p+wCg: folds
M+7+BTmX5vZatHVuoRB1nA: folds
1MJUKc3cc0QmUoz1JZLR2w: folds
4WLZvqBn5qv5tds5kt5A1Q collected $0.50 from pot
*** SUMMARY ***
Total pot $0.50 | Rake $0
Seat 1: RjBdQ6w31rgcy0o24VLR6w folded before Flop (didn't bet)
Seat 2: ulxuJchBV9iguXg0FUonfg folded before Flop (didn't bet)
Seat 3: xZCXQSXlrZkp3pZizzVXCw folded before Flop (didn't bet)
Seat 4: 5k9fvXD9suIgCxU4HLQjTw folded before Flop (didn't bet)
Seat 5: zE9cVigS2nW/Ljy4K4bUQA folded before Flop (didn't bet)
Seat 6: SKnJuWHScqetA/qG5p+wCg folded before Flop (didn't bet)
Seat 7: M+7+BTmX5vZatHVuoRB1nA (button) folded before Flop (didn't bet)
Seat 8: 1MJUKc3cc0QmUoz1JZLR2w (small blind) folded before Flop
Seat 9: 4WLZvqBn5qv5tds5kt5A1Q (big blind) collected ($0.50)



PokerStars Game #59938972200:  Hold'em No Limit ($0.25/$0.50) - 2009/07/01 0:28:08 ET
Table 'tyR5AZNKV8Aadbrnrnlg7g' 6-max Seat #5 is the button
Seat 1: R+KjpH/wSjDLhtIy9+edNA ($87 in chips)
Seat 2: 58zdeSBSuSFX/qZfhc7YmA ($28.35 in chips)
Seat 3: tdOvWynovql5imfooroLMg ($50 in chips)
Seat 4: Rt6KgtZ8YaJoTc3FPim00w ($83.50 in chips)
Seat 5: wOyVV9M/oyiw3YaOjNZ05w ($54.60 in chips)
Seat 6: ZKazl1hGaPiapDXincgi2Q ($29.50 in chips)
ZKazl1hGaPiapDXincgi2Q: posts small blind $0.25
R+KjpH/wSjDLhtIy9+edNA: posts big blind $0.50
*** HOLE CARDS ***
58zdeSBSuSFX/qZfhc7YmA: calls $0.50
tdOvWynovql5imfooroLMg: calls $0.50
Rt6KgtZ8YaJoTc3FPim00w: folds
wOyVV9M/oyiw3YaOjNZ05w: folds
ZKazl1hGaPiapDXincgi2Q: calls $0.25
R+KjpH/wSjDLhtIy9+edNA: checks
*** FLOP *** [6c Td Kd]
ZKazl1hGaPiapDXincgi2Q: checks
R+KjpH/wSjDLhtIy9+edNA: checks
58zdeSBSuSFX/qZfhc7YmA: bets $1.50
tdOvWynovql5imfooroLMg: folds
ZKazl1hGaPiapDXincgi2Q: folds
R+KjpH/wSjDLhtIy9+edNA: folds
58zdeSBSuSFX/qZfhc7YmA collected $1.90 from pot
*** SUMMARY ***
Total pot $2 | Rake $0.10
Board [6c Td Kd]
Seat 1: R+KjpH/wSjDLhtIy9+edNA (big blind) folded on the Flop
Seat 2: 58zdeSBSuSFX/qZfhc7YmA collected ($1.90)
Seat 3: tdOvWynovql5imfooroLMg folded on the Flop
Seat 4: Rt6KgtZ8YaJoTc3FPim00w folded before Flop (didn't bet)
Seat 5: wOyVV9M/oyiw3YaOjNZ05w (button) folded before Flop (didn't bet)
Seat 6: ZKazl1hGaPiapDXincgi2Q (small blind) folded on the Flop



PokerStars Game #59938975014:  Hold'em No Limit ($0.25/$0.50) - 2009/07/01 0:28:12 ET
Table 'IeNZOZQ4T6oiaHqFeo6yIA' 2-max Seat #1 is the button
Seat 1: ndd1nfncBkWNitBnsfCoVQ ($82.30 in chips)
Seat 2: A91IUl5JaZROhtfCtnnwYw ($50.55 in chips)
ndd1nfncBkWNitBnsfCoVQ: posts small blind $0.25
A91IUl5JaZROhtfCtnnwYw: posts big blind $0.50
*** HOLE CARDS ***
ndd1nfncBkWNitBnsfCoVQ: raises $1 to $1.50
A91IUl5JaZROhtfCtnnwYw: raises $1 to $2.50
ndd1nfncBkWNitBnsfCoVQ: folds
A91IUl5JaZROhtfCtnnwYw collected $3 from pot
*** SUMMARY ***
Total pot $3 | Rake $0
Seat 1: ndd1nfncBkWNitBnsfCoVQ (button) (small blind) folded before Flop
Seat 2: A91IUl5JaZROhtfCtnnwYw (big blind) collected ($3)



PokerStars Game #59938977528:  Hold'em No Limit ($0.25/$0.50) - 2009/07/01 0:28:16 ET
Table 'kgbJRsxfv64KrErDRBAkcw' 6-max Seat #6 is the button
Seat 1: N7O9jUEx2YiQn1+yRYTHmw ($17.55 in chips)
Seat 2: Q+thC23WCv1kJUJtH/+4Jw ($67.15 in chips)
Seat 3: T0Gx/FcQ5VH9u7XaOMX97A ($61.60 in chips)
Seat 4: qanMEqjABjWxC/JgQ/0l7w ($59.95 in chips)
Seat 5: +Pf9jTVizYlIo+woPvptfA ($50 in chips)
Seat 6: ozrlafxxh1HmYdA0/h+MuA ($6.85 in chips)
N7O9jUEx2YiQn1+yRYTHmw: posts small blind $0.25
Q+thC23WCv1kJUJtH/+4Jw: posts big blind $0.50
*** HOLE CARDS ***
T0Gx/FcQ5VH9u7XaOMX97A: folds
qanMEqjABjWxC/JgQ/0l7w: raises $1 to $1.50
+Pf9jTVizYlIo+woPvptfA: folds
ozrlafxxh1HmYdA0/h+MuA: calls $1.50
N7O9jUEx2YiQn1+yRYTHmw: folds
Q+thC23WCv1kJUJtH/+4Jw: calls $1
*** FLOP *** [Qs 2d Qh]
Q+thC23WCv1kJUJtH/+4Jw: checks
qanMEqjABjWxC/JgQ/0l7w: checks
ozrlafxxh1HmYdA0/h+MuA: checks
*** TURN *** [Qs 2d Qh] [3c]
Q+thC23WCv1kJUJtH/+4Jw: bets $3.50
qanMEqjABjWxC/JgQ/0l7w: folds
ozrlafxxh1HmYdA0/h+MuA: calls $3.50
*** RIVER *** [Qs 2d Qh 3c] [Ac]
Q+thC23WCv1kJUJtH/+4Jw: bets $2
ozrlafxxh1HmYdA0/h+MuA: calls $1.85 and is all-in
*** SHOW DOWN ***
Q+thC23WCv1kJUJtH/+4Jw: shows [Qd 5d] (three of a kind, Queens)
ozrlafxxh1HmYdA0/h+MuA: shows [3h 3s] (a full house, Threes full of Queens)
ozrlafxxh1HmYdA0/h+MuA collected $14.75 from pot
*** SUMMARY ***
Total pot $15.45 | Rake $0.70
Board [Qs 2d Qh 3c Ac]
Seat 1: N7O9jUEx2YiQn1+yRYTHmw (small blind) folded before Flop
Seat 2: Q+thC23WCv1kJUJtH/+4Jw (big blind) showed [Qd 5d] and lost with three of a kind, Queens
Seat 3: T0Gx/FcQ5VH9u7XaOMX97A folded before Flop (didn't bet)
Seat 4: qanMEqjABjWxC/JgQ/0l7w folded on the Turn
Seat 5: +Pf9jTVizYlIo+woPvptfA folded before Flop (didn't bet)
Seat 6: ozrlafxxh1HmYdA0/h+MuA (button) showed [3h 3s] and won ($14.75) with a full house, Threes full of Queens



PokerStars Game #59938978424:  Hold'em No Limit ($0.25/$0.50) - 2009/07/01 0:28:17 ET
Table 'QOgaEqMcJ73pcUMMxoisUg' 6-max Seat #5 is the button
Seat 2: Im2p1Nt83UKSqv5c9frm4Q ($50 in chips)
Seat 3: wUZNozoIDYf+16hp4nn6dw ($34.95 in chips)
Seat 4: zAcsDhG/T128Vn7XGVSgKg ($61.05 in chips)
Seat 5: 6vNxrjjCl6FwfaaymM9jjg ($29.30 in chips)
Seat 6: s83dnhZ6VC53vY0/f6OV/g ($41.85 in chips)
s83dnhZ6VC53vY0/f6OV/g: posts small blind $0.25
Im2p1Nt83UKSqv5c9frm4Q: posts big blind $0.50
*** HOLE CARDS ***
wUZNozoIDYf+16hp4nn6dw: raises $0.50 to $1
zAcsDhG/T128Vn7XGVSgKg: folds
6vNxrjjCl6FwfaaymM9jjg: calls $1
s83dnhZ6VC53vY0/f6OV/g: folds
Im2p1Nt83UKSqv5c9frm4Q: calls $0.50
*** FLOP *** [5d 8h 3c]
Im2p1Nt83UKSqv5c9frm4Q: checks
wUZNozoIDYf+16hp4nn6dw: bets $1.50
6vNxrjjCl6FwfaaymM9jjg: calls $1.50
Im2p1Nt83UKSqv5c9frm4Q: folds
*** TURN *** [5d 8h 3c] [6s]
wUZNozoIDYf+16hp4nn6dw: bets $3.50
6vNxrjjCl6FwfaaymM9jjg: folds
wUZNozoIDYf+16hp4nn6dw collected $5.95 from pot
*** SUMMARY ***
Total pot $6.25 | Rake $0.30
Board [5d 8h 3c 6s]
Seat 2: Im2p1Nt83UKSqv5c9frm4Q (big blind) folded on the Flop
Seat 3: wUZNozoIDYf+16hp4nn6dw collected ($5.95)
Seat 4: zAcsDhG/T128Vn7XGVSgKg folded before Flop (didn't bet)
Seat 5: 6vNxrjjCl6FwfaaymM9jjg (button) folded on the Turn
Seat 6: s83dnhZ6VC53vY0/f6OV/g (small blind) folded before Flop



PokerStars Game #59938978768:  Hold'em No Limit ($0.25/$0.50) - 2009/07/01 0:28:18 ET
Table '+dXkOAQyS8j9PQZusUTMpg' 2-max Seat #1 is the button
Seat 1: XFa6sBGjP2gxoIvxR3fZIg ($51.40 in chips)
Seat 2: 5IBeOgaApY1Bvzv2P8X4EA ($93.25 in chips)
XFa6sBGjP2gxoIvxR3fZIg: posts small blind $0.25
5IBeOgaApY1Bvzv2P8X4EA: posts big blind $0.50
*** HOLE CARDS ***
XFa6sBGjP2gxoIvxR3fZIg: raises $1 to $1.50
5IBeOgaApY1Bvzv2P8X4EA: folds
XFa6sBGjP2gxoIvxR3fZIg collected $1 from pot
XFa6sBGjP2gxoIvxR3fZIg: doesn't show hand
*** SUMMARY ***
Total pot $1 | Rake $0
Seat 1: XFa6sBGjP2gxoIvxR3fZIg (button) (small blind) collected ($1)
Seat 2: 5IBeOgaApY1Bvzv2P8X4EA (big blind) folded before Flop



PokerStars Game #59938979666:  Hold'em No Limit ($0.25/$0.50) - 2009/07/01 0:28:19 ET
Table 'mTxf8gPLgffN3Iwfm7Icfg' 2-max Seat #2 is the button
Seat 1: Do9Rlu1R5u/AcRtMTl8SYg ($95.80 in chips)
Seat 2: EMc5LPgVaded4Qc77vm0fw ($63.85 in chips)
EMc5LPgVaded4Qc77vm0fw: posts small blind $0.25
Do9Rlu1R5u/AcRtMTl8SYg: posts big blind $0.50
*** HOLE CARDS ***
EMc5LPgVaded4Qc77vm0fw: raises $1 to $1.50
Do9Rlu1R5u/AcRtMTl8SYg: folds
EMc5LPgVaded4Qc77vm0fw collected $1 from pot
EMc5LPgVaded4Qc77vm0fw: doesn't show hand
*** SUMMARY ***
Total pot $1 | Rake $0
Seat 1: Do9Rlu1R5u/AcRtMTl8SYg (big blind) folded before Flop
Seat 2: EMc5LPgVaded4Qc77vm0fw (button) (small blind) collected ($1)



PokerStars Game #59938979568:  Hold'em No Limit ($0.25/$0.50) - 2009/07/01 0:28:19 ET
Table '+z1aekfHkpp09pc8F9aViw' 6-max Seat #2 is the button
Seat 1: wOyVV9M/oyiw3YaOjNZ05w ($52.55 in chips)
Seat 2: M6xK/VklCvdyyrmvzATlxQ ($38.30 in chips)
Seat 3: uUznlIMFnRUvwrBhYF73KA ($59 in chips)
Seat 4: RowCSpSURHTOL/dcjg/Iug ($43.20 in chips)
Seat 5: crjGpJEzSZgD38FoE3VMGg ($59.15 in chips)
Seat 6: 686aeHikcJlgKkSuIFdcXQ ($70.10 in chips)
uUznlIMFnRUvwrBhYF73KA: posts small blind $0.25
RowCSpSURHTOL/dcjg/Iug: posts big blind $0.50
*** HOLE CARDS ***
crjGpJEzSZgD38FoE3VMGg: folds
686aeHikcJlgKkSuIFdcXQ: folds
wOyVV9M/oyiw3YaOjNZ05w: folds
M6xK/VklCvdyyrmvzATlxQ: folds
uUznlIMFnRUvwrBhYF73KA: calls $0.25
RowCSpSURHTOL/dcjg/Iug: raises $1.50 to $2
uUznlIMFnRUvwrBhYF73KA: raises $1.50 to $3.50
RowCSpSURHTOL/dcjg/Iug: calls $1.50
*** FLOP *** [4c 4h 3h]
uUznlIMFnRUvwrBhYF73KA: checks
RowCSpSURHTOL/dcjg/Iug: bets $3
uUznlIMFnRUvwrBhYF73KA: raises $3 to $6
RowCSpSURHTOL/dcjg/Iug: calls $3
*** TURN *** [4c 4h 3h] [5s]
uUznlIMFnRUvwrBhYF73KA: checks
RowCSpSURHTOL/dcjg/Iug: checks
*** RIVER *** [4c 4h 3h 5s] [As]
uUznlIMFnRUvwrBhYF73KA: checks
RowCSpSURHTOL/dcjg/Iug: checks
*** SHOW DOWN ***
uUznlIMFnRUvwrBhYF73KA: shows [Kc Ad] (two pair, Aces and Fours)
RowCSpSURHTOL/dcjg/Iug: mucks hand
uUznlIMFnRUvwrBhYF73KA collected $18.10 from pot
*** SUMMARY ***
Total pot $19 | Rake $0.90
Board [4c 4h 3h 5s As]
Seat 1: wOyVV9M/oyiw3YaOjNZ05w folded before Flop (didn't bet)
Seat 2: M6xK/VklCvdyyrmvzATlxQ (button) folded before Flop (didn't bet)
Seat 3: uUznlIMFnRUvwrBhYF73KA (small blind) showed [Kc Ad] and won ($18.10) with two pair, Aces and Fours
Seat 4: RowCSpSURHTOL/dcjg/Iug (big blind) mucked
Seat 5: crjGpJEzSZgD38FoE3VMGg folded before Flop (didn't bet)
Seat 6: 686aeHikcJlgKkSuIFdcXQ folded before Flop (didn't bet)



PokerStars Game #59938979628:  Hold'em No Limit ($0.25/$0.50) - 2009/07/01 0:28:19 ET
Table 'Nz0Vr7WMHL2g5Uk7dDZjpw' 9-max Seat #8 is the button
Seat 2: XNMDwbXt/Q4jM99AXnbJDw ($50 in chips)
Seat 3: 4QTiNH5fteLgJjx/s6Hy6A ($18.40 in chips)
Seat 4: 5JJVDlaiMnB004o/RqbZZQ ($28.50 in chips)
Seat 5: WGW0DgjBUXs1ylURHG8vnQ ($15.90 in chips)
Seat 6: k1f0lS7tlMHCLGs0JT34Tg ($9.50 in chips)
Seat 7: KPLH0gELgFe2OuAnhJFI5w ($18.20 in chips)
Seat 8: HkZI6g4zl83TDTA7SRspmQ ($18.95 in chips)
Seat 9: Ak2W6V2TDVIQrvSAy4eD7Q ($26.75 in chips)
Ak2W6V2TDVIQrvSAy4eD7Q: posts small blind $0.25
XNMDwbXt/Q4jM99AXnbJDw: posts big blind $0.50
*** HOLE CARDS ***
4QTiNH5fteLgJjx/s6Hy6A: calls $0.50
5JJVDlaiMnB004o/RqbZZQ: folds
WGW0DgjBUXs1ylURHG8vnQ: folds
k1f0lS7tlMHCLGs0JT34Tg: calls $0.50
KPLH0gELgFe2OuAnhJFI5w: calls $0.50
HkZI6g4zl83TDTA7SRspmQ: calls $0.50
Ak2W6V2TDVIQrvSAy4eD7Q: calls $0.25
XNMDwbXt/Q4jM99AXnbJDw: checks
*** FLOP *** [4d 9s 5h]
Ak2W6V2TDVIQrvSAy4eD7Q: checks
XNMDwbXt/Q4jM99AXnbJDw: checks
4QTiNH5fteLgJjx/s6Hy6A: checks
k1f0lS7tlMHCLGs0JT34Tg: bets $1
KPLH0gELgFe2OuAnhJFI5w: calls $1
HkZI6g4zl83TDTA7SRspmQ: calls $1
Ak2W6V2TDVIQrvSAy4eD7Q: folds
XNMDwbXt/Q4jM99AXnbJDw: folds
4QTiNH5fteLgJjx/s6Hy6A: folds
*** TURN *** [4d 9s 5h] [3h]
k1f0lS7tlMHCLGs0JT34Tg: bets $1
KPLH0gELgFe2OuAnhJFI5w: calls $1
HkZI6g4zl83TDTA7SRspmQ: calls $1
*** RIVER *** [4d 9s 5h 3h] [2d]
k1f0lS7tlMHCLGs0JT34Tg: bets $3
KPLH0gELgFe2OuAnhJFI5w: calls $3
HkZI6g4zl83TDTA7SRspmQ: folds
*** SHOW DOWN ***
k1f0lS7tlMHCLGs0JT34Tg: shows [4c Ac] (a straight, Ace to Five)
KPLH0gELgFe2OuAnhJFI5w: shows [6c 8s] (a straight, Deuce to Six)
KPLH0gELgFe2OuAnhJFI5w collected $14.30 from pot
*** SUMMARY ***
Total pot $15 | Rake $0.70
Board [4d 9s 5h 3h 2d]
Seat 2: XNMDwbXt/Q4jM99AXnbJDw (big blind) folded on the Flop
Seat 3: 4QTiNH5fteLgJjx/s6Hy6A folded on the Flop
Seat 4: 5JJVDlaiMnB004o/RqbZZQ folded before Flop (didn't bet)
Seat 5: WGW0DgjBUXs1ylURHG8vnQ folded before Flop (didn't bet)
Seat 6: k1f0lS7tlMHCLGs0JT34Tg showed [4c Ac] and lost with a straight, Ace to Five
Seat 7: KPLH0gELgFe2OuAnhJFI5w showed [6c 8s] and won ($14.30) with a straight, Deuce to Six
Seat 8: HkZI6g4zl83TDTA7SRspmQ (button) folded on the River
Seat 9: Ak2W6V2TDVIQrvSAy4eD7Q (small blind) folded on the Flop



PokerStars Game #59938980314:  Hold'em No Limit ($0.25/$0.50) - 2009/07/01 0:28:20 ET
Table 'c/CRn+68J3Y8KxD5g1ek2Q' 2-max Seat #2 is the button
Seat 1: 46qCyJ6evTkHo9al5sBMNA ($259.75 in chips)
Seat 2: BypVLsYQt3ePFm2xQL/dOA ($119.70 in chips)
BypVLsYQt3ePFm2xQL/dOA: posts small blind $0.25
46qCyJ6evTkHo9al5sBMNA: posts big blind $0.50
*** HOLE CARDS ***
BypVLsYQt3ePFm2xQL/dOA: calls $0.25
46qCyJ6evTkHo9al5sBMNA: checks
*** FLOP *** [Qh Kd 3c]
46qCyJ6evTkHo9al5sBMNA: checks
BypVLsYQt3ePFm2xQL/dOA: bets $1
46qCyJ6evTkHo9al5sBMNA: folds
BypVLsYQt3ePFm2xQL/dOA collected $0.95 from pot
BypVLsYQt3ePFm2xQL/dOA: doesn't show hand
*** SUMMARY ***
Total pot $1 | Rake $0.05
Board [Qh Kd 3c]
Seat 1: 46qCyJ6evTkHo9al5sBMNA (big blind) folded on the Flop
Seat 2: BypVLsYQt3ePFm2xQL/dOA (button) (small blind) collected ($0.95)



PokerStars Game #59938981138:  Hold'em No Limit ($0.25/$0.50) - 2009/07/01 0:28:22 ET
Table '5EmHi+fnatGQQShcNmzOZQ' 6-max Seat #5 is the button
Seat 1: SwPczQo3cOtwEzhJrfO2cQ ($24.70 in chips)
Seat 3: L9qfLYXrczhAPd/VckgsWw ($61.35 in chips)
Seat 4: wOyVV9M/oyiw3YaOjNZ05w ($50 in chips)
Seat 5: kxPhs4ePFqMy52CInAJ2aw ($61.10 in chips)
Seat 6: 686aeHikcJlgKkSuIFdcXQ ($143.65 in chips)
686aeHikcJlgKkSuIFdcXQ: posts small blind $0.25
SwPczQo3cOtwEzhJrfO2cQ: posts big blind $0.50
vXIHnZ+dv/hwSBxyvGw7bQ: sits out
*** HOLE CARDS ***
L9qfLYXrczhAPd/VckgsWw: folds
wOyVV9M/oyiw3YaOjNZ05w: folds
kxPhs4ePFqMy52CInAJ2aw: raises $1.50 to $2
686aeHikcJlgKkSuIFdcXQ: folds
SwPczQo3cOtwEzhJrfO2cQ: folds
kxPhs4ePFqMy52CInAJ2aw collected $1.25 from pot
kxPhs4ePFqMy52CInAJ2aw: doesn't show hand
*** SUMMARY ***
Total pot $1.25 | Rake $0
Seat 1: SwPczQo3cOtwEzhJrfO2cQ (big blind) folded before Flop
Seat 3: L9qfLYXrczhAPd/VckgsWw folded before Flop (didn't bet)
Seat 4: wOyVV9M/oyiw3YaOjNZ05w folded before Flop (didn't bet)
Seat 5: kxPhs4ePFqMy52CInAJ2aw (button) collected ($1.25)
Seat 6: 686aeHikcJlgKkSuIFdcXQ (small blind) folded before Flop



PokerStars Game #59938981208:  Hold'em No Limit ($0.25/$0.50) - 2009/07/01 0:28:22 ET
Table '3FhG0gl3kMX3wBEEqj+wnQ' 9-max Seat #8 is the button
Seat 1: e0J9pdCNUDTCG031RnXqLA ($17 in chips)
Seat 2: 4dl3YNqZ6Houm2jZAzDmRg ($15.55 in chips)
Seat 3: HZkVla4kK2SI42CVrPZ/ig ($9.25 in chips)
Seat 4: bz4LMfV0GGl/MJ/ABXuPmg ($21.35 in chips)
Seat 5: XNMDwbXt/Q4jM99AXnbJDw ($50 in chips)
Seat 6: 5JJVDlaiMnB004o/RqbZZQ ($23.75 in chips)
Seat 7: mSD1pginDsyHG5PDfqzphw ($10 in chips)
Seat 8: j3K/Jujr7PY4ZM2RZvlH6A ($65.70 in chips)
Seat 9: L5e2lrPLQm1Pqx30IIZ/Fw ($12.10 in chips)
L5e2lrPLQm1Pqx30IIZ/Fw: posts small blind $0.25
e0J9pdCNUDTCG031RnXqLA: posts big blind $0.50
*** HOLE CARDS ***
4dl3YNqZ6Houm2jZAzDmRg: folds
HZkVla4kK2SI42CVrPZ/ig: folds
bz4LMfV0GGl/MJ/ABXuPmg: folds
XNMDwbXt/Q4jM99AXnbJDw: folds
5JJVDlaiMnB004o/RqbZZQ: folds
mSD1pginDsyHG5PDfqzphw: folds
j3K/Jujr7PY4ZM2RZvlH6A: folds
L5e2lrPLQm1Pqx30IIZ/Fw: folds
e0J9pdCNUDTCG031RnXqLA collected $0.50 from pot
e0J9pdCNUDTCG031RnXqLA: doesn't show hand
*** SUMMARY ***
Total pot $0.50 | Rake $0
Seat 1: e0J9pdCNUDTCG031RnXqLA (big blind) collected ($0.50)
Seat 2: 4dl3YNqZ6Houm2jZAzDmRg folded before Flop (didn't bet)
Seat 3: HZkVla4kK2SI42CVrPZ/ig folded before Flop (didn't bet)
Seat 4: bz4LMfV0GGl/MJ/ABXuPmg folded before Flop (didn't bet)
Seat 5: XNMDwbXt/Q4jM99AXnbJDw folded before Flop (didn't bet)
Seat 6: 5JJVDlaiMnB004o/RqbZZQ folded before Flop (didn't bet)
Seat 7: mSD1pginDsyHG5PDfqzphw folded before Flop (didn't bet)
Seat 8: j3K/Jujr7PY4ZM2RZvlH6A (button) folded before Flop (didn't bet)
Seat 9: L5e2lrPLQm1Pqx30IIZ/Fw (small blind) folded before Flop



PokerStars Game #59938982762:  Hold'em No Limit ($0.25/$0.50) - 2009/07/01 0:28:24 ET
Table 'EiNh8p/wGJ1FP575iMFnqg' 9-max Seat #3 is the button
Seat 1: r3ZqM1Mi0W3y4hOdssE+Sg ($50 in chips)
Seat 2: sSAA879uXOGR+8Mf3zLa6Q ($14.60 in chips)
Seat 3: ymLPoEIl7UL3TvZYmnadxQ ($49.50 in chips)
Seat 4: HIIPkpiaCQfs5HcPKjlHvg ($40.20 in chips)
Seat 5: M+7+BTmX5vZatHVuoRB1nA ($78.15 in chips)
Seat 6: 3UmXLy3GfjC3EkOebduerQ ($56.60 in chips)
Seat 7: Wj7mKnRFR90j40wWUu2+Og ($77.80 in chips)
Seat 8: KrPAGRACBg+w0M//SXe8Ag ($13.30 in chips)
Seat 9: OMwFJ4pF0xk2Ru/AJiFeFw ($69.90 in chips)
HIIPkpiaCQfs5HcPKjlHvg: posts small blind $0.25
M+7+BTmX5vZatHVuoRB1nA: posts big blind $0.50
*** HOLE CARDS ***
3UmXLy3GfjC3EkOebduerQ: raises $1.50 to $2
Wj7mKnRFR90j40wWUu2+Og: raises $5 to $7
KrPAGRACBg+w0M//SXe8Ag: folds
OMwFJ4pF0xk2Ru/AJiFeFw: folds
r3ZqM1Mi0W3y4hOdssE+Sg: folds
sSAA879uXOGR+8Mf3zLa6Q: folds
ymLPoEIl7UL3TvZYmnadxQ: folds
sSAA879uXOGR+8Mf3zLa6Q leaves the table
HIIPkpiaCQfs5HcPKjlHvg: folds
M+7+BTmX5vZatHVuoRB1nA: folds
3UmXLy3GfjC3EkOebduerQ: folds
Wj7mKnRFR90j40wWUu2+Og collected $4.75 from pot
*** SUMMARY ***
Total pot $4.75 | Rake $0
Seat 1: r3ZqM1Mi0W3y4hOdssE+Sg folded before Flop (didn't bet)
Seat 2: sSAA879uXOGR+8Mf3zLa6Q folded before Flop (didn't bet)
Seat 3: ymLPoEIl7UL3TvZYmnadxQ (button) folded before Flop (didn't bet)
Seat 4: HIIPkpiaCQfs5HcPKjlHvg (small blind) folded before Flop
Seat 5: M+7+BTmX5vZatHVuoRB1nA (big blind) folded before Flop
Seat 6: 3UmXLy3GfjC3EkOebduerQ folded before Flop
Seat 7: Wj7mKnRFR90j40wWUu2+Og collected ($4.75)
Seat 8: KrPAGRACBg+w0M//SXe8Ag folded before Flop (didn't bet)
Seat 9: OMwFJ4pF0xk2Ru/AJiFeFw folded before Flop (didn't bet)



PokerStars Game #59938983698:  Hold'em No Limit ($0.25/$0.50) - 2009/07/01 0:28:25 ET
Table 'E7bWJ45aoFXRpyRv2gw+Ig' 2-max Seat #1 is the button
Seat 1: FRkiRasEGlHUeLrEl+k/nA ($54.55 in chips)
Seat 2: 3Wro85I7472vJ4Wkpneo9A ($122.55 in chips)
FRkiRasEGlHUeLrEl+k/nA: posts small blind $0.25
3Wro85I7472vJ4Wkpneo9A: posts big blind $0.50
*** HOLE CARDS ***
FRkiRasEGlHUeLrEl+k/nA: raises $1 to $1.50
3Wro85I7472vJ4Wkpneo9A: calls $1
*** FLOP *** [Jc Jh 7h]
3Wro85I7472vJ4Wkpneo9A: checks
FRkiRasEGlHUeLrEl+k/nA: bets $1
3Wro85I7472vJ4Wkpneo9A: calls $1
*** TURN *** [Jc Jh 7h] [Ad]
3Wro85I7472vJ4Wkpneo9A: checks
FRkiRasEGlHUeLrEl+k/nA: checks
*** RIVER *** [Jc Jh 7h Ad] [4h]
3Wro85I7472vJ4Wkpneo9A: checks
FRkiRasEGlHUeLrEl+k/nA: checks
*** SHOW DOWN ***
3Wro85I7472vJ4Wkpneo9A: shows [7c 8d] (two pair, Jacks and Sevens)
FRkiRasEGlHUeLrEl+k/nA: mucks hand
3Wro85I7472vJ4Wkpneo9A collected $4.80 from pot
*** SUMMARY ***
Total pot $5 | Rake $0.20
Board [Jc Jh 7h Ad 4h]
Seat 1: FRkiRasEGlHUeLrEl+k/nA (button) (small blind) mucked
Seat 2: 3Wro85I7472vJ4Wkpneo9A (big blind) showed [7c 8d] and won ($4.80) with two pair, Jacks and Sevens



PokerStars Game #59938983540:  Hold'em No Limit ($0.25/$0.50) - 2009/07/01 0:28:25 ET
Table '+dXkOAQyS8j9PQZusUTMpg' 2-max Seat #2 is the button
Seat 1: XFa6sBGjP2gxoIvxR3fZIg ($51.90 in chips)
Seat 2: 5IBeOgaApY1Bvzv2P8X4EA ($92.75 in chips)
5IBeOgaApY1Bvzv2P8X4EA: posts small blind $0.25
XFa6sBGjP2gxoIvxR3fZIg: posts big blind $0.50
*** HOLE CARDS ***
5IBeOgaApY1Bvzv2P8X4EA: folds
XFa6sBGjP2gxoIvxR3fZIg collected $0.50 from pot
XFa6sBGjP2gxoIvxR3fZIg: doesn't show hand
*** SUMMARY ***
Total pot $0.50 | Rake $0
Seat 1: XFa6sBGjP2gxoIvxR3fZIg (big blind) collected ($0.50)
Seat 2: 5IBeOgaApY1Bvzv2P8X4EA (button) (small blind) folded before Flop



PokerStars Game #59938984548:  Hold'em No Limit ($0.25/$0.50) - 2009/07/01 0:28:27 ET
Table 'IeNZOZQ4T6oiaHqFeo6yIA' 2-max Seat #2 is the button
Seat 1: ndd1nfncBkWNitBnsfCoVQ ($80.80 in chips)
Seat 2: A91IUl5JaZROhtfCtnnwYw ($52.05 in chips)
A91IUl5JaZROhtfCtnnwYw: posts small blind $0.25
ndd1nfncBkWNitBnsfCoVQ: posts big blind $0.50
*** HOLE CARDS ***
A91IUl5JaZROhtfCtnnwYw: raises $0.50 to $1
ndd1nfncBkWNitBnsfCoVQ: calls $0.50
*** FLOP *** [Ad Ks 2h]
ndd1nfncBkWNitBnsfCoVQ: checks
A91IUl5JaZROhtfCtnnwYw: checks
*** TURN *** [Ad Ks 2h] [8c]
ndd1nfncBkWNitBnsfCoVQ: checks
A91IUl5JaZROhtfCtnnwYw: checks
*** RIVER *** [Ad Ks 2h 8c] [8s]
ndd1nfncBkWNitBnsfCoVQ: checks
A91IUl5JaZROhtfCtnnwYw: bets $1.50
ndd1nfncBkWNitBnsfCoVQ: folds
A91IUl5JaZROhtfCtnnwYw collected $1.90 from pot
*** SUMMARY ***
Total pot $2 | Rake $0.10
Board [Ad Ks 2h 8c 8s]
Seat 1: ndd1nfncBkWNitBnsfCoVQ (big blind) folded on the River
Seat 2: A91IUl5JaZROhtfCtnnwYw (button) (small blind) collected ($1.90)



PokerStars Game #59938984868:  Hold'em No Limit ($0.25/$0.50) - 2009/07/01 0:28:27 ET
Table 'T/PgNWqVyY6lkldcBVXYJQ' 6-max Seat #3 is the button
Seat 1: +Pf9jTVizYlIo+woPvptfA ($56.60 in chips)
Seat 2: oZAeY5rVqNGgt8yyQ0pxbA ($38.05 in chips)
Seat 3: L3OcNO1bgdqDI46j67KQPQ ($52.55 in chips)
Seat 4: jxMvxeUUL9UU0V6wVU+Iyw ($9.45 in chips)
Seat 5: vVQBckETtigfb5mAcyK0OA ($42.35 in chips)
Seat 6: cDzbog6kwmJp+LBeBq+iMQ ($56.75 in chips)
jxMvxeUUL9UU0V6wVU+Iyw: posts small blind $0.25
vVQBckETtigfb5mAcyK0OA: posts big blind $0.50
*** HOLE CARDS ***
cDzbog6kwmJp+LBeBq+iMQ: folds
+Pf9jTVizYlIo+woPvptfA: folds
oZAeY5rVqNGgt8yyQ0pxbA: folds
L3OcNO1bgdqDI46j67KQPQ: raises $1.50 to $2
jxMvxeUUL9UU0V6wVU+Iyw: folds
vVQBckETtigfb5mAcyK0OA said, "like what the f.u.c.k. catch the river card"
vVQBckETtigfb5mAcyK0OA: calls $1.50
*** FLOP *** [Kc 3d 2h]
vVQBckETtigfb5mAcyK0OA: checks
L3OcNO1bgdqDI46j67KQPQ: bets $3
vVQBckETtigfb5mAcyK0OA: folds
cDzbog6kwmJp+LBeBq+iMQ said, "im pround of you helen"
L3OcNO1bgdqDI46j67KQPQ collected $4.05 from pot
L3OcNO1bgdqDI46j67KQPQ: doesn't show hand
cDzbog6kwmJp+LBeBq+iMQ said, "hank you"
*** SUMMARY ***
Total pot $4.25 | Rake $0.20
Board [Kc 3d 2h]
Seat 1: +Pf9jTVizYlIo+woPvptfA folded before Flop (didn't bet)
Seat 2: oZAeY5rVqNGgt8yyQ0pxbA folded before Flop (didn't bet)
Seat 3: L3OcNO1bgdqDI46j67KQPQ (button) collected ($4.05)
Seat 4: jxMvxeUUL9UU0V6wVU+Iyw (small blind) folded before Flop
Seat 5: vVQBckETtigfb5mAcyK0OA (big blind) folded on the Flop
Seat 6: cDzbog6kwmJp+LBeBq+iMQ folded before Flop (didn't bet)



PokerStars Game #59938985906:  Hold'em No Limit ($0.25/$0.50) - 2009/07/01 0:28:29 ET
Table 'mTxf8gPLgffN3Iwfm7Icfg' 2-max Seat #1 is the button
Seat 1: Do9Rlu1R5u/AcRtMTl8SYg ($95.30 in chips)
Seat 2: EMc5LPgVaded4Qc77vm0fw ($64.35 in chips)
Do9Rlu1R5u/AcRtMTl8SYg: posts small blind $0.25
EMc5LPgVaded4Qc77vm0fw: posts big blind $0.50
*** HOLE CARDS ***
Do9Rlu1R5u/AcRtMTl8SYg: calls $0.25
EMc5LPgVaded4Qc77vm0fw: checks
*** FLOP *** [3h 2h Kh]
EMc5LPgVaded4Qc77vm0fw: checks
Do9Rlu1R5u/AcRtMTl8SYg: checks
*** TURN *** [3h 2h Kh] [3d]
EMc5LPgVaded4Qc77vm0fw: checks
Do9Rlu1R5u/AcRtMTl8SYg: checks
*** RIVER *** [3h 2h Kh 3d] [7c]
EMc5LPgVaded4Qc77vm0fw: checks
Do9Rlu1R5u/AcRtMTl8SYg: checks
*** SHOW DOWN ***
EMc5LPgVaded4Qc77vm0fw: shows [5d 2s] (two pair, Threes and Deuces)
Do9Rlu1R5u/AcRtMTl8SYg: mucks hand
EMc5LPgVaded4Qc77vm0fw collected $0.95 from pot
*** SUMMARY ***
Total pot $1 | Rake $0.05
Board [3h 2h Kh 3d 7c]
Seat 1: Do9Rlu1R5u/AcRtMTl8SYg (button) (small blind) mucked
Seat 2: EMc5LPgVaded4Qc77vm0fw (big blind) showed [5d 2s] and won ($0.95) with two pair, Threes and Deuces



PokerStars Game #59938987668:  Hold'em No Limit ($0.25/$0.50) - 2009/07/01 0:28:31 ET
Table '+dXkOAQyS8j9PQZusUTMpg' 2-max Seat #1 is the button
Seat 1: XFa6sBGjP2gxoIvxR3fZIg ($52.15 in chips)
Seat 2: 5IBeOgaApY1Bvzv2P8X4EA ($92.50 in chips)
XFa6sBGjP2gxoIvxR3fZIg: posts small blind $0.25
5IBeOgaApY1Bvzv2P8X4EA: posts big blind $0.50
*** HOLE CARDS ***
XFa6sBGjP2gxoIvxR3fZIg: raises $1 to $1.50
5IBeOgaApY1Bvzv2P8X4EA: folds
XFa6sBGjP2gxoIvxR3fZIg collected $1 from pot
*** SUMMARY ***
Total pot $1 | Rake $0
Seat 1: XFa6sBGjP2gxoIvxR3fZIg (button) (small blind) collected ($1)
Seat 2: 5IBeOgaApY1Bvzv2P8X4EA (big blind) folded before Flop



PokerStars Game #59938987352:  Hold'em No Limit ($0.25/$0.50) - 2009/07/01 0:28:31 ET
Table 'PALRfuH85dr5IkDfdv6new' 9-max Seat #7 is the button
Seat 1: SKnJuWHScqetA/qG5p+wCg ($30.25 in chips)
Seat 2: 9r7ZoBbAJj5IeyZ0q9BdzA ($6.85 in chips)
Seat 3: 50QWoELmpmHFrFIlWMJo9g ($87.45 in chips)
Seat 4: mZNMJI1mY40XTC0U7GZakA ($50.75 in chips)
Seat 5: jSSGUXdNFAZA3QCvTcUMQw ($43.45 in chips)
Seat 6: E2518gp4aFz1+kAgmGqeEg ($10.25 in chips)
Seat 7: 3NcyXvr39gnK+KbTq7ezyA ($39.25 in chips)
Seat 8: NkS+CseUKx4XHszWq0PXEQ ($45.15 in chips)
Seat 9: CIrAX/m6o7jYmKOAjJXv4Q ($36.25 in chips)
NkS+CseUKx4XHszWq0PXEQ: posts small blind $0.25
CIrAX/m6o7jYmKOAjJXv4Q: posts big blind $0.50
*** HOLE CARDS ***
SKnJuWHScqetA/qG5p+wCg said, "nh"
SKnJuWHScqetA/qG5p+wCg: folds
9r7ZoBbAJj5IeyZ0q9BdzA: folds
50QWoELmpmHFrFIlWMJo9g: folds
mZNMJI1mY40XTC0U7GZakA: folds
jSSGUXdNFAZA3QCvTcUMQw: folds
E2518gp4aFz1+kAgmGqeEg: folds
3NcyXvr39gnK+KbTq7ezyA: folds
NkS+CseUKx4XHszWq0PXEQ: calls $0.25
CIrAX/m6o7jYmKOAjJXv4Q: checks
*** FLOP *** [2s 3d 8h]
NkS+CseUKx4XHszWq0PXEQ: checks
CIrAX/m6o7jYmKOAjJXv4Q: bets $0.50
NkS+CseUKx4XHszWq0PXEQ: folds
CIrAX/m6o7jYmKOAjJXv4Q collected $0.95 from pot
*** SUMMARY ***
Total pot $1 | Rake $0.05
Board [2s 3d 8h]
Seat 1: SKnJuWHScqetA/qG5p+wCg folded before Flop (didn't bet)
Seat 2: 9r7ZoBbAJj5IeyZ0q9BdzA folded before Flop (didn't bet)
Seat 3: 50QWoELmpmHFrFIlWMJo9g folded before Flop (didn't bet)
Seat 4: mZNMJI1mY40XTC0U7GZakA folded before Flop (didn't bet)
Seat 5: jSSGUXdNFAZA3QCvTcUMQw folded before Flop (didn't bet)
Seat 6: E2518gp4aFz1+kAgmGqeEg folded before Flop (didn't bet)
Seat 7: 3NcyXvr39gnK+KbTq7ezyA (button) folded before Flop (didn't bet)
Seat 8: NkS+CseUKx4XHszWq0PXEQ (small blind) folded on the Flop
Seat 9: CIrAX/m6o7jYmKOAjJXv4Q (big blind) collected ($0.95)



PokerStars Game #59938988470:  Hold'em No Limit ($0.25/$0.50) - 2009/07/01 0:28:33 ET
Table '37qXEp3oe+er5q4CZip9eQ' 6-max Seat #4 is the button
Seat 1: oqOqoO2AyCZenUghCxMDxw ($50 in chips)
Seat 2: 6wzJiRvp8HY6t+MQGnSIzA ($18.80 in chips)
Seat 3: Rt6KgtZ8YaJoTc3FPim00w ($96.50 in chips)
Seat 4: XsmE8nXMAAMFJbWaJTmHFw ($15.45 in chips)
Seat 5: VOmI0x4dDPnTESZd5B4d1Q ($44.75 in chips)
Seat 6: l4m/wWPs22DSP5xpszjXKA ($10 in chips)
VOmI0x4dDPnTESZd5B4d1Q: posts small blind $0.25
l4m/wWPs22DSP5xpszjXKA: posts big blind $0.50
*** HOLE CARDS ***
oqOqoO2AyCZenUghCxMDxw: folds
6wzJiRvp8HY6t+MQGnSIzA: folds
Rt6KgtZ8YaJoTc3FPim00w: raises $1 to $1.50
XsmE8nXMAAMFJbWaJTmHFw: calls $1.50
VOmI0x4dDPnTESZd5B4d1Q: folds
l4m/wWPs22DSP5xpszjXKA: folds
*** FLOP *** [Kc Ah 5h]
Rt6KgtZ8YaJoTc3FPim00w: checks
XsmE8nXMAAMFJbWaJTmHFw: bets $1.70
Rt6KgtZ8YaJoTc3FPim00w: folds
XsmE8nXMAAMFJbWaJTmHFw collected $3.60 from pot
*** SUMMARY ***
Total pot $3.75 | Rake $0.15
Board [Kc Ah 5h]
Seat 1: oqOqoO2AyCZenUghCxMDxw folded before Flop (didn't bet)
Seat 2: 6wzJiRvp8HY6t+MQGnSIzA folded before Flop (didn't bet)
Seat 3: Rt6KgtZ8YaJoTc3FPim00w folded on the Flop
Seat 4: XsmE8nXMAAMFJbWaJTmHFw (button) collected ($3.60)
Seat 5: VOmI0x4dDPnTESZd5B4d1Q (small blind) folded before Flop
Seat 6: l4m/wWPs22DSP5xpszjXKA (big blind) folded before Flop



PokerStars Game #59938992092:  Hold'em No Limit ($0.25/$0.50) - 2009/07/01 0:28:38 ET
Table '+dXkOAQyS8j9PQZusUTMpg' 2-max Seat #2 is the button
Seat 1: XFa6sBGjP2gxoIvxR3fZIg ($52.65 in chips)
Seat 2: 5IBeOgaApY1Bvzv2P8X4EA ($92 in chips)
5IBeOgaApY1Bvzv2P8X4EA: posts small blind $0.25
XFa6sBGjP2gxoIvxR3fZIg: posts big blind $0.50
*** HOLE CARDS ***
5IBeOgaApY1Bvzv2P8X4EA: calls $0.25
XFa6sBGjP2gxoIvxR3fZIg: raises $2 to $2.50
5IBeOgaApY1Bvzv2P8X4EA: calls $2
*** FLOP *** [Jd As 5c]
XFa6sBGjP2gxoIvxR3fZIg: bets $4
5IBeOgaApY1Bvzv2P8X4EA: calls $4
*** TURN *** [Jd As 5c] [8d]
XFa6sBGjP2gxoIvxR3fZIg: bets $10
5IBeOgaApY1Bvzv2P8X4EA: folds
XFa6sBGjP2gxoIvxR3fZIg collected $12.50 from pot
XFa6sBGjP2gxoIvxR3fZIg: doesn't show hand
*** SUMMARY ***
Total pot $13 | Rake $0.50
Board [Jd As 5c 8d]
Seat 1: XFa6sBGjP2gxoIvxR3fZIg (big blind) collected ($12.50)
Seat 2: 5IBeOgaApY1Bvzv2P8X4EA (button) (small blind) folded on the Turn



PokerStars Game #59938993098:  Hold'em No Limit ($0.25/$0.50) - 2009/07/01 0:28:40 ET
Table 'c/CRn+68J3Y8KxD5g1ek2Q' 2-max Seat #1 is the button
Seat 1: 46qCyJ6evTkHo9al5sBMNA ($259.25 in chips)
Seat 2: BypVLsYQt3ePFm2xQL/dOA ($120.15 in chips)
46qCyJ6evTkHo9al5sBMNA: posts small blind $0.25
BypVLsYQt3ePFm2xQL/dOA: posts big blind $0.50
*** HOLE CARDS ***
46qCyJ6evTkHo9al5sBMNA: folds
BypVLsYQt3ePFm2xQL/dOA collected $0.50 from pot
BypVLsYQt3ePFm2xQL/dOA: doesn't show hand
*** SUMMARY ***
Total pot $0.50 | Rake $0
Seat 1: 46qCyJ6evTkHo9al5sBMNA (button) (small blind) folded before Flop
Seat 2: BypVLsYQt3ePFm2xQL/dOA (big blind) collected ($0.50)



PokerStars Game #59938993564:  Hold'em No Limit ($0.25/$0.50) - 2009/07/01 0:28:40 ET
Table 'MJxeZCzYELxiIsyUZyT0jw' 6-max Seat #6 is the button
Seat 1: wOyVV9M/oyiw3YaOjNZ05w ($51.35 in chips)
Seat 2: dB6jzDlJmET84VMWw1mTRA ($50 in chips)
Seat 3: JQZew0FjzS19kTjeNtrE+A ($52.55 in chips)
Seat 4: lP7Q6pewz4C2RsAfKsjdWw ($35.05 in chips)
Seat 5: 3jvoOXNtXE90w2BdfNZwZQ ($53.80 in chips)
Seat 6: TTx3CHxyi0SObcHyMJRp5w ($48 in chips)
wOyVV9M/oyiw3YaOjNZ05w: posts small blind $0.25
dB6jzDlJmET84VMWw1mTRA: posts big blind $0.50
*** HOLE CARDS ***
JQZew0FjzS19kTjeNtrE+A: calls $0.50
lP7Q6pewz4C2RsAfKsjdWw: raises $0.50 to $1
3jvoOXNtXE90w2BdfNZwZQ: folds
TTx3CHxyi0SObcHyMJRp5w: folds
wOyVV9M/oyiw3YaOjNZ05w: folds
dB6jzDlJmET84VMWw1mTRA: folds
JQZew0FjzS19kTjeNtrE+A: calls $0.50
*** FLOP *** [Qs 2c Jh]
JQZew0FjzS19kTjeNtrE+A: checks
lP7Q6pewz4C2RsAfKsjdWw: bets $1
JQZew0FjzS19kTjeNtrE+A: folds
lP7Q6pewz4C2RsAfKsjdWw collected $2.65 from pot
lP7Q6pewz4C2RsAfKsjdWw: doesn't show hand
*** SUMMARY ***
Total pot $2.75 | Rake $0.10
Board [Qs 2c Jh]
Seat 1: wOyVV9M/oyiw3YaOjNZ05w (small blind) folded before Flop
Seat 2: dB6jzDlJmET84VMWw1mTRA (big blind) folded before Flop
Seat 3: JQZew0FjzS19kTjeNtrE+A folded on the Flop
Seat 4: lP7Q6pewz4C2RsAfKsjdWw collected ($2.65)
Seat 5: 3jvoOXNtXE90w2BdfNZwZQ folded before Flop (didn't bet)
Seat 6: TTx3CHxyi0SObcHyMJRp5w (button) folded before Flop (didn't bet)



PokerStars Game #59938994954:  Hold'em No Limit ($0.25/$0.50) - 2009/07/01 0:28:42 ET
Table '5EmHi+fnatGQQShcNmzOZQ' 6-max Seat #6 is the button
Seat 1: SwPczQo3cOtwEzhJrfO2cQ ($24.20 in chips)
Seat 2: vXIHnZ+dv/hwSBxyvGw7bQ ($50 in chips)
Seat 3: L9qfLYXrczhAPd/VckgsWw ($61.35 in chips)
Seat 4: wOyVV9M/oyiw3YaOjNZ05w ($50 in chips)
Seat 5: kxPhs4ePFqMy52CInAJ2aw ($61.85 in chips)
Seat 6: 686aeHikcJlgKkSuIFdcXQ ($143.40 in chips)
SwPczQo3cOtwEzhJrfO2cQ: posts small blind $0.25
vXIHnZ+dv/hwSBxyvGw7bQ: posts big blind $0.50
*** HOLE CARDS ***
L9qfLYXrczhAPd/VckgsWw: folds
wOyVV9M/oyiw3YaOjNZ05w: folds
kxPhs4ePFqMy52CInAJ2aw: folds
686aeHikcJlgKkSuIFdcXQ: folds
SwPczQo3cOtwEzhJrfO2cQ: folds
vXIHnZ+dv/hwSBxyvGw7bQ collected $0.50 from pot
vXIHnZ+dv/hwSBxyvGw7bQ: doesn't show hand
*** SUMMARY ***
Total pot $0.50 | Rake $0
Seat 1: SwPczQo3cOtwEzhJrfO2cQ (small blind) folded before Flop
Seat 2: vXIHnZ+dv/hwSBxyvGw7bQ (big blind) collected ($0.50)
Seat 3: L9qfLYXrczhAPd/VckgsWw folded before Flop (didn't bet)
Seat 4: wOyVV9M/oyiw3YaOjNZ05w folded before Flop (didn't bet)
Seat 5: kxPhs4ePFqMy52CInAJ2aw folded before Flop (didn't bet)
Seat 6: 686aeHikcJlgKkSuIFdcXQ (button) folded before Flop (didn't bet)



PokerStars Game #59938994922:  Hold'em No Limit ($0.25/$0.50) - 2009/07/01 0:28:42 ET
Table 'hSTs/dUsYLgJQuF2Onp0MQ' 6-max Seat #1 is the button
Seat 1: Donj3X7gYzeS5pAl7s9f+Q ($27.70 in chips)
Seat 2: 6vNxrjjCl6FwfaaymM9jjg ($27.35 in chips)
Seat 3: C3qJBo7uxfFVDluE1lmK2w ($30 in chips)
Seat 4: L0aIPg7qefDQjdJo3HCVEA ($8.25 in chips)
Seat 5: 686aeHikcJlgKkSuIFdcXQ ($60.65 in chips)
Seat 6: +laPa9P7BjZKKnR0n+OmvA ($8.95 in chips)
6vNxrjjCl6FwfaaymM9jjg: posts small blind $0.25
C3qJBo7uxfFVDluE1lmK2w: posts big blind $0.50
*** HOLE CARDS ***
L0aIPg7qefDQjdJo3HCVEA: raises $0.50 to $1
686aeHikcJlgKkSuIFdcXQ: folds
+laPa9P7BjZKKnR0n+OmvA: folds
Donj3X7gYzeS5pAl7s9f+Q: folds
6vNxrjjCl6FwfaaymM9jjg: calls $0.75
C3qJBo7uxfFVDluE1lmK2w: folds
*** FLOP *** [5c Tc 8s]
6vNxrjjCl6FwfaaymM9jjg: checks
L0aIPg7qefDQjdJo3HCVEA: checks
*** TURN *** [5c Tc 8s] [6d]
6vNxrjjCl6FwfaaymM9jjg: checks
L0aIPg7qefDQjdJo3HCVEA: checks
*** RIVER *** [5c Tc 8s 6d] [9c]
6vNxrjjCl6FwfaaymM9jjg: checks
L0aIPg7qefDQjdJo3HCVEA: checks
*** SHOW DOWN ***
6vNxrjjCl6FwfaaymM9jjg: shows [4d Kd] (high card King)
L0aIPg7qefDQjdJo3HCVEA: shows [Kh Jc] (high card King - Jack kicker)
L0aIPg7qefDQjdJo3HCVEA collected $2.40 from pot
*** SUMMARY ***
Total pot $2.50 | Rake $0.10
Board [5c Tc 8s 6d 9c]
Seat 1: Donj3X7gYzeS5pAl7s9f+Q (button) folded before Flop (didn't bet)
Seat 2: 6vNxrjjCl6FwfaaymM9jjg (small blind) showed [4d Kd] and lost with high card King
Seat 3: C3qJBo7uxfFVDluE1lmK2w (big blind) folded before Flop
Seat 4: L0aIPg7qefDQjdJo3HCVEA showed [Kh Jc] and won ($2.40) with high card King
Seat 5: 686aeHikcJlgKkSuIFdcXQ folded before Flop (didn't bet)
Seat 6: +laPa9P7BjZKKnR0n+OmvA folded before Flop (didn't bet)



PokerStars Game #59938995794:  Hold'em No Limit ($0.25/$0.50) - 2009/07/01 0:28:44 ET
Table 'tyR5AZNKV8Aadbrnrnlg7g' 6-max Seat #6 is the button
Seat 1: R+KjpH/wSjDLhtIy9+edNA ($86.50 in chips)
Seat 2: 58zdeSBSuSFX/qZfhc7YmA ($29.75 in chips)
Seat 3: tdOvWynovql5imfooroLMg ($49.50 in chips)
Seat 4: Rt6KgtZ8YaJoTc3FPim00w ($83.50 in chips)
Seat 5: wOyVV9M/oyiw3YaOjNZ05w ($54.60 in chips)
Seat 6: ZKazl1hGaPiapDXincgi2Q ($29 in chips)
R+KjpH/wSjDLhtIy9+edNA: posts small blind $0.25
58zdeSBSuSFX/qZfhc7YmA: posts big blind $0.50
*** HOLE CARDS ***
tdOvWynovql5imfooroLMg: folds
Rt6KgtZ8YaJoTc3FPim00w: folds
wOyVV9M/oyiw3YaOjNZ05w: folds
ZKazl1hGaPiapDXincgi2Q: folds
R+KjpH/wSjDLhtIy9+edNA: raises $1 to $1.50
58zdeSBSuSFX/qZfhc7YmA: calls $1
*** FLOP *** [Ac 8h 9h]
R+KjpH/wSjDLhtIy9+edNA: bets $2
58zdeSBSuSFX/qZfhc7YmA: raises $2 to $4
R+KjpH/wSjDLhtIy9+edNA: calls $2
*** TURN *** [Ac 8h 9h] [Ad]
R+KjpH/wSjDLhtIy9+edNA: checks
58zdeSBSuSFX/qZfhc7YmA: bets $5.50
R+KjpH/wSjDLhtIy9+edNA: folds
58zdeSBSuSFX/qZfhc7YmA collected $10.50 from pot
*** SUMMARY ***
Total pot $11 | Rake $0.50
Board [Ac 8h 9h Ad]
Seat 1: R+KjpH/wSjDLhtIy9+edNA (small blind) folded on the Turn
Seat 2: 58zdeSBSuSFX/qZfhc7YmA (big blind) collected ($10.50)
Seat 3: tdOvWynovql5imfooroLMg folded before Flop (didn't bet)
Seat 4: Rt6KgtZ8YaJoTc3FPim00w folded before Flop (didn't bet)
Seat 5: wOyVV9M/oyiw3YaOjNZ05w folded before Flop (didn't bet)
Seat 6: ZKazl1hGaPiapDXincgi2Q (button) folded before Flop (didn't bet)



PokerStars Game #59938996828:  Hold'em No Limit ($0.25/$0.50) - 2009/07/01 0:28:45 ET
Table 'GfL/No5u5PoEnU39lP5pQg' 6-max Seat #5 is the button
Seat 1: 1WUCqNG+p+vfWRTXNu4ljw ($50 in chips)
Seat 2: uVwggSetzp7d+eVgowO3vg ($57.80 in chips)
Seat 4: OZ6OtYh5Y53MCH/p0QTn5g ($50 in chips)
Seat 5: crjGpJEzSZgD38FoE3VMGg ($52.80 in chips)
1WUCqNG+p+vfWRTXNu4ljw: posts small blind $0.25
uVwggSetzp7d+eVgowO3vg: posts big blind $0.50
*** HOLE CARDS ***
OZ6OtYh5Y53MCH/p0QTn5g: folds
OZ6OtYh5Y53MCH/p0QTn5g leaves the table
crjGpJEzSZgD38FoE3VMGg: folds
NbUTppWfym/RxV/DmDz2Sw joins the table at seat #3
1WUCqNG+p+vfWRTXNu4ljw: folds
uVwggSetzp7d+eVgowO3vg collected $0.50 from pot
*** SUMMARY ***
Total pot $0.50 | Rake $0
Seat 1: 1WUCqNG+p+vfWRTXNu4ljw (small blind) folded before Flop
Seat 2: uVwggSetzp7d+eVgowO3vg (big blind) collected ($0.50)
Seat 4: OZ6OtYh5Y53MCH/p0QTn5g folded before Flop (didn't bet)
Seat 5: crjGpJEzSZgD38FoE3VMGg (button) folded before Flop (didn't bet)



PokerStars Game #59938997714:  Hold'em No Limit ($0.25/$0.50) - 2009/07/01 0:28:47 ET
Table 'c/CRn+68J3Y8KxD5g1ek2Q' 2-max Seat #2 is the button
Seat 1: 46qCyJ6evTkHo9al5sBMNA ($259 in chips)
Seat 2: BypVLsYQt3ePFm2xQL/dOA ($120.40 in chips)
BypVLsYQt3ePFm2xQL/dOA: posts small blind $0.25
46qCyJ6evTkHo9al5sBMNA: posts big blind $0.50
*** HOLE CARDS ***
BypVLsYQt3ePFm2xQL/dOA: raises $0.50 to $1
46qCyJ6evTkHo9al5sBMNA: calls $0.50
*** FLOP *** [3s 5s 3h]
46qCyJ6evTkHo9al5sBMNA: checks
BypVLsYQt3ePFm2xQL/dOA: checks
*** TURN *** [3s 5s 3h] [5d]
46qCyJ6evTkHo9al5sBMNA: checks
BypVLsYQt3ePFm2xQL/dOA: bets $0.50
46qCyJ6evTkHo9al5sBMNA: folds
BypVLsYQt3ePFm2xQL/dOA collected $1.90 from pot
BypVLsYQt3ePFm2xQL/dOA: doesn't show hand
*** SUMMARY ***
Total pot $2 | Rake $0.10
Board [3s 5s 3h 5d]
Seat 1: 46qCyJ6evTkHo9al5sBMNA (big blind) folded on the Turn
Seat 2: BypVLsYQt3ePFm2xQL/dOA (button) (small blind) collected ($1.90)



PokerStars Game #59938997756:  Hold'em No Limit ($0.25/$0.50) - 2009/07/01 0:28:47 ET
Table 'fx6MqwfYAj/Rt86hBz2L3Q' 9-max Seat #5 is the button
Seat 1: jf2c/o9gI7Xj0GleCSMj9g ($50.55 in chips)
Seat 2: C3rGXblctNcWI6JYPHhaEg ($8.65 in chips)
Seat 3: iadBi5AEt7gTBXbDSSnMYQ ($48.45 in chips)
Seat 4: gPEN9Zp33YTm/mu9/SYP1w ($24.70 in chips)
Seat 5: iAISe3dVeua8PUn2wwgDHw ($27.40 in chips)
Seat 6: 5k9fvXD9suIgCxU4HLQjTw ($50 in chips)
Seat 7: bkXkL3pmapikPQQRNPZSEA ($16.90 in chips)
Seat 9: HZkVla4kK2SI42CVrPZ/ig ($9.25 in chips)
5k9fvXD9suIgCxU4HLQjTw: posts small blind $0.25
bkXkL3pmapikPQQRNPZSEA: posts big blind $0.50
CAuekkxPVzBL9SK4Tjjbuw: sits out
*** HOLE CARDS ***
HZkVla4kK2SI42CVrPZ/ig: folds
jf2c/o9gI7Xj0GleCSMj9g: raises $1 to $1.50
C3rGXblctNcWI6JYPHhaEg: folds
iadBi5AEt7gTBXbDSSnMYQ: folds
gPEN9Zp33YTm/mu9/SYP1w: calls $1.50
iAISe3dVeua8PUn2wwgDHw: folds
5k9fvXD9suIgCxU4HLQjTw: folds
bkXkL3pmapikPQQRNPZSEA: folds
*** FLOP *** [6d Qs 8c]
jf2c/o9gI7Xj0GleCSMj9g: bets $1.50
gPEN9Zp33YTm/mu9/SYP1w: folds
jf2c/o9gI7Xj0GleCSMj9g collected $3.60 from pot
jf2c/o9gI7Xj0GleCSMj9g: doesn't show hand
*** SUMMARY ***
Total pot $3.75 | Rake $0.15
Board [6d Qs 8c]
Seat 1: jf2c/o9gI7Xj0GleCSMj9g collected ($3.60)
Seat 2: C3rGXblctNcWI6JYPHhaEg folded before Flop (didn't bet)
Seat 3: iadBi5AEt7gTBXbDSSnMYQ folded before Flop (didn't bet)
Seat 4: gPEN9Zp33YTm/mu9/SYP1w folded on the Flop
Seat 5: iAISe3dVeua8PUn2wwgDHw (button) folded before Flop (didn't bet)
Seat 6: 5k9fvXD9suIgCxU4HLQjTw (small blind) folded before Flop
Seat 7: bkXkL3pmapikPQQRNPZSEA (big blind) folded before Flop
Seat 9: HZkVla4kK2SI42CVrPZ/ig folded before Flop (didn't bet)



PokerStars Game #59939000636:  Hold'em No Limit ($0.25/$0.50) - 2009/07/01 0:28:51 ET
Table 'EiNh8p/wGJ1FP575iMFnqg' 9-max Seat #4 is the button
Seat 1: r3ZqM1Mi0W3y4hOdssE+Sg ($50 in chips)
Seat 3: ymLPoEIl7UL3TvZYmnadxQ ($49.50 in chips)
Seat 4: HIIPkpiaCQfs5HcPKjlHvg ($39.95 in chips)
Seat 5: M+7+BTmX5vZatHVuoRB1nA ($77.65 in chips)
Seat 6: 3UmXLy3GfjC3EkOebduerQ ($54.60 in chips)
Seat 7: Wj7mKnRFR90j40wWUu2+Og ($80.55 in chips)
Seat 8: KrPAGRACBg+w0M//SXe8Ag ($13.30 in chips)
Seat 9: OMwFJ4pF0xk2Ru/AJiFeFw ($69.90 in chips)
M+7+BTmX5vZatHVuoRB1nA: posts small blind $0.25
3UmXLy3GfjC3EkOebduerQ: posts big blind $0.50
*** HOLE CARDS ***
8ehL7qlZzjgUh2H35iiWLw joins the table at seat #2
Wj7mKnRFR90j40wWUu2+Og: folds
KrPAGRACBg+w0M//SXe8Ag: calls $0.50
OMwFJ4pF0xk2Ru/AJiFeFw: folds
r3ZqM1Mi0W3y4hOdssE+Sg: folds
ymLPoEIl7UL3TvZYmnadxQ: folds
HIIPkpiaCQfs5HcPKjlHvg: folds
M+7+BTmX5vZatHVuoRB1nA: folds
3UmXLy3GfjC3EkOebduerQ: checks
*** FLOP *** [Tc 9h 5s]
3UmXLy3GfjC3EkOebduerQ: checks
KrPAGRACBg+w0M//SXe8Ag: bets $0.50
3UmXLy3GfjC3EkOebduerQ: raises $1 to $1.50
KrPAGRACBg+w0M//SXe8Ag: calls $1
*** TURN *** [Tc 9h 5s] [7h]
3UmXLy3GfjC3EkOebduerQ: checks
KrPAGRACBg+w0M//SXe8Ag: checks
*** RIVER *** [Tc 9h 5s 7h] [4c]
3UmXLy3GfjC3EkOebduerQ: bets $2
KrPAGRACBg+w0M//SXe8Ag: folds
3UmXLy3GfjC3EkOebduerQ collected $4.05 from pot
3UmXLy3GfjC3EkOebduerQ: doesn't show hand
*** SUMMARY ***
Total pot $4.25 | Rake $0.20
Board [Tc 9h 5s 7h 4c]
Seat 1: r3ZqM1Mi0W3y4hOdssE+Sg folded before Flop (didn't bet)
Seat 3: ymLPoEIl7UL3TvZYmnadxQ folded before Flop (didn't bet)
Seat 4: HIIPkpiaCQfs5HcPKjlHvg (button) folded before Flop (didn't bet)
Seat 5: M+7+BTmX5vZatHVuoRB1nA (small blind) folded before Flop
Seat 6: 3UmXLy3GfjC3EkOebduerQ (big blind) collected ($4.05)
Seat 7: Wj7mKnRFR90j40wWUu2+Og folded before Flop (didn't bet)
Seat 8: KrPAGRACBg+w0M//SXe8Ag folded on the River
Seat 9: OMwFJ4pF0xk2Ru/AJiFeFw folded before Flop (didn't bet)



PokerStars Game #59939001110:  Hold'em No Limit ($0.25/$0.50) - 2009/07/01 0:28:52 ET
Table 'NCiXr0d5CEKBQr/cZgLhbA' 9-max Seat #8 is the button
Seat 2: ulxuJchBV9iguXg0FUonfg ($35.20 in chips)
Seat 3: xZCXQSXlrZkp3pZizzVXCw ($57.65 in chips)
Seat 4: 5k9fvXD9suIgCxU4HLQjTw ($50 in chips)
Seat 5: zE9cVigS2nW/Ljy4K4bUQA ($39.50 in chips)
Seat 6: SKnJuWHScqetA/qG5p+wCg ($30 in chips)
Seat 7: M+7+BTmX5vZatHVuoRB1nA ($48.50 in chips)
Seat 8: 1MJUKc3cc0QmUoz1JZLR2w ($53.10 in chips)
Seat 9: 4WLZvqBn5qv5tds5kt5A1Q ($30.25 in chips)
4WLZvqBn5qv5tds5kt5A1Q: posts small blind $0.25
RjBdQ6w31rgcy0o24VLR6w: is sitting out
ulxuJchBV9iguXg0FUonfg: posts big blind $0.50
*** HOLE CARDS ***
RjBdQ6w31rgcy0o24VLR6w leaves the table
xZCXQSXlrZkp3pZizzVXCw: folds
5k9fvXD9suIgCxU4HLQjTw: raises $1 to $1.50
zE9cVigS2nW/Ljy4K4bUQA: folds
SKnJuWHScqetA/qG5p+wCg: folds
pFtzb1sR4b0d1aw6aIRgDg joins the table at seat #1
M+7+BTmX5vZatHVuoRB1nA: folds
1MJUKc3cc0QmUoz1JZLR2w: folds
4WLZvqBn5qv5tds5kt5A1Q: calls $1.25
ulxuJchBV9iguXg0FUonfg: calls $1
*** FLOP *** [5c Ac 6h]
4WLZvqBn5qv5tds5kt5A1Q: checks
ulxuJchBV9iguXg0FUonfg: bets $2
5k9fvXD9suIgCxU4HLQjTw: raises $3 to $5
4WLZvqBn5qv5tds5kt5A1Q: folds
ulxuJchBV9iguXg0FUonfg: calls $3
*** TURN *** [5c Ac 6h] [6s]
ulxuJchBV9iguXg0FUonfg: bets $4
5k9fvXD9suIgCxU4HLQjTw: calls $4
*** RIVER *** [5c Ac 6h 6s] [4d]
ulxuJchBV9iguXg0FUonfg: checks
5k9fvXD9suIgCxU4HLQjTw: checks
*** SHOW DOWN ***
ulxuJchBV9iguXg0FUonfg: shows [Jc Qc] (a pair of Sixes)
5k9fvXD9suIgCxU4HLQjTw: shows [Ad Jd] (two pair, Aces and Sixes)
5k9fvXD9suIgCxU4HLQjTw collected $21.45 from pot
*** SUMMARY ***
Total pot $22.50 | Rake $1.05
Board [5c Ac 6h 6s 4d]
Seat 2: ulxuJchBV9iguXg0FUonfg (big blind) showed [Jc Qc] and lost with a pair of Sixes
Seat 3: xZCXQSXlrZkp3pZizzVXCw folded before Flop (didn't bet)
Seat 4: 5k9fvXD9suIgCxU4HLQjTw showed [Ad Jd] and won ($21.45) with two pair, Aces and Sixes
Seat 5: zE9cVigS2nW/Ljy4K4bUQA folded before Flop (didn't bet)
Seat 6: SKnJuWHScqetA/qG5p+wCg folded before Flop (didn't bet)
Seat 7: M+7+BTmX5vZatHVuoRB1nA folded before Flop (didn't bet)
Seat 8: 1MJUKc3cc0QmUoz1JZLR2w (button) folded before Flop (didn't bet)
Seat 9: 4WLZvqBn5qv5tds5kt5A1Q (small blind) folded on the Flop



PokerStars Game #59939001176:  Hold'em No Limit ($0.25/$0.50) - 2009/07/01 0:28:52 ET
Table 'mTxf8gPLgffN3Iwfm7Icfg' 2-max Seat #2 is the button
Seat 1: Do9Rlu1R5u/AcRtMTl8SYg ($94.80 in chips)
Seat 2: EMc5LPgVaded4Qc77vm0fw ($64.80 in chips)
EMc5LPgVaded4Qc77vm0fw: posts small blind $0.25
Do9Rlu1R5u/AcRtMTl8SYg: posts big blind $0.50
*** HOLE CARDS ***
EMc5LPgVaded4Qc77vm0fw: raises $1 to $1.50
Do9Rlu1R5u/AcRtMTl8SYg: folds
EMc5LPgVaded4Qc77vm0fw collected $1 from pot
EMc5LPgVaded4Qc77vm0fw: doesn't show hand
*** SUMMARY ***
Total pot $1 | Rake $0
Seat 1: Do9Rlu1R5u/AcRtMTl8SYg (big blind) folded before Flop
Seat 2: EMc5LPgVaded4Qc77vm0fw (button) (small blind) collected ($1)



PokerStars Game #59939002476:  Hold'em No Limit ($0.25/$0.50) - 2009/07/01 0:28:54 ET
Table 'IeNZOZQ4T6oiaHqFeo6yIA' 2-max Seat #1 is the button
Seat 1: ndd1nfncBkWNitBnsfCoVQ ($79.80 in chips)
Seat 2: A91IUl5JaZROhtfCtnnwYw ($52.95 in chips)
ndd1nfncBkWNitBnsfCoVQ: posts small blind $0.25
A91IUl5JaZROhtfCtnnwYw: posts big blind $0.50
*** HOLE CARDS ***
ndd1nfncBkWNitBnsfCoVQ: raises $1 to $1.50
A91IUl5JaZROhtfCtnnwYw: calls $1
*** FLOP *** [Ac 2h 4c]
A91IUl5JaZROhtfCtnnwYw: checks
ndd1nfncBkWNitBnsfCoVQ: bets $2
A91IUl5JaZROhtfCtnnwYw: folds
ndd1nfncBkWNitBnsfCoVQ collected $2.85 from pot
ndd1nfncBkWNitBnsfCoVQ: doesn't show hand
*** SUMMARY ***
Total pot $3 | Rake $0.15
Board [Ac 2h 4c]
Seat 1: ndd1nfncBkWNitBnsfCoVQ (button) (small blind) collected ($2.85)
Seat 2: A91IUl5JaZROhtfCtnnwYw (big blind) folded on the Flop



PokerStars Game #59939005952:  Hold'em No Limit ($0.25/$0.50) - 2009/07/01 0:28:59 ET
Table 'E7bWJ45aoFXRpyRv2gw+Ig' 2-max Seat #2 is the button
Seat 1: FRkiRasEGlHUeLrEl+k/nA ($52.05 in chips)
Seat 2: 3Wro85I7472vJ4Wkpneo9A ($124.85 in chips)
3Wro85I7472vJ4Wkpneo9A: posts small blind $0.25
FRkiRasEGlHUeLrEl+k/nA: posts big blind $0.50
*** HOLE CARDS ***
3Wro85I7472vJ4Wkpneo9A: folds
FRkiRasEGlHUeLrEl+k/nA collected $0.50 from pot
*** SUMMARY ***
Total pot $0.50 | Rake $0
Seat 1: FRkiRasEGlHUeLrEl+k/nA (big blind) collected ($0.50)
Seat 2: 3Wro85I7472vJ4Wkpneo9A (button) (small blind) folded before Flop



PokerStars Game #59939006072:  Hold'em No Limit ($0.25/$0.50) - 2009/07/01 0:28:59 ET
Table 'mTxf8gPLgffN3Iwfm7Icfg' 2-max Seat #1 is the button
Seat 1: Do9Rlu1R5u/AcRtMTl8SYg ($94.30 in chips)
Seat 2: EMc5LPgVaded4Qc77vm0fw ($65.30 in chips)
Do9Rlu1R5u/AcRtMTl8SYg: posts small blind $0.25
EMc5LPgVaded4Qc77vm0fw: posts big blind $0.50
*** HOLE CARDS ***
Do9Rlu1R5u/AcRtMTl8SYg: raises $1 to $1.50
EMc5LPgVaded4Qc77vm0fw: raises $3 to $4.50
Do9Rlu1R5u/AcRtMTl8SYg: folds
EMc5LPgVaded4Qc77vm0fw collected $3 from pot
EMc5LPgVaded4Qc77vm0fw: doesn't show hand
*** SUMMARY ***
Total pot $3 | Rake $0
Seat 1: Do9Rlu1R5u/AcRtMTl8SYg (button) (small blind) folded before Flop
Seat 2: EMc5LPgVaded4Qc77vm0fw (big blind) collected ($3)



PokerStars Game #59939005862:  Hold'em No Limit ($0.25/$0.50) - 2009/07/01 0:28:59 ET
Table '5EmHi+fnatGQQShcNmzOZQ' 6-max Seat #1 is the button
Seat 1: SwPczQo3cOtwEzhJrfO2cQ ($23.95 in chips)
Seat 2: vXIHnZ+dv/hwSBxyvGw7bQ ($50.25 in chips)
Seat 3: L9qfLYXrczhAPd/VckgsWw ($61.35 in chips)
Seat 4: wOyVV9M/oyiw3YaOjNZ05w ($50 in chips)
Seat 5: kxPhs4ePFqMy52CInAJ2aw ($61.85 in chips)
Seat 6: 686aeHikcJlgKkSuIFdcXQ ($143.40 in chips)
vXIHnZ+dv/hwSBxyvGw7bQ: posts small blind $0.25
L9qfLYXrczhAPd/VckgsWw: posts big blind $0.50
*** HOLE CARDS ***
wOyVV9M/oyiw3YaOjNZ05w: raises $1.50 to $2
kxPhs4ePFqMy52CInAJ2aw: folds
686aeHikcJlgKkSuIFdcXQ: calls $2
SwPczQo3cOtwEzhJrfO2cQ: folds
vXIHnZ+dv/hwSBxyvGw7bQ: folds
L9qfLYXrczhAPd/VckgsWw: folds
*** FLOP *** [6s 3d Jc]
wOyVV9M/oyiw3YaOjNZ05w: bets $3
686aeHikcJlgKkSuIFdcXQ: folds
wOyVV9M/oyiw3YaOjNZ05w collected $4.55 from pot
*** SUMMARY ***
Total pot $4.75 | Rake $0.20
Board [6s 3d Jc]
Seat 1: SwPczQo3cOtwEzhJrfO2cQ (button) folded before Flop (didn't bet)
Seat 2: vXIHnZ+dv/hwSBxyvGw7bQ (small blind) folded before Flop
Seat 3: L9qfLYXrczhAPd/VckgsWw (big blind) folded before Flop
Seat 4: wOyVV9M/oyiw3YaOjNZ05w collected ($4.55)
Seat 5: kxPhs4ePFqMy52CInAJ2aw folded before Flop (didn't bet)
Seat 6: 686aeHikcJlgKkSuIFdcXQ folded on the Flop



PokerStars Game #59939006446:  Hold'em No Limit ($0.25/$0.50) - 2009/07/01 0:29:00 ET
Table 'lSisgp6H7Fg1hH5VfjEjYQ' 9-max Seat #9 is the button
Seat 1: pEW8B6uXbdR47kfljMQ3+Q ($38.10 in chips)
Seat 2: UrcnkQOiLVk8BlKDPJSy7Q ($50.35 in chips)
Seat 3: aTkyjTh3w5YLWiIERupZOA ($39.40 in chips)
Seat 4: bwv/rbH/hHhPhY6u9mu04w ($25.65 in chips)
Seat 5: mSD1pginDsyHG5PDfqzphw ($10 in chips)
Seat 6: +k7T5ocke8UwavtgUHm+Cg ($25.35 in chips)
Seat 7: dGw5MBstXyXhWHHVFOWOFA ($42 in chips)
Seat 8: a4JDWmpFQkL10XfAyuF51A ($38 in chips)
Seat 9: 5JJVDlaiMnB004o/RqbZZQ ($40.45 in chips)
pEW8B6uXbdR47kfljMQ3+Q: posts small blind $0.25
UrcnkQOiLVk8BlKDPJSy7Q: posts big blind $0.50
*** HOLE CARDS ***
aTkyjTh3w5YLWiIERupZOA: raises $1 to $1.50
bwv/rbH/hHhPhY6u9mu04w: folds
mSD1pginDsyHG5PDfqzphw: folds
+k7T5ocke8UwavtgUHm+Cg: folds
dGw5MBstXyXhWHHVFOWOFA: folds
a4JDWmpFQkL10XfAyuF51A: folds
5JJVDlaiMnB004o/RqbZZQ: folds
pEW8B6uXbdR47kfljMQ3+Q: folds
UrcnkQOiLVk8BlKDPJSy7Q: folds
aTkyjTh3w5YLWiIERupZOA collected $1.25 from pot
aTkyjTh3w5YLWiIERupZOA: doesn't show hand
*** SUMMARY ***
Total pot $1.25 | Rake $0
Seat 1: pEW8B6uXbdR47kfljMQ3+Q (small blind) folded before Flop
Seat 2: UrcnkQOiLVk8BlKDPJSy7Q (big blind) folded before Flop
Seat 3: aTkyjTh3w5YLWiIERupZOA collected ($1.25)
Seat 4: bwv/rbH/hHhPhY6u9mu04w folded before Flop (didn't bet)
Seat 5: mSD1pginDsyHG5PDfqzphw folded before Flop (didn't bet)
Seat 6: +k7T5ocke8UwavtgUHm+Cg folded before Flop (didn't bet)
Seat 7: dGw5MBstXyXhWHHVFOWOFA folded before Flop (didn't bet)
Seat 8: a4JDWmpFQkL10XfAyuF51A folded before Flop (didn't bet)
Seat 9: 5JJVDlaiMnB004o/RqbZZQ (button) folded before Flop (didn't bet)



PokerStars Game #59939007488:  Hold'em No Limit ($0.25/$0.50) - 2009/07/01 0:29:01 ET
Table 'GfL/No5u5PoEnU39lP5pQg' 6-max Seat #1 is the button
Seat 1: 1WUCqNG+p+vfWRTXNu4ljw ($50 in chips)
Seat 2: uVwggSetzp7d+eVgowO3vg ($58.05 in chips)
Seat 3: NbUTppWfym/RxV/DmDz2Sw ($20.60 in chips)
Seat 5: crjGpJEzSZgD38FoE3VMGg ($52.80 in chips)
uVwggSetzp7d+eVgowO3vg: posts small blind $0.25
NbUTppWfym/RxV/DmDz2Sw: posts big blind $0.50
*** HOLE CARDS ***
crjGpJEzSZgD38FoE3VMGg: raises $1.50 to $2
1WUCqNG+p+vfWRTXNu4ljw: folds
uVwggSetzp7d+eVgowO3vg: folds
NbUTppWfym/RxV/DmDz2Sw: calls $1.50
*** FLOP *** [2s 8d Ac]
NbUTppWfym/RxV/DmDz2Sw: checks
x+pzUFJsMIiGd7a5pcR4tg joins the table at seat #4
crjGpJEzSZgD38FoE3VMGg: bets $2.50
NbUTppWfym/RxV/DmDz2Sw: folds
crjGpJEzSZgD38FoE3VMGg collected $4.05 from pot
crjGpJEzSZgD38FoE3VMGg: doesn't show hand
*** SUMMARY ***
Total pot $4.25 | Rake $0.20
Board [2s 8d Ac]
Seat 1: 1WUCqNG+p+vfWRTXNu4ljw (button) folded before Flop (didn't bet)
Seat 2: uVwggSetzp7d+eVgowO3vg (small blind) folded before Flop
Seat 3: NbUTppWfym/RxV/DmDz2Sw (big blind) folded on the Flop
Seat 5: crjGpJEzSZgD38FoE3VMGg collected ($4.05)



PokerStars Game #59939008940:  Hold'em No Limit ($0.25/$0.50) - 2009/07/01 0:29:03 ET
Table 'T/PgNWqVyY6lkldcBVXYJQ' 6-max Seat #4 is the button
Seat 1: +Pf9jTVizYlIo+woPvptfA ($56.60 in chips)
Seat 2: oZAeY5rVqNGgt8yyQ0pxbA ($38.05 in chips)
Seat 3: L3OcNO1bgdqDI46j67KQPQ ($54.60 in chips)
Seat 4: jxMvxeUUL9UU0V6wVU+Iyw ($9.20 in chips)
Seat 5: vVQBckETtigfb5mAcyK0OA ($40.35 in chips)
Seat 6: cDzbog6kwmJp+LBeBq+iMQ ($56.75 in chips)
vVQBckETtigfb5mAcyK0OA: posts small blind $0.25
cDzbog6kwmJp+LBeBq+iMQ: posts big blind $0.50
*** HOLE CARDS ***
+Pf9jTVizYlIo+woPvptfA: folds
cDzbog6kwmJp+LBeBq+iMQ said, "thank"
cDzbog6kwmJp+LBeBq+iMQ said, "*"
oZAeY5rVqNGgt8yyQ0pxbA: folds
L3OcNO1bgdqDI46j67KQPQ: folds
jxMvxeUUL9UU0V6wVU+Iyw: folds
vVQBckETtigfb5mAcyK0OA: calls $0.25
cDzbog6kwmJp+LBeBq+iMQ: checks
*** FLOP *** [Ac Jc Ks]
vVQBckETtigfb5mAcyK0OA: bets $0.50
cDzbog6kwmJp+LBeBq+iMQ: calls $0.50
*** TURN *** [Ac Jc Ks] [Jd]
vVQBckETtigfb5mAcyK0OA: checks
cDzbog6kwmJp+LBeBq+iMQ: checks
*** RIVER *** [Ac Jc Ks Jd] [8s]
vVQBckETtigfb5mAcyK0OA: checks
cDzbog6kwmJp+LBeBq+iMQ: checks
*** SHOW DOWN ***
vVQBckETtigfb5mAcyK0OA: shows [Kh 5s] (two pair, Kings and Jacks)
cDzbog6kwmJp+LBeBq+iMQ: mucks hand
vVQBckETtigfb5mAcyK0OA collected $1.95 from pot
vVQBckETtigfb5mAcyK0OA said, "i think its time to bump it up a little"
*** SUMMARY ***
Total pot $2 | Rake $0.05
Board [Ac Jc Ks Jd 8s]
Seat 1: +Pf9jTVizYlIo+woPvptfA folded before Flop (didn't bet)
Seat 2: oZAeY5rVqNGgt8yyQ0pxbA folded before Flop (didn't bet)
Seat 3: L3OcNO1bgdqDI46j67KQPQ folded before Flop (didn't bet)
Seat 4: jxMvxeUUL9UU0V6wVU+Iyw (button) folded before Flop (didn't bet)
Seat 5: vVQBckETtigfb5mAcyK0OA (small blind) showed [Kh 5s] and won ($1.95) with two pair, Kings and Jacks
Seat 6: cDzbog6kwmJp+LBeBq+iMQ (big blind) mucked



PokerStars Game #59939010168:  Hold'em No Limit ($0.25/$0.50) - 2009/07/01 0:29:05 ET
Table 'E7bWJ45aoFXRpyRv2gw+Ig' 2-max Seat #1 is the button
Seat 1: FRkiRasEGlHUeLrEl+k/nA ($52.30 in chips)
Seat 2: 3Wro85I7472vJ4Wkpneo9A ($124.60 in chips)
FRkiRasEGlHUeLrEl+k/nA: posts small blind $0.25
3Wro85I7472vJ4Wkpneo9A: posts big blind $0.50
*** HOLE CARDS ***
FRkiRasEGlHUeLrEl+k/nA: raises $1.50 to $2
3Wro85I7472vJ4Wkpneo9A: folds
FRkiRasEGlHUeLrEl+k/nA collected $1 from pot
*** SUMMARY ***
Total pot $1 | Rake $0
Seat 1: FRkiRasEGlHUeLrEl+k/nA (button) (small blind) collected ($1)
Seat 2: 3Wro85I7472vJ4Wkpneo9A (big blind) folded before Flop



PokerStars Game #59939009732:  Hold'em No Limit ($0.25/$0.50) - 2009/07/01 0:29:05 ET
Table 'eMxdLyFDf28E0wit6gm3Uw' 6-max Seat #4 is the button
Seat 2: jwuKQ1S3U4NnzMQn3E3dgw ($64.05 in chips)
Seat 3: dZcLsEI8iXkobBduRJ45Yw ($19.60 in chips)
Seat 4: QM93o65lI8kLzmiB/BILlA ($19.80 in chips)
Seat 6: L0aIPg7qefDQjdJo3HCVEA ($7.50 in chips)
L0aIPg7qefDQjdJo3HCVEA: posts small blind $0.25
jwuKQ1S3U4NnzMQn3E3dgw: posts big blind $0.50
*** HOLE CARDS ***
dZcLsEI8iXkobBduRJ45Yw: folds
QM93o65lI8kLzmiB/BILlA: calls $0.50
L0aIPg7qefDQjdJo3HCVEA: folds
jwuKQ1S3U4NnzMQn3E3dgw: checks
*** FLOP *** [6h Js 9d]
jwuKQ1S3U4NnzMQn3E3dgw: checks
QM93o65lI8kLzmiB/BILlA: checks
*** TURN *** [6h Js 9d] [9c]
jwuKQ1S3U4NnzMQn3E3dgw: checks
QM93o65lI8kLzmiB/BILlA: checks
*** RIVER *** [6h Js 9d 9c] [5c]
jwuKQ1S3U4NnzMQn3E3dgw: checks
QM93o65lI8kLzmiB/BILlA: checks
*** SHOW DOWN ***
jwuKQ1S3U4NnzMQn3E3dgw: shows [Kh 8c] (a pair of Nines)
QM93o65lI8kLzmiB/BILlA: shows [Tc Ac] (a pair of Nines - Ace kicker)
QM93o65lI8kLzmiB/BILlA collected $1.20 from pot
*** SUMMARY ***
Total pot $1.25 | Rake $0.05
Board [6h Js 9d 9c 5c]
Seat 2: jwuKQ1S3U4NnzMQn3E3dgw (big blind) showed [Kh 8c] and lost with a pair of Nines
Seat 3: dZcLsEI8iXkobBduRJ45Yw folded before Flop (didn't bet)
Seat 4: QM93o65lI8kLzmiB/BILlA (button) showed [Tc Ac] and won ($1.20) with a pair of Nines
Seat 6: L0aIPg7qefDQjdJo3HCVEA (small blind) folded before Flop



PokerStars Game #59939010874:  Hold'em No Limit ($0.25/$0.50) - 2009/07/01 0:29:06 ET
Table '+dXkOAQyS8j9PQZusUTMpg' 2-max Seat #1 is the button
Seat 1: XFa6sBGjP2gxoIvxR3fZIg ($58.65 in chips)
Seat 2: 5IBeOgaApY1Bvzv2P8X4EA ($85.50 in chips)
XFa6sBGjP2gxoIvxR3fZIg: posts small blind $0.25
5IBeOgaApY1Bvzv2P8X4EA: posts big blind $0.50
*** HOLE CARDS ***
XFa6sBGjP2gxoIvxR3fZIg: raises $1 to $1.50
5IBeOgaApY1Bvzv2P8X4EA: folds
XFa6sBGjP2gxoIvxR3fZIg collected $1 from pot
XFa6sBGjP2gxoIvxR3fZIg: doesn't show hand
*** SUMMARY ***
Total pot $1 | Rake $0
Seat 1: XFa6sBGjP2gxoIvxR3fZIg (button) (small blind) collected ($1)
Seat 2: 5IBeOgaApY1Bvzv2P8X4EA (big blind) folded before Flop



PokerStars Game #59939012216:  Hold'em No Limit ($0.25/$0.50) - 2009/07/01 0:29:08 ET
Table 'kgbJRsxfv64KrErDRBAkcw' 6-max Seat #1 is the button
Seat 1: N7O9jUEx2YiQn1+yRYTHmw ($17.30 in chips)
Seat 2: Q+thC23WCv1kJUJtH/+4Jw ($60.30 in chips)
Seat 3: T0Gx/FcQ5VH9u7XaOMX97A ($61.60 in chips)
Seat 4: qanMEqjABjWxC/JgQ/0l7w ($58.45 in chips)
Seat 5: +Pf9jTVizYlIo+woPvptfA ($50 in chips)
Seat 6: ozrlafxxh1HmYdA0/h+MuA ($14.75 in chips)
Q+thC23WCv1kJUJtH/+4Jw: posts small blind $0.25
T0Gx/FcQ5VH9u7XaOMX97A: posts big blind $0.50
*** HOLE CARDS ***
qanMEqjABjWxC/JgQ/0l7w: folds
+Pf9jTVizYlIo+woPvptfA: folds
ozrlafxxh1HmYdA0/h+MuA: folds
N7O9jUEx2YiQn1+yRYTHmw: raises $1 to $1.50
Q+thC23WCv1kJUJtH/+4Jw: calls $1.25
T0Gx/FcQ5VH9u7XaOMX97A: raises $5 to $6.50
N7O9jUEx2YiQn1+yRYTHmw: calls $5
Q+thC23WCv1kJUJtH/+4Jw: folds
*** FLOP *** [Qd 9c 8h]
T0Gx/FcQ5VH9u7XaOMX97A: bets $11
N7O9jUEx2YiQn1+yRYTHmw: calls $10.80 and is all-in
*** TURN *** [Qd 9c 8h] [6c]
*** RIVER *** [Qd 9c 8h 6c] [4d]
*** SHOW DOWN ***
T0Gx/FcQ5VH9u7XaOMX97A: shows [Ac Ks] (high card Ace)
N7O9jUEx2YiQn1+yRYTHmw: mucks hand
T0Gx/FcQ5VH9u7XaOMX97A collected $34.35 from pot
*** SUMMARY ***
Total pot $36.10 | Rake $1.75
Board [Qd 9c 8h 6c 4d]
Seat 1: N7O9jUEx2YiQn1+yRYTHmw (button) mucked
Seat 2: Q+thC23WCv1kJUJtH/+4Jw (small blind) folded before Flop
Seat 3: T0Gx/FcQ5VH9u7XaOMX97A (big blind) showed [Ac Ks] and won ($34.35) with high card Ace
Seat 4: qanMEqjABjWxC/JgQ/0l7w folded before Flop (didn't bet)
Seat 5: +Pf9jTVizYlIo+woPvptfA folded before Flop (didn't bet)
Seat 6: ozrlafxxh1HmYdA0/h+MuA folded before Flop (didn't bet)



PokerStars Game #59939013746:  Hold'em No Limit ($0.25/$0.50) - 2009/07/01 0:29:11 ET
Table 'otvGDROEDdqsabxskT79qg' 9-max Seat #3 is the button
Seat 1: 8ehL7qlZzjgUh2H35iiWLw ($52.30 in chips)
Seat 2: cCjTzH9jio8607WzjcfXlg ($11.30 in chips)
Seat 3: +k7T5ocke8UwavtgUHm+Cg ($74.65 in chips)
Seat 4: MG90wfSJZnOejs/KD3vlQQ ($51.30 in chips)
Seat 5: XNMDwbXt/Q4jM99AXnbJDw ($54.45 in chips)
Seat 7: C7+tBppJrKgd/r+tuKUIpA ($40.15 in chips)
Seat 9: KcY3X8YpD74Kw1RHkx/g4A ($61.60 in chips)
MG90wfSJZnOejs/KD3vlQQ: posts small blind $0.25
XNMDwbXt/Q4jM99AXnbJDw: posts big blind $0.50
bxLSulbgr8LmKNjOzw8URg: sits out
zE9cVigS2nW/Ljy4K4bUQA: sits out
*** HOLE CARDS ***
C7+tBppJrKgd/r+tuKUIpA: folds
KcY3X8YpD74Kw1RHkx/g4A: folds
8ehL7qlZzjgUh2H35iiWLw: folds
cCjTzH9jio8607WzjcfXlg: calls $0.50
+k7T5ocke8UwavtgUHm+Cg: folds
MG90wfSJZnOejs/KD3vlQQ: raises $1.50 to $2
XNMDwbXt/Q4jM99AXnbJDw: folds
cCjTzH9jio8607WzjcfXlg: calls $1.50
*** FLOP *** [Qd 4s 5c]
MG90wfSJZnOejs/KD3vlQQ: bets $3.50
cCjTzH9jio8607WzjcfXlg: folds
MG90wfSJZnOejs/KD3vlQQ collected $4.30 from pot
MG90wfSJZnOejs/KD3vlQQ: doesn't show hand
*** SUMMARY ***
Total pot $4.50 | Rake $0.20
Board [Qd 4s 5c]
Seat 1: 8ehL7qlZzjgUh2H35iiWLw folded before Flop (didn't bet)
Seat 2: cCjTzH9jio8607WzjcfXlg folded on the Flop
Seat 3: +k7T5ocke8UwavtgUHm+Cg (button) folded before Flop (didn't bet)
Seat 4: MG90wfSJZnOejs/KD3vlQQ (small blind) collected ($4.30)
Seat 5: XNMDwbXt/Q4jM99AXnbJDw (big blind) folded before Flop
Seat 7: C7+tBppJrKgd/r+tuKUIpA folded before Flop (didn't bet)
Seat 9: KcY3X8YpD74Kw1RHkx/g4A folded before Flop (didn't bet)



PokerStars Game #59939014660:  Hold'em No Limit ($0.25/$0.50) - 2009/07/01 0:29:12 ET
Table 'c/CRn+68J3Y8KxD5g1ek2Q' 2-max Seat #1 is the button
Seat 1: 46qCyJ6evTkHo9al5sBMNA ($258 in chips)
Seat 2: BypVLsYQt3ePFm2xQL/dOA ($121.30 in chips)
46qCyJ6evTkHo9al5sBMNA: posts small blind $0.25
BypVLsYQt3ePFm2xQL/dOA: posts big blind $0.50
*** HOLE CARDS ***
46qCyJ6evTkHo9al5sBMNA: raises $1.50 to $2
BypVLsYQt3ePFm2xQL/dOA: folds
46qCyJ6evTkHo9al5sBMNA collected $1 from pot
46qCyJ6evTkHo9al5sBMNA: doesn't show hand
*** SUMMARY ***
Total pot $1 | Rake $0
Seat 1: 46qCyJ6evTkHo9al5sBMNA (button) (small blind) collected ($1)
Seat 2: BypVLsYQt3ePFm2xQL/dOA (big blind) folded before Flop



PokerStars Game #59939014580:  Hold'em No Limit ($0.25/$0.50) - 2009/07/01 0:29:12 ET
Table '3FhG0gl3kMX3wBEEqj+wnQ' 9-max Seat #9 is the button
Seat 1: e0J9pdCNUDTCG031RnXqLA ($17.25 in chips)
Seat 2: 4dl3YNqZ6Houm2jZAzDmRg ($15.55 in chips)
Seat 3: HZkVla4kK2SI42CVrPZ/ig ($9.25 in chips)
Seat 4: bz4LMfV0GGl/MJ/ABXuPmg ($21.35 in chips)
Seat 5: XNMDwbXt/Q4jM99AXnbJDw ($50 in chips)
Seat 6: 5JJVDlaiMnB004o/RqbZZQ ($23.75 in chips)
Seat 7: mSD1pginDsyHG5PDfqzphw ($10 in chips)
Seat 8: j3K/Jujr7PY4ZM2RZvlH6A ($65.70 in chips)
Seat 9: L5e2lrPLQm1Pqx30IIZ/Fw ($11.85 in chips)
e0J9pdCNUDTCG031RnXqLA: posts small blind $0.25
4dl3YNqZ6Houm2jZAzDmRg: posts big blind $0.50
*** HOLE CARDS ***
HZkVla4kK2SI42CVrPZ/ig: folds
bz4LMfV0GGl/MJ/ABXuPmg: folds
XNMDwbXt/Q4jM99AXnbJDw: folds
5JJVDlaiMnB004o/RqbZZQ: folds
mSD1pginDsyHG5PDfqzphw: folds
j3K/Jujr7PY4ZM2RZvlH6A: raises $1 to $1.50
L5e2lrPLQm1Pqx30IIZ/Fw: folds
e0J9pdCNUDTCG031RnXqLA: folds
4dl3YNqZ6Houm2jZAzDmRg: calls $1
*** FLOP *** [5s Jd 8h]
4dl3YNqZ6Houm2jZAzDmRg: bets $2.50
j3K/Jujr7PY4ZM2RZvlH6A: calls $2.50
*** TURN *** [5s Jd 8h] [8s]
4dl3YNqZ6Houm2jZAzDmRg: bets $11.55 and is all-in
j3K/Jujr7PY4ZM2RZvlH6A: folds
4dl3YNqZ6Houm2jZAzDmRg collected $7.85 from pot
*** SUMMARY ***
Total pot $8.25 | Rake $0.40
Board [5s Jd 8h 8s]
Seat 1: e0J9pdCNUDTCG031RnXqLA (small blind) folded before Flop
Seat 2: 4dl3YNqZ6Houm2jZAzDmRg (big blind) collected ($7.85)
Seat 3: HZkVla4kK2SI42CVrPZ/ig folded before Flop (didn't bet)
Seat 4: bz4LMfV0GGl/MJ/ABXuPmg folded before Flop (didn't bet)
Seat 5: XNMDwbXt/Q4jM99AXnbJDw folded before Flop (didn't bet)
Seat 6: 5JJVDlaiMnB004o/RqbZZQ folded before Flop (didn't bet)
Seat 7: mSD1pginDsyHG5PDfqzphw folded before Flop (didn't bet)
Seat 8: j3K/Jujr7PY4ZM2RZvlH6A folded on the Turn
Seat 9: L5e2lrPLQm1Pqx30IIZ/Fw (button) folded before Flop (didn't bet)



PokerStars Game #59939015520:  Hold'em No Limit ($0.25/$0.50) - 2009/07/01 0:29:13 ET
Table 'mTxf8gPLgffN3Iwfm7Icfg' 2-max Seat #2 is the button
Seat 1: Do9Rlu1R5u/AcRtMTl8SYg ($92.80 in chips)
Seat 2: EMc5LPgVaded4Qc77vm0fw ($66.80 in chips)
EMc5LPgVaded4Qc77vm0fw: posts small blind $0.25
Do9Rlu1R5u/AcRtMTl8SYg: posts big blind $0.50
*** HOLE CARDS ***
EMc5LPgVaded4Qc77vm0fw: raises $1 to $1.50
Do9Rlu1R5u/AcRtMTl8SYg: folds
EMc5LPgVaded4Qc77vm0fw collected $1 from pot
EMc5LPgVaded4Qc77vm0fw: doesn't show hand
*** SUMMARY ***
Total pot $1 | Rake $0
Seat 1: Do9Rlu1R5u/AcRtMTl8SYg (big blind) folded before Flop
Seat 2: EMc5LPgVaded4Qc77vm0fw (button) (small blind) collected ($1)



PokerStars Game #59939015676:  Hold'em No Limit ($0.25/$0.50) - 2009/07/01 0:29:14 ET
Table '+dXkOAQyS8j9PQZusUTMpg' 2-max Seat #2 is the button
Seat 1: XFa6sBGjP2gxoIvxR3fZIg ($59.15 in chips)
Seat 2: 5IBeOgaApY1Bvzv2P8X4EA ($85 in chips)
5IBeOgaApY1Bvzv2P8X4EA: posts small blind $0.25
XFa6sBGjP2gxoIvxR3fZIg: posts big blind $0.50
*** HOLE CARDS ***
5IBeOgaApY1Bvzv2P8X4EA: raises $1 to $1.50
XFa6sBGjP2gxoIvxR3fZIg: folds
5IBeOgaApY1Bvzv2P8X4EA collected $1 from pot
5IBeOgaApY1Bvzv2P8X4EA: doesn't show hand
*** SUMMARY ***
Total pot $1 | Rake $0
Seat 1: XFa6sBGjP2gxoIvxR3fZIg (big blind) folded before Flop
Seat 2: 5IBeOgaApY1Bvzv2P8X4EA (button) (small blind) collected ($1)



PokerStars Game #59939016656:  Hold'em No Limit ($0.25/$0.50) - 2009/07/01 0:29:15 ET
Table 'E7bWJ45aoFXRpyRv2gw+Ig' 2-max Seat #2 is the button
Seat 1: FRkiRasEGlHUeLrEl+k/nA ($52.80 in chips)
Seat 2: 3Wro85I7472vJ4Wkpneo9A ($124.10 in chips)
3Wro85I7472vJ4Wkpneo9A: posts small blind $0.25
FRkiRasEGlHUeLrEl+k/nA: posts big blind $0.50
*** HOLE CARDS ***
3Wro85I7472vJ4Wkpneo9A: calls $0.25
FRkiRasEGlHUeLrEl+k/nA: checks
*** FLOP *** [8c 9d 4h]
FRkiRasEGlHUeLrEl+k/nA: bets $0.50
3Wro85I7472vJ4Wkpneo9A: calls $0.50
*** TURN *** [8c 9d 4h] [4c]
FRkiRasEGlHUeLrEl+k/nA: checks
3Wro85I7472vJ4Wkpneo9A: checks
*** RIVER *** [8c 9d 4h 4c] [Kc]
FRkiRasEGlHUeLrEl+k/nA: checks
3Wro85I7472vJ4Wkpneo9A: bets $2
FRkiRasEGlHUeLrEl+k/nA: folds
3Wro85I7472vJ4Wkpneo9A collected $1.95 from pot
3Wro85I7472vJ4Wkpneo9A: doesn't show hand
*** SUMMARY ***
Total pot $2 | Rake $0.05
Board [8c 9d 4h 4c Kc]
Seat 1: FRkiRasEGlHUeLrEl+k/nA (big blind) folded on the River
Seat 2: 3Wro85I7472vJ4Wkpneo9A (button) (small blind) collected ($1.95)



PokerStars Game #59939017022:  Hold'em No Limit ($0.25/$0.50) - 2009/07/01 0:29:15 ET
Table 'IeNZOZQ4T6oiaHqFeo6yIA' 2-max Seat #2 is the button
Seat 1: ndd1nfncBkWNitBnsfCoVQ ($81.15 in chips)
Seat 2: A91IUl5JaZROhtfCtnnwYw ($51.45 in chips)
A91IUl5JaZROhtfCtnnwYw: posts small blind $0.25
ndd1nfncBkWNitBnsfCoVQ: posts big blind $0.50
*** HOLE CARDS ***
A91IUl5JaZROhtfCtnnwYw: raises $0.50 to $1
ndd1nfncBkWNitBnsfCoVQ: folds
A91IUl5JaZROhtfCtnnwYw collected $1 from pot
*** SUMMARY ***
Total pot $1 | Rake $0
Seat 1: ndd1nfncBkWNitBnsfCoVQ (big blind) folded before Flop
Seat 2: A91IUl5JaZROhtfCtnnwYw (button) (small blind) collected ($1)



PokerStars Game #59939016524:  Hold'em No Limit ($0.25/$0.50) - 2009/07/01 0:29:15 ET
Table '37qXEp3oe+er5q4CZip9eQ' 6-max Seat #5 is the button
Seat 1: oqOqoO2AyCZenUghCxMDxw ($50 in chips)
Seat 2: 6wzJiRvp8HY6t+MQGnSIzA ($18.80 in chips)
Seat 3: Rt6KgtZ8YaJoTc3FPim00w ($95 in chips)
Seat 4: XsmE8nXMAAMFJbWaJTmHFw ($17.55 in chips)
Seat 5: VOmI0x4dDPnTESZd5B4d1Q ($44.50 in chips)
Seat 6: l4m/wWPs22DSP5xpszjXKA ($9.50 in chips)
l4m/wWPs22DSP5xpszjXKA: posts small blind $0.25
oqOqoO2AyCZenUghCxMDxw: posts big blind $0.50
*** HOLE CARDS ***
6wzJiRvp8HY6t+MQGnSIzA: calls $0.50
Rt6KgtZ8YaJoTc3FPim00w: folds
XsmE8nXMAAMFJbWaJTmHFw: raises $1.20 to $1.70
VOmI0x4dDPnTESZd5B4d1Q: folds
l4m/wWPs22DSP5xpszjXKA: folds
oqOqoO2AyCZenUghCxMDxw: folds
6wzJiRvp8HY6t+MQGnSIzA: calls $1.20
*** FLOP *** [7h Jh 2s]
6wzJiRvp8HY6t+MQGnSIzA: checks
XsmE8nXMAAMFJbWaJTmHFw: bets $1.90
6wzJiRvp8HY6t+MQGnSIzA: folds
XsmE8nXMAAMFJbWaJTmHFw collected $3.95 from pot
*** SUMMARY ***
Total pot $4.15 | Rake $0.20
Board [7h Jh 2s]
Seat 1: oqOqoO2AyCZenUghCxMDxw (big blind) folded before Flop
Seat 2: 6wzJiRvp8HY6t+MQGnSIzA folded on the Flop
Seat 3: Rt6KgtZ8YaJoTc3FPim00w folded before Flop (didn't bet)
Seat 4: XsmE8nXMAAMFJbWaJTmHFw collected ($3.95)
Seat 5: VOmI0x4dDPnTESZd5B4d1Q (button) folded before Flop (didn't bet)
Seat 6: l4m/wWPs22DSP5xpszjXKA (small blind) folded before Flop



PokerStars Game #59939018612:  Hold'em No Limit ($0.25/$0.50) - 2009/07/01 0:29:18 ET
Table 'QOgaEqMcJ73pcUMMxoisUg' 6-max Seat #6 is the button
Seat 2: Im2p1Nt83UKSqv5c9frm4Q ($50 in chips)
Seat 3: wUZNozoIDYf+16hp4nn6dw ($38.40 in chips)
Seat 4: zAcsDhG/T128Vn7XGVSgKg ($61.05 in chips)
Seat 5: 6vNxrjjCl6FwfaaymM9jjg ($26.80 in chips)
Seat 6: s83dnhZ6VC53vY0/f6OV/g ($41.60 in chips)
Im2p1Nt83UKSqv5c9frm4Q: posts small blind $0.25
wUZNozoIDYf+16hp4nn6dw: posts big blind $0.50
*** HOLE CARDS ***
zAcsDhG/T128Vn7XGVSgKg: folds
OZ6OtYh5Y53MCH/p0QTn5g joins the table at seat #1
6vNxrjjCl6FwfaaymM9jjg: folds
s83dnhZ6VC53vY0/f6OV/g: raises $1.50 to $2
Im2p1Nt83UKSqv5c9frm4Q: folds
wUZNozoIDYf+16hp4nn6dw: calls $1.50
*** FLOP *** [5d 8h 4c]
wUZNozoIDYf+16hp4nn6dw: checks
s83dnhZ6VC53vY0/f6OV/g: checks
*** TURN *** [5d 8h 4c] [6h]
wUZNozoIDYf+16hp4nn6dw: checks
s83dnhZ6VC53vY0/f6OV/g: checks
*** RIVER *** [5d 8h 4c 6h] [8d]
wUZNozoIDYf+16hp4nn6dw: bets $3.50
s83dnhZ6VC53vY0/f6OV/g: calls $3.50
*** SHOW DOWN ***
wUZNozoIDYf+16hp4nn6dw: shows [Td 4d] (two pair, Eights and Fours)
s83dnhZ6VC53vY0/f6OV/g: mucks hand
wUZNozoIDYf+16hp4nn6dw collected $10.70 from pot
*** SUMMARY ***
Total pot $11.25 | Rake $0.55
Board [5d 8h 4c 6h 8d]
Seat 2: Im2p1Nt83UKSqv5c9frm4Q (small blind) folded before Flop
Seat 3: wUZNozoIDYf+16hp4nn6dw (big blind) showed [Td 4d] and won ($10.70) with two pair, Eights and Fours
Seat 4: zAcsDhG/T128Vn7XGVSgKg folded before Flop (didn't bet)
Seat 5: 6vNxrjjCl6FwfaaymM9jjg folded before Flop (didn't bet)
Seat 6: s83dnhZ6VC53vY0/f6OV/g (button) mucked



PokerStars Game #59939019124:  Hold'em No Limit ($0.25/$0.50) - 2009/07/01 0:29:19 ET
Table 'PALRfuH85dr5IkDfdv6new' 9-max Seat #8 is the button
Seat 1: SKnJuWHScqetA/qG5p+wCg ($30.25 in chips)
Seat 2: 9r7ZoBbAJj5IeyZ0q9BdzA ($6.85 in chips)
Seat 3: 50QWoELmpmHFrFIlWMJo9g ($87.45 in chips)
Seat 4: mZNMJI1mY40XTC0U7GZakA ($50.75 in chips)
Seat 5: jSSGUXdNFAZA3QCvTcUMQw ($43.45 in chips)
Seat 6: E2518gp4aFz1+kAgmGqeEg ($10.25 in chips)
Seat 7: 3NcyXvr39gnK+KbTq7ezyA ($39.25 in chips)
Seat 8: NkS+CseUKx4XHszWq0PXEQ ($44.65 in chips)
Seat 9: CIrAX/m6o7jYmKOAjJXv4Q ($36.70 in chips)
CIrAX/m6o7jYmKOAjJXv4Q: posts small blind $0.25
SKnJuWHScqetA/qG5p+wCg: posts big blind $0.50
*** HOLE CARDS ***
9r7ZoBbAJj5IeyZ0q9BdzA: folds
50QWoELmpmHFrFIlWMJo9g: folds
mZNMJI1mY40XTC0U7GZakA: folds
jSSGUXdNFAZA3QCvTcUMQw: folds
E2518gp4aFz1+kAgmGqeEg: raises $1 to $1.50
3NcyXvr39gnK+KbTq7ezyA: folds
NkS+CseUKx4XHszWq0PXEQ: folds
CIrAX/m6o7jYmKOAjJXv4Q: folds
SKnJuWHScqetA/qG5p+wCg: folds
E2518gp4aFz1+kAgmGqeEg collected $1.25 from pot
E2518gp4aFz1+kAgmGqeEg: doesn't show hand
*** SUMMARY ***
Total pot $1.25 | Rake $0
Seat 1: SKnJuWHScqetA/qG5p+wCg (big blind) folded before Flop
Seat 2: 9r7ZoBbAJj5IeyZ0q9BdzA folded before Flop (didn't bet)
Seat 3: 50QWoELmpmHFrFIlWMJo9g folded before Flop (didn't bet)
Seat 4: mZNMJI1mY40XTC0U7GZakA folded before Flop (didn't bet)
Seat 5: jSSGUXdNFAZA3QCvTcUMQw folded before Flop (didn't bet)
Seat 6: E2518gp4aFz1+kAgmGqeEg collected ($1.25)
Seat 7: 3NcyXvr39gnK+KbTq7ezyA folded before Flop (didn't bet)
Seat 8: NkS+CseUKx4XHszWq0PXEQ (button) folded before Flop (didn't bet)
Seat 9: CIrAX/m6o7jYmKOAjJXv4Q (small blind) folded before Flop



PokerStars Game #59939019250:  Hold'em No Limit ($0.25/$0.50) - 2009/07/01 0:29:19 ET
Table 'MJxeZCzYELxiIsyUZyT0jw' 6-max Seat #1 is the button
Seat 1: wOyVV9M/oyiw3YaOjNZ05w ($51.10 in chips)
Seat 2: dB6jzDlJmET84VMWw1mTRA ($50 in chips)
Seat 3: JQZew0FjzS19kTjeNtrE+A ($51.55 in chips)
Seat 4: lP7Q6pewz4C2RsAfKsjdWw ($36.70 in chips)
Seat 5: 3jvoOXNtXE90w2BdfNZwZQ ($53.80 in chips)
Seat 6: TTx3CHxyi0SObcHyMJRp5w ($48 in chips)
dB6jzDlJmET84VMWw1mTRA: posts small blind $0.25
JQZew0FjzS19kTjeNtrE+A: posts big blind $0.50
*** HOLE CARDS ***
lP7Q6pewz4C2RsAfKsjdWw: folds
3jvoOXNtXE90w2BdfNZwZQ: folds
TTx3CHxyi0SObcHyMJRp5w: folds
wOyVV9M/oyiw3YaOjNZ05w: raises $1 to $1.50
dB6jzDlJmET84VMWw1mTRA: calls $1.25
JQZew0FjzS19kTjeNtrE+A: folds
*** FLOP *** [Ks 4c 5c]
dB6jzDlJmET84VMWw1mTRA: checks
wOyVV9M/oyiw3YaOjNZ05w: bets $1.75
dB6jzDlJmET84VMWw1mTRA: folds
wOyVV9M/oyiw3YaOjNZ05w collected $3.35 from pot
wOyVV9M/oyiw3YaOjNZ05w: doesn't show hand
*** SUMMARY ***
Total pot $3.50 | Rake $0.15
Board [Ks 4c 5c]
Seat 1: wOyVV9M/oyiw3YaOjNZ05w (button) collected ($3.35)
Seat 2: dB6jzDlJmET84VMWw1mTRA (small blind) folded on the Flop
Seat 3: JQZew0FjzS19kTjeNtrE+A (big blind) folded before Flop
Seat 4: lP7Q6pewz4C2RsAfKsjdWw folded before Flop (didn't bet)
Seat 5: 3jvoOXNtXE90w2BdfNZwZQ folded before Flop (didn't bet)
Seat 6: TTx3CHxyi0SObcHyMJRp5w folded before Flop (didn't bet)



PokerStars Game #59939021024:  Hold'em No Limit ($0.25/$0.50) - 2009/07/01 0:29:20 ET
Table 'mTxf8gPLgffN3Iwfm7Icfg' 2-max Seat #1 is the button
Seat 1: Do9Rlu1R5u/AcRtMTl8SYg ($92.30 in chips)
Seat 2: EMc5LPgVaded4Qc77vm0fw ($67.30 in chips)
Do9Rlu1R5u/AcRtMTl8SYg: posts small blind $0.25
EMc5LPgVaded4Qc77vm0fw: posts big blind $0.50
*** HOLE CARDS ***
Do9Rlu1R5u/AcRtMTl8SYg: folds
EMc5LPgVaded4Qc77vm0fw collected $0.50 from pot
EMc5LPgVaded4Qc77vm0fw: doesn't show hand
*** SUMMARY ***
Total pot $0.50 | Rake $0
Seat 1: Do9Rlu1R5u/AcRtMTl8SYg (button) (small blind) folded before Flop
Seat 2: EMc5LPgVaded4Qc77vm0fw (big blind) collected ($0.50)



PokerStars Game #59939021690:  Hold'em No Limit ($0.25/$0.50) - 2009/07/01 0:29:21 ET
Table 'lSisgp6H7Fg1hH5VfjEjYQ' 9-max Seat #1 is the button
Seat 1: pEW8B6uXbdR47kfljMQ3+Q ($37.85 in chips)
Seat 2: UrcnkQOiLVk8BlKDPJSy7Q ($50 in chips)
Seat 3: aTkyjTh3w5YLWiIERupZOA ($40.15 in chips)
Seat 4: bwv/rbH/hHhPhY6u9mu04w ($25.65 in chips)
Seat 5: mSD1pginDsyHG5PDfqzphw ($10 in chips)
Seat 6: +k7T5ocke8UwavtgUHm+Cg ($25.35 in chips)
Seat 7: dGw5MBstXyXhWHHVFOWOFA ($42 in chips)
Seat 8: a4JDWmpFQkL10XfAyuF51A ($38 in chips)
Seat 9: 5JJVDlaiMnB004o/RqbZZQ ($40.45 in chips)
UrcnkQOiLVk8BlKDPJSy7Q: posts small blind $0.25
aTkyjTh3w5YLWiIERupZOA: posts big blind $0.50
*** HOLE CARDS ***
bwv/rbH/hHhPhY6u9mu04w: calls $0.50
mSD1pginDsyHG5PDfqzphw: folds
+k7T5ocke8UwavtgUHm+Cg: folds
dGw5MBstXyXhWHHVFOWOFA: folds
dGw5MBstXyXhWHHVFOWOFA is sitting out
a4JDWmpFQkL10XfAyuF51A: folds
dGw5MBstXyXhWHHVFOWOFA has returned
5JJVDlaiMnB004o/RqbZZQ: folds
pEW8B6uXbdR47kfljMQ3+Q: folds
UrcnkQOiLVk8BlKDPJSy7Q: raises $2 to $2.50
aTkyjTh3w5YLWiIERupZOA: folds
bwv/rbH/hHhPhY6u9mu04w: calls $2
*** FLOP *** [3h Jh Ac]
UrcnkQOiLVk8BlKDPJSy7Q: bets $4
bwv/rbH/hHhPhY6u9mu04w: folds
UrcnkQOiLVk8BlKDPJSy7Q collected $5.25 from pot
UrcnkQOiLVk8BlKDPJSy7Q: doesn't show hand
*** SUMMARY ***
Total pot $5.50 | Rake $0.25
Board [3h Jh Ac]
Seat 1: pEW8B6uXbdR47kfljMQ3+Q (button) folded before Flop (didn't bet)
Seat 2: UrcnkQOiLVk8BlKDPJSy7Q (small blind) collected ($5.25)
Seat 3: aTkyjTh3w5YLWiIERupZOA (big blind) folded before Flop
Seat 4: bwv/rbH/hHhPhY6u9mu04w folded on the Flop
Seat 5: mSD1pginDsyHG5PDfqzphw folded before Flop (didn't bet)
Seat 6: +k7T5ocke8UwavtgUHm+Cg folded before Flop (didn't bet)
Seat 7: dGw5MBstXyXhWHHVFOWOFA folded before Flop (didn't bet)
Seat 8: a4JDWmpFQkL10XfAyuF51A folded before Flop (didn't bet)
Seat 9: 5JJVDlaiMnB004o/RqbZZQ folded before Flop (didn't bet)



PokerStars Game #59939022198:  Hold'em No Limit ($0.25/$0.50) - 2009/07/01 0:29:22 ET
Table 'c/CRn+68J3Y8KxD5g1ek2Q' 2-max Seat #2 is the button
Seat 1: 46qCyJ6evTkHo9al5sBMNA ($258.50 in chips)
Seat 2: BypVLsYQt3ePFm2xQL/dOA ($120.80 in chips)
BypVLsYQt3ePFm2xQL/dOA: posts small blind $0.25
46qCyJ6evTkHo9al5sBMNA: posts big blind $0.50
*** HOLE CARDS ***
BypVLsYQt3ePFm2xQL/dOA: raises $0.50 to $1
46qCyJ6evTkHo9al5sBMNA: folds
BypVLsYQt3ePFm2xQL/dOA collected $1 from pot
BypVLsYQt3ePFm2xQL/dOA: doesn't show hand
*** SUMMARY ***
Total pot $1 | Rake $0
Seat 1: 46qCyJ6evTkHo9al5sBMNA (big blind) folded before Flop
Seat 2: BypVLsYQt3ePFm2xQL/dOA (button) (small blind) collected ($1)



PokerStars Game #59939024142:  Hold'em No Limit ($0.25/$0.50) - 2009/07/01 0:29:25 ET
Table '+dXkOAQyS8j9PQZusUTMpg' 2-max Seat #1 is the button
Seat 1: XFa6sBGjP2gxoIvxR3fZIg ($58.65 in chips)
Seat 2: 5IBeOgaApY1Bvzv2P8X4EA ($85.50 in chips)
XFa6sBGjP2gxoIvxR3fZIg: posts small blind $0.25
5IBeOgaApY1Bvzv2P8X4EA: posts big blind $0.50
*** HOLE CARDS ***
XFa6sBGjP2gxoIvxR3fZIg: folds
5IBeOgaApY1Bvzv2P8X4EA collected $0.50 from pot
5IBeOgaApY1Bvzv2P8X4EA: doesn't show hand
*** SUMMARY ***
Total pot $0.50 | Rake $0
Seat 1: XFa6sBGjP2gxoIvxR3fZIg (button) (small blind) folded before Flop
Seat 2: 5IBeOgaApY1Bvzv2P8X4EA (big blind) collected ($0.50)



PokerStars Game #59939024610:  Hold'em No Limit ($0.25/$0.50) - 2009/07/01 0:29:26 ET
Table 'IeNZOZQ4T6oiaHqFeo6yIA' 2-max Seat #1 is the button
Seat 1: ndd1nfncBkWNitBnsfCoVQ ($80.65 in chips)
Seat 2: A91IUl5JaZROhtfCtnnwYw ($51.95 in chips)
ndd1nfncBkWNitBnsfCoVQ: posts small blind $0.25
A91IUl5JaZROhtfCtnnwYw: posts big blind $0.50
*** HOLE CARDS ***
ndd1nfncBkWNitBnsfCoVQ: raises $1 to $1.50
A91IUl5JaZROhtfCtnnwYw: calls $1
*** FLOP *** [3h Jd 7c]
A91IUl5JaZROhtfCtnnwYw: checks
ndd1nfncBkWNitBnsfCoVQ: bets $2.50
A91IUl5JaZROhtfCtnnwYw: calls $2.50
*** TURN *** [3h Jd 7c] [Ah]
A91IUl5JaZROhtfCtnnwYw: checks
ndd1nfncBkWNitBnsfCoVQ: bets $7
A91IUl5JaZROhtfCtnnwYw: calls $7
*** RIVER *** [3h Jd 7c Ah] [Jh]
A91IUl5JaZROhtfCtnnwYw: checks
ndd1nfncBkWNitBnsfCoVQ: checks
*** SHOW DOWN ***
A91IUl5JaZROhtfCtnnwYw: shows [Tc Kh] (a pair of Jacks)
ndd1nfncBkWNitBnsfCoVQ: shows [3c 7d] (two pair, Jacks and Sevens)
ndd1nfncBkWNitBnsfCoVQ collected $21.50 from pot
*** SUMMARY ***
Total pot $22 | Rake $0.50
Board [3h Jd 7c Ah Jh]
Seat 1: ndd1nfncBkWNitBnsfCoVQ (button) (small blind) showed [3c 7d] and won ($21.50) with two pair, Jacks and Sevens
Seat 2: A91IUl5JaZROhtfCtnnwYw (big blind) showed [Tc Kh] and lost with a pair of Jacks



PokerStars Game #59939024630:  Hold'em No Limit ($0.25/$0.50) - 2009/07/01 0:29:26 ET
Table '5EmHi+fnatGQQShcNmzOZQ' 6-max Seat #2 is the button
Seat 1: SwPczQo3cOtwEzhJrfO2cQ ($23.95 in chips)
Seat 2: vXIHnZ+dv/hwSBxyvGw7bQ ($50 in chips)
Seat 3: L9qfLYXrczhAPd/VckgsWw ($60.85 in chips)
Seat 4: wOyVV9M/oyiw3YaOjNZ05w ($52.55 in chips)
Seat 5: kxPhs4ePFqMy52CInAJ2aw ($61.85 in chips)
Seat 6: 686aeHikcJlgKkSuIFdcXQ ($141.40 in chips)
L9qfLYXrczhAPd/VckgsWw: posts small blind $0.25
wOyVV9M/oyiw3YaOjNZ05w: posts big blind $0.50
*** HOLE CARDS ***
kxPhs4ePFqMy52CInAJ2aw: folds
686aeHikcJlgKkSuIFdcXQ: folds
SwPczQo3cOtwEzhJrfO2cQ: folds
vXIHnZ+dv/hwSBxyvGw7bQ: raises $1 to $1.50
L9qfLYXrczhAPd/VckgsWw: calls $1.25
wOyVV9M/oyiw3YaOjNZ05w: folds
*** FLOP *** [7c 2c 3d]
L9qfLYXrczhAPd/VckgsWw: bets $1
vXIHnZ+dv/hwSBxyvGw7bQ: folds
L9qfLYXrczhAPd/VckgsWw collected $3.35 from pot
L9qfLYXrczhAPd/VckgsWw: doesn't show hand
*** SUMMARY ***
Total pot $3.50 | Rake $0.15
Board [7c 2c 3d]
Seat 1: SwPczQo3cOtwEzhJrfO2cQ folded before Flop (didn't bet)
Seat 2: vXIHnZ+dv/hwSBxyvGw7bQ (button) folded on the Flop
Seat 3: L9qfLYXrczhAPd/VckgsWw (small blind) collected ($3.35)
Seat 4: wOyVV9M/oyiw3YaOjNZ05w (big blind) folded before Flop
Seat 5: kxPhs4ePFqMy52CInAJ2aw folded before Flop (didn't bet)
Seat 6: 686aeHikcJlgKkSuIFdcXQ folded before Flop (didn't bet)



PokerStars Game #59939024770:  Hold'em No Limit ($0.25/$0.50) - 2009/07/01 0:29:26 ET
Table 'tyR5AZNKV8Aadbrnrnlg7g' 6-max Seat #1 is the button
Seat 1: R+KjpH/wSjDLhtIy9+edNA ($81 in chips)
Seat 2: 58zdeSBSuSFX/qZfhc7YmA ($34.75 in chips)
Seat 3: tdOvWynovql5imfooroLMg ($49.50 in chips)
Seat 4: Rt6KgtZ8YaJoTc3FPim00w ($83.50 in chips)
Seat 5: wOyVV9M/oyiw3YaOjNZ05w ($54.60 in chips)
Seat 6: ZKazl1hGaPiapDXincgi2Q ($29 in chips)
58zdeSBSuSFX/qZfhc7YmA: posts small blind $0.25
tdOvWynovql5imfooroLMg: posts big blind $0.50
*** HOLE CARDS ***
Rt6KgtZ8YaJoTc3FPim00w: folds
wOyVV9M/oyiw3YaOjNZ05w: raises $1.50 to $2
ZKazl1hGaPiapDXincgi2Q: folds
R+KjpH/wSjDLhtIy9+edNA: folds
58zdeSBSuSFX/qZfhc7YmA: folds
tdOvWynovql5imfooroLMg: folds
wOyVV9M/oyiw3YaOjNZ05w collected $1.25 from pot
wOyVV9M/oyiw3YaOjNZ05w: doesn't show hand
*** SUMMARY ***
Total pot $1.25 | Rake $0
Seat 1: R+KjpH/wSjDLhtIy9+edNA (button) folded before Flop (didn't bet)
Seat 2: 58zdeSBSuSFX/qZfhc7YmA (small blind) folded before Flop
Seat 3: tdOvWynovql5imfooroLMg (big blind) folded before Flop
Seat 4: Rt6KgtZ8YaJoTc3FPim00w folded before Flop (didn't bet)
Seat 5: wOyVV9M/oyiw3YaOjNZ05w collected ($1.25)
Seat 6: ZKazl1hGaPiapDXincgi2Q folded before Flop (didn't bet)



PokerStars Game #59939025114:  Hold'em No Limit ($0.25/$0.50) - 2009/07/01 0:29:27 ET
Table 'mTxf8gPLgffN3Iwfm7Icfg' 2-max Seat #2 is the button
Seat 1: Do9Rlu1R5u/AcRtMTl8SYg ($92.05 in chips)
Seat 2: EMc5LPgVaded4Qc77vm0fw ($67.55 in chips)
EMc5LPgVaded4Qc77vm0fw: posts small blind $0.25
Do9Rlu1R5u/AcRtMTl8SYg: posts big blind $0.50
*** HOLE CARDS ***
EMc5LPgVaded4Qc77vm0fw: folds
Do9Rlu1R5u/AcRtMTl8SYg collected $0.50 from pot
Do9Rlu1R5u/AcRtMTl8SYg: doesn't show hand
*** SUMMARY ***
Total pot $0.50 | Rake $0
Seat 1: Do9Rlu1R5u/AcRtMTl8SYg (big blind) collected ($0.50)
Seat 2: EMc5LPgVaded4Qc77vm0fw (button) (small blind) folded before Flop



PokerStars Game #59939025464:  Hold'em No Limit ($0.25/$0.50) - 2009/07/01 0:29:27 ET
Table 'Nz0Vr7WMHL2g5Uk7dDZjpw' 9-max Seat #9 is the button
Seat 2: XNMDwbXt/Q4jM99AXnbJDw ($50 in chips)
Seat 3: 4QTiNH5fteLgJjx/s6Hy6A ($17.90 in chips)
Seat 4: 5JJVDlaiMnB004o/RqbZZQ ($28.50 in chips)
Seat 5: WGW0DgjBUXs1ylURHG8vnQ ($15.90 in chips)
Seat 6: k1f0lS7tlMHCLGs0JT34Tg ($4 in chips)
Seat 7: KPLH0gELgFe2OuAnhJFI5w ($27 in chips)
Seat 8: HkZI6g4zl83TDTA7SRspmQ ($16.45 in chips)
Seat 9: Ak2W6V2TDVIQrvSAy4eD7Q ($26.25 in chips)
XNMDwbXt/Q4jM99AXnbJDw: posts small blind $0.25
4QTiNH5fteLgJjx/s6Hy6A: posts big blind $0.50
*** HOLE CARDS ***
5JJVDlaiMnB004o/RqbZZQ: folds
WGW0DgjBUXs1ylURHG8vnQ: folds
k1f0lS7tlMHCLGs0JT34Tg: calls $0.50
KPLH0gELgFe2OuAnhJFI5w: calls $0.50
HkZI6g4zl83TDTA7SRspmQ: folds
Ak2W6V2TDVIQrvSAy4eD7Q has timed out
Ak2W6V2TDVIQrvSAy4eD7Q: folds
Ak2W6V2TDVIQrvSAy4eD7Q is sitting out
XNMDwbXt/Q4jM99AXnbJDw: folds
4QTiNH5fteLgJjx/s6Hy6A: raises $2 to $2.50
k1f0lS7tlMHCLGs0JT34Tg: raises $1.50 to $4 and is all-in
KPLH0gELgFe2OuAnhJFI5w: folds
4QTiNH5fteLgJjx/s6Hy6A: calls $1.50
*** FLOP *** [3d 8s 3s]
*** TURN *** [3d 8s 3s] [Qs]
*** RIVER *** [3d 8s 3s Qs] [2c]
*** SHOW DOWN ***
4QTiNH5fteLgJjx/s6Hy6A: shows [Kd 7d] (a pair of Threes)
k1f0lS7tlMHCLGs0JT34Tg: shows [Ks Tc] (a pair of Threes - King+Queen+Ten kicker)
k1f0lS7tlMHCLGs0JT34Tg collected $8.35 from pot
*** SUMMARY ***
Total pot $8.75 | Rake $0.40
Board [3d 8s 3s Qs 2c]
Seat 2: XNMDwbXt/Q4jM99AXnbJDw (small blind) folded before Flop
Seat 3: 4QTiNH5fteLgJjx/s6Hy6A (big blind) showed [Kd 7d] and lost with a pair of Threes
Seat 4: 5JJVDlaiMnB004o/RqbZZQ folded before Flop (didn't bet)
Seat 5: WGW0DgjBUXs1ylURHG8vnQ folded before Flop (didn't bet)
Seat 6: k1f0lS7tlMHCLGs0JT34Tg showed [Ks Tc] and won ($8.35) with a pair of Threes
Seat 7: KPLH0gELgFe2OuAnhJFI5w folded before Flop
Seat 8: HkZI6g4zl83TDTA7SRspmQ folded before Flop (didn't bet)
Seat 9: Ak2W6V2TDVIQrvSAy4eD7Q (button) folded before Flop (didn't bet)



PokerStars Game #59939025912:  Hold'em No Limit ($0.25/$0.50) - 2009/07/01 0:29:28 ET
Table 'GfL/No5u5PoEnU39lP5pQg' 6-max Seat #2 is the button
Seat 1: 1WUCqNG+p+vfWRTXNu4ljw ($50 in chips)
Seat 2: uVwggSetzp7d+eVgowO3vg ($57.80 in chips)
Seat 3: NbUTppWfym/RxV/DmDz2Sw ($18.60 in chips)
Seat 4: x+pzUFJsMIiGd7a5pcR4tg ($50 in chips)
Seat 5: crjGpJEzSZgD38FoE3VMGg ($54.85 in chips)
NbUTppWfym/RxV/DmDz2Sw: posts small blind $0.25
x+pzUFJsMIiGd7a5pcR4tg: posts big blind $0.50
*** HOLE CARDS ***
crjGpJEzSZgD38FoE3VMGg: folds
1WUCqNG+p+vfWRTXNu4ljw: raises $1.50 to $2
uVwggSetzp7d+eVgowO3vg: folds
NbUTppWfym/RxV/DmDz2Sw: calls $1.75
x+pzUFJsMIiGd7a5pcR4tg: folds
*** FLOP *** [3h Jd Qs]
NbUTppWfym/RxV/DmDz2Sw: checks
1WUCqNG+p+vfWRTXNu4ljw: checks
*** TURN *** [3h Jd Qs] [9d]
NbUTppWfym/RxV/DmDz2Sw: checks
3wylWYGeXFXcrE4XVrlPng has returned
1WUCqNG+p+vfWRTXNu4ljw: bets $2.50
NbUTppWfym/RxV/DmDz2Sw: folds
1WUCqNG+p+vfWRTXNu4ljw collected $4.30 from pot
*** SUMMARY ***
Total pot $4.50 | Rake $0.20
Board [3h Jd Qs 9d]
Seat 1: 1WUCqNG+p+vfWRTXNu4ljw collected ($4.30)
Seat 2: uVwggSetzp7d+eVgowO3vg (button) folded before Flop (didn't bet)
Seat 3: NbUTppWfym/RxV/DmDz2Sw (small blind) folded on the Turn
Seat 4: x+pzUFJsMIiGd7a5pcR4tg (big blind) folded before Flop
Seat 5: crjGpJEzSZgD38FoE3VMGg folded before Flop (didn't bet)



PokerStars Game #59939027020:  Hold'em No Limit ($0.25/$0.50) - 2009/07/01 0:29:29 ET
Table 'fx6MqwfYAj/Rt86hBz2L3Q' 9-max Seat #6 is the button
Seat 1: jf2c/o9gI7Xj0GleCSMj9g ($52.65 in chips)
Seat 2: C3rGXblctNcWI6JYPHhaEg ($8.65 in chips)
Seat 3: iadBi5AEt7gTBXbDSSnMYQ ($48.45 in chips)
Seat 4: gPEN9Zp33YTm/mu9/SYP1w ($23.20 in chips)
Seat 5: iAISe3dVeua8PUn2wwgDHw ($27.40 in chips)
Seat 6: 5k9fvXD9suIgCxU4HLQjTw ($50 in chips)
Seat 7: bkXkL3pmapikPQQRNPZSEA ($16.40 in chips)
Seat 8: CAuekkxPVzBL9SK4Tjjbuw ($30 in chips)
Seat 9: HZkVla4kK2SI42CVrPZ/ig ($9.25 in chips)
bkXkL3pmapikPQQRNPZSEA: posts small blind $0.25
CAuekkxPVzBL9SK4Tjjbuw: posts big blind $0.50
*** HOLE CARDS ***
HZkVla4kK2SI42CVrPZ/ig: folds
jf2c/o9gI7Xj0GleCSMj9g: calls $0.50
C3rGXblctNcWI6JYPHhaEg: raises $1.15 to $1.65
iadBi5AEt7gTBXbDSSnMYQ: calls $1.65
gPEN9Zp33YTm/mu9/SYP1w: folds
iAISe3dVeua8PUn2wwgDHw: calls $1.65
5k9fvXD9suIgCxU4HLQjTw: folds
bkXkL3pmapikPQQRNPZSEA: folds
CAuekkxPVzBL9SK4Tjjbuw: folds
jf2c/o9gI7Xj0GleCSMj9g: calls $1.15
*** FLOP *** [3c 7h 8c]
jf2c/o9gI7Xj0GleCSMj9g: checks
C3rGXblctNcWI6JYPHhaEg: bets $1.50
iadBi5AEt7gTBXbDSSnMYQ: folds
iAISe3dVeua8PUn2wwgDHw: raises $1.50 to $3
jf2c/o9gI7Xj0GleCSMj9g: folds
C3rGXblctNcWI6JYPHhaEg: calls $1.50
*** TURN *** [3c 7h 8c] [Tc]
C3rGXblctNcWI6JYPHhaEg: checks
iAISe3dVeua8PUn2wwgDHw: checks
*** RIVER *** [3c 7h 8c Tc] [6d]
C3rGXblctNcWI6JYPHhaEg: bets $4 and is all-in
iAISe3dVeua8PUn2wwgDHw: calls $4
*** SHOW DOWN ***
C3rGXblctNcWI6JYPHhaEg: shows [Ac Jc] (a flush, Ace high)
iAISe3dVeua8PUn2wwgDHw: mucks hand
C3rGXblctNcWI6JYPHhaEg collected $20.35 from pot
*** SUMMARY ***
Total pot $21.35 | Rake $1
Board [3c 7h 8c Tc 6d]
Seat 1: jf2c/o9gI7Xj0GleCSMj9g folded on the Flop
Seat 2: C3rGXblctNcWI6JYPHhaEg showed [Ac Jc] and won ($20.35) with a flush, Ace high
Seat 3: iadBi5AEt7gTBXbDSSnMYQ folded on the Flop
Seat 4: gPEN9Zp33YTm/mu9/SYP1w folded before Flop (didn't bet)
Seat 5: iAISe3dVeua8PUn2wwgDHw mucked
Seat 6: 5k9fvXD9suIgCxU4HLQjTw (button) folded before Flop (didn't bet)
Seat 7: bkXkL3pmapikPQQRNPZSEA (small blind) folded before Flop
Seat 8: CAuekkxPVzBL9SK4Tjjbuw (big blind) folded before Flop
Seat 9: HZkVla4kK2SI42CVrPZ/ig folded before Flop (didn't bet)



PokerStars Game #59939027606:  Hold'em No Limit ($0.25/$0.50) - 2009/07/01 0:29:30 ET
Table 'c/CRn+68J3Y8KxD5g1ek2Q' 2-max Seat #1 is the button
Seat 1: 46qCyJ6evTkHo9al5sBMNA ($258 in chips)
Seat 2: BypVLsYQt3ePFm2xQL/dOA ($121.30 in chips)
46qCyJ6evTkHo9al5sBMNA: posts small blind $0.25
BypVLsYQt3ePFm2xQL/dOA: posts big blind $0.50
*** HOLE CARDS ***
46qCyJ6evTkHo9al5sBMNA: raises $1 to $1.50
BypVLsYQt3ePFm2xQL/dOA: calls $1
*** FLOP *** [4s Qc Qh]
BypVLsYQt3ePFm2xQL/dOA: checks
46qCyJ6evTkHo9al5sBMNA: checks
*** TURN *** [4s Qc Qh] [2s]
BypVLsYQt3ePFm2xQL/dOA: bets $2.50
46qCyJ6evTkHo9al5sBMNA: folds
BypVLsYQt3ePFm2xQL/dOA collected $2.85 from pot
BypVLsYQt3ePFm2xQL/dOA: doesn't show hand
*** SUMMARY ***
Total pot $3 | Rake $0.15
Board [4s Qc Qh 2s]
Seat 1: 46qCyJ6evTkHo9al5sBMNA (button) (small blind) folded on the Turn
Seat 2: BypVLsYQt3ePFm2xQL/dOA (big blind) collected ($2.85)



PokerStars Game #59939029046:  Hold'em No Limit ($0.25/$0.50) - 2009/07/01 0:29:32 ET
Table '+dXkOAQyS8j9PQZusUTMpg' 2-max Seat #2 is the button
Seat 1: XFa6sBGjP2gxoIvxR3fZIg ($58.40 in chips)
Seat 2: 5IBeOgaApY1Bvzv2P8X4EA ($85.75 in chips)
5IBeOgaApY1Bvzv2P8X4EA: posts small blind $0.25
XFa6sBGjP2gxoIvxR3fZIg: posts big blind $0.50
*** HOLE CARDS ***
5IBeOgaApY1Bvzv2P8X4EA: folds
XFa6sBGjP2gxoIvxR3fZIg collected $0.50 from pot
*** SUMMARY ***
Total pot $0.50 | Rake $0
Seat 1: XFa6sBGjP2gxoIvxR3fZIg (big blind) collected ($0.50)
Seat 2: 5IBeOgaApY1Bvzv2P8X4EA (button) (small blind) folded before Flop



PokerStars Game #59939029126:  Hold'em No Limit ($0.25/$0.50) - 2009/07/01 0:29:33 ET
Table 'mTxf8gPLgffN3Iwfm7Icfg' 2-max Seat #1 is the button
Seat 1: Do9Rlu1R5u/AcRtMTl8SYg ($92.30 in chips)
Seat 2: EMc5LPgVaded4Qc77vm0fw ($67.30 in chips)
Do9Rlu1R5u/AcRtMTl8SYg: posts small blind $0.25
EMc5LPgVaded4Qc77vm0fw: posts big blind $0.50
*** HOLE CARDS ***
Do9Rlu1R5u/AcRtMTl8SYg: folds
EMc5LPgVaded4Qc77vm0fw collected $0.50 from pot
EMc5LPgVaded4Qc77vm0fw: doesn't show hand
*** SUMMARY ***
Total pot $0.50 | Rake $0
Seat 1: Do9Rlu1R5u/AcRtMTl8SYg (button) (small blind) folded before Flop
Seat 2: EMc5LPgVaded4Qc77vm0fw (big blind) collected ($0.50)



PokerStars Game #59939029748:  Hold'em No Limit ($0.25/$0.50) - 2009/07/01 0:29:33 ET
Table 'EiNh8p/wGJ1FP575iMFnqg' 9-max Seat #5 is the button
Seat 1: r3ZqM1Mi0W3y4hOdssE+Sg ($50 in chips)
Seat 3: ymLPoEIl7UL3TvZYmnadxQ ($49.50 in chips)
Seat 4: HIIPkpiaCQfs5HcPKjlHvg ($39.95 in chips)
Seat 5: M+7+BTmX5vZatHVuoRB1nA ($77.40 in chips)
Seat 6: 3UmXLy3GfjC3EkOebduerQ ($56.65 in chips)
Seat 7: Wj7mKnRFR90j40wWUu2+Og ($80.55 in chips)
Seat 8: KrPAGRACBg+w0M//SXe8Ag ($11.30 in chips)
Seat 9: OMwFJ4pF0xk2Ru/AJiFeFw ($69.90 in chips)
3UmXLy3GfjC3EkOebduerQ: posts small blind $0.25
Wj7mKnRFR90j40wWUu2+Og: posts big blind $0.50
8ehL7qlZzjgUh2H35iiWLw: sits out
*** HOLE CARDS ***
KrPAGRACBg+w0M//SXe8Ag: calls $0.50
OMwFJ4pF0xk2Ru/AJiFeFw: folds
r3ZqM1Mi0W3y4hOdssE+Sg: calls $0.50
ymLPoEIl7UL3TvZYmnadxQ: folds
HIIPkpiaCQfs5HcPKjlHvg: raises $1.50 to $2
M+7+BTmX5vZatHVuoRB1nA: raises $5.50 to $7.50
3UmXLy3GfjC3EkOebduerQ: folds
Wj7mKnRFR90j40wWUu2+Og: folds
KrPAGRACBg+w0M//SXe8Ag: folds
r3ZqM1Mi0W3y4hOdssE+Sg: folds
HIIPkpiaCQfs5HcPKjlHvg: calls $5.50
*** FLOP *** [Qs 4c Qd]
HIIPkpiaCQfs5HcPKjlHvg: checks
M+7+BTmX5vZatHVuoRB1nA: bets $11.50
HIIPkpiaCQfs5HcPKjlHvg: folds
M+7+BTmX5vZatHVuoRB1nA collected $15.95 from pot
M+7+BTmX5vZatHVuoRB1nA: doesn't show hand
*** SUMMARY ***
Total pot $16.75 | Rake $0.80
Board [Qs 4c Qd]
Seat 1: r3ZqM1Mi0W3y4hOdssE+Sg folded before Flop
Seat 3: ymLPoEIl7UL3TvZYmnadxQ folded before Flop (didn't bet)
Seat 4: HIIPkpiaCQfs5HcPKjlHvg folded on the Flop
Seat 5: M+7+BTmX5vZatHVuoRB1nA (button) collected ($15.95)
Seat 6: 3UmXLy3GfjC3EkOebduerQ (small blind) folded before Flop
Seat 7: Wj7mKnRFR90j40wWUu2+Og (big blind) folded before Flop
Seat 8: KrPAGRACBg+w0M//SXe8Ag folded before Flop
Seat 9: OMwFJ4pF0xk2Ru/AJiFeFw folded before Flop (didn't bet)



PokerStars Game #59939033640:  Hold'em No Limit ($0.25/$0.50) - 2009/07/01 0:29:39 ET
Table 'mTxf8gPLgffN3Iwfm7Icfg' 2-max Seat #2 is the button
Seat 1: Do9Rlu1R5u/AcRtMTl8SYg ($92.05 in chips)
Seat 2: EMc5LPgVaded4Qc77vm0fw ($67.55 in chips)
EMc5LPgVaded4Qc77vm0fw: posts small blind $0.25
Do9Rlu1R5u/AcRtMTl8SYg: posts big blind $0.50
*** HOLE CARDS ***
EMc5LPgVaded4Qc77vm0fw: folds
Do9Rlu1R5u/AcRtMTl8SYg collected $0.50 from pot
Do9Rlu1R5u/AcRtMTl8SYg: doesn't show hand
*** SUMMARY ***
Total pot $0.50 | Rake $0
Seat 1: Do9Rlu1R5u/AcRtMTl8SYg (big blind) collected ($0.50)
Seat 2: EMc5LPgVaded4Qc77vm0fw (button) (small blind) folded before Flop



PokerStars Game #59939034364:  Hold'em No Limit ($0.25/$0.50) - 2009/07/01 0:29:40 ET
Table '+dXkOAQyS8j9PQZusUTMpg' 2-max Seat #1 is the button
Seat 1: XFa6sBGjP2gxoIvxR3fZIg ($58.65 in chips)
Seat 2: 5IBeOgaApY1Bvzv2P8X4EA ($85.50 in chips)
XFa6sBGjP2gxoIvxR3fZIg: posts small blind $0.25
5IBeOgaApY1Bvzv2P8X4EA: posts big blind $0.50
*** HOLE CARDS ***
XFa6sBGjP2gxoIvxR3fZIg: raises $1 to $1.50
5IBeOgaApY1Bvzv2P8X4EA: folds
XFa6sBGjP2gxoIvxR3fZIg collected $1 from pot
*** SUMMARY ***
Total pot $1 | Rake $0
Seat 1: XFa6sBGjP2gxoIvxR3fZIg (button) (small blind) collected ($1)
Seat 2: 5IBeOgaApY1Bvzv2P8X4EA (big blind) folded before Flop



PokerStars Game #59939034630:  Hold'em No Limit ($0.25/$0.50) - 2009/07/01 0:29:41 ET
Table 'T/PgNWqVyY6lkldcBVXYJQ' 6-max Seat #5 is the button
Seat 1: +Pf9jTVizYlIo+woPvptfA ($56.60 in chips)
Seat 2: oZAeY5rVqNGgt8yyQ0pxbA ($38.05 in chips)
Seat 3: L3OcNO1bgdqDI46j67KQPQ ($54.60 in chips)
Seat 4: jxMvxeUUL9UU0V6wVU+Iyw ($9.20 in chips)
Seat 5: vVQBckETtigfb5mAcyK0OA ($41.30 in chips)
Seat 6: cDzbog6kwmJp+LBeBq+iMQ ($55.75 in chips)
cDzbog6kwmJp+LBeBq+iMQ: posts small blind $0.25
+Pf9jTVizYlIo+woPvptfA: posts big blind $0.50
*** HOLE CARDS ***
oZAeY5rVqNGgt8yyQ0pxbA: folds
L3OcNO1bgdqDI46j67KQPQ: folds
jxMvxeUUL9UU0V6wVU+Iyw: folds
vVQBckETtigfb5mAcyK0OA: folds
cDzbog6kwmJp+LBeBq+iMQ: calls $0.25
+Pf9jTVizYlIo+woPvptfA: checks
*** FLOP *** [6h 2d 4s]
cDzbog6kwmJp+LBeBq+iMQ: checks
+Pf9jTVizYlIo+woPvptfA: checks
*** TURN *** [6h 2d 4s] [9d]
cDzbog6kwmJp+LBeBq+iMQ: checks
vVQBckETtigfb5mAcyK0OA said, "f.u.c.k. it no more of this 1.00$ raise s.h.i.t"
+Pf9jTVizYlIo+woPvptfA: checks
*** RIVER *** [6h 2d 4s 9d] [9s]
cDzbog6kwmJp+LBeBq+iMQ: checks
+Pf9jTVizYlIo+woPvptfA: checks
*** SHOW DOWN ***
cDzbog6kwmJp+LBeBq+iMQ: shows [Tc 8c] (a pair of Nines)
+Pf9jTVizYlIo+woPvptfA: shows [6d Qs] (two pair, Nines and Sixes)
+Pf9jTVizYlIo+woPvptfA collected $0.95 from pot
*** SUMMARY ***
Total pot $1 | Rake $0.05
Board [6h 2d 4s 9d 9s]
Seat 1: +Pf9jTVizYlIo+woPvptfA (big blind) showed [6d Qs] and won ($0.95) with two pair, Nines and Sixes
Seat 2: oZAeY5rVqNGgt8yyQ0pxbA folded before Flop (didn't bet)
Seat 3: L3OcNO1bgdqDI46j67KQPQ folded before Flop (didn't bet)
Seat 4: jxMvxeUUL9UU0V6wVU+Iyw folded before Flop (didn't bet)
Seat 5: vVQBckETtigfb5mAcyK0OA (button) folded before Flop (didn't bet)
Seat 6: cDzbog6kwmJp+LBeBq+iMQ (small blind) showed [Tc 8c] and lost with a pair of Nines



PokerStars Game #59939035178:  Hold'em No Limit ($0.25/$0.50) - 2009/07/01 0:29:42 ET
Table '/cQuAT3ef4t+PGrXiNhGaQ' 9-max Seat #4 is the button
Seat 2: jXGruyaMqirTaTXNOvBdew ($71.40 in chips)
Seat 3: g4k0NXISyLCqaSWZDBjfEg ($53.90 in chips)
Seat 4: OWP/DOu+PlPK6ZZ3zYa0HA ($41.65 in chips)
Seat 5: 5SgaHdWixdClWvaEG+KUjQ ($21.20 in chips)
Seat 6: APYIOyK/4AGb+kIwlOUNBQ ($47.25 in chips)
Seat 7: J0W5D97jl5VLky+IoPvDeA ($111.80 in chips)
Seat 8: W3ingbA178eb7J5rt1PuIQ ($22.65 in chips)
Seat 9: E2518gp4aFz1+kAgmGqeEg ($14.65 in chips)
5SgaHdWixdClWvaEG+KUjQ: posts small blind $0.25
APYIOyK/4AGb+kIwlOUNBQ: posts big blind $0.50
*** HOLE CARDS ***
mMPPugoX87YtMYMtcxQcoA leaves the table
J0W5D97jl5VLky+IoPvDeA: raises $1.50 to $2
W3ingbA178eb7J5rt1PuIQ: folds
HZkVla4kK2SI42CVrPZ/ig joins the table at seat #1
E2518gp4aFz1+kAgmGqeEg: folds
jXGruyaMqirTaTXNOvBdew: folds
g4k0NXISyLCqaSWZDBjfEg: folds
OWP/DOu+PlPK6ZZ3zYa0HA: folds
5SgaHdWixdClWvaEG+KUjQ: folds
APYIOyK/4AGb+kIwlOUNBQ: calls $1.50
*** FLOP *** [Th Kd 8s]
APYIOyK/4AGb+kIwlOUNBQ: checks
J0W5D97jl5VLky+IoPvDeA: bets $2
APYIOyK/4AGb+kIwlOUNBQ: calls $2
*** TURN *** [Th Kd 8s] [7c]
APYIOyK/4AGb+kIwlOUNBQ: checks
J0W5D97jl5VLky+IoPvDeA: checks
*** RIVER *** [Th Kd 8s 7c] [2d]
APYIOyK/4AGb+kIwlOUNBQ: checks
J0W5D97jl5VLky+IoPvDeA: checks
*** SHOW DOWN ***
APYIOyK/4AGb+kIwlOUNBQ: shows [8h Ah] (a pair of Eights)
J0W5D97jl5VLky+IoPvDeA: shows [Qc Qs] (a pair of Queens)
J0W5D97jl5VLky+IoPvDeA collected $7.85 from pot
*** SUMMARY ***
Total pot $8.25 | Rake $0.40
Board [Th Kd 8s 7c 2d]
Seat 2: jXGruyaMqirTaTXNOvBdew folded before Flop (didn't bet)
Seat 3: g4k0NXISyLCqaSWZDBjfEg folded before Flop (didn't bet)
Seat 4: OWP/DOu+PlPK6ZZ3zYa0HA (button) folded before Flop (didn't bet)
Seat 5: 5SgaHdWixdClWvaEG+KUjQ (small blind) folded before Flop
Seat 6: APYIOyK/4AGb+kIwlOUNBQ (big blind) showed [8h Ah] and lost with a pair of Eights
Seat 7: J0W5D97jl5VLky+IoPvDeA showed [Qc Qs] and won ($7.85) with a pair of Queens
Seat 8: W3ingbA178eb7J5rt1PuIQ folded before Flop (didn't bet)
Seat 9: E2518gp4aFz1+kAgmGqeEg folded before Flop (didn't bet)



PokerStars Game #59939036230:  Hold'em No Limit ($0.25/$0.50) - 2009/07/01 0:29:43 ET
Table 'otvGDROEDdqsabxskT79qg' 9-max Seat #4 is the button
Seat 1: 8ehL7qlZzjgUh2H35iiWLw ($52.30 in chips)
Seat 2: cCjTzH9jio8607WzjcfXlg ($9.30 in chips)
Seat 3: +k7T5ocke8UwavtgUHm+Cg ($74.65 in chips)
Seat 4: MG90wfSJZnOejs/KD3vlQQ ($53.60 in chips)
Seat 5: XNMDwbXt/Q4jM99AXnbJDw ($53.95 in chips)
Seat 6: bxLSulbgr8LmKNjOzw8URg ($50 in chips)
Seat 7: C7+tBppJrKgd/r+tuKUIpA ($40.15 in chips)
Seat 9: KcY3X8YpD74Kw1RHkx/g4A ($61.60 in chips)
XNMDwbXt/Q4jM99AXnbJDw: posts small blind $0.25
bxLSulbgr8LmKNjOzw8URg: posts big blind $0.50
zE9cVigS2nW/Ljy4K4bUQA: sits out
*** HOLE CARDS ***
C7+tBppJrKgd/r+tuKUIpA: calls $0.50
KcY3X8YpD74Kw1RHkx/g4A: calls $0.50
8ehL7qlZzjgUh2H35iiWLw: raises $2 to $2.50
cCjTzH9jio8607WzjcfXlg: folds
+k7T5ocke8UwavtgUHm+Cg: folds
MG90wfSJZnOejs/KD3vlQQ: folds
XNMDwbXt/Q4jM99AXnbJDw: folds
bxLSulbgr8LmKNjOzw8URg: folds
C7+tBppJrKgd/r+tuKUIpA: calls $2
KcY3X8YpD74Kw1RHkx/g4A: calls $2
*** FLOP *** [As Ts 6h]
C7+tBppJrKgd/r+tuKUIpA: checks
KcY3X8YpD74Kw1RHkx/g4A: checks
8ehL7qlZzjgUh2H35iiWLw: checks
*** TURN *** [As Ts 6h] [Ah]
C7+tBppJrKgd/r+tuKUIpA: checks
KcY3X8YpD74Kw1RHkx/g4A: checks
8ehL7qlZzjgUh2H35iiWLw: bets $5
C7+tBppJrKgd/r+tuKUIpA: folds
KcY3X8YpD74Kw1RHkx/g4A: raises $5 to $10
8ehL7qlZzjgUh2H35iiWLw: folds
KcY3X8YpD74Kw1RHkx/g4A collected $17.40 from pot
*** SUMMARY ***
Total pot $18.25 | Rake $0.85
Board [As Ts 6h Ah]
Seat 1: 8ehL7qlZzjgUh2H35iiWLw folded on the Turn
Seat 2: cCjTzH9jio8607WzjcfXlg folded before Flop (didn't bet)
Seat 3: +k7T5ocke8UwavtgUHm+Cg folded before Flop (didn't bet)
Seat 4: MG90wfSJZnOejs/KD3vlQQ (button) folded before Flop (didn't bet)
Seat 5: XNMDwbXt/Q4jM99AXnbJDw (small blind) folded before Flop
Seat 6: bxLSulbgr8LmKNjOzw8URg (big blind) folded before Flop
Seat 7: C7+tBppJrKgd/r+tuKUIpA folded on the Turn
Seat 9: KcY3X8YpD74Kw1RHkx/g4A collected ($17.40)



PokerStars Game #59939038962:  Hold'em No Limit ($0.25/$0.50) - 2009/07/01 0:29:47 ET
Table 'mTxf8gPLgffN3Iwfm7Icfg' 2-max Seat #1 is the button
Seat 1: Do9Rlu1R5u/AcRtMTl8SYg ($92.30 in chips)
Seat 2: EMc5LPgVaded4Qc77vm0fw ($67.30 in chips)
Do9Rlu1R5u/AcRtMTl8SYg: posts small blind $0.25
EMc5LPgVaded4Qc77vm0fw: posts big blind $0.50
*** HOLE CARDS ***
Do9Rlu1R5u/AcRtMTl8SYg: raises $1 to $1.50
EMc5LPgVaded4Qc77vm0fw: folds
Do9Rlu1R5u/AcRtMTl8SYg collected $1 from pot
Do9Rlu1R5u/AcRtMTl8SYg: doesn't show hand
*** SUMMARY ***
Total pot $1 | Rake $0
Seat 1: Do9Rlu1R5u/AcRtMTl8SYg (button) (small blind) collected ($1)
Seat 2: EMc5LPgVaded4Qc77vm0fw (big blind) folded before Flop



PokerStars Game #59939038620:  Hold'em No Limit ($0.25/$0.50) - 2009/07/01 0:29:47 ET
Table 'PALRfuH85dr5IkDfdv6new' 9-max Seat #9 is the button
Seat 1: SKnJuWHScqetA/qG5p+wCg ($30 in chips)
Seat 2: 9r7ZoBbAJj5IeyZ0q9BdzA ($6.85 in chips)
Seat 3: 50QWoELmpmHFrFIlWMJo9g ($87.45 in chips)
Seat 4: mZNMJI1mY40XTC0U7GZakA ($50.75 in chips)
Seat 5: jSSGUXdNFAZA3QCvTcUMQw ($43.45 in chips)
Seat 6: E2518gp4aFz1+kAgmGqeEg ($11 in chips)
Seat 7: 3NcyXvr39gnK+KbTq7ezyA ($39.25 in chips)
Seat 8: NkS+CseUKx4XHszWq0PXEQ ($44.65 in chips)
Seat 9: CIrAX/m6o7jYmKOAjJXv4Q ($36.45 in chips)
SKnJuWHScqetA/qG5p+wCg: posts small blind $0.25
9r7ZoBbAJj5IeyZ0q9BdzA: posts big blind $0.50
*** HOLE CARDS ***
50QWoELmpmHFrFIlWMJo9g: folds
mZNMJI1mY40XTC0U7GZakA: folds
jSSGUXdNFAZA3QCvTcUMQw: folds
E2518gp4aFz1+kAgmGqeEg: raises $1 to $1.50
3NcyXvr39gnK+KbTq7ezyA: folds
NkS+CseUKx4XHszWq0PXEQ: folds
CIrAX/m6o7jYmKOAjJXv4Q: folds
SKnJuWHScqetA/qG5p+wCg: folds
9r7ZoBbAJj5IeyZ0q9BdzA: folds
E2518gp4aFz1+kAgmGqeEg collected $1.25 from pot
E2518gp4aFz1+kAgmGqeEg: doesn't show hand
*** SUMMARY ***
Total pot $1.25 | Rake $0
Seat 1: SKnJuWHScqetA/qG5p+wCg (small blind) folded before Flop
Seat 2: 9r7ZoBbAJj5IeyZ0q9BdzA (big blind) folded before Flop
Seat 3: 50QWoELmpmHFrFIlWMJo9g folded before Flop (didn't bet)
Seat 4: mZNMJI1mY40XTC0U7GZakA folded before Flop (didn't bet)
Seat 5: jSSGUXdNFAZA3QCvTcUMQw folded before Flop (didn't bet)
Seat 6: E2518gp4aFz1+kAgmGqeEg collected ($1.25)
Seat 7: 3NcyXvr39gnK+KbTq7ezyA folded before Flop (didn't bet)
Seat 8: NkS+CseUKx4XHszWq0PXEQ folded before Flop (didn't bet)
Seat 9: CIrAX/m6o7jYmKOAjJXv4Q (button) folded before Flop (didn't bet)



PokerStars Game #59939039530:  Hold'em No Limit ($0.25/$0.50) - 2009/07/01 0:29:48 ET
Table 'tyR5AZNKV8Aadbrnrnlg7g' 6-max Seat #2 is the button
Seat 1: R+KjpH/wSjDLhtIy9+edNA ($81 in chips)
Seat 2: 58zdeSBSuSFX/qZfhc7YmA ($34.50 in chips)
Seat 3: tdOvWynovql5imfooroLMg ($49 in chips)
Seat 4: Rt6KgtZ8YaJoTc3FPim00w ($83.50 in chips)
Seat 5: wOyVV9M/oyiw3YaOjNZ05w ($55.35 in chips)
Seat 6: ZKazl1hGaPiapDXincgi2Q ($29 in chips)
tdOvWynovql5imfooroLMg: posts small blind $0.25
Rt6KgtZ8YaJoTc3FPim00w: posts big blind $0.50
*** HOLE CARDS ***
wOyVV9M/oyiw3YaOjNZ05w: folds
ZKazl1hGaPiapDXincgi2Q: calls $0.50
R+KjpH/wSjDLhtIy9+edNA: folds
58zdeSBSuSFX/qZfhc7YmA: folds
tdOvWynovql5imfooroLMg: folds
Rt6KgtZ8YaJoTc3FPim00w: checks
*** FLOP *** [Ts 9s Ac]
Rt6KgtZ8YaJoTc3FPim00w: checks
ZKazl1hGaPiapDXincgi2Q: checks
*** TURN *** [Ts 9s Ac] [8c]
Rt6KgtZ8YaJoTc3FPim00w: checks
ZKazl1hGaPiapDXincgi2Q: bets $1
Rt6KgtZ8YaJoTc3FPim00w: folds
ZKazl1hGaPiapDXincgi2Q collected $1.20 from pot
ZKazl1hGaPiapDXincgi2Q: doesn't show hand
*** SUMMARY ***
Total pot $1.25 | Rake $0.05
Board [Ts 9s Ac 8c]
Seat 1: R+KjpH/wSjDLhtIy9+edNA folded before Flop (didn't bet)
Seat 2: 58zdeSBSuSFX/qZfhc7YmA (button) folded before Flop (didn't bet)
Seat 3: tdOvWynovql5imfooroLMg (small blind) folded before Flop
Seat 4: Rt6KgtZ8YaJoTc3FPim00w (big blind) folded on the Turn
Seat 5: wOyVV9M/oyiw3YaOjNZ05w folded before Flop (didn't bet)
Seat 6: ZKazl1hGaPiapDXincgi2Q collected ($1.20)



PokerStars Game #59939040122:  Hold'em No Limit ($0.25/$0.50) - 2009/07/01 0:29:49 ET
Table '+dXkOAQyS8j9PQZusUTMpg' 2-max Seat #2 is the button
Seat 1: XFa6sBGjP2gxoIvxR3fZIg ($59.15 in chips)
Seat 2: 5IBeOgaApY1Bvzv2P8X4EA ($85 in chips)
5IBeOgaApY1Bvzv2P8X4EA: posts small blind $0.25
XFa6sBGjP2gxoIvxR3fZIg: posts big blind $0.50
*** HOLE CARDS ***
5IBeOgaApY1Bvzv2P8X4EA: raises $1 to $1.50
XFa6sBGjP2gxoIvxR3fZIg: folds
5IBeOgaApY1Bvzv2P8X4EA collected $1 from pot
5IBeOgaApY1Bvzv2P8X4EA: doesn't show hand
*** SUMMARY ***
Total pot $1 | Rake $0
Seat 1: XFa6sBGjP2gxoIvxR3fZIg (big blind) folded before Flop
Seat 2: 5IBeOgaApY1Bvzv2P8X4EA (button) (small blind) collected ($1)



PokerStars Game #59939041536:  Hold'em No Limit ($0.25/$0.50) - 2009/07/01 0:29:51 ET
Table 'c/CRn+68J3Y8KxD5g1ek2Q' 2-max Seat #2 is the button
Seat 1: 46qCyJ6evTkHo9al5sBMNA ($256.50 in chips)
Seat 2: BypVLsYQt3ePFm2xQL/dOA ($122.65 in chips)
BypVLsYQt3ePFm2xQL/dOA: posts small blind $0.25
46qCyJ6evTkHo9al5sBMNA: posts big blind $0.50
*** HOLE CARDS ***
BypVLsYQt3ePFm2xQL/dOA: raises $1 to $1.50
46qCyJ6evTkHo9al5sBMNA: folds
BypVLsYQt3ePFm2xQL/dOA collected $1 from pot
BypVLsYQt3ePFm2xQL/dOA: doesn't show hand
*** SUMMARY ***
Total pot $1 | Rake $0
Seat 1: 46qCyJ6evTkHo9al5sBMNA (big blind) folded before Flop
Seat 2: BypVLsYQt3ePFm2xQL/dOA (button) (small blind) collected ($1)



PokerStars Game #59939041656:  Hold'em No Limit ($0.25/$0.50) - 2009/07/01 0:29:51 ET
Table '+z1aekfHkpp09pc8F9aViw' 6-max Seat #3 is the button
Seat 1: wOyVV9M/oyiw3YaOjNZ05w ($52.55 in chips)
Seat 2: M6xK/VklCvdyyrmvzATlxQ ($38.30 in chips)
Seat 3: uUznlIMFnRUvwrBhYF73KA ($67.60 in chips)
Seat 4: RowCSpSURHTOL/dcjg/Iug ($33.70 in chips)
Seat 5: crjGpJEzSZgD38FoE3VMGg ($59.15 in chips)
Seat 6: 686aeHikcJlgKkSuIFdcXQ ($70.10 in chips)
RowCSpSURHTOL/dcjg/Iug: posts small blind $0.25
crjGpJEzSZgD38FoE3VMGg: posts big blind $0.50
*** HOLE CARDS ***
686aeHikcJlgKkSuIFdcXQ: folds
wOyVV9M/oyiw3YaOjNZ05w: folds
M6xK/VklCvdyyrmvzATlxQ: folds
uUznlIMFnRUvwrBhYF73KA: calls $0.50
RowCSpSURHTOL/dcjg/Iug: calls $0.25
crjGpJEzSZgD38FoE3VMGg: checks
*** FLOP *** [8s Kh Jh]
RowCSpSURHTOL/dcjg/Iug: checks
crjGpJEzSZgD38FoE3VMGg: checks
uUznlIMFnRUvwrBhYF73KA: checks
*** TURN *** [8s Kh Jh] [Js]
RowCSpSURHTOL/dcjg/Iug: checks
crjGpJEzSZgD38FoE3VMGg: bets $1.50
uUznlIMFnRUvwrBhYF73KA: folds
RowCSpSURHTOL/dcjg/Iug: folds
crjGpJEzSZgD38FoE3VMGg collected $1.45 from pot
*** SUMMARY ***
Total pot $1.50 | Rake $0.05
Board [8s Kh Jh Js]
Seat 1: wOyVV9M/oyiw3YaOjNZ05w folded before Flop (didn't bet)
Seat 2: M6xK/VklCvdyyrmvzATlxQ folded before Flop (didn't bet)
Seat 3: uUznlIMFnRUvwrBhYF73KA (button) folded on the Turn
Seat 4: RowCSpSURHTOL/dcjg/Iug (small blind) folded on the Turn
Seat 5: crjGpJEzSZgD38FoE3VMGg (big blind) collected ($1.45)
Seat 6: 686aeHikcJlgKkSuIFdcXQ folded before Flop (didn't bet)



PokerStars Game #59939043560:  Hold'em No Limit ($0.25/$0.50) - 2009/07/01 0:29:54 ET
Table 'E7bWJ45aoFXRpyRv2gw+Ig' 2-max Seat #1 is the button
Seat 1: FRkiRasEGlHUeLrEl+k/nA ($51.80 in chips)
Seat 2: 3Wro85I7472vJ4Wkpneo9A ($125.05 in chips)
FRkiRasEGlHUeLrEl+k/nA: posts small blind $0.25
3Wro85I7472vJ4Wkpneo9A: posts big blind $0.50
*** HOLE CARDS ***
FRkiRasEGlHUeLrEl+k/nA: calls $0.25
3Wro85I7472vJ4Wkpneo9A: raises $1.50 to $2
FRkiRasEGlHUeLrEl+k/nA: calls $1.50
*** FLOP *** [Jd Kc Tc]
3Wro85I7472vJ4Wkpneo9A: bets $3
FRkiRasEGlHUeLrEl+k/nA: calls $3
*** TURN *** [Jd Kc Tc] [7h]
3Wro85I7472vJ4Wkpneo9A: bets $7
FRkiRasEGlHUeLrEl+k/nA: calls $7
*** RIVER *** [Jd Kc Tc 7h] [6s]
3Wro85I7472vJ4Wkpneo9A: bets $13.50
FRkiRasEGlHUeLrEl+k/nA: folds
3Wro85I7472vJ4Wkpneo9A collected $23.50 from pot
3Wro85I7472vJ4Wkpneo9A: doesn't show hand
*** SUMMARY ***
Total pot $24 | Rake $0.50
Board [Jd Kc Tc 7h 6s]
Seat 1: FRkiRasEGlHUeLrEl+k/nA (button) (small blind) folded on the River
Seat 2: 3Wro85I7472vJ4Wkpneo9A (big blind) collected ($23.50)



PokerStars Game #59939044710:  Hold'em No Limit ($0.25/$0.50) - 2009/07/01 0:29:56 ET
Table 'mTxf8gPLgffN3Iwfm7Icfg' 2-max Seat #2 is the button
Seat 1: Do9Rlu1R5u/AcRtMTl8SYg ($92.80 in chips)
Seat 2: EMc5LPgVaded4Qc77vm0fw ($66.80 in chips)
EMc5LPgVaded4Qc77vm0fw: posts small blind $0.25
Do9Rlu1R5u/AcRtMTl8SYg: posts big blind $0.50
*** HOLE CARDS ***
EMc5LPgVaded4Qc77vm0fw: folds
Do9Rlu1R5u/AcRtMTl8SYg collected $0.50 from pot
Do9Rlu1R5u/AcRtMTl8SYg: doesn't show hand
*** SUMMARY ***
Total pot $0.50 | Rake $0
Seat 1: Do9Rlu1R5u/AcRtMTl8SYg (big blind) collected ($0.50)
Seat 2: EMc5LPgVaded4Qc77vm0fw (button) (small blind) folded before Flop



PokerStars Game #59939046310:  Hold'em No Limit ($0.25/$0.50) - 2009/07/01 0:29:58 ET
Table 'kgbJRsxfv64KrErDRBAkcw' 6-max Seat #2 is the button
Seat 2: Q+thC23WCv1kJUJtH/+4Jw ($58.80 in chips)
Seat 3: T0Gx/FcQ5VH9u7XaOMX97A ($78.65 in chips)
Seat 4: qanMEqjABjWxC/JgQ/0l7w ($58.45 in chips)
Seat 5: +Pf9jTVizYlIo+woPvptfA ($50 in chips)
Seat 6: ozrlafxxh1HmYdA0/h+MuA ($14.75 in chips)
T0Gx/FcQ5VH9u7XaOMX97A: posts small blind $0.25
qanMEqjABjWxC/JgQ/0l7w: posts big blind $0.50
*** HOLE CARDS ***
N7O9jUEx2YiQn1+yRYTHmw leaves the table
+Pf9jTVizYlIo+woPvptfA: folds
ozrlafxxh1HmYdA0/h+MuA: calls $0.50
Q+thC23WCv1kJUJtH/+4Jw: folds
T0Gx/FcQ5VH9u7XaOMX97A: calls $0.25
qanMEqjABjWxC/JgQ/0l7w: checks
*** FLOP *** [8d 8s 5c]
T0Gx/FcQ5VH9u7XaOMX97A: checks
qanMEqjABjWxC/JgQ/0l7w: checks
ozrlafxxh1HmYdA0/h+MuA: checks
*** TURN *** [8d 8s 5c] [4c]
T0Gx/FcQ5VH9u7XaOMX97A: checks
qanMEqjABjWxC/JgQ/0l7w: checks
ozrlafxxh1HmYdA0/h+MuA: checks
*** RIVER *** [8d 8s 5c 4c] [Jc]
T0Gx/FcQ5VH9u7XaOMX97A: bets $1
mxTUARCsU8Eby0whmHNcOw joins the table at seat #1
qanMEqjABjWxC/JgQ/0l7w: folds
ozrlafxxh1HmYdA0/h+MuA: folds
T0Gx/FcQ5VH9u7XaOMX97A collected $1.45 from pot
T0Gx/FcQ5VH9u7XaOMX97A: doesn't show hand
*** SUMMARY ***
Total pot $1.50 | Rake $0.05
Board [8d 8s 5c 4c Jc]
Seat 2: Q+thC23WCv1kJUJtH/+4Jw (button) folded before Flop (didn't bet)
Seat 3: T0Gx/FcQ5VH9u7XaOMX97A (small blind) collected ($1.45)
Seat 4: qanMEqjABjWxC/JgQ/0l7w (big blind) folded on the River
Seat 5: +Pf9jTVizYlIo+woPvptfA folded before Flop (didn't bet)
Seat 6: ozrlafxxh1HmYdA0/h+MuA folded on the River



PokerStars Game #59939047544:  Hold'em No Limit ($0.25/$0.50) - 2009/07/01 0:30:00 ET
Table '5EmHi+fnatGQQShcNmzOZQ' 6-max Seat #3 is the button
Seat 1: SwPczQo3cOtwEzhJrfO2cQ ($23.95 in chips)
Seat 2: vXIHnZ+dv/hwSBxyvGw7bQ ($50 in chips)
Seat 3: L9qfLYXrczhAPd/VckgsWw ($62.70 in chips)
Seat 4: wOyVV9M/oyiw3YaOjNZ05w ($52.05 in chips)
Seat 5: kxPhs4ePFqMy52CInAJ2aw ($61.85 in chips)
Seat 6: 686aeHikcJlgKkSuIFdcXQ ($141.40 in chips)
wOyVV9M/oyiw3YaOjNZ05w: posts small blind $0.25
kxPhs4ePFqMy52CInAJ2aw: posts big blind $0.50
*** HOLE CARDS ***
686aeHikcJlgKkSuIFdcXQ: folds
SwPczQo3cOtwEzhJrfO2cQ: folds
vXIHnZ+dv/hwSBxyvGw7bQ: folds
L9qfLYXrczhAPd/VckgsWw: folds
wOyVV9M/oyiw3YaOjNZ05w: folds
kxPhs4ePFqMy52CInAJ2aw collected $0.50 from pot
kxPhs4ePFqMy52CInAJ2aw: doesn't show hand
*** SUMMARY ***
Total pot $0.50 | Rake $0
Seat 1: SwPczQo3cOtwEzhJrfO2cQ folded before Flop (didn't bet)
Seat 2: vXIHnZ+dv/hwSBxyvGw7bQ folded before Flop (didn't bet)
Seat 3: L9qfLYXrczhAPd/VckgsWw (button) folded before Flop (didn't bet)
Seat 4: wOyVV9M/oyiw3YaOjNZ05w (small blind) folded before Flop
Seat 5: kxPhs4ePFqMy52CInAJ2aw (big blind) collected ($0.50)
Seat 6: 686aeHikcJlgKkSuIFdcXQ folded before Flop (didn't bet)



PokerStars Game #59939048742:  Hold'em No Limit ($0.25/$0.50) - 2009/07/01 0:30:02 ET
Table 'mTxf8gPLgffN3Iwfm7Icfg' 2-max Seat #1 is the button
Seat 1: Do9Rlu1R5u/AcRtMTl8SYg ($93.05 in chips)
Seat 2: EMc5LPgVaded4Qc77vm0fw ($66.55 in chips)
Do9Rlu1R5u/AcRtMTl8SYg: posts small blind $0.25
EMc5LPgVaded4Qc77vm0fw: posts big blind $0.50
*** HOLE CARDS ***
Do9Rlu1R5u/AcRtMTl8SYg: folds
EMc5LPgVaded4Qc77vm0fw collected $0.50 from pot
EMc5LPgVaded4Qc77vm0fw: doesn't show hand
*** SUMMARY ***
Total pot $0.50 | Rake $0
Seat 1: Do9Rlu1R5u/AcRtMTl8SYg (button) (small blind) folded before Flop
Seat 2: EMc5LPgVaded4Qc77vm0fw (big blind) collected ($0.50)



PokerStars Game #59939048774:  Hold'em No Limit ($0.25/$0.50) - 2009/07/01 0:30:02 ET
Table '3FhG0gl3kMX3wBEEqj+wnQ' 9-max Seat #1 is the button
Seat 1: e0J9pdCNUDTCG031RnXqLA ($17 in chips)
Seat 2: 4dl3YNqZ6Houm2jZAzDmRg ($19.40 in chips)
Seat 3: HZkVla4kK2SI42CVrPZ/ig ($9.25 in chips)
Seat 4: bz4LMfV0GGl/MJ/ABXuPmg ($21.35 in chips)
Seat 5: XNMDwbXt/Q4jM99AXnbJDw ($50 in chips)
Seat 6: 5JJVDlaiMnB004o/RqbZZQ ($23.75 in chips)
Seat 7: mSD1pginDsyHG5PDfqzphw ($10 in chips)
Seat 8: j3K/Jujr7PY4ZM2RZvlH6A ($61.70 in chips)
Seat 9: L5e2lrPLQm1Pqx30IIZ/Fw ($11.85 in chips)
4dl3YNqZ6Houm2jZAzDmRg: posts small blind $0.25
HZkVla4kK2SI42CVrPZ/ig: posts big blind $0.50
*** HOLE CARDS ***
bz4LMfV0GGl/MJ/ABXuPmg: folds
XNMDwbXt/Q4jM99AXnbJDw: folds
5JJVDlaiMnB004o/RqbZZQ: raises $1 to $1.50
mSD1pginDsyHG5PDfqzphw: folds
j3K/Jujr7PY4ZM2RZvlH6A: raises $2 to $3.50
L5e2lrPLQm1Pqx30IIZ/Fw: folds
e0J9pdCNUDTCG031RnXqLA: folds
4dl3YNqZ6Houm2jZAzDmRg: calls $3.25
HZkVla4kK2SI42CVrPZ/ig: folds
5JJVDlaiMnB004o/RqbZZQ: raises $20.25 to $23.75 and is all-in
j3K/Jujr7PY4ZM2RZvlH6A: folds
4dl3YNqZ6Houm2jZAzDmRg: calls $15.90 and is all-in
*** FLOP *** [6s 6c 7d]
*** TURN *** [6s 6c 7d] [As]
*** RIVER *** [6s 6c 7d As] [Ac]
*** SHOW DOWN ***
4dl3YNqZ6Houm2jZAzDmRg: shows [Kc Jd] (two pair, Aces and Sixes)
5JJVDlaiMnB004o/RqbZZQ: shows [Kd Ks] (two pair, Aces and Kings)
5JJVDlaiMnB004o/RqbZZQ collected $40.70 from pot
*** SUMMARY ***
Total pot $42.80 | Rake $2.10
Board [6s 6c 7d As Ac]
Seat 1: e0J9pdCNUDTCG031RnXqLA (button) folded before Flop (didn't bet)
Seat 2: 4dl3YNqZ6Houm2jZAzDmRg (small blind) showed [Kc Jd] and lost with two pair, Aces and Sixes
Seat 3: HZkVla4kK2SI42CVrPZ/ig (big blind) folded before Flop
Seat 4: bz4LMfV0GGl/MJ/ABXuPmg folded before Flop (didn't bet)
Seat 5: XNMDwbXt/Q4jM99AXnbJDw folded before Flop (didn't bet)
Seat 6: 5JJVDlaiMnB004o/RqbZZQ showed [Kd Ks] and won ($40.70) with two pair, Aces and Kings
Seat 7: mSD1pginDsyHG5PDfqzphw folded before Flop (didn't bet)
Seat 8: j3K/Jujr7PY4ZM2RZvlH6A folded before Flop
Seat 9: L5e2lrPLQm1Pqx30IIZ/Fw folded before Flop (didn't bet)



PokerStars Game #59939049462:  Hold'em No Limit ($0.25/$0.50) - 2009/07/01 0:30:03 ET
Table 'QOgaEqMcJ73pcUMMxoisUg' 6-max Seat #2 is the button
Seat 2: Im2p1Nt83UKSqv5c9frm4Q ($50 in chips)
Seat 3: wUZNozoIDYf+16hp4nn6dw ($43.60 in chips)
Seat 4: zAcsDhG/T128Vn7XGVSgKg ($61.05 in chips)
Seat 5: 6vNxrjjCl6FwfaaymM9jjg ($26.80 in chips)
Seat 6: s83dnhZ6VC53vY0/f6OV/g ($36.10 in chips)
wUZNozoIDYf+16hp4nn6dw: posts small blind $0.25
zAcsDhG/T128Vn7XGVSgKg: posts big blind $0.50
OZ6OtYh5Y53MCH/p0QTn5g: sits out
*** HOLE CARDS ***
6vNxrjjCl6FwfaaymM9jjg: folds
s83dnhZ6VC53vY0/f6OV/g: folds
Im2p1Nt83UKSqv5c9frm4Q: folds
wUZNozoIDYf+16hp4nn6dw: calls $0.25
zAcsDhG/T128Vn7XGVSgKg: checks
*** FLOP *** [9h Jd 4h]
wUZNozoIDYf+16hp4nn6dw: checks
s83dnhZ6VC53vY0/f6OV/g leaves the table
zAcsDhG/T128Vn7XGVSgKg: checks
*** TURN *** [9h Jd 4h] [Qs]
wUZNozoIDYf+16hp4nn6dw: checks
zAcsDhG/T128Vn7XGVSgKg: checks
*** RIVER *** [9h Jd 4h Qs] [2c]
wUZNozoIDYf+16hp4nn6dw: bets $2
zAcsDhG/T128Vn7XGVSgKg: folds
wUZNozoIDYf+16hp4nn6dw collected $0.95 from pot
*** SUMMARY ***
Total pot $1 | Rake $0.05
Board [9h Jd 4h Qs 2c]
Seat 2: Im2p1Nt83UKSqv5c9frm4Q (button) folded before Flop (didn't bet)
Seat 3: wUZNozoIDYf+16hp4nn6dw (small blind) collected ($0.95)
Seat 4: zAcsDhG/T128Vn7XGVSgKg (big blind) folded on the River
Seat 5: 6vNxrjjCl6FwfaaymM9jjg folded before Flop (didn't bet)
Seat 6: s83dnhZ6VC53vY0/f6OV/g folded before Flop (didn't bet)



PokerStars Game #59939049548:  Hold'em No Limit ($0.25/$0.50) - 2009/07/01 0:30:03 ET
Table 'c/CRn+68J3Y8KxD5g1ek2Q' 2-max Seat #1 is the button
Seat 1: 46qCyJ6evTkHo9al5sBMNA ($256 in chips)
Seat 2: BypVLsYQt3ePFm2xQL/dOA ($123.15 in chips)
46qCyJ6evTkHo9al5sBMNA: posts small blind $0.25
BypVLsYQt3ePFm2xQL/dOA: posts big blind $0.50
*** HOLE CARDS ***
46qCyJ6evTkHo9al5sBMNA: folds
BypVLsYQt3ePFm2xQL/dOA collected $0.50 from pot
BypVLsYQt3ePFm2xQL/dOA: doesn't show hand
*** SUMMARY ***
Total pot $0.50 | Rake $0
Seat 1: 46qCyJ6evTkHo9al5sBMNA (button) (small blind) folded before Flop
Seat 2: BypVLsYQt3ePFm2xQL/dOA (big blind) collected ($0.50)



PokerStars Game #59939049652:  Hold'em No Limit ($0.25/$0.50) - 2009/07/01 0:30:03 ET
Table '+dXkOAQyS8j9PQZusUTMpg' 2-max Seat #1 is the button
Seat 1: XFa6sBGjP2gxoIvxR3fZIg ($58.65 in chips)
Seat 2: 5IBeOgaApY1Bvzv2P8X4EA ($85.50 in chips)
XFa6sBGjP2gxoIvxR3fZIg: posts small blind $0.25
5IBeOgaApY1Bvzv2P8X4EA: posts big blind $0.50
*** HOLE CARDS ***
XFa6sBGjP2gxoIvxR3fZIg: raises $1 to $1.50
5IBeOgaApY1Bvzv2P8X4EA: folds
XFa6sBGjP2gxoIvxR3fZIg collected $1 from pot
XFa6sBGjP2gxoIvxR3fZIg: doesn't show hand
*** SUMMARY ***
Total pot $1 | Rake $0
Seat 1: XFa6sBGjP2gxoIvxR3fZIg (button) (small blind) collected ($1)
Seat 2: 5IBeOgaApY1Bvzv2P8X4EA (big blind) folded before Flop



PokerStars Game #59939049670:  Hold'em No Limit ($0.25/$0.50) - 2009/07/01 0:30:03 ET
Table 'MJxeZCzYELxiIsyUZyT0jw' 6-max Seat #2 is the button
Seat 1: wOyVV9M/oyiw3YaOjNZ05w ($52.95 in chips)
Seat 2: dB6jzDlJmET84VMWw1mTRA ($50 in chips)
Seat 3: JQZew0FjzS19kTjeNtrE+A ($51.05 in chips)
Seat 4: lP7Q6pewz4C2RsAfKsjdWw ($36.70 in chips)
Seat 5: 3jvoOXNtXE90w2BdfNZwZQ ($53.80 in chips)
Seat 6: TTx3CHxyi0SObcHyMJRp5w ($48 in chips)
JQZew0FjzS19kTjeNtrE+A: posts small blind $0.25
lP7Q6pewz4C2RsAfKsjdWw: posts big blind $0.50
*** HOLE CARDS ***
3jvoOXNtXE90w2BdfNZwZQ: folds
TTx3CHxyi0SObcHyMJRp5w: calls $0.50
wOyVV9M/oyiw3YaOjNZ05w: folds
dB6jzDlJmET84VMWw1mTRA: folds
JQZew0FjzS19kTjeNtrE+A: calls $0.25
lP7Q6pewz4C2RsAfKsjdWw: checks
*** FLOP *** [Ts 4d 3c]
JQZew0FjzS19kTjeNtrE+A: checks
lP7Q6pewz4C2RsAfKsjdWw: checks
TTx3CHxyi0SObcHyMJRp5w: bets $1.50
JQZew0FjzS19kTjeNtrE+A: folds
lP7Q6pewz4C2RsAfKsjdWw: folds
TTx3CHxyi0SObcHyMJRp5w collected $1.45 from pot
TTx3CHxyi0SObcHyMJRp5w: doesn't show hand
*** SUMMARY ***
Total pot $1.50 | Rake $0.05
Board [Ts 4d 3c]
Seat 1: wOyVV9M/oyiw3YaOjNZ05w folded before Flop (didn't bet)
Seat 2: dB6jzDlJmET84VMWw1mTRA (button) folded before Flop (didn't bet)
Seat 3: JQZew0FjzS19kTjeNtrE+A (small blind) folded on the Flop
Seat 4: lP7Q6pewz4C2RsAfKsjdWw (big blind) folded on the Flop
Seat 5: 3jvoOXNtXE90w2BdfNZwZQ folded before Flop (didn't bet)
Seat 6: TTx3CHxyi0SObcHyMJRp5w collected ($1.45)



PokerStars Game #59939051720:  Hold'em No Limit ($0.25/$0.50) - 2009/07/01 0:30:12 ET
Table '37qXEp3oe+er5q4CZip9eQ' 6-max Seat #6 is the button
Seat 1: oqOqoO2AyCZenUghCxMDxw ($50 in chips)
Seat 2: 6wzJiRvp8HY6t+MQGnSIzA ($17.10 in chips)
Seat 3: Rt6KgtZ8YaJoTc3FPim00w ($95 in chips)
Seat 4: XsmE8nXMAAMFJbWaJTmHFw ($19.80 in chips)
Seat 5: VOmI0x4dDPnTESZd5B4d1Q ($44.50 in chips)
Seat 6: l4m/wWPs22DSP5xpszjXKA ($9.25 in chips)
oqOqoO2AyCZenUghCxMDxw: posts small blind $0.25
6wzJiRvp8HY6t+MQGnSIzA: posts big blind $0.50
*** HOLE CARDS ***
Rt6KgtZ8YaJoTc3FPim00w: raises $1 to $1.50
XsmE8nXMAAMFJbWaJTmHFw: folds
VOmI0x4dDPnTESZd5B4d1Q: folds
l4m/wWPs22DSP5xpszjXKA: folds
oqOqoO2AyCZenUghCxMDxw: folds
6wzJiRvp8HY6t+MQGnSIzA: folds
Rt6KgtZ8YaJoTc3FPim00w collected $1.25 from pot
*** SUMMARY ***
Total pot $1.25 | Rake $0
Seat 1: oqOqoO2AyCZenUghCxMDxw (small blind) folded before Flop
Seat 2: 6wzJiRvp8HY6t+MQGnSIzA (big blind) folded before Flop
Seat 3: Rt6KgtZ8YaJoTc3FPim00w collected ($1.25)
Seat 4: XsmE8nXMAAMFJbWaJTmHFw folded before Flop (didn't bet)
Seat 5: VOmI0x4dDPnTESZd5B4d1Q folded before Flop (didn't bet)
Seat 6: l4m/wWPs22DSP5xpszjXKA (button) folded before Flop (didn't bet)



PokerStars Game #59939051786:  Hold'em No Limit ($0.25/$0.50) - 2009/07/01 0:30:12 ET
Table 'NCiXr0d5CEKBQr/cZgLhbA' 9-max Seat #9 is the button
Seat 2: ulxuJchBV9iguXg0FUonfg ($24.70 in chips)
Seat 3: xZCXQSXlrZkp3pZizzVXCw ($57.65 in chips)
Seat 4: 5k9fvXD9suIgCxU4HLQjTw ($60.95 in chips)
Seat 5: zE9cVigS2nW/Ljy4K4bUQA ($39.50 in chips)
Seat 6: SKnJuWHScqetA/qG5p+wCg ($30 in chips)
Seat 7: M+7+BTmX5vZatHVuoRB1nA ($48.50 in chips)
Seat 8: 1MJUKc3cc0QmUoz1JZLR2w ($53.10 in chips)
Seat 9: 4WLZvqBn5qv5tds5kt5A1Q ($28.75 in chips)
pFtzb1sR4b0d1aw6aIRgDg will be allowed to play after the button
ulxuJchBV9iguXg0FUonfg: posts small blind $0.25
xZCXQSXlrZkp3pZizzVXCw: posts big blind $0.50
*** HOLE CARDS ***
5k9fvXD9suIgCxU4HLQjTw: folds
zE9cVigS2nW/Ljy4K4bUQA: folds
SKnJuWHScqetA/qG5p+wCg: folds
M+7+BTmX5vZatHVuoRB1nA: folds
1MJUKc3cc0QmUoz1JZLR2w: calls $0.50
4WLZvqBn5qv5tds5kt5A1Q: folds
ulxuJchBV9iguXg0FUonfg: calls $0.25
xZCXQSXlrZkp3pZizzVXCw: checks
*** FLOP *** [Th 5s 8s]
ulxuJchBV9iguXg0FUonfg: checks
xZCXQSXlrZkp3pZizzVXCw: checks
1MJUKc3cc0QmUoz1JZLR2w: bets $1.50
ulxuJchBV9iguXg0FUonfg: folds
xZCXQSXlrZkp3pZizzVXCw: folds
1MJUKc3cc0QmUoz1JZLR2w collected $1.45 from pot
*** SUMMARY ***
Total pot $1.50 | Rake $0.05
Board [Th 5s 8s]
Seat 2: ulxuJchBV9iguXg0FUonfg (small blind) folded on the Flop
Seat 3: xZCXQSXlrZkp3pZizzVXCw (big blind) folded on the Flop
Seat 4: 5k9fvXD9suIgCxU4HLQjTw folded before Flop (didn't bet)
Seat 5: zE9cVigS2nW/Ljy4K4bUQA folded before Flop (didn't bet)
Seat 6: SKnJuWHScqetA/qG5p+wCg folded before Flop (didn't bet)
Seat 7: M+7+BTmX5vZatHVuoRB1nA folded before Flop (didn't bet)
Seat 8: 1MJUKc3cc0QmUoz1JZLR2w collected ($1.45)
Seat 9: 4WLZvqBn5qv5tds5kt5A1Q (button) folded before Flop (didn't bet)



PokerStars Game #59939054050:  Hold'em No Limit ($0.25/$0.50) - 2009/07/01 0:30:13 ET
Table 'mTxf8gPLgffN3Iwfm7Icfg' 2-max Seat #2 is the button
Seat 1: Do9Rlu1R5u/AcRtMTl8SYg ($92.80 in chips)
Seat 2: EMc5LPgVaded4Qc77vm0fw ($66.80 in chips)
EMc5LPgVaded4Qc77vm0fw: posts small blind $0.25
Do9Rlu1R5u/AcRtMTl8SYg: posts big blind $0.50
*** HOLE CARDS ***
EMc5LPgVaded4Qc77vm0fw: raises $1 to $1.50
Do9Rlu1R5u/AcRtMTl8SYg: folds
EMc5LPgVaded4Qc77vm0fw collected $1 from pot
EMc5LPgVaded4Qc77vm0fw: doesn't show hand
*** SUMMARY ***
Total pot $1 | Rake $0
Seat 1: Do9Rlu1R5u/AcRtMTl8SYg (big blind) folded before Flop
Seat 2: EMc5LPgVaded4Qc77vm0fw (button) (small blind) collected ($1)



PokerStars Game #59939055298:  Hold'em No Limit ($0.25/$0.50) - 2009/07/01 0:30:13 ET
Table 'c/CRn+68J3Y8KxD5g1ek2Q' 2-max Seat #2 is the button
Seat 1: 46qCyJ6evTkHo9al5sBMNA ($255.75 in chips)
Seat 2: BypVLsYQt3ePFm2xQL/dOA ($123.40 in chips)
BypVLsYQt3ePFm2xQL/dOA: posts small blind $0.25
46qCyJ6evTkHo9al5sBMNA: posts big blind $0.50
*** HOLE CARDS ***
BypVLsYQt3ePFm2xQL/dOA: raises $2.50 to $3
46qCyJ6evTkHo9al5sBMNA: folds
BypVLsYQt3ePFm2xQL/dOA collected $1 from pot
BypVLsYQt3ePFm2xQL/dOA: doesn't show hand
*** SUMMARY ***
Total pot $1 | Rake $0
Seat 1: 46qCyJ6evTkHo9al5sBMNA (big blind) folded before Flop
Seat 2: BypVLsYQt3ePFm2xQL/dOA (button) (small blind) collected ($1)



PokerStars Game #59939055190:  Hold'em No Limit ($0.25/$0.50) - 2009/07/01 0:30:13 ET
Table 'lSisgp6H7Fg1hH5VfjEjYQ' 9-max Seat #2 is the button
Seat 1: pEW8B6uXbdR47kfljMQ3+Q ($37.85 in chips)
Seat 2: UrcnkQOiLVk8BlKDPJSy7Q ($52.75 in chips)
Seat 3: aTkyjTh3w5YLWiIERupZOA ($39.65 in chips)
Seat 4: bwv/rbH/hHhPhY6u9mu04w ($23.15 in chips)
Seat 5: mSD1pginDsyHG5PDfqzphw ($10 in chips)
Seat 6: +k7T5ocke8UwavtgUHm+Cg ($25.35 in chips)
Seat 7: dGw5MBstXyXhWHHVFOWOFA ($42 in chips)
Seat 8: a4JDWmpFQkL10XfAyuF51A ($38 in chips)
Seat 9: 5JJVDlaiMnB004o/RqbZZQ ($40.45 in chips)
aTkyjTh3w5YLWiIERupZOA: posts small blind $0.25
bwv/rbH/hHhPhY6u9mu04w: posts big blind $0.50
*** HOLE CARDS ***
mSD1pginDsyHG5PDfqzphw: folds
+k7T5ocke8UwavtgUHm+Cg: folds
dGw5MBstXyXhWHHVFOWOFA: folds
a4JDWmpFQkL10XfAyuF51A: folds
5JJVDlaiMnB004o/RqbZZQ: folds
pEW8B6uXbdR47kfljMQ3+Q: folds
UrcnkQOiLVk8BlKDPJSy7Q: folds
aTkyjTh3w5YLWiIERupZOA: folds
bwv/rbH/hHhPhY6u9mu04w collected $0.50 from pot
*** SUMMARY ***
Total pot $0.50 | Rake $0
Seat 1: pEW8B6uXbdR47kfljMQ3+Q folded before Flop (didn't bet)
Seat 2: UrcnkQOiLVk8BlKDPJSy7Q (button) folded before Flop (didn't bet)
Seat 3: aTkyjTh3w5YLWiIERupZOA (small blind) folded before Flop
Seat 4: bwv/rbH/hHhPhY6u9mu04w (big blind) collected ($0.50)
Seat 5: mSD1pginDsyHG5PDfqzphw folded before Flop (didn't bet)
Seat 6: +k7T5ocke8UwavtgUHm+Cg folded before Flop (didn't bet)
Seat 7: dGw5MBstXyXhWHHVFOWOFA folded before Flop (didn't bet)
Seat 8: a4JDWmpFQkL10XfAyuF51A folded before Flop (didn't bet)
Seat 9: 5JJVDlaiMnB004o/RqbZZQ folded before Flop (didn't bet)



PokerStars Game #59939055798:  Hold'em No Limit ($0.25/$0.50) - 2009/07/01 0:30:14 ET
Table 'IeNZOZQ4T6oiaHqFeo6yIA' 2-max Seat #2 is the button
Seat 1: ndd1nfncBkWNitBnsfCoVQ ($91.15 in chips)
Seat 2: A91IUl5JaZROhtfCtnnwYw ($40.95 in chips)
A91IUl5JaZROhtfCtnnwYw: posts small blind $0.25
ndd1nfncBkWNitBnsfCoVQ: posts big blind $0.50
*** HOLE CARDS ***
A91IUl5JaZROhtfCtnnwYw: calls $0.25
ndd1nfncBkWNitBnsfCoVQ: raises $1.50 to $2
A91IUl5JaZROhtfCtnnwYw: calls $1.50
*** FLOP *** [3c Kc Kd]
ndd1nfncBkWNitBnsfCoVQ: bets $3
A91IUl5JaZROhtfCtnnwYw: folds
ndd1nfncBkWNitBnsfCoVQ collected $3.80 from pot
ndd1nfncBkWNitBnsfCoVQ: doesn't show hand
*** SUMMARY ***
Total pot $4 | Rake $0.20
Board [3c Kc Kd]
Seat 1: ndd1nfncBkWNitBnsfCoVQ (big blind) collected ($3.80)
Seat 2: A91IUl5JaZROhtfCtnnwYw (button) (small blind) folded on the Flop



PokerStars Game #59939055908:  Hold'em No Limit ($0.25/$0.50) - 2009/07/01 0:30:14 ET
Table '+dXkOAQyS8j9PQZusUTMpg' 2-max Seat #2 is the button
Seat 1: XFa6sBGjP2gxoIvxR3fZIg ($59.15 in chips)
Seat 2: 5IBeOgaApY1Bvzv2P8X4EA ($85 in chips)
5IBeOgaApY1Bvzv2P8X4EA: posts small blind $0.25
XFa6sBGjP2gxoIvxR3fZIg: posts big blind $0.50
*** HOLE CARDS ***
5IBeOgaApY1Bvzv2P8X4EA: calls $0.25
XFa6sBGjP2gxoIvxR3fZIg: checks
*** FLOP *** [9h 3d 2s]
XFa6sBGjP2gxoIvxR3fZIg: checks
5IBeOgaApY1Bvzv2P8X4EA: checks
*** TURN *** [9h 3d 2s] [Ac]
XFa6sBGjP2gxoIvxR3fZIg: checks
5IBeOgaApY1Bvzv2P8X4EA: checks
*** RIVER *** [9h 3d 2s Ac] [5c]
XFa6sBGjP2gxoIvxR3fZIg: checks
5IBeOgaApY1Bvzv2P8X4EA: checks
*** SHOW DOWN ***
XFa6sBGjP2gxoIvxR3fZIg: shows [7h 6c] (high card Ace)
5IBeOgaApY1Bvzv2P8X4EA: shows [8s Ks] (high card Ace - King kicker)
5IBeOgaApY1Bvzv2P8X4EA collected $0.95 from pot
*** SUMMARY ***
Total pot $1 | Rake $0.05
Board [9h 3d 2s Ac 5c]
Seat 1: XFa6sBGjP2gxoIvxR3fZIg (big blind) showed [7h 6c] and lost with high card Ace
Seat 2: 5IBeOgaApY1Bvzv2P8X4EA (button) (small blind) showed [8s Ks] and won ($0.95) with high card Ace



PokerStars Game #59939058560:  Hold'em No Limit ($0.25/$0.50) - 2009/07/01 0:30:17 ET
Table 'GfL/No5u5PoEnU39lP5pQg' 6-max Seat #3 is the button
Seat 1: 1WUCqNG+p+vfWRTXNu4ljw ($52.30 in chips)
Seat 2: uVwggSetzp7d+eVgowO3vg ($57.80 in chips)
Seat 3: NbUTppWfym/RxV/DmDz2Sw ($16.60 in chips)
Seat 4: x+pzUFJsMIiGd7a5pcR4tg ($50 in chips)
Seat 5: crjGpJEzSZgD38FoE3VMGg ($54.85 in chips)
x+pzUFJsMIiGd7a5pcR4tg: posts small blind $0.25
crjGpJEzSZgD38FoE3VMGg: posts big blind $0.50
3wylWYGeXFXcrE4XVrlPng: sits out
*** HOLE CARDS ***
1WUCqNG+p+vfWRTXNu4ljw: folds
uVwggSetzp7d+eVgowO3vg: folds
NbUTppWfym/RxV/DmDz2Sw: calls $0.50
x+pzUFJsMIiGd7a5pcR4tg: raises $2 to $2.50
crjGpJEzSZgD38FoE3VMGg: folds
NbUTppWfym/RxV/DmDz2Sw: calls $2
*** FLOP *** [As Ad 5c]
x+pzUFJsMIiGd7a5pcR4tg: bets $4
NbUTppWfym/RxV/DmDz2Sw: folds
x+pzUFJsMIiGd7a5pcR4tg collected $5.25 from pot
x+pzUFJsMIiGd7a5pcR4tg: doesn't show hand
*** SUMMARY ***
Total pot $5.50 | Rake $0.25
Board [As Ad 5c]
Seat 1: 1WUCqNG+p+vfWRTXNu4ljw folded before Flop (didn't bet)
Seat 2: uVwggSetzp7d+eVgowO3vg folded before Flop (didn't bet)
Seat 3: NbUTppWfym/RxV/DmDz2Sw (button) folded on the Flop
Seat 4: x+pzUFJsMIiGd7a5pcR4tg (small blind) collected ($5.25)
Seat 5: crjGpJEzSZgD38FoE3VMGg (big blind) folded before Flop



PokerStars Game #59939061246:  Hold'em No Limit ($0.25/$0.50) - 2009/07/01 0:30:21 ET
Table 'eMxdLyFDf28E0wit6gm3Uw' 6-max Seat #6 is the button
Seat 2: jwuKQ1S3U4NnzMQn3E3dgw ($63.55 in chips)
Seat 3: dZcLsEI8iXkobBduRJ45Yw ($19.60 in chips)
Seat 4: QM93o65lI8kLzmiB/BILlA ($20.50 in chips)
Seat 6: L0aIPg7qefDQjdJo3HCVEA ($7.25 in chips)
jwuKQ1S3U4NnzMQn3E3dgw: posts small blind $0.25
dZcLsEI8iXkobBduRJ45Yw: posts big blind $0.50
*** HOLE CARDS ***
QM93o65lI8kLzmiB/BILlA: calls $0.50
GtdWeBVCZhDBcNFRTOb8Hg joins the table at seat #1
L0aIPg7qefDQjdJo3HCVEA: raises $0.50 to $1
jwuKQ1S3U4NnzMQn3E3dgw: raises $0.50 to $1.50
dZcLsEI8iXkobBduRJ45Yw: folds
QM93o65lI8kLzmiB/BILlA: calls $1
L0aIPg7qefDQjdJo3HCVEA: raises $5.75 to $7.25 and is all-in
jwuKQ1S3U4NnzMQn3E3dgw: calls $5.75
QM93o65lI8kLzmiB/BILlA: calls $5.75
*** FLOP *** [8s As 4h]
jwuKQ1S3U4NnzMQn3E3dgw: bets $21.50
QM93o65lI8kLzmiB/BILlA: folds
*** TURN *** [8s As 4h] [9s]
*** RIVER *** [8s As 4h 9s] [8d]
*** SHOW DOWN ***
jwuKQ1S3U4NnzMQn3E3dgw: shows [Qd Ah] (two pair, Aces and Eights)
L0aIPg7qefDQjdJo3HCVEA: shows [Ac Qc] (two pair, Aces and Eights)
jwuKQ1S3U4NnzMQn3E3dgw collected $10.60 from pot
L0aIPg7qefDQjdJo3HCVEA collected $10.55 from pot
*** SUMMARY ***
Total pot $22.25 | Rake $1.10
Board [8s As 4h 9s 8d]
Seat 2: jwuKQ1S3U4NnzMQn3E3dgw (small blind) showed [Qd Ah] and won ($10.60) with two pair, Aces and Eights
Seat 3: dZcLsEI8iXkobBduRJ45Yw (big blind) folded before Flop
Seat 4: QM93o65lI8kLzmiB/BILlA folded on the Flop
Seat 6: L0aIPg7qefDQjdJo3HCVEA (button) showed [Ac Qc] and won ($10.55) with two pair, Aces and Eights



PokerStars Game #59939061216:  Hold'em No Limit ($0.25/$0.50) - 2009/07/01 0:30:21 ET
Table 'mTxf8gPLgffN3Iwfm7Icfg' 2-max Seat #1 is the button
Seat 1: Do9Rlu1R5u/AcRtMTl8SYg ($92.30 in chips)
Seat 2: EMc5LPgVaded4Qc77vm0fw ($67.30 in chips)
Do9Rlu1R5u/AcRtMTl8SYg: posts small blind $0.25
EMc5LPgVaded4Qc77vm0fw: posts big blind $0.50
*** HOLE CARDS ***
Do9Rlu1R5u/AcRtMTl8SYg: calls $0.25
EMc5LPgVaded4Qc77vm0fw: raises $1.50 to $2
Do9Rlu1R5u/AcRtMTl8SYg: folds
EMc5LPgVaded4Qc77vm0fw collected $1 from pot
EMc5LPgVaded4Qc77vm0fw: doesn't show hand
*** SUMMARY ***
Total pot $1 | Rake $0
Seat 1: Do9Rlu1R5u/AcRtMTl8SYg (button) (small blind) folded before Flop
Seat 2: EMc5LPgVaded4Qc77vm0fw (big blind) collected ($1)



PokerStars Game #59939062688:  Hold'em No Limit ($0.25/$0.50) - 2009/07/01 0:30:23 ET
Table '5EmHi+fnatGQQShcNmzOZQ' 6-max Seat #4 is the button
Seat 1: SwPczQo3cOtwEzhJrfO2cQ ($23.95 in chips)
Seat 2: vXIHnZ+dv/hwSBxyvGw7bQ ($50 in chips)
Seat 3: L9qfLYXrczhAPd/VckgsWw ($62.70 in chips)
Seat 4: wOyVV9M/oyiw3YaOjNZ05w ($51.80 in chips)
Seat 5: kxPhs4ePFqMy52CInAJ2aw ($62.10 in chips)
Seat 6: 686aeHikcJlgKkSuIFdcXQ ($141.40 in chips)
kxPhs4ePFqMy52CInAJ2aw: posts small blind $0.25
686aeHikcJlgKkSuIFdcXQ: posts big blind $0.50
*** HOLE CARDS ***
SwPczQo3cOtwEzhJrfO2cQ: raises $0.50 to $1
vXIHnZ+dv/hwSBxyvGw7bQ: folds
L9qfLYXrczhAPd/VckgsWw: folds
wOyVV9M/oyiw3YaOjNZ05w: raises $3.50 to $4.50
kxPhs4ePFqMy52CInAJ2aw: folds
686aeHikcJlgKkSuIFdcXQ: folds
SwPczQo3cOtwEzhJrfO2cQ: calls $3.50
*** FLOP *** [Ad 3d 4d]
SwPczQo3cOtwEzhJrfO2cQ: checks
wOyVV9M/oyiw3YaOjNZ05w: bets $7.50
SwPczQo3cOtwEzhJrfO2cQ: folds
wOyVV9M/oyiw3YaOjNZ05w collected $9.30 from pot
wOyVV9M/oyiw3YaOjNZ05w: doesn't show hand
*** SUMMARY ***
Total pot $9.75 | Rake $0.45
Board [Ad 3d 4d]
Seat 1: SwPczQo3cOtwEzhJrfO2cQ folded on the Flop
Seat 2: vXIHnZ+dv/hwSBxyvGw7bQ folded before Flop (didn't bet)
Seat 3: L9qfLYXrczhAPd/VckgsWw folded before Flop (didn't bet)
Seat 4: wOyVV9M/oyiw3YaOjNZ05w (button) collected ($9.30)
Seat 5: kxPhs4ePFqMy52CInAJ2aw (small blind) folded before Flop
Seat 6: 686aeHikcJlgKkSuIFdcXQ (big blind) folded before Flop



PokerStars Game #59939065844:  Hold'em No Limit ($0.25/$0.50) - 2009/07/01 0:30:28 ET
Table '37qXEp3oe+er5q4CZip9eQ' 6-max Seat #1 is the button
Seat 1: oqOqoO2AyCZenUghCxMDxw ($50 in chips)
Seat 2: 6wzJiRvp8HY6t+MQGnSIzA ($16.60 in chips)
Seat 3: Rt6KgtZ8YaJoTc3FPim00w ($95.75 in chips)
Seat 4: XsmE8nXMAAMFJbWaJTmHFw ($19.80 in chips)
Seat 5: VOmI0x4dDPnTESZd5B4d1Q ($44.50 in chips)
Seat 6: l4m/wWPs22DSP5xpszjXKA ($9.25 in chips)
6wzJiRvp8HY6t+MQGnSIzA: posts small blind $0.25
Rt6KgtZ8YaJoTc3FPim00w: posts big blind $0.50
*** HOLE CARDS ***
XsmE8nXMAAMFJbWaJTmHFw: folds
VOmI0x4dDPnTESZd5B4d1Q: raises $1.50 to $2
l4m/wWPs22DSP5xpszjXKA: folds
oqOqoO2AyCZenUghCxMDxw: folds
6wzJiRvp8HY6t+MQGnSIzA: raises $3 to $5
Rt6KgtZ8YaJoTc3FPim00w: folds
VOmI0x4dDPnTESZd5B4d1Q: folds
6wzJiRvp8HY6t+MQGnSIzA collected $4.50 from pot
*** SUMMARY ***
Total pot $4.50 | Rake $0
Seat 1: oqOqoO2AyCZenUghCxMDxw (button) folded before Flop (didn't bet)
Seat 2: 6wzJiRvp8HY6t+MQGnSIzA (small blind) collected ($4.50)
Seat 3: Rt6KgtZ8YaJoTc3FPim00w (big blind) folded before Flop
Seat 4: XsmE8nXMAAMFJbWaJTmHFw folded before Flop (didn't bet)
Seat 5: VOmI0x4dDPnTESZd5B4d1Q folded before Flop
Seat 6: l4m/wWPs22DSP5xpszjXKA folded before Flop (didn't bet)



PokerStars Game #59939065652:  Hold'em No Limit ($0.25/$0.50) - 2009/07/01 0:30:28 ET
Table 'tyR5AZNKV8Aadbrnrnlg7g' 6-max Seat #3 is the button
Seat 1: R+KjpH/wSjDLhtIy9+edNA ($81 in chips)
Seat 2: 58zdeSBSuSFX/qZfhc7YmA ($34.50 in chips)
Seat 3: tdOvWynovql5imfooroLMg ($48.75 in chips)
Seat 4: Rt6KgtZ8YaJoTc3FPim00w ($83 in chips)
Seat 5: wOyVV9M/oyiw3YaOjNZ05w ($55.35 in chips)
Seat 6: ZKazl1hGaPiapDXincgi2Q ($29.70 in chips)
Rt6KgtZ8YaJoTc3FPim00w: posts small blind $0.25
wOyVV9M/oyiw3YaOjNZ05w: posts big blind $0.50
*** HOLE CARDS ***
ZKazl1hGaPiapDXincgi2Q: folds
R+KjpH/wSjDLhtIy9+edNA: folds
58zdeSBSuSFX/qZfhc7YmA: calls $0.50
tdOvWynovql5imfooroLMg: folds
Rt6KgtZ8YaJoTc3FPim00w: calls $0.25
wOyVV9M/oyiw3YaOjNZ05w: checks
*** FLOP *** [6h Qh Qd]
Rt6KgtZ8YaJoTc3FPim00w: bets $1
wOyVV9M/oyiw3YaOjNZ05w: folds
58zdeSBSuSFX/qZfhc7YmA: folds
Rt6KgtZ8YaJoTc3FPim00w collected $1.45 from pot
Rt6KgtZ8YaJoTc3FPim00w: doesn't show hand
*** SUMMARY ***
Total pot $1.50 | Rake $0.05
Board [6h Qh Qd]
Seat 1: R+KjpH/wSjDLhtIy9+edNA folded before Flop (didn't bet)
Seat 2: 58zdeSBSuSFX/qZfhc7YmA folded on the Flop
Seat 3: tdOvWynovql5imfooroLMg (button) folded before Flop (didn't bet)
Seat 4: Rt6KgtZ8YaJoTc3FPim00w (small blind) collected ($1.45)
Seat 5: wOyVV9M/oyiw3YaOjNZ05w (big blind) folded on the Flop
Seat 6: ZKazl1hGaPiapDXincgi2Q folded before Flop (didn't bet)



PokerStars Game #59939065714:  Hold'em No Limit ($0.25/$0.50) - 2009/07/01 0:30:28 ET
Table 'fx6MqwfYAj/Rt86hBz2L3Q' 9-max Seat #7 is the button
Seat 1: jf2c/o9gI7Xj0GleCSMj9g ($51 in chips)
Seat 2: C3rGXblctNcWI6JYPHhaEg ($20.35 in chips)
Seat 3: iadBi5AEt7gTBXbDSSnMYQ ($46.80 in chips)
Seat 4: gPEN9Zp33YTm/mu9/SYP1w ($23.20 in chips)
Seat 5: iAISe3dVeua8PUn2wwgDHw ($18.75 in chips)
Seat 6: 5k9fvXD9suIgCxU4HLQjTw ($50 in chips)
Seat 7: bkXkL3pmapikPQQRNPZSEA ($16.15 in chips)
Seat 8: CAuekkxPVzBL9SK4Tjjbuw ($29.50 in chips)
Seat 9: HZkVla4kK2SI42CVrPZ/ig ($9.25 in chips)
CAuekkxPVzBL9SK4Tjjbuw: posts small blind $0.25
HZkVla4kK2SI42CVrPZ/ig: posts big blind $0.50
*** HOLE CARDS ***
jf2c/o9gI7Xj0GleCSMj9g: folds
C3rGXblctNcWI6JYPHhaEg: calls $0.50
iadBi5AEt7gTBXbDSSnMYQ: calls $0.50
gPEN9Zp33YTm/mu9/SYP1w: folds
iAISe3dVeua8PUn2wwgDHw: calls $0.50
5k9fvXD9suIgCxU4HLQjTw: folds
bkXkL3pmapikPQQRNPZSEA: folds
CAuekkxPVzBL9SK4Tjjbuw: calls $0.25
HZkVla4kK2SI42CVrPZ/ig: checks
*** FLOP *** [Jd Td 4h]
CAuekkxPVzBL9SK4Tjjbuw: checks
HZkVla4kK2SI42CVrPZ/ig: checks
C3rGXblctNcWI6JYPHhaEg: bets $1.85
iadBi5AEt7gTBXbDSSnMYQ: folds
iAISe3dVeua8PUn2wwgDHw: calls $1.85
CAuekkxPVzBL9SK4Tjjbuw: folds
HZkVla4kK2SI42CVrPZ/ig: folds
*** TURN *** [Jd Td 4h] [8c]
C3rGXblctNcWI6JYPHhaEg: bets $2
iAISe3dVeua8PUn2wwgDHw: calls $2
*** RIVER *** [Jd Td 4h 8c] [Js]
C3rGXblctNcWI6JYPHhaEg: bets $6
iAISe3dVeua8PUn2wwgDHw: folds
C3rGXblctNcWI6JYPHhaEg collected $9.75 from pot
C3rGXblctNcWI6JYPHhaEg: doesn't show hand
*** SUMMARY ***
Total pot $10.20 | Rake $0.45
Board [Jd Td 4h 8c Js]
Seat 1: jf2c/o9gI7Xj0GleCSMj9g folded before Flop (didn't bet)
Seat 2: C3rGXblctNcWI6JYPHhaEg collected ($9.75)
Seat 3: iadBi5AEt7gTBXbDSSnMYQ folded on the Flop
Seat 4: gPEN9Zp33YTm/mu9/SYP1w folded before Flop (didn't bet)
Seat 5: iAISe3dVeua8PUn2wwgDHw folded on the River
Seat 6: 5k9fvXD9suIgCxU4HLQjTw folded before Flop (didn't bet)
Seat 7: bkXkL3pmapikPQQRNPZSEA (button) folded before Flop (didn't bet)
Seat 8: CAuekkxPVzBL9SK4Tjjbuw (small blind) folded on the Flop
Seat 9: HZkVla4kK2SI42CVrPZ/ig (big blind) folded on the Flop



PokerStars Game #59939066174:  Hold'em No Limit ($0.25/$0.50) - 2009/07/01 0:30:29 ET
Table 'IeNZOZQ4T6oiaHqFeo6yIA' 2-max Seat #1 is the button
Seat 1: ndd1nfncBkWNitBnsfCoVQ ($92.95 in chips)
Seat 2: A91IUl5JaZROhtfCtnnwYw ($38.95 in chips)
ndd1nfncBkWNitBnsfCoVQ: posts small blind $0.25
A91IUl5JaZROhtfCtnnwYw: posts big blind $0.50
*** HOLE CARDS ***
ndd1nfncBkWNitBnsfCoVQ: raises $1 to $1.50
A91IUl5JaZROhtfCtnnwYw: raises $1 to $2.50
ndd1nfncBkWNitBnsfCoVQ: calls $1
*** FLOP *** [2d 4d 7d]
A91IUl5JaZROhtfCtnnwYw: bets $3.50
ndd1nfncBkWNitBnsfCoVQ: folds
A91IUl5JaZROhtfCtnnwYw collected $4.75 from pot
A91IUl5JaZROhtfCtnnwYw: doesn't show hand
*** SUMMARY ***
Total pot $5 | Rake $0.25
Board [2d 4d 7d]
Seat 1: ndd1nfncBkWNitBnsfCoVQ (button) (small blind) folded on the Flop
Seat 2: A91IUl5JaZROhtfCtnnwYw (big blind) collected ($4.75)



PokerStars Game #59939066512:  Hold'em No Limit ($0.25/$0.50) - 2009/07/01 0:30:29 ET
Table 'c/CRn+68J3Y8KxD5g1ek2Q' 2-max Seat #1 is the button
Seat 1: 46qCyJ6evTkHo9al5sBMNA ($255.25 in chips)
Seat 2: BypVLsYQt3ePFm2xQL/dOA ($123.90 in chips)
46qCyJ6evTkHo9al5sBMNA: posts small blind $0.25
BypVLsYQt3ePFm2xQL/dOA: posts big blind $0.50
*** HOLE CARDS ***
46qCyJ6evTkHo9al5sBMNA: folds
BypVLsYQt3ePFm2xQL/dOA collected $0.50 from pot
BypVLsYQt3ePFm2xQL/dOA: doesn't show hand
*** SUMMARY ***
Total pot $0.50 | Rake $0
Seat 1: 46qCyJ6evTkHo9al5sBMNA (button) (small blind) folded before Flop
Seat 2: BypVLsYQt3ePFm2xQL/dOA (big blind) collected ($0.50)



PokerStars Game #59939067272:  Hold'em No Limit ($0.25/$0.50) - 2009/07/01 0:30:30 ET
Table 'hSTs/dUsYLgJQuF2Onp0MQ' 6-max Seat #2 is the button
Seat 1: Donj3X7gYzeS5pAl7s9f+Q ($27.70 in chips)
Seat 2: 6vNxrjjCl6FwfaaymM9jjg ($26.35 in chips)
Seat 3: C3qJBo7uxfFVDluE1lmK2w ($29.50 in chips)
Seat 4: L0aIPg7qefDQjdJo3HCVEA ($9.65 in chips)
Seat 5: 686aeHikcJlgKkSuIFdcXQ ($60.65 in chips)
Seat 6: +laPa9P7BjZKKnR0n+OmvA ($8.95 in chips)
C3qJBo7uxfFVDluE1lmK2w: posts small blind $0.25
L0aIPg7qefDQjdJo3HCVEA: posts big blind $0.50
*** HOLE CARDS ***
686aeHikcJlgKkSuIFdcXQ: folds
+laPa9P7BjZKKnR0n+OmvA: raises $1 to $1.50
Donj3X7gYzeS5pAl7s9f+Q: folds
6vNxrjjCl6FwfaaymM9jjg: folds
C3qJBo7uxfFVDluE1lmK2w: folds
L0aIPg7qefDQjdJo3HCVEA: folds
+laPa9P7BjZKKnR0n+OmvA collected $1.25 from pot
*** SUMMARY ***
Total pot $1.25 | Rake $0
Seat 1: Donj3X7gYzeS5pAl7s9f+Q folded before Flop (didn't bet)
Seat 2: 6vNxrjjCl6FwfaaymM9jjg (button) folded before Flop (didn't bet)
Seat 3: C3qJBo7uxfFVDluE1lmK2w (small blind) folded before Flop
Seat 4: L0aIPg7qefDQjdJo3HCVEA (big blind) folded before Flop
Seat 5: 686aeHikcJlgKkSuIFdcXQ folded before Flop (didn't bet)
Seat 6: +laPa9P7BjZKKnR0n+OmvA collected ($1.25)



PokerStars Game #59939067368:  Hold'em No Limit ($0.25/$0.50) - 2009/07/01 0:30:30 ET
Table 'PALRfuH85dr5IkDfdv6new' 9-max Seat #1 is the button
Seat 1: SKnJuWHScqetA/qG5p+wCg ($30 in chips)
Seat 2: 9r7ZoBbAJj5IeyZ0q9BdzA ($6.35 in chips)
Seat 3: 50QWoELmpmHFrFIlWMJo9g ($87.45 in chips)
Seat 4: mZNMJI1mY40XTC0U7GZakA ($50.75 in chips)
Seat 5: jSSGUXdNFAZA3QCvTcUMQw ($43.45 in chips)
Seat 6: E2518gp4aFz1+kAgmGqeEg ($11.75 in chips)
Seat 7: 3NcyXvr39gnK+KbTq7ezyA ($39.25 in chips)
Seat 8: NkS+CseUKx4XHszWq0PXEQ ($44.65 in chips)
Seat 9: CIrAX/m6o7jYmKOAjJXv4Q ($36.45 in chips)
9r7ZoBbAJj5IeyZ0q9BdzA: posts small blind $0.25
50QWoELmpmHFrFIlWMJo9g: posts big blind $0.50
*** HOLE CARDS ***
mZNMJI1mY40XTC0U7GZakA: raises $1 to $1.50
jSSGUXdNFAZA3QCvTcUMQw: folds
E2518gp4aFz1+kAgmGqeEg: folds
3NcyXvr39gnK+KbTq7ezyA: folds
NkS+CseUKx4XHszWq0PXEQ: folds
CIrAX/m6o7jYmKOAjJXv4Q: folds
SKnJuWHScqetA/qG5p+wCg: folds
9r7ZoBbAJj5IeyZ0q9BdzA: calls $1.25
50QWoELmpmHFrFIlWMJo9g: calls $1
*** FLOP *** [4s 9d 2h]
9r7ZoBbAJj5IeyZ0q9BdzA: bets $4.85 and is all-in
50QWoELmpmHFrFIlWMJo9g: folds
mZNMJI1mY40XTC0U7GZakA: calls $4.85
*** TURN *** [4s 9d 2h] [Ad]
*** RIVER *** [4s 9d 2h Ad] [Ah]
*** SHOW DOWN ***
9r7ZoBbAJj5IeyZ0q9BdzA: shows [Kd 5d] (a pair of Aces)
mZNMJI1mY40XTC0U7GZakA: shows [Kh Ac] (three of a kind, Aces)
mZNMJI1mY40XTC0U7GZakA collected $13.50 from pot
*** SUMMARY ***
Total pot $14.20 | Rake $0.70
Board [4s 9d 2h Ad Ah]
Seat 1: SKnJuWHScqetA/qG5p+wCg (button) folded before Flop (didn't bet)
Seat 2: 9r7ZoBbAJj5IeyZ0q9BdzA (small blind) showed [Kd 5d] and lost with a pair of Aces
Seat 3: 50QWoELmpmHFrFIlWMJo9g (big blind) folded on the Flop
Seat 4: mZNMJI1mY40XTC0U7GZakA showed [Kh Ac] and won ($13.50) with three of a kind, Aces
Seat 5: jSSGUXdNFAZA3QCvTcUMQw folded before Flop (didn't bet)
Seat 6: E2518gp4aFz1+kAgmGqeEg folded before Flop (didn't bet)
Seat 7: 3NcyXvr39gnK+KbTq7ezyA folded before Flop (didn't bet)
Seat 8: NkS+CseUKx4XHszWq0PXEQ folded before Flop (didn't bet)
Seat 9: CIrAX/m6o7jYmKOAjJXv4Q folded before Flop (didn't bet)



PokerStars Game #59939068228:  Hold'em No Limit ($0.25/$0.50) - 2009/07/01 0:30:32 ET
Table 'Nz0Vr7WMHL2g5Uk7dDZjpw' 9-max Seat #2 is the button
Seat 2: XNMDwbXt/Q4jM99AXnbJDw ($50 in chips)
Seat 3: 4QTiNH5fteLgJjx/s6Hy6A ($13.90 in chips)
Seat 4: 5JJVDlaiMnB004o/RqbZZQ ($28.50 in chips)
Seat 5: WGW0DgjBUXs1ylURHG8vnQ ($15.90 in chips)
Seat 6: k1f0lS7tlMHCLGs0JT34Tg ($14.35 in chips)
Seat 7: KPLH0gELgFe2OuAnhJFI5w ($26.50 in chips)
Seat 8: HkZI6g4zl83TDTA7SRspmQ ($16.45 in chips)
4QTiNH5fteLgJjx/s6Hy6A: posts small blind $0.25
5JJVDlaiMnB004o/RqbZZQ: posts big blind $0.50
*** HOLE CARDS ***
WGW0DgjBUXs1ylURHG8vnQ: folds
k1f0lS7tlMHCLGs0JT34Tg: folds
KPLH0gELgFe2OuAnhJFI5w: folds
HkZI6g4zl83TDTA7SRspmQ: folds
XNMDwbXt/Q4jM99AXnbJDw: folds
4QTiNH5fteLgJjx/s6Hy6A: calls $0.25
5JJVDlaiMnB004o/RqbZZQ: checks
*** FLOP *** [Ac 9h 7c]
Ak2W6V2TDVIQrvSAy4eD7Q has returned
4QTiNH5fteLgJjx/s6Hy6A: checks
5JJVDlaiMnB004o/RqbZZQ: checks
*** TURN *** [Ac 9h 7c] [8c]
4QTiNH5fteLgJjx/s6Hy6A: bets $0.50
5JJVDlaiMnB004o/RqbZZQ: folds
4QTiNH5fteLgJjx/s6Hy6A collected $0.95 from pot
*** SUMMARY ***
Total pot $1 | Rake $0.05
Board [Ac 9h 7c 8c]
Seat 2: XNMDwbXt/Q4jM99AXnbJDw (button) folded before Flop (didn't bet)
Seat 3: 4QTiNH5fteLgJjx/s6Hy6A (small blind) collected ($0.95)
Seat 4: 5JJVDlaiMnB004o/RqbZZQ (big blind) folded on the Turn
Seat 5: WGW0DgjBUXs1ylURHG8vnQ folded before Flop (didn't bet)
Seat 6: k1f0lS7tlMHCLGs0JT34Tg folded before Flop (didn't bet)
Seat 7: KPLH0gELgFe2OuAnhJFI5w folded before Flop (didn't bet)
Seat 8: HkZI6g4zl83TDTA7SRspmQ folded before Flop (didn't bet)



PokerStars Game #59939068336:  Hold'em No Limit ($0.25/$0.50) - 2009/07/01 0:30:32 ET
Table 'mTxf8gPLgffN3Iwfm7Icfg' 2-max Seat #2 is the button
Seat 1: Do9Rlu1R5u/AcRtMTl8SYg ($91.80 in chips)
Seat 2: EMc5LPgVaded4Qc77vm0fw ($67.80 in chips)
EMc5LPgVaded4Qc77vm0fw: posts small blind $0.25
Do9Rlu1R5u/AcRtMTl8SYg: posts big blind $0.50
*** HOLE CARDS ***
EMc5LPgVaded4Qc77vm0fw: folds
Do9Rlu1R5u/AcRtMTl8SYg collected $0.50 from pot
Do9Rlu1R5u/AcRtMTl8SYg: doesn't show hand
*** SUMMARY ***
Total pot $0.50 | Rake $0
Seat 1: Do9Rlu1R5u/AcRtMTl8SYg (big blind) collected ($0.50)
Seat 2: EMc5LPgVaded4Qc77vm0fw (button) (small blind) folded before Flop



PokerStars Game #59939068282:  Hold'em No Limit ($0.25/$0.50) - 2009/07/01 0:30:32 ET
Table '+dXkOAQyS8j9PQZusUTMpg' 2-max Seat #1 is the button
Seat 1: XFa6sBGjP2gxoIvxR3fZIg ($58.65 in chips)
Seat 2: 5IBeOgaApY1Bvzv2P8X4EA ($85.45 in chips)
XFa6sBGjP2gxoIvxR3fZIg: posts small blind $0.25
5IBeOgaApY1Bvzv2P8X4EA: posts big blind $0.50
*** HOLE CARDS ***
XFa6sBGjP2gxoIvxR3fZIg: raises $1 to $1.50
5IBeOgaApY1Bvzv2P8X4EA: folds
XFa6sBGjP2gxoIvxR3fZIg collected $1 from pot
*** SUMMARY ***
Total pot $1 | Rake $0
Seat 1: XFa6sBGjP2gxoIvxR3fZIg (button) (small blind) collected ($1)
Seat 2: 5IBeOgaApY1Bvzv2P8X4EA (big blind) folded before Flop



PokerStars Game #59939068556:  Hold'em No Limit ($0.25/$0.50) - 2009/07/01 0:30:32 ET
Table 'kI5Vcwq81ICnViGkH0RdAA' 2-max Seat #2 is the button
Seat 1: MUkHApRgMhpvwuGWL/ocLA ($20 in chips)
Seat 2: NLuFWBo8jk99TQd389Tijw ($25 in chips)
NLuFWBo8jk99TQd389Tijw: posts small blind $0.25
MUkHApRgMhpvwuGWL/ocLA: posts big blind $0.50
*** HOLE CARDS ***
NLuFWBo8jk99TQd389Tijw: calls $0.25
MUkHApRgMhpvwuGWL/ocLA: checks
*** FLOP *** [8c 9d Tc]
MUkHApRgMhpvwuGWL/ocLA: bets $0.50
NLuFWBo8jk99TQd389Tijw: calls $0.50
*** TURN *** [8c 9d Tc] [Qd]
MUkHApRgMhpvwuGWL/ocLA: checks
NLuFWBo8jk99TQd389Tijw: bets $3
MUkHApRgMhpvwuGWL/ocLA: folds
NLuFWBo8jk99TQd389Tijw collected $1.95 from pot
*** SUMMARY ***
Total pot $2 | Rake $0.05
Board [8c 9d Tc Qd]
Seat 1: MUkHApRgMhpvwuGWL/ocLA (big blind) folded on the Turn
Seat 2: NLuFWBo8jk99TQd389Tijw (button) (small blind) collected ($1.95)



PokerStars Game #59939068508:  Hold'em No Limit ($0.25/$0.50) - 2009/07/01 0:30:32 ET
Table 'EiNh8p/wGJ1FP575iMFnqg' 9-max Seat #6 is the button
Seat 1: r3ZqM1Mi0W3y4hOdssE+Sg ($49.50 in chips)
Seat 3: ymLPoEIl7UL3TvZYmnadxQ ($49.50 in chips)
Seat 4: HIIPkpiaCQfs5HcPKjlHvg ($32.45 in chips)
Seat 5: M+7+BTmX5vZatHVuoRB1nA ($85.85 in chips)
Seat 6: 3UmXLy3GfjC3EkOebduerQ ($56.40 in chips)
Seat 7: Wj7mKnRFR90j40wWUu2+Og ($80.05 in chips)
Seat 8: KrPAGRACBg+w0M//SXe8Ag ($10.80 in chips)
Seat 9: OMwFJ4pF0xk2Ru/AJiFeFw ($69.90 in chips)
Wj7mKnRFR90j40wWUu2+Og: posts small blind $0.25
KrPAGRACBg+w0M//SXe8Ag: posts big blind $0.50
8ehL7qlZzjgUh2H35iiWLw: sits out
*** HOLE CARDS ***
OMwFJ4pF0xk2Ru/AJiFeFw: folds
r3ZqM1Mi0W3y4hOdssE+Sg: calls $0.50
ymLPoEIl7UL3TvZYmnadxQ: calls $0.50
HIIPkpiaCQfs5HcPKjlHvg: calls $0.50
M+7+BTmX5vZatHVuoRB1nA: folds
3UmXLy3GfjC3EkOebduerQ: folds
Wj7mKnRFR90j40wWUu2+Og: calls $0.25
KrPAGRACBg+w0M//SXe8Ag: checks
*** FLOP *** [2s 2c 9c]
Wj7mKnRFR90j40wWUu2+Og: checks
KrPAGRACBg+w0M//SXe8Ag: checks
r3ZqM1Mi0W3y4hOdssE+Sg: checks
ymLPoEIl7UL3TvZYmnadxQ: checks
HIIPkpiaCQfs5HcPKjlHvg: checks
*** TURN *** [2s 2c 9c] [6d]
Wj7mKnRFR90j40wWUu2+Og: bets $0.50
KrPAGRACBg+w0M//SXe8Ag: folds
r3ZqM1Mi0W3y4hOdssE+Sg: folds
ymLPoEIl7UL3TvZYmnadxQ: calls $0.50
HIIPkpiaCQfs5HcPKjlHvg: folds
*** RIVER *** [2s 2c 9c 6d] [Jd]
Wj7mKnRFR90j40wWUu2+Og: checks
ymLPoEIl7UL3TvZYmnadxQ: checks
*** SHOW DOWN ***
Wj7mKnRFR90j40wWUu2+Og: shows [6s 7s] (two pair, Sixes and Deuces)
ymLPoEIl7UL3TvZYmnadxQ: shows [Th 9s] (two pair, Nines and Deuces)
ymLPoEIl7UL3TvZYmnadxQ collected $3.35 from pot
*** SUMMARY ***
Total pot $3.50 | Rake $0.15
Board [2s 2c 9c 6d Jd]
Seat 1: r3ZqM1Mi0W3y4hOdssE+Sg folded on the Turn
Seat 3: ymLPoEIl7UL3TvZYmnadxQ showed [Th 9s] and won ($3.35) with two pair, Nines and Deuces
Seat 4: HIIPkpiaCQfs5HcPKjlHvg folded on the Turn
Seat 5: M+7+BTmX5vZatHVuoRB1nA folded before Flop (didn't bet)
Seat 6: 3UmXLy3GfjC3EkOebduerQ (button) folded before Flop (didn't bet)
Seat 7: Wj7mKnRFR90j40wWUu2+Og (small blind) showed [6s 7s] and lost with two pair, Sixes and Deuces
Seat 8: KrPAGRACBg+w0M//SXe8Ag (big blind) folded on the Turn
Seat 9: OMwFJ4pF0xk2Ru/AJiFeFw folded before Flop (didn't bet)



PokerStars Game #59939070904:  Hold'em No Limit ($0.25/$0.50) - 2009/07/01 0:30:36 ET
Table 'c/CRn+68J3Y8KxD5g1ek2Q' 2-max Seat #2 is the button
Seat 1: 46qCyJ6evTkHo9al5sBMNA ($255 in chips)
Seat 2: BypVLsYQt3ePFm2xQL/dOA ($124.15 in chips)
BypVLsYQt3ePFm2xQL/dOA: posts small blind $0.25
46qCyJ6evTkHo9al5sBMNA: posts big blind $0.50
*** HOLE CARDS ***
BypVLsYQt3ePFm2xQL/dOA: calls $0.25
46qCyJ6evTkHo9al5sBMNA: checks
*** FLOP *** [2h 7s Qd]
46qCyJ6evTkHo9al5sBMNA: checks
BypVLsYQt3ePFm2xQL/dOA: checks
*** TURN *** [2h 7s Qd] [Ac]
46qCyJ6evTkHo9al5sBMNA: checks
BypVLsYQt3ePFm2xQL/dOA: checks
*** RIVER *** [2h 7s Qd Ac] [Jd]
46qCyJ6evTkHo9al5sBMNA: bets $2.50
BypVLsYQt3ePFm2xQL/dOA: raises $8 to $10.50
46qCyJ6evTkHo9al5sBMNA: calls $8
*** SHOW DOWN ***
BypVLsYQt3ePFm2xQL/dOA: shows [2d Jc] (two pair, Jacks and Deuces)
46qCyJ6evTkHo9al5sBMNA: mucks hand
BypVLsYQt3ePFm2xQL/dOA collected $21.50 from pot
*** SUMMARY ***
Total pot $22 | Rake $0.50
Board [2h 7s Qd Ac Jd]
Seat 1: 46qCyJ6evTkHo9al5sBMNA (big blind) mucked
Seat 2: BypVLsYQt3ePFm2xQL/dOA (button) (small blind) showed [2d Jc] and won ($21.50) with two pair, Jacks and Deuces



PokerStars Game #59939072582:  Hold'em No Limit ($0.25/$0.50) - 2009/07/01 0:30:38 ET
Table 'mTxf8gPLgffN3Iwfm7Icfg' 2-max Seat #1 is the button
Seat 1: Do9Rlu1R5u/AcRtMTl8SYg ($92.05 in chips)
Seat 2: EMc5LPgVaded4Qc77vm0fw ($67.55 in chips)
Do9Rlu1R5u/AcRtMTl8SYg: posts small blind $0.25
EMc5LPgVaded4Qc77vm0fw: posts big blind $0.50
*** HOLE CARDS ***
Do9Rlu1R5u/AcRtMTl8SYg: raises $1 to $1.50
EMc5LPgVaded4Qc77vm0fw: calls $1
*** FLOP *** [4c 7h Qh]
EMc5LPgVaded4Qc77vm0fw: bets $2.50
Do9Rlu1R5u/AcRtMTl8SYg: folds
EMc5LPgVaded4Qc77vm0fw collected $2.85 from pot
EMc5LPgVaded4Qc77vm0fw: doesn't show hand
*** SUMMARY ***
Total pot $3 | Rake $0.15
Board [4c 7h Qh]
Seat 1: Do9Rlu1R5u/AcRtMTl8SYg (button) (small blind) folded on the Flop
Seat 2: EMc5LPgVaded4Qc77vm0fw (big blind) collected ($2.85)



PokerStars Game #59939072004:  Hold'em No Limit ($0.25/$0.50) - 2009/07/01 0:30:38 ET
Table '+z1aekfHkpp09pc8F9aViw' 6-max Seat #4 is the button
Seat 1: wOyVV9M/oyiw3YaOjNZ05w ($52.55 in chips)
Seat 2: M6xK/VklCvdyyrmvzATlxQ ($38.30 in chips)
Seat 3: uUznlIMFnRUvwrBhYF73KA ($67.10 in chips)
Seat 4: RowCSpSURHTOL/dcjg/Iug ($33.20 in chips)
Seat 5: crjGpJEzSZgD38FoE3VMGg ($60.10 in chips)
Seat 6: 686aeHikcJlgKkSuIFdcXQ ($70.10 in chips)
crjGpJEzSZgD38FoE3VMGg: posts small blind $0.25
686aeHikcJlgKkSuIFdcXQ: posts big blind $0.50
*** HOLE CARDS ***
wOyVV9M/oyiw3YaOjNZ05w: folds
M6xK/VklCvdyyrmvzATlxQ: folds
uUznlIMFnRUvwrBhYF73KA: calls $0.50
RowCSpSURHTOL/dcjg/Iug: raises $1 to $1.50
crjGpJEzSZgD38FoE3VMGg: calls $1.25
686aeHikcJlgKkSuIFdcXQ: folds
uUznlIMFnRUvwrBhYF73KA: calls $1
*** FLOP *** [Js Qs Jc]
crjGpJEzSZgD38FoE3VMGg: checks
uUznlIMFnRUvwrBhYF73KA: checks
RowCSpSURHTOL/dcjg/Iug: checks
*** TURN *** [Js Qs Jc] [9c]
crjGpJEzSZgD38FoE3VMGg: checks
uUznlIMFnRUvwrBhYF73KA: checks
RowCSpSURHTOL/dcjg/Iug: bets $2
crjGpJEzSZgD38FoE3VMGg: calls $2
uUznlIMFnRUvwrBhYF73KA: raises $2 to $4
RowCSpSURHTOL/dcjg/Iug: calls $2
crjGpJEzSZgD38FoE3VMGg: calls $2
*** RIVER *** [Js Qs Jc 9c] [5h]
crjGpJEzSZgD38FoE3VMGg: checks
uUznlIMFnRUvwrBhYF73KA: checks
RowCSpSURHTOL/dcjg/Iug: bets $6
crjGpJEzSZgD38FoE3VMGg: folds
uUznlIMFnRUvwrBhYF73KA: calls $6
*** SHOW DOWN ***
RowCSpSURHTOL/dcjg/Iug: shows [Jd As] (three of a kind, Jacks)
uUznlIMFnRUvwrBhYF73KA: mucks hand
RowCSpSURHTOL/dcjg/Iug collected $27.60 from pot
*** SUMMARY ***
Total pot $29 | Rake $1.40
Board [Js Qs Jc 9c 5h]
Seat 1: wOyVV9M/oyiw3YaOjNZ05w folded before Flop (didn't bet)
Seat 2: M6xK/VklCvdyyrmvzATlxQ folded before Flop (didn't bet)
Seat 3: uUznlIMFnRUvwrBhYF73KA mucked
Seat 4: RowCSpSURHTOL/dcjg/Iug (button) showed [Jd As] and won ($27.60) with three of a kind, Jacks
Seat 5: crjGpJEzSZgD38FoE3VMGg (small blind) folded on the River
Seat 6: 686aeHikcJlgKkSuIFdcXQ (big blind) folded before Flop



PokerStars Game #59939072380:  Hold'em No Limit ($0.25/$0.50) - 2009/07/01 0:30:38 ET
Table 'lSisgp6H7Fg1hH5VfjEjYQ' 9-max Seat #3 is the button
Seat 1: pEW8B6uXbdR47kfljMQ3+Q ($37.85 in chips)
Seat 2: UrcnkQOiLVk8BlKDPJSy7Q ($52.75 in chips)
Seat 3: aTkyjTh3w5YLWiIERupZOA ($39.40 in chips)
Seat 4: bwv/rbH/hHhPhY6u9mu04w ($23.40 in chips)
Seat 5: mSD1pginDsyHG5PDfqzphw ($10 in chips)
Seat 6: +k7T5ocke8UwavtgUHm+Cg ($25.35 in chips)
Seat 7: dGw5MBstXyXhWHHVFOWOFA ($42 in chips)
Seat 8: a4JDWmpFQkL10XfAyuF51A ($38 in chips)
Seat 9: 5JJVDlaiMnB004o/RqbZZQ ($40.45 in chips)
bwv/rbH/hHhPhY6u9mu04w: posts small blind $0.25
mSD1pginDsyHG5PDfqzphw: posts big blind $0.50
*** HOLE CARDS ***
+k7T5ocke8UwavtgUHm+Cg: folds
dGw5MBstXyXhWHHVFOWOFA: folds
a4JDWmpFQkL10XfAyuF51A: folds
5JJVDlaiMnB004o/RqbZZQ: raises $1.50 to $2
pEW8B6uXbdR47kfljMQ3+Q: folds
UrcnkQOiLVk8BlKDPJSy7Q: calls $2
aTkyjTh3w5YLWiIERupZOA: folds
bwv/rbH/hHhPhY6u9mu04w: folds
mSD1pginDsyHG5PDfqzphw: folds
*** FLOP *** [2h 4c 6c]
5JJVDlaiMnB004o/RqbZZQ: bets $2.50
UrcnkQOiLVk8BlKDPJSy7Q: calls $2.50
*** TURN *** [2h 4c 6c] [Kd]
5JJVDlaiMnB004o/RqbZZQ: bets $4
UrcnkQOiLVk8BlKDPJSy7Q: folds
5JJVDlaiMnB004o/RqbZZQ collected $9.30 from pot
*** SUMMARY ***
Total pot $9.75 | Rake $0.45
Board [2h 4c 6c Kd]
Seat 1: pEW8B6uXbdR47kfljMQ3+Q folded before Flop (didn't bet)
Seat 2: UrcnkQOiLVk8BlKDPJSy7Q folded on the Turn
Seat 3: aTkyjTh3w5YLWiIERupZOA (button) folded before Flop (didn't bet)
Seat 4: bwv/rbH/hHhPhY6u9mu04w (small blind) folded before Flop
Seat 5: mSD1pginDsyHG5PDfqzphw (big blind) folded before Flop
Seat 6: +k7T5ocke8UwavtgUHm+Cg folded before Flop (didn't bet)
Seat 7: dGw5MBstXyXhWHHVFOWOFA folded before Flop (didn't bet)
Seat 8: a4JDWmpFQkL10XfAyuF51A folded before Flop (didn't bet)
Seat 9: 5JJVDlaiMnB004o/RqbZZQ collected ($9.30)



PokerStars Game #59939074038:  Hold'em No Limit ($0.25/$0.50) - 2009/07/01 0:30:41 ET
Table 'MJxeZCzYELxiIsyUZyT0jw' 6-max Seat #3 is the button
Seat 1: wOyVV9M/oyiw3YaOjNZ05w ($52.95 in chips)
Seat 2: dB6jzDlJmET84VMWw1mTRA ($50 in chips)
Seat 3: JQZew0FjzS19kTjeNtrE+A ($50.55 in chips)
Seat 4: lP7Q6pewz4C2RsAfKsjdWw ($36.20 in chips)
Seat 5: 3jvoOXNtXE90w2BdfNZwZQ ($53.80 in chips)
Seat 6: TTx3CHxyi0SObcHyMJRp5w ($48.95 in chips)
lP7Q6pewz4C2RsAfKsjdWw: posts small blind $0.25
3jvoOXNtXE90w2BdfNZwZQ: posts big blind $0.50
*** HOLE CARDS ***
TTx3CHxyi0SObcHyMJRp5w: folds
wOyVV9M/oyiw3YaOjNZ05w: raises $1.50 to $2
dB6jzDlJmET84VMWw1mTRA: folds
JQZew0FjzS19kTjeNtrE+A: folds
lP7Q6pewz4C2RsAfKsjdWw: folds
3jvoOXNtXE90w2BdfNZwZQ: folds
wOyVV9M/oyiw3YaOjNZ05w collected $1.25 from pot
wOyVV9M/oyiw3YaOjNZ05w: doesn't show hand
*** SUMMARY ***
Total pot $1.25 | Rake $0
Seat 1: wOyVV9M/oyiw3YaOjNZ05w collected ($1.25)
Seat 2: dB6jzDlJmET84VMWw1mTRA folded before Flop (didn't bet)
Seat 3: JQZew0FjzS19kTjeNtrE+A (button) folded before Flop (didn't bet)
Seat 4: lP7Q6pewz4C2RsAfKsjdWw (small blind) folded before Flop
Seat 5: 3jvoOXNtXE90w2BdfNZwZQ (big blind) folded before Flop
Seat 6: TTx3CHxyi0SObcHyMJRp5w folded before Flop (didn't bet)



PokerStars Game #59939074116:  Hold'em No Limit ($0.25/$0.50) - 2009/07/01 0:30:41 ET
Table 'E7bWJ45aoFXRpyRv2gw+Ig' 2-max Seat #2 is the button
Seat 1: FRkiRasEGlHUeLrEl+k/nA ($50 in chips)
Seat 2: 3Wro85I7472vJ4Wkpneo9A ($136.55 in chips)
3Wro85I7472vJ4Wkpneo9A: posts small blind $0.25
FRkiRasEGlHUeLrEl+k/nA: posts big blind $0.50
*** HOLE CARDS ***
3Wro85I7472vJ4Wkpneo9A: calls $0.25
FRkiRasEGlHUeLrEl+k/nA: checks
*** FLOP *** [Qc 7d 9d]
FRkiRasEGlHUeLrEl+k/nA: checks
3Wro85I7472vJ4Wkpneo9A: checks
*** TURN *** [Qc 7d 9d] [Qh]
FRkiRasEGlHUeLrEl+k/nA: bets $1.50
3Wro85I7472vJ4Wkpneo9A: calls $1.50
*** RIVER *** [Qc 7d 9d Qh] [6h]
FRkiRasEGlHUeLrEl+k/nA: bets $2
3Wro85I7472vJ4Wkpneo9A: calls $2
*** SHOW DOWN ***
FRkiRasEGlHUeLrEl+k/nA: shows [Qd 5c] (three of a kind, Queens)
3Wro85I7472vJ4Wkpneo9A: mucks hand
FRkiRasEGlHUeLrEl+k/nA collected $7.65 from pot
*** SUMMARY ***
Total pot $8 | Rake $0.35
Board [Qc 7d 9d Qh 6h]
Seat 1: FRkiRasEGlHUeLrEl+k/nA (big blind) showed [Qd 5c] and won ($7.65) with three of a kind, Queens
Seat 2: 3Wro85I7472vJ4Wkpneo9A (button) (small blind) mucked



PokerStars Game #59939075074:  Hold'em No Limit ($0.25/$0.50) - 2009/07/01 0:30:42 ET
Table '+dXkOAQyS8j9PQZusUTMpg' 2-max Seat #2 is the button
Seat 1: XFa6sBGjP2gxoIvxR3fZIg ($59.15 in chips)
Seat 2: 5IBeOgaApY1Bvzv2P8X4EA ($84.95 in chips)
5IBeOgaApY1Bvzv2P8X4EA: posts small blind $0.25
XFa6sBGjP2gxoIvxR3fZIg: posts big blind $0.50
*** HOLE CARDS ***
5IBeOgaApY1Bvzv2P8X4EA: folds
XFa6sBGjP2gxoIvxR3fZIg collected $0.50 from pot
*** SUMMARY ***
Total pot $0.50 | Rake $0
Seat 1: XFa6sBGjP2gxoIvxR3fZIg (big blind) collected ($0.50)
Seat 2: 5IBeOgaApY1Bvzv2P8X4EA (button) (small blind) folded before Flop



PokerStars Game #59939075958:  Hold'em No Limit ($0.25/$0.50) - 2009/07/01 0:30:43 ET
Table 'T/PgNWqVyY6lkldcBVXYJQ' 6-max Seat #6 is the button
Seat 1: +Pf9jTVizYlIo+woPvptfA ($57.05 in chips)
Seat 2: oZAeY5rVqNGgt8yyQ0pxbA ($38.05 in chips)
Seat 3: L3OcNO1bgdqDI46j67KQPQ ($54.60 in chips)
Seat 4: jxMvxeUUL9UU0V6wVU+Iyw ($9.20 in chips)
Seat 5: vVQBckETtigfb5mAcyK0OA ($50 in chips)
Seat 6: cDzbog6kwmJp+LBeBq+iMQ ($55.25 in chips)
+Pf9jTVizYlIo+woPvptfA: posts small blind $0.25
oZAeY5rVqNGgt8yyQ0pxbA: posts big blind $0.50
*** HOLE CARDS ***
vVQBckETtigfb5mAcyK0OA said, "cash in your food stamp boys"
L3OcNO1bgdqDI46j67KQPQ: folds
jxMvxeUUL9UU0V6wVU+Iyw: folds
vVQBckETtigfb5mAcyK0OA: calls $0.50
cDzbog6kwmJp+LBeBq+iMQ: folds
+Pf9jTVizYlIo+woPvptfA: calls $0.25
oZAeY5rVqNGgt8yyQ0pxbA: checks
*** FLOP *** [Qd 8d 6h]
jxMvxeUUL9UU0V6wVU+Iyw said, "been there done that."
+Pf9jTVizYlIo+woPvptfA: checks
oZAeY5rVqNGgt8yyQ0pxbA: checks
vVQBckETtigfb5mAcyK0OA: checks
*** TURN *** [Qd 8d 6h] [As]
+Pf9jTVizYlIo+woPvptfA: bets $1.25
jxMvxeUUL9UU0V6wVU+Iyw said, "bring it on biatckh"
oZAeY5rVqNGgt8yyQ0pxbA: folds
vVQBckETtigfb5mAcyK0OA: folds
+Pf9jTVizYlIo+woPvptfA collected $1.45 from pot
+Pf9jTVizYlIo+woPvptfA: doesn't show hand
*** SUMMARY ***
Total pot $1.50 | Rake $0.05
Board [Qd 8d 6h As]
Seat 1: +Pf9jTVizYlIo+woPvptfA (small blind) collected ($1.45)
Seat 2: oZAeY5rVqNGgt8yyQ0pxbA (big blind) folded on the Turn
Seat 3: L3OcNO1bgdqDI46j67KQPQ folded before Flop (didn't bet)
Seat 4: jxMvxeUUL9UU0V6wVU+Iyw folded before Flop (didn't bet)
Seat 5: vVQBckETtigfb5mAcyK0OA folded on the Turn
Seat 6: cDzbog6kwmJp+LBeBq+iMQ (button) folded before Flop (didn't bet)



PokerStars Game #59939077896:  Hold'em No Limit ($0.25/$0.50) - 2009/07/01 0:30:46 ET
Table 'kgbJRsxfv64KrErDRBAkcw' 6-max Seat #3 is the button
Seat 2: Q+thC23WCv1kJUJtH/+4Jw ($58.80 in chips)
Seat 3: T0Gx/FcQ5VH9u7XaOMX97A ($79.60 in chips)
Seat 4: qanMEqjABjWxC/JgQ/0l7w ($57.95 in chips)
Seat 5: +Pf9jTVizYlIo+woPvptfA ($50 in chips)
Seat 6: ozrlafxxh1HmYdA0/h+MuA ($14.25 in chips)
qanMEqjABjWxC/JgQ/0l7w: posts small blind $0.25
+Pf9jTVizYlIo+woPvptfA: posts big blind $0.50
mxTUARCsU8Eby0whmHNcOw: sits out
*** HOLE CARDS ***
ozrlafxxh1HmYdA0/h+MuA: calls $0.50
Q+thC23WCv1kJUJtH/+4Jw: folds
T0Gx/FcQ5VH9u7XaOMX97A: raises $2 to $2.50
qanMEqjABjWxC/JgQ/0l7w: folds
+Pf9jTVizYlIo+woPvptfA: folds
ozrlafxxh1HmYdA0/h+MuA: folds
T0Gx/FcQ5VH9u7XaOMX97A collected $1.75 from pot
T0Gx/FcQ5VH9u7XaOMX97A: doesn't show hand
*** SUMMARY ***
Total pot $1.75 | Rake $0
Seat 2: Q+thC23WCv1kJUJtH/+4Jw folded before Flop (didn't bet)
Seat 3: T0Gx/FcQ5VH9u7XaOMX97A (button) collected ($1.75)
Seat 4: qanMEqjABjWxC/JgQ/0l7w (small blind) folded before Flop
Seat 5: +Pf9jTVizYlIo+woPvptfA (big blind) folded before Flop
Seat 6: ozrlafxxh1HmYdA0/h+MuA folded before Flop



PokerStars Game #59939078964:  Hold'em No Limit ($0.25/$0.50) - 2009/07/01 0:30:48 ET
Table '+dXkOAQyS8j9PQZusUTMpg' 2-max Seat #1 is the button
Seat 1: XFa6sBGjP2gxoIvxR3fZIg ($59.40 in chips)
Seat 2: 5IBeOgaApY1Bvzv2P8X4EA ($84.70 in chips)
XFa6sBGjP2gxoIvxR3fZIg: posts small blind $0.25
5IBeOgaApY1Bvzv2P8X4EA: posts big blind $0.50
*** HOLE CARDS ***
XFa6sBGjP2gxoIvxR3fZIg: raises $1 to $1.50
5IBeOgaApY1Bvzv2P8X4EA: folds
XFa6sBGjP2gxoIvxR3fZIg collected $1 from pot
*** SUMMARY ***
Total pot $1 | Rake $0
Seat 1: XFa6sBGjP2gxoIvxR3fZIg (button) (small blind) collected ($1)
Seat 2: 5IBeOgaApY1Bvzv2P8X4EA (big blind) folded before Flop



PokerStars Game #59939080352:  Hold'em No Limit ($0.25/$0.50) - 2009/07/01 0:30:50 ET
Table 'QOgaEqMcJ73pcUMMxoisUg' 6-max Seat #3 is the button
Seat 2: Im2p1Nt83UKSqv5c9frm4Q ($50 in chips)
Seat 3: wUZNozoIDYf+16hp4nn6dw ($44.05 in chips)
Seat 4: zAcsDhG/T128Vn7XGVSgKg ($60.55 in chips)
Seat 5: 6vNxrjjCl6FwfaaymM9jjg ($26.80 in chips)
zAcsDhG/T128Vn7XGVSgKg: posts small blind $0.25
6vNxrjjCl6FwfaaymM9jjg: posts big blind $0.50
OZ6OtYh5Y53MCH/p0QTn5g: sits out
*** HOLE CARDS ***
Im2p1Nt83UKSqv5c9frm4Q: raises $1 to $1.50
wUZNozoIDYf+16hp4nn6dw: raises $1 to $2.50
zAcsDhG/T128Vn7XGVSgKg: folds
pmE+2KJb4nffAVqjLIXxFg joins the table at seat #6
6vNxrjjCl6FwfaaymM9jjg: folds
Im2p1Nt83UKSqv5c9frm4Q: calls $1
*** FLOP *** [Ah Tc Th]
Im2p1Nt83UKSqv5c9frm4Q: checks
wUZNozoIDYf+16hp4nn6dw: bets $1.50
Im2p1Nt83UKSqv5c9frm4Q: raises $4 to $5.50
wUZNozoIDYf+16hp4nn6dw: raises $4 to $9.50
Im2p1Nt83UKSqv5c9frm4Q: raises $8.50 to $18
wUZNozoIDYf+16hp4nn6dw: calls $8.50
*** TURN *** [Ah Tc Th] [Kc]
Im2p1Nt83UKSqv5c9frm4Q: bets $29.50 and is all-in
wUZNozoIDYf+16hp4nn6dw: calls $23.55 and is all-in
*** RIVER *** [Ah Tc Th Kc] [3c]
*** SHOW DOWN ***
Im2p1Nt83UKSqv5c9frm4Q: shows [As Kh] (two pair, Aces and Kings)
wUZNozoIDYf+16hp4nn6dw: mucks hand
Im2p1Nt83UKSqv5c9frm4Q collected $86.85 from pot
*** SUMMARY ***
Total pot $88.85 | Rake $2
Board [Ah Tc Th Kc 3c]
Seat 2: Im2p1Nt83UKSqv5c9frm4Q showed [As Kh] and won ($86.85) with two pair, Aces and Kings
Seat 3: wUZNozoIDYf+16hp4nn6dw (button) mucked
Seat 4: zAcsDhG/T128Vn7XGVSgKg (small blind) folded before Flop
Seat 5: 6vNxrjjCl6FwfaaymM9jjg (big blind) folded before Flop



PokerStars Game #59939081520:  Hold'em No Limit ($0.25/$0.50) - 2009/07/01 0:30:52 ET
Table 'IeNZOZQ4T6oiaHqFeo6yIA' 2-max Seat #2 is the button
Seat 1: ndd1nfncBkWNitBnsfCoVQ ($90.45 in chips)
Seat 2: A91IUl5JaZROhtfCtnnwYw ($41.20 in chips)
A91IUl5JaZROhtfCtnnwYw: posts small blind $0.25
ndd1nfncBkWNitBnsfCoVQ: posts big blind $0.50
*** HOLE CARDS ***
A91IUl5JaZROhtfCtnnwYw: calls $0.25
ndd1nfncBkWNitBnsfCoVQ: checks
*** FLOP *** [As 5s 7d]
ndd1nfncBkWNitBnsfCoVQ: bets $1
A91IUl5JaZROhtfCtnnwYw: calls $1
*** TURN *** [As 5s 7d] [Td]
ndd1nfncBkWNitBnsfCoVQ: bets $2.50
A91IUl5JaZROhtfCtnnwYw: folds
ndd1nfncBkWNitBnsfCoVQ collected $2.90 from pot
ndd1nfncBkWNitBnsfCoVQ: doesn't show hand
*** SUMMARY ***
Total pot $3 | Rake $0.10
Board [As 5s 7d Td]
Seat 1: ndd1nfncBkWNitBnsfCoVQ (big blind) collected ($2.90)
Seat 2: A91IUl5JaZROhtfCtnnwYw (button) (small blind) folded on the Turn



PokerStars Game #59939081880:  Hold'em No Limit ($0.25/$0.50) - 2009/07/01 0:30:52 ET
Table '/cQuAT3ef4t+PGrXiNhGaQ' 9-max Seat #5 is the button
Seat 2: jXGruyaMqirTaTXNOvBdew ($71.40 in chips)
Seat 3: g4k0NXISyLCqaSWZDBjfEg ($53.90 in chips)
Seat 4: OWP/DOu+PlPK6ZZ3zYa0HA ($41.65 in chips)
Seat 5: 5SgaHdWixdClWvaEG+KUjQ ($20.95 in chips)
Seat 6: APYIOyK/4AGb+kIwlOUNBQ ($43.25 in chips)
Seat 7: J0W5D97jl5VLky+IoPvDeA ($115.65 in chips)
Seat 8: W3ingbA178eb7J5rt1PuIQ ($22.65 in chips)
Seat 9: E2518gp4aFz1+kAgmGqeEg ($14.65 in chips)
APYIOyK/4AGb+kIwlOUNBQ: posts small blind $0.25
J0W5D97jl5VLky+IoPvDeA: posts big blind $0.50
HZkVla4kK2SI42CVrPZ/ig: sits out
*** HOLE CARDS ***
W3ingbA178eb7J5rt1PuIQ: raises $1 to $1.50
E2518gp4aFz1+kAgmGqeEg: folds
jXGruyaMqirTaTXNOvBdew: folds
g4k0NXISyLCqaSWZDBjfEg: folds
OWP/DOu+PlPK6ZZ3zYa0HA: folds
5SgaHdWixdClWvaEG+KUjQ: folds
APYIOyK/4AGb+kIwlOUNBQ: folds
J0W5D97jl5VLky+IoPvDeA: folds
W3ingbA178eb7J5rt1PuIQ collected $1.25 from pot
*** SUMMARY ***
Total pot $1.25 | Rake $0
Seat 2: jXGruyaMqirTaTXNOvBdew folded before Flop (didn't bet)
Seat 3: g4k0NXISyLCqaSWZDBjfEg folded before Flop (didn't bet)
Seat 4: OWP/DOu+PlPK6ZZ3zYa0HA folded before Flop (didn't bet)
Seat 5: 5SgaHdWixdClWvaEG+KUjQ (button) folded before Flop (didn't bet)
Seat 6: APYIOyK/4AGb+kIwlOUNBQ (small blind) folded before Flop
Seat 7: J0W5D97jl5VLky+IoPvDeA (big blind) folded before Flop
Seat 8: W3ingbA178eb7J5rt1PuIQ collected ($1.25)
Seat 9: E2518gp4aFz1+kAgmGqeEg folded before Flop (didn't bet)



PokerStars Game #59939082962:  Hold'em No Limit ($0.25/$0.50) - 2009/07/01 0:30:54 ET
Table 'GfL/No5u5PoEnU39lP5pQg' 6-max Seat #4 is the button
Seat 1: 1WUCqNG+p+vfWRTXNu4ljw ($52.30 in chips)
Seat 2: uVwggSetzp7d+eVgowO3vg ($57.80 in chips)
Seat 3: NbUTppWfym/RxV/DmDz2Sw ($14.10 in chips)
Seat 4: x+pzUFJsMIiGd7a5pcR4tg ($52.75 in chips)
Seat 5: crjGpJEzSZgD38FoE3VMGg ($54.35 in chips)
Seat 6: 3wylWYGeXFXcrE4XVrlPng ($80.45 in chips)
crjGpJEzSZgD38FoE3VMGg: posts small blind $0.25
3wylWYGeXFXcrE4XVrlPng: posts big blind $0.50
*** HOLE CARDS ***
1WUCqNG+p+vfWRTXNu4ljw: folds
uVwggSetzp7d+eVgowO3vg: folds
NbUTppWfym/RxV/DmDz2Sw: calls $0.50
x+pzUFJsMIiGd7a5pcR4tg: folds
crjGpJEzSZgD38FoE3VMGg: folds
3wylWYGeXFXcrE4XVrlPng: checks
*** FLOP *** [Th Ad 2s]
3wylWYGeXFXcrE4XVrlPng: checks
NbUTppWfym/RxV/DmDz2Sw: checks
*** TURN *** [Th Ad 2s] [4d]
3wylWYGeXFXcrE4XVrlPng: bets $1
NbUTppWfym/RxV/DmDz2Sw: calls $1
*** RIVER *** [Th Ad 2s 4d] [9d]
3wylWYGeXFXcrE4XVrlPng: checks
NbUTppWfym/RxV/DmDz2Sw: checks
*** SHOW DOWN ***
3wylWYGeXFXcrE4XVrlPng: shows [3d 3h] (a pair of Threes)
NbUTppWfym/RxV/DmDz2Sw: shows [5d 5h] (a pair of Fives)
NbUTppWfym/RxV/DmDz2Sw collected $3.10 from pot
*** SUMMARY ***
Total pot $3.25 | Rake $0.15
Board [Th Ad 2s 4d 9d]
Seat 1: 1WUCqNG+p+vfWRTXNu4ljw folded before Flop (didn't bet)
Seat 2: uVwggSetzp7d+eVgowO3vg folded before Flop (didn't bet)
Seat 3: NbUTppWfym/RxV/DmDz2Sw showed [5d 5h] and won ($3.10) with a pair of Fives
Seat 4: x+pzUFJsMIiGd7a5pcR4tg (button) folded before Flop (didn't bet)
Seat 5: crjGpJEzSZgD38FoE3VMGg (small blind) folded before Flop
Seat 6: 3wylWYGeXFXcrE4XVrlPng (big blind) showed [3d 3h] and lost with a pair of Threes



PokerStars Game #59939083534:  Hold'em No Limit ($0.25/$0.50) - 2009/07/01 0:30:55 ET
Table 'mTxf8gPLgffN3Iwfm7Icfg' 2-max Seat #2 is the button
Seat 1: Do9Rlu1R5u/AcRtMTl8SYg ($90.55 in chips)
Seat 2: EMc5LPgVaded4Qc77vm0fw ($68.90 in chips)
EMc5LPgVaded4Qc77vm0fw: posts small blind $0.25
Do9Rlu1R5u/AcRtMTl8SYg: posts big blind $0.50
*** HOLE CARDS ***
EMc5LPgVaded4Qc77vm0fw: calls $0.25
Do9Rlu1R5u/AcRtMTl8SYg: checks
*** FLOP *** [6h 3c 8h]
Do9Rlu1R5u/AcRtMTl8SYg: checks
EMc5LPgVaded4Qc77vm0fw: bets $1
Do9Rlu1R5u/AcRtMTl8SYg: folds
EMc5LPgVaded4Qc77vm0fw collected $0.95 from pot
EMc5LPgVaded4Qc77vm0fw: doesn't show hand
*** SUMMARY ***
Total pot $1 | Rake $0.05
Board [6h 3c 8h]
Seat 1: Do9Rlu1R5u/AcRtMTl8SYg (big blind) folded on the Flop
Seat 2: EMc5LPgVaded4Qc77vm0fw (button) (small blind) collected ($0.95)



PokerStars Game #59939083852:  Hold'em No Limit ($0.25/$0.50) - 2009/07/01 0:30:55 ET
Table 'otvGDROEDdqsabxskT79qg' 9-max Seat #5 is the button
Seat 1: 8ehL7qlZzjgUh2H35iiWLw ($50 in chips)
Seat 2: cCjTzH9jio8607WzjcfXlg ($9.30 in chips)
Seat 3: +k7T5ocke8UwavtgUHm+Cg ($74.65 in chips)
Seat 4: MG90wfSJZnOejs/KD3vlQQ ($53.60 in chips)
Seat 5: XNMDwbXt/Q4jM99AXnbJDw ($53.70 in chips)
Seat 6: bxLSulbgr8LmKNjOzw8URg ($49.50 in chips)
Seat 7: C7+tBppJrKgd/r+tuKUIpA ($37.65 in chips)
Seat 9: KcY3X8YpD74Kw1RHkx/g4A ($71.50 in chips)
bxLSulbgr8LmKNjOzw8URg: posts small blind $0.25
C7+tBppJrKgd/r+tuKUIpA: posts big blind $0.50
zE9cVigS2nW/Ljy4K4bUQA: sits out
*** HOLE CARDS ***
KcY3X8YpD74Kw1RHkx/g4A: folds
8ehL7qlZzjgUh2H35iiWLw: folds
cCjTzH9jio8607WzjcfXlg: calls $0.50
+k7T5ocke8UwavtgUHm+Cg: folds
MG90wfSJZnOejs/KD3vlQQ: raises $1.50 to $2
XNMDwbXt/Q4jM99AXnbJDw: folds
bxLSulbgr8LmKNjOzw8URg: folds
C7+tBppJrKgd/r+tuKUIpA: calls $1.50
cCjTzH9jio8607WzjcfXlg: folds
*** FLOP *** [4s 4c Jd]
C7+tBppJrKgd/r+tuKUIpA: checks
MG90wfSJZnOejs/KD3vlQQ: bets $3.75
C7+tBppJrKgd/r+tuKUIpA: folds
MG90wfSJZnOejs/KD3vlQQ collected $4.55 from pot
MG90wfSJZnOejs/KD3vlQQ: doesn't show hand
*** SUMMARY ***
Total pot $4.75 | Rake $0.20
Board [4s 4c Jd]
Seat 1: 8ehL7qlZzjgUh2H35iiWLw folded before Flop (didn't bet)
Seat 2: cCjTzH9jio8607WzjcfXlg folded before Flop
Seat 3: +k7T5ocke8UwavtgUHm+Cg folded before Flop (didn't bet)
Seat 4: MG90wfSJZnOejs/KD3vlQQ collected ($4.55)
Seat 5: XNMDwbXt/Q4jM99AXnbJDw (button) folded before Flop (didn't bet)
Seat 6: bxLSulbgr8LmKNjOzw8URg (small blind) folded before Flop
Seat 7: C7+tBppJrKgd/r+tuKUIpA (big blind) folded on the Flop
Seat 9: KcY3X8YpD74Kw1RHkx/g4A folded before Flop (didn't bet)



PokerStars Game #59939083978:  Hold'em No Limit ($0.25/$0.50) - 2009/07/01 0:30:56 ET
Table 'tyR5AZNKV8Aadbrnrnlg7g' 6-max Seat #4 is the button
Seat 1: R+KjpH/wSjDLhtIy9+edNA ($81 in chips)
Seat 2: 58zdeSBSuSFX/qZfhc7YmA ($34 in chips)
Seat 3: tdOvWynovql5imfooroLMg ($48.75 in chips)
Seat 4: Rt6KgtZ8YaJoTc3FPim00w ($83.95 in chips)
Seat 5: wOyVV9M/oyiw3YaOjNZ05w ($54.85 in chips)
Seat 6: ZKazl1hGaPiapDXincgi2Q ($29.70 in chips)
wOyVV9M/oyiw3YaOjNZ05w: posts small blind $0.25
ZKazl1hGaPiapDXincgi2Q: posts big blind $0.50
*** HOLE CARDS ***
R+KjpH/wSjDLhtIy9+edNA: folds
58zdeSBSuSFX/qZfhc7YmA: folds
tdOvWynovql5imfooroLMg: folds
Rt6KgtZ8YaJoTc3FPim00w: folds
wOyVV9M/oyiw3YaOjNZ05w: folds
ZKazl1hGaPiapDXincgi2Q collected $0.50 from pot
ZKazl1hGaPiapDXincgi2Q: doesn't show hand
*** SUMMARY ***
Total pot $0.50 | Rake $0
Seat 1: R+KjpH/wSjDLhtIy9+edNA folded before Flop (didn't bet)
Seat 2: 58zdeSBSuSFX/qZfhc7YmA folded before Flop (didn't bet)
Seat 3: tdOvWynovql5imfooroLMg folded before Flop (didn't bet)
Seat 4: Rt6KgtZ8YaJoTc3FPim00w (button) folded before Flop (didn't bet)
Seat 5: wOyVV9M/oyiw3YaOjNZ05w (small blind) folded before Flop
Seat 6: ZKazl1hGaPiapDXincgi2Q (big blind) collected ($0.50)



PokerStars Game #59939085100:  Hold'em No Limit ($0.25/$0.50) - 2009/07/01 0:30:57 ET
Table '+dXkOAQyS8j9PQZusUTMpg' 2-max Seat #2 is the button
Seat 1: XFa6sBGjP2gxoIvxR3fZIg ($59.90 in chips)
Seat 2: 5IBeOgaApY1Bvzv2P8X4EA ($84.20 in chips)
5IBeOgaApY1Bvzv2P8X4EA: posts small blind $0.25
XFa6sBGjP2gxoIvxR3fZIg: posts big blind $0.50
*** HOLE CARDS ***
5IBeOgaApY1Bvzv2P8X4EA: calls $0.25
XFa6sBGjP2gxoIvxR3fZIg: checks
*** FLOP *** [4c Ts 8h]
XFa6sBGjP2gxoIvxR3fZIg: checks
5IBeOgaApY1Bvzv2P8X4EA: bets $1
XFa6sBGjP2gxoIvxR3fZIg: folds
5IBeOgaApY1Bvzv2P8X4EA collected $0.95 from pot
5IBeOgaApY1Bvzv2P8X4EA: doesn't show hand
*** SUMMARY ***
Total pot $1 | Rake $0.05
Board [4c Ts 8h]
Seat 1: XFa6sBGjP2gxoIvxR3fZIg (big blind) folded on the Flop
Seat 2: 5IBeOgaApY1Bvzv2P8X4EA (button) (small blind) collected ($0.95)



PokerStars Game #59939085398:  Hold'em No Limit ($0.25/$0.50) - 2009/07/01 0:30:58 ET
Table 'kI5Vcwq81ICnViGkH0RdAA' 2-max Seat #1 is the button
Seat 1: MUkHApRgMhpvwuGWL/ocLA ($19 in chips)
Seat 2: NLuFWBo8jk99TQd389Tijw ($25.95 in chips)
MUkHApRgMhpvwuGWL/ocLA: posts small blind $0.25
NLuFWBo8jk99TQd389Tijw: posts big blind $0.50
*** HOLE CARDS ***
MUkHApRgMhpvwuGWL/ocLA: raises $1 to $1.50
NLuFWBo8jk99TQd389Tijw: calls $1
*** FLOP *** [4d 6c 9s]
NLuFWBo8jk99TQd389Tijw: bets $1
MUkHApRgMhpvwuGWL/ocLA: calls $1
*** TURN *** [4d 6c 9s] [3s]
NLuFWBo8jk99TQd389Tijw: checks
MUkHApRgMhpvwuGWL/ocLA: bets $3
NLuFWBo8jk99TQd389Tijw: folds
MUkHApRgMhpvwuGWL/ocLA collected $4.80 from pot
*** SUMMARY ***
Total pot $5 | Rake $0.20
Board [4d 6c 9s 3s]
Seat 1: MUkHApRgMhpvwuGWL/ocLA (button) (small blind) collected ($4.80)
Seat 2: NLuFWBo8jk99TQd389Tijw (big blind) folded on the Turn



PokerStars Game #59939087834:  Hold'em No Limit ($0.25/$0.50) - 2009/07/01 0:31:01 ET
Table 'NCiXr0d5CEKBQr/cZgLhbA' 9-max Seat #2 is the button
Seat 2: ulxuJchBV9iguXg0FUonfg ($24.20 in chips)
Seat 3: xZCXQSXlrZkp3pZizzVXCw ($57.15 in chips)
Seat 4: 5k9fvXD9suIgCxU4HLQjTw ($60.95 in chips)
Seat 5: zE9cVigS2nW/Ljy4K4bUQA ($39.50 in chips)
Seat 6: SKnJuWHScqetA/qG5p+wCg ($30 in chips)
Seat 7: M+7+BTmX5vZatHVuoRB1nA ($48.50 in chips)
Seat 8: 1MJUKc3cc0QmUoz1JZLR2w ($54.05 in chips)
Seat 9: 4WLZvqBn5qv5tds5kt5A1Q ($28.75 in chips)
xZCXQSXlrZkp3pZizzVXCw: posts small blind $0.25
5k9fvXD9suIgCxU4HLQjTw: posts big blind $0.50
pFtzb1sR4b0d1aw6aIRgDg: sits out
*** HOLE CARDS ***
zE9cVigS2nW/Ljy4K4bUQA: folds
SKnJuWHScqetA/qG5p+wCg: folds
M+7+BTmX5vZatHVuoRB1nA: folds
1MJUKc3cc0QmUoz1JZLR2w: folds
4WLZvqBn5qv5tds5kt5A1Q: folds
ulxuJchBV9iguXg0FUonfg: calls $0.50
xZCXQSXlrZkp3pZizzVXCw: folds
5k9fvXD9suIgCxU4HLQjTw: checks
*** FLOP *** [6h Ts 9h]
5k9fvXD9suIgCxU4HLQjTw: checks
ulxuJchBV9iguXg0FUonfg: bets $1
5k9fvXD9suIgCxU4HLQjTw: calls $1
*** TURN *** [6h Ts 9h] [Ad]
5k9fvXD9suIgCxU4HLQjTw: checks
ulxuJchBV9iguXg0FUonfg: bets $2
5k9fvXD9suIgCxU4HLQjTw: folds
ulxuJchBV9iguXg0FUonfg collected $3.10 from pot
*** SUMMARY ***
Total pot $3.25 | Rake $0.15
Board [6h Ts 9h Ad]
Seat 2: ulxuJchBV9iguXg0FUonfg (button) collected ($3.10)
Seat 3: xZCXQSXlrZkp3pZizzVXCw (small blind) folded before Flop
Seat 4: 5k9fvXD9suIgCxU4HLQjTw (big blind) folded on the Turn
Seat 5: zE9cVigS2nW/Ljy4K4bUQA folded before Flop (didn't bet)
Seat 6: SKnJuWHScqetA/qG5p+wCg folded before Flop (didn't bet)
Seat 7: M+7+BTmX5vZatHVuoRB1nA folded before Flop (didn't bet)
Seat 8: 1MJUKc3cc0QmUoz1JZLR2w folded before Flop (didn't bet)
Seat 9: 4WLZvqBn5qv5tds5kt5A1Q folded before Flop (didn't bet)



PokerStars Game #59939088522:  Hold'em No Limit ($0.25/$0.50) - 2009/07/01 0:31:02 ET
Table 'hSTs/dUsYLgJQuF2Onp0MQ' 6-max Seat #3 is the button
Seat 1: Donj3X7gYzeS5pAl7s9f+Q ($27.70 in chips)
Seat 2: 6vNxrjjCl6FwfaaymM9jjg ($26.35 in chips)
Seat 3: C3qJBo7uxfFVDluE1lmK2w ($29.25 in chips)
Seat 4: L0aIPg7qefDQjdJo3HCVEA ($9.15 in chips)
Seat 5: 686aeHikcJlgKkSuIFdcXQ ($60.65 in chips)
Seat 6: +laPa9P7BjZKKnR0n+OmvA ($9.70 in chips)
L0aIPg7qefDQjdJo3HCVEA: posts small blind $0.25
686aeHikcJlgKkSuIFdcXQ: posts big blind $0.50
*** HOLE CARDS ***
+laPa9P7BjZKKnR0n+OmvA: folds
Donj3X7gYzeS5pAl7s9f+Q: folds
6vNxrjjCl6FwfaaymM9jjg: folds
C3qJBo7uxfFVDluE1lmK2w: raises $1 to $1.50
L0aIPg7qefDQjdJo3HCVEA: folds
686aeHikcJlgKkSuIFdcXQ: folds
C3qJBo7uxfFVDluE1lmK2w collected $1.25 from pot
*** SUMMARY ***
Total pot $1.25 | Rake $0
Seat 1: Donj3X7gYzeS5pAl7s9f+Q folded before Flop (didn't bet)
Seat 2: 6vNxrjjCl6FwfaaymM9jjg folded before Flop (didn't bet)
Seat 3: C3qJBo7uxfFVDluE1lmK2w (button) collected ($1.25)
Seat 4: L0aIPg7qefDQjdJo3HCVEA (small blind) folded before Flop
Seat 5: 686aeHikcJlgKkSuIFdcXQ (big blind) folded before Flop
Seat 6: +laPa9P7BjZKKnR0n+OmvA folded before Flop (didn't bet)



PokerStars Game #59939089744:  Hold'em No Limit ($0.25/$0.50) - 2009/07/01 0:31:04 ET
Table 'MJxeZCzYELxiIsyUZyT0jw' 6-max Seat #4 is the button
Seat 1: wOyVV9M/oyiw3YaOjNZ05w ($53.70 in chips)
Seat 2: dB6jzDlJmET84VMWw1mTRA ($50 in chips)
Seat 3: JQZew0FjzS19kTjeNtrE+A ($50.55 in chips)
Seat 4: lP7Q6pewz4C2RsAfKsjdWw ($35.95 in chips)
Seat 5: 3jvoOXNtXE90w2BdfNZwZQ ($53.30 in chips)
Seat 6: TTx3CHxyi0SObcHyMJRp5w ($48.95 in chips)
3jvoOXNtXE90w2BdfNZwZQ: posts small blind $0.25
TTx3CHxyi0SObcHyMJRp5w: posts big blind $0.50
*** HOLE CARDS ***
wOyVV9M/oyiw3YaOjNZ05w: folds
dB6jzDlJmET84VMWw1mTRA: raises $1.50 to $2
JQZew0FjzS19kTjeNtrE+A: folds
lP7Q6pewz4C2RsAfKsjdWw: folds
3jvoOXNtXE90w2BdfNZwZQ: folds
TTx3CHxyi0SObcHyMJRp5w: folds
dB6jzDlJmET84VMWw1mTRA collected $1.25 from pot
dB6jzDlJmET84VMWw1mTRA: doesn't show hand
*** SUMMARY ***
Total pot $1.25 | Rake $0
Seat 1: wOyVV9M/oyiw3YaOjNZ05w folded before Flop (didn't bet)
Seat 2: dB6jzDlJmET84VMWw1mTRA collected ($1.25)
Seat 3: JQZew0FjzS19kTjeNtrE+A folded before Flop (didn't bet)
Seat 4: lP7Q6pewz4C2RsAfKsjdWw (button) folded before Flop (didn't bet)
Seat 5: 3jvoOXNtXE90w2BdfNZwZQ (small blind) folded before Flop
Seat 6: TTx3CHxyi0SObcHyMJRp5w (big blind) folded before Flop



PokerStars Game #59939092160:  Hold'em No Limit ($0.25/$0.50) - 2009/07/01 0:31:08 ET
Table '5EmHi+fnatGQQShcNmzOZQ' 6-max Seat #5 is the button
Seat 1: SwPczQo3cOtwEzhJrfO2cQ ($19.45 in chips)
Seat 2: vXIHnZ+dv/hwSBxyvGw7bQ ($50 in chips)
Seat 3: L9qfLYXrczhAPd/VckgsWw ($62.70 in chips)
Seat 4: wOyVV9M/oyiw3YaOjNZ05w ($56.60 in chips)
Seat 5: kxPhs4ePFqMy52CInAJ2aw ($61.85 in chips)
Seat 6: 686aeHikcJlgKkSuIFdcXQ ($140.90 in chips)
686aeHikcJlgKkSuIFdcXQ: posts small blind $0.25
SwPczQo3cOtwEzhJrfO2cQ: posts big blind $0.50
*** HOLE CARDS ***
vXIHnZ+dv/hwSBxyvGw7bQ: folds
L9qfLYXrczhAPd/VckgsWw: folds
wOyVV9M/oyiw3YaOjNZ05w: raises $1.25 to $1.75
kxPhs4ePFqMy52CInAJ2aw: calls $1.75
686aeHikcJlgKkSuIFdcXQ: folds
SwPczQo3cOtwEzhJrfO2cQ: raises $1.75 to $3.50
wOyVV9M/oyiw3YaOjNZ05w: calls $1.75
kxPhs4ePFqMy52CInAJ2aw: calls $1.75
*** FLOP *** [8h 4d Kc]
SwPczQo3cOtwEzhJrfO2cQ: bets $4.50
wOyVV9M/oyiw3YaOjNZ05w: folds
kxPhs4ePFqMy52CInAJ2aw: calls $4.50
*** TURN *** [8h 4d Kc] [4h]
SwPczQo3cOtwEzhJrfO2cQ: bets $5
kxPhs4ePFqMy52CInAJ2aw: folds
SwPczQo3cOtwEzhJrfO2cQ collected $18.80 from pot
*** SUMMARY ***
Total pot $19.75 | Rake $0.95
Board [8h 4d Kc 4h]
Seat 1: SwPczQo3cOtwEzhJrfO2cQ (big blind) collected ($18.80)
Seat 2: vXIHnZ+dv/hwSBxyvGw7bQ folded before Flop (didn't bet)
Seat 3: L9qfLYXrczhAPd/VckgsWw folded before Flop (didn't bet)
Seat 4: wOyVV9M/oyiw3YaOjNZ05w folded on the Flop
Seat 5: kxPhs4ePFqMy52CInAJ2aw (button) folded on the Turn
Seat 6: 686aeHikcJlgKkSuIFdcXQ (small blind) folded before Flop



PokerStars Game #59939093688:  Hold'em No Limit ($0.25/$0.50) - 2009/07/01 0:31:10 ET
Table '37qXEp3oe+er5q4CZip9eQ' 6-max Seat #2 is the button
Seat 1: oqOqoO2AyCZenUghCxMDxw ($50 in chips)
Seat 2: 6wzJiRvp8HY6t+MQGnSIzA ($19.10 in chips)
Seat 3: Rt6KgtZ8YaJoTc3FPim00w ($95.25 in chips)
Seat 4: XsmE8nXMAAMFJbWaJTmHFw ($19.80 in chips)
Seat 5: VOmI0x4dDPnTESZd5B4d1Q ($42.50 in chips)
Seat 6: l4m/wWPs22DSP5xpszjXKA ($9.25 in chips)
Rt6KgtZ8YaJoTc3FPim00w: posts small blind $0.25
XsmE8nXMAAMFJbWaJTmHFw: posts big blind $0.50
*** HOLE CARDS ***
VOmI0x4dDPnTESZd5B4d1Q: folds
l4m/wWPs22DSP5xpszjXKA: folds
oqOqoO2AyCZenUghCxMDxw: folds
6wzJiRvp8HY6t+MQGnSIzA: folds
Rt6KgtZ8YaJoTc3FPim00w: folds
XsmE8nXMAAMFJbWaJTmHFw collected $0.50 from pot
*** SUMMARY ***
Total pot $0.50 | Rake $0
Seat 1: oqOqoO2AyCZenUghCxMDxw folded before Flop (didn't bet)
Seat 2: 6wzJiRvp8HY6t+MQGnSIzA (button) folded before Flop (didn't bet)
Seat 3: Rt6KgtZ8YaJoTc3FPim00w (small blind) folded before Flop
Seat 4: XsmE8nXMAAMFJbWaJTmHFw (big blind) collected ($0.50)
Seat 5: VOmI0x4dDPnTESZd5B4d1Q folded before Flop (didn't bet)
Seat 6: l4m/wWPs22DSP5xpszjXKA folded before Flop (didn't bet)



PokerStars Game #59939093942:  Hold'em No Limit ($0.25/$0.50) - 2009/07/01 0:31:10 ET
Table 'IeNZOZQ4T6oiaHqFeo6yIA' 2-max Seat #1 is the button
Seat 1: ndd1nfncBkWNitBnsfCoVQ ($91.85 in chips)
Seat 2: A91IUl5JaZROhtfCtnnwYw ($39.70 in chips)
ndd1nfncBkWNitBnsfCoVQ: posts small blind $0.25
A91IUl5JaZROhtfCtnnwYw: posts big blind $0.50
*** HOLE CARDS ***
ndd1nfncBkWNitBnsfCoVQ: raises $1 to $1.50
A91IUl5JaZROhtfCtnnwYw: raises $1 to $2.50
ndd1nfncBkWNitBnsfCoVQ: calls $1
*** FLOP *** [9s 7c Ac]
A91IUl5JaZROhtfCtnnwYw: checks
ndd1nfncBkWNitBnsfCoVQ: checks
*** TURN *** [9s 7c Ac] [Kd]
A91IUl5JaZROhtfCtnnwYw: checks
ndd1nfncBkWNitBnsfCoVQ: checks
*** RIVER *** [9s 7c Ac Kd] [7h]
A91IUl5JaZROhtfCtnnwYw: checks
ndd1nfncBkWNitBnsfCoVQ: checks
*** SHOW DOWN ***
A91IUl5JaZROhtfCtnnwYw: shows [Ts Jd] (a pair of Sevens)
ndd1nfncBkWNitBnsfCoVQ: shows [4h Jc] (a pair of Sevens)
A91IUl5JaZROhtfCtnnwYw collected $2.40 from pot
ndd1nfncBkWNitBnsfCoVQ collected $2.35 from pot
*** SUMMARY ***
Total pot $5 | Rake $0.25
Board [9s 7c Ac Kd 7h]
Seat 1: ndd1nfncBkWNitBnsfCoVQ (button) (small blind) showed [4h Jc] and won ($2.35) with a pair of Sevens
Seat 2: A91IUl5JaZROhtfCtnnwYw (big blind) showed [Ts Jd] and won ($2.40) with a pair of Sevens



PokerStars Game #59939094220:  Hold'em No Limit ($0.25/$0.50) - 2009/07/01 0:31:11 ET
Table '+dXkOAQyS8j9PQZusUTMpg' 2-max Seat #1 is the button
Seat 1: XFa6sBGjP2gxoIvxR3fZIg ($59.40 in chips)
Seat 2: 5IBeOgaApY1Bvzv2P8X4EA ($84.65 in chips)
XFa6sBGjP2gxoIvxR3fZIg: posts small blind $0.25
5IBeOgaApY1Bvzv2P8X4EA: posts big blind $0.50
*** HOLE CARDS ***
XFa6sBGjP2gxoIvxR3fZIg: raises $1 to $1.50
5IBeOgaApY1Bvzv2P8X4EA: calls $1
*** FLOP *** [9c Tc 9d]
5IBeOgaApY1Bvzv2P8X4EA: checks
XFa6sBGjP2gxoIvxR3fZIg: bets $2
5IBeOgaApY1Bvzv2P8X4EA: calls $2
*** TURN *** [9c Tc 9d] [Qh]
5IBeOgaApY1Bvzv2P8X4EA: checks
XFa6sBGjP2gxoIvxR3fZIg: bets $5.50
5IBeOgaApY1Bvzv2P8X4EA: calls $5.50
*** RIVER *** [9c Tc 9d Qh] [Qs]
5IBeOgaApY1Bvzv2P8X4EA: bets $15.50
XFa6sBGjP2gxoIvxR3fZIg: raises $34.90 to $50.40 and is all-in
5IBeOgaApY1Bvzv2P8X4EA: calls $34.90
*** SHOW DOWN ***
XFa6sBGjP2gxoIvxR3fZIg: shows [Kc Qd] (a full house, Queens full of Nines)
5IBeOgaApY1Bvzv2P8X4EA: shows [9h Qc] (a full house, Queens full of Nines)
5IBeOgaApY1Bvzv2P8X4EA collected $59.15 from pot
XFa6sBGjP2gxoIvxR3fZIg collected $59.15 from pot
*** SUMMARY ***
Total pot $118.80 | Rake $0.50
Board [9c Tc 9d Qh Qs]
Seat 1: XFa6sBGjP2gxoIvxR3fZIg (button) (small blind) showed [Kc Qd] and won ($59.15) with a full house, Queens full of Nines
Seat 2: 5IBeOgaApY1Bvzv2P8X4EA (big blind) showed [9h Qc] and won ($59.15) with a full house, Queens full of Nines



PokerStars Game #59939096024:  Hold'em No Limit ($0.25/$0.50) - 2009/07/01 0:31:14 ET
Table 'c/CRn+68J3Y8KxD5g1ek2Q' 2-max Seat #1 is the button
Seat 1: 46qCyJ6evTkHo9al5sBMNA ($244 in chips)
Seat 2: BypVLsYQt3ePFm2xQL/dOA ($134.65 in chips)
46qCyJ6evTkHo9al5sBMNA: posts small blind $0.25
BypVLsYQt3ePFm2xQL/dOA: posts big blind $0.50
*** HOLE CARDS ***
46qCyJ6evTkHo9al5sBMNA: folds
BypVLsYQt3ePFm2xQL/dOA collected $0.50 from pot
BypVLsYQt3ePFm2xQL/dOA: doesn't show hand
*** SUMMARY ***
Total pot $0.50 | Rake $0
Seat 1: 46qCyJ6evTkHo9al5sBMNA (button) (small blind) folded before Flop
Seat 2: BypVLsYQt3ePFm2xQL/dOA (big blind) collected ($0.50)



PokerStars Game #59939096494:  Hold'em No Limit ($0.25/$0.50) - 2009/07/01 0:31:14 ET
Table 'tyR5AZNKV8Aadbrnrnlg7g' 6-max Seat #5 is the button
Seat 1: R+KjpH/wSjDLhtIy9+edNA ($81 in chips)
Seat 2: 58zdeSBSuSFX/qZfhc7YmA ($34 in chips)
Seat 3: tdOvWynovql5imfooroLMg ($48.75 in chips)
Seat 4: Rt6KgtZ8YaJoTc3FPim00w ($83.95 in chips)
Seat 5: wOyVV9M/oyiw3YaOjNZ05w ($54.60 in chips)
Seat 6: ZKazl1hGaPiapDXincgi2Q ($29.95 in chips)
ZKazl1hGaPiapDXincgi2Q: posts small blind $0.25
R+KjpH/wSjDLhtIy9+edNA: posts big blind $0.50
*** HOLE CARDS ***
58zdeSBSuSFX/qZfhc7YmA: raises $1 to $1.50
tdOvWynovql5imfooroLMg: folds
Rt6KgtZ8YaJoTc3FPim00w: folds
wOyVV9M/oyiw3YaOjNZ05w: folds
ZKazl1hGaPiapDXincgi2Q: calls $1.25
R+KjpH/wSjDLhtIy9+edNA: folds
*** FLOP *** [3h Qh 2d]
ZKazl1hGaPiapDXincgi2Q: checks
58zdeSBSuSFX/qZfhc7YmA: bets $2.50
ZKazl1hGaPiapDXincgi2Q: calls $2.50
*** TURN *** [3h Qh 2d] [3d]
ZKazl1hGaPiapDXincgi2Q: checks
58zdeSBSuSFX/qZfhc7YmA: checks
*** RIVER *** [3h Qh 2d 3d] [3c]
ZKazl1hGaPiapDXincgi2Q: checks
58zdeSBSuSFX/qZfhc7YmA: checks
*** SHOW DOWN ***
ZKazl1hGaPiapDXincgi2Q: shows [4c Ac] (three of a kind, Threes)
58zdeSBSuSFX/qZfhc7YmA: shows [Ks As] (three of a kind, Threes - Ace+King kicker)
58zdeSBSuSFX/qZfhc7YmA collected $8.10 from pot
*** SUMMARY ***
Total pot $8.50 | Rake $0.40
Board [3h Qh 2d 3d 3c]
Seat 1: R+KjpH/wSjDLhtIy9+edNA (big blind) folded before Flop
Seat 2: 58zdeSBSuSFX/qZfhc7YmA showed [Ks As] and won ($8.10) with three of a kind, Threes
Seat 3: tdOvWynovql5imfooroLMg folded before Flop (didn't bet)
Seat 4: Rt6KgtZ8YaJoTc3FPim00w folded before Flop (didn't bet)
Seat 5: wOyVV9M/oyiw3YaOjNZ05w (button) folded before Flop (didn't bet)
Seat 6: ZKazl1hGaPiapDXincgi2Q (small blind) showed [4c Ac] and lost with three of a kind, Threes



PokerStars Game #59939098042:  Hold'em No Limit ($0.25/$0.50) - 2009/07/01 0:31:16 ET
Table 'E7bWJ45aoFXRpyRv2gw+Ig' 2-max Seat #1 is the button
Seat 1: FRkiRasEGlHUeLrEl+k/nA ($53.65 in chips)
Seat 2: 3Wro85I7472vJ4Wkpneo9A ($132.55 in chips)
FRkiRasEGlHUeLrEl+k/nA: posts small blind $0.25
3Wro85I7472vJ4Wkpneo9A: posts big blind $0.50
*** HOLE CARDS ***
FRkiRasEGlHUeLrEl+k/nA: raises $1 to $1.50
3Wro85I7472vJ4Wkpneo9A: folds
FRkiRasEGlHUeLrEl+k/nA collected $1 from pot
*** SUMMARY ***
Total pot $1 | Rake $0
Seat 1: FRkiRasEGlHUeLrEl+k/nA (button) (small blind) collected ($1)
Seat 2: 3Wro85I7472vJ4Wkpneo9A (big blind) folded before Flop



PokerStars Game #59939098392:  Hold'em No Limit ($0.25/$0.50) - 2009/07/01 0:31:17 ET
Table 'kgbJRsxfv64KrErDRBAkcw' 6-max Seat #4 is the button
Seat 2: Q+thC23WCv1kJUJtH/+4Jw ($58.80 in chips)
Seat 3: T0Gx/FcQ5VH9u7XaOMX97A ($80.85 in chips)
Seat 4: qanMEqjABjWxC/JgQ/0l7w ($57.70 in chips)
Seat 5: +Pf9jTVizYlIo+woPvptfA ($50 in chips)
Seat 6: ozrlafxxh1HmYdA0/h+MuA ($13.75 in chips)
+Pf9jTVizYlIo+woPvptfA: posts small blind $0.25
ozrlafxxh1HmYdA0/h+MuA: posts big blind $0.50
mxTUARCsU8Eby0whmHNcOw: sits out
*** HOLE CARDS ***
Q+thC23WCv1kJUJtH/+4Jw: raises $1.50 to $2
T0Gx/FcQ5VH9u7XaOMX97A: folds
qanMEqjABjWxC/JgQ/0l7w: folds
+Pf9jTVizYlIo+woPvptfA: folds
ozrlafxxh1HmYdA0/h+MuA: folds
Q+thC23WCv1kJUJtH/+4Jw collected $1.25 from pot
*** SUMMARY ***
Total pot $1.25 | Rake $0
Seat 2: Q+thC23WCv1kJUJtH/+4Jw collected ($1.25)
Seat 3: T0Gx/FcQ5VH9u7XaOMX97A folded before Flop (didn't bet)
Seat 4: qanMEqjABjWxC/JgQ/0l7w (button) folded before Flop (didn't bet)
Seat 5: +Pf9jTVizYlIo+woPvptfA (small blind) folded before Flop
Seat 6: ozrlafxxh1HmYdA0/h+MuA (big blind) folded before Flop



PokerStars Game #59939098932:  Hold'em No Limit ($0.25/$0.50) - 2009/07/01 0:31:18 ET
Table 'mTxf8gPLgffN3Iwfm7Icfg' 2-max Seat #1 is the button
Seat 1: Do9Rlu1R5u/AcRtMTl8SYg ($90.05 in chips)
Seat 2: EMc5LPgVaded4Qc77vm0fw ($69.35 in chips)
Do9Rlu1R5u/AcRtMTl8SYg: posts small blind $0.25
EMc5LPgVaded4Qc77vm0fw: posts big blind $0.50
*** HOLE CARDS ***
Do9Rlu1R5u/AcRtMTl8SYg: folds
EMc5LPgVaded4Qc77vm0fw collected $0.50 from pot
EMc5LPgVaded4Qc77vm0fw: doesn't show hand
*** SUMMARY ***
Total pot $0.50 | Rake $0
Seat 1: Do9Rlu1R5u/AcRtMTl8SYg (button) (small blind) folded before Flop
Seat 2: EMc5LPgVaded4Qc77vm0fw (big blind) collected ($0.50)



PokerStars Game #59939100280:  Hold'em No Limit ($0.25/$0.50) - 2009/07/01 0:31:20 ET
Table 'c/CRn+68J3Y8KxD5g1ek2Q' 2-max Seat #2 is the button
Seat 1: 46qCyJ6evTkHo9al5sBMNA ($243.75 in chips)
Seat 2: BypVLsYQt3ePFm2xQL/dOA ($134.90 in chips)
BypVLsYQt3ePFm2xQL/dOA: posts small blind $0.25
46qCyJ6evTkHo9al5sBMNA: posts big blind $0.50
*** HOLE CARDS ***
BypVLsYQt3ePFm2xQL/dOA: calls $0.25
46qCyJ6evTkHo9al5sBMNA: checks
*** FLOP *** [Ac 7h Tc]
46qCyJ6evTkHo9al5sBMNA: checks
BypVLsYQt3ePFm2xQL/dOA: bets $1
46qCyJ6evTkHo9al5sBMNA: folds
BypVLsYQt3ePFm2xQL/dOA collected $0.95 from pot
BypVLsYQt3ePFm2xQL/dOA: doesn't show hand
*** SUMMARY ***
Total pot $1 | Rake $0.05
Board [Ac 7h Tc]
Seat 1: 46qCyJ6evTkHo9al5sBMNA (big blind) folded on the Flop
Seat 2: BypVLsYQt3ePFm2xQL/dOA (button) (small blind) collected ($0.95)



PokerStars Game #59939101026:  Hold'em No Limit ($0.25/$0.50) - 2009/07/01 0:31:21 ET
Table 'kI5Vcwq81ICnViGkH0RdAA' 2-max Seat #2 is the button
Seat 1: MUkHApRgMhpvwuGWL/ocLA ($21.30 in chips)
Seat 2: NLuFWBo8jk99TQd389Tijw ($23.45 in chips)
NLuFWBo8jk99TQd389Tijw: posts small blind $0.25
MUkHApRgMhpvwuGWL/ocLA: posts big blind $0.50
*** HOLE CARDS ***
NLuFWBo8jk99TQd389Tijw: calls $0.25
MUkHApRgMhpvwuGWL/ocLA: checks
*** FLOP *** [Kh Ad 2h]
MUkHApRgMhpvwuGWL/ocLA: bets $0.50
NLuFWBo8jk99TQd389Tijw: calls $0.50
*** TURN *** [Kh Ad 2h] [Ac]
MUkHApRgMhpvwuGWL/ocLA: checks
NLuFWBo8jk99TQd389Tijw: checks
*** RIVER *** [Kh Ad 2h Ac] [6s]
MUkHApRgMhpvwuGWL/ocLA: bets $1
NLuFWBo8jk99TQd389Tijw: calls $1
*** SHOW DOWN ***
MUkHApRgMhpvwuGWL/ocLA: shows [Qd Ks] (two pair, Aces and Kings)
NLuFWBo8jk99TQd389Tijw: shows [Kc 7h] (two pair, Aces and Kings - lower kicker)
MUkHApRgMhpvwuGWL/ocLA collected $3.85 from pot
*** SUMMARY ***
Total pot $4 | Rake $0.15
Board [Kh Ad 2h Ac 6s]
Seat 1: MUkHApRgMhpvwuGWL/ocLA (big blind) showed [Qd Ks] and won ($3.85) with two pair, Aces and Kings
Seat 2: NLuFWBo8jk99TQd389Tijw (button) (small blind) showed [Kc 7h] and lost with two pair, Aces and Kings



PokerStars Game #59939101948:  Hold'em No Limit ($0.25/$0.50) - 2009/07/01 0:31:22 ET
Table 'T/PgNWqVyY6lkldcBVXYJQ' 6-max Seat #1 is the button
Seat 1: +Pf9jTVizYlIo+woPvptfA ($58 in chips)
Seat 2: oZAeY5rVqNGgt8yyQ0pxbA ($37.55 in chips)
Seat 3: L3OcNO1bgdqDI46j67KQPQ ($54.60 in chips)
Seat 4: jxMvxeUUL9UU0V6wVU+Iyw ($9.20 in chips)
Seat 5: vVQBckETtigfb5mAcyK0OA ($49.50 in chips)
Seat 6: cDzbog6kwmJp+LBeBq+iMQ ($55.25 in chips)
oZAeY5rVqNGgt8yyQ0pxbA: posts small blind $0.25
L3OcNO1bgdqDI46j67KQPQ: posts big blind $0.50
*** HOLE CARDS ***
jxMvxeUUL9UU0V6wVU+Iyw: folds
vVQBckETtigfb5mAcyK0OA: folds
vVQBckETtigfb5mAcyK0OA said, "if i can get higher than a 9"
cDzbog6kwmJp+LBeBq+iMQ: folds
+Pf9jTVizYlIo+woPvptfA: folds
oZAeY5rVqNGgt8yyQ0pxbA: folds
L3OcNO1bgdqDI46j67KQPQ collected $0.50 from pot
L3OcNO1bgdqDI46j67KQPQ: doesn't show hand
*** SUMMARY ***
Total pot $0.50 | Rake $0
Seat 1: +Pf9jTVizYlIo+woPvptfA (button) folded before Flop (didn't bet)
Seat 2: oZAeY5rVqNGgt8yyQ0pxbA (small blind) folded before Flop
Seat 3: L3OcNO1bgdqDI46j67KQPQ (big blind) collected ($0.50)
Seat 4: jxMvxeUUL9UU0V6wVU+Iyw folded before Flop (didn't bet)
Seat 5: vVQBckETtigfb5mAcyK0OA folded before Flop (didn't bet)
Seat 6: cDzbog6kwmJp+LBeBq+iMQ folded before Flop (didn't bet)



PokerStars Game #59939102508:  Hold'em No Limit ($0.25/$0.50) - 2009/07/01 0:31:23 ET
Table '/cQuAT3ef4t+PGrXiNhGaQ' 9-max Seat #6 is the button
Seat 2: jXGruyaMqirTaTXNOvBdew ($71.40 in chips)
Seat 3: g4k0NXISyLCqaSWZDBjfEg ($53.90 in chips)
Seat 4: OWP/DOu+PlPK6ZZ3zYa0HA ($41.65 in chips)
Seat 5: 5SgaHdWixdClWvaEG+KUjQ ($20.95 in chips)
Seat 6: APYIOyK/4AGb+kIwlOUNBQ ($43 in chips)
Seat 7: J0W5D97jl5VLky+IoPvDeA ($115.15 in chips)
Seat 8: W3ingbA178eb7J5rt1PuIQ ($23.40 in chips)
Seat 9: E2518gp4aFz1+kAgmGqeEg ($14.65 in chips)
J0W5D97jl5VLky+IoPvDeA: posts small blind $0.25
W3ingbA178eb7J5rt1PuIQ: posts big blind $0.50
HZkVla4kK2SI42CVrPZ/ig: sits out
*** HOLE CARDS ***
E2518gp4aFz1+kAgmGqeEg: raises $1 to $1.50
jXGruyaMqirTaTXNOvBdew: folds
g4k0NXISyLCqaSWZDBjfEg: folds
OWP/DOu+PlPK6ZZ3zYa0HA: folds
5SgaHdWixdClWvaEG+KUjQ: folds
APYIOyK/4AGb+kIwlOUNBQ: folds
J0W5D97jl5VLky+IoPvDeA: folds
W3ingbA178eb7J5rt1PuIQ: calls $1
*** FLOP *** [Th Jd Qh]
W3ingbA178eb7J5rt1PuIQ: bets $3.50
E2518gp4aFz1+kAgmGqeEg: raises $9.65 to $13.15 and is all-in
W3ingbA178eb7J5rt1PuIQ: calls $9.65
*** TURN *** [Th Jd Qh] [4d]
*** RIVER *** [Th Jd Qh 4d] [8d]
*** SHOW DOWN ***
W3ingbA178eb7J5rt1PuIQ: shows [Js Qd] (two pair, Queens and Jacks)
E2518gp4aFz1+kAgmGqeEg: mucks hand
W3ingbA178eb7J5rt1PuIQ collected $28.10 from pot
*** SUMMARY ***
Total pot $29.55 | Rake $1.45
Board [Th Jd Qh 4d 8d]
Seat 2: jXGruyaMqirTaTXNOvBdew folded before Flop (didn't bet)
Seat 3: g4k0NXISyLCqaSWZDBjfEg folded before Flop (didn't bet)
Seat 4: OWP/DOu+PlPK6ZZ3zYa0HA folded before Flop (didn't bet)
Seat 5: 5SgaHdWixdClWvaEG+KUjQ folded before Flop (didn't bet)
Seat 6: APYIOyK/4AGb+kIwlOUNBQ (button) folded before Flop (didn't bet)
Seat 7: J0W5D97jl5VLky+IoPvDeA (small blind) folded before Flop
Seat 8: W3ingbA178eb7J5rt1PuIQ (big blind) showed [Js Qd] and won ($28.10) with two pair, Queens and Jacks
Seat 9: E2518gp4aFz1+kAgmGqeEg mucked



PokerStars Game #59939103290:  Hold'em No Limit ($0.25/$0.50) - 2009/07/01 0:31:24 ET
Table '3FhG0gl3kMX3wBEEqj+wnQ' 9-max Seat #3 is the button
Seat 1: e0J9pdCNUDTCG031RnXqLA ($17 in chips)
Seat 3: HZkVla4kK2SI42CVrPZ/ig ($8.75 in chips)
Seat 4: bz4LMfV0GGl/MJ/ABXuPmg ($21.35 in chips)
Seat 5: XNMDwbXt/Q4jM99AXnbJDw ($50 in chips)
Seat 6: 5JJVDlaiMnB004o/RqbZZQ ($45.05 in chips)
Seat 7: mSD1pginDsyHG5PDfqzphw ($10 in chips)
Seat 8: j3K/Jujr7PY4ZM2RZvlH6A ($58.20 in chips)
Seat 9: L5e2lrPLQm1Pqx30IIZ/Fw ($11.85 in chips)
bz4LMfV0GGl/MJ/ABXuPmg: posts small blind $0.25
XNMDwbXt/Q4jM99AXnbJDw: posts big blind $0.50
*** HOLE CARDS ***
4dl3YNqZ6Houm2jZAzDmRg leaves the table
7cYQ+syUWjl38ty/ICOMhw joins the table at seat #2
5JJVDlaiMnB004o/RqbZZQ: folds
mSD1pginDsyHG5PDfqzphw: folds
j3K/Jujr7PY4ZM2RZvlH6A: raises $0.50 to $1
L5e2lrPLQm1Pqx30IIZ/Fw: calls $1
e0J9pdCNUDTCG031RnXqLA: folds
HZkVla4kK2SI42CVrPZ/ig: folds
bz4LMfV0GGl/MJ/ABXuPmg: calls $0.75
XNMDwbXt/Q4jM99AXnbJDw: folds
*** FLOP *** [Kh Ks 7h]
bz4LMfV0GGl/MJ/ABXuPmg: checks
j3K/Jujr7PY4ZM2RZvlH6A: bets $1.50
L5e2lrPLQm1Pqx30IIZ/Fw: folds
bz4LMfV0GGl/MJ/ABXuPmg: folds
j3K/Jujr7PY4ZM2RZvlH6A collected $3.35 from pot
j3K/Jujr7PY4ZM2RZvlH6A: doesn't show hand
*** SUMMARY ***
Total pot $3.50 | Rake $0.15
Board [Kh Ks 7h]
Seat 1: e0J9pdCNUDTCG031RnXqLA folded before Flop (didn't bet)
Seat 3: HZkVla4kK2SI42CVrPZ/ig (button) folded before Flop (didn't bet)
Seat 4: bz4LMfV0GGl/MJ/ABXuPmg (small blind) folded on the Flop
Seat 5: XNMDwbXt/Q4jM99AXnbJDw (big blind) folded before Flop
Seat 6: 5JJVDlaiMnB004o/RqbZZQ folded before Flop (didn't bet)
Seat 7: mSD1pginDsyHG5PDfqzphw folded before Flop (didn't bet)
Seat 8: j3K/Jujr7PY4ZM2RZvlH6A collected ($3.35)
Seat 9: L5e2lrPLQm1Pqx30IIZ/Fw folded on the Flop



PokerStars Game #59939103378:  Hold'em No Limit ($0.25/$0.50) - 2009/07/01 0:31:24 ET
Table 'E7bWJ45aoFXRpyRv2gw+Ig' 2-max Seat #2 is the button
Seat 1: FRkiRasEGlHUeLrEl+k/nA ($54.15 in chips)
Seat 2: 3Wro85I7472vJ4Wkpneo9A ($132.05 in chips)
3Wro85I7472vJ4Wkpneo9A: posts small blind $0.25
FRkiRasEGlHUeLrEl+k/nA: posts big blind $0.50
*** HOLE CARDS ***
3Wro85I7472vJ4Wkpneo9A: raises $1 to $1.50
FRkiRasEGlHUeLrEl+k/nA: raises $3 to $4.50
3Wro85I7472vJ4Wkpneo9A: calls $3
*** FLOP *** [6s Ts 7h]
FRkiRasEGlHUeLrEl+k/nA: bets $3.50
3Wro85I7472vJ4Wkpneo9A: raises $10.50 to $14
FRkiRasEGlHUeLrEl+k/nA: folds
3Wro85I7472vJ4Wkpneo9A collected $15.50 from pot
3Wro85I7472vJ4Wkpneo9A: doesn't show hand
*** SUMMARY ***
Total pot $16 | Rake $0.50
Board [6s Ts 7h]
Seat 1: FRkiRasEGlHUeLrEl+k/nA (big blind) folded on the Flop
Seat 2: 3Wro85I7472vJ4Wkpneo9A (button) (small blind) collected ($15.50)



PokerStars Game #59939103764:  Hold'em No Limit ($0.25/$0.50) - 2009/07/01 0:31:25 ET
Table 'mTxf8gPLgffN3Iwfm7Icfg' 2-max Seat #2 is the button
Seat 1: Do9Rlu1R5u/AcRtMTl8SYg ($89.80 in chips)
Seat 2: EMc5LPgVaded4Qc77vm0fw ($69.60 in chips)
EMc5LPgVaded4Qc77vm0fw: posts small blind $0.25
Do9Rlu1R5u/AcRtMTl8SYg: posts big blind $0.50
*** HOLE CARDS ***
EMc5LPgVaded4Qc77vm0fw: folds
Do9Rlu1R5u/AcRtMTl8SYg collected $0.50 from pot
Do9Rlu1R5u/AcRtMTl8SYg: doesn't show hand
*** SUMMARY ***
Total pot $0.50 | Rake $0
Seat 1: Do9Rlu1R5u/AcRtMTl8SYg (big blind) collected ($0.50)
Seat 2: EMc5LPgVaded4Qc77vm0fw (button) (small blind) folded before Flop



PokerStars Game #59939104300:  Hold'em No Limit ($0.25/$0.50) - 2009/07/01 0:31:26 ET
Table '37qXEp3oe+er5q4CZip9eQ' 6-max Seat #3 is the button
Seat 1: oqOqoO2AyCZenUghCxMDxw ($50 in chips)
Seat 2: 6wzJiRvp8HY6t+MQGnSIzA ($19.10 in chips)
Seat 3: Rt6KgtZ8YaJoTc3FPim00w ($95 in chips)
Seat 4: XsmE8nXMAAMFJbWaJTmHFw ($20.05 in chips)
Seat 5: VOmI0x4dDPnTESZd5B4d1Q ($42.50 in chips)
Seat 6: l4m/wWPs22DSP5xpszjXKA ($9.25 in chips)
XsmE8nXMAAMFJbWaJTmHFw: posts small blind $0.25
VOmI0x4dDPnTESZd5B4d1Q: posts big blind $0.50
*** HOLE CARDS ***
l4m/wWPs22DSP5xpszjXKA: calls $0.50
oqOqoO2AyCZenUghCxMDxw: raises $1 to $1.50
6wzJiRvp8HY6t+MQGnSIzA: calls $1.50
Rt6KgtZ8YaJoTc3FPim00w: folds
XsmE8nXMAAMFJbWaJTmHFw: folds
VOmI0x4dDPnTESZd5B4d1Q: folds
l4m/wWPs22DSP5xpszjXKA: calls $1
*** FLOP *** [8h 6d 4s]
l4m/wWPs22DSP5xpszjXKA: checks
oqOqoO2AyCZenUghCxMDxw: bets $2.50
6wzJiRvp8HY6t+MQGnSIzA: folds
l4m/wWPs22DSP5xpszjXKA: folds
oqOqoO2AyCZenUghCxMDxw collected $5 from pot
*** SUMMARY ***
Total pot $5.25 | Rake $0.25
Board [8h 6d 4s]
Seat 1: oqOqoO2AyCZenUghCxMDxw collected ($5)
Seat 2: 6wzJiRvp8HY6t+MQGnSIzA folded on the Flop
Seat 3: Rt6KgtZ8YaJoTc3FPim00w (button) folded before Flop (didn't bet)
Seat 4: XsmE8nXMAAMFJbWaJTmHFw (small blind) folded before Flop
Seat 5: VOmI0x4dDPnTESZd5B4d1Q (big blind) folded before Flop
Seat 6: l4m/wWPs22DSP5xpszjXKA folded on the Flop



PokerStars Game #59939106454:  Hold'em No Limit ($0.25/$0.50) - 2009/07/01 0:31:29 ET
Table 'PALRfuH85dr5IkDfdv6new' 9-max Seat #3 is the button
Seat 1: SKnJuWHScqetA/qG5p+wCg ($30 in chips)
Seat 3: 50QWoELmpmHFrFIlWMJo9g ($85.95 in chips)
Seat 4: mZNMJI1mY40XTC0U7GZakA ($57.90 in chips)
Seat 5: jSSGUXdNFAZA3QCvTcUMQw ($43.45 in chips)
Seat 6: E2518gp4aFz1+kAgmGqeEg ($11.75 in chips)
Seat 7: 3NcyXvr39gnK+KbTq7ezyA ($39.25 in chips)
Seat 8: NkS+CseUKx4XHszWq0PXEQ ($44.65 in chips)
Seat 9: CIrAX/m6o7jYmKOAjJXv4Q ($36.45 in chips)
mZNMJI1mY40XTC0U7GZakA: posts small blind $0.25
jSSGUXdNFAZA3QCvTcUMQw: posts big blind $0.50
*** HOLE CARDS ***
E2518gp4aFz1+kAgmGqeEg: folds
3NcyXvr39gnK+KbTq7ezyA: folds
9r7ZoBbAJj5IeyZ0q9BdzA has returned
NkS+CseUKx4XHszWq0PXEQ: folds
CIrAX/m6o7jYmKOAjJXv4Q: folds
SKnJuWHScqetA/qG5p+wCg: folds
50QWoELmpmHFrFIlWMJo9g: raises $1 to $1.50
mZNMJI1mY40XTC0U7GZakA: folds
jSSGUXdNFAZA3QCvTcUMQw: folds
50QWoELmpmHFrFIlWMJo9g collected $1.25 from pot
50QWoELmpmHFrFIlWMJo9g: doesn't show hand
*** SUMMARY ***
Total pot $1.25 | Rake $0
Seat 1: SKnJuWHScqetA/qG5p+wCg folded before Flop (didn't bet)
Seat 3: 50QWoELmpmHFrFIlWMJo9g (button) collected ($1.25)
Seat 4: mZNMJI1mY40XTC0U7GZakA (small blind) folded before Flop
Seat 5: jSSGUXdNFAZA3QCvTcUMQw (big blind) folded before Flop
Seat 6: E2518gp4aFz1+kAgmGqeEg folded before Flop (didn't bet)
Seat 7: 3NcyXvr39gnK+KbTq7ezyA folded before Flop (didn't bet)
Seat 8: NkS+CseUKx4XHszWq0PXEQ folded before Flop (didn't bet)
Seat 9: CIrAX/m6o7jYmKOAjJXv4Q folded before Flop (didn't bet)



PokerStars Game #59939107468:  Hold'em No Limit ($0.25/$0.50) - 2009/07/01 0:31:30 ET
Table 'MJxeZCzYELxiIsyUZyT0jw' 6-max Seat #5 is the button
Seat 2: dB6jzDlJmET84VMWw1mTRA ($50.75 in chips)
Seat 3: JQZew0FjzS19kTjeNtrE+A ($50.55 in chips)
Seat 4: lP7Q6pewz4C2RsAfKsjdWw ($35.95 in chips)
Seat 5: 3jvoOXNtXE90w2BdfNZwZQ ($53.05 in chips)
Seat 6: TTx3CHxyi0SObcHyMJRp5w ($48.45 in chips)
TTx3CHxyi0SObcHyMJRp5w: posts small blind $0.25
wOyVV9M/oyiw3YaOjNZ05w: is sitting out
dB6jzDlJmET84VMWw1mTRA: posts big blind $0.50
*** HOLE CARDS ***
JQZew0FjzS19kTjeNtrE+A: folds
lP7Q6pewz4C2RsAfKsjdWw: calls $0.50
3jvoOXNtXE90w2BdfNZwZQ: folds
TTx3CHxyi0SObcHyMJRp5w: raises $1.50 to $2
dB6jzDlJmET84VMWw1mTRA: folds
lP7Q6pewz4C2RsAfKsjdWw: calls $1.50
*** FLOP *** [Td 5s As]
TTx3CHxyi0SObcHyMJRp5w: checks
lP7Q6pewz4C2RsAfKsjdWw: checks
*** TURN *** [Td 5s As] [Kd]
TTx3CHxyi0SObcHyMJRp5w: bets $2
lP7Q6pewz4C2RsAfKsjdWw: calls $2
*** RIVER *** [Td 5s As Kd] [2d]
TTx3CHxyi0SObcHyMJRp5w: bets $5
lP7Q6pewz4C2RsAfKsjdWw: folds
TTx3CHxyi0SObcHyMJRp5w collected $8.10 from pot
TTx3CHxyi0SObcHyMJRp5w: doesn't show hand
*** SUMMARY ***
Total pot $8.50 | Rake $0.40
Board [Td 5s As Kd 2d]
Seat 2: dB6jzDlJmET84VMWw1mTRA (big blind) folded before Flop
Seat 3: JQZew0FjzS19kTjeNtrE+A folded before Flop (didn't bet)
Seat 4: lP7Q6pewz4C2RsAfKsjdWw folded on the River
Seat 5: 3jvoOXNtXE90w2BdfNZwZQ (button) folded before Flop (didn't bet)
Seat 6: TTx3CHxyi0SObcHyMJRp5w (small blind) collected ($8.10)



PokerStars Game #59939108162:  Hold'em No Limit ($0.25/$0.50) - 2009/07/01 0:31:31 ET
Table 'kgbJRsxfv64KrErDRBAkcw' 6-max Seat #5 is the button
Seat 1: mxTUARCsU8Eby0whmHNcOw ($10 in chips)
Seat 2: Q+thC23WCv1kJUJtH/+4Jw ($59.55 in chips)
Seat 3: T0Gx/FcQ5VH9u7XaOMX97A ($80.85 in chips)
Seat 4: qanMEqjABjWxC/JgQ/0l7w ($57.70 in chips)
Seat 5: +Pf9jTVizYlIo+woPvptfA ($50 in chips)
Seat 6: ozrlafxxh1HmYdA0/h+MuA ($13.25 in chips)
ozrlafxxh1HmYdA0/h+MuA: posts small blind $0.25
mxTUARCsU8Eby0whmHNcOw: posts big blind $0.50
*** HOLE CARDS ***
Q+thC23WCv1kJUJtH/+4Jw: folds
T0Gx/FcQ5VH9u7XaOMX97A: folds
qanMEqjABjWxC/JgQ/0l7w: folds
+Pf9jTVizYlIo+woPvptfA: folds
ozrlafxxh1HmYdA0/h+MuA: calls $0.25
mxTUARCsU8Eby0whmHNcOw: checks
*** FLOP *** [Jd 6s 5d]
ozrlafxxh1HmYdA0/h+MuA: checks
mxTUARCsU8Eby0whmHNcOw: checks
*** TURN *** [Jd 6s 5d] [3h]
ozrlafxxh1HmYdA0/h+MuA: checks
mxTUARCsU8Eby0whmHNcOw: checks
*** RIVER *** [Jd 6s 5d 3h] [8d]
ozrlafxxh1HmYdA0/h+MuA: checks
mxTUARCsU8Eby0whmHNcOw: checks
*** SHOW DOWN ***
ozrlafxxh1HmYdA0/h+MuA: shows [Kc Ts] (high card King)
mxTUARCsU8Eby0whmHNcOw: mucks hand
ozrlafxxh1HmYdA0/h+MuA collected $0.95 from pot
*** SUMMARY ***
Total pot $1 | Rake $0.05
Board [Jd 6s 5d 3h 8d]
Seat 1: mxTUARCsU8Eby0whmHNcOw (big blind) mucked
Seat 2: Q+thC23WCv1kJUJtH/+4Jw folded before Flop (didn't bet)
Seat 3: T0Gx/FcQ5VH9u7XaOMX97A folded before Flop (didn't bet)
Seat 4: qanMEqjABjWxC/JgQ/0l7w folded before Flop (didn't bet)
Seat 5: +Pf9jTVizYlIo+woPvptfA (button) folded before Flop (didn't bet)
Seat 6: ozrlafxxh1HmYdA0/h+MuA (small blind) showed [Kc Ts] and won ($0.95) with high card King



PokerStars Game #59939107838:  Hold'em No Limit ($0.25/$0.50) - 2009/07/01 0:31:31 ET
Table 'mTxf8gPLgffN3Iwfm7Icfg' 2-max Seat #1 is the button
Seat 1: Do9Rlu1R5u/AcRtMTl8SYg ($90.05 in chips)
Seat 2: EMc5LPgVaded4Qc77vm0fw ($69.35 in chips)
Do9Rlu1R5u/AcRtMTl8SYg: posts small blind $0.25
EMc5LPgVaded4Qc77vm0fw: posts big blind $0.50
*** HOLE CARDS ***
Do9Rlu1R5u/AcRtMTl8SYg: folds
EMc5LPgVaded4Qc77vm0fw collected $0.50 from pot
EMc5LPgVaded4Qc77vm0fw: doesn't show hand
*** SUMMARY ***
Total pot $0.50 | Rake $0
Seat 1: Do9Rlu1R5u/AcRtMTl8SYg (button) (small blind) folded before Flop
Seat 2: EMc5LPgVaded4Qc77vm0fw (big blind) collected ($0.50)



PokerStars Game #59939111456:  Hold'em No Limit ($0.25/$0.50) - 2009/07/01 0:31:36 ET
Table 'IeNZOZQ4T6oiaHqFeo6yIA' 2-max Seat #2 is the button
Seat 1: ndd1nfncBkWNitBnsfCoVQ ($91.70 in chips)
Seat 2: A91IUl5JaZROhtfCtnnwYw ($39.60 in chips)
A91IUl5JaZROhtfCtnnwYw: posts small blind $0.25
ndd1nfncBkWNitBnsfCoVQ: posts big blind $0.50
*** HOLE CARDS ***
A91IUl5JaZROhtfCtnnwYw: calls $0.25
ndd1nfncBkWNitBnsfCoVQ: checks
*** FLOP *** [8d Kc 3c]
ndd1nfncBkWNitBnsfCoVQ: bets $1
A91IUl5JaZROhtfCtnnwYw: calls $1
*** TURN *** [8d Kc 3c] [Jd]
ndd1nfncBkWNitBnsfCoVQ: bets $2.50
A91IUl5JaZROhtfCtnnwYw: calls $2.50
*** RIVER *** [8d Kc 3c Jd] [Ac]
ndd1nfncBkWNitBnsfCoVQ: checks
A91IUl5JaZROhtfCtnnwYw: bets $5.50
ndd1nfncBkWNitBnsfCoVQ: folds
A91IUl5JaZROhtfCtnnwYw collected $7.65 from pot
A91IUl5JaZROhtfCtnnwYw: doesn't show hand
*** SUMMARY ***
Total pot $8 | Rake $0.35
Board [8d Kc 3c Jd Ac]
Seat 1: ndd1nfncBkWNitBnsfCoVQ (big blind) folded on the River
Seat 2: A91IUl5JaZROhtfCtnnwYw (button) (small blind) collected ($7.65)



PokerStars Game #59939113576:  Hold'em No Limit ($0.25/$0.50) - 2009/07/01 0:31:39 ET
Table 'mTxf8gPLgffN3Iwfm7Icfg' 2-max Seat #2 is the button
Seat 1: Do9Rlu1R5u/AcRtMTl8SYg ($89.80 in chips)
Seat 2: EMc5LPgVaded4Qc77vm0fw ($69.60 in chips)
EMc5LPgVaded4Qc77vm0fw: posts small blind $0.25
Do9Rlu1R5u/AcRtMTl8SYg: posts big blind $0.50
*** HOLE CARDS ***
EMc5LPgVaded4Qc77vm0fw: folds
Do9Rlu1R5u/AcRtMTl8SYg collected $0.50 from pot
Do9Rlu1R5u/AcRtMTl8SYg: doesn't show hand
*** SUMMARY ***
Total pot $0.50 | Rake $0
Seat 1: Do9Rlu1R5u/AcRtMTl8SYg (big blind) collected ($0.50)
Seat 2: EMc5LPgVaded4Qc77vm0fw (button) (small blind) folded before Flop



PokerStars Game #59939114358:  Hold'em No Limit ($0.25/$0.50) - 2009/07/01 0:31:40 ET
Table 'otvGDROEDdqsabxskT79qg' 9-max Seat #6 is the button
Seat 1: 8ehL7qlZzjgUh2H35iiWLw ($50 in chips)
Seat 2: cCjTzH9jio8607WzjcfXlg ($8.80 in chips)
Seat 3: +k7T5ocke8UwavtgUHm+Cg ($74.65 in chips)
Seat 4: MG90wfSJZnOejs/KD3vlQQ ($56.15 in chips)
Seat 5: XNMDwbXt/Q4jM99AXnbJDw ($53.70 in chips)
Seat 6: bxLSulbgr8LmKNjOzw8URg ($49.25 in chips)
Seat 7: C7+tBppJrKgd/r+tuKUIpA ($35.65 in chips)
Seat 8: zE9cVigS2nW/Ljy4K4bUQA ($30 in chips)
Seat 9: KcY3X8YpD74Kw1RHkx/g4A ($71.50 in chips)
C7+tBppJrKgd/r+tuKUIpA: posts small blind $0.25
zE9cVigS2nW/Ljy4K4bUQA: posts big blind $0.50
*** HOLE CARDS ***
KcY3X8YpD74Kw1RHkx/g4A: folds
8ehL7qlZzjgUh2H35iiWLw: folds
cCjTzH9jio8607WzjcfXlg: folds
+k7T5ocke8UwavtgUHm+Cg: folds
MG90wfSJZnOejs/KD3vlQQ: folds
XNMDwbXt/Q4jM99AXnbJDw: raises $1 to $1.50
bxLSulbgr8LmKNjOzw8URg: folds
C7+tBppJrKgd/r+tuKUIpA: calls $1.25
zE9cVigS2nW/Ljy4K4bUQA: folds
*** FLOP *** [8h 3s Qc]
C7+tBppJrKgd/r+tuKUIpA: checks
XNMDwbXt/Q4jM99AXnbJDw: bets $1.50
C7+tBppJrKgd/r+tuKUIpA: folds
XNMDwbXt/Q4jM99AXnbJDw collected $3.35 from pot
XNMDwbXt/Q4jM99AXnbJDw: doesn't show hand
*** SUMMARY ***
Total pot $3.50 | Rake $0.15
Board [8h 3s Qc]
Seat 1: 8ehL7qlZzjgUh2H35iiWLw folded before Flop (didn't bet)
Seat 2: cCjTzH9jio8607WzjcfXlg folded before Flop (didn't bet)
Seat 3: +k7T5ocke8UwavtgUHm+Cg folded before Flop (didn't bet)
Seat 4: MG90wfSJZnOejs/KD3vlQQ folded before Flop (didn't bet)
Seat 5: XNMDwbXt/Q4jM99AXnbJDw collected ($3.35)
Seat 6: bxLSulbgr8LmKNjOzw8URg (button) folded before Flop (didn't bet)
Seat 7: C7+tBppJrKgd/r+tuKUIpA (small blind) folded on the Flop
Seat 8: zE9cVigS2nW/Ljy4K4bUQA (big blind) folded before Flop
Seat 9: KcY3X8YpD74Kw1RHkx/g4A folded before Flop (didn't bet)



PokerStars Game #59939114488:  Hold'em No Limit ($0.25/$0.50) - 2009/07/01 0:31:41 ET
Table 'c/CRn+68J3Y8KxD5g1ek2Q' 2-max Seat #1 is the button
Seat 1: 46qCyJ6evTkHo9al5sBMNA ($243.25 in chips)
Seat 2: BypVLsYQt3ePFm2xQL/dOA ($135.35 in chips)
46qCyJ6evTkHo9al5sBMNA: posts small blind $0.25
BypVLsYQt3ePFm2xQL/dOA: posts big blind $0.50
*** HOLE CARDS ***
46qCyJ6evTkHo9al5sBMNA: folds
BypVLsYQt3ePFm2xQL/dOA collected $0.50 from pot
BypVLsYQt3ePFm2xQL/dOA: doesn't show hand
*** SUMMARY ***
Total pot $0.50 | Rake $0
Seat 1: 46qCyJ6evTkHo9al5sBMNA (button) (small blind) folded before Flop
Seat 2: BypVLsYQt3ePFm2xQL/dOA (big blind) collected ($0.50)



PokerStars Game #59939114530:  Hold'em No Limit ($0.25/$0.50) - 2009/07/01 0:31:41 ET
Table 'kI5Vcwq81ICnViGkH0RdAA' 2-max Seat #1 is the button
Seat 1: MUkHApRgMhpvwuGWL/ocLA ($23.15 in chips)
Seat 2: NLuFWBo8jk99TQd389Tijw ($21.45 in chips)
MUkHApRgMhpvwuGWL/ocLA: posts small blind $0.25
NLuFWBo8jk99TQd389Tijw: posts big blind $0.50
*** HOLE CARDS ***
MUkHApRgMhpvwuGWL/ocLA: raises $1 to $1.50
NLuFWBo8jk99TQd389Tijw: calls $1
*** FLOP *** [Kh 6s Ah]
NLuFWBo8jk99TQd389Tijw: bets $2
MUkHApRgMhpvwuGWL/ocLA: raises $2 to $4
NLuFWBo8jk99TQd389Tijw: calls $2
*** TURN *** [Kh 6s Ah] [Th]
NLuFWBo8jk99TQd389Tijw: bets $3.50
MUkHApRgMhpvwuGWL/ocLA: calls $3.50
*** RIVER *** [Kh 6s Ah Th] [Td]
NLuFWBo8jk99TQd389Tijw: bets $12.45 and is all-in
MUkHApRgMhpvwuGWL/ocLA: calls $12.45
*** SHOW DOWN ***
NLuFWBo8jk99TQd389Tijw: shows [Ad Ts] (a full house, Tens full of Aces)
MUkHApRgMhpvwuGWL/ocLA: mucks hand
NLuFWBo8jk99TQd389Tijw collected $42.40 from pot
*** SUMMARY ***
Total pot $42.90 | Rake $0.50
Board [Kh 6s Ah Th Td]
Seat 1: MUkHApRgMhpvwuGWL/ocLA (button) (small blind) mucked
Seat 2: NLuFWBo8jk99TQd389Tijw (big blind) showed [Ad Ts] and won ($42.40) with a full house, Tens full of Aces



PokerStars Game #59939114656:  Hold'em No Limit ($0.25/$0.50) - 2009/07/01 0:31:41 ET
Table 'Nz0Vr7WMHL2g5Uk7dDZjpw' 9-max Seat #3 is the button
Seat 2: XNMDwbXt/Q4jM99AXnbJDw ($50 in chips)
Seat 3: 4QTiNH5fteLgJjx/s6Hy6A ($14.35 in chips)
Seat 4: 5JJVDlaiMnB004o/RqbZZQ ($28 in chips)
Seat 5: WGW0DgjBUXs1ylURHG8vnQ ($15.90 in chips)
Seat 6: k1f0lS7tlMHCLGs0JT34Tg ($14.35 in chips)
Seat 7: KPLH0gELgFe2OuAnhJFI5w ($26.50 in chips)
Seat 8: HkZI6g4zl83TDTA7SRspmQ ($16.45 in chips)
Seat 9: Ak2W6V2TDVIQrvSAy4eD7Q ($26.25 in chips)
5JJVDlaiMnB004o/RqbZZQ: posts small blind $0.25
WGW0DgjBUXs1ylURHG8vnQ: posts big blind $0.50
*** HOLE CARDS ***
k1f0lS7tlMHCLGs0JT34Tg: calls $0.50
KPLH0gELgFe2OuAnhJFI5w: folds
HkZI6g4zl83TDTA7SRspmQ: folds
Ak2W6V2TDVIQrvSAy4eD7Q: raises $1 to $1.50
XNMDwbXt/Q4jM99AXnbJDw: raises $3.50 to $5
4QTiNH5fteLgJjx/s6Hy6A: folds
5JJVDlaiMnB004o/RqbZZQ: folds
WGW0DgjBUXs1ylURHG8vnQ: folds
k1f0lS7tlMHCLGs0JT34Tg: folds
Ak2W6V2TDVIQrvSAy4eD7Q: calls $3.50
*** FLOP *** [3d 7s Qd]
tLkxo7JgV+WWI0UBw44K5A is connected
Ak2W6V2TDVIQrvSAy4eD7Q: checks
XNMDwbXt/Q4jM99AXnbJDw: bets $4
tLkxo7JgV+WWI0UBw44K5A has returned
Ak2W6V2TDVIQrvSAy4eD7Q: calls $4
*** TURN *** [3d 7s Qd] [As]
Ak2W6V2TDVIQrvSAy4eD7Q: checks
XNMDwbXt/Q4jM99AXnbJDw: bets $9
Ak2W6V2TDVIQrvSAy4eD7Q: calls $9
*** RIVER *** [3d 7s Qd As] [4c]
Ak2W6V2TDVIQrvSAy4eD7Q: checks
XNMDwbXt/Q4jM99AXnbJDw: bets $9
Ak2W6V2TDVIQrvSAy4eD7Q: folds
XNMDwbXt/Q4jM99AXnbJDw collected $35.45 from pot
XNMDwbXt/Q4jM99AXnbJDw: doesn't show hand
*** SUMMARY ***
Total pot $37.25 | Rake $1.80
Board [3d 7s Qd As 4c]
Seat 2: XNMDwbXt/Q4jM99AXnbJDw collected ($35.45)
Seat 3: 4QTiNH5fteLgJjx/s6Hy6A (button) folded before Flop (didn't bet)
Seat 4: 5JJVDlaiMnB004o/RqbZZQ (small blind) folded before Flop
Seat 5: WGW0DgjBUXs1ylURHG8vnQ (big blind) folded before Flop
Seat 6: k1f0lS7tlMHCLGs0JT34Tg folded before Flop
Seat 7: KPLH0gELgFe2OuAnhJFI5w folded before Flop (didn't bet)
Seat 8: HkZI6g4zl83TDTA7SRspmQ folded before Flop (didn't bet)
Seat 9: Ak2W6V2TDVIQrvSAy4eD7Q folded on the River



PokerStars Game #59939117546:  Hold'em No Limit ($0.25/$0.50) - 2009/07/01 0:31:45 ET
Table 'GfL/No5u5PoEnU39lP5pQg' 6-max Seat #5 is the button
Seat 1: 1WUCqNG+p+vfWRTXNu4ljw ($52.30 in chips)
Seat 2: uVwggSetzp7d+eVgowO3vg ($57.80 in chips)
Seat 3: NbUTppWfym/RxV/DmDz2Sw ($15.70 in chips)
Seat 4: x+pzUFJsMIiGd7a5pcR4tg ($52.75 in chips)
Seat 5: crjGpJEzSZgD38FoE3VMGg ($54.10 in chips)
Seat 6: 3wylWYGeXFXcrE4XVrlPng ($78.95 in chips)
3wylWYGeXFXcrE4XVrlPng: posts small blind $0.25
1WUCqNG+p+vfWRTXNu4ljw: posts big blind $0.50
*** HOLE CARDS ***
uVwggSetzp7d+eVgowO3vg: raises $1.50 to $2
NbUTppWfym/RxV/DmDz2Sw: folds
x+pzUFJsMIiGd7a5pcR4tg: folds
crjGpJEzSZgD38FoE3VMGg: calls $2
3wylWYGeXFXcrE4XVrlPng: folds
3wylWYGeXFXcrE4XVrlPng is sitting out
1WUCqNG+p+vfWRTXNu4ljw: calls $1.50
*** FLOP *** [5h 2c Jd]
1WUCqNG+p+vfWRTXNu4ljw: checks
uVwggSetzp7d+eVgowO3vg: checks
crjGpJEzSZgD38FoE3VMGg: bets $3
1WUCqNG+p+vfWRTXNu4ljw: folds
uVwggSetzp7d+eVgowO3vg: folds
crjGpJEzSZgD38FoE3VMGg collected $5.95 from pot
crjGpJEzSZgD38FoE3VMGg: doesn't show hand
*** SUMMARY ***
Total pot $6.25 | Rake $0.30
Board [5h 2c Jd]
Seat 1: 1WUCqNG+p+vfWRTXNu4ljw (big blind) folded on the Flop
Seat 2: uVwggSetzp7d+eVgowO3vg folded on the Flop
Seat 3: NbUTppWfym/RxV/DmDz2Sw folded before Flop (didn't bet)
Seat 4: x+pzUFJsMIiGd7a5pcR4tg folded before Flop (didn't bet)
Seat 5: crjGpJEzSZgD38FoE3VMGg (button) collected ($5.95)
Seat 6: 3wylWYGeXFXcrE4XVrlPng (small blind) folded before Flop



PokerStars Game #59939117920:  Hold'em No Limit ($0.25/$0.50) - 2009/07/01 0:31:46 ET
Table 'T/PgNWqVyY6lkldcBVXYJQ' 6-max Seat #2 is the button
Seat 1: +Pf9jTVizYlIo+woPvptfA ($58 in chips)
Seat 2: oZAeY5rVqNGgt8yyQ0pxbA ($37.30 in chips)
Seat 3: L3OcNO1bgdqDI46j67KQPQ ($54.85 in chips)
Seat 4: jxMvxeUUL9UU0V6wVU+Iyw ($9.20 in chips)
Seat 5: vVQBckETtigfb5mAcyK0OA ($49.50 in chips)
Seat 6: cDzbog6kwmJp+LBeBq+iMQ ($55.25 in chips)
L3OcNO1bgdqDI46j67KQPQ: posts small blind $0.25
jxMvxeUUL9UU0V6wVU+Iyw: posts big blind $0.50
*** HOLE CARDS ***
vVQBckETtigfb5mAcyK0OA: calls $0.50
cDzbog6kwmJp+LBeBq+iMQ: folds
+Pf9jTVizYlIo+woPvptfA: folds
oZAeY5rVqNGgt8yyQ0pxbA: raises $1.50 to $2
L3OcNO1bgdqDI46j67KQPQ: folds
jxMvxeUUL9UU0V6wVU+Iyw: folds
vVQBckETtigfb5mAcyK0OA: folds
oZAeY5rVqNGgt8yyQ0pxbA collected $1.75 from pot
oZAeY5rVqNGgt8yyQ0pxbA: doesn't show hand
*** SUMMARY ***
Total pot $1.75 | Rake $0
Seat 1: +Pf9jTVizYlIo+woPvptfA folded before Flop (didn't bet)
Seat 2: oZAeY5rVqNGgt8yyQ0pxbA (button) collected ($1.75)
Seat 3: L3OcNO1bgdqDI46j67KQPQ (small blind) folded before Flop
Seat 4: jxMvxeUUL9UU0V6wVU+Iyw (big blind) folded before Flop
Seat 5: vVQBckETtigfb5mAcyK0OA folded before Flop
Seat 6: cDzbog6kwmJp+LBeBq+iMQ folded before Flop (didn't bet)



PokerStars Game #59939117792:  Hold'em No Limit ($0.25/$0.50) - 2009/07/01 0:31:46 ET
Table 'mTxf8gPLgffN3Iwfm7Icfg' 2-max Seat #1 is the button
Seat 1: Do9Rlu1R5u/AcRtMTl8SYg ($90.05 in chips)
Seat 2: EMc5LPgVaded4Qc77vm0fw ($69.35 in chips)
Do9Rlu1R5u/AcRtMTl8SYg: posts small blind $0.25
EMc5LPgVaded4Qc77vm0fw: posts big blind $0.50
*** HOLE CARDS ***
Do9Rlu1R5u/AcRtMTl8SYg: folds
EMc5LPgVaded4Qc77vm0fw collected $0.50 from pot
EMc5LPgVaded4Qc77vm0fw: doesn't show hand
*** SUMMARY ***
Total pot $0.50 | Rake $0
Seat 1: Do9Rlu1R5u/AcRtMTl8SYg (button) (small blind) folded before Flop
Seat 2: EMc5LPgVaded4Qc77vm0fw (big blind) collected ($0.50)



PokerStars Game #59939118820:  Hold'em No Limit ($0.25/$0.50) - 2009/07/01 0:31:47 ET
Table 'c/CRn+68J3Y8KxD5g1ek2Q' 2-max Seat #2 is the button
Seat 1: 46qCyJ6evTkHo9al5sBMNA ($243 in chips)
Seat 2: BypVLsYQt3ePFm2xQL/dOA ($135.60 in chips)
BypVLsYQt3ePFm2xQL/dOA: posts small blind $0.25
46qCyJ6evTkHo9al5sBMNA: posts big blind $0.50
*** HOLE CARDS ***
BypVLsYQt3ePFm2xQL/dOA: raises $1 to $1.50
46qCyJ6evTkHo9al5sBMNA: raises $4.50 to $6
BypVLsYQt3ePFm2xQL/dOA: calls $4.50
*** FLOP *** [7c 7d Kd]
46qCyJ6evTkHo9al5sBMNA: checks
BypVLsYQt3ePFm2xQL/dOA: bets $0.50
46qCyJ6evTkHo9al5sBMNA: raises $7.50 to $8
BypVLsYQt3ePFm2xQL/dOA: folds
46qCyJ6evTkHo9al5sBMNA collected $12.50 from pot
46qCyJ6evTkHo9al5sBMNA: doesn't show hand
*** SUMMARY ***
Total pot $13 | Rake $0.50
Board [7c 7d Kd]
Seat 1: 46qCyJ6evTkHo9al5sBMNA (big blind) collected ($12.50)
Seat 2: BypVLsYQt3ePFm2xQL/dOA (button) (small blind) folded on the Flop



PokerStars Game #59939118460:  Hold'em No Limit ($0.25/$0.50) - 2009/07/01 0:31:47 ET
Table 'hSTs/dUsYLgJQuF2Onp0MQ' 6-max Seat #4 is the button
Seat 1: Donj3X7gYzeS5pAl7s9f+Q ($27.70 in chips)
Seat 2: 6vNxrjjCl6FwfaaymM9jjg ($26.35 in chips)
Seat 3: C3qJBo7uxfFVDluE1lmK2w ($30 in chips)
Seat 4: L0aIPg7qefDQjdJo3HCVEA ($8.90 in chips)
Seat 5: 686aeHikcJlgKkSuIFdcXQ ($60.15 in chips)
Seat 6: +laPa9P7BjZKKnR0n+OmvA ($9.70 in chips)
686aeHikcJlgKkSuIFdcXQ: posts small blind $0.25
+laPa9P7BjZKKnR0n+OmvA: posts big blind $0.50
*** HOLE CARDS ***
Donj3X7gYzeS5pAl7s9f+Q: folds
6vNxrjjCl6FwfaaymM9jjg: raises $2 to $2.50
C3qJBo7uxfFVDluE1lmK2w: folds
L0aIPg7qefDQjdJo3HCVEA: folds
686aeHikcJlgKkSuIFdcXQ: folds
+laPa9P7BjZKKnR0n+OmvA: raises $7.20 to $9.70 and is all-in
6vNxrjjCl6FwfaaymM9jjg: calls $7.20
*** FLOP *** [Jc 7c Kd]
*** TURN *** [Jc 7c Kd] [7s]
*** RIVER *** [Jc 7c Kd 7s] [8c]
*** SHOW DOWN ***
+laPa9P7BjZKKnR0n+OmvA: shows [Qh Qd] (two pair, Queens and Sevens)
6vNxrjjCl6FwfaaymM9jjg: shows [Kh Js] (two pair, Kings and Jacks)
6vNxrjjCl6FwfaaymM9jjg collected $18.70 from pot
*** SUMMARY ***
Total pot $19.65 | Rake $0.95
Board [Jc 7c Kd 7s 8c]
Seat 1: Donj3X7gYzeS5pAl7s9f+Q folded before Flop (didn't bet)
Seat 2: 6vNxrjjCl6FwfaaymM9jjg showed [Kh Js] and won ($18.70) with two pair, Kings and Jacks
Seat 3: C3qJBo7uxfFVDluE1lmK2w folded before Flop (didn't bet)
Seat 4: L0aIPg7qefDQjdJo3HCVEA (button) folded before Flop (didn't bet)
Seat 5: 686aeHikcJlgKkSuIFdcXQ (small blind) folded before Flop
Seat 6: +laPa9P7BjZKKnR0n+OmvA (big blind) showed [Qh Qd] and lost with two pair, Queens and Sevens



PokerStars Game #59939118886:  Hold'em No Limit ($0.25/$0.50) - 2009/07/01 0:31:47 ET
Table 'fx6MqwfYAj/Rt86hBz2L3Q' 9-max Seat #8 is the button
Seat 1: jf2c/o9gI7Xj0GleCSMj9g ($51 in chips)
Seat 2: C3rGXblctNcWI6JYPHhaEg ($25.75 in chips)
Seat 3: iadBi5AEt7gTBXbDSSnMYQ ($46.30 in chips)
Seat 4: gPEN9Zp33YTm/mu9/SYP1w ($23.20 in chips)
Seat 5: iAISe3dVeua8PUn2wwgDHw ($14.40 in chips)
Seat 6: 5k9fvXD9suIgCxU4HLQjTw ($50 in chips)
Seat 7: bkXkL3pmapikPQQRNPZSEA ($16.15 in chips)
Seat 8: CAuekkxPVzBL9SK4Tjjbuw ($29 in chips)
Seat 9: HZkVla4kK2SI42CVrPZ/ig ($8.75 in chips)
HZkVla4kK2SI42CVrPZ/ig: posts small blind $0.25
jf2c/o9gI7Xj0GleCSMj9g: posts big blind $0.50
*** HOLE CARDS ***
C3rGXblctNcWI6JYPHhaEg: calls $0.50
iadBi5AEt7gTBXbDSSnMYQ: raises $1 to $1.50
gPEN9Zp33YTm/mu9/SYP1w: folds
iAISe3dVeua8PUn2wwgDHw: raises $1 to $2.50
5k9fvXD9suIgCxU4HLQjTw: folds
bkXkL3pmapikPQQRNPZSEA: folds
CAuekkxPVzBL9SK4Tjjbuw: folds
HZkVla4kK2SI42CVrPZ/ig: folds
jf2c/o9gI7Xj0GleCSMj9g: folds
C3rGXblctNcWI6JYPHhaEg: folds
iadBi5AEt7gTBXbDSSnMYQ: raises $2.50 to $5
iAISe3dVeua8PUn2wwgDHw: calls $2.50
*** FLOP *** [9s 2c 7h]
iadBi5AEt7gTBXbDSSnMYQ: bets $41.30 and is all-in
iAISe3dVeua8PUn2wwgDHw: calls $9.40 and is all-in
*** TURN *** [9s 2c 7h] [Kd]
*** RIVER *** [9s 2c 7h Kd] [Th]
*** SHOW DOWN ***
iadBi5AEt7gTBXbDSSnMYQ: shows [Js Jd] (a pair of Jacks)
iAISe3dVeua8PUn2wwgDHw: mucks hand
iadBi5AEt7gTBXbDSSnMYQ collected $28.60 from pot
*** SUMMARY ***
Total pot $30.05 | Rake $1.45
Board [9s 2c 7h Kd Th]
Seat 1: jf2c/o9gI7Xj0GleCSMj9g (big blind) folded before Flop
Seat 2: C3rGXblctNcWI6JYPHhaEg folded before Flop
Seat 3: iadBi5AEt7gTBXbDSSnMYQ showed [Js Jd] and won ($28.60) with a pair of Jacks
Seat 4: gPEN9Zp33YTm/mu9/SYP1w folded before Flop (didn't bet)
Seat 5: iAISe3dVeua8PUn2wwgDHw mucked
Seat 6: 5k9fvXD9suIgCxU4HLQjTw folded before Flop (didn't bet)
Seat 7: bkXkL3pmapikPQQRNPZSEA folded before Flop (didn't bet)
Seat 8: CAuekkxPVzBL9SK4Tjjbuw (button) folded before Flop (didn't bet)
Seat 9: HZkVla4kK2SI42CVrPZ/ig (small blind) folded before Flop



PokerStars Game #59939119206:  Hold'em No Limit ($0.25/$0.50) - 2009/07/01 0:31:48 ET
Table 'QOgaEqMcJ73pcUMMxoisUgErOuyGLI5PT3G5MnpHgC/g Seat #9 is the button
Seat 1: L5e2lrPLQm1Pqx30IIZ/Fw ($10 in chips)
Seat 2: RjBdQ6w31rgcy0o24VLR6w ($10.20 in chips)
Seat 3: xZCXQSXlrZkp3pZizzVXCw ($49.75 in chips)
Seat 4: 3UmXLy3GfjC3EkOebduerQ ($50 in chips)
Seat 5: JwvquocWfhTVApN5t47LgA ($57.80 in chips)
Seat 6: zE9cVigS2nW/Ljy4K4bUQA ($30 in chips)
Seat 7: 90Wb75h3W1BRpbqVnuk8gw ($72.65 in chips)
Seat 8: g4k0NXISyLCqaSWZDBjfEg ($50 in chips)
Seat 9: J0W5D97jl5VLky+IoPvDeA ($56.40 in chips)
L5e2lrPLQm1Pqx30IIZ/Fw: posts small blind $0.25
RjBdQ6w31rgcy0o24VLR6w: posts big blind $0.50
*** HOLE CARDS ***
xZCXQSXlrZkp3pZizzVXCw: folds
3UmXLy3GfjC3EkOebduerQ: folds
JwvquocWfhTVApN5t47LgA: folds
zE9cVigS2nW/Ljy4K4bUQA: raises $1 to $1.50
90Wb75h3W1BRpbqVnuk8gw: folds
g4k0NXISyLCqaSWZDBjfEg: calls $1.50
J0W5D97jl5VLky+IoPvDeA: folds
L5e2lrPLQm1Pqx30IIZ/Fw: folds
RjBdQ6w31rgcy0o24VLR6w: folds
*** FLOP *** [Tc 2h 7h]
zE9cVigS2nW/Ljy4K4bUQA: checks
g4k0NXISyLCqaSWZDBjfEg: checks
*** TURN *** [Tc 2h 7h] [8h]
zE9cVigS2nW/Ljy4K4bUQA: checks
g4k0NXISyLCqaSWZDBjfEg: checks
*** RIVER *** [Tc 2h 7h 8h] [5s]
zE9cVigS2nW/Ljy4K4bUQA: checks
g4k0NXISyLCqaSWZDBjfEg: checks
*** SHOW DOWN ***
zE9cVigS2nW/Ljy4K4bUQA: shows [Jc Ac] (high card Ace)
g4k0NXISyLCqaSWZDBjfEg: shows [Qs As] (high card Ace - Queen kicker)
g4k0NXISyLCqaSWZDBjfEg collected $3.60 from pot
*** SUMMARY ***
Total pot $3.75 | Rake $0.15
Board [Tc 2h 7h 8h 5s]
Seat 1: L5e2lrPLQm1Pqx30IIZ/Fw (small blind) folded before Flop
Seat 2: RjBdQ6w31rgcy0o24VLR6w (big blind) folded before Flop
Seat 3: xZCXQSXlrZkp3pZizzVXCw folded before Flop (didn't bet)
Seat 4: 3UmXLy3GfjC3EkOebduerQ folded before Flop (didn't bet)
Seat 5: JwvquocWfhTVApN5t47LgA folded before Flop (didn't bet)
Seat 6: zE9cVigS2nW/Ljy4K4bUQA showed [Jc Ac] and lost with high card Ace
Seat 7: 90Wb75h3W1BRpbqVnuk8gw folded before Flop (didn't bet)
Seat 8: g4k0NXISyLCqaSWZDBjfEg showed [Qs As] and won ($3.60) with high card Ace
Seat 9: J0W5D97jl5VLky+IoPvDeA (button) folded before Flop (didn't bet)



PokerStars Game #59939121932:  Hold'em No Limit ($0.25/$0.50) - 2009/07/01 0:31:52 ET
Table 'eMxdLyFDf28E0wit6gm3Uw' 6-max Seat #2 is the button
Seat 1: GtdWeBVCZhDBcNFRTOb8Hg ($10 in chips)
Seat 2: jwuKQ1S3U4NnzMQn3E3dgw ($66.90 in chips)
Seat 3: dZcLsEI8iXkobBduRJ45Yw ($19.10 in chips)
Seat 4: QM93o65lI8kLzmiB/BILlA ($13.25 in chips)
Seat 6: L0aIPg7qefDQjdJo3HCVEA ($10.55 in chips)
dZcLsEI8iXkobBduRJ45Yw: posts small blind $0.25
QM93o65lI8kLzmiB/BILlA: posts big blind $0.50
GtdWeBVCZhDBcNFRTOb8Hg: posts big blind $0.50
*** HOLE CARDS ***
L0aIPg7qefDQjdJo3HCVEA: raises $0.50 to $1
GtdWeBVCZhDBcNFRTOb8Hg: folds
jwuKQ1S3U4NnzMQn3E3dgw: calls $1
dZcLsEI8iXkobBduRJ45Yw: calls $0.75
QM93o65lI8kLzmiB/BILlA: calls $0.50
*** FLOP *** [Qh Jh 5d]
dZcLsEI8iXkobBduRJ45Yw: checks
QM93o65lI8kLzmiB/BILlA: checks
L0aIPg7qefDQjdJo3HCVEA: checks
jwuKQ1S3U4NnzMQn3E3dgw: checks
*** TURN *** [Qh Jh 5d] [7s]
dZcLsEI8iXkobBduRJ45Yw: checks
QM93o65lI8kLzmiB/BILlA: checks
L0aIPg7qefDQjdJo3HCVEA: checks
jwuKQ1S3U4NnzMQn3E3dgw: checks
*** RIVER *** [Qh Jh 5d 7s] [7c]
dZcLsEI8iXkobBduRJ45Yw: checks
QM93o65lI8kLzmiB/BILlA: checks
L0aIPg7qefDQjdJo3HCVEA: checks
jwuKQ1S3U4NnzMQn3E3dgw: bets $6.50
dZcLsEI8iXkobBduRJ45Yw: folds
QM93o65lI8kLzmiB/BILlA: folds
L0aIPg7qefDQjdJo3HCVEA: folds
jwuKQ1S3U4NnzMQn3E3dgw collected $4.30 from pot
*** SUMMARY ***
Total pot $4.50 | Rake $0.20
Board [Qh Jh 5d 7s 7c]
Seat 1: GtdWeBVCZhDBcNFRTOb8Hg folded before Flop
Seat 2: jwuKQ1S3U4NnzMQn3E3dgw (button) collected ($4.30)
Seat 3: dZcLsEI8iXkobBduRJ45Yw (small blind) folded on the River
Seat 4: QM93o65lI8kLzmiB/BILlA (big blind) folded on the River
Seat 6: L0aIPg7qefDQjdJo3HCVEA folded on the River



PokerStars Game #59939121756:  Hold'em No Limit ($0.25/$0.50) - 2009/07/01 0:31:52 ET
Table 'E7bWJ45aoFXRpyRv2gw+Ig' 2-max Seat #1 is the button
Seat 1: FRkiRasEGlHUeLrEl+k/nA ($50 in chips)
Seat 2: 3Wro85I7472vJ4Wkpneo9A ($139.55 in chips)
FRkiRasEGlHUeLrEl+k/nA: posts small blind $0.25
3Wro85I7472vJ4Wkpneo9A: posts big blind $0.50
*** HOLE CARDS ***
FRkiRasEGlHUeLrEl+k/nA: raises $1 to $1.50
3Wro85I7472vJ4Wkpneo9A: folds
FRkiRasEGlHUeLrEl+k/nA collected $1 from pot
*** SUMMARY ***
Total pot $1 | Rake $0
Seat 1: FRkiRasEGlHUeLrEl+k/nA (button) (small blind) collected ($1)
Seat 2: 3Wro85I7472vJ4Wkpneo9A (big blind) folded before Flop



PokerStars Game #59939121796:  Hold'em No Limit ($0.25/$0.50) - 2009/07/01 0:31:52 ET
Table 'mTxf8gPLgffN3Iwfm7Icfg' 2-max Seat #2 is the button
Seat 1: Do9Rlu1R5u/AcRtMTl8SYg ($89.80 in chips)
Seat 2: EMc5LPgVaded4Qc77vm0fw ($69.60 in chips)
EMc5LPgVaded4Qc77vm0fw: posts small blind $0.25
Do9Rlu1R5u/AcRtMTl8SYg: posts big blind $0.50
*** HOLE CARDS ***
EMc5LPgVaded4Qc77vm0fw: raises $1 to $1.50
Do9Rlu1R5u/AcRtMTl8SYg: folds
EMc5LPgVaded4Qc77vm0fw collected $1 from pot
EMc5LPgVaded4Qc77vm0fw: doesn't show hand
*** SUMMARY ***
Total pot $1 | Rake $0
Seat 1: Do9Rlu1R5u/AcRtMTl8SYg (big blind) folded before Flop
Seat 2: EMc5LPgVaded4Qc77vm0fw (button) (small blind) collected ($1)



PokerStars Game #59939122184:  Hold'em No Limit ($0.25/$0.50) - 2009/07/01 0:31:52 ET
Table 'EiNh8p/wGJ1FP575iMFnqg' 9-max Seat #7 is the button
Seat 1: r3ZqM1Mi0W3y4hOdssE+Sg ($49 in chips)
Seat 3: ymLPoEIl7UL3TvZYmnadxQ ($51.85 in chips)
Seat 4: HIIPkpiaCQfs5HcPKjlHvg ($31.95 in chips)
Seat 5: M+7+BTmX5vZatHVuoRB1nA ($85.85 in chips)
Seat 6: 3UmXLy3GfjC3EkOebduerQ ($56.40 in chips)
Seat 7: Wj7mKnRFR90j40wWUu2+Og ($79.05 in chips)
Seat 8: KrPAGRACBg+w0M//SXe8Ag ($10.30 in chips)
Seat 9: OMwFJ4pF0xk2Ru/AJiFeFw ($69.90 in chips)
KrPAGRACBg+w0M//SXe8Ag: posts small blind $0.25
OMwFJ4pF0xk2Ru/AJiFeFw: posts big blind $0.50
8ehL7qlZzjgUh2H35iiWLw: sits out
*** HOLE CARDS ***
r3ZqM1Mi0W3y4hOdssE+Sg: folds
ymLPoEIl7UL3TvZYmnadxQ: folds
HIIPkpiaCQfs5HcPKjlHvg: folds
M+7+BTmX5vZatHVuoRB1nA: folds
3UmXLy3GfjC3EkOebduerQ: calls $0.50
Wj7mKnRFR90j40wWUu2+Og: calls $0.50
KrPAGRACBg+w0M//SXe8Ag: calls $0.25
OMwFJ4pF0xk2Ru/AJiFeFw: raises $2 to $2.50
3UmXLy3GfjC3EkOebduerQ: calls $2
Wj7mKnRFR90j40wWUu2+Og: calls $2
KrPAGRACBg+w0M//SXe8Ag: folds
*** FLOP *** [3d 3h 4s]
OMwFJ4pF0xk2Ru/AJiFeFw: bets $5.50
3UmXLy3GfjC3EkOebduerQ: folds
Wj7mKnRFR90j40wWUu2+Og: calls $5.50
*** TURN *** [3d 3h 4s] [4d]
OMwFJ4pF0xk2Ru/AJiFeFw: bets $11.75
Wj7mKnRFR90j40wWUu2+Og: folds
OMwFJ4pF0xk2Ru/AJiFeFw collected $18.10 from pot
OMwFJ4pF0xk2Ru/AJiFeFw: doesn't show hand
*** SUMMARY ***
Total pot $19 | Rake $0.90
Board [3d 3h 4s 4d]
Seat 1: r3ZqM1Mi0W3y4hOdssE+Sg folded before Flop (didn't bet)
Seat 3: ymLPoEIl7UL3TvZYmnadxQ folded before Flop (didn't bet)
Seat 4: HIIPkpiaCQfs5HcPKjlHvg folded before Flop (didn't bet)
Seat 5: M+7+BTmX5vZatHVuoRB1nA folded before Flop (didn't bet)
Seat 6: 3UmXLy3GfjC3EkOebduerQ folded on the Flop
Seat 7: Wj7mKnRFR90j40wWUu2+Og (button) folded on the Turn
Seat 8: KrPAGRACBg+w0M//SXe8Ag (small blind) folded before Flop
Seat 9: OMwFJ4pF0xk2Ru/AJiFeFw (big blind) collected ($18.10)



PokerStars Game #59939127314:  Hold'em No Limit ($0.25/$0.50) - 2009/07/01 0:32:00 ET
Table 'E7bWJ45aoFXRpyRv2gw+Ig' 2-max Seat #2 is the button
Seat 1: FRkiRasEGlHUeLrEl+k/nA ($50.50 in chips)
Seat 2: 3Wro85I7472vJ4Wkpneo9A ($139.05 in chips)
3Wro85I7472vJ4Wkpneo9A: posts small blind $0.25
FRkiRasEGlHUeLrEl+k/nA: posts big blind $0.50
*** HOLE CARDS ***
3Wro85I7472vJ4Wkpneo9A: calls $0.25
FRkiRasEGlHUeLrEl+k/nA: checks
*** FLOP *** [4h 7h 2d]
FRkiRasEGlHUeLrEl+k/nA: bets $1.50
3Wro85I7472vJ4Wkpneo9A: calls $1.50
*** TURN *** [4h 7h 2d] [Kc]
FRkiRasEGlHUeLrEl+k/nA: checks
3Wro85I7472vJ4Wkpneo9A: bets $2.50
FRkiRasEGlHUeLrEl+k/nA: calls $2.50
*** RIVER *** [4h 7h 2d Kc] [Ad]
FRkiRasEGlHUeLrEl+k/nA: checks
3Wro85I7472vJ4Wkpneo9A: checks
*** SHOW DOWN ***
FRkiRasEGlHUeLrEl+k/nA: shows [8s 7d] (a pair of Sevens)
3Wro85I7472vJ4Wkpneo9A: shows [Jc Jd] (a pair of Jacks)
3Wro85I7472vJ4Wkpneo9A collected $8.60 from pot
*** SUMMARY ***
Total pot $9 | Rake $0.40
Board [4h 7h 2d Kc Ad]
Seat 1: FRkiRasEGlHUeLrEl+k/nA (big blind) showed [8s 7d] and lost with a pair of Sevens
Seat 2: 3Wro85I7472vJ4Wkpneo9A (button) (small blind) showed [Jc Jd] and won ($8.60) with a pair of Jacks



PokerStars Game #59939127532:  Hold'em No Limit ($0.25/$0.50) - 2009/07/01 0:32:00 ET
Table 'mTxf8gPLgffN3Iwfm7Icfg' 2-max Seat #1 is the button
Seat 1: Do9Rlu1R5u/AcRtMTl8SYg ($89.30 in chips)
Seat 2: EMc5LPgVaded4Qc77vm0fw ($70.10 in chips)
Do9Rlu1R5u/AcRtMTl8SYg: posts small blind $0.25
EMc5LPgVaded4Qc77vm0fw: posts big blind $0.50
*** HOLE CARDS ***
Do9Rlu1R5u/AcRtMTl8SYg: raises $1 to $1.50
EMc5LPgVaded4Qc77vm0fw: calls $1
*** FLOP *** [Qd 2h 8h]
EMc5LPgVaded4Qc77vm0fw: bets $1.50
Do9Rlu1R5u/AcRtMTl8SYg: folds
EMc5LPgVaded4Qc77vm0fw collected $2.85 from pot
EMc5LPgVaded4Qc77vm0fw: doesn't show hand
*** SUMMARY ***
Total pot $3 | Rake $0.15
Board [Qd 2h 8h]
Seat 1: Do9Rlu1R5u/AcRtMTl8SYg (button) (small blind) folded on the Flop
Seat 2: EMc5LPgVaded4Qc77vm0fw (big blind) collected ($2.85)



PokerStars Game #59939128606:  Hold'em No Limit ($0.25/$0.50) - 2009/07/01 0:32:02 ET
Table 'lSisgp6H7Fg1hH5VfjEjYQ' 9-max Seat #4 is the button
Seat 1: pEW8B6uXbdR47kfljMQ3+Q ($37.85 in chips)
Seat 2: UrcnkQOiLVk8BlKDPJSy7Q ($50 in chips)
Seat 3: aTkyjTh3w5YLWiIERupZOA ($39.40 in chips)
Seat 4: bwv/rbH/hHhPhY6u9mu04w ($23.15 in chips)
Seat 5: mSD1pginDsyHG5PDfqzphw ($10 in chips)
Seat 6: +k7T5ocke8UwavtgUHm+Cg ($25.35 in chips)
Seat 7: dGw5MBstXyXhWHHVFOWOFA ($42 in chips)
Seat 8: a4JDWmpFQkL10XfAyuF51A ($38 in chips)
Seat 9: 5JJVDlaiMnB004o/RqbZZQ ($45.25 in chips)
mSD1pginDsyHG5PDfqzphw: posts small blind $0.25
+k7T5ocke8UwavtgUHm+Cg: posts big blind $0.50
*** HOLE CARDS ***
dGw5MBstXyXhWHHVFOWOFA: folds
a4JDWmpFQkL10XfAyuF51A: folds
5JJVDlaiMnB004o/RqbZZQ: folds
pEW8B6uXbdR47kfljMQ3+Q: folds
dGw5MBstXyXhWHHVFOWOFA leaves the table
UrcnkQOiLVk8BlKDPJSy7Q: folds
aTkyjTh3w5YLWiIERupZOA: raises $1 to $1.50
bwv/rbH/hHhPhY6u9mu04w: calls $1.50
mSD1pginDsyHG5PDfqzphw: folds
+k7T5ocke8UwavtgUHm+Cg: calls $1
*** FLOP *** [7h 9c 3h]
+k7T5ocke8UwavtgUHm+Cg: checks
aTkyjTh3w5YLWiIERupZOA: bets $2
bwv/rbH/hHhPhY6u9mu04w: folds
+k7T5ocke8UwavtgUHm+Cg: folds
aTkyjTh3w5YLWiIERupZOA collected $4.55 from pot
aTkyjTh3w5YLWiIERupZOA: doesn't show hand
Y3DZ6qQlLeBhixDj4M9vmg joins the table at seat #7
*** SUMMARY ***
Total pot $4.75 | Rake $0.20
Board [7h 9c 3h]
Seat 1: pEW8B6uXbdR47kfljMQ3+Q folded before Flop (didn't bet)
Seat 2: UrcnkQOiLVk8BlKDPJSy7Q folded before Flop (didn't bet)
Seat 3: aTkyjTh3w5YLWiIERupZOA collected ($4.55)
Seat 4: bwv/rbH/hHhPhY6u9mu04w (button) folded on the Flop
Seat 5: mSD1pginDsyHG5PDfqzphw (small blind) folded before Flop
Seat 6: +k7T5ocke8UwavtgUHm+Cg (big blind) folded on the Flop
Seat 7: dGw5MBstXyXhWHHVFOWOFA folded before Flop (didn't bet)
Seat 8: a4JDWmpFQkL10XfAyuF51A folded before Flop (didn't bet)
Seat 9: 5JJVDlaiMnB004o/RqbZZQ folded before Flop (didn't bet)



PokerStars Game #59939129650:  Hold'em No Limit ($0.25/$0.50) - 2009/07/01 0:32:03 ET
Table 'T/PgNWqVyY6lkldcBVXYJQ' 6-max Seat #3 is the button
Seat 1: +Pf9jTVizYlIo+woPvptfA ($58 in chips)
Seat 2: oZAeY5rVqNGgt8yyQ0pxbA ($38.55 in chips)
Seat 3: L3OcNO1bgdqDI46j67KQPQ ($54.60 in chips)
Seat 4: jxMvxeUUL9UU0V6wVU+Iyw ($8.70 in chips)
Seat 5: vVQBckETtigfb5mAcyK0OA ($49 in chips)
Seat 6: cDzbog6kwmJp+LBeBq+iMQ ($55.25 in chips)
jxMvxeUUL9UU0V6wVU+Iyw: posts small blind $0.25
vVQBckETtigfb5mAcyK0OA: posts big blind $0.50
*** HOLE CARDS ***
cDzbog6kwmJp+LBeBq+iMQ: folds
+Pf9jTVizYlIo+woPvptfA: folds
oZAeY5rVqNGgt8yyQ0pxbA: folds
L3OcNO1bgdqDI46j67KQPQ: folds
jxMvxeUUL9UU0V6wVU+Iyw: folds
vVQBckETtigfb5mAcyK0OA collected $0.50 from pot
vVQBckETtigfb5mAcyK0OA: doesn't show hand
*** SUMMARY ***
Total pot $0.50 | Rake $0
Seat 1: +Pf9jTVizYlIo+woPvptfA folded before Flop (didn't bet)
Seat 2: oZAeY5rVqNGgt8yyQ0pxbA folded before Flop (didn't bet)
Seat 3: L3OcNO1bgdqDI46j67KQPQ (button) folded before Flop (didn't bet)
Seat 4: jxMvxeUUL9UU0V6wVU+Iyw (small blind) folded before Flop
Seat 5: vVQBckETtigfb5mAcyK0OA (big blind) collected ($0.50)
Seat 6: cDzbog6kwmJp+LBeBq+iMQ folded before Flop (didn't bet)



PokerStars Game #59939129954:  Hold'em No Limit ($0.25/$0.50) - 2009/07/01 0:32:04 ET
Table 'IeNZOZQ4T6oiaHqFeo6yIA' 2-max Seat #1 is the button
Seat 1: ndd1nfncBkWNitBnsfCoVQ ($87.70 in chips)
Seat 2: A91IUl5JaZROhtfCtnnwYw ($43.25 in chips)
ndd1nfncBkWNitBnsfCoVQ: posts small blind $0.25
A91IUl5JaZROhtfCtnnwYw: posts big blind $0.50
*** HOLE CARDS ***
ndd1nfncBkWNitBnsfCoVQ: raises $1 to $1.50
A91IUl5JaZROhtfCtnnwYw: raises $1 to $2.50
ndd1nfncBkWNitBnsfCoVQ: calls $1
*** FLOP *** [Ts 3c Ac]
A91IUl5JaZROhtfCtnnwYw: bets $3.50
ndd1nfncBkWNitBnsfCoVQ: calls $3.50
*** TURN *** [Ts 3c Ac] [7s]
A91IUl5JaZROhtfCtnnwYw: checks
ndd1nfncBkWNitBnsfCoVQ: checks
*** RIVER *** [Ts 3c Ac 7s] [8h]
A91IUl5JaZROhtfCtnnwYw: checks
ndd1nfncBkWNitBnsfCoVQ: checks
*** SHOW DOWN ***
A91IUl5JaZROhtfCtnnwYw: shows [Jc Kc] (high card Ace)
ndd1nfncBkWNitBnsfCoVQ: shows [3h Qc] (a pair of Threes)
ndd1nfncBkWNitBnsfCoVQ collected $11.50 from pot
*** SUMMARY ***
Total pot $12 | Rake $0.50
Board [Ts 3c Ac 7s 8h]
Seat 1: ndd1nfncBkWNitBnsfCoVQ (button) (small blind) showed [3h Qc] and won ($11.50) with a pair of Threes
Seat 2: A91IUl5JaZROhtfCtnnwYw (big blind) showed [Jc Kc] and lost with high card Ace



PokerStars Game #59939131496:  Hold'em No Limit ($0.25/$0.50) - 2009/07/01 0:32:06 ET
Table '+dXkOAQyS8j9PQZusUTMpg' 2-max Seat #2 is the button
Seat 1: XFa6sBGjP2gxoIvxR3fZIg ($59.15 in chips)
Seat 2: 5IBeOgaApY1Bvzv2P8X4EA ($84.40 in chips)
5IBeOgaApY1Bvzv2P8X4EA: posts small blind $0.25
XFa6sBGjP2gxoIvxR3fZIg: posts big blind $0.50
*** HOLE CARDS ***
5IBeOgaApY1Bvzv2P8X4EA: folds
XFa6sBGjP2gxoIvxR3fZIg collected $0.50 from pot
*** SUMMARY ***
Total pot $0.50 | Rake $0
Seat 1: XFa6sBGjP2gxoIvxR3fZIg (big blind) collected ($0.50)
Seat 2: 5IBeOgaApY1Bvzv2P8X4EA (button) (small blind) folded before Flop



PokerStars Game #59939131128:  Hold'em No Limit ($0.25/$0.50) - 2009/07/01 0:32:06 ET
Table '37qXEp3oe+er5q4CZip9eQ' 6-max Seat #4 is the button
Seat 1: oqOqoO2AyCZenUghCxMDxw ($53.50 in chips)
Seat 2: 6wzJiRvp8HY6t+MQGnSIzA ($17.60 in chips)
Seat 3: Rt6KgtZ8YaJoTc3FPim00w ($95 in chips)
Seat 4: XsmE8nXMAAMFJbWaJTmHFw ($19.80 in chips)
Seat 5: VOmI0x4dDPnTESZd5B4d1Q ($42 in chips)
Seat 6: l4m/wWPs22DSP5xpszjXKA ($7.75 in chips)
VOmI0x4dDPnTESZd5B4d1Q: posts small blind $0.25
l4m/wWPs22DSP5xpszjXKA: posts big blind $0.50
*** HOLE CARDS ***
oqOqoO2AyCZenUghCxMDxw: folds
6wzJiRvp8HY6t+MQGnSIzA: folds
Rt6KgtZ8YaJoTc3FPim00w: folds
XsmE8nXMAAMFJbWaJTmHFw: raises $1 to $1.50
VOmI0x4dDPnTESZd5B4d1Q: folds
l4m/wWPs22DSP5xpszjXKA: folds
XsmE8nXMAAMFJbWaJTmHFw collected $1.25 from pot
*** SUMMARY ***
Total pot $1.25 | Rake $0
Seat 1: oqOqoO2AyCZenUghCxMDxw folded before Flop (didn't bet)
Seat 2: 6wzJiRvp8HY6t+MQGnSIzA folded before Flop (didn't bet)
Seat 3: Rt6KgtZ8YaJoTc3FPim00w folded before Flop (didn't bet)
Seat 4: XsmE8nXMAAMFJbWaJTmHFw (button) collected ($1.25)
Seat 5: VOmI0x4dDPnTESZd5B4d1Q (small blind) folded before Flop
Seat 6: l4m/wWPs22DSP5xpszjXKA (big blind) folded before Flop



PokerStars Game #59939131052:  Hold'em No Limit ($0.25/$0.50) - 2009/07/01 0:32:06 ET
Table 'tyR5AZNKV8Aadbrnrnlg7g' 6-max Seat #6 is the button
Seat 1: R+KjpH/wSjDLhtIy9+edNA ($80.50 in chips)
Seat 2: 58zdeSBSuSFX/qZfhc7YmA ($38.10 in chips)
Seat 3: tdOvWynovql5imfooroLMg ($48.75 in chips)
Seat 4: Rt6KgtZ8YaJoTc3FPim00w ($83.95 in chips)
Seat 5: wOyVV9M/oyiw3YaOjNZ05w ($54.60 in chips)
Seat 6: ZKazl1hGaPiapDXincgi2Q ($25.95 in chips)
R+KjpH/wSjDLhtIy9+edNA: posts small blind $0.25
58zdeSBSuSFX/qZfhc7YmA: posts big blind $0.50
*** HOLE CARDS ***
tdOvWynovql5imfooroLMg: folds
Rt6KgtZ8YaJoTc3FPim00w: folds
wOyVV9M/oyiw3YaOjNZ05w: raises $1.25 to $1.75
ZKazl1hGaPiapDXincgi2Q: calls $1.75
R+KjpH/wSjDLhtIy9+edNA: folds
58zdeSBSuSFX/qZfhc7YmA: folds
*** FLOP *** [3s Tc 2d]
wOyVV9M/oyiw3YaOjNZ05w: bets $2
ZKazl1hGaPiapDXincgi2Q: calls $2
*** TURN *** [3s Tc 2d] [8s]
wOyVV9M/oyiw3YaOjNZ05w: bets $4
ZKazl1hGaPiapDXincgi2Q: folds
wOyVV9M/oyiw3YaOjNZ05w collected $7.85 from pot
*** SUMMARY ***
Total pot $8.25 | Rake $0.40
Board [3s Tc 2d 8s]
Seat 1: R+KjpH/wSjDLhtIy9+edNA (small blind) folded before Flop
Seat 2: 58zdeSBSuSFX/qZfhc7YmA (big blind) folded before Flop
Seat 3: tdOvWynovql5imfooroLMg folded before Flop (didn't bet)
Seat 4: Rt6KgtZ8YaJoTc3FPim00w folded before Flop (didn't bet)
Seat 5: wOyVV9M/oyiw3YaOjNZ05w collected ($7.85)
Seat 6: ZKazl1hGaPiapDXincgi2Q (button) folded on the Turn



PokerStars Game #59939131890:  Hold'em No Limit ($0.25/$0.50) - 2009/07/01 0:32:07 ET
Table 'NCiXr0d5CEKBQr/cZgLhbA' 9-max Seat #3 is the button
Seat 2: ulxuJchBV9iguXg0FUonfg ($25.80 in chips)
Seat 3: xZCXQSXlrZkp3pZizzVXCw ($56.90 in chips)
Seat 4: 5k9fvXD9suIgCxU4HLQjTw ($59.45 in chips)
Seat 5: zE9cVigS2nW/Ljy4K4bUQA ($39.50 in chips)
Seat 6: SKnJuWHScqetA/qG5p+wCg ($30 in chips)
Seat 7: M+7+BTmX5vZatHVuoRB1nA ($48.50 in chips)
Seat 8: 1MJUKc3cc0QmUoz1JZLR2w ($54.05 in chips)
Seat 9: 4WLZvqBn5qv5tds5kt5A1Q ($28.75 in chips)
5k9fvXD9suIgCxU4HLQjTw: posts small blind $0.25
zE9cVigS2nW/Ljy4K4bUQA: posts big blind $0.50
pFtzb1sR4b0d1aw6aIRgDg: sits out
*** HOLE CARDS ***
SKnJuWHScqetA/qG5p+wCg: folds
M+7+BTmX5vZatHVuoRB1nA: folds
1MJUKc3cc0QmUoz1JZLR2w: calls $0.50
4WLZvqBn5qv5tds5kt5A1Q: folds
ulxuJchBV9iguXg0FUonfg: folds
xZCXQSXlrZkp3pZizzVXCw: folds
5k9fvXD9suIgCxU4HLQjTw: folds
zE9cVigS2nW/Ljy4K4bUQA: checks
*** FLOP *** [8d 6c Kh]
zE9cVigS2nW/Ljy4K4bUQA: checks
1MJUKc3cc0QmUoz1JZLR2w: checks
*** TURN *** [8d 6c Kh] [Ad]
zE9cVigS2nW/Ljy4K4bUQA: checks
1MJUKc3cc0QmUoz1JZLR2w: checks
*** RIVER *** [8d 6c Kh Ad] [Td]
zE9cVigS2nW/Ljy4K4bUQA: bets $1.50
1MJUKc3cc0QmUoz1JZLR2w: folds
zE9cVigS2nW/Ljy4K4bUQA collected $1.20 from pot
*** SUMMARY ***
Total pot $1.25 | Rake $0.05
Board [8d 6c Kh Ad Td]
Seat 2: ulxuJchBV9iguXg0FUonfg folded before Flop (didn't bet)
Seat 3: xZCXQSXlrZkp3pZizzVXCw (button) folded before Flop (didn't bet)
Seat 4: 5k9fvXD9suIgCxU4HLQjTw (small blind) folded before Flop
Seat 5: zE9cVigS2nW/Ljy4K4bUQA (big blind) collected ($1.20)
Seat 6: SKnJuWHScqetA/qG5p+wCg folded before Flop (didn't bet)
Seat 7: M+7+BTmX5vZatHVuoRB1nA folded before Flop (didn't bet)
Seat 8: 1MJUKc3cc0QmUoz1JZLR2w folded on the River
Seat 9: 4WLZvqBn5qv5tds5kt5A1Q folded before Flop (didn't bet)



PokerStars Game #59939131956:  Hold'em No Limit ($0.25/$0.50) - 2009/07/01 0:32:07 ET
Table '+z1aekfHkpp09pc8F9aViw' 6-max Seat #5 is the button
Seat 2: M6xK/VklCvdyyrmvzATlxQ ($38.30 in chips)
Seat 3: uUznlIMFnRUvwrBhYF73KA ($55.60 in chips)
Seat 4: RowCSpSURHTOL/dcjg/Iug ($49.30 in chips)
Seat 5: crjGpJEzSZgD38FoE3VMGg ($54.60 in chips)
Seat 6: 686aeHikcJlgKkSuIFdcXQ ($69.60 in chips)
686aeHikcJlgKkSuIFdcXQ: posts small blind $0.25
wOyVV9M/oyiw3YaOjNZ05w: is sitting out
wOyVV9M/oyiw3YaOjNZ05w leaves the table
M6xK/VklCvdyyrmvzATlxQ: posts big blind $0.50
*** HOLE CARDS ***
uUznlIMFnRUvwrBhYF73KA: folds
RowCSpSURHTOL/dcjg/Iug: folds
FHilMb2i2DbUCc9lplszog joins the table at seat #1
crjGpJEzSZgD38FoE3VMGg: raises $1.50 to $2
686aeHikcJlgKkSuIFdcXQ: folds
M6xK/VklCvdyyrmvzATlxQ: folds
crjGpJEzSZgD38FoE3VMGg collected $1.25 from pot
*** SUMMARY ***
Total pot $1.25 | Rake $0
Seat 2: M6xK/VklCvdyyrmvzATlxQ (big blind) folded before Flop
Seat 3: uUznlIMFnRUvwrBhYF73KA folded before Flop (didn't bet)
Seat 4: RowCSpSURHTOL/dcjg/Iug folded before Flop (didn't bet)
Seat 5: crjGpJEzSZgD38FoE3VMGg (button) collected ($1.25)
Seat 6: 686aeHikcJlgKkSuIFdcXQ (small blind) folded before Flop



PokerStars Game #59939133182:  Hold'em No Limit ($0.25/$0.50) - 2009/07/01 0:32:09 ET
Table 'PALRfuH85dr5IkDfdv6new' 9-max Seat #4 is the button
Seat 1: SKnJuWHScqetA/qG5p+wCg ($30 in chips)
Seat 2: 9r7ZoBbAJj5IeyZ0q9BdzA ($10 in chips)
Seat 3: 50QWoELmpmHFrFIlWMJo9g ($86.70 in chips)
Seat 4: mZNMJI1mY40XTC0U7GZakA ($57.65 in chips)
Seat 5: jSSGUXdNFAZA3QCvTcUMQw ($42.95 in chips)
Seat 6: E2518gp4aFz1+kAgmGqeEg ($11.75 in chips)
Seat 7: 3NcyXvr39gnK+KbTq7ezyA ($39.25 in chips)
Seat 8: NkS+CseUKx4XHszWq0PXEQ ($44.65 in chips)
Seat 9: CIrAX/m6o7jYmKOAjJXv4Q ($36.45 in chips)
jSSGUXdNFAZA3QCvTcUMQw: posts small blind $0.25
E2518gp4aFz1+kAgmGqeEg: posts big blind $0.50
*** HOLE CARDS ***
3NcyXvr39gnK+KbTq7ezyA: calls $0.50
NkS+CseUKx4XHszWq0PXEQ: folds
CIrAX/m6o7jYmKOAjJXv4Q: folds
SKnJuWHScqetA/qG5p+wCg: folds
9r7ZoBbAJj5IeyZ0q9BdzA: raises $0.50 to $1
50QWoELmpmHFrFIlWMJo9g: folds
mZNMJI1mY40XTC0U7GZakA: folds
jSSGUXdNFAZA3QCvTcUMQw: folds
E2518gp4aFz1+kAgmGqeEg: calls $0.50
3NcyXvr39gnK+KbTq7ezyA: calls $0.50
*** FLOP *** [8c 9h 4h]
E2518gp4aFz1+kAgmGqeEg: checks
3NcyXvr39gnK+KbTq7ezyA: checks
9r7ZoBbAJj5IeyZ0q9BdzA: bets $1
E2518gp4aFz1+kAgmGqeEg: raises $2 to $3
3NcyXvr39gnK+KbTq7ezyA: folds
9r7ZoBbAJj5IeyZ0q9BdzA: folds
E2518gp4aFz1+kAgmGqeEg collected $5 from pot
E2518gp4aFz1+kAgmGqeEg: doesn't show hand
*** SUMMARY ***
Total pot $5.25 | Rake $0.25
Board [8c 9h 4h]
Seat 1: SKnJuWHScqetA/qG5p+wCg folded before Flop (didn't bet)
Seat 2: 9r7ZoBbAJj5IeyZ0q9BdzA folded on the Flop
Seat 3: 50QWoELmpmHFrFIlWMJo9g folded before Flop (didn't bet)
Seat 4: mZNMJI1mY40XTC0U7GZakA (button) folded before Flop (didn't bet)
Seat 5: jSSGUXdNFAZA3QCvTcUMQw (small blind) folded before Flop
Seat 6: E2518gp4aFz1+kAgmGqeEg (big blind) collected ($5)
Seat 7: 3NcyXvr39gnK+KbTq7ezyA folded on the Flop
Seat 8: NkS+CseUKx4XHszWq0PXEQ folded before Flop (didn't bet)
Seat 9: CIrAX/m6o7jYmKOAjJXv4Q folded before Flop (didn't bet)



PokerStars Game #59939134734:  Hold'em No Limit ($0.25/$0.50) - 2009/07/01 0:32:11 ET
Table '/cQuAT3ef4t+PGrXiNhGaQ' 9-max Seat #7 is the button
Seat 2: jXGruyaMqirTaTXNOvBdew ($71.40 in chips)
Seat 3: g4k0NXISyLCqaSWZDBjfEg ($53.90 in chips)
Seat 4: OWP/DOu+PlPK6ZZ3zYa0HA ($41.65 in chips)
Seat 5: 5SgaHdWixdClWvaEG+KUjQ ($20.95 in chips)
Seat 6: APYIOyK/4AGb+kIwlOUNBQ ($43 in chips)
Seat 7: J0W5D97jl5VLky+IoPvDeA ($114.90 in chips)
Seat 8: W3ingbA178eb7J5rt1PuIQ ($36.85 in chips)
Seat 9: E2518gp4aFz1+kAgmGqeEg ($11 in chips)
W3ingbA178eb7J5rt1PuIQ: posts small blind $0.25
E2518gp4aFz1+kAgmGqeEg: posts big blind $0.50
HZkVla4kK2SI42CVrPZ/ig: sits out
*** HOLE CARDS ***
jXGruyaMqirTaTXNOvBdew: folds
g4k0NXISyLCqaSWZDBjfEg: folds
OWP/DOu+PlPK6ZZ3zYa0HA: folds
5SgaHdWixdClWvaEG+KUjQ: folds
APYIOyK/4AGb+kIwlOUNBQ: folds
J0W5D97jl5VLky+IoPvDeA: folds
W3ingbA178eb7J5rt1PuIQ: raises $1.50 to $2
E2518gp4aFz1+kAgmGqeEg: folds
W3ingbA178eb7J5rt1PuIQ collected $1 from pot
*** SUMMARY ***
Total pot $1 | Rake $0
Seat 2: jXGruyaMqirTaTXNOvBdew folded before Flop (didn't bet)
Seat 3: g4k0NXISyLCqaSWZDBjfEg folded before Flop (didn't bet)
Seat 4: OWP/DOu+PlPK6ZZ3zYa0HA folded before Flop (didn't bet)
Seat 5: 5SgaHdWixdClWvaEG+KUjQ folded before Flop (didn't bet)
Seat 6: APYIOyK/4AGb+kIwlOUNBQ folded before Flop (didn't bet)
Seat 7: J0W5D97jl5VLky+IoPvDeA (button) folded before Flop (didn't bet)
Seat 8: W3ingbA178eb7J5rt1PuIQ (small blind) collected ($1)
Seat 9: E2518gp4aFz1+kAgmGqeEg (big blind) folded before Flop



PokerStars Game #59939135036:  Hold'em No Limit ($0.25/$0.50) - 2009/07/01 0:32:11 ET
Table '5EmHi+fnatGQQShcNmzOZQ' 6-max Seat #6 is the button
Seat 1: SwPczQo3cOtwEzhJrfO2cQ ($30.25 in chips)
Seat 2: vXIHnZ+dv/hwSBxyvGw7bQ ($50 in chips)
Seat 3: L9qfLYXrczhAPd/VckgsWw ($62.70 in chips)
Seat 4: wOyVV9M/oyiw3YaOjNZ05w ($53.10 in chips)
Seat 5: kxPhs4ePFqMy52CInAJ2aw ($53.85 in chips)
Seat 6: 686aeHikcJlgKkSuIFdcXQ ($140.65 in chips)
SwPczQo3cOtwEzhJrfO2cQ: posts small blind $0.25
vXIHnZ+dv/hwSBxyvGw7bQ: posts big blind $0.50
*** HOLE CARDS ***
L9qfLYXrczhAPd/VckgsWw: folds
wOyVV9M/oyiw3YaOjNZ05w: folds
kxPhs4ePFqMy52CInAJ2aw: folds
686aeHikcJlgKkSuIFdcXQ: folds
SwPczQo3cOtwEzhJrfO2cQ: calls $0.25
vXIHnZ+dv/hwSBxyvGw7bQ: checks
*** FLOP *** [Qc 4s 6c]
SwPczQo3cOtwEzhJrfO2cQ: checks
vXIHnZ+dv/hwSBxyvGw7bQ: bets $1
SwPczQo3cOtwEzhJrfO2cQ: folds
vXIHnZ+dv/hwSBxyvGw7bQ collected $0.95 from pot
vXIHnZ+dv/hwSBxyvGw7bQ: doesn't show hand
*** SUMMARY ***
Total pot $1 | Rake $0.05
Board [Qc 4s 6c]
Seat 1: SwPczQo3cOtwEzhJrfO2cQ (small blind) folded on the Flop
Seat 2: vXIHnZ+dv/hwSBxyvGw7bQ (big blind) collected ($0.95)
Seat 3: L9qfLYXrczhAPd/VckgsWw folded before Flop (didn't bet)
Seat 4: wOyVV9M/oyiw3YaOjNZ05w folded before Flop (didn't bet)
Seat 5: kxPhs4ePFqMy52CInAJ2aw folded before Flop (didn't bet)
Seat 6: 686aeHikcJlgKkSuIFdcXQ (button) folded before Flop (didn't bet)



PokerStars Game #59939135412:  Hold'em No Limit ($0.25/$0.50) - 2009/07/01 0:32:12 ET
Table 'QOgaEqMcJ73pcUMMxoisUg' 6-max Seat #4 is the button
Seat 2: Im2p1Nt83UKSqv5c9frm4Q ($92.80 in chips)
Seat 4: zAcsDhG/T128Vn7XGVSgKg ($60.30 in chips)
Seat 5: 6vNxrjjCl6FwfaaymM9jjg ($26.30 in chips)
Seat 6: pmE+2KJb4nffAVqjLIXxFg ($22.75 in chips)
wUZNozoIDYf+16hp4nn6dw leaves the table
6vNxrjjCl6FwfaaymM9jjg: posts small blind $0.25
Rt6KgtZ8YaJoTc3FPim00w joins the table at seat #3
pmE+2KJb4nffAVqjLIXxFg: posts big blind $0.50
OZ6OtYh5Y53MCH/p0QTn5g: sits out
*** HOLE CARDS ***
Im2p1Nt83UKSqv5c9frm4Q: raises $1 to $1.50
zAcsDhG/T128Vn7XGVSgKg: raises $3.50 to $5
6vNxrjjCl6FwfaaymM9jjg: folds
pmE+2KJb4nffAVqjLIXxFg: folds
Im2p1Nt83UKSqv5c9frm4Q: folds
zAcsDhG/T128Vn7XGVSgKg collected $3.75 from pot
*** SUMMARY ***
Total pot $3.75 | Rake $0
Seat 2: Im2p1Nt83UKSqv5c9frm4Q folded before Flop
Seat 4: zAcsDhG/T128Vn7XGVSgKg (button) collected ($3.75)
Seat 5: 6vNxrjjCl6FwfaaymM9jjg (small blind) folded before Flop
Seat 6: pmE+2KJb4nffAVqjLIXxFg (big blind) folded before Flop



PokerStars Game #59939136058:  Hold'em No Limit ($0.25/$0.50) - 2009/07/01 0:32:13 ET
Table '+dXkOAQyS8j9PQZusUTMpg' 2-max Seat #1 is the button
Seat 1: XFa6sBGjP2gxoIvxR3fZIg ($59.40 in chips)
Seat 2: 5IBeOgaApY1Bvzv2P8X4EA ($84.15 in chips)
XFa6sBGjP2gxoIvxR3fZIg: posts small blind $0.25
5IBeOgaApY1Bvzv2P8X4EA: posts big blind $0.50
*** HOLE CARDS ***
5IBeOgaApY1Bvzv2P8X4EA said, "lucky you againg"
XFa6sBGjP2gxoIvxR3fZIg: raises $1 to $1.50
5IBeOgaApY1Bvzv2P8X4EA: calls $1
*** FLOP *** [3h 6c 5d]
XFa6sBGjP2gxoIvxR3fZIg said, "lucky river yeah"
5IBeOgaApY1Bvzv2P8X4EA: checks
5IBeOgaApY1Bvzv2P8X4EA said, "jajaja"
XFa6sBGjP2gxoIvxR3fZIg: bets $2
5IBeOgaApY1Bvzv2P8X4EA: folds
XFa6sBGjP2gxoIvxR3fZIg collected $2.85 from pot
*** SUMMARY ***
Total pot $3 | Rake $0.15
Board [3h 6c 5d]
Seat 1: XFa6sBGjP2gxoIvxR3fZIg (button) (small blind) collected ($2.85)
Seat 2: 5IBeOgaApY1Bvzv2P8X4EA (big blind) folded on the Flop



PokerStars Game #59939136726:  Hold'em No Limit ($0.25/$0.50) - 2009/07/01 0:32:14 ET
Table 'kgbJRsxfv64KrErDRBAkcw' 6-max Seat #6 is the button
Seat 1: mxTUARCsU8Eby0whmHNcOw ($9.50 in chips)
Seat 2: Q+thC23WCv1kJUJtH/+4Jw ($59.55 in chips)
Seat 3: T0Gx/FcQ5VH9u7XaOMX97A ($80.85 in chips)
Seat 4: qanMEqjABjWxC/JgQ/0l7w ($57.70 in chips)
Seat 5: +Pf9jTVizYlIo+woPvptfA ($50 in chips)
Seat 6: ozrlafxxh1HmYdA0/h+MuA ($13.70 in chips)
mxTUARCsU8Eby0whmHNcOw: posts small blind $0.25
Q+thC23WCv1kJUJtH/+4Jw: posts big blind $0.50
*** HOLE CARDS ***
T0Gx/FcQ5VH9u7XaOMX97A: folds
qanMEqjABjWxC/JgQ/0l7w: folds
+Pf9jTVizYlIo+woPvptfA: raises $1.50 to $2
ozrlafxxh1HmYdA0/h+MuA: folds
mxTUARCsU8Eby0whmHNcOw: calls $1.75
Q+thC23WCv1kJUJtH/+4Jw: folds
*** FLOP *** [3h 5h 7c]
mxTUARCsU8Eby0whmHNcOw: checks
+Pf9jTVizYlIo+woPvptfA: bets $3
mxTUARCsU8Eby0whmHNcOw: folds
+Pf9jTVizYlIo+woPvptfA collected $4.30 from pot
+Pf9jTVizYlIo+woPvptfA: doesn't show hand
*** SUMMARY ***
Total pot $4.50 | Rake $0.20
Board [3h 5h 7c]
Seat 1: mxTUARCsU8Eby0whmHNcOw (small blind) folded on the Flop
Seat 2: Q+thC23WCv1kJUJtH/+4Jw (big blind) folded before Flop
Seat 3: T0Gx/FcQ5VH9u7XaOMX97A folded before Flop (didn't bet)
Seat 4: qanMEqjABjWxC/JgQ/0l7w folded before Flop (didn't bet)
Seat 5: +Pf9jTVizYlIo+woPvptfA collected ($4.30)
Seat 6: ozrlafxxh1HmYdA0/h+MuA (button) folded before Flop (didn't bet)



PokerStars Game #59939136826:  Hold'em No Limit ($0.25/$0.50) - 2009/07/01 0:32:14 ET
Table 'MJxeZCzYELxiIsyUZyT0jw' 6-max Seat #6 is the button
Seat 2: dB6jzDlJmET84VMWw1mTRA ($50.25 in chips)
Seat 3: JQZew0FjzS19kTjeNtrE+A ($50.55 in chips)
Seat 4: lP7Q6pewz4C2RsAfKsjdWw ($31.95 in chips)
Seat 5: 3jvoOXNtXE90w2BdfNZwZQ ($53.05 in chips)
Seat 6: TTx3CHxyi0SObcHyMJRp5w ($52.55 in chips)
dB6jzDlJmET84VMWw1mTRA: posts small blind $0.25
JQZew0FjzS19kTjeNtrE+A: posts big blind $0.50
*** HOLE CARDS ***
lP7Q6pewz4C2RsAfKsjdWw: calls $0.50
3jvoOXNtXE90w2BdfNZwZQ: raises $2 to $2.50
TTx3CHxyi0SObcHyMJRp5w: calls $2.50
dB6jzDlJmET84VMWw1mTRA: folds
JQZew0FjzS19kTjeNtrE+A: folds
lP7Q6pewz4C2RsAfKsjdWw: folds
*** FLOP *** [Jd Qs 4h]
3jvoOXNtXE90w2BdfNZwZQ: checks
TTx3CHxyi0SObcHyMJRp5w: bets $2.50
3jvoOXNtXE90w2BdfNZwZQ: calls $2.50
*** TURN *** [Jd Qs 4h] [6c]
3jvoOXNtXE90w2BdfNZwZQ: checks
TTx3CHxyi0SObcHyMJRp5w: bets $6
3jvoOXNtXE90w2BdfNZwZQ: calls $6
*** RIVER *** [Jd Qs 4h 6c] [9s]
3jvoOXNtXE90w2BdfNZwZQ: checks
TTx3CHxyi0SObcHyMJRp5w: checks
*** SHOW DOWN ***
3jvoOXNtXE90w2BdfNZwZQ: shows [Jc Ah] (a pair of Jacks)
TTx3CHxyi0SObcHyMJRp5w: shows [Kh Ks] (a pair of Kings)
TTx3CHxyi0SObcHyMJRp5w collected $22.15 from pot
*** SUMMARY ***
Total pot $23.25 | Rake $1.10
Board [Jd Qs 4h 6c 9s]
Seat 2: dB6jzDlJmET84VMWw1mTRA (small blind) folded before Flop
Seat 3: JQZew0FjzS19kTjeNtrE+A (big blind) folded before Flop
Seat 4: lP7Q6pewz4C2RsAfKsjdWw folded before Flop
Seat 5: 3jvoOXNtXE90w2BdfNZwZQ showed [Jc Ah] and lost with a pair of Jacks
Seat 6: TTx3CHxyi0SObcHyMJRp5w (button) showed [Kh Ks] and won ($22.15) with a pair of Kings



PokerStars Game #59939137254:  Hold'em No Limit ($0.25/$0.50) - 2009/07/01 0:32:15 ET
Table 'mTxf8gPLgffN3Iwfm7Icfg' 2-max Seat #2 is the button
Seat 1: Do9Rlu1R5u/AcRtMTl8SYg ($87.80 in chips)
Seat 2: EMc5LPgVaded4Qc77vm0fw ($71.45 in chips)
EMc5LPgVaded4Qc77vm0fw: posts small blind $0.25
Do9Rlu1R5u/AcRtMTl8SYg: posts big blind $0.50
*** HOLE CARDS ***
EMc5LPgVaded4Qc77vm0fw: folds
Do9Rlu1R5u/AcRtMTl8SYg collected $0.50 from pot
Do9Rlu1R5u/AcRtMTl8SYg: doesn't show hand
*** SUMMARY ***
Total pot $0.50 | Rake $0
Seat 1: Do9Rlu1R5u/AcRtMTl8SYg (big blind) collected ($0.50)
Seat 2: EMc5LPgVaded4Qc77vm0fw (button) (small blind) folded before Flop



PokerStars Game #59939139626:  Hold'em No Limit ($0.25/$0.50) - 2009/07/01 0:32:18 ET
Table '3FhG0gl3kMX3wBEEqj+wnQ' 9-max Seat #4 is the button
Seat 1: e0J9pdCNUDTCG031RnXqLA ($17 in chips)
Seat 3: HZkVla4kK2SI42CVrPZ/ig ($8.75 in chips)
Seat 4: bz4LMfV0GGl/MJ/ABXuPmg ($20.35 in chips)
Seat 5: XNMDwbXt/Q4jM99AXnbJDw ($50 in chips)
Seat 6: 5JJVDlaiMnB004o/RqbZZQ ($45.05 in chips)
Seat 7: mSD1pginDsyHG5PDfqzphw ($10 in chips)
Seat 8: j3K/Jujr7PY4ZM2RZvlH6A ($60.55 in chips)
Seat 9: L5e2lrPLQm1Pqx30IIZ/Fw ($10.85 in chips)
XNMDwbXt/Q4jM99AXnbJDw: posts small blind $0.25
5JJVDlaiMnB004o/RqbZZQ: posts big blind $0.50
7cYQ+syUWjl38ty/ICOMhw: sits out
*** HOLE CARDS ***
mSD1pginDsyHG5PDfqzphw: folds
j3K/Jujr7PY4ZM2RZvlH6A: folds
L5e2lrPLQm1Pqx30IIZ/Fw: folds
e0J9pdCNUDTCG031RnXqLA: folds
HZkVla4kK2SI42CVrPZ/ig: folds
bz4LMfV0GGl/MJ/ABXuPmg: folds
XNMDwbXt/Q4jM99AXnbJDw: raises $0.50 to $1
5JJVDlaiMnB004o/RqbZZQ: raises $2 to $3
XNMDwbXt/Q4jM99AXnbJDw: folds
5JJVDlaiMnB004o/RqbZZQ collected $2 from pot
*** SUMMARY ***
Total pot $2 | Rake $0
Seat 1: e0J9pdCNUDTCG031RnXqLA folded before Flop (didn't bet)
Seat 3: HZkVla4kK2SI42CVrPZ/ig folded before Flop (didn't bet)
Seat 4: bz4LMfV0GGl/MJ/ABXuPmg (button) folded before Flop (didn't bet)
Seat 5: XNMDwbXt/Q4jM99AXnbJDw (small blind) folded before Flop
Seat 6: 5JJVDlaiMnB004o/RqbZZQ (big blind) collected ($2)
Seat 7: mSD1pginDsyHG5PDfqzphw folded before Flop (didn't bet)
Seat 8: j3K/Jujr7PY4ZM2RZvlH6A folded before Flop (didn't bet)
Seat 9: L5e2lrPLQm1Pqx30IIZ/Fw folded before Flop (didn't bet)



PokerStars Game #59939141172:  Hold'em No Limit ($0.25/$0.50) - 2009/07/01 0:32:20 ET
Table 'otvGDROEDdqsabxskT79qg' 9-max Seat #7 is the button
Seat 1: 8ehL7qlZzjgUh2H35iiWLw ($50 in chips)
Seat 2: cCjTzH9jio8607WzjcfXlg ($8.80 in chips)
Seat 3: +k7T5ocke8UwavtgUHm+Cg ($74.65 in chips)
Seat 4: MG90wfSJZnOejs/KD3vlQQ ($56.15 in chips)
Seat 5: XNMDwbXt/Q4jM99AXnbJDw ($55.55 in chips)
Seat 6: bxLSulbgr8LmKNjOzw8URg ($49.25 in chips)
Seat 7: C7+tBppJrKgd/r+tuKUIpA ($34.15 in chips)
Seat 8: zE9cVigS2nW/Ljy4K4bUQA ($30 in chips)
Seat 9: KcY3X8YpD74Kw1RHkx/g4A ($71.50 in chips)
zE9cVigS2nW/Ljy4K4bUQA: posts small blind $0.25
KcY3X8YpD74Kw1RHkx/g4A: posts big blind $0.50
*** HOLE CARDS ***
8ehL7qlZzjgUh2H35iiWLw: folds
cCjTzH9jio8607WzjcfXlg: calls $0.50
+k7T5ocke8UwavtgUHm+Cg: folds
MG90wfSJZnOejs/KD3vlQQ: folds
XNMDwbXt/Q4jM99AXnbJDw: folds
bxLSulbgr8LmKNjOzw8URg: folds
C7+tBppJrKgd/r+tuKUIpA: folds
zE9cVigS2nW/Ljy4K4bUQA: folds
KcY3X8YpD74Kw1RHkx/g4A: checks
*** FLOP *** [3c Jc Qd]
KcY3X8YpD74Kw1RHkx/g4A: checks
cCjTzH9jio8607WzjcfXlg: bets $1
KcY3X8YpD74Kw1RHkx/g4A: folds
cCjTzH9jio8607WzjcfXlg collected $1.20 from pot
*** SUMMARY ***
Total pot $1.25 | Rake $0.05
Board [3c Jc Qd]
Seat 1: 8ehL7qlZzjgUh2H35iiWLw folded before Flop (didn't bet)
Seat 2: cCjTzH9jio8607WzjcfXlg collected ($1.20)
Seat 3: +k7T5ocke8UwavtgUHm+Cg folded before Flop (didn't bet)
Seat 4: MG90wfSJZnOejs/KD3vlQQ folded before Flop (didn't bet)
Seat 5: XNMDwbXt/Q4jM99AXnbJDw folded before Flop (didn't bet)
Seat 6: bxLSulbgr8LmKNjOzw8URg folded before Flop (didn't bet)
Seat 7: C7+tBppJrKgd/r+tuKUIpA (button) folded before Flop (didn't bet)
Seat 8: zE9cVigS2nW/Ljy4K4bUQA (small blind) folded before Flop
Seat 9: KcY3X8YpD74Kw1RHkx/g4A (big blind) folded on the Flop



PokerStars Game #59939141410:  Hold'em No Limit ($0.25/$0.50) - 2009/07/01 0:32:21 ET
Table 'mTxf8gPLgffN3Iwfm7Icfg' 2-max Seat #1 is the button
Seat 1: Do9Rlu1R5u/AcRtMTl8SYg ($88.05 in chips)
Seat 2: EMc5LPgVaded4Qc77vm0fw ($71.20 in chips)
Do9Rlu1R5u/AcRtMTl8SYg: posts small blind $0.25
EMc5LPgVaded4Qc77vm0fw: posts big blind $0.50
*** HOLE CARDS ***
Do9Rlu1R5u/AcRtMTl8SYg: calls $0.25
EMc5LPgVaded4Qc77vm0fw: checks
*** FLOP *** [Jd Js 9s]
EMc5LPgVaded4Qc77vm0fw: checks
Do9Rlu1R5u/AcRtMTl8SYg: checks
*** TURN *** [Jd Js 9s] [6s]
EMc5LPgVaded4Qc77vm0fw: bets $1
Do9Rlu1R5u/AcRtMTl8SYg: calls $1
*** RIVER *** [Jd Js 9s 6s] [9c]
EMc5LPgVaded4Qc77vm0fw: checks
Do9Rlu1R5u/AcRtMTl8SYg: bets $1.50
EMc5LPgVaded4Qc77vm0fw: folds
Do9Rlu1R5u/AcRtMTl8SYg collected $2.90 from pot
Do9Rlu1R5u/AcRtMTl8SYg: doesn't show hand
*** SUMMARY ***
Total pot $3 | Rake $0.10
Board [Jd Js 9s 6s 9c]
Seat 1: Do9Rlu1R5u/AcRtMTl8SYg (button) (small blind) collected ($2.90)
Seat 2: EMc5LPgVaded4Qc77vm0fw (big blind) folded on the River



PokerStars Game #59939141358:  Hold'em No Limit ($0.25/$0.50) - 2009/07/01 0:32:21 ET
Table 'T/PgNWqVyY6lkldcBVXYJQ' 6-max Seat #4 is the button
Seat 1: +Pf9jTVizYlIo+woPvptfA ($58 in chips)
Seat 2: oZAeY5rVqNGgt8yyQ0pxbA ($38.55 in chips)
Seat 3: L3OcNO1bgdqDI46j67KQPQ ($54.60 in chips)
Seat 4: jxMvxeUUL9UU0V6wVU+Iyw ($8.45 in chips)
Seat 5: vVQBckETtigfb5mAcyK0OA ($49.25 in chips)
Seat 6: cDzbog6kwmJp+LBeBq+iMQ ($55.25 in chips)
vVQBckETtigfb5mAcyK0OA: posts small blind $0.25
cDzbog6kwmJp+LBeBq+iMQ: posts big blind $0.50
*** HOLE CARDS ***
+Pf9jTVizYlIo+woPvptfA: folds
oZAeY5rVqNGgt8yyQ0pxbA: calls $0.50
L3OcNO1bgdqDI46j67KQPQ: folds
jxMvxeUUL9UU0V6wVU+Iyw: raises $2 to $2.50
vVQBckETtigfb5mAcyK0OA: folds
cDzbog6kwmJp+LBeBq+iMQ: calls $2
oZAeY5rVqNGgt8yyQ0pxbA: calls $2
*** FLOP *** [2c 3c 7h]
cDzbog6kwmJp+LBeBq+iMQ: checks
oZAeY5rVqNGgt8yyQ0pxbA: bets $1.50
jxMvxeUUL9UU0V6wVU+Iyw: calls $1.50
cDzbog6kwmJp+LBeBq+iMQ: calls $1.50
*** TURN *** [2c 3c 7h] [Jh]
cDzbog6kwmJp+LBeBq+iMQ: checks
oZAeY5rVqNGgt8yyQ0pxbA: checks
jxMvxeUUL9UU0V6wVU+Iyw: bets $4.45 and is all-in
cDzbog6kwmJp+LBeBq+iMQ: raises $10.55 to $15
oZAeY5rVqNGgt8yyQ0pxbA: folds
*** RIVER *** [2c 3c 7h Jh] [Qh]
*** SHOW DOWN ***
cDzbog6kwmJp+LBeBq+iMQ: shows [Js As] (a pair of Jacks)
jxMvxeUUL9UU0V6wVU+Iyw: shows [Ah Qd] (a pair of Queens)
jxMvxeUUL9UU0V6wVU+Iyw collected $20.15 from pot
*** SUMMARY ***
Total pot $21.15 | Rake $1
Board [2c 3c 7h Jh Qh]
Seat 1: +Pf9jTVizYlIo+woPvptfA folded before Flop (didn't bet)
Seat 2: oZAeY5rVqNGgt8yyQ0pxbA folded on the Turn
Seat 3: L3OcNO1bgdqDI46j67KQPQ folded before Flop (didn't bet)
Seat 4: jxMvxeUUL9UU0V6wVU+Iyw (button) showed [Ah Qd] and won ($20.15) with a pair of Queens
Seat 5: vVQBckETtigfb5mAcyK0OA (small blind) folded before Flop
Seat 6: cDzbog6kwmJp+LBeBq+iMQ (big blind) showed [Js As] and lost with a pair of Jacks



PokerStars Game #59939147030:  Hold'em No Limit ($0.25/$0.50) - 2009/07/01 0:32:29 ET
Table '+dXkOAQyS8j9PQZusUTMpg' 2-max Seat #2 is the button
Seat 1: XFa6sBGjP2gxoIvxR3fZIg ($60.75 in chips)
Seat 2: 5IBeOgaApY1Bvzv2P8X4EA ($82.65 in chips)
5IBeOgaApY1Bvzv2P8X4EA: posts small blind $0.25
XFa6sBGjP2gxoIvxR3fZIg: posts big blind $0.50
*** HOLE CARDS ***
5IBeOgaApY1Bvzv2P8X4EA: folds
XFa6sBGjP2gxoIvxR3fZIg collected $0.50 from pot
XFa6sBGjP2gxoIvxR3fZIg: doesn't show hand
*** SUMMARY ***
Total pot $0.50 | Rake $0
Seat 1: XFa6sBGjP2gxoIvxR3fZIg (big blind) collected ($0.50)
Seat 2: 5IBeOgaApY1Bvzv2P8X4EA (button) (small blind) folded before Flop



PokerStars Game #59939148240:  Hold'em No Limit ($0.25/$0.50) - 2009/07/01 0:32:31 ET
Table 'E7bWJ45aoFXRpyRv2gw+Ig' 2-max Seat #1 is the button
Seat 1: FRkiRasEGlHUeLrEl+k/nA ($50 in chips)
Seat 2: 3Wro85I7472vJ4Wkpneo9A ($143.15 in chips)
FRkiRasEGlHUeLrEl+k/nA: posts small blind $0.25
3Wro85I7472vJ4Wkpneo9A: posts big blind $0.50
*** HOLE CARDS ***
FRkiRasEGlHUeLrEl+k/nA: folds
3Wro85I7472vJ4Wkpneo9A collected $0.50 from pot
3Wro85I7472vJ4Wkpneo9A: doesn't show hand
*** SUMMARY ***
Total pot $0.50 | Rake $0
Seat 1: FRkiRasEGlHUeLrEl+k/nA (button) (small blind) folded before Flop
Seat 2: 3Wro85I7472vJ4Wkpneo9A (big blind) collected ($0.50)



PokerStars Game #59939150546:  Hold'em No Limit ($0.25/$0.50) - 2009/07/01 0:32:35 ET
Table 'c/CRn+68J3Y8KxD5g1ek2Q' 2-max Seat #1 is the button
Seat 1: 46qCyJ6evTkHo9al5sBMNA ($249 in chips)
Seat 2: BypVLsYQt3ePFm2xQL/dOA ($129.10 in chips)
46qCyJ6evTkHo9al5sBMNA: posts small blind $0.25
BypVLsYQt3ePFm2xQL/dOA: posts big blind $0.50
*** HOLE CARDS ***
46qCyJ6evTkHo9al5sBMNA: raises $1.50 to $2
BypVLsYQt3ePFm2xQL/dOA: folds
46qCyJ6evTkHo9al5sBMNA collected $1 from pot
46qCyJ6evTkHo9al5sBMNA: doesn't show hand
*** SUMMARY ***
Total pot $1 | Rake $0
Seat 1: 46qCyJ6evTkHo9al5sBMNA (button) (small blind) collected ($1)
Seat 2: BypVLsYQt3ePFm2xQL/dOA (big blind) folded before Flop



PokerStars Game #59939151130:  Hold'em No Limit ($0.25/$0.50) - 2009/07/01 0:32:35 ET
Table '+dXkOAQyS8j9PQZusUTMpg' 2-max Seat #1 is the button
Seat 1: XFa6sBGjP2gxoIvxR3fZIg ($61 in chips)
Seat 2: 5IBeOgaApY1Bvzv2P8X4EA ($82.40 in chips)
XFa6sBGjP2gxoIvxR3fZIg: posts small blind $0.25
5IBeOgaApY1Bvzv2P8X4EA: posts big blind $0.50
*** HOLE CARDS ***
XFa6sBGjP2gxoIvxR3fZIg: raises $1 to $1.50
5IBeOgaApY1Bvzv2P8X4EA: raises $1.50 to $3
XFa6sBGjP2gxoIvxR3fZIg: calls $1.50
*** FLOP *** [Kc 2s 8h]
5IBeOgaApY1Bvzv2P8X4EA: checks
XFa6sBGjP2gxoIvxR3fZIg: bets $4
5IBeOgaApY1Bvzv2P8X4EA: raises $5 to $9
XFa6sBGjP2gxoIvxR3fZIg: calls $5
*** TURN *** [Kc 2s 8h] [5d]
5IBeOgaApY1Bvzv2P8X4EA: bets $4.50
XFa6sBGjP2gxoIvxR3fZIg: raises $17 to $21.50
5IBeOgaApY1Bvzv2P8X4EA: folds
XFa6sBGjP2gxoIvxR3fZIg collected $32.50 from pot
XFa6sBGjP2gxoIvxR3fZIg: doesn't show hand
*** SUMMARY ***
Total pot $33 | Rake $0.50
Board [Kc 2s 8h 5d]
Seat 1: XFa6sBGjP2gxoIvxR3fZIg (button) (small blind) collected ($32.50)
Seat 2: 5IBeOgaApY1Bvzv2P8X4EA (big blind) folded on the Turn



PokerStars Game #59939152164:  Hold'em No Limit ($0.25/$0.50) - 2009/07/01 0:32:37 ET
Table 'E7bWJ45aoFXRpyRv2gw+Ig' 2-max Seat #2 is the button
Seat 1: FRkiRasEGlHUeLrEl+k/nA ($50 in chips)
Seat 2: 3Wro85I7472vJ4Wkpneo9A ($143.40 in chips)
3Wro85I7472vJ4Wkpneo9A: posts small blind $0.25
FRkiRasEGlHUeLrEl+k/nA: posts big blind $0.50
*** HOLE CARDS ***
3Wro85I7472vJ4Wkpneo9A: calls $0.25
FRkiRasEGlHUeLrEl+k/nA: checks
*** FLOP *** [Jd 8c Td]
FRkiRasEGlHUeLrEl+k/nA: checks
3Wro85I7472vJ4Wkpneo9A: bets $1
FRkiRasEGlHUeLrEl+k/nA: calls $1
*** TURN *** [Jd 8c Td] [4c]
FRkiRasEGlHUeLrEl+k/nA: checks
3Wro85I7472vJ4Wkpneo9A: checks
*** RIVER *** [Jd 8c Td 4c] [9d]
FRkiRasEGlHUeLrEl+k/nA: checks
3Wro85I7472vJ4Wkpneo9A: bets $2
FRkiRasEGlHUeLrEl+k/nA: folds
3Wro85I7472vJ4Wkpneo9A collected $2.90 from pot
3Wro85I7472vJ4Wkpneo9A: doesn't show hand
*** SUMMARY ***
Total pot $3 | Rake $0.10
Board [Jd 8c Td 4c 9d]
Seat 1: FRkiRasEGlHUeLrEl+k/nA (big blind) folded on the River
Seat 2: 3Wro85I7472vJ4Wkpneo9A (button) (small blind) collected ($2.90)



PokerStars Game #59939153036:  Hold'em No Limit ($0.25/$0.50) - 2009/07/01 0:32:38 ET
Table '37qXEp3oe+er5q4CZip9eQ' 6-max Seat #5 is the button
Seat 1: oqOqoO2AyCZenUghCxMDxw ($53.50 in chips)
Seat 2: 6wzJiRvp8HY6t+MQGnSIzA ($17.60 in chips)
Seat 3: Rt6KgtZ8YaJoTc3FPim00w ($95 in chips)
Seat 4: XsmE8nXMAAMFJbWaJTmHFw ($20.55 in chips)
Seat 5: VOmI0x4dDPnTESZd5B4d1Q ($41.75 in chips)
Seat 6: l4m/wWPs22DSP5xpszjXKA ($7.25 in chips)
l4m/wWPs22DSP5xpszjXKA: posts small blind $0.25
oqOqoO2AyCZenUghCxMDxw: posts big blind $0.50
*** HOLE CARDS ***
6wzJiRvp8HY6t+MQGnSIzA: raises $1.50 to $2
Rt6KgtZ8YaJoTc3FPim00w: folds
XsmE8nXMAAMFJbWaJTmHFw: folds
VOmI0x4dDPnTESZd5B4d1Q: folds
l4m/wWPs22DSP5xpszjXKA: calls $1.75
oqOqoO2AyCZenUghCxMDxw: folds
*** FLOP *** [7d 4s 6c]
l4m/wWPs22DSP5xpszjXKA: bets $2
6wzJiRvp8HY6t+MQGnSIzA: raises $4 to $6
l4m/wWPs22DSP5xpszjXKA: calls $3.25 and is all-in
*** TURN *** [7d 4s 6c] [Kd]
*** RIVER *** [7d 4s 6c Kd] [5d]
*** SHOW DOWN ***
l4m/wWPs22DSP5xpszjXKA: shows [Tc Qc] (high card King)
6wzJiRvp8HY6t+MQGnSIzA: shows [Jc Jd] (a pair of Jacks)
6wzJiRvp8HY6t+MQGnSIzA collected $14.30 from pot
*** SUMMARY ***
Total pot $15 | Rake $0.70
Board [7d 4s 6c Kd 5d]
Seat 1: oqOqoO2AyCZenUghCxMDxw (big blind) folded before Flop
Seat 2: 6wzJiRvp8HY6t+MQGnSIzA showed [Jc Jd] and won ($14.30) with a pair of Jacks
Seat 3: Rt6KgtZ8YaJoTc3FPim00w folded before Flop (didn't bet)
Seat 4: XsmE8nXMAAMFJbWaJTmHFw folded before Flop (didn't bet)
Seat 5: VOmI0x4dDPnTESZd5B4d1Q (button) folded before Flop (didn't bet)
Seat 6: l4m/wWPs22DSP5xpszjXKA (small blind) showed [Tc Qc] and lost with high card King



PokerStars Game #59939153346:  Hold'em No Limit ($0.25/$0.50) - 2009/07/01 0:32:39 ET
Table 'IeNZOZQ4T6oiaHqFeo6yIA' 2-max Seat #2 is the button
Seat 1: ndd1nfncBkWNitBnsfCoVQ ($93.20 in chips)
Seat 2: A91IUl5JaZROhtfCtnnwYw ($37.25 in chips)
A91IUl5JaZROhtfCtnnwYw: posts small blind $0.25
ndd1nfncBkWNitBnsfCoVQ: posts big blind $0.50
*** HOLE CARDS ***
A91IUl5JaZROhtfCtnnwYw: raises $0.50 to $1
ndd1nfncBkWNitBnsfCoVQ: calls $0.50
*** FLOP *** [Kh 4c 2c]
ndd1nfncBkWNitBnsfCoVQ: checks
A91IUl5JaZROhtfCtnnwYw: checks
*** TURN *** [Kh 4c 2c] [Ks]
ndd1nfncBkWNitBnsfCoVQ: checks
A91IUl5JaZROhtfCtnnwYw: checks
*** RIVER *** [Kh 4c 2c Ks] [Th]
ndd1nfncBkWNitBnsfCoVQ: bets $1
A91IUl5JaZROhtfCtnnwYw: calls $1
*** SHOW DOWN ***
ndd1nfncBkWNitBnsfCoVQ: shows [9d 6h] (a pair of Kings)
A91IUl5JaZROhtfCtnnwYw: mucks hand
ndd1nfncBkWNitBnsfCoVQ collected $3.85 from pot
*** SUMMARY ***
Total pot $4 | Rake $0.15
Board [Kh 4c 2c Ks Th]
Seat 1: ndd1nfncBkWNitBnsfCoVQ (big blind) showed [9d 6h] and won ($3.85) with a pair of Kings
Seat 2: A91IUl5JaZROhtfCtnnwYw (button) (small blind) mucked



PokerStars Game #59939153442:  Hold'em No Limit ($0.25/$0.50) - 2009/07/01 0:32:39 ET
Table 'GfL/No5u5PoEnU39lP5pQg' 6-max Seat #1 is the button
Seat 1: 1WUCqNG+p+vfWRTXNu4ljw ($50.30 in chips)
Seat 2: uVwggSetzp7d+eVgowO3vg ($55.80 in chips)
Seat 3: NbUTppWfym/RxV/DmDz2Sw ($15.70 in chips)
Seat 4: x+pzUFJsMIiGd7a5pcR4tg ($52.75 in chips)
Seat 5: crjGpJEzSZgD38FoE3VMGg ($58.05 in chips)
uVwggSetzp7d+eVgowO3vg: posts small blind $0.25
NbUTppWfym/RxV/DmDz2Sw: posts big blind $0.50
*** HOLE CARDS ***
x+pzUFJsMIiGd7a5pcR4tg: raises $1 to $1.50
crjGpJEzSZgD38FoE3VMGg: folds
1WUCqNG+p+vfWRTXNu4ljw: folds
uVwggSetzp7d+eVgowO3vg: calls $1.25
NbUTppWfym/RxV/DmDz2Sw: folds
*** FLOP *** [9h 3d 9d]
uVwggSetzp7d+eVgowO3vg: checks
x+pzUFJsMIiGd7a5pcR4tg: bets $2.50
uVwggSetzp7d+eVgowO3vg: folds
x+pzUFJsMIiGd7a5pcR4tg collected $3.35 from pot
x+pzUFJsMIiGd7a5pcR4tg: doesn't show hand
*** SUMMARY ***
Total pot $3.50 | Rake $0.15
Board [9h 3d 9d]
Seat 1: 1WUCqNG+p+vfWRTXNu4ljw (button) folded before Flop (didn't bet)
Seat 2: uVwggSetzp7d+eVgowO3vg (small blind) folded on the Flop
Seat 3: NbUTppWfym/RxV/DmDz2Sw (big blind) folded before Flop
Seat 4: x+pzUFJsMIiGd7a5pcR4tg collected ($3.35)
Seat 5: crjGpJEzSZgD38FoE3VMGg folded before Flop (didn't bet)



PokerStars Game #59939155488:  Hold'em No Limit ($0.25/$0.50) - 2009/07/01 0:32:42 ET
Table 'fx6MqwfYAj/Rt86hBz2L3Q' 9-max Seat #9 is the button
Seat 1: jf2c/o9gI7Xj0GleCSMj9g ($50.50 in chips)
Seat 2: C3rGXblctNcWI6JYPHhaEg ($25.25 in chips)
Seat 3: iadBi5AEt7gTBXbDSSnMYQ ($60.50 in chips)
Seat 4: gPEN9Zp33YTm/mu9/SYP1w ($23.20 in chips)
Seat 6: 5k9fvXD9suIgCxU4HLQjTw ($50 in chips)
Seat 7: bkXkL3pmapikPQQRNPZSEA ($16.15 in chips)
Seat 8: CAuekkxPVzBL9SK4Tjjbuw ($29 in chips)
Seat 9: HZkVla4kK2SI42CVrPZ/ig ($8.50 in chips)
jf2c/o9gI7Xj0GleCSMj9g: posts small blind $0.25
C3rGXblctNcWI6JYPHhaEg: posts big blind $0.50
*** HOLE CARDS ***
iadBi5AEt7gTBXbDSSnMYQ: calls $0.50
iAISe3dVeua8PUn2wwgDHw has returned
gPEN9Zp33YTm/mu9/SYP1w: calls $0.50
5k9fvXD9suIgCxU4HLQjTw: folds
bkXkL3pmapikPQQRNPZSEA: calls $0.50
CAuekkxPVzBL9SK4Tjjbuw: folds
HZkVla4kK2SI42CVrPZ/ig: folds
jf2c/o9gI7Xj0GleCSMj9g: calls $0.25
C3rGXblctNcWI6JYPHhaEg: checks
*** FLOP *** [8h 4c 3h]
jf2c/o9gI7Xj0GleCSMj9g: checks
C3rGXblctNcWI6JYPHhaEg: bets $0.75
iadBi5AEt7gTBXbDSSnMYQ: calls $0.75
gPEN9Zp33YTm/mu9/SYP1w: folds
bkXkL3pmapikPQQRNPZSEA: calls $0.75
jf2c/o9gI7Xj0GleCSMj9g: folds
*** TURN *** [8h 4c 3h] [3c]
C3rGXblctNcWI6JYPHhaEg: bets $2
iadBi5AEt7gTBXbDSSnMYQ: calls $2
bkXkL3pmapikPQQRNPZSEA: calls $2
*** RIVER *** [8h 4c 3h 3c] [7d]
C3rGXblctNcWI6JYPHhaEg: checks
iadBi5AEt7gTBXbDSSnMYQ: bets $1.50
bkXkL3pmapikPQQRNPZSEA: calls $1.50
C3rGXblctNcWI6JYPHhaEg: folds
*** SHOW DOWN ***
iadBi5AEt7gTBXbDSSnMYQ: shows [5s 5d] (two pair, Fives and Threes)
bkXkL3pmapikPQQRNPZSEA: shows [3s As] (three of a kind, Threes)
bkXkL3pmapikPQQRNPZSEA collected $13.10 from pot
*** SUMMARY ***
Total pot $13.75 | Rake $0.65
Board [8h 4c 3h 3c 7d]
Seat 1: jf2c/o9gI7Xj0GleCSMj9g (small blind) folded on the Flop
Seat 2: C3rGXblctNcWI6JYPHhaEg (big blind) folded on the River
Seat 3: iadBi5AEt7gTBXbDSSnMYQ showed [5s 5d] and lost with two pair, Fives and Threes
Seat 4: gPEN9Zp33YTm/mu9/SYP1w folded on the Flop
Seat 6: 5k9fvXD9suIgCxU4HLQjTw folded before Flop (didn't bet)
Seat 7: bkXkL3pmapikPQQRNPZSEA showed [3s As] and won ($13.10) with three of a kind, Threes
Seat 8: CAuekkxPVzBL9SK4Tjjbuw folded before Flop (didn't bet)
Seat 9: HZkVla4kK2SI42CVrPZ/ig (button) folded before Flop (didn't bet)



PokerStars Game #59939156886:  Hold'em No Limit ($0.25/$0.50) - 2009/07/01 0:32:44 ET
Table 'c/CRn+68J3Y8KxD5g1ek2Q' 2-max Seat #2 is the button
Seat 1: 46qCyJ6evTkHo9al5sBMNA ($249.50 in chips)
Seat 2: BypVLsYQt3ePFm2xQL/dOA ($128.60 in chips)
BypVLsYQt3ePFm2xQL/dOA: posts small blind $0.25
46qCyJ6evTkHo9al5sBMNA: posts big blind $0.50
*** HOLE CARDS ***
BypVLsYQt3ePFm2xQL/dOA: raises $2 to $2.50
46qCyJ6evTkHo9al5sBMNA: folds
BypVLsYQt3ePFm2xQL/dOA collected $1 from pot
BypVLsYQt3ePFm2xQL/dOA: doesn't show hand
*** SUMMARY ***
Total pot $1 | Rake $0
Seat 1: 46qCyJ6evTkHo9al5sBMNA (big blind) folded before Flop
Seat 2: BypVLsYQt3ePFm2xQL/dOA (button) (small blind) collected ($1)



PokerStars Game #59939157284:  Hold'em No Limit ($0.25/$0.50) - 2009/07/01 0:32:45 ET
Table 'mTxf8gPLgffN3Iwfm7Icfg' 2-max Seat #2 is the button
Seat 1: Do9Rlu1R5u/AcRtMTl8SYg ($89.45 in chips)
Seat 2: EMc5LPgVaded4Qc77vm0fw ($69.70 in chips)
EMc5LPgVaded4Qc77vm0fw: posts small blind $0.25
Do9Rlu1R5u/AcRtMTl8SYg: posts big blind $0.50
*** HOLE CARDS ***
EMc5LPgVaded4Qc77vm0fw: raises $1 to $1.50
Do9Rlu1R5u/AcRtMTl8SYg: folds
EMc5LPgVaded4Qc77vm0fw collected $1 from pot
EMc5LPgVaded4Qc77vm0fw: doesn't show hand
*** SUMMARY ***
Total pot $1 | Rake $0
Seat 1: Do9Rlu1R5u/AcRtMTl8SYg (big blind) folded before Flop
Seat 2: EMc5LPgVaded4Qc77vm0fw (button) (small blind) collected ($1)



PokerStars Game #59939157556:  Hold'em No Limit ($0.25/$0.50) - 2009/07/01 0:32:45 ET
Table '+z1aekfHkpp09pc8F9aViw' 6-max Seat #6 is the button
Seat 2: M6xK/VklCvdyyrmvzATlxQ ($37.80 in chips)
Seat 3: uUznlIMFnRUvwrBhYF73KA ($55.60 in chips)
Seat 4: RowCSpSURHTOL/dcjg/Iug ($49.30 in chips)
Seat 5: crjGpJEzSZgD38FoE3VMGg ($55.35 in chips)
Seat 6: 686aeHikcJlgKkSuIFdcXQ ($69.35 in chips)
FHilMb2i2DbUCc9lplszog will be allowed to play after the button
M6xK/VklCvdyyrmvzATlxQ: posts small blind $0.25
uUznlIMFnRUvwrBhYF73KA: posts big blind $0.50
*** HOLE CARDS ***
RowCSpSURHTOL/dcjg/Iug: folds
crjGpJEzSZgD38FoE3VMGg: folds
686aeHikcJlgKkSuIFdcXQ: folds
M6xK/VklCvdyyrmvzATlxQ: raises $1 to $1.50
uUznlIMFnRUvwrBhYF73KA: folds
M6xK/VklCvdyyrmvzATlxQ collected $1 from pot
*** SUMMARY ***
Total pot $1 | Rake $0
Seat 2: M6xK/VklCvdyyrmvzATlxQ (small blind) collected ($1)
Seat 3: uUznlIMFnRUvwrBhYF73KA (big blind) folded before Flop
Seat 4: RowCSpSURHTOL/dcjg/Iug folded before Flop (didn't bet)
Seat 5: crjGpJEzSZgD38FoE3VMGg folded before Flop (didn't bet)
Seat 6: 686aeHikcJlgKkSuIFdcXQ (button) folded before Flop (didn't bet)



PokerStars Game #59939157522:  Hold'em No Limit ($0.25/$0.50) - 2009/07/01 0:32:45 ET
Table 'QOgaEqMcJ73pcUMMxoisUgErOuyGLI5PT3G5MnpHgC/g Seat #1 is the button
Seat 1: L5e2lrPLQm1Pqx30IIZ/Fw ($10 in chips)
Seat 2: RjBdQ6w31rgcy0o24VLR6w ($9.70 in chips)
Seat 3: xZCXQSXlrZkp3pZizzVXCw ($49.75 in chips)
Seat 4: 3UmXLy3GfjC3EkOebduerQ ($50 in chips)
Seat 5: JwvquocWfhTVApN5t47LgA ($57.80 in chips)
Seat 6: zE9cVigS2nW/Ljy4K4bUQA ($30 in chips)
Seat 7: 90Wb75h3W1BRpbqVnuk8gw ($72.65 in chips)
Seat 8: g4k0NXISyLCqaSWZDBjfEg ($52.10 in chips)
Seat 9: J0W5D97jl5VLky+IoPvDeA ($56.40 in chips)
RjBdQ6w31rgcy0o24VLR6w: posts small blind $0.25
xZCXQSXlrZkp3pZizzVXCw: posts big blind $0.50
*** HOLE CARDS ***
3UmXLy3GfjC3EkOebduerQ: folds
JwvquocWfhTVApN5t47LgA: folds
zE9cVigS2nW/Ljy4K4bUQA: folds
90Wb75h3W1BRpbqVnuk8gw: raises $1.50 to $2
g4k0NXISyLCqaSWZDBjfEg: folds
J0W5D97jl5VLky+IoPvDeA: folds
L5e2lrPLQm1Pqx30IIZ/Fw: folds
RjBdQ6w31rgcy0o24VLR6w: raises $7.70 to $9.70 and is all-in
xZCXQSXlrZkp3pZizzVXCw: folds
90Wb75h3W1BRpbqVnuk8gw: calls $7.70
*** FLOP *** [3h 4s 3c]
*** TURN *** [3h 4s 3c] [8c]
*** RIVER *** [3h 4s 3c 8c] [4h]
*** SHOW DOWN ***
RjBdQ6w31rgcy0o24VLR6w: shows [9h 9s] (two pair, Nines and Fours)
90Wb75h3W1BRpbqVnuk8gw: mucks hand
RjBdQ6w31rgcy0o24VLR6w collected $18.95 from pot
*** SUMMARY ***
Total pot $19.90 | Rake $0.95
Board [3h 4s 3c 8c 4h]
Seat 1: L5e2lrPLQm1Pqx30IIZ/Fw (button) folded before Flop (didn't bet)
Seat 2: RjBdQ6w31rgcy0o24VLR6w (small blind) showed [9h 9s] and won ($18.95) with two pair, Nines and Fours
Seat 3: xZCXQSXlrZkp3pZizzVXCw (big blind) folded before Flop
Seat 4: 3UmXLy3GfjC3EkOebduerQ folded before Flop (didn't bet)
Seat 5: JwvquocWfhTVApN5t47LgA folded before Flop (didn't bet)
Seat 6: zE9cVigS2nW/Ljy4K4bUQA folded before Flop (didn't bet)
Seat 7: 90Wb75h3W1BRpbqVnuk8gw mucked
Seat 8: g4k0NXISyLCqaSWZDBjfEg folded before Flop (didn't bet)
Seat 9: J0W5D97jl5VLky+IoPvDeA folded before Flop (didn't bet)



PokerStars Game #59939158352:  Hold'em No Limit ($0.25/$0.50) - 2009/07/01 0:32:46 ET
Table 'kgbJRsxfv64KrErDRBAkcw' 6-max Seat #1 is the button
Seat 1: mxTUARCsU8Eby0whmHNcOw ($7.50 in chips)
Seat 2: Q+thC23WCv1kJUJtH/+4Jw ($59.05 in chips)
Seat 3: T0Gx/FcQ5VH9u7XaOMX97A ($80.85 in chips)
Seat 4: qanMEqjABjWxC/JgQ/0l7w ($57.70 in chips)
Seat 5: +Pf9jTVizYlIo+woPvptfA ($52.30 in chips)
Seat 6: ozrlafxxh1HmYdA0/h+MuA ($13.70 in chips)
Q+thC23WCv1kJUJtH/+4Jw: posts small blind $0.25
T0Gx/FcQ5VH9u7XaOMX97A: posts big blind $0.50
*** HOLE CARDS ***
qanMEqjABjWxC/JgQ/0l7w: folds
+Pf9jTVizYlIo+woPvptfA: folds
ozrlafxxh1HmYdA0/h+MuA: calls $0.50
mxTUARCsU8Eby0whmHNcOw: folds
Q+thC23WCv1kJUJtH/+4Jw: folds
T0Gx/FcQ5VH9u7XaOMX97A: checks
*** FLOP *** [7c Jc 4c]
T0Gx/FcQ5VH9u7XaOMX97A: checks
ozrlafxxh1HmYdA0/h+MuA: bets $1
T0Gx/FcQ5VH9u7XaOMX97A: folds
ozrlafxxh1HmYdA0/h+MuA collected $1.20 from pot
*** SUMMARY ***
Total pot $1.25 | Rake $0.05
Board [7c Jc 4c]
Seat 1: mxTUARCsU8Eby0whmHNcOw (button) folded before Flop (didn't bet)
Seat 2: Q+thC23WCv1kJUJtH/+4Jw (small blind) folded before Flop
Seat 3: T0Gx/FcQ5VH9u7XaOMX97A (big blind) folded on the Flop
Seat 4: qanMEqjABjWxC/JgQ/0l7w folded before Flop (didn't bet)
Seat 5: +Pf9jTVizYlIo+woPvptfA folded before Flop (didn't bet)
Seat 6: ozrlafxxh1HmYdA0/h+MuA collected ($1.20)



PokerStars Game #59939158628:  Hold'em No Limit ($0.25/$0.50) - 2009/07/01 0:32:47 ET
Table 'lSisgp6H7Fg1hH5VfjEjYQ' 9-max Seat #5 is the button
Seat 1: pEW8B6uXbdR47kfljMQ3+Q ($37.85 in chips)
Seat 2: UrcnkQOiLVk8BlKDPJSy7Q ($50 in chips)
Seat 3: aTkyjTh3w5YLWiIERupZOA ($42.45 in chips)
Seat 4: bwv/rbH/hHhPhY6u9mu04w ($21.65 in chips)
Seat 5: mSD1pginDsyHG5PDfqzphw ($10 in chips)
Seat 6: +k7T5ocke8UwavtgUHm+Cg ($23.85 in chips)
Seat 7: Y3DZ6qQlLeBhixDj4M9vmg ($15 in chips)
Seat 8: a4JDWmpFQkL10XfAyuF51A ($38 in chips)
Seat 9: 5JJVDlaiMnB004o/RqbZZQ ($45.25 in chips)
+k7T5ocke8UwavtgUHm+Cg: posts small blind $0.25
Y3DZ6qQlLeBhixDj4M9vmg: posts big blind $0.50
*** HOLE CARDS ***
a4JDWmpFQkL10XfAyuF51A: calls $0.50
5JJVDlaiMnB004o/RqbZZQ: folds
pEW8B6uXbdR47kfljMQ3+Q is disconnected
pEW8B6uXbdR47kfljMQ3+Q is connected
pEW8B6uXbdR47kfljMQ3+Q: folds
UrcnkQOiLVk8BlKDPJSy7Q: raises $2 to $2.50
aTkyjTh3w5YLWiIERupZOA: folds
bwv/rbH/hHhPhY6u9mu04w: folds
mSD1pginDsyHG5PDfqzphw: folds
+k7T5ocke8UwavtgUHm+Cg: calls $2.25
Y3DZ6qQlLeBhixDj4M9vmg: folds
a4JDWmpFQkL10XfAyuF51A: calls $2
*** FLOP *** [Th 4h 5c]
+k7T5ocke8UwavtgUHm+Cg: checks
a4JDWmpFQkL10XfAyuF51A: checks
UrcnkQOiLVk8BlKDPJSy7Q: checks
*** TURN *** [Th 4h 5c] [3s]
+k7T5ocke8UwavtgUHm+Cg: bets $4
a4JDWmpFQkL10XfAyuF51A: folds
UrcnkQOiLVk8BlKDPJSy7Q: folds
+k7T5ocke8UwavtgUHm+Cg collected $7.60 from pot
+k7T5ocke8UwavtgUHm+Cg: doesn't show hand
*** SUMMARY ***
Total pot $8 | Rake $0.40
Board [Th 4h 5c 3s]
Seat 1: pEW8B6uXbdR47kfljMQ3+Q folded before Flop (didn't bet)
Seat 2: UrcnkQOiLVk8BlKDPJSy7Q folded on the Turn
Seat 3: aTkyjTh3w5YLWiIERupZOA folded before Flop (didn't bet)
Seat 4: bwv/rbH/hHhPhY6u9mu04w folded before Flop (didn't bet)
Seat 5: mSD1pginDsyHG5PDfqzphw (button) folded before Flop (didn't bet)
Seat 6: +k7T5ocke8UwavtgUHm+Cg (small blind) collected ($7.60)
Seat 7: Y3DZ6qQlLeBhixDj4M9vmg (big blind) folded before Flop
Seat 8: a4JDWmpFQkL10XfAyuF51A folded on the Turn
Seat 9: 5JJVDlaiMnB004o/RqbZZQ folded before Flop (didn't bet)



PokerStars Game #59939160030:  Hold'em No Limit ($0.25/$0.50) - 2009/07/01 0:32:49 ET
Table '3FhG0gl3kMX3wBEEqj+wnQ' 9-max Seat #5 is the button
Seat 1: e0J9pdCNUDTCG031RnXqLA ($17 in chips)
Seat 3: HZkVla4kK2SI42CVrPZ/ig ($8.75 in chips)
Seat 4: bz4LMfV0GGl/MJ/ABXuPmg ($20.35 in chips)
Seat 5: XNMDwbXt/Q4jM99AXnbJDw ($50 in chips)
Seat 6: 5JJVDlaiMnB004o/RqbZZQ ($46.05 in chips)
Seat 7: mSD1pginDsyHG5PDfqzphw ($10 in chips)
Seat 8: j3K/Jujr7PY4ZM2RZvlH6A ($60.55 in chips)
Seat 9: L5e2lrPLQm1Pqx30IIZ/Fw ($10.85 in chips)
5JJVDlaiMnB004o/RqbZZQ: posts small blind $0.25
mSD1pginDsyHG5PDfqzphw: posts big blind $0.50
7cYQ+syUWjl38ty/ICOMhw: sits out
*** HOLE CARDS ***
j3K/Jujr7PY4ZM2RZvlH6A: folds
L5e2lrPLQm1Pqx30IIZ/Fw: folds
e0J9pdCNUDTCG031RnXqLA: folds
HZkVla4kK2SI42CVrPZ/ig: folds
bz4LMfV0GGl/MJ/ABXuPmg: folds
XNMDwbXt/Q4jM99AXnbJDw: raises $0.50 to $1
5JJVDlaiMnB004o/RqbZZQ: folds
mSD1pginDsyHG5PDfqzphw: folds
XNMDwbXt/Q4jM99AXnbJDw collected $1.25 from pot
XNMDwbXt/Q4jM99AXnbJDw: doesn't show hand
*** SUMMARY ***
Total pot $1.25 | Rake $0
Seat 1: e0J9pdCNUDTCG031RnXqLA folded before Flop (didn't bet)
Seat 3: HZkVla4kK2SI42CVrPZ/ig folded before Flop (didn't bet)
Seat 4: bz4LMfV0GGl/MJ/ABXuPmg folded before Flop (didn't bet)
Seat 5: XNMDwbXt/Q4jM99AXnbJDw (button) collected ($1.25)
Seat 6: 5JJVDlaiMnB004o/RqbZZQ (small blind) folded before Flop
Seat 7: mSD1pginDsyHG5PDfqzphw (big blind) folded before Flop
Seat 8: j3K/Jujr7PY4ZM2RZvlH6A folded before Flop (didn't bet)
Seat 9: L5e2lrPLQm1Pqx30IIZ/Fw folded before Flop (didn't bet)



PokerStars Game #59939161020:  Hold'em No Limit ($0.25/$0.50) - 2009/07/01 0:32:50 ET
Table '/cQuAT3ef4t+PGrXiNhGaQ' 9-max Seat #8 is the button
Seat 1: HZkVla4kK2SI42CVrPZ/ig ($10 in chips)
Seat 2: jXGruyaMqirTaTXNOvBdew ($71.40 in chips)
Seat 3: g4k0NXISyLCqaSWZDBjfEg ($53.90 in chips)
Seat 4: OWP/DOu+PlPK6ZZ3zYa0HA ($41.65 in chips)
Seat 5: 5SgaHdWixdClWvaEG+KUjQ ($20.95 in chips)
Seat 6: APYIOyK/4AGb+kIwlOUNBQ ($43 in chips)
Seat 7: J0W5D97jl5VLky+IoPvDeA ($114.90 in chips)
Seat 8: W3ingbA178eb7J5rt1PuIQ ($37.35 in chips)
Seat 9: E2518gp4aFz1+kAgmGqeEg ($10.50 in chips)
E2518gp4aFz1+kAgmGqeEg: posts small blind $0.25
HZkVla4kK2SI42CVrPZ/ig: posts big blind $0.50
*** HOLE CARDS ***
jXGruyaMqirTaTXNOvBdew: folds
g4k0NXISyLCqaSWZDBjfEg: folds
OWP/DOu+PlPK6ZZ3zYa0HA: folds
5SgaHdWixdClWvaEG+KUjQ: folds
APYIOyK/4AGb+kIwlOUNBQ: raises $1 to $1.50
J0W5D97jl5VLky+IoPvDeA: folds
W3ingbA178eb7J5rt1PuIQ: folds
E2518gp4aFz1+kAgmGqeEg: folds
HZkVla4kK2SI42CVrPZ/ig: folds
APYIOyK/4AGb+kIwlOUNBQ collected $1.25 from pot
*** SUMMARY ***
Total pot $1.25 | Rake $0
Seat 1: HZkVla4kK2SI42CVrPZ/ig (big blind) folded before Flop
Seat 2: jXGruyaMqirTaTXNOvBdew folded before Flop (didn't bet)
Seat 3: g4k0NXISyLCqaSWZDBjfEg folded before Flop (didn't bet)
Seat 4: OWP/DOu+PlPK6ZZ3zYa0HA folded before Flop (didn't bet)
Seat 5: 5SgaHdWixdClWvaEG+KUjQ folded before Flop (didn't bet)
Seat 6: APYIOyK/4AGb+kIwlOUNBQ collected ($1.25)
Seat 7: J0W5D97jl5VLky+IoPvDeA folded before Flop (didn't bet)
Seat 8: W3ingbA178eb7J5rt1PuIQ (button) folded before Flop (didn't bet)
Seat 9: E2518gp4aFz1+kAgmGqeEg (small blind) folded before Flop



PokerStars Game #59939163160:  Hold'em No Limit ($0.25/$0.50) - 2009/07/01 0:32:54 ET
Table 'tyR5AZNKV8Aadbrnrnlg7g' 6-max Seat #1 is the button
Seat 1: R+KjpH/wSjDLhtIy9+edNA ($80.25 in chips)
Seat 2: 58zdeSBSuSFX/qZfhc7YmA ($37.60 in chips)
Seat 3: tdOvWynovql5imfooroLMg ($48.75 in chips)
Seat 4: Rt6KgtZ8YaJoTc3FPim00w ($83.95 in chips)
Seat 5: wOyVV9M/oyiw3YaOjNZ05w ($58.70 in chips)
Seat 6: ZKazl1hGaPiapDXincgi2Q ($22.20 in chips)
58zdeSBSuSFX/qZfhc7YmA: posts small blind $0.25
tdOvWynovql5imfooroLMg: posts big blind $0.50
*** HOLE CARDS ***
Rt6KgtZ8YaJoTc3FPim00w: folds
wOyVV9M/oyiw3YaOjNZ05w: folds
ZKazl1hGaPiapDXincgi2Q: folds
R+KjpH/wSjDLhtIy9+edNA: raises $1 to $1.50
58zdeSBSuSFX/qZfhc7YmA: folds
tdOvWynovql5imfooroLMg: folds
R+KjpH/wSjDLhtIy9+edNA collected $1.25 from pot
R+KjpH/wSjDLhtIy9+edNA: doesn't show hand
*** SUMMARY ***
Total pot $1.25 | Rake $0
Seat 1: R+KjpH/wSjDLhtIy9+edNA (button) collected ($1.25)
Seat 2: 58zdeSBSuSFX/qZfhc7YmA (small blind) folded before Flop
Seat 3: tdOvWynovql5imfooroLMg (big blind) folded before Flop
Seat 4: Rt6KgtZ8YaJoTc3FPim00w folded before Flop (didn't bet)
Seat 5: wOyVV9M/oyiw3YaOjNZ05w folded before Flop (didn't bet)
Seat 6: ZKazl1hGaPiapDXincgi2Q folded before Flop (didn't bet)



PokerStars Game #59939164222:  Hold'em No Limit ($0.25/$0.50) - 2009/07/01 0:32:55 ET
Table 'otvGDROEDdqsabxskT79qg' 9-max Seat #8 is the button
Seat 1: 8ehL7qlZzjgUh2H35iiWLw ($50 in chips)
Seat 2: cCjTzH9jio8607WzjcfXlg ($9.50 in chips)
Seat 3: +k7T5ocke8UwavtgUHm+Cg ($74.65 in chips)
Seat 4: MG90wfSJZnOejs/KD3vlQQ ($56.15 in chips)
Seat 5: XNMDwbXt/Q4jM99AXnbJDw ($55.55 in chips)
Seat 6: bxLSulbgr8LmKNjOzw8URg ($49.25 in chips)
Seat 7: C7+tBppJrKgd/r+tuKUIpA ($34.15 in chips)
Seat 8: zE9cVigS2nW/Ljy4K4bUQA ($30 in chips)
Seat 9: KcY3X8YpD74Kw1RHkx/g4A ($71 in chips)
KcY3X8YpD74Kw1RHkx/g4A: posts small blind $0.25
8ehL7qlZzjgUh2H35iiWLw: posts big blind $0.50
*** HOLE CARDS ***
cCjTzH9jio8607WzjcfXlg: folds
+k7T5ocke8UwavtgUHm+Cg: folds
MG90wfSJZnOejs/KD3vlQQ: folds
XNMDwbXt/Q4jM99AXnbJDw: folds
bxLSulbgr8LmKNjOzw8URg: folds
C7+tBppJrKgd/r+tuKUIpA: folds
zE9cVigS2nW/Ljy4K4bUQA: raises $1 to $1.50
KcY3X8YpD74Kw1RHkx/g4A: calls $1.25
8ehL7qlZzjgUh2H35iiWLw: calls $1
*** FLOP *** [2d 3s 6c]
KcY3X8YpD74Kw1RHkx/g4A: checks
8ehL7qlZzjgUh2H35iiWLw: bets $3
zE9cVigS2nW/Ljy4K4bUQA: folds
KcY3X8YpD74Kw1RHkx/g4A: calls $3
*** TURN *** [2d 3s 6c] [As]
KcY3X8YpD74Kw1RHkx/g4A: checks
8ehL7qlZzjgUh2H35iiWLw: bets $7
KcY3X8YpD74Kw1RHkx/g4A: folds
8ehL7qlZzjgUh2H35iiWLw collected $10 from pot
8ehL7qlZzjgUh2H35iiWLw: doesn't show hand
*** SUMMARY ***
Total pot $10.50 | Rake $0.50
Board [2d 3s 6c As]
Seat 1: 8ehL7qlZzjgUh2H35iiWLw (big blind) collected ($10)
Seat 2: cCjTzH9jio8607WzjcfXlg folded before Flop (didn't bet)
Seat 3: +k7T5ocke8UwavtgUHm+Cg folded before Flop (didn't bet)
Seat 4: MG90wfSJZnOejs/KD3vlQQ folded before Flop (didn't bet)
Seat 5: XNMDwbXt/Q4jM99AXnbJDw folded before Flop (didn't bet)
Seat 6: bxLSulbgr8LmKNjOzw8URg folded before Flop (didn't bet)
Seat 7: C7+tBppJrKgd/r+tuKUIpA folded before Flop (didn't bet)
Seat 8: zE9cVigS2nW/Ljy4K4bUQA (button) folded on the Flop
Seat 9: KcY3X8YpD74Kw1RHkx/g4A (small blind) folded on the Turn



PokerStars Game #59939164562:  Hold'em No Limit ($0.25/$0.50) - 2009/07/01 0:32:56 ET
Table 'mTxf8gPLgffN3Iwfm7Icfg' 2-max Seat #1 is the button
Seat 1: Do9Rlu1R5u/AcRtMTl8SYg ($88.95 in chips)
Seat 2: EMc5LPgVaded4Qc77vm0fw ($70.20 in chips)
Do9Rlu1R5u/AcRtMTl8SYg: posts small blind $0.25
EMc5LPgVaded4Qc77vm0fw: posts big blind $0.50
*** HOLE CARDS ***
Do9Rlu1R5u/AcRtMTl8SYg: raises $1 to $1.50
EMc5LPgVaded4Qc77vm0fw: calls $1
*** FLOP *** [4s 8c Th]
EMc5LPgVaded4Qc77vm0fw: checks
Do9Rlu1R5u/AcRtMTl8SYg: checks
*** TURN *** [4s 8c Th] [8s]
EMc5LPgVaded4Qc77vm0fw: checks
Do9Rlu1R5u/AcRtMTl8SYg: checks
*** RIVER *** [4s 8c Th 8s] [Jd]
EMc5LPgVaded4Qc77vm0fw: bets $1
Do9Rlu1R5u/AcRtMTl8SYg: folds
EMc5LPgVaded4Qc77vm0fw collected $2.85 from pot
EMc5LPgVaded4Qc77vm0fw: doesn't show hand
*** SUMMARY ***
Total pot $3 | Rake $0.15
Board [4s 8c Th 8s Jd]
Seat 1: Do9Rlu1R5u/AcRtMTl8SYg (button) (small blind) folded on the River
Seat 2: EMc5LPgVaded4Qc77vm0fw (big blind) collected ($2.85)



PokerStars Game #59939165958:  Hold'em No Limit ($0.25/$0.50) - 2009/07/01 0:32:58 ET
Table 'c/CRn+68J3Y8KxD5g1ek2Q' 2-max Seat #1 is the button
Seat 1: 46qCyJ6evTkHo9al5sBMNA ($249 in chips)
Seat 2: BypVLsYQt3ePFm2xQL/dOA ($129.10 in chips)
46qCyJ6evTkHo9al5sBMNA: posts small blind $0.25
BypVLsYQt3ePFm2xQL/dOA: posts big blind $0.50
*** HOLE CARDS ***
46qCyJ6evTkHo9al5sBMNA: folds
BypVLsYQt3ePFm2xQL/dOA collected $0.50 from pot
BypVLsYQt3ePFm2xQL/dOA: doesn't show hand
*** SUMMARY ***
Total pot $0.50 | Rake $0
Seat 1: 46qCyJ6evTkHo9al5sBMNA (button) (small blind) folded before Flop
Seat 2: BypVLsYQt3ePFm2xQL/dOA (big blind) collected ($0.50)



PokerStars Game #59939166322:  Hold'em No Limit ($0.25/$0.50) - 2009/07/01 0:32:58 ET
Table 'EiNh8p/wGJ1FP575iMFnqg' 9-max Seat #8 is the button
Seat 1: r3ZqM1Mi0W3y4hOdssE+Sg ($49 in chips)
Seat 3: ymLPoEIl7UL3TvZYmnadxQ ($51.85 in chips)
Seat 4: HIIPkpiaCQfs5HcPKjlHvg ($31.95 in chips)
Seat 5: M+7+BTmX5vZatHVuoRB1nA ($85.85 in chips)
Seat 6: 3UmXLy3GfjC3EkOebduerQ ($53.90 in chips)
Seat 7: Wj7mKnRFR90j40wWUu2+Og ($71.05 in chips)
Seat 8: KrPAGRACBg+w0M//SXe8Ag ($9.80 in chips)
Seat 9: OMwFJ4pF0xk2Ru/AJiFeFw ($80 in chips)
OMwFJ4pF0xk2Ru/AJiFeFw: posts small blind $0.25
r3ZqM1Mi0W3y4hOdssE+Sg: posts big blind $0.50
8ehL7qlZzjgUh2H35iiWLw: sits out
*** HOLE CARDS ***
ymLPoEIl7UL3TvZYmnadxQ: folds
HIIPkpiaCQfs5HcPKjlHvg: folds
M+7+BTmX5vZatHVuoRB1nA: folds
3UmXLy3GfjC3EkOebduerQ: raises $1.50 to $2
Wj7mKnRFR90j40wWUu2+Og: folds
KrPAGRACBg+w0M//SXe8Ag: folds
OMwFJ4pF0xk2Ru/AJiFeFw: folds
r3ZqM1Mi0W3y4hOdssE+Sg: folds
3UmXLy3GfjC3EkOebduerQ collected $1.25 from pot
3UmXLy3GfjC3EkOebduerQ: doesn't show hand
*** SUMMARY ***
Total pot $1.25 | Rake $0
Seat 1: r3ZqM1Mi0W3y4hOdssE+Sg (big blind) folded before Flop
Seat 3: ymLPoEIl7UL3TvZYmnadxQ folded before Flop (didn't bet)
Seat 4: HIIPkpiaCQfs5HcPKjlHvg folded before Flop (didn't bet)
Seat 5: M+7+BTmX5vZatHVuoRB1nA folded before Flop (didn't bet)
Seat 6: 3UmXLy3GfjC3EkOebduerQ collected ($1.25)
Seat 7: Wj7mKnRFR90j40wWUu2+Og folded before Flop (didn't bet)
Seat 8: KrPAGRACBg+w0M//SXe8Ag (button) folded before Flop (didn't bet)
Seat 9: OMwFJ4pF0xk2Ru/AJiFeFw (small blind) folded before Flop



PokerStars Game #59939168042:  Hold'em No Limit ($0.25/$0.50) - 2009/07/01 0:33:01 ET
Table 'IeNZOZQ4T6oiaHqFeo6yIA' 2-max Seat #1 is the button
Seat 1: ndd1nfncBkWNitBnsfCoVQ ($95.05 in chips)
Seat 2: A91IUl5JaZROhtfCtnnwYw ($35.25 in chips)
ndd1nfncBkWNitBnsfCoVQ: posts small blind $0.25
A91IUl5JaZROhtfCtnnwYw: posts big blind $0.50
*** HOLE CARDS ***
ndd1nfncBkWNitBnsfCoVQ: raises $1 to $1.50
A91IUl5JaZROhtfCtnnwYw: raises $1 to $2.50
ndd1nfncBkWNitBnsfCoVQ: calls $1
*** FLOP *** [8h 5c 2h]
A91IUl5JaZROhtfCtnnwYw: bets $4
ndd1nfncBkWNitBnsfCoVQ: calls $4
*** TURN *** [8h 5c 2h] [5d]
A91IUl5JaZROhtfCtnnwYw: bets $11.50
ndd1nfncBkWNitBnsfCoVQ: folds
A91IUl5JaZROhtfCtnnwYw collected $12.50 from pot
A91IUl5JaZROhtfCtnnwYw: doesn't show hand
*** SUMMARY ***
Total pot $13 | Rake $0.50
Board [8h 5c 2h 5d]
Seat 1: ndd1nfncBkWNitBnsfCoVQ (button) (small blind) folded on the Turn
Seat 2: A91IUl5JaZROhtfCtnnwYw (big blind) collected ($12.50)



PokerStars Game #59939167714:  Hold'em No Limit ($0.25/$0.50) - 2009/07/01 0:33:01 ET
Table '5EmHi+fnatGQQShcNmzOZQ' 6-max Seat #1 is the button
Seat 1: SwPczQo3cOtwEzhJrfO2cQ ($29.75 in chips)
Seat 2: vXIHnZ+dv/hwSBxyvGw7bQ ($50.45 in chips)
Seat 3: L9qfLYXrczhAPd/VckgsWw ($62.70 in chips)
Seat 4: wOyVV9M/oyiw3YaOjNZ05w ($53.10 in chips)
Seat 5: kxPhs4ePFqMy52CInAJ2aw ($53.85 in chips)
Seat 6: 686aeHikcJlgKkSuIFdcXQ ($140.65 in chips)
vXIHnZ+dv/hwSBxyvGw7bQ: posts small blind $0.25
L9qfLYXrczhAPd/VckgsWw: posts big blind $0.50
*** HOLE CARDS ***
wOyVV9M/oyiw3YaOjNZ05w: folds
kxPhs4ePFqMy52CInAJ2aw: folds
686aeHikcJlgKkSuIFdcXQ: raises $1.50 to $2
SwPczQo3cOtwEzhJrfO2cQ: folds
vXIHnZ+dv/hwSBxyvGw7bQ: folds
L9qfLYXrczhAPd/VckgsWw: calls $1.50
*** FLOP *** [6d 2c 4d]
L9qfLYXrczhAPd/VckgsWw: checks
686aeHikcJlgKkSuIFdcXQ: checks
*** TURN *** [6d 2c 4d] [4h]
L9qfLYXrczhAPd/VckgsWw: bets $1.50
686aeHikcJlgKkSuIFdcXQ: folds
L9qfLYXrczhAPd/VckgsWw collected $4.05 from pot
L9qfLYXrczhAPd/VckgsWw: doesn't show hand
*** SUMMARY ***
Total pot $4.25 | Rake $0.20
Board [6d 2c 4d 4h]
Seat 1: SwPczQo3cOtwEzhJrfO2cQ (button) folded before Flop (didn't bet)
Seat 2: vXIHnZ+dv/hwSBxyvGw7bQ (small blind) folded before Flop
Seat 3: L9qfLYXrczhAPd/VckgsWw (big blind) collected ($4.05)
Seat 4: wOyVV9M/oyiw3YaOjNZ05w folded before Flop (didn't bet)
Seat 5: kxPhs4ePFqMy52CInAJ2aw folded before Flop (didn't bet)
Seat 6: 686aeHikcJlgKkSuIFdcXQ folded on the Turn



PokerStars Game #59939170352:  Hold'em No Limit ($0.25/$0.50) - 2009/07/01 0:33:04 ET
Table 'c/CRn+68J3Y8KxD5g1ek2Q' 2-max Seat #2 is the button
Seat 1: 46qCyJ6evTkHo9al5sBMNA ($248.75 in chips)
Seat 2: BypVLsYQt3ePFm2xQL/dOA ($129.35 in chips)
BypVLsYQt3ePFm2xQL/dOA: posts small blind $0.25
46qCyJ6evTkHo9al5sBMNA: posts big blind $0.50
*** HOLE CARDS ***
BypVLsYQt3ePFm2xQL/dOA: raises $1.50 to $2
46qCyJ6evTkHo9al5sBMNA: calls $1.50
*** FLOP *** [Kd Jc 5d]
46qCyJ6evTkHo9al5sBMNA: checks
BypVLsYQt3ePFm2xQL/dOA: checks
*** TURN *** [Kd Jc 5d] [3c]
46qCyJ6evTkHo9al5sBMNA: checks
BypVLsYQt3ePFm2xQL/dOA: checks
*** RIVER *** [Kd Jc 5d 3c] [Ah]
46qCyJ6evTkHo9al5sBMNA: checks
BypVLsYQt3ePFm2xQL/dOA: bets $4.50
46qCyJ6evTkHo9al5sBMNA: folds
BypVLsYQt3ePFm2xQL/dOA collected $3.80 from pot
BypVLsYQt3ePFm2xQL/dOA: doesn't show hand
*** SUMMARY ***
Total pot $4 | Rake $0.20
Board [Kd Jc 5d 3c Ah]
Seat 1: 46qCyJ6evTkHo9al5sBMNA (big blind) folded on the River
Seat 2: BypVLsYQt3ePFm2xQL/dOA (button) (small blind) collected ($3.80)



PokerStars Game #59939171420:  Hold'em No Limit ($0.25/$0.50) - 2009/07/01 0:33:06 ET
Table 'E7bWJ45aoFXRpyRv2gw+Ig' 2-max Seat #1 is the button
Seat 1: FRkiRasEGlHUeLrEl+k/nA ($50 in chips)
Seat 2: 3Wro85I7472vJ4Wkpneo9A ($144.80 in chips)
FRkiRasEGlHUeLrEl+k/nA: posts small blind $0.25
3Wro85I7472vJ4Wkpneo9A: posts big blind $0.50
*** HOLE CARDS ***
FRkiRasEGlHUeLrEl+k/nA: raises $1 to $1.50
3Wro85I7472vJ4Wkpneo9A: calls $1
*** FLOP *** [2s 9d Qh]
3Wro85I7472vJ4Wkpneo9A: bets $2
FRkiRasEGlHUeLrEl+k/nA: folds
3Wro85I7472vJ4Wkpneo9A collected $2.85 from pot
3Wro85I7472vJ4Wkpneo9A: doesn't show hand
*** SUMMARY ***
Total pot $3 | Rake $0.15
Board [2s 9d Qh]
Seat 1: FRkiRasEGlHUeLrEl+k/nA (button) (small blind) folded on the Flop
Seat 2: 3Wro85I7472vJ4Wkpneo9A (big blind) collected ($2.85)



PokerStars Game #59939172914:  Hold'em No Limit ($0.25/$0.50) - 2009/07/01 0:33:08 ET
Table 'Nz0Vr7WMHL2g5Uk7dDZjpw' 9-max Seat #4 is the button
Seat 2: XNMDwbXt/Q4jM99AXnbJDw ($67.45 in chips)
Seat 3: 4QTiNH5fteLgJjx/s6Hy6A ($14.35 in chips)
Seat 4: 5JJVDlaiMnB004o/RqbZZQ ($27.75 in chips)
Seat 5: WGW0DgjBUXs1ylURHG8vnQ ($15.40 in chips)
Seat 6: k1f0lS7tlMHCLGs0JT34Tg ($13.85 in chips)
Seat 7: KPLH0gELgFe2OuAnhJFI5w ($26.50 in chips)
Seat 8: HkZI6g4zl83TDTA7SRspmQ ($16.45 in chips)
Seat 9: Ak2W6V2TDVIQrvSAy4eD7Q ($8.25 in chips)
WGW0DgjBUXs1ylURHG8vnQ: posts small blind $0.25
k1f0lS7tlMHCLGs0JT34Tg: posts big blind $0.50
tLkxo7JgV+WWI0UBw44K5A: sits out
*** HOLE CARDS ***
KPLH0gELgFe2OuAnhJFI5w: folds
HkZI6g4zl83TDTA7SRspmQ: folds
Ak2W6V2TDVIQrvSAy4eD7Q: folds
XNMDwbXt/Q4jM99AXnbJDw: folds
4QTiNH5fteLgJjx/s6Hy6A: folds
5JJVDlaiMnB004o/RqbZZQ: folds
WGW0DgjBUXs1ylURHG8vnQ: calls $0.25
k1f0lS7tlMHCLGs0JT34Tg: checks
*** FLOP *** [Ks 7h 6h]
WGW0DgjBUXs1ylURHG8vnQ: bets $1
k1f0lS7tlMHCLGs0JT34Tg: folds
WGW0DgjBUXs1ylURHG8vnQ collected $0.95 from pot
WGW0DgjBUXs1ylURHG8vnQ: doesn't show hand
*** SUMMARY ***
Total pot $1 | Rake $0.05
Board [Ks 7h 6h]
Seat 2: XNMDwbXt/Q4jM99AXnbJDw folded before Flop (didn't bet)
Seat 3: 4QTiNH5fteLgJjx/s6Hy6A folded before Flop (didn't bet)
Seat 4: 5JJVDlaiMnB004o/RqbZZQ (button) folded before Flop (didn't bet)
Seat 5: WGW0DgjBUXs1ylURHG8vnQ (small blind) collected ($0.95)
Seat 6: k1f0lS7tlMHCLGs0JT34Tg (big blind) folded on the Flop
Seat 7: KPLH0gELgFe2OuAnhJFI5w folded before Flop (didn't bet)
Seat 8: HkZI6g4zl83TDTA7SRspmQ folded before Flop (didn't bet)
Seat 9: Ak2W6V2TDVIQrvSAy4eD7Q folded before Flop (didn't bet)



PokerStars Game #59939174360:  Hold'em No Limit ($0.25/$0.50) - 2009/07/01 0:33:10 ET
Table 'QOgaEqMcJ73pcUMMxoisUg' 6-max Seat #5 is the button
Seat 1: OZ6OtYh5Y53MCH/p0QTn5g ($50 in chips)
Seat 2: Im2p1Nt83UKSqv5c9frm4Q ($91.30 in chips)
Seat 4: zAcsDhG/T128Vn7XGVSgKg ($62.55 in chips)
Seat 5: 6vNxrjjCl6FwfaaymM9jjg ($26.05 in chips)
Seat 6: pmE+2KJb4nffAVqjLIXxFg ($22.25 in chips)
pmE+2KJb4nffAVqjLIXxFg: posts small blind $0.25
OZ6OtYh5Y53MCH/p0QTn5g: posts big blind $0.50
Rt6KgtZ8YaJoTc3FPim00w: sits out
*** HOLE CARDS ***
Im2p1Nt83UKSqv5c9frm4Q: folds
zAcsDhG/T128Vn7XGVSgKg: folds
6vNxrjjCl6FwfaaymM9jjg: folds
pmE+2KJb4nffAVqjLIXxFg: folds
OZ6OtYh5Y53MCH/p0QTn5g collected $0.50 from pot
*** SUMMARY ***
Total pot $0.50 | Rake $0
Seat 1: OZ6OtYh5Y53MCH/p0QTn5g (big blind) collected ($0.50)
Seat 2: Im2p1Nt83UKSqv5c9frm4Q folded before Flop (didn't bet)
Seat 4: zAcsDhG/T128Vn7XGVSgKg folded before Flop (didn't bet)
Seat 5: 6vNxrjjCl6FwfaaymM9jjg (button) folded before Flop (didn't bet)
Seat 6: pmE+2KJb4nffAVqjLIXxFg (small blind) folded before Flop



PokerStars Game #59939174956:  Hold'em No Limit ($0.25/$0.50) - 2009/07/01 0:33:11 ET
Table 'kgbJRsxfv64KrErDRBAkcw' 6-max Seat #2 is the button
Seat 1: mxTUARCsU8Eby0whmHNcOw ($7.50 in chips)
Seat 2: Q+thC23WCv1kJUJtH/+4Jw ($58.80 in chips)
Seat 3: T0Gx/FcQ5VH9u7XaOMX97A ($80.35 in chips)
Seat 4: qanMEqjABjWxC/JgQ/0l7w ($57.70 in chips)
Seat 5: +Pf9jTVizYlIo+woPvptfA ($52.30 in chips)
Seat 6: ozrlafxxh1HmYdA0/h+MuA ($14.40 in chips)
T0Gx/FcQ5VH9u7XaOMX97A: posts small blind $0.25
qanMEqjABjWxC/JgQ/0l7w: posts big blind $0.50
*** HOLE CARDS ***
+Pf9jTVizYlIo+woPvptfA: folds
ozrlafxxh1HmYdA0/h+MuA: calls $0.50
mxTUARCsU8Eby0whmHNcOw: folds
Q+thC23WCv1kJUJtH/+4Jw: folds
T0Gx/FcQ5VH9u7XaOMX97A: raises $2 to $2.50
qanMEqjABjWxC/JgQ/0l7w: folds
ozrlafxxh1HmYdA0/h+MuA: folds
T0Gx/FcQ5VH9u7XaOMX97A collected $1.50 from pot
T0Gx/FcQ5VH9u7XaOMX97A: doesn't show hand
*** SUMMARY ***
Total pot $1.50 | Rake $0
Seat 1: mxTUARCsU8Eby0whmHNcOw folded before Flop (didn't bet)
Seat 2: Q+thC23WCv1kJUJtH/+4Jw (button) folded before Flop (didn't bet)
Seat 3: T0Gx/FcQ5VH9u7XaOMX97A (small blind) collected ($1.50)
Seat 4: qanMEqjABjWxC/JgQ/0l7w (big blind) folded before Flop
Seat 5: +Pf9jTVizYlIo+woPvptfA folded before Flop (didn't bet)
Seat 6: ozrlafxxh1HmYdA0/h+MuA folded before Flop



PokerStars Game #59939177080:  Hold'em No Limit ($0.25/$0.50) - 2009/07/01 0:33:14 ET
Table 'PALRfuH85dr5IkDfdv6new' 9-max Seat #5 is the button
Seat 1: SKnJuWHScqetA/qG5p+wCg ($30 in chips)
Seat 2: 9r7ZoBbAJj5IeyZ0q9BdzA ($8 in chips)
Seat 3: 50QWoELmpmHFrFIlWMJo9g ($86.70 in chips)
Seat 4: mZNMJI1mY40XTC0U7GZakA ($57.65 in chips)
Seat 5: jSSGUXdNFAZA3QCvTcUMQw ($42.70 in chips)
Seat 6: E2518gp4aFz1+kAgmGqeEg ($14.75 in chips)
Seat 7: 3NcyXvr39gnK+KbTq7ezyA ($38.25 in chips)
Seat 8: NkS+CseUKx4XHszWq0PXEQ ($44.65 in chips)
Seat 9: CIrAX/m6o7jYmKOAjJXv4Q ($36.45 in chips)
E2518gp4aFz1+kAgmGqeEg: posts small blind $0.25
3NcyXvr39gnK+KbTq7ezyA: posts big blind $0.50
*** HOLE CARDS ***
NkS+CseUKx4XHszWq0PXEQ: folds
CIrAX/m6o7jYmKOAjJXv4Q: calls $0.50
SKnJuWHScqetA/qG5p+wCg: folds
9r7ZoBbAJj5IeyZ0q9BdzA: folds
50QWoELmpmHFrFIlWMJo9g: folds
mZNMJI1mY40XTC0U7GZakA: folds
jSSGUXdNFAZA3QCvTcUMQw: folds
E2518gp4aFz1+kAgmGqeEg: folds
3NcyXvr39gnK+KbTq7ezyA: checks
*** FLOP *** [Jh Ad Td]
3NcyXvr39gnK+KbTq7ezyA: checks
CIrAX/m6o7jYmKOAjJXv4Q: bets $1
3NcyXvr39gnK+KbTq7ezyA: calls $1
*** TURN *** [Jh Ad Td] [8s]
3NcyXvr39gnK+KbTq7ezyA: checks
CIrAX/m6o7jYmKOAjJXv4Q: bets $3
3NcyXvr39gnK+KbTq7ezyA: folds
CIrAX/m6o7jYmKOAjJXv4Q collected $3.10 from pot
*** SUMMARY ***
Total pot $3.25 | Rake $0.15
Board [Jh Ad Td 8s]
Seat 1: SKnJuWHScqetA/qG5p+wCg folded before Flop (didn't bet)
Seat 2: 9r7ZoBbAJj5IeyZ0q9BdzA folded before Flop (didn't bet)
Seat 3: 50QWoELmpmHFrFIlWMJo9g folded before Flop (didn't bet)
Seat 4: mZNMJI1mY40XTC0U7GZakA folded before Flop (didn't bet)
Seat 5: jSSGUXdNFAZA3QCvTcUMQw (button) folded before Flop (didn't bet)
Seat 6: E2518gp4aFz1+kAgmGqeEg (small blind) folded before Flop
Seat 7: 3NcyXvr39gnK+KbTq7ezyA (big blind) folded on the Turn
Seat 8: NkS+CseUKx4XHszWq0PXEQ folded before Flop (didn't bet)
Seat 9: CIrAX/m6o7jYmKOAjJXv4Q collected ($3.10)



PokerStars Game #59939177284:  Hold'em No Limit ($0.25/$0.50) - 2009/07/01 0:33:15 ET
Table 'tyR5AZNKV8Aadbrnrnlg7g' 6-max Seat #2 is the button
Seat 1: R+KjpH/wSjDLhtIy9+edNA ($81 in chips)
Seat 2: 58zdeSBSuSFX/qZfhc7YmA ($37.35 in chips)
Seat 3: tdOvWynovql5imfooroLMg ($48.25 in chips)
Seat 4: Rt6KgtZ8YaJoTc3FPim00w ($83.95 in chips)
Seat 5: wOyVV9M/oyiw3YaOjNZ05w ($58.70 in chips)
Seat 6: ZKazl1hGaPiapDXincgi2Q ($22.20 in chips)
tdOvWynovql5imfooroLMg: posts small blind $0.25
Rt6KgtZ8YaJoTc3FPim00w: posts big blind $0.50
*** HOLE CARDS ***
wOyVV9M/oyiw3YaOjNZ05w: folds
ZKazl1hGaPiapDXincgi2Q: folds
R+KjpH/wSjDLhtIy9+edNA: folds
58zdeSBSuSFX/qZfhc7YmA: calls $0.50
tdOvWynovql5imfooroLMg: folds
Rt6KgtZ8YaJoTc3FPim00w: checks
*** FLOP *** [As Qc Jh]
Rt6KgtZ8YaJoTc3FPim00w: checks
58zdeSBSuSFX/qZfhc7YmA: bets $2.50
Rt6KgtZ8YaJoTc3FPim00w: folds
58zdeSBSuSFX/qZfhc7YmA collected $1.20 from pot
*** SUMMARY ***
Total pot $1.25 | Rake $0.05
Board [As Qc Jh]
Seat 1: R+KjpH/wSjDLhtIy9+edNA folded before Flop (didn't bet)
Seat 2: 58zdeSBSuSFX/qZfhc7YmA (button) collected ($1.20)
Seat 3: tdOvWynovql5imfooroLMg (small blind) folded before Flop
Seat 4: Rt6KgtZ8YaJoTc3FPim00w (big blind) folded on the Flop
Seat 5: wOyVV9M/oyiw3YaOjNZ05w folded before Flop (didn't bet)
Seat 6: ZKazl1hGaPiapDXincgi2Q folded before Flop (didn't bet)



PokerStars Game #59939178412:  Hold'em No Limit ($0.25/$0.50) - 2009/07/01 0:33:16 ET
Table 'mTxf8gPLgffN3Iwfm7Icfg' 2-max Seat #2 is the button
Seat 1: Do9Rlu1R5u/AcRtMTl8SYg ($87.45 in chips)
Seat 2: EMc5LPgVaded4Qc77vm0fw ($71.55 in chips)
EMc5LPgVaded4Qc77vm0fw: posts small blind $0.25
Do9Rlu1R5u/AcRtMTl8SYg: posts big blind $0.50
*** HOLE CARDS ***
EMc5LPgVaded4Qc77vm0fw: raises $1 to $1.50
Do9Rlu1R5u/AcRtMTl8SYg: raises $3 to $4.50
EMc5LPgVaded4Qc77vm0fw: calls $3
*** FLOP *** [4c Ks Kd]
Do9Rlu1R5u/AcRtMTl8SYg: bets $6
EMc5LPgVaded4Qc77vm0fw: raises $8.50 to $14.50
Do9Rlu1R5u/AcRtMTl8SYg: folds
EMc5LPgVaded4Qc77vm0fw collected $20.50 from pot
EMc5LPgVaded4Qc77vm0fw: doesn't show hand
*** SUMMARY ***
Total pot $21 | Rake $0.50
Board [4c Ks Kd]
Seat 1: Do9Rlu1R5u/AcRtMTl8SYg (big blind) folded on the Flop
Seat 2: EMc5LPgVaded4Qc77vm0fw (button) (small blind) collected ($20.50)



PokerStars Game #59939177908:  Hold'em No Limit ($0.25/$0.50) - 2009/07/01 0:33:16 ET
Table 'EiNh8p/wGJ1FP575iMFnqg' 9-max Seat #9 is the button
Seat 1: r3ZqM1Mi0W3y4hOdssE+Sg ($48.50 in chips)
Seat 2: 8ehL7qlZzjgUh2H35iiWLw ($50 in chips)
Seat 3: ymLPoEIl7UL3TvZYmnadxQ ($51.85 in chips)
Seat 4: HIIPkpiaCQfs5HcPKjlHvg ($31.95 in chips)
Seat 5: M+7+BTmX5vZatHVuoRB1nA ($85.85 in chips)
Seat 6: 3UmXLy3GfjC3EkOebduerQ ($54.65 in chips)
Seat 7: Wj7mKnRFR90j40wWUu2+Og ($71.05 in chips)
Seat 8: KrPAGRACBg+w0M//SXe8Ag ($9.80 in chips)
Seat 9: OMwFJ4pF0xk2Ru/AJiFeFw ($79.75 in chips)
r3ZqM1Mi0W3y4hOdssE+Sg: posts small blind $0.25
8ehL7qlZzjgUh2H35iiWLw: posts big blind $0.50
*** HOLE CARDS ***
ymLPoEIl7UL3TvZYmnadxQ: raises $0.50 to $1
HIIPkpiaCQfs5HcPKjlHvg: folds
M+7+BTmX5vZatHVuoRB1nA: calls $1
3UmXLy3GfjC3EkOebduerQ: folds
Wj7mKnRFR90j40wWUu2+Og: folds
KrPAGRACBg+w0M//SXe8Ag: calls $1
OMwFJ4pF0xk2Ru/AJiFeFw: folds
r3ZqM1Mi0W3y4hOdssE+Sg: folds
8ehL7qlZzjgUh2H35iiWLw: folds
*** FLOP *** [7h 8d Ks]
KrPAGRACBg+w0M//SXe8Ag said, "zzzzzzzzzzzzzzzzzzzz"
ymLPoEIl7UL3TvZYmnadxQ: checks
M+7+BTmX5vZatHVuoRB1nA: checks
KrPAGRACBg+w0M//SXe8Ag: bets $1
ymLPoEIl7UL3TvZYmnadxQ: folds
M+7+BTmX5vZatHVuoRB1nA: folds
KrPAGRACBg+w0M//SXe8Ag collected $3.60 from pot
KrPAGRACBg+w0M//SXe8Ag: doesn't show hand
*** SUMMARY ***
Total pot $3.75 | Rake $0.15
Board [7h 8d Ks]
Seat 1: r3ZqM1Mi0W3y4hOdssE+Sg (small blind) folded before Flop
Seat 2: 8ehL7qlZzjgUh2H35iiWLw (big blind) folded before Flop
Seat 3: ymLPoEIl7UL3TvZYmnadxQ folded on the Flop
Seat 4: HIIPkpiaCQfs5HcPKjlHvg folded before Flop (didn't bet)
Seat 5: M+7+BTmX5vZatHVuoRB1nA folded on the Flop
Seat 6: 3UmXLy3GfjC3EkOebduerQ folded before Flop (didn't bet)
Seat 7: Wj7mKnRFR90j40wWUu2+Og folded before Flop (didn't bet)
Seat 8: KrPAGRACBg+w0M//SXe8Ag collected ($3.60)
Seat 9: OMwFJ4pF0xk2Ru/AJiFeFw (button) folded before Flop (didn't bet)



PokerStars Game #59939178888:  Hold'em No Limit ($0.25/$0.50) - 2009/07/01 0:33:17 ET
Table 'NCiXr0d5CEKBQr/cZgLhbA' 9-max Seat #4 is the button
Seat 2: ulxuJchBV9iguXg0FUonfg ($25.80 in chips)
Seat 3: xZCXQSXlrZkp3pZizzVXCw ($56.90 in chips)
Seat 4: 5k9fvXD9suIgCxU4HLQjTw ($59.20 in chips)
Seat 5: zE9cVigS2nW/Ljy4K4bUQA ($40.20 in chips)
Seat 6: SKnJuWHScqetA/qG5p+wCg ($30 in chips)
Seat 7: M+7+BTmX5vZatHVuoRB1nA ($48.50 in chips)
Seat 8: 1MJUKc3cc0QmUoz1JZLR2w ($53.55 in chips)
Seat 9: 4WLZvqBn5qv5tds5kt5A1Q ($28.75 in chips)
zE9cVigS2nW/Ljy4K4bUQA: posts small blind $0.25
SKnJuWHScqetA/qG5p+wCg: posts big blind $0.50
pFtzb1sR4b0d1aw6aIRgDg: sits out
*** HOLE CARDS ***
M+7+BTmX5vZatHVuoRB1nA: raises $1.50 to $2
1MJUKc3cc0QmUoz1JZLR2w: folds
4WLZvqBn5qv5tds5kt5A1Q: folds
ulxuJchBV9iguXg0FUonfg: folds
xZCXQSXlrZkp3pZizzVXCw: calls $2
5k9fvXD9suIgCxU4HLQjTw: folds
zE9cVigS2nW/Ljy4K4bUQA: folds
SKnJuWHScqetA/qG5p+wCg: raises $4 to $6
M+7+BTmX5vZatHVuoRB1nA: folds
xZCXQSXlrZkp3pZizzVXCw: folds
SKnJuWHScqetA/qG5p+wCg collected $6.25 from pot
*** SUMMARY ***
Total pot $6.25 | Rake $0
Seat 2: ulxuJchBV9iguXg0FUonfg folded before Flop (didn't bet)
Seat 3: xZCXQSXlrZkp3pZizzVXCw folded before Flop
Seat 4: 5k9fvXD9suIgCxU4HLQjTw (button) folded before Flop (didn't bet)
Seat 5: zE9cVigS2nW/Ljy4K4bUQA (small blind) folded before Flop
Seat 6: SKnJuWHScqetA/qG5p+wCg (big blind) collected ($6.25)
Seat 7: M+7+BTmX5vZatHVuoRB1nA folded before Flop
Seat 8: 1MJUKc3cc0QmUoz1JZLR2w folded before Flop (didn't bet)
Seat 9: 4WLZvqBn5qv5tds5kt5A1Q folded before Flop (didn't bet)



PokerStars Game #59939179110:  Hold'em No Limit ($0.25/$0.50) - 2009/07/01 0:33:18 ET
Table 'T/PgNWqVyY6lkldcBVXYJQ' 6-max Seat #5 is the button
Seat 1: +Pf9jTVizYlIo+woPvptfA ($58 in chips)
Seat 2: oZAeY5rVqNGgt8yyQ0pxbA ($34.55 in chips)
Seat 3: L3OcNO1bgdqDI46j67KQPQ ($54.60 in chips)
Seat 4: jxMvxeUUL9UU0V6wVU+Iyw ($20.15 in chips)
Seat 5: vVQBckETtigfb5mAcyK0OA ($49 in chips)
Seat 6: cDzbog6kwmJp+LBeBq+iMQ ($46.80 in chips)
cDzbog6kwmJp+LBeBq+iMQ: posts small blind $0.25
+Pf9jTVizYlIo+woPvptfA: posts big blind $0.50
*** HOLE CARDS ***
cDzbog6kwmJp+LBeBq+iMQ said, "omg"
cDzbog6kwmJp+LBeBq+iMQ said, "lol"
cDzbog6kwmJp+LBeBq+iMQ said, "nh"
jxMvxeUUL9UU0V6wVU+Iyw said, "all luck"
oZAeY5rVqNGgt8yyQ0pxbA: folds
L3OcNO1bgdqDI46j67KQPQ: folds
jxMvxeUUL9UU0V6wVU+Iyw: folds
cDzbog6kwmJp+LBeBq+iMQ said, "stars rigs the river"
vVQBckETtigfb5mAcyK0OA: folds
cDzbog6kwmJp+LBeBq+iMQ said, "im convinced"
jxMvxeUUL9UU0V6wVU+Iyw said, "been getting up the rear for 3 hours now"
cDzbog6kwmJp+LBeBq+iMQ: calls $0.25
+Pf9jTVizYlIo+woPvptfA: checks
*** FLOP *** [9h 8c Jd]
jxMvxeUUL9UU0V6wVU+Iyw leaves the table
cDzbog6kwmJp+LBeBq+iMQ: bets $0.50
+Pf9jTVizYlIo+woPvptfA: folds
cDzbog6kwmJp+LBeBq+iMQ collected $0.95 from pot
*** SUMMARY ***
Total pot $1 | Rake $0.05
Board [9h 8c Jd]
Seat 1: +Pf9jTVizYlIo+woPvptfA (big blind) folded on the Flop
Seat 2: oZAeY5rVqNGgt8yyQ0pxbA folded before Flop (didn't bet)
Seat 3: L3OcNO1bgdqDI46j67KQPQ folded before Flop (didn't bet)
Seat 4: jxMvxeUUL9UU0V6wVU+Iyw folded before Flop (didn't bet)
Seat 5: vVQBckETtigfb5mAcyK0OA (button) folded before Flop (didn't bet)
Seat 6: cDzbog6kwmJp+LBeBq+iMQ (small blind) collected ($0.95)



PokerStars Game #59939180068:  Hold'em No Limit ($0.25/$0.50) - 2009/07/01 0:33:19 ET
Table '+z1aekfHkpp09pc8F9aViw' 6-max Seat #2 is the button
Seat 1: FHilMb2i2DbUCc9lplszog ($50 in chips)
Seat 2: M6xK/VklCvdyyrmvzATlxQ ($38.30 in chips)
Seat 3: uUznlIMFnRUvwrBhYF73KA ($55.10 in chips)
Seat 4: RowCSpSURHTOL/dcjg/Iug ($49.30 in chips)
Seat 5: crjGpJEzSZgD38FoE3VMGg ($55.35 in chips)
Seat 6: 686aeHikcJlgKkSuIFdcXQ ($69.35 in chips)
uUznlIMFnRUvwrBhYF73KA: posts small blind $0.25
RowCSpSURHTOL/dcjg/Iug: posts big blind $0.50
FHilMb2i2DbUCc9lplszog: posts big blind $0.50
*** HOLE CARDS ***
crjGpJEzSZgD38FoE3VMGg: folds
686aeHikcJlgKkSuIFdcXQ: folds
FHilMb2i2DbUCc9lplszog: checks
M6xK/VklCvdyyrmvzATlxQ: folds
uUznlIMFnRUvwrBhYF73KA: calls $0.25
RowCSpSURHTOL/dcjg/Iug: checks
*** FLOP *** [Jh 2h Td]
uUznlIMFnRUvwrBhYF73KA: checks
RowCSpSURHTOL/dcjg/Iug: checks
FHilMb2i2DbUCc9lplszog: bets $1.50
uUznlIMFnRUvwrBhYF73KA: calls $1.50
RowCSpSURHTOL/dcjg/Iug: folds
*** TURN *** [Jh 2h Td] [Tc]
uUznlIMFnRUvwrBhYF73KA: checks
FHilMb2i2DbUCc9lplszog: bets $2.50
uUznlIMFnRUvwrBhYF73KA: calls $2.50
*** RIVER *** [Jh 2h Td Tc] [2s]
uUznlIMFnRUvwrBhYF73KA: bets $9
FHilMb2i2DbUCc9lplszog: folds
uUznlIMFnRUvwrBhYF73KA collected $9.05 from pot
*** SUMMARY ***
Total pot $9.50 | Rake $0.45
Board [Jh 2h Td Tc 2s]
Seat 1: FHilMb2i2DbUCc9lplszog folded on the River
Seat 2: M6xK/VklCvdyyrmvzATlxQ (button) folded before Flop (didn't bet)
Seat 3: uUznlIMFnRUvwrBhYF73KA (small blind) collected ($9.05)
Seat 4: RowCSpSURHTOL/dcjg/Iug (big blind) folded on the Flop
Seat 5: crjGpJEzSZgD38FoE3VMGg folded before Flop (didn't bet)
Seat 6: 686aeHikcJlgKkSuIFdcXQ folded before Flop (didn't bet)



PokerStars Game #59939181336:  Hold'em No Limit ($0.25/$0.50) - 2009/07/01 0:33:21 ET
Table 'GfL/No5u5PoEnU39lP5pQg' 6-max Seat #2 is the button
Seat 1: 1WUCqNG+p+vfWRTXNu4ljw ($50.30 in chips)
Seat 2: uVwggSetzp7d+eVgowO3vg ($54.30 in chips)
Seat 3: NbUTppWfym/RxV/DmDz2Sw ($15.20 in chips)
Seat 4: x+pzUFJsMIiGd7a5pcR4tg ($54.60 in chips)
Seat 5: crjGpJEzSZgD38FoE3VMGg ($58.05 in chips)
NbUTppWfym/RxV/DmDz2Sw: posts small blind $0.25
x+pzUFJsMIiGd7a5pcR4tg: posts big blind $0.50
*** HOLE CARDS ***
crjGpJEzSZgD38FoE3VMGg: raises $1.50 to $2
1WUCqNG+p+vfWRTXNu4ljw: folds
uVwggSetzp7d+eVgowO3vg: folds
NbUTppWfym/RxV/DmDz2Sw: calls $1.75
x+pzUFJsMIiGd7a5pcR4tg: folds
*** FLOP *** [5s 5h Jd]
NbUTppWfym/RxV/DmDz2Sw: checks
crjGpJEzSZgD38FoE3VMGg: bets $2.50
NbUTppWfym/RxV/DmDz2Sw: folds
crjGpJEzSZgD38FoE3VMGg collected $4.30 from pot
crjGpJEzSZgD38FoE3VMGg: doesn't show hand
*** SUMMARY ***
Total pot $4.50 | Rake $0.20
Board [5s 5h Jd]
Seat 1: 1WUCqNG+p+vfWRTXNu4ljw folded before Flop (didn't bet)
Seat 2: uVwggSetzp7d+eVgowO3vg (button) folded before Flop (didn't bet)
Seat 3: NbUTppWfym/RxV/DmDz2Sw (small blind) folded on the Flop
Seat 4: x+pzUFJsMIiGd7a5pcR4tg (big blind) folded before Flop
Seat 5: crjGpJEzSZgD38FoE3VMGg collected ($4.30)



PokerStars Game #59939183702:  Hold'em No Limit ($0.25/$0.50) - 2009/07/01 0:33:25 ET
Table '37qXEp3oe+er5q4CZip9eQ' 6-max Seat #1 is the button
Seat 1: oqOqoO2AyCZenUghCxMDxw ($53 in chips)
Seat 2: 6wzJiRvp8HY6t+MQGnSIzA ($24.65 in chips)
Seat 3: Rt6KgtZ8YaJoTc3FPim00w ($95 in chips)
Seat 4: XsmE8nXMAAMFJbWaJTmHFw ($20.55 in chips)
Seat 5: VOmI0x4dDPnTESZd5B4d1Q ($41.75 in chips)
6wzJiRvp8HY6t+MQGnSIzA: posts small blind $0.25
Rt6KgtZ8YaJoTc3FPim00w: posts big blind $0.50
*** HOLE CARDS ***
XsmE8nXMAAMFJbWaJTmHFw: raises $1 to $1.50
l4m/wWPs22DSP5xpszjXKA leaves the table
VOmI0x4dDPnTESZd5B4d1Q: folds
oqOqoO2AyCZenUghCxMDxw: folds
6wzJiRvp8HY6t+MQGnSIzA: folds
Rt6KgtZ8YaJoTc3FPim00w: calls $1
*** FLOP *** [Kc 5h 8s]
Rt6KgtZ8YaJoTc3FPim00w: checks
XsmE8nXMAAMFJbWaJTmHFw: bets $1.50
Rt6KgtZ8YaJoTc3FPim00w: raises $3.50 to $5
XsmE8nXMAAMFJbWaJTmHFw: calls $3.50
*** TURN *** [Kc 5h 8s] [4h]
Rt6KgtZ8YaJoTc3FPim00w: checks
XsmE8nXMAAMFJbWaJTmHFw: checks
*** RIVER *** [Kc 5h 8s 4h] [8h]
Rt6KgtZ8YaJoTc3FPim00w: checks
XsmE8nXMAAMFJbWaJTmHFw: bets $3.50
Rt6KgtZ8YaJoTc3FPim00w: folds
XsmE8nXMAAMFJbWaJTmHFw collected $12.60 from pot
*** SUMMARY ***
Total pot $13.25 | Rake $0.65
Board [Kc 5h 8s 4h 8h]
Seat 1: oqOqoO2AyCZenUghCxMDxw (button) folded before Flop (didn't bet)
Seat 2: 6wzJiRvp8HY6t+MQGnSIzA (small blind) folded before Flop
Seat 3: Rt6KgtZ8YaJoTc3FPim00w (big blind) folded on the River
Seat 4: XsmE8nXMAAMFJbWaJTmHFw collected ($12.60)
Seat 5: VOmI0x4dDPnTESZd5B4d1Q folded before Flop (didn't bet)



PokerStars Game #59939184900:  Hold'em No Limit ($0.25/$0.50) - 2009/07/01 0:33:26 ET
Table 'hSTs/dUsYLgJQuF2Onp0MQ' 6-max Seat #5 is the button
Seat 1: Donj3X7gYzeS5pAl7s9f+Q ($27.70 in chips)
Seat 2: 6vNxrjjCl6FwfaaymM9jjg ($35.35 in chips)
Seat 3: C3qJBo7uxfFVDluE1lmK2w ($30 in chips)
Seat 4: L0aIPg7qefDQjdJo3HCVEA ($8.90 in chips)
Seat 5: 686aeHikcJlgKkSuIFdcXQ ($59.90 in chips)
Donj3X7gYzeS5pAl7s9f+Q: posts small blind $0.25
+laPa9P7BjZKKnR0n+OmvA leaves the table
6vNxrjjCl6FwfaaymM9jjg: posts big blind $0.50
*** HOLE CARDS ***
C3qJBo7uxfFVDluE1lmK2w: folds
L0aIPg7qefDQjdJo3HCVEA: folds
w0pd++ZQHijd9dDhKEYOAQ joins the table at seat #6
686aeHikcJlgKkSuIFdcXQ: folds
Donj3X7gYzeS5pAl7s9f+Q: calls $0.25
6vNxrjjCl6FwfaaymM9jjg: checks
*** FLOP *** [3h Jc Qh]
Donj3X7gYzeS5pAl7s9f+Q: checks
6vNxrjjCl6FwfaaymM9jjg: checks
*** TURN *** [3h Jc Qh] [7d]
Donj3X7gYzeS5pAl7s9f+Q: checks
6vNxrjjCl6FwfaaymM9jjg: bets $1.50
Donj3X7gYzeS5pAl7s9f+Q: raises $1.50 to $3
6vNxrjjCl6FwfaaymM9jjg: calls $1.50
*** RIVER *** [3h Jc Qh 7d] [8d]
Donj3X7gYzeS5pAl7s9f+Q: checks
6vNxrjjCl6FwfaaymM9jjg: checks
*** SHOW DOWN ***
Donj3X7gYzeS5pAl7s9f+Q: shows [7s Jh] (two pair, Jacks and Sevens)
6vNxrjjCl6FwfaaymM9jjg: mucks hand
Donj3X7gYzeS5pAl7s9f+Q collected $6.70 from pot
*** SUMMARY ***
Total pot $7 | Rake $0.30
Board [3h Jc Qh 7d 8d]
Seat 1: Donj3X7gYzeS5pAl7s9f+Q (small blind) showed [7s Jh] and won ($6.70) with two pair, Jacks and Sevens
Seat 2: 6vNxrjjCl6FwfaaymM9jjg (big blind) mucked
Seat 3: C3qJBo7uxfFVDluE1lmK2w folded before Flop (didn't bet)
Seat 4: L0aIPg7qefDQjdJo3HCVEA folded before Flop (didn't bet)
Seat 5: 686aeHikcJlgKkSuIFdcXQ (button) folded before Flop (didn't bet)



PokerStars Game #59939184352:  Hold'em No Limit ($0.25/$0.50) - 2009/07/01 0:33:26 ET
Table 'E7bWJ45aoFXRpyRv2gw+Ig' 2-max Seat #2 is the button
Seat 1: FRkiRasEGlHUeLrEl+k/nA ($50 in chips)
Seat 2: 3Wro85I7472vJ4Wkpneo9A ($146.15 in chips)
3Wro85I7472vJ4Wkpneo9A: posts small blind $0.25
FRkiRasEGlHUeLrEl+k/nA: posts big blind $0.50
*** HOLE CARDS ***
3Wro85I7472vJ4Wkpneo9A: raises $1 to $1.50
FRkiRasEGlHUeLrEl+k/nA: calls $1
*** FLOP *** [Th Qh 5s]
FRkiRasEGlHUeLrEl+k/nA: checks
3Wro85I7472vJ4Wkpneo9A: checks
*** TURN *** [Th Qh 5s] [Kc]
FRkiRasEGlHUeLrEl+k/nA: checks
3Wro85I7472vJ4Wkpneo9A: checks
*** RIVER *** [Th Qh 5s Kc] [4s]
FRkiRasEGlHUeLrEl+k/nA: checks
3Wro85I7472vJ4Wkpneo9A: checks
*** SHOW DOWN ***
FRkiRasEGlHUeLrEl+k/nA: shows [7c Qd] (a pair of Queens)
3Wro85I7472vJ4Wkpneo9A: mucks hand
FRkiRasEGlHUeLrEl+k/nA collected $2.85 from pot
*** SUMMARY ***
Total pot $3 | Rake $0.15
Board [Th Qh 5s Kc 4s]
Seat 1: FRkiRasEGlHUeLrEl+k/nA (big blind) showed [7c Qd] and won ($2.85) with a pair of Queens
Seat 2: 3Wro85I7472vJ4Wkpneo9A (button) (small blind) mucked



PokerStars Game #59939184730:  Hold'em No Limit ($0.25/$0.50) - 2009/07/01 0:33:26 ET
Table '+dXkOAQyS8j9PQZusUTMpg' 2-max Seat #2 is the button
Seat 1: XFa6sBGjP2gxoIvxR3fZIg ($77 in chips)
Seat 2: 5IBeOgaApY1Bvzv2P8X4EA ($65.90 in chips)
5IBeOgaApY1Bvzv2P8X4EA: posts small blind $0.25
XFa6sBGjP2gxoIvxR3fZIg: posts big blind $0.50
*** HOLE CARDS ***
5IBeOgaApY1Bvzv2P8X4EA: calls $0.25
XFa6sBGjP2gxoIvxR3fZIg: raises $2 to $2.50
5IBeOgaApY1Bvzv2P8X4EA: calls $2
*** FLOP *** [6h 3s As]
XFa6sBGjP2gxoIvxR3fZIg: bets $3.50
5IBeOgaApY1Bvzv2P8X4EA: folds
XFa6sBGjP2gxoIvxR3fZIg collected $4.75 from pot
XFa6sBGjP2gxoIvxR3fZIg: doesn't show hand
*** SUMMARY ***
Total pot $5 | Rake $0.25
Board [6h 3s As]
Seat 1: XFa6sBGjP2gxoIvxR3fZIg (big blind) collected ($4.75)
Seat 2: 5IBeOgaApY1Bvzv2P8X4EA (button) (small blind) folded on the Flop



PokerStars Game #59939186000:  Hold'em No Limit ($0.25/$0.50) - 2009/07/01 0:33:28 ET
Table 'MJxeZCzYELxiIsyUZyT0jw' 6-max Seat #2 is the button
Seat 2: dB6jzDlJmET84VMWw1mTRA ($50 in chips)
Seat 3: JQZew0FjzS19kTjeNtrE+A ($50.05 in chips)
Seat 4: lP7Q6pewz4C2RsAfKsjdWw ($31.45 in chips)
Seat 5: 3jvoOXNtXE90w2BdfNZwZQ ($50 in chips)
Seat 6: TTx3CHxyi0SObcHyMJRp5w ($63.70 in chips)
JQZew0FjzS19kTjeNtrE+A: posts small blind $0.25
lP7Q6pewz4C2RsAfKsjdWw: posts big blind $0.50
*** HOLE CARDS ***
wOyVV9M/oyiw3YaOjNZ05w leaves the table
3jvoOXNtXE90w2BdfNZwZQ: folds
TTx3CHxyi0SObcHyMJRp5w: folds
dB6jzDlJmET84VMWw1mTRA: folds
tdOvWynovql5imfooroLMg joins the table at seat #1
JQZew0FjzS19kTjeNtrE+A: calls $0.25
lP7Q6pewz4C2RsAfKsjdWw: checks
*** FLOP *** [Qs 8c 4s]
JQZew0FjzS19kTjeNtrE+A: checks
lP7Q6pewz4C2RsAfKsjdWw: checks
*** TURN *** [Qs 8c 4s] [5h]
JQZew0FjzS19kTjeNtrE+A: bets $1.50
lP7Q6pewz4C2RsAfKsjdWw: calls $1.50
*** RIVER *** [Qs 8c 4s 5h] [4c]
JQZew0FjzS19kTjeNtrE+A: checks
lP7Q6pewz4C2RsAfKsjdWw: checks
*** SHOW DOWN ***
JQZew0FjzS19kTjeNtrE+A: shows [3s 9s] (a pair of Fours)
lP7Q6pewz4C2RsAfKsjdWw: shows [As 5c] (two pair, Fives and Fours)
lP7Q6pewz4C2RsAfKsjdWw collected $3.85 from pot
*** SUMMARY ***
Total pot $4 | Rake $0.15
Board [Qs 8c 4s 5h 4c]
Seat 2: dB6jzDlJmET84VMWw1mTRA (button) folded before Flop (didn't bet)
Seat 3: JQZew0FjzS19kTjeNtrE+A (small blind) showed [3s 9s] and lost with a pair of Fours
Seat 4: lP7Q6pewz4C2RsAfKsjdWw (big blind) showed [As 5c] and won ($3.85) with two pair, Fives and Fours
Seat 5: 3jvoOXNtXE90w2BdfNZwZQ folded before Flop (didn't bet)
Seat 6: TTx3CHxyi0SObcHyMJRp5w folded before Flop (didn't bet)



PokerStars Game #59939187976:  Hold'em No Limit ($0.25/$0.50) - 2009/07/01 0:33:31 ET
Table '3FhG0gl3kMX3wBEEqj+wnQ' 9-max Seat #6 is the button
Seat 1: e0J9pdCNUDTCG031RnXqLA ($17 in chips)
Seat 3: HZkVla4kK2SI42CVrPZ/ig ($8.75 in chips)
Seat 4: bz4LMfV0GGl/MJ/ABXuPmg ($20.35 in chips)
Seat 5: XNMDwbXt/Q4jM99AXnbJDw ($50.75 in chips)
Seat 6: 5JJVDlaiMnB004o/RqbZZQ ($45.80 in chips)
Seat 7: mSD1pginDsyHG5PDfqzphw ($10 in chips)
Seat 8: j3K/Jujr7PY4ZM2RZvlH6A ($60.55 in chips)
Seat 9: L5e2lrPLQm1Pqx30IIZ/Fw ($10.85 in chips)
mSD1pginDsyHG5PDfqzphw: posts small blind $0.25
j3K/Jujr7PY4ZM2RZvlH6A: posts big blind $0.50
7cYQ+syUWjl38ty/ICOMhw: sits out
*** HOLE CARDS ***
L5e2lrPLQm1Pqx30IIZ/Fw: folds
e0J9pdCNUDTCG031RnXqLA: folds
HZkVla4kK2SI42CVrPZ/ig: folds
bz4LMfV0GGl/MJ/ABXuPmg: folds
XNMDwbXt/Q4jM99AXnbJDw: folds
5JJVDlaiMnB004o/RqbZZQ: folds
mSD1pginDsyHG5PDfqzphw: raises $1 to $1.50
j3K/Jujr7PY4ZM2RZvlH6A: raises $3 to $4.50
bz4LMfV0GGl/MJ/ABXuPmg leaves the table
mSD1pginDsyHG5PDfqzphw: folds
j3K/Jujr7PY4ZM2RZvlH6A collected $3 from pot
j3K/Jujr7PY4ZM2RZvlH6A: doesn't show hand
*** SUMMARY ***
Total pot $3 | Rake $0
Seat 1: e0J9pdCNUDTCG031RnXqLA folded before Flop (didn't bet)
Seat 3: HZkVla4kK2SI42CVrPZ/ig folded before Flop (didn't bet)
Seat 4: bz4LMfV0GGl/MJ/ABXuPmg folded before Flop (didn't bet)
Seat 5: XNMDwbXt/Q4jM99AXnbJDw folded before Flop (didn't bet)
Seat 6: 5JJVDlaiMnB004o/RqbZZQ (button) folded before Flop (didn't bet)
Seat 7: mSD1pginDsyHG5PDfqzphw (small blind) folded before Flop
Seat 8: j3K/Jujr7PY4ZM2RZvlH6A (big blind) collected ($3)
Seat 9: L5e2lrPLQm1Pqx30IIZ/Fw folded before Flop (didn't bet)



PokerStars Game #59939189018:  Hold'em No Limit ($0.25/$0.50) - 2009/07/01 0:33:33 ET
Table 'c/CRn+68J3Y8KxD5g1ek2Q' 2-max Seat #1 is the button
Seat 1: 46qCyJ6evTkHo9al5sBMNA ($246.75 in chips)
Seat 2: BypVLsYQt3ePFm2xQL/dOA ($131.15 in chips)
46qCyJ6evTkHo9al5sBMNA: posts small blind $0.25
BypVLsYQt3ePFm2xQL/dOA: posts big blind $0.50
*** HOLE CARDS ***
46qCyJ6evTkHo9al5sBMNA: raises $1 to $1.50
BypVLsYQt3ePFm2xQL/dOA: calls $1
*** FLOP *** [Kd 8h 6c]
BypVLsYQt3ePFm2xQL/dOA: checks
46qCyJ6evTkHo9al5sBMNA: bets $2
BypVLsYQt3ePFm2xQL/dOA: calls $2
*** TURN *** [Kd 8h 6c] [Kh]
BypVLsYQt3ePFm2xQL/dOA: checks
46qCyJ6evTkHo9al5sBMNA: checks
*** RIVER *** [Kd 8h 6c Kh] [9h]
BypVLsYQt3ePFm2xQL/dOA: bets $6.50
46qCyJ6evTkHo9al5sBMNA: raises $12.50 to $19
BypVLsYQt3ePFm2xQL/dOA: calls $12.50
*** SHOW DOWN ***
46qCyJ6evTkHo9al5sBMNA: shows [6h 5h] (a flush, King high)
BypVLsYQt3ePFm2xQL/dOA: mucks hand
46qCyJ6evTkHo9al5sBMNA collected $44.50 from pot
*** SUMMARY ***
Total pot $45 | Rake $0.50
Board [Kd 8h 6c Kh 9h]
Seat 1: 46qCyJ6evTkHo9al5sBMNA (button) (small blind) showed [6h 5h] and won ($44.50) with a flush, King high
Seat 2: BypVLsYQt3ePFm2xQL/dOA (big blind) mucked



PokerStars Game #59939190896:  Hold'em No Limit ($0.25/$0.50) - 2009/07/01 0:33:35 ET
Table '/cQuAT3ef4t+PGrXiNhGaQ' 9-max Seat #9 is the button
Seat 1: HZkVla4kK2SI42CVrPZ/ig ($9.50 in chips)
Seat 2: jXGruyaMqirTaTXNOvBdew ($71.40 in chips)
Seat 3: g4k0NXISyLCqaSWZDBjfEg ($53.90 in chips)
Seat 4: OWP/DOu+PlPK6ZZ3zYa0HA ($41.65 in chips)
Seat 5: 5SgaHdWixdClWvaEG+KUjQ ($20.95 in chips)
Seat 6: APYIOyK/4AGb+kIwlOUNBQ ($43.75 in chips)
Seat 7: J0W5D97jl5VLky+IoPvDeA ($114.90 in chips)
Seat 8: W3ingbA178eb7J5rt1PuIQ ($37.35 in chips)
Seat 9: E2518gp4aFz1+kAgmGqeEg ($10.25 in chips)
HZkVla4kK2SI42CVrPZ/ig: posts small blind $0.25
jXGruyaMqirTaTXNOvBdew: posts big blind $0.50
*** HOLE CARDS ***
g4k0NXISyLCqaSWZDBjfEg: folds
OWP/DOu+PlPK6ZZ3zYa0HA: folds
5SgaHdWixdClWvaEG+KUjQ: folds
APYIOyK/4AGb+kIwlOUNBQ: folds
J0W5D97jl5VLky+IoPvDeA: folds
W3ingbA178eb7J5rt1PuIQ: raises $1.50 to $2
E2518gp4aFz1+kAgmGqeEg: raises $8.25 to $10.25 and is all-in
HZkVla4kK2SI42CVrPZ/ig: folds
jXGruyaMqirTaTXNOvBdew: folds
W3ingbA178eb7J5rt1PuIQ: calls $8.25
*** FLOP *** [Jc Ah 7d]
*** TURN *** [Jc Ah 7d] [Js]
*** RIVER *** [Jc Ah 7d Js] [6c]
*** SHOW DOWN ***
W3ingbA178eb7J5rt1PuIQ: shows [4c 4d] (two pair, Jacks and Fours)
E2518gp4aFz1+kAgmGqeEg: shows [8d 8h] (two pair, Jacks and Eights)
E2518gp4aFz1+kAgmGqeEg collected $20.20 from pot
E2518gp4aFz1+kAgmGqeEg is sitting out
*** SUMMARY ***
Total pot $21.25 | Rake $1.05
Board [Jc Ah 7d Js 6c]
Seat 1: HZkVla4kK2SI42CVrPZ/ig (small blind) folded before Flop
Seat 2: jXGruyaMqirTaTXNOvBdew (big blind) folded before Flop
Seat 3: g4k0NXISyLCqaSWZDBjfEg folded before Flop (didn't bet)
Seat 4: OWP/DOu+PlPK6ZZ3zYa0HA folded before Flop (didn't bet)
Seat 5: 5SgaHdWixdClWvaEG+KUjQ folded before Flop (didn't bet)
Seat 6: APYIOyK/4AGb+kIwlOUNBQ folded before Flop (didn't bet)
Seat 7: J0W5D97jl5VLky+IoPvDeA folded before Flop (didn't bet)
Seat 8: W3ingbA178eb7J5rt1PuIQ showed [4c 4d] and lost with two pair, Jacks and Fours
Seat 9: E2518gp4aFz1+kAgmGqeEg (button) showed [8d 8h] and won ($20.20) with two pair, Jacks and Eights



PokerStars Game #59939191640:  Hold'em No Limit ($0.25/$0.50) - 2009/07/01 0:33:36 ET
Table 'IeNZOZQ4T6oiaHqFeo6yIA' 2-max Seat #2 is the button
Seat 1: ndd1nfncBkWNitBnsfCoVQ ($88.55 in chips)
Seat 2: A91IUl5JaZROhtfCtnnwYw ($41.25 in chips)
A91IUl5JaZROhtfCtnnwYw: posts small blind $0.25
ndd1nfncBkWNitBnsfCoVQ: posts big blind $0.50
*** HOLE CARDS ***
A91IUl5JaZROhtfCtnnwYw: raises $0.50 to $1
ndd1nfncBkWNitBnsfCoVQ: calls $0.50
*** FLOP *** [Js Qc 9d]
ndd1nfncBkWNitBnsfCoVQ: checks
A91IUl5JaZROhtfCtnnwYw: bets $1.50
ndd1nfncBkWNitBnsfCoVQ: raises $5 to $6.50
A91IUl5JaZROhtfCtnnwYw: calls $5
*** TURN *** [Js Qc 9d] [Ks]
ndd1nfncBkWNitBnsfCoVQ: checks
A91IUl5JaZROhtfCtnnwYw: bets $15
ndd1nfncBkWNitBnsfCoVQ: folds
A91IUl5JaZROhtfCtnnwYw collected $14.50 from pot
A91IUl5JaZROhtfCtnnwYw: doesn't show hand
*** SUMMARY ***
Total pot $15 | Rake $0.50
Board [Js Qc 9d Ks]
Seat 1: ndd1nfncBkWNitBnsfCoVQ (big blind) folded on the Turn
Seat 2: A91IUl5JaZROhtfCtnnwYw (button) (small blind) collected ($14.50)



PokerStars Game #59939191944:  Hold'em No Limit ($0.25/$0.50) - 2009/07/01 0:33:37 ET
Table 'QOgaEqMcJ73pcUMMxoisUg' 6-max Seat #6 is the button
Seat 1: OZ6OtYh5Y53MCH/p0QTn5g ($50.25 in chips)
Seat 3: Rt6KgtZ8YaJoTc3FPim00w ($50 in chips)
Seat 4: zAcsDhG/T128Vn7XGVSgKg ($62.55 in chips)
Seat 5: 6vNxrjjCl6FwfaaymM9jjg ($26.05 in chips)
Seat 6: pmE+2KJb4nffAVqjLIXxFg ($22 in chips)
OZ6OtYh5Y53MCH/p0QTn5g: posts small blind $0.25
Im2p1Nt83UKSqv5c9frm4Q: is sitting out
Rt6KgtZ8YaJoTc3FPim00w: posts big blind $0.50
*** HOLE CARDS ***
zAcsDhG/T128Vn7XGVSgKg: raises $1 to $1.50
6vNxrjjCl6FwfaaymM9jjg: folds
pmE+2KJb4nffAVqjLIXxFg: folds
OZ6OtYh5Y53MCH/p0QTn5g: folds
Rt6KgtZ8YaJoTc3FPim00w: calls $1
*** FLOP *** [Td Ks 7s]
Rt6KgtZ8YaJoTc3FPim00w: checks
zAcsDhG/T128Vn7XGVSgKg: bets $2
Rt6KgtZ8YaJoTc3FPim00w: folds
zAcsDhG/T128Vn7XGVSgKg collected $3.10 from pot
*** SUMMARY ***
Total pot $3.25 | Rake $0.15
Board [Td Ks 7s]
Seat 1: OZ6OtYh5Y53MCH/p0QTn5g (small blind) folded before Flop
Seat 3: Rt6KgtZ8YaJoTc3FPim00w (big blind) folded on the Flop
Seat 4: zAcsDhG/T128Vn7XGVSgKg collected ($3.10)
Seat 5: 6vNxrjjCl6FwfaaymM9jjg folded before Flop (didn't bet)
Seat 6: pmE+2KJb4nffAVqjLIXxFg (button) folded before Flop (didn't bet)



PokerStars Game #59939193778:  Hold'em No Limit ($0.25/$0.50) - 2009/07/01 0:33:40 ET
Table 'tyR5AZNKV8Aadbrnrnlg7g' 6-max Seat #3 is the button
Seat 1: R+KjpH/wSjDLhtIy9+edNA ($81 in chips)
Seat 2: 58zdeSBSuSFX/qZfhc7YmA ($38.05 in chips)
Seat 3: tdOvWynovql5imfooroLMg ($48 in chips)
Seat 4: Rt6KgtZ8YaJoTc3FPim00w ($83.45 in chips)
Seat 6: ZKazl1hGaPiapDXincgi2Q ($22.20 in chips)
Rt6KgtZ8YaJoTc3FPim00w: posts small blind $0.25
wOyVV9M/oyiw3YaOjNZ05w: is sitting out
ZKazl1hGaPiapDXincgi2Q: posts big blind $0.50
*** HOLE CARDS ***
wOyVV9M/oyiw3YaOjNZ05w leaves the table
R+KjpH/wSjDLhtIy9+edNA: folds
58zdeSBSuSFX/qZfhc7YmA: raises $1 to $1.50
tdOvWynovql5imfooroLMg: folds
Rt6KgtZ8YaJoTc3FPim00w: folds
ZKazl1hGaPiapDXincgi2Q: folds
58zdeSBSuSFX/qZfhc7YmA collected $1.25 from pot
*** SUMMARY ***
Total pot $1.25 | Rake $0
Seat 1: R+KjpH/wSjDLhtIy9+edNA folded before Flop (didn't bet)
Seat 2: 58zdeSBSuSFX/qZfhc7YmA collected ($1.25)
Seat 3: tdOvWynovql5imfooroLMg (button) folded before Flop (didn't bet)
Seat 4: Rt6KgtZ8YaJoTc3FPim00w (small blind) folded before Flop
Seat 6: ZKazl1hGaPiapDXincgi2Q (big blind) folded before Flop



PokerStars Game #59939194652:  Hold'em No Limit ($0.25/$0.50) - 2009/07/01 0:33:41 ET
Table 'hWT2kq66tnKEpD26cia6fQ' 2-max Seat #2 is the button
Seat 1: ZGkLiY2Qq6oVQktNWqoLVg ($16.45 in chips)
Seat 2: dkC7J+qbyqk0qCcmJbEPPw ($47.50 in chips)
dkC7J+qbyqk0qCcmJbEPPw: posts small blind $0.25
ZGkLiY2Qq6oVQktNWqoLVg: posts big blind $0.50
*** HOLE CARDS ***
dkC7J+qbyqk0qCcmJbEPPw: raises $2 to $2.50
ZGkLiY2Qq6oVQktNWqoLVg: folds
dkC7J+qbyqk0qCcmJbEPPw collected $1 from pot
*** SUMMARY ***
Total pot $1 | Rake $0
Seat 1: ZGkLiY2Qq6oVQktNWqoLVg (big blind) folded before Flop
Seat 2: dkC7J+qbyqk0qCcmJbEPPw (button) (small blind) collected ($1)



PokerStars Game #59939195220:  Hold'em No Limit ($0.25/$0.50) - 2009/07/01 0:33:42 ET
Table '+dXkOAQyS8j9PQZusUTMpg' 2-max Seat #1 is the button
Seat 1: XFa6sBGjP2gxoIvxR3fZIg ($79.25 in chips)
Seat 2: 5IBeOgaApY1Bvzv2P8X4EA ($63.40 in chips)
XFa6sBGjP2gxoIvxR3fZIg: posts small blind $0.25
5IBeOgaApY1Bvzv2P8X4EA: posts big blind $0.50
*** HOLE CARDS ***
XFa6sBGjP2gxoIvxR3fZIg: raises $1 to $1.50
5IBeOgaApY1Bvzv2P8X4EA: folds
XFa6sBGjP2gxoIvxR3fZIg collected $1 from pot
XFa6sBGjP2gxoIvxR3fZIg: doesn't show hand
*** SUMMARY ***
Total pot $1 | Rake $0
Seat 1: XFa6sBGjP2gxoIvxR3fZIg (button) (small blind) collected ($1)
Seat 2: 5IBeOgaApY1Bvzv2P8X4EA (big blind) folded before Flop



PokerStars Game #59939196694:  Hold'em No Limit ($0.25/$0.50) - 2009/07/01 0:33:44 ET
Table 'ibNfFy0bCzuBaUORla0aGw' 9-max Seat #3 is the button
Seat 1: xZCXQSXlrZkp3pZizzVXCw ($53.95 in chips)
Seat 2: 90Wb75h3W1BRpbqVnuk8gw ($61.85 in chips)
Seat 3: dDaHs3X8+fe3bIkRU0cbrw ($40.90 in chips)
Seat 4: YBN054X4blmis+B2bBlC0g ($19.10 in chips)
Seat 6: 8n9jQLh3cZKbsmr5PIjgiQ ($39 in chips)
Seat 7: HZkVla4kK2SI42CVrPZ/ig ($9.25 in chips)
Seat 8: xUrN9TWLq4m5V+OXY7KUUA ($50 in chips)
Seat 9: pFtzb1sR4b0d1aw6aIRgDg ($50.75 in chips)
YBN054X4blmis+B2bBlC0g: posts small blind $0.25
GarryKas: is sitting out
GarryKas leaves the table
8n9jQLh3cZKbsmr5PIjgiQ: posts big blind $0.50
*** HOLE CARDS ***
HZkVla4kK2SI42CVrPZ/ig: folds
xUrN9TWLq4m5V+OXY7KUUA: folds
pFtzb1sR4b0d1aw6aIRgDg: folds
xZCXQSXlrZkp3pZizzVXCw: folds
90Wb75h3W1BRpbqVnuk8gw: raises $1.50 to $2
dDaHs3X8+fe3bIkRU0cbrw: folds
YBN054X4blmis+B2bBlC0g: calls $1.75
8n9jQLh3cZKbsmr5PIjgiQ: folds
*** FLOP *** [8h 2c 9d]
YBN054X4blmis+B2bBlC0g: checks
90Wb75h3W1BRpbqVnuk8gw: bets $2.50
YBN054X4blmis+B2bBlC0g: folds
90Wb75h3W1BRpbqVnuk8gw collected $4.30 from pot
90Wb75h3W1BRpbqVnuk8gw: doesn't show hand
*** SUMMARY ***
Total pot $4.50 | Rake $0.20
Board [8h 2c 9d]
Seat 1: xZCXQSXlrZkp3pZizzVXCw folded before Flop (didn't bet)
Seat 2: 90Wb75h3W1BRpbqVnuk8gw collected ($4.30)
Seat 3: dDaHs3X8+fe3bIkRU0cbrw (button) folded before Flop (didn't bet)
Seat 4: YBN054X4blmis+B2bBlC0g (small blind) folded on the Flop
Seat 6: 8n9jQLh3cZKbsmr5PIjgiQ (big blind) folded before Flop
Seat 7: HZkVla4kK2SI42CVrPZ/ig folded before Flop (didn't bet)
Seat 8: xUrN9TWLq4m5V+OXY7KUUA folded before Flop (didn't bet)
Seat 9: pFtzb1sR4b0d1aw6aIRgDg folded before Flop (didn't bet)



PokerStars Game #59939197670:  Hold'em No Limit ($0.25/$0.50) - 2009/07/01 0:33:46 ET
Table 'QOgaEqMcJ73pcUMMxoisUgErOuyGLI5PT3G5MnpHgC/g Seat #2 is the button
Seat 1: L5e2lrPLQm1Pqx30IIZ/Fw ($10 in chips)
Seat 2: RjBdQ6w31rgcy0o24VLR6w ($18.95 in chips)
Seat 3: xZCXQSXlrZkp3pZizzVXCw ($49.25 in chips)
Seat 4: 3UmXLy3GfjC3EkOebduerQ ($50 in chips)
Seat 5: JwvquocWfhTVApN5t47LgA ($57.80 in chips)
Seat 6: zE9cVigS2nW/Ljy4K4bUQA ($30 in chips)
Seat 7: 90Wb75h3W1BRpbqVnuk8gw ($62.95 in chips)
Seat 8: g4k0NXISyLCqaSWZDBjfEg ($52.10 in chips)
Seat 9: J0W5D97jl5VLky+IoPvDeA ($56.40 in chips)
xZCXQSXlrZkp3pZizzVXCw: posts small blind $0.25
3UmXLy3GfjC3EkOebduerQ: posts big blind $0.50
*** HOLE CARDS ***
JwvquocWfhTVApN5t47LgA: folds
zE9cVigS2nW/Ljy4K4bUQA: folds
90Wb75h3W1BRpbqVnuk8gw: folds
g4k0NXISyLCqaSWZDBjfEg: folds
J0W5D97jl5VLky+IoPvDeA: folds
L5e2lrPLQm1Pqx30IIZ/Fw: folds
RjBdQ6w31rgcy0o24VLR6w: folds
xZCXQSXlrZkp3pZizzVXCw: raises $1 to $1.50
3UmXLy3GfjC3EkOebduerQ: folds
xZCXQSXlrZkp3pZizzVXCw collected $1 from pot
*** SUMMARY ***
Total pot $1 | Rake $0
Seat 1: L5e2lrPLQm1Pqx30IIZ/Fw folded before Flop (didn't bet)
Seat 2: RjBdQ6w31rgcy0o24VLR6w (button) folded before Flop (didn't bet)
Seat 3: xZCXQSXlrZkp3pZizzVXCw (small blind) collected ($1)
Seat 4: 3UmXLy3GfjC3EkOebduerQ (big blind) folded before Flop
Seat 5: JwvquocWfhTVApN5t47LgA folded before Flop (didn't bet)
Seat 6: zE9cVigS2nW/Ljy4K4bUQA folded before Flop (didn't bet)
Seat 7: 90Wb75h3W1BRpbqVnuk8gw folded before Flop (didn't bet)
Seat 8: g4k0NXISyLCqaSWZDBjfEg folded before Flop (didn't bet)
Seat 9: J0W5D97jl5VLky+IoPvDeA folded before Flop (didn't bet)



PokerStars Game #59939198288:  Hold'em No Limit ($0.25/$0.50) - 2009/07/01 0:33:47 ET
Table 'kgbJRsxfv64KrErDRBAkcw' 6-max Seat #3 is the button
Seat 1: mxTUARCsU8Eby0whmHNcOw ($7.50 in chips)
Seat 2: Q+thC23WCv1kJUJtH/+4Jw ($58.80 in chips)
Seat 3: T0Gx/FcQ5VH9u7XaOMX97A ($81.35 in chips)
Seat 4: qanMEqjABjWxC/JgQ/0l7w ($57.20 in chips)
Seat 5: +Pf9jTVizYlIo+woPvptfA ($52.30 in chips)
Seat 6: ozrlafxxh1HmYdA0/h+MuA ($13.90 in chips)
qanMEqjABjWxC/JgQ/0l7w: posts small blind $0.25
+Pf9jTVizYlIo+woPvptfA: posts big blind $0.50
*** HOLE CARDS ***
ozrlafxxh1HmYdA0/h+MuA: folds
mxTUARCsU8Eby0whmHNcOw: folds
Q+thC23WCv1kJUJtH/+4Jw: folds
T0Gx/FcQ5VH9u7XaOMX97A: raises $1 to $1.50
qanMEqjABjWxC/JgQ/0l7w: folds
+Pf9jTVizYlIo+woPvptfA: folds
T0Gx/FcQ5VH9u7XaOMX97A collected $1.25 from pot
T0Gx/FcQ5VH9u7XaOMX97A: doesn't show hand
*** SUMMARY ***
Total pot $1.25 | Rake $0
Seat 1: mxTUARCsU8Eby0whmHNcOw folded before Flop (didn't bet)
Seat 2: Q+thC23WCv1kJUJtH/+4Jw folded before Flop (didn't bet)
Seat 3: T0Gx/FcQ5VH9u7XaOMX97A (button) collected ($1.25)
Seat 4: qanMEqjABjWxC/JgQ/0l7w (small blind) folded before Flop
Seat 5: +Pf9jTVizYlIo+woPvptfA (big blind) folded before Flop
Seat 6: ozrlafxxh1HmYdA0/h+MuA folded before Flop (didn't bet)



PokerStars Game #59939199402:  Hold'em No Limit ($0.25/$0.50) - 2009/07/01 0:33:48 ET
Table 'hWT2kq66tnKEpD26cia6fQ' 2-max Seat #1 is the button
Seat 1: ZGkLiY2Qq6oVQktNWqoLVg ($15.95 in chips)
Seat 2: dkC7J+qbyqk0qCcmJbEPPw ($48 in chips)
ZGkLiY2Qq6oVQktNWqoLVg: posts small blind $0.25
dkC7J+qbyqk0qCcmJbEPPw: posts big blind $0.50
*** HOLE CARDS ***
ZGkLiY2Qq6oVQktNWqoLVg: raises $1 to $1.50
dkC7J+qbyqk0qCcmJbEPPw: folds
ZGkLiY2Qq6oVQktNWqoLVg collected $1 from pot
ZGkLiY2Qq6oVQktNWqoLVg: doesn't show hand
*** SUMMARY ***
Total pot $1 | Rake $0
Seat 1: ZGkLiY2Qq6oVQktNWqoLVg (button) (small blind) collected ($1)
Seat 2: dkC7J+qbyqk0qCcmJbEPPw (big blind) folded before Flop



PokerStars Game #59939199830:  Hold'em No Limit ($0.25/$0.50) - 2009/07/01 0:33:49 ET
Table 'E7bWJ45aoFXRpyRv2gw+Ig' 2-max Seat #1 is the button
Seat 1: FRkiRasEGlHUeLrEl+k/nA ($51.35 in chips)
Seat 2: 3Wro85I7472vJ4Wkpneo9A ($144.65 in chips)
FRkiRasEGlHUeLrEl+k/nA: posts small blind $0.25
3Wro85I7472vJ4Wkpneo9A: posts big blind $0.50
*** HOLE CARDS ***
FRkiRasEGlHUeLrEl+k/nA: raises $1 to $1.50
3Wro85I7472vJ4Wkpneo9A: folds
FRkiRasEGlHUeLrEl+k/nA collected $1 from pot
*** SUMMARY ***
Total pot $1 | Rake $0
Seat 1: FRkiRasEGlHUeLrEl+k/nA (button) (small blind) collected ($1)
Seat 2: 3Wro85I7472vJ4Wkpneo9A (big blind) folded before Flop



PokerStars Game #59939199772:  Hold'em No Limit ($0.25/$0.50) - 2009/07/01 0:33:49 ET
Table '+dXkOAQyS8j9PQZusUTMpg' 2-max Seat #2 is the button
Seat 1: XFa6sBGjP2gxoIvxR3fZIg ($79.75 in chips)
Seat 2: 5IBeOgaApY1Bvzv2P8X4EA ($62.90 in chips)
5IBeOgaApY1Bvzv2P8X4EA: posts small blind $0.25
XFa6sBGjP2gxoIvxR3fZIg: posts big blind $0.50
*** HOLE CARDS ***
5IBeOgaApY1Bvzv2P8X4EA: folds
XFa6sBGjP2gxoIvxR3fZIg collected $0.50 from pot
*** SUMMARY ***
Total pot $0.50 | Rake $0
Seat 1: XFa6sBGjP2gxoIvxR3fZIg (big blind) collected ($0.50)
Seat 2: 5IBeOgaApY1Bvzv2P8X4EA (button) (small blind) folded before Flop



PokerStars Game #59939201430:  Hold'em No Limit ($0.25/$0.50) - 2009/07/01 0:33:51 ET
Table 'mTxf8gPLgffN3Iwfm7Icfg' 2-max Seat #1 is the button
Seat 1: Do9Rlu1R5u/AcRtMTl8SYg ($76.95 in chips)
Seat 2: EMc5LPgVaded4Qc77vm0fw ($81.55 in chips)
Do9Rlu1R5u/AcRtMTl8SYg: posts small blind $0.25
EMc5LPgVaded4Qc77vm0fw: posts big blind $0.50
*** HOLE CARDS ***
Do9Rlu1R5u/AcRtMTl8SYg: calls $0.25
EMc5LPgVaded4Qc77vm0fw: raises $1.50 to $2
Do9Rlu1R5u/AcRtMTl8SYg: calls $1.50
*** FLOP *** [6h 5d Kc]
EMc5LPgVaded4Qc77vm0fw: bets $2.50
Do9Rlu1R5u/AcRtMTl8SYg: folds
EMc5LPgVaded4Qc77vm0fw collected $3.80 from pot
EMc5LPgVaded4Qc77vm0fw: doesn't show hand
*** SUMMARY ***
Total pot $4 | Rake $0.20
Board [6h 5d Kc]
Seat 1: Do9Rlu1R5u/AcRtMTl8SYg (button) (small blind) folded on the Flop
Seat 2: EMc5LPgVaded4Qc77vm0fw (big blind) collected ($3.80)



PokerStars Game #59939200822:  Hold'em No Limit ($0.25/$0.50) - 2009/07/01 0:33:51 ET
Table '5EmHi+fnatGQQShcNmzOZQ' 6-max Seat #2 is the button
Seat 1: SwPczQo3cOtwEzhJrfO2cQ ($29.75 in chips)
Seat 2: vXIHnZ+dv/hwSBxyvGw7bQ ($50.20 in chips)
Seat 3: L9qfLYXrczhAPd/VckgsWw ($64.75 in chips)
Seat 5: kxPhs4ePFqMy52CInAJ2aw ($53.85 in chips)
Seat 6: 686aeHikcJlgKkSuIFdcXQ ($138.65 in chips)
L9qfLYXrczhAPd/VckgsWw: posts small blind $0.25
wOyVV9M/oyiw3YaOjNZ05w: is sitting out
kxPhs4ePFqMy52CInAJ2aw: posts big blind $0.50
*** HOLE CARDS ***
686aeHikcJlgKkSuIFdcXQ: folds
wOyVV9M/oyiw3YaOjNZ05w leaves the table
SwPczQo3cOtwEzhJrfO2cQ: calls $0.50
1b+2BbjMN8qhR1WPqdE9VQ joins the table at seat #4
vXIHnZ+dv/hwSBxyvGw7bQ: raises $2 to $2.50
L9qfLYXrczhAPd/VckgsWw: calls $2.25
kxPhs4ePFqMy52CInAJ2aw: folds
SwPczQo3cOtwEzhJrfO2cQ: folds
*** FLOP *** [2c Ad 9h]
L9qfLYXrczhAPd/VckgsWw: checks
vXIHnZ+dv/hwSBxyvGw7bQ: bets $3.50
L9qfLYXrczhAPd/VckgsWw: calls $3.50
*** TURN *** [2c Ad 9h] [2s]
L9qfLYXrczhAPd/VckgsWw: checks
vXIHnZ+dv/hwSBxyvGw7bQ: bets $8
L9qfLYXrczhAPd/VckgsWw: calls $8
*** RIVER *** [2c Ad 9h 2s] [3h]
L9qfLYXrczhAPd/VckgsWw: bets $13.50
vXIHnZ+dv/hwSBxyvGw7bQ: calls $13.50
*** SHOW DOWN ***
L9qfLYXrczhAPd/VckgsWw: shows [Ac Kh] (two pair, Aces and Deuces)
vXIHnZ+dv/hwSBxyvGw7bQ: mucks hand
L9qfLYXrczhAPd/VckgsWw collected $54 from pot
*** SUMMARY ***
Total pot $56 | Rake $2
Board [2c Ad 9h 2s 3h]
Seat 1: SwPczQo3cOtwEzhJrfO2cQ folded before Flop
Seat 2: vXIHnZ+dv/hwSBxyvGw7bQ (button) mucked
Seat 3: L9qfLYXrczhAPd/VckgsWw (small blind) showed [Ac Kh] and won ($54) with two pair, Aces and Deuces
Seat 5: kxPhs4ePFqMy52CInAJ2aw (big blind) folded before Flop
Seat 6: 686aeHikcJlgKkSuIFdcXQ folded before Flop (didn't bet)



PokerStars Game #59939201944:  Hold'em No Limit ($0.25/$0.50) - 2009/07/01 0:33:52 ET
Table 'Nz0Vr7WMHL2g5Uk7dDZjpw' 9-max Seat #5 is the button
Seat 2: XNMDwbXt/Q4jM99AXnbJDw ($67.45 in chips)
Seat 3: 4QTiNH5fteLgJjx/s6Hy6A ($14.35 in chips)
Seat 4: 5JJVDlaiMnB004o/RqbZZQ ($27.75 in chips)
Seat 5: WGW0DgjBUXs1ylURHG8vnQ ($15.85 in chips)
Seat 6: k1f0lS7tlMHCLGs0JT34Tg ($13.35 in chips)
Seat 7: KPLH0gELgFe2OuAnhJFI5w ($26.50 in chips)
Seat 8: HkZI6g4zl83TDTA7SRspmQ ($16.45 in chips)
Seat 9: Ak2W6V2TDVIQrvSAy4eD7Q ($8.25 in chips)
k1f0lS7tlMHCLGs0JT34Tg: posts small blind $0.25
KPLH0gELgFe2OuAnhJFI5w: posts big blind $0.50
tLkxo7JgV+WWI0UBw44K5A: sits out
*** HOLE CARDS ***
HkZI6g4zl83TDTA7SRspmQ: folds
Ak2W6V2TDVIQrvSAy4eD7Q: folds
XNMDwbXt/Q4jM99AXnbJDw: folds
4QTiNH5fteLgJjx/s6Hy6A: calls $0.50
5JJVDlaiMnB004o/RqbZZQ: calls $0.50
WGW0DgjBUXs1ylURHG8vnQ: calls $0.50
k1f0lS7tlMHCLGs0JT34Tg: calls $0.25
KPLH0gELgFe2OuAnhJFI5w: checks
*** FLOP *** [Td Ks Ac]
k1f0lS7tlMHCLGs0JT34Tg: bets $0.50
KPLH0gELgFe2OuAnhJFI5w: folds
4QTiNH5fteLgJjx/s6Hy6A: folds
5JJVDlaiMnB004o/RqbZZQ: folds
WGW0DgjBUXs1ylURHG8vnQ: calls $0.50
*** TURN *** [Td Ks Ac] [5s]
k1f0lS7tlMHCLGs0JT34Tg: checks
WGW0DgjBUXs1ylURHG8vnQ: bets $0.50
k1f0lS7tlMHCLGs0JT34Tg: calls $0.50
*** RIVER *** [Td Ks Ac 5s] [Tc]
k1f0lS7tlMHCLGs0JT34Tg: checks
WGW0DgjBUXs1ylURHG8vnQ: bets $0.50
k1f0lS7tlMHCLGs0JT34Tg: calls $0.50
*** SHOW DOWN ***
WGW0DgjBUXs1ylURHG8vnQ: shows [8c Kc] (two pair, Kings and Tens)
k1f0lS7tlMHCLGs0JT34Tg: shows [Kd 7h] (two pair, Kings and Tens)
k1f0lS7tlMHCLGs0JT34Tg collected $2.65 from pot
WGW0DgjBUXs1ylURHG8vnQ collected $2.60 from pot
*** SUMMARY ***
Total pot $5.50 | Rake $0.25
Board [Td Ks Ac 5s Tc]
Seat 2: XNMDwbXt/Q4jM99AXnbJDw folded before Flop (didn't bet)
Seat 3: 4QTiNH5fteLgJjx/s6Hy6A folded on the Flop
Seat 4: 5JJVDlaiMnB004o/RqbZZQ folded on the Flop
Seat 5: WGW0DgjBUXs1ylURHG8vnQ (button) showed [8c Kc] and won ($2.60) with two pair, Kings and Tens
Seat 6: k1f0lS7tlMHCLGs0JT34Tg (small blind) showed [Kd 7h] and won ($2.65) with two pair, Kings and Tens
Seat 7: KPLH0gELgFe2OuAnhJFI5w (big blind) folded on the Flop
Seat 8: HkZI6g4zl83TDTA7SRspmQ folded before Flop (didn't bet)
Seat 9: Ak2W6V2TDVIQrvSAy4eD7Q folded before Flop (didn't bet)



PokerStars Game #59939203210:  Hold'em No Limit ($0.25/$0.50) - 2009/07/01 0:33:54 ET
Table 'GfL/No5u5PoEnU39lP5pQg' 6-max Seat #3 is the button
Seat 1: 1WUCqNG+p+vfWRTXNu4ljw ($50.30 in chips)
Seat 2: uVwggSetzp7d+eVgowO3vg ($54.30 in chips)
Seat 3: NbUTppWfym/RxV/DmDz2Sw ($13.20 in chips)
Seat 4: x+pzUFJsMIiGd7a5pcR4tg ($54.10 in chips)
Seat 5: crjGpJEzSZgD38FoE3VMGg ($60.35 in chips)
x+pzUFJsMIiGd7a5pcR4tg: posts small blind $0.25
crjGpJEzSZgD38FoE3VMGg: posts big blind $0.50
*** HOLE CARDS ***
1WUCqNG+p+vfWRTXNu4ljw: folds
uVwggSetzp7d+eVgowO3vg: folds
NbUTppWfym/RxV/DmDz2Sw: calls $0.50
x+pzUFJsMIiGd7a5pcR4tg: folds
crjGpJEzSZgD38FoE3VMGg: checks
*** FLOP *** [Kh Kd Jd]
crjGpJEzSZgD38FoE3VMGg: checks
NbUTppWfym/RxV/DmDz2Sw: checks
*** TURN *** [Kh Kd Jd] [4s]
crjGpJEzSZgD38FoE3VMGg: checks
NbUTppWfym/RxV/DmDz2Sw: checks
*** RIVER *** [Kh Kd Jd 4s] [5d]
crjGpJEzSZgD38FoE3VMGg: checks
NbUTppWfym/RxV/DmDz2Sw: checks
*** SHOW DOWN ***
crjGpJEzSZgD38FoE3VMGg: shows [3h Td] (a pair of Kings)
NbUTppWfym/RxV/DmDz2Sw: shows [Qc 6c] (a pair of Kings - Queen kicker)
NbUTppWfym/RxV/DmDz2Sw collected $1.20 from pot
*** SUMMARY ***
Total pot $1.25 | Rake $0.05
Board [Kh Kd Jd 4s 5d]
Seat 1: 1WUCqNG+p+vfWRTXNu4ljw folded before Flop (didn't bet)
Seat 2: uVwggSetzp7d+eVgowO3vg folded before Flop (didn't bet)
Seat 3: NbUTppWfym/RxV/DmDz2Sw (button) showed [Qc 6c] and won ($1.20) with a pair of Kings
Seat 4: x+pzUFJsMIiGd7a5pcR4tg (small blind) folded before Flop
Seat 5: crjGpJEzSZgD38FoE3VMGg (big blind) showed [3h Td] and lost with a pair of Kings



PokerStars Game #59939203444:  Hold'em No Limit ($0.25/$0.50) - 2009/07/01 0:33:54 ET
Table 'T/PgNWqVyY6lkldcBVXYJQ' 6-max Seat #6 is the button
Seat 1: +Pf9jTVizYlIo+woPvptfA ($57.50 in chips)
Seat 2: oZAeY5rVqNGgt8yyQ0pxbA ($34.55 in chips)
Seat 3: L3OcNO1bgdqDI46j67KQPQ ($54.60 in chips)
Seat 5: vVQBckETtigfb5mAcyK0OA ($49 in chips)
Seat 6: cDzbog6kwmJp+LBeBq+iMQ ($47.25 in chips)
+Pf9jTVizYlIo+woPvptfA: posts small blind $0.25
oZAeY5rVqNGgt8yyQ0pxbA: posts big blind $0.50
*** HOLE CARDS ***
L3OcNO1bgdqDI46j67KQPQ: folds
vVQBckETtigfb5mAcyK0OA: calls $0.50
cDzbog6kwmJp+LBeBq+iMQ said, "I have A9 in case anyone cares... its what i lost 1400 on earlier"
cDzbog6kwmJp+LBeBq+iMQ: calls $0.50
+Pf9jTVizYlIo+woPvptfA: folds
oZAeY5rVqNGgt8yyQ0pxbA: checks
*** FLOP *** [5h 7s 6h]
oZAeY5rVqNGgt8yyQ0pxbA: bets $1
cDzbog6kwmJp+LBeBq+iMQ said, "missed"
cDzbog6kwmJp+LBeBq+iMQ said, "lol"
vVQBckETtigfb5mAcyK0OA: folds
cDzbog6kwmJp+LBeBq+iMQ said, "common gut shot"
cDzbog6kwmJp+LBeBq+iMQ: calls $1
*** TURN *** [5h 7s 6h] [Js]
oZAeY5rVqNGgt8yyQ0pxbA: bets $2
cDzbog6kwmJp+LBeBq+iMQ said, "common flush"
cDzbog6kwmJp+LBeBq+iMQ: calls $2
*** RIVER *** [5h 7s 6h Js] [Kh]
oZAeY5rVqNGgt8yyQ0pxbA: bets $2
cDzbog6kwmJp+LBeBq+iMQ said, "****"
cDzbog6kwmJp+LBeBq+iMQ: folds
otJMdCRvqd5YCcFsA3JWpg joins the table at seat #4
oZAeY5rVqNGgt8yyQ0pxbA collected $7.40 from pot
oZAeY5rVqNGgt8yyQ0pxbA: doesn't show hand
*** SUMMARY ***
Total pot $7.75 | Rake $0.35
Board [5h 7s 6h Js Kh]
Seat 1: +Pf9jTVizYlIo+woPvptfA (small blind) folded before Flop
Seat 2: oZAeY5rVqNGgt8yyQ0pxbA (big blind) collected ($7.40)
Seat 3: L3OcNO1bgdqDI46j67KQPQ folded before Flop (didn't bet)
Seat 5: vVQBckETtigfb5mAcyK0OA folded on the Flop
Seat 6: cDzbog6kwmJp+LBeBq+iMQ (button) folded on the River



PokerStars Game #59939203076:  Hold'em No Limit ($0.25/$0.50) - 2009/07/01 0:33:54 ET
Table 'lSisgp6H7Fg1hH5VfjEjYQ' 9-max Seat #6 is the button
Seat 1: pEW8B6uXbdR47kfljMQ3+Q ($37.85 in chips)
Seat 2: UrcnkQOiLVk8BlKDPJSy7Q ($50 in chips)
Seat 3: aTkyjTh3w5YLWiIERupZOA ($42.45 in chips)
Seat 4: bwv/rbH/hHhPhY6u9mu04w ($21.65 in chips)
Seat 5: mSD1pginDsyHG5PDfqzphw ($10 in chips)
Seat 6: +k7T5ocke8UwavtgUHm+Cg ($28.95 in chips)
Seat 7: Y3DZ6qQlLeBhixDj4M9vmg ($14.50 in chips)
Seat 8: a4JDWmpFQkL10XfAyuF51A ($35.50 in chips)
Seat 9: 5JJVDlaiMnB004o/RqbZZQ ($45.25 in chips)
Y3DZ6qQlLeBhixDj4M9vmg: posts small blind $0.25
a4JDWmpFQkL10XfAyuF51A: posts big blind $0.50
*** HOLE CARDS ***
5JJVDlaiMnB004o/RqbZZQ: folds
pEW8B6uXbdR47kfljMQ3+Q is disconnected
pEW8B6uXbdR47kfljMQ3+Q is connected
pEW8B6uXbdR47kfljMQ3+Q: folds
UrcnkQOiLVk8BlKDPJSy7Q: calls $0.50
aTkyjTh3w5YLWiIERupZOA: folds
bwv/rbH/hHhPhY6u9mu04w: folds
mSD1pginDsyHG5PDfqzphw: folds
+k7T5ocke8UwavtgUHm+Cg: folds
Y3DZ6qQlLeBhixDj4M9vmg: calls $0.25
a4JDWmpFQkL10XfAyuF51A: checks
*** FLOP *** [7d 9h 6h]
Y3DZ6qQlLeBhixDj4M9vmg: checks
a4JDWmpFQkL10XfAyuF51A: checks
UrcnkQOiLVk8BlKDPJSy7Q: bets $1.50
Y3DZ6qQlLeBhixDj4M9vmg: calls $1.50
a4JDWmpFQkL10XfAyuF51A: folds
*** TURN *** [7d 9h 6h] [Jc]
Y3DZ6qQlLeBhixDj4M9vmg: checks
UrcnkQOiLVk8BlKDPJSy7Q: bets $3
Y3DZ6qQlLeBhixDj4M9vmg: folds
UrcnkQOiLVk8BlKDPJSy7Q collected $4.30 from pot
UrcnkQOiLVk8BlKDPJSy7Q: doesn't show hand
*** SUMMARY ***
Total pot $4.50 | Rake $0.20
Board [7d 9h 6h Jc]
Seat 1: pEW8B6uXbdR47kfljMQ3+Q folded before Flop (didn't bet)
Seat 2: UrcnkQOiLVk8BlKDPJSy7Q collected ($4.30)
Seat 3: aTkyjTh3w5YLWiIERupZOA folded before Flop (didn't bet)
Seat 4: bwv/rbH/hHhPhY6u9mu04w folded before Flop (didn't bet)
Seat 5: mSD1pginDsyHG5PDfqzphw folded before Flop (didn't bet)
Seat 6: +k7T5ocke8UwavtgUHm+Cg (button) folded before Flop (didn't bet)
Seat 7: Y3DZ6qQlLeBhixDj4M9vmg (small blind) folded on the Turn
Seat 8: a4JDWmpFQkL10XfAyuF51A (big blind) folded on the Flop
Seat 9: 5JJVDlaiMnB004o/RqbZZQ folded before Flop (didn't bet)



PokerStars Game #59939203816:  Hold'em No Limit ($0.25/$0.50) - 2009/07/01 0:33:55 ET
Table 'tyR5AZNKV8Aadbrnrnlg7g' 6-max Seat #4 is the button
Seat 1: R+KjpH/wSjDLhtIy9+edNA ($81 in chips)
Seat 2: 58zdeSBSuSFX/qZfhc7YmA ($38.80 in chips)
Seat 3: tdOvWynovql5imfooroLMg ($48 in chips)
Seat 4: Rt6KgtZ8YaJoTc3FPim00w ($83.20 in chips)
Seat 6: ZKazl1hGaPiapDXincgi2Q ($21.70 in chips)
ZKazl1hGaPiapDXincgi2Q: posts small blind $0.25
R+KjpH/wSjDLhtIy9+edNA: posts big blind $0.50
*** HOLE CARDS ***
58zdeSBSuSFX/qZfhc7YmA: folds
58zdeSBSuSFX/qZfhc7YmA leaves the table
tdOvWynovql5imfooroLMg: folds
Rt6KgtZ8YaJoTc3FPim00w: folds
ZKazl1hGaPiapDXincgi2Q: calls $0.25
R+KjpH/wSjDLhtIy9+edNA: raises $1.50 to $2
ZKazl1hGaPiapDXincgi2Q: calls $1.50
*** FLOP *** [5c 4d 9h]
ZKazl1hGaPiapDXincgi2Q: checks
R+KjpH/wSjDLhtIy9+edNA: bets $2
ZKazl1hGaPiapDXincgi2Q: calls $2
*** TURN *** [5c 4d 9h] [Kh]
BAjwVL+zKKd0s0fAWstzQQ joins the table at seat #2
ZKazl1hGaPiapDXincgi2Q: checks
R+KjpH/wSjDLhtIy9+edNA: checks
*** RIVER *** [5c 4d 9h Kh] [Ks]
ZKazl1hGaPiapDXincgi2Q: checks
R+KjpH/wSjDLhtIy9+edNA: bets $4
ZKazl1hGaPiapDXincgi2Q: folds
R+KjpH/wSjDLhtIy9+edNA collected $7.65 from pot
R+KjpH/wSjDLhtIy9+edNA: doesn't show hand
*** SUMMARY ***
Total pot $8 | Rake $0.35
Board [5c 4d 9h Kh Ks]
Seat 1: R+KjpH/wSjDLhtIy9+edNA (big blind) collected ($7.65)
Seat 2: 58zdeSBSuSFX/qZfhc7YmA folded before Flop (didn't bet)
Seat 3: tdOvWynovql5imfooroLMg folded before Flop (didn't bet)
Seat 4: Rt6KgtZ8YaJoTc3FPim00w (button) folded before Flop (didn't bet)
Seat 6: ZKazl1hGaPiapDXincgi2Q (small blind) folded on the River



PokerStars Game #59939203862:  Hold'em No Limit ($0.25/$0.50) - 2009/07/01 0:33:55 ET
Table '+dXkOAQyS8j9PQZusUTMpg' 2-max Seat #1 is the button
Seat 1: XFa6sBGjP2gxoIvxR3fZIg ($80 in chips)
Seat 2: 5IBeOgaApY1Bvzv2P8X4EA ($62.65 in chips)
XFa6sBGjP2gxoIvxR3fZIg: posts small blind $0.25
5IBeOgaApY1Bvzv2P8X4EA: posts big blind $0.50
*** HOLE CARDS ***
XFa6sBGjP2gxoIvxR3fZIg: raises $1 to $1.50
5IBeOgaApY1Bvzv2P8X4EA: folds
XFa6sBGjP2gxoIvxR3fZIg collected $1 from pot
*** SUMMARY ***
Total pot $1 | Rake $0
Seat 1: XFa6sBGjP2gxoIvxR3fZIg (button) (small blind) collected ($1)
Seat 2: 5IBeOgaApY1Bvzv2P8X4EA (big blind) folded before Flop



PokerStars Game #59939204742:  Hold'em No Limit ($0.25/$0.50) - 2009/07/01 0:33:56 ET
Table 'hWT2kq66tnKEpD26cia6fQ' 2-max Seat #2 is the button
Seat 1: ZGkLiY2Qq6oVQktNWqoLVg ($16.45 in chips)
Seat 2: dkC7J+qbyqk0qCcmJbEPPw ($47.50 in chips)
dkC7J+qbyqk0qCcmJbEPPw: posts small blind $0.25
ZGkLiY2Qq6oVQktNWqoLVg: posts big blind $0.50
*** HOLE CARDS ***
dkC7J+qbyqk0qCcmJbEPPw: folds
ZGkLiY2Qq6oVQktNWqoLVg collected $0.50 from pot
ZGkLiY2Qq6oVQktNWqoLVg: doesn't show hand
*** SUMMARY ***
Total pot $0.50 | Rake $0
Seat 1: ZGkLiY2Qq6oVQktNWqoLVg (big blind) collected ($0.50)
Seat 2: dkC7J+qbyqk0qCcmJbEPPw (button) (small blind) folded before Flop



PokerStars Game #59939204964:  Hold'em No Limit ($0.25/$0.50) - 2009/07/01 0:33:57 ET
Table 'E7bWJ45aoFXRpyRv2gw+Ig' 2-max Seat #2 is the button
Seat 1: FRkiRasEGlHUeLrEl+k/nA ($51.85 in chips)
Seat 2: 3Wro85I7472vJ4Wkpneo9A ($144.15 in chips)
3Wro85I7472vJ4Wkpneo9A: posts small blind $0.25
FRkiRasEGlHUeLrEl+k/nA: posts big blind $0.50
*** HOLE CARDS ***
3Wro85I7472vJ4Wkpneo9A: calls $0.25
FRkiRasEGlHUeLrEl+k/nA: raises $1.50 to $2
3Wro85I7472vJ4Wkpneo9A: folds
FRkiRasEGlHUeLrEl+k/nA collected $1 from pot
FRkiRasEGlHUeLrEl+k/nA: doesn't show hand
*** SUMMARY ***
Total pot $1 | Rake $0
Seat 1: FRkiRasEGlHUeLrEl+k/nA (big blind) collected ($1)
Seat 2: 3Wro85I7472vJ4Wkpneo9A (button) (small blind) folded before Flop



PokerStars Game #59939208820:  Hold'em No Limit ($0.25/$0.50) - 2009/07/01 0:34:02 ET
Table 'hWT2kq66tnKEpD26cia6fQ' 2-max Seat #1 is the button
Seat 1: ZGkLiY2Qq6oVQktNWqoLVg ($16.70 in chips)
Seat 2: dkC7J+qbyqk0qCcmJbEPPw ($47.25 in chips)
ZGkLiY2Qq6oVQktNWqoLVg: posts small blind $0.25
dkC7J+qbyqk0qCcmJbEPPw: posts big blind $0.50
*** HOLE CARDS ***
ZGkLiY2Qq6oVQktNWqoLVg: folds
dkC7J+qbyqk0qCcmJbEPPw collected $0.50 from pot
*** SUMMARY ***
Total pot $0.50 | Rake $0
Seat 1: ZGkLiY2Qq6oVQktNWqoLVg (button) (small blind) folded before Flop
Seat 2: dkC7J+qbyqk0qCcmJbEPPw (big blind) collected ($0.50)



PokerStars Game #59939208580:  Hold'em No Limit ($0.25/$0.50) - 2009/07/01 0:34:02 ET
Table '+dXkOAQyS8j9PQZusUTMpg' 2-max Seat #2 is the button
Seat 1: XFa6sBGjP2gxoIvxR3fZIg ($80.50 in chips)
Seat 2: 5IBeOgaApY1Bvzv2P8X4EA ($62.15 in chips)
5IBeOgaApY1Bvzv2P8X4EA: posts small blind $0.25
XFa6sBGjP2gxoIvxR3fZIg: posts big blind $0.50
*** HOLE CARDS ***
5IBeOgaApY1Bvzv2P8X4EA: calls $0.25
XFa6sBGjP2gxoIvxR3fZIg: checks
*** FLOP *** [2s 9d Kc]
XFa6sBGjP2gxoIvxR3fZIg: checks
5IBeOgaApY1Bvzv2P8X4EA: checks
*** TURN *** [2s 9d Kc] [Ac]
XFa6sBGjP2gxoIvxR3fZIg: checks
5IBeOgaApY1Bvzv2P8X4EA: checks
*** RIVER *** [2s 9d Kc Ac] [8h]
XFa6sBGjP2gxoIvxR3fZIg: checks
5IBeOgaApY1Bvzv2P8X4EA: checks
*** SHOW DOWN ***
XFa6sBGjP2gxoIvxR3fZIg: shows [5d 3s] (high card Ace)
5IBeOgaApY1Bvzv2P8X4EA: shows [Ts 8s] (a pair of Eights)
5IBeOgaApY1Bvzv2P8X4EA collected $0.95 from pot
*** SUMMARY ***
Total pot $1 | Rake $0.05
Board [2s 9d Kc Ac 8h]
Seat 1: XFa6sBGjP2gxoIvxR3fZIg (big blind) showed [5d 3s] and lost with high card Ace
Seat 2: 5IBeOgaApY1Bvzv2P8X4EA (button) (small blind) showed [Ts 8s] and won ($0.95) with a pair of Eights



PokerStars Game #59939211492:  Hold'em No Limit ($0.25/$0.50) - 2009/07/01 0:34:06 ET
Table '3FhG0gl3kMX3wBEEqj+wnQ' 9-max Seat #7 is the button
Seat 1: e0J9pdCNUDTCG031RnXqLA ($17 in chips)
Seat 3: HZkVla4kK2SI42CVrPZ/ig ($8.75 in chips)
Seat 5: XNMDwbXt/Q4jM99AXnbJDw ($50.75 in chips)
Seat 6: 5JJVDlaiMnB004o/RqbZZQ ($45.80 in chips)
Seat 7: mSD1pginDsyHG5PDfqzphw ($10 in chips)
Seat 8: j3K/Jujr7PY4ZM2RZvlH6A ($62.05 in chips)
Seat 9: L5e2lrPLQm1Pqx30IIZ/Fw ($10.85 in chips)
j3K/Jujr7PY4ZM2RZvlH6A: posts small blind $0.25
L5e2lrPLQm1Pqx30IIZ/Fw: posts big blind $0.50
7cYQ+syUWjl38ty/ICOMhw: sits out
*** HOLE CARDS ***
e0J9pdCNUDTCG031RnXqLA: raises $1.50 to $2
bjvJtA9Hqscfznq66txaOQ joins the table at seat #4
HZkVla4kK2SI42CVrPZ/ig: folds
XNMDwbXt/Q4jM99AXnbJDw: folds
5JJVDlaiMnB004o/RqbZZQ: folds
mSD1pginDsyHG5PDfqzphw: folds
j3K/Jujr7PY4ZM2RZvlH6A: folds
L5e2lrPLQm1Pqx30IIZ/Fw: folds
e0J9pdCNUDTCG031RnXqLA collected $1.25 from pot
e0J9pdCNUDTCG031RnXqLA: doesn't show hand
*** SUMMARY ***
Total pot $1.25 | Rake $0
Seat 1: e0J9pdCNUDTCG031RnXqLA collected ($1.25)
Seat 3: HZkVla4kK2SI42CVrPZ/ig folded before Flop (didn't bet)
Seat 5: XNMDwbXt/Q4jM99AXnbJDw folded before Flop (didn't bet)
Seat 6: 5JJVDlaiMnB004o/RqbZZQ folded before Flop (didn't bet)
Seat 7: mSD1pginDsyHG5PDfqzphw (button) folded before Flop (didn't bet)
Seat 8: j3K/Jujr7PY4ZM2RZvlH6A (small blind) folded before Flop
Seat 9: L5e2lrPLQm1Pqx30IIZ/Fw (big blind) folded before Flop



PokerStars Game #59939211628:  Hold'em No Limit ($0.25/$0.50) - 2009/07/01 0:34:07 ET
Table 'E7bWJ45aoFXRpyRv2gw+Ig' 2-max Seat #1 is the button
Seat 1: FRkiRasEGlHUeLrEl+k/nA ($52.35 in chips)
Seat 2: 3Wro85I7472vJ4Wkpneo9A ($143.65 in chips)
FRkiRasEGlHUeLrEl+k/nA: posts small blind $0.25
3Wro85I7472vJ4Wkpneo9A: posts big blind $0.50
*** HOLE CARDS ***
FRkiRasEGlHUeLrEl+k/nA: folds
3Wro85I7472vJ4Wkpneo9A collected $0.50 from pot
3Wro85I7472vJ4Wkpneo9A: doesn't show hand
*** SUMMARY ***
Total pot $0.50 | Rake $0
Seat 1: FRkiRasEGlHUeLrEl+k/nA (button) (small blind) folded before Flop
Seat 2: 3Wro85I7472vJ4Wkpneo9A (big blind) collected ($0.50)



PokerStars Game #59939212190:  Hold'em No Limit ($0.25/$0.50) - 2009/07/01 0:34:08 ET
Table 'mTxf8gPLgffN3Iwfm7Icfg' 2-max Seat #2 is the button
Seat 1: Do9Rlu1R5u/AcRtMTl8SYg ($74.95 in chips)
Seat 2: EMc5LPgVaded4Qc77vm0fw ($83.35 in chips)
EMc5LPgVaded4Qc77vm0fw: posts small blind $0.25
Do9Rlu1R5u/AcRtMTl8SYg: posts big blind $0.50
*** HOLE CARDS ***
EMc5LPgVaded4Qc77vm0fw: folds
Do9Rlu1R5u/AcRtMTl8SYg collected $0.50 from pot
Do9Rlu1R5u/AcRtMTl8SYg: doesn't show hand
*** SUMMARY ***
Total pot $0.50 | Rake $0
Seat 1: Do9Rlu1R5u/AcRtMTl8SYg (big blind) collected ($0.50)
Seat 2: EMc5LPgVaded4Qc77vm0fw (button) (small blind) folded before Flop



PokerStars Game #59939212704:  Hold'em No Limit ($0.25/$0.50) - 2009/07/01 0:34:08 ET
Table 'hWT2kq66tnKEpD26cia6fQ' 2-max Seat #2 is the button
Seat 1: ZGkLiY2Qq6oVQktNWqoLVg ($16.45 in chips)
Seat 2: dkC7J+qbyqk0qCcmJbEPPw ($47.50 in chips)
dkC7J+qbyqk0qCcmJbEPPw: posts small blind $0.25
ZGkLiY2Qq6oVQktNWqoLVg: posts big blind $0.50
*** HOLE CARDS ***
dkC7J+qbyqk0qCcmJbEPPw: folds
ZGkLiY2Qq6oVQktNWqoLVg collected $0.50 from pot
*** SUMMARY ***
Total pot $0.50 | Rake $0
Seat 1: ZGkLiY2Qq6oVQktNWqoLVg (big blind) collected ($0.50)
Seat 2: dkC7J+qbyqk0qCcmJbEPPw (button) (small blind) folded before Flop



PokerStars Game #59939213538:  Hold'em No Limit ($0.25/$0.50) - 2009/07/01 0:34:09 ET
Table 'NCiXr0d5CEKBQr/cZgLhbA' 9-max Seat #5 is the button
Seat 2: ulxuJchBV9iguXg0FUonfg ($25.80 in chips)
Seat 3: xZCXQSXlrZkp3pZizzVXCw ($54.90 in chips)
Seat 4: 5k9fvXD9suIgCxU4HLQjTw ($59.20 in chips)
Seat 5: zE9cVigS2nW/Ljy4K4bUQA ($39.95 in chips)
Seat 6: SKnJuWHScqetA/qG5p+wCg ($34.25 in chips)
Seat 7: M+7+BTmX5vZatHVuoRB1nA ($46.50 in chips)
Seat 8: 1MJUKc3cc0QmUoz1JZLR2w ($53.55 in chips)
Seat 9: 4WLZvqBn5qv5tds5kt5A1Q ($28.75 in chips)
SKnJuWHScqetA/qG5p+wCg: posts small blind $0.25
M+7+BTmX5vZatHVuoRB1nA: posts big blind $0.50
pFtzb1sR4b0d1aw6aIRgDg: sits out
*** HOLE CARDS ***
1MJUKc3cc0QmUoz1JZLR2w: folds
4WLZvqBn5qv5tds5kt5A1Q: calls $0.50
ulxuJchBV9iguXg0FUonfg: folds
xZCXQSXlrZkp3pZizzVXCw: raises $2 to $2.50
5k9fvXD9suIgCxU4HLQjTw: folds
zE9cVigS2nW/Ljy4K4bUQA: folds
SKnJuWHScqetA/qG5p+wCg: folds
M+7+BTmX5vZatHVuoRB1nA: calls $2
4WLZvqBn5qv5tds5kt5A1Q: calls $2
*** FLOP *** [6s 5h 3s]
M+7+BTmX5vZatHVuoRB1nA: checks
4WLZvqBn5qv5tds5kt5A1Q: checks
xZCXQSXlrZkp3pZizzVXCw: bets $5.50
M+7+BTmX5vZatHVuoRB1nA: folds
4WLZvqBn5qv5tds5kt5A1Q: calls $5.50
*** TURN *** [6s 5h 3s] [Kd]
4WLZvqBn5qv5tds5kt5A1Q: checks
xZCXQSXlrZkp3pZizzVXCw: bets $11
4WLZvqBn5qv5tds5kt5A1Q: calls $11
*** RIVER *** [6s 5h 3s Kd] [9s]
4WLZvqBn5qv5tds5kt5A1Q: checks
xZCXQSXlrZkp3pZizzVXCw: checks
*** SHOW DOWN ***
4WLZvqBn5qv5tds5kt5A1Q: shows [7s 8s] (a flush, Nine high)
xZCXQSXlrZkp3pZizzVXCw: mucks hand
4WLZvqBn5qv5tds5kt5A1Q collected $38.80 from pot
*** SUMMARY ***
Total pot $40.75 | Rake $1.95
Board [6s 5h 3s Kd 9s]
Seat 2: ulxuJchBV9iguXg0FUonfg folded before Flop (didn't bet)
Seat 3: xZCXQSXlrZkp3pZizzVXCw mucked
Seat 4: 5k9fvXD9suIgCxU4HLQjTw folded before Flop (didn't bet)
Seat 5: zE9cVigS2nW/Ljy4K4bUQA (button) folded before Flop (didn't bet)
Seat 6: SKnJuWHScqetA/qG5p+wCg (small blind) folded before Flop
Seat 7: M+7+BTmX5vZatHVuoRB1nA (big blind) folded on the Flop
Seat 8: 1MJUKc3cc0QmUoz1JZLR2w folded before Flop (didn't bet)
Seat 9: 4WLZvqBn5qv5tds5kt5A1Q showed [7s 8s] and won ($38.80) with a flush, Nine high



PokerStars Game #59939213670:  Hold'em No Limit ($0.25/$0.50) - 2009/07/01 0:34:10 ET
Table 'fx6MqwfYAj/Rt86hBz2L3Q' 9-max Seat #1 is the button
Seat 1: jf2c/o9gI7Xj0GleCSMj9g ($50 in chips)
Seat 2: C3rGXblctNcWI6JYPHhaEg ($22 in chips)
Seat 3: iadBi5AEt7gTBXbDSSnMYQ ($55.75 in chips)
Seat 4: gPEN9Zp33YTm/mu9/SYP1w ($22.70 in chips)
Seat 5: iAISe3dVeua8PUn2wwgDHw ($30 in chips)
Seat 6: 5k9fvXD9suIgCxU4HLQjTw ($50 in chips)
Seat 7: bkXkL3pmapikPQQRNPZSEA ($24.50 in chips)
Seat 8: CAuekkxPVzBL9SK4Tjjbuw ($29 in chips)
Seat 9: HZkVla4kK2SI42CVrPZ/ig ($8.50 in chips)
C3rGXblctNcWI6JYPHhaEg: posts small blind $0.25
iadBi5AEt7gTBXbDSSnMYQ: posts big blind $0.50
*** HOLE CARDS ***
gPEN9Zp33YTm/mu9/SYP1w: folds
iAISe3dVeua8PUn2wwgDHw: raises $0.50 to $1
5k9fvXD9suIgCxU4HLQjTw: folds
bkXkL3pmapikPQQRNPZSEA: folds
CAuekkxPVzBL9SK4Tjjbuw: folds
HZkVla4kK2SI42CVrPZ/ig: folds
jf2c/o9gI7Xj0GleCSMj9g has timed out while being disconnected
jf2c/o9gI7Xj0GleCSMj9g: folds
jf2c/o9gI7Xj0GleCSMj9g is sitting out
C3rGXblctNcWI6JYPHhaEg: calls $0.75
iadBi5AEt7gTBXbDSSnMYQ: calls $0.50
*** FLOP *** [4h 7s Ks]
jf2c/o9gI7Xj0GleCSMj9g is disconnected
C3rGXblctNcWI6JYPHhaEg: checks
jf2c/o9gI7Xj0GleCSMj9g is connected
iadBi5AEt7gTBXbDSSnMYQ: bets $2
iAISe3dVeua8PUn2wwgDHw: calls $2
C3rGXblctNcWI6JYPHhaEg: folds
*** TURN *** [4h 7s Ks] [9d]
iadBi5AEt7gTBXbDSSnMYQ: bets $3.50
jf2c/o9gI7Xj0GleCSMj9g leaves the table
iAISe3dVeua8PUn2wwgDHw: raises $3.50 to $7
pmyrdhen joins the table at seat #1
iadBi5AEt7gTBXbDSSnMYQ: raises $4 to $11
iAISe3dVeua8PUn2wwgDHw: raises $4 to $15
iadBi5AEt7gTBXbDSSnMYQ: folds
iAISe3dVeua8PUn2wwgDHw collected $27.60 from pot
*** SUMMARY ***
Total pot $29 | Rake $1.40
Board [4h 7s Ks 9d]
Seat 1: jf2c/o9gI7Xj0GleCSMj9g (button) folded before Flop (didn't bet)
Seat 2: C3rGXblctNcWI6JYPHhaEg (small blind) folded on the Flop
Seat 3: iadBi5AEt7gTBXbDSSnMYQ (big blind) folded on the Turn
Seat 4: gPEN9Zp33YTm/mu9/SYP1w folded before Flop (didn't bet)
Seat 5: iAISe3dVeua8PUn2wwgDHw collected ($27.60)
Seat 6: 5k9fvXD9suIgCxU4HLQjTw folded before Flop (didn't bet)
Seat 7: bkXkL3pmapikPQQRNPZSEA folded before Flop (didn't bet)
Seat 8: CAuekkxPVzBL9SK4Tjjbuw folded before Flop (didn't bet)
Seat 9: HZkVla4kK2SI42CVrPZ/ig folded before Flop (didn't bet)



PokerStars Game #59939214744:  Hold'em No Limit ($0.25/$0.50) - 2009/07/01 0:34:11 ET
Table 'otvGDROEDdqsabxskT79qg' 9-max Seat #9 is the button
Seat 1: 8ehL7qlZzjgUh2H35iiWLw ($55.50 in chips)
Seat 2: cCjTzH9jio8607WzjcfXlg ($9.50 in chips)
Seat 3: +k7T5ocke8UwavtgUHm+Cg ($74.65 in chips)
Seat 4: MG90wfSJZnOejs/KD3vlQQ ($56.15 in chips)
Seat 5: XNMDwbXt/Q4jM99AXnbJDw ($55.55 in chips)
Seat 6: bxLSulbgr8LmKNjOzw8URg ($49.25 in chips)
Seat 7: C7+tBppJrKgd/r+tuKUIpA ($34.15 in chips)
Seat 8: zE9cVigS2nW/Ljy4K4bUQA ($30 in chips)
Seat 9: KcY3X8YpD74Kw1RHkx/g4A ($66.50 in chips)
8ehL7qlZzjgUh2H35iiWLw: posts small blind $0.25
cCjTzH9jio8607WzjcfXlg: posts big blind $0.50
*** HOLE CARDS ***
+k7T5ocke8UwavtgUHm+Cg: folds
MG90wfSJZnOejs/KD3vlQQ: folds
XNMDwbXt/Q4jM99AXnbJDw: folds
bxLSulbgr8LmKNjOzw8URg: folds
C7+tBppJrKgd/r+tuKUIpA: folds
zE9cVigS2nW/Ljy4K4bUQA: folds
KcY3X8YpD74Kw1RHkx/g4A: folds
8ehL7qlZzjgUh2H35iiWLw: raises $1.50 to $2
cCjTzH9jio8607WzjcfXlg: folds
8ehL7qlZzjgUh2H35iiWLw collected $1 from pot
8ehL7qlZzjgUh2H35iiWLw: doesn't show hand
*** SUMMARY ***
Total pot $1 | Rake $0
Seat 1: 8ehL7qlZzjgUh2H35iiWLw (small blind) collected ($1)
Seat 2: cCjTzH9jio8607WzjcfXlg (big blind) folded before Flop
Seat 3: +k7T5ocke8UwavtgUHm+Cg folded before Flop (didn't bet)
Seat 4: MG90wfSJZnOejs/KD3vlQQ folded before Flop (didn't bet)
Seat 5: XNMDwbXt/Q4jM99AXnbJDw folded before Flop (didn't bet)
Seat 6: bxLSulbgr8LmKNjOzw8URg folded before Flop (didn't bet)
Seat 7: C7+tBppJrKgd/r+tuKUIpA folded before Flop (didn't bet)
Seat 8: zE9cVigS2nW/Ljy4K4bUQA folded before Flop (didn't bet)
Seat 9: KcY3X8YpD74Kw1RHkx/g4A (button) folded before Flop (didn't bet)



PokerStars Game #59939214470:  Hold'em No Limit ($0.25/$0.50) - 2009/07/01 0:34:11 ET
Table 'kgbJRsxfv64KrErDRBAkcw' 6-max Seat #4 is the button
Seat 1: mxTUARCsU8Eby0whmHNcOw ($7.50 in chips)
Seat 2: Q+thC23WCv1kJUJtH/+4Jw ($58.80 in chips)
Seat 3: T0Gx/FcQ5VH9u7XaOMX97A ($82.10 in chips)
Seat 4: qanMEqjABjWxC/JgQ/0l7w ($56.95 in chips)
Seat 5: +Pf9jTVizYlIo+woPvptfA ($51.80 in chips)
Seat 6: ozrlafxxh1HmYdA0/h+MuA ($13.90 in chips)
+Pf9jTVizYlIo+woPvptfA: posts small blind $0.25
ozrlafxxh1HmYdA0/h+MuA: posts big blind $0.50
*** HOLE CARDS ***
mxTUARCsU8Eby0whmHNcOw: folds
Q+thC23WCv1kJUJtH/+4Jw: folds
T0Gx/FcQ5VH9u7XaOMX97A: folds
qanMEqjABjWxC/JgQ/0l7w: folds
+Pf9jTVizYlIo+woPvptfA: folds
ozrlafxxh1HmYdA0/h+MuA collected $0.50 from pot
*** SUMMARY ***
Total pot $0.50 | Rake $0
Seat 1: mxTUARCsU8Eby0whmHNcOw folded before Flop (didn't bet)
Seat 2: Q+thC23WCv1kJUJtH/+4Jw folded before Flop (didn't bet)
Seat 3: T0Gx/FcQ5VH9u7XaOMX97A folded before Flop (didn't bet)
Seat 4: qanMEqjABjWxC/JgQ/0l7w (button) folded before Flop (didn't bet)
Seat 5: +Pf9jTVizYlIo+woPvptfA (small blind) folded before Flop
Seat 6: ozrlafxxh1HmYdA0/h+MuA (big blind) collected ($0.50)



PokerStars Game #59939216024:  Hold'em No Limit ($0.25/$0.50) - 2009/07/01 0:34:13 ET
Table 'E7bWJ45aoFXRpyRv2gw+Ig' 2-max Seat #2 is the button
Seat 1: FRkiRasEGlHUeLrEl+k/nA ($52.10 in chips)
Seat 2: 3Wro85I7472vJ4Wkpneo9A ($143.90 in chips)
3Wro85I7472vJ4Wkpneo9A: posts small blind $0.25
FRkiRasEGlHUeLrEl+k/nA: posts big blind $0.50
*** HOLE CARDS ***
3Wro85I7472vJ4Wkpneo9A: calls $0.25
FRkiRasEGlHUeLrEl+k/nA: raises $1.50 to $2
3Wro85I7472vJ4Wkpneo9A: calls $1.50
*** FLOP *** [3h Kd Tc]
FRkiRasEGlHUeLrEl+k/nA: checks
3Wro85I7472vJ4Wkpneo9A: checks
*** TURN *** [3h Kd Tc] [5h]
FRkiRasEGlHUeLrEl+k/nA: bets $1
3Wro85I7472vJ4Wkpneo9A: calls $1
*** RIVER *** [3h Kd Tc 5h] [4d]
FRkiRasEGlHUeLrEl+k/nA: bets $2
3Wro85I7472vJ4Wkpneo9A: calls $2
*** SHOW DOWN ***
FRkiRasEGlHUeLrEl+k/nA: shows [Js Ac] (high card Ace)
3Wro85I7472vJ4Wkpneo9A: mucks hand
FRkiRasEGlHUeLrEl+k/nA collected $9.55 from pot
*** SUMMARY ***
Total pot $10 | Rake $0.45
Board [3h Kd Tc 5h 4d]
Seat 1: FRkiRasEGlHUeLrEl+k/nA (big blind) showed [Js Ac] and won ($9.55) with high card Ace
Seat 2: 3Wro85I7472vJ4Wkpneo9A (button) (small blind) mucked



PokerStars Game #59939216314:  Hold'em No Limit ($0.25/$0.50) - 2009/07/01 0:34:13 ET
Table 'mTxf8gPLgffN3Iwfm7Icfg' 2-max Seat #1 is the button
Seat 1: Do9Rlu1R5u/AcRtMTl8SYg ($75.20 in chips)
Seat 2: EMc5LPgVaded4Qc77vm0fw ($83.10 in chips)
Do9Rlu1R5u/AcRtMTl8SYg: posts small blind $0.25
EMc5LPgVaded4Qc77vm0fw: posts big blind $0.50
*** HOLE CARDS ***
Do9Rlu1R5u/AcRtMTl8SYg: raises $1 to $1.50
EMc5LPgVaded4Qc77vm0fw: folds
Do9Rlu1R5u/AcRtMTl8SYg collected $1 from pot
Do9Rlu1R5u/AcRtMTl8SYg: doesn't show hand
*** SUMMARY ***
Total pot $1 | Rake $0
Seat 1: Do9Rlu1R5u/AcRtMTl8SYg (button) (small blind) collected ($1)
Seat 2: EMc5LPgVaded4Qc77vm0fw (big blind) folded before Flop



PokerStars Game #59939218508:  Hold'em No Limit ($0.25/$0.50) - 2009/07/01 0:34:17 ET
Table 'hWT2kq66tnKEpD26cia6fQ' 2-max Seat #1 is the button
Seat 1: ZGkLiY2Qq6oVQktNWqoLVg ($16.70 in chips)
Seat 2: dkC7J+qbyqk0qCcmJbEPPw ($47.25 in chips)
ZGkLiY2Qq6oVQktNWqoLVg: posts small blind $0.25
dkC7J+qbyqk0qCcmJbEPPw: posts big blind $0.50
*** HOLE CARDS ***
ZGkLiY2Qq6oVQktNWqoLVg: folds
dkC7J+qbyqk0qCcmJbEPPw collected $0.50 from pot
*** SUMMARY ***
Total pot $0.50 | Rake $0
Seat 1: ZGkLiY2Qq6oVQktNWqoLVg (button) (small blind) folded before Flop
Seat 2: dkC7J+qbyqk0qCcmJbEPPw (big blind) collected ($0.50)



PokerStars Game #59939219128:  Hold'em No Limit ($0.25/$0.50) - 2009/07/01 0:34:18 ET
Table '/cQuAT3ef4t+PGrXiNhGaQ' 9-max Seat #1 is the button
Seat 1: HZkVla4kK2SI42CVrPZ/ig ($9.25 in chips)
Seat 2: jXGruyaMqirTaTXNOvBdew ($70.90 in chips)
Seat 3: g4k0NXISyLCqaSWZDBjfEg ($53.90 in chips)
Seat 4: OWP/DOu+PlPK6ZZ3zYa0HA ($41.65 in chips)
Seat 5: 5SgaHdWixdClWvaEG+KUjQ ($20.95 in chips)
Seat 6: APYIOyK/4AGb+kIwlOUNBQ ($43.75 in chips)
Seat 7: J0W5D97jl5VLky+IoPvDeA ($114.90 in chips)
Seat 8: W3ingbA178eb7J5rt1PuIQ ($27.10 in chips)
jXGruyaMqirTaTXNOvBdew: posts small blind $0.25
g4k0NXISyLCqaSWZDBjfEg: posts big blind $0.50
*** HOLE CARDS ***
OWP/DOu+PlPK6ZZ3zYa0HA: folds
E2518gp4aFz1+kAgmGqeEg leaves the table
5SgaHdWixdClWvaEG+KUjQ: folds
APYIOyK/4AGb+kIwlOUNBQ: folds
J0W5D97jl5VLky+IoPvDeA: folds
W3ingbA178eb7J5rt1PuIQ: folds
HZkVla4kK2SI42CVrPZ/ig: folds
jXGruyaMqirTaTXNOvBdew: folds
g4k0NXISyLCqaSWZDBjfEg collected $0.50 from pot
*** SUMMARY ***
Total pot $0.50 | Rake $0
Seat 1: HZkVla4kK2SI42CVrPZ/ig (button) folded before Flop (didn't bet)
Seat 2: jXGruyaMqirTaTXNOvBdew (small blind) folded before Flop
Seat 3: g4k0NXISyLCqaSWZDBjfEg (big blind) collected ($0.50)
Seat 4: OWP/DOu+PlPK6ZZ3zYa0HA folded before Flop (didn't bet)
Seat 5: 5SgaHdWixdClWvaEG+KUjQ folded before Flop (didn't bet)
Seat 6: APYIOyK/4AGb+kIwlOUNBQ folded before Flop (didn't bet)
Seat 7: J0W5D97jl5VLky+IoPvDeA folded before Flop (didn't bet)
Seat 8: W3ingbA178eb7J5rt1PuIQ folded before Flop (didn't bet)



PokerStars Game #59939220134:  Hold'em No Limit ($0.25/$0.50) - 2009/07/01 0:34:19 ET
Table 'IeNZOZQ4T6oiaHqFeo6yIA' 2-max Seat #1 is the button
Seat 1: ndd1nfncBkWNitBnsfCoVQ ($81.05 in chips)
Seat 2: A91IUl5JaZROhtfCtnnwYw ($48.25 in chips)
ndd1nfncBkWNitBnsfCoVQ: posts small blind $0.25
A91IUl5JaZROhtfCtnnwYw: posts big blind $0.50
*** HOLE CARDS ***
ndd1nfncBkWNitBnsfCoVQ: raises $1 to $1.50
A91IUl5JaZROhtfCtnnwYw: calls $1
*** FLOP *** [Tc 8h 6c]
A91IUl5JaZROhtfCtnnwYw: checks
ndd1nfncBkWNitBnsfCoVQ: bets $3
A91IUl5JaZROhtfCtnnwYw: calls $3
*** TURN *** [Tc 8h 6c] [9d]
A91IUl5JaZROhtfCtnnwYw: checks
ndd1nfncBkWNitBnsfCoVQ: bets $6
A91IUl5JaZROhtfCtnnwYw: raises $6 to $12
ndd1nfncBkWNitBnsfCoVQ: folds
A91IUl5JaZROhtfCtnnwYw collected $20.50 from pot
*** SUMMARY ***
Total pot $21 | Rake $0.50
Board [Tc 8h 6c 9d]
Seat 1: ndd1nfncBkWNitBnsfCoVQ (button) (small blind) folded on the Turn
Seat 2: A91IUl5JaZROhtfCtnnwYw (big blind) collected ($20.50)



PokerStars Game #59939220984:  Hold'em No Limit ($0.25/$0.50) - 2009/07/01 0:34:21 ET
Table '+dXkOAQyS8j9PQZusUTMpg' 2-max Seat #1 is the button
Seat 1: XFa6sBGjP2gxoIvxR3fZIg ($80 in chips)
Seat 2: 5IBeOgaApY1Bvzv2P8X4EA ($62.60 in chips)
XFa6sBGjP2gxoIvxR3fZIg: posts small blind $0.25
5IBeOgaApY1Bvzv2P8X4EA: posts big blind $0.50
*** HOLE CARDS ***
XFa6sBGjP2gxoIvxR3fZIg: raises $1 to $1.50
5IBeOgaApY1Bvzv2P8X4EA: calls $1
*** FLOP *** [Ts 5d Kh]
5IBeOgaApY1Bvzv2P8X4EA: checks
XFa6sBGjP2gxoIvxR3fZIg: bets $2
5IBeOgaApY1Bvzv2P8X4EA: calls $2
*** TURN *** [Ts 5d Kh] [Jc]
5IBeOgaApY1Bvzv2P8X4EA: checks
XFa6sBGjP2gxoIvxR3fZIg: bets $4
5IBeOgaApY1Bvzv2P8X4EA: raises $5 to $9
XFa6sBGjP2gxoIvxR3fZIg: calls $5
*** RIVER *** [Ts 5d Kh Jc] [5h]
5IBeOgaApY1Bvzv2P8X4EA: checks
XFa6sBGjP2gxoIvxR3fZIg: checks
*** SHOW DOWN ***
5IBeOgaApY1Bvzv2P8X4EA: shows [Qc 9h] (a straight, Nine to King)
XFa6sBGjP2gxoIvxR3fZIg: mucks hand
5IBeOgaApY1Bvzv2P8X4EA collected $24.50 from pot
*** SUMMARY ***
Total pot $25 | Rake $0.50
Board [Ts 5d Kh Jc 5h]
Seat 1: XFa6sBGjP2gxoIvxR3fZIg (button) (small blind) mucked
Seat 2: 5IBeOgaApY1Bvzv2P8X4EA (big blind) showed [Qc 9h] and won ($24.50) with a straight, Nine to King



PokerStars Game #59939221298:  Hold'em No Limit ($0.25/$0.50) - 2009/07/01 0:34:21 ET
Table 'PALRfuH85dr5IkDfdv6new' 9-max Seat #6 is the button
Seat 1: SKnJuWHScqetA/qG5p+wCg ($30 in chips)
Seat 2: 9r7ZoBbAJj5IeyZ0q9BdzA ($8 in chips)
Seat 3: 50QWoELmpmHFrFIlWMJo9g ($86.70 in chips)
Seat 4: mZNMJI1mY40XTC0U7GZakA ($57.65 in chips)
Seat 5: jSSGUXdNFAZA3QCvTcUMQw ($42.70 in chips)
Seat 6: E2518gp4aFz1+kAgmGqeEg ($14.50 in chips)
Seat 7: 3NcyXvr39gnK+KbTq7ezyA ($36.75 in chips)
Seat 8: NkS+CseUKx4XHszWq0PXEQ ($44.65 in chips)
Seat 9: CIrAX/m6o7jYmKOAjJXv4Q ($38.05 in chips)
3NcyXvr39gnK+KbTq7ezyA: posts small blind $0.25
NkS+CseUKx4XHszWq0PXEQ: posts big blind $0.50
*** HOLE CARDS ***
CIrAX/m6o7jYmKOAjJXv4Q: folds
SKnJuWHScqetA/qG5p+wCg: folds
9r7ZoBbAJj5IeyZ0q9BdzA: folds
50QWoELmpmHFrFIlWMJo9g: folds
mZNMJI1mY40XTC0U7GZakA: folds
jSSGUXdNFAZA3QCvTcUMQw: folds
E2518gp4aFz1+kAgmGqeEg: folds
3NcyXvr39gnK+KbTq7ezyA: calls $0.25
NkS+CseUKx4XHszWq0PXEQ: checks
*** FLOP *** [5c 3h 2c]
3NcyXvr39gnK+KbTq7ezyA: checks
NkS+CseUKx4XHszWq0PXEQ: checks
*** TURN *** [5c 3h 2c] [As]
3NcyXvr39gnK+KbTq7ezyA: checks
NkS+CseUKx4XHszWq0PXEQ: checks
*** RIVER *** [5c 3h 2c As] [Jd]
3NcyXvr39gnK+KbTq7ezyA: checks
NkS+CseUKx4XHszWq0PXEQ: checks
*** SHOW DOWN ***
3NcyXvr39gnK+KbTq7ezyA: shows [Th 9c] (high card Ace)
NkS+CseUKx4XHszWq0PXEQ: mucks hand
3NcyXvr39gnK+KbTq7ezyA collected $0.95 from pot
*** SUMMARY ***
Total pot $1 | Rake $0.05
Board [5c 3h 2c As Jd]
Seat 1: SKnJuWHScqetA/qG5p+wCg folded before Flop (didn't bet)
Seat 2: 9r7ZoBbAJj5IeyZ0q9BdzA folded before Flop (didn't bet)
Seat 3: 50QWoELmpmHFrFIlWMJo9g folded before Flop (didn't bet)
Seat 4: mZNMJI1mY40XTC0U7GZakA folded before Flop (didn't bet)
Seat 5: jSSGUXdNFAZA3QCvTcUMQw folded before Flop (didn't bet)
Seat 6: E2518gp4aFz1+kAgmGqeEg (button) folded before Flop (didn't bet)
Seat 7: 3NcyXvr39gnK+KbTq7ezyA (small blind) showed [Th 9c] and won ($0.95) with high card Ace
Seat 8: NkS+CseUKx4XHszWq0PXEQ (big blind) mucked
Seat 9: CIrAX/m6o7jYmKOAjJXv4Q folded before Flop (didn't bet)



PokerStars Game #59939221608:  Hold'em No Limit ($0.25/$0.50) - 2009/07/01 0:34:21 ET
Table 'QOgaEqMcJ73pcUMMxoisUg' 6-max Seat #1 is the button
Seat 1: OZ6OtYh5Y53MCH/p0QTn5g ($50 in chips)
Seat 3: Rt6KgtZ8YaJoTc3FPim00w ($50 in chips)
Seat 4: zAcsDhG/T128Vn7XGVSgKg ($64.15 in chips)
Seat 5: 6vNxrjjCl6FwfaaymM9jjg ($26.05 in chips)
Seat 6: pmE+2KJb4nffAVqjLIXxFg ($22 in chips)
Rt6KgtZ8YaJoTc3FPim00w: posts small blind $0.25
zAcsDhG/T128Vn7XGVSgKg: posts big blind $0.50
*** HOLE CARDS ***
6vNxrjjCl6FwfaaymM9jjg: folds
Im2p1Nt83UKSqv5c9frm4Q leaves the table
pmE+2KJb4nffAVqjLIXxFg: calls $0.50
4QfsCWthT/vSLirorNXqtg joins the table at seat #2
OZ6OtYh5Y53MCH/p0QTn5g: folds
Rt6KgtZ8YaJoTc3FPim00w: raises $2 to $2.50
zAcsDhG/T128Vn7XGVSgKg: folds
pmE+2KJb4nffAVqjLIXxFg: folds
Rt6KgtZ8YaJoTc3FPim00w collected $1.50 from pot
*** SUMMARY ***
Total pot $1.50 | Rake $0
Seat 1: OZ6OtYh5Y53MCH/p0QTn5g (button) folded before Flop (didn't bet)
Seat 3: Rt6KgtZ8YaJoTc3FPim00w (small blind) collected ($1.50)
Seat 4: zAcsDhG/T128Vn7XGVSgKg (big blind) folded before Flop
Seat 5: 6vNxrjjCl6FwfaaymM9jjg folded before Flop (didn't bet)
Seat 6: pmE+2KJb4nffAVqjLIXxFg folded before Flop



PokerStars Game #59939221708:  Hold'em No Limit ($0.25/$0.50) - 2009/07/01 0:34:22 ET
Table 'mTxf8gPLgffN3Iwfm7Icfg' 2-max Seat #2 is the button
Seat 1: Do9Rlu1R5u/AcRtMTl8SYg ($75.70 in chips)
Seat 2: EMc5LPgVaded4Qc77vm0fw ($82.60 in chips)
EMc5LPgVaded4Qc77vm0fw: posts small blind $0.25
Do9Rlu1R5u/AcRtMTl8SYg: posts big blind $0.50
*** HOLE CARDS ***
EMc5LPgVaded4Qc77vm0fw: folds
Do9Rlu1R5u/AcRtMTl8SYg collected $0.50 from pot
Do9Rlu1R5u/AcRtMTl8SYg: doesn't show hand
*** SUMMARY ***
Total pot $0.50 | Rake $0
Seat 1: Do9Rlu1R5u/AcRtMTl8SYg (big blind) collected ($0.50)
Seat 2: EMc5LPgVaded4Qc77vm0fw (button) (small blind) folded before Flop



PokerStars Game #59939221892:  Hold'em No Limit ($0.25/$0.50) - 2009/07/01 0:34:22 ET
Table 'hSTs/dUsYLgJQuF2Onp0MQ' 6-max Seat #1 is the button
Seat 1: Donj3X7gYzeS5pAl7s9f+Q ($30.90 in chips)
Seat 2: 6vNxrjjCl6FwfaaymM9jjg ($31.85 in chips)
Seat 3: C3qJBo7uxfFVDluE1lmK2w ($30 in chips)
Seat 4: L0aIPg7qefDQjdJo3HCVEA ($8.90 in chips)
Seat 5: 686aeHikcJlgKkSuIFdcXQ ($59.90 in chips)
Seat 6: w0pd++ZQHijd9dDhKEYOAQ ($28.70 in chips)
6vNxrjjCl6FwfaaymM9jjg: posts small blind $0.25
C3qJBo7uxfFVDluE1lmK2w: posts big blind $0.50
w0pd++ZQHijd9dDhKEYOAQ: posts big blind $0.50
*** HOLE CARDS ***
L0aIPg7qefDQjdJo3HCVEA: folds
686aeHikcJlgKkSuIFdcXQ: folds
w0pd++ZQHijd9dDhKEYOAQ: checks
Donj3X7gYzeS5pAl7s9f+Q: calls $0.50
6vNxrjjCl6FwfaaymM9jjg: raises $3 to $3.50
C3qJBo7uxfFVDluE1lmK2w: folds
w0pd++ZQHijd9dDhKEYOAQ: folds
Donj3X7gYzeS5pAl7s9f+Q: folds
6vNxrjjCl6FwfaaymM9jjg collected $2 from pot
*** SUMMARY ***
Total pot $2 | Rake $0
Seat 1: Donj3X7gYzeS5pAl7s9f+Q (button) folded before Flop
Seat 2: 6vNxrjjCl6FwfaaymM9jjg (small blind) collected ($2)
Seat 3: C3qJBo7uxfFVDluE1lmK2w (big blind) folded before Flop
Seat 4: L0aIPg7qefDQjdJo3HCVEA folded before Flop (didn't bet)
Seat 5: 686aeHikcJlgKkSuIFdcXQ folded before Flop (didn't bet)
Seat 6: w0pd++ZQHijd9dDhKEYOAQ folded before Flop



PokerStars Game #59939222562:  Hold'em No Limit ($0.25/$0.50) - 2009/07/01 0:34:23 ET
Table 'hWT2kq66tnKEpD26cia6fQ' 2-max Seat #2 is the button
Seat 1: ZGkLiY2Qq6oVQktNWqoLVg ($16.45 in chips)
Seat 2: dkC7J+qbyqk0qCcmJbEPPw ($47.50 in chips)
dkC7J+qbyqk0qCcmJbEPPw: posts small blind $0.25
ZGkLiY2Qq6oVQktNWqoLVg: posts big blind $0.50
*** HOLE CARDS ***
dkC7J+qbyqk0qCcmJbEPPw: folds
ZGkLiY2Qq6oVQktNWqoLVg collected $0.50 from pot
*** SUMMARY ***
Total pot $0.50 | Rake $0
Seat 1: ZGkLiY2Qq6oVQktNWqoLVg (big blind) collected ($0.50)
Seat 2: dkC7J+qbyqk0qCcmJbEPPw (button) (small blind) folded before Flop



PokerStars Game #59939222302:  Hold'em No Limit ($0.25/$0.50) - 2009/07/01 0:34:23 ET
Table 'c/CRn+68J3Y8KxD5g1ek2Q' 2-max Seat #2 is the button
Seat 1: 46qCyJ6evTkHo9al5sBMNA ($268.75 in chips)
Seat 2: BypVLsYQt3ePFm2xQL/dOA ($108.65 in chips)
BypVLsYQt3ePFm2xQL/dOA: posts small blind $0.25
46qCyJ6evTkHo9al5sBMNA: posts big blind $0.50
*** HOLE CARDS ***
BypVLsYQt3ePFm2xQL/dOA: raises $3 to $3.50
46qCyJ6evTkHo9al5sBMNA: folds
BypVLsYQt3ePFm2xQL/dOA collected $1 from pot
BypVLsYQt3ePFm2xQL/dOA: doesn't show hand
*** SUMMARY ***
Total pot $1 | Rake $0
Seat 1: 46qCyJ6evTkHo9al5sBMNA (big blind) folded before Flop
Seat 2: BypVLsYQt3ePFm2xQL/dOA (button) (small blind) collected ($1)



PokerStars Game #59939222342:  Hold'em No Limit ($0.25/$0.50) - 2009/07/01 0:34:23 ET
Table 'eMxdLyFDf28E0wit6gm3Uw' 6-max Seat #3 is the button
Seat 1: GtdWeBVCZhDBcNFRTOb8Hg ($9.50 in chips)
Seat 2: jwuKQ1S3U4NnzMQn3E3dgw ($70.20 in chips)
Seat 3: dZcLsEI8iXkobBduRJ45Yw ($18.10 in chips)
Seat 4: QM93o65lI8kLzmiB/BILlA ($12.25 in chips)
Seat 6: L0aIPg7qefDQjdJo3HCVEA ($9.55 in chips)
QM93o65lI8kLzmiB/BILlA: posts small blind $0.25
L0aIPg7qefDQjdJo3HCVEA: posts big blind $0.50
*** HOLE CARDS ***
GtdWeBVCZhDBcNFRTOb8Hg: raises $0.50 to $1
jwuKQ1S3U4NnzMQn3E3dgw: raises $1 to $2
dZcLsEI8iXkobBduRJ45Yw: folds
QM93o65lI8kLzmiB/BILlA: calls $1.75
L0aIPg7qefDQjdJo3HCVEA: folds
GtdWeBVCZhDBcNFRTOb8Hg: calls $1
*** FLOP *** [6h 9s 7s]
QM93o65lI8kLzmiB/BILlA: checks
GtdWeBVCZhDBcNFRTOb8Hg: checks
jwuKQ1S3U4NnzMQn3E3dgw: checks
*** TURN *** [6h 9s 7s] [Jh]
QM93o65lI8kLzmiB/BILlA: checks
GtdWeBVCZhDBcNFRTOb8Hg: checks
jwuKQ1S3U4NnzMQn3E3dgw: checks
*** RIVER *** [6h 9s 7s Jh] [3h]
QM93o65lI8kLzmiB/BILlA: checks
GtdWeBVCZhDBcNFRTOb8Hg: checks
jwuKQ1S3U4NnzMQn3E3dgw: bets $5.50
QM93o65lI8kLzmiB/BILlA: folds
GtdWeBVCZhDBcNFRTOb8Hg: folds
jwuKQ1S3U4NnzMQn3E3dgw collected $6.20 from pot
*** SUMMARY ***
Total pot $6.50 | Rake $0.30
Board [6h 9s 7s Jh 3h]
Seat 1: GtdWeBVCZhDBcNFRTOb8Hg folded on the River
Seat 2: jwuKQ1S3U4NnzMQn3E3dgw collected ($6.20)
Seat 3: dZcLsEI8iXkobBduRJ45Yw (button) folded before Flop (didn't bet)
Seat 4: QM93o65lI8kLzmiB/BILlA (small blind) folded on the River
Seat 6: L0aIPg7qefDQjdJo3HCVEA (big blind) folded before Flop



PokerStars Game #59939225344:  Hold'em No Limit ($0.25/$0.50) - 2009/07/01 0:34:27 ET
Table 'mTxf8gPLgffN3Iwfm7Icfg' 2-max Seat #1 is the button
Seat 1: Do9Rlu1R5u/AcRtMTl8SYg ($75.95 in chips)
Seat 2: EMc5LPgVaded4Qc77vm0fw ($82.35 in chips)
Do9Rlu1R5u/AcRtMTl8SYg: posts small blind $0.25
EMc5LPgVaded4Qc77vm0fw: posts big blind $0.50
*** HOLE CARDS ***
Do9Rlu1R5u/AcRtMTl8SYg: folds
EMc5LPgVaded4Qc77vm0fw collected $0.50 from pot
EMc5LPgVaded4Qc77vm0fw: doesn't show hand
*** SUMMARY ***
Total pot $0.50 | Rake $0
Seat 1: Do9Rlu1R5u/AcRtMTl8SYg (button) (small blind) folded before Flop
Seat 2: EMc5LPgVaded4Qc77vm0fw (big blind) collected ($0.50)



PokerStars Game #59939226728:  Hold'em No Limit ($0.25/$0.50) - 2009/07/01 0:34:29 ET
Table '3FhG0gl3kMX3wBEEqj+wnQ' 9-max Seat #8 is the button
Seat 1: e0J9pdCNUDTCG031RnXqLA ($17.75 in chips)
Seat 3: HZkVla4kK2SI42CVrPZ/ig ($8.75 in chips)
Seat 5: XNMDwbXt/Q4jM99AXnbJDw ($50.75 in chips)
Seat 6: 5JJVDlaiMnB004o/RqbZZQ ($45.80 in chips)
Seat 7: mSD1pginDsyHG5PDfqzphw ($10 in chips)
Seat 8: j3K/Jujr7PY4ZM2RZvlH6A ($61.80 in chips)
Seat 9: L5e2lrPLQm1Pqx30IIZ/Fw ($10.35 in chips)
L5e2lrPLQm1Pqx30IIZ/Fw: posts small blind $0.25
e0J9pdCNUDTCG031RnXqLA: posts big blind $0.50
7cYQ+syUWjl38ty/ICOMhw: sits out
bjvJtA9Hqscfznq66txaOQ: sits out
*** HOLE CARDS ***
HZkVla4kK2SI42CVrPZ/ig: folds
XNMDwbXt/Q4jM99AXnbJDw: folds
XNMDwbXt/Q4jM99AXnbJDw leaves the table
5JJVDlaiMnB004o/RqbZZQ: folds
mSD1pginDsyHG5PDfqzphw: folds
j3K/Jujr7PY4ZM2RZvlH6A: folds
L5e2lrPLQm1Pqx30IIZ/Fw: folds
gsyXT42WLEcOS4DdEk2wlw joins the table at seat #5
e0J9pdCNUDTCG031RnXqLA collected $0.50 from pot
e0J9pdCNUDTCG031RnXqLA: doesn't show hand
*** SUMMARY ***
Total pot $0.50 | Rake $0
Seat 1: e0J9pdCNUDTCG031RnXqLA (big blind) collected ($0.50)
Seat 3: HZkVla4kK2SI42CVrPZ/ig folded before Flop (didn't bet)
Seat 5: XNMDwbXt/Q4jM99AXnbJDw folded before Flop (didn't bet)
Seat 6: 5JJVDlaiMnB004o/RqbZZQ folded before Flop (didn't bet)
Seat 7: mSD1pginDsyHG5PDfqzphw folded before Flop (didn't bet)
Seat 8: j3K/Jujr7PY4ZM2RZvlH6A (button) folded before Flop (didn't bet)
Seat 9: L5e2lrPLQm1Pqx30IIZ/Fw (small blind) folded before Flop



PokerStars Game #59939228264:  Hold'em No Limit ($0.25/$0.50) - 2009/07/01 0:34:32 ET
Table 'kgbJRsxfv64KrErDRBAkcw' 6-max Seat #5 is the button
Seat 1: mxTUARCsU8Eby0whmHNcOw ($7.50 in chips)
Seat 2: Q+thC23WCv1kJUJtH/+4Jw ($58.80 in chips)
Seat 3: T0Gx/FcQ5VH9u7XaOMX97A ($82.10 in chips)
Seat 4: qanMEqjABjWxC/JgQ/0l7w ($56.95 in chips)
Seat 5: +Pf9jTVizYlIo+woPvptfA ($51.55 in chips)
Seat 6: ozrlafxxh1HmYdA0/h+MuA ($14.15 in chips)
ozrlafxxh1HmYdA0/h+MuA: posts small blind $0.25
mxTUARCsU8Eby0whmHNcOw: posts big blind $0.50
*** HOLE CARDS ***
Q+thC23WCv1kJUJtH/+4Jw: folds
T0Gx/FcQ5VH9u7XaOMX97A: folds
qanMEqjABjWxC/JgQ/0l7w: raises $1 to $1.50
+Pf9jTVizYlIo+woPvptfA: folds
ozrlafxxh1HmYdA0/h+MuA: calls $1.25
mxTUARCsU8Eby0whmHNcOw: calls $1
*** FLOP *** [4c 8d 2s]
ozrlafxxh1HmYdA0/h+MuA: checks
mxTUARCsU8Eby0whmHNcOw: checks
qanMEqjABjWxC/JgQ/0l7w: checks
*** TURN *** [4c 8d 2s] [2c]
ozrlafxxh1HmYdA0/h+MuA: checks
mxTUARCsU8Eby0whmHNcOw: checks
qanMEqjABjWxC/JgQ/0l7w: checks
*** RIVER *** [4c 8d 2s 2c] [Qs]
ozrlafxxh1HmYdA0/h+MuA: checks
mxTUARCsU8Eby0whmHNcOw: checks
qanMEqjABjWxC/JgQ/0l7w: checks
*** SHOW DOWN ***
ozrlafxxh1HmYdA0/h+MuA: shows [7d As] (a pair of Deuces)
mxTUARCsU8Eby0whmHNcOw: mucks hand
qanMEqjABjWxC/JgQ/0l7w: mucks hand
ozrlafxxh1HmYdA0/h+MuA collected $4.30 from pot
*** SUMMARY ***
Total pot $4.50 | Rake $0.20
Board [4c 8d 2s 2c Qs]
Seat 1: mxTUARCsU8Eby0whmHNcOw (big blind) mucked
Seat 2: Q+thC23WCv1kJUJtH/+4Jw folded before Flop (didn't bet)
Seat 3: T0Gx/FcQ5VH9u7XaOMX97A folded before Flop (didn't bet)
Seat 4: qanMEqjABjWxC/JgQ/0l7w mucked
Seat 5: +Pf9jTVizYlIo+woPvptfA (button) folded before Flop (didn't bet)
Seat 6: ozrlafxxh1HmYdA0/h+MuA (small blind) showed [7d As] and won ($4.30) with a pair of Deuces



PokerStars Game #59939228392:  Hold'em No Limit ($0.25/$0.50) - 2009/07/01 0:34:32 ET
Table 'MJxeZCzYELxiIsyUZyT0jw' 6-max Seat #3 is the button
Seat 2: dB6jzDlJmET84VMWw1mTRA ($50 in chips)
Seat 3: JQZew0FjzS19kTjeNtrE+A ($50 in chips)
Seat 4: lP7Q6pewz4C2RsAfKsjdWw ($33.30 in chips)
Seat 5: 3jvoOXNtXE90w2BdfNZwZQ ($50 in chips)
Seat 6: TTx3CHxyi0SObcHyMJRp5w ($63.70 in chips)
lP7Q6pewz4C2RsAfKsjdWw: posts small blind $0.25
3jvoOXNtXE90w2BdfNZwZQ: posts big blind $0.50
tdOvWynovql5imfooroLMg: sits out
*** HOLE CARDS ***
TTx3CHxyi0SObcHyMJRp5w: folds
dB6jzDlJmET84VMWw1mTRA: raises $1 to $1.50
JQZew0FjzS19kTjeNtrE+A: folds
lP7Q6pewz4C2RsAfKsjdWw: folds
3jvoOXNtXE90w2BdfNZwZQ: folds
dB6jzDlJmET84VMWw1mTRA collected $1.25 from pot
dB6jzDlJmET84VMWw1mTRA: doesn't show hand
*** SUMMARY ***
Total pot $1.25 | Rake $0
Seat 2: dB6jzDlJmET84VMWw1mTRA collected ($1.25)
Seat 3: JQZew0FjzS19kTjeNtrE+A (button) folded before Flop (didn't bet)
Seat 4: lP7Q6pewz4C2RsAfKsjdWw (small blind) folded before Flop
Seat 5: 3jvoOXNtXE90w2BdfNZwZQ (big blind) folded before Flop
Seat 6: TTx3CHxyi0SObcHyMJRp5w folded before Flop (didn't bet)



PokerStars Game #59939229538:  Hold'em No Limit ($0.25/$0.50) - 2009/07/01 0:34:34 ET
Table 'mTxf8gPLgffN3Iwfm7Icfg' 2-max Seat #2 is the button
Seat 1: Do9Rlu1R5u/AcRtMTl8SYg ($75.70 in chips)
Seat 2: EMc5LPgVaded4Qc77vm0fw ($82.60 in chips)
EMc5LPgVaded4Qc77vm0fw: posts small blind $0.25
Do9Rlu1R5u/AcRtMTl8SYg: posts big blind $0.50
*** HOLE CARDS ***
EMc5LPgVaded4Qc77vm0fw: raises $1.50 to $2
Do9Rlu1R5u/AcRtMTl8SYg: folds
EMc5LPgVaded4Qc77vm0fw collected $1 from pot
EMc5LPgVaded4Qc77vm0fw: doesn't show hand
*** SUMMARY ***
Total pot $1 | Rake $0
Seat 1: Do9Rlu1R5u/AcRtMTl8SYg (big blind) folded before Flop
Seat 2: EMc5LPgVaded4Qc77vm0fw (button) (small blind) collected ($1)



PokerStars Game #59939232186:  Hold'em No Limit ($0.25/$0.50) - 2009/07/01 0:34:37 ET
Table 'hWT2kq66tnKEpD26cia6fQ' 2-max Seat #1 is the button
Seat 1: ZGkLiY2Qq6oVQktNWqoLVg ($16.70 in chips)
Seat 2: dkC7J+qbyqk0qCcmJbEPPw ($47.25 in chips)
ZGkLiY2Qq6oVQktNWqoLVg: posts small blind $0.25
dkC7J+qbyqk0qCcmJbEPPw: posts big blind $0.50
*** HOLE CARDS ***
ZGkLiY2Qq6oVQktNWqoLVg: raises $1 to $1.50
dkC7J+qbyqk0qCcmJbEPPw: folds
ZGkLiY2Qq6oVQktNWqoLVg collected $1 from pot
*** SUMMARY ***
Total pot $1 | Rake $0
Seat 1: ZGkLiY2Qq6oVQktNWqoLVg (button) (small blind) collected ($1)
Seat 2: dkC7J+qbyqk0qCcmJbEPPw (big blind) folded before Flop



PokerStars Game #59939232004:  Hold'em No Limit ($0.25/$0.50) - 2009/07/01 0:34:37 ET
Table 'c/CRn+68J3Y8KxD5g1ek2Q' 2-max Seat #1 is the button
Seat 1: 46qCyJ6evTkHo9al5sBMNA ($268.25 in chips)
Seat 2: BypVLsYQt3ePFm2xQL/dOA ($109.15 in chips)
46qCyJ6evTkHo9al5sBMNA: posts small blind $0.25
BypVLsYQt3ePFm2xQL/dOA: posts big blind $0.50
*** HOLE CARDS ***
46qCyJ6evTkHo9al5sBMNA: folds
BypVLsYQt3ePFm2xQL/dOA collected $0.50 from pot
BypVLsYQt3ePFm2xQL/dOA: doesn't show hand
*** SUMMARY ***
Total pot $0.50 | Rake $0
Seat 1: 46qCyJ6evTkHo9al5sBMNA (button) (small blind) folded before Flop
Seat 2: BypVLsYQt3ePFm2xQL/dOA (big blind) collected ($0.50)



PokerStars Game #59939232658:  Hold'em No Limit ($0.25/$0.50) - 2009/07/01 0:34:38 ET
Table '+111aLuBwnz8YVYSA7J1jA' 2-max Seat #2 is the button
Seat 1: ndd1nfncBkWNitBnsfCoVQ ($50 in chips)
Seat 2: +ciXH35zeafrjg1W6wiBTg ($50 in chips)
+ciXH35zeafrjg1W6wiBTg: posts small blind $0.25
ndd1nfncBkWNitBnsfCoVQ: posts big blind $0.50
*** HOLE CARDS ***
+ciXH35zeafrjg1W6wiBTg: raises $1 to $1.50
ndd1nfncBkWNitBnsfCoVQ: raises $3.50 to $5
+ciXH35zeafrjg1W6wiBTg: calls $3.50
*** FLOP *** [8c Td 9d]
ndd1nfncBkWNitBnsfCoVQ: bets $8
+ciXH35zeafrjg1W6wiBTg: calls $8
*** TURN *** [8c Td 9d] [7c]
ndd1nfncBkWNitBnsfCoVQ: checks
+ciXH35zeafrjg1W6wiBTg: bets $21
ndd1nfncBkWNitBnsfCoVQ: raises $16 to $37 and is all-in
+ciXH35zeafrjg1W6wiBTg: calls $16 and is all-in
*** RIVER *** [8c Td 9d 7c] [Qc]
*** SHOW DOWN ***
ndd1nfncBkWNitBnsfCoVQ: shows [Js Jh] (a straight, Eight to Queen)
+ciXH35zeafrjg1W6wiBTg: mucks hand
ndd1nfncBkWNitBnsfCoVQ collected $99.50 from pot
*** SUMMARY ***
Total pot $100 | Rake $0.50
Board [8c Td 9d 7c Qc]
Seat 1: ndd1nfncBkWNitBnsfCoVQ (big blind) showed [Js Jh] and won ($99.50) with a straight, Eight to Queen
Seat 2: +ciXH35zeafrjg1W6wiBTg (button) (small blind) mucked



PokerStars Game #59939232370:  Hold'em No Limit ($0.25/$0.50) - 2009/07/01 0:34:38 ET
Table '37qXEp3oe+er5q4CZip9eQ' 6-max Seat #2 is the button
Seat 1: oqOqoO2AyCZenUghCxMDxw ($53 in chips)
Seat 2: 6wzJiRvp8HY6t+MQGnSIzA ($24.40 in chips)
Seat 3: Rt6KgtZ8YaJoTc3FPim00w ($88.50 in chips)
Seat 4: XsmE8nXMAAMFJbWaJTmHFw ($26.65 in chips)
Seat 5: VOmI0x4dDPnTESZd5B4d1Q ($41.75 in chips)
Rt6KgtZ8YaJoTc3FPim00w: posts small blind $0.25
XsmE8nXMAAMFJbWaJTmHFw: posts big blind $0.50
*** HOLE CARDS ***
VOmI0x4dDPnTESZd5B4d1Q: folds
oqOqoO2AyCZenUghCxMDxw: folds
6wzJiRvp8HY6t+MQGnSIzA: folds
Rt6KgtZ8YaJoTc3FPim00w: folds
XsmE8nXMAAMFJbWaJTmHFw collected $0.50 from pot
*** SUMMARY ***
Total pot $0.50 | Rake $0
Seat 1: oqOqoO2AyCZenUghCxMDxw folded before Flop (didn't bet)
Seat 2: 6wzJiRvp8HY6t+MQGnSIzA (button) folded before Flop (didn't bet)
Seat 3: Rt6KgtZ8YaJoTc3FPim00w (small blind) folded before Flop
Seat 4: XsmE8nXMAAMFJbWaJTmHFw (big blind) collected ($0.50)
Seat 5: VOmI0x4dDPnTESZd5B4d1Q folded before Flop (didn't bet)



PokerStars Game #59939234142:  Hold'em No Limit ($0.25/$0.50) - 2009/07/01 0:34:40 ET
Table 'GfL/No5u5PoEnU39lP5pQg' 6-max Seat #4 is the button
Seat 1: 1WUCqNG+p+vfWRTXNu4ljw ($50.30 in chips)
Seat 2: uVwggSetzp7d+eVgowO3vg ($54.30 in chips)
Seat 3: NbUTppWfym/RxV/DmDz2Sw ($13.90 in chips)
Seat 4: x+pzUFJsMIiGd7a5pcR4tg ($53.85 in chips)
Seat 5: crjGpJEzSZgD38FoE3VMGg ($59.85 in chips)
crjGpJEzSZgD38FoE3VMGg: posts small blind $0.25
1WUCqNG+p+vfWRTXNu4ljw: posts big blind $0.50
*** HOLE CARDS ***
uVwggSetzp7d+eVgowO3vg: folds
NbUTppWfym/RxV/DmDz2Sw: calls $0.50
x+pzUFJsMIiGd7a5pcR4tg: folds
crjGpJEzSZgD38FoE3VMGg: folds
1WUCqNG+p+vfWRTXNu4ljw: checks
*** FLOP *** [2c Ad 6s]
1WUCqNG+p+vfWRTXNu4ljw: checks
NbUTppWfym/RxV/DmDz2Sw: checks
*** TURN *** [2c Ad 6s] [Tc]
1WUCqNG+p+vfWRTXNu4ljw: checks
NbUTppWfym/RxV/DmDz2Sw: checks
*** RIVER *** [2c Ad 6s Tc] [9c]
1WUCqNG+p+vfWRTXNu4ljw: checks
NbUTppWfym/RxV/DmDz2Sw: checks
*** SHOW DOWN ***
1WUCqNG+p+vfWRTXNu4ljw: shows [Jd 4c] (high card Ace)
NbUTppWfym/RxV/DmDz2Sw: shows [9s Qc] (a pair of Nines)
NbUTppWfym/RxV/DmDz2Sw collected $1.20 from pot
*** SUMMARY ***
Total pot $1.25 | Rake $0.05
Board [2c Ad 6s Tc 9c]
Seat 1: 1WUCqNG+p+vfWRTXNu4ljw (big blind) showed [Jd 4c] and lost with high card Ace
Seat 2: uVwggSetzp7d+eVgowO3vg folded before Flop (didn't bet)
Seat 3: NbUTppWfym/RxV/DmDz2Sw showed [9s Qc] and won ($1.20) with a pair of Nines
Seat 4: x+pzUFJsMIiGd7a5pcR4tg (button) folded before Flop (didn't bet)
Seat 5: crjGpJEzSZgD38FoE3VMGg (small blind) folded before Flop



PokerStars Game #59939235264:  Hold'em No Limit ($0.25/$0.50) - 2009/07/01 0:34:42 ET
Table 'mTxf8gPLgffN3Iwfm7Icfg' 2-max Seat #1 is the button
Seat 1: Do9Rlu1R5u/AcRtMTl8SYg ($75.20 in chips)
Seat 2: EMc5LPgVaded4Qc77vm0fw ($83.10 in chips)
Do9Rlu1R5u/AcRtMTl8SYg: posts small blind $0.25
EMc5LPgVaded4Qc77vm0fw: posts big blind $0.50
*** HOLE CARDS ***
Do9Rlu1R5u/AcRtMTl8SYg: folds
EMc5LPgVaded4Qc77vm0fw collected $0.50 from pot
EMc5LPgVaded4Qc77vm0fw: doesn't show hand
*** SUMMARY ***
Total pot $0.50 | Rake $0
Seat 1: Do9Rlu1R5u/AcRtMTl8SYg (button) (small blind) folded before Flop
Seat 2: EMc5LPgVaded4Qc77vm0fw (big blind) collected ($0.50)



PokerStars Game #59939236280:  Hold'em No Limit ($0.25/$0.50) - 2009/07/01 0:34:44 ET
Table 'c/CRn+68J3Y8KxD5g1ek2Q' 2-max Seat #2 is the button
Seat 1: 46qCyJ6evTkHo9al5sBMNA ($268 in chips)
Seat 2: BypVLsYQt3ePFm2xQL/dOA ($109.40 in chips)
BypVLsYQt3ePFm2xQL/dOA: posts small blind $0.25
46qCyJ6evTkHo9al5sBMNA: posts big blind $0.50
*** HOLE CARDS ***
BypVLsYQt3ePFm2xQL/dOA: raises $2.50 to $3
46qCyJ6evTkHo9al5sBMNA: raises $6 to $9
BypVLsYQt3ePFm2xQL/dOA: calls $6
*** FLOP *** [Qc 4s 5c]
46qCyJ6evTkHo9al5sBMNA: checks
BypVLsYQt3ePFm2xQL/dOA: bets $8
46qCyJ6evTkHo9al5sBMNA: calls $8
*** TURN *** [Qc 4s 5c] [5s]
46qCyJ6evTkHo9al5sBMNA: checks
BypVLsYQt3ePFm2xQL/dOA: checks
*** RIVER *** [Qc 4s 5c 5s] [2c]
46qCyJ6evTkHo9al5sBMNA: checks
BypVLsYQt3ePFm2xQL/dOA: bets $20.50
46qCyJ6evTkHo9al5sBMNA: calls $20.50
*** SHOW DOWN ***
BypVLsYQt3ePFm2xQL/dOA: shows [8c Jc] (a flush, Queen high)
46qCyJ6evTkHo9al5sBMNA: mucks hand
BypVLsYQt3ePFm2xQL/dOA collected $74.50 from pot
*** SUMMARY ***
Total pot $75 | Rake $0.50
Board [Qc 4s 5c 5s 2c]
Seat 1: 46qCyJ6evTkHo9al5sBMNA (big blind) mucked
Seat 2: BypVLsYQt3ePFm2xQL/dOA (button) (small blind) showed [8c Jc] and won ($74.50) with a flush, Queen high



PokerStars Game #59939236558:  Hold'em No Limit ($0.25/$0.50) - 2009/07/01 0:34:44 ET
Table '/cQuAT3ef4t+PGrXiNhGaQ' 9-max Seat #2 is the button
Seat 1: HZkVla4kK2SI42CVrPZ/ig ($9.25 in chips)
Seat 2: jXGruyaMqirTaTXNOvBdew ($70.65 in chips)
Seat 3: g4k0NXISyLCqaSWZDBjfEg ($54.15 in chips)
Seat 4: OWP/DOu+PlPK6ZZ3zYa0HA ($41.65 in chips)
Seat 5: 5SgaHdWixdClWvaEG+KUjQ ($20.95 in chips)
Seat 6: APYIOyK/4AGb+kIwlOUNBQ ($43.75 in chips)
Seat 7: J0W5D97jl5VLky+IoPvDeA ($114.90 in chips)
Seat 8: W3ingbA178eb7J5rt1PuIQ ($27.10 in chips)
g4k0NXISyLCqaSWZDBjfEg: posts small blind $0.25
OWP/DOu+PlPK6ZZ3zYa0HA: posts big blind $0.50
*** HOLE CARDS ***
5SgaHdWixdClWvaEG+KUjQ: folds
APYIOyK/4AGb+kIwlOUNBQ: folds
J0W5D97jl5VLky+IoPvDeA: folds
W3ingbA178eb7J5rt1PuIQ: calls $0.50
HZkVla4kK2SI42CVrPZ/ig: folds
jXGruyaMqirTaTXNOvBdew: folds
g4k0NXISyLCqaSWZDBjfEg: calls $0.25
OWP/DOu+PlPK6ZZ3zYa0HA: checks
*** FLOP *** [Qs Kc 5h]
g4k0NXISyLCqaSWZDBjfEg: checks
OWP/DOu+PlPK6ZZ3zYa0HA: checks
W3ingbA178eb7J5rt1PuIQ: bets $1
g4k0NXISyLCqaSWZDBjfEg: folds
OWP/DOu+PlPK6ZZ3zYa0HA: calls $1
*** TURN *** [Qs Kc 5h] [Js]
OWP/DOu+PlPK6ZZ3zYa0HA: checks
W3ingbA178eb7J5rt1PuIQ: checks
*** RIVER *** [Qs Kc 5h Js] [7d]
OWP/DOu+PlPK6ZZ3zYa0HA: checks
W3ingbA178eb7J5rt1PuIQ: checks
*** SHOW DOWN ***
OWP/DOu+PlPK6ZZ3zYa0HA: shows [Qd Ac] (a pair of Queens)
W3ingbA178eb7J5rt1PuIQ: shows [Tc Kh] (a pair of Kings)
W3ingbA178eb7J5rt1PuIQ collected $3.35 from pot
*** SUMMARY ***
Total pot $3.50 | Rake $0.15
Board [Qs Kc 5h Js 7d]
Seat 1: HZkVla4kK2SI42CVrPZ/ig folded before Flop (didn't bet)
Seat 2: jXGruyaMqirTaTXNOvBdew (button) folded before Flop (didn't bet)
Seat 3: g4k0NXISyLCqaSWZDBjfEg (small blind) folded on the Flop
Seat 4: OWP/DOu+PlPK6ZZ3zYa0HA (big blind) showed [Qd Ac] and lost with a pair of Queens
Seat 5: 5SgaHdWixdClWvaEG+KUjQ folded before Flop (didn't bet)
Seat 6: APYIOyK/4AGb+kIwlOUNBQ folded before Flop (didn't bet)
Seat 7: J0W5D97jl5VLky+IoPvDeA folded before Flop (didn't bet)
Seat 8: W3ingbA178eb7J5rt1PuIQ showed [Tc Kh] and won ($3.35) with a pair of Kings



PokerStars Game #59939236960:  Hold'em No Limit ($0.25/$0.50) - 2009/07/01 0:34:45 ET
Table 'ibNfFy0bCzuBaUORla0aGw' 9-max Seat #4 is the button
Seat 1: xZCXQSXlrZkp3pZizzVXCw ($53.95 in chips)
Seat 2: 90Wb75h3W1BRpbqVnuk8gw ($64.15 in chips)
Seat 3: dDaHs3X8+fe3bIkRU0cbrw ($40.90 in chips)
Seat 4: YBN054X4blmis+B2bBlC0g ($17.10 in chips)
Seat 6: 8n9jQLh3cZKbsmr5PIjgiQ ($38.50 in chips)
Seat 7: HZkVla4kK2SI42CVrPZ/ig ($9.25 in chips)
Seat 8: xUrN9TWLq4m5V+OXY7KUUA ($50 in chips)
Seat 9: pFtzb1sR4b0d1aw6aIRgDg ($50.75 in chips)
8n9jQLh3cZKbsmr5PIjgiQ: posts small blind $0.25
HZkVla4kK2SI42CVrPZ/ig: posts big blind $0.50
*** HOLE CARDS ***
xUrN9TWLq4m5V+OXY7KUUA: folds
pFtzb1sR4b0d1aw6aIRgDg: folds
xZCXQSXlrZkp3pZizzVXCw has timed out
xZCXQSXlrZkp3pZizzVXCw: folds
xZCXQSXlrZkp3pZizzVXCw is sitting out
90Wb75h3W1BRpbqVnuk8gw: raises $1.50 to $2
dDaHs3X8+fe3bIkRU0cbrw: folds
xZCXQSXlrZkp3pZizzVXCw has returned
YBN054X4blmis+B2bBlC0g: calls $2
8n9jQLh3cZKbsmr5PIjgiQ: folds
HZkVla4kK2SI42CVrPZ/ig: folds
*** FLOP *** [Ad Jh 7s]
90Wb75h3W1BRpbqVnuk8gw: bets $2.50
YBN054X4blmis+B2bBlC0g: calls $2.50
*** TURN *** [Ad Jh 7s] [Ts]
90Wb75h3W1BRpbqVnuk8gw: checks
YBN054X4blmis+B2bBlC0g: checks
*** RIVER *** [Ad Jh 7s Ts] [Kc]
90Wb75h3W1BRpbqVnuk8gw: checks
YBN054X4blmis+B2bBlC0g: bets $1.50
90Wb75h3W1BRpbqVnuk8gw: folds
GIJAc9kPrLZHLSX8Q6i99w joins the table at seat #5
YBN054X4blmis+B2bBlC0g collected $9.30 from pot
YBN054X4blmis+B2bBlC0g: doesn't show hand
*** SUMMARY ***
Total pot $9.75 | Rake $0.45
Board [Ad Jh 7s Ts Kc]
Seat 1: xZCXQSXlrZkp3pZizzVXCw folded before Flop (didn't bet)
Seat 2: 90Wb75h3W1BRpbqVnuk8gw folded on the River
Seat 3: dDaHs3X8+fe3bIkRU0cbrw folded before Flop (didn't bet)
Seat 4: YBN054X4blmis+B2bBlC0g (button) collected ($9.30)
Seat 6: 8n9jQLh3cZKbsmr5PIjgiQ (small blind) folded before Flop
Seat 7: HZkVla4kK2SI42CVrPZ/ig (big blind) folded before Flop
Seat 8: xUrN9TWLq4m5V+OXY7KUUA folded before Flop (didn't bet)
Seat 9: pFtzb1sR4b0d1aw6aIRgDg folded before Flop (didn't bet)



PokerStars Game #59939236916:  Hold'em No Limit ($0.25/$0.50) - 2009/07/01 0:34:45 ET
Table 'QOgaEqMcJ73pcUMMxoisUgErOuyGLI5PT3G5MnpHgC/g Seat #3 is the button
Seat 1: L5e2lrPLQm1Pqx30IIZ/Fw ($10 in chips)
Seat 2: RjBdQ6w31rgcy0o24VLR6w ($18.95 in chips)
Seat 3: xZCXQSXlrZkp3pZizzVXCw ($49.75 in chips)
Seat 4: 3UmXLy3GfjC3EkOebduerQ ($50 in chips)
Seat 5: JwvquocWfhTVApN5t47LgA ($57.80 in chips)
Seat 6: zE9cVigS2nW/Ljy4K4bUQA ($30 in chips)
Seat 7: 90Wb75h3W1BRpbqVnuk8gw ($62.95 in chips)
Seat 8: g4k0NXISyLCqaSWZDBjfEg ($52.10 in chips)
Seat 9: J0W5D97jl5VLky+IoPvDeA ($56.40 in chips)
3UmXLy3GfjC3EkOebduerQ: posts small blind $0.25
JwvquocWfhTVApN5t47LgA: posts big blind $0.50
*** HOLE CARDS ***
zE9cVigS2nW/Ljy4K4bUQA: folds
90Wb75h3W1BRpbqVnuk8gw: folds
g4k0NXISyLCqaSWZDBjfEg: folds
J0W5D97jl5VLky+IoPvDeA: folds
L5e2lrPLQm1Pqx30IIZ/Fw: folds
RjBdQ6w31rgcy0o24VLR6w: folds
xZCXQSXlrZkp3pZizzVXCw: raises $1 to $1.50
3UmXLy3GfjC3EkOebduerQ: folds
JwvquocWfhTVApN5t47LgA: folds
xZCXQSXlrZkp3pZizzVXCw collected $1.25 from pot
*** SUMMARY ***
Total pot $1.25 | Rake $0
Seat 1: L5e2lrPLQm1Pqx30IIZ/Fw folded before Flop (didn't bet)
Seat 2: RjBdQ6w31rgcy0o24VLR6w folded before Flop (didn't bet)
Seat 3: xZCXQSXlrZkp3pZizzVXCw (button) collected ($1.25)
Seat 4: 3UmXLy3GfjC3EkOebduerQ (small blind) folded before Flop
Seat 5: JwvquocWfhTVApN5t47LgA (big blind) folded before Flop
Seat 6: zE9cVigS2nW/Ljy4K4bUQA folded before Flop (didn't bet)
Seat 7: 90Wb75h3W1BRpbqVnuk8gw folded before Flop (didn't bet)
Seat 8: g4k0NXISyLCqaSWZDBjfEg folded before Flop (didn't bet)
Seat 9: J0W5D97jl5VLky+IoPvDeA folded before Flop (didn't bet)



PokerStars Game #59939237948:  Hold'em No Limit ($0.25/$0.50) - 2009/07/01 0:34:46 ET
Table 'E7bWJ45aoFXRpyRv2gw+Ig' 2-max Seat #1 is the button
Seat 1: FRkiRasEGlHUeLrEl+k/nA ($56.65 in chips)
Seat 2: 3Wro85I7472vJ4Wkpneo9A ($138.90 in chips)
FRkiRasEGlHUeLrEl+k/nA: posts small blind $0.25
3Wro85I7472vJ4Wkpneo9A: posts big blind $0.50
*** HOLE CARDS ***
FRkiRasEGlHUeLrEl+k/nA: folds
3Wro85I7472vJ4Wkpneo9A collected $0.50 from pot
3Wro85I7472vJ4Wkpneo9A: doesn't show hand
*** SUMMARY ***
Total pot $0.50 | Rake $0
Seat 1: FRkiRasEGlHUeLrEl+k/nA (button) (small blind) folded before Flop
Seat 2: 3Wro85I7472vJ4Wkpneo9A (big blind) collected ($0.50)



PokerStars Game #59939238972:  Hold'em No Limit ($0.25/$0.50) - 2009/07/01 0:34:48 ET
Table 'hWT2kq66tnKEpD26cia6fQ' 2-max Seat #2 is the button
Seat 1: ZGkLiY2Qq6oVQktNWqoLVg ($17.20 in chips)
Seat 2: dkC7J+qbyqk0qCcmJbEPPw ($46.75 in chips)
dkC7J+qbyqk0qCcmJbEPPw: posts small blind $0.25
ZGkLiY2Qq6oVQktNWqoLVg: posts big blind $0.50
*** HOLE CARDS ***
dkC7J+qbyqk0qCcmJbEPPw: raises $1 to $1.50
ZGkLiY2Qq6oVQktNWqoLVg: calls $1
*** FLOP *** [2h 9c 4d]
ZGkLiY2Qq6oVQktNWqoLVg: checks
dkC7J+qbyqk0qCcmJbEPPw: bets $2.50
ZGkLiY2Qq6oVQktNWqoLVg: folds
dkC7J+qbyqk0qCcmJbEPPw collected $2.85 from pot
*** SUMMARY ***
Total pot $3 | Rake $0.15
Board [2h 9c 4d]
Seat 1: ZGkLiY2Qq6oVQktNWqoLVg (big blind) folded on the Flop
Seat 2: dkC7J+qbyqk0qCcmJbEPPw (button) (small blind) collected ($2.85)



PokerStars Game #59939239316:  Hold'em No Limit ($0.25/$0.50) - 2009/07/01 0:34:48 ET
Table 'T/PgNWqVyY6lkldcBVXYJQ' 6-max Seat #1 is the button
Seat 1: +Pf9jTVizYlIo+woPvptfA ($57.25 in chips)
Seat 2: oZAeY5rVqNGgt8yyQ0pxbA ($38.45 in chips)
Seat 3: L3OcNO1bgdqDI46j67KQPQ ($54.60 in chips)
Seat 5: vVQBckETtigfb5mAcyK0OA ($48.50 in chips)
Seat 6: cDzbog6kwmJp+LBeBq+iMQ ($43.75 in chips)
oZAeY5rVqNGgt8yyQ0pxbA: posts small blind $0.25
L3OcNO1bgdqDI46j67KQPQ: posts big blind $0.50
otJMdCRvqd5YCcFsA3JWpg: sits out
*** HOLE CARDS ***
vVQBckETtigfb5mAcyK0OA: calls $0.50
cDzbog6kwmJp+LBeBq+iMQ: folds
+Pf9jTVizYlIo+woPvptfA: folds
oZAeY5rVqNGgt8yyQ0pxbA: folds
L3OcNO1bgdqDI46j67KQPQ: checks
*** FLOP *** [Jd 4s 3d]
L3OcNO1bgdqDI46j67KQPQ: checks
vVQBckETtigfb5mAcyK0OA: checks
*** TURN *** [Jd 4s 3d] [Jh]
L3OcNO1bgdqDI46j67KQPQ: checks
vVQBckETtigfb5mAcyK0OA: bets $0.50
L3OcNO1bgdqDI46j67KQPQ: folds
vVQBckETtigfb5mAcyK0OA collected $1.20 from pot
vVQBckETtigfb5mAcyK0OA: doesn't show hand
*** SUMMARY ***
Total pot $1.25 | Rake $0.05
Board [Jd 4s 3d Jh]
Seat 1: +Pf9jTVizYlIo+woPvptfA (button) folded before Flop (didn't bet)
Seat 2: oZAeY5rVqNGgt8yyQ0pxbA (small blind) folded before Flop
Seat 3: L3OcNO1bgdqDI46j67KQPQ (big blind) folded on the Turn
Seat 5: vVQBckETtigfb5mAcyK0OA collected ($1.20)
Seat 6: cDzbog6kwmJp+LBeBq+iMQ folded before Flop (didn't bet)



PokerStars Game #59939239790:  Hold'em No Limit ($0.25/$0.50) - 2009/07/01 0:34:49 ET
Table 'mTxf8gPLgffN3Iwfm7Icfg' 2-max Seat #2 is the button
Seat 1: Do9Rlu1R5u/AcRtMTl8SYg ($74.95 in chips)
Seat 2: EMc5LPgVaded4Qc77vm0fw ($83.35 in chips)
EMc5LPgVaded4Qc77vm0fw: posts small blind $0.25
Do9Rlu1R5u/AcRtMTl8SYg: posts big blind $0.50
*** HOLE CARDS ***
EMc5LPgVaded4Qc77vm0fw: calls $0.25
Do9Rlu1R5u/AcRtMTl8SYg: checks
*** FLOP *** [4d Kd Jh]
Do9Rlu1R5u/AcRtMTl8SYg: checks
EMc5LPgVaded4Qc77vm0fw: checks
*** TURN *** [4d Kd Jh] [7h]
Do9Rlu1R5u/AcRtMTl8SYg: checks
EMc5LPgVaded4Qc77vm0fw: bets $1
Do9Rlu1R5u/AcRtMTl8SYg: folds
EMc5LPgVaded4Qc77vm0fw collected $0.95 from pot
EMc5LPgVaded4Qc77vm0fw: doesn't show hand
*** SUMMARY ***
Total pot $1 | Rake $0.05
Board [4d Kd Jh 7h]
Seat 1: Do9Rlu1R5u/AcRtMTl8SYg (big blind) folded on the Turn
Seat 2: EMc5LPgVaded4Qc77vm0fw (button) (small blind) collected ($0.95)



PokerStars Game #59939241064:  Hold'em No Limit ($0.25/$0.50) - 2009/07/01 0:34:51 ET
Table 'EiNh8p/wGJ1FP575iMFnqg' 9-max Seat #1 is the button
Seat 1: r3ZqM1Mi0W3y4hOdssE+Sg ($48.25 in chips)
Seat 2: 8ehL7qlZzjgUh2H35iiWLw ($50 in chips)
Seat 3: ymLPoEIl7UL3TvZYmnadxQ ($50.85 in chips)
Seat 4: HIIPkpiaCQfs5HcPKjlHvg ($31.95 in chips)
Seat 5: M+7+BTmX5vZatHVuoRB1nA ($84.85 in chips)
Seat 6: 3UmXLy3GfjC3EkOebduerQ ($54.65 in chips)
Seat 7: Wj7mKnRFR90j40wWUu2+Og ($71.05 in chips)
Seat 8: KrPAGRACBg+w0M//SXe8Ag ($12.40 in chips)
Seat 9: OMwFJ4pF0xk2Ru/AJiFeFw ($79.75 in chips)
8ehL7qlZzjgUh2H35iiWLw: posts small blind $0.25
ymLPoEIl7UL3TvZYmnadxQ: posts big blind $0.50
*** HOLE CARDS ***
HIIPkpiaCQfs5HcPKjlHvg: calls $0.50
M+7+BTmX5vZatHVuoRB1nA: folds
3UmXLy3GfjC3EkOebduerQ: folds
Wj7mKnRFR90j40wWUu2+Og: folds
KrPAGRACBg+w0M//SXe8Ag: calls $0.50
OMwFJ4pF0xk2Ru/AJiFeFw: raises $1.75 to $2.25
r3ZqM1Mi0W3y4hOdssE+Sg: folds
8ehL7qlZzjgUh2H35iiWLw: folds
ymLPoEIl7UL3TvZYmnadxQ: folds
HIIPkpiaCQfs5HcPKjlHvg: calls $1.75
KrPAGRACBg+w0M//SXe8Ag: folds
*** FLOP *** [Jd Kh Tc]
HIIPkpiaCQfs5HcPKjlHvg: checks
OMwFJ4pF0xk2Ru/AJiFeFw: bets $3.50
HIIPkpiaCQfs5HcPKjlHvg: calls $3.50
*** TURN *** [Jd Kh Tc] [2c]
HIIPkpiaCQfs5HcPKjlHvg: checks
OMwFJ4pF0xk2Ru/AJiFeFw: bets $7
HIIPkpiaCQfs5HcPKjlHvg: calls $7
*** RIVER *** [Jd Kh Tc 2c] [6c]
HIIPkpiaCQfs5HcPKjlHvg: bets $10
OMwFJ4pF0xk2Ru/AJiFeFw: calls $10
*** SHOW DOWN ***
HIIPkpiaCQfs5HcPKjlHvg: shows [As Jc] (a pair of Jacks)
OMwFJ4pF0xk2Ru/AJiFeFw: shows [Ac Kd] (a pair of Kings)
OMwFJ4pF0xk2Ru/AJiFeFw collected $44.50 from pot
*** SUMMARY ***
Total pot $46.75 | Rake $2.25
Board [Jd Kh Tc 2c 6c]
Seat 1: r3ZqM1Mi0W3y4hOdssE+Sg (button) folded before Flop (didn't bet)
Seat 2: 8ehL7qlZzjgUh2H35iiWLw (small blind) folded before Flop
Seat 3: ymLPoEIl7UL3TvZYmnadxQ (big blind) folded before Flop
Seat 4: HIIPkpiaCQfs5HcPKjlHvg showed [As Jc] and lost with a pair of Jacks
Seat 5: M+7+BTmX5vZatHVuoRB1nA folded before Flop (didn't bet)
Seat 6: 3UmXLy3GfjC3EkOebduerQ folded before Flop (didn't bet)
Seat 7: Wj7mKnRFR90j40wWUu2+Og folded before Flop (didn't bet)
Seat 8: KrPAGRACBg+w0M//SXe8Ag folded before Flop
Seat 9: OMwFJ4pF0xk2Ru/AJiFeFw showed [Ac Kd] and won ($44.50) with a pair of Kings



PokerStars Game #59939242348:  Hold'em No Limit ($0.25/$0.50) - 2009/07/01 0:34:53 ET
Table '+z1aekfHkpp09pc8F9aViw' 6-max Seat #3 is the button
Seat 1: FHilMb2i2DbUCc9lplszog ($45.50 in chips)
Seat 2: M6xK/VklCvdyyrmvzATlxQ ($38.30 in chips)
Seat 3: uUznlIMFnRUvwrBhYF73KA ($59.65 in chips)
Seat 4: RowCSpSURHTOL/dcjg/Iug ($48.80 in chips)
Seat 5: crjGpJEzSZgD38FoE3VMGg ($55.35 in chips)
Seat 6: 686aeHikcJlgKkSuIFdcXQ ($69.35 in chips)
RowCSpSURHTOL/dcjg/Iug: posts small blind $0.25
crjGpJEzSZgD38FoE3VMGg: posts big blind $0.50
*** HOLE CARDS ***
686aeHikcJlgKkSuIFdcXQ: folds
FHilMb2i2DbUCc9lplszog: raises $1 to $1.50
M6xK/VklCvdyyrmvzATlxQ: folds
uUznlIMFnRUvwrBhYF73KA: calls $1.50
RowCSpSURHTOL/dcjg/Iug: folds
crjGpJEzSZgD38FoE3VMGg: folds
*** FLOP *** [3h 8c Qc]
FHilMb2i2DbUCc9lplszog: bets $1.50
uUznlIMFnRUvwrBhYF73KA: folds
FHilMb2i2DbUCc9lplszog collected $3.60 from pot
*** SUMMARY ***
Total pot $3.75 | Rake $0.15
Board [3h 8c Qc]
Seat 1: FHilMb2i2DbUCc9lplszog collected ($3.60)
Seat 2: M6xK/VklCvdyyrmvzATlxQ folded before Flop (didn't bet)
Seat 3: uUznlIMFnRUvwrBhYF73KA (button) folded on the Flop
Seat 4: RowCSpSURHTOL/dcjg/Iug (small blind) folded before Flop
Seat 5: crjGpJEzSZgD38FoE3VMGg (big blind) folded before Flop
Seat 6: 686aeHikcJlgKkSuIFdcXQ folded before Flop (didn't bet)



PokerStars Game #59939243130:  Hold'em No Limit ($0.25/$0.50) - 2009/07/01 0:34:54 ET
Table '+dXkOAQyS8j9PQZusUTMpg' 2-max Seat #2 is the button
Seat 1: XFa6sBGjP2gxoIvxR3fZIg ($67.50 in chips)
Seat 2: 5IBeOgaApY1Bvzv2P8X4EA ($74.60 in chips)
5IBeOgaApY1Bvzv2P8X4EA: posts small blind $0.25
XFa6sBGjP2gxoIvxR3fZIg: posts big blind $0.50
*** HOLE CARDS ***
5IBeOgaApY1Bvzv2P8X4EA: folds
XFa6sBGjP2gxoIvxR3fZIg collected $0.50 from pot
XFa6sBGjP2gxoIvxR3fZIg: doesn't show hand
*** SUMMARY ***
Total pot $0.50 | Rake $0
Seat 1: XFa6sBGjP2gxoIvxR3fZIg (big blind) collected ($0.50)
Seat 2: 5IBeOgaApY1Bvzv2P8X4EA (button) (small blind) folded before Flop



PokerStars Game #59939242906:  Hold'em No Limit ($0.25/$0.50) - 2009/07/01 0:34:54 ET
Table '37qXEp3oe+er5q4CZip9eQ' 6-max Seat #3 is the button
Seat 1: oqOqoO2AyCZenUghCxMDxw ($53 in chips)
Seat 2: 6wzJiRvp8HY6t+MQGnSIzA ($24.40 in chips)
Seat 3: Rt6KgtZ8YaJoTc3FPim00w ($88.25 in chips)
Seat 4: XsmE8nXMAAMFJbWaJTmHFw ($26.90 in chips)
Seat 5: VOmI0x4dDPnTESZd5B4d1Q ($41.75 in chips)
XsmE8nXMAAMFJbWaJTmHFw: posts small blind $0.25
VOmI0x4dDPnTESZd5B4d1Q: posts big blind $0.50
*** HOLE CARDS ***
oqOqoO2AyCZenUghCxMDxw: folds
6wzJiRvp8HY6t+MQGnSIzA: calls $0.50
Rt6KgtZ8YaJoTc3FPim00w: raises $1.50 to $2
XsmE8nXMAAMFJbWaJTmHFw: calls $1.75
VOmI0x4dDPnTESZd5B4d1Q: folds
6wzJiRvp8HY6t+MQGnSIzA: calls $1.50
*** FLOP *** [Ks Kh Qh]
XsmE8nXMAAMFJbWaJTmHFw: checks
6wzJiRvp8HY6t+MQGnSIzA: checks
Rt6KgtZ8YaJoTc3FPim00w: checks
*** TURN *** [Ks Kh Qh] [4d]
XsmE8nXMAAMFJbWaJTmHFw: checks
N50kln4negd8q7Mmoz1j4g joins the table at seat #6
6wzJiRvp8HY6t+MQGnSIzA: bets $2
Rt6KgtZ8YaJoTc3FPim00w: folds
XsmE8nXMAAMFJbWaJTmHFw: folds
6wzJiRvp8HY6t+MQGnSIzA collected $6.20 from pot
*** SUMMARY ***
Total pot $6.50 | Rake $0.30
Board [Ks Kh Qh 4d]
Seat 1: oqOqoO2AyCZenUghCxMDxw folded before Flop (didn't bet)
Seat 2: 6wzJiRvp8HY6t+MQGnSIzA collected ($6.20)
Seat 3: Rt6KgtZ8YaJoTc3FPim00w (button) folded on the Turn
Seat 4: XsmE8nXMAAMFJbWaJTmHFw (small blind) folded on the Turn
Seat 5: VOmI0x4dDPnTESZd5B4d1Q (big blind) folded before Flop



PokerStars Game #59939243002:  Hold'em No Limit ($0.25/$0.50) - 2009/07/01 0:34:54 ET
Table 'tyR5AZNKV8Aadbrnrnlg7g' 6-max Seat #6 is the button
Seat 1: R+KjpH/wSjDLhtIy9+edNA ($84.65 in chips)
Seat 2: BAjwVL+zKKd0s0fAWstzQQ ($18.65 in chips)
Seat 3: tdOvWynovql5imfooroLMg ($48 in chips)
Seat 4: Rt6KgtZ8YaJoTc3FPim00w ($83.20 in chips)
Seat 6: ZKazl1hGaPiapDXincgi2Q ($17.70 in chips)
R+KjpH/wSjDLhtIy9+edNA: posts small blind $0.25
BAjwVL+zKKd0s0fAWstzQQ: posts big blind $0.50
*** HOLE CARDS ***
tdOvWynovql5imfooroLMg: folds
Rt6KgtZ8YaJoTc3FPim00w: folds
ZKazl1hGaPiapDXincgi2Q: calls $0.50
R+KjpH/wSjDLhtIy9+edNA: folds
BAjwVL+zKKd0s0fAWstzQQ: checks
*** FLOP *** [Js As 3d]
BAjwVL+zKKd0s0fAWstzQQ: checks
ZKazl1hGaPiapDXincgi2Q: checks
*** TURN *** [Js As 3d] [Kd]
BAjwVL+zKKd0s0fAWstzQQ: checks
ZKazl1hGaPiapDXincgi2Q: checks
*** RIVER *** [Js As 3d Kd] [Ks]
BAjwVL+zKKd0s0fAWstzQQ: checks
ZKazl1hGaPiapDXincgi2Q: checks
*** SHOW DOWN ***
BAjwVL+zKKd0s0fAWstzQQ: shows [2s 7d] (a pair of Kings)
ZKazl1hGaPiapDXincgi2Q: shows [Th 5d] (a pair of Kings - Ace+Jack+Ten kicker)
ZKazl1hGaPiapDXincgi2Q collected $1.20 from pot
*** SUMMARY ***
Total pot $1.25 | Rake $0.05
Board [Js As 3d Kd Ks]
Seat 1: R+KjpH/wSjDLhtIy9+edNA (small blind) folded before Flop
Seat 2: BAjwVL+zKKd0s0fAWstzQQ (big blind) showed [2s 7d] and lost with a pair of Kings
Seat 3: tdOvWynovql5imfooroLMg folded before Flop (didn't bet)
Seat 4: Rt6KgtZ8YaJoTc3FPim00w folded before Flop (didn't bet)
Seat 6: ZKazl1hGaPiapDXincgi2Q (button) showed [Th 5d] and won ($1.20) with a pair of Kings



PokerStars Game #59939244556:  Hold'em No Limit ($0.25/$0.50) - 2009/07/01 0:34:56 ET
Table 'E7bWJ45aoFXRpyRv2gw+Ig' 2-max Seat #2 is the button
Seat 1: FRkiRasEGlHUeLrEl+k/nA ($56.40 in chips)
Seat 2: 3Wro85I7472vJ4Wkpneo9A ($139.15 in chips)
3Wro85I7472vJ4Wkpneo9A: posts small blind $0.25
FRkiRasEGlHUeLrEl+k/nA: posts big blind $0.50
*** HOLE CARDS ***
3Wro85I7472vJ4Wkpneo9A: folds
FRkiRasEGlHUeLrEl+k/nA collected $0.50 from pot
FRkiRasEGlHUeLrEl+k/nA: doesn't show hand
*** SUMMARY ***
Total pot $0.50 | Rake $0
Seat 1: FRkiRasEGlHUeLrEl+k/nA (big blind) collected ($0.50)
Seat 2: 3Wro85I7472vJ4Wkpneo9A (button) (small blind) folded before Flop



PokerStars Game #59939244484:  Hold'em No Limit ($0.25/$0.50) - 2009/07/01 0:34:56 ET
Table '3FhG0gl3kMX3wBEEqj+wnQ' 9-max Seat #9 is the button
Seat 1: e0J9pdCNUDTCG031RnXqLA ($18 in chips)
Seat 2: 7cYQ+syUWjl38ty/ICOMhw ($50 in chips)
Seat 3: HZkVla4kK2SI42CVrPZ/ig ($8.75 in chips)
Seat 6: 5JJVDlaiMnB004o/RqbZZQ ($45.80 in chips)
Seat 7: mSD1pginDsyHG5PDfqzphw ($10 in chips)
Seat 8: j3K/Jujr7PY4ZM2RZvlH6A ($61.80 in chips)
Seat 9: L5e2lrPLQm1Pqx30IIZ/Fw ($10.10 in chips)
e0J9pdCNUDTCG031RnXqLA: posts small blind $0.25
7cYQ+syUWjl38ty/ICOMhw: posts big blind $0.50
bjvJtA9Hqscfznq66txaOQ: sits out
gsyXT42WLEcOS4DdEk2wlw: sits out
*** HOLE CARDS ***
HZkVla4kK2SI42CVrPZ/ig: folds
5JJVDlaiMnB004o/RqbZZQ: raises $2 to $2.50
mSD1pginDsyHG5PDfqzphw: folds
j3K/Jujr7PY4ZM2RZvlH6A: raises $5 to $7.50
L5e2lrPLQm1Pqx30IIZ/Fw: folds
e0J9pdCNUDTCG031RnXqLA: folds
7cYQ+syUWjl38ty/ICOMhw: folds
5JJVDlaiMnB004o/RqbZZQ: folds
j3K/Jujr7PY4ZM2RZvlH6A collected $5.75 from pot
j3K/Jujr7PY4ZM2RZvlH6A: doesn't show hand
*** SUMMARY ***
Total pot $5.75 | Rake $0
Seat 1: e0J9pdCNUDTCG031RnXqLA (small blind) folded before Flop
Seat 2: 7cYQ+syUWjl38ty/ICOMhw (big blind) folded before Flop
Seat 3: HZkVla4kK2SI42CVrPZ/ig folded before Flop (didn't bet)
Seat 6: 5JJVDlaiMnB004o/RqbZZQ folded before Flop
Seat 7: mSD1pginDsyHG5PDfqzphw folded before Flop (didn't bet)
Seat 8: j3K/Jujr7PY4ZM2RZvlH6A collected ($5.75)
Seat 9: L5e2lrPLQm1Pqx30IIZ/Fw (button) folded before Flop (didn't bet)



PokerStars Game #59939245778:  Hold'em No Limit ($0.25/$0.50) - 2009/07/01 0:34:58 ET
Table 'hSTs/dUsYLgJQuF2Onp0MQ' 6-max Seat #2 is the button
Seat 1: Donj3X7gYzeS5pAl7s9f+Q ($30.40 in chips)
Seat 2: 6vNxrjjCl6FwfaaymM9jjg ($33.35 in chips)
Seat 3: C3qJBo7uxfFVDluE1lmK2w ($29.50 in chips)
Seat 4: L0aIPg7qefDQjdJo3HCVEA ($8.90 in chips)
Seat 5: 686aeHikcJlgKkSuIFdcXQ ($59.90 in chips)
Seat 6: w0pd++ZQHijd9dDhKEYOAQ ($28.20 in chips)
C3qJBo7uxfFVDluE1lmK2w: posts small blind $0.25
L0aIPg7qefDQjdJo3HCVEA: posts big blind $0.50
*** HOLE CARDS ***
686aeHikcJlgKkSuIFdcXQ: folds
w0pd++ZQHijd9dDhKEYOAQ: raises $1 to $1.50
Donj3X7gYzeS5pAl7s9f+Q: folds
6vNxrjjCl6FwfaaymM9jjg: calls $1.50
C3qJBo7uxfFVDluE1lmK2w: folds
L0aIPg7qefDQjdJo3HCVEA: folds
*** FLOP *** [4s Jh 7d]
w0pd++ZQHijd9dDhKEYOAQ: bets $1.50
6vNxrjjCl6FwfaaymM9jjg: calls $1.50
*** TURN *** [4s Jh 7d] [Ts]
w0pd++ZQHijd9dDhKEYOAQ: checks
6vNxrjjCl6FwfaaymM9jjg: checks
*** RIVER *** [4s Jh 7d Ts] [Td]
w0pd++ZQHijd9dDhKEYOAQ: bets $5
6vNxrjjCl6FwfaaymM9jjg: folds
w0pd++ZQHijd9dDhKEYOAQ collected $6.45 from pot
*** SUMMARY ***
Total pot $6.75 | Rake $0.30
Board [4s Jh 7d Ts Td]
Seat 1: Donj3X7gYzeS5pAl7s9f+Q folded before Flop (didn't bet)
Seat 2: 6vNxrjjCl6FwfaaymM9jjg (button) folded on the River
Seat 3: C3qJBo7uxfFVDluE1lmK2w (small blind) folded before Flop
Seat 4: L0aIPg7qefDQjdJo3HCVEA (big blind) folded before Flop
Seat 5: 686aeHikcJlgKkSuIFdcXQ folded before Flop (didn't bet)
Seat 6: w0pd++ZQHijd9dDhKEYOAQ collected ($6.45)



PokerStars Game #59939246040:  Hold'em No Limit ($0.25/$0.50) - 2009/07/01 0:34:58 ET
Table 'QOgaEqMcJ73pcUMMxoisUg' 6-max Seat #3 is the button
Seat 1: OZ6OtYh5Y53MCH/p0QTn5g ($50 in chips)
Seat 3: Rt6KgtZ8YaJoTc3FPim00w ($51 in chips)
Seat 4: zAcsDhG/T128Vn7XGVSgKg ($63.65 in chips)
Seat 5: 6vNxrjjCl6FwfaaymM9jjg ($26.05 in chips)
Seat 6: pmE+2KJb4nffAVqjLIXxFg ($21.50 in chips)
zAcsDhG/T128Vn7XGVSgKg: posts small blind $0.25
6vNxrjjCl6FwfaaymM9jjg: posts big blind $0.50
4QfsCWthT/vSLirorNXqtg: sits out
*** HOLE CARDS ***
pmE+2KJb4nffAVqjLIXxFg: folds
OZ6OtYh5Y53MCH/p0QTn5g: folds
Rt6KgtZ8YaJoTc3FPim00w: folds
zAcsDhG/T128Vn7XGVSgKg: raises $1 to $1.50
6vNxrjjCl6FwfaaymM9jjg: calls $1
*** FLOP *** [Ts Qc Kh]
zAcsDhG/T128Vn7XGVSgKg: bets $2
6vNxrjjCl6FwfaaymM9jjg: raises $2 to $4
zAcsDhG/T128Vn7XGVSgKg: calls $2
*** TURN *** [Ts Qc Kh] [6s]
zAcsDhG/T128Vn7XGVSgKg: checks
6vNxrjjCl6FwfaaymM9jjg: bets $6
zAcsDhG/T128Vn7XGVSgKg: folds
6vNxrjjCl6FwfaaymM9jjg collected $10.50 from pot
*** SUMMARY ***
Total pot $11 | Rake $0.50
Board [Ts Qc Kh 6s]
Seat 1: OZ6OtYh5Y53MCH/p0QTn5g folded before Flop (didn't bet)
Seat 3: Rt6KgtZ8YaJoTc3FPim00w (button) folded before Flop (didn't bet)
Seat 4: zAcsDhG/T128Vn7XGVSgKg (small blind) folded on the Turn
Seat 5: 6vNxrjjCl6FwfaaymM9jjg (big blind) collected ($10.50)
Seat 6: pmE+2KJb4nffAVqjLIXxFg folded before Flop (didn't bet)



PokerStars Game #59939246466:  Hold'em No Limit ($0.25/$0.50) - 2009/07/01 0:34:59 ET
Table 'IeNZOZQ4T6oiaHqFeo6yIA' 2-max Seat #2 is the button
Seat 1: ndd1nfncBkWNitBnsfCoVQ ($70.55 in chips)
Seat 2: A91IUl5JaZROhtfCtnnwYw ($58.25 in chips)
A91IUl5JaZROhtfCtnnwYw: posts small blind $0.25
ndd1nfncBkWNitBnsfCoVQ: posts big blind $0.50
*** HOLE CARDS ***
A91IUl5JaZROhtfCtnnwYw: calls $0.25
ndd1nfncBkWNitBnsfCoVQ: checks
*** FLOP *** [5s Ac 2d]
ndd1nfncBkWNitBnsfCoVQ: checks
A91IUl5JaZROhtfCtnnwYw: bets $0.50
ndd1nfncBkWNitBnsfCoVQ: folds
A91IUl5JaZROhtfCtnnwYw collected $0.95 from pot
*** SUMMARY ***
Total pot $1 | Rake $0.05
Board [5s Ac 2d]
Seat 1: ndd1nfncBkWNitBnsfCoVQ (big blind) folded on the Flop
Seat 2: A91IUl5JaZROhtfCtnnwYw (button) (small blind) collected ($0.95)



PokerStars Game #59939247278:  Hold'em No Limit ($0.25/$0.50) - 2009/07/01 0:35:00 ET
Table '+dXkOAQyS8j9PQZusUTMpg' 2-max Seat #1 is the button
Seat 1: XFa6sBGjP2gxoIvxR3fZIg ($67.75 in chips)
Seat 2: 5IBeOgaApY1Bvzv2P8X4EA ($74.35 in chips)
XFa6sBGjP2gxoIvxR3fZIg: posts small blind $0.25
5IBeOgaApY1Bvzv2P8X4EA: posts big blind $0.50
*** HOLE CARDS ***
XFa6sBGjP2gxoIvxR3fZIg: raises $1 to $1.50
5IBeOgaApY1Bvzv2P8X4EA: raises $1.50 to $3
XFa6sBGjP2gxoIvxR3fZIg: raises $8.50 to $11.50
5IBeOgaApY1Bvzv2P8X4EA: raises $62.85 to $74.35 and is all-in
XFa6sBGjP2gxoIvxR3fZIg said, "hmmhmmhmm"
5IBeOgaApY1Bvzv2P8X4EA said, "jajajajajja:D"
XFa6sBGjP2gxoIvxR3fZIg said, "I think I have to call, gl"
XFa6sBGjP2gxoIvxR3fZIg: calls $56.25 and is all-in
*** FLOP *** [6d Jh 3h]
*** TURN *** [6d Jh 3h] [2s]
5IBeOgaApY1Bvzv2P8X4EA said, "gl"
*** RIVER *** [6d Jh 3h 2s] [9c]
*** SHOW DOWN ***
5IBeOgaApY1Bvzv2P8X4EA: shows [Ah Ad] (a pair of Aces)
XFa6sBGjP2gxoIvxR3fZIg: mucks hand
5IBeOgaApY1Bvzv2P8X4EA collected $135 from pot
*** SUMMARY ***
Total pot $135.50 | Rake $0.50
Board [6d Jh 3h 2s 9c]
Seat 1: XFa6sBGjP2gxoIvxR3fZIg (button) (small blind) mucked
Seat 2: 5IBeOgaApY1Bvzv2P8X4EA (big blind) showed [Ah Ad] and won ($135) with a pair of Aces



PokerStars Game #59939249430:  Hold'em No Limit ($0.25/$0.50) - 2009/07/01 0:35:03 ET
Table 'otvGDROEDdqsabxskT79qg' 9-max Seat #1 is the button
Seat 1: 8ehL7qlZzjgUh2H35iiWLw ($56 in chips)
Seat 2: cCjTzH9jio8607WzjcfXlg ($9 in chips)
Seat 3: +k7T5ocke8UwavtgUHm+Cg ($74.65 in chips)
Seat 4: MG90wfSJZnOejs/KD3vlQQ ($56.15 in chips)
Seat 5: XNMDwbXt/Q4jM99AXnbJDw ($55.55 in chips)
Seat 6: bxLSulbgr8LmKNjOzw8URg ($49.25 in chips)
Seat 7: C7+tBppJrKgd/r+tuKUIpA ($34.15 in chips)
Seat 8: zE9cVigS2nW/Ljy4K4bUQA ($30 in chips)
Seat 9: KcY3X8YpD74Kw1RHkx/g4A ($66.50 in chips)
cCjTzH9jio8607WzjcfXlg: posts small blind $0.25
+k7T5ocke8UwavtgUHm+Cg: posts big blind $0.50
*** HOLE CARDS ***
MG90wfSJZnOejs/KD3vlQQ: folds
XNMDwbXt/Q4jM99AXnbJDw: folds
bxLSulbgr8LmKNjOzw8URg: folds
C7+tBppJrKgd/r+tuKUIpA: folds
zE9cVigS2nW/Ljy4K4bUQA: folds
KcY3X8YpD74Kw1RHkx/g4A: calls $0.50
8ehL7qlZzjgUh2H35iiWLw: folds
cCjTzH9jio8607WzjcfXlg: calls $0.25
+k7T5ocke8UwavtgUHm+Cg: checks
*** FLOP *** [Ks Kd 6c]
cCjTzH9jio8607WzjcfXlg: checks
+k7T5ocke8UwavtgUHm+Cg: checks
KcY3X8YpD74Kw1RHkx/g4A: checks
*** TURN *** [Ks Kd 6c] [Kc]
cCjTzH9jio8607WzjcfXlg: checks
+k7T5ocke8UwavtgUHm+Cg: checks
KcY3X8YpD74Kw1RHkx/g4A: checks
*** RIVER *** [Ks Kd 6c Kc] [5c]
cCjTzH9jio8607WzjcfXlg: checks
+k7T5ocke8UwavtgUHm+Cg: checks
KcY3X8YpD74Kw1RHkx/g4A: checks
*** SHOW DOWN ***
cCjTzH9jio8607WzjcfXlg: shows [2d Ad] (three of a kind, Kings)
+k7T5ocke8UwavtgUHm+Cg: shows [2s 5s] (a full house, Kings full of Fives)
KcY3X8YpD74Kw1RHkx/g4A: mucks hand
+k7T5ocke8UwavtgUHm+Cg collected $1.45 from pot
*** SUMMARY ***
Total pot $1.50 | Rake $0.05
Board [Ks Kd 6c Kc 5c]
Seat 1: 8ehL7qlZzjgUh2H35iiWLw (button) folded before Flop (didn't bet)
Seat 2: cCjTzH9jio8607WzjcfXlg (small blind) showed [2d Ad] and lost with three of a kind, Kings
Seat 3: +k7T5ocke8UwavtgUHm+Cg (big blind) showed [2s 5s] and won ($1.45) with a full house, Kings full of Fives
Seat 4: MG90wfSJZnOejs/KD3vlQQ folded before Flop (didn't bet)
Seat 5: XNMDwbXt/Q4jM99AXnbJDw folded before Flop (didn't bet)
Seat 6: bxLSulbgr8LmKNjOzw8URg folded before Flop (didn't bet)
Seat 7: C7+tBppJrKgd/r+tuKUIpA folded before Flop (didn't bet)
Seat 8: zE9cVigS2nW/Ljy4K4bUQA folded before Flop (didn't bet)
Seat 9: KcY3X8YpD74Kw1RHkx/g4A mucked



PokerStars Game #59939249744:  Hold'em No Limit ($0.25/$0.50) - 2009/07/01 0:35:04 ET
Table 'E7bWJ45aoFXRpyRv2gw+Ig' 2-max Seat #1 is the button
Seat 1: FRkiRasEGlHUeLrEl+k/nA ($56.65 in chips)
Seat 2: 3Wro85I7472vJ4Wkpneo9A ($138.90 in chips)
FRkiRasEGlHUeLrEl+k/nA: posts small blind $0.25
3Wro85I7472vJ4Wkpneo9A: posts big blind $0.50
*** HOLE CARDS ***
FRkiRasEGlHUeLrEl+k/nA: raises $1 to $1.50
3Wro85I7472vJ4Wkpneo9A: folds
FRkiRasEGlHUeLrEl+k/nA collected $1 from pot
*** SUMMARY ***
Total pot $1 | Rake $0
Seat 1: FRkiRasEGlHUeLrEl+k/nA (button) (small blind) collected ($1)
Seat 2: 3Wro85I7472vJ4Wkpneo9A (big blind) folded before Flop



PokerStars Game #59939251180:  Hold'em No Limit ($0.25/$0.50) - 2009/07/01 0:35:06 ET
Table 'MJxeZCzYELxiIsyUZyT0jw' 6-max Seat #4 is the button
Seat 2: dB6jzDlJmET84VMWw1mTRA ($50.75 in chips)
Seat 3: JQZew0FjzS19kTjeNtrE+A ($50 in chips)
Seat 4: lP7Q6pewz4C2RsAfKsjdWw ($33.05 in chips)
Seat 5: 3jvoOXNtXE90w2BdfNZwZQ ($50 in chips)
Seat 6: TTx3CHxyi0SObcHyMJRp5w ($63.70 in chips)
3jvoOXNtXE90w2BdfNZwZQ: posts small blind $0.25
TTx3CHxyi0SObcHyMJRp5w: posts big blind $0.50
tdOvWynovql5imfooroLMg: sits out
*** HOLE CARDS ***
dB6jzDlJmET84VMWw1mTRA: folds
JQZew0FjzS19kTjeNtrE+A: folds
lP7Q6pewz4C2RsAfKsjdWw: raises $1.50 to $2
3jvoOXNtXE90w2BdfNZwZQ: folds
TTx3CHxyi0SObcHyMJRp5w: folds
lP7Q6pewz4C2RsAfKsjdWw collected $1.25 from pot
lP7Q6pewz4C2RsAfKsjdWw: doesn't show hand
*** SUMMARY ***
Total pot $1.25 | Rake $0
Seat 2: dB6jzDlJmET84VMWw1mTRA folded before Flop (didn't bet)
Seat 3: JQZew0FjzS19kTjeNtrE+A folded before Flop (didn't bet)
Seat 4: lP7Q6pewz4C2RsAfKsjdWw (button) collected ($1.25)
Seat 5: 3jvoOXNtXE90w2BdfNZwZQ (small blind) folded before Flop
Seat 6: TTx3CHxyi0SObcHyMJRp5w (big blind) folded before Flop



PokerStars Game #59939252982:  Hold'em No Limit ($0.25/$0.50) - 2009/07/01 0:35:09 ET
Table 'mTxf8gPLgffN3Iwfm7Icfg' 2-max Seat #1 is the button
Seat 1: Do9Rlu1R5u/AcRtMTl8SYg ($74.45 in chips)
Seat 2: EMc5LPgVaded4Qc77vm0fw ($83.80 in chips)
Do9Rlu1R5u/AcRtMTl8SYg: posts small blind $0.25
EMc5LPgVaded4Qc77vm0fw: posts big blind $0.50
*** HOLE CARDS ***
Do9Rlu1R5u/AcRtMTl8SYg: raises $1 to $1.50
EMc5LPgVaded4Qc77vm0fw: folds
Do9Rlu1R5u/AcRtMTl8SYg collected $1 from pot
Do9Rlu1R5u/AcRtMTl8SYg: doesn't show hand
*** SUMMARY ***
Total pot $1 | Rake $0
Seat 1: Do9Rlu1R5u/AcRtMTl8SYg (button) (small blind) collected ($1)
Seat 2: EMc5LPgVaded4Qc77vm0fw (big blind) folded before Flop



PokerStars Game #59939253006:  Hold'em No Limit ($0.25/$0.50) - 2009/07/01 0:35:09 ET
Table 'Nz0Vr7WMHL2g5Uk7dDZjpw' 9-max Seat #6 is the button
Seat 2: XNMDwbXt/Q4jM99AXnbJDw ($67.45 in chips)
Seat 3: 4QTiNH5fteLgJjx/s6Hy6A ($13.85 in chips)
Seat 4: 5JJVDlaiMnB004o/RqbZZQ ($27.25 in chips)
Seat 5: WGW0DgjBUXs1ylURHG8vnQ ($16.45 in chips)
Seat 6: k1f0lS7tlMHCLGs0JT34Tg ($14 in chips)
Seat 7: KPLH0gELgFe2OuAnhJFI5w ($26 in chips)
Seat 8: HkZI6g4zl83TDTA7SRspmQ ($16.45 in chips)
Seat 9: Ak2W6V2TDVIQrvSAy4eD7Q ($50 in chips)
KPLH0gELgFe2OuAnhJFI5w: posts small blind $0.25
HkZI6g4zl83TDTA7SRspmQ: posts big blind $0.50
tLkxo7JgV+WWI0UBw44K5A: sits out
*** HOLE CARDS ***
Ak2W6V2TDVIQrvSAy4eD7Q: folds
XNMDwbXt/Q4jM99AXnbJDw: folds
4QTiNH5fteLgJjx/s6Hy6A: calls $0.50
5JJVDlaiMnB004o/RqbZZQ: folds
WGW0DgjBUXs1ylURHG8vnQ: folds
k1f0lS7tlMHCLGs0JT34Tg: calls $0.50
KPLH0gELgFe2OuAnhJFI5w: calls $0.25
HkZI6g4zl83TDTA7SRspmQ: checks
*** FLOP *** [As 9c 7h]
KPLH0gELgFe2OuAnhJFI5w: checks
HkZI6g4zl83TDTA7SRspmQ: checks
4QTiNH5fteLgJjx/s6Hy6A: bets $1
k1f0lS7tlMHCLGs0JT34Tg: folds
KPLH0gELgFe2OuAnhJFI5w: folds
HkZI6g4zl83TDTA7SRspmQ: folds
4QTiNH5fteLgJjx/s6Hy6A collected $1.90 from pot
*** SUMMARY ***
Total pot $2 | Rake $0.10
Board [As 9c 7h]
Seat 2: XNMDwbXt/Q4jM99AXnbJDw folded before Flop (didn't bet)
Seat 3: 4QTiNH5fteLgJjx/s6Hy6A collected ($1.90)
Seat 4: 5JJVDlaiMnB004o/RqbZZQ folded before Flop (didn't bet)
Seat 5: WGW0DgjBUXs1ylURHG8vnQ folded before Flop (didn't bet)
Seat 6: k1f0lS7tlMHCLGs0JT34Tg (button) folded on the Flop
Seat 7: KPLH0gELgFe2OuAnhJFI5w (small blind) folded on the Flop
Seat 8: HkZI6g4zl83TDTA7SRspmQ (big blind) folded on the Flop
Seat 9: Ak2W6V2TDVIQrvSAy4eD7Q folded before Flop (didn't bet)



PokerStars Game #59939255374:  Hold'em No Limit ($0.25/$0.50) - 2009/07/01 0:35:12 ET
Table 'E7bWJ45aoFXRpyRv2gw+Ig' 2-max Seat #2 is the button
Seat 1: FRkiRasEGlHUeLrEl+k/nA ($57.15 in chips)
Seat 2: 3Wro85I7472vJ4Wkpneo9A ($138.40 in chips)
3Wro85I7472vJ4Wkpneo9A: posts small blind $0.25
FRkiRasEGlHUeLrEl+k/nA: posts big blind $0.50
*** HOLE CARDS ***
3Wro85I7472vJ4Wkpneo9A: raises $1 to $1.50
FRkiRasEGlHUeLrEl+k/nA: folds
3Wro85I7472vJ4Wkpneo9A collected $1 from pot
3Wro85I7472vJ4Wkpneo9A: doesn't show hand
*** SUMMARY ***
Total pot $1 | Rake $0
Seat 1: FRkiRasEGlHUeLrEl+k/nA (big blind) folded before Flop
Seat 2: 3Wro85I7472vJ4Wkpneo9A (button) (small blind) collected ($1)



PokerStars Game #59939257934:  Hold'em No Limit ($0.25/$0.50) - 2009/07/01 0:35:16 ET
Table 'GfL/No5u5PoEnU39lP5pQg' 6-max Seat #5 is the button
Seat 1: 1WUCqNG+p+vfWRTXNu4ljw ($50 in chips)
Seat 2: uVwggSetzp7d+eVgowO3vg ($54.30 in chips)
Seat 3: NbUTppWfym/RxV/DmDz2Sw ($14.60 in chips)
Seat 4: x+pzUFJsMIiGd7a5pcR4tg ($53.85 in chips)
Seat 5: crjGpJEzSZgD38FoE3VMGg ($59.60 in chips)
1WUCqNG+p+vfWRTXNu4ljw: posts small blind $0.25
uVwggSetzp7d+eVgowO3vg: posts big blind $0.50
*** HOLE CARDS ***
NbUTppWfym/RxV/DmDz2Sw: folds
x+pzUFJsMIiGd7a5pcR4tg: raises $1 to $1.50
crjGpJEzSZgD38FoE3VMGg: folds
1WUCqNG+p+vfWRTXNu4ljw: raises $4.50 to $6
uVwggSetzp7d+eVgowO3vg: folds
x+pzUFJsMIiGd7a5pcR4tg: folds
1WUCqNG+p+vfWRTXNu4ljw collected $3.50 from pot
*** SUMMARY ***
Total pot $3.50 | Rake $0
Seat 1: 1WUCqNG+p+vfWRTXNu4ljw (small blind) collected ($3.50)
Seat 2: uVwggSetzp7d+eVgowO3vg (big blind) folded before Flop
Seat 3: NbUTppWfym/RxV/DmDz2Sw folded before Flop (didn't bet)
Seat 4: x+pzUFJsMIiGd7a5pcR4tg folded before Flop
Seat 5: crjGpJEzSZgD38FoE3VMGg (button) folded before Flop (didn't bet)



PokerStars Game #59939258016:  Hold'em No Limit ($0.25/$0.50) - 2009/07/01 0:35:17 ET
Table '5EmHi+fnatGQQShcNmzOZQ' 6-max Seat #3 is the button
Seat 1: SwPczQo3cOtwEzhJrfO2cQ ($29.25 in chips)
Seat 2: vXIHnZ+dv/hwSBxyvGw7bQ ($50 in chips)
Seat 3: L9qfLYXrczhAPd/VckgsWw ($91.25 in chips)
Seat 5: kxPhs4ePFqMy52CInAJ2aw ($53.35 in chips)
Seat 6: 686aeHikcJlgKkSuIFdcXQ ($138.65 in chips)
1b+2BbjMN8qhR1WPqdE9VQ will be allowed to play after the button
kxPhs4ePFqMy52CInAJ2aw: posts small blind $0.25
686aeHikcJlgKkSuIFdcXQ: posts big blind $0.50
*** HOLE CARDS ***
SwPczQo3cOtwEzhJrfO2cQ: raises $1 to $1.50
vXIHnZ+dv/hwSBxyvGw7bQ: raises $3.50 to $5
L9qfLYXrczhAPd/VckgsWw: folds
kxPhs4ePFqMy52CInAJ2aw: folds
686aeHikcJlgKkSuIFdcXQ: folds
SwPczQo3cOtwEzhJrfO2cQ: calls $3.50
*** FLOP *** [2h 3h Th]
SwPczQo3cOtwEzhJrfO2cQ: bets $4
vXIHnZ+dv/hwSBxyvGw7bQ: raises $8 to $12
SwPczQo3cOtwEzhJrfO2cQ: calls $8
*** TURN *** [2h 3h Th] [3c]
SwPczQo3cOtwEzhJrfO2cQ: checks
vXIHnZ+dv/hwSBxyvGw7bQ: bets $18
SwPczQo3cOtwEzhJrfO2cQ: calls $12.25 and is all-in
*** RIVER *** [2h 3h Th 3c] [Kc]
*** SHOW DOWN ***
SwPczQo3cOtwEzhJrfO2cQ: shows [5h 5c] (two pair, Fives and Threes)
vXIHnZ+dv/hwSBxyvGw7bQ: shows [Kh Qh] (a flush, King high)
vXIHnZ+dv/hwSBxyvGw7bQ collected $57.25 from pot
*** SUMMARY ***
Total pot $59.25 | Rake $2
Board [2h 3h Th 3c Kc]
Seat 1: SwPczQo3cOtwEzhJrfO2cQ showed [5h 5c] and lost with two pair, Fives and Threes
Seat 2: vXIHnZ+dv/hwSBxyvGw7bQ showed [Kh Qh] and won ($57.25) with a flush, King high
Seat 3: L9qfLYXrczhAPd/VckgsWw (button) folded before Flop (didn't bet)
Seat 5: kxPhs4ePFqMy52CInAJ2aw (small blind) folded before Flop
Seat 6: 686aeHikcJlgKkSuIFdcXQ (big blind) folded before Flop



PokerStars Game #59939258128:  Hold'em No Limit ($0.25/$0.50) - 2009/07/01 0:35:17 ET
Table 'mTxf8gPLgffN3Iwfm7Icfg' 2-max Seat #2 is the button
Seat 1: Do9Rlu1R5u/AcRtMTl8SYg ($74.95 in chips)
Seat 2: EMc5LPgVaded4Qc77vm0fw ($83.30 in chips)
EMc5LPgVaded4Qc77vm0fw: posts small blind $0.25
Do9Rlu1R5u/AcRtMTl8SYg: posts big blind $0.50
*** HOLE CARDS ***
EMc5LPgVaded4Qc77vm0fw: folds
Do9Rlu1R5u/AcRtMTl8SYg collected $0.50 from pot
Do9Rlu1R5u/AcRtMTl8SYg: doesn't show hand
*** SUMMARY ***
Total pot $0.50 | Rake $0
Seat 1: Do9Rlu1R5u/AcRtMTl8SYg (big blind) collected ($0.50)
Seat 2: EMc5LPgVaded4Qc77vm0fw (button) (small blind) folded before Flop



PokerStars Game #59939259080:  Hold'em No Limit ($0.25/$0.50) - 2009/07/01 0:35:18 ET
Table 'IeNZOZQ4T6oiaHqFeo6yIA' 2-max Seat #1 is the button
Seat 1: ndd1nfncBkWNitBnsfCoVQ ($70.05 in chips)
Seat 2: A91IUl5JaZROhtfCtnnwYw ($58.70 in chips)
ndd1nfncBkWNitBnsfCoVQ: posts small blind $0.25
A91IUl5JaZROhtfCtnnwYw: posts big blind $0.50
*** HOLE CARDS ***
ndd1nfncBkWNitBnsfCoVQ: raises $1 to $1.50
A91IUl5JaZROhtfCtnnwYw: raises $1 to $2.50
ndd1nfncBkWNitBnsfCoVQ: calls $1
*** FLOP *** [5h Kd 4s]
A91IUl5JaZROhtfCtnnwYw: bets $3.50
ndd1nfncBkWNitBnsfCoVQ: calls $3.50
*** TURN *** [5h Kd 4s] [Qd]
A91IUl5JaZROhtfCtnnwYw: bets $4
ndd1nfncBkWNitBnsfCoVQ: raises $8 to $12
A91IUl5JaZROhtfCtnnwYw: raises $8 to $20
ndd1nfncBkWNitBnsfCoVQ: folds
A91IUl5JaZROhtfCtnnwYw collected $35.50 from pot
A91IUl5JaZROhtfCtnnwYw: doesn't show hand
*** SUMMARY ***
Total pot $36 | Rake $0.50
Board [5h Kd 4s Qd]
Seat 1: ndd1nfncBkWNitBnsfCoVQ (button) (small blind) folded on the Turn
Seat 2: A91IUl5JaZROhtfCtnnwYw (big blind) collected ($35.50)



PokerStars Game #59939259340:  Hold'em No Limit ($0.25/$0.50) - 2009/07/01 0:35:18 ET
Table 'T/PgNWqVyY6lkldcBVXYJQ' 6-max Seat #2 is the button
Seat 1: +Pf9jTVizYlIo+woPvptfA ($57.25 in chips)
Seat 2: oZAeY5rVqNGgt8yyQ0pxbA ($38.20 in chips)
Seat 3: L3OcNO1bgdqDI46j67KQPQ ($54.10 in chips)
Seat 4: otJMdCRvqd5YCcFsA3JWpg ($10 in chips)
Seat 5: vVQBckETtigfb5mAcyK0OA ($49.20 in chips)
Seat 6: cDzbog6kwmJp+LBeBq+iMQ ($43.75 in chips)
L3OcNO1bgdqDI46j67KQPQ: posts small blind $0.25
otJMdCRvqd5YCcFsA3JWpg: posts big blind $0.50
*** HOLE CARDS ***
vVQBckETtigfb5mAcyK0OA: calls $0.50
cDzbog6kwmJp+LBeBq+iMQ: calls $0.50
+Pf9jTVizYlIo+woPvptfA: folds
oZAeY5rVqNGgt8yyQ0pxbA: calls $0.50
L3OcNO1bgdqDI46j67KQPQ: folds
otJMdCRvqd5YCcFsA3JWpg: checks
*** FLOP *** [2c 6h 8c]
otJMdCRvqd5YCcFsA3JWpg: checks
vVQBckETtigfb5mAcyK0OA: bets $1
cDzbog6kwmJp+LBeBq+iMQ: calls $1
oZAeY5rVqNGgt8yyQ0pxbA: folds
otJMdCRvqd5YCcFsA3JWpg: folds
*** TURN *** [2c 6h 8c] [9h]
vVQBckETtigfb5mAcyK0OA: bets $0.50
cDzbog6kwmJp+LBeBq+iMQ: calls $0.50
*** RIVER *** [2c 6h 8c 9h] [Kc]
vVQBckETtigfb5mAcyK0OA: bets $0.50
cDzbog6kwmJp+LBeBq+iMQ: calls $0.50
*** SHOW DOWN ***
vVQBckETtigfb5mAcyK0OA: shows [8d 7h] (a pair of Eights)
cDzbog6kwmJp+LBeBq+iMQ: mucks hand
vVQBckETtigfb5mAcyK0OA collected $5.95 from pot
*** SUMMARY ***
Total pot $6.25 | Rake $0.30
Board [2c 6h 8c 9h Kc]
Seat 1: +Pf9jTVizYlIo+woPvptfA folded before Flop (didn't bet)
Seat 2: oZAeY5rVqNGgt8yyQ0pxbA (button) folded on the Flop
Seat 3: L3OcNO1bgdqDI46j67KQPQ (small blind) folded before Flop
Seat 4: otJMdCRvqd5YCcFsA3JWpg (big blind) folded on the Flop
Seat 5: vVQBckETtigfb5mAcyK0OA showed [8d 7h] and won ($5.95) with a pair of Eights
Seat 6: cDzbog6kwmJp+LBeBq+iMQ mucked



PokerStars Game #59939261362:  Hold'em No Limit ($0.25/$0.50) - 2009/07/01 0:35:21 ET
Table 'E7bWJ45aoFXRpyRv2gw+Ig' 2-max Seat #1 is the button
Seat 1: FRkiRasEGlHUeLrEl+k/nA ($56.65 in chips)
Seat 2: 3Wro85I7472vJ4Wkpneo9A ($138.90 in chips)
FRkiRasEGlHUeLrEl+k/nA: posts small blind $0.25
3Wro85I7472vJ4Wkpneo9A: posts big blind $0.50
*** HOLE CARDS ***
FRkiRasEGlHUeLrEl+k/nA: calls $0.25
3Wro85I7472vJ4Wkpneo9A: checks
*** FLOP *** [7h 6h Ks]
3Wro85I7472vJ4Wkpneo9A: checks
FRkiRasEGlHUeLrEl+k/nA: bets $1
3Wro85I7472vJ4Wkpneo9A: folds
FRkiRasEGlHUeLrEl+k/nA collected $0.95 from pot
FRkiRasEGlHUeLrEl+k/nA: doesn't show hand
*** SUMMARY ***
Total pot $1 | Rake $0.05
Board [7h 6h Ks]
Seat 1: FRkiRasEGlHUeLrEl+k/nA (button) (small blind) collected ($0.95)
Seat 2: 3Wro85I7472vJ4Wkpneo9A (big blind) folded on the Flop



PokerStars Game #59939262452:  Hold'em No Limit ($0.25/$0.50) - 2009/07/01 0:35:23 ET
Table 'mTxf8gPLgffN3Iwfm7Icfg' 2-max Seat #1 is the button
Seat 1: Do9Rlu1R5u/AcRtMTl8SYg ($75.20 in chips)
Seat 2: EMc5LPgVaded4Qc77vm0fw ($83.05 in chips)
Do9Rlu1R5u/AcRtMTl8SYg: posts small blind $0.25
EMc5LPgVaded4Qc77vm0fw: posts big blind $0.50
*** HOLE CARDS ***
Do9Rlu1R5u/AcRtMTl8SYg: folds
EMc5LPgVaded4Qc77vm0fw collected $0.50 from pot
EMc5LPgVaded4Qc77vm0fw: doesn't show hand
*** SUMMARY ***
Total pot $0.50 | Rake $0
Seat 1: Do9Rlu1R5u/AcRtMTl8SYg (button) (small blind) folded before Flop
Seat 2: EMc5LPgVaded4Qc77vm0fw (big blind) collected ($0.50)



PokerStars Game #59939262348:  Hold'em No Limit ($0.25/$0.50) - 2009/07/01 0:35:23 ET
Table 'kgbJRsxfv64KrErDRBAkcw' 6-max Seat #6 is the button
Seat 1: mxTUARCsU8Eby0whmHNcOw ($6 in chips)
Seat 2: Q+thC23WCv1kJUJtH/+4Jw ($58.80 in chips)
Seat 3: T0Gx/FcQ5VH9u7XaOMX97A ($82.10 in chips)
Seat 4: qanMEqjABjWxC/JgQ/0l7w ($55.45 in chips)
Seat 5: +Pf9jTVizYlIo+woPvptfA ($51.55 in chips)
Seat 6: ozrlafxxh1HmYdA0/h+MuA ($16.95 in chips)
mxTUARCsU8Eby0whmHNcOw: posts small blind $0.25
Q+thC23WCv1kJUJtH/+4Jw: posts big blind $0.50
*** HOLE CARDS ***
T0Gx/FcQ5VH9u7XaOMX97A: raises $1 to $1.50
qanMEqjABjWxC/JgQ/0l7w: folds
+Pf9jTVizYlIo+woPvptfA: folds
ozrlafxxh1HmYdA0/h+MuA: calls $1.50
mxTUARCsU8Eby0whmHNcOw: raises $4.50 to $6 and is all-in
Q+thC23WCv1kJUJtH/+4Jw: calls $5.50
T0Gx/FcQ5VH9u7XaOMX97A: calls $4.50
ozrlafxxh1HmYdA0/h+MuA: calls $4.50
*** FLOP *** [As Tc 3h]
Q+thC23WCv1kJUJtH/+4Jw: checks
T0Gx/FcQ5VH9u7XaOMX97A: checks
ozrlafxxh1HmYdA0/h+MuA: checks
*** TURN *** [As Tc 3h] [2s]
Q+thC23WCv1kJUJtH/+4Jw: checks
T0Gx/FcQ5VH9u7XaOMX97A: bets $13
ozrlafxxh1HmYdA0/h+MuA: calls $10.95 and is all-in
Q+thC23WCv1kJUJtH/+4Jw: folds
*** RIVER *** [As Tc 3h 2s] [5c]
*** SHOW DOWN ***
T0Gx/FcQ5VH9u7XaOMX97A: shows [Ad Qh] (a pair of Aces)
ozrlafxxh1HmYdA0/h+MuA: mucks hand
T0Gx/FcQ5VH9u7XaOMX97A collected $20.90 from side pot
mxTUARCsU8Eby0whmHNcOw: mucks hand
T0Gx/FcQ5VH9u7XaOMX97A collected $22.80 from main pot
*** SUMMARY ***
Total pot $45.90 Main pot $22.80. Side pot $20.90. | Rake $2.20
Board [As Tc 3h 2s 5c]
Seat 1: mxTUARCsU8Eby0whmHNcOw (small blind) mucked
Seat 2: Q+thC23WCv1kJUJtH/+4Jw (big blind) folded on the Turn
Seat 3: T0Gx/FcQ5VH9u7XaOMX97A showed [Ad Qh] and won ($43.70) with a pair of Aces
Seat 4: qanMEqjABjWxC/JgQ/0l7w folded before Flop (didn't bet)
Seat 5: +Pf9jTVizYlIo+woPvptfA folded before Flop (didn't bet)
Seat 6: ozrlafxxh1HmYdA0/h+MuA (button) mucked



PokerStars Game #59939262212:  Hold'em No Limit ($0.25/$0.50) - 2009/07/01 0:35:23 ET
Table 'tyR5AZNKV8Aadbrnrnlg7g' 6-max Seat #1 is the button
Seat 1: R+KjpH/wSjDLhtIy9+edNA ($84.40 in chips)
Seat 2: BAjwVL+zKKd0s0fAWstzQQ ($18.15 in chips)
Seat 3: tdOvWynovql5imfooroLMg ($48 in chips)
Seat 4: Rt6KgtZ8YaJoTc3FPim00w ($83.20 in chips)
Seat 6: ZKazl1hGaPiapDXincgi2Q ($18.40 in chips)
BAjwVL+zKKd0s0fAWstzQQ: posts small blind $0.25
tdOvWynovql5imfooroLMg: posts big blind $0.50
*** HOLE CARDS ***
Rt6KgtZ8YaJoTc3FPim00w: folds
ZKazl1hGaPiapDXincgi2Q: calls $0.50
R+KjpH/wSjDLhtIy9+edNA: folds
BAjwVL+zKKd0s0fAWstzQQ: folds
tdOvWynovql5imfooroLMg: checks
*** FLOP *** [5d 9c Kd]
tdOvWynovql5imfooroLMg: checks
ZKazl1hGaPiapDXincgi2Q: checks
*** TURN *** [5d 9c Kd] [6c]
tdOvWynovql5imfooroLMg: bets $0.50
ZKazl1hGaPiapDXincgi2Q: folds
tdOvWynovql5imfooroLMg collected $1.20 from pot
*** SUMMARY ***
Total pot $1.25 | Rake $0.05
Board [5d 9c Kd 6c]
Seat 1: R+KjpH/wSjDLhtIy9+edNA (button) folded before Flop (didn't bet)
Seat 2: BAjwVL+zKKd0s0fAWstzQQ (small blind) folded before Flop
Seat 3: tdOvWynovql5imfooroLMg (big blind) collected ($1.20)
Seat 4: Rt6KgtZ8YaJoTc3FPim00w folded before Flop (didn't bet)
Seat 6: ZKazl1hGaPiapDXincgi2Q folded on the Turn



PokerStars Game #59939263240:  Hold'em No Limit ($0.25/$0.50) - 2009/07/01 0:35:24 ET
Table 'lSisgp6H7Fg1hH5VfjEjYQ' 9-max Seat #7 is the button
Seat 1: pEW8B6uXbdR47kfljMQ3+Q ($37.85 in chips)
Seat 2: UrcnkQOiLVk8BlKDPJSy7Q ($52.30 in chips)
Seat 3: aTkyjTh3w5YLWiIERupZOA ($42.45 in chips)
Seat 4: bwv/rbH/hHhPhY6u9mu04w ($21.65 in chips)
Seat 5: mSD1pginDsyHG5PDfqzphw ($10 in chips)
Seat 6: +k7T5ocke8UwavtgUHm+Cg ($28.95 in chips)
Seat 7: Y3DZ6qQlLeBhixDj4M9vmg ($12.50 in chips)
Seat 8: a4JDWmpFQkL10XfAyuF51A ($35 in chips)
a4JDWmpFQkL10XfAyuF51A: posts small blind $0.25
5JJVDlaiMnB004o/RqbZZQ: is sitting out
pEW8B6uXbdR47kfljMQ3+Q: posts big blind $0.50
*** HOLE CARDS ***
5JJVDlaiMnB004o/RqbZZQ leaves the table
UrcnkQOiLVk8BlKDPJSy7Q: folds
aTkyjTh3w5YLWiIERupZOA: folds
bwv/rbH/hHhPhY6u9mu04w: folds
mSD1pginDsyHG5PDfqzphw: raises $1 to $1.50
+k7T5ocke8UwavtgUHm+Cg: folds
gsyXT42WLEcOS4DdEk2wlw joins the table at seat #9
Y3DZ6qQlLeBhixDj4M9vmg: calls $1.50
a4JDWmpFQkL10XfAyuF51A: folds
pEW8B6uXbdR47kfljMQ3+Q: folds
*** FLOP *** [8d 5s 9c]
mSD1pginDsyHG5PDfqzphw: bets $2
Y3DZ6qQlLeBhixDj4M9vmg: folds
mSD1pginDsyHG5PDfqzphw collected $3.60 from pot
mSD1pginDsyHG5PDfqzphw: doesn't show hand
*** SUMMARY ***
Total pot $3.75 | Rake $0.15
Board [8d 5s 9c]
Seat 1: pEW8B6uXbdR47kfljMQ3+Q (big blind) folded before Flop
Seat 2: UrcnkQOiLVk8BlKDPJSy7Q folded before Flop (didn't bet)
Seat 3: aTkyjTh3w5YLWiIERupZOA folded before Flop (didn't bet)
Seat 4: bwv/rbH/hHhPhY6u9mu04w folded before Flop (didn't bet)
Seat 5: mSD1pginDsyHG5PDfqzphw collected ($3.60)
Seat 6: +k7T5ocke8UwavtgUHm+Cg folded before Flop (didn't bet)
Seat 7: Y3DZ6qQlLeBhixDj4M9vmg (button) folded on the Flop
Seat 8: a4JDWmpFQkL10XfAyuF51A (small blind) folded before Flop



PokerStars Game #59939264766:  Hold'em No Limit ($0.25/$0.50) - 2009/07/01 0:35:26 ET
Table '+z1aekfHkpp09pc8F9aViw' 6-max Seat #4 is the button
Seat 1: FHilMb2i2DbUCc9lplszog ($47.60 in chips)
Seat 2: M6xK/VklCvdyyrmvzATlxQ ($38.30 in chips)
Seat 3: uUznlIMFnRUvwrBhYF73KA ($58.15 in chips)
Seat 4: RowCSpSURHTOL/dcjg/Iug ($48.55 in chips)
Seat 5: crjGpJEzSZgD38FoE3VMGg ($54.85 in chips)
Seat 6: 686aeHikcJlgKkSuIFdcXQ ($69.35 in chips)
crjGpJEzSZgD38FoE3VMGg: posts small blind $0.25
686aeHikcJlgKkSuIFdcXQ: posts big blind $0.50
*** HOLE CARDS ***
FHilMb2i2DbUCc9lplszog: folds
M6xK/VklCvdyyrmvzATlxQ: raises $1 to $1.50
uUznlIMFnRUvwrBhYF73KA: folds
RowCSpSURHTOL/dcjg/Iug: raises $3.50 to $5
crjGpJEzSZgD38FoE3VMGg: folds
686aeHikcJlgKkSuIFdcXQ: folds
M6xK/VklCvdyyrmvzATlxQ: folds
RowCSpSURHTOL/dcjg/Iug collected $3.75 from pot
*** SUMMARY ***
Total pot $3.75 | Rake $0
Seat 1: FHilMb2i2DbUCc9lplszog folded before Flop (didn't bet)
Seat 2: M6xK/VklCvdyyrmvzATlxQ folded before Flop
Seat 3: uUznlIMFnRUvwrBhYF73KA folded before Flop (didn't bet)
Seat 4: RowCSpSURHTOL/dcjg/Iug (button) collected ($3.75)
Seat 5: crjGpJEzSZgD38FoE3VMGg (small blind) folded before Flop
Seat 6: 686aeHikcJlgKkSuIFdcXQ (big blind) folded before Flop



PokerStars Game #59939264692:  Hold'em No Limit ($0.25/$0.50) - 2009/07/01 0:35:26 ET
Table 'MJxeZCzYELxiIsyUZyT0jw' 6-max Seat #5 is the button
Seat 1: tdOvWynovql5imfooroLMg ($50 in chips)
Seat 2: dB6jzDlJmET84VMWw1mTRA ($50.75 in chips)
Seat 3: JQZew0FjzS19kTjeNtrE+A ($50 in chips)
Seat 4: lP7Q6pewz4C2RsAfKsjdWw ($33.80 in chips)
Seat 5: 3jvoOXNtXE90w2BdfNZwZQ ($50 in chips)
Seat 6: TTx3CHxyi0SObcHyMJRp5w ($63.20 in chips)
TTx3CHxyi0SObcHyMJRp5w: posts small blind $0.25
tdOvWynovql5imfooroLMg: posts big blind $0.50
*** HOLE CARDS ***
dB6jzDlJmET84VMWw1mTRA: folds
JQZew0FjzS19kTjeNtrE+A: calls $0.50
lP7Q6pewz4C2RsAfKsjdWw: calls $0.50
3jvoOXNtXE90w2BdfNZwZQ: folds
TTx3CHxyi0SObcHyMJRp5w: calls $0.25
tdOvWynovql5imfooroLMg: checks
*** FLOP *** [3s 4h 9h]
TTx3CHxyi0SObcHyMJRp5w: checks
tdOvWynovql5imfooroLMg: checks
JQZew0FjzS19kTjeNtrE+A: bets $1.50
lP7Q6pewz4C2RsAfKsjdWw: folds
TTx3CHxyi0SObcHyMJRp5w: folds
tdOvWynovql5imfooroLMg: folds
JQZew0FjzS19kTjeNtrE+A collected $1.90 from pot
*** SUMMARY ***
Total pot $2 | Rake $0.10
Board [3s 4h 9h]
Seat 1: tdOvWynovql5imfooroLMg (big blind) folded on the Flop
Seat 2: dB6jzDlJmET84VMWw1mTRA folded before Flop (didn't bet)
Seat 3: JQZew0FjzS19kTjeNtrE+A collected ($1.90)
Seat 4: lP7Q6pewz4C2RsAfKsjdWw folded on the Flop
Seat 5: 3jvoOXNtXE90w2BdfNZwZQ (button) folded before Flop (didn't bet)
Seat 6: TTx3CHxyi0SObcHyMJRp5w (small blind) folded on the Flop



PokerStars Game #59939265262:  Hold'em No Limit ($0.25/$0.50) - 2009/07/01 0:35:27 ET
Table '3FhG0gl3kMX3wBEEqj+wnQ' 9-max Seat #1 is the button
Seat 1: e0J9pdCNUDTCG031RnXqLA ($17.75 in chips)
Seat 2: 7cYQ+syUWjl38ty/ICOMhw ($49.50 in chips)
Seat 3: HZkVla4kK2SI42CVrPZ/ig ($8.75 in chips)
Seat 6: 5JJVDlaiMnB004o/RqbZZQ ($43.30 in chips)
Seat 7: mSD1pginDsyHG5PDfqzphw ($10 in chips)
Seat 8: j3K/Jujr7PY4ZM2RZvlH6A ($65.05 in chips)
Seat 9: L5e2lrPLQm1Pqx30IIZ/Fw ($10.10 in chips)
7cYQ+syUWjl38ty/ICOMhw: posts small blind $0.25
HZkVla4kK2SI42CVrPZ/ig: posts big blind $0.50
bjvJtA9Hqscfznq66txaOQ: sits out
gsyXT42WLEcOS4DdEk2wlw: sits out
*** HOLE CARDS ***
5JJVDlaiMnB004o/RqbZZQ: folds
mSD1pginDsyHG5PDfqzphw: folds
j3K/Jujr7PY4ZM2RZvlH6A: folds
L5e2lrPLQm1Pqx30IIZ/Fw: folds
e0J9pdCNUDTCG031RnXqLA: folds
7cYQ+syUWjl38ty/ICOMhw: raises $0.50 to $1
HZkVla4kK2SI42CVrPZ/ig: calls $0.50
*** FLOP *** [8d Qc 5c]
7cYQ+syUWjl38ty/ICOMhw: bets $1.50
HZkVla4kK2SI42CVrPZ/ig: folds
7cYQ+syUWjl38ty/ICOMhw collected $1.90 from pot
*** SUMMARY ***
Total pot $2 | Rake $0.10
Board [8d Qc 5c]
Seat 1: e0J9pdCNUDTCG031RnXqLA (button) folded before Flop (didn't bet)
Seat 2: 7cYQ+syUWjl38ty/ICOMhw (small blind) collected ($1.90)
Seat 3: HZkVla4kK2SI42CVrPZ/ig (big blind) folded on the Flop
Seat 6: 5JJVDlaiMnB004o/RqbZZQ folded before Flop (didn't bet)
Seat 7: mSD1pginDsyHG5PDfqzphw folded before Flop (didn't bet)
Seat 8: j3K/Jujr7PY4ZM2RZvlH6A folded before Flop (didn't bet)
Seat 9: L5e2lrPLQm1Pqx30IIZ/Fw folded before Flop (didn't bet)



PokerStars Game #59939265858:  Hold'em No Limit ($0.25/$0.50) - 2009/07/01 0:35:28 ET
Table 'fx6MqwfYAj/Rt86hBz2L3Q' 9-max Seat #2 is the button
Seat 2: C3rGXblctNcWI6JYPHhaEg ($21 in chips)
Seat 3: iadBi5AEt7gTBXbDSSnMYQ ($41.75 in chips)
Seat 4: gPEN9Zp33YTm/mu9/SYP1w ($22.70 in chips)
Seat 5: iAISe3dVeua8PUn2wwgDHw ($43.60 in chips)
Seat 6: 5k9fvXD9suIgCxU4HLQjTw ($50 in chips)
Seat 7: bkXkL3pmapikPQQRNPZSEA ($24.50 in chips)
Seat 8: CAuekkxPVzBL9SK4Tjjbuw ($29 in chips)
Seat 9: HZkVla4kK2SI42CVrPZ/ig ($8.50 in chips)
iadBi5AEt7gTBXbDSSnMYQ: posts small blind $0.25
gPEN9Zp33YTm/mu9/SYP1w: posts big blind $0.50
pmyrdhen: sits out
*** HOLE CARDS ***
iAISe3dVeua8PUn2wwgDHw: folds
5k9fvXD9suIgCxU4HLQjTw: folds
bkXkL3pmapikPQQRNPZSEA: folds
CAuekkxPVzBL9SK4Tjjbuw: folds
HZkVla4kK2SI42CVrPZ/ig: folds
C3rGXblctNcWI6JYPHhaEg: calls $0.50
iadBi5AEt7gTBXbDSSnMYQ: calls $0.25
gPEN9Zp33YTm/mu9/SYP1w: checks
*** FLOP *** [4s Jc 2c]
iadBi5AEt7gTBXbDSSnMYQ: checks
gPEN9Zp33YTm/mu9/SYP1w: checks
C3rGXblctNcWI6JYPHhaEg: bets $0.50
iadBi5AEt7gTBXbDSSnMYQ: calls $0.50
gPEN9Zp33YTm/mu9/SYP1w: folds
*** TURN *** [4s Jc 2c] [9s]
iadBi5AEt7gTBXbDSSnMYQ: checks
C3rGXblctNcWI6JYPHhaEg: checks
*** RIVER *** [4s Jc 2c 9s] [7d]
iadBi5AEt7gTBXbDSSnMYQ: checks
C3rGXblctNcWI6JYPHhaEg: checks
*** SHOW DOWN ***
iadBi5AEt7gTBXbDSSnMYQ: shows [Tc Kd] (high card King)
C3rGXblctNcWI6JYPHhaEg: mucks hand
iadBi5AEt7gTBXbDSSnMYQ collected $2.40 from pot
*** SUMMARY ***
Total pot $2.50 | Rake $0.10
Board [4s Jc 2c 9s 7d]
Seat 2: C3rGXblctNcWI6JYPHhaEg (button) mucked
Seat 3: iadBi5AEt7gTBXbDSSnMYQ (small blind) showed [Tc Kd] and won ($2.40) with high card King
Seat 4: gPEN9Zp33YTm/mu9/SYP1w (big blind) folded on the Flop
Seat 5: iAISe3dVeua8PUn2wwgDHw folded before Flop (didn't bet)
Seat 6: 5k9fvXD9suIgCxU4HLQjTw folded before Flop (didn't bet)
Seat 7: bkXkL3pmapikPQQRNPZSEA folded before Flop (didn't bet)
Seat 8: CAuekkxPVzBL9SK4Tjjbuw folded before Flop (didn't bet)
Seat 9: HZkVla4kK2SI42CVrPZ/ig folded before Flop (didn't bet)



PokerStars Game #59939266054:  Hold'em No Limit ($0.25/$0.50) - 2009/07/01 0:35:29 ET
Table '+111aLuBwnz8YVYSA7J1jA' 2-max Seat #1 is the button
Seat 1: ndd1nfncBkWNitBnsfCoVQ ($99.50 in chips)
Seat 2: +ciXH35zeafrjg1W6wiBTg ($50 in chips)
ndd1nfncBkWNitBnsfCoVQ: posts small blind $0.25
+ciXH35zeafrjg1W6wiBTg: posts big blind $0.50
*** HOLE CARDS ***
ndd1nfncBkWNitBnsfCoVQ: raises $1 to $1.50
+ciXH35zeafrjg1W6wiBTg: raises $1.50 to $3
ndd1nfncBkWNitBnsfCoVQ: calls $1.50
*** FLOP *** [2d 2h 9c]
+ciXH35zeafrjg1W6wiBTg: bets $3.50
ndd1nfncBkWNitBnsfCoVQ: folds
+ciXH35zeafrjg1W6wiBTg collected $5.70 from pot
+ciXH35zeafrjg1W6wiBTg: doesn't show hand
*** SUMMARY ***
Total pot $6 | Rake $0.30
Board [2d 2h 9c]
Seat 1: ndd1nfncBkWNitBnsfCoVQ (button) (small blind) folded on the Flop
Seat 2: +ciXH35zeafrjg1W6wiBTg (big blind) collected ($5.70)



PokerStars Game #59939266396:  Hold'em No Limit ($0.25/$0.50) - 2009/07/01 0:35:29 ET
Table 'PALRfuH85dr5IkDfdv6new' 9-max Seat #7 is the button
Seat 1: SKnJuWHScqetA/qG5p+wCg ($30 in chips)
Seat 2: 9r7ZoBbAJj5IeyZ0q9BdzA ($8 in chips)
Seat 3: 50QWoELmpmHFrFIlWMJo9g ($86.70 in chips)
Seat 4: mZNMJI1mY40XTC0U7GZakA ($57.65 in chips)
Seat 5: jSSGUXdNFAZA3QCvTcUMQw ($42.70 in chips)
Seat 6: E2518gp4aFz1+kAgmGqeEg ($14.50 in chips)
Seat 7: 3NcyXvr39gnK+KbTq7ezyA ($37.20 in chips)
Seat 8: NkS+CseUKx4XHszWq0PXEQ ($44.15 in chips)
Seat 9: CIrAX/m6o7jYmKOAjJXv4Q ($38.05 in chips)
NkS+CseUKx4XHszWq0PXEQ: posts small blind $0.25
CIrAX/m6o7jYmKOAjJXv4Q: posts big blind $0.50
*** HOLE CARDS ***
SKnJuWHScqetA/qG5p+wCg: folds
9r7ZoBbAJj5IeyZ0q9BdzA: folds
50QWoELmpmHFrFIlWMJo9g: folds
mZNMJI1mY40XTC0U7GZakA: folds
jSSGUXdNFAZA3QCvTcUMQw: folds
E2518gp4aFz1+kAgmGqeEg: folds
3NcyXvr39gnK+KbTq7ezyA: calls $0.50
NkS+CseUKx4XHszWq0PXEQ: folds
CIrAX/m6o7jYmKOAjJXv4Q: checks
*** FLOP *** [3d 6d 2h]
CIrAX/m6o7jYmKOAjJXv4Q: checks
3NcyXvr39gnK+KbTq7ezyA: checks
*** TURN *** [3d 6d 2h] [9h]
CIrAX/m6o7jYmKOAjJXv4Q: checks
3NcyXvr39gnK+KbTq7ezyA: bets $0.50
CIrAX/m6o7jYmKOAjJXv4Q: calls $0.50
*** RIVER *** [3d 6d 2h 9h] [4c]
CIrAX/m6o7jYmKOAjJXv4Q: checks
3NcyXvr39gnK+KbTq7ezyA: checks
*** SHOW DOWN ***
CIrAX/m6o7jYmKOAjJXv4Q: shows [9s 5h] (a straight, Deuce to Six)
3NcyXvr39gnK+KbTq7ezyA: mucks hand
CIrAX/m6o7jYmKOAjJXv4Q collected $2.15 from pot
*** SUMMARY ***
Total pot $2.25 | Rake $0.10
Board [3d 6d 2h 9h 4c]
Seat 1: SKnJuWHScqetA/qG5p+wCg folded before Flop (didn't bet)
Seat 2: 9r7ZoBbAJj5IeyZ0q9BdzA folded before Flop (didn't bet)
Seat 3: 50QWoELmpmHFrFIlWMJo9g folded before Flop (didn't bet)
Seat 4: mZNMJI1mY40XTC0U7GZakA folded before Flop (didn't bet)
Seat 5: jSSGUXdNFAZA3QCvTcUMQw folded before Flop (didn't bet)
Seat 6: E2518gp4aFz1+kAgmGqeEg folded before Flop (didn't bet)
Seat 7: 3NcyXvr39gnK+KbTq7ezyA (button) mucked
Seat 8: NkS+CseUKx4XHszWq0PXEQ (small blind) folded before Flop
Seat 9: CIrAX/m6o7jYmKOAjJXv4Q (big blind) showed [9s 5h] and won ($2.15) with a straight, Deuce to Six



PokerStars Game #59939268582:  Hold'em No Limit ($0.25/$0.50) - 2009/07/01 0:35:32 ET
Table 'mTxf8gPLgffN3Iwfm7Icfg' 2-max Seat #2 is the button
Seat 1: Do9Rlu1R5u/AcRtMTl8SYg ($74.95 in chips)
Seat 2: EMc5LPgVaded4Qc77vm0fw ($83.30 in chips)
EMc5LPgVaded4Qc77vm0fw: posts small blind $0.25
Do9Rlu1R5u/AcRtMTl8SYg: posts big blind $0.50
*** HOLE CARDS ***
EMc5LPgVaded4Qc77vm0fw: folds
Do9Rlu1R5u/AcRtMTl8SYg collected $0.50 from pot
Do9Rlu1R5u/AcRtMTl8SYg: doesn't show hand
*** SUMMARY ***
Total pot $0.50 | Rake $0
Seat 1: Do9Rlu1R5u/AcRtMTl8SYg (big blind) collected ($0.50)
Seat 2: EMc5LPgVaded4Qc77vm0fw (button) (small blind) folded before Flop



PokerStars Game #59939271180:  Hold'em No Limit ($0.25/$0.50) - 2009/07/01 0:35:36 ET
Table 'E7bWJ45aoFXRpyRv2gw+Ig' 2-max Seat #2 is the button
Seat 1: FRkiRasEGlHUeLrEl+k/nA ($57.10 in chips)
Seat 2: 3Wro85I7472vJ4Wkpneo9A ($138.40 in chips)
3Wro85I7472vJ4Wkpneo9A: posts small blind $0.25
FRkiRasEGlHUeLrEl+k/nA: posts big blind $0.50
*** HOLE CARDS ***
3Wro85I7472vJ4Wkpneo9A: raises $1 to $1.50
FRkiRasEGlHUeLrEl+k/nA: calls $1
*** FLOP *** [5d Qh 7h]
FRkiRasEGlHUeLrEl+k/nA: checks
3Wro85I7472vJ4Wkpneo9A: checks
*** TURN *** [5d Qh 7h] [Qd]
FRkiRasEGlHUeLrEl+k/nA: checks
3Wro85I7472vJ4Wkpneo9A: bets $2
FRkiRasEGlHUeLrEl+k/nA: folds
3Wro85I7472vJ4Wkpneo9A collected $2.85 from pot
3Wro85I7472vJ4Wkpneo9A: doesn't show hand
*** SUMMARY ***
Total pot $3 | Rake $0.15
Board [5d Qh 7h Qd]
Seat 1: FRkiRasEGlHUeLrEl+k/nA (big blind) folded on the Turn
Seat 2: 3Wro85I7472vJ4Wkpneo9A (button) (small blind) collected ($2.85)



PokerStars Game #59939272504:  Hold'em No Limit ($0.25/$0.50) - 2009/07/01 0:35:38 ET
Table 'c/CRn+68J3Y8KxD5g1ek2Q' 2-max Seat #1 is the button
Seat 1: 46qCyJ6evTkHo9al5sBMNA ($230.50 in chips)
Seat 2: BypVLsYQt3ePFm2xQL/dOA ($146.40 in chips)
46qCyJ6evTkHo9al5sBMNA: posts small blind $0.25
BypVLsYQt3ePFm2xQL/dOA: posts big blind $0.50
*** HOLE CARDS ***
46qCyJ6evTkHo9al5sBMNA: raises $1.50 to $2
BypVLsYQt3ePFm2xQL/dOA: calls $1.50
*** FLOP *** [Ad Ks 2d]
BypVLsYQt3ePFm2xQL/dOA: checks
46qCyJ6evTkHo9al5sBMNA: bets $3
BypVLsYQt3ePFm2xQL/dOA: folds
46qCyJ6evTkHo9al5sBMNA collected $3.80 from pot
46qCyJ6evTkHo9al5sBMNA: doesn't show hand
*** SUMMARY ***
Total pot $4 | Rake $0.20
Board [Ad Ks 2d]
Seat 1: 46qCyJ6evTkHo9al5sBMNA (button) (small blind) collected ($3.80)
Seat 2: BypVLsYQt3ePFm2xQL/dOA (big blind) folded on the Flop



PokerStars Game #59939272614:  Hold'em No Limit ($0.25/$0.50) - 2009/07/01 0:35:39 ET
Table 'mTxf8gPLgffN3Iwfm7Icfg' 2-max Seat #1 is the button
Seat 1: Do9Rlu1R5u/AcRtMTl8SYg ($75.20 in chips)
Seat 2: EMc5LPgVaded4Qc77vm0fw ($83.05 in chips)
Do9Rlu1R5u/AcRtMTl8SYg: posts small blind $0.25
EMc5LPgVaded4Qc77vm0fw: posts big blind $0.50
*** HOLE CARDS ***
Do9Rlu1R5u/AcRtMTl8SYg: raises $1 to $1.50
EMc5LPgVaded4Qc77vm0fw: raises $3.50 to $5
Do9Rlu1R5u/AcRtMTl8SYg: calls $3.50
*** FLOP *** [Jd 6d 9s]
EMc5LPgVaded4Qc77vm0fw: bets $5.50
Do9Rlu1R5u/AcRtMTl8SYg: calls $5.50
*** TURN *** [Jd 6d 9s] [2c]
EMc5LPgVaded4Qc77vm0fw: checks
Do9Rlu1R5u/AcRtMTl8SYg: checks
*** RIVER *** [Jd 6d 9s 2c] [Kd]
EMc5LPgVaded4Qc77vm0fw: checks
Do9Rlu1R5u/AcRtMTl8SYg: checks
*** SHOW DOWN ***
EMc5LPgVaded4Qc77vm0fw: shows [Kh Qd] (a pair of Kings)
Do9Rlu1R5u/AcRtMTl8SYg: mucks hand
EMc5LPgVaded4Qc77vm0fw collected $20.50 from pot
*** SUMMARY ***
Total pot $21 | Rake $0.50
Board [Jd 6d 9s 2c Kd]
Seat 1: Do9Rlu1R5u/AcRtMTl8SYg (button) (small blind) mucked
Seat 2: EMc5LPgVaded4Qc77vm0fw (big blind) showed [Kh Qd] and won ($20.50) with a pair of Kings



PokerStars Game #59939274660:  Hold'em No Limit ($0.25/$0.50) - 2009/07/01 0:35:42 ET
Table 'QOgaEqMcJ73pcUMMxoisUgErOuyGLI5PT3G5MnpHgC/g Seat #4 is the button
Seat 1: L5e2lrPLQm1Pqx30IIZ/Fw ($10 in chips)
Seat 2: RjBdQ6w31rgcy0o24VLR6w ($18.95 in chips)
Seat 3: xZCXQSXlrZkp3pZizzVXCw ($50.50 in chips)
Seat 4: 3UmXLy3GfjC3EkOebduerQ ($50 in chips)
Seat 5: JwvquocWfhTVApN5t47LgA ($57.30 in chips)
Seat 6: zE9cVigS2nW/Ljy4K4bUQA ($30 in chips)
Seat 7: 90Wb75h3W1BRpbqVnuk8gw ($62.95 in chips)
Seat 8: g4k0NXISyLCqaSWZDBjfEg ($52.10 in chips)
Seat 9: J0W5D97jl5VLky+IoPvDeA ($56.40 in chips)
JwvquocWfhTVApN5t47LgA: posts small blind $0.25
zE9cVigS2nW/Ljy4K4bUQA: posts big blind $0.50
*** HOLE CARDS ***
90Wb75h3W1BRpbqVnuk8gw: folds
g4k0NXISyLCqaSWZDBjfEg: folds
J0W5D97jl5VLky+IoPvDeA: raises $1.50 to $2
L5e2lrPLQm1Pqx30IIZ/Fw: folds
RjBdQ6w31rgcy0o24VLR6w: folds
xZCXQSXlrZkp3pZizzVXCw: folds
3UmXLy3GfjC3EkOebduerQ: folds
JwvquocWfhTVApN5t47LgA: folds
zE9cVigS2nW/Ljy4K4bUQA: folds
J0W5D97jl5VLky+IoPvDeA collected $1.25 from pot
*** SUMMARY ***
Total pot $1.25 | Rake $0
Seat 1: L5e2lrPLQm1Pqx30IIZ/Fw folded before Flop (didn't bet)
Seat 2: RjBdQ6w31rgcy0o24VLR6w folded before Flop (didn't bet)
Seat 3: xZCXQSXlrZkp3pZizzVXCw folded before Flop (didn't bet)
Seat 4: 3UmXLy3GfjC3EkOebduerQ (button) folded before Flop (didn't bet)
Seat 5: JwvquocWfhTVApN5t47LgA (small blind) folded before Flop
Seat 6: zE9cVigS2nW/Ljy4K4bUQA (big blind) folded before Flop
Seat 7: 90Wb75h3W1BRpbqVnuk8gw folded before Flop (didn't bet)
Seat 8: g4k0NXISyLCqaSWZDBjfEg folded before Flop (didn't bet)
Seat 9: J0W5D97jl5VLky+IoPvDeA collected ($1.25)



PokerStars Game #59939275232:  Hold'em No Limit ($0.25/$0.50) - 2009/07/01 0:35:43 ET
Table 'X6IRCRTh+20gjz8aubWnwA' 9-max Seat #8 is the button
Seat 1: DSM67hHHq1XFoEOi9p8Alw ($51.55 in chips)
Seat 2: HZkVla4kK2SI42CVrPZ/ig ($8.50 in chips)
Seat 3: GeZ7AYmAZ9Ln8liPZzV8EA ($23.70 in chips)
Seat 4: 2J+UVOVrW+V3maOylyxMcQ ($40.65 in chips)
Seat 5: QtFsO51ArDuQ44+KvR2jow ($28.60 in chips)
Seat 6: /6In1zC3WtgwxDcueWzZWg ($63.15 in chips)
Seat 7: cFHQjKQOOKTUzoilhrXHLg ($29.25 in chips)
Seat 8: HxeBVq06/3Bh/H986sgdbw ($7.25 in chips)
Seat 9: M+7+BTmX5vZatHVuoRB1nA ($82.25 in chips)
M+7+BTmX5vZatHVuoRB1nA: posts small blind $0.25
DSM67hHHq1XFoEOi9p8Alw: posts big blind $0.50
*** HOLE CARDS ***
HZkVla4kK2SI42CVrPZ/ig: folds
GeZ7AYmAZ9Ln8liPZzV8EA: folds
2J+UVOVrW+V3maOylyxMcQ: folds
QtFsO51ArDuQ44+KvR2jow: folds
/6In1zC3WtgwxDcueWzZWg: raises $1 to $1.50
cFHQjKQOOKTUzoilhrXHLg: calls $1.50
HxeBVq06/3Bh/H986sgdbw: folds
M+7+BTmX5vZatHVuoRB1nA: calls $1.25
DSM67hHHq1XFoEOi9p8Alw: folds
*** FLOP *** [9d 6d Td]
M+7+BTmX5vZatHVuoRB1nA: checks
/6In1zC3WtgwxDcueWzZWg: bets $2
cFHQjKQOOKTUzoilhrXHLg: folds
M+7+BTmX5vZatHVuoRB1nA: folds
/6In1zC3WtgwxDcueWzZWg collected $4.75 from pot
/6In1zC3WtgwxDcueWzZWg: doesn't show hand
*** SUMMARY ***
Total pot $5 | Rake $0.25
Board [9d 6d Td]
Seat 1: DSM67hHHq1XFoEOi9p8Alw (big blind) folded before Flop
Seat 2: HZkVla4kK2SI42CVrPZ/ig folded before Flop (didn't bet)
Seat 3: GeZ7AYmAZ9Ln8liPZzV8EA folded before Flop (didn't bet)
Seat 4: 2J+UVOVrW+V3maOylyxMcQ folded before Flop (didn't bet)
Seat 5: QtFsO51ArDuQ44+KvR2jow folded before Flop (didn't bet)
Seat 6: /6In1zC3WtgwxDcueWzZWg collected ($4.75)
Seat 7: cFHQjKQOOKTUzoilhrXHLg folded on the Flop
Seat 8: HxeBVq06/3Bh/H986sgdbw (button) folded before Flop (didn't bet)
Seat 9: M+7+BTmX5vZatHVuoRB1nA (small blind) folded on the Flop



PokerStars Game #59939277324:  Hold'em No Limit ($0.25/$0.50) - 2009/07/01 0:35:46 ET
Table 'eMxdLyFDf28E0wit6gm3Uw' 6-max Seat #4 is the button
Seat 1: GtdWeBVCZhDBcNFRTOb8Hg ($7.50 in chips)
Seat 2: jwuKQ1S3U4NnzMQn3E3dgw ($74.40 in chips)
Seat 3: dZcLsEI8iXkobBduRJ45Yw ($18.10 in chips)
Seat 4: QM93o65lI8kLzmiB/BILlA ($10.25 in chips)
Seat 6: L0aIPg7qefDQjdJo3HCVEA ($9.05 in chips)
L0aIPg7qefDQjdJo3HCVEA: posts small blind $0.25
GtdWeBVCZhDBcNFRTOb8Hg: posts big blind $0.50
*** HOLE CARDS ***
jwuKQ1S3U4NnzMQn3E3dgw: folds
dZcLsEI8iXkobBduRJ45Yw: raises $0.50 to $1
QM93o65lI8kLzmiB/BILlA: raises $4 to $5
L0aIPg7qefDQjdJo3HCVEA: folds
GtdWeBVCZhDBcNFRTOb8Hg: folds
dZcLsEI8iXkobBduRJ45Yw: folds
QM93o65lI8kLzmiB/BILlA collected $2.75 from pot
*** SUMMARY ***
Total pot $2.75 | Rake $0
Seat 1: GtdWeBVCZhDBcNFRTOb8Hg (big blind) folded before Flop
Seat 2: jwuKQ1S3U4NnzMQn3E3dgw folded before Flop (didn't bet)
Seat 3: dZcLsEI8iXkobBduRJ45Yw folded before Flop
Seat 4: QM93o65lI8kLzmiB/BILlA (button) collected ($2.75)
Seat 6: L0aIPg7qefDQjdJo3HCVEA (small blind) folded before Flop



PokerStars Game #59939277644:  Hold'em No Limit ($0.25/$0.50) - 2009/07/01 0:35:46 ET
Table '+111aLuBwnz8YVYSA7J1jA' 2-max Seat #2 is the button
Seat 1: ndd1nfncBkWNitBnsfCoVQ ($96.50 in chips)
Seat 2: +ciXH35zeafrjg1W6wiBTg ($52.70 in chips)
+ciXH35zeafrjg1W6wiBTg: posts small blind $0.25
ndd1nfncBkWNitBnsfCoVQ: posts big blind $0.50
*** HOLE CARDS ***
+ciXH35zeafrjg1W6wiBTg: raises $1.50 to $2
ndd1nfncBkWNitBnsfCoVQ: calls $1.50
*** FLOP *** [2h 4s Qd]
ndd1nfncBkWNitBnsfCoVQ: checks
+ciXH35zeafrjg1W6wiBTg: bets $2.50
ndd1nfncBkWNitBnsfCoVQ: folds
+ciXH35zeafrjg1W6wiBTg collected $3.80 from pot
+ciXH35zeafrjg1W6wiBTg: doesn't show hand
*** SUMMARY ***
Total pot $4 | Rake $0.20
Board [2h 4s Qd]
Seat 1: ndd1nfncBkWNitBnsfCoVQ (big blind) folded on the Flop
Seat 2: +ciXH35zeafrjg1W6wiBTg (button) (small blind) collected ($3.80)



PokerStars Game #59939277310:  Hold'em No Limit ($0.25/$0.50) - 2009/07/01 0:35:46 ET
Table 'NCiXr0d5CEKBQr/cZgLhbA' 9-max Seat #6 is the button
Seat 2: ulxuJchBV9iguXg0FUonfg ($25.80 in chips)
Seat 3: xZCXQSXlrZkp3pZizzVXCw ($50 in chips)
Seat 4: 5k9fvXD9suIgCxU4HLQjTw ($59.20 in chips)
Seat 5: zE9cVigS2nW/Ljy4K4bUQA ($39.95 in chips)
Seat 6: SKnJuWHScqetA/qG5p+wCg ($34 in chips)
Seat 7: M+7+BTmX5vZatHVuoRB1nA ($44 in chips)
Seat 8: 1MJUKc3cc0QmUoz1JZLR2w ($53.55 in chips)
Seat 9: 4WLZvqBn5qv5tds5kt5A1Q ($48.55 in chips)
M+7+BTmX5vZatHVuoRB1nA: posts small blind $0.25
1MJUKc3cc0QmUoz1JZLR2w: posts big blind $0.50
pFtzb1sR4b0d1aw6aIRgDg: sits out
*** HOLE CARDS ***
4WLZvqBn5qv5tds5kt5A1Q: folds
ulxuJchBV9iguXg0FUonfg: folds
xZCXQSXlrZkp3pZizzVXCw: folds
5k9fvXD9suIgCxU4HLQjTw: raises $1 to $1.50
zE9cVigS2nW/Ljy4K4bUQA: folds
SKnJuWHScqetA/qG5p+wCg: folds
M+7+BTmX5vZatHVuoRB1nA: raises $4 to $5.50
1MJUKc3cc0QmUoz1JZLR2w: folds
5k9fvXD9suIgCxU4HLQjTw: folds
M+7+BTmX5vZatHVuoRB1nA collected $3.50 from pot
*** SUMMARY ***
Total pot $3.50 | Rake $0
Seat 2: ulxuJchBV9iguXg0FUonfg folded before Flop (didn't bet)
Seat 3: xZCXQSXlrZkp3pZizzVXCw folded before Flop (didn't bet)
Seat 4: 5k9fvXD9suIgCxU4HLQjTw folded before Flop
Seat 5: zE9cVigS2nW/Ljy4K4bUQA folded before Flop (didn't bet)
Seat 6: SKnJuWHScqetA/qG5p+wCg (button) folded before Flop (didn't bet)
Seat 7: M+7+BTmX5vZatHVuoRB1nA (small blind) collected ($3.50)
Seat 8: 1MJUKc3cc0QmUoz1JZLR2w (big blind) folded before Flop
Seat 9: 4WLZvqBn5qv5tds5kt5A1Q folded before Flop (didn't bet)



PokerStars Game #59939278998:  Hold'em No Limit ($0.25/$0.50) - 2009/07/01 0:35:48 ET
Table '/cQuAT3ef4t+PGrXiNhGaQ' 9-max Seat #3 is the button
Seat 1: HZkVla4kK2SI42CVrPZ/ig ($9.25 in chips)
Seat 2: jXGruyaMqirTaTXNOvBdew ($70.65 in chips)
Seat 3: g4k0NXISyLCqaSWZDBjfEg ($53.65 in chips)
Seat 4: OWP/DOu+PlPK6ZZ3zYa0HA ($40.15 in chips)
Seat 5: 5SgaHdWixdClWvaEG+KUjQ ($20.95 in chips)
Seat 6: APYIOyK/4AGb+kIwlOUNBQ ($43.75 in chips)
Seat 7: J0W5D97jl5VLky+IoPvDeA ($114.90 in chips)
Seat 8: W3ingbA178eb7J5rt1PuIQ ($28.95 in chips)
OWP/DOu+PlPK6ZZ3zYa0HA: posts small blind $0.25
5SgaHdWixdClWvaEG+KUjQ: posts big blind $0.50
*** HOLE CARDS ***
APYIOyK/4AGb+kIwlOUNBQ: raises $1 to $1.50
J0W5D97jl5VLky+IoPvDeA: folds
W3ingbA178eb7J5rt1PuIQ: folds
HZkVla4kK2SI42CVrPZ/ig: calls $1.50
jXGruyaMqirTaTXNOvBdew: folds
g4k0NXISyLCqaSWZDBjfEg: folds
OWP/DOu+PlPK6ZZ3zYa0HA: folds
5SgaHdWixdClWvaEG+KUjQ: calls $1
*** FLOP *** [Qs Kd Js]
5SgaHdWixdClWvaEG+KUjQ: checks
APYIOyK/4AGb+kIwlOUNBQ: bets $2.50
stumblehere joins the table at seat #9
HZkVla4kK2SI42CVrPZ/ig: calls $2.50
5SgaHdWixdClWvaEG+KUjQ: calls $2.50
*** TURN *** [Qs Kd Js] [Ks]
5SgaHdWixdClWvaEG+KUjQ: checks
APYIOyK/4AGb+kIwlOUNBQ: checks
HZkVla4kK2SI42CVrPZ/ig: checks
*** RIVER *** [Qs Kd Js Ks] [6d]
5SgaHdWixdClWvaEG+KUjQ: bets $7.50
APYIOyK/4AGb+kIwlOUNBQ: folds
HZkVla4kK2SI42CVrPZ/ig: folds
5SgaHdWixdClWvaEG+KUjQ collected $11.65 from pot
*** SUMMARY ***
Total pot $12.25 | Rake $0.60
Board [Qs Kd Js Ks 6d]
Seat 1: HZkVla4kK2SI42CVrPZ/ig folded on the River
Seat 2: jXGruyaMqirTaTXNOvBdew folded before Flop (didn't bet)
Seat 3: g4k0NXISyLCqaSWZDBjfEg (button) folded before Flop (didn't bet)
Seat 4: OWP/DOu+PlPK6ZZ3zYa0HA (small blind) folded before Flop
Seat 5: 5SgaHdWixdClWvaEG+KUjQ (big blind) collected ($11.65)
Seat 6: APYIOyK/4AGb+kIwlOUNBQ folded on the River
Seat 7: J0W5D97jl5VLky+IoPvDeA folded before Flop (didn't bet)
Seat 8: W3ingbA178eb7J5rt1PuIQ folded before Flop (didn't bet)



PokerStars Game #59939279482:  Hold'em No Limit ($0.25/$0.50) - 2009/07/01 0:35:49 ET
Table 'EiNh8p/wGJ1FP575iMFnqg' 9-max Seat #2 is the button
Seat 1: r3ZqM1Mi0W3y4hOdssE+Sg ($48.25 in chips)
Seat 2: 8ehL7qlZzjgUh2H35iiWLw ($50 in chips)
Seat 3: ymLPoEIl7UL3TvZYmnadxQ ($50.35 in chips)
Seat 4: HIIPkpiaCQfs5HcPKjlHvg ($9.20 in chips)
Seat 5: M+7+BTmX5vZatHVuoRB1nA ($84.85 in chips)
Seat 6: 3UmXLy3GfjC3EkOebduerQ ($54.65 in chips)
Seat 7: Wj7mKnRFR90j40wWUu2+Og ($71.05 in chips)
Seat 8: KrPAGRACBg+w0M//SXe8Ag ($11.90 in chips)
Seat 9: OMwFJ4pF0xk2Ru/AJiFeFw ($101.50 in chips)
ymLPoEIl7UL3TvZYmnadxQ: posts small blind $0.25
HIIPkpiaCQfs5HcPKjlHvg: posts big blind $0.50
*** HOLE CARDS ***
M+7+BTmX5vZatHVuoRB1nA: folds
3UmXLy3GfjC3EkOebduerQ: folds
Wj7mKnRFR90j40wWUu2+Og: folds
KrPAGRACBg+w0M//SXe8Ag: calls $0.50
OMwFJ4pF0xk2Ru/AJiFeFw: calls $0.50
r3ZqM1Mi0W3y4hOdssE+Sg: calls $0.50
8ehL7qlZzjgUh2H35iiWLw: folds
ymLPoEIl7UL3TvZYmnadxQ: calls $0.25
HIIPkpiaCQfs5HcPKjlHvg: checks
*** FLOP *** [2d Kh 6s]
ymLPoEIl7UL3TvZYmnadxQ: checks
HIIPkpiaCQfs5HcPKjlHvg: checks
KrPAGRACBg+w0M//SXe8Ag: checks
OMwFJ4pF0xk2Ru/AJiFeFw: checks
r3ZqM1Mi0W3y4hOdssE+Sg: bets $2
ymLPoEIl7UL3TvZYmnadxQ: folds
HIIPkpiaCQfs5HcPKjlHvg: folds
HIIPkpiaCQfs5HcPKjlHvg leaves the table
KrPAGRACBg+w0M//SXe8Ag: folds
OMwFJ4pF0xk2Ru/AJiFeFw: folds
Lacher64 joins the table at seat #4
r3ZqM1Mi0W3y4hOdssE+Sg collected $2.40 from pot
*** SUMMARY ***
Total pot $2.50 | Rake $0.10
Board [2d Kh 6s]
Seat 1: r3ZqM1Mi0W3y4hOdssE+Sg collected ($2.40)
Seat 2: 8ehL7qlZzjgUh2H35iiWLw (button) folded before Flop (didn't bet)
Seat 3: ymLPoEIl7UL3TvZYmnadxQ (small blind) folded on the Flop
Seat 4: HIIPkpiaCQfs5HcPKjlHvg (big blind) folded on the Flop
Seat 5: M+7+BTmX5vZatHVuoRB1nA folded before Flop (didn't bet)
Seat 6: 3UmXLy3GfjC3EkOebduerQ folded before Flop (didn't bet)
Seat 7: Wj7mKnRFR90j40wWUu2+Og folded before Flop (didn't bet)
Seat 8: KrPAGRACBg+w0M//SXe8Ag folded on the Flop
Seat 9: OMwFJ4pF0xk2Ru/AJiFeFw folded on the Flop



PokerStars Game #59939281202:  Hold'em No Limit ($0.25/$0.50) - 2009/07/01 0:35:52 ET
Table 'QOgaEqMcJ73pcUMMxoisUg' 6-max Seat #4 is the button
Seat 1: OZ6OtYh5Y53MCH/p0QTn5g ($50 in chips)
Seat 3: Rt6KgtZ8YaJoTc3FPim00w ($51 in chips)
Seat 4: zAcsDhG/T128Vn7XGVSgKg ($58.15 in chips)
Seat 5: 6vNxrjjCl6FwfaaymM9jjg ($31.05 in chips)
Seat 6: pmE+2KJb4nffAVqjLIXxFg ($21.50 in chips)
6vNxrjjCl6FwfaaymM9jjg: posts small blind $0.25
pmE+2KJb4nffAVqjLIXxFg: posts big blind $0.50
4QfsCWthT/vSLirorNXqtg: sits out
*** HOLE CARDS ***
OZ6OtYh5Y53MCH/p0QTn5g: raises $1.50 to $2
Rt6KgtZ8YaJoTc3FPim00w: calls $2
zAcsDhG/T128Vn7XGVSgKg: folds
6vNxrjjCl6FwfaaymM9jjg: calls $1.75
pmE+2KJb4nffAVqjLIXxFg: folds
*** FLOP *** [9d Jd Ah]
6vNxrjjCl6FwfaaymM9jjg: checks
OZ6OtYh5Y53MCH/p0QTn5g: bets $5
Rt6KgtZ8YaJoTc3FPim00w: folds
6vNxrjjCl6FwfaaymM9jjg: folds
OZ6OtYh5Y53MCH/p0QTn5g collected $6.20 from pot
*** SUMMARY ***
Total pot $6.50 | Rake $0.30
Board [9d Jd Ah]
Seat 1: OZ6OtYh5Y53MCH/p0QTn5g collected ($6.20)
Seat 3: Rt6KgtZ8YaJoTc3FPim00w folded on the Flop
Seat 4: zAcsDhG/T128Vn7XGVSgKg (button) folded before Flop (didn't bet)
Seat 5: 6vNxrjjCl6FwfaaymM9jjg (small blind) folded on the Flop
Seat 6: pmE+2KJb4nffAVqjLIXxFg (big blind) folded before Flop



PokerStars Game #59939282192:  Hold'em No Limit ($0.25/$0.50) - 2009/07/01 0:35:53 ET
Table 'GfL/No5u5PoEnU39lP5pQg' 6-max Seat #1 is the button
Seat 1: 1WUCqNG+p+vfWRTXNu4ljw ($52 in chips)
Seat 2: uVwggSetzp7d+eVgowO3vg ($53.80 in chips)
Seat 3: NbUTppWfym/RxV/DmDz2Sw ($14.60 in chips)
Seat 4: x+pzUFJsMIiGd7a5pcR4tg ($52.35 in chips)
Seat 5: crjGpJEzSZgD38FoE3VMGg ($59.60 in chips)
uVwggSetzp7d+eVgowO3vg: posts small blind $0.25
NbUTppWfym/RxV/DmDz2Sw: posts big blind $0.50
*** HOLE CARDS ***
x+pzUFJsMIiGd7a5pcR4tg: folds
crjGpJEzSZgD38FoE3VMGg: folds
1WUCqNG+p+vfWRTXNu4ljw: folds
uVwggSetzp7d+eVgowO3vg: folds
NbUTppWfym/RxV/DmDz2Sw collected $0.50 from pot
*** SUMMARY ***
Total pot $0.50 | Rake $0
Seat 1: 1WUCqNG+p+vfWRTXNu4ljw (button) folded before Flop (didn't bet)
Seat 2: uVwggSetzp7d+eVgowO3vg (small blind) folded before Flop
Seat 3: NbUTppWfym/RxV/DmDz2Sw (big blind) collected ($0.50)
Seat 4: x+pzUFJsMIiGd7a5pcR4tg folded before Flop (didn't bet)
Seat 5: crjGpJEzSZgD38FoE3VMGg folded before Flop (didn't bet)



PokerStars Game #59939284332:  Hold'em No Limit ($0.25/$0.50) - 2009/07/01 0:35:56 ET
Table 'tyR5AZNKV8Aadbrnrnlg7g' 6-max Seat #2 is the button
Seat 1: R+KjpH/wSjDLhtIy9+edNA ($84.40 in chips)
Seat 2: BAjwVL+zKKd0s0fAWstzQQ ($17.90 in chips)
Seat 3: tdOvWynovql5imfooroLMg ($48.70 in chips)
Seat 4: Rt6KgtZ8YaJoTc3FPim00w ($83.20 in chips)
Seat 6: ZKazl1hGaPiapDXincgi2Q ($17.90 in chips)
tdOvWynovql5imfooroLMg: posts small blind $0.25
Rt6KgtZ8YaJoTc3FPim00w: posts big blind $0.50
*** HOLE CARDS ***
ZKazl1hGaPiapDXincgi2Q: folds
R+KjpH/wSjDLhtIy9+edNA: folds
BAjwVL+zKKd0s0fAWstzQQ: calls $0.50
tdOvWynovql5imfooroLMg: folds
Rt6KgtZ8YaJoTc3FPim00w: checks
*** FLOP *** [Ac Qc 2c]
Rt6KgtZ8YaJoTc3FPim00w: checks
BAjwVL+zKKd0s0fAWstzQQ: bets $0.50
Rt6KgtZ8YaJoTc3FPim00w: folds
BAjwVL+zKKd0s0fAWstzQQ collected $1.20 from pot
BAjwVL+zKKd0s0fAWstzQQ: doesn't show hand
*** SUMMARY ***
Total pot $1.25 | Rake $0.05
Board [Ac Qc 2c]
Seat 1: R+KjpH/wSjDLhtIy9+edNA folded before Flop (didn't bet)
Seat 2: BAjwVL+zKKd0s0fAWstzQQ (button) collected ($1.20)
Seat 3: tdOvWynovql5imfooroLMg (small blind) folded before Flop
Seat 4: Rt6KgtZ8YaJoTc3FPim00w (big blind) folded on the Flop
Seat 6: ZKazl1hGaPiapDXincgi2Q folded before Flop (didn't bet)



PokerStars Game #59939284902:  Hold'em No Limit ($0.25/$0.50) - 2009/07/01 0:35:57 ET
Table 'otvGDROEDdqsabxskT79qg' 9-max Seat #2 is the button
Seat 1: 8ehL7qlZzjgUh2H35iiWLw ($56 in chips)
Seat 2: cCjTzH9jio8607WzjcfXlg ($8.50 in chips)
Seat 3: +k7T5ocke8UwavtgUHm+Cg ($75.60 in chips)
Seat 4: MG90wfSJZnOejs/KD3vlQQ ($56.15 in chips)
Seat 5: XNMDwbXt/Q4jM99AXnbJDw ($55.55 in chips)
Seat 6: bxLSulbgr8LmKNjOzw8URg ($49.25 in chips)
Seat 7: C7+tBppJrKgd/r+tuKUIpA ($34.15 in chips)
Seat 8: zE9cVigS2nW/Ljy4K4bUQA ($30 in chips)
Seat 9: KcY3X8YpD74Kw1RHkx/g4A ($66 in chips)
+k7T5ocke8UwavtgUHm+Cg: posts small blind $0.25
MG90wfSJZnOejs/KD3vlQQ: posts big blind $0.50
*** HOLE CARDS ***
XNMDwbXt/Q4jM99AXnbJDw: folds
bxLSulbgr8LmKNjOzw8URg: raises $1.50 to $2
C7+tBppJrKgd/r+tuKUIpA: folds
zE9cVigS2nW/Ljy4K4bUQA: calls $2
KcY3X8YpD74Kw1RHkx/g4A: folds
8ehL7qlZzjgUh2H35iiWLw: folds
cCjTzH9jio8607WzjcfXlg: folds
+k7T5ocke8UwavtgUHm+Cg: folds
MG90wfSJZnOejs/KD3vlQQ: folds
*** FLOP *** [As 7c Jd]
bxLSulbgr8LmKNjOzw8URg: bets $2.50
zE9cVigS2nW/Ljy4K4bUQA: folds
bxLSulbgr8LmKNjOzw8URg collected $4.55 from pot
bxLSulbgr8LmKNjOzw8URg: doesn't show hand
*** SUMMARY ***
Total pot $4.75 | Rake $0.20
Board [As 7c Jd]
Seat 1: 8ehL7qlZzjgUh2H35iiWLw folded before Flop (didn't bet)
Seat 2: cCjTzH9jio8607WzjcfXlg (button) folded before Flop (didn't bet)
Seat 3: +k7T5ocke8UwavtgUHm+Cg (small blind) folded before Flop
Seat 4: MG90wfSJZnOejs/KD3vlQQ (big blind) folded before Flop
Seat 5: XNMDwbXt/Q4jM99AXnbJDw folded before Flop (didn't bet)
Seat 6: bxLSulbgr8LmKNjOzw8URg collected ($4.55)
Seat 7: C7+tBppJrKgd/r+tuKUIpA folded before Flop (didn't bet)
Seat 8: zE9cVigS2nW/Ljy4K4bUQA folded on the Flop
Seat 9: KcY3X8YpD74Kw1RHkx/g4A folded before Flop (didn't bet)



PokerStars Game #59939286148:  Hold'em No Limit ($0.25/$0.50) - 2009/07/01 0:35:59 ET
Table 'hSTs/dUsYLgJQuF2Onp0MQ' 6-max Seat #3 is the button
Seat 1: Donj3X7gYzeS5pAl7s9f+Q ($30.40 in chips)
Seat 2: 6vNxrjjCl6FwfaaymM9jjg ($30.35 in chips)
Seat 3: C3qJBo7uxfFVDluE1lmK2w ($29.25 in chips)
Seat 4: L0aIPg7qefDQjdJo3HCVEA ($8.40 in chips)
Seat 5: 686aeHikcJlgKkSuIFdcXQ ($59.90 in chips)
Seat 6: w0pd++ZQHijd9dDhKEYOAQ ($31.65 in chips)
L0aIPg7qefDQjdJo3HCVEA: posts small blind $0.25
686aeHikcJlgKkSuIFdcXQ: posts big blind $0.50
*** HOLE CARDS ***
w0pd++ZQHijd9dDhKEYOAQ: folds
Donj3X7gYzeS5pAl7s9f+Q: folds
6vNxrjjCl6FwfaaymM9jjg: folds
C3qJBo7uxfFVDluE1lmK2w: folds
L0aIPg7qefDQjdJo3HCVEA: raises $0.50 to $1
686aeHikcJlgKkSuIFdcXQ: calls $0.50
*** FLOP *** [Ts 4d Qc]
L0aIPg7qefDQjdJo3HCVEA: bets $1
686aeHikcJlgKkSuIFdcXQ: folds
L0aIPg7qefDQjdJo3HCVEA collected $1.90 from pot
*** SUMMARY ***
Total pot $2 | Rake $0.10
Board [Ts 4d Qc]
Seat 1: Donj3X7gYzeS5pAl7s9f+Q folded before Flop (didn't bet)
Seat 2: 6vNxrjjCl6FwfaaymM9jjg folded before Flop (didn't bet)
Seat 3: C3qJBo7uxfFVDluE1lmK2w (button) folded before Flop (didn't bet)
Seat 4: L0aIPg7qefDQjdJo3HCVEA (small blind) collected ($1.90)
Seat 5: 686aeHikcJlgKkSuIFdcXQ (big blind) folded on the Flop
Seat 6: w0pd++ZQHijd9dDhKEYOAQ folded before Flop (didn't bet)



PokerStars Game #59939287044:  Hold'em No Limit ($0.25/$0.50) - 2009/07/01 0:36:00 ET
Table 'E7bWJ45aoFXRpyRv2gw+Ig' 2-max Seat #1 is the button
Seat 1: FRkiRasEGlHUeLrEl+k/nA ($55.60 in chips)
Seat 2: 3Wro85I7472vJ4Wkpneo9A ($139.75 in chips)
FRkiRasEGlHUeLrEl+k/nA: posts small blind $0.25
3Wro85I7472vJ4Wkpneo9A: posts big blind $0.50
*** HOLE CARDS ***
FRkiRasEGlHUeLrEl+k/nA: raises $1 to $1.50
3Wro85I7472vJ4Wkpneo9A: folds
FRkiRasEGlHUeLrEl+k/nA collected $1 from pot
*** SUMMARY ***
Total pot $1 | Rake $0
Seat 1: FRkiRasEGlHUeLrEl+k/nA (button) (small blind) collected ($1)
Seat 2: 3Wro85I7472vJ4Wkpneo9A (big blind) folded before Flop



PokerStars Game #59939286800:  Hold'em No Limit ($0.25/$0.50) - 2009/07/01 0:36:00 ET
Table 'c/CRn+68J3Y8KxD5g1ek2Q' 2-max Seat #2 is the button
Seat 1: 46qCyJ6evTkHo9al5sBMNA ($232.30 in chips)
Seat 2: BypVLsYQt3ePFm2xQL/dOA ($144.40 in chips)
BypVLsYQt3ePFm2xQL/dOA: posts small blind $0.25
46qCyJ6evTkHo9al5sBMNA: posts big blind $0.50
*** HOLE CARDS ***
BypVLsYQt3ePFm2xQL/dOA: calls $0.25
46qCyJ6evTkHo9al5sBMNA: raises $1 to $1.50
BypVLsYQt3ePFm2xQL/dOA: calls $1
*** FLOP *** [4c 9c As]
46qCyJ6evTkHo9al5sBMNA: checks
BypVLsYQt3ePFm2xQL/dOA: checks
*** TURN *** [4c 9c As] [9d]
46qCyJ6evTkHo9al5sBMNA: bets $2
BypVLsYQt3ePFm2xQL/dOA: folds
46qCyJ6evTkHo9al5sBMNA collected $2.85 from pot
46qCyJ6evTkHo9al5sBMNA: doesn't show hand
*** SUMMARY ***
Total pot $3 | Rake $0.15
Board [4c 9c As 9d]
Seat 1: 46qCyJ6evTkHo9al5sBMNA (big blind) collected ($2.85)
Seat 2: BypVLsYQt3ePFm2xQL/dOA (button) (small blind) folded on the Turn



PokerStars Game #59939288186:  Hold'em No Limit ($0.25/$0.50) - 2009/07/01 0:36:02 ET
Table 'lSisgp6H7Fg1hH5VfjEjYQ' 9-max Seat #8 is the button
Seat 1: pEW8B6uXbdR47kfljMQ3+Q ($37.35 in chips)
Seat 2: UrcnkQOiLVk8BlKDPJSy7Q ($52.30 in chips)
Seat 3: aTkyjTh3w5YLWiIERupZOA ($42.45 in chips)
Seat 4: bwv/rbH/hHhPhY6u9mu04w ($21.65 in chips)
Seat 5: mSD1pginDsyHG5PDfqzphw ($12.10 in chips)
Seat 6: +k7T5ocke8UwavtgUHm+Cg ($28.95 in chips)
Seat 7: Y3DZ6qQlLeBhixDj4M9vmg ($11 in chips)
Seat 8: a4JDWmpFQkL10XfAyuF51A ($34.75 in chips)
gsyXT42WLEcOS4DdEk2wlw will be allowed to play after the button
pEW8B6uXbdR47kfljMQ3+Q: posts small blind $0.25
UrcnkQOiLVk8BlKDPJSy7Q: posts big blind $0.50
*** HOLE CARDS ***
aTkyjTh3w5YLWiIERupZOA: folds
bwv/rbH/hHhPhY6u9mu04w: folds
mSD1pginDsyHG5PDfqzphw: folds
+k7T5ocke8UwavtgUHm+Cg: folds
Y3DZ6qQlLeBhixDj4M9vmg: folds
a4JDWmpFQkL10XfAyuF51A: folds
pEW8B6uXbdR47kfljMQ3+Q: folds
UrcnkQOiLVk8BlKDPJSy7Q collected $0.50 from pot
UrcnkQOiLVk8BlKDPJSy7Q: doesn't show hand
*** SUMMARY ***
Total pot $0.50 | Rake $0
Seat 1: pEW8B6uXbdR47kfljMQ3+Q (small blind) folded before Flop
Seat 2: UrcnkQOiLVk8BlKDPJSy7Q (big blind) collected ($0.50)
Seat 3: aTkyjTh3w5YLWiIERupZOA folded before Flop (didn't bet)
Seat 4: bwv/rbH/hHhPhY6u9mu04w folded before Flop (didn't bet)
Seat 5: mSD1pginDsyHG5PDfqzphw folded before Flop (didn't bet)
Seat 6: +k7T5ocke8UwavtgUHm+Cg folded before Flop (didn't bet)
Seat 7: Y3DZ6qQlLeBhixDj4M9vmg folded before Flop (didn't bet)
Seat 8: a4JDWmpFQkL10XfAyuF51A (button) folded before Flop (didn't bet)



PokerStars Game #59939288182:  Hold'em No Limit ($0.25/$0.50) - 2009/07/01 0:36:02 ET
Table '3FhG0gl3kMX3wBEEqj+wnQ' 9-max Seat #2 is the button
Seat 1: e0J9pdCNUDTCG031RnXqLA ($17.75 in chips)
Seat 2: 7cYQ+syUWjl38ty/ICOMhw ($50.40 in chips)
Seat 3: HZkVla4kK2SI42CVrPZ/ig ($7.75 in chips)
Seat 4: bjvJtA9Hqscfznq66txaOQ ($10 in chips)
Seat 6: 5JJVDlaiMnB004o/RqbZZQ ($43.30 in chips)
Seat 7: mSD1pginDsyHG5PDfqzphw ($10 in chips)
Seat 8: j3K/Jujr7PY4ZM2RZvlH6A ($65.05 in chips)
Seat 9: L5e2lrPLQm1Pqx30IIZ/Fw ($10.10 in chips)
HZkVla4kK2SI42CVrPZ/ig: posts small blind $0.25
bjvJtA9Hqscfznq66txaOQ: posts big blind $0.50
gsyXT42WLEcOS4DdEk2wlw: sits out
*** HOLE CARDS ***
5JJVDlaiMnB004o/RqbZZQ: folds
mSD1pginDsyHG5PDfqzphw: folds
j3K/Jujr7PY4ZM2RZvlH6A: raises $2 to $2.50
L5e2lrPLQm1Pqx30IIZ/Fw: folds
e0J9pdCNUDTCG031RnXqLA: folds
7cYQ+syUWjl38ty/ICOMhw: folds
HZkVla4kK2SI42CVrPZ/ig: raises $5.25 to $7.75 and is all-in
bjvJtA9Hqscfznq66txaOQ: folds
j3K/Jujr7PY4ZM2RZvlH6A: calls $5.25
*** FLOP *** [7h Qs 2d]
*** TURN *** [7h Qs 2d] [5h]
*** RIVER *** [7h Qs 2d 5h] [Kd]
*** SHOW DOWN ***
HZkVla4kK2SI42CVrPZ/ig: shows [9c 9h] (a pair of Nines)
j3K/Jujr7PY4ZM2RZvlH6A: mucks hand
HZkVla4kK2SI42CVrPZ/ig collected $15.20 from pot
*** SUMMARY ***
Total pot $16 | Rake $0.80
Board [7h Qs 2d 5h Kd]
Seat 1: e0J9pdCNUDTCG031RnXqLA folded before Flop (didn't bet)
Seat 2: 7cYQ+syUWjl38ty/ICOMhw (button) folded before Flop (didn't bet)
Seat 3: HZkVla4kK2SI42CVrPZ/ig (small blind) showed [9c 9h] and won ($15.20) with a pair of Nines
Seat 4: bjvJtA9Hqscfznq66txaOQ (big blind) folded before Flop
Seat 6: 5JJVDlaiMnB004o/RqbZZQ folded before Flop (didn't bet)
Seat 7: mSD1pginDsyHG5PDfqzphw folded before Flop (didn't bet)
Seat 8: j3K/Jujr7PY4ZM2RZvlH6A mucked
Seat 9: L5e2lrPLQm1Pqx30IIZ/Fw folded before Flop (didn't bet)



PokerStars Game #59939289192:  Hold'em No Limit ($0.25/$0.50) - 2009/07/01 0:36:04 ET
Table 'Nz0Vr7WMHL2g5Uk7dDZjpw' 9-max Seat #7 is the button
Seat 2: XNMDwbXt/Q4jM99AXnbJDw ($67.45 in chips)
Seat 3: 4QTiNH5fteLgJjx/s6Hy6A ($15.25 in chips)
Seat 4: 5JJVDlaiMnB004o/RqbZZQ ($27.25 in chips)
Seat 5: WGW0DgjBUXs1ylURHG8vnQ ($16.45 in chips)
Seat 6: k1f0lS7tlMHCLGs0JT34Tg ($13.50 in chips)
Seat 7: KPLH0gELgFe2OuAnhJFI5w ($25.50 in chips)
Seat 8: HkZI6g4zl83TDTA7SRspmQ ($15.95 in chips)
Seat 9: Ak2W6V2TDVIQrvSAy4eD7Q ($50 in chips)
HkZI6g4zl83TDTA7SRspmQ: posts small blind $0.25
Ak2W6V2TDVIQrvSAy4eD7Q: posts big blind $0.50
tLkxo7JgV+WWI0UBw44K5A: sits out
*** HOLE CARDS ***
XNMDwbXt/Q4jM99AXnbJDw: folds
4QTiNH5fteLgJjx/s6Hy6A: folds
5JJVDlaiMnB004o/RqbZZQ: folds
WGW0DgjBUXs1ylURHG8vnQ: folds
k1f0lS7tlMHCLGs0JT34Tg: folds
KPLH0gELgFe2OuAnhJFI5w: folds
HkZI6g4zl83TDTA7SRspmQ: folds
Ak2W6V2TDVIQrvSAy4eD7Q collected $0.50 from pot
*** SUMMARY ***
Total pot $0.50 | Rake $0
Seat 2: XNMDwbXt/Q4jM99AXnbJDw folded before Flop (didn't bet)
Seat 3: 4QTiNH5fteLgJjx/s6Hy6A folded before Flop (didn't bet)
Seat 4: 5JJVDlaiMnB004o/RqbZZQ folded before Flop (didn't bet)
Seat 5: WGW0DgjBUXs1ylURHG8vnQ folded before Flop (didn't bet)
Seat 6: k1f0lS7tlMHCLGs0JT34Tg folded before Flop (didn't bet)
Seat 7: KPLH0gELgFe2OuAnhJFI5w (button) folded before Flop (didn't bet)
Seat 8: HkZI6g4zl83TDTA7SRspmQ (small blind) folded before Flop
Seat 9: Ak2W6V2TDVIQrvSAy4eD7Q (big blind) collected ($0.50)



PokerStars Game #59939290940:  Hold'em No Limit ($0.25/$0.50) - 2009/07/01 0:36:06 ET
Table '37qXEp3oe+er5q4CZip9eQ' 6-max Seat #4 is the button
Seat 1: oqOqoO2AyCZenUghCxMDxw ($53 in chips)
Seat 2: 6wzJiRvp8HY6t+MQGnSIzA ($28.60 in chips)
Seat 3: Rt6KgtZ8YaJoTc3FPim00w ($86.25 in chips)
Seat 4: XsmE8nXMAAMFJbWaJTmHFw ($24.90 in chips)
Seat 5: VOmI0x4dDPnTESZd5B4d1Q ($41.25 in chips)
Seat 6: N50kln4negd8q7Mmoz1j4g ($25 in chips)
VOmI0x4dDPnTESZd5B4d1Q: posts small blind $0.25
N50kln4negd8q7Mmoz1j4g: posts big blind $0.50
*** HOLE CARDS ***
oqOqoO2AyCZenUghCxMDxw: folds
6wzJiRvp8HY6t+MQGnSIzA: folds
Rt6KgtZ8YaJoTc3FPim00w: raises $1 to $1.50
XsmE8nXMAAMFJbWaJTmHFw: folds
VOmI0x4dDPnTESZd5B4d1Q: calls $1.25
N50kln4negd8q7Mmoz1j4g: folds
*** FLOP *** [2s Jc 2c]
VOmI0x4dDPnTESZd5B4d1Q: checks
Rt6KgtZ8YaJoTc3FPim00w: checks
*** TURN *** [2s Jc 2c] [Jh]
VOmI0x4dDPnTESZd5B4d1Q: bets $2.50
Rt6KgtZ8YaJoTc3FPim00w: raises $4.50 to $7
VOmI0x4dDPnTESZd5B4d1Q: calls $4.50
*** RIVER *** [2s Jc 2c Jh] [4s]
VOmI0x4dDPnTESZd5B4d1Q: bets $5
Rt6KgtZ8YaJoTc3FPim00w: folds
VOmI0x4dDPnTESZd5B4d1Q collected $16.65 from pot
*** SUMMARY ***
Total pot $17.50 | Rake $0.85
Board [2s Jc 2c Jh 4s]
Seat 1: oqOqoO2AyCZenUghCxMDxw folded before Flop (didn't bet)
Seat 2: 6wzJiRvp8HY6t+MQGnSIzA folded before Flop (didn't bet)
Seat 3: Rt6KgtZ8YaJoTc3FPim00w folded on the River
Seat 4: XsmE8nXMAAMFJbWaJTmHFw (button) folded before Flop (didn't bet)
Seat 5: VOmI0x4dDPnTESZd5B4d1Q (small blind) collected ($16.65)
Seat 6: N50kln4negd8q7Mmoz1j4g (big blind) folded before Flop



PokerStars Game #59939291238:  Hold'em No Limit ($0.25/$0.50) - 2009/07/01 0:36:07 ET
Table '+111aLuBwnz8YVYSA7J1jA' 2-max Seat #1 is the button
Seat 1: ndd1nfncBkWNitBnsfCoVQ ($94.50 in chips)
Seat 2: +ciXH35zeafrjg1W6wiBTg ($54.50 in chips)
ndd1nfncBkWNitBnsfCoVQ: posts small blind $0.25
+ciXH35zeafrjg1W6wiBTg: posts big blind $0.50
*** HOLE CARDS ***
ndd1nfncBkWNitBnsfCoVQ: raises $1 to $1.50
+ciXH35zeafrjg1W6wiBTg: calls $1
*** FLOP *** [Js 8c 9c]
+ciXH35zeafrjg1W6wiBTg: checks
ndd1nfncBkWNitBnsfCoVQ: checks
*** TURN *** [Js 8c 9c] [7c]
+ciXH35zeafrjg1W6wiBTg: bets $2
ndd1nfncBkWNitBnsfCoVQ: folds
+ciXH35zeafrjg1W6wiBTg collected $2.85 from pot
+ciXH35zeafrjg1W6wiBTg: doesn't show hand
*** SUMMARY ***
Total pot $3 | Rake $0.15
Board [Js 8c 9c 7c]
Seat 1: ndd1nfncBkWNitBnsfCoVQ (button) (small blind) folded on the Turn
Seat 2: +ciXH35zeafrjg1W6wiBTg (big blind) collected ($2.85)



PokerStars Game #59939292492:  Hold'em No Limit ($0.25/$0.50) - 2009/07/01 0:36:09 ET
Table 'GfL/No5u5PoEnU39lP5pQg' 6-max Seat #2 is the button
Seat 1: 1WUCqNG+p+vfWRTXNu4ljw ($52 in chips)
Seat 2: uVwggSetzp7d+eVgowO3vg ($53.55 in chips)
Seat 3: NbUTppWfym/RxV/DmDz2Sw ($14.85 in chips)
Seat 4: x+pzUFJsMIiGd7a5pcR4tg ($52.35 in chips)
Seat 5: crjGpJEzSZgD38FoE3VMGg ($59.60 in chips)
NbUTppWfym/RxV/DmDz2Sw: posts small blind $0.25
x+pzUFJsMIiGd7a5pcR4tg: posts big blind $0.50
*** HOLE CARDS ***
crjGpJEzSZgD38FoE3VMGg: folds
1WUCqNG+p+vfWRTXNu4ljw: folds
uVwggSetzp7d+eVgowO3vg: raises $0.50 to $1
NbUTppWfym/RxV/DmDz2Sw: calls $0.75
x+pzUFJsMIiGd7a5pcR4tg: folds
*** FLOP *** [Qs 8c Jd]
NbUTppWfym/RxV/DmDz2Sw: checks
uVwggSetzp7d+eVgowO3vg: checks
*** TURN *** [Qs 8c Jd] [5h]
NbUTppWfym/RxV/DmDz2Sw: checks
uVwggSetzp7d+eVgowO3vg: bets $1
NbUTppWfym/RxV/DmDz2Sw: calls $1
*** RIVER *** [Qs 8c Jd 5h] [Kc]
NbUTppWfym/RxV/DmDz2Sw: bets $2
uVwggSetzp7d+eVgowO3vg: folds
NbUTppWfym/RxV/DmDz2Sw collected $4.30 from pot
*** SUMMARY ***
Total pot $4.50 | Rake $0.20
Board [Qs 8c Jd 5h Kc]
Seat 1: 1WUCqNG+p+vfWRTXNu4ljw folded before Flop (didn't bet)
Seat 2: uVwggSetzp7d+eVgowO3vg (button) folded on the River
Seat 3: NbUTppWfym/RxV/DmDz2Sw (small blind) collected ($4.30)
Seat 4: x+pzUFJsMIiGd7a5pcR4tg (big blind) folded before Flop
Seat 5: crjGpJEzSZgD38FoE3VMGg folded before Flop (didn't bet)



PokerStars Game #59939293150:  Hold'em No Limit ($0.25/$0.50) - 2009/07/01 0:36:10 ET
Table 'MJxeZCzYELxiIsyUZyT0jw' 6-max Seat #6 is the button
Seat 1: tdOvWynovql5imfooroLMg ($49.50 in chips)
Seat 2: dB6jzDlJmET84VMWw1mTRA ($50.75 in chips)
Seat 3: JQZew0FjzS19kTjeNtrE+A ($51.40 in chips)
Seat 4: lP7Q6pewz4C2RsAfKsjdWw ($33.30 in chips)
Seat 5: 3jvoOXNtXE90w2BdfNZwZQ ($50 in chips)
Seat 6: TTx3CHxyi0SObcHyMJRp5w ($62.70 in chips)
tdOvWynovql5imfooroLMg: posts small blind $0.25
dB6jzDlJmET84VMWw1mTRA: posts big blind $0.50
*** HOLE CARDS ***
JQZew0FjzS19kTjeNtrE+A: raises $1.50 to $2
lP7Q6pewz4C2RsAfKsjdWw: folds
3jvoOXNtXE90w2BdfNZwZQ: folds
TTx3CHxyi0SObcHyMJRp5w: folds
tdOvWynovql5imfooroLMg: folds
dB6jzDlJmET84VMWw1mTRA: folds
JQZew0FjzS19kTjeNtrE+A collected $1.25 from pot
*** SUMMARY ***
Total pot $1.25 | Rake $0
Seat 1: tdOvWynovql5imfooroLMg (small blind) folded before Flop
Seat 2: dB6jzDlJmET84VMWw1mTRA (big blind) folded before Flop
Seat 3: JQZew0FjzS19kTjeNtrE+A collected ($1.25)
Seat 4: lP7Q6pewz4C2RsAfKsjdWw folded before Flop (didn't bet)
Seat 5: 3jvoOXNtXE90w2BdfNZwZQ folded before Flop (didn't bet)
Seat 6: TTx3CHxyi0SObcHyMJRp5w (button) folded before Flop (didn't bet)



PokerStars Game #59939293824:  Hold'em No Limit ($0.25/$0.50) - 2009/07/01 0:36:11 ET
Table 'E7bWJ45aoFXRpyRv2gw+Ig' 2-max Seat #2 is the button
Seat 1: FRkiRasEGlHUeLrEl+k/nA ($56.10 in chips)
Seat 2: 3Wro85I7472vJ4Wkpneo9A ($139.25 in chips)
3Wro85I7472vJ4Wkpneo9A: posts small blind $0.25
FRkiRasEGlHUeLrEl+k/nA: posts big blind $0.50
*** HOLE CARDS ***
3Wro85I7472vJ4Wkpneo9A: raises $1 to $1.50
FRkiRasEGlHUeLrEl+k/nA: calls $1
*** FLOP *** [2s 9c 3d]
FRkiRasEGlHUeLrEl+k/nA: checks
3Wro85I7472vJ4Wkpneo9A: bets $2
FRkiRasEGlHUeLrEl+k/nA: folds
3Wro85I7472vJ4Wkpneo9A collected $2.85 from pot
3Wro85I7472vJ4Wkpneo9A: doesn't show hand
*** SUMMARY ***
Total pot $3 | Rake $0.15
Board [2s 9c 3d]
Seat 1: FRkiRasEGlHUeLrEl+k/nA (big blind) folded on the Flop
Seat 2: 3Wro85I7472vJ4Wkpneo9A (button) (small blind) collected ($2.85)



PokerStars Game #59939295968:  Hold'em No Limit ($0.25/$0.50) - 2009/07/01 0:36:14 ET
Table 'IeNZOZQ4T6oiaHqFeo6yIA' 2-max Seat #2 is the button
Seat 1: ndd1nfncBkWNitBnsfCoVQ ($52.05 in chips)
Seat 2: A91IUl5JaZROhtfCtnnwYw ($76.20 in chips)
A91IUl5JaZROhtfCtnnwYw: posts small blind $0.25
ndd1nfncBkWNitBnsfCoVQ: posts big blind $0.50
*** HOLE CARDS ***
A91IUl5JaZROhtfCtnnwYw: raises $0.50 to $1
ndd1nfncBkWNitBnsfCoVQ: calls $0.50
*** FLOP *** [Kh 2d Js]
ndd1nfncBkWNitBnsfCoVQ: checks
A91IUl5JaZROhtfCtnnwYw: checks
*** TURN *** [Kh 2d Js] [Ac]
ndd1nfncBkWNitBnsfCoVQ: checks
A91IUl5JaZROhtfCtnnwYw: checks
*** RIVER *** [Kh 2d Js Ac] [5c]
ndd1nfncBkWNitBnsfCoVQ: checks
A91IUl5JaZROhtfCtnnwYw: checks
*** SHOW DOWN ***
ndd1nfncBkWNitBnsfCoVQ: shows [4s 4h] (a pair of Fours)
A91IUl5JaZROhtfCtnnwYw: mucks hand
ndd1nfncBkWNitBnsfCoVQ collected $1.90 from pot
*** SUMMARY ***
Total pot $2 | Rake $0.10
Board [Kh 2d Js Ac 5c]
Seat 1: ndd1nfncBkWNitBnsfCoVQ (big blind) showed [4s 4h] and won ($1.90) with a pair of Fours
Seat 2: A91IUl5JaZROhtfCtnnwYw (button) (small blind) mucked



PokerStars Game #59939296320:  Hold'em No Limit ($0.25/$0.50) - 2009/07/01 0:36:15 ET
Table 'T/PgNWqVyY6lkldcBVXYJQ' 6-max Seat #3 is the button
Seat 1: +Pf9jTVizYlIo+woPvptfA ($57.25 in chips)
Seat 2: oZAeY5rVqNGgt8yyQ0pxbA ($37.70 in chips)
Seat 3: L3OcNO1bgdqDI46j67KQPQ ($53.85 in chips)
Seat 4: otJMdCRvqd5YCcFsA3JWpg ($9.50 in chips)
Seat 5: vVQBckETtigfb5mAcyK0OA ($52.65 in chips)
Seat 6: cDzbog6kwmJp+LBeBq+iMQ ($41.25 in chips)
otJMdCRvqd5YCcFsA3JWpg: posts small blind $0.25
vVQBckETtigfb5mAcyK0OA: posts big blind $0.50
*** HOLE CARDS ***
cDzbog6kwmJp+LBeBq+iMQ: folds
+Pf9jTVizYlIo+woPvptfA: folds
oZAeY5rVqNGgt8yyQ0pxbA: folds
L3OcNO1bgdqDI46j67KQPQ: folds
otJMdCRvqd5YCcFsA3JWpg: folds
vVQBckETtigfb5mAcyK0OA collected $0.50 from pot
*** SUMMARY ***
Total pot $0.50 | Rake $0
Seat 1: +Pf9jTVizYlIo+woPvptfA folded before Flop (didn't bet)
Seat 2: oZAeY5rVqNGgt8yyQ0pxbA folded before Flop (didn't bet)
Seat 3: L3OcNO1bgdqDI46j67KQPQ (button) folded before Flop (didn't bet)
Seat 4: otJMdCRvqd5YCcFsA3JWpg (small blind) folded before Flop
Seat 5: vVQBckETtigfb5mAcyK0OA (big blind) collected ($0.50)
Seat 6: cDzbog6kwmJp+LBeBq+iMQ folded before Flop (didn't bet)



PokerStars Game #59939296598:  Hold'em No Limit ($0.25/$0.50) - 2009/07/01 0:36:15 ET
Table 'PALRfuH85dr5IkDfdv6new' 9-max Seat #8 is the button
Seat 1: SKnJuWHScqetA/qG5p+wCg ($30 in chips)
Seat 2: 9r7ZoBbAJj5IeyZ0q9BdzA ($8 in chips)
Seat 3: 50QWoELmpmHFrFIlWMJo9g ($86.70 in chips)
Seat 4: mZNMJI1mY40XTC0U7GZakA ($57.65 in chips)
Seat 5: jSSGUXdNFAZA3QCvTcUMQw ($42.70 in chips)
Seat 6: E2518gp4aFz1+kAgmGqeEg ($14.50 in chips)
Seat 7: 3NcyXvr39gnK+KbTq7ezyA ($36.20 in chips)
Seat 8: NkS+CseUKx4XHszWq0PXEQ ($43.90 in chips)
Seat 9: CIrAX/m6o7jYmKOAjJXv4Q ($39.20 in chips)
CIrAX/m6o7jYmKOAjJXv4Q: posts small blind $0.25
SKnJuWHScqetA/qG5p+wCg: posts big blind $0.50
*** HOLE CARDS ***
9r7ZoBbAJj5IeyZ0q9BdzA: raises $1.50 to $2
50QWoELmpmHFrFIlWMJo9g: folds
mZNMJI1mY40XTC0U7GZakA: folds
jSSGUXdNFAZA3QCvTcUMQw: folds
E2518gp4aFz1+kAgmGqeEg: folds
3NcyXvr39gnK+KbTq7ezyA: folds
NkS+CseUKx4XHszWq0PXEQ: folds
CIrAX/m6o7jYmKOAjJXv4Q: folds
SKnJuWHScqetA/qG5p+wCg: folds
9r7ZoBbAJj5IeyZ0q9BdzA collected $1.25 from pot
*** SUMMARY ***
Total pot $1.25 | Rake $0
Seat 1: SKnJuWHScqetA/qG5p+wCg (big blind) folded before Flop
Seat 2: 9r7ZoBbAJj5IeyZ0q9BdzA collected ($1.25)
Seat 3: 50QWoELmpmHFrFIlWMJo9g folded before Flop (didn't bet)
Seat 4: mZNMJI1mY40XTC0U7GZakA folded before Flop (didn't bet)
Seat 5: jSSGUXdNFAZA3QCvTcUMQw folded before Flop (didn't bet)
Seat 6: E2518gp4aFz1+kAgmGqeEg folded before Flop (didn't bet)
Seat 7: 3NcyXvr39gnK+KbTq7ezyA folded before Flop (didn't bet)
Seat 8: NkS+CseUKx4XHszWq0PXEQ (button) folded before Flop (didn't bet)
Seat 9: CIrAX/m6o7jYmKOAjJXv4Q (small blind) folded before Flop



PokerStars Game #59939298112:  Hold'em No Limit ($0.25/$0.50) - 2009/07/01 0:36:18 ET
Table 'Nz0Vr7WMHL2g5Uk7dDZjpw' 9-max Seat #8 is the button
Seat 1: tLkxo7JgV+WWI0UBw44K5A ($97.25 in chips)
Seat 2: XNMDwbXt/Q4jM99AXnbJDw ($67.45 in chips)
Seat 3: 4QTiNH5fteLgJjx/s6Hy6A ($15.25 in chips)
Seat 4: 5JJVDlaiMnB004o/RqbZZQ ($27.25 in chips)
Seat 5: WGW0DgjBUXs1ylURHG8vnQ ($16.45 in chips)
Seat 6: k1f0lS7tlMHCLGs0JT34Tg ($13.50 in chips)
Seat 7: KPLH0gELgFe2OuAnhJFI5w ($25.50 in chips)
Seat 8: HkZI6g4zl83TDTA7SRspmQ ($15.70 in chips)
Seat 9: Ak2W6V2TDVIQrvSAy4eD7Q ($50.25 in chips)
Ak2W6V2TDVIQrvSAy4eD7Q: posts small blind $0.25
tLkxo7JgV+WWI0UBw44K5A: posts big blind $0.50
*** HOLE CARDS ***
XNMDwbXt/Q4jM99AXnbJDw: folds
4QTiNH5fteLgJjx/s6Hy6A: calls $0.50
5JJVDlaiMnB004o/RqbZZQ: folds
WGW0DgjBUXs1ylURHG8vnQ: folds
k1f0lS7tlMHCLGs0JT34Tg: folds
KPLH0gELgFe2OuAnhJFI5w: calls $0.50
HkZI6g4zl83TDTA7SRspmQ: calls $0.50
Ak2W6V2TDVIQrvSAy4eD7Q: calls $0.25
tLkxo7JgV+WWI0UBw44K5A: checks
*** FLOP *** [3d 6c Th]
Ak2W6V2TDVIQrvSAy4eD7Q: checks
tLkxo7JgV+WWI0UBw44K5A: checks
4QTiNH5fteLgJjx/s6Hy6A: bets $1.50
KPLH0gELgFe2OuAnhJFI5w: folds
HkZI6g4zl83TDTA7SRspmQ: folds
Ak2W6V2TDVIQrvSAy4eD7Q: folds
Ak2W6V2TDVIQrvSAy4eD7Q leaves the table
mSD1pginDsyHG5PDfqzphw joins the table at seat #9
tLkxo7JgV+WWI0UBw44K5A: folds
4QTiNH5fteLgJjx/s6Hy6A collected $2.40 from pot
*** SUMMARY ***
Total pot $2.50 | Rake $0.10
Board [3d 6c Th]
Seat 1: tLkxo7JgV+WWI0UBw44K5A (big blind) folded on the Flop
Seat 2: XNMDwbXt/Q4jM99AXnbJDw folded before Flop (didn't bet)
Seat 3: 4QTiNH5fteLgJjx/s6Hy6A collected ($2.40)
Seat 4: 5JJVDlaiMnB004o/RqbZZQ folded before Flop (didn't bet)
Seat 5: WGW0DgjBUXs1ylURHG8vnQ folded before Flop (didn't bet)
Seat 6: k1f0lS7tlMHCLGs0JT34Tg folded before Flop (didn't bet)
Seat 7: KPLH0gELgFe2OuAnhJFI5w folded on the Flop
Seat 8: HkZI6g4zl83TDTA7SRspmQ (button) folded on the Flop
Seat 9: Ak2W6V2TDVIQrvSAy4eD7Q (small blind) folded on the Flop



PokerStars Game #59939299162:  Hold'em No Limit ($0.25/$0.50) - 2009/07/01 0:36:19 ET
Table '+z1aekfHkpp09pc8F9aViw' 6-max Seat #5 is the button
Seat 1: FHilMb2i2DbUCc9lplszog ($47.60 in chips)
Seat 2: M6xK/VklCvdyyrmvzATlxQ ($36.80 in chips)
Seat 3: uUznlIMFnRUvwrBhYF73KA ($58.15 in chips)
Seat 4: RowCSpSURHTOL/dcjg/Iug ($50.80 in chips)
Seat 5: crjGpJEzSZgD38FoE3VMGg ($54.60 in chips)
Seat 6: 686aeHikcJlgKkSuIFdcXQ ($68.85 in chips)
686aeHikcJlgKkSuIFdcXQ: posts small blind $0.25
FHilMb2i2DbUCc9lplszog: posts big blind $0.50
*** HOLE CARDS ***
M6xK/VklCvdyyrmvzATlxQ: folds
uUznlIMFnRUvwrBhYF73KA: calls $0.50
RowCSpSURHTOL/dcjg/Iug: folds
crjGpJEzSZgD38FoE3VMGg: raises $2 to $2.50
686aeHikcJlgKkSuIFdcXQ: folds
FHilMb2i2DbUCc9lplszog: calls $2
uUznlIMFnRUvwrBhYF73KA: calls $2
*** FLOP *** [9h 7c 8s]
FHilMb2i2DbUCc9lplszog: checks
uUznlIMFnRUvwrBhYF73KA: bets $4
crjGpJEzSZgD38FoE3VMGg: calls $4
FHilMb2i2DbUCc9lplszog: calls $4
*** TURN *** [9h 7c 8s] [2c]
FHilMb2i2DbUCc9lplszog: checks
uUznlIMFnRUvwrBhYF73KA: checks
crjGpJEzSZgD38FoE3VMGg: checks
*** RIVER *** [9h 7c 8s 2c] [3s]
FHilMb2i2DbUCc9lplszog: checks
uUznlIMFnRUvwrBhYF73KA: bets $12
crjGpJEzSZgD38FoE3VMGg: folds
FHilMb2i2DbUCc9lplszog: folds
uUznlIMFnRUvwrBhYF73KA collected $18.80 from pot
*** SUMMARY ***
Total pot $19.75 | Rake $0.95
Board [9h 7c 8s 2c 3s]
Seat 1: FHilMb2i2DbUCc9lplszog (big blind) folded on the River
Seat 2: M6xK/VklCvdyyrmvzATlxQ folded before Flop (didn't bet)
Seat 3: uUznlIMFnRUvwrBhYF73KA collected ($18.80)
Seat 4: RowCSpSURHTOL/dcjg/Iug folded before Flop (didn't bet)
Seat 5: crjGpJEzSZgD38FoE3VMGg (button) folded on the River
Seat 6: 686aeHikcJlgKkSuIFdcXQ (small blind) folded before Flop



PokerStars Game #59939299620:  Hold'em No Limit ($0.25/$0.50) - 2009/07/01 0:36:20 ET
Table 'kgbJRsxfv64KrErDRBAkcw' 6-max Seat #2 is the button
Seat 2: Q+thC23WCv1kJUJtH/+4Jw ($52.80 in chips)
Seat 3: T0Gx/FcQ5VH9u7XaOMX97A ($108.85 in chips)
Seat 4: qanMEqjABjWxC/JgQ/0l7w ($55.45 in chips)
Seat 5: +Pf9jTVizYlIo+woPvptfA ($51.55 in chips)
T0Gx/FcQ5VH9u7XaOMX97A: posts small blind $0.25
qanMEqjABjWxC/JgQ/0l7w: posts big blind $0.50
*** HOLE CARDS ***
+Pf9jTVizYlIo+woPvptfA: folds
mxTUARCsU8Eby0whmHNcOw leaves the table
Q+thC23WCv1kJUJtH/+4Jw: folds
T0Gx/FcQ5VH9u7XaOMX97A: folds
qanMEqjABjWxC/JgQ/0l7w collected $0.50 from pot
*** SUMMARY ***
Total pot $0.50 | Rake $0
Seat 2: Q+thC23WCv1kJUJtH/+4Jw (button) folded before Flop (didn't bet)
Seat 3: T0Gx/FcQ5VH9u7XaOMX97A (small blind) folded before Flop
Seat 4: qanMEqjABjWxC/JgQ/0l7w (big blind) collected ($0.50)
Seat 5: +Pf9jTVizYlIo+woPvptfA folded before Flop (didn't bet)



PokerStars Game #59939300488:  Hold'em No Limit ($0.25/$0.50) - 2009/07/01 0:36:21 ET
Table '5EmHi+fnatGQQShcNmzOZQ' 6-max Seat #5 is the button
Seat 2: vXIHnZ+dv/hwSBxyvGw7bQ ($78 in chips)
Seat 3: L9qfLYXrczhAPd/VckgsWw ($91.25 in chips)
Seat 5: kxPhs4ePFqMy52CInAJ2aw ($53.10 in chips)
Seat 6: 686aeHikcJlgKkSuIFdcXQ ($138.15 in chips)
686aeHikcJlgKkSuIFdcXQ: posts small blind $0.25
vXIHnZ+dv/hwSBxyvGw7bQ: posts big blind $0.50
1b+2BbjMN8qhR1WPqdE9VQ: sits out
*** HOLE CARDS ***
SwPczQo3cOtwEzhJrfO2cQ leaves the table
L9qfLYXrczhAPd/VckgsWw: folds
kxPhs4ePFqMy52CInAJ2aw: folds
686aeHikcJlgKkSuIFdcXQ: raises $1.50 to $2
vXIHnZ+dv/hwSBxyvGw7bQ: folds
686aeHikcJlgKkSuIFdcXQ collected $1 from pot
*** SUMMARY ***
Total pot $1 | Rake $0
Seat 2: vXIHnZ+dv/hwSBxyvGw7bQ (big blind) folded before Flop
Seat 3: L9qfLYXrczhAPd/VckgsWw folded before Flop (didn't bet)
Seat 5: kxPhs4ePFqMy52CInAJ2aw (button) folded before Flop (didn't bet)
Seat 6: 686aeHikcJlgKkSuIFdcXQ (small blind) collected ($1)



PokerStars Game #59939300406:  Hold'em No Limit ($0.25/$0.50) - 2009/07/01 0:36:21 ET
Table 'tyR5AZNKV8Aadbrnrnlg7g' 6-max Seat #3 is the button
Seat 1: R+KjpH/wSjDLhtIy9+edNA ($84.40 in chips)
Seat 2: BAjwVL+zKKd0s0fAWstzQQ ($18.60 in chips)
Seat 3: tdOvWynovql5imfooroLMg ($48.45 in chips)
Seat 4: Rt6KgtZ8YaJoTc3FPim00w ($82.70 in chips)
Seat 6: ZKazl1hGaPiapDXincgi2Q ($17.90 in chips)
Rt6KgtZ8YaJoTc3FPim00w: posts small blind $0.25
ZKazl1hGaPiapDXincgi2Q: posts big blind $0.50
*** HOLE CARDS ***
R+KjpH/wSjDLhtIy9+edNA: folds
BAjwVL+zKKd0s0fAWstzQQ: folds
tdOvWynovql5imfooroLMg: folds
Rt6KgtZ8YaJoTc3FPim00w: folds
ZKazl1hGaPiapDXincgi2Q collected $0.50 from pot
ZKazl1hGaPiapDXincgi2Q: doesn't show hand
*** SUMMARY ***
Total pot $0.50 | Rake $0
Seat 1: R+KjpH/wSjDLhtIy9+edNA folded before Flop (didn't bet)
Seat 2: BAjwVL+zKKd0s0fAWstzQQ folded before Flop (didn't bet)
Seat 3: tdOvWynovql5imfooroLMg (button) folded before Flop (didn't bet)
Seat 4: Rt6KgtZ8YaJoTc3FPim00w (small blind) folded before Flop
Seat 6: ZKazl1hGaPiapDXincgi2Q (big blind) collected ($0.50)



PokerStars Game #59939302644:  Hold'em No Limit ($0.25/$0.50) - 2009/07/01 0:36:24 ET
Table 'X6IRCRTh+20gjz8aubWnwA' 9-max Seat #9 is the button
Seat 1: DSM67hHHq1XFoEOi9p8Alw ($51.05 in chips)
Seat 2: HZkVla4kK2SI42CVrPZ/ig ($8.50 in chips)
Seat 3: GeZ7AYmAZ9Ln8liPZzV8EA ($23.70 in chips)
Seat 4: 2J+UVOVrW+V3maOylyxMcQ ($40.65 in chips)
Seat 5: QtFsO51ArDuQ44+KvR2jow ($28.60 in chips)
Seat 6: /6In1zC3WtgwxDcueWzZWg ($66.40 in chips)
Seat 7: cFHQjKQOOKTUzoilhrXHLg ($27.75 in chips)
Seat 8: HxeBVq06/3Bh/H986sgdbw ($7.25 in chips)
Seat 9: M+7+BTmX5vZatHVuoRB1nA ($80.75 in chips)
DSM67hHHq1XFoEOi9p8Alw: posts small blind $0.25
HZkVla4kK2SI42CVrPZ/ig: posts big blind $0.50
*** HOLE CARDS ***
GeZ7AYmAZ9Ln8liPZzV8EA: folds
2J+UVOVrW+V3maOylyxMcQ: calls $0.50
QtFsO51ArDuQ44+KvR2jow: folds
/6In1zC3WtgwxDcueWzZWg: folds
cFHQjKQOOKTUzoilhrXHLg: calls $0.50
HxeBVq06/3Bh/H986sgdbw: folds
M+7+BTmX5vZatHVuoRB1nA: folds
DSM67hHHq1XFoEOi9p8Alw: folds
HZkVla4kK2SI42CVrPZ/ig: checks
*** FLOP *** [8h 4d Td]
HZkVla4kK2SI42CVrPZ/ig: checks
2J+UVOVrW+V3maOylyxMcQ: bets $0.50
cFHQjKQOOKTUzoilhrXHLg: calls $0.50
HZkVla4kK2SI42CVrPZ/ig: calls $0.50
*** TURN *** [8h 4d Td] [3s]
HZkVla4kK2SI42CVrPZ/ig: checks
2J+UVOVrW+V3maOylyxMcQ: bets $0.50
cFHQjKQOOKTUzoilhrXHLg: calls $0.50
HZkVla4kK2SI42CVrPZ/ig: calls $0.50
*** RIVER *** [8h 4d Td 3s] [4c]
HZkVla4kK2SI42CVrPZ/ig: checks
2J+UVOVrW+V3maOylyxMcQ: checks
cFHQjKQOOKTUzoilhrXHLg: checks
*** SHOW DOWN ***
HZkVla4kK2SI42CVrPZ/ig: shows [7h 5c] (a pair of Fours)
2J+UVOVrW+V3maOylyxMcQ: shows [7d Ad] (a pair of Fours - Ace kicker)
cFHQjKQOOKTUzoilhrXHLg: mucks hand
2J+UVOVrW+V3maOylyxMcQ collected $4.55 from pot
*** SUMMARY ***
Total pot $4.75 | Rake $0.20
Board [8h 4d Td 3s 4c]
Seat 1: DSM67hHHq1XFoEOi9p8Alw (small blind) folded before Flop
Seat 2: HZkVla4kK2SI42CVrPZ/ig (big blind) showed [7h 5c] and lost with a pair of Fours
Seat 3: GeZ7AYmAZ9Ln8liPZzV8EA folded before Flop (didn't bet)
Seat 4: 2J+UVOVrW+V3maOylyxMcQ showed [7d Ad] and won ($4.55) with a pair of Fours
Seat 5: QtFsO51ArDuQ44+KvR2jow folded before Flop (didn't bet)
Seat 6: /6In1zC3WtgwxDcueWzZWg folded before Flop (didn't bet)
Seat 7: cFHQjKQOOKTUzoilhrXHLg mucked
Seat 8: HxeBVq06/3Bh/H986sgdbw folded before Flop (didn't bet)
Seat 9: M+7+BTmX5vZatHVuoRB1nA (button) folded before Flop (didn't bet)



PokerStars Game #59939303362:  Hold'em No Limit ($0.25/$0.50) - 2009/07/01 0:36:25 ET
Table 'QOgaEqMcJ73pcUMMxoisUgErOuyGLI5PT3G5MnpHgC/g Seat #5 is the button
Seat 1: L5e2lrPLQm1Pqx30IIZ/Fw ($10 in chips)
Seat 2: RjBdQ6w31rgcy0o24VLR6w ($18.95 in chips)
Seat 3: xZCXQSXlrZkp3pZizzVXCw ($50.50 in chips)
Seat 4: 3UmXLy3GfjC3EkOebduerQ ($50 in chips)
Seat 5: JwvquocWfhTVApN5t47LgA ($57.05 in chips)
Seat 6: zE9cVigS2nW/Ljy4K4bUQA ($30 in chips)
Seat 7: 90Wb75h3W1BRpbqVnuk8gw ($62.95 in chips)
Seat 8: g4k0NXISyLCqaSWZDBjfEg ($52.10 in chips)
Seat 9: J0W5D97jl5VLky+IoPvDeA ($57.15 in chips)
zE9cVigS2nW/Ljy4K4bUQA: posts small blind $0.25
90Wb75h3W1BRpbqVnuk8gw: posts big blind $0.50
*** HOLE CARDS ***
g4k0NXISyLCqaSWZDBjfEg: folds
J0W5D97jl5VLky+IoPvDeA: folds
L5e2lrPLQm1Pqx30IIZ/Fw: folds
RjBdQ6w31rgcy0o24VLR6w: folds
xZCXQSXlrZkp3pZizzVXCw: folds
3UmXLy3GfjC3EkOebduerQ: folds
JwvquocWfhTVApN5t47LgA: calls $0.50
zE9cVigS2nW/Ljy4K4bUQA: folds
90Wb75h3W1BRpbqVnuk8gw: checks
*** FLOP *** [Qh 8s 4c]
90Wb75h3W1BRpbqVnuk8gw: checks
JwvquocWfhTVApN5t47LgA: checks
*** TURN *** [Qh 8s 4c] [9s]
90Wb75h3W1BRpbqVnuk8gw: bets $1
JwvquocWfhTVApN5t47LgA: raises $1 to $2
90Wb75h3W1BRpbqVnuk8gw: calls $1
*** RIVER *** [Qh 8s 4c 9s] [Kd]
90Wb75h3W1BRpbqVnuk8gw: checks
JwvquocWfhTVApN5t47LgA: bets $4
90Wb75h3W1BRpbqVnuk8gw: folds
JwvquocWfhTVApN5t47LgA collected $5 from pot
*** SUMMARY ***
Total pot $5.25 | Rake $0.25
Board [Qh 8s 4c 9s Kd]
Seat 1: L5e2lrPLQm1Pqx30IIZ/Fw folded before Flop (didn't bet)
Seat 2: RjBdQ6w31rgcy0o24VLR6w folded before Flop (didn't bet)
Seat 3: xZCXQSXlrZkp3pZizzVXCw folded before Flop (didn't bet)
Seat 4: 3UmXLy3GfjC3EkOebduerQ folded before Flop (didn't bet)
Seat 5: JwvquocWfhTVApN5t47LgA (button) collected ($5)
Seat 6: zE9cVigS2nW/Ljy4K4bUQA (small blind) folded before Flop
Seat 7: 90Wb75h3W1BRpbqVnuk8gw (big blind) folded on the River
Seat 8: g4k0NXISyLCqaSWZDBjfEg folded before Flop (didn't bet)
Seat 9: J0W5D97jl5VLky+IoPvDeA folded before Flop (didn't bet)



PokerStars Game #59939303242:  Hold'em No Limit ($0.25/$0.50) - 2009/07/01 0:36:25 ET
Table 'NCiXr0d5CEKBQr/cZgLhbA' 9-max Seat #7 is the button
Seat 2: ulxuJchBV9iguXg0FUonfg ($25.80 in chips)
Seat 3: xZCXQSXlrZkp3pZizzVXCw ($50 in chips)
Seat 4: 5k9fvXD9suIgCxU4HLQjTw ($57.70 in chips)
Seat 5: zE9cVigS2nW/Ljy4K4bUQA ($39.95 in chips)
Seat 6: SKnJuWHScqetA/qG5p+wCg ($34 in chips)
Seat 7: M+7+BTmX5vZatHVuoRB1nA ($46 in chips)
Seat 8: 1MJUKc3cc0QmUoz1JZLR2w ($53.05 in chips)
Seat 9: 4WLZvqBn5qv5tds5kt5A1Q ($48.55 in chips)
1MJUKc3cc0QmUoz1JZLR2w: posts small blind $0.25
4WLZvqBn5qv5tds5kt5A1Q: posts big blind $0.50
pFtzb1sR4b0d1aw6aIRgDg: sits out
*** HOLE CARDS ***
ulxuJchBV9iguXg0FUonfg: folds
xZCXQSXlrZkp3pZizzVXCw: folds
5k9fvXD9suIgCxU4HLQjTw: folds
zE9cVigS2nW/Ljy4K4bUQA: folds
SKnJuWHScqetA/qG5p+wCg: folds
M+7+BTmX5vZatHVuoRB1nA: folds
1MJUKc3cc0QmUoz1JZLR2w: folds
4WLZvqBn5qv5tds5kt5A1Q collected $0.50 from pot
*** SUMMARY ***
Total pot $0.50 | Rake $0
Seat 2: ulxuJchBV9iguXg0FUonfg folded before Flop (didn't bet)
Seat 3: xZCXQSXlrZkp3pZizzVXCw folded before Flop (didn't bet)
Seat 4: 5k9fvXD9suIgCxU4HLQjTw folded before Flop (didn't bet)
Seat 5: zE9cVigS2nW/Ljy4K4bUQA folded before Flop (didn't bet)
Seat 6: SKnJuWHScqetA/qG5p+wCg folded before Flop (didn't bet)
Seat 7: M+7+BTmX5vZatHVuoRB1nA (button) folded before Flop (didn't bet)
Seat 8: 1MJUKc3cc0QmUoz1JZLR2w (small blind) folded before Flop
Seat 9: 4WLZvqBn5qv5tds5kt5A1Q (big blind) collected ($0.50)



PokerStars Game #59939303430:  Hold'em No Limit ($0.25/$0.50) - 2009/07/01 0:36:26 ET
Table 'c/CRn+68J3Y8KxD5g1ek2Q' 2-max Seat #1 is the button
Seat 1: 46qCyJ6evTkHo9al5sBMNA ($233.65 in chips)
Seat 2: BypVLsYQt3ePFm2xQL/dOA ($142.90 in chips)
46qCyJ6evTkHo9al5sBMNA: posts small blind $0.25
BypVLsYQt3ePFm2xQL/dOA: posts big blind $0.50
*** HOLE CARDS ***
46qCyJ6evTkHo9al5sBMNA: raises $1 to $1.50
BypVLsYQt3ePFm2xQL/dOA: folds
46qCyJ6evTkHo9al5sBMNA collected $1 from pot
46qCyJ6evTkHo9al5sBMNA: doesn't show hand
*** SUMMARY ***
Total pot $1 | Rake $0
Seat 1: 46qCyJ6evTkHo9al5sBMNA (button) (small blind) collected ($1)
Seat 2: BypVLsYQt3ePFm2xQL/dOA (big blind) folded before Flop



PokerStars Game #59939304012:  Hold'em No Limit ($0.25/$0.50) - 2009/07/01 0:36:26 ET
Table '+dXkOAQyS8j9PQZusUTMpg' 2-max Seat #2 is the button
Seat 1: XFa6sBGjP2gxoIvxR3fZIg ($50 in chips)
Seat 2: 5IBeOgaApY1Bvzv2P8X4EA ($141.60 in chips)
5IBeOgaApY1Bvzv2P8X4EA: posts small blind $0.25
XFa6sBGjP2gxoIvxR3fZIg said, "Well, IÃ¯Â¿Â½m not foldin AQ there"
XFa6sBGjP2gxoIvxR3fZIg: posts big blind $0.50
*** HOLE CARDS ***
5IBeOgaApY1Bvzv2P8X4EA said, "what did you have?"
5IBeOgaApY1Bvzv2P8X4EA: calls $0.25
XFa6sBGjP2gxoIvxR3fZIg: checks
*** FLOP *** [Jd 4d Td]
5IBeOgaApY1Bvzv2P8X4EA said, "mmm"
XFa6sBGjP2gxoIvxR3fZIg: checks
5IBeOgaApY1Bvzv2P8X4EA: bets $1
XFa6sBGjP2gxoIvxR3fZIg: folds
5IBeOgaApY1Bvzv2P8X4EA collected $0.95 from pot
5IBeOgaApY1Bvzv2P8X4EA: doesn't show hand
*** SUMMARY ***
Total pot $1 | Rake $0.05
Board [Jd 4d Td]
Seat 1: XFa6sBGjP2gxoIvxR3fZIg (big blind) folded on the Flop
Seat 2: 5IBeOgaApY1Bvzv2P8X4EA (button) (small blind) collected ($0.95)



PokerStars Game #59939304426:  Hold'em No Limit ($0.25/$0.50) - 2009/07/01 0:36:27 ET
Table 'E7bWJ45aoFXRpyRv2gw+Ig' 2-max Seat #1 is the button
Seat 1: FRkiRasEGlHUeLrEl+k/nA ($54.60 in chips)
Seat 2: 3Wro85I7472vJ4Wkpneo9A ($140.60 in chips)
FRkiRasEGlHUeLrEl+k/nA: posts small blind $0.25
3Wro85I7472vJ4Wkpneo9A: posts big blind $0.50
*** HOLE CARDS ***
FRkiRasEGlHUeLrEl+k/nA: raises $1 to $1.50
3Wro85I7472vJ4Wkpneo9A: folds
FRkiRasEGlHUeLrEl+k/nA collected $1 from pot
FRkiRasEGlHUeLrEl+k/nA: doesn't show hand
*** SUMMARY ***
Total pot $1 | Rake $0
Seat 1: FRkiRasEGlHUeLrEl+k/nA (button) (small blind) collected ($1)
Seat 2: 3Wro85I7472vJ4Wkpneo9A (big blind) folded before Flop



PokerStars Game #59939305076:  Hold'em No Limit ($0.25/$0.50) - 2009/07/01 0:36:28 ET
Table '+111aLuBwnz8YVYSA7J1jA' 2-max Seat #2 is the button
Seat 1: ndd1nfncBkWNitBnsfCoVQ ($93 in chips)
Seat 2: +ciXH35zeafrjg1W6wiBTg ($55.85 in chips)
+ciXH35zeafrjg1W6wiBTg: posts small blind $0.25
ndd1nfncBkWNitBnsfCoVQ: posts big blind $0.50
*** HOLE CARDS ***
+ciXH35zeafrjg1W6wiBTg: raises $1.50 to $2
ndd1nfncBkWNitBnsfCoVQ: folds
+ciXH35zeafrjg1W6wiBTg collected $1 from pot
+ciXH35zeafrjg1W6wiBTg: doesn't show hand
*** SUMMARY ***
Total pot $1 | Rake $0
Seat 1: ndd1nfncBkWNitBnsfCoVQ (big blind) folded before Flop
Seat 2: +ciXH35zeafrjg1W6wiBTg (button) (small blind) collected ($1)



PokerStars Game #59939305154:  Hold'em No Limit ($0.25/$0.50) - 2009/07/01 0:36:28 ET
Table 'MJxeZCzYELxiIsyUZyT0jw' 6-max Seat #1 is the button
Seat 1: tdOvWynovql5imfooroLMg ($49.25 in chips)
Seat 2: dB6jzDlJmET84VMWw1mTRA ($50.25 in chips)
Seat 3: JQZew0FjzS19kTjeNtrE+A ($52.15 in chips)
Seat 4: lP7Q6pewz4C2RsAfKsjdWw ($33.30 in chips)
Seat 5: 3jvoOXNtXE90w2BdfNZwZQ ($50 in chips)
Seat 6: TTx3CHxyi0SObcHyMJRp5w ($62.70 in chips)
dB6jzDlJmET84VMWw1mTRA: posts small blind $0.25
JQZew0FjzS19kTjeNtrE+A: posts big blind $0.50
*** HOLE CARDS ***
lP7Q6pewz4C2RsAfKsjdWw: raises $0.50 to $1
3jvoOXNtXE90w2BdfNZwZQ: folds
TTx3CHxyi0SObcHyMJRp5w: calls $1
tdOvWynovql5imfooroLMg: folds
dB6jzDlJmET84VMWw1mTRA: folds
JQZew0FjzS19kTjeNtrE+A: calls $0.50
*** FLOP *** [Kc As 4s]
JQZew0FjzS19kTjeNtrE+A: checks
lP7Q6pewz4C2RsAfKsjdWw: bets $2.50
TTx3CHxyi0SObcHyMJRp5w: folds
JQZew0FjzS19kTjeNtrE+A: folds
lP7Q6pewz4C2RsAfKsjdWw collected $3.10 from pot
lP7Q6pewz4C2RsAfKsjdWw: doesn't show hand
*** SUMMARY ***
Total pot $3.25 | Rake $0.15
Board [Kc As 4s]
Seat 1: tdOvWynovql5imfooroLMg (button) folded before Flop (didn't bet)
Seat 2: dB6jzDlJmET84VMWw1mTRA (small blind) folded before Flop
Seat 3: JQZew0FjzS19kTjeNtrE+A (big blind) folded on the Flop
Seat 4: lP7Q6pewz4C2RsAfKsjdWw collected ($3.10)
Seat 5: 3jvoOXNtXE90w2BdfNZwZQ folded before Flop (didn't bet)
Seat 6: TTx3CHxyi0SObcHyMJRp5w folded on the Flop



PokerStars Game #59939306542:  Hold'em No Limit ($0.25/$0.50) - 2009/07/01 0:36:30 ET
Table 'T/PgNWqVyY6lkldcBVXYJQ' 6-max Seat #4 is the button
Seat 1: +Pf9jTVizYlIo+woPvptfA ($57.25 in chips)
Seat 2: oZAeY5rVqNGgt8yyQ0pxbA ($37.70 in chips)
Seat 3: L3OcNO1bgdqDI46j67KQPQ ($53.85 in chips)
Seat 4: otJMdCRvqd5YCcFsA3JWpg ($9.25 in chips)
Seat 5: vVQBckETtigfb5mAcyK0OA ($52.90 in chips)
Seat 6: cDzbog6kwmJp+LBeBq+iMQ ($41.25 in chips)
vVQBckETtigfb5mAcyK0OA: posts small blind $0.25
cDzbog6kwmJp+LBeBq+iMQ: posts big blind $0.50
*** HOLE CARDS ***
+Pf9jTVizYlIo+woPvptfA: folds
oZAeY5rVqNGgt8yyQ0pxbA: folds
L3OcNO1bgdqDI46j67KQPQ: folds
otJMdCRvqd5YCcFsA3JWpg: folds
vVQBckETtigfb5mAcyK0OA: calls $0.25
cDzbog6kwmJp+LBeBq+iMQ: checks
*** FLOP *** [7d 5s Kc]
vVQBckETtigfb5mAcyK0OA: checks
cDzbog6kwmJp+LBeBq+iMQ: checks
*** TURN *** [7d 5s Kc] [Kh]
oZAeY5rVqNGgt8yyQ0pxbA leaves the table
vVQBckETtigfb5mAcyK0OA: checks
cDzbog6kwmJp+LBeBq+iMQ: bets $0.50
vVQBckETtigfb5mAcyK0OA: calls $0.50
*** RIVER *** [7d 5s Kc Kh] [3s]
vVQBckETtigfb5mAcyK0OA: checks
cDzbog6kwmJp+LBeBq+iMQ: bets $1.50
vVQBckETtigfb5mAcyK0OA: folds
cDzbog6kwmJp+LBeBq+iMQ collected $1.95 from pot
*** SUMMARY ***
Total pot $2 | Rake $0.05
Board [7d 5s Kc Kh 3s]
Seat 1: +Pf9jTVizYlIo+woPvptfA folded before Flop (didn't bet)
Seat 2: oZAeY5rVqNGgt8yyQ0pxbA folded before Flop (didn't bet)
Seat 3: L3OcNO1bgdqDI46j67KQPQ folded before Flop (didn't bet)
Seat 4: otJMdCRvqd5YCcFsA3JWpg (button) folded before Flop (didn't bet)
Seat 5: vVQBckETtigfb5mAcyK0OA (small blind) folded on the River
Seat 6: cDzbog6kwmJp+LBeBq+iMQ (big blind) collected ($1.95)



PokerStars Game #59939306472:  Hold'em No Limit ($0.25/$0.50) - 2009/07/01 0:36:30 ET
Table 'mTxf8gPLgffN3Iwfm7Icfg' 2-max Seat #2 is the button
Seat 1: Do9Rlu1R5u/AcRtMTl8SYg ($64.70 in chips)
Seat 2: EMc5LPgVaded4Qc77vm0fw ($93.05 in chips)
EMc5LPgVaded4Qc77vm0fw: posts small blind $0.25
Do9Rlu1R5u/AcRtMTl8SYg: posts big blind $0.50
*** HOLE CARDS ***
EMc5LPgVaded4Qc77vm0fw: raises $1.50 to $2
Do9Rlu1R5u/AcRtMTl8SYg: folds
EMc5LPgVaded4Qc77vm0fw collected $1 from pot
EMc5LPgVaded4Qc77vm0fw: doesn't show hand
*** SUMMARY ***
Total pot $1 | Rake $0
Seat 1: Do9Rlu1R5u/AcRtMTl8SYg (big blind) folded before Flop
Seat 2: EMc5LPgVaded4Qc77vm0fw (button) (small blind) collected ($1)



PokerStars Game #59939306470:  Hold'em No Limit ($0.25/$0.50) - 2009/07/01 0:36:30 ET
Table 'lSisgp6H7Fg1hH5VfjEjYQ' 9-max Seat #1 is the button
Seat 1: pEW8B6uXbdR47kfljMQ3+Q ($37.10 in chips)
Seat 2: UrcnkQOiLVk8BlKDPJSy7Q ($52.55 in chips)
Seat 3: aTkyjTh3w5YLWiIERupZOA ($42.45 in chips)
Seat 4: bwv/rbH/hHhPhY6u9mu04w ($21.65 in chips)
Seat 5: mSD1pginDsyHG5PDfqzphw ($12.10 in chips)
Seat 6: +k7T5ocke8UwavtgUHm+Cg ($28.95 in chips)
Seat 7: Y3DZ6qQlLeBhixDj4M9vmg ($11 in chips)
Seat 8: a4JDWmpFQkL10XfAyuF51A ($34.75 in chips)
UrcnkQOiLVk8BlKDPJSy7Q: posts small blind $0.25
aTkyjTh3w5YLWiIERupZOA: posts big blind $0.50
gsyXT42WLEcOS4DdEk2wlw: sits out
*** HOLE CARDS ***
bwv/rbH/hHhPhY6u9mu04w: folds
mSD1pginDsyHG5PDfqzphw: folds
+k7T5ocke8UwavtgUHm+Cg: folds
Y3DZ6qQlLeBhixDj4M9vmg: raises $1 to $1.50
a4JDWmpFQkL10XfAyuF51A: folds
pEW8B6uXbdR47kfljMQ3+Q: folds
UrcnkQOiLVk8BlKDPJSy7Q: folds
aTkyjTh3w5YLWiIERupZOA: folds
Y3DZ6qQlLeBhixDj4M9vmg collected $1.25 from pot
*** SUMMARY ***
Total pot $1.25 | Rake $0
Seat 1: pEW8B6uXbdR47kfljMQ3+Q (button) folded before Flop (didn't bet)
Seat 2: UrcnkQOiLVk8BlKDPJSy7Q (small blind) folded before Flop
Seat 3: aTkyjTh3w5YLWiIERupZOA (big blind) folded before Flop
Seat 4: bwv/rbH/hHhPhY6u9mu04w folded before Flop (didn't bet)
Seat 5: mSD1pginDsyHG5PDfqzphw folded before Flop (didn't bet)
Seat 6: +k7T5ocke8UwavtgUHm+Cg folded before Flop (didn't bet)
Seat 7: Y3DZ6qQlLeBhixDj4M9vmg collected ($1.25)
Seat 8: a4JDWmpFQkL10XfAyuF51A folded before Flop (didn't bet)



PokerStars Game #59939306960:  Hold'em No Limit ($0.25/$0.50) - 2009/07/01 0:36:31 ET
Table 'ibNfFy0bCzuBaUORla0aGw' 9-max Seat #6 is the button
Seat 1: xZCXQSXlrZkp3pZizzVXCw ($53.95 in chips)
Seat 2: 90Wb75h3W1BRpbqVnuk8gw ($59.65 in chips)
Seat 3: dDaHs3X8+fe3bIkRU0cbrw ($40.90 in chips)
Seat 4: YBN054X4blmis+B2bBlC0g ($21.90 in chips)
Seat 5: GIJAc9kPrLZHLSX8Q6i99w ($25 in chips)
Seat 6: 8n9jQLh3cZKbsmr5PIjgiQ ($38.25 in chips)
Seat 7: HZkVla4kK2SI42CVrPZ/ig ($8.75 in chips)
Seat 8: xUrN9TWLq4m5V+OXY7KUUA ($50 in chips)
Seat 9: pFtzb1sR4b0d1aw6aIRgDg ($50.75 in chips)
HZkVla4kK2SI42CVrPZ/ig: posts small blind $0.25
xUrN9TWLq4m5V+OXY7KUUA: posts big blind $0.50
GIJAc9kPrLZHLSX8Q6i99w: posts big blind $0.50
*** HOLE CARDS ***
pFtzb1sR4b0d1aw6aIRgDg: folds
xZCXQSXlrZkp3pZizzVXCw: folds
90Wb75h3W1BRpbqVnuk8gw: folds
dDaHs3X8+fe3bIkRU0cbrw: folds
YBN054X4blmis+B2bBlC0g: folds
GIJAc9kPrLZHLSX8Q6i99w: checks
8n9jQLh3cZKbsmr5PIjgiQ: raises $1.50 to $2
HZkVla4kK2SI42CVrPZ/ig: raises $6.75 to $8.75 and is all-in
xUrN9TWLq4m5V+OXY7KUUA: folds
GIJAc9kPrLZHLSX8Q6i99w: folds
8n9jQLh3cZKbsmr5PIjgiQ: folds
HZkVla4kK2SI42CVrPZ/ig collected $5 from pot
*** SUMMARY ***
Total pot $5 | Rake $0
Seat 1: xZCXQSXlrZkp3pZizzVXCw folded before Flop (didn't bet)
Seat 2: 90Wb75h3W1BRpbqVnuk8gw folded before Flop (didn't bet)
Seat 3: dDaHs3X8+fe3bIkRU0cbrw folded before Flop (didn't bet)
Seat 4: YBN054X4blmis+B2bBlC0g folded before Flop (didn't bet)
Seat 5: GIJAc9kPrLZHLSX8Q6i99w folded before Flop
Seat 6: 8n9jQLh3cZKbsmr5PIjgiQ (button) folded before Flop
Seat 7: HZkVla4kK2SI42CVrPZ/ig (small blind) collected ($5)
Seat 8: xUrN9TWLq4m5V+OXY7KUUA (big blind) folded before Flop
Seat 9: pFtzb1sR4b0d1aw6aIRgDg folded before Flop (didn't bet)



PokerStars Game #59939308612:  Hold'em No Limit ($0.25/$0.50) - 2009/07/01 0:36:33 ET
Table 'BCN5su+SsXiy1zRMJi0SJw' 6-max Seat #5 is the button
Seat 1: crjGpJEzSZgD38FoE3VMGg ($50 in chips)
Seat 2: oU2kDCkT/gilYbHWrg7D8w ($20.65 in chips)
Seat 4: JY9CtoZTeav+mhWyxSSyJQ ($14.40 in chips)
Seat 5: IBNygaT1aa9Z1uPdJJilwA ($67.25 in chips)
Seat 6: b2symlOdL7+0c9Pj4N/KlA ($50.25 in chips)
b2symlOdL7+0c9Pj4N/KlA: posts small blind $0.25
crjGpJEzSZgD38FoE3VMGg: posts big blind $0.50
g+vwI6lMKpU2uteXSjOzVw: sits out
*** HOLE CARDS ***
oU2kDCkT/gilYbHWrg7D8w: folds
JY9CtoZTeav+mhWyxSSyJQ: raises $0.50 to $1
IBNygaT1aa9Z1uPdJJilwA: folds
b2symlOdL7+0c9Pj4N/KlA: folds
crjGpJEzSZgD38FoE3VMGg: folds
JY9CtoZTeav+mhWyxSSyJQ collected $1.25 from pot
*** SUMMARY ***
Total pot $1.25 | Rake $0
Seat 1: crjGpJEzSZgD38FoE3VMGg (big blind) folded before Flop
Seat 2: oU2kDCkT/gilYbHWrg7D8w folded before Flop (didn't bet)
Seat 4: JY9CtoZTeav+mhWyxSSyJQ collected ($1.25)
Seat 5: IBNygaT1aa9Z1uPdJJilwA (button) folded before Flop (didn't bet)
Seat 6: b2symlOdL7+0c9Pj4N/KlA (small blind) folded before Flop



PokerStars Game #59939308876:  Hold'em No Limit ($0.25/$0.50) - 2009/07/01 0:36:33 ET
Table 'hWT2kq66tnKEpD26cia6fQ' 2-max Seat #1 is the button
Seat 1: q+vRKwm51mnr6kxX/161WQ ($50 in chips)
Seat 2: dkC7J+qbyqk0qCcmJbEPPw ($48.10 in chips)
q+vRKwm51mnr6kxX/161WQ: posts small blind $0.25
dkC7J+qbyqk0qCcmJbEPPw: posts big blind $0.50
*** HOLE CARDS ***
q+vRKwm51mnr6kxX/161WQ: raises $1 to $1.50
dkC7J+qbyqk0qCcmJbEPPw: raises $3.50 to $5
q+vRKwm51mnr6kxX/161WQ: folds
dkC7J+qbyqk0qCcmJbEPPw collected $3 from pot
*** SUMMARY ***
Total pot $3 | Rake $0
Seat 1: q+vRKwm51mnr6kxX/161WQ (button) (small blind) folded before Flop
Seat 2: dkC7J+qbyqk0qCcmJbEPPw (big blind) collected ($3)



PokerStars Game #59939309496:  Hold'em No Limit ($0.25/$0.50) - 2009/07/01 0:36:34 ET
Table 'tyR5AZNKV8Aadbrnrnlg7g' 6-max Seat #4 is the button
Seat 1: R+KjpH/wSjDLhtIy9+edNA ($84.40 in chips)
Seat 2: BAjwVL+zKKd0s0fAWstzQQ ($18.60 in chips)
Seat 3: tdOvWynovql5imfooroLMg ($48.45 in chips)
Seat 4: Rt6KgtZ8YaJoTc3FPim00w ($82.45 in chips)
Seat 6: ZKazl1hGaPiapDXincgi2Q ($18.15 in chips)
ZKazl1hGaPiapDXincgi2Q: posts small blind $0.25
R+KjpH/wSjDLhtIy9+edNA: posts big blind $0.50
*** HOLE CARDS ***
BAjwVL+zKKd0s0fAWstzQQ: calls $0.50
tdOvWynovql5imfooroLMg: calls $0.50
Rt6KgtZ8YaJoTc3FPim00w: folds
ZKazl1hGaPiapDXincgi2Q: calls $0.25
R+KjpH/wSjDLhtIy9+edNA: checks
*** FLOP *** [3s 9h Ad]
ZKazl1hGaPiapDXincgi2Q: checks
R+KjpH/wSjDLhtIy9+edNA: checks
BAjwVL+zKKd0s0fAWstzQQ: bets $1
tdOvWynovql5imfooroLMg: raises $3 to $4
ZKazl1hGaPiapDXincgi2Q: folds
R+KjpH/wSjDLhtIy9+edNA: folds
BAjwVL+zKKd0s0fAWstzQQ: calls $3
*** TURN *** [3s 9h Ad] [As]
BAjwVL+zKKd0s0fAWstzQQ: checks
tdOvWynovql5imfooroLMg: checks
*** RIVER *** [3s 9h Ad As] [9d]
BAjwVL+zKKd0s0fAWstzQQ: bets $3
tdOvWynovql5imfooroLMg: calls $3
*** SHOW DOWN ***
BAjwVL+zKKd0s0fAWstzQQ: shows [Ah Th] (a full house, Aces full of Nines)
tdOvWynovql5imfooroLMg: mucks hand
BAjwVL+zKKd0s0fAWstzQQ collected $15.25 from pot
*** SUMMARY ***
Total pot $16 | Rake $0.75
Board [3s 9h Ad As 9d]
Seat 1: R+KjpH/wSjDLhtIy9+edNA (big blind) folded on the Flop
Seat 2: BAjwVL+zKKd0s0fAWstzQQ showed [Ah Th] and won ($15.25) with a full house, Aces full of Nines
Seat 3: tdOvWynovql5imfooroLMg mucked
Seat 4: Rt6KgtZ8YaJoTc3FPim00w (button) folded before Flop (didn't bet)
Seat 6: ZKazl1hGaPiapDXincgi2Q (small blind) folded on the Flop



PokerStars Game #59939310028:  Hold'em No Limit ($0.25/$0.50) - 2009/07/01 0:36:35 ET
Table 'eMxdLyFDf28E0wit6gm3Uw' 6-max Seat #6 is the button
Seat 1: GtdWeBVCZhDBcNFRTOb8Hg ($7 in chips)
Seat 2: jwuKQ1S3U4NnzMQn3E3dgw ($74.40 in chips)
Seat 3: dZcLsEI8iXkobBduRJ45Yw ($17.10 in chips)
Seat 4: QM93o65lI8kLzmiB/BILlA ($12 in chips)
Seat 6: L0aIPg7qefDQjdJo3HCVEA ($8.80 in chips)
GtdWeBVCZhDBcNFRTOb8Hg: posts small blind $0.25
jwuKQ1S3U4NnzMQn3E3dgw: posts big blind $0.50
*** HOLE CARDS ***
dZcLsEI8iXkobBduRJ45Yw: calls $0.50
QM93o65lI8kLzmiB/BILlA: folds
QM93o65lI8kLzmiB/BILlA leaves the table
3jxEWvv2qK1HCXLj4khowQ joins the table at seat #4
L0aIPg7qefDQjdJo3HCVEA: calls $0.50
GtdWeBVCZhDBcNFRTOb8Hg: calls $0.25
jwuKQ1S3U4NnzMQn3E3dgw: checks
*** FLOP *** [2c 8d 3s]
GtdWeBVCZhDBcNFRTOb8Hg: checks
jwuKQ1S3U4NnzMQn3E3dgw: checks
dZcLsEI8iXkobBduRJ45Yw: checks
L0aIPg7qefDQjdJo3HCVEA: bets $1
GtdWeBVCZhDBcNFRTOb8Hg: folds
jwuKQ1S3U4NnzMQn3E3dgw: folds
dZcLsEI8iXkobBduRJ45Yw: raises $1.50 to $2.50
L0aIPg7qefDQjdJo3HCVEA: raises $1.50 to $4
dZcLsEI8iXkobBduRJ45Yw: raises $12.60 to $16.60 and is all-in
L0aIPg7qefDQjdJo3HCVEA: calls $4.30 and is all-in
*** TURN *** [2c 8d 3s] [6s]
*** RIVER *** [2c 8d 3s 6s] [Ts]
*** SHOW DOWN ***
dZcLsEI8iXkobBduRJ45Yw: shows [Jd Jh] (a pair of Jacks)
L0aIPg7qefDQjdJo3HCVEA: shows [2s 2d] (three of a kind, Deuces)
L0aIPg7qefDQjdJo3HCVEA collected $17.70 from pot
*** SUMMARY ***
Total pot $18.60 | Rake $0.90
Board [2c 8d 3s 6s Ts]
Seat 1: GtdWeBVCZhDBcNFRTOb8Hg (small blind) folded on the Flop
Seat 2: jwuKQ1S3U4NnzMQn3E3dgw (big blind) folded on the Flop
Seat 3: dZcLsEI8iXkobBduRJ45Yw showed [Jd Jh] and lost with a pair of Jacks
Seat 4: QM93o65lI8kLzmiB/BILlA folded before Flop (didn't bet)
Seat 6: L0aIPg7qefDQjdJo3HCVEA (button) showed [2s 2d] and won ($17.70) with three of a kind, Deuces



PokerStars Game #59939309920:  Hold'em No Limit ($0.25/$0.50) - 2009/07/01 0:36:35 ET
Table 'kgbJRsxfv64KrErDRBAkcw' 6-max Seat #3 is the button
Seat 2: Q+thC23WCv1kJUJtH/+4Jw ($52.80 in chips)
Seat 3: T0Gx/FcQ5VH9u7XaOMX97A ($108.60 in chips)
Seat 4: qanMEqjABjWxC/JgQ/0l7w ($55.70 in chips)
Seat 5: +Pf9jTVizYlIo+woPvptfA ($51.55 in chips)
qanMEqjABjWxC/JgQ/0l7w: posts small blind $0.25
+Pf9jTVizYlIo+woPvptfA: posts big blind $0.50
*** HOLE CARDS ***
Q+thC23WCv1kJUJtH/+4Jw: raises $1.50 to $2
T0Gx/FcQ5VH9u7XaOMX97A: folds
qanMEqjABjWxC/JgQ/0l7w: folds
+Pf9jTVizYlIo+woPvptfA: folds
Q+thC23WCv1kJUJtH/+4Jw collected $1.25 from pot
*** SUMMARY ***
Total pot $1.25 | Rake $0
Seat 2: Q+thC23WCv1kJUJtH/+4Jw collected ($1.25)
Seat 3: T0Gx/FcQ5VH9u7XaOMX97A (button) folded before Flop (didn't bet)
Seat 4: qanMEqjABjWxC/JgQ/0l7w (small blind) folded before Flop
Seat 5: +Pf9jTVizYlIo+woPvptfA (big blind) folded before Flop



PokerStars Game #59939310436:  Hold'em No Limit ($0.25/$0.50) - 2009/07/01 0:36:36 ET
Table '+111aLuBwnz8YVYSA7J1jA' 2-max Seat #1 is the button
Seat 1: ndd1nfncBkWNitBnsfCoVQ ($92.50 in chips)
Seat 2: +ciXH35zeafrjg1W6wiBTg ($56.35 in chips)
ndd1nfncBkWNitBnsfCoVQ: posts small blind $0.25
+ciXH35zeafrjg1W6wiBTg: posts big blind $0.50
*** HOLE CARDS ***
ndd1nfncBkWNitBnsfCoVQ: raises $1 to $1.50
+ciXH35zeafrjg1W6wiBTg: calls $1
*** FLOP *** [Td 3h 7h]
+ciXH35zeafrjg1W6wiBTg: checks
ndd1nfncBkWNitBnsfCoVQ: checks
*** TURN *** [Td 3h 7h] [Qc]
+ciXH35zeafrjg1W6wiBTg: checks
ndd1nfncBkWNitBnsfCoVQ: checks
*** RIVER *** [Td 3h 7h Qc] [2h]
+ciXH35zeafrjg1W6wiBTg: checks
ndd1nfncBkWNitBnsfCoVQ: checks
*** SHOW DOWN ***
+ciXH35zeafrjg1W6wiBTg: shows [Ah 9d] (high card Ace)
ndd1nfncBkWNitBnsfCoVQ: shows [8d 3s] (a pair of Threes)
ndd1nfncBkWNitBnsfCoVQ collected $2.85 from pot
*** SUMMARY ***
Total pot $3 | Rake $0.15
Board [Td 3h 7h Qc 2h]
Seat 1: ndd1nfncBkWNitBnsfCoVQ (button) (small blind) showed [8d 3s] and won ($2.85) with a pair of Threes
Seat 2: +ciXH35zeafrjg1W6wiBTg (big blind) showed [Ah 9d] and lost with high card Ace



PokerStars Game #59939311534:  Hold'em No Limit ($0.25/$0.50) - 2009/07/01 0:36:37 ET
Table 'mTxf8gPLgffN3Iwfm7Icfg' 2-max Seat #1 is the button
Seat 1: Do9Rlu1R5u/AcRtMTl8SYg ($64.20 in chips)
Seat 2: EMc5LPgVaded4Qc77vm0fw ($93.55 in chips)
Do9Rlu1R5u/AcRtMTl8SYg: posts small blind $0.25
EMc5LPgVaded4Qc77vm0fw: posts big blind $0.50
*** HOLE CARDS ***
Do9Rlu1R5u/AcRtMTl8SYg: folds
EMc5LPgVaded4Qc77vm0fw collected $0.50 from pot
EMc5LPgVaded4Qc77vm0fw: doesn't show hand
*** SUMMARY ***
Total pot $0.50 | Rake $0
Seat 1: Do9Rlu1R5u/AcRtMTl8SYg (button) (small blind) folded before Flop
Seat 2: EMc5LPgVaded4Qc77vm0fw (big blind) collected ($0.50)



PokerStars Game #59939311280:  Hold'em No Limit ($0.25/$0.50) - 2009/07/01 0:36:37 ET
Table 'IeNZOZQ4T6oiaHqFeo6yIA' 2-max Seat #1 is the button
Seat 1: ndd1nfncBkWNitBnsfCoVQ ($52.95 in chips)
Seat 2: A91IUl5JaZROhtfCtnnwYw ($75.20 in chips)
ndd1nfncBkWNitBnsfCoVQ: posts small blind $0.25
A91IUl5JaZROhtfCtnnwYw: posts big blind $0.50
*** HOLE CARDS ***
ndd1nfncBkWNitBnsfCoVQ: raises $1 to $1.50
A91IUl5JaZROhtfCtnnwYw: raises $1 to $2.50
ndd1nfncBkWNitBnsfCoVQ: calls $1
*** FLOP *** [2h 8d 3d]
A91IUl5JaZROhtfCtnnwYw: bets $0.50
ndd1nfncBkWNitBnsfCoVQ: calls $0.50
*** TURN *** [2h 8d 3d] [Js]
A91IUl5JaZROhtfCtnnwYw: bets $0.50
ndd1nfncBkWNitBnsfCoVQ: calls $0.50
*** RIVER *** [2h 8d 3d Js] [5h]
A91IUl5JaZROhtfCtnnwYw: checks
ndd1nfncBkWNitBnsfCoVQ: bets $5
A91IUl5JaZROhtfCtnnwYw: folds
ndd1nfncBkWNitBnsfCoVQ collected $6.70 from pot
ndd1nfncBkWNitBnsfCoVQ: doesn't show hand
*** SUMMARY ***
Total pot $7 | Rake $0.30
Board [2h 8d 3d Js 5h]
Seat 1: ndd1nfncBkWNitBnsfCoVQ (button) (small blind) collected ($6.70)
Seat 2: A91IUl5JaZROhtfCtnnwYw (big blind) folded on the River



PokerStars Game #59939310958:  Hold'em No Limit ($0.25/$0.50) - 2009/07/01 0:36:37 ET
Table '3FhG0gl3kMX3wBEEqj+wnQ' 9-max Seat #3 is the button
Seat 1: e0J9pdCNUDTCG031RnXqLA ($17.75 in chips)
Seat 2: 7cYQ+syUWjl38ty/ICOMhw ($50.40 in chips)
Seat 3: HZkVla4kK2SI42CVrPZ/ig ($15.20 in chips)
Seat 4: bjvJtA9Hqscfznq66txaOQ ($9.50 in chips)
Seat 5: gsyXT42WLEcOS4DdEk2wlw ($30 in chips)
Seat 6: 5JJVDlaiMnB004o/RqbZZQ ($43.30 in chips)
Seat 7: mSD1pginDsyHG5PDfqzphw ($10 in chips)
Seat 8: j3K/Jujr7PY4ZM2RZvlH6A ($57.30 in chips)
Seat 9: L5e2lrPLQm1Pqx30IIZ/Fw ($10.10 in chips)
bjvJtA9Hqscfznq66txaOQ: posts small blind $0.25
gsyXT42WLEcOS4DdEk2wlw: posts big blind $0.50
*** HOLE CARDS ***
5JJVDlaiMnB004o/RqbZZQ: folds
mSD1pginDsyHG5PDfqzphw: folds
j3K/Jujr7PY4ZM2RZvlH6A: folds
L5e2lrPLQm1Pqx30IIZ/Fw: folds
e0J9pdCNUDTCG031RnXqLA: folds
7cYQ+syUWjl38ty/ICOMhw: folds
HZkVla4kK2SI42CVrPZ/ig: raises $1 to $1.50
bjvJtA9Hqscfznq66txaOQ: folds
gsyXT42WLEcOS4DdEk2wlw: folds
HZkVla4kK2SI42CVrPZ/ig collected $1.25 from pot
HZkVla4kK2SI42CVrPZ/ig: doesn't show hand
*** SUMMARY ***
Total pot $1.25 | Rake $0
Seat 1: e0J9pdCNUDTCG031RnXqLA folded before Flop (didn't bet)
Seat 2: 7cYQ+syUWjl38ty/ICOMhw folded before Flop (didn't bet)
Seat 3: HZkVla4kK2SI42CVrPZ/ig (button) collected ($1.25)
Seat 4: bjvJtA9Hqscfznq66txaOQ (small blind) folded before Flop
Seat 5: gsyXT42WLEcOS4DdEk2wlw (big blind) folded before Flop
Seat 6: 5JJVDlaiMnB004o/RqbZZQ folded before Flop (didn't bet)
Seat 7: mSD1pginDsyHG5PDfqzphw folded before Flop (didn't bet)
Seat 8: j3K/Jujr7PY4ZM2RZvlH6A folded before Flop (didn't bet)
Seat 9: L5e2lrPLQm1Pqx30IIZ/Fw folded before Flop (didn't bet)



PokerStars Game #59939311838:  Hold'em No Limit ($0.25/$0.50) - 2009/07/01 0:36:38 ET
Table 'E7bWJ45aoFXRpyRv2gw+Ig' 2-max Seat #2 is the button
Seat 1: FRkiRasEGlHUeLrEl+k/nA ($55.10 in chips)
Seat 2: 3Wro85I7472vJ4Wkpneo9A ($140.10 in chips)
3Wro85I7472vJ4Wkpneo9A: posts small blind $0.25
FRkiRasEGlHUeLrEl+k/nA: posts big blind $0.50
*** HOLE CARDS ***
3Wro85I7472vJ4Wkpneo9A: calls $0.25
FRkiRasEGlHUeLrEl+k/nA: raises $1 to $1.50
3Wro85I7472vJ4Wkpneo9A: calls $1
*** FLOP *** [4d Js 5s]
FRkiRasEGlHUeLrEl+k/nA: bets $1
3Wro85I7472vJ4Wkpneo9A: raises $2 to $3
FRkiRasEGlHUeLrEl+k/nA: calls $2
*** TURN *** [4d Js 5s] [3c]
FRkiRasEGlHUeLrEl+k/nA: checks
3Wro85I7472vJ4Wkpneo9A: checks
*** RIVER *** [4d Js 5s 3c] [6d]
FRkiRasEGlHUeLrEl+k/nA: checks
3Wro85I7472vJ4Wkpneo9A: checks
*** SHOW DOWN ***
FRkiRasEGlHUeLrEl+k/nA: shows [Ac 3h] (a pair of Threes)
3Wro85I7472vJ4Wkpneo9A: shows [6c Kh] (a pair of Sixes)
3Wro85I7472vJ4Wkpneo9A collected $8.60 from pot
*** SUMMARY ***
Total pot $9 | Rake $0.40
Board [4d Js 5s 3c 6d]
Seat 1: FRkiRasEGlHUeLrEl+k/nA (big blind) showed [Ac 3h] and lost with a pair of Threes
Seat 2: 3Wro85I7472vJ4Wkpneo9A (button) (small blind) showed [6c Kh] and won ($8.60) with a pair of Sixes



PokerStars Game #59939312654:  Hold'em No Limit ($0.25/$0.50) - 2009/07/01 0:36:39 ET
Table 'c/CRn+68J3Y8KxD5g1ek2Q' 2-max Seat #2 is the button
Seat 1: 46qCyJ6evTkHo9al5sBMNA ($234.15 in chips)
Seat 2: BypVLsYQt3ePFm2xQL/dOA ($142.40 in chips)
BypVLsYQt3ePFm2xQL/dOA: posts small blind $0.25
46qCyJ6evTkHo9al5sBMNA: posts big blind $0.50
*** HOLE CARDS ***
BypVLsYQt3ePFm2xQL/dOA: calls $0.25
46qCyJ6evTkHo9al5sBMNA: checks
*** FLOP *** [Jd Th 6c]
46qCyJ6evTkHo9al5sBMNA: checks
BypVLsYQt3ePFm2xQL/dOA: bets $1
46qCyJ6evTkHo9al5sBMNA: folds
BypVLsYQt3ePFm2xQL/dOA collected $0.95 from pot
BypVLsYQt3ePFm2xQL/dOA: doesn't show hand
*** SUMMARY ***
Total pot $1 | Rake $0.05
Board [Jd Th 6c]
Seat 1: 46qCyJ6evTkHo9al5sBMNA (big blind) folded on the Flop
Seat 2: BypVLsYQt3ePFm2xQL/dOA (button) (small blind) collected ($0.95)



PokerStars Game #59939315342:  Hold'em No Limit ($0.25/$0.50) - 2009/07/01 0:36:43 ET
Table 'mTxf8gPLgffN3Iwfm7Icfg' 2-max Seat #2 is the button
Seat 1: Do9Rlu1R5u/AcRtMTl8SYg ($63.95 in chips)
Seat 2: EMc5LPgVaded4Qc77vm0fw ($93.80 in chips)
EMc5LPgVaded4Qc77vm0fw: posts small blind $0.25
Do9Rlu1R5u/AcRtMTl8SYg: posts big blind $0.50
*** HOLE CARDS ***
EMc5LPgVaded4Qc77vm0fw: folds
Do9Rlu1R5u/AcRtMTl8SYg collected $0.50 from pot
Do9Rlu1R5u/AcRtMTl8SYg: doesn't show hand
*** SUMMARY ***
Total pot $0.50 | Rake $0
Seat 1: Do9Rlu1R5u/AcRtMTl8SYg (big blind) collected ($0.50)
Seat 2: EMc5LPgVaded4Qc77vm0fw (button) (small blind) folded before Flop



PokerStars Game #59939315104:  Hold'em No Limit ($0.25/$0.50) - 2009/07/01 0:36:43 ET
Table 'otvGDROEDdqsabxskT79qg' 9-max Seat #3 is the button
Seat 1: 8ehL7qlZzjgUh2H35iiWLw ($56 in chips)
Seat 2: cCjTzH9jio8607WzjcfXlg ($8.50 in chips)
Seat 3: +k7T5ocke8UwavtgUHm+Cg ($75.35 in chips)
Seat 4: MG90wfSJZnOejs/KD3vlQQ ($55.65 in chips)
Seat 5: XNMDwbXt/Q4jM99AXnbJDw ($55.55 in chips)
Seat 6: bxLSulbgr8LmKNjOzw8URg ($51.80 in chips)
Seat 7: C7+tBppJrKgd/r+tuKUIpA ($34.15 in chips)
Seat 8: zE9cVigS2nW/Ljy4K4bUQA ($30 in chips)
Seat 9: KcY3X8YpD74Kw1RHkx/g4A ($66 in chips)
MG90wfSJZnOejs/KD3vlQQ: posts small blind $0.25
XNMDwbXt/Q4jM99AXnbJDw: posts big blind $0.50
*** HOLE CARDS ***
bxLSulbgr8LmKNjOzw8URg: folds
C7+tBppJrKgd/r+tuKUIpA: calls $0.50
zE9cVigS2nW/Ljy4K4bUQA: folds
KcY3X8YpD74Kw1RHkx/g4A: folds
8ehL7qlZzjgUh2H35iiWLw: folds
cCjTzH9jio8607WzjcfXlg: calls $0.50
+k7T5ocke8UwavtgUHm+Cg: folds
MG90wfSJZnOejs/KD3vlQQ: folds
XNMDwbXt/Q4jM99AXnbJDw: checks
*** FLOP *** [5s 9h 3c]
XNMDwbXt/Q4jM99AXnbJDw: checks
C7+tBppJrKgd/r+tuKUIpA: checks
cCjTzH9jio8607WzjcfXlg: checks
*** TURN *** [5s 9h 3c] [3h]
XNMDwbXt/Q4jM99AXnbJDw: checks
C7+tBppJrKgd/r+tuKUIpA: checks
cCjTzH9jio8607WzjcfXlg: checks
*** RIVER *** [5s 9h 3c 3h] [Js]
XNMDwbXt/Q4jM99AXnbJDw: checks
C7+tBppJrKgd/r+tuKUIpA: checks
cCjTzH9jio8607WzjcfXlg: checks
*** SHOW DOWN ***
XNMDwbXt/Q4jM99AXnbJDw: shows [4c 2s] (a pair of Threes)
C7+tBppJrKgd/r+tuKUIpA: shows [5d Ac] (two pair, Fives and Threes)
cCjTzH9jio8607WzjcfXlg: mucks hand
C7+tBppJrKgd/r+tuKUIpA collected $1.70 from pot
*** SUMMARY ***
Total pot $1.75 | Rake $0.05
Board [5s 9h 3c 3h Js]
Seat 1: 8ehL7qlZzjgUh2H35iiWLw folded before Flop (didn't bet)
Seat 2: cCjTzH9jio8607WzjcfXlg mucked
Seat 3: +k7T5ocke8UwavtgUHm+Cg (button) folded before Flop (didn't bet)
Seat 4: MG90wfSJZnOejs/KD3vlQQ (small blind) folded before Flop
Seat 5: XNMDwbXt/Q4jM99AXnbJDw (big blind) showed [4c 2s] and lost with a pair of Threes
Seat 6: bxLSulbgr8LmKNjOzw8URg folded before Flop (didn't bet)
Seat 7: C7+tBppJrKgd/r+tuKUIpA showed [5d Ac] and won ($1.70) with two pair, Fives and Threes
Seat 8: zE9cVigS2nW/Ljy4K4bUQA folded before Flop (didn't bet)
Seat 9: KcY3X8YpD74Kw1RHkx/g4A folded before Flop (didn't bet)



PokerStars Game #59939315926:  Hold'em No Limit ($0.25/$0.50) - 2009/07/01 0:36:44 ET
Table 'QOgaEqMcJ73pcUMMxoisUg' 6-max Seat #5 is the button
Seat 1: OZ6OtYh5Y53MCH/p0QTn5g ($54.20 in chips)
Seat 3: Rt6KgtZ8YaJoTc3FPim00w ($50 in chips)
Seat 4: zAcsDhG/T128Vn7XGVSgKg ($58.15 in chips)
Seat 5: 6vNxrjjCl6FwfaaymM9jjg ($29.05 in chips)
Seat 6: pmE+2KJb4nffAVqjLIXxFg ($21 in chips)
pmE+2KJb4nffAVqjLIXxFg: posts small blind $0.25
OZ6OtYh5Y53MCH/p0QTn5g: posts big blind $0.50
4QfsCWthT/vSLirorNXqtg: sits out
*** HOLE CARDS ***
Rt6KgtZ8YaJoTc3FPim00w: folds
zAcsDhG/T128Vn7XGVSgKg: folds
6vNxrjjCl6FwfaaymM9jjg: calls $0.50
pmE+2KJb4nffAVqjLIXxFg: folds
OZ6OtYh5Y53MCH/p0QTn5g: checks
*** FLOP *** [Kh 2d 8c]
OZ6OtYh5Y53MCH/p0QTn5g: checks
6vNxrjjCl6FwfaaymM9jjg: bets $1
OZ6OtYh5Y53MCH/p0QTn5g: folds
6vNxrjjCl6FwfaaymM9jjg collected $1.20 from pot
*** SUMMARY ***
Total pot $1.25 | Rake $0.05
Board [Kh 2d 8c]
Seat 1: OZ6OtYh5Y53MCH/p0QTn5g (big blind) folded on the Flop
Seat 3: Rt6KgtZ8YaJoTc3FPim00w folded before Flop (didn't bet)
Seat 4: zAcsDhG/T128Vn7XGVSgKg folded before Flop (didn't bet)
Seat 5: 6vNxrjjCl6FwfaaymM9jjg (button) collected ($1.20)
Seat 6: pmE+2KJb4nffAVqjLIXxFg (small blind) folded before Flop



PokerStars Game #59939315742:  Hold'em No Limit ($0.25/$0.50) - 2009/07/01 0:36:44 ET
Table 'hWT2kq66tnKEpD26cia6fQ' 2-max Seat #2 is the button
Seat 1: q+vRKwm51mnr6kxX/161WQ ($48.50 in chips)
Seat 2: dkC7J+qbyqk0qCcmJbEPPw ($49.60 in chips)
dkC7J+qbyqk0qCcmJbEPPw: posts small blind $0.25
q+vRKwm51mnr6kxX/161WQ: posts big blind $0.50
*** HOLE CARDS ***
dkC7J+qbyqk0qCcmJbEPPw: folds
q+vRKwm51mnr6kxX/161WQ collected $0.50 from pot
q+vRKwm51mnr6kxX/161WQ: doesn't show hand
*** SUMMARY ***
Total pot $0.50 | Rake $0
Seat 1: q+vRKwm51mnr6kxX/161WQ (big blind) collected ($0.50)
Seat 2: dkC7J+qbyqk0qCcmJbEPPw (button) (small blind) folded before Flop



PokerStars Game #59939315454:  Hold'em No Limit ($0.25/$0.50) - 2009/07/01 0:36:44 ET
Table '+dXkOAQyS8j9PQZusUTMpg' 2-max Seat #1 is the button
Seat 1: XFa6sBGjP2gxoIvxR3fZIg ($49.50 in chips)
Seat 2: 5IBeOgaApY1Bvzv2P8X4EA ($142.05 in chips)
XFa6sBGjP2gxoIvxR3fZIg: posts small blind $0.25
5IBeOgaApY1Bvzv2P8X4EA: posts big blind $0.50
*** HOLE CARDS ***
XFa6sBGjP2gxoIvxR3fZIg: raises $1 to $1.50
5IBeOgaApY1Bvzv2P8X4EA: folds
XFa6sBGjP2gxoIvxR3fZIg collected $1 from pot
5IBeOgaApY1Bvzv2P8X4EA said, "hard to fold"
*** SUMMARY ***
Total pot $1 | Rake $0
Seat 1: XFa6sBGjP2gxoIvxR3fZIg (button) (small blind) collected ($1)
Seat 2: 5IBeOgaApY1Bvzv2P8X4EA (big blind) folded before Flop



PokerStars Game #59939316970:  Hold'em No Limit ($0.25/$0.50) - 2009/07/01 0:36:46 ET
Table '5EmHi+fnatGQQShcNmzOZQ' 6-max Seat #6 is the button
Seat 2: vXIHnZ+dv/hwSBxyvGw7bQ ($77.50 in chips)
Seat 3: L9qfLYXrczhAPd/VckgsWw ($91.25 in chips)
Seat 5: kxPhs4ePFqMy52CInAJ2aw ($53.10 in chips)
Seat 6: 686aeHikcJlgKkSuIFdcXQ ($138.65 in chips)
vXIHnZ+dv/hwSBxyvGw7bQ: posts small blind $0.25
L9qfLYXrczhAPd/VckgsWw: posts big blind $0.50
1b+2BbjMN8qhR1WPqdE9VQ: sits out
*** HOLE CARDS ***
kxPhs4ePFqMy52CInAJ2aw: raises $1.50 to $2
686aeHikcJlgKkSuIFdcXQ: folds
vXIHnZ+dv/hwSBxyvGw7bQ: folds
L9qfLYXrczhAPd/VckgsWw: folds
kxPhs4ePFqMy52CInAJ2aw collected $1.25 from pot
kxPhs4ePFqMy52CInAJ2aw: doesn't show hand
*** SUMMARY ***
Total pot $1.25 | Rake $0
Seat 2: vXIHnZ+dv/hwSBxyvGw7bQ (small blind) folded before Flop
Seat 3: L9qfLYXrczhAPd/VckgsWw (big blind) folded before Flop
Seat 5: kxPhs4ePFqMy52CInAJ2aw collected ($1.25)
Seat 6: 686aeHikcJlgKkSuIFdcXQ (button) folded before Flop (didn't bet)



PokerStars Game #59939318462:  Hold'em No Limit ($0.25/$0.50) - 2009/07/01 0:36:48 ET
Table 'kgbJRsxfv64KrErDRBAkcw' 6-max Seat #4 is the button
Seat 2: Q+thC23WCv1kJUJtH/+4Jw ($53.55 in chips)
Seat 3: T0Gx/FcQ5VH9u7XaOMX97A ($108.60 in chips)
Seat 4: qanMEqjABjWxC/JgQ/0l7w ($55.45 in chips)
Seat 5: +Pf9jTVizYlIo+woPvptfA ($51.05 in chips)
+Pf9jTVizYlIo+woPvptfA: posts small blind $0.25
Q+thC23WCv1kJUJtH/+4Jw: posts big blind $0.50
*** HOLE CARDS ***
T0Gx/FcQ5VH9u7XaOMX97A: folds
qanMEqjABjWxC/JgQ/0l7w: folds
+Pf9jTVizYlIo+woPvptfA: folds
Q+thC23WCv1kJUJtH/+4Jw collected $0.50 from pot
*** SUMMARY ***
Total pot $0.50 | Rake $0
Seat 2: Q+thC23WCv1kJUJtH/+4Jw (big blind) collected ($0.50)
Seat 3: T0Gx/FcQ5VH9u7XaOMX97A folded before Flop (didn't bet)
Seat 4: qanMEqjABjWxC/JgQ/0l7w (button) folded before Flop (didn't bet)
Seat 5: +Pf9jTVizYlIo+woPvptfA (small blind) folded before Flop



PokerStars Game #59939319096:  Hold'em No Limit ($0.25/$0.50) - 2009/07/01 0:36:49 ET
Table 'hWT2kq66tnKEpD26cia6fQ' 2-max Seat #1 is the button
Seat 1: q+vRKwm51mnr6kxX/161WQ ($48.75 in chips)
Seat 2: dkC7J+qbyqk0qCcmJbEPPw ($49.35 in chips)
q+vRKwm51mnr6kxX/161WQ: posts small blind $0.25
dkC7J+qbyqk0qCcmJbEPPw: posts big blind $0.50
*** HOLE CARDS ***
q+vRKwm51mnr6kxX/161WQ: raises $1 to $1.50
dkC7J+qbyqk0qCcmJbEPPw: calls $1
*** FLOP *** [9h Ts 7d]
dkC7J+qbyqk0qCcmJbEPPw: checks
q+vRKwm51mnr6kxX/161WQ: bets $2
dkC7J+qbyqk0qCcmJbEPPw: calls $2
*** TURN *** [9h Ts 7d] [2c]
dkC7J+qbyqk0qCcmJbEPPw: checks
q+vRKwm51mnr6kxX/161WQ: bets $4
dkC7J+qbyqk0qCcmJbEPPw: calls $4
*** RIVER *** [9h Ts 7d 2c] [Qs]
dkC7J+qbyqk0qCcmJbEPPw: checks
q+vRKwm51mnr6kxX/161WQ: bets $8.50
dkC7J+qbyqk0qCcmJbEPPw: calls $8.50
*** SHOW DOWN ***
q+vRKwm51mnr6kxX/161WQ: shows [3s 5s] (high card Queen)
dkC7J+qbyqk0qCcmJbEPPw: shows [9s Kh] (a pair of Nines)
dkC7J+qbyqk0qCcmJbEPPw collected $31.50 from pot
*** SUMMARY ***
Total pot $32 | Rake $0.50
Board [9h Ts 7d 2c Qs]
Seat 1: q+vRKwm51mnr6kxX/161WQ (button) (small blind) showed [3s 5s] and lost with high card Queen
Seat 2: dkC7J+qbyqk0qCcmJbEPPw (big blind) showed [9s Kh] and won ($31.50) with a pair of Nines



PokerStars Game #59939319352:  Hold'em No Limit ($0.25/$0.50) - 2009/07/01 0:36:50 ET
Table 'mTxf8gPLgffN3Iwfm7Icfg' 2-max Seat #1 is the button
Seat 1: Do9Rlu1R5u/AcRtMTl8SYg ($64.20 in chips)
Seat 2: EMc5LPgVaded4Qc77vm0fw ($93.55 in chips)
Do9Rlu1R5u/AcRtMTl8SYg: posts small blind $0.25
EMc5LPgVaded4Qc77vm0fw: posts big blind $0.50
*** HOLE CARDS ***
Do9Rlu1R5u/AcRtMTl8SYg: raises $1 to $1.50
EMc5LPgVaded4Qc77vm0fw: calls $1
*** FLOP *** [9h Ah 2c]
EMc5LPgVaded4Qc77vm0fw: checks
Do9Rlu1R5u/AcRtMTl8SYg: bets $2
EMc5LPgVaded4Qc77vm0fw: raises $4 to $6
Do9Rlu1R5u/AcRtMTl8SYg: folds
EMc5LPgVaded4Qc77vm0fw collected $6.70 from pot
EMc5LPgVaded4Qc77vm0fw: doesn't show hand
*** SUMMARY ***
Total pot $7 | Rake $0.30
Board [9h Ah 2c]
Seat 1: Do9Rlu1R5u/AcRtMTl8SYg (button) (small blind) folded on the Flop
Seat 2: EMc5LPgVaded4Qc77vm0fw (big blind) collected ($6.70)



PokerStars Game #59939320632:  Hold'em No Limit ($0.25/$0.50) - 2009/07/01 0:36:52 ET
Table '+dXkOAQyS8j9PQZusUTMpg' 2-max Seat #2 is the button
Seat 1: XFa6sBGjP2gxoIvxR3fZIg ($50 in chips)
Seat 2: 5IBeOgaApY1Bvzv2P8X4EA ($141.55 in chips)
5IBeOgaApY1Bvzv2P8X4EA: posts small blind $0.25
XFa6sBGjP2gxoIvxR3fZIg: posts big blind $0.50
*** HOLE CARDS ***
5IBeOgaApY1Bvzv2P8X4EA: folds
XFa6sBGjP2gxoIvxR3fZIg collected $0.50 from pot
*** SUMMARY ***
Total pot $0.50 | Rake $0
Seat 1: XFa6sBGjP2gxoIvxR3fZIg (big blind) collected ($0.50)
Seat 2: 5IBeOgaApY1Bvzv2P8X4EA (button) (small blind) folded before Flop



PokerStars Game #59939321388:  Hold'em No Limit ($0.25/$0.50) - 2009/07/01 0:36:53 ET
Table 'EiNh8p/wGJ1FP575iMFnqg' 9-max Seat #3 is the button
Seat 1: r3ZqM1Mi0W3y4hOdssE+Sg ($50.15 in chips)
Seat 2: 8ehL7qlZzjgUh2H35iiWLw ($50 in chips)
Seat 3: ymLPoEIl7UL3TvZYmnadxQ ($49.85 in chips)
Seat 5: M+7+BTmX5vZatHVuoRB1nA ($84.85 in chips)
Seat 6: 3UmXLy3GfjC3EkOebduerQ ($54.65 in chips)
Seat 7: Wj7mKnRFR90j40wWUu2+Og ($71.05 in chips)
Seat 8: KrPAGRACBg+w0M//SXe8Ag ($11.40 in chips)
Seat 9: OMwFJ4pF0xk2Ru/AJiFeFw ($101 in chips)
Lacher64 will be allowed to play after the button
M+7+BTmX5vZatHVuoRB1nA: posts small blind $0.25
3UmXLy3GfjC3EkOebduerQ: posts big blind $0.50
*** HOLE CARDS ***
Wj7mKnRFR90j40wWUu2+Og: folds
KrPAGRACBg+w0M//SXe8Ag: calls $0.50
OMwFJ4pF0xk2Ru/AJiFeFw: folds
r3ZqM1Mi0W3y4hOdssE+Sg: folds
Wj7mKnRFR90j40wWUu2+Og is sitting out
Wj7mKnRFR90j40wWUu2+Og leaves the table
8ehL7qlZzjgUh2H35iiWLw: raises $2 to $2.50
997ViqAtWn1FPjJqcffwcA joins the table at seat #7
ymLPoEIl7UL3TvZYmnadxQ: folds
M+7+BTmX5vZatHVuoRB1nA: folds
3UmXLy3GfjC3EkOebduerQ: folds
KrPAGRACBg+w0M//SXe8Ag: folds
8ehL7qlZzjgUh2H35iiWLw collected $1.75 from pot
8ehL7qlZzjgUh2H35iiWLw: doesn't show hand
*** SUMMARY ***
Total pot $1.75 | Rake $0
Seat 1: r3ZqM1Mi0W3y4hOdssE+Sg folded before Flop (didn't bet)
Seat 2: 8ehL7qlZzjgUh2H35iiWLw collected ($1.75)
Seat 3: ymLPoEIl7UL3TvZYmnadxQ (button) folded before Flop (didn't bet)
Seat 5: M+7+BTmX5vZatHVuoRB1nA (small blind) folded before Flop
Seat 6: 3UmXLy3GfjC3EkOebduerQ (big blind) folded before Flop
Seat 7: Wj7mKnRFR90j40wWUu2+Og folded before Flop (didn't bet)
Seat 8: KrPAGRACBg+w0M//SXe8Ag folded before Flop
Seat 9: OMwFJ4pF0xk2Ru/AJiFeFw folded before Flop (didn't bet)



PokerStars Game #59939322346:  Hold'em No Limit ($0.25/$0.50) - 2009/07/01 0:36:54 ET
Table 'BCN5su+SsXiy1zRMJi0SJw' 6-max Seat #6 is the button
Seat 1: crjGpJEzSZgD38FoE3VMGg ($50 in chips)
Seat 2: oU2kDCkT/gilYbHWrg7D8w ($20.65 in chips)
Seat 4: JY9CtoZTeav+mhWyxSSyJQ ($15.15 in chips)
Seat 5: IBNygaT1aa9Z1uPdJJilwA ($67.25 in chips)
Seat 6: b2symlOdL7+0c9Pj4N/KlA ($50 in chips)
crjGpJEzSZgD38FoE3VMGg: posts small blind $0.25
oU2kDCkT/gilYbHWrg7D8w: posts big blind $0.50
g+vwI6lMKpU2uteXSjOzVw: sits out
*** HOLE CARDS ***
JY9CtoZTeav+mhWyxSSyJQ: folds
IBNygaT1aa9Z1uPdJJilwA: raises $0.50 to $1
b2symlOdL7+0c9Pj4N/KlA: folds
crjGpJEzSZgD38FoE3VMGg: folds
oU2kDCkT/gilYbHWrg7D8w: calls $0.50
*** FLOP *** [9c 4d 5d]
oU2kDCkT/gilYbHWrg7D8w: checks
IBNygaT1aa9Z1uPdJJilwA: checks
*** TURN *** [9c 4d 5d] [8d]
oU2kDCkT/gilYbHWrg7D8w: bets $1.50
IBNygaT1aa9Z1uPdJJilwA: folds
oU2kDCkT/gilYbHWrg7D8w collected $2.15 from pot
oU2kDCkT/gilYbHWrg7D8w: doesn't show hand
*** SUMMARY ***
Total pot $2.25 | Rake $0.10
Board [9c 4d 5d 8d]
Seat 1: crjGpJEzSZgD38FoE3VMGg (small blind) folded before Flop
Seat 2: oU2kDCkT/gilYbHWrg7D8w (big blind) collected ($2.15)
Seat 4: JY9CtoZTeav+mhWyxSSyJQ folded before Flop (didn't bet)
Seat 5: IBNygaT1aa9Z1uPdJJilwA folded on the Turn
Seat 6: b2symlOdL7+0c9Pj4N/KlA (button) folded before Flop (didn't bet)



PokerStars Game #59939323754:  Hold'em No Limit ($0.25/$0.50) - 2009/07/01 0:36:56 ET
Table 'c/CRn+68J3Y8KxD5g1ek2Q' 2-max Seat #1 is the button
Seat 1: 46qCyJ6evTkHo9al5sBMNA ($233.65 in chips)
Seat 2: BypVLsYQt3ePFm2xQL/dOA ($142.85 in chips)
46qCyJ6evTkHo9al5sBMNA: posts small blind $0.25
BypVLsYQt3ePFm2xQL/dOA: posts big blind $0.50
*** HOLE CARDS ***
46qCyJ6evTkHo9al5sBMNA: raises $1.50 to $2
BypVLsYQt3ePFm2xQL/dOA: calls $1.50
*** FLOP *** [7h Kh 4c]
BypVLsYQt3ePFm2xQL/dOA: checks
46qCyJ6evTkHo9al5sBMNA: bets $2.50
BypVLsYQt3ePFm2xQL/dOA: folds
46qCyJ6evTkHo9al5sBMNA collected $3.80 from pot
46qCyJ6evTkHo9al5sBMNA: doesn't show hand
*** SUMMARY ***
Total pot $4 | Rake $0.20
Board [7h Kh 4c]
Seat 1: 46qCyJ6evTkHo9al5sBMNA (button) (small blind) collected ($3.80)
Seat 2: BypVLsYQt3ePFm2xQL/dOA (big blind) folded on the Flop



PokerStars Game #59939323588:  Hold'em No Limit ($0.25/$0.50) - 2009/07/01 0:36:56 ET
Table '+111aLuBwnz8YVYSA7J1jA' 2-max Seat #2 is the button
Seat 1: ndd1nfncBkWNitBnsfCoVQ ($93.85 in chips)
Seat 2: +ciXH35zeafrjg1W6wiBTg ($54.85 in chips)
+ciXH35zeafrjg1W6wiBTg: posts small blind $0.25
ndd1nfncBkWNitBnsfCoVQ: posts big blind $0.50
*** HOLE CARDS ***
+ciXH35zeafrjg1W6wiBTg: raises $1 to $1.50
ndd1nfncBkWNitBnsfCoVQ: raises $3.50 to $5
+ciXH35zeafrjg1W6wiBTg: calls $3.50
*** FLOP *** [Qs 4c 6d]
ndd1nfncBkWNitBnsfCoVQ: checks
+ciXH35zeafrjg1W6wiBTg: bets $6.50
ndd1nfncBkWNitBnsfCoVQ: folds
+ciXH35zeafrjg1W6wiBTg collected $9.50 from pot
+ciXH35zeafrjg1W6wiBTg: doesn't show hand
*** SUMMARY ***
Total pot $10 | Rake $0.50
Board [Qs 4c 6d]
Seat 1: ndd1nfncBkWNitBnsfCoVQ (big blind) folded on the Flop
Seat 2: +ciXH35zeafrjg1W6wiBTg (button) (small blind) collected ($9.50)



PokerStars Game #59939324532:  Hold'em No Limit ($0.25/$0.50) - 2009/07/01 0:36:58 ET
Table '+dXkOAQyS8j9PQZusUTMpg' 2-max Seat #1 is the button
Seat 1: XFa6sBGjP2gxoIvxR3fZIg ($50.25 in chips)
Seat 2: 5IBeOgaApY1Bvzv2P8X4EA ($141.30 in chips)
XFa6sBGjP2gxoIvxR3fZIg: posts small blind $0.25
5IBeOgaApY1Bvzv2P8X4EA: posts big blind $0.50
*** HOLE CARDS ***
XFa6sBGjP2gxoIvxR3fZIg said, "To a shove like that yes, canÃ¯Â¿Â½t put you on AA there"
XFa6sBGjP2gxoIvxR3fZIg: raises $1 to $1.50
5IBeOgaApY1Bvzv2P8X4EA: calls $1
*** FLOP *** [9h Jh Ts]
5IBeOgaApY1Bvzv2P8X4EA: checks
XFa6sBGjP2gxoIvxR3fZIg: checks
*** TURN *** [9h Jh Ts] [4s]
5IBeOgaApY1Bvzv2P8X4EA: checks
XFa6sBGjP2gxoIvxR3fZIg: checks
*** RIVER *** [9h Jh Ts 4s] [2d]
5IBeOgaApY1Bvzv2P8X4EA: checks
XFa6sBGjP2gxoIvxR3fZIg: checks
*** SHOW DOWN ***
5IBeOgaApY1Bvzv2P8X4EA: shows [6c 6h] (a pair of Sixes)
XFa6sBGjP2gxoIvxR3fZIg: mucks hand
5IBeOgaApY1Bvzv2P8X4EA collected $2.85 from pot
*** SUMMARY ***
Total pot $3 | Rake $0.15
Board [9h Jh Ts 4s 2d]
Seat 1: XFa6sBGjP2gxoIvxR3fZIg (button) (small blind) mucked
Seat 2: 5IBeOgaApY1Bvzv2P8X4EA (big blind) showed [6c 6h] and won ($2.85) with a pair of Sixes



PokerStars Game #59939324798:  Hold'em No Limit ($0.25/$0.50) - 2009/07/01 0:36:58 ET
Table 'fx6MqwfYAj/Rt86hBz2L3Q' 9-max Seat #3 is the button
Seat 2: C3rGXblctNcWI6JYPHhaEg ($20 in chips)
Seat 3: iadBi5AEt7gTBXbDSSnMYQ ($43.15 in chips)
Seat 4: gPEN9Zp33YTm/mu9/SYP1w ($22.20 in chips)
Seat 5: iAISe3dVeua8PUn2wwgDHw ($43.60 in chips)
Seat 6: 5k9fvXD9suIgCxU4HLQjTw ($50 in chips)
Seat 7: bkXkL3pmapikPQQRNPZSEA ($24.50 in chips)
Seat 8: CAuekkxPVzBL9SK4Tjjbuw ($29 in chips)
Seat 9: HZkVla4kK2SI42CVrPZ/ig ($8.50 in chips)
gPEN9Zp33YTm/mu9/SYP1w: posts small blind $0.25
iAISe3dVeua8PUn2wwgDHw: posts big blind $0.50
pmyrdhen: sits out
*** HOLE CARDS ***
5k9fvXD9suIgCxU4HLQjTw: folds
bkXkL3pmapikPQQRNPZSEA: folds
CAuekkxPVzBL9SK4Tjjbuw: folds
C3rGXblctNcWI6JYPHhaEg said, "where in okc are you??"
C3rGXblctNcWI6JYPHhaEg said, "wildfire"
HZkVla4kK2SI42CVrPZ/ig: folds
C3rGXblctNcWI6JYPHhaEg: calls $0.50
iadBi5AEt7gTBXbDSSnMYQ said, "s.w."
iadBi5AEt7gTBXbDSSnMYQ: calls $0.50
gPEN9Zp33YTm/mu9/SYP1w: calls $0.25
iAISe3dVeua8PUn2wwgDHw: checks
*** FLOP *** [5s Ac Ks]
C3rGXblctNcWI6JYPHhaEg said, "anywhere near moore?"
iadBi5AEt7gTBXbDSSnMYQ said, "u?"
gPEN9Zp33YTm/mu9/SYP1w: checks
C3rGXblctNcWI6JYPHhaEg said, "thats where im from"
iAISe3dVeua8PUn2wwgDHw: checks
C3rGXblctNcWI6JYPHhaEg: checks
iadBi5AEt7gTBXbDSSnMYQ: checks
*** TURN *** [5s Ac Ks] [8s]
iadBi5AEt7gTBXbDSSnMYQ said, "kinda close not rlly"
C3rGXblctNcWI6JYPHhaEg said, "like 12th and sante fe ish area"
gPEN9Zp33YTm/mu9/SYP1w: checks
C3rGXblctNcWI6JYPHhaEg said, "know where that is??"
iAISe3dVeua8PUn2wwgDHw: checks
C3rGXblctNcWI6JYPHhaEg: checks
iadBi5AEt7gTBXbDSSnMYQ said, "nope"
C3rGXblctNcWI6JYPHhaEg said, "ohh.."
iadBi5AEt7gTBXbDSSnMYQ: checks
*** RIVER *** [5s Ac Ks 8s] [Jh]
gPEN9Zp33YTm/mu9/SYP1w: checks
iAISe3dVeua8PUn2wwgDHw: checks
C3rGXblctNcWI6JYPHhaEg: checks
iadBi5AEt7gTBXbDSSnMYQ: bets $1.50
gPEN9Zp33YTm/mu9/SYP1w: folds
iAISe3dVeua8PUn2wwgDHw: folds
C3rGXblctNcWI6JYPHhaEg: folds
iadBi5AEt7gTBXbDSSnMYQ collected $1.90 from pot
*** SUMMARY ***
Total pot $2 | Rake $0.10
Board [5s Ac Ks 8s Jh]
Seat 2: C3rGXblctNcWI6JYPHhaEg folded on the River
Seat 3: iadBi5AEt7gTBXbDSSnMYQ (button) collected ($1.90)
Seat 4: gPEN9Zp33YTm/mu9/SYP1w (small blind) folded on the River
Seat 5: iAISe3dVeua8PUn2wwgDHw (big blind) folded on the River
Seat 6: 5k9fvXD9suIgCxU4HLQjTw folded before Flop (didn't bet)
Seat 7: bkXkL3pmapikPQQRNPZSEA folded before Flop (didn't bet)
Seat 8: CAuekkxPVzBL9SK4Tjjbuw folded before Flop (didn't bet)
Seat 9: HZkVla4kK2SI42CVrPZ/ig folded before Flop (didn't bet)



PokerStars Game #59939324624:  Hold'em No Limit ($0.25/$0.50) - 2009/07/01 0:36:58 ET
Table 'GfL/No5u5PoEnU39lP5pQg' 6-max Seat #3 is the button
Seat 1: 1WUCqNG+p+vfWRTXNu4ljw ($52 in chips)
Seat 2: uVwggSetzp7d+eVgowO3vg ($51.55 in chips)
Seat 3: NbUTppWfym/RxV/DmDz2Sw ($17.15 in chips)
Seat 4: x+pzUFJsMIiGd7a5pcR4tg ($51.85 in chips)
Seat 5: crjGpJEzSZgD38FoE3VMGg ($59.60 in chips)
x+pzUFJsMIiGd7a5pcR4tg: posts small blind $0.25
crjGpJEzSZgD38FoE3VMGg: posts big blind $0.50
*** HOLE CARDS ***
1WUCqNG+p+vfWRTXNu4ljw: folds
uVwggSetzp7d+eVgowO3vg: raises $1.50 to $2
NbUTppWfym/RxV/DmDz2Sw: calls $2
x+pzUFJsMIiGd7a5pcR4tg: folds
crjGpJEzSZgD38FoE3VMGg: raises $6 to $8
uVwggSetzp7d+eVgowO3vg: calls $6
NbUTppWfym/RxV/DmDz2Sw: calls $6
*** FLOP *** [Ks 5h Qs]
crjGpJEzSZgD38FoE3VMGg: checks
uVwggSetzp7d+eVgowO3vg: bets $7
NbUTppWfym/RxV/DmDz2Sw: calls $7
crjGpJEzSZgD38FoE3VMGg: folds
*** TURN *** [Ks 5h Qs] [8s]
uVwggSetzp7d+eVgowO3vg: bets $2.50
NbUTppWfym/RxV/DmDz2Sw: calls $2.15 and is all-in
*** RIVER *** [Ks 5h Qs 8s] [5s]
*** SHOW DOWN ***
uVwggSetzp7d+eVgowO3vg: shows [Kc Kd] (a full house, Kings full of Fives)
NbUTppWfym/RxV/DmDz2Sw: mucks hand
uVwggSetzp7d+eVgowO3vg collected $40.55 from pot
*** SUMMARY ***
Total pot $42.55 | Rake $2
Board [Ks 5h Qs 8s 5s]
Seat 1: 1WUCqNG+p+vfWRTXNu4ljw folded before Flop (didn't bet)
Seat 2: uVwggSetzp7d+eVgowO3vg showed [Kc Kd] and won ($40.55) with a full house, Kings full of Fives
Seat 3: NbUTppWfym/RxV/DmDz2Sw (button) mucked
Seat 4: x+pzUFJsMIiGd7a5pcR4tg (small blind) folded before Flop
Seat 5: crjGpJEzSZgD38FoE3VMGg (big blind) folded on the Flop



PokerStars Game #59939324548:  Hold'em No Limit ($0.25/$0.50) - 2009/07/01 0:36:58 ET
Table 'NCiXr0d5CEKBQr/cZgLhbA' 9-max Seat #8 is the button
Seat 1: pFtzb1sR4b0d1aw6aIRgDg ($50 in chips)
Seat 2: ulxuJchBV9iguXg0FUonfg ($25.80 in chips)
Seat 3: xZCXQSXlrZkp3pZizzVXCw ($50 in chips)
Seat 4: 5k9fvXD9suIgCxU4HLQjTw ($57.70 in chips)
Seat 5: zE9cVigS2nW/Ljy4K4bUQA ($39.95 in chips)
Seat 6: SKnJuWHScqetA/qG5p+wCg ($34 in chips)
Seat 7: M+7+BTmX5vZatHVuoRB1nA ($46 in chips)
Seat 8: 1MJUKc3cc0QmUoz1JZLR2w ($52.80 in chips)
Seat 9: 4WLZvqBn5qv5tds5kt5A1Q ($48.80 in chips)
4WLZvqBn5qv5tds5kt5A1Q: posts small blind $0.25
pFtzb1sR4b0d1aw6aIRgDg: posts big blind $0.50
*** HOLE CARDS ***
ulxuJchBV9iguXg0FUonfg: raises $1 to $1.50
xZCXQSXlrZkp3pZizzVXCw: folds
5k9fvXD9suIgCxU4HLQjTw: folds
zE9cVigS2nW/Ljy4K4bUQA: folds
SKnJuWHScqetA/qG5p+wCg: raises $3 to $4.50
M+7+BTmX5vZatHVuoRB1nA: folds
1MJUKc3cc0QmUoz1JZLR2w: folds
4WLZvqBn5qv5tds5kt5A1Q: folds
pFtzb1sR4b0d1aw6aIRgDg: folds
ulxuJchBV9iguXg0FUonfg: calls $3
*** FLOP *** [Js Jh 2h]
ulxuJchBV9iguXg0FUonfg: checks
SKnJuWHScqetA/qG5p+wCg: checks
*** TURN *** [Js Jh 2h] [3c]
ulxuJchBV9iguXg0FUonfg: bets $7
SKnJuWHScqetA/qG5p+wCg: calls $7
*** RIVER *** [Js Jh 2h 3c] [Td]
ulxuJchBV9iguXg0FUonfg: bets $14.30 and is all-in
SKnJuWHScqetA/qG5p+wCg: calls $14.30
*** SHOW DOWN ***
ulxuJchBV9iguXg0FUonfg: shows [Th Ts] (a full house, Tens full of Jacks)
SKnJuWHScqetA/qG5p+wCg: mucks hand
ulxuJchBV9iguXg0FUonfg collected $49.80 from pot
*** SUMMARY ***
Total pot $52.35 | Rake $2.55
Board [Js Jh 2h 3c Td]
Seat 1: pFtzb1sR4b0d1aw6aIRgDg (big blind) folded before Flop
Seat 2: ulxuJchBV9iguXg0FUonfg showed [Th Ts] and won ($49.80) with a full house, Tens full of Jacks
Seat 3: xZCXQSXlrZkp3pZizzVXCw folded before Flop (didn't bet)
Seat 4: 5k9fvXD9suIgCxU4HLQjTw folded before Flop (didn't bet)
Seat 5: zE9cVigS2nW/Ljy4K4bUQA folded before Flop (didn't bet)
Seat 6: SKnJuWHScqetA/qG5p+wCg mucked
Seat 7: M+7+BTmX5vZatHVuoRB1nA folded before Flop (didn't bet)
Seat 8: 1MJUKc3cc0QmUoz1JZLR2w (button) folded before Flop (didn't bet)
Seat 9: 4WLZvqBn5qv5tds5kt5A1Q (small blind) folded before Flop



PokerStars Game #59939325448:  Hold'em No Limit ($0.25/$0.50) - 2009/07/01 0:36:59 ET
Table 'kgbJRsxfv64KrErDRBAkcw' 6-max Seat #5 is the button
Seat 2: Q+thC23WCv1kJUJtH/+4Jw ($53.80 in chips)
Seat 3: T0Gx/FcQ5VH9u7XaOMX97A ($108.60 in chips)
Seat 4: qanMEqjABjWxC/JgQ/0l7w ($55.45 in chips)
Seat 5: +Pf9jTVizYlIo+woPvptfA ($50.80 in chips)
Q+thC23WCv1kJUJtH/+4Jw: posts small blind $0.25
T0Gx/FcQ5VH9u7XaOMX97A: posts big blind $0.50
*** HOLE CARDS ***
qanMEqjABjWxC/JgQ/0l7w: folds
+Pf9jTVizYlIo+woPvptfA: folds
Q+thC23WCv1kJUJtH/+4Jw: folds
T0Gx/FcQ5VH9u7XaOMX97A collected $0.50 from pot
T0Gx/FcQ5VH9u7XaOMX97A: doesn't show hand
*** SUMMARY ***
Total pot $0.50 | Rake $0
Seat 2: Q+thC23WCv1kJUJtH/+4Jw (small blind) folded before Flop
Seat 3: T0Gx/FcQ5VH9u7XaOMX97A (big blind) collected ($0.50)
Seat 4: qanMEqjABjWxC/JgQ/0l7w folded before Flop (didn't bet)
Seat 5: +Pf9jTVizYlIo+woPvptfA (button) folded before Flop (didn't bet)



PokerStars Game #59939326962:  Hold'em No Limit ($0.25/$0.50) - 2009/07/01 0:37:02 ET
Table 'hSTs/dUsYLgJQuF2Onp0MQ' 6-max Seat #4 is the button
Seat 1: Donj3X7gYzeS5pAl7s9f+Q ($30.40 in chips)
Seat 2: 6vNxrjjCl6FwfaaymM9jjg ($30.35 in chips)
Seat 3: C3qJBo7uxfFVDluE1lmK2w ($29.25 in chips)
Seat 4: L0aIPg7qefDQjdJo3HCVEA ($9.30 in chips)
Seat 5: 686aeHikcJlgKkSuIFdcXQ ($58.90 in chips)
Seat 6: w0pd++ZQHijd9dDhKEYOAQ ($31.65 in chips)
686aeHikcJlgKkSuIFdcXQ: posts small blind $0.25
w0pd++ZQHijd9dDhKEYOAQ: posts big blind $0.50
*** HOLE CARDS ***
Donj3X7gYzeS5pAl7s9f+Q: calls $0.50
6vNxrjjCl6FwfaaymM9jjg: folds
C3qJBo7uxfFVDluE1lmK2w: calls $0.50
L0aIPg7qefDQjdJo3HCVEA: raises $0.50 to $1
686aeHikcJlgKkSuIFdcXQ: folds
w0pd++ZQHijd9dDhKEYOAQ: calls $0.50
Donj3X7gYzeS5pAl7s9f+Q: calls $0.50
C3qJBo7uxfFVDluE1lmK2w: calls $0.50
*** FLOP *** [Ks 6c 8c]
w0pd++ZQHijd9dDhKEYOAQ: checks
Donj3X7gYzeS5pAl7s9f+Q: checks
C3qJBo7uxfFVDluE1lmK2w: checks
L0aIPg7qefDQjdJo3HCVEA: checks
*** TURN *** [Ks 6c 8c] [2c]
w0pd++ZQHijd9dDhKEYOAQ: checks
Donj3X7gYzeS5pAl7s9f+Q: bets $3.50
C3qJBo7uxfFVDluE1lmK2w: calls $3.50
L0aIPg7qefDQjdJo3HCVEA: folds
w0pd++ZQHijd9dDhKEYOAQ: folds
*** RIVER *** [Ks 6c 8c 2c] [Tc]
Donj3X7gYzeS5pAl7s9f+Q: checks
C3qJBo7uxfFVDluE1lmK2w: bets $3.50
Donj3X7gYzeS5pAl7s9f+Q: folds
C3qJBo7uxfFVDluE1lmK2w collected $10.70 from pot
*** SUMMARY ***
Total pot $11.25 | Rake $0.55
Board [Ks 6c 8c 2c Tc]
Seat 1: Donj3X7gYzeS5pAl7s9f+Q folded on the River
Seat 2: 6vNxrjjCl6FwfaaymM9jjg folded before Flop (didn't bet)
Seat 3: C3qJBo7uxfFVDluE1lmK2w collected ($10.70)
Seat 4: L0aIPg7qefDQjdJo3HCVEA (button) folded on the Turn
Seat 5: 686aeHikcJlgKkSuIFdcXQ (small blind) folded before Flop
Seat 6: w0pd++ZQHijd9dDhKEYOAQ (big blind) folded on the Turn



PokerStars Game #59939328280:  Hold'em No Limit ($0.25/$0.50) - 2009/07/01 0:37:03 ET
Table 'MJxeZCzYELxiIsyUZyT0jw' 6-max Seat #2 is the button
Seat 1: tdOvWynovql5imfooroLMg ($49.25 in chips)
Seat 2: dB6jzDlJmET84VMWw1mTRA ($50 in chips)
Seat 3: JQZew0FjzS19kTjeNtrE+A ($51.15 in chips)
Seat 4: lP7Q6pewz4C2RsAfKsjdWw ($35.40 in chips)
Seat 5: 3jvoOXNtXE90w2BdfNZwZQ ($50 in chips)
Seat 6: TTx3CHxyi0SObcHyMJRp5w ($61.70 in chips)
JQZew0FjzS19kTjeNtrE+A: posts small blind $0.25
lP7Q6pewz4C2RsAfKsjdWw: posts big blind $0.50
*** HOLE CARDS ***
3jvoOXNtXE90w2BdfNZwZQ: folds
TTx3CHxyi0SObcHyMJRp5w: folds
tdOvWynovql5imfooroLMg: raises $0.50 to $1
dB6jzDlJmET84VMWw1mTRA: folds
JQZew0FjzS19kTjeNtrE+A: folds
lP7Q6pewz4C2RsAfKsjdWw: folds
tdOvWynovql5imfooroLMg collected $1.25 from pot
*** SUMMARY ***
Total pot $1.25 | Rake $0
Seat 1: tdOvWynovql5imfooroLMg collected ($1.25)
Seat 2: dB6jzDlJmET84VMWw1mTRA (button) folded before Flop (didn't bet)
Seat 3: JQZew0FjzS19kTjeNtrE+A (small blind) folded before Flop
Seat 4: lP7Q6pewz4C2RsAfKsjdWw (big blind) folded before Flop
Seat 5: 3jvoOXNtXE90w2BdfNZwZQ folded before Flop (didn't bet)
Seat 6: TTx3CHxyi0SObcHyMJRp5w folded before Flop (didn't bet)



PokerStars Game #59939331482:  Hold'em No Limit ($0.25/$0.50) - 2009/07/01 0:37:08 ET
Table 'E7bWJ45aoFXRpyRv2gw+Ig' 2-max Seat #1 is the button
Seat 1: FRkiRasEGlHUeLrEl+k/nA ($50.60 in chips)
Seat 2: 3Wro85I7472vJ4Wkpneo9A ($144.20 in chips)
FRkiRasEGlHUeLrEl+k/nA: posts small blind $0.25
3Wro85I7472vJ4Wkpneo9A: posts big blind $0.50
*** HOLE CARDS ***
FRkiRasEGlHUeLrEl+k/nA: folds
3Wro85I7472vJ4Wkpneo9A collected $0.50 from pot
3Wro85I7472vJ4Wkpneo9A: doesn't show hand
*** SUMMARY ***
Total pot $0.50 | Rake $0
Seat 1: FRkiRasEGlHUeLrEl+k/nA (button) (small blind) folded before Flop
Seat 2: 3Wro85I7472vJ4Wkpneo9A (big blind) collected ($0.50)



PokerStars Game #59939331546:  Hold'em No Limit ($0.25/$0.50) - 2009/07/01 0:37:08 ET
Table 'lSisgp6H7Fg1hH5VfjEjYQ' 9-max Seat #2 is the button
Seat 1: pEW8B6uXbdR47kfljMQ3+Q ($37.10 in chips)
Seat 2: UrcnkQOiLVk8BlKDPJSy7Q ($52.30 in chips)
Seat 3: aTkyjTh3w5YLWiIERupZOA ($41.95 in chips)
Seat 4: bwv/rbH/hHhPhY6u9mu04w ($21.65 in chips)
Seat 5: mSD1pginDsyHG5PDfqzphw ($12.10 in chips)
Seat 6: +k7T5ocke8UwavtgUHm+Cg ($28.95 in chips)
Seat 7: Y3DZ6qQlLeBhixDj4M9vmg ($11.75 in chips)
Seat 8: a4JDWmpFQkL10XfAyuF51A ($34.75 in chips)
aTkyjTh3w5YLWiIERupZOA: posts small blind $0.25
bwv/rbH/hHhPhY6u9mu04w: posts big blind $0.50
gsyXT42WLEcOS4DdEk2wlw: sits out
*** HOLE CARDS ***
mSD1pginDsyHG5PDfqzphw: folds
+k7T5ocke8UwavtgUHm+Cg: folds
Y3DZ6qQlLeBhixDj4M9vmg: calls $0.50
a4JDWmpFQkL10XfAyuF51A: folds
pEW8B6uXbdR47kfljMQ3+Q: folds
UrcnkQOiLVk8BlKDPJSy7Q: folds
aTkyjTh3w5YLWiIERupZOA: folds
bwv/rbH/hHhPhY6u9mu04w: raises $1 to $1.50
Y3DZ6qQlLeBhixDj4M9vmg: calls $1
*** FLOP *** [6s Kh 4d]
bwv/rbH/hHhPhY6u9mu04w: bets $1.50
Y3DZ6qQlLeBhixDj4M9vmg: folds
bwv/rbH/hHhPhY6u9mu04w collected $3.10 from pot
*** SUMMARY ***
Total pot $3.25 | Rake $0.15
Board [6s Kh 4d]
Seat 1: pEW8B6uXbdR47kfljMQ3+Q folded before Flop (didn't bet)
Seat 2: UrcnkQOiLVk8BlKDPJSy7Q (button) folded before Flop (didn't bet)
Seat 3: aTkyjTh3w5YLWiIERupZOA (small blind) folded before Flop
Seat 4: bwv/rbH/hHhPhY6u9mu04w (big blind) collected ($3.10)
Seat 5: mSD1pginDsyHG5PDfqzphw folded before Flop (didn't bet)
Seat 6: +k7T5ocke8UwavtgUHm+Cg folded before Flop (didn't bet)
Seat 7: Y3DZ6qQlLeBhixDj4M9vmg folded on the Flop
Seat 8: a4JDWmpFQkL10XfAyuF51A folded before Flop (didn't bet)



PokerStars Game #59939332062:  Hold'em No Limit ($0.25/$0.50) - 2009/07/01 0:37:09 ET
Table 'Nz0Vr7WMHL2g5Uk7dDZjpw' 9-max Seat #1 is the button
Seat 1: tLkxo7JgV+WWI0UBw44K5A ($96.75 in chips)
Seat 2: XNMDwbXt/Q4jM99AXnbJDw ($67.45 in chips)
Seat 3: 4QTiNH5fteLgJjx/s6Hy6A ($17.15 in chips)
Seat 4: 5JJVDlaiMnB004o/RqbZZQ ($27.25 in chips)
Seat 5: WGW0DgjBUXs1ylURHG8vnQ ($16.45 in chips)
Seat 6: k1f0lS7tlMHCLGs0JT34Tg ($13.50 in chips)
Seat 7: KPLH0gELgFe2OuAnhJFI5w ($25 in chips)
Seat 8: HkZI6g4zl83TDTA7SRspmQ ($15.20 in chips)
XNMDwbXt/Q4jM99AXnbJDw: posts small blind $0.25
4QTiNH5fteLgJjx/s6Hy6A: posts big blind $0.50
mSD1pginDsyHG5PDfqzphw: sits out
*** HOLE CARDS ***
5JJVDlaiMnB004o/RqbZZQ: folds
WGW0DgjBUXs1ylURHG8vnQ: calls $0.50
k1f0lS7tlMHCLGs0JT34Tg: folds
KPLH0gELgFe2OuAnhJFI5w: calls $0.50
HkZI6g4zl83TDTA7SRspmQ: calls $0.50
tLkxo7JgV+WWI0UBw44K5A: calls $0.50
XNMDwbXt/Q4jM99AXnbJDw: folds
4QTiNH5fteLgJjx/s6Hy6A: checks
*** FLOP *** [9h Jd 3d]
4QTiNH5fteLgJjx/s6Hy6A: checks
WGW0DgjBUXs1ylURHG8vnQ: bets $0.50
KPLH0gELgFe2OuAnhJFI5w: calls $0.50
HkZI6g4zl83TDTA7SRspmQ: calls $0.50
tLkxo7JgV+WWI0UBw44K5A: folds
4QTiNH5fteLgJjx/s6Hy6A: folds
*** TURN *** [9h Jd 3d] [6d]
WGW0DgjBUXs1ylURHG8vnQ: bets $0.50
KPLH0gELgFe2OuAnhJFI5w: folds
HkZI6g4zl83TDTA7SRspmQ: calls $0.50
*** RIVER *** [9h Jd 3d 6d] [Js]
WGW0DgjBUXs1ylURHG8vnQ: bets $0.50
HkZI6g4zl83TDTA7SRspmQ: folds
WGW0DgjBUXs1ylURHG8vnQ collected $5 from pot
WGW0DgjBUXs1ylURHG8vnQ: doesn't show hand
*** SUMMARY ***
Total pot $5.25 | Rake $0.25
Board [9h Jd 3d 6d Js]
Seat 1: tLkxo7JgV+WWI0UBw44K5A (button) folded on the Flop
Seat 2: XNMDwbXt/Q4jM99AXnbJDw (small blind) folded before Flop
Seat 3: 4QTiNH5fteLgJjx/s6Hy6A (big blind) folded on the Flop
Seat 4: 5JJVDlaiMnB004o/RqbZZQ folded before Flop (didn't bet)
Seat 5: WGW0DgjBUXs1ylURHG8vnQ collected ($5)
Seat 6: k1f0lS7tlMHCLGs0JT34Tg folded before Flop (didn't bet)
Seat 7: KPLH0gELgFe2OuAnhJFI5w folded on the Turn
Seat 8: HkZI6g4zl83TDTA7SRspmQ folded on the River



PokerStars Game #59939331702:  Hold'em No Limit ($0.25/$0.50) - 2009/07/01 0:37:09 ET
Table 'T/PgNWqVyY6lkldcBVXYJQ' 6-max Seat #5 is the button
Seat 1: +Pf9jTVizYlIo+woPvptfA ($57.25 in chips)
Seat 3: L3OcNO1bgdqDI46j67KQPQ ($53.85 in chips)
Seat 4: otJMdCRvqd5YCcFsA3JWpg ($9.25 in chips)
Seat 5: vVQBckETtigfb5mAcyK0OA ($51.90 in chips)
Seat 6: cDzbog6kwmJp+LBeBq+iMQ ($42.20 in chips)
cDzbog6kwmJp+LBeBq+iMQ: posts small blind $0.25
+Pf9jTVizYlIo+woPvptfA: posts big blind $0.50
*** HOLE CARDS ***
L3OcNO1bgdqDI46j67KQPQ: folds
otJMdCRvqd5YCcFsA3JWpg: folds
vVQBckETtigfb5mAcyK0OA: calls $0.50
cDzbog6kwmJp+LBeBq+iMQ: calls $0.25
+Pf9jTVizYlIo+woPvptfA: checks
*** FLOP *** [As 5s Kd]
cDzbog6kwmJp+LBeBq+iMQ: checks
+Pf9jTVizYlIo+woPvptfA: checks
vVQBckETtigfb5mAcyK0OA: checks
*** TURN *** [As 5s Kd] [Th]
cDzbog6kwmJp+LBeBq+iMQ: checks
+Pf9jTVizYlIo+woPvptfA: checks
vVQBckETtigfb5mAcyK0OA: checks
*** RIVER *** [As 5s Kd Th] [Jd]
LvH4G7n+QSjT6NDaD3cREA joins the table at seat #2
cDzbog6kwmJp+LBeBq+iMQ: checks
+Pf9jTVizYlIo+woPvptfA: checks
vVQBckETtigfb5mAcyK0OA: bets $51.40 and is all-in
cDzbog6kwmJp+LBeBq+iMQ: folds
+Pf9jTVizYlIo+woPvptfA: folds
vVQBckETtigfb5mAcyK0OA collected $1.45 from pot
vVQBckETtigfb5mAcyK0OA: doesn't show hand
*** SUMMARY ***
Total pot $1.50 | Rake $0.05
Board [As 5s Kd Th Jd]
Seat 1: +Pf9jTVizYlIo+woPvptfA (big blind) folded on the River
Seat 3: L3OcNO1bgdqDI46j67KQPQ folded before Flop (didn't bet)
Seat 4: otJMdCRvqd5YCcFsA3JWpg folded before Flop (didn't bet)
Seat 5: vVQBckETtigfb5mAcyK0OA (button) collected ($1.45)
Seat 6: cDzbog6kwmJp+LBeBq+iMQ (small blind) folded on the River



PokerStars Game #59939332338:  Hold'em No Limit ($0.25/$0.50) - 2009/07/01 0:37:10 ET
Table '5EmHi+fnatGQQShcNmzOZQ' 6-max Seat #2 is the button
Seat 2: vXIHnZ+dv/hwSBxyvGw7bQ ($77.25 in chips)
Seat 3: L9qfLYXrczhAPd/VckgsWw ($90.75 in chips)
Seat 4: 1b+2BbjMN8qhR1WPqdE9VQ ($50 in chips)
Seat 5: kxPhs4ePFqMy52CInAJ2aw ($53.85 in chips)
Seat 6: 686aeHikcJlgKkSuIFdcXQ ($138.65 in chips)
L9qfLYXrczhAPd/VckgsWw: posts small blind $0.25
1b+2BbjMN8qhR1WPqdE9VQ: posts big blind $0.50
*** HOLE CARDS ***
kxPhs4ePFqMy52CInAJ2aw: folds
686aeHikcJlgKkSuIFdcXQ: folds
vXIHnZ+dv/hwSBxyvGw7bQ: folds
L9qfLYXrczhAPd/VckgsWw: raises $1.50 to $2
1b+2BbjMN8qhR1WPqdE9VQ: calls $1.50
*** FLOP *** [3c 4d 9h]
L9qfLYXrczhAPd/VckgsWw: bets $1.50
+SZCX3+7lnuhHKIu+PP9rg joins the table at seat #1
1b+2BbjMN8qhR1WPqdE9VQ: raises $3 to $4.50
L9qfLYXrczhAPd/VckgsWw: calls $3
*** TURN *** [3c 4d 9h] [2s]
L9qfLYXrczhAPd/VckgsWw: checks
1b+2BbjMN8qhR1WPqdE9VQ: checks
*** RIVER *** [3c 4d 9h 2s] [Kc]
L9qfLYXrczhAPd/VckgsWw: checks
1b+2BbjMN8qhR1WPqdE9VQ: checks
*** SHOW DOWN ***
L9qfLYXrczhAPd/VckgsWw: shows [Ad Jd] (high card Ace)
1b+2BbjMN8qhR1WPqdE9VQ: shows [7s 7h] (a pair of Sevens)
1b+2BbjMN8qhR1WPqdE9VQ collected $12.40 from pot
*** SUMMARY ***
Total pot $13 | Rake $0.60
Board [3c 4d 9h 2s Kc]
Seat 2: vXIHnZ+dv/hwSBxyvGw7bQ (button) folded before Flop (didn't bet)
Seat 3: L9qfLYXrczhAPd/VckgsWw (small blind) showed [Ad Jd] and lost with high card Ace
Seat 4: 1b+2BbjMN8qhR1WPqdE9VQ (big blind) showed [7s 7h] and won ($12.40) with a pair of Sevens
Seat 5: kxPhs4ePFqMy52CInAJ2aw folded before Flop (didn't bet)
Seat 6: 686aeHikcJlgKkSuIFdcXQ folded before Flop (didn't bet)



PokerStars Game #59939332714:  Hold'em No Limit ($0.25/$0.50) - 2009/07/01 0:37:10 ET
Table '3FhG0gl3kMX3wBEEqj+wnQ' 9-max Seat #4 is the button
Seat 1: e0J9pdCNUDTCG031RnXqLA ($17.75 in chips)
Seat 2: 7cYQ+syUWjl38ty/ICOMhw ($50.40 in chips)
Seat 3: HZkVla4kK2SI42CVrPZ/ig ($15.95 in chips)
Seat 4: bjvJtA9Hqscfznq66txaOQ ($9.25 in chips)
Seat 5: gsyXT42WLEcOS4DdEk2wlw ($29.50 in chips)
Seat 7: mSD1pginDsyHG5PDfqzphw ($10 in chips)
Seat 8: j3K/Jujr7PY4ZM2RZvlH6A ($57.30 in chips)
Seat 9: L5e2lrPLQm1Pqx30IIZ/Fw ($10.10 in chips)
gsyXT42WLEcOS4DdEk2wlw: posts small blind $0.25
5JJVDlaiMnB004o/RqbZZQ: is sitting out
mSD1pginDsyHG5PDfqzphw: posts big blind $0.50
*** HOLE CARDS ***
j3K/Jujr7PY4ZM2RZvlH6A: raises $2 to $2.50
L5e2lrPLQm1Pqx30IIZ/Fw: folds
5JJVDlaiMnB004o/RqbZZQ leaves the table
e0J9pdCNUDTCG031RnXqLA: folds
7cYQ+syUWjl38ty/ICOMhw: folds
HZkVla4kK2SI42CVrPZ/ig: folds
bjvJtA9Hqscfznq66txaOQ: folds
gsyXT42WLEcOS4DdEk2wlw: folds
mSD1pginDsyHG5PDfqzphw: folds
j3K/Jujr7PY4ZM2RZvlH6A collected $1.25 from pot
j3K/Jujr7PY4ZM2RZvlH6A: doesn't show hand
*** SUMMARY ***
Total pot $1.25 | Rake $0
Seat 1: e0J9pdCNUDTCG031RnXqLA folded before Flop (didn't bet)
Seat 2: 7cYQ+syUWjl38ty/ICOMhw folded before Flop (didn't bet)
Seat 3: HZkVla4kK2SI42CVrPZ/ig folded before Flop (didn't bet)
Seat 4: bjvJtA9Hqscfznq66txaOQ (button) folded before Flop (didn't bet)
Seat 5: gsyXT42WLEcOS4DdEk2wlw (small blind) folded before Flop
Seat 7: mSD1pginDsyHG5PDfqzphw (big blind) folded before Flop
Seat 8: j3K/Jujr7PY4ZM2RZvlH6A collected ($1.25)
Seat 9: L5e2lrPLQm1Pqx30IIZ/Fw folded before Flop (didn't bet)



PokerStars Game #59939332268:  Hold'em No Limit ($0.25/$0.50) - 2009/07/01 0:37:10 ET
Table 'mTxf8gPLgffN3Iwfm7Icfg' 2-max Seat #2 is the button
Seat 1: Do9Rlu1R5u/AcRtMTl8SYg ($60.70 in chips)
Seat 2: EMc5LPgVaded4Qc77vm0fw ($96.75 in chips)
EMc5LPgVaded4Qc77vm0fw: posts small blind $0.25
Do9Rlu1R5u/AcRtMTl8SYg: posts big blind $0.50
*** HOLE CARDS ***
EMc5LPgVaded4Qc77vm0fw: folds
Do9Rlu1R5u/AcRtMTl8SYg collected $0.50 from pot
Do9Rlu1R5u/AcRtMTl8SYg: doesn't show hand
*** SUMMARY ***
Total pot $0.50 | Rake $0
Seat 1: Do9Rlu1R5u/AcRtMTl8SYg (big blind) collected ($0.50)
Seat 2: EMc5LPgVaded4Qc77vm0fw (button) (small blind) folded before Flop



PokerStars Game #59939334466:  Hold'em No Limit ($0.25/$0.50) - 2009/07/01 0:37:13 ET
Table 'kgbJRsxfv64KrErDRBAkcw' 6-max Seat #2 is the button
Seat 2: Q+thC23WCv1kJUJtH/+4Jw ($53.55 in chips)
Seat 3: T0Gx/FcQ5VH9u7XaOMX97A ($108.85 in chips)
Seat 4: qanMEqjABjWxC/JgQ/0l7w ($55.45 in chips)
Seat 5: +Pf9jTVizYlIo+woPvptfA ($50.80 in chips)
T0Gx/FcQ5VH9u7XaOMX97A: posts small blind $0.25
qanMEqjABjWxC/JgQ/0l7w: posts big blind $0.50
*** HOLE CARDS ***
+Pf9jTVizYlIo+woPvptfA: folds
Q+thC23WCv1kJUJtH/+4Jw: raises $1.50 to $2
T0Gx/FcQ5VH9u7XaOMX97A: folds
qanMEqjABjWxC/JgQ/0l7w: folds
Q+thC23WCv1kJUJtH/+4Jw collected $1.25 from pot
*** SUMMARY ***
Total pot $1.25 | Rake $0
Seat 2: Q+thC23WCv1kJUJtH/+4Jw (button) collected ($1.25)
Seat 3: T0Gx/FcQ5VH9u7XaOMX97A (small blind) folded before Flop
Seat 4: qanMEqjABjWxC/JgQ/0l7w (big blind) folded before Flop
Seat 5: +Pf9jTVizYlIo+woPvptfA folded before Flop (didn't bet)



PokerStars Game #59939335638:  Hold'em No Limit ($0.25/$0.50) - 2009/07/01 0:37:15 ET
Table 'E7bWJ45aoFXRpyRv2gw+Ig' 2-max Seat #2 is the button
Seat 1: FRkiRasEGlHUeLrEl+k/nA ($50.35 in chips)
Seat 2: 3Wro85I7472vJ4Wkpneo9A ($144.45 in chips)
3Wro85I7472vJ4Wkpneo9A: posts small blind $0.25
FRkiRasEGlHUeLrEl+k/nA: posts big blind $0.50
*** HOLE CARDS ***
3Wro85I7472vJ4Wkpneo9A: folds
FRkiRasEGlHUeLrEl+k/nA collected $0.50 from pot
*** SUMMARY ***
Total pot $0.50 | Rake $0
Seat 1: FRkiRasEGlHUeLrEl+k/nA (big blind) collected ($0.50)
Seat 2: 3Wro85I7472vJ4Wkpneo9A (button) (small blind) folded before Flop



PokerStars Game #59939335614:  Hold'em No Limit ($0.25/$0.50) - 2009/07/01 0:37:15 ET
Table 'IeNZOZQ4T6oiaHqFeo6yIA' 2-max Seat #2 is the button
Seat 1: ndd1nfncBkWNitBnsfCoVQ ($56.15 in chips)
Seat 2: A91IUl5JaZROhtfCtnnwYw ($71.70 in chips)
A91IUl5JaZROhtfCtnnwYw: posts small blind $0.25
ndd1nfncBkWNitBnsfCoVQ: posts big blind $0.50
*** HOLE CARDS ***
A91IUl5JaZROhtfCtnnwYw: raises $0.50 to $1
ndd1nfncBkWNitBnsfCoVQ: folds
A91IUl5JaZROhtfCtnnwYw collected $1 from pot
*** SUMMARY ***
Total pot $1 | Rake $0
Seat 1: ndd1nfncBkWNitBnsfCoVQ (big blind) folded before Flop
Seat 2: A91IUl5JaZROhtfCtnnwYw (button) (small blind) collected ($1)



PokerStars Game #59939336362:  Hold'em No Limit ($0.25/$0.50) - 2009/07/01 0:37:16 ET
Table 'mTxf8gPLgffN3Iwfm7Icfg' 2-max Seat #1 is the button
Seat 1: Do9Rlu1R5u/AcRtMTl8SYg ($60.95 in chips)
Seat 2: EMc5LPgVaded4Qc77vm0fw ($96.50 in chips)
Do9Rlu1R5u/AcRtMTl8SYg: posts small blind $0.25
EMc5LPgVaded4Qc77vm0fw: posts big blind $0.50
*** HOLE CARDS ***
Do9Rlu1R5u/AcRtMTl8SYg: raises $1 to $1.50
EMc5LPgVaded4Qc77vm0fw: folds
Do9Rlu1R5u/AcRtMTl8SYg collected $1 from pot
Do9Rlu1R5u/AcRtMTl8SYg: doesn't show hand
*** SUMMARY ***
Total pot $1 | Rake $0
Seat 1: Do9Rlu1R5u/AcRtMTl8SYg (button) (small blind) collected ($1)
Seat 2: EMc5LPgVaded4Qc77vm0fw (big blind) folded before Flop



PokerStars Game #59939337084:  Hold'em No Limit ($0.25/$0.50) - 2009/07/01 0:37:17 ET
Table 'ibNfFy0bCzuBaUORla0aGw' 9-max Seat #7 is the button
Seat 1: xZCXQSXlrZkp3pZizzVXCw ($53.95 in chips)
Seat 2: 90Wb75h3W1BRpbqVnuk8gw ($59.65 in chips)
Seat 3: dDaHs3X8+fe3bIkRU0cbrw ($40.90 in chips)
Seat 4: YBN054X4blmis+B2bBlC0g ($21.90 in chips)
Seat 5: GIJAc9kPrLZHLSX8Q6i99w ($24.50 in chips)
Seat 6: 8n9jQLh3cZKbsmr5PIjgiQ ($36.25 in chips)
Seat 7: HZkVla4kK2SI42CVrPZ/ig ($11.75 in chips)
Seat 8: xUrN9TWLq4m5V+OXY7KUUA ($50 in chips)
Seat 9: pFtzb1sR4b0d1aw6aIRgDg ($50.75 in chips)
xUrN9TWLq4m5V+OXY7KUUA: posts small blind $0.25
pFtzb1sR4b0d1aw6aIRgDg: posts big blind $0.50
*** HOLE CARDS ***
xZCXQSXlrZkp3pZizzVXCw: folds
90Wb75h3W1BRpbqVnuk8gw: folds
dDaHs3X8+fe3bIkRU0cbrw: folds
YBN054X4blmis+B2bBlC0g: calls $0.50
GIJAc9kPrLZHLSX8Q6i99w: folds
8n9jQLh3cZKbsmr5PIjgiQ: folds
HZkVla4kK2SI42CVrPZ/ig: folds
xUrN9TWLq4m5V+OXY7KUUA: calls $0.25
pFtzb1sR4b0d1aw6aIRgDg: checks
*** FLOP *** [3c 6d 3h]
xUrN9TWLq4m5V+OXY7KUUA: bets $1.50
pFtzb1sR4b0d1aw6aIRgDg: folds
YBN054X4blmis+B2bBlC0g: raises $1.50 to $3
xUrN9TWLq4m5V+OXY7KUUA: folds
YBN054X4blmis+B2bBlC0g collected $4.30 from pot
*** SUMMARY ***
Total pot $4.50 | Rake $0.20
Board [3c 6d 3h]
Seat 1: xZCXQSXlrZkp3pZizzVXCw folded before Flop (didn't bet)
Seat 2: 90Wb75h3W1BRpbqVnuk8gw folded before Flop (didn't bet)
Seat 3: dDaHs3X8+fe3bIkRU0cbrw folded before Flop (didn't bet)
Seat 4: YBN054X4blmis+B2bBlC0g collected ($4.30)
Seat 5: GIJAc9kPrLZHLSX8Q6i99w folded before Flop (didn't bet)
Seat 6: 8n9jQLh3cZKbsmr5PIjgiQ folded before Flop (didn't bet)
Seat 7: HZkVla4kK2SI42CVrPZ/ig (button) folded before Flop (didn't bet)
Seat 8: xUrN9TWLq4m5V+OXY7KUUA (small blind) folded on the Flop
Seat 9: pFtzb1sR4b0d1aw6aIRgDg (big blind) folded on the Flop



PokerStars Game #59939340138:  Hold'em No Limit ($0.25/$0.50) - 2009/07/01 0:37:21 ET
Table 'E7bWJ45aoFXRpyRv2gw+Ig' 2-max Seat #1 is the button
Seat 1: FRkiRasEGlHUeLrEl+k/nA ($50.60 in chips)
Seat 2: 3Wro85I7472vJ4Wkpneo9A ($144.20 in chips)
FRkiRasEGlHUeLrEl+k/nA: posts small blind $0.25
3Wro85I7472vJ4Wkpneo9A: posts big blind $0.50
*** HOLE CARDS ***
FRkiRasEGlHUeLrEl+k/nA: folds
3Wro85I7472vJ4Wkpneo9A collected $0.50 from pot
3Wro85I7472vJ4Wkpneo9A: doesn't show hand
*** SUMMARY ***
Total pot $0.50 | Rake $0
Seat 1: FRkiRasEGlHUeLrEl+k/nA (button) (small blind) folded before Flop
Seat 2: 3Wro85I7472vJ4Wkpneo9A (big blind) collected ($0.50)



PokerStars Game #59939339666:  Hold'em No Limit ($0.25/$0.50) - 2009/07/01 0:37:21 ET
Table 'QOgaEqMcJ73pcUMMxoisUg' 6-max Seat #6 is the button
Seat 1: OZ6OtYh5Y53MCH/p0QTn5g ($53.70 in chips)
Seat 2: 4QfsCWthT/vSLirorNXqtg ($50 in chips)
Seat 3: Rt6KgtZ8YaJoTc3FPim00w ($50 in chips)
Seat 4: zAcsDhG/T128Vn7XGVSgKg ($58.15 in chips)
Seat 5: 6vNxrjjCl6FwfaaymM9jjg ($29.75 in chips)
Seat 6: pmE+2KJb4nffAVqjLIXxFg ($20.75 in chips)
OZ6OtYh5Y53MCH/p0QTn5g: posts small blind $0.25
4QfsCWthT/vSLirorNXqtg: posts big blind $0.50
*** HOLE CARDS ***
Rt6KgtZ8YaJoTc3FPim00w: raises $1 to $1.50
zAcsDhG/T128Vn7XGVSgKg: folds
6vNxrjjCl6FwfaaymM9jjg: raises $3.50 to $5
pmE+2KJb4nffAVqjLIXxFg: folds
OZ6OtYh5Y53MCH/p0QTn5g: folds
4QfsCWthT/vSLirorNXqtg: folds
Rt6KgtZ8YaJoTc3FPim00w: raises $45 to $50 and is all-in
6vNxrjjCl6FwfaaymM9jjg: calls $24.75 and is all-in
*** FLOP *** [3c 7d Ac]
*** TURN *** [3c 7d Ac] [3s]
*** RIVER *** [3c 7d Ac 3s] [Ks]
*** SHOW DOWN ***
Rt6KgtZ8YaJoTc3FPim00w: shows [Ah Qs] (two pair, Aces and Threes)
6vNxrjjCl6FwfaaymM9jjg: mucks hand
Rt6KgtZ8YaJoTc3FPim00w collected $57.25 from pot
*** SUMMARY ***
Total pot $60.25 | Rake $3
Board [3c 7d Ac 3s Ks]
Seat 1: OZ6OtYh5Y53MCH/p0QTn5g (small blind) folded before Flop
Seat 2: 4QfsCWthT/vSLirorNXqtg (big blind) folded before Flop
Seat 3: Rt6KgtZ8YaJoTc3FPim00w showed [Ah Qs] and won ($57.25) with two pair, Aces and Threes
Seat 4: zAcsDhG/T128Vn7XGVSgKg folded before Flop (didn't bet)
Seat 5: 6vNxrjjCl6FwfaaymM9jjg mucked
Seat 6: pmE+2KJb4nffAVqjLIXxFg (button) folded before Flop (didn't bet)



PokerStars Game #59939340502:  Hold'em No Limit ($0.25/$0.50) - 2009/07/01 0:37:22 ET
Table 'E7bWJ45aoFXRpyRv2gw+Ig99gCy/CZQwPIjZWH+BguQgeat #5 is the button
Seat 2: n6VQBu6crjYjy6DxNP1NZA ($19.70 in chips)
Seat 3: qEn9ijNGtuyTxamBf07hYg ($50 in chips)
Seat 4: bxLSulbgr8LmKNjOzw8URg ($63.45 in chips)
Seat 5: DSM67hHHq1XFoEOi9p8Alw ($49.25 in chips)
Seat 6: OcnLOMVFdy23jXnoTyaO5Q ($267.55 in chips)
Seat 7: 4dd+rKHhaMiTl5LEkADvQQ ($9.25 in chips)
Seat 8: 8ehL7qlZzjgUh2H35iiWLw ($50 in chips)
Seat 9: j3K/Jujr7PY4ZM2RZvlH6A ($64.20 in chips)
OcnLOMVFdy23jXnoTyaO5Q: posts small blind $0.25
4dd+rKHhaMiTl5LEkADvQQ: posts big blind $0.50
RjBdQ6w31rgcy0o24VLR6w: sits out
*** HOLE CARDS ***
8ehL7qlZzjgUh2H35iiWLw: folds
j3K/Jujr7PY4ZM2RZvlH6A: calls $0.50
n6VQBu6crjYjy6DxNP1NZA: folds
qEn9ijNGtuyTxamBf07hYg: folds
bxLSulbgr8LmKNjOzw8URg: folds
DSM67hHHq1XFoEOi9p8Alw: raises $1 to $1.50
OcnLOMVFdy23jXnoTyaO5Q: calls $1.25
4dd+rKHhaMiTl5LEkADvQQ: folds
j3K/Jujr7PY4ZM2RZvlH6A: calls $1
*** FLOP *** [7h 3s Kh]
OcnLOMVFdy23jXnoTyaO5Q: checks
j3K/Jujr7PY4ZM2RZvlH6A: bets $6
DSM67hHHq1XFoEOi9p8Alw: folds
OcnLOMVFdy23jXnoTyaO5Q: calls $6
*** TURN *** [7h 3s Kh] [As]
OcnLOMVFdy23jXnoTyaO5Q: checks
j3K/Jujr7PY4ZM2RZvlH6A: bets $15
OcnLOMVFdy23jXnoTyaO5Q: calls $15
*** RIVER *** [7h 3s Kh As] [Js]
OcnLOMVFdy23jXnoTyaO5Q: checks
j3K/Jujr7PY4ZM2RZvlH6A: bets $41.70 and is all-in
OcnLOMVFdy23jXnoTyaO5Q: folds
j3K/Jujr7PY4ZM2RZvlH6A collected $44.70 from pot
j3K/Jujr7PY4ZM2RZvlH6A: doesn't show hand
*** SUMMARY ***
Total pot $47 | Rake $2.30
Board [7h 3s Kh As Js]
Seat 2: n6VQBu6crjYjy6DxNP1NZA folded before Flop (didn't bet)
Seat 3: qEn9ijNGtuyTxamBf07hYg folded before Flop (didn't bet)
Seat 4: bxLSulbgr8LmKNjOzw8URg folded before Flop (didn't bet)
Seat 5: DSM67hHHq1XFoEOi9p8Alw (button) folded on the Flop
Seat 6: OcnLOMVFdy23jXnoTyaO5Q (small blind) folded on the River
Seat 7: 4dd+rKHhaMiTl5LEkADvQQ (big blind) folded before Flop
Seat 8: 8ehL7qlZzjgUh2H35iiWLw folded before Flop (didn't bet)
Seat 9: j3K/Jujr7PY4ZM2RZvlH6A collected ($44.70)



PokerStars Game #59939340886:  Hold'em No Limit ($0.25/$0.50) - 2009/07/01 0:37:22 ET
Table 'tyR5AZNKV8Aadbrnrnlg7g' 6-max Seat #6 is the button
Seat 1: R+KjpH/wSjDLhtIy9+edNA ($83.90 in chips)
Seat 2: BAjwVL+zKKd0s0fAWstzQQ ($26.35 in chips)
Seat 3: tdOvWynovql5imfooroLMg ($40.95 in chips)
Seat 4: Rt6KgtZ8YaJoTc3FPim00w ($82.45 in chips)
Seat 6: ZKazl1hGaPiapDXincgi2Q ($17.65 in chips)
R+KjpH/wSjDLhtIy9+edNA: posts small blind $0.25
BAjwVL+zKKd0s0fAWstzQQ: posts big blind $0.50
*** HOLE CARDS ***
tdOvWynovql5imfooroLMg: folds
Rt6KgtZ8YaJoTc3FPim00w: folds
ZKazl1hGaPiapDXincgi2Q: folds
R+KjpH/wSjDLhtIy9+edNA: raises $1 to $1.50
BAjwVL+zKKd0s0fAWstzQQ: calls $1
*** FLOP *** [9d 5d 8h]
R+KjpH/wSjDLhtIy9+edNA: bets $2
BAjwVL+zKKd0s0fAWstzQQ: folds
R+KjpH/wSjDLhtIy9+edNA collected $2.85 from pot
R+KjpH/wSjDLhtIy9+edNA: doesn't show hand
*** SUMMARY ***
Total pot $3 | Rake $0.15
Board [9d 5d 8h]
Seat 1: R+KjpH/wSjDLhtIy9+edNA (small blind) collected ($2.85)
Seat 2: BAjwVL+zKKd0s0fAWstzQQ (big blind) folded on the Flop
Seat 3: tdOvWynovql5imfooroLMg folded before Flop (didn't bet)
Seat 4: Rt6KgtZ8YaJoTc3FPim00w folded before Flop (didn't bet)
Seat 6: ZKazl1hGaPiapDXincgi2Q (button) folded before Flop (didn't bet)



PokerStars Game #59939341228:  Hold'em No Limit ($0.25/$0.50) - 2009/07/01 0:37:23 ET
Table 'BCN5su+SsXiy1zRMJi0SJw' 6-max Seat #1 is the button
Seat 1: crjGpJEzSZgD38FoE3VMGg ($50 in chips)
Seat 2: oU2kDCkT/gilYbHWrg7D8w ($21.80 in chips)
Seat 3: g+vwI6lMKpU2uteXSjOzVw ($20 in chips)
Seat 4: JY9CtoZTeav+mhWyxSSyJQ ($15.15 in chips)
Seat 5: IBNygaT1aa9Z1uPdJJilwA ($66.25 in chips)
Seat 6: b2symlOdL7+0c9Pj4N/KlA ($50 in chips)
oU2kDCkT/gilYbHWrg7D8w: posts small blind $0.25
g+vwI6lMKpU2uteXSjOzVw: posts big blind $0.50
*** HOLE CARDS ***
JY9CtoZTeav+mhWyxSSyJQ: folds
IBNygaT1aa9Z1uPdJJilwA: folds
b2symlOdL7+0c9Pj4N/KlA: folds
crjGpJEzSZgD38FoE3VMGg: folds
oU2kDCkT/gilYbHWrg7D8w: raises $1 to $1.50
g+vwI6lMKpU2uteXSjOzVw: calls $1
*** FLOP *** [6d 4d 2s]
oU2kDCkT/gilYbHWrg7D8w: bets $2.50
g+vwI6lMKpU2uteXSjOzVw: folds
oU2kDCkT/gilYbHWrg7D8w collected $2.85 from pot
*** SUMMARY ***
Total pot $3 | Rake $0.15
Board [6d 4d 2s]
Seat 1: crjGpJEzSZgD38FoE3VMGg (button) folded before Flop (didn't bet)
Seat 2: oU2kDCkT/gilYbHWrg7D8w (small blind) collected ($2.85)
Seat 3: g+vwI6lMKpU2uteXSjOzVw (big blind) folded on the Flop
Seat 4: JY9CtoZTeav+mhWyxSSyJQ folded before Flop (didn't bet)
Seat 5: IBNygaT1aa9Z1uPdJJilwA folded before Flop (didn't bet)
Seat 6: b2symlOdL7+0c9Pj4N/KlA folded before Flop (didn't bet)



PokerStars Game #59939341484:  Hold'em No Limit ($0.25/$0.50) - 2009/07/01 0:37:23 ET
Table 'mTxf8gPLgffN3Iwfm7Icfg' 2-max Seat #2 is the button
Seat 1: Do9Rlu1R5u/AcRtMTl8SYg ($61.45 in chips)
Seat 2: EMc5LPgVaded4Qc77vm0fw ($96 in chips)
EMc5LPgVaded4Qc77vm0fw: posts small blind $0.25
Do9Rlu1R5u/AcRtMTl8SYg: posts big blind $0.50
*** HOLE CARDS ***
EMc5LPgVaded4Qc77vm0fw: folds
Do9Rlu1R5u/AcRtMTl8SYg collected $0.50 from pot
*** SUMMARY ***
Total pot $0.50 | Rake $0
Seat 1: Do9Rlu1R5u/AcRtMTl8SYg (big blind) collected ($0.50)
Seat 2: EMc5LPgVaded4Qc77vm0fw (button) (small blind) folded before Flop



PokerStars Game #59939342206:  Hold'em No Limit ($0.25/$0.50) - 2009/07/01 0:37:24 ET
Table 'IeNZOZQ4T6oiaHqFeo6yIA' 2-max Seat #1 is the button
Seat 1: ndd1nfncBkWNitBnsfCoVQ ($55.65 in chips)
Seat 2: A91IUl5JaZROhtfCtnnwYw ($72.20 in chips)
ndd1nfncBkWNitBnsfCoVQ: posts small blind $0.25
A91IUl5JaZROhtfCtnnwYw: posts big blind $0.50
*** HOLE CARDS ***
ndd1nfncBkWNitBnsfCoVQ: raises $1 to $1.50
A91IUl5JaZROhtfCtnnwYw: raises $1 to $2.50
ndd1nfncBkWNitBnsfCoVQ: calls $1
*** FLOP *** [5d 6d 4s]
A91IUl5JaZROhtfCtnnwYw: checks
ndd1nfncBkWNitBnsfCoVQ: bets $4
A91IUl5JaZROhtfCtnnwYw: calls $4
*** TURN *** [5d 6d 4s] [5c]
A91IUl5JaZROhtfCtnnwYw: checks
ndd1nfncBkWNitBnsfCoVQ: bets $8
A91IUl5JaZROhtfCtnnwYw: raises $8 to $16
ndd1nfncBkWNitBnsfCoVQ: calls $8
*** RIVER *** [5d 6d 4s 5c] [Jh]
A91IUl5JaZROhtfCtnnwYw: checks
ndd1nfncBkWNitBnsfCoVQ: checks
*** SHOW DOWN ***
A91IUl5JaZROhtfCtnnwYw: shows [3s 2h] (a straight, Deuce to Six)
ndd1nfncBkWNitBnsfCoVQ: mucks hand
A91IUl5JaZROhtfCtnnwYw collected $44.50 from pot
*** SUMMARY ***
Total pot $45 | Rake $0.50
Board [5d 6d 4s 5c Jh]
Seat 1: ndd1nfncBkWNitBnsfCoVQ (button) (small blind) mucked
Seat 2: A91IUl5JaZROhtfCtnnwYw (big blind) showed [3s 2h] and won ($44.50) with a straight, Deuce to Six



PokerStars Game #59939341644:  Hold'em No Limit ($0.25/$0.50) - 2009/07/01 0:37:24 ET
Table '+111aLuBwnz8YVYSA7J1jA' 2-max Seat #1 is the button
Seat 1: ndd1nfncBkWNitBnsfCoVQ ($88.85 in chips)
Seat 2: +ciXH35zeafrjg1W6wiBTg ($59.35 in chips)
ndd1nfncBkWNitBnsfCoVQ: posts small blind $0.25
+ciXH35zeafrjg1W6wiBTg: posts big blind $0.50
*** HOLE CARDS ***
ndd1nfncBkWNitBnsfCoVQ: raises $1 to $1.50
+ciXH35zeafrjg1W6wiBTg: calls $1
*** FLOP *** [Th Qc 7h]
+ciXH35zeafrjg1W6wiBTg: checks
ndd1nfncBkWNitBnsfCoVQ: bets $2
+ciXH35zeafrjg1W6wiBTg: folds
ndd1nfncBkWNitBnsfCoVQ collected $2.85 from pot
ndd1nfncBkWNitBnsfCoVQ: doesn't show hand
*** SUMMARY ***
Total pot $3 | Rake $0.15
Board [Th Qc 7h]
Seat 1: ndd1nfncBkWNitBnsfCoVQ (button) (small blind) collected ($2.85)
Seat 2: +ciXH35zeafrjg1W6wiBTg (big blind) folded on the Flop



PokerStars Game #59939341650:  Hold'em No Limit ($0.25/$0.50) - 2009/07/01 0:37:24 ET
Table '37qXEp3oe+er5q4CZip9eQ' 6-max Seat #5 is the button
Seat 1: oqOqoO2AyCZenUghCxMDxw ($53 in chips)
Seat 2: 6wzJiRvp8HY6t+MQGnSIzA ($28.60 in chips)
Seat 3: Rt6KgtZ8YaJoTc3FPim00w ($77.75 in chips)
Seat 4: XsmE8nXMAAMFJbWaJTmHFw ($24.90 in chips)
Seat 5: VOmI0x4dDPnTESZd5B4d1Q ($49.40 in chips)
Seat 6: N50kln4negd8q7Mmoz1j4g ($24.50 in chips)
N50kln4negd8q7Mmoz1j4g: posts small blind $0.25
oqOqoO2AyCZenUghCxMDxw: posts big blind $0.50
*** HOLE CARDS ***
6wzJiRvp8HY6t+MQGnSIzA: calls $0.50
Rt6KgtZ8YaJoTc3FPim00w: folds
XsmE8nXMAAMFJbWaJTmHFw: raises $1 to $1.50
VOmI0x4dDPnTESZd5B4d1Q: folds
N50kln4negd8q7Mmoz1j4g: folds
oqOqoO2AyCZenUghCxMDxw: folds
6wzJiRvp8HY6t+MQGnSIzA: calls $1
*** FLOP *** [Jh Tc 4h]
6wzJiRvp8HY6t+MQGnSIzA: checks
XsmE8nXMAAMFJbWaJTmHFw: checks
*** TURN *** [Jh Tc 4h] [4c]
6wzJiRvp8HY6t+MQGnSIzA: bets $1.50
XsmE8nXMAAMFJbWaJTmHFw: calls $1.50
*** RIVER *** [Jh Tc 4h 4c] [Jd]
6wzJiRvp8HY6t+MQGnSIzA: checks
XsmE8nXMAAMFJbWaJTmHFw: checks
*** SHOW DOWN ***
6wzJiRvp8HY6t+MQGnSIzA: shows [Kh 8d] (two pair, Jacks and Fours)
XsmE8nXMAAMFJbWaJTmHFw: shows [Ac Qc] (two pair, Jacks and Fours - Ace kicker)
XsmE8nXMAAMFJbWaJTmHFw collected $6.45 from pot
*** SUMMARY ***
Total pot $6.75 | Rake $0.30
Board [Jh Tc 4h 4c Jd]
Seat 1: oqOqoO2AyCZenUghCxMDxw (big blind) folded before Flop
Seat 2: 6wzJiRvp8HY6t+MQGnSIzA showed [Kh 8d] and lost with two pair, Jacks and Fours
Seat 3: Rt6KgtZ8YaJoTc3FPim00w folded before Flop (didn't bet)
Seat 4: XsmE8nXMAAMFJbWaJTmHFw showed [Ac Qc] and won ($6.45) with two pair, Jacks and Fours
Seat 5: VOmI0x4dDPnTESZd5B4d1Q (button) folded before Flop (didn't bet)
Seat 6: N50kln4negd8q7Mmoz1j4g (small blind) folded before Flop



PokerStars Game #59939342002:  Hold'em No Limit ($0.25/$0.50) - 2009/07/01 0:37:24 ET
Table 'EiNh8p/wGJ1FP575iMFnqg' 9-max Seat #5 is the button
Seat 1: r3ZqM1Mi0W3y4hOdssE+Sg ($50.15 in chips)
Seat 2: 8ehL7qlZzjgUh2H35iiWLw ($51.25 in chips)
Seat 3: ymLPoEIl7UL3TvZYmnadxQ ($49.85 in chips)
Seat 5: M+7+BTmX5vZatHVuoRB1nA ($84.60 in chips)
Seat 6: 3UmXLy3GfjC3EkOebduerQ ($54.15 in chips)
Seat 7: 997ViqAtWn1FPjJqcffwcA ($50 in chips)
Seat 8: KrPAGRACBg+w0M//SXe8Ag ($10.90 in chips)
Seat 9: OMwFJ4pF0xk2Ru/AJiFeFw ($101 in chips)
3UmXLy3GfjC3EkOebduerQ: posts small blind $0.25
997ViqAtWn1FPjJqcffwcA: posts big blind $0.50
Lacher64: sits out
*** HOLE CARDS ***
KrPAGRACBg+w0M//SXe8Ag: folds
OMwFJ4pF0xk2Ru/AJiFeFw: folds
r3ZqM1Mi0W3y4hOdssE+Sg: folds
8ehL7qlZzjgUh2H35iiWLw: folds
ymLPoEIl7UL3TvZYmnadxQ: folds
M+7+BTmX5vZatHVuoRB1nA: raises $1.50 to $2
3UmXLy3GfjC3EkOebduerQ: folds
997ViqAtWn1FPjJqcffwcA: folds
M+7+BTmX5vZatHVuoRB1nA collected $1.25 from pot
M+7+BTmX5vZatHVuoRB1nA: doesn't show hand
*** SUMMARY ***
Total pot $1.25 | Rake $0
Seat 1: r3ZqM1Mi0W3y4hOdssE+Sg folded before Flop (didn't bet)
Seat 2: 8ehL7qlZzjgUh2H35iiWLw folded before Flop (didn't bet)
Seat 3: ymLPoEIl7UL3TvZYmnadxQ folded before Flop (didn't bet)
Seat 5: M+7+BTmX5vZatHVuoRB1nA (button) collected ($1.25)
Seat 6: 3UmXLy3GfjC3EkOebduerQ (small blind) folded before Flop
Seat 7: 997ViqAtWn1FPjJqcffwcA (big blind) folded before Flop
Seat 8: KrPAGRACBg+w0M//SXe8Ag folded before Flop (didn't bet)
Seat 9: OMwFJ4pF0xk2Ru/AJiFeFw folded before Flop (didn't bet)



PokerStars Game #59939343506:  Hold'em No Limit ($0.25/$0.50) - 2009/07/01 0:37:26 ET
Table 'hWT2kq66tnKEpD26cia6fQ' 2-max Seat #2 is the button
Seat 1: q+vRKwm51mnr6kxX/161WQ ($32.75 in chips)
Seat 2: dkC7J+qbyqk0qCcmJbEPPw ($64.85 in chips)
dkC7J+qbyqk0qCcmJbEPPw: posts small blind $0.25
q+vRKwm51mnr6kxX/161WQ: posts big blind $0.50
*** HOLE CARDS ***
dkC7J+qbyqk0qCcmJbEPPw: raises $1 to $1.50
q+vRKwm51mnr6kxX/161WQ: folds
dkC7J+qbyqk0qCcmJbEPPw collected $1 from pot
*** SUMMARY ***
Total pot $1 | Rake $0
Seat 1: q+vRKwm51mnr6kxX/161WQ (big blind) folded before Flop
Seat 2: dkC7J+qbyqk0qCcmJbEPPw (button) (small blind) collected ($1)



PokerStars Game #59939344068:  Hold'em No Limit ($0.25/$0.50) - 2009/07/01 0:37:27 ET
Table 'E7bWJ45aoFXRpyRv2gw+Ig' 2-max Seat #2 is the button
Seat 1: FRkiRasEGlHUeLrEl+k/nA ($50.35 in chips)
Seat 2: 3Wro85I7472vJ4Wkpneo9A ($144.45 in chips)
3Wro85I7472vJ4Wkpneo9A: posts small blind $0.25
FRkiRasEGlHUeLrEl+k/nA: posts big blind $0.50
*** HOLE CARDS ***
3Wro85I7472vJ4Wkpneo9A: calls $0.25
FRkiRasEGlHUeLrEl+k/nA: checks
*** FLOP *** [2s 2h Qh]
FRkiRasEGlHUeLrEl+k/nA: checks
3Wro85I7472vJ4Wkpneo9A: bets $1
FRkiRasEGlHUeLrEl+k/nA: folds
3Wro85I7472vJ4Wkpneo9A collected $0.95 from pot
3Wro85I7472vJ4Wkpneo9A: doesn't show hand
*** SUMMARY ***
Total pot $1 | Rake $0.05
Board [2s 2h Qh]
Seat 1: FRkiRasEGlHUeLrEl+k/nA (big blind) folded on the Flop
Seat 2: 3Wro85I7472vJ4Wkpneo9A (button) (small blind) collected ($0.95)



PokerStars Game #59939345230:  Hold'em No Limit ($0.25/$0.50) - 2009/07/01 0:37:29 ET
Table 'mTxf8gPLgffN3Iwfm7Icfg' 2-max Seat #1 is the button
Seat 1: Do9Rlu1R5u/AcRtMTl8SYg ($61.70 in chips)
Seat 2: EMc5LPgVaded4Qc77vm0fw ($95.75 in chips)
Do9Rlu1R5u/AcRtMTl8SYg: posts small blind $0.25
EMc5LPgVaded4Qc77vm0fw: posts big blind $0.50
*** HOLE CARDS ***
Do9Rlu1R5u/AcRtMTl8SYg: raises $1 to $1.50
EMc5LPgVaded4Qc77vm0fw: folds
Do9Rlu1R5u/AcRtMTl8SYg collected $1 from pot
Do9Rlu1R5u/AcRtMTl8SYg: doesn't show hand
*** SUMMARY ***
Total pot $1 | Rake $0
Seat 1: Do9Rlu1R5u/AcRtMTl8SYg (button) (small blind) collected ($1)
Seat 2: EMc5LPgVaded4Qc77vm0fw (big blind) folded before Flop



PokerStars Game #59939344930:  Hold'em No Limit ($0.25/$0.50) - 2009/07/01 0:37:29 ET
Table 'c/CRn+68J3Y8KxD5g1ek2Q' 2-max Seat #2 is the button
Seat 1: 46qCyJ6evTkHo9al5sBMNA ($235.45 in chips)
Seat 2: BypVLsYQt3ePFm2xQL/dOA ($140.85 in chips)
BypVLsYQt3ePFm2xQL/dOA: posts small blind $0.25
46qCyJ6evTkHo9al5sBMNA: posts big blind $0.50
*** HOLE CARDS ***
BypVLsYQt3ePFm2xQL/dOA: raises $2 to $2.50
46qCyJ6evTkHo9al5sBMNA: folds
BypVLsYQt3ePFm2xQL/dOA collected $1 from pot
BypVLsYQt3ePFm2xQL/dOA: doesn't show hand
*** SUMMARY ***
Total pot $1 | Rake $0
Seat 1: 46qCyJ6evTkHo9al5sBMNA (big blind) folded before Flop
Seat 2: BypVLsYQt3ePFm2xQL/dOA (button) (small blind) collected ($1)



PokerStars Game #59939349348:  Hold'em No Limit ($0.25/$0.50) - 2009/07/01 0:37:36 ET
Table '+dXkOAQyS8j9PQZusUTMpg' 2-max Seat #2 is the button
Seat 1: XFa6sBGjP2gxoIvxR3fZIg ($48.75 in chips)
Seat 2: 5IBeOgaApY1Bvzv2P8X4EA ($142.65 in chips)
5IBeOgaApY1Bvzv2P8X4EA: posts small blind $0.25
XFa6sBGjP2gxoIvxR3fZIg: posts big blind $0.50
*** HOLE CARDS ***
5IBeOgaApY1Bvzv2P8X4EA said, ":D"
5IBeOgaApY1Bvzv2P8X4EA: raises $1 to $1.50
XFa6sBGjP2gxoIvxR3fZIg: folds
5IBeOgaApY1Bvzv2P8X4EA collected $1 from pot
5IBeOgaApY1Bvzv2P8X4EA: doesn't show hand
*** SUMMARY ***
Total pot $1 | Rake $0
Seat 1: XFa6sBGjP2gxoIvxR3fZIg (big blind) folded before Flop
Seat 2: 5IBeOgaApY1Bvzv2P8X4EA (button) (small blind) collected ($1)



PokerStars Game #59939350834:  Hold'em No Limit ($0.25/$0.50) - 2009/07/01 0:37:38 ET
Table 'hWT2kq66tnKEpD26cia6fQ' 2-max Seat #1 is the button
Seat 1: q+vRKwm51mnr6kxX/161WQ ($50 in chips)
Seat 2: dkC7J+qbyqk0qCcmJbEPPw ($65.35 in chips)
q+vRKwm51mnr6kxX/161WQ: posts small blind $0.25
dkC7J+qbyqk0qCcmJbEPPw: posts big blind $0.50
*** HOLE CARDS ***
q+vRKwm51mnr6kxX/161WQ: folds
dkC7J+qbyqk0qCcmJbEPPw collected $0.50 from pot
*** SUMMARY ***
Total pot $0.50 | Rake $0
Seat 1: q+vRKwm51mnr6kxX/161WQ (button) (small blind) folded before Flop
Seat 2: dkC7J+qbyqk0qCcmJbEPPw (big blind) collected ($0.50)



PokerStars Game #59939350716:  Hold'em No Limit ($0.25/$0.50) - 2009/07/01 0:37:38 ET
Table 'c/CRn+68J3Y8KxD5g1ek2Q' 2-max Seat #1 is the button
Seat 1: 46qCyJ6evTkHo9al5sBMNA ($234.95 in chips)
Seat 2: BypVLsYQt3ePFm2xQL/dOA ($141.35 in chips)
46qCyJ6evTkHo9al5sBMNA: posts small blind $0.25
BypVLsYQt3ePFm2xQL/dOA: posts big blind $0.50
*** HOLE CARDS ***
46qCyJ6evTkHo9al5sBMNA: raises $1 to $1.50
BypVLsYQt3ePFm2xQL/dOA: calls $1
*** FLOP *** [Kd 3s 4s]
BypVLsYQt3ePFm2xQL/dOA: checks
46qCyJ6evTkHo9al5sBMNA: bets $2
BypVLsYQt3ePFm2xQL/dOA: calls $2
*** TURN *** [Kd 3s 4s] [6c]
BypVLsYQt3ePFm2xQL/dOA: checks
46qCyJ6evTkHo9al5sBMNA: bets $4
BypVLsYQt3ePFm2xQL/dOA: calls $4
*** RIVER *** [Kd 3s 4s 6c] [9h]
BypVLsYQt3ePFm2xQL/dOA: checks
46qCyJ6evTkHo9al5sBMNA: bets $7
BypVLsYQt3ePFm2xQL/dOA: folds
46qCyJ6evTkHo9al5sBMNA collected $14.50 from pot
46qCyJ6evTkHo9al5sBMNA: doesn't show hand
*** SUMMARY ***
Total pot $15 | Rake $0.50
Board [Kd 3s 4s 6c 9h]
Seat 1: 46qCyJ6evTkHo9al5sBMNA (button) (small blind) collected ($14.50)
Seat 2: BypVLsYQt3ePFm2xQL/dOA (big blind) folded on the River



PokerStars Game #59939352306:  Hold'em No Limit ($0.25/$0.50) - 2009/07/01 0:37:40 ET
Table 'mTxf8gPLgffN3Iwfm7Icfg' 2-max Seat #2 is the button
Seat 1: Do9Rlu1R5u/AcRtMTl8SYg ($62.20 in chips)
Seat 2: EMc5LPgVaded4Qc77vm0fw ($95.25 in chips)
EMc5LPgVaded4Qc77vm0fw: posts small blind $0.25
Do9Rlu1R5u/AcRtMTl8SYg: posts big blind $0.50
*** HOLE CARDS ***
EMc5LPgVaded4Qc77vm0fw: folds
Do9Rlu1R5u/AcRtMTl8SYg collected $0.50 from pot
Do9Rlu1R5u/AcRtMTl8SYg: doesn't show hand
*** SUMMARY ***
Total pot $0.50 | Rake $0
Seat 1: Do9Rlu1R5u/AcRtMTl8SYg (big blind) collected ($0.50)
Seat 2: EMc5LPgVaded4Qc77vm0fw (button) (small blind) folded before Flop



PokerStars Game #59939352348:  Hold'em No Limit ($0.25/$0.50) - 2009/07/01 0:37:40 ET
Table '3FhG0gl3kMX3wBEEqj+wnQ' 9-max Seat #5 is the button
Seat 1: e0J9pdCNUDTCG031RnXqLA ($17.75 in chips)
Seat 2: 7cYQ+syUWjl38ty/ICOMhw ($50.40 in chips)
Seat 3: HZkVla4kK2SI42CVrPZ/ig ($15.95 in chips)
Seat 4: bjvJtA9Hqscfznq66txaOQ ($9.25 in chips)
Seat 5: gsyXT42WLEcOS4DdEk2wlw ($29.25 in chips)
Seat 7: mSD1pginDsyHG5PDfqzphw ($10 in chips)
Seat 8: j3K/Jujr7PY4ZM2RZvlH6A ($58.05 in chips)
Seat 9: L5e2lrPLQm1Pqx30IIZ/Fw ($10.10 in chips)
mSD1pginDsyHG5PDfqzphw: posts small blind $0.25
j3K/Jujr7PY4ZM2RZvlH6A: posts big blind $0.50
*** HOLE CARDS ***
L5e2lrPLQm1Pqx30IIZ/Fw: folds
e0J9pdCNUDTCG031RnXqLA: raises $1 to $1.50
7cYQ+syUWjl38ty/ICOMhw: folds
997ViqAtWn1FPjJqcffwcA joins the table at seat #6
HZkVla4kK2SI42CVrPZ/ig: folds
bjvJtA9Hqscfznq66txaOQ: folds
gsyXT42WLEcOS4DdEk2wlw: folds
mSD1pginDsyHG5PDfqzphw: folds
j3K/Jujr7PY4ZM2RZvlH6A: calls $1
*** FLOP *** [3h Jd 5d]
j3K/Jujr7PY4ZM2RZvlH6A: bets $2
e0J9pdCNUDTCG031RnXqLA: raises $5 to $7
j3K/Jujr7PY4ZM2RZvlH6A: folds
e0J9pdCNUDTCG031RnXqLA collected $6.90 from pot
e0J9pdCNUDTCG031RnXqLA: doesn't show hand
*** SUMMARY ***
Total pot $7.25 | Rake $0.35
Board [3h Jd 5d]
Seat 1: e0J9pdCNUDTCG031RnXqLA collected ($6.90)
Seat 2: 7cYQ+syUWjl38ty/ICOMhw folded before Flop (didn't bet)
Seat 3: HZkVla4kK2SI42CVrPZ/ig folded before Flop (didn't bet)
Seat 4: bjvJtA9Hqscfznq66txaOQ folded before Flop (didn't bet)
Seat 5: gsyXT42WLEcOS4DdEk2wlw (button) folded before Flop (didn't bet)
Seat 7: mSD1pginDsyHG5PDfqzphw (small blind) folded before Flop
Seat 8: j3K/Jujr7PY4ZM2RZvlH6A (big blind) folded on the Flop
Seat 9: L5e2lrPLQm1Pqx30IIZ/Fw folded before Flop (didn't bet)



PokerStars Game #59939352950:  Hold'em No Limit ($0.25/$0.50) - 2009/07/01 0:37:41 ET
Table 'MJxeZCzYELxiIsyUZyT0jw' 6-max Seat #3 is the button
Seat 1: tdOvWynovql5imfooroLMg ($50 in chips)
Seat 2: dB6jzDlJmET84VMWw1mTRA ($50 in chips)
Seat 3: JQZew0FjzS19kTjeNtrE+A ($50.90 in chips)
Seat 4: lP7Q6pewz4C2RsAfKsjdWw ($34.90 in chips)
Seat 5: 3jvoOXNtXE90w2BdfNZwZQ ($50 in chips)
Seat 6: TTx3CHxyi0SObcHyMJRp5w ($61.70 in chips)
lP7Q6pewz4C2RsAfKsjdWw: posts small blind $0.25
3jvoOXNtXE90w2BdfNZwZQ: posts big blind $0.50
*** HOLE CARDS ***
TTx3CHxyi0SObcHyMJRp5w: calls $0.50
tdOvWynovql5imfooroLMg: folds
dB6jzDlJmET84VMWw1mTRA: folds
JQZew0FjzS19kTjeNtrE+A: calls $0.50
lP7Q6pewz4C2RsAfKsjdWw: calls $0.25
3jvoOXNtXE90w2BdfNZwZQ: checks
*** FLOP *** [Js Jh Ts]
lP7Q6pewz4C2RsAfKsjdWw: checks
3jvoOXNtXE90w2BdfNZwZQ: checks
TTx3CHxyi0SObcHyMJRp5w: checks
JQZew0FjzS19kTjeNtrE+A: bets $1.50
lP7Q6pewz4C2RsAfKsjdWw: folds
3jvoOXNtXE90w2BdfNZwZQ: folds
TTx3CHxyi0SObcHyMJRp5w: folds
JQZew0FjzS19kTjeNtrE+A collected $1.90 from pot
*** SUMMARY ***
Total pot $2 | Rake $0.10
Board [Js Jh Ts]
Seat 1: tdOvWynovql5imfooroLMg folded before Flop (didn't bet)
Seat 2: dB6jzDlJmET84VMWw1mTRA folded before Flop (didn't bet)
Seat 3: JQZew0FjzS19kTjeNtrE+A (button) collected ($1.90)
Seat 4: lP7Q6pewz4C2RsAfKsjdWw (small blind) folded on the Flop
Seat 5: 3jvoOXNtXE90w2BdfNZwZQ (big blind) folded on the Flop
Seat 6: TTx3CHxyi0SObcHyMJRp5w folded on the Flop



PokerStars Game #59939353594:  Hold'em No Limit ($0.25/$0.50) - 2009/07/01 0:37:42 ET
Table '+111aLuBwnz8YVYSA7J1jA' 2-max Seat #2 is the button
Seat 1: ndd1nfncBkWNitBnsfCoVQ ($90.20 in chips)
Seat 2: +ciXH35zeafrjg1W6wiBTg ($57.85 in chips)
+ciXH35zeafrjg1W6wiBTg: posts small blind $0.25
ndd1nfncBkWNitBnsfCoVQ: posts big blind $0.50
*** HOLE CARDS ***
+ciXH35zeafrjg1W6wiBTg: calls $0.25
ndd1nfncBkWNitBnsfCoVQ: raises $1.50 to $2
+ciXH35zeafrjg1W6wiBTg: calls $1.50
*** FLOP *** [9h Kh Ad]
ndd1nfncBkWNitBnsfCoVQ: checks
+ciXH35zeafrjg1W6wiBTg: checks
*** TURN *** [9h Kh Ad] [8h]
ndd1nfncBkWNitBnsfCoVQ: checks
+ciXH35zeafrjg1W6wiBTg: bets $1.50
ndd1nfncBkWNitBnsfCoVQ: calls $1.50
*** RIVER *** [9h Kh Ad 8h] [7s]
ndd1nfncBkWNitBnsfCoVQ: checks
+ciXH35zeafrjg1W6wiBTg: checks
*** SHOW DOWN ***
ndd1nfncBkWNitBnsfCoVQ: shows [Ts Ks] (a pair of Kings)
+ciXH35zeafrjg1W6wiBTg: mucks hand
ndd1nfncBkWNitBnsfCoVQ collected $6.70 from pot
*** SUMMARY ***
Total pot $7 | Rake $0.30
Board [9h Kh Ad 8h 7s]
Seat 1: ndd1nfncBkWNitBnsfCoVQ (big blind) showed [Ts Ks] and won ($6.70) with a pair of Kings
Seat 2: +ciXH35zeafrjg1W6wiBTg (button) (small blind) mucked



PokerStars Game #59939353528:  Hold'em No Limit ($0.25/$0.50) - 2009/07/01 0:37:42 ET
Table 'tyR5AZNKV8Aadbrnrnlg7g' 6-max Seat #1 is the button
Seat 1: R+KjpH/wSjDLhtIy9+edNA ($85.25 in chips)
Seat 2: BAjwVL+zKKd0s0fAWstzQQ ($24.85 in chips)
Seat 3: tdOvWynovql5imfooroLMg ($50 in chips)
Seat 4: Rt6KgtZ8YaJoTc3FPim00w ($82.45 in chips)
Seat 6: ZKazl1hGaPiapDXincgi2Q ($17.65 in chips)
BAjwVL+zKKd0s0fAWstzQQ: posts small blind $0.25
tdOvWynovql5imfooroLMg: posts big blind $0.50
*** HOLE CARDS ***
Rt6KgtZ8YaJoTc3FPim00w: folds
ZKazl1hGaPiapDXincgi2Q: calls $0.50
R+KjpH/wSjDLhtIy9+edNA: raises $1.50 to $2
BAjwVL+zKKd0s0fAWstzQQ: folds
tdOvWynovql5imfooroLMg: calls $1.50
ZKazl1hGaPiapDXincgi2Q: calls $1.50
*** FLOP *** [Ad 3d 8s]
tdOvWynovql5imfooroLMg: checks
ZKazl1hGaPiapDXincgi2Q: checks
R+KjpH/wSjDLhtIy9+edNA: bets $3
tdOvWynovql5imfooroLMg: folds
ZKazl1hGaPiapDXincgi2Q: folds
R+KjpH/wSjDLhtIy9+edNA collected $5.95 from pot
R+KjpH/wSjDLhtIy9+edNA: doesn't show hand
*** SUMMARY ***
Total pot $6.25 | Rake $0.30
Board [Ad 3d 8s]
Seat 1: R+KjpH/wSjDLhtIy9+edNA (button) collected ($5.95)
Seat 2: BAjwVL+zKKd0s0fAWstzQQ (small blind) folded before Flop
Seat 3: tdOvWynovql5imfooroLMg (big blind) folded on the Flop
Seat 4: Rt6KgtZ8YaJoTc3FPim00w folded before Flop (didn't bet)
Seat 6: ZKazl1hGaPiapDXincgi2Q folded on the Flop



PokerStars Game #59939354934:  Hold'em No Limit ($0.25/$0.50) - 2009/07/01 0:37:44 ET
Table 'hWT2kq66tnKEpD26cia6fQ' 2-max Seat #2 is the button
Seat 1: q+vRKwm51mnr6kxX/161WQ ($49.75 in chips)
Seat 2: dkC7J+qbyqk0qCcmJbEPPw ($65.60 in chips)
dkC7J+qbyqk0qCcmJbEPPw: posts small blind $0.25
q+vRKwm51mnr6kxX/161WQ: posts big blind $0.50
*** HOLE CARDS ***
dkC7J+qbyqk0qCcmJbEPPw: raises $1 to $1.50
q+vRKwm51mnr6kxX/161WQ: raises $3 to $4.50
dkC7J+qbyqk0qCcmJbEPPw: calls $3
*** FLOP *** [4s 7s Jc]
q+vRKwm51mnr6kxX/161WQ: checks
dkC7J+qbyqk0qCcmJbEPPw: checks
*** TURN *** [4s 7s Jc] [9s]
q+vRKwm51mnr6kxX/161WQ: checks
dkC7J+qbyqk0qCcmJbEPPw: checks
*** RIVER *** [4s 7s Jc 9s] [5c]
q+vRKwm51mnr6kxX/161WQ: bets $4.50
dkC7J+qbyqk0qCcmJbEPPw: folds
q+vRKwm51mnr6kxX/161WQ collected $8.55 from pot
q+vRKwm51mnr6kxX/161WQ: doesn't show hand
*** SUMMARY ***
Total pot $9 | Rake $0.45
Board [4s 7s Jc 9s 5c]
Seat 1: q+vRKwm51mnr6kxX/161WQ (big blind) collected ($8.55)
Seat 2: dkC7J+qbyqk0qCcmJbEPPw (button) (small blind) folded on the River



PokerStars Game #59939355588:  Hold'em No Limit ($0.25/$0.50) - 2009/07/01 0:37:45 ET
Table '+dXkOAQyS8j9PQZusUTMpg' 2-max Seat #1 is the button
Seat 1: XFa6sBGjP2gxoIvxR3fZIg ($48.25 in chips)
Seat 2: 5IBeOgaApY1Bvzv2P8X4EA ($143.15 in chips)
XFa6sBGjP2gxoIvxR3fZIg: posts small blind $0.25
5IBeOgaApY1Bvzv2P8X4EA: posts big blind $0.50
*** HOLE CARDS ***
XFa6sBGjP2gxoIvxR3fZIg: raises $1 to $1.50
5IBeOgaApY1Bvzv2P8X4EA: folds
XFa6sBGjP2gxoIvxR3fZIg collected $1 from pot
*** SUMMARY ***
Total pot $1 | Rake $0
Seat 1: XFa6sBGjP2gxoIvxR3fZIg (button) (small blind) collected ($1)
Seat 2: 5IBeOgaApY1Bvzv2P8X4EA (big blind) folded before Flop



PokerStars Game #59939355914:  Hold'em No Limit ($0.25/$0.50) - 2009/07/01 0:37:46 ET
Table 'mTxf8gPLgffN3Iwfm7Icfg' 2-max Seat #1 is the button
Seat 1: Do9Rlu1R5u/AcRtMTl8SYg ($62.45 in chips)
Seat 2: EMc5LPgVaded4Qc77vm0fw ($95 in chips)
Do9Rlu1R5u/AcRtMTl8SYg: posts small blind $0.25
EMc5LPgVaded4Qc77vm0fw: posts big blind $0.50
*** HOLE CARDS ***
Do9Rlu1R5u/AcRtMTl8SYg: folds
EMc5LPgVaded4Qc77vm0fw collected $0.50 from pot
EMc5LPgVaded4Qc77vm0fw: doesn't show hand
*** SUMMARY ***
Total pot $0.50 | Rake $0
Seat 1: Do9Rlu1R5u/AcRtMTl8SYg (button) (small blind) folded before Flop
Seat 2: EMc5LPgVaded4Qc77vm0fw (big blind) collected ($0.50)



PokerStars Game #59939357248:  Hold'em No Limit ($0.25/$0.50) - 2009/07/01 0:37:48 ET
Table 'E7bWJ45aoFXRpyRv2gw+Ig' 2-max Seat #1 is the button
Seat 1: FRkiRasEGlHUeLrEl+k/nA ($50 in chips)
Seat 2: 3Wro85I7472vJ4Wkpneo9A ($144.90 in chips)
FRkiRasEGlHUeLrEl+k/nA: posts small blind $0.25
3Wro85I7472vJ4Wkpneo9A: posts big blind $0.50
*** HOLE CARDS ***
FRkiRasEGlHUeLrEl+k/nA: folds
3Wro85I7472vJ4Wkpneo9A collected $0.50 from pot
3Wro85I7472vJ4Wkpneo9A: doesn't show hand
*** SUMMARY ***
Total pot $0.50 | Rake $0
Seat 1: FRkiRasEGlHUeLrEl+k/nA (button) (small blind) folded before Flop
Seat 2: 3Wro85I7472vJ4Wkpneo9A (big blind) collected ($0.50)



PokerStars Game #59939357616:  Hold'em No Limit ($0.25/$0.50) - 2009/07/01 0:37:48 ET
Table 'lSisgp6H7Fg1hH5VfjEjYQ' 9-max Seat #3 is the button
Seat 1: pEW8B6uXbdR47kfljMQ3+Q ($37.10 in chips)
Seat 2: UrcnkQOiLVk8BlKDPJSy7Q ($52.30 in chips)
Seat 3: aTkyjTh3w5YLWiIERupZOA ($41.70 in chips)
Seat 4: bwv/rbH/hHhPhY6u9mu04w ($23.25 in chips)
Seat 5: mSD1pginDsyHG5PDfqzphw ($12.10 in chips)
Seat 6: +k7T5ocke8UwavtgUHm+Cg ($28.95 in chips)
Seat 7: Y3DZ6qQlLeBhixDj4M9vmg ($10.25 in chips)
Seat 8: a4JDWmpFQkL10XfAyuF51A ($34.75 in chips)
bwv/rbH/hHhPhY6u9mu04w: posts small blind $0.25
mSD1pginDsyHG5PDfqzphw: posts big blind $0.50
gsyXT42WLEcOS4DdEk2wlw: sits out
*** HOLE CARDS ***
+k7T5ocke8UwavtgUHm+Cg: raises $1 to $1.50
Y3DZ6qQlLeBhixDj4M9vmg: calls $1.50
a4JDWmpFQkL10XfAyuF51A: folds
pEW8B6uXbdR47kfljMQ3+Q is disconnected
pEW8B6uXbdR47kfljMQ3+Q is connected
pEW8B6uXbdR47kfljMQ3+Q: folds
UrcnkQOiLVk8BlKDPJSy7Q: folds
aTkyjTh3w5YLWiIERupZOA: folds
bwv/rbH/hHhPhY6u9mu04w: folds
mSD1pginDsyHG5PDfqzphw: folds
*** FLOP *** [Qs 9s Ts]
+k7T5ocke8UwavtgUHm+Cg: bets $1
Y3DZ6qQlLeBhixDj4M9vmg: folds
+k7T5ocke8UwavtgUHm+Cg collected $3.60 from pot
+k7T5ocke8UwavtgUHm+Cg: doesn't show hand
*** SUMMARY ***
Total pot $3.75 | Rake $0.15
Board [Qs 9s Ts]
Seat 1: pEW8B6uXbdR47kfljMQ3+Q folded before Flop (didn't bet)
Seat 2: UrcnkQOiLVk8BlKDPJSy7Q folded before Flop (didn't bet)
Seat 3: aTkyjTh3w5YLWiIERupZOA (button) folded before Flop (didn't bet)
Seat 4: bwv/rbH/hHhPhY6u9mu04w (small blind) folded before Flop
Seat 5: mSD1pginDsyHG5PDfqzphw (big blind) folded before Flop
Seat 6: +k7T5ocke8UwavtgUHm+Cg collected ($3.60)
Seat 7: Y3DZ6qQlLeBhixDj4M9vmg folded on the Flop
Seat 8: a4JDWmpFQkL10XfAyuF51A folded before Flop (didn't bet)



PokerStars Game #59939357966:  Hold'em No Limit ($0.25/$0.50) - 2009/07/01 0:37:49 ET
Table 'BCN5su+SsXiy1zRMJi0SJw' 6-max Seat #2 is the button
Seat 1: crjGpJEzSZgD38FoE3VMGg ($50 in chips)
Seat 2: oU2kDCkT/gilYbHWrg7D8w ($23.15 in chips)
Seat 3: g+vwI6lMKpU2uteXSjOzVw ($18.50 in chips)
Seat 4: JY9CtoZTeav+mhWyxSSyJQ ($15.15 in chips)
Seat 5: IBNygaT1aa9Z1uPdJJilwA ($66.25 in chips)
Seat 6: b2symlOdL7+0c9Pj4N/KlA ($50 in chips)
g+vwI6lMKpU2uteXSjOzVw: posts small blind $0.25
JY9CtoZTeav+mhWyxSSyJQ: posts big blind $0.50
*** HOLE CARDS ***
IBNygaT1aa9Z1uPdJJilwA: folds
b2symlOdL7+0c9Pj4N/KlA: folds
crjGpJEzSZgD38FoE3VMGg: folds
oU2kDCkT/gilYbHWrg7D8w: calls $0.50
g+vwI6lMKpU2uteXSjOzVw: calls $0.25
JY9CtoZTeav+mhWyxSSyJQ: checks
*** FLOP *** [5c 5d Ah]
g+vwI6lMKpU2uteXSjOzVw: checks
JY9CtoZTeav+mhWyxSSyJQ: checks
oU2kDCkT/gilYbHWrg7D8w: bets $1.50
g+vwI6lMKpU2uteXSjOzVw: folds
JY9CtoZTeav+mhWyxSSyJQ: calls $1.50
*** TURN *** [5c 5d Ah] [2h]
JY9CtoZTeav+mhWyxSSyJQ: checks
oU2kDCkT/gilYbHWrg7D8w: bets $1.50
JY9CtoZTeav+mhWyxSSyJQ: calls $1.50
*** RIVER *** [5c 5d Ah 2h] [6c]
JY9CtoZTeav+mhWyxSSyJQ: checks
oU2kDCkT/gilYbHWrg7D8w: bets $2.50
JY9CtoZTeav+mhWyxSSyJQ: raises $3.50 to $6
oU2kDCkT/gilYbHWrg7D8w: calls $3.50
*** SHOW DOWN ***
JY9CtoZTeav+mhWyxSSyJQ: shows [5h Th] (three of a kind, Fives)
oU2kDCkT/gilYbHWrg7D8w: shows [5s 4s] (three of a kind, Fives - lower kicker)
JY9CtoZTeav+mhWyxSSyJQ collected $18.55 from pot
*** SUMMARY ***
Total pot $19.50 | Rake $0.95
Board [5c 5d Ah 2h 6c]
Seat 1: crjGpJEzSZgD38FoE3VMGg folded before Flop (didn't bet)
Seat 2: oU2kDCkT/gilYbHWrg7D8w (button) showed [5s 4s] and lost with three of a kind, Fives
Seat 3: g+vwI6lMKpU2uteXSjOzVw (small blind) folded on the Flop
Seat 4: JY9CtoZTeav+mhWyxSSyJQ (big blind) showed [5h Th] and won ($18.55) with three of a kind, Fives
Seat 5: IBNygaT1aa9Z1uPdJJilwA folded before Flop (didn't bet)
Seat 6: b2symlOdL7+0c9Pj4N/KlA folded before Flop (didn't bet)



PokerStars Game #59939358756:  Hold'em No Limit ($0.25/$0.50) - 2009/07/01 0:37:50 ET
Table 'T/PgNWqVyY6lkldcBVXYJQ' 6-max Seat #6 is the button
Seat 1: +Pf9jTVizYlIo+woPvptfA ($56.75 in chips)
Seat 2: LvH4G7n+QSjT6NDaD3cREA ($50 in chips)
Seat 3: L3OcNO1bgdqDI46j67KQPQ ($53.85 in chips)
Seat 4: otJMdCRvqd5YCcFsA3JWpg ($9.25 in chips)
Seat 5: vVQBckETtigfb5mAcyK0OA ($52.85 in chips)
Seat 6: cDzbog6kwmJp+LBeBq+iMQ ($41.70 in chips)
+Pf9jTVizYlIo+woPvptfA: posts small blind $0.25
LvH4G7n+QSjT6NDaD3cREA: posts big blind $0.50
*** HOLE CARDS ***
L3OcNO1bgdqDI46j67KQPQ: folds
otJMdCRvqd5YCcFsA3JWpg: raises $1 to $1.50
vVQBckETtigfb5mAcyK0OA: calls $1.50
cDzbog6kwmJp+LBeBq+iMQ: folds
+Pf9jTVizYlIo+woPvptfA: folds
LvH4G7n+QSjT6NDaD3cREA: folds
*** FLOP *** [8h Tc Js]
otJMdCRvqd5YCcFsA3JWpg: bets $7.75 and is all-in
vVQBckETtigfb5mAcyK0OA: folds
otJMdCRvqd5YCcFsA3JWpg collected $3.60 from pot
*** SUMMARY ***
Total pot $3.75 | Rake $0.15
Board [8h Tc Js]
Seat 1: +Pf9jTVizYlIo+woPvptfA (small blind) folded before Flop
Seat 2: LvH4G7n+QSjT6NDaD3cREA (big blind) folded before Flop
Seat 3: L3OcNO1bgdqDI46j67KQPQ folded before Flop (didn't bet)
Seat 4: otJMdCRvqd5YCcFsA3JWpg collected ($3.60)
Seat 5: vVQBckETtigfb5mAcyK0OA folded on the Flop
Seat 6: cDzbog6kwmJp+LBeBq+iMQ (button) folded before Flop (didn't bet)



PokerStars Game #59939359856:  Hold'em No Limit ($0.25/$0.50) - 2009/07/01 0:37:52 ET
Table 'mTxf8gPLgffN3Iwfm7Icfg' 2-max Seat #2 is the button
Seat 1: Do9Rlu1R5u/AcRtMTl8SYg ($62.20 in chips)
Seat 2: EMc5LPgVaded4Qc77vm0fw ($95.25 in chips)
EMc5LPgVaded4Qc77vm0fw: posts small blind $0.25
Do9Rlu1R5u/AcRtMTl8SYg: posts big blind $0.50
*** HOLE CARDS ***
EMc5LPgVaded4Qc77vm0fw: raises $1 to $1.50
Do9Rlu1R5u/AcRtMTl8SYg: folds
EMc5LPgVaded4Qc77vm0fw collected $1 from pot
EMc5LPgVaded4Qc77vm0fw: doesn't show hand
*** SUMMARY ***
Total pot $1 | Rake $0
Seat 1: Do9Rlu1R5u/AcRtMTl8SYg (big blind) folded before Flop
Seat 2: EMc5LPgVaded4Qc77vm0fw (button) (small blind) collected ($1)



PokerStars Game #59939360992:  Hold'em No Limit ($0.25/$0.50) - 2009/07/01 0:37:53 ET
Table '+dXkOAQyS8j9PQZusUTMpg' 2-max Seat #2 is the button
Seat 1: XFa6sBGjP2gxoIvxR3fZIg ($48.75 in chips)
Seat 2: 5IBeOgaApY1Bvzv2P8X4EA ($142.65 in chips)
5IBeOgaApY1Bvzv2P8X4EA: posts small blind $0.25
XFa6sBGjP2gxoIvxR3fZIg: posts big blind $0.50
*** HOLE CARDS ***
XFa6sBGjP2gxoIvxR3fZIg said, "IÃ¯Â¿Â½m not doing so well right now..."
5IBeOgaApY1Bvzv2P8X4EA: calls $0.25
XFa6sBGjP2gxoIvxR3fZIg: checks
*** FLOP *** [Th Jh 7h]
XFa6sBGjP2gxoIvxR3fZIg said, "need to get a grip"
XFa6sBGjP2gxoIvxR3fZIg: checks
5IBeOgaApY1Bvzv2P8X4EA: checks
*** TURN *** [Th Jh 7h] [Js]
XFa6sBGjP2gxoIvxR3fZIg: checks
5IBeOgaApY1Bvzv2P8X4EA: checks
*** RIVER *** [Th Jh 7h Js] [Kc]
XFa6sBGjP2gxoIvxR3fZIg: checks
5IBeOgaApY1Bvzv2P8X4EA: bets $1
XFa6sBGjP2gxoIvxR3fZIg: folds
5IBeOgaApY1Bvzv2P8X4EA collected $0.95 from pot
5IBeOgaApY1Bvzv2P8X4EA: doesn't show hand
*** SUMMARY ***
Total pot $1 | Rake $0.05
Board [Th Jh 7h Js Kc]
Seat 1: XFa6sBGjP2gxoIvxR3fZIg (big blind) folded on the River
Seat 2: 5IBeOgaApY1Bvzv2P8X4EA (button) (small blind) collected ($0.95)



PokerStars Game #59939361142:  Hold'em No Limit ($0.25/$0.50) - 2009/07/01 0:37:54 ET
Table 'QOgaEqMcJ73pcUMMxoisUgErOuyGLI5PT3G5MnpHgC/g Seat #6 is the button
Seat 1: L5e2lrPLQm1Pqx30IIZ/Fw ($10 in chips)
Seat 2: RjBdQ6w31rgcy0o24VLR6w ($18.95 in chips)
Seat 3: xZCXQSXlrZkp3pZizzVXCw ($50.50 in chips)
Seat 4: 3UmXLy3GfjC3EkOebduerQ ($50 in chips)
Seat 5: JwvquocWfhTVApN5t47LgA ($59.55 in chips)
Seat 6: zE9cVigS2nW/Ljy4K4bUQA ($30 in chips)
Seat 7: 90Wb75h3W1BRpbqVnuk8gw ($60.45 in chips)
Seat 8: g4k0NXISyLCqaSWZDBjfEg ($52.10 in chips)
Seat 9: J0W5D97jl5VLky+IoPvDeA ($57.15 in chips)
90Wb75h3W1BRpbqVnuk8gw: posts small blind $0.25
g4k0NXISyLCqaSWZDBjfEg: posts big blind $0.50
*** HOLE CARDS ***
J0W5D97jl5VLky+IoPvDeA: raises $1.50 to $2
L5e2lrPLQm1Pqx30IIZ/Fw: folds
RjBdQ6w31rgcy0o24VLR6w has timed out
RjBdQ6w31rgcy0o24VLR6w: folds
RjBdQ6w31rgcy0o24VLR6w is sitting out
xZCXQSXlrZkp3pZizzVXCw: folds
3UmXLy3GfjC3EkOebduerQ: folds
JwvquocWfhTVApN5t47LgA: folds
zE9cVigS2nW/Ljy4K4bUQA: folds
90Wb75h3W1BRpbqVnuk8gw: folds
g4k0NXISyLCqaSWZDBjfEg: folds
J0W5D97jl5VLky+IoPvDeA collected $1.25 from pot
*** SUMMARY ***
Total pot $1.25 | Rake $0
Seat 1: L5e2lrPLQm1Pqx30IIZ/Fw folded before Flop (didn't bet)
Seat 2: RjBdQ6w31rgcy0o24VLR6w folded before Flop (didn't bet)
Seat 3: xZCXQSXlrZkp3pZizzVXCw folded before Flop (didn't bet)
Seat 4: 3UmXLy3GfjC3EkOebduerQ folded before Flop (didn't bet)
Seat 5: JwvquocWfhTVApN5t47LgA folded before Flop (didn't bet)
Seat 6: zE9cVigS2nW/Ljy4K4bUQA (button) folded before Flop (didn't bet)
Seat 7: 90Wb75h3W1BRpbqVnuk8gw (small blind) folded before Flop
Seat 8: g4k0NXISyLCqaSWZDBjfEg (big blind) folded before Flop
Seat 9: J0W5D97jl5VLky+IoPvDeA collected ($1.25)



PokerStars Game #59939361870:  Hold'em No Limit ($0.25/$0.50) - 2009/07/01 0:37:55 ET
Table 'GfL/No5u5PoEnU39lP5pQg' 6-max Seat #4 is the button
Seat 1: 1WUCqNG+p+vfWRTXNu4ljw ($52 in chips)
Seat 2: uVwggSetzp7d+eVgowO3vg ($74.95 in chips)
Seat 4: x+pzUFJsMIiGd7a5pcR4tg ($51.60 in chips)
Seat 5: crjGpJEzSZgD38FoE3VMGg ($51.60 in chips)
crjGpJEzSZgD38FoE3VMGg: posts small blind $0.25
1WUCqNG+p+vfWRTXNu4ljw: posts big blind $0.50
*** HOLE CARDS ***
uVwggSetzp7d+eVgowO3vg: folds
x+pzUFJsMIiGd7a5pcR4tg: folds
crjGpJEzSZgD38FoE3VMGg: raises $1.50 to $2
1WUCqNG+p+vfWRTXNu4ljw: folds
crjGpJEzSZgD38FoE3VMGg collected $1 from pot
crjGpJEzSZgD38FoE3VMGg: doesn't show hand
*** SUMMARY ***
Total pot $1 | Rake $0
Seat 1: 1WUCqNG+p+vfWRTXNu4ljw (big blind) folded before Flop
Seat 2: uVwggSetzp7d+eVgowO3vg folded before Flop (didn't bet)
Seat 4: x+pzUFJsMIiGd7a5pcR4tg (button) folded before Flop (didn't bet)
Seat 5: crjGpJEzSZgD38FoE3VMGg (small blind) collected ($1)



PokerStars Game #59939363442:  Hold'em No Limit ($0.25/$0.50) - 2009/07/01 0:37:57 ET
Table 'E7bWJ45aoFXRpyRv2gw+Ig' 2-max Seat #2 is the button
Seat 1: FRkiRasEGlHUeLrEl+k/nA ($50 in chips)
Seat 2: 3Wro85I7472vJ4Wkpneo9A ($145.15 in chips)
3Wro85I7472vJ4Wkpneo9A: posts small blind $0.25
FRkiRasEGlHUeLrEl+k/nA: posts big blind $0.50
*** HOLE CARDS ***
3Wro85I7472vJ4Wkpneo9A: folds
FRkiRasEGlHUeLrEl+k/nA collected $0.50 from pot
*** SUMMARY ***
Total pot $0.50 | Rake $0
Seat 1: FRkiRasEGlHUeLrEl+k/nA (big blind) collected ($0.50)
Seat 2: 3Wro85I7472vJ4Wkpneo9A (button) (small blind) folded before Flop



PokerStars Game #59939364734:  Hold'em No Limit ($0.25/$0.50) - 2009/07/01 0:37:59 ET
Table 'EiNh8p/wGJ1FP575iMFnqg' 9-max Seat #6 is the button
Seat 1: r3ZqM1Mi0W3y4hOdssE+Sg ($50.15 in chips)
Seat 2: 8ehL7qlZzjgUh2H35iiWLw ($51.25 in chips)
Seat 3: ymLPoEIl7UL3TvZYmnadxQ ($49.85 in chips)
Seat 5: M+7+BTmX5vZatHVuoRB1nA ($85.35 in chips)
Seat 6: 3UmXLy3GfjC3EkOebduerQ ($53.90 in chips)
Seat 7: 997ViqAtWn1FPjJqcffwcA ($50 in chips)
Seat 8: KrPAGRACBg+w0M//SXe8Ag ($10.90 in chips)
Seat 9: OMwFJ4pF0xk2Ru/AJiFeFw ($101 in chips)
997ViqAtWn1FPjJqcffwcA: posts small blind $0.25
KrPAGRACBg+w0M//SXe8Ag: posts big blind $0.50
Lacher64: sits out
*** HOLE CARDS ***
OMwFJ4pF0xk2Ru/AJiFeFw: folds
r3ZqM1Mi0W3y4hOdssE+Sg: folds
8ehL7qlZzjgUh2H35iiWLw: folds
ymLPoEIl7UL3TvZYmnadxQ: calls $0.50
M+7+BTmX5vZatHVuoRB1nA: folds
3UmXLy3GfjC3EkOebduerQ: folds
997ViqAtWn1FPjJqcffwcA: folds
KrPAGRACBg+w0M//SXe8Ag: checks
*** FLOP *** [9h Th Js]
KrPAGRACBg+w0M//SXe8Ag: bets $0.50
ymLPoEIl7UL3TvZYmnadxQ: folds
KrPAGRACBg+w0M//SXe8Ag collected $1.20 from pot
KrPAGRACBg+w0M//SXe8Ag: doesn't show hand
*** SUMMARY ***
Total pot $1.25 | Rake $0.05
Board [9h Th Js]
Seat 1: r3ZqM1Mi0W3y4hOdssE+Sg folded before Flop (didn't bet)
Seat 2: 8ehL7qlZzjgUh2H35iiWLw folded before Flop (didn't bet)
Seat 3: ymLPoEIl7UL3TvZYmnadxQ folded on the Flop
Seat 5: M+7+BTmX5vZatHVuoRB1nA folded before Flop (didn't bet)
Seat 6: 3UmXLy3GfjC3EkOebduerQ (button) folded before Flop (didn't bet)
Seat 7: 997ViqAtWn1FPjJqcffwcA (small blind) folded before Flop
Seat 8: KrPAGRACBg+w0M//SXe8Ag (big blind) collected ($1.20)
Seat 9: OMwFJ4pF0xk2Ru/AJiFeFw folded before Flop (didn't bet)



PokerStars Game #59939365168:  Hold'em No Limit ($0.25/$0.50) - 2009/07/01 0:38:00 ET
Table 'mTxf8gPLgffN3Iwfm7Icfg' 2-max Seat #1 is the button
Seat 1: Do9Rlu1R5u/AcRtMTl8SYg ($61.70 in chips)
Seat 2: EMc5LPgVaded4Qc77vm0fw ($95.75 in chips)
Do9Rlu1R5u/AcRtMTl8SYg: posts small blind $0.25
EMc5LPgVaded4Qc77vm0fw: posts big blind $0.50
*** HOLE CARDS ***
Do9Rlu1R5u/AcRtMTl8SYg: raises $1 to $1.50
EMc5LPgVaded4Qc77vm0fw: folds
Do9Rlu1R5u/AcRtMTl8SYg collected $1 from pot
Do9Rlu1R5u/AcRtMTl8SYg: doesn't show hand
*** SUMMARY ***
Total pot $1 | Rake $0
Seat 1: Do9Rlu1R5u/AcRtMTl8SYg (button) (small blind) collected ($1)
Seat 2: EMc5LPgVaded4Qc77vm0fw (big blind) folded before Flop



PokerStars Game #59939368162:  Hold'em No Limit ($0.25/$0.50) - 2009/07/01 0:38:04 ET
Table 'E7bWJ45aoFXRpyRv2gw+Ig' 2-max Seat #1 is the button
Seat 1: FRkiRasEGlHUeLrEl+k/nA ($50.25 in chips)
Seat 2: 3Wro85I7472vJ4Wkpneo9A ($144.90 in chips)
FRkiRasEGlHUeLrEl+k/nA: posts small blind $0.25
3Wro85I7472vJ4Wkpneo9A: posts big blind $0.50
*** HOLE CARDS ***
FRkiRasEGlHUeLrEl+k/nA: raises $1 to $1.50
3Wro85I7472vJ4Wkpneo9A: folds
FRkiRasEGlHUeLrEl+k/nA collected $1 from pot
*** SUMMARY ***
Total pot $1 | Rake $0
Seat 1: FRkiRasEGlHUeLrEl+k/nA (button) (small blind) collected ($1)
Seat 2: 3Wro85I7472vJ4Wkpneo9A (big blind) folded before Flop



PokerStars Game #59939368320:  Hold'em No Limit ($0.25/$0.50) - 2009/07/01 0:38:04 ET
Table 'Nz0Vr7WMHL2g5Uk7dDZjpw' 9-max Seat #2 is the button
Seat 1: tLkxo7JgV+WWI0UBw44K5A ($96.25 in chips)
Seat 2: XNMDwbXt/Q4jM99AXnbJDw ($67.20 in chips)
Seat 3: 4QTiNH5fteLgJjx/s6Hy6A ($16.65 in chips)
Seat 5: WGW0DgjBUXs1ylURHG8vnQ ($19.95 in chips)
Seat 6: k1f0lS7tlMHCLGs0JT34Tg ($13.50 in chips)
Seat 7: KPLH0gELgFe2OuAnhJFI5w ($24 in chips)
Seat 8: HkZI6g4zl83TDTA7SRspmQ ($13.70 in chips)
4QTiNH5fteLgJjx/s6Hy6A: posts small blind $0.25
5JJVDlaiMnB004o/RqbZZQ: is sitting out
WGW0DgjBUXs1ylURHG8vnQ: posts big blind $0.50
mSD1pginDsyHG5PDfqzphw: sits out
*** HOLE CARDS ***
5JJVDlaiMnB004o/RqbZZQ leaves the table
k1f0lS7tlMHCLGs0JT34Tg: folds
KPLH0gELgFe2OuAnhJFI5w: folds
HkZI6g4zl83TDTA7SRspmQ: raises $1 to $1.50
tLkxo7JgV+WWI0UBw44K5A: folds
XNMDwbXt/Q4jM99AXnbJDw: folds
4QTiNH5fteLgJjx/s6Hy6A: folds
Nioubi123 joins the table at seat #4
WGW0DgjBUXs1ylURHG8vnQ: folds
HkZI6g4zl83TDTA7SRspmQ collected $1.25 from pot
*** SUMMARY ***
Total pot $1.25 | Rake $0
Seat 1: tLkxo7JgV+WWI0UBw44K5A folded before Flop (didn't bet)
Seat 2: XNMDwbXt/Q4jM99AXnbJDw (button) folded before Flop (didn't bet)
Seat 3: 4QTiNH5fteLgJjx/s6Hy6A (small blind) folded before Flop
Seat 5: WGW0DgjBUXs1ylURHG8vnQ (big blind) folded before Flop
Seat 6: k1f0lS7tlMHCLGs0JT34Tg folded before Flop (didn't bet)
Seat 7: KPLH0gELgFe2OuAnhJFI5w folded before Flop (didn't bet)
Seat 8: HkZI6g4zl83TDTA7SRspmQ collected ($1.25)



PokerStars Game #59939368998:  Hold'em No Limit ($0.25/$0.50) - 2009/07/01 0:38:05 ET
Table 'QOgaEqMcJ73pcUMMxoisUg' 6-max Seat #1 is the button
Seat 1: OZ6OtYh5Y53MCH/p0QTn5g ($53.45 in chips)
Seat 2: 4QfsCWthT/vSLirorNXqtg ($50 in chips)
Seat 3: Rt6KgtZ8YaJoTc3FPim00w ($77.50 in chips)
Seat 4: zAcsDhG/T128Vn7XGVSgKg ($58.15 in chips)
Seat 6: pmE+2KJb4nffAVqjLIXxFg ($20.75 in chips)
4QfsCWthT/vSLirorNXqtg: posts small blind $0.25
Rt6KgtZ8YaJoTc3FPim00w: posts big blind $0.50
*** HOLE CARDS ***
zAcsDhG/T128Vn7XGVSgKg: folds
pmE+2KJb4nffAVqjLIXxFg: folds
6vNxrjjCl6FwfaaymM9jjg has returned
OZ6OtYh5Y53MCH/p0QTn5g: raises $1 to $1.50
4QfsCWthT/vSLirorNXqtg: folds
Rt6KgtZ8YaJoTc3FPim00w: folds
OZ6OtYh5Y53MCH/p0QTn5g collected $1.25 from pot
OZ6OtYh5Y53MCH/p0QTn5g: doesn't show hand
*** SUMMARY ***
Total pot $1.25 | Rake $0
Seat 1: OZ6OtYh5Y53MCH/p0QTn5g (button) collected ($1.25)
Seat 2: 4QfsCWthT/vSLirorNXqtg (small blind) folded before Flop
Seat 3: Rt6KgtZ8YaJoTc3FPim00w (big blind) folded before Flop
Seat 4: zAcsDhG/T128Vn7XGVSgKg folded before Flop (didn't bet)
Seat 6: pmE+2KJb4nffAVqjLIXxFg folded before Flop (didn't bet)



PokerStars Game #59939369156:  Hold'em No Limit ($0.25/$0.50) - 2009/07/01 0:38:06 ET
Table '+z1aekfHkpp09pc8F9aViw' 6-max Seat #6 is the button
Seat 1: FHilMb2i2DbUCc9lplszog ($41.10 in chips)
Seat 2: M6xK/VklCvdyyrmvzATlxQ ($36.80 in chips)
Seat 3: uUznlIMFnRUvwrBhYF73KA ($70.45 in chips)
Seat 4: RowCSpSURHTOL/dcjg/Iug ($50.80 in chips)
Seat 5: crjGpJEzSZgD38FoE3VMGg ($50 in chips)
Seat 6: 686aeHikcJlgKkSuIFdcXQ ($68.60 in chips)
FHilMb2i2DbUCc9lplszog: posts small blind $0.25
M6xK/VklCvdyyrmvzATlxQ: posts big blind $0.50
*** HOLE CARDS ***
uUznlIMFnRUvwrBhYF73KA: calls $0.50
RowCSpSURHTOL/dcjg/Iug: calls $0.50
crjGpJEzSZgD38FoE3VMGg: folds
686aeHikcJlgKkSuIFdcXQ: folds
FHilMb2i2DbUCc9lplszog: raises $2 to $2.50
M6xK/VklCvdyyrmvzATlxQ: folds
uUznlIMFnRUvwrBhYF73KA: calls $2
RowCSpSURHTOL/dcjg/Iug: folds
*** FLOP *** [Qd As Ad]
FHilMb2i2DbUCc9lplszog: bets $2.50
uUznlIMFnRUvwrBhYF73KA: calls $2.50
*** TURN *** [Qd As Ad] [6s]
FHilMb2i2DbUCc9lplszog: bets $5
uUznlIMFnRUvwrBhYF73KA: calls $5
*** RIVER *** [Qd As Ad 6s] [Kc]
FHilMb2i2DbUCc9lplszog: checks
uUznlIMFnRUvwrBhYF73KA: bets $10
FHilMb2i2DbUCc9lplszog: calls $10
*** SHOW DOWN ***
uUznlIMFnRUvwrBhYF73KA: shows [7s Ah] (three of a kind, Aces)
FHilMb2i2DbUCc9lplszog: mucks hand
uUznlIMFnRUvwrBhYF73KA collected $39 from pot
*** SUMMARY ***
Total pot $41 | Rake $2
Board [Qd As Ad 6s Kc]
Seat 1: FHilMb2i2DbUCc9lplszog (small blind) mucked
Seat 2: M6xK/VklCvdyyrmvzATlxQ (big blind) folded before Flop
Seat 3: uUznlIMFnRUvwrBhYF73KA showed [7s Ah] and won ($39) with three of a kind, Aces
Seat 4: RowCSpSURHTOL/dcjg/Iug folded before Flop
Seat 5: crjGpJEzSZgD38FoE3VMGg folded before Flop (didn't bet)
Seat 6: 686aeHikcJlgKkSuIFdcXQ (button) folded before Flop (didn't bet)



PokerStars Game #59939370284:  Hold'em No Limit ($0.25/$0.50) - 2009/07/01 0:38:07 ET
Table 'mTxf8gPLgffN3Iwfm7Icfg' 2-max Seat #2 is the button
Seat 1: Do9Rlu1R5u/AcRtMTl8SYg ($62.20 in chips)
Seat 2: EMc5LPgVaded4Qc77vm0fw ($95.25 in chips)
EMc5LPgVaded4Qc77vm0fw: posts small blind $0.25
Do9Rlu1R5u/AcRtMTl8SYg: posts big blind $0.50
*** HOLE CARDS ***
EMc5LPgVaded4Qc77vm0fw: folds
Do9Rlu1R5u/AcRtMTl8SYg collected $0.50 from pot
Do9Rlu1R5u/AcRtMTl8SYg: doesn't show hand
*** SUMMARY ***
Total pot $0.50 | Rake $0
Seat 1: Do9Rlu1R5u/AcRtMTl8SYg (big blind) collected ($0.50)
Seat 2: EMc5LPgVaded4Qc77vm0fw (button) (small blind) folded before Flop



PokerStars Game #59939371046:  Hold'em No Limit ($0.25/$0.50) - 2009/07/01 0:38:09 ET
Table '/cQuAT3ef4t+PGrXiNhGaQ' 9-max Seat #4 is the button
Seat 1: HZkVla4kK2SI42CVrPZ/ig ($5.25 in chips)
Seat 2: jXGruyaMqirTaTXNOvBdew ($70.65 in chips)
Seat 3: g4k0NXISyLCqaSWZDBjfEg ($53.65 in chips)
Seat 4: OWP/DOu+PlPK6ZZ3zYa0HA ($39.90 in chips)
Seat 5: 5SgaHdWixdClWvaEG+KUjQ ($28.60 in chips)
Seat 6: APYIOyK/4AGb+kIwlOUNBQ ($39.75 in chips)
Seat 7: J0W5D97jl5VLky+IoPvDeA ($114.90 in chips)
Seat 8: W3ingbA178eb7J5rt1PuIQ ($28.95 in chips)
5SgaHdWixdClWvaEG+KUjQ: posts small blind $0.25
APYIOyK/4AGb+kIwlOUNBQ: posts big blind $0.50
stumblehere: sits out
*** HOLE CARDS ***
J0W5D97jl5VLky+IoPvDeA: folds
W3ingbA178eb7J5rt1PuIQ: folds
HZkVla4kK2SI42CVrPZ/ig: raises $1 to $1.50
jXGruyaMqirTaTXNOvBdew: folds
g4k0NXISyLCqaSWZDBjfEg: folds
OWP/DOu+PlPK6ZZ3zYa0HA: folds
5SgaHdWixdClWvaEG+KUjQ: folds
APYIOyK/4AGb+kIwlOUNBQ: folds
HZkVla4kK2SI42CVrPZ/ig collected $1.25 from pot
*** SUMMARY ***
Total pot $1.25 | Rake $0
Seat 1: HZkVla4kK2SI42CVrPZ/ig collected ($1.25)
Seat 2: jXGruyaMqirTaTXNOvBdew folded before Flop (didn't bet)
Seat 3: g4k0NXISyLCqaSWZDBjfEg folded before Flop (didn't bet)
Seat 4: OWP/DOu+PlPK6ZZ3zYa0HA (button) folded before Flop (didn't bet)
Seat 5: 5SgaHdWixdClWvaEG+KUjQ (small blind) folded before Flop
Seat 6: APYIOyK/4AGb+kIwlOUNBQ (big blind) folded before Flop
Seat 7: J0W5D97jl5VLky+IoPvDeA folded before Flop (didn't bet)
Seat 8: W3ingbA178eb7J5rt1PuIQ folded before Flop (didn't bet)



PokerStars Game #59939372188:  Hold'em No Limit ($0.25/$0.50) - 2009/07/01 0:38:10 ET
Table '+111aLuBwnz8YVYSA7J1jA' 2-max Seat #1 is the button
Seat 1: ndd1nfncBkWNitBnsfCoVQ ($93.40 in chips)
Seat 2: +ciXH35zeafrjg1W6wiBTg ($54.35 in chips)
ndd1nfncBkWNitBnsfCoVQ: posts small blind $0.25
+ciXH35zeafrjg1W6wiBTg: posts big blind $0.50
*** HOLE CARDS ***
ndd1nfncBkWNitBnsfCoVQ: raises $1 to $1.50
+ciXH35zeafrjg1W6wiBTg: folds
ndd1nfncBkWNitBnsfCoVQ collected $1 from pot
ndd1nfncBkWNitBnsfCoVQ: doesn't show hand
*** SUMMARY ***
Total pot $1 | Rake $0
Seat 1: ndd1nfncBkWNitBnsfCoVQ (button) (small blind) collected ($1)
Seat 2: +ciXH35zeafrjg1W6wiBTg (big blind) folded before Flop



PokerStars Game #59939372030:  Hold'em No Limit ($0.25/$0.50) - 2009/07/01 0:38:10 ET
Table '5EmHi+fnatGQQShcNmzOZQ' 6-max Seat #3 is the button
Seat 1: +SZCX3+7lnuhHKIu+PP9rg ($30 in chips)
Seat 2: vXIHnZ+dv/hwSBxyvGw7bQ ($77.25 in chips)
Seat 3: L9qfLYXrczhAPd/VckgsWw ($84.25 in chips)
Seat 4: 1b+2BbjMN8qhR1WPqdE9VQ ($55.90 in chips)
Seat 5: kxPhs4ePFqMy52CInAJ2aw ($53.85 in chips)
Seat 6: 686aeHikcJlgKkSuIFdcXQ ($138.65 in chips)
1b+2BbjMN8qhR1WPqdE9VQ: posts small blind $0.25
kxPhs4ePFqMy52CInAJ2aw: posts big blind $0.50
+SZCX3+7lnuhHKIu+PP9rg: posts big blind $0.50
*** HOLE CARDS ***
686aeHikcJlgKkSuIFdcXQ: raises $1.50 to $2
+SZCX3+7lnuhHKIu+PP9rg: folds
vXIHnZ+dv/hwSBxyvGw7bQ: folds
L9qfLYXrczhAPd/VckgsWw: folds
1b+2BbjMN8qhR1WPqdE9VQ: folds
kxPhs4ePFqMy52CInAJ2aw: calls $1.50
*** FLOP *** [5s 8d Qh]
kxPhs4ePFqMy52CInAJ2aw: checks
686aeHikcJlgKkSuIFdcXQ: checks
*** TURN *** [5s 8d Qh] [Jd]
kxPhs4ePFqMy52CInAJ2aw: checks
686aeHikcJlgKkSuIFdcXQ: checks
*** RIVER *** [5s 8d Qh Jd] [Kd]
kxPhs4ePFqMy52CInAJ2aw: checks
686aeHikcJlgKkSuIFdcXQ: checks
*** SHOW DOWN ***
kxPhs4ePFqMy52CInAJ2aw: shows [6c 6d] (a pair of Sixes)
686aeHikcJlgKkSuIFdcXQ: shows [Js Ah] (a pair of Jacks)
686aeHikcJlgKkSuIFdcXQ collected $4.55 from pot
*** SUMMARY ***
Total pot $4.75 | Rake $0.20
Board [5s 8d Qh Jd Kd]
Seat 1: +SZCX3+7lnuhHKIu+PP9rg folded before Flop
Seat 2: vXIHnZ+dv/hwSBxyvGw7bQ folded before Flop (didn't bet)
Seat 3: L9qfLYXrczhAPd/VckgsWw (button) folded before Flop (didn't bet)
Seat 4: 1b+2BbjMN8qhR1WPqdE9VQ (small blind) folded before Flop
Seat 5: kxPhs4ePFqMy52CInAJ2aw (big blind) showed [6c 6d] and lost with a pair of Sixes
Seat 6: 686aeHikcJlgKkSuIFdcXQ showed [Js Ah] and won ($4.55) with a pair of Jacks



PokerStars Game #59939373228:  Hold'em No Limit ($0.25/$0.50) - 2009/07/01 0:38:12 ET
Table 'E7bWJ45aoFXRpyRv2gw+Ig' 2-max Seat #2 is the button
Seat 1: FRkiRasEGlHUeLrEl+k/nA ($50.75 in chips)
Seat 2: 3Wro85I7472vJ4Wkpneo9A ($144.40 in chips)
3Wro85I7472vJ4Wkpneo9A: posts small blind $0.25
FRkiRasEGlHUeLrEl+k/nA: posts big blind $0.50
*** HOLE CARDS ***
3Wro85I7472vJ4Wkpneo9A: raises $1 to $1.50
FRkiRasEGlHUeLrEl+k/nA: folds
3Wro85I7472vJ4Wkpneo9A collected $1 from pot
3Wro85I7472vJ4Wkpneo9A: doesn't show hand
*** SUMMARY ***
Total pot $1 | Rake $0
Seat 1: FRkiRasEGlHUeLrEl+k/nA (big blind) folded before Flop
Seat 2: 3Wro85I7472vJ4Wkpneo9A (button) (small blind) collected ($1)



PokerStars Game #59939374262:  Hold'em No Limit ($0.25/$0.50) - 2009/07/01 0:38:13 ET
Table 'eMxdLyFDf28E0wit6gm3Uw' 6-max Seat #1 is the button
Seat 1: GtdWeBVCZhDBcNFRTOb8Hg ($6.50 in chips)
Seat 2: jwuKQ1S3U4NnzMQn3E3dgw ($73.90 in chips)
Seat 3: dZcLsEI8iXkobBduRJ45Yw ($8.30 in chips)
Seat 4: 3jxEWvv2qK1HCXLj4khowQ ($30 in chips)
Seat 6: L0aIPg7qefDQjdJo3HCVEA ($17.70 in chips)
jwuKQ1S3U4NnzMQn3E3dgw: posts small blind $0.25
dZcLsEI8iXkobBduRJ45Yw said, "nh"
dZcLsEI8iXkobBduRJ45Yw: posts big blind $0.50
3jxEWvv2qK1HCXLj4khowQ: posts big blind $0.50
*** HOLE CARDS ***
3jxEWvv2qK1HCXLj4khowQ: checks
L0aIPg7qefDQjdJo3HCVEA: folds
GtdWeBVCZhDBcNFRTOb8Hg: calls $0.50
jwuKQ1S3U4NnzMQn3E3dgw: calls $0.25
dZcLsEI8iXkobBduRJ45Yw: raises $1.50 to $2
3jxEWvv2qK1HCXLj4khowQ: folds
GtdWeBVCZhDBcNFRTOb8Hg: calls $1.50
jwuKQ1S3U4NnzMQn3E3dgw: folds
*** FLOP *** [9d Js Qh]
dZcLsEI8iXkobBduRJ45Yw: bets $6.30 and is all-in
GtdWeBVCZhDBcNFRTOb8Hg: folds
dZcLsEI8iXkobBduRJ45Yw collected $4.75 from pot
*** SUMMARY ***
Total pot $5 | Rake $0.25
Board [9d Js Qh]
Seat 1: GtdWeBVCZhDBcNFRTOb8Hg (button) folded on the Flop
Seat 2: jwuKQ1S3U4NnzMQn3E3dgw (small blind) folded before Flop
Seat 3: dZcLsEI8iXkobBduRJ45Yw (big blind) collected ($4.75)
Seat 4: 3jxEWvv2qK1HCXLj4khowQ folded before Flop
Seat 6: L0aIPg7qefDQjdJo3HCVEA folded before Flop (didn't bet)



PokerStars Game #59939374088:  Hold'em No Limit ($0.25/$0.50) - 2009/07/01 0:38:13 ET
Table 'otvGDROEDdqsabxskT79qg' 9-max Seat #4 is the button
Seat 1: 8ehL7qlZzjgUh2H35iiWLw ($56 in chips)
Seat 2: cCjTzH9jio8607WzjcfXlg ($8 in chips)
Seat 3: +k7T5ocke8UwavtgUHm+Cg ($75.35 in chips)
Seat 4: MG90wfSJZnOejs/KD3vlQQ ($55.40 in chips)
Seat 5: XNMDwbXt/Q4jM99AXnbJDw ($55.05 in chips)
Seat 6: bxLSulbgr8LmKNjOzw8URg ($51.80 in chips)
Seat 7: C7+tBppJrKgd/r+tuKUIpA ($35.35 in chips)
Seat 8: zE9cVigS2nW/Ljy4K4bUQA ($30 in chips)
Seat 9: KcY3X8YpD74Kw1RHkx/g4A ($66 in chips)
XNMDwbXt/Q4jM99AXnbJDw: posts small blind $0.25
bxLSulbgr8LmKNjOzw8URg: posts big blind $0.50
*** HOLE CARDS ***
C7+tBppJrKgd/r+tuKUIpA: folds
zE9cVigS2nW/Ljy4K4bUQA: folds
KcY3X8YpD74Kw1RHkx/g4A: folds
8ehL7qlZzjgUh2H35iiWLw: folds
cCjTzH9jio8607WzjcfXlg: calls $0.50
+k7T5ocke8UwavtgUHm+Cg: folds
MG90wfSJZnOejs/KD3vlQQ: folds
XNMDwbXt/Q4jM99AXnbJDw: folds
bxLSulbgr8LmKNjOzw8URg: checks
*** FLOP *** [Kc 3s 9c]
bxLSulbgr8LmKNjOzw8URg: checks
cCjTzH9jio8607WzjcfXlg: checks
*** TURN *** [Kc 3s 9c] [9h]
bxLSulbgr8LmKNjOzw8URg: checks
cCjTzH9jio8607WzjcfXlg: checks
*** RIVER *** [Kc 3s 9c 9h] [3c]
bxLSulbgr8LmKNjOzw8URg: checks
cCjTzH9jio8607WzjcfXlg: checks
*** SHOW DOWN ***
bxLSulbgr8LmKNjOzw8URg: shows [6s Th] (two pair, Nines and Threes)
cCjTzH9jio8607WzjcfXlg: shows [Tc Qh] (two pair, Nines and Threes)
bxLSulbgr8LmKNjOzw8URg collected $0.60 from pot
cCjTzH9jio8607WzjcfXlg collected $0.60 from pot
*** SUMMARY ***
Total pot $1.25 | Rake $0.05
Board [Kc 3s 9c 9h 3c]
Seat 1: 8ehL7qlZzjgUh2H35iiWLw folded before Flop (didn't bet)
Seat 2: cCjTzH9jio8607WzjcfXlg showed [Tc Qh] and won ($0.60) with two pair, Nines and Threes
Seat 3: +k7T5ocke8UwavtgUHm+Cg folded before Flop (didn't bet)
Seat 4: MG90wfSJZnOejs/KD3vlQQ (button) folded before Flop (didn't bet)
Seat 5: XNMDwbXt/Q4jM99AXnbJDw (small blind) folded before Flop
Seat 6: bxLSulbgr8LmKNjOzw8URg (big blind) showed [6s Th] and won ($0.60) with two pair, Nines and Threes
Seat 7: C7+tBppJrKgd/r+tuKUIpA folded before Flop (didn't bet)
Seat 8: zE9cVigS2nW/Ljy4K4bUQA folded before Flop (didn't bet)
Seat 9: KcY3X8YpD74Kw1RHkx/g4A folded before Flop (didn't bet)



PokerStars Game #59939374298:  Hold'em No Limit ($0.25/$0.50) - 2009/07/01 0:38:14 ET
Table 'mTxf8gPLgffN3Iwfm7Icfg' 2-max Seat #1 is the button
Seat 1: Do9Rlu1R5u/AcRtMTl8SYg ($62.45 in chips)
Seat 2: EMc5LPgVaded4Qc77vm0fw ($95 in chips)
Do9Rlu1R5u/AcRtMTl8SYg: posts small blind $0.25
EMc5LPgVaded4Qc77vm0fw: posts big blind $0.50
*** HOLE CARDS ***
Do9Rlu1R5u/AcRtMTl8SYg: calls $0.25
EMc5LPgVaded4Qc77vm0fw: checks
*** FLOP *** [7c 9c 6h]
EMc5LPgVaded4Qc77vm0fw: checks
Do9Rlu1R5u/AcRtMTl8SYg: bets $1
EMc5LPgVaded4Qc77vm0fw: calls $1
*** TURN *** [7c 9c 6h] [6c]
EMc5LPgVaded4Qc77vm0fw: checks
Do9Rlu1R5u/AcRtMTl8SYg: checks
*** RIVER *** [7c 9c 6h 6c] [6s]
EMc5LPgVaded4Qc77vm0fw: checks
Do9Rlu1R5u/AcRtMTl8SYg: checks
*** SHOW DOWN ***
EMc5LPgVaded4Qc77vm0fw: shows [Ac 3s] (three of a kind, Sixes)
Do9Rlu1R5u/AcRtMTl8SYg: mucks hand
EMc5LPgVaded4Qc77vm0fw collected $2.90 from pot
*** SUMMARY ***
Total pot $3 | Rake $0.10
Board [7c 9c 6h 6c 6s]
Seat 1: Do9Rlu1R5u/AcRtMTl8SYg (button) (small blind) mucked
Seat 2: EMc5LPgVaded4Qc77vm0fw (big blind) showed [Ac 3s] and won ($2.90) with three of a kind, Sixes



PokerStars Game #59939374824:  Hold'em No Limit ($0.25/$0.50) - 2009/07/01 0:38:14 ET
Table 'hWT2kq66tnKEpD26cia6fQ' 2-max Seat #1 is the button
Seat 1: q+vRKwm51mnr6kxX/161WQ ($53.80 in chips)
Seat 2: dkC7J+qbyqk0qCcmJbEPPw ($61.10 in chips)
q+vRKwm51mnr6kxX/161WQ: posts small blind $0.25
dkC7J+qbyqk0qCcmJbEPPw: posts big blind $0.50
*** HOLE CARDS ***
q+vRKwm51mnr6kxX/161WQ: raises $1 to $1.50
dkC7J+qbyqk0qCcmJbEPPw: calls $1
*** FLOP *** [2d 3s 7d]
dkC7J+qbyqk0qCcmJbEPPw: checks
q+vRKwm51mnr6kxX/161WQ: bets $2
dkC7J+qbyqk0qCcmJbEPPw: folds
q+vRKwm51mnr6kxX/161WQ collected $2.85 from pot
q+vRKwm51mnr6kxX/161WQ: doesn't show hand
*** SUMMARY ***
Total pot $3 | Rake $0.15
Board [2d 3s 7d]
Seat 1: q+vRKwm51mnr6kxX/161WQ (button) (small blind) collected ($2.85)
Seat 2: dkC7J+qbyqk0qCcmJbEPPw (big blind) folded on the Flop



PokerStars Game #59939375304:  Hold'em No Limit ($0.25/$0.50) - 2009/07/01 0:38:15 ET
Table 'c/CRn+68J3Y8KxD5g1ek2Q' 2-max Seat #2 is the button
Seat 1: 46qCyJ6evTkHo9al5sBMNA ($241.95 in chips)
Seat 2: BypVLsYQt3ePFm2xQL/dOA ($133.85 in chips)
BypVLsYQt3ePFm2xQL/dOA: posts small blind $0.25
46qCyJ6evTkHo9al5sBMNA: posts big blind $0.50
*** HOLE CARDS ***
BypVLsYQt3ePFm2xQL/dOA: raises $1 to $1.50
46qCyJ6evTkHo9al5sBMNA: folds
BypVLsYQt3ePFm2xQL/dOA collected $1 from pot
BypVLsYQt3ePFm2xQL/dOA: doesn't show hand
*** SUMMARY ***
Total pot $1 | Rake $0
Seat 1: 46qCyJ6evTkHo9al5sBMNA (big blind) folded before Flop
Seat 2: BypVLsYQt3ePFm2xQL/dOA (button) (small blind) collected ($1)



PokerStars Game #59939377884:  Hold'em No Limit ($0.25/$0.50) - 2009/07/01 0:38:19 ET
Table '+111aLuBwnz8YVYSA7J1jA' 2-max Seat #2 is the button
Seat 1: ndd1nfncBkWNitBnsfCoVQ ($93.90 in chips)
Seat 2: +ciXH35zeafrjg1W6wiBTg ($53.85 in chips)
+ciXH35zeafrjg1W6wiBTg: posts small blind $0.25
ndd1nfncBkWNitBnsfCoVQ: posts big blind $0.50
*** HOLE CARDS ***
+ciXH35zeafrjg1W6wiBTg: raises $1 to $1.50
ndd1nfncBkWNitBnsfCoVQ: folds
+ciXH35zeafrjg1W6wiBTg collected $1 from pot
+ciXH35zeafrjg1W6wiBTg: doesn't show hand
*** SUMMARY ***
Total pot $1 | Rake $0
Seat 1: ndd1nfncBkWNitBnsfCoVQ (big blind) folded before Flop
Seat 2: +ciXH35zeafrjg1W6wiBTg (button) (small blind) collected ($1)



PokerStars Game #59939378048:  Hold'em No Limit ($0.25/$0.50) - 2009/07/01 0:38:19 ET
Table 'tyR5AZNKV8Aadbrnrnlg7g' 6-max Seat #2 is the button
Seat 1: R+KjpH/wSjDLhtIy9+edNA ($89.20 in chips)
Seat 2: BAjwVL+zKKd0s0fAWstzQQ ($24.60 in chips)
Seat 3: tdOvWynovql5imfooroLMg ($48 in chips)
Seat 4: Rt6KgtZ8YaJoTc3FPim00w ($82.45 in chips)
Seat 6: ZKazl1hGaPiapDXincgi2Q ($15.65 in chips)
tdOvWynovql5imfooroLMg: posts small blind $0.25
Rt6KgtZ8YaJoTc3FPim00w: posts big blind $0.50
*** HOLE CARDS ***
ZKazl1hGaPiapDXincgi2Q: folds
R+KjpH/wSjDLhtIy9+edNA: folds
BAjwVL+zKKd0s0fAWstzQQ: raises $1 to $1.50
tdOvWynovql5imfooroLMg: folds
Rt6KgtZ8YaJoTc3FPim00w: folds
BAjwVL+zKKd0s0fAWstzQQ collected $1.25 from pot
BAjwVL+zKKd0s0fAWstzQQ: doesn't show hand
*** SUMMARY ***
Total pot $1.25 | Rake $0
Seat 1: R+KjpH/wSjDLhtIy9+edNA folded before Flop (didn't bet)
Seat 2: BAjwVL+zKKd0s0fAWstzQQ (button) collected ($1.25)
Seat 3: tdOvWynovql5imfooroLMg (small blind) folded before Flop
Seat 4: Rt6KgtZ8YaJoTc3FPim00w (big blind) folded before Flop
Seat 6: ZKazl1hGaPiapDXincgi2Q folded before Flop (didn't bet)



PokerStars Game #59939377666:  Hold'em No Limit ($0.25/$0.50) - 2009/07/01 0:38:19 ET
Table 'GfL/No5u5PoEnU39lP5pQg' 6-max Seat #5 is the button
Seat 1: 1WUCqNG+p+vfWRTXNu4ljw ($51.50 in chips)
Seat 2: uVwggSetzp7d+eVgowO3vg ($74.95 in chips)
Seat 4: x+pzUFJsMIiGd7a5pcR4tg ($51.60 in chips)
Seat 5: crjGpJEzSZgD38FoE3VMGg ($52.10 in chips)
1WUCqNG+p+vfWRTXNu4ljw: posts small blind $0.25
uVwggSetzp7d+eVgowO3vg: posts big blind $0.50
*** HOLE CARDS ***
x+pzUFJsMIiGd7a5pcR4tg: raises $1 to $1.50
crjGpJEzSZgD38FoE3VMGg: folds
1WUCqNG+p+vfWRTXNu4ljw: folds
NbUTppWfym/RxV/DmDz2Sw leaves the table
uVwggSetzp7d+eVgowO3vg: calls $1
*** FLOP *** [9h 8d 2h]
uVwggSetzp7d+eVgowO3vg: checks
x+pzUFJsMIiGd7a5pcR4tg: checks
*** TURN *** [9h 8d 2h] [Jd]
hell_goose joins the table at seat #3
uVwggSetzp7d+eVgowO3vg: bets $1.50
x+pzUFJsMIiGd7a5pcR4tg: calls $1.50
*** RIVER *** [9h 8d 2h Jd] [Td]
uVwggSetzp7d+eVgowO3vg: checks
x+pzUFJsMIiGd7a5pcR4tg: bets $4.50
uVwggSetzp7d+eVgowO3vg: folds
x+pzUFJsMIiGd7a5pcR4tg collected $5.95 from pot
x+pzUFJsMIiGd7a5pcR4tg: doesn't show hand
*** SUMMARY ***
Total pot $6.25 | Rake $0.30
Board [9h 8d 2h Jd Td]
Seat 1: 1WUCqNG+p+vfWRTXNu4ljw (small blind) folded before Flop
Seat 2: uVwggSetzp7d+eVgowO3vg (big blind) folded on the River
Seat 4: x+pzUFJsMIiGd7a5pcR4tg collected ($5.95)
Seat 5: crjGpJEzSZgD38FoE3VMGg (button) folded before Flop (didn't bet)



PokerStars Game #59939378362:  Hold'em No Limit ($0.25/$0.50) - 2009/07/01 0:38:20 ET
Table '+dXkOAQyS8j9PQZusUTMpg' 2-max Seat #1 is the button
Seat 1: XFa6sBGjP2gxoIvxR3fZIg ($48.25 in chips)
Seat 2: 5IBeOgaApY1Bvzv2P8X4EA ($143.10 in chips)
XFa6sBGjP2gxoIvxR3fZIg: posts small blind $0.25
5IBeOgaApY1Bvzv2P8X4EA: posts big blind $0.50
*** HOLE CARDS ***
XFa6sBGjP2gxoIvxR3fZIg: raises $1 to $1.50
5IBeOgaApY1Bvzv2P8X4EA: folds
XFa6sBGjP2gxoIvxR3fZIg collected $1 from pot
*** SUMMARY ***
Total pot $1 | Rake $0
Seat 1: XFa6sBGjP2gxoIvxR3fZIg (button) (small blind) collected ($1)
Seat 2: 5IBeOgaApY1Bvzv2P8X4EA (big blind) folded before Flop



PokerStars Game #59939378984:  Hold'em No Limit ($0.25/$0.50) - 2009/07/01 0:38:21 ET
Table 'E7bWJ45aoFXRpyRv2gw+Ig' 2-max Seat #1 is the button
Seat 1: FRkiRasEGlHUeLrEl+k/nA ($50.25 in chips)
Seat 2: 3Wro85I7472vJ4Wkpneo9A ($144.90 in chips)
FRkiRasEGlHUeLrEl+k/nA: posts small blind $0.25
3Wro85I7472vJ4Wkpneo9A: posts big blind $0.50
*** HOLE CARDS ***
FRkiRasEGlHUeLrEl+k/nA: calls $0.25
3Wro85I7472vJ4Wkpneo9A: raises $1.50 to $2
FRkiRasEGlHUeLrEl+k/nA: calls $1.50
*** FLOP *** [3c 8s 9d]
3Wro85I7472vJ4Wkpneo9A: bets $3
FRkiRasEGlHUeLrEl+k/nA: folds
3Wro85I7472vJ4Wkpneo9A collected $3.80 from pot
3Wro85I7472vJ4Wkpneo9A: doesn't show hand
*** SUMMARY ***
Total pot $4 | Rake $0.20
Board [3c 8s 9d]
Seat 1: FRkiRasEGlHUeLrEl+k/nA (button) (small blind) folded on the Flop
Seat 2: 3Wro85I7472vJ4Wkpneo9A (big blind) collected ($3.80)



PokerStars Game #59939379348:  Hold'em No Limit ($0.25/$0.50) - 2009/07/01 0:38:22 ET
Table 'T/PgNWqVyY6lkldcBVXYJQ' 6-max Seat #1 is the button
Seat 1: +Pf9jTVizYlIo+woPvptfA ($56.50 in chips)
Seat 2: LvH4G7n+QSjT6NDaD3cREA ($50 in chips)
Seat 3: L3OcNO1bgdqDI46j67KQPQ ($53.85 in chips)
Seat 4: otJMdCRvqd5YCcFsA3JWpg ($11.35 in chips)
Seat 5: vVQBckETtigfb5mAcyK0OA ($51.35 in chips)
Seat 6: cDzbog6kwmJp+LBeBq+iMQ ($41.70 in chips)
LvH4G7n+QSjT6NDaD3cREA: posts small blind $0.25
L3OcNO1bgdqDI46j67KQPQ: posts big blind $0.50
*** HOLE CARDS ***
otJMdCRvqd5YCcFsA3JWpg: folds
vVQBckETtigfb5mAcyK0OA: calls $0.50
cDzbog6kwmJp+LBeBq+iMQ: folds
+Pf9jTVizYlIo+woPvptfA: folds
LvH4G7n+QSjT6NDaD3cREA: calls $0.25
L3OcNO1bgdqDI46j67KQPQ: checks
*** FLOP *** [Jc Qh Kc]
LvH4G7n+QSjT6NDaD3cREA: bets $1
L3OcNO1bgdqDI46j67KQPQ: folds
vVQBckETtigfb5mAcyK0OA: folds
LvH4G7n+QSjT6NDaD3cREA collected $1.45 from pot
LvH4G7n+QSjT6NDaD3cREA: doesn't show hand
*** SUMMARY ***
Total pot $1.50 | Rake $0.05
Board [Jc Qh Kc]
Seat 1: +Pf9jTVizYlIo+woPvptfA (button) folded before Flop (didn't bet)
Seat 2: LvH4G7n+QSjT6NDaD3cREA (small blind) collected ($1.45)
Seat 3: L3OcNO1bgdqDI46j67KQPQ (big blind) folded on the Flop
Seat 4: otJMdCRvqd5YCcFsA3JWpg folded before Flop (didn't bet)
Seat 5: vVQBckETtigfb5mAcyK0OA folded on the Flop
Seat 6: cDzbog6kwmJp+LBeBq+iMQ folded before Flop (didn't bet)



PokerStars Game #59939380528:  Hold'em No Limit ($0.25/$0.50) - 2009/07/01 0:38:23 ET
Table 'c/CRn+68J3Y8KxD5g1ek2Q' 2-max Seat #1 is the button
Seat 1: 46qCyJ6evTkHo9al5sBMNA ($241.45 in chips)
Seat 2: BypVLsYQt3ePFm2xQL/dOA ($134.35 in chips)
46qCyJ6evTkHo9al5sBMNA: posts small blind $0.25
BypVLsYQt3ePFm2xQL/dOA: posts big blind $0.50
*** HOLE CARDS ***
46qCyJ6evTkHo9al5sBMNA: folds
BypVLsYQt3ePFm2xQL/dOA collected $0.50 from pot
BypVLsYQt3ePFm2xQL/dOA: doesn't show hand
*** SUMMARY ***
Total pot $0.50 | Rake $0
Seat 1: 46qCyJ6evTkHo9al5sBMNA (button) (small blind) folded before Flop
Seat 2: BypVLsYQt3ePFm2xQL/dOA (big blind) collected ($0.50)



PokerStars Game #59939380022:  Hold'em No Limit ($0.25/$0.50) - 2009/07/01 0:38:23 ET
Table 'X6IRCRTh+20gjz8aubWnwA' 9-max Seat #1 is the button
Seat 1: DSM67hHHq1XFoEOi9p8Alw ($50.80 in chips)
Seat 2: HZkVla4kK2SI42CVrPZ/ig ($7 in chips)
Seat 3: GeZ7AYmAZ9Ln8liPZzV8EA ($23.70 in chips)
Seat 4: 2J+UVOVrW+V3maOylyxMcQ ($43.70 in chips)
Seat 5: QtFsO51ArDuQ44+KvR2jow ($28.60 in chips)
Seat 6: /6In1zC3WtgwxDcueWzZWg ($66.40 in chips)
Seat 7: cFHQjKQOOKTUzoilhrXHLg ($26.25 in chips)
Seat 8: HxeBVq06/3Bh/H986sgdbw ($7.25 in chips)
Seat 9: M+7+BTmX5vZatHVuoRB1nA ($80.75 in chips)
HZkVla4kK2SI42CVrPZ/ig: posts small blind $0.25
GeZ7AYmAZ9Ln8liPZzV8EA: posts big blind $0.50
*** HOLE CARDS ***
2J+UVOVrW+V3maOylyxMcQ: folds
QtFsO51ArDuQ44+KvR2jow: folds
/6In1zC3WtgwxDcueWzZWg: folds
cFHQjKQOOKTUzoilhrXHLg: calls $0.50
HxeBVq06/3Bh/H986sgdbw: folds
M+7+BTmX5vZatHVuoRB1nA: raises $1.50 to $2
DSM67hHHq1XFoEOi9p8Alw: folds
QtFsO51ArDuQ44+KvR2jow leaves the table
HZkVla4kK2SI42CVrPZ/ig: folds
Nioubi123 joins the table at seat #5
GeZ7AYmAZ9Ln8liPZzV8EA: folds
cFHQjKQOOKTUzoilhrXHLg: calls $1.50
*** FLOP *** [Tc 8d Jd]
cFHQjKQOOKTUzoilhrXHLg: checks
M+7+BTmX5vZatHVuoRB1nA: bets $3
cFHQjKQOOKTUzoilhrXHLg: calls $3
*** TURN *** [Tc 8d Jd] [2d]
cFHQjKQOOKTUzoilhrXHLg: checks
M+7+BTmX5vZatHVuoRB1nA: bets $6.50
cFHQjKQOOKTUzoilhrXHLg: calls $6.50
*** RIVER *** [Tc 8d Jd 2d] [As]
cFHQjKQOOKTUzoilhrXHLg: checks
M+7+BTmX5vZatHVuoRB1nA: checks
*** SHOW DOWN ***
cFHQjKQOOKTUzoilhrXHLg: shows [Td Ad] (a flush, Ace high)
M+7+BTmX5vZatHVuoRB1nA: mucks hand
cFHQjKQOOKTUzoilhrXHLg collected $22.60 from pot
*** SUMMARY ***
Total pot $23.75 | Rake $1.15
Board [Tc 8d Jd 2d As]
Seat 1: DSM67hHHq1XFoEOi9p8Alw (button) folded before Flop (didn't bet)
Seat 2: HZkVla4kK2SI42CVrPZ/ig (small blind) folded before Flop
Seat 3: GeZ7AYmAZ9Ln8liPZzV8EA (big blind) folded before Flop
Seat 4: 2J+UVOVrW+V3maOylyxMcQ folded before Flop (didn't bet)
Seat 5: QtFsO51ArDuQ44+KvR2jow folded before Flop (didn't bet)
Seat 6: /6In1zC3WtgwxDcueWzZWg folded before Flop (didn't bet)
Seat 7: cFHQjKQOOKTUzoilhrXHLg showed [Td Ad] and won ($22.60) with a flush, Ace high
Seat 8: HxeBVq06/3Bh/H986sgdbw folded before Flop (didn't bet)
Seat 9: M+7+BTmX5vZatHVuoRB1nA mucked



PokerStars Game #59939381668:  Hold'em No Limit ($0.25/$0.50) - 2009/07/01 0:38:25 ET
Table 'QOgaEqMcJ73pcUMMxoisUg' 6-max Seat #2 is the button
Seat 1: OZ6OtYh5Y53MCH/p0QTn5g ($54.20 in chips)
Seat 2: 4QfsCWthT/vSLirorNXqtg ($50 in chips)
Seat 3: Rt6KgtZ8YaJoTc3FPim00w ($77 in chips)
Seat 4: zAcsDhG/T128Vn7XGVSgKg ($58.15 in chips)
Seat 5: 6vNxrjjCl6FwfaaymM9jjg ($15 in chips)
Seat 6: pmE+2KJb4nffAVqjLIXxFg ($20.75 in chips)
Rt6KgtZ8YaJoTc3FPim00w: posts small blind $0.25
zAcsDhG/T128Vn7XGVSgKg: posts big blind $0.50
*** HOLE CARDS ***
6vNxrjjCl6FwfaaymM9jjg: raises $2.50 to $3
pmE+2KJb4nffAVqjLIXxFg: folds
OZ6OtYh5Y53MCH/p0QTn5g: folds
4QfsCWthT/vSLirorNXqtg: folds
Rt6KgtZ8YaJoTc3FPim00w: folds
zAcsDhG/T128Vn7XGVSgKg: folds
6vNxrjjCl6FwfaaymM9jjg collected $1.25 from pot
*** SUMMARY ***
Total pot $1.25 | Rake $0
Seat 1: OZ6OtYh5Y53MCH/p0QTn5g folded before Flop (didn't bet)
Seat 2: 4QfsCWthT/vSLirorNXqtg (button) folded before Flop (didn't bet)
Seat 3: Rt6KgtZ8YaJoTc3FPim00w (small blind) folded before Flop
Seat 4: zAcsDhG/T128Vn7XGVSgKg (big blind) folded before Flop
Seat 5: 6vNxrjjCl6FwfaaymM9jjg collected ($1.25)
Seat 6: pmE+2KJb4nffAVqjLIXxFg folded before Flop (didn't bet)



PokerStars Game #59939383752:  Hold'em No Limit ($0.25/$0.50) - 2009/07/01 0:38:28 ET
Table '37qXEp3oe+er5q4CZip9eQ' 6-max Seat #6 is the button
Seat 1: oqOqoO2AyCZenUghCxMDxw ($52.50 in chips)
Seat 2: 6wzJiRvp8HY6t+MQGnSIzA ($25.60 in chips)
Seat 3: Rt6KgtZ8YaJoTc3FPim00w ($77.75 in chips)
Seat 4: XsmE8nXMAAMFJbWaJTmHFw ($28.35 in chips)
Seat 5: VOmI0x4dDPnTESZd5B4d1Q ($49.40 in chips)
Seat 6: N50kln4negd8q7Mmoz1j4g ($24.25 in chips)
oqOqoO2AyCZenUghCxMDxw: posts small blind $0.25
6wzJiRvp8HY6t+MQGnSIzA: posts big blind $0.50
*** HOLE CARDS ***
Rt6KgtZ8YaJoTc3FPim00w: raises $1 to $1.50
XsmE8nXMAAMFJbWaJTmHFw: folds
VOmI0x4dDPnTESZd5B4d1Q: folds
N50kln4negd8q7Mmoz1j4g: calls $1.50
oqOqoO2AyCZenUghCxMDxw: folds
6wzJiRvp8HY6t+MQGnSIzA: folds
*** FLOP *** [Ah Td Ks]
Rt6KgtZ8YaJoTc3FPim00w: bets $2.50
N50kln4negd8q7Mmoz1j4g: calls $2.50
*** TURN *** [Ah Td Ks] [3d]
Rt6KgtZ8YaJoTc3FPim00w: checks
N50kln4negd8q7Mmoz1j4g: bets $5
Rt6KgtZ8YaJoTc3FPim00w: folds
N50kln4negd8q7Mmoz1j4g collected $8.35 from pot
*** SUMMARY ***
Total pot $8.75 | Rake $0.40
Board [Ah Td Ks 3d]
Seat 1: oqOqoO2AyCZenUghCxMDxw (small blind) folded before Flop
Seat 2: 6wzJiRvp8HY6t+MQGnSIzA (big blind) folded before Flop
Seat 3: Rt6KgtZ8YaJoTc3FPim00w folded on the Turn
Seat 4: XsmE8nXMAAMFJbWaJTmHFw folded before Flop (didn't bet)
Seat 5: VOmI0x4dDPnTESZd5B4d1Q folded before Flop (didn't bet)
Seat 6: N50kln4negd8q7Mmoz1j4g (button) collected ($8.35)



PokerStars Game #59939383386:  Hold'em No Limit ($0.25/$0.50) - 2009/07/01 0:38:28 ET
Table '+111aLuBwnz8YVYSA7J1jA' 2-max Seat #1 is the button
Seat 1: ndd1nfncBkWNitBnsfCoVQ ($93.40 in chips)
Seat 2: +ciXH35zeafrjg1W6wiBTg ($54.35 in chips)
ndd1nfncBkWNitBnsfCoVQ: posts small blind $0.25
+ciXH35zeafrjg1W6wiBTg: posts big blind $0.50
*** HOLE CARDS ***
ndd1nfncBkWNitBnsfCoVQ: folds
+ciXH35zeafrjg1W6wiBTg collected $0.50 from pot
+ciXH35zeafrjg1W6wiBTg: doesn't show hand
*** SUMMARY ***
Total pot $0.50 | Rake $0
Seat 1: ndd1nfncBkWNitBnsfCoVQ (button) (small blind) folded before Flop
Seat 2: +ciXH35zeafrjg1W6wiBTg (big blind) collected ($0.50)



PokerStars Game #59939384476:  Hold'em No Limit ($0.25/$0.50) - 2009/07/01 0:38:29 ET
Table '+dXkOAQyS8j9PQZusUTMpg' 2-max Seat #2 is the button
Seat 1: XFa6sBGjP2gxoIvxR3fZIg ($48.75 in chips)
Seat 2: 5IBeOgaApY1Bvzv2P8X4EA ($142.60 in chips)
5IBeOgaApY1Bvzv2P8X4EA: posts small blind $0.25
XFa6sBGjP2gxoIvxR3fZIg: posts big blind $0.50
*** HOLE CARDS ***
5IBeOgaApY1Bvzv2P8X4EA: folds
XFa6sBGjP2gxoIvxR3fZIg collected $0.50 from pot
*** SUMMARY ***
Total pot $0.50 | Rake $0
Seat 1: XFa6sBGjP2gxoIvxR3fZIg (big blind) collected ($0.50)
Seat 2: 5IBeOgaApY1Bvzv2P8X4EA (button) (small blind) folded before Flop



PokerStars Game #59939384348:  Hold'em No Limit ($0.25/$0.50) - 2009/07/01 0:38:29 ET
Table 'ibNfFy0bCzuBaUORla0aGw' 9-max Seat #8 is the button
Seat 1: xZCXQSXlrZkp3pZizzVXCw ($53.95 in chips)
Seat 2: 90Wb75h3W1BRpbqVnuk8gw ($59.65 in chips)
Seat 3: dDaHs3X8+fe3bIkRU0cbrw ($40.90 in chips)
Seat 4: YBN054X4blmis+B2bBlC0g ($24.20 in chips)
Seat 5: GIJAc9kPrLZHLSX8Q6i99w ($24.50 in chips)
Seat 6: 8n9jQLh3cZKbsmr5PIjgiQ ($36.25 in chips)
Seat 7: HZkVla4kK2SI42CVrPZ/ig ($11.75 in chips)
Seat 8: xUrN9TWLq4m5V+OXY7KUUA ($50 in chips)
Seat 9: pFtzb1sR4b0d1aw6aIRgDg ($50.25 in chips)
pFtzb1sR4b0d1aw6aIRgDg: posts small blind $0.25
xZCXQSXlrZkp3pZizzVXCw: posts big blind $0.50
*** HOLE CARDS ***
90Wb75h3W1BRpbqVnuk8gw: folds
dDaHs3X8+fe3bIkRU0cbrw: folds
YBN054X4blmis+B2bBlC0g: folds
GIJAc9kPrLZHLSX8Q6i99w: folds
8n9jQLh3cZKbsmr5PIjgiQ: calls $0.50
HZkVla4kK2SI42CVrPZ/ig: folds
xUrN9TWLq4m5V+OXY7KUUA: raises $2 to $2.50
pFtzb1sR4b0d1aw6aIRgDg: folds
xZCXQSXlrZkp3pZizzVXCw: folds
8n9jQLh3cZKbsmr5PIjgiQ: folds
xUrN9TWLq4m5V+OXY7KUUA collected $1.75 from pot
*** SUMMARY ***
Total pot $1.75 | Rake $0
Seat 1: xZCXQSXlrZkp3pZizzVXCw (big blind) folded before Flop
Seat 2: 90Wb75h3W1BRpbqVnuk8gw folded before Flop (didn't bet)
Seat 3: dDaHs3X8+fe3bIkRU0cbrw folded before Flop (didn't bet)
Seat 4: YBN054X4blmis+B2bBlC0g folded before Flop (didn't bet)
Seat 5: GIJAc9kPrLZHLSX8Q6i99w folded before Flop (didn't bet)
Seat 6: 8n9jQLh3cZKbsmr5PIjgiQ folded before Flop
Seat 7: HZkVla4kK2SI42CVrPZ/ig folded before Flop (didn't bet)
Seat 8: xUrN9TWLq4m5V+OXY7KUUA (button) collected ($1.75)
Seat 9: pFtzb1sR4b0d1aw6aIRgDg (small blind) folded before Flop



PokerStars Game #59939384828:  Hold'em No Limit ($0.25/$0.50) - 2009/07/01 0:38:30 ET
Table 'c/CRn+68J3Y8KxD5g1ek2Q' 2-max Seat #2 is the button
Seat 1: 46qCyJ6evTkHo9al5sBMNA ($241.20 in chips)
Seat 2: BypVLsYQt3ePFm2xQL/dOA ($134.60 in chips)
BypVLsYQt3ePFm2xQL/dOA: posts small blind $0.25
46qCyJ6evTkHo9al5sBMNA: posts big blind $0.50
*** HOLE CARDS ***
BypVLsYQt3ePFm2xQL/dOA: raises $1.50 to $2
46qCyJ6evTkHo9al5sBMNA: calls $1.50
*** FLOP *** [2c 9h 9s]
46qCyJ6evTkHo9al5sBMNA: checks
BypVLsYQt3ePFm2xQL/dOA: checks
*** TURN *** [2c 9h 9s] [Qs]
46qCyJ6evTkHo9al5sBMNA: checks
BypVLsYQt3ePFm2xQL/dOA: bets $3
46qCyJ6evTkHo9al5sBMNA: folds
BypVLsYQt3ePFm2xQL/dOA collected $3.80 from pot
BypVLsYQt3ePFm2xQL/dOA: doesn't show hand
*** SUMMARY ***
Total pot $4 | Rake $0.20
Board [2c 9h 9s Qs]
Seat 1: 46qCyJ6evTkHo9al5sBMNA (big blind) folded on the Turn
Seat 2: BypVLsYQt3ePFm2xQL/dOA (button) (small blind) collected ($3.80)



PokerStars Game #59939387306:  Hold'em No Limit ($0.25/$0.50) - 2009/07/01 0:38:33 ET
Table 'IeNZOZQ4T6oiaHqFeo6yIA' 2-max Seat #2 is the button
Seat 1: ndd1nfncBkWNitBnsfCoVQ ($50 in chips)
Seat 2: A91IUl5JaZROhtfCtnnwYw ($94.20 in chips)
A91IUl5JaZROhtfCtnnwYw: posts small blind $0.25
ndd1nfncBkWNitBnsfCoVQ: posts big blind $0.50
*** HOLE CARDS ***
A91IUl5JaZROhtfCtnnwYw: raises $0.50 to $1
ndd1nfncBkWNitBnsfCoVQ: calls $0.50
*** FLOP *** [6d Jd 8h]
ndd1nfncBkWNitBnsfCoVQ: checks
A91IUl5JaZROhtfCtnnwYw: checks
*** TURN *** [6d Jd 8h] [7c]
ndd1nfncBkWNitBnsfCoVQ: checks
A91IUl5JaZROhtfCtnnwYw: checks
*** RIVER *** [6d Jd 8h 7c] [Ks]
ndd1nfncBkWNitBnsfCoVQ: checks
A91IUl5JaZROhtfCtnnwYw: checks
*** SHOW DOWN ***
ndd1nfncBkWNitBnsfCoVQ: shows [Ah 6h] (a pair of Sixes)
A91IUl5JaZROhtfCtnnwYw: mucks hand
ndd1nfncBkWNitBnsfCoVQ collected $1.90 from pot
*** SUMMARY ***
Total pot $2 | Rake $0.10
Board [6d Jd 8h 7c Ks]
Seat 1: ndd1nfncBkWNitBnsfCoVQ (big blind) showed [Ah 6h] and won ($1.90) with a pair of Sixes
Seat 2: A91IUl5JaZROhtfCtnnwYw (button) (small blind) mucked



PokerStars Game #59939387616:  Hold'em No Limit ($0.25/$0.50) - 2009/07/01 0:38:34 ET
Table 'tyR5AZNKV8Aadbrnrnlg7g' 6-max Seat #3 is the button
Seat 1: R+KjpH/wSjDLhtIy9+edNA ($89.20 in chips)
Seat 2: BAjwVL+zKKd0s0fAWstzQQ ($25.35 in chips)
Seat 3: tdOvWynovql5imfooroLMg ($47.75 in chips)
Seat 4: Rt6KgtZ8YaJoTc3FPim00w ($81.95 in chips)
Seat 6: ZKazl1hGaPiapDXincgi2Q ($15.65 in chips)
Rt6KgtZ8YaJoTc3FPim00w: posts small blind $0.25
ZKazl1hGaPiapDXincgi2Q: posts big blind $0.50
*** HOLE CARDS ***
R+KjpH/wSjDLhtIy9+edNA: folds
BAjwVL+zKKd0s0fAWstzQQ: folds
tdOvWynovql5imfooroLMg: folds
Rt6KgtZ8YaJoTc3FPim00w: folds
ZKazl1hGaPiapDXincgi2Q collected $0.50 from pot
ZKazl1hGaPiapDXincgi2Q: doesn't show hand
*** SUMMARY ***
Total pot $0.50 | Rake $0
Seat 1: R+KjpH/wSjDLhtIy9+edNA folded before Flop (didn't bet)
Seat 2: BAjwVL+zKKd0s0fAWstzQQ folded before Flop (didn't bet)
Seat 3: tdOvWynovql5imfooroLMg (button) folded before Flop (didn't bet)
Seat 4: Rt6KgtZ8YaJoTc3FPim00w (small blind) folded before Flop
Seat 6: ZKazl1hGaPiapDXincgi2Q (big blind) collected ($0.50)



PokerStars Game #59939388440:  Hold'em No Limit ($0.25/$0.50) - 2009/07/01 0:38:35 ET
Table '+111aLuBwnz8YVYSA7J1jA' 2-max Seat #2 is the button
Seat 1: ndd1nfncBkWNitBnsfCoVQ ($93.15 in chips)
Seat 2: +ciXH35zeafrjg1W6wiBTg ($54.60 in chips)
+ciXH35zeafrjg1W6wiBTg: posts small blind $0.25
ndd1nfncBkWNitBnsfCoVQ: posts big blind $0.50
*** HOLE CARDS ***
+ciXH35zeafrjg1W6wiBTg: raises $1 to $1.50
ndd1nfncBkWNitBnsfCoVQ: folds
+ciXH35zeafrjg1W6wiBTg collected $1 from pot
+ciXH35zeafrjg1W6wiBTg: doesn't show hand
*** SUMMARY ***
Total pot $1 | Rake $0
Seat 1: ndd1nfncBkWNitBnsfCoVQ (big blind) folded before Flop
Seat 2: +ciXH35zeafrjg1W6wiBTg (button) (small blind) collected ($1)



PokerStars Game #59939388716:  Hold'em No Limit ($0.25/$0.50) - 2009/07/01 0:38:36 ET
Table 'hWT2kq66tnKEpD26cia6fQ' 2-max Seat #2 is the button
Seat 1: q+vRKwm51mnr6kxX/161WQ ($55.15 in chips)
Seat 2: dkC7J+qbyqk0qCcmJbEPPw ($59.60 in chips)
dkC7J+qbyqk0qCcmJbEPPw: posts small blind $0.25
q+vRKwm51mnr6kxX/161WQ: posts big blind $0.50
*** HOLE CARDS ***
dkC7J+qbyqk0qCcmJbEPPw: folds
q+vRKwm51mnr6kxX/161WQ collected $0.50 from pot
q+vRKwm51mnr6kxX/161WQ: doesn't show hand
*** SUMMARY ***
Total pot $0.50 | Rake $0
Seat 1: q+vRKwm51mnr6kxX/161WQ (big blind) collected ($0.50)
Seat 2: dkC7J+qbyqk0qCcmJbEPPw (button) (small blind) folded before Flop



PokerStars Game #59939388780:  Hold'em No Limit ($0.25/$0.50) - 2009/07/01 0:38:36 ET
Table '+dXkOAQyS8j9PQZusUTMpg' 2-max Seat #1 is the button
Seat 1: XFa6sBGjP2gxoIvxR3fZIg ($49 in chips)
Seat 2: 5IBeOgaApY1Bvzv2P8X4EA ($142.35 in chips)
XFa6sBGjP2gxoIvxR3fZIg: posts small blind $0.25
5IBeOgaApY1Bvzv2P8X4EA: posts big blind $0.50
*** HOLE CARDS ***
XFa6sBGjP2gxoIvxR3fZIg: raises $1 to $1.50
5IBeOgaApY1Bvzv2P8X4EA: folds
XFa6sBGjP2gxoIvxR3fZIg collected $1 from pot
*** SUMMARY ***
Total pot $1 | Rake $0
Seat 1: XFa6sBGjP2gxoIvxR3fZIg (button) (small blind) collected ($1)
Seat 2: 5IBeOgaApY1Bvzv2P8X4EA (big blind) folded before Flop



PokerStars Game #59939388810:  Hold'em No Limit ($0.25/$0.50) - 2009/07/01 0:38:36 ET
Table '3FhG0gl3kMX3wBEEqj+wnQ' 9-max Seat #7 is the button
Seat 1: e0J9pdCNUDTCG031RnXqLA ($21.15 in chips)
Seat 2: 7cYQ+syUWjl38ty/ICOMhw ($50.40 in chips)
Seat 3: HZkVla4kK2SI42CVrPZ/ig ($15.95 in chips)
Seat 4: bjvJtA9Hqscfznq66txaOQ ($9.25 in chips)
Seat 5: gsyXT42WLEcOS4DdEk2wlw ($29.25 in chips)
Seat 7: mSD1pginDsyHG5PDfqzphw ($10 in chips)
Seat 8: j3K/Jujr7PY4ZM2RZvlH6A ($54.55 in chips)
Seat 9: L5e2lrPLQm1Pqx30IIZ/Fw ($10.10 in chips)
j3K/Jujr7PY4ZM2RZvlH6A: posts small blind $0.25
L5e2lrPLQm1Pqx30IIZ/Fw: posts big blind $0.50
997ViqAtWn1FPjJqcffwcA: sits out
*** HOLE CARDS ***
e0J9pdCNUDTCG031RnXqLA: folds
7cYQ+syUWjl38ty/ICOMhw: calls $0.50
HZkVla4kK2SI42CVrPZ/ig: folds
bjvJtA9Hqscfznq66txaOQ: folds
gsyXT42WLEcOS4DdEk2wlw: folds
mSD1pginDsyHG5PDfqzphw: folds
j3K/Jujr7PY4ZM2RZvlH6A: folds
L5e2lrPLQm1Pqx30IIZ/Fw: checks
*** FLOP *** [Kc As 8c]
L5e2lrPLQm1Pqx30IIZ/Fw: checks
7cYQ+syUWjl38ty/ICOMhw: bets $1
L5e2lrPLQm1Pqx30IIZ/Fw: folds
7cYQ+syUWjl38ty/ICOMhw collected $1.20 from pot
*** SUMMARY ***
Total pot $1.25 | Rake $0.05
Board [Kc As 8c]
Seat 1: e0J9pdCNUDTCG031RnXqLA folded before Flop (didn't bet)
Seat 2: 7cYQ+syUWjl38ty/ICOMhw collected ($1.20)
Seat 3: HZkVla4kK2SI42CVrPZ/ig folded before Flop (didn't bet)
Seat 4: bjvJtA9Hqscfznq66txaOQ folded before Flop (didn't bet)
Seat 5: gsyXT42WLEcOS4DdEk2wlw folded before Flop (didn't bet)
Seat 7: mSD1pginDsyHG5PDfqzphw (button) folded before Flop (didn't bet)
Seat 8: j3K/Jujr7PY4ZM2RZvlH6A (small blind) folded before Flop
Seat 9: L5e2lrPLQm1Pqx30IIZ/Fw (big blind) folded on the Flop



PokerStars Game #59939390250:  Hold'em No Limit ($0.25/$0.50) - 2009/07/01 0:38:39 ET
Table 'E7bWJ45aoFXRpyRv2gw+Ig' 2-max Seat #2 is the button
Seat 1: FRkiRasEGlHUeLrEl+k/nA ($50 in chips)
Seat 2: 3Wro85I7472vJ4Wkpneo9A ($146.70 in chips)
3Wro85I7472vJ4Wkpneo9A: posts small blind $0.25
FRkiRasEGlHUeLrEl+k/nA: posts big blind $0.50
*** HOLE CARDS ***
3Wro85I7472vJ4Wkpneo9A: calls $0.25
FRkiRasEGlHUeLrEl+k/nA: raises $1 to $1.50
3Wro85I7472vJ4Wkpneo9A: calls $1
*** FLOP *** [Js Tc 6c]
FRkiRasEGlHUeLrEl+k/nA: checks
3Wro85I7472vJ4Wkpneo9A: bets $2
FRkiRasEGlHUeLrEl+k/nA: folds
3Wro85I7472vJ4Wkpneo9A collected $2.85 from pot
3Wro85I7472vJ4Wkpneo9A: doesn't show hand
*** SUMMARY ***
Total pot $3 | Rake $0.15
Board [Js Tc 6c]
Seat 1: FRkiRasEGlHUeLrEl+k/nA (big blind) folded on the Flop
Seat 2: 3Wro85I7472vJ4Wkpneo9A (button) (small blind) collected ($2.85)



PokerStars Game #59939391810:  Hold'em No Limit ($0.25/$0.50) - 2009/07/01 0:38:40 ET
Table 'EiNh8p/wGJ1FP575iMFnqg' 9-max Seat #7 is the button
Seat 1: r3ZqM1Mi0W3y4hOdssE+Sg ($50.15 in chips)
Seat 2: 8ehL7qlZzjgUh2H35iiWLw ($51.25 in chips)
Seat 3: ymLPoEIl7UL3TvZYmnadxQ ($49.35 in chips)
Seat 5: M+7+BTmX5vZatHVuoRB1nA ($85.35 in chips)
Seat 6: 3UmXLy3GfjC3EkOebduerQ ($53.90 in chips)
Seat 7: 997ViqAtWn1FPjJqcffwcA ($50 in chips)
Seat 8: KrPAGRACBg+w0M//SXe8Ag ($11.60 in chips)
Seat 9: OMwFJ4pF0xk2Ru/AJiFeFw ($101 in chips)
KrPAGRACBg+w0M//SXe8Ag: posts small blind $0.25
OMwFJ4pF0xk2Ru/AJiFeFw: posts big blind $0.50
Lacher64: sits out
*** HOLE CARDS ***
r3ZqM1Mi0W3y4hOdssE+Sg: folds
8ehL7qlZzjgUh2H35iiWLw: raises $1.50 to $2
ymLPoEIl7UL3TvZYmnadxQ: folds
M+7+BTmX5vZatHVuoRB1nA: folds
3UmXLy3GfjC3EkOebduerQ: folds
997ViqAtWn1FPjJqcffwcA: folds
KrPAGRACBg+w0M//SXe8Ag: folds
OMwFJ4pF0xk2Ru/AJiFeFw: folds
8ehL7qlZzjgUh2H35iiWLw collected $1.25 from pot
8ehL7qlZzjgUh2H35iiWLw: doesn't show hand
*** SUMMARY ***
Total pot $1.25 | Rake $0
Seat 1: r3ZqM1Mi0W3y4hOdssE+Sg folded before Flop (didn't bet)
Seat 2: 8ehL7qlZzjgUh2H35iiWLw collected ($1.25)
Seat 3: ymLPoEIl7UL3TvZYmnadxQ folded before Flop (didn't bet)
Seat 5: M+7+BTmX5vZatHVuoRB1nA folded before Flop (didn't bet)
Seat 6: 3UmXLy3GfjC3EkOebduerQ folded before Flop (didn't bet)
Seat 7: 997ViqAtWn1FPjJqcffwcA (button) folded before Flop (didn't bet)
Seat 8: KrPAGRACBg+w0M//SXe8Ag (small blind) folded before Flop
Seat 9: OMwFJ4pF0xk2Ru/AJiFeFw (big blind) folded before Flop



