PokerStars Game #59939391964:  Hold'em No Limit ($0.25/$0.50) - 2009/07/01 0:38:41 ET
Table '/cQuAT3ef4t+PGrXiNhGaQ' 9-max Seat #5 is the button
Seat 1: HZkVla4kK2SI42CVrPZ/ig ($6 in chips)
Seat 2: jXGruyaMqirTaTXNOvBdew ($70.65 in chips)
Seat 3: g4k0NXISyLCqaSWZDBjfEg ($53.65 in chips)
Seat 4: OWP/DOu+PlPK6ZZ3zYa0HA ($39.90 in chips)
Seat 5: 5SgaHdWixdClWvaEG+KUjQ ($28.35 in chips)
Seat 6: APYIOyK/4AGb+kIwlOUNBQ ($39.25 in chips)
Seat 7: J0W5D97jl5VLky+IoPvDeA ($114.90 in chips)
Seat 8: W3ingbA178eb7J5rt1PuIQ ($28.95 in chips)
APYIOyK/4AGb+kIwlOUNBQ: posts small blind $0.25
J0W5D97jl5VLky+IoPvDeA: posts big blind $0.50
AjV5McH1KMMclY26QdLM5w: sits out
*** HOLE CARDS ***
W3ingbA178eb7J5rt1PuIQ: folds
HZkVla4kK2SI42CVrPZ/ig: folds
jXGruyaMqirTaTXNOvBdew: folds
g4k0NXISyLCqaSWZDBjfEg: raises $1 to $1.50
OWP/DOu+PlPK6ZZ3zYa0HA: folds
5SgaHdWixdClWvaEG+KUjQ: folds
APYIOyK/4AGb+kIwlOUNBQ: folds
J0W5D97jl5VLky+IoPvDeA: folds
g4k0NXISyLCqaSWZDBjfEg collected $1.25 from pot
*** SUMMARY ***
Total pot $1.25 | Rake $0
Seat 1: HZkVla4kK2SI42CVrPZ/ig folded before Flop (didn't bet)
Seat 2: jXGruyaMqirTaTXNOvBdew folded before Flop (didn't bet)
Seat 3: g4k0NXISyLCqaSWZDBjfEg collected ($1.25)
Seat 4: OWP/DOu+PlPK6ZZ3zYa0HA folded before Flop (didn't bet)
Seat 5: 5SgaHdWixdClWvaEG+KUjQ (button) folded before Flop (didn't bet)
Seat 6: APYIOyK/4AGb+kIwlOUNBQ (small blind) folded before Flop
Seat 7: J0W5D97jl5VLky+IoPvDeA (big blind) folded before Flop
Seat 8: W3ingbA178eb7J5rt1PuIQ folded before Flop (didn't bet)



PokerStars Game #59939392758:  Hold'em No Limit ($0.25/$0.50) - 2009/07/01 0:38:42 ET
Table 'hWT2kq66tnKEpD26cia6fQ' 2-max Seat #1 is the button
Seat 1: q+vRKwm51mnr6kxX/161WQ ($55.40 in chips)
Seat 2: dkC7J+qbyqk0qCcmJbEPPw ($59.35 in chips)
q+vRKwm51mnr6kxX/161WQ: posts small blind $0.25
dkC7J+qbyqk0qCcmJbEPPw: posts big blind $0.50
*** HOLE CARDS ***
q+vRKwm51mnr6kxX/161WQ: raises $1 to $1.50
dkC7J+qbyqk0qCcmJbEPPw: folds
q+vRKwm51mnr6kxX/161WQ collected $1 from pot
q+vRKwm51mnr6kxX/161WQ: doesn't show hand
*** SUMMARY ***
Total pot $1 | Rake $0
Seat 1: q+vRKwm51mnr6kxX/161WQ (button) (small blind) collected ($1)
Seat 2: dkC7J+qbyqk0qCcmJbEPPw (big blind) folded before Flop



PokerStars Game #59939392982:  Hold'em No Limit ($0.25/$0.50) - 2009/07/01 0:38:42 ET
Table 'NCiXr0d5CEKBQr/cZgLhbA' 9-max Seat #9 is the button
Seat 1: pFtzb1sR4b0d1aw6aIRgDg ($50 in chips)
Seat 2: ulxuJchBV9iguXg0FUonfg ($49.80 in chips)
Seat 3: xZCXQSXlrZkp3pZizzVXCw ($50 in chips)
Seat 4: 5k9fvXD9suIgCxU4HLQjTw ($57.70 in chips)
Seat 5: zE9cVigS2nW/Ljy4K4bUQA ($39.95 in chips)
Seat 6: SKnJuWHScqetA/qG5p+wCg ($30 in chips)
Seat 7: M+7+BTmX5vZatHVuoRB1nA ($46 in chips)
Seat 8: 1MJUKc3cc0QmUoz1JZLR2w ($52.80 in chips)
Seat 9: 4WLZvqBn5qv5tds5kt5A1Q ($48.55 in chips)
pFtzb1sR4b0d1aw6aIRgDg: posts small blind $0.25
ulxuJchBV9iguXg0FUonfg: posts big blind $0.50
*** HOLE CARDS ***
xZCXQSXlrZkp3pZizzVXCw: raises $1 to $1.50
5k9fvXD9suIgCxU4HLQjTw: folds
zE9cVigS2nW/Ljy4K4bUQA: folds
SKnJuWHScqetA/qG5p+wCg: folds
M+7+BTmX5vZatHVuoRB1nA: folds
1MJUKc3cc0QmUoz1JZLR2w: folds
SKnJuWHScqetA/qG5p+wCg said, "idiot"
4WLZvqBn5qv5tds5kt5A1Q: folds
pFtzb1sR4b0d1aw6aIRgDg: folds
ulxuJchBV9iguXg0FUonfg: folds
xZCXQSXlrZkp3pZizzVXCw collected $1.25 from pot
*** SUMMARY ***
Total pot $1.25 | Rake $0
Seat 1: pFtzb1sR4b0d1aw6aIRgDg (small blind) folded before Flop
Seat 2: ulxuJchBV9iguXg0FUonfg (big blind) folded before Flop
Seat 3: xZCXQSXlrZkp3pZizzVXCw collected ($1.25)
Seat 4: 5k9fvXD9suIgCxU4HLQjTw folded before Flop (didn't bet)
Seat 5: zE9cVigS2nW/Ljy4K4bUQA folded before Flop (didn't bet)
Seat 6: SKnJuWHScqetA/qG5p+wCg folded before Flop (didn't bet)
Seat 7: M+7+BTmX5vZatHVuoRB1nA folded before Flop (didn't bet)
Seat 8: 1MJUKc3cc0QmUoz1JZLR2w folded before Flop (didn't bet)
Seat 9: 4WLZvqBn5qv5tds5kt5A1Q (button) folded before Flop (didn't bet)



PokerStars Game #59939393578:  Hold'em No Limit ($0.25/$0.50) - 2009/07/01 0:38:43 ET
Table '+dXkOAQyS8j9PQZusUTMpg' 2-max Seat #2 is the button
Seat 1: XFa6sBGjP2gxoIvxR3fZIg ($49.50 in chips)
Seat 2: 5IBeOgaApY1Bvzv2P8X4EA ($141.85 in chips)
5IBeOgaApY1Bvzv2P8X4EA: posts small blind $0.25
XFa6sBGjP2gxoIvxR3fZIg: posts big blind $0.50
*** HOLE CARDS ***
5IBeOgaApY1Bvzv2P8X4EA: calls $0.25
XFa6sBGjP2gxoIvxR3fZIg: raises $2 to $2.50
5IBeOgaApY1Bvzv2P8X4EA: calls $2
*** FLOP *** [Qh Qc 7d]
5IBeOgaApY1Bvzv2P8X4EA said, "iaces"
5IBeOgaApY1Bvzv2P8X4EA said, "?"
XFa6sBGjP2gxoIvxR3fZIg: checks
5IBeOgaApY1Bvzv2P8X4EA: checks
*** TURN *** [Qh Qc 7d] [4h]
5IBeOgaApY1Bvzv2P8X4EA said, "jajajaj"
XFa6sBGjP2gxoIvxR3fZIg: checks
5IBeOgaApY1Bvzv2P8X4EA: checks
*** RIVER *** [Qh Qc 7d 4h] [5h]
XFa6sBGjP2gxoIvxR3fZIg: bets $0.50
5IBeOgaApY1Bvzv2P8X4EA: calls $0.50
*** SHOW DOWN ***
XFa6sBGjP2gxoIvxR3fZIg: shows [As 5d] (two pair, Queens and Fives)
5IBeOgaApY1Bvzv2P8X4EA: shows [Kh 7s] (two pair, Queens and Sevens)
5IBeOgaApY1Bvzv2P8X4EA collected $5.75 from pot
*** SUMMARY ***
Total pot $6 | Rake $0.25
Board [Qh Qc 7d 4h 5h]
Seat 1: XFa6sBGjP2gxoIvxR3fZIg (big blind) showed [As 5d] and lost with two pair, Queens and Fives
Seat 2: 5IBeOgaApY1Bvzv2P8X4EA (button) (small blind) showed [Kh 7s] and won ($5.75) with two pair, Queens and Sevens



PokerStars Game #59939394022:  Hold'em No Limit ($0.25/$0.50) - 2009/07/01 0:38:44 ET
Table '+111aLuBwnz8YVYSA7J1jA' 2-max Seat #1 is the button
Seat 1: ndd1nfncBkWNitBnsfCoVQ ($92.65 in chips)
Seat 2: +ciXH35zeafrjg1W6wiBTg ($55.10 in chips)
ndd1nfncBkWNitBnsfCoVQ: posts small blind $0.25
+ciXH35zeafrjg1W6wiBTg: posts big blind $0.50
*** HOLE CARDS ***
ndd1nfncBkWNitBnsfCoVQ: raises $1 to $1.50
+ciXH35zeafrjg1W6wiBTg: calls $1
*** FLOP *** [Jh 9c 4d]
+ciXH35zeafrjg1W6wiBTg: checks
ndd1nfncBkWNitBnsfCoVQ: checks
*** TURN *** [Jh 9c 4d] [Td]
+ciXH35zeafrjg1W6wiBTg: bets $1.50
ndd1nfncBkWNitBnsfCoVQ: folds
+ciXH35zeafrjg1W6wiBTg collected $2.85 from pot
+ciXH35zeafrjg1W6wiBTg: doesn't show hand
*** SUMMARY ***
Total pot $3 | Rake $0.15
Board [Jh 9c 4d Td]
Seat 1: ndd1nfncBkWNitBnsfCoVQ (button) (small blind) folded on the Turn
Seat 2: +ciXH35zeafrjg1W6wiBTg (big blind) collected ($2.85)



PokerStars Game #59939394348:  Hold'em No Limit ($0.25/$0.50) - 2009/07/01 0:38:44 ET
Table 'tyR5AZNKV8Aadbrnrnlg7g' 6-max Seat #4 is the button
Seat 1: R+KjpH/wSjDLhtIy9+edNA ($89.20 in chips)
Seat 2: BAjwVL+zKKd0s0fAWstzQQ ($25.35 in chips)
Seat 3: tdOvWynovql5imfooroLMg ($47.75 in chips)
Seat 4: Rt6KgtZ8YaJoTc3FPim00w ($81.70 in chips)
Seat 6: ZKazl1hGaPiapDXincgi2Q ($15.90 in chips)
ZKazl1hGaPiapDXincgi2Q: posts small blind $0.25
R+KjpH/wSjDLhtIy9+edNA: posts big blind $0.50
*** HOLE CARDS ***
BAjwVL+zKKd0s0fAWstzQQ: calls $0.50
tdOvWynovql5imfooroLMg: calls $0.50
Ek4w9XqBXqK5jBUQeLedGw joins the table at seat #5
Rt6KgtZ8YaJoTc3FPim00w: raises $2 to $2.50
ZKazl1hGaPiapDXincgi2Q: folds
R+KjpH/wSjDLhtIy9+edNA: folds
BAjwVL+zKKd0s0fAWstzQQ: folds
tdOvWynovql5imfooroLMg: calls $2
*** FLOP *** [Ks 2s 9c]
tdOvWynovql5imfooroLMg: checks
Rt6KgtZ8YaJoTc3FPim00w: bets $4.50
tdOvWynovql5imfooroLMg: folds
Rt6KgtZ8YaJoTc3FPim00w collected $5.95 from pot
Rt6KgtZ8YaJoTc3FPim00w: doesn't show hand
*** SUMMARY ***
Total pot $6.25 | Rake $0.30
Board [Ks 2s 9c]
Seat 1: R+KjpH/wSjDLhtIy9+edNA (big blind) folded before Flop
Seat 2: BAjwVL+zKKd0s0fAWstzQQ folded before Flop
Seat 3: tdOvWynovql5imfooroLMg folded on the Flop
Seat 4: Rt6KgtZ8YaJoTc3FPim00w (button) collected ($5.95)
Seat 6: ZKazl1hGaPiapDXincgi2Q (small blind) folded before Flop



PokerStars Game #59939394828:  Hold'em No Limit ($0.25/$0.50) - 2009/07/01 0:38:45 ET
Table 'MJxeZCzYELxiIsyUZyT0jw' 6-max Seat #4 is the button
Seat 1: tdOvWynovql5imfooroLMg ($50 in chips)
Seat 2: dB6jzDlJmET84VMWw1mTRA ($50 in chips)
Seat 3: JQZew0FjzS19kTjeNtrE+A ($52.30 in chips)
Seat 4: lP7Q6pewz4C2RsAfKsjdWw ($34.40 in chips)
Seat 5: 3jvoOXNtXE90w2BdfNZwZQ ($50 in chips)
Seat 6: TTx3CHxyi0SObcHyMJRp5w ($61.20 in chips)
3jvoOXNtXE90w2BdfNZwZQ: posts small blind $0.25
TTx3CHxyi0SObcHyMJRp5w: posts big blind $0.50
*** HOLE CARDS ***
tdOvWynovql5imfooroLMg: raises $1.25 to $1.75
dB6jzDlJmET84VMWw1mTRA: folds
JQZew0FjzS19kTjeNtrE+A: calls $1.75
lP7Q6pewz4C2RsAfKsjdWw: folds
3jvoOXNtXE90w2BdfNZwZQ: folds
TTx3CHxyi0SObcHyMJRp5w: folds
*** FLOP *** [Th Td Ah]
tdOvWynovql5imfooroLMg: bets $3
JQZew0FjzS19kTjeNtrE+A: folds
tdOvWynovql5imfooroLMg collected $4.05 from pot
*** SUMMARY ***
Total pot $4.25 | Rake $0.20
Board [Th Td Ah]
Seat 1: tdOvWynovql5imfooroLMg collected ($4.05)
Seat 2: dB6jzDlJmET84VMWw1mTRA folded before Flop (didn't bet)
Seat 3: JQZew0FjzS19kTjeNtrE+A folded on the Flop
Seat 4: lP7Q6pewz4C2RsAfKsjdWw (button) folded before Flop (didn't bet)
Seat 5: 3jvoOXNtXE90w2BdfNZwZQ (small blind) folded before Flop
Seat 6: TTx3CHxyi0SObcHyMJRp5w (big blind) folded before Flop



PokerStars Game #59939398478:  Hold'em No Limit ($0.25/$0.50) - 2009/07/01 0:38:51 ET
Table 'hWT2kq66tnKEpD26cia6fQ' 2-max Seat #2 is the button
Seat 1: q+vRKwm51mnr6kxX/161WQ ($55.90 in chips)
Seat 2: dkC7J+qbyqk0qCcmJbEPPw ($58.85 in chips)
dkC7J+qbyqk0qCcmJbEPPw: posts small blind $0.25
q+vRKwm51mnr6kxX/161WQ: posts big blind $0.50
*** HOLE CARDS ***
dkC7J+qbyqk0qCcmJbEPPw: folds
q+vRKwm51mnr6kxX/161WQ collected $0.50 from pot
q+vRKwm51mnr6kxX/161WQ: doesn't show hand
*** SUMMARY ***
Total pot $0.50 | Rake $0
Seat 1: q+vRKwm51mnr6kxX/161WQ (big blind) collected ($0.50)
Seat 2: dkC7J+qbyqk0qCcmJbEPPw (button) (small blind) folded before Flop



PokerStars Game #59939398920:  Hold'em No Limit ($0.25/$0.50) - 2009/07/01 0:38:52 ET
Table 'QOgaEqMcJ73pcUMMxoisUg' 6-max Seat #3 is the button
Seat 1: OZ6OtYh5Y53MCH/p0QTn5g ($54.20 in chips)
Seat 2: 4QfsCWthT/vSLirorNXqtg ($50 in chips)
Seat 3: Rt6KgtZ8YaJoTc3FPim00w ($76.75 in chips)
Seat 4: zAcsDhG/T128Vn7XGVSgKg ($57.65 in chips)
Seat 5: 6vNxrjjCl6FwfaaymM9jjg ($15.75 in chips)
Seat 6: pmE+2KJb4nffAVqjLIXxFg ($20.75 in chips)
zAcsDhG/T128Vn7XGVSgKg: posts small blind $0.25
6vNxrjjCl6FwfaaymM9jjg: posts big blind $0.50
*** HOLE CARDS ***
pmE+2KJb4nffAVqjLIXxFg: folds
OZ6OtYh5Y53MCH/p0QTn5g: folds
4QfsCWthT/vSLirorNXqtg: folds
Rt6KgtZ8YaJoTc3FPim00w: raises $1 to $1.50
zAcsDhG/T128Vn7XGVSgKg: folds
6vNxrjjCl6FwfaaymM9jjg: folds
Rt6KgtZ8YaJoTc3FPim00w collected $1.25 from pot
*** SUMMARY ***
Total pot $1.25 | Rake $0
Seat 1: OZ6OtYh5Y53MCH/p0QTn5g folded before Flop (didn't bet)
Seat 2: 4QfsCWthT/vSLirorNXqtg folded before Flop (didn't bet)
Seat 3: Rt6KgtZ8YaJoTc3FPim00w (button) collected ($1.25)
Seat 4: zAcsDhG/T128Vn7XGVSgKg (small blind) folded before Flop
Seat 5: 6vNxrjjCl6FwfaaymM9jjg (big blind) folded before Flop
Seat 6: pmE+2KJb4nffAVqjLIXxFg folded before Flop (didn't bet)



PokerStars Game #59939400468:  Hold'em No Limit ($0.25/$0.50) - 2009/07/01 0:38:54 ET
Table 'fx6MqwfYAj/Rt86hBz2L3Q' 9-max Seat #4 is the button
Seat 2: C3rGXblctNcWI6JYPHhaEg ($19.50 in chips)
Seat 3: iadBi5AEt7gTBXbDSSnMYQ ($44.55 in chips)
Seat 4: gPEN9Zp33YTm/mu9/SYP1w ($21.70 in chips)
Seat 5: iAISe3dVeua8PUn2wwgDHw ($43.10 in chips)
Seat 6: 5k9fvXD9suIgCxU4HLQjTw ($50 in chips)
Seat 7: bkXkL3pmapikPQQRNPZSEA ($24.50 in chips)
Seat 8: CAuekkxPVzBL9SK4Tjjbuw ($29 in chips)
Seat 9: HZkVla4kK2SI42CVrPZ/ig ($8.50 in chips)
iAISe3dVeua8PUn2wwgDHw: posts small blind $0.25
5k9fvXD9suIgCxU4HLQjTw: posts big blind $0.50
SegjDnMxWMujiD57ESNL+g: sits out
*** HOLE CARDS ***
bkXkL3pmapikPQQRNPZSEA: folds
CAuekkxPVzBL9SK4Tjjbuw: raises $1.50 to $2
HZkVla4kK2SI42CVrPZ/ig: folds
C3rGXblctNcWI6JYPHhaEg: calls $2
iadBi5AEt7gTBXbDSSnMYQ: folds
gPEN9Zp33YTm/mu9/SYP1w: folds
iAISe3dVeua8PUn2wwgDHw: calls $1.75
5k9fvXD9suIgCxU4HLQjTw: folds
*** FLOP *** [Kd 7h 4h]
iAISe3dVeua8PUn2wwgDHw: checks
CAuekkxPVzBL9SK4Tjjbuw: checks
C3rGXblctNcWI6JYPHhaEg: bets $1.50
iAISe3dVeua8PUn2wwgDHw: folds
CAuekkxPVzBL9SK4Tjjbuw: raises $2.50 to $4
C3rGXblctNcWI6JYPHhaEg: calls $2.50
*** TURN *** [Kd 7h 4h] [Jd]
CAuekkxPVzBL9SK4Tjjbuw: bets $4
C3rGXblctNcWI6JYPHhaEg: folds
CAuekkxPVzBL9SK4Tjjbuw collected $13.80 from pot
*** SUMMARY ***
Total pot $14.50 | Rake $0.70
Board [Kd 7h 4h Jd]
Seat 2: C3rGXblctNcWI6JYPHhaEg folded on the Turn
Seat 3: iadBi5AEt7gTBXbDSSnMYQ folded before Flop (didn't bet)
Seat 4: gPEN9Zp33YTm/mu9/SYP1w (button) folded before Flop (didn't bet)
Seat 5: iAISe3dVeua8PUn2wwgDHw (small blind) folded on the Flop
Seat 6: 5k9fvXD9suIgCxU4HLQjTw (big blind) folded before Flop
Seat 7: bkXkL3pmapikPQQRNPZSEA folded before Flop (didn't bet)
Seat 8: CAuekkxPVzBL9SK4Tjjbuw collected ($13.80)
Seat 9: HZkVla4kK2SI42CVrPZ/ig folded before Flop (didn't bet)



PokerStars Game #59939401402:  Hold'em No Limit ($0.25/$0.50) - 2009/07/01 0:38:55 ET
Table '99gCy/CZQwPIjZWH+BguQgE7bWJ45aoFXRpyRv2gw+Igeat #6 is the button
Seat 2: n6VQBu6crjYjy6DxNP1NZA ($19.70 in chips)
Seat 3: qEn9ijNGtuyTxamBf07hYg ($50 in chips)
Seat 4: bxLSulbgr8LmKNjOzw8URg ($63.45 in chips)
Seat 5: DSM67hHHq1XFoEOi9p8Alw ($47.75 in chips)
Seat 6: OcnLOMVFdy23jXnoTyaO5Q ($245.05 in chips)
Seat 7: 4dd+rKHhaMiTl5LEkADvQQ ($10 in chips)
Seat 8: 8ehL7qlZzjgUh2H35iiWLw ($50 in chips)
Seat 9: j3K/Jujr7PY4ZM2RZvlH6A ($86.40 in chips)
4dd+rKHhaMiTl5LEkADvQQ: posts small blind $0.25
8ehL7qlZzjgUh2H35iiWLw: posts big blind $0.50
RjBdQ6w31rgcy0o24VLR6w: sits out
*** HOLE CARDS ***
j3K/Jujr7PY4ZM2RZvlH6A: folds
n6VQBu6crjYjy6DxNP1NZA: folds
qEn9ijNGtuyTxamBf07hYg: folds
bxLSulbgr8LmKNjOzw8URg: folds
DSM67hHHq1XFoEOi9p8Alw: folds
OcnLOMVFdy23jXnoTyaO5Q: folds
OcnLOMVFdy23jXnoTyaO5Q is sitting out
4dd+rKHhaMiTl5LEkADvQQ: folds
8ehL7qlZzjgUh2H35iiWLw collected $0.50 from pot
8ehL7qlZzjgUh2H35iiWLw: doesn't show hand
*** SUMMARY ***
Total pot $0.50 | Rake $0
Seat 2: n6VQBu6crjYjy6DxNP1NZA folded before Flop (didn't bet)
Seat 3: qEn9ijNGtuyTxamBf07hYg folded before Flop (didn't bet)
Seat 4: bxLSulbgr8LmKNjOzw8URg folded before Flop (didn't bet)
Seat 5: DSM67hHHq1XFoEOi9p8Alw folded before Flop (didn't bet)
Seat 6: OcnLOMVFdy23jXnoTyaO5Q (button) folded before Flop (didn't bet)
Seat 7: 4dd+rKHhaMiTl5LEkADvQQ (small blind) folded before Flop
Seat 8: 8ehL7qlZzjgUh2H35iiWLw (big blind) collected ($0.50)
Seat 9: j3K/Jujr7PY4ZM2RZvlH6A folded before Flop (didn't bet)



PokerStars Game #59939401822:  Hold'em No Limit ($0.25/$0.50) - 2009/07/01 0:38:56 ET
Table 'BCN5su+SsXiy1zRMJi0SJw' 6-max Seat #3 is the button
Seat 1: crjGpJEzSZgD38FoE3VMGg ($50 in chips)
Seat 2: oU2kDCkT/gilYbHWrg7D8w ($13.65 in chips)
Seat 3: g+vwI6lMKpU2uteXSjOzVw ($18 in chips)
Seat 4: JY9CtoZTeav+mhWyxSSyJQ ($24.20 in chips)
Seat 5: IBNygaT1aa9Z1uPdJJilwA ($66.25 in chips)
Seat 6: b2symlOdL7+0c9Pj4N/KlA ($50 in chips)
JY9CtoZTeav+mhWyxSSyJQ: posts small blind $0.25
IBNygaT1aa9Z1uPdJJilwA: posts big blind $0.50
*** HOLE CARDS ***
oU2kDCkT/gilYbHWrg7D8w said, "nh"
JY9CtoZTeav+mhWyxSSyJQ said, "u2 ty"
b2symlOdL7+0c9Pj4N/KlA: folds
crjGpJEzSZgD38FoE3VMGg: folds
oU2kDCkT/gilYbHWrg7D8w: folds
g+vwI6lMKpU2uteXSjOzVw: raises $1.50 to $2
JY9CtoZTeav+mhWyxSSyJQ: folds
IBNygaT1aa9Z1uPdJJilwA: calls $1.50
*** FLOP *** [Qh Qc Ks]
oU2kDCkT/gilYbHWrg7D8w said, "thx"
IBNygaT1aa9Z1uPdJJilwA: checks
g+vwI6lMKpU2uteXSjOzVw: bets $2
oU2kDCkT/gilYbHWrg7D8w said, "except i lost"
oU2kDCkT/gilYbHWrg7D8w said, "lol"
IBNygaT1aa9Z1uPdJJilwA: folds
g+vwI6lMKpU2uteXSjOzVw collected $4.05 from pot
g+vwI6lMKpU2uteXSjOzVw: doesn't show hand
*** SUMMARY ***
Total pot $4.25 | Rake $0.20
Board [Qh Qc Ks]
Seat 1: crjGpJEzSZgD38FoE3VMGg folded before Flop (didn't bet)
Seat 2: oU2kDCkT/gilYbHWrg7D8w folded before Flop (didn't bet)
Seat 3: g+vwI6lMKpU2uteXSjOzVw (button) collected ($4.05)
Seat 4: JY9CtoZTeav+mhWyxSSyJQ (small blind) folded before Flop
Seat 5: IBNygaT1aa9Z1uPdJJilwA (big blind) folded on the Flop
Seat 6: b2symlOdL7+0c9Pj4N/KlA folded before Flop (didn't bet)



PokerStars Game #59939402080:  Hold'em No Limit ($0.25/$0.50) - 2009/07/01 0:38:57 ET
Table 'c/CRn+68J3Y8KxD5g1ek2Q' 2-max Seat #1 is the button
Seat 1: 46qCyJ6evTkHo9al5sBMNA ($239.20 in chips)
Seat 2: BypVLsYQt3ePFm2xQL/dOA ($136.40 in chips)
46qCyJ6evTkHo9al5sBMNA: posts small blind $0.25
BypVLsYQt3ePFm2xQL/dOA: posts big blind $0.50
*** HOLE CARDS ***
46qCyJ6evTkHo9al5sBMNA: raises $1 to $1.50
BypVLsYQt3ePFm2xQL/dOA: raises $2.50 to $4
46qCyJ6evTkHo9al5sBMNA: calls $2.50
*** FLOP *** [Kh 9h 7d]
BypVLsYQt3ePFm2xQL/dOA: bets $4
46qCyJ6evTkHo9al5sBMNA: calls $4
*** TURN *** [Kh 9h 7d] [3h]
BypVLsYQt3ePFm2xQL/dOA: bets $8.50
46qCyJ6evTkHo9al5sBMNA: calls $8.50
*** RIVER *** [Kh 9h 7d 3h] [6c]
BypVLsYQt3ePFm2xQL/dOA: bets $14.50
46qCyJ6evTkHo9al5sBMNA: calls $14.50
*** SHOW DOWN ***
BypVLsYQt3ePFm2xQL/dOA: shows [9d 9s] (three of a kind, Nines)
46qCyJ6evTkHo9al5sBMNA: mucks hand
BypVLsYQt3ePFm2xQL/dOA collected $61.50 from pot
*** SUMMARY ***
Total pot $62 | Rake $0.50
Board [Kh 9h 7d 3h 6c]
Seat 1: 46qCyJ6evTkHo9al5sBMNA (button) (small blind) mucked
Seat 2: BypVLsYQt3ePFm2xQL/dOA (big blind) showed [9d 9s] and won ($61.50) with three of a kind, Nines



PokerStars Game #59939403782:  Hold'em No Limit ($0.25/$0.50) - 2009/07/01 0:38:59 ET
Table 'IeNZOZQ4T6oiaHqFeo6yIA' 2-max Seat #1 is the button
Seat 1: ndd1nfncBkWNitBnsfCoVQ ($50.90 in chips)
Seat 2: A91IUl5JaZROhtfCtnnwYw ($93.20 in chips)
ndd1nfncBkWNitBnsfCoVQ: posts small blind $0.25
A91IUl5JaZROhtfCtnnwYw: posts big blind $0.50
*** HOLE CARDS ***
ndd1nfncBkWNitBnsfCoVQ: raises $1 to $1.50
A91IUl5JaZROhtfCtnnwYw: raises $1 to $2.50
ndd1nfncBkWNitBnsfCoVQ: folds
A91IUl5JaZROhtfCtnnwYw collected $3 from pot
A91IUl5JaZROhtfCtnnwYw: doesn't show hand
*** SUMMARY ***
Total pot $3 | Rake $0
Seat 1: ndd1nfncBkWNitBnsfCoVQ (button) (small blind) folded before Flop
Seat 2: A91IUl5JaZROhtfCtnnwYw (big blind) collected ($3)



PokerStars Game #59939404484:  Hold'em No Limit ($0.25/$0.50) - 2009/07/01 0:39:00 ET
Table 'E7bWJ45aoFXRpyRv2gw+Ig' 2-max Seat #1 is the button
Seat 1: FRkiRasEGlHUeLrEl+k/nA ($50 in chips)
Seat 2: 3Wro85I7472vJ4Wkpneo9A ($148.05 in chips)
FRkiRasEGlHUeLrEl+k/nA: posts small blind $0.25
3Wro85I7472vJ4Wkpneo9A: posts big blind $0.50
*** HOLE CARDS ***
FRkiRasEGlHUeLrEl+k/nA: raises $1 to $1.50
3Wro85I7472vJ4Wkpneo9A: calls $1
*** FLOP *** [8h Qh Js]
3Wro85I7472vJ4Wkpneo9A: checks
FRkiRasEGlHUeLrEl+k/nA: bets $1
3Wro85I7472vJ4Wkpneo9A: folds
FRkiRasEGlHUeLrEl+k/nA collected $2.85 from pot
*** SUMMARY ***
Total pot $3 | Rake $0.15
Board [8h Qh Js]
Seat 1: FRkiRasEGlHUeLrEl+k/nA (button) (small blind) collected ($2.85)
Seat 2: 3Wro85I7472vJ4Wkpneo9A (big blind) folded on the Flop



PokerStars Game #59939405332:  Hold'em No Limit ($0.25/$0.50) - 2009/07/01 0:39:01 ET
Table 'lSisgp6H7Fg1hH5VfjEjYQ' 9-max Seat #4 is the button
Seat 1: pEW8B6uXbdR47kfljMQ3+Q ($37.10 in chips)
Seat 2: UrcnkQOiLVk8BlKDPJSy7Q ($52.30 in chips)
Seat 3: aTkyjTh3w5YLWiIERupZOA ($41.70 in chips)
Seat 4: bwv/rbH/hHhPhY6u9mu04w ($23 in chips)
Seat 5: mSD1pginDsyHG5PDfqzphw ($11.60 in chips)
Seat 6: +k7T5ocke8UwavtgUHm+Cg ($31.05 in chips)
Seat 7: Y3DZ6qQlLeBhixDj4M9vmg ($8.75 in chips)
Seat 8: a4JDWmpFQkL10XfAyuF51A ($34.75 in chips)
mSD1pginDsyHG5PDfqzphw: posts small blind $0.25
+k7T5ocke8UwavtgUHm+Cg: posts big blind $0.50
gsyXT42WLEcOS4DdEk2wlw: sits out
*** HOLE CARDS ***
pEW8B6uXbdR47kfljMQ3+Q is disconnected
pEW8B6uXbdR47kfljMQ3+Q is connected
Y3DZ6qQlLeBhixDj4M9vmg: folds
a4JDWmpFQkL10XfAyuF51A: folds
pEW8B6uXbdR47kfljMQ3+Q: folds
UrcnkQOiLVk8BlKDPJSy7Q: folds
aTkyjTh3w5YLWiIERupZOA: folds
bwv/rbH/hHhPhY6u9mu04w: folds
mSD1pginDsyHG5PDfqzphw: folds
+k7T5ocke8UwavtgUHm+Cg collected $0.50 from pot
+k7T5ocke8UwavtgUHm+Cg: doesn't show hand
*** SUMMARY ***
Total pot $0.50 | Rake $0
Seat 1: pEW8B6uXbdR47kfljMQ3+Q folded before Flop (didn't bet)
Seat 2: UrcnkQOiLVk8BlKDPJSy7Q folded before Flop (didn't bet)
Seat 3: aTkyjTh3w5YLWiIERupZOA folded before Flop (didn't bet)
Seat 4: bwv/rbH/hHhPhY6u9mu04w (button) folded before Flop (didn't bet)
Seat 5: mSD1pginDsyHG5PDfqzphw (small blind) folded before Flop
Seat 6: +k7T5ocke8UwavtgUHm+Cg (big blind) collected ($0.50)
Seat 7: Y3DZ6qQlLeBhixDj4M9vmg folded before Flop (didn't bet)
Seat 8: a4JDWmpFQkL10XfAyuF51A folded before Flop (didn't bet)



PokerStars Game #59939405614:  Hold'em No Limit ($0.25/$0.50) - 2009/07/01 0:39:02 ET
Table '+111aLuBwnz8YVYSA7J1jA' 2-max Seat #2 is the button
Seat 1: ndd1nfncBkWNitBnsfCoVQ ($91.15 in chips)
Seat 2: +ciXH35zeafrjg1W6wiBTg ($56.45 in chips)
+ciXH35zeafrjg1W6wiBTg: posts small blind $0.25
ndd1nfncBkWNitBnsfCoVQ: posts big blind $0.50
*** HOLE CARDS ***
+ciXH35zeafrjg1W6wiBTg: raises $1 to $1.50
ndd1nfncBkWNitBnsfCoVQ: folds
+ciXH35zeafrjg1W6wiBTg collected $1 from pot
+ciXH35zeafrjg1W6wiBTg: doesn't show hand
*** SUMMARY ***
Total pot $1 | Rake $0
Seat 1: ndd1nfncBkWNitBnsfCoVQ (big blind) folded before Flop
Seat 2: +ciXH35zeafrjg1W6wiBTg (button) (small blind) collected ($1)



PokerStars Game #59939406022:  Hold'em No Limit ($0.25/$0.50) - 2009/07/01 0:39:02 ET
Table 'hSTs/dUsYLgJQuF2Onp0MQ' 6-max Seat #5 is the button
Seat 1: Donj3X7gYzeS5pAl7s9f+Q ($25.90 in chips)
Seat 2: 6vNxrjjCl6FwfaaymM9jjg ($30.35 in chips)
Seat 3: C3qJBo7uxfFVDluE1lmK2w ($35.45 in chips)
Seat 4: L0aIPg7qefDQjdJo3HCVEA ($8.30 in chips)
Seat 5: 686aeHikcJlgKkSuIFdcXQ ($58.65 in chips)
Seat 6: w0pd++ZQHijd9dDhKEYOAQ ($30.65 in chips)
w0pd++ZQHijd9dDhKEYOAQ: posts small blind $0.25
Donj3X7gYzeS5pAl7s9f+Q: posts big blind $0.50
*** HOLE CARDS ***
6vNxrjjCl6FwfaaymM9jjg: folds
C3qJBo7uxfFVDluE1lmK2w: folds
L0aIPg7qefDQjdJo3HCVEA: folds
686aeHikcJlgKkSuIFdcXQ: raises $1.50 to $2
w0pd++ZQHijd9dDhKEYOAQ: folds
Donj3X7gYzeS5pAl7s9f+Q: calls $1.50
*** FLOP *** [7c Js Jd]
Donj3X7gYzeS5pAl7s9f+Q: checks
686aeHikcJlgKkSuIFdcXQ: checks
*** TURN *** [7c Js Jd] [Kd]
Donj3X7gYzeS5pAl7s9f+Q: bets $2.50
686aeHikcJlgKkSuIFdcXQ: calls $2.50
*** RIVER *** [7c Js Jd Kd] [Ah]
Donj3X7gYzeS5pAl7s9f+Q: checks
686aeHikcJlgKkSuIFdcXQ: checks
*** SHOW DOWN ***
Donj3X7gYzeS5pAl7s9f+Q: shows [Kc Td] (two pair, Kings and Jacks)
686aeHikcJlgKkSuIFdcXQ: shows [Ad 7d] (two pair, Aces and Jacks)
686aeHikcJlgKkSuIFdcXQ collected $8.80 from pot
*** SUMMARY ***
Total pot $9.25 | Rake $0.45
Board [7c Js Jd Kd Ah]
Seat 1: Donj3X7gYzeS5pAl7s9f+Q (big blind) showed [Kc Td] and lost with two pair, Kings and Jacks
Seat 2: 6vNxrjjCl6FwfaaymM9jjg folded before Flop (didn't bet)
Seat 3: C3qJBo7uxfFVDluE1lmK2w folded before Flop (didn't bet)
Seat 4: L0aIPg7qefDQjdJo3HCVEA folded before Flop (didn't bet)
Seat 5: 686aeHikcJlgKkSuIFdcXQ (button) showed [Ad 7d] and won ($8.80) with two pair, Aces and Jacks
Seat 6: w0pd++ZQHijd9dDhKEYOAQ (small blind) folded before Flop



PokerStars Game #59939406490:  Hold'em No Limit ($0.25/$0.50) - 2009/07/01 0:39:03 ET
Table 'otvGDROEDdqsabxskT79qg' 9-max Seat #5 is the button
Seat 1: 8ehL7qlZzjgUh2H35iiWLw ($56 in chips)
Seat 2: cCjTzH9jio8607WzjcfXlg ($8.10 in chips)
Seat 3: +k7T5ocke8UwavtgUHm+Cg ($75.35 in chips)
Seat 4: MG90wfSJZnOejs/KD3vlQQ ($55.40 in chips)
Seat 5: XNMDwbXt/Q4jM99AXnbJDw ($54.80 in chips)
Seat 6: bxLSulbgr8LmKNjOzw8URg ($51.90 in chips)
Seat 7: C7+tBppJrKgd/r+tuKUIpA ($35.35 in chips)
Seat 8: zE9cVigS2nW/Ljy4K4bUQA ($30 in chips)
Seat 9: KcY3X8YpD74Kw1RHkx/g4A ($66 in chips)
bxLSulbgr8LmKNjOzw8URg: posts small blind $0.25
C7+tBppJrKgd/r+tuKUIpA: posts big blind $0.50
*** HOLE CARDS ***
zE9cVigS2nW/Ljy4K4bUQA: folds
KcY3X8YpD74Kw1RHkx/g4A: folds
8ehL7qlZzjgUh2H35iiWLw: folds
cCjTzH9jio8607WzjcfXlg: calls $0.50
+k7T5ocke8UwavtgUHm+Cg: folds
MG90wfSJZnOejs/KD3vlQQ: folds
XNMDwbXt/Q4jM99AXnbJDw: folds
bxLSulbgr8LmKNjOzw8URg: calls $0.25
C7+tBppJrKgd/r+tuKUIpA: checks
*** FLOP *** [7s 9h Qd]
bxLSulbgr8LmKNjOzw8URg: checks
C7+tBppJrKgd/r+tuKUIpA: checks
cCjTzH9jio8607WzjcfXlg: checks
*** TURN *** [7s 9h Qd] [5h]
bxLSulbgr8LmKNjOzw8URg: checks
C7+tBppJrKgd/r+tuKUIpA: checks
cCjTzH9jio8607WzjcfXlg: checks
*** RIVER *** [7s 9h Qd 5h] [Td]
bxLSulbgr8LmKNjOzw8URg: checks
C7+tBppJrKgd/r+tuKUIpA: checks
cCjTzH9jio8607WzjcfXlg: bets $1
bxLSulbgr8LmKNjOzw8URg: folds
C7+tBppJrKgd/r+tuKUIpA: folds
cCjTzH9jio8607WzjcfXlg collected $1.45 from pot
*** SUMMARY ***
Total pot $1.50 | Rake $0.05
Board [7s 9h Qd 5h Td]
Seat 1: 8ehL7qlZzjgUh2H35iiWLw folded before Flop (didn't bet)
Seat 2: cCjTzH9jio8607WzjcfXlg collected ($1.45)
Seat 3: +k7T5ocke8UwavtgUHm+Cg folded before Flop (didn't bet)
Seat 4: MG90wfSJZnOejs/KD3vlQQ folded before Flop (didn't bet)
Seat 5: XNMDwbXt/Q4jM99AXnbJDw (button) folded before Flop (didn't bet)
Seat 6: bxLSulbgr8LmKNjOzw8URg (small blind) folded on the River
Seat 7: C7+tBppJrKgd/r+tuKUIpA (big blind) folded on the River
Seat 8: zE9cVigS2nW/Ljy4K4bUQA folded before Flop (didn't bet)
Seat 9: KcY3X8YpD74Kw1RHkx/g4A folded before Flop (didn't bet)



PokerStars Game #59939407176:  Hold'em No Limit ($0.25/$0.50) - 2009/07/01 0:39:04 ET
Table 'ibNfFy0bCzuBaUORla0aGw' 9-max Seat #9 is the button
Seat 1: xZCXQSXlrZkp3pZizzVXCw ($53.45 in chips)
Seat 2: 90Wb75h3W1BRpbqVnuk8gw ($59.65 in chips)
Seat 3: dDaHs3X8+fe3bIkRU0cbrw ($40.90 in chips)
Seat 4: YBN054X4blmis+B2bBlC0g ($24.20 in chips)
Seat 5: GIJAc9kPrLZHLSX8Q6i99w ($24.50 in chips)
Seat 6: 8n9jQLh3cZKbsmr5PIjgiQ ($35.75 in chips)
Seat 7: HZkVla4kK2SI42CVrPZ/ig ($11.75 in chips)
Seat 8: xUrN9TWLq4m5V+OXY7KUUA ($51.25 in chips)
Seat 9: pFtzb1sR4b0d1aw6aIRgDg ($50 in chips)
xZCXQSXlrZkp3pZizzVXCw: posts small blind $0.25
90Wb75h3W1BRpbqVnuk8gw: posts big blind $0.50
*** HOLE CARDS ***
dDaHs3X8+fe3bIkRU0cbrw: folds
YBN054X4blmis+B2bBlC0g: folds
GIJAc9kPrLZHLSX8Q6i99w: calls $0.50
8n9jQLh3cZKbsmr5PIjgiQ: folds
HZkVla4kK2SI42CVrPZ/ig: folds
xUrN9TWLq4m5V+OXY7KUUA: folds
pFtzb1sR4b0d1aw6aIRgDg: folds
xZCXQSXlrZkp3pZizzVXCw: folds
90Wb75h3W1BRpbqVnuk8gw: checks
*** FLOP *** [Tc As 9h]
90Wb75h3W1BRpbqVnuk8gw: checks
GIJAc9kPrLZHLSX8Q6i99w: bets $1.50
90Wb75h3W1BRpbqVnuk8gw: folds
GIJAc9kPrLZHLSX8Q6i99w collected $1.20 from pot
*** SUMMARY ***
Total pot $1.25 | Rake $0.05
Board [Tc As 9h]
Seat 1: xZCXQSXlrZkp3pZizzVXCw (small blind) folded before Flop
Seat 2: 90Wb75h3W1BRpbqVnuk8gw (big blind) folded on the Flop
Seat 3: dDaHs3X8+fe3bIkRU0cbrw folded before Flop (didn't bet)
Seat 4: YBN054X4blmis+B2bBlC0g folded before Flop (didn't bet)
Seat 5: GIJAc9kPrLZHLSX8Q6i99w collected ($1.20)
Seat 6: 8n9jQLh3cZKbsmr5PIjgiQ folded before Flop (didn't bet)
Seat 7: HZkVla4kK2SI42CVrPZ/ig folded before Flop (didn't bet)
Seat 8: xUrN9TWLq4m5V+OXY7KUUA folded before Flop (didn't bet)
Seat 9: pFtzb1sR4b0d1aw6aIRgDg (button) folded before Flop (didn't bet)



PokerStars Game #59939407754:  Hold'em No Limit ($0.25/$0.50) - 2009/07/01 0:39:05 ET
Table 'hWT2kq66tnKEpD26cia6fQ' 2-max Seat #1 is the button
Seat 1: q+vRKwm51mnr6kxX/161WQ ($56.15 in chips)
Seat 2: dkC7J+qbyqk0qCcmJbEPPw ($58.60 in chips)
q+vRKwm51mnr6kxX/161WQ: posts small blind $0.25
dkC7J+qbyqk0qCcmJbEPPw: posts big blind $0.50
*** HOLE CARDS ***
q+vRKwm51mnr6kxX/161WQ: raises $1 to $1.50
dkC7J+qbyqk0qCcmJbEPPw: folds
q+vRKwm51mnr6kxX/161WQ collected $1 from pot
q+vRKwm51mnr6kxX/161WQ: doesn't show hand
*** SUMMARY ***
Total pot $1 | Rake $0
Seat 1: q+vRKwm51mnr6kxX/161WQ (button) (small blind) collected ($1)
Seat 2: dkC7J+qbyqk0qCcmJbEPPw (big blind) folded before Flop



PokerStars Game #59939409748:  Hold'em No Limit ($0.25/$0.50) - 2009/07/01 0:39:08 ET
Table 'eMxdLyFDf28E0wit6gm3Uw' 6-max Seat #2 is the button
Seat 1: GtdWeBVCZhDBcNFRTOb8Hg ($4.50 in chips)
Seat 2: jwuKQ1S3U4NnzMQn3E3dgw ($73.40 in chips)
Seat 3: dZcLsEI8iXkobBduRJ45Yw ($11.05 in chips)
Seat 4: 3jxEWvv2qK1HCXLj4khowQ ($29.50 in chips)
Seat 6: L0aIPg7qefDQjdJo3HCVEA ($17.70 in chips)
dZcLsEI8iXkobBduRJ45Yw: posts small blind $0.25
3jxEWvv2qK1HCXLj4khowQ: posts big blind $0.50
*** HOLE CARDS ***
L0aIPg7qefDQjdJo3HCVEA: folds
GtdWeBVCZhDBcNFRTOb8Hg: folds
X0X97o2fDAPiGx6o1gahsw has returned
jwuKQ1S3U4NnzMQn3E3dgw: raises $1.50 to $2
dZcLsEI8iXkobBduRJ45Yw: folds
3jxEWvv2qK1HCXLj4khowQ: folds
jwuKQ1S3U4NnzMQn3E3dgw collected $1.25 from pot
*** SUMMARY ***
Total pot $1.25 | Rake $0
Seat 1: GtdWeBVCZhDBcNFRTOb8Hg folded before Flop (didn't bet)
Seat 2: jwuKQ1S3U4NnzMQn3E3dgw (button) collected ($1.25)
Seat 3: dZcLsEI8iXkobBduRJ45Yw (small blind) folded before Flop
Seat 4: 3jxEWvv2qK1HCXLj4khowQ (big blind) folded before Flop
Seat 6: L0aIPg7qefDQjdJo3HCVEA folded before Flop (didn't bet)



PokerStars Game #59939410200:  Hold'em No Limit ($0.25/$0.50) - 2009/07/01 0:39:09 ET
Table 'IeNZOZQ4T6oiaHqFeo6yIA' 2-max Seat #2 is the button
Seat 1: ndd1nfncBkWNitBnsfCoVQ ($50 in chips)
Seat 2: A91IUl5JaZROhtfCtnnwYw ($94.70 in chips)
A91IUl5JaZROhtfCtnnwYw: posts small blind $0.25
ndd1nfncBkWNitBnsfCoVQ: posts big blind $0.50
*** HOLE CARDS ***
A91IUl5JaZROhtfCtnnwYw: calls $0.25
ndd1nfncBkWNitBnsfCoVQ: checks
*** FLOP *** [Ad 8h 9s]
ndd1nfncBkWNitBnsfCoVQ: checks
A91IUl5JaZROhtfCtnnwYw: checks
*** TURN *** [Ad 8h 9s] [Ah]
ndd1nfncBkWNitBnsfCoVQ: checks
A91IUl5JaZROhtfCtnnwYw: checks
*** RIVER *** [Ad 8h 9s Ah] [6d]
ndd1nfncBkWNitBnsfCoVQ: checks
A91IUl5JaZROhtfCtnnwYw: checks
*** SHOW DOWN ***
ndd1nfncBkWNitBnsfCoVQ: shows [3c 8s] (two pair, Aces and Eights)
A91IUl5JaZROhtfCtnnwYw: mucks hand
ndd1nfncBkWNitBnsfCoVQ collected $0.95 from pot
*** SUMMARY ***
Total pot $1 | Rake $0.05
Board [Ad 8h 9s Ah 6d]
Seat 1: ndd1nfncBkWNitBnsfCoVQ (big blind) showed [3c 8s] and won ($0.95) with two pair, Aces and Eights
Seat 2: A91IUl5JaZROhtfCtnnwYw (button) (small blind) mucked



PokerStars Game #59939411576:  Hold'em No Limit ($0.25/$0.50) - 2009/07/01 0:39:11 ET
Table '+111aLuBwnz8YVYSA7J1jA' 2-max Seat #1 is the button
Seat 1: ndd1nfncBkWNitBnsfCoVQ ($90.65 in chips)
Seat 2: +ciXH35zeafrjg1W6wiBTg ($56.95 in chips)
ndd1nfncBkWNitBnsfCoVQ: posts small blind $0.25
+ciXH35zeafrjg1W6wiBTg: posts big blind $0.50
*** HOLE CARDS ***
ndd1nfncBkWNitBnsfCoVQ: raises $1 to $1.50
+ciXH35zeafrjg1W6wiBTg: calls $1
*** FLOP *** [2s Jh Ad]
+ciXH35zeafrjg1W6wiBTg: checks
ndd1nfncBkWNitBnsfCoVQ: bets $2
+ciXH35zeafrjg1W6wiBTg: folds
ndd1nfncBkWNitBnsfCoVQ collected $2.85 from pot
*** SUMMARY ***
Total pot $3 | Rake $0.15
Board [2s Jh Ad]
Seat 1: ndd1nfncBkWNitBnsfCoVQ (button) (small blind) collected ($2.85)
Seat 2: +ciXH35zeafrjg1W6wiBTg (big blind) folded on the Flop



PokerStars Game #59939411396:  Hold'em No Limit ($0.25/$0.50) - 2009/07/01 0:39:11 ET
Table 'T/PgNWqVyY6lkldcBVXYJQ' 6-max Seat #2 is the button
Seat 1: +Pf9jTVizYlIo+woPvptfA ($56.50 in chips)
Seat 2: LvH4G7n+QSjT6NDaD3cREA ($50.95 in chips)
Seat 3: L3OcNO1bgdqDI46j67KQPQ ($53.35 in chips)
Seat 4: otJMdCRvqd5YCcFsA3JWpg ($11.35 in chips)
Seat 5: vVQBckETtigfb5mAcyK0OA ($50.85 in chips)
Seat 6: cDzbog6kwmJp+LBeBq+iMQ ($41.70 in chips)
L3OcNO1bgdqDI46j67KQPQ: posts small blind $0.25
otJMdCRvqd5YCcFsA3JWpg: posts big blind $0.50
*** HOLE CARDS ***
vVQBckETtigfb5mAcyK0OA: calls $0.50
cDzbog6kwmJp+LBeBq+iMQ: calls $0.50
+Pf9jTVizYlIo+woPvptfA: folds
LvH4G7n+QSjT6NDaD3cREA: raises $2 to $2.50
L3OcNO1bgdqDI46j67KQPQ: folds
otJMdCRvqd5YCcFsA3JWpg: raises $8.85 to $11.35 and is all-in
vVQBckETtigfb5mAcyK0OA: folds
cDzbog6kwmJp+LBeBq+iMQ: folds
LvH4G7n+QSjT6NDaD3cREA: calls $8.85
*** FLOP *** [7d 5c Th]
*** TURN *** [7d 5c Th] [Kc]
*** RIVER *** [7d 5c Th Kc] [4s]
*** SHOW DOWN ***
otJMdCRvqd5YCcFsA3JWpg: shows [Jh Js] (a pair of Jacks)
LvH4G7n+QSjT6NDaD3cREA: shows [Ks Kh] (three of a kind, Kings)
LvH4G7n+QSjT6NDaD3cREA collected $22.80 from pot
*** SUMMARY ***
Total pot $23.95 | Rake $1.15
Board [7d 5c Th Kc 4s]
Seat 1: +Pf9jTVizYlIo+woPvptfA folded before Flop (didn't bet)
Seat 2: LvH4G7n+QSjT6NDaD3cREA (button) showed [Ks Kh] and won ($22.80) with three of a kind, Kings
Seat 3: L3OcNO1bgdqDI46j67KQPQ (small blind) folded before Flop
Seat 4: otJMdCRvqd5YCcFsA3JWpg (big blind) showed [Jh Js] and lost with a pair of Jacks
Seat 5: vVQBckETtigfb5mAcyK0OA folded before Flop
Seat 6: cDzbog6kwmJp+LBeBq+iMQ folded before Flop



PokerStars Game #59939411710:  Hold'em No Limit ($0.25/$0.50) - 2009/07/01 0:39:12 ET
Table 'EiNh8p/wGJ1FP575iMFnqg' 9-max Seat #8 is the button
Seat 1: r3ZqM1Mi0W3y4hOdssE+Sg ($50.15 in chips)
Seat 2: 8ehL7qlZzjgUh2H35iiWLw ($52 in chips)
Seat 3: ymLPoEIl7UL3TvZYmnadxQ ($49.35 in chips)
Seat 5: M+7+BTmX5vZatHVuoRB1nA ($85.35 in chips)
Seat 6: 3UmXLy3GfjC3EkOebduerQ ($53.90 in chips)
Seat 7: 997ViqAtWn1FPjJqcffwcA ($50 in chips)
Seat 8: KrPAGRACBg+w0M//SXe8Ag ($11.35 in chips)
Seat 9: OMwFJ4pF0xk2Ru/AJiFeFw ($100.50 in chips)
OMwFJ4pF0xk2Ru/AJiFeFw: posts small blind $0.25
r3ZqM1Mi0W3y4hOdssE+Sg: posts big blind $0.50
cMzaiXAM/ZAdNaEUu+LqhA: sits out
*** HOLE CARDS ***
8ehL7qlZzjgUh2H35iiWLw: folds
ymLPoEIl7UL3TvZYmnadxQ: folds
M+7+BTmX5vZatHVuoRB1nA: folds
3UmXLy3GfjC3EkOebduerQ: raises $1.50 to $2
997ViqAtWn1FPjJqcffwcA: folds
KrPAGRACBg+w0M//SXe8Ag: folds
OMwFJ4pF0xk2Ru/AJiFeFw: folds
r3ZqM1Mi0W3y4hOdssE+Sg: folds
3UmXLy3GfjC3EkOebduerQ collected $1.25 from pot
3UmXLy3GfjC3EkOebduerQ: doesn't show hand
*** SUMMARY ***
Total pot $1.25 | Rake $0
Seat 1: r3ZqM1Mi0W3y4hOdssE+Sg (big blind) folded before Flop
Seat 2: 8ehL7qlZzjgUh2H35iiWLw folded before Flop (didn't bet)
Seat 3: ymLPoEIl7UL3TvZYmnadxQ folded before Flop (didn't bet)
Seat 5: M+7+BTmX5vZatHVuoRB1nA folded before Flop (didn't bet)
Seat 6: 3UmXLy3GfjC3EkOebduerQ collected ($1.25)
Seat 7: 997ViqAtWn1FPjJqcffwcA folded before Flop (didn't bet)
Seat 8: KrPAGRACBg+w0M//SXe8Ag (button) folded before Flop (didn't bet)
Seat 9: OMwFJ4pF0xk2Ru/AJiFeFw (small blind) folded before Flop



PokerStars Game #59939414002:  Hold'em No Limit ($0.25/$0.50) - 2009/07/01 0:39:15 ET
Table '5EmHi+fnatGQQShcNmzOZQ' 6-max Seat #4 is the button
Seat 1: +SZCX3+7lnuhHKIu+PP9rg ($29.50 in chips)
Seat 2: vXIHnZ+dv/hwSBxyvGw7bQ ($77.25 in chips)
Seat 3: L9qfLYXrczhAPd/VckgsWw ($84.25 in chips)
Seat 4: 1b+2BbjMN8qhR1WPqdE9VQ ($55.65 in chips)
Seat 5: kxPhs4ePFqMy52CInAJ2aw ($51.85 in chips)
Seat 6: 686aeHikcJlgKkSuIFdcXQ ($141.20 in chips)
kxPhs4ePFqMy52CInAJ2aw: posts small blind $0.25
686aeHikcJlgKkSuIFdcXQ: posts big blind $0.50
*** HOLE CARDS ***
+SZCX3+7lnuhHKIu+PP9rg: folds
vXIHnZ+dv/hwSBxyvGw7bQ: folds
L9qfLYXrczhAPd/VckgsWw: folds
1b+2BbjMN8qhR1WPqdE9VQ: folds
kxPhs4ePFqMy52CInAJ2aw: folds
686aeHikcJlgKkSuIFdcXQ collected $0.50 from pot
*** SUMMARY ***
Total pot $0.50 | Rake $0
Seat 1: +SZCX3+7lnuhHKIu+PP9rg folded before Flop (didn't bet)
Seat 2: vXIHnZ+dv/hwSBxyvGw7bQ folded before Flop (didn't bet)
Seat 3: L9qfLYXrczhAPd/VckgsWw folded before Flop (didn't bet)
Seat 4: 1b+2BbjMN8qhR1WPqdE9VQ (button) folded before Flop (didn't bet)
Seat 5: kxPhs4ePFqMy52CInAJ2aw (small blind) folded before Flop
Seat 6: 686aeHikcJlgKkSuIFdcXQ (big blind) collected ($0.50)



PokerStars Game #59939414676:  Hold'em No Limit ($0.25/$0.50) - 2009/07/01 0:39:16 ET
Table 'NCiXr0d5CEKBQr/cZgLhbA' 9-max Seat #1 is the button
Seat 1: pFtzb1sR4b0d1aw6aIRgDg ($50 in chips)
Seat 2: ulxuJchBV9iguXg0FUonfg ($49.30 in chips)
Seat 3: xZCXQSXlrZkp3pZizzVXCw ($50.75 in chips)
Seat 4: 5k9fvXD9suIgCxU4HLQjTw ($57.70 in chips)
Seat 5: zE9cVigS2nW/Ljy4K4bUQA ($39.95 in chips)
Seat 6: SKnJuWHScqetA/qG5p+wCg ($30 in chips)
Seat 7: M+7+BTmX5vZatHVuoRB1nA ($46 in chips)
Seat 8: 1MJUKc3cc0QmUoz1JZLR2w ($52.80 in chips)
Seat 9: 4WLZvqBn5qv5tds5kt5A1Q ($48.55 in chips)
ulxuJchBV9iguXg0FUonfg: posts small blind $0.25
xZCXQSXlrZkp3pZizzVXCw: posts big blind $0.50
*** HOLE CARDS ***
ulxuJchBV9iguXg0FUonfg said, "set that trap a little too well"
5k9fvXD9suIgCxU4HLQjTw: folds
zE9cVigS2nW/Ljy4K4bUQA: folds
SKnJuWHScqetA/qG5p+wCg: folds
M+7+BTmX5vZatHVuoRB1nA: folds
1MJUKc3cc0QmUoz1JZLR2w: folds
4WLZvqBn5qv5tds5kt5A1Q: folds
pFtzb1sR4b0d1aw6aIRgDg: folds
ulxuJchBV9iguXg0FUonfg: calls $0.25
xZCXQSXlrZkp3pZizzVXCw: checks
*** FLOP *** [5s Th 9h]
ulxuJchBV9iguXg0FUonfg: checks
xZCXQSXlrZkp3pZizzVXCw: checks
*** TURN *** [5s Th 9h] [Td]
ulxuJchBV9iguXg0FUonfg: bets $1
xZCXQSXlrZkp3pZizzVXCw: folds
ulxuJchBV9iguXg0FUonfg collected $0.95 from pot
*** SUMMARY ***
Total pot $1 | Rake $0.05
Board [5s Th 9h Td]
Seat 1: pFtzb1sR4b0d1aw6aIRgDg (button) folded before Flop (didn't bet)
Seat 2: ulxuJchBV9iguXg0FUonfg (small blind) collected ($0.95)
Seat 3: xZCXQSXlrZkp3pZizzVXCw (big blind) folded on the Turn
Seat 4: 5k9fvXD9suIgCxU4HLQjTw folded before Flop (didn't bet)
Seat 5: zE9cVigS2nW/Ljy4K4bUQA folded before Flop (didn't bet)
Seat 6: SKnJuWHScqetA/qG5p+wCg folded before Flop (didn't bet)
Seat 7: M+7+BTmX5vZatHVuoRB1nA folded before Flop (didn't bet)
Seat 8: 1MJUKc3cc0QmUoz1JZLR2w folded before Flop (didn't bet)
Seat 9: 4WLZvqBn5qv5tds5kt5A1Q folded before Flop (didn't bet)



PokerStars Game #59939415202:  Hold'em No Limit ($0.25/$0.50) - 2009/07/01 0:39:17 ET
Table 'X6IRCRTh+20gjz8aubWnwA' 9-max Seat #2 is the button
Seat 1: DSM67hHHq1XFoEOi9p8Alw ($50.80 in chips)
Seat 2: HZkVla4kK2SI42CVrPZ/ig ($6.75 in chips)
Seat 3: GeZ7AYmAZ9Ln8liPZzV8EA ($23.20 in chips)
Seat 4: 2J+UVOVrW+V3maOylyxMcQ ($43.70 in chips)
Seat 6: /6In1zC3WtgwxDcueWzZWg ($66.40 in chips)
Seat 7: cFHQjKQOOKTUzoilhrXHLg ($37.35 in chips)
Seat 8: HxeBVq06/3Bh/H986sgdbw ($7.25 in chips)
Seat 9: M+7+BTmX5vZatHVuoRB1nA ($69.25 in chips)
GeZ7AYmAZ9Ln8liPZzV8EA: posts small blind $0.25
2J+UVOVrW+V3maOylyxMcQ: posts big blind $0.50
NnQCepdIR/AOUQn1yhYx6Q: sits out
*** HOLE CARDS ***
/6In1zC3WtgwxDcueWzZWg: raises $1 to $1.50
cFHQjKQOOKTUzoilhrXHLg: calls $1.50
HxeBVq06/3Bh/H986sgdbw: folds
M+7+BTmX5vZatHVuoRB1nA: folds
DSM67hHHq1XFoEOi9p8Alw: folds
HZkVla4kK2SI42CVrPZ/ig: folds
GeZ7AYmAZ9Ln8liPZzV8EA: folds
2J+UVOVrW+V3maOylyxMcQ: folds
*** FLOP *** [7s 9s 7h]
/6In1zC3WtgwxDcueWzZWg: checks
cFHQjKQOOKTUzoilhrXHLg: checks
*** TURN *** [7s 9s 7h] [Td]
/6In1zC3WtgwxDcueWzZWg: checks
cFHQjKQOOKTUzoilhrXHLg: bets $1
/6In1zC3WtgwxDcueWzZWg: calls $1
*** RIVER *** [7s 9s 7h Td] [2c]
/6In1zC3WtgwxDcueWzZWg: checks
cFHQjKQOOKTUzoilhrXHLg: checks
*** SHOW DOWN ***
/6In1zC3WtgwxDcueWzZWg: shows [As Jc] (a pair of Sevens)
cFHQjKQOOKTUzoilhrXHLg: mucks hand
/6In1zC3WtgwxDcueWzZWg collected $5.50 from pot
*** SUMMARY ***
Total pot $5.75 | Rake $0.25
Board [7s 9s 7h Td 2c]
Seat 1: DSM67hHHq1XFoEOi9p8Alw folded before Flop (didn't bet)
Seat 2: HZkVla4kK2SI42CVrPZ/ig (button) folded before Flop (didn't bet)
Seat 3: GeZ7AYmAZ9Ln8liPZzV8EA (small blind) folded before Flop
Seat 4: 2J+UVOVrW+V3maOylyxMcQ (big blind) folded before Flop
Seat 6: /6In1zC3WtgwxDcueWzZWg showed [As Jc] and won ($5.50) with a pair of Sevens
Seat 7: cFHQjKQOOKTUzoilhrXHLg mucked
Seat 8: HxeBVq06/3Bh/H986sgdbw folded before Flop (didn't bet)
Seat 9: M+7+BTmX5vZatHVuoRB1nA folded before Flop (didn't bet)



PokerStars Game #59939415844:  Hold'em No Limit ($0.25/$0.50) - 2009/07/01 0:39:18 ET
Table 'QOgaEqMcJ73pcUMMxoisUgErOuyGLI5PT3G5MnpHgC/g Seat #7 is the button
Seat 1: L5e2lrPLQm1Pqx30IIZ/Fw ($10 in chips)
Seat 3: xZCXQSXlrZkp3pZizzVXCw ($50.50 in chips)
Seat 4: 3UmXLy3GfjC3EkOebduerQ ($50 in chips)
Seat 5: JwvquocWfhTVApN5t47LgA ($59.55 in chips)
Seat 6: zE9cVigS2nW/Ljy4K4bUQA ($30 in chips)
Seat 7: 90Wb75h3W1BRpbqVnuk8gw ($60.20 in chips)
Seat 8: g4k0NXISyLCqaSWZDBjfEg ($51.60 in chips)
Seat 9: J0W5D97jl5VLky+IoPvDeA ($57.90 in chips)
g4k0NXISyLCqaSWZDBjfEg: posts small blind $0.25
J0W5D97jl5VLky+IoPvDeA: posts big blind $0.50
*** HOLE CARDS ***
L5e2lrPLQm1Pqx30IIZ/Fw: folds
xZCXQSXlrZkp3pZizzVXCw: folds
3UmXLy3GfjC3EkOebduerQ: folds
JwvquocWfhTVApN5t47LgA: folds
zE9cVigS2nW/Ljy4K4bUQA: folds
90Wb75h3W1BRpbqVnuk8gw: folds
g4k0NXISyLCqaSWZDBjfEg: folds
J0W5D97jl5VLky+IoPvDeA collected $0.50 from pot
*** SUMMARY ***
Total pot $0.50 | Rake $0
Seat 1: L5e2lrPLQm1Pqx30IIZ/Fw folded before Flop (didn't bet)
Seat 3: xZCXQSXlrZkp3pZizzVXCw folded before Flop (didn't bet)
Seat 4: 3UmXLy3GfjC3EkOebduerQ folded before Flop (didn't bet)
Seat 5: JwvquocWfhTVApN5t47LgA folded before Flop (didn't bet)
Seat 6: zE9cVigS2nW/Ljy4K4bUQA folded before Flop (didn't bet)
Seat 7: 90Wb75h3W1BRpbqVnuk8gw (button) folded before Flop (didn't bet)
Seat 8: g4k0NXISyLCqaSWZDBjfEg (small blind) folded before Flop
Seat 9: J0W5D97jl5VLky+IoPvDeA (big blind) collected ($0.50)



PokerStars Game #59939416126:  Hold'em No Limit ($0.25/$0.50) - 2009/07/01 0:39:18 ET
Table 'E7bWJ45aoFXRpyRv2gw+Ig' 2-max Seat #2 is the button
Seat 1: FRkiRasEGlHUeLrEl+k/nA ($51.35 in chips)
Seat 2: 3Wro85I7472vJ4Wkpneo9A ($146.55 in chips)
3Wro85I7472vJ4Wkpneo9A: posts small blind $0.25
FRkiRasEGlHUeLrEl+k/nA: posts big blind $0.50
*** HOLE CARDS ***
3Wro85I7472vJ4Wkpneo9A: calls $0.25
FRkiRasEGlHUeLrEl+k/nA: checks
*** FLOP *** [2d Kc 7c]
FRkiRasEGlHUeLrEl+k/nA: checks
3Wro85I7472vJ4Wkpneo9A: bets $1
FRkiRasEGlHUeLrEl+k/nA: raises $2 to $3
3Wro85I7472vJ4Wkpneo9A: folds
FRkiRasEGlHUeLrEl+k/nA collected $2.90 from pot
*** SUMMARY ***
Total pot $3 | Rake $0.10
Board [2d Kc 7c]
Seat 1: FRkiRasEGlHUeLrEl+k/nA (big blind) collected ($2.90)
Seat 2: 3Wro85I7472vJ4Wkpneo9A (button) (small blind) folded on the Flop



PokerStars Game #59939416278:  Hold'em No Limit ($0.25/$0.50) - 2009/07/01 0:39:19 ET
Table '37qXEp3oe+er5q4CZip9eQ' 6-max Seat #1 is the button
Seat 1: oqOqoO2AyCZenUghCxMDxw ($52.25 in chips)
Seat 2: 6wzJiRvp8HY6t+MQGnSIzA ($25.10 in chips)
Seat 3: Rt6KgtZ8YaJoTc3FPim00w ($73.75 in chips)
Seat 4: XsmE8nXMAAMFJbWaJTmHFw ($28.35 in chips)
Seat 5: VOmI0x4dDPnTESZd5B4d1Q ($49.40 in chips)
Seat 6: N50kln4negd8q7Mmoz1j4g ($28.60 in chips)
6wzJiRvp8HY6t+MQGnSIzA: posts small blind $0.25
Rt6KgtZ8YaJoTc3FPim00w: posts big blind $0.50
*** HOLE CARDS ***
XsmE8nXMAAMFJbWaJTmHFw: folds
VOmI0x4dDPnTESZd5B4d1Q: folds
N50kln4negd8q7Mmoz1j4g: raises $1.50 to $2
oqOqoO2AyCZenUghCxMDxw: folds
6wzJiRvp8HY6t+MQGnSIzA: folds
Rt6KgtZ8YaJoTc3FPim00w: folds
N50kln4negd8q7Mmoz1j4g collected $1.25 from pot
*** SUMMARY ***
Total pot $1.25 | Rake $0
Seat 1: oqOqoO2AyCZenUghCxMDxw (button) folded before Flop (didn't bet)
Seat 2: 6wzJiRvp8HY6t+MQGnSIzA (small blind) folded before Flop
Seat 3: Rt6KgtZ8YaJoTc3FPim00w (big blind) folded before Flop
Seat 4: XsmE8nXMAAMFJbWaJTmHFw folded before Flop (didn't bet)
Seat 5: VOmI0x4dDPnTESZd5B4d1Q folded before Flop (didn't bet)
Seat 6: N50kln4negd8q7Mmoz1j4g collected ($1.25)



PokerStars Game #59939416892:  Hold'em No Limit ($0.25/$0.50) - 2009/07/01 0:39:20 ET
Table 'MJxeZCzYELxiIsyUZyT0jw' 6-max Seat #5 is the button
Seat 1: tdOvWynovql5imfooroLMg ($52.30 in chips)
Seat 2: dB6jzDlJmET84VMWw1mTRA ($50 in chips)
Seat 3: JQZew0FjzS19kTjeNtrE+A ($50.55 in chips)
Seat 4: lP7Q6pewz4C2RsAfKsjdWw ($34.40 in chips)
Seat 5: 3jvoOXNtXE90w2BdfNZwZQ ($50 in chips)
Seat 6: TTx3CHxyi0SObcHyMJRp5w ($60.70 in chips)
TTx3CHxyi0SObcHyMJRp5w: posts small blind $0.25
tdOvWynovql5imfooroLMg: posts big blind $0.50
*** HOLE CARDS ***
dB6jzDlJmET84VMWw1mTRA: folds
JQZew0FjzS19kTjeNtrE+A: folds
lP7Q6pewz4C2RsAfKsjdWw: calls $0.50
3jvoOXNtXE90w2BdfNZwZQ: raises $2 to $2.50
TTx3CHxyi0SObcHyMJRp5w: folds
tdOvWynovql5imfooroLMg: folds
lP7Q6pewz4C2RsAfKsjdWw: folds
3jvoOXNtXE90w2BdfNZwZQ collected $1.75 from pot
3jvoOXNtXE90w2BdfNZwZQ: doesn't show hand
*** SUMMARY ***
Total pot $1.75 | Rake $0
Seat 1: tdOvWynovql5imfooroLMg (big blind) folded before Flop
Seat 2: dB6jzDlJmET84VMWw1mTRA folded before Flop (didn't bet)
Seat 3: JQZew0FjzS19kTjeNtrE+A folded before Flop (didn't bet)
Seat 4: lP7Q6pewz4C2RsAfKsjdWw folded before Flop
Seat 5: 3jvoOXNtXE90w2BdfNZwZQ (button) collected ($1.75)
Seat 6: TTx3CHxyi0SObcHyMJRp5w (small blind) folded before Flop



PokerStars Game #59939418052:  Hold'em No Limit ($0.25/$0.50) - 2009/07/01 0:39:21 ET
Table 'GfL/No5u5PoEnU39lP5pQg' 6-max Seat #1 is the button
Seat 1: 1WUCqNG+p+vfWRTXNu4ljw ($51.25 in chips)
Seat 2: uVwggSetzp7d+eVgowO3vg ($71.95 in chips)
Seat 3: Ek4w9XqBXqK5jBUQeLedGw ($50 in chips)
Seat 4: x+pzUFJsMIiGd7a5pcR4tg ($54.55 in chips)
Seat 5: crjGpJEzSZgD38FoE3VMGg ($52.10 in chips)
uVwggSetzp7d+eVgowO3vg: posts small blind $0.25
Ek4w9XqBXqK5jBUQeLedGw: posts big blind $0.50
*** HOLE CARDS ***
x+pzUFJsMIiGd7a5pcR4tg: folds
crjGpJEzSZgD38FoE3VMGg: raises $1.50 to $2
1WUCqNG+p+vfWRTXNu4ljw: calls $2
uVwggSetzp7d+eVgowO3vg: folds
Ek4w9XqBXqK5jBUQeLedGw: folds
*** FLOP *** [7h 9d 3s]
crjGpJEzSZgD38FoE3VMGg: bets $2.50
1WUCqNG+p+vfWRTXNu4ljw: calls $2.50
*** TURN *** [7h 9d 3s] [Ts]
crjGpJEzSZgD38FoE3VMGg: checks
1WUCqNG+p+vfWRTXNu4ljw: checks
*** RIVER *** [7h 9d 3s Ts] [Qc]
crjGpJEzSZgD38FoE3VMGg: checks
1WUCqNG+p+vfWRTXNu4ljw: checks
*** SHOW DOWN ***
crjGpJEzSZgD38FoE3VMGg: shows [Ac Qs] (a pair of Queens)
1WUCqNG+p+vfWRTXNu4ljw: mucks hand
crjGpJEzSZgD38FoE3VMGg collected $9.30 from pot
*** SUMMARY ***
Total pot $9.75 | Rake $0.45
Board [7h 9d 3s Ts Qc]
Seat 1: 1WUCqNG+p+vfWRTXNu4ljw (button) mucked
Seat 2: uVwggSetzp7d+eVgowO3vg (small blind) folded before Flop
Seat 3: Ek4w9XqBXqK5jBUQeLedGw (big blind) folded before Flop
Seat 4: x+pzUFJsMIiGd7a5pcR4tg folded before Flop (didn't bet)
Seat 5: crjGpJEzSZgD38FoE3VMGg showed [Ac Qs] and won ($9.30) with a pair of Queens



PokerStars Game #59939418354:  Hold'em No Limit ($0.25/$0.50) - 2009/07/01 0:39:22 ET
Table 'QOeVnLhwctF9UyV/beDi+A' 2-max Seat #2 is the button
Seat 1: bypIyrYcAAifLfhZpGlKLA ($53.30 in chips)
Seat 2: Ucrm3XtZmoONapW32SPhag ($32.35 in chips)
Ucrm3XtZmoONapW32SPhag: posts small blind $0.25
bypIyrYcAAifLfhZpGlKLA: posts big blind $0.50
*** HOLE CARDS ***
Ucrm3XtZmoONapW32SPhag: raises $0.50 to $1
bypIyrYcAAifLfhZpGlKLA: calls $0.50
*** FLOP *** [7h 5s Kh]
bypIyrYcAAifLfhZpGlKLA: checks
Ucrm3XtZmoONapW32SPhag: bets $1
bypIyrYcAAifLfhZpGlKLA: calls $1
*** TURN *** [7h 5s Kh] [5h]
bypIyrYcAAifLfhZpGlKLA: checks
Ucrm3XtZmoONapW32SPhag: checks
*** RIVER *** [7h 5s Kh 5h] [8d]
bypIyrYcAAifLfhZpGlKLA: checks
Ucrm3XtZmoONapW32SPhag: checks
*** SHOW DOWN ***
bypIyrYcAAifLfhZpGlKLA: shows [Ah Td] (a pair of Fives)
Ucrm3XtZmoONapW32SPhag: shows [3s 3c] (two pair, Fives and Threes)
Ucrm3XtZmoONapW32SPhag collected $3.85 from pot
*** SUMMARY ***
Total pot $4 | Rake $0.15
Board [7h 5s Kh 5h 8d]
Seat 1: bypIyrYcAAifLfhZpGlKLA (big blind) showed [Ah Td] and lost with a pair of Fives
Seat 2: Ucrm3XtZmoONapW32SPhag (button) (small blind) showed [3s 3c] and won ($3.85) with two pair, Fives and Threes



PokerStars Game #59939419378:  Hold'em No Limit ($0.25/$0.50) - 2009/07/01 0:39:24 ET
Table '+111aLuBwnz8YVYSA7J1jA' 2-max Seat #2 is the button
Seat 1: ndd1nfncBkWNitBnsfCoVQ ($92 in chips)
Seat 2: +ciXH35zeafrjg1W6wiBTg ($55.45 in chips)
+ciXH35zeafrjg1W6wiBTg: posts small blind $0.25
ndd1nfncBkWNitBnsfCoVQ: posts big blind $0.50
*** HOLE CARDS ***
+ciXH35zeafrjg1W6wiBTg: raises $1 to $1.50
ndd1nfncBkWNitBnsfCoVQ: folds
+ciXH35zeafrjg1W6wiBTg collected $1 from pot
+ciXH35zeafrjg1W6wiBTg: doesn't show hand
*** SUMMARY ***
Total pot $1 | Rake $0
Seat 1: ndd1nfncBkWNitBnsfCoVQ (big blind) folded before Flop
Seat 2: +ciXH35zeafrjg1W6wiBTg (button) (small blind) collected ($1)



PokerStars Game #59939419980:  Hold'em No Limit ($0.25/$0.50) - 2009/07/01 0:39:24 ET
Table 'QOgaEqMcJ73pcUMMxoisUg' 6-max Seat #4 is the button
Seat 1: OZ6OtYh5Y53MCH/p0QTn5g ($54.20 in chips)
Seat 2: 4QfsCWthT/vSLirorNXqtg ($50 in chips)
Seat 3: Rt6KgtZ8YaJoTc3FPim00w ($77.50 in chips)
Seat 4: zAcsDhG/T128Vn7XGVSgKg ($57.40 in chips)
Seat 5: 6vNxrjjCl6FwfaaymM9jjg ($15.25 in chips)
Seat 6: pmE+2KJb4nffAVqjLIXxFg ($20.75 in chips)
6vNxrjjCl6FwfaaymM9jjg: posts small blind $0.25
pmE+2KJb4nffAVqjLIXxFg: posts big blind $0.50
*** HOLE CARDS ***
OZ6OtYh5Y53MCH/p0QTn5g: folds
4QfsCWthT/vSLirorNXqtg: folds
Rt6KgtZ8YaJoTc3FPim00w: folds
zAcsDhG/T128Vn7XGVSgKg: folds
6vNxrjjCl6FwfaaymM9jjg: folds
pmE+2KJb4nffAVqjLIXxFg collected $0.50 from pot
*** SUMMARY ***
Total pot $0.50 | Rake $0
Seat 1: OZ6OtYh5Y53MCH/p0QTn5g folded before Flop (didn't bet)
Seat 2: 4QfsCWthT/vSLirorNXqtg folded before Flop (didn't bet)
Seat 3: Rt6KgtZ8YaJoTc3FPim00w folded before Flop (didn't bet)
Seat 4: zAcsDhG/T128Vn7XGVSgKg (button) folded before Flop (didn't bet)
Seat 5: 6vNxrjjCl6FwfaaymM9jjg (small blind) folded before Flop
Seat 6: pmE+2KJb4nffAVqjLIXxFg (big blind) collected ($0.50)



PokerStars Game #59939420248:  Hold'em No Limit ($0.25/$0.50) - 2009/07/01 0:39:25 ET
Table 'lSisgp6H7Fg1hH5VfjEjYQ' 9-max Seat #5 is the button
Seat 1: pEW8B6uXbdR47kfljMQ3+Q ($37.10 in chips)
Seat 2: UrcnkQOiLVk8BlKDPJSy7Q ($52.30 in chips)
Seat 3: aTkyjTh3w5YLWiIERupZOA ($41.70 in chips)
Seat 4: bwv/rbH/hHhPhY6u9mu04w ($23 in chips)
Seat 5: mSD1pginDsyHG5PDfqzphw ($11.35 in chips)
Seat 6: +k7T5ocke8UwavtgUHm+Cg ($31.30 in chips)
Seat 7: Y3DZ6qQlLeBhixDj4M9vmg ($8.75 in chips)
Seat 8: a4JDWmpFQkL10XfAyuF51A ($34.75 in chips)
+k7T5ocke8UwavtgUHm+Cg: posts small blind $0.25
Y3DZ6qQlLeBhixDj4M9vmg: posts big blind $0.50
gsyXT42WLEcOS4DdEk2wlw: sits out
*** HOLE CARDS ***
a4JDWmpFQkL10XfAyuF51A: folds
pEW8B6uXbdR47kfljMQ3+Q: folds
UrcnkQOiLVk8BlKDPJSy7Q: folds
aTkyjTh3w5YLWiIERupZOA: folds
bwv/rbH/hHhPhY6u9mu04w: calls $0.50
mSD1pginDsyHG5PDfqzphw: folds
+k7T5ocke8UwavtgUHm+Cg: calls $0.25
Y3DZ6qQlLeBhixDj4M9vmg: checks
*** FLOP *** [Kc Qh Ah]
+k7T5ocke8UwavtgUHm+Cg: checks
Y3DZ6qQlLeBhixDj4M9vmg: bets $0.50
bwv/rbH/hHhPhY6u9mu04w: folds
+k7T5ocke8UwavtgUHm+Cg: calls $0.50
*** TURN *** [Kc Qh Ah] [As]
+k7T5ocke8UwavtgUHm+Cg: checks
Y3DZ6qQlLeBhixDj4M9vmg: bets $0.50
+k7T5ocke8UwavtgUHm+Cg: calls $0.50
*** RIVER *** [Kc Qh Ah As] [Jc]
+k7T5ocke8UwavtgUHm+Cg: checks
Y3DZ6qQlLeBhixDj4M9vmg: bets $0.50
+k7T5ocke8UwavtgUHm+Cg: calls $0.50
*** SHOW DOWN ***
Y3DZ6qQlLeBhixDj4M9vmg: shows [Ks 2c] (two pair, Aces and Kings)
+k7T5ocke8UwavtgUHm+Cg: mucks hand
Y3DZ6qQlLeBhixDj4M9vmg collected $4.30 from pot
*** SUMMARY ***
Total pot $4.50 | Rake $0.20
Board [Kc Qh Ah As Jc]
Seat 1: pEW8B6uXbdR47kfljMQ3+Q folded before Flop (didn't bet)
Seat 2: UrcnkQOiLVk8BlKDPJSy7Q folded before Flop (didn't bet)
Seat 3: aTkyjTh3w5YLWiIERupZOA folded before Flop (didn't bet)
Seat 4: bwv/rbH/hHhPhY6u9mu04w folded on the Flop
Seat 5: mSD1pginDsyHG5PDfqzphw (button) folded before Flop (didn't bet)
Seat 6: +k7T5ocke8UwavtgUHm+Cg (small blind) mucked
Seat 7: Y3DZ6qQlLeBhixDj4M9vmg (big blind) showed [Ks 2c] and won ($4.30) with two pair, Aces and Kings
Seat 8: a4JDWmpFQkL10XfAyuF51A folded before Flop (didn't bet)



PokerStars Game #59939420272:  Hold'em No Limit ($0.25/$0.50) - 2009/07/01 0:39:25 ET
Table '/cQuAT3ef4t+PGrXiNhGaQ' 9-max Seat #6 is the button
Seat 1: HZkVla4kK2SI42CVrPZ/ig ($6 in chips)
Seat 2: jXGruyaMqirTaTXNOvBdew ($70.65 in chips)
Seat 3: g4k0NXISyLCqaSWZDBjfEg ($54.40 in chips)
Seat 4: OWP/DOu+PlPK6ZZ3zYa0HA ($39.90 in chips)
Seat 5: 5SgaHdWixdClWvaEG+KUjQ ($28.35 in chips)
Seat 6: APYIOyK/4AGb+kIwlOUNBQ ($39 in chips)
Seat 7: J0W5D97jl5VLky+IoPvDeA ($114.40 in chips)
Seat 8: W3ingbA178eb7J5rt1PuIQ ($28.95 in chips)
J0W5D97jl5VLky+IoPvDeA: posts small blind $0.25
W3ingbA178eb7J5rt1PuIQ: posts big blind $0.50
AjV5McH1KMMclY26QdLM5w: sits out
*** HOLE CARDS ***
HZkVla4kK2SI42CVrPZ/ig: folds
jXGruyaMqirTaTXNOvBdew: calls $0.50
g4k0NXISyLCqaSWZDBjfEg: folds
OWP/DOu+PlPK6ZZ3zYa0HA: folds
5SgaHdWixdClWvaEG+KUjQ: calls $0.50
APYIOyK/4AGb+kIwlOUNBQ: folds
J0W5D97jl5VLky+IoPvDeA: folds
W3ingbA178eb7J5rt1PuIQ: checks
*** FLOP *** [2h 3d 2s]
W3ingbA178eb7J5rt1PuIQ: checks
jXGruyaMqirTaTXNOvBdew: bets $1.50
5SgaHdWixdClWvaEG+KUjQ: folds
W3ingbA178eb7J5rt1PuIQ: folds
jXGruyaMqirTaTXNOvBdew collected $1.70 from pot
*** SUMMARY ***
Total pot $1.75 | Rake $0.05
Board [2h 3d 2s]
Seat 1: HZkVla4kK2SI42CVrPZ/ig folded before Flop (didn't bet)
Seat 2: jXGruyaMqirTaTXNOvBdew collected ($1.70)
Seat 3: g4k0NXISyLCqaSWZDBjfEg folded before Flop (didn't bet)
Seat 4: OWP/DOu+PlPK6ZZ3zYa0HA folded before Flop (didn't bet)
Seat 5: 5SgaHdWixdClWvaEG+KUjQ folded on the Flop
Seat 6: APYIOyK/4AGb+kIwlOUNBQ (button) folded before Flop (didn't bet)
Seat 7: J0W5D97jl5VLky+IoPvDeA (small blind) folded before Flop
Seat 8: W3ingbA178eb7J5rt1PuIQ (big blind) folded on the Flop



PokerStars Game #59939421196:  Hold'em No Limit ($0.25/$0.50) - 2009/07/01 0:39:26 ET
Table 'tyR5AZNKV8Aadbrnrnlg7g' 6-max Seat #6 is the button
Seat 1: R+KjpH/wSjDLhtIy9+edNA ($88.70 in chips)
Seat 2: BAjwVL+zKKd0s0fAWstzQQ ($24.85 in chips)
Seat 3: tdOvWynovql5imfooroLMg ($45.25 in chips)
Seat 4: Rt6KgtZ8YaJoTc3FPim00w ($85.15 in chips)
Seat 6: ZKazl1hGaPiapDXincgi2Q ($15.65 in chips)
R+KjpH/wSjDLhtIy9+edNA: posts small blind $0.25
BAjwVL+zKKd0s0fAWstzQQ: posts big blind $0.50
Ek4w9XqBXqK5jBUQeLedGw: sits out
*** HOLE CARDS ***
tdOvWynovql5imfooroLMg: folds
Rt6KgtZ8YaJoTc3FPim00w: folds
ZKazl1hGaPiapDXincgi2Q: raises $1 to $1.50
R+KjpH/wSjDLhtIy9+edNA: folds
BAjwVL+zKKd0s0fAWstzQQ: folds
ZKazl1hGaPiapDXincgi2Q collected $1.25 from pot
ZKazl1hGaPiapDXincgi2Q: doesn't show hand
*** SUMMARY ***
Total pot $1.25 | Rake $0
Seat 1: R+KjpH/wSjDLhtIy9+edNA (small blind) folded before Flop
Seat 2: BAjwVL+zKKd0s0fAWstzQQ (big blind) folded before Flop
Seat 3: tdOvWynovql5imfooroLMg folded before Flop (didn't bet)
Seat 4: Rt6KgtZ8YaJoTc3FPim00w folded before Flop (didn't bet)
Seat 6: ZKazl1hGaPiapDXincgi2Q (button) collected ($1.25)



PokerStars Game #59939422240:  Hold'em No Limit ($0.25/$0.50) - 2009/07/01 0:39:28 ET
Table '3FhG0gl3kMX3wBEEqj+wnQ' 9-max Seat #8 is the button
Seat 1: e0J9pdCNUDTCG031RnXqLA ($21.15 in chips)
Seat 2: 7cYQ+syUWjl38ty/ICOMhw ($51.10 in chips)
Seat 3: HZkVla4kK2SI42CVrPZ/ig ($15.95 in chips)
Seat 4: bjvJtA9Hqscfznq66txaOQ ($9.25 in chips)
Seat 5: gsyXT42WLEcOS4DdEk2wlw ($29.25 in chips)
Seat 7: mSD1pginDsyHG5PDfqzphw ($10 in chips)
Seat 8: j3K/Jujr7PY4ZM2RZvlH6A ($54.30 in chips)
Seat 9: L5e2lrPLQm1Pqx30IIZ/Fw ($10 in chips)
L5e2lrPLQm1Pqx30IIZ/Fw: posts small blind $0.25
e0J9pdCNUDTCG031RnXqLA: posts big blind $0.50
997ViqAtWn1FPjJqcffwcA: sits out
*** HOLE CARDS ***
7cYQ+syUWjl38ty/ICOMhw: folds
HZkVla4kK2SI42CVrPZ/ig: calls $0.50
bjvJtA9Hqscfznq66txaOQ: folds
gsyXT42WLEcOS4DdEk2wlw: calls $0.50
mSD1pginDsyHG5PDfqzphw: folds
j3K/Jujr7PY4ZM2RZvlH6A: raises $1 to $1.50
L5e2lrPLQm1Pqx30IIZ/Fw: folds
e0J9pdCNUDTCG031RnXqLA: folds
HZkVla4kK2SI42CVrPZ/ig: raises $2.50 to $4
gsyXT42WLEcOS4DdEk2wlw: folds
j3K/Jujr7PY4ZM2RZvlH6A: calls $2.50
*** FLOP *** [2h Ad Ac]
HZkVla4kK2SI42CVrPZ/ig: checks
j3K/Jujr7PY4ZM2RZvlH6A: bets $3
HZkVla4kK2SI42CVrPZ/ig: calls $3
*** TURN *** [2h Ad Ac] [Ah]
HZkVla4kK2SI42CVrPZ/ig: bets $8.95 and is all-in
j3K/Jujr7PY4ZM2RZvlH6A: folds
HZkVla4kK2SI42CVrPZ/ig collected $14.55 from pot
HZkVla4kK2SI42CVrPZ/ig: doesn't show hand
*** SUMMARY ***
Total pot $15.25 | Rake $0.70
Board [2h Ad Ac Ah]
Seat 1: e0J9pdCNUDTCG031RnXqLA (big blind) folded before Flop
Seat 2: 7cYQ+syUWjl38ty/ICOMhw folded before Flop (didn't bet)
Seat 3: HZkVla4kK2SI42CVrPZ/ig collected ($14.55)
Seat 4: bjvJtA9Hqscfznq66txaOQ folded before Flop (didn't bet)
Seat 5: gsyXT42WLEcOS4DdEk2wlw folded before Flop
Seat 7: mSD1pginDsyHG5PDfqzphw folded before Flop (didn't bet)
Seat 8: j3K/Jujr7PY4ZM2RZvlH6A (button) folded on the Turn
Seat 9: L5e2lrPLQm1Pqx30IIZ/Fw (small blind) folded before Flop



PokerStars Game #59939422978:  Hold'em No Limit ($0.25/$0.50) - 2009/07/01 0:39:29 ET
Table '99gCy/CZQwPIjZWH+BguQgE7bWJ45aoFXRpyRv2gw+Igeat #7 is the button
Seat 2: n6VQBu6crjYjy6DxNP1NZA ($19.70 in chips)
Seat 3: qEn9ijNGtuyTxamBf07hYg ($50 in chips)
Seat 4: bxLSulbgr8LmKNjOzw8URg ($63.45 in chips)
Seat 5: DSM67hHHq1XFoEOi9p8Alw ($50 in chips)
Seat 7: 4dd+rKHhaMiTl5LEkADvQQ ($9.75 in chips)
Seat 8: 8ehL7qlZzjgUh2H35iiWLw ($50.25 in chips)
Seat 9: j3K/Jujr7PY4ZM2RZvlH6A ($86.40 in chips)
8ehL7qlZzjgUh2H35iiWLw: posts small blind $0.25
j3K/Jujr7PY4ZM2RZvlH6A: posts big blind $0.50
RjBdQ6w31rgcy0o24VLR6w: sits out
*** HOLE CARDS ***
n6VQBu6crjYjy6DxNP1NZA: folds
qEn9ijNGtuyTxamBf07hYg: raises $1.50 to $2
bxLSulbgr8LmKNjOzw8URg: folds
DSM67hHHq1XFoEOi9p8Alw: folds
4dd+rKHhaMiTl5LEkADvQQ: folds
8ehL7qlZzjgUh2H35iiWLw: folds
j3K/Jujr7PY4ZM2RZvlH6A: folds
qEn9ijNGtuyTxamBf07hYg collected $1.25 from pot
qEn9ijNGtuyTxamBf07hYg: doesn't show hand
*** SUMMARY ***
Total pot $1.25 | Rake $0
Seat 2: n6VQBu6crjYjy6DxNP1NZA folded before Flop (didn't bet)
Seat 3: qEn9ijNGtuyTxamBf07hYg collected ($1.25)
Seat 4: bxLSulbgr8LmKNjOzw8URg folded before Flop (didn't bet)
Seat 5: DSM67hHHq1XFoEOi9p8Alw folded before Flop (didn't bet)
Seat 7: 4dd+rKHhaMiTl5LEkADvQQ (button) folded before Flop (didn't bet)
Seat 8: 8ehL7qlZzjgUh2H35iiWLw (small blind) folded before Flop
Seat 9: j3K/Jujr7PY4ZM2RZvlH6A (big blind) folded before Flop



PokerStars Game #59939423310:  Hold'em No Limit ($0.25/$0.50) - 2009/07/01 0:39:29 ET
Table 'hWT2kq66tnKEpD26cia6fQ' 2-max Seat #2 is the button
Seat 1: q+vRKwm51mnr6kxX/161WQ ($56.65 in chips)
Seat 2: dkC7J+qbyqk0qCcmJbEPPw ($58.10 in chips)
dkC7J+qbyqk0qCcmJbEPPw: posts small blind $0.25
q+vRKwm51mnr6kxX/161WQ: posts big blind $0.50
*** HOLE CARDS ***
dkC7J+qbyqk0qCcmJbEPPw: raises $1 to $1.50
q+vRKwm51mnr6kxX/161WQ: folds
dkC7J+qbyqk0qCcmJbEPPw collected $1 from pot
*** SUMMARY ***
Total pot $1 | Rake $0
Seat 1: q+vRKwm51mnr6kxX/161WQ (big blind) folded before Flop
Seat 2: dkC7J+qbyqk0qCcmJbEPPw (button) (small blind) collected ($1)



PokerStars Game #59939424960:  Hold'em No Limit ($0.25/$0.50) - 2009/07/01 0:39:32 ET
Table '+dXkOAQyS8j9PQZusUTMpg' 2-max Seat #1 is the button
Seat 1: XFa6sBGjP2gxoIvxR3fZIg ($46.50 in chips)
Seat 2: 5IBeOgaApY1Bvzv2P8X4EA ($144.60 in chips)
XFa6sBGjP2gxoIvxR3fZIg: posts small blind $0.25
5IBeOgaApY1Bvzv2P8X4EA: posts big blind $0.50
*** HOLE CARDS ***
XFa6sBGjP2gxoIvxR3fZIg: raises $1 to $1.50
5IBeOgaApY1Bvzv2P8X4EA: calls $1
*** FLOP *** [4s 2d Qs]
5IBeOgaApY1Bvzv2P8X4EA: checks
XFa6sBGjP2gxoIvxR3fZIg: bets $2
5IBeOgaApY1Bvzv2P8X4EA: calls $2
*** TURN *** [4s 2d Qs] [5h]
5IBeOgaApY1Bvzv2P8X4EA: checks
XFa6sBGjP2gxoIvxR3fZIg: checks
*** RIVER *** [4s 2d Qs 5h] [8d]
5IBeOgaApY1Bvzv2P8X4EA: checks
XFa6sBGjP2gxoIvxR3fZIg: checks
*** SHOW DOWN ***
5IBeOgaApY1Bvzv2P8X4EA: shows [6h 6s] (a pair of Sixes)
XFa6sBGjP2gxoIvxR3fZIg: mucks hand
5IBeOgaApY1Bvzv2P8X4EA collected $6.70 from pot
*** SUMMARY ***
Total pot $7 | Rake $0.30
Board [4s 2d Qs 5h 8d]
Seat 1: XFa6sBGjP2gxoIvxR3fZIg (button) (small blind) mucked
Seat 2: 5IBeOgaApY1Bvzv2P8X4EA (big blind) showed [6h 6s] and won ($6.70) with a pair of Sixes



PokerStars Game #59939425694:  Hold'em No Limit ($0.25/$0.50) - 2009/07/01 0:39:33 ET
Table 'IeNZOZQ4T6oiaHqFeo6yIA' 2-max Seat #1 is the button
Seat 1: ndd1nfncBkWNitBnsfCoVQ ($50.45 in chips)
Seat 2: A91IUl5JaZROhtfCtnnwYw ($94.20 in chips)
ndd1nfncBkWNitBnsfCoVQ: posts small blind $0.25
A91IUl5JaZROhtfCtnnwYw: posts big blind $0.50
*** HOLE CARDS ***
ndd1nfncBkWNitBnsfCoVQ: raises $1 to $1.50
A91IUl5JaZROhtfCtnnwYw: calls $1
*** FLOP *** [5c Jh 4h]
A91IUl5JaZROhtfCtnnwYw: bets $0.50
ndd1nfncBkWNitBnsfCoVQ: raises $2.50 to $3
A91IUl5JaZROhtfCtnnwYw: calls $2.50
*** TURN *** [5c Jh 4h] [3h]
A91IUl5JaZROhtfCtnnwYw: checks
ndd1nfncBkWNitBnsfCoVQ: bets $7
A91IUl5JaZROhtfCtnnwYw: calls $7
*** RIVER *** [5c Jh 4h 3h] [6s]
A91IUl5JaZROhtfCtnnwYw: bets $23.50
ndd1nfncBkWNitBnsfCoVQ: folds
A91IUl5JaZROhtfCtnnwYw collected $22.50 from pot
A91IUl5JaZROhtfCtnnwYw: doesn't show hand
*** SUMMARY ***
Total pot $23 | Rake $0.50
Board [5c Jh 4h 3h 6s]
Seat 1: ndd1nfncBkWNitBnsfCoVQ (button) (small blind) folded on the River
Seat 2: A91IUl5JaZROhtfCtnnwYw (big blind) collected ($22.50)



PokerStars Game #59939425392:  Hold'em No Limit ($0.25/$0.50) - 2009/07/01 0:39:33 ET
Table '+111aLuBwnz8YVYSA7J1jA' 2-max Seat #1 is the button
Seat 1: ndd1nfncBkWNitBnsfCoVQ ($91.50 in chips)
Seat 2: +ciXH35zeafrjg1W6wiBTg ($55.95 in chips)
ndd1nfncBkWNitBnsfCoVQ: posts small blind $0.25
+ciXH35zeafrjg1W6wiBTg: posts big blind $0.50
*** HOLE CARDS ***
ndd1nfncBkWNitBnsfCoVQ: raises $1 to $1.50
+ciXH35zeafrjg1W6wiBTg: folds
ndd1nfncBkWNitBnsfCoVQ collected $1 from pot
ndd1nfncBkWNitBnsfCoVQ: doesn't show hand
*** SUMMARY ***
Total pot $1 | Rake $0
Seat 1: ndd1nfncBkWNitBnsfCoVQ (button) (small blind) collected ($1)
Seat 2: +ciXH35zeafrjg1W6wiBTg (big blind) folded before Flop



PokerStars Game #59939426740:  Hold'em No Limit ($0.25/$0.50) - 2009/07/01 0:39:35 ET
Table '5EmHi+fnatGQQShcNmzOZQ' 6-max Seat #5 is the button
Seat 1: +SZCX3+7lnuhHKIu+PP9rg ($29.50 in chips)
Seat 2: vXIHnZ+dv/hwSBxyvGw7bQ ($77.25 in chips)
Seat 3: L9qfLYXrczhAPd/VckgsWw ($84.25 in chips)
Seat 4: 1b+2BbjMN8qhR1WPqdE9VQ ($55.65 in chips)
Seat 5: kxPhs4ePFqMy52CInAJ2aw ($51.60 in chips)
Seat 6: 686aeHikcJlgKkSuIFdcXQ ($141.45 in chips)
686aeHikcJlgKkSuIFdcXQ: posts small blind $0.25
+SZCX3+7lnuhHKIu+PP9rg: posts big blind $0.50
*** HOLE CARDS ***
vXIHnZ+dv/hwSBxyvGw7bQ: folds
L9qfLYXrczhAPd/VckgsWw: folds
1b+2BbjMN8qhR1WPqdE9VQ: folds
kxPhs4ePFqMy52CInAJ2aw: folds
686aeHikcJlgKkSuIFdcXQ: folds
+SZCX3+7lnuhHKIu+PP9rg collected $0.50 from pot
+SZCX3+7lnuhHKIu+PP9rg: doesn't show hand
*** SUMMARY ***
Total pot $0.50 | Rake $0
Seat 1: +SZCX3+7lnuhHKIu+PP9rg (big blind) collected ($0.50)
Seat 2: vXIHnZ+dv/hwSBxyvGw7bQ folded before Flop (didn't bet)
Seat 3: L9qfLYXrczhAPd/VckgsWw folded before Flop (didn't bet)
Seat 4: 1b+2BbjMN8qhR1WPqdE9VQ folded before Flop (didn't bet)
Seat 5: kxPhs4ePFqMy52CInAJ2aw (button) folded before Flop (didn't bet)
Seat 6: 686aeHikcJlgKkSuIFdcXQ (small blind) folded before Flop



PokerStars Game #59939428330:  Hold'em No Limit ($0.25/$0.50) - 2009/07/01 0:39:37 ET
Table 'BCN5su+SsXiy1zRMJi0SJw' 6-max Seat #4 is the button
Seat 1: crjGpJEzSZgD38FoE3VMGg ($50 in chips)
Seat 2: oU2kDCkT/gilYbHWrg7D8w ($13.65 in chips)
Seat 3: g+vwI6lMKpU2uteXSjOzVw ($20.05 in chips)
Seat 4: JY9CtoZTeav+mhWyxSSyJQ ($23.95 in chips)
Seat 5: IBNygaT1aa9Z1uPdJJilwA ($64.25 in chips)
Seat 6: b2symlOdL7+0c9Pj4N/KlA ($50 in chips)
IBNygaT1aa9Z1uPdJJilwA: posts small blind $0.25
b2symlOdL7+0c9Pj4N/KlA: posts big blind $0.50
*** HOLE CARDS ***
JY9CtoZTeav+mhWyxSSyJQ said, "lol"
crjGpJEzSZgD38FoE3VMGg: folds
oU2kDCkT/gilYbHWrg7D8w: folds
g+vwI6lMKpU2uteXSjOzVw: folds
JY9CtoZTeav+mhWyxSSyJQ: folds
IBNygaT1aa9Z1uPdJJilwA: folds
b2symlOdL7+0c9Pj4N/KlA collected $0.50 from pot
b2symlOdL7+0c9Pj4N/KlA: doesn't show hand
*** SUMMARY ***
Total pot $0.50 | Rake $0
Seat 1: crjGpJEzSZgD38FoE3VMGg folded before Flop (didn't bet)
Seat 2: oU2kDCkT/gilYbHWrg7D8w folded before Flop (didn't bet)
Seat 3: g+vwI6lMKpU2uteXSjOzVw folded before Flop (didn't bet)
Seat 4: JY9CtoZTeav+mhWyxSSyJQ (button) folded before Flop (didn't bet)
Seat 5: IBNygaT1aa9Z1uPdJJilwA (small blind) folded before Flop
Seat 6: b2symlOdL7+0c9Pj4N/KlA (big blind) collected ($0.50)



PokerStars Game #59939428058:  Hold'em No Limit ($0.25/$0.50) - 2009/07/01 0:39:37 ET
Table 'eMxdLyFDf28E0wit6gm3Uw' 6-max Seat #3 is the button
Seat 1: GtdWeBVCZhDBcNFRTOb8Hg ($4.50 in chips)
Seat 2: jwuKQ1S3U4NnzMQn3E3dgw ($74.15 in chips)
Seat 3: dZcLsEI8iXkobBduRJ45Yw ($10.80 in chips)
Seat 4: 3jxEWvv2qK1HCXLj4khowQ ($29 in chips)
Seat 5: X0X97o2fDAPiGx6o1gahsw ($54.10 in chips)
Seat 6: L0aIPg7qefDQjdJo3HCVEA ($17.70 in chips)
3jxEWvv2qK1HCXLj4khowQ: posts small blind $0.25
X0X97o2fDAPiGx6o1gahsw: posts big blind $0.50
*** HOLE CARDS ***
L0aIPg7qefDQjdJo3HCVEA: folds
GtdWeBVCZhDBcNFRTOb8Hg: calls $0.50
jwuKQ1S3U4NnzMQn3E3dgw: folds
dZcLsEI8iXkobBduRJ45Yw: calls $0.50
3jxEWvv2qK1HCXLj4khowQ: folds
X0X97o2fDAPiGx6o1gahsw: checks
*** FLOP *** [Jd 9d 3s]
X0X97o2fDAPiGx6o1gahsw: checks
GtdWeBVCZhDBcNFRTOb8Hg: checks
dZcLsEI8iXkobBduRJ45Yw: bets $1
X0X97o2fDAPiGx6o1gahsw: calls $1
GtdWeBVCZhDBcNFRTOb8Hg: folds
*** TURN *** [Jd 9d 3s] [6h]
X0X97o2fDAPiGx6o1gahsw: checks
dZcLsEI8iXkobBduRJ45Yw: checks
*** RIVER *** [Jd 9d 3s 6h] [8h]
X0X97o2fDAPiGx6o1gahsw: checks
dZcLsEI8iXkobBduRJ45Yw: bets $0.50
X0X97o2fDAPiGx6o1gahsw: calls $0.50
*** SHOW DOWN ***
dZcLsEI8iXkobBduRJ45Yw: shows [Qh 9c] (a pair of Nines)
X0X97o2fDAPiGx6o1gahsw: mucks hand
dZcLsEI8iXkobBduRJ45Yw collected $4.55 from pot
*** SUMMARY ***
Total pot $4.75 | Rake $0.20
Board [Jd 9d 3s 6h 8h]
Seat 1: GtdWeBVCZhDBcNFRTOb8Hg folded on the Flop
Seat 2: jwuKQ1S3U4NnzMQn3E3dgw folded before Flop (didn't bet)
Seat 3: dZcLsEI8iXkobBduRJ45Yw (button) showed [Qh 9c] and won ($4.55) with a pair of Nines
Seat 4: 3jxEWvv2qK1HCXLj4khowQ (small blind) folded before Flop
Seat 5: X0X97o2fDAPiGx6o1gahsw (big blind) mucked
Seat 6: L0aIPg7qefDQjdJo3HCVEA folded before Flop (didn't bet)



PokerStars Game #59939428146:  Hold'em No Limit ($0.25/$0.50) - 2009/07/01 0:39:37 ET
Table 'hWT2kq66tnKEpD26cia6fQ' 2-max Seat #1 is the button
Seat 1: q+vRKwm51mnr6kxX/161WQ ($56.15 in chips)
Seat 2: dkC7J+qbyqk0qCcmJbEPPw ($58.60 in chips)
q+vRKwm51mnr6kxX/161WQ: posts small blind $0.25
dkC7J+qbyqk0qCcmJbEPPw: posts big blind $0.50
*** HOLE CARDS ***
q+vRKwm51mnr6kxX/161WQ: raises $1 to $1.50
dkC7J+qbyqk0qCcmJbEPPw: folds
q+vRKwm51mnr6kxX/161WQ collected $1 from pot
q+vRKwm51mnr6kxX/161WQ: doesn't show hand
*** SUMMARY ***
Total pot $1 | Rake $0
Seat 1: q+vRKwm51mnr6kxX/161WQ (button) (small blind) collected ($1)
Seat 2: dkC7J+qbyqk0qCcmJbEPPw (big blind) folded before Flop



PokerStars Game #59939428846:  Hold'em No Limit ($0.25/$0.50) - 2009/07/01 0:39:38 ET
Table 'c/CRn+68J3Y8KxD5g1ek2Q' 2-max Seat #2 is the button
Seat 1: 46qCyJ6evTkHo9al5sBMNA ($208.20 in chips)
Seat 2: BypVLsYQt3ePFm2xQL/dOA ($166.90 in chips)
BypVLsYQt3ePFm2xQL/dOA: posts small blind $0.25
46qCyJ6evTkHo9al5sBMNA: posts big blind $0.50
*** HOLE CARDS ***
BypVLsYQt3ePFm2xQL/dOA: raises $1 to $1.50
46qCyJ6evTkHo9al5sBMNA: folds
BypVLsYQt3ePFm2xQL/dOA collected $1 from pot
BypVLsYQt3ePFm2xQL/dOA: doesn't show hand
*** SUMMARY ***
Total pot $1 | Rake $0
Seat 1: 46qCyJ6evTkHo9al5sBMNA (big blind) folded before Flop
Seat 2: BypVLsYQt3ePFm2xQL/dOA (button) (small blind) collected ($1)



PokerStars Game #59939429084:  Hold'em No Limit ($0.25/$0.50) - 2009/07/01 0:39:38 ET
Table '37qXEp3oe+er5q4CZip9eQ' 6-max Seat #2 is the button
Seat 1: oqOqoO2AyCZenUghCxMDxw ($52.25 in chips)
Seat 2: 6wzJiRvp8HY6t+MQGnSIzA ($24.85 in chips)
Seat 3: Rt6KgtZ8YaJoTc3FPim00w ($73.25 in chips)
Seat 4: XsmE8nXMAAMFJbWaJTmHFw ($28.35 in chips)
Seat 5: VOmI0x4dDPnTESZd5B4d1Q ($49.40 in chips)
Seat 6: N50kln4negd8q7Mmoz1j4g ($29.35 in chips)
Rt6KgtZ8YaJoTc3FPim00w: posts small blind $0.25
XsmE8nXMAAMFJbWaJTmHFw: posts big blind $0.50
*** HOLE CARDS ***
VOmI0x4dDPnTESZd5B4d1Q: calls $0.50
N50kln4negd8q7Mmoz1j4g: calls $0.50
oqOqoO2AyCZenUghCxMDxw: folds
6wzJiRvp8HY6t+MQGnSIzA: folds
Rt6KgtZ8YaJoTc3FPim00w: folds
XsmE8nXMAAMFJbWaJTmHFw: checks
*** FLOP *** [8s Ah 6s]
XsmE8nXMAAMFJbWaJTmHFw: bets $1
VOmI0x4dDPnTESZd5B4d1Q: folds
N50kln4negd8q7Mmoz1j4g: calls $1
*** TURN *** [8s Ah 6s] [Jc]
XsmE8nXMAAMFJbWaJTmHFw: bets $1.60
N50kln4negd8q7Mmoz1j4g: folds
XsmE8nXMAAMFJbWaJTmHFw collected $3.60 from pot
*** SUMMARY ***
Total pot $3.75 | Rake $0.15
Board [8s Ah 6s Jc]
Seat 1: oqOqoO2AyCZenUghCxMDxw folded before Flop (didn't bet)
Seat 2: 6wzJiRvp8HY6t+MQGnSIzA (button) folded before Flop (didn't bet)
Seat 3: Rt6KgtZ8YaJoTc3FPim00w (small blind) folded before Flop
Seat 4: XsmE8nXMAAMFJbWaJTmHFw (big blind) collected ($3.60)
Seat 5: VOmI0x4dDPnTESZd5B4d1Q folded on the Flop
Seat 6: N50kln4negd8q7Mmoz1j4g folded on the Turn



PokerStars Game #59939429024:  Hold'em No Limit ($0.25/$0.50) - 2009/07/01 0:39:38 ET
Table 'EiNh8p/wGJ1FP575iMFnqg' 9-max Seat #9 is the button
Seat 1: r3ZqM1Mi0W3y4hOdssE+Sg ($49.65 in chips)
Seat 2: 8ehL7qlZzjgUh2H35iiWLw ($52 in chips)
Seat 3: ymLPoEIl7UL3TvZYmnadxQ ($49.35 in chips)
Seat 5: M+7+BTmX5vZatHVuoRB1nA ($85.35 in chips)
Seat 6: 3UmXLy3GfjC3EkOebduerQ ($54.65 in chips)
Seat 7: 997ViqAtWn1FPjJqcffwcA ($50 in chips)
Seat 8: KrPAGRACBg+w0M//SXe8Ag ($11.35 in chips)
Seat 9: OMwFJ4pF0xk2Ru/AJiFeFw ($100.25 in chips)
r3ZqM1Mi0W3y4hOdssE+Sg: posts small blind $0.25
8ehL7qlZzjgUh2H35iiWLw: posts big blind $0.50
cMzaiXAM/ZAdNaEUu+LqhA: sits out
*** HOLE CARDS ***
ymLPoEIl7UL3TvZYmnadxQ: folds
M+7+BTmX5vZatHVuoRB1nA: folds
3UmXLy3GfjC3EkOebduerQ: folds
997ViqAtWn1FPjJqcffwcA: folds
KrPAGRACBg+w0M//SXe8Ag: calls $0.50
OMwFJ4pF0xk2Ru/AJiFeFw: raises $1 to $1.50
r3ZqM1Mi0W3y4hOdssE+Sg: folds
8ehL7qlZzjgUh2H35iiWLw: folds
KrPAGRACBg+w0M//SXe8Ag: folds
OMwFJ4pF0xk2Ru/AJiFeFw collected $1.75 from pot
OMwFJ4pF0xk2Ru/AJiFeFw: doesn't show hand
*** SUMMARY ***
Total pot $1.75 | Rake $0
Seat 1: r3ZqM1Mi0W3y4hOdssE+Sg (small blind) folded before Flop
Seat 2: 8ehL7qlZzjgUh2H35iiWLw (big blind) folded before Flop
Seat 3: ymLPoEIl7UL3TvZYmnadxQ folded before Flop (didn't bet)
Seat 5: M+7+BTmX5vZatHVuoRB1nA folded before Flop (didn't bet)
Seat 6: 3UmXLy3GfjC3EkOebduerQ folded before Flop (didn't bet)
Seat 7: 997ViqAtWn1FPjJqcffwcA folded before Flop (didn't bet)
Seat 8: KrPAGRACBg+w0M//SXe8Ag folded before Flop
Seat 9: OMwFJ4pF0xk2Ru/AJiFeFw (button) collected ($1.75)



PokerStars Game #59939429774:  Hold'em No Limit ($0.25/$0.50) - 2009/07/01 0:39:39 ET
Table '+111aLuBwnz8YVYSA7J1jA' 2-max Seat #2 is the button
Seat 1: ndd1nfncBkWNitBnsfCoVQ ($92 in chips)
Seat 2: +ciXH35zeafrjg1W6wiBTg ($55.45 in chips)
+ciXH35zeafrjg1W6wiBTg: posts small blind $0.25
ndd1nfncBkWNitBnsfCoVQ: posts big blind $0.50
*** HOLE CARDS ***
+ciXH35zeafrjg1W6wiBTg: raises $1 to $1.50
ndd1nfncBkWNitBnsfCoVQ: folds
+ciXH35zeafrjg1W6wiBTg collected $1 from pot
+ciXH35zeafrjg1W6wiBTg: doesn't show hand
*** SUMMARY ***
Total pot $1 | Rake $0
Seat 1: ndd1nfncBkWNitBnsfCoVQ (big blind) folded before Flop
Seat 2: +ciXH35zeafrjg1W6wiBTg (button) (small blind) collected ($1)



PokerStars Game #59939430588:  Hold'em No Limit ($0.25/$0.50) - 2009/07/01 0:39:41 ET
Table 'tyR5AZNKV8Aadbrnrnlg7g' 6-max Seat #1 is the button
Seat 1: R+KjpH/wSjDLhtIy9+edNA ($88.45 in chips)
Seat 2: BAjwVL+zKKd0s0fAWstzQQ ($24.35 in chips)
Seat 3: tdOvWynovql5imfooroLMg ($45.25 in chips)
Seat 4: Rt6KgtZ8YaJoTc3FPim00w ($85.15 in chips)
Seat 6: ZKazl1hGaPiapDXincgi2Q ($16.40 in chips)
BAjwVL+zKKd0s0fAWstzQQ: posts small blind $0.25
tdOvWynovql5imfooroLMg: posts big blind $0.50
Ek4w9XqBXqK5jBUQeLedGw: sits out
*** HOLE CARDS ***
Rt6KgtZ8YaJoTc3FPim00w: folds
ZKazl1hGaPiapDXincgi2Q: calls $0.50
R+KjpH/wSjDLhtIy9+edNA: calls $0.50
BAjwVL+zKKd0s0fAWstzQQ: folds
tdOvWynovql5imfooroLMg: checks
*** FLOP *** [6h 9c Qh]
tdOvWynovql5imfooroLMg: checks
ZKazl1hGaPiapDXincgi2Q: checks
R+KjpH/wSjDLhtIy9+edNA: bets $1
tdOvWynovql5imfooroLMg: folds
ZKazl1hGaPiapDXincgi2Q: calls $1
*** TURN *** [6h 9c Qh] [3c]
ZKazl1hGaPiapDXincgi2Q: checks
R+KjpH/wSjDLhtIy9+edNA: bets $2
ZKazl1hGaPiapDXincgi2Q: calls $2
*** RIVER *** [6h 9c Qh 3c] [8d]
ZKazl1hGaPiapDXincgi2Q: checks
R+KjpH/wSjDLhtIy9+edNA: checks
*** SHOW DOWN ***
ZKazl1hGaPiapDXincgi2Q: shows [Jc Ac] (high card Ace)
R+KjpH/wSjDLhtIy9+edNA: shows [9h 4h] (a pair of Nines)
R+KjpH/wSjDLhtIy9+edNA collected $7.40 from pot
*** SUMMARY ***
Total pot $7.75 | Rake $0.35
Board [6h 9c Qh 3c 8d]
Seat 1: R+KjpH/wSjDLhtIy9+edNA (button) showed [9h 4h] and won ($7.40) with a pair of Nines
Seat 2: BAjwVL+zKKd0s0fAWstzQQ (small blind) folded before Flop
Seat 3: tdOvWynovql5imfooroLMg (big blind) folded on the Flop
Seat 4: Rt6KgtZ8YaJoTc3FPim00w folded before Flop (didn't bet)
Seat 6: ZKazl1hGaPiapDXincgi2Q showed [Jc Ac] and lost with high card Ace



PokerStars Game #59939432016:  Hold'em No Limit ($0.25/$0.50) - 2009/07/01 0:39:43 ET
Table 'E7bWJ45aoFXRpyRv2gw+Ig' 2-max Seat #1 is the button
Seat 1: FRkiRasEGlHUeLrEl+k/nA ($52.75 in chips)
Seat 2: 3Wro85I7472vJ4Wkpneo9A ($145.05 in chips)
FRkiRasEGlHUeLrEl+k/nA: posts small blind $0.25
3Wro85I7472vJ4Wkpneo9A: posts big blind $0.50
*** HOLE CARDS ***
FRkiRasEGlHUeLrEl+k/nA: calls $0.25
3Wro85I7472vJ4Wkpneo9A: checks
*** FLOP *** [Ts 7s Kd]
3Wro85I7472vJ4Wkpneo9A: checks
FRkiRasEGlHUeLrEl+k/nA: checks
*** TURN *** [Ts 7s Kd] [7d]
3Wro85I7472vJ4Wkpneo9A: checks
FRkiRasEGlHUeLrEl+k/nA: checks
*** RIVER *** [Ts 7s Kd 7d] [Jh]
3Wro85I7472vJ4Wkpneo9A: checks
FRkiRasEGlHUeLrEl+k/nA: bets $1
3Wro85I7472vJ4Wkpneo9A: folds
FRkiRasEGlHUeLrEl+k/nA collected $0.95 from pot
*** SUMMARY ***
Total pot $1 | Rake $0.05
Board [Ts 7s Kd 7d Jh]
Seat 1: FRkiRasEGlHUeLrEl+k/nA (button) (small blind) collected ($0.95)
Seat 2: 3Wro85I7472vJ4Wkpneo9A (big blind) folded on the River



PokerStars Game #59939433342:  Hold'em No Limit ($0.25/$0.50) - 2009/07/01 0:39:45 ET
Table 'hWT2kq66tnKEpD26cia6fQ' 2-max Seat #2 is the button
Seat 1: q+vRKwm51mnr6kxX/161WQ ($56.65 in chips)
Seat 2: dkC7J+qbyqk0qCcmJbEPPw ($58.10 in chips)
dkC7J+qbyqk0qCcmJbEPPw: posts small blind $0.25
q+vRKwm51mnr6kxX/161WQ: posts big blind $0.50
*** HOLE CARDS ***
dkC7J+qbyqk0qCcmJbEPPw: raises $1 to $1.50
q+vRKwm51mnr6kxX/161WQ: folds
dkC7J+qbyqk0qCcmJbEPPw collected $1 from pot
*** SUMMARY ***
Total pot $1 | Rake $0
Seat 1: q+vRKwm51mnr6kxX/161WQ (big blind) folded before Flop
Seat 2: dkC7J+qbyqk0qCcmJbEPPw (button) (small blind) collected ($1)



PokerStars Game #59939433574:  Hold'em No Limit ($0.25/$0.50) - 2009/07/01 0:39:45 ET
Table '+z1aekfHkpp09pc8F9aViw' 6-max Seat #1 is the button
Seat 1: FHilMb2i2DbUCc9lplszog ($21.10 in chips)
Seat 2: M6xK/VklCvdyyrmvzATlxQ ($36.30 in chips)
Seat 3: uUznlIMFnRUvwrBhYF73KA ($89.45 in chips)
Seat 4: RowCSpSURHTOL/dcjg/Iug ($50.30 in chips)
Seat 5: crjGpJEzSZgD38FoE3VMGg ($50 in chips)
Seat 6: 686aeHikcJlgKkSuIFdcXQ ($68.60 in chips)
M6xK/VklCvdyyrmvzATlxQ: posts small blind $0.25
uUznlIMFnRUvwrBhYF73KA: posts big blind $0.50
*** HOLE CARDS ***
RowCSpSURHTOL/dcjg/Iug: folds
crjGpJEzSZgD38FoE3VMGg: folds
686aeHikcJlgKkSuIFdcXQ: raises $1 to $1.50
FHilMb2i2DbUCc9lplszog: calls $1.50
M6xK/VklCvdyyrmvzATlxQ: folds
uUznlIMFnRUvwrBhYF73KA: calls $1
*** FLOP *** [Jc 3h 3d]
uUznlIMFnRUvwrBhYF73KA: checks
686aeHikcJlgKkSuIFdcXQ: checks
FHilMb2i2DbUCc9lplszog: checks
*** TURN *** [Jc 3h 3d] [4s]
uUznlIMFnRUvwrBhYF73KA: checks
686aeHikcJlgKkSuIFdcXQ: checks
FHilMb2i2DbUCc9lplszog: bets $2
uUznlIMFnRUvwrBhYF73KA: calls $2
686aeHikcJlgKkSuIFdcXQ: folds
*** RIVER *** [Jc 3h 3d 4s] [Qc]
uUznlIMFnRUvwrBhYF73KA: bets $5
FHilMb2i2DbUCc9lplszog: raises $12.60 to $17.60 and is all-in
uUznlIMFnRUvwrBhYF73KA: folds
FHilMb2i2DbUCc9lplszog collected $17.85 from pot
*** SUMMARY ***
Total pot $18.75 | Rake $0.90
Board [Jc 3h 3d 4s Qc]
Seat 1: FHilMb2i2DbUCc9lplszog (button) collected ($17.85)
Seat 2: M6xK/VklCvdyyrmvzATlxQ (small blind) folded before Flop
Seat 3: uUznlIMFnRUvwrBhYF73KA (big blind) folded on the River
Seat 4: RowCSpSURHTOL/dcjg/Iug folded before Flop (didn't bet)
Seat 5: crjGpJEzSZgD38FoE3VMGg folded before Flop (didn't bet)
Seat 6: 686aeHikcJlgKkSuIFdcXQ folded on the Turn



PokerStars Game #59939433976:  Hold'em No Limit ($0.25/$0.50) - 2009/07/01 0:39:46 ET
Table 'QOgaEqMcJ73pcUMMxoisUg' 6-max Seat #5 is the button
Seat 1: OZ6OtYh5Y53MCH/p0QTn5g ($54.20 in chips)
Seat 2: 4QfsCWthT/vSLirorNXqtg ($50 in chips)
Seat 3: Rt6KgtZ8YaJoTc3FPim00w ($77.50 in chips)
Seat 4: zAcsDhG/T128Vn7XGVSgKg ($57.40 in chips)
Seat 5: 6vNxrjjCl6FwfaaymM9jjg ($15 in chips)
Seat 6: pmE+2KJb4nffAVqjLIXxFg ($21 in chips)
pmE+2KJb4nffAVqjLIXxFg: posts small blind $0.25
OZ6OtYh5Y53MCH/p0QTn5g: posts big blind $0.50
*** HOLE CARDS ***
4QfsCWthT/vSLirorNXqtg: folds
Rt6KgtZ8YaJoTc3FPim00w: folds
zAcsDhG/T128Vn7XGVSgKg: folds
6vNxrjjCl6FwfaaymM9jjg: raises $2 to $2.50
pmE+2KJb4nffAVqjLIXxFg: calls $2.25
OZ6OtYh5Y53MCH/p0QTn5g: folds
*** FLOP *** [As 9c Ts]
pmE+2KJb4nffAVqjLIXxFg: checks
6vNxrjjCl6FwfaaymM9jjg: checks
*** TURN *** [As 9c Ts] [7h]
pmE+2KJb4nffAVqjLIXxFg: checks
6vNxrjjCl6FwfaaymM9jjg: checks
*** RIVER *** [As 9c Ts 7h] [3d]
pmE+2KJb4nffAVqjLIXxFg: bets $0.50
6vNxrjjCl6FwfaaymM9jjg: calls $0.50
*** SHOW DOWN ***
pmE+2KJb4nffAVqjLIXxFg: shows [Qs Qd] (a pair of Queens)
6vNxrjjCl6FwfaaymM9jjg: mucks hand
pmE+2KJb4nffAVqjLIXxFg collected $6.20 from pot
*** SUMMARY ***
Total pot $6.50 | Rake $0.30
Board [As 9c Ts 7h 3d]
Seat 1: OZ6OtYh5Y53MCH/p0QTn5g (big blind) folded before Flop
Seat 2: 4QfsCWthT/vSLirorNXqtg folded before Flop (didn't bet)
Seat 3: Rt6KgtZ8YaJoTc3FPim00w folded before Flop (didn't bet)
Seat 4: zAcsDhG/T128Vn7XGVSgKg folded before Flop (didn't bet)
Seat 5: 6vNxrjjCl6FwfaaymM9jjg (button) mucked
Seat 6: pmE+2KJb4nffAVqjLIXxFg (small blind) showed [Qs Qd] and won ($6.20) with a pair of Queens



PokerStars Game #59939434650:  Hold'em No Limit ($0.25/$0.50) - 2009/07/01 0:39:47 ET
Table '+111aLuBwnz8YVYSA7J1jA' 2-max Seat #1 is the button
Seat 1: ndd1nfncBkWNitBnsfCoVQ ($91.50 in chips)
Seat 2: +ciXH35zeafrjg1W6wiBTg ($55.95 in chips)
ndd1nfncBkWNitBnsfCoVQ: posts small blind $0.25
+ciXH35zeafrjg1W6wiBTg: posts big blind $0.50
*** HOLE CARDS ***
ndd1nfncBkWNitBnsfCoVQ: raises $1 to $1.50
+ciXH35zeafrjg1W6wiBTg: calls $1
*** FLOP *** [Qh 4s 8d]
+ciXH35zeafrjg1W6wiBTg: checks
ndd1nfncBkWNitBnsfCoVQ: checks
*** TURN *** [Qh 4s 8d] [2s]
+ciXH35zeafrjg1W6wiBTg: bets $2
ndd1nfncBkWNitBnsfCoVQ: calls $2
*** RIVER *** [Qh 4s 8d 2s] [Ac]
+ciXH35zeafrjg1W6wiBTg: checks
ndd1nfncBkWNitBnsfCoVQ: checks
*** SHOW DOWN ***
+ciXH35zeafrjg1W6wiBTg: shows [Jc Th] (high card Ace)
ndd1nfncBkWNitBnsfCoVQ: shows [6h 4c] (a pair of Fours)
ndd1nfncBkWNitBnsfCoVQ collected $6.70 from pot
*** SUMMARY ***
Total pot $7 | Rake $0.30
Board [Qh 4s 8d 2s Ac]
Seat 1: ndd1nfncBkWNitBnsfCoVQ (button) (small blind) showed [6h 4c] and won ($6.70) with a pair of Fours
Seat 2: +ciXH35zeafrjg1W6wiBTg (big blind) showed [Jc Th] and lost with high card Ace



PokerStars Game #59939435048:  Hold'em No Limit ($0.25/$0.50) - 2009/07/01 0:39:47 ET
Table 'QOgaEqMcJ73pcUMMxoisUgErOuyGLI5PT3G5MnpHgC/g Seat #8 is the button
Seat 1: L5e2lrPLQm1Pqx30IIZ/Fw ($10 in chips)
Seat 3: xZCXQSXlrZkp3pZizzVXCw ($50.50 in chips)
Seat 4: 3UmXLy3GfjC3EkOebduerQ ($50 in chips)
Seat 5: JwvquocWfhTVApN5t47LgA ($59.55 in chips)
Seat 6: zE9cVigS2nW/Ljy4K4bUQA ($30 in chips)
Seat 7: 90Wb75h3W1BRpbqVnuk8gw ($60.20 in chips)
Seat 8: g4k0NXISyLCqaSWZDBjfEg ($51.35 in chips)
Seat 9: J0W5D97jl5VLky+IoPvDeA ($58.15 in chips)
J0W5D97jl5VLky+IoPvDeA: posts small blind $0.25
L5e2lrPLQm1Pqx30IIZ/Fw: posts big blind $0.50
*** HOLE CARDS ***
xZCXQSXlrZkp3pZizzVXCw: folds
3UmXLy3GfjC3EkOebduerQ: folds
JwvquocWfhTVApN5t47LgA: folds
zE9cVigS2nW/Ljy4K4bUQA: folds
90Wb75h3W1BRpbqVnuk8gw: raises $1.50 to $2
g4k0NXISyLCqaSWZDBjfEg: folds
J0W5D97jl5VLky+IoPvDeA: folds
L5e2lrPLQm1Pqx30IIZ/Fw: folds
90Wb75h3W1BRpbqVnuk8gw collected $1.25 from pot
*** SUMMARY ***
Total pot $1.25 | Rake $0
Seat 1: L5e2lrPLQm1Pqx30IIZ/Fw (big blind) folded before Flop
Seat 3: xZCXQSXlrZkp3pZizzVXCw folded before Flop (didn't bet)
Seat 4: 3UmXLy3GfjC3EkOebduerQ folded before Flop (didn't bet)
Seat 5: JwvquocWfhTVApN5t47LgA folded before Flop (didn't bet)
Seat 6: zE9cVigS2nW/Ljy4K4bUQA folded before Flop (didn't bet)
Seat 7: 90Wb75h3W1BRpbqVnuk8gw collected ($1.25)
Seat 8: g4k0NXISyLCqaSWZDBjfEg (button) folded before Flop (didn't bet)
Seat 9: J0W5D97jl5VLky+IoPvDeA (small blind) folded before Flop



PokerStars Game #59939435278:  Hold'em No Limit ($0.25/$0.50) - 2009/07/01 0:39:48 ET
Table 'QOeVnLhwctF9UyV/beDi+A' 2-max Seat #1 is the button
Seat 1: bypIyrYcAAifLfhZpGlKLA ($51.30 in chips)
Seat 2: Ucrm3XtZmoONapW32SPhag ($34.20 in chips)
bypIyrYcAAifLfhZpGlKLA: posts small blind $0.25
Ucrm3XtZmoONapW32SPhag: posts big blind $0.50
*** HOLE CARDS ***
bypIyrYcAAifLfhZpGlKLA: raises $1 to $1.50
Ucrm3XtZmoONapW32SPhag: folds
bypIyrYcAAifLfhZpGlKLA collected $1 from pot
bypIyrYcAAifLfhZpGlKLA: doesn't show hand
*** SUMMARY ***
Total pot $1 | Rake $0
Seat 1: bypIyrYcAAifLfhZpGlKLA (button) (small blind) collected ($1)
Seat 2: Ucrm3XtZmoONapW32SPhag (big blind) folded before Flop



PokerStars Game #59939435676:  Hold'em No Limit ($0.25/$0.50) - 2009/07/01 0:39:48 ET
Table 'c/CRn+68J3Y8KxD5g1ek2Q' 2-max Seat #1 is the button
Seat 1: 46qCyJ6evTkHo9al5sBMNA ($207.70 in chips)
Seat 2: BypVLsYQt3ePFm2xQL/dOA ($167.40 in chips)
46qCyJ6evTkHo9al5sBMNA: posts small blind $0.25
BypVLsYQt3ePFm2xQL/dOA: posts big blind $0.50
*** HOLE CARDS ***
46qCyJ6evTkHo9al5sBMNA: folds
BypVLsYQt3ePFm2xQL/dOA collected $0.50 from pot
BypVLsYQt3ePFm2xQL/dOA: doesn't show hand
*** SUMMARY ***
Total pot $0.50 | Rake $0
Seat 1: 46qCyJ6evTkHo9al5sBMNA (button) (small blind) folded before Flop
Seat 2: BypVLsYQt3ePFm2xQL/dOA (big blind) collected ($0.50)



PokerStars Game #59939436440:  Hold'em No Limit ($0.25/$0.50) - 2009/07/01 0:39:50 ET
Table 'MJxeZCzYELxiIsyUZyT0jw' 6-max Seat #6 is the button
Seat 1: tdOvWynovql5imfooroLMg ($51.80 in chips)
Seat 2: dB6jzDlJmET84VMWw1mTRA ($50 in chips)
Seat 3: JQZew0FjzS19kTjeNtrE+A ($50.55 in chips)
Seat 4: lP7Q6pewz4C2RsAfKsjdWw ($33.90 in chips)
Seat 5: 3jvoOXNtXE90w2BdfNZwZQ ($51.25 in chips)
Seat 6: TTx3CHxyi0SObcHyMJRp5w ($60.45 in chips)
tdOvWynovql5imfooroLMg: posts small blind $0.25
dB6jzDlJmET84VMWw1mTRA: posts big blind $0.50
*** HOLE CARDS ***
JQZew0FjzS19kTjeNtrE+A: folds
lP7Q6pewz4C2RsAfKsjdWw: folds
3jvoOXNtXE90w2BdfNZwZQ: raises $1.50 to $2
TTx3CHxyi0SObcHyMJRp5w: folds
tdOvWynovql5imfooroLMg: folds
dB6jzDlJmET84VMWw1mTRA: folds
3jvoOXNtXE90w2BdfNZwZQ collected $1.25 from pot
*** SUMMARY ***
Total pot $1.25 | Rake $0
Seat 1: tdOvWynovql5imfooroLMg (small blind) folded before Flop
Seat 2: dB6jzDlJmET84VMWw1mTRA (big blind) folded before Flop
Seat 3: JQZew0FjzS19kTjeNtrE+A folded before Flop (didn't bet)
Seat 4: lP7Q6pewz4C2RsAfKsjdWw folded before Flop (didn't bet)
Seat 5: 3jvoOXNtXE90w2BdfNZwZQ collected ($1.25)
Seat 6: TTx3CHxyi0SObcHyMJRp5w (button) folded before Flop (didn't bet)



PokerStars Game #59939438624:  Hold'em No Limit ($0.25/$0.50) - 2009/07/01 0:39:53 ET
Table 'hWT2kq66tnKEpD26cia6fQ' 2-max Seat #1 is the button
Seat 1: q+vRKwm51mnr6kxX/161WQ ($56.15 in chips)
Seat 2: dkC7J+qbyqk0qCcmJbEPPw ($58.60 in chips)
q+vRKwm51mnr6kxX/161WQ: posts small blind $0.25
dkC7J+qbyqk0qCcmJbEPPw: posts big blind $0.50
*** HOLE CARDS ***
q+vRKwm51mnr6kxX/161WQ: raises $1 to $1.50
dkC7J+qbyqk0qCcmJbEPPw: calls $1
*** FLOP *** [Td 6s Kh]
dkC7J+qbyqk0qCcmJbEPPw: checks
q+vRKwm51mnr6kxX/161WQ: bets $2
dkC7J+qbyqk0qCcmJbEPPw: raises $4 to $6
q+vRKwm51mnr6kxX/161WQ: folds
dkC7J+qbyqk0qCcmJbEPPw collected $6.70 from pot
*** SUMMARY ***
Total pot $7 | Rake $0.30
Board [Td 6s Kh]
Seat 1: q+vRKwm51mnr6kxX/161WQ (button) (small blind) folded on the Flop
Seat 2: dkC7J+qbyqk0qCcmJbEPPw (big blind) collected ($6.70)



PokerStars Game #59939439934:  Hold'em No Limit ($0.25/$0.50) - 2009/07/01 0:39:55 ET
Table 'QOeVnLhwctF9UyV/beDi+A' 2-max Seat #2 is the button
Seat 1: bypIyrYcAAifLfhZpGlKLA ($51.80 in chips)
Seat 2: Ucrm3XtZmoONapW32SPhag ($33.70 in chips)
Ucrm3XtZmoONapW32SPhag: posts small blind $0.25
bypIyrYcAAifLfhZpGlKLA: posts big blind $0.50
*** HOLE CARDS ***
Ucrm3XtZmoONapW32SPhag: calls $0.25
bypIyrYcAAifLfhZpGlKLA: raises $1.50 to $2
Ucrm3XtZmoONapW32SPhag: calls $1.50
*** FLOP *** [Qc Kh 5s]
bypIyrYcAAifLfhZpGlKLA: bets $3
Ucrm3XtZmoONapW32SPhag: folds
bypIyrYcAAifLfhZpGlKLA collected $3.80 from pot
bypIyrYcAAifLfhZpGlKLA: doesn't show hand
*** SUMMARY ***
Total pot $4 | Rake $0.20
Board [Qc Kh 5s]
Seat 1: bypIyrYcAAifLfhZpGlKLA (big blind) collected ($3.80)
Seat 2: Ucrm3XtZmoONapW32SPhag (button) (small blind) folded on the Flop



PokerStars Game #59939440474:  Hold'em No Limit ($0.25/$0.50) - 2009/07/01 0:39:56 ET
Table '+dXkOAQyS8j9PQZusUTMpg' 2-max Seat #2 is the button
Seat 1: XFa6sBGjP2gxoIvxR3fZIg ($43 in chips)
Seat 2: 5IBeOgaApY1Bvzv2P8X4EA ($147.80 in chips)
5IBeOgaApY1Bvzv2P8X4EA: posts small blind $0.25
XFa6sBGjP2gxoIvxR3fZIg: posts big blind $0.50
*** HOLE CARDS ***
5IBeOgaApY1Bvzv2P8X4EA: calls $0.25
XFa6sBGjP2gxoIvxR3fZIg: checks
*** FLOP *** [Ts 8c 7c]
XFa6sBGjP2gxoIvxR3fZIg: checks
5IBeOgaApY1Bvzv2P8X4EA: checks
*** TURN *** [Ts 8c 7c] [8h]
XFa6sBGjP2gxoIvxR3fZIg: checks
5IBeOgaApY1Bvzv2P8X4EA: checks
*** RIVER *** [Ts 8c 7c 8h] [2d]
XFa6sBGjP2gxoIvxR3fZIg: checks
5IBeOgaApY1Bvzv2P8X4EA: bets $1
XFa6sBGjP2gxoIvxR3fZIg: folds
5IBeOgaApY1Bvzv2P8X4EA collected $0.95 from pot
5IBeOgaApY1Bvzv2P8X4EA: doesn't show hand
*** SUMMARY ***
Total pot $1 | Rake $0.05
Board [Ts 8c 7c 8h 2d]
Seat 1: XFa6sBGjP2gxoIvxR3fZIg (big blind) folded on the River
Seat 2: 5IBeOgaApY1Bvzv2P8X4EA (button) (small blind) collected ($0.95)



PokerStars Game #59939440586:  Hold'em No Limit ($0.25/$0.50) - 2009/07/01 0:39:56 ET
Table 'BCN5su+SsXiy1zRMJi0SJw' 6-max Seat #5 is the button
Seat 1: crjGpJEzSZgD38FoE3VMGg ($50 in chips)
Seat 2: oU2kDCkT/gilYbHWrg7D8w ($13.65 in chips)
Seat 3: g+vwI6lMKpU2uteXSjOzVw ($20.05 in chips)
Seat 4: JY9CtoZTeav+mhWyxSSyJQ ($23.95 in chips)
Seat 5: IBNygaT1aa9Z1uPdJJilwA ($64 in chips)
Seat 6: b2symlOdL7+0c9Pj4N/KlA ($50.25 in chips)
b2symlOdL7+0c9Pj4N/KlA: posts small blind $0.25
crjGpJEzSZgD38FoE3VMGg: posts big blind $0.50
*** HOLE CARDS ***
oU2kDCkT/gilYbHWrg7D8w: raises $1.50 to $2
g+vwI6lMKpU2uteXSjOzVw: folds
JY9CtoZTeav+mhWyxSSyJQ: folds
IBNygaT1aa9Z1uPdJJilwA: folds
b2symlOdL7+0c9Pj4N/KlA: folds
crjGpJEzSZgD38FoE3VMGg: folds
oU2kDCkT/gilYbHWrg7D8w collected $1.25 from pot
oU2kDCkT/gilYbHWrg7D8w: doesn't show hand
*** SUMMARY ***
Total pot $1.25 | Rake $0
Seat 1: crjGpJEzSZgD38FoE3VMGg (big blind) folded before Flop
Seat 2: oU2kDCkT/gilYbHWrg7D8w collected ($1.25)
Seat 3: g+vwI6lMKpU2uteXSjOzVw folded before Flop (didn't bet)
Seat 4: JY9CtoZTeav+mhWyxSSyJQ folded before Flop (didn't bet)
Seat 5: IBNygaT1aa9Z1uPdJJilwA (button) folded before Flop (didn't bet)
Seat 6: b2symlOdL7+0c9Pj4N/KlA (small blind) folded before Flop



PokerStars Game #59939441542:  Hold'em No Limit ($0.25/$0.50) - 2009/07/01 0:39:58 ET
Table '5EmHi+fnatGQQShcNmzOZQ' 6-max Seat #6 is the button
Seat 1: +SZCX3+7lnuhHKIu+PP9rg ($29.75 in chips)
Seat 2: vXIHnZ+dv/hwSBxyvGw7bQ ($77.25 in chips)
Seat 3: L9qfLYXrczhAPd/VckgsWw ($84.25 in chips)
Seat 4: 1b+2BbjMN8qhR1WPqdE9VQ ($55.65 in chips)
Seat 5: kxPhs4ePFqMy52CInAJ2aw ($51.60 in chips)
Seat 6: 686aeHikcJlgKkSuIFdcXQ ($141.20 in chips)
+SZCX3+7lnuhHKIu+PP9rg: posts small blind $0.25
vXIHnZ+dv/hwSBxyvGw7bQ: posts big blind $0.50
*** HOLE CARDS ***
L9qfLYXrczhAPd/VckgsWw: calls $0.50
1b+2BbjMN8qhR1WPqdE9VQ: folds
kxPhs4ePFqMy52CInAJ2aw: raises $2 to $2.50
686aeHikcJlgKkSuIFdcXQ: folds
+SZCX3+7lnuhHKIu+PP9rg: folds
vXIHnZ+dv/hwSBxyvGw7bQ: folds
L9qfLYXrczhAPd/VckgsWw: calls $2
*** FLOP *** [As 4h Qc]
L9qfLYXrczhAPd/VckgsWw: checks
kxPhs4ePFqMy52CInAJ2aw: bets $4
L9qfLYXrczhAPd/VckgsWw: folds
kxPhs4ePFqMy52CInAJ2aw collected $5.50 from pot
*** SUMMARY ***
Total pot $5.75 | Rake $0.25
Board [As 4h Qc]
Seat 1: +SZCX3+7lnuhHKIu+PP9rg (small blind) folded before Flop
Seat 2: vXIHnZ+dv/hwSBxyvGw7bQ (big blind) folded before Flop
Seat 3: L9qfLYXrczhAPd/VckgsWw folded on the Flop
Seat 4: 1b+2BbjMN8qhR1WPqdE9VQ folded before Flop (didn't bet)
Seat 5: kxPhs4ePFqMy52CInAJ2aw collected ($5.50)
Seat 6: 686aeHikcJlgKkSuIFdcXQ (button) folded before Flop (didn't bet)



PokerStars Game #59939442142:  Hold'em No Limit ($0.25/$0.50) - 2009/07/01 0:39:59 ET
Table 'c/CRn+68J3Y8KxD5g1ek2Q' 2-max Seat #2 is the button
Seat 1: 46qCyJ6evTkHo9al5sBMNA ($207.45 in chips)
Seat 2: BypVLsYQt3ePFm2xQL/dOA ($167.65 in chips)
BypVLsYQt3ePFm2xQL/dOA: posts small blind $0.25
46qCyJ6evTkHo9al5sBMNA: posts big blind $0.50
*** HOLE CARDS ***
BypVLsYQt3ePFm2xQL/dOA: calls $0.25
46qCyJ6evTkHo9al5sBMNA: checks
*** FLOP *** [Qd Jh 9s]
46qCyJ6evTkHo9al5sBMNA: checks
BypVLsYQt3ePFm2xQL/dOA: checks
*** TURN *** [Qd Jh 9s] [3h]
46qCyJ6evTkHo9al5sBMNA: checks
BypVLsYQt3ePFm2xQL/dOA: checks
*** RIVER *** [Qd Jh 9s 3h] [3c]
46qCyJ6evTkHo9al5sBMNA: checks
BypVLsYQt3ePFm2xQL/dOA: checks
*** SHOW DOWN ***
46qCyJ6evTkHo9al5sBMNA: shows [Ks 8c] (a pair of Threes)
BypVLsYQt3ePFm2xQL/dOA: shows [Kc 5h] (a pair of Threes)
46qCyJ6evTkHo9al5sBMNA collected $0.50 from pot
BypVLsYQt3ePFm2xQL/dOA collected $0.45 from pot
*** SUMMARY ***
Total pot $1 | Rake $0.05
Board [Qd Jh 9s 3h 3c]
Seat 1: 46qCyJ6evTkHo9al5sBMNA (big blind) showed [Ks 8c] and won ($0.50) with a pair of Threes
Seat 2: BypVLsYQt3ePFm2xQL/dOA (button) (small blind) showed [Kc 5h] and won ($0.45) with a pair of Threes



PokerStars Game #59939444702:  Hold'em No Limit ($0.25/$0.50) - 2009/07/01 0:40:02 ET
Table 'hSTs/dUsYLgJQuF2Onp0MQ' 6-max Seat #6 is the button
Seat 1: Donj3X7gYzeS5pAl7s9f+Q ($21.40 in chips)
Seat 2: 6vNxrjjCl6FwfaaymM9jjg ($30.35 in chips)
Seat 3: C3qJBo7uxfFVDluE1lmK2w ($35.45 in chips)
Seat 4: L0aIPg7qefDQjdJo3HCVEA ($8.30 in chips)
Seat 5: 686aeHikcJlgKkSuIFdcXQ ($62.95 in chips)
Seat 6: w0pd++ZQHijd9dDhKEYOAQ ($30.40 in chips)
Donj3X7gYzeS5pAl7s9f+Q: posts small blind $0.25
6vNxrjjCl6FwfaaymM9jjg: posts big blind $0.50
*** HOLE CARDS ***
C3qJBo7uxfFVDluE1lmK2w: folds
L0aIPg7qefDQjdJo3HCVEA: folds
686aeHikcJlgKkSuIFdcXQ: folds
w0pd++ZQHijd9dDhKEYOAQ: folds
Donj3X7gYzeS5pAl7s9f+Q: raises $0.50 to $1
6vNxrjjCl6FwfaaymM9jjg: calls $0.50
*** FLOP *** [As 4h 9h]
Donj3X7gYzeS5pAl7s9f+Q: bets $2
6vNxrjjCl6FwfaaymM9jjg: raises $2 to $4
Donj3X7gYzeS5pAl7s9f+Q: calls $2
*** TURN *** [As 4h 9h] [9d]
Donj3X7gYzeS5pAl7s9f+Q: checks
6vNxrjjCl6FwfaaymM9jjg: checks
*** RIVER *** [As 4h 9h 9d] [8h]
Donj3X7gYzeS5pAl7s9f+Q: checks
6vNxrjjCl6FwfaaymM9jjg: checks
*** SHOW DOWN ***
Donj3X7gYzeS5pAl7s9f+Q: shows [5s Ah] (two pair, Aces and Nines)
6vNxrjjCl6FwfaaymM9jjg: shows [Td 9c] (three of a kind, Nines)
6vNxrjjCl6FwfaaymM9jjg collected $9.55 from pot
*** SUMMARY ***
Total pot $10 | Rake $0.45
Board [As 4h 9h 9d 8h]
Seat 1: Donj3X7gYzeS5pAl7s9f+Q (small blind) showed [5s Ah] and lost with two pair, Aces and Nines
Seat 2: 6vNxrjjCl6FwfaaymM9jjg (big blind) showed [Td 9c] and won ($9.55) with three of a kind, Nines
Seat 3: C3qJBo7uxfFVDluE1lmK2w folded before Flop (didn't bet)
Seat 4: L0aIPg7qefDQjdJo3HCVEA folded before Flop (didn't bet)
Seat 5: 686aeHikcJlgKkSuIFdcXQ folded before Flop (didn't bet)
Seat 6: w0pd++ZQHijd9dDhKEYOAQ (button) folded before Flop (didn't bet)



PokerStars Game #59939445712:  Hold'em No Limit ($0.25/$0.50) - 2009/07/01 0:40:04 ET
Table 'T/PgNWqVyY6lkldcBVXYJQ' 6-max Seat #3 is the button
Seat 1: +Pf9jTVizYlIo+woPvptfA ($56.50 in chips)
Seat 2: LvH4G7n+QSjT6NDaD3cREA ($62.40 in chips)
Seat 3: L3OcNO1bgdqDI46j67KQPQ ($53.10 in chips)
Seat 5: vVQBckETtigfb5mAcyK0OA ($50.35 in chips)
Seat 6: cDzbog6kwmJp+LBeBq+iMQ ($41.20 in chips)
vVQBckETtigfb5mAcyK0OA: posts small blind $0.25
cDzbog6kwmJp+LBeBq+iMQ: posts big blind $0.50
*** HOLE CARDS ***
+Pf9jTVizYlIo+woPvptfA: folds
otJMdCRvqd5YCcFsA3JWpg leaves the table
Ek4w9XqBXqK5jBUQeLedGw joins the table at seat #4
LvH4G7n+QSjT6NDaD3cREA has timed out
LvH4G7n+QSjT6NDaD3cREA: folds
LvH4G7n+QSjT6NDaD3cREA is sitting out
L3OcNO1bgdqDI46j67KQPQ: raises $1.50 to $2
vVQBckETtigfb5mAcyK0OA: folds
LvH4G7n+QSjT6NDaD3cREA has returned
cDzbog6kwmJp+LBeBq+iMQ: folds
L3OcNO1bgdqDI46j67KQPQ collected $1.25 from pot
L3OcNO1bgdqDI46j67KQPQ: doesn't show hand
*** SUMMARY ***
Total pot $1.25 | Rake $0
Seat 1: +Pf9jTVizYlIo+woPvptfA folded before Flop (didn't bet)
Seat 2: LvH4G7n+QSjT6NDaD3cREA folded before Flop (didn't bet)
Seat 3: L3OcNO1bgdqDI46j67KQPQ (button) collected ($1.25)
Seat 5: vVQBckETtigfb5mAcyK0OA (small blind) folded before Flop
Seat 6: cDzbog6kwmJp+LBeBq+iMQ (big blind) folded before Flop



PokerStars Game #59939448048:  Hold'em No Limit ($0.25/$0.50) - 2009/07/01 0:40:08 ET
Table 'MJxeZCzYELxiIsyUZyT0jw' 6-max Seat #1 is the button
Seat 1: tdOvWynovql5imfooroLMg ($51.55 in chips)
Seat 2: dB6jzDlJmET84VMWw1mTRA ($50 in chips)
Seat 3: JQZew0FjzS19kTjeNtrE+A ($50.55 in chips)
Seat 4: lP7Q6pewz4C2RsAfKsjdWw ($33.90 in chips)
Seat 5: 3jvoOXNtXE90w2BdfNZwZQ ($52 in chips)
Seat 6: TTx3CHxyi0SObcHyMJRp5w ($60.45 in chips)
dB6jzDlJmET84VMWw1mTRA: posts small blind $0.25
JQZew0FjzS19kTjeNtrE+A: posts big blind $0.50
*** HOLE CARDS ***
lP7Q6pewz4C2RsAfKsjdWw: calls $0.50
3jvoOXNtXE90w2BdfNZwZQ: folds
TTx3CHxyi0SObcHyMJRp5w: calls $0.50
tdOvWynovql5imfooroLMg: folds
dB6jzDlJmET84VMWw1mTRA: folds
JQZew0FjzS19kTjeNtrE+A: checks
*** FLOP *** [3d 5s Jh]
JQZew0FjzS19kTjeNtrE+A: checks
lP7Q6pewz4C2RsAfKsjdWw: bets $2
TTx3CHxyi0SObcHyMJRp5w: folds
JQZew0FjzS19kTjeNtrE+A: folds
lP7Q6pewz4C2RsAfKsjdWw collected $1.70 from pot
lP7Q6pewz4C2RsAfKsjdWw is sitting out
lP7Q6pewz4C2RsAfKsjdWw: doesn't show hand
*** SUMMARY ***
Total pot $1.75 | Rake $0.05
Board [3d 5s Jh]
Seat 1: tdOvWynovql5imfooroLMg (button) folded before Flop (didn't bet)
Seat 2: dB6jzDlJmET84VMWw1mTRA (small blind) folded before Flop
Seat 3: JQZew0FjzS19kTjeNtrE+A (big blind) folded on the Flop
Seat 4: lP7Q6pewz4C2RsAfKsjdWw collected ($1.70)
Seat 5: 3jvoOXNtXE90w2BdfNZwZQ folded before Flop (didn't bet)
Seat 6: TTx3CHxyi0SObcHyMJRp5w folded on the Flop



PokerStars Game #59939448174:  Hold'em No Limit ($0.25/$0.50) - 2009/07/01 0:40:08 ET
Table 'hWT2kq66tnKEpD26cia6fQ' 2-max Seat #2 is the button
Seat 1: q+vRKwm51mnr6kxX/161WQ ($52.65 in chips)
Seat 2: dkC7J+qbyqk0qCcmJbEPPw ($61.80 in chips)
dkC7J+qbyqk0qCcmJbEPPw: posts small blind $0.25
q+vRKwm51mnr6kxX/161WQ: posts big blind $0.50
*** HOLE CARDS ***
dkC7J+qbyqk0qCcmJbEPPw: folds
q+vRKwm51mnr6kxX/161WQ collected $0.50 from pot
q+vRKwm51mnr6kxX/161WQ: doesn't show hand
*** SUMMARY ***
Total pot $0.50 | Rake $0
Seat 1: q+vRKwm51mnr6kxX/161WQ (big blind) collected ($0.50)
Seat 2: dkC7J+qbyqk0qCcmJbEPPw (button) (small blind) folded before Flop



PokerStars Game #59939448882:  Hold'em No Limit ($0.25/$0.50) - 2009/07/01 0:40:09 ET
Table '+111aLuBwnz8YVYSA7J1jA' 2-max Seat #2 is the button
Seat 1: ndd1nfncBkWNitBnsfCoVQ ($94.70 in chips)
Seat 2: +ciXH35zeafrjg1W6wiBTg ($52.45 in chips)
+ciXH35zeafrjg1W6wiBTg: posts small blind $0.25
ndd1nfncBkWNitBnsfCoVQ: posts big blind $0.50
*** HOLE CARDS ***
+ciXH35zeafrjg1W6wiBTg: raises $1 to $1.50
ndd1nfncBkWNitBnsfCoVQ: folds
+ciXH35zeafrjg1W6wiBTg collected $1 from pot
+ciXH35zeafrjg1W6wiBTg: doesn't show hand
*** SUMMARY ***
Total pot $1 | Rake $0
Seat 1: ndd1nfncBkWNitBnsfCoVQ (big blind) folded before Flop
Seat 2: +ciXH35zeafrjg1W6wiBTg (button) (small blind) collected ($1)



PokerStars Game #59939449706:  Hold'em No Limit ($0.25/$0.50) - 2009/07/01 0:40:10 ET
Table 'X6IRCRTh+20gjz8aubWnwA' 9-max Seat #3 is the button
Seat 1: DSM67hHHq1XFoEOi9p8Alw ($50.80 in chips)
Seat 2: HZkVla4kK2SI42CVrPZ/ig ($6.75 in chips)
Seat 3: GeZ7AYmAZ9Ln8liPZzV8EA ($22.95 in chips)
Seat 4: 2J+UVOVrW+V3maOylyxMcQ ($43.20 in chips)
Seat 5: NnQCepdIR/AOUQn1yhYx6Q ($10 in chips)
Seat 6: /6In1zC3WtgwxDcueWzZWg ($69.40 in chips)
Seat 7: cFHQjKQOOKTUzoilhrXHLg ($34.85 in chips)
Seat 8: HxeBVq06/3Bh/H986sgdbw ($7.25 in chips)
Seat 9: M+7+BTmX5vZatHVuoRB1nA ($69.25 in chips)
2J+UVOVrW+V3maOylyxMcQ: posts small blind $0.25
NnQCepdIR/AOUQn1yhYx6Q: posts big blind $0.50
*** HOLE CARDS ***
/6In1zC3WtgwxDcueWzZWg: folds
cFHQjKQOOKTUzoilhrXHLg: calls $0.50
HxeBVq06/3Bh/H986sgdbw: folds
M+7+BTmX5vZatHVuoRB1nA: folds
DSM67hHHq1XFoEOi9p8Alw: folds
HZkVla4kK2SI42CVrPZ/ig: folds
GeZ7AYmAZ9Ln8liPZzV8EA: folds
2J+UVOVrW+V3maOylyxMcQ: calls $0.25
NnQCepdIR/AOUQn1yhYx6Q: checks
*** FLOP *** [8s 8c Tc]
2J+UVOVrW+V3maOylyxMcQ: checks
NnQCepdIR/AOUQn1yhYx6Q: checks
cFHQjKQOOKTUzoilhrXHLg: checks
*** TURN *** [8s 8c Tc] [2s]
2J+UVOVrW+V3maOylyxMcQ: checks
NnQCepdIR/AOUQn1yhYx6Q: checks
cFHQjKQOOKTUzoilhrXHLg: bets $0.50
2J+UVOVrW+V3maOylyxMcQ: calls $0.50
NnQCepdIR/AOUQn1yhYx6Q: folds
*** RIVER *** [8s 8c Tc 2s] [Th]
2J+UVOVrW+V3maOylyxMcQ: checks
cFHQjKQOOKTUzoilhrXHLg: bets $1
2J+UVOVrW+V3maOylyxMcQ: folds
cFHQjKQOOKTUzoilhrXHLg collected $2.40 from pot
*** SUMMARY ***
Total pot $2.50 | Rake $0.10
Board [8s 8c Tc 2s Th]
Seat 1: DSM67hHHq1XFoEOi9p8Alw folded before Flop (didn't bet)
Seat 2: HZkVla4kK2SI42CVrPZ/ig folded before Flop (didn't bet)
Seat 3: GeZ7AYmAZ9Ln8liPZzV8EA (button) folded before Flop (didn't bet)
Seat 4: 2J+UVOVrW+V3maOylyxMcQ (small blind) folded on the River
Seat 5: NnQCepdIR/AOUQn1yhYx6Q (big blind) folded on the Turn
Seat 6: /6In1zC3WtgwxDcueWzZWg folded before Flop (didn't bet)
Seat 7: cFHQjKQOOKTUzoilhrXHLg collected ($2.40)
Seat 8: HxeBVq06/3Bh/H986sgdbw folded before Flop (didn't bet)
Seat 9: M+7+BTmX5vZatHVuoRB1nA folded before Flop (didn't bet)



PokerStars Game #59939450080:  Hold'em No Limit ($0.25/$0.50) - 2009/07/01 0:40:11 ET
Table 'fx6MqwfYAj/Rt86hBz2L3Q' 9-max Seat #5 is the button
Seat 2: C3rGXblctNcWI6JYPHhaEg ($13.50 in chips)
Seat 3: iadBi5AEt7gTBXbDSSnMYQ ($44.55 in chips)
Seat 4: gPEN9Zp33YTm/mu9/SYP1w ($21.70 in chips)
Seat 5: iAISe3dVeua8PUn2wwgDHw ($41.10 in chips)
Seat 6: 5k9fvXD9suIgCxU4HLQjTw ($50 in chips)
Seat 7: bkXkL3pmapikPQQRNPZSEA ($24.50 in chips)
Seat 8: CAuekkxPVzBL9SK4Tjjbuw ($36.80 in chips)
Seat 9: HZkVla4kK2SI42CVrPZ/ig ($8.50 in chips)
5k9fvXD9suIgCxU4HLQjTw: posts small blind $0.25
bkXkL3pmapikPQQRNPZSEA: posts big blind $0.50
SegjDnMxWMujiD57ESNL+g: sits out
*** HOLE CARDS ***
CAuekkxPVzBL9SK4Tjjbuw: folds
CAuekkxPVzBL9SK4Tjjbuw leaves the table
HZkVla4kK2SI42CVrPZ/ig: folds
C3rGXblctNcWI6JYPHhaEg: folds
iadBi5AEt7gTBXbDSSnMYQ: folds
gPEN9Zp33YTm/mu9/SYP1w: folds
iAISe3dVeua8PUn2wwgDHw: raises $0.50 to $1
5k9fvXD9suIgCxU4HLQjTw: folds
bkXkL3pmapikPQQRNPZSEA: calls $0.50
*** FLOP *** [Td 3d 8s]
bkXkL3pmapikPQQRNPZSEA: checks
iAISe3dVeua8PUn2wwgDHw: bets $1
bkXkL3pmapikPQQRNPZSEA: calls $1
*** TURN *** [Td 3d 8s] [Ah]
bkXkL3pmapikPQQRNPZSEA: checks
NnQCepdIR/AOUQn1yhYx6Q joins the table at seat #8
iAISe3dVeua8PUn2wwgDHw: bets $2.50
bkXkL3pmapikPQQRNPZSEA: raises $2.50 to $5
iAISe3dVeua8PUn2wwgDHw: calls $2.50
*** RIVER *** [Td 3d 8s Ah] [3c]
bkXkL3pmapikPQQRNPZSEA: checks
iAISe3dVeua8PUn2wwgDHw: bets $2.50
bkXkL3pmapikPQQRNPZSEA: calls $2.50
*** SHOW DOWN ***
iAISe3dVeua8PUn2wwgDHw: shows [Ad 4h] (two pair, Aces and Threes)
bkXkL3pmapikPQQRNPZSEA: shows [Tc As] (two pair, Aces and Tens)
bkXkL3pmapikPQQRNPZSEA collected $18.35 from pot
*** SUMMARY ***
Total pot $19.25 | Rake $0.90
Board [Td 3d 8s Ah 3c]
Seat 2: C3rGXblctNcWI6JYPHhaEg folded before Flop (didn't bet)
Seat 3: iadBi5AEt7gTBXbDSSnMYQ folded before Flop (didn't bet)
Seat 4: gPEN9Zp33YTm/mu9/SYP1w folded before Flop (didn't bet)
Seat 5: iAISe3dVeua8PUn2wwgDHw (button) showed [Ad 4h] and lost with two pair, Aces and Threes
Seat 6: 5k9fvXD9suIgCxU4HLQjTw (small blind) folded before Flop
Seat 7: bkXkL3pmapikPQQRNPZSEA (big blind) showed [Tc As] and won ($18.35) with two pair, Aces and Tens
Seat 8: CAuekkxPVzBL9SK4Tjjbuw folded before Flop (didn't bet)
Seat 9: HZkVla4kK2SI42CVrPZ/ig folded before Flop (didn't bet)



PokerStars Game #59939450850:  Hold'em No Limit ($0.25/$0.50) - 2009/07/01 0:40:12 ET
Table 'E7bWJ45aoFXRpyRv2gw+Ig' 2-max Seat #2 is the button
Seat 1: FRkiRasEGlHUeLrEl+k/nA ($53.20 in chips)
Seat 2: 3Wro85I7472vJ4Wkpneo9A ($144.55 in chips)
3Wro85I7472vJ4Wkpneo9A: posts small blind $0.25
FRkiRasEGlHUeLrEl+k/nA: posts big blind $0.50
*** HOLE CARDS ***
3Wro85I7472vJ4Wkpneo9A: calls $0.25
FRkiRasEGlHUeLrEl+k/nA: checks
*** FLOP *** [5h Kh Jd]
FRkiRasEGlHUeLrEl+k/nA: bets $1
3Wro85I7472vJ4Wkpneo9A: calls $1
*** TURN *** [5h Kh Jd] [Th]
FRkiRasEGlHUeLrEl+k/nA: bets $1
3Wro85I7472vJ4Wkpneo9A: calls $1
*** RIVER *** [5h Kh Jd Th] [9s]
FRkiRasEGlHUeLrEl+k/nA: checks
3Wro85I7472vJ4Wkpneo9A: checks
*** SHOW DOWN ***
FRkiRasEGlHUeLrEl+k/nA: shows [3c Kc] (a pair of Kings)
3Wro85I7472vJ4Wkpneo9A: shows [Kd 8s] (a pair of Kings)
FRkiRasEGlHUeLrEl+k/nA collected $2.40 from pot
3Wro85I7472vJ4Wkpneo9A collected $2.40 from pot
*** SUMMARY ***
Total pot $5 | Rake $0.20
Board [5h Kh Jd Th 9s]
Seat 1: FRkiRasEGlHUeLrEl+k/nA (big blind) showed [3c Kc] and won ($2.40) with a pair of Kings
Seat 2: 3Wro85I7472vJ4Wkpneo9A (button) (small blind) showed [Kd 8s] and won ($2.40) with a pair of Kings



PokerStars Game #59939452576:  Hold'em No Limit ($0.25/$0.50) - 2009/07/01 0:40:15 ET
Table 'hWT2kq66tnKEpD26cia6fQ' 2-max Seat #1 is the button
Seat 1: q+vRKwm51mnr6kxX/161WQ ($52.90 in chips)
Seat 2: dkC7J+qbyqk0qCcmJbEPPw ($61.55 in chips)
q+vRKwm51mnr6kxX/161WQ: posts small blind $0.25
dkC7J+qbyqk0qCcmJbEPPw: posts big blind $0.50
*** HOLE CARDS ***
q+vRKwm51mnr6kxX/161WQ: raises $1 to $1.50
dkC7J+qbyqk0qCcmJbEPPw: folds
q+vRKwm51mnr6kxX/161WQ collected $1 from pot
q+vRKwm51mnr6kxX/161WQ: doesn't show hand
*** SUMMARY ***
Total pot $1 | Rake $0
Seat 1: q+vRKwm51mnr6kxX/161WQ (button) (small blind) collected ($1)
Seat 2: dkC7J+qbyqk0qCcmJbEPPw (big blind) folded before Flop



PokerStars Game #59939454238:  Hold'em No Limit ($0.25/$0.50) - 2009/07/01 0:40:17 ET
Table '+111aLuBwnz8YVYSA7J1jA' 2-max Seat #1 is the button
Seat 1: ndd1nfncBkWNitBnsfCoVQ ($94.20 in chips)
Seat 2: +ciXH35zeafrjg1W6wiBTg ($52.95 in chips)
ndd1nfncBkWNitBnsfCoVQ: posts small blind $0.25
+ciXH35zeafrjg1W6wiBTg: posts big blind $0.50
*** HOLE CARDS ***
ndd1nfncBkWNitBnsfCoVQ: raises $1 to $1.50
+ciXH35zeafrjg1W6wiBTg: calls $1
*** FLOP *** [2s 7h 8h]
+ciXH35zeafrjg1W6wiBTg: checks
ndd1nfncBkWNitBnsfCoVQ: checks
*** TURN *** [2s 7h 8h] [4c]
+ciXH35zeafrjg1W6wiBTg: bets $1.50
ndd1nfncBkWNitBnsfCoVQ: calls $1.50
*** RIVER *** [2s 7h 8h 4c] [4h]
+ciXH35zeafrjg1W6wiBTg: bets $5
ndd1nfncBkWNitBnsfCoVQ: calls $5
*** SHOW DOWN ***
+ciXH35zeafrjg1W6wiBTg: shows [6s 9h] (a pair of Fours)
ndd1nfncBkWNitBnsfCoVQ: shows [Ah 2d] (two pair, Fours and Deuces)
ndd1nfncBkWNitBnsfCoVQ collected $15.50 from pot
*** SUMMARY ***
Total pot $16 | Rake $0.50
Board [2s 7h 8h 4c 4h]
Seat 1: ndd1nfncBkWNitBnsfCoVQ (button) (small blind) showed [Ah 2d] and won ($15.50) with two pair, Fours and Deuces
Seat 2: +ciXH35zeafrjg1W6wiBTg (big blind) showed [6s 9h] and lost with a pair of Fours



PokerStars Game #59939453928:  Hold'em No Limit ($0.25/$0.50) - 2009/07/01 0:40:17 ET
Table 'NCiXr0d5CEKBQr/cZgLhbA' 9-max Seat #2 is the button
Seat 1: pFtzb1sR4b0d1aw6aIRgDg ($50 in chips)
Seat 2: ulxuJchBV9iguXg0FUonfg ($49.75 in chips)
Seat 3: xZCXQSXlrZkp3pZizzVXCw ($50.25 in chips)
Seat 4: 5k9fvXD9suIgCxU4HLQjTw ($57.70 in chips)
Seat 5: zE9cVigS2nW/Ljy4K4bUQA ($39.95 in chips)
Seat 6: SKnJuWHScqetA/qG5p+wCg ($30 in chips)
Seat 7: M+7+BTmX5vZatHVuoRB1nA ($46 in chips)
Seat 8: 1MJUKc3cc0QmUoz1JZLR2w ($52.80 in chips)
Seat 9: 4WLZvqBn5qv5tds5kt5A1Q ($48.55 in chips)
xZCXQSXlrZkp3pZizzVXCw: posts small blind $0.25
5k9fvXD9suIgCxU4HLQjTw: posts big blind $0.50
*** HOLE CARDS ***
zE9cVigS2nW/Ljy4K4bUQA: folds
SKnJuWHScqetA/qG5p+wCg: folds
M+7+BTmX5vZatHVuoRB1nA: folds
1MJUKc3cc0QmUoz1JZLR2w: folds
4WLZvqBn5qv5tds5kt5A1Q: folds
pFtzb1sR4b0d1aw6aIRgDg: folds
ulxuJchBV9iguXg0FUonfg: folds
xZCXQSXlrZkp3pZizzVXCw: raises $1 to $1.50
5k9fvXD9suIgCxU4HLQjTw: folds
xZCXQSXlrZkp3pZizzVXCw collected $1 from pot
*** SUMMARY ***
Total pot $1 | Rake $0
Seat 1: pFtzb1sR4b0d1aw6aIRgDg folded before Flop (didn't bet)
Seat 2: ulxuJchBV9iguXg0FUonfg (button) folded before Flop (didn't bet)
Seat 3: xZCXQSXlrZkp3pZizzVXCw (small blind) collected ($1)
Seat 4: 5k9fvXD9suIgCxU4HLQjTw (big blind) folded before Flop
Seat 5: zE9cVigS2nW/Ljy4K4bUQA folded before Flop (didn't bet)
Seat 6: SKnJuWHScqetA/qG5p+wCg folded before Flop (didn't bet)
Seat 7: M+7+BTmX5vZatHVuoRB1nA folded before Flop (didn't bet)
Seat 8: 1MJUKc3cc0QmUoz1JZLR2w folded before Flop (didn't bet)
Seat 9: 4WLZvqBn5qv5tds5kt5A1Q folded before Flop (didn't bet)



PokerStars Game #59939455592:  Hold'em No Limit ($0.25/$0.50) - 2009/07/01 0:40:19 ET
Table '/cQuAT3ef4t+PGrXiNhGaQ' 9-max Seat #7 is the button
Seat 1: HZkVla4kK2SI42CVrPZ/ig ($6 in chips)
Seat 2: jXGruyaMqirTaTXNOvBdew ($71.85 in chips)
Seat 3: g4k0NXISyLCqaSWZDBjfEg ($54.40 in chips)
Seat 4: OWP/DOu+PlPK6ZZ3zYa0HA ($39.90 in chips)
Seat 5: 5SgaHdWixdClWvaEG+KUjQ ($27.85 in chips)
Seat 6: APYIOyK/4AGb+kIwlOUNBQ ($39 in chips)
Seat 7: J0W5D97jl5VLky+IoPvDeA ($114.15 in chips)
Seat 8: W3ingbA178eb7J5rt1PuIQ ($28.45 in chips)
Seat 9: AjV5McH1KMMclY26QdLM5w ($25 in chips)
W3ingbA178eb7J5rt1PuIQ: posts small blind $0.25
AjV5McH1KMMclY26QdLM5w: posts big blind $0.50
*** HOLE CARDS ***
HZkVla4kK2SI42CVrPZ/ig: folds
jXGruyaMqirTaTXNOvBdew: folds
g4k0NXISyLCqaSWZDBjfEg: folds
OWP/DOu+PlPK6ZZ3zYa0HA: folds
5SgaHdWixdClWvaEG+KUjQ: raises $1 to $1.50
APYIOyK/4AGb+kIwlOUNBQ: folds
J0W5D97jl5VLky+IoPvDeA: folds
W3ingbA178eb7J5rt1PuIQ: folds
AjV5McH1KMMclY26QdLM5w: raises $2.50 to $4
5SgaHdWixdClWvaEG+KUjQ: folds
AjV5McH1KMMclY26QdLM5w collected $3.25 from pot
AjV5McH1KMMclY26QdLM5w: doesn't show hand
*** SUMMARY ***
Total pot $3.25 | Rake $0
Seat 1: HZkVla4kK2SI42CVrPZ/ig folded before Flop (didn't bet)
Seat 2: jXGruyaMqirTaTXNOvBdew folded before Flop (didn't bet)
Seat 3: g4k0NXISyLCqaSWZDBjfEg folded before Flop (didn't bet)
Seat 4: OWP/DOu+PlPK6ZZ3zYa0HA folded before Flop (didn't bet)
Seat 5: 5SgaHdWixdClWvaEG+KUjQ folded before Flop
Seat 6: APYIOyK/4AGb+kIwlOUNBQ folded before Flop (didn't bet)
Seat 7: J0W5D97jl5VLky+IoPvDeA (button) folded before Flop (didn't bet)
Seat 8: W3ingbA178eb7J5rt1PuIQ (small blind) folded before Flop
Seat 9: AjV5McH1KMMclY26QdLM5w (big blind) collected ($3.25)



PokerStars Game #59939455748:  Hold'em No Limit ($0.25/$0.50) - 2009/07/01 0:40:19 ET
Table 'QOeVnLhwctF9UyV/beDi+A' 2-max Seat #1 is the button
Seat 1: bypIyrYcAAifLfhZpGlKLA ($53.60 in chips)
Seat 2: Ucrm3XtZmoONapW32SPhag ($31.70 in chips)
bypIyrYcAAifLfhZpGlKLA: posts small blind $0.25
Ucrm3XtZmoONapW32SPhag: posts big blind $0.50
*** HOLE CARDS ***
bypIyrYcAAifLfhZpGlKLA: raises $1 to $1.50
Ucrm3XtZmoONapW32SPhag: folds
bypIyrYcAAifLfhZpGlKLA collected $1 from pot
bypIyrYcAAifLfhZpGlKLA: doesn't show hand
*** SUMMARY ***
Total pot $1 | Rake $0
Seat 1: bypIyrYcAAifLfhZpGlKLA (button) (small blind) collected ($1)
Seat 2: Ucrm3XtZmoONapW32SPhag (big blind) folded before Flop



PokerStars Game #59939455880:  Hold'em No Limit ($0.25/$0.50) - 2009/07/01 0:40:20 ET
Table 'ibNfFy0bCzuBaUORla0aGw' 9-max Seat #1 is the button
Seat 1: xZCXQSXlrZkp3pZizzVXCw ($53.20 in chips)
Seat 2: 90Wb75h3W1BRpbqVnuk8gw ($59.15 in chips)
Seat 3: dDaHs3X8+fe3bIkRU0cbrw ($40.90 in chips)
Seat 4: YBN054X4blmis+B2bBlC0g ($24.20 in chips)
Seat 5: GIJAc9kPrLZHLSX8Q6i99w ($25.20 in chips)
Seat 6: 8n9jQLh3cZKbsmr5PIjgiQ ($35.75 in chips)
Seat 7: HZkVla4kK2SI42CVrPZ/ig ($11.75 in chips)
Seat 8: xUrN9TWLq4m5V+OXY7KUUA ($51.25 in chips)
Seat 9: pFtzb1sR4b0d1aw6aIRgDg ($50 in chips)
90Wb75h3W1BRpbqVnuk8gw: posts small blind $0.25
dDaHs3X8+fe3bIkRU0cbrw: posts big blind $0.50
*** HOLE CARDS ***
YBN054X4blmis+B2bBlC0g: folds
GIJAc9kPrLZHLSX8Q6i99w: folds
8n9jQLh3cZKbsmr5PIjgiQ: folds
HZkVla4kK2SI42CVrPZ/ig: folds
xUrN9TWLq4m5V+OXY7KUUA: folds
pFtzb1sR4b0d1aw6aIRgDg: raises $2 to $2.50
xZCXQSXlrZkp3pZizzVXCw: folds
90Wb75h3W1BRpbqVnuk8gw: folds
dDaHs3X8+fe3bIkRU0cbrw: folds
pFtzb1sR4b0d1aw6aIRgDg collected $1.25 from pot
*** SUMMARY ***
Total pot $1.25 | Rake $0
Seat 1: xZCXQSXlrZkp3pZizzVXCw (button) folded before Flop (didn't bet)
Seat 2: 90Wb75h3W1BRpbqVnuk8gw (small blind) folded before Flop
Seat 3: dDaHs3X8+fe3bIkRU0cbrw (big blind) folded before Flop
Seat 4: YBN054X4blmis+B2bBlC0g folded before Flop (didn't bet)
Seat 5: GIJAc9kPrLZHLSX8Q6i99w folded before Flop (didn't bet)
Seat 6: 8n9jQLh3cZKbsmr5PIjgiQ folded before Flop (didn't bet)
Seat 7: HZkVla4kK2SI42CVrPZ/ig folded before Flop (didn't bet)
Seat 8: xUrN9TWLq4m5V+OXY7KUUA folded before Flop (didn't bet)
Seat 9: pFtzb1sR4b0d1aw6aIRgDg collected ($1.25)



PokerStars Game #59939456550:  Hold'em No Limit ($0.25/$0.50) - 2009/07/01 0:40:21 ET
Table '+dXkOAQyS8j9PQZusUTMpg' 2-max Seat #1 is the button
Seat 1: XFa6sBGjP2gxoIvxR3fZIg ($50 in chips)
Seat 2: 5IBeOgaApY1Bvzv2P8X4EA ($148.25 in chips)
XFa6sBGjP2gxoIvxR3fZIg: posts small blind $0.25
5IBeOgaApY1Bvzv2P8X4EA: posts big blind $0.50
*** HOLE CARDS ***
XFa6sBGjP2gxoIvxR3fZIg: raises $1 to $1.50
5IBeOgaApY1Bvzv2P8X4EA: calls $1
*** FLOP *** [Jh Qc 9c]
5IBeOgaApY1Bvzv2P8X4EA: checks
XFa6sBGjP2gxoIvxR3fZIg: bets $2
5IBeOgaApY1Bvzv2P8X4EA: calls $2
*** TURN *** [Jh Qc 9c] [9h]
5IBeOgaApY1Bvzv2P8X4EA: checks
XFa6sBGjP2gxoIvxR3fZIg: bets $5
5IBeOgaApY1Bvzv2P8X4EA: calls $5
*** RIVER *** [Jh Qc 9c 9h] [Qh]
5IBeOgaApY1Bvzv2P8X4EA: checks
XFa6sBGjP2gxoIvxR3fZIg: checks
*** SHOW DOWN ***
5IBeOgaApY1Bvzv2P8X4EA: shows [Kh 9d] (a full house, Nines full of Queens)
XFa6sBGjP2gxoIvxR3fZIg: mucks hand
5IBeOgaApY1Bvzv2P8X4EA collected $16.50 from pot
*** SUMMARY ***
Total pot $17 | Rake $0.50
Board [Jh Qc 9c 9h Qh]
Seat 1: XFa6sBGjP2gxoIvxR3fZIg (button) (small blind) mucked
Seat 2: 5IBeOgaApY1Bvzv2P8X4EA (big blind) showed [Kh 9d] and won ($16.50) with a full house, Nines full of Queens



PokerStars Game #59939456702:  Hold'em No Limit ($0.25/$0.50) - 2009/07/01 0:40:21 ET
Table 'BCN5su+SsXiy1zRMJi0SJw' 6-max Seat #6 is the button
Seat 1: crjGpJEzSZgD38FoE3VMGg ($50 in chips)
Seat 2: oU2kDCkT/gilYbHWrg7D8w ($14.40 in chips)
Seat 3: g+vwI6lMKpU2uteXSjOzVw ($20.05 in chips)
Seat 4: JY9CtoZTeav+mhWyxSSyJQ ($23.95 in chips)
Seat 5: IBNygaT1aa9Z1uPdJJilwA ($64 in chips)
Seat 6: b2symlOdL7+0c9Pj4N/KlA ($50 in chips)
crjGpJEzSZgD38FoE3VMGg: posts small blind $0.25
oU2kDCkT/gilYbHWrg7D8w: posts big blind $0.50
*** HOLE CARDS ***
g+vwI6lMKpU2uteXSjOzVw: folds
JY9CtoZTeav+mhWyxSSyJQ: calls $0.50
IBNygaT1aa9Z1uPdJJilwA: folds
b2symlOdL7+0c9Pj4N/KlA: raises $1.50 to $2
crjGpJEzSZgD38FoE3VMGg: raises $5 to $7
oU2kDCkT/gilYbHWrg7D8w: folds
JY9CtoZTeav+mhWyxSSyJQ: folds
b2symlOdL7+0c9Pj4N/KlA: folds
crjGpJEzSZgD38FoE3VMGg collected $5 from pot
crjGpJEzSZgD38FoE3VMGg: doesn't show hand
*** SUMMARY ***
Total pot $5 | Rake $0
Seat 1: crjGpJEzSZgD38FoE3VMGg (small blind) collected ($5)
Seat 2: oU2kDCkT/gilYbHWrg7D8w (big blind) folded before Flop
Seat 3: g+vwI6lMKpU2uteXSjOzVw folded before Flop (didn't bet)
Seat 4: JY9CtoZTeav+mhWyxSSyJQ folded before Flop
Seat 5: IBNygaT1aa9Z1uPdJJilwA folded before Flop (didn't bet)
Seat 6: b2symlOdL7+0c9Pj4N/KlA (button) folded before Flop



PokerStars Game #59939457284:  Hold'em No Limit ($0.25/$0.50) - 2009/07/01 0:40:22 ET
Table 'IeNZOZQ4T6oiaHqFeo6yIA' 2-max Seat #2 is the button
Seat 1: ndd1nfncBkWNitBnsfCoVQ ($50 in chips)
Seat 2: A91IUl5JaZROhtfCtnnwYw ($105.20 in chips)
A91IUl5JaZROhtfCtnnwYw: posts small blind $0.25
ndd1nfncBkWNitBnsfCoVQ: posts big blind $0.50
*** HOLE CARDS ***
A91IUl5JaZROhtfCtnnwYw: raises $0.50 to $1
ndd1nfncBkWNitBnsfCoVQ: folds
A91IUl5JaZROhtfCtnnwYw collected $1 from pot
A91IUl5JaZROhtfCtnnwYw: doesn't show hand
*** SUMMARY ***
Total pot $1 | Rake $0
Seat 1: ndd1nfncBkWNitBnsfCoVQ (big blind) folded before Flop
Seat 2: A91IUl5JaZROhtfCtnnwYw (button) (small blind) collected ($1)



PokerStars Game #59939457312:  Hold'em No Limit ($0.25/$0.50) - 2009/07/01 0:40:22 ET
Table 'QOgaEqMcJ73pcUMMxoisUgErOuyGLI5PT3G5MnpHgC/g Seat #9 is the button
Seat 1: L5e2lrPLQm1Pqx30IIZ/Fw ($10 in chips)
Seat 3: xZCXQSXlrZkp3pZizzVXCw ($50.50 in chips)
Seat 4: 3UmXLy3GfjC3EkOebduerQ ($50 in chips)
Seat 5: JwvquocWfhTVApN5t47LgA ($59.55 in chips)
Seat 6: zE9cVigS2nW/Ljy4K4bUQA ($30 in chips)
Seat 7: 90Wb75h3W1BRpbqVnuk8gw ($60.95 in chips)
Seat 8: g4k0NXISyLCqaSWZDBjfEg ($51.35 in chips)
Seat 9: J0W5D97jl5VLky+IoPvDeA ($57.90 in chips)
L5e2lrPLQm1Pqx30IIZ/Fw: posts small blind $0.25
xZCXQSXlrZkp3pZizzVXCw: posts big blind $0.50
*** HOLE CARDS ***
3UmXLy3GfjC3EkOebduerQ: folds
JwvquocWfhTVApN5t47LgA: folds
zE9cVigS2nW/Ljy4K4bUQA: folds
90Wb75h3W1BRpbqVnuk8gw: folds
g4k0NXISyLCqaSWZDBjfEg: raises $1 to $1.50
J0W5D97jl5VLky+IoPvDeA: folds
L5e2lrPLQm1Pqx30IIZ/Fw: folds
xZCXQSXlrZkp3pZizzVXCw: folds
g4k0NXISyLCqaSWZDBjfEg collected $1.25 from pot
*** SUMMARY ***
Total pot $1.25 | Rake $0
Seat 1: L5e2lrPLQm1Pqx30IIZ/Fw (small blind) folded before Flop
Seat 3: xZCXQSXlrZkp3pZizzVXCw (big blind) folded before Flop
Seat 4: 3UmXLy3GfjC3EkOebduerQ folded before Flop (didn't bet)
Seat 5: JwvquocWfhTVApN5t47LgA folded before Flop (didn't bet)
Seat 6: zE9cVigS2nW/Ljy4K4bUQA folded before Flop (didn't bet)
Seat 7: 90Wb75h3W1BRpbqVnuk8gw folded before Flop (didn't bet)
Seat 8: g4k0NXISyLCqaSWZDBjfEg collected ($1.25)
Seat 9: J0W5D97jl5VLky+IoPvDeA (button) folded before Flop (didn't bet)



PokerStars Game #59939459620:  Hold'em No Limit ($0.25/$0.50) - 2009/07/01 0:40:25 ET
Table 'ZYwMb9E6tY50Qm+iNbXRYw' 2-max Seat #1 is the button
Seat 1: DXLfRb8KDZWmrztw2bwtFw ($4.70 in chips)
Seat 2: 16tvT7AYgZ2LgiGFcvFKQg ($23.95 in chips)
DXLfRb8KDZWmrztw2bwtFw: posts small blind $0.25
16tvT7AYgZ2LgiGFcvFKQg: posts big blind $0.50
*** HOLE CARDS ***
DXLfRb8KDZWmrztw2bwtFw: folds
16tvT7AYgZ2LgiGFcvFKQg collected $0.50 from pot
*** SUMMARY ***
Total pot $0.50 | Rake $0
Seat 1: DXLfRb8KDZWmrztw2bwtFw (button) (small blind) folded before Flop
Seat 2: 16tvT7AYgZ2LgiGFcvFKQg (big blind) collected ($0.50)



PokerStars Game #59939459310:  Hold'em No Limit ($0.25/$0.50) - 2009/07/01 0:40:25 ET
Table 'c/CRn+68J3Y8KxD5g1ek2Q' 2-max Seat #1 is the button
Seat 1: 46qCyJ6evTkHo9al5sBMNA ($207.45 in chips)
Seat 2: BypVLsYQt3ePFm2xQL/dOA ($167.60 in chips)
46qCyJ6evTkHo9al5sBMNA: posts small blind $0.25
BypVLsYQt3ePFm2xQL/dOA: posts big blind $0.50
*** HOLE CARDS ***
46qCyJ6evTkHo9al5sBMNA: folds
BypVLsYQt3ePFm2xQL/dOA collected $0.50 from pot
BypVLsYQt3ePFm2xQL/dOA: doesn't show hand
*** SUMMARY ***
Total pot $0.50 | Rake $0
Seat 1: 46qCyJ6evTkHo9al5sBMNA (button) (small blind) folded before Flop
Seat 2: BypVLsYQt3ePFm2xQL/dOA (big blind) collected ($0.50)



PokerStars Game #59939460312:  Hold'em No Limit ($0.25/$0.50) - 2009/07/01 0:40:26 ET
Table '99gCy/CZQwPIjZWH+BguQgE7bWJ45aoFXRpyRv2gw+Igeat #8 is the button
Seat 1: RjBdQ6w31rgcy0o24VLR6w ($10 in chips)
Seat 2: n6VQBu6crjYjy6DxNP1NZA ($19.70 in chips)
Seat 3: qEn9ijNGtuyTxamBf07hYg ($50.75 in chips)
Seat 4: bxLSulbgr8LmKNjOzw8URg ($63.45 in chips)
Seat 5: DSM67hHHq1XFoEOi9p8Alw ($50 in chips)
Seat 7: 4dd+rKHhaMiTl5LEkADvQQ ($9.75 in chips)
Seat 8: 8ehL7qlZzjgUh2H35iiWLw ($50 in chips)
Seat 9: j3K/Jujr7PY4ZM2RZvlH6A ($85.90 in chips)
j3K/Jujr7PY4ZM2RZvlH6A: posts small blind $0.25
RjBdQ6w31rgcy0o24VLR6w: posts big blind $0.50
*** HOLE CARDS ***
n6VQBu6crjYjy6DxNP1NZA: folds
qEn9ijNGtuyTxamBf07hYg: folds
bxLSulbgr8LmKNjOzw8URg: folds
DSM67hHHq1XFoEOi9p8Alw: folds
4dd+rKHhaMiTl5LEkADvQQ: raises $1.50 to $2
8ehL7qlZzjgUh2H35iiWLw: folds
j3K/Jujr7PY4ZM2RZvlH6A: folds
RjBdQ6w31rgcy0o24VLR6w has timed out
RjBdQ6w31rgcy0o24VLR6w: folds
RjBdQ6w31rgcy0o24VLR6w is sitting out
4dd+rKHhaMiTl5LEkADvQQ collected $1.25 from pot
4dd+rKHhaMiTl5LEkADvQQ: doesn't show hand
*** SUMMARY ***
Total pot $1.25 | Rake $0
Seat 1: RjBdQ6w31rgcy0o24VLR6w (big blind) folded before Flop
Seat 2: n6VQBu6crjYjy6DxNP1NZA folded before Flop (didn't bet)
Seat 3: qEn9ijNGtuyTxamBf07hYg folded before Flop (didn't bet)
Seat 4: bxLSulbgr8LmKNjOzw8URg folded before Flop (didn't bet)
Seat 5: DSM67hHHq1XFoEOi9p8Alw folded before Flop (didn't bet)
Seat 7: 4dd+rKHhaMiTl5LEkADvQQ collected ($1.25)
Seat 8: 8ehL7qlZzjgUh2H35iiWLw (button) folded before Flop (didn't bet)
Seat 9: j3K/Jujr7PY4ZM2RZvlH6A (small blind) folded before Flop



PokerStars Game #59939459978:  Hold'em No Limit ($0.25/$0.50) - 2009/07/01 0:40:26 ET
Table 'tyR5AZNKV8Aadbrnrnlg7g' 6-max Seat #2 is the button
Seat 1: R+KjpH/wSjDLhtIy9+edNA ($92.35 in chips)
Seat 2: BAjwVL+zKKd0s0fAWstzQQ ($24.10 in chips)
Seat 3: tdOvWynovql5imfooroLMg ($44.75 in chips)
Seat 4: Rt6KgtZ8YaJoTc3FPim00w ($85.15 in chips)
Seat 6: ZKazl1hGaPiapDXincgi2Q ($12.90 in chips)
tdOvWynovql5imfooroLMg: posts small blind $0.25
Rt6KgtZ8YaJoTc3FPim00w: posts big blind $0.50
Ek4w9XqBXqK5jBUQeLedGw: sits out
*** HOLE CARDS ***
ZKazl1hGaPiapDXincgi2Q: calls $0.50
R+KjpH/wSjDLhtIy9+edNA: folds
BAjwVL+zKKd0s0fAWstzQQ: folds
tdOvWynovql5imfooroLMg: raises $1.50 to $2
Rt6KgtZ8YaJoTc3FPim00w: folds
ZKazl1hGaPiapDXincgi2Q: folds
tdOvWynovql5imfooroLMg collected $1.50 from pot
tdOvWynovql5imfooroLMg: doesn't show hand
*** SUMMARY ***
Total pot $1.50 | Rake $0
Seat 1: R+KjpH/wSjDLhtIy9+edNA folded before Flop (didn't bet)
Seat 2: BAjwVL+zKKd0s0fAWstzQQ (button) folded before Flop (didn't bet)
Seat 3: tdOvWynovql5imfooroLMg (small blind) collected ($1.50)
Seat 4: Rt6KgtZ8YaJoTc3FPim00w (big blind) folded before Flop
Seat 6: ZKazl1hGaPiapDXincgi2Q folded before Flop



PokerStars Game #59939460404:  Hold'em No Limit ($0.25/$0.50) - 2009/07/01 0:40:27 ET
Table 'QOeVnLhwctF9UyV/beDi+A' 2-max Seat #2 is the button
Seat 1: bypIyrYcAAifLfhZpGlKLA ($54.10 in chips)
Seat 2: Ucrm3XtZmoONapW32SPhag ($31.20 in chips)
Ucrm3XtZmoONapW32SPhag: posts small blind $0.25
bypIyrYcAAifLfhZpGlKLA: posts big blind $0.50
*** HOLE CARDS ***
Ucrm3XtZmoONapW32SPhag: calls $0.25
bypIyrYcAAifLfhZpGlKLA: checks
*** FLOP *** [6h Jh As]
bypIyrYcAAifLfhZpGlKLA: checks
Ucrm3XtZmoONapW32SPhag: bets $1
bypIyrYcAAifLfhZpGlKLA: folds
Ucrm3XtZmoONapW32SPhag collected $0.95 from pot
Ucrm3XtZmoONapW32SPhag: doesn't show hand
*** SUMMARY ***
Total pot $1 | Rake $0.05
Board [6h Jh As]
Seat 1: bypIyrYcAAifLfhZpGlKLA (big blind) folded on the Flop
Seat 2: Ucrm3XtZmoONapW32SPhag (button) (small blind) collected ($0.95)



PokerStars Game #59939460900:  Hold'em No Limit ($0.25/$0.50) - 2009/07/01 0:40:27 ET
Table 'hWT2kq66tnKEpD26cia6fQ' 2-max Seat #2 is the button
Seat 1: q+vRKwm51mnr6kxX/161WQ ($53.40 in chips)
Seat 2: dkC7J+qbyqk0qCcmJbEPPw ($61.05 in chips)
dkC7J+qbyqk0qCcmJbEPPw: posts small blind $0.25
q+vRKwm51mnr6kxX/161WQ: posts big blind $0.50
*** HOLE CARDS ***
dkC7J+qbyqk0qCcmJbEPPw: raises $1 to $1.50
q+vRKwm51mnr6kxX/161WQ: calls $1
*** FLOP *** [9c 3h 3d]
q+vRKwm51mnr6kxX/161WQ: checks
dkC7J+qbyqk0qCcmJbEPPw: checks
*** TURN *** [9c 3h 3d] [Kc]
q+vRKwm51mnr6kxX/161WQ: checks
dkC7J+qbyqk0qCcmJbEPPw: checks
*** RIVER *** [9c 3h 3d Kc] [7d]
q+vRKwm51mnr6kxX/161WQ: checks
dkC7J+qbyqk0qCcmJbEPPw: checks
*** SHOW DOWN ***
q+vRKwm51mnr6kxX/161WQ: shows [4s Ad] (a pair of Threes)
dkC7J+qbyqk0qCcmJbEPPw: mucks hand
q+vRKwm51mnr6kxX/161WQ collected $2.85 from pot
*** SUMMARY ***
Total pot $3 | Rake $0.15
Board [9c 3h 3d Kc 7d]
Seat 1: q+vRKwm51mnr6kxX/161WQ (big blind) showed [4s Ad] and won ($2.85) with a pair of Threes
Seat 2: dkC7J+qbyqk0qCcmJbEPPw (button) (small blind) mucked



PokerStars Game #59939461438:  Hold'em No Limit ($0.25/$0.50) - 2009/07/01 0:40:28 ET
Table 'otvGDROEDdqsabxskT79qg' 9-max Seat #6 is the button
Seat 1: 8ehL7qlZzjgUh2H35iiWLw ($56 in chips)
Seat 2: cCjTzH9jio8607WzjcfXlg ($9.05 in chips)
Seat 3: +k7T5ocke8UwavtgUHm+Cg ($75.35 in chips)
Seat 4: MG90wfSJZnOejs/KD3vlQQ ($55.40 in chips)
Seat 5: XNMDwbXt/Q4jM99AXnbJDw ($54.80 in chips)
Seat 6: bxLSulbgr8LmKNjOzw8URg ($51.40 in chips)
Seat 7: C7+tBppJrKgd/r+tuKUIpA ($34.85 in chips)
Seat 8: zE9cVigS2nW/Ljy4K4bUQA ($30 in chips)
Seat 9: KcY3X8YpD74Kw1RHkx/g4A ($66 in chips)
C7+tBppJrKgd/r+tuKUIpA: posts small blind $0.25
zE9cVigS2nW/Ljy4K4bUQA: posts big blind $0.50
*** HOLE CARDS ***
KcY3X8YpD74Kw1RHkx/g4A: folds
8ehL7qlZzjgUh2H35iiWLw: folds
cCjTzH9jio8607WzjcfXlg: folds
+k7T5ocke8UwavtgUHm+Cg: folds
MG90wfSJZnOejs/KD3vlQQ: raises $1 to $1.50
XNMDwbXt/Q4jM99AXnbJDw: folds
bxLSulbgr8LmKNjOzw8URg: folds
C7+tBppJrKgd/r+tuKUIpA: folds
zE9cVigS2nW/Ljy4K4bUQA: folds
MG90wfSJZnOejs/KD3vlQQ collected $1.25 from pot
MG90wfSJZnOejs/KD3vlQQ: doesn't show hand
*** SUMMARY ***
Total pot $1.25 | Rake $0
Seat 1: 8ehL7qlZzjgUh2H35iiWLw folded before Flop (didn't bet)
Seat 2: cCjTzH9jio8607WzjcfXlg folded before Flop (didn't bet)
Seat 3: +k7T5ocke8UwavtgUHm+Cg folded before Flop (didn't bet)
Seat 4: MG90wfSJZnOejs/KD3vlQQ collected ($1.25)
Seat 5: XNMDwbXt/Q4jM99AXnbJDw folded before Flop (didn't bet)
Seat 6: bxLSulbgr8LmKNjOzw8URg (button) folded before Flop (didn't bet)
Seat 7: C7+tBppJrKgd/r+tuKUIpA (small blind) folded before Flop
Seat 8: zE9cVigS2nW/Ljy4K4bUQA (big blind) folded before Flop
Seat 9: KcY3X8YpD74Kw1RHkx/g4A folded before Flop (didn't bet)



PokerStars Game #59939463536:  Hold'em No Limit ($0.25/$0.50) - 2009/07/01 0:40:31 ET
Table 'ZYwMb9E6tY50Qm+iNbXRYw' 2-max Seat #2 is the button
Seat 1: DXLfRb8KDZWmrztw2bwtFw ($4.45 in chips)
Seat 2: 16tvT7AYgZ2LgiGFcvFKQg ($24.20 in chips)
16tvT7AYgZ2LgiGFcvFKQg: posts small blind $0.25
DXLfRb8KDZWmrztw2bwtFw: posts big blind $0.50
*** HOLE CARDS ***
16tvT7AYgZ2LgiGFcvFKQg: calls $0.25
DXLfRb8KDZWmrztw2bwtFw: checks
*** FLOP *** [Tc 4h Jh]
DXLfRb8KDZWmrztw2bwtFw: checks
16tvT7AYgZ2LgiGFcvFKQg: bets $0.50
DXLfRb8KDZWmrztw2bwtFw: folds
16tvT7AYgZ2LgiGFcvFKQg collected $0.95 from pot
*** SUMMARY ***
Total pot $1 | Rake $0.05
Board [Tc 4h Jh]
Seat 1: DXLfRb8KDZWmrztw2bwtFw (big blind) folded on the Flop
Seat 2: 16tvT7AYgZ2LgiGFcvFKQg (button) (small blind) collected ($0.95)



PokerStars Game #59939462978:  Hold'em No Limit ($0.25/$0.50) - 2009/07/01 0:40:31 ET
Table 'IeNZOZQ4T6oiaHqFeo6yIA' 2-max Seat #1 is the button
Seat 1: ndd1nfncBkWNitBnsfCoVQ ($49.50 in chips)
Seat 2: A91IUl5JaZROhtfCtnnwYw ($105.70 in chips)
ndd1nfncBkWNitBnsfCoVQ: posts small blind $0.25
A91IUl5JaZROhtfCtnnwYw: posts big blind $0.50
*** HOLE CARDS ***
ndd1nfncBkWNitBnsfCoVQ: raises $1 to $1.50
A91IUl5JaZROhtfCtnnwYw: folds
ndd1nfncBkWNitBnsfCoVQ collected $1 from pot
ndd1nfncBkWNitBnsfCoVQ: doesn't show hand
*** SUMMARY ***
Total pot $1 | Rake $0
Seat 1: ndd1nfncBkWNitBnsfCoVQ (button) (small blind) collected ($1)
Seat 2: A91IUl5JaZROhtfCtnnwYw (big blind) folded before Flop



PokerStars Game #59939463288:  Hold'em No Limit ($0.25/$0.50) - 2009/07/01 0:40:31 ET
Table 'EiNh8p/wGJ1FP575iMFnqg' 9-max Seat #1 is the button
Seat 1: r3ZqM1Mi0W3y4hOdssE+Sg ($49.40 in chips)
Seat 2: 8ehL7qlZzjgUh2H35iiWLw ($51.50 in chips)
Seat 3: ymLPoEIl7UL3TvZYmnadxQ ($49.35 in chips)
Seat 5: M+7+BTmX5vZatHVuoRB1nA ($85.35 in chips)
Seat 6: 3UmXLy3GfjC3EkOebduerQ ($54.65 in chips)
Seat 7: 997ViqAtWn1FPjJqcffwcA ($50 in chips)
Seat 8: KrPAGRACBg+w0M//SXe8Ag ($10.85 in chips)
Seat 9: OMwFJ4pF0xk2Ru/AJiFeFw ($101.50 in chips)
8ehL7qlZzjgUh2H35iiWLw: posts small blind $0.25
ymLPoEIl7UL3TvZYmnadxQ: posts big blind $0.50
cMzaiXAM/ZAdNaEUu+LqhA: sits out
*** HOLE CARDS ***
M+7+BTmX5vZatHVuoRB1nA: folds
3UmXLy3GfjC3EkOebduerQ: folds
997ViqAtWn1FPjJqcffwcA: folds
KrPAGRACBg+w0M//SXe8Ag: calls $0.50
OMwFJ4pF0xk2Ru/AJiFeFw: folds
OMwFJ4pF0xk2Ru/AJiFeFw leaves the table
r3ZqM1Mi0W3y4hOdssE+Sg: folds
8ehL7qlZzjgUh2H35iiWLw: calls $0.25
ymLPoEIl7UL3TvZYmnadxQ: checks
*** FLOP *** [4h 9h 7h]
NnQCepdIR/AOUQn1yhYx6Q joins the table at seat #9
8ehL7qlZzjgUh2H35iiWLw: bets $1
ymLPoEIl7UL3TvZYmnadxQ: folds
KrPAGRACBg+w0M//SXe8Ag: calls $1
*** TURN *** [4h 9h 7h] [2c]
8ehL7qlZzjgUh2H35iiWLw: bets $3
KrPAGRACBg+w0M//SXe8Ag: folds
8ehL7qlZzjgUh2H35iiWLw collected $3.35 from pot
8ehL7qlZzjgUh2H35iiWLw: doesn't show hand
*** SUMMARY ***
Total pot $3.50 | Rake $0.15
Board [4h 9h 7h 2c]
Seat 1: r3ZqM1Mi0W3y4hOdssE+Sg (button) folded before Flop (didn't bet)
Seat 2: 8ehL7qlZzjgUh2H35iiWLw (small blind) collected ($3.35)
Seat 3: ymLPoEIl7UL3TvZYmnadxQ (big blind) folded on the Flop
Seat 5: M+7+BTmX5vZatHVuoRB1nA folded before Flop (didn't bet)
Seat 6: 3UmXLy3GfjC3EkOebduerQ folded before Flop (didn't bet)
Seat 7: 997ViqAtWn1FPjJqcffwcA folded before Flop (didn't bet)
Seat 8: KrPAGRACBg+w0M//SXe8Ag folded on the Turn
Seat 9: OMwFJ4pF0xk2Ru/AJiFeFw folded before Flop (didn't bet)



PokerStars Game #59939463834:  Hold'em No Limit ($0.25/$0.50) - 2009/07/01 0:40:32 ET
Table '37qXEp3oe+er5q4CZip9eQ' 6-max Seat #3 is the button
Seat 1: oqOqoO2AyCZenUghCxMDxw ($52.25 in chips)
Seat 2: 6wzJiRvp8HY6t+MQGnSIzA ($24.85 in chips)
Seat 3: Rt6KgtZ8YaJoTc3FPim00w ($73 in chips)
Seat 4: XsmE8nXMAAMFJbWaJTmHFw ($30.45 in chips)
Seat 5: VOmI0x4dDPnTESZd5B4d1Q ($48.90 in chips)
Seat 6: N50kln4negd8q7Mmoz1j4g ($27.85 in chips)
XsmE8nXMAAMFJbWaJTmHFw: posts small blind $0.25
VOmI0x4dDPnTESZd5B4d1Q: posts big blind $0.50
*** HOLE CARDS ***
N50kln4negd8q7Mmoz1j4g: raises $1.50 to $2
oqOqoO2AyCZenUghCxMDxw: calls $2
6wzJiRvp8HY6t+MQGnSIzA: folds
Rt6KgtZ8YaJoTc3FPim00w: folds
XsmE8nXMAAMFJbWaJTmHFw: folds
VOmI0x4dDPnTESZd5B4d1Q: calls $1.50
*** FLOP *** [Qc 8c 3s]
VOmI0x4dDPnTESZd5B4d1Q: checks
N50kln4negd8q7Mmoz1j4g: bets $3
oqOqoO2AyCZenUghCxMDxw: calls $3
VOmI0x4dDPnTESZd5B4d1Q: folds
*** TURN *** [Qc 8c 3s] [6h]
N50kln4negd8q7Mmoz1j4g: checks
oqOqoO2AyCZenUghCxMDxw: bets $7
N50kln4negd8q7Mmoz1j4g: folds
oqOqoO2AyCZenUghCxMDxw collected $11.70 from pot
*** SUMMARY ***
Total pot $12.25 | Rake $0.55
Board [Qc 8c 3s 6h]
Seat 1: oqOqoO2AyCZenUghCxMDxw collected ($11.70)
Seat 2: 6wzJiRvp8HY6t+MQGnSIzA folded before Flop (didn't bet)
Seat 3: Rt6KgtZ8YaJoTc3FPim00w (button) folded before Flop (didn't bet)
Seat 4: XsmE8nXMAAMFJbWaJTmHFw (small blind) folded before Flop
Seat 5: VOmI0x4dDPnTESZd5B4d1Q (big blind) folded on the Flop
Seat 6: N50kln4negd8q7Mmoz1j4g folded on the Turn



PokerStars Game #59939464820:  Hold'em No Limit ($0.25/$0.50) - 2009/07/01 0:40:33 ET
Table 'c/CRn+68J3Y8KxD5g1ek2Q' 2-max Seat #2 is the button
Seat 1: 46qCyJ6evTkHo9al5sBMNA ($207.20 in chips)
Seat 2: BypVLsYQt3ePFm2xQL/dOA ($167.85 in chips)
BypVLsYQt3ePFm2xQL/dOA: posts small blind $0.25
46qCyJ6evTkHo9al5sBMNA: posts big blind $0.50
*** HOLE CARDS ***
BypVLsYQt3ePFm2xQL/dOA: raises $1 to $1.50
46qCyJ6evTkHo9al5sBMNA: folds
BypVLsYQt3ePFm2xQL/dOA collected $1 from pot
BypVLsYQt3ePFm2xQL/dOA: doesn't show hand
*** SUMMARY ***
Total pot $1 | Rake $0
Seat 1: 46qCyJ6evTkHo9al5sBMNA (big blind) folded before Flop
Seat 2: BypVLsYQt3ePFm2xQL/dOA (button) (small blind) collected ($1)



PokerStars Game #59939465758:  Hold'em No Limit ($0.25/$0.50) - 2009/07/01 0:40:35 ET
Table '3FhG0gl3kMX3wBEEqj+wnQ' 9-max Seat #9 is the button
Seat 1: e0J9pdCNUDTCG031RnXqLA ($20.65 in chips)
Seat 2: 7cYQ+syUWjl38ty/ICOMhw ($51.10 in chips)
Seat 3: HZkVla4kK2SI42CVrPZ/ig ($23.50 in chips)
Seat 4: bjvJtA9Hqscfznq66txaOQ ($9.25 in chips)
Seat 5: gsyXT42WLEcOS4DdEk2wlw ($28.75 in chips)
Seat 7: mSD1pginDsyHG5PDfqzphw ($10 in chips)
Seat 8: j3K/Jujr7PY4ZM2RZvlH6A ($47.30 in chips)
Seat 9: L5e2lrPLQm1Pqx30IIZ/Fw ($10 in chips)
e0J9pdCNUDTCG031RnXqLA: posts small blind $0.25
7cYQ+syUWjl38ty/ICOMhw: posts big blind $0.50
997ViqAtWn1FPjJqcffwcA: sits out
*** HOLE CARDS ***
gsyXT42WLEcOS4DdEk2wlw said, "i had the ace"
HZkVla4kK2SI42CVrPZ/ig: folds
bjvJtA9Hqscfznq66txaOQ: folds
gsyXT42WLEcOS4DdEk2wlw: folds
mSD1pginDsyHG5PDfqzphw: folds
j3K/Jujr7PY4ZM2RZvlH6A: raises $1.50 to $2
L5e2lrPLQm1Pqx30IIZ/Fw: folds
e0J9pdCNUDTCG031RnXqLA: folds
HZkVla4kK2SI42CVrPZ/ig said, "pockets"
7cYQ+syUWjl38ty/ICOMhw: folds
j3K/Jujr7PY4ZM2RZvlH6A collected $1.25 from pot
j3K/Jujr7PY4ZM2RZvlH6A: doesn't show hand
*** SUMMARY ***
Total pot $1.25 | Rake $0
Seat 1: e0J9pdCNUDTCG031RnXqLA (small blind) folded before Flop
Seat 2: 7cYQ+syUWjl38ty/ICOMhw (big blind) folded before Flop
Seat 3: HZkVla4kK2SI42CVrPZ/ig folded before Flop (didn't bet)
Seat 4: bjvJtA9Hqscfznq66txaOQ folded before Flop (didn't bet)
Seat 5: gsyXT42WLEcOS4DdEk2wlw folded before Flop (didn't bet)
Seat 7: mSD1pginDsyHG5PDfqzphw folded before Flop (didn't bet)
Seat 8: j3K/Jujr7PY4ZM2RZvlH6A collected ($1.25)
Seat 9: L5e2lrPLQm1Pqx30IIZ/Fw (button) folded before Flop (didn't bet)



PokerStars Game #59939466038:  Hold'em No Limit ($0.25/$0.50) - 2009/07/01 0:40:36 ET
Table 'lSisgp6H7Fg1hH5VfjEjYQ' 9-max Seat #6 is the button
Seat 1: pEW8B6uXbdR47kfljMQ3+Q ($37.10 in chips)
Seat 2: UrcnkQOiLVk8BlKDPJSy7Q ($52.30 in chips)
Seat 3: aTkyjTh3w5YLWiIERupZOA ($41.70 in chips)
Seat 4: bwv/rbH/hHhPhY6u9mu04w ($22.50 in chips)
Seat 5: mSD1pginDsyHG5PDfqzphw ($11.35 in chips)
Seat 6: +k7T5ocke8UwavtgUHm+Cg ($29.30 in chips)
Seat 7: Y3DZ6qQlLeBhixDj4M9vmg ($11.05 in chips)
Seat 8: a4JDWmpFQkL10XfAyuF51A ($34.75 in chips)
Y3DZ6qQlLeBhixDj4M9vmg: posts small blind $0.25
a4JDWmpFQkL10XfAyuF51A: posts big blind $0.50
gsyXT42WLEcOS4DdEk2wlw: sits out
*** HOLE CARDS ***
pEW8B6uXbdR47kfljMQ3+Q: folds
UrcnkQOiLVk8BlKDPJSy7Q: raises $1.50 to $2
aTkyjTh3w5YLWiIERupZOA: folds
bwv/rbH/hHhPhY6u9mu04w: calls $2
mSD1pginDsyHG5PDfqzphw: folds
+k7T5ocke8UwavtgUHm+Cg: folds
Y3DZ6qQlLeBhixDj4M9vmg: folds
a4JDWmpFQkL10XfAyuF51A: folds
*** FLOP *** [4s 6h 2c]
UrcnkQOiLVk8BlKDPJSy7Q: bets $3
bwv/rbH/hHhPhY6u9mu04w: raises $3 to $6
pEW8B6uXbdR47kfljMQ3+Q leaves the table
UrcnkQOiLVk8BlKDPJSy7Q: raises $8 to $14
bwv/rbH/hHhPhY6u9mu04w: raises $6.50 to $20.50 and is all-in
5k9fvXD9suIgCxU4HLQjTw joins the table at seat #1
UrcnkQOiLVk8BlKDPJSy7Q: calls $6.50
*** TURN *** [4s 6h 2c] [9h]
*** RIVER *** [4s 6h 2c 9h] [Kd]
*** SHOW DOWN ***
UrcnkQOiLVk8BlKDPJSy7Q: shows [Qs Qc] (a pair of Queens)
bwv/rbH/hHhPhY6u9mu04w: shows [Ah As] (a pair of Aces)
bwv/rbH/hHhPhY6u9mu04w collected $43.50 from pot
*** SUMMARY ***
Total pot $45.75 | Rake $2.25
Board [4s 6h 2c 9h Kd]
Seat 1: pEW8B6uXbdR47kfljMQ3+Q folded before Flop (didn't bet)
Seat 2: UrcnkQOiLVk8BlKDPJSy7Q showed [Qs Qc] and lost with a pair of Queens
Seat 3: aTkyjTh3w5YLWiIERupZOA folded before Flop (didn't bet)
Seat 4: bwv/rbH/hHhPhY6u9mu04w showed [Ah As] and won ($43.50) with a pair of Aces
Seat 5: mSD1pginDsyHG5PDfqzphw folded before Flop (didn't bet)
Seat 6: +k7T5ocke8UwavtgUHm+Cg (button) folded before Flop (didn't bet)
Seat 7: Y3DZ6qQlLeBhixDj4M9vmg (small blind) folded before Flop
Seat 8: a4JDWmpFQkL10XfAyuF51A (big blind) folded before Flop



PokerStars Game #59939467388:  Hold'em No Limit ($0.25/$0.50) - 2009/07/01 0:40:37 ET
Table 'IeNZOZQ4T6oiaHqFeo6yIA' 2-max Seat #2 is the button
Seat 1: ndd1nfncBkWNitBnsfCoVQ ($50 in chips)
Seat 2: A91IUl5JaZROhtfCtnnwYw ($105.20 in chips)
A91IUl5JaZROhtfCtnnwYw: posts small blind $0.25
ndd1nfncBkWNitBnsfCoVQ: posts big blind $0.50
*** HOLE CARDS ***
A91IUl5JaZROhtfCtnnwYw: raises $0.50 to $1
ndd1nfncBkWNitBnsfCoVQ: calls $0.50
*** FLOP *** [Kh 6h Th]
ndd1nfncBkWNitBnsfCoVQ: checks
A91IUl5JaZROhtfCtnnwYw: checks
*** TURN *** [Kh 6h Th] [Jh]
ndd1nfncBkWNitBnsfCoVQ: bets $1.50
A91IUl5JaZROhtfCtnnwYw: raises $1.50 to $3
ndd1nfncBkWNitBnsfCoVQ: folds
A91IUl5JaZROhtfCtnnwYw collected $4.80 from pot
A91IUl5JaZROhtfCtnnwYw: doesn't show hand
*** SUMMARY ***
Total pot $5 | Rake $0.20
Board [Kh 6h Th Jh]
Seat 1: ndd1nfncBkWNitBnsfCoVQ (big blind) folded on the Turn
Seat 2: A91IUl5JaZROhtfCtnnwYw (button) (small blind) collected ($4.80)



PokerStars Game #59939467466:  Hold'em No Limit ($0.25/$0.50) - 2009/07/01 0:40:38 ET
Table 'E7bWJ45aoFXRpyRv2gw+Ig' 2-max Seat #1 is the button
Seat 1: FRkiRasEGlHUeLrEl+k/nA ($53.10 in chips)
Seat 2: 3Wro85I7472vJ4Wkpneo9A ($144.45 in chips)
FRkiRasEGlHUeLrEl+k/nA: posts small blind $0.25
3Wro85I7472vJ4Wkpneo9A: posts big blind $0.50
*** HOLE CARDS ***
FRkiRasEGlHUeLrEl+k/nA: raises $1 to $1.50
3Wro85I7472vJ4Wkpneo9A: calls $1
*** FLOP *** [4d Jd 8d]
3Wro85I7472vJ4Wkpneo9A: checks
FRkiRasEGlHUeLrEl+k/nA: bets $0.50
3Wro85I7472vJ4Wkpneo9A: calls $0.50
*** TURN *** [4d Jd 8d] [2d]
3Wro85I7472vJ4Wkpneo9A: checks
FRkiRasEGlHUeLrEl+k/nA: checks
*** RIVER *** [4d Jd 8d 2d] [Th]
3Wro85I7472vJ4Wkpneo9A: checks
FRkiRasEGlHUeLrEl+k/nA: checks
*** SHOW DOWN ***
3Wro85I7472vJ4Wkpneo9A: shows [6s 6d] (a flush, Jack high)
FRkiRasEGlHUeLrEl+k/nA: mucks hand
3Wro85I7472vJ4Wkpneo9A collected $3.85 from pot
*** SUMMARY ***
Total pot $4 | Rake $0.15
Board [4d Jd 8d 2d Th]
Seat 1: FRkiRasEGlHUeLrEl+k/nA (button) (small blind) mucked
Seat 2: 3Wro85I7472vJ4Wkpneo9A (big blind) showed [6s 6d] and won ($3.85) with a flush, Jack high



PokerStars Game #59939468660:  Hold'em No Limit ($0.25/$0.50) - 2009/07/01 0:40:39 ET
Table 'QOeVnLhwctF9UyV/beDi+A' 2-max Seat #1 is the button
Seat 1: bypIyrYcAAifLfhZpGlKLA ($53.60 in chips)
Seat 2: Ucrm3XtZmoONapW32SPhag ($31.65 in chips)
bypIyrYcAAifLfhZpGlKLA: posts small blind $0.25
Ucrm3XtZmoONapW32SPhag: posts big blind $0.50
*** HOLE CARDS ***
bypIyrYcAAifLfhZpGlKLA: raises $0.50 to $1
Ucrm3XtZmoONapW32SPhag: folds
bypIyrYcAAifLfhZpGlKLA collected $1 from pot
bypIyrYcAAifLfhZpGlKLA: doesn't show hand
*** SUMMARY ***
Total pot $1 | Rake $0
Seat 1: bypIyrYcAAifLfhZpGlKLA (button) (small blind) collected ($1)
Seat 2: Ucrm3XtZmoONapW32SPhag (big blind) folded before Flop



PokerStars Game #59939469234:  Hold'em No Limit ($0.25/$0.50) - 2009/07/01 0:40:40 ET
Table 'QOgaEqMcJ73pcUMMxoisUg' 6-max Seat #6 is the button
Seat 1: OZ6OtYh5Y53MCH/p0QTn5g ($53.70 in chips)
Seat 2: 4QfsCWthT/vSLirorNXqtg ($50 in chips)
Seat 3: Rt6KgtZ8YaJoTc3FPim00w ($77.50 in chips)
Seat 4: zAcsDhG/T128Vn7XGVSgKg ($57.40 in chips)
Seat 5: 6vNxrjjCl6FwfaaymM9jjg ($12 in chips)
Seat 6: pmE+2KJb4nffAVqjLIXxFg ($24.20 in chips)
OZ6OtYh5Y53MCH/p0QTn5g: posts small blind $0.25
4QfsCWthT/vSLirorNXqtg: posts big blind $0.50
*** HOLE CARDS ***
Rt6KgtZ8YaJoTc3FPim00w: folds
zAcsDhG/T128Vn7XGVSgKg: raises $1 to $1.50
6vNxrjjCl6FwfaaymM9jjg: folds
pmE+2KJb4nffAVqjLIXxFg: folds
OZ6OtYh5Y53MCH/p0QTn5g: calls $1.25
4QfsCWthT/vSLirorNXqtg: folds
*** FLOP *** [Qd 7c 5s]
OZ6OtYh5Y53MCH/p0QTn5g: checks
zAcsDhG/T128Vn7XGVSgKg: bets $2.50
OZ6OtYh5Y53MCH/p0QTn5g: calls $2.50
*** TURN *** [Qd 7c 5s] [3h]
OZ6OtYh5Y53MCH/p0QTn5g: bets $6.50
zAcsDhG/T128Vn7XGVSgKg: calls $6.50
*** RIVER *** [Qd 7c 5s 3h] [Jh]
OZ6OtYh5Y53MCH/p0QTn5g: bets $19
zAcsDhG/T128Vn7XGVSgKg: folds
OZ6OtYh5Y53MCH/p0QTn5g collected $20.45 from pot
*** SUMMARY ***
Total pot $21.50 | Rake $1.05
Board [Qd 7c 5s 3h Jh]
Seat 1: OZ6OtYh5Y53MCH/p0QTn5g (small blind) collected ($20.45)
Seat 2: 4QfsCWthT/vSLirorNXqtg (big blind) folded before Flop
Seat 3: Rt6KgtZ8YaJoTc3FPim00w folded before Flop (didn't bet)
Seat 4: zAcsDhG/T128Vn7XGVSgKg folded on the River
Seat 5: 6vNxrjjCl6FwfaaymM9jjg folded before Flop (didn't bet)
Seat 6: pmE+2KJb4nffAVqjLIXxFg (button) folded before Flop (didn't bet)



PokerStars Game #59939469866:  Hold'em No Limit ($0.25/$0.50) - 2009/07/01 0:40:41 ET
Table 'T/PgNWqVyY6lkldcBVXYJQ' 6-max Seat #5 is the button
Seat 1: +Pf9jTVizYlIo+woPvptfA ($56.50 in chips)
Seat 2: LvH4G7n+QSjT6NDaD3cREA ($62.40 in chips)
Seat 3: L3OcNO1bgdqDI46j67KQPQ ($53.85 in chips)
Seat 5: vVQBckETtigfb5mAcyK0OA ($50.10 in chips)
Seat 6: cDzbog6kwmJp+LBeBq+iMQ ($40.70 in chips)
cDzbog6kwmJp+LBeBq+iMQ: posts small blind $0.25
+Pf9jTVizYlIo+woPvptfA: posts big blind $0.50
Ek4w9XqBXqK5jBUQeLedGw: sits out
*** HOLE CARDS ***
LvH4G7n+QSjT6NDaD3cREA: folds
L3OcNO1bgdqDI46j67KQPQ: folds
vVQBckETtigfb5mAcyK0OA: folds
cDzbog6kwmJp+LBeBq+iMQ: calls $0.25
+Pf9jTVizYlIo+woPvptfA: checks
*** FLOP *** [Js 7c 5s]
cDzbog6kwmJp+LBeBq+iMQ: checks
+Pf9jTVizYlIo+woPvptfA: checks
*** TURN *** [Js 7c 5s] [6c]
cDzbog6kwmJp+LBeBq+iMQ: bets $1
+Pf9jTVizYlIo+woPvptfA: folds
cDzbog6kwmJp+LBeBq+iMQ collected $0.95 from pot
*** SUMMARY ***
Total pot $1 | Rake $0.05
Board [Js 7c 5s 6c]
Seat 1: +Pf9jTVizYlIo+woPvptfA (big blind) folded on the Turn
Seat 2: LvH4G7n+QSjT6NDaD3cREA folded before Flop (didn't bet)
Seat 3: L3OcNO1bgdqDI46j67KQPQ folded before Flop (didn't bet)
Seat 5: vVQBckETtigfb5mAcyK0OA (button) folded before Flop (didn't bet)
Seat 6: cDzbog6kwmJp+LBeBq+iMQ (small blind) collected ($0.95)



PokerStars Game #59939471192:  Hold'em No Limit ($0.25/$0.50) - 2009/07/01 0:40:44 ET
Table 'ZYwMb9E6tY50Qm+iNbXRYw' 2-max Seat #1 is the button
Seat 1: DXLfRb8KDZWmrztw2bwtFw ($3.95 in chips)
Seat 2: 16tvT7AYgZ2LgiGFcvFKQg ($24.65 in chips)
DXLfRb8KDZWmrztw2bwtFw: posts small blind $0.25
16tvT7AYgZ2LgiGFcvFKQg: posts big blind $0.50
*** HOLE CARDS ***
DXLfRb8KDZWmrztw2bwtFw: raises $1.50 to $2
16tvT7AYgZ2LgiGFcvFKQg: folds
DXLfRb8KDZWmrztw2bwtFw collected $1 from pot
*** SUMMARY ***
Total pot $1 | Rake $0
Seat 1: DXLfRb8KDZWmrztw2bwtFw (button) (small blind) collected ($1)
Seat 2: 16tvT7AYgZ2LgiGFcvFKQg (big blind) folded before Flop



PokerStars Game #59939471188:  Hold'em No Limit ($0.25/$0.50) - 2009/07/01 0:40:44 ET
Table 'c/CRn+68J3Y8KxD5g1ek2Q' 2-max Seat #1 is the button
Seat 1: 46qCyJ6evTkHo9al5sBMNA ($206.70 in chips)
Seat 2: BypVLsYQt3ePFm2xQL/dOA ($168.35 in chips)
46qCyJ6evTkHo9al5sBMNA: posts small blind $0.25
BypVLsYQt3ePFm2xQL/dOA: posts big blind $0.50
*** HOLE CARDS ***
46qCyJ6evTkHo9al5sBMNA: raises $1 to $1.50
BypVLsYQt3ePFm2xQL/dOA: calls $1
*** FLOP *** [9h Jh 5s]
BypVLsYQt3ePFm2xQL/dOA: checks
46qCyJ6evTkHo9al5sBMNA: checks
*** TURN *** [9h Jh 5s] [Qc]
BypVLsYQt3ePFm2xQL/dOA: bets $2
46qCyJ6evTkHo9al5sBMNA: folds
BypVLsYQt3ePFm2xQL/dOA collected $2.85 from pot
BypVLsYQt3ePFm2xQL/dOA: doesn't show hand
*** SUMMARY ***
Total pot $3 | Rake $0.15
Board [9h Jh 5s Qc]
Seat 1: 46qCyJ6evTkHo9al5sBMNA (button) (small blind) folded on the Turn
Seat 2: BypVLsYQt3ePFm2xQL/dOA (big blind) collected ($2.85)



PokerStars Game #59939472032:  Hold'em No Limit ($0.25/$0.50) - 2009/07/01 0:40:45 ET
Table 'GfL/No5u5PoEnU39lP5pQg' 6-max Seat #2 is the button
Seat 1: 1WUCqNG+p+vfWRTXNu4ljw ($50 in chips)
Seat 2: uVwggSetzp7d+eVgowO3vg ($71.70 in chips)
Seat 3: Ek4w9XqBXqK5jBUQeLedGw ($50 in chips)
Seat 4: x+pzUFJsMIiGd7a5pcR4tg ($54.55 in chips)
Seat 5: crjGpJEzSZgD38FoE3VMGg ($56.90 in chips)
Ek4w9XqBXqK5jBUQeLedGw: posts small blind $0.25
x+pzUFJsMIiGd7a5pcR4tg: posts big blind $0.50
*** HOLE CARDS ***
crjGpJEzSZgD38FoE3VMGg: folds
1WUCqNG+p+vfWRTXNu4ljw: folds
uVwggSetzp7d+eVgowO3vg: folds
Ek4w9XqBXqK5jBUQeLedGw: folds
x+pzUFJsMIiGd7a5pcR4tg collected $0.50 from pot
x+pzUFJsMIiGd7a5pcR4tg: doesn't show hand
*** SUMMARY ***
Total pot $0.50 | Rake $0
Seat 1: 1WUCqNG+p+vfWRTXNu4ljw folded before Flop (didn't bet)
Seat 2: uVwggSetzp7d+eVgowO3vg (button) folded before Flop (didn't bet)
Seat 3: Ek4w9XqBXqK5jBUQeLedGw (small blind) folded before Flop
Seat 4: x+pzUFJsMIiGd7a5pcR4tg (big blind) collected ($0.50)
Seat 5: crjGpJEzSZgD38FoE3VMGg folded before Flop (didn't bet)



PokerStars Game #59939472964:  Hold'em No Limit ($0.25/$0.50) - 2009/07/01 0:40:46 ET
Table '+111aLuBwnz8YVYSA7J1jA' 2-max Seat #2 is the button
Seat 1: ndd1nfncBkWNitBnsfCoVQ ($101.70 in chips)
Seat 2: +ciXH35zeafrjg1W6wiBTg ($50 in chips)
+ciXH35zeafrjg1W6wiBTg: posts small blind $0.25
ndd1nfncBkWNitBnsfCoVQ: posts big blind $0.50
*** HOLE CARDS ***
+ciXH35zeafrjg1W6wiBTg: raises $1.50 to $2
ndd1nfncBkWNitBnsfCoVQ: folds
+ciXH35zeafrjg1W6wiBTg collected $1 from pot
+ciXH35zeafrjg1W6wiBTg: doesn't show hand
*** SUMMARY ***
Total pot $1 | Rake $0
Seat 1: ndd1nfncBkWNitBnsfCoVQ (big blind) folded before Flop
Seat 2: +ciXH35zeafrjg1W6wiBTg (button) (small blind) collected ($1)



PokerStars Game #59939472982:  Hold'em No Limit ($0.25/$0.50) - 2009/07/01 0:40:46 ET
Table 'QOgaEqMcJ73pcUMMxoisUgErOuyGLI5PT3G5MnpHgC/g Seat #1 is the button
Seat 1: L5e2lrPLQm1Pqx30IIZ/Fw ($10 in chips)
Seat 3: xZCXQSXlrZkp3pZizzVXCw ($50 in chips)
Seat 4: 3UmXLy3GfjC3EkOebduerQ ($50 in chips)
Seat 5: JwvquocWfhTVApN5t47LgA ($59.55 in chips)
Seat 6: zE9cVigS2nW/Ljy4K4bUQA ($30 in chips)
Seat 7: 90Wb75h3W1BRpbqVnuk8gw ($60.95 in chips)
Seat 8: g4k0NXISyLCqaSWZDBjfEg ($52.10 in chips)
Seat 9: J0W5D97jl5VLky+IoPvDeA ($57.90 in chips)
xZCXQSXlrZkp3pZizzVXCw: posts small blind $0.25
3UmXLy3GfjC3EkOebduerQ: posts big blind $0.50
*** HOLE CARDS ***
JwvquocWfhTVApN5t47LgA: folds
zE9cVigS2nW/Ljy4K4bUQA: folds
90Wb75h3W1BRpbqVnuk8gw: folds
g4k0NXISyLCqaSWZDBjfEg: folds
J0W5D97jl5VLky+IoPvDeA: folds
L5e2lrPLQm1Pqx30IIZ/Fw: folds
xZCXQSXlrZkp3pZizzVXCw: raises $1 to $1.50
3UmXLy3GfjC3EkOebduerQ: folds
xZCXQSXlrZkp3pZizzVXCw collected $1 from pot
*** SUMMARY ***
Total pot $1 | Rake $0
Seat 1: L5e2lrPLQm1Pqx30IIZ/Fw (button) folded before Flop (didn't bet)
Seat 3: xZCXQSXlrZkp3pZizzVXCw (small blind) collected ($1)
Seat 4: 3UmXLy3GfjC3EkOebduerQ (big blind) folded before Flop
Seat 5: JwvquocWfhTVApN5t47LgA folded before Flop (didn't bet)
Seat 6: zE9cVigS2nW/Ljy4K4bUQA folded before Flop (didn't bet)
Seat 7: 90Wb75h3W1BRpbqVnuk8gw folded before Flop (didn't bet)
Seat 8: g4k0NXISyLCqaSWZDBjfEg folded before Flop (didn't bet)
Seat 9: J0W5D97jl5VLky+IoPvDeA folded before Flop (didn't bet)



PokerStars Game #59939473346:  Hold'em No Limit ($0.25/$0.50) - 2009/07/01 0:40:47 ET
Table 'hSTs/dUsYLgJQuF2Onp0MQ' 6-max Seat #1 is the button
Seat 1: Donj3X7gYzeS5pAl7s9f+Q ($16.40 in chips)
Seat 2: 6vNxrjjCl6FwfaaymM9jjg ($34.90 in chips)
Seat 3: C3qJBo7uxfFVDluE1lmK2w ($35.45 in chips)
Seat 4: L0aIPg7qefDQjdJo3HCVEA ($8.30 in chips)
Seat 5: 686aeHikcJlgKkSuIFdcXQ ($62.95 in chips)
Seat 6: w0pd++ZQHijd9dDhKEYOAQ ($30.40 in chips)
6vNxrjjCl6FwfaaymM9jjg: posts small blind $0.25
C3qJBo7uxfFVDluE1lmK2w: posts big blind $0.50
*** HOLE CARDS ***
L0aIPg7qefDQjdJo3HCVEA: folds
686aeHikcJlgKkSuIFdcXQ: folds
w0pd++ZQHijd9dDhKEYOAQ: folds
Donj3X7gYzeS5pAl7s9f+Q: folds
Donj3X7gYzeS5pAl7s9f+Q leaves the table
6vNxrjjCl6FwfaaymM9jjg: calls $0.25
C3qJBo7uxfFVDluE1lmK2w: checks
*** FLOP *** [Th Qd Jh]
6vNxrjjCl6FwfaaymM9jjg: checks
C3qJBo7uxfFVDluE1lmK2w: checks
*** TURN *** [Th Qd Jh] [9d]
6vNxrjjCl6FwfaaymM9jjg: checks
C3qJBo7uxfFVDluE1lmK2w: bets $0.50
6vNxrjjCl6FwfaaymM9jjg: calls $0.50
*** RIVER *** [Th Qd Jh 9d] [5s]
1WUCqNG+p+vfWRTXNu4ljw joins the table at seat #1
6vNxrjjCl6FwfaaymM9jjg: bets $1
C3qJBo7uxfFVDluE1lmK2w: calls $1
*** SHOW DOWN ***
6vNxrjjCl6FwfaaymM9jjg: shows [Kc 4c] (a straight, Nine to King)
C3qJBo7uxfFVDluE1lmK2w: mucks hand
6vNxrjjCl6FwfaaymM9jjg collected $3.85 from pot
*** SUMMARY ***
Total pot $4 | Rake $0.15
Board [Th Qd Jh 9d 5s]
Seat 1: Donj3X7gYzeS5pAl7s9f+Q (button) folded before Flop (didn't bet)
Seat 2: 6vNxrjjCl6FwfaaymM9jjg (small blind) showed [Kc 4c] and won ($3.85) with a straight, Nine to King
Seat 3: C3qJBo7uxfFVDluE1lmK2w (big blind) mucked
Seat 4: L0aIPg7qefDQjdJo3HCVEA folded before Flop (didn't bet)
Seat 5: 686aeHikcJlgKkSuIFdcXQ folded before Flop (didn't bet)
Seat 6: w0pd++ZQHijd9dDhKEYOAQ folded before Flop (didn't bet)



PokerStars Game #59939473130:  Hold'em No Limit ($0.25/$0.50) - 2009/07/01 0:40:47 ET
Table 'MJxeZCzYELxiIsyUZyT0jw' 6-max Seat #2 is the button
Seat 1: tdOvWynovql5imfooroLMg ($51.55 in chips)
Seat 2: dB6jzDlJmET84VMWw1mTRA ($50 in chips)
Seat 3: JQZew0FjzS19kTjeNtrE+A ($50.05 in chips)
Seat 5: 3jvoOXNtXE90w2BdfNZwZQ ($52 in chips)
Seat 6: TTx3CHxyi0SObcHyMJRp5w ($59.95 in chips)
JQZew0FjzS19kTjeNtrE+A: posts small blind $0.25
3jvoOXNtXE90w2BdfNZwZQ: posts big blind $0.50
*** HOLE CARDS ***
TTx3CHxyi0SObcHyMJRp5w: folds
tdOvWynovql5imfooroLMg: folds
lP7Q6pewz4C2RsAfKsjdWw leaves the table
dB6jzDlJmET84VMWw1mTRA: folds
JQZew0FjzS19kTjeNtrE+A: folds
3jvoOXNtXE90w2BdfNZwZQ collected $0.50 from pot
3jvoOXNtXE90w2BdfNZwZQ: doesn't show hand
*** SUMMARY ***
Total pot $0.50 | Rake $0
Seat 1: tdOvWynovql5imfooroLMg folded before Flop (didn't bet)
Seat 2: dB6jzDlJmET84VMWw1mTRA (button) folded before Flop (didn't bet)
Seat 3: JQZew0FjzS19kTjeNtrE+A (small blind) folded before Flop
Seat 5: 3jvoOXNtXE90w2BdfNZwZQ (big blind) collected ($0.50)
Seat 6: TTx3CHxyi0SObcHyMJRp5w folded before Flop (didn't bet)



PokerStars Game #59939473892:  Hold'em No Limit ($0.25/$0.50) - 2009/07/01 0:40:48 ET
Table 'QOeVnLhwctF9UyV/beDi+A' 2-max Seat #2 is the button
Seat 1: bypIyrYcAAifLfhZpGlKLA ($54.10 in chips)
Seat 2: Ucrm3XtZmoONapW32SPhag ($31.15 in chips)
Ucrm3XtZmoONapW32SPhag: posts small blind $0.25
bypIyrYcAAifLfhZpGlKLA: posts big blind $0.50
*** HOLE CARDS ***
Ucrm3XtZmoONapW32SPhag: raises $0.50 to $1
bypIyrYcAAifLfhZpGlKLA: raises $2 to $3
Ucrm3XtZmoONapW32SPhag: calls $2
*** FLOP *** [Kh 3c 9d]
bypIyrYcAAifLfhZpGlKLA: bets $3.50
Ucrm3XtZmoONapW32SPhag: raises $3.50 to $7
bypIyrYcAAifLfhZpGlKLA: calls $3.50
*** TURN *** [Kh 3c 9d] [Tc]
bypIyrYcAAifLfhZpGlKLA: checks
Ucrm3XtZmoONapW32SPhag: checks
*** RIVER *** [Kh 3c 9d Tc] [Ah]
bypIyrYcAAifLfhZpGlKLA: bets $24.50
Ucrm3XtZmoONapW32SPhag: folds
bypIyrYcAAifLfhZpGlKLA collected $19.50 from pot
bypIyrYcAAifLfhZpGlKLA: doesn't show hand
*** SUMMARY ***
Total pot $20 | Rake $0.50
Board [Kh 3c 9d Tc Ah]
Seat 1: bypIyrYcAAifLfhZpGlKLA (big blind) collected ($19.50)
Seat 2: Ucrm3XtZmoONapW32SPhag (button) (small blind) folded on the River



PokerStars Game #59939474598:  Hold'em No Limit ($0.25/$0.50) - 2009/07/01 0:40:49 ET
Table 'tyR5AZNKV8Aadbrnrnlg7g' 6-max Seat #3 is the button
Seat 1: R+KjpH/wSjDLhtIy9+edNA ($92.35 in chips)
Seat 2: BAjwVL+zKKd0s0fAWstzQQ ($24.10 in chips)
Seat 3: tdOvWynovql5imfooroLMg ($45.75 in chips)
Seat 4: Rt6KgtZ8YaJoTc3FPim00w ($84.65 in chips)
Seat 5: Ek4w9XqBXqK5jBUQeLedGw ($50 in chips)
Seat 6: ZKazl1hGaPiapDXincgi2Q ($12.40 in chips)
Rt6KgtZ8YaJoTc3FPim00w: posts small blind $0.25
Ek4w9XqBXqK5jBUQeLedGw: posts big blind $0.50
*** HOLE CARDS ***
ZKazl1hGaPiapDXincgi2Q: folds
R+KjpH/wSjDLhtIy9+edNA: folds
BAjwVL+zKKd0s0fAWstzQQ: folds
tdOvWynovql5imfooroLMg: folds
Rt6KgtZ8YaJoTc3FPim00w: raises $1 to $1.50
Ek4w9XqBXqK5jBUQeLedGw: raises $4.50 to $6
Rt6KgtZ8YaJoTc3FPim00w: raises $9 to $15
Ek4w9XqBXqK5jBUQeLedGw: raises $35 to $50 and is all-in
Rt6KgtZ8YaJoTc3FPim00w: calls $35
*** FLOP *** [Qd Tc Qh]
*** TURN *** [Qd Tc Qh] [5h]
*** RIVER *** [Qd Tc Qh 5h] [9d]
*** SHOW DOWN ***
Rt6KgtZ8YaJoTc3FPim00w: shows [Ks Kh] (two pair, Kings and Queens)
Ek4w9XqBXqK5jBUQeLedGw: mucks hand
Rt6KgtZ8YaJoTc3FPim00w collected $97 from pot
*** SUMMARY ***
Total pot $100 | Rake $3
Board [Qd Tc Qh 5h 9d]
Seat 1: R+KjpH/wSjDLhtIy9+edNA folded before Flop (didn't bet)
Seat 2: BAjwVL+zKKd0s0fAWstzQQ folded before Flop (didn't bet)
Seat 3: tdOvWynovql5imfooroLMg (button) folded before Flop (didn't bet)
Seat 4: Rt6KgtZ8YaJoTc3FPim00w (small blind) showed [Ks Kh] and won ($97) with two pair, Kings and Queens
Seat 5: Ek4w9XqBXqK5jBUQeLedGw (big blind) mucked
Seat 6: ZKazl1hGaPiapDXincgi2Q folded before Flop (didn't bet)



PokerStars Game #59939474612:  Hold'em No Limit ($0.25/$0.50) - 2009/07/01 0:40:49 ET
Table 'eMxdLyFDf28E0wit6gm3Uw' 6-max Seat #4 is the button
Seat 1: GtdWeBVCZhDBcNFRTOb8Hg ($4 in chips)
Seat 2: jwuKQ1S3U4NnzMQn3E3dgw ($74.15 in chips)
Seat 3: dZcLsEI8iXkobBduRJ45Yw ($13.35 in chips)
Seat 4: 3jxEWvv2qK1HCXLj4khowQ ($28.75 in chips)
Seat 5: X0X97o2fDAPiGx6o1gahsw ($52.10 in chips)
X0X97o2fDAPiGx6o1gahsw: posts small blind $0.25
L0aIPg7qefDQjdJo3HCVEA: is sitting out
L0aIPg7qefDQjdJo3HCVEA leaves the table
GtdWeBVCZhDBcNFRTOb8Hg: posts big blind $0.50
*** HOLE CARDS ***
nOfdMHEXflgT86UgFWblAA joins the table at seat #6
jwuKQ1S3U4NnzMQn3E3dgw: calls $0.50
dZcLsEI8iXkobBduRJ45Yw: folds
3jxEWvv2qK1HCXLj4khowQ: folds
X0X97o2fDAPiGx6o1gahsw: folds
GtdWeBVCZhDBcNFRTOb8Hg: checks
*** FLOP *** [Th 8s 7s]
GtdWeBVCZhDBcNFRTOb8Hg: checks
jwuKQ1S3U4NnzMQn3E3dgw: checks
*** TURN *** [Th 8s 7s] [5h]
GtdWeBVCZhDBcNFRTOb8Hg: bets $0.50
jwuKQ1S3U4NnzMQn3E3dgw: calls $0.50
*** RIVER *** [Th 8s 7s 5h] [9s]
GtdWeBVCZhDBcNFRTOb8Hg: bets $0.50
jwuKQ1S3U4NnzMQn3E3dgw: calls $0.50
*** SHOW DOWN ***
GtdWeBVCZhDBcNFRTOb8Hg: shows [Qd 8c] (a pair of Eights)
jwuKQ1S3U4NnzMQn3E3dgw: mucks hand
GtdWeBVCZhDBcNFRTOb8Hg collected $3.10 from pot
*** SUMMARY ***
Total pot $3.25 | Rake $0.15
Board [Th 8s 7s 5h 9s]
Seat 1: GtdWeBVCZhDBcNFRTOb8Hg (big blind) showed [Qd 8c] and won ($3.10) with a pair of Eights
Seat 2: jwuKQ1S3U4NnzMQn3E3dgw mucked
Seat 3: dZcLsEI8iXkobBduRJ45Yw folded before Flop (didn't bet)
Seat 4: 3jxEWvv2qK1HCXLj4khowQ (button) folded before Flop (didn't bet)
Seat 5: X0X97o2fDAPiGx6o1gahsw (small blind) folded before Flop



PokerStars Game #59939476614:  Hold'em No Limit ($0.25/$0.50) - 2009/07/01 0:40:52 ET
Table 'NCiXr0d5CEKBQr/cZgLhbA' 9-max Seat #3 is the button
Seat 1: pFtzb1sR4b0d1aw6aIRgDg ($50 in chips)
Seat 2: ulxuJchBV9iguXg0FUonfg ($49.75 in chips)
Seat 3: xZCXQSXlrZkp3pZizzVXCw ($50.75 in chips)
Seat 4: 5k9fvXD9suIgCxU4HLQjTw ($57.20 in chips)
Seat 5: zE9cVigS2nW/Ljy4K4bUQA ($39.95 in chips)
Seat 6: SKnJuWHScqetA/qG5p+wCg ($30 in chips)
Seat 7: M+7+BTmX5vZatHVuoRB1nA ($46 in chips)
Seat 8: 1MJUKc3cc0QmUoz1JZLR2w ($52.80 in chips)
Seat 9: 4WLZvqBn5qv5tds5kt5A1Q ($48.55 in chips)
5k9fvXD9suIgCxU4HLQjTw: posts small blind $0.25
zE9cVigS2nW/Ljy4K4bUQA: posts big blind $0.50
*** HOLE CARDS ***
SKnJuWHScqetA/qG5p+wCg: folds
M+7+BTmX5vZatHVuoRB1nA: folds
1MJUKc3cc0QmUoz1JZLR2w: calls $0.50
4WLZvqBn5qv5tds5kt5A1Q: calls $0.50
pFtzb1sR4b0d1aw6aIRgDg: folds
ulxuJchBV9iguXg0FUonfg: folds
xZCXQSXlrZkp3pZizzVXCw: folds
5k9fvXD9suIgCxU4HLQjTw: calls $0.25
zE9cVigS2nW/Ljy4K4bUQA: checks
*** FLOP *** [7c Qd 3c]
5k9fvXD9suIgCxU4HLQjTw: checks
zE9cVigS2nW/Ljy4K4bUQA: checks
1MJUKc3cc0QmUoz1JZLR2w: checks
4WLZvqBn5qv5tds5kt5A1Q: checks
*** TURN *** [7c Qd 3c] [Tc]
5k9fvXD9suIgCxU4HLQjTw: checks
zE9cVigS2nW/Ljy4K4bUQA: checks
1MJUKc3cc0QmUoz1JZLR2w: checks
4WLZvqBn5qv5tds5kt5A1Q: checks
*** RIVER *** [7c Qd 3c Tc] [6c]
5k9fvXD9suIgCxU4HLQjTw: checks
zE9cVigS2nW/Ljy4K4bUQA: checks
1MJUKc3cc0QmUoz1JZLR2w: bets $2.50
4WLZvqBn5qv5tds5kt5A1Q: folds
5k9fvXD9suIgCxU4HLQjTw: folds
zE9cVigS2nW/Ljy4K4bUQA: calls $2.50
*** SHOW DOWN ***
1MJUKc3cc0QmUoz1JZLR2w: shows [Jc Ac] (a flush, Ace high)
zE9cVigS2nW/Ljy4K4bUQA: mucks hand
1MJUKc3cc0QmUoz1JZLR2w collected $6.70 from pot
*** SUMMARY ***
Total pot $7 | Rake $0.30
Board [7c Qd 3c Tc 6c]
Seat 1: pFtzb1sR4b0d1aw6aIRgDg folded before Flop (didn't bet)
Seat 2: ulxuJchBV9iguXg0FUonfg folded before Flop (didn't bet)
Seat 3: xZCXQSXlrZkp3pZizzVXCw (button) folded before Flop (didn't bet)
Seat 4: 5k9fvXD9suIgCxU4HLQjTw (small blind) folded on the River
Seat 5: zE9cVigS2nW/Ljy4K4bUQA (big blind) mucked
Seat 6: SKnJuWHScqetA/qG5p+wCg folded before Flop (didn't bet)
Seat 7: M+7+BTmX5vZatHVuoRB1nA folded before Flop (didn't bet)
Seat 8: 1MJUKc3cc0QmUoz1JZLR2w showed [Jc Ac] and won ($6.70) with a flush, Ace high
Seat 9: 4WLZvqBn5qv5tds5kt5A1Q folded on the River



PokerStars Game #59939476626:  Hold'em No Limit ($0.25/$0.50) - 2009/07/01 0:40:52 ET
Table '+dXkOAQyS8j9PQZusUTMpg' 2-max Seat #2 is the button
Seat 1: XFa6sBGjP2gxoIvxR3fZIg ($41.50 in chips)
Seat 2: 5IBeOgaApY1Bvzv2P8X4EA ($156.25 in chips)
5IBeOgaApY1Bvzv2P8X4EA: posts small blind $0.25
XFa6sBGjP2gxoIvxR3fZIg: posts big blind $0.50
*** HOLE CARDS ***
5IBeOgaApY1Bvzv2P8X4EA: folds
XFa6sBGjP2gxoIvxR3fZIg collected $0.50 from pot
*** SUMMARY ***
Total pot $0.50 | Rake $0
Seat 1: XFa6sBGjP2gxoIvxR3fZIg (big blind) collected ($0.50)
Seat 2: 5IBeOgaApY1Bvzv2P8X4EA (button) (small blind) folded before Flop



PokerStars Game #59939477664:  Hold'em No Limit ($0.25/$0.50) - 2009/07/01 0:40:54 ET
Table '+111aLuBwnz8YVYSA7J1jA' 2-max Seat #1 is the button
Seat 1: ndd1nfncBkWNitBnsfCoVQ ($101.20 in chips)
Seat 2: +ciXH35zeafrjg1W6wiBTg ($50.50 in chips)
ndd1nfncBkWNitBnsfCoVQ: posts small blind $0.25
+ciXH35zeafrjg1W6wiBTg: posts big blind $0.50
*** HOLE CARDS ***
ndd1nfncBkWNitBnsfCoVQ: raises $1 to $1.50
+ciXH35zeafrjg1W6wiBTg: raises $2 to $3.50
ndd1nfncBkWNitBnsfCoVQ: folds
+ciXH35zeafrjg1W6wiBTg collected $3 from pot
+ciXH35zeafrjg1W6wiBTg: doesn't show hand
*** SUMMARY ***
Total pot $3 | Rake $0
Seat 1: ndd1nfncBkWNitBnsfCoVQ (button) (small blind) folded before Flop
Seat 2: +ciXH35zeafrjg1W6wiBTg (big blind) collected ($3)



PokerStars Game #59939479128:  Hold'em No Limit ($0.25/$0.50) - 2009/07/01 0:40:56 ET
Table 'ibNfFy0bCzuBaUORla0aGw' 9-max Seat #2 is the button
Seat 1: xZCXQSXlrZkp3pZizzVXCw ($53.20 in chips)
Seat 2: 90Wb75h3W1BRpbqVnuk8gw ($58.90 in chips)
Seat 3: dDaHs3X8+fe3bIkRU0cbrw ($40.40 in chips)
Seat 4: YBN054X4blmis+B2bBlC0g ($24.20 in chips)
Seat 5: GIJAc9kPrLZHLSX8Q6i99w ($25.20 in chips)
Seat 6: 8n9jQLh3cZKbsmr5PIjgiQ ($35.75 in chips)
Seat 7: HZkVla4kK2SI42CVrPZ/ig ($11.75 in chips)
Seat 8: xUrN9TWLq4m5V+OXY7KUUA ($51.25 in chips)
Seat 9: pFtzb1sR4b0d1aw6aIRgDg ($50.75 in chips)
dDaHs3X8+fe3bIkRU0cbrw: posts small blind $0.25
YBN054X4blmis+B2bBlC0g: posts big blind $0.50
*** HOLE CARDS ***
GIJAc9kPrLZHLSX8Q6i99w: folds
8n9jQLh3cZKbsmr5PIjgiQ: raises $1.50 to $2
HZkVla4kK2SI42CVrPZ/ig: folds
xUrN9TWLq4m5V+OXY7KUUA: folds
pFtzb1sR4b0d1aw6aIRgDg: folds
xZCXQSXlrZkp3pZizzVXCw: folds
90Wb75h3W1BRpbqVnuk8gw: folds
dDaHs3X8+fe3bIkRU0cbrw: folds
YBN054X4blmis+B2bBlC0g: folds
8n9jQLh3cZKbsmr5PIjgiQ collected $1.25 from pot
*** SUMMARY ***
Total pot $1.25 | Rake $0
Seat 1: xZCXQSXlrZkp3pZizzVXCw folded before Flop (didn't bet)
Seat 2: 90Wb75h3W1BRpbqVnuk8gw (button) folded before Flop (didn't bet)
Seat 3: dDaHs3X8+fe3bIkRU0cbrw (small blind) folded before Flop
Seat 4: YBN054X4blmis+B2bBlC0g (big blind) folded before Flop
Seat 5: GIJAc9kPrLZHLSX8Q6i99w folded before Flop (didn't bet)
Seat 6: 8n9jQLh3cZKbsmr5PIjgiQ collected ($1.25)
Seat 7: HZkVla4kK2SI42CVrPZ/ig folded before Flop (didn't bet)
Seat 8: xUrN9TWLq4m5V+OXY7KUUA folded before Flop (didn't bet)
Seat 9: pFtzb1sR4b0d1aw6aIRgDg folded before Flop (didn't bet)



PokerStars Game #59939480794:  Hold'em No Limit ($0.25/$0.50) - 2009/07/01 0:40:58 ET
Table '+dXkOAQyS8j9PQZusUTMpg' 2-max Seat #1 is the button
Seat 1: XFa6sBGjP2gxoIvxR3fZIg ($41.75 in chips)
Seat 2: 5IBeOgaApY1Bvzv2P8X4EA ($156 in chips)
XFa6sBGjP2gxoIvxR3fZIg: posts small blind $0.25
5IBeOgaApY1Bvzv2P8X4EA: posts big blind $0.50
*** HOLE CARDS ***
XFa6sBGjP2gxoIvxR3fZIg: raises $1 to $1.50
5IBeOgaApY1Bvzv2P8X4EA: folds
XFa6sBGjP2gxoIvxR3fZIg collected $1 from pot
XFa6sBGjP2gxoIvxR3fZIg: doesn't show hand
*** SUMMARY ***
Total pot $1 | Rake $0
Seat 1: XFa6sBGjP2gxoIvxR3fZIg (button) (small blind) collected ($1)
Seat 2: 5IBeOgaApY1Bvzv2P8X4EA (big blind) folded before Flop



PokerStars Game #59939482318:  Hold'em No Limit ($0.25/$0.50) - 2009/07/01 0:41:01 ET
Table 'GfL/No5u5PoEnU39lP5pQg' 6-max Seat #3 is the button
Seat 1: 1WUCqNG+p+vfWRTXNu4ljw ($50 in chips)
Seat 2: uVwggSetzp7d+eVgowO3vg ($71.70 in chips)
Seat 3: Ek4w9XqBXqK5jBUQeLedGw ($50 in chips)
Seat 4: x+pzUFJsMIiGd7a5pcR4tg ($54.80 in chips)
x+pzUFJsMIiGd7a5pcR4tg: posts small blind $0.25
crjGpJEzSZgD38FoE3VMGg: is sitting out
1WUCqNG+p+vfWRTXNu4ljw: posts big blind $0.50
*** HOLE CARDS ***
uVwggSetzp7d+eVgowO3vg: folds
crjGpJEzSZgD38FoE3VMGg leaves the table
Ek4w9XqBXqK5jBUQeLedGw: folds
x+pzUFJsMIiGd7a5pcR4tg: calls $0.25
1WUCqNG+p+vfWRTXNu4ljw: raises $2 to $2.50
x+pzUFJsMIiGd7a5pcR4tg: folds
1WUCqNG+p+vfWRTXNu4ljw collected $1 from pot
*** SUMMARY ***
Total pot $1 | Rake $0
Seat 1: 1WUCqNG+p+vfWRTXNu4ljw (big blind) collected ($1)
Seat 2: uVwggSetzp7d+eVgowO3vg folded before Flop (didn't bet)
Seat 3: Ek4w9XqBXqK5jBUQeLedGw (button) folded before Flop (didn't bet)
Seat 4: x+pzUFJsMIiGd7a5pcR4tg (small blind) folded before Flop



PokerStars Game #59939483416:  Hold'em No Limit ($0.25/$0.50) - 2009/07/01 0:41:02 ET
Table 'MJxeZCzYELxiIsyUZyT0jw' 6-max Seat #3 is the button
Seat 1: tdOvWynovql5imfooroLMg ($51.55 in chips)
Seat 2: dB6jzDlJmET84VMWw1mTRA ($50 in chips)
Seat 3: JQZew0FjzS19kTjeNtrE+A ($50 in chips)
Seat 5: 3jvoOXNtXE90w2BdfNZwZQ ($52.25 in chips)
Seat 6: TTx3CHxyi0SObcHyMJRp5w ($59.95 in chips)
alGiiQP/wwtYnfuXII+sgw joins the table at seat #4
3jvoOXNtXE90w2BdfNZwZQ: posts small blind $0.25
TTx3CHxyi0SObcHyMJRp5w: posts big blind $0.50
*** HOLE CARDS ***
tdOvWynovql5imfooroLMg: folds
dB6jzDlJmET84VMWw1mTRA: raises $1 to $1.50
JQZew0FjzS19kTjeNtrE+A: folds
3jvoOXNtXE90w2BdfNZwZQ: folds
TTx3CHxyi0SObcHyMJRp5w: folds
dB6jzDlJmET84VMWw1mTRA collected $1.25 from pot
dB6jzDlJmET84VMWw1mTRA: doesn't show hand
*** SUMMARY ***
Total pot $1.25 | Rake $0
Seat 1: tdOvWynovql5imfooroLMg folded before Flop (didn't bet)
Seat 2: dB6jzDlJmET84VMWw1mTRA collected ($1.25)
Seat 3: JQZew0FjzS19kTjeNtrE+A (button) folded before Flop (didn't bet)
Seat 5: 3jvoOXNtXE90w2BdfNZwZQ (small blind) folded before Flop
Seat 6: TTx3CHxyi0SObcHyMJRp5w (big blind) folded before Flop



PokerStars Game #59939483042:  Hold'em No Limit ($0.25/$0.50) - 2009/07/01 0:41:02 ET
Table 'hWT2kq66tnKEpD26cia6fQ' 2-max Seat #1 is the button
Seat 1: q+vRKwm51mnr6kxX/161WQ ($54.75 in chips)
Seat 2: dkC7J+qbyqk0qCcmJbEPPw ($59.55 in chips)
q+vRKwm51mnr6kxX/161WQ: posts small blind $0.25
dkC7J+qbyqk0qCcmJbEPPw: posts big blind $0.50
*** HOLE CARDS ***
q+vRKwm51mnr6kxX/161WQ: folds
dkC7J+qbyqk0qCcmJbEPPw collected $0.50 from pot
*** SUMMARY ***
Total pot $0.50 | Rake $0
Seat 1: q+vRKwm51mnr6kxX/161WQ (button) (small blind) folded before Flop
Seat 2: dkC7J+qbyqk0qCcmJbEPPw (big blind) collected ($0.50)



PokerStars Game #59939483932:  Hold'em No Limit ($0.25/$0.50) - 2009/07/01 0:41:03 ET
Table 'E7bWJ45aoFXRpyRv2gw+Ig' 2-max Seat #2 is the button
Seat 1: FRkiRasEGlHUeLrEl+k/nA ($51.10 in chips)
Seat 2: 3Wro85I7472vJ4Wkpneo9A ($146.30 in chips)
3Wro85I7472vJ4Wkpneo9A: posts small blind $0.25
FRkiRasEGlHUeLrEl+k/nA: posts big blind $0.50
*** HOLE CARDS ***
3Wro85I7472vJ4Wkpneo9A: raises $1 to $1.50
FRkiRasEGlHUeLrEl+k/nA: calls $1
*** FLOP *** [9c 5h Jd]
FRkiRasEGlHUeLrEl+k/nA: checks
3Wro85I7472vJ4Wkpneo9A: checks
*** TURN *** [9c 5h Jd] [Ad]
FRkiRasEGlHUeLrEl+k/nA: bets $1
3Wro85I7472vJ4Wkpneo9A: raises $3 to $4
FRkiRasEGlHUeLrEl+k/nA: calls $3
*** RIVER *** [9c 5h Jd Ad] [3c]
FRkiRasEGlHUeLrEl+k/nA: checks
3Wro85I7472vJ4Wkpneo9A: checks
*** SHOW DOWN ***
FRkiRasEGlHUeLrEl+k/nA: shows [Ah 3h] (two pair, Aces and Threes)
3Wro85I7472vJ4Wkpneo9A: mucks hand
FRkiRasEGlHUeLrEl+k/nA collected $10.50 from pot
*** SUMMARY ***
Total pot $11 | Rake $0.50
Board [9c 5h Jd Ad 3c]
Seat 1: FRkiRasEGlHUeLrEl+k/nA (big blind) showed [Ah 3h] and won ($10.50) with two pair, Aces and Threes
Seat 2: 3Wro85I7472vJ4Wkpneo9A (button) (small blind) mucked



PokerStars Game #59939483574:  Hold'em No Limit ($0.25/$0.50) - 2009/07/01 0:41:03 ET
Table '+111aLuBwnz8YVYSA7J1jA' 2-max Seat #2 is the button
Seat 1: ndd1nfncBkWNitBnsfCoVQ ($99.70 in chips)
Seat 2: +ciXH35zeafrjg1W6wiBTg ($52 in chips)
+ciXH35zeafrjg1W6wiBTg: posts small blind $0.25
ndd1nfncBkWNitBnsfCoVQ: posts big blind $0.50
*** HOLE CARDS ***
+ciXH35zeafrjg1W6wiBTg: calls $0.25
ndd1nfncBkWNitBnsfCoVQ: checks
*** FLOP *** [5c 5h 3c]
ndd1nfncBkWNitBnsfCoVQ: bets $1
+ciXH35zeafrjg1W6wiBTg: raises $2 to $3
ndd1nfncBkWNitBnsfCoVQ: calls $2
*** TURN *** [5c 5h 3c] [Td]
ndd1nfncBkWNitBnsfCoVQ: checks
+ciXH35zeafrjg1W6wiBTg: bets $3.50
ndd1nfncBkWNitBnsfCoVQ: calls $3.50
*** RIVER *** [5c 5h 3c Td] [7h]
ndd1nfncBkWNitBnsfCoVQ: checks
+ciXH35zeafrjg1W6wiBTg: bets $3.50
ndd1nfncBkWNitBnsfCoVQ: calls $3.50
*** SHOW DOWN ***
+ciXH35zeafrjg1W6wiBTg: shows [6h 7s] (two pair, Sevens and Fives)
ndd1nfncBkWNitBnsfCoVQ: mucks hand
+ciXH35zeafrjg1W6wiBTg collected $20.50 from pot
*** SUMMARY ***
Total pot $21 | Rake $0.50
Board [5c 5h 3c Td 7h]
Seat 1: ndd1nfncBkWNitBnsfCoVQ (big blind) mucked
Seat 2: +ciXH35zeafrjg1W6wiBTg (button) (small blind) showed [6h 7s] and won ($20.50) with two pair, Sevens and Fives



PokerStars Game #59939483478:  Hold'em No Limit ($0.25/$0.50) - 2009/07/01 0:41:03 ET
Table 'BCN5su+SsXiy1zRMJi0SJw' 6-max Seat #1 is the button
Seat 1: crjGpJEzSZgD38FoE3VMGg ($53 in chips)
Seat 2: oU2kDCkT/gilYbHWrg7D8w ($13.90 in chips)
Seat 3: g+vwI6lMKpU2uteXSjOzVw ($20.05 in chips)
Seat 4: JY9CtoZTeav+mhWyxSSyJQ ($23.45 in chips)
Seat 5: IBNygaT1aa9Z1uPdJJilwA ($64 in chips)
Seat 6: b2symlOdL7+0c9Pj4N/KlA ($50 in chips)
oU2kDCkT/gilYbHWrg7D8w: posts small blind $0.25
g+vwI6lMKpU2uteXSjOzVw: posts big blind $0.50
*** HOLE CARDS ***
JY9CtoZTeav+mhWyxSSyJQ: calls $0.50
IBNygaT1aa9Z1uPdJJilwA: folds
b2symlOdL7+0c9Pj4N/KlA: folds
crjGpJEzSZgD38FoE3VMGg: raises $1.50 to $2
oU2kDCkT/gilYbHWrg7D8w: folds
g+vwI6lMKpU2uteXSjOzVw: folds
JY9CtoZTeav+mhWyxSSyJQ: calls $1.50
*** FLOP *** [Qc Kc 8d]
JY9CtoZTeav+mhWyxSSyJQ: checks
crjGpJEzSZgD38FoE3VMGg: checks
*** TURN *** [Qc Kc 8d] [8h]
JY9CtoZTeav+mhWyxSSyJQ: checks
crjGpJEzSZgD38FoE3VMGg: checks
*** RIVER *** [Qc Kc 8d 8h] [Kh]
JY9CtoZTeav+mhWyxSSyJQ: bets $1
crjGpJEzSZgD38FoE3VMGg: calls $1
*** SHOW DOWN ***
JY9CtoZTeav+mhWyxSSyJQ: shows [9s 9h] (two pair, Kings and Nines)
crjGpJEzSZgD38FoE3VMGg: mucks hand
JY9CtoZTeav+mhWyxSSyJQ collected $6.45 from pot
*** SUMMARY ***
Total pot $6.75 | Rake $0.30
Board [Qc Kc 8d 8h Kh]
Seat 1: crjGpJEzSZgD38FoE3VMGg (button) mucked
Seat 2: oU2kDCkT/gilYbHWrg7D8w (small blind) folded before Flop
Seat 3: g+vwI6lMKpU2uteXSjOzVw (big blind) folded before Flop
Seat 4: JY9CtoZTeav+mhWyxSSyJQ showed [9s 9h] and won ($6.45) with two pair, Kings and Nines
Seat 5: IBNygaT1aa9Z1uPdJJilwA folded before Flop (didn't bet)
Seat 6: b2symlOdL7+0c9Pj4N/KlA folded before Flop (didn't bet)



PokerStars Game #59939484258:  Hold'em No Limit ($0.25/$0.50) - 2009/07/01 0:41:04 ET
Table 'fx6MqwfYAj/Rt86hBz2L3Q' 9-max Seat #6 is the button
Seat 2: C3rGXblctNcWI6JYPHhaEg ($13.50 in chips)
Seat 3: iadBi5AEt7gTBXbDSSnMYQ ($44.55 in chips)
Seat 4: gPEN9Zp33YTm/mu9/SYP1w ($21.70 in chips)
Seat 5: iAISe3dVeua8PUn2wwgDHw ($31.60 in chips)
Seat 6: 5k9fvXD9suIgCxU4HLQjTw ($50 in chips)
Seat 7: bkXkL3pmapikPQQRNPZSEA ($33.35 in chips)
Seat 8: NnQCepdIR/AOUQn1yhYx6Q ($10 in chips)
Seat 9: HZkVla4kK2SI42CVrPZ/ig ($8.50 in chips)
bkXkL3pmapikPQQRNPZSEA: posts small blind $0.25
NnQCepdIR/AOUQn1yhYx6Q: posts big blind $0.50
SegjDnMxWMujiD57ESNL+g: sits out
*** HOLE CARDS ***
HZkVla4kK2SI42CVrPZ/ig: folds
C3rGXblctNcWI6JYPHhaEg: calls $0.50
iadBi5AEt7gTBXbDSSnMYQ: calls $0.50
gPEN9Zp33YTm/mu9/SYP1w: folds
iAISe3dVeua8PUn2wwgDHw: folds
5k9fvXD9suIgCxU4HLQjTw: folds
bkXkL3pmapikPQQRNPZSEA: folds
NnQCepdIR/AOUQn1yhYx6Q: checks
*** FLOP *** [Ac Jh 6s]
bkXkL3pmapikPQQRNPZSEA leaves the table
NnQCepdIR/AOUQn1yhYx6Q: checks
SKnJuWHScqetA/qG5p+wCg joins the table at seat #7
C3rGXblctNcWI6JYPHhaEg: bets $1
iadBi5AEt7gTBXbDSSnMYQ: raises $2 to $3
NnQCepdIR/AOUQn1yhYx6Q: folds
C3rGXblctNcWI6JYPHhaEg: calls $2
*** TURN *** [Ac Jh 6s] [5c]
C3rGXblctNcWI6JYPHhaEg: checks
iadBi5AEt7gTBXbDSSnMYQ: bets $2.50
C3rGXblctNcWI6JYPHhaEg: calls $2.50
*** RIVER *** [Ac Jh 6s 5c] [9d]
C3rGXblctNcWI6JYPHhaEg: checks
iadBi5AEt7gTBXbDSSnMYQ: checks
*** SHOW DOWN ***
C3rGXblctNcWI6JYPHhaEg: shows [8s Js] (a pair of Jacks)
iadBi5AEt7gTBXbDSSnMYQ: shows [8c Ah] (a pair of Aces)
iadBi5AEt7gTBXbDSSnMYQ collected $12.15 from pot
C3rGXblctNcWI6JYPHhaEg said, "nh"
*** SUMMARY ***
Total pot $12.75 | Rake $0.60
Board [Ac Jh 6s 5c 9d]
Seat 2: C3rGXblctNcWI6JYPHhaEg showed [8s Js] and lost with a pair of Jacks
Seat 3: iadBi5AEt7gTBXbDSSnMYQ showed [8c Ah] and won ($12.15) with a pair of Aces
Seat 4: gPEN9Zp33YTm/mu9/SYP1w folded before Flop (didn't bet)
Seat 5: iAISe3dVeua8PUn2wwgDHw folded before Flop (didn't bet)
Seat 6: 5k9fvXD9suIgCxU4HLQjTw (button) folded before Flop (didn't bet)
Seat 7: bkXkL3pmapikPQQRNPZSEA (small blind) folded before Flop
Seat 8: NnQCepdIR/AOUQn1yhYx6Q (big blind) folded on the Flop
Seat 9: HZkVla4kK2SI42CVrPZ/ig folded before Flop (didn't bet)



PokerStars Game #59939484808:  Hold'em No Limit ($0.25/$0.50) - 2009/07/01 0:41:05 ET
Table 'IeNZOZQ4T6oiaHqFeo6yIA' 2-max Seat #1 is the button
Seat 1: ndd1nfncBkWNitBnsfCoVQ ($50 in chips)
Seat 2: A91IUl5JaZROhtfCtnnwYw ($107.50 in chips)
ndd1nfncBkWNitBnsfCoVQ: posts small blind $0.25
A91IUl5JaZROhtfCtnnwYw: posts big blind $0.50
*** HOLE CARDS ***
ndd1nfncBkWNitBnsfCoVQ: raises $1 to $1.50
A91IUl5JaZROhtfCtnnwYw: raises $1 to $2.50
ndd1nfncBkWNitBnsfCoVQ: calls $1
*** FLOP *** [3c 5s Ah]
A91IUl5JaZROhtfCtnnwYw: checks
ndd1nfncBkWNitBnsfCoVQ: checks
*** TURN *** [3c 5s Ah] [Kh]
A91IUl5JaZROhtfCtnnwYw: bets $0.50
ndd1nfncBkWNitBnsfCoVQ: folds
A91IUl5JaZROhtfCtnnwYw collected $4.75 from pot
A91IUl5JaZROhtfCtnnwYw: doesn't show hand
*** SUMMARY ***
Total pot $5 | Rake $0.25
Board [3c 5s Ah Kh]
Seat 1: ndd1nfncBkWNitBnsfCoVQ (button) (small blind) folded on the Turn
Seat 2: A91IUl5JaZROhtfCtnnwYw (big blind) collected ($4.75)



PokerStars Game #59939486014:  Hold'em No Limit ($0.25/$0.50) - 2009/07/01 0:41:06 ET
Table 'c/CRn+68J3Y8KxD5g1ek2Q' 2-max Seat #2 is the button
Seat 1: 46qCyJ6evTkHo9al5sBMNA ($205.20 in chips)
Seat 2: BypVLsYQt3ePFm2xQL/dOA ($169.70 in chips)
BypVLsYQt3ePFm2xQL/dOA: posts small blind $0.25
46qCyJ6evTkHo9al5sBMNA: posts big blind $0.50
*** HOLE CARDS ***
BypVLsYQt3ePFm2xQL/dOA: calls $0.25
46qCyJ6evTkHo9al5sBMNA: raises $1.50 to $2
BypVLsYQt3ePFm2xQL/dOA: folds
46qCyJ6evTkHo9al5sBMNA collected $1 from pot
46qCyJ6evTkHo9al5sBMNA: doesn't show hand
*** SUMMARY ***
Total pot $1 | Rake $0
Seat 1: 46qCyJ6evTkHo9al5sBMNA (big blind) collected ($1)
Seat 2: BypVLsYQt3ePFm2xQL/dOA (button) (small blind) folded before Flop



PokerStars Game #59939486176:  Hold'em No Limit ($0.25/$0.50) - 2009/07/01 0:41:07 ET
Table 'T/PgNWqVyY6lkldcBVXYJQ' 6-max Seat #6 is the button
Seat 1: +Pf9jTVizYlIo+woPvptfA ($56 in chips)
Seat 2: LvH4G7n+QSjT6NDaD3cREA ($62.40 in chips)
Seat 3: L3OcNO1bgdqDI46j67KQPQ ($53.85 in chips)
Seat 5: vVQBckETtigfb5mAcyK0OA ($50.10 in chips)
Seat 6: cDzbog6kwmJp+LBeBq+iMQ ($41.15 in chips)
+Pf9jTVizYlIo+woPvptfA: posts small blind $0.25
LvH4G7n+QSjT6NDaD3cREA: posts big blind $0.50
Ek4w9XqBXqK5jBUQeLedGw: sits out
*** HOLE CARDS ***
L3OcNO1bgdqDI46j67KQPQ: folds
vVQBckETtigfb5mAcyK0OA: raises $0.50 to $1
cDzbog6kwmJp+LBeBq+iMQ: calls $1
+Pf9jTVizYlIo+woPvptfA: folds
LvH4G7n+QSjT6NDaD3cREA: folds
*** FLOP *** [Js Ks Tc]
vVQBckETtigfb5mAcyK0OA: bets $1
cDzbog6kwmJp+LBeBq+iMQ: calls $1
*** TURN *** [Js Ks Tc] [Qh]
vVQBckETtigfb5mAcyK0OA: bets $2
cDzbog6kwmJp+LBeBq+iMQ: raises $2.50 to $4.50
vVQBckETtigfb5mAcyK0OA: raises $43.60 to $48.10 and is all-in
cDzbog6kwmJp+LBeBq+iMQ said, "u gonna show the ace"
cDzbog6kwmJp+LBeBq+iMQ said, "?"
cDzbog6kwmJp+LBeBq+iMQ said, "lol"
vVQBckETtigfb5mAcyK0OA said, "2 aces"
cDzbog6kwmJp+LBeBq+iMQ said, "i wanna c em"
cDzbog6kwmJp+LBeBq+iMQ said, "haha"
vVQBckETtigfb5mAcyK0OA said, "pocket aces"
cDzbog6kwmJp+LBeBq+iMQ: folds
vVQBckETtigfb5mAcyK0OA collected $13.10 from pot
vVQBckETtigfb5mAcyK0OA: doesn't show hand
*** SUMMARY ***
Total pot $13.75 | Rake $0.65
Board [Js Ks Tc Qh]
Seat 1: +Pf9jTVizYlIo+woPvptfA (small blind) folded before Flop
Seat 2: LvH4G7n+QSjT6NDaD3cREA (big blind) folded before Flop
Seat 3: L3OcNO1bgdqDI46j67KQPQ folded before Flop (didn't bet)
Seat 5: vVQBckETtigfb5mAcyK0OA collected ($13.10)
Seat 6: cDzbog6kwmJp+LBeBq+iMQ (button) folded on the Turn



PokerStars Game #59939487174:  Hold'em No Limit ($0.25/$0.50) - 2009/07/01 0:41:08 ET
Table 'hWT2kq66tnKEpD26cia6fQ' 2-max Seat #2 is the button
Seat 1: q+vRKwm51mnr6kxX/161WQ ($54.50 in chips)
Seat 2: dkC7J+qbyqk0qCcmJbEPPw ($59.80 in chips)
dkC7J+qbyqk0qCcmJbEPPw: posts small blind $0.25
q+vRKwm51mnr6kxX/161WQ: posts big blind $0.50
*** HOLE CARDS ***
dkC7J+qbyqk0qCcmJbEPPw: raises $1 to $1.50
q+vRKwm51mnr6kxX/161WQ: calls $1
*** FLOP *** [7h Ad 5s]
q+vRKwm51mnr6kxX/161WQ: checks
dkC7J+qbyqk0qCcmJbEPPw: checks
*** TURN *** [7h Ad 5s] [Qh]
q+vRKwm51mnr6kxX/161WQ: bets $2
dkC7J+qbyqk0qCcmJbEPPw: raises $4 to $6
q+vRKwm51mnr6kxX/161WQ: calls $4
*** RIVER *** [7h Ad 5s Qh] [2d]
q+vRKwm51mnr6kxX/161WQ: checks
dkC7J+qbyqk0qCcmJbEPPw: bets $8
q+vRKwm51mnr6kxX/161WQ: calls $8
*** SHOW DOWN ***
dkC7J+qbyqk0qCcmJbEPPw: shows [Qd Qs] (three of a kind, Queens)
q+vRKwm51mnr6kxX/161WQ: mucks hand
dkC7J+qbyqk0qCcmJbEPPw collected $30.50 from pot
*** SUMMARY ***
Total pot $31 | Rake $0.50
Board [7h Ad 5s Qh 2d]
Seat 1: q+vRKwm51mnr6kxX/161WQ (big blind) mucked
Seat 2: dkC7J+qbyqk0qCcmJbEPPw (button) (small blind) showed [Qd Qs] and won ($30.50) with three of a kind, Queens



PokerStars Game #59939487138:  Hold'em No Limit ($0.25/$0.50) - 2009/07/01 0:41:08 ET
Table '+dXkOAQyS8j9PQZusUTMpg' 2-max Seat #2 is the button
Seat 1: XFa6sBGjP2gxoIvxR3fZIg ($50 in chips)
Seat 2: 5IBeOgaApY1Bvzv2P8X4EA ($155.50 in chips)
5IBeOgaApY1Bvzv2P8X4EA: posts small blind $0.25
XFa6sBGjP2gxoIvxR3fZIg: posts big blind $0.50
*** HOLE CARDS ***
5IBeOgaApY1Bvzv2P8X4EA: calls $0.25
XFa6sBGjP2gxoIvxR3fZIg: checks
*** FLOP *** [9c 9d 4s]
XFa6sBGjP2gxoIvxR3fZIg: checks
5IBeOgaApY1Bvzv2P8X4EA: checks
*** TURN *** [9c 9d 4s] [5h]
XFa6sBGjP2gxoIvxR3fZIg: checks
5IBeOgaApY1Bvzv2P8X4EA: checks
*** RIVER *** [9c 9d 4s 5h] [3h]
XFa6sBGjP2gxoIvxR3fZIg: checks
5IBeOgaApY1Bvzv2P8X4EA: checks
*** SHOW DOWN ***
XFa6sBGjP2gxoIvxR3fZIg: shows [7c 2h] (a pair of Nines)
5IBeOgaApY1Bvzv2P8X4EA: shows [Qh Ts] (a pair of Nines - Queen kicker)
5IBeOgaApY1Bvzv2P8X4EA collected $0.95 from pot
*** SUMMARY ***
Total pot $1 | Rake $0.05
Board [9c 9d 4s 5h 3h]
Seat 1: XFa6sBGjP2gxoIvxR3fZIg (big blind) showed [7c 2h] and lost with a pair of Nines
Seat 2: 5IBeOgaApY1Bvzv2P8X4EA (button) (small blind) showed [Qh Ts] and won ($0.95) with a pair of Nines



PokerStars Game #59939487438:  Hold'em No Limit ($0.25/$0.50) - 2009/07/01 0:41:09 ET
Table '3FhG0gl3kMX3wBEEqj+wnQ' 9-max Seat #1 is the button
Seat 1: e0J9pdCNUDTCG031RnXqLA ($20.40 in chips)
Seat 2: 7cYQ+syUWjl38ty/ICOMhw ($50.60 in chips)
Seat 4: bjvJtA9Hqscfznq66txaOQ ($9.25 in chips)
Seat 5: gsyXT42WLEcOS4DdEk2wlw ($28.75 in chips)
Seat 7: mSD1pginDsyHG5PDfqzphw ($10 in chips)
Seat 8: j3K/Jujr7PY4ZM2RZvlH6A ($48.05 in chips)
Seat 9: L5e2lrPLQm1Pqx30IIZ/Fw ($10 in chips)
7cYQ+syUWjl38ty/ICOMhw: posts small blind $0.25
HZkVla4kK2SI42CVrPZ/ig: is sitting out
bjvJtA9Hqscfznq66txaOQ: posts big blind $0.50
997ViqAtWn1FPjJqcffwcA: sits out
*** HOLE CARDS ***
gsyXT42WLEcOS4DdEk2wlw: folds
mSD1pginDsyHG5PDfqzphw: folds
gsyXT42WLEcOS4DdEk2wlw said, "it was a nice reraise"
j3K/Jujr7PY4ZM2RZvlH6A: folds
L5e2lrPLQm1Pqx30IIZ/Fw: raises $1 to $1.50
e0J9pdCNUDTCG031RnXqLA: folds
7cYQ+syUWjl38ty/ICOMhw: folds
bjvJtA9Hqscfznq66txaOQ: folds
L5e2lrPLQm1Pqx30IIZ/Fw collected $1.25 from pot
*** SUMMARY ***
Total pot $1.25 | Rake $0
Seat 1: e0J9pdCNUDTCG031RnXqLA (button) folded before Flop (didn't bet)
Seat 2: 7cYQ+syUWjl38ty/ICOMhw (small blind) folded before Flop
Seat 4: bjvJtA9Hqscfznq66txaOQ (big blind) folded before Flop
Seat 5: gsyXT42WLEcOS4DdEk2wlw folded before Flop (didn't bet)
Seat 7: mSD1pginDsyHG5PDfqzphw folded before Flop (didn't bet)
Seat 8: j3K/Jujr7PY4ZM2RZvlH6A folded before Flop (didn't bet)
Seat 9: L5e2lrPLQm1Pqx30IIZ/Fw collected ($1.25)



PokerStars Game #59939488404:  Hold'em No Limit ($0.25/$0.50) - 2009/07/01 0:41:10 ET
Table 'X6IRCRTh+20gjz8aubWnwA' 9-max Seat #4 is the button
Seat 1: DSM67hHHq1XFoEOi9p8Alw ($50.80 in chips)
Seat 2: HZkVla4kK2SI42CVrPZ/ig ($6.75 in chips)
Seat 3: GeZ7AYmAZ9Ln8liPZzV8EA ($22.95 in chips)
Seat 4: 2J+UVOVrW+V3maOylyxMcQ ($42.20 in chips)
Seat 5: NnQCepdIR/AOUQn1yhYx6Q ($9.50 in chips)
Seat 6: /6In1zC3WtgwxDcueWzZWg ($69.40 in chips)
Seat 7: cFHQjKQOOKTUzoilhrXHLg ($36.25 in chips)
Seat 8: HxeBVq06/3Bh/H986sgdbw ($7.25 in chips)
Seat 9: M+7+BTmX5vZatHVuoRB1nA ($69.25 in chips)
NnQCepdIR/AOUQn1yhYx6Q: posts small blind $0.25
/6In1zC3WtgwxDcueWzZWg: posts big blind $0.50
*** HOLE CARDS ***
cFHQjKQOOKTUzoilhrXHLg: calls $0.50
HxeBVq06/3Bh/H986sgdbw: folds
M+7+BTmX5vZatHVuoRB1nA: folds
DSM67hHHq1XFoEOi9p8Alw: folds
HZkVla4kK2SI42CVrPZ/ig: raises $1.50 to $2
GeZ7AYmAZ9Ln8liPZzV8EA: folds
2J+UVOVrW+V3maOylyxMcQ: calls $2
NnQCepdIR/AOUQn1yhYx6Q: folds
/6In1zC3WtgwxDcueWzZWg: folds
cFHQjKQOOKTUzoilhrXHLg: folds
*** FLOP *** [Th 9d 7s]
HZkVla4kK2SI42CVrPZ/ig: checks
2J+UVOVrW+V3maOylyxMcQ: checks
*** TURN *** [Th 9d 7s] [Ah]
HZkVla4kK2SI42CVrPZ/ig: bets $2
2J+UVOVrW+V3maOylyxMcQ: calls $2
*** RIVER *** [Th 9d 7s Ah] [2s]
HZkVla4kK2SI42CVrPZ/ig: bets $2.75 and is all-in
2J+UVOVrW+V3maOylyxMcQ: folds
HZkVla4kK2SI42CVrPZ/ig collected $8.80 from pot
*** SUMMARY ***
Total pot $9.25 | Rake $0.45
Board [Th 9d 7s Ah 2s]
Seat 1: DSM67hHHq1XFoEOi9p8Alw folded before Flop (didn't bet)
Seat 2: HZkVla4kK2SI42CVrPZ/ig collected ($8.80)
Seat 3: GeZ7AYmAZ9Ln8liPZzV8EA folded before Flop (didn't bet)
Seat 4: 2J+UVOVrW+V3maOylyxMcQ (button) folded on the River
Seat 5: NnQCepdIR/AOUQn1yhYx6Q (small blind) folded before Flop
Seat 6: /6In1zC3WtgwxDcueWzZWg (big blind) folded before Flop
Seat 7: cFHQjKQOOKTUzoilhrXHLg folded before Flop
Seat 8: HxeBVq06/3Bh/H986sgdbw folded before Flop (didn't bet)
Seat 9: M+7+BTmX5vZatHVuoRB1nA folded before Flop (didn't bet)



PokerStars Game #59939489812:  Hold'em No Limit ($0.25/$0.50) - 2009/07/01 0:41:13 ET
Table 'otvGDROEDdqsabxskT79qg' 9-max Seat #7 is the button
Seat 1: 8ehL7qlZzjgUh2H35iiWLw ($56 in chips)
Seat 2: cCjTzH9jio8607WzjcfXlg ($9.05 in chips)
Seat 3: +k7T5ocke8UwavtgUHm+Cg ($75.35 in chips)
Seat 4: MG90wfSJZnOejs/KD3vlQQ ($56.15 in chips)
Seat 5: XNMDwbXt/Q4jM99AXnbJDw ($54.80 in chips)
Seat 6: bxLSulbgr8LmKNjOzw8URg ($51.40 in chips)
Seat 7: C7+tBppJrKgd/r+tuKUIpA ($34.60 in chips)
Seat 8: zE9cVigS2nW/Ljy4K4bUQA ($30 in chips)
Seat 9: KcY3X8YpD74Kw1RHkx/g4A ($66 in chips)
zE9cVigS2nW/Ljy4K4bUQA: posts small blind $0.25
KcY3X8YpD74Kw1RHkx/g4A: posts big blind $0.50
*** HOLE CARDS ***
8ehL7qlZzjgUh2H35iiWLw: folds
cCjTzH9jio8607WzjcfXlg: folds
+k7T5ocke8UwavtgUHm+Cg: folds
MG90wfSJZnOejs/KD3vlQQ: folds
XNMDwbXt/Q4jM99AXnbJDw: folds
bxLSulbgr8LmKNjOzw8URg: folds
C7+tBppJrKgd/r+tuKUIpA: folds
zE9cVigS2nW/Ljy4K4bUQA: folds
KcY3X8YpD74Kw1RHkx/g4A collected $0.50 from pot
*** SUMMARY ***
Total pot $0.50 | Rake $0
Seat 1: 8ehL7qlZzjgUh2H35iiWLw folded before Flop (didn't bet)
Seat 2: cCjTzH9jio8607WzjcfXlg folded before Flop (didn't bet)
Seat 3: +k7T5ocke8UwavtgUHm+Cg folded before Flop (didn't bet)
Seat 4: MG90wfSJZnOejs/KD3vlQQ folded before Flop (didn't bet)
Seat 5: XNMDwbXt/Q4jM99AXnbJDw folded before Flop (didn't bet)
Seat 6: bxLSulbgr8LmKNjOzw8URg folded before Flop (didn't bet)
Seat 7: C7+tBppJrKgd/r+tuKUIpA (button) folded before Flop (didn't bet)
Seat 8: zE9cVigS2nW/Ljy4K4bUQA (small blind) folded before Flop
Seat 9: KcY3X8YpD74Kw1RHkx/g4A (big blind) collected ($0.50)



PokerStars Game #59939490156:  Hold'em No Limit ($0.25/$0.50) - 2009/07/01 0:41:13 ET
Table '/cQuAT3ef4t+PGrXiNhGaQ' 9-max Seat #8 is the button
Seat 1: HZkVla4kK2SI42CVrPZ/ig ($6 in chips)
Seat 2: jXGruyaMqirTaTXNOvBdew ($71.85 in chips)
Seat 3: g4k0NXISyLCqaSWZDBjfEg ($54.40 in chips)
Seat 4: OWP/DOu+PlPK6ZZ3zYa0HA ($39.90 in chips)
Seat 5: 5SgaHdWixdClWvaEG+KUjQ ($26.35 in chips)
Seat 6: APYIOyK/4AGb+kIwlOUNBQ ($39 in chips)
Seat 7: J0W5D97jl5VLky+IoPvDeA ($114.15 in chips)
Seat 8: W3ingbA178eb7J5rt1PuIQ ($28.20 in chips)
Seat 9: AjV5McH1KMMclY26QdLM5w ($26.75 in chips)
AjV5McH1KMMclY26QdLM5w: posts small blind $0.25
HZkVla4kK2SI42CVrPZ/ig: posts big blind $0.50
*** HOLE CARDS ***
jXGruyaMqirTaTXNOvBdew: folds
g4k0NXISyLCqaSWZDBjfEg: folds
OWP/DOu+PlPK6ZZ3zYa0HA: raises $1 to $1.50
5SgaHdWixdClWvaEG+KUjQ: folds
APYIOyK/4AGb+kIwlOUNBQ: calls $1.50
J0W5D97jl5VLky+IoPvDeA: folds
W3ingbA178eb7J5rt1PuIQ: raises $6 to $7.50
AjV5McH1KMMclY26QdLM5w: folds
HZkVla4kK2SI42CVrPZ/ig: folds
OWP/DOu+PlPK6ZZ3zYa0HA: calls $6
APYIOyK/4AGb+kIwlOUNBQ: folds
*** FLOP *** [2s 3s Tc]
OWP/DOu+PlPK6ZZ3zYa0HA: checks
W3ingbA178eb7J5rt1PuIQ: bets $10.50
OWP/DOu+PlPK6ZZ3zYa0HA: folds
W3ingbA178eb7J5rt1PuIQ collected $16.40 from pot
*** SUMMARY ***
Total pot $17.25 | Rake $0.85
Board [2s 3s Tc]
Seat 1: HZkVla4kK2SI42CVrPZ/ig (big blind) folded before Flop
Seat 2: jXGruyaMqirTaTXNOvBdew folded before Flop (didn't bet)
Seat 3: g4k0NXISyLCqaSWZDBjfEg folded before Flop (didn't bet)
Seat 4: OWP/DOu+PlPK6ZZ3zYa0HA folded on the Flop
Seat 5: 5SgaHdWixdClWvaEG+KUjQ folded before Flop (didn't bet)
Seat 6: APYIOyK/4AGb+kIwlOUNBQ folded before Flop
Seat 7: J0W5D97jl5VLky+IoPvDeA folded before Flop (didn't bet)
Seat 8: W3ingbA178eb7J5rt1PuIQ (button) collected ($16.40)
Seat 9: AjV5McH1KMMclY26QdLM5w (small blind) folded before Flop



PokerStars Game #59939490408:  Hold'em No Limit ($0.25/$0.50) - 2009/07/01 0:41:14 ET
Table '5EmHi+fnatGQQShcNmzOZQ' 6-max Seat #1 is the button
Seat 1: +SZCX3+7lnuhHKIu+PP9rg ($29.50 in chips)
Seat 2: vXIHnZ+dv/hwSBxyvGw7bQ ($76.75 in chips)
Seat 3: L9qfLYXrczhAPd/VckgsWw ($81.75 in chips)
Seat 4: 1b+2BbjMN8qhR1WPqdE9VQ ($55.65 in chips)
Seat 5: kxPhs4ePFqMy52CInAJ2aw ($54.60 in chips)
Seat 6: 686aeHikcJlgKkSuIFdcXQ ($141.20 in chips)
vXIHnZ+dv/hwSBxyvGw7bQ: posts small blind $0.25
L9qfLYXrczhAPd/VckgsWw: posts big blind $0.50
*** HOLE CARDS ***
1b+2BbjMN8qhR1WPqdE9VQ: folds
kxPhs4ePFqMy52CInAJ2aw: folds
686aeHikcJlgKkSuIFdcXQ: folds
+SZCX3+7lnuhHKIu+PP9rg: calls $0.50
vXIHnZ+dv/hwSBxyvGw7bQ: folds
L9qfLYXrczhAPd/VckgsWw: checks
*** FLOP *** [3h Kd 6h]
L9qfLYXrczhAPd/VckgsWw: checks
+SZCX3+7lnuhHKIu+PP9rg: checks
*** TURN *** [3h Kd 6h] [Td]
L9qfLYXrczhAPd/VckgsWw: bets $1
+SZCX3+7lnuhHKIu+PP9rg: calls $1
*** RIVER *** [3h Kd 6h Td] [Ks]
L9qfLYXrczhAPd/VckgsWw: checks
+SZCX3+7lnuhHKIu+PP9rg: bets $1
L9qfLYXrczhAPd/VckgsWw: folds
+SZCX3+7lnuhHKIu+PP9rg collected $3.10 from pot
+SZCX3+7lnuhHKIu+PP9rg: doesn't show hand
*** SUMMARY ***
Total pot $3.25 | Rake $0.15
Board [3h Kd 6h Td Ks]
Seat 1: +SZCX3+7lnuhHKIu+PP9rg (button) collected ($3.10)
Seat 2: vXIHnZ+dv/hwSBxyvGw7bQ (small blind) folded before Flop
Seat 3: L9qfLYXrczhAPd/VckgsWw (big blind) folded on the River
Seat 4: 1b+2BbjMN8qhR1WPqdE9VQ folded before Flop (didn't bet)
Seat 5: kxPhs4ePFqMy52CInAJ2aw folded before Flop (didn't bet)
Seat 6: 686aeHikcJlgKkSuIFdcXQ folded before Flop (didn't bet)



PokerStars Game #59939493942:  Hold'em No Limit ($0.25/$0.50) - 2009/07/01 0:41:19 ET
Table 'c/CRn+68J3Y8KxD5g1ek2Q' 2-max Seat #1 is the button
Seat 1: 46qCyJ6evTkHo9al5sBMNA ($205.70 in chips)
Seat 2: BypVLsYQt3ePFm2xQL/dOA ($169.20 in chips)
46qCyJ6evTkHo9al5sBMNA: posts small blind $0.25
BypVLsYQt3ePFm2xQL/dOA: posts big blind $0.50
*** HOLE CARDS ***
46qCyJ6evTkHo9al5sBMNA: folds
BypVLsYQt3ePFm2xQL/dOA collected $0.50 from pot
BypVLsYQt3ePFm2xQL/dOA: doesn't show hand
*** SUMMARY ***
Total pot $0.50 | Rake $0
Seat 1: 46qCyJ6evTkHo9al5sBMNA (button) (small blind) folded before Flop
Seat 2: BypVLsYQt3ePFm2xQL/dOA (big blind) collected ($0.50)



PokerStars Game #59939494684:  Hold'em No Limit ($0.25/$0.50) - 2009/07/01 0:41:20 ET
Table 'GfL/No5u5PoEnU39lP5pQg' 6-max Seat #4 is the button
Seat 1: 1WUCqNG+p+vfWRTXNu4ljw ($50.50 in chips)
Seat 2: uVwggSetzp7d+eVgowO3vg ($71.70 in chips)
Seat 3: Ek4w9XqBXqK5jBUQeLedGw ($50 in chips)
Seat 4: x+pzUFJsMIiGd7a5pcR4tg ($54.30 in chips)
M1KyQQvVPVuxqTAB8sR/zQ joins the table at seat #5
1WUCqNG+p+vfWRTXNu4ljw: posts small blind $0.25
uVwggSetzp7d+eVgowO3vg: posts big blind $0.50
*** HOLE CARDS ***
Ek4w9XqBXqK5jBUQeLedGw: raises $1 to $1.50
x+pzUFJsMIiGd7a5pcR4tg: folds
1WUCqNG+p+vfWRTXNu4ljw: folds
uVwggSetzp7d+eVgowO3vg: folds
Ek4w9XqBXqK5jBUQeLedGw collected $1.25 from pot
*** SUMMARY ***
Total pot $1.25 | Rake $0
Seat 1: 1WUCqNG+p+vfWRTXNu4ljw (small blind) folded before Flop
Seat 2: uVwggSetzp7d+eVgowO3vg (big blind) folded before Flop
Seat 3: Ek4w9XqBXqK5jBUQeLedGw collected ($1.25)
Seat 4: x+pzUFJsMIiGd7a5pcR4tg (button) folded before Flop (didn't bet)



PokerStars Game #59939495858:  Hold'em No Limit ($0.25/$0.50) - 2009/07/01 0:41:22 ET
Table 'EiNh8p/wGJ1FP575iMFnqg' 9-max Seat #2 is the button
Seat 1: r3ZqM1Mi0W3y4hOdssE+Sg ($49.40 in chips)
Seat 2: 8ehL7qlZzjgUh2H35iiWLw ($53.35 in chips)
Seat 3: ymLPoEIl7UL3TvZYmnadxQ ($48.85 in chips)
Seat 4: cMzaiXAM/ZAdNaEUu+LqhA ($50 in chips)
Seat 5: M+7+BTmX5vZatHVuoRB1nA ($85.35 in chips)
Seat 6: 3UmXLy3GfjC3EkOebduerQ ($54.65 in chips)
Seat 7: 997ViqAtWn1FPjJqcffwcA ($50 in chips)
Seat 8: KrPAGRACBg+w0M//SXe8Ag ($9.35 in chips)
ymLPoEIl7UL3TvZYmnadxQ: posts small blind $0.25
cMzaiXAM/ZAdNaEUu+LqhA: posts big blind $0.50
NnQCepdIR/AOUQn1yhYx6Q: sits out
*** HOLE CARDS ***
M+7+BTmX5vZatHVuoRB1nA: folds
3UmXLy3GfjC3EkOebduerQ: raises $1.50 to $2
997ViqAtWn1FPjJqcffwcA: folds
KrPAGRACBg+w0M//SXe8Ag: folds
r3ZqM1Mi0W3y4hOdssE+Sg: folds
8ehL7qlZzjgUh2H35iiWLw: folds
ymLPoEIl7UL3TvZYmnadxQ: folds
cMzaiXAM/ZAdNaEUu+LqhA: folds
3UmXLy3GfjC3EkOebduerQ collected $1.25 from pot
3UmXLy3GfjC3EkOebduerQ: doesn't show hand
*** SUMMARY ***
Total pot $1.25 | Rake $0
Seat 1: r3ZqM1Mi0W3y4hOdssE+Sg folded before Flop (didn't bet)
Seat 2: 8ehL7qlZzjgUh2H35iiWLw (button) folded before Flop (didn't bet)
Seat 3: ymLPoEIl7UL3TvZYmnadxQ (small blind) folded before Flop
Seat 4: cMzaiXAM/ZAdNaEUu+LqhA (big blind) folded before Flop
Seat 5: M+7+BTmX5vZatHVuoRB1nA folded before Flop (didn't bet)
Seat 6: 3UmXLy3GfjC3EkOebduerQ collected ($1.25)
Seat 7: 997ViqAtWn1FPjJqcffwcA folded before Flop (didn't bet)
Seat 8: KrPAGRACBg+w0M//SXe8Ag folded before Flop (didn't bet)



PokerStars Game #59939497716:  Hold'em No Limit ($0.25/$0.50) - 2009/07/01 0:41:25 ET
Table '+dXkOAQyS8j9PQZusUTMpg' 2-max Seat #1 is the button
Seat 1: XFa6sBGjP2gxoIvxR3fZIg ($49.50 in chips)
Seat 2: 5IBeOgaApY1Bvzv2P8X4EA ($155.95 in chips)
XFa6sBGjP2gxoIvxR3fZIg: posts small blind $0.25
5IBeOgaApY1Bvzv2P8X4EA: posts big blind $0.50
*** HOLE CARDS ***
XFa6sBGjP2gxoIvxR3fZIg: raises $1 to $1.50
5IBeOgaApY1Bvzv2P8X4EA: calls $1
*** FLOP *** [Tc 6h 2s]
5IBeOgaApY1Bvzv2P8X4EA: checks
XFa6sBGjP2gxoIvxR3fZIg: bets $2
5IBeOgaApY1Bvzv2P8X4EA: calls $2
*** TURN *** [Tc 6h 2s] [7s]
5IBeOgaApY1Bvzv2P8X4EA: checks
XFa6sBGjP2gxoIvxR3fZIg: bets $5.50
5IBeOgaApY1Bvzv2P8X4EA: folds
XFa6sBGjP2gxoIvxR3fZIg collected $6.70 from pot
XFa6sBGjP2gxoIvxR3fZIg: doesn't show hand
*** SUMMARY ***
Total pot $7 | Rake $0.30
Board [Tc 6h 2s 7s]
Seat 1: XFa6sBGjP2gxoIvxR3fZIg (button) (small blind) collected ($6.70)
Seat 2: 5IBeOgaApY1Bvzv2P8X4EA (big blind) folded on the Turn



PokerStars Game #59939498186:  Hold'em No Limit ($0.25/$0.50) - 2009/07/01 0:41:26 ET
Table 'c/CRn+68J3Y8KxD5g1ek2Q' 2-max Seat #2 is the button
Seat 1: 46qCyJ6evTkHo9al5sBMNA ($205.45 in chips)
Seat 2: BypVLsYQt3ePFm2xQL/dOA ($169.45 in chips)
BypVLsYQt3ePFm2xQL/dOA: posts small blind $0.25
46qCyJ6evTkHo9al5sBMNA: posts big blind $0.50
*** HOLE CARDS ***
BypVLsYQt3ePFm2xQL/dOA: raises $1 to $1.50
46qCyJ6evTkHo9al5sBMNA: folds
BypVLsYQt3ePFm2xQL/dOA collected $1 from pot
BypVLsYQt3ePFm2xQL/dOA: doesn't show hand
*** SUMMARY ***
Total pot $1 | Rake $0
Seat 1: 46qCyJ6evTkHo9al5sBMNA (big blind) folded before Flop
Seat 2: BypVLsYQt3ePFm2xQL/dOA (button) (small blind) collected ($1)



PokerStars Game #59939498604:  Hold'em No Limit ($0.25/$0.50) - 2009/07/01 0:41:26 ET
Table 'MJxeZCzYELxiIsyUZyT0jw' 6-max Seat #5 is the button
Seat 2: dB6jzDlJmET84VMWw1mTRA ($50.75 in chips)
Seat 3: JQZew0FjzS19kTjeNtrE+A ($50 in chips)
Seat 5: 3jvoOXNtXE90w2BdfNZwZQ ($52 in chips)
Seat 6: TTx3CHxyi0SObcHyMJRp5w ($59.45 in chips)
TTx3CHxyi0SObcHyMJRp5w: posts small blind $0.25
tdOvWynovql5imfooroLMg: is sitting out
dB6jzDlJmET84VMWw1mTRA: posts big blind $0.50
alGiiQP/wwtYnfuXII+sgw: sits out
*** HOLE CARDS ***
JQZew0FjzS19kTjeNtrE+A: folds
3jvoOXNtXE90w2BdfNZwZQ: folds
TTx3CHxyi0SObcHyMJRp5w: folds
dB6jzDlJmET84VMWw1mTRA collected $0.50 from pot
dB6jzDlJmET84VMWw1mTRA: doesn't show hand
*** SUMMARY ***
Total pot $0.50 | Rake $0
Seat 2: dB6jzDlJmET84VMWw1mTRA (big blind) collected ($0.50)
Seat 3: JQZew0FjzS19kTjeNtrE+A folded before Flop (didn't bet)
Seat 5: 3jvoOXNtXE90w2BdfNZwZQ (button) folded before Flop (didn't bet)
Seat 6: TTx3CHxyi0SObcHyMJRp5w (small blind) folded before Flop



PokerStars Game #59939500104:  Hold'em No Limit ($0.25/$0.50) - 2009/07/01 0:41:29 ET
Table 'IeNZOZQ4T6oiaHqFeo6yIA' 2-max Seat #2 is the button
Seat 1: ndd1nfncBkWNitBnsfCoVQ ($50 in chips)
Seat 2: A91IUl5JaZROhtfCtnnwYw ($109.75 in chips)
A91IUl5JaZROhtfCtnnwYw: posts small blind $0.25
ndd1nfncBkWNitBnsfCoVQ: posts big blind $0.50
*** HOLE CARDS ***
A91IUl5JaZROhtfCtnnwYw: raises $0.50 to $1
ndd1nfncBkWNitBnsfCoVQ: folds
A91IUl5JaZROhtfCtnnwYw collected $1 from pot
A91IUl5JaZROhtfCtnnwYw: doesn't show hand
*** SUMMARY ***
Total pot $1 | Rake $0
Seat 1: ndd1nfncBkWNitBnsfCoVQ (big blind) folded before Flop
Seat 2: A91IUl5JaZROhtfCtnnwYw (button) (small blind) collected ($1)



PokerStars Game #59939500188:  Hold'em No Limit ($0.25/$0.50) - 2009/07/01 0:41:29 ET
Table '37qXEp3oe+er5q4CZip9eQ' 6-max Seat #4 is the button
Seat 1: oqOqoO2AyCZenUghCxMDxw ($58.95 in chips)
Seat 2: 6wzJiRvp8HY6t+MQGnSIzA ($24.85 in chips)
Seat 3: Rt6KgtZ8YaJoTc3FPim00w ($73 in chips)
Seat 4: XsmE8nXMAAMFJbWaJTmHFw ($30.20 in chips)
Seat 5: VOmI0x4dDPnTESZd5B4d1Q ($46.90 in chips)
Seat 6: N50kln4negd8q7Mmoz1j4g ($22.85 in chips)
VOmI0x4dDPnTESZd5B4d1Q: posts small blind $0.25
N50kln4negd8q7Mmoz1j4g: posts big blind $0.50
*** HOLE CARDS ***
oqOqoO2AyCZenUghCxMDxw: folds
6wzJiRvp8HY6t+MQGnSIzA: raises $1 to $1.50
Rt6KgtZ8YaJoTc3FPim00w: folds
XsmE8nXMAAMFJbWaJTmHFw: folds
VOmI0x4dDPnTESZd5B4d1Q: folds
N50kln4negd8q7Mmoz1j4g: calls $1
*** FLOP *** [Jd Kh Qc]
N50kln4negd8q7Mmoz1j4g: checks
VOmI0x4dDPnTESZd5B4d1Q is sitting out
6wzJiRvp8HY6t+MQGnSIzA: bets $3
N50kln4negd8q7Mmoz1j4g: folds
6wzJiRvp8HY6t+MQGnSIzA collected $3.10 from pot
*** SUMMARY ***
Total pot $3.25 | Rake $0.15
Board [Jd Kh Qc]
Seat 1: oqOqoO2AyCZenUghCxMDxw folded before Flop (didn't bet)
Seat 2: 6wzJiRvp8HY6t+MQGnSIzA collected ($3.10)
Seat 3: Rt6KgtZ8YaJoTc3FPim00w folded before Flop (didn't bet)
Seat 4: XsmE8nXMAAMFJbWaJTmHFw (button) folded before Flop (didn't bet)
Seat 5: VOmI0x4dDPnTESZd5B4d1Q (small blind) folded before Flop
Seat 6: N50kln4negd8q7Mmoz1j4g (big blind) folded on the Flop



PokerStars Game #59939499944:  Hold'em No Limit ($0.25/$0.50) - 2009/07/01 0:41:29 ET
Table 'QOgaEqMcJ73pcUMMxoisUgErOuyGLI5PT3G5MnpHgC/g Seat #3 is the button
Seat 1: L5e2lrPLQm1Pqx30IIZ/Fw ($10 in chips)
Seat 3: xZCXQSXlrZkp3pZizzVXCw ($50.50 in chips)
Seat 4: 3UmXLy3GfjC3EkOebduerQ ($50 in chips)
Seat 5: JwvquocWfhTVApN5t47LgA ($59.55 in chips)
Seat 6: zE9cVigS2nW/Ljy4K4bUQA ($30 in chips)
Seat 7: 90Wb75h3W1BRpbqVnuk8gw ($60.95 in chips)
Seat 8: g4k0NXISyLCqaSWZDBjfEg ($52.10 in chips)
Seat 9: J0W5D97jl5VLky+IoPvDeA ($57.90 in chips)
3UmXLy3GfjC3EkOebduerQ: posts small blind $0.25
JwvquocWfhTVApN5t47LgA: posts big blind $0.50
*** HOLE CARDS ***
zE9cVigS2nW/Ljy4K4bUQA: folds
90Wb75h3W1BRpbqVnuk8gw: folds
g4k0NXISyLCqaSWZDBjfEg: folds
J0W5D97jl5VLky+IoPvDeA: folds
L5e2lrPLQm1Pqx30IIZ/Fw: folds
xZCXQSXlrZkp3pZizzVXCw: folds
3UmXLy3GfjC3EkOebduerQ: folds
JwvquocWfhTVApN5t47LgA collected $0.50 from pot
*** SUMMARY ***
Total pot $0.50 | Rake $0
Seat 1: L5e2lrPLQm1Pqx30IIZ/Fw folded before Flop (didn't bet)
Seat 3: xZCXQSXlrZkp3pZizzVXCw (button) folded before Flop (didn't bet)
Seat 4: 3UmXLy3GfjC3EkOebduerQ (small blind) folded before Flop
Seat 5: JwvquocWfhTVApN5t47LgA (big blind) collected ($0.50)
Seat 6: zE9cVigS2nW/Ljy4K4bUQA folded before Flop (didn't bet)
Seat 7: 90Wb75h3W1BRpbqVnuk8gw folded before Flop (didn't bet)
Seat 8: g4k0NXISyLCqaSWZDBjfEg folded before Flop (didn't bet)
Seat 9: J0W5D97jl5VLky+IoPvDeA folded before Flop (didn't bet)



PokerStars Game #59939501854:  Hold'em No Limit ($0.25/$0.50) - 2009/07/01 0:41:32 ET
Table 'QOeVnLhwctF9UyV/beDi+A' 2-max Seat #1 is the button
Seat 1: bypIyrYcAAifLfhZpGlKLA ($63.60 in chips)
Seat 2: Ucrm3XtZmoONapW32SPhag ($21.15 in chips)
bypIyrYcAAifLfhZpGlKLA: posts small blind $0.25
Ucrm3XtZmoONapW32SPhag: posts big blind $0.50
*** HOLE CARDS ***
bypIyrYcAAifLfhZpGlKLA: raises $1 to $1.50
Ucrm3XtZmoONapW32SPhag: calls $1
*** FLOP *** [4s 2d 9d]
Ucrm3XtZmoONapW32SPhag: checks
bypIyrYcAAifLfhZpGlKLA: bets $2.50
Ucrm3XtZmoONapW32SPhag: folds
bypIyrYcAAifLfhZpGlKLA collected $2.85 from pot
bypIyrYcAAifLfhZpGlKLA: doesn't show hand
*** SUMMARY ***
Total pot $3 | Rake $0.15
Board [4s 2d 9d]
Seat 1: bypIyrYcAAifLfhZpGlKLA (button) (small blind) collected ($2.85)
Seat 2: Ucrm3XtZmoONapW32SPhag (big blind) folded on the Flop



PokerStars Game #59939501730:  Hold'em No Limit ($0.25/$0.50) - 2009/07/01 0:41:32 ET
Table 'ibNfFy0bCzuBaUORla0aGw' 9-max Seat #3 is the button
Seat 1: xZCXQSXlrZkp3pZizzVXCw ($53.20 in chips)
Seat 2: 90Wb75h3W1BRpbqVnuk8gw ($58.90 in chips)
Seat 3: dDaHs3X8+fe3bIkRU0cbrw ($40.15 in chips)
Seat 4: YBN054X4blmis+B2bBlC0g ($23.70 in chips)
Seat 5: GIJAc9kPrLZHLSX8Q6i99w ($25.20 in chips)
Seat 6: 8n9jQLh3cZKbsmr5PIjgiQ ($36.50 in chips)
Seat 7: HZkVla4kK2SI42CVrPZ/ig ($11.75 in chips)
Seat 8: xUrN9TWLq4m5V+OXY7KUUA ($51.25 in chips)
Seat 9: pFtzb1sR4b0d1aw6aIRgDg ($50.75 in chips)
YBN054X4blmis+B2bBlC0g: posts small blind $0.25
GIJAc9kPrLZHLSX8Q6i99w: posts big blind $0.50
*** HOLE CARDS ***
8n9jQLh3cZKbsmr5PIjgiQ: folds
HZkVla4kK2SI42CVrPZ/ig: folds
xUrN9TWLq4m5V+OXY7KUUA: folds
pFtzb1sR4b0d1aw6aIRgDg: folds
xZCXQSXlrZkp3pZizzVXCw: folds
90Wb75h3W1BRpbqVnuk8gw: folds
dDaHs3X8+fe3bIkRU0cbrw: folds
YBN054X4blmis+B2bBlC0g: folds
GIJAc9kPrLZHLSX8Q6i99w collected $0.50 from pot
*** SUMMARY ***
Total pot $0.50 | Rake $0
Seat 1: xZCXQSXlrZkp3pZizzVXCw folded before Flop (didn't bet)
Seat 2: 90Wb75h3W1BRpbqVnuk8gw folded before Flop (didn't bet)
Seat 3: dDaHs3X8+fe3bIkRU0cbrw (button) folded before Flop (didn't bet)
Seat 4: YBN054X4blmis+B2bBlC0g (small blind) folded before Flop
Seat 5: GIJAc9kPrLZHLSX8Q6i99w (big blind) collected ($0.50)
Seat 6: 8n9jQLh3cZKbsmr5PIjgiQ folded before Flop (didn't bet)
Seat 7: HZkVla4kK2SI42CVrPZ/ig folded before Flop (didn't bet)
Seat 8: xUrN9TWLq4m5V+OXY7KUUA folded before Flop (didn't bet)
Seat 9: pFtzb1sR4b0d1aw6aIRgDg folded before Flop (didn't bet)



PokerStars Game #59939502450:  Hold'em No Limit ($0.25/$0.50) - 2009/07/01 0:41:33 ET
Table '+z1aekfHkpp09pc8F9aViw' 6-max Seat #2 is the button
Seat 1: FHilMb2i2DbUCc9lplszog ($30.45 in chips)
Seat 2: M6xK/VklCvdyyrmvzATlxQ ($36.05 in chips)
Seat 3: uUznlIMFnRUvwrBhYF73KA ($80.95 in chips)
Seat 4: RowCSpSURHTOL/dcjg/Iug ($50.30 in chips)
Seat 5: crjGpJEzSZgD38FoE3VMGg ($50 in chips)
Seat 6: 686aeHikcJlgKkSuIFdcXQ ($67.10 in chips)
uUznlIMFnRUvwrBhYF73KA: posts small blind $0.25
RowCSpSURHTOL/dcjg/Iug: posts big blind $0.50
*** HOLE CARDS ***
crjGpJEzSZgD38FoE3VMGg: folds
686aeHikcJlgKkSuIFdcXQ: folds
FHilMb2i2DbUCc9lplszog: calls $0.50
M6xK/VklCvdyyrmvzATlxQ: calls $0.50
uUznlIMFnRUvwrBhYF73KA: calls $0.25
RowCSpSURHTOL/dcjg/Iug: checks
*** FLOP *** [Ac 7c 2c]
uUznlIMFnRUvwrBhYF73KA: checks
RowCSpSURHTOL/dcjg/Iug: checks
FHilMb2i2DbUCc9lplszog: checks
M6xK/VklCvdyyrmvzATlxQ: checks
*** TURN *** [Ac 7c 2c] [5c]
uUznlIMFnRUvwrBhYF73KA: checks
RowCSpSURHTOL/dcjg/Iug: checks
FHilMb2i2DbUCc9lplszog: checks
M6xK/VklCvdyyrmvzATlxQ: checks
*** RIVER *** [Ac 7c 2c 5c] [Tc]
uUznlIMFnRUvwrBhYF73KA: checks
RowCSpSURHTOL/dcjg/Iug: checks
FHilMb2i2DbUCc9lplszog: checks
M6xK/VklCvdyyrmvzATlxQ: checks
*** SHOW DOWN ***
uUznlIMFnRUvwrBhYF73KA: shows [3s Ks] (a flush, Ace high)
RowCSpSURHTOL/dcjg/Iug: shows [3h As] (a flush, Ace high)
FHilMb2i2DbUCc9lplszog: shows [7s 9h] (a flush, Ace high)
M6xK/VklCvdyyrmvzATlxQ: shows [Td 8d] (a flush, Ace high)
uUznlIMFnRUvwrBhYF73KA collected $0.50 from pot
RowCSpSURHTOL/dcjg/Iug collected $0.50 from pot
FHilMb2i2DbUCc9lplszog collected $0.45 from pot
M6xK/VklCvdyyrmvzATlxQ collected $0.45 from pot
*** SUMMARY ***
Total pot $2 | Rake $0.10
Board [Ac 7c 2c 5c Tc]
Seat 1: FHilMb2i2DbUCc9lplszog showed [7s 9h] and won ($0.45) with a flush, Ace high
Seat 2: M6xK/VklCvdyyrmvzATlxQ (button) showed [Td 8d] and won ($0.45) with a flush, Ace high
Seat 3: uUznlIMFnRUvwrBhYF73KA (small blind) showed [3s Ks] and won ($0.50) with a flush, Ace high
Seat 4: RowCSpSURHTOL/dcjg/Iug (big blind) showed [3h As] and won ($0.50) with a flush, Ace high
Seat 5: crjGpJEzSZgD38FoE3VMGg folded before Flop (didn't bet)
Seat 6: 686aeHikcJlgKkSuIFdcXQ folded before Flop (didn't bet)



PokerStars Game #59939503016:  Hold'em No Limit ($0.25/$0.50) - 2009/07/01 0:41:34 ET
Table 'tyR5AZNKV8Aadbrnrnlg7g' 6-max Seat #4 is the button
Seat 1: R+KjpH/wSjDLhtIy9+edNA ($92.35 in chips)
Seat 2: BAjwVL+zKKd0s0fAWstzQQ ($24.10 in chips)
Seat 3: tdOvWynovql5imfooroLMg ($45.75 in chips)
Seat 4: Rt6KgtZ8YaJoTc3FPim00w ($131.65 in chips)
Seat 5: Ek4w9XqBXqK5jBUQeLedGw ($50 in chips)
Seat 6: ZKazl1hGaPiapDXincgi2Q ($12.40 in chips)
Ek4w9XqBXqK5jBUQeLedGw: posts small blind $0.25
ZKazl1hGaPiapDXincgi2Q: posts big blind $0.50
*** HOLE CARDS ***
R+KjpH/wSjDLhtIy9+edNA: raises $1 to $1.50
BAjwVL+zKKd0s0fAWstzQQ: folds
tdOvWynovql5imfooroLMg: folds
Rt6KgtZ8YaJoTc3FPim00w: folds
Ek4w9XqBXqK5jBUQeLedGw: folds
ZKazl1hGaPiapDXincgi2Q: folds
R+KjpH/wSjDLhtIy9+edNA collected $1.25 from pot
R+KjpH/wSjDLhtIy9+edNA: doesn't show hand
*** SUMMARY ***
Total pot $1.25 | Rake $0
Seat 1: R+KjpH/wSjDLhtIy9+edNA collected ($1.25)
Seat 2: BAjwVL+zKKd0s0fAWstzQQ folded before Flop (didn't bet)
Seat 3: tdOvWynovql5imfooroLMg folded before Flop (didn't bet)
Seat 4: Rt6KgtZ8YaJoTc3FPim00w (button) folded before Flop (didn't bet)
Seat 5: Ek4w9XqBXqK5jBUQeLedGw (small blind) folded before Flop
Seat 6: ZKazl1hGaPiapDXincgi2Q (big blind) folded before Flop



PokerStars Game #59939503178:  Hold'em No Limit ($0.25/$0.50) - 2009/07/01 0:41:34 ET
Table '3FhG0gl3kMX3wBEEqj+wnQ' 9-max Seat #2 is the button
Seat 1: e0J9pdCNUDTCG031RnXqLA ($20.40 in chips)
Seat 2: 7cYQ+syUWjl38ty/ICOMhw ($50.35 in chips)
Seat 4: bjvJtA9Hqscfznq66txaOQ ($8.75 in chips)
Seat 5: gsyXT42WLEcOS4DdEk2wlw ($28.75 in chips)
Seat 7: mSD1pginDsyHG5PDfqzphw ($10 in chips)
Seat 8: j3K/Jujr7PY4ZM2RZvlH6A ($48.05 in chips)
Seat 9: L5e2lrPLQm1Pqx30IIZ/Fw ($10.75 in chips)
bjvJtA9Hqscfznq66txaOQ: posts small blind $0.25
gsyXT42WLEcOS4DdEk2wlw: posts big blind $0.50
997ViqAtWn1FPjJqcffwcA: sits out
*** HOLE CARDS ***
HZkVla4kK2SI42CVrPZ/ig leaves the table
gsyXT42WLEcOS4DdEk2wlw said, "it was a suited weak ace"
mSD1pginDsyHG5PDfqzphw: folds
j3K/Jujr7PY4ZM2RZvlH6A: folds
L5e2lrPLQm1Pqx30IIZ/Fw: folds
e0J9pdCNUDTCG031RnXqLA: raises $0.50 to $1
7cYQ+syUWjl38ty/ICOMhw: calls $1
bjvJtA9Hqscfznq66txaOQ: folds
gsyXT42WLEcOS4DdEk2wlw: folds
*** FLOP *** [8c Jh Qh]
e0J9pdCNUDTCG031RnXqLA: checks
7cYQ+syUWjl38ty/ICOMhw: checks
*** TURN *** [8c Jh Qh] [Ks]
e0J9pdCNUDTCG031RnXqLA: checks
7cYQ+syUWjl38ty/ICOMhw: bets $1.50
e0J9pdCNUDTCG031RnXqLA: calls $1.50
*** RIVER *** [8c Jh Qh Ks] [2s]
e0J9pdCNUDTCG031RnXqLA: checks
7cYQ+syUWjl38ty/ICOMhw: checks
*** SHOW DOWN ***
e0J9pdCNUDTCG031RnXqLA: shows [Ac 9h] (high card Ace)
7cYQ+syUWjl38ty/ICOMhw: mucks hand
e0J9pdCNUDTCG031RnXqLA collected $5.50 from pot
*** SUMMARY ***
Total pot $5.75 | Rake $0.25
Board [8c Jh Qh Ks 2s]
Seat 1: e0J9pdCNUDTCG031RnXqLA showed [Ac 9h] and won ($5.50) with high card Ace
Seat 2: 7cYQ+syUWjl38ty/ICOMhw (button) mucked
Seat 4: bjvJtA9Hqscfznq66txaOQ (small blind) folded before Flop
Seat 5: gsyXT42WLEcOS4DdEk2wlw (big blind) folded before Flop
Seat 7: mSD1pginDsyHG5PDfqzphw folded before Flop (didn't bet)
Seat 8: j3K/Jujr7PY4ZM2RZvlH6A folded before Flop (didn't bet)
Seat 9: L5e2lrPLQm1Pqx30IIZ/Fw folded before Flop (didn't bet)



PokerStars Game #59939505118:  Hold'em No Limit ($0.25/$0.50) - 2009/07/01 0:41:37 ET
Table 'hSTs/dUsYLgJQuF2Onp0MQ' 6-max Seat #2 is the button
Seat 2: 6vNxrjjCl6FwfaaymM9jjg ($36.75 in chips)
Seat 3: C3qJBo7uxfFVDluE1lmK2w ($33.45 in chips)
Seat 4: L0aIPg7qefDQjdJo3HCVEA ($8.30 in chips)
Seat 5: 686aeHikcJlgKkSuIFdcXQ ($62.95 in chips)
Seat 6: w0pd++ZQHijd9dDhKEYOAQ ($30.40 in chips)
C3qJBo7uxfFVDluE1lmK2w: posts small blind $0.25
L0aIPg7qefDQjdJo3HCVEA: posts big blind $0.50
1WUCqNG+p+vfWRTXNu4ljw: sits out
*** HOLE CARDS ***
686aeHikcJlgKkSuIFdcXQ: folds
w0pd++ZQHijd9dDhKEYOAQ: folds
6vNxrjjCl6FwfaaymM9jjg: raises $2 to $2.50
C3qJBo7uxfFVDluE1lmK2w: folds
L0aIPg7qefDQjdJo3HCVEA: folds
6vNxrjjCl6FwfaaymM9jjg collected $1.25 from pot
*** SUMMARY ***
Total pot $1.25 | Rake $0
Seat 2: 6vNxrjjCl6FwfaaymM9jjg (button) collected ($1.25)
Seat 3: C3qJBo7uxfFVDluE1lmK2w (small blind) folded before Flop
Seat 4: L0aIPg7qefDQjdJo3HCVEA (big blind) folded before Flop
Seat 5: 686aeHikcJlgKkSuIFdcXQ folded before Flop (didn't bet)
Seat 6: w0pd++ZQHijd9dDhKEYOAQ folded before Flop (didn't bet)



PokerStars Game #59939505472:  Hold'em No Limit ($0.25/$0.50) - 2009/07/01 0:41:37 ET
Table 'GfL/No5u5PoEnU39lP5pQg' 6-max Seat #1 is the button
Seat 1: 1WUCqNG+p+vfWRTXNu4ljw ($50.25 in chips)
Seat 2: uVwggSetzp7d+eVgowO3vg ($71.20 in chips)
Seat 3: Ek4w9XqBXqK5jBUQeLedGw ($50.75 in chips)
Seat 4: x+pzUFJsMIiGd7a5pcR4tg ($54.30 in chips)
uVwggSetzp7d+eVgowO3vg: posts small blind $0.25
Ek4w9XqBXqK5jBUQeLedGw: posts big blind $0.50
M1KyQQvVPVuxqTAB8sR/zQ: sits out
*** HOLE CARDS ***
x+pzUFJsMIiGd7a5pcR4tg: folds
1WUCqNG+p+vfWRTXNu4ljw: folds
uVwggSetzp7d+eVgowO3vg: folds
Ek4w9XqBXqK5jBUQeLedGw collected $0.50 from pot
*** SUMMARY ***
Total pot $0.50 | Rake $0
Seat 1: 1WUCqNG+p+vfWRTXNu4ljw (button) folded before Flop (didn't bet)
Seat 2: uVwggSetzp7d+eVgowO3vg (small blind) folded before Flop
Seat 3: Ek4w9XqBXqK5jBUQeLedGw (big blind) collected ($0.50)
Seat 4: x+pzUFJsMIiGd7a5pcR4tg folded before Flop (didn't bet)



PokerStars Game #59939506062:  Hold'em No Limit ($0.25/$0.50) - 2009/07/01 0:41:38 ET
Table 'hWT2kq66tnKEpD26cia6fQ' 2-max Seat #1 is the button
Seat 1: q+vRKwm51mnr6kxX/161WQ ($39 in chips)
Seat 2: dkC7J+qbyqk0qCcmJbEPPw ($74.80 in chips)
q+vRKwm51mnr6kxX/161WQ: posts small blind $0.25
dkC7J+qbyqk0qCcmJbEPPw: posts big blind $0.50
*** HOLE CARDS ***
q+vRKwm51mnr6kxX/161WQ: raises $1 to $1.50
dkC7J+qbyqk0qCcmJbEPPw: calls $1
*** FLOP *** [5h Ts 2s]
dkC7J+qbyqk0qCcmJbEPPw: checks
q+vRKwm51mnr6kxX/161WQ: bets $2
dkC7J+qbyqk0qCcmJbEPPw: folds
q+vRKwm51mnr6kxX/161WQ collected $2.85 from pot
q+vRKwm51mnr6kxX/161WQ: doesn't show hand
*** SUMMARY ***
Total pot $3 | Rake $0.15
Board [5h Ts 2s]
Seat 1: q+vRKwm51mnr6kxX/161WQ (button) (small blind) collected ($2.85)
Seat 2: dkC7J+qbyqk0qCcmJbEPPw (big blind) folded on the Flop



PokerStars Game #59939506606:  Hold'em No Limit ($0.25/$0.50) - 2009/07/01 0:41:39 ET
Table 'IeNZOZQ4T6oiaHqFeo6yIA' 2-max Seat #1 is the button
Seat 1: ndd1nfncBkWNitBnsfCoVQ ($49.50 in chips)
Seat 2: A91IUl5JaZROhtfCtnnwYw ($110.25 in chips)
ndd1nfncBkWNitBnsfCoVQ: posts small blind $0.25
A91IUl5JaZROhtfCtnnwYw: posts big blind $0.50
*** HOLE CARDS ***
ndd1nfncBkWNitBnsfCoVQ: raises $1 to $1.50
A91IUl5JaZROhtfCtnnwYw: calls $1
*** FLOP *** [8h 6h Td]
A91IUl5JaZROhtfCtnnwYw: checks
ndd1nfncBkWNitBnsfCoVQ: checks
*** TURN *** [8h 6h Td] [Ac]
A91IUl5JaZROhtfCtnnwYw: bets $0.50
ndd1nfncBkWNitBnsfCoVQ: folds
A91IUl5JaZROhtfCtnnwYw collected $2.85 from pot
A91IUl5JaZROhtfCtnnwYw: doesn't show hand
*** SUMMARY ***
Total pot $3 | Rake $0.15
Board [8h 6h Td Ac]
Seat 1: ndd1nfncBkWNitBnsfCoVQ (button) (small blind) folded on the Turn
Seat 2: A91IUl5JaZROhtfCtnnwYw (big blind) collected ($2.85)



PokerStars Game #59939507622:  Hold'em No Limit ($0.25/$0.50) - 2009/07/01 0:41:40 ET
Table 'E7bWJ45aoFXRpyRv2gw+Ig' 2-max Seat #1 is the button
Seat 1: FRkiRasEGlHUeLrEl+k/nA ($56.10 in chips)
Seat 2: 3Wro85I7472vJ4Wkpneo9A ($140.80 in chips)
FRkiRasEGlHUeLrEl+k/nA: posts small blind $0.25
3Wro85I7472vJ4Wkpneo9A: posts big blind $0.50
*** HOLE CARDS ***
FRkiRasEGlHUeLrEl+k/nA: calls $0.25
3Wro85I7472vJ4Wkpneo9A: checks
*** FLOP *** [Td 9s 6h]
3Wro85I7472vJ4Wkpneo9A: bets $1
FRkiRasEGlHUeLrEl+k/nA: calls $1
*** TURN *** [Td 9s 6h] [4s]
3Wro85I7472vJ4Wkpneo9A: bets $2
FRkiRasEGlHUeLrEl+k/nA: calls $2
*** RIVER *** [Td 9s 6h 4s] [5s]
3Wro85I7472vJ4Wkpneo9A: bets $4
FRkiRasEGlHUeLrEl+k/nA: raises $8 to $12
3Wro85I7472vJ4Wkpneo9A: calls $8
*** SHOW DOWN ***
FRkiRasEGlHUeLrEl+k/nA: shows [8c 7h] (a straight, Six to Ten)
3Wro85I7472vJ4Wkpneo9A: mucks hand
FRkiRasEGlHUeLrEl+k/nA collected $30.50 from pot
*** SUMMARY ***
Total pot $31 | Rake $0.50
Board [Td 9s 6h 4s 5s]
Seat 1: FRkiRasEGlHUeLrEl+k/nA (button) (small blind) showed [8c 7h] and won ($30.50) with a straight, Six to Ten
Seat 2: 3Wro85I7472vJ4Wkpneo9A (big blind) mucked



PokerStars Game #59939508246:  Hold'em No Limit ($0.25/$0.50) - 2009/07/01 0:41:41 ET
Table 'c/CRn+68J3Y8KxD5g1ek2Q' 2-max Seat #1 is the button
Seat 1: 46qCyJ6evTkHo9al5sBMNA ($204.95 in chips)
Seat 2: BypVLsYQt3ePFm2xQL/dOA ($169.95 in chips)
46qCyJ6evTkHo9al5sBMNA: posts small blind $0.25
BypVLsYQt3ePFm2xQL/dOA: posts big blind $0.50
*** HOLE CARDS ***
46qCyJ6evTkHo9al5sBMNA: folds
BypVLsYQt3ePFm2xQL/dOA collected $0.50 from pot
BypVLsYQt3ePFm2xQL/dOA: doesn't show hand
*** SUMMARY ***
Total pot $0.50 | Rake $0
Seat 1: 46qCyJ6evTkHo9al5sBMNA (button) (small blind) folded before Flop
Seat 2: BypVLsYQt3ePFm2xQL/dOA (big blind) collected ($0.50)



PokerStars Game #59939508644:  Hold'em No Limit ($0.25/$0.50) - 2009/07/01 0:41:42 ET
Table '+111aLuBwnz8YVYSA7J1jA' 2-max Seat #1 is the button
Seat 1: ndd1nfncBkWNitBnsfCoVQ ($89.20 in chips)
Seat 2: +ciXH35zeafrjg1W6wiBTg ($62 in chips)
ndd1nfncBkWNitBnsfCoVQ: posts small blind $0.25
+ciXH35zeafrjg1W6wiBTg: posts big blind $0.50
*** HOLE CARDS ***
ndd1nfncBkWNitBnsfCoVQ: raises $1 to $1.50
+ciXH35zeafrjg1W6wiBTg: raises $2 to $3.50
ndd1nfncBkWNitBnsfCoVQ: calls $2
*** FLOP *** [Js Qh 9s]
+ciXH35zeafrjg1W6wiBTg: bets $4
ndd1nfncBkWNitBnsfCoVQ: folds
+ciXH35zeafrjg1W6wiBTg collected $6.65 from pot
+ciXH35zeafrjg1W6wiBTg: doesn't show hand
*** SUMMARY ***
Total pot $7 | Rake $0.35
Board [Js Qh 9s]
Seat 1: ndd1nfncBkWNitBnsfCoVQ (button) (small blind) folded on the Flop
Seat 2: +ciXH35zeafrjg1W6wiBTg (big blind) collected ($6.65)



PokerStars Game #59939508678:  Hold'em No Limit ($0.25/$0.50) - 2009/07/01 0:41:42 ET
Table '99gCy/CZQwPIjZWH+BguQgE7bWJ45aoFXRpyRv2gw+Igeat #9 is the button
Seat 2: n6VQBu6crjYjy6DxNP1NZA ($19.70 in chips)
Seat 3: qEn9ijNGtuyTxamBf07hYg ($50.75 in chips)
Seat 4: bxLSulbgr8LmKNjOzw8URg ($63.45 in chips)
Seat 5: DSM67hHHq1XFoEOi9p8Alw ($50 in chips)
Seat 7: 4dd+rKHhaMiTl5LEkADvQQ ($10.50 in chips)
Seat 8: 8ehL7qlZzjgUh2H35iiWLw ($50 in chips)
Seat 9: j3K/Jujr7PY4ZM2RZvlH6A ($85.65 in chips)
n6VQBu6crjYjy6DxNP1NZA: posts small blind $0.25
qEn9ijNGtuyTxamBf07hYg: posts big blind $0.50
*** HOLE CARDS ***
bxLSulbgr8LmKNjOzw8URg: folds
DSM67hHHq1XFoEOi9p8Alw: folds
4dd+rKHhaMiTl5LEkADvQQ: folds
8ehL7qlZzjgUh2H35iiWLw: folds
j3K/Jujr7PY4ZM2RZvlH6A: calls $0.50
n6VQBu6crjYjy6DxNP1NZA: folds
qEn9ijNGtuyTxamBf07hYg: checks
*** FLOP *** [Ad 5c Th]
qEn9ijNGtuyTxamBf07hYg: checks
j3K/Jujr7PY4ZM2RZvlH6A: bets $1
qEn9ijNGtuyTxamBf07hYg: folds
j3K/Jujr7PY4ZM2RZvlH6A collected $1.20 from pot
j3K/Jujr7PY4ZM2RZvlH6A: doesn't show hand
*** SUMMARY ***
Total pot $1.25 | Rake $0.05
Board [Ad 5c Th]
Seat 2: n6VQBu6crjYjy6DxNP1NZA (small blind) folded before Flop
Seat 3: qEn9ijNGtuyTxamBf07hYg (big blind) folded on the Flop
Seat 4: bxLSulbgr8LmKNjOzw8URg folded before Flop (didn't bet)
Seat 5: DSM67hHHq1XFoEOi9p8Alw folded before Flop (didn't bet)
Seat 7: 4dd+rKHhaMiTl5LEkADvQQ folded before Flop (didn't bet)
Seat 8: 8ehL7qlZzjgUh2H35iiWLw folded before Flop (didn't bet)
Seat 9: j3K/Jujr7PY4ZM2RZvlH6A (button) collected ($1.20)



PokerStars Game #59939510128:  Hold'em No Limit ($0.25/$0.50) - 2009/07/01 0:41:44 ET
Table 'EiNh8p/wGJ1FP575iMFnqg' 9-max Seat #3 is the button
Seat 1: r3ZqM1Mi0W3y4hOdssE+Sg ($49.40 in chips)
Seat 2: 8ehL7qlZzjgUh2H35iiWLw ($53.35 in chips)
Seat 3: ymLPoEIl7UL3TvZYmnadxQ ($48.60 in chips)
Seat 4: cMzaiXAM/ZAdNaEUu+LqhA ($50 in chips)
Seat 5: M+7+BTmX5vZatHVuoRB1nA ($85.35 in chips)
Seat 6: 3UmXLy3GfjC3EkOebduerQ ($55.40 in chips)
Seat 7: 997ViqAtWn1FPjJqcffwcA ($50 in chips)
Seat 8: KrPAGRACBg+w0M//SXe8Ag ($9.35 in chips)
cMzaiXAM/ZAdNaEUu+LqhA: posts small blind $0.25
M+7+BTmX5vZatHVuoRB1nA: posts big blind $0.50
NnQCepdIR/AOUQn1yhYx6Q: sits out
*** HOLE CARDS ***
3UmXLy3GfjC3EkOebduerQ: raises $1.50 to $2
997ViqAtWn1FPjJqcffwcA: folds
KrPAGRACBg+w0M//SXe8Ag: folds
r3ZqM1Mi0W3y4hOdssE+Sg: folds
8ehL7qlZzjgUh2H35iiWLw: folds
ymLPoEIl7UL3TvZYmnadxQ: folds
cMzaiXAM/ZAdNaEUu+LqhA: calls $1.75
M+7+BTmX5vZatHVuoRB1nA: calls $1.50
*** FLOP *** [Kd 4c 4h]
cMzaiXAM/ZAdNaEUu+LqhA: checks
M+7+BTmX5vZatHVuoRB1nA: checks
3UmXLy3GfjC3EkOebduerQ: bets $4
cMzaiXAM/ZAdNaEUu+LqhA: folds
M+7+BTmX5vZatHVuoRB1nA: calls $4
*** TURN *** [Kd 4c 4h] [3c]
M+7+BTmX5vZatHVuoRB1nA: checks
3UmXLy3GfjC3EkOebduerQ: bets $9
M+7+BTmX5vZatHVuoRB1nA: folds
3UmXLy3GfjC3EkOebduerQ collected $13.35 from pot
3UmXLy3GfjC3EkOebduerQ: doesn't show hand
*** SUMMARY ***
Total pot $14 | Rake $0.65
Board [Kd 4c 4h 3c]
Seat 1: r3ZqM1Mi0W3y4hOdssE+Sg folded before Flop (didn't bet)
Seat 2: 8ehL7qlZzjgUh2H35iiWLw folded before Flop (didn't bet)
Seat 3: ymLPoEIl7UL3TvZYmnadxQ (button) folded before Flop (didn't bet)
Seat 4: cMzaiXAM/ZAdNaEUu+LqhA (small blind) folded on the Flop
Seat 5: M+7+BTmX5vZatHVuoRB1nA (big blind) folded on the Turn
Seat 6: 3UmXLy3GfjC3EkOebduerQ collected ($13.35)
Seat 7: 997ViqAtWn1FPjJqcffwcA folded before Flop (didn't bet)
Seat 8: KrPAGRACBg+w0M//SXe8Ag folded before Flop (didn't bet)



PokerStars Game #59939509800:  Hold'em No Limit ($0.25/$0.50) - 2009/07/01 0:41:44 ET
Table 'lSisgp6H7Fg1hH5VfjEjYQ' 9-max Seat #7 is the button
Seat 2: UrcnkQOiLVk8BlKDPJSy7Q ($50 in chips)
Seat 3: aTkyjTh3w5YLWiIERupZOA ($41.70 in chips)
Seat 4: bwv/rbH/hHhPhY6u9mu04w ($43.50 in chips)
Seat 5: mSD1pginDsyHG5PDfqzphw ($11.35 in chips)
Seat 6: +k7T5ocke8UwavtgUHm+Cg ($29.30 in chips)
Seat 7: Y3DZ6qQlLeBhixDj4M9vmg ($10.80 in chips)
Seat 8: a4JDWmpFQkL10XfAyuF51A ($34.25 in chips)
Seat 9: gsyXT42WLEcOS4DdEk2wlw ($30 in chips)
a4JDWmpFQkL10XfAyuF51A: posts small blind $0.25
gsyXT42WLEcOS4DdEk2wlw: posts big blind $0.50
5k9fvXD9suIgCxU4HLQjTw: sits out
*** HOLE CARDS ***
UrcnkQOiLVk8BlKDPJSy7Q: folds
aTkyjTh3w5YLWiIERupZOA: folds
bwv/rbH/hHhPhY6u9mu04w: folds
mSD1pginDsyHG5PDfqzphw: folds
+k7T5ocke8UwavtgUHm+Cg: folds
Y3DZ6qQlLeBhixDj4M9vmg: folds
a4JDWmpFQkL10XfAyuF51A: calls $0.25
gsyXT42WLEcOS4DdEk2wlw: checks
*** FLOP *** [Js 2d 3d]
a4JDWmpFQkL10XfAyuF51A: checks
gsyXT42WLEcOS4DdEk2wlw: checks
*** TURN *** [Js 2d 3d] [5d]
a4JDWmpFQkL10XfAyuF51A: checks
gsyXT42WLEcOS4DdEk2wlw: checks
*** RIVER *** [Js 2d 3d 5d] [Qs]
a4JDWmpFQkL10XfAyuF51A: checks
gsyXT42WLEcOS4DdEk2wlw: checks
*** SHOW DOWN ***
a4JDWmpFQkL10XfAyuF51A: shows [4h Kc] (high card King)
gsyXT42WLEcOS4DdEk2wlw: shows [9h 2h] (a pair of Deuces)
gsyXT42WLEcOS4DdEk2wlw collected $0.95 from pot
*** SUMMARY ***
Total pot $1 | Rake $0.05
Board [Js 2d 3d 5d Qs]
Seat 2: UrcnkQOiLVk8BlKDPJSy7Q folded before Flop (didn't bet)
Seat 3: aTkyjTh3w5YLWiIERupZOA folded before Flop (didn't bet)
Seat 4: bwv/rbH/hHhPhY6u9mu04w folded before Flop (didn't bet)
Seat 5: mSD1pginDsyHG5PDfqzphw folded before Flop (didn't bet)
Seat 6: +k7T5ocke8UwavtgUHm+Cg folded before Flop (didn't bet)
Seat 7: Y3DZ6qQlLeBhixDj4M9vmg (button) folded before Flop (didn't bet)
Seat 8: a4JDWmpFQkL10XfAyuF51A (small blind) showed [4h Kc] and lost with high card King
Seat 9: gsyXT42WLEcOS4DdEk2wlw (big blind) showed [9h 2h] and won ($0.95) with a pair of Deuces



PokerStars Game #59939510706:  Hold'em No Limit ($0.25/$0.50) - 2009/07/01 0:41:45 ET
Table '+dXkOAQyS8j9PQZusUTMpg' 2-max Seat #2 is the button
Seat 1: XFa6sBGjP2gxoIvxR3fZIg ($52.70 in chips)
Seat 2: 5IBeOgaApY1Bvzv2P8X4EA ($152.45 in chips)
5IBeOgaApY1Bvzv2P8X4EA: posts small blind $0.25
XFa6sBGjP2gxoIvxR3fZIg: posts big blind $0.50
*** HOLE CARDS ***
5IBeOgaApY1Bvzv2P8X4EA: folds
XFa6sBGjP2gxoIvxR3fZIg collected $0.50 from pot
XFa6sBGjP2gxoIvxR3fZIg: doesn't show hand
*** SUMMARY ***
Total pot $0.50 | Rake $0
Seat 1: XFa6sBGjP2gxoIvxR3fZIg (big blind) collected ($0.50)
Seat 2: 5IBeOgaApY1Bvzv2P8X4EA (button) (small blind) folded before Flop



PokerStars Game #59939510978:  Hold'em No Limit ($0.25/$0.50) - 2009/07/01 0:41:46 ET
Table 'QOgaEqMcJ73pcUMMxoisUg' 6-max Seat #1 is the button
Seat 1: OZ6OtYh5Y53MCH/p0QTn5g ($63.65 in chips)
Seat 2: 4QfsCWthT/vSLirorNXqtg ($50 in chips)
Seat 3: Rt6KgtZ8YaJoTc3FPim00w ($77.50 in chips)
Seat 4: zAcsDhG/T128Vn7XGVSgKg ($50 in chips)
Seat 5: 6vNxrjjCl6FwfaaymM9jjg ($12 in chips)
Seat 6: pmE+2KJb4nffAVqjLIXxFg ($24.20 in chips)
4QfsCWthT/vSLirorNXqtg: posts small blind $0.25
Rt6KgtZ8YaJoTc3FPim00w: posts big blind $0.50
*** HOLE CARDS ***
zAcsDhG/T128Vn7XGVSgKg: folds
6vNxrjjCl6FwfaaymM9jjg: raises $2 to $2.50
pmE+2KJb4nffAVqjLIXxFg: folds
OZ6OtYh5Y53MCH/p0QTn5g: folds
4QfsCWthT/vSLirorNXqtg: folds
Rt6KgtZ8YaJoTc3FPim00w: folds
6vNxrjjCl6FwfaaymM9jjg collected $1.25 from pot
*** SUMMARY ***
Total pot $1.25 | Rake $0
Seat 1: OZ6OtYh5Y53MCH/p0QTn5g (button) folded before Flop (didn't bet)
Seat 2: 4QfsCWthT/vSLirorNXqtg (small blind) folded before Flop
Seat 3: Rt6KgtZ8YaJoTc3FPim00w (big blind) folded before Flop
Seat 4: zAcsDhG/T128Vn7XGVSgKg folded before Flop (didn't bet)
Seat 5: 6vNxrjjCl6FwfaaymM9jjg collected ($1.25)
Seat 6: pmE+2KJb4nffAVqjLIXxFg folded before Flop (didn't bet)



PokerStars Game #59939511884:  Hold'em No Limit ($0.25/$0.50) - 2009/07/01 0:41:47 ET
Table 'GfL/No5u5PoEnU39lP5pQg' 6-max Seat #2 is the button
Seat 1: 1WUCqNG+p+vfWRTXNu4ljw ($50.25 in chips)
Seat 2: uVwggSetzp7d+eVgowO3vg ($70.95 in chips)
Seat 3: Ek4w9XqBXqK5jBUQeLedGw ($51 in chips)
Seat 4: x+pzUFJsMIiGd7a5pcR4tg ($54.30 in chips)
Ek4w9XqBXqK5jBUQeLedGw: posts small blind $0.25
x+pzUFJsMIiGd7a5pcR4tg: posts big blind $0.50
M1KyQQvVPVuxqTAB8sR/zQ: sits out
*** HOLE CARDS ***
1WUCqNG+p+vfWRTXNu4ljw: folds
uVwggSetzp7d+eVgowO3vg: folds
Ek4w9XqBXqK5jBUQeLedGw: raises $1 to $1.50
x+pzUFJsMIiGd7a5pcR4tg: folds
Ek4w9XqBXqK5jBUQeLedGw collected $1 from pot
*** SUMMARY ***
Total pot $1 | Rake $0
Seat 1: 1WUCqNG+p+vfWRTXNu4ljw folded before Flop (didn't bet)
Seat 2: uVwggSetzp7d+eVgowO3vg (button) folded before Flop (didn't bet)
Seat 3: Ek4w9XqBXqK5jBUQeLedGw (small blind) collected ($1)
Seat 4: x+pzUFJsMIiGd7a5pcR4tg (big blind) folded before Flop



PokerStars Game #59939511648:  Hold'em No Limit ($0.25/$0.50) - 2009/07/01 0:41:47 ET
Table 'MJxeZCzYELxiIsyUZyT0jw' 6-max Seat #6 is the button
Seat 2: dB6jzDlJmET84VMWw1mTRA ($51 in chips)
Seat 3: JQZew0FjzS19kTjeNtrE+A ($50 in chips)
Seat 5: 3jvoOXNtXE90w2BdfNZwZQ ($52 in chips)
Seat 6: TTx3CHxyi0SObcHyMJRp5w ($59.20 in chips)
dB6jzDlJmET84VMWw1mTRA: posts small blind $0.25
JQZew0FjzS19kTjeNtrE+A: posts big blind $0.50
alGiiQP/wwtYnfuXII+sgw: sits out
*** HOLE CARDS ***
3jvoOXNtXE90w2BdfNZwZQ: folds
TTx3CHxyi0SObcHyMJRp5w: folds
dB6jzDlJmET84VMWw1mTRA: raises $1.50 to $2
JQZew0FjzS19kTjeNtrE+A: calls $1.50
*** FLOP *** [Qs 7d 5s]
tdOvWynovql5imfooroLMg leaves the table
dB6jzDlJmET84VMWw1mTRA: bets $2.50
JQZew0FjzS19kTjeNtrE+A: folds
dB6jzDlJmET84VMWw1mTRA collected $3.80 from pot
dB6jzDlJmET84VMWw1mTRA: doesn't show hand
*** SUMMARY ***
Total pot $4 | Rake $0.20
Board [Qs 7d 5s]
Seat 2: dB6jzDlJmET84VMWw1mTRA (small blind) collected ($3.80)
Seat 3: JQZew0FjzS19kTjeNtrE+A (big blind) folded on the Flop
Seat 5: 3jvoOXNtXE90w2BdfNZwZQ folded before Flop (didn't bet)
Seat 6: TTx3CHxyi0SObcHyMJRp5w (button) folded before Flop (didn't bet)



PokerStars Game #59939512844:  Hold'em No Limit ($0.25/$0.50) - 2009/07/01 0:41:49 ET
Table 'otvGDROEDdqsabxskT79qg' 9-max Seat #8 is the button
Seat 1: 8ehL7qlZzjgUh2H35iiWLw ($56 in chips)
Seat 2: cCjTzH9jio8607WzjcfXlg ($9.05 in chips)
Seat 3: +k7T5ocke8UwavtgUHm+Cg ($75.35 in chips)
Seat 4: MG90wfSJZnOejs/KD3vlQQ ($56.15 in chips)
Seat 5: XNMDwbXt/Q4jM99AXnbJDw ($54.80 in chips)
Seat 6: bxLSulbgr8LmKNjOzw8URg ($51.40 in chips)
Seat 7: C7+tBppJrKgd/r+tuKUIpA ($34.60 in chips)
Seat 8: zE9cVigS2nW/Ljy4K4bUQA ($30 in chips)
Seat 9: KcY3X8YpD74Kw1RHkx/g4A ($66.25 in chips)
KcY3X8YpD74Kw1RHkx/g4A: posts small blind $0.25
8ehL7qlZzjgUh2H35iiWLw: posts big blind $0.50
*** HOLE CARDS ***
cCjTzH9jio8607WzjcfXlg: folds
+k7T5ocke8UwavtgUHm+Cg: calls $0.50
MG90wfSJZnOejs/KD3vlQQ: folds
XNMDwbXt/Q4jM99AXnbJDw: calls $0.50
bxLSulbgr8LmKNjOzw8URg: folds
C7+tBppJrKgd/r+tuKUIpA has timed out
C7+tBppJrKgd/r+tuKUIpA: folds
C7+tBppJrKgd/r+tuKUIpA is sitting out
zE9cVigS2nW/Ljy4K4bUQA: folds
KcY3X8YpD74Kw1RHkx/g4A: folds
C7+tBppJrKgd/r+tuKUIpA has returned
8ehL7qlZzjgUh2H35iiWLw: checks
*** FLOP *** [7d Kd Tc]
8ehL7qlZzjgUh2H35iiWLw: checks
+k7T5ocke8UwavtgUHm+Cg: checks
XNMDwbXt/Q4jM99AXnbJDw: checks
*** TURN *** [7d Kd Tc] [4h]
8ehL7qlZzjgUh2H35iiWLw: checks
+k7T5ocke8UwavtgUHm+Cg: checks
XNMDwbXt/Q4jM99AXnbJDw: checks
*** RIVER *** [7d Kd Tc 4h] [Qh]
8ehL7qlZzjgUh2H35iiWLw: checks
+k7T5ocke8UwavtgUHm+Cg: checks
XNMDwbXt/Q4jM99AXnbJDw: checks
*** SHOW DOWN ***
8ehL7qlZzjgUh2H35iiWLw: shows [2s 2d] (a pair of Deuces)
+k7T5ocke8UwavtgUHm+Cg: shows [Qc Jd] (a pair of Queens)
XNMDwbXt/Q4jM99AXnbJDw: mucks hand
+k7T5ocke8UwavtgUHm+Cg collected $1.70 from pot
*** SUMMARY ***
Total pot $1.75 | Rake $0.05
Board [7d Kd Tc 4h Qh]
Seat 1: 8ehL7qlZzjgUh2H35iiWLw (big blind) showed [2s 2d] and lost with a pair of Deuces
Seat 2: cCjTzH9jio8607WzjcfXlg folded before Flop (didn't bet)
Seat 3: +k7T5ocke8UwavtgUHm+Cg showed [Qc Jd] and won ($1.70) with a pair of Queens
Seat 4: MG90wfSJZnOejs/KD3vlQQ folded before Flop (didn't bet)
Seat 5: XNMDwbXt/Q4jM99AXnbJDw mucked
Seat 6: bxLSulbgr8LmKNjOzw8URg folded before Flop (didn't bet)
Seat 7: C7+tBppJrKgd/r+tuKUIpA folded before Flop (didn't bet)
Seat 8: zE9cVigS2nW/Ljy4K4bUQA (button) folded before Flop (didn't bet)
Seat 9: KcY3X8YpD74Kw1RHkx/g4A (small blind) folded before Flop



PokerStars Game #59939514520:  Hold'em No Limit ($0.25/$0.50) - 2009/07/01 0:41:51 ET
Table '+dXkOAQyS8j9PQZusUTMpg' 2-max Seat #1 is the button
Seat 1: XFa6sBGjP2gxoIvxR3fZIg ($52.95 in chips)
Seat 2: 5IBeOgaApY1Bvzv2P8X4EA ($152.20 in chips)
XFa6sBGjP2gxoIvxR3fZIg: posts small blind $0.25
5IBeOgaApY1Bvzv2P8X4EA: posts big blind $0.50
*** HOLE CARDS ***
XFa6sBGjP2gxoIvxR3fZIg: raises $1 to $1.50
5IBeOgaApY1Bvzv2P8X4EA: raises $1.50 to $3
XFa6sBGjP2gxoIvxR3fZIg: calls $1.50
*** FLOP *** [2c 3c 7h]
5IBeOgaApY1Bvzv2P8X4EA: checks
XFa6sBGjP2gxoIvxR3fZIg: checks
*** TURN *** [2c 3c 7h] [2d]
5IBeOgaApY1Bvzv2P8X4EA: checks
XFa6sBGjP2gxoIvxR3fZIg: checks
*** RIVER *** [2c 3c 7h 2d] [Ad]
5IBeOgaApY1Bvzv2P8X4EA: bets $4.50
XFa6sBGjP2gxoIvxR3fZIg: folds
5IBeOgaApY1Bvzv2P8X4EA collected $5.70 from pot
5IBeOgaApY1Bvzv2P8X4EA: doesn't show hand
*** SUMMARY ***
Total pot $6 | Rake $0.30
Board [2c 3c 7h 2d Ad]
Seat 1: XFa6sBGjP2gxoIvxR3fZIg (button) (small blind) folded on the River
Seat 2: 5IBeOgaApY1Bvzv2P8X4EA (big blind) collected ($5.70)



PokerStars Game #59939514920:  Hold'em No Limit ($0.25/$0.50) - 2009/07/01 0:41:52 ET
Table 'c/CRn+68J3Y8KxD5g1ek2Q' 2-max Seat #2 is the button
Seat 1: 46qCyJ6evTkHo9al5sBMNA ($204.70 in chips)
Seat 2: BypVLsYQt3ePFm2xQL/dOA ($170.20 in chips)
BypVLsYQt3ePFm2xQL/dOA: posts small blind $0.25
46qCyJ6evTkHo9al5sBMNA: posts big blind $0.50
*** HOLE CARDS ***
BypVLsYQt3ePFm2xQL/dOA: calls $0.25
46qCyJ6evTkHo9al5sBMNA: checks
*** FLOP *** [7s 3c 3h]
46qCyJ6evTkHo9al5sBMNA: checks
BypVLsYQt3ePFm2xQL/dOA: bets $1.50
46qCyJ6evTkHo9al5sBMNA: raises $4.50 to $6
BypVLsYQt3ePFm2xQL/dOA: calls $4.50
*** TURN *** [7s 3c 3h] [8d]
46qCyJ6evTkHo9al5sBMNA: bets $9
BypVLsYQt3ePFm2xQL/dOA: calls $9
*** RIVER *** [7s 3c 3h 8d] [As]
46qCyJ6evTkHo9al5sBMNA: bets $21
BypVLsYQt3ePFm2xQL/dOA: folds
46qCyJ6evTkHo9al5sBMNA collected $30.50 from pot
46qCyJ6evTkHo9al5sBMNA: doesn't show hand
*** SUMMARY ***
Total pot $31 | Rake $0.50
Board [7s 3c 3h 8d As]
Seat 1: 46qCyJ6evTkHo9al5sBMNA (big blind) collected ($30.50)
Seat 2: BypVLsYQt3ePFm2xQL/dOA (button) (small blind) folded on the River



PokerStars Game #59939515830:  Hold'em No Limit ($0.25/$0.50) - 2009/07/01 0:41:53 ET
Table 'QOeVnLhwctF9UyV/beDi+A' 2-max Seat #2 is the button
Seat 1: bypIyrYcAAifLfhZpGlKLA ($64.95 in chips)
Seat 2: Ucrm3XtZmoONapW32SPhag ($19.65 in chips)
Ucrm3XtZmoONapW32SPhag: posts small blind $0.25
bypIyrYcAAifLfhZpGlKLA: posts big blind $0.50
*** HOLE CARDS ***
Ucrm3XtZmoONapW32SPhag: raises $0.50 to $1
bypIyrYcAAifLfhZpGlKLA: calls $0.50
*** FLOP *** [Td 2h Kd]
bypIyrYcAAifLfhZpGlKLA: checks
Ucrm3XtZmoONapW32SPhag: checks
*** TURN *** [Td 2h Kd] [3d]
bypIyrYcAAifLfhZpGlKLA: bets $1.50
Ucrm3XtZmoONapW32SPhag: raises $1.50 to $3
bypIyrYcAAifLfhZpGlKLA: folds
Ucrm3XtZmoONapW32SPhag collected $4.80 from pot
Ucrm3XtZmoONapW32SPhag: doesn't show hand
*** SUMMARY ***
Total pot $5 | Rake $0.20
Board [Td 2h Kd 3d]
Seat 1: bypIyrYcAAifLfhZpGlKLA (big blind) folded on the Turn
Seat 2: Ucrm3XtZmoONapW32SPhag (button) (small blind) collected ($4.80)



PokerStars Game #59939516096:  Hold'em No Limit ($0.25/$0.50) - 2009/07/01 0:41:54 ET
Table 'hWT2kq66tnKEpD26cia6fQ' 2-max Seat #2 is the button
Seat 1: q+vRKwm51mnr6kxX/161WQ ($40.35 in chips)
Seat 2: dkC7J+qbyqk0qCcmJbEPPw ($73.30 in chips)
dkC7J+qbyqk0qCcmJbEPPw: posts small blind $0.25
q+vRKwm51mnr6kxX/161WQ: posts big blind $0.50
*** HOLE CARDS ***
dkC7J+qbyqk0qCcmJbEPPw: folds
q+vRKwm51mnr6kxX/161WQ collected $0.50 from pot
q+vRKwm51mnr6kxX/161WQ: doesn't show hand
*** SUMMARY ***
Total pot $0.50 | Rake $0
Seat 1: q+vRKwm51mnr6kxX/161WQ (big blind) collected ($0.50)
Seat 2: dkC7J+qbyqk0qCcmJbEPPw (button) (small blind) folded before Flop



PokerStars Game #59939518418:  Hold'em No Limit ($0.25/$0.50) - 2009/07/01 0:41:57 ET
Table 'tyR5AZNKV8Aadbrnrnlg7g' 6-max Seat #5 is the button
Seat 1: R+KjpH/wSjDLhtIy9+edNA ($93.10 in chips)
Seat 2: BAjwVL+zKKd0s0fAWstzQQ ($24.10 in chips)
Seat 3: tdOvWynovql5imfooroLMg ($45.75 in chips)
Seat 4: Rt6KgtZ8YaJoTc3FPim00w ($131.65 in chips)
Seat 5: Ek4w9XqBXqK5jBUQeLedGw ($50 in chips)
Seat 6: ZKazl1hGaPiapDXincgi2Q ($11.90 in chips)
ZKazl1hGaPiapDXincgi2Q: posts small blind $0.25
R+KjpH/wSjDLhtIy9+edNA: posts big blind $0.50
*** HOLE CARDS ***
BAjwVL+zKKd0s0fAWstzQQ: calls $0.50
tdOvWynovql5imfooroLMg: folds
Rt6KgtZ8YaJoTc3FPim00w: folds
Ek4w9XqBXqK5jBUQeLedGw: folds
ZKazl1hGaPiapDXincgi2Q: calls $0.25
R+KjpH/wSjDLhtIy9+edNA: checks
*** FLOP *** [7s Kc Th]
ZKazl1hGaPiapDXincgi2Q: checks
R+KjpH/wSjDLhtIy9+edNA: checks
BAjwVL+zKKd0s0fAWstzQQ: checks
*** TURN *** [7s Kc Th] [2s]
ZKazl1hGaPiapDXincgi2Q: checks
R+KjpH/wSjDLhtIy9+edNA: checks
BAjwVL+zKKd0s0fAWstzQQ: checks
*** RIVER *** [7s Kc Th 2s] [Jc]
ZKazl1hGaPiapDXincgi2Q: bets $1
R+KjpH/wSjDLhtIy9+edNA: folds
BAjwVL+zKKd0s0fAWstzQQ: folds
ZKazl1hGaPiapDXincgi2Q collected $1.45 from pot
ZKazl1hGaPiapDXincgi2Q: doesn't show hand
*** SUMMARY ***
Total pot $1.50 | Rake $0.05
Board [7s Kc Th 2s Jc]
Seat 1: R+KjpH/wSjDLhtIy9+edNA (big blind) folded on the River
Seat 2: BAjwVL+zKKd0s0fAWstzQQ folded on the River
Seat 3: tdOvWynovql5imfooroLMg folded before Flop (didn't bet)
Seat 4: Rt6KgtZ8YaJoTc3FPim00w folded before Flop (didn't bet)
Seat 5: Ek4w9XqBXqK5jBUQeLedGw (button) folded before Flop (didn't bet)
Seat 6: ZKazl1hGaPiapDXincgi2Q (small blind) collected ($1.45)



PokerStars Game #59939518338:  Hold'em No Limit ($0.25/$0.50) - 2009/07/01 0:41:57 ET
Table 'fx6MqwfYAj/Rt86hBz2L3Q' 9-max Seat #8 is the button
Seat 1: SegjDnMxWMujiD57ESNL+g ($10 in chips)
Seat 2: C3rGXblctNcWI6JYPHhaEg ($7.50 in chips)
Seat 3: iadBi5AEt7gTBXbDSSnMYQ ($50.70 in chips)
Seat 4: gPEN9Zp33YTm/mu9/SYP1w ($21.70 in chips)
Seat 5: iAISe3dVeua8PUn2wwgDHw ($31.60 in chips)
Seat 6: 5k9fvXD9suIgCxU4HLQjTw ($50 in chips)
Seat 8: NnQCepdIR/AOUQn1yhYx6Q ($9.50 in chips)
Seat 9: HZkVla4kK2SI42CVrPZ/ig ($8.50 in chips)
HZkVla4kK2SI42CVrPZ/ig: posts small blind $0.25
SegjDnMxWMujiD57ESNL+g: posts big blind $0.50
iadBi5AEt7gTBXbDSSnMYQ said, "thx"
SKnJuWHScqetA/qG5p+wCg: sits out
*** HOLE CARDS ***
C3rGXblctNcWI6JYPHhaEg: raises $1 to $1.50
iadBi5AEt7gTBXbDSSnMYQ: folds
gPEN9Zp33YTm/mu9/SYP1w: folds
iAISe3dVeua8PUn2wwgDHw: raises $1 to $2.50
5k9fvXD9suIgCxU4HLQjTw: folds
NnQCepdIR/AOUQn1yhYx6Q: folds
HZkVla4kK2SI42CVrPZ/ig: folds
SegjDnMxWMujiD57ESNL+g: folds
C3rGXblctNcWI6JYPHhaEg: calls $1
*** FLOP *** [4s 6h 3s]
C3rGXblctNcWI6JYPHhaEg: bets $2
iAISe3dVeua8PUn2wwgDHw: raises $2 to $4
C3rGXblctNcWI6JYPHhaEg: calls $2
*** TURN *** [4s 6h 3s] [Td]
C3rGXblctNcWI6JYPHhaEg: bets $1 and is all-in
iAISe3dVeua8PUn2wwgDHw: calls $1
*** RIVER *** [4s 6h 3s Td] [8h]
*** SHOW DOWN ***
C3rGXblctNcWI6JYPHhaEg: shows [Js Ts] (a pair of Tens)
iAISe3dVeua8PUn2wwgDHw: mucks hand
C3rGXblctNcWI6JYPHhaEg collected $15 from pot
*** SUMMARY ***
Total pot $15.75 | Rake $0.75
Board [4s 6h 3s Td 8h]
Seat 1: SegjDnMxWMujiD57ESNL+g (big blind) folded before Flop
Seat 2: C3rGXblctNcWI6JYPHhaEg showed [Js Ts] and won ($15) with a pair of Tens
Seat 3: iadBi5AEt7gTBXbDSSnMYQ folded before Flop (didn't bet)
Seat 4: gPEN9Zp33YTm/mu9/SYP1w folded before Flop (didn't bet)
Seat 5: iAISe3dVeua8PUn2wwgDHw mucked
Seat 6: 5k9fvXD9suIgCxU4HLQjTw folded before Flop (didn't bet)
Seat 8: NnQCepdIR/AOUQn1yhYx6Q (button) folded before Flop (didn't bet)
Seat 9: HZkVla4kK2SI42CVrPZ/ig (small blind) folded before Flop



PokerStars Game #59939520432:  Hold'em No Limit ($0.25/$0.50) - 2009/07/01 0:41:58 ET
Table '5EmHi+fnatGQQShcNmzOZQ' 6-max Seat #2 is the button
Seat 1: +SZCX3+7lnuhHKIu+PP9rg ($31.10 in chips)
Seat 2: vXIHnZ+dv/hwSBxyvGw7bQ ($76.50 in chips)
Seat 3: L9qfLYXrczhAPd/VckgsWw ($80.25 in chips)
Seat 4: 1b+2BbjMN8qhR1WPqdE9VQ ($55.65 in chips)
Seat 5: kxPhs4ePFqMy52CInAJ2aw ($54.60 in chips)
Seat 6: 686aeHikcJlgKkSuIFdcXQ ($141.20 in chips)
L9qfLYXrczhAPd/VckgsWw: posts small blind $0.25
1b+2BbjMN8qhR1WPqdE9VQ: posts big blind $0.50
*** HOLE CARDS ***
kxPhs4ePFqMy52CInAJ2aw: raises $1.50 to $2
686aeHikcJlgKkSuIFdcXQ: folds
+SZCX3+7lnuhHKIu+PP9rg: folds
vXIHnZ+dv/hwSBxyvGw7bQ: folds
L9qfLYXrczhAPd/VckgsWw: folds
1b+2BbjMN8qhR1WPqdE9VQ: folds
kxPhs4ePFqMy52CInAJ2aw collected $1.25 from pot
kxPhs4ePFqMy52CInAJ2aw: doesn't show hand
*** SUMMARY ***
Total pot $1.25 | Rake $0
Seat 1: +SZCX3+7lnuhHKIu+PP9rg folded before Flop (didn't bet)
Seat 2: vXIHnZ+dv/hwSBxyvGw7bQ (button) folded before Flop (didn't bet)
Seat 3: L9qfLYXrczhAPd/VckgsWw (small blind) folded before Flop
Seat 4: 1b+2BbjMN8qhR1WPqdE9VQ (big blind) folded before Flop
Seat 5: kxPhs4ePFqMy52CInAJ2aw collected ($1.25)
Seat 6: 686aeHikcJlgKkSuIFdcXQ folded before Flop (didn't bet)



PokerStars Game #59939518944:  Hold'em No Limit ($0.25/$0.50) - 2009/07/01 0:41:58 ET
Table 'IeNZOZQ4T6oiaHqFeo6yIA' 2-max Seat #2 is the button
Seat 1: ndd1nfncBkWNitBnsfCoVQ ($50 in chips)
Seat 2: A91IUl5JaZROhtfCtnnwYw ($111.60 in chips)
A91IUl5JaZROhtfCtnnwYw: posts small blind $0.25
ndd1nfncBkWNitBnsfCoVQ: posts big blind $0.50
*** HOLE CARDS ***
A91IUl5JaZROhtfCtnnwYw: calls $0.25
ndd1nfncBkWNitBnsfCoVQ: checks
*** FLOP *** [4s Kd 3d]
ndd1nfncBkWNitBnsfCoVQ: bets $1
A91IUl5JaZROhtfCtnnwYw: raises $1 to $2
ndd1nfncBkWNitBnsfCoVQ: calls $1
*** TURN *** [4s Kd 3d] [4c]
ndd1nfncBkWNitBnsfCoVQ: checks
A91IUl5JaZROhtfCtnnwYw: bets $7
ndd1nfncBkWNitBnsfCoVQ: folds
A91IUl5JaZROhtfCtnnwYw collected $4.80 from pot
A91IUl5JaZROhtfCtnnwYw: doesn't show hand
*** SUMMARY ***
Total pot $5 | Rake $0.20
Board [4s Kd 3d 4c]
Seat 1: ndd1nfncBkWNitBnsfCoVQ (big blind) folded on the Turn
Seat 2: A91IUl5JaZROhtfCtnnwYw (button) (small blind) collected ($4.80)



PokerStars Game #59939521026:  Hold'em No Limit ($0.25/$0.50) - 2009/07/01 0:41:59 ET
Table '+111aLuBwnz8YVYSA7J1jA' 2-max Seat #2 is the button
Seat 1: ndd1nfncBkWNitBnsfCoVQ ($85.70 in chips)
Seat 2: +ciXH35zeafrjg1W6wiBTg ($65.15 in chips)
+ciXH35zeafrjg1W6wiBTg: posts small blind $0.25
ndd1nfncBkWNitBnsfCoVQ: posts big blind $0.50
*** HOLE CARDS ***
+ciXH35zeafrjg1W6wiBTg: raises $1 to $1.50
ndd1nfncBkWNitBnsfCoVQ: folds
+ciXH35zeafrjg1W6wiBTg collected $1 from pot
+ciXH35zeafrjg1W6wiBTg: doesn't show hand
*** SUMMARY ***
Total pot $1 | Rake $0
Seat 1: ndd1nfncBkWNitBnsfCoVQ (big blind) folded before Flop
Seat 2: +ciXH35zeafrjg1W6wiBTg (button) (small blind) collected ($1)



PokerStars Game #59939522822:  Hold'em No Limit ($0.25/$0.50) - 2009/07/01 0:42:02 ET
Table 'hWT2kq66tnKEpD26cia6fQ' 2-max Seat #1 is the button
Seat 1: q+vRKwm51mnr6kxX/161WQ ($40.60 in chips)
Seat 2: dkC7J+qbyqk0qCcmJbEPPw ($73.05 in chips)
q+vRKwm51mnr6kxX/161WQ: posts small blind $0.25
dkC7J+qbyqk0qCcmJbEPPw: posts big blind $0.50
*** HOLE CARDS ***
q+vRKwm51mnr6kxX/161WQ: raises $1 to $1.50
dkC7J+qbyqk0qCcmJbEPPw: raises $3.50 to $5
q+vRKwm51mnr6kxX/161WQ: calls $3.50
*** FLOP *** [Qc 4s 8c]
dkC7J+qbyqk0qCcmJbEPPw: checks
q+vRKwm51mnr6kxX/161WQ: bets $6
dkC7J+qbyqk0qCcmJbEPPw: folds
q+vRKwm51mnr6kxX/161WQ collected $9.50 from pot
q+vRKwm51mnr6kxX/161WQ: doesn't show hand
*** SUMMARY ***
Total pot $10 | Rake $0.50
Board [Qc 4s 8c]
Seat 1: q+vRKwm51mnr6kxX/161WQ (button) (small blind) collected ($9.50)
Seat 2: dkC7J+qbyqk0qCcmJbEPPw (big blind) folded on the Flop



PokerStars Game #59939524364:  Hold'em No Limit ($0.25/$0.50) - 2009/07/01 0:42:05 ET
Table 'QOgaEqMcJ73pcUMMxoisUgErOuyGLI5PT3G5MnpHgC/g Seat #4 is the button
Seat 1: L5e2lrPLQm1Pqx30IIZ/Fw ($10 in chips)
Seat 3: xZCXQSXlrZkp3pZizzVXCw ($50.50 in chips)
Seat 4: 3UmXLy3GfjC3EkOebduerQ ($50 in chips)
Seat 5: JwvquocWfhTVApN5t47LgA ($59.80 in chips)
Seat 6: zE9cVigS2nW/Ljy4K4bUQA ($30 in chips)
Seat 7: 90Wb75h3W1BRpbqVnuk8gw ($60.95 in chips)
Seat 8: g4k0NXISyLCqaSWZDBjfEg ($52.10 in chips)
Seat 9: J0W5D97jl5VLky+IoPvDeA ($57.90 in chips)
JwvquocWfhTVApN5t47LgA: posts small blind $0.25
zE9cVigS2nW/Ljy4K4bUQA: posts big blind $0.50
*** HOLE CARDS ***
90Wb75h3W1BRpbqVnuk8gw: folds
g4k0NXISyLCqaSWZDBjfEg: folds
J0W5D97jl5VLky+IoPvDeA: folds
L5e2lrPLQm1Pqx30IIZ/Fw: folds
xZCXQSXlrZkp3pZizzVXCw: folds
3UmXLy3GfjC3EkOebduerQ: folds
JwvquocWfhTVApN5t47LgA: folds
zE9cVigS2nW/Ljy4K4bUQA collected $0.50 from pot
zE9cVigS2nW/Ljy4K4bUQA: doesn't show hand
*** SUMMARY ***
Total pot $0.50 | Rake $0
Seat 1: L5e2lrPLQm1Pqx30IIZ/Fw folded before Flop (didn't bet)
Seat 3: xZCXQSXlrZkp3pZizzVXCw folded before Flop (didn't bet)
Seat 4: 3UmXLy3GfjC3EkOebduerQ (button) folded before Flop (didn't bet)
Seat 5: JwvquocWfhTVApN5t47LgA (small blind) folded before Flop
Seat 6: zE9cVigS2nW/Ljy4K4bUQA (big blind) collected ($0.50)
Seat 7: 90Wb75h3W1BRpbqVnuk8gw folded before Flop (didn't bet)
Seat 8: g4k0NXISyLCqaSWZDBjfEg folded before Flop (didn't bet)
Seat 9: J0W5D97jl5VLky+IoPvDeA folded before Flop (didn't bet)



PokerStars Game #59939524310:  Hold'em No Limit ($0.25/$0.50) - 2009/07/01 0:42:05 ET
Table 'GfL/No5u5PoEnU39lP5pQg' 6-max Seat #3 is the button
Seat 1: 1WUCqNG+p+vfWRTXNu4ljw ($50.25 in chips)
Seat 2: uVwggSetzp7d+eVgowO3vg ($70.95 in chips)
Seat 3: Ek4w9XqBXqK5jBUQeLedGw ($51.50 in chips)
Seat 4: x+pzUFJsMIiGd7a5pcR4tg ($53.80 in chips)
Seat 5: M1KyQQvVPVuxqTAB8sR/zQ ($50 in chips)
x+pzUFJsMIiGd7a5pcR4tg: posts small blind $0.25
M1KyQQvVPVuxqTAB8sR/zQ: posts big blind $0.50
*** HOLE CARDS ***
1WUCqNG+p+vfWRTXNu4ljw: folds
uVwggSetzp7d+eVgowO3vg: folds
Ek4w9XqBXqK5jBUQeLedGw: folds
x+pzUFJsMIiGd7a5pcR4tg: folds
M1KyQQvVPVuxqTAB8sR/zQ collected $0.50 from pot
M1KyQQvVPVuxqTAB8sR/zQ: doesn't show hand
*** SUMMARY ***
Total pot $0.50 | Rake $0
Seat 1: 1WUCqNG+p+vfWRTXNu4ljw folded before Flop (didn't bet)
Seat 2: uVwggSetzp7d+eVgowO3vg folded before Flop (didn't bet)
Seat 3: Ek4w9XqBXqK5jBUQeLedGw (button) folded before Flop (didn't bet)
Seat 4: x+pzUFJsMIiGd7a5pcR4tg (small blind) folded before Flop
Seat 5: M1KyQQvVPVuxqTAB8sR/zQ (big blind) collected ($0.50)



PokerStars Game #59939524270:  Hold'em No Limit ($0.25/$0.50) - 2009/07/01 0:42:05 ET
Table '37qXEp3oe+er5q4CZip9eQ' 6-max Seat #6 is the button
Seat 1: oqOqoO2AyCZenUghCxMDxw ($58.95 in chips)
Seat 2: 6wzJiRvp8HY6t+MQGnSIzA ($26.45 in chips)
Seat 3: Rt6KgtZ8YaJoTc3FPim00w ($73 in chips)
Seat 4: XsmE8nXMAAMFJbWaJTmHFw ($30.20 in chips)
Seat 6: N50kln4negd8q7Mmoz1j4g ($21.35 in chips)
oqOqoO2AyCZenUghCxMDxw: posts small blind $0.25
6wzJiRvp8HY6t+MQGnSIzA: posts big blind $0.50
*** HOLE CARDS ***
Rt6KgtZ8YaJoTc3FPim00w: folds
XsmE8nXMAAMFJbWaJTmHFw: folds
N50kln4negd8q7Mmoz1j4g: folds
oqOqoO2AyCZenUghCxMDxw: calls $0.25
6wzJiRvp8HY6t+MQGnSIzA: checks
*** FLOP *** [Ah 2s Qh]
oqOqoO2AyCZenUghCxMDxw: checks
6wzJiRvp8HY6t+MQGnSIzA: checks
*** TURN *** [Ah 2s Qh] [9h]
oqOqoO2AyCZenUghCxMDxw: bets $0.50
6wzJiRvp8HY6t+MQGnSIzA: folds
oqOqoO2AyCZenUghCxMDxw collected $0.95 from pot
*** SUMMARY ***
Total pot $1 | Rake $0.05
Board [Ah 2s Qh 9h]
Seat 1: oqOqoO2AyCZenUghCxMDxw (small blind) collected ($0.95)
Seat 2: 6wzJiRvp8HY6t+MQGnSIzA (big blind) folded on the Turn
Seat 3: Rt6KgtZ8YaJoTc3FPim00w folded before Flop (didn't bet)
Seat 4: XsmE8nXMAAMFJbWaJTmHFw folded before Flop (didn't bet)
Seat 6: N50kln4negd8q7Mmoz1j4g (button) folded before Flop (didn't bet)



PokerStars Game #59939525764:  Hold'em No Limit ($0.25/$0.50) - 2009/07/01 0:42:07 ET
Table '+111aLuBwnz8YVYSA7J1jA' 2-max Seat #1 is the button
Seat 1: ndd1nfncBkWNitBnsfCoVQ ($85.20 in chips)
Seat 2: +ciXH35zeafrjg1W6wiBTg ($65.65 in chips)
ndd1nfncBkWNitBnsfCoVQ: posts small blind $0.25
+ciXH35zeafrjg1W6wiBTg: posts big blind $0.50
*** HOLE CARDS ***
ndd1nfncBkWNitBnsfCoVQ: raises $1 to $1.50
+ciXH35zeafrjg1W6wiBTg: folds
ndd1nfncBkWNitBnsfCoVQ collected $1 from pot
ndd1nfncBkWNitBnsfCoVQ: doesn't show hand
*** SUMMARY ***
Total pot $1 | Rake $0
Seat 1: ndd1nfncBkWNitBnsfCoVQ (button) (small blind) collected ($1)
Seat 2: +ciXH35zeafrjg1W6wiBTg (big blind) folded before Flop



PokerStars Game #59939526390:  Hold'em No Limit ($0.25/$0.50) - 2009/07/01 0:42:08 ET
Table 'BCN5su+SsXiy1zRMJi0SJw' 6-max Seat #2 is the button
Seat 1: crjGpJEzSZgD38FoE3VMGg ($50 in chips)
Seat 2: oU2kDCkT/gilYbHWrg7D8w ($13.65 in chips)
Seat 3: g+vwI6lMKpU2uteXSjOzVw ($19.55 in chips)
Seat 4: JY9CtoZTeav+mhWyxSSyJQ ($26.90 in chips)
Seat 5: IBNygaT1aa9Z1uPdJJilwA ($64 in chips)
Seat 6: b2symlOdL7+0c9Pj4N/KlA ($50 in chips)
g+vwI6lMKpU2uteXSjOzVw: posts small blind $0.25
JY9CtoZTeav+mhWyxSSyJQ: posts big blind $0.50
*** HOLE CARDS ***
IBNygaT1aa9Z1uPdJJilwA: folds
b2symlOdL7+0c9Pj4N/KlA: folds
crjGpJEzSZgD38FoE3VMGg: folds
oU2kDCkT/gilYbHWrg7D8w: folds
g+vwI6lMKpU2uteXSjOzVw: folds
JY9CtoZTeav+mhWyxSSyJQ collected $0.50 from pot
JY9CtoZTeav+mhWyxSSyJQ: doesn't show hand
*** SUMMARY ***
Total pot $0.50 | Rake $0
Seat 1: crjGpJEzSZgD38FoE3VMGg folded before Flop (didn't bet)
Seat 2: oU2kDCkT/gilYbHWrg7D8w (button) folded before Flop (didn't bet)
Seat 3: g+vwI6lMKpU2uteXSjOzVw (small blind) folded before Flop
Seat 4: JY9CtoZTeav+mhWyxSSyJQ (big blind) collected ($0.50)
Seat 5: IBNygaT1aa9Z1uPdJJilwA folded before Flop (didn't bet)
Seat 6: b2symlOdL7+0c9Pj4N/KlA folded before Flop (didn't bet)



PokerStars Game #59939527178:  Hold'em No Limit ($0.25/$0.50) - 2009/07/01 0:42:09 ET
Table 'ibNfFy0bCzuBaUORla0aGw' 9-max Seat #4 is the button
Seat 1: xZCXQSXlrZkp3pZizzVXCw ($53.20 in chips)
Seat 2: 90Wb75h3W1BRpbqVnuk8gw ($58.90 in chips)
Seat 3: dDaHs3X8+fe3bIkRU0cbrw ($40.15 in chips)
Seat 4: YBN054X4blmis+B2bBlC0g ($23.45 in chips)
Seat 5: GIJAc9kPrLZHLSX8Q6i99w ($25.45 in chips)
Seat 6: 8n9jQLh3cZKbsmr5PIjgiQ ($36.50 in chips)
Seat 7: HZkVla4kK2SI42CVrPZ/ig ($11.75 in chips)
Seat 8: xUrN9TWLq4m5V+OXY7KUUA ($51.25 in chips)
Seat 9: pFtzb1sR4b0d1aw6aIRgDg ($50.75 in chips)
GIJAc9kPrLZHLSX8Q6i99w: posts small blind $0.25
8n9jQLh3cZKbsmr5PIjgiQ: posts big blind $0.50
*** HOLE CARDS ***
HZkVla4kK2SI42CVrPZ/ig: calls $0.50
xUrN9TWLq4m5V+OXY7KUUA: raises $1.50 to $2
pFtzb1sR4b0d1aw6aIRgDg: folds
xZCXQSXlrZkp3pZizzVXCw: folds
90Wb75h3W1BRpbqVnuk8gw: folds
dDaHs3X8+fe3bIkRU0cbrw: folds
YBN054X4blmis+B2bBlC0g: folds
GIJAc9kPrLZHLSX8Q6i99w: folds
8n9jQLh3cZKbsmr5PIjgiQ: folds
HZkVla4kK2SI42CVrPZ/ig: calls $1.50
*** FLOP *** [5d 5c 3c]
HZkVla4kK2SI42CVrPZ/ig: checks
xUrN9TWLq4m5V+OXY7KUUA: checks
*** TURN *** [5d 5c 3c] [Ah]
HZkVla4kK2SI42CVrPZ/ig: bets $2.50
xUrN9TWLq4m5V+OXY7KUUA: folds
HZkVla4kK2SI42CVrPZ/ig collected $4.55 from pot
*** SUMMARY ***
Total pot $4.75 | Rake $0.20
Board [5d 5c 3c Ah]
Seat 1: xZCXQSXlrZkp3pZizzVXCw folded before Flop (didn't bet)
Seat 2: 90Wb75h3W1BRpbqVnuk8gw folded before Flop (didn't bet)
Seat 3: dDaHs3X8+fe3bIkRU0cbrw folded before Flop (didn't bet)
Seat 4: YBN054X4blmis+B2bBlC0g (button) folded before Flop (didn't bet)
Seat 5: GIJAc9kPrLZHLSX8Q6i99w (small blind) folded before Flop
Seat 6: 8n9jQLh3cZKbsmr5PIjgiQ (big blind) folded before Flop
Seat 7: HZkVla4kK2SI42CVrPZ/ig collected ($4.55)
Seat 8: xUrN9TWLq4m5V+OXY7KUUA folded on the Turn
Seat 9: pFtzb1sR4b0d1aw6aIRgDg folded before Flop (didn't bet)



PokerStars Game #59939529580:  Hold'em No Limit ($0.25/$0.50) - 2009/07/01 0:42:13 ET
Table 'hSTs/dUsYLgJQuF2Onp0MQ' 6-max Seat #3 is the button
Seat 2: 6vNxrjjCl6FwfaaymM9jjg ($37.50 in chips)
Seat 3: C3qJBo7uxfFVDluE1lmK2w ($33.20 in chips)
Seat 4: L0aIPg7qefDQjdJo3HCVEA ($7.80 in chips)
Seat 5: 686aeHikcJlgKkSuIFdcXQ ($62.95 in chips)
Seat 6: w0pd++ZQHijd9dDhKEYOAQ ($30.40 in chips)
L0aIPg7qefDQjdJo3HCVEA: posts small blind $0.25
686aeHikcJlgKkSuIFdcXQ: posts big blind $0.50
1WUCqNG+p+vfWRTXNu4ljw: sits out
*** HOLE CARDS ***
w0pd++ZQHijd9dDhKEYOAQ: folds
6vNxrjjCl6FwfaaymM9jjg: calls $0.50
C3qJBo7uxfFVDluE1lmK2w: calls $0.50
L0aIPg7qefDQjdJo3HCVEA: folds
686aeHikcJlgKkSuIFdcXQ: checks
*** FLOP *** [7d Kh Qc]
686aeHikcJlgKkSuIFdcXQ: bets $1.50
6vNxrjjCl6FwfaaymM9jjg: calls $1.50
C3qJBo7uxfFVDluE1lmK2w: raises $3 to $4.50
686aeHikcJlgKkSuIFdcXQ: folds
6vNxrjjCl6FwfaaymM9jjg: calls $3
*** TURN *** [7d Kh Qc] [Th]
6vNxrjjCl6FwfaaymM9jjg: checks
C3qJBo7uxfFVDluE1lmK2w: bets $6
6vNxrjjCl6FwfaaymM9jjg: raises $26.50 to $32.50 and is all-in
C3qJBo7uxfFVDluE1lmK2w: calls $22.20 and is all-in
*** RIVER *** [7d Kh Qc Th] [5h]
*** SHOW DOWN ***
6vNxrjjCl6FwfaaymM9jjg: shows [Qd Td] (two pair, Queens and Tens)
C3qJBo7uxfFVDluE1lmK2w: shows [Ks 7h] (two pair, Kings and Sevens)
C3qJBo7uxfFVDluE1lmK2w collected $66.65 from pot
*** SUMMARY ***
Total pot $68.65 | Rake $2
Board [7d Kh Qc Th 5h]
Seat 2: 6vNxrjjCl6FwfaaymM9jjg showed [Qd Td] and lost with two pair, Queens and Tens
Seat 3: C3qJBo7uxfFVDluE1lmK2w (button) showed [Ks 7h] and won ($66.65) with two pair, Kings and Sevens
Seat 4: L0aIPg7qefDQjdJo3HCVEA (small blind) folded before Flop
Seat 5: 686aeHikcJlgKkSuIFdcXQ (big blind) folded on the Flop
Seat 6: w0pd++ZQHijd9dDhKEYOAQ folded before Flop (didn't bet)



PokerStars Game #59939529670:  Hold'em No Limit ($0.25/$0.50) - 2009/07/01 0:42:13 ET
Table '3FhG0gl3kMX3wBEEqj+wnQ' 9-max Seat #4 is the button
Seat 1: e0J9pdCNUDTCG031RnXqLA ($23.40 in chips)
Seat 2: 7cYQ+syUWjl38ty/ICOMhw ($47.85 in chips)
Seat 4: bjvJtA9Hqscfznq66txaOQ ($8.50 in chips)
Seat 5: gsyXT42WLEcOS4DdEk2wlw ($28.25 in chips)
Seat 6: 997ViqAtWn1FPjJqcffwcA ($50 in chips)
Seat 7: mSD1pginDsyHG5PDfqzphw ($10 in chips)
Seat 8: j3K/Jujr7PY4ZM2RZvlH6A ($48.05 in chips)
Seat 9: L5e2lrPLQm1Pqx30IIZ/Fw ($10.75 in chips)
gsyXT42WLEcOS4DdEk2wlw: posts small blind $0.25
997ViqAtWn1FPjJqcffwcA: posts big blind $0.50
*** HOLE CARDS ***
mSD1pginDsyHG5PDfqzphw: folds
j3K/Jujr7PY4ZM2RZvlH6A: raises $1 to $1.50
L5e2lrPLQm1Pqx30IIZ/Fw: folds
e0J9pdCNUDTCG031RnXqLA: folds
7cYQ+syUWjl38ty/ICOMhw: folds
bjvJtA9Hqscfznq66txaOQ: folds
gsyXT42WLEcOS4DdEk2wlw: folds
997ViqAtWn1FPjJqcffwcA: folds
j3K/Jujr7PY4ZM2RZvlH6A collected $1.25 from pot
j3K/Jujr7PY4ZM2RZvlH6A: doesn't show hand
*** SUMMARY ***
Total pot $1.25 | Rake $0
Seat 1: e0J9pdCNUDTCG031RnXqLA folded before Flop (didn't bet)
Seat 2: 7cYQ+syUWjl38ty/ICOMhw folded before Flop (didn't bet)
Seat 4: bjvJtA9Hqscfznq66txaOQ (button) folded before Flop (didn't bet)
Seat 5: gsyXT42WLEcOS4DdEk2wlw (small blind) folded before Flop
Seat 6: 997ViqAtWn1FPjJqcffwcA (big blind) folded before Flop
Seat 7: mSD1pginDsyHG5PDfqzphw folded before Flop (didn't bet)
Seat 8: j3K/Jujr7PY4ZM2RZvlH6A collected ($1.25)
Seat 9: L5e2lrPLQm1Pqx30IIZ/Fw folded before Flop (didn't bet)



PokerStars Game #59939530210:  Hold'em No Limit ($0.25/$0.50) - 2009/07/01 0:42:14 ET
Table '+111aLuBwnz8YVYSA7J1jA' 2-max Seat #2 is the button
Seat 1: ndd1nfncBkWNitBnsfCoVQ ($85.70 in chips)
Seat 2: +ciXH35zeafrjg1W6wiBTg ($65.15 in chips)
+ciXH35zeafrjg1W6wiBTg: posts small blind $0.25
ndd1nfncBkWNitBnsfCoVQ: posts big blind $0.50
*** HOLE CARDS ***
+ciXH35zeafrjg1W6wiBTg: raises $1 to $1.50
ndd1nfncBkWNitBnsfCoVQ: folds
+ciXH35zeafrjg1W6wiBTg collected $1 from pot
+ciXH35zeafrjg1W6wiBTg: doesn't show hand
*** SUMMARY ***
Total pot $1 | Rake $0
Seat 1: ndd1nfncBkWNitBnsfCoVQ (big blind) folded before Flop
Seat 2: +ciXH35zeafrjg1W6wiBTg (button) (small blind) collected ($1)



PokerStars Game #59939531290:  Hold'em No Limit ($0.25/$0.50) - 2009/07/01 0:42:16 ET
Table '+dXkOAQyS8j9PQZusUTMpg' 2-max Seat #2 is the button
Seat 1: XFa6sBGjP2gxoIvxR3fZIg ($49.95 in chips)
Seat 2: 5IBeOgaApY1Bvzv2P8X4EA ($154.90 in chips)
5IBeOgaApY1Bvzv2P8X4EA: posts small blind $0.25
XFa6sBGjP2gxoIvxR3fZIg: posts big blind $0.50
*** HOLE CARDS ***
5IBeOgaApY1Bvzv2P8X4EA: calls $0.25
XFa6sBGjP2gxoIvxR3fZIg: checks
*** FLOP *** [Ad 3c Td]
XFa6sBGjP2gxoIvxR3fZIg: checks
5IBeOgaApY1Bvzv2P8X4EA: checks
*** TURN *** [Ad 3c Td] [7c]
XFa6sBGjP2gxoIvxR3fZIg: checks
5IBeOgaApY1Bvzv2P8X4EA: bets $1
XFa6sBGjP2gxoIvxR3fZIg: folds
5IBeOgaApY1Bvzv2P8X4EA collected $0.95 from pot
5IBeOgaApY1Bvzv2P8X4EA: doesn't show hand
*** SUMMARY ***
Total pot $1 | Rake $0.05
Board [Ad 3c Td 7c]
Seat 1: XFa6sBGjP2gxoIvxR3fZIg (big blind) folded on the Turn
Seat 2: 5IBeOgaApY1Bvzv2P8X4EA (button) (small blind) collected ($0.95)



PokerStars Game #59939532380:  Hold'em No Limit ($0.25/$0.50) - 2009/07/01 0:42:17 ET
Table 'NCiXr0d5CEKBQr/cZgLhbA' 9-max Seat #4 is the button
Seat 1: pFtzb1sR4b0d1aw6aIRgDg ($50 in chips)
Seat 2: ulxuJchBV9iguXg0FUonfg ($49.75 in chips)
Seat 3: xZCXQSXlrZkp3pZizzVXCw ($50.75 in chips)
Seat 4: 5k9fvXD9suIgCxU4HLQjTw ($56.70 in chips)
Seat 5: zE9cVigS2nW/Ljy4K4bUQA ($36.95 in chips)
Seat 6: SKnJuWHScqetA/qG5p+wCg ($30 in chips)
Seat 7: M+7+BTmX5vZatHVuoRB1nA ($46 in chips)
Seat 8: 1MJUKc3cc0QmUoz1JZLR2w ($56.50 in chips)
Seat 9: 4WLZvqBn5qv5tds5kt5A1Q ($48.05 in chips)
zE9cVigS2nW/Ljy4K4bUQA: posts small blind $0.25
SKnJuWHScqetA/qG5p+wCg: posts big blind $0.50
*** HOLE CARDS ***
M+7+BTmX5vZatHVuoRB1nA: folds
1MJUKc3cc0QmUoz1JZLR2w: folds
4WLZvqBn5qv5tds5kt5A1Q: folds
pFtzb1sR4b0d1aw6aIRgDg: folds
ulxuJchBV9iguXg0FUonfg: folds
xZCXQSXlrZkp3pZizzVXCw: folds
5k9fvXD9suIgCxU4HLQjTw: folds
zE9cVigS2nW/Ljy4K4bUQA: folds
SKnJuWHScqetA/qG5p+wCg collected $0.50 from pot
*** SUMMARY ***
Total pot $0.50 | Rake $0
Seat 1: pFtzb1sR4b0d1aw6aIRgDg folded before Flop (didn't bet)
Seat 2: ulxuJchBV9iguXg0FUonfg folded before Flop (didn't bet)
Seat 3: xZCXQSXlrZkp3pZizzVXCw folded before Flop (didn't bet)
Seat 4: 5k9fvXD9suIgCxU4HLQjTw (button) folded before Flop (didn't bet)
Seat 5: zE9cVigS2nW/Ljy4K4bUQA (small blind) folded before Flop
Seat 6: SKnJuWHScqetA/qG5p+wCg (big blind) collected ($0.50)
Seat 7: M+7+BTmX5vZatHVuoRB1nA folded before Flop (didn't bet)
Seat 8: 1MJUKc3cc0QmUoz1JZLR2w folded before Flop (didn't bet)
Seat 9: 4WLZvqBn5qv5tds5kt5A1Q folded before Flop (didn't bet)



PokerStars Game #59939532894:  Hold'em No Limit ($0.25/$0.50) - 2009/07/01 0:42:18 ET
Table 'QOgaEqMcJ73pcUMMxoisUg' 6-max Seat #2 is the button
Seat 1: OZ6OtYh5Y53MCH/p0QTn5g ($63.65 in chips)
Seat 2: 4QfsCWthT/vSLirorNXqtg ($50 in chips)
Seat 3: Rt6KgtZ8YaJoTc3FPim00w ($77 in chips)
Seat 4: zAcsDhG/T128Vn7XGVSgKg ($50 in chips)
Seat 5: 6vNxrjjCl6FwfaaymM9jjg ($12.75 in chips)
Seat 6: pmE+2KJb4nffAVqjLIXxFg ($24.20 in chips)
Rt6KgtZ8YaJoTc3FPim00w: posts small blind $0.25
zAcsDhG/T128Vn7XGVSgKg: posts big blind $0.50
*** HOLE CARDS ***
6vNxrjjCl6FwfaaymM9jjg: folds
pmE+2KJb4nffAVqjLIXxFg: folds
OZ6OtYh5Y53MCH/p0QTn5g: raises $1 to $1.50
4QfsCWthT/vSLirorNXqtg: folds
Rt6KgtZ8YaJoTc3FPim00w: folds
zAcsDhG/T128Vn7XGVSgKg: raises $4 to $5.50
OZ6OtYh5Y53MCH/p0QTn5g: calls $4
*** FLOP *** [Jc Tc 4d]
zAcsDhG/T128Vn7XGVSgKg: bets $7
OZ6OtYh5Y53MCH/p0QTn5g: raises $10.50 to $17.50
zAcsDhG/T128Vn7XGVSgKg: raises $27 to $44.50 and is all-in
OZ6OtYh5Y53MCH/p0QTn5g: calls $27
*** TURN *** [Jc Tc 4d] [6h]
*** RIVER *** [Jc Tc 4d 6h] [6c]
*** SHOW DOWN ***
zAcsDhG/T128Vn7XGVSgKg: shows [Ac Qh] (a pair of Sixes)
OZ6OtYh5Y53MCH/p0QTn5g: shows [Js Ad] (two pair, Jacks and Sixes)
OZ6OtYh5Y53MCH/p0QTn5g collected $97.25 from pot
*** SUMMARY ***
Total pot $100.25 | Rake $3
Board [Jc Tc 4d 6h 6c]
Seat 1: OZ6OtYh5Y53MCH/p0QTn5g showed [Js Ad] and won ($97.25) with two pair, Jacks and Sixes
Seat 2: 4QfsCWthT/vSLirorNXqtg (button) folded before Flop (didn't bet)
Seat 3: Rt6KgtZ8YaJoTc3FPim00w (small blind) folded before Flop
Seat 4: zAcsDhG/T128Vn7XGVSgKg (big blind) showed [Ac Qh] and lost with a pair of Sixes
Seat 5: 6vNxrjjCl6FwfaaymM9jjg folded before Flop (didn't bet)
Seat 6: pmE+2KJb4nffAVqjLIXxFg folded before Flop (didn't bet)



PokerStars Game #59939534422:  Hold'em No Limit ($0.25/$0.50) - 2009/07/01 0:42:20 ET
Table 'BCN5su+SsXiy1zRMJi0SJw' 6-max Seat #3 is the button
Seat 1: crjGpJEzSZgD38FoE3VMGg ($50 in chips)
Seat 2: oU2kDCkT/gilYbHWrg7D8w ($13.65 in chips)
Seat 3: g+vwI6lMKpU2uteXSjOzVw ($19.30 in chips)
Seat 4: JY9CtoZTeav+mhWyxSSyJQ ($27.15 in chips)
Seat 5: IBNygaT1aa9Z1uPdJJilwA ($64 in chips)
Seat 6: b2symlOdL7+0c9Pj4N/KlA ($50 in chips)
JY9CtoZTeav+mhWyxSSyJQ: posts small blind $0.25
IBNygaT1aa9Z1uPdJJilwA: posts big blind $0.50
*** HOLE CARDS ***
b2symlOdL7+0c9Pj4N/KlA: folds
crjGpJEzSZgD38FoE3VMGg: folds
oU2kDCkT/gilYbHWrg7D8w: folds
g+vwI6lMKpU2uteXSjOzVw: folds
JY9CtoZTeav+mhWyxSSyJQ: folds
IBNygaT1aa9Z1uPdJJilwA collected $0.50 from pot
*** SUMMARY ***
Total pot $0.50 | Rake $0
Seat 1: crjGpJEzSZgD38FoE3VMGg folded before Flop (didn't bet)
Seat 2: oU2kDCkT/gilYbHWrg7D8w folded before Flop (didn't bet)
Seat 3: g+vwI6lMKpU2uteXSjOzVw (button) folded before Flop (didn't bet)
Seat 4: JY9CtoZTeav+mhWyxSSyJQ (small blind) folded before Flop
Seat 5: IBNygaT1aa9Z1uPdJJilwA (big blind) collected ($0.50)
Seat 6: b2symlOdL7+0c9Pj4N/KlA folded before Flop (didn't bet)



PokerStars Game #59939534134:  Hold'em No Limit ($0.25/$0.50) - 2009/07/01 0:42:20 ET
Table 'E7bWJ45aoFXRpyRv2gw+Ig' 2-max Seat #2 is the button
Seat 1: FRkiRasEGlHUeLrEl+k/nA ($71.10 in chips)
Seat 2: 3Wro85I7472vJ4Wkpneo9A ($125.30 in chips)
3Wro85I7472vJ4Wkpneo9A: posts small blind $0.25
FRkiRasEGlHUeLrEl+k/nA: posts big blind $0.50
*** HOLE CARDS ***
3Wro85I7472vJ4Wkpneo9A: raises $1 to $1.50
FRkiRasEGlHUeLrEl+k/nA: calls $1
*** FLOP *** [9c 2d 9d]
FRkiRasEGlHUeLrEl+k/nA: checks
3Wro85I7472vJ4Wkpneo9A: bets $2
FRkiRasEGlHUeLrEl+k/nA: folds
3Wro85I7472vJ4Wkpneo9A collected $2.85 from pot
3Wro85I7472vJ4Wkpneo9A: doesn't show hand
*** SUMMARY ***
Total pot $3 | Rake $0.15
Board [9c 2d 9d]
Seat 1: FRkiRasEGlHUeLrEl+k/nA (big blind) folded on the Flop
Seat 2: 3Wro85I7472vJ4Wkpneo9A (button) (small blind) collected ($2.85)



PokerStars Game #59939534344:  Hold'em No Limit ($0.25/$0.50) - 2009/07/01 0:42:20 ET
Table 'QOeVnLhwctF9UyV/beDi+A' 2-max Seat #1 is the button
Seat 1: bypIyrYcAAifLfhZpGlKLA ($62.45 in chips)
Seat 2: Ucrm3XtZmoONapW32SPhag ($21.95 in chips)
bypIyrYcAAifLfhZpGlKLA: posts small blind $0.25
Ucrm3XtZmoONapW32SPhag: posts big blind $0.50
*** HOLE CARDS ***
bypIyrYcAAifLfhZpGlKLA: folds
Ucrm3XtZmoONapW32SPhag collected $0.50 from pot
Ucrm3XtZmoONapW32SPhag: doesn't show hand
*** SUMMARY ***
Total pot $0.50 | Rake $0
Seat 1: bypIyrYcAAifLfhZpGlKLA (button) (small blind) folded before Flop
Seat 2: Ucrm3XtZmoONapW32SPhag (big blind) collected ($0.50)



PokerStars Game #59939533902:  Hold'em No Limit ($0.25/$0.50) - 2009/07/01 0:42:20 ET
Table 'GfL/No5u5PoEnU39lP5pQg' 6-max Seat #4 is the button
Seat 1: 1WUCqNG+p+vfWRTXNu4ljw ($50.25 in chips)
Seat 2: uVwggSetzp7d+eVgowO3vg ($70.95 in chips)
Seat 3: Ek4w9XqBXqK5jBUQeLedGw ($51.50 in chips)
Seat 4: x+pzUFJsMIiGd7a5pcR4tg ($53.55 in chips)
Seat 5: M1KyQQvVPVuxqTAB8sR/zQ ($50.25 in chips)
M1KyQQvVPVuxqTAB8sR/zQ: posts small blind $0.25
1WUCqNG+p+vfWRTXNu4ljw: posts big blind $0.50
*** HOLE CARDS ***
uVwggSetzp7d+eVgowO3vg: calls $0.50
Ek4w9XqBXqK5jBUQeLedGw: raises $1 to $1.50
x+pzUFJsMIiGd7a5pcR4tg: folds
M1KyQQvVPVuxqTAB8sR/zQ: folds
1WUCqNG+p+vfWRTXNu4ljw: calls $1
uVwggSetzp7d+eVgowO3vg: calls $1
*** FLOP *** [9d Qc 4d]
1WUCqNG+p+vfWRTXNu4ljw: checks
uVwggSetzp7d+eVgowO3vg: checks
Ek4w9XqBXqK5jBUQeLedGw: checks
*** TURN *** [9d Qc 4d] [Kd]
1WUCqNG+p+vfWRTXNu4ljw: bets $3
uVwggSetzp7d+eVgowO3vg: folds
Ek4w9XqBXqK5jBUQeLedGw: calls $3
*** RIVER *** [9d Qc 4d Kd] [8d]
1WUCqNG+p+vfWRTXNu4ljw: checks
Ek4w9XqBXqK5jBUQeLedGw: bets $8
1WUCqNG+p+vfWRTXNu4ljw: calls $8
*** SHOW DOWN ***
Ek4w9XqBXqK5jBUQeLedGw: shows [Kc As] (a pair of Kings)
1WUCqNG+p+vfWRTXNu4ljw: shows [Qd Qs] (a flush, King high)
1WUCqNG+p+vfWRTXNu4ljw collected $25.45 from pot
*** SUMMARY ***
Total pot $26.75 | Rake $1.30
Board [9d Qc 4d Kd 8d]
Seat 1: 1WUCqNG+p+vfWRTXNu4ljw (big blind) showed [Qd Qs] and won ($25.45) with a flush, King high
Seat 2: uVwggSetzp7d+eVgowO3vg folded on the Turn
Seat 3: Ek4w9XqBXqK5jBUQeLedGw showed [Kc As] and lost with a pair of Kings
Seat 4: x+pzUFJsMIiGd7a5pcR4tg (button) folded before Flop (didn't bet)
Seat 5: M1KyQQvVPVuxqTAB8sR/zQ (small blind) folded before Flop



PokerStars Game #59939535174:  Hold'em No Limit ($0.25/$0.50) - 2009/07/01 0:42:21 ET
Table '+111aLuBwnz8YVYSA7J1jA' 2-max Seat #1 is the button
Seat 1: ndd1nfncBkWNitBnsfCoVQ ($85.20 in chips)
Seat 2: +ciXH35zeafrjg1W6wiBTg ($65.65 in chips)
ndd1nfncBkWNitBnsfCoVQ: posts small blind $0.25
+ciXH35zeafrjg1W6wiBTg: posts big blind $0.50
*** HOLE CARDS ***
ndd1nfncBkWNitBnsfCoVQ: raises $1 to $1.50
+ciXH35zeafrjg1W6wiBTg: raises $2 to $3.50
ndd1nfncBkWNitBnsfCoVQ: calls $2
*** FLOP *** [Th 8d 9h]
+ciXH35zeafrjg1W6wiBTg: bets $4.50
ndd1nfncBkWNitBnsfCoVQ: raises $7.50 to $12
+ciXH35zeafrjg1W6wiBTg: calls $7.50
*** TURN *** [Th 8d 9h] [Jh]
+ciXH35zeafrjg1W6wiBTg: checks
ndd1nfncBkWNitBnsfCoVQ: checks
*** RIVER *** [Th 8d 9h Jh] [9c]
+ciXH35zeafrjg1W6wiBTg: bets $15
ndd1nfncBkWNitBnsfCoVQ: calls $15
*** SHOW DOWN ***
+ciXH35zeafrjg1W6wiBTg: shows [7c 7s] (a straight, Seven to Jack)
ndd1nfncBkWNitBnsfCoVQ: shows [As 7d] (a straight, Seven to Jack)
+ciXH35zeafrjg1W6wiBTg collected $30.25 from pot
ndd1nfncBkWNitBnsfCoVQ collected $30.25 from pot
*** SUMMARY ***
Total pot $61 | Rake $0.50
Board [Th 8d 9h Jh 9c]
Seat 1: ndd1nfncBkWNitBnsfCoVQ (button) (small blind) showed [As 7d] and won ($30.25) with a straight, Seven to Jack
Seat 2: +ciXH35zeafrjg1W6wiBTg (big blind) showed [7c 7s] and won ($30.25) with a straight, Seven to Jack



PokerStars Game #59939535066:  Hold'em No Limit ($0.25/$0.50) - 2009/07/01 0:42:21 ET
Table '5EmHi+fnatGQQShcNmzOZQ' 6-max Seat #3 is the button
Seat 1: +SZCX3+7lnuhHKIu+PP9rg ($31.10 in chips)
Seat 2: vXIHnZ+dv/hwSBxyvGw7bQ ($76.50 in chips)
Seat 3: L9qfLYXrczhAPd/VckgsWw ($80 in chips)
Seat 4: 1b+2BbjMN8qhR1WPqdE9VQ ($55.15 in chips)
Seat 5: kxPhs4ePFqMy52CInAJ2aw ($55.35 in chips)
Seat 6: 686aeHikcJlgKkSuIFdcXQ ($141.20 in chips)
1b+2BbjMN8qhR1WPqdE9VQ: posts small blind $0.25
kxPhs4ePFqMy52CInAJ2aw: posts big blind $0.50
*** HOLE CARDS ***
686aeHikcJlgKkSuIFdcXQ: folds
+SZCX3+7lnuhHKIu+PP9rg: folds
vXIHnZ+dv/hwSBxyvGw7bQ: raises $1 to $1.50
L9qfLYXrczhAPd/VckgsWw: folds
1b+2BbjMN8qhR1WPqdE9VQ: calls $1.25
kxPhs4ePFqMy52CInAJ2aw: folds
*** FLOP *** [Ah 8s 4s]
1b+2BbjMN8qhR1WPqdE9VQ: checks
vXIHnZ+dv/hwSBxyvGw7bQ: bets $2.25
1b+2BbjMN8qhR1WPqdE9VQ: folds
vXIHnZ+dv/hwSBxyvGw7bQ collected $3.35 from pot
vXIHnZ+dv/hwSBxyvGw7bQ: doesn't show hand
*** SUMMARY ***
Total pot $3.50 | Rake $0.15
Board [Ah 8s 4s]
Seat 1: +SZCX3+7lnuhHKIu+PP9rg folded before Flop (didn't bet)
Seat 2: vXIHnZ+dv/hwSBxyvGw7bQ collected ($3.35)
Seat 3: L9qfLYXrczhAPd/VckgsWw (button) folded before Flop (didn't bet)
Seat 4: 1b+2BbjMN8qhR1WPqdE9VQ (small blind) folded on the Flop
Seat 5: kxPhs4ePFqMy52CInAJ2aw (big blind) folded before Flop
Seat 6: 686aeHikcJlgKkSuIFdcXQ folded before Flop (didn't bet)



PokerStars Game #59939536050:  Hold'em No Limit ($0.25/$0.50) - 2009/07/01 0:42:23 ET
Table 'MJxeZCzYELxiIsyUZyT0jw' 6-max Seat #2 is the button
Seat 2: dB6jzDlJmET84VMWw1mTRA ($52.80 in chips)
Seat 3: JQZew0FjzS19kTjeNtrE+A ($48.25 in chips)
Seat 4: alGiiQP/wwtYnfuXII+sgw ($50 in chips)
Seat 5: 3jvoOXNtXE90w2BdfNZwZQ ($52 in chips)
Seat 6: TTx3CHxyi0SObcHyMJRp5w ($59.20 in chips)
JQZew0FjzS19kTjeNtrE+A: posts small blind $0.25
alGiiQP/wwtYnfuXII+sgw: posts big blind $0.50
*** HOLE CARDS ***
3jvoOXNtXE90w2BdfNZwZQ: folds
TTx3CHxyi0SObcHyMJRp5w: folds
dB6jzDlJmET84VMWw1mTRA: folds
JQZew0FjzS19kTjeNtrE+A: raises $1.50 to $2
alGiiQP/wwtYnfuXII+sgw: calls $1.50
*** FLOP *** [9h Qs 2d]
JQZew0FjzS19kTjeNtrE+A: bets $3
alGiiQP/wwtYnfuXII+sgw: calls $3
*** TURN *** [9h Qs 2d] [9c]
JQZew0FjzS19kTjeNtrE+A: bets $4
alGiiQP/wwtYnfuXII+sgw: folds
JQZew0FjzS19kTjeNtrE+A collected $9.55 from pot
*** SUMMARY ***
Total pot $10 | Rake $0.45
Board [9h Qs 2d 9c]
Seat 2: dB6jzDlJmET84VMWw1mTRA (button) folded before Flop (didn't bet)
Seat 3: JQZew0FjzS19kTjeNtrE+A (small blind) collected ($9.55)
Seat 4: alGiiQP/wwtYnfuXII+sgw (big blind) folded on the Turn
Seat 5: 3jvoOXNtXE90w2BdfNZwZQ folded before Flop (didn't bet)
Seat 6: TTx3CHxyi0SObcHyMJRp5w folded before Flop (didn't bet)



PokerStars Game #59939536654:  Hold'em No Limit ($0.25/$0.50) - 2009/07/01 0:42:24 ET
Table 'eMxdLyFDf28E0wit6gm3Uw' 6-max Seat #5 is the button
Seat 1: GtdWeBVCZhDBcNFRTOb8Hg ($5.60 in chips)
Seat 2: jwuKQ1S3U4NnzMQn3E3dgw ($72.65 in chips)
Seat 3: dZcLsEI8iXkobBduRJ45Yw ($13.35 in chips)
Seat 4: 3jxEWvv2qK1HCXLj4khowQ ($28.75 in chips)
Seat 5: X0X97o2fDAPiGx6o1gahsw ($51.85 in chips)
nOfdMHEXflgT86UgFWblAA will be allowed to play after the button
GtdWeBVCZhDBcNFRTOb8Hg: posts small blind $0.25
jwuKQ1S3U4NnzMQn3E3dgw: posts big blind $0.50
*** HOLE CARDS ***
dZcLsEI8iXkobBduRJ45Yw: folds
3jxEWvv2qK1HCXLj4khowQ: calls $0.50
X0X97o2fDAPiGx6o1gahsw: calls $0.50
GtdWeBVCZhDBcNFRTOb8Hg: calls $0.25
jwuKQ1S3U4NnzMQn3E3dgw: raises $1 to $1.50
3jxEWvv2qK1HCXLj4khowQ: calls $1
X0X97o2fDAPiGx6o1gahsw: folds
GtdWeBVCZhDBcNFRTOb8Hg: folds
*** FLOP *** [8h Td Kc]
jwuKQ1S3U4NnzMQn3E3dgw: bets $3
3jxEWvv2qK1HCXLj4khowQ: raises $3 to $6
jwuKQ1S3U4NnzMQn3E3dgw: calls $3
*** TURN *** [8h Td Kc] [Qh]
jwuKQ1S3U4NnzMQn3E3dgw: bets $21.50
3jxEWvv2qK1HCXLj4khowQ: folds
jwuKQ1S3U4NnzMQn3E3dgw collected $15.25 from pot
*** SUMMARY ***
Total pot $16 | Rake $0.75
Board [8h Td Kc Qh]
Seat 1: GtdWeBVCZhDBcNFRTOb8Hg (small blind) folded before Flop
Seat 2: jwuKQ1S3U4NnzMQn3E3dgw (big blind) collected ($15.25)
Seat 3: dZcLsEI8iXkobBduRJ45Yw folded before Flop (didn't bet)
Seat 4: 3jxEWvv2qK1HCXLj4khowQ folded on the Turn
Seat 5: X0X97o2fDAPiGx6o1gahsw (button) folded before Flop



PokerStars Game #59939536520:  Hold'em No Limit ($0.25/$0.50) - 2009/07/01 0:42:24 ET
Table '/cQuAT3ef4t+PGrXiNhGaQ' 9-max Seat #9 is the button
Seat 1: HZkVla4kK2SI42CVrPZ/ig ($5.50 in chips)
Seat 2: jXGruyaMqirTaTXNOvBdew ($71.85 in chips)
Seat 3: g4k0NXISyLCqaSWZDBjfEg ($54.40 in chips)
Seat 4: OWP/DOu+PlPK6ZZ3zYa0HA ($32.40 in chips)
Seat 5: 5SgaHdWixdClWvaEG+KUjQ ($26.35 in chips)
Seat 6: APYIOyK/4AGb+kIwlOUNBQ ($37.50 in chips)
Seat 7: J0W5D97jl5VLky+IoPvDeA ($114.15 in chips)
Seat 8: W3ingbA178eb7J5rt1PuIQ ($37.10 in chips)
Seat 9: AjV5McH1KMMclY26QdLM5w ($26.50 in chips)
HZkVla4kK2SI42CVrPZ/ig: posts small blind $0.25
jXGruyaMqirTaTXNOvBdew: posts big blind $0.50
*** HOLE CARDS ***
g4k0NXISyLCqaSWZDBjfEg: folds
OWP/DOu+PlPK6ZZ3zYa0HA: folds
5SgaHdWixdClWvaEG+KUjQ: folds
APYIOyK/4AGb+kIwlOUNBQ: raises $1 to $1.50
J0W5D97jl5VLky+IoPvDeA: folds
W3ingbA178eb7J5rt1PuIQ: folds
AjV5McH1KMMclY26QdLM5w: folds
HZkVla4kK2SI42CVrPZ/ig: folds
jXGruyaMqirTaTXNOvBdew: folds
APYIOyK/4AGb+kIwlOUNBQ collected $1.25 from pot
*** SUMMARY ***
Total pot $1.25 | Rake $0
Seat 1: HZkVla4kK2SI42CVrPZ/ig (small blind) folded before Flop
Seat 2: jXGruyaMqirTaTXNOvBdew (big blind) folded before Flop
Seat 3: g4k0NXISyLCqaSWZDBjfEg folded before Flop (didn't bet)
Seat 4: OWP/DOu+PlPK6ZZ3zYa0HA folded before Flop (didn't bet)
Seat 5: 5SgaHdWixdClWvaEG+KUjQ folded before Flop (didn't bet)
Seat 6: APYIOyK/4AGb+kIwlOUNBQ collected ($1.25)
Seat 7: J0W5D97jl5VLky+IoPvDeA folded before Flop (didn't bet)
Seat 8: W3ingbA178eb7J5rt1PuIQ folded before Flop (didn't bet)
Seat 9: AjV5McH1KMMclY26QdLM5w (button) folded before Flop (didn't bet)



PokerStars Game #59939537442:  Hold'em No Limit ($0.25/$0.50) - 2009/07/01 0:42:25 ET
Table 'T/PgNWqVyY6lkldcBVXYJQ' 6-max Seat #1 is the button
Seat 1: +Pf9jTVizYlIo+woPvptfA ($55.75 in chips)
Seat 2: LvH4G7n+QSjT6NDaD3cREA ($61.90 in chips)
Seat 3: L3OcNO1bgdqDI46j67KQPQ ($53.85 in chips)
Seat 5: vVQBckETtigfb5mAcyK0OA ($56.70 in chips)
Seat 6: cDzbog6kwmJp+LBeBq+iMQ ($34.65 in chips)
LvH4G7n+QSjT6NDaD3cREA: posts small blind $0.25
L3OcNO1bgdqDI46j67KQPQ: posts big blind $0.50
Ek4w9XqBXqK5jBUQeLedGw: sits out
*** HOLE CARDS ***
vVQBckETtigfb5mAcyK0OA: folds
vVQBckETtigfb5mAcyK0OA said, "had the 9"
cDzbog6kwmJp+LBeBq+iMQ: calls $0.50
+Pf9jTVizYlIo+woPvptfA: folds
LvH4G7n+QSjT6NDaD3cREA: calls $0.25
cDzbog6kwmJp+LBeBq+iMQ said, "good lay down then"
L3OcNO1bgdqDI46j67KQPQ: checks
*** FLOP *** [6h 6s As]
cDzbog6kwmJp+LBeBq+iMQ said, "2 pair"
cDzbog6kwmJp+LBeBq+iMQ said, "lol"
LvH4G7n+QSjT6NDaD3cREA: bets $1.50
L3OcNO1bgdqDI46j67KQPQ: folds
cDzbog6kwmJp+LBeBq+iMQ: calls $1.50
*** TURN *** [6h 6s As] [4d]
LvH4G7n+QSjT6NDaD3cREA: bets $3
cDzbog6kwmJp+LBeBq+iMQ: calls $3
*** RIVER *** [6h 6s As 4d] [Qc]
LvH4G7n+QSjT6NDaD3cREA: bets $9
cDzbog6kwmJp+LBeBq+iMQ: calls $9
*** SHOW DOWN ***
LvH4G7n+QSjT6NDaD3cREA: shows [Qd 6d] (a full house, Sixes full of Queens)
cDzbog6kwmJp+LBeBq+iMQ: mucks hand
LvH4G7n+QSjT6NDaD3cREA collected $27.10 from pot
*** SUMMARY ***
Total pot $28.50 | Rake $1.40
Board [6h 6s As 4d Qc]
Seat 1: +Pf9jTVizYlIo+woPvptfA (button) folded before Flop (didn't bet)
Seat 2: LvH4G7n+QSjT6NDaD3cREA (small blind) showed [Qd 6d] and won ($27.10) with a full house, Sixes full of Queens
Seat 3: L3OcNO1bgdqDI46j67KQPQ (big blind) folded on the Flop
Seat 5: vVQBckETtigfb5mAcyK0OA folded before Flop (didn't bet)
Seat 6: cDzbog6kwmJp+LBeBq+iMQ mucked



PokerStars Game #59939537162:  Hold'em No Limit ($0.25/$0.50) - 2009/07/01 0:42:25 ET
Table 'IeNZOZQ4T6oiaHqFeo6yIA' 2-max Seat #1 is the button
Seat 1: ndd1nfncBkWNitBnsfCoVQ ($50 in chips)
Seat 2: A91IUl5JaZROhtfCtnnwYw ($113.90 in chips)
ndd1nfncBkWNitBnsfCoVQ: posts small blind $0.25
A91IUl5JaZROhtfCtnnwYw: posts big blind $0.50
*** HOLE CARDS ***
ndd1nfncBkWNitBnsfCoVQ: raises $1 to $1.50
A91IUl5JaZROhtfCtnnwYw: raises $1 to $2.50
ndd1nfncBkWNitBnsfCoVQ: calls $1
*** FLOP *** [Jc 8s 5c]
A91IUl5JaZROhtfCtnnwYw: bets $5.50
ndd1nfncBkWNitBnsfCoVQ: calls $5.50
*** TURN *** [Jc 8s 5c] [Ah]
A91IUl5JaZROhtfCtnnwYw: checks
ndd1nfncBkWNitBnsfCoVQ: checks
*** RIVER *** [Jc 8s 5c Ah] [Tc]
A91IUl5JaZROhtfCtnnwYw: checks
ndd1nfncBkWNitBnsfCoVQ: checks
*** SHOW DOWN ***
A91IUl5JaZROhtfCtnnwYw: shows [Kd Jh] (a pair of Jacks)
ndd1nfncBkWNitBnsfCoVQ: mucks hand
A91IUl5JaZROhtfCtnnwYw collected $15.50 from pot
*** SUMMARY ***
Total pot $16 | Rake $0.50
Board [Jc 8s 5c Ah Tc]
Seat 1: ndd1nfncBkWNitBnsfCoVQ (button) (small blind) mucked
Seat 2: A91IUl5JaZROhtfCtnnwYw (big blind) showed [Kd Jh] and won ($15.50) with a pair of Jacks



PokerStars Game #59939538360:  Hold'em No Limit ($0.25/$0.50) - 2009/07/01 0:42:27 ET
Table 'lSisgp6H7Fg1hH5VfjEjYQ' 9-max Seat #8 is the button
Seat 1: 5k9fvXD9suIgCxU4HLQjTw ($50 in chips)
Seat 2: UrcnkQOiLVk8BlKDPJSy7Q ($50 in chips)
Seat 3: aTkyjTh3w5YLWiIERupZOA ($41.70 in chips)
Seat 4: bwv/rbH/hHhPhY6u9mu04w ($43.50 in chips)
Seat 5: mSD1pginDsyHG5PDfqzphw ($11.35 in chips)
Seat 6: +k7T5ocke8UwavtgUHm+Cg ($29.30 in chips)
Seat 7: Y3DZ6qQlLeBhixDj4M9vmg ($10.80 in chips)
Seat 8: a4JDWmpFQkL10XfAyuF51A ($33.75 in chips)
Seat 9: gsyXT42WLEcOS4DdEk2wlw ($30.45 in chips)
gsyXT42WLEcOS4DdEk2wlw: posts small blind $0.25
5k9fvXD9suIgCxU4HLQjTw: posts big blind $0.50
*** HOLE CARDS ***
UrcnkQOiLVk8BlKDPJSy7Q: folds
aTkyjTh3w5YLWiIERupZOA: raises $1 to $1.50
bwv/rbH/hHhPhY6u9mu04w: folds
mSD1pginDsyHG5PDfqzphw: folds
+k7T5ocke8UwavtgUHm+Cg: folds
Y3DZ6qQlLeBhixDj4M9vmg: folds
a4JDWmpFQkL10XfAyuF51A: folds
gsyXT42WLEcOS4DdEk2wlw: folds
5k9fvXD9suIgCxU4HLQjTw: folds
aTkyjTh3w5YLWiIERupZOA collected $1.25 from pot
*** SUMMARY ***
Total pot $1.25 | Rake $0
Seat 1: 5k9fvXD9suIgCxU4HLQjTw (big blind) folded before Flop
Seat 2: UrcnkQOiLVk8BlKDPJSy7Q folded before Flop (didn't bet)
Seat 3: aTkyjTh3w5YLWiIERupZOA collected ($1.25)
Seat 4: bwv/rbH/hHhPhY6u9mu04w folded before Flop (didn't bet)
Seat 5: mSD1pginDsyHG5PDfqzphw folded before Flop (didn't bet)
Seat 6: +k7T5ocke8UwavtgUHm+Cg folded before Flop (didn't bet)
Seat 7: Y3DZ6qQlLeBhixDj4M9vmg folded before Flop (didn't bet)
Seat 8: a4JDWmpFQkL10XfAyuF51A (button) folded before Flop (didn't bet)
Seat 9: gsyXT42WLEcOS4DdEk2wlw (small blind) folded before Flop



PokerStars Game #59939539406:  Hold'em No Limit ($0.25/$0.50) - 2009/07/01 0:42:28 ET
Table 'X6IRCRTh+20gjz8aubWnwA' 9-max Seat #5 is the button
Seat 1: DSM67hHHq1XFoEOi9p8Alw ($50.80 in chips)
Seat 2: HZkVla4kK2SI42CVrPZ/ig ($11.55 in chips)
Seat 3: GeZ7AYmAZ9Ln8liPZzV8EA ($22.95 in chips)
Seat 4: 2J+UVOVrW+V3maOylyxMcQ ($38.20 in chips)
Seat 5: NnQCepdIR/AOUQn1yhYx6Q ($9.25 in chips)
Seat 6: /6In1zC3WtgwxDcueWzZWg ($68.90 in chips)
Seat 7: cFHQjKQOOKTUzoilhrXHLg ($35.75 in chips)
Seat 8: HxeBVq06/3Bh/H986sgdbw ($7.25 in chips)
Seat 9: M+7+BTmX5vZatHVuoRB1nA ($69.25 in chips)
/6In1zC3WtgwxDcueWzZWg: posts small blind $0.25
cFHQjKQOOKTUzoilhrXHLg: posts big blind $0.50
*** HOLE CARDS ***
HxeBVq06/3Bh/H986sgdbw has timed out
HxeBVq06/3Bh/H986sgdbw: folds
HxeBVq06/3Bh/H986sgdbw is sitting out
M+7+BTmX5vZatHVuoRB1nA: folds
DSM67hHHq1XFoEOi9p8Alw: folds
HZkVla4kK2SI42CVrPZ/ig: folds
GeZ7AYmAZ9Ln8liPZzV8EA: calls $0.50
2J+UVOVrW+V3maOylyxMcQ: calls $0.50
NnQCepdIR/AOUQn1yhYx6Q: folds
/6In1zC3WtgwxDcueWzZWg: calls $0.25
cFHQjKQOOKTUzoilhrXHLg: checks
*** FLOP *** [Kh Ac 3d]
/6In1zC3WtgwxDcueWzZWg: checks
cFHQjKQOOKTUzoilhrXHLg: checks
GeZ7AYmAZ9Ln8liPZzV8EA: bets $0.95
2J+UVOVrW+V3maOylyxMcQ: folds
/6In1zC3WtgwxDcueWzZWg: folds
cFHQjKQOOKTUzoilhrXHLg: folds
GeZ7AYmAZ9Ln8liPZzV8EA collected $1.90 from pot
GeZ7AYmAZ9Ln8liPZzV8EA: doesn't show hand
*** SUMMARY ***
Total pot $2 | Rake $0.10
Board [Kh Ac 3d]
Seat 1: DSM67hHHq1XFoEOi9p8Alw folded before Flop (didn't bet)
Seat 2: HZkVla4kK2SI42CVrPZ/ig folded before Flop (didn't bet)
Seat 3: GeZ7AYmAZ9Ln8liPZzV8EA collected ($1.90)
Seat 4: 2J+UVOVrW+V3maOylyxMcQ folded on the Flop
Seat 5: NnQCepdIR/AOUQn1yhYx6Q (button) folded before Flop (didn't bet)
Seat 6: /6In1zC3WtgwxDcueWzZWg (small blind) folded on the Flop
Seat 7: cFHQjKQOOKTUzoilhrXHLg (big blind) folded on the Flop
Seat 8: HxeBVq06/3Bh/H986sgdbw folded before Flop (didn't bet)
Seat 9: M+7+BTmX5vZatHVuoRB1nA folded before Flop (didn't bet)



PokerStars Game #59939539162:  Hold'em No Limit ($0.25/$0.50) - 2009/07/01 0:42:28 ET
Table 'QOeVnLhwctF9UyV/beDi+A' 2-max Seat #2 is the button
Seat 1: bypIyrYcAAifLfhZpGlKLA ($62.20 in chips)
Seat 2: Ucrm3XtZmoONapW32SPhag ($22.20 in chips)
Ucrm3XtZmoONapW32SPhag: posts small blind $0.25
bypIyrYcAAifLfhZpGlKLA: posts big blind $0.50
*** HOLE CARDS ***
Ucrm3XtZmoONapW32SPhag: calls $0.25
bypIyrYcAAifLfhZpGlKLA: raises $1 to $1.50
Ucrm3XtZmoONapW32SPhag: calls $1
*** FLOP *** [Td 2h 6h]
bypIyrYcAAifLfhZpGlKLA: bets $2
Ucrm3XtZmoONapW32SPhag: calls $2
*** TURN *** [Td 2h 6h] [8d]
bypIyrYcAAifLfhZpGlKLA: checks
Ucrm3XtZmoONapW32SPhag: checks
*** RIVER *** [Td 2h 6h 8d] [5h]
bypIyrYcAAifLfhZpGlKLA: checks
Ucrm3XtZmoONapW32SPhag: bets $5
bypIyrYcAAifLfhZpGlKLA: folds
Ucrm3XtZmoONapW32SPhag collected $6.70 from pot
Ucrm3XtZmoONapW32SPhag: doesn't show hand
*** SUMMARY ***
Total pot $7 | Rake $0.30
Board [Td 2h 6h 8d 5h]
Seat 1: bypIyrYcAAifLfhZpGlKLA (big blind) folded on the River
Seat 2: Ucrm3XtZmoONapW32SPhag (button) (small blind) collected ($6.70)



PokerStars Game #59939539226:  Hold'em No Limit ($0.25/$0.50) - 2009/07/01 0:42:28 ET
Table 'QOgaEqMcJ73pcUMMxoisUgErOuyGLI5PT3G5MnpHgC/g Seat #5 is the button
Seat 1: L5e2lrPLQm1Pqx30IIZ/Fw ($10 in chips)
Seat 3: xZCXQSXlrZkp3pZizzVXCw ($50.50 in chips)
Seat 4: 3UmXLy3GfjC3EkOebduerQ ($50 in chips)
Seat 5: JwvquocWfhTVApN5t47LgA ($59.55 in chips)
Seat 6: zE9cVigS2nW/Ljy4K4bUQA ($30.25 in chips)
Seat 7: 90Wb75h3W1BRpbqVnuk8gw ($60.95 in chips)
Seat 8: g4k0NXISyLCqaSWZDBjfEg ($52.10 in chips)
Seat 9: J0W5D97jl5VLky+IoPvDeA ($57.90 in chips)
zE9cVigS2nW/Ljy4K4bUQA: posts small blind $0.25
90Wb75h3W1BRpbqVnuk8gw: posts big blind $0.50
*** HOLE CARDS ***
g4k0NXISyLCqaSWZDBjfEg: folds
J0W5D97jl5VLky+IoPvDeA: folds
L5e2lrPLQm1Pqx30IIZ/Fw: raises $1.50 to $2
xZCXQSXlrZkp3pZizzVXCw: folds
3UmXLy3GfjC3EkOebduerQ: folds
JwvquocWfhTVApN5t47LgA: calls $2
zE9cVigS2nW/Ljy4K4bUQA: folds
90Wb75h3W1BRpbqVnuk8gw: folds
*** FLOP *** [Ks 2c Qd]
L5e2lrPLQm1Pqx30IIZ/Fw: checks
JwvquocWfhTVApN5t47LgA: checks
*** TURN *** [Ks 2c Qd] [6d]
L5e2lrPLQm1Pqx30IIZ/Fw: bets $3
JwvquocWfhTVApN5t47LgA: folds
L5e2lrPLQm1Pqx30IIZ/Fw collected $4.55 from pot
*** SUMMARY ***
Total pot $4.75 | Rake $0.20
Board [Ks 2c Qd 6d]
Seat 1: L5e2lrPLQm1Pqx30IIZ/Fw collected ($4.55)
Seat 3: xZCXQSXlrZkp3pZizzVXCw folded before Flop (didn't bet)
Seat 4: 3UmXLy3GfjC3EkOebduerQ folded before Flop (didn't bet)
Seat 5: JwvquocWfhTVApN5t47LgA (button) folded on the Turn
Seat 6: zE9cVigS2nW/Ljy4K4bUQA (small blind) folded before Flop
Seat 7: 90Wb75h3W1BRpbqVnuk8gw (big blind) folded before Flop
Seat 8: g4k0NXISyLCqaSWZDBjfEg folded before Flop (didn't bet)
Seat 9: J0W5D97jl5VLky+IoPvDeA folded before Flop (didn't bet)



PokerStars Game #59939541178:  Hold'em No Limit ($0.25/$0.50) - 2009/07/01 0:42:31 ET
Table '3FhG0gl3kMX3wBEEqj+wnQ' 9-max Seat #5 is the button
Seat 1: e0J9pdCNUDTCG031RnXqLA ($23.40 in chips)
Seat 2: 7cYQ+syUWjl38ty/ICOMhw ($47.85 in chips)
Seat 4: bjvJtA9Hqscfznq66txaOQ ($8.50 in chips)
Seat 5: gsyXT42WLEcOS4DdEk2wlw ($28 in chips)
Seat 6: 997ViqAtWn1FPjJqcffwcA ($50 in chips)
Seat 7: mSD1pginDsyHG5PDfqzphw ($10 in chips)
Seat 8: j3K/Jujr7PY4ZM2RZvlH6A ($48.80 in chips)
Seat 9: L5e2lrPLQm1Pqx30IIZ/Fw ($10.75 in chips)
997ViqAtWn1FPjJqcffwcA: posts small blind $0.25
mSD1pginDsyHG5PDfqzphw: posts big blind $0.50
*** HOLE CARDS ***
j3K/Jujr7PY4ZM2RZvlH6A: folds
L5e2lrPLQm1Pqx30IIZ/Fw: folds
e0J9pdCNUDTCG031RnXqLA: folds
7cYQ+syUWjl38ty/ICOMhw: folds
bjvJtA9Hqscfznq66txaOQ: raises $1 to $1.50
gsyXT42WLEcOS4DdEk2wlw: folds
997ViqAtWn1FPjJqcffwcA: folds
mSD1pginDsyHG5PDfqzphw: raises $8.50 to $10 and is all-in
k1f0lS7tlMHCLGs0JT34Tg joins the table at seat #3
bjvJtA9Hqscfznq66txaOQ: folds
mSD1pginDsyHG5PDfqzphw collected $3.25 from pot
mSD1pginDsyHG5PDfqzphw: doesn't show hand
*** SUMMARY ***
Total pot $3.25 | Rake $0
Seat 1: e0J9pdCNUDTCG031RnXqLA folded before Flop (didn't bet)
Seat 2: 7cYQ+syUWjl38ty/ICOMhw folded before Flop (didn't bet)
Seat 4: bjvJtA9Hqscfznq66txaOQ folded before Flop
Seat 5: gsyXT42WLEcOS4DdEk2wlw (button) folded before Flop (didn't bet)
Seat 6: 997ViqAtWn1FPjJqcffwcA (small blind) folded before Flop
Seat 7: mSD1pginDsyHG5PDfqzphw (big blind) collected ($3.25)
Seat 8: j3K/Jujr7PY4ZM2RZvlH6A folded before Flop (didn't bet)
Seat 9: L5e2lrPLQm1Pqx30IIZ/Fw folded before Flop (didn't bet)



PokerStars Game #59939542284:  Hold'em No Limit ($0.25/$0.50) - 2009/07/01 0:42:33 ET
Table '99gCy/CZQwPIjZWH+BguQgE7bWJ45aoFXRpyRv2gw+Igeat #2 is the button
Seat 2: n6VQBu6crjYjy6DxNP1NZA ($19.45 in chips)
Seat 3: qEn9ijNGtuyTxamBf07hYg ($50.25 in chips)
Seat 4: bxLSulbgr8LmKNjOzw8URg ($63.45 in chips)
Seat 5: DSM67hHHq1XFoEOi9p8Alw ($50 in chips)
Seat 7: 4dd+rKHhaMiTl5LEkADvQQ ($10.50 in chips)
Seat 8: 8ehL7qlZzjgUh2H35iiWLw ($50 in chips)
Seat 9: j3K/Jujr7PY4ZM2RZvlH6A ($86.35 in chips)
qEn9ijNGtuyTxamBf07hYg: posts small blind $0.25
bxLSulbgr8LmKNjOzw8URg: posts big blind $0.50
*** HOLE CARDS ***
DSM67hHHq1XFoEOi9p8Alw: folds
4dd+rKHhaMiTl5LEkADvQQ: folds
8ehL7qlZzjgUh2H35iiWLw: folds
j3K/Jujr7PY4ZM2RZvlH6A: folds
n6VQBu6crjYjy6DxNP1NZA: folds
qEn9ijNGtuyTxamBf07hYg: folds
bxLSulbgr8LmKNjOzw8URg collected $0.50 from pot
bxLSulbgr8LmKNjOzw8URg: doesn't show hand
*** SUMMARY ***
Total pot $0.50 | Rake $0
Seat 2: n6VQBu6crjYjy6DxNP1NZA (button) folded before Flop (didn't bet)
Seat 3: qEn9ijNGtuyTxamBf07hYg (small blind) folded before Flop
Seat 4: bxLSulbgr8LmKNjOzw8URg (big blind) collected ($0.50)
Seat 5: DSM67hHHq1XFoEOi9p8Alw folded before Flop (didn't bet)
Seat 7: 4dd+rKHhaMiTl5LEkADvQQ folded before Flop (didn't bet)
Seat 8: 8ehL7qlZzjgUh2H35iiWLw folded before Flop (didn't bet)
Seat 9: j3K/Jujr7PY4ZM2RZvlH6A folded before Flop (didn't bet)



PokerStars Game #59939542692:  Hold'em No Limit ($0.25/$0.50) - 2009/07/01 0:42:34 ET
Table '+dXkOAQyS8j9PQZusUTMpg' 2-max Seat #1 is the button
Seat 1: XFa6sBGjP2gxoIvxR3fZIg ($49.45 in chips)
Seat 2: 5IBeOgaApY1Bvzv2P8X4EA ($155.35 in chips)
XFa6sBGjP2gxoIvxR3fZIg: posts small blind $0.25
5IBeOgaApY1Bvzv2P8X4EA: posts big blind $0.50
*** HOLE CARDS ***
XFa6sBGjP2gxoIvxR3fZIg: raises $1 to $1.50
5IBeOgaApY1Bvzv2P8X4EA: calls $1
*** FLOP *** [Td 5c Kc]
5IBeOgaApY1Bvzv2P8X4EA: checks
XFa6sBGjP2gxoIvxR3fZIg: checks
*** TURN *** [Td 5c Kc] [8s]
5IBeOgaApY1Bvzv2P8X4EA: checks
XFa6sBGjP2gxoIvxR3fZIg: checks
*** RIVER *** [Td 5c Kc 8s] [2d]
5IBeOgaApY1Bvzv2P8X4EA: checks
XFa6sBGjP2gxoIvxR3fZIg: checks
*** SHOW DOWN ***
5IBeOgaApY1Bvzv2P8X4EA: shows [3c As] (high card Ace)
XFa6sBGjP2gxoIvxR3fZIg: mucks hand
5IBeOgaApY1Bvzv2P8X4EA collected $2.85 from pot
*** SUMMARY ***
Total pot $3 | Rake $0.15
Board [Td 5c Kc 8s 2d]
Seat 1: XFa6sBGjP2gxoIvxR3fZIg (button) (small blind) mucked
Seat 2: 5IBeOgaApY1Bvzv2P8X4EA (big blind) showed [3c As] and won ($2.85) with high card Ace



PokerStars Game #59939543574:  Hold'em No Limit ($0.25/$0.50) - 2009/07/01 0:42:35 ET
Table 'E7bWJ45aoFXRpyRv2gw+Ig' 2-max Seat #1 is the button
Seat 1: FRkiRasEGlHUeLrEl+k/nA ($69.60 in chips)
Seat 2: 3Wro85I7472vJ4Wkpneo9A ($126.65 in chips)
FRkiRasEGlHUeLrEl+k/nA: posts small blind $0.25
3Wro85I7472vJ4Wkpneo9A: posts big blind $0.50
*** HOLE CARDS ***
FRkiRasEGlHUeLrEl+k/nA: folds
3Wro85I7472vJ4Wkpneo9A collected $0.50 from pot
3Wro85I7472vJ4Wkpneo9A: doesn't show hand
*** SUMMARY ***
Total pot $0.50 | Rake $0
Seat 1: FRkiRasEGlHUeLrEl+k/nA (button) (small blind) folded before Flop
Seat 2: 3Wro85I7472vJ4Wkpneo9A (big blind) collected ($0.50)



PokerStars Game #59939543360:  Hold'em No Limit ($0.25/$0.50) - 2009/07/01 0:42:35 ET
Table 'BCN5su+SsXiy1zRMJi0SJw' 6-max Seat #4 is the button
Seat 1: crjGpJEzSZgD38FoE3VMGg ($50 in chips)
Seat 2: oU2kDCkT/gilYbHWrg7D8w ($13.65 in chips)
Seat 3: g+vwI6lMKpU2uteXSjOzVw ($19.30 in chips)
Seat 4: JY9CtoZTeav+mhWyxSSyJQ ($26.90 in chips)
Seat 5: IBNygaT1aa9Z1uPdJJilwA ($64.25 in chips)
Seat 6: b2symlOdL7+0c9Pj4N/KlA ($50 in chips)
IBNygaT1aa9Z1uPdJJilwA: posts small blind $0.25
b2symlOdL7+0c9Pj4N/KlA: posts big blind $0.50
*** HOLE CARDS ***
crjGpJEzSZgD38FoE3VMGg: folds
oU2kDCkT/gilYbHWrg7D8w has timed out
oU2kDCkT/gilYbHWrg7D8w: folds
oU2kDCkT/gilYbHWrg7D8w is sitting out
g+vwI6lMKpU2uteXSjOzVw: raises $2.50 to $3
JY9CtoZTeav+mhWyxSSyJQ: folds
IBNygaT1aa9Z1uPdJJilwA: folds
b2symlOdL7+0c9Pj4N/KlA: folds
oU2kDCkT/gilYbHWrg7D8w has returned
g+vwI6lMKpU2uteXSjOzVw collected $1.25 from pot
g+vwI6lMKpU2uteXSjOzVw: doesn't show hand
*** SUMMARY ***
Total pot $1.25 | Rake $0
Seat 1: crjGpJEzSZgD38FoE3VMGg folded before Flop (didn't bet)
Seat 2: oU2kDCkT/gilYbHWrg7D8w folded before Flop (didn't bet)
Seat 3: g+vwI6lMKpU2uteXSjOzVw collected ($1.25)
Seat 4: JY9CtoZTeav+mhWyxSSyJQ (button) folded before Flop (didn't bet)
Seat 5: IBNygaT1aa9Z1uPdJJilwA (small blind) folded before Flop
Seat 6: b2symlOdL7+0c9Pj4N/KlA (big blind) folded before Flop



PokerStars Game #59939543344:  Hold'em No Limit ($0.25/$0.50) - 2009/07/01 0:42:35 ET
Table 'tyR5AZNKV8Aadbrnrnlg7g' 6-max Seat #6 is the button
Seat 1: R+KjpH/wSjDLhtIy9+edNA ($92.60 in chips)
Seat 2: BAjwVL+zKKd0s0fAWstzQQ ($23.60 in chips)
Seat 3: tdOvWynovql5imfooroLMg ($45.75 in chips)
Seat 4: Rt6KgtZ8YaJoTc3FPim00w ($131.65 in chips)
Seat 5: Ek4w9XqBXqK5jBUQeLedGw ($50 in chips)
Seat 6: ZKazl1hGaPiapDXincgi2Q ($12.85 in chips)
R+KjpH/wSjDLhtIy9+edNA: posts small blind $0.25
BAjwVL+zKKd0s0fAWstzQQ: posts big blind $0.50
*** HOLE CARDS ***
tdOvWynovql5imfooroLMg: folds
Rt6KgtZ8YaJoTc3FPim00w: folds
Ek4w9XqBXqK5jBUQeLedGw: folds
ZKazl1hGaPiapDXincgi2Q: calls $0.50
R+KjpH/wSjDLhtIy9+edNA: folds
BAjwVL+zKKd0s0fAWstzQQ: checks
*** FLOP *** [7d 7c 5d]
BAjwVL+zKKd0s0fAWstzQQ: checks
ZKazl1hGaPiapDXincgi2Q: checks
*** TURN *** [7d 7c 5d] [3s]
BAjwVL+zKKd0s0fAWstzQQ: checks
ZKazl1hGaPiapDXincgi2Q: checks
*** RIVER *** [7d 7c 5d 3s] [Th]
BAjwVL+zKKd0s0fAWstzQQ: checks
ZKazl1hGaPiapDXincgi2Q: checks
*** SHOW DOWN ***
BAjwVL+zKKd0s0fAWstzQQ: shows [4d 2h] (a pair of Sevens)
ZKazl1hGaPiapDXincgi2Q: shows [8h Jc] (a pair of Sevens - Jack kicker)
ZKazl1hGaPiapDXincgi2Q collected $1.20 from pot
*** SUMMARY ***
Total pot $1.25 | Rake $0.05
Board [7d 7c 5d 3s Th]
Seat 1: R+KjpH/wSjDLhtIy9+edNA (small blind) folded before Flop
Seat 2: BAjwVL+zKKd0s0fAWstzQQ (big blind) showed [4d 2h] and lost with a pair of Sevens
Seat 3: tdOvWynovql5imfooroLMg folded before Flop (didn't bet)
Seat 4: Rt6KgtZ8YaJoTc3FPim00w folded before Flop (didn't bet)
Seat 5: Ek4w9XqBXqK5jBUQeLedGw folded before Flop (didn't bet)
Seat 6: ZKazl1hGaPiapDXincgi2Q (button) showed [8h Jc] and won ($1.20) with a pair of Sevens



PokerStars Game #59939544902:  Hold'em No Limit ($0.25/$0.50) - 2009/07/01 0:42:37 ET
Table '37qXEp3oe+er5q4CZip9eQ' 6-max Seat #1 is the button
Seat 1: oqOqoO2AyCZenUghCxMDxw ($59.40 in chips)
Seat 2: 6wzJiRvp8HY6t+MQGnSIzA ($25.95 in chips)
Seat 3: Rt6KgtZ8YaJoTc3FPim00w ($73 in chips)
Seat 4: XsmE8nXMAAMFJbWaJTmHFw ($30.20 in chips)
Seat 6: N50kln4negd8q7Mmoz1j4g ($21.35 in chips)
6wzJiRvp8HY6t+MQGnSIzA: posts small blind $0.25
Rt6KgtZ8YaJoTc3FPim00w: posts big blind $0.50
*** HOLE CARDS ***
XsmE8nXMAAMFJbWaJTmHFw: folds
N50kln4negd8q7Mmoz1j4g: folds
oqOqoO2AyCZenUghCxMDxw: raises $0.50 to $1
6wzJiRvp8HY6t+MQGnSIzA: raises $2 to $3
Rt6KgtZ8YaJoTc3FPim00w: folds
oqOqoO2AyCZenUghCxMDxw: folds
6wzJiRvp8HY6t+MQGnSIzA collected $2.50 from pot
*** SUMMARY ***
Total pot $2.50 | Rake $0
Seat 1: oqOqoO2AyCZenUghCxMDxw (button) folded before Flop
Seat 2: 6wzJiRvp8HY6t+MQGnSIzA (small blind) collected ($2.50)
Seat 3: Rt6KgtZ8YaJoTc3FPim00w (big blind) folded before Flop
Seat 4: XsmE8nXMAAMFJbWaJTmHFw folded before Flop (didn't bet)
Seat 6: N50kln4negd8q7Mmoz1j4g folded before Flop (didn't bet)



PokerStars Game #59939545252:  Hold'em No Limit ($0.25/$0.50) - 2009/07/01 0:42:38 ET
Table 'hWT2kq66tnKEpD26cia6fQ' 2-max Seat #2 is the button
Seat 1: q+vRKwm51mnr6kxX/161WQ ($45.10 in chips)
Seat 2: dkC7J+qbyqk0qCcmJbEPPw ($68.05 in chips)
dkC7J+qbyqk0qCcmJbEPPw: posts small blind $0.25
q+vRKwm51mnr6kxX/161WQ: posts big blind $0.50
*** HOLE CARDS ***
dkC7J+qbyqk0qCcmJbEPPw: raises $1 to $1.50
q+vRKwm51mnr6kxX/161WQ: folds
dkC7J+qbyqk0qCcmJbEPPw collected $1 from pot
*** SUMMARY ***
Total pot $1 | Rake $0
Seat 1: q+vRKwm51mnr6kxX/161WQ (big blind) folded before Flop
Seat 2: dkC7J+qbyqk0qCcmJbEPPw (button) (small blind) collected ($1)



PokerStars Game #59939547852:  Hold'em No Limit ($0.25/$0.50) - 2009/07/01 0:42:42 ET
Table 'E7bWJ45aoFXRpyRv2gw+Ig' 2-max Seat #2 is the button
Seat 1: FRkiRasEGlHUeLrEl+k/nA ($69.35 in chips)
Seat 2: 3Wro85I7472vJ4Wkpneo9A ($126.90 in chips)
3Wro85I7472vJ4Wkpneo9A: posts small blind $0.25
FRkiRasEGlHUeLrEl+k/nA: posts big blind $0.50
*** HOLE CARDS ***
3Wro85I7472vJ4Wkpneo9A: raises $1 to $1.50
FRkiRasEGlHUeLrEl+k/nA: folds
3Wro85I7472vJ4Wkpneo9A collected $1 from pot
3Wro85I7472vJ4Wkpneo9A: doesn't show hand
*** SUMMARY ***
Total pot $1 | Rake $0
Seat 1: FRkiRasEGlHUeLrEl+k/nA (big blind) folded before Flop
Seat 2: 3Wro85I7472vJ4Wkpneo9A (button) (small blind) collected ($1)



PokerStars Game #59939550460:  Hold'em No Limit ($0.25/$0.50) - 2009/07/01 0:42:46 ET
Table 'hWT2kq66tnKEpD26cia6fQ' 2-max Seat #1 is the button
Seat 1: q+vRKwm51mnr6kxX/161WQ ($44.60 in chips)
Seat 2: dkC7J+qbyqk0qCcmJbEPPw ($68.55 in chips)
q+vRKwm51mnr6kxX/161WQ: posts small blind $0.25
dkC7J+qbyqk0qCcmJbEPPw: posts big blind $0.50
*** HOLE CARDS ***
q+vRKwm51mnr6kxX/161WQ: raises $1 to $1.50
dkC7J+qbyqk0qCcmJbEPPw: raises $3 to $4.50
q+vRKwm51mnr6kxX/161WQ: folds
dkC7J+qbyqk0qCcmJbEPPw collected $3 from pot
*** SUMMARY ***
Total pot $3 | Rake $0
Seat 1: q+vRKwm51mnr6kxX/161WQ (button) (small blind) folded before Flop
Seat 2: dkC7J+qbyqk0qCcmJbEPPw (big blind) collected ($3)



PokerStars Game #59939551846:  Hold'em No Limit ($0.25/$0.50) - 2009/07/01 0:42:48 ET
Table '99gCy/CZQwPIjZWH+BguQgE7bWJ45aoFXRpyRv2gw+Igeat #3 is the button
Seat 2: n6VQBu6crjYjy6DxNP1NZA ($19.45 in chips)
Seat 3: qEn9ijNGtuyTxamBf07hYg ($50 in chips)
Seat 4: bxLSulbgr8LmKNjOzw8URg ($63.70 in chips)
Seat 5: DSM67hHHq1XFoEOi9p8Alw ($50 in chips)
Seat 7: 4dd+rKHhaMiTl5LEkADvQQ ($10.50 in chips)
Seat 8: 8ehL7qlZzjgUh2H35iiWLw ($50 in chips)
Seat 9: j3K/Jujr7PY4ZM2RZvlH6A ($86.35 in chips)
bxLSulbgr8LmKNjOzw8URg: posts small blind $0.25
DSM67hHHq1XFoEOi9p8Alw: posts big blind $0.50
*** HOLE CARDS ***
4dd+rKHhaMiTl5LEkADvQQ: folds
8ehL7qlZzjgUh2H35iiWLw: folds
j3K/Jujr7PY4ZM2RZvlH6A: raises $1 to $1.50
n6VQBu6crjYjy6DxNP1NZA: calls $1.50
qEn9ijNGtuyTxamBf07hYg: folds
bxLSulbgr8LmKNjOzw8URg: folds
DSM67hHHq1XFoEOi9p8Alw: folds
*** FLOP *** [Ac 2h Qd]
j3K/Jujr7PY4ZM2RZvlH6A: bets $2
4dd+rKHhaMiTl5LEkADvQQ leaves the table
n6VQBu6crjYjy6DxNP1NZA: calls $2
*** TURN *** [Ac 2h Qd] [Th]
j3K/Jujr7PY4ZM2RZvlH6A: bets $7
OcnLOMVFdy23jXnoTyaO5Q has returned
n6VQBu6crjYjy6DxNP1NZA: raises $8.95 to $15.95 and is all-in
j3K/Jujr7PY4ZM2RZvlH6A: folds
n6VQBu6crjYjy6DxNP1NZA collected $20.70 from pot
n6VQBu6crjYjy6DxNP1NZA: doesn't show hand
*** SUMMARY ***
Total pot $21.75 | Rake $1.05
Board [Ac 2h Qd Th]
Seat 2: n6VQBu6crjYjy6DxNP1NZA collected ($20.70)
Seat 3: qEn9ijNGtuyTxamBf07hYg (button) folded before Flop (didn't bet)
Seat 4: bxLSulbgr8LmKNjOzw8URg (small blind) folded before Flop
Seat 5: DSM67hHHq1XFoEOi9p8Alw (big blind) folded before Flop
Seat 7: 4dd+rKHhaMiTl5LEkADvQQ folded before Flop (didn't bet)
Seat 8: 8ehL7qlZzjgUh2H35iiWLw folded before Flop (didn't bet)
Seat 9: j3K/Jujr7PY4ZM2RZvlH6A folded on the Turn



PokerStars Game #59939552054:  Hold'em No Limit ($0.25/$0.50) - 2009/07/01 0:42:48 ET
Table 'EiNh8p/wGJ1FP575iMFnqg' 9-max Seat #4 is the button
Seat 1: r3ZqM1Mi0W3y4hOdssE+Sg ($49.40 in chips)
Seat 2: 8ehL7qlZzjgUh2H35iiWLw ($53.35 in chips)
Seat 3: ymLPoEIl7UL3TvZYmnadxQ ($48.60 in chips)
Seat 4: cMzaiXAM/ZAdNaEUu+LqhA ($50 in chips)
Seat 5: M+7+BTmX5vZatHVuoRB1nA ($79.35 in chips)
Seat 6: 3UmXLy3GfjC3EkOebduerQ ($62.75 in chips)
Seat 7: 997ViqAtWn1FPjJqcffwcA ($50 in chips)
Seat 8: KrPAGRACBg+w0M//SXe8Ag ($9.35 in chips)
M+7+BTmX5vZatHVuoRB1nA: posts small blind $0.25
3UmXLy3GfjC3EkOebduerQ: posts big blind $0.50
NnQCepdIR/AOUQn1yhYx6Q: sits out
*** HOLE CARDS ***
997ViqAtWn1FPjJqcffwcA: folds
KrPAGRACBg+w0M//SXe8Ag: folds
r3ZqM1Mi0W3y4hOdssE+Sg: folds
8ehL7qlZzjgUh2H35iiWLw: folds
ymLPoEIl7UL3TvZYmnadxQ: folds
cMzaiXAM/ZAdNaEUu+LqhA: folds
M+7+BTmX5vZatHVuoRB1nA: calls $0.25
3UmXLy3GfjC3EkOebduerQ: checks
*** FLOP *** [7s Ac Tc]
M+7+BTmX5vZatHVuoRB1nA: checks
3UmXLy3GfjC3EkOebduerQ: checks
*** TURN *** [7s Ac Tc] [7d]
M+7+BTmX5vZatHVuoRB1nA: checks
3UmXLy3GfjC3EkOebduerQ: checks
*** RIVER *** [7s Ac Tc 7d] [3c]
M+7+BTmX5vZatHVuoRB1nA: checks
3UmXLy3GfjC3EkOebduerQ: checks
*** SHOW DOWN ***
M+7+BTmX5vZatHVuoRB1nA: shows [8d 5d] (a pair of Sevens)
3UmXLy3GfjC3EkOebduerQ: shows [2s Th] (two pair, Tens and Sevens)
3UmXLy3GfjC3EkOebduerQ collected $0.95 from pot
*** SUMMARY ***
Total pot $1 | Rake $0.05
Board [7s Ac Tc 7d 3c]
Seat 1: r3ZqM1Mi0W3y4hOdssE+Sg folded before Flop (didn't bet)
Seat 2: 8ehL7qlZzjgUh2H35iiWLw folded before Flop (didn't bet)
Seat 3: ymLPoEIl7UL3TvZYmnadxQ folded before Flop (didn't bet)
Seat 4: cMzaiXAM/ZAdNaEUu+LqhA (button) folded before Flop (didn't bet)
Seat 5: M+7+BTmX5vZatHVuoRB1nA (small blind) showed [8d 5d] and lost with a pair of Sevens
Seat 6: 3UmXLy3GfjC3EkOebduerQ (big blind) showed [2s Th] and won ($0.95) with two pair, Tens and Sevens
Seat 7: 997ViqAtWn1FPjJqcffwcA folded before Flop (didn't bet)
Seat 8: KrPAGRACBg+w0M//SXe8Ag folded before Flop (didn't bet)



PokerStars Game #59939552422:  Hold'em No Limit ($0.25/$0.50) - 2009/07/01 0:42:49 ET
Table 'c/CRn+68J3Y8KxD5g1ek2Q' 2-max Seat #1 is the button
Seat 1: 46qCyJ6evTkHo9al5sBMNA ($219.70 in chips)
Seat 2: BypVLsYQt3ePFm2xQL/dOA ($154.70 in chips)
46qCyJ6evTkHo9al5sBMNA: posts small blind $0.25
BypVLsYQt3ePFm2xQL/dOA: posts big blind $0.50
*** HOLE CARDS ***
46qCyJ6evTkHo9al5sBMNA: folds
BypVLsYQt3ePFm2xQL/dOA collected $0.50 from pot
BypVLsYQt3ePFm2xQL/dOA: doesn't show hand
*** SUMMARY ***
Total pot $0.50 | Rake $0
Seat 1: 46qCyJ6evTkHo9al5sBMNA (button) (small blind) folded before Flop
Seat 2: BypVLsYQt3ePFm2xQL/dOA (big blind) collected ($0.50)



PokerStars Game #59939554046:  Hold'em No Limit ($0.25/$0.50) - 2009/07/01 0:42:51 ET
Table '5EmHi+fnatGQQShcNmzOZQ' 6-max Seat #4 is the button
Seat 1: +SZCX3+7lnuhHKIu+PP9rg ($31.10 in chips)
Seat 2: vXIHnZ+dv/hwSBxyvGw7bQ ($78.35 in chips)
Seat 3: L9qfLYXrczhAPd/VckgsWw ($80 in chips)
Seat 4: 1b+2BbjMN8qhR1WPqdE9VQ ($53.65 in chips)
Seat 5: kxPhs4ePFqMy52CInAJ2aw ($54.85 in chips)
Seat 6: 686aeHikcJlgKkSuIFdcXQ ($141.20 in chips)
kxPhs4ePFqMy52CInAJ2aw: posts small blind $0.25
686aeHikcJlgKkSuIFdcXQ: posts big blind $0.50
*** HOLE CARDS ***
+SZCX3+7lnuhHKIu+PP9rg: folds
vXIHnZ+dv/hwSBxyvGw7bQ: folds
L9qfLYXrczhAPd/VckgsWw: folds
1b+2BbjMN8qhR1WPqdE9VQ: folds
kxPhs4ePFqMy52CInAJ2aw: folds
686aeHikcJlgKkSuIFdcXQ collected $0.50 from pot
*** SUMMARY ***
Total pot $0.50 | Rake $0
Seat 1: +SZCX3+7lnuhHKIu+PP9rg folded before Flop (didn't bet)
Seat 2: vXIHnZ+dv/hwSBxyvGw7bQ folded before Flop (didn't bet)
Seat 3: L9qfLYXrczhAPd/VckgsWw folded before Flop (didn't bet)
Seat 4: 1b+2BbjMN8qhR1WPqdE9VQ (button) folded before Flop (didn't bet)
Seat 5: kxPhs4ePFqMy52CInAJ2aw (small blind) folded before Flop
Seat 6: 686aeHikcJlgKkSuIFdcXQ (big blind) collected ($0.50)



PokerStars Game #59939554916:  Hold'em No Limit ($0.25/$0.50) - 2009/07/01 0:42:53 ET
Table '+dXkOAQyS8j9PQZusUTMpg' 2-max Seat #2 is the button
Seat 1: XFa6sBGjP2gxoIvxR3fZIg ($47.95 in chips)
Seat 2: 5IBeOgaApY1Bvzv2P8X4EA ($156.70 in chips)
5IBeOgaApY1Bvzv2P8X4EA: posts small blind $0.25
XFa6sBGjP2gxoIvxR3fZIg: posts big blind $0.50
*** HOLE CARDS ***
5IBeOgaApY1Bvzv2P8X4EA: folds
XFa6sBGjP2gxoIvxR3fZIg collected $0.50 from pot
*** SUMMARY ***
Total pot $0.50 | Rake $0
Seat 1: XFa6sBGjP2gxoIvxR3fZIg (big blind) collected ($0.50)
Seat 2: 5IBeOgaApY1Bvzv2P8X4EA (button) (small blind) folded before Flop



PokerStars Game #59939555174:  Hold'em No Limit ($0.25/$0.50) - 2009/07/01 0:42:53 ET
Table '/cQuAT3ef4t+PGrXiNhGaQ' 9-max Seat #1 is the button
Seat 1: HZkVla4kK2SI42CVrPZ/ig ($5.25 in chips)
Seat 2: jXGruyaMqirTaTXNOvBdew ($71.35 in chips)
Seat 3: g4k0NXISyLCqaSWZDBjfEg ($54.40 in chips)
Seat 4: OWP/DOu+PlPK6ZZ3zYa0HA ($32.40 in chips)
Seat 5: 5SgaHdWixdClWvaEG+KUjQ ($26.35 in chips)
Seat 6: APYIOyK/4AGb+kIwlOUNBQ ($38.25 in chips)
Seat 7: J0W5D97jl5VLky+IoPvDeA ($114.15 in chips)
Seat 8: W3ingbA178eb7J5rt1PuIQ ($37.10 in chips)
Seat 9: AjV5McH1KMMclY26QdLM5w ($26.50 in chips)
jXGruyaMqirTaTXNOvBdew: posts small blind $0.25
g4k0NXISyLCqaSWZDBjfEg: posts big blind $0.50
*** HOLE CARDS ***
OWP/DOu+PlPK6ZZ3zYa0HA: folds
5SgaHdWixdClWvaEG+KUjQ: folds
APYIOyK/4AGb+kIwlOUNBQ: raises $1 to $1.50
J0W5D97jl5VLky+IoPvDeA: folds
W3ingbA178eb7J5rt1PuIQ: folds
AjV5McH1KMMclY26QdLM5w: folds
HZkVla4kK2SI42CVrPZ/ig: folds
jXGruyaMqirTaTXNOvBdew: folds
g4k0NXISyLCqaSWZDBjfEg: folds
APYIOyK/4AGb+kIwlOUNBQ collected $1.25 from pot
*** SUMMARY ***
Total pot $1.25 | Rake $0
Seat 1: HZkVla4kK2SI42CVrPZ/ig (button) folded before Flop (didn't bet)
Seat 2: jXGruyaMqirTaTXNOvBdew (small blind) folded before Flop
Seat 3: g4k0NXISyLCqaSWZDBjfEg (big blind) folded before Flop
Seat 4: OWP/DOu+PlPK6ZZ3zYa0HA folded before Flop (didn't bet)
Seat 5: 5SgaHdWixdClWvaEG+KUjQ folded before Flop (didn't bet)
Seat 6: APYIOyK/4AGb+kIwlOUNBQ collected ($1.25)
Seat 7: J0W5D97jl5VLky+IoPvDeA folded before Flop (didn't bet)
Seat 8: W3ingbA178eb7J5rt1PuIQ folded before Flop (didn't bet)
Seat 9: AjV5McH1KMMclY26QdLM5w folded before Flop (didn't bet)



PokerStars Game #59939555826:  Hold'em No Limit ($0.25/$0.50) - 2009/07/01 0:42:54 ET
Table 'lSisgp6H7Fg1hH5VfjEjYQ' 9-max Seat #9 is the button
Seat 1: 5k9fvXD9suIgCxU4HLQjTw ($50 in chips)
Seat 2: UrcnkQOiLVk8BlKDPJSy7Q ($50 in chips)
Seat 3: aTkyjTh3w5YLWiIERupZOA ($42.45 in chips)
Seat 4: bwv/rbH/hHhPhY6u9mu04w ($43.50 in chips)
Seat 5: mSD1pginDsyHG5PDfqzphw ($11.35 in chips)
Seat 6: +k7T5ocke8UwavtgUHm+Cg ($29.30 in chips)
Seat 7: Y3DZ6qQlLeBhixDj4M9vmg ($10.80 in chips)
Seat 8: a4JDWmpFQkL10XfAyuF51A ($33.75 in chips)
Seat 9: gsyXT42WLEcOS4DdEk2wlw ($30.20 in chips)
5k9fvXD9suIgCxU4HLQjTw: posts small blind $0.25
UrcnkQOiLVk8BlKDPJSy7Q: posts big blind $0.50
*** HOLE CARDS ***
aTkyjTh3w5YLWiIERupZOA: folds
bwv/rbH/hHhPhY6u9mu04w: folds
mSD1pginDsyHG5PDfqzphw: folds
+k7T5ocke8UwavtgUHm+Cg: folds
Y3DZ6qQlLeBhixDj4M9vmg: folds
a4JDWmpFQkL10XfAyuF51A: folds
gsyXT42WLEcOS4DdEk2wlw: folds
5k9fvXD9suIgCxU4HLQjTw: folds
UrcnkQOiLVk8BlKDPJSy7Q collected $0.50 from pot
UrcnkQOiLVk8BlKDPJSy7Q: doesn't show hand
*** SUMMARY ***
Total pot $0.50 | Rake $0
Seat 1: 5k9fvXD9suIgCxU4HLQjTw (small blind) folded before Flop
Seat 2: UrcnkQOiLVk8BlKDPJSy7Q (big blind) collected ($0.50)
Seat 3: aTkyjTh3w5YLWiIERupZOA folded before Flop (didn't bet)
Seat 4: bwv/rbH/hHhPhY6u9mu04w folded before Flop (didn't bet)
Seat 5: mSD1pginDsyHG5PDfqzphw folded before Flop (didn't bet)
Seat 6: +k7T5ocke8UwavtgUHm+Cg folded before Flop (didn't bet)
Seat 7: Y3DZ6qQlLeBhixDj4M9vmg folded before Flop (didn't bet)
Seat 8: a4JDWmpFQkL10XfAyuF51A folded before Flop (didn't bet)
Seat 9: gsyXT42WLEcOS4DdEk2wlw (button) folded before Flop (didn't bet)



PokerStars Game #59939555954:  Hold'em No Limit ($0.25/$0.50) - 2009/07/01 0:42:54 ET
Table 'E7bWJ45aoFXRpyRv2gw+Ig' 2-max Seat #1 is the button
Seat 1: FRkiRasEGlHUeLrEl+k/nA ($68.85 in chips)
Seat 2: 3Wro85I7472vJ4Wkpneo9A ($127.40 in chips)
FRkiRasEGlHUeLrEl+k/nA: posts small blind $0.25
3Wro85I7472vJ4Wkpneo9A: posts big blind $0.50
*** HOLE CARDS ***
FRkiRasEGlHUeLrEl+k/nA: calls $0.25
3Wro85I7472vJ4Wkpneo9A: checks
*** FLOP *** [8s 7h Qd]
3Wro85I7472vJ4Wkpneo9A: bets $1
FRkiRasEGlHUeLrEl+k/nA: calls $1
*** TURN *** [8s 7h Qd] [Jh]
3Wro85I7472vJ4Wkpneo9A: bets $2
FRkiRasEGlHUeLrEl+k/nA: calls $2
*** RIVER *** [8s 7h Qd Jh] [5s]
3Wro85I7472vJ4Wkpneo9A: checks
FRkiRasEGlHUeLrEl+k/nA: bets $4
3Wro85I7472vJ4Wkpneo9A: folds
FRkiRasEGlHUeLrEl+k/nA collected $6.70 from pot
*** SUMMARY ***
Total pot $7 | Rake $0.30
Board [8s 7h Qd Jh 5s]
Seat 1: FRkiRasEGlHUeLrEl+k/nA (button) (small blind) collected ($6.70)
Seat 2: 3Wro85I7472vJ4Wkpneo9A (big blind) folded on the River



PokerStars Game #59939557124:  Hold'em No Limit ($0.25/$0.50) - 2009/07/01 0:42:56 ET
Table '+111aLuBwnz8YVYSA7J1jA' 2-max Seat #2 is the button
Seat 1: ndd1nfncBkWNitBnsfCoVQ ($84.95 in chips)
Seat 2: +ciXH35zeafrjg1W6wiBTg ($65.40 in chips)
+ciXH35zeafrjg1W6wiBTg: posts small blind $0.25
ndd1nfncBkWNitBnsfCoVQ: posts big blind $0.50
*** HOLE CARDS ***
+ciXH35zeafrjg1W6wiBTg: raises $1 to $1.50
ndd1nfncBkWNitBnsfCoVQ: folds
+ciXH35zeafrjg1W6wiBTg collected $1 from pot
+ciXH35zeafrjg1W6wiBTg: doesn't show hand
*** SUMMARY ***
Total pot $1 | Rake $0
Seat 1: ndd1nfncBkWNitBnsfCoVQ (big blind) folded before Flop
Seat 2: +ciXH35zeafrjg1W6wiBTg (button) (small blind) collected ($1)



PokerStars Game #59939558348:  Hold'em No Limit ($0.25/$0.50) - 2009/07/01 0:42:58 ET
Table 'c/CRn+68J3Y8KxD5g1ek2Q' 2-max Seat #2 is the button
Seat 1: 46qCyJ6evTkHo9al5sBMNA ($219.45 in chips)
Seat 2: BypVLsYQt3ePFm2xQL/dOA ($154.95 in chips)
BypVLsYQt3ePFm2xQL/dOA: posts small blind $0.25
46qCyJ6evTkHo9al5sBMNA: posts big blind $0.50
*** HOLE CARDS ***
BypVLsYQt3ePFm2xQL/dOA: calls $0.25
46qCyJ6evTkHo9al5sBMNA: checks
*** FLOP *** [Kh 3h 4c]
46qCyJ6evTkHo9al5sBMNA: checks
BypVLsYQt3ePFm2xQL/dOA: bets $1
46qCyJ6evTkHo9al5sBMNA: folds
BypVLsYQt3ePFm2xQL/dOA collected $0.95 from pot
BypVLsYQt3ePFm2xQL/dOA: doesn't show hand
*** SUMMARY ***
Total pot $1 | Rake $0.05
Board [Kh 3h 4c]
Seat 1: 46qCyJ6evTkHo9al5sBMNA (big blind) folded on the Flop
Seat 2: BypVLsYQt3ePFm2xQL/dOA (button) (small blind) collected ($0.95)



PokerStars Game #59939558650:  Hold'em No Limit ($0.25/$0.50) - 2009/07/01 0:42:58 ET
Table '+dXkOAQyS8j9PQZusUTMpg' 2-max Seat #1 is the button
Seat 1: XFa6sBGjP2gxoIvxR3fZIg ($48.20 in chips)
Seat 2: 5IBeOgaApY1Bvzv2P8X4EA ($156.45 in chips)
XFa6sBGjP2gxoIvxR3fZIg: posts small blind $0.25
5IBeOgaApY1Bvzv2P8X4EA: posts big blind $0.50
*** HOLE CARDS ***
XFa6sBGjP2gxoIvxR3fZIg: raises $1 to $1.50
5IBeOgaApY1Bvzv2P8X4EA: folds
XFa6sBGjP2gxoIvxR3fZIg collected $1 from pot
XFa6sBGjP2gxoIvxR3fZIg: doesn't show hand
*** SUMMARY ***
Total pot $1 | Rake $0
Seat 1: XFa6sBGjP2gxoIvxR3fZIg (button) (small blind) collected ($1)
Seat 2: 5IBeOgaApY1Bvzv2P8X4EA (big blind) folded before Flop



PokerStars Game #59939559342:  Hold'em No Limit ($0.25/$0.50) - 2009/07/01 0:43:00 ET
Table 'QOeVnLhwctF9UyV/beDi+A' 2-max Seat #1 is the button
Seat 1: bypIyrYcAAifLfhZpGlKLA ($58.70 in chips)
Seat 2: Ucrm3XtZmoONapW32SPhag ($25.40 in chips)
bypIyrYcAAifLfhZpGlKLA: posts small blind $0.25
Ucrm3XtZmoONapW32SPhag: posts big blind $0.50
*** HOLE CARDS ***
bypIyrYcAAifLfhZpGlKLA: raises $1 to $1.50
Ucrm3XtZmoONapW32SPhag: raises $1 to $2.50
bypIyrYcAAifLfhZpGlKLA: calls $1
*** FLOP *** [Qh Kd 6s]
Ucrm3XtZmoONapW32SPhag: bets $3
bypIyrYcAAifLfhZpGlKLA: folds
Ucrm3XtZmoONapW32SPhag collected $4.75 from pot
Ucrm3XtZmoONapW32SPhag: doesn't show hand
*** SUMMARY ***
Total pot $5 | Rake $0.25
Board [Qh Kd 6s]
Seat 1: bypIyrYcAAifLfhZpGlKLA (button) (small blind) folded on the Flop
Seat 2: Ucrm3XtZmoONapW32SPhag (big blind) collected ($4.75)



PokerStars Game #59939559934:  Hold'em No Limit ($0.25/$0.50) - 2009/07/01 0:43:00 ET
Table 'hWT2kq66tnKEpD26cia6fQ' 2-max Seat #2 is the button
Seat 1: q+vRKwm51mnr6kxX/161WQ ($43.10 in chips)
Seat 2: dkC7J+qbyqk0qCcmJbEPPw ($70.05 in chips)
dkC7J+qbyqk0qCcmJbEPPw: posts small blind $0.25
q+vRKwm51mnr6kxX/161WQ: posts big blind $0.50
*** HOLE CARDS ***
dkC7J+qbyqk0qCcmJbEPPw: raises $1 to $1.50
q+vRKwm51mnr6kxX/161WQ: calls $1
*** FLOP *** [Js 4d Ad]
q+vRKwm51mnr6kxX/161WQ: checks
dkC7J+qbyqk0qCcmJbEPPw: checks
*** TURN *** [Js 4d Ad] [Kh]
q+vRKwm51mnr6kxX/161WQ: checks
dkC7J+qbyqk0qCcmJbEPPw: checks
*** RIVER *** [Js 4d Ad Kh] [9d]
q+vRKwm51mnr6kxX/161WQ: checks
dkC7J+qbyqk0qCcmJbEPPw: checks
*** SHOW DOWN ***
q+vRKwm51mnr6kxX/161WQ: shows [Ac 2c] (a pair of Aces)
dkC7J+qbyqk0qCcmJbEPPw: mucks hand
q+vRKwm51mnr6kxX/161WQ collected $2.85 from pot
*** SUMMARY ***
Total pot $3 | Rake $0.15
Board [Js 4d Ad Kh 9d]
Seat 1: q+vRKwm51mnr6kxX/161WQ (big blind) showed [Ac 2c] and won ($2.85) with a pair of Aces
Seat 2: dkC7J+qbyqk0qCcmJbEPPw (button) (small blind) mucked



PokerStars Game #59939560562:  Hold'em No Limit ($0.25/$0.50) - 2009/07/01 0:43:01 ET
Table 'IeNZOZQ4T6oiaHqFeo6yIA' 2-max Seat #2 is the button
Seat 1: ndd1nfncBkWNitBnsfCoVQ ($50 in chips)
Seat 2: A91IUl5JaZROhtfCtnnwYw ($121.40 in chips)
A91IUl5JaZROhtfCtnnwYw: posts small blind $0.25
ndd1nfncBkWNitBnsfCoVQ: posts big blind $0.50
*** HOLE CARDS ***
A91IUl5JaZROhtfCtnnwYw: calls $0.25
ndd1nfncBkWNitBnsfCoVQ: checks
*** FLOP *** [Kd Ad 9h]
ndd1nfncBkWNitBnsfCoVQ: checks
A91IUl5JaZROhtfCtnnwYw: bets $1
ndd1nfncBkWNitBnsfCoVQ: folds
A91IUl5JaZROhtfCtnnwYw collected $0.95 from pot
A91IUl5JaZROhtfCtnnwYw: doesn't show hand
*** SUMMARY ***
Total pot $1 | Rake $0.05
Board [Kd Ad 9h]
Seat 1: ndd1nfncBkWNitBnsfCoVQ (big blind) folded on the Flop
Seat 2: A91IUl5JaZROhtfCtnnwYw (button) (small blind) collected ($0.95)



PokerStars Game #59939562134:  Hold'em No Limit ($0.25/$0.50) - 2009/07/01 0:43:04 ET
Table '+111aLuBwnz8YVYSA7J1jA' 2-max Seat #1 is the button
Seat 1: ndd1nfncBkWNitBnsfCoVQ ($84.45 in chips)
Seat 2: +ciXH35zeafrjg1W6wiBTg ($65.90 in chips)
ndd1nfncBkWNitBnsfCoVQ: posts small blind $0.25
+ciXH35zeafrjg1W6wiBTg: posts big blind $0.50
*** HOLE CARDS ***
ndd1nfncBkWNitBnsfCoVQ: raises $1 to $1.50
+ciXH35zeafrjg1W6wiBTg: raises $2 to $3.50
ndd1nfncBkWNitBnsfCoVQ: calls $2
*** FLOP *** [9d Qh Ks]
+ciXH35zeafrjg1W6wiBTg: bets $4
ndd1nfncBkWNitBnsfCoVQ: calls $4
*** TURN *** [9d Qh Ks] [6s]
+ciXH35zeafrjg1W6wiBTg: bets $10
ndd1nfncBkWNitBnsfCoVQ: folds
+ciXH35zeafrjg1W6wiBTg collected $14.50 from pot
+ciXH35zeafrjg1W6wiBTg: doesn't show hand
*** SUMMARY ***
Total pot $15 | Rake $0.50
Board [9d Qh Ks 6s]
Seat 1: ndd1nfncBkWNitBnsfCoVQ (button) (small blind) folded on the Turn
Seat 2: +ciXH35zeafrjg1W6wiBTg (big blind) collected ($14.50)



PokerStars Game #59939562290:  Hold'em No Limit ($0.25/$0.50) - 2009/07/01 0:43:04 ET
Table 'otvGDROEDdqsabxskT79qg' 9-max Seat #9 is the button
Seat 1: 8ehL7qlZzjgUh2H35iiWLw ($55.50 in chips)
Seat 2: cCjTzH9jio8607WzjcfXlg ($9.05 in chips)
Seat 3: +k7T5ocke8UwavtgUHm+Cg ($76.55 in chips)
Seat 4: MG90wfSJZnOejs/KD3vlQQ ($56.15 in chips)
Seat 5: XNMDwbXt/Q4jM99AXnbJDw ($54.30 in chips)
Seat 6: bxLSulbgr8LmKNjOzw8URg ($51.40 in chips)
Seat 7: C7+tBppJrKgd/r+tuKUIpA ($34.60 in chips)
Seat 8: zE9cVigS2nW/Ljy4K4bUQA ($30 in chips)
Seat 9: KcY3X8YpD74Kw1RHkx/g4A ($66 in chips)
8ehL7qlZzjgUh2H35iiWLw: posts small blind $0.25
cCjTzH9jio8607WzjcfXlg: posts big blind $0.50
*** HOLE CARDS ***
+k7T5ocke8UwavtgUHm+Cg: folds
MG90wfSJZnOejs/KD3vlQQ: folds
XNMDwbXt/Q4jM99AXnbJDw: folds
bxLSulbgr8LmKNjOzw8URg: folds
C7+tBppJrKgd/r+tuKUIpA: calls $0.50
zE9cVigS2nW/Ljy4K4bUQA: raises $1.50 to $2
KcY3X8YpD74Kw1RHkx/g4A: folds
8ehL7qlZzjgUh2H35iiWLw: folds
cCjTzH9jio8607WzjcfXlg: folds
C7+tBppJrKgd/r+tuKUIpA: calls $1.50
*** FLOP *** [3h 5s 6d]
C7+tBppJrKgd/r+tuKUIpA: checks
zE9cVigS2nW/Ljy4K4bUQA: bets $3
C7+tBppJrKgd/r+tuKUIpA: calls $3
*** TURN *** [3h 5s 6d] [4d]
C7+tBppJrKgd/r+tuKUIpA: checks
zE9cVigS2nW/Ljy4K4bUQA: checks
*** RIVER *** [3h 5s 6d 4d] [9h]
C7+tBppJrKgd/r+tuKUIpA: checks
zE9cVigS2nW/Ljy4K4bUQA: checks
*** SHOW DOWN ***
C7+tBppJrKgd/r+tuKUIpA: shows [Qh Qs] (a pair of Queens)
zE9cVigS2nW/Ljy4K4bUQA: mucks hand
C7+tBppJrKgd/r+tuKUIpA collected $10.25 from pot
*** SUMMARY ***
Total pot $10.75 | Rake $0.50
Board [3h 5s 6d 4d 9h]
Seat 1: 8ehL7qlZzjgUh2H35iiWLw (small blind) folded before Flop
Seat 2: cCjTzH9jio8607WzjcfXlg (big blind) folded before Flop
Seat 3: +k7T5ocke8UwavtgUHm+Cg folded before Flop (didn't bet)
Seat 4: MG90wfSJZnOejs/KD3vlQQ folded before Flop (didn't bet)
Seat 5: XNMDwbXt/Q4jM99AXnbJDw folded before Flop (didn't bet)
Seat 6: bxLSulbgr8LmKNjOzw8URg folded before Flop (didn't bet)
Seat 7: C7+tBppJrKgd/r+tuKUIpA showed [Qh Qs] and won ($10.25) with a pair of Queens
Seat 8: zE9cVigS2nW/Ljy4K4bUQA mucked
Seat 9: KcY3X8YpD74Kw1RHkx/g4A (button) folded before Flop (didn't bet)



PokerStars Game #59939563134:  Hold'em No Limit ($0.25/$0.50) - 2009/07/01 0:43:05 ET
Table '37qXEp3oe+er5q4CZip9eQ' 6-max Seat #2 is the button
Seat 1: oqOqoO2AyCZenUghCxMDxw ($58.40 in chips)
Seat 2: 6wzJiRvp8HY6t+MQGnSIzA ($27.45 in chips)
Seat 3: Rt6KgtZ8YaJoTc3FPim00w ($72.50 in chips)
Seat 4: XsmE8nXMAAMFJbWaJTmHFw ($30.20 in chips)
Seat 6: N50kln4negd8q7Mmoz1j4g ($21.35 in chips)
Rt6KgtZ8YaJoTc3FPim00w: posts small blind $0.25
XsmE8nXMAAMFJbWaJTmHFw: posts big blind $0.50
*** HOLE CARDS ***
N50kln4negd8q7Mmoz1j4g: folds
oqOqoO2AyCZenUghCxMDxw: folds
6wzJiRvp8HY6t+MQGnSIzA: calls $0.50
Rt6KgtZ8YaJoTc3FPim00w: folds
XsmE8nXMAAMFJbWaJTmHFw: checks
*** FLOP *** [Tc 3d 6h]
XsmE8nXMAAMFJbWaJTmHFw: checks
6wzJiRvp8HY6t+MQGnSIzA: checks
*** TURN *** [Tc 3d 6h] [Qs]
XsmE8nXMAAMFJbWaJTmHFw: checks
6wzJiRvp8HY6t+MQGnSIzA: bets $0.50
XsmE8nXMAAMFJbWaJTmHFw: calls $0.50
*** RIVER *** [Tc 3d 6h Qs] [6s]
XsmE8nXMAAMFJbWaJTmHFw: checks
6wzJiRvp8HY6t+MQGnSIzA: checks
*** SHOW DOWN ***
XsmE8nXMAAMFJbWaJTmHFw: shows [9h 7d] (a pair of Sixes)
6wzJiRvp8HY6t+MQGnSIzA: shows [Ad 4h] (a pair of Sixes - Ace kicker)
6wzJiRvp8HY6t+MQGnSIzA collected $2.15 from pot
*** SUMMARY ***
Total pot $2.25 | Rake $0.10
Board [Tc 3d 6h Qs 6s]
Seat 1: oqOqoO2AyCZenUghCxMDxw folded before Flop (didn't bet)
Seat 2: 6wzJiRvp8HY6t+MQGnSIzA (button) showed [Ad 4h] and won ($2.15) with a pair of Sixes
Seat 3: Rt6KgtZ8YaJoTc3FPim00w (small blind) folded before Flop
Seat 4: XsmE8nXMAAMFJbWaJTmHFw (big blind) showed [9h 7d] and lost with a pair of Sixes
Seat 6: N50kln4negd8q7Mmoz1j4g folded before Flop (didn't bet)



PokerStars Game #59939562886:  Hold'em No Limit ($0.25/$0.50) - 2009/07/01 0:43:05 ET
Table '+dXkOAQyS8j9PQZusUTMpg' 2-max Seat #2 is the button
Seat 1: XFa6sBGjP2gxoIvxR3fZIg ($48.70 in chips)
Seat 2: 5IBeOgaApY1Bvzv2P8X4EA ($155.95 in chips)
5IBeOgaApY1Bvzv2P8X4EA: posts small blind $0.25
XFa6sBGjP2gxoIvxR3fZIg: posts big blind $0.50
*** HOLE CARDS ***
5IBeOgaApY1Bvzv2P8X4EA: folds
XFa6sBGjP2gxoIvxR3fZIg collected $0.50 from pot
*** SUMMARY ***
Total pot $0.50 | Rake $0
Seat 1: XFa6sBGjP2gxoIvxR3fZIg (big blind) collected ($0.50)
Seat 2: 5IBeOgaApY1Bvzv2P8X4EA (button) (small blind) folded before Flop



PokerStars Game #59939563952:  Hold'em No Limit ($0.25/$0.50) - 2009/07/01 0:43:07 ET
Table 'fx6MqwfYAj/Rt86hBz2L3Q' 9-max Seat #9 is the button
Seat 1: SegjDnMxWMujiD57ESNL+g ($10 in chips)
Seat 2: C3rGXblctNcWI6JYPHhaEg ($15 in chips)
Seat 3: iadBi5AEt7gTBXbDSSnMYQ ($50.70 in chips)
Seat 4: gPEN9Zp33YTm/mu9/SYP1w ($21.70 in chips)
Seat 5: iAISe3dVeua8PUn2wwgDHw ($24.10 in chips)
Seat 6: 5k9fvXD9suIgCxU4HLQjTw ($50 in chips)
Seat 8: NnQCepdIR/AOUQn1yhYx6Q ($9.50 in chips)
Seat 9: HZkVla4kK2SI42CVrPZ/ig ($8.25 in chips)
SegjDnMxWMujiD57ESNL+g: posts small blind $0.25
C3rGXblctNcWI6JYPHhaEg: posts big blind $0.50
SKnJuWHScqetA/qG5p+wCg: sits out
*** HOLE CARDS ***
iadBi5AEt7gTBXbDSSnMYQ: raises $0.50 to $1
gPEN9Zp33YTm/mu9/SYP1w: folds
iAISe3dVeua8PUn2wwgDHw: folds
5k9fvXD9suIgCxU4HLQjTw: folds
NnQCepdIR/AOUQn1yhYx6Q: folds
HZkVla4kK2SI42CVrPZ/ig: folds
SegjDnMxWMujiD57ESNL+g: folds
C3rGXblctNcWI6JYPHhaEg: folds
iadBi5AEt7gTBXbDSSnMYQ collected $1.25 from pot
*** SUMMARY ***
Total pot $1.25 | Rake $0
Seat 1: SegjDnMxWMujiD57ESNL+g (small blind) folded before Flop
Seat 2: C3rGXblctNcWI6JYPHhaEg (big blind) folded before Flop
Seat 3: iadBi5AEt7gTBXbDSSnMYQ collected ($1.25)
Seat 4: gPEN9Zp33YTm/mu9/SYP1w folded before Flop (didn't bet)
Seat 5: iAISe3dVeua8PUn2wwgDHw folded before Flop (didn't bet)
Seat 6: 5k9fvXD9suIgCxU4HLQjTw folded before Flop (didn't bet)
Seat 8: NnQCepdIR/AOUQn1yhYx6Q folded before Flop (didn't bet)
Seat 9: HZkVla4kK2SI42CVrPZ/ig (button) folded before Flop (didn't bet)



PokerStars Game #59939564320:  Hold'em No Limit ($0.25/$0.50) - 2009/07/01 0:43:07 ET
Table 'tyR5AZNKV8Aadbrnrnlg7g' 6-max Seat #1 is the button
Seat 1: R+KjpH/wSjDLhtIy9+edNA ($92.35 in chips)
Seat 2: BAjwVL+zKKd0s0fAWstzQQ ($23.10 in chips)
Seat 4: Rt6KgtZ8YaJoTc3FPim00w ($131.65 in chips)
Seat 5: Ek4w9XqBXqK5jBUQeLedGw ($50 in chips)
Seat 6: ZKazl1hGaPiapDXincgi2Q ($13.55 in chips)
BAjwVL+zKKd0s0fAWstzQQ: posts small blind $0.25
tdOvWynovql5imfooroLMg: is sitting out
Rt6KgtZ8YaJoTc3FPim00w: posts big blind $0.50
*** HOLE CARDS ***
tdOvWynovql5imfooroLMg leaves the table
Ek4w9XqBXqK5jBUQeLedGw: folds
ZKazl1hGaPiapDXincgi2Q: folds
of9mtXiD8G4Nx5p7hCbgqQ joins the table at seat #3
R+KjpH/wSjDLhtIy9+edNA: raises $1 to $1.50
BAjwVL+zKKd0s0fAWstzQQ: folds
ZKazl1hGaPiapDXincgi2Q is sitting out
of9mtXiD8G4Nx5p7hCbgqQ leaves the table
Rt6KgtZ8YaJoTc3FPim00w: folds
R+KjpH/wSjDLhtIy9+edNA collected $1.25 from pot
R+KjpH/wSjDLhtIy9+edNA: doesn't show hand
*** SUMMARY ***
Total pot $1.25 | Rake $0
Seat 1: R+KjpH/wSjDLhtIy9+edNA (button) collected ($1.25)
Seat 2: BAjwVL+zKKd0s0fAWstzQQ (small blind) folded before Flop
Seat 4: Rt6KgtZ8YaJoTc3FPim00w (big blind) folded before Flop
Seat 5: Ek4w9XqBXqK5jBUQeLedGw folded before Flop (didn't bet)
Seat 6: ZKazl1hGaPiapDXincgi2Q folded before Flop (didn't bet)



PokerStars Game #59939564222:  Hold'em No Limit ($0.25/$0.50) - 2009/07/01 0:43:07 ET
Table 'NCiXr0d5CEKBQr/cZgLhbA' 9-max Seat #5 is the button
Seat 1: pFtzb1sR4b0d1aw6aIRgDg ($50 in chips)
Seat 2: ulxuJchBV9iguXg0FUonfg ($49.75 in chips)
Seat 3: xZCXQSXlrZkp3pZizzVXCw ($50.75 in chips)
Seat 4: 5k9fvXD9suIgCxU4HLQjTw ($56.70 in chips)
Seat 5: zE9cVigS2nW/Ljy4K4bUQA ($36.70 in chips)
Seat 6: SKnJuWHScqetA/qG5p+wCg ($30.25 in chips)
Seat 7: M+7+BTmX5vZatHVuoRB1nA ($46 in chips)
Seat 8: 1MJUKc3cc0QmUoz1JZLR2w ($56.50 in chips)
Seat 9: 4WLZvqBn5qv5tds5kt5A1Q ($48.05 in chips)
SKnJuWHScqetA/qG5p+wCg: posts small blind $0.25
M+7+BTmX5vZatHVuoRB1nA: posts big blind $0.50
*** HOLE CARDS ***
1MJUKc3cc0QmUoz1JZLR2w: folds
4WLZvqBn5qv5tds5kt5A1Q: calls $0.50
pFtzb1sR4b0d1aw6aIRgDg: folds
ulxuJchBV9iguXg0FUonfg: folds
xZCXQSXlrZkp3pZizzVXCw: folds
5k9fvXD9suIgCxU4HLQjTw: folds
zE9cVigS2nW/Ljy4K4bUQA: folds
SKnJuWHScqetA/qG5p+wCg: calls $0.25
M+7+BTmX5vZatHVuoRB1nA: checks
*** FLOP *** [9s 3c 8h]
SKnJuWHScqetA/qG5p+wCg: checks
M+7+BTmX5vZatHVuoRB1nA: bets $1
4WLZvqBn5qv5tds5kt5A1Q: calls $1
SKnJuWHScqetA/qG5p+wCg: folds
*** TURN *** [9s 3c 8h] [5d]
M+7+BTmX5vZatHVuoRB1nA: checks
4WLZvqBn5qv5tds5kt5A1Q: checks
*** RIVER *** [9s 3c 8h 5d] [4c]
M+7+BTmX5vZatHVuoRB1nA: bets $1
4WLZvqBn5qv5tds5kt5A1Q: folds
M+7+BTmX5vZatHVuoRB1nA collected $3.35 from pot
*** SUMMARY ***
Total pot $3.50 | Rake $0.15
Board [9s 3c 8h 5d 4c]
Seat 1: pFtzb1sR4b0d1aw6aIRgDg folded before Flop (didn't bet)
Seat 2: ulxuJchBV9iguXg0FUonfg folded before Flop (didn't bet)
Seat 3: xZCXQSXlrZkp3pZizzVXCw folded before Flop (didn't bet)
Seat 4: 5k9fvXD9suIgCxU4HLQjTw folded before Flop (didn't bet)
Seat 5: zE9cVigS2nW/Ljy4K4bUQA (button) folded before Flop (didn't bet)
Seat 6: SKnJuWHScqetA/qG5p+wCg (small blind) folded on the Flop
Seat 7: M+7+BTmX5vZatHVuoRB1nA (big blind) collected ($3.35)
Seat 8: 1MJUKc3cc0QmUoz1JZLR2w folded before Flop (didn't bet)
Seat 9: 4WLZvqBn5qv5tds5kt5A1Q folded on the River



PokerStars Game #59939564958:  Hold'em No Limit ($0.25/$0.50) - 2009/07/01 0:43:08 ET
Table 'BCN5su+SsXiy1zRMJi0SJw' 6-max Seat #5 is the button
Seat 1: crjGpJEzSZgD38FoE3VMGg ($50 in chips)
Seat 2: oU2kDCkT/gilYbHWrg7D8w ($13.65 in chips)
Seat 3: g+vwI6lMKpU2uteXSjOzVw ($20.05 in chips)
Seat 4: JY9CtoZTeav+mhWyxSSyJQ ($26.90 in chips)
Seat 5: IBNygaT1aa9Z1uPdJJilwA ($64 in chips)
Seat 6: b2symlOdL7+0c9Pj4N/KlA ($50 in chips)
b2symlOdL7+0c9Pj4N/KlA: posts small blind $0.25
crjGpJEzSZgD38FoE3VMGg: posts big blind $0.50
*** HOLE CARDS ***
oU2kDCkT/gilYbHWrg7D8w: raises $1 to $1.50
g+vwI6lMKpU2uteXSjOzVw: folds
JY9CtoZTeav+mhWyxSSyJQ: folds
IBNygaT1aa9Z1uPdJJilwA: folds
b2symlOdL7+0c9Pj4N/KlA: folds
crjGpJEzSZgD38FoE3VMGg: folds
oU2kDCkT/gilYbHWrg7D8w collected $1.25 from pot
*** SUMMARY ***
Total pot $1.25 | Rake $0
Seat 1: crjGpJEzSZgD38FoE3VMGg (big blind) folded before Flop
Seat 2: oU2kDCkT/gilYbHWrg7D8w collected ($1.25)
Seat 3: g+vwI6lMKpU2uteXSjOzVw folded before Flop (didn't bet)
Seat 4: JY9CtoZTeav+mhWyxSSyJQ folded before Flop (didn't bet)
Seat 5: IBNygaT1aa9Z1uPdJJilwA (button) folded before Flop (didn't bet)
Seat 6: b2symlOdL7+0c9Pj4N/KlA (small blind) folded before Flop



PokerStars Game #59939569672:  Hold'em No Limit ($0.25/$0.50) - 2009/07/01 0:43:15 ET
Table '+z1aekfHkpp09pc8F9aViw' 6-max Seat #3 is the button
Seat 1: FHilMb2i2DbUCc9lplszog ($30.40 in chips)
Seat 2: M6xK/VklCvdyyrmvzATlxQ ($36 in chips)
Seat 3: uUznlIMFnRUvwrBhYF73KA ($80.95 in chips)
Seat 4: RowCSpSURHTOL/dcjg/Iug ($50.30 in chips)
Seat 5: crjGpJEzSZgD38FoE3VMGg ($50 in chips)
Seat 6: 686aeHikcJlgKkSuIFdcXQ ($67.10 in chips)
RowCSpSURHTOL/dcjg/Iug: posts small blind $0.25
crjGpJEzSZgD38FoE3VMGg: posts big blind $0.50
*** HOLE CARDS ***
686aeHikcJlgKkSuIFdcXQ: folds
FHilMb2i2DbUCc9lplszog: raises $1 to $1.50
M6xK/VklCvdyyrmvzATlxQ: folds
uUznlIMFnRUvwrBhYF73KA: calls $1.50
RowCSpSURHTOL/dcjg/Iug: folds
crjGpJEzSZgD38FoE3VMGg: folds
*** FLOP *** [Kc Qd 7s]
FHilMb2i2DbUCc9lplszog: bets $2
uUznlIMFnRUvwrBhYF73KA: raises $2 to $4
FHilMb2i2DbUCc9lplszog: calls $2
*** TURN *** [Kc Qd 7s] [As]
FHilMb2i2DbUCc9lplszog: checks
uUznlIMFnRUvwrBhYF73KA: checks
*** RIVER *** [Kc Qd 7s As] [9h]
FHilMb2i2DbUCc9lplszog: bets $8
uUznlIMFnRUvwrBhYF73KA: folds
FHilMb2i2DbUCc9lplszog collected $11.20 from pot
*** SUMMARY ***
Total pot $11.75 | Rake $0.55
Board [Kc Qd 7s As 9h]
Seat 1: FHilMb2i2DbUCc9lplszog collected ($11.20)
Seat 2: M6xK/VklCvdyyrmvzATlxQ folded before Flop (didn't bet)
Seat 3: uUznlIMFnRUvwrBhYF73KA (button) folded on the River
Seat 4: RowCSpSURHTOL/dcjg/Iug (small blind) folded before Flop
Seat 5: crjGpJEzSZgD38FoE3VMGg (big blind) folded before Flop
Seat 6: 686aeHikcJlgKkSuIFdcXQ folded before Flop (didn't bet)



PokerStars Game #59939569356:  Hold'em No Limit ($0.25/$0.50) - 2009/07/01 0:43:15 ET
Table 'QOeVnLhwctF9UyV/beDi+A' 2-max Seat #2 is the button
Seat 1: bypIyrYcAAifLfhZpGlKLA ($56.20 in chips)
Seat 2: Ucrm3XtZmoONapW32SPhag ($27.65 in chips)
Ucrm3XtZmoONapW32SPhag: posts small blind $0.25
bypIyrYcAAifLfhZpGlKLA: posts big blind $0.50
*** HOLE CARDS ***
Ucrm3XtZmoONapW32SPhag: calls $0.25
bypIyrYcAAifLfhZpGlKLA: raises $1.50 to $2
Ucrm3XtZmoONapW32SPhag: calls $1.50
*** FLOP *** [2s Jd 4c]
bypIyrYcAAifLfhZpGlKLA: bets $2.50
Ucrm3XtZmoONapW32SPhag: folds
bypIyrYcAAifLfhZpGlKLA collected $3.80 from pot
bypIyrYcAAifLfhZpGlKLA: doesn't show hand
*** SUMMARY ***
Total pot $4 | Rake $0.20
Board [2s Jd 4c]
Seat 1: bypIyrYcAAifLfhZpGlKLA (big blind) collected ($3.80)
Seat 2: Ucrm3XtZmoONapW32SPhag (button) (small blind) folded on the Flop



PokerStars Game #59939569168:  Hold'em No Limit ($0.25/$0.50) - 2009/07/01 0:43:15 ET
Table '+dXkOAQyS8j9PQZusUTMpg' 2-max Seat #1 is the button
Seat 1: XFa6sBGjP2gxoIvxR3fZIg ($48.95 in chips)
Seat 2: 5IBeOgaApY1Bvzv2P8X4EA ($155.70 in chips)
XFa6sBGjP2gxoIvxR3fZIg: posts small blind $0.25
5IBeOgaApY1Bvzv2P8X4EA: posts big blind $0.50
*** HOLE CARDS ***
XFa6sBGjP2gxoIvxR3fZIg: raises $1 to $1.50
5IBeOgaApY1Bvzv2P8X4EA: calls $1
*** FLOP *** [Ts Kc Jc]
5IBeOgaApY1Bvzv2P8X4EA: checks
XFa6sBGjP2gxoIvxR3fZIg: bets $2
5IBeOgaApY1Bvzv2P8X4EA: calls $2
*** TURN *** [Ts Kc Jc] [5c]
5IBeOgaApY1Bvzv2P8X4EA: checks
XFa6sBGjP2gxoIvxR3fZIg: checks
*** RIVER *** [Ts Kc Jc 5c] [5h]
5IBeOgaApY1Bvzv2P8X4EA: bets $2.50
XFa6sBGjP2gxoIvxR3fZIg: raises $14 to $16.50
5IBeOgaApY1Bvzv2P8X4EA: folds
XFa6sBGjP2gxoIvxR3fZIg collected $11.50 from pot
XFa6sBGjP2gxoIvxR3fZIg: doesn't show hand
*** SUMMARY ***
Total pot $12 | Rake $0.50
Board [Ts Kc Jc 5c 5h]
Seat 1: XFa6sBGjP2gxoIvxR3fZIg (button) (small blind) collected ($11.50)
Seat 2: 5IBeOgaApY1Bvzv2P8X4EA (big blind) folded on the River



PokerStars Game #59939569286:  Hold'em No Limit ($0.25/$0.50) - 2009/07/01 0:43:15 ET
Table 'MJxeZCzYELxiIsyUZyT0jw' 6-max Seat #3 is the button
Seat 2: dB6jzDlJmET84VMWw1mTRA ($52.80 in chips)
Seat 3: JQZew0FjzS19kTjeNtrE+A ($52.80 in chips)
Seat 4: alGiiQP/wwtYnfuXII+sgw ($45 in chips)
Seat 5: 3jvoOXNtXE90w2BdfNZwZQ ($52 in chips)
Seat 6: TTx3CHxyi0SObcHyMJRp5w ($59.20 in chips)
alGiiQP/wwtYnfuXII+sgw: posts small blind $0.25
3jvoOXNtXE90w2BdfNZwZQ: posts big blind $0.50
*** HOLE CARDS ***
TTx3CHxyi0SObcHyMJRp5w: folds
dB6jzDlJmET84VMWw1mTRA: folds
JQZew0FjzS19kTjeNtrE+A: calls $0.50
alGiiQP/wwtYnfuXII+sgw: calls $0.25
3jvoOXNtXE90w2BdfNZwZQ: checks
*** FLOP *** [8h 4d 3d]
alGiiQP/wwtYnfuXII+sgw: bets $1
3jvoOXNtXE90w2BdfNZwZQ: folds
jNIq+EZLEm61oWSMYUVeWQ joins the table at seat #1
JQZew0FjzS19kTjeNtrE+A: folds
alGiiQP/wwtYnfuXII+sgw collected $1.45 from pot
*** SUMMARY ***
Total pot $1.50 | Rake $0.05
Board [8h 4d 3d]
Seat 2: dB6jzDlJmET84VMWw1mTRA folded before Flop (didn't bet)
Seat 3: JQZew0FjzS19kTjeNtrE+A (button) folded on the Flop
Seat 4: alGiiQP/wwtYnfuXII+sgw (small blind) collected ($1.45)
Seat 5: 3jvoOXNtXE90w2BdfNZwZQ (big blind) folded on the Flop
Seat 6: TTx3CHxyi0SObcHyMJRp5w folded before Flop (didn't bet)



PokerStars Game #59939571204:  Hold'em No Limit ($0.25/$0.50) - 2009/07/01 0:43:18 ET
Table 'lSisgp6H7Fg1hH5VfjEjYQ' 9-max Seat #1 is the button
Seat 1: 5k9fvXD9suIgCxU4HLQjTw ($50 in chips)
Seat 2: UrcnkQOiLVk8BlKDPJSy7Q ($50.25 in chips)
Seat 3: aTkyjTh3w5YLWiIERupZOA ($42.45 in chips)
Seat 4: bwv/rbH/hHhPhY6u9mu04w ($43.50 in chips)
Seat 5: mSD1pginDsyHG5PDfqzphw ($11.35 in chips)
Seat 6: +k7T5ocke8UwavtgUHm+Cg ($29.30 in chips)
Seat 7: Y3DZ6qQlLeBhixDj4M9vmg ($10.80 in chips)
Seat 8: a4JDWmpFQkL10XfAyuF51A ($33.75 in chips)
Seat 9: gsyXT42WLEcOS4DdEk2wlw ($30.20 in chips)
UrcnkQOiLVk8BlKDPJSy7Q: posts small blind $0.25
aTkyjTh3w5YLWiIERupZOA: posts big blind $0.50
*** HOLE CARDS ***
bwv/rbH/hHhPhY6u9mu04w: folds
mSD1pginDsyHG5PDfqzphw: raises $1 to $1.50
+k7T5ocke8UwavtgUHm+Cg: folds
Y3DZ6qQlLeBhixDj4M9vmg: folds
a4JDWmpFQkL10XfAyuF51A: folds
gsyXT42WLEcOS4DdEk2wlw: folds
5k9fvXD9suIgCxU4HLQjTw: folds
UrcnkQOiLVk8BlKDPJSy7Q: folds
aTkyjTh3w5YLWiIERupZOA: folds
mSD1pginDsyHG5PDfqzphw collected $1.25 from pot
mSD1pginDsyHG5PDfqzphw: doesn't show hand
*** SUMMARY ***
Total pot $1.25 | Rake $0
Seat 1: 5k9fvXD9suIgCxU4HLQjTw (button) folded before Flop (didn't bet)
Seat 2: UrcnkQOiLVk8BlKDPJSy7Q (small blind) folded before Flop
Seat 3: aTkyjTh3w5YLWiIERupZOA (big blind) folded before Flop
Seat 4: bwv/rbH/hHhPhY6u9mu04w folded before Flop (didn't bet)
Seat 5: mSD1pginDsyHG5PDfqzphw collected ($1.25)
Seat 6: +k7T5ocke8UwavtgUHm+Cg folded before Flop (didn't bet)
Seat 7: Y3DZ6qQlLeBhixDj4M9vmg folded before Flop (didn't bet)
Seat 8: a4JDWmpFQkL10XfAyuF51A folded before Flop (didn't bet)
Seat 9: gsyXT42WLEcOS4DdEk2wlw folded before Flop (didn't bet)



PokerStars Game #59939571616:  Hold'em No Limit ($0.25/$0.50) - 2009/07/01 0:43:18 ET
Table 'c/CRn+68J3Y8KxD5g1ek2Q' 2-max Seat #1 is the button
Seat 1: 46qCyJ6evTkHo9al5sBMNA ($218.95 in chips)
Seat 2: BypVLsYQt3ePFm2xQL/dOA ($155.40 in chips)
46qCyJ6evTkHo9al5sBMNA: posts small blind $0.25
BypVLsYQt3ePFm2xQL/dOA: posts big blind $0.50
*** HOLE CARDS ***
46qCyJ6evTkHo9al5sBMNA: folds
BypVLsYQt3ePFm2xQL/dOA collected $0.50 from pot
BypVLsYQt3ePFm2xQL/dOA: doesn't show hand
*** SUMMARY ***
Total pot $0.50 | Rake $0
Seat 1: 46qCyJ6evTkHo9al5sBMNA (button) (small blind) folded before Flop
Seat 2: BypVLsYQt3ePFm2xQL/dOA (big blind) collected ($0.50)



PokerStars Game #59939572088:  Hold'em No Limit ($0.25/$0.50) - 2009/07/01 0:43:19 ET
Table 'IeNZOZQ4T6oiaHqFeo6yIA' 2-max Seat #1 is the button
Seat 1: ndd1nfncBkWNitBnsfCoVQ ($49.50 in chips)
Seat 2: A91IUl5JaZROhtfCtnnwYw ($121.85 in chips)
ndd1nfncBkWNitBnsfCoVQ: posts small blind $0.25
A91IUl5JaZROhtfCtnnwYw: posts big blind $0.50
*** HOLE CARDS ***
ndd1nfncBkWNitBnsfCoVQ: raises $1 to $1.50
A91IUl5JaZROhtfCtnnwYw: calls $1
*** FLOP *** [9d As 5c]
A91IUl5JaZROhtfCtnnwYw: checks
ndd1nfncBkWNitBnsfCoVQ: checks
*** TURN *** [9d As 5c] [4s]
A91IUl5JaZROhtfCtnnwYw: checks
ndd1nfncBkWNitBnsfCoVQ: checks
*** RIVER *** [9d As 5c 4s] [Ac]
A91IUl5JaZROhtfCtnnwYw: bets $2.50
ndd1nfncBkWNitBnsfCoVQ: folds
A91IUl5JaZROhtfCtnnwYw collected $2.85 from pot
A91IUl5JaZROhtfCtnnwYw: doesn't show hand
*** SUMMARY ***
Total pot $3 | Rake $0.15
Board [9d As 5c 4s Ac]
Seat 1: ndd1nfncBkWNitBnsfCoVQ (button) (small blind) folded on the River
Seat 2: A91IUl5JaZROhtfCtnnwYw (big blind) collected ($2.85)



PokerStars Game #59939572194:  Hold'em No Limit ($0.25/$0.50) - 2009/07/01 0:43:19 ET
Table 'T/PgNWqVyY6lkldcBVXYJQ' 6-max Seat #2 is the button
Seat 1: +Pf9jTVizYlIo+woPvptfA ($55.75 in chips)
Seat 2: LvH4G7n+QSjT6NDaD3cREA ($75 in chips)
Seat 3: L3OcNO1bgdqDI46j67KQPQ ($53.35 in chips)
Seat 4: Ek4w9XqBXqK5jBUQeLedGw ($50 in chips)
Seat 5: vVQBckETtigfb5mAcyK0OA ($56.70 in chips)
Seat 6: cDzbog6kwmJp+LBeBq+iMQ ($20.65 in chips)
L3OcNO1bgdqDI46j67KQPQ: posts small blind $0.25
Ek4w9XqBXqK5jBUQeLedGw: posts big blind $0.50
*** HOLE CARDS ***
vVQBckETtigfb5mAcyK0OA: calls $0.50
cDzbog6kwmJp+LBeBq+iMQ said, "geeez 2 ****ingawful hands"
cDzbog6kwmJp+LBeBq+iMQ: raises $0.50 to $1
+Pf9jTVizYlIo+woPvptfA: folds
LvH4G7n+QSjT6NDaD3cREA: folds
L3OcNO1bgdqDI46j67KQPQ: calls $0.75
Ek4w9XqBXqK5jBUQeLedGw: folds
vVQBckETtigfb5mAcyK0OA said, "suck out on the river every time at poker stars"
vVQBckETtigfb5mAcyK0OA: calls $0.50
*** FLOP *** [Kc 2h Js]
LvH4G7n+QSjT6NDaD3cREA said, "I thought it worked out pretty good."
L3OcNO1bgdqDI46j67KQPQ: bets $2
vVQBckETtigfb5mAcyK0OA: folds
cDzbog6kwmJp+LBeBq+iMQ: calls $2
*** TURN *** [Kc 2h Js] [Ad]
L3OcNO1bgdqDI46j67KQPQ: bets $4
cDzbog6kwmJp+LBeBq+iMQ: calls $4
*** RIVER *** [Kc 2h Js Ad] [Ts]
L3OcNO1bgdqDI46j67KQPQ: checks
cDzbog6kwmJp+LBeBq+iMQ: bets $13.65 and is all-in
L3OcNO1bgdqDI46j67KQPQ: folds
cDzbog6kwmJp+LBeBq+iMQ collected $14.75 from pot
*** SUMMARY ***
Total pot $15.50 | Rake $0.75
Board [Kc 2h Js Ad Ts]
Seat 1: +Pf9jTVizYlIo+woPvptfA folded before Flop (didn't bet)
Seat 2: LvH4G7n+QSjT6NDaD3cREA (button) folded before Flop (didn't bet)
Seat 3: L3OcNO1bgdqDI46j67KQPQ (small blind) folded on the River
Seat 4: Ek4w9XqBXqK5jBUQeLedGw (big blind) folded before Flop
Seat 5: vVQBckETtigfb5mAcyK0OA folded on the Flop
Seat 6: cDzbog6kwmJp+LBeBq+iMQ collected ($14.75)



PokerStars Game #59939571816:  Hold'em No Limit ($0.25/$0.50) - 2009/07/01 0:43:19 ET
Table 'hSTs/dUsYLgJQuF2Onp0MQ' 6-max Seat #4 is the button
Seat 2: 6vNxrjjCl6FwfaaymM9jjg ($4.30 in chips)
Seat 3: C3qJBo7uxfFVDluE1lmK2w ($66.65 in chips)
Seat 4: L0aIPg7qefDQjdJo3HCVEA ($7.55 in chips)
Seat 5: 686aeHikcJlgKkSuIFdcXQ ($60.95 in chips)
Seat 6: w0pd++ZQHijd9dDhKEYOAQ ($30.40 in chips)
686aeHikcJlgKkSuIFdcXQ: posts small blind $0.25
w0pd++ZQHijd9dDhKEYOAQ: posts big blind $0.50
1WUCqNG+p+vfWRTXNu4ljw: sits out
*** HOLE CARDS ***
6vNxrjjCl6FwfaaymM9jjg: raises $3.80 to $4.30 and is all-in
C3qJBo7uxfFVDluE1lmK2w: folds
L0aIPg7qefDQjdJo3HCVEA: folds
686aeHikcJlgKkSuIFdcXQ: folds
w0pd++ZQHijd9dDhKEYOAQ: folds
w0pd++ZQHijd9dDhKEYOAQ leaves the table
6vNxrjjCl6FwfaaymM9jjg collected $1.25 from pot
*** SUMMARY ***
Total pot $1.25 | Rake $0
Seat 2: 6vNxrjjCl6FwfaaymM9jjg collected ($1.25)
Seat 3: C3qJBo7uxfFVDluE1lmK2w folded before Flop (didn't bet)
Seat 4: L0aIPg7qefDQjdJo3HCVEA (button) folded before Flop (didn't bet)
Seat 5: 686aeHikcJlgKkSuIFdcXQ (small blind) folded before Flop
Seat 6: w0pd++ZQHijd9dDhKEYOAQ (big blind) folded before Flop



PokerStars Game #59939573344:  Hold'em No Limit ($0.25/$0.50) - 2009/07/01 0:43:21 ET
Table '5EmHi+fnatGQQShcNmzOZQ' 6-max Seat #5 is the button
Seat 1: +SZCX3+7lnuhHKIu+PP9rg ($31.10 in chips)
Seat 2: vXIHnZ+dv/hwSBxyvGw7bQ ($78.35 in chips)
Seat 3: L9qfLYXrczhAPd/VckgsWw ($80 in chips)
Seat 4: 1b+2BbjMN8qhR1WPqdE9VQ ($53.65 in chips)
Seat 5: kxPhs4ePFqMy52CInAJ2aw ($54.60 in chips)
Seat 6: 686aeHikcJlgKkSuIFdcXQ ($141.45 in chips)
686aeHikcJlgKkSuIFdcXQ: posts small blind $0.25
+SZCX3+7lnuhHKIu+PP9rg: posts big blind $0.50
*** HOLE CARDS ***
vXIHnZ+dv/hwSBxyvGw7bQ: folds
L9qfLYXrczhAPd/VckgsWw: folds
1b+2BbjMN8qhR1WPqdE9VQ: folds
kxPhs4ePFqMy52CInAJ2aw: raises $1.50 to $2
686aeHikcJlgKkSuIFdcXQ: folds
+SZCX3+7lnuhHKIu+PP9rg: folds
kxPhs4ePFqMy52CInAJ2aw collected $1.25 from pot
kxPhs4ePFqMy52CInAJ2aw: doesn't show hand
*** SUMMARY ***
Total pot $1.25 | Rake $0
Seat 1: +SZCX3+7lnuhHKIu+PP9rg (big blind) folded before Flop
Seat 2: vXIHnZ+dv/hwSBxyvGw7bQ folded before Flop (didn't bet)
Seat 3: L9qfLYXrczhAPd/VckgsWw folded before Flop (didn't bet)
Seat 4: 1b+2BbjMN8qhR1WPqdE9VQ folded before Flop (didn't bet)
Seat 5: kxPhs4ePFqMy52CInAJ2aw (button) collected ($1.25)
Seat 6: 686aeHikcJlgKkSuIFdcXQ (small blind) folded before Flop



PokerStars Game #59939574902:  Hold'em No Limit ($0.25/$0.50) - 2009/07/01 0:43:23 ET
Table '3FhG0gl3kMX3wBEEqj+wnQ' 9-max Seat #6 is the button
Seat 1: e0J9pdCNUDTCG031RnXqLA ($23.40 in chips)
Seat 2: 7cYQ+syUWjl38ty/ICOMhw ($47.85 in chips)
Seat 4: bjvJtA9Hqscfznq66txaOQ ($7 in chips)
Seat 5: gsyXT42WLEcOS4DdEk2wlw ($28 in chips)
Seat 6: 997ViqAtWn1FPjJqcffwcA ($50 in chips)
Seat 7: mSD1pginDsyHG5PDfqzphw ($11.75 in chips)
Seat 8: j3K/Jujr7PY4ZM2RZvlH6A ($48.80 in chips)
Seat 9: L5e2lrPLQm1Pqx30IIZ/Fw ($10.75 in chips)
mSD1pginDsyHG5PDfqzphw: posts small blind $0.25
j3K/Jujr7PY4ZM2RZvlH6A: posts big blind $0.50
k1f0lS7tlMHCLGs0JT34Tg: sits out
*** HOLE CARDS ***
L5e2lrPLQm1Pqx30IIZ/Fw: folds
e0J9pdCNUDTCG031RnXqLA: folds
7cYQ+syUWjl38ty/ICOMhw: folds
bjvJtA9Hqscfznq66txaOQ: folds
gsyXT42WLEcOS4DdEk2wlw: folds
997ViqAtWn1FPjJqcffwcA: folds
mSD1pginDsyHG5PDfqzphw: folds
j3K/Jujr7PY4ZM2RZvlH6A collected $0.50 from pot
j3K/Jujr7PY4ZM2RZvlH6A: doesn't show hand
*** SUMMARY ***
Total pot $0.50 | Rake $0
Seat 1: e0J9pdCNUDTCG031RnXqLA folded before Flop (didn't bet)
Seat 2: 7cYQ+syUWjl38ty/ICOMhw folded before Flop (didn't bet)
Seat 4: bjvJtA9Hqscfznq66txaOQ folded before Flop (didn't bet)
Seat 5: gsyXT42WLEcOS4DdEk2wlw folded before Flop (didn't bet)
Seat 6: 997ViqAtWn1FPjJqcffwcA (button) folded before Flop (didn't bet)
Seat 7: mSD1pginDsyHG5PDfqzphw (small blind) folded before Flop
Seat 8: j3K/Jujr7PY4ZM2RZvlH6A (big blind) collected ($0.50)
Seat 9: L5e2lrPLQm1Pqx30IIZ/Fw folded before Flop (didn't bet)



PokerStars Game #59939575592:  Hold'em No Limit ($0.25/$0.50) - 2009/07/01 0:43:25 ET
Table 'X6IRCRTh+20gjz8aubWnwA' 9-max Seat #6 is the button
Seat 1: DSM67hHHq1XFoEOi9p8Alw ($50.80 in chips)
Seat 2: HZkVla4kK2SI42CVrPZ/ig ($11.55 in chips)
Seat 3: GeZ7AYmAZ9Ln8liPZzV8EA ($24.35 in chips)
Seat 4: 2J+UVOVrW+V3maOylyxMcQ ($37.70 in chips)
Seat 5: NnQCepdIR/AOUQn1yhYx6Q ($9.25 in chips)
Seat 6: /6In1zC3WtgwxDcueWzZWg ($68.40 in chips)
Seat 7: cFHQjKQOOKTUzoilhrXHLg ($35.25 in chips)
Seat 9: M+7+BTmX5vZatHVuoRB1nA ($69.25 in chips)
cFHQjKQOOKTUzoilhrXHLg: posts small blind $0.25
M+7+BTmX5vZatHVuoRB1nA: posts big blind $0.50
*** HOLE CARDS ***
HxeBVq06/3Bh/H986sgdbw has returned
DSM67hHHq1XFoEOi9p8Alw: folds
HZkVla4kK2SI42CVrPZ/ig: folds
GeZ7AYmAZ9Ln8liPZzV8EA: folds
2J+UVOVrW+V3maOylyxMcQ: folds
NnQCepdIR/AOUQn1yhYx6Q: raises $1.50 to $2
/6In1zC3WtgwxDcueWzZWg: folds
cFHQjKQOOKTUzoilhrXHLg: folds
M+7+BTmX5vZatHVuoRB1nA: folds
NnQCepdIR/AOUQn1yhYx6Q collected $1.25 from pot
*** SUMMARY ***
Total pot $1.25 | Rake $0
Seat 1: DSM67hHHq1XFoEOi9p8Alw folded before Flop (didn't bet)
Seat 2: HZkVla4kK2SI42CVrPZ/ig folded before Flop (didn't bet)
Seat 3: GeZ7AYmAZ9Ln8liPZzV8EA folded before Flop (didn't bet)
Seat 4: 2J+UVOVrW+V3maOylyxMcQ folded before Flop (didn't bet)
Seat 5: NnQCepdIR/AOUQn1yhYx6Q collected ($1.25)
Seat 6: /6In1zC3WtgwxDcueWzZWg (button) folded before Flop (didn't bet)
Seat 7: cFHQjKQOOKTUzoilhrXHLg (small blind) folded before Flop
Seat 9: M+7+BTmX5vZatHVuoRB1nA (big blind) folded before Flop



PokerStars Game #59939575898:  Hold'em No Limit ($0.25/$0.50) - 2009/07/01 0:43:25 ET
Table 'c/CRn+68J3Y8KxD5g1ek2Q' 2-max Seat #2 is the button
Seat 1: 46qCyJ6evTkHo9al5sBMNA ($218.70 in chips)
Seat 2: BypVLsYQt3ePFm2xQL/dOA ($155.65 in chips)
BypVLsYQt3ePFm2xQL/dOA: posts small blind $0.25
46qCyJ6evTkHo9al5sBMNA: posts big blind $0.50
*** HOLE CARDS ***
BypVLsYQt3ePFm2xQL/dOA: raises $0.50 to $1
46qCyJ6evTkHo9al5sBMNA: folds
BypVLsYQt3ePFm2xQL/dOA collected $1 from pot
BypVLsYQt3ePFm2xQL/dOA: doesn't show hand
*** SUMMARY ***
Total pot $1 | Rake $0
Seat 1: 46qCyJ6evTkHo9al5sBMNA (big blind) folded before Flop
Seat 2: BypVLsYQt3ePFm2xQL/dOA (button) (small blind) collected ($1)



PokerStars Game #59939576460:  Hold'em No Limit ($0.25/$0.50) - 2009/07/01 0:43:26 ET
Table 'E7bWJ45aoFXRpyRv2gw+Ig' 2-max Seat #2 is the button
Seat 1: FRkiRasEGlHUeLrEl+k/nA ($72.05 in chips)
Seat 2: 3Wro85I7472vJ4Wkpneo9A ($123.90 in chips)
3Wro85I7472vJ4Wkpneo9A: posts small blind $0.25
FRkiRasEGlHUeLrEl+k/nA: posts big blind $0.50
*** HOLE CARDS ***
3Wro85I7472vJ4Wkpneo9A: calls $0.25
FRkiRasEGlHUeLrEl+k/nA: checks
*** FLOP *** [Ad 2s 9d]
FRkiRasEGlHUeLrEl+k/nA: checks
3Wro85I7472vJ4Wkpneo9A: checks
*** TURN *** [Ad 2s 9d] [6s]
FRkiRasEGlHUeLrEl+k/nA: checks
3Wro85I7472vJ4Wkpneo9A: checks
*** RIVER *** [Ad 2s 9d 6s] [7c]
FRkiRasEGlHUeLrEl+k/nA: bets $1.50
3Wro85I7472vJ4Wkpneo9A: folds
FRkiRasEGlHUeLrEl+k/nA collected $0.95 from pot
*** SUMMARY ***
Total pot $1 | Rake $0.05
Board [Ad 2s 9d 6s 7c]
Seat 1: FRkiRasEGlHUeLrEl+k/nA (big blind) collected ($0.95)
Seat 2: 3Wro85I7472vJ4Wkpneo9A (button) (small blind) folded on the River



PokerStars Game #59939577454:  Hold'em No Limit ($0.25/$0.50) - 2009/07/01 0:43:27 ET
Table 'hWT2kq66tnKEpD26cia6fQ' 2-max Seat #1 is the button
Seat 1: q+vRKwm51mnr6kxX/161WQ ($44.45 in chips)
Seat 2: dkC7J+qbyqk0qCcmJbEPPw ($68.55 in chips)
q+vRKwm51mnr6kxX/161WQ: posts small blind $0.25
dkC7J+qbyqk0qCcmJbEPPw: posts big blind $0.50
*** HOLE CARDS ***
q+vRKwm51mnr6kxX/161WQ: raises $1 to $1.50
dkC7J+qbyqk0qCcmJbEPPw: raises $3.50 to $5
q+vRKwm51mnr6kxX/161WQ: calls $3.50
*** FLOP *** [3c 9h 2h]
dkC7J+qbyqk0qCcmJbEPPw: bets $7
q+vRKwm51mnr6kxX/161WQ: raises $32.45 to $39.45 and is all-in
dkC7J+qbyqk0qCcmJbEPPw: folds
q+vRKwm51mnr6kxX/161WQ collected $23.50 from pot
q+vRKwm51mnr6kxX/161WQ: doesn't show hand
*** SUMMARY ***
Total pot $24 | Rake $0.50
Board [3c 9h 2h]
Seat 1: q+vRKwm51mnr6kxX/161WQ (button) (small blind) collected ($23.50)
Seat 2: dkC7J+qbyqk0qCcmJbEPPw (big blind) folded on the Flop



PokerStars Game #59939577304:  Hold'em No Limit ($0.25/$0.50) - 2009/07/01 0:43:27 ET
Table 'BCN5su+SsXiy1zRMJi0SJw' 6-max Seat #6 is the button
Seat 1: crjGpJEzSZgD38FoE3VMGg ($50 in chips)
Seat 2: oU2kDCkT/gilYbHWrg7D8w ($14.40 in chips)
Seat 3: g+vwI6lMKpU2uteXSjOzVw ($20.05 in chips)
Seat 4: JY9CtoZTeav+mhWyxSSyJQ ($26.90 in chips)
Seat 5: IBNygaT1aa9Z1uPdJJilwA ($64 in chips)
Seat 6: b2symlOdL7+0c9Pj4N/KlA ($50 in chips)
crjGpJEzSZgD38FoE3VMGg: posts small blind $0.25
oU2kDCkT/gilYbHWrg7D8w: posts big blind $0.50
*** HOLE CARDS ***
g+vwI6lMKpU2uteXSjOzVw: folds
JY9CtoZTeav+mhWyxSSyJQ: folds
IBNygaT1aa9Z1uPdJJilwA: folds
b2symlOdL7+0c9Pj4N/KlA: raises $1 to $1.50
crjGpJEzSZgD38FoE3VMGg: folds
oU2kDCkT/gilYbHWrg7D8w: calls $1
*** FLOP *** [Ah Tc 7s]
oU2kDCkT/gilYbHWrg7D8w: checks
b2symlOdL7+0c9Pj4N/KlA: bets $2.50
oU2kDCkT/gilYbHWrg7D8w: folds
b2symlOdL7+0c9Pj4N/KlA collected $3.10 from pot
b2symlOdL7+0c9Pj4N/KlA: doesn't show hand
*** SUMMARY ***
Total pot $3.25 | Rake $0.15
Board [Ah Tc 7s]
Seat 1: crjGpJEzSZgD38FoE3VMGg (small blind) folded before Flop
Seat 2: oU2kDCkT/gilYbHWrg7D8w (big blind) folded on the Flop
Seat 3: g+vwI6lMKpU2uteXSjOzVw folded before Flop (didn't bet)
Seat 4: JY9CtoZTeav+mhWyxSSyJQ folded before Flop (didn't bet)
Seat 5: IBNygaT1aa9Z1uPdJJilwA folded before Flop (didn't bet)
Seat 6: b2symlOdL7+0c9Pj4N/KlA (button) collected ($3.10)



PokerStars Game #59939576858:  Hold'em No Limit ($0.25/$0.50) - 2009/07/01 0:43:27 ET
Table 'QOgaEqMcJ73pcUMMxoisUg' 6-max Seat #3 is the button
Seat 1: OZ6OtYh5Y53MCH/p0QTn5g ($110.90 in chips)
Seat 2: 4QfsCWthT/vSLirorNXqtg ($50 in chips)
Seat 3: Rt6KgtZ8YaJoTc3FPim00w ($76.75 in chips)
Seat 4: zAcsDhG/T128Vn7XGVSgKg ($50 in chips)
Seat 5: 6vNxrjjCl6FwfaaymM9jjg ($12.75 in chips)
Seat 6: pmE+2KJb4nffAVqjLIXxFg ($24.20 in chips)
zAcsDhG/T128Vn7XGVSgKg: posts small blind $0.25
6vNxrjjCl6FwfaaymM9jjg: posts big blind $0.50
*** HOLE CARDS ***
pmE+2KJb4nffAVqjLIXxFg: folds
OZ6OtYh5Y53MCH/p0QTn5g: raises $1.50 to $2
4QfsCWthT/vSLirorNXqtg: folds
Rt6KgtZ8YaJoTc3FPim00w: folds
zAcsDhG/T128Vn7XGVSgKg: folds
6vNxrjjCl6FwfaaymM9jjg: raises $5 to $7
OZ6OtYh5Y53MCH/p0QTn5g: folds
6vNxrjjCl6FwfaaymM9jjg collected $4.25 from pot
*** SUMMARY ***
Total pot $4.25 | Rake $0
Seat 1: OZ6OtYh5Y53MCH/p0QTn5g folded before Flop
Seat 2: 4QfsCWthT/vSLirorNXqtg folded before Flop (didn't bet)
Seat 3: Rt6KgtZ8YaJoTc3FPim00w (button) folded before Flop (didn't bet)
Seat 4: zAcsDhG/T128Vn7XGVSgKg (small blind) folded before Flop
Seat 5: 6vNxrjjCl6FwfaaymM9jjg (big blind) collected ($4.25)
Seat 6: pmE+2KJb4nffAVqjLIXxFg folded before Flop (didn't bet)



PokerStars Game #59939578894:  Hold'em No Limit ($0.25/$0.50) - 2009/07/01 0:43:30 ET
Table '+111aLuBwnz8YVYSA7J1jA' 2-max Seat #2 is the button
Seat 1: ndd1nfncBkWNitBnsfCoVQ ($76.95 in chips)
Seat 2: +ciXH35zeafrjg1W6wiBTg ($72.90 in chips)
+ciXH35zeafrjg1W6wiBTg: posts small blind $0.25
ndd1nfncBkWNitBnsfCoVQ: posts big blind $0.50
*** HOLE CARDS ***
+ciXH35zeafrjg1W6wiBTg: raises $1.50 to $2
ndd1nfncBkWNitBnsfCoVQ: folds
+ciXH35zeafrjg1W6wiBTg collected $1 from pot
+ciXH35zeafrjg1W6wiBTg: doesn't show hand
*** SUMMARY ***
Total pot $1 | Rake $0
Seat 1: ndd1nfncBkWNitBnsfCoVQ (big blind) folded before Flop
Seat 2: +ciXH35zeafrjg1W6wiBTg (button) (small blind) collected ($1)



PokerStars Game #59939580626:  Hold'em No Limit ($0.25/$0.50) - 2009/07/01 0:43:32 ET
Table 'c/CRn+68J3Y8KxD5g1ek2Q' 2-max Seat #1 is the button
Seat 1: 46qCyJ6evTkHo9al5sBMNA ($218.20 in chips)
Seat 2: BypVLsYQt3ePFm2xQL/dOA ($156.15 in chips)
46qCyJ6evTkHo9al5sBMNA: posts small blind $0.25
BypVLsYQt3ePFm2xQL/dOA: posts big blind $0.50
*** HOLE CARDS ***
46qCyJ6evTkHo9al5sBMNA: raises $1 to $1.50
BypVLsYQt3ePFm2xQL/dOA: raises $4 to $5.50
46qCyJ6evTkHo9al5sBMNA: folds
BypVLsYQt3ePFm2xQL/dOA collected $3 from pot
BypVLsYQt3ePFm2xQL/dOA: doesn't show hand
*** SUMMARY ***
Total pot $3 | Rake $0
Seat 1: 46qCyJ6evTkHo9al5sBMNA (button) (small blind) folded before Flop
Seat 2: BypVLsYQt3ePFm2xQL/dOA (big blind) collected ($3)



PokerStars Game #59939580406:  Hold'em No Limit ($0.25/$0.50) - 2009/07/01 0:43:32 ET
Table '/cQuAT3ef4t+PGrXiNhGaQ' 9-max Seat #2 is the button
Seat 1: HZkVla4kK2SI42CVrPZ/ig ($5.25 in chips)
Seat 2: jXGruyaMqirTaTXNOvBdew ($71.10 in chips)
Seat 3: g4k0NXISyLCqaSWZDBjfEg ($53.90 in chips)
Seat 4: OWP/DOu+PlPK6ZZ3zYa0HA ($32.40 in chips)
Seat 5: 5SgaHdWixdClWvaEG+KUjQ ($26.35 in chips)
Seat 6: APYIOyK/4AGb+kIwlOUNBQ ($39 in chips)
Seat 7: J0W5D97jl5VLky+IoPvDeA ($114.15 in chips)
Seat 8: W3ingbA178eb7J5rt1PuIQ ($37.10 in chips)
Seat 9: AjV5McH1KMMclY26QdLM5w ($26.50 in chips)
g4k0NXISyLCqaSWZDBjfEg: posts small blind $0.25
OWP/DOu+PlPK6ZZ3zYa0HA: posts big blind $0.50
*** HOLE CARDS ***
5SgaHdWixdClWvaEG+KUjQ: folds
APYIOyK/4AGb+kIwlOUNBQ: folds
J0W5D97jl5VLky+IoPvDeA: folds
W3ingbA178eb7J5rt1PuIQ: folds
AjV5McH1KMMclY26QdLM5w: raises $1 to $1.50
HZkVla4kK2SI42CVrPZ/ig: folds
jXGruyaMqirTaTXNOvBdew: calls $1.50
g4k0NXISyLCqaSWZDBjfEg: folds
OWP/DOu+PlPK6ZZ3zYa0HA: calls $1
*** FLOP *** [Kh 3h Kd]
OWP/DOu+PlPK6ZZ3zYa0HA: checks
AjV5McH1KMMclY26QdLM5w: bets $2
jXGruyaMqirTaTXNOvBdew: calls $2
OWP/DOu+PlPK6ZZ3zYa0HA: folds
*** TURN *** [Kh 3h Kd] [Ah]
AjV5McH1KMMclY26QdLM5w: checks
jXGruyaMqirTaTXNOvBdew: checks
*** RIVER *** [Kh 3h Kd Ah] [7c]
AjV5McH1KMMclY26QdLM5w: bets $3
jXGruyaMqirTaTXNOvBdew: folds
AjV5McH1KMMclY26QdLM5w collected $8.35 from pot
*** SUMMARY ***
Total pot $8.75 | Rake $0.40
Board [Kh 3h Kd Ah 7c]
Seat 1: HZkVla4kK2SI42CVrPZ/ig folded before Flop (didn't bet)
Seat 2: jXGruyaMqirTaTXNOvBdew (button) folded on the River
Seat 3: g4k0NXISyLCqaSWZDBjfEg (small blind) folded before Flop
Seat 4: OWP/DOu+PlPK6ZZ3zYa0HA (big blind) folded on the Flop
Seat 5: 5SgaHdWixdClWvaEG+KUjQ folded before Flop (didn't bet)
Seat 6: APYIOyK/4AGb+kIwlOUNBQ folded before Flop (didn't bet)
Seat 7: J0W5D97jl5VLky+IoPvDeA folded before Flop (didn't bet)
Seat 8: W3ingbA178eb7J5rt1PuIQ folded before Flop (didn't bet)
Seat 9: AjV5McH1KMMclY26QdLM5w collected ($8.35)



PokerStars Game #59939581350:  Hold'em No Limit ($0.25/$0.50) - 2009/07/01 0:43:34 ET
Table 'tyR5AZNKV8Aadbrnrnlg7g' 6-max Seat #2 is the button
Seat 1: R+KjpH/wSjDLhtIy9+edNA ($93.10 in chips)
Seat 2: BAjwVL+zKKd0s0fAWstzQQ ($22.85 in chips)
Seat 4: Rt6KgtZ8YaJoTc3FPim00w ($131.15 in chips)
Seat 5: Ek4w9XqBXqK5jBUQeLedGw ($50 in chips)
Rt6KgtZ8YaJoTc3FPim00w: posts small blind $0.25
Ek4w9XqBXqK5jBUQeLedGw: posts big blind $0.50
*** HOLE CARDS ***
R+KjpH/wSjDLhtIy9+edNA: folds
R+KjpH/wSjDLhtIy9+edNA is sitting out
BAjwVL+zKKd0s0fAWstzQQ: folds
R+KjpH/wSjDLhtIy9+edNA leaves the table
Rt6KgtZ8YaJoTc3FPim00w: raises $1 to $1.50
Ek4w9XqBXqK5jBUQeLedGw: folds
Rt6KgtZ8YaJoTc3FPim00w collected $1 from pot
Rt6KgtZ8YaJoTc3FPim00w: doesn't show hand
*** SUMMARY ***
Total pot $1 | Rake $0
Seat 1: R+KjpH/wSjDLhtIy9+edNA folded before Flop (didn't bet)
Seat 2: BAjwVL+zKKd0s0fAWstzQQ (button) folded before Flop (didn't bet)
Seat 4: Rt6KgtZ8YaJoTc3FPim00w (small blind) collected ($1)
Seat 5: Ek4w9XqBXqK5jBUQeLedGw (big blind) folded before Flop



PokerStars Game #59939582590:  Hold'em No Limit ($0.25/$0.50) - 2009/07/01 0:43:36 ET
Table 'lSisgp6H7Fg1hH5VfjEjYQ' 9-max Seat #2 is the button
Seat 1: 5k9fvXD9suIgCxU4HLQjTw ($50 in chips)
Seat 2: UrcnkQOiLVk8BlKDPJSy7Q ($50 in chips)
Seat 3: aTkyjTh3w5YLWiIERupZOA ($41.95 in chips)
Seat 4: bwv/rbH/hHhPhY6u9mu04w ($43.50 in chips)
Seat 5: mSD1pginDsyHG5PDfqzphw ($12.10 in chips)
Seat 6: +k7T5ocke8UwavtgUHm+Cg ($29.30 in chips)
Seat 7: Y3DZ6qQlLeBhixDj4M9vmg ($10.80 in chips)
Seat 8: a4JDWmpFQkL10XfAyuF51A ($33.75 in chips)
Seat 9: gsyXT42WLEcOS4DdEk2wlw ($30.20 in chips)
aTkyjTh3w5YLWiIERupZOA: posts small blind $0.25
bwv/rbH/hHhPhY6u9mu04w: posts big blind $0.50
*** HOLE CARDS ***
mSD1pginDsyHG5PDfqzphw: folds
+k7T5ocke8UwavtgUHm+Cg: folds
Y3DZ6qQlLeBhixDj4M9vmg: folds
a4JDWmpFQkL10XfAyuF51A: calls $0.50
gsyXT42WLEcOS4DdEk2wlw: folds
5k9fvXD9suIgCxU4HLQjTw: folds
UrcnkQOiLVk8BlKDPJSy7Q: folds
aTkyjTh3w5YLWiIERupZOA: raises $1 to $1.50
bwv/rbH/hHhPhY6u9mu04w: raises $1.50 to $3
a4JDWmpFQkL10XfAyuF51A: folds
aTkyjTh3w5YLWiIERupZOA: raises $2.50 to $5.50
bwv/rbH/hHhPhY6u9mu04w: calls $2.50
*** FLOP *** [7c Ac Th]
aTkyjTh3w5YLWiIERupZOA: checks
bwv/rbH/hHhPhY6u9mu04w: checks
*** TURN *** [7c Ac Th] [Kc]
aTkyjTh3w5YLWiIERupZOA: checks
bwv/rbH/hHhPhY6u9mu04w: checks
*** RIVER *** [7c Ac Th Kc] [3s]
aTkyjTh3w5YLWiIERupZOA: bets $5
bwv/rbH/hHhPhY6u9mu04w: calls $5
*** SHOW DOWN ***
aTkyjTh3w5YLWiIERupZOA: shows [Ah As] (three of a kind, Aces)
bwv/rbH/hHhPhY6u9mu04w: mucks hand
aTkyjTh3w5YLWiIERupZOA collected $20.50 from pot
*** SUMMARY ***
Total pot $21.50 | Rake $1
Board [7c Ac Th Kc 3s]
Seat 1: 5k9fvXD9suIgCxU4HLQjTw folded before Flop (didn't bet)
Seat 2: UrcnkQOiLVk8BlKDPJSy7Q (button) folded before Flop (didn't bet)
Seat 3: aTkyjTh3w5YLWiIERupZOA (small blind) showed [Ah As] and won ($20.50) with three of a kind, Aces
Seat 4: bwv/rbH/hHhPhY6u9mu04w (big blind) mucked
Seat 5: mSD1pginDsyHG5PDfqzphw folded before Flop (didn't bet)
Seat 6: +k7T5ocke8UwavtgUHm+Cg folded before Flop (didn't bet)
Seat 7: Y3DZ6qQlLeBhixDj4M9vmg folded before Flop (didn't bet)
Seat 8: a4JDWmpFQkL10XfAyuF51A folded before Flop
Seat 9: gsyXT42WLEcOS4DdEk2wlw folded before Flop (didn't bet)



PokerStars Game #59939582650:  Hold'em No Limit ($0.25/$0.50) - 2009/07/01 0:43:36 ET
Table 'QOgaEqMcJ73pcUMMxoisUgErOuyGLI5PT3G5MnpHgC/g Seat #6 is the button
Seat 1: L5e2lrPLQm1Pqx30IIZ/Fw ($12.55 in chips)
Seat 3: xZCXQSXlrZkp3pZizzVXCw ($50.50 in chips)
Seat 4: 3UmXLy3GfjC3EkOebduerQ ($50 in chips)
Seat 5: JwvquocWfhTVApN5t47LgA ($57.55 in chips)
Seat 6: zE9cVigS2nW/Ljy4K4bUQA ($30 in chips)
Seat 7: 90Wb75h3W1BRpbqVnuk8gw ($60.45 in chips)
Seat 8: g4k0NXISyLCqaSWZDBjfEg ($52.10 in chips)
Seat 9: J0W5D97jl5VLky+IoPvDeA ($57.90 in chips)
90Wb75h3W1BRpbqVnuk8gw: posts small blind $0.25
g4k0NXISyLCqaSWZDBjfEg: posts big blind $0.50
*** HOLE CARDS ***
J0W5D97jl5VLky+IoPvDeA: folds
L5e2lrPLQm1Pqx30IIZ/Fw: folds
xZCXQSXlrZkp3pZizzVXCw: folds
3UmXLy3GfjC3EkOebduerQ: folds
JwvquocWfhTVApN5t47LgA: folds
zE9cVigS2nW/Ljy4K4bUQA: folds
90Wb75h3W1BRpbqVnuk8gw: raises $1.50 to $2
g4k0NXISyLCqaSWZDBjfEg: folds
90Wb75h3W1BRpbqVnuk8gw collected $1 from pot
*** SUMMARY ***
Total pot $1 | Rake $0
Seat 1: L5e2lrPLQm1Pqx30IIZ/Fw folded before Flop (didn't bet)
Seat 3: xZCXQSXlrZkp3pZizzVXCw folded before Flop (didn't bet)
Seat 4: 3UmXLy3GfjC3EkOebduerQ folded before Flop (didn't bet)
Seat 5: JwvquocWfhTVApN5t47LgA folded before Flop (didn't bet)
Seat 6: zE9cVigS2nW/Ljy4K4bUQA (button) folded before Flop (didn't bet)
Seat 7: 90Wb75h3W1BRpbqVnuk8gw (small blind) collected ($1)
Seat 8: g4k0NXISyLCqaSWZDBjfEg (big blind) folded before Flop
Seat 9: J0W5D97jl5VLky+IoPvDeA folded before Flop (didn't bet)



PokerStars Game #59939583234:  Hold'em No Limit ($0.25/$0.50) - 2009/07/01 0:43:37 ET
Table 'fx6MqwfYAj/Rt86hBz2L3Q' 9-max Seat #1 is the button
Seat 1: SegjDnMxWMujiD57ESNL+g ($10 in chips)
Seat 2: C3rGXblctNcWI6JYPHhaEg ($14.50 in chips)
Seat 3: iadBi5AEt7gTBXbDSSnMYQ ($51.45 in chips)
Seat 4: gPEN9Zp33YTm/mu9/SYP1w ($21.70 in chips)
Seat 5: iAISe3dVeua8PUn2wwgDHw ($24.10 in chips)
Seat 6: 5k9fvXD9suIgCxU4HLQjTw ($50 in chips)
Seat 8: NnQCepdIR/AOUQn1yhYx6Q ($9.50 in chips)
Seat 9: HZkVla4kK2SI42CVrPZ/ig ($8.25 in chips)
C3rGXblctNcWI6JYPHhaEg: posts small blind $0.25
iadBi5AEt7gTBXbDSSnMYQ: posts big blind $0.50
SKnJuWHScqetA/qG5p+wCg: sits out
*** HOLE CARDS ***
gPEN9Zp33YTm/mu9/SYP1w: folds
iAISe3dVeua8PUn2wwgDHw: folds
5k9fvXD9suIgCxU4HLQjTw: folds
NnQCepdIR/AOUQn1yhYx6Q: raises $1.50 to $2
HZkVla4kK2SI42CVrPZ/ig: folds
SegjDnMxWMujiD57ESNL+g: folds
C3rGXblctNcWI6JYPHhaEg: calls $1.75
iadBi5AEt7gTBXbDSSnMYQ: folds
*** FLOP *** [Td 6c 2h]
C3rGXblctNcWI6JYPHhaEg: checks
NnQCepdIR/AOUQn1yhYx6Q: checks
*** TURN *** [Td 6c 2h] [6d]
C3rGXblctNcWI6JYPHhaEg: bets $1
NnQCepdIR/AOUQn1yhYx6Q: calls $1
*** RIVER *** [Td 6c 2h 6d] [7d]
C3rGXblctNcWI6JYPHhaEg: bets $1.50
NnQCepdIR/AOUQn1yhYx6Q: calls $1.50
*** SHOW DOWN ***
C3rGXblctNcWI6JYPHhaEg: shows [Kd 8c] (a pair of Sixes)
NnQCepdIR/AOUQn1yhYx6Q: shows [4h Ah] (a pair of Sixes - Ace kicker)
NnQCepdIR/AOUQn1yhYx6Q collected $9.05 from pot
*** SUMMARY ***
Total pot $9.50 | Rake $0.45
Board [Td 6c 2h 6d 7d]
Seat 1: SegjDnMxWMujiD57ESNL+g (button) folded before Flop (didn't bet)
Seat 2: C3rGXblctNcWI6JYPHhaEg (small blind) showed [Kd 8c] and lost with a pair of Sixes
Seat 3: iadBi5AEt7gTBXbDSSnMYQ (big blind) folded before Flop
Seat 4: gPEN9Zp33YTm/mu9/SYP1w folded before Flop (didn't bet)
Seat 5: iAISe3dVeua8PUn2wwgDHw folded before Flop (didn't bet)
Seat 6: 5k9fvXD9suIgCxU4HLQjTw folded before Flop (didn't bet)
Seat 8: NnQCepdIR/AOUQn1yhYx6Q showed [4h Ah] and won ($9.05) with a pair of Sixes
Seat 9: HZkVla4kK2SI42CVrPZ/ig folded before Flop (didn't bet)



PokerStars Game #59939584692:  Hold'em No Limit ($0.25/$0.50) - 2009/07/01 0:43:39 ET
Table '+111aLuBwnz8YVYSA7J1jA' 2-max Seat #1 is the button
Seat 1: ndd1nfncBkWNitBnsfCoVQ ($76.45 in chips)
Seat 2: +ciXH35zeafrjg1W6wiBTg ($73.40 in chips)
ndd1nfncBkWNitBnsfCoVQ: posts small blind $0.25
+ciXH35zeafrjg1W6wiBTg: posts big blind $0.50
*** HOLE CARDS ***
ndd1nfncBkWNitBnsfCoVQ: raises $1 to $1.50
+ciXH35zeafrjg1W6wiBTg: calls $1
*** FLOP *** [4c 7s 7c]
+ciXH35zeafrjg1W6wiBTg: checks
ndd1nfncBkWNitBnsfCoVQ: bets $2
+ciXH35zeafrjg1W6wiBTg: raises $2 to $4
ndd1nfncBkWNitBnsfCoVQ: calls $2
*** TURN *** [4c 7s 7c] [Kd]
+ciXH35zeafrjg1W6wiBTg: bets $4
ndd1nfncBkWNitBnsfCoVQ: raises $8 to $12
+ciXH35zeafrjg1W6wiBTg: calls $8
*** RIVER *** [4c 7s 7c Kd] [5c]
+ciXH35zeafrjg1W6wiBTg: checks
ndd1nfncBkWNitBnsfCoVQ: checks
*** SHOW DOWN ***
+ciXH35zeafrjg1W6wiBTg: shows [6s 5h] (two pair, Sevens and Fives)
ndd1nfncBkWNitBnsfCoVQ: shows [5d 3d] (two pair, Sevens and Fives)
+ciXH35zeafrjg1W6wiBTg collected $17.25 from pot
ndd1nfncBkWNitBnsfCoVQ collected $17.25 from pot
*** SUMMARY ***
Total pot $35 | Rake $0.50
Board [4c 7s 7c Kd 5c]
Seat 1: ndd1nfncBkWNitBnsfCoVQ (button) (small blind) showed [5d 3d] and won ($17.25) with two pair, Sevens and Fives
Seat 2: +ciXH35zeafrjg1W6wiBTg (big blind) showed [6s 5h] and won ($17.25) with two pair, Sevens and Fives



PokerStars Game #59939585144:  Hold'em No Limit ($0.25/$0.50) - 2009/07/01 0:43:40 ET
Table 'QOeVnLhwctF9UyV/beDi+A' 2-max Seat #1 is the button
Seat 1: bypIyrYcAAifLfhZpGlKLA ($58 in chips)
Seat 2: Ucrm3XtZmoONapW32SPhag ($25.65 in chips)
bypIyrYcAAifLfhZpGlKLA: posts small blind $0.25
Ucrm3XtZmoONapW32SPhag: posts big blind $0.50
*** HOLE CARDS ***
bypIyrYcAAifLfhZpGlKLA: raises $1 to $1.50
Ucrm3XtZmoONapW32SPhag: calls $1
*** FLOP *** [5c 7d 6s]
Ucrm3XtZmoONapW32SPhag: checks
bypIyrYcAAifLfhZpGlKLA: bets $2.50
Ucrm3XtZmoONapW32SPhag: folds
bypIyrYcAAifLfhZpGlKLA collected $2.85 from pot
bypIyrYcAAifLfhZpGlKLA: doesn't show hand
*** SUMMARY ***
Total pot $3 | Rake $0.15
Board [5c 7d 6s]
Seat 1: bypIyrYcAAifLfhZpGlKLA (button) (small blind) collected ($2.85)
Seat 2: Ucrm3XtZmoONapW32SPhag (big blind) folded on the Flop



PokerStars Game #59939586174:  Hold'em No Limit ($0.25/$0.50) - 2009/07/01 0:43:41 ET
Table 'EiNh8p/wGJ1FP575iMFnqg' 9-max Seat #5 is the button
Seat 1: r3ZqM1Mi0W3y4hOdssE+Sg ($49.40 in chips)
Seat 2: 8ehL7qlZzjgUh2H35iiWLw ($53.35 in chips)
Seat 3: ymLPoEIl7UL3TvZYmnadxQ ($48.60 in chips)
Seat 4: cMzaiXAM/ZAdNaEUu+LqhA ($50 in chips)
Seat 5: M+7+BTmX5vZatHVuoRB1nA ($78.85 in chips)
Seat 6: 3UmXLy3GfjC3EkOebduerQ ($63.20 in chips)
Seat 7: 997ViqAtWn1FPjJqcffwcA ($50 in chips)
Seat 8: KrPAGRACBg+w0M//SXe8Ag ($9.35 in chips)
3UmXLy3GfjC3EkOebduerQ: posts small blind $0.25
997ViqAtWn1FPjJqcffwcA: posts big blind $0.50
NnQCepdIR/AOUQn1yhYx6Q: sits out
*** HOLE CARDS ***
KrPAGRACBg+w0M//SXe8Ag: calls $0.50
r3ZqM1Mi0W3y4hOdssE+Sg: folds
8ehL7qlZzjgUh2H35iiWLw: folds
ymLPoEIl7UL3TvZYmnadxQ: folds
cMzaiXAM/ZAdNaEUu+LqhA: folds
M+7+BTmX5vZatHVuoRB1nA: folds
3UmXLy3GfjC3EkOebduerQ: folds
997ViqAtWn1FPjJqcffwcA: checks
*** FLOP *** [Kd 6d 3h]
997ViqAtWn1FPjJqcffwcA: checks
KrPAGRACBg+w0M//SXe8Ag: bets $0.50
997ViqAtWn1FPjJqcffwcA: folds
KrPAGRACBg+w0M//SXe8Ag collected $1.20 from pot
KrPAGRACBg+w0M//SXe8Ag: doesn't show hand
*** SUMMARY ***
Total pot $1.25 | Rake $0.05
Board [Kd 6d 3h]
Seat 1: r3ZqM1Mi0W3y4hOdssE+Sg folded before Flop (didn't bet)
Seat 2: 8ehL7qlZzjgUh2H35iiWLw folded before Flop (didn't bet)
Seat 3: ymLPoEIl7UL3TvZYmnadxQ folded before Flop (didn't bet)
Seat 4: cMzaiXAM/ZAdNaEUu+LqhA folded before Flop (didn't bet)
Seat 5: M+7+BTmX5vZatHVuoRB1nA (button) folded before Flop (didn't bet)
Seat 6: 3UmXLy3GfjC3EkOebduerQ (small blind) folded before Flop
Seat 7: 997ViqAtWn1FPjJqcffwcA (big blind) folded on the Flop
Seat 8: KrPAGRACBg+w0M//SXe8Ag collected ($1.20)



PokerStars Game #59939585826:  Hold'em No Limit ($0.25/$0.50) - 2009/07/01 0:43:41 ET
Table 'hSTs/dUsYLgJQuF2Onp0MQ' 6-max Seat #5 is the button
Seat 2: 6vNxrjjCl6FwfaaymM9jjg ($5.05 in chips)
Seat 3: C3qJBo7uxfFVDluE1lmK2w ($66.65 in chips)
Seat 4: L0aIPg7qefDQjdJo3HCVEA ($7.55 in chips)
Seat 5: 686aeHikcJlgKkSuIFdcXQ ($60.70 in chips)
1WUCqNG+p+vfWRTXNu4ljw will be allowed to play after the button
6vNxrjjCl6FwfaaymM9jjg: posts small blind $0.25
C3qJBo7uxfFVDluE1lmK2w: posts big blind $0.50
*** HOLE CARDS ***
M1KyQQvVPVuxqTAB8sR/zQ joins the table at seat #6
L0aIPg7qefDQjdJo3HCVEA: folds
686aeHikcJlgKkSuIFdcXQ: folds
6vNxrjjCl6FwfaaymM9jjg: raises $4.55 to $5.05 and is all-in
C3qJBo7uxfFVDluE1lmK2w: calls $4.55
*** FLOP *** [Qh Th 4c]
*** TURN *** [Qh Th 4c] [8s]
*** RIVER *** [Qh Th 4c 8s] [6d]
*** SHOW DOWN ***
6vNxrjjCl6FwfaaymM9jjg: shows [6c Ah] (a pair of Sixes)
C3qJBo7uxfFVDluE1lmK2w: shows [Ac 8h] (a pair of Eights)
C3qJBo7uxfFVDluE1lmK2w collected $9.60 from pot
*** SUMMARY ***
Total pot $10.10 | Rake $0.50
Board [Qh Th 4c 8s 6d]
Seat 2: 6vNxrjjCl6FwfaaymM9jjg (small blind) showed [6c Ah] and lost with a pair of Sixes
Seat 3: C3qJBo7uxfFVDluE1lmK2w (big blind) showed [Ac 8h] and won ($9.60) with a pair of Eights
Seat 4: L0aIPg7qefDQjdJo3HCVEA folded before Flop (didn't bet)
Seat 5: 686aeHikcJlgKkSuIFdcXQ (button) folded before Flop (didn't bet)



PokerStars Game #59939586628:  Hold'em No Limit ($0.25/$0.50) - 2009/07/01 0:43:42 ET
Table 'ibNfFy0bCzuBaUORla0aGw' 9-max Seat #5 is the button
Seat 1: xZCXQSXlrZkp3pZizzVXCw ($53.20 in chips)
Seat 2: 90Wb75h3W1BRpbqVnuk8gw ($58.90 in chips)
Seat 3: dDaHs3X8+fe3bIkRU0cbrw ($40.15 in chips)
Seat 4: YBN054X4blmis+B2bBlC0g ($23.45 in chips)
Seat 5: GIJAc9kPrLZHLSX8Q6i99w ($25.20 in chips)
Seat 6: 8n9jQLh3cZKbsmr5PIjgiQ ($36 in chips)
Seat 7: HZkVla4kK2SI42CVrPZ/ig ($14.30 in chips)
Seat 8: xUrN9TWLq4m5V+OXY7KUUA ($50 in chips)
Seat 9: pFtzb1sR4b0d1aw6aIRgDg ($50.75 in chips)
8n9jQLh3cZKbsmr5PIjgiQ: posts small blind $0.25
HZkVla4kK2SI42CVrPZ/ig: posts big blind $0.50
*** HOLE CARDS ***
xUrN9TWLq4m5V+OXY7KUUA: folds
pFtzb1sR4b0d1aw6aIRgDg: folds
xZCXQSXlrZkp3pZizzVXCw: folds
90Wb75h3W1BRpbqVnuk8gw: raises $1.50 to $2
dDaHs3X8+fe3bIkRU0cbrw: folds
YBN054X4blmis+B2bBlC0g: folds
GIJAc9kPrLZHLSX8Q6i99w: folds
8n9jQLh3cZKbsmr5PIjgiQ: calls $1.75
HZkVla4kK2SI42CVrPZ/ig: folds
*** FLOP *** [3s 5d Ah]
8n9jQLh3cZKbsmr5PIjgiQ: checks
90Wb75h3W1BRpbqVnuk8gw: bets $2.50
8n9jQLh3cZKbsmr5PIjgiQ: calls $2.50
*** TURN *** [3s 5d Ah] [Kd]
8n9jQLh3cZKbsmr5PIjgiQ: checks
90Wb75h3W1BRpbqVnuk8gw: checks
*** RIVER *** [3s 5d Ah Kd] [6d]
8n9jQLh3cZKbsmr5PIjgiQ: bets $3
90Wb75h3W1BRpbqVnuk8gw: calls $3
*** SHOW DOWN ***
8n9jQLh3cZKbsmr5PIjgiQ: shows [Ad Kh] (two pair, Aces and Kings)
90Wb75h3W1BRpbqVnuk8gw: mucks hand
8n9jQLh3cZKbsmr5PIjgiQ collected $14.75 from pot
*** SUMMARY ***
Total pot $15.50 | Rake $0.75
Board [3s 5d Ah Kd 6d]
Seat 1: xZCXQSXlrZkp3pZizzVXCw folded before Flop (didn't bet)
Seat 2: 90Wb75h3W1BRpbqVnuk8gw mucked
Seat 3: dDaHs3X8+fe3bIkRU0cbrw folded before Flop (didn't bet)
Seat 4: YBN054X4blmis+B2bBlC0g folded before Flop (didn't bet)
Seat 5: GIJAc9kPrLZHLSX8Q6i99w (button) folded before Flop (didn't bet)
Seat 6: 8n9jQLh3cZKbsmr5PIjgiQ (small blind) showed [Ad Kh] and won ($14.75) with two pair, Aces and Kings
Seat 7: HZkVla4kK2SI42CVrPZ/ig (big blind) folded before Flop
Seat 8: xUrN9TWLq4m5V+OXY7KUUA folded before Flop (didn't bet)
Seat 9: pFtzb1sR4b0d1aw6aIRgDg folded before Flop (didn't bet)



PokerStars Game #59939586480:  Hold'em No Limit ($0.25/$0.50) - 2009/07/01 0:43:42 ET
Table 'MJxeZCzYELxiIsyUZyT0jw' 6-max Seat #4 is the button
Seat 1: jNIq+EZLEm61oWSMYUVeWQ ($10 in chips)
Seat 2: dB6jzDlJmET84VMWw1mTRA ($52.80 in chips)
Seat 3: JQZew0FjzS19kTjeNtrE+A ($52.30 in chips)
Seat 4: alGiiQP/wwtYnfuXII+sgw ($45.95 in chips)
Seat 5: 3jvoOXNtXE90w2BdfNZwZQ ($51.50 in chips)
Seat 6: TTx3CHxyi0SObcHyMJRp5w ($59.20 in chips)
3jvoOXNtXE90w2BdfNZwZQ: posts small blind $0.25
TTx3CHxyi0SObcHyMJRp5w: posts big blind $0.50
jNIq+EZLEm61oWSMYUVeWQ: posts big blind $0.50
*** HOLE CARDS ***
jNIq+EZLEm61oWSMYUVeWQ: checks
dB6jzDlJmET84VMWw1mTRA: folds
JQZew0FjzS19kTjeNtrE+A: folds
alGiiQP/wwtYnfuXII+sgw: folds
3jvoOXNtXE90w2BdfNZwZQ: folds
TTx3CHxyi0SObcHyMJRp5w: checks
*** FLOP *** [Kh 3c 2s]
TTx3CHxyi0SObcHyMJRp5w: checks
jNIq+EZLEm61oWSMYUVeWQ: checks
*** TURN *** [Kh 3c 2s] [5h]
TTx3CHxyi0SObcHyMJRp5w: bets $0.50
jNIq+EZLEm61oWSMYUVeWQ: raises $0.50 to $1
TTx3CHxyi0SObcHyMJRp5w: calls $0.50
*** RIVER *** [Kh 3c 2s 5h] [4c]
TTx3CHxyi0SObcHyMJRp5w: checks
jNIq+EZLEm61oWSMYUVeWQ: checks
dB6jzDlJmET84VMWw1mTRA leaves the table
*** SHOW DOWN ***
TTx3CHxyi0SObcHyMJRp5w: shows [9h Th] (high card King)
jNIq+EZLEm61oWSMYUVeWQ: shows [8h 8c] (a pair of Eights)
jNIq+EZLEm61oWSMYUVeWQ collected $3.10 from pot
*** SUMMARY ***
Total pot $3.25 | Rake $0.15
Board [Kh 3c 2s 5h 4c]
Seat 1: jNIq+EZLEm61oWSMYUVeWQ showed [8h 8c] and won ($3.10) with a pair of Eights
Seat 2: dB6jzDlJmET84VMWw1mTRA folded before Flop (didn't bet)
Seat 3: JQZew0FjzS19kTjeNtrE+A folded before Flop (didn't bet)
Seat 4: alGiiQP/wwtYnfuXII+sgw (button) folded before Flop (didn't bet)
Seat 5: 3jvoOXNtXE90w2BdfNZwZQ (small blind) folded before Flop
Seat 6: TTx3CHxyi0SObcHyMJRp5w (big blind) showed [9h Th] and lost with high card King



PokerStars Game #59939588878:  Hold'em No Limit ($0.25/$0.50) - 2009/07/01 0:43:46 ET
Table '5EmHi+fnatGQQShcNmzOZQ' 6-max Seat #6 is the button
Seat 1: +SZCX3+7lnuhHKIu+PP9rg ($30.60 in chips)
Seat 2: vXIHnZ+dv/hwSBxyvGw7bQ ($78.35 in chips)
Seat 3: L9qfLYXrczhAPd/VckgsWw ($80 in chips)
Seat 4: 1b+2BbjMN8qhR1WPqdE9VQ ($53.65 in chips)
Seat 5: kxPhs4ePFqMy52CInAJ2aw ($55.35 in chips)
Seat 6: 686aeHikcJlgKkSuIFdcXQ ($141.20 in chips)
+SZCX3+7lnuhHKIu+PP9rg: posts small blind $0.25
vXIHnZ+dv/hwSBxyvGw7bQ: posts big blind $0.50
*** HOLE CARDS ***
L9qfLYXrczhAPd/VckgsWw: folds
1b+2BbjMN8qhR1WPqdE9VQ: folds
kxPhs4ePFqMy52CInAJ2aw: raises $1.50 to $2
686aeHikcJlgKkSuIFdcXQ: folds
+SZCX3+7lnuhHKIu+PP9rg: folds
vXIHnZ+dv/hwSBxyvGw7bQ: folds
kxPhs4ePFqMy52CInAJ2aw collected $1.25 from pot
kxPhs4ePFqMy52CInAJ2aw: doesn't show hand
*** SUMMARY ***
Total pot $1.25 | Rake $0
Seat 1: +SZCX3+7lnuhHKIu+PP9rg (small blind) folded before Flop
Seat 2: vXIHnZ+dv/hwSBxyvGw7bQ (big blind) folded before Flop
Seat 3: L9qfLYXrczhAPd/VckgsWw folded before Flop (didn't bet)
Seat 4: 1b+2BbjMN8qhR1WPqdE9VQ folded before Flop (didn't bet)
Seat 5: kxPhs4ePFqMy52CInAJ2aw collected ($1.25)
Seat 6: 686aeHikcJlgKkSuIFdcXQ (button) folded before Flop (didn't bet)



PokerStars Game #59939588776:  Hold'em No Limit ($0.25/$0.50) - 2009/07/01 0:43:46 ET
Table 'IeNZOZQ4T6oiaHqFeo6yIA' 2-max Seat #2 is the button
Seat 1: ndd1nfncBkWNitBnsfCoVQ ($50 in chips)
Seat 2: A91IUl5JaZROhtfCtnnwYw ($123.20 in chips)
A91IUl5JaZROhtfCtnnwYw: posts small blind $0.25
ndd1nfncBkWNitBnsfCoVQ: posts big blind $0.50
*** HOLE CARDS ***
A91IUl5JaZROhtfCtnnwYw: raises $0.50 to $1
ndd1nfncBkWNitBnsfCoVQ: calls $0.50
*** FLOP *** [Jc 7c 6h]
ndd1nfncBkWNitBnsfCoVQ: checks
A91IUl5JaZROhtfCtnnwYw: checks
*** TURN *** [Jc 7c 6h] [4s]
ndd1nfncBkWNitBnsfCoVQ: bets $2
A91IUl5JaZROhtfCtnnwYw: folds
ndd1nfncBkWNitBnsfCoVQ collected $1.90 from pot
ndd1nfncBkWNitBnsfCoVQ: doesn't show hand
*** SUMMARY ***
Total pot $2 | Rake $0.10
Board [Jc 7c 6h 4s]
Seat 1: ndd1nfncBkWNitBnsfCoVQ (big blind) collected ($1.90)
Seat 2: A91IUl5JaZROhtfCtnnwYw (button) (small blind) folded on the Turn



PokerStars Game #59939589096:  Hold'em No Limit ($0.25/$0.50) - 2009/07/01 0:43:46 ET
Table 'c/CRn+68J3Y8KxD5g1ek2Q' 2-max Seat #2 is the button
Seat 1: 46qCyJ6evTkHo9al5sBMNA ($216.70 in chips)
Seat 2: BypVLsYQt3ePFm2xQL/dOA ($157.65 in chips)
BypVLsYQt3ePFm2xQL/dOA: posts small blind $0.25
46qCyJ6evTkHo9al5sBMNA: posts big blind $0.50
*** HOLE CARDS ***
BypVLsYQt3ePFm2xQL/dOA: calls $0.25
46qCyJ6evTkHo9al5sBMNA: checks
*** FLOP *** [2d 5c Ts]
46qCyJ6evTkHo9al5sBMNA: checks
BypVLsYQt3ePFm2xQL/dOA: bets $1
46qCyJ6evTkHo9al5sBMNA: folds
BypVLsYQt3ePFm2xQL/dOA collected $0.95 from pot
BypVLsYQt3ePFm2xQL/dOA: doesn't show hand
*** SUMMARY ***
Total pot $1 | Rake $0.05
Board [2d 5c Ts]
Seat 1: 46qCyJ6evTkHo9al5sBMNA (big blind) folded on the Flop
Seat 2: BypVLsYQt3ePFm2xQL/dOA (button) (small blind) collected ($0.95)



PokerStars Game #59939591834:  Hold'em No Limit ($0.25/$0.50) - 2009/07/01 0:43:50 ET
Table '3FhG0gl3kMX3wBEEqj+wnQ' 9-max Seat #7 is the button
Seat 1: e0J9pdCNUDTCG031RnXqLA ($23.40 in chips)
Seat 2: 7cYQ+syUWjl38ty/ICOMhw ($47.85 in chips)
Seat 4: bjvJtA9Hqscfznq66txaOQ ($7 in chips)
Seat 5: gsyXT42WLEcOS4DdEk2wlw ($28 in chips)
Seat 6: 997ViqAtWn1FPjJqcffwcA ($50 in chips)
Seat 7: mSD1pginDsyHG5PDfqzphw ($11.50 in chips)
Seat 8: j3K/Jujr7PY4ZM2RZvlH6A ($49.05 in chips)
Seat 9: L5e2lrPLQm1Pqx30IIZ/Fw ($10.75 in chips)
j3K/Jujr7PY4ZM2RZvlH6A: posts small blind $0.25
L5e2lrPLQm1Pqx30IIZ/Fw: posts big blind $0.50
k1f0lS7tlMHCLGs0JT34Tg: sits out
*** HOLE CARDS ***
e0J9pdCNUDTCG031RnXqLA: folds
7cYQ+syUWjl38ty/ICOMhw: folds
bjvJtA9Hqscfznq66txaOQ: raises $1 to $1.50
gsyXT42WLEcOS4DdEk2wlw: folds
997ViqAtWn1FPjJqcffwcA: folds
mSD1pginDsyHG5PDfqzphw: folds
j3K/Jujr7PY4ZM2RZvlH6A: raises $2 to $3.50
L5e2lrPLQm1Pqx30IIZ/Fw: folds
bjvJtA9Hqscfznq66txaOQ: raises $3.50 to $7 and is all-in
j3K/Jujr7PY4ZM2RZvlH6A: calls $3.50
*** FLOP *** [6s 3h 8s]
*** TURN *** [6s 3h 8s] [Js]
*** RIVER *** [6s 3h 8s Js] [5c]
*** SHOW DOWN ***
j3K/Jujr7PY4ZM2RZvlH6A: shows [4d 7c] (a straight, Four to Eight)
bjvJtA9Hqscfznq66txaOQ: mucks hand
j3K/Jujr7PY4ZM2RZvlH6A collected $13.80 from pot
*** SUMMARY ***
Total pot $14.50 | Rake $0.70
Board [6s 3h 8s Js 5c]
Seat 1: e0J9pdCNUDTCG031RnXqLA folded before Flop (didn't bet)
Seat 2: 7cYQ+syUWjl38ty/ICOMhw folded before Flop (didn't bet)
Seat 4: bjvJtA9Hqscfznq66txaOQ mucked
Seat 5: gsyXT42WLEcOS4DdEk2wlw folded before Flop (didn't bet)
Seat 6: 997ViqAtWn1FPjJqcffwcA folded before Flop (didn't bet)
Seat 7: mSD1pginDsyHG5PDfqzphw (button) folded before Flop (didn't bet)
Seat 8: j3K/Jujr7PY4ZM2RZvlH6A (small blind) showed [4d 7c] and won ($13.80) with a straight, Four to Eight
Seat 9: L5e2lrPLQm1Pqx30IIZ/Fw (big blind) folded before Flop



PokerStars Game #59939593072:  Hold'em No Limit ($0.25/$0.50) - 2009/07/01 0:43:52 ET
Table 'X6IRCRTh+20gjz8aubWnwA' 9-max Seat #7 is the button
Seat 1: DSM67hHHq1XFoEOi9p8Alw ($50.80 in chips)
Seat 2: HZkVla4kK2SI42CVrPZ/ig ($11.55 in chips)
Seat 3: GeZ7AYmAZ9Ln8liPZzV8EA ($24.35 in chips)
Seat 4: 2J+UVOVrW+V3maOylyxMcQ ($37.70 in chips)
Seat 5: NnQCepdIR/AOUQn1yhYx6Q ($10 in chips)
Seat 6: /6In1zC3WtgwxDcueWzZWg ($68.40 in chips)
Seat 7: cFHQjKQOOKTUzoilhrXHLg ($35 in chips)
Seat 9: M+7+BTmX5vZatHVuoRB1nA ($68.75 in chips)
HxeBVq06/3Bh/H986sgdbw will be allowed to play after the button
M+7+BTmX5vZatHVuoRB1nA: posts small blind $0.25
DSM67hHHq1XFoEOi9p8Alw: posts big blind $0.50
*** HOLE CARDS ***
HZkVla4kK2SI42CVrPZ/ig: folds
GeZ7AYmAZ9Ln8liPZzV8EA: folds
2J+UVOVrW+V3maOylyxMcQ: calls $0.50
NnQCepdIR/AOUQn1yhYx6Q: folds
/6In1zC3WtgwxDcueWzZWg: calls $0.50
cFHQjKQOOKTUzoilhrXHLg: calls $0.50
M+7+BTmX5vZatHVuoRB1nA: folds
DSM67hHHq1XFoEOi9p8Alw: checks
*** FLOP *** [Ts 8s 5c]
DSM67hHHq1XFoEOi9p8Alw: checks
2J+UVOVrW+V3maOylyxMcQ: checks
/6In1zC3WtgwxDcueWzZWg: checks
cFHQjKQOOKTUzoilhrXHLg: checks
*** TURN *** [Ts 8s 5c] [Qh]
DSM67hHHq1XFoEOi9p8Alw: checks
2J+UVOVrW+V3maOylyxMcQ: checks
/6In1zC3WtgwxDcueWzZWg: checks
cFHQjKQOOKTUzoilhrXHLg: checks
*** RIVER *** [Ts 8s 5c Qh] [Jh]
DSM67hHHq1XFoEOi9p8Alw: checks
2J+UVOVrW+V3maOylyxMcQ: checks
/6In1zC3WtgwxDcueWzZWg: bets $0.50
cFHQjKQOOKTUzoilhrXHLg: folds
DSM67hHHq1XFoEOi9p8Alw: folds
2J+UVOVrW+V3maOylyxMcQ: folds
/6In1zC3WtgwxDcueWzZWg collected $2.15 from pot
/6In1zC3WtgwxDcueWzZWg: doesn't show hand
*** SUMMARY ***
Total pot $2.25 | Rake $0.10
Board [Ts 8s 5c Qh Jh]
Seat 1: DSM67hHHq1XFoEOi9p8Alw (big blind) folded on the River
Seat 2: HZkVla4kK2SI42CVrPZ/ig folded before Flop (didn't bet)
Seat 3: GeZ7AYmAZ9Ln8liPZzV8EA folded before Flop (didn't bet)
Seat 4: 2J+UVOVrW+V3maOylyxMcQ folded on the River
Seat 5: NnQCepdIR/AOUQn1yhYx6Q folded before Flop (didn't bet)
Seat 6: /6In1zC3WtgwxDcueWzZWg collected ($2.15)
Seat 7: cFHQjKQOOKTUzoilhrXHLg (button) folded on the River
Seat 9: M+7+BTmX5vZatHVuoRB1nA (small blind) folded before Flop



PokerStars Game #59939593960:  Hold'em No Limit ($0.25/$0.50) - 2009/07/01 0:43:53 ET
Table 'E7bWJ45aoFXRpyRv2gw+Ig' 2-max Seat #1 is the button
Seat 1: FRkiRasEGlHUeLrEl+k/nA ($72.50 in chips)
Seat 2: 3Wro85I7472vJ4Wkpneo9A ($123.40 in chips)
FRkiRasEGlHUeLrEl+k/nA: posts small blind $0.25
3Wro85I7472vJ4Wkpneo9A: posts big blind $0.50
*** HOLE CARDS ***
FRkiRasEGlHUeLrEl+k/nA: raises $1 to $1.50
3Wro85I7472vJ4Wkpneo9A: folds
FRkiRasEGlHUeLrEl+k/nA collected $1 from pot
*** SUMMARY ***
Total pot $1 | Rake $0
Seat 1: FRkiRasEGlHUeLrEl+k/nA (button) (small blind) collected ($1)
Seat 2: 3Wro85I7472vJ4Wkpneo9A (big blind) folded before Flop



PokerStars Game #59939593992:  Hold'em No Limit ($0.25/$0.50) - 2009/07/01 0:43:53 ET
Table 'QOeVnLhwctF9UyV/beDi+A' 2-max Seat #2 is the button
Seat 1: bypIyrYcAAifLfhZpGlKLA ($59.35 in chips)
Seat 2: Ucrm3XtZmoONapW32SPhag ($24.15 in chips)
Ucrm3XtZmoONapW32SPhag: posts small blind $0.25
bypIyrYcAAifLfhZpGlKLA: posts big blind $0.50
*** HOLE CARDS ***
Ucrm3XtZmoONapW32SPhag: calls $0.25
bypIyrYcAAifLfhZpGlKLA: checks
*** FLOP *** [4d 2h Th]
bypIyrYcAAifLfhZpGlKLA: bets $1
Ucrm3XtZmoONapW32SPhag: calls $1
*** TURN *** [4d 2h Th] [9d]
bypIyrYcAAifLfhZpGlKLA: bets $3
Ucrm3XtZmoONapW32SPhag: folds
bypIyrYcAAifLfhZpGlKLA collected $2.90 from pot
bypIyrYcAAifLfhZpGlKLA: doesn't show hand
*** SUMMARY ***
Total pot $3 | Rake $0.10
Board [4d 2h Th 9d]
Seat 1: bypIyrYcAAifLfhZpGlKLA (big blind) collected ($2.90)
Seat 2: Ucrm3XtZmoONapW32SPhag (button) (small blind) folded on the Turn



PokerStars Game #59939596784:  Hold'em No Limit ($0.25/$0.50) - 2009/07/01 0:43:58 ET
Table '37qXEp3oe+er5q4CZip9eQ' 6-max Seat #3 is the button
Seat 1: oqOqoO2AyCZenUghCxMDxw ($58.40 in chips)
Seat 2: 6wzJiRvp8HY6t+MQGnSIzA ($28.60 in chips)
Seat 3: Rt6KgtZ8YaJoTc3FPim00w ($72.25 in chips)
Seat 4: XsmE8nXMAAMFJbWaJTmHFw ($29.20 in chips)
Seat 6: N50kln4negd8q7Mmoz1j4g ($21.35 in chips)
XsmE8nXMAAMFJbWaJTmHFw: posts small blind $0.25
N50kln4negd8q7Mmoz1j4g: posts big blind $0.50
*** HOLE CARDS ***
oqOqoO2AyCZenUghCxMDxw: folds
VOmI0x4dDPnTESZd5B4d1Q has returned
6wzJiRvp8HY6t+MQGnSIzA: raises $1.50 to $2
Rt6KgtZ8YaJoTc3FPim00w: folds
XsmE8nXMAAMFJbWaJTmHFw: folds
N50kln4negd8q7Mmoz1j4g: calls $1.50
*** FLOP *** [Tc 5c Qd]
N50kln4negd8q7Mmoz1j4g: checks
6wzJiRvp8HY6t+MQGnSIzA: bets $1.50
N50kln4negd8q7Mmoz1j4g: calls $1.50
*** TURN *** [Tc 5c Qd] [2s]
N50kln4negd8q7Mmoz1j4g: checks
6wzJiRvp8HY6t+MQGnSIzA: bets $1.50
N50kln4negd8q7Mmoz1j4g: raises $4 to $5.50
6wzJiRvp8HY6t+MQGnSIzA: calls $4
*** RIVER *** [Tc 5c Qd 2s] [Ks]
N50kln4negd8q7Mmoz1j4g: checks
6wzJiRvp8HY6t+MQGnSIzA: checks
*** SHOW DOWN ***
N50kln4negd8q7Mmoz1j4g: shows [Ad Qc] (a pair of Queens)
6wzJiRvp8HY6t+MQGnSIzA: mucks hand
N50kln4negd8q7Mmoz1j4g collected $17.40 from pot
*** SUMMARY ***
Total pot $18.25 | Rake $0.85
Board [Tc 5c Qd 2s Ks]
Seat 1: oqOqoO2AyCZenUghCxMDxw folded before Flop (didn't bet)
Seat 2: 6wzJiRvp8HY6t+MQGnSIzA mucked
Seat 3: Rt6KgtZ8YaJoTc3FPim00w (button) folded before Flop (didn't bet)
Seat 4: XsmE8nXMAAMFJbWaJTmHFw (small blind) folded before Flop
Seat 6: N50kln4negd8q7Mmoz1j4g (big blind) showed [Ad Qc] and won ($17.40) with a pair of Queens



PokerStars Game #59939598486:  Hold'em No Limit ($0.25/$0.50) - 2009/07/01 0:44:00 ET
Table '+dXkOAQyS8j9PQZusUTMpg' 2-max Seat #2 is the button
Seat 1: XFa6sBGjP2gxoIvxR3fZIg ($54.45 in chips)
Seat 2: 5IBeOgaApY1Bvzv2P8X4EA ($149.70 in chips)
5IBeOgaApY1Bvzv2P8X4EA: posts small blind $0.25
XFa6sBGjP2gxoIvxR3fZIg: posts big blind $0.50
*** HOLE CARDS ***
5IBeOgaApY1Bvzv2P8X4EA: folds
XFa6sBGjP2gxoIvxR3fZIg collected $0.50 from pot
XFa6sBGjP2gxoIvxR3fZIg: doesn't show hand
*** SUMMARY ***
Total pot $0.50 | Rake $0
Seat 1: XFa6sBGjP2gxoIvxR3fZIg (big blind) collected ($0.50)
Seat 2: 5IBeOgaApY1Bvzv2P8X4EA (button) (small blind) folded before Flop



PokerStars Game #59939601008:  Hold'em No Limit ($0.25/$0.50) - 2009/07/01 0:44:04 ET
Table 'E7bWJ45aoFXRpyRv2gw+Ig' 2-max Seat #2 is the button
Seat 1: FRkiRasEGlHUeLrEl+k/nA ($73 in chips)
Seat 2: 3Wro85I7472vJ4Wkpneo9A ($122.90 in chips)
3Wro85I7472vJ4Wkpneo9A: posts small blind $0.25
FRkiRasEGlHUeLrEl+k/nA: posts big blind $0.50
*** HOLE CARDS ***
3Wro85I7472vJ4Wkpneo9A: raises $1 to $1.50
FRkiRasEGlHUeLrEl+k/nA: folds
3Wro85I7472vJ4Wkpneo9A collected $1 from pot
3Wro85I7472vJ4Wkpneo9A: doesn't show hand
*** SUMMARY ***
Total pot $1 | Rake $0
Seat 1: FRkiRasEGlHUeLrEl+k/nA (big blind) folded before Flop
Seat 2: 3Wro85I7472vJ4Wkpneo9A (button) (small blind) collected ($1)



PokerStars Game #59939601610:  Hold'em No Limit ($0.25/$0.50) - 2009/07/01 0:44:05 ET
Table 'c/CRn+68J3Y8KxD5g1ek2Q' 2-max Seat #1 is the button
Seat 1: 46qCyJ6evTkHo9al5sBMNA ($216.20 in chips)
Seat 2: BypVLsYQt3ePFm2xQL/dOA ($158.10 in chips)
46qCyJ6evTkHo9al5sBMNA: posts small blind $0.25
BypVLsYQt3ePFm2xQL/dOA: posts big blind $0.50
*** HOLE CARDS ***
46qCyJ6evTkHo9al5sBMNA: raises $1 to $1.50
BypVLsYQt3ePFm2xQL/dOA: calls $1
*** FLOP *** [6c 5d 6d]
BypVLsYQt3ePFm2xQL/dOA: checks
46qCyJ6evTkHo9al5sBMNA: bets $2.50
BypVLsYQt3ePFm2xQL/dOA: calls $2.50
*** TURN *** [6c 5d 6d] [Jd]
BypVLsYQt3ePFm2xQL/dOA: checks
46qCyJ6evTkHo9al5sBMNA: bets $4.50
BypVLsYQt3ePFm2xQL/dOA: calls $4.50
*** RIVER *** [6c 5d 6d Jd] [9d]
BypVLsYQt3ePFm2xQL/dOA: bets $11
46qCyJ6evTkHo9al5sBMNA: raises $196.70 to $207.70 and is all-in
BypVLsYQt3ePFm2xQL/dOA: folds
46qCyJ6evTkHo9al5sBMNA collected $38.50 from pot
46qCyJ6evTkHo9al5sBMNA: doesn't show hand
*** SUMMARY ***
Total pot $39 | Rake $0.50
Board [6c 5d 6d Jd 9d]
Seat 1: 46qCyJ6evTkHo9al5sBMNA (button) (small blind) collected ($38.50)
Seat 2: BypVLsYQt3ePFm2xQL/dOA (big blind) folded on the River



PokerStars Game #59939601288:  Hold'em No Limit ($0.25/$0.50) - 2009/07/01 0:44:05 ET
Table 'BCN5su+SsXiy1zRMJi0SJw' 6-max Seat #1 is the button
Seat 1: crjGpJEzSZgD38FoE3VMGg ($50 in chips)
Seat 2: oU2kDCkT/gilYbHWrg7D8w ($12.90 in chips)
Seat 3: g+vwI6lMKpU2uteXSjOzVw ($20.05 in chips)
Seat 4: JY9CtoZTeav+mhWyxSSyJQ ($26.90 in chips)
Seat 5: IBNygaT1aa9Z1uPdJJilwA ($64 in chips)
Seat 6: b2symlOdL7+0c9Pj4N/KlA ($51.60 in chips)
oU2kDCkT/gilYbHWrg7D8w: posts small blind $0.25
g+vwI6lMKpU2uteXSjOzVw: posts big blind $0.50
*** HOLE CARDS ***
JY9CtoZTeav+mhWyxSSyJQ: folds
IBNygaT1aa9Z1uPdJJilwA: calls $0.50
b2symlOdL7+0c9Pj4N/KlA: raises $1.50 to $2
crjGpJEzSZgD38FoE3VMGg: folds
oU2kDCkT/gilYbHWrg7D8w: folds
g+vwI6lMKpU2uteXSjOzVw: folds
IBNygaT1aa9Z1uPdJJilwA: folds
b2symlOdL7+0c9Pj4N/KlA collected $1.75 from pot
b2symlOdL7+0c9Pj4N/KlA: doesn't show hand
*** SUMMARY ***
Total pot $1.75 | Rake $0
Seat 1: crjGpJEzSZgD38FoE3VMGg (button) folded before Flop (didn't bet)
Seat 2: oU2kDCkT/gilYbHWrg7D8w (small blind) folded before Flop
Seat 3: g+vwI6lMKpU2uteXSjOzVw (big blind) folded before Flop
Seat 4: JY9CtoZTeav+mhWyxSSyJQ folded before Flop (didn't bet)
Seat 5: IBNygaT1aa9Z1uPdJJilwA folded before Flop
Seat 6: b2symlOdL7+0c9Pj4N/KlA collected ($1.75)



PokerStars Game #59939602608:  Hold'em No Limit ($0.25/$0.50) - 2009/07/01 0:44:07 ET
Table 'hWT2kq66tnKEpD26cia6fQ' 2-max Seat #2 is the button
Seat 1: q+vRKwm51mnr6kxX/161WQ ($55.95 in chips)
Seat 2: dkC7J+qbyqk0qCcmJbEPPw ($56.55 in chips)
dkC7J+qbyqk0qCcmJbEPPw: posts small blind $0.25
q+vRKwm51mnr6kxX/161WQ: posts big blind $0.50
*** HOLE CARDS ***
dkC7J+qbyqk0qCcmJbEPPw: raises $1 to $1.50
q+vRKwm51mnr6kxX/161WQ: folds
dkC7J+qbyqk0qCcmJbEPPw collected $1 from pot
dkC7J+qbyqk0qCcmJbEPPw: doesn't show hand
*** SUMMARY ***
Total pot $1 | Rake $0
Seat 1: q+vRKwm51mnr6kxX/161WQ (big blind) folded before Flop
Seat 2: dkC7J+qbyqk0qCcmJbEPPw (button) (small blind) collected ($1)



PokerStars Game #59939602898:  Hold'em No Limit ($0.25/$0.50) - 2009/07/01 0:44:07 ET
Table '+dXkOAQyS8j9PQZusUTMpg' 2-max Seat #1 is the button
Seat 1: XFa6sBGjP2gxoIvxR3fZIg ($54.70 in chips)
Seat 2: 5IBeOgaApY1Bvzv2P8X4EA ($149.45 in chips)
XFa6sBGjP2gxoIvxR3fZIg: posts small blind $0.25
5IBeOgaApY1Bvzv2P8X4EA: posts big blind $0.50
*** HOLE CARDS ***
XFa6sBGjP2gxoIvxR3fZIg: raises $1 to $1.50
5IBeOgaApY1Bvzv2P8X4EA: folds
XFa6sBGjP2gxoIvxR3fZIg collected $1 from pot
*** SUMMARY ***
Total pot $1 | Rake $0
Seat 1: XFa6sBGjP2gxoIvxR3fZIg (button) (small blind) collected ($1)
Seat 2: 5IBeOgaApY1Bvzv2P8X4EA (big blind) folded before Flop



PokerStars Game #59939603652:  Hold'em No Limit ($0.25/$0.50) - 2009/07/01 0:44:08 ET
Table 'otvGDROEDdqsabxskT79qg' 9-max Seat #1 is the button
Seat 1: 8ehL7qlZzjgUh2H35iiWLw ($55.25 in chips)
Seat 2: cCjTzH9jio8607WzjcfXlg ($8.55 in chips)
Seat 3: +k7T5ocke8UwavtgUHm+Cg ($76.55 in chips)
Seat 4: MG90wfSJZnOejs/KD3vlQQ ($56.15 in chips)
Seat 5: XNMDwbXt/Q4jM99AXnbJDw ($54.30 in chips)
Seat 6: bxLSulbgr8LmKNjOzw8URg ($51.40 in chips)
Seat 7: C7+tBppJrKgd/r+tuKUIpA ($39.85 in chips)
Seat 8: zE9cVigS2nW/Ljy4K4bUQA ($30 in chips)
Seat 9: KcY3X8YpD74Kw1RHkx/g4A ($66 in chips)
cCjTzH9jio8607WzjcfXlg: posts small blind $0.25
+k7T5ocke8UwavtgUHm+Cg: posts big blind $0.50
*** HOLE CARDS ***
MG90wfSJZnOejs/KD3vlQQ: raises $1 to $1.50
XNMDwbXt/Q4jM99AXnbJDw: folds
bxLSulbgr8LmKNjOzw8URg: folds
C7+tBppJrKgd/r+tuKUIpA: folds
zE9cVigS2nW/Ljy4K4bUQA: folds
KcY3X8YpD74Kw1RHkx/g4A: calls $1.50
8ehL7qlZzjgUh2H35iiWLw: folds
cCjTzH9jio8607WzjcfXlg: folds
+k7T5ocke8UwavtgUHm+Cg: calls $1
*** FLOP *** [4s 5d 3d]
+k7T5ocke8UwavtgUHm+Cg: checks
MG90wfSJZnOejs/KD3vlQQ: bets $3.75
KcY3X8YpD74Kw1RHkx/g4A: folds
+k7T5ocke8UwavtgUHm+Cg: calls $3.75
*** TURN *** [4s 5d 3d] [8h]
+k7T5ocke8UwavtgUHm+Cg: checks
MG90wfSJZnOejs/KD3vlQQ: bets $9
+k7T5ocke8UwavtgUHm+Cg: calls $9
*** RIVER *** [4s 5d 3d 8h] [Tc]
+k7T5ocke8UwavtgUHm+Cg: checks
MG90wfSJZnOejs/KD3vlQQ: bets $16
+k7T5ocke8UwavtgUHm+Cg: folds
MG90wfSJZnOejs/KD3vlQQ collected $28.80 from pot
MG90wfSJZnOejs/KD3vlQQ: doesn't show hand
*** SUMMARY ***
Total pot $30.25 | Rake $1.45
Board [4s 5d 3d 8h Tc]
Seat 1: 8ehL7qlZzjgUh2H35iiWLw (button) folded before Flop (didn't bet)
Seat 2: cCjTzH9jio8607WzjcfXlg (small blind) folded before Flop
Seat 3: +k7T5ocke8UwavtgUHm+Cg (big blind) folded on the River
Seat 4: MG90wfSJZnOejs/KD3vlQQ collected ($28.80)
Seat 5: XNMDwbXt/Q4jM99AXnbJDw folded before Flop (didn't bet)
Seat 6: bxLSulbgr8LmKNjOzw8URg folded before Flop (didn't bet)
Seat 7: C7+tBppJrKgd/r+tuKUIpA folded before Flop (didn't bet)
Seat 8: zE9cVigS2nW/Ljy4K4bUQA folded before Flop (didn't bet)
Seat 9: KcY3X8YpD74Kw1RHkx/g4A folded on the Flop



PokerStars Game #59939603906:  Hold'em No Limit ($0.25/$0.50) - 2009/07/01 0:44:09 ET
Table 'EiNh8p/wGJ1FP575iMFnqg' 9-max Seat #6 is the button
Seat 1: r3ZqM1Mi0W3y4hOdssE+Sg ($49.40 in chips)
Seat 2: 8ehL7qlZzjgUh2H35iiWLw ($53.35 in chips)
Seat 3: ymLPoEIl7UL3TvZYmnadxQ ($48.60 in chips)
Seat 4: cMzaiXAM/ZAdNaEUu+LqhA ($50 in chips)
Seat 5: M+7+BTmX5vZatHVuoRB1nA ($78.85 in chips)
Seat 6: 3UmXLy3GfjC3EkOebduerQ ($62.95 in chips)
Seat 7: 997ViqAtWn1FPjJqcffwcA ($50 in chips)
Seat 8: KrPAGRACBg+w0M//SXe8Ag ($10.05 in chips)
997ViqAtWn1FPjJqcffwcA: posts small blind $0.25
KrPAGRACBg+w0M//SXe8Ag: posts big blind $0.50
NnQCepdIR/AOUQn1yhYx6Q: sits out
*** HOLE CARDS ***
r3ZqM1Mi0W3y4hOdssE+Sg: calls $0.50
8ehL7qlZzjgUh2H35iiWLw: folds
ymLPoEIl7UL3TvZYmnadxQ: folds
cMzaiXAM/ZAdNaEUu+LqhA: folds
M+7+BTmX5vZatHVuoRB1nA: calls $0.50
3UmXLy3GfjC3EkOebduerQ: folds
997ViqAtWn1FPjJqcffwcA: folds
KrPAGRACBg+w0M//SXe8Ag: checks
*** FLOP *** [8h Tc 9s]
KrPAGRACBg+w0M//SXe8Ag: bets $0.50
r3ZqM1Mi0W3y4hOdssE+Sg: folds
M+7+BTmX5vZatHVuoRB1nA: calls $0.50
*** TURN *** [8h Tc 9s] [8s]
KrPAGRACBg+w0M//SXe8Ag: bets $0.50
M+7+BTmX5vZatHVuoRB1nA: calls $0.50
*** RIVER *** [8h Tc 9s 8s] [Ts]
KrPAGRACBg+w0M//SXe8Ag: bets $4
M+7+BTmX5vZatHVuoRB1nA: folds
KrPAGRACBg+w0M//SXe8Ag collected $3.60 from pot
*** SUMMARY ***
Total pot $3.75 | Rake $0.15
Board [8h Tc 9s 8s Ts]
Seat 1: r3ZqM1Mi0W3y4hOdssE+Sg folded on the Flop
Seat 2: 8ehL7qlZzjgUh2H35iiWLw folded before Flop (didn't bet)
Seat 3: ymLPoEIl7UL3TvZYmnadxQ folded before Flop (didn't bet)
Seat 4: cMzaiXAM/ZAdNaEUu+LqhA folded before Flop (didn't bet)
Seat 5: M+7+BTmX5vZatHVuoRB1nA folded on the River
Seat 6: 3UmXLy3GfjC3EkOebduerQ (button) folded before Flop (didn't bet)
Seat 7: 997ViqAtWn1FPjJqcffwcA (small blind) folded before Flop
Seat 8: KrPAGRACBg+w0M//SXe8Ag (big blind) collected ($3.60)



PokerStars Game #59939604482:  Hold'em No Limit ($0.25/$0.50) - 2009/07/01 0:44:10 ET
Table 'QOgaEqMcJ73pcUMMxoisUgErOuyGLI5PT3G5MnpHgC/g Seat #7 is the button
Seat 1: L5e2lrPLQm1Pqx30IIZ/Fw ($12.55 in chips)
Seat 3: xZCXQSXlrZkp3pZizzVXCw ($50.50 in chips)
Seat 4: 3UmXLy3GfjC3EkOebduerQ ($50 in chips)
Seat 5: JwvquocWfhTVApN5t47LgA ($57.55 in chips)
Seat 6: zE9cVigS2nW/Ljy4K4bUQA ($30 in chips)
Seat 7: 90Wb75h3W1BRpbqVnuk8gw ($60.95 in chips)
Seat 8: g4k0NXISyLCqaSWZDBjfEg ($51.60 in chips)
Seat 9: J0W5D97jl5VLky+IoPvDeA ($57.90 in chips)
g4k0NXISyLCqaSWZDBjfEg: posts small blind $0.25
J0W5D97jl5VLky+IoPvDeA: posts big blind $0.50
*** HOLE CARDS ***
L5e2lrPLQm1Pqx30IIZ/Fw: folds
xZCXQSXlrZkp3pZizzVXCw: folds
3UmXLy3GfjC3EkOebduerQ: folds
JwvquocWfhTVApN5t47LgA: folds
zE9cVigS2nW/Ljy4K4bUQA: raises $1 to $1.50
90Wb75h3W1BRpbqVnuk8gw: folds
g4k0NXISyLCqaSWZDBjfEg: folds
J0W5D97jl5VLky+IoPvDeA: folds
zE9cVigS2nW/Ljy4K4bUQA collected $1.25 from pot
*** SUMMARY ***
Total pot $1.25 | Rake $0
Seat 1: L5e2lrPLQm1Pqx30IIZ/Fw folded before Flop (didn't bet)
Seat 3: xZCXQSXlrZkp3pZizzVXCw folded before Flop (didn't bet)
Seat 4: 3UmXLy3GfjC3EkOebduerQ folded before Flop (didn't bet)
Seat 5: JwvquocWfhTVApN5t47LgA folded before Flop (didn't bet)
Seat 6: zE9cVigS2nW/Ljy4K4bUQA collected ($1.25)
Seat 7: 90Wb75h3W1BRpbqVnuk8gw (button) folded before Flop (didn't bet)
Seat 8: g4k0NXISyLCqaSWZDBjfEg (small blind) folded before Flop
Seat 9: J0W5D97jl5VLky+IoPvDeA (big blind) folded before Flop



PokerStars Game #59939604658:  Hold'em No Limit ($0.25/$0.50) - 2009/07/01 0:44:10 ET
Table 'QOeVnLhwctF9UyV/beDi+A' 2-max Seat #1 is the button
Seat 1: bypIyrYcAAifLfhZpGlKLA ($60.75 in chips)
Seat 2: Ucrm3XtZmoONapW32SPhag ($22.65 in chips)
bypIyrYcAAifLfhZpGlKLA: posts small blind $0.25
Ucrm3XtZmoONapW32SPhag: posts big blind $0.50
*** HOLE CARDS ***
bypIyrYcAAifLfhZpGlKLA: folds
Ucrm3XtZmoONapW32SPhag collected $0.50 from pot
Ucrm3XtZmoONapW32SPhag: doesn't show hand
*** SUMMARY ***
Total pot $0.50 | Rake $0
Seat 1: bypIyrYcAAifLfhZpGlKLA (button) (small blind) folded before Flop
Seat 2: Ucrm3XtZmoONapW32SPhag (big blind) collected ($0.50)



PokerStars Game #59939604716:  Hold'em No Limit ($0.25/$0.50) - 2009/07/01 0:44:10 ET
Table 'IeNZOZQ4T6oiaHqFeo6yIA' 2-max Seat #1 is the button
Seat 1: ndd1nfncBkWNitBnsfCoVQ ($50.90 in chips)
Seat 2: A91IUl5JaZROhtfCtnnwYw ($122.20 in chips)
ndd1nfncBkWNitBnsfCoVQ: posts small blind $0.25
A91IUl5JaZROhtfCtnnwYw: posts big blind $0.50
*** HOLE CARDS ***
ndd1nfncBkWNitBnsfCoVQ: raises $1 to $1.50
A91IUl5JaZROhtfCtnnwYw: calls $1
*** FLOP *** [7d 5h 9d]
A91IUl5JaZROhtfCtnnwYw: bets $1.50
ndd1nfncBkWNitBnsfCoVQ: raises $4.50 to $6
A91IUl5JaZROhtfCtnnwYw: calls $4.50
*** TURN *** [7d 5h 9d] [Ad]
A91IUl5JaZROhtfCtnnwYw: checks
ndd1nfncBkWNitBnsfCoVQ: bets $12
A91IUl5JaZROhtfCtnnwYw: folds
ndd1nfncBkWNitBnsfCoVQ collected $14.50 from pot
ndd1nfncBkWNitBnsfCoVQ: doesn't show hand
*** SUMMARY ***
Total pot $15 | Rake $0.50
Board [7d 5h 9d Ad]
Seat 1: ndd1nfncBkWNitBnsfCoVQ (button) (small blind) collected ($14.50)
Seat 2: A91IUl5JaZROhtfCtnnwYw (big blind) folded on the Turn



PokerStars Game #59939605734:  Hold'em No Limit ($0.25/$0.50) - 2009/07/01 0:44:12 ET
Table '99gCy/CZQwPIjZWH+BguQgE7bWJ45aoFXRpyRv2gw+Igeat #4 is the button
Seat 2: n6VQBu6crjYjy6DxNP1NZA ($29.65 in chips)
Seat 3: qEn9ijNGtuyTxamBf07hYg ($50 in chips)
Seat 4: bxLSulbgr8LmKNjOzw8URg ($63.45 in chips)
Seat 5: DSM67hHHq1XFoEOi9p8Alw ($49.50 in chips)
Seat 6: OcnLOMVFdy23jXnoTyaO5Q ($245.05 in chips)
Seat 8: 8ehL7qlZzjgUh2H35iiWLw ($50 in chips)
Seat 9: j3K/Jujr7PY4ZM2RZvlH6A ($75.85 in chips)
DSM67hHHq1XFoEOi9p8Alw: posts small blind $0.25
OcnLOMVFdy23jXnoTyaO5Q: posts big blind $0.50
*** HOLE CARDS ***
8ehL7qlZzjgUh2H35iiWLw: folds
bfSq6LBw0UvxeM5yfuWC7w joins the table at seat #7
j3K/Jujr7PY4ZM2RZvlH6A: calls $0.50
n6VQBu6crjYjy6DxNP1NZA: folds
qEn9ijNGtuyTxamBf07hYg: folds
bxLSulbgr8LmKNjOzw8URg: folds
DSM67hHHq1XFoEOi9p8Alw: folds
OcnLOMVFdy23jXnoTyaO5Q: checks
*** FLOP *** [Td 2c Js]
OcnLOMVFdy23jXnoTyaO5Q: checks
j3K/Jujr7PY4ZM2RZvlH6A: checks
*** TURN *** [Td 2c Js] [Jh]
OcnLOMVFdy23jXnoTyaO5Q: bets $0.50
bfSq6LBw0UvxeM5yfuWC7w said, "are you"
bfSq6LBw0UvxeM5yfuWC7w said, "amana bynes"
j3K/Jujr7PY4ZM2RZvlH6A: calls $0.50
*** RIVER *** [Td 2c Js Jh] [8c]
OcnLOMVFdy23jXnoTyaO5Q: checks
j3K/Jujr7PY4ZM2RZvlH6A: checks
*** SHOW DOWN ***
OcnLOMVFdy23jXnoTyaO5Q: shows [4c 7s] (a pair of Jacks)
j3K/Jujr7PY4ZM2RZvlH6A: shows [3c 7c] (a pair of Jacks)
OcnLOMVFdy23jXnoTyaO5Q collected $1.10 from pot
j3K/Jujr7PY4ZM2RZvlH6A collected $1.05 from pot
*** SUMMARY ***
Total pot $2.25 | Rake $0.10
Board [Td 2c Js Jh 8c]
Seat 2: n6VQBu6crjYjy6DxNP1NZA folded before Flop (didn't bet)
Seat 3: qEn9ijNGtuyTxamBf07hYg folded before Flop (didn't bet)
Seat 4: bxLSulbgr8LmKNjOzw8URg (button) folded before Flop (didn't bet)
Seat 5: DSM67hHHq1XFoEOi9p8Alw (small blind) folded before Flop
Seat 6: OcnLOMVFdy23jXnoTyaO5Q (big blind) showed [4c 7s] and won ($1.10) with a pair of Jacks
Seat 8: 8ehL7qlZzjgUh2H35iiWLw folded before Flop (didn't bet)
Seat 9: j3K/Jujr7PY4ZM2RZvlH6A showed [3c 7c] and won ($1.05) with a pair of Jacks



PokerStars Game #59939605954:  Hold'em No Limit ($0.25/$0.50) - 2009/07/01 0:44:12 ET
Table 'eMxdLyFDf28E0wit6gm3Uw' 6-max Seat #1 is the button
Seat 1: GtdWeBVCZhDBcNFRTOb8Hg ($5.10 in chips)
Seat 2: jwuKQ1S3U4NnzMQn3E3dgw ($80.40 in chips)
Seat 3: dZcLsEI8iXkobBduRJ45Yw ($13.35 in chips)
Seat 4: 3jxEWvv2qK1HCXLj4khowQ ($41.25 in chips)
Seat 5: X0X97o2fDAPiGx6o1gahsw ($51.35 in chips)
jwuKQ1S3U4NnzMQn3E3dgw: posts small blind $0.25
dZcLsEI8iXkobBduRJ45Yw: posts big blind $0.50
nOfdMHEXflgT86UgFWblAA: sits out
*** HOLE CARDS ***
3jxEWvv2qK1HCXLj4khowQ: folds
X0X97o2fDAPiGx6o1gahsw: raises $1.50 to $2
GtdWeBVCZhDBcNFRTOb8Hg: folds
jwuKQ1S3U4NnzMQn3E3dgw: folds
dZcLsEI8iXkobBduRJ45Yw: folds
X0X97o2fDAPiGx6o1gahsw collected $1.25 from pot
*** SUMMARY ***
Total pot $1.25 | Rake $0
Seat 1: GtdWeBVCZhDBcNFRTOb8Hg (button) folded before Flop (didn't bet)
Seat 2: jwuKQ1S3U4NnzMQn3E3dgw (small blind) folded before Flop
Seat 3: dZcLsEI8iXkobBduRJ45Yw (big blind) folded before Flop
Seat 4: 3jxEWvv2qK1HCXLj4khowQ folded before Flop (didn't bet)
Seat 5: X0X97o2fDAPiGx6o1gahsw collected ($1.25)



PokerStars Game #59939606446:  Hold'em No Limit ($0.25/$0.50) - 2009/07/01 0:44:13 ET
Table 'NCiXr0d5CEKBQr/cZgLhbA' 9-max Seat #6 is the button
Seat 1: pFtzb1sR4b0d1aw6aIRgDg ($50 in chips)
Seat 2: ulxuJchBV9iguXg0FUonfg ($49.75 in chips)
Seat 3: xZCXQSXlrZkp3pZizzVXCw ($50.75 in chips)
Seat 4: 5k9fvXD9suIgCxU4HLQjTw ($56.70 in chips)
Seat 5: zE9cVigS2nW/Ljy4K4bUQA ($36.70 in chips)
Seat 6: SKnJuWHScqetA/qG5p+wCg ($30 in chips)
Seat 7: M+7+BTmX5vZatHVuoRB1nA ($47.85 in chips)
Seat 8: 1MJUKc3cc0QmUoz1JZLR2w ($56.50 in chips)
Seat 9: 4WLZvqBn5qv5tds5kt5A1Q ($46.55 in chips)
M+7+BTmX5vZatHVuoRB1nA: posts small blind $0.25
1MJUKc3cc0QmUoz1JZLR2w: posts big blind $0.50
*** HOLE CARDS ***
4WLZvqBn5qv5tds5kt5A1Q: folds
pFtzb1sR4b0d1aw6aIRgDg: calls $0.50
ulxuJchBV9iguXg0FUonfg: folds
xZCXQSXlrZkp3pZizzVXCw: folds
5k9fvXD9suIgCxU4HLQjTw: folds
zE9cVigS2nW/Ljy4K4bUQA: folds
SKnJuWHScqetA/qG5p+wCg: raises $1.50 to $2
M+7+BTmX5vZatHVuoRB1nA: folds
1MJUKc3cc0QmUoz1JZLR2w: calls $1.50
pFtzb1sR4b0d1aw6aIRgDg: calls $1.50
*** FLOP *** [7d 6d 7h]
1MJUKc3cc0QmUoz1JZLR2w: checks
pFtzb1sR4b0d1aw6aIRgDg: checks
SKnJuWHScqetA/qG5p+wCg: bets $2.50
1MJUKc3cc0QmUoz1JZLR2w: folds
pFtzb1sR4b0d1aw6aIRgDg: folds
SKnJuWHScqetA/qG5p+wCg collected $5.95 from pot
*** SUMMARY ***
Total pot $6.25 | Rake $0.30
Board [7d 6d 7h]
Seat 1: pFtzb1sR4b0d1aw6aIRgDg folded on the Flop
Seat 2: ulxuJchBV9iguXg0FUonfg folded before Flop (didn't bet)
Seat 3: xZCXQSXlrZkp3pZizzVXCw folded before Flop (didn't bet)
Seat 4: 5k9fvXD9suIgCxU4HLQjTw folded before Flop (didn't bet)
Seat 5: zE9cVigS2nW/Ljy4K4bUQA folded before Flop (didn't bet)
Seat 6: SKnJuWHScqetA/qG5p+wCg (button) collected ($5.95)
Seat 7: M+7+BTmX5vZatHVuoRB1nA (small blind) folded before Flop
Seat 8: 1MJUKc3cc0QmUoz1JZLR2w (big blind) folded on the Flop
Seat 9: 4WLZvqBn5qv5tds5kt5A1Q folded before Flop (didn't bet)



PokerStars Game #59939606692:  Hold'em No Limit ($0.25/$0.50) - 2009/07/01 0:44:13 ET
Table '+111aLuBwnz8YVYSA7J1jA' 2-max Seat #2 is the button
Seat 1: ndd1nfncBkWNitBnsfCoVQ ($76.20 in chips)
Seat 2: +ciXH35zeafrjg1W6wiBTg ($73.15 in chips)
+ciXH35zeafrjg1W6wiBTg: posts small blind $0.25
ndd1nfncBkWNitBnsfCoVQ: posts big blind $0.50
*** HOLE CARDS ***
+ciXH35zeafrjg1W6wiBTg: calls $0.25
ndd1nfncBkWNitBnsfCoVQ: checks
*** FLOP *** [Kd Ad 4h]
ndd1nfncBkWNitBnsfCoVQ: bets $1
+ciXH35zeafrjg1W6wiBTg: folds
ndd1nfncBkWNitBnsfCoVQ collected $0.95 from pot
ndd1nfncBkWNitBnsfCoVQ: doesn't show hand
*** SUMMARY ***
Total pot $1 | Rake $0.05
Board [Kd Ad 4h]
Seat 1: ndd1nfncBkWNitBnsfCoVQ (big blind) collected ($0.95)
Seat 2: +ciXH35zeafrjg1W6wiBTg (button) (small blind) folded on the Flop



PokerStars Game #59939607138:  Hold'em No Limit ($0.25/$0.50) - 2009/07/01 0:44:14 ET
Table 'E7bWJ45aoFXRpyRv2gw+Ig' 2-max Seat #1 is the button
Seat 1: FRkiRasEGlHUeLrEl+k/nA ($72.50 in chips)
Seat 2: 3Wro85I7472vJ4Wkpneo9A ($123.40 in chips)
FRkiRasEGlHUeLrEl+k/nA: posts small blind $0.25
3Wro85I7472vJ4Wkpneo9A: posts big blind $0.50
*** HOLE CARDS ***
FRkiRasEGlHUeLrEl+k/nA: calls $0.25
3Wro85I7472vJ4Wkpneo9A: checks
*** FLOP *** [8c 4h 4s]
3Wro85I7472vJ4Wkpneo9A: bets $1
FRkiRasEGlHUeLrEl+k/nA: calls $1
*** TURN *** [8c 4h 4s] [Kd]
3Wro85I7472vJ4Wkpneo9A: checks
FRkiRasEGlHUeLrEl+k/nA: bets $1.50
3Wro85I7472vJ4Wkpneo9A: calls $1.50
*** RIVER *** [8c 4h 4s Kd] [2c]
3Wro85I7472vJ4Wkpneo9A: checks
FRkiRasEGlHUeLrEl+k/nA: checks
*** SHOW DOWN ***
3Wro85I7472vJ4Wkpneo9A: shows [8h Jd] (two pair, Eights and Fours)
FRkiRasEGlHUeLrEl+k/nA: mucks hand
3Wro85I7472vJ4Wkpneo9A collected $5.75 from pot
*** SUMMARY ***
Total pot $6 | Rake $0.25
Board [8c 4h 4s Kd 2c]
Seat 1: FRkiRasEGlHUeLrEl+k/nA (button) (small blind) mucked
Seat 2: 3Wro85I7472vJ4Wkpneo9A (big blind) showed [8h Jd] and won ($5.75) with two pair, Eights and Fours



PokerStars Game #59939608048:  Hold'em No Limit ($0.25/$0.50) - 2009/07/01 0:44:15 ET
Table 'QOeVnLhwctF9UyV/beDi+A' 2-max Seat #2 is the button
Seat 1: bypIyrYcAAifLfhZpGlKLA ($60.50 in chips)
Seat 2: Ucrm3XtZmoONapW32SPhag ($22.90 in chips)
Ucrm3XtZmoONapW32SPhag: posts small blind $0.25
bypIyrYcAAifLfhZpGlKLA: posts big blind $0.50
*** HOLE CARDS ***
Ucrm3XtZmoONapW32SPhag: folds
bypIyrYcAAifLfhZpGlKLA collected $0.50 from pot
bypIyrYcAAifLfhZpGlKLA: doesn't show hand
*** SUMMARY ***
Total pot $0.50 | Rake $0
Seat 1: bypIyrYcAAifLfhZpGlKLA (big blind) collected ($0.50)
Seat 2: Ucrm3XtZmoONapW32SPhag (button) (small blind) folded before Flop



PokerStars Game #59939608500:  Hold'em No Limit ($0.25/$0.50) - 2009/07/01 0:44:16 ET
Table '+dXkOAQyS8j9PQZusUTMpg' 2-max Seat #2 is the button
Seat 1: XFa6sBGjP2gxoIvxR3fZIg ($55.20 in chips)
Seat 2: 5IBeOgaApY1Bvzv2P8X4EA ($148.95 in chips)
5IBeOgaApY1Bvzv2P8X4EA: posts small blind $0.25
XFa6sBGjP2gxoIvxR3fZIg: posts big blind $0.50
*** HOLE CARDS ***
5IBeOgaApY1Bvzv2P8X4EA: folds
XFa6sBGjP2gxoIvxR3fZIg collected $0.50 from pot
*** SUMMARY ***
Total pot $0.50 | Rake $0
Seat 1: XFa6sBGjP2gxoIvxR3fZIg (big blind) collected ($0.50)
Seat 2: 5IBeOgaApY1Bvzv2P8X4EA (button) (small blind) folded before Flop



PokerStars Game #59939609314:  Hold'em No Limit ($0.25/$0.50) - 2009/07/01 0:44:17 ET
Table 'GfL/No5u5PoEnU39lP5pQg' 6-max Seat #5 is the button
Seat 1: 1WUCqNG+p+vfWRTXNu4ljw ($63.20 in chips)
Seat 2: uVwggSetzp7d+eVgowO3vg ($69.45 in chips)
Seat 3: Ek4w9XqBXqK5jBUQeLedGw ($50 in chips)
Seat 4: x+pzUFJsMIiGd7a5pcR4tg ($53.55 in chips)
Seat 5: M1KyQQvVPVuxqTAB8sR/zQ ($50 in chips)
drintense was removed from the table for failing to post
1WUCqNG+p+vfWRTXNu4ljw: posts small blind $0.25
uVwggSetzp7d+eVgowO3vg: posts big blind $0.50
*** HOLE CARDS ***
Ek4w9XqBXqK5jBUQeLedGw: folds
x+pzUFJsMIiGd7a5pcR4tg: raises $1 to $1.50
M1KyQQvVPVuxqTAB8sR/zQ: folds
1WUCqNG+p+vfWRTXNu4ljw: folds
uVwggSetzp7d+eVgowO3vg: calls $1
*** FLOP *** [7h 9s Kh]
uVwggSetzp7d+eVgowO3vg: checks
x+pzUFJsMIiGd7a5pcR4tg: checks
*** TURN *** [7h 9s Kh] [Tc]
uVwggSetzp7d+eVgowO3vg: checks
x+pzUFJsMIiGd7a5pcR4tg: checks
*** RIVER *** [7h 9s Kh Tc] [Jh]
uVwggSetzp7d+eVgowO3vg: checks
x+pzUFJsMIiGd7a5pcR4tg: bets $2.50
uVwggSetzp7d+eVgowO3vg: folds
x+pzUFJsMIiGd7a5pcR4tg collected $3.10 from pot
x+pzUFJsMIiGd7a5pcR4tg: doesn't show hand
*** SUMMARY ***
Total pot $3.25 | Rake $0.15
Board [7h 9s Kh Tc Jh]
Seat 1: 1WUCqNG+p+vfWRTXNu4ljw (small blind) folded before Flop
Seat 2: uVwggSetzp7d+eVgowO3vg (big blind) folded on the River
Seat 3: Ek4w9XqBXqK5jBUQeLedGw folded before Flop (didn't bet)
Seat 4: x+pzUFJsMIiGd7a5pcR4tg collected ($3.10)
Seat 5: M1KyQQvVPVuxqTAB8sR/zQ (button) folded before Flop (didn't bet)



PokerStars Game #59939610598:  Hold'em No Limit ($0.25/$0.50) - 2009/07/01 0:44:19 ET
Table 'QOgaEqMcJ73pcUMMxoisUg' 6-max Seat #4 is the button
Seat 1: OZ6OtYh5Y53MCH/p0QTn5g ($108.90 in chips)
Seat 2: 4QfsCWthT/vSLirorNXqtg ($50 in chips)
Seat 3: Rt6KgtZ8YaJoTc3FPim00w ($76.75 in chips)
Seat 4: zAcsDhG/T128Vn7XGVSgKg ($50 in chips)
Seat 5: 6vNxrjjCl6FwfaaymM9jjg ($15 in chips)
Seat 6: pmE+2KJb4nffAVqjLIXxFg ($24.20 in chips)
6vNxrjjCl6FwfaaymM9jjg: posts small blind $0.25
pmE+2KJb4nffAVqjLIXxFg: posts big blind $0.50
*** HOLE CARDS ***
OZ6OtYh5Y53MCH/p0QTn5g: folds
4QfsCWthT/vSLirorNXqtg: folds
Rt6KgtZ8YaJoTc3FPim00w: folds
OZ6OtYh5Y53MCH/p0QTn5g leaves the table
zAcsDhG/T128Vn7XGVSgKg: raises $1 to $1.50
6vNxrjjCl6FwfaaymM9jjg: folds
pmE+2KJb4nffAVqjLIXxFg: calls $1
*** FLOP *** [9h Jh 5h]
pmE+2KJb4nffAVqjLIXxFg: checks
/olYG0EzMWzADIgH1y2ySQ joins the table at seat #1
zAcsDhG/T128Vn7XGVSgKg: bets $2.50
pmE+2KJb4nffAVqjLIXxFg: folds
zAcsDhG/T128Vn7XGVSgKg collected $3.10 from pot
*** SUMMARY ***
Total pot $3.25 | Rake $0.15
Board [9h Jh 5h]
Seat 1: OZ6OtYh5Y53MCH/p0QTn5g folded before Flop (didn't bet)
Seat 2: 4QfsCWthT/vSLirorNXqtg folded before Flop (didn't bet)
Seat 3: Rt6KgtZ8YaJoTc3FPim00w folded before Flop (didn't bet)
Seat 4: zAcsDhG/T128Vn7XGVSgKg (button) collected ($3.10)
Seat 5: 6vNxrjjCl6FwfaaymM9jjg (small blind) folded before Flop
Seat 6: pmE+2KJb4nffAVqjLIXxFg (big blind) folded on the Flop



PokerStars Game #59939612850:  Hold'em No Limit ($0.25/$0.50) - 2009/07/01 0:44:23 ET
Table 'QOeVnLhwctF9UyV/beDi+A' 2-max Seat #1 is the button
Seat 1: bypIyrYcAAifLfhZpGlKLA ($60.75 in chips)
Seat 2: Ucrm3XtZmoONapW32SPhag ($22.65 in chips)
bypIyrYcAAifLfhZpGlKLA: posts small blind $0.25
Ucrm3XtZmoONapW32SPhag: posts big blind $0.50
*** HOLE CARDS ***
bypIyrYcAAifLfhZpGlKLA: folds
Ucrm3XtZmoONapW32SPhag collected $0.50 from pot
Ucrm3XtZmoONapW32SPhag: doesn't show hand
*** SUMMARY ***
Total pot $0.50 | Rake $0
Seat 1: bypIyrYcAAifLfhZpGlKLA (button) (small blind) folded before Flop
Seat 2: Ucrm3XtZmoONapW32SPhag (big blind) collected ($0.50)



PokerStars Game #59939612892:  Hold'em No Limit ($0.25/$0.50) - 2009/07/01 0:44:23 ET
Table 'MJxeZCzYELxiIsyUZyT0jw' 6-max Seat #5 is the button
Seat 1: jNIq+EZLEm61oWSMYUVeWQ ($11.60 in chips)
Seat 3: JQZew0FjzS19kTjeNtrE+A ($52.30 in chips)
Seat 4: alGiiQP/wwtYnfuXII+sgw ($45.95 in chips)
Seat 5: 3jvoOXNtXE90w2BdfNZwZQ ($51.25 in chips)
Seat 6: TTx3CHxyi0SObcHyMJRp5w ($57.70 in chips)
TTx3CHxyi0SObcHyMJRp5w: posts small blind $0.25
jNIq+EZLEm61oWSMYUVeWQ: posts big blind $0.50
*** HOLE CARDS ***
JQZew0FjzS19kTjeNtrE+A: folds
alGiiQP/wwtYnfuXII+sgw: folds
3jvoOXNtXE90w2BdfNZwZQ: folds
TTx3CHxyi0SObcHyMJRp5w: folds
jNIq+EZLEm61oWSMYUVeWQ collected $0.50 from pot
*** SUMMARY ***
Total pot $0.50 | Rake $0
Seat 1: jNIq+EZLEm61oWSMYUVeWQ (big blind) collected ($0.50)
Seat 3: JQZew0FjzS19kTjeNtrE+A folded before Flop (didn't bet)
Seat 4: alGiiQP/wwtYnfuXII+sgw folded before Flop (didn't bet)
Seat 5: 3jvoOXNtXE90w2BdfNZwZQ (button) folded before Flop (didn't bet)
Seat 6: TTx3CHxyi0SObcHyMJRp5w (small blind) folded before Flop



PokerStars Game #59939613308:  Hold'em No Limit ($0.25/$0.50) - 2009/07/01 0:44:24 ET
Table 'Vdlc9wqYcHTUhtdyN7CuJw' 2-max Seat #1 is the button
Seat 1: yBO+mXB6m/rCft2ErwGf/Q ($108.45 in chips)
Seat 2: NZ/5cxwnorKW2SNsWy1+8A ($18 in chips)
yBO+mXB6m/rCft2ErwGf/Q: posts small blind $0.25
NZ/5cxwnorKW2SNsWy1+8A: posts big blind $0.50
*** HOLE CARDS ***
yBO+mXB6m/rCft2ErwGf/Q: raises $0.50 to $1
NZ/5cxwnorKW2SNsWy1+8A: folds
yBO+mXB6m/rCft2ErwGf/Q collected $1 from pot
*** SUMMARY ***
Total pot $1 | Rake $0
Seat 1: yBO+mXB6m/rCft2ErwGf/Q (button) (small blind) collected ($1)
Seat 2: NZ/5cxwnorKW2SNsWy1+8A (big blind) folded before Flop



PokerStars Game #59939613644:  Hold'em No Limit ($0.25/$0.50) - 2009/07/01 0:44:24 ET
Table '+dXkOAQyS8j9PQZusUTMpg' 2-max Seat #1 is the button
Seat 1: XFa6sBGjP2gxoIvxR3fZIg ($55.45 in chips)
Seat 2: 5IBeOgaApY1Bvzv2P8X4EA ($148.70 in chips)
XFa6sBGjP2gxoIvxR3fZIg: posts small blind $0.25
5IBeOgaApY1Bvzv2P8X4EA: posts big blind $0.50
*** HOLE CARDS ***
XFa6sBGjP2gxoIvxR3fZIg: raises $1 to $1.50
5IBeOgaApY1Bvzv2P8X4EA: folds
XFa6sBGjP2gxoIvxR3fZIg collected $1 from pot
*** SUMMARY ***
Total pot $1 | Rake $0
Seat 1: XFa6sBGjP2gxoIvxR3fZIg (button) (small blind) collected ($1)
Seat 2: 5IBeOgaApY1Bvzv2P8X4EA (big blind) folded before Flop



PokerStars Game #59939614176:  Hold'em No Limit ($0.25/$0.50) - 2009/07/01 0:44:25 ET
Table 'hWT2kq66tnKEpD26cia6fQ' 2-max Seat #1 is the button
Seat 1: q+vRKwm51mnr6kxX/161WQ ($55.45 in chips)
Seat 2: dkC7J+qbyqk0qCcmJbEPPw ($57.05 in chips)
q+vRKwm51mnr6kxX/161WQ: posts small blind $0.25
dkC7J+qbyqk0qCcmJbEPPw: posts big blind $0.50
*** HOLE CARDS ***
q+vRKwm51mnr6kxX/161WQ: raises $1 to $1.50
dkC7J+qbyqk0qCcmJbEPPw: folds
q+vRKwm51mnr6kxX/161WQ collected $1 from pot
q+vRKwm51mnr6kxX/161WQ: doesn't show hand
*** SUMMARY ***
Total pot $1 | Rake $0
Seat 1: q+vRKwm51mnr6kxX/161WQ (button) (small blind) collected ($1)
Seat 2: dkC7J+qbyqk0qCcmJbEPPw (big blind) folded before Flop



PokerStars Game #59939615006:  Hold'em No Limit ($0.25/$0.50) - 2009/07/01 0:44:26 ET
Table 'BCN5su+SsXiy1zRMJi0SJw' 6-max Seat #2 is the button
Seat 1: crjGpJEzSZgD38FoE3VMGg ($50 in chips)
Seat 2: oU2kDCkT/gilYbHWrg7D8w ($12.65 in chips)
Seat 3: g+vwI6lMKpU2uteXSjOzVw ($19.55 in chips)
Seat 4: JY9CtoZTeav+mhWyxSSyJQ ($26.90 in chips)
Seat 5: IBNygaT1aa9Z1uPdJJilwA ($63.50 in chips)
Seat 6: b2symlOdL7+0c9Pj4N/KlA ($52.85 in chips)
g+vwI6lMKpU2uteXSjOzVw: posts small blind $0.25
JY9CtoZTeav+mhWyxSSyJQ: posts big blind $0.50
*** HOLE CARDS ***
IBNygaT1aa9Z1uPdJJilwA: raises $1 to $1.50
b2symlOdL7+0c9Pj4N/KlA: folds
crjGpJEzSZgD38FoE3VMGg: folds
oU2kDCkT/gilYbHWrg7D8w: folds
g+vwI6lMKpU2uteXSjOzVw: folds
JY9CtoZTeav+mhWyxSSyJQ: folds
IBNygaT1aa9Z1uPdJJilwA collected $1.25 from pot
*** SUMMARY ***
Total pot $1.25 | Rake $0
Seat 1: crjGpJEzSZgD38FoE3VMGg folded before Flop (didn't bet)
Seat 2: oU2kDCkT/gilYbHWrg7D8w (button) folded before Flop (didn't bet)
Seat 3: g+vwI6lMKpU2uteXSjOzVw (small blind) folded before Flop
Seat 4: JY9CtoZTeav+mhWyxSSyJQ (big blind) folded before Flop
Seat 5: IBNygaT1aa9Z1uPdJJilwA collected ($1.25)
Seat 6: b2symlOdL7+0c9Pj4N/KlA folded before Flop (didn't bet)



PokerStars Game #59939615838:  Hold'em No Limit ($0.25/$0.50) - 2009/07/01 0:44:27 ET
Table '+z1aekfHkpp09pc8F9aViw' 6-max Seat #4 is the button
Seat 1: FHilMb2i2DbUCc9lplszog ($36.10 in chips)
Seat 2: M6xK/VklCvdyyrmvzATlxQ ($36 in chips)
Seat 3: uUznlIMFnRUvwrBhYF73KA ($75.45 in chips)
Seat 4: RowCSpSURHTOL/dcjg/Iug ($50.05 in chips)
Seat 5: crjGpJEzSZgD38FoE3VMGg ($50 in chips)
Seat 6: 686aeHikcJlgKkSuIFdcXQ ($67.10 in chips)
crjGpJEzSZgD38FoE3VMGg: posts small blind $0.25
686aeHikcJlgKkSuIFdcXQ: posts big blind $0.50
*** HOLE CARDS ***
FHilMb2i2DbUCc9lplszog: folds
M6xK/VklCvdyyrmvzATlxQ: folds
uUznlIMFnRUvwrBhYF73KA: calls $0.50
RowCSpSURHTOL/dcjg/Iug: folds
crjGpJEzSZgD38FoE3VMGg: raises $3 to $3.50
686aeHikcJlgKkSuIFdcXQ: folds
uUznlIMFnRUvwrBhYF73KA: calls $3
*** FLOP *** [5d 4c Jh]
crjGpJEzSZgD38FoE3VMGg: bets $6
uUznlIMFnRUvwrBhYF73KA: raises $7.50 to $13.50
crjGpJEzSZgD38FoE3VMGg: calls $7.50
*** TURN *** [5d 4c Jh] [7d]
crjGpJEzSZgD38FoE3VMGg: checks
uUznlIMFnRUvwrBhYF73KA: checks
*** RIVER *** [5d 4c Jh 7d] [3d]
crjGpJEzSZgD38FoE3VMGg: checks
uUznlIMFnRUvwrBhYF73KA: bets $17.50
crjGpJEzSZgD38FoE3VMGg: calls $17.50
*** SHOW DOWN ***
uUznlIMFnRUvwrBhYF73KA: shows [5s 5h] (three of a kind, Fives)
crjGpJEzSZgD38FoE3VMGg: mucks hand
uUznlIMFnRUvwrBhYF73KA collected $66.50 from pot
*** SUMMARY ***
Total pot $69.50 | Rake $3
Board [5d 4c Jh 7d 3d]
Seat 1: FHilMb2i2DbUCc9lplszog folded before Flop (didn't bet)
Seat 2: M6xK/VklCvdyyrmvzATlxQ folded before Flop (didn't bet)
Seat 3: uUznlIMFnRUvwrBhYF73KA showed [5s 5h] and won ($66.50) with three of a kind, Fives
Seat 4: RowCSpSURHTOL/dcjg/Iug (button) folded before Flop (didn't bet)
Seat 5: crjGpJEzSZgD38FoE3VMGg (small blind) mucked
Seat 6: 686aeHikcJlgKkSuIFdcXQ (big blind) folded before Flop



PokerStars Game #59939615514:  Hold'em No Limit ($0.25/$0.50) - 2009/07/01 0:44:27 ET
Table '+111aLuBwnz8YVYSA7J1jA' 2-max Seat #1 is the button
Seat 1: ndd1nfncBkWNitBnsfCoVQ ($76.65 in chips)
Seat 2: +ciXH35zeafrjg1W6wiBTg ($72.65 in chips)
ndd1nfncBkWNitBnsfCoVQ: posts small blind $0.25
+ciXH35zeafrjg1W6wiBTg: posts big blind $0.50
*** HOLE CARDS ***
ndd1nfncBkWNitBnsfCoVQ: raises $1 to $1.50
+ciXH35zeafrjg1W6wiBTg: raises $1.50 to $3
ndd1nfncBkWNitBnsfCoVQ: calls $1.50
*** FLOP *** [3h As 2d]
+ciXH35zeafrjg1W6wiBTg: bets $4
ndd1nfncBkWNitBnsfCoVQ: folds
+ciXH35zeafrjg1W6wiBTg collected $5.70 from pot
+ciXH35zeafrjg1W6wiBTg: doesn't show hand
*** SUMMARY ***
Total pot $6 | Rake $0.30
Board [3h As 2d]
Seat 1: ndd1nfncBkWNitBnsfCoVQ (button) (small blind) folded on the Flop
Seat 2: +ciXH35zeafrjg1W6wiBTg (big blind) collected ($5.70)



PokerStars Game #59939616786:  Hold'em No Limit ($0.25/$0.50) - 2009/07/01 0:44:29 ET
Table 'QOeVnLhwctF9UyV/beDi+A' 2-max Seat #2 is the button
Seat 1: bypIyrYcAAifLfhZpGlKLA ($60.50 in chips)
Seat 2: Ucrm3XtZmoONapW32SPhag ($22.90 in chips)
Ucrm3XtZmoONapW32SPhag: posts small blind $0.25
bypIyrYcAAifLfhZpGlKLA: posts big blind $0.50
*** HOLE CARDS ***
Ucrm3XtZmoONapW32SPhag: folds
bypIyrYcAAifLfhZpGlKLA collected $0.50 from pot
bypIyrYcAAifLfhZpGlKLA: doesn't show hand
*** SUMMARY ***
Total pot $0.50 | Rake $0
Seat 1: bypIyrYcAAifLfhZpGlKLA (big blind) collected ($0.50)
Seat 2: Ucrm3XtZmoONapW32SPhag (button) (small blind) folded before Flop



PokerStars Game #59939617494:  Hold'em No Limit ($0.25/$0.50) - 2009/07/01 0:44:30 ET
Table 'lSisgp6H7Fg1hH5VfjEjYQ' 9-max Seat #3 is the button
Seat 1: 5k9fvXD9suIgCxU4HLQjTw ($50 in chips)
Seat 2: UrcnkQOiLVk8BlKDPJSy7Q ($50 in chips)
Seat 3: aTkyjTh3w5YLWiIERupZOA ($51.95 in chips)
Seat 4: bwv/rbH/hHhPhY6u9mu04w ($33 in chips)
Seat 5: mSD1pginDsyHG5PDfqzphw ($12.10 in chips)
Seat 6: +k7T5ocke8UwavtgUHm+Cg ($29.30 in chips)
Seat 7: Y3DZ6qQlLeBhixDj4M9vmg ($10.80 in chips)
Seat 8: a4JDWmpFQkL10XfAyuF51A ($33.25 in chips)
Seat 9: gsyXT42WLEcOS4DdEk2wlw ($30.20 in chips)
bwv/rbH/hHhPhY6u9mu04w: posts small blind $0.25
mSD1pginDsyHG5PDfqzphw: posts big blind $0.50
*** HOLE CARDS ***
+k7T5ocke8UwavtgUHm+Cg: raises $1.50 to $2
Y3DZ6qQlLeBhixDj4M9vmg: folds
a4JDWmpFQkL10XfAyuF51A: folds
gsyXT42WLEcOS4DdEk2wlw: folds
5k9fvXD9suIgCxU4HLQjTw: folds
UrcnkQOiLVk8BlKDPJSy7Q: folds
aTkyjTh3w5YLWiIERupZOA: folds
bwv/rbH/hHhPhY6u9mu04w: calls $1.75
mSD1pginDsyHG5PDfqzphw: folds
*** FLOP *** [2d Jd 8s]
bwv/rbH/hHhPhY6u9mu04w: checks
+k7T5ocke8UwavtgUHm+Cg: bets $2
bwv/rbH/hHhPhY6u9mu04w: folds
+k7T5ocke8UwavtgUHm+Cg collected $4.30 from pot
+k7T5ocke8UwavtgUHm+Cg: doesn't show hand
*** SUMMARY ***
Total pot $4.50 | Rake $0.20
Board [2d Jd 8s]
Seat 1: 5k9fvXD9suIgCxU4HLQjTw folded before Flop (didn't bet)
Seat 2: UrcnkQOiLVk8BlKDPJSy7Q folded before Flop (didn't bet)
Seat 3: aTkyjTh3w5YLWiIERupZOA (button) folded before Flop (didn't bet)
Seat 4: bwv/rbH/hHhPhY6u9mu04w (small blind) folded on the Flop
Seat 5: mSD1pginDsyHG5PDfqzphw (big blind) folded before Flop
Seat 6: +k7T5ocke8UwavtgUHm+Cg collected ($4.30)
Seat 7: Y3DZ6qQlLeBhixDj4M9vmg folded before Flop (didn't bet)
Seat 8: a4JDWmpFQkL10XfAyuF51A folded before Flop (didn't bet)
Seat 9: gsyXT42WLEcOS4DdEk2wlw folded before Flop (didn't bet)



PokerStars Game #59939619734:  Hold'em No Limit ($0.25/$0.50) - 2009/07/01 0:44:33 ET
Table '+dXkOAQyS8j9PQZusUTMpg' 2-max Seat #2 is the button
Seat 1: XFa6sBGjP2gxoIvxR3fZIg ($55.95 in chips)
Seat 2: 5IBeOgaApY1Bvzv2P8X4EA ($148.20 in chips)
5IBeOgaApY1Bvzv2P8X4EA: posts small blind $0.25
XFa6sBGjP2gxoIvxR3fZIg: posts big blind $0.50
*** HOLE CARDS ***
5IBeOgaApY1Bvzv2P8X4EA: folds
XFa6sBGjP2gxoIvxR3fZIg collected $0.50 from pot
*** SUMMARY ***
Total pot $0.50 | Rake $0
Seat 1: XFa6sBGjP2gxoIvxR3fZIg (big blind) collected ($0.50)
Seat 2: 5IBeOgaApY1Bvzv2P8X4EA (button) (small blind) folded before Flop



PokerStars Game #59939619470:  Hold'em No Limit ($0.25/$0.50) - 2009/07/01 0:44:33 ET
Table '5EmHi+fnatGQQShcNmzOZQ' 6-max Seat #1 is the button
Seat 1: +SZCX3+7lnuhHKIu+PP9rg ($30.35 in chips)
Seat 2: vXIHnZ+dv/hwSBxyvGw7bQ ($77.85 in chips)
Seat 3: L9qfLYXrczhAPd/VckgsWw ($80 in chips)
Seat 4: 1b+2BbjMN8qhR1WPqdE9VQ ($53.65 in chips)
Seat 5: kxPhs4ePFqMy52CInAJ2aw ($56.10 in chips)
Seat 6: 686aeHikcJlgKkSuIFdcXQ ($141.20 in chips)
vXIHnZ+dv/hwSBxyvGw7bQ: posts small blind $0.25
L9qfLYXrczhAPd/VckgsWw: posts big blind $0.50
*** HOLE CARDS ***
1b+2BbjMN8qhR1WPqdE9VQ: folds
kxPhs4ePFqMy52CInAJ2aw: folds
686aeHikcJlgKkSuIFdcXQ: raises $1 to $1.50
+SZCX3+7lnuhHKIu+PP9rg: folds
vXIHnZ+dv/hwSBxyvGw7bQ: folds
L9qfLYXrczhAPd/VckgsWw: folds
686aeHikcJlgKkSuIFdcXQ collected $1.25 from pot
*** SUMMARY ***
Total pot $1.25 | Rake $0
Seat 1: +SZCX3+7lnuhHKIu+PP9rg (button) folded before Flop (didn't bet)
Seat 2: vXIHnZ+dv/hwSBxyvGw7bQ (small blind) folded before Flop
Seat 3: L9qfLYXrczhAPd/VckgsWw (big blind) folded before Flop
Seat 4: 1b+2BbjMN8qhR1WPqdE9VQ folded before Flop (didn't bet)
Seat 5: kxPhs4ePFqMy52CInAJ2aw folded before Flop (didn't bet)
Seat 6: 686aeHikcJlgKkSuIFdcXQ collected ($1.25)



PokerStars Game #59939619642:  Hold'em No Limit ($0.25/$0.50) - 2009/07/01 0:44:33 ET
Table 'T/PgNWqVyY6lkldcBVXYJQ' 6-max Seat #3 is the button
Seat 1: +Pf9jTVizYlIo+woPvptfA ($55.75 in chips)
Seat 2: LvH4G7n+QSjT6NDaD3cREA ($75 in chips)
Seat 3: L3OcNO1bgdqDI46j67KQPQ ($50 in chips)
Seat 4: Ek4w9XqBXqK5jBUQeLedGw ($50 in chips)
Seat 5: vVQBckETtigfb5mAcyK0OA ($55.70 in chips)
Seat 6: cDzbog6kwmJp+LBeBq+iMQ ($28.40 in chips)
Ek4w9XqBXqK5jBUQeLedGw: posts small blind $0.25
vVQBckETtigfb5mAcyK0OA: posts big blind $0.50
*** HOLE CARDS ***
cDzbog6kwmJp+LBeBq+iMQ: folds
+Pf9jTVizYlIo+woPvptfA: folds
cDzbog6kwmJp+LBeBq+iMQ said, "u had me b4 the river rant"
LvH4G7n+QSjT6NDaD3cREA: raises $1 to $1.50
cDzbog6kwmJp+LBeBq+iMQ said, "so i guess it didnt matter"
L3OcNO1bgdqDI46j67KQPQ: folds
Ek4w9XqBXqK5jBUQeLedGw: folds
vVQBckETtigfb5mAcyK0OA: folds
LvH4G7n+QSjT6NDaD3cREA collected $1.25 from pot
LvH4G7n+QSjT6NDaD3cREA: doesn't show hand
*** SUMMARY ***
Total pot $1.25 | Rake $0
Seat 1: +Pf9jTVizYlIo+woPvptfA folded before Flop (didn't bet)
Seat 2: LvH4G7n+QSjT6NDaD3cREA collected ($1.25)
Seat 3: L3OcNO1bgdqDI46j67KQPQ (button) folded before Flop (didn't bet)
Seat 4: Ek4w9XqBXqK5jBUQeLedGw (small blind) folded before Flop
Seat 5: vVQBckETtigfb5mAcyK0OA (big blind) folded before Flop
Seat 6: cDzbog6kwmJp+LBeBq+iMQ folded before Flop (didn't bet)



PokerStars Game #59939620980:  Hold'em No Limit ($0.25/$0.50) - 2009/07/01 0:44:35 ET
Table 'QOeVnLhwctF9UyV/beDi+A' 2-max Seat #1 is the button
Seat 1: bypIyrYcAAifLfhZpGlKLA ($60.75 in chips)
Seat 2: Ucrm3XtZmoONapW32SPhag ($22.65 in chips)
bypIyrYcAAifLfhZpGlKLA: posts small blind $0.25
Ucrm3XtZmoONapW32SPhag: posts big blind $0.50
*** HOLE CARDS ***
bypIyrYcAAifLfhZpGlKLA: raises $1 to $1.50
Ucrm3XtZmoONapW32SPhag: folds
bypIyrYcAAifLfhZpGlKLA collected $1 from pot
bypIyrYcAAifLfhZpGlKLA: doesn't show hand
*** SUMMARY ***
Total pot $1 | Rake $0
Seat 1: bypIyrYcAAifLfhZpGlKLA (button) (small blind) collected ($1)
Seat 2: Ucrm3XtZmoONapW32SPhag (big blind) folded before Flop



PokerStars Game #59939620542:  Hold'em No Limit ($0.25/$0.50) - 2009/07/01 0:44:35 ET
Table 'hWT2kq66tnKEpD26cia6fQ' 2-max Seat #2 is the button
Seat 1: q+vRKwm51mnr6kxX/161WQ ($55.95 in chips)
Seat 2: dkC7J+qbyqk0qCcmJbEPPw ($56.55 in chips)
dkC7J+qbyqk0qCcmJbEPPw: posts small blind $0.25
q+vRKwm51mnr6kxX/161WQ: posts big blind $0.50
*** HOLE CARDS ***
dkC7J+qbyqk0qCcmJbEPPw: folds
q+vRKwm51mnr6kxX/161WQ collected $0.50 from pot
q+vRKwm51mnr6kxX/161WQ: doesn't show hand
*** SUMMARY ***
Total pot $0.50 | Rake $0
Seat 1: q+vRKwm51mnr6kxX/161WQ (big blind) collected ($0.50)
Seat 2: dkC7J+qbyqk0qCcmJbEPPw (button) (small blind) folded before Flop



PokerStars Game #59939620704:  Hold'em No Limit ($0.25/$0.50) - 2009/07/01 0:44:35 ET
Table 'Vdlc9wqYcHTUhtdyN7CuJw' 2-max Seat #2 is the button
Seat 1: yBO+mXB6m/rCft2ErwGf/Q ($108.95 in chips)
Seat 2: NZ/5cxwnorKW2SNsWy1+8A ($17.50 in chips)
NZ/5cxwnorKW2SNsWy1+8A: posts small blind $0.25
yBO+mXB6m/rCft2ErwGf/Q: posts big blind $0.50
*** HOLE CARDS ***
NZ/5cxwnorKW2SNsWy1+8A: calls $0.25
yBO+mXB6m/rCft2ErwGf/Q: raises $1 to $1.50
NZ/5cxwnorKW2SNsWy1+8A: folds
yBO+mXB6m/rCft2ErwGf/Q collected $1 from pot
*** SUMMARY ***
Total pot $1 | Rake $0
Seat 1: yBO+mXB6m/rCft2ErwGf/Q (big blind) collected ($1)
Seat 2: NZ/5cxwnorKW2SNsWy1+8A (button) (small blind) folded before Flop



PokerStars Game #59939623626:  Hold'em No Limit ($0.25/$0.50) - 2009/07/01 0:44:39 ET
Table 'MJxeZCzYELxiIsyUZyT0jw' 6-max Seat #6 is the button
Seat 1: jNIq+EZLEm61oWSMYUVeWQ ($11.85 in chips)
Seat 3: JQZew0FjzS19kTjeNtrE+A ($52.30 in chips)
Seat 4: alGiiQP/wwtYnfuXII+sgw ($45.95 in chips)
Seat 5: 3jvoOXNtXE90w2BdfNZwZQ ($51.25 in chips)
Seat 6: TTx3CHxyi0SObcHyMJRp5w ($57.45 in chips)
jNIq+EZLEm61oWSMYUVeWQ: posts small blind $0.25
JQZew0FjzS19kTjeNtrE+A: posts big blind $0.50
*** HOLE CARDS ***
alGiiQP/wwtYnfuXII+sgw: folds
3jvoOXNtXE90w2BdfNZwZQ: folds
TTx3CHxyi0SObcHyMJRp5w: folds
jNIq+EZLEm61oWSMYUVeWQ: calls $0.25
JQZew0FjzS19kTjeNtrE+A: checks
*** FLOP *** [Ac 3d Tc]
jNIq+EZLEm61oWSMYUVeWQ: checks
JQZew0FjzS19kTjeNtrE+A: bets $1
jNIq+EZLEm61oWSMYUVeWQ: calls $1
*** TURN *** [Ac 3d Tc] [5h]
jNIq+EZLEm61oWSMYUVeWQ: checks
JQZew0FjzS19kTjeNtrE+A: bets $1.50
jNIq+EZLEm61oWSMYUVeWQ: raises $1.50 to $3
JQZew0FjzS19kTjeNtrE+A: calls $1.50
*** RIVER *** [Ac 3d Tc 5h] [6h]
jNIq+EZLEm61oWSMYUVeWQ: bets $4
JQZew0FjzS19kTjeNtrE+A: calls $4
*** SHOW DOWN ***
jNIq+EZLEm61oWSMYUVeWQ: shows [As 4d] (a pair of Aces)
JQZew0FjzS19kTjeNtrE+A: shows [Ah 9d] (a pair of Aces - Ten+Nine kicker)
JQZew0FjzS19kTjeNtrE+A collected $16.20 from pot
*** SUMMARY ***
Total pot $17 | Rake $0.80
Board [Ac 3d Tc 5h 6h]
Seat 1: jNIq+EZLEm61oWSMYUVeWQ (small blind) showed [As 4d] and lost with a pair of Aces
Seat 3: JQZew0FjzS19kTjeNtrE+A (big blind) showed [Ah 9d] and won ($16.20) with a pair of Aces
Seat 4: alGiiQP/wwtYnfuXII+sgw folded before Flop (didn't bet)
Seat 5: 3jvoOXNtXE90w2BdfNZwZQ folded before Flop (didn't bet)
Seat 6: TTx3CHxyi0SObcHyMJRp5w (button) folded before Flop (didn't bet)



PokerStars Game #59939624834:  Hold'em No Limit ($0.25/$0.50) - 2009/07/01 0:44:41 ET
Table '+111aLuBwnz8YVYSA7J1jA' 2-max Seat #2 is the button
Seat 1: ndd1nfncBkWNitBnsfCoVQ ($73.65 in chips)
Seat 2: +ciXH35zeafrjg1W6wiBTg ($75.35 in chips)
+ciXH35zeafrjg1W6wiBTg: posts small blind $0.25
ndd1nfncBkWNitBnsfCoVQ: posts big blind $0.50
*** HOLE CARDS ***
+ciXH35zeafrjg1W6wiBTg: calls $0.25
ndd1nfncBkWNitBnsfCoVQ: checks
*** FLOP *** [3c Js 5s]
ndd1nfncBkWNitBnsfCoVQ: checks
+ciXH35zeafrjg1W6wiBTg: checks
*** TURN *** [3c Js 5s] [Kc]
ndd1nfncBkWNitBnsfCoVQ: checks
+ciXH35zeafrjg1W6wiBTg: checks
*** RIVER *** [3c Js 5s Kc] [Jc]
ndd1nfncBkWNitBnsfCoVQ: checks
+ciXH35zeafrjg1W6wiBTg: checks
*** SHOW DOWN ***
ndd1nfncBkWNitBnsfCoVQ: shows [4d 3d] (two pair, Jacks and Threes)
+ciXH35zeafrjg1W6wiBTg: mucks hand
ndd1nfncBkWNitBnsfCoVQ collected $0.95 from pot
*** SUMMARY ***
Total pot $1 | Rake $0.05
Board [3c Js 5s Kc Jc]
Seat 1: ndd1nfncBkWNitBnsfCoVQ (big blind) showed [4d 3d] and won ($0.95) with two pair, Jacks and Threes
Seat 2: +ciXH35zeafrjg1W6wiBTg (button) (small blind) mucked



PokerStars Game #59939625396:  Hold'em No Limit ($0.25/$0.50) - 2009/07/01 0:44:42 ET
Table 'hWT2kq66tnKEpD26cia6fQ' 2-max Seat #1 is the button
Seat 1: q+vRKwm51mnr6kxX/161WQ ($56.20 in chips)
Seat 2: dkC7J+qbyqk0qCcmJbEPPw ($56.30 in chips)
q+vRKwm51mnr6kxX/161WQ: posts small blind $0.25
dkC7J+qbyqk0qCcmJbEPPw: posts big blind $0.50
*** HOLE CARDS ***
q+vRKwm51mnr6kxX/161WQ: raises $1 to $1.50
dkC7J+qbyqk0qCcmJbEPPw: raises $3.50 to $5
q+vRKwm51mnr6kxX/161WQ: folds
dkC7J+qbyqk0qCcmJbEPPw collected $3 from pot
*** SUMMARY ***
Total pot $3 | Rake $0
Seat 1: q+vRKwm51mnr6kxX/161WQ (button) (small blind) folded before Flop
Seat 2: dkC7J+qbyqk0qCcmJbEPPw (big blind) collected ($3)



PokerStars Game #59939625332:  Hold'em No Limit ($0.25/$0.50) - 2009/07/01 0:44:42 ET
Table '+dXkOAQyS8j9PQZusUTMpg' 2-max Seat #1 is the button
Seat 1: XFa6sBGjP2gxoIvxR3fZIg ($56.20 in chips)
Seat 2: 5IBeOgaApY1Bvzv2P8X4EA ($147.95 in chips)
XFa6sBGjP2gxoIvxR3fZIg: posts small blind $0.25
5IBeOgaApY1Bvzv2P8X4EA: posts big blind $0.50
*** HOLE CARDS ***
XFa6sBGjP2gxoIvxR3fZIg: raises $1 to $1.50
5IBeOgaApY1Bvzv2P8X4EA: calls $1
*** FLOP *** [5h 5s Tc]
5IBeOgaApY1Bvzv2P8X4EA: checks
XFa6sBGjP2gxoIvxR3fZIg: checks
*** TURN *** [5h 5s Tc] [6d]
5IBeOgaApY1Bvzv2P8X4EA: checks
XFa6sBGjP2gxoIvxR3fZIg: bets $1.50
5IBeOgaApY1Bvzv2P8X4EA: calls $1.50
*** RIVER *** [5h 5s Tc 6d] [7h]
5IBeOgaApY1Bvzv2P8X4EA: checks
XFa6sBGjP2gxoIvxR3fZIg: bets $4.50
5IBeOgaApY1Bvzv2P8X4EA: calls $4.50
*** SHOW DOWN ***
XFa6sBGjP2gxoIvxR3fZIg: shows [2s 3s] (a pair of Fives)
5IBeOgaApY1Bvzv2P8X4EA: shows [Kc Qs] (a pair of Fives - King kicker)
5IBeOgaApY1Bvzv2P8X4EA collected $14.50 from pot
*** SUMMARY ***
Total pot $15 | Rake $0.50
Board [5h 5s Tc 6d 7h]
Seat 1: XFa6sBGjP2gxoIvxR3fZIg (button) (small blind) showed [2s 3s] and lost with a pair of Fives
Seat 2: 5IBeOgaApY1Bvzv2P8X4EA (big blind) showed [Kc Qs] and won ($14.50) with a pair of Fives



PokerStars Game #59939625392:  Hold'em No Limit ($0.25/$0.50) - 2009/07/01 0:44:42 ET
Table 'fx6MqwfYAj/Rt86hBz2L3Q' 9-max Seat #2 is the button
Seat 1: SegjDnMxWMujiD57ESNL+g ($10 in chips)
Seat 2: C3rGXblctNcWI6JYPHhaEg ($10 in chips)
Seat 3: iadBi5AEt7gTBXbDSSnMYQ ($50.95 in chips)
Seat 4: gPEN9Zp33YTm/mu9/SYP1w ($21.70 in chips)
Seat 5: iAISe3dVeua8PUn2wwgDHw ($24.10 in chips)
Seat 6: 5k9fvXD9suIgCxU4HLQjTw ($50 in chips)
Seat 8: NnQCepdIR/AOUQn1yhYx6Q ($14.05 in chips)
Seat 9: HZkVla4kK2SI42CVrPZ/ig ($8.25 in chips)
iadBi5AEt7gTBXbDSSnMYQ: posts small blind $0.25
gPEN9Zp33YTm/mu9/SYP1w: posts big blind $0.50
SKnJuWHScqetA/qG5p+wCg: sits out
*** HOLE CARDS ***
iAISe3dVeua8PUn2wwgDHw: folds
5k9fvXD9suIgCxU4HLQjTw: folds
NnQCepdIR/AOUQn1yhYx6Q: folds
HZkVla4kK2SI42CVrPZ/ig: folds
SegjDnMxWMujiD57ESNL+g: folds
C3rGXblctNcWI6JYPHhaEg: folds
iadBi5AEt7gTBXbDSSnMYQ: calls $0.25
gPEN9Zp33YTm/mu9/SYP1w: checks
*** FLOP *** [9s 6d 8c]
iadBi5AEt7gTBXbDSSnMYQ: checks
gPEN9Zp33YTm/mu9/SYP1w: checks
*** TURN *** [9s 6d 8c] [5h]
iadBi5AEt7gTBXbDSSnMYQ: checks
gPEN9Zp33YTm/mu9/SYP1w: checks
*** RIVER *** [9s 6d 8c 5h] [6s]
iadBi5AEt7gTBXbDSSnMYQ: bets $1.50
gPEN9Zp33YTm/mu9/SYP1w: raises $1.50 to $3
iadBi5AEt7gTBXbDSSnMYQ: folds
gPEN9Zp33YTm/mu9/SYP1w collected $3.85 from pot
*** SUMMARY ***
Total pot $4 | Rake $0.15
Board [9s 6d 8c 5h 6s]
Seat 1: SegjDnMxWMujiD57ESNL+g folded before Flop (didn't bet)
Seat 2: C3rGXblctNcWI6JYPHhaEg (button) folded before Flop (didn't bet)
Seat 3: iadBi5AEt7gTBXbDSSnMYQ (small blind) folded on the River
Seat 4: gPEN9Zp33YTm/mu9/SYP1w (big blind) collected ($3.85)
Seat 5: iAISe3dVeua8PUn2wwgDHw folded before Flop (didn't bet)
Seat 6: 5k9fvXD9suIgCxU4HLQjTw folded before Flop (didn't bet)
Seat 8: NnQCepdIR/AOUQn1yhYx6Q folded before Flop (didn't bet)
Seat 9: HZkVla4kK2SI42CVrPZ/ig folded before Flop (didn't bet)



PokerStars Game #59939625440:  Hold'em No Limit ($0.25/$0.50) - 2009/07/01 0:44:42 ET
Table '3FhG0gl3kMX3wBEEqj+wnQ' 9-max Seat #8 is the button
Seat 1: e0J9pdCNUDTCG031RnXqLA ($23.40 in chips)
Seat 2: 7cYQ+syUWjl38ty/ICOMhw ($47.85 in chips)
Seat 4: bjvJtA9Hqscfznq66txaOQ ($10 in chips)
Seat 5: gsyXT42WLEcOS4DdEk2wlw ($28 in chips)
Seat 6: 997ViqAtWn1FPjJqcffwcA ($50 in chips)
Seat 7: mSD1pginDsyHG5PDfqzphw ($11.50 in chips)
Seat 8: j3K/Jujr7PY4ZM2RZvlH6A ($55.85 in chips)
Seat 9: L5e2lrPLQm1Pqx30IIZ/Fw ($10.25 in chips)
L5e2lrPLQm1Pqx30IIZ/Fw: posts small blind $0.25
e0J9pdCNUDTCG031RnXqLA: posts big blind $0.50
k1f0lS7tlMHCLGs0JT34Tg: sits out
*** HOLE CARDS ***
7cYQ+syUWjl38ty/ICOMhw: folds
bjvJtA9Hqscfznq66txaOQ: folds
gsyXT42WLEcOS4DdEk2wlw: folds
997ViqAtWn1FPjJqcffwcA: folds
mSD1pginDsyHG5PDfqzphw: folds
j3K/Jujr7PY4ZM2RZvlH6A: raises $1.50 to $2
L5e2lrPLQm1Pqx30IIZ/Fw: folds
e0J9pdCNUDTCG031RnXqLA: folds
j3K/Jujr7PY4ZM2RZvlH6A collected $1.25 from pot
j3K/Jujr7PY4ZM2RZvlH6A: doesn't show hand
*** SUMMARY ***
Total pot $1.25 | Rake $0
Seat 1: e0J9pdCNUDTCG031RnXqLA (big blind) folded before Flop
Seat 2: 7cYQ+syUWjl38ty/ICOMhw folded before Flop (didn't bet)
Seat 4: bjvJtA9Hqscfznq66txaOQ folded before Flop (didn't bet)
Seat 5: gsyXT42WLEcOS4DdEk2wlw folded before Flop (didn't bet)
Seat 6: 997ViqAtWn1FPjJqcffwcA folded before Flop (didn't bet)
Seat 7: mSD1pginDsyHG5PDfqzphw folded before Flop (didn't bet)
Seat 8: j3K/Jujr7PY4ZM2RZvlH6A (button) collected ($1.25)
Seat 9: L5e2lrPLQm1Pqx30IIZ/Fw (small blind) folded before Flop



PokerStars Game #59939625886:  Hold'em No Limit ($0.25/$0.50) - 2009/07/01 0:44:43 ET
Table 'QOeVnLhwctF9UyV/beDi+A' 2-max Seat #2 is the button
Seat 1: bypIyrYcAAifLfhZpGlKLA ($61.25 in chips)
Seat 2: Ucrm3XtZmoONapW32SPhag ($22.15 in chips)
Ucrm3XtZmoONapW32SPhag: posts small blind $0.25
bypIyrYcAAifLfhZpGlKLA: posts big blind $0.50
*** HOLE CARDS ***
Ucrm3XtZmoONapW32SPhag: calls $0.25
bypIyrYcAAifLfhZpGlKLA: checks
*** FLOP *** [6d 9c Ah]
bypIyrYcAAifLfhZpGlKLA: checks
Ucrm3XtZmoONapW32SPhag: checks
*** TURN *** [6d 9c Ah] [4d]
bypIyrYcAAifLfhZpGlKLA: bets $1
Ucrm3XtZmoONapW32SPhag: folds
bypIyrYcAAifLfhZpGlKLA collected $0.95 from pot
bypIyrYcAAifLfhZpGlKLA: doesn't show hand
*** SUMMARY ***
Total pot $1 | Rake $0.05
Board [6d 9c Ah 4d]
Seat 1: bypIyrYcAAifLfhZpGlKLA (big blind) collected ($0.95)
Seat 2: Ucrm3XtZmoONapW32SPhag (button) (small blind) folded on the Turn



PokerStars Game #59939626574:  Hold'em No Limit ($0.25/$0.50) - 2009/07/01 0:44:44 ET
Table '0eJtgVAXVvBgncFdcUpXcQ' 2-max Seat #2 is the button
Seat 1: Ag6DvxX4vbRheqsv2zXKTQ ($20 in chips)
Seat 2: KMc4R+K9ao4Ur3rF7NGe6Q ($10 in chips)
KMc4R+K9ao4Ur3rF7NGe6Q: posts small blind $0.25
Ag6DvxX4vbRheqsv2zXKTQ: posts big blind $0.50
*** HOLE CARDS ***
KMc4R+K9ao4Ur3rF7NGe6Q: calls $0.25
Ag6DvxX4vbRheqsv2zXKTQ: checks
*** FLOP *** [Kd 9c 2c]
Ag6DvxX4vbRheqsv2zXKTQ: checks
KMc4R+K9ao4Ur3rF7NGe6Q: checks
*** TURN *** [Kd 9c 2c] [3d]
Ag6DvxX4vbRheqsv2zXKTQ: bets $1
KMc4R+K9ao4Ur3rF7NGe6Q: folds
Ag6DvxX4vbRheqsv2zXKTQ collected $0.95 from pot
*** SUMMARY ***
Total pot $1 | Rake $0.05
Board [Kd 9c 2c 3d]
Seat 1: Ag6DvxX4vbRheqsv2zXKTQ (big blind) collected ($0.95)
Seat 2: KMc4R+K9ao4Ur3rF7NGe6Q (button) (small blind) folded on the Turn



PokerStars Game #59939627136:  Hold'em No Limit ($0.25/$0.50) - 2009/07/01 0:44:45 ET
Table 'BCN5su+SsXiy1zRMJi0SJw' 6-max Seat #3 is the button
Seat 1: crjGpJEzSZgD38FoE3VMGg ($50 in chips)
Seat 2: oU2kDCkT/gilYbHWrg7D8w ($12.65 in chips)
Seat 3: g+vwI6lMKpU2uteXSjOzVw ($19.30 in chips)
Seat 4: JY9CtoZTeav+mhWyxSSyJQ ($26.40 in chips)
Seat 5: IBNygaT1aa9Z1uPdJJilwA ($64.25 in chips)
Seat 6: b2symlOdL7+0c9Pj4N/KlA ($52.85 in chips)
JY9CtoZTeav+mhWyxSSyJQ: posts small blind $0.25
IBNygaT1aa9Z1uPdJJilwA: posts big blind $0.50
*** HOLE CARDS ***
b2symlOdL7+0c9Pj4N/KlA: folds
crjGpJEzSZgD38FoE3VMGg: folds
oU2kDCkT/gilYbHWrg7D8w: raises $1.50 to $2
g+vwI6lMKpU2uteXSjOzVw: calls $2
JY9CtoZTeav+mhWyxSSyJQ: folds
IBNygaT1aa9Z1uPdJJilwA: folds
*** FLOP *** [6d Kd 8h]
oU2kDCkT/gilYbHWrg7D8w: bets $4
g+vwI6lMKpU2uteXSjOzVw: calls $4
*** TURN *** [6d Kd 8h] [9d]
oU2kDCkT/gilYbHWrg7D8w: checks
g+vwI6lMKpU2uteXSjOzVw: bets $5
oU2kDCkT/gilYbHWrg7D8w: folds
g+vwI6lMKpU2uteXSjOzVw collected $12.15 from pot
g+vwI6lMKpU2uteXSjOzVw: doesn't show hand
*** SUMMARY ***
Total pot $12.75 | Rake $0.60
Board [6d Kd 8h 9d]
Seat 1: crjGpJEzSZgD38FoE3VMGg folded before Flop (didn't bet)
Seat 2: oU2kDCkT/gilYbHWrg7D8w folded on the Turn
Seat 3: g+vwI6lMKpU2uteXSjOzVw (button) collected ($12.15)
Seat 4: JY9CtoZTeav+mhWyxSSyJQ (small blind) folded before Flop
Seat 5: IBNygaT1aa9Z1uPdJJilwA (big blind) folded before Flop
Seat 6: b2symlOdL7+0c9Pj4N/KlA folded before Flop (didn't bet)



PokerStars Game #59939628736:  Hold'em No Limit ($0.25/$0.50) - 2009/07/01 0:44:47 ET
Table 'QOgaEqMcJ73pcUMMxoisUgErOuyGLI5PT3G5MnpHgC/g Seat #8 is the button
Seat 3: xZCXQSXlrZkp3pZizzVXCw ($50.50 in chips)
Seat 4: 3UmXLy3GfjC3EkOebduerQ ($50 in chips)
Seat 5: JwvquocWfhTVApN5t47LgA ($57.55 in chips)
Seat 6: zE9cVigS2nW/Ljy4K4bUQA ($30.75 in chips)
Seat 7: 90Wb75h3W1BRpbqVnuk8gw ($60.95 in chips)
Seat 8: g4k0NXISyLCqaSWZDBjfEg ($51.35 in chips)
Seat 9: J0W5D97jl5VLky+IoPvDeA ($57.40 in chips)
J0W5D97jl5VLky+IoPvDeA: posts small blind $0.25
L5e2lrPLQm1Pqx30IIZ/Fw: is sitting out
xZCXQSXlrZkp3pZizzVXCw: posts big blind $0.50
*** HOLE CARDS ***
L5e2lrPLQm1Pqx30IIZ/Fw leaves the table
3UmXLy3GfjC3EkOebduerQ: folds
JwvquocWfhTVApN5t47LgA: calls $0.50
zE9cVigS2nW/Ljy4K4bUQA: folds
90Wb75h3W1BRpbqVnuk8gw: folds
g4k0NXISyLCqaSWZDBjfEg: raises $1.50 to $2
J0W5D97jl5VLky+IoPvDeA: folds
xZCXQSXlrZkp3pZizzVXCw: folds
JwvquocWfhTVApN5t47LgA: calls $1.50
*** FLOP *** [8c 4d Ad]
JwvquocWfhTVApN5t47LgA: bets $1
g4k0NXISyLCqaSWZDBjfEg: folds
JwvquocWfhTVApN5t47LgA collected $4.55 from pot
*** SUMMARY ***
Total pot $4.75 | Rake $0.20
Board [8c 4d Ad]
Seat 3: xZCXQSXlrZkp3pZizzVXCw (big blind) folded before Flop
Seat 4: 3UmXLy3GfjC3EkOebduerQ folded before Flop (didn't bet)
Seat 5: JwvquocWfhTVApN5t47LgA collected ($4.55)
Seat 6: zE9cVigS2nW/Ljy4K4bUQA folded before Flop (didn't bet)
Seat 7: 90Wb75h3W1BRpbqVnuk8gw folded before Flop (didn't bet)
Seat 8: g4k0NXISyLCqaSWZDBjfEg (button) folded on the Flop
Seat 9: J0W5D97jl5VLky+IoPvDeA (small blind) folded before Flop



PokerStars Game #59939629466:  Hold'em No Limit ($0.25/$0.50) - 2009/07/01 0:44:48 ET
Table 'eMxdLyFDf28E0wit6gm3Uw' 6-max Seat #2 is the button
Seat 1: GtdWeBVCZhDBcNFRTOb8Hg ($5.10 in chips)
Seat 2: jwuKQ1S3U4NnzMQn3E3dgw ($80.15 in chips)
Seat 3: dZcLsEI8iXkobBduRJ45Yw ($12.85 in chips)
Seat 4: 3jxEWvv2qK1HCXLj4khowQ ($41.25 in chips)
Seat 5: X0X97o2fDAPiGx6o1gahsw ($52.10 in chips)
dZcLsEI8iXkobBduRJ45Yw: posts small blind $0.25
3jxEWvv2qK1HCXLj4khowQ: posts big blind $0.50
nOfdMHEXflgT86UgFWblAA: sits out
*** HOLE CARDS ***
X0X97o2fDAPiGx6o1gahsw: raises $1.50 to $2
GtdWeBVCZhDBcNFRTOb8Hg: folds
jwuKQ1S3U4NnzMQn3E3dgw: folds
jwuKQ1S3U4NnzMQn3E3dgw is sitting out
dZcLsEI8iXkobBduRJ45Yw: folds
3jxEWvv2qK1HCXLj4khowQ: folds
X0X97o2fDAPiGx6o1gahsw collected $1.25 from pot
*** SUMMARY ***
Total pot $1.25 | Rake $0
Seat 1: GtdWeBVCZhDBcNFRTOb8Hg folded before Flop (didn't bet)
Seat 2: jwuKQ1S3U4NnzMQn3E3dgw (button) folded before Flop (didn't bet)
Seat 3: dZcLsEI8iXkobBduRJ45Yw (small blind) folded before Flop
Seat 4: 3jxEWvv2qK1HCXLj4khowQ (big blind) folded before Flop
Seat 5: X0X97o2fDAPiGx6o1gahsw collected ($1.25)



PokerStars Game #59939630672:  Hold'em No Limit ($0.25/$0.50) - 2009/07/01 0:44:50 ET
Table 'Vdlc9wqYcHTUhtdyN7CuJw' 2-max Seat #1 is the button
Seat 1: yBO+mXB6m/rCft2ErwGf/Q ($109.45 in chips)
Seat 2: NZ/5cxwnorKW2SNsWy1+8A ($17 in chips)
yBO+mXB6m/rCft2ErwGf/Q: posts small blind $0.25
NZ/5cxwnorKW2SNsWy1+8A: posts big blind $0.50
*** HOLE CARDS ***
yBO+mXB6m/rCft2ErwGf/Q: raises $0.50 to $1
NZ/5cxwnorKW2SNsWy1+8A: calls $0.50
*** FLOP *** [2h 6c 7s]
NZ/5cxwnorKW2SNsWy1+8A: checks
yBO+mXB6m/rCft2ErwGf/Q: bets $0.50
NZ/5cxwnorKW2SNsWy1+8A: folds
yBO+mXB6m/rCft2ErwGf/Q collected $1.90 from pot
*** SUMMARY ***
Total pot $2 | Rake $0.10
Board [2h 6c 7s]
Seat 1: yBO+mXB6m/rCft2ErwGf/Q (button) (small blind) collected ($1.90)
Seat 2: NZ/5cxwnorKW2SNsWy1+8A (big blind) folded on the Flop



PokerStars Game #59939631162:  Hold'em No Limit ($0.25/$0.50) - 2009/07/01 0:44:51 ET
Table 'X6IRCRTh+20gjz8aubWnwA' 9-max Seat #9 is the button
Seat 1: DSM67hHHq1XFoEOi9p8Alw ($50.30 in chips)
Seat 2: HZkVla4kK2SI42CVrPZ/ig ($11.55 in chips)
Seat 3: GeZ7AYmAZ9Ln8liPZzV8EA ($24.35 in chips)
Seat 4: 2J+UVOVrW+V3maOylyxMcQ ($37.20 in chips)
Seat 5: NnQCepdIR/AOUQn1yhYx6Q ($10 in chips)
Seat 6: /6In1zC3WtgwxDcueWzZWg ($70.05 in chips)
Seat 7: cFHQjKQOOKTUzoilhrXHLg ($34.50 in chips)
Seat 8: HxeBVq06/3Bh/H986sgdbw ($7.25 in chips)
Seat 9: M+7+BTmX5vZatHVuoRB1nA ($68.50 in chips)
DSM67hHHq1XFoEOi9p8Alw: posts small blind $0.25
HZkVla4kK2SI42CVrPZ/ig: posts big blind $0.50
HxeBVq06/3Bh/H986sgdbw: posts small & big blinds $0.75
*** HOLE CARDS ***
GeZ7AYmAZ9Ln8liPZzV8EA: folds
2J+UVOVrW+V3maOylyxMcQ: folds
NnQCepdIR/AOUQn1yhYx6Q: folds
GeZ7AYmAZ9Ln8liPZzV8EA leaves the table
/6In1zC3WtgwxDcueWzZWg: folds
cFHQjKQOOKTUzoilhrXHLg: folds
HxeBVq06/3Bh/H986sgdbw: checks
M+7+BTmX5vZatHVuoRB1nA: folds
DSM67hHHq1XFoEOi9p8Alw: folds
HZkVla4kK2SI42CVrPZ/ig: checks
*** FLOP *** [7h Kd 7s]
SWv01peOe69QQRvhQTqjQw joins the table at seat #3
HZkVla4kK2SI42CVrPZ/ig: checks
HxeBVq06/3Bh/H986sgdbw: bets $1.50
HZkVla4kK2SI42CVrPZ/ig: folds
HxeBVq06/3Bh/H986sgdbw collected $1.45 from pot
HxeBVq06/3Bh/H986sgdbw: doesn't show hand
*** SUMMARY ***
Total pot $1.50 | Rake $0.05
Board [7h Kd 7s]
Seat 1: DSM67hHHq1XFoEOi9p8Alw (small blind) folded before Flop
Seat 2: HZkVla4kK2SI42CVrPZ/ig (big blind) folded on the Flop
Seat 3: GeZ7AYmAZ9Ln8liPZzV8EA folded before Flop (didn't bet)
Seat 4: 2J+UVOVrW+V3maOylyxMcQ folded before Flop (didn't bet)
Seat 5: NnQCepdIR/AOUQn1yhYx6Q folded before Flop (didn't bet)
Seat 6: /6In1zC3WtgwxDcueWzZWg folded before Flop (didn't bet)
Seat 7: cFHQjKQOOKTUzoilhrXHLg folded before Flop (didn't bet)
Seat 8: HxeBVq06/3Bh/H986sgdbw collected ($1.45)
Seat 9: M+7+BTmX5vZatHVuoRB1nA (button) folded before Flop (didn't bet)



PokerStars Game #59939632350:  Hold'em No Limit ($0.25/$0.50) - 2009/07/01 0:44:53 ET
Table 'E7bWJ45aoFXRpyRv2gw+Ig' 2-max Seat #2 is the button
Seat 1: FRkiRasEGlHUeLrEl+k/nA ($69.50 in chips)
Seat 2: 3Wro85I7472vJ4Wkpneo9A ($126.15 in chips)
3Wro85I7472vJ4Wkpneo9A: posts small blind $0.25
FRkiRasEGlHUeLrEl+k/nA: posts big blind $0.50
*** HOLE CARDS ***
3Wro85I7472vJ4Wkpneo9A: folds
FRkiRasEGlHUeLrEl+k/nA collected $0.50 from pot
*** SUMMARY ***
Total pot $0.50 | Rake $0
Seat 1: FRkiRasEGlHUeLrEl+k/nA (big blind) collected ($0.50)
Seat 2: 3Wro85I7472vJ4Wkpneo9A (button) (small blind) folded before Flop



PokerStars Game #59939633002:  Hold'em No Limit ($0.25/$0.50) - 2009/07/01 0:44:54 ET
Table 'EiNh8p/wGJ1FP575iMFnqg' 9-max Seat #7 is the button
Seat 1: r3ZqM1Mi0W3y4hOdssE+Sg ($48.90 in chips)
Seat 2: 8ehL7qlZzjgUh2H35iiWLw ($53.35 in chips)
Seat 3: ymLPoEIl7UL3TvZYmnadxQ ($48.60 in chips)
Seat 4: cMzaiXAM/ZAdNaEUu+LqhA ($50 in chips)
Seat 5: M+7+BTmX5vZatHVuoRB1nA ($77.35 in chips)
Seat 6: 3UmXLy3GfjC3EkOebduerQ ($62.95 in chips)
Seat 7: 997ViqAtWn1FPjJqcffwcA ($50 in chips)
Seat 8: KrPAGRACBg+w0M//SXe8Ag ($12.15 in chips)
Seat 9: NnQCepdIR/AOUQn1yhYx6Q ($10 in chips)
KrPAGRACBg+w0M//SXe8Ag: posts small blind $0.25
NnQCepdIR/AOUQn1yhYx6Q: posts big blind $0.50
*** HOLE CARDS ***
r3ZqM1Mi0W3y4hOdssE+Sg: calls $0.50
8ehL7qlZzjgUh2H35iiWLw: folds
ymLPoEIl7UL3TvZYmnadxQ: calls $0.50
cMzaiXAM/ZAdNaEUu+LqhA: folds
M+7+BTmX5vZatHVuoRB1nA: raises $2 to $2.50
3UmXLy3GfjC3EkOebduerQ: folds
997ViqAtWn1FPjJqcffwcA: folds
KrPAGRACBg+w0M//SXe8Ag: folds
NnQCepdIR/AOUQn1yhYx6Q: folds
r3ZqM1Mi0W3y4hOdssE+Sg: calls $2
ymLPoEIl7UL3TvZYmnadxQ: folds
*** FLOP *** [8c Td 8d]
r3ZqM1Mi0W3y4hOdssE+Sg: checks
M+7+BTmX5vZatHVuoRB1nA: bets $4
r3ZqM1Mi0W3y4hOdssE+Sg: folds
M+7+BTmX5vZatHVuoRB1nA collected $5.95 from pot
M+7+BTmX5vZatHVuoRB1nA: doesn't show hand
*** SUMMARY ***
Total pot $6.25 | Rake $0.30
Board [8c Td 8d]
Seat 1: r3ZqM1Mi0W3y4hOdssE+Sg folded on the Flop
Seat 2: 8ehL7qlZzjgUh2H35iiWLw folded before Flop (didn't bet)
Seat 3: ymLPoEIl7UL3TvZYmnadxQ folded before Flop
Seat 4: cMzaiXAM/ZAdNaEUu+LqhA folded before Flop (didn't bet)
Seat 5: M+7+BTmX5vZatHVuoRB1nA collected ($5.95)
Seat 6: 3UmXLy3GfjC3EkOebduerQ folded before Flop (didn't bet)
Seat 7: 997ViqAtWn1FPjJqcffwcA (button) folded before Flop (didn't bet)
Seat 8: KrPAGRACBg+w0M//SXe8Ag (small blind) folded before Flop
Seat 9: NnQCepdIR/AOUQn1yhYx6Q (big blind) folded before Flop



PokerStars Game #59939632738:  Hold'em No Limit ($0.25/$0.50) - 2009/07/01 0:44:54 ET
Table '37qXEp3oe+er5q4CZip9eQ' 6-max Seat #4 is the button
Seat 1: oqOqoO2AyCZenUghCxMDxw ($58.40 in chips)
Seat 2: 6wzJiRvp8HY6t+MQGnSIzA ($19.60 in chips)
Seat 3: Rt6KgtZ8YaJoTc3FPim00w ($72.25 in chips)
Seat 4: XsmE8nXMAAMFJbWaJTmHFw ($28.95 in chips)
Seat 6: N50kln4negd8q7Mmoz1j4g ($29.75 in chips)
VOmI0x4dDPnTESZd5B4d1Q will be allowed to play after the button
N50kln4negd8q7Mmoz1j4g: posts small blind $0.25
oqOqoO2AyCZenUghCxMDxw: posts big blind $0.50
*** HOLE CARDS ***
6wzJiRvp8HY6t+MQGnSIzA: calls $0.50
Rt6KgtZ8YaJoTc3FPim00w: folds
XsmE8nXMAAMFJbWaJTmHFw: folds
N50kln4negd8q7Mmoz1j4g: folds
oqOqoO2AyCZenUghCxMDxw: checks
*** FLOP *** [Qc Ah 8c]
oqOqoO2AyCZenUghCxMDxw: checks
6wzJiRvp8HY6t+MQGnSIzA: checks
*** TURN *** [Qc Ah 8c] [6c]
oqOqoO2AyCZenUghCxMDxw: checks
6wzJiRvp8HY6t+MQGnSIzA: bets $0.50
oqOqoO2AyCZenUghCxMDxw: folds
6wzJiRvp8HY6t+MQGnSIzA collected $1.20 from pot
*** SUMMARY ***
Total pot $1.25 | Rake $0.05
Board [Qc Ah 8c 6c]
Seat 1: oqOqoO2AyCZenUghCxMDxw (big blind) folded on the Turn
Seat 2: 6wzJiRvp8HY6t+MQGnSIzA collected ($1.20)
Seat 3: Rt6KgtZ8YaJoTc3FPim00w folded before Flop (didn't bet)
Seat 4: XsmE8nXMAAMFJbWaJTmHFw (button) folded before Flop (didn't bet)
Seat 6: N50kln4negd8q7Mmoz1j4g (small blind) folded before Flop



PokerStars Game #59939636350:  Hold'em No Limit ($0.25/$0.50) - 2009/07/01 0:44:59 ET
Table 'E7bWJ45aoFXRpyRv2gw+Ig' 2-max Seat #1 is the button
Seat 1: FRkiRasEGlHUeLrEl+k/nA ($69.75 in chips)
Seat 2: 3Wro85I7472vJ4Wkpneo9A ($125.90 in chips)
FRkiRasEGlHUeLrEl+k/nA: posts small blind $0.25
3Wro85I7472vJ4Wkpneo9A: posts big blind $0.50
*** HOLE CARDS ***
FRkiRasEGlHUeLrEl+k/nA: calls $0.25
3Wro85I7472vJ4Wkpneo9A: checks
*** FLOP *** [Kh Qd 3h]
3Wro85I7472vJ4Wkpneo9A: checks
FRkiRasEGlHUeLrEl+k/nA: checks
*** TURN *** [Kh Qd 3h] [Ks]
3Wro85I7472vJ4Wkpneo9A: bets $1
FRkiRasEGlHUeLrEl+k/nA: folds
3Wro85I7472vJ4Wkpneo9A collected $0.95 from pot
3Wro85I7472vJ4Wkpneo9A: doesn't show hand
*** SUMMARY ***
Total pot $1 | Rake $0.05
Board [Kh Qd 3h Ks]
Seat 1: FRkiRasEGlHUeLrEl+k/nA (button) (small blind) folded on the Turn
Seat 2: 3Wro85I7472vJ4Wkpneo9A (big blind) collected ($0.95)



PokerStars Game #59939636692:  Hold'em No Limit ($0.25/$0.50) - 2009/07/01 0:45:00 ET
Table '0eJtgVAXVvBgncFdcUpXcQ' 2-max Seat #1 is the button
Seat 1: Ag6DvxX4vbRheqsv2zXKTQ ($20.45 in chips)
Seat 2: KMc4R+K9ao4Ur3rF7NGe6Q ($9.50 in chips)
Ag6DvxX4vbRheqsv2zXKTQ: posts small blind $0.25
KMc4R+K9ao4Ur3rF7NGe6Q: posts big blind $0.50
*** HOLE CARDS ***
Ag6DvxX4vbRheqsv2zXKTQ: folds
KMc4R+K9ao4Ur3rF7NGe6Q collected $0.50 from pot
KMc4R+K9ao4Ur3rF7NGe6Q: doesn't show hand
*** SUMMARY ***
Total pot $0.50 | Rake $0
Seat 1: Ag6DvxX4vbRheqsv2zXKTQ (button) (small blind) folded before Flop
Seat 2: KMc4R+K9ao4Ur3rF7NGe6Q (big blind) collected ($0.50)



PokerStars Game #59939637346:  Hold'em No Limit ($0.25/$0.50) - 2009/07/01 0:45:01 ET
Table 'QOeVnLhwctF9UyV/beDi+A' 2-max Seat #1 is the button
Seat 1: bypIyrYcAAifLfhZpGlKLA ($61.70 in chips)
Seat 2: Ucrm3XtZmoONapW32SPhag ($21.65 in chips)
bypIyrYcAAifLfhZpGlKLA: posts small blind $0.25
Ucrm3XtZmoONapW32SPhag: posts big blind $0.50
*** HOLE CARDS ***
bypIyrYcAAifLfhZpGlKLA: raises $0.50 to $1
Ucrm3XtZmoONapW32SPhag: raises $0.50 to $1.50
bypIyrYcAAifLfhZpGlKLA: calls $0.50
*** FLOP *** [6s Qd 8s]
Ucrm3XtZmoONapW32SPhag: checks
bypIyrYcAAifLfhZpGlKLA: bets $2
Ucrm3XtZmoONapW32SPhag: calls $2
*** TURN *** [6s Qd 8s] [2c]
Ucrm3XtZmoONapW32SPhag: checks
bypIyrYcAAifLfhZpGlKLA: bets $4
Ucrm3XtZmoONapW32SPhag: folds
bypIyrYcAAifLfhZpGlKLA collected $6.70 from pot
bypIyrYcAAifLfhZpGlKLA: doesn't show hand
*** SUMMARY ***
Total pot $7 | Rake $0.30
Board [6s Qd 8s 2c]
Seat 1: bypIyrYcAAifLfhZpGlKLA (button) (small blind) collected ($6.70)
Seat 2: Ucrm3XtZmoONapW32SPhag (big blind) folded on the Turn



PokerStars Game #59939638074:  Hold'em No Limit ($0.25/$0.50) - 2009/07/01 0:45:02 ET
Table '5EmHi+fnatGQQShcNmzOZQ' 6-max Seat #2 is the button
Seat 1: +SZCX3+7lnuhHKIu+PP9rg ($30.35 in chips)
Seat 2: vXIHnZ+dv/hwSBxyvGw7bQ ($77.60 in chips)
Seat 3: L9qfLYXrczhAPd/VckgsWw ($79.50 in chips)
Seat 4: 1b+2BbjMN8qhR1WPqdE9VQ ($53.65 in chips)
Seat 5: kxPhs4ePFqMy52CInAJ2aw ($56.10 in chips)
Seat 6: 686aeHikcJlgKkSuIFdcXQ ($141.95 in chips)
L9qfLYXrczhAPd/VckgsWw: posts small blind $0.25
1b+2BbjMN8qhR1WPqdE9VQ: posts big blind $0.50
*** HOLE CARDS ***
kxPhs4ePFqMy52CInAJ2aw: folds
686aeHikcJlgKkSuIFdcXQ: folds
+SZCX3+7lnuhHKIu+PP9rg: raises $1 to $1.50
vXIHnZ+dv/hwSBxyvGw7bQ: raises $3.50 to $5
L9qfLYXrczhAPd/VckgsWw: folds
1b+2BbjMN8qhR1WPqdE9VQ: folds
+SZCX3+7lnuhHKIu+PP9rg: calls $3.50
*** FLOP *** [Th 6h 3h]
+SZCX3+7lnuhHKIu+PP9rg: checks
L9qfLYXrczhAPd/VckgsWw leaves the table
vXIHnZ+dv/hwSBxyvGw7bQ: bets $8.50
+SZCX3+7lnuhHKIu+PP9rg: raises $8.50 to $17
vXIHnZ+dv/hwSBxyvGw7bQ: raises $18.50 to $35.50
+SZCX3+7lnuhHKIu+PP9rg: calls $8.35 and is all-in
*** TURN *** [Th 6h 3h] [4d]
*** RIVER *** [Th 6h 3h 4d] [Ah]
*** SHOW DOWN ***
+SZCX3+7lnuhHKIu+PP9rg: shows [8h 7h] (a flush, Ace high)
vXIHnZ+dv/hwSBxyvGw7bQ: mucks hand
+SZCX3+7lnuhHKIu+PP9rg collected $58.45 from pot
*** SUMMARY ***
Total pot $61.45 | Rake $3
Board [Th 6h 3h 4d Ah]
Seat 1: +SZCX3+7lnuhHKIu+PP9rg showed [8h 7h] and won ($58.45) with a flush, Ace high
Seat 2: vXIHnZ+dv/hwSBxyvGw7bQ (button) mucked
Seat 3: L9qfLYXrczhAPd/VckgsWw (small blind) folded before Flop
Seat 4: 1b+2BbjMN8qhR1WPqdE9VQ (big blind) folded before Flop
Seat 5: kxPhs4ePFqMy52CInAJ2aw folded before Flop (didn't bet)
Seat 6: 686aeHikcJlgKkSuIFdcXQ folded before Flop (didn't bet)



PokerStars Game #59939638236:  Hold'em No Limit ($0.25/$0.50) - 2009/07/01 0:45:02 ET
Table 'ibNfFy0bCzuBaUORla0aGw' 9-max Seat #6 is the button
Seat 1: xZCXQSXlrZkp3pZizzVXCw ($53.20 in chips)
Seat 2: 90Wb75h3W1BRpbqVnuk8gw ($51.40 in chips)
Seat 3: dDaHs3X8+fe3bIkRU0cbrw ($40.15 in chips)
Seat 4: YBN054X4blmis+B2bBlC0g ($23.45 in chips)
Seat 5: GIJAc9kPrLZHLSX8Q6i99w ($25.20 in chips)
Seat 6: 8n9jQLh3cZKbsmr5PIjgiQ ($43.25 in chips)
Seat 7: HZkVla4kK2SI42CVrPZ/ig ($13.80 in chips)
Seat 8: xUrN9TWLq4m5V+OXY7KUUA ($50 in chips)
Seat 9: pFtzb1sR4b0d1aw6aIRgDg ($50.75 in chips)
HZkVla4kK2SI42CVrPZ/ig: posts small blind $0.25
xUrN9TWLq4m5V+OXY7KUUA: posts big blind $0.50
*** HOLE CARDS ***
pFtzb1sR4b0d1aw6aIRgDg: folds
xZCXQSXlrZkp3pZizzVXCw: folds
90Wb75h3W1BRpbqVnuk8gw: folds
dDaHs3X8+fe3bIkRU0cbrw: folds
YBN054X4blmis+B2bBlC0g: folds
GIJAc9kPrLZHLSX8Q6i99w: calls $0.50
8n9jQLh3cZKbsmr5PIjgiQ: folds
HZkVla4kK2SI42CVrPZ/ig: folds
xUrN9TWLq4m5V+OXY7KUUA: checks
*** FLOP *** [Jh 7h As]
xUrN9TWLq4m5V+OXY7KUUA: checks
GIJAc9kPrLZHLSX8Q6i99w: checks
*** TURN *** [Jh 7h As] [Ad]
xUrN9TWLq4m5V+OXY7KUUA: checks
GIJAc9kPrLZHLSX8Q6i99w: checks
*** RIVER *** [Jh 7h As Ad] [4s]
xUrN9TWLq4m5V+OXY7KUUA: checks
GIJAc9kPrLZHLSX8Q6i99w: checks
*** SHOW DOWN ***
xUrN9TWLq4m5V+OXY7KUUA: shows [2c 2s] (two pair, Aces and Deuces)
GIJAc9kPrLZHLSX8Q6i99w: mucks hand
xUrN9TWLq4m5V+OXY7KUUA collected $1.20 from pot
*** SUMMARY ***
Total pot $1.25 | Rake $0.05
Board [Jh 7h As Ad 4s]
Seat 1: xZCXQSXlrZkp3pZizzVXCw folded before Flop (didn't bet)
Seat 2: 90Wb75h3W1BRpbqVnuk8gw folded before Flop (didn't bet)
Seat 3: dDaHs3X8+fe3bIkRU0cbrw folded before Flop (didn't bet)
Seat 4: YBN054X4blmis+B2bBlC0g folded before Flop (didn't bet)
Seat 5: GIJAc9kPrLZHLSX8Q6i99w mucked
Seat 6: 8n9jQLh3cZKbsmr5PIjgiQ (button) folded before Flop (didn't bet)
Seat 7: HZkVla4kK2SI42CVrPZ/ig (small blind) folded before Flop
Seat 8: xUrN9TWLq4m5V+OXY7KUUA (big blind) showed [2c 2s] and won ($1.20) with two pair, Aces and Deuces
Seat 9: pFtzb1sR4b0d1aw6aIRgDg folded before Flop (didn't bet)



PokerStars Game #59939639220:  Hold'em No Limit ($0.25/$0.50) - 2009/07/01 0:45:04 ET
Table '99gCy/CZQwPIjZWH+BguQgE7bWJ45aoFXRpyRv2gw+Igeat #5 is the button
Seat 2: n6VQBu6crjYjy6DxNP1NZA ($29.65 in chips)
Seat 3: qEn9ijNGtuyTxamBf07hYg ($50 in chips)
Seat 4: bxLSulbgr8LmKNjOzw8URg ($63.45 in chips)
Seat 5: DSM67hHHq1XFoEOi9p8Alw ($49.25 in chips)
Seat 6: OcnLOMVFdy23jXnoTyaO5Q ($245.15 in chips)
Seat 7: bfSq6LBw0UvxeM5yfuWC7w ($18.35 in chips)
Seat 8: 8ehL7qlZzjgUh2H35iiWLw ($50 in chips)
Seat 9: j3K/Jujr7PY4ZM2RZvlH6A ($75.90 in chips)
OcnLOMVFdy23jXnoTyaO5Q: posts small blind $0.25
bfSq6LBw0UvxeM5yfuWC7w: posts big blind $0.50
*** HOLE CARDS ***
8ehL7qlZzjgUh2H35iiWLw: folds
j3K/Jujr7PY4ZM2RZvlH6A: calls $0.50
n6VQBu6crjYjy6DxNP1NZA: folds
qEn9ijNGtuyTxamBf07hYg: raises $2 to $2.50
bxLSulbgr8LmKNjOzw8URg: folds
DSM67hHHq1XFoEOi9p8Alw: folds
OcnLOMVFdy23jXnoTyaO5Q: folds
OcnLOMVFdy23jXnoTyaO5Q is sitting out
bfSq6LBw0UvxeM5yfuWC7w: folds
j3K/Jujr7PY4ZM2RZvlH6A: calls $2
*** FLOP *** [2c Th Qd]
j3K/Jujr7PY4ZM2RZvlH6A: bets $3
qEn9ijNGtuyTxamBf07hYg: raises $4.50 to $7.50
j3K/Jujr7PY4ZM2RZvlH6A: raises $14.50 to $22
bfSq6LBw0UvxeM5yfuWC7w said, "alvaro"
bfSq6LBw0UvxeM5yfuWC7w said, "is that picture amanda"
bfSq6LBw0UvxeM5yfuWC7w said, "bynes"
bfSq6LBw0UvxeM5yfuWC7w said, "!?!"
qEn9ijNGtuyTxamBf07hYg: folds
j3K/Jujr7PY4ZM2RZvlH6A collected $19.75 from pot
j3K/Jujr7PY4ZM2RZvlH6A: doesn't show hand
*** SUMMARY ***
Total pot $20.75 | Rake $1
Board [2c Th Qd]
Seat 2: n6VQBu6crjYjy6DxNP1NZA folded before Flop (didn't bet)
Seat 3: qEn9ijNGtuyTxamBf07hYg folded on the Flop
Seat 4: bxLSulbgr8LmKNjOzw8URg folded before Flop (didn't bet)
Seat 5: DSM67hHHq1XFoEOi9p8Alw (button) folded before Flop (didn't bet)
Seat 6: OcnLOMVFdy23jXnoTyaO5Q (small blind) folded before Flop
Seat 7: bfSq6LBw0UvxeM5yfuWC7w (big blind) folded before Flop
Seat 8: 8ehL7qlZzjgUh2H35iiWLw folded before Flop (didn't bet)
Seat 9: j3K/Jujr7PY4ZM2RZvlH6A collected ($19.75)



PokerStars Game #59939640046:  Hold'em No Limit ($0.25/$0.50) - 2009/07/01 0:45:05 ET
Table '3FhG0gl3kMX3wBEEqj+wnQ' 9-max Seat #9 is the button
Seat 1: e0J9pdCNUDTCG031RnXqLA ($22.90 in chips)
Seat 2: 7cYQ+syUWjl38ty/ICOMhw ($47.85 in chips)
Seat 4: bjvJtA9Hqscfznq66txaOQ ($10 in chips)
Seat 5: gsyXT42WLEcOS4DdEk2wlw ($28 in chips)
Seat 6: 997ViqAtWn1FPjJqcffwcA ($50 in chips)
Seat 7: mSD1pginDsyHG5PDfqzphw ($11.50 in chips)
Seat 8: j3K/Jujr7PY4ZM2RZvlH6A ($56.60 in chips)
Seat 9: L5e2lrPLQm1Pqx30IIZ/Fw ($10 in chips)
e0J9pdCNUDTCG031RnXqLA: posts small blind $0.25
7cYQ+syUWjl38ty/ICOMhw: posts big blind $0.50
k1f0lS7tlMHCLGs0JT34Tg: sits out
*** HOLE CARDS ***
bjvJtA9Hqscfznq66txaOQ: folds
gsyXT42WLEcOS4DdEk2wlw: folds
997ViqAtWn1FPjJqcffwcA: folds
mSD1pginDsyHG5PDfqzphw: folds
j3K/Jujr7PY4ZM2RZvlH6A: raises $2 to $2.50
L5e2lrPLQm1Pqx30IIZ/Fw: folds
e0J9pdCNUDTCG031RnXqLA: folds
7cYQ+syUWjl38ty/ICOMhw: folds
j3K/Jujr7PY4ZM2RZvlH6A collected $1.25 from pot
j3K/Jujr7PY4ZM2RZvlH6A: doesn't show hand
*** SUMMARY ***
Total pot $1.25 | Rake $0
Seat 1: e0J9pdCNUDTCG031RnXqLA (small blind) folded before Flop
Seat 2: 7cYQ+syUWjl38ty/ICOMhw (big blind) folded before Flop
Seat 4: bjvJtA9Hqscfznq66txaOQ folded before Flop (didn't bet)
Seat 5: gsyXT42WLEcOS4DdEk2wlw folded before Flop (didn't bet)
Seat 6: 997ViqAtWn1FPjJqcffwcA folded before Flop (didn't bet)
Seat 7: mSD1pginDsyHG5PDfqzphw folded before Flop (didn't bet)
Seat 8: j3K/Jujr7PY4ZM2RZvlH6A collected ($1.25)
Seat 9: L5e2lrPLQm1Pqx30IIZ/Fw (button) folded before Flop (didn't bet)



PokerStars Game #59939640132:  Hold'em No Limit ($0.25/$0.50) - 2009/07/01 0:45:05 ET
Table '0eJtgVAXVvBgncFdcUpXcQ' 2-max Seat #2 is the button
Seat 1: Ag6DvxX4vbRheqsv2zXKTQ ($20.20 in chips)
Seat 2: KMc4R+K9ao4Ur3rF7NGe6Q ($9.75 in chips)
KMc4R+K9ao4Ur3rF7NGe6Q: posts small blind $0.25
Ag6DvxX4vbRheqsv2zXKTQ: posts big blind $0.50
*** HOLE CARDS ***
KMc4R+K9ao4Ur3rF7NGe6Q: calls $0.25
Ag6DvxX4vbRheqsv2zXKTQ: checks
*** FLOP *** [Ad 7s Tc]
Ag6DvxX4vbRheqsv2zXKTQ: checks
KMc4R+K9ao4Ur3rF7NGe6Q: checks
*** TURN *** [Ad 7s Tc] [2h]
Ag6DvxX4vbRheqsv2zXKTQ: bets $1
KMc4R+K9ao4Ur3rF7NGe6Q: raises $1.50 to $2.50
Ag6DvxX4vbRheqsv2zXKTQ: folds
KMc4R+K9ao4Ur3rF7NGe6Q collected $2.90 from pot
KMc4R+K9ao4Ur3rF7NGe6Q: doesn't show hand
*** SUMMARY ***
Total pot $3 | Rake $0.10
Board [Ad 7s Tc 2h]
Seat 1: Ag6DvxX4vbRheqsv2zXKTQ (big blind) folded on the Turn
Seat 2: KMc4R+K9ao4Ur3rF7NGe6Q (button) (small blind) collected ($2.90)



PokerStars Game #59939640294:  Hold'em No Limit ($0.25/$0.50) - 2009/07/01 0:45:05 ET
Table 'IeNZOZQ4T6oiaHqFeo6yIA' 2-max Seat #2 is the button
Seat 1: ndd1nfncBkWNitBnsfCoVQ ($57.90 in chips)
Seat 2: A91IUl5JaZROhtfCtnnwYw ($114.70 in chips)
A91IUl5JaZROhtfCtnnwYw: posts small blind $0.25
ndd1nfncBkWNitBnsfCoVQ: posts big blind $0.50
*** HOLE CARDS ***
A91IUl5JaZROhtfCtnnwYw: raises $0.50 to $1
ndd1nfncBkWNitBnsfCoVQ: calls $0.50
*** FLOP *** [3d 9h 5h]
ndd1nfncBkWNitBnsfCoVQ: checks
A91IUl5JaZROhtfCtnnwYw: bets $1.50
ndd1nfncBkWNitBnsfCoVQ: folds
A91IUl5JaZROhtfCtnnwYw collected $1.90 from pot
A91IUl5JaZROhtfCtnnwYw: doesn't show hand
*** SUMMARY ***
Total pot $2 | Rake $0.10
Board [3d 9h 5h]
Seat 1: ndd1nfncBkWNitBnsfCoVQ (big blind) folded on the Flop
Seat 2: A91IUl5JaZROhtfCtnnwYw (button) (small blind) collected ($1.90)



PokerStars Game #59939639788:  Hold'em No Limit ($0.25/$0.50) - 2009/07/01 0:45:05 ET
Table 'Vdlc9wqYcHTUhtdyN7CuJw' 2-max Seat #2 is the button
Seat 1: yBO+mXB6m/rCft2ErwGf/Q ($110.35 in chips)
Seat 2: NZ/5cxwnorKW2SNsWy1+8A ($16 in chips)
NZ/5cxwnorKW2SNsWy1+8A: posts small blind $0.25
yBO+mXB6m/rCft2ErwGf/Q: posts big blind $0.50
*** HOLE CARDS ***
NZ/5cxwnorKW2SNsWy1+8A: folds
yBO+mXB6m/rCft2ErwGf/Q collected $0.50 from pot
*** SUMMARY ***
Total pot $0.50 | Rake $0
Seat 1: yBO+mXB6m/rCft2ErwGf/Q (big blind) collected ($0.50)
Seat 2: NZ/5cxwnorKW2SNsWy1+8A (button) (small blind) folded before Flop



PokerStars Game #59939640172:  Hold'em No Limit ($0.25/$0.50) - 2009/07/01 0:45:05 ET
Table '+111aLuBwnz8YVYSA7J1jA' 2-max Seat #1 is the button
Seat 1: ndd1nfncBkWNitBnsfCoVQ ($74.10 in chips)
Seat 2: +ciXH35zeafrjg1W6wiBTg ($74.85 in chips)
ndd1nfncBkWNitBnsfCoVQ: posts small blind $0.25
+ciXH35zeafrjg1W6wiBTg: posts big blind $0.50
*** HOLE CARDS ***
ndd1nfncBkWNitBnsfCoVQ: raises $1 to $1.50
+ciXH35zeafrjg1W6wiBTg: raises $2 to $3.50
ndd1nfncBkWNitBnsfCoVQ: raises $7.50 to $11
+ciXH35zeafrjg1W6wiBTg: calls $7.50
*** FLOP *** [Qd 3s Th]
+ciXH35zeafrjg1W6wiBTg: checks
ndd1nfncBkWNitBnsfCoVQ: checks
*** TURN *** [Qd 3s Th] [Td]
+ciXH35zeafrjg1W6wiBTg: checks
ndd1nfncBkWNitBnsfCoVQ: checks
*** RIVER *** [Qd 3s Th Td] [4h]
+ciXH35zeafrjg1W6wiBTg: checks
ndd1nfncBkWNitBnsfCoVQ: checks
*** SHOW DOWN ***
+ciXH35zeafrjg1W6wiBTg: shows [8d As] (a pair of Tens)
ndd1nfncBkWNitBnsfCoVQ: shows [Ah Kc] (a pair of Tens - Ace+King kicker)
ndd1nfncBkWNitBnsfCoVQ collected $21.50 from pot
*** SUMMARY ***
Total pot $22 | Rake $0.50
Board [Qd 3s Th Td 4h]
Seat 1: ndd1nfncBkWNitBnsfCoVQ (button) (small blind) showed [Ah Kc] and won ($21.50) with a pair of Tens
Seat 2: +ciXH35zeafrjg1W6wiBTg (big blind) showed [8d As] and lost with a pair of Tens



PokerStars Game #59939640068:  Hold'em No Limit ($0.25/$0.50) - 2009/07/01 0:45:05 ET
Table 'lSisgp6H7Fg1hH5VfjEjYQ' 9-max Seat #4 is the button
Seat 1: 5k9fvXD9suIgCxU4HLQjTw ($50 in chips)
Seat 2: UrcnkQOiLVk8BlKDPJSy7Q ($50 in chips)
Seat 3: aTkyjTh3w5YLWiIERupZOA ($51.95 in chips)
Seat 4: bwv/rbH/hHhPhY6u9mu04w ($31 in chips)
Seat 5: mSD1pginDsyHG5PDfqzphw ($11.60 in chips)
Seat 6: +k7T5ocke8UwavtgUHm+Cg ($31.60 in chips)
Seat 7: Y3DZ6qQlLeBhixDj4M9vmg ($10.80 in chips)
Seat 8: a4JDWmpFQkL10XfAyuF51A ($33.25 in chips)
Seat 9: gsyXT42WLEcOS4DdEk2wlw ($30.20 in chips)
mSD1pginDsyHG5PDfqzphw: posts small blind $0.25
+k7T5ocke8UwavtgUHm+Cg: posts big blind $0.50
*** HOLE CARDS ***
Y3DZ6qQlLeBhixDj4M9vmg: calls $0.50
a4JDWmpFQkL10XfAyuF51A: calls $0.50
gsyXT42WLEcOS4DdEk2wlw: folds
5k9fvXD9suIgCxU4HLQjTw: folds
UrcnkQOiLVk8BlKDPJSy7Q: folds
aTkyjTh3w5YLWiIERupZOA: folds
bwv/rbH/hHhPhY6u9mu04w: calls $0.50
mSD1pginDsyHG5PDfqzphw: folds
+k7T5ocke8UwavtgUHm+Cg: checks
*** FLOP *** [3c 4c 3s]
+k7T5ocke8UwavtgUHm+Cg: bets $1.50
Y3DZ6qQlLeBhixDj4M9vmg: folds
a4JDWmpFQkL10XfAyuF51A: calls $1.50
bwv/rbH/hHhPhY6u9mu04w: folds
*** TURN *** [3c 4c 3s] [3d]
+k7T5ocke8UwavtgUHm+Cg: checks
a4JDWmpFQkL10XfAyuF51A: checks
*** RIVER *** [3c 4c 3s 3d] [4s]
+k7T5ocke8UwavtgUHm+Cg: bets $7
a4JDWmpFQkL10XfAyuF51A: folds
+k7T5ocke8UwavtgUHm+Cg collected $5 from pot
+k7T5ocke8UwavtgUHm+Cg: doesn't show hand
*** SUMMARY ***
Total pot $5.25 | Rake $0.25
Board [3c 4c 3s 3d 4s]
Seat 1: 5k9fvXD9suIgCxU4HLQjTw folded before Flop (didn't bet)
Seat 2: UrcnkQOiLVk8BlKDPJSy7Q folded before Flop (didn't bet)
Seat 3: aTkyjTh3w5YLWiIERupZOA folded before Flop (didn't bet)
Seat 4: bwv/rbH/hHhPhY6u9mu04w (button) folded on the Flop
Seat 5: mSD1pginDsyHG5PDfqzphw (small blind) folded before Flop
Seat 6: +k7T5ocke8UwavtgUHm+Cg (big blind) collected ($5)
Seat 7: Y3DZ6qQlLeBhixDj4M9vmg folded on the Flop
Seat 8: a4JDWmpFQkL10XfAyuF51A folded on the River
Seat 9: gsyXT42WLEcOS4DdEk2wlw folded before Flop (didn't bet)



PokerStars Game #59939639838:  Hold'em No Limit ($0.25/$0.50) - 2009/07/01 0:45:05 ET
Table 'NCiXr0d5CEKBQr/cZgLhbA' 9-max Seat #7 is the button
Seat 1: pFtzb1sR4b0d1aw6aIRgDg ($50 in chips)
Seat 2: ulxuJchBV9iguXg0FUonfg ($49.75 in chips)
Seat 3: xZCXQSXlrZkp3pZizzVXCw ($50.75 in chips)
Seat 4: 5k9fvXD9suIgCxU4HLQjTw ($56.70 in chips)
Seat 5: zE9cVigS2nW/Ljy4K4bUQA ($36.70 in chips)
Seat 6: SKnJuWHScqetA/qG5p+wCg ($33.95 in chips)
Seat 7: M+7+BTmX5vZatHVuoRB1nA ($47.60 in chips)
Seat 8: 1MJUKc3cc0QmUoz1JZLR2w ($54.50 in chips)
Seat 9: 4WLZvqBn5qv5tds5kt5A1Q ($46.55 in chips)
1MJUKc3cc0QmUoz1JZLR2w: posts small blind $0.25
4WLZvqBn5qv5tds5kt5A1Q: posts big blind $0.50
*** HOLE CARDS ***
pFtzb1sR4b0d1aw6aIRgDg: folds
ulxuJchBV9iguXg0FUonfg: raises $1 to $1.50
xZCXQSXlrZkp3pZizzVXCw: folds
5k9fvXD9suIgCxU4HLQjTw: folds
zE9cVigS2nW/Ljy4K4bUQA: folds
SKnJuWHScqetA/qG5p+wCg: folds
M+7+BTmX5vZatHVuoRB1nA: folds
1MJUKc3cc0QmUoz1JZLR2w: folds
4WLZvqBn5qv5tds5kt5A1Q: folds
ulxuJchBV9iguXg0FUonfg collected $1.25 from pot
ulxuJchBV9iguXg0FUonfg: doesn't show hand
*** SUMMARY ***
Total pot $1.25 | Rake $0
Seat 1: pFtzb1sR4b0d1aw6aIRgDg folded before Flop (didn't bet)
Seat 2: ulxuJchBV9iguXg0FUonfg collected ($1.25)
Seat 3: xZCXQSXlrZkp3pZizzVXCw folded before Flop (didn't bet)
Seat 4: 5k9fvXD9suIgCxU4HLQjTw folded before Flop (didn't bet)
Seat 5: zE9cVigS2nW/Ljy4K4bUQA folded before Flop (didn't bet)
Seat 6: SKnJuWHScqetA/qG5p+wCg folded before Flop (didn't bet)
Seat 7: M+7+BTmX5vZatHVuoRB1nA (button) folded before Flop (didn't bet)
Seat 8: 1MJUKc3cc0QmUoz1JZLR2w (small blind) folded before Flop
Seat 9: 4WLZvqBn5qv5tds5kt5A1Q (big blind) folded before Flop



PokerStars Game #59939639984:  Hold'em No Limit ($0.25/$0.50) - 2009/07/01 0:45:05 ET
Table 'GfL/No5u5PoEnU39lP5pQg' 6-max Seat #1 is the button
Seat 1: 1WUCqNG+p+vfWRTXNu4ljw ($62.95 in chips)
Seat 2: uVwggSetzp7d+eVgowO3vg ($67.95 in chips)
Seat 3: Ek4w9XqBXqK5jBUQeLedGw ($50 in chips)
Seat 4: x+pzUFJsMIiGd7a5pcR4tg ($55.15 in chips)
Seat 5: M1KyQQvVPVuxqTAB8sR/zQ ($50 in chips)
uVwggSetzp7d+eVgowO3vg: posts small blind $0.25
Ek4w9XqBXqK5jBUQeLedGw: posts big blind $0.50
*** HOLE CARDS ***
x+pzUFJsMIiGd7a5pcR4tg: folds
M1KyQQvVPVuxqTAB8sR/zQ: folds
1WUCqNG+p+vfWRTXNu4ljw: folds
x+pzUFJsMIiGd7a5pcR4tg leaves the table
uVwggSetzp7d+eVgowO3vg: folds
Ek4w9XqBXqK5jBUQeLedGw collected $0.50 from pot
*** SUMMARY ***
Total pot $0.50 | Rake $0
Seat 1: 1WUCqNG+p+vfWRTXNu4ljw (button) folded before Flop (didn't bet)
Seat 2: uVwggSetzp7d+eVgowO3vg (small blind) folded before Flop
Seat 3: Ek4w9XqBXqK5jBUQeLedGw (big blind) collected ($0.50)
Seat 4: x+pzUFJsMIiGd7a5pcR4tg folded before Flop (didn't bet)
Seat 5: M1KyQQvVPVuxqTAB8sR/zQ folded before Flop (didn't bet)



PokerStars Game #59939640820:  Hold'em No Limit ($0.25/$0.50) - 2009/07/01 0:45:06 ET
Table '/cQuAT3ef4t+PGrXiNhGaQ' 9-max Seat #3 is the button
Seat 1: HZkVla4kK2SI42CVrPZ/ig ($5.25 in chips)
Seat 2: jXGruyaMqirTaTXNOvBdew ($67.60 in chips)
Seat 3: g4k0NXISyLCqaSWZDBjfEg ($53.65 in chips)
Seat 4: OWP/DOu+PlPK6ZZ3zYa0HA ($30.90 in chips)
Seat 5: 5SgaHdWixdClWvaEG+KUjQ ($26.35 in chips)
Seat 6: APYIOyK/4AGb+kIwlOUNBQ ($39 in chips)
Seat 7: J0W5D97jl5VLky+IoPvDeA ($114.15 in chips)
Seat 8: W3ingbA178eb7J5rt1PuIQ ($37.10 in chips)
Seat 9: AjV5McH1KMMclY26QdLM5w ($31.35 in chips)
OWP/DOu+PlPK6ZZ3zYa0HA: posts small blind $0.25
5SgaHdWixdClWvaEG+KUjQ: posts big blind $0.50
*** HOLE CARDS ***
APYIOyK/4AGb+kIwlOUNBQ: folds
J0W5D97jl5VLky+IoPvDeA: folds
W3ingbA178eb7J5rt1PuIQ: folds
AjV5McH1KMMclY26QdLM5w: folds
HZkVla4kK2SI42CVrPZ/ig: folds
jXGruyaMqirTaTXNOvBdew: raises $1 to $1.50
g4k0NXISyLCqaSWZDBjfEg: folds
OWP/DOu+PlPK6ZZ3zYa0HA: calls $1.25
5SgaHdWixdClWvaEG+KUjQ: folds
*** FLOP *** [As 2h 3c]
OWP/DOu+PlPK6ZZ3zYa0HA: checks
jXGruyaMqirTaTXNOvBdew: bets $3
OWP/DOu+PlPK6ZZ3zYa0HA: folds
jXGruyaMqirTaTXNOvBdew collected $3.35 from pot
*** SUMMARY ***
Total pot $3.50 | Rake $0.15
Board [As 2h 3c]
Seat 1: HZkVla4kK2SI42CVrPZ/ig folded before Flop (didn't bet)
Seat 2: jXGruyaMqirTaTXNOvBdew collected ($3.35)
Seat 3: g4k0NXISyLCqaSWZDBjfEg (button) folded before Flop (didn't bet)
Seat 4: OWP/DOu+PlPK6ZZ3zYa0HA (small blind) folded on the Flop
Seat 5: 5SgaHdWixdClWvaEG+KUjQ (big blind) folded before Flop
Seat 6: APYIOyK/4AGb+kIwlOUNBQ folded before Flop (didn't bet)
Seat 7: J0W5D97jl5VLky+IoPvDeA folded before Flop (didn't bet)
Seat 8: W3ingbA178eb7J5rt1PuIQ folded before Flop (didn't bet)
Seat 9: AjV5McH1KMMclY26QdLM5w folded before Flop (didn't bet)



PokerStars Game #59939641832:  Hold'em No Limit ($0.25/$0.50) - 2009/07/01 0:45:08 ET
Table 'T/PgNWqVyY6lkldcBVXYJQ' 6-max Seat #4 is the button
Seat 1: +Pf9jTVizYlIo+woPvptfA ($55.75 in chips)
Seat 2: LvH4G7n+QSjT6NDaD3cREA ($75.75 in chips)
Seat 3: L3OcNO1bgdqDI46j67KQPQ ($50 in chips)
Seat 4: Ek4w9XqBXqK5jBUQeLedGw ($50 in chips)
Seat 5: vVQBckETtigfb5mAcyK0OA ($55.20 in chips)
Seat 6: cDzbog6kwmJp+LBeBq+iMQ ($28.40 in chips)
vVQBckETtigfb5mAcyK0OA: posts small blind $0.25
cDzbog6kwmJp+LBeBq+iMQ: posts big blind $0.50
*** HOLE CARDS ***
+Pf9jTVizYlIo+woPvptfA: folds
LvH4G7n+QSjT6NDaD3cREA: folds
L3OcNO1bgdqDI46j67KQPQ: raises $1.50 to $2
LvH4G7n+QSjT6NDaD3cREA said, "y"
Ek4w9XqBXqK5jBUQeLedGw: folds
vVQBckETtigfb5mAcyK0OA: folds
cDzbog6kwmJp+LBeBq+iMQ: folds
L3OcNO1bgdqDI46j67KQPQ collected $1.25 from pot
L3OcNO1bgdqDI46j67KQPQ: doesn't show hand
*** SUMMARY ***
Total pot $1.25 | Rake $0
Seat 1: +Pf9jTVizYlIo+woPvptfA folded before Flop (didn't bet)
Seat 2: LvH4G7n+QSjT6NDaD3cREA folded before Flop (didn't bet)
Seat 3: L3OcNO1bgdqDI46j67KQPQ collected ($1.25)
Seat 4: Ek4w9XqBXqK5jBUQeLedGw (button) folded before Flop (didn't bet)
Seat 5: vVQBckETtigfb5mAcyK0OA (small blind) folded before Flop
Seat 6: cDzbog6kwmJp+LBeBq+iMQ (big blind) folded before Flop



PokerStars Game #59939643380:  Hold'em No Limit ($0.25/$0.50) - 2009/07/01 0:45:10 ET
Table 'Vdlc9wqYcHTUhtdyN7CuJw' 2-max Seat #1 is the button
Seat 1: yBO+mXB6m/rCft2ErwGf/Q ($110.60 in chips)
Seat 2: NZ/5cxwnorKW2SNsWy1+8A ($15.75 in chips)
yBO+mXB6m/rCft2ErwGf/Q: posts small blind $0.25
NZ/5cxwnorKW2SNsWy1+8A: posts big blind $0.50
*** HOLE CARDS ***
yBO+mXB6m/rCft2ErwGf/Q: calls $0.25
NZ/5cxwnorKW2SNsWy1+8A: checks
*** FLOP *** [9s 5s 3h]
NZ/5cxwnorKW2SNsWy1+8A: checks
yBO+mXB6m/rCft2ErwGf/Q: checks
*** TURN *** [9s 5s 3h] [Jh]
NZ/5cxwnorKW2SNsWy1+8A: bets $1
yBO+mXB6m/rCft2ErwGf/Q: calls $1
*** RIVER *** [9s 5s 3h Jh] [2d]
NZ/5cxwnorKW2SNsWy1+8A: bets $1
yBO+mXB6m/rCft2ErwGf/Q: raises $3 to $4
NZ/5cxwnorKW2SNsWy1+8A: calls $3
*** SHOW DOWN ***
yBO+mXB6m/rCft2ErwGf/Q: shows [6d 4c] (a straight, Deuce to Six)
NZ/5cxwnorKW2SNsWy1+8A: mucks hand
yBO+mXB6m/rCft2ErwGf/Q collected $10.50 from pot
*** SUMMARY ***
Total pot $11 | Rake $0.50
Board [9s 5s 3h Jh 2d]
Seat 1: yBO+mXB6m/rCft2ErwGf/Q (button) (small blind) showed [6d 4c] and won ($10.50) with a straight, Deuce to Six
Seat 2: NZ/5cxwnorKW2SNsWy1+8A (big blind) mucked



PokerStars Game #59939643354:  Hold'em No Limit ($0.25/$0.50) - 2009/07/01 0:45:10 ET
Table '+dXkOAQyS8j9PQZusUTMpg' 2-max Seat #2 is the button
Seat 1: XFa6sBGjP2gxoIvxR3fZIg ($48.70 in chips)
Seat 2: 5IBeOgaApY1Bvzv2P8X4EA ($154.95 in chips)
5IBeOgaApY1Bvzv2P8X4EA: posts small blind $0.25
XFa6sBGjP2gxoIvxR3fZIg: posts big blind $0.50
*** HOLE CARDS ***
5IBeOgaApY1Bvzv2P8X4EA: calls $0.25
XFa6sBGjP2gxoIvxR3fZIg: checks
*** FLOP *** [Ts Th Kc]
XFa6sBGjP2gxoIvxR3fZIg: checks
5IBeOgaApY1Bvzv2P8X4EA: checks
*** TURN *** [Ts Th Kc] [Qs]
XFa6sBGjP2gxoIvxR3fZIg: checks
5IBeOgaApY1Bvzv2P8X4EA: checks
*** RIVER *** [Ts Th Kc Qs] [Ah]
XFa6sBGjP2gxoIvxR3fZIg: checks
5IBeOgaApY1Bvzv2P8X4EA: checks
*** SHOW DOWN ***
XFa6sBGjP2gxoIvxR3fZIg: shows [8c 5d] (a pair of Tens)
5IBeOgaApY1Bvzv2P8X4EA: shows [6h 6c] (two pair, Tens and Sixes)
5IBeOgaApY1Bvzv2P8X4EA collected $0.95 from pot
*** SUMMARY ***
Total pot $1 | Rake $0.05
Board [Ts Th Kc Qs Ah]
Seat 1: XFa6sBGjP2gxoIvxR3fZIg (big blind) showed [8c 5d] and lost with a pair of Tens
Seat 2: 5IBeOgaApY1Bvzv2P8X4EA (button) (small blind) showed [6h 6c] and won ($0.95) with two pair, Tens and Sixes



PokerStars Game #59939644580:  Hold'em No Limit ($0.25/$0.50) - 2009/07/01 0:45:12 ET
Table 'otvGDROEDdqsabxskT79qg' 9-max Seat #2 is the button
Seat 1: 8ehL7qlZzjgUh2H35iiWLw ($55.25 in chips)
Seat 2: cCjTzH9jio8607WzjcfXlg ($8.30 in chips)
Seat 3: +k7T5ocke8UwavtgUHm+Cg ($62.30 in chips)
Seat 4: MG90wfSJZnOejs/KD3vlQQ ($70.70 in chips)
Seat 5: XNMDwbXt/Q4jM99AXnbJDw ($54.30 in chips)
Seat 6: bxLSulbgr8LmKNjOzw8URg ($51.40 in chips)
Seat 7: C7+tBppJrKgd/r+tuKUIpA ($39.85 in chips)
Seat 8: zE9cVigS2nW/Ljy4K4bUQA ($30 in chips)
Seat 9: KcY3X8YpD74Kw1RHkx/g4A ($64.50 in chips)
+k7T5ocke8UwavtgUHm+Cg: posts small blind $0.25
MG90wfSJZnOejs/KD3vlQQ: posts big blind $0.50
*** HOLE CARDS ***
XNMDwbXt/Q4jM99AXnbJDw: folds
bxLSulbgr8LmKNjOzw8URg: raises $1 to $1.50
C7+tBppJrKgd/r+tuKUIpA: calls $1.50
zE9cVigS2nW/Ljy4K4bUQA: folds
KcY3X8YpD74Kw1RHkx/g4A: folds
8ehL7qlZzjgUh2H35iiWLw: folds
cCjTzH9jio8607WzjcfXlg: calls $1.50
+k7T5ocke8UwavtgUHm+Cg: folds
MG90wfSJZnOejs/KD3vlQQ: folds
*** FLOP *** [8h 5c Jh]
bxLSulbgr8LmKNjOzw8URg: checks
C7+tBppJrKgd/r+tuKUIpA: checks
cCjTzH9jio8607WzjcfXlg: bets $0.50
bxLSulbgr8LmKNjOzw8URg: folds
C7+tBppJrKgd/r+tuKUIpA: calls $0.50
*** TURN *** [8h 5c Jh] [Qs]
C7+tBppJrKgd/r+tuKUIpA: checks
cCjTzH9jio8607WzjcfXlg: bets $1
C7+tBppJrKgd/r+tuKUIpA: folds
cCjTzH9jio8607WzjcfXlg collected $5.95 from pot
*** SUMMARY ***
Total pot $6.25 | Rake $0.30
Board [8h 5c Jh Qs]
Seat 1: 8ehL7qlZzjgUh2H35iiWLw folded before Flop (didn't bet)
Seat 2: cCjTzH9jio8607WzjcfXlg (button) collected ($5.95)
Seat 3: +k7T5ocke8UwavtgUHm+Cg (small blind) folded before Flop
Seat 4: MG90wfSJZnOejs/KD3vlQQ (big blind) folded before Flop
Seat 5: XNMDwbXt/Q4jM99AXnbJDw folded before Flop (didn't bet)
Seat 6: bxLSulbgr8LmKNjOzw8URg folded on the Flop
Seat 7: C7+tBppJrKgd/r+tuKUIpA folded on the Turn
Seat 8: zE9cVigS2nW/Ljy4K4bUQA folded before Flop (didn't bet)
Seat 9: KcY3X8YpD74Kw1RHkx/g4A folded before Flop (didn't bet)



PokerStars Game #59939644532:  Hold'em No Limit ($0.25/$0.50) - 2009/07/01 0:45:12 ET
Table 'eMxdLyFDf28E0wit6gm3Uw' 6-max Seat #3 is the button
Seat 1: GtdWeBVCZhDBcNFRTOb8Hg ($5.10 in chips)
Seat 3: dZcLsEI8iXkobBduRJ45Yw ($12.60 in chips)
Seat 4: 3jxEWvv2qK1HCXLj4khowQ ($40.75 in chips)
Seat 5: X0X97o2fDAPiGx6o1gahsw ($52.85 in chips)
3jxEWvv2qK1HCXLj4khowQ: posts small blind $0.25
X0X97o2fDAPiGx6o1gahsw: posts big blind $0.50
nOfdMHEXflgT86UgFWblAA: sits out
*** HOLE CARDS ***
GtdWeBVCZhDBcNFRTOb8Hg: calls $0.50
dZcLsEI8iXkobBduRJ45Yw: calls $0.50
3jxEWvv2qK1HCXLj4khowQ: folds
X0X97o2fDAPiGx6o1gahsw: raises $30 to $30.50
GtdWeBVCZhDBcNFRTOb8Hg: folds
dZcLsEI8iXkobBduRJ45Yw: folds
X0X97o2fDAPiGx6o1gahsw collected $1.75 from pot
*** SUMMARY ***
Total pot $1.75 | Rake $0
Seat 1: GtdWeBVCZhDBcNFRTOb8Hg folded before Flop
Seat 3: dZcLsEI8iXkobBduRJ45Yw (button) folded before Flop
Seat 4: 3jxEWvv2qK1HCXLj4khowQ (small blind) folded before Flop
Seat 5: X0X97o2fDAPiGx6o1gahsw (big blind) collected ($1.75)



PokerStars Game #59939649334:  Hold'em No Limit ($0.25/$0.50) - 2009/07/01 0:45:20 ET
Table 'GfL/No5u5PoEnU39lP5pQg' 6-max Seat #2 is the button
Seat 1: 1WUCqNG+p+vfWRTXNu4ljw ($62.95 in chips)
Seat 2: uVwggSetzp7d+eVgowO3vg ($67.70 in chips)
Seat 3: Ek4w9XqBXqK5jBUQeLedGw ($50.25 in chips)
Seat 5: M1KyQQvVPVuxqTAB8sR/zQ ($50 in chips)
Ek4w9XqBXqK5jBUQeLedGw: posts small blind $0.25
M1KyQQvVPVuxqTAB8sR/zQ: posts big blind $0.50
*** HOLE CARDS ***
1WUCqNG+p+vfWRTXNu4ljw: folds
uVwggSetzp7d+eVgowO3vg: folds
Ek4w9XqBXqK5jBUQeLedGw: folds
M1KyQQvVPVuxqTAB8sR/zQ collected $0.50 from pot
M1KyQQvVPVuxqTAB8sR/zQ: doesn't show hand
*** SUMMARY ***
Total pot $0.50 | Rake $0
Seat 1: 1WUCqNG+p+vfWRTXNu4ljw folded before Flop (didn't bet)
Seat 2: uVwggSetzp7d+eVgowO3vg (button) folded before Flop (didn't bet)
Seat 3: Ek4w9XqBXqK5jBUQeLedGw (small blind) folded before Flop
Seat 5: M1KyQQvVPVuxqTAB8sR/zQ (big blind) collected ($0.50)



PokerStars Game #59939650010:  Hold'em No Limit ($0.25/$0.50) - 2009/07/01 0:45:21 ET
Table 'IeNZOZQ4T6oiaHqFeo6yIA' 2-max Seat #1 is the button
Seat 1: ndd1nfncBkWNitBnsfCoVQ ($56.90 in chips)
Seat 2: A91IUl5JaZROhtfCtnnwYw ($115.60 in chips)
ndd1nfncBkWNitBnsfCoVQ: posts small blind $0.25
A91IUl5JaZROhtfCtnnwYw: posts big blind $0.50
*** HOLE CARDS ***
ndd1nfncBkWNitBnsfCoVQ: folds
A91IUl5JaZROhtfCtnnwYw collected $0.50 from pot
A91IUl5JaZROhtfCtnnwYw: doesn't show hand
*** SUMMARY ***
Total pot $0.50 | Rake $0
Seat 1: ndd1nfncBkWNitBnsfCoVQ (button) (small blind) folded before Flop
Seat 2: A91IUl5JaZROhtfCtnnwYw (big blind) collected ($0.50)



PokerStars Game #59939652336:  Hold'em No Limit ($0.25/$0.50) - 2009/07/01 0:45:24 ET
Table 'E7bWJ45aoFXRpyRv2gw+Ig' 2-max Seat #2 is the button
Seat 1: FRkiRasEGlHUeLrEl+k/nA ($69.25 in chips)
Seat 2: 3Wro85I7472vJ4Wkpneo9A ($126.35 in chips)
3Wro85I7472vJ4Wkpneo9A: posts small blind $0.25
FRkiRasEGlHUeLrEl+k/nA: posts big blind $0.50
*** HOLE CARDS ***
3Wro85I7472vJ4Wkpneo9A: calls $0.25
FRkiRasEGlHUeLrEl+k/nA: checks
*** FLOP *** [2c 3s Kc]
FRkiRasEGlHUeLrEl+k/nA: checks
3Wro85I7472vJ4Wkpneo9A: bets $1
FRkiRasEGlHUeLrEl+k/nA: raises $3 to $4
3Wro85I7472vJ4Wkpneo9A: folds
FRkiRasEGlHUeLrEl+k/nA collected $2.90 from pot
*** SUMMARY ***
Total pot $3 | Rake $0.10
Board [2c 3s Kc]
Seat 1: FRkiRasEGlHUeLrEl+k/nA (big blind) collected ($2.90)
Seat 2: 3Wro85I7472vJ4Wkpneo9A (button) (small blind) folded on the Flop



PokerStars Game #59939652436:  Hold'em No Limit ($0.25/$0.50) - 2009/07/01 0:45:24 ET
Table '37qXEp3oe+er5q4CZip9eQ' 6-max Seat #6 is the button
Seat 1: oqOqoO2AyCZenUghCxMDxw ($57.90 in chips)
Seat 2: 6wzJiRvp8HY6t+MQGnSIzA ($20.30 in chips)
Seat 3: Rt6KgtZ8YaJoTc3FPim00w ($72.25 in chips)
Seat 4: XsmE8nXMAAMFJbWaJTmHFw ($28.95 in chips)
Seat 5: VOmI0x4dDPnTESZd5B4d1Q ($46.65 in chips)
Seat 6: N50kln4negd8q7Mmoz1j4g ($29.50 in chips)
oqOqoO2AyCZenUghCxMDxw: posts small blind $0.25
6wzJiRvp8HY6t+MQGnSIzA: posts big blind $0.50
VOmI0x4dDPnTESZd5B4d1Q: posts small & big blinds $0.75
*** HOLE CARDS ***
Rt6KgtZ8YaJoTc3FPim00w: raises $1.50 to $2
XsmE8nXMAAMFJbWaJTmHFw: folds
VOmI0x4dDPnTESZd5B4d1Q: folds
N50kln4negd8q7Mmoz1j4g: folds
oqOqoO2AyCZenUghCxMDxw: folds
6wzJiRvp8HY6t+MQGnSIzA: folds
Rt6KgtZ8YaJoTc3FPim00w collected $2 from pot
*** SUMMARY ***
Total pot $2 | Rake $0
Seat 1: oqOqoO2AyCZenUghCxMDxw (small blind) folded before Flop
Seat 2: 6wzJiRvp8HY6t+MQGnSIzA (big blind) folded before Flop
Seat 3: Rt6KgtZ8YaJoTc3FPim00w collected ($2)
Seat 4: XsmE8nXMAAMFJbWaJTmHFw folded before Flop (didn't bet)
Seat 5: VOmI0x4dDPnTESZd5B4d1Q folded before Flop
Seat 6: N50kln4negd8q7Mmoz1j4g (button) folded before Flop (didn't bet)



PokerStars Game #59939653076:  Hold'em No Limit ($0.25/$0.50) - 2009/07/01 0:45:25 ET
Table '0eJtgVAXVvBgncFdcUpXcQ' 2-max Seat #1 is the button
Seat 1: Ag6DvxX4vbRheqsv2zXKTQ ($18.70 in chips)
Seat 2: KMc4R+K9ao4Ur3rF7NGe6Q ($11.15 in chips)
Ag6DvxX4vbRheqsv2zXKTQ: posts small blind $0.25
KMc4R+K9ao4Ur3rF7NGe6Q: posts big blind $0.50
*** HOLE CARDS ***
Ag6DvxX4vbRheqsv2zXKTQ: raises $1 to $1.50
KMc4R+K9ao4Ur3rF7NGe6Q: calls $1
*** FLOP *** [Ad 3c 9c]
KMc4R+K9ao4Ur3rF7NGe6Q: bets $1
Ag6DvxX4vbRheqsv2zXKTQ: calls $1
*** TURN *** [Ad 3c 9c] [5c]
KMc4R+K9ao4Ur3rF7NGe6Q: checks
Ag6DvxX4vbRheqsv2zXKTQ: checks
*** RIVER *** [Ad 3c 9c 5c] [2s]
KMc4R+K9ao4Ur3rF7NGe6Q: bets $3
Ag6DvxX4vbRheqsv2zXKTQ: folds
KMc4R+K9ao4Ur3rF7NGe6Q collected $4.80 from pot
KMc4R+K9ao4Ur3rF7NGe6Q: doesn't show hand
*** SUMMARY ***
Total pot $5 | Rake $0.20
Board [Ad 3c 9c 5c 2s]
Seat 1: Ag6DvxX4vbRheqsv2zXKTQ (button) (small blind) folded on the River
Seat 2: KMc4R+K9ao4Ur3rF7NGe6Q (big blind) collected ($4.80)



PokerStars Game #59939653628:  Hold'em No Limit ($0.25/$0.50) - 2009/07/01 0:45:26 ET
Table 'IeNZOZQ4T6oiaHqFeo6yIA' 2-max Seat #2 is the button
Seat 1: ndd1nfncBkWNitBnsfCoVQ ($56.65 in chips)
Seat 2: A91IUl5JaZROhtfCtnnwYw ($115.85 in chips)
A91IUl5JaZROhtfCtnnwYw: posts small blind $0.25
ndd1nfncBkWNitBnsfCoVQ: posts big blind $0.50
*** HOLE CARDS ***
A91IUl5JaZROhtfCtnnwYw: calls $0.25
ndd1nfncBkWNitBnsfCoVQ: checks
*** FLOP *** [2c 7s 8d]
ndd1nfncBkWNitBnsfCoVQ: checks
A91IUl5JaZROhtfCtnnwYw: bets $1
ndd1nfncBkWNitBnsfCoVQ: calls $1
*** TURN *** [2c 7s 8d] [6s]
ndd1nfncBkWNitBnsfCoVQ: bets $2
A91IUl5JaZROhtfCtnnwYw: raises $2 to $4
ndd1nfncBkWNitBnsfCoVQ: calls $2
*** RIVER *** [2c 7s 8d 6s] [4h]
ndd1nfncBkWNitBnsfCoVQ: checks
A91IUl5JaZROhtfCtnnwYw: bets $12
ndd1nfncBkWNitBnsfCoVQ: calls $12
*** SHOW DOWN ***
A91IUl5JaZROhtfCtnnwYw: shows [Kc 5d] (a straight, Four to Eight)
ndd1nfncBkWNitBnsfCoVQ: mucks hand
A91IUl5JaZROhtfCtnnwYw collected $34.50 from pot
*** SUMMARY ***
Total pot $35 | Rake $0.50
Board [2c 7s 8d 6s 4h]
Seat 1: ndd1nfncBkWNitBnsfCoVQ (big blind) mucked
Seat 2: A91IUl5JaZROhtfCtnnwYw (button) (small blind) showed [Kc 5d] and won ($34.50) with a straight, Four to Eight



PokerStars Game #59939654054:  Hold'em No Limit ($0.25/$0.50) - 2009/07/01 0:45:27 ET
Table '3FhG0gl3kMX3wBEEqj+wnQ' 9-max Seat #1 is the button
Seat 1: e0J9pdCNUDTCG031RnXqLA ($22.65 in chips)
Seat 2: 7cYQ+syUWjl38ty/ICOMhw ($47.35 in chips)
Seat 3: k1f0lS7tlMHCLGs0JT34Tg ($10 in chips)
Seat 4: bjvJtA9Hqscfznq66txaOQ ($10 in chips)
Seat 5: gsyXT42WLEcOS4DdEk2wlw ($28 in chips)
Seat 6: 997ViqAtWn1FPjJqcffwcA ($50 in chips)
Seat 7: mSD1pginDsyHG5PDfqzphw ($11.50 in chips)
Seat 8: j3K/Jujr7PY4ZM2RZvlH6A ($57.35 in chips)
Seat 9: L5e2lrPLQm1Pqx30IIZ/Fw ($10 in chips)
7cYQ+syUWjl38ty/ICOMhw: posts small blind $0.25
k1f0lS7tlMHCLGs0JT34Tg: posts big blind $0.50
*** HOLE CARDS ***
bjvJtA9Hqscfznq66txaOQ: folds
gsyXT42WLEcOS4DdEk2wlw: folds
997ViqAtWn1FPjJqcffwcA: folds
mSD1pginDsyHG5PDfqzphw: folds
j3K/Jujr7PY4ZM2RZvlH6A: folds
L5e2lrPLQm1Pqx30IIZ/Fw: folds
e0J9pdCNUDTCG031RnXqLA: raises $1.15 to $1.65
7cYQ+syUWjl38ty/ICOMhw: calls $1.40
k1f0lS7tlMHCLGs0JT34Tg: folds
*** FLOP *** [Ts 7s 2s]
7cYQ+syUWjl38ty/ICOMhw: bets $2
e0J9pdCNUDTCG031RnXqLA: raises $2 to $4
7cYQ+syUWjl38ty/ICOMhw: folds
e0J9pdCNUDTCG031RnXqLA collected $7.45 from pot
e0J9pdCNUDTCG031RnXqLA: shows [7h 7c] (three of a kind, Sevens)
*** SUMMARY ***
Total pot $7.80 | Rake $0.35
Board [Ts 7s 2s]
Seat 1: e0J9pdCNUDTCG031RnXqLA (button) collected ($7.45)
Seat 2: 7cYQ+syUWjl38ty/ICOMhw (small blind) folded on the Flop
Seat 3: k1f0lS7tlMHCLGs0JT34Tg (big blind) folded before Flop
Seat 4: bjvJtA9Hqscfznq66txaOQ folded before Flop (didn't bet)
Seat 5: gsyXT42WLEcOS4DdEk2wlw folded before Flop (didn't bet)
Seat 6: 997ViqAtWn1FPjJqcffwcA folded before Flop (didn't bet)
Seat 7: mSD1pginDsyHG5PDfqzphw folded before Flop (didn't bet)
Seat 8: j3K/Jujr7PY4ZM2RZvlH6A folded before Flop (didn't bet)
Seat 9: L5e2lrPLQm1Pqx30IIZ/Fw folded before Flop (didn't bet)



PokerStars Game #59939654894:  Hold'em No Limit ($0.25/$0.50) - 2009/07/01 0:45:28 ET
Table 'T/PgNWqVyY6lkldcBVXYJQ' 6-max Seat #5 is the button
Seat 1: +Pf9jTVizYlIo+woPvptfA ($55.75 in chips)
Seat 2: LvH4G7n+QSjT6NDaD3cREA ($75.75 in chips)
Seat 3: L3OcNO1bgdqDI46j67KQPQ ($50.75 in chips)
Seat 4: Ek4w9XqBXqK5jBUQeLedGw ($50 in chips)
Seat 5: vVQBckETtigfb5mAcyK0OA ($54.95 in chips)
Seat 6: cDzbog6kwmJp+LBeBq+iMQ ($27.90 in chips)
cDzbog6kwmJp+LBeBq+iMQ: posts small blind $0.25
+Pf9jTVizYlIo+woPvptfA: posts big blind $0.50
*** HOLE CARDS ***
LvH4G7n+QSjT6NDaD3cREA: folds
L3OcNO1bgdqDI46j67KQPQ: folds
Ek4w9XqBXqK5jBUQeLedGw: folds
vVQBckETtigfb5mAcyK0OA: calls $0.50
cDzbog6kwmJp+LBeBq+iMQ: folds
+Pf9jTVizYlIo+woPvptfA: raises $2 to $2.50
vVQBckETtigfb5mAcyK0OA: folds
+Pf9jTVizYlIo+woPvptfA collected $1.25 from pot
+Pf9jTVizYlIo+woPvptfA: doesn't show hand
*** SUMMARY ***
Total pot $1.25 | Rake $0
Seat 1: +Pf9jTVizYlIo+woPvptfA (big blind) collected ($1.25)
Seat 2: LvH4G7n+QSjT6NDaD3cREA folded before Flop (didn't bet)
Seat 3: L3OcNO1bgdqDI46j67KQPQ folded before Flop (didn't bet)
Seat 4: Ek4w9XqBXqK5jBUQeLedGw folded before Flop (didn't bet)
Seat 5: vVQBckETtigfb5mAcyK0OA (button) folded before Flop
Seat 6: cDzbog6kwmJp+LBeBq+iMQ (small blind) folded before Flop



PokerStars Game #59939655500:  Hold'em No Limit ($0.25/$0.50) - 2009/07/01 0:45:29 ET
Table 'BCN5su+SsXiy1zRMJi0SJw' 6-max Seat #4 is the button
Seat 1: crjGpJEzSZgD38FoE3VMGg ($50 in chips)
Seat 2: oU2kDCkT/gilYbHWrg7D8w ($6.65 in chips)
Seat 3: g+vwI6lMKpU2uteXSjOzVw ($25.45 in chips)
Seat 4: JY9CtoZTeav+mhWyxSSyJQ ($26.15 in chips)
Seat 5: IBNygaT1aa9Z1uPdJJilwA ($63.75 in chips)
Seat 6: b2symlOdL7+0c9Pj4N/KlA ($52.85 in chips)
IBNygaT1aa9Z1uPdJJilwA: posts small blind $0.25
b2symlOdL7+0c9Pj4N/KlA: posts big blind $0.50
*** HOLE CARDS ***
crjGpJEzSZgD38FoE3VMGg: folds
oU2kDCkT/gilYbHWrg7D8w: folds
g+vwI6lMKpU2uteXSjOzVw: calls $0.50
JY9CtoZTeav+mhWyxSSyJQ: folds
IBNygaT1aa9Z1uPdJJilwA: calls $0.25
b2symlOdL7+0c9Pj4N/KlA: checks
*** FLOP *** [4s 2d 5d]
IBNygaT1aa9Z1uPdJJilwA: checks
b2symlOdL7+0c9Pj4N/KlA: bets $1
g+vwI6lMKpU2uteXSjOzVw: calls $1
IBNygaT1aa9Z1uPdJJilwA: calls $1
*** TURN *** [4s 2d 5d] [3s]
IBNygaT1aa9Z1uPdJJilwA: checks
b2symlOdL7+0c9Pj4N/KlA: checks
g+vwI6lMKpU2uteXSjOzVw: bets $2
IBNygaT1aa9Z1uPdJJilwA: raises $4.50 to $6.50
b2symlOdL7+0c9Pj4N/KlA: folds
g+vwI6lMKpU2uteXSjOzVw: folds
IBNygaT1aa9Z1uPdJJilwA collected $8.10 from pot
*** SUMMARY ***
Total pot $8.50 | Rake $0.40
Board [4s 2d 5d 3s]
Seat 1: crjGpJEzSZgD38FoE3VMGg folded before Flop (didn't bet)
Seat 2: oU2kDCkT/gilYbHWrg7D8w folded before Flop (didn't bet)
Seat 3: g+vwI6lMKpU2uteXSjOzVw folded on the Turn
Seat 4: JY9CtoZTeav+mhWyxSSyJQ (button) folded before Flop (didn't bet)
Seat 5: IBNygaT1aa9Z1uPdJJilwA (small blind) collected ($8.10)
Seat 6: b2symlOdL7+0c9Pj4N/KlA (big blind) folded on the Turn



PokerStars Game #59939656824:  Hold'em No Limit ($0.25/$0.50) - 2009/07/01 0:45:31 ET
Table 'GfL/No5u5PoEnU39lP5pQg' 6-max Seat #3 is the button
Seat 1: 1WUCqNG+p+vfWRTXNu4ljw ($62.95 in chips)
Seat 2: uVwggSetzp7d+eVgowO3vg ($67.70 in chips)
Seat 3: Ek4w9XqBXqK5jBUQeLedGw ($50 in chips)
Seat 5: M1KyQQvVPVuxqTAB8sR/zQ ($50.25 in chips)
M1KyQQvVPVuxqTAB8sR/zQ: posts small blind $0.25
1WUCqNG+p+vfWRTXNu4ljw: posts big blind $0.50
*** HOLE CARDS ***
uVwggSetzp7d+eVgowO3vg: calls $0.50
Ek4w9XqBXqK5jBUQeLedGw: folds
M1KyQQvVPVuxqTAB8sR/zQ: calls $0.25
1WUCqNG+p+vfWRTXNu4ljw: checks
*** FLOP *** [Qc Ac Th]
M1KyQQvVPVuxqTAB8sR/zQ: checks
1WUCqNG+p+vfWRTXNu4ljw: checks
uVwggSetzp7d+eVgowO3vg: checks
*** TURN *** [Qc Ac Th] [4c]
M1KyQQvVPVuxqTAB8sR/zQ: checks
1WUCqNG+p+vfWRTXNu4ljw: checks
uVwggSetzp7d+eVgowO3vg: checks
*** RIVER *** [Qc Ac Th 4c] [9d]
M1KyQQvVPVuxqTAB8sR/zQ: bets $0.75
1WUCqNG+p+vfWRTXNu4ljw: folds
uVwggSetzp7d+eVgowO3vg: folds
M1KyQQvVPVuxqTAB8sR/zQ collected $1.45 from pot
M1KyQQvVPVuxqTAB8sR/zQ: doesn't show hand
*** SUMMARY ***
Total pot $1.50 | Rake $0.05
Board [Qc Ac Th 4c 9d]
Seat 1: 1WUCqNG+p+vfWRTXNu4ljw (big blind) folded on the River
Seat 2: uVwggSetzp7d+eVgowO3vg folded on the River
Seat 3: Ek4w9XqBXqK5jBUQeLedGw (button) folded before Flop (didn't bet)
Seat 5: M1KyQQvVPVuxqTAB8sR/zQ (small blind) collected ($1.45)



PokerStars Game #59939658004:  Hold'em No Limit ($0.25/$0.50) - 2009/07/01 0:45:33 ET
Table 'MJxeZCzYELxiIsyUZyT0jw' 6-max Seat #1 is the button
Seat 1: jNIq+EZLEm61oWSMYUVeWQ ($3.35 in chips)
Seat 3: JQZew0FjzS19kTjeNtrE+A ($60 in chips)
Seat 4: alGiiQP/wwtYnfuXII+sgw ($45.95 in chips)
Seat 5: 3jvoOXNtXE90w2BdfNZwZQ ($51.25 in chips)
Seat 6: TTx3CHxyi0SObcHyMJRp5w ($57.45 in chips)
JQZew0FjzS19kTjeNtrE+A: posts small blind $0.25
alGiiQP/wwtYnfuXII+sgw: posts big blind $0.50
*** HOLE CARDS ***
3jvoOXNtXE90w2BdfNZwZQ: raises $1.50 to $2
TTx3CHxyi0SObcHyMJRp5w: folds
jNIq+EZLEm61oWSMYUVeWQ: folds
JQZew0FjzS19kTjeNtrE+A: folds
alGiiQP/wwtYnfuXII+sgw: folds
3jvoOXNtXE90w2BdfNZwZQ collected $1.25 from pot
3jvoOXNtXE90w2BdfNZwZQ: doesn't show hand
*** SUMMARY ***
Total pot $1.25 | Rake $0
Seat 1: jNIq+EZLEm61oWSMYUVeWQ (button) folded before Flop (didn't bet)
Seat 3: JQZew0FjzS19kTjeNtrE+A (small blind) folded before Flop
Seat 4: alGiiQP/wwtYnfuXII+sgw (big blind) folded before Flop
Seat 5: 3jvoOXNtXE90w2BdfNZwZQ collected ($1.25)
Seat 6: TTx3CHxyi0SObcHyMJRp5w folded before Flop (didn't bet)



PokerStars Game #59939658010:  Hold'em No Limit ($0.25/$0.50) - 2009/07/01 0:45:33 ET
Table '+dXkOAQyS8j9PQZusUTMpg' 2-max Seat #1 is the button
Seat 1: XFa6sBGjP2gxoIvxR3fZIg ($48.20 in chips)
Seat 2: 5IBeOgaApY1Bvzv2P8X4EA ($155.40 in chips)
XFa6sBGjP2gxoIvxR3fZIg: posts small blind $0.25
5IBeOgaApY1Bvzv2P8X4EA: posts big blind $0.50
*** HOLE CARDS ***
XFa6sBGjP2gxoIvxR3fZIg: raises $1 to $1.50
5IBeOgaApY1Bvzv2P8X4EA: folds
XFa6sBGjP2gxoIvxR3fZIg collected $1 from pot
*** SUMMARY ***
Total pot $1 | Rake $0
Seat 1: XFa6sBGjP2gxoIvxR3fZIg (button) (small blind) collected ($1)
Seat 2: 5IBeOgaApY1Bvzv2P8X4EA (big blind) folded before Flop



PokerStars Game #59939661296:  Hold'em No Limit ($0.25/$0.50) - 2009/07/01 0:45:38 ET
Table 'NCiXr0d5CEKBQr/cZgLhbA' 9-max Seat #8 is the button
Seat 1: pFtzb1sR4b0d1aw6aIRgDg ($50 in chips)
Seat 2: ulxuJchBV9iguXg0FUonfg ($50.50 in chips)
Seat 3: xZCXQSXlrZkp3pZizzVXCw ($50.75 in chips)
Seat 4: 5k9fvXD9suIgCxU4HLQjTw ($56.70 in chips)
Seat 5: zE9cVigS2nW/Ljy4K4bUQA ($36.70 in chips)
Seat 6: SKnJuWHScqetA/qG5p+wCg ($33.95 in chips)
Seat 7: M+7+BTmX5vZatHVuoRB1nA ($47.60 in chips)
Seat 8: 1MJUKc3cc0QmUoz1JZLR2w ($54.25 in chips)
Seat 9: 4WLZvqBn5qv5tds5kt5A1Q ($46.05 in chips)
4WLZvqBn5qv5tds5kt5A1Q: posts small blind $0.25
pFtzb1sR4b0d1aw6aIRgDg: posts big blind $0.50
*** HOLE CARDS ***
ulxuJchBV9iguXg0FUonfg: folds
xZCXQSXlrZkp3pZizzVXCw: folds
5k9fvXD9suIgCxU4HLQjTw: folds
zE9cVigS2nW/Ljy4K4bUQA: folds
SKnJuWHScqetA/qG5p+wCg: calls $0.50
M+7+BTmX5vZatHVuoRB1nA: folds
1MJUKc3cc0QmUoz1JZLR2w: raises $2 to $2.50
4WLZvqBn5qv5tds5kt5A1Q: folds
pFtzb1sR4b0d1aw6aIRgDg: calls $2
SKnJuWHScqetA/qG5p+wCg: folds
*** FLOP *** [9c 9s 8d]
pFtzb1sR4b0d1aw6aIRgDg: checks
1MJUKc3cc0QmUoz1JZLR2w: checks
*** TURN *** [9c 9s 8d] [Kd]
pFtzb1sR4b0d1aw6aIRgDg: checks
1MJUKc3cc0QmUoz1JZLR2w: checks
*** RIVER *** [9c 9s 8d Kd] [Qh]
pFtzb1sR4b0d1aw6aIRgDg: checks
1MJUKc3cc0QmUoz1JZLR2w: bets $2
pFtzb1sR4b0d1aw6aIRgDg: folds
1MJUKc3cc0QmUoz1JZLR2w collected $5.50 from pot
*** SUMMARY ***
Total pot $5.75 | Rake $0.25
Board [9c 9s 8d Kd Qh]
Seat 1: pFtzb1sR4b0d1aw6aIRgDg (big blind) folded on the River
Seat 2: ulxuJchBV9iguXg0FUonfg folded before Flop (didn't bet)
Seat 3: xZCXQSXlrZkp3pZizzVXCw folded before Flop (didn't bet)
Seat 4: 5k9fvXD9suIgCxU4HLQjTw folded before Flop (didn't bet)
Seat 5: zE9cVigS2nW/Ljy4K4bUQA folded before Flop (didn't bet)
Seat 6: SKnJuWHScqetA/qG5p+wCg folded before Flop
Seat 7: M+7+BTmX5vZatHVuoRB1nA folded before Flop (didn't bet)
Seat 8: 1MJUKc3cc0QmUoz1JZLR2w (button) collected ($5.50)
Seat 9: 4WLZvqBn5qv5tds5kt5A1Q (small blind) folded before Flop



PokerStars Game #59939662406:  Hold'em No Limit ($0.25/$0.50) - 2009/07/01 0:45:40 ET
Table 'Vdlc9wqYcHTUhtdyN7CuJw' 2-max Seat #2 is the button
Seat 1: yBO+mXB6m/rCft2ErwGf/Q ($115.60 in chips)
Seat 2: NZ/5cxwnorKW2SNsWy1+8A ($10.25 in chips)
NZ/5cxwnorKW2SNsWy1+8A: posts small blind $0.25
yBO+mXB6m/rCft2ErwGf/Q: posts big blind $0.50
*** HOLE CARDS ***
NZ/5cxwnorKW2SNsWy1+8A: calls $0.25
yBO+mXB6m/rCft2ErwGf/Q: checks
*** FLOP *** [4h Kd 3d]
yBO+mXB6m/rCft2ErwGf/Q: checks
NZ/5cxwnorKW2SNsWy1+8A: bets $0.50
yBO+mXB6m/rCft2ErwGf/Q: calls $0.50
*** TURN *** [4h Kd 3d] [8s]
yBO+mXB6m/rCft2ErwGf/Q: checks
NZ/5cxwnorKW2SNsWy1+8A: checks
*** RIVER *** [4h Kd 3d 8s] [5c]
yBO+mXB6m/rCft2ErwGf/Q: checks
NZ/5cxwnorKW2SNsWy1+8A: checks
*** SHOW DOWN ***
yBO+mXB6m/rCft2ErwGf/Q: shows [3c 2c] (a pair of Threes)
NZ/5cxwnorKW2SNsWy1+8A: mucks hand
yBO+mXB6m/rCft2ErwGf/Q collected $1.95 from pot
*** SUMMARY ***
Total pot $2 | Rake $0.05
Board [4h Kd 3d 8s 5c]
Seat 1: yBO+mXB6m/rCft2ErwGf/Q (big blind) showed [3c 2c] and won ($1.95) with a pair of Threes
Seat 2: NZ/5cxwnorKW2SNsWy1+8A (button) (small blind) mucked



PokerStars Game #59939662320:  Hold'em No Limit ($0.25/$0.50) - 2009/07/01 0:45:40 ET
Table '37qXEp3oe+er5q4CZip9eQ' 6-max Seat #1 is the button
Seat 1: oqOqoO2AyCZenUghCxMDxw ($57.65 in chips)
Seat 2: 6wzJiRvp8HY6t+MQGnSIzA ($19.80 in chips)
Seat 3: Rt6KgtZ8YaJoTc3FPim00w ($73.75 in chips)
Seat 4: XsmE8nXMAAMFJbWaJTmHFw ($28.95 in chips)
Seat 5: VOmI0x4dDPnTESZd5B4d1Q ($45.90 in chips)
Seat 6: N50kln4negd8q7Mmoz1j4g ($29.50 in chips)
6wzJiRvp8HY6t+MQGnSIzA: posts small blind $0.25
Rt6KgtZ8YaJoTc3FPim00w: posts big blind $0.50
*** HOLE CARDS ***
XsmE8nXMAAMFJbWaJTmHFw: folds
VOmI0x4dDPnTESZd5B4d1Q: folds
N50kln4negd8q7Mmoz1j4g: raises $1.50 to $2
oqOqoO2AyCZenUghCxMDxw: folds
6wzJiRvp8HY6t+MQGnSIzA: folds
Rt6KgtZ8YaJoTc3FPim00w: calls $1.50
*** FLOP *** [5h 2d Qc]
Rt6KgtZ8YaJoTc3FPim00w: checks
N50kln4negd8q7Mmoz1j4g: bets $2.50
Rt6KgtZ8YaJoTc3FPim00w: calls $2.50
*** TURN *** [5h 2d Qc] [As]
Rt6KgtZ8YaJoTc3FPim00w: checks
N50kln4negd8q7Mmoz1j4g: checks
*** RIVER *** [5h 2d Qc As] [7h]
Rt6KgtZ8YaJoTc3FPim00w: bets $12
N50kln4negd8q7Mmoz1j4g: raises $12 to $24
Rt6KgtZ8YaJoTc3FPim00w: raises $45.25 to $69.25 and is all-in
N50kln4negd8q7Mmoz1j4g: calls $1 and is all-in
*** SHOW DOWN ***
Rt6KgtZ8YaJoTc3FPim00w: shows [7c 7d] (three of a kind, Sevens)
N50kln4negd8q7Mmoz1j4g: mucks hand
Rt6KgtZ8YaJoTc3FPim00w collected $56.35 from pot
*** SUMMARY ***
Total pot $59.25 | Rake $2.90
Board [5h 2d Qc As 7h]
Seat 1: oqOqoO2AyCZenUghCxMDxw (button) folded before Flop (didn't bet)
Seat 2: 6wzJiRvp8HY6t+MQGnSIzA (small blind) folded before Flop
Seat 3: Rt6KgtZ8YaJoTc3FPim00w (big blind) showed [7c 7d] and won ($56.35) with three of a kind, Sevens
Seat 4: XsmE8nXMAAMFJbWaJTmHFw folded before Flop (didn't bet)
Seat 5: VOmI0x4dDPnTESZd5B4d1Q folded before Flop (didn't bet)
Seat 6: N50kln4negd8q7Mmoz1j4g mucked



PokerStars Game #59939662298:  Hold'em No Limit ($0.25/$0.50) - 2009/07/01 0:45:40 ET
Table 'fx6MqwfYAj/Rt86hBz2L3Q' 9-max Seat #3 is the button
Seat 1: SegjDnMxWMujiD57ESNL+g ($10 in chips)
Seat 2: C3rGXblctNcWI6JYPHhaEg ($10 in chips)
Seat 3: iadBi5AEt7gTBXbDSSnMYQ ($48.95 in chips)
Seat 4: gPEN9Zp33YTm/mu9/SYP1w ($23.55 in chips)
Seat 5: iAISe3dVeua8PUn2wwgDHw ($24.10 in chips)
Seat 6: 5k9fvXD9suIgCxU4HLQjTw ($50 in chips)
Seat 8: NnQCepdIR/AOUQn1yhYx6Q ($14.05 in chips)
Seat 9: HZkVla4kK2SI42CVrPZ/ig ($8.25 in chips)
gPEN9Zp33YTm/mu9/SYP1w: posts small blind $0.25
iAISe3dVeua8PUn2wwgDHw: posts big blind $0.50
SKnJuWHScqetA/qG5p+wCg: sits out
*** HOLE CARDS ***
5k9fvXD9suIgCxU4HLQjTw: raises $1 to $1.50
NnQCepdIR/AOUQn1yhYx6Q: folds
HZkVla4kK2SI42CVrPZ/ig: calls $1.50
SegjDnMxWMujiD57ESNL+g: folds
C3rGXblctNcWI6JYPHhaEg: calls $1.50
iadBi5AEt7gTBXbDSSnMYQ: folds
gPEN9Zp33YTm/mu9/SYP1w: folds
iAISe3dVeua8PUn2wwgDHw: folds
*** FLOP *** [2h 4d 7h]
5k9fvXD9suIgCxU4HLQjTw: checks
HZkVla4kK2SI42CVrPZ/ig: checks
C3rGXblctNcWI6JYPHhaEg: checks
*** TURN *** [2h 4d 7h] [Qc]
5k9fvXD9suIgCxU4HLQjTw: checks
HZkVla4kK2SI42CVrPZ/ig: bets $2.50
C3rGXblctNcWI6JYPHhaEg: folds
5k9fvXD9suIgCxU4HLQjTw: folds
HZkVla4kK2SI42CVrPZ/ig collected $5 from pot
HZkVla4kK2SI42CVrPZ/ig: doesn't show hand
*** SUMMARY ***
Total pot $5.25 | Rake $0.25
Board [2h 4d 7h Qc]
Seat 1: SegjDnMxWMujiD57ESNL+g folded before Flop (didn't bet)
Seat 2: C3rGXblctNcWI6JYPHhaEg folded on the Turn
Seat 3: iadBi5AEt7gTBXbDSSnMYQ (button) folded before Flop (didn't bet)
Seat 4: gPEN9Zp33YTm/mu9/SYP1w (small blind) folded before Flop
Seat 5: iAISe3dVeua8PUn2wwgDHw (big blind) folded before Flop
Seat 6: 5k9fvXD9suIgCxU4HLQjTw folded on the Turn
Seat 8: NnQCepdIR/AOUQn1yhYx6Q folded before Flop (didn't bet)
Seat 9: HZkVla4kK2SI42CVrPZ/ig collected ($5)



PokerStars Game #59939663238:  Hold'em No Limit ($0.25/$0.50) - 2009/07/01 0:45:41 ET
Table 'QOgaEqMcJ73pcUMMxoisUg' 6-max Seat #5 is the button
Seat 1: /olYG0EzMWzADIgH1y2ySQ ($30 in chips)
Seat 2: 4QfsCWthT/vSLirorNXqtg ($50 in chips)
Seat 3: Rt6KgtZ8YaJoTc3FPim00w ($76.75 in chips)
Seat 4: zAcsDhG/T128Vn7XGVSgKg ($51.60 in chips)
Seat 5: 6vNxrjjCl6FwfaaymM9jjg ($14.75 in chips)
Seat 6: pmE+2KJb4nffAVqjLIXxFg ($22.70 in chips)
pmE+2KJb4nffAVqjLIXxFg: posts small blind $0.25
/olYG0EzMWzADIgH1y2ySQ: posts big blind $0.50
*** HOLE CARDS ***
4QfsCWthT/vSLirorNXqtg: folds
Rt6KgtZ8YaJoTc3FPim00w: folds
zAcsDhG/T128Vn7XGVSgKg: folds
6vNxrjjCl6FwfaaymM9jjg: raises $2 to $2.50
pmE+2KJb4nffAVqjLIXxFg: folds
/olYG0EzMWzADIgH1y2ySQ: calls $2
*** FLOP *** [Th 9c 7s]
/olYG0EzMWzADIgH1y2ySQ: checks
6vNxrjjCl6FwfaaymM9jjg: checks
*** TURN *** [Th 9c 7s] [Ks]
/olYG0EzMWzADIgH1y2ySQ: checks
6vNxrjjCl6FwfaaymM9jjg: bets $5.50
/olYG0EzMWzADIgH1y2ySQ: folds
6vNxrjjCl6FwfaaymM9jjg collected $5 from pot
*** SUMMARY ***
Total pot $5.25 | Rake $0.25
Board [Th 9c 7s Ks]
Seat 1: /olYG0EzMWzADIgH1y2ySQ (big blind) folded on the Turn
Seat 2: 4QfsCWthT/vSLirorNXqtg folded before Flop (didn't bet)
Seat 3: Rt6KgtZ8YaJoTc3FPim00w folded before Flop (didn't bet)
Seat 4: zAcsDhG/T128Vn7XGVSgKg folded before Flop (didn't bet)
Seat 5: 6vNxrjjCl6FwfaaymM9jjg (button) collected ($5)
Seat 6: pmE+2KJb4nffAVqjLIXxFg (small blind) folded before Flop



PokerStars Game #59939663190:  Hold'em No Limit ($0.25/$0.50) - 2009/07/01 0:45:41 ET
Table '+dXkOAQyS8j9PQZusUTMpg' 2-max Seat #2 is the button
Seat 1: XFa6sBGjP2gxoIvxR3fZIg ($48.70 in chips)
Seat 2: 5IBeOgaApY1Bvzv2P8X4EA ($154.90 in chips)
5IBeOgaApY1Bvzv2P8X4EA: posts small blind $0.25
XFa6sBGjP2gxoIvxR3fZIg: posts big blind $0.50
*** HOLE CARDS ***
5IBeOgaApY1Bvzv2P8X4EA: folds
XFa6sBGjP2gxoIvxR3fZIg collected $0.50 from pot
*** SUMMARY ***
Total pot $0.50 | Rake $0
Seat 1: XFa6sBGjP2gxoIvxR3fZIg (big blind) collected ($0.50)
Seat 2: 5IBeOgaApY1Bvzv2P8X4EA (button) (small blind) folded before Flop



PokerStars Game #59939664244:  Hold'em No Limit ($0.25/$0.50) - 2009/07/01 0:45:43 ET
Table 'QOeVnLhwctF9UyV/beDi+A' 2-max Seat #2 is the button
Seat 1: bypIyrYcAAifLfhZpGlKLA ($64.90 in chips)
Seat 2: Ucrm3XtZmoONapW32SPhag ($18.15 in chips)
Ucrm3XtZmoONapW32SPhag: posts small blind $0.25
bypIyrYcAAifLfhZpGlKLA: posts big blind $0.50
*** HOLE CARDS ***
Ucrm3XtZmoONapW32SPhag: calls $0.25
bypIyrYcAAifLfhZpGlKLA: checks
*** FLOP *** [4h 2c As]
bypIyrYcAAifLfhZpGlKLA: bets $0.50
Ucrm3XtZmoONapW32SPhag: calls $0.50
*** TURN *** [4h 2c As] [9s]
bypIyrYcAAifLfhZpGlKLA: checks
Ucrm3XtZmoONapW32SPhag: bets $1
bypIyrYcAAifLfhZpGlKLA: calls $1
*** RIVER *** [4h 2c As 9s] [Jc]
bypIyrYcAAifLfhZpGlKLA: bets $4
Ucrm3XtZmoONapW32SPhag: folds
bypIyrYcAAifLfhZpGlKLA collected $3.85 from pot
bypIyrYcAAifLfhZpGlKLA: doesn't show hand
*** SUMMARY ***
Total pot $4 | Rake $0.15
Board [4h 2c As 9s Jc]
Seat 1: bypIyrYcAAifLfhZpGlKLA (big blind) collected ($3.85)
Seat 2: Ucrm3XtZmoONapW32SPhag (button) (small blind) folded on the River



PokerStars Game #59939665548:  Hold'em No Limit ($0.25/$0.50) - 2009/07/01 0:45:45 ET
Table '0eJtgVAXVvBgncFdcUpXcQ' 2-max Seat #2 is the button
Seat 1: Ag6DvxX4vbRheqsv2zXKTQ ($16.20 in chips)
Seat 2: KMc4R+K9ao4Ur3rF7NGe6Q ($13.45 in chips)
KMc4R+K9ao4Ur3rF7NGe6Q: posts small blind $0.25
Ag6DvxX4vbRheqsv2zXKTQ: posts big blind $0.50
*** HOLE CARDS ***
KMc4R+K9ao4Ur3rF7NGe6Q: calls $0.25
Ag6DvxX4vbRheqsv2zXKTQ: raises $1.50 to $2
KMc4R+K9ao4Ur3rF7NGe6Q: calls $1.50
*** FLOP *** [Jc Kd 4s]
Ag6DvxX4vbRheqsv2zXKTQ: checks
KMc4R+K9ao4Ur3rF7NGe6Q: bets $1
Ag6DvxX4vbRheqsv2zXKTQ: calls $1
*** TURN *** [Jc Kd 4s] [Ts]
Ag6DvxX4vbRheqsv2zXKTQ: checks
KMc4R+K9ao4Ur3rF7NGe6Q: checks
*** RIVER *** [Jc Kd 4s Ts] [9c]
Ag6DvxX4vbRheqsv2zXKTQ: checks
KMc4R+K9ao4Ur3rF7NGe6Q: checks
*** SHOW DOWN ***
Ag6DvxX4vbRheqsv2zXKTQ: shows [Ac 8d] (high card Ace)
KMc4R+K9ao4Ur3rF7NGe6Q: shows [Jd 8c] (a pair of Jacks)
KMc4R+K9ao4Ur3rF7NGe6Q collected $5.75 from pot
*** SUMMARY ***
Total pot $6 | Rake $0.25
Board [Jc Kd 4s Ts 9c]
Seat 1: Ag6DvxX4vbRheqsv2zXKTQ (big blind) showed [Ac 8d] and lost with high card Ace
Seat 2: KMc4R+K9ao4Ur3rF7NGe6Q (button) (small blind) showed [Jd 8c] and won ($5.75) with a pair of Jacks



PokerStars Game #59939666026:  Hold'em No Limit ($0.25/$0.50) - 2009/07/01 0:45:46 ET
Table 'QOgaEqMcJ73pcUMMxoisUgErOuyGLI5PT3G5MnpHgC/g Seat #9 is the button
Seat 3: xZCXQSXlrZkp3pZizzVXCw ($50 in chips)
Seat 4: 3UmXLy3GfjC3EkOebduerQ ($50 in chips)
Seat 5: JwvquocWfhTVApN5t47LgA ($60.10 in chips)
Seat 6: zE9cVigS2nW/Ljy4K4bUQA ($30.75 in chips)
Seat 7: 90Wb75h3W1BRpbqVnuk8gw ($60.95 in chips)
Seat 8: g4k0NXISyLCqaSWZDBjfEg ($50 in chips)
Seat 9: J0W5D97jl5VLky+IoPvDeA ($57.15 in chips)
xZCXQSXlrZkp3pZizzVXCw: posts small blind $0.25
3UmXLy3GfjC3EkOebduerQ: posts big blind $0.50
*** HOLE CARDS ***
JwvquocWfhTVApN5t47LgA: raises $2.50 to $3
zE9cVigS2nW/Ljy4K4bUQA: folds
90Wb75h3W1BRpbqVnuk8gw: folds
g4k0NXISyLCqaSWZDBjfEg: folds
J0W5D97jl5VLky+IoPvDeA: folds
xZCXQSXlrZkp3pZizzVXCw: folds
3UmXLy3GfjC3EkOebduerQ: folds
JwvquocWfhTVApN5t47LgA collected $1.25 from pot
*** SUMMARY ***
Total pot $1.25 | Rake $0
Seat 3: xZCXQSXlrZkp3pZizzVXCw (small blind) folded before Flop
Seat 4: 3UmXLy3GfjC3EkOebduerQ (big blind) folded before Flop
Seat 5: JwvquocWfhTVApN5t47LgA collected ($1.25)
Seat 6: zE9cVigS2nW/Ljy4K4bUQA folded before Flop (didn't bet)
Seat 7: 90Wb75h3W1BRpbqVnuk8gw folded before Flop (didn't bet)
Seat 8: g4k0NXISyLCqaSWZDBjfEg folded before Flop (didn't bet)
Seat 9: J0W5D97jl5VLky+IoPvDeA (button) folded before Flop (didn't bet)



PokerStars Game #59939666448:  Hold'em No Limit ($0.25/$0.50) - 2009/07/01 0:45:47 ET
Table 'E7bWJ45aoFXRpyRv2gw+Ig' 2-max Seat #1 is the button
Seat 1: FRkiRasEGlHUeLrEl+k/nA ($70.65 in chips)
Seat 2: 3Wro85I7472vJ4Wkpneo9A ($124.85 in chips)
FRkiRasEGlHUeLrEl+k/nA: posts small blind $0.25
3Wro85I7472vJ4Wkpneo9A: posts big blind $0.50
*** HOLE CARDS ***
FRkiRasEGlHUeLrEl+k/nA: raises $1 to $1.50
3Wro85I7472vJ4Wkpneo9A: raises $3.50 to $5
FRkiRasEGlHUeLrEl+k/nA: calls $3.50
*** FLOP *** [3h Js 3s]
3Wro85I7472vJ4Wkpneo9A: bets $7
FRkiRasEGlHUeLrEl+k/nA: calls $7
*** TURN *** [3h Js 3s] [4h]
3Wro85I7472vJ4Wkpneo9A: checks
FRkiRasEGlHUeLrEl+k/nA: bets $14
3Wro85I7472vJ4Wkpneo9A: calls $14
*** RIVER *** [3h Js 3s 4h] [Qc]
3Wro85I7472vJ4Wkpneo9A: checks
FRkiRasEGlHUeLrEl+k/nA: checks
*** SHOW DOWN ***
3Wro85I7472vJ4Wkpneo9A: shows [Tc Jc] (two pair, Jacks and Threes)
FRkiRasEGlHUeLrEl+k/nA: shows [9d Jd] (two pair, Jacks and Threes)
3Wro85I7472vJ4Wkpneo9A collected $25.75 from pot
FRkiRasEGlHUeLrEl+k/nA collected $25.75 from pot
*** SUMMARY ***
Total pot $52 | Rake $0.50
Board [3h Js 3s 4h Qc]
Seat 1: FRkiRasEGlHUeLrEl+k/nA (button) (small blind) showed [9d Jd] and won ($25.75) with two pair, Jacks and Threes
Seat 2: 3Wro85I7472vJ4Wkpneo9A (big blind) showed [Tc Jc] and won ($25.75) with two pair, Jacks and Threes



PokerStars Game #59939667432:  Hold'em No Limit ($0.25/$0.50) - 2009/07/01 0:45:48 ET
Table '+dXkOAQyS8j9PQZusUTMpg' 2-max Seat #1 is the button
Seat 1: XFa6sBGjP2gxoIvxR3fZIg ($48.95 in chips)
Seat 2: 5IBeOgaApY1Bvzv2P8X4EA ($154.65 in chips)
XFa6sBGjP2gxoIvxR3fZIg: posts small blind $0.25
5IBeOgaApY1Bvzv2P8X4EA: posts big blind $0.50
*** HOLE CARDS ***
XFa6sBGjP2gxoIvxR3fZIg: raises $1 to $1.50
5IBeOgaApY1Bvzv2P8X4EA said, "i get you"
5IBeOgaApY1Bvzv2P8X4EA said, ":D"
XFa6sBGjP2gxoIvxR3fZIg said, "I never bluff"
5IBeOgaApY1Bvzv2P8X4EA: folds
XFa6sBGjP2gxoIvxR3fZIg collected $1 from pot
5IBeOgaApY1Bvzv2P8X4EA said, "got"
*** SUMMARY ***
Total pot $1 | Rake $0
Seat 1: XFa6sBGjP2gxoIvxR3fZIg (button) (small blind) collected ($1)
Seat 2: 5IBeOgaApY1Bvzv2P8X4EA (big blind) folded before Flop



PokerStars Game #59939667922:  Hold'em No Limit ($0.25/$0.50) - 2009/07/01 0:45:49 ET
Table 'EiNh8p/wGJ1FP575iMFnqg' 9-max Seat #8 is the button
Seat 1: r3ZqM1Mi0W3y4hOdssE+Sg ($46.40 in chips)
Seat 2: 8ehL7qlZzjgUh2H35iiWLw ($53.35 in chips)
Seat 3: ymLPoEIl7UL3TvZYmnadxQ ($48.10 in chips)
Seat 4: cMzaiXAM/ZAdNaEUu+LqhA ($50 in chips)
Seat 5: M+7+BTmX5vZatHVuoRB1nA ($80.80 in chips)
Seat 6: 3UmXLy3GfjC3EkOebduerQ ($62.95 in chips)
Seat 7: 997ViqAtWn1FPjJqcffwcA ($50 in chips)
Seat 8: KrPAGRACBg+w0M//SXe8Ag ($11.90 in chips)
Seat 9: NnQCepdIR/AOUQn1yhYx6Q ($9.50 in chips)
NnQCepdIR/AOUQn1yhYx6Q: posts small blind $0.25
r3ZqM1Mi0W3y4hOdssE+Sg: posts big blind $0.50
*** HOLE CARDS ***
8ehL7qlZzjgUh2H35iiWLw: folds
ymLPoEIl7UL3TvZYmnadxQ: folds
cMzaiXAM/ZAdNaEUu+LqhA: folds
M+7+BTmX5vZatHVuoRB1nA: folds
3UmXLy3GfjC3EkOebduerQ: raises $1.50 to $2
997ViqAtWn1FPjJqcffwcA: folds
KrPAGRACBg+w0M//SXe8Ag: calls $2
NnQCepdIR/AOUQn1yhYx6Q: folds
r3ZqM1Mi0W3y4hOdssE+Sg: folds
*** FLOP *** [Ad 2s 4h]
3UmXLy3GfjC3EkOebduerQ: checks
KrPAGRACBg+w0M//SXe8Ag: bets $1.50
3UmXLy3GfjC3EkOebduerQ: calls $1.50
*** TURN *** [Ad 2s 4h] [Tc]
3UmXLy3GfjC3EkOebduerQ: checks
KrPAGRACBg+w0M//SXe8Ag: checks
*** RIVER *** [Ad 2s 4h Tc] [2h]
3UmXLy3GfjC3EkOebduerQ: checks
KrPAGRACBg+w0M//SXe8Ag: checks
*** SHOW DOWN ***
3UmXLy3GfjC3EkOebduerQ: shows [9s 9c] (two pair, Nines and Deuces)
KrPAGRACBg+w0M//SXe8Ag: mucks hand
3UmXLy3GfjC3EkOebduerQ collected $7.40 from pot
*** SUMMARY ***
Total pot $7.75 | Rake $0.35
Board [Ad 2s 4h Tc 2h]
Seat 1: r3ZqM1Mi0W3y4hOdssE+Sg (big blind) folded before Flop
Seat 2: 8ehL7qlZzjgUh2H35iiWLw folded before Flop (didn't bet)
Seat 3: ymLPoEIl7UL3TvZYmnadxQ folded before Flop (didn't bet)
Seat 4: cMzaiXAM/ZAdNaEUu+LqhA folded before Flop (didn't bet)
Seat 5: M+7+BTmX5vZatHVuoRB1nA folded before Flop (didn't bet)
Seat 6: 3UmXLy3GfjC3EkOebduerQ showed [9s 9c] and won ($7.40) with two pair, Nines and Deuces
Seat 7: 997ViqAtWn1FPjJqcffwcA folded before Flop (didn't bet)
Seat 8: KrPAGRACBg+w0M//SXe8Ag (button) mucked
Seat 9: NnQCepdIR/AOUQn1yhYx6Q (small blind) folded before Flop



PokerStars Game #59939668648:  Hold'em No Limit ($0.25/$0.50) - 2009/07/01 0:45:50 ET
Table 'eMxdLyFDf28E0wit6gm3Uw' 6-max Seat #4 is the button
Seat 1: GtdWeBVCZhDBcNFRTOb8Hg ($4.60 in chips)
Seat 3: dZcLsEI8iXkobBduRJ45Yw ($12.10 in chips)
Seat 4: 3jxEWvv2qK1HCXLj4khowQ ($40.50 in chips)
Seat 5: X0X97o2fDAPiGx6o1gahsw ($54.10 in chips)
Seat 6: nOfdMHEXflgT86UgFWblAA ($50 in chips)
X0X97o2fDAPiGx6o1gahsw: posts small blind $0.25
nOfdMHEXflgT86UgFWblAA: posts big blind $0.50
*** HOLE CARDS ***
GtdWeBVCZhDBcNFRTOb8Hg: calls $0.50
dZcLsEI8iXkobBduRJ45Yw: folds
3jxEWvv2qK1HCXLj4khowQ: folds
X0X97o2fDAPiGx6o1gahsw: calls $0.25
nOfdMHEXflgT86UgFWblAA: checks
*** FLOP *** [9d 7d 9c]
X0X97o2fDAPiGx6o1gahsw: bets $1
nOfdMHEXflgT86UgFWblAA: calls $1
GtdWeBVCZhDBcNFRTOb8Hg: folds
*** TURN *** [9d 7d 9c] [Js]
X0X97o2fDAPiGx6o1gahsw: bets $2.50
nOfdMHEXflgT86UgFWblAA: raises $4.50 to $7
X0X97o2fDAPiGx6o1gahsw: calls $4.50
*** RIVER *** [9d 7d 9c Js] [3d]
X0X97o2fDAPiGx6o1gahsw: checks
nOfdMHEXflgT86UgFWblAA: bets $7
X0X97o2fDAPiGx6o1gahsw: raises $8 to $15
nOfdMHEXflgT86UgFWblAA: calls $8
*** SHOW DOWN ***
X0X97o2fDAPiGx6o1gahsw: shows [3h 9h] (a full house, Nines full of Threes)
nOfdMHEXflgT86UgFWblAA: mucks hand
X0X97o2fDAPiGx6o1gahsw collected $45.50 from pot
*** SUMMARY ***
Total pot $47.50 | Rake $2
Board [9d 7d 9c Js 3d]
Seat 1: GtdWeBVCZhDBcNFRTOb8Hg folded on the Flop
Seat 3: dZcLsEI8iXkobBduRJ45Yw folded before Flop (didn't bet)
Seat 4: 3jxEWvv2qK1HCXLj4khowQ (button) folded before Flop (didn't bet)
Seat 5: X0X97o2fDAPiGx6o1gahsw (small blind) showed [3h 9h] and won ($45.50) with a full house, Nines full of Threes
Seat 6: nOfdMHEXflgT86UgFWblAA (big blind) mucked



PokerStars Game #59939669412:  Hold'em No Limit ($0.25/$0.50) - 2009/07/01 0:45:51 ET
Table 'X6IRCRTh+20gjz8aubWnwA' 9-max Seat #1 is the button
Seat 1: DSM67hHHq1XFoEOi9p8Alw ($50.05 in chips)
Seat 2: HZkVla4kK2SI42CVrPZ/ig ($11.05 in chips)
Seat 3: SWv01peOe69QQRvhQTqjQw ($16.90 in chips)
Seat 4: 2J+UVOVrW+V3maOylyxMcQ ($37.20 in chips)
Seat 5: NnQCepdIR/AOUQn1yhYx6Q ($10 in chips)
Seat 6: /6In1zC3WtgwxDcueWzZWg ($70.05 in chips)
Seat 7: cFHQjKQOOKTUzoilhrXHLg ($34.50 in chips)
Seat 8: HxeBVq06/3Bh/H986sgdbw ($7.95 in chips)
Seat 9: M+7+BTmX5vZatHVuoRB1nA ($68.50 in chips)
HZkVla4kK2SI42CVrPZ/ig: posts small blind $0.25
SWv01peOe69QQRvhQTqjQw: posts big blind $0.50
*** HOLE CARDS ***
2J+UVOVrW+V3maOylyxMcQ: calls $0.50
NnQCepdIR/AOUQn1yhYx6Q: folds
/6In1zC3WtgwxDcueWzZWg: folds
cFHQjKQOOKTUzoilhrXHLg: calls $0.50
HxeBVq06/3Bh/H986sgdbw: calls $0.50
M+7+BTmX5vZatHVuoRB1nA: folds
DSM67hHHq1XFoEOi9p8Alw: folds
HZkVla4kK2SI42CVrPZ/ig: calls $0.25
SWv01peOe69QQRvhQTqjQw: checks
*** FLOP *** [Jh 9s 2c]
HZkVla4kK2SI42CVrPZ/ig: checks
SWv01peOe69QQRvhQTqjQw: checks
2J+UVOVrW+V3maOylyxMcQ: checks
cFHQjKQOOKTUzoilhrXHLg: checks
HxeBVq06/3Bh/H986sgdbw: checks
*** TURN *** [Jh 9s 2c] [Jc]
HZkVla4kK2SI42CVrPZ/ig: checks
SWv01peOe69QQRvhQTqjQw: checks
2J+UVOVrW+V3maOylyxMcQ: checks
cFHQjKQOOKTUzoilhrXHLg: checks
HxeBVq06/3Bh/H986sgdbw: checks
*** RIVER *** [Jh 9s 2c Jc] [6s]
HZkVla4kK2SI42CVrPZ/ig: bets $1
SWv01peOe69QQRvhQTqjQw: calls $1
2J+UVOVrW+V3maOylyxMcQ: folds
cFHQjKQOOKTUzoilhrXHLg: raises $1 to $2
HxeBVq06/3Bh/H986sgdbw: folds
HZkVla4kK2SI42CVrPZ/ig: calls $1
SWv01peOe69QQRvhQTqjQw: calls $1
*** SHOW DOWN ***
cFHQjKQOOKTUzoilhrXHLg: shows [9c Js] (a full house, Jacks full of Nines)
HZkVla4kK2SI42CVrPZ/ig: mucks hand
SWv01peOe69QQRvhQTqjQw: mucks hand
cFHQjKQOOKTUzoilhrXHLg collected $8.10 from pot
*** SUMMARY ***
Total pot $8.50 | Rake $0.40
Board [Jh 9s 2c Jc 6s]
Seat 1: DSM67hHHq1XFoEOi9p8Alw (button) folded before Flop (didn't bet)
Seat 2: HZkVla4kK2SI42CVrPZ/ig (small blind) mucked
Seat 3: SWv01peOe69QQRvhQTqjQw (big blind) mucked
Seat 4: 2J+UVOVrW+V3maOylyxMcQ folded on the River
Seat 5: NnQCepdIR/AOUQn1yhYx6Q folded before Flop (didn't bet)
Seat 6: /6In1zC3WtgwxDcueWzZWg folded before Flop (didn't bet)
Seat 7: cFHQjKQOOKTUzoilhrXHLg showed [9c Js] and won ($8.10) with a full house, Jacks full of Nines
Seat 8: HxeBVq06/3Bh/H986sgdbw folded on the River
Seat 9: M+7+BTmX5vZatHVuoRB1nA folded before Flop (didn't bet)



PokerStars Game #59939669116:  Hold'em No Limit ($0.25/$0.50) - 2009/07/01 0:45:51 ET
Table 'T/PgNWqVyY6lkldcBVXYJQ' 6-max Seat #6 is the button
Seat 1: +Pf9jTVizYlIo+woPvptfA ($56.50 in chips)
Seat 2: LvH4G7n+QSjT6NDaD3cREA ($75.75 in chips)
Seat 3: L3OcNO1bgdqDI46j67KQPQ ($50.75 in chips)
Seat 4: Ek4w9XqBXqK5jBUQeLedGw ($50 in chips)
Seat 5: vVQBckETtigfb5mAcyK0OA ($54.45 in chips)
Seat 6: cDzbog6kwmJp+LBeBq+iMQ ($27.65 in chips)
+Pf9jTVizYlIo+woPvptfA: posts small blind $0.25
LvH4G7n+QSjT6NDaD3cREA: posts big blind $0.50
*** HOLE CARDS ***
L3OcNO1bgdqDI46j67KQPQ: folds
Ek4w9XqBXqK5jBUQeLedGw: folds
vVQBckETtigfb5mAcyK0OA: folds
cDzbog6kwmJp+LBeBq+iMQ: calls $0.50
+Pf9jTVizYlIo+woPvptfA: folds
LvH4G7n+QSjT6NDaD3cREA: checks
*** FLOP *** [7h 6h Js]
LvH4G7n+QSjT6NDaD3cREA: checks
cDzbog6kwmJp+LBeBq+iMQ: bets $0.50
LvH4G7n+QSjT6NDaD3cREA: raises $1.50 to $2
cDzbog6kwmJp+LBeBq+iMQ: calls $1.50
*** TURN *** [7h 6h Js] [4s]
LvH4G7n+QSjT6NDaD3cREA: bets $4
cDzbog6kwmJp+LBeBq+iMQ: calls $4
*** RIVER *** [7h 6h Js 4s] [8d]
vVQBckETtigfb5mAcyK0OA said, "when there is only 1 play left.players with good cards bet ******ed"
LvH4G7n+QSjT6NDaD3cREA: bets $8
cDzbog6kwmJp+LBeBq+iMQ: raises $8 to $16
LvH4G7n+QSjT6NDaD3cREA: folds
cDzbog6kwmJp+LBeBq+iMQ collected $27.85 from pot
*** SUMMARY ***
Total pot $29.25 | Rake $1.40
Board [7h 6h Js 4s 8d]
Seat 1: +Pf9jTVizYlIo+woPvptfA (small blind) folded before Flop
Seat 2: LvH4G7n+QSjT6NDaD3cREA (big blind) folded on the River
Seat 3: L3OcNO1bgdqDI46j67KQPQ folded before Flop (didn't bet)
Seat 4: Ek4w9XqBXqK5jBUQeLedGw folded before Flop (didn't bet)
Seat 5: vVQBckETtigfb5mAcyK0OA folded before Flop (didn't bet)
Seat 6: cDzbog6kwmJp+LBeBq+iMQ (button) collected ($27.85)



PokerStars Game #59939670048:  Hold'em No Limit ($0.25/$0.50) - 2009/07/01 0:45:52 ET
Table 'lpxYasB1ClBSgTpCCITwhQ' 9-max Seat #5 is the button
Seat 2: OWP/DOu+PlPK6ZZ3zYa0HA ($19.75 in chips)
Seat 3: cDNz32Scry3j+v2+kE3pHg ($50 in chips)
Seat 4: o4Jr+EJ272Vq/p5v7ZCBYA ($34.40 in chips)
Seat 5: IYd5zG8k7vdBNVHbHg2Pag ($36.60 in chips)
Seat 6: SegjDnMxWMujiD57ESNL+g ($12.25 in chips)
Seat 7: bmRtaIYKthN1F+B3JLZ3Jw ($21.70 in chips)
Seat 8: V+ivdLiYYuNr+thEXNextg ($34.25 in chips)
SegjDnMxWMujiD57ESNL+g: posts small blind $0.25
bmRtaIYKthN1F+B3JLZ3Jw: posts big blind $0.50
XNMDwbXt/Q4jM99AXnbJDw: sits out
*** HOLE CARDS ***
V+ivdLiYYuNr+thEXNextg: folds
OWP/DOu+PlPK6ZZ3zYa0HA: raises $1 to $1.50
cDNz32Scry3j+v2+kE3pHg: folds
o4Jr+EJ272Vq/p5v7ZCBYA: folds
IYd5zG8k7vdBNVHbHg2Pag: folds
SegjDnMxWMujiD57ESNL+g: folds
bmRtaIYKthN1F+B3JLZ3Jw: folds
OWP/DOu+PlPK6ZZ3zYa0HA collected $1.25 from pot
*** SUMMARY ***
Total pot $1.25 | Rake $0
Seat 2: OWP/DOu+PlPK6ZZ3zYa0HA collected ($1.25)
Seat 3: cDNz32Scry3j+v2+kE3pHg folded before Flop (didn't bet)
Seat 4: o4Jr+EJ272Vq/p5v7ZCBYA folded before Flop (didn't bet)
Seat 5: IYd5zG8k7vdBNVHbHg2Pag (button) folded before Flop (didn't bet)
Seat 6: SegjDnMxWMujiD57ESNL+g (small blind) folded before Flop
Seat 7: bmRtaIYKthN1F+B3JLZ3Jw (big blind) folded before Flop
Seat 8: V+ivdLiYYuNr+thEXNextg folded before Flop (didn't bet)



PokerStars Game #59939669974:  Hold'em No Limit ($0.25/$0.50) - 2009/07/01 0:45:52 ET
Table 'MJxeZCzYELxiIsyUZyT0jw' 6-max Seat #3 is the button
Seat 1: jNIq+EZLEm61oWSMYUVeWQ ($3.35 in chips)
Seat 3: JQZew0FjzS19kTjeNtrE+A ($59.75 in chips)
Seat 4: alGiiQP/wwtYnfuXII+sgw ($45.45 in chips)
Seat 5: 3jvoOXNtXE90w2BdfNZwZQ ($52 in chips)
Seat 6: TTx3CHxyi0SObcHyMJRp5w ($57.45 in chips)
alGiiQP/wwtYnfuXII+sgw: posts small blind $0.25
3jvoOXNtXE90w2BdfNZwZQ: posts big blind $0.50
*** HOLE CARDS ***
TTx3CHxyi0SObcHyMJRp5w: folds
jNIq+EZLEm61oWSMYUVeWQ: calls $0.50
JQZew0FjzS19kTjeNtrE+A: folds
alGiiQP/wwtYnfuXII+sgw: calls $0.25
3jvoOXNtXE90w2BdfNZwZQ: checks
*** FLOP *** [Qd 5c Th]
alGiiQP/wwtYnfuXII+sgw: checks
3jvoOXNtXE90w2BdfNZwZQ: checks
jNIq+EZLEm61oWSMYUVeWQ: checks
*** TURN *** [Qd 5c Th] [9h]
alGiiQP/wwtYnfuXII+sgw: checks
3jvoOXNtXE90w2BdfNZwZQ: checks
jNIq+EZLEm61oWSMYUVeWQ: checks
*** RIVER *** [Qd 5c Th 9h] [2c]
alGiiQP/wwtYnfuXII+sgw: checks
3jvoOXNtXE90w2BdfNZwZQ: checks
jNIq+EZLEm61oWSMYUVeWQ: checks
*** SHOW DOWN ***
alGiiQP/wwtYnfuXII+sgw: shows [Js 3s] (high card Queen)
3jvoOXNtXE90w2BdfNZwZQ: shows [4s Jd] (high card Queen)
jNIq+EZLEm61oWSMYUVeWQ: shows [5s 6s] (a pair of Fives)
jNIq+EZLEm61oWSMYUVeWQ collected $1.45 from pot
*** SUMMARY ***
Total pot $1.50 | Rake $0.05
Board [Qd 5c Th 9h 2c]
Seat 1: jNIq+EZLEm61oWSMYUVeWQ showed [5s 6s] and won ($1.45) with a pair of Fives
Seat 3: JQZew0FjzS19kTjeNtrE+A (button) folded before Flop (didn't bet)
Seat 4: alGiiQP/wwtYnfuXII+sgw (small blind) showed [Js 3s] and lost with high card Queen
Seat 5: 3jvoOXNtXE90w2BdfNZwZQ (big blind) showed [4s Jd] and lost with high card Queen
Seat 6: TTx3CHxyi0SObcHyMJRp5w folded before Flop (didn't bet)



PokerStars Game #59939670576:  Hold'em No Limit ($0.25/$0.50) - 2009/07/01 0:45:53 ET
Table '+111aLuBwnz8YVYSA7J1jA' 2-max Seat #2 is the button
Seat 1: ndd1nfncBkWNitBnsfCoVQ ($84.60 in chips)
Seat 2: +ciXH35zeafrjg1W6wiBTg ($63.85 in chips)
+ciXH35zeafrjg1W6wiBTg: posts small blind $0.25
ndd1nfncBkWNitBnsfCoVQ: posts big blind $0.50
*** HOLE CARDS ***
+ciXH35zeafrjg1W6wiBTg: raises $1.50 to $2
ndd1nfncBkWNitBnsfCoVQ: calls $1.50
*** FLOP *** [4s 7d 5c]
ndd1nfncBkWNitBnsfCoVQ: checks
+ciXH35zeafrjg1W6wiBTg: bets $2.50
ndd1nfncBkWNitBnsfCoVQ: folds
+ciXH35zeafrjg1W6wiBTg collected $3.80 from pot
+ciXH35zeafrjg1W6wiBTg: doesn't show hand
*** SUMMARY ***
Total pot $4 | Rake $0.20
Board [4s 7d 5c]
Seat 1: ndd1nfncBkWNitBnsfCoVQ (big blind) folded on the Flop
Seat 2: +ciXH35zeafrjg1W6wiBTg (button) (small blind) collected ($3.80)



PokerStars Game #59939674072:  Hold'em No Limit ($0.25/$0.50) - 2009/07/01 0:45:58 ET
Table '+z1aekfHkpp09pc8F9aViw' 6-max Seat #5 is the button
Seat 1: FHilMb2i2DbUCc9lplszog ($36.10 in chips)
Seat 2: M6xK/VklCvdyyrmvzATlxQ ($36 in chips)
Seat 3: uUznlIMFnRUvwrBhYF73KA ($107.45 in chips)
Seat 4: RowCSpSURHTOL/dcjg/Iug ($50.05 in chips)
Seat 5: crjGpJEzSZgD38FoE3VMGg ($50 in chips)
Seat 6: 686aeHikcJlgKkSuIFdcXQ ($66.60 in chips)
686aeHikcJlgKkSuIFdcXQ: posts small blind $0.25
FHilMb2i2DbUCc9lplszog: posts big blind $0.50
*** HOLE CARDS ***
M6xK/VklCvdyyrmvzATlxQ: folds
uUznlIMFnRUvwrBhYF73KA: folds
RowCSpSURHTOL/dcjg/Iug: folds
crjGpJEzSZgD38FoE3VMGg: folds
686aeHikcJlgKkSuIFdcXQ: raises $1.50 to $2
FHilMb2i2DbUCc9lplszog: raises $2 to $4
686aeHikcJlgKkSuIFdcXQ: folds
FHilMb2i2DbUCc9lplszog collected $4 from pot
*** SUMMARY ***
Total pot $4 | Rake $0
Seat 1: FHilMb2i2DbUCc9lplszog (big blind) collected ($4)
Seat 2: M6xK/VklCvdyyrmvzATlxQ folded before Flop (didn't bet)
Seat 3: uUznlIMFnRUvwrBhYF73KA folded before Flop (didn't bet)
Seat 4: RowCSpSURHTOL/dcjg/Iug folded before Flop (didn't bet)
Seat 5: crjGpJEzSZgD38FoE3VMGg (button) folded before Flop (didn't bet)
Seat 6: 686aeHikcJlgKkSuIFdcXQ (small blind) folded before Flop



PokerStars Game #59939675712:  Hold'em No Limit ($0.25/$0.50) - 2009/07/01 0:46:01 ET
Table 'c/CRn+68J3Y8KxD5g1ek2Q' 2-max Seat #2 is the button
Seat 1: 46qCyJ6evTkHo9al5sBMNA ($235.20 in chips)
Seat 2: BypVLsYQt3ePFm2xQL/dOA ($138.60 in chips)
BypVLsYQt3ePFm2xQL/dOA: posts small blind $0.25
46qCyJ6evTkHo9al5sBMNA: posts big blind $0.50
*** HOLE CARDS ***
BypVLsYQt3ePFm2xQL/dOA: calls $0.25
46qCyJ6evTkHo9al5sBMNA: raises $1 to $1.50
BypVLsYQt3ePFm2xQL/dOA: calls $1
*** FLOP *** [7h 8s Qs]
46qCyJ6evTkHo9al5sBMNA: bets $2
BypVLsYQt3ePFm2xQL/dOA: calls $2
*** TURN *** [7h 8s Qs] [3d]
46qCyJ6evTkHo9al5sBMNA: checks
BypVLsYQt3ePFm2xQL/dOA: checks
*** RIVER *** [7h 8s Qs 3d] [Kc]
46qCyJ6evTkHo9al5sBMNA: checks
BypVLsYQt3ePFm2xQL/dOA: checks
*** SHOW DOWN ***
46qCyJ6evTkHo9al5sBMNA: shows [9d Th] (high card King)
BypVLsYQt3ePFm2xQL/dOA: shows [Js 7c] (a pair of Sevens)
BypVLsYQt3ePFm2xQL/dOA collected $6.70 from pot
*** SUMMARY ***
Total pot $7 | Rake $0.30
Board [7h 8s Qs 3d Kc]
Seat 1: 46qCyJ6evTkHo9al5sBMNA (big blind) showed [9d Th] and lost with high card King
Seat 2: BypVLsYQt3ePFm2xQL/dOA (button) (small blind) showed [Js 7c] and won ($6.70) with a pair of Sevens



PokerStars Game #59939675620:  Hold'em No Limit ($0.25/$0.50) - 2009/07/01 0:46:01 ET
Table '+dXkOAQyS8j9PQZusUTMpg' 2-max Seat #2 is the button
Seat 1: XFa6sBGjP2gxoIvxR3fZIg ($49.45 in chips)
Seat 2: 5IBeOgaApY1Bvzv2P8X4EA ($154.15 in chips)
5IBeOgaApY1Bvzv2P8X4EA: posts small blind $0.25
5IBeOgaApY1Bvzv2P8X4EA said, ":D"
XFa6sBGjP2gxoIvxR3fZIg: posts big blind $0.50
*** HOLE CARDS ***
5IBeOgaApY1Bvzv2P8X4EA: calls $0.25
XFa6sBGjP2gxoIvxR3fZIg said, "You sure did :)"
XFa6sBGjP2gxoIvxR3fZIg: checks
*** FLOP *** [Qh 5c Qd]
XFa6sBGjP2gxoIvxR3fZIg: checks
5IBeOgaApY1Bvzv2P8X4EA: checks
*** TURN *** [Qh 5c Qd] [4d]
XFa6sBGjP2gxoIvxR3fZIg: checks
5IBeOgaApY1Bvzv2P8X4EA: checks
*** RIVER *** [Qh 5c Qd 4d] [6s]
XFa6sBGjP2gxoIvxR3fZIg: bets $1
5IBeOgaApY1Bvzv2P8X4EA: folds
XFa6sBGjP2gxoIvxR3fZIg collected $0.95 from pot
XFa6sBGjP2gxoIvxR3fZIg: doesn't show hand
*** SUMMARY ***
Total pot $1 | Rake $0.05
Board [Qh 5c Qd 4d 6s]
Seat 1: XFa6sBGjP2gxoIvxR3fZIg (big blind) collected ($0.95)
Seat 2: 5IBeOgaApY1Bvzv2P8X4EA (button) (small blind) folded on the River



PokerStars Game #59939679310:  Hold'em No Limit ($0.25/$0.50) - 2009/07/01 0:46:06 ET
Table '0eJtgVAXVvBgncFdcUpXcQ' 2-max Seat #1 is the button
Seat 1: Ag6DvxX4vbRheqsv2zXKTQ ($13.20 in chips)
Seat 2: KMc4R+K9ao4Ur3rF7NGe6Q ($16.20 in chips)
Ag6DvxX4vbRheqsv2zXKTQ: posts small blind $0.25
KMc4R+K9ao4Ur3rF7NGe6Q: posts big blind $0.50
*** HOLE CARDS ***
Ag6DvxX4vbRheqsv2zXKTQ: raises $2 to $2.50
KMc4R+K9ao4Ur3rF7NGe6Q: calls $2
*** FLOP *** [6h Js Ac]
KMc4R+K9ao4Ur3rF7NGe6Q: bets $13.70 and is all-in
Ag6DvxX4vbRheqsv2zXKTQ: calls $10.70 and is all-in
*** TURN *** [6h Js Ac] [Jd]
*** RIVER *** [6h Js Ac Jd] [5c]
*** SHOW DOWN ***
KMc4R+K9ao4Ur3rF7NGe6Q: shows [Jc Tc] (three of a kind, Jacks)
Ag6DvxX4vbRheqsv2zXKTQ: mucks hand
KMc4R+K9ao4Ur3rF7NGe6Q collected $25.90 from pot
*** SUMMARY ***
Total pot $26.40 | Rake $0.50
Board [6h Js Ac Jd 5c]
Seat 1: Ag6DvxX4vbRheqsv2zXKTQ (button) (small blind) mucked
Seat 2: KMc4R+K9ao4Ur3rF7NGe6Q (big blind) showed [Jc Tc] and won ($25.90) with three of a kind, Jacks



PokerStars Game #59939680408:  Hold'em No Limit ($0.25/$0.50) - 2009/07/01 0:46:08 ET
Table 'lSisgp6H7Fg1hH5VfjEjYQ' 9-max Seat #5 is the button
Seat 1: 5k9fvXD9suIgCxU4HLQjTw ($50 in chips)
Seat 2: UrcnkQOiLVk8BlKDPJSy7Q ($50 in chips)
Seat 3: aTkyjTh3w5YLWiIERupZOA ($51.95 in chips)
Seat 4: bwv/rbH/hHhPhY6u9mu04w ($30.50 in chips)
Seat 5: mSD1pginDsyHG5PDfqzphw ($11.35 in chips)
Seat 6: +k7T5ocke8UwavtgUHm+Cg ($34.60 in chips)
Seat 7: Y3DZ6qQlLeBhixDj4M9vmg ($10.30 in chips)
Seat 8: a4JDWmpFQkL10XfAyuF51A ($31.25 in chips)
Seat 9: gsyXT42WLEcOS4DdEk2wlw ($30.20 in chips)
+k7T5ocke8UwavtgUHm+Cg: posts small blind $0.25
Y3DZ6qQlLeBhixDj4M9vmg: posts big blind $0.50
*** HOLE CARDS ***
a4JDWmpFQkL10XfAyuF51A: folds
gsyXT42WLEcOS4DdEk2wlw: folds
5k9fvXD9suIgCxU4HLQjTw: folds
UrcnkQOiLVk8BlKDPJSy7Q: folds
aTkyjTh3w5YLWiIERupZOA: folds
bwv/rbH/hHhPhY6u9mu04w: folds
mSD1pginDsyHG5PDfqzphw: folds
+k7T5ocke8UwavtgUHm+Cg: raises $1 to $1.50
Y3DZ6qQlLeBhixDj4M9vmg: folds
+k7T5ocke8UwavtgUHm+Cg collected $1 from pot
+k7T5ocke8UwavtgUHm+Cg: doesn't show hand
*** SUMMARY ***
Total pot $1 | Rake $0
Seat 1: 5k9fvXD9suIgCxU4HLQjTw folded before Flop (didn't bet)
Seat 2: UrcnkQOiLVk8BlKDPJSy7Q folded before Flop (didn't bet)
Seat 3: aTkyjTh3w5YLWiIERupZOA folded before Flop (didn't bet)
Seat 4: bwv/rbH/hHhPhY6u9mu04w folded before Flop (didn't bet)
Seat 5: mSD1pginDsyHG5PDfqzphw (button) folded before Flop (didn't bet)
Seat 6: +k7T5ocke8UwavtgUHm+Cg (small blind) collected ($1)
Seat 7: Y3DZ6qQlLeBhixDj4M9vmg (big blind) folded before Flop
Seat 8: a4JDWmpFQkL10XfAyuF51A folded before Flop (didn't bet)
Seat 9: gsyXT42WLEcOS4DdEk2wlw folded before Flop (didn't bet)



PokerStars Game #59939681216:  Hold'em No Limit ($0.25/$0.50) - 2009/07/01 0:46:09 ET
Table 'IeNZOZQ4T6oiaHqFeo6yIA' 2-max Seat #1 is the button
Seat 1: ndd1nfncBkWNitBnsfCoVQ ($50 in chips)
Seat 2: A91IUl5JaZROhtfCtnnwYw ($132.85 in chips)
ndd1nfncBkWNitBnsfCoVQ: posts small blind $0.25
A91IUl5JaZROhtfCtnnwYw: posts big blind $0.50
*** HOLE CARDS ***
ndd1nfncBkWNitBnsfCoVQ: raises $1 to $1.50
A91IUl5JaZROhtfCtnnwYw: raises $1 to $2.50
ndd1nfncBkWNitBnsfCoVQ: calls $1
*** FLOP *** [2h 4s 7d]
A91IUl5JaZROhtfCtnnwYw: checks
ndd1nfncBkWNitBnsfCoVQ: bets $4
A91IUl5JaZROhtfCtnnwYw: raises $4 to $8
ndd1nfncBkWNitBnsfCoVQ: calls $4
*** TURN *** [2h 4s 7d] [Qc]
A91IUl5JaZROhtfCtnnwYw: checks
ndd1nfncBkWNitBnsfCoVQ: checks
*** RIVER *** [2h 4s 7d Qc] [Td]
A91IUl5JaZROhtfCtnnwYw: checks
ndd1nfncBkWNitBnsfCoVQ: bets $39.50 and is all-in
A91IUl5JaZROhtfCtnnwYw: folds
ndd1nfncBkWNitBnsfCoVQ collected $20.50 from pot
ndd1nfncBkWNitBnsfCoVQ: doesn't show hand
*** SUMMARY ***
Total pot $21 | Rake $0.50
Board [2h 4s 7d Qc Td]
Seat 1: ndd1nfncBkWNitBnsfCoVQ (button) (small blind) collected ($20.50)
Seat 2: A91IUl5JaZROhtfCtnnwYw (big blind) folded on the River



PokerStars Game #59939681680:  Hold'em No Limit ($0.25/$0.50) - 2009/07/01 0:46:10 ET
Table '+111aLuBwnz8YVYSA7J1jA' 2-max Seat #1 is the button
Seat 1: ndd1nfncBkWNitBnsfCoVQ ($82.60 in chips)
Seat 2: +ciXH35zeafrjg1W6wiBTg ($65.65 in chips)
ndd1nfncBkWNitBnsfCoVQ: posts small blind $0.25
+ciXH35zeafrjg1W6wiBTg: posts big blind $0.50
*** HOLE CARDS ***
ndd1nfncBkWNitBnsfCoVQ: raises $1 to $1.50
+ciXH35zeafrjg1W6wiBTg: raises $1.50 to $3
ndd1nfncBkWNitBnsfCoVQ: calls $1.50
*** FLOP *** [3d 2d 5d]
+ciXH35zeafrjg1W6wiBTg: bets $2.50
ndd1nfncBkWNitBnsfCoVQ: calls $2.50
*** TURN *** [3d 2d 5d] [9c]
+ciXH35zeafrjg1W6wiBTg: checks
ndd1nfncBkWNitBnsfCoVQ: checks
*** RIVER *** [3d 2d 5d 9c] [4s]
+ciXH35zeafrjg1W6wiBTg: bets $10
ndd1nfncBkWNitBnsfCoVQ: folds
+ciXH35zeafrjg1W6wiBTg collected $10.50 from pot
+ciXH35zeafrjg1W6wiBTg: doesn't show hand
*** SUMMARY ***
Total pot $11 | Rake $0.50
Board [3d 2d 5d 9c 4s]
Seat 1: ndd1nfncBkWNitBnsfCoVQ (button) (small blind) folded on the River
Seat 2: +ciXH35zeafrjg1W6wiBTg (big blind) collected ($10.50)



PokerStars Game #59939682122:  Hold'em No Limit ($0.25/$0.50) - 2009/07/01 0:46:11 ET
Table 'otvGDROEDdqsabxskT79qg' 9-max Seat #3 is the button
Seat 1: 8ehL7qlZzjgUh2H35iiWLw ($55.25 in chips)
Seat 2: cCjTzH9jio8607WzjcfXlg ($12.25 in chips)
Seat 3: +k7T5ocke8UwavtgUHm+Cg ($62.05 in chips)
Seat 4: MG90wfSJZnOejs/KD3vlQQ ($70.20 in chips)
Seat 5: XNMDwbXt/Q4jM99AXnbJDw ($54.30 in chips)
Seat 6: bxLSulbgr8LmKNjOzw8URg ($49.90 in chips)
Seat 7: C7+tBppJrKgd/r+tuKUIpA ($37.85 in chips)
Seat 8: zE9cVigS2nW/Ljy4K4bUQA ($30 in chips)
Seat 9: KcY3X8YpD74Kw1RHkx/g4A ($64.50 in chips)
MG90wfSJZnOejs/KD3vlQQ: posts small blind $0.25
XNMDwbXt/Q4jM99AXnbJDw: posts big blind $0.50
*** HOLE CARDS ***
bxLSulbgr8LmKNjOzw8URg: folds
C7+tBppJrKgd/r+tuKUIpA: folds
zE9cVigS2nW/Ljy4K4bUQA: folds
KcY3X8YpD74Kw1RHkx/g4A: calls $0.50
8ehL7qlZzjgUh2H35iiWLw: folds
cCjTzH9jio8607WzjcfXlg: folds
+k7T5ocke8UwavtgUHm+Cg: folds
MG90wfSJZnOejs/KD3vlQQ: folds
XNMDwbXt/Q4jM99AXnbJDw: checks
*** FLOP *** [Td 2s 3c]
XNMDwbXt/Q4jM99AXnbJDw: checks
KcY3X8YpD74Kw1RHkx/g4A: bets $0.50
XNMDwbXt/Q4jM99AXnbJDw: folds
KcY3X8YpD74Kw1RHkx/g4A collected $1.20 from pot
*** SUMMARY ***
Total pot $1.25 | Rake $0.05
Board [Td 2s 3c]
Seat 1: 8ehL7qlZzjgUh2H35iiWLw folded before Flop (didn't bet)
Seat 2: cCjTzH9jio8607WzjcfXlg folded before Flop (didn't bet)
Seat 3: +k7T5ocke8UwavtgUHm+Cg (button) folded before Flop (didn't bet)
Seat 4: MG90wfSJZnOejs/KD3vlQQ (small blind) folded before Flop
Seat 5: XNMDwbXt/Q4jM99AXnbJDw (big blind) folded on the Flop
Seat 6: bxLSulbgr8LmKNjOzw8URg folded before Flop (didn't bet)
Seat 7: C7+tBppJrKgd/r+tuKUIpA folded before Flop (didn't bet)
Seat 8: zE9cVigS2nW/Ljy4K4bUQA folded before Flop (didn't bet)
Seat 9: KcY3X8YpD74Kw1RHkx/g4A collected ($1.20)



PokerStars Game #59939682274:  Hold'em No Limit ($0.25/$0.50) - 2009/07/01 0:46:11 ET
Table '3FhG0gl3kMX3wBEEqj+wnQ' 9-max Seat #2 is the button
Seat 1: e0J9pdCNUDTCG031RnXqLA ($26.45 in chips)
Seat 2: 7cYQ+syUWjl38ty/ICOMhw ($50 in chips)
Seat 3: k1f0lS7tlMHCLGs0JT34Tg ($9.50 in chips)
Seat 4: bjvJtA9Hqscfznq66txaOQ ($10 in chips)
Seat 5: gsyXT42WLEcOS4DdEk2wlw ($28 in chips)
Seat 6: 997ViqAtWn1FPjJqcffwcA ($50 in chips)
Seat 7: mSD1pginDsyHG5PDfqzphw ($11.50 in chips)
Seat 8: j3K/Jujr7PY4ZM2RZvlH6A ($57.35 in chips)
Seat 9: L5e2lrPLQm1Pqx30IIZ/Fw ($10 in chips)
k1f0lS7tlMHCLGs0JT34Tg: posts small blind $0.25
bjvJtA9Hqscfznq66txaOQ: posts big blind $0.50
*** HOLE CARDS ***
gsyXT42WLEcOS4DdEk2wlw: folds
7cYQ+syUWjl38ty/ICOMhw said, "6's"
997ViqAtWn1FPjJqcffwcA: folds
mSD1pginDsyHG5PDfqzphw: folds
j3K/Jujr7PY4ZM2RZvlH6A: folds
L5e2lrPLQm1Pqx30IIZ/Fw: folds
e0J9pdCNUDTCG031RnXqLA: raises $0.50 to $1
7cYQ+syUWjl38ty/ICOMhw: folds
k1f0lS7tlMHCLGs0JT34Tg: calls $0.75
bjvJtA9Hqscfznq66txaOQ: folds
*** FLOP *** [Qs 9c 7d]
k1f0lS7tlMHCLGs0JT34Tg: bets $1.50
e0J9pdCNUDTCG031RnXqLA: calls $1.50
*** TURN *** [Qs 9c 7d] [Jc]
k1f0lS7tlMHCLGs0JT34Tg: bets $2
e0J9pdCNUDTCG031RnXqLA: raises $2 to $4
k1f0lS7tlMHCLGs0JT34Tg: calls $2
*** RIVER *** [Qs 9c 7d Jc] [Ad]
k1f0lS7tlMHCLGs0JT34Tg: bets $3 and is all-in
e0J9pdCNUDTCG031RnXqLA: calls $3
*** SHOW DOWN ***
k1f0lS7tlMHCLGs0JT34Tg: shows [As Qc] (two pair, Aces and Queens)
e0J9pdCNUDTCG031RnXqLA: shows [Td Kd] (a straight, Ten to Ace)
e0J9pdCNUDTCG031RnXqLA collected $18.60 from pot
*** SUMMARY ***
Total pot $19.50 | Rake $0.90
Board [Qs 9c 7d Jc Ad]
Seat 1: e0J9pdCNUDTCG031RnXqLA showed [Td Kd] and won ($18.60) with a straight, Ten to Ace
Seat 2: 7cYQ+syUWjl38ty/ICOMhw (button) folded before Flop (didn't bet)
Seat 3: k1f0lS7tlMHCLGs0JT34Tg (small blind) showed [As Qc] and lost with two pair, Aces and Queens
Seat 4: bjvJtA9Hqscfznq66txaOQ (big blind) folded before Flop
Seat 5: gsyXT42WLEcOS4DdEk2wlw folded before Flop (didn't bet)
Seat 6: 997ViqAtWn1FPjJqcffwcA folded before Flop (didn't bet)
Seat 7: mSD1pginDsyHG5PDfqzphw folded before Flop (didn't bet)
Seat 8: j3K/Jujr7PY4ZM2RZvlH6A folded before Flop (didn't bet)
Seat 9: L5e2lrPLQm1Pqx30IIZ/Fw folded before Flop (didn't bet)



PokerStars Game #59939682442:  Hold'em No Limit ($0.25/$0.50) - 2009/07/01 0:46:11 ET
Table '5EmHi+fnatGQQShcNmzOZQ' 6-max Seat #4 is the button
Seat 1: +SZCX3+7lnuhHKIu+PP9rg ($58.45 in chips)
Seat 2: vXIHnZ+dv/hwSBxyvGw7bQ ($50 in chips)
Seat 4: 1b+2BbjMN8qhR1WPqdE9VQ ($53.15 in chips)
Seat 5: kxPhs4ePFqMy52CInAJ2aw ($56.10 in chips)
Seat 6: 686aeHikcJlgKkSuIFdcXQ ($141.95 in chips)
kxPhs4ePFqMy52CInAJ2aw: posts small blind $0.25
686aeHikcJlgKkSuIFdcXQ: posts big blind $0.50
*** HOLE CARDS ***
+SZCX3+7lnuhHKIu+PP9rg said, "thanks"
+SZCX3+7lnuhHKIu+PP9rg: calls $0.50
vXIHnZ+dv/hwSBxyvGw7bQ: folds
1b+2BbjMN8qhR1WPqdE9VQ: folds
kxPhs4ePFqMy52CInAJ2aw: folds
TjmTe3bhs9dFz5gXX9x7Lw joins the table at seat #3
686aeHikcJlgKkSuIFdcXQ: checks
*** FLOP *** [Ks 5h 7s]
686aeHikcJlgKkSuIFdcXQ: checks
+SZCX3+7lnuhHKIu+PP9rg: bets $1
686aeHikcJlgKkSuIFdcXQ: folds
+SZCX3+7lnuhHKIu+PP9rg collected $1.20 from pot
+SZCX3+7lnuhHKIu+PP9rg: doesn't show hand
*** SUMMARY ***
Total pot $1.25 | Rake $0.05
Board [Ks 5h 7s]
Seat 1: +SZCX3+7lnuhHKIu+PP9rg collected ($1.20)
Seat 2: vXIHnZ+dv/hwSBxyvGw7bQ folded before Flop (didn't bet)
Seat 4: 1b+2BbjMN8qhR1WPqdE9VQ (button) folded before Flop (didn't bet)
Seat 5: kxPhs4ePFqMy52CInAJ2aw (small blind) folded before Flop
Seat 6: 686aeHikcJlgKkSuIFdcXQ (big blind) folded on the Flop



PokerStars Game #59939682176:  Hold'em No Limit ($0.25/$0.50) - 2009/07/01 0:46:11 ET
Table 'GfL/No5u5PoEnU39lP5pQg' 6-max Seat #5 is the button
Seat 1: 1WUCqNG+p+vfWRTXNu4ljw ($62.45 in chips)
Seat 2: uVwggSetzp7d+eVgowO3vg ($67.20 in chips)
Seat 3: Ek4w9XqBXqK5jBUQeLedGw ($50 in chips)
Seat 5: M1KyQQvVPVuxqTAB8sR/zQ ($51.20 in chips)
1WUCqNG+p+vfWRTXNu4ljw: posts small blind $0.25
uVwggSetzp7d+eVgowO3vg: posts big blind $0.50
*** HOLE CARDS ***
Ek4w9XqBXqK5jBUQeLedGw: folds
r6u7MWSXF30/khcTYkrG9Q joins the table at seat #4
M1KyQQvVPVuxqTAB8sR/zQ: folds
1WUCqNG+p+vfWRTXNu4ljw: folds
uVwggSetzp7d+eVgowO3vg collected $0.50 from pot
uVwggSetzp7d+eVgowO3vg: shows [Ac Jd] (high card Ace)
*** SUMMARY ***
Total pot $0.50 | Rake $0
Seat 1: 1WUCqNG+p+vfWRTXNu4ljw (small blind) folded before Flop
Seat 2: uVwggSetzp7d+eVgowO3vg (big blind) collected ($0.50)
Seat 3: Ek4w9XqBXqK5jBUQeLedGw folded before Flop (didn't bet)
Seat 5: M1KyQQvVPVuxqTAB8sR/zQ (button) folded before Flop (didn't bet)



PokerStars Game #59939685696:  Hold'em No Limit ($0.25/$0.50) - 2009/07/01 0:46:16 ET
Table '/cQuAT3ef4t+PGrXiNhGaQ' 9-max Seat #4 is the button
Seat 1: HZkVla4kK2SI42CVrPZ/ig ($5.25 in chips)
Seat 2: jXGruyaMqirTaTXNOvBdew ($69.45 in chips)
Seat 3: g4k0NXISyLCqaSWZDBjfEg ($53.65 in chips)
Seat 4: OWP/DOu+PlPK6ZZ3zYa0HA ($29.40 in chips)
Seat 5: 5SgaHdWixdClWvaEG+KUjQ ($25.85 in chips)
Seat 6: APYIOyK/4AGb+kIwlOUNBQ ($39 in chips)
Seat 7: J0W5D97jl5VLky+IoPvDeA ($114.15 in chips)
Seat 8: W3ingbA178eb7J5rt1PuIQ ($37.10 in chips)
Seat 9: AjV5McH1KMMclY26QdLM5w ($31.35 in chips)
5SgaHdWixdClWvaEG+KUjQ: posts small blind $0.25
APYIOyK/4AGb+kIwlOUNBQ: posts big blind $0.50
*** HOLE CARDS ***
J0W5D97jl5VLky+IoPvDeA: folds
W3ingbA178eb7J5rt1PuIQ: folds
AjV5McH1KMMclY26QdLM5w: folds
HZkVla4kK2SI42CVrPZ/ig: folds
jXGruyaMqirTaTXNOvBdew: folds
g4k0NXISyLCqaSWZDBjfEg: raises $1 to $1.50
OWP/DOu+PlPK6ZZ3zYa0HA: folds
5SgaHdWixdClWvaEG+KUjQ: folds
APYIOyK/4AGb+kIwlOUNBQ: calls $1
*** FLOP *** [4c Td 6c]
APYIOyK/4AGb+kIwlOUNBQ: checks
g4k0NXISyLCqaSWZDBjfEg: checks
*** TURN *** [4c Td 6c] [8s]
APYIOyK/4AGb+kIwlOUNBQ: checks
g4k0NXISyLCqaSWZDBjfEg: checks
*** RIVER *** [4c Td 6c 8s] [3d]
APYIOyK/4AGb+kIwlOUNBQ: checks
g4k0NXISyLCqaSWZDBjfEg: checks
*** SHOW DOWN ***
APYIOyK/4AGb+kIwlOUNBQ: shows [5d Ah] (high card Ace)
g4k0NXISyLCqaSWZDBjfEg: shows [8h 9s] (a pair of Eights)
g4k0NXISyLCqaSWZDBjfEg collected $3.10 from pot
*** SUMMARY ***
Total pot $3.25 | Rake $0.15
Board [4c Td 6c 8s 3d]
Seat 1: HZkVla4kK2SI42CVrPZ/ig folded before Flop (didn't bet)
Seat 2: jXGruyaMqirTaTXNOvBdew folded before Flop (didn't bet)
Seat 3: g4k0NXISyLCqaSWZDBjfEg showed [8h 9s] and won ($3.10) with a pair of Eights
Seat 4: OWP/DOu+PlPK6ZZ3zYa0HA (button) folded before Flop (didn't bet)
Seat 5: 5SgaHdWixdClWvaEG+KUjQ (small blind) folded before Flop
Seat 6: APYIOyK/4AGb+kIwlOUNBQ (big blind) showed [5d Ah] and lost with high card Ace
Seat 7: J0W5D97jl5VLky+IoPvDeA folded before Flop (didn't bet)
Seat 8: W3ingbA178eb7J5rt1PuIQ folded before Flop (didn't bet)
Seat 9: AjV5McH1KMMclY26QdLM5w folded before Flop (didn't bet)



PokerStars Game #59939685736:  Hold'em No Limit ($0.25/$0.50) - 2009/07/01 0:46:16 ET
Table 'QOeVnLhwctF9UyV/beDi+A' 2-max Seat #1 is the button
Seat 1: bypIyrYcAAifLfhZpGlKLA ($66.75 in chips)
Seat 2: Ucrm3XtZmoONapW32SPhag ($16.15 in chips)
bypIyrYcAAifLfhZpGlKLA: posts small blind $0.25
Ucrm3XtZmoONapW32SPhag: posts big blind $0.50
*** HOLE CARDS ***
bypIyrYcAAifLfhZpGlKLA: raises $0.50 to $1
Ucrm3XtZmoONapW32SPhag: calls $0.50
*** FLOP *** [Js Qh 5d]
Ucrm3XtZmoONapW32SPhag: checks
bypIyrYcAAifLfhZpGlKLA: bets $1.50
Ucrm3XtZmoONapW32SPhag: calls $1.50
*** TURN *** [Js Qh 5d] [Ts]
Ucrm3XtZmoONapW32SPhag: checks
bypIyrYcAAifLfhZpGlKLA: checks
*** RIVER *** [Js Qh 5d Ts] [5c]
Ucrm3XtZmoONapW32SPhag: checks
bypIyrYcAAifLfhZpGlKLA: checks
*** SHOW DOWN ***
Ucrm3XtZmoONapW32SPhag: shows [5s Ad] (three of a kind, Fives)
bypIyrYcAAifLfhZpGlKLA: mucks hand
Ucrm3XtZmoONapW32SPhag collected $4.80 from pot
*** SUMMARY ***
Total pot $5 | Rake $0.20
Board [Js Qh 5d Ts 5c]
Seat 1: bypIyrYcAAifLfhZpGlKLA (button) (small blind) mucked
Seat 2: Ucrm3XtZmoONapW32SPhag (big blind) showed [5s Ad] and won ($4.80) with three of a kind, Fives



PokerStars Game #59939686030:  Hold'em No Limit ($0.25/$0.50) - 2009/07/01 0:46:17 ET
Table 'BCN5su+SsXiy1zRMJi0SJw' 6-max Seat #5 is the button
Seat 2: oU2kDCkT/gilYbHWrg7D8w ($6.65 in chips)
Seat 3: g+vwI6lMKpU2uteXSjOzVw ($21.95 in chips)
Seat 4: JY9CtoZTeav+mhWyxSSyJQ ($26.15 in chips)
Seat 5: IBNygaT1aa9Z1uPdJJilwA ($68.35 in chips)
Seat 6: b2symlOdL7+0c9Pj4N/KlA ($51.35 in chips)
b2symlOdL7+0c9Pj4N/KlA: posts small blind $0.25
crjGpJEzSZgD38FoE3VMGg: is sitting out
oU2kDCkT/gilYbHWrg7D8w: posts big blind $0.50
*** HOLE CARDS ***
g+vwI6lMKpU2uteXSjOzVw: calls $0.50
crjGpJEzSZgD38FoE3VMGg leaves the table
JY9CtoZTeav+mhWyxSSyJQ: calls $0.50
IBNygaT1aa9Z1uPdJJilwA: folds
b2symlOdL7+0c9Pj4N/KlA: folds
oU2kDCkT/gilYbHWrg7D8w: checks
*** FLOP *** [8d 5h 7h]
oU2kDCkT/gilYbHWrg7D8w: checks
g+vwI6lMKpU2uteXSjOzVw: checks
JY9CtoZTeav+mhWyxSSyJQ: checks
*** TURN *** [8d 5h 7h] [5s]
oU2kDCkT/gilYbHWrg7D8w: checks
g+vwI6lMKpU2uteXSjOzVw: checks
JY9CtoZTeav+mhWyxSSyJQ: checks
*** RIVER *** [8d 5h 7h 5s] [8h]
GxXV09ciXaOxyY2H5aMIIw joins the table at seat #1
oU2kDCkT/gilYbHWrg7D8w: bets $3
g+vwI6lMKpU2uteXSjOzVw: calls $3
JY9CtoZTeav+mhWyxSSyJQ: folds
*** SHOW DOWN ***
oU2kDCkT/gilYbHWrg7D8w: shows [5d Qd] (a full house, Fives full of Eights)
g+vwI6lMKpU2uteXSjOzVw: mucks hand
oU2kDCkT/gilYbHWrg7D8w collected $7.40 from pot
*** SUMMARY ***
Total pot $7.75 | Rake $0.35
Board [8d 5h 7h 5s 8h]
Seat 2: oU2kDCkT/gilYbHWrg7D8w (big blind) showed [5d Qd] and won ($7.40) with a full house, Fives full of Eights
Seat 3: g+vwI6lMKpU2uteXSjOzVw mucked
Seat 4: JY9CtoZTeav+mhWyxSSyJQ folded on the River
Seat 5: IBNygaT1aa9Z1uPdJJilwA (button) folded before Flop (didn't bet)
Seat 6: b2symlOdL7+0c9Pj4N/KlA (small blind) folded before Flop



PokerStars Game #59939688420:  Hold'em No Limit ($0.25/$0.50) - 2009/07/01 0:46:21 ET
Table 'QOgaEqMcJ73pcUMMxoisUgErOuyGLI5PT3G5MnpHgC/g Seat #3 is the button
Seat 3: xZCXQSXlrZkp3pZizzVXCw ($49.75 in chips)
Seat 4: 3UmXLy3GfjC3EkOebduerQ ($50 in chips)
Seat 5: JwvquocWfhTVApN5t47LgA ($60.85 in chips)
Seat 6: zE9cVigS2nW/Ljy4K4bUQA ($30.75 in chips)
Seat 7: 90Wb75h3W1BRpbqVnuk8gw ($60.95 in chips)
Seat 8: g4k0NXISyLCqaSWZDBjfEg ($50 in chips)
Seat 9: J0W5D97jl5VLky+IoPvDeA ($57.15 in chips)
3UmXLy3GfjC3EkOebduerQ: posts small blind $0.25
JwvquocWfhTVApN5t47LgA: posts big blind $0.50
*** HOLE CARDS ***
zE9cVigS2nW/Ljy4K4bUQA: folds
90Wb75h3W1BRpbqVnuk8gw: raises $1.50 to $2
g4k0NXISyLCqaSWZDBjfEg: folds
J0W5D97jl5VLky+IoPvDeA: folds
xZCXQSXlrZkp3pZizzVXCw: folds
3UmXLy3GfjC3EkOebduerQ: folds
JwvquocWfhTVApN5t47LgA: folds
90Wb75h3W1BRpbqVnuk8gw collected $1.25 from pot
*** SUMMARY ***
Total pot $1.25 | Rake $0
Seat 3: xZCXQSXlrZkp3pZizzVXCw (button) folded before Flop (didn't bet)
Seat 4: 3UmXLy3GfjC3EkOebduerQ (small blind) folded before Flop
Seat 5: JwvquocWfhTVApN5t47LgA (big blind) folded before Flop
Seat 6: zE9cVigS2nW/Ljy4K4bUQA folded before Flop (didn't bet)
Seat 7: 90Wb75h3W1BRpbqVnuk8gw collected ($1.25)
Seat 8: g4k0NXISyLCqaSWZDBjfEg folded before Flop (didn't bet)
Seat 9: J0W5D97jl5VLky+IoPvDeA folded before Flop (didn't bet)



PokerStars Game #59939688914:  Hold'em No Limit ($0.25/$0.50) - 2009/07/01 0:46:22 ET
Table 'lpxYasB1ClBSgTpCCITwhQ' 9-max Seat #6 is the button
Seat 2: OWP/DOu+PlPK6ZZ3zYa0HA ($20.50 in chips)
Seat 3: cDNz32Scry3j+v2+kE3pHg ($50 in chips)
Seat 4: o4Jr+EJ272Vq/p5v7ZCBYA ($34.40 in chips)
Seat 5: IYd5zG8k7vdBNVHbHg2Pag ($36.60 in chips)
Seat 6: SegjDnMxWMujiD57ESNL+g ($12 in chips)
Seat 7: bmRtaIYKthN1F+B3JLZ3Jw ($21.20 in chips)
Seat 8: V+ivdLiYYuNr+thEXNextg ($34.25 in chips)
bmRtaIYKthN1F+B3JLZ3Jw: posts small blind $0.25
V+ivdLiYYuNr+thEXNextg: posts big blind $0.50
XNMDwbXt/Q4jM99AXnbJDw: sits out
*** HOLE CARDS ***
OWP/DOu+PlPK6ZZ3zYa0HA: folds
mj7PS7wCH4PAl7+eYTFs7A has returned
cDNz32Scry3j+v2+kE3pHg: folds
o4Jr+EJ272Vq/p5v7ZCBYA: calls $0.50
IYd5zG8k7vdBNVHbHg2Pag: folds
SegjDnMxWMujiD57ESNL+g: folds
bmRtaIYKthN1F+B3JLZ3Jw: calls $0.25
V+ivdLiYYuNr+thEXNextg: checks
*** FLOP *** [5d Ts 7d]
bmRtaIYKthN1F+B3JLZ3Jw: checks
V+ivdLiYYuNr+thEXNextg: checks
o4Jr+EJ272Vq/p5v7ZCBYA: bets $2.50
bmRtaIYKthN1F+B3JLZ3Jw: folds
V+ivdLiYYuNr+thEXNextg: folds
o4Jr+EJ272Vq/p5v7ZCBYA collected $1.45 from pot
o4Jr+EJ272Vq/p5v7ZCBYA: doesn't show hand
*** SUMMARY ***
Total pot $1.50 | Rake $0.05
Board [5d Ts 7d]
Seat 2: OWP/DOu+PlPK6ZZ3zYa0HA folded before Flop (didn't bet)
Seat 3: cDNz32Scry3j+v2+kE3pHg folded before Flop (didn't bet)
Seat 4: o4Jr+EJ272Vq/p5v7ZCBYA collected ($1.45)
Seat 5: IYd5zG8k7vdBNVHbHg2Pag folded before Flop (didn't bet)
Seat 6: SegjDnMxWMujiD57ESNL+g (button) folded before Flop (didn't bet)
Seat 7: bmRtaIYKthN1F+B3JLZ3Jw (small blind) folded on the Flop
Seat 8: V+ivdLiYYuNr+thEXNextg (big blind) folded on the Flop



PokerStars Game #59939689306:  Hold'em No Limit ($0.25/$0.50) - 2009/07/01 0:46:22 ET
Table 'QOgaEqMcJ73pcUMMxoisUg' 6-max Seat #6 is the button
Seat 1: /olYG0EzMWzADIgH1y2ySQ ($27.50 in chips)
Seat 2: 4QfsCWthT/vSLirorNXqtg ($50 in chips)
Seat 3: Rt6KgtZ8YaJoTc3FPim00w ($76.75 in chips)
Seat 4: zAcsDhG/T128Vn7XGVSgKg ($51.60 in chips)
Seat 5: 6vNxrjjCl6FwfaaymM9jjg ($17.25 in chips)
Seat 6: pmE+2KJb4nffAVqjLIXxFg ($22.45 in chips)
/olYG0EzMWzADIgH1y2ySQ: posts small blind $0.25
4QfsCWthT/vSLirorNXqtg: posts big blind $0.50
*** HOLE CARDS ***
Rt6KgtZ8YaJoTc3FPim00w: folds
zAcsDhG/T128Vn7XGVSgKg: folds
6vNxrjjCl6FwfaaymM9jjg: calls $0.50
pmE+2KJb4nffAVqjLIXxFg: folds
/olYG0EzMWzADIgH1y2ySQ: calls $0.25
4QfsCWthT/vSLirorNXqtg: checks
*** FLOP *** [Jh 4h Qc]
/olYG0EzMWzADIgH1y2ySQ: checks
4QfsCWthT/vSLirorNXqtg: checks
6vNxrjjCl6FwfaaymM9jjg: checks
*** TURN *** [Jh 4h Qc] [7s]
/olYG0EzMWzADIgH1y2ySQ: checks
4QfsCWthT/vSLirorNXqtg: checks
6vNxrjjCl6FwfaaymM9jjg: bets $2
/olYG0EzMWzADIgH1y2ySQ: folds
4QfsCWthT/vSLirorNXqtg: folds
6vNxrjjCl6FwfaaymM9jjg collected $1.45 from pot
*** SUMMARY ***
Total pot $1.50 | Rake $0.05
Board [Jh 4h Qc 7s]
Seat 1: /olYG0EzMWzADIgH1y2ySQ (small blind) folded on the Turn
Seat 2: 4QfsCWthT/vSLirorNXqtg (big blind) folded on the Turn
Seat 3: Rt6KgtZ8YaJoTc3FPim00w folded before Flop (didn't bet)
Seat 4: zAcsDhG/T128Vn7XGVSgKg folded before Flop (didn't bet)
Seat 5: 6vNxrjjCl6FwfaaymM9jjg collected ($1.45)
Seat 6: pmE+2KJb4nffAVqjLIXxFg (button) folded before Flop (didn't bet)



PokerStars Game #59939689956:  Hold'em No Limit ($0.25/$0.50) - 2009/07/01 0:46:23 ET
Table '99gCy/CZQwPIjZWH+BguQgE7bWJ45aoFXRpyRv2gw+Igeat #7 is the button
Seat 2: n6VQBu6crjYjy6DxNP1NZA ($29.65 in chips)
Seat 3: qEn9ijNGtuyTxamBf07hYg ($50 in chips)
Seat 4: bxLSulbgr8LmKNjOzw8URg ($63.45 in chips)
Seat 5: DSM67hHHq1XFoEOi9p8Alw ($49.25 in chips)
Seat 7: bfSq6LBw0UvxeM5yfuWC7w ($17.85 in chips)
Seat 8: 8ehL7qlZzjgUh2H35iiWLw ($50 in chips)
Seat 9: j3K/Jujr7PY4ZM2RZvlH6A ($85.65 in chips)
8ehL7qlZzjgUh2H35iiWLw: posts small blind $0.25
j3K/Jujr7PY4ZM2RZvlH6A: posts big blind $0.50
*** HOLE CARDS ***
n6VQBu6crjYjy6DxNP1NZA: folds
qEn9ijNGtuyTxamBf07hYg: folds
bxLSulbgr8LmKNjOzw8URg: folds
qEn9ijNGtuyTxamBf07hYg said, "QT?"
DSM67hHHq1XFoEOi9p8Alw: folds
bfSq6LBw0UvxeM5yfuWC7w: raises $0.50 to $1
8ehL7qlZzjgUh2H35iiWLw: folds
j3K/Jujr7PY4ZM2RZvlH6A: folds
bfSq6LBw0UvxeM5yfuWC7w collected $1.25 from pot
*** SUMMARY ***
Total pot $1.25 | Rake $0
Seat 2: n6VQBu6crjYjy6DxNP1NZA folded before Flop (didn't bet)
Seat 3: qEn9ijNGtuyTxamBf07hYg folded before Flop (didn't bet)
Seat 4: bxLSulbgr8LmKNjOzw8URg folded before Flop (didn't bet)
Seat 5: DSM67hHHq1XFoEOi9p8Alw folded before Flop (didn't bet)
Seat 7: bfSq6LBw0UvxeM5yfuWC7w (button) collected ($1.25)
Seat 8: 8ehL7qlZzjgUh2H35iiWLw (small blind) folded before Flop
Seat 9: j3K/Jujr7PY4ZM2RZvlH6A (big blind) folded before Flop



PokerStars Game #59939689774:  Hold'em No Limit ($0.25/$0.50) - 2009/07/01 0:46:23 ET
Table 'Vdlc9wqYcHTUhtdyN7CuJw' 2-max Seat #1 is the button
Seat 1: yBO+mXB6m/rCft2ErwGf/Q ($116.55 in chips)
Seat 2: NZ/5cxwnorKW2SNsWy1+8A ($9.25 in chips)
yBO+mXB6m/rCft2ErwGf/Q: posts small blind $0.25
NZ/5cxwnorKW2SNsWy1+8A: posts big blind $0.50
*** HOLE CARDS ***
yBO+mXB6m/rCft2ErwGf/Q: folds
NZ/5cxwnorKW2SNsWy1+8A collected $0.50 from pot
NZ/5cxwnorKW2SNsWy1+8A: doesn't show hand
*** SUMMARY ***
Total pot $0.50 | Rake $0
Seat 1: yBO+mXB6m/rCft2ErwGf/Q (button) (small blind) folded before Flop
Seat 2: NZ/5cxwnorKW2SNsWy1+8A (big blind) collected ($0.50)



PokerStars Game #59939689792:  Hold'em No Limit ($0.25/$0.50) - 2009/07/01 0:46:23 ET
Table 'GfL/No5u5PoEnU39lP5pQg' 6-max Seat #1 is the button
Seat 1: 1WUCqNG+p+vfWRTXNu4ljw ($62.20 in chips)
Seat 2: uVwggSetzp7d+eVgowO3vg ($67.45 in chips)
Seat 3: Ek4w9XqBXqK5jBUQeLedGw ($50 in chips)
Seat 5: M1KyQQvVPVuxqTAB8sR/zQ ($51.20 in chips)
uVwggSetzp7d+eVgowO3vg: posts small blind $0.25
Ek4w9XqBXqK5jBUQeLedGw: posts big blind $0.50
r6u7MWSXF30/khcTYkrG9Q: sits out
*** HOLE CARDS ***
M1KyQQvVPVuxqTAB8sR/zQ: raises $1 to $1.50
1WUCqNG+p+vfWRTXNu4ljw: raises $3 to $4.50
uVwggSetzp7d+eVgowO3vg: folds
Ek4w9XqBXqK5jBUQeLedGw: folds
M1KyQQvVPVuxqTAB8sR/zQ: calls $3
*** FLOP *** [Ah Ks Jh]
M1KyQQvVPVuxqTAB8sR/zQ: checks
1WUCqNG+p+vfWRTXNu4ljw: bets $6.50
M1KyQQvVPVuxqTAB8sR/zQ: folds
1WUCqNG+p+vfWRTXNu4ljw collected $9.30 from pot
*** SUMMARY ***
Total pot $9.75 | Rake $0.45
Board [Ah Ks Jh]
Seat 1: 1WUCqNG+p+vfWRTXNu4ljw (button) collected ($9.30)
Seat 2: uVwggSetzp7d+eVgowO3vg (small blind) folded before Flop
Seat 3: Ek4w9XqBXqK5jBUQeLedGw (big blind) folded before Flop
Seat 5: M1KyQQvVPVuxqTAB8sR/zQ folded on the Flop



PokerStars Game #59939690504:  Hold'em No Limit ($0.25/$0.50) - 2009/07/01 0:46:24 ET
Table '+dXkOAQyS8j9PQZusUTMpg' 2-max Seat #1 is the button
Seat 1: XFa6sBGjP2gxoIvxR3fZIg ($49.90 in chips)
Seat 2: 5IBeOgaApY1Bvzv2P8X4EA ($153.65 in chips)
XFa6sBGjP2gxoIvxR3fZIg: posts small blind $0.25
5IBeOgaApY1Bvzv2P8X4EA: posts big blind $0.50
*** HOLE CARDS ***
XFa6sBGjP2gxoIvxR3fZIg: raises $1 to $1.50
5IBeOgaApY1Bvzv2P8X4EA: folds
XFa6sBGjP2gxoIvxR3fZIg collected $1 from pot
*** SUMMARY ***
Total pot $1 | Rake $0
Seat 1: XFa6sBGjP2gxoIvxR3fZIg (button) (small blind) collected ($1)
Seat 2: 5IBeOgaApY1Bvzv2P8X4EA (big blind) folded before Flop



PokerStars Game #59939692242:  Hold'em No Limit ($0.25/$0.50) - 2009/07/01 0:46:27 ET
Table '0eJtgVAXVvBgncFdcUpXcQ' 2-max Seat #2 is the button
Seat 1: Ag6DvxX4vbRheqsv2zXKTQ ($20 in chips)
Seat 2: KMc4R+K9ao4Ur3rF7NGe6Q ($28.90 in chips)
KMc4R+K9ao4Ur3rF7NGe6Q: posts small blind $0.25
Ag6DvxX4vbRheqsv2zXKTQ: posts big blind $0.50
*** HOLE CARDS ***
Ag6DvxX4vbRheqsv2zXKTQ said, "sure.."
KMc4R+K9ao4Ur3rF7NGe6Q: calls $0.25
Ag6DvxX4vbRheqsv2zXKTQ: checks
*** FLOP *** [Qc 3c Ac]
KMc4R+K9ao4Ur3rF7NGe6Q said, "sorry"
Ag6DvxX4vbRheqsv2zXKTQ said, "nice luck.."
Ag6DvxX4vbRheqsv2zXKTQ: checks
KMc4R+K9ao4Ur3rF7NGe6Q: checks
*** TURN *** [Qc 3c Ac] [Ts]
Ag6DvxX4vbRheqsv2zXKTQ: checks
KMc4R+K9ao4Ur3rF7NGe6Q: checks
*** RIVER *** [Qc 3c Ac Ts] [5h]
Ag6DvxX4vbRheqsv2zXKTQ: checks
KMc4R+K9ao4Ur3rF7NGe6Q said, "had plenty of my own tonight as well my man"
KMc4R+K9ao4Ur3rF7NGe6Q: checks
*** SHOW DOWN ***
Ag6DvxX4vbRheqsv2zXKTQ: shows [6h 5c] (a pair of Fives)
KMc4R+K9ao4Ur3rF7NGe6Q: mucks hand
Ag6DvxX4vbRheqsv2zXKTQ collected $0.95 from pot
*** SUMMARY ***
Total pot $1 | Rake $0.05
Board [Qc 3c Ac Ts 5h]
Seat 1: Ag6DvxX4vbRheqsv2zXKTQ (big blind) showed [6h 5c] and won ($0.95) with a pair of Fives
Seat 2: KMc4R+K9ao4Ur3rF7NGe6Q (button) (small blind) mucked



PokerStars Game #59939693610:  Hold'em No Limit ($0.25/$0.50) - 2009/07/01 0:46:29 ET
Table 'E7bWJ45aoFXRpyRv2gw+Ig' 2-max Seat #2 is the button
Seat 1: FRkiRasEGlHUeLrEl+k/nA ($70.40 in chips)
Seat 2: 3Wro85I7472vJ4Wkpneo9A ($124.60 in chips)
3Wro85I7472vJ4Wkpneo9A: posts small blind $0.25
FRkiRasEGlHUeLrEl+k/nA: posts big blind $0.50
*** HOLE CARDS ***
3Wro85I7472vJ4Wkpneo9A: raises $1 to $1.50
FRkiRasEGlHUeLrEl+k/nA: calls $1
*** FLOP *** [3d Td Kh]
FRkiRasEGlHUeLrEl+k/nA: checks
3Wro85I7472vJ4Wkpneo9A: checks
*** TURN *** [3d Td Kh] [9s]
FRkiRasEGlHUeLrEl+k/nA: checks
3Wro85I7472vJ4Wkpneo9A: checks
*** RIVER *** [3d Td Kh 9s] [Ah]
FRkiRasEGlHUeLrEl+k/nA: checks
3Wro85I7472vJ4Wkpneo9A: checks
*** SHOW DOWN ***
FRkiRasEGlHUeLrEl+k/nA: shows [2c 2d] (a pair of Deuces)
3Wro85I7472vJ4Wkpneo9A: mucks hand
FRkiRasEGlHUeLrEl+k/nA collected $2.85 from pot
*** SUMMARY ***
Total pot $3 | Rake $0.15
Board [3d Td Kh 9s Ah]
Seat 1: FRkiRasEGlHUeLrEl+k/nA (big blind) showed [2c 2d] and won ($2.85) with a pair of Deuces
Seat 2: 3Wro85I7472vJ4Wkpneo9A (button) (small blind) mucked



PokerStars Game #59939693686:  Hold'em No Limit ($0.25/$0.50) - 2009/07/01 0:46:29 ET
Table '+z1aekfHkpp09pc8F9aViw' 6-max Seat #6 is the button
Seat 1: FHilMb2i2DbUCc9lplszog ($38.10 in chips)
Seat 2: M6xK/VklCvdyyrmvzATlxQ ($36 in chips)
Seat 3: uUznlIMFnRUvwrBhYF73KA ($107.45 in chips)
Seat 4: RowCSpSURHTOL/dcjg/Iug ($50.05 in chips)
Seat 5: crjGpJEzSZgD38FoE3VMGg ($50 in chips)
Seat 6: 686aeHikcJlgKkSuIFdcXQ ($64.60 in chips)
FHilMb2i2DbUCc9lplszog: posts small blind $0.25
M6xK/VklCvdyyrmvzATlxQ: posts big blind $0.50
*** HOLE CARDS ***
uUznlIMFnRUvwrBhYF73KA has timed out
uUznlIMFnRUvwrBhYF73KA: folds
uUznlIMFnRUvwrBhYF73KA is sitting out
uUznlIMFnRUvwrBhYF73KA has returned
RowCSpSURHTOL/dcjg/Iug: folds
crjGpJEzSZgD38FoE3VMGg: folds
686aeHikcJlgKkSuIFdcXQ: folds
FHilMb2i2DbUCc9lplszog: raises $1 to $1.50
M6xK/VklCvdyyrmvzATlxQ: folds
FHilMb2i2DbUCc9lplszog collected $1 from pot
*** SUMMARY ***
Total pot $1 | Rake $0
Seat 1: FHilMb2i2DbUCc9lplszog (small blind) collected ($1)
Seat 2: M6xK/VklCvdyyrmvzATlxQ (big blind) folded before Flop
Seat 3: uUznlIMFnRUvwrBhYF73KA folded before Flop (didn't bet)
Seat 4: RowCSpSURHTOL/dcjg/Iug folded before Flop (didn't bet)
Seat 5: crjGpJEzSZgD38FoE3VMGg folded before Flop (didn't bet)
Seat 6: 686aeHikcJlgKkSuIFdcXQ (button) folded before Flop (didn't bet)



PokerStars Game #59939694556:  Hold'em No Limit ($0.25/$0.50) - 2009/07/01 0:46:30 ET
Table 'c/CRn+68J3Y8KxD5g1ek2Q' 2-max Seat #1 is the button
Seat 1: 46qCyJ6evTkHo9al5sBMNA ($231.70 in chips)
Seat 2: BypVLsYQt3ePFm2xQL/dOA ($141.80 in chips)
46qCyJ6evTkHo9al5sBMNA: posts small blind $0.25
BypVLsYQt3ePFm2xQL/dOA: posts big blind $0.50
*** HOLE CARDS ***
46qCyJ6evTkHo9al5sBMNA: folds
BypVLsYQt3ePFm2xQL/dOA collected $0.50 from pot
BypVLsYQt3ePFm2xQL/dOA: doesn't show hand
*** SUMMARY ***
Total pot $0.50 | Rake $0
Seat 1: 46qCyJ6evTkHo9al5sBMNA (button) (small blind) folded before Flop
Seat 2: BypVLsYQt3ePFm2xQL/dOA (big blind) collected ($0.50)



PokerStars Game #59939695744:  Hold'em No Limit ($0.25/$0.50) - 2009/07/01 0:46:32 ET
Table '+dXkOAQyS8j9PQZusUTMpg' 2-max Seat #2 is the button
Seat 1: XFa6sBGjP2gxoIvxR3fZIg ($50.40 in chips)
Seat 2: 5IBeOgaApY1Bvzv2P8X4EA ($153.15 in chips)
5IBeOgaApY1Bvzv2P8X4EA: posts small blind $0.25
XFa6sBGjP2gxoIvxR3fZIg: posts big blind $0.50
*** HOLE CARDS ***
5IBeOgaApY1Bvzv2P8X4EA: folds
XFa6sBGjP2gxoIvxR3fZIg collected $0.50 from pot
XFa6sBGjP2gxoIvxR3fZIg: doesn't show hand
*** SUMMARY ***
Total pot $0.50 | Rake $0
Seat 1: XFa6sBGjP2gxoIvxR3fZIg (big blind) collected ($0.50)
Seat 2: 5IBeOgaApY1Bvzv2P8X4EA (button) (small blind) folded before Flop



PokerStars Game #59939695992:  Hold'em No Limit ($0.25/$0.50) - 2009/07/01 0:46:33 ET
Table 'Vdlc9wqYcHTUhtdyN7CuJw' 2-max Seat #2 is the button
Seat 1: yBO+mXB6m/rCft2ErwGf/Q ($116.30 in chips)
Seat 2: NZ/5cxwnorKW2SNsWy1+8A ($9.50 in chips)
NZ/5cxwnorKW2SNsWy1+8A: posts small blind $0.25
yBO+mXB6m/rCft2ErwGf/Q: posts big blind $0.50
*** HOLE CARDS ***
NZ/5cxwnorKW2SNsWy1+8A: folds
yBO+mXB6m/rCft2ErwGf/Q collected $0.50 from pot
*** SUMMARY ***
Total pot $0.50 | Rake $0
Seat 1: yBO+mXB6m/rCft2ErwGf/Q (big blind) collected ($0.50)
Seat 2: NZ/5cxwnorKW2SNsWy1+8A (button) (small blind) folded before Flop



PokerStars Game #59939697948:  Hold'em No Limit ($0.25/$0.50) - 2009/07/01 0:46:36 ET
Table 'MJxeZCzYELxiIsyUZyT0jw' 6-max Seat #4 is the button
Seat 1: jNIq+EZLEm61oWSMYUVeWQ ($4.30 in chips)
Seat 3: JQZew0FjzS19kTjeNtrE+A ($59.75 in chips)
Seat 4: alGiiQP/wwtYnfuXII+sgw ($44.95 in chips)
Seat 5: 3jvoOXNtXE90w2BdfNZwZQ ($51.50 in chips)
Seat 6: TTx3CHxyi0SObcHyMJRp5w ($57.45 in chips)
3jvoOXNtXE90w2BdfNZwZQ: posts small blind $0.25
TTx3CHxyi0SObcHyMJRp5w: posts big blind $0.50
*** HOLE CARDS ***
jNIq+EZLEm61oWSMYUVeWQ: calls $0.50
JQZew0FjzS19kTjeNtrE+A: folds
alGiiQP/wwtYnfuXII+sgw: calls $0.50
3jvoOXNtXE90w2BdfNZwZQ: calls $0.25
TTx3CHxyi0SObcHyMJRp5w: checks
*** FLOP *** [Th 7s 6h]
3jvoOXNtXE90w2BdfNZwZQ: bets $1.50
TTx3CHxyi0SObcHyMJRp5w: folds
jNIq+EZLEm61oWSMYUVeWQ: folds
alGiiQP/wwtYnfuXII+sgw: calls $1.50
*** TURN *** [Th 7s 6h] [Qh]
3jvoOXNtXE90w2BdfNZwZQ: checks
t3GiVMzqA9Svgr5Uol32cQ joins the table at seat #2
alGiiQP/wwtYnfuXII+sgw: bets $2.50
3jvoOXNtXE90w2BdfNZwZQ: folds
alGiiQP/wwtYnfuXII+sgw collected $4.80 from pot
*** SUMMARY ***
Total pot $5 | Rake $0.20
Board [Th 7s 6h Qh]
Seat 1: jNIq+EZLEm61oWSMYUVeWQ folded on the Flop
Seat 3: JQZew0FjzS19kTjeNtrE+A folded before Flop (didn't bet)
Seat 4: alGiiQP/wwtYnfuXII+sgw (button) collected ($4.80)
Seat 5: 3jvoOXNtXE90w2BdfNZwZQ (small blind) folded on the Turn
Seat 6: TTx3CHxyi0SObcHyMJRp5w (big blind) folded on the Flop



PokerStars Game #59939698234:  Hold'em No Limit ($0.25/$0.50) - 2009/07/01 0:46:36 ET
Table 'lSisgp6H7Fg1hH5VfjEjYQ' 9-max Seat #6 is the button
Seat 1: 5k9fvXD9suIgCxU4HLQjTw ($50 in chips)
Seat 2: UrcnkQOiLVk8BlKDPJSy7Q ($50 in chips)
Seat 3: aTkyjTh3w5YLWiIERupZOA ($51.95 in chips)
Seat 4: bwv/rbH/hHhPhY6u9mu04w ($30.50 in chips)
Seat 5: mSD1pginDsyHG5PDfqzphw ($11.35 in chips)
Seat 6: +k7T5ocke8UwavtgUHm+Cg ($35.10 in chips)
Seat 7: Y3DZ6qQlLeBhixDj4M9vmg ($9.80 in chips)
Seat 8: a4JDWmpFQkL10XfAyuF51A ($31.25 in chips)
Seat 9: gsyXT42WLEcOS4DdEk2wlw ($30.20 in chips)
Y3DZ6qQlLeBhixDj4M9vmg: posts small blind $0.25
a4JDWmpFQkL10XfAyuF51A: posts big blind $0.50
*** HOLE CARDS ***
gsyXT42WLEcOS4DdEk2wlw: calls $0.50
5k9fvXD9suIgCxU4HLQjTw: folds
UrcnkQOiLVk8BlKDPJSy7Q: folds
aTkyjTh3w5YLWiIERupZOA: folds
bwv/rbH/hHhPhY6u9mu04w: folds
mSD1pginDsyHG5PDfqzphw: folds
+k7T5ocke8UwavtgUHm+Cg: calls $0.50
Y3DZ6qQlLeBhixDj4M9vmg: calls $0.25
a4JDWmpFQkL10XfAyuF51A: checks
*** FLOP *** [Ad Ts 4d]
Y3DZ6qQlLeBhixDj4M9vmg: checks
a4JDWmpFQkL10XfAyuF51A: checks
gsyXT42WLEcOS4DdEk2wlw: bets $1
+k7T5ocke8UwavtgUHm+Cg: folds
Y3DZ6qQlLeBhixDj4M9vmg: folds
a4JDWmpFQkL10XfAyuF51A: folds
gsyXT42WLEcOS4DdEk2wlw collected $1.90 from pot
*** SUMMARY ***
Total pot $2 | Rake $0.10
Board [Ad Ts 4d]
Seat 1: 5k9fvXD9suIgCxU4HLQjTw folded before Flop (didn't bet)
Seat 2: UrcnkQOiLVk8BlKDPJSy7Q folded before Flop (didn't bet)
Seat 3: aTkyjTh3w5YLWiIERupZOA folded before Flop (didn't bet)
Seat 4: bwv/rbH/hHhPhY6u9mu04w folded before Flop (didn't bet)
Seat 5: mSD1pginDsyHG5PDfqzphw folded before Flop (didn't bet)
Seat 6: +k7T5ocke8UwavtgUHm+Cg (button) folded on the Flop
Seat 7: Y3DZ6qQlLeBhixDj4M9vmg (small blind) folded on the Flop
Seat 8: a4JDWmpFQkL10XfAyuF51A (big blind) folded on the Flop
Seat 9: gsyXT42WLEcOS4DdEk2wlw collected ($1.90)



PokerStars Game #59939699742:  Hold'em No Limit ($0.25/$0.50) - 2009/07/01 0:46:39 ET
Table 'EiNh8p/wGJ1FP575iMFnqg' 9-max Seat #9 is the button
Seat 1: r3ZqM1Mi0W3y4hOdssE+Sg ($45.90 in chips)
Seat 2: 8ehL7qlZzjgUh2H35iiWLw ($53.35 in chips)
Seat 3: ymLPoEIl7UL3TvZYmnadxQ ($48.10 in chips)
Seat 4: cMzaiXAM/ZAdNaEUu+LqhA ($50 in chips)
Seat 5: M+7+BTmX5vZatHVuoRB1nA ($80.80 in chips)
Seat 6: 3UmXLy3GfjC3EkOebduerQ ($66.85 in chips)
Seat 7: 997ViqAtWn1FPjJqcffwcA ($50 in chips)
Seat 8: KrPAGRACBg+w0M//SXe8Ag ($8.40 in chips)
Seat 9: NnQCepdIR/AOUQn1yhYx6Q ($9.25 in chips)
r3ZqM1Mi0W3y4hOdssE+Sg: posts small blind $0.25
8ehL7qlZzjgUh2H35iiWLw: posts big blind $0.50
*** HOLE CARDS ***
ymLPoEIl7UL3TvZYmnadxQ: calls $0.50
cMzaiXAM/ZAdNaEUu+LqhA: folds
M+7+BTmX5vZatHVuoRB1nA: raises $1 to $1.50
3UmXLy3GfjC3EkOebduerQ: folds
997ViqAtWn1FPjJqcffwcA: folds
KrPAGRACBg+w0M//SXe8Ag: calls $1.50
NnQCepdIR/AOUQn1yhYx6Q: folds
r3ZqM1Mi0W3y4hOdssE+Sg: calls $1.25
8ehL7qlZzjgUh2H35iiWLw: folds
ymLPoEIl7UL3TvZYmnadxQ: raises $6 to $7.50
M+7+BTmX5vZatHVuoRB1nA: folds
KrPAGRACBg+w0M//SXe8Ag: folds
r3ZqM1Mi0W3y4hOdssE+Sg: folds
ymLPoEIl7UL3TvZYmnadxQ collected $6.50 from pot
ymLPoEIl7UL3TvZYmnadxQ: doesn't show hand
*** SUMMARY ***
Total pot $6.50 | Rake $0
Seat 1: r3ZqM1Mi0W3y4hOdssE+Sg (small blind) folded before Flop
Seat 2: 8ehL7qlZzjgUh2H35iiWLw (big blind) folded before Flop
Seat 3: ymLPoEIl7UL3TvZYmnadxQ collected ($6.50)
Seat 4: cMzaiXAM/ZAdNaEUu+LqhA folded before Flop (didn't bet)
Seat 5: M+7+BTmX5vZatHVuoRB1nA folded before Flop
Seat 6: 3UmXLy3GfjC3EkOebduerQ folded before Flop (didn't bet)
Seat 7: 997ViqAtWn1FPjJqcffwcA folded before Flop (didn't bet)
Seat 8: KrPAGRACBg+w0M//SXe8Ag folded before Flop
Seat 9: NnQCepdIR/AOUQn1yhYx6Q (button) folded before Flop (didn't bet)



PokerStars Game #59939699826:  Hold'em No Limit ($0.25/$0.50) - 2009/07/01 0:46:39 ET
Table 'c/CRn+68J3Y8KxD5g1ek2Q' 2-max Seat #2 is the button
Seat 1: 46qCyJ6evTkHo9al5sBMNA ($231.45 in chips)
Seat 2: BypVLsYQt3ePFm2xQL/dOA ($142.05 in chips)
BypVLsYQt3ePFm2xQL/dOA: posts small blind $0.25
46qCyJ6evTkHo9al5sBMNA: posts big blind $0.50
*** HOLE CARDS ***
BypVLsYQt3ePFm2xQL/dOA said, "royal flush"
BypVLsYQt3ePFm2xQL/dOA: raises $1 to $1.50
46qCyJ6evTkHo9al5sBMNA: calls $1
*** FLOP *** [7h Js 6d]
46qCyJ6evTkHo9al5sBMNA: checks
BypVLsYQt3ePFm2xQL/dOA: checks
*** TURN *** [7h Js 6d] [Qs]
46qCyJ6evTkHo9al5sBMNA: checks
BypVLsYQt3ePFm2xQL/dOA: checks
*** RIVER *** [7h Js 6d Qs] [9c]
46qCyJ6evTkHo9al5sBMNA said, "did u?"
46qCyJ6evTkHo9al5sBMNA: checks
BypVLsYQt3ePFm2xQL/dOA: checks
*** SHOW DOWN ***
46qCyJ6evTkHo9al5sBMNA: shows [Tc Ah] (high card Ace)
BypVLsYQt3ePFm2xQL/dOA: mucks hand
46qCyJ6evTkHo9al5sBMNA collected $2.85 from pot
*** SUMMARY ***
Total pot $3 | Rake $0.15
Board [7h Js 6d Qs 9c]
Seat 1: 46qCyJ6evTkHo9al5sBMNA (big blind) showed [Tc Ah] and won ($2.85) with high card Ace
Seat 2: BypVLsYQt3ePFm2xQL/dOA (button) (small blind) mucked



PokerStars Game #59939699858:  Hold'em No Limit ($0.25/$0.50) - 2009/07/01 0:46:39 ET
Table 'Vdlc9wqYcHTUhtdyN7CuJw' 2-max Seat #1 is the button
Seat 1: yBO+mXB6m/rCft2ErwGf/Q ($116.55 in chips)
Seat 2: NZ/5cxwnorKW2SNsWy1+8A ($9.25 in chips)
yBO+mXB6m/rCft2ErwGf/Q: posts small blind $0.25
NZ/5cxwnorKW2SNsWy1+8A: posts big blind $0.50
*** HOLE CARDS ***
yBO+mXB6m/rCft2ErwGf/Q: raises $1 to $1.50
NZ/5cxwnorKW2SNsWy1+8A: folds
yBO+mXB6m/rCft2ErwGf/Q collected $1 from pot
*** SUMMARY ***
Total pot $1 | Rake $0
Seat 1: yBO+mXB6m/rCft2ErwGf/Q (button) (small blind) collected ($1)
Seat 2: NZ/5cxwnorKW2SNsWy1+8A (big blind) folded before Flop



PokerStars Game #59939699854:  Hold'em No Limit ($0.25/$0.50) - 2009/07/01 0:46:39 ET
Table '+dXkOAQyS8j9PQZusUTMpg' 2-max Seat #1 is the button
Seat 1: XFa6sBGjP2gxoIvxR3fZIg ($50.65 in chips)
Seat 2: 5IBeOgaApY1Bvzv2P8X4EA ($152.90 in chips)
XFa6sBGjP2gxoIvxR3fZIg: posts small blind $0.25
5IBeOgaApY1Bvzv2P8X4EA: posts big blind $0.50
*** HOLE CARDS ***
XFa6sBGjP2gxoIvxR3fZIg: raises $1 to $1.50
5IBeOgaApY1Bvzv2P8X4EA: folds
XFa6sBGjP2gxoIvxR3fZIg collected $1 from pot
*** SUMMARY ***
Total pot $1 | Rake $0
Seat 1: XFa6sBGjP2gxoIvxR3fZIg (button) (small blind) collected ($1)
Seat 2: 5IBeOgaApY1Bvzv2P8X4EA (big blind) folded before Flop



PokerStars Game #59939701172:  Hold'em No Limit ($0.25/$0.50) - 2009/07/01 0:46:41 ET
Table '+111aLuBwnz8YVYSA7J1jA' 2-max Seat #2 is the button
Seat 1: ndd1nfncBkWNitBnsfCoVQ ($77.10 in chips)
Seat 2: +ciXH35zeafrjg1W6wiBTg ($70.65 in chips)
+ciXH35zeafrjg1W6wiBTg: posts small blind $0.25
ndd1nfncBkWNitBnsfCoVQ: posts big blind $0.50
*** HOLE CARDS ***
+ciXH35zeafrjg1W6wiBTg: raises $1 to $1.50
ndd1nfncBkWNitBnsfCoVQ: calls $1
*** FLOP *** [Ah Tc 7h]
ndd1nfncBkWNitBnsfCoVQ: checks
+ciXH35zeafrjg1W6wiBTg: bets $1.50
ndd1nfncBkWNitBnsfCoVQ: folds
+ciXH35zeafrjg1W6wiBTg collected $2.85 from pot
+ciXH35zeafrjg1W6wiBTg: doesn't show hand
*** SUMMARY ***
Total pot $3 | Rake $0.15
Board [Ah Tc 7h]
Seat 1: ndd1nfncBkWNitBnsfCoVQ (big blind) folded on the Flop
Seat 2: +ciXH35zeafrjg1W6wiBTg (button) (small blind) collected ($2.85)



PokerStars Game #59939702468:  Hold'em No Limit ($0.25/$0.50) - 2009/07/01 0:46:43 ET
Table 'NCiXr0d5CEKBQr/cZgLhbA' 9-max Seat #9 is the button
Seat 1: pFtzb1sR4b0d1aw6aIRgDg ($50 in chips)
Seat 2: ulxuJchBV9iguXg0FUonfg ($50.50 in chips)
Seat 3: xZCXQSXlrZkp3pZizzVXCw ($50.75 in chips)
Seat 4: 5k9fvXD9suIgCxU4HLQjTw ($56.70 in chips)
Seat 5: zE9cVigS2nW/Ljy4K4bUQA ($36.70 in chips)
Seat 6: SKnJuWHScqetA/qG5p+wCg ($33.45 in chips)
Seat 7: M+7+BTmX5vZatHVuoRB1nA ($47.60 in chips)
Seat 8: 1MJUKc3cc0QmUoz1JZLR2w ($57.25 in chips)
Seat 9: 4WLZvqBn5qv5tds5kt5A1Q ($45.80 in chips)
pFtzb1sR4b0d1aw6aIRgDg: posts small blind $0.25
ulxuJchBV9iguXg0FUonfg: posts big blind $0.50
*** HOLE CARDS ***
xZCXQSXlrZkp3pZizzVXCw: raises $1 to $1.50
5k9fvXD9suIgCxU4HLQjTw: folds
zE9cVigS2nW/Ljy4K4bUQA: folds
SKnJuWHScqetA/qG5p+wCg: folds
M+7+BTmX5vZatHVuoRB1nA: folds
1MJUKc3cc0QmUoz1JZLR2w: folds
4WLZvqBn5qv5tds5kt5A1Q: folds
pFtzb1sR4b0d1aw6aIRgDg: folds
ulxuJchBV9iguXg0FUonfg: folds
xZCXQSXlrZkp3pZizzVXCw collected $1.25 from pot
*** SUMMARY ***
Total pot $1.25 | Rake $0
Seat 1: pFtzb1sR4b0d1aw6aIRgDg (small blind) folded before Flop
Seat 2: ulxuJchBV9iguXg0FUonfg (big blind) folded before Flop
Seat 3: xZCXQSXlrZkp3pZizzVXCw collected ($1.25)
Seat 4: 5k9fvXD9suIgCxU4HLQjTw folded before Flop (didn't bet)
Seat 5: zE9cVigS2nW/Ljy4K4bUQA folded before Flop (didn't bet)
Seat 6: SKnJuWHScqetA/qG5p+wCg folded before Flop (didn't bet)
Seat 7: M+7+BTmX5vZatHVuoRB1nA folded before Flop (didn't bet)
Seat 8: 1MJUKc3cc0QmUoz1JZLR2w folded before Flop (didn't bet)
Seat 9: 4WLZvqBn5qv5tds5kt5A1Q (button) folded before Flop (didn't bet)



PokerStars Game #59939703110:  Hold'em No Limit ($0.25/$0.50) - 2009/07/01 0:46:44 ET
Table 'QOeVnLhwctF9UyV/beDi+A' 2-max Seat #2 is the button
Seat 1: bypIyrYcAAifLfhZpGlKLA ($64.25 in chips)
Seat 2: Ucrm3XtZmoONapW32SPhag ($18.45 in chips)
Ucrm3XtZmoONapW32SPhag: posts small blind $0.25
bypIyrYcAAifLfhZpGlKLA: posts big blind $0.50
*** HOLE CARDS ***
Ucrm3XtZmoONapW32SPhag: calls $0.25
bypIyrYcAAifLfhZpGlKLA: checks
*** FLOP *** [4c 6d Qc]
bypIyrYcAAifLfhZpGlKLA: bets $0.50
Ucrm3XtZmoONapW32SPhag: raises $2.50 to $3
bypIyrYcAAifLfhZpGlKLA: folds
Ucrm3XtZmoONapW32SPhag collected $1.95 from pot
Ucrm3XtZmoONapW32SPhag: doesn't show hand
*** SUMMARY ***
Total pot $2 | Rake $0.05
Board [4c 6d Qc]
Seat 1: bypIyrYcAAifLfhZpGlKLA (big blind) folded on the Flop
Seat 2: Ucrm3XtZmoONapW32SPhag (button) (small blind) collected ($1.95)



PokerStars Game #59939704228:  Hold'em No Limit ($0.25/$0.50) - 2009/07/01 0:46:46 ET
Table '+dXkOAQyS8j9PQZusUTMpg' 2-max Seat #2 is the button
Seat 1: XFa6sBGjP2gxoIvxR3fZIg ($51.15 in chips)
Seat 2: 5IBeOgaApY1Bvzv2P8X4EA ($152.40 in chips)
5IBeOgaApY1Bvzv2P8X4EA: posts small blind $0.25
XFa6sBGjP2gxoIvxR3fZIg: posts big blind $0.50
*** HOLE CARDS ***
5IBeOgaApY1Bvzv2P8X4EA: folds
XFa6sBGjP2gxoIvxR3fZIg collected $0.50 from pot
*** SUMMARY ***
Total pot $0.50 | Rake $0
Seat 1: XFa6sBGjP2gxoIvxR3fZIg (big blind) collected ($0.50)
Seat 2: 5IBeOgaApY1Bvzv2P8X4EA (button) (small blind) folded before Flop



PokerStars Game #59939704548:  Hold'em No Limit ($0.25/$0.50) - 2009/07/01 0:46:46 ET
Table 'ibNfFy0bCzuBaUORla0aGw' 9-max Seat #7 is the button
Seat 1: xZCXQSXlrZkp3pZizzVXCw ($53.20 in chips)
Seat 2: 90Wb75h3W1BRpbqVnuk8gw ($51.40 in chips)
Seat 3: dDaHs3X8+fe3bIkRU0cbrw ($40.15 in chips)
Seat 4: YBN054X4blmis+B2bBlC0g ($23.45 in chips)
Seat 5: GIJAc9kPrLZHLSX8Q6i99w ($24.70 in chips)
Seat 6: 8n9jQLh3cZKbsmr5PIjgiQ ($43.25 in chips)
Seat 7: HZkVla4kK2SI42CVrPZ/ig ($13.55 in chips)
Seat 8: xUrN9TWLq4m5V+OXY7KUUA ($50.70 in chips)
Seat 9: pFtzb1sR4b0d1aw6aIRgDg ($50.75 in chips)
xUrN9TWLq4m5V+OXY7KUUA: posts small blind $0.25
pFtzb1sR4b0d1aw6aIRgDg: posts big blind $0.50
*** HOLE CARDS ***
xZCXQSXlrZkp3pZizzVXCw: folds
90Wb75h3W1BRpbqVnuk8gw: folds
dDaHs3X8+fe3bIkRU0cbrw: folds
YBN054X4blmis+B2bBlC0g: folds
GIJAc9kPrLZHLSX8Q6i99w: calls $0.50
8n9jQLh3cZKbsmr5PIjgiQ: folds
HZkVla4kK2SI42CVrPZ/ig: folds
xUrN9TWLq4m5V+OXY7KUUA: folds
pFtzb1sR4b0d1aw6aIRgDg: checks
*** FLOP *** [Qs 5s Js]
pFtzb1sR4b0d1aw6aIRgDg: checks
GIJAc9kPrLZHLSX8Q6i99w: checks
*** TURN *** [Qs 5s Js] [3d]
pFtzb1sR4b0d1aw6aIRgDg: checks
GIJAc9kPrLZHLSX8Q6i99w: bets $1.50
pFtzb1sR4b0d1aw6aIRgDg: folds
GIJAc9kPrLZHLSX8Q6i99w collected $1.20 from pot
*** SUMMARY ***
Total pot $1.25 | Rake $0.05
Board [Qs 5s Js 3d]
Seat 1: xZCXQSXlrZkp3pZizzVXCw folded before Flop (didn't bet)
Seat 2: 90Wb75h3W1BRpbqVnuk8gw folded before Flop (didn't bet)
Seat 3: dDaHs3X8+fe3bIkRU0cbrw folded before Flop (didn't bet)
Seat 4: YBN054X4blmis+B2bBlC0g folded before Flop (didn't bet)
Seat 5: GIJAc9kPrLZHLSX8Q6i99w collected ($1.20)
Seat 6: 8n9jQLh3cZKbsmr5PIjgiQ folded before Flop (didn't bet)
Seat 7: HZkVla4kK2SI42CVrPZ/ig (button) folded before Flop (didn't bet)
Seat 8: xUrN9TWLq4m5V+OXY7KUUA (small blind) folded before Flop
Seat 9: pFtzb1sR4b0d1aw6aIRgDg (big blind) folded on the Turn



PokerStars Game #59939705232:  Hold'em No Limit ($0.25/$0.50) - 2009/07/01 0:46:47 ET
Table 'otvGDROEDdqsabxskT79qg' 9-max Seat #4 is the button
Seat 1: 8ehL7qlZzjgUh2H35iiWLw ($55.25 in chips)
Seat 2: cCjTzH9jio8607WzjcfXlg ($12.25 in chips)
Seat 3: +k7T5ocke8UwavtgUHm+Cg ($62.05 in chips)
Seat 4: MG90wfSJZnOejs/KD3vlQQ ($69.95 in chips)
Seat 5: XNMDwbXt/Q4jM99AXnbJDw ($53.80 in chips)
Seat 6: bxLSulbgr8LmKNjOzw8URg ($49.90 in chips)
Seat 7: C7+tBppJrKgd/r+tuKUIpA ($37.85 in chips)
Seat 8: zE9cVigS2nW/Ljy4K4bUQA ($30 in chips)
Seat 9: KcY3X8YpD74Kw1RHkx/g4A ($65.20 in chips)
XNMDwbXt/Q4jM99AXnbJDw: posts small blind $0.25
bxLSulbgr8LmKNjOzw8URg: posts big blind $0.50
*** HOLE CARDS ***
C7+tBppJrKgd/r+tuKUIpA: folds
zE9cVigS2nW/Ljy4K4bUQA: folds
KcY3X8YpD74Kw1RHkx/g4A: calls $0.50
8ehL7qlZzjgUh2H35iiWLw: folds
cCjTzH9jio8607WzjcfXlg: folds
+k7T5ocke8UwavtgUHm+Cg: calls $0.50
MG90wfSJZnOejs/KD3vlQQ: folds
XNMDwbXt/Q4jM99AXnbJDw: folds
bxLSulbgr8LmKNjOzw8URg: checks
*** FLOP *** [6s Ac 2s]
bxLSulbgr8LmKNjOzw8URg: checks
KcY3X8YpD74Kw1RHkx/g4A: bets $1
+k7T5ocke8UwavtgUHm+Cg: folds
bxLSulbgr8LmKNjOzw8URg: folds
KcY3X8YpD74Kw1RHkx/g4A collected $1.70 from pot
*** SUMMARY ***
Total pot $1.75 | Rake $0.05
Board [6s Ac 2s]
Seat 1: 8ehL7qlZzjgUh2H35iiWLw folded before Flop (didn't bet)
Seat 2: cCjTzH9jio8607WzjcfXlg folded before Flop (didn't bet)
Seat 3: +k7T5ocke8UwavtgUHm+Cg folded on the Flop
Seat 4: MG90wfSJZnOejs/KD3vlQQ (button) folded before Flop (didn't bet)
Seat 5: XNMDwbXt/Q4jM99AXnbJDw (small blind) folded before Flop
Seat 6: bxLSulbgr8LmKNjOzw8URg (big blind) folded on the Flop
Seat 7: C7+tBppJrKgd/r+tuKUIpA folded before Flop (didn't bet)
Seat 8: zE9cVigS2nW/Ljy4K4bUQA folded before Flop (didn't bet)
Seat 9: KcY3X8YpD74Kw1RHkx/g4A collected ($1.70)



PokerStars Game #59939706268:  Hold'em No Limit ($0.25/$0.50) - 2009/07/01 0:46:49 ET
Table 'T/PgNWqVyY6lkldcBVXYJQ' 6-max Seat #1 is the button
Seat 1: +Pf9jTVizYlIo+woPvptfA ($56.25 in chips)
Seat 2: LvH4G7n+QSjT6NDaD3cREA ($61.25 in chips)
Seat 3: L3OcNO1bgdqDI46j67KQPQ ($50.75 in chips)
Seat 4: Ek4w9XqBXqK5jBUQeLedGw ($50 in chips)
Seat 5: vVQBckETtigfb5mAcyK0OA ($54.45 in chips)
Seat 6: cDzbog6kwmJp+LBeBq+iMQ ($41 in chips)
LvH4G7n+QSjT6NDaD3cREA: posts small blind $0.25
L3OcNO1bgdqDI46j67KQPQ: posts big blind $0.50
*** HOLE CARDS ***
Ek4w9XqBXqK5jBUQeLedGw: folds
vVQBckETtigfb5mAcyK0OA: calls $0.50
cDzbog6kwmJp+LBeBq+iMQ: calls $0.50
+Pf9jTVizYlIo+woPvptfA: calls $0.50
LvH4G7n+QSjT6NDaD3cREA: calls $0.25
L3OcNO1bgdqDI46j67KQPQ: checks
*** FLOP *** [Th 3h 6h]
cDzbog6kwmJp+LBeBq+iMQ said, "ouch i didnt even pair the board"
LvH4G7n+QSjT6NDaD3cREA: checks
cDzbog6kwmJp+LBeBq+iMQ said, "lol"
L3OcNO1bgdqDI46j67KQPQ: checks
vVQBckETtigfb5mAcyK0OA: checks
cDzbog6kwmJp+LBeBq+iMQ: checks
+Pf9jTVizYlIo+woPvptfA: checks
*** TURN *** [Th 3h 6h] [As]
LvH4G7n+QSjT6NDaD3cREA: checks
vVQBckETtigfb5mAcyK0OA said, "lol"
L3OcNO1bgdqDI46j67KQPQ: checks
vVQBckETtigfb5mAcyK0OA: bets $0.50
cDzbog6kwmJp+LBeBq+iMQ: raises $0.50 to $1
+Pf9jTVizYlIo+woPvptfA: folds
LvH4G7n+QSjT6NDaD3cREA: calls $1
L3OcNO1bgdqDI46j67KQPQ: folds
vVQBckETtigfb5mAcyK0OA: calls $0.50
*** RIVER *** [Th 3h 6h As] [3c]
LvH4G7n+QSjT6NDaD3cREA: checks
vVQBckETtigfb5mAcyK0OA: checks
cDzbog6kwmJp+LBeBq+iMQ: bets $5
LvH4G7n+QSjT6NDaD3cREA: folds
vVQBckETtigfb5mAcyK0OA: folds
cDzbog6kwmJp+LBeBq+iMQ collected $5.25 from pot
cDzbog6kwmJp+LBeBq+iMQ: doesn't show hand
*** SUMMARY ***
Total pot $5.50 | Rake $0.25
Board [Th 3h 6h As 3c]
Seat 1: +Pf9jTVizYlIo+woPvptfA (button) folded on the Turn
Seat 2: LvH4G7n+QSjT6NDaD3cREA (small blind) folded on the River
Seat 3: L3OcNO1bgdqDI46j67KQPQ (big blind) folded on the Turn
Seat 4: Ek4w9XqBXqK5jBUQeLedGw folded before Flop (didn't bet)
Seat 5: vVQBckETtigfb5mAcyK0OA folded on the River
Seat 6: cDzbog6kwmJp+LBeBq+iMQ collected ($5.25)



PokerStars Game #59939707926:  Hold'em No Limit ($0.25/$0.50) - 2009/07/01 0:46:51 ET
Table 'Vdlc9wqYcHTUhtdyN7CuJw' 2-max Seat #2 is the button
Seat 1: yBO+mXB6m/rCft2ErwGf/Q ($117.05 in chips)
Seat 2: NZ/5cxwnorKW2SNsWy1+8A ($8.75 in chips)
NZ/5cxwnorKW2SNsWy1+8A: posts small blind $0.25
yBO+mXB6m/rCft2ErwGf/Q: posts big blind $0.50
*** HOLE CARDS ***
NZ/5cxwnorKW2SNsWy1+8A: folds
yBO+mXB6m/rCft2ErwGf/Q collected $0.50 from pot
*** SUMMARY ***
Total pot $0.50 | Rake $0
Seat 1: yBO+mXB6m/rCft2ErwGf/Q (big blind) collected ($0.50)
Seat 2: NZ/5cxwnorKW2SNsWy1+8A (button) (small blind) folded before Flop



PokerStars Game #59939708408:  Hold'em No Limit ($0.25/$0.50) - 2009/07/01 0:46:52 ET
Table 'E7bWJ45aoFXRpyRv2gw+Ig' 2-max Seat #1 is the button
Seat 1: FRkiRasEGlHUeLrEl+k/nA ($71.75 in chips)
Seat 2: 3Wro85I7472vJ4Wkpneo9A ($123.10 in chips)
FRkiRasEGlHUeLrEl+k/nA: posts small blind $0.25
3Wro85I7472vJ4Wkpneo9A: posts big blind $0.50
*** HOLE CARDS ***
FRkiRasEGlHUeLrEl+k/nA: folds
3Wro85I7472vJ4Wkpneo9A collected $0.50 from pot
3Wro85I7472vJ4Wkpneo9A: doesn't show hand
*** SUMMARY ***
Total pot $0.50 | Rake $0
Seat 1: FRkiRasEGlHUeLrEl+k/nA (button) (small blind) folded before Flop
Seat 2: 3Wro85I7472vJ4Wkpneo9A (big blind) collected ($0.50)



PokerStars Game #59939708116:  Hold'em No Limit ($0.25/$0.50) - 2009/07/01 0:46:52 ET
Table '+dXkOAQyS8j9PQZusUTMpg' 2-max Seat #1 is the button
Seat 1: XFa6sBGjP2gxoIvxR3fZIg ($51.40 in chips)
Seat 2: 5IBeOgaApY1Bvzv2P8X4EA ($152.15 in chips)
XFa6sBGjP2gxoIvxR3fZIg: posts small blind $0.25
5IBeOgaApY1Bvzv2P8X4EA: posts big blind $0.50
*** HOLE CARDS ***
XFa6sBGjP2gxoIvxR3fZIg: raises $1 to $1.50
5IBeOgaApY1Bvzv2P8X4EA: folds
XFa6sBGjP2gxoIvxR3fZIg collected $1 from pot
XFa6sBGjP2gxoIvxR3fZIg: doesn't show hand
*** SUMMARY ***
Total pot $1 | Rake $0
Seat 1: XFa6sBGjP2gxoIvxR3fZIg (button) (small blind) collected ($1)
Seat 2: 5IBeOgaApY1Bvzv2P8X4EA (big blind) folded before Flop



PokerStars Game #59939708842:  Hold'em No Limit ($0.25/$0.50) - 2009/07/01 0:46:53 ET
Table 'fx6MqwfYAj/Rt86hBz2L3Q' 9-max Seat #4 is the button
Seat 1: SegjDnMxWMujiD57ESNL+g ($10 in chips)
Seat 2: C3rGXblctNcWI6JYPHhaEg ($8.50 in chips)
Seat 3: iadBi5AEt7gTBXbDSSnMYQ ($48.95 in chips)
Seat 4: gPEN9Zp33YTm/mu9/SYP1w ($23.30 in chips)
Seat 5: iAISe3dVeua8PUn2wwgDHw ($23.60 in chips)
Seat 6: 5k9fvXD9suIgCxU4HLQjTw ($50 in chips)
Seat 8: NnQCepdIR/AOUQn1yhYx6Q ($14.05 in chips)
Seat 9: HZkVla4kK2SI42CVrPZ/ig ($11.75 in chips)
iAISe3dVeua8PUn2wwgDHw: posts small blind $0.25
5k9fvXD9suIgCxU4HLQjTw: posts big blind $0.50
SKnJuWHScqetA/qG5p+wCg: sits out
*** HOLE CARDS ***
NnQCepdIR/AOUQn1yhYx6Q: folds
HZkVla4kK2SI42CVrPZ/ig: folds
SegjDnMxWMujiD57ESNL+g: folds
C3rGXblctNcWI6JYPHhaEg: calls $0.50
iadBi5AEt7gTBXbDSSnMYQ: folds
gPEN9Zp33YTm/mu9/SYP1w: folds
iAISe3dVeua8PUn2wwgDHw: folds
5k9fvXD9suIgCxU4HLQjTw: checks
*** FLOP *** [Jc 4s 9h]
5k9fvXD9suIgCxU4HLQjTw: checks
C3rGXblctNcWI6JYPHhaEg: checks
*** TURN *** [Jc 4s 9h] [4h]
5k9fvXD9suIgCxU4HLQjTw: checks
C3rGXblctNcWI6JYPHhaEg: bets $2
5k9fvXD9suIgCxU4HLQjTw: folds
C3rGXblctNcWI6JYPHhaEg collected $1.20 from pot
*** SUMMARY ***
Total pot $1.25 | Rake $0.05
Board [Jc 4s 9h 4h]
Seat 1: SegjDnMxWMujiD57ESNL+g folded before Flop (didn't bet)
Seat 2: C3rGXblctNcWI6JYPHhaEg collected ($1.20)
Seat 3: iadBi5AEt7gTBXbDSSnMYQ folded before Flop (didn't bet)
Seat 4: gPEN9Zp33YTm/mu9/SYP1w (button) folded before Flop (didn't bet)
Seat 5: iAISe3dVeua8PUn2wwgDHw (small blind) folded before Flop
Seat 6: 5k9fvXD9suIgCxU4HLQjTw (big blind) folded on the Turn
Seat 8: NnQCepdIR/AOUQn1yhYx6Q folded before Flop (didn't bet)
Seat 9: HZkVla4kK2SI42CVrPZ/ig folded before Flop (didn't bet)



PokerStars Game #59939708624:  Hold'em No Limit ($0.25/$0.50) - 2009/07/01 0:46:53 ET
Table '5EmHi+fnatGQQShcNmzOZQ' 6-max Seat #5 is the button
Seat 1: +SZCX3+7lnuhHKIu+PP9rg ($59.15 in chips)
Seat 2: vXIHnZ+dv/hwSBxyvGw7bQ ($50 in chips)
Seat 4: 1b+2BbjMN8qhR1WPqdE9VQ ($53.15 in chips)
Seat 5: kxPhs4ePFqMy52CInAJ2aw ($55.85 in chips)
Seat 6: 686aeHikcJlgKkSuIFdcXQ ($141.45 in chips)
686aeHikcJlgKkSuIFdcXQ: posts small blind $0.25
+SZCX3+7lnuhHKIu+PP9rg: posts big blind $0.50
TjmTe3bhs9dFz5gXX9x7Lw: sits out
*** HOLE CARDS ***
+SZCX3+7lnuhHKIu+PP9rg said, "thanks aa"
vXIHnZ+dv/hwSBxyvGw7bQ: raises $1 to $1.50
1b+2BbjMN8qhR1WPqdE9VQ: folds
kxPhs4ePFqMy52CInAJ2aw: folds
686aeHikcJlgKkSuIFdcXQ: folds
+SZCX3+7lnuhHKIu+PP9rg: folds
vXIHnZ+dv/hwSBxyvGw7bQ collected $1.25 from pot
vXIHnZ+dv/hwSBxyvGw7bQ: doesn't show hand
*** SUMMARY ***
Total pot $1.25 | Rake $0
Seat 1: +SZCX3+7lnuhHKIu+PP9rg (big blind) folded before Flop
Seat 2: vXIHnZ+dv/hwSBxyvGw7bQ collected ($1.25)
Seat 4: 1b+2BbjMN8qhR1WPqdE9VQ folded before Flop (didn't bet)
Seat 5: kxPhs4ePFqMy52CInAJ2aw (button) folded before Flop (didn't bet)
Seat 6: 686aeHikcJlgKkSuIFdcXQ (small blind) folded before Flop



PokerStars Game #59939710638:  Hold'em No Limit ($0.25/$0.50) - 2009/07/01 0:46:56 ET
Table '+111aLuBwnz8YVYSA7J1jA' 2-max Seat #1 is the button
Seat 1: ndd1nfncBkWNitBnsfCoVQ ($75.60 in chips)
Seat 2: +ciXH35zeafrjg1W6wiBTg ($72 in chips)
ndd1nfncBkWNitBnsfCoVQ: posts small blind $0.25
+ciXH35zeafrjg1W6wiBTg: posts big blind $0.50
*** HOLE CARDS ***
ndd1nfncBkWNitBnsfCoVQ: raises $1 to $1.50
+ciXH35zeafrjg1W6wiBTg: folds
ndd1nfncBkWNitBnsfCoVQ collected $1 from pot
ndd1nfncBkWNitBnsfCoVQ: doesn't show hand
*** SUMMARY ***
Total pot $1 | Rake $0
Seat 1: ndd1nfncBkWNitBnsfCoVQ (button) (small blind) collected ($1)
Seat 2: +ciXH35zeafrjg1W6wiBTg (big blind) folded before Flop



PokerStars Game #59939711260:  Hold'em No Limit ($0.25/$0.50) - 2009/07/01 0:46:57 ET
Table '3FhG0gl3kMX3wBEEqj+wnQ' 9-max Seat #4 is the button
Seat 1: e0J9pdCNUDTCG031RnXqLA ($35.55 in chips)
Seat 2: 7cYQ+syUWjl38ty/ICOMhw ($50 in chips)
Seat 4: bjvJtA9Hqscfznq66txaOQ ($9.50 in chips)
Seat 5: gsyXT42WLEcOS4DdEk2wlw ($28 in chips)
Seat 6: 997ViqAtWn1FPjJqcffwcA ($50 in chips)
Seat 7: mSD1pginDsyHG5PDfqzphw ($11.50 in chips)
Seat 8: j3K/Jujr7PY4ZM2RZvlH6A ($57.35 in chips)
Seat 9: L5e2lrPLQm1Pqx30IIZ/Fw ($10 in chips)
gsyXT42WLEcOS4DdEk2wlw: posts small blind $0.25
997ViqAtWn1FPjJqcffwcA: posts big blind $0.50
*** HOLE CARDS ***
mSD1pginDsyHG5PDfqzphw: folds
j3K/Jujr7PY4ZM2RZvlH6A: folds
L5e2lrPLQm1Pqx30IIZ/Fw: folds
e0J9pdCNUDTCG031RnXqLA: folds
7cYQ+syUWjl38ty/ICOMhw: folds
bjvJtA9Hqscfznq66txaOQ: folds
gsyXT42WLEcOS4DdEk2wlw: folds
997ViqAtWn1FPjJqcffwcA collected $0.50 from pot
997ViqAtWn1FPjJqcffwcA: doesn't show hand
*** SUMMARY ***
Total pot $0.50 | Rake $0
Seat 1: e0J9pdCNUDTCG031RnXqLA folded before Flop (didn't bet)
Seat 2: 7cYQ+syUWjl38ty/ICOMhw folded before Flop (didn't bet)
Seat 4: bjvJtA9Hqscfznq66txaOQ (button) folded before Flop (didn't bet)
Seat 5: gsyXT42WLEcOS4DdEk2wlw (small blind) folded before Flop
Seat 6: 997ViqAtWn1FPjJqcffwcA (big blind) collected ($0.50)
Seat 7: mSD1pginDsyHG5PDfqzphw folded before Flop (didn't bet)
Seat 8: j3K/Jujr7PY4ZM2RZvlH6A folded before Flop (didn't bet)
Seat 9: L5e2lrPLQm1Pqx30IIZ/Fw folded before Flop (didn't bet)



PokerStars Game #59939711782:  Hold'em No Limit ($0.25/$0.50) - 2009/07/01 0:46:57 ET
Table 'lpxYasB1ClBSgTpCCITwhQ' 9-max Seat #7 is the button
Seat 1: mj7PS7wCH4PAl7+eYTFs7A ($48.65 in chips)
Seat 2: OWP/DOu+PlPK6ZZ3zYa0HA ($20.50 in chips)
Seat 3: cDNz32Scry3j+v2+kE3pHg ($50 in chips)
Seat 4: o4Jr+EJ272Vq/p5v7ZCBYA ($35.35 in chips)
Seat 5: IYd5zG8k7vdBNVHbHg2Pag ($36.60 in chips)
Seat 6: SegjDnMxWMujiD57ESNL+g ($12 in chips)
Seat 7: bmRtaIYKthN1F+B3JLZ3Jw ($20.70 in chips)
Seat 8: V+ivdLiYYuNr+thEXNextg ($33.75 in chips)
Seat 9: XNMDwbXt/Q4jM99AXnbJDw ($50 in chips)
V+ivdLiYYuNr+thEXNextg: posts small blind $0.25
XNMDwbXt/Q4jM99AXnbJDw: posts big blind $0.50
mj7PS7wCH4PAl7+eYTFs7A: posts small & big blinds $0.75
*** HOLE CARDS ***
mj7PS7wCH4PAl7+eYTFs7A: checks
OWP/DOu+PlPK6ZZ3zYa0HA: raises $1.50 to $2
cDNz32Scry3j+v2+kE3pHg: folds
o4Jr+EJ272Vq/p5v7ZCBYA: folds
IYd5zG8k7vdBNVHbHg2Pag: folds
SegjDnMxWMujiD57ESNL+g: folds
bmRtaIYKthN1F+B3JLZ3Jw: folds
V+ivdLiYYuNr+thEXNextg: folds
XNMDwbXt/Q4jM99AXnbJDw: folds
mj7PS7wCH4PAl7+eYTFs7A: folds
OWP/DOu+PlPK6ZZ3zYa0HA collected $2 from pot
*** SUMMARY ***
Total pot $2 | Rake $0
Seat 1: mj7PS7wCH4PAl7+eYTFs7A folded before Flop
Seat 2: OWP/DOu+PlPK6ZZ3zYa0HA collected ($2)
Seat 3: cDNz32Scry3j+v2+kE3pHg folded before Flop (didn't bet)
Seat 4: o4Jr+EJ272Vq/p5v7ZCBYA folded before Flop (didn't bet)
Seat 5: IYd5zG8k7vdBNVHbHg2Pag folded before Flop (didn't bet)
Seat 6: SegjDnMxWMujiD57ESNL+g folded before Flop (didn't bet)
Seat 7: bmRtaIYKthN1F+B3JLZ3Jw (button) folded before Flop (didn't bet)
Seat 8: V+ivdLiYYuNr+thEXNextg (small blind) folded before Flop
Seat 9: XNMDwbXt/Q4jM99AXnbJDw (big blind) folded before Flop



PokerStars Game #59939712116:  Hold'em No Limit ($0.25/$0.50) - 2009/07/01 0:46:58 ET
Table '0eJtgVAXVvBgncFdcUpXcQ' 2-max Seat #1 is the button
Seat 1: Ag6DvxX4vbRheqsv2zXKTQ ($25.45 in chips)
Seat 2: KMc4R+K9ao4Ur3rF7NGe6Q ($28.40 in chips)
Ag6DvxX4vbRheqsv2zXKTQ: posts small blind $0.25
KMc4R+K9ao4Ur3rF7NGe6Q: posts big blind $0.50
*** HOLE CARDS ***
Ag6DvxX4vbRheqsv2zXKTQ: folds
KMc4R+K9ao4Ur3rF7NGe6Q collected $0.50 from pot
KMc4R+K9ao4Ur3rF7NGe6Q said, "sht happens"
Ag6DvxX4vbRheqsv2zXKTQ said, "why all in there?"
*** SUMMARY ***
Total pot $0.50 | Rake $0
Seat 1: Ag6DvxX4vbRheqsv2zXKTQ (button) (small blind) folded before Flop
Seat 2: KMc4R+K9ao4Ur3rF7NGe6Q (big blind) collected ($0.50)



PokerStars Game #59939713056:  Hold'em No Limit ($0.25/$0.50) - 2009/07/01 0:46:59 ET
Table 'E7bWJ45aoFXRpyRv2gw+Ig' 2-max Seat #2 is the button
Seat 1: FRkiRasEGlHUeLrEl+k/nA ($71.50 in chips)
Seat 2: 3Wro85I7472vJ4Wkpneo9A ($123.35 in chips)
3Wro85I7472vJ4Wkpneo9A: posts small blind $0.25
FRkiRasEGlHUeLrEl+k/nA: posts big blind $0.50
*** HOLE CARDS ***
3Wro85I7472vJ4Wkpneo9A: raises $1 to $1.50
FRkiRasEGlHUeLrEl+k/nA: calls $1
*** FLOP *** [9c Tc Qh]
FRkiRasEGlHUeLrEl+k/nA: bets $2
3Wro85I7472vJ4Wkpneo9A: calls $2
*** TURN *** [9c Tc Qh] [9h]
FRkiRasEGlHUeLrEl+k/nA: bets $3.50
3Wro85I7472vJ4Wkpneo9A: calls $3.50
*** RIVER *** [9c Tc Qh 9h] [5c]
FRkiRasEGlHUeLrEl+k/nA: bets $13.50
3Wro85I7472vJ4Wkpneo9A: calls $13.50
*** SHOW DOWN ***
FRkiRasEGlHUeLrEl+k/nA: shows [9s Th] (a full house, Nines full of Tens)
3Wro85I7472vJ4Wkpneo9A: mucks hand
FRkiRasEGlHUeLrEl+k/nA collected $40.50 from pot
*** SUMMARY ***
Total pot $41 | Rake $0.50
Board [9c Tc Qh 9h 5c]
Seat 1: FRkiRasEGlHUeLrEl+k/nA (big blind) showed [9s Th] and won ($40.50) with a full house, Nines full of Tens
Seat 2: 3Wro85I7472vJ4Wkpneo9A (button) (small blind) mucked



PokerStars Game #59939712862:  Hold'em No Limit ($0.25/$0.50) - 2009/07/01 0:46:59 ET
Table 'Vdlc9wqYcHTUhtdyN7CuJw' 2-max Seat #1 is the button
Seat 1: yBO+mXB6m/rCft2ErwGf/Q ($117.30 in chips)
Seat 2: NZ/5cxwnorKW2SNsWy1+8A ($8.50 in chips)
yBO+mXB6m/rCft2ErwGf/Q: posts small blind $0.25
NZ/5cxwnorKW2SNsWy1+8A: posts big blind $0.50
*** HOLE CARDS ***
yBO+mXB6m/rCft2ErwGf/Q: calls $0.25
NZ/5cxwnorKW2SNsWy1+8A: checks
*** FLOP *** [6h Th Jd]
NZ/5cxwnorKW2SNsWy1+8A: checks
yBO+mXB6m/rCft2ErwGf/Q: checks
*** TURN *** [6h Th Jd] [3d]
NZ/5cxwnorKW2SNsWy1+8A: checks
yBO+mXB6m/rCft2ErwGf/Q: bets $0.50
NZ/5cxwnorKW2SNsWy1+8A: folds
yBO+mXB6m/rCft2ErwGf/Q collected $0.95 from pot
*** SUMMARY ***
Total pot $1 | Rake $0.05
Board [6h Th Jd 3d]
Seat 1: yBO+mXB6m/rCft2ErwGf/Q (button) (small blind) collected ($0.95)
Seat 2: NZ/5cxwnorKW2SNsWy1+8A (big blind) folded on the Turn



PokerStars Game #59939712670:  Hold'em No Limit ($0.25/$0.50) - 2009/07/01 0:46:59 ET
Table '+dXkOAQyS8j9PQZusUTMpg' 2-max Seat #2 is the button
Seat 1: XFa6sBGjP2gxoIvxR3fZIg ($51.90 in chips)
Seat 2: 5IBeOgaApY1Bvzv2P8X4EA ($151.65 in chips)
5IBeOgaApY1Bvzv2P8X4EA: posts small blind $0.25
XFa6sBGjP2gxoIvxR3fZIg: posts big blind $0.50
*** HOLE CARDS ***
5IBeOgaApY1Bvzv2P8X4EA: calls $0.25
XFa6sBGjP2gxoIvxR3fZIg: checks
*** FLOP *** [9s 8c Kc]
XFa6sBGjP2gxoIvxR3fZIg: bets $1
5IBeOgaApY1Bvzv2P8X4EA: calls $1
*** TURN *** [9s 8c Kc] [Jc]
XFa6sBGjP2gxoIvxR3fZIg: checks
5IBeOgaApY1Bvzv2P8X4EA: checks
*** RIVER *** [9s 8c Kc Jc] [2c]
XFa6sBGjP2gxoIvxR3fZIg: checks
5IBeOgaApY1Bvzv2P8X4EA: checks
*** SHOW DOWN ***
XFa6sBGjP2gxoIvxR3fZIg: shows [5d 8h] (a pair of Eights)
5IBeOgaApY1Bvzv2P8X4EA: shows [2d Kd] (two pair, Kings and Deuces)
5IBeOgaApY1Bvzv2P8X4EA collected $2.90 from pot
*** SUMMARY ***
Total pot $3 | Rake $0.10
Board [9s 8c Kc Jc 2c]
Seat 1: XFa6sBGjP2gxoIvxR3fZIg (big blind) showed [5d 8h] and lost with a pair of Eights
Seat 2: 5IBeOgaApY1Bvzv2P8X4EA (button) (small blind) showed [2d Kd] and won ($2.90) with two pair, Kings and Deuces



PokerStars Game #59939712634:  Hold'em No Limit ($0.25/$0.50) - 2009/07/01 0:46:59 ET
Table '37qXEp3oe+er5q4CZip9eQ' 6-max Seat #2 is the button
Seat 1: oqOqoO2AyCZenUghCxMDxw ($57.65 in chips)
Seat 2: 6wzJiRvp8HY6t+MQGnSIzA ($19.55 in chips)
Seat 3: Rt6KgtZ8YaJoTc3FPim00w ($100.60 in chips)
Seat 4: XsmE8nXMAAMFJbWaJTmHFw ($28.95 in chips)
Seat 5: VOmI0x4dDPnTESZd5B4d1Q ($45.90 in chips)
Rt6KgtZ8YaJoTc3FPim00w: posts small blind $0.25
XsmE8nXMAAMFJbWaJTmHFw: posts big blind $0.50
*** HOLE CARDS ***
N50kln4negd8q7Mmoz1j4g has returned
VOmI0x4dDPnTESZd5B4d1Q: calls $0.50
oqOqoO2AyCZenUghCxMDxw: folds
6wzJiRvp8HY6t+MQGnSIzA: raises $1 to $1.50
Rt6KgtZ8YaJoTc3FPim00w: folds
XsmE8nXMAAMFJbWaJTmHFw: calls $1
VOmI0x4dDPnTESZd5B4d1Q: calls $1
*** FLOP *** [9d 2s 8h]
XsmE8nXMAAMFJbWaJTmHFw: checks
VOmI0x4dDPnTESZd5B4d1Q: checks
6wzJiRvp8HY6t+MQGnSIzA: bets $2
XsmE8nXMAAMFJbWaJTmHFw: folds
VOmI0x4dDPnTESZd5B4d1Q: calls $2
*** TURN *** [9d 2s 8h] [Ac]
VOmI0x4dDPnTESZd5B4d1Q: checks
6wzJiRvp8HY6t+MQGnSIzA: checks
*** RIVER *** [9d 2s 8h Ac] [4d]
VOmI0x4dDPnTESZd5B4d1Q: bets $4
6wzJiRvp8HY6t+MQGnSIzA: calls $4
*** SHOW DOWN ***
VOmI0x4dDPnTESZd5B4d1Q: shows [Js Qh] (high card Ace)
6wzJiRvp8HY6t+MQGnSIzA: shows [9c Kc] (a pair of Nines)
6wzJiRvp8HY6t+MQGnSIzA collected $15.95 from pot
*** SUMMARY ***
Total pot $16.75 | Rake $0.80
Board [9d 2s 8h Ac 4d]
Seat 1: oqOqoO2AyCZenUghCxMDxw folded before Flop (didn't bet)
Seat 2: 6wzJiRvp8HY6t+MQGnSIzA (button) showed [9c Kc] and won ($15.95) with a pair of Nines
Seat 3: Rt6KgtZ8YaJoTc3FPim00w (small blind) folded before Flop
Seat 4: XsmE8nXMAAMFJbWaJTmHFw (big blind) folded on the Flop
Seat 5: VOmI0x4dDPnTESZd5B4d1Q showed [Js Qh] and lost with high card Ace



PokerStars Game #59939713352:  Hold'em No Limit ($0.25/$0.50) - 2009/07/01 0:47:00 ET
Table 'QOeVnLhwctF9UyV/beDi+A' 2-max Seat #1 is the button
Seat 1: bypIyrYcAAifLfhZpGlKLA ($63.25 in chips)
Seat 2: Ucrm3XtZmoONapW32SPhag ($19.40 in chips)
bypIyrYcAAifLfhZpGlKLA: posts small blind $0.25
Ucrm3XtZmoONapW32SPhag: posts big blind $0.50
*** HOLE CARDS ***
bypIyrYcAAifLfhZpGlKLA: raises $1 to $1.50
Ucrm3XtZmoONapW32SPhag: folds
bypIyrYcAAifLfhZpGlKLA collected $1 from pot
bypIyrYcAAifLfhZpGlKLA: doesn't show hand
*** SUMMARY ***
Total pot $1 | Rake $0
Seat 1: bypIyrYcAAifLfhZpGlKLA (button) (small blind) collected ($1)
Seat 2: Ucrm3XtZmoONapW32SPhag (big blind) folded before Flop



PokerStars Game #59939714354:  Hold'em No Limit ($0.25/$0.50) - 2009/07/01 0:47:01 ET
Table 'QOgaEqMcJ73pcUMMxoisUgErOuyGLI5PT3G5MnpHgC/g Seat #4 is the button
Seat 3: xZCXQSXlrZkp3pZizzVXCw ($49.75 in chips)
Seat 4: 3UmXLy3GfjC3EkOebduerQ ($50 in chips)
Seat 5: JwvquocWfhTVApN5t47LgA ($60.35 in chips)
Seat 6: zE9cVigS2nW/Ljy4K4bUQA ($30.75 in chips)
Seat 7: 90Wb75h3W1BRpbqVnuk8gw ($61.70 in chips)
Seat 8: g4k0NXISyLCqaSWZDBjfEg ($50 in chips)
Seat 9: J0W5D97jl5VLky+IoPvDeA ($57.15 in chips)
JwvquocWfhTVApN5t47LgA: posts small blind $0.25
zE9cVigS2nW/Ljy4K4bUQA: posts big blind $0.50
*** HOLE CARDS ***
90Wb75h3W1BRpbqVnuk8gw: folds
g4k0NXISyLCqaSWZDBjfEg: folds
J0W5D97jl5VLky+IoPvDeA: raises $1.50 to $2
xZCXQSXlrZkp3pZizzVXCw: folds
3UmXLy3GfjC3EkOebduerQ: folds
JwvquocWfhTVApN5t47LgA: folds
eBrej2jnlUCs/JgxFCRn2g joins the table at seat #1
zE9cVigS2nW/Ljy4K4bUQA: folds
J0W5D97jl5VLky+IoPvDeA collected $1.25 from pot
*** SUMMARY ***
Total pot $1.25 | Rake $0
Seat 3: xZCXQSXlrZkp3pZizzVXCw folded before Flop (didn't bet)
Seat 4: 3UmXLy3GfjC3EkOebduerQ (button) folded before Flop (didn't bet)
Seat 5: JwvquocWfhTVApN5t47LgA (small blind) folded before Flop
Seat 6: zE9cVigS2nW/Ljy4K4bUQA (big blind) folded before Flop
Seat 7: 90Wb75h3W1BRpbqVnuk8gw folded before Flop (didn't bet)
Seat 8: g4k0NXISyLCqaSWZDBjfEg folded before Flop (didn't bet)
Seat 9: J0W5D97jl5VLky+IoPvDeA collected ($1.25)



PokerStars Game #59939714670:  Hold'em No Limit ($0.25/$0.50) - 2009/07/01 0:47:02 ET
Table '+111aLuBwnz8YVYSA7J1jA' 2-max Seat #2 is the button
Seat 1: ndd1nfncBkWNitBnsfCoVQ ($76.10 in chips)
Seat 2: +ciXH35zeafrjg1W6wiBTg ($71.50 in chips)
+ciXH35zeafrjg1W6wiBTg: posts small blind $0.25
ndd1nfncBkWNitBnsfCoVQ: posts big blind $0.50
*** HOLE CARDS ***
+ciXH35zeafrjg1W6wiBTg: raises $1 to $1.50
ndd1nfncBkWNitBnsfCoVQ: calls $1
*** FLOP *** [8c 7c 6d]
ndd1nfncBkWNitBnsfCoVQ: checks
+ciXH35zeafrjg1W6wiBTg: bets $1.50
ndd1nfncBkWNitBnsfCoVQ: raises $3.50 to $5
+ciXH35zeafrjg1W6wiBTg: calls $3.50
*** TURN *** [8c 7c 6d] [Js]
ndd1nfncBkWNitBnsfCoVQ: bets $11
+ciXH35zeafrjg1W6wiBTg: calls $11
*** RIVER *** [8c 7c 6d Js] [3c]
ndd1nfncBkWNitBnsfCoVQ: bets $58.60 and is all-in
+ciXH35zeafrjg1W6wiBTg: folds
ndd1nfncBkWNitBnsfCoVQ collected $34.50 from pot
ndd1nfncBkWNitBnsfCoVQ: doesn't show hand
*** SUMMARY ***
Total pot $35 | Rake $0.50
Board [8c 7c 6d Js 3c]
Seat 1: ndd1nfncBkWNitBnsfCoVQ (big blind) collected ($34.50)
Seat 2: +ciXH35zeafrjg1W6wiBTg (button) (small blind) folded on the River



PokerStars Game #59939714768:  Hold'em No Limit ($0.25/$0.50) - 2009/07/01 0:47:02 ET
Table 'GfL/No5u5PoEnU39lP5pQg' 6-max Seat #2 is the button
Seat 1: 1WUCqNG+p+vfWRTXNu4ljw ($67 in chips)
Seat 2: uVwggSetzp7d+eVgowO3vg ($67.20 in chips)
Seat 3: Ek4w9XqBXqK5jBUQeLedGw ($50 in chips)
Seat 4: r6u7MWSXF30/khcTYkrG9Q ($20 in chips)
Seat 5: M1KyQQvVPVuxqTAB8sR/zQ ($50 in chips)
Ek4w9XqBXqK5jBUQeLedGw: posts small blind $0.25
r6u7MWSXF30/khcTYkrG9Q: posts big blind $0.50
*** HOLE CARDS ***
M1KyQQvVPVuxqTAB8sR/zQ: folds
1WUCqNG+p+vfWRTXNu4ljw: raises $1.50 to $2
uVwggSetzp7d+eVgowO3vg: folds
Ek4w9XqBXqK5jBUQeLedGw: folds
r6u7MWSXF30/khcTYkrG9Q: calls $1.50
*** FLOP *** [3d Ad 5h]
r6u7MWSXF30/khcTYkrG9Q: checks
1WUCqNG+p+vfWRTXNu4ljw: bets $2.50
r6u7MWSXF30/khcTYkrG9Q: raises $5 to $7.50
1WUCqNG+p+vfWRTXNu4ljw: folds
r6u7MWSXF30/khcTYkrG9Q collected $8.80 from pot
*** SUMMARY ***
Total pot $9.25 | Rake $0.45
Board [3d Ad 5h]
Seat 1: 1WUCqNG+p+vfWRTXNu4ljw folded on the Flop
Seat 2: uVwggSetzp7d+eVgowO3vg (button) folded before Flop (didn't bet)
Seat 3: Ek4w9XqBXqK5jBUQeLedGw (small blind) folded before Flop
Seat 4: r6u7MWSXF30/khcTYkrG9Q (big blind) collected ($8.80)
Seat 5: M1KyQQvVPVuxqTAB8sR/zQ folded before Flop (didn't bet)



PokerStars Game #59939715368:  Hold'em No Limit ($0.25/$0.50) - 2009/07/01 0:47:03 ET
Table 'IeNZOZQ4T6oiaHqFeo6yIA' 2-max Seat #2 is the button
Seat 1: ndd1nfncBkWNitBnsfCoVQ ($60 in chips)
Seat 2: A91IUl5JaZROhtfCtnnwYw ($122.35 in chips)
A91IUl5JaZROhtfCtnnwYw: posts small blind $0.25
ndd1nfncBkWNitBnsfCoVQ: posts big blind $0.50
*** HOLE CARDS ***
A91IUl5JaZROhtfCtnnwYw: calls $0.25
ndd1nfncBkWNitBnsfCoVQ: checks
*** FLOP *** [Jc Qd As]
ndd1nfncBkWNitBnsfCoVQ: checks
A91IUl5JaZROhtfCtnnwYw: bets $1
ndd1nfncBkWNitBnsfCoVQ: folds
A91IUl5JaZROhtfCtnnwYw collected $0.95 from pot
*** SUMMARY ***
Total pot $1 | Rake $0.05
Board [Jc Qd As]
Seat 1: ndd1nfncBkWNitBnsfCoVQ (big blind) folded on the Flop
Seat 2: A91IUl5JaZROhtfCtnnwYw (button) (small blind) collected ($0.95)



PokerStars Game #59939715256:  Hold'em No Limit ($0.25/$0.50) - 2009/07/01 0:47:03 ET
Table '99gCy/CZQwPIjZWH+BguQgE7bWJ45aoFXRpyRv2gw+Igeat #8 is the button
Seat 2: n6VQBu6crjYjy6DxNP1NZA ($29.65 in chips)
Seat 3: qEn9ijNGtuyTxamBf07hYg ($50 in chips)
Seat 4: bxLSulbgr8LmKNjOzw8URg ($63.45 in chips)
Seat 5: DSM67hHHq1XFoEOi9p8Alw ($49.25 in chips)
Seat 7: bfSq6LBw0UvxeM5yfuWC7w ($18.60 in chips)
Seat 8: 8ehL7qlZzjgUh2H35iiWLw ($50 in chips)
Seat 9: j3K/Jujr7PY4ZM2RZvlH6A ($85.15 in chips)
j3K/Jujr7PY4ZM2RZvlH6A: posts small blind $0.25
n6VQBu6crjYjy6DxNP1NZA: posts big blind $0.50
*** HOLE CARDS ***
qEn9ijNGtuyTxamBf07hYg: folds
bxLSulbgr8LmKNjOzw8URg: raises $1 to $1.50
DSM67hHHq1XFoEOi9p8Alw: folds
bfSq6LBw0UvxeM5yfuWC7w: folds
8ehL7qlZzjgUh2H35iiWLw: folds
j3K/Jujr7PY4ZM2RZvlH6A: folds
n6VQBu6crjYjy6DxNP1NZA: folds
bxLSulbgr8LmKNjOzw8URg collected $1.25 from pot
bxLSulbgr8LmKNjOzw8URg: doesn't show hand
*** SUMMARY ***
Total pot $1.25 | Rake $0
Seat 2: n6VQBu6crjYjy6DxNP1NZA (big blind) folded before Flop
Seat 3: qEn9ijNGtuyTxamBf07hYg folded before Flop (didn't bet)
Seat 4: bxLSulbgr8LmKNjOzw8URg collected ($1.25)
Seat 5: DSM67hHHq1XFoEOi9p8Alw folded before Flop (didn't bet)
Seat 7: bfSq6LBw0UvxeM5yfuWC7w folded before Flop (didn't bet)
Seat 8: 8ehL7qlZzjgUh2H35iiWLw (button) folded before Flop (didn't bet)
Seat 9: j3K/Jujr7PY4ZM2RZvlH6A (small blind) folded before Flop



PokerStars Game #59939716140:  Hold'em No Limit ($0.25/$0.50) - 2009/07/01 0:47:04 ET
Table '0eJtgVAXVvBgncFdcUpXcQ' 2-max Seat #2 is the button
Seat 1: Ag6DvxX4vbRheqsv2zXKTQ ($25.20 in chips)
Seat 2: KMc4R+K9ao4Ur3rF7NGe6Q ($28.65 in chips)
KMc4R+K9ao4Ur3rF7NGe6Q: posts small blind $0.25
Ag6DvxX4vbRheqsv2zXKTQ: posts big blind $0.50
*** HOLE CARDS ***
KMc4R+K9ao4Ur3rF7NGe6Q said, "honestly"
Ag6DvxX4vbRheqsv2zXKTQ said, "was pretty obv u didnt had the ace"
KMc4R+K9ao4Ur3rF7NGe6Q said, "i though you had a weak ace and though i can push you off"
KMc4R+K9ao4Ur3rF7NGe6Q: calls $0.25
Ag6DvxX4vbRheqsv2zXKTQ: checks
*** FLOP *** [8h Ah 5s]
Ag6DvxX4vbRheqsv2zXKTQ: checks
KMc4R+K9ao4Ur3rF7NGe6Q: checks
*** TURN *** [8h Ah 5s] [6h]
Ag6DvxX4vbRheqsv2zXKTQ: checks
KMc4R+K9ao4Ur3rF7NGe6Q: checks
*** RIVER *** [8h Ah 5s 6h] [2s]
Ag6DvxX4vbRheqsv2zXKTQ: checks
KMc4R+K9ao4Ur3rF7NGe6Q said, "your right"
KMc4R+K9ao4Ur3rF7NGe6Q: checks
*** SHOW DOWN ***
Ag6DvxX4vbRheqsv2zXKTQ: shows [5c Jd] (a pair of Fives)
KMc4R+K9ao4Ur3rF7NGe6Q: mucks hand
KMc4R+K9ao4Ur3rF7NGe6Q said, "dumb move"
Ag6DvxX4vbRheqsv2zXKTQ collected $0.95 from pot
Ag6DvxX4vbRheqsv2zXKTQ said, "my damn luck :|"
*** SUMMARY ***
Total pot $1 | Rake $0.05
Board [8h Ah 5s 6h 2s]
Seat 1: Ag6DvxX4vbRheqsv2zXKTQ (big blind) showed [5c Jd] and won ($0.95) with a pair of Fives
Seat 2: KMc4R+K9ao4Ur3rF7NGe6Q (button) (small blind) mucked



PokerStars Game #59939716296:  Hold'em No Limit ($0.25/$0.50) - 2009/07/01 0:47:04 ET
Table 'BCN5su+SsXiy1zRMJi0SJw' 6-max Seat #6 is the button
Seat 2: oU2kDCkT/gilYbHWrg7D8w ($10.55 in chips)
Seat 3: g+vwI6lMKpU2uteXSjOzVw ($18.45 in chips)
Seat 4: JY9CtoZTeav+mhWyxSSyJQ ($25.65 in chips)
Seat 5: IBNygaT1aa9Z1uPdJJilwA ($68.35 in chips)
Seat 6: b2symlOdL7+0c9Pj4N/KlA ($51.10 in chips)
GxXV09ciXaOxyY2H5aMIIw will be allowed to play after the button
oU2kDCkT/gilYbHWrg7D8w: posts small blind $0.25
g+vwI6lMKpU2uteXSjOzVw: posts big blind $0.50
*** HOLE CARDS ***
JY9CtoZTeav+mhWyxSSyJQ: folds
IBNygaT1aa9Z1uPdJJilwA: calls $0.50
b2symlOdL7+0c9Pj4N/KlA: raises $2 to $2.50
oU2kDCkT/gilYbHWrg7D8w: folds
g+vwI6lMKpU2uteXSjOzVw: folds
IBNygaT1aa9Z1uPdJJilwA: calls $2
*** FLOP *** [6c 3s 9h]
IBNygaT1aa9Z1uPdJJilwA: checks
b2symlOdL7+0c9Pj4N/KlA: bets $4
IBNygaT1aa9Z1uPdJJilwA: raises $4 to $8
b2symlOdL7+0c9Pj4N/KlA: raises $10 to $18
IBNygaT1aa9Z1uPdJJilwA: calls $10
*** TURN *** [6c 3s 9h] [Kh]
IBNygaT1aa9Z1uPdJJilwA: checks
b2symlOdL7+0c9Pj4N/KlA: bets $30.60 and is all-in
IBNygaT1aa9Z1uPdJJilwA: calls $30.60
*** RIVER *** [6c 3s 9h Kh] [Qh]
*** SHOW DOWN ***
IBNygaT1aa9Z1uPdJJilwA: shows [8d 9d] (a pair of Nines)
b2symlOdL7+0c9Pj4N/KlA: shows [Ac Ks] (a pair of Kings)
b2symlOdL7+0c9Pj4N/KlA collected $100.95 from pot
*** SUMMARY ***
Total pot $102.95 | Rake $2
Board [6c 3s 9h Kh Qh]
Seat 2: oU2kDCkT/gilYbHWrg7D8w (small blind) folded before Flop
Seat 3: g+vwI6lMKpU2uteXSjOzVw (big blind) folded before Flop
Seat 4: JY9CtoZTeav+mhWyxSSyJQ folded before Flop (didn't bet)
Seat 5: IBNygaT1aa9Z1uPdJJilwA showed [8d 9d] and lost with a pair of Nines
Seat 6: b2symlOdL7+0c9Pj4N/KlA (button) showed [Ac Ks] and won ($100.95) with a pair of Kings



PokerStars Game #59939718350:  Hold'em No Limit ($0.25/$0.50) - 2009/07/01 0:47:08 ET
Table 'QOeVnLhwctF9UyV/beDi+A' 2-max Seat #2 is the button
Seat 1: bypIyrYcAAifLfhZpGlKLA ($63.75 in chips)
Seat 2: Ucrm3XtZmoONapW32SPhag ($18.90 in chips)
Ucrm3XtZmoONapW32SPhag: posts small blind $0.25
bypIyrYcAAifLfhZpGlKLA: posts big blind $0.50
*** HOLE CARDS ***
Ucrm3XtZmoONapW32SPhag: raises $0.50 to $1
bypIyrYcAAifLfhZpGlKLA: raises $2.50 to $3.50
Ucrm3XtZmoONapW32SPhag: folds
bypIyrYcAAifLfhZpGlKLA collected $2 from pot
bypIyrYcAAifLfhZpGlKLA: doesn't show hand
*** SUMMARY ***
Total pot $2 | Rake $0
Seat 1: bypIyrYcAAifLfhZpGlKLA (big blind) collected ($2)
Seat 2: Ucrm3XtZmoONapW32SPhag (button) (small blind) folded before Flop



PokerStars Game #59939718946:  Hold'em No Limit ($0.25/$0.50) - 2009/07/01 0:47:08 ET
Table 'QOgaEqMcJ73pcUMMxoisUg' 6-max Seat #1 is the button
Seat 1: /olYG0EzMWzADIgH1y2ySQ ($27 in chips)
Seat 2: 4QfsCWthT/vSLirorNXqtg ($50 in chips)
Seat 3: Rt6KgtZ8YaJoTc3FPim00w ($76.75 in chips)
Seat 4: zAcsDhG/T128Vn7XGVSgKg ($51.60 in chips)
Seat 5: 6vNxrjjCl6FwfaaymM9jjg ($18.20 in chips)
Seat 6: pmE+2KJb4nffAVqjLIXxFg ($22.45 in chips)
4QfsCWthT/vSLirorNXqtg: posts small blind $0.25
Rt6KgtZ8YaJoTc3FPim00w: posts big blind $0.50
*** HOLE CARDS ***
zAcsDhG/T128Vn7XGVSgKg: folds
6vNxrjjCl6FwfaaymM9jjg: folds
pmE+2KJb4nffAVqjLIXxFg: calls $0.50
/olYG0EzMWzADIgH1y2ySQ: folds
4QfsCWthT/vSLirorNXqtg: folds
Rt6KgtZ8YaJoTc3FPim00w: raises $2 to $2.50
pmE+2KJb4nffAVqjLIXxFg: calls $2
*** FLOP *** [5s Ad Jh]
Rt6KgtZ8YaJoTc3FPim00w: bets $3.50
pmE+2KJb4nffAVqjLIXxFg: calls $3.50
*** TURN *** [5s Ad Jh] [4c]
Rt6KgtZ8YaJoTc3FPim00w said, "8"
Rt6KgtZ8YaJoTc3FPim00w: bets $8
pmE+2KJb4nffAVqjLIXxFg: calls $8
*** RIVER *** [5s Ad Jh 4c] [5c]
Rt6KgtZ8YaJoTc3FPim00w: bets $62.75 and is all-in
pmE+2KJb4nffAVqjLIXxFg: calls $8.45 and is all-in
*** SHOW DOWN ***
Rt6KgtZ8YaJoTc3FPim00w: shows [Kd Ah] (two pair, Aces and Fives)
pmE+2KJb4nffAVqjLIXxFg: mucks hand
Rt6KgtZ8YaJoTc3FPim00w collected $43 from pot
*** SUMMARY ***
Total pot $45.15 | Rake $2.15
Board [5s Ad Jh 4c 5c]
Seat 1: /olYG0EzMWzADIgH1y2ySQ (button) folded before Flop (didn't bet)
Seat 2: 4QfsCWthT/vSLirorNXqtg (small blind) folded before Flop
Seat 3: Rt6KgtZ8YaJoTc3FPim00w (big blind) showed [Kd Ah] and won ($43) with two pair, Aces and Fives
Seat 4: zAcsDhG/T128Vn7XGVSgKg folded before Flop (didn't bet)
Seat 5: 6vNxrjjCl6FwfaaymM9jjg folded before Flop (didn't bet)
Seat 6: pmE+2KJb4nffAVqjLIXxFg mucked



PokerStars Game #59939720288:  Hold'em No Limit ($0.25/$0.50) - 2009/07/01 0:47:11 ET
Table 'X6IRCRTh+20gjz8aubWnwA' 9-max Seat #2 is the button
Seat 1: DSM67hHHq1XFoEOi9p8Alw ($50.05 in chips)
Seat 2: HZkVla4kK2SI42CVrPZ/ig ($8.55 in chips)
Seat 3: SWv01peOe69QQRvhQTqjQw ($14.40 in chips)
Seat 4: 2J+UVOVrW+V3maOylyxMcQ ($36.70 in chips)
Seat 5: NnQCepdIR/AOUQn1yhYx6Q ($10 in chips)
Seat 6: /6In1zC3WtgwxDcueWzZWg ($70.05 in chips)
Seat 7: cFHQjKQOOKTUzoilhrXHLg ($40.10 in chips)
Seat 8: HxeBVq06/3Bh/H986sgdbw ($7.45 in chips)
Seat 9: M+7+BTmX5vZatHVuoRB1nA ($68.50 in chips)
SWv01peOe69QQRvhQTqjQw: posts small blind $0.25
2J+UVOVrW+V3maOylyxMcQ: posts big blind $0.50
*** HOLE CARDS ***
NnQCepdIR/AOUQn1yhYx6Q: folds
/6In1zC3WtgwxDcueWzZWg: calls $0.50
cFHQjKQOOKTUzoilhrXHLg: calls $0.50
HxeBVq06/3Bh/H986sgdbw: folds
M+7+BTmX5vZatHVuoRB1nA: folds
DSM67hHHq1XFoEOi9p8Alw: folds
HZkVla4kK2SI42CVrPZ/ig: folds
SWv01peOe69QQRvhQTqjQw: calls $0.25
2J+UVOVrW+V3maOylyxMcQ: checks
*** FLOP *** [Qd 9s Ah]
SWv01peOe69QQRvhQTqjQw: checks
2J+UVOVrW+V3maOylyxMcQ: checks
/6In1zC3WtgwxDcueWzZWg: bets $0.50
cFHQjKQOOKTUzoilhrXHLg: calls $0.50
SWv01peOe69QQRvhQTqjQw: calls $0.50
2J+UVOVrW+V3maOylyxMcQ: folds
*** TURN *** [Qd 9s Ah] [6h]
SWv01peOe69QQRvhQTqjQw: checks
/6In1zC3WtgwxDcueWzZWg: bets $1
cFHQjKQOOKTUzoilhrXHLg: raises $1.50 to $2.50
SWv01peOe69QQRvhQTqjQw: folds
/6In1zC3WtgwxDcueWzZWg: folds
cFHQjKQOOKTUzoilhrXHLg collected $5.25 from pot
cFHQjKQOOKTUzoilhrXHLg: doesn't show hand
*** SUMMARY ***
Total pot $5.50 | Rake $0.25
Board [Qd 9s Ah 6h]
Seat 1: DSM67hHHq1XFoEOi9p8Alw folded before Flop (didn't bet)
Seat 2: HZkVla4kK2SI42CVrPZ/ig (button) folded before Flop (didn't bet)
Seat 3: SWv01peOe69QQRvhQTqjQw (small blind) folded on the Turn
Seat 4: 2J+UVOVrW+V3maOylyxMcQ (big blind) folded on the Flop
Seat 5: NnQCepdIR/AOUQn1yhYx6Q folded before Flop (didn't bet)
Seat 6: /6In1zC3WtgwxDcueWzZWg folded on the Turn
Seat 7: cFHQjKQOOKTUzoilhrXHLg collected ($5.25)
Seat 8: HxeBVq06/3Bh/H986sgdbw folded before Flop (didn't bet)
Seat 9: M+7+BTmX5vZatHVuoRB1nA folded before Flop (didn't bet)



PokerStars Game #59939723566:  Hold'em No Limit ($0.25/$0.50) - 2009/07/01 0:47:16 ET
Table 'eMxdLyFDf28E0wit6gm3Uw' 6-max Seat #5 is the button
Seat 1: GtdWeBVCZhDBcNFRTOb8Hg ($4.10 in chips)
Seat 3: dZcLsEI8iXkobBduRJ45Yw ($12.10 in chips)
Seat 4: 3jxEWvv2qK1HCXLj4khowQ ($40.50 in chips)
Seat 5: X0X97o2fDAPiGx6o1gahsw ($76.10 in chips)
Seat 6: nOfdMHEXflgT86UgFWblAA ($50 in chips)
nOfdMHEXflgT86UgFWblAA: posts small blind $0.25
GtdWeBVCZhDBcNFRTOb8Hg: posts big blind $0.50
*** HOLE CARDS ***
dZcLsEI8iXkobBduRJ45Yw: folds
3jxEWvv2qK1HCXLj4khowQ: folds
X0X97o2fDAPiGx6o1gahsw: folds
nOfdMHEXflgT86UgFWblAA: raises $4.50 to $5
GtdWeBVCZhDBcNFRTOb8Hg: folds
nOfdMHEXflgT86UgFWblAA collected $1 from pot
*** SUMMARY ***
Total pot $1 | Rake $0
Seat 1: GtdWeBVCZhDBcNFRTOb8Hg (big blind) folded before Flop
Seat 3: dZcLsEI8iXkobBduRJ45Yw folded before Flop (didn't bet)
Seat 4: 3jxEWvv2qK1HCXLj4khowQ folded before Flop (didn't bet)
Seat 5: X0X97o2fDAPiGx6o1gahsw (button) folded before Flop (didn't bet)
Seat 6: nOfdMHEXflgT86UgFWblAA (small blind) collected ($1)



PokerStars Game #59939723572:  Hold'em No Limit ($0.25/$0.50) - 2009/07/01 0:47:16 ET
Table '+dXkOAQyS8j9PQZusUTMpg' 2-max Seat #1 is the button
Seat 1: XFa6sBGjP2gxoIvxR3fZIg ($50.40 in chips)
Seat 2: 5IBeOgaApY1Bvzv2P8X4EA ($153.05 in chips)
XFa6sBGjP2gxoIvxR3fZIg: posts small blind $0.25
5IBeOgaApY1Bvzv2P8X4EA: posts big blind $0.50
*** HOLE CARDS ***
XFa6sBGjP2gxoIvxR3fZIg: raises $1 to $1.50
5IBeOgaApY1Bvzv2P8X4EA: calls $1
*** FLOP *** [7s Td 2d]
5IBeOgaApY1Bvzv2P8X4EA: checks
XFa6sBGjP2gxoIvxR3fZIg: bets $2
5IBeOgaApY1Bvzv2P8X4EA: calls $2
*** TURN *** [7s Td 2d] [4h]
5IBeOgaApY1Bvzv2P8X4EA: checks
XFa6sBGjP2gxoIvxR3fZIg: checks
*** RIVER *** [7s Td 2d 4h] [5h]
5IBeOgaApY1Bvzv2P8X4EA: checks
XFa6sBGjP2gxoIvxR3fZIg: bets $7.50
5IBeOgaApY1Bvzv2P8X4EA: calls $7.50
*** SHOW DOWN ***
XFa6sBGjP2gxoIvxR3fZIg: shows [Th Kh] (a pair of Tens)
5IBeOgaApY1Bvzv2P8X4EA: mucks hand
XFa6sBGjP2gxoIvxR3fZIg collected $21.50 from pot
*** SUMMARY ***
Total pot $22 | Rake $0.50
Board [7s Td 2d 4h 5h]
Seat 1: XFa6sBGjP2gxoIvxR3fZIg (button) (small blind) showed [Th Kh] and won ($21.50) with a pair of Tens
Seat 2: 5IBeOgaApY1Bvzv2P8X4EA (big blind) mucked



PokerStars Game #59939723368:  Hold'em No Limit ($0.25/$0.50) - 2009/07/01 0:47:16 ET
Table '3FhG0gl3kMX3wBEEqj+wnQ' 9-max Seat #5 is the button
Seat 1: e0J9pdCNUDTCG031RnXqLA ($35.55 in chips)
Seat 2: 7cYQ+syUWjl38ty/ICOMhw ($50 in chips)
Seat 4: bjvJtA9Hqscfznq66txaOQ ($9.50 in chips)
Seat 5: gsyXT42WLEcOS4DdEk2wlw ($27.75 in chips)
Seat 6: 997ViqAtWn1FPjJqcffwcA ($50.25 in chips)
Seat 7: mSD1pginDsyHG5PDfqzphw ($11.50 in chips)
Seat 8: j3K/Jujr7PY4ZM2RZvlH6A ($57.35 in chips)
Seat 9: L5e2lrPLQm1Pqx30IIZ/Fw ($10 in chips)
997ViqAtWn1FPjJqcffwcA: posts small blind $0.25
mSD1pginDsyHG5PDfqzphw: posts big blind $0.50
*** HOLE CARDS ***
j3K/Jujr7PY4ZM2RZvlH6A: raises $0.50 to $1
L5e2lrPLQm1Pqx30IIZ/Fw: folds
e0J9pdCNUDTCG031RnXqLA: folds
7cYQ+syUWjl38ty/ICOMhw: folds
bjvJtA9Hqscfznq66txaOQ: folds
gsyXT42WLEcOS4DdEk2wlw: folds
997ViqAtWn1FPjJqcffwcA: folds
mSD1pginDsyHG5PDfqzphw: calls $0.50
*** FLOP *** [Ks Kh 6d]
mSD1pginDsyHG5PDfqzphw: checks
j3K/Jujr7PY4ZM2RZvlH6A: bets $1.50
mSD1pginDsyHG5PDfqzphw: folds
j3K/Jujr7PY4ZM2RZvlH6A collected $2.15 from pot
j3K/Jujr7PY4ZM2RZvlH6A: doesn't show hand
*** SUMMARY ***
Total pot $2.25 | Rake $0.10
Board [Ks Kh 6d]
Seat 1: e0J9pdCNUDTCG031RnXqLA folded before Flop (didn't bet)
Seat 2: 7cYQ+syUWjl38ty/ICOMhw folded before Flop (didn't bet)
Seat 4: bjvJtA9Hqscfznq66txaOQ folded before Flop (didn't bet)
Seat 5: gsyXT42WLEcOS4DdEk2wlw (button) folded before Flop (didn't bet)
Seat 6: 997ViqAtWn1FPjJqcffwcA (small blind) folded before Flop
Seat 7: mSD1pginDsyHG5PDfqzphw (big blind) folded on the Flop
Seat 8: j3K/Jujr7PY4ZM2RZvlH6A collected ($2.15)
Seat 9: L5e2lrPLQm1Pqx30IIZ/Fw folded before Flop (didn't bet)



PokerStars Game #59939724120:  Hold'em No Limit ($0.25/$0.50) - 2009/07/01 0:47:17 ET
Table 'NCiXr0d5CEKBQr/cZgLhbA' 9-max Seat #1 is the button
Seat 1: pFtzb1sR4b0d1aw6aIRgDg ($50 in chips)
Seat 2: ulxuJchBV9iguXg0FUonfg ($50 in chips)
Seat 3: xZCXQSXlrZkp3pZizzVXCw ($51.50 in chips)
Seat 4: 5k9fvXD9suIgCxU4HLQjTw ($56.70 in chips)
Seat 5: zE9cVigS2nW/Ljy4K4bUQA ($36.70 in chips)
Seat 6: SKnJuWHScqetA/qG5p+wCg ($33.45 in chips)
Seat 7: M+7+BTmX5vZatHVuoRB1nA ($47.60 in chips)
Seat 8: 1MJUKc3cc0QmUoz1JZLR2w ($57.25 in chips)
Seat 9: 4WLZvqBn5qv5tds5kt5A1Q ($45.80 in chips)
ulxuJchBV9iguXg0FUonfg: posts small blind $0.25
xZCXQSXlrZkp3pZizzVXCw: posts big blind $0.50
*** HOLE CARDS ***
5k9fvXD9suIgCxU4HLQjTw: folds
zE9cVigS2nW/Ljy4K4bUQA: folds
SKnJuWHScqetA/qG5p+wCg: folds
M+7+BTmX5vZatHVuoRB1nA: folds
1MJUKc3cc0QmUoz1JZLR2w: folds
4WLZvqBn5qv5tds5kt5A1Q: folds
pFtzb1sR4b0d1aw6aIRgDg: folds
ulxuJchBV9iguXg0FUonfg: folds
xZCXQSXlrZkp3pZizzVXCw collected $0.50 from pot
*** SUMMARY ***
Total pot $0.50 | Rake $0
Seat 1: pFtzb1sR4b0d1aw6aIRgDg (button) folded before Flop (didn't bet)
Seat 2: ulxuJchBV9iguXg0FUonfg (small blind) folded before Flop
Seat 3: xZCXQSXlrZkp3pZizzVXCw (big blind) collected ($0.50)
Seat 4: 5k9fvXD9suIgCxU4HLQjTw folded before Flop (didn't bet)
Seat 5: zE9cVigS2nW/Ljy4K4bUQA folded before Flop (didn't bet)
Seat 6: SKnJuWHScqetA/qG5p+wCg folded before Flop (didn't bet)
Seat 7: M+7+BTmX5vZatHVuoRB1nA folded before Flop (didn't bet)
Seat 8: 1MJUKc3cc0QmUoz1JZLR2w folded before Flop (didn't bet)
Seat 9: 4WLZvqBn5qv5tds5kt5A1Q folded before Flop (didn't bet)



PokerStars Game #59939725764:  Hold'em No Limit ($0.25/$0.50) - 2009/07/01 0:47:20 ET
Table '/cQuAT3ef4t+PGrXiNhGaQ' 9-max Seat #5 is the button
Seat 1: HZkVla4kK2SI42CVrPZ/ig ($5.25 in chips)
Seat 2: jXGruyaMqirTaTXNOvBdew ($69.45 in chips)
Seat 3: g4k0NXISyLCqaSWZDBjfEg ($55.25 in chips)
Seat 4: OWP/DOu+PlPK6ZZ3zYa0HA ($29.40 in chips)
Seat 5: 5SgaHdWixdClWvaEG+KUjQ ($25.60 in chips)
Seat 6: APYIOyK/4AGb+kIwlOUNBQ ($37.50 in chips)
Seat 7: J0W5D97jl5VLky+IoPvDeA ($114.15 in chips)
Seat 8: W3ingbA178eb7J5rt1PuIQ ($37.10 in chips)
Seat 9: AjV5McH1KMMclY26QdLM5w ($31.35 in chips)
APYIOyK/4AGb+kIwlOUNBQ: posts small blind $0.25
J0W5D97jl5VLky+IoPvDeA: posts big blind $0.50
*** HOLE CARDS ***
W3ingbA178eb7J5rt1PuIQ: folds
W3ingbA178eb7J5rt1PuIQ leaves the table
AjV5McH1KMMclY26QdLM5w: raises $1 to $1.50
HZkVla4kK2SI42CVrPZ/ig: raises $3.75 to $5.25 and is all-in
jXGruyaMqirTaTXNOvBdew: folds
g4k0NXISyLCqaSWZDBjfEg: folds
OWP/DOu+PlPK6ZZ3zYa0HA: folds
eBrej2jnlUCs/JgxFCRn2g joins the table at seat #8
5SgaHdWixdClWvaEG+KUjQ: folds
APYIOyK/4AGb+kIwlOUNBQ: folds
J0W5D97jl5VLky+IoPvDeA: folds
AjV5McH1KMMclY26QdLM5w: calls $3.75
*** FLOP *** [2c 3d 9s]
*** TURN *** [2c 3d 9s] [5s]
*** RIVER *** [2c 3d 9s 5s] [7h]
*** SHOW DOWN ***
AjV5McH1KMMclY26QdLM5w: shows [Kh Jh] (high card King)
HZkVla4kK2SI42CVrPZ/ig: shows [Ac Qd] (high card Ace)
HZkVla4kK2SI42CVrPZ/ig collected $10.70 from pot
*** SUMMARY ***
Total pot $11.25 | Rake $0.55
Board [2c 3d 9s 5s 7h]
Seat 1: HZkVla4kK2SI42CVrPZ/ig showed [Ac Qd] and won ($10.70) with high card Ace
Seat 2: jXGruyaMqirTaTXNOvBdew folded before Flop (didn't bet)
Seat 3: g4k0NXISyLCqaSWZDBjfEg folded before Flop (didn't bet)
Seat 4: OWP/DOu+PlPK6ZZ3zYa0HA folded before Flop (didn't bet)
Seat 5: 5SgaHdWixdClWvaEG+KUjQ (button) folded before Flop (didn't bet)
Seat 6: APYIOyK/4AGb+kIwlOUNBQ (small blind) folded before Flop
Seat 7: J0W5D97jl5VLky+IoPvDeA (big blind) folded before Flop
Seat 8: W3ingbA178eb7J5rt1PuIQ folded before Flop (didn't bet)
Seat 9: AjV5McH1KMMclY26QdLM5w showed [Kh Jh] and lost with high card King



PokerStars Game #59939726366:  Hold'em No Limit ($0.25/$0.50) - 2009/07/01 0:47:20 ET
Table 'MJxeZCzYELxiIsyUZyT0jw' 6-max Seat #5 is the button
Seat 1: jNIq+EZLEm61oWSMYUVeWQ ($3.80 in chips)
Seat 3: JQZew0FjzS19kTjeNtrE+A ($59.75 in chips)
Seat 4: alGiiQP/wwtYnfuXII+sgw ($47.75 in chips)
Seat 5: 3jvoOXNtXE90w2BdfNZwZQ ($50 in chips)
Seat 6: TTx3CHxyi0SObcHyMJRp5w ($56.95 in chips)
TTx3CHxyi0SObcHyMJRp5w: posts small blind $0.25
jNIq+EZLEm61oWSMYUVeWQ: posts big blind $0.50
t3GiVMzqA9Svgr5Uol32cQ: sits out
*** HOLE CARDS ***
JQZew0FjzS19kTjeNtrE+A: calls $0.50
alGiiQP/wwtYnfuXII+sgw: calls $0.50
3jvoOXNtXE90w2BdfNZwZQ: folds
TTx3CHxyi0SObcHyMJRp5w: raises $1 to $1.50
jNIq+EZLEm61oWSMYUVeWQ: calls $1
JQZew0FjzS19kTjeNtrE+A: calls $1
alGiiQP/wwtYnfuXII+sgw: calls $1
*** FLOP *** [2s Td 6d]
TTx3CHxyi0SObcHyMJRp5w: checks
jNIq+EZLEm61oWSMYUVeWQ: bets $2.30 and is all-in
JQZew0FjzS19kTjeNtrE+A: calls $2.30
alGiiQP/wwtYnfuXII+sgw: folds
TTx3CHxyi0SObcHyMJRp5w: calls $2.30
*** TURN *** [2s Td 6d] [7d]
TTx3CHxyi0SObcHyMJRp5w: checks
JQZew0FjzS19kTjeNtrE+A: bets $4
TTx3CHxyi0SObcHyMJRp5w: folds
*** RIVER *** [2s Td 6d 7d] [2c]
*** SHOW DOWN ***
jNIq+EZLEm61oWSMYUVeWQ: shows [8c Qc] (a pair of Deuces)
JQZew0FjzS19kTjeNtrE+A: shows [4d Qd] (a flush, Queen high)
JQZew0FjzS19kTjeNtrE+A collected $12.30 from pot
*** SUMMARY ***
Total pot $12.90 | Rake $0.60
Board [2s Td 6d 7d 2c]
Seat 1: jNIq+EZLEm61oWSMYUVeWQ (big blind) showed [8c Qc] and lost with a pair of Deuces
Seat 3: JQZew0FjzS19kTjeNtrE+A showed [4d Qd] and won ($12.30) with a flush, Queen high
Seat 4: alGiiQP/wwtYnfuXII+sgw folded on the Flop
Seat 5: 3jvoOXNtXE90w2BdfNZwZQ (button) folded before Flop (didn't bet)
Seat 6: TTx3CHxyi0SObcHyMJRp5w (small blind) folded on the Turn



PokerStars Game #59939727274:  Hold'em No Limit ($0.25/$0.50) - 2009/07/01 0:47:22 ET
Table 'IeNZOZQ4T6oiaHqFeo6yIA' 2-max Seat #1 is the button
Seat 1: ndd1nfncBkWNitBnsfCoVQ ($59.50 in chips)
Seat 2: A91IUl5JaZROhtfCtnnwYw ($122.80 in chips)
ndd1nfncBkWNitBnsfCoVQ: posts small blind $0.25
A91IUl5JaZROhtfCtnnwYw: posts big blind $0.50
*** HOLE CARDS ***
ndd1nfncBkWNitBnsfCoVQ: raises $1 to $1.50
A91IUl5JaZROhtfCtnnwYw: calls $1
*** FLOP *** [4h Jh 2h]
A91IUl5JaZROhtfCtnnwYw: checks
ndd1nfncBkWNitBnsfCoVQ: bets $3
A91IUl5JaZROhtfCtnnwYw: calls $3
*** TURN *** [4h Jh 2h] [Ah]
A91IUl5JaZROhtfCtnnwYw: checks
ndd1nfncBkWNitBnsfCoVQ: checks
*** RIVER *** [4h Jh 2h Ah] [3d]
A91IUl5JaZROhtfCtnnwYw: checks
ndd1nfncBkWNitBnsfCoVQ: checks
*** SHOW DOWN ***
A91IUl5JaZROhtfCtnnwYw: shows [Qc 2d] (a pair of Deuces)
ndd1nfncBkWNitBnsfCoVQ: shows [Ks Kd] (a pair of Kings)
ndd1nfncBkWNitBnsfCoVQ collected $8.60 from pot
*** SUMMARY ***
Total pot $9 | Rake $0.40
Board [4h Jh 2h Ah 3d]
Seat 1: ndd1nfncBkWNitBnsfCoVQ (button) (small blind) showed [Ks Kd] and won ($8.60) with a pair of Kings
Seat 2: A91IUl5JaZROhtfCtnnwYw (big blind) showed [Qc 2d] and lost with a pair of Deuces



PokerStars Game #59939728864:  Hold'em No Limit ($0.25/$0.50) - 2009/07/01 0:47:24 ET
Table '5EmHi+fnatGQQShcNmzOZQ' 6-max Seat #6 is the button
Seat 1: +SZCX3+7lnuhHKIu+PP9rg ($58.65 in chips)
Seat 2: vXIHnZ+dv/hwSBxyvGw7bQ ($50.75 in chips)
Seat 4: 1b+2BbjMN8qhR1WPqdE9VQ ($53.15 in chips)
Seat 5: kxPhs4ePFqMy52CInAJ2aw ($55.85 in chips)
Seat 6: 686aeHikcJlgKkSuIFdcXQ ($141.20 in chips)
+SZCX3+7lnuhHKIu+PP9rg: posts small blind $0.25
vXIHnZ+dv/hwSBxyvGw7bQ: posts big blind $0.50
TjmTe3bhs9dFz5gXX9x7Lw: sits out
*** HOLE CARDS ***
1b+2BbjMN8qhR1WPqdE9VQ: folds
kxPhs4ePFqMy52CInAJ2aw: folds
+SZCX3+7lnuhHKIu+PP9rg said, "nooooooooooooooo not my 50 cents .....lmfao"
686aeHikcJlgKkSuIFdcXQ: folds
+SZCX3+7lnuhHKIu+PP9rg: calls $0.25
vXIHnZ+dv/hwSBxyvGw7bQ: raises $1.50 to $2
+SZCX3+7lnuhHKIu+PP9rg: calls $1.50
*** FLOP *** [6h Ad As]
+SZCX3+7lnuhHKIu+PP9rg: checks
vXIHnZ+dv/hwSBxyvGw7bQ: bets $2.65
+SZCX3+7lnuhHKIu+PP9rg: folds
+SZCX3+7lnuhHKIu+PP9rg leaves the table
vXIHnZ+dv/hwSBxyvGw7bQ collected $3.80 from pot
vXIHnZ+dv/hwSBxyvGw7bQ: doesn't show hand
*** SUMMARY ***
Total pot $4 | Rake $0.20
Board [6h Ad As]
Seat 1: +SZCX3+7lnuhHKIu+PP9rg (small blind) folded on the Flop
Seat 2: vXIHnZ+dv/hwSBxyvGw7bQ (big blind) collected ($3.80)
Seat 4: 1b+2BbjMN8qhR1WPqdE9VQ folded before Flop (didn't bet)
Seat 5: kxPhs4ePFqMy52CInAJ2aw folded before Flop (didn't bet)
Seat 6: 686aeHikcJlgKkSuIFdcXQ (button) folded before Flop (didn't bet)



PokerStars Game #59939729856:  Hold'em No Limit ($0.25/$0.50) - 2009/07/01 0:47:26 ET
Table 'EiNh8p/wGJ1FP575iMFnqg' 9-max Seat #1 is the button
Seat 1: r3ZqM1Mi0W3y4hOdssE+Sg ($44.40 in chips)
Seat 2: 8ehL7qlZzjgUh2H35iiWLw ($52.85 in chips)
Seat 3: ymLPoEIl7UL3TvZYmnadxQ ($53.10 in chips)
Seat 4: cMzaiXAM/ZAdNaEUu+LqhA ($50 in chips)
Seat 5: M+7+BTmX5vZatHVuoRB1nA ($79.30 in chips)
Seat 6: 3UmXLy3GfjC3EkOebduerQ ($66.85 in chips)
Seat 7: 997ViqAtWn1FPjJqcffwcA ($50 in chips)
Seat 8: KrPAGRACBg+w0M//SXe8Ag ($6.90 in chips)
Seat 9: NnQCepdIR/AOUQn1yhYx6Q ($9.25 in chips)
8ehL7qlZzjgUh2H35iiWLw: posts small blind $0.25
ymLPoEIl7UL3TvZYmnadxQ: posts big blind $0.50
*** HOLE CARDS ***
cMzaiXAM/ZAdNaEUu+LqhA: folds
M+7+BTmX5vZatHVuoRB1nA: folds
3UmXLy3GfjC3EkOebduerQ: folds
997ViqAtWn1FPjJqcffwcA: folds
KrPAGRACBg+w0M//SXe8Ag: raises $0.50 to $1
NnQCepdIR/AOUQn1yhYx6Q: folds
r3ZqM1Mi0W3y4hOdssE+Sg: calls $1
8ehL7qlZzjgUh2H35iiWLw: folds
ymLPoEIl7UL3TvZYmnadxQ: folds
*** FLOP *** [6s 5c 8d]
KrPAGRACBg+w0M//SXe8Ag: bets $1
r3ZqM1Mi0W3y4hOdssE+Sg: raises $2 to $3
KrPAGRACBg+w0M//SXe8Ag: raises $2.90 to $5.90 and is all-in
r3ZqM1Mi0W3y4hOdssE+Sg: calls $2.90
*** TURN *** [6s 5c 8d] [2d]
*** RIVER *** [6s 5c 8d 2d] [Th]
*** SHOW DOWN ***
KrPAGRACBg+w0M//SXe8Ag: shows [7s Ah] (high card Ace)
r3ZqM1Mi0W3y4hOdssE+Sg: shows [Kc Kh] (a pair of Kings)
r3ZqM1Mi0W3y4hOdssE+Sg collected $13.85 from pot
*** SUMMARY ***
Total pot $14.55 | Rake $0.70
Board [6s 5c 8d 2d Th]
Seat 1: r3ZqM1Mi0W3y4hOdssE+Sg (button) showed [Kc Kh] and won ($13.85) with a pair of Kings
Seat 2: 8ehL7qlZzjgUh2H35iiWLw (small blind) folded before Flop
Seat 3: ymLPoEIl7UL3TvZYmnadxQ (big blind) folded before Flop
Seat 4: cMzaiXAM/ZAdNaEUu+LqhA folded before Flop (didn't bet)
Seat 5: M+7+BTmX5vZatHVuoRB1nA folded before Flop (didn't bet)
Seat 6: 3UmXLy3GfjC3EkOebduerQ folded before Flop (didn't bet)
Seat 7: 997ViqAtWn1FPjJqcffwcA folded before Flop (didn't bet)
Seat 8: KrPAGRACBg+w0M//SXe8Ag showed [7s Ah] and lost with high card Ace
Seat 9: NnQCepdIR/AOUQn1yhYx6Q folded before Flop (didn't bet)



PokerStars Game #59939729822:  Hold'em No Limit ($0.25/$0.50) - 2009/07/01 0:47:26 ET
Table 'QOeVnLhwctF9UyV/beDi+A' 2-max Seat #1 is the button
Seat 1: bypIyrYcAAifLfhZpGlKLA ($64.75 in chips)
Seat 2: Ucrm3XtZmoONapW32SPhag ($17.90 in chips)
bypIyrYcAAifLfhZpGlKLA: posts small blind $0.25
Ucrm3XtZmoONapW32SPhag: posts big blind $0.50
*** HOLE CARDS ***
bypIyrYcAAifLfhZpGlKLA: raises $1 to $1.50
Ucrm3XtZmoONapW32SPhag: folds
bypIyrYcAAifLfhZpGlKLA collected $1 from pot
bypIyrYcAAifLfhZpGlKLA: doesn't show hand
*** SUMMARY ***
Total pot $1 | Rake $0
Seat 1: bypIyrYcAAifLfhZpGlKLA (button) (small blind) collected ($1)
Seat 2: Ucrm3XtZmoONapW32SPhag (big blind) folded before Flop



PokerStars Game #59939731862:  Hold'em No Limit ($0.25/$0.50) - 2009/07/01 0:47:29 ET
Table 'lpxYasB1ClBSgTpCCITwhQ' 9-max Seat #8 is the button
Seat 1: mj7PS7wCH4PAl7+eYTFs7A ($47.90 in chips)
Seat 2: OWP/DOu+PlPK6ZZ3zYa0HA ($22 in chips)
Seat 3: cDNz32Scry3j+v2+kE3pHg ($50 in chips)
Seat 4: o4Jr+EJ272Vq/p5v7ZCBYA ($35.35 in chips)
Seat 5: IYd5zG8k7vdBNVHbHg2Pag ($36.60 in chips)
Seat 6: SegjDnMxWMujiD57ESNL+g ($12 in chips)
Seat 7: bmRtaIYKthN1F+B3JLZ3Jw ($20.70 in chips)
Seat 8: V+ivdLiYYuNr+thEXNextg ($33.50 in chips)
Seat 9: XNMDwbXt/Q4jM99AXnbJDw ($50 in chips)
XNMDwbXt/Q4jM99AXnbJDw: posts small blind $0.25
mj7PS7wCH4PAl7+eYTFs7A: posts big blind $0.50
*** HOLE CARDS ***
OWP/DOu+PlPK6ZZ3zYa0HA: calls $0.50
cDNz32Scry3j+v2+kE3pHg: folds
o4Jr+EJ272Vq/p5v7ZCBYA: folds
IYd5zG8k7vdBNVHbHg2Pag: folds
SegjDnMxWMujiD57ESNL+g: raises $1 to $1.50
bmRtaIYKthN1F+B3JLZ3Jw: folds
V+ivdLiYYuNr+thEXNextg: folds
XNMDwbXt/Q4jM99AXnbJDw: folds
mj7PS7wCH4PAl7+eYTFs7A: folds
OWP/DOu+PlPK6ZZ3zYa0HA: calls $1
*** FLOP *** [4d Th 4c]
OWP/DOu+PlPK6ZZ3zYa0HA: checks
SegjDnMxWMujiD57ESNL+g: bets $2.50
OWP/DOu+PlPK6ZZ3zYa0HA: calls $2.50
*** TURN *** [4d Th 4c] [6h]
OWP/DOu+PlPK6ZZ3zYa0HA: checks
SegjDnMxWMujiD57ESNL+g: checks
*** RIVER *** [4d Th 4c 6h] [3c]
OWP/DOu+PlPK6ZZ3zYa0HA: checks
SegjDnMxWMujiD57ESNL+g: checks
*** SHOW DOWN ***
OWP/DOu+PlPK6ZZ3zYa0HA: shows [Qd Ah] (a pair of Fours)
SegjDnMxWMujiD57ESNL+g: mucks hand
OWP/DOu+PlPK6ZZ3zYa0HA collected $8.35 from pot
*** SUMMARY ***
Total pot $8.75 | Rake $0.40
Board [4d Th 4c 6h 3c]
Seat 1: mj7PS7wCH4PAl7+eYTFs7A (big blind) folded before Flop
Seat 2: OWP/DOu+PlPK6ZZ3zYa0HA showed [Qd Ah] and won ($8.35) with a pair of Fours
Seat 3: cDNz32Scry3j+v2+kE3pHg folded before Flop (didn't bet)
Seat 4: o4Jr+EJ272Vq/p5v7ZCBYA folded before Flop (didn't bet)
Seat 5: IYd5zG8k7vdBNVHbHg2Pag folded before Flop (didn't bet)
Seat 6: SegjDnMxWMujiD57ESNL+g mucked
Seat 7: bmRtaIYKthN1F+B3JLZ3Jw folded before Flop (didn't bet)
Seat 8: V+ivdLiYYuNr+thEXNextg (button) folded before Flop (didn't bet)
Seat 9: XNMDwbXt/Q4jM99AXnbJDw (small blind) folded before Flop



PokerStars Game #59939732244:  Hold'em No Limit ($0.25/$0.50) - 2009/07/01 0:47:30 ET
Table 'lSisgp6H7Fg1hH5VfjEjYQ' 9-max Seat #7 is the button
Seat 1: 5k9fvXD9suIgCxU4HLQjTw ($50 in chips)
Seat 2: UrcnkQOiLVk8BlKDPJSy7Q ($50 in chips)
Seat 3: aTkyjTh3w5YLWiIERupZOA ($51.95 in chips)
Seat 4: bwv/rbH/hHhPhY6u9mu04w ($30.50 in chips)
Seat 5: mSD1pginDsyHG5PDfqzphw ($11.35 in chips)
Seat 6: +k7T5ocke8UwavtgUHm+Cg ($34.60 in chips)
Seat 7: Y3DZ6qQlLeBhixDj4M9vmg ($9.30 in chips)
Seat 8: a4JDWmpFQkL10XfAyuF51A ($30.75 in chips)
Seat 9: gsyXT42WLEcOS4DdEk2wlw ($31.60 in chips)
a4JDWmpFQkL10XfAyuF51A: posts small blind $0.25
gsyXT42WLEcOS4DdEk2wlw: posts big blind $0.50
*** HOLE CARDS ***
5k9fvXD9suIgCxU4HLQjTw: folds
UrcnkQOiLVk8BlKDPJSy7Q: folds
aTkyjTh3w5YLWiIERupZOA: folds
bwv/rbH/hHhPhY6u9mu04w: raises $1 to $1.50
mSD1pginDsyHG5PDfqzphw: folds
+k7T5ocke8UwavtgUHm+Cg: calls $1.50
Y3DZ6qQlLeBhixDj4M9vmg: folds
a4JDWmpFQkL10XfAyuF51A: folds
gsyXT42WLEcOS4DdEk2wlw: folds
*** FLOP *** [6c 3s Jc]
bwv/rbH/hHhPhY6u9mu04w: bets $1
+k7T5ocke8UwavtgUHm+Cg: calls $1
*** TURN *** [6c 3s Jc] [5s]
bwv/rbH/hHhPhY6u9mu04w: bets $1.50
+k7T5ocke8UwavtgUHm+Cg: calls $1.50
*** RIVER *** [6c 3s Jc 5s] [9d]
bwv/rbH/hHhPhY6u9mu04w: checks
+k7T5ocke8UwavtgUHm+Cg: checks
*** SHOW DOWN ***
bwv/rbH/hHhPhY6u9mu04w: shows [Td Th] (a pair of Tens)
+k7T5ocke8UwavtgUHm+Cg: mucks hand
bwv/rbH/hHhPhY6u9mu04w collected $8.35 from pot
*** SUMMARY ***
Total pot $8.75 | Rake $0.40
Board [6c 3s Jc 5s 9d]
Seat 1: 5k9fvXD9suIgCxU4HLQjTw folded before Flop (didn't bet)
Seat 2: UrcnkQOiLVk8BlKDPJSy7Q folded before Flop (didn't bet)
Seat 3: aTkyjTh3w5YLWiIERupZOA folded before Flop (didn't bet)
Seat 4: bwv/rbH/hHhPhY6u9mu04w showed [Td Th] and won ($8.35) with a pair of Tens
Seat 5: mSD1pginDsyHG5PDfqzphw folded before Flop (didn't bet)
Seat 6: +k7T5ocke8UwavtgUHm+Cg mucked
Seat 7: Y3DZ6qQlLeBhixDj4M9vmg (button) folded before Flop (didn't bet)
Seat 8: a4JDWmpFQkL10XfAyuF51A (small blind) folded before Flop
Seat 9: gsyXT42WLEcOS4DdEk2wlw (big blind) folded before Flop



PokerStars Game #59939732752:  Hold'em No Limit ($0.25/$0.50) - 2009/07/01 0:47:30 ET
Table '99gCy/CZQwPIjZWH+BguQgE7bWJ45aoFXRpyRv2gw+Igeat #9 is the button
Seat 2: n6VQBu6crjYjy6DxNP1NZA ($29.15 in chips)
Seat 3: qEn9ijNGtuyTxamBf07hYg ($50 in chips)
Seat 4: bxLSulbgr8LmKNjOzw8URg ($64.20 in chips)
Seat 5: DSM67hHHq1XFoEOi9p8Alw ($49.25 in chips)
Seat 7: bfSq6LBw0UvxeM5yfuWC7w ($18.60 in chips)
Seat 8: 8ehL7qlZzjgUh2H35iiWLw ($50 in chips)
Seat 9: j3K/Jujr7PY4ZM2RZvlH6A ($84.90 in chips)
n6VQBu6crjYjy6DxNP1NZA: posts small blind $0.25
qEn9ijNGtuyTxamBf07hYg: posts big blind $0.50
*** HOLE CARDS ***
bxLSulbgr8LmKNjOzw8URg: folds
DSM67hHHq1XFoEOi9p8Alw: folds
bfSq6LBw0UvxeM5yfuWC7w: folds
8ehL7qlZzjgUh2H35iiWLw: folds
j3K/Jujr7PY4ZM2RZvlH6A: raises $1 to $1.50
n6VQBu6crjYjy6DxNP1NZA: folds
qEn9ijNGtuyTxamBf07hYg: folds
j3K/Jujr7PY4ZM2RZvlH6A collected $1.25 from pot
j3K/Jujr7PY4ZM2RZvlH6A: doesn't show hand
*** SUMMARY ***
Total pot $1.25 | Rake $0
Seat 2: n6VQBu6crjYjy6DxNP1NZA (small blind) folded before Flop
Seat 3: qEn9ijNGtuyTxamBf07hYg (big blind) folded before Flop
Seat 4: bxLSulbgr8LmKNjOzw8URg folded before Flop (didn't bet)
Seat 5: DSM67hHHq1XFoEOi9p8Alw folded before Flop (didn't bet)
Seat 7: bfSq6LBw0UvxeM5yfuWC7w folded before Flop (didn't bet)
Seat 8: 8ehL7qlZzjgUh2H35iiWLw folded before Flop (didn't bet)
Seat 9: j3K/Jujr7PY4ZM2RZvlH6A (button) collected ($1.25)



PokerStars Game #59939735084:  Hold'em No Limit ($0.25/$0.50) - 2009/07/01 0:47:34 ET
Table 'QOeVnLhwctF9UyV/beDi+A' 2-max Seat #2 is the button
Seat 1: bypIyrYcAAifLfhZpGlKLA ($65.25 in chips)
Seat 2: Ucrm3XtZmoONapW32SPhag ($17.40 in chips)
Ucrm3XtZmoONapW32SPhag: posts small blind $0.25
bypIyrYcAAifLfhZpGlKLA: posts big blind $0.50
*** HOLE CARDS ***
Ucrm3XtZmoONapW32SPhag: calls $0.25
bypIyrYcAAifLfhZpGlKLA: raises $0.50 to $1
Ucrm3XtZmoONapW32SPhag: raises $0.50 to $1.50
bypIyrYcAAifLfhZpGlKLA: raises $0.50 to $2
Ucrm3XtZmoONapW32SPhag: calls $0.50
*** FLOP *** [Ks 8h Jh]
bypIyrYcAAifLfhZpGlKLA: bets $3
Ucrm3XtZmoONapW32SPhag: folds
bypIyrYcAAifLfhZpGlKLA collected $3.80 from pot
bypIyrYcAAifLfhZpGlKLA: doesn't show hand
*** SUMMARY ***
Total pot $4 | Rake $0.20
Board [Ks 8h Jh]
Seat 1: bypIyrYcAAifLfhZpGlKLA (big blind) collected ($3.80)
Seat 2: Ucrm3XtZmoONapW32SPhag (button) (small blind) folded on the Flop



PokerStars Game #59939736590:  Hold'em No Limit ($0.25/$0.50) - 2009/07/01 0:47:36 ET
Table 'c/CRn+68J3Y8KxD5g1ek2Q' 2-max Seat #1 is the button
Seat 1: 46qCyJ6evTkHo9al5sBMNA ($232.80 in chips)
Seat 2: BypVLsYQt3ePFm2xQL/dOA ($140.55 in chips)
46qCyJ6evTkHo9al5sBMNA: posts small blind $0.25
BypVLsYQt3ePFm2xQL/dOA: posts big blind $0.50
*** HOLE CARDS ***
46qCyJ6evTkHo9al5sBMNA said, "i had flush"
46qCyJ6evTkHo9al5sBMNA: folds
BypVLsYQt3ePFm2xQL/dOA said, "no maybe yo"
BypVLsYQt3ePFm2xQL/dOA collected $0.50 from pot
BypVLsYQt3ePFm2xQL/dOA: doesn't show hand
*** SUMMARY ***
Total pot $0.50 | Rake $0
Seat 1: 46qCyJ6evTkHo9al5sBMNA (button) (small blind) folded before Flop
Seat 2: BypVLsYQt3ePFm2xQL/dOA (big blind) collected ($0.50)



PokerStars Game #59939737532:  Hold'em No Limit ($0.25/$0.50) - 2009/07/01 0:47:38 ET
Table 'otvGDROEDdqsabxskT79qg' 9-max Seat #5 is the button
Seat 1: 8ehL7qlZzjgUh2H35iiWLw ($55.25 in chips)
Seat 2: cCjTzH9jio8607WzjcfXlg ($12.25 in chips)
Seat 3: +k7T5ocke8UwavtgUHm+Cg ($61.55 in chips)
Seat 4: MG90wfSJZnOejs/KD3vlQQ ($69.95 in chips)
Seat 5: XNMDwbXt/Q4jM99AXnbJDw ($53.55 in chips)
Seat 6: bxLSulbgr8LmKNjOzw8URg ($49.40 in chips)
Seat 7: C7+tBppJrKgd/r+tuKUIpA ($37.85 in chips)
Seat 8: zE9cVigS2nW/Ljy4K4bUQA ($30 in chips)
Seat 9: KcY3X8YpD74Kw1RHkx/g4A ($66.40 in chips)
bxLSulbgr8LmKNjOzw8URg: posts small blind $0.25
C7+tBppJrKgd/r+tuKUIpA: posts big blind $0.50
*** HOLE CARDS ***
zE9cVigS2nW/Ljy4K4bUQA: folds
KcY3X8YpD74Kw1RHkx/g4A: folds
8ehL7qlZzjgUh2H35iiWLw: folds
cCjTzH9jio8607WzjcfXlg: folds
+k7T5ocke8UwavtgUHm+Cg: folds
MG90wfSJZnOejs/KD3vlQQ: folds
XNMDwbXt/Q4jM99AXnbJDw: raises $0.50 to $1
bxLSulbgr8LmKNjOzw8URg: raises $2.50 to $3.50
C7+tBppJrKgd/r+tuKUIpA: folds
XNMDwbXt/Q4jM99AXnbJDw: folds
bxLSulbgr8LmKNjOzw8URg collected $2.50 from pot
bxLSulbgr8LmKNjOzw8URg: doesn't show hand
*** SUMMARY ***
Total pot $2.50 | Rake $0
Seat 1: 8ehL7qlZzjgUh2H35iiWLw folded before Flop (didn't bet)
Seat 2: cCjTzH9jio8607WzjcfXlg folded before Flop (didn't bet)
Seat 3: +k7T5ocke8UwavtgUHm+Cg folded before Flop (didn't bet)
Seat 4: MG90wfSJZnOejs/KD3vlQQ folded before Flop (didn't bet)
Seat 5: XNMDwbXt/Q4jM99AXnbJDw (button) folded before Flop
Seat 6: bxLSulbgr8LmKNjOzw8URg (small blind) collected ($2.50)
Seat 7: C7+tBppJrKgd/r+tuKUIpA (big blind) folded before Flop
Seat 8: zE9cVigS2nW/Ljy4K4bUQA folded before Flop (didn't bet)
Seat 9: KcY3X8YpD74Kw1RHkx/g4A folded before Flop (didn't bet)



PokerStars Game #59939738400:  Hold'em No Limit ($0.25/$0.50) - 2009/07/01 0:47:39 ET
Table 'QOgaEqMcJ73pcUMMxoisUgErOuyGLI5PT3G5MnpHgC/g Seat #5 is the button
Seat 3: xZCXQSXlrZkp3pZizzVXCw ($49.75 in chips)
Seat 4: 3UmXLy3GfjC3EkOebduerQ ($50 in chips)
Seat 5: JwvquocWfhTVApN5t47LgA ($60.10 in chips)
Seat 6: zE9cVigS2nW/Ljy4K4bUQA ($30.25 in chips)
Seat 7: 90Wb75h3W1BRpbqVnuk8gw ($61.70 in chips)
Seat 8: g4k0NXISyLCqaSWZDBjfEg ($50 in chips)
Seat 9: J0W5D97jl5VLky+IoPvDeA ($57.90 in chips)
zE9cVigS2nW/Ljy4K4bUQA: posts small blind $0.25
90Wb75h3W1BRpbqVnuk8gw: posts big blind $0.50
eBrej2jnlUCs/JgxFCRn2g: sits out
*** HOLE CARDS ***
g4k0NXISyLCqaSWZDBjfEg: folds
J0W5D97jl5VLky+IoPvDeA: folds
xZCXQSXlrZkp3pZizzVXCw: folds
3UmXLy3GfjC3EkOebduerQ: folds
JwvquocWfhTVApN5t47LgA: folds
zE9cVigS2nW/Ljy4K4bUQA: folds
90Wb75h3W1BRpbqVnuk8gw collected $0.50 from pot
*** SUMMARY ***
Total pot $0.50 | Rake $0
Seat 3: xZCXQSXlrZkp3pZizzVXCw folded before Flop (didn't bet)
Seat 4: 3UmXLy3GfjC3EkOebduerQ folded before Flop (didn't bet)
Seat 5: JwvquocWfhTVApN5t47LgA (button) folded before Flop (didn't bet)
Seat 6: zE9cVigS2nW/Ljy4K4bUQA (small blind) folded before Flop
Seat 7: 90Wb75h3W1BRpbqVnuk8gw (big blind) collected ($0.50)
Seat 8: g4k0NXISyLCqaSWZDBjfEg folded before Flop (didn't bet)
Seat 9: J0W5D97jl5VLky+IoPvDeA folded before Flop (didn't bet)



PokerStars Game #59939738958:  Hold'em No Limit ($0.25/$0.50) - 2009/07/01 0:47:40 ET
Table 'Vdlc9wqYcHTUhtdyN7CuJw' 2-max Seat #2 is the button
Seat 1: yBO+mXB6m/rCft2ErwGf/Q ($117.75 in chips)
Seat 2: NZ/5cxwnorKW2SNsWy1+8A ($8 in chips)
NZ/5cxwnorKW2SNsWy1+8A: posts small blind $0.25
yBO+mXB6m/rCft2ErwGf/Q: posts big blind $0.50
*** HOLE CARDS ***
NZ/5cxwnorKW2SNsWy1+8A: calls $0.25
yBO+mXB6m/rCft2ErwGf/Q: checks
*** FLOP *** [Tc 4d Ad]
yBO+mXB6m/rCft2ErwGf/Q: checks
NZ/5cxwnorKW2SNsWy1+8A: bets $1
yBO+mXB6m/rCft2ErwGf/Q: folds
NZ/5cxwnorKW2SNsWy1+8A collected $0.95 from pot
NZ/5cxwnorKW2SNsWy1+8A: doesn't show hand
*** SUMMARY ***
Total pot $1 | Rake $0.05
Board [Tc 4d Ad]
Seat 1: yBO+mXB6m/rCft2ErwGf/Q (big blind) folded on the Flop
Seat 2: NZ/5cxwnorKW2SNsWy1+8A (button) (small blind) collected ($0.95)



PokerStars Game #59939738552:  Hold'em No Limit ($0.25/$0.50) - 2009/07/01 0:47:40 ET
Table '+111aLuBwnz8YVYSA7J1jA' 2-max Seat #1 is the button
Seat 1: ndd1nfncBkWNitBnsfCoVQ ($93.10 in chips)
Seat 2: +ciXH35zeafrjg1W6wiBTg ($54 in chips)
ndd1nfncBkWNitBnsfCoVQ: posts small blind $0.25
+ciXH35zeafrjg1W6wiBTg: posts big blind $0.50
*** HOLE CARDS ***
ndd1nfncBkWNitBnsfCoVQ: raises $1 to $1.50
+ciXH35zeafrjg1W6wiBTg: calls $1
*** FLOP *** [6h 7s 8c]
+ciXH35zeafrjg1W6wiBTg: checks
ndd1nfncBkWNitBnsfCoVQ: checks
*** TURN *** [6h 7s 8c] [As]
+ciXH35zeafrjg1W6wiBTg: bets $1.50
ndd1nfncBkWNitBnsfCoVQ: folds
+ciXH35zeafrjg1W6wiBTg collected $2.85 from pot
+ciXH35zeafrjg1W6wiBTg: doesn't show hand
*** SUMMARY ***
Total pot $3 | Rake $0.15
Board [6h 7s 8c As]
Seat 1: ndd1nfncBkWNitBnsfCoVQ (button) (small blind) folded on the Turn
Seat 2: +ciXH35zeafrjg1W6wiBTg (big blind) collected ($2.85)



PokerStars Game #59939739046:  Hold'em No Limit ($0.25/$0.50) - 2009/07/01 0:47:40 ET
Table 'eMxdLyFDf28E0wit6gm3Uw' 6-max Seat #6 is the button
Seat 1: GtdWeBVCZhDBcNFRTOb8Hg ($3.60 in chips)
Seat 3: dZcLsEI8iXkobBduRJ45Yw ($12.10 in chips)
Seat 4: 3jxEWvv2qK1HCXLj4khowQ ($40.50 in chips)
Seat 5: X0X97o2fDAPiGx6o1gahsw ($76.10 in chips)
Seat 6: nOfdMHEXflgT86UgFWblAA ($50.50 in chips)
GtdWeBVCZhDBcNFRTOb8Hg: posts small blind $0.25
dZcLsEI8iXkobBduRJ45Yw: posts big blind $0.50
*** HOLE CARDS ***
3jxEWvv2qK1HCXLj4khowQ: calls $0.50
X0X97o2fDAPiGx6o1gahsw: folds
nOfdMHEXflgT86UgFWblAA: folds
GtdWeBVCZhDBcNFRTOb8Hg: calls $0.25
dZcLsEI8iXkobBduRJ45Yw: raises $1.50 to $2
3jxEWvv2qK1HCXLj4khowQ: calls $1.50
GtdWeBVCZhDBcNFRTOb8Hg: folds
*** FLOP *** [5h 6d 5s]
dZcLsEI8iXkobBduRJ45Yw: checks
3jxEWvv2qK1HCXLj4khowQ: checks
*** TURN *** [5h 6d 5s] [Jh]
dZcLsEI8iXkobBduRJ45Yw: checks
3jxEWvv2qK1HCXLj4khowQ: checks
*** RIVER *** [5h 6d 5s Jh] [As]
dZcLsEI8iXkobBduRJ45Yw: checks
3jxEWvv2qK1HCXLj4khowQ: bets $3
dZcLsEI8iXkobBduRJ45Yw: folds
3jxEWvv2qK1HCXLj4khowQ collected $4.30 from pot
*** SUMMARY ***
Total pot $4.50 | Rake $0.20
Board [5h 6d 5s Jh As]
Seat 1: GtdWeBVCZhDBcNFRTOb8Hg (small blind) folded before Flop
Seat 3: dZcLsEI8iXkobBduRJ45Yw (big blind) folded on the River
Seat 4: 3jxEWvv2qK1HCXLj4khowQ collected ($4.30)
Seat 5: X0X97o2fDAPiGx6o1gahsw folded before Flop (didn't bet)
Seat 6: nOfdMHEXflgT86UgFWblAA (button) folded before Flop (didn't bet)



PokerStars Game #59939741066:  Hold'em No Limit ($0.25/$0.50) - 2009/07/01 0:47:43 ET
Table 'fx6MqwfYAj/Rt86hBz2L3Q' 9-max Seat #5 is the button
Seat 1: SegjDnMxWMujiD57ESNL+g ($10 in chips)
Seat 2: C3rGXblctNcWI6JYPHhaEg ($9.20 in chips)
Seat 3: iadBi5AEt7gTBXbDSSnMYQ ($48.95 in chips)
Seat 4: gPEN9Zp33YTm/mu9/SYP1w ($23.30 in chips)
Seat 5: iAISe3dVeua8PUn2wwgDHw ($23.35 in chips)
Seat 6: 5k9fvXD9suIgCxU4HLQjTw ($50 in chips)
Seat 7: SKnJuWHScqetA/qG5p+wCg ($30 in chips)
Seat 8: NnQCepdIR/AOUQn1yhYx6Q ($14.05 in chips)
Seat 9: HZkVla4kK2SI42CVrPZ/ig ($11.75 in chips)
5k9fvXD9suIgCxU4HLQjTw: posts small blind $0.25
SKnJuWHScqetA/qG5p+wCg: posts big blind $0.50
*** HOLE CARDS ***
NnQCepdIR/AOUQn1yhYx6Q: folds
HZkVla4kK2SI42CVrPZ/ig: folds
NnQCepdIR/AOUQn1yhYx6Q leaves the table
SegjDnMxWMujiD57ESNL+g: folds
C3rGXblctNcWI6JYPHhaEg: raises $0.50 to $1
iadBi5AEt7gTBXbDSSnMYQ: calls $1
gPEN9Zp33YTm/mu9/SYP1w: folds
iAISe3dVeua8PUn2wwgDHw: raises $0.50 to $1.50
JYwJYYV9pM5KWdSiETl8rA joins the table at seat #8
5k9fvXD9suIgCxU4HLQjTw: folds
SKnJuWHScqetA/qG5p+wCg: folds
C3rGXblctNcWI6JYPHhaEg: calls $0.50
iadBi5AEt7gTBXbDSSnMYQ: calls $0.50
*** FLOP *** [2s 3d 3c]
C3rGXblctNcWI6JYPHhaEg: bets $0.70
iadBi5AEt7gTBXbDSSnMYQ: folds
iAISe3dVeua8PUn2wwgDHw: calls $0.70
*** TURN *** [2s 3d 3c] [6h]
C3rGXblctNcWI6JYPHhaEg: bets $2
iAISe3dVeua8PUn2wwgDHw: calls $2
*** RIVER *** [2s 3d 3c 6h] [Qd]
C3rGXblctNcWI6JYPHhaEg: bets $5 and is all-in
iAISe3dVeua8PUn2wwgDHw: calls $5
*** SHOW DOWN ***
C3rGXblctNcWI6JYPHhaEg: shows [7c Ac] (a pair of Threes)
iAISe3dVeua8PUn2wwgDHw: shows [5d 5h] (two pair, Fives and Threes)
iAISe3dVeua8PUn2wwgDHw collected $19.65 from pot
*** SUMMARY ***
Total pot $20.65 | Rake $1
Board [2s 3d 3c 6h Qd]
Seat 1: SegjDnMxWMujiD57ESNL+g folded before Flop (didn't bet)
Seat 2: C3rGXblctNcWI6JYPHhaEg showed [7c Ac] and lost with a pair of Threes
Seat 3: iadBi5AEt7gTBXbDSSnMYQ folded on the Flop
Seat 4: gPEN9Zp33YTm/mu9/SYP1w folded before Flop (didn't bet)
Seat 5: iAISe3dVeua8PUn2wwgDHw (button) showed [5d 5h] and won ($19.65) with two pair, Fives and Threes
Seat 6: 5k9fvXD9suIgCxU4HLQjTw (small blind) folded before Flop
Seat 7: SKnJuWHScqetA/qG5p+wCg (big blind) folded before Flop
Seat 8: NnQCepdIR/AOUQn1yhYx6Q folded before Flop (didn't bet)
Seat 9: HZkVla4kK2SI42CVrPZ/ig folded before Flop (didn't bet)



PokerStars Game #59939740948:  Hold'em No Limit ($0.25/$0.50) - 2009/07/01 0:47:43 ET
Table 'ibNfFy0bCzuBaUORla0aGw' 9-max Seat #8 is the button
Seat 1: xZCXQSXlrZkp3pZizzVXCw ($53.20 in chips)
Seat 2: 90Wb75h3W1BRpbqVnuk8gw ($51.40 in chips)
Seat 3: dDaHs3X8+fe3bIkRU0cbrw ($40.15 in chips)
Seat 4: YBN054X4blmis+B2bBlC0g ($23.45 in chips)
Seat 5: GIJAc9kPrLZHLSX8Q6i99w ($25.40 in chips)
Seat 6: 8n9jQLh3cZKbsmr5PIjgiQ ($43.25 in chips)
Seat 7: HZkVla4kK2SI42CVrPZ/ig ($13.55 in chips)
Seat 8: xUrN9TWLq4m5V+OXY7KUUA ($50.45 in chips)
Seat 9: pFtzb1sR4b0d1aw6aIRgDg ($50.25 in chips)
pFtzb1sR4b0d1aw6aIRgDg: posts small blind $0.25
xZCXQSXlrZkp3pZizzVXCw: posts big blind $0.50
*** HOLE CARDS ***
90Wb75h3W1BRpbqVnuk8gw: folds
dDaHs3X8+fe3bIkRU0cbrw: folds
YBN054X4blmis+B2bBlC0g: folds
GIJAc9kPrLZHLSX8Q6i99w: folds
8n9jQLh3cZKbsmr5PIjgiQ: folds
HZkVla4kK2SI42CVrPZ/ig: raises $1 to $1.50
xUrN9TWLq4m5V+OXY7KUUA: folds
pFtzb1sR4b0d1aw6aIRgDg: folds
xZCXQSXlrZkp3pZizzVXCw: folds
HZkVla4kK2SI42CVrPZ/ig collected $1.25 from pot
*** SUMMARY ***
Total pot $1.25 | Rake $0
Seat 1: xZCXQSXlrZkp3pZizzVXCw (big blind) folded before Flop
Seat 2: 90Wb75h3W1BRpbqVnuk8gw folded before Flop (didn't bet)
Seat 3: dDaHs3X8+fe3bIkRU0cbrw folded before Flop (didn't bet)
Seat 4: YBN054X4blmis+B2bBlC0g folded before Flop (didn't bet)
Seat 5: GIJAc9kPrLZHLSX8Q6i99w folded before Flop (didn't bet)
Seat 6: 8n9jQLh3cZKbsmr5PIjgiQ folded before Flop (didn't bet)
Seat 7: HZkVla4kK2SI42CVrPZ/ig collected ($1.25)
Seat 8: xUrN9TWLq4m5V+OXY7KUUA (button) folded before Flop (didn't bet)
Seat 9: pFtzb1sR4b0d1aw6aIRgDg (small blind) folded before Flop



PokerStars Game #59939741044:  Hold'em No Limit ($0.25/$0.50) - 2009/07/01 0:47:43 ET
Table '0eJtgVAXVvBgncFdcUpXcQ' 2-max Seat #1 is the button
Seat 1: Ag6DvxX4vbRheqsv2zXKTQ ($25.65 in chips)
Seat 2: KMc4R+K9ao4Ur3rF7NGe6Q ($28.15 in chips)
Ag6DvxX4vbRheqsv2zXKTQ: posts small blind $0.25
KMc4R+K9ao4Ur3rF7NGe6Q: posts big blind $0.50
*** HOLE CARDS ***
Ag6DvxX4vbRheqsv2zXKTQ: folds
KMc4R+K9ao4Ur3rF7NGe6Q said, "sorry"
KMc4R+K9ao4Ur3rF7NGe6Q collected $0.50 from pot
KMc4R+K9ao4Ur3rF7NGe6Q: doesn't show hand
*** SUMMARY ***
Total pot $0.50 | Rake $0
Seat 1: Ag6DvxX4vbRheqsv2zXKTQ (button) (small blind) folded before Flop
Seat 2: KMc4R+K9ao4Ur3rF7NGe6Q (big blind) collected ($0.50)



PokerStars Game #59939741634:  Hold'em No Limit ($0.25/$0.50) - 2009/07/01 0:47:44 ET
Table 'GfL/No5u5PoEnU39lP5pQg' 6-max Seat #3 is the button
Seat 1: 1WUCqNG+p+vfWRTXNu4ljw ($62.50 in chips)
Seat 2: uVwggSetzp7d+eVgowO3vg ($67.20 in chips)
Seat 3: Ek4w9XqBXqK5jBUQeLedGw ($50 in chips)
Seat 4: r6u7MWSXF30/khcTYkrG9Q ($24.30 in chips)
Seat 5: M1KyQQvVPVuxqTAB8sR/zQ ($50 in chips)
r6u7MWSXF30/khcTYkrG9Q: posts small blind $0.25
M1KyQQvVPVuxqTAB8sR/zQ: posts big blind $0.50
*** HOLE CARDS ***
1WUCqNG+p+vfWRTXNu4ljw: folds
uVwggSetzp7d+eVgowO3vg: calls $0.50
Ek4w9XqBXqK5jBUQeLedGw: folds
r6u7MWSXF30/khcTYkrG9Q: calls $0.25
M1KyQQvVPVuxqTAB8sR/zQ: raises $1.75 to $2.25
uVwggSetzp7d+eVgowO3vg: calls $1.75
r6u7MWSXF30/khcTYkrG9Q: folds
*** FLOP *** [Ts 8s Td]
M1KyQQvVPVuxqTAB8sR/zQ: bets $3.50
uVwggSetzp7d+eVgowO3vg: folds
M1KyQQvVPVuxqTAB8sR/zQ collected $4.75 from pot
M1KyQQvVPVuxqTAB8sR/zQ: doesn't show hand
*** SUMMARY ***
Total pot $5 | Rake $0.25
Board [Ts 8s Td]
Seat 1: 1WUCqNG+p+vfWRTXNu4ljw folded before Flop (didn't bet)
Seat 2: uVwggSetzp7d+eVgowO3vg folded on the Flop
Seat 3: Ek4w9XqBXqK5jBUQeLedGw (button) folded before Flop (didn't bet)
Seat 4: r6u7MWSXF30/khcTYkrG9Q (small blind) folded before Flop
Seat 5: M1KyQQvVPVuxqTAB8sR/zQ (big blind) collected ($4.75)



PokerStars Game #59939741888:  Hold'em No Limit ($0.25/$0.50) - 2009/07/01 0:47:45 ET
Table '+z1aekfHkpp09pc8F9aViw' 6-max Seat #1 is the button
Seat 1: FHilMb2i2DbUCc9lplszog ($38.60 in chips)
Seat 2: M6xK/VklCvdyyrmvzATlxQ ($35.50 in chips)
Seat 3: uUznlIMFnRUvwrBhYF73KA ($107.45 in chips)
Seat 4: RowCSpSURHTOL/dcjg/Iug ($50.05 in chips)
Seat 5: crjGpJEzSZgD38FoE3VMGg ($50 in chips)
Seat 6: 686aeHikcJlgKkSuIFdcXQ ($64.60 in chips)
M6xK/VklCvdyyrmvzATlxQ: posts small blind $0.25
uUznlIMFnRUvwrBhYF73KA: posts big blind $0.50
*** HOLE CARDS ***
RowCSpSURHTOL/dcjg/Iug: folds
crjGpJEzSZgD38FoE3VMGg: folds
686aeHikcJlgKkSuIFdcXQ: folds
FHilMb2i2DbUCc9lplszog: folds
M6xK/VklCvdyyrmvzATlxQ: folds
uUznlIMFnRUvwrBhYF73KA collected $0.50 from pot
*** SUMMARY ***
Total pot $0.50 | Rake $0
Seat 1: FHilMb2i2DbUCc9lplszog (button) folded before Flop (didn't bet)
Seat 2: M6xK/VklCvdyyrmvzATlxQ (small blind) folded before Flop
Seat 3: uUznlIMFnRUvwrBhYF73KA (big blind) collected ($0.50)
Seat 4: RowCSpSURHTOL/dcjg/Iug folded before Flop (didn't bet)
Seat 5: crjGpJEzSZgD38FoE3VMGg folded before Flop (didn't bet)
Seat 6: 686aeHikcJlgKkSuIFdcXQ folded before Flop (didn't bet)



PokerStars Game #59939743688:  Hold'em No Limit ($0.25/$0.50) - 2009/07/01 0:47:48 ET
Table 'c/CRn+68J3Y8KxD5g1ek2Q' 2-max Seat #2 is the button
Seat 1: 46qCyJ6evTkHo9al5sBMNA ($232.55 in chips)
Seat 2: BypVLsYQt3ePFm2xQL/dOA ($140.80 in chips)
BypVLsYQt3ePFm2xQL/dOA: posts small blind $0.25
46qCyJ6evTkHo9al5sBMNA: posts big blind $0.50
*** HOLE CARDS ***
BypVLsYQt3ePFm2xQL/dOA: raises $0.50 to $1
46qCyJ6evTkHo9al5sBMNA: calls $0.50
*** FLOP *** [6h Ad 5d]
46qCyJ6evTkHo9al5sBMNA said, "i wish i have"
46qCyJ6evTkHo9al5sBMNA: bets $2
BypVLsYQt3ePFm2xQL/dOA: folds
46qCyJ6evTkHo9al5sBMNA collected $1.90 from pot
46qCyJ6evTkHo9al5sBMNA: doesn't show hand
*** SUMMARY ***
Total pot $2 | Rake $0.10
Board [6h Ad 5d]
Seat 1: 46qCyJ6evTkHo9al5sBMNA (big blind) collected ($1.90)
Seat 2: BypVLsYQt3ePFm2xQL/dOA (button) (small blind) folded on the Flop



PokerStars Game #59939744736:  Hold'em No Limit ($0.25/$0.50) - 2009/07/01 0:47:49 ET
Table '0eJtgVAXVvBgncFdcUpXcQ' 2-max Seat #2 is the button
Seat 1: Ag6DvxX4vbRheqsv2zXKTQ ($25.40 in chips)
Seat 2: KMc4R+K9ao4Ur3rF7NGe6Q ($28.40 in chips)
KMc4R+K9ao4Ur3rF7NGe6Q: posts small blind $0.25
Ag6DvxX4vbRheqsv2zXKTQ: posts big blind $0.50
*** HOLE CARDS ***
KMc4R+K9ao4Ur3rF7NGe6Q: calls $0.25
Ag6DvxX4vbRheqsv2zXKTQ: checks
*** FLOP *** [7h Jd 2h]
Ag6DvxX4vbRheqsv2zXKTQ said, "np lets continue"
Ag6DvxX4vbRheqsv2zXKTQ: checks
KMc4R+K9ao4Ur3rF7NGe6Q: bets $1
Ag6DvxX4vbRheqsv2zXKTQ: folds
KMc4R+K9ao4Ur3rF7NGe6Q said, "sure"
KMc4R+K9ao4Ur3rF7NGe6Q collected $0.95 from pot
*** SUMMARY ***
Total pot $1 | Rake $0.05
Board [7h Jd 2h]
Seat 1: Ag6DvxX4vbRheqsv2zXKTQ (big blind) folded on the Flop
Seat 2: KMc4R+K9ao4Ur3rF7NGe6Q (button) (small blind) collected ($0.95)



PokerStars Game #59939745266:  Hold'em No Limit ($0.25/$0.50) - 2009/07/01 0:47:50 ET
Table '+dXkOAQyS8j9PQZusUTMpg' 2-max Seat #2 is the button
Seat 1: XFa6sBGjP2gxoIvxR3fZIg ($60.90 in chips)
Seat 2: 5IBeOgaApY1Bvzv2P8X4EA ($142.05 in chips)
5IBeOgaApY1Bvzv2P8X4EA: posts small blind $0.25
XFa6sBGjP2gxoIvxR3fZIg: posts big blind $0.50
*** HOLE CARDS ***
5IBeOgaApY1Bvzv2P8X4EA: folds
XFa6sBGjP2gxoIvxR3fZIg collected $0.50 from pot
*** SUMMARY ***
Total pot $0.50 | Rake $0
Seat 1: XFa6sBGjP2gxoIvxR3fZIg (big blind) collected ($0.50)
Seat 2: 5IBeOgaApY1Bvzv2P8X4EA (button) (small blind) folded before Flop



PokerStars Game #59939746236:  Hold'em No Limit ($0.25/$0.50) - 2009/07/01 0:47:52 ET
Table 'E7bWJ45aoFXRpyRv2gw+Ig' 2-max Seat #1 is the button
Seat 1: FRkiRasEGlHUeLrEl+k/nA ($91.50 in chips)
Seat 2: 3Wro85I7472vJ4Wkpneo9A ($102.85 in chips)
FRkiRasEGlHUeLrEl+k/nA: posts small blind $0.25
3Wro85I7472vJ4Wkpneo9A: posts big blind $0.50
*** HOLE CARDS ***
FRkiRasEGlHUeLrEl+k/nA: raises $1.50 to $2
3Wro85I7472vJ4Wkpneo9A: folds
FRkiRasEGlHUeLrEl+k/nA collected $1 from pot
*** SUMMARY ***
Total pot $1 | Rake $0
Seat 1: FRkiRasEGlHUeLrEl+k/nA (button) (small blind) collected ($1)
Seat 2: 3Wro85I7472vJ4Wkpneo9A (big blind) folded before Flop



PokerStars Game #59939748282:  Hold'em No Limit ($0.25/$0.50) - 2009/07/01 0:47:55 ET
Table 'QOeVnLhwctF9UyV/beDi+A' 2-max Seat #1 is the button
Seat 1: bypIyrYcAAifLfhZpGlKLA ($67.05 in chips)
Seat 2: Ucrm3XtZmoONapW32SPhag ($15.40 in chips)
bypIyrYcAAifLfhZpGlKLA: posts small blind $0.25
Ucrm3XtZmoONapW32SPhag: posts big blind $0.50
*** HOLE CARDS ***
bypIyrYcAAifLfhZpGlKLA: raises $1 to $1.50
Ucrm3XtZmoONapW32SPhag: folds
bypIyrYcAAifLfhZpGlKLA collected $1 from pot
bypIyrYcAAifLfhZpGlKLA: doesn't show hand
*** SUMMARY ***
Total pot $1 | Rake $0
Seat 1: bypIyrYcAAifLfhZpGlKLA (button) (small blind) collected ($1)
Seat 2: Ucrm3XtZmoONapW32SPhag (big blind) folded before Flop



PokerStars Game #59939748238:  Hold'em No Limit ($0.25/$0.50) - 2009/07/01 0:47:55 ET
Table '+111aLuBwnz8YVYSA7J1jA' 2-max Seat #2 is the button
Seat 1: ndd1nfncBkWNitBnsfCoVQ ($91.60 in chips)
Seat 2: +ciXH35zeafrjg1W6wiBTg ($55.35 in chips)
+ciXH35zeafrjg1W6wiBTg: posts small blind $0.25
ndd1nfncBkWNitBnsfCoVQ: posts big blind $0.50
*** HOLE CARDS ***
+ciXH35zeafrjg1W6wiBTg: raises $1.50 to $2
ndd1nfncBkWNitBnsfCoVQ: folds
+ciXH35zeafrjg1W6wiBTg collected $1 from pot
+ciXH35zeafrjg1W6wiBTg: doesn't show hand
*** SUMMARY ***
Total pot $1 | Rake $0
Seat 1: ndd1nfncBkWNitBnsfCoVQ (big blind) folded before Flop
Seat 2: +ciXH35zeafrjg1W6wiBTg (button) (small blind) collected ($1)



PokerStars Game #59939749264:  Hold'em No Limit ($0.25/$0.50) - 2009/07/01 0:47:56 ET
Table 'IeNZOZQ4T6oiaHqFeo6yIA' 2-max Seat #2 is the button
Seat 1: ndd1nfncBkWNitBnsfCoVQ ($63.60 in chips)
Seat 2: A91IUl5JaZROhtfCtnnwYw ($118.30 in chips)
A91IUl5JaZROhtfCtnnwYw: posts small blind $0.25
ndd1nfncBkWNitBnsfCoVQ: posts big blind $0.50
*** HOLE CARDS ***
A91IUl5JaZROhtfCtnnwYw: calls $0.25
ndd1nfncBkWNitBnsfCoVQ: checks
*** FLOP *** [As 2c Kd]
ndd1nfncBkWNitBnsfCoVQ: checks
A91IUl5JaZROhtfCtnnwYw: checks
*** TURN *** [As 2c Kd] [Th]
ndd1nfncBkWNitBnsfCoVQ: checks
A91IUl5JaZROhtfCtnnwYw: checks
*** RIVER *** [As 2c Kd Th] [3c]
ndd1nfncBkWNitBnsfCoVQ: checks
A91IUl5JaZROhtfCtnnwYw: bets $1
ndd1nfncBkWNitBnsfCoVQ: folds
A91IUl5JaZROhtfCtnnwYw collected $0.95 from pot
A91IUl5JaZROhtfCtnnwYw: doesn't show hand
*** SUMMARY ***
Total pot $1 | Rake $0.05
Board [As 2c Kd Th 3c]
Seat 1: ndd1nfncBkWNitBnsfCoVQ (big blind) folded on the River
Seat 2: A91IUl5JaZROhtfCtnnwYw (button) (small blind) collected ($0.95)



PokerStars Game #59939749574:  Hold'em No Limit ($0.25/$0.50) - 2009/07/01 0:47:57 ET
Table '+dXkOAQyS8j9PQZusUTMpg' 2-max Seat #1 is the button
Seat 1: XFa6sBGjP2gxoIvxR3fZIg ($61.15 in chips)
Seat 2: 5IBeOgaApY1Bvzv2P8X4EA ($141.80 in chips)
XFa6sBGjP2gxoIvxR3fZIg: posts small blind $0.25
5IBeOgaApY1Bvzv2P8X4EA: posts big blind $0.50
*** HOLE CARDS ***
XFa6sBGjP2gxoIvxR3fZIg: raises $1 to $1.50
5IBeOgaApY1Bvzv2P8X4EA: calls $1
*** FLOP *** [2c 7h 3d]
5IBeOgaApY1Bvzv2P8X4EA: checks
XFa6sBGjP2gxoIvxR3fZIg: bets $2
5IBeOgaApY1Bvzv2P8X4EA: folds
XFa6sBGjP2gxoIvxR3fZIg collected $2.85 from pot
XFa6sBGjP2gxoIvxR3fZIg: doesn't show hand
*** SUMMARY ***
Total pot $3 | Rake $0.15
Board [2c 7h 3d]
Seat 1: XFa6sBGjP2gxoIvxR3fZIg (button) (small blind) collected ($2.85)
Seat 2: 5IBeOgaApY1Bvzv2P8X4EA (big blind) folded on the Flop



PokerStars Game #59939751786:  Hold'em No Limit ($0.25/$0.50) - 2009/07/01 0:48:00 ET
Table 'E7bWJ45aoFXRpyRv2gw+Ig' 2-max Seat #2 is the button
Seat 1: FRkiRasEGlHUeLrEl+k/nA ($92 in chips)
Seat 2: 3Wro85I7472vJ4Wkpneo9A ($102.35 in chips)
3Wro85I7472vJ4Wkpneo9A: posts small blind $0.25
FRkiRasEGlHUeLrEl+k/nA: posts big blind $0.50
*** HOLE CARDS ***
3Wro85I7472vJ4Wkpneo9A: raises $1 to $1.50
FRkiRasEGlHUeLrEl+k/nA: calls $1
*** FLOP *** [8d Qd Th]
FRkiRasEGlHUeLrEl+k/nA: checks
3Wro85I7472vJ4Wkpneo9A: bets $2
FRkiRasEGlHUeLrEl+k/nA: calls $2
*** TURN *** [8d Qd Th] [8c]
FRkiRasEGlHUeLrEl+k/nA: checks
3Wro85I7472vJ4Wkpneo9A: bets $4.50
FRkiRasEGlHUeLrEl+k/nA: folds
3Wro85I7472vJ4Wkpneo9A collected $6.70 from pot
3Wro85I7472vJ4Wkpneo9A: doesn't show hand
*** SUMMARY ***
Total pot $7 | Rake $0.30
Board [8d Qd Th 8c]
Seat 1: FRkiRasEGlHUeLrEl+k/nA (big blind) folded on the Turn
Seat 2: 3Wro85I7472vJ4Wkpneo9A (button) (small blind) collected ($6.70)



PokerStars Game #59939751618:  Hold'em No Limit ($0.25/$0.50) - 2009/07/01 0:48:00 ET
Table '5EmHi+fnatGQQShcNmzOZQ' 6-max Seat #2 is the button
Seat 2: vXIHnZ+dv/hwSBxyvGw7bQ ($52.55 in chips)
Seat 4: 1b+2BbjMN8qhR1WPqdE9VQ ($53.15 in chips)
Seat 5: kxPhs4ePFqMy52CInAJ2aw ($55.85 in chips)
Seat 6: 686aeHikcJlgKkSuIFdcXQ ($141.20 in chips)
TjmTe3bhs9dFz5gXX9x7Lw will be allowed to play after the button
1b+2BbjMN8qhR1WPqdE9VQ: posts small blind $0.25
kxPhs4ePFqMy52CInAJ2aw: posts big blind $0.50
*** HOLE CARDS ***
686aeHikcJlgKkSuIFdcXQ: folds
vXIHnZ+dv/hwSBxyvGw7bQ: raises $1 to $1.50
1b+2BbjMN8qhR1WPqdE9VQ: folds
kxPhs4ePFqMy52CInAJ2aw: folds
vXIHnZ+dv/hwSBxyvGw7bQ collected $1.25 from pot
vXIHnZ+dv/hwSBxyvGw7bQ: doesn't show hand
*** SUMMARY ***
Total pot $1.25 | Rake $0
Seat 2: vXIHnZ+dv/hwSBxyvGw7bQ (button) collected ($1.25)
Seat 4: 1b+2BbjMN8qhR1WPqdE9VQ (small blind) folded before Flop
Seat 5: kxPhs4ePFqMy52CInAJ2aw (big blind) folded before Flop
Seat 6: 686aeHikcJlgKkSuIFdcXQ folded before Flop (didn't bet)



PokerStars Game #59939753356:  Hold'em No Limit ($0.25/$0.50) - 2009/07/01 0:48:03 ET
Table 'QOeVnLhwctF9UyV/beDi+A' 2-max Seat #2 is the button
Seat 1: bypIyrYcAAifLfhZpGlKLA ($67.55 in chips)
Seat 2: Ucrm3XtZmoONapW32SPhag ($14.90 in chips)
Ucrm3XtZmoONapW32SPhag: posts small blind $0.25
bypIyrYcAAifLfhZpGlKLA: posts big blind $0.50
*** HOLE CARDS ***
Ucrm3XtZmoONapW32SPhag: calls $0.25
bypIyrYcAAifLfhZpGlKLA: checks
*** FLOP *** [Ks 3s 6d]
bypIyrYcAAifLfhZpGlKLA: checks
Ucrm3XtZmoONapW32SPhag: checks
*** TURN *** [Ks 3s 6d] [8s]
bypIyrYcAAifLfhZpGlKLA: checks
Ucrm3XtZmoONapW32SPhag: bets $0.50
bypIyrYcAAifLfhZpGlKLA: folds
Ucrm3XtZmoONapW32SPhag collected $0.95 from pot
Ucrm3XtZmoONapW32SPhag: doesn't show hand
*** SUMMARY ***
Total pot $1 | Rake $0.05
Board [Ks 3s 6d 8s]
Seat 1: bypIyrYcAAifLfhZpGlKLA (big blind) folded on the Turn
Seat 2: Ucrm3XtZmoONapW32SPhag (button) (small blind) collected ($0.95)



PokerStars Game #59939753188:  Hold'em No Limit ($0.25/$0.50) - 2009/07/01 0:48:03 ET
Table '+111aLuBwnz8YVYSA7J1jA' 2-max Seat #1 is the button
Seat 1: ndd1nfncBkWNitBnsfCoVQ ($91.10 in chips)
Seat 2: +ciXH35zeafrjg1W6wiBTg ($55.85 in chips)
ndd1nfncBkWNitBnsfCoVQ: posts small blind $0.25
+ciXH35zeafrjg1W6wiBTg: posts big blind $0.50
*** HOLE CARDS ***
ndd1nfncBkWNitBnsfCoVQ: raises $1 to $1.50
+ciXH35zeafrjg1W6wiBTg: raises $2 to $3.50
ndd1nfncBkWNitBnsfCoVQ: raises $7.50 to $11
+ciXH35zeafrjg1W6wiBTg: calls $7.50
*** FLOP *** [8c 8s 8d]
+ciXH35zeafrjg1W6wiBTg: checks
ndd1nfncBkWNitBnsfCoVQ: bets $13
+ciXH35zeafrjg1W6wiBTg: calls $13
*** TURN *** [8c 8s 8d] [Kh]
+ciXH35zeafrjg1W6wiBTg: checks
ndd1nfncBkWNitBnsfCoVQ: bets $35
+ciXH35zeafrjg1W6wiBTg: calls $31.85 and is all-in
*** RIVER *** [8c 8s 8d Kh] [Qs]
*** SHOW DOWN ***
+ciXH35zeafrjg1W6wiBTg: shows [9d Ah] (three of a kind, Eights)
ndd1nfncBkWNitBnsfCoVQ: mucks hand
ndd1nfncBkWNitBnsfCoVQ leaves the table
+ciXH35zeafrjg1W6wiBTg collected $111.20 from pot
*** SUMMARY ***
Total pot $111.70 | Rake $0.50
Board [8c 8s 8d Kh Qs]
Seat 1: ndd1nfncBkWNitBnsfCoVQ (button) (small blind) mucked
Seat 2: +ciXH35zeafrjg1W6wiBTg (big blind) showed [9d Ah] and won ($111.20) with three of a kind, Eights



PokerStars Game #59939753930:  Hold'em No Limit ($0.25/$0.50) - 2009/07/01 0:48:04 ET
Table '0eJtgVAXVvBgncFdcUpXcQ' 2-max Seat #1 is the button
Seat 1: Ag6DvxX4vbRheqsv2zXKTQ ($24.90 in chips)
Seat 2: KMc4R+K9ao4Ur3rF7NGe6Q ($28.85 in chips)
Ag6DvxX4vbRheqsv2zXKTQ: posts small blind $0.25
KMc4R+K9ao4Ur3rF7NGe6Q: posts big blind $0.50
*** HOLE CARDS ***
Ag6DvxX4vbRheqsv2zXKTQ: raises $1 to $1.50
KMc4R+K9ao4Ur3rF7NGe6Q: calls $1
*** FLOP *** [Kh Qd 7h]
KMc4R+K9ao4Ur3rF7NGe6Q: checks
Ag6DvxX4vbRheqsv2zXKTQ: bets $2
KMc4R+K9ao4Ur3rF7NGe6Q: folds
Ag6DvxX4vbRheqsv2zXKTQ collected $2.85 from pot
*** SUMMARY ***
Total pot $3 | Rake $0.15
Board [Kh Qd 7h]
Seat 1: Ag6DvxX4vbRheqsv2zXKTQ (button) (small blind) collected ($2.85)
Seat 2: KMc4R+K9ao4Ur3rF7NGe6Q (big blind) folded on the Flop



PokerStars Game #59939754584:  Hold'em No Limit ($0.25/$0.50) - 2009/07/01 0:48:05 ET
Table 'BCN5su+SsXiy1zRMJi0SJw' 6-max Seat #2 is the button
Seat 2: oU2kDCkT/gilYbHWrg7D8w ($10.30 in chips)
Seat 3: g+vwI6lMKpU2uteXSjOzVw ($17.95 in chips)
Seat 4: JY9CtoZTeav+mhWyxSSyJQ ($25.65 in chips)
Seat 5: IBNygaT1aa9Z1uPdJJilwA ($17.25 in chips)
Seat 6: b2symlOdL7+0c9Pj4N/KlA ($100.95 in chips)
g+vwI6lMKpU2uteXSjOzVw: posts small blind $0.25
JY9CtoZTeav+mhWyxSSyJQ: posts big blind $0.50
GxXV09ciXaOxyY2H5aMIIw: sits out
*** HOLE CARDS ***
IBNygaT1aa9Z1uPdJJilwA: folds
b2symlOdL7+0c9Pj4N/KlA: folds
oU2kDCkT/gilYbHWrg7D8w: folds
g+vwI6lMKpU2uteXSjOzVw: calls $0.25
JY9CtoZTeav+mhWyxSSyJQ: checks
*** FLOP *** [4c 8d 2s]
g+vwI6lMKpU2uteXSjOzVw: checks
JY9CtoZTeav+mhWyxSSyJQ: bets $0.50
g+vwI6lMKpU2uteXSjOzVw: folds
JY9CtoZTeav+mhWyxSSyJQ collected $0.95 from pot
JY9CtoZTeav+mhWyxSSyJQ: doesn't show hand
*** SUMMARY ***
Total pot $1 | Rake $0.05
Board [4c 8d 2s]
Seat 2: oU2kDCkT/gilYbHWrg7D8w (button) folded before Flop (didn't bet)
Seat 3: g+vwI6lMKpU2uteXSjOzVw (small blind) folded on the Flop
Seat 4: JY9CtoZTeav+mhWyxSSyJQ (big blind) collected ($0.95)
Seat 5: IBNygaT1aa9Z1uPdJJilwA folded before Flop (didn't bet)
Seat 6: b2symlOdL7+0c9Pj4N/KlA folded before Flop (didn't bet)



PokerStars Game #59939757866:  Hold'em No Limit ($0.25/$0.50) - 2009/07/01 0:48:10 ET
Table 'c/CRn+68J3Y8KxD5g1ek2Q' 2-max Seat #1 is the button
Seat 1: 46qCyJ6evTkHo9al5sBMNA ($233.45 in chips)
Seat 2: BypVLsYQt3ePFm2xQL/dOA ($139.80 in chips)
46qCyJ6evTkHo9al5sBMNA: posts small blind $0.25
BypVLsYQt3ePFm2xQL/dOA: posts big blind $0.50
*** HOLE CARDS ***
46qCyJ6evTkHo9al5sBMNA: raises $1.50 to $2
BypVLsYQt3ePFm2xQL/dOA: folds
46qCyJ6evTkHo9al5sBMNA collected $1 from pot
46qCyJ6evTkHo9al5sBMNA: doesn't show hand
*** SUMMARY ***
Total pot $1 | Rake $0
Seat 1: 46qCyJ6evTkHo9al5sBMNA (button) (small blind) collected ($1)
Seat 2: BypVLsYQt3ePFm2xQL/dOA (big blind) folded before Flop



PokerStars Game #59939758022:  Hold'em No Limit ($0.25/$0.50) - 2009/07/01 0:48:10 ET
Table 'Vdlc9wqYcHTUhtdyN7CuJw' 2-max Seat #1 is the button
Seat 1: yBO+mXB6m/rCft2ErwGf/Q ($117.25 in chips)
Seat 2: NZ/5cxwnorKW2SNsWy1+8A ($8.45 in chips)
yBO+mXB6m/rCft2ErwGf/Q: posts small blind $0.25
NZ/5cxwnorKW2SNsWy1+8A: posts big blind $0.50
*** HOLE CARDS ***
yBO+mXB6m/rCft2ErwGf/Q: raises $1 to $1.50
NZ/5cxwnorKW2SNsWy1+8A: folds
yBO+mXB6m/rCft2ErwGf/Q collected $1 from pot
*** SUMMARY ***
Total pot $1 | Rake $0
Seat 1: yBO+mXB6m/rCft2ErwGf/Q (button) (small blind) collected ($1)
Seat 2: NZ/5cxwnorKW2SNsWy1+8A (big blind) folded before Flop



PokerStars Game #59939758788:  Hold'em No Limit ($0.25/$0.50) - 2009/07/01 0:48:11 ET
Table 'T/PgNWqVyY6lkldcBVXYJQ' 6-max Seat #2 is the button
Seat 1: +Pf9jTVizYlIo+woPvptfA ($55.75 in chips)
Seat 2: LvH4G7n+QSjT6NDaD3cREA ($59.75 in chips)
Seat 3: L3OcNO1bgdqDI46j67KQPQ ($50.25 in chips)
Seat 4: Ek4w9XqBXqK5jBUQeLedGw ($50 in chips)
Seat 5: vVQBckETtigfb5mAcyK0OA ($52.95 in chips)
Seat 6: cDzbog6kwmJp+LBeBq+iMQ ($44.75 in chips)
L3OcNO1bgdqDI46j67KQPQ: posts small blind $0.25
Ek4w9XqBXqK5jBUQeLedGw: posts big blind $0.50
*** HOLE CARDS ***
vVQBckETtigfb5mAcyK0OA: calls $0.50
cDzbog6kwmJp+LBeBq+iMQ: folds
+Pf9jTVizYlIo+woPvptfA: folds
LvH4G7n+QSjT6NDaD3cREA: raises $1.50 to $2
L3OcNO1bgdqDI46j67KQPQ: folds
Ek4w9XqBXqK5jBUQeLedGw: folds
vVQBckETtigfb5mAcyK0OA: calls $1.50
*** FLOP *** [8s 7s 4h]
vVQBckETtigfb5mAcyK0OA: checks
LvH4G7n+QSjT6NDaD3cREA: checks
*** TURN *** [8s 7s 4h] [8h]
vVQBckETtigfb5mAcyK0OA: bets $3
LvH4G7n+QSjT6NDaD3cREA: calls $3
*** RIVER *** [8s 7s 4h 8h] [4c]
vVQBckETtigfb5mAcyK0OA: bets $0.50
LvH4G7n+QSjT6NDaD3cREA: calls $0.50
*** SHOW DOWN ***
vVQBckETtigfb5mAcyK0OA: shows [6d 7d] (two pair, Eights and Sevens)
LvH4G7n+QSjT6NDaD3cREA: mucks hand
vVQBckETtigfb5mAcyK0OA collected $11.20 from pot
vVQBckETtigfb5mAcyK0OA is sitting out
*** SUMMARY ***
Total pot $11.75 | Rake $0.55
Board [8s 7s 4h 8h 4c]
Seat 1: +Pf9jTVizYlIo+woPvptfA folded before Flop (didn't bet)
Seat 2: LvH4G7n+QSjT6NDaD3cREA (button) mucked
Seat 3: L3OcNO1bgdqDI46j67KQPQ (small blind) folded before Flop
Seat 4: Ek4w9XqBXqK5jBUQeLedGw (big blind) folded before Flop
Seat 5: vVQBckETtigfb5mAcyK0OA showed [6d 7d] and won ($11.20) with two pair, Eights and Sevens
Seat 6: cDzbog6kwmJp+LBeBq+iMQ folded before Flop (didn't bet)



PokerStars Game #59939758378:  Hold'em No Limit ($0.25/$0.50) - 2009/07/01 0:48:11 ET
Table '99gCy/CZQwPIjZWH+BguQgE7bWJ45aoFXRpyRv2gw+Igeat #2 is the button
Seat 2: n6VQBu6crjYjy6DxNP1NZA ($28.90 in chips)
Seat 3: qEn9ijNGtuyTxamBf07hYg ($50 in chips)
Seat 4: bxLSulbgr8LmKNjOzw8URg ($64.20 in chips)
Seat 5: DSM67hHHq1XFoEOi9p8Alw ($49.25 in chips)
Seat 7: bfSq6LBw0UvxeM5yfuWC7w ($18.60 in chips)
Seat 8: 8ehL7qlZzjgUh2H35iiWLw ($50 in chips)
Seat 9: j3K/Jujr7PY4ZM2RZvlH6A ($85.65 in chips)
qEn9ijNGtuyTxamBf07hYg: posts small blind $0.25
bxLSulbgr8LmKNjOzw8URg: posts big blind $0.50
*** HOLE CARDS ***
DSM67hHHq1XFoEOi9p8Alw: folds
bfSq6LBw0UvxeM5yfuWC7w: folds
8ehL7qlZzjgUh2H35iiWLw: folds
j3K/Jujr7PY4ZM2RZvlH6A: raises $2 to $2.50
n6VQBu6crjYjy6DxNP1NZA: folds
qEn9ijNGtuyTxamBf07hYg: folds
bxLSulbgr8LmKNjOzw8URg: calls $2
*** FLOP *** [9d 4d Jh]
bxLSulbgr8LmKNjOzw8URg: checks
j3K/Jujr7PY4ZM2RZvlH6A: bets $4.50
bfSq6LBw0UvxeM5yfuWC7w said, "ALVARO_20!?"
bxLSulbgr8LmKNjOzw8URg: folds
j3K/Jujr7PY4ZM2RZvlH6A collected $5 from pot
j3K/Jujr7PY4ZM2RZvlH6A: doesn't show hand
bfSq6LBw0UvxeM5yfuWC7w said, "IS THAT PICTURE OF AMANDA BYNES"
*** SUMMARY ***
Total pot $5.25 | Rake $0.25
Board [9d 4d Jh]
Seat 2: n6VQBu6crjYjy6DxNP1NZA (button) folded before Flop (didn't bet)
Seat 3: qEn9ijNGtuyTxamBf07hYg (small blind) folded before Flop
Seat 4: bxLSulbgr8LmKNjOzw8URg (big blind) folded on the Flop
Seat 5: DSM67hHHq1XFoEOi9p8Alw folded before Flop (didn't bet)
Seat 7: bfSq6LBw0UvxeM5yfuWC7w folded before Flop (didn't bet)
Seat 8: 8ehL7qlZzjgUh2H35iiWLw folded before Flop (didn't bet)
Seat 9: j3K/Jujr7PY4ZM2RZvlH6A collected ($5)



PokerStars Game #59939758656:  Hold'em No Limit ($0.25/$0.50) - 2009/07/01 0:48:11 ET
Table '/cQuAT3ef4t+PGrXiNhGaQ' 9-max Seat #6 is the button
Seat 1: HZkVla4kK2SI42CVrPZ/ig ($10.70 in chips)
Seat 2: jXGruyaMqirTaTXNOvBdew ($69.45 in chips)
Seat 3: g4k0NXISyLCqaSWZDBjfEg ($55.25 in chips)
Seat 4: OWP/DOu+PlPK6ZZ3zYa0HA ($29.40 in chips)
Seat 5: 5SgaHdWixdClWvaEG+KUjQ ($25.60 in chips)
Seat 6: APYIOyK/4AGb+kIwlOUNBQ ($37.25 in chips)
Seat 7: J0W5D97jl5VLky+IoPvDeA ($113.65 in chips)
Seat 8: eBrej2jnlUCs/JgxFCRn2g ($40 in chips)
Seat 9: AjV5McH1KMMclY26QdLM5w ($26.10 in chips)
J0W5D97jl5VLky+IoPvDeA: posts small blind $0.25
eBrej2jnlUCs/JgxFCRn2g: posts big blind $0.50
*** HOLE CARDS ***
AjV5McH1KMMclY26QdLM5w: folds
HZkVla4kK2SI42CVrPZ/ig: folds
jXGruyaMqirTaTXNOvBdew: folds
g4k0NXISyLCqaSWZDBjfEg: folds
OWP/DOu+PlPK6ZZ3zYa0HA: folds
5SgaHdWixdClWvaEG+KUjQ: folds
APYIOyK/4AGb+kIwlOUNBQ: folds
J0W5D97jl5VLky+IoPvDeA: folds
eBrej2jnlUCs/JgxFCRn2g collected $0.50 from pot
*** SUMMARY ***
Total pot $0.50 | Rake $0
Seat 1: HZkVla4kK2SI42CVrPZ/ig folded before Flop (didn't bet)
Seat 2: jXGruyaMqirTaTXNOvBdew folded before Flop (didn't bet)
Seat 3: g4k0NXISyLCqaSWZDBjfEg folded before Flop (didn't bet)
Seat 4: OWP/DOu+PlPK6ZZ3zYa0HA folded before Flop (didn't bet)
Seat 5: 5SgaHdWixdClWvaEG+KUjQ folded before Flop (didn't bet)
Seat 6: APYIOyK/4AGb+kIwlOUNBQ (button) folded before Flop (didn't bet)
Seat 7: J0W5D97jl5VLky+IoPvDeA (small blind) folded before Flop
Seat 8: eBrej2jnlUCs/JgxFCRn2g (big blind) collected ($0.50)
Seat 9: AjV5McH1KMMclY26QdLM5w folded before Flop (didn't bet)



PokerStars Game #59939758998:  Hold'em No Limit ($0.25/$0.50) - 2009/07/01 0:48:12 ET
Table '+dXkOAQyS8j9PQZusUTMpg' 2-max Seat #2 is the button
Seat 1: XFa6sBGjP2gxoIvxR3fZIg ($62.50 in chips)
Seat 2: 5IBeOgaApY1Bvzv2P8X4EA ($140.30 in chips)
5IBeOgaApY1Bvzv2P8X4EA: posts small blind $0.25
XFa6sBGjP2gxoIvxR3fZIg: posts big blind $0.50
*** HOLE CARDS ***
5IBeOgaApY1Bvzv2P8X4EA: folds
XFa6sBGjP2gxoIvxR3fZIg collected $0.50 from pot
*** SUMMARY ***
Total pot $0.50 | Rake $0
Seat 1: XFa6sBGjP2gxoIvxR3fZIg (big blind) collected ($0.50)
Seat 2: 5IBeOgaApY1Bvzv2P8X4EA (button) (small blind) folded before Flop



PokerStars Game #59939759682:  Hold'em No Limit ($0.25/$0.50) - 2009/07/01 0:48:13 ET
Table '3FhG0gl3kMX3wBEEqj+wnQ' 9-max Seat #6 is the button
Seat 1: e0J9pdCNUDTCG031RnXqLA ($35.55 in chips)
Seat 2: 7cYQ+syUWjl38ty/ICOMhw ($50 in chips)
Seat 4: bjvJtA9Hqscfznq66txaOQ ($9.50 in chips)
Seat 5: gsyXT42WLEcOS4DdEk2wlw ($27.75 in chips)
Seat 6: 997ViqAtWn1FPjJqcffwcA ($50 in chips)
Seat 7: mSD1pginDsyHG5PDfqzphw ($10.50 in chips)
Seat 8: j3K/Jujr7PY4ZM2RZvlH6A ($58.50 in chips)
Seat 9: L5e2lrPLQm1Pqx30IIZ/Fw ($10 in chips)
mSD1pginDsyHG5PDfqzphw: posts small blind $0.25
j3K/Jujr7PY4ZM2RZvlH6A: posts big blind $0.50
*** HOLE CARDS ***
L5e2lrPLQm1Pqx30IIZ/Fw: folds
e0J9pdCNUDTCG031RnXqLA: raises $0.50 to $1
7cYQ+syUWjl38ty/ICOMhw: folds
bjvJtA9Hqscfznq66txaOQ: folds
gsyXT42WLEcOS4DdEk2wlw: folds
997ViqAtWn1FPjJqcffwcA: folds
mSD1pginDsyHG5PDfqzphw: folds
j3K/Jujr7PY4ZM2RZvlH6A: raises $1.50 to $2.50
e0J9pdCNUDTCG031RnXqLA: calls $1.50
*** FLOP *** [2c 4s Ah]
j3K/Jujr7PY4ZM2RZvlH6A: bets $3.50
e0J9pdCNUDTCG031RnXqLA: folds
j3K/Jujr7PY4ZM2RZvlH6A collected $5 from pot
j3K/Jujr7PY4ZM2RZvlH6A: doesn't show hand
*** SUMMARY ***
Total pot $5.25 | Rake $0.25
Board [2c 4s Ah]
Seat 1: e0J9pdCNUDTCG031RnXqLA folded on the Flop
Seat 2: 7cYQ+syUWjl38ty/ICOMhw folded before Flop (didn't bet)
Seat 4: bjvJtA9Hqscfznq66txaOQ folded before Flop (didn't bet)
Seat 5: gsyXT42WLEcOS4DdEk2wlw folded before Flop (didn't bet)
Seat 6: 997ViqAtWn1FPjJqcffwcA (button) folded before Flop (didn't bet)
Seat 7: mSD1pginDsyHG5PDfqzphw (small blind) folded before Flop
Seat 8: j3K/Jujr7PY4ZM2RZvlH6A (big blind) collected ($5)
Seat 9: L5e2lrPLQm1Pqx30IIZ/Fw folded before Flop (didn't bet)



PokerStars Game #59939761698:  Hold'em No Limit ($0.25/$0.50) - 2009/07/01 0:48:16 ET
Table 'QOgaEqMcJ73pcUMMxoisUgErOuyGLI5PT3G5MnpHgC/g Seat #6 is the button
Seat 3: xZCXQSXlrZkp3pZizzVXCw ($49.75 in chips)
Seat 4: 3UmXLy3GfjC3EkOebduerQ ($50 in chips)
Seat 5: JwvquocWfhTVApN5t47LgA ($60.10 in chips)
Seat 6: zE9cVigS2nW/Ljy4K4bUQA ($30 in chips)
Seat 7: 90Wb75h3W1BRpbqVnuk8gw ($61.95 in chips)
Seat 8: g4k0NXISyLCqaSWZDBjfEg ($50 in chips)
Seat 9: J0W5D97jl5VLky+IoPvDeA ($57.90 in chips)
90Wb75h3W1BRpbqVnuk8gw: posts small blind $0.25
g4k0NXISyLCqaSWZDBjfEg: posts big blind $0.50
eBrej2jnlUCs/JgxFCRn2g: sits out
*** HOLE CARDS ***
J0W5D97jl5VLky+IoPvDeA: folds
xZCXQSXlrZkp3pZizzVXCw: folds
3UmXLy3GfjC3EkOebduerQ: folds
JwvquocWfhTVApN5t47LgA: folds
zE9cVigS2nW/Ljy4K4bUQA: folds
90Wb75h3W1BRpbqVnuk8gw: folds
g4k0NXISyLCqaSWZDBjfEg collected $0.50 from pot
*** SUMMARY ***
Total pot $0.50 | Rake $0
Seat 3: xZCXQSXlrZkp3pZizzVXCw folded before Flop (didn't bet)
Seat 4: 3UmXLy3GfjC3EkOebduerQ folded before Flop (didn't bet)
Seat 5: JwvquocWfhTVApN5t47LgA folded before Flop (didn't bet)
Seat 6: zE9cVigS2nW/Ljy4K4bUQA (button) folded before Flop (didn't bet)
Seat 7: 90Wb75h3W1BRpbqVnuk8gw (small blind) folded before Flop
Seat 8: g4k0NXISyLCqaSWZDBjfEg (big blind) collected ($0.50)
Seat 9: J0W5D97jl5VLky+IoPvDeA folded before Flop (didn't bet)



PokerStars Game #59939761988:  Hold'em No Limit ($0.25/$0.50) - 2009/07/01 0:48:16 ET
Table 'NCiXr0d5CEKBQr/cZgLhbA' 9-max Seat #2 is the button
Seat 1: pFtzb1sR4b0d1aw6aIRgDg ($50 in chips)
Seat 2: ulxuJchBV9iguXg0FUonfg ($49.75 in chips)
Seat 3: xZCXQSXlrZkp3pZizzVXCw ($51.75 in chips)
Seat 4: 5k9fvXD9suIgCxU4HLQjTw ($56.70 in chips)
Seat 5: zE9cVigS2nW/Ljy4K4bUQA ($36.70 in chips)
Seat 6: SKnJuWHScqetA/qG5p+wCg ($33.45 in chips)
Seat 7: M+7+BTmX5vZatHVuoRB1nA ($47.60 in chips)
Seat 8: 1MJUKc3cc0QmUoz1JZLR2w ($57.25 in chips)
Seat 9: 4WLZvqBn5qv5tds5kt5A1Q ($45.80 in chips)
xZCXQSXlrZkp3pZizzVXCw: posts small blind $0.25
5k9fvXD9suIgCxU4HLQjTw: posts big blind $0.50
*** HOLE CARDS ***
zE9cVigS2nW/Ljy4K4bUQA: folds
SKnJuWHScqetA/qG5p+wCg: folds
M+7+BTmX5vZatHVuoRB1nA: folds
1MJUKc3cc0QmUoz1JZLR2w: folds
4WLZvqBn5qv5tds5kt5A1Q: folds
pFtzb1sR4b0d1aw6aIRgDg: folds
ulxuJchBV9iguXg0FUonfg: folds
xZCXQSXlrZkp3pZizzVXCw: raises $1 to $1.50
5k9fvXD9suIgCxU4HLQjTw: folds
xZCXQSXlrZkp3pZizzVXCw collected $1 from pot
*** SUMMARY ***
Total pot $1 | Rake $0
Seat 1: pFtzb1sR4b0d1aw6aIRgDg folded before Flop (didn't bet)
Seat 2: ulxuJchBV9iguXg0FUonfg (button) folded before Flop (didn't bet)
Seat 3: xZCXQSXlrZkp3pZizzVXCw (small blind) collected ($1)
Seat 4: 5k9fvXD9suIgCxU4HLQjTw (big blind) folded before Flop
Seat 5: zE9cVigS2nW/Ljy4K4bUQA folded before Flop (didn't bet)
Seat 6: SKnJuWHScqetA/qG5p+wCg folded before Flop (didn't bet)
Seat 7: M+7+BTmX5vZatHVuoRB1nA folded before Flop (didn't bet)
Seat 8: 1MJUKc3cc0QmUoz1JZLR2w folded before Flop (didn't bet)
Seat 9: 4WLZvqBn5qv5tds5kt5A1Q folded before Flop (didn't bet)



PokerStars Game #59939761908:  Hold'em No Limit ($0.25/$0.50) - 2009/07/01 0:48:16 ET
Table 'GfL/No5u5PoEnU39lP5pQg' 6-max Seat #4 is the button
Seat 1: 1WUCqNG+p+vfWRTXNu4ljw ($62.50 in chips)
Seat 2: uVwggSetzp7d+eVgowO3vg ($64.95 in chips)
Seat 3: Ek4w9XqBXqK5jBUQeLedGw ($50 in chips)
Seat 4: r6u7MWSXF30/khcTYkrG9Q ($23.80 in chips)
Seat 5: M1KyQQvVPVuxqTAB8sR/zQ ($52.50 in chips)
M1KyQQvVPVuxqTAB8sR/zQ: posts small blind $0.25
1WUCqNG+p+vfWRTXNu4ljw: posts big blind $0.50
*** HOLE CARDS ***
r6u7MWSXF30/khcTYkrG9Q said, "what's the deal with the 5xvpp?"
uVwggSetzp7d+eVgowO3vg: folds
Ek4w9XqBXqK5jBUQeLedGw: folds
r6u7MWSXF30/khcTYkrG9Q said, "they running some kind of special this month?"
r6u7MWSXF30/khcTYkrG9Q: raises $1 to $1.50
M1KyQQvVPVuxqTAB8sR/zQ: folds
1WUCqNG+p+vfWRTXNu4ljw: calls $1
*** FLOP *** [6d Kh Kd]
1WUCqNG+p+vfWRTXNu4ljw: checks
r6u7MWSXF30/khcTYkrG9Q: checks
*** TURN *** [6d Kh Kd] [8c]
1WUCqNG+p+vfWRTXNu4ljw: checks
r6u7MWSXF30/khcTYkrG9Q: checks
*** RIVER *** [6d Kh Kd 8c] [Ks]
1WUCqNG+p+vfWRTXNu4ljw: checks
r6u7MWSXF30/khcTYkrG9Q: checks
*** SHOW DOWN ***
1WUCqNG+p+vfWRTXNu4ljw: shows [4h Ad] (three of a kind, Kings)
r6u7MWSXF30/khcTYkrG9Q: shows [As Jc] (three of a kind, Kings - Ace+Jack kicker)
r6u7MWSXF30/khcTYkrG9Q collected $3.10 from pot
*** SUMMARY ***
Total pot $3.25 | Rake $0.15
Board [6d Kh Kd 8c Ks]
Seat 1: 1WUCqNG+p+vfWRTXNu4ljw (big blind) showed [4h Ad] and lost with three of a kind, Kings
Seat 2: uVwggSetzp7d+eVgowO3vg folded before Flop (didn't bet)
Seat 3: Ek4w9XqBXqK5jBUQeLedGw folded before Flop (didn't bet)
Seat 4: r6u7MWSXF30/khcTYkrG9Q (button) showed [As Jc] and won ($3.10) with three of a kind, Kings
Seat 5: M1KyQQvVPVuxqTAB8sR/zQ (small blind) folded before Flop



PokerStars Game #59939761990:  Hold'em No Limit ($0.25/$0.50) - 2009/07/01 0:48:16 ET
Table 'MJxeZCzYELxiIsyUZyT0jw' 6-max Seat #6 is the button
Seat 3: JQZew0FjzS19kTjeNtrE+A ($68.25 in chips)
Seat 4: alGiiQP/wwtYnfuXII+sgw ($46.25 in chips)
Seat 5: 3jvoOXNtXE90w2BdfNZwZQ ($50 in chips)
Seat 6: TTx3CHxyi0SObcHyMJRp5w ($53.15 in chips)
t3GiVMzqA9Svgr5Uol32cQ will be allowed to play after the button
JQZew0FjzS19kTjeNtrE+A: posts small blind $0.25
alGiiQP/wwtYnfuXII+sgw: posts big blind $0.50
*** HOLE CARDS ***
jNIq+EZLEm61oWSMYUVeWQ leaves the table
3jvoOXNtXE90w2BdfNZwZQ: folds
TTx3CHxyi0SObcHyMJRp5w: folds
JQZew0FjzS19kTjeNtrE+A: calls $0.25
alGiiQP/wwtYnfuXII+sgw: checks
*** FLOP *** [7d 9c Qs]
JQZew0FjzS19kTjeNtrE+A: bets $1
alGiiQP/wwtYnfuXII+sgw: calls $1
*** TURN *** [7d 9c Qs] [3h]
JQZew0FjzS19kTjeNtrE+A: checks
alGiiQP/wwtYnfuXII+sgw: bets $2
JQZew0FjzS19kTjeNtrE+A: calls $2
*** RIVER *** [7d 9c Qs 3h] [8c]
JQZew0FjzS19kTjeNtrE+A: checks
alGiiQP/wwtYnfuXII+sgw: checks
*** SHOW DOWN ***
JQZew0FjzS19kTjeNtrE+A: shows [9h 4h] (a pair of Nines)
alGiiQP/wwtYnfuXII+sgw: shows [Qc 6s] (a pair of Queens)
alGiiQP/wwtYnfuXII+sgw collected $6.70 from pot
*** SUMMARY ***
Total pot $7 | Rake $0.30
Board [7d 9c Qs 3h 8c]
Seat 3: JQZew0FjzS19kTjeNtrE+A (small blind) showed [9h 4h] and lost with a pair of Nines
Seat 4: alGiiQP/wwtYnfuXII+sgw (big blind) showed [Qc 6s] and won ($6.70) with a pair of Queens
Seat 5: 3jvoOXNtXE90w2BdfNZwZQ folded before Flop (didn't bet)
Seat 6: TTx3CHxyi0SObcHyMJRp5w (button) folded before Flop (didn't bet)



PokerStars Game #59939762736:  Hold'em No Limit ($0.25/$0.50) - 2009/07/01 0:48:17 ET
Table '5EmHi+fnatGQQShcNmzOZQ' 6-max Seat #4 is the button
Seat 2: vXIHnZ+dv/hwSBxyvGw7bQ ($53.30 in chips)
Seat 4: 1b+2BbjMN8qhR1WPqdE9VQ ($52.90 in chips)
Seat 5: kxPhs4ePFqMy52CInAJ2aw ($55.35 in chips)
Seat 6: 686aeHikcJlgKkSuIFdcXQ ($141.20 in chips)
kxPhs4ePFqMy52CInAJ2aw: posts small blind $0.25
686aeHikcJlgKkSuIFdcXQ: posts big blind $0.50
TjmTe3bhs9dFz5gXX9x7Lw: sits out
*** HOLE CARDS ***
vXIHnZ+dv/hwSBxyvGw7bQ: folds
1b+2BbjMN8qhR1WPqdE9VQ: folds
kxPhs4ePFqMy52CInAJ2aw: raises $1.50 to $2
686aeHikcJlgKkSuIFdcXQ: raises $5 to $7
kxPhs4ePFqMy52CInAJ2aw: folds
686aeHikcJlgKkSuIFdcXQ collected $4 from pot
*** SUMMARY ***
Total pot $4 | Rake $0
Seat 2: vXIHnZ+dv/hwSBxyvGw7bQ folded before Flop (didn't bet)
Seat 4: 1b+2BbjMN8qhR1WPqdE9VQ (button) folded before Flop (didn't bet)
Seat 5: kxPhs4ePFqMy52CInAJ2aw (small blind) folded before Flop
Seat 6: 686aeHikcJlgKkSuIFdcXQ (big blind) collected ($4)



PokerStars Game #59939762282:  Hold'em No Limit ($0.25/$0.50) - 2009/07/01 0:48:17 ET
Table '0eJtgVAXVvBgncFdcUpXcQ' 2-max Seat #2 is the button
Seat 1: Ag6DvxX4vbRheqsv2zXKTQ ($26.25 in chips)
Seat 2: KMc4R+K9ao4Ur3rF7NGe6Q ($27.35 in chips)
KMc4R+K9ao4Ur3rF7NGe6Q: posts small blind $0.25
Ag6DvxX4vbRheqsv2zXKTQ: posts big blind $0.50
*** HOLE CARDS ***
KMc4R+K9ao4Ur3rF7NGe6Q: folds
Ag6DvxX4vbRheqsv2zXKTQ collected $0.50 from pot
*** SUMMARY ***
Total pot $0.50 | Rake $0
Seat 1: Ag6DvxX4vbRheqsv2zXKTQ (big blind) collected ($0.50)
Seat 2: KMc4R+K9ao4Ur3rF7NGe6Q (button) (small blind) folded before Flop



PokerStars Game #59939762858:  Hold'em No Limit ($0.25/$0.50) - 2009/07/01 0:48:18 ET
Table '+dXkOAQyS8j9PQZusUTMpg' 2-max Seat #1 is the button
Seat 1: XFa6sBGjP2gxoIvxR3fZIg ($62.75 in chips)
Seat 2: 5IBeOgaApY1Bvzv2P8X4EA ($140.05 in chips)
XFa6sBGjP2gxoIvxR3fZIg: posts small blind $0.25
5IBeOgaApY1Bvzv2P8X4EA: posts big blind $0.50
*** HOLE CARDS ***
XFa6sBGjP2gxoIvxR3fZIg: raises $1 to $1.50
5IBeOgaApY1Bvzv2P8X4EA: calls $1
*** FLOP *** [2h 6c 9d]
5IBeOgaApY1Bvzv2P8X4EA: checks
XFa6sBGjP2gxoIvxR3fZIg: checks
*** TURN *** [2h 6c 9d] [7c]
5IBeOgaApY1Bvzv2P8X4EA: checks
XFa6sBGjP2gxoIvxR3fZIg: checks
*** RIVER *** [2h 6c 9d 7c] [Qc]
5IBeOgaApY1Bvzv2P8X4EA: checks
XFa6sBGjP2gxoIvxR3fZIg: checks
*** SHOW DOWN ***
5IBeOgaApY1Bvzv2P8X4EA: shows [Ad 8h] (high card Ace)
XFa6sBGjP2gxoIvxR3fZIg: mucks hand
5IBeOgaApY1Bvzv2P8X4EA collected $2.85 from pot
*** SUMMARY ***
Total pot $3 | Rake $0.15
Board [2h 6c 9d 7c Qc]
Seat 1: XFa6sBGjP2gxoIvxR3fZIg (button) (small blind) mucked
Seat 2: 5IBeOgaApY1Bvzv2P8X4EA (big blind) showed [Ad 8h] and won ($2.85) with high card Ace



PokerStars Game #59939762974:  Hold'em No Limit ($0.25/$0.50) - 2009/07/01 0:48:18 ET
Table 'otvGDROEDdqsabxskT79qg' 9-max Seat #6 is the button
Seat 1: 8ehL7qlZzjgUh2H35iiWLw ($55.25 in chips)
Seat 2: cCjTzH9jio8607WzjcfXlg ($12.25 in chips)
Seat 3: +k7T5ocke8UwavtgUHm+Cg ($61.55 in chips)
Seat 4: MG90wfSJZnOejs/KD3vlQQ ($69.95 in chips)
Seat 5: XNMDwbXt/Q4jM99AXnbJDw ($52.55 in chips)
Seat 6: bxLSulbgr8LmKNjOzw8URg ($50.90 in chips)
Seat 7: C7+tBppJrKgd/r+tuKUIpA ($37.35 in chips)
Seat 8: zE9cVigS2nW/Ljy4K4bUQA ($30 in chips)
Seat 9: KcY3X8YpD74Kw1RHkx/g4A ($66.40 in chips)
C7+tBppJrKgd/r+tuKUIpA: posts small blind $0.25
zE9cVigS2nW/Ljy4K4bUQA: posts big blind $0.50
*** HOLE CARDS ***
KcY3X8YpD74Kw1RHkx/g4A: folds
8ehL7qlZzjgUh2H35iiWLw: folds
cCjTzH9jio8607WzjcfXlg: calls $0.50
+k7T5ocke8UwavtgUHm+Cg: folds
MG90wfSJZnOejs/KD3vlQQ: folds
XNMDwbXt/Q4jM99AXnbJDw: folds
bxLSulbgr8LmKNjOzw8URg: folds
C7+tBppJrKgd/r+tuKUIpA: folds
zE9cVigS2nW/Ljy4K4bUQA: checks
*** FLOP *** [Qh Qc Qs]
zE9cVigS2nW/Ljy4K4bUQA: checks
cCjTzH9jio8607WzjcfXlg: checks
*** TURN *** [Qh Qc Qs] [5c]
zE9cVigS2nW/Ljy4K4bUQA: checks
cCjTzH9jio8607WzjcfXlg: checks
*** RIVER *** [Qh Qc Qs 5c] [Js]
zE9cVigS2nW/Ljy4K4bUQA: checks
cCjTzH9jio8607WzjcfXlg: bets $1
zE9cVigS2nW/Ljy4K4bUQA: folds
cCjTzH9jio8607WzjcfXlg collected $1.20 from pot
*** SUMMARY ***
Total pot $1.25 | Rake $0.05
Board [Qh Qc Qs 5c Js]
Seat 1: 8ehL7qlZzjgUh2H35iiWLw folded before Flop (didn't bet)
Seat 2: cCjTzH9jio8607WzjcfXlg collected ($1.20)
Seat 3: +k7T5ocke8UwavtgUHm+Cg folded before Flop (didn't bet)
Seat 4: MG90wfSJZnOejs/KD3vlQQ folded before Flop (didn't bet)
Seat 5: XNMDwbXt/Q4jM99AXnbJDw folded before Flop (didn't bet)
Seat 6: bxLSulbgr8LmKNjOzw8URg (button) folded before Flop (didn't bet)
Seat 7: C7+tBppJrKgd/r+tuKUIpA (small blind) folded before Flop
Seat 8: zE9cVigS2nW/Ljy4K4bUQA (big blind) folded on the River
Seat 9: KcY3X8YpD74Kw1RHkx/g4A folded before Flop (didn't bet)



PokerStars Game #59939764390:  Hold'em No Limit ($0.25/$0.50) - 2009/07/01 0:48:20 ET
Table 'EiNh8p/wGJ1FP575iMFnqg' 9-max Seat #2 is the button
Seat 1: r3ZqM1Mi0W3y4hOdssE+Sg ($51.35 in chips)
Seat 2: 8ehL7qlZzjgUh2H35iiWLw ($52.60 in chips)
Seat 3: ymLPoEIl7UL3TvZYmnadxQ ($52.60 in chips)
Seat 4: cMzaiXAM/ZAdNaEUu+LqhA ($50 in chips)
Seat 5: M+7+BTmX5vZatHVuoRB1nA ($79.30 in chips)
Seat 6: 3UmXLy3GfjC3EkOebduerQ ($66.85 in chips)
Seat 7: 997ViqAtWn1FPjJqcffwcA ($50 in chips)
Seat 9: NnQCepdIR/AOUQn1yhYx6Q ($9.25 in chips)
ymLPoEIl7UL3TvZYmnadxQ: posts small blind $0.25
cMzaiXAM/ZAdNaEUu+LqhA: posts big blind $0.50
*** HOLE CARDS ***
M+7+BTmX5vZatHVuoRB1nA: folds
3UmXLy3GfjC3EkOebduerQ: folds
KrPAGRACBg+w0M//SXe8Ag leaves the table
997ViqAtWn1FPjJqcffwcA: folds
NnQCepdIR/AOUQn1yhYx6Q: folds
r3ZqM1Mi0W3y4hOdssE+Sg: raises $1.50 to $2
8ehL7qlZzjgUh2H35iiWLw: folds
mSD1pginDsyHG5PDfqzphw joins the table at seat #8
ymLPoEIl7UL3TvZYmnadxQ: folds
cMzaiXAM/ZAdNaEUu+LqhA: calls $1.50
*** FLOP *** [Ts 4h 2s]
cMzaiXAM/ZAdNaEUu+LqhA: checks
r3ZqM1Mi0W3y4hOdssE+Sg: bets $3.50
cMzaiXAM/ZAdNaEUu+LqhA: calls $3.50
*** TURN *** [Ts 4h 2s] [Tc]
cMzaiXAM/ZAdNaEUu+LqhA: checks
r3ZqM1Mi0W3y4hOdssE+Sg: checks
*** RIVER *** [Ts 4h 2s Tc] [8d]
cMzaiXAM/ZAdNaEUu+LqhA: bets $5
r3ZqM1Mi0W3y4hOdssE+Sg: folds
cMzaiXAM/ZAdNaEUu+LqhA collected $10.70 from pot
cMzaiXAM/ZAdNaEUu+LqhA: doesn't show hand
*** SUMMARY ***
Total pot $11.25 | Rake $0.55
Board [Ts 4h 2s Tc 8d]
Seat 1: r3ZqM1Mi0W3y4hOdssE+Sg folded on the River
Seat 2: 8ehL7qlZzjgUh2H35iiWLw (button) folded before Flop (didn't bet)
Seat 3: ymLPoEIl7UL3TvZYmnadxQ (small blind) folded before Flop
Seat 4: cMzaiXAM/ZAdNaEUu+LqhA (big blind) collected ($10.70)
Seat 5: M+7+BTmX5vZatHVuoRB1nA folded before Flop (didn't bet)
Seat 6: 3UmXLy3GfjC3EkOebduerQ folded before Flop (didn't bet)
Seat 7: 997ViqAtWn1FPjJqcffwcA folded before Flop (didn't bet)
Seat 9: NnQCepdIR/AOUQn1yhYx6Q folded before Flop (didn't bet)



PokerStars Game #59939765044:  Hold'em No Limit ($0.25/$0.50) - 2009/07/01 0:48:21 ET
Table 'c/CRn+68J3Y8KxD5g1ek2Q' 2-max Seat #2 is the button
Seat 1: 46qCyJ6evTkHo9al5sBMNA ($233.95 in chips)
Seat 2: BypVLsYQt3ePFm2xQL/dOA ($139.30 in chips)
BypVLsYQt3ePFm2xQL/dOA: posts small blind $0.25
46qCyJ6evTkHo9al5sBMNA: posts big blind $0.50
*** HOLE CARDS ***
BypVLsYQt3ePFm2xQL/dOA: raises $1 to $1.50
46qCyJ6evTkHo9al5sBMNA: folds
BypVLsYQt3ePFm2xQL/dOA collected $1 from pot
BypVLsYQt3ePFm2xQL/dOA: doesn't show hand
*** SUMMARY ***
Total pot $1 | Rake $0
Seat 1: 46qCyJ6evTkHo9al5sBMNA (big blind) folded before Flop
Seat 2: BypVLsYQt3ePFm2xQL/dOA (button) (small blind) collected ($1)



PokerStars Game #59939765182:  Hold'em No Limit ($0.25/$0.50) - 2009/07/01 0:48:21 ET
Table 'lSisgp6H7Fg1hH5VfjEjYQ' 9-max Seat #8 is the button
Seat 1: 5k9fvXD9suIgCxU4HLQjTw ($50 in chips)
Seat 2: UrcnkQOiLVk8BlKDPJSy7Q ($50 in chips)
Seat 3: aTkyjTh3w5YLWiIERupZOA ($51.95 in chips)
Seat 4: bwv/rbH/hHhPhY6u9mu04w ($34.85 in chips)
Seat 5: mSD1pginDsyHG5PDfqzphw ($11.35 in chips)
Seat 6: +k7T5ocke8UwavtgUHm+Cg ($30.60 in chips)
Seat 7: Y3DZ6qQlLeBhixDj4M9vmg ($9.30 in chips)
Seat 8: a4JDWmpFQkL10XfAyuF51A ($30.50 in chips)
Seat 9: gsyXT42WLEcOS4DdEk2wlw ($31.10 in chips)
gsyXT42WLEcOS4DdEk2wlw: posts small blind $0.25
5k9fvXD9suIgCxU4HLQjTw: posts big blind $0.50
*** HOLE CARDS ***
UrcnkQOiLVk8BlKDPJSy7Q: raises $1.50 to $2
aTkyjTh3w5YLWiIERupZOA: folds
bwv/rbH/hHhPhY6u9mu04w: folds
mSD1pginDsyHG5PDfqzphw: folds
+k7T5ocke8UwavtgUHm+Cg: calls $2
Y3DZ6qQlLeBhixDj4M9vmg: folds
a4JDWmpFQkL10XfAyuF51A: folds
gsyXT42WLEcOS4DdEk2wlw: folds
5k9fvXD9suIgCxU4HLQjTw: folds
*** FLOP *** [Qd Qs Qh]
UrcnkQOiLVk8BlKDPJSy7Q: bets $2
+k7T5ocke8UwavtgUHm+Cg: calls $2
*** TURN *** [Qd Qs Qh] [4h]
UrcnkQOiLVk8BlKDPJSy7Q: bets $7
+k7T5ocke8UwavtgUHm+Cg: calls $7
*** RIVER *** [Qd Qs Qh 4h] [2c]
UrcnkQOiLVk8BlKDPJSy7Q: bets $39 and is all-in
+k7T5ocke8UwavtgUHm+Cg: calls $19.60 and is all-in
*** SHOW DOWN ***
UrcnkQOiLVk8BlKDPJSy7Q: shows [Qc Ah] (four of a kind, Queens)
+k7T5ocke8UwavtgUHm+Cg: mucks hand
UrcnkQOiLVk8BlKDPJSy7Q collected $58.95 from pot
*** SUMMARY ***
Total pot $61.95 | Rake $3
Board [Qd Qs Qh 4h 2c]
Seat 1: 5k9fvXD9suIgCxU4HLQjTw (big blind) folded before Flop
Seat 2: UrcnkQOiLVk8BlKDPJSy7Q showed [Qc Ah] and won ($58.95) with four of a kind, Queens
Seat 3: aTkyjTh3w5YLWiIERupZOA folded before Flop (didn't bet)
Seat 4: bwv/rbH/hHhPhY6u9mu04w folded before Flop (didn't bet)
Seat 5: mSD1pginDsyHG5PDfqzphw folded before Flop (didn't bet)
Seat 6: +k7T5ocke8UwavtgUHm+Cg mucked
Seat 7: Y3DZ6qQlLeBhixDj4M9vmg folded before Flop (didn't bet)
Seat 8: a4JDWmpFQkL10XfAyuF51A (button) folded before Flop (didn't bet)
Seat 9: gsyXT42WLEcOS4DdEk2wlw (small blind) folded before Flop



PokerStars Game #59939766536:  Hold'em No Limit ($0.25/$0.50) - 2009/07/01 0:48:23 ET
Table '0eJtgVAXVvBgncFdcUpXcQ' 2-max Seat #1 is the button
Seat 1: Ag6DvxX4vbRheqsv2zXKTQ ($26.50 in chips)
Seat 2: KMc4R+K9ao4Ur3rF7NGe6Q ($27.10 in chips)
Ag6DvxX4vbRheqsv2zXKTQ: posts small blind $0.25
KMc4R+K9ao4Ur3rF7NGe6Q: posts big blind $0.50
*** HOLE CARDS ***
Ag6DvxX4vbRheqsv2zXKTQ: calls $0.25
KMc4R+K9ao4Ur3rF7NGe6Q: raises $1 to $1.50
Ag6DvxX4vbRheqsv2zXKTQ: calls $1
*** FLOP *** [5c 4d 6c]
KMc4R+K9ao4Ur3rF7NGe6Q: bets $1
Ag6DvxX4vbRheqsv2zXKTQ: calls $1
*** TURN *** [5c 4d 6c] [2c]
KMc4R+K9ao4Ur3rF7NGe6Q: bets $1.50
Ag6DvxX4vbRheqsv2zXKTQ: calls $1.50
*** RIVER *** [5c 4d 6c 2c] [Jd]
KMc4R+K9ao4Ur3rF7NGe6Q: checks
Ag6DvxX4vbRheqsv2zXKTQ: checks
*** SHOW DOWN ***
KMc4R+K9ao4Ur3rF7NGe6Q: shows [Ks 7s] (high card King)
Ag6DvxX4vbRheqsv2zXKTQ: shows [Tc Kh] (high card King - Jack+Ten kicker)
Ag6DvxX4vbRheqsv2zXKTQ collected $7.65 from pot
*** SUMMARY ***
Total pot $8 | Rake $0.35
Board [5c 4d 6c 2c Jd]
Seat 1: Ag6DvxX4vbRheqsv2zXKTQ (button) (small blind) showed [Tc Kh] and won ($7.65) with high card King
Seat 2: KMc4R+K9ao4Ur3rF7NGe6Q (big blind) showed [Ks 7s] and lost with high card King



PokerStars Game #59939766090:  Hold'em No Limit ($0.25/$0.50) - 2009/07/01 0:48:23 ET
Table 'QOeVnLhwctF9UyV/beDi+A' 2-max Seat #1 is the button
Seat 1: bypIyrYcAAifLfhZpGlKLA ($67.05 in chips)
Seat 2: Ucrm3XtZmoONapW32SPhag ($15.35 in chips)
bypIyrYcAAifLfhZpGlKLA: posts small blind $0.25
Ucrm3XtZmoONapW32SPhag: posts big blind $0.50
*** HOLE CARDS ***
bypIyrYcAAifLfhZpGlKLA: raises $0.50 to $1
Ucrm3XtZmoONapW32SPhag: raises $2.50 to $3.50
bypIyrYcAAifLfhZpGlKLA: folds
Ucrm3XtZmoONapW32SPhag collected $2 from pot
Ucrm3XtZmoONapW32SPhag: doesn't show hand
*** SUMMARY ***
Total pot $2 | Rake $0
Seat 1: bypIyrYcAAifLfhZpGlKLA (button) (small blind) folded before Flop
Seat 2: Ucrm3XtZmoONapW32SPhag (big blind) collected ($2)



PokerStars Game #59939765984:  Hold'em No Limit ($0.25/$0.50) - 2009/07/01 0:48:23 ET
Table '37qXEp3oe+er5q4CZip9eQ' 6-max Seat #3 is the button
Seat 1: oqOqoO2AyCZenUghCxMDxw ($57.65 in chips)
Seat 2: 6wzJiRvp8HY6t+MQGnSIzA ($28 in chips)
Seat 3: Rt6KgtZ8YaJoTc3FPim00w ($100.35 in chips)
Seat 4: XsmE8nXMAAMFJbWaJTmHFw ($27.45 in chips)
Seat 5: VOmI0x4dDPnTESZd5B4d1Q ($38.40 in chips)
Seat 6: N50kln4negd8q7Mmoz1j4g ($25 in chips)
XsmE8nXMAAMFJbWaJTmHFw: posts small blind $0.25
VOmI0x4dDPnTESZd5B4d1Q: posts big blind $0.50
*** HOLE CARDS ***
N50kln4negd8q7Mmoz1j4g: calls $0.50
oqOqoO2AyCZenUghCxMDxw: folds
6wzJiRvp8HY6t+MQGnSIzA: folds
Rt6KgtZ8YaJoTc3FPim00w: folds
XsmE8nXMAAMFJbWaJTmHFw: folds
VOmI0x4dDPnTESZd5B4d1Q: raises $2 to $2.50
N50kln4negd8q7Mmoz1j4g: folds
VOmI0x4dDPnTESZd5B4d1Q collected $1.25 from pot
*** SUMMARY ***
Total pot $1.25 | Rake $0
Seat 1: oqOqoO2AyCZenUghCxMDxw folded before Flop (didn't bet)
Seat 2: 6wzJiRvp8HY6t+MQGnSIzA folded before Flop (didn't bet)
Seat 3: Rt6KgtZ8YaJoTc3FPim00w (button) folded before Flop (didn't bet)
Seat 4: XsmE8nXMAAMFJbWaJTmHFw (small blind) folded before Flop
Seat 5: VOmI0x4dDPnTESZd5B4d1Q (big blind) collected ($1.25)
Seat 6: N50kln4negd8q7Mmoz1j4g folded before Flop



PokerStars Game #59939767576:  Hold'em No Limit ($0.25/$0.50) - 2009/07/01 0:48:25 ET
Table 'Vdlc9wqYcHTUhtdyN7CuJw' 2-max Seat #2 is the button
Seat 1: yBO+mXB6m/rCft2ErwGf/Q ($117.75 in chips)
Seat 2: NZ/5cxwnorKW2SNsWy1+8A ($7.95 in chips)
NZ/5cxwnorKW2SNsWy1+8A: posts small blind $0.25
yBO+mXB6m/rCft2ErwGf/Q: posts big blind $0.50
*** HOLE CARDS ***
NZ/5cxwnorKW2SNsWy1+8A: calls $0.25
yBO+mXB6m/rCft2ErwGf/Q: checks
*** FLOP *** [7c Kc Jd]
yBO+mXB6m/rCft2ErwGf/Q: bets $0.50
NZ/5cxwnorKW2SNsWy1+8A: calls $0.50
*** TURN *** [7c Kc Jd] [4d]
yBO+mXB6m/rCft2ErwGf/Q: bets $0.50
NZ/5cxwnorKW2SNsWy1+8A: calls $0.50
*** RIVER *** [7c Kc Jd 4d] [9d]
yBO+mXB6m/rCft2ErwGf/Q: bets $0.50
NZ/5cxwnorKW2SNsWy1+8A: raises $1 to $1.50
yBO+mXB6m/rCft2ErwGf/Q: folds
NZ/5cxwnorKW2SNsWy1+8A collected $3.85 from pot
NZ/5cxwnorKW2SNsWy1+8A: doesn't show hand
*** SUMMARY ***
Total pot $4 | Rake $0.15
Board [7c Kc Jd 4d 9d]
Seat 1: yBO+mXB6m/rCft2ErwGf/Q (big blind) folded on the River
Seat 2: NZ/5cxwnorKW2SNsWy1+8A (button) (small blind) collected ($3.85)



PokerStars Game #59939767636:  Hold'em No Limit ($0.25/$0.50) - 2009/07/01 0:48:25 ET
Table 'ibNfFy0bCzuBaUORla0aGw' 9-max Seat #9 is the button
Seat 1: xZCXQSXlrZkp3pZizzVXCw ($52.70 in chips)
Seat 2: 90Wb75h3W1BRpbqVnuk8gw ($51.40 in chips)
Seat 3: dDaHs3X8+fe3bIkRU0cbrw ($40.15 in chips)
Seat 4: YBN054X4blmis+B2bBlC0g ($23.45 in chips)
Seat 5: GIJAc9kPrLZHLSX8Q6i99w ($25.40 in chips)
Seat 6: 8n9jQLh3cZKbsmr5PIjgiQ ($43.25 in chips)
Seat 7: HZkVla4kK2SI42CVrPZ/ig ($14.30 in chips)
Seat 8: xUrN9TWLq4m5V+OXY7KUUA ($50.45 in chips)
Seat 9: pFtzb1sR4b0d1aw6aIRgDg ($50 in chips)
xZCXQSXlrZkp3pZizzVXCw: posts small blind $0.25
90Wb75h3W1BRpbqVnuk8gw: posts big blind $0.50
*** HOLE CARDS ***
dDaHs3X8+fe3bIkRU0cbrw: folds
YBN054X4blmis+B2bBlC0g: folds
GIJAc9kPrLZHLSX8Q6i99w: folds
dDaHs3X8+fe3bIkRU0cbrw leaves the table
8n9jQLh3cZKbsmr5PIjgiQ: folds
AjV5McH1KMMclY26QdLM5w joins the table at seat #3
HZkVla4kK2SI42CVrPZ/ig: folds
xUrN9TWLq4m5V+OXY7KUUA: folds
pFtzb1sR4b0d1aw6aIRgDg: folds
xZCXQSXlrZkp3pZizzVXCw: folds
90Wb75h3W1BRpbqVnuk8gw collected $0.50 from pot
*** SUMMARY ***
Total pot $0.50 | Rake $0
Seat 1: xZCXQSXlrZkp3pZizzVXCw (small blind) folded before Flop
Seat 2: 90Wb75h3W1BRpbqVnuk8gw (big blind) collected ($0.50)
Seat 3: dDaHs3X8+fe3bIkRU0cbrw folded before Flop (didn't bet)
Seat 4: YBN054X4blmis+B2bBlC0g folded before Flop (didn't bet)
Seat 5: GIJAc9kPrLZHLSX8Q6i99w folded before Flop (didn't bet)
Seat 6: 8n9jQLh3cZKbsmr5PIjgiQ folded before Flop (didn't bet)
Seat 7: HZkVla4kK2SI42CVrPZ/ig folded before Flop (didn't bet)
Seat 8: xUrN9TWLq4m5V+OXY7KUUA folded before Flop (didn't bet)
Seat 9: pFtzb1sR4b0d1aw6aIRgDg (button) folded before Flop (didn't bet)



PokerStars Game #59939768664:  Hold'em No Limit ($0.25/$0.50) - 2009/07/01 0:48:27 ET
Table 'X6IRCRTh+20gjz8aubWnwA' 9-max Seat #3 is the button
Seat 1: DSM67hHHq1XFoEOi9p8Alw ($50.05 in chips)
Seat 2: HZkVla4kK2SI42CVrPZ/ig ($8.55 in chips)
Seat 3: SWv01peOe69QQRvhQTqjQw ($13.40 in chips)
Seat 4: 2J+UVOVrW+V3maOylyxMcQ ($36.20 in chips)
Seat 5: NnQCepdIR/AOUQn1yhYx6Q ($10 in chips)
Seat 6: /6In1zC3WtgwxDcueWzZWg ($68.05 in chips)
Seat 7: cFHQjKQOOKTUzoilhrXHLg ($43.35 in chips)
Seat 8: HxeBVq06/3Bh/H986sgdbw ($7.45 in chips)
Seat 9: M+7+BTmX5vZatHVuoRB1nA ($68.50 in chips)
2J+UVOVrW+V3maOylyxMcQ: posts small blind $0.25
NnQCepdIR/AOUQn1yhYx6Q: posts big blind $0.50
*** HOLE CARDS ***
/6In1zC3WtgwxDcueWzZWg: folds
cFHQjKQOOKTUzoilhrXHLg: calls $0.50
HxeBVq06/3Bh/H986sgdbw: folds
M+7+BTmX5vZatHVuoRB1nA: folds
DSM67hHHq1XFoEOi9p8Alw: folds
HZkVla4kK2SI42CVrPZ/ig: folds
SWv01peOe69QQRvhQTqjQw: folds
2J+UVOVrW+V3maOylyxMcQ: raises $0.50 to $1
NnQCepdIR/AOUQn1yhYx6Q: folds
cFHQjKQOOKTUzoilhrXHLg: calls $0.50
*** FLOP *** [4d 2d 8c]
2J+UVOVrW+V3maOylyxMcQ: bets $1
cFHQjKQOOKTUzoilhrXHLg: folds
2J+UVOVrW+V3maOylyxMcQ collected $2.40 from pot
2J+UVOVrW+V3maOylyxMcQ: doesn't show hand
*** SUMMARY ***
Total pot $2.50 | Rake $0.10
Board [4d 2d 8c]
Seat 1: DSM67hHHq1XFoEOi9p8Alw folded before Flop (didn't bet)
Seat 2: HZkVla4kK2SI42CVrPZ/ig folded before Flop (didn't bet)
Seat 3: SWv01peOe69QQRvhQTqjQw (button) folded before Flop (didn't bet)
Seat 4: 2J+UVOVrW+V3maOylyxMcQ (small blind) collected ($2.40)
Seat 5: NnQCepdIR/AOUQn1yhYx6Q (big blind) folded before Flop
Seat 6: /6In1zC3WtgwxDcueWzZWg folded before Flop (didn't bet)
Seat 7: cFHQjKQOOKTUzoilhrXHLg folded on the Flop
Seat 8: HxeBVq06/3Bh/H986sgdbw folded before Flop (didn't bet)
Seat 9: M+7+BTmX5vZatHVuoRB1nA folded before Flop (didn't bet)



PokerStars Game #59939768874:  Hold'em No Limit ($0.25/$0.50) - 2009/07/01 0:48:27 ET
Table '+z1aekfHkpp09pc8F9aViw' 6-max Seat #2 is the button
Seat 1: FHilMb2i2DbUCc9lplszog ($38.60 in chips)
Seat 2: M6xK/VklCvdyyrmvzATlxQ ($35.25 in chips)
Seat 3: uUznlIMFnRUvwrBhYF73KA ($107.70 in chips)
Seat 4: RowCSpSURHTOL/dcjg/Iug ($50.05 in chips)
Seat 5: crjGpJEzSZgD38FoE3VMGg ($50 in chips)
Seat 6: 686aeHikcJlgKkSuIFdcXQ ($64.60 in chips)
uUznlIMFnRUvwrBhYF73KA: posts small blind $0.25
RowCSpSURHTOL/dcjg/Iug: posts big blind $0.50
*** HOLE CARDS ***
crjGpJEzSZgD38FoE3VMGg: folds
686aeHikcJlgKkSuIFdcXQ: folds
FHilMb2i2DbUCc9lplszog: raises $1 to $1.50
M6xK/VklCvdyyrmvzATlxQ: folds
uUznlIMFnRUvwrBhYF73KA: folds
RowCSpSURHTOL/dcjg/Iug: folds
FHilMb2i2DbUCc9lplszog collected $1.25 from pot
FHilMb2i2DbUCc9lplszog: doesn't show hand
*** SUMMARY ***
Total pot $1.25 | Rake $0
Seat 1: FHilMb2i2DbUCc9lplszog collected ($1.25)
Seat 2: M6xK/VklCvdyyrmvzATlxQ (button) folded before Flop (didn't bet)
Seat 3: uUznlIMFnRUvwrBhYF73KA (small blind) folded before Flop
Seat 4: RowCSpSURHTOL/dcjg/Iug (big blind) folded before Flop
Seat 5: crjGpJEzSZgD38FoE3VMGg folded before Flop (didn't bet)
Seat 6: 686aeHikcJlgKkSuIFdcXQ folded before Flop (didn't bet)



PokerStars Game #59939769478:  Hold'em No Limit ($0.25/$0.50) - 2009/07/01 0:48:28 ET
Table 'QOgaEqMcJ73pcUMMxoisUg' 6-max Seat #2 is the button
Seat 1: /olYG0EzMWzADIgH1y2ySQ ($27 in chips)
Seat 2: 4QfsCWthT/vSLirorNXqtg ($50 in chips)
Seat 3: Rt6KgtZ8YaJoTc3FPim00w ($97.30 in chips)
Seat 4: zAcsDhG/T128Vn7XGVSgKg ($51.60 in chips)
Seat 5: 6vNxrjjCl6FwfaaymM9jjg ($18.20 in chips)
Rt6KgtZ8YaJoTc3FPim00w: posts small blind $0.25
zAcsDhG/T128Vn7XGVSgKg: posts big blind $0.50
*** HOLE CARDS ***
6vNxrjjCl6FwfaaymM9jjg: folds
/olYG0EzMWzADIgH1y2ySQ: raises $1 to $1.50
4QfsCWthT/vSLirorNXqtg: folds
pmE+2KJb4nffAVqjLIXxFg leaves the table
Rt6KgtZ8YaJoTc3FPim00w: folds
zAcsDhG/T128Vn7XGVSgKg: folds
/olYG0EzMWzADIgH1y2ySQ collected $1.25 from pot
*** SUMMARY ***
Total pot $1.25 | Rake $0
Seat 1: /olYG0EzMWzADIgH1y2ySQ collected ($1.25)
Seat 2: 4QfsCWthT/vSLirorNXqtg (button) folded before Flop (didn't bet)
Seat 3: Rt6KgtZ8YaJoTc3FPim00w (small blind) folded before Flop
Seat 4: zAcsDhG/T128Vn7XGVSgKg (big blind) folded before Flop
Seat 5: 6vNxrjjCl6FwfaaymM9jjg folded before Flop (didn't bet)



PokerStars Game #59939771310:  Hold'em No Limit ($0.25/$0.50) - 2009/07/01 0:48:31 ET
Table 'E7bWJ45aoFXRpyRv2gw+Ig' 2-max Seat #1 is the button
Seat 1: FRkiRasEGlHUeLrEl+k/nA ($88.50 in chips)
Seat 2: 3Wro85I7472vJ4Wkpneo9A ($105.55 in chips)
FRkiRasEGlHUeLrEl+k/nA: posts small blind $0.25
3Wro85I7472vJ4Wkpneo9A: posts big blind $0.50
*** HOLE CARDS ***
FRkiRasEGlHUeLrEl+k/nA: raises $1 to $1.50
3Wro85I7472vJ4Wkpneo9A: calls $1
*** FLOP *** [Ah 2c 2h]
3Wro85I7472vJ4Wkpneo9A: checks
FRkiRasEGlHUeLrEl+k/nA: bets $1.50
3Wro85I7472vJ4Wkpneo9A: calls $1.50
*** TURN *** [Ah 2c 2h] [Qc]
3Wro85I7472vJ4Wkpneo9A: checks
FRkiRasEGlHUeLrEl+k/nA: bets $3.50
3Wro85I7472vJ4Wkpneo9A: calls $3.50
*** RIVER *** [Ah 2c 2h Qc] [4d]
3Wro85I7472vJ4Wkpneo9A: checks
FRkiRasEGlHUeLrEl+k/nA: bets $3.50
3Wro85I7472vJ4Wkpneo9A: calls $3.50
*** SHOW DOWN ***
FRkiRasEGlHUeLrEl+k/nA: shows [Ac 7h] (two pair, Aces and Deuces)
3Wro85I7472vJ4Wkpneo9A: shows [Ts Ad] (two pair, Aces and Deuces)
3Wro85I7472vJ4Wkpneo9A collected $9.75 from pot
FRkiRasEGlHUeLrEl+k/nA collected $9.75 from pot
*** SUMMARY ***
Total pot $20 | Rake $0.50
Board [Ah 2c 2h Qc 4d]
Seat 1: FRkiRasEGlHUeLrEl+k/nA (button) (small blind) showed [Ac 7h] and won ($9.75) with two pair, Aces and Deuces
Seat 2: 3Wro85I7472vJ4Wkpneo9A (big blind) showed [Ts Ad] and won ($9.75) with two pair, Aces and Deuces



PokerStars Game #59939771988:  Hold'em No Limit ($0.25/$0.50) - 2009/07/01 0:48:32 ET
Table 'c/CRn+68J3Y8KxD5g1ek2Q' 2-max Seat #1 is the button
Seat 1: 46qCyJ6evTkHo9al5sBMNA ($233.45 in chips)
Seat 2: BypVLsYQt3ePFm2xQL/dOA ($139.80 in chips)
46qCyJ6evTkHo9al5sBMNA: posts small blind $0.25
BypVLsYQt3ePFm2xQL/dOA: posts big blind $0.50
*** HOLE CARDS ***
46qCyJ6evTkHo9al5sBMNA: folds
BypVLsYQt3ePFm2xQL/dOA collected $0.50 from pot
BypVLsYQt3ePFm2xQL/dOA: doesn't show hand
*** SUMMARY ***
Total pot $0.50 | Rake $0
Seat 1: 46qCyJ6evTkHo9al5sBMNA (button) (small blind) folded before Flop
Seat 2: BypVLsYQt3ePFm2xQL/dOA (big blind) collected ($0.50)



PokerStars Game #59939772594:  Hold'em No Limit ($0.25/$0.50) - 2009/07/01 0:48:33 ET
Table 'QOeVnLhwctF9UyV/beDi+A' 2-max Seat #2 is the button
Seat 1: bypIyrYcAAifLfhZpGlKLA ($66.05 in chips)
Seat 2: Ucrm3XtZmoONapW32SPhag ($16.35 in chips)
Ucrm3XtZmoONapW32SPhag: posts small blind $0.25
bypIyrYcAAifLfhZpGlKLA: posts big blind $0.50
*** HOLE CARDS ***
Ucrm3XtZmoONapW32SPhag: raises $0.50 to $1
bypIyrYcAAifLfhZpGlKLA: calls $0.50
*** FLOP *** [2d 9h Tc]
bypIyrYcAAifLfhZpGlKLA: bets $1.50
Ucrm3XtZmoONapW32SPhag: raises $1.50 to $3
bypIyrYcAAifLfhZpGlKLA: calls $1.50
*** TURN *** [2d 9h Tc] [Jc]
bypIyrYcAAifLfhZpGlKLA: checks
Ucrm3XtZmoONapW32SPhag: checks
*** RIVER *** [2d 9h Tc Jc] [Td]
bypIyrYcAAifLfhZpGlKLA: bets $5.50
Ucrm3XtZmoONapW32SPhag: folds
bypIyrYcAAifLfhZpGlKLA collected $7.65 from pot
bypIyrYcAAifLfhZpGlKLA: doesn't show hand
*** SUMMARY ***
Total pot $8 | Rake $0.35
Board [2d 9h Tc Jc Td]
Seat 1: bypIyrYcAAifLfhZpGlKLA (big blind) collected ($7.65)
Seat 2: Ucrm3XtZmoONapW32SPhag (button) (small blind) folded on the River



PokerStars Game #59939772972:  Hold'em No Limit ($0.25/$0.50) - 2009/07/01 0:48:34 ET
Table 'BCN5su+SsXiy1zRMJi0SJw' 6-max Seat #3 is the button
Seat 2: oU2kDCkT/gilYbHWrg7D8w ($10.30 in chips)
Seat 3: g+vwI6lMKpU2uteXSjOzVw ($17.45 in chips)
Seat 4: JY9CtoZTeav+mhWyxSSyJQ ($26.10 in chips)
Seat 5: IBNygaT1aa9Z1uPdJJilwA ($17.25 in chips)
Seat 6: b2symlOdL7+0c9Pj4N/KlA ($100.95 in chips)
JY9CtoZTeav+mhWyxSSyJQ: posts small blind $0.25
IBNygaT1aa9Z1uPdJJilwA: posts big blind $0.50
GxXV09ciXaOxyY2H5aMIIw: sits out
*** HOLE CARDS ***
b2symlOdL7+0c9Pj4N/KlA: raises $1.50 to $2
oU2kDCkT/gilYbHWrg7D8w: calls $2
g+vwI6lMKpU2uteXSjOzVw: calls $2
JY9CtoZTeav+mhWyxSSyJQ: folds
IBNygaT1aa9Z1uPdJJilwA: raises $15.25 to $17.25 and is all-in
b2symlOdL7+0c9Pj4N/KlA: raises $15.25 to $32.50
oU2kDCkT/gilYbHWrg7D8w: calls $8.30 and is all-in
g+vwI6lMKpU2uteXSjOzVw: folds
*** FLOP *** [8d 4d 6d]
*** TURN *** [8d 4d 6d] [3c]
*** RIVER *** [8d 4d 6d 3c] [9c]
*** SHOW DOWN ***
IBNygaT1aa9Z1uPdJJilwA: shows [Ks Ac] (high card Ace)
b2symlOdL7+0c9Pj4N/KlA: mucks hand
IBNygaT1aa9Z1uPdJJilwA collected $13.55 from side pot
oU2kDCkT/gilYbHWrg7D8w: shows [Jd Qd] (a flush, Queen high)
oU2kDCkT/gilYbHWrg7D8w collected $31.50 from main pot
*** SUMMARY ***
Total pot $47.05 Main pot $31.50. Side pot $13.55. | Rake $2
Board [8d 4d 6d 3c 9c]
Seat 2: oU2kDCkT/gilYbHWrg7D8w showed [Jd Qd] and won ($31.50) with a flush, Queen high
Seat 3: g+vwI6lMKpU2uteXSjOzVw (button) folded before Flop
Seat 4: JY9CtoZTeav+mhWyxSSyJQ (small blind) folded before Flop
Seat 5: IBNygaT1aa9Z1uPdJJilwA (big blind) showed [Ks Ac] and won ($13.55) with high card Ace
Seat 6: b2symlOdL7+0c9Pj4N/KlA mucked



PokerStars Game #59939775014:  Hold'em No Limit ($0.25/$0.50) - 2009/07/01 0:48:37 ET
Table 'lpxYasB1ClBSgTpCCITwhQ' 9-max Seat #9 is the button
Seat 1: mj7PS7wCH4PAl7+eYTFs7A ($47.40 in chips)
Seat 2: OWP/DOu+PlPK6ZZ3zYa0HA ($26.35 in chips)
Seat 3: cDNz32Scry3j+v2+kE3pHg ($50 in chips)
Seat 4: o4Jr+EJ272Vq/p5v7ZCBYA ($35.35 in chips)
Seat 5: IYd5zG8k7vdBNVHbHg2Pag ($36.60 in chips)
Seat 6: SegjDnMxWMujiD57ESNL+g ($8 in chips)
Seat 7: bmRtaIYKthN1F+B3JLZ3Jw ($20.70 in chips)
Seat 8: V+ivdLiYYuNr+thEXNextg ($33.50 in chips)
Seat 9: XNMDwbXt/Q4jM99AXnbJDw ($50 in chips)
mj7PS7wCH4PAl7+eYTFs7A: posts small blind $0.25
OWP/DOu+PlPK6ZZ3zYa0HA: posts big blind $0.50
*** HOLE CARDS ***
cDNz32Scry3j+v2+kE3pHg: folds
o4Jr+EJ272Vq/p5v7ZCBYA: raises $0.50 to $1
IYd5zG8k7vdBNVHbHg2Pag: folds
SegjDnMxWMujiD57ESNL+g: calls $1
bmRtaIYKthN1F+B3JLZ3Jw: folds
V+ivdLiYYuNr+thEXNextg: folds
XNMDwbXt/Q4jM99AXnbJDw: calls $1
mj7PS7wCH4PAl7+eYTFs7A: folds
OWP/DOu+PlPK6ZZ3zYa0HA: calls $0.50
*** FLOP *** [3c 4h Th]
OWP/DOu+PlPK6ZZ3zYa0HA: checks
o4Jr+EJ272Vq/p5v7ZCBYA: bets $2
SegjDnMxWMujiD57ESNL+g: folds
XNMDwbXt/Q4jM99AXnbJDw: folds
OWP/DOu+PlPK6ZZ3zYa0HA: folds
o4Jr+EJ272Vq/p5v7ZCBYA collected $4.05 from pot
o4Jr+EJ272Vq/p5v7ZCBYA: doesn't show hand
*** SUMMARY ***
Total pot $4.25 | Rake $0.20
Board [3c 4h Th]
Seat 1: mj7PS7wCH4PAl7+eYTFs7A (small blind) folded before Flop
Seat 2: OWP/DOu+PlPK6ZZ3zYa0HA (big blind) folded on the Flop
Seat 3: cDNz32Scry3j+v2+kE3pHg folded before Flop (didn't bet)
Seat 4: o4Jr+EJ272Vq/p5v7ZCBYA collected ($4.05)
Seat 5: IYd5zG8k7vdBNVHbHg2Pag folded before Flop (didn't bet)
Seat 6: SegjDnMxWMujiD57ESNL+g folded on the Flop
Seat 7: bmRtaIYKthN1F+B3JLZ3Jw folded before Flop (didn't bet)
Seat 8: V+ivdLiYYuNr+thEXNextg folded before Flop (didn't bet)
Seat 9: XNMDwbXt/Q4jM99AXnbJDw (button) folded on the Flop



PokerStars Game #59939775366:  Hold'em No Limit ($0.25/$0.50) - 2009/07/01 0:48:37 ET
Table '+dXkOAQyS8j9PQZusUTMpg' 2-max Seat #2 is the button
Seat 1: XFa6sBGjP2gxoIvxR3fZIg ($61.25 in chips)
Seat 2: 5IBeOgaApY1Bvzv2P8X4EA ($141.40 in chips)
5IBeOgaApY1Bvzv2P8X4EA: posts small blind $0.25
XFa6sBGjP2gxoIvxR3fZIg: posts big blind $0.50
*** HOLE CARDS ***
5IBeOgaApY1Bvzv2P8X4EA: folds
XFa6sBGjP2gxoIvxR3fZIg collected $0.50 from pot
XFa6sBGjP2gxoIvxR3fZIg: doesn't show hand
*** SUMMARY ***
Total pot $0.50 | Rake $0
Seat 1: XFa6sBGjP2gxoIvxR3fZIg (big blind) collected ($0.50)
Seat 2: 5IBeOgaApY1Bvzv2P8X4EA (button) (small blind) folded before Flop



PokerStars Game #59939776142:  Hold'em No Limit ($0.25/$0.50) - 2009/07/01 0:48:39 ET
Table 'eMxdLyFDf28E0wit6gm3Uw' 6-max Seat #1 is the button
Seat 1: GtdWeBVCZhDBcNFRTOb8Hg ($3.10 in chips)
Seat 3: dZcLsEI8iXkobBduRJ45Yw ($10.10 in chips)
Seat 4: 3jxEWvv2qK1HCXLj4khowQ ($42.80 in chips)
Seat 5: X0X97o2fDAPiGx6o1gahsw ($76.10 in chips)
Seat 6: nOfdMHEXflgT86UgFWblAA ($50.50 in chips)
dZcLsEI8iXkobBduRJ45Yw: posts small blind $0.25
3jxEWvv2qK1HCXLj4khowQ: posts big blind $0.50
*** HOLE CARDS ***
X0X97o2fDAPiGx6o1gahsw: folds
nOfdMHEXflgT86UgFWblAA: folds
GtdWeBVCZhDBcNFRTOb8Hg: folds
dZcLsEI8iXkobBduRJ45Yw: calls $0.25
3jxEWvv2qK1HCXLj4khowQ: checks
*** FLOP *** [Ks 8c 9d]
dZcLsEI8iXkobBduRJ45Yw: checks
3jxEWvv2qK1HCXLj4khowQ: checks
*** TURN *** [Ks 8c 9d] [Qc]
dZcLsEI8iXkobBduRJ45Yw: bets $0.50
3jxEWvv2qK1HCXLj4khowQ: folds
dZcLsEI8iXkobBduRJ45Yw collected $0.95 from pot
*** SUMMARY ***
Total pot $1 | Rake $0.05
Board [Ks 8c 9d Qc]
Seat 1: GtdWeBVCZhDBcNFRTOb8Hg (button) folded before Flop (didn't bet)
Seat 3: dZcLsEI8iXkobBduRJ45Yw (small blind) collected ($0.95)
Seat 4: 3jxEWvv2qK1HCXLj4khowQ (big blind) folded on the Turn
Seat 5: X0X97o2fDAPiGx6o1gahsw folded before Flop (didn't bet)
Seat 6: nOfdMHEXflgT86UgFWblAA folded before Flop (didn't bet)



PokerStars Game #59939777092:  Hold'em No Limit ($0.25/$0.50) - 2009/07/01 0:48:40 ET
Table 'c/CRn+68J3Y8KxD5g1ek2Q' 2-max Seat #2 is the button
Seat 1: 46qCyJ6evTkHo9al5sBMNA ($233.20 in chips)
Seat 2: BypVLsYQt3ePFm2xQL/dOA ($140.05 in chips)
BypVLsYQt3ePFm2xQL/dOA: posts small blind $0.25
46qCyJ6evTkHo9al5sBMNA: posts big blind $0.50
*** HOLE CARDS ***
BypVLsYQt3ePFm2xQL/dOA said, "i folded very good hand"
BypVLsYQt3ePFm2xQL/dOA: raises $1.50 to $2
46qCyJ6evTkHo9al5sBMNA: raises $4 to $6
BypVLsYQt3ePFm2xQL/dOA: raises $9.50 to $15.50
46qCyJ6evTkHo9al5sBMNA: calls $9.50
*** FLOP *** [Ad 9c 3d]
46qCyJ6evTkHo9al5sBMNA said, "tks god"
46qCyJ6evTkHo9al5sBMNA: checks
BypVLsYQt3ePFm2xQL/dOA: bets $17.50
46qCyJ6evTkHo9al5sBMNA: calls $17.50
*** TURN *** [Ad 9c 3d] [4c]
46qCyJ6evTkHo9al5sBMNA: checks
BypVLsYQt3ePFm2xQL/dOA: bets $40.50
46qCyJ6evTkHo9al5sBMNA: calls $40.50
*** RIVER *** [Ad 9c 3d 4c] [Js]
46qCyJ6evTkHo9al5sBMNA: bets $70.50
BypVLsYQt3ePFm2xQL/dOA: calls $66.55 and is all-in
*** SHOW DOWN ***
46qCyJ6evTkHo9al5sBMNA: shows [Ac Qd] (a pair of Aces)
BypVLsYQt3ePFm2xQL/dOA: shows [As Kc] (a pair of Aces - King kicker)
BypVLsYQt3ePFm2xQL/dOA collected $279.60 from pot
*** SUMMARY ***
Total pot $280.10 | Rake $0.50
Board [Ad 9c 3d 4c Js]
Seat 1: 46qCyJ6evTkHo9al5sBMNA (big blind) showed [Ac Qd] and lost with a pair of Aces
Seat 2: BypVLsYQt3ePFm2xQL/dOA (button) (small blind) showed [As Kc] and won ($279.60) with a pair of Aces



PokerStars Game #59939779662:  Hold'em No Limit ($0.25/$0.50) - 2009/07/01 0:48:44 ET
Table '+dXkOAQyS8j9PQZusUTMpg' 2-max Seat #1 is the button
Seat 1: XFa6sBGjP2gxoIvxR3fZIg ($61.50 in chips)
Seat 2: 5IBeOgaApY1Bvzv2P8X4EA ($141.15 in chips)
XFa6sBGjP2gxoIvxR3fZIg: posts small blind $0.25
5IBeOgaApY1Bvzv2P8X4EA: posts big blind $0.50
*** HOLE CARDS ***
XFa6sBGjP2gxoIvxR3fZIg: raises $1 to $1.50
5IBeOgaApY1Bvzv2P8X4EA: folds
XFa6sBGjP2gxoIvxR3fZIg collected $1 from pot
XFa6sBGjP2gxoIvxR3fZIg: doesn't show hand
*** SUMMARY ***
Total pot $1 | Rake $0
Seat 1: XFa6sBGjP2gxoIvxR3fZIg (button) (small blind) collected ($1)
Seat 2: 5IBeOgaApY1Bvzv2P8X4EA (big blind) folded before Flop



PokerStars Game #59939780316:  Hold'em No Limit ($0.25/$0.50) - 2009/07/01 0:48:45 ET
Table '0eJtgVAXVvBgncFdcUpXcQ' 2-max Seat #2 is the button
Seat 1: Ag6DvxX4vbRheqsv2zXKTQ ($30.15 in chips)
Seat 2: KMc4R+K9ao4Ur3rF7NGe6Q ($23.10 in chips)
KMc4R+K9ao4Ur3rF7NGe6Q: posts small blind $0.25
Ag6DvxX4vbRheqsv2zXKTQ: posts big blind $0.50
*** HOLE CARDS ***
KMc4R+K9ao4Ur3rF7NGe6Q: calls $0.25
Ag6DvxX4vbRheqsv2zXKTQ: checks
*** FLOP *** [4h 7h Ad]
Ag6DvxX4vbRheqsv2zXKTQ: checks
KMc4R+K9ao4Ur3rF7NGe6Q: bets $1
Ag6DvxX4vbRheqsv2zXKTQ: folds
KMc4R+K9ao4Ur3rF7NGe6Q collected $0.95 from pot
KMc4R+K9ao4Ur3rF7NGe6Q: doesn't show hand
*** SUMMARY ***
Total pot $1 | Rake $0.05
Board [4h 7h Ad]
Seat 1: Ag6DvxX4vbRheqsv2zXKTQ (big blind) folded on the Flop
Seat 2: KMc4R+K9ao4Ur3rF7NGe6Q (button) (small blind) collected ($0.95)



PokerStars Game #59939780384:  Hold'em No Limit ($0.25/$0.50) - 2009/07/01 0:48:45 ET
Table 'QOgaEqMcJ73pcUMMxoisUgErOuyGLI5PT3G5MnpHgC/g Seat #7 is the button
Seat 3: xZCXQSXlrZkp3pZizzVXCw ($49.75 in chips)
Seat 4: 3UmXLy3GfjC3EkOebduerQ ($50 in chips)
Seat 5: JwvquocWfhTVApN5t47LgA ($60.10 in chips)
Seat 6: zE9cVigS2nW/Ljy4K4bUQA ($30 in chips)
Seat 7: 90Wb75h3W1BRpbqVnuk8gw ($61.70 in chips)
Seat 8: g4k0NXISyLCqaSWZDBjfEg ($50.25 in chips)
Seat 9: J0W5D97jl5VLky+IoPvDeA ($57.90 in chips)
g4k0NXISyLCqaSWZDBjfEg: posts small blind $0.25
J0W5D97jl5VLky+IoPvDeA: posts big blind $0.50
eBrej2jnlUCs/JgxFCRn2g: sits out
*** HOLE CARDS ***
xZCXQSXlrZkp3pZizzVXCw: folds
3UmXLy3GfjC3EkOebduerQ: folds
JwvquocWfhTVApN5t47LgA: folds
zE9cVigS2nW/Ljy4K4bUQA: folds
90Wb75h3W1BRpbqVnuk8gw: raises $1.50 to $2
g4k0NXISyLCqaSWZDBjfEg: folds
J0W5D97jl5VLky+IoPvDeA: calls $1.50
*** FLOP *** [Jd As Tc]
J0W5D97jl5VLky+IoPvDeA: bets $2
90Wb75h3W1BRpbqVnuk8gw: calls $2
*** TURN *** [Jd As Tc] [Th]
J0W5D97jl5VLky+IoPvDeA: checks
90Wb75h3W1BRpbqVnuk8gw: bets $5
J0W5D97jl5VLky+IoPvDeA: folds
90Wb75h3W1BRpbqVnuk8gw collected $7.85 from pot
*** SUMMARY ***
Total pot $8.25 | Rake $0.40
Board [Jd As Tc Th]
Seat 3: xZCXQSXlrZkp3pZizzVXCw folded before Flop (didn't bet)
Seat 4: 3UmXLy3GfjC3EkOebduerQ folded before Flop (didn't bet)
Seat 5: JwvquocWfhTVApN5t47LgA folded before Flop (didn't bet)
Seat 6: zE9cVigS2nW/Ljy4K4bUQA folded before Flop (didn't bet)
Seat 7: 90Wb75h3W1BRpbqVnuk8gw (button) collected ($7.85)
Seat 8: g4k0NXISyLCqaSWZDBjfEg (small blind) folded before Flop
Seat 9: J0W5D97jl5VLky+IoPvDeA (big blind) folded on the Turn



PokerStars Game #59939781016:  Hold'em No Limit ($0.25/$0.50) - 2009/07/01 0:48:46 ET
Table '37qXEp3oe+er5q4CZip9eQ' 6-max Seat #4 is the button
Seat 1: oqOqoO2AyCZenUghCxMDxw ($57.65 in chips)
Seat 2: 6wzJiRvp8HY6t+MQGnSIzA ($28 in chips)
Seat 3: Rt6KgtZ8YaJoTc3FPim00w ($100.35 in chips)
Seat 4: XsmE8nXMAAMFJbWaJTmHFw ($27.20 in chips)
Seat 5: VOmI0x4dDPnTESZd5B4d1Q ($39.15 in chips)
Seat 6: N50kln4negd8q7Mmoz1j4g ($24.50 in chips)
VOmI0x4dDPnTESZd5B4d1Q: posts small blind $0.25
N50kln4negd8q7Mmoz1j4g: posts big blind $0.50
*** HOLE CARDS ***
oqOqoO2AyCZenUghCxMDxw: folds
6wzJiRvp8HY6t+MQGnSIzA: calls $0.50
Rt6KgtZ8YaJoTc3FPim00w: folds
XsmE8nXMAAMFJbWaJTmHFw: raises $1 to $1.50
VOmI0x4dDPnTESZd5B4d1Q: folds
N50kln4negd8q7Mmoz1j4g: folds
6wzJiRvp8HY6t+MQGnSIzA: calls $1
*** FLOP *** [2c 7h 2d]
6wzJiRvp8HY6t+MQGnSIzA: checks
XsmE8nXMAAMFJbWaJTmHFw: bets $1.50
6wzJiRvp8HY6t+MQGnSIzA: folds
XsmE8nXMAAMFJbWaJTmHFw collected $3.60 from pot
*** SUMMARY ***
Total pot $3.75 | Rake $0.15
Board [2c 7h 2d]
Seat 1: oqOqoO2AyCZenUghCxMDxw folded before Flop (didn't bet)
Seat 2: 6wzJiRvp8HY6t+MQGnSIzA folded on the Flop
Seat 3: Rt6KgtZ8YaJoTc3FPim00w folded before Flop (didn't bet)
Seat 4: XsmE8nXMAAMFJbWaJTmHFw (button) collected ($3.60)
Seat 5: VOmI0x4dDPnTESZd5B4d1Q (small blind) folded before Flop
Seat 6: N50kln4negd8q7Mmoz1j4g (big blind) folded before Flop



PokerStars Game #59939783044:  Hold'em No Limit ($0.25/$0.50) - 2009/07/01 0:48:49 ET
Table 'fx6MqwfYAj/Rt86hBz2L3Q' 9-max Seat #6 is the button
Seat 1: SegjDnMxWMujiD57ESNL+g ($10 in chips)
Seat 3: iadBi5AEt7gTBXbDSSnMYQ ($47.45 in chips)
Seat 4: gPEN9Zp33YTm/mu9/SYP1w ($23.30 in chips)
Seat 5: iAISe3dVeua8PUn2wwgDHw ($33.80 in chips)
Seat 6: 5k9fvXD9suIgCxU4HLQjTw ($50 in chips)
Seat 7: SKnJuWHScqetA/qG5p+wCg ($30 in chips)
Seat 8: JYwJYYV9pM5KWdSiETl8rA ($30 in chips)
Seat 9: HZkVla4kK2SI42CVrPZ/ig ($11.75 in chips)
SKnJuWHScqetA/qG5p+wCg: posts small blind $0.25
JYwJYYV9pM5KWdSiETl8rA: posts big blind $0.50
*** HOLE CARDS ***
HZkVla4kK2SI42CVrPZ/ig: folds
SegjDnMxWMujiD57ESNL+g: folds
iadBi5AEt7gTBXbDSSnMYQ: folds
gPEN9Zp33YTm/mu9/SYP1w: folds
iAISe3dVeua8PUn2wwgDHw: calls $0.50
5k9fvXD9suIgCxU4HLQjTw: folds
SKnJuWHScqetA/qG5p+wCg: folds
JYwJYYV9pM5KWdSiETl8rA: checks
*** FLOP *** [Qd 5s Qc]
JYwJYYV9pM5KWdSiETl8rA: checks
iAISe3dVeua8PUn2wwgDHw: checks
*** TURN *** [Qd 5s Qc] [Jd]
JYwJYYV9pM5KWdSiETl8rA: checks
iAISe3dVeua8PUn2wwgDHw: bets $0.50
JYwJYYV9pM5KWdSiETl8rA: folds
iAISe3dVeua8PUn2wwgDHw collected $1.20 from pot
*** SUMMARY ***
Total pot $1.25 | Rake $0.05
Board [Qd 5s Qc Jd]
Seat 1: SegjDnMxWMujiD57ESNL+g folded before Flop (didn't bet)
Seat 3: iadBi5AEt7gTBXbDSSnMYQ folded before Flop (didn't bet)
Seat 4: gPEN9Zp33YTm/mu9/SYP1w folded before Flop (didn't bet)
Seat 5: iAISe3dVeua8PUn2wwgDHw collected ($1.20)
Seat 6: 5k9fvXD9suIgCxU4HLQjTw (button) folded before Flop (didn't bet)
Seat 7: SKnJuWHScqetA/qG5p+wCg (small blind) folded before Flop
Seat 8: JYwJYYV9pM5KWdSiETl8rA (big blind) folded on the Turn
Seat 9: HZkVla4kK2SI42CVrPZ/ig folded before Flop (didn't bet)



PokerStars Game #59939783478:  Hold'em No Limit ($0.25/$0.50) - 2009/07/01 0:48:50 ET
Table '99gCy/CZQwPIjZWH+BguQgE7bWJ45aoFXRpyRv2gw+Igeat #3 is the button
Seat 2: n6VQBu6crjYjy6DxNP1NZA ($28.90 in chips)
Seat 3: qEn9ijNGtuyTxamBf07hYg ($50 in chips)
Seat 4: bxLSulbgr8LmKNjOzw8URg ($61.70 in chips)
Seat 5: DSM67hHHq1XFoEOi9p8Alw ($49.25 in chips)
Seat 7: bfSq6LBw0UvxeM5yfuWC7w ($18.60 in chips)
Seat 8: 8ehL7qlZzjgUh2H35iiWLw ($50 in chips)
Seat 9: j3K/Jujr7PY4ZM2RZvlH6A ($88.15 in chips)
bxLSulbgr8LmKNjOzw8URg: posts small blind $0.25
DSM67hHHq1XFoEOi9p8Alw: posts big blind $0.50
*** HOLE CARDS ***
bfSq6LBw0UvxeM5yfuWC7w said, "PROP BET"
bfSq6LBw0UvxeM5yfuWC7w: folds
8ehL7qlZzjgUh2H35iiWLw: folds
j3K/Jujr7PY4ZM2RZvlH6A: folds
n6VQBu6crjYjy6DxNP1NZA: raises $1 to $1.50
qEn9ijNGtuyTxamBf07hYg: folds
bxLSulbgr8LmKNjOzw8URg: folds
DSM67hHHq1XFoEOi9p8Alw: calls $1
*** FLOP *** [3c Kd Js]
DSM67hHHq1XFoEOi9p8Alw: checks
n6VQBu6crjYjy6DxNP1NZA: bets $1.50
DSM67hHHq1XFoEOi9p8Alw: folds
n6VQBu6crjYjy6DxNP1NZA collected $3.10 from pot
n6VQBu6crjYjy6DxNP1NZA: doesn't show hand
*** SUMMARY ***
Total pot $3.25 | Rake $0.15
Board [3c Kd Js]
Seat 2: n6VQBu6crjYjy6DxNP1NZA collected ($3.10)
Seat 3: qEn9ijNGtuyTxamBf07hYg (button) folded before Flop (didn't bet)
Seat 4: bxLSulbgr8LmKNjOzw8URg (small blind) folded before Flop
Seat 5: DSM67hHHq1XFoEOi9p8Alw (big blind) folded on the Flop
Seat 7: bfSq6LBw0UvxeM5yfuWC7w folded before Flop (didn't bet)
Seat 8: 8ehL7qlZzjgUh2H35iiWLw folded before Flop (didn't bet)
Seat 9: j3K/Jujr7PY4ZM2RZvlH6A folded before Flop (didn't bet)



PokerStars Game #59939783304:  Hold'em No Limit ($0.25/$0.50) - 2009/07/01 0:48:50 ET
Table 'NCiXr0d5CEKBQr/cZgLhbA' 9-max Seat #3 is the button
Seat 1: pFtzb1sR4b0d1aw6aIRgDg ($50 in chips)
Seat 2: ulxuJchBV9iguXg0FUonfg ($49.75 in chips)
Seat 3: xZCXQSXlrZkp3pZizzVXCw ($52.25 in chips)
Seat 4: 5k9fvXD9suIgCxU4HLQjTw ($56.20 in chips)
Seat 5: zE9cVigS2nW/Ljy4K4bUQA ($36.70 in chips)
Seat 6: SKnJuWHScqetA/qG5p+wCg ($33.45 in chips)
Seat 7: M+7+BTmX5vZatHVuoRB1nA ($47.60 in chips)
Seat 8: 1MJUKc3cc0QmUoz1JZLR2w ($57.25 in chips)
Seat 9: 4WLZvqBn5qv5tds5kt5A1Q ($45.80 in chips)
5k9fvXD9suIgCxU4HLQjTw: posts small blind $0.25
zE9cVigS2nW/Ljy4K4bUQA: posts big blind $0.50
*** HOLE CARDS ***
SKnJuWHScqetA/qG5p+wCg: calls $0.50
M+7+BTmX5vZatHVuoRB1nA: calls $0.50
1MJUKc3cc0QmUoz1JZLR2w: raises $2.50 to $3
4WLZvqBn5qv5tds5kt5A1Q: folds
pFtzb1sR4b0d1aw6aIRgDg: folds
ulxuJchBV9iguXg0FUonfg: folds
xZCXQSXlrZkp3pZizzVXCw: folds
5k9fvXD9suIgCxU4HLQjTw: folds
zE9cVigS2nW/Ljy4K4bUQA: folds
SKnJuWHScqetA/qG5p+wCg: folds
M+7+BTmX5vZatHVuoRB1nA: folds
1MJUKc3cc0QmUoz1JZLR2w collected $2.25 from pot
*** SUMMARY ***
Total pot $2.25 | Rake $0
Seat 1: pFtzb1sR4b0d1aw6aIRgDg folded before Flop (didn't bet)
Seat 2: ulxuJchBV9iguXg0FUonfg folded before Flop (didn't bet)
Seat 3: xZCXQSXlrZkp3pZizzVXCw (button) folded before Flop (didn't bet)
Seat 4: 5k9fvXD9suIgCxU4HLQjTw (small blind) folded before Flop
Seat 5: zE9cVigS2nW/Ljy4K4bUQA (big blind) folded before Flop
Seat 6: SKnJuWHScqetA/qG5p+wCg folded before Flop
Seat 7: M+7+BTmX5vZatHVuoRB1nA folded before Flop
Seat 8: 1MJUKc3cc0QmUoz1JZLR2w collected ($2.25)
Seat 9: 4WLZvqBn5qv5tds5kt5A1Q folded before Flop (didn't bet)



PokerStars Game #59939784270:  Hold'em No Limit ($0.25/$0.50) - 2009/07/01 0:48:51 ET
Table '+dXkOAQyS8j9PQZusUTMpg' 2-max Seat #2 is the button
Seat 1: XFa6sBGjP2gxoIvxR3fZIg ($62 in chips)
Seat 2: 5IBeOgaApY1Bvzv2P8X4EA ($140.65 in chips)
5IBeOgaApY1Bvzv2P8X4EA: posts small blind $0.25
XFa6sBGjP2gxoIvxR3fZIg: posts big blind $0.50
*** HOLE CARDS ***
5IBeOgaApY1Bvzv2P8X4EA: folds
XFa6sBGjP2gxoIvxR3fZIg collected $0.50 from pot
XFa6sBGjP2gxoIvxR3fZIg: doesn't show hand
*** SUMMARY ***
Total pot $0.50 | Rake $0
Seat 1: XFa6sBGjP2gxoIvxR3fZIg (big blind) collected ($0.50)
Seat 2: 5IBeOgaApY1Bvzv2P8X4EA (button) (small blind) folded before Flop



PokerStars Game #59939784384:  Hold'em No Limit ($0.25/$0.50) - 2009/07/01 0:48:52 ET
Table 'ibNfFy0bCzuBaUORla0aGw' 9-max Seat #1 is the button
Seat 1: xZCXQSXlrZkp3pZizzVXCw ($52.45 in chips)
Seat 2: 90Wb75h3W1BRpbqVnuk8gw ($51.65 in chips)
Seat 3: AjV5McH1KMMclY26QdLM5w ($25 in chips)
Seat 4: YBN054X4blmis+B2bBlC0g ($23.45 in chips)
Seat 5: GIJAc9kPrLZHLSX8Q6i99w ($25.40 in chips)
Seat 6: 8n9jQLh3cZKbsmr5PIjgiQ ($43.25 in chips)
Seat 7: HZkVla4kK2SI42CVrPZ/ig ($14.30 in chips)
Seat 8: xUrN9TWLq4m5V+OXY7KUUA ($50.45 in chips)
Seat 9: pFtzb1sR4b0d1aw6aIRgDg ($50 in chips)
90Wb75h3W1BRpbqVnuk8gw: posts small blind $0.25
AjV5McH1KMMclY26QdLM5w: posts big blind $0.50
*** HOLE CARDS ***
YBN054X4blmis+B2bBlC0g: folds
GIJAc9kPrLZHLSX8Q6i99w: folds
8n9jQLh3cZKbsmr5PIjgiQ: folds
HZkVla4kK2SI42CVrPZ/ig: folds
xUrN9TWLq4m5V+OXY7KUUA: folds
pFtzb1sR4b0d1aw6aIRgDg: folds
xZCXQSXlrZkp3pZizzVXCw: raises $1 to $1.50
90Wb75h3W1BRpbqVnuk8gw: folds
AjV5McH1KMMclY26QdLM5w: folds
xZCXQSXlrZkp3pZizzVXCw collected $1.25 from pot
*** SUMMARY ***
Total pot $1.25 | Rake $0
Seat 1: xZCXQSXlrZkp3pZizzVXCw (button) collected ($1.25)
Seat 2: 90Wb75h3W1BRpbqVnuk8gw (small blind) folded before Flop
Seat 3: AjV5McH1KMMclY26QdLM5w (big blind) folded before Flop
Seat 4: YBN054X4blmis+B2bBlC0g folded before Flop (didn't bet)
Seat 5: GIJAc9kPrLZHLSX8Q6i99w folded before Flop (didn't bet)
Seat 6: 8n9jQLh3cZKbsmr5PIjgiQ folded before Flop (didn't bet)
Seat 7: HZkVla4kK2SI42CVrPZ/ig folded before Flop (didn't bet)
Seat 8: xUrN9TWLq4m5V+OXY7KUUA folded before Flop (didn't bet)
Seat 9: pFtzb1sR4b0d1aw6aIRgDg folded before Flop (didn't bet)



PokerStars Game #59939784386:  Hold'em No Limit ($0.25/$0.50) - 2009/07/01 0:48:52 ET
Table '/cQuAT3ef4t+PGrXiNhGaQ' 9-max Seat #7 is the button
Seat 1: HZkVla4kK2SI42CVrPZ/ig ($10.70 in chips)
Seat 2: jXGruyaMqirTaTXNOvBdew ($69.45 in chips)
Seat 3: g4k0NXISyLCqaSWZDBjfEg ($55.25 in chips)
Seat 4: OWP/DOu+PlPK6ZZ3zYa0HA ($29.40 in chips)
Seat 5: 5SgaHdWixdClWvaEG+KUjQ ($25.60 in chips)
Seat 6: APYIOyK/4AGb+kIwlOUNBQ ($37.25 in chips)
Seat 7: J0W5D97jl5VLky+IoPvDeA ($113.40 in chips)
Seat 8: eBrej2jnlUCs/JgxFCRn2g ($40.25 in chips)
Seat 9: AjV5McH1KMMclY26QdLM5w ($26.10 in chips)
eBrej2jnlUCs/JgxFCRn2g: posts small blind $0.25
AjV5McH1KMMclY26QdLM5w: posts big blind $0.50
*** HOLE CARDS ***
HZkVla4kK2SI42CVrPZ/ig: raises $1 to $1.50
jXGruyaMqirTaTXNOvBdew: folds
g4k0NXISyLCqaSWZDBjfEg: folds
OWP/DOu+PlPK6ZZ3zYa0HA: calls $1.50
5SgaHdWixdClWvaEG+KUjQ: folds
APYIOyK/4AGb+kIwlOUNBQ: folds
J0W5D97jl5VLky+IoPvDeA: folds
eBrej2jnlUCs/JgxFCRn2g: folds
AjV5McH1KMMclY26QdLM5w: calls $1
*** FLOP *** [Ah 3d 6h]
AjV5McH1KMMclY26QdLM5w: checks
HZkVla4kK2SI42CVrPZ/ig: bets $2
OWP/DOu+PlPK6ZZ3zYa0HA: folds
AjV5McH1KMMclY26QdLM5w: folds
HZkVla4kK2SI42CVrPZ/ig collected $4.55 from pot
*** SUMMARY ***
Total pot $4.75 | Rake $0.20
Board [Ah 3d 6h]
Seat 1: HZkVla4kK2SI42CVrPZ/ig collected ($4.55)
Seat 2: jXGruyaMqirTaTXNOvBdew folded before Flop (didn't bet)
Seat 3: g4k0NXISyLCqaSWZDBjfEg folded before Flop (didn't bet)
Seat 4: OWP/DOu+PlPK6ZZ3zYa0HA folded on the Flop
Seat 5: 5SgaHdWixdClWvaEG+KUjQ folded before Flop (didn't bet)
Seat 6: APYIOyK/4AGb+kIwlOUNBQ folded before Flop (didn't bet)
Seat 7: J0W5D97jl5VLky+IoPvDeA (button) folded before Flop (didn't bet)
Seat 8: eBrej2jnlUCs/JgxFCRn2g (small blind) folded before Flop
Seat 9: AjV5McH1KMMclY26QdLM5w (big blind) folded on the Flop



PokerStars Game #59939784646:  Hold'em No Limit ($0.25/$0.50) - 2009/07/01 0:48:52 ET
Table '5EmHi+fnatGQQShcNmzOZQ' 6-max Seat #5 is the button
Seat 3: TjmTe3bhs9dFz5gXX9x7Lw ($24 in chips)
Seat 4: 1b+2BbjMN8qhR1WPqdE9VQ ($52.90 in chips)
Seat 5: kxPhs4ePFqMy52CInAJ2aw ($53.35 in chips)
Seat 6: 686aeHikcJlgKkSuIFdcXQ ($143.20 in chips)
686aeHikcJlgKkSuIFdcXQ: posts small blind $0.25
vXIHnZ+dv/hwSBxyvGw7bQ: is sitting out
TjmTe3bhs9dFz5gXX9x7Lw: posts big blind $0.50
*** HOLE CARDS ***
1b+2BbjMN8qhR1WPqdE9VQ: folds
kxPhs4ePFqMy52CInAJ2aw: raises $1.50 to $2
686aeHikcJlgKkSuIFdcXQ: folds
TjmTe3bhs9dFz5gXX9x7Lw: calls $1.50
*** FLOP *** [6s 2h 2c]
TjmTe3bhs9dFz5gXX9x7Lw: checks
kxPhs4ePFqMy52CInAJ2aw: bets $3
TjmTe3bhs9dFz5gXX9x7Lw: raises $4.50 to $7.50
kxPhs4ePFqMy52CInAJ2aw: folds
TjmTe3bhs9dFz5gXX9x7Lw collected $9.75 from pot
TjmTe3bhs9dFz5gXX9x7Lw: doesn't show hand
*** SUMMARY ***
Total pot $10.25 | Rake $0.50
Board [6s 2h 2c]
Seat 3: TjmTe3bhs9dFz5gXX9x7Lw (big blind) collected ($9.75)
Seat 4: 1b+2BbjMN8qhR1WPqdE9VQ folded before Flop (didn't bet)
Seat 5: kxPhs4ePFqMy52CInAJ2aw (button) folded on the Flop
Seat 6: 686aeHikcJlgKkSuIFdcXQ (small blind) folded before Flop



PokerStars Game #59939785792:  Hold'em No Limit ($0.25/$0.50) - 2009/07/01 0:48:54 ET
Table 'QOgaEqMcJ73pcUMMxoisUg' 6-max Seat #3 is the button
Seat 1: /olYG0EzMWzADIgH1y2ySQ ($27.75 in chips)
Seat 2: 4QfsCWthT/vSLirorNXqtg ($50 in chips)
Seat 3: Rt6KgtZ8YaJoTc3FPim00w ($97.05 in chips)
Seat 4: zAcsDhG/T128Vn7XGVSgKg ($51.10 in chips)
Seat 5: 6vNxrjjCl6FwfaaymM9jjg ($18.20 in chips)
zAcsDhG/T128Vn7XGVSgKg: posts small blind $0.25
6vNxrjjCl6FwfaaymM9jjg: posts big blind $0.50
*** HOLE CARDS ***
/olYG0EzMWzADIgH1y2ySQ: folds
4QfsCWthT/vSLirorNXqtg: folds
Rt6KgtZ8YaJoTc3FPim00w: raises $1 to $1.50
zAcsDhG/T128Vn7XGVSgKg: folds
6vNxrjjCl6FwfaaymM9jjg: raises $6.50 to $8
Rt6KgtZ8YaJoTc3FPim00w: folds
6vNxrjjCl6FwfaaymM9jjg collected $3.25 from pot
*** SUMMARY ***
Total pot $3.25 | Rake $0
Seat 1: /olYG0EzMWzADIgH1y2ySQ folded before Flop (didn't bet)
Seat 2: 4QfsCWthT/vSLirorNXqtg folded before Flop (didn't bet)
Seat 3: Rt6KgtZ8YaJoTc3FPim00w (button) folded before Flop
Seat 4: zAcsDhG/T128Vn7XGVSgKg (small blind) folded before Flop
Seat 5: 6vNxrjjCl6FwfaaymM9jjg (big blind) collected ($3.25)



PokerStars Game #59939786738:  Hold'em No Limit ($0.25/$0.50) - 2009/07/01 0:48:55 ET
Table 'GfL/No5u5PoEnU39lP5pQg' 6-max Seat #5 is the button
Seat 1: 1WUCqNG+p+vfWRTXNu4ljw ($61 in chips)
Seat 2: uVwggSetzp7d+eVgowO3vg ($64.95 in chips)
Seat 3: Ek4w9XqBXqK5jBUQeLedGw ($50 in chips)
Seat 4: r6u7MWSXF30/khcTYkrG9Q ($25.40 in chips)
Seat 5: M1KyQQvVPVuxqTAB8sR/zQ ($52.25 in chips)
1WUCqNG+p+vfWRTXNu4ljw: posts small blind $0.25
uVwggSetzp7d+eVgowO3vg: posts big blind $0.50
*** HOLE CARDS ***
Ek4w9XqBXqK5jBUQeLedGw: folds
r6u7MWSXF30/khcTYkrG9Q: folds
M1KyQQvVPVuxqTAB8sR/zQ: raises $1 to $1.50
1WUCqNG+p+vfWRTXNu4ljw: folds
uVwggSetzp7d+eVgowO3vg: folds
kxPhs4ePFqMy52CInAJ2aw joins the table at seat #6
M1KyQQvVPVuxqTAB8sR/zQ collected $1.25 from pot
M1KyQQvVPVuxqTAB8sR/zQ: doesn't show hand
*** SUMMARY ***
Total pot $1.25 | Rake $0
Seat 1: 1WUCqNG+p+vfWRTXNu4ljw (small blind) folded before Flop
Seat 2: uVwggSetzp7d+eVgowO3vg (big blind) folded before Flop
Seat 3: Ek4w9XqBXqK5jBUQeLedGw folded before Flop (didn't bet)
Seat 4: r6u7MWSXF30/khcTYkrG9Q folded before Flop (didn't bet)
Seat 5: M1KyQQvVPVuxqTAB8sR/zQ (button) collected ($1.25)



PokerStars Game #59939788124:  Hold'em No Limit ($0.25/$0.50) - 2009/07/01 0:48:58 ET
Table '+dXkOAQyS8j9PQZusUTMpg' 2-max Seat #1 is the button
Seat 1: XFa6sBGjP2gxoIvxR3fZIg ($62.25 in chips)
Seat 2: 5IBeOgaApY1Bvzv2P8X4EA ($140.40 in chips)
XFa6sBGjP2gxoIvxR3fZIg: posts small blind $0.25
5IBeOgaApY1Bvzv2P8X4EA: posts big blind $0.50
*** HOLE CARDS ***
XFa6sBGjP2gxoIvxR3fZIg: raises $1 to $1.50
5IBeOgaApY1Bvzv2P8X4EA: calls $1
*** FLOP *** [Jc Qs 9s]
5IBeOgaApY1Bvzv2P8X4EA: checks
XFa6sBGjP2gxoIvxR3fZIg: checks
*** TURN *** [Jc Qs 9s] [6s]
5IBeOgaApY1Bvzv2P8X4EA: bets $0.50
XFa6sBGjP2gxoIvxR3fZIg: calls $0.50
*** RIVER *** [Jc Qs 9s 6s] [3c]
5IBeOgaApY1Bvzv2P8X4EA: bets $1
XFa6sBGjP2gxoIvxR3fZIg: calls $1
*** SHOW DOWN ***
5IBeOgaApY1Bvzv2P8X4EA: shows [4c 6c] (a pair of Sixes)
XFa6sBGjP2gxoIvxR3fZIg: shows [5c 6h] (a pair of Sixes)
5IBeOgaApY1Bvzv2P8X4EA collected $2.90 from pot
XFa6sBGjP2gxoIvxR3fZIg collected $2.85 from pot
*** SUMMARY ***
Total pot $6 | Rake $0.25
Board [Jc Qs 9s 6s 3c]
Seat 1: XFa6sBGjP2gxoIvxR3fZIg (button) (small blind) showed [5c 6h] and won ($2.85) with a pair of Sixes
Seat 2: 5IBeOgaApY1Bvzv2P8X4EA (big blind) showed [4c 6c] and won ($2.90) with a pair of Sixes



PokerStars Game #59939789530:  Hold'em No Limit ($0.25/$0.50) - 2009/07/01 0:49:00 ET
Table '0eJtgVAXVvBgncFdcUpXcQ' 2-max Seat #1 is the button
Seat 1: Ag6DvxX4vbRheqsv2zXKTQ ($29.65 in chips)
Seat 2: KMc4R+K9ao4Ur3rF7NGe6Q ($23.55 in chips)
Ag6DvxX4vbRheqsv2zXKTQ: posts small blind $0.25
KMc4R+K9ao4Ur3rF7NGe6Q: posts big blind $0.50
*** HOLE CARDS ***
Ag6DvxX4vbRheqsv2zXKTQ: raises $0.50 to $1
KMc4R+K9ao4Ur3rF7NGe6Q: calls $0.50
*** FLOP *** [Kd 9s Jh]
KMc4R+K9ao4Ur3rF7NGe6Q: bets $1
Ag6DvxX4vbRheqsv2zXKTQ: raises $1.50 to $2.50
KMc4R+K9ao4Ur3rF7NGe6Q: calls $1.50
*** TURN *** [Kd 9s Jh] [7h]
KMc4R+K9ao4Ur3rF7NGe6Q: checks
Ag6DvxX4vbRheqsv2zXKTQ: bets $3
KMc4R+K9ao4Ur3rF7NGe6Q: calls $3
*** RIVER *** [Kd 9s Jh 7h] [5c]
KMc4R+K9ao4Ur3rF7NGe6Q: bets $3.50
Ag6DvxX4vbRheqsv2zXKTQ: calls $3.50
*** SHOW DOWN ***
KMc4R+K9ao4Ur3rF7NGe6Q: shows [Js 5s] (two pair, Jacks and Fives)
Ag6DvxX4vbRheqsv2zXKTQ: shows [9h Kc] (two pair, Kings and Nines)
Ag6DvxX4vbRheqsv2zXKTQ collected $19.50 from pot
*** SUMMARY ***
Total pot $20 | Rake $0.50
Board [Kd 9s Jh 7h 5c]
Seat 1: Ag6DvxX4vbRheqsv2zXKTQ (button) (small blind) showed [9h Kc] and won ($19.50) with two pair, Kings and Nines
Seat 2: KMc4R+K9ao4Ur3rF7NGe6Q (big blind) showed [Js 5s] and lost with two pair, Jacks and Fives



PokerStars Game #59939791928:  Hold'em No Limit ($0.25/$0.50) - 2009/07/01 0:49:03 ET
Table 'MJxeZCzYELxiIsyUZyT0jw' 6-max Seat #3 is the button
Seat 2: t3GiVMzqA9Svgr5Uol32cQ ($30 in chips)
Seat 3: JQZew0FjzS19kTjeNtrE+A ($64.75 in chips)
Seat 4: alGiiQP/wwtYnfuXII+sgw ($49.45 in chips)
Seat 5: 3jvoOXNtXE90w2BdfNZwZQ ($50 in chips)
Seat 6: TTx3CHxyi0SObcHyMJRp5w ($53.15 in chips)
alGiiQP/wwtYnfuXII+sgw: posts small blind $0.25
3jvoOXNtXE90w2BdfNZwZQ: posts big blind $0.50
t3GiVMzqA9Svgr5Uol32cQ: posts big blind $0.50
*** HOLE CARDS ***
TTx3CHxyi0SObcHyMJRp5w: folds
t3GiVMzqA9Svgr5Uol32cQ: checks
JQZew0FjzS19kTjeNtrE+A: calls $0.50
alGiiQP/wwtYnfuXII+sgw: calls $0.25
3jvoOXNtXE90w2BdfNZwZQ: checks
*** FLOP *** [9c 8d 5h]
alGiiQP/wwtYnfuXII+sgw: checks
nOfdMHEXflgT86UgFWblAA joins the table at seat #1
3jvoOXNtXE90w2BdfNZwZQ: checks
t3GiVMzqA9Svgr5Uol32cQ: checks
JQZew0FjzS19kTjeNtrE+A: bets $2
alGiiQP/wwtYnfuXII+sgw: folds
3jvoOXNtXE90w2BdfNZwZQ: folds
t3GiVMzqA9Svgr5Uol32cQ: calls $2
*** TURN *** [9c 8d 5h] [Tc]
t3GiVMzqA9Svgr5Uol32cQ: checks
JQZew0FjzS19kTjeNtrE+A: checks
*** RIVER *** [9c 8d 5h Tc] [Jd]
t3GiVMzqA9Svgr5Uol32cQ: checks
JQZew0FjzS19kTjeNtrE+A: bets $4
t3GiVMzqA9Svgr5Uol32cQ: calls $4
*** SHOW DOWN ***
JQZew0FjzS19kTjeNtrE+A: shows [4s 2s] (high card Jack)
t3GiVMzqA9Svgr5Uol32cQ: shows [7h 6d] (a straight, Seven to Jack)
t3GiVMzqA9Svgr5Uol32cQ collected $13.35 from pot
*** SUMMARY ***
Total pot $14 | Rake $0.65
Board [9c 8d 5h Tc Jd]
Seat 2: t3GiVMzqA9Svgr5Uol32cQ showed [7h 6d] and won ($13.35) with a straight, Seven to Jack
Seat 3: JQZew0FjzS19kTjeNtrE+A (button) showed [4s 2s] and lost with high card Jack
Seat 4: alGiiQP/wwtYnfuXII+sgw (small blind) folded on the Flop
Seat 5: 3jvoOXNtXE90w2BdfNZwZQ (big blind) folded on the Flop
Seat 6: TTx3CHxyi0SObcHyMJRp5w folded before Flop (didn't bet)



PokerStars Game #59939792414:  Hold'em No Limit ($0.25/$0.50) - 2009/07/01 0:49:04 ET
Table '+z1aekfHkpp09pc8F9aViw' 6-max Seat #3 is the button
Seat 1: FHilMb2i2DbUCc9lplszog ($39.35 in chips)
Seat 2: M6xK/VklCvdyyrmvzATlxQ ($35.25 in chips)
Seat 3: uUznlIMFnRUvwrBhYF73KA ($107.45 in chips)
Seat 4: RowCSpSURHTOL/dcjg/Iug ($49.55 in chips)
Seat 6: 686aeHikcJlgKkSuIFdcXQ ($64.60 in chips)
RowCSpSURHTOL/dcjg/Iug: posts small blind $0.25
crjGpJEzSZgD38FoE3VMGg: is sitting out
686aeHikcJlgKkSuIFdcXQ: posts big blind $0.50
*** HOLE CARDS ***
crjGpJEzSZgD38FoE3VMGg leaves the table
FHilMb2i2DbUCc9lplszog: folds
M6xK/VklCvdyyrmvzATlxQ: folds
uUznlIMFnRUvwrBhYF73KA: calls $0.50
RowCSpSURHTOL/dcjg/Iug: calls $0.25
686aeHikcJlgKkSuIFdcXQ: raises $3 to $3.50
uUznlIMFnRUvwrBhYF73KA: calls $3
RowCSpSURHTOL/dcjg/Iug: folds
*** FLOP *** [Qs 9h 9d]
686aeHikcJlgKkSuIFdcXQ: bets $6.50
uUznlIMFnRUvwrBhYF73KA: folds
686aeHikcJlgKkSuIFdcXQ collected $7.15 from pot
*** SUMMARY ***
Total pot $7.50 | Rake $0.35
Board [Qs 9h 9d]
Seat 1: FHilMb2i2DbUCc9lplszog folded before Flop (didn't bet)
Seat 2: M6xK/VklCvdyyrmvzATlxQ folded before Flop (didn't bet)
Seat 3: uUznlIMFnRUvwrBhYF73KA (button) folded on the Flop
Seat 4: RowCSpSURHTOL/dcjg/Iug (small blind) folded before Flop
Seat 6: 686aeHikcJlgKkSuIFdcXQ (big blind) collected ($7.15)



PokerStars Game #59939793442:  Hold'em No Limit ($0.25/$0.50) - 2009/07/01 0:49:06 ET
Table 'QOeVnLhwctF9UyV/beDi+A' 2-max Seat #1 is the button
Seat 1: bypIyrYcAAifLfhZpGlKLA ($69.70 in chips)
Seat 2: Ucrm3XtZmoONapW32SPhag ($12.35 in chips)
bypIyrYcAAifLfhZpGlKLA: posts small blind $0.25
Ucrm3XtZmoONapW32SPhag: posts big blind $0.50
*** HOLE CARDS ***
bypIyrYcAAifLfhZpGlKLA: raises $0.50 to $1
Ucrm3XtZmoONapW32SPhag: calls $0.50
*** FLOP *** [Ad 2c Kh]
Ucrm3XtZmoONapW32SPhag: checks
bypIyrYcAAifLfhZpGlKLA: bets $1.50
Ucrm3XtZmoONapW32SPhag: folds
bypIyrYcAAifLfhZpGlKLA collected $1.90 from pot
bypIyrYcAAifLfhZpGlKLA: doesn't show hand
*** SUMMARY ***
Total pot $2 | Rake $0.10
Board [Ad 2c Kh]
Seat 1: bypIyrYcAAifLfhZpGlKLA (button) (small blind) collected ($1.90)
Seat 2: Ucrm3XtZmoONapW32SPhag (big blind) folded on the Flop



PokerStars Game #59939793258:  Hold'em No Limit ($0.25/$0.50) - 2009/07/01 0:49:06 ET
Table 'BCN5su+SsXiy1zRMJi0SJw' 6-max Seat #4 is the button
Seat 1: GxXV09ciXaOxyY2H5aMIIw ($30 in chips)
Seat 2: oU2kDCkT/gilYbHWrg7D8w ($31.50 in chips)
Seat 3: g+vwI6lMKpU2uteXSjOzVw ($15.45 in chips)
Seat 4: JY9CtoZTeav+mhWyxSSyJQ ($25.85 in chips)
Seat 5: IBNygaT1aa9Z1uPdJJilwA ($13.55 in chips)
Seat 6: b2symlOdL7+0c9Pj4N/KlA ($83.70 in chips)
IBNygaT1aa9Z1uPdJJilwA: posts small blind $0.25
b2symlOdL7+0c9Pj4N/KlA: posts big blind $0.50
GxXV09ciXaOxyY2H5aMIIw: posts big blind $0.50
*** HOLE CARDS ***
GxXV09ciXaOxyY2H5aMIIw: checks
oU2kDCkT/gilYbHWrg7D8w: folds
g+vwI6lMKpU2uteXSjOzVw: calls $0.50
JY9CtoZTeav+mhWyxSSyJQ: folds
IBNygaT1aa9Z1uPdJJilwA: calls $0.25
b2symlOdL7+0c9Pj4N/KlA: checks
*** FLOP *** [5s 7c Kc]
IBNygaT1aa9Z1uPdJJilwA: checks
b2symlOdL7+0c9Pj4N/KlA: checks
GxXV09ciXaOxyY2H5aMIIw: checks
g+vwI6lMKpU2uteXSjOzVw: bets $2
IBNygaT1aa9Z1uPdJJilwA: folds
b2symlOdL7+0c9Pj4N/KlA: folds
GxXV09ciXaOxyY2H5aMIIw: folds
g+vwI6lMKpU2uteXSjOzVw collected $1.90 from pot
*** SUMMARY ***
Total pot $2 | Rake $0.10
Board [5s 7c Kc]
Seat 1: GxXV09ciXaOxyY2H5aMIIw folded on the Flop
Seat 2: oU2kDCkT/gilYbHWrg7D8w folded before Flop (didn't bet)
Seat 3: g+vwI6lMKpU2uteXSjOzVw collected ($1.90)
Seat 4: JY9CtoZTeav+mhWyxSSyJQ (button) folded before Flop (didn't bet)
Seat 5: IBNygaT1aa9Z1uPdJJilwA (small blind) folded on the Flop
Seat 6: b2symlOdL7+0c9Pj4N/KlA (big blind) folded on the Flop



PokerStars Game #59939794786:  Hold'em No Limit ($0.25/$0.50) - 2009/07/01 0:49:08 ET
Table '3FhG0gl3kMX3wBEEqj+wnQ' 9-max Seat #7 is the button
Seat 1: e0J9pdCNUDTCG031RnXqLA ($33.05 in chips)
Seat 2: 7cYQ+syUWjl38ty/ICOMhw ($50 in chips)
Seat 4: bjvJtA9Hqscfznq66txaOQ ($9.50 in chips)
Seat 5: gsyXT42WLEcOS4DdEk2wlw ($27.75 in chips)
Seat 6: 997ViqAtWn1FPjJqcffwcA ($50 in chips)
Seat 7: mSD1pginDsyHG5PDfqzphw ($10.25 in chips)
Seat 8: j3K/Jujr7PY4ZM2RZvlH6A ($61 in chips)
Seat 9: L5e2lrPLQm1Pqx30IIZ/Fw ($10 in chips)
j3K/Jujr7PY4ZM2RZvlH6A: posts small blind $0.25
L5e2lrPLQm1Pqx30IIZ/Fw: posts big blind $0.50
*** HOLE CARDS ***
e0J9pdCNUDTCG031RnXqLA: folds
7cYQ+syUWjl38ty/ICOMhw: folds
bjvJtA9Hqscfznq66txaOQ: folds
gsyXT42WLEcOS4DdEk2wlw: folds
997ViqAtWn1FPjJqcffwcA: folds
mSD1pginDsyHG5PDfqzphw: folds
j3K/Jujr7PY4ZM2RZvlH6A: calls $0.25
L5e2lrPLQm1Pqx30IIZ/Fw: checks
*** FLOP *** [Tc 9d 3s]
j3K/Jujr7PY4ZM2RZvlH6A: bets $1
L5e2lrPLQm1Pqx30IIZ/Fw: folds
j3K/Jujr7PY4ZM2RZvlH6A collected $0.95 from pot
j3K/Jujr7PY4ZM2RZvlH6A: doesn't show hand
*** SUMMARY ***
Total pot $1 | Rake $0.05
Board [Tc 9d 3s]
Seat 1: e0J9pdCNUDTCG031RnXqLA folded before Flop (didn't bet)
Seat 2: 7cYQ+syUWjl38ty/ICOMhw folded before Flop (didn't bet)
Seat 4: bjvJtA9Hqscfznq66txaOQ folded before Flop (didn't bet)
Seat 5: gsyXT42WLEcOS4DdEk2wlw folded before Flop (didn't bet)
Seat 6: 997ViqAtWn1FPjJqcffwcA folded before Flop (didn't bet)
Seat 7: mSD1pginDsyHG5PDfqzphw (button) folded before Flop (didn't bet)
Seat 8: j3K/Jujr7PY4ZM2RZvlH6A (small blind) collected ($0.95)
Seat 9: L5e2lrPLQm1Pqx30IIZ/Fw (big blind) folded on the Flop



PokerStars Game #59939795498:  Hold'em No Limit ($0.25/$0.50) - 2009/07/01 0:49:09 ET
Table 'T/PgNWqVyY6lkldcBVXYJQ' 6-max Seat #3 is the button
Seat 1: +Pf9jTVizYlIo+woPvptfA ($55.75 in chips)
Seat 2: LvH4G7n+QSjT6NDaD3cREA ($54.25 in chips)
Seat 3: L3OcNO1bgdqDI46j67KQPQ ($50 in chips)
Seat 4: Ek4w9XqBXqK5jBUQeLedGw ($50 in chips)
Seat 6: cDzbog6kwmJp+LBeBq+iMQ ($44.75 in chips)
Ek4w9XqBXqK5jBUQeLedGw: posts small blind $0.25
cDzbog6kwmJp+LBeBq+iMQ: posts big blind $0.50
*** HOLE CARDS ***
+Pf9jTVizYlIo+woPvptfA: raises $1.50 to $2
LvH4G7n+QSjT6NDaD3cREA: folds
L3OcNO1bgdqDI46j67KQPQ: folds
Ek4w9XqBXqK5jBUQeLedGw: folds
cDzbog6kwmJp+LBeBq+iMQ: calls $1.50
*** FLOP *** [Th 5s 4h]
cDzbog6kwmJp+LBeBq+iMQ: checks
+Pf9jTVizYlIo+woPvptfA: bets $3
vVQBckETtigfb5mAcyK0OA leaves the table
cDzbog6kwmJp+LBeBq+iMQ: calls $3
*** TURN *** [Th 5s 4h] [Ac]
cDzbog6kwmJp+LBeBq+iMQ: checks
+Pf9jTVizYlIo+woPvptfA: bets $6.50
of9mtXiD8G4Nx5p7hCbgqQ joins the table at seat #5
cDzbog6kwmJp+LBeBq+iMQ: calls $6.50
*** RIVER *** [Th 5s 4h Ac] [9s]
cDzbog6kwmJp+LBeBq+iMQ: checks
+Pf9jTVizYlIo+woPvptfA: bets $12.50
cDzbog6kwmJp+LBeBq+iMQ: calls $12.50
*** SHOW DOWN ***
+Pf9jTVizYlIo+woPvptfA: shows [Qh Ah] (a pair of Aces)
cDzbog6kwmJp+LBeBq+iMQ: mucks hand
+Pf9jTVizYlIo+woPvptfA collected $46.25 from pot
*** SUMMARY ***
Total pot $48.25 | Rake $2
Board [Th 5s 4h Ac 9s]
Seat 1: +Pf9jTVizYlIo+woPvptfA showed [Qh Ah] and won ($46.25) with a pair of Aces
Seat 2: LvH4G7n+QSjT6NDaD3cREA folded before Flop (didn't bet)
Seat 3: L3OcNO1bgdqDI46j67KQPQ (button) folded before Flop (didn't bet)
Seat 4: Ek4w9XqBXqK5jBUQeLedGw (small blind) folded before Flop
Seat 6: cDzbog6kwmJp+LBeBq+iMQ (big blind) mucked



PokerStars Game #59939795430:  Hold'em No Limit ($0.25/$0.50) - 2009/07/01 0:49:09 ET
Table 'otvGDROEDdqsabxskT79qg' 9-max Seat #7 is the button
Seat 1: 8ehL7qlZzjgUh2H35iiWLw ($55.25 in chips)
Seat 2: cCjTzH9jio8607WzjcfXlg ($12.95 in chips)
Seat 3: +k7T5ocke8UwavtgUHm+Cg ($61.55 in chips)
Seat 4: MG90wfSJZnOejs/KD3vlQQ ($69.95 in chips)
Seat 5: XNMDwbXt/Q4jM99AXnbJDw ($52.55 in chips)
Seat 6: bxLSulbgr8LmKNjOzw8URg ($50.90 in chips)
Seat 7: C7+tBppJrKgd/r+tuKUIpA ($37.10 in chips)
Seat 8: zE9cVigS2nW/Ljy4K4bUQA ($30 in chips)
Seat 9: KcY3X8YpD74Kw1RHkx/g4A ($66.40 in chips)
zE9cVigS2nW/Ljy4K4bUQA: posts small blind $0.25
KcY3X8YpD74Kw1RHkx/g4A: posts big blind $0.50
*** HOLE CARDS ***
8ehL7qlZzjgUh2H35iiWLw: folds
cCjTzH9jio8607WzjcfXlg: folds
+k7T5ocke8UwavtgUHm+Cg: calls $0.50
MG90wfSJZnOejs/KD3vlQQ: folds
XNMDwbXt/Q4jM99AXnbJDw: folds
bxLSulbgr8LmKNjOzw8URg: folds
C7+tBppJrKgd/r+tuKUIpA: calls $0.50
zE9cVigS2nW/Ljy4K4bUQA: folds
KcY3X8YpD74Kw1RHkx/g4A: checks
*** FLOP *** [Qs 9h 6s]
KcY3X8YpD74Kw1RHkx/g4A: checks
+k7T5ocke8UwavtgUHm+Cg: bets $1
C7+tBppJrKgd/r+tuKUIpA: folds
KcY3X8YpD74Kw1RHkx/g4A: calls $1
*** TURN *** [Qs 9h 6s] [6d]
KcY3X8YpD74Kw1RHkx/g4A: checks
+k7T5ocke8UwavtgUHm+Cg: bets $1
KcY3X8YpD74Kw1RHkx/g4A: calls $1
*** RIVER *** [Qs 9h 6s 6d] [5c]
KcY3X8YpD74Kw1RHkx/g4A: checks
+k7T5ocke8UwavtgUHm+Cg: bets $5.50
KcY3X8YpD74Kw1RHkx/g4A: calls $5.50
*** SHOW DOWN ***
+k7T5ocke8UwavtgUHm+Cg: shows [7d 8d] (a straight, Five to Nine)
KcY3X8YpD74Kw1RHkx/g4A: mucks hand
+k7T5ocke8UwavtgUHm+Cg collected $15.95 from pot
*** SUMMARY ***
Total pot $16.75 | Rake $0.80
Board [Qs 9h 6s 6d 5c]
Seat 1: 8ehL7qlZzjgUh2H35iiWLw folded before Flop (didn't bet)
Seat 2: cCjTzH9jio8607WzjcfXlg folded before Flop (didn't bet)
Seat 3: +k7T5ocke8UwavtgUHm+Cg showed [7d 8d] and won ($15.95) with a straight, Five to Nine
Seat 4: MG90wfSJZnOejs/KD3vlQQ folded before Flop (didn't bet)
Seat 5: XNMDwbXt/Q4jM99AXnbJDw folded before Flop (didn't bet)
Seat 6: bxLSulbgr8LmKNjOzw8URg folded before Flop (didn't bet)
Seat 7: C7+tBppJrKgd/r+tuKUIpA (button) folded on the Flop
Seat 8: zE9cVigS2nW/Ljy4K4bUQA (small blind) folded before Flop
Seat 9: KcY3X8YpD74Kw1RHkx/g4A (big blind) mucked



PokerStars Game #59939799558:  Hold'em No Limit ($0.25/$0.50) - 2009/07/01 0:49:15 ET
Table 'GfL/No5u5PoEnU39lP5pQg' 6-max Seat #1 is the button
Seat 1: 1WUCqNG+p+vfWRTXNu4ljw ($60.75 in chips)
Seat 2: uVwggSetzp7d+eVgowO3vg ($64.45 in chips)
Seat 3: Ek4w9XqBXqK5jBUQeLedGw ($50 in chips)
Seat 4: r6u7MWSXF30/khcTYkrG9Q ($25.40 in chips)
Seat 5: M1KyQQvVPVuxqTAB8sR/zQ ($53 in chips)
uVwggSetzp7d+eVgowO3vg: posts small blind $0.25
Ek4w9XqBXqK5jBUQeLedGw: posts big blind $0.50
kxPhs4ePFqMy52CInAJ2aw: sits out
*** HOLE CARDS ***
r6u7MWSXF30/khcTYkrG9Q: folds
M1KyQQvVPVuxqTAB8sR/zQ: folds
1WUCqNG+p+vfWRTXNu4ljw: folds
uVwggSetzp7d+eVgowO3vg: folds
Ek4w9XqBXqK5jBUQeLedGw collected $0.50 from pot
*** SUMMARY ***
Total pot $0.50 | Rake $0
Seat 1: 1WUCqNG+p+vfWRTXNu4ljw (button) folded before Flop (didn't bet)
Seat 2: uVwggSetzp7d+eVgowO3vg (small blind) folded before Flop
Seat 3: Ek4w9XqBXqK5jBUQeLedGw (big blind) collected ($0.50)
Seat 4: r6u7MWSXF30/khcTYkrG9Q folded before Flop (didn't bet)
Seat 5: M1KyQQvVPVuxqTAB8sR/zQ folded before Flop (didn't bet)



PokerStars Game #59939799370:  Hold'em No Limit ($0.25/$0.50) - 2009/07/01 0:49:15 ET
Table 'Vdlc9wqYcHTUhtdyN7CuJw' 2-max Seat #1 is the button
Seat 1: yBO+mXB6m/rCft2ErwGf/Q ($115.75 in chips)
Seat 2: NZ/5cxwnorKW2SNsWy1+8A ($9.80 in chips)
yBO+mXB6m/rCft2ErwGf/Q: posts small blind $0.25
NZ/5cxwnorKW2SNsWy1+8A: posts big blind $0.50
*** HOLE CARDS ***
yBO+mXB6m/rCft2ErwGf/Q: calls $0.25
NZ/5cxwnorKW2SNsWy1+8A: checks
*** FLOP *** [9s 9h 8h]
NZ/5cxwnorKW2SNsWy1+8A: checks
yBO+mXB6m/rCft2ErwGf/Q: checks
*** TURN *** [9s 9h 8h] [7d]
NZ/5cxwnorKW2SNsWy1+8A: checks
yBO+mXB6m/rCft2ErwGf/Q: bets $0.50
NZ/5cxwnorKW2SNsWy1+8A: calls $0.50
*** RIVER *** [9s 9h 8h 7d] [3s]
NZ/5cxwnorKW2SNsWy1+8A: checks
yBO+mXB6m/rCft2ErwGf/Q: checks
*** SHOW DOWN ***
NZ/5cxwnorKW2SNsWy1+8A: shows [Ac 7h] (two pair, Nines and Sevens)
yBO+mXB6m/rCft2ErwGf/Q: mucks hand
NZ/5cxwnorKW2SNsWy1+8A collected $1.95 from pot
*** SUMMARY ***
Total pot $2 | Rake $0.05
Board [9s 9h 8h 7d 3s]
Seat 1: yBO+mXB6m/rCft2ErwGf/Q (button) (small blind) mucked
Seat 2: NZ/5cxwnorKW2SNsWy1+8A (big blind) showed [Ac 7h] and won ($1.95) with two pair, Nines and Sevens



PokerStars Game #59939799896:  Hold'em No Limit ($0.25/$0.50) - 2009/07/01 0:49:16 ET
Table 'X6IRCRTh+20gjz8aubWnwA' 9-max Seat #4 is the button
Seat 1: DSM67hHHq1XFoEOi9p8Alw ($50.05 in chips)
Seat 2: HZkVla4kK2SI42CVrPZ/ig ($8.55 in chips)
Seat 3: SWv01peOe69QQRvhQTqjQw ($13.40 in chips)
Seat 4: 2J+UVOVrW+V3maOylyxMcQ ($37.60 in chips)
Seat 5: NnQCepdIR/AOUQn1yhYx6Q ($9.50 in chips)
Seat 7: cFHQjKQOOKTUzoilhrXHLg ($42.35 in chips)
Seat 8: HxeBVq06/3Bh/H986sgdbw ($7.45 in chips)
Seat 9: M+7+BTmX5vZatHVuoRB1nA ($68.50 in chips)
NnQCepdIR/AOUQn1yhYx6Q: posts small blind $0.25
/6In1zC3WtgwxDcueWzZWg: is sitting out
cFHQjKQOOKTUzoilhrXHLg: posts big blind $0.50
*** HOLE CARDS ***
HxeBVq06/3Bh/H986sgdbw: folds
M+7+BTmX5vZatHVuoRB1nA: folds
/6In1zC3WtgwxDcueWzZWg leaves the table
DSM67hHHq1XFoEOi9p8Alw: folds
75K2MXwN65Sjfp1yHd50Hg joins the table at seat #6
HZkVla4kK2SI42CVrPZ/ig: folds
SWv01peOe69QQRvhQTqjQw: folds
2J+UVOVrW+V3maOylyxMcQ: folds
NnQCepdIR/AOUQn1yhYx6Q: raises $1.50 to $2
cFHQjKQOOKTUzoilhrXHLg: folds
NnQCepdIR/AOUQn1yhYx6Q collected $1 from pot
*** SUMMARY ***
Total pot $1 | Rake $0
Seat 1: DSM67hHHq1XFoEOi9p8Alw folded before Flop (didn't bet)
Seat 2: HZkVla4kK2SI42CVrPZ/ig folded before Flop (didn't bet)
Seat 3: SWv01peOe69QQRvhQTqjQw folded before Flop (didn't bet)
Seat 4: 2J+UVOVrW+V3maOylyxMcQ (button) folded before Flop (didn't bet)
Seat 5: NnQCepdIR/AOUQn1yhYx6Q (small blind) collected ($1)
Seat 7: cFHQjKQOOKTUzoilhrXHLg (big blind) folded before Flop
Seat 8: HxeBVq06/3Bh/H986sgdbw folded before Flop (didn't bet)
Seat 9: M+7+BTmX5vZatHVuoRB1nA folded before Flop (didn't bet)



PokerStars Game #59939800796:  Hold'em No Limit ($0.25/$0.50) - 2009/07/01 0:49:17 ET
Table 'fx6MqwfYAj/Rt86hBz2L3Q' 9-max Seat #7 is the button
Seat 1: SegjDnMxWMujiD57ESNL+g ($10 in chips)
Seat 3: iadBi5AEt7gTBXbDSSnMYQ ($47.45 in chips)
Seat 4: gPEN9Zp33YTm/mu9/SYP1w ($23.30 in chips)
Seat 5: iAISe3dVeua8PUn2wwgDHw ($34.50 in chips)
Seat 6: 5k9fvXD9suIgCxU4HLQjTw ($50 in chips)
Seat 7: SKnJuWHScqetA/qG5p+wCg ($30 in chips)
Seat 8: JYwJYYV9pM5KWdSiETl8rA ($29.50 in chips)
Seat 9: HZkVla4kK2SI42CVrPZ/ig ($11.75 in chips)
JYwJYYV9pM5KWdSiETl8rA: posts small blind $0.25
HZkVla4kK2SI42CVrPZ/ig: posts big blind $0.50
*** HOLE CARDS ***
SegjDnMxWMujiD57ESNL+g: folds
iadBi5AEt7gTBXbDSSnMYQ: raises $1.50 to $2
gPEN9Zp33YTm/mu9/SYP1w: folds
iAISe3dVeua8PUn2wwgDHw: folds
5k9fvXD9suIgCxU4HLQjTw: folds
SKnJuWHScqetA/qG5p+wCg: folds
JYwJYYV9pM5KWdSiETl8rA: folds
HZkVla4kK2SI42CVrPZ/ig: folds
iadBi5AEt7gTBXbDSSnMYQ collected $1.25 from pot
*** SUMMARY ***
Total pot $1.25 | Rake $0
Seat 1: SegjDnMxWMujiD57ESNL+g folded before Flop (didn't bet)
Seat 3: iadBi5AEt7gTBXbDSSnMYQ collected ($1.25)
Seat 4: gPEN9Zp33YTm/mu9/SYP1w folded before Flop (didn't bet)
Seat 5: iAISe3dVeua8PUn2wwgDHw folded before Flop (didn't bet)
Seat 6: 5k9fvXD9suIgCxU4HLQjTw folded before Flop (didn't bet)
Seat 7: SKnJuWHScqetA/qG5p+wCg (button) folded before Flop (didn't bet)
Seat 8: JYwJYYV9pM5KWdSiETl8rA (small blind) folded before Flop
Seat 9: HZkVla4kK2SI42CVrPZ/ig (big blind) folded before Flop



PokerStars Game #59939800710:  Hold'em No Limit ($0.25/$0.50) - 2009/07/01 0:49:17 ET
Table '+dXkOAQyS8j9PQZusUTMpg' 2-max Seat #2 is the button
Seat 1: XFa6sBGjP2gxoIvxR3fZIg ($62.10 in chips)
Seat 2: 5IBeOgaApY1Bvzv2P8X4EA ($140.30 in chips)
5IBeOgaApY1Bvzv2P8X4EA: posts small blind $0.25
XFa6sBGjP2gxoIvxR3fZIg: posts big blind $0.50
*** HOLE CARDS ***
5IBeOgaApY1Bvzv2P8X4EA said, "jajajajajaj"
5IBeOgaApY1Bvzv2P8X4EA: folds
XFa6sBGjP2gxoIvxR3fZIg collected $0.50 from pot
XFa6sBGjP2gxoIvxR3fZIg said, "heh"
*** SUMMARY ***
Total pot $0.50 | Rake $0
Seat 1: XFa6sBGjP2gxoIvxR3fZIg (big blind) collected ($0.50)
Seat 2: 5IBeOgaApY1Bvzv2P8X4EA (button) (small blind) folded before Flop



PokerStars Game #59939801564:  Hold'em No Limit ($0.25/$0.50) - 2009/07/01 0:49:18 ET
Table 'eMxdLyFDf28E0wit6gm3Uw' 6-max Seat #3 is the button
Seat 1: GtdWeBVCZhDBcNFRTOb8Hg ($3.10 in chips)
Seat 3: dZcLsEI8iXkobBduRJ45Yw ($10.55 in chips)
Seat 4: 3jxEWvv2qK1HCXLj4khowQ ($42.30 in chips)
Seat 5: X0X97o2fDAPiGx6o1gahsw ($76.10 in chips)
Seat 6: nOfdMHEXflgT86UgFWblAA ($50.50 in chips)
3jxEWvv2qK1HCXLj4khowQ: posts small blind $0.25
X0X97o2fDAPiGx6o1gahsw: posts big blind $0.50
*** HOLE CARDS ***
nOfdMHEXflgT86UgFWblAA: folds
GtdWeBVCZhDBcNFRTOb8Hg: folds
dZcLsEI8iXkobBduRJ45Yw: folds
3jxEWvv2qK1HCXLj4khowQ: raises $1 to $1.50
X0X97o2fDAPiGx6o1gahsw: folds
3jxEWvv2qK1HCXLj4khowQ collected $1 from pot
*** SUMMARY ***
Total pot $1 | Rake $0
Seat 1: GtdWeBVCZhDBcNFRTOb8Hg folded before Flop (didn't bet)
Seat 3: dZcLsEI8iXkobBduRJ45Yw (button) folded before Flop (didn't bet)
Seat 4: 3jxEWvv2qK1HCXLj4khowQ (small blind) collected ($1)
Seat 5: X0X97o2fDAPiGx6o1gahsw (big blind) folded before Flop
Seat 6: nOfdMHEXflgT86UgFWblAA folded before Flop (didn't bet)



PokerStars Game #59939802772:  Hold'em No Limit ($0.25/$0.50) - 2009/07/01 0:49:20 ET
Table 'E7bWJ45aoFXRpyRv2gw+Ig' 2-max Seat #2 is the button
Seat 1: FRkiRasEGlHUeLrEl+k/nA ($88.25 in chips)
Seat 2: 3Wro85I7472vJ4Wkpneo9A ($105.30 in chips)
3Wro85I7472vJ4Wkpneo9A: posts small blind $0.25
FRkiRasEGlHUeLrEl+k/nA: posts big blind $0.50
*** HOLE CARDS ***
3Wro85I7472vJ4Wkpneo9A: raises $1 to $1.50
FRkiRasEGlHUeLrEl+k/nA: folds
3Wro85I7472vJ4Wkpneo9A collected $1 from pot
3Wro85I7472vJ4Wkpneo9A: doesn't show hand
*** SUMMARY ***
Total pot $1 | Rake $0
Seat 1: FRkiRasEGlHUeLrEl+k/nA (big blind) folded before Flop
Seat 2: 3Wro85I7472vJ4Wkpneo9A (button) (small blind) collected ($1)



PokerStars Game #59939803748:  Hold'em No Limit ($0.25/$0.50) - 2009/07/01 0:49:22 ET
Table 'QOeVnLhwctF9UyV/beDi+A' 2-max Seat #2 is the button
Seat 1: bypIyrYcAAifLfhZpGlKLA ($70.60 in chips)
Seat 2: Ucrm3XtZmoONapW32SPhag ($11.35 in chips)
Ucrm3XtZmoONapW32SPhag: posts small blind $0.25
bypIyrYcAAifLfhZpGlKLA: posts big blind $0.50
*** HOLE CARDS ***
Ucrm3XtZmoONapW32SPhag: calls $0.25
bypIyrYcAAifLfhZpGlKLA: checks
*** FLOP *** [3h 9c Kh]
bypIyrYcAAifLfhZpGlKLA: bets $1
Ucrm3XtZmoONapW32SPhag: folds
bypIyrYcAAifLfhZpGlKLA collected $0.95 from pot
bypIyrYcAAifLfhZpGlKLA: doesn't show hand
*** SUMMARY ***
Total pot $1 | Rake $0.05
Board [3h 9c Kh]
Seat 1: bypIyrYcAAifLfhZpGlKLA (big blind) collected ($0.95)
Seat 2: Ucrm3XtZmoONapW32SPhag (button) (small blind) folded on the Flop



PokerStars Game #59939806032:  Hold'em No Limit ($0.25/$0.50) - 2009/07/01 0:49:25 ET
Table '37qXEp3oe+er5q4CZip9eQ' 6-max Seat #5 is the button
Seat 1: oqOqoO2AyCZenUghCxMDxw ($57.65 in chips)
Seat 2: 6wzJiRvp8HY6t+MQGnSIzA ($26.50 in chips)
Seat 3: Rt6KgtZ8YaJoTc3FPim00w ($100.35 in chips)
Seat 4: XsmE8nXMAAMFJbWaJTmHFw ($29.30 in chips)
Seat 5: VOmI0x4dDPnTESZd5B4d1Q ($38.90 in chips)
Seat 6: N50kln4negd8q7Mmoz1j4g ($24 in chips)
N50kln4negd8q7Mmoz1j4g: posts small blind $0.25
oqOqoO2AyCZenUghCxMDxw: posts big blind $0.50
*** HOLE CARDS ***
6wzJiRvp8HY6t+MQGnSIzA: folds
Rt6KgtZ8YaJoTc3FPim00w: folds
XsmE8nXMAAMFJbWaJTmHFw: folds
VOmI0x4dDPnTESZd5B4d1Q: calls $0.50
N50kln4negd8q7Mmoz1j4g: calls $0.25
oqOqoO2AyCZenUghCxMDxw: checks
*** FLOP *** [3h Jh 9s]
N50kln4negd8q7Mmoz1j4g: checks
oqOqoO2AyCZenUghCxMDxw: checks
VOmI0x4dDPnTESZd5B4d1Q: bets $1
N50kln4negd8q7Mmoz1j4g: calls $1
oqOqoO2AyCZenUghCxMDxw: folds
*** TURN *** [3h Jh 9s] [As]
N50kln4negd8q7Mmoz1j4g: checks
VOmI0x4dDPnTESZd5B4d1Q: bets $3.20
N50kln4negd8q7Mmoz1j4g: calls $3.20
*** RIVER *** [3h Jh 9s As] [4s]
N50kln4negd8q7Mmoz1j4g: checks
VOmI0x4dDPnTESZd5B4d1Q: bets $3.20
N50kln4negd8q7Mmoz1j4g: folds
VOmI0x4dDPnTESZd5B4d1Q collected $9.45 from pot
*** SUMMARY ***
Total pot $9.90 | Rake $0.45
Board [3h Jh 9s As 4s]
Seat 1: oqOqoO2AyCZenUghCxMDxw (big blind) folded on the Flop
Seat 2: 6wzJiRvp8HY6t+MQGnSIzA folded before Flop (didn't bet)
Seat 3: Rt6KgtZ8YaJoTc3FPim00w folded before Flop (didn't bet)
Seat 4: XsmE8nXMAAMFJbWaJTmHFw folded before Flop (didn't bet)
Seat 5: VOmI0x4dDPnTESZd5B4d1Q (button) collected ($9.45)
Seat 6: N50kln4negd8q7Mmoz1j4g (small blind) folded on the River



PokerStars Game #59939806624:  Hold'em No Limit ($0.25/$0.50) - 2009/07/01 0:49:26 ET
Table '+dXkOAQyS8j9PQZusUTMpg' 2-max Seat #1 is the button
Seat 1: XFa6sBGjP2gxoIvxR3fZIg ($62.35 in chips)
Seat 2: 5IBeOgaApY1Bvzv2P8X4EA ($140.05 in chips)
XFa6sBGjP2gxoIvxR3fZIg: posts small blind $0.25
5IBeOgaApY1Bvzv2P8X4EA: posts big blind $0.50
*** HOLE CARDS ***
XFa6sBGjP2gxoIvxR3fZIg: raises $1 to $1.50
5IBeOgaApY1Bvzv2P8X4EA: calls $1
*** FLOP *** [Ad 2h 7h]
5IBeOgaApY1Bvzv2P8X4EA: checks
XFa6sBGjP2gxoIvxR3fZIg: bets $2
5IBeOgaApY1Bvzv2P8X4EA: folds
XFa6sBGjP2gxoIvxR3fZIg collected $2.85 from pot
XFa6sBGjP2gxoIvxR3fZIg: doesn't show hand
*** SUMMARY ***
Total pot $3 | Rake $0.15
Board [Ad 2h 7h]
Seat 1: XFa6sBGjP2gxoIvxR3fZIg (button) (small blind) collected ($2.85)
Seat 2: 5IBeOgaApY1Bvzv2P8X4EA (big blind) folded on the Flop



PokerStars Game #59939806414:  Hold'em No Limit ($0.25/$0.50) - 2009/07/01 0:49:26 ET
Table 'QOgaEqMcJ73pcUMMxoisUg' 6-max Seat #4 is the button
Seat 1: /olYG0EzMWzADIgH1y2ySQ ($27.75 in chips)
Seat 2: 4QfsCWthT/vSLirorNXqtg ($50 in chips)
Seat 3: Rt6KgtZ8YaJoTc3FPim00w ($95.55 in chips)
Seat 4: zAcsDhG/T128Vn7XGVSgKg ($50.85 in chips)
Seat 5: 6vNxrjjCl6FwfaaymM9jjg ($19.95 in chips)
6vNxrjjCl6FwfaaymM9jjg: posts small blind $0.25
/olYG0EzMWzADIgH1y2ySQ: posts big blind $0.50
*** HOLE CARDS ***
4QfsCWthT/vSLirorNXqtg: raises $1.50 to $2
Rt6KgtZ8YaJoTc3FPim00w: folds
GoVjFxr3C+JO9vtJH9+IcA joins the table at seat #6
zAcsDhG/T128Vn7XGVSgKg: folds
6vNxrjjCl6FwfaaymM9jjg: calls $1.75
/olYG0EzMWzADIgH1y2ySQ: calls $1.50
*** FLOP *** [2h Kd 8h]
6vNxrjjCl6FwfaaymM9jjg: checks
/olYG0EzMWzADIgH1y2ySQ: checks
4QfsCWthT/vSLirorNXqtg: bets $4.25
6vNxrjjCl6FwfaaymM9jjg: calls $4.25
/olYG0EzMWzADIgH1y2ySQ: folds
*** TURN *** [2h Kd 8h] [3s]
6vNxrjjCl6FwfaaymM9jjg: checks
4QfsCWthT/vSLirorNXqtg: checks
*** RIVER *** [2h Kd 8h 3s] [6s]
6vNxrjjCl6FwfaaymM9jjg: bets $5
4QfsCWthT/vSLirorNXqtg: calls $5
*** SHOW DOWN ***
6vNxrjjCl6FwfaaymM9jjg: shows [8c 8d] (three of a kind, Eights)
4QfsCWthT/vSLirorNXqtg: mucks hand
6vNxrjjCl6FwfaaymM9jjg collected $23.35 from pot
*** SUMMARY ***
Total pot $24.50 | Rake $1.15
Board [2h Kd 8h 3s 6s]
Seat 1: /olYG0EzMWzADIgH1y2ySQ (big blind) folded on the Flop
Seat 2: 4QfsCWthT/vSLirorNXqtg mucked
Seat 3: Rt6KgtZ8YaJoTc3FPim00w folded before Flop (didn't bet)
Seat 4: zAcsDhG/T128Vn7XGVSgKg (button) folded before Flop (didn't bet)
Seat 5: 6vNxrjjCl6FwfaaymM9jjg (small blind) showed [8c 8d] and won ($23.35) with three of a kind, Eights



PokerStars Game #59939806582:  Hold'em No Limit ($0.25/$0.50) - 2009/07/01 0:49:26 ET
Table 'lpxYasB1ClBSgTpCCITwhQ' 9-max Seat #1 is the button
Seat 1: mj7PS7wCH4PAl7+eYTFs7A ($47.15 in chips)
Seat 2: OWP/DOu+PlPK6ZZ3zYa0HA ($25.35 in chips)
Seat 3: cDNz32Scry3j+v2+kE3pHg ($50 in chips)
Seat 4: o4Jr+EJ272Vq/p5v7ZCBYA ($38.40 in chips)
Seat 5: IYd5zG8k7vdBNVHbHg2Pag ($36.60 in chips)
Seat 6: SegjDnMxWMujiD57ESNL+g ($7 in chips)
Seat 7: bmRtaIYKthN1F+B3JLZ3Jw ($20.70 in chips)
Seat 8: V+ivdLiYYuNr+thEXNextg ($33.50 in chips)
Seat 9: XNMDwbXt/Q4jM99AXnbJDw ($50 in chips)
OWP/DOu+PlPK6ZZ3zYa0HA: posts small blind $0.25
cDNz32Scry3j+v2+kE3pHg: posts big blind $0.50
*** HOLE CARDS ***
o4Jr+EJ272Vq/p5v7ZCBYA: calls $0.50
IYd5zG8k7vdBNVHbHg2Pag: folds
SegjDnMxWMujiD57ESNL+g: folds
bmRtaIYKthN1F+B3JLZ3Jw: folds
V+ivdLiYYuNr+thEXNextg: folds
XNMDwbXt/Q4jM99AXnbJDw: folds
mj7PS7wCH4PAl7+eYTFs7A: folds
OWP/DOu+PlPK6ZZ3zYa0HA: calls $0.25
cDNz32Scry3j+v2+kE3pHg: checks
*** FLOP *** [7h Ah 8d]
OWP/DOu+PlPK6ZZ3zYa0HA: checks
cDNz32Scry3j+v2+kE3pHg: bets $1
o4Jr+EJ272Vq/p5v7ZCBYA: calls $1
OWP/DOu+PlPK6ZZ3zYa0HA: folds
*** TURN *** [7h Ah 8d] [Ks]
cDNz32Scry3j+v2+kE3pHg: checks
o4Jr+EJ272Vq/p5v7ZCBYA: bets $2
cDNz32Scry3j+v2+kE3pHg: calls $2
*** RIVER *** [7h Ah 8d Ks] [4c]
cDNz32Scry3j+v2+kE3pHg: checks
o4Jr+EJ272Vq/p5v7ZCBYA: bets $5
cDNz32Scry3j+v2+kE3pHg: folds
o4Jr+EJ272Vq/p5v7ZCBYA collected $7.15 from pot
*** SUMMARY ***
Total pot $7.50 | Rake $0.35
Board [7h Ah 8d Ks 4c]
Seat 1: mj7PS7wCH4PAl7+eYTFs7A (button) folded before Flop (didn't bet)
Seat 2: OWP/DOu+PlPK6ZZ3zYa0HA (small blind) folded on the Flop
Seat 3: cDNz32Scry3j+v2+kE3pHg (big blind) folded on the River
Seat 4: o4Jr+EJ272Vq/p5v7ZCBYA collected ($7.15)
Seat 5: IYd5zG8k7vdBNVHbHg2Pag folded before Flop (didn't bet)
Seat 6: SegjDnMxWMujiD57ESNL+g folded before Flop (didn't bet)
Seat 7: bmRtaIYKthN1F+B3JLZ3Jw folded before Flop (didn't bet)
Seat 8: V+ivdLiYYuNr+thEXNextg folded before Flop (didn't bet)
Seat 9: XNMDwbXt/Q4jM99AXnbJDw folded before Flop (didn't bet)



PokerStars Game #59939808194:  Hold'em No Limit ($0.25/$0.50) - 2009/07/01 0:49:29 ET
Table 'E7bWJ45aoFXRpyRv2gw+Ig' 2-max Seat #1 is the button
Seat 1: FRkiRasEGlHUeLrEl+k/nA ($87.75 in chips)
Seat 2: 3Wro85I7472vJ4Wkpneo9A ($105.80 in chips)
FRkiRasEGlHUeLrEl+k/nA: posts small blind $0.25
3Wro85I7472vJ4Wkpneo9A: posts big blind $0.50
*** HOLE CARDS ***
FRkiRasEGlHUeLrEl+k/nA: folds
3Wro85I7472vJ4Wkpneo9A collected $0.50 from pot
3Wro85I7472vJ4Wkpneo9A: doesn't show hand
*** SUMMARY ***
Total pot $0.50 | Rake $0
Seat 1: FRkiRasEGlHUeLrEl+k/nA (button) (small blind) folded before Flop
Seat 2: 3Wro85I7472vJ4Wkpneo9A (big blind) collected ($0.50)



PokerStars Game #59939808534:  Hold'em No Limit ($0.25/$0.50) - 2009/07/01 0:49:29 ET
Table 'lSisgp6H7Fg1hH5VfjEjYQ' 9-max Seat #9 is the button
Seat 1: 5k9fvXD9suIgCxU4HLQjTw ($50 in chips)
Seat 2: UrcnkQOiLVk8BlKDPJSy7Q ($78.35 in chips)
Seat 3: aTkyjTh3w5YLWiIERupZOA ($51.95 in chips)
Seat 4: bwv/rbH/hHhPhY6u9mu04w ($34.85 in chips)
Seat 5: mSD1pginDsyHG5PDfqzphw ($11.35 in chips)
Seat 7: Y3DZ6qQlLeBhixDj4M9vmg ($9.30 in chips)
Seat 8: a4JDWmpFQkL10XfAyuF51A ($30.50 in chips)
Seat 9: gsyXT42WLEcOS4DdEk2wlw ($30.85 in chips)
5k9fvXD9suIgCxU4HLQjTw: posts small blind $0.25
UrcnkQOiLVk8BlKDPJSy7Q: posts big blind $0.50
*** HOLE CARDS ***
aTkyjTh3w5YLWiIERupZOA: folds
+k7T5ocke8UwavtgUHm+Cg has returned
bwv/rbH/hHhPhY6u9mu04w: folds
mSD1pginDsyHG5PDfqzphw: folds
Y3DZ6qQlLeBhixDj4M9vmg: raises $1 to $1.50
a4JDWmpFQkL10XfAyuF51A: folds
gsyXT42WLEcOS4DdEk2wlw: folds
5k9fvXD9suIgCxU4HLQjTw: folds
UrcnkQOiLVk8BlKDPJSy7Q: folds
Y3DZ6qQlLeBhixDj4M9vmg collected $1.25 from pot
*** SUMMARY ***
Total pot $1.25 | Rake $0
Seat 1: 5k9fvXD9suIgCxU4HLQjTw (small blind) folded before Flop
Seat 2: UrcnkQOiLVk8BlKDPJSy7Q (big blind) folded before Flop
Seat 3: aTkyjTh3w5YLWiIERupZOA folded before Flop (didn't bet)
Seat 4: bwv/rbH/hHhPhY6u9mu04w folded before Flop (didn't bet)
Seat 5: mSD1pginDsyHG5PDfqzphw folded before Flop (didn't bet)
Seat 7: Y3DZ6qQlLeBhixDj4M9vmg collected ($1.25)
Seat 8: a4JDWmpFQkL10XfAyuF51A folded before Flop (didn't bet)
Seat 9: gsyXT42WLEcOS4DdEk2wlw (button) folded before Flop (didn't bet)



PokerStars Game #59939810546:  Hold'em No Limit ($0.25/$0.50) - 2009/07/01 0:49:33 ET
Table '0eJtgVAXVvBgncFdcUpXcQ' 2-max Seat #2 is the button
Seat 1: Ag6DvxX4vbRheqsv2zXKTQ ($39.15 in chips)
Seat 2: KMc4R+K9ao4Ur3rF7NGe6Q ($13.55 in chips)
KMc4R+K9ao4Ur3rF7NGe6Q: posts small blind $0.25
Ag6DvxX4vbRheqsv2zXKTQ: posts big blind $0.50
*** HOLE CARDS ***
KMc4R+K9ao4Ur3rF7NGe6Q said, "ouch"
KMc4R+K9ao4Ur3rF7NGe6Q said, "nh"
KMc4R+K9ao4Ur3rF7NGe6Q: raises $2 to $2.50
Ag6DvxX4vbRheqsv2zXKTQ said, "wow"
Ag6DvxX4vbRheqsv2zXKTQ said, "sick"
Ag6DvxX4vbRheqsv2zXKTQ: folds
KMc4R+K9ao4Ur3rF7NGe6Q said, "yeh"
KMc4R+K9ao4Ur3rF7NGe6Q collected $1 from pot
Ag6DvxX4vbRheqsv2zXKTQ said, "bad river for u"
KMc4R+K9ao4Ur3rF7NGe6Q: doesn't show hand
*** SUMMARY ***
Total pot $1 | Rake $0
Seat 1: Ag6DvxX4vbRheqsv2zXKTQ (big blind) folded before Flop
Seat 2: KMc4R+K9ao4Ur3rF7NGe6Q (button) (small blind) collected ($1)



PokerStars Game #59939810654:  Hold'em No Limit ($0.25/$0.50) - 2009/07/01 0:49:33 ET
Table '99gCy/CZQwPIjZWH+BguQgE7bWJ45aoFXRpyRv2gw+Igeat #4 is the button
Seat 2: n6VQBu6crjYjy6DxNP1NZA ($30.50 in chips)
Seat 3: qEn9ijNGtuyTxamBf07hYg ($50 in chips)
Seat 4: bxLSulbgr8LmKNjOzw8URg ($61.45 in chips)
Seat 5: DSM67hHHq1XFoEOi9p8Alw ($47.75 in chips)
Seat 7: bfSq6LBw0UvxeM5yfuWC7w ($18.60 in chips)
Seat 8: 8ehL7qlZzjgUh2H35iiWLw ($50 in chips)
Seat 9: j3K/Jujr7PY4ZM2RZvlH6A ($88.15 in chips)
DSM67hHHq1XFoEOi9p8Alw: posts small blind $0.25
bfSq6LBw0UvxeM5yfuWC7w: posts big blind $0.50
*** HOLE CARDS ***
8ehL7qlZzjgUh2H35iiWLw: folds
j3K/Jujr7PY4ZM2RZvlH6A: raises $1 to $1.50
n6VQBu6crjYjy6DxNP1NZA: folds
qEn9ijNGtuyTxamBf07hYg: raises $3.50 to $5
bxLSulbgr8LmKNjOzw8URg: folds
DSM67hHHq1XFoEOi9p8Alw: folds
bfSq6LBw0UvxeM5yfuWC7w: folds
j3K/Jujr7PY4ZM2RZvlH6A: raises $9 to $14
qEn9ijNGtuyTxamBf07hYg: folds
j3K/Jujr7PY4ZM2RZvlH6A collected $10.75 from pot
j3K/Jujr7PY4ZM2RZvlH6A: doesn't show hand
*** SUMMARY ***
Total pot $10.75 | Rake $0
Seat 2: n6VQBu6crjYjy6DxNP1NZA folded before Flop (didn't bet)
Seat 3: qEn9ijNGtuyTxamBf07hYg folded before Flop
Seat 4: bxLSulbgr8LmKNjOzw8URg (button) folded before Flop (didn't bet)
Seat 5: DSM67hHHq1XFoEOi9p8Alw (small blind) folded before Flop
Seat 7: bfSq6LBw0UvxeM5yfuWC7w (big blind) folded before Flop
Seat 8: 8ehL7qlZzjgUh2H35iiWLw folded before Flop (didn't bet)
Seat 9: j3K/Jujr7PY4ZM2RZvlH6A collected ($10.75)



PokerStars Game #59939813484:  Hold'em No Limit ($0.25/$0.50) - 2009/07/01 0:49:37 ET
Table 'EiNh8p/wGJ1FP575iMFnqg' 9-max Seat #3 is the button
Seat 1: r3ZqM1Mi0W3y4hOdssE+Sg ($45.85 in chips)
Seat 2: 8ehL7qlZzjgUh2H35iiWLw ($52.60 in chips)
Seat 3: ymLPoEIl7UL3TvZYmnadxQ ($52.35 in chips)
Seat 4: cMzaiXAM/ZAdNaEUu+LqhA ($55.20 in chips)
Seat 5: M+7+BTmX5vZatHVuoRB1nA ($79.30 in chips)
Seat 6: 3UmXLy3GfjC3EkOebduerQ ($66.85 in chips)
Seat 7: 997ViqAtWn1FPjJqcffwcA ($50 in chips)
Seat 9: NnQCepdIR/AOUQn1yhYx6Q ($9.25 in chips)
cMzaiXAM/ZAdNaEUu+LqhA: posts small blind $0.25
M+7+BTmX5vZatHVuoRB1nA: posts big blind $0.50
mSD1pginDsyHG5PDfqzphw: sits out
*** HOLE CARDS ***
3UmXLy3GfjC3EkOebduerQ: folds
997ViqAtWn1FPjJqcffwcA: folds
NnQCepdIR/AOUQn1yhYx6Q: folds
r3ZqM1Mi0W3y4hOdssE+Sg: folds
8ehL7qlZzjgUh2H35iiWLw: folds
ymLPoEIl7UL3TvZYmnadxQ: raises $1 to $1.50
cMzaiXAM/ZAdNaEUu+LqhA: folds
M+7+BTmX5vZatHVuoRB1nA: raises $4 to $5.50
ymLPoEIl7UL3TvZYmnadxQ: folds
M+7+BTmX5vZatHVuoRB1nA collected $3.25 from pot
M+7+BTmX5vZatHVuoRB1nA: doesn't show hand
*** SUMMARY ***
Total pot $3.25 | Rake $0
Seat 1: r3ZqM1Mi0W3y4hOdssE+Sg folded before Flop (didn't bet)
Seat 2: 8ehL7qlZzjgUh2H35iiWLw folded before Flop (didn't bet)
Seat 3: ymLPoEIl7UL3TvZYmnadxQ (button) folded before Flop
Seat 4: cMzaiXAM/ZAdNaEUu+LqhA (small blind) folded before Flop
Seat 5: M+7+BTmX5vZatHVuoRB1nA (big blind) collected ($3.25)
Seat 6: 3UmXLy3GfjC3EkOebduerQ folded before Flop (didn't bet)
Seat 7: 997ViqAtWn1FPjJqcffwcA folded before Flop (didn't bet)
Seat 9: NnQCepdIR/AOUQn1yhYx6Q folded before Flop (didn't bet)



PokerStars Game #59939813970:  Hold'em No Limit ($0.25/$0.50) - 2009/07/01 0:49:38 ET
Table 'GfL/No5u5PoEnU39lP5pQg' 6-max Seat #2 is the button
Seat 1: 1WUCqNG+p+vfWRTXNu4ljw ($60.75 in chips)
Seat 2: uVwggSetzp7d+eVgowO3vg ($64.20 in chips)
Seat 3: Ek4w9XqBXqK5jBUQeLedGw ($50.25 in chips)
Seat 4: r6u7MWSXF30/khcTYkrG9Q ($25.40 in chips)
Seat 5: M1KyQQvVPVuxqTAB8sR/zQ ($53 in chips)
Ek4w9XqBXqK5jBUQeLedGw: posts small blind $0.25
r6u7MWSXF30/khcTYkrG9Q: posts big blind $0.50
kxPhs4ePFqMy52CInAJ2aw: sits out
*** HOLE CARDS ***
M1KyQQvVPVuxqTAB8sR/zQ: folds
1WUCqNG+p+vfWRTXNu4ljw: folds
uVwggSetzp7d+eVgowO3vg: raises $1 to $1.50
Ek4w9XqBXqK5jBUQeLedGw: folds
r6u7MWSXF30/khcTYkrG9Q: folds
uVwggSetzp7d+eVgowO3vg collected $1.25 from pot
*** SUMMARY ***
Total pot $1.25 | Rake $0
Seat 1: 1WUCqNG+p+vfWRTXNu4ljw folded before Flop (didn't bet)
Seat 2: uVwggSetzp7d+eVgowO3vg (button) collected ($1.25)
Seat 3: Ek4w9XqBXqK5jBUQeLedGw (small blind) folded before Flop
Seat 4: r6u7MWSXF30/khcTYkrG9Q (big blind) folded before Flop
Seat 5: M1KyQQvVPVuxqTAB8sR/zQ folded before Flop (didn't bet)



PokerStars Game #59939814516:  Hold'em No Limit ($0.25/$0.50) - 2009/07/01 0:49:39 ET
Table 'eMxdLyFDf28E0wit6gm3Uw' 6-max Seat #4 is the button
Seat 1: GtdWeBVCZhDBcNFRTOb8Hg ($3.10 in chips)
Seat 3: dZcLsEI8iXkobBduRJ45Yw ($10.55 in chips)
Seat 4: 3jxEWvv2qK1HCXLj4khowQ ($42.80 in chips)
Seat 5: X0X97o2fDAPiGx6o1gahsw ($75.60 in chips)
Seat 6: nOfdMHEXflgT86UgFWblAA ($50.50 in chips)
X0X97o2fDAPiGx6o1gahsw: posts small blind $0.25
nOfdMHEXflgT86UgFWblAA: posts big blind $0.50
*** HOLE CARDS ***
GtdWeBVCZhDBcNFRTOb8Hg: calls $0.50
dZcLsEI8iXkobBduRJ45Yw: raises $1 to $1.50
3jxEWvv2qK1HCXLj4khowQ: folds
X0X97o2fDAPiGx6o1gahsw: folds
nOfdMHEXflgT86UgFWblAA: folds
GtdWeBVCZhDBcNFRTOb8Hg: raises $1 to $2.50
dZcLsEI8iXkobBduRJ45Yw: raises $1 to $3.50
GtdWeBVCZhDBcNFRTOb8Hg: calls $0.60 and is all-in
*** FLOP *** [Js 2h 4h]
*** TURN *** [Js 2h 4h] [6s]
*** RIVER *** [Js 2h 4h 6s] [Qc]
*** SHOW DOWN ***
GtdWeBVCZhDBcNFRTOb8Hg: shows [6c 8c] (a pair of Sixes)
dZcLsEI8iXkobBduRJ45Yw: shows [Jd Jc] (three of a kind, Jacks)
dZcLsEI8iXkobBduRJ45Yw collected $6.65 from pot
*** SUMMARY ***
Total pot $6.95 | Rake $0.30
Board [Js 2h 4h 6s Qc]
Seat 1: GtdWeBVCZhDBcNFRTOb8Hg showed [6c 8c] and lost with a pair of Sixes
Seat 3: dZcLsEI8iXkobBduRJ45Yw showed [Jd Jc] and won ($6.65) with three of a kind, Jacks
Seat 4: 3jxEWvv2qK1HCXLj4khowQ (button) folded before Flop (didn't bet)
Seat 5: X0X97o2fDAPiGx6o1gahsw (small blind) folded before Flop
Seat 6: nOfdMHEXflgT86UgFWblAA (big blind) folded before Flop



PokerStars Game #59939814750:  Hold'em No Limit ($0.25/$0.50) - 2009/07/01 0:49:39 ET
Table 'fx6MqwfYAj/Rt86hBz2L3Q' 9-max Seat #8 is the button
Seat 1: SegjDnMxWMujiD57ESNL+g ($10 in chips)
Seat 3: iadBi5AEt7gTBXbDSSnMYQ ($48.20 in chips)
Seat 4: gPEN9Zp33YTm/mu9/SYP1w ($23.30 in chips)
Seat 5: iAISe3dVeua8PUn2wwgDHw ($34.50 in chips)
Seat 6: 5k9fvXD9suIgCxU4HLQjTw ($50 in chips)
Seat 7: SKnJuWHScqetA/qG5p+wCg ($30 in chips)
Seat 8: JYwJYYV9pM5KWdSiETl8rA ($29.25 in chips)
Seat 9: HZkVla4kK2SI42CVrPZ/ig ($11.25 in chips)
HZkVla4kK2SI42CVrPZ/ig: posts small blind $0.25
SegjDnMxWMujiD57ESNL+g: posts big blind $0.50
*** HOLE CARDS ***
iadBi5AEt7gTBXbDSSnMYQ: folds
gPEN9Zp33YTm/mu9/SYP1w: folds
iAISe3dVeua8PUn2wwgDHw: folds
5k9fvXD9suIgCxU4HLQjTw: raises $1 to $1.50
SKnJuWHScqetA/qG5p+wCg: folds
JYwJYYV9pM5KWdSiETl8rA: folds
HZkVla4kK2SI42CVrPZ/ig: folds
SegjDnMxWMujiD57ESNL+g: folds
5k9fvXD9suIgCxU4HLQjTw collected $1.25 from pot
5k9fvXD9suIgCxU4HLQjTw: doesn't show hand
*** SUMMARY ***
Total pot $1.25 | Rake $0
Seat 1: SegjDnMxWMujiD57ESNL+g (big blind) folded before Flop
Seat 3: iadBi5AEt7gTBXbDSSnMYQ folded before Flop (didn't bet)
Seat 4: gPEN9Zp33YTm/mu9/SYP1w folded before Flop (didn't bet)
Seat 5: iAISe3dVeua8PUn2wwgDHw folded before Flop (didn't bet)
Seat 6: 5k9fvXD9suIgCxU4HLQjTw collected ($1.25)
Seat 7: SKnJuWHScqetA/qG5p+wCg folded before Flop (didn't bet)
Seat 8: JYwJYYV9pM5KWdSiETl8rA (button) folded before Flop (didn't bet)
Seat 9: HZkVla4kK2SI42CVrPZ/ig (small blind) folded before Flop



PokerStars Game #59939814908:  Hold'em No Limit ($0.25/$0.50) - 2009/07/01 0:49:39 ET
Table 'BCN5su+SsXiy1zRMJi0SJw' 6-max Seat #5 is the button
Seat 1: GxXV09ciXaOxyY2H5aMIIw ($29.50 in chips)
Seat 2: oU2kDCkT/gilYbHWrg7D8w ($31.50 in chips)
Seat 3: g+vwI6lMKpU2uteXSjOzVw ($16.85 in chips)
Seat 4: JY9CtoZTeav+mhWyxSSyJQ ($25.85 in chips)
Seat 5: IBNygaT1aa9Z1uPdJJilwA ($13.05 in chips)
Seat 6: b2symlOdL7+0c9Pj4N/KlA ($83.20 in chips)
b2symlOdL7+0c9Pj4N/KlA: posts small blind $0.25
GxXV09ciXaOxyY2H5aMIIw: posts big blind $0.50
*** HOLE CARDS ***
oU2kDCkT/gilYbHWrg7D8w: folds
g+vwI6lMKpU2uteXSjOzVw: calls $0.50
JY9CtoZTeav+mhWyxSSyJQ: folds
IBNygaT1aa9Z1uPdJJilwA: folds
b2symlOdL7+0c9Pj4N/KlA: folds
GxXV09ciXaOxyY2H5aMIIw: checks
*** FLOP *** [5h 3h Jh]
GxXV09ciXaOxyY2H5aMIIw: checks
g+vwI6lMKpU2uteXSjOzVw: checks
*** TURN *** [5h 3h Jh] [Ah]
GxXV09ciXaOxyY2H5aMIIw: checks
g+vwI6lMKpU2uteXSjOzVw: bets $1.50
GxXV09ciXaOxyY2H5aMIIw: folds
g+vwI6lMKpU2uteXSjOzVw collected $1.20 from pot
g+vwI6lMKpU2uteXSjOzVw: doesn't show hand
*** SUMMARY ***
Total pot $1.25 | Rake $0.05
Board [5h 3h Jh Ah]
Seat 1: GxXV09ciXaOxyY2H5aMIIw (big blind) folded on the Turn
Seat 2: oU2kDCkT/gilYbHWrg7D8w folded before Flop (didn't bet)
Seat 3: g+vwI6lMKpU2uteXSjOzVw collected ($1.20)
Seat 4: JY9CtoZTeav+mhWyxSSyJQ folded before Flop (didn't bet)
Seat 5: IBNygaT1aa9Z1uPdJJilwA (button) folded before Flop (didn't bet)
Seat 6: b2symlOdL7+0c9Pj4N/KlA (small blind) folded before Flop



PokerStars Game #59939814500:  Hold'em No Limit ($0.25/$0.50) - 2009/07/01 0:49:39 ET
Table 'QOeVnLhwctF9UyV/beDi+A' 2-max Seat #1 is the button
Seat 1: bypIyrYcAAifLfhZpGlKLA ($71.05 in chips)
Seat 2: Ucrm3XtZmoONapW32SPhag ($10.85 in chips)
bypIyrYcAAifLfhZpGlKLA: posts small blind $0.25
Ucrm3XtZmoONapW32SPhag: posts big blind $0.50
*** HOLE CARDS ***
bypIyrYcAAifLfhZpGlKLA: raises $0.50 to $1
Ucrm3XtZmoONapW32SPhag: calls $0.50
*** FLOP *** [4h Kd 2h]
Ucrm3XtZmoONapW32SPhag: checks
bypIyrYcAAifLfhZpGlKLA: bets $1.50
Ucrm3XtZmoONapW32SPhag: folds
bypIyrYcAAifLfhZpGlKLA collected $1.90 from pot
bypIyrYcAAifLfhZpGlKLA: doesn't show hand
*** SUMMARY ***
Total pot $2 | Rake $0.10
Board [4h Kd 2h]
Seat 1: bypIyrYcAAifLfhZpGlKLA (button) (small blind) collected ($1.90)
Seat 2: Ucrm3XtZmoONapW32SPhag (big blind) folded on the Flop



PokerStars Game #59939814968:  Hold'em No Limit ($0.25/$0.50) - 2009/07/01 0:49:40 ET
Table 'E7bWJ45aoFXRpyRv2gw+Ig' 2-max Seat #2 is the button
Seat 1: FRkiRasEGlHUeLrEl+k/nA ($87.50 in chips)
Seat 2: 3Wro85I7472vJ4Wkpneo9A ($106.05 in chips)
3Wro85I7472vJ4Wkpneo9A: posts small blind $0.25
FRkiRasEGlHUeLrEl+k/nA: posts big blind $0.50
*** HOLE CARDS ***
3Wro85I7472vJ4Wkpneo9A: folds
FRkiRasEGlHUeLrEl+k/nA collected $0.50 from pot
*** SUMMARY ***
Total pot $0.50 | Rake $0
Seat 1: FRkiRasEGlHUeLrEl+k/nA (big blind) collected ($0.50)
Seat 2: 3Wro85I7472vJ4Wkpneo9A (button) (small blind) folded before Flop



PokerStars Game #59939815234:  Hold'em No Limit ($0.25/$0.50) - 2009/07/01 0:49:40 ET
Table '+dXkOAQyS8j9PQZusUTMpg' 2-max Seat #2 is the button
Seat 1: XFa6sBGjP2gxoIvxR3fZIg ($63.70 in chips)
Seat 2: 5IBeOgaApY1Bvzv2P8X4EA ($138.55 in chips)
5IBeOgaApY1Bvzv2P8X4EA: posts small blind $0.25
XFa6sBGjP2gxoIvxR3fZIg: posts big blind $0.50
*** HOLE CARDS ***
5IBeOgaApY1Bvzv2P8X4EA: folds
XFa6sBGjP2gxoIvxR3fZIg collected $0.50 from pot
*** SUMMARY ***
Total pot $0.50 | Rake $0
Seat 1: XFa6sBGjP2gxoIvxR3fZIg (big blind) collected ($0.50)
Seat 2: 5IBeOgaApY1Bvzv2P8X4EA (button) (small blind) folded before Flop



PokerStars Game #59939816898:  Hold'em No Limit ($0.25/$0.50) - 2009/07/01 0:49:43 ET
Table '3FhG0gl3kMX3wBEEqj+wnQ' 9-max Seat #8 is the button
Seat 1: e0J9pdCNUDTCG031RnXqLA ($33.05 in chips)
Seat 2: 7cYQ+syUWjl38ty/ICOMhw ($50 in chips)
Seat 4: bjvJtA9Hqscfznq66txaOQ ($9.50 in chips)
Seat 5: gsyXT42WLEcOS4DdEk2wlw ($27.75 in chips)
Seat 6: 997ViqAtWn1FPjJqcffwcA ($50 in chips)
Seat 7: mSD1pginDsyHG5PDfqzphw ($10.25 in chips)
Seat 8: j3K/Jujr7PY4ZM2RZvlH6A ($61.45 in chips)
Seat 9: L5e2lrPLQm1Pqx30IIZ/Fw ($10 in chips)
L5e2lrPLQm1Pqx30IIZ/Fw: posts small blind $0.25
e0J9pdCNUDTCG031RnXqLA: posts big blind $0.50
*** HOLE CARDS ***
7cYQ+syUWjl38ty/ICOMhw: folds
bjvJtA9Hqscfznq66txaOQ: folds
gsyXT42WLEcOS4DdEk2wlw: folds
997ViqAtWn1FPjJqcffwcA: folds
mSD1pginDsyHG5PDfqzphw: folds
j3K/Jujr7PY4ZM2RZvlH6A: folds
L5e2lrPLQm1Pqx30IIZ/Fw: raises $0.50 to $1
e0J9pdCNUDTCG031RnXqLA: folds
L5e2lrPLQm1Pqx30IIZ/Fw collected $1 from pot
*** SUMMARY ***
Total pot $1 | Rake $0
Seat 1: e0J9pdCNUDTCG031RnXqLA (big blind) folded before Flop
Seat 2: 7cYQ+syUWjl38ty/ICOMhw folded before Flop (didn't bet)
Seat 4: bjvJtA9Hqscfznq66txaOQ folded before Flop (didn't bet)
Seat 5: gsyXT42WLEcOS4DdEk2wlw folded before Flop (didn't bet)
Seat 6: 997ViqAtWn1FPjJqcffwcA folded before Flop (didn't bet)
Seat 7: mSD1pginDsyHG5PDfqzphw folded before Flop (didn't bet)
Seat 8: j3K/Jujr7PY4ZM2RZvlH6A (button) folded before Flop (didn't bet)
Seat 9: L5e2lrPLQm1Pqx30IIZ/Fw (small blind) collected ($1)



PokerStars Game #59939817922:  Hold'em No Limit ($0.25/$0.50) - 2009/07/01 0:49:44 ET
Table '5EmHi+fnatGQQShcNmzOZQ' 6-max Seat #6 is the button
Seat 3: TjmTe3bhs9dFz5gXX9x7Lw ($28.75 in chips)
Seat 4: 1b+2BbjMN8qhR1WPqdE9VQ ($52.90 in chips)
Seat 5: kxPhs4ePFqMy52CInAJ2aw ($48.35 in chips)
Seat 6: 686aeHikcJlgKkSuIFdcXQ ($142.95 in chips)
TjmTe3bhs9dFz5gXX9x7Lw: posts small blind $0.25
1b+2BbjMN8qhR1WPqdE9VQ: posts big blind $0.50
*** HOLE CARDS ***
kxPhs4ePFqMy52CInAJ2aw: folds
686aeHikcJlgKkSuIFdcXQ: raises $1 to $1.50
TjmTe3bhs9dFz5gXX9x7Lw: calls $1.25
1b+2BbjMN8qhR1WPqdE9VQ: raises $5.50 to $7
686aeHikcJlgKkSuIFdcXQ: calls $5.50
TjmTe3bhs9dFz5gXX9x7Lw: folds
*** FLOP *** [6d Qc Ks]
1b+2BbjMN8qhR1WPqdE9VQ: bets $9.50
686aeHikcJlgKkSuIFdcXQ: folds
1b+2BbjMN8qhR1WPqdE9VQ collected $14.75 from pot
1b+2BbjMN8qhR1WPqdE9VQ: doesn't show hand
*** SUMMARY ***
Total pot $15.50 | Rake $0.75
Board [6d Qc Ks]
Seat 3: TjmTe3bhs9dFz5gXX9x7Lw (small blind) folded before Flop
Seat 4: 1b+2BbjMN8qhR1WPqdE9VQ (big blind) collected ($14.75)
Seat 5: kxPhs4ePFqMy52CInAJ2aw folded before Flop (didn't bet)
Seat 6: 686aeHikcJlgKkSuIFdcXQ (button) folded on the Flop



PokerStars Game #59939818630:  Hold'em No Limit ($0.25/$0.50) - 2009/07/01 0:49:45 ET
Table '+z1aekfHkpp09pc8F9aViw' 6-max Seat #4 is the button
Seat 1: FHilMb2i2DbUCc9lplszog ($39.35 in chips)
Seat 2: M6xK/VklCvdyyrmvzATlxQ ($35.25 in chips)
Seat 3: uUznlIMFnRUvwrBhYF73KA ($103.95 in chips)
Seat 4: RowCSpSURHTOL/dcjg/Iug ($49.05 in chips)
Seat 6: 686aeHikcJlgKkSuIFdcXQ ($68.25 in chips)
686aeHikcJlgKkSuIFdcXQ: posts small blind $0.25
FHilMb2i2DbUCc9lplszog: posts big blind $0.50
*** HOLE CARDS ***
M6xK/VklCvdyyrmvzATlxQ: folds
uUznlIMFnRUvwrBhYF73KA: raises $0.50 to $1
RowCSpSURHTOL/dcjg/Iug: folds
686aeHikcJlgKkSuIFdcXQ: calls $0.75
FHilMb2i2DbUCc9lplszog: calls $0.50
*** FLOP *** [5c Td Ad]
686aeHikcJlgKkSuIFdcXQ: bets $2.50
FHilMb2i2DbUCc9lplszog: folds
uUznlIMFnRUvwrBhYF73KA: raises $2.50 to $5
686aeHikcJlgKkSuIFdcXQ: calls $2.50
*** TURN *** [5c Td Ad] [5d]
686aeHikcJlgKkSuIFdcXQ: checks
uUznlIMFnRUvwrBhYF73KA: bets $9
686aeHikcJlgKkSuIFdcXQ: calls $9
*** RIVER *** [5c Td Ad 5d] [Tc]
686aeHikcJlgKkSuIFdcXQ: checks
uUznlIMFnRUvwrBhYF73KA: checks
*** SHOW DOWN ***
686aeHikcJlgKkSuIFdcXQ: shows [3h Ah] (two pair, Aces and Tens)
uUznlIMFnRUvwrBhYF73KA: shows [As Kd] (two pair, Aces and Tens - King kicker)
uUznlIMFnRUvwrBhYF73KA collected $29.50 from pot
*** SUMMARY ***
Total pot $31 | Rake $1.50
Board [5c Td Ad 5d Tc]
Seat 1: FHilMb2i2DbUCc9lplszog (big blind) folded on the Flop
Seat 2: M6xK/VklCvdyyrmvzATlxQ folded before Flop (didn't bet)
Seat 3: uUznlIMFnRUvwrBhYF73KA showed [As Kd] and won ($29.50) with two pair, Aces and Tens
Seat 4: RowCSpSURHTOL/dcjg/Iug (button) folded before Flop (didn't bet)
Seat 6: 686aeHikcJlgKkSuIFdcXQ (small blind) showed [3h Ah] and lost with two pair, Aces and Tens



PokerStars Game #59939819492:  Hold'em No Limit ($0.25/$0.50) - 2009/07/01 0:49:46 ET
Table '+dXkOAQyS8j9PQZusUTMpg' 2-max Seat #1 is the button
Seat 1: XFa6sBGjP2gxoIvxR3fZIg ($63.95 in chips)
Seat 2: 5IBeOgaApY1Bvzv2P8X4EA ($138.30 in chips)
XFa6sBGjP2gxoIvxR3fZIg: posts small blind $0.25
5IBeOgaApY1Bvzv2P8X4EA: posts big blind $0.50
*** HOLE CARDS ***
XFa6sBGjP2gxoIvxR3fZIg: raises $1 to $1.50
5IBeOgaApY1Bvzv2P8X4EA: folds
XFa6sBGjP2gxoIvxR3fZIg collected $1 from pot
XFa6sBGjP2gxoIvxR3fZIg: doesn't show hand
*** SUMMARY ***
Total pot $1 | Rake $0
Seat 1: XFa6sBGjP2gxoIvxR3fZIg (button) (small blind) collected ($1)
Seat 2: 5IBeOgaApY1Bvzv2P8X4EA (big blind) folded before Flop



PokerStars Game #59939820080:  Hold'em No Limit ($0.25/$0.50) - 2009/07/01 0:49:47 ET
Table '0eJtgVAXVvBgncFdcUpXcQ' 2-max Seat #1 is the button
Seat 1: Ag6DvxX4vbRheqsv2zXKTQ ($38.65 in chips)
Seat 2: KMc4R+K9ao4Ur3rF7NGe6Q ($14.05 in chips)
Ag6DvxX4vbRheqsv2zXKTQ: posts small blind $0.25
KMc4R+K9ao4Ur3rF7NGe6Q: posts big blind $0.50
*** HOLE CARDS ***
KMc4R+K9ao4Ur3rF7NGe6Q said, "lol"
Ag6DvxX4vbRheqsv2zXKTQ: calls $0.25
KMc4R+K9ao4Ur3rF7NGe6Q: checks
*** FLOP *** [Ts 2h 8s]
KMc4R+K9ao4Ur3rF7NGe6Q: checks
Ag6DvxX4vbRheqsv2zXKTQ: bets $1
KMc4R+K9ao4Ur3rF7NGe6Q: calls $1
*** TURN *** [Ts 2h 8s] [9s]
KMc4R+K9ao4Ur3rF7NGe6Q: bets $1.50
Ag6DvxX4vbRheqsv2zXKTQ: folds
KMc4R+K9ao4Ur3rF7NGe6Q collected $2.90 from pot
KMc4R+K9ao4Ur3rF7NGe6Q: doesn't show hand
*** SUMMARY ***
Total pot $3 | Rake $0.10
Board [Ts 2h 8s 9s]
Seat 1: Ag6DvxX4vbRheqsv2zXKTQ (button) (small blind) folded on the Turn
Seat 2: KMc4R+K9ao4Ur3rF7NGe6Q (big blind) collected ($2.90)



PokerStars Game #59939819636:  Hold'em No Limit ($0.25/$0.50) - 2009/07/01 0:49:47 ET
Table 'E7bWJ45aoFXRpyRv2gw+Ig' 2-max Seat #1 is the button
Seat 1: FRkiRasEGlHUeLrEl+k/nA ($87.75 in chips)
Seat 2: 3Wro85I7472vJ4Wkpneo9A ($105.80 in chips)
FRkiRasEGlHUeLrEl+k/nA: posts small blind $0.25
3Wro85I7472vJ4Wkpneo9A: posts big blind $0.50
*** HOLE CARDS ***
FRkiRasEGlHUeLrEl+k/nA: folds
3Wro85I7472vJ4Wkpneo9A collected $0.50 from pot
3Wro85I7472vJ4Wkpneo9A: doesn't show hand
*** SUMMARY ***
Total pot $0.50 | Rake $0
Seat 1: FRkiRasEGlHUeLrEl+k/nA (button) (small blind) folded before Flop
Seat 2: 3Wro85I7472vJ4Wkpneo9A (big blind) collected ($0.50)



PokerStars Game #59939821566:  Hold'em No Limit ($0.25/$0.50) - 2009/07/01 0:49:50 ET
Table 'NCiXr0d5CEKBQr/cZgLhbA' 9-max Seat #4 is the button
Seat 1: pFtzb1sR4b0d1aw6aIRgDg ($50 in chips)
Seat 2: ulxuJchBV9iguXg0FUonfg ($49.75 in chips)
Seat 3: xZCXQSXlrZkp3pZizzVXCw ($52.25 in chips)
Seat 4: 5k9fvXD9suIgCxU4HLQjTw ($55.95 in chips)
Seat 5: zE9cVigS2nW/Ljy4K4bUQA ($36.20 in chips)
Seat 6: SKnJuWHScqetA/qG5p+wCg ($32.95 in chips)
Seat 7: M+7+BTmX5vZatHVuoRB1nA ($47.10 in chips)
Seat 8: 1MJUKc3cc0QmUoz1JZLR2w ($59 in chips)
Seat 9: 4WLZvqBn5qv5tds5kt5A1Q ($45.80 in chips)
zE9cVigS2nW/Ljy4K4bUQA: posts small blind $0.25
SKnJuWHScqetA/qG5p+wCg: posts big blind $0.50
*** HOLE CARDS ***
M+7+BTmX5vZatHVuoRB1nA: folds
1MJUKc3cc0QmUoz1JZLR2w: folds
4WLZvqBn5qv5tds5kt5A1Q: raises $1.50 to $2
pFtzb1sR4b0d1aw6aIRgDg: folds
ulxuJchBV9iguXg0FUonfg: folds
xZCXQSXlrZkp3pZizzVXCw: folds
5k9fvXD9suIgCxU4HLQjTw: folds
zE9cVigS2nW/Ljy4K4bUQA: folds
SKnJuWHScqetA/qG5p+wCg: folds
4WLZvqBn5qv5tds5kt5A1Q collected $1.25 from pot
*** SUMMARY ***
Total pot $1.25 | Rake $0
Seat 1: pFtzb1sR4b0d1aw6aIRgDg folded before Flop (didn't bet)
Seat 2: ulxuJchBV9iguXg0FUonfg folded before Flop (didn't bet)
Seat 3: xZCXQSXlrZkp3pZizzVXCw folded before Flop (didn't bet)
Seat 4: 5k9fvXD9suIgCxU4HLQjTw (button) folded before Flop (didn't bet)
Seat 5: zE9cVigS2nW/Ljy4K4bUQA (small blind) folded before Flop
Seat 6: SKnJuWHScqetA/qG5p+wCg (big blind) folded before Flop
Seat 7: M+7+BTmX5vZatHVuoRB1nA folded before Flop (didn't bet)
Seat 8: 1MJUKc3cc0QmUoz1JZLR2w folded before Flop (didn't bet)
Seat 9: 4WLZvqBn5qv5tds5kt5A1Q collected ($1.25)



PokerStars Game #59939822160:  Hold'em No Limit ($0.25/$0.50) - 2009/07/01 0:49:51 ET
Table 'Vdlc9wqYcHTUhtdyN7CuJw' 2-max Seat #2 is the button
Seat 1: yBO+mXB6m/rCft2ErwGf/Q ($114.75 in chips)
Seat 2: NZ/5cxwnorKW2SNsWy1+8A ($10.75 in chips)
NZ/5cxwnorKW2SNsWy1+8A: posts small blind $0.25
yBO+mXB6m/rCft2ErwGf/Q: posts big blind $0.50
*** HOLE CARDS ***
NZ/5cxwnorKW2SNsWy1+8A: folds
yBO+mXB6m/rCft2ErwGf/Q collected $0.50 from pot
*** SUMMARY ***
Total pot $0.50 | Rake $0
Seat 1: yBO+mXB6m/rCft2ErwGf/Q (big blind) collected ($0.50)
Seat 2: NZ/5cxwnorKW2SNsWy1+8A (button) (small blind) folded before Flop



PokerStars Game #59939823488:  Hold'em No Limit ($0.25/$0.50) - 2009/07/01 0:49:53 ET
Table 'E7bWJ45aoFXRpyRv2gw+Ig' 2-max Seat #2 is the button
Seat 1: FRkiRasEGlHUeLrEl+k/nA ($87.50 in chips)
Seat 2: 3Wro85I7472vJ4Wkpneo9A ($106.05 in chips)
3Wro85I7472vJ4Wkpneo9A: posts small blind $0.25
FRkiRasEGlHUeLrEl+k/nA: posts big blind $0.50
*** HOLE CARDS ***
3Wro85I7472vJ4Wkpneo9A: raises $1 to $1.50
FRkiRasEGlHUeLrEl+k/nA: raises $3 to $4.50
3Wro85I7472vJ4Wkpneo9A: raises $9.50 to $14
FRkiRasEGlHUeLrEl+k/nA: folds
3Wro85I7472vJ4Wkpneo9A collected $9 from pot
3Wro85I7472vJ4Wkpneo9A: doesn't show hand
*** SUMMARY ***
Total pot $9 | Rake $0
Seat 1: FRkiRasEGlHUeLrEl+k/nA (big blind) folded before Flop
Seat 2: 3Wro85I7472vJ4Wkpneo9A (button) (small blind) collected ($9)



PokerStars Game #59939823800:  Hold'em No Limit ($0.25/$0.50) - 2009/07/01 0:49:53 ET
Table 'X6IRCRTh+20gjz8aubWnwA' 9-max Seat #5 is the button
Seat 1: DSM67hHHq1XFoEOi9p8Alw ($50.05 in chips)
Seat 2: HZkVla4kK2SI42CVrPZ/ig ($8.55 in chips)
Seat 3: SWv01peOe69QQRvhQTqjQw ($13.40 in chips)
Seat 4: 2J+UVOVrW+V3maOylyxMcQ ($37.60 in chips)
Seat 5: NnQCepdIR/AOUQn1yhYx6Q ($10 in chips)
Seat 7: cFHQjKQOOKTUzoilhrXHLg ($41.85 in chips)
Seat 8: HxeBVq06/3Bh/H986sgdbw ($7.45 in chips)
Seat 9: M+7+BTmX5vZatHVuoRB1nA ($68.50 in chips)
75K2MXwN65Sjfp1yHd50Hg will be allowed to play after the button
cFHQjKQOOKTUzoilhrXHLg: posts small blind $0.25
HxeBVq06/3Bh/H986sgdbw: posts big blind $0.50
*** HOLE CARDS ***
M+7+BTmX5vZatHVuoRB1nA: raises $1.50 to $2
DSM67hHHq1XFoEOi9p8Alw: folds
HZkVla4kK2SI42CVrPZ/ig: folds
SWv01peOe69QQRvhQTqjQw: folds
2J+UVOVrW+V3maOylyxMcQ: folds
NnQCepdIR/AOUQn1yhYx6Q: folds
cFHQjKQOOKTUzoilhrXHLg: calls $1.75
HxeBVq06/3Bh/H986sgdbw: calls $1.50
*** FLOP *** [Th Ac 3c]
cFHQjKQOOKTUzoilhrXHLg: checks
HxeBVq06/3Bh/H986sgdbw: checks
M+7+BTmX5vZatHVuoRB1nA: bets $4.50
cFHQjKQOOKTUzoilhrXHLg: calls $4.50
HxeBVq06/3Bh/H986sgdbw: calls $4.50
*** TURN *** [Th Ac 3c] [Jc]
cFHQjKQOOKTUzoilhrXHLg: checks
HxeBVq06/3Bh/H986sgdbw: checks
M+7+BTmX5vZatHVuoRB1nA: checks
*** RIVER *** [Th Ac 3c Jc] [Td]
cFHQjKQOOKTUzoilhrXHLg: checks
HxeBVq06/3Bh/H986sgdbw: checks
M+7+BTmX5vZatHVuoRB1nA: bets $9.50
cFHQjKQOOKTUzoilhrXHLg: calls $9.50
HxeBVq06/3Bh/H986sgdbw: calls $0.95 and is all-in
*** SHOW DOWN ***
M+7+BTmX5vZatHVuoRB1nA: shows [5d 5s] (two pair, Tens and Fives)
cFHQjKQOOKTUzoilhrXHLg: shows [6s Ad] (two pair, Aces and Tens)
cFHQjKQOOKTUzoilhrXHLg collected $16.25 from side pot
HxeBVq06/3Bh/H986sgdbw: shows [6c As] (two pair, Aces and Tens)
cFHQjKQOOKTUzoilhrXHLg collected $10.65 from main pot
HxeBVq06/3Bh/H986sgdbw collected $10.65 from main pot
*** SUMMARY ***
Total pot $39.45 Main pot $21.30. Side pot $16.25. | Rake $1.90
Board [Th Ac 3c Jc Td]
Seat 1: DSM67hHHq1XFoEOi9p8Alw folded before Flop (didn't bet)
Seat 2: HZkVla4kK2SI42CVrPZ/ig folded before Flop (didn't bet)
Seat 3: SWv01peOe69QQRvhQTqjQw folded before Flop (didn't bet)
Seat 4: 2J+UVOVrW+V3maOylyxMcQ folded before Flop (didn't bet)
Seat 5: NnQCepdIR/AOUQn1yhYx6Q (button) folded before Flop (didn't bet)
Seat 7: cFHQjKQOOKTUzoilhrXHLg (small blind) showed [6s Ad] and won ($26.90) with two pair, Aces and Tens
Seat 8: HxeBVq06/3Bh/H986sgdbw (big blind) showed [6c As] and won ($10.65) with two pair, Aces and Tens
Seat 9: M+7+BTmX5vZatHVuoRB1nA showed [5d 5s] and lost with two pair, Tens and Fives



PokerStars Game #59939823802:  Hold'em No Limit ($0.25/$0.50) - 2009/07/01 0:49:53 ET
Table 'ibNfFy0bCzuBaUORla0aGw' 9-max Seat #2 is the button
Seat 1: xZCXQSXlrZkp3pZizzVXCw ($53.20 in chips)
Seat 2: 90Wb75h3W1BRpbqVnuk8gw ($51.40 in chips)
Seat 3: AjV5McH1KMMclY26QdLM5w ($25 in chips)
Seat 4: YBN054X4blmis+B2bBlC0g ($23.45 in chips)
Seat 5: GIJAc9kPrLZHLSX8Q6i99w ($25.40 in chips)
Seat 6: 8n9jQLh3cZKbsmr5PIjgiQ ($43.25 in chips)
Seat 7: HZkVla4kK2SI42CVrPZ/ig ($14.30 in chips)
Seat 8: xUrN9TWLq4m5V+OXY7KUUA ($50.45 in chips)
Seat 9: pFtzb1sR4b0d1aw6aIRgDg ($50 in chips)
AjV5McH1KMMclY26QdLM5w: posts small blind $0.25
YBN054X4blmis+B2bBlC0g: posts big blind $0.50
*** HOLE CARDS ***
GIJAc9kPrLZHLSX8Q6i99w: folds
8n9jQLh3cZKbsmr5PIjgiQ: folds
HZkVla4kK2SI42CVrPZ/ig: folds
xUrN9TWLq4m5V+OXY7KUUA: folds
pFtzb1sR4b0d1aw6aIRgDg: folds
xZCXQSXlrZkp3pZizzVXCw: folds
90Wb75h3W1BRpbqVnuk8gw: folds
AjV5McH1KMMclY26QdLM5w: folds
YBN054X4blmis+B2bBlC0g collected $0.50 from pot
*** SUMMARY ***
Total pot $0.50 | Rake $0
Seat 1: xZCXQSXlrZkp3pZizzVXCw folded before Flop (didn't bet)
Seat 2: 90Wb75h3W1BRpbqVnuk8gw (button) folded before Flop (didn't bet)
Seat 3: AjV5McH1KMMclY26QdLM5w (small blind) folded before Flop
Seat 4: YBN054X4blmis+B2bBlC0g (big blind) collected ($0.50)
Seat 5: GIJAc9kPrLZHLSX8Q6i99w folded before Flop (didn't bet)
Seat 6: 8n9jQLh3cZKbsmr5PIjgiQ folded before Flop (didn't bet)
Seat 7: HZkVla4kK2SI42CVrPZ/ig folded before Flop (didn't bet)
Seat 8: xUrN9TWLq4m5V+OXY7KUUA folded before Flop (didn't bet)
Seat 9: pFtzb1sR4b0d1aw6aIRgDg folded before Flop (didn't bet)



PokerStars Game #59939824352:  Hold'em No Limit ($0.25/$0.50) - 2009/07/01 0:49:54 ET
Table '+dXkOAQyS8j9PQZusUTMpg' 2-max Seat #2 is the button
Seat 1: XFa6sBGjP2gxoIvxR3fZIg ($64.45 in chips)
Seat 2: 5IBeOgaApY1Bvzv2P8X4EA ($137.80 in chips)
5IBeOgaApY1Bvzv2P8X4EA: posts small blind $0.25
XFa6sBGjP2gxoIvxR3fZIg: posts big blind $0.50
*** HOLE CARDS ***
5IBeOgaApY1Bvzv2P8X4EA: calls $0.25
XFa6sBGjP2gxoIvxR3fZIg: checks
*** FLOP *** [4h 7h Kd]
XFa6sBGjP2gxoIvxR3fZIg: checks
5IBeOgaApY1Bvzv2P8X4EA: bets $1.50
XFa6sBGjP2gxoIvxR3fZIg: folds
5IBeOgaApY1Bvzv2P8X4EA collected $0.95 from pot
5IBeOgaApY1Bvzv2P8X4EA: doesn't show hand
*** SUMMARY ***
Total pot $1 | Rake $0.05
Board [4h 7h Kd]
Seat 1: XFa6sBGjP2gxoIvxR3fZIg (big blind) folded on the Flop
Seat 2: 5IBeOgaApY1Bvzv2P8X4EA (button) (small blind) collected ($0.95)



PokerStars Game #59939824870:  Hold'em No Limit ($0.25/$0.50) - 2009/07/01 0:49:55 ET
Table '/cQuAT3ef4t+PGrXiNhGaQ' 9-max Seat #8 is the button
Seat 1: HZkVla4kK2SI42CVrPZ/ig ($13.75 in chips)
Seat 2: jXGruyaMqirTaTXNOvBdew ($69.45 in chips)
Seat 3: g4k0NXISyLCqaSWZDBjfEg ($55.25 in chips)
Seat 4: OWP/DOu+PlPK6ZZ3zYa0HA ($27.90 in chips)
Seat 5: 5SgaHdWixdClWvaEG+KUjQ ($25.60 in chips)
Seat 6: APYIOyK/4AGb+kIwlOUNBQ ($37.25 in chips)
Seat 7: J0W5D97jl5VLky+IoPvDeA ($113.40 in chips)
Seat 8: eBrej2jnlUCs/JgxFCRn2g ($40 in chips)
Seat 9: AjV5McH1KMMclY26QdLM5w ($25 in chips)
AjV5McH1KMMclY26QdLM5w: posts small blind $0.25
HZkVla4kK2SI42CVrPZ/ig: posts big blind $0.50
*** HOLE CARDS ***
jXGruyaMqirTaTXNOvBdew: calls $0.50
g4k0NXISyLCqaSWZDBjfEg: folds
OWP/DOu+PlPK6ZZ3zYa0HA: raises $1 to $1.50
5SgaHdWixdClWvaEG+KUjQ: calls $1.50
APYIOyK/4AGb+kIwlOUNBQ: folds
J0W5D97jl5VLky+IoPvDeA: folds
eBrej2jnlUCs/JgxFCRn2g: folds
AjV5McH1KMMclY26QdLM5w: folds
HZkVla4kK2SI42CVrPZ/ig: folds
jXGruyaMqirTaTXNOvBdew: raises $7.50 to $9
OWP/DOu+PlPK6ZZ3zYa0HA: folds
5SgaHdWixdClWvaEG+KUjQ: folds
jXGruyaMqirTaTXNOvBdew collected $5.25 from pot
*** SUMMARY ***
Total pot $5.25 | Rake $0
Seat 1: HZkVla4kK2SI42CVrPZ/ig (big blind) folded before Flop
Seat 2: jXGruyaMqirTaTXNOvBdew collected ($5.25)
Seat 3: g4k0NXISyLCqaSWZDBjfEg folded before Flop (didn't bet)
Seat 4: OWP/DOu+PlPK6ZZ3zYa0HA folded before Flop
Seat 5: 5SgaHdWixdClWvaEG+KUjQ folded before Flop
Seat 6: APYIOyK/4AGb+kIwlOUNBQ folded before Flop (didn't bet)
Seat 7: J0W5D97jl5VLky+IoPvDeA folded before Flop (didn't bet)
Seat 8: eBrej2jnlUCs/JgxFCRn2g (button) folded before Flop (didn't bet)
Seat 9: AjV5McH1KMMclY26QdLM5w (small blind) folded before Flop



PokerStars Game #59939826102:  Hold'em No Limit ($0.25/$0.50) - 2009/07/01 0:49:57 ET
Table 'Vdlc9wqYcHTUhtdyN7CuJw' 2-max Seat #1 is the button
Seat 1: yBO+mXB6m/rCft2ErwGf/Q ($115 in chips)
Seat 2: NZ/5cxwnorKW2SNsWy1+8A ($10.50 in chips)
yBO+mXB6m/rCft2ErwGf/Q: posts small blind $0.25
NZ/5cxwnorKW2SNsWy1+8A: posts big blind $0.50
*** HOLE CARDS ***
yBO+mXB6m/rCft2ErwGf/Q: raises $1 to $1.50
NZ/5cxwnorKW2SNsWy1+8A: folds
yBO+mXB6m/rCft2ErwGf/Q collected $1 from pot
*** SUMMARY ***
Total pot $1 | Rake $0
Seat 1: yBO+mXB6m/rCft2ErwGf/Q (button) (small blind) collected ($1)
Seat 2: NZ/5cxwnorKW2SNsWy1+8A (big blind) folded before Flop



PokerStars Game #59939827244:  Hold'em No Limit ($0.25/$0.50) - 2009/07/01 0:49:59 ET
Table 'lSisgp6H7Fg1hH5VfjEjYQ' 9-max Seat #1 is the button
Seat 1: 5k9fvXD9suIgCxU4HLQjTw ($50 in chips)
Seat 2: UrcnkQOiLVk8BlKDPJSy7Q ($77.85 in chips)
Seat 3: aTkyjTh3w5YLWiIERupZOA ($51.95 in chips)
Seat 4: bwv/rbH/hHhPhY6u9mu04w ($34.85 in chips)
Seat 5: mSD1pginDsyHG5PDfqzphw ($11.35 in chips)
Seat 6: +k7T5ocke8UwavtgUHm+Cg ($30 in chips)
Seat 7: Y3DZ6qQlLeBhixDj4M9vmg ($10.05 in chips)
Seat 8: a4JDWmpFQkL10XfAyuF51A ($30.50 in chips)
Seat 9: gsyXT42WLEcOS4DdEk2wlw ($30.85 in chips)
UrcnkQOiLVk8BlKDPJSy7Q: posts small blind $0.25
aTkyjTh3w5YLWiIERupZOA: posts big blind $0.50
*** HOLE CARDS ***
bwv/rbH/hHhPhY6u9mu04w: folds
mSD1pginDsyHG5PDfqzphw: folds
+k7T5ocke8UwavtgUHm+Cg: raises $1 to $1.50
Y3DZ6qQlLeBhixDj4M9vmg: calls $1.50
a4JDWmpFQkL10XfAyuF51A: folds
gsyXT42WLEcOS4DdEk2wlw: raises $6.50 to $8
5k9fvXD9suIgCxU4HLQjTw: folds
UrcnkQOiLVk8BlKDPJSy7Q: folds
aTkyjTh3w5YLWiIERupZOA: folds
+k7T5ocke8UwavtgUHm+Cg: folds
Y3DZ6qQlLeBhixDj4M9vmg: calls $6.50
*** FLOP *** [6c As 7s]
Y3DZ6qQlLeBhixDj4M9vmg: bets $2
gsyXT42WLEcOS4DdEk2wlw: raises $2 to $4
Y3DZ6qQlLeBhixDj4M9vmg: calls $0.05 and is all-in
*** TURN *** [6c As 7s] [6h]
*** RIVER *** [6c As 7s 6h] [8c]
*** SHOW DOWN ***
Y3DZ6qQlLeBhixDj4M9vmg: shows [7h 7d] (a full house, Sevens full of Sixes)
gsyXT42WLEcOS4DdEk2wlw: shows [Ac Ad] (a full house, Aces full of Sixes)
gsyXT42WLEcOS4DdEk2wlw collected $21.30 from pot
*** SUMMARY ***
Total pot $22.35 | Rake $1.05
Board [6c As 7s 6h 8c]
Seat 1: 5k9fvXD9suIgCxU4HLQjTw (button) folded before Flop (didn't bet)
Seat 2: UrcnkQOiLVk8BlKDPJSy7Q (small blind) folded before Flop
Seat 3: aTkyjTh3w5YLWiIERupZOA (big blind) folded before Flop
Seat 4: bwv/rbH/hHhPhY6u9mu04w folded before Flop (didn't bet)
Seat 5: mSD1pginDsyHG5PDfqzphw folded before Flop (didn't bet)
Seat 6: +k7T5ocke8UwavtgUHm+Cg folded before Flop
Seat 7: Y3DZ6qQlLeBhixDj4M9vmg showed [7h 7d] and lost with a full house, Sevens full of Sixes
Seat 8: a4JDWmpFQkL10XfAyuF51A folded before Flop (didn't bet)
Seat 9: gsyXT42WLEcOS4DdEk2wlw showed [Ac Ad] and won ($21.30) with a full house, Aces full of Sixes



PokerStars Game #59939827954:  Hold'em No Limit ($0.25/$0.50) - 2009/07/01 0:50:00 ET
Table 'T/PgNWqVyY6lkldcBVXYJQ' 6-max Seat #4 is the button
Seat 1: +Pf9jTVizYlIo+woPvptfA ($78 in chips)
Seat 2: LvH4G7n+QSjT6NDaD3cREA ($54.25 in chips)
Seat 3: L3OcNO1bgdqDI46j67KQPQ ($50 in chips)
Seat 4: Ek4w9XqBXqK5jBUQeLedGw ($50 in chips)
Seat 6: cDzbog6kwmJp+LBeBq+iMQ ($20.75 in chips)
of9mtXiD8G4Nx5p7hCbgqQ will be allowed to play after the button
cDzbog6kwmJp+LBeBq+iMQ: posts small blind $0.25
+Pf9jTVizYlIo+woPvptfA: posts big blind $0.50
*** HOLE CARDS ***
LvH4G7n+QSjT6NDaD3cREA: folds
L3OcNO1bgdqDI46j67KQPQ: folds
Ek4w9XqBXqK5jBUQeLedGw: folds
cDzbog6kwmJp+LBeBq+iMQ: calls $0.25
+Pf9jTVizYlIo+woPvptfA: checks
*** FLOP *** [3h Jd 6c]
cDzbog6kwmJp+LBeBq+iMQ: checks
+Pf9jTVizYlIo+woPvptfA: checks
*** TURN *** [3h Jd 6c] [7d]
cDzbog6kwmJp+LBeBq+iMQ: bets $0.50
+Pf9jTVizYlIo+woPvptfA: folds
cDzbog6kwmJp+LBeBq+iMQ collected $0.95 from pot
*** SUMMARY ***
Total pot $1 | Rake $0.05
Board [3h Jd 6c 7d]
Seat 1: +Pf9jTVizYlIo+woPvptfA (big blind) folded on the Turn
Seat 2: LvH4G7n+QSjT6NDaD3cREA folded before Flop (didn't bet)
Seat 3: L3OcNO1bgdqDI46j67KQPQ folded before Flop (didn't bet)
Seat 4: Ek4w9XqBXqK5jBUQeLedGw (button) folded before Flop (didn't bet)
Seat 6: cDzbog6kwmJp+LBeBq+iMQ (small blind) collected ($0.95)



PokerStars Game #59939828444:  Hold'em No Limit ($0.25/$0.50) - 2009/07/01 0:50:01 ET
Table 'fx6MqwfYAj/Rt86hBz2L3Q' 9-max Seat #9 is the button
Seat 1: SegjDnMxWMujiD57ESNL+g ($9.50 in chips)
Seat 3: iadBi5AEt7gTBXbDSSnMYQ ($48.20 in chips)
Seat 4: gPEN9Zp33YTm/mu9/SYP1w ($23.30 in chips)
Seat 5: iAISe3dVeua8PUn2wwgDHw ($34.50 in chips)
Seat 6: 5k9fvXD9suIgCxU4HLQjTw ($50.75 in chips)
Seat 7: SKnJuWHScqetA/qG5p+wCg ($30 in chips)
Seat 8: JYwJYYV9pM5KWdSiETl8rA ($29.25 in chips)
Seat 9: HZkVla4kK2SI42CVrPZ/ig ($11 in chips)
SegjDnMxWMujiD57ESNL+g: posts small blind $0.25
iadBi5AEt7gTBXbDSSnMYQ: posts big blind $0.50
*** HOLE CARDS ***
gPEN9Zp33YTm/mu9/SYP1w: folds
iAISe3dVeua8PUn2wwgDHw: folds
5k9fvXD9suIgCxU4HLQjTw: folds
SKnJuWHScqetA/qG5p+wCg: folds
JYwJYYV9pM5KWdSiETl8rA: folds
HZkVla4kK2SI42CVrPZ/ig: folds
SegjDnMxWMujiD57ESNL+g: raises $1.50 to $2
iadBi5AEt7gTBXbDSSnMYQ: folds
SegjDnMxWMujiD57ESNL+g collected $1 from pot
SegjDnMxWMujiD57ESNL+g: doesn't show hand
*** SUMMARY ***
Total pot $1 | Rake $0
Seat 1: SegjDnMxWMujiD57ESNL+g (small blind) collected ($1)
Seat 3: iadBi5AEt7gTBXbDSSnMYQ (big blind) folded before Flop
Seat 4: gPEN9Zp33YTm/mu9/SYP1w folded before Flop (didn't bet)
Seat 5: iAISe3dVeua8PUn2wwgDHw folded before Flop (didn't bet)
Seat 6: 5k9fvXD9suIgCxU4HLQjTw folded before Flop (didn't bet)
Seat 7: SKnJuWHScqetA/qG5p+wCg folded before Flop (didn't bet)
Seat 8: JYwJYYV9pM5KWdSiETl8rA folded before Flop (didn't bet)
Seat 9: HZkVla4kK2SI42CVrPZ/ig (button) folded before Flop (didn't bet)



PokerStars Game #59939829256:  Hold'em No Limit ($0.25/$0.50) - 2009/07/01 0:50:02 ET
Table 'QOeVnLhwctF9UyV/beDi+A' 2-max Seat #2 is the button
Seat 1: bypIyrYcAAifLfhZpGlKLA ($71.95 in chips)
Seat 2: Ucrm3XtZmoONapW32SPhag ($9.85 in chips)
Ucrm3XtZmoONapW32SPhag: posts small blind $0.25
bypIyrYcAAifLfhZpGlKLA: posts big blind $0.50
*** HOLE CARDS ***
Ucrm3XtZmoONapW32SPhag: folds
bypIyrYcAAifLfhZpGlKLA collected $0.50 from pot
bypIyrYcAAifLfhZpGlKLA: doesn't show hand
*** SUMMARY ***
Total pot $0.50 | Rake $0
Seat 1: bypIyrYcAAifLfhZpGlKLA (big blind) collected ($0.50)
Seat 2: Ucrm3XtZmoONapW32SPhag (button) (small blind) folded before Flop



PokerStars Game #59939830376:  Hold'em No Limit ($0.25/$0.50) - 2009/07/01 0:50:04 ET
Table '0eJtgVAXVvBgncFdcUpXcQ' 2-max Seat #2 is the button
Seat 1: Ag6DvxX4vbRheqsv2zXKTQ ($37.15 in chips)
Seat 2: KMc4R+K9ao4Ur3rF7NGe6Q ($15.45 in chips)
KMc4R+K9ao4Ur3rF7NGe6Q: posts small blind $0.25
Ag6DvxX4vbRheqsv2zXKTQ: posts big blind $0.50
*** HOLE CARDS ***
KMc4R+K9ao4Ur3rF7NGe6Q: calls $0.25
Ag6DvxX4vbRheqsv2zXKTQ: checks
*** FLOP *** [2c 7d 6c]
Ag6DvxX4vbRheqsv2zXKTQ: checks
KMc4R+K9ao4Ur3rF7NGe6Q: checks
*** TURN *** [2c 7d 6c] [4c]
Ag6DvxX4vbRheqsv2zXKTQ: bets $1
KMc4R+K9ao4Ur3rF7NGe6Q: folds
Ag6DvxX4vbRheqsv2zXKTQ collected $0.95 from pot
*** SUMMARY ***
Total pot $1 | Rake $0.05
Board [2c 7d 6c 4c]
Seat 1: Ag6DvxX4vbRheqsv2zXKTQ (big blind) collected ($0.95)
Seat 2: KMc4R+K9ao4Ur3rF7NGe6Q (button) (small blind) folded on the Turn



PokerStars Game #59939830768:  Hold'em No Limit ($0.25/$0.50) - 2009/07/01 0:50:04 ET
Table 'c/CRn+68J3Y8KxD5g1ek2Q' 2-max Seat #1 is the button
Seat 1: 46qCyJ6evTkHo9al5sBMNA ($93.15 in chips)
Seat 2: BypVLsYQt3ePFm2xQL/dOA ($279.60 in chips)
46qCyJ6evTkHo9al5sBMNA: posts small blind $0.25
BypVLsYQt3ePFm2xQL/dOA: posts big blind $0.50
*** HOLE CARDS ***
46qCyJ6evTkHo9al5sBMNA: raises $1 to $1.50
BypVLsYQt3ePFm2xQL/dOA: calls $1
*** FLOP *** [Ac Ad Kc]
BypVLsYQt3ePFm2xQL/dOA: bets $1
46qCyJ6evTkHo9al5sBMNA: calls $1
*** TURN *** [Ac Ad Kc] [5s]
BypVLsYQt3ePFm2xQL/dOA: bets $1.50
46qCyJ6evTkHo9al5sBMNA: calls $1.50
*** RIVER *** [Ac Ad Kc 5s] [Qs]
BypVLsYQt3ePFm2xQL/dOA: bets $1.50
46qCyJ6evTkHo9al5sBMNA: calls $1.50
*** SHOW DOWN ***
BypVLsYQt3ePFm2xQL/dOA: shows [8h Kh] (two pair, Aces and Kings)
46qCyJ6evTkHo9al5sBMNA: mucks hand
BypVLsYQt3ePFm2xQL/dOA collected $10.50 from pot
*** SUMMARY ***
Total pot $11 | Rake $0.50
Board [Ac Ad Kc 5s Qs]
Seat 1: 46qCyJ6evTkHo9al5sBMNA (button) (small blind) mucked
Seat 2: BypVLsYQt3ePFm2xQL/dOA (big blind) showed [8h Kh] and won ($10.50) with two pair, Aces and Kings



PokerStars Game #59939830832:  Hold'em No Limit ($0.25/$0.50) - 2009/07/01 0:50:05 ET
Table '3FhG0gl3kMX3wBEEqj+wnQ' 9-max Seat #9 is the button
Seat 1: e0J9pdCNUDTCG031RnXqLA ($32.55 in chips)
Seat 2: 7cYQ+syUWjl38ty/ICOMhw ($50 in chips)
Seat 4: bjvJtA9Hqscfznq66txaOQ ($9.50 in chips)
Seat 5: gsyXT42WLEcOS4DdEk2wlw ($27.75 in chips)
Seat 6: 997ViqAtWn1FPjJqcffwcA ($50 in chips)
Seat 7: mSD1pginDsyHG5PDfqzphw ($10.25 in chips)
Seat 8: j3K/Jujr7PY4ZM2RZvlH6A ($61.45 in chips)
Seat 9: L5e2lrPLQm1Pqx30IIZ/Fw ($10.50 in chips)
e0J9pdCNUDTCG031RnXqLA: posts small blind $0.25
7cYQ+syUWjl38ty/ICOMhw: posts big blind $0.50
*** HOLE CARDS ***
bjvJtA9Hqscfznq66txaOQ: calls $0.50
gsyXT42WLEcOS4DdEk2wlw: folds
997ViqAtWn1FPjJqcffwcA: folds
mSD1pginDsyHG5PDfqzphw: folds
j3K/Jujr7PY4ZM2RZvlH6A: calls $0.50
L5e2lrPLQm1Pqx30IIZ/Fw: folds
e0J9pdCNUDTCG031RnXqLA: folds
7cYQ+syUWjl38ty/ICOMhw: checks
*** FLOP *** [9d 2h 8h]
7cYQ+syUWjl38ty/ICOMhw: checks
bjvJtA9Hqscfznq66txaOQ: bets $1.50
j3K/Jujr7PY4ZM2RZvlH6A: folds
7cYQ+syUWjl38ty/ICOMhw: folds
bjvJtA9Hqscfznq66txaOQ collected $1.70 from pot
bjvJtA9Hqscfznq66txaOQ: doesn't show hand
*** SUMMARY ***
Total pot $1.75 | Rake $0.05
Board [9d 2h 8h]
Seat 1: e0J9pdCNUDTCG031RnXqLA (small blind) folded before Flop
Seat 2: 7cYQ+syUWjl38ty/ICOMhw (big blind) folded on the Flop
Seat 4: bjvJtA9Hqscfznq66txaOQ collected ($1.70)
Seat 5: gsyXT42WLEcOS4DdEk2wlw folded before Flop (didn't bet)
Seat 6: 997ViqAtWn1FPjJqcffwcA folded before Flop (didn't bet)
Seat 7: mSD1pginDsyHG5PDfqzphw folded before Flop (didn't bet)
Seat 8: j3K/Jujr7PY4ZM2RZvlH6A folded on the Flop
Seat 9: L5e2lrPLQm1Pqx30IIZ/Fw (button) folded before Flop (didn't bet)



PokerStars Game #59939830850:  Hold'em No Limit ($0.25/$0.50) - 2009/07/01 0:50:05 ET
Table 'GfL/No5u5PoEnU39lP5pQg' 6-max Seat #3 is the button
Seat 1: 1WUCqNG+p+vfWRTXNu4ljw ($60.75 in chips)
Seat 2: uVwggSetzp7d+eVgowO3vg ($64.95 in chips)
Seat 3: Ek4w9XqBXqK5jBUQeLedGw ($50 in chips)
Seat 4: r6u7MWSXF30/khcTYkrG9Q ($24.90 in chips)
Seat 5: M1KyQQvVPVuxqTAB8sR/zQ ($53 in chips)
r6u7MWSXF30/khcTYkrG9Q: posts small blind $0.25
M1KyQQvVPVuxqTAB8sR/zQ: posts big blind $0.50
kxPhs4ePFqMy52CInAJ2aw: sits out
*** HOLE CARDS ***
1WUCqNG+p+vfWRTXNu4ljw: folds
uVwggSetzp7d+eVgowO3vg: calls $0.50
Ek4w9XqBXqK5jBUQeLedGw: raises $2.50 to $3
r6u7MWSXF30/khcTYkrG9Q: folds
M1KyQQvVPVuxqTAB8sR/zQ: folds
uVwggSetzp7d+eVgowO3vg: folds
Ek4w9XqBXqK5jBUQeLedGw collected $1.75 from pot
*** SUMMARY ***
Total pot $1.75 | Rake $0
Seat 1: 1WUCqNG+p+vfWRTXNu4ljw folded before Flop (didn't bet)
Seat 2: uVwggSetzp7d+eVgowO3vg folded before Flop
Seat 3: Ek4w9XqBXqK5jBUQeLedGw (button) collected ($1.75)
Seat 4: r6u7MWSXF30/khcTYkrG9Q (small blind) folded before Flop
Seat 5: M1KyQQvVPVuxqTAB8sR/zQ (big blind) folded before Flop



PokerStars Game #59939833840:  Hold'em No Limit ($0.25/$0.50) - 2009/07/01 0:50:09 ET
Table '+dXkOAQyS8j9PQZusUTMpg' 2-max Seat #1 is the button
Seat 1: XFa6sBGjP2gxoIvxR3fZIg ($63.95 in chips)
Seat 2: 5IBeOgaApY1Bvzv2P8X4EA ($138.25 in chips)
XFa6sBGjP2gxoIvxR3fZIg: posts small blind $0.25
5IBeOgaApY1Bvzv2P8X4EA: posts big blind $0.50
*** HOLE CARDS ***
XFa6sBGjP2gxoIvxR3fZIg: raises $1 to $1.50
5IBeOgaApY1Bvzv2P8X4EA: calls $1
*** FLOP *** [Jd 6d 7c]
5IBeOgaApY1Bvzv2P8X4EA: checks
XFa6sBGjP2gxoIvxR3fZIg: checks
*** TURN *** [Jd 6d 7c] [Ts]
5IBeOgaApY1Bvzv2P8X4EA: bets $2.50
XFa6sBGjP2gxoIvxR3fZIg: folds
5IBeOgaApY1Bvzv2P8X4EA collected $2.85 from pot
5IBeOgaApY1Bvzv2P8X4EA: doesn't show hand
*** SUMMARY ***
Total pot $3 | Rake $0.15
Board [Jd 6d 7c Ts]
Seat 1: XFa6sBGjP2gxoIvxR3fZIg (button) (small blind) folded on the Turn
Seat 2: 5IBeOgaApY1Bvzv2P8X4EA (big blind) collected ($2.85)



PokerStars Game #59939834906:  Hold'em No Limit ($0.25/$0.50) - 2009/07/01 0:50:11 ET
Table 'Vdlc9wqYcHTUhtdyN7CuJw' 2-max Seat #2 is the button
Seat 1: yBO+mXB6m/rCft2ErwGf/Q ($115.50 in chips)
Seat 2: NZ/5cxwnorKW2SNsWy1+8A ($10 in chips)
NZ/5cxwnorKW2SNsWy1+8A: posts small blind $0.25
yBO+mXB6m/rCft2ErwGf/Q: posts big blind $0.50
*** HOLE CARDS ***
NZ/5cxwnorKW2SNsWy1+8A: calls $0.25
yBO+mXB6m/rCft2ErwGf/Q: raises $1 to $1.50
NZ/5cxwnorKW2SNsWy1+8A: folds
yBO+mXB6m/rCft2ErwGf/Q collected $1 from pot
*** SUMMARY ***
Total pot $1 | Rake $0
Seat 1: yBO+mXB6m/rCft2ErwGf/Q (big blind) collected ($1)
Seat 2: NZ/5cxwnorKW2SNsWy1+8A (button) (small blind) folded before Flop



PokerStars Game #59939835050:  Hold'em No Limit ($0.25/$0.50) - 2009/07/01 0:50:11 ET
Table 'QOgaEqMcJ73pcUMMxoisUgErOuyGLI5PT3G5MnpHgC/g Seat #8 is the button
Seat 1: eBrej2jnlUCs/JgxFCRn2g ($40 in chips)
Seat 3: xZCXQSXlrZkp3pZizzVXCw ($49.75 in chips)
Seat 4: 3UmXLy3GfjC3EkOebduerQ ($50 in chips)
Seat 5: JwvquocWfhTVApN5t47LgA ($60.10 in chips)
Seat 6: zE9cVigS2nW/Ljy4K4bUQA ($30 in chips)
Seat 7: 90Wb75h3W1BRpbqVnuk8gw ($65.55 in chips)
Seat 8: g4k0NXISyLCqaSWZDBjfEg ($50 in chips)
Seat 9: J0W5D97jl5VLky+IoPvDeA ($53.90 in chips)
J0W5D97jl5VLky+IoPvDeA: posts small blind $0.25
eBrej2jnlUCs/JgxFCRn2g: posts big blind $0.50
*** HOLE CARDS ***
xZCXQSXlrZkp3pZizzVXCw: folds
3UmXLy3GfjC3EkOebduerQ: folds
JwvquocWfhTVApN5t47LgA: calls $0.50
zE9cVigS2nW/Ljy4K4bUQA: folds
90Wb75h3W1BRpbqVnuk8gw: folds
g4k0NXISyLCqaSWZDBjfEg: folds
J0W5D97jl5VLky+IoPvDeA: folds
eBrej2jnlUCs/JgxFCRn2g: checks
*** FLOP *** [9c Kh Js]
eBrej2jnlUCs/JgxFCRn2g: checks
JwvquocWfhTVApN5t47LgA: bets $1
eBrej2jnlUCs/JgxFCRn2g: folds
JwvquocWfhTVApN5t47LgA collected $1.20 from pot
*** SUMMARY ***
Total pot $1.25 | Rake $0.05
Board [9c Kh Js]
Seat 1: eBrej2jnlUCs/JgxFCRn2g (big blind) folded on the Flop
Seat 3: xZCXQSXlrZkp3pZizzVXCw folded before Flop (didn't bet)
Seat 4: 3UmXLy3GfjC3EkOebduerQ folded before Flop (didn't bet)
Seat 5: JwvquocWfhTVApN5t47LgA collected ($1.20)
Seat 6: zE9cVigS2nW/Ljy4K4bUQA folded before Flop (didn't bet)
Seat 7: 90Wb75h3W1BRpbqVnuk8gw folded before Flop (didn't bet)
Seat 8: g4k0NXISyLCqaSWZDBjfEg (button) folded before Flop (didn't bet)
Seat 9: J0W5D97jl5VLky+IoPvDeA (small blind) folded before Flop



PokerStars Game #59939835404:  Hold'em No Limit ($0.25/$0.50) - 2009/07/01 0:50:12 ET
Table '99gCy/CZQwPIjZWH+BguQgE7bWJ45aoFXRpyRv2gw+Igeat #5 is the button
Seat 2: n6VQBu6crjYjy6DxNP1NZA ($30.50 in chips)
Seat 3: qEn9ijNGtuyTxamBf07hYg ($50 in chips)
Seat 4: bxLSulbgr8LmKNjOzw8URg ($61.45 in chips)
Seat 5: DSM67hHHq1XFoEOi9p8Alw ($47.50 in chips)
Seat 7: bfSq6LBw0UvxeM5yfuWC7w ($18.10 in chips)
Seat 8: 8ehL7qlZzjgUh2H35iiWLw ($50 in chips)
Seat 9: j3K/Jujr7PY4ZM2RZvlH6A ($93.90 in chips)
bfSq6LBw0UvxeM5yfuWC7w: posts small blind $0.25
8ehL7qlZzjgUh2H35iiWLw: posts big blind $0.50
*** HOLE CARDS ***
j3K/Jujr7PY4ZM2RZvlH6A: calls $0.50
n6VQBu6crjYjy6DxNP1NZA: calls $0.50
qEn9ijNGtuyTxamBf07hYg: folds
bxLSulbgr8LmKNjOzw8URg: folds
DSM67hHHq1XFoEOi9p8Alw: folds
bfSq6LBw0UvxeM5yfuWC7w: folds
8ehL7qlZzjgUh2H35iiWLw: raises $3 to $3.50
j3K/Jujr7PY4ZM2RZvlH6A: folds
n6VQBu6crjYjy6DxNP1NZA: folds
8ehL7qlZzjgUh2H35iiWLw collected $1.75 from pot
8ehL7qlZzjgUh2H35iiWLw: doesn't show hand
*** SUMMARY ***
Total pot $1.75 | Rake $0
Seat 2: n6VQBu6crjYjy6DxNP1NZA folded before Flop
Seat 3: qEn9ijNGtuyTxamBf07hYg folded before Flop (didn't bet)
Seat 4: bxLSulbgr8LmKNjOzw8URg folded before Flop (didn't bet)
Seat 5: DSM67hHHq1XFoEOi9p8Alw (button) folded before Flop (didn't bet)
Seat 7: bfSq6LBw0UvxeM5yfuWC7w (small blind) folded before Flop
Seat 8: 8ehL7qlZzjgUh2H35iiWLw (big blind) collected ($1.75)
Seat 9: j3K/Jujr7PY4ZM2RZvlH6A folded before Flop



PokerStars Game #59939836200:  Hold'em No Limit ($0.25/$0.50) - 2009/07/01 0:50:13 ET
Table 'QOeVnLhwctF9UyV/beDi+A' 2-max Seat #1 is the button
Seat 1: bypIyrYcAAifLfhZpGlKLA ($72.20 in chips)
Seat 2: Ucrm3XtZmoONapW32SPhag ($9.60 in chips)
bypIyrYcAAifLfhZpGlKLA: posts small blind $0.25
Ucrm3XtZmoONapW32SPhag: posts big blind $0.50
*** HOLE CARDS ***
bypIyrYcAAifLfhZpGlKLA: raises $0.50 to $1
Ucrm3XtZmoONapW32SPhag: folds
bypIyrYcAAifLfhZpGlKLA collected $1 from pot
bypIyrYcAAifLfhZpGlKLA: doesn't show hand
*** SUMMARY ***
Total pot $1 | Rake $0
Seat 1: bypIyrYcAAifLfhZpGlKLA (button) (small blind) collected ($1)
Seat 2: Ucrm3XtZmoONapW32SPhag (big blind) folded before Flop



PokerStars Game #59939836906:  Hold'em No Limit ($0.25/$0.50) - 2009/07/01 0:50:14 ET
Table 'eMxdLyFDf28E0wit6gm3Uw' 6-max Seat #5 is the button
Seat 3: dZcLsEI8iXkobBduRJ45Yw ($14.10 in chips)
Seat 4: 3jxEWvv2qK1HCXLj4khowQ ($42.80 in chips)
Seat 5: X0X97o2fDAPiGx6o1gahsw ($75.35 in chips)
Seat 6: nOfdMHEXflgT86UgFWblAA ($50 in chips)
nOfdMHEXflgT86UgFWblAA: posts small blind $0.25
dZcLsEI8iXkobBduRJ45Yw: posts big blind $0.50
*** HOLE CARDS ***
3jxEWvv2qK1HCXLj4khowQ: folds
X0X97o2fDAPiGx6o1gahsw: folds
nOfdMHEXflgT86UgFWblAA: folds
dZcLsEI8iXkobBduRJ45Yw collected $0.50 from pot
*** SUMMARY ***
Total pot $0.50 | Rake $0
Seat 3: dZcLsEI8iXkobBduRJ45Yw (big blind) collected ($0.50)
Seat 4: 3jxEWvv2qK1HCXLj4khowQ folded before Flop (didn't bet)
Seat 5: X0X97o2fDAPiGx6o1gahsw (button) folded before Flop (didn't bet)
Seat 6: nOfdMHEXflgT86UgFWblAA (small blind) folded before Flop



PokerStars Game #59939838142:  Hold'em No Limit ($0.25/$0.50) - 2009/07/01 0:50:16 ET
Table 'otvGDROEDdqsabxskT79qg' 9-max Seat #8 is the button
Seat 1: 8ehL7qlZzjgUh2H35iiWLw ($55.25 in chips)
Seat 2: cCjTzH9jio8607WzjcfXlg ($12.95 in chips)
Seat 3: +k7T5ocke8UwavtgUHm+Cg ($69.50 in chips)
Seat 4: MG90wfSJZnOejs/KD3vlQQ ($69.95 in chips)
Seat 5: XNMDwbXt/Q4jM99AXnbJDw ($52.55 in chips)
Seat 6: bxLSulbgr8LmKNjOzw8URg ($50.90 in chips)
Seat 7: C7+tBppJrKgd/r+tuKUIpA ($36.60 in chips)
Seat 8: zE9cVigS2nW/Ljy4K4bUQA ($30 in chips)
Seat 9: KcY3X8YpD74Kw1RHkx/g4A ($58.40 in chips)
KcY3X8YpD74Kw1RHkx/g4A: posts small blind $0.25
8ehL7qlZzjgUh2H35iiWLw: posts big blind $0.50
*** HOLE CARDS ***
cCjTzH9jio8607WzjcfXlg: folds
+k7T5ocke8UwavtgUHm+Cg: calls $0.50
MG90wfSJZnOejs/KD3vlQQ: folds
XNMDwbXt/Q4jM99AXnbJDw: folds
bxLSulbgr8LmKNjOzw8URg: calls $0.50
C7+tBppJrKgd/r+tuKUIpA: folds
zE9cVigS2nW/Ljy4K4bUQA: folds
KcY3X8YpD74Kw1RHkx/g4A: calls $0.25
8ehL7qlZzjgUh2H35iiWLw: checks
*** FLOP *** [6c Th 6h]
KcY3X8YpD74Kw1RHkx/g4A: checks
8ehL7qlZzjgUh2H35iiWLw: checks
+k7T5ocke8UwavtgUHm+Cg: checks
bxLSulbgr8LmKNjOzw8URg: bets $1.50
KcY3X8YpD74Kw1RHkx/g4A: folds
8ehL7qlZzjgUh2H35iiWLw: folds
+k7T5ocke8UwavtgUHm+Cg: calls $1.50
*** TURN *** [6c Th 6h] [7s]
+k7T5ocke8UwavtgUHm+Cg: checks
bxLSulbgr8LmKNjOzw8URg: bets $3
KcY3X8YpD74Kw1RHkx/g4A said, "NH"
+k7T5ocke8UwavtgUHm+Cg: folds
bxLSulbgr8LmKNjOzw8URg collected $4.80 from pot
bxLSulbgr8LmKNjOzw8URg: doesn't show hand
*** SUMMARY ***
Total pot $5 | Rake $0.20
Board [6c Th 6h 7s]
Seat 1: 8ehL7qlZzjgUh2H35iiWLw (big blind) folded on the Flop
Seat 2: cCjTzH9jio8607WzjcfXlg folded before Flop (didn't bet)
Seat 3: +k7T5ocke8UwavtgUHm+Cg folded on the Turn
Seat 4: MG90wfSJZnOejs/KD3vlQQ folded before Flop (didn't bet)
Seat 5: XNMDwbXt/Q4jM99AXnbJDw folded before Flop (didn't bet)
Seat 6: bxLSulbgr8LmKNjOzw8URg collected ($4.80)
Seat 7: C7+tBppJrKgd/r+tuKUIpA folded before Flop (didn't bet)
Seat 8: zE9cVigS2nW/Ljy4K4bUQA (button) folded before Flop (didn't bet)
Seat 9: KcY3X8YpD74Kw1RHkx/g4A (small blind) folded on the Flop



PokerStars Game #59939837686:  Hold'em No Limit ($0.25/$0.50) - 2009/07/01 0:50:16 ET
Table '0eJtgVAXVvBgncFdcUpXcQ' 2-max Seat #1 is the button
Seat 1: Ag6DvxX4vbRheqsv2zXKTQ ($37.60 in chips)
Seat 2: KMc4R+K9ao4Ur3rF7NGe6Q ($14.95 in chips)
Ag6DvxX4vbRheqsv2zXKTQ: posts small blind $0.25
KMc4R+K9ao4Ur3rF7NGe6Q: posts big blind $0.50
*** HOLE CARDS ***
Ag6DvxX4vbRheqsv2zXKTQ: folds
KMc4R+K9ao4Ur3rF7NGe6Q collected $0.50 from pot
KMc4R+K9ao4Ur3rF7NGe6Q: doesn't show hand
*** SUMMARY ***
Total pot $0.50 | Rake $0
Seat 1: Ag6DvxX4vbRheqsv2zXKTQ (button) (small blind) folded before Flop
Seat 2: KMc4R+K9ao4Ur3rF7NGe6Q (big blind) collected ($0.50)



PokerStars Game #59939839102:  Hold'em No Limit ($0.25/$0.50) - 2009/07/01 0:50:18 ET
Table 'BCN5su+SsXiy1zRMJi0SJw' 6-max Seat #6 is the button
Seat 1: GxXV09ciXaOxyY2H5aMIIw ($29 in chips)
Seat 2: oU2kDCkT/gilYbHWrg7D8w ($31.50 in chips)
Seat 3: g+vwI6lMKpU2uteXSjOzVw ($17.55 in chips)
Seat 4: JY9CtoZTeav+mhWyxSSyJQ ($25.85 in chips)
Seat 5: IBNygaT1aa9Z1uPdJJilwA ($13.05 in chips)
Seat 6: b2symlOdL7+0c9Pj4N/KlA ($82.95 in chips)
GxXV09ciXaOxyY2H5aMIIw: posts small blind $0.25
oU2kDCkT/gilYbHWrg7D8w: posts big blind $0.50
*** HOLE CARDS ***
g+vwI6lMKpU2uteXSjOzVw: folds
JY9CtoZTeav+mhWyxSSyJQ: folds
IBNygaT1aa9Z1uPdJJilwA: folds
b2symlOdL7+0c9Pj4N/KlA: folds
GxXV09ciXaOxyY2H5aMIIw: folds
oU2kDCkT/gilYbHWrg7D8w collected $0.50 from pot
*** SUMMARY ***
Total pot $0.50 | Rake $0
Seat 1: GxXV09ciXaOxyY2H5aMIIw (small blind) folded before Flop
Seat 2: oU2kDCkT/gilYbHWrg7D8w (big blind) collected ($0.50)
Seat 3: g+vwI6lMKpU2uteXSjOzVw folded before Flop (didn't bet)
Seat 4: JY9CtoZTeav+mhWyxSSyJQ folded before Flop (didn't bet)
Seat 5: IBNygaT1aa9Z1uPdJJilwA folded before Flop (didn't bet)
Seat 6: b2symlOdL7+0c9Pj4N/KlA (button) folded before Flop (didn't bet)



PokerStars Game #59939840184:  Hold'em No Limit ($0.25/$0.50) - 2009/07/01 0:50:20 ET
Table 'lpxYasB1ClBSgTpCCITwhQ' 9-max Seat #2 is the button
Seat 1: mj7PS7wCH4PAl7+eYTFs7A ($47.15 in chips)
Seat 2: OWP/DOu+PlPK6ZZ3zYa0HA ($24.85 in chips)
Seat 3: cDNz32Scry3j+v2+kE3pHg ($50 in chips)
Seat 5: IYd5zG8k7vdBNVHbHg2Pag ($36.60 in chips)
Seat 6: SegjDnMxWMujiD57ESNL+g ($7 in chips)
Seat 7: bmRtaIYKthN1F+B3JLZ3Jw ($20.70 in chips)
Seat 8: V+ivdLiYYuNr+thEXNextg ($33.50 in chips)
Seat 9: XNMDwbXt/Q4jM99AXnbJDw ($50 in chips)
cDNz32Scry3j+v2+kE3pHg: posts small blind $0.25
o4Jr+EJ272Vq/p5v7ZCBYA: is sitting out
IYd5zG8k7vdBNVHbHg2Pag: posts big blind $0.50
*** HOLE CARDS ***
SegjDnMxWMujiD57ESNL+g: folds
bmRtaIYKthN1F+B3JLZ3Jw: folds
o4Jr+EJ272Vq/p5v7ZCBYA leaves the table
V+ivdLiYYuNr+thEXNextg: folds
XNMDwbXt/Q4jM99AXnbJDw: folds
mj7PS7wCH4PAl7+eYTFs7A: folds
NnQCepdIR/AOUQn1yhYx6Q joins the table at seat #4
OWP/DOu+PlPK6ZZ3zYa0HA: folds
cDNz32Scry3j+v2+kE3pHg: raises $1 to $1.50
IYd5zG8k7vdBNVHbHg2Pag: folds
cDNz32Scry3j+v2+kE3pHg collected $1 from pot
cDNz32Scry3j+v2+kE3pHg: doesn't show hand
*** SUMMARY ***
Total pot $1 | Rake $0
Seat 1: mj7PS7wCH4PAl7+eYTFs7A folded before Flop (didn't bet)
Seat 2: OWP/DOu+PlPK6ZZ3zYa0HA (button) folded before Flop (didn't bet)
Seat 3: cDNz32Scry3j+v2+kE3pHg (small blind) collected ($1)
Seat 5: IYd5zG8k7vdBNVHbHg2Pag (big blind) folded before Flop
Seat 6: SegjDnMxWMujiD57ESNL+g folded before Flop (didn't bet)
Seat 7: bmRtaIYKthN1F+B3JLZ3Jw folded before Flop (didn't bet)
Seat 8: V+ivdLiYYuNr+thEXNextg folded before Flop (didn't bet)
Seat 9: XNMDwbXt/Q4jM99AXnbJDw folded before Flop (didn't bet)



PokerStars Game #59939841130:  Hold'em No Limit ($0.25/$0.50) - 2009/07/01 0:50:21 ET
Table '0eJtgVAXVvBgncFdcUpXcQ' 2-max Seat #2 is the button
Seat 1: Ag6DvxX4vbRheqsv2zXKTQ ($37.35 in chips)
Seat 2: KMc4R+K9ao4Ur3rF7NGe6Q ($15.20 in chips)
KMc4R+K9ao4Ur3rF7NGe6Q: posts small blind $0.25
Ag6DvxX4vbRheqsv2zXKTQ: posts big blind $0.50
*** HOLE CARDS ***
KMc4R+K9ao4Ur3rF7NGe6Q: calls $0.25
Ag6DvxX4vbRheqsv2zXKTQ: checks
*** FLOP *** [Kh 8h 3d]
Ag6DvxX4vbRheqsv2zXKTQ: checks
KMc4R+K9ao4Ur3rF7NGe6Q: bets $1.50
Ag6DvxX4vbRheqsv2zXKTQ: folds
KMc4R+K9ao4Ur3rF7NGe6Q collected $0.95 from pot
KMc4R+K9ao4Ur3rF7NGe6Q: doesn't show hand
*** SUMMARY ***
Total pot $1 | Rake $0.05
Board [Kh 8h 3d]
Seat 1: Ag6DvxX4vbRheqsv2zXKTQ (big blind) folded on the Flop
Seat 2: KMc4R+K9ao4Ur3rF7NGe6Q (button) (small blind) collected ($0.95)



PokerStars Game #59939841188:  Hold'em No Limit ($0.25/$0.50) - 2009/07/01 0:50:21 ET
Table 'E7bWJ45aoFXRpyRv2gw+Ig' 2-max Seat #1 is the button
Seat 1: FRkiRasEGlHUeLrEl+k/nA ($83 in chips)
Seat 2: 3Wro85I7472vJ4Wkpneo9A ($110.55 in chips)
FRkiRasEGlHUeLrEl+k/nA: posts small blind $0.25
3Wro85I7472vJ4Wkpneo9A: posts big blind $0.50
*** HOLE CARDS ***
FRkiRasEGlHUeLrEl+k/nA: calls $0.25
3Wro85I7472vJ4Wkpneo9A: checks
*** FLOP *** [6h 3s Js]
3Wro85I7472vJ4Wkpneo9A: bets $1
FRkiRasEGlHUeLrEl+k/nA: folds
3Wro85I7472vJ4Wkpneo9A collected $0.95 from pot
3Wro85I7472vJ4Wkpneo9A: doesn't show hand
*** SUMMARY ***
Total pot $1 | Rake $0.05
Board [6h 3s Js]
Seat 1: FRkiRasEGlHUeLrEl+k/nA (button) (small blind) folded on the Flop
Seat 2: 3Wro85I7472vJ4Wkpneo9A (big blind) collected ($0.95)



PokerStars Game #59939840848:  Hold'em No Limit ($0.25/$0.50) - 2009/07/01 0:50:21 ET
Table 'QOeVnLhwctF9UyV/beDi+A' 2-max Seat #2 is the button
Seat 1: bypIyrYcAAifLfhZpGlKLA ($72.70 in chips)
Seat 2: Ucrm3XtZmoONapW32SPhag ($9.10 in chips)
Ucrm3XtZmoONapW32SPhag: posts small blind $0.25
bypIyrYcAAifLfhZpGlKLA: posts big blind $0.50
*** HOLE CARDS ***
Ucrm3XtZmoONapW32SPhag: folds
bypIyrYcAAifLfhZpGlKLA collected $0.50 from pot
bypIyrYcAAifLfhZpGlKLA: doesn't show hand
*** SUMMARY ***
Total pot $0.50 | Rake $0
Seat 1: bypIyrYcAAifLfhZpGlKLA (big blind) collected ($0.50)
Seat 2: Ucrm3XtZmoONapW32SPhag (button) (small blind) folded before Flop



PokerStars Game #59939842616:  Hold'em No Limit ($0.25/$0.50) - 2009/07/01 0:50:24 ET
Table 'Vdlc9wqYcHTUhtdyN7CuJw' 2-max Seat #1 is the button
Seat 1: yBO+mXB6m/rCft2ErwGf/Q ($116 in chips)
Seat 2: NZ/5cxwnorKW2SNsWy1+8A ($9.50 in chips)
yBO+mXB6m/rCft2ErwGf/Q: posts small blind $0.25
NZ/5cxwnorKW2SNsWy1+8A: posts big blind $0.50
*** HOLE CARDS ***
yBO+mXB6m/rCft2ErwGf/Q: folds
NZ/5cxwnorKW2SNsWy1+8A collected $0.50 from pot
NZ/5cxwnorKW2SNsWy1+8A: doesn't show hand
*** SUMMARY ***
Total pot $0.50 | Rake $0
Seat 1: yBO+mXB6m/rCft2ErwGf/Q (button) (small blind) folded before Flop
Seat 2: NZ/5cxwnorKW2SNsWy1+8A (big blind) collected ($0.50)



PokerStars Game #59939843360:  Hold'em No Limit ($0.25/$0.50) - 2009/07/01 0:50:25 ET
Table 'EiNh8p/wGJ1FP575iMFnqg' 9-max Seat #4 is the button
Seat 1: r3ZqM1Mi0W3y4hOdssE+Sg ($45.85 in chips)
Seat 2: 8ehL7qlZzjgUh2H35iiWLw ($52.60 in chips)
Seat 3: ymLPoEIl7UL3TvZYmnadxQ ($50.85 in chips)
Seat 4: cMzaiXAM/ZAdNaEUu+LqhA ($54.95 in chips)
Seat 5: M+7+BTmX5vZatHVuoRB1nA ($81.05 in chips)
Seat 6: 3UmXLy3GfjC3EkOebduerQ ($66.85 in chips)
Seat 7: 997ViqAtWn1FPjJqcffwcA ($50 in chips)
Seat 9: NnQCepdIR/AOUQn1yhYx6Q ($9.25 in chips)
M+7+BTmX5vZatHVuoRB1nA: posts small blind $0.25
3UmXLy3GfjC3EkOebduerQ: posts big blind $0.50
mSD1pginDsyHG5PDfqzphw: sits out
*** HOLE CARDS ***
997ViqAtWn1FPjJqcffwcA: folds
NnQCepdIR/AOUQn1yhYx6Q: folds
r3ZqM1Mi0W3y4hOdssE+Sg: folds
8ehL7qlZzjgUh2H35iiWLw: folds
ymLPoEIl7UL3TvZYmnadxQ: folds
cMzaiXAM/ZAdNaEUu+LqhA: folds
M+7+BTmX5vZatHVuoRB1nA: calls $0.25
3UmXLy3GfjC3EkOebduerQ: checks
*** FLOP *** [Qd 4h 8d]
M+7+BTmX5vZatHVuoRB1nA: checks
3UmXLy3GfjC3EkOebduerQ: bets $0.75
M+7+BTmX5vZatHVuoRB1nA: raises $1.75 to $2.50
3UmXLy3GfjC3EkOebduerQ: folds
M+7+BTmX5vZatHVuoRB1nA collected $2.40 from pot
M+7+BTmX5vZatHVuoRB1nA: doesn't show hand
*** SUMMARY ***
Total pot $2.50 | Rake $0.10
Board [Qd 4h 8d]
Seat 1: r3ZqM1Mi0W3y4hOdssE+Sg folded before Flop (didn't bet)
Seat 2: 8ehL7qlZzjgUh2H35iiWLw folded before Flop (didn't bet)
Seat 3: ymLPoEIl7UL3TvZYmnadxQ folded before Flop (didn't bet)
Seat 4: cMzaiXAM/ZAdNaEUu+LqhA (button) folded before Flop (didn't bet)
Seat 5: M+7+BTmX5vZatHVuoRB1nA (small blind) collected ($2.40)
Seat 6: 3UmXLy3GfjC3EkOebduerQ (big blind) folded on the Flop
Seat 7: 997ViqAtWn1FPjJqcffwcA folded before Flop (didn't bet)
Seat 9: NnQCepdIR/AOUQn1yhYx6Q folded before Flop (didn't bet)



PokerStars Game #59939844148:  Hold'em No Limit ($0.25/$0.50) - 2009/07/01 0:50:26 ET
Table 'MJxeZCzYELxiIsyUZyT0jw' 6-max Seat #4 is the button
Seat 2: t3GiVMzqA9Svgr5Uol32cQ ($36.85 in chips)
Seat 3: JQZew0FjzS19kTjeNtrE+A ($58.25 in chips)
Seat 4: alGiiQP/wwtYnfuXII+sgw ($48.95 in chips)
Seat 5: 3jvoOXNtXE90w2BdfNZwZQ ($50 in chips)
Seat 6: TTx3CHxyi0SObcHyMJRp5w ($53.15 in chips)
3jvoOXNtXE90w2BdfNZwZQ: posts small blind $0.25
TTx3CHxyi0SObcHyMJRp5w: posts big blind $0.50
nOfdMHEXflgT86UgFWblAA: sits out
*** HOLE CARDS ***
t3GiVMzqA9Svgr5Uol32cQ: folds
JQZew0FjzS19kTjeNtrE+A: raises $1.50 to $2
alGiiQP/wwtYnfuXII+sgw: folds
3jvoOXNtXE90w2BdfNZwZQ: folds
TTx3CHxyi0SObcHyMJRp5w: calls $1.50
*** FLOP *** [Qd 8h Jd]
TTx3CHxyi0SObcHyMJRp5w: checks
JQZew0FjzS19kTjeNtrE+A: bets $2
TTx3CHxyi0SObcHyMJRp5w: folds
JQZew0FjzS19kTjeNtrE+A collected $4.05 from pot
*** SUMMARY ***
Total pot $4.25 | Rake $0.20
Board [Qd 8h Jd]
Seat 2: t3GiVMzqA9Svgr5Uol32cQ folded before Flop (didn't bet)
Seat 3: JQZew0FjzS19kTjeNtrE+A collected ($4.05)
Seat 4: alGiiQP/wwtYnfuXII+sgw (button) folded before Flop (didn't bet)
Seat 5: 3jvoOXNtXE90w2BdfNZwZQ (small blind) folded before Flop
Seat 6: TTx3CHxyi0SObcHyMJRp5w (big blind) folded on the Flop



PokerStars Game #59939844942:  Hold'em No Limit ($0.25/$0.50) - 2009/07/01 0:50:27 ET
Table 'QOeVnLhwctF9UyV/beDi+A' 2-max Seat #1 is the button
Seat 1: bypIyrYcAAifLfhZpGlKLA ($72.95 in chips)
Seat 2: Ucrm3XtZmoONapW32SPhag ($8.85 in chips)
bypIyrYcAAifLfhZpGlKLA: posts small blind $0.25
Ucrm3XtZmoONapW32SPhag: posts big blind $0.50
*** HOLE CARDS ***
bypIyrYcAAifLfhZpGlKLA: raises $0.50 to $1
Ucrm3XtZmoONapW32SPhag: folds
bypIyrYcAAifLfhZpGlKLA collected $1 from pot
bypIyrYcAAifLfhZpGlKLA: doesn't show hand
*** SUMMARY ***
Total pot $1 | Rake $0
Seat 1: bypIyrYcAAifLfhZpGlKLA (button) (small blind) collected ($1)
Seat 2: Ucrm3XtZmoONapW32SPhag (big blind) folded before Flop



PokerStars Game #59939845512:  Hold'em No Limit ($0.25/$0.50) - 2009/07/01 0:50:28 ET
Table 'fx6MqwfYAj/Rt86hBz2L3Q' 9-max Seat #1 is the button
Seat 1: SegjDnMxWMujiD57ESNL+g ($10 in chips)
Seat 3: iadBi5AEt7gTBXbDSSnMYQ ($47.70 in chips)
Seat 4: gPEN9Zp33YTm/mu9/SYP1w ($23.30 in chips)
Seat 5: iAISe3dVeua8PUn2wwgDHw ($34.50 in chips)
Seat 6: 5k9fvXD9suIgCxU4HLQjTw ($50.75 in chips)
Seat 7: SKnJuWHScqetA/qG5p+wCg ($30 in chips)
Seat 8: JYwJYYV9pM5KWdSiETl8rA ($29.25 in chips)
Seat 9: HZkVla4kK2SI42CVrPZ/ig ($11 in chips)
iadBi5AEt7gTBXbDSSnMYQ: posts small blind $0.25
gPEN9Zp33YTm/mu9/SYP1w: posts big blind $0.50
*** HOLE CARDS ***
iAISe3dVeua8PUn2wwgDHw: folds
5k9fvXD9suIgCxU4HLQjTw: folds
SKnJuWHScqetA/qG5p+wCg: calls $0.50
JYwJYYV9pM5KWdSiETl8rA: folds
HZkVla4kK2SI42CVrPZ/ig: folds
SegjDnMxWMujiD57ESNL+g: folds
iadBi5AEt7gTBXbDSSnMYQ: calls $0.25
gPEN9Zp33YTm/mu9/SYP1w: checks
*** FLOP *** [4d 5c Js]
iadBi5AEt7gTBXbDSSnMYQ: bets $1.50
gPEN9Zp33YTm/mu9/SYP1w: folds
SKnJuWHScqetA/qG5p+wCg: folds
iadBi5AEt7gTBXbDSSnMYQ collected $1.45 from pot
*** SUMMARY ***
Total pot $1.50 | Rake $0.05
Board [4d 5c Js]
Seat 1: SegjDnMxWMujiD57ESNL+g (button) folded before Flop (didn't bet)
Seat 3: iadBi5AEt7gTBXbDSSnMYQ (small blind) collected ($1.45)
Seat 4: gPEN9Zp33YTm/mu9/SYP1w (big blind) folded on the Flop
Seat 5: iAISe3dVeua8PUn2wwgDHw folded before Flop (didn't bet)
Seat 6: 5k9fvXD9suIgCxU4HLQjTw folded before Flop (didn't bet)
Seat 7: SKnJuWHScqetA/qG5p+wCg folded on the Flop
Seat 8: JYwJYYV9pM5KWdSiETl8rA folded before Flop (didn't bet)
Seat 9: HZkVla4kK2SI42CVrPZ/ig folded before Flop (didn't bet)



PokerStars Game #59939845930:  Hold'em No Limit ($0.25/$0.50) - 2009/07/01 0:50:29 ET
Table '+dXkOAQyS8j9PQZusUTMpg' 2-max Seat #2 is the button
Seat 1: XFa6sBGjP2gxoIvxR3fZIg ($62.45 in chips)
Seat 2: 5IBeOgaApY1Bvzv2P8X4EA ($139.60 in chips)
5IBeOgaApY1Bvzv2P8X4EA: posts small blind $0.25
XFa6sBGjP2gxoIvxR3fZIg: posts big blind $0.50
*** HOLE CARDS ***
5IBeOgaApY1Bvzv2P8X4EA: raises $1 to $1.50
XFa6sBGjP2gxoIvxR3fZIg: calls $1
*** FLOP *** [6d 3c As]
XFa6sBGjP2gxoIvxR3fZIg: checks
5IBeOgaApY1Bvzv2P8X4EA: bets $1.50
XFa6sBGjP2gxoIvxR3fZIg: folds
5IBeOgaApY1Bvzv2P8X4EA collected $2.85 from pot
5IBeOgaApY1Bvzv2P8X4EA: doesn't show hand
*** SUMMARY ***
Total pot $3 | Rake $0.15
Board [6d 3c As]
Seat 1: XFa6sBGjP2gxoIvxR3fZIg (big blind) folded on the Flop
Seat 2: 5IBeOgaApY1Bvzv2P8X4EA (button) (small blind) collected ($2.85)



PokerStars Game #59939846116:  Hold'em No Limit ($0.25/$0.50) - 2009/07/01 0:50:29 ET
Table 'GfL/No5u5PoEnU39lP5pQg' 6-max Seat #4 is the button
Seat 1: 1WUCqNG+p+vfWRTXNu4ljw ($60.75 in chips)
Seat 2: uVwggSetzp7d+eVgowO3vg ($64.45 in chips)
Seat 3: Ek4w9XqBXqK5jBUQeLedGw ($51.25 in chips)
Seat 4: r6u7MWSXF30/khcTYkrG9Q ($24.65 in chips)
Seat 5: M1KyQQvVPVuxqTAB8sR/zQ ($52.50 in chips)
Seat 6: kxPhs4ePFqMy52CInAJ2aw ($50 in chips)
M1KyQQvVPVuxqTAB8sR/zQ: posts small blind $0.25
kxPhs4ePFqMy52CInAJ2aw: posts big blind $0.50
*** HOLE CARDS ***
1WUCqNG+p+vfWRTXNu4ljw: folds
uVwggSetzp7d+eVgowO3vg: folds
Ek4w9XqBXqK5jBUQeLedGw: folds
r6u7MWSXF30/khcTYkrG9Q: folds
M1KyQQvVPVuxqTAB8sR/zQ: folds
kxPhs4ePFqMy52CInAJ2aw collected $0.50 from pot
kxPhs4ePFqMy52CInAJ2aw: doesn't show hand
*** SUMMARY ***
Total pot $0.50 | Rake $0
Seat 1: 1WUCqNG+p+vfWRTXNu4ljw folded before Flop (didn't bet)
Seat 2: uVwggSetzp7d+eVgowO3vg folded before Flop (didn't bet)
Seat 3: Ek4w9XqBXqK5jBUQeLedGw folded before Flop (didn't bet)
Seat 4: r6u7MWSXF30/khcTYkrG9Q (button) folded before Flop (didn't bet)
Seat 5: M1KyQQvVPVuxqTAB8sR/zQ (small blind) folded before Flop
Seat 6: kxPhs4ePFqMy52CInAJ2aw (big blind) collected ($0.50)



PokerStars Game #59939847076:  Hold'em No Limit ($0.25/$0.50) - 2009/07/01 0:50:31 ET
Table 'BCN5su+SsXiy1zRMJi0SJw' 6-max Seat #1 is the button
Seat 1: GxXV09ciXaOxyY2H5aMIIw ($28.75 in chips)
Seat 2: oU2kDCkT/gilYbHWrg7D8w ($31.75 in chips)
Seat 3: g+vwI6lMKpU2uteXSjOzVw ($17.55 in chips)
Seat 4: JY9CtoZTeav+mhWyxSSyJQ ($25.85 in chips)
Seat 5: IBNygaT1aa9Z1uPdJJilwA ($13.05 in chips)
Seat 6: b2symlOdL7+0c9Pj4N/KlA ($82.95 in chips)
oU2kDCkT/gilYbHWrg7D8w: posts small blind $0.25
g+vwI6lMKpU2uteXSjOzVw: posts big blind $0.50
*** HOLE CARDS ***
JY9CtoZTeav+mhWyxSSyJQ: folds
JY9CtoZTeav+mhWyxSSyJQ is sitting out
IBNygaT1aa9Z1uPdJJilwA: folds
b2symlOdL7+0c9Pj4N/KlA: folds
JY9CtoZTeav+mhWyxSSyJQ said, "gl all"
GxXV09ciXaOxyY2H5aMIIw: folds
JY9CtoZTeav+mhWyxSSyJQ has returned
JY9CtoZTeav+mhWyxSSyJQ is sitting out
oU2kDCkT/gilYbHWrg7D8w: calls $0.25
g+vwI6lMKpU2uteXSjOzVw: checks
*** FLOP *** [6d Jd 5h]
oU2kDCkT/gilYbHWrg7D8w: checks
g+vwI6lMKpU2uteXSjOzVw: checks
*** TURN *** [6d Jd 5h] [5s]
oU2kDCkT/gilYbHWrg7D8w: checks
g+vwI6lMKpU2uteXSjOzVw: checks
*** RIVER *** [6d Jd 5h 5s] [Tc]
oU2kDCkT/gilYbHWrg7D8w said, "thx"
oU2kDCkT/gilYbHWrg7D8w said, "gn"
oU2kDCkT/gilYbHWrg7D8w: bets $0.50
g+vwI6lMKpU2uteXSjOzVw: calls $0.50
*** SHOW DOWN ***
oU2kDCkT/gilYbHWrg7D8w: shows [Td 4c] (two pair, Tens and Fives)
g+vwI6lMKpU2uteXSjOzVw: shows [7c Th] (two pair, Tens and Fives)
oU2kDCkT/gilYbHWrg7D8w collected $1 from pot
g+vwI6lMKpU2uteXSjOzVw collected $0.95 from pot
*** SUMMARY ***
Total pot $2 | Rake $0.05
Board [6d Jd 5h 5s Tc]
Seat 1: GxXV09ciXaOxyY2H5aMIIw (button) folded before Flop (didn't bet)
Seat 2: oU2kDCkT/gilYbHWrg7D8w (small blind) showed [Td 4c] and won ($1) with two pair, Tens and Fives
Seat 3: g+vwI6lMKpU2uteXSjOzVw (big blind) showed [7c Th] and won ($0.95) with two pair, Tens and Fives
Seat 4: JY9CtoZTeav+mhWyxSSyJQ folded before Flop (didn't bet)
Seat 5: IBNygaT1aa9Z1uPdJJilwA folded before Flop (didn't bet)
Seat 6: b2symlOdL7+0c9Pj4N/KlA folded before Flop (didn't bet)



PokerStars Game #59939847164:  Hold'em No Limit ($0.25/$0.50) - 2009/07/01 0:50:31 ET
Table 'Vdlc9wqYcHTUhtdyN7CuJw' 2-max Seat #2 is the button
Seat 1: yBO+mXB6m/rCft2ErwGf/Q ($115.75 in chips)
Seat 2: NZ/5cxwnorKW2SNsWy1+8A ($9.75 in chips)
NZ/5cxwnorKW2SNsWy1+8A: posts small blind $0.25
yBO+mXB6m/rCft2ErwGf/Q: posts big blind $0.50
*** HOLE CARDS ***
NZ/5cxwnorKW2SNsWy1+8A: calls $0.25
yBO+mXB6m/rCft2ErwGf/Q: checks
*** FLOP *** [3d As 9s]
yBO+mXB6m/rCft2ErwGf/Q: checks
NZ/5cxwnorKW2SNsWy1+8A: checks
*** TURN *** [3d As 9s] [4d]
yBO+mXB6m/rCft2ErwGf/Q: checks
NZ/5cxwnorKW2SNsWy1+8A: checks
*** RIVER *** [3d As 9s 4d] [Jd]
yBO+mXB6m/rCft2ErwGf/Q: checks
NZ/5cxwnorKW2SNsWy1+8A: checks
*** SHOW DOWN ***
yBO+mXB6m/rCft2ErwGf/Q: shows [6h 8c] (high card Ace)
NZ/5cxwnorKW2SNsWy1+8A: shows [Ks 8d] (high card Ace - King kicker)
NZ/5cxwnorKW2SNsWy1+8A collected $0.95 from pot
*** SUMMARY ***
Total pot $1 | Rake $0.05
Board [3d As 9s 4d Jd]
Seat 1: yBO+mXB6m/rCft2ErwGf/Q (big blind) showed [6h 8c] and lost with high card Ace
Seat 2: NZ/5cxwnorKW2SNsWy1+8A (button) (small blind) showed [Ks 8d] and won ($0.95) with high card Ace



PokerStars Game #59939847496:  Hold'em No Limit ($0.25/$0.50) - 2009/07/01 0:50:31 ET
Table 'T/PgNWqVyY6lkldcBVXYJQ' 6-max Seat #6 is the button
Seat 1: +Pf9jTVizYlIo+woPvptfA ($77.50 in chips)
Seat 2: LvH4G7n+QSjT6NDaD3cREA ($54.25 in chips)
Seat 3: L3OcNO1bgdqDI46j67KQPQ ($50 in chips)
Seat 4: Ek4w9XqBXqK5jBUQeLedGw ($50 in chips)
Seat 6: cDzbog6kwmJp+LBeBq+iMQ ($21.20 in chips)
+Pf9jTVizYlIo+woPvptfA: posts small blind $0.25
LvH4G7n+QSjT6NDaD3cREA: posts big blind $0.50
of9mtXiD8G4Nx5p7hCbgqQ: sits out
*** HOLE CARDS ***
L3OcNO1bgdqDI46j67KQPQ: folds
Ek4w9XqBXqK5jBUQeLedGw: folds
cDzbog6kwmJp+LBeBq+iMQ: folds
+Pf9jTVizYlIo+woPvptfA: folds
LvH4G7n+QSjT6NDaD3cREA collected $0.50 from pot
LvH4G7n+QSjT6NDaD3cREA: doesn't show hand
*** SUMMARY ***
Total pot $0.50 | Rake $0
Seat 1: +Pf9jTVizYlIo+woPvptfA (small blind) folded before Flop
Seat 2: LvH4G7n+QSjT6NDaD3cREA (big blind) collected ($0.50)
Seat 3: L3OcNO1bgdqDI46j67KQPQ folded before Flop (didn't bet)
Seat 4: Ek4w9XqBXqK5jBUQeLedGw folded before Flop (didn't bet)
Seat 6: cDzbog6kwmJp+LBeBq+iMQ (button) folded before Flop (didn't bet)



PokerStars Game #59939847908:  Hold'em No Limit ($0.25/$0.50) - 2009/07/01 0:50:32 ET
Table 'eMxdLyFDf28E0wit6gm3Uw' 6-max Seat #6 is the button
Seat 3: dZcLsEI8iXkobBduRJ45Yw ($14.35 in chips)
Seat 4: 3jxEWvv2qK1HCXLj4khowQ ($42.80 in chips)
Seat 5: X0X97o2fDAPiGx6o1gahsw ($75.35 in chips)
Seat 6: nOfdMHEXflgT86UgFWblAA ($50 in chips)
dZcLsEI8iXkobBduRJ45Yw: posts small blind $0.25
3jxEWvv2qK1HCXLj4khowQ: posts big blind $0.50
*** HOLE CARDS ***
X0X97o2fDAPiGx6o1gahsw: raises $1 to $1.50
nOfdMHEXflgT86UgFWblAA: folds
dZcLsEI8iXkobBduRJ45Yw: folds
3jxEWvv2qK1HCXLj4khowQ: folds
X0X97o2fDAPiGx6o1gahsw collected $1.25 from pot
*** SUMMARY ***
Total pot $1.25 | Rake $0
Seat 3: dZcLsEI8iXkobBduRJ45Yw (small blind) folded before Flop
Seat 4: 3jxEWvv2qK1HCXLj4khowQ (big blind) folded before Flop
Seat 5: X0X97o2fDAPiGx6o1gahsw collected ($1.25)
Seat 6: nOfdMHEXflgT86UgFWblAA (button) folded before Flop (didn't bet)



PokerStars Game #59939848136:  Hold'em No Limit ($0.25/$0.50) - 2009/07/01 0:50:32 ET
Table 'c/CRn+68J3Y8KxD5g1ek2Q' 2-max Seat #2 is the button
Seat 1: 46qCyJ6evTkHo9al5sBMNA ($87.65 in chips)
Seat 2: BypVLsYQt3ePFm2xQL/dOA ($284.60 in chips)
BypVLsYQt3ePFm2xQL/dOA: posts small blind $0.25
46qCyJ6evTkHo9al5sBMNA: posts big blind $0.50
*** HOLE CARDS ***
BypVLsYQt3ePFm2xQL/dOA: calls $0.25
46qCyJ6evTkHo9al5sBMNA: checks
*** FLOP *** [Ad 9c Jd]
46qCyJ6evTkHo9al5sBMNA: checks
BypVLsYQt3ePFm2xQL/dOA: bets $2
46qCyJ6evTkHo9al5sBMNA: folds
BypVLsYQt3ePFm2xQL/dOA collected $0.95 from pot
BypVLsYQt3ePFm2xQL/dOA: doesn't show hand
*** SUMMARY ***
Total pot $1 | Rake $0.05
Board [Ad 9c Jd]
Seat 1: 46qCyJ6evTkHo9al5sBMNA (big blind) folded on the Flop
Seat 2: BypVLsYQt3ePFm2xQL/dOA (button) (small blind) collected ($0.95)



PokerStars Game #59939847786:  Hold'em No Limit ($0.25/$0.50) - 2009/07/01 0:50:32 ET
Table '37qXEp3oe+er5q4CZip9eQ' 6-max Seat #6 is the button
Seat 1: oqOqoO2AyCZenUghCxMDxw ($57.15 in chips)
Seat 2: 6wzJiRvp8HY6t+MQGnSIzA ($26.50 in chips)
Seat 3: Rt6KgtZ8YaJoTc3FPim00w ($100.35 in chips)
Seat 4: XsmE8nXMAAMFJbWaJTmHFw ($29.30 in chips)
Seat 5: VOmI0x4dDPnTESZd5B4d1Q ($43.65 in chips)
Seat 6: N50kln4negd8q7Mmoz1j4g ($19.30 in chips)
oqOqoO2AyCZenUghCxMDxw: posts small blind $0.25
6wzJiRvp8HY6t+MQGnSIzA: posts big blind $0.50
*** HOLE CARDS ***
Rt6KgtZ8YaJoTc3FPim00w: folds
XsmE8nXMAAMFJbWaJTmHFw: raises $1 to $1.50
VOmI0x4dDPnTESZd5B4d1Q: folds
N50kln4negd8q7Mmoz1j4g: folds
oqOqoO2AyCZenUghCxMDxw: folds
6wzJiRvp8HY6t+MQGnSIzA: calls $1
*** FLOP *** [4h 2c As]
6wzJiRvp8HY6t+MQGnSIzA: checks
XsmE8nXMAAMFJbWaJTmHFw: bets $2
6wzJiRvp8HY6t+MQGnSIzA: calls $2
*** TURN *** [4h 2c As] [5d]
6wzJiRvp8HY6t+MQGnSIzA: checks
XsmE8nXMAAMFJbWaJTmHFw: bets $3
6wzJiRvp8HY6t+MQGnSIzA: calls $3
*** RIVER *** [4h 2c As 5d] [2d]
6wzJiRvp8HY6t+MQGnSIzA: checks
XsmE8nXMAAMFJbWaJTmHFw: checks
*** SHOW DOWN ***
6wzJiRvp8HY6t+MQGnSIzA: shows [Ac 6d] (two pair, Aces and Deuces)
XsmE8nXMAAMFJbWaJTmHFw: shows [9c Ah] (two pair, Aces and Deuces - Nine kicker)
XsmE8nXMAAMFJbWaJTmHFw collected $12.65 from pot
*** SUMMARY ***
Total pot $13.25 | Rake $0.60
Board [4h 2c As 5d 2d]
Seat 1: oqOqoO2AyCZenUghCxMDxw (small blind) folded before Flop
Seat 2: 6wzJiRvp8HY6t+MQGnSIzA (big blind) showed [Ac 6d] and lost with two pair, Aces and Deuces
Seat 3: Rt6KgtZ8YaJoTc3FPim00w folded before Flop (didn't bet)
Seat 4: XsmE8nXMAAMFJbWaJTmHFw showed [9c Ah] and won ($12.65) with two pair, Aces and Deuces
Seat 5: VOmI0x4dDPnTESZd5B4d1Q folded before Flop (didn't bet)
Seat 6: N50kln4negd8q7Mmoz1j4g (button) folded before Flop (didn't bet)



PokerStars Game #59939849846:  Hold'em No Limit ($0.25/$0.50) - 2009/07/01 0:50:35 ET
Table 'QOeVnLhwctF9UyV/beDi+A' 2-max Seat #2 is the button
Seat 1: bypIyrYcAAifLfhZpGlKLA ($73.45 in chips)
Seat 2: Ucrm3XtZmoONapW32SPhag ($8.35 in chips)
Ucrm3XtZmoONapW32SPhag: posts small blind $0.25
bypIyrYcAAifLfhZpGlKLA: posts big blind $0.50
*** HOLE CARDS ***
Ucrm3XtZmoONapW32SPhag: raises $0.50 to $1
bypIyrYcAAifLfhZpGlKLA: calls $0.50
*** FLOP *** [2d 2c 8h]
bypIyrYcAAifLfhZpGlKLA: checks
Ucrm3XtZmoONapW32SPhag: bets $1
bypIyrYcAAifLfhZpGlKLA: calls $1
*** TURN *** [2d 2c 8h] [4h]
bypIyrYcAAifLfhZpGlKLA: bets $1
Ucrm3XtZmoONapW32SPhag: raises $5.35 to $6.35 and is all-in
bypIyrYcAAifLfhZpGlKLA: calls $5.35
*** RIVER *** [2d 2c 8h 4h] [4d]
*** SHOW DOWN ***
bypIyrYcAAifLfhZpGlKLA: shows [6h 2h] (a full house, Deuces full of Fours)
Ucrm3XtZmoONapW32SPhag: shows [7s 4s] (a full house, Fours full of Deuces)
Ucrm3XtZmoONapW32SPhag collected $16.20 from pot
*** SUMMARY ***
Total pot $16.70 | Rake $0.50
Board [2d 2c 8h 4h 4d]
Seat 1: bypIyrYcAAifLfhZpGlKLA (big blind) showed [6h 2h] and lost with a full house, Deuces full of Fours
Seat 2: Ucrm3XtZmoONapW32SPhag (button) (small blind) showed [7s 4s] and won ($16.20) with a full house, Fours full of Deuces



PokerStars Game #59939850746:  Hold'em No Limit ($0.25/$0.50) - 2009/07/01 0:50:36 ET
Table 'E7bWJ45aoFXRpyRv2gw+Ig' 2-max Seat #2 is the button
Seat 1: FRkiRasEGlHUeLrEl+k/nA ($82.50 in chips)
Seat 2: 3Wro85I7472vJ4Wkpneo9A ($111 in chips)
3Wro85I7472vJ4Wkpneo9A: posts small blind $0.25
FRkiRasEGlHUeLrEl+k/nA: posts big blind $0.50
*** HOLE CARDS ***
3Wro85I7472vJ4Wkpneo9A: folds
FRkiRasEGlHUeLrEl+k/nA collected $0.50 from pot
*** SUMMARY ***
Total pot $0.50 | Rake $0
Seat 1: FRkiRasEGlHUeLrEl+k/nA (big blind) collected ($0.50)
Seat 2: 3Wro85I7472vJ4Wkpneo9A (button) (small blind) folded before Flop



PokerStars Game #59939850394:  Hold'em No Limit ($0.25/$0.50) - 2009/07/01 0:50:36 ET
Table 'QOgaEqMcJ73pcUMMxoisUg' 6-max Seat #5 is the button
Seat 1: /olYG0EzMWzADIgH1y2ySQ ($25.75 in chips)
Seat 2: 4QfsCWthT/vSLirorNXqtg ($50 in chips)
Seat 3: Rt6KgtZ8YaJoTc3FPim00w ($95.55 in chips)
Seat 4: zAcsDhG/T128Vn7XGVSgKg ($50.85 in chips)
Seat 5: 6vNxrjjCl6FwfaaymM9jjg ($32.05 in chips)
GoVjFxr3C+JO9vtJH9+IcA will be allowed to play after the button
/olYG0EzMWzADIgH1y2ySQ: posts small blind $0.25
4QfsCWthT/vSLirorNXqtg: posts big blind $0.50
*** HOLE CARDS ***
Rt6KgtZ8YaJoTc3FPim00w: folds
zAcsDhG/T128Vn7XGVSgKg: folds
6vNxrjjCl6FwfaaymM9jjg: folds
/olYG0EzMWzADIgH1y2ySQ: calls $0.25
4QfsCWthT/vSLirorNXqtg: checks
*** FLOP *** [2s Jd 7d]
/olYG0EzMWzADIgH1y2ySQ: bets $0.50
4QfsCWthT/vSLirorNXqtg: folds
/olYG0EzMWzADIgH1y2ySQ collected $0.95 from pot
*** SUMMARY ***
Total pot $1 | Rake $0.05
Board [2s Jd 7d]
Seat 1: /olYG0EzMWzADIgH1y2ySQ (small blind) collected ($0.95)
Seat 2: 4QfsCWthT/vSLirorNXqtg (big blind) folded on the Flop
Seat 3: Rt6KgtZ8YaJoTc3FPim00w folded before Flop (didn't bet)
Seat 4: zAcsDhG/T128Vn7XGVSgKg folded before Flop (didn't bet)
Seat 5: 6vNxrjjCl6FwfaaymM9jjg (button) folded before Flop (didn't bet)



PokerStars Game #59939853968:  Hold'em No Limit ($0.25/$0.50) - 2009/07/01 0:50:41 ET
Table '0eJtgVAXVvBgncFdcUpXcQ' 2-max Seat #1 is the button
Seat 1: Ag6DvxX4vbRheqsv2zXKTQ ($36.85 in chips)
Seat 2: KMc4R+K9ao4Ur3rF7NGe6Q ($15.65 in chips)
Ag6DvxX4vbRheqsv2zXKTQ: posts small blind $0.25
KMc4R+K9ao4Ur3rF7NGe6Q: posts big blind $0.50
*** HOLE CARDS ***
Ag6DvxX4vbRheqsv2zXKTQ: raises $1 to $1.50
KMc4R+K9ao4Ur3rF7NGe6Q: folds
Ag6DvxX4vbRheqsv2zXKTQ collected $1 from pot
*** SUMMARY ***
Total pot $1 | Rake $0
Seat 1: Ag6DvxX4vbRheqsv2zXKTQ (button) (small blind) collected ($1)
Seat 2: KMc4R+K9ao4Ur3rF7NGe6Q (big blind) folded before Flop



PokerStars Game #59939854530:  Hold'em No Limit ($0.25/$0.50) - 2009/07/01 0:50:42 ET
Table '+dXkOAQyS8j9PQZusUTMpg' 2-max Seat #1 is the button
Seat 1: XFa6sBGjP2gxoIvxR3fZIg ($60.95 in chips)
Seat 2: 5IBeOgaApY1Bvzv2P8X4EA ($140.95 in chips)
XFa6sBGjP2gxoIvxR3fZIg: posts small blind $0.25
5IBeOgaApY1Bvzv2P8X4EA: posts big blind $0.50
*** HOLE CARDS ***
XFa6sBGjP2gxoIvxR3fZIg: raises $1 to $1.50
5IBeOgaApY1Bvzv2P8X4EA: folds
XFa6sBGjP2gxoIvxR3fZIg collected $1 from pot
*** SUMMARY ***
Total pot $1 | Rake $0
Seat 1: XFa6sBGjP2gxoIvxR3fZIg (button) (small blind) collected ($1)
Seat 2: 5IBeOgaApY1Bvzv2P8X4EA (big blind) folded before Flop



PokerStars Game #59939854344:  Hold'em No Limit ($0.25/$0.50) - 2009/07/01 0:50:42 ET
Table 'T/PgNWqVyY6lkldcBVXYJQ' 6-max Seat #1 is the button
Seat 1: +Pf9jTVizYlIo+woPvptfA ($77.25 in chips)
Seat 2: LvH4G7n+QSjT6NDaD3cREA ($54.50 in chips)
Seat 3: L3OcNO1bgdqDI46j67KQPQ ($50 in chips)
Seat 4: Ek4w9XqBXqK5jBUQeLedGw ($50 in chips)
Seat 6: cDzbog6kwmJp+LBeBq+iMQ ($21.20 in chips)
LvH4G7n+QSjT6NDaD3cREA: posts small blind $0.25
L3OcNO1bgdqDI46j67KQPQ: posts big blind $0.50
of9mtXiD8G4Nx5p7hCbgqQ: sits out
*** HOLE CARDS ***
Ek4w9XqBXqK5jBUQeLedGw: folds
cDzbog6kwmJp+LBeBq+iMQ: folds
cDzbog6kwmJp+LBeBq+iMQ leaves the table
+Pf9jTVizYlIo+woPvptfA: raises $1.50 to $2
LvH4G7n+QSjT6NDaD3cREA: folds
L3OcNO1bgdqDI46j67KQPQ: folds
+Pf9jTVizYlIo+woPvptfA collected $1.25 from pot
+Pf9jTVizYlIo+woPvptfA: doesn't show hand
*** SUMMARY ***
Total pot $1.25 | Rake $0
Seat 1: +Pf9jTVizYlIo+woPvptfA (button) collected ($1.25)
Seat 2: LvH4G7n+QSjT6NDaD3cREA (small blind) folded before Flop
Seat 3: L3OcNO1bgdqDI46j67KQPQ (big blind) folded before Flop
Seat 4: Ek4w9XqBXqK5jBUQeLedGw folded before Flop (didn't bet)
Seat 6: cDzbog6kwmJp+LBeBq+iMQ folded before Flop (didn't bet)



PokerStars Game #59939855130:  Hold'em No Limit ($0.25/$0.50) - 2009/07/01 0:50:43 ET
Table '5EmHi+fnatGQQShcNmzOZQ' 6-max Seat #3 is the button
Seat 3: TjmTe3bhs9dFz5gXX9x7Lw ($27.25 in chips)
Seat 4: 1b+2BbjMN8qhR1WPqdE9VQ ($60.65 in chips)
Seat 5: kxPhs4ePFqMy52CInAJ2aw ($48.35 in chips)
Seat 6: 686aeHikcJlgKkSuIFdcXQ ($135.95 in chips)
1b+2BbjMN8qhR1WPqdE9VQ: posts small blind $0.25
kxPhs4ePFqMy52CInAJ2aw: posts big blind $0.50
*** HOLE CARDS ***
686aeHikcJlgKkSuIFdcXQ: folds
TjmTe3bhs9dFz5gXX9x7Lw: folds
1b+2BbjMN8qhR1WPqdE9VQ: raises $1 to $1.50
kxPhs4ePFqMy52CInAJ2aw: calls $1
*** FLOP *** [Qd 5s 3d]
1b+2BbjMN8qhR1WPqdE9VQ: bets $2
HGzUMAFxR1k8+S4gfnB39w joins the table at seat #1
kxPhs4ePFqMy52CInAJ2aw: folds
1b+2BbjMN8qhR1WPqdE9VQ collected $2.85 from pot
1b+2BbjMN8qhR1WPqdE9VQ: doesn't show hand
*** SUMMARY ***
Total pot $3 | Rake $0.15
Board [Qd 5s 3d]
Seat 3: TjmTe3bhs9dFz5gXX9x7Lw (button) folded before Flop (didn't bet)
Seat 4: 1b+2BbjMN8qhR1WPqdE9VQ (small blind) collected ($2.85)
Seat 5: kxPhs4ePFqMy52CInAJ2aw (big blind) folded on the Flop
Seat 6: 686aeHikcJlgKkSuIFdcXQ folded before Flop (didn't bet)



PokerStars Game #59939854610:  Hold'em No Limit ($0.25/$0.50) - 2009/07/01 0:50:43 ET
Table 'E7bWJ45aoFXRpyRv2gw+Ig' 2-max Seat #1 is the button
Seat 1: FRkiRasEGlHUeLrEl+k/nA ($82.75 in chips)
Seat 2: 3Wro85I7472vJ4Wkpneo9A ($110.75 in chips)
FRkiRasEGlHUeLrEl+k/nA: posts small blind $0.25
3Wro85I7472vJ4Wkpneo9A: posts big blind $0.50
*** HOLE CARDS ***
FRkiRasEGlHUeLrEl+k/nA: raises $1 to $1.50
3Wro85I7472vJ4Wkpneo9A: folds
FRkiRasEGlHUeLrEl+k/nA collected $1 from pot
*** SUMMARY ***
Total pot $1 | Rake $0
Seat 1: FRkiRasEGlHUeLrEl+k/nA (button) (small blind) collected ($1)
Seat 2: 3Wro85I7472vJ4Wkpneo9A (big blind) folded before Flop



PokerStars Game #59939855756:  Hold'em No Limit ($0.25/$0.50) - 2009/07/01 0:50:44 ET
Table '99gCy/CZQwPIjZWH+BguQgE7bWJ45aoFXRpyRv2gw+Igeat #7 is the button
Seat 2: n6VQBu6crjYjy6DxNP1NZA ($30 in chips)
Seat 3: qEn9ijNGtuyTxamBf07hYg ($50 in chips)
Seat 4: bxLSulbgr8LmKNjOzw8URg ($61.45 in chips)
Seat 5: DSM67hHHq1XFoEOi9p8Alw ($47.50 in chips)
Seat 7: bfSq6LBw0UvxeM5yfuWC7w ($17.85 in chips)
Seat 8: 8ehL7qlZzjgUh2H35iiWLw ($51.25 in chips)
Seat 9: j3K/Jujr7PY4ZM2RZvlH6A ($93.40 in chips)
8ehL7qlZzjgUh2H35iiWLw: posts small blind $0.25
j3K/Jujr7PY4ZM2RZvlH6A: posts big blind $0.50
*** HOLE CARDS ***
n6VQBu6crjYjy6DxNP1NZA: calls $0.50
qEn9ijNGtuyTxamBf07hYg: folds
bxLSulbgr8LmKNjOzw8URg: folds
DSM67hHHq1XFoEOi9p8Alw: raises $1 to $1.50
bfSq6LBw0UvxeM5yfuWC7w: calls $1.50
8ehL7qlZzjgUh2H35iiWLw: raises $4.50 to $6
j3K/Jujr7PY4ZM2RZvlH6A: folds
n6VQBu6crjYjy6DxNP1NZA: folds
DSM67hHHq1XFoEOi9p8Alw: folds
bfSq6LBw0UvxeM5yfuWC7w: folds
8ehL7qlZzjgUh2H35iiWLw collected $5.50 from pot
8ehL7qlZzjgUh2H35iiWLw: doesn't show hand
*** SUMMARY ***
Total pot $5.50 | Rake $0
Seat 2: n6VQBu6crjYjy6DxNP1NZA folded before Flop
Seat 3: qEn9ijNGtuyTxamBf07hYg folded before Flop (didn't bet)
Seat 4: bxLSulbgr8LmKNjOzw8URg folded before Flop (didn't bet)
Seat 5: DSM67hHHq1XFoEOi9p8Alw folded before Flop
Seat 7: bfSq6LBw0UvxeM5yfuWC7w (button) folded before Flop
Seat 8: 8ehL7qlZzjgUh2H35iiWLw (small blind) collected ($5.50)
Seat 9: j3K/Jujr7PY4ZM2RZvlH6A (big blind) folded before Flop



PokerStars Game #59939856666:  Hold'em No Limit ($0.25/$0.50) - 2009/07/01 0:50:46 ET
Table 'GfL/No5u5PoEnU39lP5pQg' 6-max Seat #5 is the button
Seat 1: 1WUCqNG+p+vfWRTXNu4ljw ($60.75 in chips)
Seat 2: uVwggSetzp7d+eVgowO3vg ($64.45 in chips)
Seat 3: Ek4w9XqBXqK5jBUQeLedGw ($51.25 in chips)
Seat 4: r6u7MWSXF30/khcTYkrG9Q ($24.65 in chips)
Seat 5: M1KyQQvVPVuxqTAB8sR/zQ ($52.25 in chips)
Seat 6: kxPhs4ePFqMy52CInAJ2aw ($50.25 in chips)
kxPhs4ePFqMy52CInAJ2aw: posts small blind $0.25
1WUCqNG+p+vfWRTXNu4ljw: posts big blind $0.50
*** HOLE CARDS ***
uVwggSetzp7d+eVgowO3vg: folds
Ek4w9XqBXqK5jBUQeLedGw: folds
r6u7MWSXF30/khcTYkrG9Q: folds
M1KyQQvVPVuxqTAB8sR/zQ: folds
kxPhs4ePFqMy52CInAJ2aw: raises $1.50 to $2
1WUCqNG+p+vfWRTXNu4ljw: folds
kxPhs4ePFqMy52CInAJ2aw collected $1 from pot
kxPhs4ePFqMy52CInAJ2aw: doesn't show hand
*** SUMMARY ***
Total pot $1 | Rake $0
Seat 1: 1WUCqNG+p+vfWRTXNu4ljw (big blind) folded before Flop
Seat 2: uVwggSetzp7d+eVgowO3vg folded before Flop (didn't bet)
Seat 3: Ek4w9XqBXqK5jBUQeLedGw folded before Flop (didn't bet)
Seat 4: r6u7MWSXF30/khcTYkrG9Q folded before Flop (didn't bet)
Seat 5: M1KyQQvVPVuxqTAB8sR/zQ (button) folded before Flop (didn't bet)
Seat 6: kxPhs4ePFqMy52CInAJ2aw (small blind) collected ($1)



PokerStars Game #59939857720:  Hold'em No Limit ($0.25/$0.50) - 2009/07/01 0:50:47 ET
Table '0eJtgVAXVvBgncFdcUpXcQ' 2-max Seat #2 is the button
Seat 1: Ag6DvxX4vbRheqsv2zXKTQ ($37.35 in chips)
Seat 2: KMc4R+K9ao4Ur3rF7NGe6Q ($15.15 in chips)
KMc4R+K9ao4Ur3rF7NGe6Q: posts small blind $0.25
Ag6DvxX4vbRheqsv2zXKTQ: posts big blind $0.50
*** HOLE CARDS ***
KMc4R+K9ao4Ur3rF7NGe6Q: calls $0.25
Ag6DvxX4vbRheqsv2zXKTQ: checks
*** FLOP *** [Ad 9s 2s]
Ag6DvxX4vbRheqsv2zXKTQ: checks
KMc4R+K9ao4Ur3rF7NGe6Q: checks
*** TURN *** [Ad 9s 2s] [6h]
Ag6DvxX4vbRheqsv2zXKTQ: checks
KMc4R+K9ao4Ur3rF7NGe6Q: checks
*** RIVER *** [Ad 9s 2s 6h] [8s]
Ag6DvxX4vbRheqsv2zXKTQ: checks
KMc4R+K9ao4Ur3rF7NGe6Q: bets $2
Ag6DvxX4vbRheqsv2zXKTQ: folds
KMc4R+K9ao4Ur3rF7NGe6Q collected $0.95 from pot
KMc4R+K9ao4Ur3rF7NGe6Q: doesn't show hand
*** SUMMARY ***
Total pot $1 | Rake $0.05
Board [Ad 9s 2s 6h 8s]
Seat 1: Ag6DvxX4vbRheqsv2zXKTQ (big blind) folded on the River
Seat 2: KMc4R+K9ao4Ur3rF7NGe6Q (button) (small blind) collected ($0.95)



PokerStars Game #59939857736:  Hold'em No Limit ($0.25/$0.50) - 2009/07/01 0:50:47 ET
Table 'NCiXr0d5CEKBQr/cZgLhbA' 9-max Seat #5 is the button
Seat 1: pFtzb1sR4b0d1aw6aIRgDg ($50 in chips)
Seat 2: ulxuJchBV9iguXg0FUonfg ($49.75 in chips)
Seat 3: xZCXQSXlrZkp3pZizzVXCw ($52.25 in chips)
Seat 4: 5k9fvXD9suIgCxU4HLQjTw ($55.95 in chips)
Seat 5: zE9cVigS2nW/Ljy4K4bUQA ($35.95 in chips)
Seat 6: SKnJuWHScqetA/qG5p+wCg ($32.45 in chips)
Seat 7: M+7+BTmX5vZatHVuoRB1nA ($47.10 in chips)
Seat 8: 1MJUKc3cc0QmUoz1JZLR2w ($59 in chips)
Seat 9: 4WLZvqBn5qv5tds5kt5A1Q ($46.55 in chips)
SKnJuWHScqetA/qG5p+wCg: posts small blind $0.25
M+7+BTmX5vZatHVuoRB1nA: posts big blind $0.50
*** HOLE CARDS ***
1MJUKc3cc0QmUoz1JZLR2w: folds
4WLZvqBn5qv5tds5kt5A1Q: folds
pFtzb1sR4b0d1aw6aIRgDg: folds
ulxuJchBV9iguXg0FUonfg: calls $0.50
xZCXQSXlrZkp3pZizzVXCw: folds
5k9fvXD9suIgCxU4HLQjTw: folds
zE9cVigS2nW/Ljy4K4bUQA: folds
SKnJuWHScqetA/qG5p+wCg: raises $1.50 to $2
M+7+BTmX5vZatHVuoRB1nA: folds
ulxuJchBV9iguXg0FUonfg: calls $1.50
*** FLOP *** [4c 9s Tc]
SKnJuWHScqetA/qG5p+wCg: bets $2.50
ulxuJchBV9iguXg0FUonfg: folds
SKnJuWHScqetA/qG5p+wCg collected $4.30 from pot
*** SUMMARY ***
Total pot $4.50 | Rake $0.20
Board [4c 9s Tc]
Seat 1: pFtzb1sR4b0d1aw6aIRgDg folded before Flop (didn't bet)
Seat 2: ulxuJchBV9iguXg0FUonfg folded on the Flop
Seat 3: xZCXQSXlrZkp3pZizzVXCw folded before Flop (didn't bet)
Seat 4: 5k9fvXD9suIgCxU4HLQjTw folded before Flop (didn't bet)
Seat 5: zE9cVigS2nW/Ljy4K4bUQA (button) folded before Flop (didn't bet)
Seat 6: SKnJuWHScqetA/qG5p+wCg (small blind) collected ($4.30)
Seat 7: M+7+BTmX5vZatHVuoRB1nA (big blind) folded before Flop
Seat 8: 1MJUKc3cc0QmUoz1JZLR2w folded before Flop (didn't bet)
Seat 9: 4WLZvqBn5qv5tds5kt5A1Q folded before Flop (didn't bet)



PokerStars Game #59939858036:  Hold'em No Limit ($0.25/$0.50) - 2009/07/01 0:50:48 ET
Table 'lpxYasB1ClBSgTpCCITwhQ' 9-max Seat #3 is the button
Seat 1: mj7PS7wCH4PAl7+eYTFs7A ($47.15 in chips)
Seat 2: OWP/DOu+PlPK6ZZ3zYa0HA ($24.85 in chips)
Seat 3: cDNz32Scry3j+v2+kE3pHg ($50.50 in chips)
Seat 5: IYd5zG8k7vdBNVHbHg2Pag ($36.10 in chips)
Seat 6: SegjDnMxWMujiD57ESNL+g ($7 in chips)
Seat 7: bmRtaIYKthN1F+B3JLZ3Jw ($20.70 in chips)
Seat 8: V+ivdLiYYuNr+thEXNextg ($33.50 in chips)
Seat 9: XNMDwbXt/Q4jM99AXnbJDw ($50 in chips)
NnQCepdIR/AOUQn1yhYx6Q will be allowed to play after the button
IYd5zG8k7vdBNVHbHg2Pag: posts small blind $0.25
SegjDnMxWMujiD57ESNL+g: posts big blind $0.50
*** HOLE CARDS ***
bmRtaIYKthN1F+B3JLZ3Jw: folds
V+ivdLiYYuNr+thEXNextg: folds
XNMDwbXt/Q4jM99AXnbJDw: folds
mj7PS7wCH4PAl7+eYTFs7A: folds
OWP/DOu+PlPK6ZZ3zYa0HA: folds
cDNz32Scry3j+v2+kE3pHg: raises $1 to $1.50
IYd5zG8k7vdBNVHbHg2Pag: folds
SegjDnMxWMujiD57ESNL+g: folds
cDNz32Scry3j+v2+kE3pHg collected $1.25 from pot
cDNz32Scry3j+v2+kE3pHg: doesn't show hand
*** SUMMARY ***
Total pot $1.25 | Rake $0
Seat 1: mj7PS7wCH4PAl7+eYTFs7A folded before Flop (didn't bet)
Seat 2: OWP/DOu+PlPK6ZZ3zYa0HA folded before Flop (didn't bet)
Seat 3: cDNz32Scry3j+v2+kE3pHg (button) collected ($1.25)
Seat 5: IYd5zG8k7vdBNVHbHg2Pag (small blind) folded before Flop
Seat 6: SegjDnMxWMujiD57ESNL+g (big blind) folded before Flop
Seat 7: bmRtaIYKthN1F+B3JLZ3Jw folded before Flop (didn't bet)
Seat 8: V+ivdLiYYuNr+thEXNextg folded before Flop (didn't bet)
Seat 9: XNMDwbXt/Q4jM99AXnbJDw folded before Flop (didn't bet)



PokerStars Game #59939859422:  Hold'em No Limit ($0.25/$0.50) - 2009/07/01 0:50:50 ET
Table '3FhG0gl3kMX3wBEEqj+wnQ' 9-max Seat #1 is the button
Seat 1: e0J9pdCNUDTCG031RnXqLA ($32.30 in chips)
Seat 2: 7cYQ+syUWjl38ty/ICOMhw ($49.50 in chips)
Seat 4: bjvJtA9Hqscfznq66txaOQ ($10.70 in chips)
Seat 5: gsyXT42WLEcOS4DdEk2wlw ($27.75 in chips)
Seat 6: 997ViqAtWn1FPjJqcffwcA ($50 in chips)
Seat 7: mSD1pginDsyHG5PDfqzphw ($10.25 in chips)
Seat 8: j3K/Jujr7PY4ZM2RZvlH6A ($60.95 in chips)
Seat 9: L5e2lrPLQm1Pqx30IIZ/Fw ($10.50 in chips)
7cYQ+syUWjl38ty/ICOMhw: posts small blind $0.25
bjvJtA9Hqscfznq66txaOQ: posts big blind $0.50
*** HOLE CARDS ***
gsyXT42WLEcOS4DdEk2wlw: folds
997ViqAtWn1FPjJqcffwcA: folds
mSD1pginDsyHG5PDfqzphw: folds
j3K/Jujr7PY4ZM2RZvlH6A: folds
L5e2lrPLQm1Pqx30IIZ/Fw: folds
e0J9pdCNUDTCG031RnXqLA: raises $0.50 to $1
7cYQ+syUWjl38ty/ICOMhw: calls $0.75
bjvJtA9Hqscfznq66txaOQ: folds
*** FLOP *** [Kc 2h 3c]
7cYQ+syUWjl38ty/ICOMhw: checks
e0J9pdCNUDTCG031RnXqLA: checks
*** TURN *** [Kc 2h 3c] [8c]
7cYQ+syUWjl38ty/ICOMhw: bets $1.50
e0J9pdCNUDTCG031RnXqLA: folds
7cYQ+syUWjl38ty/ICOMhw collected $2.40 from pot
*** SUMMARY ***
Total pot $2.50 | Rake $0.10
Board [Kc 2h 3c 8c]
Seat 1: e0J9pdCNUDTCG031RnXqLA (button) folded on the Turn
Seat 2: 7cYQ+syUWjl38ty/ICOMhw (small blind) collected ($2.40)
Seat 4: bjvJtA9Hqscfznq66txaOQ (big blind) folded before Flop
Seat 5: gsyXT42WLEcOS4DdEk2wlw folded before Flop (didn't bet)
Seat 6: 997ViqAtWn1FPjJqcffwcA folded before Flop (didn't bet)
Seat 7: mSD1pginDsyHG5PDfqzphw folded before Flop (didn't bet)
Seat 8: j3K/Jujr7PY4ZM2RZvlH6A folded before Flop (didn't bet)
Seat 9: L5e2lrPLQm1Pqx30IIZ/Fw folded before Flop (didn't bet)



PokerStars Game #59939859556:  Hold'em No Limit ($0.25/$0.50) - 2009/07/01 0:50:50 ET
Table '+dXkOAQyS8j9PQZusUTMpg' 2-max Seat #2 is the button
Seat 1: XFa6sBGjP2gxoIvxR3fZIg ($61.45 in chips)
Seat 2: 5IBeOgaApY1Bvzv2P8X4EA ($140.45 in chips)
5IBeOgaApY1Bvzv2P8X4EA: posts small blind $0.25
XFa6sBGjP2gxoIvxR3fZIg: posts big blind $0.50
*** HOLE CARDS ***
5IBeOgaApY1Bvzv2P8X4EA: calls $0.25
XFa6sBGjP2gxoIvxR3fZIg: checks
*** FLOP *** [3d 3h Jc]
XFa6sBGjP2gxoIvxR3fZIg: checks
5IBeOgaApY1Bvzv2P8X4EA: checks
*** TURN *** [3d 3h Jc] [5s]
XFa6sBGjP2gxoIvxR3fZIg: checks
5IBeOgaApY1Bvzv2P8X4EA: checks
*** RIVER *** [3d 3h Jc 5s] [7s]
XFa6sBGjP2gxoIvxR3fZIg: bets $0.50
5IBeOgaApY1Bvzv2P8X4EA: folds
XFa6sBGjP2gxoIvxR3fZIg collected $0.95 from pot
*** SUMMARY ***
Total pot $1 | Rake $0.05
Board [3d 3h Jc 5s 7s]
Seat 1: XFa6sBGjP2gxoIvxR3fZIg (big blind) collected ($0.95)
Seat 2: 5IBeOgaApY1Bvzv2P8X4EA (button) (small blind) folded on the River



PokerStars Game #59939860262:  Hold'em No Limit ($0.25/$0.50) - 2009/07/01 0:50:51 ET
Table 'Vdlc9wqYcHTUhtdyN7CuJw' 2-max Seat #1 is the button
Seat 1: yBO+mXB6m/rCft2ErwGf/Q ($115.25 in chips)
Seat 2: NZ/5cxwnorKW2SNsWy1+8A ($10.20 in chips)
yBO+mXB6m/rCft2ErwGf/Q: posts small blind $0.25
NZ/5cxwnorKW2SNsWy1+8A: posts big blind $0.50
*** HOLE CARDS ***
yBO+mXB6m/rCft2ErwGf/Q: calls $0.25
NZ/5cxwnorKW2SNsWy1+8A: checks
*** FLOP *** [Tc Qs 5s]
NZ/5cxwnorKW2SNsWy1+8A: checks
yBO+mXB6m/rCft2ErwGf/Q: checks
*** TURN *** [Tc Qs 5s] [7s]
NZ/5cxwnorKW2SNsWy1+8A: checks
yBO+mXB6m/rCft2ErwGf/Q: checks
*** RIVER *** [Tc Qs 5s 7s] [Kc]
NZ/5cxwnorKW2SNsWy1+8A: checks
yBO+mXB6m/rCft2ErwGf/Q: checks
*** SHOW DOWN ***
NZ/5cxwnorKW2SNsWy1+8A: shows [8c 6d] (high card King)
yBO+mXB6m/rCft2ErwGf/Q: shows [4c 8d] (high card King)
NZ/5cxwnorKW2SNsWy1+8A collected $0.50 from pot
yBO+mXB6m/rCft2ErwGf/Q collected $0.45 from pot
*** SUMMARY ***
Total pot $1 | Rake $0.05
Board [Tc Qs 5s 7s Kc]
Seat 1: yBO+mXB6m/rCft2ErwGf/Q (button) (small blind) showed [4c 8d] and won ($0.45) with high card King
Seat 2: NZ/5cxwnorKW2SNsWy1+8A (big blind) showed [8c 6d] and won ($0.50) with high card King



PokerStars Game #59939860318:  Hold'em No Limit ($0.25/$0.50) - 2009/07/01 0:50:52 ET
Table 'c/CRn+68J3Y8KxD5g1ek2Q' 2-max Seat #1 is the button
Seat 1: 46qCyJ6evTkHo9al5sBMNA ($87.15 in chips)
Seat 2: BypVLsYQt3ePFm2xQL/dOA ($285.05 in chips)
46qCyJ6evTkHo9al5sBMNA: posts small blind $0.25
BypVLsYQt3ePFm2xQL/dOA: posts big blind $0.50
*** HOLE CARDS ***
46qCyJ6evTkHo9al5sBMNA: raises $1 to $1.50
BypVLsYQt3ePFm2xQL/dOA: folds
46qCyJ6evTkHo9al5sBMNA collected $1 from pot
46qCyJ6evTkHo9al5sBMNA: doesn't show hand
*** SUMMARY ***
Total pot $1 | Rake $0
Seat 1: 46qCyJ6evTkHo9al5sBMNA (button) (small blind) collected ($1)
Seat 2: BypVLsYQt3ePFm2xQL/dOA (big blind) folded before Flop



PokerStars Game #59939863614:  Hold'em No Limit ($0.25/$0.50) - 2009/07/01 0:50:56 ET
Table 'E7bWJ45aoFXRpyRv2gw+Ig' 2-max Seat #2 is the button
Seat 1: FRkiRasEGlHUeLrEl+k/nA ($83.25 in chips)
Seat 2: 3Wro85I7472vJ4Wkpneo9A ($110.25 in chips)
3Wro85I7472vJ4Wkpneo9A: posts small blind $0.25
FRkiRasEGlHUeLrEl+k/nA: posts big blind $0.50
*** HOLE CARDS ***
3Wro85I7472vJ4Wkpneo9A: raises $1 to $1.50
FRkiRasEGlHUeLrEl+k/nA: calls $1
*** FLOP *** [3s 2s Qs]
FRkiRasEGlHUeLrEl+k/nA: bets $1.50
3Wro85I7472vJ4Wkpneo9A: raises $3.50 to $5
FRkiRasEGlHUeLrEl+k/nA: raises $8.50 to $13.50
3Wro85I7472vJ4Wkpneo9A: calls $8.50
*** TURN *** [3s 2s Qs] [7s]
FRkiRasEGlHUeLrEl+k/nA: checks
3Wro85I7472vJ4Wkpneo9A: checks
*** RIVER *** [3s 2s Qs 7s] [Th]
FRkiRasEGlHUeLrEl+k/nA: checks
3Wro85I7472vJ4Wkpneo9A: bets $10
FRkiRasEGlHUeLrEl+k/nA: calls $10
*** SHOW DOWN ***
3Wro85I7472vJ4Wkpneo9A: shows [2h 2c] (three of a kind, Deuces)
FRkiRasEGlHUeLrEl+k/nA: shows [8s 5s] (a flush, Queen high)
FRkiRasEGlHUeLrEl+k/nA collected $49.50 from pot
*** SUMMARY ***
Total pot $50 | Rake $0.50
Board [3s 2s Qs 7s Th]
Seat 1: FRkiRasEGlHUeLrEl+k/nA (big blind) showed [8s 5s] and won ($49.50) with a flush, Queen high
Seat 2: 3Wro85I7472vJ4Wkpneo9A (button) (small blind) showed [2h 2c] and lost with three of a kind, Deuces



PokerStars Game #59939863170:  Hold'em No Limit ($0.25/$0.50) - 2009/07/01 0:50:56 ET
Table 'MJxeZCzYELxiIsyUZyT0jw' 6-max Seat #5 is the button
Seat 1: nOfdMHEXflgT86UgFWblAA ($50 in chips)
Seat 2: t3GiVMzqA9Svgr5Uol32cQ ($36.85 in chips)
Seat 3: JQZew0FjzS19kTjeNtrE+A ($60.30 in chips)
Seat 4: alGiiQP/wwtYnfuXII+sgw ($48.95 in chips)
Seat 5: 3jvoOXNtXE90w2BdfNZwZQ ($50 in chips)
Seat 6: TTx3CHxyi0SObcHyMJRp5w ($51.15 in chips)
TTx3CHxyi0SObcHyMJRp5w: posts small blind $0.25
nOfdMHEXflgT86UgFWblAA: posts big blind $0.50
*** HOLE CARDS ***
t3GiVMzqA9Svgr5Uol32cQ: folds
JQZew0FjzS19kTjeNtrE+A: folds
alGiiQP/wwtYnfuXII+sgw: folds
3jvoOXNtXE90w2BdfNZwZQ: raises $1 to $1.50
TTx3CHxyi0SObcHyMJRp5w: folds
nOfdMHEXflgT86UgFWblAA: folds
3jvoOXNtXE90w2BdfNZwZQ collected $1.25 from pot
3jvoOXNtXE90w2BdfNZwZQ: doesn't show hand
*** SUMMARY ***
Total pot $1.25 | Rake $0
Seat 1: nOfdMHEXflgT86UgFWblAA (big blind) folded before Flop
Seat 2: t3GiVMzqA9Svgr5Uol32cQ folded before Flop (didn't bet)
Seat 3: JQZew0FjzS19kTjeNtrE+A folded before Flop (didn't bet)
Seat 4: alGiiQP/wwtYnfuXII+sgw folded before Flop (didn't bet)
Seat 5: 3jvoOXNtXE90w2BdfNZwZQ (button) collected ($1.25)
Seat 6: TTx3CHxyi0SObcHyMJRp5w (small blind) folded before Flop



PokerStars Game #59939864268:  Hold'em No Limit ($0.25/$0.50) - 2009/07/01 0:50:57 ET
Table 'ibNfFy0bCzuBaUORla0aGw' 9-max Seat #3 is the button
Seat 1: xZCXQSXlrZkp3pZizzVXCw ($53.20 in chips)
Seat 2: 90Wb75h3W1BRpbqVnuk8gw ($51.40 in chips)
Seat 3: AjV5McH1KMMclY26QdLM5w ($25 in chips)
Seat 4: YBN054X4blmis+B2bBlC0g ($23.70 in chips)
Seat 5: GIJAc9kPrLZHLSX8Q6i99w ($25.40 in chips)
Seat 6: 8n9jQLh3cZKbsmr5PIjgiQ ($43.25 in chips)
Seat 7: HZkVla4kK2SI42CVrPZ/ig ($14.30 in chips)
Seat 8: xUrN9TWLq4m5V+OXY7KUUA ($50.45 in chips)
Seat 9: pFtzb1sR4b0d1aw6aIRgDg ($50 in chips)
YBN054X4blmis+B2bBlC0g: posts small blind $0.25
GIJAc9kPrLZHLSX8Q6i99w: posts big blind $0.50
*** HOLE CARDS ***
8n9jQLh3cZKbsmr5PIjgiQ: calls $0.50
HZkVla4kK2SI42CVrPZ/ig: folds
xUrN9TWLq4m5V+OXY7KUUA: folds
pFtzb1sR4b0d1aw6aIRgDg: folds
xZCXQSXlrZkp3pZizzVXCw: raises $2 to $2.50
90Wb75h3W1BRpbqVnuk8gw: folds
AjV5McH1KMMclY26QdLM5w: folds
YBN054X4blmis+B2bBlC0g: folds
GIJAc9kPrLZHLSX8Q6i99w: folds
8n9jQLh3cZKbsmr5PIjgiQ: calls $2
*** FLOP *** [Qs Jh Ah]
8n9jQLh3cZKbsmr5PIjgiQ: checks
xZCXQSXlrZkp3pZizzVXCw: bets $4
8n9jQLh3cZKbsmr5PIjgiQ: raises $4 to $8
xZCXQSXlrZkp3pZizzVXCw: raises $11.50 to $19.50
8n9jQLh3cZKbsmr5PIjgiQ: raises $21.25 to $40.75 and is all-in
xZCXQSXlrZkp3pZizzVXCw: calls $21.25
*** TURN *** [Qs Jh Ah] [Tc]
*** RIVER *** [Qs Jh Ah Tc] [Kc]
*** SHOW DOWN ***
8n9jQLh3cZKbsmr5PIjgiQ: shows [Ac Jc] (a straight, Ten to Ace)
xZCXQSXlrZkp3pZizzVXCw: shows [As Ad] (a straight, Ten to Ace)
8n9jQLh3cZKbsmr5PIjgiQ collected $42.15 from pot
xZCXQSXlrZkp3pZizzVXCw collected $42.10 from pot
*** SUMMARY ***
Total pot $87.25 | Rake $3
Board [Qs Jh Ah Tc Kc]
Seat 1: xZCXQSXlrZkp3pZizzVXCw showed [As Ad] and won ($42.10) with a straight, Ten to Ace
Seat 2: 90Wb75h3W1BRpbqVnuk8gw folded before Flop (didn't bet)
Seat 3: AjV5McH1KMMclY26QdLM5w (button) folded before Flop (didn't bet)
Seat 4: YBN054X4blmis+B2bBlC0g (small blind) folded before Flop
Seat 5: GIJAc9kPrLZHLSX8Q6i99w (big blind) folded before Flop
Seat 6: 8n9jQLh3cZKbsmr5PIjgiQ showed [Ac Jc] and won ($42.15) with a straight, Ten to Ace
Seat 7: HZkVla4kK2SI42CVrPZ/ig folded before Flop (didn't bet)
Seat 8: xUrN9TWLq4m5V+OXY7KUUA folded before Flop (didn't bet)
Seat 9: pFtzb1sR4b0d1aw6aIRgDg folded before Flop (didn't bet)



PokerStars Game #59939864192:  Hold'em No Limit ($0.25/$0.50) - 2009/07/01 0:50:57 ET
Table 'T/PgNWqVyY6lkldcBVXYJQ' 6-max Seat #2 is the button
Seat 1: +Pf9jTVizYlIo+woPvptfA ($78 in chips)
Seat 2: LvH4G7n+QSjT6NDaD3cREA ($54.25 in chips)
Seat 3: L3OcNO1bgdqDI46j67KQPQ ($50 in chips)
Seat 4: Ek4w9XqBXqK5jBUQeLedGw ($50 in chips)
L3OcNO1bgdqDI46j67KQPQ: posts small blind $0.25
Ek4w9XqBXqK5jBUQeLedGw: posts big blind $0.50
of9mtXiD8G4Nx5p7hCbgqQ: sits out
*** HOLE CARDS ***
+Pf9jTVizYlIo+woPvptfA: folds
LvH4G7n+QSjT6NDaD3cREA: raises $1.50 to $2
L3OcNO1bgdqDI46j67KQPQ: folds
Ek4w9XqBXqK5jBUQeLedGw: folds
LvH4G7n+QSjT6NDaD3cREA collected $1.25 from pot
LvH4G7n+QSjT6NDaD3cREA: doesn't show hand
*** SUMMARY ***
Total pot $1.25 | Rake $0
Seat 1: +Pf9jTVizYlIo+woPvptfA folded before Flop (didn't bet)
Seat 2: LvH4G7n+QSjT6NDaD3cREA (button) collected ($1.25)
Seat 3: L3OcNO1bgdqDI46j67KQPQ (small blind) folded before Flop
Seat 4: Ek4w9XqBXqK5jBUQeLedGw (big blind) folded before Flop



PokerStars Game #59939866090:  Hold'em No Limit ($0.25/$0.50) - 2009/07/01 0:51:00 ET
Table 'X6IRCRTh+20gjz8aubWnwA' 9-max Seat #7 is the button
Seat 1: DSM67hHHq1XFoEOi9p8Alw ($50.05 in chips)
Seat 2: HZkVla4kK2SI42CVrPZ/ig ($8.55 in chips)
Seat 3: SWv01peOe69QQRvhQTqjQw ($13.40 in chips)
Seat 4: 2J+UVOVrW+V3maOylyxMcQ ($37.60 in chips)
Seat 5: NnQCepdIR/AOUQn1yhYx6Q ($10 in chips)
Seat 7: cFHQjKQOOKTUzoilhrXHLg ($52.75 in chips)
Seat 8: HxeBVq06/3Bh/H986sgdbw ($10.65 in chips)
Seat 9: M+7+BTmX5vZatHVuoRB1nA ($52.50 in chips)
HxeBVq06/3Bh/H986sgdbw: posts small blind $0.25
M+7+BTmX5vZatHVuoRB1nA: posts big blind $0.50
75K2MXwN65Sjfp1yHd50Hg: sits out
*** HOLE CARDS ***
DSM67hHHq1XFoEOi9p8Alw: folds
HZkVla4kK2SI42CVrPZ/ig: folds
SWv01peOe69QQRvhQTqjQw: folds
2J+UVOVrW+V3maOylyxMcQ: calls $0.50
NnQCepdIR/AOUQn1yhYx6Q: folds
cFHQjKQOOKTUzoilhrXHLg: calls $0.50
HxeBVq06/3Bh/H986sgdbw: calls $0.25
M+7+BTmX5vZatHVuoRB1nA: checks
*** FLOP *** [Qh Ac Td]
HxeBVq06/3Bh/H986sgdbw: checks
M+7+BTmX5vZatHVuoRB1nA: checks
2J+UVOVrW+V3maOylyxMcQ: checks
cFHQjKQOOKTUzoilhrXHLg: checks
*** TURN *** [Qh Ac Td] [8s]
HxeBVq06/3Bh/H986sgdbw: checks
M+7+BTmX5vZatHVuoRB1nA: bets $1
2J+UVOVrW+V3maOylyxMcQ: raises $1 to $2
cFHQjKQOOKTUzoilhrXHLg: folds
HxeBVq06/3Bh/H986sgdbw: folds
M+7+BTmX5vZatHVuoRB1nA: calls $1
*** RIVER *** [Qh Ac Td 8s] [Qs]
M+7+BTmX5vZatHVuoRB1nA: checks
2J+UVOVrW+V3maOylyxMcQ: bets $3
M+7+BTmX5vZatHVuoRB1nA: calls $3
*** SHOW DOWN ***
2J+UVOVrW+V3maOylyxMcQ: shows [8d Qc] (a full house, Queens full of Eights)
M+7+BTmX5vZatHVuoRB1nA: mucks hand
2J+UVOVrW+V3maOylyxMcQ collected $11.45 from pot
*** SUMMARY ***
Total pot $12 | Rake $0.55
Board [Qh Ac Td 8s Qs]
Seat 1: DSM67hHHq1XFoEOi9p8Alw folded before Flop (didn't bet)
Seat 2: HZkVla4kK2SI42CVrPZ/ig folded before Flop (didn't bet)
Seat 3: SWv01peOe69QQRvhQTqjQw folded before Flop (didn't bet)
Seat 4: 2J+UVOVrW+V3maOylyxMcQ showed [8d Qc] and won ($11.45) with a full house, Queens full of Eights
Seat 5: NnQCepdIR/AOUQn1yhYx6Q folded before Flop (didn't bet)
Seat 7: cFHQjKQOOKTUzoilhrXHLg (button) folded on the Turn
Seat 8: HxeBVq06/3Bh/H986sgdbw (small blind) folded on the Turn
Seat 9: M+7+BTmX5vZatHVuoRB1nA (big blind) mucked



PokerStars Game #59939869118:  Hold'em No Limit ($0.25/$0.50) - 2009/07/01 0:51:05 ET
Table 'fx6MqwfYAj/Rt86hBz2L3Q' 9-max Seat #3 is the button
Seat 1: SegjDnMxWMujiD57ESNL+g ($10 in chips)
Seat 3: iadBi5AEt7gTBXbDSSnMYQ ($48.65 in chips)
Seat 4: gPEN9Zp33YTm/mu9/SYP1w ($22.80 in chips)
Seat 5: iAISe3dVeua8PUn2wwgDHw ($34.50 in chips)
Seat 6: 5k9fvXD9suIgCxU4HLQjTw ($50.75 in chips)
Seat 7: SKnJuWHScqetA/qG5p+wCg ($30 in chips)
Seat 8: JYwJYYV9pM5KWdSiETl8rA ($29.25 in chips)
Seat 9: HZkVla4kK2SI42CVrPZ/ig ($11 in chips)
gPEN9Zp33YTm/mu9/SYP1w: posts small blind $0.25
iAISe3dVeua8PUn2wwgDHw: posts big blind $0.50
*** HOLE CARDS ***
5k9fvXD9suIgCxU4HLQjTw: folds
SKnJuWHScqetA/qG5p+wCg: folds
JYwJYYV9pM5KWdSiETl8rA: raises $1.50 to $2
HZkVla4kK2SI42CVrPZ/ig: folds
SegjDnMxWMujiD57ESNL+g: folds
iadBi5AEt7gTBXbDSSnMYQ: calls $2
gPEN9Zp33YTm/mu9/SYP1w: folds
iAISe3dVeua8PUn2wwgDHw: calls $1.50
*** FLOP *** [7h 6c 2c]
iAISe3dVeua8PUn2wwgDHw: checks
JYwJYYV9pM5KWdSiETl8rA: checks
iadBi5AEt7gTBXbDSSnMYQ: bets $12
iAISe3dVeua8PUn2wwgDHw: folds
JYwJYYV9pM5KWdSiETl8rA: folds
iadBi5AEt7gTBXbDSSnMYQ collected $5.95 from pot
iadBi5AEt7gTBXbDSSnMYQ: doesn't show hand
*** SUMMARY ***
Total pot $6.25 | Rake $0.30
Board [7h 6c 2c]
Seat 1: SegjDnMxWMujiD57ESNL+g folded before Flop (didn't bet)
Seat 3: iadBi5AEt7gTBXbDSSnMYQ (button) collected ($5.95)
Seat 4: gPEN9Zp33YTm/mu9/SYP1w (small blind) folded before Flop
Seat 5: iAISe3dVeua8PUn2wwgDHw (big blind) folded on the Flop
Seat 6: 5k9fvXD9suIgCxU4HLQjTw folded before Flop (didn't bet)
Seat 7: SKnJuWHScqetA/qG5p+wCg folded before Flop (didn't bet)
Seat 8: JYwJYYV9pM5KWdSiETl8rA folded on the Flop
Seat 9: HZkVla4kK2SI42CVrPZ/ig folded before Flop (didn't bet)



PokerStars Game #59939869020:  Hold'em No Limit ($0.25/$0.50) - 2009/07/01 0:51:05 ET
Table 'QOgaEqMcJ73pcUMMxoisUg' 6-max Seat #1 is the button
Seat 1: /olYG0EzMWzADIgH1y2ySQ ($26.20 in chips)
Seat 2: 4QfsCWthT/vSLirorNXqtg ($50 in chips)
Seat 3: Rt6KgtZ8YaJoTc3FPim00w ($95.55 in chips)
Seat 4: zAcsDhG/T128Vn7XGVSgKg ($50.85 in chips)
Seat 5: 6vNxrjjCl6FwfaaymM9jjg ($32.05 in chips)
4QfsCWthT/vSLirorNXqtg: posts small blind $0.25
Rt6KgtZ8YaJoTc3FPim00w: posts big blind $0.50
GoVjFxr3C+JO9vtJH9+IcA: sits out
*** HOLE CARDS ***
zAcsDhG/T128Vn7XGVSgKg: folds
6vNxrjjCl6FwfaaymM9jjg: raises $3 to $3.50
/olYG0EzMWzADIgH1y2ySQ: folds
4QfsCWthT/vSLirorNXqtg: folds
Rt6KgtZ8YaJoTc3FPim00w: folds
6vNxrjjCl6FwfaaymM9jjg collected $1.25 from pot
*** SUMMARY ***
Total pot $1.25 | Rake $0
Seat 1: /olYG0EzMWzADIgH1y2ySQ (button) folded before Flop (didn't bet)
Seat 2: 4QfsCWthT/vSLirorNXqtg (small blind) folded before Flop
Seat 3: Rt6KgtZ8YaJoTc3FPim00w (big blind) folded before Flop
Seat 4: zAcsDhG/T128Vn7XGVSgKg folded before Flop (didn't bet)
Seat 5: 6vNxrjjCl6FwfaaymM9jjg collected ($1.25)



PokerStars Game #59939869508:  Hold'em No Limit ($0.25/$0.50) - 2009/07/01 0:51:06 ET
Table '0eJtgVAXVvBgncFdcUpXcQ' 2-max Seat #1 is the button
Seat 1: Ag6DvxX4vbRheqsv2zXKTQ ($36.85 in chips)
Seat 2: KMc4R+K9ao4Ur3rF7NGe6Q ($15.60 in chips)
Ag6DvxX4vbRheqsv2zXKTQ: posts small blind $0.25
KMc4R+K9ao4Ur3rF7NGe6Q: posts big blind $0.50
*** HOLE CARDS ***
Ag6DvxX4vbRheqsv2zXKTQ: raises $0.50 to $1
KMc4R+K9ao4Ur3rF7NGe6Q: calls $0.50
*** FLOP *** [Ts 4s Ah]
KMc4R+K9ao4Ur3rF7NGe6Q: bets $1
Ag6DvxX4vbRheqsv2zXKTQ: calls $1
*** TURN *** [Ts 4s Ah] [Kd]
KMc4R+K9ao4Ur3rF7NGe6Q: bets $1.50
Ag6DvxX4vbRheqsv2zXKTQ: folds
KMc4R+K9ao4Ur3rF7NGe6Q collected $3.85 from pot
KMc4R+K9ao4Ur3rF7NGe6Q: doesn't show hand
*** SUMMARY ***
Total pot $4 | Rake $0.15
Board [Ts 4s Ah Kd]
Seat 1: Ag6DvxX4vbRheqsv2zXKTQ (button) (small blind) folded on the Turn
Seat 2: KMc4R+K9ao4Ur3rF7NGe6Q (big blind) collected ($3.85)



PokerStars Game #59939870226:  Hold'em No Limit ($0.25/$0.50) - 2009/07/01 0:51:07 ET
Table '+z1aekfHkpp09pc8F9aViw' 6-max Seat #6 is the button
Seat 1: FHilMb2i2DbUCc9lplszog ($38.35 in chips)
Seat 2: M6xK/VklCvdyyrmvzATlxQ ($35.25 in chips)
Seat 3: uUznlIMFnRUvwrBhYF73KA ($118.45 in chips)
Seat 4: RowCSpSURHTOL/dcjg/Iug ($49.05 in chips)
Seat 6: 686aeHikcJlgKkSuIFdcXQ ($53.25 in chips)
FHilMb2i2DbUCc9lplszog: posts small blind $0.25
M6xK/VklCvdyyrmvzATlxQ: posts big blind $0.50
*** HOLE CARDS ***
uUznlIMFnRUvwrBhYF73KA: folds
rplyldNweS6YyMNEALQrug joins the table at seat #5
RowCSpSURHTOL/dcjg/Iug: raises $1.50 to $2
686aeHikcJlgKkSuIFdcXQ: folds
FHilMb2i2DbUCc9lplszog: calls $1.75
M6xK/VklCvdyyrmvzATlxQ: folds
*** FLOP *** [7d 9h Ts]
FHilMb2i2DbUCc9lplszog: checks
RowCSpSURHTOL/dcjg/Iug: bets $2
FHilMb2i2DbUCc9lplszog: raises $2 to $4
RowCSpSURHTOL/dcjg/Iug: calls $2
*** TURN *** [7d 9h Ts] [2d]
FHilMb2i2DbUCc9lplszog: bets $5.50
RowCSpSURHTOL/dcjg/Iug: folds
FHilMb2i2DbUCc9lplszog collected $11.90 from pot
*** SUMMARY ***
Total pot $12.50 | Rake $0.60
Board [7d 9h Ts 2d]
Seat 1: FHilMb2i2DbUCc9lplszog (small blind) collected ($11.90)
Seat 2: M6xK/VklCvdyyrmvzATlxQ (big blind) folded before Flop
Seat 3: uUznlIMFnRUvwrBhYF73KA folded before Flop (didn't bet)
Seat 4: RowCSpSURHTOL/dcjg/Iug folded on the Turn
Seat 6: 686aeHikcJlgKkSuIFdcXQ (button) folded before Flop (didn't bet)



PokerStars Game #59939871930:  Hold'em No Limit ($0.25/$0.50) - 2009/07/01 0:51:10 ET
Table 'QOgaEqMcJ73pcUMMxoisUgErOuyGLI5PT3G5MnpHgC/g Seat #9 is the button
Seat 3: xZCXQSXlrZkp3pZizzVXCw ($49.75 in chips)
Seat 4: 3UmXLy3GfjC3EkOebduerQ ($50 in chips)
Seat 5: JwvquocWfhTVApN5t47LgA ($60.80 in chips)
Seat 6: zE9cVigS2nW/Ljy4K4bUQA ($30 in chips)
Seat 7: 90Wb75h3W1BRpbqVnuk8gw ($65.55 in chips)
Seat 8: g4k0NXISyLCqaSWZDBjfEg ($50 in chips)
Seat 9: J0W5D97jl5VLky+IoPvDeA ($53.65 in chips)
eBrej2jnlUCs/JgxFCRn2g has timed out
eBrej2jnlUCs/JgxFCRn2g: is sitting out
xZCXQSXlrZkp3pZizzVXCw: posts small blind $0.25
3UmXLy3GfjC3EkOebduerQ: posts big blind $0.50
*** HOLE CARDS ***
eBrej2jnlUCs/JgxFCRn2g has returned
JwvquocWfhTVApN5t47LgA: folds
zE9cVigS2nW/Ljy4K4bUQA: folds
90Wb75h3W1BRpbqVnuk8gw: folds
g4k0NXISyLCqaSWZDBjfEg: folds
J0W5D97jl5VLky+IoPvDeA: calls $0.50
xZCXQSXlrZkp3pZizzVXCw: folds
3UmXLy3GfjC3EkOebduerQ: checks
*** FLOP *** [Ac Kd 6c]
3UmXLy3GfjC3EkOebduerQ: bets $1
J0W5D97jl5VLky+IoPvDeA: folds
3UmXLy3GfjC3EkOebduerQ collected $1.20 from pot
*** SUMMARY ***
Total pot $1.25 | Rake $0.05
Board [Ac Kd 6c]
Seat 3: xZCXQSXlrZkp3pZizzVXCw (small blind) folded before Flop
Seat 4: 3UmXLy3GfjC3EkOebduerQ (big blind) collected ($1.20)
Seat 5: JwvquocWfhTVApN5t47LgA folded before Flop (didn't bet)
Seat 6: zE9cVigS2nW/Ljy4K4bUQA folded before Flop (didn't bet)
Seat 7: 90Wb75h3W1BRpbqVnuk8gw folded before Flop (didn't bet)
Seat 8: g4k0NXISyLCqaSWZDBjfEg folded before Flop (didn't bet)
Seat 9: J0W5D97jl5VLky+IoPvDeA (button) folded on the Flop



PokerStars Game #59939872478:  Hold'em No Limit ($0.25/$0.50) - 2009/07/01 0:51:10 ET
Table 'EiNh8p/wGJ1FP575iMFnqg' 9-max Seat #5 is the button
Seat 1: r3ZqM1Mi0W3y4hOdssE+Sg ($45.85 in chips)
Seat 2: 8ehL7qlZzjgUh2H35iiWLw ($52.60 in chips)
Seat 3: ymLPoEIl7UL3TvZYmnadxQ ($50.85 in chips)
Seat 4: cMzaiXAM/ZAdNaEUu+LqhA ($54.95 in chips)
Seat 5: M+7+BTmX5vZatHVuoRB1nA ($82.20 in chips)
Seat 6: 3UmXLy3GfjC3EkOebduerQ ($65.60 in chips)
Seat 7: 997ViqAtWn1FPjJqcffwcA ($50 in chips)
Seat 9: NnQCepdIR/AOUQn1yhYx6Q ($9.25 in chips)
3UmXLy3GfjC3EkOebduerQ: posts small blind $0.25
997ViqAtWn1FPjJqcffwcA: posts big blind $0.50
mSD1pginDsyHG5PDfqzphw: sits out
*** HOLE CARDS ***
NnQCepdIR/AOUQn1yhYx6Q: folds
r3ZqM1Mi0W3y4hOdssE+Sg: folds
8ehL7qlZzjgUh2H35iiWLw: folds
ymLPoEIl7UL3TvZYmnadxQ: folds
cMzaiXAM/ZAdNaEUu+LqhA: folds
M+7+BTmX5vZatHVuoRB1nA: folds
3UmXLy3GfjC3EkOebduerQ: folds
997ViqAtWn1FPjJqcffwcA collected $0.50 from pot
*** SUMMARY ***
Total pot $0.50 | Rake $0
Seat 1: r3ZqM1Mi0W3y4hOdssE+Sg folded before Flop (didn't bet)
Seat 2: 8ehL7qlZzjgUh2H35iiWLw folded before Flop (didn't bet)
Seat 3: ymLPoEIl7UL3TvZYmnadxQ folded before Flop (didn't bet)
Seat 4: cMzaiXAM/ZAdNaEUu+LqhA folded before Flop (didn't bet)
Seat 5: M+7+BTmX5vZatHVuoRB1nA (button) folded before Flop (didn't bet)
Seat 6: 3UmXLy3GfjC3EkOebduerQ (small blind) folded before Flop
Seat 7: 997ViqAtWn1FPjJqcffwcA (big blind) collected ($0.50)
Seat 9: NnQCepdIR/AOUQn1yhYx6Q folded before Flop (didn't bet)



PokerStars Game #59939872630:  Hold'em No Limit ($0.25/$0.50) - 2009/07/01 0:51:11 ET
Table 'lSisgp6H7Fg1hH5VfjEjYQ' 9-max Seat #2 is the button
Seat 1: 5k9fvXD9suIgCxU4HLQjTw ($50 in chips)
Seat 2: UrcnkQOiLVk8BlKDPJSy7Q ($77.60 in chips)
Seat 3: aTkyjTh3w5YLWiIERupZOA ($51.45 in chips)
Seat 4: bwv/rbH/hHhPhY6u9mu04w ($34.85 in chips)
Seat 5: mSD1pginDsyHG5PDfqzphw ($11.35 in chips)
Seat 6: +k7T5ocke8UwavtgUHm+Cg ($28.50 in chips)
Seat 8: a4JDWmpFQkL10XfAyuF51A ($30.50 in chips)
Seat 9: gsyXT42WLEcOS4DdEk2wlw ($42.10 in chips)
aTkyjTh3w5YLWiIERupZOA: posts small blind $0.25
bwv/rbH/hHhPhY6u9mu04w: posts big blind $0.50
*** HOLE CARDS ***
mSD1pginDsyHG5PDfqzphw: folds
+k7T5ocke8UwavtgUHm+Cg: folds
a4JDWmpFQkL10XfAyuF51A: folds
gsyXT42WLEcOS4DdEk2wlw: folds
5k9fvXD9suIgCxU4HLQjTw: raises $1 to $1.50
UrcnkQOiLVk8BlKDPJSy7Q: folds
aTkyjTh3w5YLWiIERupZOA: folds
bwv/rbH/hHhPhY6u9mu04w: folds
Y3DZ6qQlLeBhixDj4M9vmg leaves the table
5k9fvXD9suIgCxU4HLQjTw collected $1.25 from pot
*** SUMMARY ***
Total pot $1.25 | Rake $0
Seat 1: 5k9fvXD9suIgCxU4HLQjTw collected ($1.25)
Seat 2: UrcnkQOiLVk8BlKDPJSy7Q (button) folded before Flop (didn't bet)
Seat 3: aTkyjTh3w5YLWiIERupZOA (small blind) folded before Flop
Seat 4: bwv/rbH/hHhPhY6u9mu04w (big blind) folded before Flop
Seat 5: mSD1pginDsyHG5PDfqzphw folded before Flop (didn't bet)
Seat 6: +k7T5ocke8UwavtgUHm+Cg folded before Flop (didn't bet)
Seat 8: a4JDWmpFQkL10XfAyuF51A folded before Flop (didn't bet)
Seat 9: gsyXT42WLEcOS4DdEk2wlw folded before Flop (didn't bet)



PokerStars Game #59939872694:  Hold'em No Limit ($0.25/$0.50) - 2009/07/01 0:51:11 ET
Table 'QOeVnLhwctF9UyV/beDi+A' 2-max Seat #1 is the button
Seat 1: bypIyrYcAAifLfhZpGlKLA ($65.10 in chips)
Seat 2: Ucrm3XtZmoONapW32SPhag ($16.20 in chips)
bypIyrYcAAifLfhZpGlKLA: posts small blind $0.25
Ucrm3XtZmoONapW32SPhag: posts big blind $0.50
*** HOLE CARDS ***
bypIyrYcAAifLfhZpGlKLA: raises $0.50 to $1
Ucrm3XtZmoONapW32SPhag: calls $0.50
*** FLOP *** [Ad Tc Jh]
Ucrm3XtZmoONapW32SPhag: checks
bypIyrYcAAifLfhZpGlKLA: checks
*** TURN *** [Ad Tc Jh] [9s]
Ucrm3XtZmoONapW32SPhag: bets $0.50
bypIyrYcAAifLfhZpGlKLA: raises $2 to $2.50
Ucrm3XtZmoONapW32SPhag: folds
bypIyrYcAAifLfhZpGlKLA collected $2.90 from pot
bypIyrYcAAifLfhZpGlKLA: doesn't show hand
*** SUMMARY ***
Total pot $3 | Rake $0.10
Board [Ad Tc Jh 9s]
Seat 1: bypIyrYcAAifLfhZpGlKLA (button) (small blind) collected ($2.90)
Seat 2: Ucrm3XtZmoONapW32SPhag (big blind) folded on the Turn



PokerStars Game #59939873098:  Hold'em No Limit ($0.25/$0.50) - 2009/07/01 0:51:11 ET
Table 'Vdlc9wqYcHTUhtdyN7CuJw' 2-max Seat #2 is the button
Seat 1: yBO+mXB6m/rCft2ErwGf/Q ($115.20 in chips)
Seat 2: NZ/5cxwnorKW2SNsWy1+8A ($10.20 in chips)
NZ/5cxwnorKW2SNsWy1+8A: posts small blind $0.25
yBO+mXB6m/rCft2ErwGf/Q: posts big blind $0.50
*** HOLE CARDS ***
NZ/5cxwnorKW2SNsWy1+8A: calls $0.25
yBO+mXB6m/rCft2ErwGf/Q: raises $1 to $1.50
NZ/5cxwnorKW2SNsWy1+8A: calls $1
*** FLOP *** [As 5s Th]
yBO+mXB6m/rCft2ErwGf/Q: bets $1
NZ/5cxwnorKW2SNsWy1+8A: calls $1
*** TURN *** [As 5s Th] [5h]
yBO+mXB6m/rCft2ErwGf/Q: bets $0.50
NZ/5cxwnorKW2SNsWy1+8A: calls $0.50
*** RIVER *** [As 5s Th 5h] [3s]
yBO+mXB6m/rCft2ErwGf/Q: bets $0.50
NZ/5cxwnorKW2SNsWy1+8A: calls $0.50
*** SHOW DOWN ***
yBO+mXB6m/rCft2ErwGf/Q: shows [Ts 7d] (two pair, Tens and Fives)
NZ/5cxwnorKW2SNsWy1+8A: shows [Td 9h] (two pair, Tens and Fives)
yBO+mXB6m/rCft2ErwGf/Q collected $3.35 from pot
NZ/5cxwnorKW2SNsWy1+8A collected $3.35 from pot
*** SUMMARY ***
Total pot $7 | Rake $0.30
Board [As 5s Th 5h 3s]
Seat 1: yBO+mXB6m/rCft2ErwGf/Q (big blind) showed [Ts 7d] and won ($3.35) with two pair, Tens and Fives
Seat 2: NZ/5cxwnorKW2SNsWy1+8A (button) (small blind) showed [Td 9h] and won ($3.35) with two pair, Tens and Fives



PokerStars Game #59939873096:  Hold'em No Limit ($0.25/$0.50) - 2009/07/01 0:51:11 ET
Table '+dXkOAQyS8j9PQZusUTMpg' 2-max Seat #1 is the button
Seat 1: XFa6sBGjP2gxoIvxR3fZIg ($61.90 in chips)
Seat 2: 5IBeOgaApY1Bvzv2P8X4EA ($139.95 in chips)
XFa6sBGjP2gxoIvxR3fZIg: posts small blind $0.25
5IBeOgaApY1Bvzv2P8X4EA: posts big blind $0.50
*** HOLE CARDS ***
XFa6sBGjP2gxoIvxR3fZIg: raises $1 to $1.50
5IBeOgaApY1Bvzv2P8X4EA: calls $1
*** FLOP *** [Kc Kh 6d]
5IBeOgaApY1Bvzv2P8X4EA: checks
XFa6sBGjP2gxoIvxR3fZIg: checks
*** TURN *** [Kc Kh 6d] [2s]
5IBeOgaApY1Bvzv2P8X4EA: checks
XFa6sBGjP2gxoIvxR3fZIg: checks
*** RIVER *** [Kc Kh 6d 2s] [Jd]
5IBeOgaApY1Bvzv2P8X4EA: checks
XFa6sBGjP2gxoIvxR3fZIg: checks
*** SHOW DOWN ***
5IBeOgaApY1Bvzv2P8X4EA: shows [Js 9c] (two pair, Kings and Jacks)
XFa6sBGjP2gxoIvxR3fZIg: mucks hand
5IBeOgaApY1Bvzv2P8X4EA collected $2.85 from pot
*** SUMMARY ***
Total pot $3 | Rake $0.15
Board [Kc Kh 6d 2s Jd]
Seat 1: XFa6sBGjP2gxoIvxR3fZIg (button) (small blind) mucked
Seat 2: 5IBeOgaApY1Bvzv2P8X4EA (big blind) showed [Js 9c] and won ($2.85) with two pair, Kings and Jacks



PokerStars Game #59939873648:  Hold'em No Limit ($0.25/$0.50) - 2009/07/01 0:51:12 ET
Table 'c/CRn+68J3Y8KxD5g1ek2Q' 2-max Seat #2 is the button
Seat 1: 46qCyJ6evTkHo9al5sBMNA ($87.65 in chips)
Seat 2: BypVLsYQt3ePFm2xQL/dOA ($284.55 in chips)
BypVLsYQt3ePFm2xQL/dOA: posts small blind $0.25
46qCyJ6evTkHo9al5sBMNA: posts big blind $0.50
*** HOLE CARDS ***
BypVLsYQt3ePFm2xQL/dOA: calls $0.25
46qCyJ6evTkHo9al5sBMNA: raises $1 to $1.50
BypVLsYQt3ePFm2xQL/dOA: calls $1
*** FLOP *** [As Qh Th]
46qCyJ6evTkHo9al5sBMNA: bets $2
BypVLsYQt3ePFm2xQL/dOA: calls $2
*** TURN *** [As Qh Th] [Kc]
46qCyJ6evTkHo9al5sBMNA: checks
BypVLsYQt3ePFm2xQL/dOA: checks
*** RIVER *** [As Qh Th Kc] [9s]
46qCyJ6evTkHo9al5sBMNA: bets $9
BypVLsYQt3ePFm2xQL/dOA: folds
46qCyJ6evTkHo9al5sBMNA collected $6.70 from pot
46qCyJ6evTkHo9al5sBMNA: doesn't show hand
*** SUMMARY ***
Total pot $7 | Rake $0.30
Board [As Qh Th Kc 9s]
Seat 1: 46qCyJ6evTkHo9al5sBMNA (big blind) collected ($6.70)
Seat 2: BypVLsYQt3ePFm2xQL/dOA (button) (small blind) folded on the River



PokerStars Game #59939873306:  Hold'em No Limit ($0.25/$0.50) - 2009/07/01 0:51:12 ET
Table 'GfL/No5u5PoEnU39lP5pQg' 6-max Seat #6 is the button
Seat 1: 1WUCqNG+p+vfWRTXNu4ljw ($60.25 in chips)
Seat 2: uVwggSetzp7d+eVgowO3vg ($64.45 in chips)
Seat 3: Ek4w9XqBXqK5jBUQeLedGw ($51.25 in chips)
Seat 4: r6u7MWSXF30/khcTYkrG9Q ($24.65 in chips)
Seat 5: M1KyQQvVPVuxqTAB8sR/zQ ($52.25 in chips)
Seat 6: kxPhs4ePFqMy52CInAJ2aw ($50.75 in chips)
1WUCqNG+p+vfWRTXNu4ljw: posts small blind $0.25
uVwggSetzp7d+eVgowO3vg: posts big blind $0.50
*** HOLE CARDS ***
Ek4w9XqBXqK5jBUQeLedGw: folds
r6u7MWSXF30/khcTYkrG9Q: folds
M1KyQQvVPVuxqTAB8sR/zQ: folds
kxPhs4ePFqMy52CInAJ2aw: folds
1WUCqNG+p+vfWRTXNu4ljw: folds
uVwggSetzp7d+eVgowO3vg collected $0.50 from pot
*** SUMMARY ***
Total pot $0.50 | Rake $0
Seat 1: 1WUCqNG+p+vfWRTXNu4ljw (small blind) folded before Flop
Seat 2: uVwggSetzp7d+eVgowO3vg (big blind) collected ($0.50)
Seat 3: Ek4w9XqBXqK5jBUQeLedGw folded before Flop (didn't bet)
Seat 4: r6u7MWSXF30/khcTYkrG9Q folded before Flop (didn't bet)
Seat 5: M1KyQQvVPVuxqTAB8sR/zQ folded before Flop (didn't bet)
Seat 6: kxPhs4ePFqMy52CInAJ2aw (button) folded before Flop (didn't bet)



PokerStars Game #59939877158:  Hold'em No Limit ($0.25/$0.50) - 2009/07/01 0:51:18 ET
Table 'T/PgNWqVyY6lkldcBVXYJQ' 6-max Seat #3 is the button
Seat 1: +Pf9jTVizYlIo+woPvptfA ($78 in chips)
Seat 2: LvH4G7n+QSjT6NDaD3cREA ($55 in chips)
Seat 3: L3OcNO1bgdqDI46j67KQPQ ($50 in chips)
Seat 4: Ek4w9XqBXqK5jBUQeLedGw ($50 in chips)
Seat 5: of9mtXiD8G4Nx5p7hCbgqQ ($50 in chips)
Ek4w9XqBXqK5jBUQeLedGw: posts small blind $0.25
of9mtXiD8G4Nx5p7hCbgqQ: posts big blind $0.50
*** HOLE CARDS ***
+Pf9jTVizYlIo+woPvptfA: folds
LvH4G7n+QSjT6NDaD3cREA: raises $1 to $1.50
L3OcNO1bgdqDI46j67KQPQ: folds
Ek4w9XqBXqK5jBUQeLedGw: folds
of9mtXiD8G4Nx5p7hCbgqQ: folds
LvH4G7n+QSjT6NDaD3cREA collected $1.25 from pot
LvH4G7n+QSjT6NDaD3cREA: doesn't show hand
khHFhne53qR5U3ky0T78jw joins the table at seat #6
*** SUMMARY ***
Total pot $1.25 | Rake $0
Seat 1: +Pf9jTVizYlIo+woPvptfA folded before Flop (didn't bet)
Seat 2: LvH4G7n+QSjT6NDaD3cREA collected ($1.25)
Seat 3: L3OcNO1bgdqDI46j67KQPQ (button) folded before Flop (didn't bet)
Seat 4: Ek4w9XqBXqK5jBUQeLedGw (small blind) folded before Flop
Seat 5: of9mtXiD8G4Nx5p7hCbgqQ (big blind) folded before Flop



PokerStars Game #59939877734:  Hold'em No Limit ($0.25/$0.50) - 2009/07/01 0:51:19 ET
Table 'otvGDROEDdqsabxskT79qg' 9-max Seat #9 is the button
Seat 1: 8ehL7qlZzjgUh2H35iiWLw ($54.75 in chips)
Seat 2: cCjTzH9jio8607WzjcfXlg ($12.95 in chips)
Seat 3: +k7T5ocke8UwavtgUHm+Cg ($67.50 in chips)
Seat 4: MG90wfSJZnOejs/KD3vlQQ ($69.95 in chips)
Seat 5: XNMDwbXt/Q4jM99AXnbJDw ($52.55 in chips)
Seat 6: bxLSulbgr8LmKNjOzw8URg ($53.70 in chips)
Seat 7: C7+tBppJrKgd/r+tuKUIpA ($36.60 in chips)
Seat 8: zE9cVigS2nW/Ljy4K4bUQA ($30 in chips)
Seat 9: KcY3X8YpD74Kw1RHkx/g4A ($57.90 in chips)
8ehL7qlZzjgUh2H35iiWLw: posts small blind $0.25
cCjTzH9jio8607WzjcfXlg: posts big blind $0.50
*** HOLE CARDS ***
+k7T5ocke8UwavtgUHm+Cg: folds
MG90wfSJZnOejs/KD3vlQQ: folds
XNMDwbXt/Q4jM99AXnbJDw: folds
bxLSulbgr8LmKNjOzw8URg: folds
C7+tBppJrKgd/r+tuKUIpA: calls $0.50
zE9cVigS2nW/Ljy4K4bUQA: folds
KcY3X8YpD74Kw1RHkx/g4A: folds
8ehL7qlZzjgUh2H35iiWLw: folds
cCjTzH9jio8607WzjcfXlg: checks
*** FLOP *** [7d Qh Qs]
cCjTzH9jio8607WzjcfXlg: bets $0.50
C7+tBppJrKgd/r+tuKUIpA: calls $0.50
*** TURN *** [7d Qh Qs] [5s]
cCjTzH9jio8607WzjcfXlg: bets $0.50
C7+tBppJrKgd/r+tuKUIpA: calls $0.50
*** RIVER *** [7d Qh Qs 5s] [3s]
cCjTzH9jio8607WzjcfXlg: checks
C7+tBppJrKgd/r+tuKUIpA: checks
*** SHOW DOWN ***
cCjTzH9jio8607WzjcfXlg: shows [Qc 8c] (three of a kind, Queens)
C7+tBppJrKgd/r+tuKUIpA: mucks hand
cCjTzH9jio8607WzjcfXlg collected $3.10 from pot
*** SUMMARY ***
Total pot $3.25 | Rake $0.15
Board [7d Qh Qs 5s 3s]
Seat 1: 8ehL7qlZzjgUh2H35iiWLw (small blind) folded before Flop
Seat 2: cCjTzH9jio8607WzjcfXlg (big blind) showed [Qc 8c] and won ($3.10) with three of a kind, Queens
Seat 3: +k7T5ocke8UwavtgUHm+Cg folded before Flop (didn't bet)
Seat 4: MG90wfSJZnOejs/KD3vlQQ folded before Flop (didn't bet)
Seat 5: XNMDwbXt/Q4jM99AXnbJDw folded before Flop (didn't bet)
Seat 6: bxLSulbgr8LmKNjOzw8URg folded before Flop (didn't bet)
Seat 7: C7+tBppJrKgd/r+tuKUIpA mucked
Seat 8: zE9cVigS2nW/Ljy4K4bUQA folded before Flop (didn't bet)
Seat 9: KcY3X8YpD74Kw1RHkx/g4A (button) folded before Flop (didn't bet)



PokerStars Game #59939878484:  Hold'em No Limit ($0.25/$0.50) - 2009/07/01 0:51:20 ET
Table '5EmHi+fnatGQQShcNmzOZQ' 6-max Seat #4 is the button
Seat 1: HGzUMAFxR1k8+S4gfnB39w ($31.40 in chips)
Seat 3: TjmTe3bhs9dFz5gXX9x7Lw ($27.25 in chips)
Seat 4: 1b+2BbjMN8qhR1WPqdE9VQ ($62 in chips)
Seat 5: kxPhs4ePFqMy52CInAJ2aw ($50 in chips)
Seat 6: 686aeHikcJlgKkSuIFdcXQ ($135.95 in chips)
kxPhs4ePFqMy52CInAJ2aw: posts small blind $0.25
686aeHikcJlgKkSuIFdcXQ: posts big blind $0.50
HGzUMAFxR1k8+S4gfnB39w: posts big blind $0.50
*** HOLE CARDS ***
HGzUMAFxR1k8+S4gfnB39w: checks
TjmTe3bhs9dFz5gXX9x7Lw: folds
1b+2BbjMN8qhR1WPqdE9VQ: raises $1.50 to $2
kxPhs4ePFqMy52CInAJ2aw: folds
686aeHikcJlgKkSuIFdcXQ: folds
HGzUMAFxR1k8+S4gfnB39w: folds
1b+2BbjMN8qhR1WPqdE9VQ collected $1.75 from pot
1b+2BbjMN8qhR1WPqdE9VQ: doesn't show hand
*** SUMMARY ***
Total pot $1.75 | Rake $0
Seat 1: HGzUMAFxR1k8+S4gfnB39w folded before Flop
Seat 3: TjmTe3bhs9dFz5gXX9x7Lw folded before Flop (didn't bet)
Seat 4: 1b+2BbjMN8qhR1WPqdE9VQ (button) collected ($1.75)
Seat 5: kxPhs4ePFqMy52CInAJ2aw (small blind) folded before Flop
Seat 6: 686aeHikcJlgKkSuIFdcXQ (big blind) folded before Flop



PokerStars Game #59939879062:  Hold'em No Limit ($0.25/$0.50) - 2009/07/01 0:51:21 ET
Table '37qXEp3oe+er5q4CZip9eQ' 6-max Seat #1 is the button
Seat 1: oqOqoO2AyCZenUghCxMDxw ($56.90 in chips)
Seat 2: 6wzJiRvp8HY6t+MQGnSIzA ($20 in chips)
Seat 3: Rt6KgtZ8YaJoTc3FPim00w ($100.35 in chips)
Seat 4: XsmE8nXMAAMFJbWaJTmHFw ($35.45 in chips)
Seat 5: VOmI0x4dDPnTESZd5B4d1Q ($43.65 in chips)
Seat 6: N50kln4negd8q7Mmoz1j4g ($19.30 in chips)
6wzJiRvp8HY6t+MQGnSIzA: posts small blind $0.25
Rt6KgtZ8YaJoTc3FPim00w: posts big blind $0.50
*** HOLE CARDS ***
XsmE8nXMAAMFJbWaJTmHFw: folds
VOmI0x4dDPnTESZd5B4d1Q: folds
N50kln4negd8q7Mmoz1j4g: folds
oqOqoO2AyCZenUghCxMDxw: folds
6wzJiRvp8HY6t+MQGnSIzA: calls $0.25
Rt6KgtZ8YaJoTc3FPim00w: checks
*** FLOP *** [Ah 5d Jc]
6wzJiRvp8HY6t+MQGnSIzA: bets $1
Rt6KgtZ8YaJoTc3FPim00w: calls $1
*** TURN *** [Ah 5d Jc] [2s]
6wzJiRvp8HY6t+MQGnSIzA: checks
Rt6KgtZ8YaJoTc3FPim00w: checks
*** RIVER *** [Ah 5d Jc 2s] [Td]
6wzJiRvp8HY6t+MQGnSIzA: bets $2
Rt6KgtZ8YaJoTc3FPim00w: calls $2
*** SHOW DOWN ***
6wzJiRvp8HY6t+MQGnSIzA: shows [8d Th] (a pair of Tens)
Rt6KgtZ8YaJoTc3FPim00w: shows [Js 8h] (a pair of Jacks)
Rt6KgtZ8YaJoTc3FPim00w collected $6.70 from pot
*** SUMMARY ***
Total pot $7 | Rake $0.30
Board [Ah 5d Jc 2s Td]
Seat 1: oqOqoO2AyCZenUghCxMDxw (button) folded before Flop (didn't bet)
Seat 2: 6wzJiRvp8HY6t+MQGnSIzA (small blind) showed [8d Th] and lost with a pair of Tens
Seat 3: Rt6KgtZ8YaJoTc3FPim00w (big blind) showed [Js 8h] and won ($6.70) with a pair of Jacks
Seat 4: XsmE8nXMAAMFJbWaJTmHFw folded before Flop (didn't bet)
Seat 5: VOmI0x4dDPnTESZd5B4d1Q folded before Flop (didn't bet)
Seat 6: N50kln4negd8q7Mmoz1j4g folded before Flop (didn't bet)



PokerStars Game #59939879266:  Hold'em No Limit ($0.25/$0.50) - 2009/07/01 0:51:21 ET
Table '0eJtgVAXVvBgncFdcUpXcQ' 2-max Seat #2 is the button
Seat 1: Ag6DvxX4vbRheqsv2zXKTQ ($34.85 in chips)
Seat 2: KMc4R+K9ao4Ur3rF7NGe6Q ($17.45 in chips)
KMc4R+K9ao4Ur3rF7NGe6Q: posts small blind $0.25
Ag6DvxX4vbRheqsv2zXKTQ: posts big blind $0.50
*** HOLE CARDS ***
KMc4R+K9ao4Ur3rF7NGe6Q: calls $0.25
Ag6DvxX4vbRheqsv2zXKTQ: checks
*** FLOP *** [4s 7c Kd]
Ag6DvxX4vbRheqsv2zXKTQ: checks
KMc4R+K9ao4Ur3rF7NGe6Q: bets $1
Ag6DvxX4vbRheqsv2zXKTQ: calls $1
*** TURN *** [4s 7c Kd] [6s]
Ag6DvxX4vbRheqsv2zXKTQ: checks
KMc4R+K9ao4Ur3rF7NGe6Q: checks
*** RIVER *** [4s 7c Kd 6s] [Th]
Ag6DvxX4vbRheqsv2zXKTQ: bets $1
KMc4R+K9ao4Ur3rF7NGe6Q: calls $1
*** SHOW DOWN ***
Ag6DvxX4vbRheqsv2zXKTQ: shows [Ts Qh] (a pair of Tens)
KMc4R+K9ao4Ur3rF7NGe6Q: mucks hand
Ag6DvxX4vbRheqsv2zXKTQ collected $4.80 from pot
*** SUMMARY ***
Total pot $5 | Rake $0.20
Board [4s 7c Kd 6s Th]
Seat 1: Ag6DvxX4vbRheqsv2zXKTQ (big blind) showed [Ts Qh] and won ($4.80) with a pair of Tens
Seat 2: KMc4R+K9ao4Ur3rF7NGe6Q (button) (small blind) mucked



PokerStars Game #59939879700:  Hold'em No Limit ($0.25/$0.50) - 2009/07/01 0:51:22 ET
Table 'MJxeZCzYELxiIsyUZyT0jw' 6-max Seat #6 is the button
Seat 1: nOfdMHEXflgT86UgFWblAA ($50 in chips)
Seat 2: t3GiVMzqA9Svgr5Uol32cQ ($36.85 in chips)
Seat 3: JQZew0FjzS19kTjeNtrE+A ($60.30 in chips)
Seat 4: alGiiQP/wwtYnfuXII+sgw ($48.95 in chips)
Seat 5: 3jvoOXNtXE90w2BdfNZwZQ ($50.75 in chips)
Seat 6: TTx3CHxyi0SObcHyMJRp5w ($50.90 in chips)
nOfdMHEXflgT86UgFWblAA: posts small blind $0.25
t3GiVMzqA9Svgr5Uol32cQ: posts big blind $0.50
*** HOLE CARDS ***
JQZew0FjzS19kTjeNtrE+A: folds
alGiiQP/wwtYnfuXII+sgw: calls $0.50
3jvoOXNtXE90w2BdfNZwZQ: folds
TTx3CHxyi0SObcHyMJRp5w: calls $0.50
nOfdMHEXflgT86UgFWblAA: calls $0.25
t3GiVMzqA9Svgr5Uol32cQ: checks
*** FLOP *** [7d Qh 9d]
nOfdMHEXflgT86UgFWblAA: checks
t3GiVMzqA9Svgr5Uol32cQ: checks
alGiiQP/wwtYnfuXII+sgw: checks
TTx3CHxyi0SObcHyMJRp5w: checks
*** TURN *** [7d Qh 9d] [Ad]
nOfdMHEXflgT86UgFWblAA: checks
t3GiVMzqA9Svgr5Uol32cQ: checks
alGiiQP/wwtYnfuXII+sgw: bets $0.50
TTx3CHxyi0SObcHyMJRp5w: raises $1 to $1.50
nOfdMHEXflgT86UgFWblAA: folds
nOfdMHEXflgT86UgFWblAA leaves the table
t3GiVMzqA9Svgr5Uol32cQ: folds
alGiiQP/wwtYnfuXII+sgw: calls $1
*** RIVER *** [7d Qh 9d Ad] [Ks]
alGiiQP/wwtYnfuXII+sgw: checks
TTx3CHxyi0SObcHyMJRp5w: checks
*** SHOW DOWN ***
alGiiQP/wwtYnfuXII+sgw: shows [As 3h] (a pair of Aces)
TTx3CHxyi0SObcHyMJRp5w: shows [3c Ac] (a pair of Aces)
alGiiQP/wwtYnfuXII+sgw collected $2.40 from pot
TTx3CHxyi0SObcHyMJRp5w collected $2.40 from pot
*** SUMMARY ***
Total pot $5 | Rake $0.20
Board [7d Qh 9d Ad Ks]
Seat 1: nOfdMHEXflgT86UgFWblAA (small blind) folded on the Turn
Seat 2: t3GiVMzqA9Svgr5Uol32cQ (big blind) folded on the Turn
Seat 3: JQZew0FjzS19kTjeNtrE+A folded before Flop (didn't bet)
Seat 4: alGiiQP/wwtYnfuXII+sgw showed [As 3h] and won ($2.40) with a pair of Aces
Seat 5: 3jvoOXNtXE90w2BdfNZwZQ folded before Flop (didn't bet)
Seat 6: TTx3CHxyi0SObcHyMJRp5w (button) showed [3c Ac] and won ($2.40) with a pair of Aces



PokerStars Game #59939880630:  Hold'em No Limit ($0.25/$0.50) - 2009/07/01 0:51:24 ET
Table '3FhG0gl3kMX3wBEEqj+wnQ' 9-max Seat #2 is the button
Seat 1: e0J9pdCNUDTCG031RnXqLA ($31.30 in chips)
Seat 2: 7cYQ+syUWjl38ty/ICOMhw ($50.90 in chips)
Seat 5: gsyXT42WLEcOS4DdEk2wlw ($27.75 in chips)
Seat 6: 997ViqAtWn1FPjJqcffwcA ($50 in chips)
Seat 7: mSD1pginDsyHG5PDfqzphw ($10.25 in chips)
Seat 8: j3K/Jujr7PY4ZM2RZvlH6A ($60.95 in chips)
Seat 9: L5e2lrPLQm1Pqx30IIZ/Fw ($10.50 in chips)
bjvJtA9Hqscfznq66txaOQ: is sitting out
gsyXT42WLEcOS4DdEk2wlw: posts small blind $0.25
997ViqAtWn1FPjJqcffwcA: posts big blind $0.50
*** HOLE CARDS ***
mSD1pginDsyHG5PDfqzphw: folds
j3K/Jujr7PY4ZM2RZvlH6A: folds
L5e2lrPLQm1Pqx30IIZ/Fw: folds
e0J9pdCNUDTCG031RnXqLA: folds
7cYQ+syUWjl38ty/ICOMhw: raises $1.50 to $2
gsyXT42WLEcOS4DdEk2wlw: calls $1.75
997ViqAtWn1FPjJqcffwcA: folds
*** FLOP *** [Qc 9d Ad]
gsyXT42WLEcOS4DdEk2wlw: checks
7cYQ+syUWjl38ty/ICOMhw: bets $3.50
gsyXT42WLEcOS4DdEk2wlw: calls $3.50
*** TURN *** [Qc 9d Ad] [5h]
gsyXT42WLEcOS4DdEk2wlw: checks
7cYQ+syUWjl38ty/ICOMhw: checks
*** RIVER *** [Qc 9d Ad 5h] [5c]
k1f0lS7tlMHCLGs0JT34Tg leaves the table
gsyXT42WLEcOS4DdEk2wlw: bets $7.50
7cYQ+syUWjl38ty/ICOMhw: folds
Min9 joins the table at seat #3
gsyXT42WLEcOS4DdEk2wlw collected $10.95 from pot
*** SUMMARY ***
Total pot $11.50 | Rake $0.55
Board [Qc 9d Ad 5h 5c]
Seat 1: e0J9pdCNUDTCG031RnXqLA folded before Flop (didn't bet)
Seat 2: 7cYQ+syUWjl38ty/ICOMhw (button) folded on the River
Seat 5: gsyXT42WLEcOS4DdEk2wlw (small blind) collected ($10.95)
Seat 6: 997ViqAtWn1FPjJqcffwcA (big blind) folded before Flop
Seat 7: mSD1pginDsyHG5PDfqzphw folded before Flop (didn't bet)
Seat 8: j3K/Jujr7PY4ZM2RZvlH6A folded before Flop (didn't bet)
Seat 9: L5e2lrPLQm1Pqx30IIZ/Fw folded before Flop (didn't bet)



PokerStars Game #59939881754:  Hold'em No Limit ($0.25/$0.50) - 2009/07/01 0:51:25 ET
Table '/cQuAT3ef4t+PGrXiNhGaQ' 9-max Seat #9 is the button
Seat 1: HZkVla4kK2SI42CVrPZ/ig ($13.25 in chips)
Seat 2: jXGruyaMqirTaTXNOvBdew ($73.20 in chips)
Seat 3: g4k0NXISyLCqaSWZDBjfEg ($55.25 in chips)
Seat 4: OWP/DOu+PlPK6ZZ3zYa0HA ($26.40 in chips)
Seat 5: 5SgaHdWixdClWvaEG+KUjQ ($24.10 in chips)
Seat 6: APYIOyK/4AGb+kIwlOUNBQ ($37.25 in chips)
Seat 7: J0W5D97jl5VLky+IoPvDeA ($113.40 in chips)
Seat 8: eBrej2jnlUCs/JgxFCRn2g ($40 in chips)
Seat 9: AjV5McH1KMMclY26QdLM5w ($25 in chips)
HZkVla4kK2SI42CVrPZ/ig: posts small blind $0.25
jXGruyaMqirTaTXNOvBdew: posts big blind $0.50
*** HOLE CARDS ***
g4k0NXISyLCqaSWZDBjfEg: folds
OWP/DOu+PlPK6ZZ3zYa0HA: folds
5SgaHdWixdClWvaEG+KUjQ: folds
APYIOyK/4AGb+kIwlOUNBQ: folds
J0W5D97jl5VLky+IoPvDeA: raises $1.50 to $2
eBrej2jnlUCs/JgxFCRn2g: calls $2
AjV5McH1KMMclY26QdLM5w: calls $2
HZkVla4kK2SI42CVrPZ/ig: raises $10.50 to $12.50
jXGruyaMqirTaTXNOvBdew: folds
J0W5D97jl5VLky+IoPvDeA: folds
eBrej2jnlUCs/JgxFCRn2g: folds
AjV5McH1KMMclY26QdLM5w: raises $12.50 to $25 and is all-in
HZkVla4kK2SI42CVrPZ/ig: calls $0.75 and is all-in
*** FLOP *** [7c 5c 2s]
*** TURN *** [7c 5c 2s] [6h]
*** RIVER *** [7c 5c 2s 6h] [9h]
*** SHOW DOWN ***
HZkVla4kK2SI42CVrPZ/ig: shows [Ks Ah] (high card Ace)
AjV5McH1KMMclY26QdLM5w: shows [Ad Kc] (high card Ace)
HZkVla4kK2SI42CVrPZ/ig collected $14.75 from pot
AjV5McH1KMMclY26QdLM5w collected $14.70 from pot
*** SUMMARY ***
Total pot $31 | Rake $1.55
Board [7c 5c 2s 6h 9h]
Seat 1: HZkVla4kK2SI42CVrPZ/ig (small blind) showed [Ks Ah] and won ($14.75) with high card Ace
Seat 2: jXGruyaMqirTaTXNOvBdew (big blind) folded before Flop
Seat 3: g4k0NXISyLCqaSWZDBjfEg folded before Flop (didn't bet)
Seat 4: OWP/DOu+PlPK6ZZ3zYa0HA folded before Flop (didn't bet)
Seat 5: 5SgaHdWixdClWvaEG+KUjQ folded before Flop (didn't bet)
Seat 6: APYIOyK/4AGb+kIwlOUNBQ folded before Flop (didn't bet)
Seat 7: J0W5D97jl5VLky+IoPvDeA folded before Flop
Seat 8: eBrej2jnlUCs/JgxFCRn2g folded before Flop
Seat 9: AjV5McH1KMMclY26QdLM5w (button) showed [Ad Kc] and won ($14.70) with high card Ace



PokerStars Game #59939883340:  Hold'em No Limit ($0.25/$0.50) - 2009/07/01 0:51:28 ET
Table 'lpxYasB1ClBSgTpCCITwhQ' 9-max Seat #5 is the button
Seat 1: mj7PS7wCH4PAl7+eYTFs7A ($47.15 in chips)
Seat 2: OWP/DOu+PlPK6ZZ3zYa0HA ($24.85 in chips)
Seat 3: cDNz32Scry3j+v2+kE3pHg ($51.25 in chips)
Seat 5: IYd5zG8k7vdBNVHbHg2Pag ($35.85 in chips)
Seat 6: SegjDnMxWMujiD57ESNL+g ($6.50 in chips)
Seat 7: bmRtaIYKthN1F+B3JLZ3Jw ($20.70 in chips)
Seat 8: V+ivdLiYYuNr+thEXNextg ($33.50 in chips)
Seat 9: XNMDwbXt/Q4jM99AXnbJDw ($50 in chips)
SegjDnMxWMujiD57ESNL+g: posts small blind $0.25
bmRtaIYKthN1F+B3JLZ3Jw: posts big blind $0.50
NnQCepdIR/AOUQn1yhYx6Q: sits out
*** HOLE CARDS ***
V+ivdLiYYuNr+thEXNextg: folds
XNMDwbXt/Q4jM99AXnbJDw: folds
mj7PS7wCH4PAl7+eYTFs7A: folds
OWP/DOu+PlPK6ZZ3zYa0HA: folds
cDNz32Scry3j+v2+kE3pHg: raises $1 to $1.50
IYd5zG8k7vdBNVHbHg2Pag: raises $2.50 to $4
SegjDnMxWMujiD57ESNL+g: folds
bmRtaIYKthN1F+B3JLZ3Jw: folds
cDNz32Scry3j+v2+kE3pHg: folds
IYd5zG8k7vdBNVHbHg2Pag collected $3.75 from pot
IYd5zG8k7vdBNVHbHg2Pag: doesn't show hand
*** SUMMARY ***
Total pot $3.75 | Rake $0
Seat 1: mj7PS7wCH4PAl7+eYTFs7A folded before Flop (didn't bet)
Seat 2: OWP/DOu+PlPK6ZZ3zYa0HA folded before Flop (didn't bet)
Seat 3: cDNz32Scry3j+v2+kE3pHg folded before Flop
Seat 5: IYd5zG8k7vdBNVHbHg2Pag (button) collected ($3.75)
Seat 6: SegjDnMxWMujiD57ESNL+g (small blind) folded before Flop
Seat 7: bmRtaIYKthN1F+B3JLZ3Jw (big blind) folded before Flop
Seat 8: V+ivdLiYYuNr+thEXNextg folded before Flop (didn't bet)
Seat 9: XNMDwbXt/Q4jM99AXnbJDw folded before Flop (didn't bet)



PokerStars Game #59939883890:  Hold'em No Limit ($0.25/$0.50) - 2009/07/01 0:51:29 ET
Table 'GfL/No5u5PoEnU39lP5pQg' 6-max Seat #1 is the button
Seat 1: 1WUCqNG+p+vfWRTXNu4ljw ($60 in chips)
Seat 2: uVwggSetzp7d+eVgowO3vg ($64.70 in chips)
Seat 3: Ek4w9XqBXqK5jBUQeLedGw ($51.25 in chips)
Seat 4: r6u7MWSXF30/khcTYkrG9Q ($24.65 in chips)
Seat 5: M1KyQQvVPVuxqTAB8sR/zQ ($52.25 in chips)
Seat 6: kxPhs4ePFqMy52CInAJ2aw ($50.75 in chips)
uVwggSetzp7d+eVgowO3vg: posts small blind $0.25
Ek4w9XqBXqK5jBUQeLedGw: posts big blind $0.50
*** HOLE CARDS ***
r6u7MWSXF30/khcTYkrG9Q: folds
M1KyQQvVPVuxqTAB8sR/zQ: folds
kxPhs4ePFqMy52CInAJ2aw: folds
1WUCqNG+p+vfWRTXNu4ljw: folds
uVwggSetzp7d+eVgowO3vg: folds
Ek4w9XqBXqK5jBUQeLedGw collected $0.50 from pot
*** SUMMARY ***
Total pot $0.50 | Rake $0
Seat 1: 1WUCqNG+p+vfWRTXNu4ljw (button) folded before Flop (didn't bet)
Seat 2: uVwggSetzp7d+eVgowO3vg (small blind) folded before Flop
Seat 3: Ek4w9XqBXqK5jBUQeLedGw (big blind) collected ($0.50)
Seat 4: r6u7MWSXF30/khcTYkrG9Q folded before Flop (didn't bet)
Seat 5: M1KyQQvVPVuxqTAB8sR/zQ folded before Flop (didn't bet)
Seat 6: kxPhs4ePFqMy52CInAJ2aw folded before Flop (didn't bet)



PokerStars Game #59939883810:  Hold'em No Limit ($0.25/$0.50) - 2009/07/01 0:51:29 ET
Table 'QOgaEqMcJ73pcUMMxoisUg' 6-max Seat #2 is the button
Seat 1: /olYG0EzMWzADIgH1y2ySQ ($26.20 in chips)
Seat 2: 4QfsCWthT/vSLirorNXqtg ($50 in chips)
Seat 3: Rt6KgtZ8YaJoTc3FPim00w ($95.05 in chips)
Seat 4: zAcsDhG/T128Vn7XGVSgKg ($50.85 in chips)
Seat 5: 6vNxrjjCl6FwfaaymM9jjg ($32.80 in chips)
Rt6KgtZ8YaJoTc3FPim00w: posts small blind $0.25
zAcsDhG/T128Vn7XGVSgKg: posts big blind $0.50
GoVjFxr3C+JO9vtJH9+IcA: sits out
*** HOLE CARDS ***
6vNxrjjCl6FwfaaymM9jjg: folds
/olYG0EzMWzADIgH1y2ySQ: folds
4QfsCWthT/vSLirorNXqtg: raises $1 to $1.50
Rt6KgtZ8YaJoTc3FPim00w: folds
zAcsDhG/T128Vn7XGVSgKg: folds
4QfsCWthT/vSLirorNXqtg collected $1.25 from pot
*** SUMMARY ***
Total pot $1.25 | Rake $0
Seat 1: /olYG0EzMWzADIgH1y2ySQ folded before Flop (didn't bet)
Seat 2: 4QfsCWthT/vSLirorNXqtg (button) collected ($1.25)
Seat 3: Rt6KgtZ8YaJoTc3FPim00w (small blind) folded before Flop
Seat 4: zAcsDhG/T128Vn7XGVSgKg (big blind) folded before Flop
Seat 5: 6vNxrjjCl6FwfaaymM9jjg folded before Flop (didn't bet)



PokerStars Game #59939885472:  Hold'em No Limit ($0.25/$0.50) - 2009/07/01 0:51:31 ET
Table 'lSisgp6H7Fg1hH5VfjEjYQ' 9-max Seat #3 is the button
Seat 1: 5k9fvXD9suIgCxU4HLQjTw ($50.75 in chips)
Seat 2: UrcnkQOiLVk8BlKDPJSy7Q ($77.60 in chips)
Seat 3: aTkyjTh3w5YLWiIERupZOA ($51.20 in chips)
Seat 4: bwv/rbH/hHhPhY6u9mu04w ($34.35 in chips)
Seat 5: mSD1pginDsyHG5PDfqzphw ($11.35 in chips)
Seat 6: +k7T5ocke8UwavtgUHm+Cg ($28.50 in chips)
Seat 8: a4JDWmpFQkL10XfAyuF51A ($30.50 in chips)
Seat 9: gsyXT42WLEcOS4DdEk2wlw ($42.10 in chips)
bwv/rbH/hHhPhY6u9mu04w: posts small blind $0.25
mSD1pginDsyHG5PDfqzphw: posts big blind $0.50
*** HOLE CARDS ***
+k7T5ocke8UwavtgUHm+Cg: raises $1 to $1.50
a4JDWmpFQkL10XfAyuF51A: folds
gsyXT42WLEcOS4DdEk2wlw: folds
5k9fvXD9suIgCxU4HLQjTw: folds
UrcnkQOiLVk8BlKDPJSy7Q: folds
aTkyjTh3w5YLWiIERupZOA: folds
bwv/rbH/hHhPhY6u9mu04w: folds
IDtNLR9uFCDdjNsJWMHA5Q joins the table at seat #7
mSD1pginDsyHG5PDfqzphw: raises $2.50 to $4
+k7T5ocke8UwavtgUHm+Cg: folds
mSD1pginDsyHG5PDfqzphw collected $3.25 from pot
mSD1pginDsyHG5PDfqzphw: doesn't show hand
*** SUMMARY ***
Total pot $3.25 | Rake $0
Seat 1: 5k9fvXD9suIgCxU4HLQjTw folded before Flop (didn't bet)
Seat 2: UrcnkQOiLVk8BlKDPJSy7Q folded before Flop (didn't bet)
Seat 3: aTkyjTh3w5YLWiIERupZOA (button) folded before Flop (didn't bet)
Seat 4: bwv/rbH/hHhPhY6u9mu04w (small blind) folded before Flop
Seat 5: mSD1pginDsyHG5PDfqzphw (big blind) collected ($3.25)
Seat 6: +k7T5ocke8UwavtgUHm+Cg folded before Flop
Seat 8: a4JDWmpFQkL10XfAyuF51A folded before Flop (didn't bet)
Seat 9: gsyXT42WLEcOS4DdEk2wlw folded before Flop (didn't bet)



PokerStars Game #59939885910:  Hold'em No Limit ($0.25/$0.50) - 2009/07/01 0:51:32 ET
Table 'T/PgNWqVyY6lkldcBVXYJQ' 6-max Seat #4 is the button
Seat 1: +Pf9jTVizYlIo+woPvptfA ($78 in chips)
Seat 2: LvH4G7n+QSjT6NDaD3cREA ($55.75 in chips)
Seat 3: L3OcNO1bgdqDI46j67KQPQ ($50 in chips)
Seat 4: Ek4w9XqBXqK5jBUQeLedGw ($50 in chips)
Seat 5: of9mtXiD8G4Nx5p7hCbgqQ ($50 in chips)
Seat 6: khHFhne53qR5U3ky0T78jw ($10 in chips)
of9mtXiD8G4Nx5p7hCbgqQ: posts small blind $0.25
khHFhne53qR5U3ky0T78jw: posts big blind $0.50
*** HOLE CARDS ***
+Pf9jTVizYlIo+woPvptfA: folds
LvH4G7n+QSjT6NDaD3cREA: folds
L3OcNO1bgdqDI46j67KQPQ: folds
Ek4w9XqBXqK5jBUQeLedGw: folds
of9mtXiD8G4Nx5p7hCbgqQ: folds
khHFhne53qR5U3ky0T78jw collected $0.50 from pot
*** SUMMARY ***
Total pot $0.50 | Rake $0
Seat 1: +Pf9jTVizYlIo+woPvptfA folded before Flop (didn't bet)
Seat 2: LvH4G7n+QSjT6NDaD3cREA folded before Flop (didn't bet)
Seat 3: L3OcNO1bgdqDI46j67KQPQ folded before Flop (didn't bet)
Seat 4: Ek4w9XqBXqK5jBUQeLedGw (button) folded before Flop (didn't bet)
Seat 5: of9mtXiD8G4Nx5p7hCbgqQ (small blind) folded before Flop
Seat 6: khHFhne53qR5U3ky0T78jw (big blind) collected ($0.50)



PokerStars Game #59939885776:  Hold'em No Limit ($0.25/$0.50) - 2009/07/01 0:51:32 ET
Table 'BCN5su+SsXiy1zRMJi0SJw' 6-max Seat #2 is the button
Seat 1: GxXV09ciXaOxyY2H5aMIIw ($28.75 in chips)
Seat 2: oU2kDCkT/gilYbHWrg7D8w ($31.75 in chips)
Seat 3: g+vwI6lMKpU2uteXSjOzVw ($17.50 in chips)
Seat 5: IBNygaT1aa9Z1uPdJJilwA ($13.05 in chips)
Seat 6: b2symlOdL7+0c9Pj4N/KlA ($82.95 in chips)
g+vwI6lMKpU2uteXSjOzVw: posts small blind $0.25
JY9CtoZTeav+mhWyxSSyJQ leaves the table
IBNygaT1aa9Z1uPdJJilwA: posts big blind $0.50
*** HOLE CARDS ***
b2symlOdL7+0c9Pj4N/KlA: raises $1.50 to $2
oU2kDCkT/gilYbHWrg7D8w said, "lol"
GxXV09ciXaOxyY2H5aMIIw: folds
oU2kDCkT/gilYbHWrg7D8w said, "of course"
oU2kDCkT/gilYbHWrg7D8w: folds
g+vwI6lMKpU2uteXSjOzVw: folds
IBNygaT1aa9Z1uPdJJilwA: folds
b2symlOdL7+0c9Pj4N/KlA collected $1.25 from pot
b2symlOdL7+0c9Pj4N/KlA: doesn't show hand
*** SUMMARY ***
Total pot $1.25 | Rake $0
Seat 1: GxXV09ciXaOxyY2H5aMIIw folded before Flop (didn't bet)
Seat 2: oU2kDCkT/gilYbHWrg7D8w (button) folded before Flop (didn't bet)
Seat 3: g+vwI6lMKpU2uteXSjOzVw (small blind) folded before Flop
Seat 5: IBNygaT1aa9Z1uPdJJilwA (big blind) folded before Flop
Seat 6: b2symlOdL7+0c9Pj4N/KlA collected ($1.25)



PokerStars Game #59939886894:  Hold'em No Limit ($0.25/$0.50) - 2009/07/01 0:51:33 ET
Table '+dXkOAQyS8j9PQZusUTMpg' 2-max Seat #2 is the button
Seat 1: XFa6sBGjP2gxoIvxR3fZIg ($60.40 in chips)
Seat 2: 5IBeOgaApY1Bvzv2P8X4EA ($141.30 in chips)
5IBeOgaApY1Bvzv2P8X4EA: posts small blind $0.25
XFa6sBGjP2gxoIvxR3fZIg: posts big blind $0.50
*** HOLE CARDS ***
5IBeOgaApY1Bvzv2P8X4EA: folds
XFa6sBGjP2gxoIvxR3fZIg collected $0.50 from pot
XFa6sBGjP2gxoIvxR3fZIg: doesn't show hand
*** SUMMARY ***
Total pot $0.50 | Rake $0
Seat 1: XFa6sBGjP2gxoIvxR3fZIg (big blind) collected ($0.50)
Seat 2: 5IBeOgaApY1Bvzv2P8X4EA (button) (small blind) folded before Flop



PokerStars Game #59939888088:  Hold'em No Limit ($0.25/$0.50) - 2009/07/01 0:51:35 ET
Table '99gCy/CZQwPIjZWH+BguQgE7bWJ45aoFXRpyRv2gw+Igeat #8 is the button
Seat 2: n6VQBu6crjYjy6DxNP1NZA ($29.50 in chips)
Seat 3: qEn9ijNGtuyTxamBf07hYg ($50 in chips)
Seat 4: bxLSulbgr8LmKNjOzw8URg ($61.45 in chips)
Seat 5: DSM67hHHq1XFoEOi9p8Alw ($46 in chips)
Seat 7: bfSq6LBw0UvxeM5yfuWC7w ($16.35 in chips)
Seat 8: 8ehL7qlZzjgUh2H35iiWLw ($55.25 in chips)
Seat 9: j3K/Jujr7PY4ZM2RZvlH6A ($92.90 in chips)
j3K/Jujr7PY4ZM2RZvlH6A: posts small blind $0.25
n6VQBu6crjYjy6DxNP1NZA: posts big blind $0.50
*** HOLE CARDS ***
qEn9ijNGtuyTxamBf07hYg: folds
bxLSulbgr8LmKNjOzw8URg: folds
DSM67hHHq1XFoEOi9p8Alw: folds
bfSq6LBw0UvxeM5yfuWC7w: folds
8ehL7qlZzjgUh2H35iiWLw: raises $1.50 to $2
j3K/Jujr7PY4ZM2RZvlH6A: folds
n6VQBu6crjYjy6DxNP1NZA: folds
8ehL7qlZzjgUh2H35iiWLw collected $1.25 from pot
8ehL7qlZzjgUh2H35iiWLw: doesn't show hand
*** SUMMARY ***
Total pot $1.25 | Rake $0
Seat 2: n6VQBu6crjYjy6DxNP1NZA (big blind) folded before Flop
Seat 3: qEn9ijNGtuyTxamBf07hYg folded before Flop (didn't bet)
Seat 4: bxLSulbgr8LmKNjOzw8URg folded before Flop (didn't bet)
Seat 5: DSM67hHHq1XFoEOi9p8Alw folded before Flop (didn't bet)
Seat 7: bfSq6LBw0UvxeM5yfuWC7w folded before Flop (didn't bet)
Seat 8: 8ehL7qlZzjgUh2H35iiWLw (button) collected ($1.25)
Seat 9: j3K/Jujr7PY4ZM2RZvlH6A (small blind) folded before Flop



PokerStars Game #59939888666:  Hold'em No Limit ($0.25/$0.50) - 2009/07/01 0:51:36 ET
Table 'NCiXr0d5CEKBQr/cZgLhbA' 9-max Seat #6 is the button
Seat 1: pFtzb1sR4b0d1aw6aIRgDg ($50 in chips)
Seat 2: ulxuJchBV9iguXg0FUonfg ($47.75 in chips)
Seat 3: xZCXQSXlrZkp3pZizzVXCw ($52.25 in chips)
Seat 4: 5k9fvXD9suIgCxU4HLQjTw ($55.95 in chips)
Seat 5: zE9cVigS2nW/Ljy4K4bUQA ($35.95 in chips)
Seat 6: SKnJuWHScqetA/qG5p+wCg ($34.75 in chips)
Seat 7: M+7+BTmX5vZatHVuoRB1nA ($46.60 in chips)
Seat 8: 1MJUKc3cc0QmUoz1JZLR2w ($59 in chips)
Seat 9: 4WLZvqBn5qv5tds5kt5A1Q ($46.55 in chips)
M+7+BTmX5vZatHVuoRB1nA: posts small blind $0.25
1MJUKc3cc0QmUoz1JZLR2w: posts big blind $0.50
*** HOLE CARDS ***
4WLZvqBn5qv5tds5kt5A1Q: folds
pFtzb1sR4b0d1aw6aIRgDg: calls $0.50
ulxuJchBV9iguXg0FUonfg: folds
xZCXQSXlrZkp3pZizzVXCw: folds
5k9fvXD9suIgCxU4HLQjTw: folds
zE9cVigS2nW/Ljy4K4bUQA: folds
SKnJuWHScqetA/qG5p+wCg: folds
M+7+BTmX5vZatHVuoRB1nA: calls $0.25
1MJUKc3cc0QmUoz1JZLR2w: checks
*** FLOP *** [4h Td 8s]
M+7+BTmX5vZatHVuoRB1nA: bets $1
1MJUKc3cc0QmUoz1JZLR2w: folds
pFtzb1sR4b0d1aw6aIRgDg: folds
M+7+BTmX5vZatHVuoRB1nA collected $1.45 from pot
*** SUMMARY ***
Total pot $1.50 | Rake $0.05
Board [4h Td 8s]
Seat 1: pFtzb1sR4b0d1aw6aIRgDg folded on the Flop
Seat 2: ulxuJchBV9iguXg0FUonfg folded before Flop (didn't bet)
Seat 3: xZCXQSXlrZkp3pZizzVXCw folded before Flop (didn't bet)
Seat 4: 5k9fvXD9suIgCxU4HLQjTw folded before Flop (didn't bet)
Seat 5: zE9cVigS2nW/Ljy4K4bUQA folded before Flop (didn't bet)
Seat 6: SKnJuWHScqetA/qG5p+wCg (button) folded before Flop (didn't bet)
Seat 7: M+7+BTmX5vZatHVuoRB1nA (small blind) collected ($1.45)
Seat 8: 1MJUKc3cc0QmUoz1JZLR2w (big blind) folded on the Flop
Seat 9: 4WLZvqBn5qv5tds5kt5A1Q folded before Flop (didn't bet)



PokerStars Game #59939890428:  Hold'em No Limit ($0.25/$0.50) - 2009/07/01 0:51:39 ET
Table '5EmHi+fnatGQQShcNmzOZQ' 6-max Seat #5 is the button
Seat 1: HGzUMAFxR1k8+S4gfnB39w ($30.90 in chips)
Seat 3: TjmTe3bhs9dFz5gXX9x7Lw ($27.25 in chips)
Seat 4: 1b+2BbjMN8qhR1WPqdE9VQ ($63.25 in chips)
Seat 5: kxPhs4ePFqMy52CInAJ2aw ($49.75 in chips)
Seat 6: 686aeHikcJlgKkSuIFdcXQ ($135.45 in chips)
686aeHikcJlgKkSuIFdcXQ: posts small blind $0.25
HGzUMAFxR1k8+S4gfnB39w: posts big blind $0.50
*** HOLE CARDS ***
TjmTe3bhs9dFz5gXX9x7Lw: folds
1b+2BbjMN8qhR1WPqdE9VQ: folds
kxPhs4ePFqMy52CInAJ2aw: folds
686aeHikcJlgKkSuIFdcXQ: folds
HGzUMAFxR1k8+S4gfnB39w collected $0.50 from pot
*** SUMMARY ***
Total pot $0.50 | Rake $0
Seat 1: HGzUMAFxR1k8+S4gfnB39w (big blind) collected ($0.50)
Seat 3: TjmTe3bhs9dFz5gXX9x7Lw folded before Flop (didn't bet)
Seat 4: 1b+2BbjMN8qhR1WPqdE9VQ folded before Flop (didn't bet)
Seat 5: kxPhs4ePFqMy52CInAJ2aw (button) folded before Flop (didn't bet)
Seat 6: 686aeHikcJlgKkSuIFdcXQ (small blind) folded before Flop



PokerStars Game #59939891328:  Hold'em No Limit ($0.25/$0.50) - 2009/07/01 0:51:40 ET
Table '+dXkOAQyS8j9PQZusUTMpg' 2-max Seat #1 is the button
Seat 1: XFa6sBGjP2gxoIvxR3fZIg ($60.65 in chips)
Seat 2: 5IBeOgaApY1Bvzv2P8X4EA ($141.05 in chips)
XFa6sBGjP2gxoIvxR3fZIg: posts small blind $0.25
5IBeOgaApY1Bvzv2P8X4EA: posts big blind $0.50
*** HOLE CARDS ***
XFa6sBGjP2gxoIvxR3fZIg: calls $0.25
5IBeOgaApY1Bvzv2P8X4EA: checks
*** FLOP *** [7s 8d 8h]
5IBeOgaApY1Bvzv2P8X4EA: checks
XFa6sBGjP2gxoIvxR3fZIg: bets $1
5IBeOgaApY1Bvzv2P8X4EA: folds
XFa6sBGjP2gxoIvxR3fZIg collected $0.95 from pot
XFa6sBGjP2gxoIvxR3fZIg: doesn't show hand
*** SUMMARY ***
Total pot $1 | Rake $0.05
Board [7s 8d 8h]
Seat 1: XFa6sBGjP2gxoIvxR3fZIg (button) (small blind) collected ($0.95)
Seat 2: 5IBeOgaApY1Bvzv2P8X4EA (big blind) folded on the Flop



PokerStars Game #59939891458:  Hold'em No Limit ($0.25/$0.50) - 2009/07/01 0:51:41 ET
Table '0eJtgVAXVvBgncFdcUpXcQ' 2-max Seat #1 is the button
Seat 1: Ag6DvxX4vbRheqsv2zXKTQ ($37.15 in chips)
Seat 2: KMc4R+K9ao4Ur3rF7NGe6Q ($14.95 in chips)
Ag6DvxX4vbRheqsv2zXKTQ: posts small blind $0.25
KMc4R+K9ao4Ur3rF7NGe6Q: posts big blind $0.50
*** HOLE CARDS ***
Ag6DvxX4vbRheqsv2zXKTQ: raises $0.50 to $1
KMc4R+K9ao4Ur3rF7NGe6Q: calls $0.50
*** FLOP *** [3s Ks Ts]
KMc4R+K9ao4Ur3rF7NGe6Q: checks
Ag6DvxX4vbRheqsv2zXKTQ: bets $1.50
KMc4R+K9ao4Ur3rF7NGe6Q: folds
Ag6DvxX4vbRheqsv2zXKTQ collected $1.90 from pot
Ag6DvxX4vbRheqsv2zXKTQ: shows [Kd 9c] (a pair of Kings)
*** SUMMARY ***
Total pot $2 | Rake $0.10
Board [3s Ks Ts]
Seat 1: Ag6DvxX4vbRheqsv2zXKTQ (button) (small blind) collected ($1.90)
Seat 2: KMc4R+K9ao4Ur3rF7NGe6Q (big blind) folded on the Flop



PokerStars Game #59939894004:  Hold'em No Limit ($0.25/$0.50) - 2009/07/01 0:51:44 ET
Table 'c/CRn+68J3Y8KxD5g1ek2Q' 2-max Seat #1 is the button
Seat 1: 46qCyJ6evTkHo9al5sBMNA ($90.85 in chips)
Seat 2: BypVLsYQt3ePFm2xQL/dOA ($281.05 in chips)
46qCyJ6evTkHo9al5sBMNA: posts small blind $0.25
BypVLsYQt3ePFm2xQL/dOA: posts big blind $0.50
*** HOLE CARDS ***
46qCyJ6evTkHo9al5sBMNA: folds
BypVLsYQt3ePFm2xQL/dOA collected $0.50 from pot
BypVLsYQt3ePFm2xQL/dOA: doesn't show hand
*** SUMMARY ***
Total pot $0.50 | Rake $0
Seat 1: 46qCyJ6evTkHo9al5sBMNA (button) (small blind) folded before Flop
Seat 2: BypVLsYQt3ePFm2xQL/dOA (big blind) collected ($0.50)



PokerStars Game #59939894070:  Hold'em No Limit ($0.25/$0.50) - 2009/07/01 0:51:45 ET
Table 'EiNh8p/wGJ1FP575iMFnqg' 9-max Seat #6 is the button
Seat 1: r3ZqM1Mi0W3y4hOdssE+Sg ($45.85 in chips)
Seat 2: 8ehL7qlZzjgUh2H35iiWLw ($52.60 in chips)
Seat 3: ymLPoEIl7UL3TvZYmnadxQ ($50.85 in chips)
Seat 4: cMzaiXAM/ZAdNaEUu+LqhA ($54.95 in chips)
Seat 5: M+7+BTmX5vZatHVuoRB1nA ($82.20 in chips)
Seat 6: 3UmXLy3GfjC3EkOebduerQ ($65.35 in chips)
Seat 7: 997ViqAtWn1FPjJqcffwcA ($50.25 in chips)
Seat 8: mSD1pginDsyHG5PDfqzphw ($10 in chips)
Seat 9: NnQCepdIR/AOUQn1yhYx6Q ($9.25 in chips)
997ViqAtWn1FPjJqcffwcA: posts small blind $0.25
mSD1pginDsyHG5PDfqzphw: posts big blind $0.50
*** HOLE CARDS ***
NnQCepdIR/AOUQn1yhYx6Q: folds
r3ZqM1Mi0W3y4hOdssE+Sg: folds
8ehL7qlZzjgUh2H35iiWLw: folds
ymLPoEIl7UL3TvZYmnadxQ: folds
cMzaiXAM/ZAdNaEUu+LqhA: raises $1.50 to $2
M+7+BTmX5vZatHVuoRB1nA: folds
3UmXLy3GfjC3EkOebduerQ: folds
997ViqAtWn1FPjJqcffwcA: folds
mSD1pginDsyHG5PDfqzphw: folds
cMzaiXAM/ZAdNaEUu+LqhA collected $1.25 from pot
cMzaiXAM/ZAdNaEUu+LqhA: doesn't show hand
*** SUMMARY ***
Total pot $1.25 | Rake $0
Seat 1: r3ZqM1Mi0W3y4hOdssE+Sg folded before Flop (didn't bet)
Seat 2: 8ehL7qlZzjgUh2H35iiWLw folded before Flop (didn't bet)
Seat 3: ymLPoEIl7UL3TvZYmnadxQ folded before Flop (didn't bet)
Seat 4: cMzaiXAM/ZAdNaEUu+LqhA collected ($1.25)
Seat 5: M+7+BTmX5vZatHVuoRB1nA folded before Flop (didn't bet)
Seat 6: 3UmXLy3GfjC3EkOebduerQ (button) folded before Flop (didn't bet)
Seat 7: 997ViqAtWn1FPjJqcffwcA (small blind) folded before Flop
Seat 8: mSD1pginDsyHG5PDfqzphw (big blind) folded before Flop
Seat 9: NnQCepdIR/AOUQn1yhYx6Q folded before Flop (didn't bet)



PokerStars Game #59939895248:  Hold'em No Limit ($0.25/$0.50) - 2009/07/01 0:51:47 ET
Table 'BCN5su+SsXiy1zRMJi0SJw' 6-max Seat #3 is the button
Seat 1: GxXV09ciXaOxyY2H5aMIIw ($28.75 in chips)
Seat 2: oU2kDCkT/gilYbHWrg7D8w ($31.75 in chips)
Seat 3: g+vwI6lMKpU2uteXSjOzVw ($17.25 in chips)
Seat 5: IBNygaT1aa9Z1uPdJJilwA ($12.55 in chips)
Seat 6: b2symlOdL7+0c9Pj4N/KlA ($83.70 in chips)
IBNygaT1aa9Z1uPdJJilwA: posts small blind $0.25
b2symlOdL7+0c9Pj4N/KlA: posts big blind $0.50
*** HOLE CARDS ***
GxXV09ciXaOxyY2H5aMIIw: folds
oU2kDCkT/gilYbHWrg7D8w: calls $0.50
g+vwI6lMKpU2uteXSjOzVw: raises $1 to $1.50
IBNygaT1aa9Z1uPdJJilwA: raises $11.05 to $12.55 and is all-in
b2symlOdL7+0c9Pj4N/KlA: folds
oU2kDCkT/gilYbHWrg7D8w: raises $11.05 to $23.60
g+vwI6lMKpU2uteXSjOzVw: folds
*** FLOP *** [3s Ah 6h]
*** TURN *** [3s Ah 6h] [2d]
*** RIVER *** [3s Ah 6h 2d] [6s]
*** SHOW DOWN ***
IBNygaT1aa9Z1uPdJJilwA: shows [9c As] (two pair, Aces and Sixes)
oU2kDCkT/gilYbHWrg7D8w: mucks hand
IBNygaT1aa9Z1uPdJJilwA collected $25.75 from pot
*** SUMMARY ***
Total pot $27.10 | Rake $1.35
Board [3s Ah 6h 2d 6s]
Seat 1: GxXV09ciXaOxyY2H5aMIIw folded before Flop (didn't bet)
Seat 2: oU2kDCkT/gilYbHWrg7D8w mucked
Seat 3: g+vwI6lMKpU2uteXSjOzVw (button) folded before Flop
Seat 5: IBNygaT1aa9Z1uPdJJilwA (small blind) showed [9c As] and won ($25.75) with two pair, Aces and Sixes
Seat 6: b2symlOdL7+0c9Pj4N/KlA (big blind) folded before Flop



PokerStars Game #59939895928:  Hold'em No Limit ($0.25/$0.50) - 2009/07/01 0:51:48 ET
Table 'Vdlc9wqYcHTUhtdyN7CuJw' 2-max Seat #1 is the button
Seat 1: yBO+mXB6m/rCft2ErwGf/Q ($115.05 in chips)
Seat 2: NZ/5cxwnorKW2SNsWy1+8A ($10.05 in chips)
yBO+mXB6m/rCft2ErwGf/Q: posts small blind $0.25
NZ/5cxwnorKW2SNsWy1+8A: posts big blind $0.50
*** HOLE CARDS ***
yBO+mXB6m/rCft2ErwGf/Q: calls $0.25
NZ/5cxwnorKW2SNsWy1+8A: raises $1 to $1.50
yBO+mXB6m/rCft2ErwGf/Q has timed out
yBO+mXB6m/rCft2ErwGf/Q: folds
yBO+mXB6m/rCft2ErwGf/Q is sitting out
NZ/5cxwnorKW2SNsWy1+8A collected $1 from pot
NZ/5cxwnorKW2SNsWy1+8A: doesn't show hand
*** SUMMARY ***
Total pot $1 | Rake $0
Seat 1: yBO+mXB6m/rCft2ErwGf/Q (button) (small blind) folded before Flop
Seat 2: NZ/5cxwnorKW2SNsWy1+8A (big blind) collected ($1)



PokerStars Game #59939896264:  Hold'em No Limit ($0.25/$0.50) - 2009/07/01 0:51:48 ET
Table 'GfL/No5u5PoEnU39lP5pQg' 6-max Seat #2 is the button
Seat 1: 1WUCqNG+p+vfWRTXNu4ljw ($60 in chips)
Seat 2: uVwggSetzp7d+eVgowO3vg ($64.45 in chips)
Seat 3: Ek4w9XqBXqK5jBUQeLedGw ($51.50 in chips)
Seat 4: r6u7MWSXF30/khcTYkrG9Q ($24.65 in chips)
Seat 5: M1KyQQvVPVuxqTAB8sR/zQ ($52.25 in chips)
Seat 6: kxPhs4ePFqMy52CInAJ2aw ($50.75 in chips)
Ek4w9XqBXqK5jBUQeLedGw: posts small blind $0.25
r6u7MWSXF30/khcTYkrG9Q: posts big blind $0.50
*** HOLE CARDS ***
M1KyQQvVPVuxqTAB8sR/zQ: folds
kxPhs4ePFqMy52CInAJ2aw: folds
1WUCqNG+p+vfWRTXNu4ljw: folds
uVwggSetzp7d+eVgowO3vg: folds
Ek4w9XqBXqK5jBUQeLedGw: folds
r6u7MWSXF30/khcTYkrG9Q collected $0.50 from pot
*** SUMMARY ***
Total pot $0.50 | Rake $0
Seat 1: 1WUCqNG+p+vfWRTXNu4ljw folded before Flop (didn't bet)
Seat 2: uVwggSetzp7d+eVgowO3vg (button) folded before Flop (didn't bet)
Seat 3: Ek4w9XqBXqK5jBUQeLedGw (small blind) folded before Flop
Seat 4: r6u7MWSXF30/khcTYkrG9Q (big blind) collected ($0.50)
Seat 5: M1KyQQvVPVuxqTAB8sR/zQ folded before Flop (didn't bet)
Seat 6: kxPhs4ePFqMy52CInAJ2aw folded before Flop (didn't bet)



PokerStars Game #59939896166:  Hold'em No Limit ($0.25/$0.50) - 2009/07/01 0:51:48 ET
Table 'fx6MqwfYAj/Rt86hBz2L3Q' 9-max Seat #4 is the button
Seat 1: SegjDnMxWMujiD57ESNL+g ($10 in chips)
Seat 3: iadBi5AEt7gTBXbDSSnMYQ ($52.60 in chips)
Seat 4: gPEN9Zp33YTm/mu9/SYP1w ($22.55 in chips)
Seat 5: iAISe3dVeua8PUn2wwgDHw ($32.50 in chips)
Seat 6: 5k9fvXD9suIgCxU4HLQjTw ($50.75 in chips)
Seat 7: SKnJuWHScqetA/qG5p+wCg ($30 in chips)
Seat 8: JYwJYYV9pM5KWdSiETl8rA ($27.25 in chips)
Seat 9: HZkVla4kK2SI42CVrPZ/ig ($11 in chips)
iAISe3dVeua8PUn2wwgDHw: posts small blind $0.25
5k9fvXD9suIgCxU4HLQjTw: posts big blind $0.50
*** HOLE CARDS ***
SKnJuWHScqetA/qG5p+wCg: folds
JYwJYYV9pM5KWdSiETl8rA: folds
HZkVla4kK2SI42CVrPZ/ig: folds
SegjDnMxWMujiD57ESNL+g: calls $0.50
iadBi5AEt7gTBXbDSSnMYQ: calls $0.50
gPEN9Zp33YTm/mu9/SYP1w: calls $0.50
iAISe3dVeua8PUn2wwgDHw: calls $0.25
5k9fvXD9suIgCxU4HLQjTw: checks
*** FLOP *** [Jd Qh 6d]
iAISe3dVeua8PUn2wwgDHw: checks
5k9fvXD9suIgCxU4HLQjTw: checks
SegjDnMxWMujiD57ESNL+g: checks
iadBi5AEt7gTBXbDSSnMYQ: checks
gPEN9Zp33YTm/mu9/SYP1w: bets $0.50
iAISe3dVeua8PUn2wwgDHw: calls $0.50
5k9fvXD9suIgCxU4HLQjTw: folds
SegjDnMxWMujiD57ESNL+g: calls $0.50
iadBi5AEt7gTBXbDSSnMYQ: calls $0.50
*** TURN *** [Jd Qh 6d] [8s]
iAISe3dVeua8PUn2wwgDHw: checks
SegjDnMxWMujiD57ESNL+g: checks
iadBi5AEt7gTBXbDSSnMYQ: checks
gPEN9Zp33YTm/mu9/SYP1w: checks
*** RIVER *** [Jd Qh 6d 8s] [Tc]
iAISe3dVeua8PUn2wwgDHw: checks
SegjDnMxWMujiD57ESNL+g: checks
iadBi5AEt7gTBXbDSSnMYQ: bets $8
C3rGXblctNcWI6JYPHhaEg has returned
gPEN9Zp33YTm/mu9/SYP1w: raises $13.55 to $21.55 and is all-in
iAISe3dVeua8PUn2wwgDHw: folds
SegjDnMxWMujiD57ESNL+g: folds
iadBi5AEt7gTBXbDSSnMYQ: calls $13.55
*** SHOW DOWN ***
gPEN9Zp33YTm/mu9/SYP1w: shows [Jh 9d] (a straight, Eight to Queen)
iadBi5AEt7gTBXbDSSnMYQ: shows [9c Kc] (a straight, Nine to King)
iadBi5AEt7gTBXbDSSnMYQ collected $45.25 from pot
*** SUMMARY ***
Total pot $47.60 | Rake $2.35
Board [Jd Qh 6d 8s Tc]
Seat 1: SegjDnMxWMujiD57ESNL+g folded on the River
Seat 3: iadBi5AEt7gTBXbDSSnMYQ showed [9c Kc] and won ($45.25) with a straight, Nine to King
Seat 4: gPEN9Zp33YTm/mu9/SYP1w (button) showed [Jh 9d] and lost with a straight, Eight to Queen
Seat 5: iAISe3dVeua8PUn2wwgDHw (small blind) folded on the River
Seat 6: 5k9fvXD9suIgCxU4HLQjTw (big blind) folded on the Flop
Seat 7: SKnJuWHScqetA/qG5p+wCg folded before Flop (didn't bet)
Seat 8: JYwJYYV9pM5KWdSiETl8rA folded before Flop (didn't bet)
Seat 9: HZkVla4kK2SI42CVrPZ/ig folded before Flop (didn't bet)



PokerStars Game #59939896520:  Hold'em No Limit ($0.25/$0.50) - 2009/07/01 0:51:49 ET
Table 'QOgaEqMcJ73pcUMMxoisUg' 6-max Seat #3 is the button
Seat 1: /olYG0EzMWzADIgH1y2ySQ ($26.20 in chips)
Seat 2: 4QfsCWthT/vSLirorNXqtg ($50.75 in chips)
Seat 3: Rt6KgtZ8YaJoTc3FPim00w ($94.80 in chips)
Seat 4: zAcsDhG/T128Vn7XGVSgKg ($50.35 in chips)
Seat 5: 6vNxrjjCl6FwfaaymM9jjg ($32.80 in chips)
zAcsDhG/T128Vn7XGVSgKg: posts small blind $0.25
6vNxrjjCl6FwfaaymM9jjg: posts big blind $0.50
GoVjFxr3C+JO9vtJH9+IcA: sits out
*** HOLE CARDS ***
/olYG0EzMWzADIgH1y2ySQ: folds
4QfsCWthT/vSLirorNXqtg: folds
Rt6KgtZ8YaJoTc3FPim00w: folds
zAcsDhG/T128Vn7XGVSgKg: folds
6vNxrjjCl6FwfaaymM9jjg collected $0.50 from pot
6vNxrjjCl6FwfaaymM9jjg: doesn't show hand
*** SUMMARY ***
Total pot $0.50 | Rake $0
Seat 1: /olYG0EzMWzADIgH1y2ySQ folded before Flop (didn't bet)
Seat 2: 4QfsCWthT/vSLirorNXqtg folded before Flop (didn't bet)
Seat 3: Rt6KgtZ8YaJoTc3FPim00w (button) folded before Flop (didn't bet)
Seat 4: zAcsDhG/T128Vn7XGVSgKg (small blind) folded before Flop
Seat 5: 6vNxrjjCl6FwfaaymM9jjg (big blind) collected ($0.50)



PokerStars Game #59939897692:  Hold'em No Limit ($0.25/$0.50) - 2009/07/01 0:51:50 ET
Table 'c/CRn+68J3Y8KxD5g1ek2Q' 2-max Seat #2 is the button
Seat 1: 46qCyJ6evTkHo9al5sBMNA ($90.60 in chips)
Seat 2: BypVLsYQt3ePFm2xQL/dOA ($281.30 in chips)
BypVLsYQt3ePFm2xQL/dOA: posts small blind $0.25
46qCyJ6evTkHo9al5sBMNA: posts big blind $0.50
*** HOLE CARDS ***
BypVLsYQt3ePFm2xQL/dOA: calls $0.25
46qCyJ6evTkHo9al5sBMNA: raises $1.50 to $2
BypVLsYQt3ePFm2xQL/dOA: calls $1.50
*** FLOP *** [5c Qc 9d]
46qCyJ6evTkHo9al5sBMNA: checks
BypVLsYQt3ePFm2xQL/dOA: checks
*** TURN *** [5c Qc 9d] [3h]
46qCyJ6evTkHo9al5sBMNA: checks
BypVLsYQt3ePFm2xQL/dOA: checks
*** RIVER *** [5c Qc 9d 3h] [4h]
46qCyJ6evTkHo9al5sBMNA: checks
BypVLsYQt3ePFm2xQL/dOA: checks
*** SHOW DOWN ***
46qCyJ6evTkHo9al5sBMNA: shows [Ks Td] (high card King)
BypVLsYQt3ePFm2xQL/dOA: shows [6s 6h] (a pair of Sixes)
BypVLsYQt3ePFm2xQL/dOA collected $3.80 from pot
*** SUMMARY ***
Total pot $4 | Rake $0.20
Board [5c Qc 9d 3h 4h]
Seat 1: 46qCyJ6evTkHo9al5sBMNA (big blind) showed [Ks Td] and lost with high card King
Seat 2: BypVLsYQt3ePFm2xQL/dOA (button) (small blind) showed [6s 6h] and won ($3.80) with a pair of Sixes



PokerStars Game #59939898802:  Hold'em No Limit ($0.25/$0.50) - 2009/07/01 0:51:52 ET
Table 'E7bWJ45aoFXRpyRv2gw+Ig' 2-max Seat #1 is the button
Seat 1: FRkiRasEGlHUeLrEl+k/nA ($107.75 in chips)
Seat 2: 3Wro85I7472vJ4Wkpneo9A ($85.25 in chips)
FRkiRasEGlHUeLrEl+k/nA: posts small blind $0.25
3Wro85I7472vJ4Wkpneo9A: posts big blind $0.50
*** HOLE CARDS ***
FRkiRasEGlHUeLrEl+k/nA: folds
3Wro85I7472vJ4Wkpneo9A collected $0.50 from pot
3Wro85I7472vJ4Wkpneo9A: doesn't show hand
*** SUMMARY ***
Total pot $0.50 | Rake $0
Seat 1: FRkiRasEGlHUeLrEl+k/nA (button) (small blind) folded before Flop
Seat 2: 3Wro85I7472vJ4Wkpneo9A (big blind) collected ($0.50)



PokerStars Game #59939898844:  Hold'em No Limit ($0.25/$0.50) - 2009/07/01 0:51:52 ET
Table 'T/PgNWqVyY6lkldcBVXYJQ' 6-max Seat #5 is the button
Seat 1: +Pf9jTVizYlIo+woPvptfA ($78 in chips)
Seat 2: LvH4G7n+QSjT6NDaD3cREA ($55.75 in chips)
Seat 3: L3OcNO1bgdqDI46j67KQPQ ($50 in chips)
Seat 4: Ek4w9XqBXqK5jBUQeLedGw ($50 in chips)
Seat 5: of9mtXiD8G4Nx5p7hCbgqQ ($50 in chips)
Seat 6: khHFhne53qR5U3ky0T78jw ($10.25 in chips)
khHFhne53qR5U3ky0T78jw: posts small blind $0.25
+Pf9jTVizYlIo+woPvptfA: posts big blind $0.50
*** HOLE CARDS ***
LvH4G7n+QSjT6NDaD3cREA: folds
L3OcNO1bgdqDI46j67KQPQ: folds
Ek4w9XqBXqK5jBUQeLedGw: folds
of9mtXiD8G4Nx5p7hCbgqQ: raises $1 to $1.50
khHFhne53qR5U3ky0T78jw: calls $1.25
+Pf9jTVizYlIo+woPvptfA: calls $1
*** FLOP *** [Kh 5c 8d]
khHFhne53qR5U3ky0T78jw: bets $0.50
+Pf9jTVizYlIo+woPvptfA: folds
of9mtXiD8G4Nx5p7hCbgqQ: raises $4.50 to $5
khHFhne53qR5U3ky0T78jw: folds
of9mtXiD8G4Nx5p7hCbgqQ collected $5.25 from pot
of9mtXiD8G4Nx5p7hCbgqQ: doesn't show hand
*** SUMMARY ***
Total pot $5.50 | Rake $0.25
Board [Kh 5c 8d]
Seat 1: +Pf9jTVizYlIo+woPvptfA (big blind) folded on the Flop
Seat 2: LvH4G7n+QSjT6NDaD3cREA folded before Flop (didn't bet)
Seat 3: L3OcNO1bgdqDI46j67KQPQ folded before Flop (didn't bet)
Seat 4: Ek4w9XqBXqK5jBUQeLedGw folded before Flop (didn't bet)
Seat 5: of9mtXiD8G4Nx5p7hCbgqQ (button) collected ($5.25)
Seat 6: khHFhne53qR5U3ky0T78jw (small blind) folded on the Flop



PokerStars Game #59939899222:  Hold'em No Limit ($0.25/$0.50) - 2009/07/01 0:51:53 ET
Table 'QOeVnLhwctF9UyV/beDi+A' 2-max Seat #2 is the button
Seat 1: bypIyrYcAAifLfhZpGlKLA ($66.50 in chips)
Seat 2: Ucrm3XtZmoONapW32SPhag ($14.70 in chips)
Ucrm3XtZmoONapW32SPhag: posts small blind $0.25
bypIyrYcAAifLfhZpGlKLA: posts big blind $0.50
*** HOLE CARDS ***
Ucrm3XtZmoONapW32SPhag: raises $0.50 to $1
bypIyrYcAAifLfhZpGlKLA: folds
Ucrm3XtZmoONapW32SPhag collected $1 from pot
Ucrm3XtZmoONapW32SPhag: doesn't show hand
*** SUMMARY ***
Total pot $1 | Rake $0
Seat 1: bypIyrYcAAifLfhZpGlKLA (big blind) folded before Flop
Seat 2: Ucrm3XtZmoONapW32SPhag (button) (small blind) collected ($1)



PokerStars Game #59939899250:  Hold'em No Limit ($0.25/$0.50) - 2009/07/01 0:51:53 ET
Table '8BQGgNetI1NOvWeu3gtMNw' 2-max Seat #2 is the button
Seat 1: bypIyrYcAAifLfhZpGlKLA ($50 in chips)
Seat 2: Z4HwehErEwzsv/noQlfUlg ($50 in chips)
Z4HwehErEwzsv/noQlfUlg: posts small blind $0.25
bypIyrYcAAifLfhZpGlKLA: posts big blind $0.50
*** HOLE CARDS ***
Z4HwehErEwzsv/noQlfUlg: raises $0.50 to $1
bypIyrYcAAifLfhZpGlKLA: raises $2.50 to $3.50
Z4HwehErEwzsv/noQlfUlg: calls $2.50
*** FLOP *** [Ah 8h 7d]
bypIyrYcAAifLfhZpGlKLA: bets $6
Z4HwehErEwzsv/noQlfUlg: raises $6 to $12
bypIyrYcAAifLfhZpGlKLA: calls $6
*** TURN *** [Ah 8h 7d] [5d]
bypIyrYcAAifLfhZpGlKLA: checks
Z4HwehErEwzsv/noQlfUlg: bets $34.50 and is all-in
bypIyrYcAAifLfhZpGlKLA: folds
Z4HwehErEwzsv/noQlfUlg collected $30.50 from pot
Z4HwehErEwzsv/noQlfUlg: doesn't show hand
*** SUMMARY ***
Total pot $31 | Rake $0.50
Board [Ah 8h 7d 5d]
Seat 1: bypIyrYcAAifLfhZpGlKLA (big blind) folded on the Turn
Seat 2: Z4HwehErEwzsv/noQlfUlg (button) (small blind) collected ($30.50)



PokerStars Game #59939900136:  Hold'em No Limit ($0.25/$0.50) - 2009/07/01 0:51:54 ET
Table '+dXkOAQyS8j9PQZusUTMpg' 2-max Seat #2 is the button
Seat 1: XFa6sBGjP2gxoIvxR3fZIg ($61.10 in chips)
Seat 2: 5IBeOgaApY1Bvzv2P8X4EA ($140.55 in chips)
5IBeOgaApY1Bvzv2P8X4EA: posts small blind $0.25
XFa6sBGjP2gxoIvxR3fZIg: posts big blind $0.50
*** HOLE CARDS ***
5IBeOgaApY1Bvzv2P8X4EA: folds
XFa6sBGjP2gxoIvxR3fZIg collected $0.50 from pot
XFa6sBGjP2gxoIvxR3fZIg: doesn't show hand
*** SUMMARY ***
Total pot $0.50 | Rake $0
Seat 1: XFa6sBGjP2gxoIvxR3fZIg (big blind) collected ($0.50)
Seat 2: 5IBeOgaApY1Bvzv2P8X4EA (button) (small blind) folded before Flop



PokerStars Game #59939900734:  Hold'em No Limit ($0.25/$0.50) - 2009/07/01 0:51:55 ET
Table 'NHLx+ggeIlZy3D6oDgC0yg' 2-max Seat #2 is the button
Seat 1: Fp/oksNpipCrD2MJ2pH20g ($10 in chips)
Seat 2: DHMk3is1XNc/OjPVB8NJ5w ($50 in chips)
DHMk3is1XNc/OjPVB8NJ5w: posts small blind $0.25
Fp/oksNpipCrD2MJ2pH20g: posts big blind $0.50
*** HOLE CARDS ***
DHMk3is1XNc/OjPVB8NJ5w: calls $0.25
Fp/oksNpipCrD2MJ2pH20g: checks
*** FLOP *** [5s Kh 2d]
Fp/oksNpipCrD2MJ2pH20g: bets $0.50
DHMk3is1XNc/OjPVB8NJ5w: calls $0.50
*** TURN *** [5s Kh 2d] [6s]
Fp/oksNpipCrD2MJ2pH20g: bets $1.50
DHMk3is1XNc/OjPVB8NJ5w: calls $1.50
*** RIVER *** [5s Kh 2d 6s] [As]
Fp/oksNpipCrD2MJ2pH20g: bets $7.50 and is all-in
DHMk3is1XNc/OjPVB8NJ5w: folds
Fp/oksNpipCrD2MJ2pH20g collected $4.80 from pot
Fp/oksNpipCrD2MJ2pH20g: doesn't show hand
*** SUMMARY ***
Total pot $5 | Rake $0.20
Board [5s Kh 2d 6s As]
Seat 1: Fp/oksNpipCrD2MJ2pH20g (big blind) collected ($4.80)
Seat 2: DHMk3is1XNc/OjPVB8NJ5w (button) (small blind) folded on the River



PokerStars Game #59939901498:  Hold'em No Limit ($0.25/$0.50) - 2009/07/01 0:51:56 ET
Table 'lSisgp6H7Fg1hH5VfjEjYQ' 9-max Seat #4 is the button
Seat 1: 5k9fvXD9suIgCxU4HLQjTw ($50.75 in chips)
Seat 2: UrcnkQOiLVk8BlKDPJSy7Q ($77.60 in chips)
Seat 3: aTkyjTh3w5YLWiIERupZOA ($51.20 in chips)
Seat 4: bwv/rbH/hHhPhY6u9mu04w ($34.10 in chips)
Seat 5: mSD1pginDsyHG5PDfqzphw ($13.10 in chips)
Seat 6: +k7T5ocke8UwavtgUHm+Cg ($27 in chips)
Seat 7: IDtNLR9uFCDdjNsJWMHA5Q ($18.10 in chips)
Seat 8: a4JDWmpFQkL10XfAyuF51A ($30.50 in chips)
Seat 9: gsyXT42WLEcOS4DdEk2wlw ($42.10 in chips)
mSD1pginDsyHG5PDfqzphw: posts small blind $0.25
+k7T5ocke8UwavtgUHm+Cg: posts big blind $0.50
IDtNLR9uFCDdjNsJWMHA5Q: posts big blind $0.50
*** HOLE CARDS ***
IDtNLR9uFCDdjNsJWMHA5Q: checks
a4JDWmpFQkL10XfAyuF51A: folds
gsyXT42WLEcOS4DdEk2wlw: folds
5k9fvXD9suIgCxU4HLQjTw: calls $0.50
UrcnkQOiLVk8BlKDPJSy7Q: folds
aTkyjTh3w5YLWiIERupZOA: folds
bwv/rbH/hHhPhY6u9mu04w: calls $0.50
mSD1pginDsyHG5PDfqzphw: calls $0.25
+k7T5ocke8UwavtgUHm+Cg: checks
*** FLOP *** [Qh 5h 7h]
mSD1pginDsyHG5PDfqzphw: checks
+k7T5ocke8UwavtgUHm+Cg: checks
IDtNLR9uFCDdjNsJWMHA5Q: checks
5k9fvXD9suIgCxU4HLQjTw: checks
bwv/rbH/hHhPhY6u9mu04w: checks
*** TURN *** [Qh 5h 7h] [Jd]
mSD1pginDsyHG5PDfqzphw: checks
+k7T5ocke8UwavtgUHm+Cg: bets $2
IDtNLR9uFCDdjNsJWMHA5Q: calls $2
5k9fvXD9suIgCxU4HLQjTw: raises $5.50 to $7.50
bwv/rbH/hHhPhY6u9mu04w: folds
mSD1pginDsyHG5PDfqzphw: folds
+k7T5ocke8UwavtgUHm+Cg: calls $5.50
IDtNLR9uFCDdjNsJWMHA5Q: folds
*** RIVER *** [Qh 5h 7h Jd] [4d]
+k7T5ocke8UwavtgUHm+Cg: checks
5k9fvXD9suIgCxU4HLQjTw: bets $8.50
+k7T5ocke8UwavtgUHm+Cg: raises $8.50 to $17
5k9fvXD9suIgCxU4HLQjTw: calls $8.50
*** SHOW DOWN ***
+k7T5ocke8UwavtgUHm+Cg: shows [3h 6h] (a flush, Queen high)
5k9fvXD9suIgCxU4HLQjTw: mucks hand
+k7T5ocke8UwavtgUHm+Cg collected $50.90 from pot
*** SUMMARY ***
Total pot $53.50 | Rake $2.60
Board [Qh 5h 7h Jd 4d]
Seat 1: 5k9fvXD9suIgCxU4HLQjTw mucked
Seat 2: UrcnkQOiLVk8BlKDPJSy7Q folded before Flop (didn't bet)
Seat 3: aTkyjTh3w5YLWiIERupZOA folded before Flop (didn't bet)
Seat 4: bwv/rbH/hHhPhY6u9mu04w (button) folded on the Turn
Seat 5: mSD1pginDsyHG5PDfqzphw (small blind) folded on the Turn
Seat 6: +k7T5ocke8UwavtgUHm+Cg (big blind) showed [3h 6h] and won ($50.90) with a flush, Queen high
Seat 7: IDtNLR9uFCDdjNsJWMHA5Q folded on the Turn
Seat 8: a4JDWmpFQkL10XfAyuF51A folded before Flop (didn't bet)
Seat 9: gsyXT42WLEcOS4DdEk2wlw folded before Flop (didn't bet)



PokerStars Game #59939902492:  Hold'em No Limit ($0.25/$0.50) - 2009/07/01 0:51:58 ET
Table '0eJtgVAXVvBgncFdcUpXcQ' 2-max Seat #2 is the button
Seat 1: Ag6DvxX4vbRheqsv2zXKTQ ($38.05 in chips)
Seat 2: KMc4R+K9ao4Ur3rF7NGe6Q ($13.95 in chips)
KMc4R+K9ao4Ur3rF7NGe6Q: posts small blind $0.25
Ag6DvxX4vbRheqsv2zXKTQ: posts big blind $0.50
*** HOLE CARDS ***
KMc4R+K9ao4Ur3rF7NGe6Q: calls $0.25
Ag6DvxX4vbRheqsv2zXKTQ: checks
*** FLOP *** [7d 6h 4s]
Ag6DvxX4vbRheqsv2zXKTQ said, "sick flop lol"
Ag6DvxX4vbRheqsv2zXKTQ: checks
KMc4R+K9ao4Ur3rF7NGe6Q: checks
*** TURN *** [7d 6h 4s] [8d]
Ag6DvxX4vbRheqsv2zXKTQ: checks
KMc4R+K9ao4Ur3rF7NGe6Q said, "yeh"
KMc4R+K9ao4Ur3rF7NGe6Q: checks
*** RIVER *** [7d 6h 4s 8d] [4d]
Ag6DvxX4vbRheqsv2zXKTQ: checks
KMc4R+K9ao4Ur3rF7NGe6Q: checks
*** SHOW DOWN ***
Ag6DvxX4vbRheqsv2zXKTQ: shows [3s Jh] (a pair of Fours)
KMc4R+K9ao4Ur3rF7NGe6Q: mucks hand
Ag6DvxX4vbRheqsv2zXKTQ collected $0.95 from pot
*** SUMMARY ***
Total pot $1 | Rake $0.05
Board [7d 6h 4s 8d 4d]
Seat 1: Ag6DvxX4vbRheqsv2zXKTQ (big blind) showed [3s Jh] and won ($0.95) with a pair of Fours
Seat 2: KMc4R+K9ao4Ur3rF7NGe6Q (button) (small blind) mucked



PokerStars Game #59939902810:  Hold'em No Limit ($0.25/$0.50) - 2009/07/01 0:51:59 ET
Table 'E7bWJ45aoFXRpyRv2gw+Ig' 2-max Seat #2 is the button
Seat 1: FRkiRasEGlHUeLrEl+k/nA ($107.50 in chips)
Seat 2: 3Wro85I7472vJ4Wkpneo9A ($85.50 in chips)
3Wro85I7472vJ4Wkpneo9A: posts small blind $0.25
FRkiRasEGlHUeLrEl+k/nA: posts big blind $0.50
*** HOLE CARDS ***
3Wro85I7472vJ4Wkpneo9A: raises $1 to $1.50
FRkiRasEGlHUeLrEl+k/nA: calls $1
*** FLOP *** [Ad Jc Js]
FRkiRasEGlHUeLrEl+k/nA: checks
3Wro85I7472vJ4Wkpneo9A: checks
*** TURN *** [Ad Jc Js] [Qd]
FRkiRasEGlHUeLrEl+k/nA: checks
3Wro85I7472vJ4Wkpneo9A: bets $2
FRkiRasEGlHUeLrEl+k/nA: folds
3Wro85I7472vJ4Wkpneo9A collected $2.85 from pot
3Wro85I7472vJ4Wkpneo9A: doesn't show hand
*** SUMMARY ***
Total pot $3 | Rake $0.15
Board [Ad Jc Js Qd]
Seat 1: FRkiRasEGlHUeLrEl+k/nA (big blind) folded on the Turn
Seat 2: 3Wro85I7472vJ4Wkpneo9A (button) (small blind) collected ($2.85)



PokerStars Game #59939904900:  Hold'em No Limit ($0.25/$0.50) - 2009/07/01 0:52:02 ET
Table '+dXkOAQyS8j9PQZusUTMpg' 2-max Seat #1 is the button
Seat 1: XFa6sBGjP2gxoIvxR3fZIg ($61.35 in chips)
Seat 2: 5IBeOgaApY1Bvzv2P8X4EA ($140.30 in chips)
XFa6sBGjP2gxoIvxR3fZIg: posts small blind $0.25
5IBeOgaApY1Bvzv2P8X4EA: posts big blind $0.50
*** HOLE CARDS ***
XFa6sBGjP2gxoIvxR3fZIg: raises $1 to $1.50
5IBeOgaApY1Bvzv2P8X4EA: folds
XFa6sBGjP2gxoIvxR3fZIg collected $1 from pot
*** SUMMARY ***
Total pot $1 | Rake $0
Seat 1: XFa6sBGjP2gxoIvxR3fZIg (button) (small blind) collected ($1)
Seat 2: 5IBeOgaApY1Bvzv2P8X4EA (big blind) folded before Flop



PokerStars Game #59939905900:  Hold'em No Limit ($0.25/$0.50) - 2009/07/01 0:52:04 ET
Table '99gCy/CZQwPIjZWH+BguQgE7bWJ45aoFXRpyRv2gw+Igeat #9 is the button
Seat 2: n6VQBu6crjYjy6DxNP1NZA ($29 in chips)
Seat 3: qEn9ijNGtuyTxamBf07hYg ($50 in chips)
Seat 4: bxLSulbgr8LmKNjOzw8URg ($61.45 in chips)
Seat 5: DSM67hHHq1XFoEOi9p8Alw ($46 in chips)
Seat 7: bfSq6LBw0UvxeM5yfuWC7w ($16.35 in chips)
Seat 8: 8ehL7qlZzjgUh2H35iiWLw ($56 in chips)
Seat 9: j3K/Jujr7PY4ZM2RZvlH6A ($92.65 in chips)
n6VQBu6crjYjy6DxNP1NZA: posts small blind $0.25
qEn9ijNGtuyTxamBf07hYg: posts big blind $0.50
*** HOLE CARDS ***
bxLSulbgr8LmKNjOzw8URg: folds
DSM67hHHq1XFoEOi9p8Alw: folds
bfSq6LBw0UvxeM5yfuWC7w: raises $0.85 to $1.35
8ehL7qlZzjgUh2H35iiWLw: folds
j3K/Jujr7PY4ZM2RZvlH6A: folds
n6VQBu6crjYjy6DxNP1NZA: folds
qEn9ijNGtuyTxamBf07hYg: folds
bfSq6LBw0UvxeM5yfuWC7w collected $1.25 from pot
*** SUMMARY ***
Total pot $1.25 | Rake $0
Seat 2: n6VQBu6crjYjy6DxNP1NZA (small blind) folded before Flop
Seat 3: qEn9ijNGtuyTxamBf07hYg (big blind) folded before Flop
Seat 4: bxLSulbgr8LmKNjOzw8URg folded before Flop (didn't bet)
Seat 5: DSM67hHHq1XFoEOi9p8Alw folded before Flop (didn't bet)
Seat 7: bfSq6LBw0UvxeM5yfuWC7w collected ($1.25)
Seat 8: 8ehL7qlZzjgUh2H35iiWLw folded before Flop (didn't bet)
Seat 9: j3K/Jujr7PY4ZM2RZvlH6A (button) folded before Flop (didn't bet)



PokerStars Game #59939907136:  Hold'em No Limit ($0.25/$0.50) - 2009/07/01 0:52:05 ET
Table 'GfL/No5u5PoEnU39lP5pQg' 6-max Seat #3 is the button
Seat 1: 1WUCqNG+p+vfWRTXNu4ljw ($60 in chips)
Seat 2: uVwggSetzp7d+eVgowO3vg ($64.45 in chips)
Seat 3: Ek4w9XqBXqK5jBUQeLedGw ($51.25 in chips)
Seat 4: r6u7MWSXF30/khcTYkrG9Q ($24.90 in chips)
Seat 5: M1KyQQvVPVuxqTAB8sR/zQ ($52.25 in chips)
Seat 6: kxPhs4ePFqMy52CInAJ2aw ($50.75 in chips)
r6u7MWSXF30/khcTYkrG9Q: posts small blind $0.25
M1KyQQvVPVuxqTAB8sR/zQ: posts big blind $0.50
*** HOLE CARDS ***
kxPhs4ePFqMy52CInAJ2aw: folds
1WUCqNG+p+vfWRTXNu4ljw: folds
uVwggSetzp7d+eVgowO3vg: raises $1.50 to $2
Ek4w9XqBXqK5jBUQeLedGw: folds
r6u7MWSXF30/khcTYkrG9Q: folds
M1KyQQvVPVuxqTAB8sR/zQ: folds
uVwggSetzp7d+eVgowO3vg collected $1.25 from pot
*** SUMMARY ***
Total pot $1.25 | Rake $0
Seat 1: 1WUCqNG+p+vfWRTXNu4ljw folded before Flop (didn't bet)
Seat 2: uVwggSetzp7d+eVgowO3vg collected ($1.25)
Seat 3: Ek4w9XqBXqK5jBUQeLedGw (button) folded before Flop (didn't bet)
Seat 4: r6u7MWSXF30/khcTYkrG9Q (small blind) folded before Flop
Seat 5: M1KyQQvVPVuxqTAB8sR/zQ (big blind) folded before Flop
Seat 6: kxPhs4ePFqMy52CInAJ2aw folded before Flop (didn't bet)



PokerStars Game #59939907560:  Hold'em No Limit ($0.25/$0.50) - 2009/07/01 0:52:06 ET
Table '+z1aekfHkpp09pc8F9aViw' 6-max Seat #1 is the button
Seat 1: FHilMb2i2DbUCc9lplszog ($44.25 in chips)
Seat 2: M6xK/VklCvdyyrmvzATlxQ ($34.75 in chips)
Seat 3: uUznlIMFnRUvwrBhYF73KA ($118.45 in chips)
Seat 4: RowCSpSURHTOL/dcjg/Iug ($43.05 in chips)
Seat 5: rplyldNweS6YyMNEALQrug ($10 in chips)
Seat 6: 686aeHikcJlgKkSuIFdcXQ ($53.25 in chips)
M6xK/VklCvdyyrmvzATlxQ: posts small blind $0.25
uUznlIMFnRUvwrBhYF73KA: posts big blind $0.50
rplyldNweS6YyMNEALQrug: posts big blind $0.50
*** HOLE CARDS ***
RowCSpSURHTOL/dcjg/Iug: folds
rplyldNweS6YyMNEALQrug: raises $2 to $2.50
686aeHikcJlgKkSuIFdcXQ: calls $2.50
FHilMb2i2DbUCc9lplszog: folds
M6xK/VklCvdyyrmvzATlxQ: folds
uUznlIMFnRUvwrBhYF73KA: folds
*** FLOP *** [Qh 4s 9s]
rplyldNweS6YyMNEALQrug: bets $3
686aeHikcJlgKkSuIFdcXQ: folds
rplyldNweS6YyMNEALQrug collected $5.50 from pot
rplyldNweS6YyMNEALQrug: doesn't show hand
*** SUMMARY ***
Total pot $5.75 | Rake $0.25
Board [Qh 4s 9s]
Seat 1: FHilMb2i2DbUCc9lplszog (button) folded before Flop (didn't bet)
Seat 2: M6xK/VklCvdyyrmvzATlxQ (small blind) folded before Flop
Seat 3: uUznlIMFnRUvwrBhYF73KA (big blind) folded before Flop
Seat 4: RowCSpSURHTOL/dcjg/Iug folded before Flop (didn't bet)
Seat 5: rplyldNweS6YyMNEALQrug collected ($5.50)
Seat 6: 686aeHikcJlgKkSuIFdcXQ folded on the Flop



PokerStars Game #59939907606:  Hold'em No Limit ($0.25/$0.50) - 2009/07/01 0:52:06 ET
Table 'X6IRCRTh+20gjz8aubWnwA' 9-max Seat #8 is the button
Seat 1: DSM67hHHq1XFoEOi9p8Alw ($50.05 in chips)
Seat 2: HZkVla4kK2SI42CVrPZ/ig ($8.55 in chips)
Seat 3: SWv01peOe69QQRvhQTqjQw ($13.40 in chips)
Seat 4: 2J+UVOVrW+V3maOylyxMcQ ($43.55 in chips)
Seat 5: NnQCepdIR/AOUQn1yhYx6Q ($10 in chips)
Seat 7: cFHQjKQOOKTUzoilhrXHLg ($52.25 in chips)
Seat 8: HxeBVq06/3Bh/H986sgdbw ($10.15 in chips)
Seat 9: M+7+BTmX5vZatHVuoRB1nA ($47 in chips)
M+7+BTmX5vZatHVuoRB1nA: posts small blind $0.25
DSM67hHHq1XFoEOi9p8Alw: posts big blind $0.50
75K2MXwN65Sjfp1yHd50Hg: sits out
*** HOLE CARDS ***
HZkVla4kK2SI42CVrPZ/ig: folds
SWv01peOe69QQRvhQTqjQw: calls $0.50
2J+UVOVrW+V3maOylyxMcQ: folds
NnQCepdIR/AOUQn1yhYx6Q: folds
cFHQjKQOOKTUzoilhrXHLg: folds
HxeBVq06/3Bh/H986sgdbw: raises $1 to $1.50
M+7+BTmX5vZatHVuoRB1nA: folds
DSM67hHHq1XFoEOi9p8Alw: folds
SWv01peOe69QQRvhQTqjQw: calls $1
*** FLOP *** [9c As Ah]
SWv01peOe69QQRvhQTqjQw: checks
HxeBVq06/3Bh/H986sgdbw: checks
*** TURN *** [9c As Ah] [2s]
SWv01peOe69QQRvhQTqjQw: bets $1.50
HxeBVq06/3Bh/H986sgdbw: calls $1.50
*** RIVER *** [9c As Ah 2s] [5h]
SWv01peOe69QQRvhQTqjQw: bets $1.50
HxeBVq06/3Bh/H986sgdbw: raises $4 to $5.50
SWv01peOe69QQRvhQTqjQw: calls $4
*** SHOW DOWN ***
HxeBVq06/3Bh/H986sgdbw: shows [Ts Ac] (three of a kind, Aces)
SWv01peOe69QQRvhQTqjQw: mucks hand
HxeBVq06/3Bh/H986sgdbw collected $16.90 from pot
*** SUMMARY ***
Total pot $17.75 | Rake $0.85
Board [9c As Ah 2s 5h]
Seat 1: DSM67hHHq1XFoEOi9p8Alw (big blind) folded before Flop
Seat 2: HZkVla4kK2SI42CVrPZ/ig folded before Flop (didn't bet)
Seat 3: SWv01peOe69QQRvhQTqjQw mucked
Seat 4: 2J+UVOVrW+V3maOylyxMcQ folded before Flop (didn't bet)
Seat 5: NnQCepdIR/AOUQn1yhYx6Q folded before Flop (didn't bet)
Seat 7: cFHQjKQOOKTUzoilhrXHLg folded before Flop (didn't bet)
Seat 8: HxeBVq06/3Bh/H986sgdbw (button) showed [Ts Ac] and won ($16.90) with three of a kind, Aces
Seat 9: M+7+BTmX5vZatHVuoRB1nA (small blind) folded before Flop



PokerStars Game #59939907220:  Hold'em No Limit ($0.25/$0.50) - 2009/07/01 0:52:06 ET
Table 'Nz0Vr7WMHL2g5Uk7dDZjpw' 9-max Seat #5 is the button
Seat 1: tLkxo7JgV+WWI0UBw44K5A ($109.85 in chips)
Seat 2: XNMDwbXt/Q4jM99AXnbJDw ($67.35 in chips)
Seat 3: uw9QayAAxLM3Hb+HR7mSkg ($11.50 in chips)
Seat 4: 75K2MXwN65Sjfp1yHd50Hg ($9.25 in chips)
Seat 5: WGW0DgjBUXs1ylURHG8vnQ ($27.50 in chips)
Seat 6: 997ViqAtWn1FPjJqcffwcA ($50 in chips)
Seat 7: KPLH0gELgFe2OuAnhJFI5w ($19.40 in chips)
Seat 8: HkZI6g4zl83TDTA7SRspmQ ($17.60 in chips)
Seat 9: mSD1pginDsyHG5PDfqzphw ($10 in chips)
997ViqAtWn1FPjJqcffwcA: posts small blind $0.25
KPLH0gELgFe2OuAnhJFI5w: posts big blind $0.50
*** HOLE CARDS ***
HkZI6g4zl83TDTA7SRspmQ: calls $0.50
mSD1pginDsyHG5PDfqzphw: folds
tLkxo7JgV+WWI0UBw44K5A: folds
XNMDwbXt/Q4jM99AXnbJDw: folds
uw9QayAAxLM3Hb+HR7mSkg: raises $11 to $11.50 and is all-in
75K2MXwN65Sjfp1yHd50Hg: folds
WGW0DgjBUXs1ylURHG8vnQ: folds
997ViqAtWn1FPjJqcffwcA: raises $11 to $22.50
KPLH0gELgFe2OuAnhJFI5w: folds
HkZI6g4zl83TDTA7SRspmQ: folds
*** FLOP *** [9h 2c 5c]
*** TURN *** [9h 2c 5c] [Jh]
*** RIVER *** [9h 2c 5c Jh] [7h]
*** SHOW DOWN ***
997ViqAtWn1FPjJqcffwcA: shows [Qd Qc] (a pair of Queens)
uw9QayAAxLM3Hb+HR7mSkg: mucks hand
997ViqAtWn1FPjJqcffwcA collected $22.80 from pot
*** SUMMARY ***
Total pot $24 | Rake $1.20
Board [9h 2c 5c Jh 7h]
Seat 1: tLkxo7JgV+WWI0UBw44K5A folded before Flop (didn't bet)
Seat 2: XNMDwbXt/Q4jM99AXnbJDw folded before Flop (didn't bet)
Seat 3: uw9QayAAxLM3Hb+HR7mSkg mucked
Seat 4: 75K2MXwN65Sjfp1yHd50Hg folded before Flop (didn't bet)
Seat 5: WGW0DgjBUXs1ylURHG8vnQ (button) folded before Flop (didn't bet)
Seat 6: 997ViqAtWn1FPjJqcffwcA (small blind) showed [Qd Qc] and won ($22.80) with a pair of Queens
Seat 7: KPLH0gELgFe2OuAnhJFI5w (big blind) folded before Flop
Seat 8: HkZI6g4zl83TDTA7SRspmQ folded before Flop
Seat 9: mSD1pginDsyHG5PDfqzphw folded before Flop (didn't bet)



PokerStars Game #59939908644:  Hold'em No Limit ($0.25/$0.50) - 2009/07/01 0:52:08 ET
Table '5EmHi+fnatGQQShcNmzOZQ' 6-max Seat #6 is the button
Seat 1: HGzUMAFxR1k8+S4gfnB39w ($31.15 in chips)
Seat 3: TjmTe3bhs9dFz5gXX9x7Lw ($27.25 in chips)
Seat 4: 1b+2BbjMN8qhR1WPqdE9VQ ($63.25 in chips)
Seat 5: kxPhs4ePFqMy52CInAJ2aw ($49.75 in chips)
Seat 6: 686aeHikcJlgKkSuIFdcXQ ($135.20 in chips)
HGzUMAFxR1k8+S4gfnB39w: posts small blind $0.25
TjmTe3bhs9dFz5gXX9x7Lw: posts big blind $0.50
*** HOLE CARDS ***
1b+2BbjMN8qhR1WPqdE9VQ: folds
kxPhs4ePFqMy52CInAJ2aw: folds
686aeHikcJlgKkSuIFdcXQ: raises $1 to $1.50
HGzUMAFxR1k8+S4gfnB39w: calls $1.25
TjmTe3bhs9dFz5gXX9x7Lw: folds
*** FLOP *** [Jc 8h 9d]
HGzUMAFxR1k8+S4gfnB39w: checks
686aeHikcJlgKkSuIFdcXQ: checks
*** TURN *** [Jc 8h 9d] [Jh]
HGzUMAFxR1k8+S4gfnB39w: bets $1
686aeHikcJlgKkSuIFdcXQ: calls $1
*** RIVER *** [Jc 8h 9d Jh] [Ks]
HGzUMAFxR1k8+S4gfnB39w: bets $3
686aeHikcJlgKkSuIFdcXQ: folds
HGzUMAFxR1k8+S4gfnB39w collected $5.25 from pot
*** SUMMARY ***
Total pot $5.50 | Rake $0.25
Board [Jc 8h 9d Jh Ks]
Seat 1: HGzUMAFxR1k8+S4gfnB39w (small blind) collected ($5.25)
Seat 3: TjmTe3bhs9dFz5gXX9x7Lw (big blind) folded before Flop
Seat 4: 1b+2BbjMN8qhR1WPqdE9VQ folded before Flop (didn't bet)
Seat 5: kxPhs4ePFqMy52CInAJ2aw folded before Flop (didn't bet)
Seat 6: 686aeHikcJlgKkSuIFdcXQ (button) folded on the River



PokerStars Game #59939909310:  Hold'em No Limit ($0.25/$0.50) - 2009/07/01 0:52:09 ET
Table 'QOgaEqMcJ73pcUMMxoisUg' 6-max Seat #4 is the button
Seat 1: /olYG0EzMWzADIgH1y2ySQ ($26.20 in chips)
Seat 2: 4QfsCWthT/vSLirorNXqtg ($50.75 in chips)
Seat 3: Rt6KgtZ8YaJoTc3FPim00w ($94.80 in chips)
Seat 4: zAcsDhG/T128Vn7XGVSgKg ($50.10 in chips)
Seat 5: 6vNxrjjCl6FwfaaymM9jjg ($33.05 in chips)
Seat 6: GoVjFxr3C+JO9vtJH9+IcA ($20 in chips)
6vNxrjjCl6FwfaaymM9jjg: posts small blind $0.25
GoVjFxr3C+JO9vtJH9+IcA: posts big blind $0.50
*** HOLE CARDS ***
/olYG0EzMWzADIgH1y2ySQ: calls $0.50
4QfsCWthT/vSLirorNXqtg: folds
Rt6KgtZ8YaJoTc3FPim00w: raises $1.50 to $2
zAcsDhG/T128Vn7XGVSgKg: folds
6vNxrjjCl6FwfaaymM9jjg: folds
GoVjFxr3C+JO9vtJH9+IcA: calls $1.50
/olYG0EzMWzADIgH1y2ySQ: folds
*** FLOP *** [4d 3d Ad]
GoVjFxr3C+JO9vtJH9+IcA: bets $1
Rt6KgtZ8YaJoTc3FPim00w: calls $1
*** TURN *** [4d 3d Ad] [2d]
GoVjFxr3C+JO9vtJH9+IcA: bets $3
Rt6KgtZ8YaJoTc3FPim00w: calls $3
*** RIVER *** [4d 3d Ad 2d] [6h]
GoVjFxr3C+JO9vtJH9+IcA: bets $6
Rt6KgtZ8YaJoTc3FPim00w: folds
GoVjFxr3C+JO9vtJH9+IcA collected $12.15 from pot
*** SUMMARY ***
Total pot $12.75 | Rake $0.60
Board [4d 3d Ad 2d 6h]
Seat 1: /olYG0EzMWzADIgH1y2ySQ folded before Flop
Seat 2: 4QfsCWthT/vSLirorNXqtg folded before Flop (didn't bet)
Seat 3: Rt6KgtZ8YaJoTc3FPim00w folded on the River
Seat 4: zAcsDhG/T128Vn7XGVSgKg (button) folded before Flop (didn't bet)
Seat 5: 6vNxrjjCl6FwfaaymM9jjg (small blind) folded before Flop
Seat 6: GoVjFxr3C+JO9vtJH9+IcA (big blind) collected ($12.15)



PokerStars Game #59939909110:  Hold'em No Limit ($0.25/$0.50) - 2009/07/01 0:52:09 ET
Table '3FhG0gl3kMX3wBEEqj+wnQ' 9-max Seat #5 is the button
Seat 1: e0J9pdCNUDTCG031RnXqLA ($31.30 in chips)
Seat 2: 7cYQ+syUWjl38ty/ICOMhw ($45.40 in chips)
Seat 5: gsyXT42WLEcOS4DdEk2wlw ($33.20 in chips)
Seat 6: 997ViqAtWn1FPjJqcffwcA ($50 in chips)
Seat 7: mSD1pginDsyHG5PDfqzphw ($10.25 in chips)
Seat 8: j3K/Jujr7PY4ZM2RZvlH6A ($60.95 in chips)
Seat 9: L5e2lrPLQm1Pqx30IIZ/Fw ($10.50 in chips)
997ViqAtWn1FPjJqcffwcA: posts small blind $0.25
mSD1pginDsyHG5PDfqzphw: posts big blind $0.50
Min9: sits out
*** HOLE CARDS ***
j3K/Jujr7PY4ZM2RZvlH6A: folds
bjvJtA9Hqscfznq66txaOQ leaves the table
L5e2lrPLQm1Pqx30IIZ/Fw: raises $1.50 to $2
e0J9pdCNUDTCG031RnXqLA: folds
7cYQ+syUWjl38ty/ICOMhw: folds
gsyXT42WLEcOS4DdEk2wlw: folds
997ViqAtWn1FPjJqcffwcA: folds
KingDonation joins the table at seat #4
mSD1pginDsyHG5PDfqzphw: calls $1.50
*** FLOP *** [3c 3h 6c]
mSD1pginDsyHG5PDfqzphw: checks
L5e2lrPLQm1Pqx30IIZ/Fw: checks
*** TURN *** [3c 3h 6c] [3s]
mSD1pginDsyHG5PDfqzphw: bets $1.50
L5e2lrPLQm1Pqx30IIZ/Fw: raises $7 to $8.50 and is all-in
mSD1pginDsyHG5PDfqzphw: folds
L5e2lrPLQm1Pqx30IIZ/Fw collected $6.90 from pot
*** SUMMARY ***
Total pot $7.25 | Rake $0.35
Board [3c 3h 6c 3s]
Seat 1: e0J9pdCNUDTCG031RnXqLA folded before Flop (didn't bet)
Seat 2: 7cYQ+syUWjl38ty/ICOMhw folded before Flop (didn't bet)
Seat 5: gsyXT42WLEcOS4DdEk2wlw (button) folded before Flop (didn't bet)
Seat 6: 997ViqAtWn1FPjJqcffwcA (small blind) folded before Flop
Seat 7: mSD1pginDsyHG5PDfqzphw (big blind) folded on the Turn
Seat 8: j3K/Jujr7PY4ZM2RZvlH6A folded before Flop (didn't bet)
Seat 9: L5e2lrPLQm1Pqx30IIZ/Fw collected ($6.90)



PokerStars Game #59939909846:  Hold'em No Limit ($0.25/$0.50) - 2009/07/01 0:52:10 ET
Table '+dXkOAQyS8j9PQZusUTMpg' 2-max Seat #2 is the button
Seat 1: XFa6sBGjP2gxoIvxR3fZIg ($61.85 in chips)
Seat 2: 5IBeOgaApY1Bvzv2P8X4EA ($139.80 in chips)
5IBeOgaApY1Bvzv2P8X4EA: posts small blind $0.25
XFa6sBGjP2gxoIvxR3fZIg: posts big blind $0.50
*** HOLE CARDS ***
5IBeOgaApY1Bvzv2P8X4EA: calls $0.25
XFa6sBGjP2gxoIvxR3fZIg: checks
*** FLOP *** [Tc 2c 8c]
XFa6sBGjP2gxoIvxR3fZIg: checks
5IBeOgaApY1Bvzv2P8X4EA: checks
*** TURN *** [Tc 2c 8c] [Qc]
XFa6sBGjP2gxoIvxR3fZIg: checks
5IBeOgaApY1Bvzv2P8X4EA: checks
*** RIVER *** [Tc 2c 8c Qc] [7d]
XFa6sBGjP2gxoIvxR3fZIg: checks
5IBeOgaApY1Bvzv2P8X4EA: checks
*** SHOW DOWN ***
XFa6sBGjP2gxoIvxR3fZIg: shows [5h Ad] (high card Ace)
5IBeOgaApY1Bvzv2P8X4EA: shows [9s As] (high card Ace - Queen+Ten+Nine kicker)
5IBeOgaApY1Bvzv2P8X4EA collected $0.95 from pot
*** SUMMARY ***
Total pot $1 | Rake $0.05
Board [Tc 2c 8c Qc 7d]
Seat 1: XFa6sBGjP2gxoIvxR3fZIg (big blind) showed [5h Ad] and lost with high card Ace
Seat 2: 5IBeOgaApY1Bvzv2P8X4EA (button) (small blind) showed [9s As] and won ($0.95) with high card Ace



PokerStars Game #59939911402:  Hold'em No Limit ($0.25/$0.50) - 2009/07/01 0:52:12 ET
Table 'EiNh8p/wGJ1FP575iMFnqg' 9-max Seat #7 is the button
Seat 1: r3ZqM1Mi0W3y4hOdssE+Sg ($45.85 in chips)
Seat 2: 8ehL7qlZzjgUh2H35iiWLw ($52.60 in chips)
Seat 3: ymLPoEIl7UL3TvZYmnadxQ ($50.85 in chips)
Seat 4: cMzaiXAM/ZAdNaEUu+LqhA ($55.70 in chips)
Seat 5: M+7+BTmX5vZatHVuoRB1nA ($82.20 in chips)
Seat 6: 3UmXLy3GfjC3EkOebduerQ ($65.35 in chips)
Seat 7: 997ViqAtWn1FPjJqcffwcA ($50 in chips)
Seat 8: mSD1pginDsyHG5PDfqzphw ($10 in chips)
Seat 9: NnQCepdIR/AOUQn1yhYx6Q ($9.25 in chips)
mSD1pginDsyHG5PDfqzphw: posts small blind $0.25
NnQCepdIR/AOUQn1yhYx6Q: posts big blind $0.50
*** HOLE CARDS ***
r3ZqM1Mi0W3y4hOdssE+Sg: folds
8ehL7qlZzjgUh2H35iiWLw: folds
ymLPoEIl7UL3TvZYmnadxQ: folds
cMzaiXAM/ZAdNaEUu+LqhA: folds
M+7+BTmX5vZatHVuoRB1nA: folds
3UmXLy3GfjC3EkOebduerQ: folds
997ViqAtWn1FPjJqcffwcA: folds
mSD1pginDsyHG5PDfqzphw: folds
NnQCepdIR/AOUQn1yhYx6Q collected $0.50 from pot
*** SUMMARY ***
Total pot $0.50 | Rake $0
Seat 1: r3ZqM1Mi0W3y4hOdssE+Sg folded before Flop (didn't bet)
Seat 2: 8ehL7qlZzjgUh2H35iiWLw folded before Flop (didn't bet)
Seat 3: ymLPoEIl7UL3TvZYmnadxQ folded before Flop (didn't bet)
Seat 4: cMzaiXAM/ZAdNaEUu+LqhA folded before Flop (didn't bet)
Seat 5: M+7+BTmX5vZatHVuoRB1nA folded before Flop (didn't bet)
Seat 6: 3UmXLy3GfjC3EkOebduerQ folded before Flop (didn't bet)
Seat 7: 997ViqAtWn1FPjJqcffwcA (button) folded before Flop (didn't bet)
Seat 8: mSD1pginDsyHG5PDfqzphw (small blind) folded before Flop
Seat 9: NnQCepdIR/AOUQn1yhYx6Q (big blind) collected ($0.50)



PokerStars Game #59939911462:  Hold'em No Limit ($0.25/$0.50) - 2009/07/01 0:52:13 ET
Table 'lpxYasB1ClBSgTpCCITwhQ' 9-max Seat #6 is the button
Seat 1: mj7PS7wCH4PAl7+eYTFs7A ($47.15 in chips)
Seat 2: OWP/DOu+PlPK6ZZ3zYa0HA ($24.85 in chips)
Seat 3: cDNz32Scry3j+v2+kE3pHg ($50 in chips)
Seat 5: IYd5zG8k7vdBNVHbHg2Pag ($38.10 in chips)
Seat 6: SegjDnMxWMujiD57ESNL+g ($6.25 in chips)
Seat 7: bmRtaIYKthN1F+B3JLZ3Jw ($20.20 in chips)
Seat 8: V+ivdLiYYuNr+thEXNextg ($33.50 in chips)
Seat 9: XNMDwbXt/Q4jM99AXnbJDw ($50 in chips)
bmRtaIYKthN1F+B3JLZ3Jw: posts small blind $0.25
V+ivdLiYYuNr+thEXNextg: posts big blind $0.50
NnQCepdIR/AOUQn1yhYx6Q: sits out
*** HOLE CARDS ***
XNMDwbXt/Q4jM99AXnbJDw: folds
mj7PS7wCH4PAl7+eYTFs7A: folds
OWP/DOu+PlPK6ZZ3zYa0HA: folds
cDNz32Scry3j+v2+kE3pHg: folds
IYd5zG8k7vdBNVHbHg2Pag: folds
SegjDnMxWMujiD57ESNL+g: folds
bmRtaIYKthN1F+B3JLZ3Jw: raises $0.50 to $1
V+ivdLiYYuNr+thEXNextg: raises $1 to $2
bmRtaIYKthN1F+B3JLZ3Jw: calls $1
*** FLOP *** [4h Tc As]
bmRtaIYKthN1F+B3JLZ3Jw: checks
V+ivdLiYYuNr+thEXNextg: bets $2
bmRtaIYKthN1F+B3JLZ3Jw: calls $2
*** TURN *** [4h Tc As] [7s]
bmRtaIYKthN1F+B3JLZ3Jw: checks
V+ivdLiYYuNr+thEXNextg: checks
*** RIVER *** [4h Tc As 7s] [3s]
bmRtaIYKthN1F+B3JLZ3Jw: bets $4.50
V+ivdLiYYuNr+thEXNextg: calls $4.50
*** SHOW DOWN ***
bmRtaIYKthN1F+B3JLZ3Jw: shows [Js Qs] (a flush, Ace high)
V+ivdLiYYuNr+thEXNextg: mucks hand
bmRtaIYKthN1F+B3JLZ3Jw collected $16.20 from pot
*** SUMMARY ***
Total pot $17 | Rake $0.80
Board [4h Tc As 7s 3s]
Seat 1: mj7PS7wCH4PAl7+eYTFs7A folded before Flop (didn't bet)
Seat 2: OWP/DOu+PlPK6ZZ3zYa0HA folded before Flop (didn't bet)
Seat 3: cDNz32Scry3j+v2+kE3pHg folded before Flop (didn't bet)
Seat 5: IYd5zG8k7vdBNVHbHg2Pag folded before Flop (didn't bet)
Seat 6: SegjDnMxWMujiD57ESNL+g (button) folded before Flop (didn't bet)
Seat 7: bmRtaIYKthN1F+B3JLZ3Jw (small blind) showed [Js Qs] and won ($16.20) with a flush, Ace high
Seat 8: V+ivdLiYYuNr+thEXNextg (big blind) mucked
Seat 9: XNMDwbXt/Q4jM99AXnbJDw folded before Flop (didn't bet)



PokerStars Game #59939912486:  Hold'em No Limit ($0.25/$0.50) - 2009/07/01 0:52:14 ET
Table 'c/CRn+68J3Y8KxD5g1ek2Q' 2-max Seat #1 is the button
Seat 1: 46qCyJ6evTkHo9al5sBMNA ($88.60 in chips)
Seat 2: BypVLsYQt3ePFm2xQL/dOA ($283.10 in chips)
46qCyJ6evTkHo9al5sBMNA: posts small blind $0.25
BypVLsYQt3ePFm2xQL/dOA: posts big blind $0.50
*** HOLE CARDS ***
46qCyJ6evTkHo9al5sBMNA: raises $1.50 to $2
BypVLsYQt3ePFm2xQL/dOA: calls $1.50
*** FLOP *** [Ts 9d Qd]
BypVLsYQt3ePFm2xQL/dOA: checks
46qCyJ6evTkHo9al5sBMNA: bets $2.50
BypVLsYQt3ePFm2xQL/dOA: calls $2.50
*** TURN *** [Ts 9d Qd] [Jd]
BypVLsYQt3ePFm2xQL/dOA: bets $4.50
46qCyJ6evTkHo9al5sBMNA: folds
BypVLsYQt3ePFm2xQL/dOA collected $8.60 from pot
BypVLsYQt3ePFm2xQL/dOA: doesn't show hand
*** SUMMARY ***
Total pot $9 | Rake $0.40
Board [Ts 9d Qd Jd]
Seat 1: 46qCyJ6evTkHo9al5sBMNA (button) (small blind) folded on the Turn
Seat 2: BypVLsYQt3ePFm2xQL/dOA (big blind) collected ($8.60)



PokerStars Game #59939914480:  Hold'em No Limit ($0.25/$0.50) - 2009/07/01 0:52:17 ET
Table 'otvGDROEDdqsabxskT79qg' 9-max Seat #1 is the button
Seat 1: 8ehL7qlZzjgUh2H35iiWLw ($54.50 in chips)
Seat 2: cCjTzH9jio8607WzjcfXlg ($14.55 in chips)
Seat 3: +k7T5ocke8UwavtgUHm+Cg ($67.50 in chips)
Seat 4: MG90wfSJZnOejs/KD3vlQQ ($69.95 in chips)
Seat 5: XNMDwbXt/Q4jM99AXnbJDw ($52.55 in chips)
Seat 6: bxLSulbgr8LmKNjOzw8URg ($53.70 in chips)
Seat 7: C7+tBppJrKgd/r+tuKUIpA ($35.10 in chips)
Seat 8: zE9cVigS2nW/Ljy4K4bUQA ($30 in chips)
Seat 9: KcY3X8YpD74Kw1RHkx/g4A ($57.90 in chips)
cCjTzH9jio8607WzjcfXlg: posts small blind $0.25
+k7T5ocke8UwavtgUHm+Cg: posts big blind $0.50
*** HOLE CARDS ***
MG90wfSJZnOejs/KD3vlQQ: folds
XNMDwbXt/Q4jM99AXnbJDw: folds
bxLSulbgr8LmKNjOzw8URg: folds
C7+tBppJrKgd/r+tuKUIpA: calls $0.50
zE9cVigS2nW/Ljy4K4bUQA: folds
KcY3X8YpD74Kw1RHkx/g4A: folds
8ehL7qlZzjgUh2H35iiWLw: folds
cCjTzH9jio8607WzjcfXlg: folds
+k7T5ocke8UwavtgUHm+Cg: checks
*** FLOP *** [Ts 3d Qs]
+k7T5ocke8UwavtgUHm+Cg: checks
C7+tBppJrKgd/r+tuKUIpA: checks
*** TURN *** [Ts 3d Qs] [Jd]
+k7T5ocke8UwavtgUHm+Cg: checks
C7+tBppJrKgd/r+tuKUIpA: checks
*** RIVER *** [Ts 3d Qs Jd] [7c]
+k7T5ocke8UwavtgUHm+Cg: checks
C7+tBppJrKgd/r+tuKUIpA: checks
*** SHOW DOWN ***
+k7T5ocke8UwavtgUHm+Cg: shows [8d Kh] (high card King)
C7+tBppJrKgd/r+tuKUIpA: shows [Ah 9d] (high card Ace)
C7+tBppJrKgd/r+tuKUIpA collected $1.20 from pot
*** SUMMARY ***
Total pot $1.25 | Rake $0.05
Board [Ts 3d Qs Jd 7c]
Seat 1: 8ehL7qlZzjgUh2H35iiWLw (button) folded before Flop (didn't bet)
Seat 2: cCjTzH9jio8607WzjcfXlg (small blind) folded before Flop
Seat 3: +k7T5ocke8UwavtgUHm+Cg (big blind) showed [8d Kh] and lost with high card King
Seat 4: MG90wfSJZnOejs/KD3vlQQ folded before Flop (didn't bet)
Seat 5: XNMDwbXt/Q4jM99AXnbJDw folded before Flop (didn't bet)
Seat 6: bxLSulbgr8LmKNjOzw8URg folded before Flop (didn't bet)
Seat 7: C7+tBppJrKgd/r+tuKUIpA showed [Ah 9d] and won ($1.20) with high card Ace
Seat 8: zE9cVigS2nW/Ljy4K4bUQA folded before Flop (didn't bet)
Seat 9: KcY3X8YpD74Kw1RHkx/g4A folded before Flop (didn't bet)



PokerStars Game #59939914126:  Hold'em No Limit ($0.25/$0.50) - 2009/07/01 0:52:17 ET
Table 'ibNfFy0bCzuBaUORla0aGw' 9-max Seat #4 is the button
Seat 1: xZCXQSXlrZkp3pZizzVXCw ($52.05 in chips)
Seat 2: 90Wb75h3W1BRpbqVnuk8gw ($51.40 in chips)
Seat 3: AjV5McH1KMMclY26QdLM5w ($25 in chips)
Seat 4: YBN054X4blmis+B2bBlC0g ($23.45 in chips)
Seat 5: GIJAc9kPrLZHLSX8Q6i99w ($24.90 in chips)
Seat 6: 8n9jQLh3cZKbsmr5PIjgiQ ($42.15 in chips)
Seat 7: HZkVla4kK2SI42CVrPZ/ig ($14.30 in chips)
Seat 8: xUrN9TWLq4m5V+OXY7KUUA ($50.45 in chips)
Seat 9: pFtzb1sR4b0d1aw6aIRgDg ($50 in chips)
GIJAc9kPrLZHLSX8Q6i99w: posts small blind $0.25
8n9jQLh3cZKbsmr5PIjgiQ: posts big blind $0.50
*** HOLE CARDS ***
HZkVla4kK2SI42CVrPZ/ig: folds
xUrN9TWLq4m5V+OXY7KUUA: folds
pFtzb1sR4b0d1aw6aIRgDg: raises $1.50 to $2
xZCXQSXlrZkp3pZizzVXCw: folds
90Wb75h3W1BRpbqVnuk8gw: folds
AjV5McH1KMMclY26QdLM5w: folds
YBN054X4blmis+B2bBlC0g: folds
GIJAc9kPrLZHLSX8Q6i99w: calls $1.75
8n9jQLh3cZKbsmr5PIjgiQ: folds
*** FLOP *** [Jc Td 8d]
GIJAc9kPrLZHLSX8Q6i99w: checks
pFtzb1sR4b0d1aw6aIRgDg: bets $2.50
GIJAc9kPrLZHLSX8Q6i99w: folds
pFtzb1sR4b0d1aw6aIRgDg collected $4.30 from pot
*** SUMMARY ***
Total pot $4.50 | Rake $0.20
Board [Jc Td 8d]
Seat 1: xZCXQSXlrZkp3pZizzVXCw folded before Flop (didn't bet)
Seat 2: 90Wb75h3W1BRpbqVnuk8gw folded before Flop (didn't bet)
Seat 3: AjV5McH1KMMclY26QdLM5w folded before Flop (didn't bet)
Seat 4: YBN054X4blmis+B2bBlC0g (button) folded before Flop (didn't bet)
Seat 5: GIJAc9kPrLZHLSX8Q6i99w (small blind) folded on the Flop
Seat 6: 8n9jQLh3cZKbsmr5PIjgiQ (big blind) folded before Flop
Seat 7: HZkVla4kK2SI42CVrPZ/ig folded before Flop (didn't bet)
Seat 8: xUrN9TWLq4m5V+OXY7KUUA folded before Flop (didn't bet)
Seat 9: pFtzb1sR4b0d1aw6aIRgDg collected ($4.30)



PokerStars Game #59939915686:  Hold'em No Limit ($0.25/$0.50) - 2009/07/01 0:52:19 ET
Table '0eJtgVAXVvBgncFdcUpXcQ' 2-max Seat #1 is the button
Seat 1: Ag6DvxX4vbRheqsv2zXKTQ ($38.50 in chips)
Seat 2: KMc4R+K9ao4Ur3rF7NGe6Q ($13.45 in chips)
Ag6DvxX4vbRheqsv2zXKTQ: posts small blind $0.25
KMc4R+K9ao4Ur3rF7NGe6Q: posts big blind $0.50
*** HOLE CARDS ***
Ag6DvxX4vbRheqsv2zXKTQ: calls $0.25
KMc4R+K9ao4Ur3rF7NGe6Q: checks
*** FLOP *** [9h 4s Qc]
KMc4R+K9ao4Ur3rF7NGe6Q: checks
Ag6DvxX4vbRheqsv2zXKTQ: bets $1
KMc4R+K9ao4Ur3rF7NGe6Q: calls $1
*** TURN *** [9h 4s Qc] [8d]
KMc4R+K9ao4Ur3rF7NGe6Q: bets $1.50
Ag6DvxX4vbRheqsv2zXKTQ: calls $1.50
*** RIVER *** [9h 4s Qc 8d] [6h]
KMc4R+K9ao4Ur3rF7NGe6Q: checks
Ag6DvxX4vbRheqsv2zXKTQ: checks
*** SHOW DOWN ***
KMc4R+K9ao4Ur3rF7NGe6Q: shows [Tc 6s] (a pair of Sixes)
Ag6DvxX4vbRheqsv2zXKTQ: shows [7d Qs] (a pair of Queens)
Ag6DvxX4vbRheqsv2zXKTQ collected $5.75 from pot
*** SUMMARY ***
Total pot $6 | Rake $0.25
Board [9h 4s Qc 8d 6h]
Seat 1: Ag6DvxX4vbRheqsv2zXKTQ (button) (small blind) showed [7d Qs] and won ($5.75) with a pair of Queens
Seat 2: KMc4R+K9ao4Ur3rF7NGe6Q (big blind) showed [Tc 6s] and lost with a pair of Sixes



PokerStars Game #59939918258:  Hold'em No Limit ($0.25/$0.50) - 2009/07/01 0:52:23 ET
Table 'GfL/No5u5PoEnU39lP5pQg' 6-max Seat #4 is the button
Seat 1: 1WUCqNG+p+vfWRTXNu4ljw ($60 in chips)
Seat 2: uVwggSetzp7d+eVgowO3vg ($65.20 in chips)
Seat 3: Ek4w9XqBXqK5jBUQeLedGw ($51.25 in chips)
Seat 4: r6u7MWSXF30/khcTYkrG9Q ($24.65 in chips)
Seat 5: M1KyQQvVPVuxqTAB8sR/zQ ($51.75 in chips)
Seat 6: kxPhs4ePFqMy52CInAJ2aw ($50.75 in chips)
M1KyQQvVPVuxqTAB8sR/zQ: posts small blind $0.25
kxPhs4ePFqMy52CInAJ2aw: posts big blind $0.50
*** HOLE CARDS ***
1WUCqNG+p+vfWRTXNu4ljw: raises $1.50 to $2
uVwggSetzp7d+eVgowO3vg: folds
Ek4w9XqBXqK5jBUQeLedGw: folds
r6u7MWSXF30/khcTYkrG9Q: folds
M1KyQQvVPVuxqTAB8sR/zQ: folds
kxPhs4ePFqMy52CInAJ2aw: folds
1WUCqNG+p+vfWRTXNu4ljw collected $1.25 from pot
*** SUMMARY ***
Total pot $1.25 | Rake $0
Seat 1: 1WUCqNG+p+vfWRTXNu4ljw collected ($1.25)
Seat 2: uVwggSetzp7d+eVgowO3vg folded before Flop (didn't bet)
Seat 3: Ek4w9XqBXqK5jBUQeLedGw folded before Flop (didn't bet)
Seat 4: r6u7MWSXF30/khcTYkrG9Q (button) folded before Flop (didn't bet)
Seat 5: M1KyQQvVPVuxqTAB8sR/zQ (small blind) folded before Flop
Seat 6: kxPhs4ePFqMy52CInAJ2aw (big blind) folded before Flop



PokerStars Game #59939918508:  Hold'em No Limit ($0.25/$0.50) - 2009/07/01 0:52:24 ET
Table 'NHLx+ggeIlZy3D6oDgC0yg' 2-max Seat #1 is the button
Seat 1: Fp/oksNpipCrD2MJ2pH20g ($12.30 in chips)
Seat 2: DHMk3is1XNc/OjPVB8NJ5w ($47.50 in chips)
Fp/oksNpipCrD2MJ2pH20g: posts small blind $0.25
DHMk3is1XNc/OjPVB8NJ5w: posts big blind $0.50
*** HOLE CARDS ***
Fp/oksNpipCrD2MJ2pH20g: raises $1.50 to $2
DHMk3is1XNc/OjPVB8NJ5w: folds
Fp/oksNpipCrD2MJ2pH20g collected $1 from pot
Fp/oksNpipCrD2MJ2pH20g: doesn't show hand
*** SUMMARY ***
Total pot $1 | Rake $0
Seat 1: Fp/oksNpipCrD2MJ2pH20g (button) (small blind) collected ($1)
Seat 2: DHMk3is1XNc/OjPVB8NJ5w (big blind) folded before Flop



PokerStars Game #59939920206:  Hold'em No Limit ($0.25/$0.50) - 2009/07/01 0:52:26 ET
Table '+dXkOAQyS8j9PQZusUTMpg' 2-max Seat #1 is the button
Seat 1: XFa6sBGjP2gxoIvxR3fZIg ($61.35 in chips)
Seat 2: 5IBeOgaApY1Bvzv2P8X4EA ($140.25 in chips)
XFa6sBGjP2gxoIvxR3fZIg: posts small blind $0.25
5IBeOgaApY1Bvzv2P8X4EA: posts big blind $0.50
*** HOLE CARDS ***
XFa6sBGjP2gxoIvxR3fZIg: raises $0.50 to $1
5IBeOgaApY1Bvzv2P8X4EA: calls $0.50
*** FLOP *** [3c 9d 3s]
5IBeOgaApY1Bvzv2P8X4EA: checks
XFa6sBGjP2gxoIvxR3fZIg: checks
*** TURN *** [3c 9d 3s] [7s]
5IBeOgaApY1Bvzv2P8X4EA: checks
XFa6sBGjP2gxoIvxR3fZIg: bets $1.50
5IBeOgaApY1Bvzv2P8X4EA: folds
XFa6sBGjP2gxoIvxR3fZIg collected $1.90 from pot
XFa6sBGjP2gxoIvxR3fZIg: doesn't show hand
*** SUMMARY ***
Total pot $2 | Rake $0.10
Board [3c 9d 3s 7s]
Seat 1: XFa6sBGjP2gxoIvxR3fZIg (button) (small blind) collected ($1.90)
Seat 2: 5IBeOgaApY1Bvzv2P8X4EA (big blind) folded on the Turn



PokerStars Game #59939920888:  Hold'em No Limit ($0.25/$0.50) - 2009/07/01 0:52:27 ET
Table 'MJxeZCzYELxiIsyUZyT0jw' 6-max Seat #2 is the button
Seat 2: t3GiVMzqA9Svgr5Uol32cQ ($36.35 in chips)
Seat 3: JQZew0FjzS19kTjeNtrE+A ($60.30 in chips)
Seat 4: alGiiQP/wwtYnfuXII+sgw ($49.35 in chips)
Seat 5: 3jvoOXNtXE90w2BdfNZwZQ ($50.75 in chips)
Seat 6: TTx3CHxyi0SObcHyMJRp5w ($51.30 in chips)
JQZew0FjzS19kTjeNtrE+A: posts small blind $0.25
alGiiQP/wwtYnfuXII+sgw: posts big blind $0.50
*** HOLE CARDS ***
3jvoOXNtXE90w2BdfNZwZQ: folds
TTx3CHxyi0SObcHyMJRp5w: calls $0.50
t3GiVMzqA9Svgr5Uol32cQ: folds
JQZew0FjzS19kTjeNtrE+A: raises $1.50 to $2
alGiiQP/wwtYnfuXII+sgw: folds
TTx3CHxyi0SObcHyMJRp5w: folds
JQZew0FjzS19kTjeNtrE+A collected $1.50 from pot
*** SUMMARY ***
Total pot $1.50 | Rake $0
Seat 2: t3GiVMzqA9Svgr5Uol32cQ (button) folded before Flop (didn't bet)
Seat 3: JQZew0FjzS19kTjeNtrE+A (small blind) collected ($1.50)
Seat 4: alGiiQP/wwtYnfuXII+sgw (big blind) folded before Flop
Seat 5: 3jvoOXNtXE90w2BdfNZwZQ folded before Flop (didn't bet)
Seat 6: TTx3CHxyi0SObcHyMJRp5w folded before Flop



PokerStars Game #59939922722:  Hold'em No Limit ($0.25/$0.50) - 2009/07/01 0:52:30 ET
Table 'BCN5su+SsXiy1zRMJi0SJw' 6-max Seat #5 is the button
Seat 1: GxXV09ciXaOxyY2H5aMIIw ($28.75 in chips)
Seat 2: oU2kDCkT/gilYbHWrg7D8w ($19.20 in chips)
Seat 3: g+vwI6lMKpU2uteXSjOzVw ($15.75 in chips)
Seat 5: IBNygaT1aa9Z1uPdJJilwA ($25.75 in chips)
Seat 6: b2symlOdL7+0c9Pj4N/KlA ($83.20 in chips)
b2symlOdL7+0c9Pj4N/KlA: posts small blind $0.25
GxXV09ciXaOxyY2H5aMIIw: posts big blind $0.50
*** HOLE CARDS ***
oU2kDCkT/gilYbHWrg7D8w: calls $0.50
g+vwI6lMKpU2uteXSjOzVw: folds
g+vwI6lMKpU2uteXSjOzVw leaves the table
IBNygaT1aa9Z1uPdJJilwA: calls $0.50
b2symlOdL7+0c9Pj4N/KlA: folds
GxXV09ciXaOxyY2H5aMIIw: checks
*** FLOP *** [Kc Jd Js]
GxXV09ciXaOxyY2H5aMIIw: checks
oU2kDCkT/gilYbHWrg7D8w: checks
IBNygaT1aa9Z1uPdJJilwA: checks
*** TURN *** [Kc Jd Js] [Ah]
GxXV09ciXaOxyY2H5aMIIw: checks
oU2kDCkT/gilYbHWrg7D8w: checks
IBNygaT1aa9Z1uPdJJilwA: checks
*** RIVER *** [Kc Jd Js Ah] [Td]
GxXV09ciXaOxyY2H5aMIIw: checks
oU2kDCkT/gilYbHWrg7D8w: checks
IBNygaT1aa9Z1uPdJJilwA: checks
*** SHOW DOWN ***
GxXV09ciXaOxyY2H5aMIIw: shows [7s 3d] (a pair of Jacks)
oU2kDCkT/gilYbHWrg7D8w: shows [8c 9c] (a pair of Jacks)
IBNygaT1aa9Z1uPdJJilwA: shows [8d 9d] (a pair of Jacks)
GxXV09ciXaOxyY2H5aMIIw collected $0.60 from pot
oU2kDCkT/gilYbHWrg7D8w collected $0.55 from pot
IBNygaT1aa9Z1uPdJJilwA collected $0.55 from pot
*** SUMMARY ***
Total pot $1.75 | Rake $0.05
Board [Kc Jd Js Ah Td]
Seat 1: GxXV09ciXaOxyY2H5aMIIw (big blind) showed [7s 3d] and won ($0.60) with a pair of Jacks
Seat 2: oU2kDCkT/gilYbHWrg7D8w showed [8c 9c] and won ($0.55) with a pair of Jacks
Seat 3: g+vwI6lMKpU2uteXSjOzVw folded before Flop (didn't bet)
Seat 5: IBNygaT1aa9Z1uPdJJilwA (button) showed [8d 9d] and won ($0.55) with a pair of Jacks
Seat 6: b2symlOdL7+0c9Pj4N/KlA (small blind) folded before Flop



PokerStars Game #59939922426:  Hold'em No Limit ($0.25/$0.50) - 2009/07/01 0:52:30 ET
Table 'E7bWJ45aoFXRpyRv2gw+Ig' 2-max Seat #1 is the button
Seat 1: FRkiRasEGlHUeLrEl+k/nA ($106 in chips)
Seat 2: 3Wro85I7472vJ4Wkpneo9A ($86.85 in chips)
FRkiRasEGlHUeLrEl+k/nA: posts small blind $0.25
3Wro85I7472vJ4Wkpneo9A: posts big blind $0.50
*** HOLE CARDS ***
FRkiRasEGlHUeLrEl+k/nA: raises $1 to $1.50
3Wro85I7472vJ4Wkpneo9A: folds
FRkiRasEGlHUeLrEl+k/nA collected $1 from pot
*** SUMMARY ***
Total pot $1 | Rake $0
Seat 1: FRkiRasEGlHUeLrEl+k/nA (button) (small blind) collected ($1)
Seat 2: 3Wro85I7472vJ4Wkpneo9A (big blind) folded before Flop



PokerStars Game #59939922378:  Hold'em No Limit ($0.25/$0.50) - 2009/07/01 0:52:30 ET
Table '8BQGgNetI1NOvWeu3gtMNw' 2-max Seat #1 is the button
Seat 1: bypIyrYcAAifLfhZpGlKLA ($50 in chips)
Seat 2: Z4HwehErEwzsv/noQlfUlg ($65 in chips)
bypIyrYcAAifLfhZpGlKLA: posts small blind $0.25
Z4HwehErEwzsv/noQlfUlg: posts big blind $0.50
*** HOLE CARDS ***
bypIyrYcAAifLfhZpGlKLA: raises $1 to $1.50
Z4HwehErEwzsv/noQlfUlg: raises $1.50 to $3
bypIyrYcAAifLfhZpGlKLA: calls $1.50
*** FLOP *** [Ad 7h 8s]
Z4HwehErEwzsv/noQlfUlg: checks
bypIyrYcAAifLfhZpGlKLA: checks
*** TURN *** [Ad 7h 8s] [8c]
Z4HwehErEwzsv/noQlfUlg: checks
bypIyrYcAAifLfhZpGlKLA: checks
*** RIVER *** [Ad 7h 8s 8c] [Jd]
Z4HwehErEwzsv/noQlfUlg: bets $9
bypIyrYcAAifLfhZpGlKLA: folds
Z4HwehErEwzsv/noQlfUlg collected $5.70 from pot
Z4HwehErEwzsv/noQlfUlg: doesn't show hand
*** SUMMARY ***
Total pot $6 | Rake $0.30
Board [Ad 7h 8s 8c Jd]
Seat 1: bypIyrYcAAifLfhZpGlKLA (button) (small blind) folded on the River
Seat 2: Z4HwehErEwzsv/noQlfUlg (big blind) collected ($5.70)



PokerStars Game #59939922712:  Hold'em No Limit ($0.25/$0.50) - 2009/07/01 0:52:30 ET
Table '37qXEp3oe+er5q4CZip9eQ' 6-max Seat #2 is the button
Seat 1: oqOqoO2AyCZenUghCxMDxw ($56.90 in chips)
Seat 2: 6wzJiRvp8HY6t+MQGnSIzA ($16.50 in chips)
Seat 3: Rt6KgtZ8YaJoTc3FPim00w ($103.55 in chips)
Seat 4: XsmE8nXMAAMFJbWaJTmHFw ($35.45 in chips)
Seat 5: VOmI0x4dDPnTESZd5B4d1Q ($43.65 in chips)
Seat 6: N50kln4negd8q7Mmoz1j4g ($19.30 in chips)
Rt6KgtZ8YaJoTc3FPim00w: posts small blind $0.25
XsmE8nXMAAMFJbWaJTmHFw: posts big blind $0.50
*** HOLE CARDS ***
VOmI0x4dDPnTESZd5B4d1Q: folds
N50kln4negd8q7Mmoz1j4g: folds
oqOqoO2AyCZenUghCxMDxw: folds
6wzJiRvp8HY6t+MQGnSIzA: raises $2 to $2.50
Rt6KgtZ8YaJoTc3FPim00w: folds
XsmE8nXMAAMFJbWaJTmHFw: folds
6wzJiRvp8HY6t+MQGnSIzA collected $1.25 from pot
*** SUMMARY ***
Total pot $1.25 | Rake $0
Seat 1: oqOqoO2AyCZenUghCxMDxw folded before Flop (didn't bet)
Seat 2: 6wzJiRvp8HY6t+MQGnSIzA (button) collected ($1.25)
Seat 3: Rt6KgtZ8YaJoTc3FPim00w (small blind) folded before Flop
Seat 4: XsmE8nXMAAMFJbWaJTmHFw (big blind) folded before Flop
Seat 5: VOmI0x4dDPnTESZd5B4d1Q folded before Flop (didn't bet)
Seat 6: N50kln4negd8q7Mmoz1j4g folded before Flop (didn't bet)



PokerStars Game #59939924088:  Hold'em No Limit ($0.25/$0.50) - 2009/07/01 0:52:33 ET
Table 'NHLx+ggeIlZy3D6oDgC0yg' 2-max Seat #2 is the button
Seat 1: Fp/oksNpipCrD2MJ2pH20g ($12.80 in chips)
Seat 2: DHMk3is1XNc/OjPVB8NJ5w ($49.50 in chips)
DHMk3is1XNc/OjPVB8NJ5w: posts small blind $0.25
Fp/oksNpipCrD2MJ2pH20g: posts big blind $0.50
*** HOLE CARDS ***
DHMk3is1XNc/OjPVB8NJ5w: calls $0.25
Fp/oksNpipCrD2MJ2pH20g: checks
*** FLOP *** [Ah 3s 9d]
Fp/oksNpipCrD2MJ2pH20g: bets $0.50
DHMk3is1XNc/OjPVB8NJ5w: folds
Fp/oksNpipCrD2MJ2pH20g collected $0.95 from pot
Fp/oksNpipCrD2MJ2pH20g: doesn't show hand
*** SUMMARY ***
Total pot $1 | Rake $0.05
Board [Ah 3s 9d]
Seat 1: Fp/oksNpipCrD2MJ2pH20g (big blind) collected ($0.95)
Seat 2: DHMk3is1XNc/OjPVB8NJ5w (button) (small blind) folded on the Flop



PokerStars Game #59939924968:  Hold'em No Limit ($0.25/$0.50) - 2009/07/01 0:52:34 ET
Table 'EiNh8p/wGJ1FP575iMFnqg' 9-max Seat #8 is the button
Seat 1: r3ZqM1Mi0W3y4hOdssE+Sg ($45.85 in chips)
Seat 2: 8ehL7qlZzjgUh2H35iiWLw ($52.60 in chips)
Seat 3: ymLPoEIl7UL3TvZYmnadxQ ($50.85 in chips)
Seat 4: cMzaiXAM/ZAdNaEUu+LqhA ($55.70 in chips)
Seat 5: M+7+BTmX5vZatHVuoRB1nA ($82.20 in chips)
Seat 6: 3UmXLy3GfjC3EkOebduerQ ($65.35 in chips)
Seat 7: 997ViqAtWn1FPjJqcffwcA ($50 in chips)
Seat 8: mSD1pginDsyHG5PDfqzphw ($10 in chips)
Seat 9: NnQCepdIR/AOUQn1yhYx6Q ($9.50 in chips)
NnQCepdIR/AOUQn1yhYx6Q: posts small blind $0.25
r3ZqM1Mi0W3y4hOdssE+Sg: posts big blind $0.50
*** HOLE CARDS ***
8ehL7qlZzjgUh2H35iiWLw: folds
ymLPoEIl7UL3TvZYmnadxQ: folds
cMzaiXAM/ZAdNaEUu+LqhA: folds
M+7+BTmX5vZatHVuoRB1nA: folds
3UmXLy3GfjC3EkOebduerQ: folds
997ViqAtWn1FPjJqcffwcA: folds
mSD1pginDsyHG5PDfqzphw: folds
NnQCepdIR/AOUQn1yhYx6Q: raises $1.50 to $2
r3ZqM1Mi0W3y4hOdssE+Sg: folds
NnQCepdIR/AOUQn1yhYx6Q collected $1 from pot
*** SUMMARY ***
Total pot $1 | Rake $0
Seat 1: r3ZqM1Mi0W3y4hOdssE+Sg (big blind) folded before Flop
Seat 2: 8ehL7qlZzjgUh2H35iiWLw folded before Flop (didn't bet)
Seat 3: ymLPoEIl7UL3TvZYmnadxQ folded before Flop (didn't bet)
Seat 4: cMzaiXAM/ZAdNaEUu+LqhA folded before Flop (didn't bet)
Seat 5: M+7+BTmX5vZatHVuoRB1nA folded before Flop (didn't bet)
Seat 6: 3UmXLy3GfjC3EkOebduerQ folded before Flop (didn't bet)
Seat 7: 997ViqAtWn1FPjJqcffwcA folded before Flop (didn't bet)
Seat 8: mSD1pginDsyHG5PDfqzphw (button) folded before Flop (didn't bet)
Seat 9: NnQCepdIR/AOUQn1yhYx6Q (small blind) collected ($1)



PokerStars Game #59939927028:  Hold'em No Limit ($0.25/$0.50) - 2009/07/01 0:52:37 ET
Table '0eJtgVAXVvBgncFdcUpXcQ' 2-max Seat #2 is the button
Seat 1: Ag6DvxX4vbRheqsv2zXKTQ ($41.25 in chips)
Seat 2: KMc4R+K9ao4Ur3rF7NGe6Q ($10.45 in chips)
KMc4R+K9ao4Ur3rF7NGe6Q: posts small blind $0.25
Ag6DvxX4vbRheqsv2zXKTQ: posts big blind $0.50
*** HOLE CARDS ***
KMc4R+K9ao4Ur3rF7NGe6Q: calls $0.25
Ag6DvxX4vbRheqsv2zXKTQ: checks
*** FLOP *** [6c 9d Jd]
Ag6DvxX4vbRheqsv2zXKTQ: checks
KMc4R+K9ao4Ur3rF7NGe6Q: bets $1.50
Ag6DvxX4vbRheqsv2zXKTQ: folds
KMc4R+K9ao4Ur3rF7NGe6Q collected $0.95 from pot
KMc4R+K9ao4Ur3rF7NGe6Q: doesn't show hand
*** SUMMARY ***
Total pot $1 | Rake $0.05
Board [6c 9d Jd]
Seat 1: Ag6DvxX4vbRheqsv2zXKTQ (big blind) folded on the Flop
Seat 2: KMc4R+K9ao4Ur3rF7NGe6Q (button) (small blind) collected ($0.95)



PokerStars Game #59939927272:  Hold'em No Limit ($0.25/$0.50) - 2009/07/01 0:52:38 ET
Table 'NCiXr0d5CEKBQr/cZgLhbA' 9-max Seat #7 is the button
Seat 1: pFtzb1sR4b0d1aw6aIRgDg ($50 in chips)
Seat 2: ulxuJchBV9iguXg0FUonfg ($47.75 in chips)
Seat 3: xZCXQSXlrZkp3pZizzVXCw ($52.25 in chips)
Seat 4: 5k9fvXD9suIgCxU4HLQjTw ($55.95 in chips)
Seat 5: zE9cVigS2nW/Ljy4K4bUQA ($35.95 in chips)
Seat 6: SKnJuWHScqetA/qG5p+wCg ($34.75 in chips)
Seat 7: M+7+BTmX5vZatHVuoRB1nA ($47.55 in chips)
Seat 8: 1MJUKc3cc0QmUoz1JZLR2w ($58.50 in chips)
Seat 9: 4WLZvqBn5qv5tds5kt5A1Q ($46.55 in chips)
1MJUKc3cc0QmUoz1JZLR2w: posts small blind $0.25
4WLZvqBn5qv5tds5kt5A1Q: posts big blind $0.50
*** HOLE CARDS ***
pFtzb1sR4b0d1aw6aIRgDg: calls $0.50
ulxuJchBV9iguXg0FUonfg: folds
xZCXQSXlrZkp3pZizzVXCw: folds
5k9fvXD9suIgCxU4HLQjTw: folds
zE9cVigS2nW/Ljy4K4bUQA: raises $1 to $1.50
SKnJuWHScqetA/qG5p+wCg: folds
M+7+BTmX5vZatHVuoRB1nA: calls $1.50
1MJUKc3cc0QmUoz1JZLR2w: folds
4WLZvqBn5qv5tds5kt5A1Q: calls $1
pFtzb1sR4b0d1aw6aIRgDg: calls $1
*** FLOP *** [5d 9s 8d]
4WLZvqBn5qv5tds5kt5A1Q: checks
pFtzb1sR4b0d1aw6aIRgDg: checks
zE9cVigS2nW/Ljy4K4bUQA: checks
M+7+BTmX5vZatHVuoRB1nA: bets $4.50
4WLZvqBn5qv5tds5kt5A1Q: folds
pFtzb1sR4b0d1aw6aIRgDg: folds
zE9cVigS2nW/Ljy4K4bUQA: folds
M+7+BTmX5vZatHVuoRB1nA collected $5.95 from pot
*** SUMMARY ***
Total pot $6.25 | Rake $0.30
Board [5d 9s 8d]
Seat 1: pFtzb1sR4b0d1aw6aIRgDg folded on the Flop
Seat 2: ulxuJchBV9iguXg0FUonfg folded before Flop (didn't bet)
Seat 3: xZCXQSXlrZkp3pZizzVXCw folded before Flop (didn't bet)
Seat 4: 5k9fvXD9suIgCxU4HLQjTw folded before Flop (didn't bet)
Seat 5: zE9cVigS2nW/Ljy4K4bUQA folded on the Flop
Seat 6: SKnJuWHScqetA/qG5p+wCg folded before Flop (didn't bet)
Seat 7: M+7+BTmX5vZatHVuoRB1nA (button) collected ($5.95)
Seat 8: 1MJUKc3cc0QmUoz1JZLR2w (small blind) folded before Flop
Seat 9: 4WLZvqBn5qv5tds5kt5A1Q (big blind) folded on the Flop



PokerStars Game #59939927878:  Hold'em No Limit ($0.25/$0.50) - 2009/07/01 0:52:39 ET
Table 'QOgaEqMcJ73pcUMMxoisUgErOuyGLI5PT3G5MnpHgC/g Seat #3 is the button
Seat 3: xZCXQSXlrZkp3pZizzVXCw ($49.50 in chips)
Seat 4: 3UmXLy3GfjC3EkOebduerQ ($50.70 in chips)
Seat 5: JwvquocWfhTVApN5t47LgA ($60.80 in chips)
Seat 6: zE9cVigS2nW/Ljy4K4bUQA ($30 in chips)
Seat 7: 90Wb75h3W1BRpbqVnuk8gw ($65.55 in chips)
Seat 8: g4k0NXISyLCqaSWZDBjfEg ($50 in chips)
Seat 9: J0W5D97jl5VLky+IoPvDeA ($53.15 in chips)
3UmXLy3GfjC3EkOebduerQ: posts small blind $0.25
JwvquocWfhTVApN5t47LgA: posts big blind $0.50
eBrej2jnlUCs/JgxFCRn2g: sits out
*** HOLE CARDS ***
zE9cVigS2nW/Ljy4K4bUQA: folds
90Wb75h3W1BRpbqVnuk8gw: folds
g4k0NXISyLCqaSWZDBjfEg: folds
J0W5D97jl5VLky+IoPvDeA: folds
xZCXQSXlrZkp3pZizzVXCw: folds
3UmXLy3GfjC3EkOebduerQ: folds
JwvquocWfhTVApN5t47LgA collected $0.50 from pot
*** SUMMARY ***
Total pot $0.50 | Rake $0
Seat 3: xZCXQSXlrZkp3pZizzVXCw (button) folded before Flop (didn't bet)
Seat 4: 3UmXLy3GfjC3EkOebduerQ (small blind) folded before Flop
Seat 5: JwvquocWfhTVApN5t47LgA (big blind) collected ($0.50)
Seat 6: zE9cVigS2nW/Ljy4K4bUQA folded before Flop (didn't bet)
Seat 7: 90Wb75h3W1BRpbqVnuk8gw folded before Flop (didn't bet)
Seat 8: g4k0NXISyLCqaSWZDBjfEg folded before Flop (didn't bet)
Seat 9: J0W5D97jl5VLky+IoPvDeA folded before Flop (didn't bet)



PokerStars Game #59939928670:  Hold'em No Limit ($0.25/$0.50) - 2009/07/01 0:52:40 ET
Table 'B+sqsfj6d6zXicNfaseTaw' 2-max Seat #2 is the button
Seat 1: +4GNcSsecmapVGSdV0mUPA ($71.05 in chips)
Seat 2: Lv5RmpRe6LtPkBzM9Gpo5A ($62.80 in chips)
Lv5RmpRe6LtPkBzM9Gpo5A: posts small blind $0.25
+4GNcSsecmapVGSdV0mUPA: posts big blind $0.50
*** HOLE CARDS ***
Lv5RmpRe6LtPkBzM9Gpo5A: raises $0.50 to $1
+4GNcSsecmapVGSdV0mUPA: calls $0.50
*** FLOP *** [8h 7s Qs]
+4GNcSsecmapVGSdV0mUPA: checks
Lv5RmpRe6LtPkBzM9Gpo5A: checks
*** TURN *** [8h 7s Qs] [7c]
+4GNcSsecmapVGSdV0mUPA: checks
Lv5RmpRe6LtPkBzM9Gpo5A: checks
*** RIVER *** [8h 7s Qs 7c] [5d]
+4GNcSsecmapVGSdV0mUPA: checks
Lv5RmpRe6LtPkBzM9Gpo5A: checks
*** SHOW DOWN ***
+4GNcSsecmapVGSdV0mUPA: shows [5h Js] (two pair, Sevens and Fives)
Lv5RmpRe6LtPkBzM9Gpo5A: mucks hand
+4GNcSsecmapVGSdV0mUPA collected $1.90 from pot
*** SUMMARY ***
Total pot $2 | Rake $0.10
Board [8h 7s Qs 7c 5d]
Seat 1: +4GNcSsecmapVGSdV0mUPA (big blind) showed [5h Js] and won ($1.90) with two pair, Sevens and Fives
Seat 2: Lv5RmpRe6LtPkBzM9Gpo5A (button) (small blind) mucked



PokerStars Game #59939930244:  Hold'em No Limit ($0.25/$0.50) - 2009/07/01 0:52:42 ET
Table 'E7bWJ45aoFXRpyRv2gw+Ig' 2-max Seat #2 is the button
Seat 1: FRkiRasEGlHUeLrEl+k/nA ($106.50 in chips)
Seat 2: 3Wro85I7472vJ4Wkpneo9A ($86.35 in chips)
3Wro85I7472vJ4Wkpneo9A: posts small blind $0.25
FRkiRasEGlHUeLrEl+k/nA: posts big blind $0.50
*** HOLE CARDS ***
3Wro85I7472vJ4Wkpneo9A: raises $1 to $1.50
FRkiRasEGlHUeLrEl+k/nA: folds
3Wro85I7472vJ4Wkpneo9A collected $1 from pot
3Wro85I7472vJ4Wkpneo9A: doesn't show hand
*** SUMMARY ***
Total pot $1 | Rake $0
Seat 1: FRkiRasEGlHUeLrEl+k/nA (big blind) folded before Flop
Seat 2: 3Wro85I7472vJ4Wkpneo9A (button) (small blind) collected ($1)



PokerStars Game #59939931570:  Hold'em No Limit ($0.25/$0.50) - 2009/07/01 0:52:44 ET
Table 'NHLx+ggeIlZy3D6oDgC0yg' 2-max Seat #1 is the button
Seat 1: Fp/oksNpipCrD2MJ2pH20g ($13.25 in chips)
Seat 2: DHMk3is1XNc/OjPVB8NJ5w ($49 in chips)
Fp/oksNpipCrD2MJ2pH20g: posts small blind $0.25
DHMk3is1XNc/OjPVB8NJ5w: posts big blind $0.50
*** HOLE CARDS ***
Fp/oksNpipCrD2MJ2pH20g: raises $0.50 to $1
DHMk3is1XNc/OjPVB8NJ5w: calls $0.50
*** FLOP *** [6d 3s 8h]
DHMk3is1XNc/OjPVB8NJ5w: checks
Fp/oksNpipCrD2MJ2pH20g: bets $0.50
DHMk3is1XNc/OjPVB8NJ5w: raises $3.50 to $4
Fp/oksNpipCrD2MJ2pH20g: folds
DHMk3is1XNc/OjPVB8NJ5w collected $2.90 from pot
DHMk3is1XNc/OjPVB8NJ5w: doesn't show hand
*** SUMMARY ***
Total pot $3 | Rake $0.10
Board [6d 3s 8h]
Seat 1: Fp/oksNpipCrD2MJ2pH20g (button) (small blind) folded on the Flop
Seat 2: DHMk3is1XNc/OjPVB8NJ5w (big blind) collected ($2.90)



PokerStars Game #59939931398:  Hold'em No Limit ($0.25/$0.50) - 2009/07/01 0:52:44 ET
Table 'T/PgNWqVyY6lkldcBVXYJQ' 6-max Seat #6 is the button
Seat 1: +Pf9jTVizYlIo+woPvptfA ($76.50 in chips)
Seat 3: L3OcNO1bgdqDI46j67KQPQ ($50 in chips)
Seat 4: Ek4w9XqBXqK5jBUQeLedGw ($50 in chips)
Seat 5: of9mtXiD8G4Nx5p7hCbgqQ ($53.25 in chips)
Seat 6: khHFhne53qR5U3ky0T78jw ($8.25 in chips)
+Pf9jTVizYlIo+woPvptfA: posts small blind $0.25
LvH4G7n+QSjT6NDaD3cREA: is sitting out
L3OcNO1bgdqDI46j67KQPQ: posts big blind $0.50
*** HOLE CARDS ***
LvH4G7n+QSjT6NDaD3cREA leaves the table
Ek4w9XqBXqK5jBUQeLedGw: folds
of9mtXiD8G4Nx5p7hCbgqQ: folds
khHFhne53qR5U3ky0T78jw: folds
+Pf9jTVizYlIo+woPvptfA: folds
L3OcNO1bgdqDI46j67KQPQ collected $0.50 from pot
L3OcNO1bgdqDI46j67KQPQ: doesn't show hand
*** SUMMARY ***
Total pot $0.50 | Rake $0
Seat 1: +Pf9jTVizYlIo+woPvptfA (small blind) folded before Flop
Seat 3: L3OcNO1bgdqDI46j67KQPQ (big blind) collected ($0.50)
Seat 4: Ek4w9XqBXqK5jBUQeLedGw folded before Flop (didn't bet)
Seat 5: of9mtXiD8G4Nx5p7hCbgqQ folded before Flop (didn't bet)
Seat 6: khHFhne53qR5U3ky0T78jw (button) folded before Flop (didn't bet)



PokerStars Game #59939931928:  Hold'em No Limit ($0.25/$0.50) - 2009/07/01 0:52:45 ET
Table 'MJxeZCzYELxiIsyUZyT0jw' 6-max Seat #3 is the button
Seat 2: t3GiVMzqA9Svgr5Uol32cQ ($36.35 in chips)
Seat 3: JQZew0FjzS19kTjeNtrE+A ($61.30 in chips)
Seat 4: alGiiQP/wwtYnfuXII+sgw ($48.85 in chips)
Seat 5: 3jvoOXNtXE90w2BdfNZwZQ ($50.75 in chips)
Seat 6: TTx3CHxyi0SObcHyMJRp5w ($50.80 in chips)
alGiiQP/wwtYnfuXII+sgw: posts small blind $0.25
3jvoOXNtXE90w2BdfNZwZQ: posts big blind $0.50
*** HOLE CARDS ***
TTx3CHxyi0SObcHyMJRp5w: folds
t3GiVMzqA9Svgr5Uol32cQ: raises $1.50 to $2
+Pf9jTVizYlIo+woPvptfA joins the table at seat #1
JQZew0FjzS19kTjeNtrE+A: folds
alGiiQP/wwtYnfuXII+sgw: folds
3jvoOXNtXE90w2BdfNZwZQ: folds
t3GiVMzqA9Svgr5Uol32cQ collected $1.25 from pot
*** SUMMARY ***
Total pot $1.25 | Rake $0
Seat 2: t3GiVMzqA9Svgr5Uol32cQ collected ($1.25)
Seat 3: JQZew0FjzS19kTjeNtrE+A (button) folded before Flop (didn't bet)
Seat 4: alGiiQP/wwtYnfuXII+sgw (small blind) folded before Flop
Seat 5: 3jvoOXNtXE90w2BdfNZwZQ (big blind) folded before Flop
Seat 6: TTx3CHxyi0SObcHyMJRp5w folded before Flop (didn't bet)



PokerStars Game #59939932216:  Hold'em No Limit ($0.25/$0.50) - 2009/07/01 0:52:45 ET
Table '+dXkOAQyS8j9PQZusUTMpg' 2-max Seat #2 is the button
Seat 1: XFa6sBGjP2gxoIvxR3fZIg ($62.25 in chips)
Seat 2: 5IBeOgaApY1Bvzv2P8X4EA ($139.25 in chips)
5IBeOgaApY1Bvzv2P8X4EA: posts small blind $0.25
XFa6sBGjP2gxoIvxR3fZIg: posts big blind $0.50
*** HOLE CARDS ***
5IBeOgaApY1Bvzv2P8X4EA: folds
XFa6sBGjP2gxoIvxR3fZIg collected $0.50 from pot
XFa6sBGjP2gxoIvxR3fZIg: doesn't show hand
*** SUMMARY ***
Total pot $0.50 | Rake $0
Seat 1: XFa6sBGjP2gxoIvxR3fZIg (big blind) collected ($0.50)
Seat 2: 5IBeOgaApY1Bvzv2P8X4EA (button) (small blind) folded before Flop



PokerStars Game #59939931624:  Hold'em No Limit ($0.25/$0.50) - 2009/07/01 0:52:45 ET
Table '+z1aekfHkpp09pc8F9aViw' 6-max Seat #2 is the button
Seat 1: FHilMb2i2DbUCc9lplszog ($44.25 in chips)
Seat 2: M6xK/VklCvdyyrmvzATlxQ ($34.50 in chips)
Seat 3: uUznlIMFnRUvwrBhYF73KA ($117.95 in chips)
Seat 4: RowCSpSURHTOL/dcjg/Iug ($43.05 in chips)
Seat 5: rplyldNweS6YyMNEALQrug ($13 in chips)
Seat 6: 686aeHikcJlgKkSuIFdcXQ ($50.75 in chips)
uUznlIMFnRUvwrBhYF73KA: posts small blind $0.25
RowCSpSURHTOL/dcjg/Iug: posts big blind $0.50
*** HOLE CARDS ***
rplyldNweS6YyMNEALQrug: calls $0.50
686aeHikcJlgKkSuIFdcXQ: folds
FHilMb2i2DbUCc9lplszog: raises $0.50 to $1
M6xK/VklCvdyyrmvzATlxQ: folds
uUznlIMFnRUvwrBhYF73KA: calls $0.75
RowCSpSURHTOL/dcjg/Iug: calls $0.50
rplyldNweS6YyMNEALQrug: calls $0.50
*** FLOP *** [As 6s Qh]
uUznlIMFnRUvwrBhYF73KA: checks
RowCSpSURHTOL/dcjg/Iug: checks
rplyldNweS6YyMNEALQrug: checks
FHilMb2i2DbUCc9lplszog: bets $2.50
uUznlIMFnRUvwrBhYF73KA: folds
RowCSpSURHTOL/dcjg/Iug: folds
rplyldNweS6YyMNEALQrug: folds
FHilMb2i2DbUCc9lplszog collected $3.80 from pot
*** SUMMARY ***
Total pot $4 | Rake $0.20
Board [As 6s Qh]
Seat 1: FHilMb2i2DbUCc9lplszog collected ($3.80)
Seat 2: M6xK/VklCvdyyrmvzATlxQ (button) folded before Flop (didn't bet)
Seat 3: uUznlIMFnRUvwrBhYF73KA (small blind) folded on the Flop
Seat 4: RowCSpSURHTOL/dcjg/Iug (big blind) folded on the Flop
Seat 5: rplyldNweS6YyMNEALQrug folded on the Flop
Seat 6: 686aeHikcJlgKkSuIFdcXQ folded before Flop (didn't bet)



PokerStars Game #59939933422:  Hold'em No Limit ($0.25/$0.50) - 2009/07/01 0:52:47 ET
Table '99gCy/CZQwPIjZWH+BguQgE7bWJ45aoFXRpyRv2gw+Igeat #2 is the button
Seat 2: n6VQBu6crjYjy6DxNP1NZA ($28.75 in chips)
Seat 3: qEn9ijNGtuyTxamBf07hYg ($50 in chips)
Seat 4: bxLSulbgr8LmKNjOzw8URg ($61.45 in chips)
Seat 5: DSM67hHHq1XFoEOi9p8Alw ($46 in chips)
Seat 7: bfSq6LBw0UvxeM5yfuWC7w ($17.10 in chips)
Seat 8: 8ehL7qlZzjgUh2H35iiWLw ($56 in chips)
Seat 9: j3K/Jujr7PY4ZM2RZvlH6A ($92.65 in chips)
qEn9ijNGtuyTxamBf07hYg: posts small blind $0.25
bxLSulbgr8LmKNjOzw8URg: posts big blind $0.50
*** HOLE CARDS ***
DSM67hHHq1XFoEOi9p8Alw: folds
bfSq6LBw0UvxeM5yfuWC7w: folds
8ehL7qlZzjgUh2H35iiWLw: raises $1.50 to $2
j3K/Jujr7PY4ZM2RZvlH6A: raises $1.50 to $3.50
n6VQBu6crjYjy6DxNP1NZA: folds
qEn9ijNGtuyTxamBf07hYg: calls $3.25
bxLSulbgr8LmKNjOzw8URg: folds
8ehL7qlZzjgUh2H35iiWLw: calls $1.50
*** FLOP *** [Qc 9s 7h]
qEn9ijNGtuyTxamBf07hYg: checks
8ehL7qlZzjgUh2H35iiWLw: checks
j3K/Jujr7PY4ZM2RZvlH6A: bets $6.50
qEn9ijNGtuyTxamBf07hYg: folds
8ehL7qlZzjgUh2H35iiWLw: folds
j3K/Jujr7PY4ZM2RZvlH6A collected $10.45 from pot
j3K/Jujr7PY4ZM2RZvlH6A: doesn't show hand
*** SUMMARY ***
Total pot $11 | Rake $0.55
Board [Qc 9s 7h]
Seat 2: n6VQBu6crjYjy6DxNP1NZA (button) folded before Flop (didn't bet)
Seat 3: qEn9ijNGtuyTxamBf07hYg (small blind) folded on the Flop
Seat 4: bxLSulbgr8LmKNjOzw8URg (big blind) folded before Flop
Seat 5: DSM67hHHq1XFoEOi9p8Alw folded before Flop (didn't bet)
Seat 7: bfSq6LBw0UvxeM5yfuWC7w folded before Flop (didn't bet)
Seat 8: 8ehL7qlZzjgUh2H35iiWLw folded on the Flop
Seat 9: j3K/Jujr7PY4ZM2RZvlH6A collected ($10.45)



PokerStars Game #59939935474:  Hold'em No Limit ($0.25/$0.50) - 2009/07/01 0:52:51 ET
Table 'E7bWJ45aoFXRpyRv2gw+Ig' 2-max Seat #1 is the button
Seat 1: FRkiRasEGlHUeLrEl+k/nA ($106 in chips)
Seat 2: 3Wro85I7472vJ4Wkpneo9A ($86.85 in chips)
FRkiRasEGlHUeLrEl+k/nA: posts small blind $0.25
3Wro85I7472vJ4Wkpneo9A: posts big blind $0.50
*** HOLE CARDS ***
FRkiRasEGlHUeLrEl+k/nA: raises $1 to $1.50
3Wro85I7472vJ4Wkpneo9A: folds
FRkiRasEGlHUeLrEl+k/nA collected $1 from pot
*** SUMMARY ***
Total pot $1 | Rake $0
Seat 1: FRkiRasEGlHUeLrEl+k/nA (button) (small blind) collected ($1)
Seat 2: 3Wro85I7472vJ4Wkpneo9A (big blind) folded before Flop



PokerStars Game #59939937036:  Hold'em No Limit ($0.25/$0.50) - 2009/07/01 0:52:53 ET
Table 'c/CRn+68J3Y8KxD5g1ek2Q' 2-max Seat #2 is the button
Seat 1: 46qCyJ6evTkHo9al5sBMNA ($84.10 in chips)
Seat 2: BypVLsYQt3ePFm2xQL/dOA ($287.20 in chips)
BypVLsYQt3ePFm2xQL/dOA: posts small blind $0.25
46qCyJ6evTkHo9al5sBMNA: posts big blind $0.50
*** HOLE CARDS ***
BypVLsYQt3ePFm2xQL/dOA: calls $0.25
46qCyJ6evTkHo9al5sBMNA: checks
*** FLOP *** [6h 8c As]
46qCyJ6evTkHo9al5sBMNA: checks
BypVLsYQt3ePFm2xQL/dOA: checks
*** TURN *** [6h 8c As] [Js]
46qCyJ6evTkHo9al5sBMNA: checks
BypVLsYQt3ePFm2xQL/dOA: checks
*** RIVER *** [6h 8c As Js] [Jc]
46qCyJ6evTkHo9al5sBMNA: checks
BypVLsYQt3ePFm2xQL/dOA: checks
*** SHOW DOWN ***
46qCyJ6evTkHo9al5sBMNA: shows [7h Qd] (a pair of Jacks)
BypVLsYQt3ePFm2xQL/dOA: mucks hand
46qCyJ6evTkHo9al5sBMNA collected $0.95 from pot
*** SUMMARY ***
Total pot $1 | Rake $0.05
Board [6h 8c As Js Jc]
Seat 1: 46qCyJ6evTkHo9al5sBMNA (big blind) showed [7h Qd] and won ($0.95) with a pair of Jacks
Seat 2: BypVLsYQt3ePFm2xQL/dOA (button) (small blind) mucked



PokerStars Game #59939936722:  Hold'em No Limit ($0.25/$0.50) - 2009/07/01 0:52:53 ET
Table 'GfL/No5u5PoEnU39lP5pQg' 6-max Seat #5 is the button
Seat 1: 1WUCqNG+p+vfWRTXNu4ljw ($60.75 in chips)
Seat 2: uVwggSetzp7d+eVgowO3vg ($65.20 in chips)
Seat 3: Ek4w9XqBXqK5jBUQeLedGw ($51.25 in chips)
Seat 4: r6u7MWSXF30/khcTYkrG9Q ($24.65 in chips)
Seat 5: M1KyQQvVPVuxqTAB8sR/zQ ($51.50 in chips)
Seat 6: kxPhs4ePFqMy52CInAJ2aw ($50.25 in chips)
kxPhs4ePFqMy52CInAJ2aw: posts small blind $0.25
1WUCqNG+p+vfWRTXNu4ljw: posts big blind $0.50
*** HOLE CARDS ***
uVwggSetzp7d+eVgowO3vg: folds
Ek4w9XqBXqK5jBUQeLedGw: folds
r6u7MWSXF30/khcTYkrG9Q: folds
M1KyQQvVPVuxqTAB8sR/zQ has timed out
M1KyQQvVPVuxqTAB8sR/zQ: folds
M1KyQQvVPVuxqTAB8sR/zQ is sitting out
kxPhs4ePFqMy52CInAJ2aw: raises $1.50 to $2
1WUCqNG+p+vfWRTXNu4ljw: folds
kxPhs4ePFqMy52CInAJ2aw collected $1 from pot
kxPhs4ePFqMy52CInAJ2aw: doesn't show hand
*** SUMMARY ***
Total pot $1 | Rake $0
Seat 1: 1WUCqNG+p+vfWRTXNu4ljw (big blind) folded before Flop
Seat 2: uVwggSetzp7d+eVgowO3vg folded before Flop (didn't bet)
Seat 3: Ek4w9XqBXqK5jBUQeLedGw folded before Flop (didn't bet)
Seat 4: r6u7MWSXF30/khcTYkrG9Q folded before Flop (didn't bet)
Seat 5: M1KyQQvVPVuxqTAB8sR/zQ (button) folded before Flop (didn't bet)
Seat 6: kxPhs4ePFqMy52CInAJ2aw (small blind) collected ($1)



PokerStars Game #59939936626:  Hold'em No Limit ($0.25/$0.50) - 2009/07/01 0:52:53 ET
Table '37qXEp3oe+er5q4CZip9eQ' 6-max Seat #3 is the button
Seat 1: oqOqoO2AyCZenUghCxMDxw ($56.90 in chips)
Seat 2: 6wzJiRvp8HY6t+MQGnSIzA ($17.25 in chips)
Seat 3: Rt6KgtZ8YaJoTc3FPim00w ($103.30 in chips)
Seat 4: XsmE8nXMAAMFJbWaJTmHFw ($34.95 in chips)
Seat 5: VOmI0x4dDPnTESZd5B4d1Q ($43.65 in chips)
Seat 6: N50kln4negd8q7Mmoz1j4g ($19.30 in chips)
XsmE8nXMAAMFJbWaJTmHFw: posts small blind $0.25
VOmI0x4dDPnTESZd5B4d1Q: posts big blind $0.50
*** HOLE CARDS ***
N50kln4negd8q7Mmoz1j4g: folds
oqOqoO2AyCZenUghCxMDxw: raises $1 to $1.50
6wzJiRvp8HY6t+MQGnSIzA: folds
Rt6KgtZ8YaJoTc3FPim00w: folds
6wzJiRvp8HY6t+MQGnSIzA leaves the table
LvH4G7n+QSjT6NDaD3cREA joins the table at seat #2
XsmE8nXMAAMFJbWaJTmHFw has timed out
XsmE8nXMAAMFJbWaJTmHFw: folds
XsmE8nXMAAMFJbWaJTmHFw is sitting out
VOmI0x4dDPnTESZd5B4d1Q: calls $1
*** FLOP *** [Js Qd 3d]
VOmI0x4dDPnTESZd5B4d1Q: checks
oqOqoO2AyCZenUghCxMDxw: checks
*** TURN *** [Js Qd 3d] [Kc]
VOmI0x4dDPnTESZd5B4d1Q: checks
oqOqoO2AyCZenUghCxMDxw: checks
*** RIVER *** [Js Qd 3d Kc] [Ks]
VOmI0x4dDPnTESZd5B4d1Q: bets $3
oqOqoO2AyCZenUghCxMDxw: folds
VOmI0x4dDPnTESZd5B4d1Q collected $3.10 from pot
*** SUMMARY ***
Total pot $3.25 | Rake $0.15
Board [Js Qd 3d Kc Ks]
Seat 1: oqOqoO2AyCZenUghCxMDxw folded on the River
Seat 2: 6wzJiRvp8HY6t+MQGnSIzA folded before Flop (didn't bet)
Seat 3: Rt6KgtZ8YaJoTc3FPim00w (button) folded before Flop (didn't bet)
Seat 4: XsmE8nXMAAMFJbWaJTmHFw (small blind) folded before Flop
Seat 5: VOmI0x4dDPnTESZd5B4d1Q (big blind) collected ($3.10)
Seat 6: N50kln4negd8q7Mmoz1j4g folded before Flop (didn't bet)



PokerStars Game #59939938254:  Hold'em No Limit ($0.25/$0.50) - 2009/07/01 0:52:55 ET
Table '0eJtgVAXVvBgncFdcUpXcQ' 2-max Seat #1 is the button
Seat 1: Ag6DvxX4vbRheqsv2zXKTQ ($40.75 in chips)
Seat 2: KMc4R+K9ao4Ur3rF7NGe6Q ($10.90 in chips)
Ag6DvxX4vbRheqsv2zXKTQ: posts small blind $0.25
KMc4R+K9ao4Ur3rF7NGe6Q: posts big blind $0.50
*** HOLE CARDS ***
Ag6DvxX4vbRheqsv2zXKTQ: calls $0.25
KMc4R+K9ao4Ur3rF7NGe6Q: checks
*** FLOP *** [Qh 7c Js]
KMc4R+K9ao4Ur3rF7NGe6Q: checks
Ag6DvxX4vbRheqsv2zXKTQ: bets $1
KMc4R+K9ao4Ur3rF7NGe6Q: calls $1
*** TURN *** [Qh 7c Js] [9d]
KMc4R+K9ao4Ur3rF7NGe6Q: bets $1
Ag6DvxX4vbRheqsv2zXKTQ: calls $1
*** RIVER *** [Qh 7c Js 9d] [6d]
KMc4R+K9ao4Ur3rF7NGe6Q: checks
Ag6DvxX4vbRheqsv2zXKTQ: checks
*** SHOW DOWN ***
KMc4R+K9ao4Ur3rF7NGe6Q: shows [Tc 5c] (high card Queen)
Ag6DvxX4vbRheqsv2zXKTQ: shows [6s 8d] (a pair of Sixes)
Ag6DvxX4vbRheqsv2zXKTQ collected $4.80 from pot
*** SUMMARY ***
Total pot $5 | Rake $0.20
Board [Qh 7c Js 9d 6d]
Seat 1: Ag6DvxX4vbRheqsv2zXKTQ (button) (small blind) showed [6s 8d] and won ($4.80) with a pair of Sixes
Seat 2: KMc4R+K9ao4Ur3rF7NGe6Q (big blind) showed [Tc 5c] and lost with high card Queen



PokerStars Game #59939938094:  Hold'em No Limit ($0.25/$0.50) - 2009/07/01 0:52:55 ET
Table 'Nz0Vr7WMHL2g5Uk7dDZjpw' 9-max Seat #6 is the button
Seat 1: tLkxo7JgV+WWI0UBw44K5A ($109.85 in chips)
Seat 2: XNMDwbXt/Q4jM99AXnbJDw ($67.35 in chips)
Seat 3: uw9QayAAxLM3Hb+HR7mSkg ($10 in chips)
Seat 4: 75K2MXwN65Sjfp1yHd50Hg ($9.25 in chips)
Seat 5: WGW0DgjBUXs1ylURHG8vnQ ($27.50 in chips)
Seat 6: 997ViqAtWn1FPjJqcffwcA ($61.30 in chips)
Seat 7: KPLH0gELgFe2OuAnhJFI5w ($18.90 in chips)
Seat 8: HkZI6g4zl83TDTA7SRspmQ ($17.10 in chips)
Seat 9: mSD1pginDsyHG5PDfqzphw ($10 in chips)
KPLH0gELgFe2OuAnhJFI5w: posts small blind $0.25
HkZI6g4zl83TDTA7SRspmQ: posts big blind $0.50
*** HOLE CARDS ***
mSD1pginDsyHG5PDfqzphw: folds
tLkxo7JgV+WWI0UBw44K5A: folds
XNMDwbXt/Q4jM99AXnbJDw: folds
uw9QayAAxLM3Hb+HR7mSkg: folds
75K2MXwN65Sjfp1yHd50Hg: folds
WGW0DgjBUXs1ylURHG8vnQ: folds
997ViqAtWn1FPjJqcffwcA: folds
KPLH0gELgFe2OuAnhJFI5w: calls $0.25
HkZI6g4zl83TDTA7SRspmQ: checks
*** FLOP *** [Qd Qh 9h]
KPLH0gELgFe2OuAnhJFI5w: checks
HkZI6g4zl83TDTA7SRspmQ: checks
*** TURN *** [Qd Qh 9h] [7c]
KPLH0gELgFe2OuAnhJFI5w: checks
HkZI6g4zl83TDTA7SRspmQ: checks
*** RIVER *** [Qd Qh 9h 7c] [As]
KPLH0gELgFe2OuAnhJFI5w: checks
HkZI6g4zl83TDTA7SRspmQ: checks
*** SHOW DOWN ***
KPLH0gELgFe2OuAnhJFI5w: shows [Kd 2s] (a pair of Queens)
HkZI6g4zl83TDTA7SRspmQ: mucks hand
KPLH0gELgFe2OuAnhJFI5w collected $0.95 from pot
*** SUMMARY ***
Total pot $1 | Rake $0.05
Board [Qd Qh 9h 7c As]
Seat 1: tLkxo7JgV+WWI0UBw44K5A folded before Flop (didn't bet)
Seat 2: XNMDwbXt/Q4jM99AXnbJDw folded before Flop (didn't bet)
Seat 3: uw9QayAAxLM3Hb+HR7mSkg folded before Flop (didn't bet)
Seat 4: 75K2MXwN65Sjfp1yHd50Hg folded before Flop (didn't bet)
Seat 5: WGW0DgjBUXs1ylURHG8vnQ folded before Flop (didn't bet)
Seat 6: 997ViqAtWn1FPjJqcffwcA (button) folded before Flop (didn't bet)
Seat 7: KPLH0gELgFe2OuAnhJFI5w (small blind) showed [Kd 2s] and won ($0.95) with a pair of Queens
Seat 8: HkZI6g4zl83TDTA7SRspmQ (big blind) mucked
Seat 9: mSD1pginDsyHG5PDfqzphw folded before Flop (didn't bet)



PokerStars Game #59939938698:  Hold'em No Limit ($0.25/$0.50) - 2009/07/01 0:52:56 ET
Table '5EmHi+fnatGQQShcNmzOZQ' 6-max Seat #1 is the button
Seat 1: HGzUMAFxR1k8+S4gfnB39w ($33.90 in chips)
Seat 3: TjmTe3bhs9dFz5gXX9x7Lw ($26.75 in chips)
Seat 4: 1b+2BbjMN8qhR1WPqdE9VQ ($63.25 in chips)
Seat 5: kxPhs4ePFqMy52CInAJ2aw ($49.75 in chips)
Seat 6: 686aeHikcJlgKkSuIFdcXQ ($132.70 in chips)
TjmTe3bhs9dFz5gXX9x7Lw: posts small blind $0.25
1b+2BbjMN8qhR1WPqdE9VQ: posts big blind $0.50
*** HOLE CARDS ***
kxPhs4ePFqMy52CInAJ2aw: folds
686aeHikcJlgKkSuIFdcXQ: folds
HGzUMAFxR1k8+S4gfnB39w: calls $0.50
TjmTe3bhs9dFz5gXX9x7Lw: folds
1b+2BbjMN8qhR1WPqdE9VQ: checks
*** FLOP *** [Kh 8s Jh]
1b+2BbjMN8qhR1WPqdE9VQ: checks
HGzUMAFxR1k8+S4gfnB39w: bets $1
1b+2BbjMN8qhR1WPqdE9VQ: folds
HGzUMAFxR1k8+S4gfnB39w collected $1.20 from pot
*** SUMMARY ***
Total pot $1.25 | Rake $0.05
Board [Kh 8s Jh]
Seat 1: HGzUMAFxR1k8+S4gfnB39w (button) collected ($1.20)
Seat 3: TjmTe3bhs9dFz5gXX9x7Lw (small blind) folded before Flop
Seat 4: 1b+2BbjMN8qhR1WPqdE9VQ (big blind) folded on the Flop
Seat 5: kxPhs4ePFqMy52CInAJ2aw folded before Flop (didn't bet)
Seat 6: 686aeHikcJlgKkSuIFdcXQ folded before Flop (didn't bet)



PokerStars Game #59939940188:  Hold'em No Limit ($0.25/$0.50) - 2009/07/01 0:52:58 ET
Table '+dXkOAQyS8j9PQZusUTMpg' 2-max Seat #1 is the button
Seat 1: XFa6sBGjP2gxoIvxR3fZIg ($62.50 in chips)
Seat 2: 5IBeOgaApY1Bvzv2P8X4EA ($139 in chips)
XFa6sBGjP2gxoIvxR3fZIg: posts small blind $0.25
5IBeOgaApY1Bvzv2P8X4EA: posts big blind $0.50
*** HOLE CARDS ***
XFa6sBGjP2gxoIvxR3fZIg: raises $1 to $1.50
5IBeOgaApY1Bvzv2P8X4EA: calls $1
*** FLOP *** [3d Tc 8c]
5IBeOgaApY1Bvzv2P8X4EA: checks
XFa6sBGjP2gxoIvxR3fZIg: checks
*** TURN *** [3d Tc 8c] [8h]
5IBeOgaApY1Bvzv2P8X4EA: bets $1
XFa6sBGjP2gxoIvxR3fZIg: folds
5IBeOgaApY1Bvzv2P8X4EA collected $2.85 from pot
5IBeOgaApY1Bvzv2P8X4EA: doesn't show hand
*** SUMMARY ***
Total pot $3 | Rake $0.15
Board [3d Tc 8c 8h]
Seat 1: XFa6sBGjP2gxoIvxR3fZIg (button) (small blind) folded on the Turn
Seat 2: 5IBeOgaApY1Bvzv2P8X4EA (big blind) collected ($2.85)



PokerStars Game #59939940494:  Hold'em No Limit ($0.25/$0.50) - 2009/07/01 0:52:59 ET
Table 'E7bWJ45aoFXRpyRv2gw+Ig' 2-max Seat #2 is the button
Seat 1: FRkiRasEGlHUeLrEl+k/nA ($106.50 in chips)
Seat 2: 3Wro85I7472vJ4Wkpneo9A ($86.35 in chips)
3Wro85I7472vJ4Wkpneo9A: posts small blind $0.25
FRkiRasEGlHUeLrEl+k/nA: posts big blind $0.50
*** HOLE CARDS ***
3Wro85I7472vJ4Wkpneo9A: raises $1 to $1.50
FRkiRasEGlHUeLrEl+k/nA: calls $1
*** FLOP *** [Jh 9h Kh]
FRkiRasEGlHUeLrEl+k/nA: checks
3Wro85I7472vJ4Wkpneo9A: bets $2
FRkiRasEGlHUeLrEl+k/nA: folds
3Wro85I7472vJ4Wkpneo9A collected $2.85 from pot
3Wro85I7472vJ4Wkpneo9A: doesn't show hand
*** SUMMARY ***
Total pot $3 | Rake $0.15
Board [Jh 9h Kh]
Seat 1: FRkiRasEGlHUeLrEl+k/nA (big blind) folded on the Flop
Seat 2: 3Wro85I7472vJ4Wkpneo9A (button) (small blind) collected ($2.85)



PokerStars Game #59939940710:  Hold'em No Limit ($0.25/$0.50) - 2009/07/01 0:52:59 ET
Table 'B+sqsfj6d6zXicNfaseTaw' 2-max Seat #1 is the button
Seat 1: +4GNcSsecmapVGSdV0mUPA ($71.95 in chips)
Seat 2: Lv5RmpRe6LtPkBzM9Gpo5A ($61.80 in chips)
+4GNcSsecmapVGSdV0mUPA: posts small blind $0.25
Lv5RmpRe6LtPkBzM9Gpo5A: posts big blind $0.50
*** HOLE CARDS ***
+4GNcSsecmapVGSdV0mUPA: raises $1.50 to $2
Lv5RmpRe6LtPkBzM9Gpo5A: calls $1.50
*** FLOP *** [9s Qd 3h]
Lv5RmpRe6LtPkBzM9Gpo5A: checks
+4GNcSsecmapVGSdV0mUPA: bets $2
Lv5RmpRe6LtPkBzM9Gpo5A: calls $2
*** TURN *** [9s Qd 3h] [Qc]
Lv5RmpRe6LtPkBzM9Gpo5A: checks
+4GNcSsecmapVGSdV0mUPA: bets $3
Lv5RmpRe6LtPkBzM9Gpo5A: calls $3
*** RIVER *** [9s Qd 3h Qc] [3s]
Lv5RmpRe6LtPkBzM9Gpo5A: checks
+4GNcSsecmapVGSdV0mUPA: bets $15
Lv5RmpRe6LtPkBzM9Gpo5A: raises $39.80 to $54.80 and is all-in
+4GNcSsecmapVGSdV0mUPA: calls $39.80
*** SHOW DOWN ***
Lv5RmpRe6LtPkBzM9Gpo5A: shows [Js Kh] (two pair, Queens and Threes)
+4GNcSsecmapVGSdV0mUPA: shows [Qs As] (a full house, Queens full of Threes)
+4GNcSsecmapVGSdV0mUPA collected $123.10 from pot
*** SUMMARY ***
Total pot $123.60 | Rake $0.50
Board [9s Qd 3h Qc 3s]
Seat 1: +4GNcSsecmapVGSdV0mUPA (button) (small blind) showed [Qs As] and won ($123.10) with a full house, Queens full of Threes
Seat 2: Lv5RmpRe6LtPkBzM9Gpo5A (big blind) showed [Js Kh] and lost with two pair, Queens and Threes



PokerStars Game #59939942058:  Hold'em No Limit ($0.25/$0.50) - 2009/07/01 0:53:01 ET
Table 'lpxYasB1ClBSgTpCCITwhQ' 9-max Seat #7 is the button
Seat 1: mj7PS7wCH4PAl7+eYTFs7A ($47.15 in chips)
Seat 2: OWP/DOu+PlPK6ZZ3zYa0HA ($24.85 in chips)
Seat 3: cDNz32Scry3j+v2+kE3pHg ($50 in chips)
Seat 5: IYd5zG8k7vdBNVHbHg2Pag ($38.10 in chips)
Seat 6: SegjDnMxWMujiD57ESNL+g ($6.25 in chips)
Seat 7: bmRtaIYKthN1F+B3JLZ3Jw ($27.90 in chips)
Seat 9: XNMDwbXt/Q4jM99AXnbJDw ($50 in chips)
V+ivdLiYYuNr+thEXNextg: is sitting out
V+ivdLiYYuNr+thEXNextg leaves the table
XNMDwbXt/Q4jM99AXnbJDw: posts small blind $0.25
mj7PS7wCH4PAl7+eYTFs7A: posts big blind $0.50
NnQCepdIR/AOUQn1yhYx6Q: sits out
*** HOLE CARDS ***
OWP/DOu+PlPK6ZZ3zYa0HA: folds
cDNz32Scry3j+v2+kE3pHg: folds
IYd5zG8k7vdBNVHbHg2Pag: folds
SegjDnMxWMujiD57ESNL+g: folds
/mfensKw8/iZ1Vrx33S4xg joins the table at seat #8
bmRtaIYKthN1F+B3JLZ3Jw: folds
XNMDwbXt/Q4jM99AXnbJDw: raises $1 to $1.50
mj7PS7wCH4PAl7+eYTFs7A: folds
XNMDwbXt/Q4jM99AXnbJDw collected $1 from pot
XNMDwbXt/Q4jM99AXnbJDw: doesn't show hand
*** SUMMARY ***
Total pot $1 | Rake $0
Seat 1: mj7PS7wCH4PAl7+eYTFs7A (big blind) folded before Flop
Seat 2: OWP/DOu+PlPK6ZZ3zYa0HA folded before Flop (didn't bet)
Seat 3: cDNz32Scry3j+v2+kE3pHg folded before Flop (didn't bet)
Seat 5: IYd5zG8k7vdBNVHbHg2Pag folded before Flop (didn't bet)
Seat 6: SegjDnMxWMujiD57ESNL+g folded before Flop (didn't bet)
Seat 7: bmRtaIYKthN1F+B3JLZ3Jw (button) folded before Flop (didn't bet)
Seat 9: XNMDwbXt/Q4jM99AXnbJDw (small blind) collected ($1)



PokerStars Game #59939943192:  Hold'em No Limit ($0.25/$0.50) - 2009/07/01 0:53:03 ET
Table 'NHLx+ggeIlZy3D6oDgC0yg' 2-max Seat #2 is the button
Seat 1: Fp/oksNpipCrD2MJ2pH20g ($11.75 in chips)
Seat 2: DHMk3is1XNc/OjPVB8NJ5w ($50.40 in chips)
DHMk3is1XNc/OjPVB8NJ5w: posts small blind $0.25
Fp/oksNpipCrD2MJ2pH20g: posts big blind $0.50
*** HOLE CARDS ***
DHMk3is1XNc/OjPVB8NJ5w: calls $0.25
Fp/oksNpipCrD2MJ2pH20g: raises $1 to $1.50
DHMk3is1XNc/OjPVB8NJ5w: calls $1
*** FLOP *** [Th 4h Ts]
Fp/oksNpipCrD2MJ2pH20g: bets $2
DHMk3is1XNc/OjPVB8NJ5w: raises $22 to $24
Fp/oksNpipCrD2MJ2pH20g: calls $8.25 and is all-in
*** TURN *** [Th 4h Ts] [8s]
*** RIVER *** [Th 4h Ts 8s] [As]
*** SHOW DOWN ***
Fp/oksNpipCrD2MJ2pH20g: shows [Kc Kd] (two pair, Kings and Tens)
DHMk3is1XNc/OjPVB8NJ5w: mucks hand
Fp/oksNpipCrD2MJ2pH20g collected $23 from pot
*** SUMMARY ***
Total pot $23.50 | Rake $0.50
Board [Th 4h Ts 8s As]
Seat 1: Fp/oksNpipCrD2MJ2pH20g (big blind) showed [Kc Kd] and won ($23) with two pair, Kings and Tens
Seat 2: DHMk3is1XNc/OjPVB8NJ5w (button) (small blind) mucked



PokerStars Game #59939943190:  Hold'em No Limit ($0.25/$0.50) - 2009/07/01 0:53:03 ET
Table '8BQGgNetI1NOvWeu3gtMNw' 2-max Seat #2 is the button
Seat 1: bypIyrYcAAifLfhZpGlKLA ($50 in chips)
Seat 2: Z4HwehErEwzsv/noQlfUlg ($67.70 in chips)
Z4HwehErEwzsv/noQlfUlg: posts small blind $0.25
bypIyrYcAAifLfhZpGlKLA: posts big blind $0.50
*** HOLE CARDS ***
Z4HwehErEwzsv/noQlfUlg: raises $2.50 to $3
bypIyrYcAAifLfhZpGlKLA: raises $4 to $7
Z4HwehErEwzsv/noQlfUlg: raises $5 to $12
bypIyrYcAAifLfhZpGlKLA: calls $5
*** FLOP *** [Jh Td 9h]
bypIyrYcAAifLfhZpGlKLA: checks
Z4HwehErEwzsv/noQlfUlg: checks
*** TURN *** [Jh Td 9h] [Js]
bypIyrYcAAifLfhZpGlKLA: checks
Z4HwehErEwzsv/noQlfUlg: bets $23
bypIyrYcAAifLfhZpGlKLA: raises $15 to $38 and is all-in
Z4HwehErEwzsv/noQlfUlg: calls $15
*** RIVER *** [Jh Td 9h Js] [7h]
*** SHOW DOWN ***
bypIyrYcAAifLfhZpGlKLA: shows [Kd Kc] (two pair, Kings and Jacks)
Z4HwehErEwzsv/noQlfUlg: shows [9d 9c] (a full house, Nines full of Jacks)
Z4HwehErEwzsv/noQlfUlg collected $99.50 from pot
*** SUMMARY ***
Total pot $100 | Rake $0.50
Board [Jh Td 9h Js 7h]
Seat 1: bypIyrYcAAifLfhZpGlKLA (big blind) showed [Kd Kc] and lost with two pair, Kings and Jacks
Seat 2: Z4HwehErEwzsv/noQlfUlg (button) (small blind) showed [9d 9c] and won ($99.50) with a full house, Nines full of Jacks



PokerStars Game #59939943204:  Hold'em No Limit ($0.25/$0.50) - 2009/07/01 0:53:03 ET
Table 'otvGDROEDdqsabxskT79qg' 9-max Seat #2 is the button
Seat 1: 8ehL7qlZzjgUh2H35iiWLw ($54.50 in chips)
Seat 2: cCjTzH9jio8607WzjcfXlg ($14.30 in chips)
Seat 3: +k7T5ocke8UwavtgUHm+Cg ($67 in chips)
Seat 4: MG90wfSJZnOejs/KD3vlQQ ($69.95 in chips)
Seat 5: XNMDwbXt/Q4jM99AXnbJDw ($52.55 in chips)
Seat 6: bxLSulbgr8LmKNjOzw8URg ($53.70 in chips)
Seat 7: C7+tBppJrKgd/r+tuKUIpA ($35.80 in chips)
Seat 8: zE9cVigS2nW/Ljy4K4bUQA ($30 in chips)
Seat 9: KcY3X8YpD74Kw1RHkx/g4A ($57.90 in chips)
+k7T5ocke8UwavtgUHm+Cg: posts small blind $0.25
MG90wfSJZnOejs/KD3vlQQ: posts big blind $0.50
*** HOLE CARDS ***
XNMDwbXt/Q4jM99AXnbJDw: folds
bxLSulbgr8LmKNjOzw8URg: folds
C7+tBppJrKgd/r+tuKUIpA: folds
zE9cVigS2nW/Ljy4K4bUQA: folds
KcY3X8YpD74Kw1RHkx/g4A: folds
8ehL7qlZzjgUh2H35iiWLw: folds
cCjTzH9jio8607WzjcfXlg: folds
+k7T5ocke8UwavtgUHm+Cg: calls $0.25
MG90wfSJZnOejs/KD3vlQQ: raises $1.25 to $1.75
+k7T5ocke8UwavtgUHm+Cg: folds
MG90wfSJZnOejs/KD3vlQQ collected $1 from pot
MG90wfSJZnOejs/KD3vlQQ: doesn't show hand
*** SUMMARY ***
Total pot $1 | Rake $0
Seat 1: 8ehL7qlZzjgUh2H35iiWLw folded before Flop (didn't bet)
Seat 2: cCjTzH9jio8607WzjcfXlg (button) folded before Flop (didn't bet)
Seat 3: +k7T5ocke8UwavtgUHm+Cg (small blind) folded before Flop
Seat 4: MG90wfSJZnOejs/KD3vlQQ (big blind) collected ($1)
Seat 5: XNMDwbXt/Q4jM99AXnbJDw folded before Flop (didn't bet)
Seat 6: bxLSulbgr8LmKNjOzw8URg folded before Flop (didn't bet)
Seat 7: C7+tBppJrKgd/r+tuKUIpA folded before Flop (didn't bet)
Seat 8: zE9cVigS2nW/Ljy4K4bUQA folded before Flop (didn't bet)
Seat 9: KcY3X8YpD74Kw1RHkx/g4A folded before Flop (didn't bet)



PokerStars Game #59939943494:  Hold'em No Limit ($0.25/$0.50) - 2009/07/01 0:53:04 ET
Table 'kgbJRsxfv64KrErDRBAkcw' 6-max Seat #3 is the button
Seat 1: w2dj3tZyWCX7+wEKRi0AVw ($15.85 in chips)
Seat 2: AdS8BJMOheS01zjCDfPMFg ($49.25 in chips)
Seat 3: c4MNIaIyPMOMxrgT8FT5nA ($133.15 in chips)
Seat 4: qanMEqjABjWxC/JgQ/0l7w ($50 in chips)
Seat 5: eUBBn2R56C1IQ6Cs/vitwg ($50 in chips)
qanMEqjABjWxC/JgQ/0l7w: posts small blind $0.25
eUBBn2R56C1IQ6Cs/vitwg: posts big blind $0.50
1b+2BbjMN8qhR1WPqdE9VQ: sits out
*** HOLE CARDS ***
w2dj3tZyWCX7+wEKRi0AVw: calls $0.50
AdS8BJMOheS01zjCDfPMFg: raises $1.50 to $2
c4MNIaIyPMOMxrgT8FT5nA: folds
qanMEqjABjWxC/JgQ/0l7w: folds
eUBBn2R56C1IQ6Cs/vitwg: folds
w2dj3tZyWCX7+wEKRi0AVw: folds
AdS8BJMOheS01zjCDfPMFg collected $1.75 from pot
*** SUMMARY ***
Total pot $1.75 | Rake $0
Seat 1: w2dj3tZyWCX7+wEKRi0AVw folded before Flop
Seat 2: AdS8BJMOheS01zjCDfPMFg collected ($1.75)
Seat 3: c4MNIaIyPMOMxrgT8FT5nA (button) folded before Flop (didn't bet)
Seat 4: qanMEqjABjWxC/JgQ/0l7w (small blind) folded before Flop
Seat 5: eUBBn2R56C1IQ6Cs/vitwg (big blind) folded before Flop



PokerStars Game #59939946436:  Hold'em No Limit ($0.25/$0.50) - 2009/07/01 0:53:08 ET
Table 'EiNh8p/wGJ1FP575iMFnqg' 9-max Seat #9 is the button
Seat 1: r3ZqM1Mi0W3y4hOdssE+Sg ($45.35 in chips)
Seat 2: 8ehL7qlZzjgUh2H35iiWLw ($52.60 in chips)
Seat 3: ymLPoEIl7UL3TvZYmnadxQ ($50.85 in chips)
Seat 4: cMzaiXAM/ZAdNaEUu+LqhA ($55.70 in chips)
Seat 5: M+7+BTmX5vZatHVuoRB1nA ($82.20 in chips)
Seat 6: 3UmXLy3GfjC3EkOebduerQ ($65.35 in chips)
Seat 7: 997ViqAtWn1FPjJqcffwcA ($50 in chips)
Seat 8: mSD1pginDsyHG5PDfqzphw ($10 in chips)
Seat 9: NnQCepdIR/AOUQn1yhYx6Q ($10 in chips)
r3ZqM1Mi0W3y4hOdssE+Sg: posts small blind $0.25
8ehL7qlZzjgUh2H35iiWLw: posts big blind $0.50
*** HOLE CARDS ***
ymLPoEIl7UL3TvZYmnadxQ: calls $0.50
cMzaiXAM/ZAdNaEUu+LqhA: folds
M+7+BTmX5vZatHVuoRB1nA: folds
3UmXLy3GfjC3EkOebduerQ: folds
997ViqAtWn1FPjJqcffwcA: folds
mSD1pginDsyHG5PDfqzphw: folds
NnQCepdIR/AOUQn1yhYx6Q: folds
r3ZqM1Mi0W3y4hOdssE+Sg: calls $0.25
8ehL7qlZzjgUh2H35iiWLw: checks
*** FLOP *** [9d 7d 6s]
r3ZqM1Mi0W3y4hOdssE+Sg: checks
8ehL7qlZzjgUh2H35iiWLw: checks
ymLPoEIl7UL3TvZYmnadxQ: checks
*** TURN *** [9d 7d 6s] [8c]
r3ZqM1Mi0W3y4hOdssE+Sg: checks
8ehL7qlZzjgUh2H35iiWLw: checks
ymLPoEIl7UL3TvZYmnadxQ: bets $1
r3ZqM1Mi0W3y4hOdssE+Sg: folds
8ehL7qlZzjgUh2H35iiWLw: folds
ymLPoEIl7UL3TvZYmnadxQ collected $1.45 from pot
ymLPoEIl7UL3TvZYmnadxQ: doesn't show hand
*** SUMMARY ***
Total pot $1.50 | Rake $0.05
Board [9d 7d 6s 8c]
Seat 1: r3ZqM1Mi0W3y4hOdssE+Sg (small blind) folded on the Turn
Seat 2: 8ehL7qlZzjgUh2H35iiWLw (big blind) folded on the Turn
Seat 3: ymLPoEIl7UL3TvZYmnadxQ collected ($1.45)
Seat 4: cMzaiXAM/ZAdNaEUu+LqhA folded before Flop (didn't bet)
Seat 5: M+7+BTmX5vZatHVuoRB1nA folded before Flop (didn't bet)
Seat 6: 3UmXLy3GfjC3EkOebduerQ folded before Flop (didn't bet)
Seat 7: 997ViqAtWn1FPjJqcffwcA folded before Flop (didn't bet)
Seat 8: mSD1pginDsyHG5PDfqzphw folded before Flop (didn't bet)
Seat 9: NnQCepdIR/AOUQn1yhYx6Q (button) folded before Flop (didn't bet)



PokerStars Game #59939946936:  Hold'em No Limit ($0.25/$0.50) - 2009/07/01 0:53:09 ET
Table 'BCN5su+SsXiy1zRMJi0SJw' 6-max Seat #6 is the button
Seat 1: GxXV09ciXaOxyY2H5aMIIw ($28.85 in chips)
Seat 2: oU2kDCkT/gilYbHWrg7D8w ($19.25 in chips)
Seat 5: IBNygaT1aa9Z1uPdJJilwA ($25.80 in chips)
Seat 6: b2symlOdL7+0c9Pj4N/KlA ($82.95 in chips)
GxXV09ciXaOxyY2H5aMIIw: posts small blind $0.25
oU2kDCkT/gilYbHWrg7D8w: posts big blind $0.50
*** HOLE CARDS ***
IBNygaT1aa9Z1uPdJJilwA: folds
b2symlOdL7+0c9Pj4N/KlA: folds
GxXV09ciXaOxyY2H5aMIIw: folds
oU2kDCkT/gilYbHWrg7D8w collected $0.50 from pot
*** SUMMARY ***
Total pot $0.50 | Rake $0
Seat 1: GxXV09ciXaOxyY2H5aMIIw (small blind) folded before Flop
Seat 2: oU2kDCkT/gilYbHWrg7D8w (big blind) collected ($0.50)
Seat 5: IBNygaT1aa9Z1uPdJJilwA folded before Flop (didn't bet)
Seat 6: b2symlOdL7+0c9Pj4N/KlA (button) folded before Flop (didn't bet)



PokerStars Game #59939947608:  Hold'em No Limit ($0.25/$0.50) - 2009/07/01 0:53:10 ET
Table 'T/PgNWqVyY6lkldcBVXYJQ' 6-max Seat #1 is the button
Seat 1: +Pf9jTVizYlIo+woPvptfA ($76.25 in chips)
Seat 3: L3OcNO1bgdqDI46j67KQPQ ($50.25 in chips)
Seat 4: Ek4w9XqBXqK5jBUQeLedGw ($50 in chips)
Seat 5: of9mtXiD8G4Nx5p7hCbgqQ ($53.25 in chips)
Seat 6: khHFhne53qR5U3ky0T78jw ($8.25 in chips)
L3OcNO1bgdqDI46j67KQPQ: posts small blind $0.25
Ek4w9XqBXqK5jBUQeLedGw: posts big blind $0.50
*** HOLE CARDS ***
of9mtXiD8G4Nx5p7hCbgqQ: folds
khHFhne53qR5U3ky0T78jw: calls $0.50
of9mtXiD8G4Nx5p7hCbgqQ leaves the table
+Pf9jTVizYlIo+woPvptfA: folds
L3OcNO1bgdqDI46j67KQPQ: folds
+Pf9jTVizYlIo+woPvptfA leaves the table
Ek4w9XqBXqK5jBUQeLedGw: checks
*** FLOP *** [5s 8h Th]
Ek4w9XqBXqK5jBUQeLedGw: bets $2
khHFhne53qR5U3ky0T78jw: calls $2
*** TURN *** [5s 8h Th] [7d]
Ek4w9XqBXqK5jBUQeLedGw: bets $5
khHFhne53qR5U3ky0T78jw: raises $0.75 to $5.75 and is all-in
Ek4w9XqBXqK5jBUQeLedGw: calls $0.75
*** RIVER *** [5s 8h Th 7d] [Ad]
*** SHOW DOWN ***
Ek4w9XqBXqK5jBUQeLedGw: shows [3h 6h] (high card Ace)
khHFhne53qR5U3ky0T78jw: shows [4h Ah] (a pair of Aces)
khHFhne53qR5U3ky0T78jw collected $15.95 from pot
*** SUMMARY ***
Total pot $16.75 | Rake $0.80
Board [5s 8h Th 7d Ad]
Seat 1: +Pf9jTVizYlIo+woPvptfA (button) folded before Flop (didn't bet)
Seat 3: L3OcNO1bgdqDI46j67KQPQ (small blind) folded before Flop
Seat 4: Ek4w9XqBXqK5jBUQeLedGw (big blind) showed [3h 6h] and lost with high card Ace
Seat 5: of9mtXiD8G4Nx5p7hCbgqQ folded before Flop (didn't bet)
Seat 6: khHFhne53qR5U3ky0T78jw showed [4h Ah] and won ($15.95) with a pair of Aces



PokerStars Game #59939950126:  Hold'em No Limit ($0.25/$0.50) - 2009/07/01 0:53:14 ET
Table '/cQuAT3ef4t+PGrXiNhGaQ' 9-max Seat #1 is the button
Seat 1: HZkVla4kK2SI42CVrPZ/ig ($14.75 in chips)
Seat 2: jXGruyaMqirTaTXNOvBdew ($72.70 in chips)
Seat 3: g4k0NXISyLCqaSWZDBjfEg ($55.25 in chips)
Seat 4: OWP/DOu+PlPK6ZZ3zYa0HA ($26.40 in chips)
Seat 5: 5SgaHdWixdClWvaEG+KUjQ ($24.10 in chips)
Seat 6: APYIOyK/4AGb+kIwlOUNBQ ($37.25 in chips)
Seat 7: J0W5D97jl5VLky+IoPvDeA ($111.40 in chips)
Seat 8: eBrej2jnlUCs/JgxFCRn2g ($40 in chips)
Seat 9: AjV5McH1KMMclY26QdLM5w ($26.45 in chips)
jXGruyaMqirTaTXNOvBdew: posts small blind $0.25
g4k0NXISyLCqaSWZDBjfEg: posts big blind $0.50
*** HOLE CARDS ***
OWP/DOu+PlPK6ZZ3zYa0HA: folds
5SgaHdWixdClWvaEG+KUjQ: folds
APYIOyK/4AGb+kIwlOUNBQ: folds
J0W5D97jl5VLky+IoPvDeA: folds
eBrej2jnlUCs/JgxFCRn2g: folds
AjV5McH1KMMclY26QdLM5w: folds
HZkVla4kK2SI42CVrPZ/ig: raises $1 to $1.50
jXGruyaMqirTaTXNOvBdew: folds
g4k0NXISyLCqaSWZDBjfEg: folds
HZkVla4kK2SI42CVrPZ/ig collected $1.25 from pot
*** SUMMARY ***
Total pot $1.25 | Rake $0
Seat 1: HZkVla4kK2SI42CVrPZ/ig (button) collected ($1.25)
Seat 2: jXGruyaMqirTaTXNOvBdew (small blind) folded before Flop
Seat 3: g4k0NXISyLCqaSWZDBjfEg (big blind) folded before Flop
Seat 4: OWP/DOu+PlPK6ZZ3zYa0HA folded before Flop (didn't bet)
Seat 5: 5SgaHdWixdClWvaEG+KUjQ folded before Flop (didn't bet)
Seat 6: APYIOyK/4AGb+kIwlOUNBQ folded before Flop (didn't bet)
Seat 7: J0W5D97jl5VLky+IoPvDeA folded before Flop (didn't bet)
Seat 8: eBrej2jnlUCs/JgxFCRn2g folded before Flop (didn't bet)
Seat 9: AjV5McH1KMMclY26QdLM5w folded before Flop (didn't bet)



PokerStars Game #59939950098:  Hold'em No Limit ($0.25/$0.50) - 2009/07/01 0:53:14 ET
Table '+dXkOAQyS8j9PQZusUTMpg' 2-max Seat #2 is the button
Seat 1: XFa6sBGjP2gxoIvxR3fZIg ($61 in chips)
Seat 2: 5IBeOgaApY1Bvzv2P8X4EA ($140.35 in chips)
5IBeOgaApY1Bvzv2P8X4EA: posts small blind $0.25
XFa6sBGjP2gxoIvxR3fZIg: posts big blind $0.50
*** HOLE CARDS ***
5IBeOgaApY1Bvzv2P8X4EA: folds
XFa6sBGjP2gxoIvxR3fZIg collected $0.50 from pot
*** SUMMARY ***
Total pot $0.50 | Rake $0
Seat 1: XFa6sBGjP2gxoIvxR3fZIg (big blind) collected ($0.50)
Seat 2: 5IBeOgaApY1Bvzv2P8X4EA (button) (small blind) folded before Flop



PokerStars Game #59939950938:  Hold'em No Limit ($0.25/$0.50) - 2009/07/01 0:53:15 ET
Table '3FhG0gl3kMX3wBEEqj+wnQ' 9-max Seat #6 is the button
Seat 1: e0J9pdCNUDTCG031RnXqLA ($31.30 in chips)
Seat 2: 7cYQ+syUWjl38ty/ICOMhw ($45.40 in chips)
Seat 5: gsyXT42WLEcOS4DdEk2wlw ($33.20 in chips)
Seat 6: 997ViqAtWn1FPjJqcffwcA ($50 in chips)
Seat 7: mSD1pginDsyHG5PDfqzphw ($10 in chips)
Seat 8: j3K/Jujr7PY4ZM2RZvlH6A ($60.95 in chips)
Seat 9: L5e2lrPLQm1Pqx30IIZ/Fw ($13.90 in chips)
mSD1pginDsyHG5PDfqzphw: posts small blind $0.25
j3K/Jujr7PY4ZM2RZvlH6A: posts big blind $0.50
Min9: sits out
KingDonation: sits out
*** HOLE CARDS ***
L5e2lrPLQm1Pqx30IIZ/Fw: folds
e0J9pdCNUDTCG031RnXqLA: folds
7cYQ+syUWjl38ty/ICOMhw: calls $0.50
gsyXT42WLEcOS4DdEk2wlw: folds
997ViqAtWn1FPjJqcffwcA: folds
mSD1pginDsyHG5PDfqzphw: folds
j3K/Jujr7PY4ZM2RZvlH6A: checks
*** FLOP *** [3s 7s Jd]
j3K/Jujr7PY4ZM2RZvlH6A: checks
7cYQ+syUWjl38ty/ICOMhw: bets $1
j3K/Jujr7PY4ZM2RZvlH6A: folds
7cYQ+syUWjl38ty/ICOMhw collected $1.20 from pot
*** SUMMARY ***
Total pot $1.25 | Rake $0.05
Board [3s 7s Jd]
Seat 1: e0J9pdCNUDTCG031RnXqLA folded before Flop (didn't bet)
Seat 2: 7cYQ+syUWjl38ty/ICOMhw collected ($1.20)
Seat 5: gsyXT42WLEcOS4DdEk2wlw folded before Flop (didn't bet)
Seat 6: 997ViqAtWn1FPjJqcffwcA (button) folded before Flop (didn't bet)
Seat 7: mSD1pginDsyHG5PDfqzphw (small blind) folded before Flop
Seat 8: j3K/Jujr7PY4ZM2RZvlH6A (big blind) folded on the Flop
Seat 9: L5e2lrPLQm1Pqx30IIZ/Fw folded before Flop (didn't bet)



PokerStars Game #59939951342:  Hold'em No Limit ($0.25/$0.50) - 2009/07/01 0:53:16 ET
Table 'MJxeZCzYELxiIsyUZyT0jw' 6-max Seat #4 is the button
Seat 2: t3GiVMzqA9Svgr5Uol32cQ ($37.10 in chips)
Seat 3: JQZew0FjzS19kTjeNtrE+A ($61.30 in chips)
Seat 4: alGiiQP/wwtYnfuXII+sgw ($48.60 in chips)
Seat 5: 3jvoOXNtXE90w2BdfNZwZQ ($50.25 in chips)
Seat 6: TTx3CHxyi0SObcHyMJRp5w ($50.80 in chips)
3jvoOXNtXE90w2BdfNZwZQ: posts small blind $0.25
TTx3CHxyi0SObcHyMJRp5w: posts big blind $0.50
+Pf9jTVizYlIo+woPvptfA: sits out
*** HOLE CARDS ***
t3GiVMzqA9Svgr5Uol32cQ: raises $0.50 to $1
JQZew0FjzS19kTjeNtrE+A: calls $1
alGiiQP/wwtYnfuXII+sgw: folds
3jvoOXNtXE90w2BdfNZwZQ: folds
TTx3CHxyi0SObcHyMJRp5w: folds
*** FLOP *** [3h Kh 5d]
t3GiVMzqA9Svgr5Uol32cQ: checks
JQZew0FjzS19kTjeNtrE+A: checks
*** TURN *** [3h Kh 5d] [9s]
t3GiVMzqA9Svgr5Uol32cQ: checks
JQZew0FjzS19kTjeNtrE+A: checks
*** RIVER *** [3h Kh 5d 9s] [7c]
t3GiVMzqA9Svgr5Uol32cQ: checks
JQZew0FjzS19kTjeNtrE+A: bets $2.50
t3GiVMzqA9Svgr5Uol32cQ: folds
JQZew0FjzS19kTjeNtrE+A collected $2.65 from pot
*** SUMMARY ***
Total pot $2.75 | Rake $0.10
Board [3h Kh 5d 9s 7c]
Seat 2: t3GiVMzqA9Svgr5Uol32cQ folded on the River
Seat 3: JQZew0FjzS19kTjeNtrE+A collected ($2.65)
Seat 4: alGiiQP/wwtYnfuXII+sgw (button) folded before Flop (didn't bet)
Seat 5: 3jvoOXNtXE90w2BdfNZwZQ (small blind) folded before Flop
Seat 6: TTx3CHxyi0SObcHyMJRp5w (big blind) folded before Flop



PokerStars Game #59939952586:  Hold'em No Limit ($0.25/$0.50) - 2009/07/01 0:53:18 ET
Table 'E7bWJ45aoFXRpyRv2gw+Ig' 2-max Seat #1 is the button
Seat 1: FRkiRasEGlHUeLrEl+k/nA ($105 in chips)
Seat 2: 3Wro85I7472vJ4Wkpneo9A ($87.70 in chips)
FRkiRasEGlHUeLrEl+k/nA: posts small blind $0.25
3Wro85I7472vJ4Wkpneo9A: posts big blind $0.50
*** HOLE CARDS ***
FRkiRasEGlHUeLrEl+k/nA: calls $0.25
3Wro85I7472vJ4Wkpneo9A: raises $1.50 to $2
FRkiRasEGlHUeLrEl+k/nA: calls $1.50
*** FLOP *** [2c 5h Th]
3Wro85I7472vJ4Wkpneo9A: bets $3
FRkiRasEGlHUeLrEl+k/nA: calls $3
*** TURN *** [2c 5h Th] [Jc]
3Wro85I7472vJ4Wkpneo9A: bets $7
FRkiRasEGlHUeLrEl+k/nA: calls $7
*** RIVER *** [2c 5h Th Jc] [4s]
3Wro85I7472vJ4Wkpneo9A: checks
FRkiRasEGlHUeLrEl+k/nA: bets $12
3Wro85I7472vJ4Wkpneo9A: folds
FRkiRasEGlHUeLrEl+k/nA collected $23.50 from pot
FRkiRasEGlHUeLrEl+k/nA: doesn't show hand
*** SUMMARY ***
Total pot $24 | Rake $0.50
Board [2c 5h Th Jc 4s]
Seat 1: FRkiRasEGlHUeLrEl+k/nA (button) (small blind) collected ($23.50)
Seat 2: 3Wro85I7472vJ4Wkpneo9A (big blind) folded on the River



PokerStars Game #59939952318:  Hold'em No Limit ($0.25/$0.50) - 2009/07/01 0:53:18 ET
Table 'Vdlc9wqYcHTUhtdyN7CuJw' 2-max Seat #2 is the button
Seat 1: yBO+mXB6m/rCft2ErwGf/Q ($114.55 in chips)
Seat 2: NZ/5cxwnorKW2SNsWy1+8A ($10.55 in chips)
NZ/5cxwnorKW2SNsWy1+8A: posts small blind $0.25
yBO+mXB6m/rCft2ErwGf/Q: posts big blind $0.50
*** HOLE CARDS ***
NZ/5cxwnorKW2SNsWy1+8A: calls $0.25
yBO+mXB6m/rCft2ErwGf/Q: checks
*** FLOP *** [Tc 5h 9s]
yBO+mXB6m/rCft2ErwGf/Q: bets $0.50
NZ/5cxwnorKW2SNsWy1+8A: folds
yBO+mXB6m/rCft2ErwGf/Q collected $0.95 from pot
*** SUMMARY ***
Total pot $1 | Rake $0.05
Board [Tc 5h 9s]
Seat 1: yBO+mXB6m/rCft2ErwGf/Q (big blind) collected ($0.95)
Seat 2: NZ/5cxwnorKW2SNsWy1+8A (button) (small blind) folded on the Flop



PokerStars Game #59939952996:  Hold'em No Limit ($0.25/$0.50) - 2009/07/01 0:53:19 ET
Table '0eJtgVAXVvBgncFdcUpXcQ' 2-max Seat #2 is the button
Seat 1: Ag6DvxX4vbRheqsv2zXKTQ ($43.05 in chips)
Seat 2: KMc4R+K9ao4Ur3rF7NGe6Q ($8.40 in chips)
KMc4R+K9ao4Ur3rF7NGe6Q: posts small blind $0.25
Ag6DvxX4vbRheqsv2zXKTQ: posts big blind $0.50
*** HOLE CARDS ***
KMc4R+K9ao4Ur3rF7NGe6Q said, "damn you hittin rivers lol"
KMc4R+K9ao4Ur3rF7NGe6Q: calls $0.25
Ag6DvxX4vbRheqsv2zXKTQ: checks
*** FLOP *** [Jc Qc 4d]
Ag6DvxX4vbRheqsv2zXKTQ said, "lol"
Ag6DvxX4vbRheqsv2zXKTQ: checks
KMc4R+K9ao4Ur3rF7NGe6Q: checks
*** TURN *** [Jc Qc 4d] [Th]
Ag6DvxX4vbRheqsv2zXKTQ: checks
KMc4R+K9ao4Ur3rF7NGe6Q: checks
*** RIVER *** [Jc Qc 4d Th] [9c]
Ag6DvxX4vbRheqsv2zXKTQ: checks
KMc4R+K9ao4Ur3rF7NGe6Q: bets $1
Ag6DvxX4vbRheqsv2zXKTQ: folds
KMc4R+K9ao4Ur3rF7NGe6Q collected $0.95 from pot
KMc4R+K9ao4Ur3rF7NGe6Q: doesn't show hand
*** SUMMARY ***
Total pot $1 | Rake $0.05
Board [Jc Qc 4d Th 9c]
Seat 1: Ag6DvxX4vbRheqsv2zXKTQ (big blind) folded on the River
Seat 2: KMc4R+K9ao4Ur3rF7NGe6Q (button) (small blind) collected ($0.95)



PokerStars Game #59939953472:  Hold'em No Limit ($0.25/$0.50) - 2009/07/01 0:53:19 ET
Table 'X6IRCRTh+20gjz8aubWnwA' 9-max Seat #9 is the button
Seat 1: DSM67hHHq1XFoEOi9p8Alw ($49.55 in chips)
Seat 2: HZkVla4kK2SI42CVrPZ/ig ($8.55 in chips)
Seat 3: SWv01peOe69QQRvhQTqjQw ($4.90 in chips)
Seat 4: 2J+UVOVrW+V3maOylyxMcQ ($43.55 in chips)
Seat 5: NnQCepdIR/AOUQn1yhYx6Q ($10 in chips)
Seat 7: cFHQjKQOOKTUzoilhrXHLg ($52.25 in chips)
Seat 8: HxeBVq06/3Bh/H986sgdbw ($18.55 in chips)
Seat 9: M+7+BTmX5vZatHVuoRB1nA ($46.75 in chips)
DSM67hHHq1XFoEOi9p8Alw: posts small blind $0.25
HZkVla4kK2SI42CVrPZ/ig: posts big blind $0.50
75K2MXwN65Sjfp1yHd50Hg: sits out
*** HOLE CARDS ***
SWv01peOe69QQRvhQTqjQw: folds
2J+UVOVrW+V3maOylyxMcQ: calls $0.50
NnQCepdIR/AOUQn1yhYx6Q: folds
cFHQjKQOOKTUzoilhrXHLg: calls $0.50
HxeBVq06/3Bh/H986sgdbw: calls $0.50
M+7+BTmX5vZatHVuoRB1nA: folds
DSM67hHHq1XFoEOi9p8Alw: calls $0.25
HZkVla4kK2SI42CVrPZ/ig: checks
*** FLOP *** [Ah 3s As]
DSM67hHHq1XFoEOi9p8Alw: checks
HZkVla4kK2SI42CVrPZ/ig: checks
2J+UVOVrW+V3maOylyxMcQ: checks
cFHQjKQOOKTUzoilhrXHLg: bets $1
HxeBVq06/3Bh/H986sgdbw: calls $1
DSM67hHHq1XFoEOi9p8Alw: folds
HZkVla4kK2SI42CVrPZ/ig: folds
2J+UVOVrW+V3maOylyxMcQ: folds
*** TURN *** [Ah 3s As] [5s]
cFHQjKQOOKTUzoilhrXHLg: checks
HxeBVq06/3Bh/H986sgdbw: bets $3
cFHQjKQOOKTUzoilhrXHLg: calls $3
*** RIVER *** [Ah 3s As 5s] [5h]
cFHQjKQOOKTUzoilhrXHLg: checks
HxeBVq06/3Bh/H986sgdbw: bets $10.50
cFHQjKQOOKTUzoilhrXHLg: folds
HxeBVq06/3Bh/H986sgdbw collected $10 from pot
*** SUMMARY ***
Total pot $10.50 | Rake $0.50
Board [Ah 3s As 5s 5h]
Seat 1: DSM67hHHq1XFoEOi9p8Alw (small blind) folded on the Flop
Seat 2: HZkVla4kK2SI42CVrPZ/ig (big blind) folded on the Flop
Seat 3: SWv01peOe69QQRvhQTqjQw folded before Flop (didn't bet)
Seat 4: 2J+UVOVrW+V3maOylyxMcQ folded on the Flop
Seat 5: NnQCepdIR/AOUQn1yhYx6Q folded before Flop (didn't bet)
Seat 7: cFHQjKQOOKTUzoilhrXHLg folded on the River
Seat 8: HxeBVq06/3Bh/H986sgdbw collected ($10)
Seat 9: M+7+BTmX5vZatHVuoRB1nA (button) folded before Flop (didn't bet)



PokerStars Game #59939953486:  Hold'em No Limit ($0.25/$0.50) - 2009/07/01 0:53:19 ET
Table 'BCN5su+SsXiy1zRMJi0SJw' 6-max Seat #1 is the button
Seat 1: GxXV09ciXaOxyY2H5aMIIw ($28.60 in chips)
Seat 2: oU2kDCkT/gilYbHWrg7D8w ($19.50 in chips)
Seat 5: IBNygaT1aa9Z1uPdJJilwA ($25.80 in chips)
Seat 6: b2symlOdL7+0c9Pj4N/KlA ($82.95 in chips)
oU2kDCkT/gilYbHWrg7D8w: posts small blind $0.25
IBNygaT1aa9Z1uPdJJilwA: posts big blind $0.50
*** HOLE CARDS ***
b2symlOdL7+0c9Pj4N/KlA: raises $1.50 to $2
GxXV09ciXaOxyY2H5aMIIw: folds
oU2kDCkT/gilYbHWrg7D8w: calls $1.75
IBNygaT1aa9Z1uPdJJilwA: folds
*** FLOP *** [3s Ks 3h]
oU2kDCkT/gilYbHWrg7D8w: checks
6wzJiRvp8HY6t+MQGnSIzA joins the table at seat #3
b2symlOdL7+0c9Pj4N/KlA: bets $3
oU2kDCkT/gilYbHWrg7D8w: folds
b2symlOdL7+0c9Pj4N/KlA collected $4.30 from pot
b2symlOdL7+0c9Pj4N/KlA: doesn't show hand
*** SUMMARY ***
Total pot $4.50 | Rake $0.20
Board [3s Ks 3h]
Seat 1: GxXV09ciXaOxyY2H5aMIIw (button) folded before Flop (didn't bet)
Seat 2: oU2kDCkT/gilYbHWrg7D8w (small blind) folded on the Flop
Seat 5: IBNygaT1aa9Z1uPdJJilwA (big blind) folded before Flop
Seat 6: b2symlOdL7+0c9Pj4N/KlA collected ($4.30)



PokerStars Game #59939954132:  Hold'em No Limit ($0.25/$0.50) - 2009/07/01 0:53:20 ET
Table 'c/CRn+68J3Y8KxD5g1ek2Q' 2-max Seat #1 is the button
Seat 1: 46qCyJ6evTkHo9al5sBMNA ($84.55 in chips)
Seat 2: BypVLsYQt3ePFm2xQL/dOA ($286.70 in chips)
46qCyJ6evTkHo9al5sBMNA: posts small blind $0.25
BypVLsYQt3ePFm2xQL/dOA: posts big blind $0.50
*** HOLE CARDS ***
46qCyJ6evTkHo9al5sBMNA: folds
BypVLsYQt3ePFm2xQL/dOA collected $0.50 from pot
BypVLsYQt3ePFm2xQL/dOA: doesn't show hand
*** SUMMARY ***
Total pot $0.50 | Rake $0
Seat 1: 46qCyJ6evTkHo9al5sBMNA (button) (small blind) folded before Flop
Seat 2: BypVLsYQt3ePFm2xQL/dOA (big blind) collected ($0.50)



PokerStars Game #59939954348:  Hold'em No Limit ($0.25/$0.50) - 2009/07/01 0:53:21 ET
Table '+dXkOAQyS8j9PQZusUTMpg' 2-max Seat #1 is the button
Seat 1: XFa6sBGjP2gxoIvxR3fZIg ($61.25 in chips)
Seat 2: 5IBeOgaApY1Bvzv2P8X4EA ($140.10 in chips)
XFa6sBGjP2gxoIvxR3fZIg: posts small blind $0.25
5IBeOgaApY1Bvzv2P8X4EA: posts big blind $0.50
*** HOLE CARDS ***
XFa6sBGjP2gxoIvxR3fZIg: raises $1 to $1.50
5IBeOgaApY1Bvzv2P8X4EA: folds
XFa6sBGjP2gxoIvxR3fZIg collected $1 from pot
XFa6sBGjP2gxoIvxR3fZIg: doesn't show hand
*** SUMMARY ***
Total pot $1 | Rake $0
Seat 1: XFa6sBGjP2gxoIvxR3fZIg (button) (small blind) collected ($1)
Seat 2: 5IBeOgaApY1Bvzv2P8X4EA (big blind) folded before Flop



PokerStars Game #59939954526:  Hold'em No Limit ($0.25/$0.50) - 2009/07/01 0:53:21 ET
Table 'QOgaEqMcJ73pcUMMxoisUg' 6-max Seat #5 is the button
Seat 1: /olYG0EzMWzADIgH1y2ySQ ($25.70 in chips)
Seat 2: 4QfsCWthT/vSLirorNXqtg ($50.75 in chips)
Seat 3: Rt6KgtZ8YaJoTc3FPim00w ($88.80 in chips)
Seat 4: zAcsDhG/T128Vn7XGVSgKg ($50.10 in chips)
Seat 5: 6vNxrjjCl6FwfaaymM9jjg ($32.80 in chips)
Seat 6: GoVjFxr3C+JO9vtJH9+IcA ($26.15 in chips)
GoVjFxr3C+JO9vtJH9+IcA: posts small blind $0.25
/olYG0EzMWzADIgH1y2ySQ: posts big blind $0.50
*** HOLE CARDS ***
4QfsCWthT/vSLirorNXqtg: folds
Rt6KgtZ8YaJoTc3FPim00w: folds
zAcsDhG/T128Vn7XGVSgKg: folds
6vNxrjjCl6FwfaaymM9jjg: raises $2.50 to $3
GoVjFxr3C+JO9vtJH9+IcA: folds
/olYG0EzMWzADIgH1y2ySQ: folds
6vNxrjjCl6FwfaaymM9jjg collected $1.25 from pot
*** SUMMARY ***
Total pot $1.25 | Rake $0
Seat 1: /olYG0EzMWzADIgH1y2ySQ (big blind) folded before Flop
Seat 2: 4QfsCWthT/vSLirorNXqtg folded before Flop (didn't bet)
Seat 3: Rt6KgtZ8YaJoTc3FPim00w folded before Flop (didn't bet)
Seat 4: zAcsDhG/T128Vn7XGVSgKg folded before Flop (didn't bet)
Seat 5: 6vNxrjjCl6FwfaaymM9jjg (button) collected ($1.25)
Seat 6: GoVjFxr3C+JO9vtJH9+IcA (small blind) folded before Flop



PokerStars Game #59939956158:  Hold'em No Limit ($0.25/$0.50) - 2009/07/01 0:53:24 ET
Table 'kgbJRsxfv64KrErDRBAkcw' 6-max Seat #4 is the button
Seat 1: w2dj3tZyWCX7+wEKRi0AVw ($15.35 in chips)
Seat 2: AdS8BJMOheS01zjCDfPMFg ($50.50 in chips)
Seat 3: c4MNIaIyPMOMxrgT8FT5nA ($133.15 in chips)
Seat 4: qanMEqjABjWxC/JgQ/0l7w ($50 in chips)
Seat 5: eUBBn2R56C1IQ6Cs/vitwg ($50 in chips)
Seat 6: 1b+2BbjMN8qhR1WPqdE9VQ ($50 in chips)
eUBBn2R56C1IQ6Cs/vitwg: posts small blind $0.25
1b+2BbjMN8qhR1WPqdE9VQ: posts big blind $0.50
*** HOLE CARDS ***
w2dj3tZyWCX7+wEKRi0AVw: folds
AdS8BJMOheS01zjCDfPMFg: raises $1 to $1.50
c4MNIaIyPMOMxrgT8FT5nA: calls $1.50
qanMEqjABjWxC/JgQ/0l7w: raises $5 to $6.50
eUBBn2R56C1IQ6Cs/vitwg: folds
1b+2BbjMN8qhR1WPqdE9VQ: folds
AdS8BJMOheS01zjCDfPMFg: folds
c4MNIaIyPMOMxrgT8FT5nA: calls $5
*** FLOP *** [6h Jd 3s]
c4MNIaIyPMOMxrgT8FT5nA: checks
qanMEqjABjWxC/JgQ/0l7w: bets $9
c4MNIaIyPMOMxrgT8FT5nA: folds
qanMEqjABjWxC/JgQ/0l7w collected $14.50 from pot
*** SUMMARY ***
Total pot $15.25 | Rake $0.75
Board [6h Jd 3s]
Seat 1: w2dj3tZyWCX7+wEKRi0AVw folded before Flop (didn't bet)
Seat 2: AdS8BJMOheS01zjCDfPMFg folded before Flop
Seat 3: c4MNIaIyPMOMxrgT8FT5nA folded on the Flop
Seat 4: qanMEqjABjWxC/JgQ/0l7w (button) collected ($14.50)
Seat 5: eUBBn2R56C1IQ6Cs/vitwg (small blind) folded before Flop
Seat 6: 1b+2BbjMN8qhR1WPqdE9VQ (big blind) folded before Flop



PokerStars Game #59939956394:  Hold'em No Limit ($0.25/$0.50) - 2009/07/01 0:53:24 ET
Table 'NHLx+ggeIlZy3D6oDgC0yg' 2-max Seat #1 is the button
Seat 1: Fp/oksNpipCrD2MJ2pH20g ($23 in chips)
Seat 2: DHMk3is1XNc/OjPVB8NJ5w ($38.65 in chips)
Fp/oksNpipCrD2MJ2pH20g: posts small blind $0.25
DHMk3is1XNc/OjPVB8NJ5w: posts big blind $0.50
*** HOLE CARDS ***
Fp/oksNpipCrD2MJ2pH20g: folds
DHMk3is1XNc/OjPVB8NJ5w collected $0.50 from pot
DHMk3is1XNc/OjPVB8NJ5w: doesn't show hand
*** SUMMARY ***
Total pot $0.50 | Rake $0
Seat 1: Fp/oksNpipCrD2MJ2pH20g (button) (small blind) folded before Flop
Seat 2: DHMk3is1XNc/OjPVB8NJ5w (big blind) collected ($0.50)



PokerStars Game #59939956306:  Hold'em No Limit ($0.25/$0.50) - 2009/07/01 0:53:24 ET
Table '5EmHi+fnatGQQShcNmzOZQ' 6-max Seat #3 is the button
Seat 1: HGzUMAFxR1k8+S4gfnB39w ($34.60 in chips)
Seat 3: TjmTe3bhs9dFz5gXX9x7Lw ($26.50 in chips)
Seat 4: 1b+2BbjMN8qhR1WPqdE9VQ ($62.75 in chips)
Seat 5: kxPhs4ePFqMy52CInAJ2aw ($49.75 in chips)
Seat 6: 686aeHikcJlgKkSuIFdcXQ ($132.70 in chips)
1b+2BbjMN8qhR1WPqdE9VQ: posts small blind $0.25
kxPhs4ePFqMy52CInAJ2aw: posts big blind $0.50
*** HOLE CARDS ***
686aeHikcJlgKkSuIFdcXQ: folds
HGzUMAFxR1k8+S4gfnB39w: calls $0.50
TjmTe3bhs9dFz5gXX9x7Lw: calls $0.50
1b+2BbjMN8qhR1WPqdE9VQ: raises $2.50 to $3
kxPhs4ePFqMy52CInAJ2aw: folds
HGzUMAFxR1k8+S4gfnB39w: calls $2.50
TjmTe3bhs9dFz5gXX9x7Lw: calls $2.50
*** FLOP *** [Jc As 5h]
1b+2BbjMN8qhR1WPqdE9VQ: bets $6
HGzUMAFxR1k8+S4gfnB39w: folds
TjmTe3bhs9dFz5gXX9x7Lw: folds
1b+2BbjMN8qhR1WPqdE9VQ collected $9.05 from pot
1b+2BbjMN8qhR1WPqdE9VQ: doesn't show hand
*** SUMMARY ***
Total pot $9.50 | Rake $0.45
Board [Jc As 5h]
Seat 1: HGzUMAFxR1k8+S4gfnB39w folded on the Flop
Seat 3: TjmTe3bhs9dFz5gXX9x7Lw (button) folded on the Flop
Seat 4: 1b+2BbjMN8qhR1WPqdE9VQ (small blind) collected ($9.05)
Seat 5: kxPhs4ePFqMy52CInAJ2aw (big blind) folded before Flop
Seat 6: 686aeHikcJlgKkSuIFdcXQ folded before Flop (didn't bet)



PokerStars Game #59939958224:  Hold'em No Limit ($0.25/$0.50) - 2009/07/01 0:53:27 ET
Table 'c/CRn+68J3Y8KxD5g1ek2Q' 2-max Seat #2 is the button
Seat 1: 46qCyJ6evTkHo9al5sBMNA ($84.30 in chips)
Seat 2: BypVLsYQt3ePFm2xQL/dOA ($286.95 in chips)
BypVLsYQt3ePFm2xQL/dOA: posts small blind $0.25
46qCyJ6evTkHo9al5sBMNA: posts big blind $0.50
*** HOLE CARDS ***
BypVLsYQt3ePFm2xQL/dOA: calls $0.25
46qCyJ6evTkHo9al5sBMNA: raises $1 to $1.50
BypVLsYQt3ePFm2xQL/dOA: calls $1
*** FLOP *** [5h 6d Js]
46qCyJ6evTkHo9al5sBMNA: bets $1.50
BypVLsYQt3ePFm2xQL/dOA: folds
46qCyJ6evTkHo9al5sBMNA collected $2.85 from pot
46qCyJ6evTkHo9al5sBMNA: doesn't show hand
*** SUMMARY ***
Total pot $3 | Rake $0.15
Board [5h 6d Js]
Seat 1: 46qCyJ6evTkHo9al5sBMNA (big blind) collected ($2.85)
Seat 2: BypVLsYQt3ePFm2xQL/dOA (button) (small blind) folded on the Flop



PokerStars Game #59939958260:  Hold'em No Limit ($0.25/$0.50) - 2009/07/01 0:53:27 ET
Table 'fx6MqwfYAj/Rt86hBz2L3Q' 9-max Seat #5 is the button
Seat 1: SegjDnMxWMujiD57ESNL+g ($9 in chips)
Seat 3: iadBi5AEt7gTBXbDSSnMYQ ($75.30 in chips)
Seat 5: iAISe3dVeua8PUn2wwgDHw ($31.50 in chips)
Seat 6: 5k9fvXD9suIgCxU4HLQjTw ($50.25 in chips)
Seat 7: SKnJuWHScqetA/qG5p+wCg ($30 in chips)
Seat 8: JYwJYYV9pM5KWdSiETl8rA ($27.25 in chips)
Seat 9: HZkVla4kK2SI42CVrPZ/ig ($11 in chips)
5k9fvXD9suIgCxU4HLQjTw: posts small blind $0.25
SKnJuWHScqetA/qG5p+wCg: posts big blind $0.50
*** HOLE CARDS ***
JYwJYYV9pM5KWdSiETl8rA: folds
gPEN9Zp33YTm/mu9/SYP1w leaves the table
SegjDnMxWMujiD57ESNL+g said, "nh"
HZkVla4kK2SI42CVrPZ/ig: folds
SegjDnMxWMujiD57ESNL+g: folds
iadBi5AEt7gTBXbDSSnMYQ: calls $0.50
iAISe3dVeua8PUn2wwgDHw: folds
75K2MXwN65Sjfp1yHd50Hg joins the table at seat #4
5k9fvXD9suIgCxU4HLQjTw: folds
SKnJuWHScqetA/qG5p+wCg: checks
*** FLOP *** [8s 5s 5d]
iadBi5AEt7gTBXbDSSnMYQ said, "ty"
SKnJuWHScqetA/qG5p+wCg: checks
iadBi5AEt7gTBXbDSSnMYQ: checks
*** TURN *** [8s 5s 5d] [6s]
SKnJuWHScqetA/qG5p+wCg: checks
iadBi5AEt7gTBXbDSSnMYQ: bets $1.50
SKnJuWHScqetA/qG5p+wCg: folds
iadBi5AEt7gTBXbDSSnMYQ collected $1.20 from pot
*** SUMMARY ***
Total pot $1.25 | Rake $0.05
Board [8s 5s 5d 6s]
Seat 1: SegjDnMxWMujiD57ESNL+g folded before Flop (didn't bet)
Seat 3: iadBi5AEt7gTBXbDSSnMYQ collected ($1.20)
Seat 5: iAISe3dVeua8PUn2wwgDHw (button) folded before Flop (didn't bet)
Seat 6: 5k9fvXD9suIgCxU4HLQjTw (small blind) folded before Flop
Seat 7: SKnJuWHScqetA/qG5p+wCg (big blind) folded on the Turn
Seat 8: JYwJYYV9pM5KWdSiETl8rA folded before Flop (didn't bet)
Seat 9: HZkVla4kK2SI42CVrPZ/ig folded before Flop (didn't bet)



PokerStars Game #59939958882:  Hold'em No Limit ($0.25/$0.50) - 2009/07/01 0:53:28 ET
Table 'QOgaEqMcJ73pcUMMxoisUgErOuyGLI5PT3G5MnpHgC/g Seat #4 is the button
Seat 3: xZCXQSXlrZkp3pZizzVXCw ($49.50 in chips)
Seat 4: 3UmXLy3GfjC3EkOebduerQ ($50.45 in chips)
Seat 5: JwvquocWfhTVApN5t47LgA ($61.05 in chips)
Seat 6: zE9cVigS2nW/Ljy4K4bUQA ($30 in chips)
Seat 7: 90Wb75h3W1BRpbqVnuk8gw ($65.55 in chips)
Seat 8: g4k0NXISyLCqaSWZDBjfEg ($50 in chips)
Seat 9: J0W5D97jl5VLky+IoPvDeA ($53.15 in chips)
JwvquocWfhTVApN5t47LgA: posts small blind $0.25
zE9cVigS2nW/Ljy4K4bUQA: posts big blind $0.50
eBrej2jnlUCs/JgxFCRn2g: sits out
*** HOLE CARDS ***
90Wb75h3W1BRpbqVnuk8gw: raises $1.50 to $2
g4k0NXISyLCqaSWZDBjfEg: folds
J0W5D97jl5VLky+IoPvDeA: folds
xZCXQSXlrZkp3pZizzVXCw: folds
3UmXLy3GfjC3EkOebduerQ: folds
JwvquocWfhTVApN5t47LgA: calls $1.75
zE9cVigS2nW/Ljy4K4bUQA: folds
*** FLOP *** [5h 9d 8c]
JwvquocWfhTVApN5t47LgA: bets $2
90Wb75h3W1BRpbqVnuk8gw: folds
JwvquocWfhTVApN5t47LgA collected $4.30 from pot
*** SUMMARY ***
Total pot $4.50 | Rake $0.20
Board [5h 9d 8c]
Seat 3: xZCXQSXlrZkp3pZizzVXCw folded before Flop (didn't bet)
Seat 4: 3UmXLy3GfjC3EkOebduerQ (button) folded before Flop (didn't bet)
Seat 5: JwvquocWfhTVApN5t47LgA (small blind) collected ($4.30)
Seat 6: zE9cVigS2nW/Ljy4K4bUQA (big blind) folded before Flop
Seat 7: 90Wb75h3W1BRpbqVnuk8gw folded on the Flop
Seat 8: g4k0NXISyLCqaSWZDBjfEg folded before Flop (didn't bet)
Seat 9: J0W5D97jl5VLky+IoPvDeA folded before Flop (didn't bet)



PokerStars Game #59939958820:  Hold'em No Limit ($0.25/$0.50) - 2009/07/01 0:53:28 ET
Table '+dXkOAQyS8j9PQZusUTMpg' 2-max Seat #2 is the button
Seat 1: XFa6sBGjP2gxoIvxR3fZIg ($61.75 in chips)
Seat 2: 5IBeOgaApY1Bvzv2P8X4EA ($139.60 in chips)
5IBeOgaApY1Bvzv2P8X4EA: posts small blind $0.25
XFa6sBGjP2gxoIvxR3fZIg: posts big blind $0.50
*** HOLE CARDS ***
5IBeOgaApY1Bvzv2P8X4EA: calls $0.25
XFa6sBGjP2gxoIvxR3fZIg: checks
*** FLOP *** [7h Qd Kc]
XFa6sBGjP2gxoIvxR3fZIg: checks
5IBeOgaApY1Bvzv2P8X4EA: bets $5
XFa6sBGjP2gxoIvxR3fZIg: folds
5IBeOgaApY1Bvzv2P8X4EA collected $0.95 from pot
5IBeOgaApY1Bvzv2P8X4EA: doesn't show hand
*** SUMMARY ***
Total pot $1 | Rake $0.05
Board [7h Qd Kc]
Seat 1: XFa6sBGjP2gxoIvxR3fZIg (big blind) folded on the Flop
Seat 2: 5IBeOgaApY1Bvzv2P8X4EA (button) (small blind) collected ($0.95)



PokerStars Game #59939958518:  Hold'em No Limit ($0.25/$0.50) - 2009/07/01 0:53:28 ET
Table 'lpxYasB1ClBSgTpCCITwhQ' 9-max Seat #9 is the button
Seat 1: mj7PS7wCH4PAl7+eYTFs7A ($46.65 in chips)
Seat 2: OWP/DOu+PlPK6ZZ3zYa0HA ($24.85 in chips)
Seat 3: cDNz32Scry3j+v2+kE3pHg ($50 in chips)
Seat 5: IYd5zG8k7vdBNVHbHg2Pag ($38.10 in chips)
Seat 6: SegjDnMxWMujiD57ESNL+g ($6.25 in chips)
Seat 7: bmRtaIYKthN1F+B3JLZ3Jw ($27.90 in chips)
Seat 8: /mfensKw8/iZ1Vrx33S4xg ($10 in chips)
Seat 9: XNMDwbXt/Q4jM99AXnbJDw ($50.50 in chips)
mj7PS7wCH4PAl7+eYTFs7A: posts small blind $0.25
OWP/DOu+PlPK6ZZ3zYa0HA: posts big blind $0.50
NnQCepdIR/AOUQn1yhYx6Q: sits out
/mfensKw8/iZ1Vrx33S4xg: posts big blind $0.50
*** HOLE CARDS ***
cDNz32Scry3j+v2+kE3pHg: folds
IYd5zG8k7vdBNVHbHg2Pag: folds
SegjDnMxWMujiD57ESNL+g: folds
bmRtaIYKthN1F+B3JLZ3Jw: raises $1.50 to $2
/mfensKw8/iZ1Vrx33S4xg: folds
XNMDwbXt/Q4jM99AXnbJDw: folds
mj7PS7wCH4PAl7+eYTFs7A: folds
OWP/DOu+PlPK6ZZ3zYa0HA: folds
bmRtaIYKthN1F+B3JLZ3Jw collected $1.75 from pot
*** SUMMARY ***
Total pot $1.75 | Rake $0
Seat 1: mj7PS7wCH4PAl7+eYTFs7A (small blind) folded before Flop
Seat 2: OWP/DOu+PlPK6ZZ3zYa0HA (big blind) folded before Flop
Seat 3: cDNz32Scry3j+v2+kE3pHg folded before Flop (didn't bet)
Seat 5: IYd5zG8k7vdBNVHbHg2Pag folded before Flop (didn't bet)
Seat 6: SegjDnMxWMujiD57ESNL+g folded before Flop (didn't bet)
Seat 7: bmRtaIYKthN1F+B3JLZ3Jw collected ($1.75)
Seat 8: /mfensKw8/iZ1Vrx33S4xg folded before Flop
Seat 9: XNMDwbXt/Q4jM99AXnbJDw (button) folded before Flop (didn't bet)



PokerStars Game #59939959294:  Hold'em No Limit ($0.25/$0.50) - 2009/07/01 0:53:29 ET
Table 'GfL/No5u5PoEnU39lP5pQg' 6-max Seat #6 is the button
Seat 1: 1WUCqNG+p+vfWRTXNu4ljw ($60.25 in chips)
Seat 2: uVwggSetzp7d+eVgowO3vg ($65.20 in chips)
Seat 3: Ek4w9XqBXqK5jBUQeLedGw ($51.25 in chips)
Seat 4: r6u7MWSXF30/khcTYkrG9Q ($24.65 in chips)
Seat 6: kxPhs4ePFqMy52CInAJ2aw ($50.75 in chips)
1WUCqNG+p+vfWRTXNu4ljw: posts small blind $0.25
uVwggSetzp7d+eVgowO3vg: posts big blind $0.50
*** HOLE CARDS ***
Ek4w9XqBXqK5jBUQeLedGw has timed out
Ek4w9XqBXqK5jBUQeLedGw: folds
Ek4w9XqBXqK5jBUQeLedGw is sitting out
r6u7MWSXF30/khcTYkrG9Q: folds
Ek4w9XqBXqK5jBUQeLedGw has returned
kxPhs4ePFqMy52CInAJ2aw: raises $1.50 to $2
1WUCqNG+p+vfWRTXNu4ljw: folds
uVwggSetzp7d+eVgowO3vg: calls $1.50
*** FLOP *** [As 7h Jd]
uVwggSetzp7d+eVgowO3vg: checks
kxPhs4ePFqMy52CInAJ2aw: bets $3
uVwggSetzp7d+eVgowO3vg: calls $3
*** TURN *** [As 7h Jd] [Kd]
uVwggSetzp7d+eVgowO3vg: checks
kxPhs4ePFqMy52CInAJ2aw: bets $7
uVwggSetzp7d+eVgowO3vg: folds
kxPhs4ePFqMy52CInAJ2aw collected $9.75 from pot
kxPhs4ePFqMy52CInAJ2aw: doesn't show hand
*** SUMMARY ***
Total pot $10.25 | Rake $0.50
Board [As 7h Jd Kd]
Seat 1: 1WUCqNG+p+vfWRTXNu4ljw (small blind) folded before Flop
Seat 2: uVwggSetzp7d+eVgowO3vg (big blind) folded on the Turn
Seat 3: Ek4w9XqBXqK5jBUQeLedGw folded before Flop (didn't bet)
Seat 4: r6u7MWSXF30/khcTYkrG9Q folded before Flop (didn't bet)
Seat 6: kxPhs4ePFqMy52CInAJ2aw (button) collected ($9.75)



PokerStars Game #59939960242:  Hold'em No Limit ($0.25/$0.50) - 2009/07/01 0:53:31 ET
Table 'NHLx+ggeIlZy3D6oDgC0yg' 2-max Seat #2 is the button
Seat 1: Fp/oksNpipCrD2MJ2pH20g ($22.75 in chips)
Seat 2: DHMk3is1XNc/OjPVB8NJ5w ($50 in chips)
DHMk3is1XNc/OjPVB8NJ5w: posts small blind $0.25
Fp/oksNpipCrD2MJ2pH20g: posts big blind $0.50
*** HOLE CARDS ***
DHMk3is1XNc/OjPVB8NJ5w: raises $0.50 to $1
Fp/oksNpipCrD2MJ2pH20g: folds
DHMk3is1XNc/OjPVB8NJ5w collected $1 from pot
DHMk3is1XNc/OjPVB8NJ5w: doesn't show hand
*** SUMMARY ***
Total pot $1 | Rake $0
Seat 1: Fp/oksNpipCrD2MJ2pH20g (big blind) folded before Flop
Seat 2: DHMk3is1XNc/OjPVB8NJ5w (button) (small blind) collected ($1)



PokerStars Game #59939961566:  Hold'em No Limit ($0.25/$0.50) - 2009/07/01 0:53:33 ET
Table 'lSisgp6H7Fg1hH5VfjEjYQ' 9-max Seat #5 is the button
Seat 1: 5k9fvXD9suIgCxU4HLQjTw ($50 in chips)
Seat 2: UrcnkQOiLVk8BlKDPJSy7Q ($77.60 in chips)
Seat 3: aTkyjTh3w5YLWiIERupZOA ($51.20 in chips)
Seat 4: bwv/rbH/hHhPhY6u9mu04w ($33.60 in chips)
Seat 5: mSD1pginDsyHG5PDfqzphw ($12.60 in chips)
Seat 6: +k7T5ocke8UwavtgUHm+Cg ($52.90 in chips)
Seat 7: IDtNLR9uFCDdjNsJWMHA5Q ($15.60 in chips)
Seat 8: a4JDWmpFQkL10XfAyuF51A ($30.50 in chips)
Seat 9: gsyXT42WLEcOS4DdEk2wlw ($42.10 in chips)
+k7T5ocke8UwavtgUHm+Cg: posts small blind $0.25
IDtNLR9uFCDdjNsJWMHA5Q: posts big blind $0.50
*** HOLE CARDS ***
a4JDWmpFQkL10XfAyuF51A: folds
gsyXT42WLEcOS4DdEk2wlw: folds
5k9fvXD9suIgCxU4HLQjTw: raises $1 to $1.50
UrcnkQOiLVk8BlKDPJSy7Q: calls $1.50
aTkyjTh3w5YLWiIERupZOA: folds
bwv/rbH/hHhPhY6u9mu04w: folds
mSD1pginDsyHG5PDfqzphw: folds
+k7T5ocke8UwavtgUHm+Cg: calls $1.25
IDtNLR9uFCDdjNsJWMHA5Q: raises $14.10 to $15.60 and is all-in
5k9fvXD9suIgCxU4HLQjTw: folds
UrcnkQOiLVk8BlKDPJSy7Q: folds
+k7T5ocke8UwavtgUHm+Cg: folds
IDtNLR9uFCDdjNsJWMHA5Q collected $6 from pot
IDtNLR9uFCDdjNsJWMHA5Q: doesn't show hand
*** SUMMARY ***
Total pot $6 | Rake $0
Seat 1: 5k9fvXD9suIgCxU4HLQjTw folded before Flop
Seat 2: UrcnkQOiLVk8BlKDPJSy7Q folded before Flop
Seat 3: aTkyjTh3w5YLWiIERupZOA folded before Flop (didn't bet)
Seat 4: bwv/rbH/hHhPhY6u9mu04w folded before Flop (didn't bet)
Seat 5: mSD1pginDsyHG5PDfqzphw (button) folded before Flop (didn't bet)
Seat 6: +k7T5ocke8UwavtgUHm+Cg (small blind) folded before Flop
Seat 7: IDtNLR9uFCDdjNsJWMHA5Q (big blind) collected ($6)
Seat 8: a4JDWmpFQkL10XfAyuF51A folded before Flop (didn't bet)
Seat 9: gsyXT42WLEcOS4DdEk2wlw folded before Flop (didn't bet)



PokerStars Game #59939962316:  Hold'em No Limit ($0.25/$0.50) - 2009/07/01 0:53:34 ET
Table 'otvGDROEDdqsabxskT79qg' 9-max Seat #3 is the button
Seat 1: 8ehL7qlZzjgUh2H35iiWLw ($54.50 in chips)
Seat 2: cCjTzH9jio8607WzjcfXlg ($14.30 in chips)
Seat 3: +k7T5ocke8UwavtgUHm+Cg ($66.50 in chips)
Seat 4: MG90wfSJZnOejs/KD3vlQQ ($70.45 in chips)
Seat 5: XNMDwbXt/Q4jM99AXnbJDw ($52.55 in chips)
Seat 6: bxLSulbgr8LmKNjOzw8URg ($53.70 in chips)
Seat 7: C7+tBppJrKgd/r+tuKUIpA ($35.80 in chips)
Seat 8: zE9cVigS2nW/Ljy4K4bUQA ($30 in chips)
Seat 9: KcY3X8YpD74Kw1RHkx/g4A ($57.90 in chips)
MG90wfSJZnOejs/KD3vlQQ: posts small blind $0.25
XNMDwbXt/Q4jM99AXnbJDw: posts big blind $0.50
*** HOLE CARDS ***
bxLSulbgr8LmKNjOzw8URg: folds
C7+tBppJrKgd/r+tuKUIpA: folds
zE9cVigS2nW/Ljy4K4bUQA: folds
KcY3X8YpD74Kw1RHkx/g4A: folds
8ehL7qlZzjgUh2H35iiWLw: folds
cCjTzH9jio8607WzjcfXlg: folds
+k7T5ocke8UwavtgUHm+Cg: folds
MG90wfSJZnOejs/KD3vlQQ: calls $0.25
XNMDwbXt/Q4jM99AXnbJDw: raises $1 to $1.50
MG90wfSJZnOejs/KD3vlQQ: calls $1
*** FLOP *** [8c Kc 7s]
MG90wfSJZnOejs/KD3vlQQ: checks
XNMDwbXt/Q4jM99AXnbJDw: bets $1.50
MG90wfSJZnOejs/KD3vlQQ: calls $1.50
*** TURN *** [8c Kc 7s] [Ah]
MG90wfSJZnOejs/KD3vlQQ: checks
XNMDwbXt/Q4jM99AXnbJDw: checks
*** RIVER *** [8c Kc 7s Ah] [9d]
MG90wfSJZnOejs/KD3vlQQ: checks
XNMDwbXt/Q4jM99AXnbJDw: checks
*** SHOW DOWN ***
MG90wfSJZnOejs/KD3vlQQ: shows [Ks Jd] (a pair of Kings)
XNMDwbXt/Q4jM99AXnbJDw: mucks hand
MG90wfSJZnOejs/KD3vlQQ collected $5.75 from pot
*** SUMMARY ***
Total pot $6 | Rake $0.25
Board [8c Kc 7s Ah 9d]
Seat 1: 8ehL7qlZzjgUh2H35iiWLw folded before Flop (didn't bet)
Seat 2: cCjTzH9jio8607WzjcfXlg folded before Flop (didn't bet)
Seat 3: +k7T5ocke8UwavtgUHm+Cg (button) folded before Flop (didn't bet)
Seat 4: MG90wfSJZnOejs/KD3vlQQ (small blind) showed [Ks Jd] and won ($5.75) with a pair of Kings
Seat 5: XNMDwbXt/Q4jM99AXnbJDw (big blind) mucked
Seat 6: bxLSulbgr8LmKNjOzw8URg folded before Flop (didn't bet)
Seat 7: C7+tBppJrKgd/r+tuKUIpA folded before Flop (didn't bet)
Seat 8: zE9cVigS2nW/Ljy4K4bUQA folded before Flop (didn't bet)
Seat 9: KcY3X8YpD74Kw1RHkx/g4A folded before Flop (didn't bet)



PokerStars Game #59939962042:  Hold'em No Limit ($0.25/$0.50) - 2009/07/01 0:53:34 ET
Table 'NCiXr0d5CEKBQr/cZgLhbA' 9-max Seat #8 is the button
Seat 1: pFtzb1sR4b0d1aw6aIRgDg ($50 in chips)
Seat 2: ulxuJchBV9iguXg0FUonfg ($47.75 in chips)
Seat 3: xZCXQSXlrZkp3pZizzVXCw ($52.25 in chips)
Seat 4: 5k9fvXD9suIgCxU4HLQjTw ($55.95 in chips)
Seat 5: zE9cVigS2nW/Ljy4K4bUQA ($34.45 in chips)
Seat 6: SKnJuWHScqetA/qG5p+wCg ($34.75 in chips)
Seat 7: M+7+BTmX5vZatHVuoRB1nA ($52 in chips)
Seat 8: 1MJUKc3cc0QmUoz1JZLR2w ($58.25 in chips)
Seat 9: 4WLZvqBn5qv5tds5kt5A1Q ($45.05 in chips)
4WLZvqBn5qv5tds5kt5A1Q: posts small blind $0.25
pFtzb1sR4b0d1aw6aIRgDg: posts big blind $0.50
*** HOLE CARDS ***
ulxuJchBV9iguXg0FUonfg: folds
xZCXQSXlrZkp3pZizzVXCw: folds
5k9fvXD9suIgCxU4HLQjTw: folds
zE9cVigS2nW/Ljy4K4bUQA: folds
SKnJuWHScqetA/qG5p+wCg: folds
M+7+BTmX5vZatHVuoRB1nA: folds
1MJUKc3cc0QmUoz1JZLR2w: folds
4WLZvqBn5qv5tds5kt5A1Q: folds
pFtzb1sR4b0d1aw6aIRgDg collected $0.50 from pot
*** SUMMARY ***
Total pot $0.50 | Rake $0
Seat 1: pFtzb1sR4b0d1aw6aIRgDg (big blind) collected ($0.50)
Seat 2: ulxuJchBV9iguXg0FUonfg folded before Flop (didn't bet)
Seat 3: xZCXQSXlrZkp3pZizzVXCw folded before Flop (didn't bet)
Seat 4: 5k9fvXD9suIgCxU4HLQjTw folded before Flop (didn't bet)
Seat 5: zE9cVigS2nW/Ljy4K4bUQA folded before Flop (didn't bet)
Seat 6: SKnJuWHScqetA/qG5p+wCg folded before Flop (didn't bet)
Seat 7: M+7+BTmX5vZatHVuoRB1nA folded before Flop (didn't bet)
Seat 8: 1MJUKc3cc0QmUoz1JZLR2w (button) folded before Flop (didn't bet)
Seat 9: 4WLZvqBn5qv5tds5kt5A1Q (small blind) folded before Flop



PokerStars Game #59939963024:  Hold'em No Limit ($0.25/$0.50) - 2009/07/01 0:53:35 ET
Table 'B+sqsfj6d6zXicNfaseTaw' 2-max Seat #2 is the button
Seat 1: +4GNcSsecmapVGSdV0mUPA ($133.25 in chips)
Seat 2: Lv5RmpRe6LtPkBzM9Gpo5A ($50 in chips)
Lv5RmpRe6LtPkBzM9Gpo5A: posts small blind $0.25
+4GNcSsecmapVGSdV0mUPA: posts big blind $0.50
*** HOLE CARDS ***
Lv5RmpRe6LtPkBzM9Gpo5A: calls $0.25
+4GNcSsecmapVGSdV0mUPA: checks
*** FLOP *** [7c 8c 2h]
+4GNcSsecmapVGSdV0mUPA: checks
Lv5RmpRe6LtPkBzM9Gpo5A: checks
*** TURN *** [7c 8c 2h] [Ts]
+4GNcSsecmapVGSdV0mUPA: bets $1
Lv5RmpRe6LtPkBzM9Gpo5A: folds
+4GNcSsecmapVGSdV0mUPA collected $0.95 from pot
+4GNcSsecmapVGSdV0mUPA: doesn't show hand
*** SUMMARY ***
Total pot $1 | Rake $0.05
Board [7c 8c 2h Ts]
Seat 1: +4GNcSsecmapVGSdV0mUPA (big blind) collected ($0.95)
Seat 2: Lv5RmpRe6LtPkBzM9Gpo5A (button) (small blind) folded on the Turn



PokerStars Game #59939964396:  Hold'em No Limit ($0.25/$0.50) - 2009/07/01 0:53:37 ET
Table 'NHLx+ggeIlZy3D6oDgC0yg' 2-max Seat #1 is the button
Seat 1: Fp/oksNpipCrD2MJ2pH20g ($22.25 in chips)
Seat 2: DHMk3is1XNc/OjPVB8NJ5w ($50.50 in chips)
Fp/oksNpipCrD2MJ2pH20g: posts small blind $0.25
DHMk3is1XNc/OjPVB8NJ5w: posts big blind $0.50
*** HOLE CARDS ***
Fp/oksNpipCrD2MJ2pH20g: calls $0.25
DHMk3is1XNc/OjPVB8NJ5w: checks
*** FLOP *** [Tc 3h 6h]
DHMk3is1XNc/OjPVB8NJ5w: checks
Fp/oksNpipCrD2MJ2pH20g: checks
*** TURN *** [Tc 3h 6h] [Th]
DHMk3is1XNc/OjPVB8NJ5w: checks
Fp/oksNpipCrD2MJ2pH20g: checks
*** RIVER *** [Tc 3h 6h Th] [Qc]
DHMk3is1XNc/OjPVB8NJ5w: checks
Fp/oksNpipCrD2MJ2pH20g: checks
*** SHOW DOWN ***
DHMk3is1XNc/OjPVB8NJ5w: shows [7s 8d] (a pair of Tens)
Fp/oksNpipCrD2MJ2pH20g: shows [Ah 9s] (a pair of Tens - Ace kicker)
Fp/oksNpipCrD2MJ2pH20g collected $0.95 from pot
*** SUMMARY ***
Total pot $1 | Rake $0.05
Board [Tc 3h 6h Th Qc]
Seat 1: Fp/oksNpipCrD2MJ2pH20g (button) (small blind) showed [Ah 9s] and won ($0.95) with a pair of Tens
Seat 2: DHMk3is1XNc/OjPVB8NJ5w (big blind) showed [7s 8d] and lost with a pair of Tens



PokerStars Game #59939964940:  Hold'em No Limit ($0.25/$0.50) - 2009/07/01 0:53:38 ET
Table 'Vdlc9wqYcHTUhtdyN7CuJw' 2-max Seat #1 is the button
Seat 1: yBO+mXB6m/rCft2ErwGf/Q ($115 in chips)
Seat 2: NZ/5cxwnorKW2SNsWy1+8A ($10.05 in chips)
yBO+mXB6m/rCft2ErwGf/Q: posts small blind $0.25
NZ/5cxwnorKW2SNsWy1+8A: posts big blind $0.50
*** HOLE CARDS ***
yBO+mXB6m/rCft2ErwGf/Q: raises $1 to $1.50
NZ/5cxwnorKW2SNsWy1+8A: folds
yBO+mXB6m/rCft2ErwGf/Q collected $1 from pot
*** SUMMARY ***
Total pot $1 | Rake $0
Seat 1: yBO+mXB6m/rCft2ErwGf/Q (button) (small blind) collected ($1)
Seat 2: NZ/5cxwnorKW2SNsWy1+8A (big blind) folded before Flop



PokerStars Game #59939964600:  Hold'em No Limit ($0.25/$0.50) - 2009/07/01 0:53:38 ET
Table '+z1aekfHkpp09pc8F9aViw' 6-max Seat #3 is the button
Seat 1: FHilMb2i2DbUCc9lplszog ($47.05 in chips)
Seat 2: M6xK/VklCvdyyrmvzATlxQ ($34.50 in chips)
Seat 3: uUznlIMFnRUvwrBhYF73KA ($116.95 in chips)
Seat 4: RowCSpSURHTOL/dcjg/Iug ($42.05 in chips)
Seat 5: rplyldNweS6YyMNEALQrug ($12 in chips)
Seat 6: 686aeHikcJlgKkSuIFdcXQ ($50.75 in chips)
RowCSpSURHTOL/dcjg/Iug: posts small blind $0.25
rplyldNweS6YyMNEALQrug: posts big blind $0.50
*** HOLE CARDS ***
686aeHikcJlgKkSuIFdcXQ: folds
FHilMb2i2DbUCc9lplszog: folds
M6xK/VklCvdyyrmvzATlxQ: folds
uUznlIMFnRUvwrBhYF73KA: raises $0.50 to $1
RowCSpSURHTOL/dcjg/Iug: folds
rplyldNweS6YyMNEALQrug: calls $0.50
*** FLOP *** [2d 8h Kd]
rplyldNweS6YyMNEALQrug: checks
uUznlIMFnRUvwrBhYF73KA: checks
*** TURN *** [2d 8h Kd] [Qh]
rplyldNweS6YyMNEALQrug: checks
uUznlIMFnRUvwrBhYF73KA: checks
*** RIVER *** [2d 8h Kd Qh] [3h]
rplyldNweS6YyMNEALQrug: bets $2.50
uUznlIMFnRUvwrBhYF73KA: calls $2.50
*** SHOW DOWN ***
rplyldNweS6YyMNEALQrug: shows [5h 7h] (a flush, Queen high)
uUznlIMFnRUvwrBhYF73KA: mucks hand
rplyldNweS6YyMNEALQrug collected $6.90 from pot
*** SUMMARY ***
Total pot $7.25 | Rake $0.35
Board [2d 8h Kd Qh 3h]
Seat 1: FHilMb2i2DbUCc9lplszog folded before Flop (didn't bet)
Seat 2: M6xK/VklCvdyyrmvzATlxQ folded before Flop (didn't bet)
Seat 3: uUznlIMFnRUvwrBhYF73KA (button) mucked
Seat 4: RowCSpSURHTOL/dcjg/Iug (small blind) folded before Flop
Seat 5: rplyldNweS6YyMNEALQrug (big blind) showed [5h 7h] and won ($6.90) with a flush, Queen high
Seat 6: 686aeHikcJlgKkSuIFdcXQ folded before Flop (didn't bet)



PokerStars Game #59939967918:  Hold'em No Limit ($0.25/$0.50) - 2009/07/01 0:53:43 ET
Table '+dXkOAQyS8j9PQZusUTMpg' 2-max Seat #1 is the button
Seat 1: XFa6sBGjP2gxoIvxR3fZIg ($61.25 in chips)
Seat 2: 5IBeOgaApY1Bvzv2P8X4EA ($140.05 in chips)
XFa6sBGjP2gxoIvxR3fZIg: posts small blind $0.25
5IBeOgaApY1Bvzv2P8X4EA: posts big blind $0.50
*** HOLE CARDS ***
XFa6sBGjP2gxoIvxR3fZIg: raises $1 to $1.50
5IBeOgaApY1Bvzv2P8X4EA: folds
XFa6sBGjP2gxoIvxR3fZIg collected $1 from pot
XFa6sBGjP2gxoIvxR3fZIg: doesn't show hand
*** SUMMARY ***
Total pot $1 | Rake $0
Seat 1: XFa6sBGjP2gxoIvxR3fZIg (button) (small blind) collected ($1)
Seat 2: 5IBeOgaApY1Bvzv2P8X4EA (big blind) folded before Flop



PokerStars Game #59939967946:  Hold'em No Limit ($0.25/$0.50) - 2009/07/01 0:53:43 ET
Table '8BQGgNetI1NOvWeu3gtMNw' 2-max Seat #1 is the button
Seat 1: bypIyrYcAAifLfhZpGlKLA ($50 in chips)
Seat 2: Z4HwehErEwzsv/noQlfUlg ($117.20 in chips)
bypIyrYcAAifLfhZpGlKLA: posts small blind $0.25
Z4HwehErEwzsv/noQlfUlg: posts big blind $0.50
*** HOLE CARDS ***
bypIyrYcAAifLfhZpGlKLA: raises $1 to $1.50
Z4HwehErEwzsv/noQlfUlg: calls $1
*** FLOP *** [Qs 7c Tc]
Z4HwehErEwzsv/noQlfUlg: checks
bypIyrYcAAifLfhZpGlKLA: bets $2
Z4HwehErEwzsv/noQlfUlg: raises $4 to $6
bypIyrYcAAifLfhZpGlKLA: folds
Z4HwehErEwzsv/noQlfUlg collected $6.70 from pot
Z4HwehErEwzsv/noQlfUlg: doesn't show hand
*** SUMMARY ***
Total pot $7 | Rake $0.30
Board [Qs 7c Tc]
Seat 1: bypIyrYcAAifLfhZpGlKLA (button) (small blind) folded on the Flop
Seat 2: Z4HwehErEwzsv/noQlfUlg (big blind) collected ($6.70)



PokerStars Game #59939968322:  Hold'em No Limit ($0.25/$0.50) - 2009/07/01 0:53:44 ET
Table '0eJtgVAXVvBgncFdcUpXcQ' 2-max Seat #1 is the button
Seat 1: Ag6DvxX4vbRheqsv2zXKTQ ($42.55 in chips)
Seat 2: KMc4R+K9ao4Ur3rF7NGe6Q ($8.85 in chips)
Ag6DvxX4vbRheqsv2zXKTQ: posts small blind $0.25
KMc4R+K9ao4Ur3rF7NGe6Q: posts big blind $0.50
*** HOLE CARDS ***
Ag6DvxX4vbRheqsv2zXKTQ: folds
KMc4R+K9ao4Ur3rF7NGe6Q collected $0.50 from pot
KMc4R+K9ao4Ur3rF7NGe6Q: doesn't show hand
*** SUMMARY ***
Total pot $0.50 | Rake $0
Seat 1: Ag6DvxX4vbRheqsv2zXKTQ (button) (small blind) folded before Flop
Seat 2: KMc4R+K9ao4Ur3rF7NGe6Q (big blind) collected ($0.50)



PokerStars Game #59939968788:  Hold'em No Limit ($0.25/$0.50) - 2009/07/01 0:53:44 ET
Table 'BCN5su+SsXiy1zRMJi0SJw' 6-max Seat #2 is the button
Seat 1: GxXV09ciXaOxyY2H5aMIIw ($28.60 in chips)
Seat 2: oU2kDCkT/gilYbHWrg7D8w ($17.50 in chips)
Seat 5: IBNygaT1aa9Z1uPdJJilwA ($25.30 in chips)
Seat 6: b2symlOdL7+0c9Pj4N/KlA ($85.25 in chips)
6wzJiRvp8HY6t+MQGnSIzA will be allowed to play after the button
IBNygaT1aa9Z1uPdJJilwA: posts small blind $0.25
b2symlOdL7+0c9Pj4N/KlA: posts big blind $0.50
*** HOLE CARDS ***
GxXV09ciXaOxyY2H5aMIIw: folds
oU2kDCkT/gilYbHWrg7D8w: calls $0.50
IBNygaT1aa9Z1uPdJJilwA: folds
b2symlOdL7+0c9Pj4N/KlA: checks
*** FLOP *** [Tc As 4c]
b2symlOdL7+0c9Pj4N/KlA: checks
oU2kDCkT/gilYbHWrg7D8w: checks
*** TURN *** [Tc As 4c] [Ad]
qfeUHOJpMYyzQcj0o2A7ng joins the table at seat #4
b2symlOdL7+0c9Pj4N/KlA: checks
oU2kDCkT/gilYbHWrg7D8w: bets $1
b2symlOdL7+0c9Pj4N/KlA: folds
oU2kDCkT/gilYbHWrg7D8w collected $1.20 from pot
*** SUMMARY ***
Total pot $1.25 | Rake $0.05
Board [Tc As 4c Ad]
Seat 1: GxXV09ciXaOxyY2H5aMIIw folded before Flop (didn't bet)
Seat 2: oU2kDCkT/gilYbHWrg7D8w (button) collected ($1.20)
Seat 5: IBNygaT1aa9Z1uPdJJilwA (small blind) folded before Flop
Seat 6: b2symlOdL7+0c9Pj4N/KlA (big blind) folded on the Turn



PokerStars Game #59939970124:  Hold'em No Limit ($0.25/$0.50) - 2009/07/01 0:53:46 ET
Table 'Vdlc9wqYcHTUhtdyN7CuJw' 2-max Seat #2 is the button
Seat 1: yBO+mXB6m/rCft2ErwGf/Q ($115.50 in chips)
Seat 2: NZ/5cxwnorKW2SNsWy1+8A ($9.55 in chips)
NZ/5cxwnorKW2SNsWy1+8A: posts small blind $0.25
yBO+mXB6m/rCft2ErwGf/Q: posts big blind $0.50
*** HOLE CARDS ***
NZ/5cxwnorKW2SNsWy1+8A: calls $0.25
yBO+mXB6m/rCft2ErwGf/Q: checks
*** FLOP *** [9h 4d 3c]
yBO+mXB6m/rCft2ErwGf/Q: bets $0.50
NZ/5cxwnorKW2SNsWy1+8A: folds
yBO+mXB6m/rCft2ErwGf/Q collected $0.95 from pot
*** SUMMARY ***
Total pot $1 | Rake $0.05
Board [9h 4d 3c]
Seat 1: yBO+mXB6m/rCft2ErwGf/Q (big blind) collected ($0.95)
Seat 2: NZ/5cxwnorKW2SNsWy1+8A (button) (small blind) folded on the Flop



PokerStars Game #59939970422:  Hold'em No Limit ($0.25/$0.50) - 2009/07/01 0:53:47 ET
Table 'c/CRn+68J3Y8KxD5g1ek2Q' 2-max Seat #1 is the button
Seat 1: 46qCyJ6evTkHo9al5sBMNA ($85.65 in chips)
Seat 2: BypVLsYQt3ePFm2xQL/dOA ($285.45 in chips)
46qCyJ6evTkHo9al5sBMNA: posts small blind $0.25
BypVLsYQt3ePFm2xQL/dOA: posts big blind $0.50
*** HOLE CARDS ***
46qCyJ6evTkHo9al5sBMNA: raises $1.50 to $2
BypVLsYQt3ePFm2xQL/dOA: calls $1.50
*** FLOP *** [2d 6h Kc]
BypVLsYQt3ePFm2xQL/dOA: checks
46qCyJ6evTkHo9al5sBMNA: checks
*** TURN *** [2d 6h Kc] [9d]
BypVLsYQt3ePFm2xQL/dOA: bets $1.50
46qCyJ6evTkHo9al5sBMNA: calls $1.50
*** RIVER *** [2d 6h Kc 9d] [Td]
BypVLsYQt3ePFm2xQL/dOA: checks
46qCyJ6evTkHo9al5sBMNA: checks
*** SHOW DOWN ***
BypVLsYQt3ePFm2xQL/dOA: shows [Qh 8d] (high card King)
46qCyJ6evTkHo9al5sBMNA: shows [Tc Jc] (a pair of Tens)
46qCyJ6evTkHo9al5sBMNA collected $6.70 from pot
*** SUMMARY ***
Total pot $7 | Rake $0.30
Board [2d 6h Kc 9d Td]
Seat 1: 46qCyJ6evTkHo9al5sBMNA (button) (small blind) showed [Tc Jc] and won ($6.70) with a pair of Tens
Seat 2: BypVLsYQt3ePFm2xQL/dOA (big blind) showed [Qh 8d] and lost with high card King



PokerStars Game #59939971702:  Hold'em No Limit ($0.25/$0.50) - 2009/07/01 0:53:49 ET
Table 'QOgaEqMcJ73pcUMMxoisUg' 6-max Seat #6 is the button
Seat 1: /olYG0EzMWzADIgH1y2ySQ ($25.20 in chips)
Seat 2: 4QfsCWthT/vSLirorNXqtg ($50.75 in chips)
Seat 3: Rt6KgtZ8YaJoTc3FPim00w ($88.80 in chips)
Seat 4: zAcsDhG/T128Vn7XGVSgKg ($50.10 in chips)
Seat 5: 6vNxrjjCl6FwfaaymM9jjg ($33.55 in chips)
Seat 6: GoVjFxr3C+JO9vtJH9+IcA ($25.90 in chips)
/olYG0EzMWzADIgH1y2ySQ: posts small blind $0.25
4QfsCWthT/vSLirorNXqtg: posts big blind $0.50
*** HOLE CARDS ***
Rt6KgtZ8YaJoTc3FPim00w: folds
zAcsDhG/T128Vn7XGVSgKg: folds
6vNxrjjCl6FwfaaymM9jjg: folds
GoVjFxr3C+JO9vtJH9+IcA: folds
/olYG0EzMWzADIgH1y2ySQ: calls $0.25
4QfsCWthT/vSLirorNXqtg: checks
*** FLOP *** [Ts Jh 9c]
/olYG0EzMWzADIgH1y2ySQ: checks
4QfsCWthT/vSLirorNXqtg: checks
*** TURN *** [Ts Jh 9c] [Qh]
/olYG0EzMWzADIgH1y2ySQ: checks
4QfsCWthT/vSLirorNXqtg: bets $0.75
/olYG0EzMWzADIgH1y2ySQ: raises $2.25 to $3
4QfsCWthT/vSLirorNXqtg: calls $2.25
*** RIVER *** [Ts Jh 9c Qh] [5d]
/olYG0EzMWzADIgH1y2ySQ: checks
4QfsCWthT/vSLirorNXqtg: bets $5
/olYG0EzMWzADIgH1y2ySQ: folds
4QfsCWthT/vSLirorNXqtg collected $6.70 from pot
*** SUMMARY ***
Total pot $7 | Rake $0.30
Board [Ts Jh 9c Qh 5d]
Seat 1: /olYG0EzMWzADIgH1y2ySQ (small blind) folded on the River
Seat 2: 4QfsCWthT/vSLirorNXqtg (big blind) collected ($6.70)
Seat 3: Rt6KgtZ8YaJoTc3FPim00w folded before Flop (didn't bet)
Seat 4: zAcsDhG/T128Vn7XGVSgKg folded before Flop (didn't bet)
Seat 5: 6vNxrjjCl6FwfaaymM9jjg folded before Flop (didn't bet)
Seat 6: GoVjFxr3C+JO9vtJH9+IcA (button) folded before Flop (didn't bet)



PokerStars Game #59939973108:  Hold'em No Limit ($0.25/$0.50) - 2009/07/01 0:53:51 ET
Table '+dXkOAQyS8j9PQZusUTMpg' 2-max Seat #2 is the button
Seat 1: XFa6sBGjP2gxoIvxR3fZIg ($61.75 in chips)
Seat 2: 5IBeOgaApY1Bvzv2P8X4EA ($139.55 in chips)
5IBeOgaApY1Bvzv2P8X4EA: posts small blind $0.25
XFa6sBGjP2gxoIvxR3fZIg: posts big blind $0.50
*** HOLE CARDS ***
5IBeOgaApY1Bvzv2P8X4EA: folds
XFa6sBGjP2gxoIvxR3fZIg collected $0.50 from pot
XFa6sBGjP2gxoIvxR3fZIg: doesn't show hand
*** SUMMARY ***
Total pot $0.50 | Rake $0
Seat 1: XFa6sBGjP2gxoIvxR3fZIg (big blind) collected ($0.50)
Seat 2: 5IBeOgaApY1Bvzv2P8X4EA (button) (small blind) folded before Flop



PokerStars Game #59939972658:  Hold'em No Limit ($0.25/$0.50) - 2009/07/01 0:53:51 ET
Table 'Nz0Vr7WMHL2g5Uk7dDZjpw' 9-max Seat #7 is the button
Seat 1: tLkxo7JgV+WWI0UBw44K5A ($109.85 in chips)
Seat 2: XNMDwbXt/Q4jM99AXnbJDw ($67.35 in chips)
Seat 3: uw9QayAAxLM3Hb+HR7mSkg ($10 in chips)
Seat 4: 75K2MXwN65Sjfp1yHd50Hg ($9.25 in chips)
Seat 5: WGW0DgjBUXs1ylURHG8vnQ ($27.50 in chips)
Seat 6: 997ViqAtWn1FPjJqcffwcA ($61.30 in chips)
Seat 7: KPLH0gELgFe2OuAnhJFI5w ($19.35 in chips)
Seat 8: HkZI6g4zl83TDTA7SRspmQ ($16.60 in chips)
Seat 9: mSD1pginDsyHG5PDfqzphw ($10 in chips)
HkZI6g4zl83TDTA7SRspmQ: posts small blind $0.25
mSD1pginDsyHG5PDfqzphw: posts big blind $0.50
*** HOLE CARDS ***
tLkxo7JgV+WWI0UBw44K5A: folds
XNMDwbXt/Q4jM99AXnbJDw: folds
uw9QayAAxLM3Hb+HR7mSkg: raises $9.50 to $10 and is all-in
75K2MXwN65Sjfp1yHd50Hg: folds
WGW0DgjBUXs1ylURHG8vnQ: folds
997ViqAtWn1FPjJqcffwcA: folds
KPLH0gELgFe2OuAnhJFI5w: folds
HkZI6g4zl83TDTA7SRspmQ: folds
mSD1pginDsyHG5PDfqzphw: folds
uw9QayAAxLM3Hb+HR7mSkg collected $1.25 from pot
uw9QayAAxLM3Hb+HR7mSkg: doesn't show hand
*** SUMMARY ***
Total pot $1.25 | Rake $0
Seat 1: tLkxo7JgV+WWI0UBw44K5A folded before Flop (didn't bet)
Seat 2: XNMDwbXt/Q4jM99AXnbJDw folded before Flop (didn't bet)
Seat 3: uw9QayAAxLM3Hb+HR7mSkg collected ($1.25)
Seat 4: 75K2MXwN65Sjfp1yHd50Hg folded before Flop (didn't bet)
Seat 5: WGW0DgjBUXs1ylURHG8vnQ folded before Flop (didn't bet)
Seat 6: 997ViqAtWn1FPjJqcffwcA folded before Flop (didn't bet)
Seat 7: KPLH0gELgFe2OuAnhJFI5w (button) folded before Flop (didn't bet)
Seat 8: HkZI6g4zl83TDTA7SRspmQ (small blind) folded before Flop
Seat 9: mSD1pginDsyHG5PDfqzphw (big blind) folded before Flop



PokerStars Game #59939973346:  Hold'em No Limit ($0.25/$0.50) - 2009/07/01 0:53:52 ET
Table '0eJtgVAXVvBgncFdcUpXcQ' 2-max Seat #2 is the button
Seat 1: Ag6DvxX4vbRheqsv2zXKTQ ($42.30 in chips)
Seat 2: KMc4R+K9ao4Ur3rF7NGe6Q ($9.10 in chips)
KMc4R+K9ao4Ur3rF7NGe6Q: posts small blind $0.25
Ag6DvxX4vbRheqsv2zXKTQ: posts big blind $0.50
*** HOLE CARDS ***
KMc4R+K9ao4Ur3rF7NGe6Q: calls $0.25
Ag6DvxX4vbRheqsv2zXKTQ: checks
*** FLOP *** [4s 2h 4h]
Ag6DvxX4vbRheqsv2zXKTQ: bets $0.50
KMc4R+K9ao4Ur3rF7NGe6Q: raises $0.50 to $1
Ag6DvxX4vbRheqsv2zXKTQ: calls $0.50
*** TURN *** [4s 2h 4h] [3s]
Ag6DvxX4vbRheqsv2zXKTQ: checks
KMc4R+K9ao4Ur3rF7NGe6Q: bets $1.50
Ag6DvxX4vbRheqsv2zXKTQ: calls $1.50
*** RIVER *** [4s 2h 4h 3s] [Th]
Ag6DvxX4vbRheqsv2zXKTQ: checks
KMc4R+K9ao4Ur3rF7NGe6Q: bets $2
Ag6DvxX4vbRheqsv2zXKTQ: folds
KMc4R+K9ao4Ur3rF7NGe6Q collected $5.75 from pot
KMc4R+K9ao4Ur3rF7NGe6Q: doesn't show hand
*** SUMMARY ***
Total pot $6 | Rake $0.25
Board [4s 2h 4h 3s Th]
Seat 1: Ag6DvxX4vbRheqsv2zXKTQ (big blind) folded on the River
Seat 2: KMc4R+K9ao4Ur3rF7NGe6Q (button) (small blind) collected ($5.75)



PokerStars Game #59939974426:  Hold'em No Limit ($0.25/$0.50) - 2009/07/01 0:53:53 ET
Table 'NHLx+ggeIlZy3D6oDgC0yg' 2-max Seat #2 is the button
Seat 1: Fp/oksNpipCrD2MJ2pH20g ($22.70 in chips)
Seat 2: DHMk3is1XNc/OjPVB8NJ5w ($50 in chips)
DHMk3is1XNc/OjPVB8NJ5w: posts small blind $0.25
Fp/oksNpipCrD2MJ2pH20g: posts big blind $0.50
*** HOLE CARDS ***
DHMk3is1XNc/OjPVB8NJ5w: folds
Fp/oksNpipCrD2MJ2pH20g collected $0.50 from pot
Fp/oksNpipCrD2MJ2pH20g: doesn't show hand
*** SUMMARY ***
Total pot $0.50 | Rake $0
Seat 1: Fp/oksNpipCrD2MJ2pH20g (big blind) collected ($0.50)
Seat 2: DHMk3is1XNc/OjPVB8NJ5w (button) (small blind) folded before Flop



PokerStars Game #59939976228:  Hold'em No Limit ($0.25/$0.50) - 2009/07/01 0:53:56 ET
Table 'lpxYasB1ClBSgTpCCITwhQ' 9-max Seat #1 is the button
Seat 1: mj7PS7wCH4PAl7+eYTFs7A ($46.40 in chips)
Seat 2: OWP/DOu+PlPK6ZZ3zYa0HA ($24.35 in chips)
Seat 4: NnQCepdIR/AOUQn1yhYx6Q ($10 in chips)
Seat 5: IYd5zG8k7vdBNVHbHg2Pag ($38.10 in chips)
Seat 6: SegjDnMxWMujiD57ESNL+g ($6.25 in chips)
Seat 7: bmRtaIYKthN1F+B3JLZ3Jw ($29.15 in chips)
Seat 8: /mfensKw8/iZ1Vrx33S4xg ($10 in chips)
Seat 9: XNMDwbXt/Q4jM99AXnbJDw ($50.50 in chips)
OWP/DOu+PlPK6ZZ3zYa0HA: posts small blind $0.25
cDNz32Scry3j+v2+kE3pHg: is sitting out
NnQCepdIR/AOUQn1yhYx6Q: posts big blind $0.50
*** HOLE CARDS ***
IYd5zG8k7vdBNVHbHg2Pag: folds
cDNz32Scry3j+v2+kE3pHg leaves the table
SegjDnMxWMujiD57ESNL+g: raises $5.75 to $6.25 and is all-in
bmRtaIYKthN1F+B3JLZ3Jw: folds
/mfensKw8/iZ1Vrx33S4xg: folds
XNMDwbXt/Q4jM99AXnbJDw: folds
caleb505 joins the table at seat #3
mj7PS7wCH4PAl7+eYTFs7A: folds
OWP/DOu+PlPK6ZZ3zYa0HA: folds
NnQCepdIR/AOUQn1yhYx6Q: folds
SegjDnMxWMujiD57ESNL+g collected $1.25 from pot
SegjDnMxWMujiD57ESNL+g: doesn't show hand
*** SUMMARY ***
Total pot $1.25 | Rake $0
Seat 1: mj7PS7wCH4PAl7+eYTFs7A (button) folded before Flop (didn't bet)
Seat 2: OWP/DOu+PlPK6ZZ3zYa0HA (small blind) folded before Flop
Seat 4: NnQCepdIR/AOUQn1yhYx6Q (big blind) folded before Flop
Seat 5: IYd5zG8k7vdBNVHbHg2Pag folded before Flop (didn't bet)
Seat 6: SegjDnMxWMujiD57ESNL+g collected ($1.25)
Seat 7: bmRtaIYKthN1F+B3JLZ3Jw folded before Flop (didn't bet)
Seat 8: /mfensKw8/iZ1Vrx33S4xg folded before Flop (didn't bet)
Seat 9: XNMDwbXt/Q4jM99AXnbJDw folded before Flop (didn't bet)



PokerStars Game #59939976790:  Hold'em No Limit ($0.25/$0.50) - 2009/07/01 0:53:57 ET
Table '5EmHi+fnatGQQShcNmzOZQ' 6-max Seat #4 is the button
Seat 1: HGzUMAFxR1k8+S4gfnB39w ($31.60 in chips)
Seat 3: TjmTe3bhs9dFz5gXX9x7Lw ($23.50 in chips)
Seat 4: 1b+2BbjMN8qhR1WPqdE9VQ ($68.80 in chips)
Seat 5: kxPhs4ePFqMy52CInAJ2aw ($49.25 in chips)
Seat 6: 686aeHikcJlgKkSuIFdcXQ ($132.70 in chips)
kxPhs4ePFqMy52CInAJ2aw: posts small blind $0.25
686aeHikcJlgKkSuIFdcXQ: posts big blind $0.50
*** HOLE CARDS ***
HGzUMAFxR1k8+S4gfnB39w: folds
TjmTe3bhs9dFz5gXX9x7Lw: calls $0.50
1b+2BbjMN8qhR1WPqdE9VQ: folds
kxPhs4ePFqMy52CInAJ2aw: raises $2.50 to $3
686aeHikcJlgKkSuIFdcXQ: folds
TjmTe3bhs9dFz5gXX9x7Lw: calls $2.50
*** FLOP *** [3s Jd Qs]
kxPhs4ePFqMy52CInAJ2aw: bets $5
TjmTe3bhs9dFz5gXX9x7Lw: folds
kxPhs4ePFqMy52CInAJ2aw collected $6.20 from pot
kxPhs4ePFqMy52CInAJ2aw: doesn't show hand
*** SUMMARY ***
Total pot $6.50 | Rake $0.30
Board [3s Jd Qs]
Seat 1: HGzUMAFxR1k8+S4gfnB39w folded before Flop (didn't bet)
Seat 3: TjmTe3bhs9dFz5gXX9x7Lw folded on the Flop
Seat 4: 1b+2BbjMN8qhR1WPqdE9VQ (button) folded before Flop (didn't bet)
Seat 5: kxPhs4ePFqMy52CInAJ2aw (small blind) collected ($6.20)
Seat 6: 686aeHikcJlgKkSuIFdcXQ (big blind) folded before Flop



PokerStars Game #59939977820:  Hold'em No Limit ($0.25/$0.50) - 2009/07/01 0:53:59 ET
Table '+dXkOAQyS8j9PQZusUTMpg' 2-max Seat #1 is the button
Seat 1: XFa6sBGjP2gxoIvxR3fZIg ($62 in chips)
Seat 2: 5IBeOgaApY1Bvzv2P8X4EA ($139.30 in chips)
XFa6sBGjP2gxoIvxR3fZIg: posts small blind $0.25
5IBeOgaApY1Bvzv2P8X4EA: posts big blind $0.50
*** HOLE CARDS ***
XFa6sBGjP2gxoIvxR3fZIg: raises $1 to $1.50
5IBeOgaApY1Bvzv2P8X4EA: calls $1
*** FLOP *** [Ah 7h 9s]
5IBeOgaApY1Bvzv2P8X4EA: checks
XFa6sBGjP2gxoIvxR3fZIg: checks
*** TURN *** [Ah 7h 9s] [5h]
5IBeOgaApY1Bvzv2P8X4EA: bets $1
XFa6sBGjP2gxoIvxR3fZIg: calls $1
*** RIVER *** [Ah 7h 9s 5h] [7d]
5IBeOgaApY1Bvzv2P8X4EA: bets $1
XFa6sBGjP2gxoIvxR3fZIg: calls $1
*** SHOW DOWN ***
5IBeOgaApY1Bvzv2P8X4EA: shows [9d Ts] (two pair, Nines and Sevens)
XFa6sBGjP2gxoIvxR3fZIg: shows [Ac 6c] (two pair, Aces and Sevens)
XFa6sBGjP2gxoIvxR3fZIg collected $6.70 from pot
*** SUMMARY ***
Total pot $7 | Rake $0.30
Board [Ah 7h 9s 5h 7d]
Seat 1: XFa6sBGjP2gxoIvxR3fZIg (button) (small blind) showed [Ac 6c] and won ($6.70) with two pair, Aces and Sevens
Seat 2: 5IBeOgaApY1Bvzv2P8X4EA (big blind) showed [9d Ts] and lost with two pair, Nines and Sevens



PokerStars Game #59939979138:  Hold'em No Limit ($0.25/$0.50) - 2009/07/01 0:54:01 ET
Table 'fx6MqwfYAj/Rt86hBz2L3Q' 9-max Seat #6 is the button
Seat 1: SegjDnMxWMujiD57ESNL+g ($9 in chips)
Seat 3: iadBi5AEt7gTBXbDSSnMYQ ($76 in chips)
Seat 5: iAISe3dVeua8PUn2wwgDHw ($31.50 in chips)
Seat 6: 5k9fvXD9suIgCxU4HLQjTw ($50 in chips)
Seat 7: SKnJuWHScqetA/qG5p+wCg ($30 in chips)
Seat 8: JYwJYYV9pM5KWdSiETl8rA ($27.25 in chips)
Seat 9: HZkVla4kK2SI42CVrPZ/ig ($11 in chips)
SKnJuWHScqetA/qG5p+wCg: posts small blind $0.25
JYwJYYV9pM5KWdSiETl8rA: posts big blind $0.50
75K2MXwN65Sjfp1yHd50Hg: sits out
*** HOLE CARDS ***
HZkVla4kK2SI42CVrPZ/ig: calls $0.50
SegjDnMxWMujiD57ESNL+g: folds
iadBi5AEt7gTBXbDSSnMYQ: raises $1 to $1.50
iAISe3dVeua8PUn2wwgDHw: calls $1.50
5k9fvXD9suIgCxU4HLQjTw: folds
SKnJuWHScqetA/qG5p+wCg: folds
JYwJYYV9pM5KWdSiETl8rA: folds
HZkVla4kK2SI42CVrPZ/ig: raises $9.50 to $11 and is all-in
iadBi5AEt7gTBXbDSSnMYQ: folds
iAISe3dVeua8PUn2wwgDHw: folds
HZkVla4kK2SI42CVrPZ/ig collected $5.25 from pot
HZkVla4kK2SI42CVrPZ/ig: doesn't show hand
*** SUMMARY ***
Total pot $5.25 | Rake $0
Seat 1: SegjDnMxWMujiD57ESNL+g folded before Flop (didn't bet)
Seat 3: iadBi5AEt7gTBXbDSSnMYQ folded before Flop
Seat 5: iAISe3dVeua8PUn2wwgDHw folded before Flop
Seat 6: 5k9fvXD9suIgCxU4HLQjTw (button) folded before Flop (didn't bet)
Seat 7: SKnJuWHScqetA/qG5p+wCg (small blind) folded before Flop
Seat 8: JYwJYYV9pM5KWdSiETl8rA (big blind) folded before Flop
Seat 9: HZkVla4kK2SI42CVrPZ/ig collected ($5.25)



PokerStars Game #59939980930:  Hold'em No Limit ($0.25/$0.50) - 2009/07/01 0:54:04 ET
Table 'E7bWJ45aoFXRpyRv2gw+Ig' 2-max Seat #2 is the button
Seat 1: FRkiRasEGlHUeLrEl+k/nA ($116.50 in chips)
Seat 2: 3Wro85I7472vJ4Wkpneo9A ($75.70 in chips)
3Wro85I7472vJ4Wkpneo9A: posts small blind $0.25
FRkiRasEGlHUeLrEl+k/nA: posts big blind $0.50
*** HOLE CARDS ***
3Wro85I7472vJ4Wkpneo9A: raises $1 to $1.50
FRkiRasEGlHUeLrEl+k/nA: folds
3Wro85I7472vJ4Wkpneo9A collected $1 from pot
3Wro85I7472vJ4Wkpneo9A: doesn't show hand
*** SUMMARY ***
Total pot $1 | Rake $0
Seat 1: FRkiRasEGlHUeLrEl+k/nA (big blind) folded before Flop
Seat 2: 3Wro85I7472vJ4Wkpneo9A (button) (small blind) collected ($1)



PokerStars Game #59939981106:  Hold'em No Limit ($0.25/$0.50) - 2009/07/01 0:54:04 ET
Table '8BQGgNetI1NOvWeu3gtMNw' 2-max Seat #2 is the button
Seat 1: bypIyrYcAAifLfhZpGlKLA ($50 in chips)
Seat 2: Z4HwehErEwzsv/noQlfUlg ($120.40 in chips)
Z4HwehErEwzsv/noQlfUlg: posts small blind $0.25
bypIyrYcAAifLfhZpGlKLA: posts big blind $0.50
*** HOLE CARDS ***
Z4HwehErEwzsv/noQlfUlg: raises $1.50 to $2
bypIyrYcAAifLfhZpGlKLA: folds
Z4HwehErEwzsv/noQlfUlg collected $1 from pot
Z4HwehErEwzsv/noQlfUlg: doesn't show hand
*** SUMMARY ***
Total pot $1 | Rake $0
Seat 1: bypIyrYcAAifLfhZpGlKLA (big blind) folded before Flop
Seat 2: Z4HwehErEwzsv/noQlfUlg (button) (small blind) collected ($1)



PokerStars Game #59939981608:  Hold'em No Limit ($0.25/$0.50) - 2009/07/01 0:54:05 ET
Table 'kgbJRsxfv64KrErDRBAkcw' 6-max Seat #5 is the button
Seat 1: w2dj3tZyWCX7+wEKRi0AVw ($15.35 in chips)
Seat 2: AdS8BJMOheS01zjCDfPMFg ($49 in chips)
Seat 3: c4MNIaIyPMOMxrgT8FT5nA ($126.65 in chips)
Seat 4: qanMEqjABjWxC/JgQ/0l7w ($58 in chips)
Seat 5: eUBBn2R56C1IQ6Cs/vitwg ($50 in chips)
Seat 6: 1b+2BbjMN8qhR1WPqdE9VQ ($50 in chips)
1b+2BbjMN8qhR1WPqdE9VQ: posts small blind $0.25
w2dj3tZyWCX7+wEKRi0AVw: posts big blind $0.50
*** HOLE CARDS ***
AdS8BJMOheS01zjCDfPMFg: folds
c4MNIaIyPMOMxrgT8FT5nA: calls $0.50
qanMEqjABjWxC/JgQ/0l7w: folds
eUBBn2R56C1IQ6Cs/vitwg: folds
1b+2BbjMN8qhR1WPqdE9VQ: folds
w2dj3tZyWCX7+wEKRi0AVw: checks
*** FLOP *** [9h Tc Qc]
w2dj3tZyWCX7+wEKRi0AVw: checks
c4MNIaIyPMOMxrgT8FT5nA: bets $1.50
w2dj3tZyWCX7+wEKRi0AVw: folds
c4MNIaIyPMOMxrgT8FT5nA collected $1.20 from pot
c4MNIaIyPMOMxrgT8FT5nA: doesn't show hand
*** SUMMARY ***
Total pot $1.25 | Rake $0.05
Board [9h Tc Qc]
Seat 1: w2dj3tZyWCX7+wEKRi0AVw (big blind) folded on the Flop
Seat 2: AdS8BJMOheS01zjCDfPMFg folded before Flop (didn't bet)
Seat 3: c4MNIaIyPMOMxrgT8FT5nA collected ($1.20)
Seat 4: qanMEqjABjWxC/JgQ/0l7w folded before Flop (didn't bet)
Seat 5: eUBBn2R56C1IQ6Cs/vitwg (button) folded before Flop (didn't bet)
Seat 6: 1b+2BbjMN8qhR1WPqdE9VQ (small blind) folded before Flop



PokerStars Game #59939981492:  Hold'em No Limit ($0.25/$0.50) - 2009/07/01 0:54:05 ET
Table '/cQuAT3ef4t+PGrXiNhGaQ' 9-max Seat #2 is the button
Seat 1: HZkVla4kK2SI42CVrPZ/ig ($15.50 in chips)
Seat 2: jXGruyaMqirTaTXNOvBdew ($72.45 in chips)
Seat 3: g4k0NXISyLCqaSWZDBjfEg ($54.75 in chips)
Seat 4: OWP/DOu+PlPK6ZZ3zYa0HA ($26.40 in chips)
Seat 5: 5SgaHdWixdClWvaEG+KUjQ ($24.10 in chips)
Seat 6: APYIOyK/4AGb+kIwlOUNBQ ($37.25 in chips)
Seat 7: J0W5D97jl5VLky+IoPvDeA ($111.40 in chips)
Seat 8: eBrej2jnlUCs/JgxFCRn2g ($40 in chips)
Seat 9: AjV5McH1KMMclY26QdLM5w ($26.45 in chips)
g4k0NXISyLCqaSWZDBjfEg: posts small blind $0.25
OWP/DOu+PlPK6ZZ3zYa0HA: posts big blind $0.50
*** HOLE CARDS ***
5SgaHdWixdClWvaEG+KUjQ: folds
APYIOyK/4AGb+kIwlOUNBQ: folds
J0W5D97jl5VLky+IoPvDeA: folds
eBrej2jnlUCs/JgxFCRn2g: folds
AjV5McH1KMMclY26QdLM5w: folds
HZkVla4kK2SI42CVrPZ/ig: folds
jXGruyaMqirTaTXNOvBdew: folds
g4k0NXISyLCqaSWZDBjfEg: folds
OWP/DOu+PlPK6ZZ3zYa0HA collected $0.50 from pot
OWP/DOu+PlPK6ZZ3zYa0HA: doesn't show hand
*** SUMMARY ***
Total pot $0.50 | Rake $0
Seat 1: HZkVla4kK2SI42CVrPZ/ig folded before Flop (didn't bet)
Seat 2: jXGruyaMqirTaTXNOvBdew (button) folded before Flop (didn't bet)
Seat 3: g4k0NXISyLCqaSWZDBjfEg (small blind) folded before Flop
Seat 4: OWP/DOu+PlPK6ZZ3zYa0HA (big blind) collected ($0.50)
Seat 5: 5SgaHdWixdClWvaEG+KUjQ folded before Flop (didn't bet)
Seat 6: APYIOyK/4AGb+kIwlOUNBQ folded before Flop (didn't bet)
Seat 7: J0W5D97jl5VLky+IoPvDeA folded before Flop (didn't bet)
Seat 8: eBrej2jnlUCs/JgxFCRn2g folded before Flop (didn't bet)
Seat 9: AjV5McH1KMMclY26QdLM5w folded before Flop (didn't bet)



PokerStars Game #59939982738:  Hold'em No Limit ($0.25/$0.50) - 2009/07/01 0:54:07 ET
Table '99gCy/CZQwPIjZWH+BguQgE7bWJ45aoFXRpyRv2gw+Igeat #3 is the button
Seat 2: n6VQBu6crjYjy6DxNP1NZA ($28.75 in chips)
Seat 3: qEn9ijNGtuyTxamBf07hYg ($50 in chips)
Seat 4: bxLSulbgr8LmKNjOzw8URg ($60.95 in chips)
Seat 5: DSM67hHHq1XFoEOi9p8Alw ($46 in chips)
Seat 7: bfSq6LBw0UvxeM5yfuWC7w ($17.10 in chips)
Seat 8: 8ehL7qlZzjgUh2H35iiWLw ($52.50 in chips)
Seat 9: j3K/Jujr7PY4ZM2RZvlH6A ($99.60 in chips)
bxLSulbgr8LmKNjOzw8URg: posts small blind $0.25
DSM67hHHq1XFoEOi9p8Alw: posts big blind $0.50
*** HOLE CARDS ***
bfSq6LBw0UvxeM5yfuWC7w: folds
8ehL7qlZzjgUh2H35iiWLw: folds
j3K/Jujr7PY4ZM2RZvlH6A: raises $1 to $1.50
n6VQBu6crjYjy6DxNP1NZA: folds
qEn9ijNGtuyTxamBf07hYg: folds
bxLSulbgr8LmKNjOzw8URg: folds
DSM67hHHq1XFoEOi9p8Alw: calls $1
*** FLOP *** [2s Tc 3s]
DSM67hHHq1XFoEOi9p8Alw: checks
j3K/Jujr7PY4ZM2RZvlH6A: bets $5
DSM67hHHq1XFoEOi9p8Alw: folds
j3K/Jujr7PY4ZM2RZvlH6A collected $3.10 from pot
j3K/Jujr7PY4ZM2RZvlH6A: doesn't show hand
*** SUMMARY ***
Total pot $3.25 | Rake $0.15
Board [2s Tc 3s]
Seat 2: n6VQBu6crjYjy6DxNP1NZA folded before Flop (didn't bet)
Seat 3: qEn9ijNGtuyTxamBf07hYg (button) folded before Flop (didn't bet)
Seat 4: bxLSulbgr8LmKNjOzw8URg (small blind) folded before Flop
Seat 5: DSM67hHHq1XFoEOi9p8Alw (big blind) folded on the Flop
Seat 7: bfSq6LBw0UvxeM5yfuWC7w folded before Flop (didn't bet)
Seat 8: 8ehL7qlZzjgUh2H35iiWLw folded before Flop (didn't bet)
Seat 9: j3K/Jujr7PY4ZM2RZvlH6A collected ($3.10)



PokerStars Game #59939983740:  Hold'em No Limit ($0.25/$0.50) - 2009/07/01 0:54:08 ET
Table 'NCiXr0d5CEKBQr/cZgLhbA' 9-max Seat #9 is the button
Seat 1: pFtzb1sR4b0d1aw6aIRgDg ($50.25 in chips)
Seat 2: ulxuJchBV9iguXg0FUonfg ($47.75 in chips)
Seat 3: xZCXQSXlrZkp3pZizzVXCw ($52.25 in chips)
Seat 4: 5k9fvXD9suIgCxU4HLQjTw ($55.95 in chips)
Seat 5: zE9cVigS2nW/Ljy4K4bUQA ($34.45 in chips)
Seat 6: SKnJuWHScqetA/qG5p+wCg ($34.75 in chips)
Seat 7: M+7+BTmX5vZatHVuoRB1nA ($52 in chips)
Seat 8: 1MJUKc3cc0QmUoz1JZLR2w ($58.25 in chips)
Seat 9: 4WLZvqBn5qv5tds5kt5A1Q ($44.80 in chips)
pFtzb1sR4b0d1aw6aIRgDg: posts small blind $0.25
ulxuJchBV9iguXg0FUonfg: posts big blind $0.50
*** HOLE CARDS ***
xZCXQSXlrZkp3pZizzVXCw: folds
5k9fvXD9suIgCxU4HLQjTw: folds
zE9cVigS2nW/Ljy4K4bUQA: folds
SKnJuWHScqetA/qG5p+wCg: folds
M+7+BTmX5vZatHVuoRB1nA: folds
1MJUKc3cc0QmUoz1JZLR2w: folds
4WLZvqBn5qv5tds5kt5A1Q: calls $0.50
pFtzb1sR4b0d1aw6aIRgDg: folds
ulxuJchBV9iguXg0FUonfg: checks
*** FLOP *** [Ts 9s Js]
ulxuJchBV9iguXg0FUonfg: checks
4WLZvqBn5qv5tds5kt5A1Q: bets $1
ulxuJchBV9iguXg0FUonfg: folds
4WLZvqBn5qv5tds5kt5A1Q collected $1.20 from pot
*** SUMMARY ***
Total pot $1.25 | Rake $0.05
Board [Ts 9s Js]
Seat 1: pFtzb1sR4b0d1aw6aIRgDg (small blind) folded before Flop
Seat 2: ulxuJchBV9iguXg0FUonfg (big blind) folded on the Flop
Seat 3: xZCXQSXlrZkp3pZizzVXCw folded before Flop (didn't bet)
Seat 4: 5k9fvXD9suIgCxU4HLQjTw folded before Flop (didn't bet)
Seat 5: zE9cVigS2nW/Ljy4K4bUQA folded before Flop (didn't bet)
Seat 6: SKnJuWHScqetA/qG5p+wCg folded before Flop (didn't bet)
Seat 7: M+7+BTmX5vZatHVuoRB1nA folded before Flop (didn't bet)
Seat 8: 1MJUKc3cc0QmUoz1JZLR2w folded before Flop (didn't bet)
Seat 9: 4WLZvqBn5qv5tds5kt5A1Q (button) collected ($1.20)



PokerStars Game #59939984180:  Hold'em No Limit ($0.25/$0.50) - 2009/07/01 0:54:09 ET
Table 'QOgaEqMcJ73pcUMMxoisUgErOuyGLI5PT3G5MnpHgC/g Seat #5 is the button
Seat 3: xZCXQSXlrZkp3pZizzVXCw ($49.50 in chips)
Seat 4: 3UmXLy3GfjC3EkOebduerQ ($50.45 in chips)
Seat 5: JwvquocWfhTVApN5t47LgA ($63.35 in chips)
Seat 6: zE9cVigS2nW/Ljy4K4bUQA ($30 in chips)
Seat 7: 90Wb75h3W1BRpbqVnuk8gw ($63.55 in chips)
Seat 8: g4k0NXISyLCqaSWZDBjfEg ($50 in chips)
Seat 9: J0W5D97jl5VLky+IoPvDeA ($53.15 in chips)
zE9cVigS2nW/Ljy4K4bUQA: posts small blind $0.25
90Wb75h3W1BRpbqVnuk8gw: posts big blind $0.50
eBrej2jnlUCs/JgxFCRn2g: sits out
*** HOLE CARDS ***
g4k0NXISyLCqaSWZDBjfEg: folds
J0W5D97jl5VLky+IoPvDeA: folds
xZCXQSXlrZkp3pZizzVXCw: folds
3UmXLy3GfjC3EkOebduerQ: folds
JwvquocWfhTVApN5t47LgA: folds
zE9cVigS2nW/Ljy4K4bUQA: folds
90Wb75h3W1BRpbqVnuk8gw collected $0.50 from pot
*** SUMMARY ***
Total pot $0.50 | Rake $0
Seat 3: xZCXQSXlrZkp3pZizzVXCw folded before Flop (didn't bet)
Seat 4: 3UmXLy3GfjC3EkOebduerQ folded before Flop (didn't bet)
Seat 5: JwvquocWfhTVApN5t47LgA (button) folded before Flop (didn't bet)
Seat 6: zE9cVigS2nW/Ljy4K4bUQA (small blind) folded before Flop
Seat 7: 90Wb75h3W1BRpbqVnuk8gw (big blind) collected ($0.50)
Seat 8: g4k0NXISyLCqaSWZDBjfEg folded before Flop (didn't bet)
Seat 9: J0W5D97jl5VLky+IoPvDeA folded before Flop (didn't bet)



PokerStars Game #59939984904:  Hold'em No Limit ($0.25/$0.50) - 2009/07/01 0:54:10 ET
Table 'lSisgp6H7Fg1hH5VfjEjYQ' 9-max Seat #6 is the button
Seat 1: 5k9fvXD9suIgCxU4HLQjTw ($50 in chips)
Seat 2: UrcnkQOiLVk8BlKDPJSy7Q ($76.10 in chips)
Seat 3: aTkyjTh3w5YLWiIERupZOA ($51.20 in chips)
Seat 4: bwv/rbH/hHhPhY6u9mu04w ($33.60 in chips)
Seat 5: mSD1pginDsyHG5PDfqzphw ($12.60 in chips)
Seat 6: +k7T5ocke8UwavtgUHm+Cg ($51.40 in chips)
Seat 7: IDtNLR9uFCDdjNsJWMHA5Q ($20.10 in chips)
Seat 8: a4JDWmpFQkL10XfAyuF51A ($30.50 in chips)
Seat 9: gsyXT42WLEcOS4DdEk2wlw ($42.10 in chips)
IDtNLR9uFCDdjNsJWMHA5Q: posts small blind $0.25
a4JDWmpFQkL10XfAyuF51A: posts big blind $0.50
*** HOLE CARDS ***
gsyXT42WLEcOS4DdEk2wlw: folds
5k9fvXD9suIgCxU4HLQjTw: folds
UrcnkQOiLVk8BlKDPJSy7Q: folds
aTkyjTh3w5YLWiIERupZOA: folds
bwv/rbH/hHhPhY6u9mu04w: folds
mSD1pginDsyHG5PDfqzphw: folds
+k7T5ocke8UwavtgUHm+Cg: raises $1 to $1.50
IDtNLR9uFCDdjNsJWMHA5Q: folds
a4JDWmpFQkL10XfAyuF51A: folds
+k7T5ocke8UwavtgUHm+Cg collected $1.25 from pot
+k7T5ocke8UwavtgUHm+Cg: doesn't show hand
*** SUMMARY ***
Total pot $1.25 | Rake $0
Seat 1: 5k9fvXD9suIgCxU4HLQjTw folded before Flop (didn't bet)
Seat 2: UrcnkQOiLVk8BlKDPJSy7Q folded before Flop (didn't bet)
Seat 3: aTkyjTh3w5YLWiIERupZOA folded before Flop (didn't bet)
Seat 4: bwv/rbH/hHhPhY6u9mu04w folded before Flop (didn't bet)
Seat 5: mSD1pginDsyHG5PDfqzphw folded before Flop (didn't bet)
Seat 6: +k7T5ocke8UwavtgUHm+Cg (button) collected ($1.25)
Seat 7: IDtNLR9uFCDdjNsJWMHA5Q (small blind) folded before Flop
Seat 8: a4JDWmpFQkL10XfAyuF51A (big blind) folded before Flop
Seat 9: gsyXT42WLEcOS4DdEk2wlw folded before Flop (didn't bet)



PokerStars Game #59939986356:  Hold'em No Limit ($0.25/$0.50) - 2009/07/01 0:54:13 ET
Table '0eJtgVAXVvBgncFdcUpXcQ' 2-max Seat #1 is the button
Seat 1: Ag6DvxX4vbRheqsv2zXKTQ ($39.30 in chips)
Seat 2: KMc4R+K9ao4Ur3rF7NGe6Q ($11.85 in chips)
Ag6DvxX4vbRheqsv2zXKTQ: posts small blind $0.25
KMc4R+K9ao4Ur3rF7NGe6Q: posts big blind $0.50
*** HOLE CARDS ***
Ag6DvxX4vbRheqsv2zXKTQ: folds
KMc4R+K9ao4Ur3rF7NGe6Q collected $0.50 from pot
KMc4R+K9ao4Ur3rF7NGe6Q: doesn't show hand
*** SUMMARY ***
Total pot $0.50 | Rake $0
Seat 1: Ag6DvxX4vbRheqsv2zXKTQ (button) (small blind) folded before Flop
Seat 2: KMc4R+K9ao4Ur3rF7NGe6Q (big blind) collected ($0.50)



PokerStars Game #59939986464:  Hold'em No Limit ($0.25/$0.50) - 2009/07/01 0:54:13 ET
Table 'E7bWJ45aoFXRpyRv2gw+Ig' 2-max Seat #1 is the button
Seat 1: FRkiRasEGlHUeLrEl+k/nA ($116 in chips)
Seat 2: 3Wro85I7472vJ4Wkpneo9A ($76.20 in chips)
FRkiRasEGlHUeLrEl+k/nA: posts small blind $0.25
3Wro85I7472vJ4Wkpneo9A: posts big blind $0.50
*** HOLE CARDS ***
FRkiRasEGlHUeLrEl+k/nA: raises $1 to $1.50
3Wro85I7472vJ4Wkpneo9A: folds
FRkiRasEGlHUeLrEl+k/nA collected $1 from pot
*** SUMMARY ***
Total pot $1 | Rake $0
Seat 1: FRkiRasEGlHUeLrEl+k/nA (button) (small blind) collected ($1)
Seat 2: 3Wro85I7472vJ4Wkpneo9A (big blind) folded before Flop



PokerStars Game #59939986538:  Hold'em No Limit ($0.25/$0.50) - 2009/07/01 0:54:13 ET
Table '8BQGgNetI1NOvWeu3gtMNw' 2-max Seat #1 is the button
Seat 1: bypIyrYcAAifLfhZpGlKLA ($50 in chips)
Seat 2: Z4HwehErEwzsv/noQlfUlg ($120.90 in chips)
bypIyrYcAAifLfhZpGlKLA: posts small blind $0.25
Z4HwehErEwzsv/noQlfUlg: posts big blind $0.50
*** HOLE CARDS ***
bypIyrYcAAifLfhZpGlKLA: raises $1 to $1.50
Z4HwehErEwzsv/noQlfUlg: calls $1
*** FLOP *** [4d Ac 4s]
Z4HwehErEwzsv/noQlfUlg: checks
bypIyrYcAAifLfhZpGlKLA: checks
*** TURN *** [4d Ac 4s] [6s]
Z4HwehErEwzsv/noQlfUlg: bets $2
bypIyrYcAAifLfhZpGlKLA: calls $2
*** RIVER *** [4d Ac 4s 6s] [8h]
Z4HwehErEwzsv/noQlfUlg: checks
bypIyrYcAAifLfhZpGlKLA: bets $6
Z4HwehErEwzsv/noQlfUlg: folds
bypIyrYcAAifLfhZpGlKLA collected $6.70 from pot
bypIyrYcAAifLfhZpGlKLA: doesn't show hand
*** SUMMARY ***
Total pot $7 | Rake $0.30
Board [4d Ac 4s 6s 8h]
Seat 1: bypIyrYcAAifLfhZpGlKLA (button) (small blind) collected ($6.70)
Seat 2: Z4HwehErEwzsv/noQlfUlg (big blind) folded on the River



PokerStars Game #59939988356:  Hold'em No Limit ($0.25/$0.50) - 2009/07/01 0:54:16 ET
Table 'BCN5su+SsXiy1zRMJi0SJw' 6-max Seat #5 is the button
Seat 1: GxXV09ciXaOxyY2H5aMIIw ($28.60 in chips)
Seat 2: oU2kDCkT/gilYbHWrg7D8w ($18.20 in chips)
Seat 3: 6wzJiRvp8HY6t+MQGnSIzA ($20 in chips)
Seat 4: qfeUHOJpMYyzQcj0o2A7ng ($27.60 in chips)
Seat 5: IBNygaT1aa9Z1uPdJJilwA ($25.05 in chips)
Seat 6: b2symlOdL7+0c9Pj4N/KlA ($84.75 in chips)
b2symlOdL7+0c9Pj4N/KlA: posts small blind $0.25
GxXV09ciXaOxyY2H5aMIIw: posts big blind $0.50
6wzJiRvp8HY6t+MQGnSIzA: posts big blind $0.50
qfeUHOJpMYyzQcj0o2A7ng: posts big blind $0.50
*** HOLE CARDS ***
oU2kDCkT/gilYbHWrg7D8w: folds
6wzJiRvp8HY6t+MQGnSIzA: checks
qfeUHOJpMYyzQcj0o2A7ng: checks
IBNygaT1aa9Z1uPdJJilwA: calls $0.50
b2symlOdL7+0c9Pj4N/KlA: folds
GxXV09ciXaOxyY2H5aMIIw: checks
*** FLOP *** [4s 7h 3c]
GxXV09ciXaOxyY2H5aMIIw: checks
6wzJiRvp8HY6t+MQGnSIzA: checks
qfeUHOJpMYyzQcj0o2A7ng: checks
IBNygaT1aa9Z1uPdJJilwA: bets $1
GxXV09ciXaOxyY2H5aMIIw: folds
6wzJiRvp8HY6t+MQGnSIzA: folds
qfeUHOJpMYyzQcj0o2A7ng: calls $1
*** TURN *** [4s 7h 3c] [5h]
qfeUHOJpMYyzQcj0o2A7ng: checks
IBNygaT1aa9Z1uPdJJilwA: checks
*** RIVER *** [4s 7h 3c 5h] [Qh]
qfeUHOJpMYyzQcj0o2A7ng: bets $7.50
IBNygaT1aa9Z1uPdJJilwA: calls $7.50
*** SHOW DOWN ***
qfeUHOJpMYyzQcj0o2A7ng: shows [8c 2h] (high card Queen)
IBNygaT1aa9Z1uPdJJilwA: shows [3s 3h] (three of a kind, Threes)
IBNygaT1aa9Z1uPdJJilwA collected $18.30 from pot
*** SUMMARY ***
Total pot $19.25 | Rake $0.95
Board [4s 7h 3c 5h Qh]
Seat 1: GxXV09ciXaOxyY2H5aMIIw (big blind) folded on the Flop
Seat 2: oU2kDCkT/gilYbHWrg7D8w folded before Flop (didn't bet)
Seat 3: 6wzJiRvp8HY6t+MQGnSIzA folded on the Flop
Seat 4: qfeUHOJpMYyzQcj0o2A7ng showed [8c 2h] and lost with high card Queen
Seat 5: IBNygaT1aa9Z1uPdJJilwA (button) showed [3s 3h] and won ($18.30) with three of a kind, Threes
Seat 6: b2symlOdL7+0c9Pj4N/KlA (small blind) folded before Flop



PokerStars Game #59939989162:  Hold'em No Limit ($0.25/$0.50) - 2009/07/01 0:54:17 ET
Table 'MJxeZCzYELxiIsyUZyT0jw' 6-max Seat #5 is the button
Seat 1: +Pf9jTVizYlIo+woPvptfA ($50 in chips)
Seat 2: t3GiVMzqA9Svgr5Uol32cQ ($36.10 in chips)
Seat 3: JQZew0FjzS19kTjeNtrE+A ($62.95 in chips)
Seat 4: alGiiQP/wwtYnfuXII+sgw ($48.60 in chips)
Seat 5: 3jvoOXNtXE90w2BdfNZwZQ ($50 in chips)
Seat 6: TTx3CHxyi0SObcHyMJRp5w ($50.30 in chips)
TTx3CHxyi0SObcHyMJRp5w: posts small blind $0.25
+Pf9jTVizYlIo+woPvptfA: posts big blind $0.50
*** HOLE CARDS ***
t3GiVMzqA9Svgr5Uol32cQ: folds
JQZew0FjzS19kTjeNtrE+A: calls $0.50
alGiiQP/wwtYnfuXII+sgw: folds
3jvoOXNtXE90w2BdfNZwZQ: raises $2 to $2.50
TTx3CHxyi0SObcHyMJRp5w: raises $2 to $4.50
+Pf9jTVizYlIo+woPvptfA: folds
JQZew0FjzS19kTjeNtrE+A: folds
3jvoOXNtXE90w2BdfNZwZQ: calls $2
*** FLOP *** [Qd 9h Ts]
TTx3CHxyi0SObcHyMJRp5w: bets $2
3jvoOXNtXE90w2BdfNZwZQ: calls $2
*** TURN *** [Qd 9h Ts] [Ks]
TTx3CHxyi0SObcHyMJRp5w: checks
3jvoOXNtXE90w2BdfNZwZQ: checks
*** RIVER *** [Qd 9h Ts Ks] [6d]
TTx3CHxyi0SObcHyMJRp5w: bets $3
3jvoOXNtXE90w2BdfNZwZQ: calls $3
*** SHOW DOWN ***
TTx3CHxyi0SObcHyMJRp5w: shows [Ad Ah] (a pair of Aces)
3jvoOXNtXE90w2BdfNZwZQ: mucks hand
TTx3CHxyi0SObcHyMJRp5w collected $19.05 from pot
*** SUMMARY ***
Total pot $20 | Rake $0.95
Board [Qd 9h Ts Ks 6d]
Seat 1: +Pf9jTVizYlIo+woPvptfA (big blind) folded before Flop
Seat 2: t3GiVMzqA9Svgr5Uol32cQ folded before Flop (didn't bet)
Seat 3: JQZew0FjzS19kTjeNtrE+A folded before Flop
Seat 4: alGiiQP/wwtYnfuXII+sgw folded before Flop (didn't bet)
Seat 5: 3jvoOXNtXE90w2BdfNZwZQ (button) mucked
Seat 6: TTx3CHxyi0SObcHyMJRp5w (small blind) showed [Ad Ah] and won ($19.05) with a pair of Aces



PokerStars Game #59939989874:  Hold'em No Limit ($0.25/$0.50) - 2009/07/01 0:54:18 ET
Table 'Vdlc9wqYcHTUhtdyN7CuJw' 2-max Seat #1 is the button
Seat 1: yBO+mXB6m/rCft2ErwGf/Q ($115.95 in chips)
Seat 2: NZ/5cxwnorKW2SNsWy1+8A ($9.05 in chips)
yBO+mXB6m/rCft2ErwGf/Q: posts small blind $0.25
NZ/5cxwnorKW2SNsWy1+8A: posts big blind $0.50
*** HOLE CARDS ***
yBO+mXB6m/rCft2ErwGf/Q: raises $1 to $1.50
NZ/5cxwnorKW2SNsWy1+8A: folds
yBO+mXB6m/rCft2ErwGf/Q collected $1 from pot
*** SUMMARY ***
Total pot $1 | Rake $0
Seat 1: yBO+mXB6m/rCft2ErwGf/Q (button) (small blind) collected ($1)
Seat 2: NZ/5cxwnorKW2SNsWy1+8A (big blind) folded before Flop



PokerStars Game #59939991040:  Hold'em No Limit ($0.25/$0.50) - 2009/07/01 0:54:20 ET
Table '0eJtgVAXVvBgncFdcUpXcQ' 2-max Seat #2 is the button
Seat 1: Ag6DvxX4vbRheqsv2zXKTQ ($39.05 in chips)
Seat 2: KMc4R+K9ao4Ur3rF7NGe6Q ($12.10 in chips)
KMc4R+K9ao4Ur3rF7NGe6Q: posts small blind $0.25
Ag6DvxX4vbRheqsv2zXKTQ: posts big blind $0.50
*** HOLE CARDS ***
KMc4R+K9ao4Ur3rF7NGe6Q: calls $0.25
Ag6DvxX4vbRheqsv2zXKTQ: checks
*** FLOP *** [5s 9c Kc]
Ag6DvxX4vbRheqsv2zXKTQ: checks
KMc4R+K9ao4Ur3rF7NGe6Q: checks
*** TURN *** [5s 9c Kc] [Jd]
Ag6DvxX4vbRheqsv2zXKTQ: checks
KMc4R+K9ao4Ur3rF7NGe6Q: checks
*** RIVER *** [5s 9c Kc Jd] [3h]
Ag6DvxX4vbRheqsv2zXKTQ: bets $1
KMc4R+K9ao4Ur3rF7NGe6Q: folds
Ag6DvxX4vbRheqsv2zXKTQ collected $0.95 from pot
*** SUMMARY ***
Total pot $1 | Rake $0.05
Board [5s 9c Kc Jd 3h]
Seat 1: Ag6DvxX4vbRheqsv2zXKTQ (big blind) collected ($0.95)
Seat 2: KMc4R+K9ao4Ur3rF7NGe6Q (button) (small blind) folded on the River



PokerStars Game #59939991922:  Hold'em No Limit ($0.25/$0.50) - 2009/07/01 0:54:22 ET
Table 'Nz0Vr7WMHL2g5Uk7dDZjpw' 9-max Seat #8 is the button
Seat 1: tLkxo7JgV+WWI0UBw44K5A ($109.85 in chips)
Seat 2: XNMDwbXt/Q4jM99AXnbJDw ($67.35 in chips)
Seat 3: uw9QayAAxLM3Hb+HR7mSkg ($10.75 in chips)
Seat 4: 75K2MXwN65Sjfp1yHd50Hg ($9.25 in chips)
Seat 5: WGW0DgjBUXs1ylURHG8vnQ ($27.50 in chips)
Seat 6: 997ViqAtWn1FPjJqcffwcA ($61.30 in chips)
Seat 7: KPLH0gELgFe2OuAnhJFI5w ($19.35 in chips)
Seat 8: HkZI6g4zl83TDTA7SRspmQ ($16.35 in chips)
Seat 9: mSD1pginDsyHG5PDfqzphw ($10 in chips)
mSD1pginDsyHG5PDfqzphw: posts small blind $0.25
tLkxo7JgV+WWI0UBw44K5A: posts big blind $0.50
*** HOLE CARDS ***
XNMDwbXt/Q4jM99AXnbJDw: folds
uw9QayAAxLM3Hb+HR7mSkg: folds
75K2MXwN65Sjfp1yHd50Hg: folds
WGW0DgjBUXs1ylURHG8vnQ: folds
997ViqAtWn1FPjJqcffwcA: folds
KPLH0gELgFe2OuAnhJFI5w: raises $1 to $1.50
HkZI6g4zl83TDTA7SRspmQ: calls $1.50
mSD1pginDsyHG5PDfqzphw: folds
tLkxo7JgV+WWI0UBw44K5A: folds
*** FLOP *** [9s 6d Jh]
KPLH0gELgFe2OuAnhJFI5w: checks
HkZI6g4zl83TDTA7SRspmQ: bets $4
KPLH0gELgFe2OuAnhJFI5w: folds
HkZI6g4zl83TDTA7SRspmQ collected $3.60 from pot
*** SUMMARY ***
Total pot $3.75 | Rake $0.15
Board [9s 6d Jh]
Seat 1: tLkxo7JgV+WWI0UBw44K5A (big blind) folded before Flop
Seat 2: XNMDwbXt/Q4jM99AXnbJDw folded before Flop (didn't bet)
Seat 3: uw9QayAAxLM3Hb+HR7mSkg folded before Flop (didn't bet)
Seat 4: 75K2MXwN65Sjfp1yHd50Hg folded before Flop (didn't bet)
Seat 5: WGW0DgjBUXs1ylURHG8vnQ folded before Flop (didn't bet)
Seat 6: 997ViqAtWn1FPjJqcffwcA folded before Flop (didn't bet)
Seat 7: KPLH0gELgFe2OuAnhJFI5w folded on the Flop
Seat 8: HkZI6g4zl83TDTA7SRspmQ (button) collected ($3.60)
Seat 9: mSD1pginDsyHG5PDfqzphw (small blind) folded before Flop



PokerStars Game #59939992744:  Hold'em No Limit ($0.25/$0.50) - 2009/07/01 0:54:23 ET
Table 'c/CRn+68J3Y8KxD5g1ek2Q' 2-max Seat #2 is the button
Seat 1: 46qCyJ6evTkHo9al5sBMNA ($88.85 in chips)
Seat 2: BypVLsYQt3ePFm2xQL/dOA ($281.95 in chips)
BypVLsYQt3ePFm2xQL/dOA: posts small blind $0.25
46qCyJ6evTkHo9al5sBMNA: posts big blind $0.50
*** HOLE CARDS ***
BypVLsYQt3ePFm2xQL/dOA: calls $0.25
46qCyJ6evTkHo9al5sBMNA: raises $1.50 to $2
BypVLsYQt3ePFm2xQL/dOA: calls $1.50
*** FLOP *** [Qc 7s Jd]
46qCyJ6evTkHo9al5sBMNA: bets $2
BypVLsYQt3ePFm2xQL/dOA: calls $2
*** TURN *** [Qc 7s Jd] [3d]
46qCyJ6evTkHo9al5sBMNA: bets $5
BypVLsYQt3ePFm2xQL/dOA: folds
46qCyJ6evTkHo9al5sBMNA collected $7.65 from pot
46qCyJ6evTkHo9al5sBMNA: doesn't show hand
*** SUMMARY ***
Total pot $8 | Rake $0.35
Board [Qc 7s Jd 3d]
Seat 1: 46qCyJ6evTkHo9al5sBMNA (big blind) collected ($7.65)
Seat 2: BypVLsYQt3ePFm2xQL/dOA (button) (small blind) folded on the Turn



PokerStars Game #59939992972:  Hold'em No Limit ($0.25/$0.50) - 2009/07/01 0:54:23 ET
Table '+dXkOAQyS8j9PQZusUTMpg' 2-max Seat #2 is the button
Seat 1: XFa6sBGjP2gxoIvxR3fZIg ($65.20 in chips)
Seat 2: 5IBeOgaApY1Bvzv2P8X4EA ($135.80 in chips)
5IBeOgaApY1Bvzv2P8X4EA: posts small blind $0.25
XFa6sBGjP2gxoIvxR3fZIg: posts big blind $0.50
*** HOLE CARDS ***
5IBeOgaApY1Bvzv2P8X4EA: folds
XFa6sBGjP2gxoIvxR3fZIg collected $0.50 from pot
*** SUMMARY ***
Total pot $0.50 | Rake $0
Seat 1: XFa6sBGjP2gxoIvxR3fZIg (big blind) collected ($0.50)
Seat 2: 5IBeOgaApY1Bvzv2P8X4EA (button) (small blind) folded before Flop



PokerStars Game #59939995532:  Hold'em No Limit ($0.25/$0.50) - 2009/07/01 0:54:27 ET
Table 'E7bWJ45aoFXRpyRv2gw+Ig' 2-max Seat #2 is the button
Seat 1: FRkiRasEGlHUeLrEl+k/nA ($116.50 in chips)
Seat 2: 3Wro85I7472vJ4Wkpneo9A ($75.70 in chips)
3Wro85I7472vJ4Wkpneo9A: posts small blind $0.25
FRkiRasEGlHUeLrEl+k/nA: posts big blind $0.50
*** HOLE CARDS ***
3Wro85I7472vJ4Wkpneo9A: raises $1 to $1.50
FRkiRasEGlHUeLrEl+k/nA: calls $1
*** FLOP *** [Th 3h 5h]
FRkiRasEGlHUeLrEl+k/nA: checks
3Wro85I7472vJ4Wkpneo9A: bets $2
FRkiRasEGlHUeLrEl+k/nA: calls $2
*** TURN *** [Th 3h 5h] [5c]
FRkiRasEGlHUeLrEl+k/nA: checks
3Wro85I7472vJ4Wkpneo9A: bets $4
FRkiRasEGlHUeLrEl+k/nA: folds
3Wro85I7472vJ4Wkpneo9A collected $6.70 from pot
3Wro85I7472vJ4Wkpneo9A: doesn't show hand
*** SUMMARY ***
Total pot $7 | Rake $0.30
Board [Th 3h 5h 5c]
Seat 1: FRkiRasEGlHUeLrEl+k/nA (big blind) folded on the Turn
Seat 2: 3Wro85I7472vJ4Wkpneo9A (button) (small blind) collected ($6.70)



PokerStars Game #59939995604:  Hold'em No Limit ($0.25/$0.50) - 2009/07/01 0:54:27 ET
Table 'lSisgp6H7Fg1hH5VfjEjYQ' 9-max Seat #7 is the button
Seat 1: 5k9fvXD9suIgCxU4HLQjTw ($50 in chips)
Seat 2: UrcnkQOiLVk8BlKDPJSy7Q ($76.10 in chips)
Seat 3: aTkyjTh3w5YLWiIERupZOA ($51.20 in chips)
Seat 4: bwv/rbH/hHhPhY6u9mu04w ($33.60 in chips)
Seat 5: mSD1pginDsyHG5PDfqzphw ($12.60 in chips)
Seat 6: +k7T5ocke8UwavtgUHm+Cg ($52.15 in chips)
Seat 7: IDtNLR9uFCDdjNsJWMHA5Q ($19.85 in chips)
Seat 8: a4JDWmpFQkL10XfAyuF51A ($30 in chips)
Seat 9: gsyXT42WLEcOS4DdEk2wlw ($42.10 in chips)
a4JDWmpFQkL10XfAyuF51A: posts small blind $0.25
gsyXT42WLEcOS4DdEk2wlw: posts big blind $0.50
*** HOLE CARDS ***
5k9fvXD9suIgCxU4HLQjTw: folds
UrcnkQOiLVk8BlKDPJSy7Q: folds
aTkyjTh3w5YLWiIERupZOA: folds
bwv/rbH/hHhPhY6u9mu04w: folds
mSD1pginDsyHG5PDfqzphw: folds
+k7T5ocke8UwavtgUHm+Cg: folds
IDtNLR9uFCDdjNsJWMHA5Q: folds
a4JDWmpFQkL10XfAyuF51A: calls $0.25
gsyXT42WLEcOS4DdEk2wlw: checks
*** FLOP *** [2c 7s 3h]
a4JDWmpFQkL10XfAyuF51A: checks
gsyXT42WLEcOS4DdEk2wlw: checks
*** TURN *** [2c 7s 3h] [9h]
a4JDWmpFQkL10XfAyuF51A: checks
gsyXT42WLEcOS4DdEk2wlw: bets $2
a4JDWmpFQkL10XfAyuF51A: folds
gsyXT42WLEcOS4DdEk2wlw collected $0.95 from pot
*** SUMMARY ***
Total pot $1 | Rake $0.05
Board [2c 7s 3h 9h]
Seat 1: 5k9fvXD9suIgCxU4HLQjTw folded before Flop (didn't bet)
Seat 2: UrcnkQOiLVk8BlKDPJSy7Q folded before Flop (didn't bet)
Seat 3: aTkyjTh3w5YLWiIERupZOA folded before Flop (didn't bet)
Seat 4: bwv/rbH/hHhPhY6u9mu04w folded before Flop (didn't bet)
Seat 5: mSD1pginDsyHG5PDfqzphw folded before Flop (didn't bet)
Seat 6: +k7T5ocke8UwavtgUHm+Cg folded before Flop (didn't bet)
Seat 7: IDtNLR9uFCDdjNsJWMHA5Q (button) folded before Flop (didn't bet)
Seat 8: a4JDWmpFQkL10XfAyuF51A (small blind) folded on the Turn
Seat 9: gsyXT42WLEcOS4DdEk2wlw (big blind) collected ($0.95)



PokerStars Game #59939995382:  Hold'em No Limit ($0.25/$0.50) - 2009/07/01 0:54:27 ET
Table '5EmHi+fnatGQQShcNmzOZQ' 6-max Seat #5 is the button
Seat 1: HGzUMAFxR1k8+S4gfnB39w ($31.60 in chips)
Seat 3: TjmTe3bhs9dFz5gXX9x7Lw ($20.50 in chips)
Seat 4: 1b+2BbjMN8qhR1WPqdE9VQ ($68.80 in chips)
Seat 5: kxPhs4ePFqMy52CInAJ2aw ($52.45 in chips)
Seat 6: 686aeHikcJlgKkSuIFdcXQ ($132.20 in chips)
686aeHikcJlgKkSuIFdcXQ: posts small blind $0.25
HGzUMAFxR1k8+S4gfnB39w: posts big blind $0.50
*** HOLE CARDS ***
TjmTe3bhs9dFz5gXX9x7Lw: folds
1b+2BbjMN8qhR1WPqdE9VQ: folds
kxPhs4ePFqMy52CInAJ2aw: folds
686aeHikcJlgKkSuIFdcXQ: raises $1.50 to $2
HGzUMAFxR1k8+S4gfnB39w: calls $1.50
*** FLOP *** [Kh 9d Js]
686aeHikcJlgKkSuIFdcXQ: bets $3
HGzUMAFxR1k8+S4gfnB39w: folds
686aeHikcJlgKkSuIFdcXQ collected $3.80 from pot
*** SUMMARY ***
Total pot $4 | Rake $0.20
Board [Kh 9d Js]
Seat 1: HGzUMAFxR1k8+S4gfnB39w (big blind) folded on the Flop
Seat 3: TjmTe3bhs9dFz5gXX9x7Lw folded before Flop (didn't bet)
Seat 4: 1b+2BbjMN8qhR1WPqdE9VQ folded before Flop (didn't bet)
Seat 5: kxPhs4ePFqMy52CInAJ2aw (button) folded before Flop (didn't bet)
Seat 6: 686aeHikcJlgKkSuIFdcXQ (small blind) collected ($3.80)



PokerStars Game #59939996632:  Hold'em No Limit ($0.25/$0.50) - 2009/07/01 0:54:29 ET
Table '+dXkOAQyS8j9PQZusUTMpg' 2-max Seat #1 is the button
Seat 1: XFa6sBGjP2gxoIvxR3fZIg ($65.45 in chips)
Seat 2: 5IBeOgaApY1Bvzv2P8X4EA ($135.55 in chips)
XFa6sBGjP2gxoIvxR3fZIg: posts small blind $0.25
5IBeOgaApY1Bvzv2P8X4EA: posts big blind $0.50
*** HOLE CARDS ***
XFa6sBGjP2gxoIvxR3fZIg: raises $1 to $1.50
5IBeOgaApY1Bvzv2P8X4EA: calls $1
*** FLOP *** [2s Ad 4d]
5IBeOgaApY1Bvzv2P8X4EA: checks
XFa6sBGjP2gxoIvxR3fZIg: checks
*** TURN *** [2s Ad 4d] [Kd]
5IBeOgaApY1Bvzv2P8X4EA: bets $1
XFa6sBGjP2gxoIvxR3fZIg: folds
5IBeOgaApY1Bvzv2P8X4EA collected $2.85 from pot
5IBeOgaApY1Bvzv2P8X4EA: doesn't show hand
*** SUMMARY ***
Total pot $3 | Rake $0.15
Board [2s Ad 4d Kd]
Seat 1: XFa6sBGjP2gxoIvxR3fZIg (button) (small blind) folded on the Turn
Seat 2: 5IBeOgaApY1Bvzv2P8X4EA (big blind) collected ($2.85)



PokerStars Game #59939996732:  Hold'em No Limit ($0.25/$0.50) - 2009/07/01 0:54:29 ET
Table '+z1aekfHkpp09pc8F9aViw' 6-max Seat #4 is the button
Seat 1: FHilMb2i2DbUCc9lplszog ($47.05 in chips)
Seat 2: M6xK/VklCvdyyrmvzATlxQ ($34.50 in chips)
Seat 3: uUznlIMFnRUvwrBhYF73KA ($113.45 in chips)
Seat 4: RowCSpSURHTOL/dcjg/Iug ($41.80 in chips)
Seat 5: rplyldNweS6YyMNEALQrug ($15.40 in chips)
Seat 6: 686aeHikcJlgKkSuIFdcXQ ($50.75 in chips)
rplyldNweS6YyMNEALQrug: posts small blind $0.25
686aeHikcJlgKkSuIFdcXQ: posts big blind $0.50
*** HOLE CARDS ***
FHilMb2i2DbUCc9lplszog: folds
M6xK/VklCvdyyrmvzATlxQ: folds
uUznlIMFnRUvwrBhYF73KA: calls $0.50
RowCSpSURHTOL/dcjg/Iug: calls $0.50
rplyldNweS6YyMNEALQrug: calls $0.25
686aeHikcJlgKkSuIFdcXQ: checks
*** FLOP *** [3d 6c 4s]
rplyldNweS6YyMNEALQrug: checks
686aeHikcJlgKkSuIFdcXQ: checks
uUznlIMFnRUvwrBhYF73KA: bets $1
RowCSpSURHTOL/dcjg/Iug: calls $1
rplyldNweS6YyMNEALQrug: calls $1
686aeHikcJlgKkSuIFdcXQ: folds
*** TURN *** [3d 6c 4s] [8d]
rplyldNweS6YyMNEALQrug: checks
uUznlIMFnRUvwrBhYF73KA: bets $2
RowCSpSURHTOL/dcjg/Iug: folds
rplyldNweS6YyMNEALQrug: calls $2
*** RIVER *** [3d 6c 4s 8d] [6s]
rplyldNweS6YyMNEALQrug: checks
uUznlIMFnRUvwrBhYF73KA: bets $3.50
rplyldNweS6YyMNEALQrug: folds
uUznlIMFnRUvwrBhYF73KA collected $8.60 from pot
*** SUMMARY ***
Total pot $9 | Rake $0.40
Board [3d 6c 4s 8d 6s]
Seat 1: FHilMb2i2DbUCc9lplszog folded before Flop (didn't bet)
Seat 2: M6xK/VklCvdyyrmvzATlxQ folded before Flop (didn't bet)
Seat 3: uUznlIMFnRUvwrBhYF73KA collected ($8.60)
Seat 4: RowCSpSURHTOL/dcjg/Iug (button) folded on the Turn
Seat 5: rplyldNweS6YyMNEALQrug (small blind) folded on the River
Seat 6: 686aeHikcJlgKkSuIFdcXQ (big blind) folded on the Flop



PokerStars Game #59939997060:  Hold'em No Limit ($0.25/$0.50) - 2009/07/01 0:54:30 ET
Table 'Vdlc9wqYcHTUhtdyN7CuJw' 2-max Seat #2 is the button
Seat 1: yBO+mXB6m/rCft2ErwGf/Q ($116.45 in chips)
Seat 2: NZ/5cxwnorKW2SNsWy1+8A ($8.55 in chips)
NZ/5cxwnorKW2SNsWy1+8A: posts small blind $0.25
yBO+mXB6m/rCft2ErwGf/Q: posts big blind $0.50
*** HOLE CARDS ***
NZ/5cxwnorKW2SNsWy1+8A: folds
yBO+mXB6m/rCft2ErwGf/Q collected $0.50 from pot
*** SUMMARY ***
Total pot $0.50 | Rake $0
Seat 1: yBO+mXB6m/rCft2ErwGf/Q (big blind) collected ($0.50)
Seat 2: NZ/5cxwnorKW2SNsWy1+8A (button) (small blind) folded before Flop



PokerStars Game #59939998102:  Hold'em No Limit ($0.25/$0.50) - 2009/07/01 0:54:32 ET
Table 'GfL/No5u5PoEnU39lP5pQg' 6-max Seat #1 is the button
Seat 1: 1WUCqNG+p+vfWRTXNu4ljw ($60 in chips)
Seat 2: uVwggSetzp7d+eVgowO3vg ($60.20 in chips)
Seat 3: Ek4w9XqBXqK5jBUQeLedGw ($51.25 in chips)
Seat 4: r6u7MWSXF30/khcTYkrG9Q ($24.65 in chips)
Seat 6: kxPhs4ePFqMy52CInAJ2aw ($55.50 in chips)
uVwggSetzp7d+eVgowO3vg: posts small blind $0.25
Ek4w9XqBXqK5jBUQeLedGw: posts big blind $0.50
*** HOLE CARDS ***
r6u7MWSXF30/khcTYkrG9Q: raises $1 to $1.50
kxPhs4ePFqMy52CInAJ2aw: folds
1WUCqNG+p+vfWRTXNu4ljw: folds
uVwggSetzp7d+eVgowO3vg: calls $1.25
Ek4w9XqBXqK5jBUQeLedGw: folds
*** FLOP *** [Jd 7s 2h]
Ek4w9XqBXqK5jBUQeLedGw leaves the table
uVwggSetzp7d+eVgowO3vg: checks
r6u7MWSXF30/khcTYkrG9Q: bets $3
uVwggSetzp7d+eVgowO3vg: calls $3
*** TURN *** [Jd 7s 2h] [Jh]
uVwggSetzp7d+eVgowO3vg: checks
r6u7MWSXF30/khcTYkrG9Q: checks
*** RIVER *** [Jd 7s 2h Jh] [3s]
uVwggSetzp7d+eVgowO3vg: bets $5
r6u7MWSXF30/khcTYkrG9Q: calls $5
*** SHOW DOWN ***
uVwggSetzp7d+eVgowO3vg: shows [Th 8c] (a pair of Jacks)
r6u7MWSXF30/khcTYkrG9Q: shows [Kc Ks] (two pair, Kings and Jacks)
r6u7MWSXF30/khcTYkrG9Q collected $18.55 from pot
*** SUMMARY ***
Total pot $19.50 | Rake $0.95
Board [Jd 7s 2h Jh 3s]
Seat 1: 1WUCqNG+p+vfWRTXNu4ljw (button) folded before Flop (didn't bet)
Seat 2: uVwggSetzp7d+eVgowO3vg (small blind) showed [Th 8c] and lost with a pair of Jacks
Seat 3: Ek4w9XqBXqK5jBUQeLedGw (big blind) folded before Flop
Seat 4: r6u7MWSXF30/khcTYkrG9Q showed [Kc Ks] and won ($18.55) with two pair, Kings and Jacks
Seat 6: kxPhs4ePFqMy52CInAJ2aw folded before Flop (didn't bet)



PokerStars Game #59939998502:  Hold'em No Limit ($0.25/$0.50) - 2009/07/01 0:54:32 ET
Table '37qXEp3oe+er5q4CZip9eQ' 6-max Seat #5 is the button
Seat 1: oqOqoO2AyCZenUghCxMDxw ($55.40 in chips)
Seat 3: Rt6KgtZ8YaJoTc3FPim00w ($103.30 in chips)
Seat 5: VOmI0x4dDPnTESZd5B4d1Q ($45.25 in chips)
Seat 6: N50kln4negd8q7Mmoz1j4g ($19.30 in chips)
N50kln4negd8q7Mmoz1j4g: posts small blind $0.25
oqOqoO2AyCZenUghCxMDxw: posts big blind $0.50
LvH4G7n+QSjT6NDaD3cREA: sits out
*** HOLE CARDS ***
Rt6KgtZ8YaJoTc3FPim00w: raises $1 to $1.50
VOmI0x4dDPnTESZd5B4d1Q: folds
N50kln4negd8q7Mmoz1j4g: folds
oqOqoO2AyCZenUghCxMDxw: folds
Rt6KgtZ8YaJoTc3FPim00w collected $1.25 from pot
*** SUMMARY ***
Total pot $1.25 | Rake $0
Seat 1: oqOqoO2AyCZenUghCxMDxw (big blind) folded before Flop
Seat 3: Rt6KgtZ8YaJoTc3FPim00w collected ($1.25)
Seat 5: VOmI0x4dDPnTESZd5B4d1Q (button) folded before Flop (didn't bet)
Seat 6: N50kln4negd8q7Mmoz1j4g (small blind) folded before Flop



PokerStars Game #59939999498:  Hold'em No Limit ($0.25/$0.50) - 2009/07/01 0:54:34 ET
Table '0eJtgVAXVvBgncFdcUpXcQ' 2-max Seat #1 is the button
Seat 1: Ag6DvxX4vbRheqsv2zXKTQ ($39.50 in chips)
Seat 2: KMc4R+K9ao4Ur3rF7NGe6Q ($11.60 in chips)
Ag6DvxX4vbRheqsv2zXKTQ: posts small blind $0.25
KMc4R+K9ao4Ur3rF7NGe6Q: posts big blind $0.50
*** HOLE CARDS ***
Ag6DvxX4vbRheqsv2zXKTQ: raises $1 to $1.50
KMc4R+K9ao4Ur3rF7NGe6Q: folds
Ag6DvxX4vbRheqsv2zXKTQ collected $1 from pot
*** SUMMARY ***
Total pot $1 | Rake $0
Seat 1: Ag6DvxX4vbRheqsv2zXKTQ (button) (small blind) collected ($1)
Seat 2: KMc4R+K9ao4Ur3rF7NGe6Q (big blind) folded before Flop



PokerStars Game #59940000074:  Hold'em No Limit ($0.25/$0.50) - 2009/07/01 0:54:35 ET
Table 'lpxYasB1ClBSgTpCCITwhQ' 9-max Seat #2 is the button
Seat 1: mj7PS7wCH4PAl7+eYTFs7A ($46.40 in chips)
Seat 2: OWP/DOu+PlPK6ZZ3zYa0HA ($24.10 in chips)
Seat 4: NnQCepdIR/AOUQn1yhYx6Q ($9.50 in chips)
Seat 5: IYd5zG8k7vdBNVHbHg2Pag ($38.10 in chips)
Seat 6: SegjDnMxWMujiD57ESNL+g ($7 in chips)
Seat 7: bmRtaIYKthN1F+B3JLZ3Jw ($29.15 in chips)
Seat 8: /mfensKw8/iZ1Vrx33S4xg ($10 in chips)
Seat 9: XNMDwbXt/Q4jM99AXnbJDw ($50.50 in chips)
caleb505 will be allowed to play after the button
NnQCepdIR/AOUQn1yhYx6Q: posts small blind $0.25
IYd5zG8k7vdBNVHbHg2Pag: posts big blind $0.50
*** HOLE CARDS ***
SegjDnMxWMujiD57ESNL+g: folds
bmRtaIYKthN1F+B3JLZ3Jw: folds
/mfensKw8/iZ1Vrx33S4xg: folds
XNMDwbXt/Q4jM99AXnbJDw: folds
mj7PS7wCH4PAl7+eYTFs7A: folds
OWP/DOu+PlPK6ZZ3zYa0HA: folds
NnQCepdIR/AOUQn1yhYx6Q: folds
IYd5zG8k7vdBNVHbHg2Pag collected $0.50 from pot
*** SUMMARY ***
Total pot $0.50 | Rake $0
Seat 1: mj7PS7wCH4PAl7+eYTFs7A folded before Flop (didn't bet)
Seat 2: OWP/DOu+PlPK6ZZ3zYa0HA (button) folded before Flop (didn't bet)
Seat 4: NnQCepdIR/AOUQn1yhYx6Q (small blind) folded before Flop
Seat 5: IYd5zG8k7vdBNVHbHg2Pag (big blind) collected ($0.50)
Seat 6: SegjDnMxWMujiD57ESNL+g folded before Flop (didn't bet)
Seat 7: bmRtaIYKthN1F+B3JLZ3Jw folded before Flop (didn't bet)
Seat 8: /mfensKw8/iZ1Vrx33S4xg folded before Flop (didn't bet)
Seat 9: XNMDwbXt/Q4jM99AXnbJDw folded before Flop (didn't bet)



PokerStars Game #59940000942:  Hold'em No Limit ($0.25/$0.50) - 2009/07/01 0:54:36 ET
Table 'Vdlc9wqYcHTUhtdyN7CuJw' 2-max Seat #1 is the button
Seat 1: yBO+mXB6m/rCft2ErwGf/Q ($116.70 in chips)
Seat 2: NZ/5cxwnorKW2SNsWy1+8A ($8.30 in chips)
yBO+mXB6m/rCft2ErwGf/Q: posts small blind $0.25
NZ/5cxwnorKW2SNsWy1+8A: posts big blind $0.50
*** HOLE CARDS ***
yBO+mXB6m/rCft2ErwGf/Q: raises $1 to $1.50
NZ/5cxwnorKW2SNsWy1+8A: calls $1
*** FLOP *** [Jh 4s 5d]
NZ/5cxwnorKW2SNsWy1+8A: checks
yBO+mXB6m/rCft2ErwGf/Q: bets $2.50
NZ/5cxwnorKW2SNsWy1+8A: folds
yBO+mXB6m/rCft2ErwGf/Q collected $2.85 from pot
*** SUMMARY ***
Total pot $3 | Rake $0.15
Board [Jh 4s 5d]
Seat 1: yBO+mXB6m/rCft2ErwGf/Q (button) (small blind) collected ($2.85)
Seat 2: NZ/5cxwnorKW2SNsWy1+8A (big blind) folded on the Flop



PokerStars Game #59940001110:  Hold'em No Limit ($0.25/$0.50) - 2009/07/01 0:54:36 ET
Table 'fx6MqwfYAj/Rt86hBz2L3Q' 9-max Seat #7 is the button
Seat 1: SegjDnMxWMujiD57ESNL+g ($9 in chips)
Seat 3: iadBi5AEt7gTBXbDSSnMYQ ($74.50 in chips)
Seat 5: iAISe3dVeua8PUn2wwgDHw ($30 in chips)
Seat 6: 5k9fvXD9suIgCxU4HLQjTw ($50 in chips)
Seat 7: SKnJuWHScqetA/qG5p+wCg ($30 in chips)
Seat 8: JYwJYYV9pM5KWdSiETl8rA ($26.75 in chips)
Seat 9: HZkVla4kK2SI42CVrPZ/ig ($14.75 in chips)
JYwJYYV9pM5KWdSiETl8rA: posts small blind $0.25
HZkVla4kK2SI42CVrPZ/ig: posts big blind $0.50
75K2MXwN65Sjfp1yHd50Hg: sits out
*** HOLE CARDS ***
SegjDnMxWMujiD57ESNL+g: folds
iadBi5AEt7gTBXbDSSnMYQ: raises $1 to $1.50
iAISe3dVeua8PUn2wwgDHw: folds
5k9fvXD9suIgCxU4HLQjTw: folds
SKnJuWHScqetA/qG5p+wCg: folds
JYwJYYV9pM5KWdSiETl8rA: folds
HZkVla4kK2SI42CVrPZ/ig: calls $1
*** FLOP *** [2c 9c 6d]
HZkVla4kK2SI42CVrPZ/ig: checks
iadBi5AEt7gTBXbDSSnMYQ: bets $1.50
HZkVla4kK2SI42CVrPZ/ig: calls $1.50
*** TURN *** [2c 9c 6d] [Ah]
HZkVla4kK2SI42CVrPZ/ig: checks
iadBi5AEt7gTBXbDSSnMYQ: bets $2.50
C3rGXblctNcWI6JYPHhaEg has returned
HZkVla4kK2SI42CVrPZ/ig: folds
iadBi5AEt7gTBXbDSSnMYQ collected $5.95 from pot
iadBi5AEt7gTBXbDSSnMYQ: doesn't show hand
*** SUMMARY ***
Total pot $6.25 | Rake $0.30
Board [2c 9c 6d Ah]
Seat 1: SegjDnMxWMujiD57ESNL+g folded before Flop (didn't bet)
Seat 3: iadBi5AEt7gTBXbDSSnMYQ collected ($5.95)
Seat 5: iAISe3dVeua8PUn2wwgDHw folded before Flop (didn't bet)
Seat 6: 5k9fvXD9suIgCxU4HLQjTw folded before Flop (didn't bet)
Seat 7: SKnJuWHScqetA/qG5p+wCg (button) folded before Flop (didn't bet)
Seat 8: JYwJYYV9pM5KWdSiETl8rA (small blind) folded before Flop
Seat 9: HZkVla4kK2SI42CVrPZ/ig (big blind) folded on the Turn



PokerStars Game #59940002416:  Hold'em No Limit ($0.25/$0.50) - 2009/07/01 0:54:39 ET
Table '8BQGgNetI1NOvWeu3gtMNw' 2-max Seat #2 is the button
Seat 1: bypIyrYcAAifLfhZpGlKLA ($53.20 in chips)
Seat 2: Z4HwehErEwzsv/noQlfUlg ($117.40 in chips)
Z4HwehErEwzsv/noQlfUlg: posts small blind $0.25
bypIyrYcAAifLfhZpGlKLA: posts big blind $0.50
*** HOLE CARDS ***
Z4HwehErEwzsv/noQlfUlg: raises $0.50 to $1
bypIyrYcAAifLfhZpGlKLA: raises $2.50 to $3.50
Z4HwehErEwzsv/noQlfUlg: calls $2.50
*** FLOP *** [5d 6h 8d]
bypIyrYcAAifLfhZpGlKLA: checks
Z4HwehErEwzsv/noQlfUlg: bets $7
bypIyrYcAAifLfhZpGlKLA: folds
Z4HwehErEwzsv/noQlfUlg collected $6.65 from pot
Z4HwehErEwzsv/noQlfUlg: doesn't show hand
*** SUMMARY ***
Total pot $7 | Rake $0.35
Board [5d 6h 8d]
Seat 1: bypIyrYcAAifLfhZpGlKLA (big blind) folded on the Flop
Seat 2: Z4HwehErEwzsv/noQlfUlg (button) (small blind) collected ($6.65)



PokerStars Game #59940002850:  Hold'em No Limit ($0.25/$0.50) - 2009/07/01 0:54:39 ET
Table 'otvGDROEDdqsabxskT79qg' 9-max Seat #4 is the button
Seat 1: 8ehL7qlZzjgUh2H35iiWLw ($54.50 in chips)
Seat 2: cCjTzH9jio8607WzjcfXlg ($14.30 in chips)
Seat 3: +k7T5ocke8UwavtgUHm+Cg ($66.50 in chips)
Seat 4: MG90wfSJZnOejs/KD3vlQQ ($73.20 in chips)
Seat 5: XNMDwbXt/Q4jM99AXnbJDw ($50 in chips)
Seat 6: bxLSulbgr8LmKNjOzw8URg ($53.70 in chips)
Seat 7: C7+tBppJrKgd/r+tuKUIpA ($35.80 in chips)
Seat 8: zE9cVigS2nW/Ljy4K4bUQA ($30 in chips)
Seat 9: KcY3X8YpD74Kw1RHkx/g4A ($57.90 in chips)
XNMDwbXt/Q4jM99AXnbJDw: posts small blind $0.25
bxLSulbgr8LmKNjOzw8URg: posts big blind $0.50
*** HOLE CARDS ***
C7+tBppJrKgd/r+tuKUIpA: calls $0.50
zE9cVigS2nW/Ljy4K4bUQA: folds
KcY3X8YpD74Kw1RHkx/g4A: folds
8ehL7qlZzjgUh2H35iiWLw: raises $2 to $2.50
cCjTzH9jio8607WzjcfXlg: folds
+k7T5ocke8UwavtgUHm+Cg: folds
MG90wfSJZnOejs/KD3vlQQ: folds
XNMDwbXt/Q4jM99AXnbJDw: folds
bxLSulbgr8LmKNjOzw8URg: folds
C7+tBppJrKgd/r+tuKUIpA: calls $2
*** FLOP *** [Kh Th Jd]
C7+tBppJrKgd/r+tuKUIpA: checks
8ehL7qlZzjgUh2H35iiWLw: bets $4
C7+tBppJrKgd/r+tuKUIpA: folds
8ehL7qlZzjgUh2H35iiWLw collected $5.50 from pot
8ehL7qlZzjgUh2H35iiWLw: doesn't show hand
*** SUMMARY ***
Total pot $5.75 | Rake $0.25
Board [Kh Th Jd]
Seat 1: 8ehL7qlZzjgUh2H35iiWLw collected ($5.50)
Seat 2: cCjTzH9jio8607WzjcfXlg folded before Flop (didn't bet)
Seat 3: +k7T5ocke8UwavtgUHm+Cg folded before Flop (didn't bet)
Seat 4: MG90wfSJZnOejs/KD3vlQQ (button) folded before Flop (didn't bet)
Seat 5: XNMDwbXt/Q4jM99AXnbJDw (small blind) folded before Flop
Seat 6: bxLSulbgr8LmKNjOzw8URg (big blind) folded before Flop
Seat 7: C7+tBppJrKgd/r+tuKUIpA folded on the Flop
Seat 8: zE9cVigS2nW/Ljy4K4bUQA folded before Flop (didn't bet)
Seat 9: KcY3X8YpD74Kw1RHkx/g4A folded before Flop (didn't bet)



PokerStars Game #59940003106:  Hold'em No Limit ($0.25/$0.50) - 2009/07/01 0:54:40 ET
Table 'kgbJRsxfv64KrErDRBAkcw' 6-max Seat #6 is the button
Seat 1: w2dj3tZyWCX7+wEKRi0AVw ($14.85 in chips)
Seat 2: AdS8BJMOheS01zjCDfPMFg ($49 in chips)
Seat 3: c4MNIaIyPMOMxrgT8FT5nA ($127.35 in chips)
Seat 4: qanMEqjABjWxC/JgQ/0l7w ($58 in chips)
Seat 5: eUBBn2R56C1IQ6Cs/vitwg ($50 in chips)
Seat 6: 1b+2BbjMN8qhR1WPqdE9VQ ($50 in chips)
w2dj3tZyWCX7+wEKRi0AVw: posts small blind $0.25
AdS8BJMOheS01zjCDfPMFg: posts big blind $0.50
*** HOLE CARDS ***
c4MNIaIyPMOMxrgT8FT5nA: raises $3.50 to $4
qanMEqjABjWxC/JgQ/0l7w: folds
eUBBn2R56C1IQ6Cs/vitwg: folds
1b+2BbjMN8qhR1WPqdE9VQ: folds
w2dj3tZyWCX7+wEKRi0AVw: folds
AdS8BJMOheS01zjCDfPMFg: folds
c4MNIaIyPMOMxrgT8FT5nA collected $1.25 from pot
c4MNIaIyPMOMxrgT8FT5nA: doesn't show hand
*** SUMMARY ***
Total pot $1.25 | Rake $0
Seat 1: w2dj3tZyWCX7+wEKRi0AVw (small blind) folded before Flop
Seat 2: AdS8BJMOheS01zjCDfPMFg (big blind) folded before Flop
Seat 3: c4MNIaIyPMOMxrgT8FT5nA collected ($1.25)
Seat 4: qanMEqjABjWxC/JgQ/0l7w folded before Flop (didn't bet)
Seat 5: eUBBn2R56C1IQ6Cs/vitwg folded before Flop (didn't bet)
Seat 6: 1b+2BbjMN8qhR1WPqdE9VQ (button) folded before Flop (didn't bet)



PokerStars Game #59940004116:  Hold'em No Limit ($0.25/$0.50) - 2009/07/01 0:54:41 ET
Table 'EiNh8p/wGJ1FP575iMFnqg' 9-max Seat #1 is the button
Seat 1: r3ZqM1Mi0W3y4hOdssE+Sg ($44.85 in chips)
Seat 2: 8ehL7qlZzjgUh2H35iiWLw ($52.10 in chips)
Seat 3: ymLPoEIl7UL3TvZYmnadxQ ($51.80 in chips)
Seat 4: cMzaiXAM/ZAdNaEUu+LqhA ($55.70 in chips)
Seat 5: M+7+BTmX5vZatHVuoRB1nA ($82.20 in chips)
Seat 6: 3UmXLy3GfjC3EkOebduerQ ($65.35 in chips)
Seat 7: 997ViqAtWn1FPjJqcffwcA ($50 in chips)
Seat 8: mSD1pginDsyHG5PDfqzphw ($10 in chips)
Seat 9: NnQCepdIR/AOUQn1yhYx6Q ($10 in chips)
8ehL7qlZzjgUh2H35iiWLw: posts small blind $0.25
ymLPoEIl7UL3TvZYmnadxQ: posts big blind $0.50
*** HOLE CARDS ***
cMzaiXAM/ZAdNaEUu+LqhA: folds
M+7+BTmX5vZatHVuoRB1nA: folds
3UmXLy3GfjC3EkOebduerQ: folds
997ViqAtWn1FPjJqcffwcA: folds
mSD1pginDsyHG5PDfqzphw: folds
NnQCepdIR/AOUQn1yhYx6Q: folds
r3ZqM1Mi0W3y4hOdssE+Sg: folds
8ehL7qlZzjgUh2H35iiWLw: folds
ymLPoEIl7UL3TvZYmnadxQ collected $0.50 from pot
ymLPoEIl7UL3TvZYmnadxQ: doesn't show hand
*** SUMMARY ***
Total pot $0.50 | Rake $0
Seat 1: r3ZqM1Mi0W3y4hOdssE+Sg (button) folded before Flop (didn't bet)
Seat 2: 8ehL7qlZzjgUh2H35iiWLw (small blind) folded before Flop
Seat 3: ymLPoEIl7UL3TvZYmnadxQ (big blind) collected ($0.50)
Seat 4: cMzaiXAM/ZAdNaEUu+LqhA folded before Flop (didn't bet)
Seat 5: M+7+BTmX5vZatHVuoRB1nA folded before Flop (didn't bet)
Seat 6: 3UmXLy3GfjC3EkOebduerQ folded before Flop (didn't bet)
Seat 7: 997ViqAtWn1FPjJqcffwcA folded before Flop (didn't bet)
Seat 8: mSD1pginDsyHG5PDfqzphw folded before Flop (didn't bet)
Seat 9: NnQCepdIR/AOUQn1yhYx6Q folded before Flop (didn't bet)



PokerStars Game #59940005006:  Hold'em No Limit ($0.25/$0.50) - 2009/07/01 0:54:43 ET
Table '0eJtgVAXVvBgncFdcUpXcQ' 2-max Seat #2 is the button
Seat 1: Ag6DvxX4vbRheqsv2zXKTQ ($40 in chips)
Seat 2: KMc4R+K9ao4Ur3rF7NGe6Q ($11.10 in chips)
KMc4R+K9ao4Ur3rF7NGe6Q: posts small blind $0.25
Ag6DvxX4vbRheqsv2zXKTQ: posts big blind $0.50
*** HOLE CARDS ***
KMc4R+K9ao4Ur3rF7NGe6Q: raises $1 to $1.50
Ag6DvxX4vbRheqsv2zXKTQ: calls $1
*** FLOP *** [4c Qs 7h]
Ag6DvxX4vbRheqsv2zXKTQ: checks
KMc4R+K9ao4Ur3rF7NGe6Q: bets $1.50
Ag6DvxX4vbRheqsv2zXKTQ: folds
KMc4R+K9ao4Ur3rF7NGe6Q collected $2.85 from pot
KMc4R+K9ao4Ur3rF7NGe6Q: doesn't show hand
*** SUMMARY ***
Total pot $3 | Rake $0.15
Board [4c Qs 7h]
Seat 1: Ag6DvxX4vbRheqsv2zXKTQ (big blind) folded on the Flop
Seat 2: KMc4R+K9ao4Ur3rF7NGe6Q (button) (small blind) collected ($2.85)



PokerStars Game #59940006068:  Hold'em No Limit ($0.25/$0.50) - 2009/07/01 0:54:44 ET
Table '+dXkOAQyS8j9PQZusUTMpg' 2-max Seat #2 is the button
Seat 1: XFa6sBGjP2gxoIvxR3fZIg ($63.95 in chips)
Seat 2: 5IBeOgaApY1Bvzv2P8X4EA ($136.90 in chips)
5IBeOgaApY1Bvzv2P8X4EA: posts small blind $0.25
XFa6sBGjP2gxoIvxR3fZIg: posts big blind $0.50
*** HOLE CARDS ***
5IBeOgaApY1Bvzv2P8X4EA: folds
XFa6sBGjP2gxoIvxR3fZIg collected $0.50 from pot
*** SUMMARY ***
Total pot $0.50 | Rake $0
Seat 1: XFa6sBGjP2gxoIvxR3fZIg (big blind) collected ($0.50)
Seat 2: 5IBeOgaApY1Bvzv2P8X4EA (button) (small blind) folded before Flop



PokerStars Game #59940007214:  Hold'em No Limit ($0.25/$0.50) - 2009/07/01 0:54:46 ET
Table 'X6IRCRTh+20gjz8aubWnwA' 9-max Seat #1 is the button
Seat 1: DSM67hHHq1XFoEOi9p8Alw ($49.05 in chips)
Seat 2: HZkVla4kK2SI42CVrPZ/ig ($8.05 in chips)
Seat 3: SWv01peOe69QQRvhQTqjQw ($4.90 in chips)
Seat 4: 2J+UVOVrW+V3maOylyxMcQ ($43.05 in chips)
Seat 5: NnQCepdIR/AOUQn1yhYx6Q ($10 in chips)
Seat 7: cFHQjKQOOKTUzoilhrXHLg ($47.75 in chips)
Seat 8: HxeBVq06/3Bh/H986sgdbw ($24.05 in chips)
Seat 9: M+7+BTmX5vZatHVuoRB1nA ($46.75 in chips)
HZkVla4kK2SI42CVrPZ/ig: posts small blind $0.25
SWv01peOe69QQRvhQTqjQw: posts big blind $0.50
75K2MXwN65Sjfp1yHd50Hg: sits out
*** HOLE CARDS ***
2J+UVOVrW+V3maOylyxMcQ: folds
2J+UVOVrW+V3maOylyxMcQ leaves the table
NnQCepdIR/AOUQn1yhYx6Q: folds
cFHQjKQOOKTUzoilhrXHLg: folds
HxeBVq06/3Bh/H986sgdbw: calls $0.50
M+7+BTmX5vZatHVuoRB1nA: folds
DSM67hHHq1XFoEOi9p8Alw: folds
HZkVla4kK2SI42CVrPZ/ig: calls $0.25
SWv01peOe69QQRvhQTqjQw: checks
*** FLOP *** [Th Jh Ac]
HZkVla4kK2SI42CVrPZ/ig: checks
SWv01peOe69QQRvhQTqjQw: checks
M3JFBNQ8Bbw3FBZ/18MuXw joins the table at seat #4
HxeBVq06/3Bh/H986sgdbw: checks
*** TURN *** [Th Jh Ac] [Js]
HZkVla4kK2SI42CVrPZ/ig: checks
SWv01peOe69QQRvhQTqjQw: checks
HxeBVq06/3Bh/H986sgdbw: bets $1
HZkVla4kK2SI42CVrPZ/ig: folds
SWv01peOe69QQRvhQTqjQw: folds
HxeBVq06/3Bh/H986sgdbw collected $1.45 from pot
HxeBVq06/3Bh/H986sgdbw: doesn't show hand
*** SUMMARY ***
Total pot $1.50 | Rake $0.05
Board [Th Jh Ac Js]
Seat 1: DSM67hHHq1XFoEOi9p8Alw (button) folded before Flop (didn't bet)
Seat 2: HZkVla4kK2SI42CVrPZ/ig (small blind) folded on the Turn
Seat 3: SWv01peOe69QQRvhQTqjQw (big blind) folded on the Turn
Seat 4: 2J+UVOVrW+V3maOylyxMcQ folded before Flop (didn't bet)
Seat 5: NnQCepdIR/AOUQn1yhYx6Q folded before Flop (didn't bet)
Seat 7: cFHQjKQOOKTUzoilhrXHLg folded before Flop (didn't bet)
Seat 8: HxeBVq06/3Bh/H986sgdbw collected ($1.45)
Seat 9: M+7+BTmX5vZatHVuoRB1nA folded before Flop (didn't bet)



PokerStars Game #59940008720:  Hold'em No Limit ($0.25/$0.50) - 2009/07/01 0:54:49 ET
Table 'QOgaEqMcJ73pcUMMxoisUgErOuyGLI5PT3G5MnpHgC/g Seat #6 is the button
Seat 3: xZCXQSXlrZkp3pZizzVXCw ($49.50 in chips)
Seat 4: 3UmXLy3GfjC3EkOebduerQ ($50.45 in chips)
Seat 5: JwvquocWfhTVApN5t47LgA ($63.35 in chips)
Seat 6: zE9cVigS2nW/Ljy4K4bUQA ($30 in chips)
Seat 7: 90Wb75h3W1BRpbqVnuk8gw ($63.80 in chips)
Seat 8: g4k0NXISyLCqaSWZDBjfEg ($50 in chips)
Seat 9: J0W5D97jl5VLky+IoPvDeA ($53.15 in chips)
90Wb75h3W1BRpbqVnuk8gw: posts small blind $0.25
g4k0NXISyLCqaSWZDBjfEg: posts big blind $0.50
eBrej2jnlUCs/JgxFCRn2g: sits out
*** HOLE CARDS ***
J0W5D97jl5VLky+IoPvDeA: folds
xZCXQSXlrZkp3pZizzVXCw: folds
3UmXLy3GfjC3EkOebduerQ: folds
JwvquocWfhTVApN5t47LgA: folds
zE9cVigS2nW/Ljy4K4bUQA: folds
90Wb75h3W1BRpbqVnuk8gw: raises $1.50 to $2
g4k0NXISyLCqaSWZDBjfEg: calls $1.50
*** FLOP *** [Ks 4s Jd]
90Wb75h3W1BRpbqVnuk8gw: bets $2
g4k0NXISyLCqaSWZDBjfEg: folds
90Wb75h3W1BRpbqVnuk8gw collected $3.80 from pot
*** SUMMARY ***
Total pot $4 | Rake $0.20
Board [Ks 4s Jd]
Seat 3: xZCXQSXlrZkp3pZizzVXCw folded before Flop (didn't bet)
Seat 4: 3UmXLy3GfjC3EkOebduerQ folded before Flop (didn't bet)
Seat 5: JwvquocWfhTVApN5t47LgA folded before Flop (didn't bet)
Seat 6: zE9cVigS2nW/Ljy4K4bUQA (button) folded before Flop (didn't bet)
Seat 7: 90Wb75h3W1BRpbqVnuk8gw (small blind) collected ($3.80)
Seat 8: g4k0NXISyLCqaSWZDBjfEg (big blind) folded on the Flop
Seat 9: J0W5D97jl5VLky+IoPvDeA folded before Flop (didn't bet)



PokerStars Game #59940010828:  Hold'em No Limit ($0.25/$0.50) - 2009/07/01 0:54:52 ET
Table '+dXkOAQyS8j9PQZusUTMpg' 2-max Seat #1 is the button
Seat 1: XFa6sBGjP2gxoIvxR3fZIg ($64.20 in chips)
Seat 2: 5IBeOgaApY1Bvzv2P8X4EA ($136.65 in chips)
XFa6sBGjP2gxoIvxR3fZIg: posts small blind $0.25
5IBeOgaApY1Bvzv2P8X4EA: posts big blind $0.50
*** HOLE CARDS ***
XFa6sBGjP2gxoIvxR3fZIg: raises $1 to $1.50
5IBeOgaApY1Bvzv2P8X4EA: folds
XFa6sBGjP2gxoIvxR3fZIg collected $1 from pot
*** SUMMARY ***
Total pot $1 | Rake $0
Seat 1: XFa6sBGjP2gxoIvxR3fZIg (button) (small blind) collected ($1)
Seat 2: 5IBeOgaApY1Bvzv2P8X4EA (big blind) folded before Flop



PokerStars Game #59940012206:  Hold'em No Limit ($0.25/$0.50) - 2009/07/01 0:54:54 ET
Table '99gCy/CZQwPIjZWH+BguQgE7bWJ45aoFXRpyRv2gw+Igeat #4 is the button
Seat 2: n6VQBu6crjYjy6DxNP1NZA ($28.75 in chips)
Seat 3: qEn9ijNGtuyTxamBf07hYg ($50 in chips)
Seat 4: bxLSulbgr8LmKNjOzw8URg ($60.70 in chips)
Seat 5: DSM67hHHq1XFoEOi9p8Alw ($44.50 in chips)
Seat 7: bfSq6LBw0UvxeM5yfuWC7w ($17.10 in chips)
Seat 8: 8ehL7qlZzjgUh2H35iiWLw ($52.50 in chips)
Seat 9: j3K/Jujr7PY4ZM2RZvlH6A ($101.20 in chips)
DSM67hHHq1XFoEOi9p8Alw: posts small blind $0.25
bfSq6LBw0UvxeM5yfuWC7w: posts big blind $0.50
*** HOLE CARDS ***
8ehL7qlZzjgUh2H35iiWLw: folds
j3K/Jujr7PY4ZM2RZvlH6A: folds
n6VQBu6crjYjy6DxNP1NZA: folds
qEn9ijNGtuyTxamBf07hYg: folds
bxLSulbgr8LmKNjOzw8URg: folds
DSM67hHHq1XFoEOi9p8Alw: folds
bfSq6LBw0UvxeM5yfuWC7w collected $0.50 from pot
bfSq6LBw0UvxeM5yfuWC7w: doesn't show hand
*** SUMMARY ***
Total pot $0.50 | Rake $0
Seat 2: n6VQBu6crjYjy6DxNP1NZA folded before Flop (didn't bet)
Seat 3: qEn9ijNGtuyTxamBf07hYg folded before Flop (didn't bet)
Seat 4: bxLSulbgr8LmKNjOzw8URg (button) folded before Flop (didn't bet)
Seat 5: DSM67hHHq1XFoEOi9p8Alw (small blind) folded before Flop
Seat 7: bfSq6LBw0UvxeM5yfuWC7w (big blind) collected ($0.50)
Seat 8: 8ehL7qlZzjgUh2H35iiWLw folded before Flop (didn't bet)
Seat 9: j3K/Jujr7PY4ZM2RZvlH6A folded before Flop (didn't bet)



PokerStars Game #59940012436:  Hold'em No Limit ($0.25/$0.50) - 2009/07/01 0:54:55 ET
Table '0eJtgVAXVvBgncFdcUpXcQ' 2-max Seat #1 is the button
Seat 1: Ag6DvxX4vbRheqsv2zXKTQ ($38.50 in chips)
Seat 2: KMc4R+K9ao4Ur3rF7NGe6Q ($12.45 in chips)
Ag6DvxX4vbRheqsv2zXKTQ: posts small blind $0.25
KMc4R+K9ao4Ur3rF7NGe6Q: posts big blind $0.50
*** HOLE CARDS ***
Ag6DvxX4vbRheqsv2zXKTQ: calls $0.25
KMc4R+K9ao4Ur3rF7NGe6Q: checks
*** FLOP *** [9d 2h Js]
KMc4R+K9ao4Ur3rF7NGe6Q: checks
Ag6DvxX4vbRheqsv2zXKTQ: bets $0.50
KMc4R+K9ao4Ur3rF7NGe6Q: folds
Ag6DvxX4vbRheqsv2zXKTQ collected $0.95 from pot
*** SUMMARY ***
Total pot $1 | Rake $0.05
Board [9d 2h Js]
Seat 1: Ag6DvxX4vbRheqsv2zXKTQ (button) (small blind) collected ($0.95)
Seat 2: KMc4R+K9ao4Ur3rF7NGe6Q (big blind) folded on the Flop



PokerStars Game #59940012462:  Hold'em No Limit ($0.25/$0.50) - 2009/07/01 0:54:55 ET
Table '5EmHi+fnatGQQShcNmzOZQ' 6-max Seat #6 is the button
Seat 1: HGzUMAFxR1k8+S4gfnB39w ($29.60 in chips)
Seat 3: TjmTe3bhs9dFz5gXX9x7Lw ($20.50 in chips)
Seat 4: 1b+2BbjMN8qhR1WPqdE9VQ ($68.80 in chips)
Seat 5: kxPhs4ePFqMy52CInAJ2aw ($52.45 in chips)
Seat 6: 686aeHikcJlgKkSuIFdcXQ ($134 in chips)
HGzUMAFxR1k8+S4gfnB39w: posts small blind $0.25
TjmTe3bhs9dFz5gXX9x7Lw: posts big blind $0.50
*** HOLE CARDS ***
1b+2BbjMN8qhR1WPqdE9VQ: folds
kxPhs4ePFqMy52CInAJ2aw: raises $1.50 to $2
686aeHikcJlgKkSuIFdcXQ: folds
HGzUMAFxR1k8+S4gfnB39w: raises $27.60 to $29.60 and is all-in
TjmTe3bhs9dFz5gXX9x7Lw: folds
kxPhs4ePFqMy52CInAJ2aw: calls $27.60
*** FLOP *** [9c Td 5h]
*** TURN *** [9c Td 5h] [Jd]
*** RIVER *** [9c Td 5h Jd] [3s]
*** SHOW DOWN ***
HGzUMAFxR1k8+S4gfnB39w: shows [Kh Ac] (high card Ace)
kxPhs4ePFqMy52CInAJ2aw: shows [7s 7d] (a pair of Sevens)
kxPhs4ePFqMy52CInAJ2aw collected $57.70 from pot
*** SUMMARY ***
Total pot $59.70 | Rake $2
Board [9c Td 5h Jd 3s]
Seat 1: HGzUMAFxR1k8+S4gfnB39w (small blind) showed [Kh Ac] and lost with high card Ace
Seat 3: TjmTe3bhs9dFz5gXX9x7Lw (big blind) folded before Flop
Seat 4: 1b+2BbjMN8qhR1WPqdE9VQ folded before Flop (didn't bet)
Seat 5: kxPhs4ePFqMy52CInAJ2aw showed [7s 7d] and won ($57.70) with a pair of Sevens
Seat 6: 686aeHikcJlgKkSuIFdcXQ (button) folded before Flop (didn't bet)



PokerStars Game #59940013614:  Hold'em No Limit ($0.25/$0.50) - 2009/07/01 0:54:56 ET
Table 'E7bWJ45aoFXRpyRv2gw+Ig' 2-max Seat #1 is the button
Seat 1: FRkiRasEGlHUeLrEl+k/nA ($113 in chips)
Seat 2: 3Wro85I7472vJ4Wkpneo9A ($78.90 in chips)
FRkiRasEGlHUeLrEl+k/nA: posts small blind $0.25
3Wro85I7472vJ4Wkpneo9A: posts big blind $0.50
*** HOLE CARDS ***
FRkiRasEGlHUeLrEl+k/nA: folds
3Wro85I7472vJ4Wkpneo9A collected $0.50 from pot
3Wro85I7472vJ4Wkpneo9A: doesn't show hand
*** SUMMARY ***
Total pot $0.50 | Rake $0
Seat 1: FRkiRasEGlHUeLrEl+k/nA (button) (small blind) folded before Flop
Seat 2: 3Wro85I7472vJ4Wkpneo9A (big blind) collected ($0.50)



PokerStars Game #59940013098:  Hold'em No Limit ($0.25/$0.50) - 2009/07/01 0:54:56 ET
Table 'QOgaEqMcJ73pcUMMxoisUg' 6-max Seat #1 is the button
Seat 1: /olYG0EzMWzADIgH1y2ySQ ($21.70 in chips)
Seat 2: 4QfsCWthT/vSLirorNXqtg ($53.95 in chips)
Seat 3: Rt6KgtZ8YaJoTc3FPim00w ($88.80 in chips)
Seat 4: zAcsDhG/T128Vn7XGVSgKg ($50.10 in chips)
Seat 5: 6vNxrjjCl6FwfaaymM9jjg ($33.55 in chips)
Seat 6: GoVjFxr3C+JO9vtJH9+IcA ($25.90 in chips)
4QfsCWthT/vSLirorNXqtg: posts small blind $0.25
Rt6KgtZ8YaJoTc3FPim00w: posts big blind $0.50
*** HOLE CARDS ***
zAcsDhG/T128Vn7XGVSgKg: folds
6vNxrjjCl6FwfaaymM9jjg: calls $0.50
GoVjFxr3C+JO9vtJH9+IcA: folds
/olYG0EzMWzADIgH1y2ySQ: folds
4QfsCWthT/vSLirorNXqtg: folds
Rt6KgtZ8YaJoTc3FPim00w: checks
*** FLOP *** [Tc Jh Kc]
Rt6KgtZ8YaJoTc3FPim00w: checks
6vNxrjjCl6FwfaaymM9jjg: checks
*** TURN *** [Tc Jh Kc] [Jc]
Rt6KgtZ8YaJoTc3FPim00w: checks
6vNxrjjCl6FwfaaymM9jjg: checks
*** RIVER *** [Tc Jh Kc Jc] [7c]
Rt6KgtZ8YaJoTc3FPim00w: checks
6vNxrjjCl6FwfaaymM9jjg: checks
*** SHOW DOWN ***
Rt6KgtZ8YaJoTc3FPim00w: shows [2h 3h] (a pair of Jacks)
6vNxrjjCl6FwfaaymM9jjg: shows [Ah 4s] (a pair of Jacks - Ace kicker)
6vNxrjjCl6FwfaaymM9jjg collected $1.20 from pot
*** SUMMARY ***
Total pot $1.25 | Rake $0.05
Board [Tc Jh Kc Jc 7c]
Seat 1: /olYG0EzMWzADIgH1y2ySQ (button) folded before Flop (didn't bet)
Seat 2: 4QfsCWthT/vSLirorNXqtg (small blind) folded before Flop
Seat 3: Rt6KgtZ8YaJoTc3FPim00w (big blind) showed [2h 3h] and lost with a pair of Jacks
Seat 4: zAcsDhG/T128Vn7XGVSgKg folded before Flop (didn't bet)
Seat 5: 6vNxrjjCl6FwfaaymM9jjg showed [Ah 4s] and won ($1.20) with a pair of Jacks
Seat 6: GoVjFxr3C+JO9vtJH9+IcA folded before Flop (didn't bet)



PokerStars Game #59940014084:  Hold'em No Limit ($0.25/$0.50) - 2009/07/01 0:54:57 ET
Table 'NCiXr0d5CEKBQr/cZgLhbA' 9-max Seat #1 is the button
Seat 1: pFtzb1sR4b0d1aw6aIRgDg ($50 in chips)
Seat 2: ulxuJchBV9iguXg0FUonfg ($47.25 in chips)
Seat 3: xZCXQSXlrZkp3pZizzVXCw ($52.25 in chips)
Seat 4: 5k9fvXD9suIgCxU4HLQjTw ($55.95 in chips)
Seat 5: zE9cVigS2nW/Ljy4K4bUQA ($34.45 in chips)
Seat 6: SKnJuWHScqetA/qG5p+wCg ($34.75 in chips)
Seat 7: M+7+BTmX5vZatHVuoRB1nA ($52 in chips)
Seat 8: 1MJUKc3cc0QmUoz1JZLR2w ($58.25 in chips)
Seat 9: 4WLZvqBn5qv5tds5kt5A1Q ($45.50 in chips)
ulxuJchBV9iguXg0FUonfg: posts small blind $0.25
xZCXQSXlrZkp3pZizzVXCw: posts big blind $0.50
*** HOLE CARDS ***
5k9fvXD9suIgCxU4HLQjTw: folds
zE9cVigS2nW/Ljy4K4bUQA: folds
SKnJuWHScqetA/qG5p+wCg: folds
M+7+BTmX5vZatHVuoRB1nA: folds
1MJUKc3cc0QmUoz1JZLR2w: folds
4WLZvqBn5qv5tds5kt5A1Q: calls $0.50
pFtzb1sR4b0d1aw6aIRgDg: folds
ulxuJchBV9iguXg0FUonfg: folds
xZCXQSXlrZkp3pZizzVXCw: checks
*** FLOP *** [Kd 3h Ah]
xZCXQSXlrZkp3pZizzVXCw: checks
4WLZvqBn5qv5tds5kt5A1Q: checks
*** TURN *** [Kd 3h Ah] [Tc]
xZCXQSXlrZkp3pZizzVXCw: checks
4WLZvqBn5qv5tds5kt5A1Q: checks
*** RIVER *** [Kd 3h Ah Tc] [3d]
xZCXQSXlrZkp3pZizzVXCw: checks
4WLZvqBn5qv5tds5kt5A1Q: checks
*** SHOW DOWN ***
xZCXQSXlrZkp3pZizzVXCw: shows [Kc 7c] (two pair, Kings and Threes)
4WLZvqBn5qv5tds5kt5A1Q: mucks hand
xZCXQSXlrZkp3pZizzVXCw collected $1.20 from pot
*** SUMMARY ***
Total pot $1.25 | Rake $0.05
Board [Kd 3h Ah Tc 3d]
Seat 1: pFtzb1sR4b0d1aw6aIRgDg (button) folded before Flop (didn't bet)
Seat 2: ulxuJchBV9iguXg0FUonfg (small blind) folded before Flop
Seat 3: xZCXQSXlrZkp3pZizzVXCw (big blind) showed [Kc 7c] and won ($1.20) with two pair, Kings and Threes
Seat 4: 5k9fvXD9suIgCxU4HLQjTw folded before Flop (didn't bet)
Seat 5: zE9cVigS2nW/Ljy4K4bUQA folded before Flop (didn't bet)
Seat 6: SKnJuWHScqetA/qG5p+wCg folded before Flop (didn't bet)
Seat 7: M+7+BTmX5vZatHVuoRB1nA folded before Flop (didn't bet)
Seat 8: 1MJUKc3cc0QmUoz1JZLR2w folded before Flop (didn't bet)
Seat 9: 4WLZvqBn5qv5tds5kt5A1Q mucked



PokerStars Game #59940014282:  Hold'em No Limit ($0.25/$0.50) - 2009/07/01 0:54:58 ET
Table 'c/CRn+68J3Y8KxD5g1ek2Q' 2-max Seat #1 is the button
Seat 1: 46qCyJ6evTkHo9al5sBMNA ($92.50 in chips)
Seat 2: BypVLsYQt3ePFm2xQL/dOA ($277.95 in chips)
46qCyJ6evTkHo9al5sBMNA: posts small blind $0.25
BypVLsYQt3ePFm2xQL/dOA: posts big blind $0.50
*** HOLE CARDS ***
46qCyJ6evTkHo9al5sBMNA: raises $1.50 to $2
BypVLsYQt3ePFm2xQL/dOA: calls $1.50
*** FLOP *** [Tc 4d 3c]
BypVLsYQt3ePFm2xQL/dOA: checks
46qCyJ6evTkHo9al5sBMNA: checks
*** TURN *** [Tc 4d 3c] [8h]
BypVLsYQt3ePFm2xQL/dOA: checks
46qCyJ6evTkHo9al5sBMNA: checks
*** RIVER *** [Tc 4d 3c 8h] [3s]
BypVLsYQt3ePFm2xQL/dOA: checks
46qCyJ6evTkHo9al5sBMNA: checks
*** SHOW DOWN ***
BypVLsYQt3ePFm2xQL/dOA: shows [Qd 9c] (a pair of Threes)
46qCyJ6evTkHo9al5sBMNA: mucks hand
BypVLsYQt3ePFm2xQL/dOA collected $3.80 from pot
*** SUMMARY ***
Total pot $4 | Rake $0.20
Board [Tc 4d 3c 8h 3s]
Seat 1: 46qCyJ6evTkHo9al5sBMNA (button) (small blind) mucked
Seat 2: BypVLsYQt3ePFm2xQL/dOA (big blind) showed [Qd 9c] and won ($3.80) with a pair of Threes



PokerStars Game #59940014312:  Hold'em No Limit ($0.25/$0.50) - 2009/07/01 0:54:58 ET
Table '8BQGgNetI1NOvWeu3gtMNw' 2-max Seat #1 is the button
Seat 1: bypIyrYcAAifLfhZpGlKLA ($50 in chips)
Seat 2: Z4HwehErEwzsv/noQlfUlg ($120.55 in chips)
bypIyrYcAAifLfhZpGlKLA: posts small blind $0.25
Z4HwehErEwzsv/noQlfUlg: posts big blind $0.50
*** HOLE CARDS ***
bypIyrYcAAifLfhZpGlKLA: raises $1 to $1.50
Z4HwehErEwzsv/noQlfUlg: calls $1
*** FLOP *** [Jh Qh 4s]
Z4HwehErEwzsv/noQlfUlg: bets $2
bypIyrYcAAifLfhZpGlKLA: calls $2
*** TURN *** [Jh Qh 4s] [2c]
Z4HwehErEwzsv/noQlfUlg: bets $2.50
bypIyrYcAAifLfhZpGlKLA: raises $7.50 to $10
Z4HwehErEwzsv/noQlfUlg: calls $7.50
*** RIVER *** [Jh Qh 4s 2c] [Ts]
Z4HwehErEwzsv/noQlfUlg: checks
bypIyrYcAAifLfhZpGlKLA: checks
*** SHOW DOWN ***
Z4HwehErEwzsv/noQlfUlg: shows [9d Js] (a pair of Jacks)
bypIyrYcAAifLfhZpGlKLA: mucks hand
Z4HwehErEwzsv/noQlfUlg collected $26.50 from pot
*** SUMMARY ***
Total pot $27 | Rake $0.50
Board [Jh Qh 4s 2c Ts]
Seat 1: bypIyrYcAAifLfhZpGlKLA (button) (small blind) mucked
Seat 2: Z4HwehErEwzsv/noQlfUlg (big blind) showed [9d Js] and won ($26.50) with a pair of Jacks



PokerStars Game #59940014722:  Hold'em No Limit ($0.25/$0.50) - 2009/07/01 0:54:58 ET
Table 'lpxYasB1ClBSgTpCCITwhQ' 9-max Seat #4 is the button
Seat 1: mj7PS7wCH4PAl7+eYTFs7A ($46.40 in chips)
Seat 2: OWP/DOu+PlPK6ZZ3zYa0HA ($24.10 in chips)
Seat 4: NnQCepdIR/AOUQn1yhYx6Q ($9.25 in chips)
Seat 5: IYd5zG8k7vdBNVHbHg2Pag ($38.35 in chips)
Seat 6: SegjDnMxWMujiD57ESNL+g ($7 in chips)
Seat 7: bmRtaIYKthN1F+B3JLZ3Jw ($29.15 in chips)
Seat 8: /mfensKw8/iZ1Vrx33S4xg ($10 in chips)
Seat 9: XNMDwbXt/Q4jM99AXnbJDw ($50.50 in chips)
IYd5zG8k7vdBNVHbHg2Pag: posts small blind $0.25
SegjDnMxWMujiD57ESNL+g: posts big blind $0.50
caleb505: sits out
*** HOLE CARDS ***
bmRtaIYKthN1F+B3JLZ3Jw: folds
/mfensKw8/iZ1Vrx33S4xg: folds
XNMDwbXt/Q4jM99AXnbJDw: folds
mj7PS7wCH4PAl7+eYTFs7A: folds
OWP/DOu+PlPK6ZZ3zYa0HA: folds
NnQCepdIR/AOUQn1yhYx6Q: folds
IYd5zG8k7vdBNVHbHg2Pag: raises $0.50 to $1
SegjDnMxWMujiD57ESNL+g: calls $0.50
*** FLOP *** [Kc 7s 5d]
IYd5zG8k7vdBNVHbHg2Pag: bets $1
SegjDnMxWMujiD57ESNL+g: calls $1
*** TURN *** [Kc 7s 5d] [4h]
IYd5zG8k7vdBNVHbHg2Pag: checks
SegjDnMxWMujiD57ESNL+g: bets $2
IYd5zG8k7vdBNVHbHg2Pag: folds
SegjDnMxWMujiD57ESNL+g collected $3.85 from pot
SegjDnMxWMujiD57ESNL+g: doesn't show hand
*** SUMMARY ***
Total pot $4 | Rake $0.15
Board [Kc 7s 5d 4h]
Seat 1: mj7PS7wCH4PAl7+eYTFs7A folded before Flop (didn't bet)
Seat 2: OWP/DOu+PlPK6ZZ3zYa0HA folded before Flop (didn't bet)
Seat 4: NnQCepdIR/AOUQn1yhYx6Q (button) folded before Flop (didn't bet)
Seat 5: IYd5zG8k7vdBNVHbHg2Pag (small blind) folded on the Turn
Seat 6: SegjDnMxWMujiD57ESNL+g (big blind) collected ($3.85)
Seat 7: bmRtaIYKthN1F+B3JLZ3Jw folded before Flop (didn't bet)
Seat 8: /mfensKw8/iZ1Vrx33S4xg folded before Flop (didn't bet)
Seat 9: XNMDwbXt/Q4jM99AXnbJDw folded before Flop (didn't bet)



PokerStars Game #59940015420:  Hold'em No Limit ($0.25/$0.50) - 2009/07/01 0:54:59 ET
Table 'BCN5su+SsXiy1zRMJi0SJw' 6-max Seat #6 is the button
Seat 1: GxXV09ciXaOxyY2H5aMIIw ($28.10 in chips)
Seat 2: oU2kDCkT/gilYbHWrg7D8w ($18.20 in chips)
Seat 3: 6wzJiRvp8HY6t+MQGnSIzA ($19.50 in chips)
Seat 4: qfeUHOJpMYyzQcj0o2A7ng ($18.60 in chips)
Seat 5: IBNygaT1aa9Z1uPdJJilwA ($34.35 in chips)
Seat 6: b2symlOdL7+0c9Pj4N/KlA ($84.50 in chips)
GxXV09ciXaOxyY2H5aMIIw: posts small blind $0.25
oU2kDCkT/gilYbHWrg7D8w: posts big blind $0.50
*** HOLE CARDS ***
6wzJiRvp8HY6t+MQGnSIzA: folds
qfeUHOJpMYyzQcj0o2A7ng: folds
IBNygaT1aa9Z1uPdJJilwA: folds
b2symlOdL7+0c9Pj4N/KlA: raises $1 to $1.50
GxXV09ciXaOxyY2H5aMIIw: folds
oU2kDCkT/gilYbHWrg7D8w: calls $1
*** FLOP *** [6d Qc Js]
oU2kDCkT/gilYbHWrg7D8w: checks
b2symlOdL7+0c9Pj4N/KlA: bets $2.50
oU2kDCkT/gilYbHWrg7D8w: calls $2.50
*** TURN *** [6d Qc Js] [Ah]
oU2kDCkT/gilYbHWrg7D8w: checks
b2symlOdL7+0c9Pj4N/KlA: checks
*** RIVER *** [6d Qc Js Ah] [Jh]
oU2kDCkT/gilYbHWrg7D8w: checks
b2symlOdL7+0c9Pj4N/KlA: checks
*** SHOW DOWN ***
oU2kDCkT/gilYbHWrg7D8w: shows [2d As] (two pair, Aces and Jacks)
b2symlOdL7+0c9Pj4N/KlA: mucks hand
oU2kDCkT/gilYbHWrg7D8w collected $7.85 from pot
*** SUMMARY ***
Total pot $8.25 | Rake $0.40
Board [6d Qc Js Ah Jh]
Seat 1: GxXV09ciXaOxyY2H5aMIIw (small blind) folded before Flop
Seat 2: oU2kDCkT/gilYbHWrg7D8w (big blind) showed [2d As] and won ($7.85) with two pair, Aces and Jacks
Seat 3: 6wzJiRvp8HY6t+MQGnSIzA folded before Flop (didn't bet)
Seat 4: qfeUHOJpMYyzQcj0o2A7ng folded before Flop (didn't bet)
Seat 5: IBNygaT1aa9Z1uPdJJilwA folded before Flop (didn't bet)
Seat 6: b2symlOdL7+0c9Pj4N/KlA (button) mucked



PokerStars Game #59940015308:  Hold'em No Limit ($0.25/$0.50) - 2009/07/01 0:54:59 ET
Table '/cQuAT3ef4t+PGrXiNhGaQ' 9-max Seat #3 is the button
Seat 1: HZkVla4kK2SI42CVrPZ/ig ($15.50 in chips)
Seat 2: jXGruyaMqirTaTXNOvBdew ($72.45 in chips)
Seat 3: g4k0NXISyLCqaSWZDBjfEg ($54.50 in chips)
Seat 4: OWP/DOu+PlPK6ZZ3zYa0HA ($26.65 in chips)
Seat 5: 5SgaHdWixdClWvaEG+KUjQ ($24.10 in chips)
Seat 6: APYIOyK/4AGb+kIwlOUNBQ ($37.25 in chips)
Seat 7: J0W5D97jl5VLky+IoPvDeA ($111.40 in chips)
Seat 8: eBrej2jnlUCs/JgxFCRn2g ($40 in chips)
Seat 9: AjV5McH1KMMclY26QdLM5w ($26.45 in chips)
OWP/DOu+PlPK6ZZ3zYa0HA: posts small blind $0.25
5SgaHdWixdClWvaEG+KUjQ: posts big blind $0.50
*** HOLE CARDS ***
APYIOyK/4AGb+kIwlOUNBQ: folds
J0W5D97jl5VLky+IoPvDeA: folds
eBrej2jnlUCs/JgxFCRn2g: folds
AjV5McH1KMMclY26QdLM5w: folds
HZkVla4kK2SI42CVrPZ/ig: calls $0.50
jXGruyaMqirTaTXNOvBdew: folds
g4k0NXISyLCqaSWZDBjfEg: raises $1.50 to $2
OWP/DOu+PlPK6ZZ3zYa0HA: folds
5SgaHdWixdClWvaEG+KUjQ: folds
HZkVla4kK2SI42CVrPZ/ig: folds
g4k0NXISyLCqaSWZDBjfEg collected $1.75 from pot
*** SUMMARY ***
Total pot $1.75 | Rake $0
Seat 1: HZkVla4kK2SI42CVrPZ/ig folded before Flop
Seat 2: jXGruyaMqirTaTXNOvBdew folded before Flop (didn't bet)
Seat 3: g4k0NXISyLCqaSWZDBjfEg (button) collected ($1.75)
Seat 4: OWP/DOu+PlPK6ZZ3zYa0HA (small blind) folded before Flop
Seat 5: 5SgaHdWixdClWvaEG+KUjQ (big blind) folded before Flop
Seat 6: APYIOyK/4AGb+kIwlOUNBQ folded before Flop (didn't bet)
Seat 7: J0W5D97jl5VLky+IoPvDeA folded before Flop (didn't bet)
Seat 8: eBrej2jnlUCs/JgxFCRn2g folded before Flop (didn't bet)
Seat 9: AjV5McH1KMMclY26QdLM5w folded before Flop (didn't bet)



PokerStars Game #59940015868:  Hold'em No Limit ($0.25/$0.50) - 2009/07/01 0:55:00 ET
Table '37qXEp3oe+er5q4CZip9eQ' 6-max Seat #6 is the button
Seat 1: oqOqoO2AyCZenUghCxMDxw ($54.90 in chips)
Seat 2: LvH4G7n+QSjT6NDaD3cREA ($50 in chips)
Seat 3: Rt6KgtZ8YaJoTc3FPim00w ($104.05 in chips)
Seat 4: XsmE8nXMAAMFJbWaJTmHFw ($34.70 in chips)
Seat 5: VOmI0x4dDPnTESZd5B4d1Q ($45.25 in chips)
Seat 6: N50kln4negd8q7Mmoz1j4g ($19.05 in chips)
oqOqoO2AyCZenUghCxMDxw: posts small blind $0.25
LvH4G7n+QSjT6NDaD3cREA: posts big blind $0.50
*** HOLE CARDS ***
Rt6KgtZ8YaJoTc3FPim00w: folds
XsmE8nXMAAMFJbWaJTmHFw: raises $1 to $1.50
VOmI0x4dDPnTESZd5B4d1Q: folds
N50kln4negd8q7Mmoz1j4g: calls $1.50
oqOqoO2AyCZenUghCxMDxw: calls $1.25
LvH4G7n+QSjT6NDaD3cREA: folds
*** FLOP *** [7c 6c 7h]
oqOqoO2AyCZenUghCxMDxw: checks
XsmE8nXMAAMFJbWaJTmHFw: checks
N50kln4negd8q7Mmoz1j4g: checks
*** TURN *** [7c 6c 7h] [4s]
oqOqoO2AyCZenUghCxMDxw: checks
XsmE8nXMAAMFJbWaJTmHFw: checks
N50kln4negd8q7Mmoz1j4g: checks
*** RIVER *** [7c 6c 7h 4s] [8d]
oqOqoO2AyCZenUghCxMDxw: checks
XsmE8nXMAAMFJbWaJTmHFw: bets $2
N50kln4negd8q7Mmoz1j4g: folds
oqOqoO2AyCZenUghCxMDxw: folds
XsmE8nXMAAMFJbWaJTmHFw collected $4.75 from pot
*** SUMMARY ***
Total pot $5 | Rake $0.25
Board [7c 6c 7h 4s 8d]
Seat 1: oqOqoO2AyCZenUghCxMDxw (small blind) folded on the River
Seat 2: LvH4G7n+QSjT6NDaD3cREA (big blind) folded before Flop
Seat 3: Rt6KgtZ8YaJoTc3FPim00w folded before Flop (didn't bet)
Seat 4: XsmE8nXMAAMFJbWaJTmHFw collected ($4.75)
Seat 5: VOmI0x4dDPnTESZd5B4d1Q folded before Flop (didn't bet)
Seat 6: N50kln4negd8q7Mmoz1j4g (button) folded on the River



PokerStars Game #59940015628:  Hold'em No Limit ($0.25/$0.50) - 2009/07/01 0:55:00 ET
Table '+dXkOAQyS8j9PQZusUTMpg' 2-max Seat #2 is the button
Seat 1: XFa6sBGjP2gxoIvxR3fZIg ($64.70 in chips)
Seat 2: 5IBeOgaApY1Bvzv2P8X4EA ($136.15 in chips)
5IBeOgaApY1Bvzv2P8X4EA: posts small blind $0.25
XFa6sBGjP2gxoIvxR3fZIg: posts big blind $0.50
*** HOLE CARDS ***
5IBeOgaApY1Bvzv2P8X4EA: folds
XFa6sBGjP2gxoIvxR3fZIg collected $0.50 from pot
*** SUMMARY ***
Total pot $0.50 | Rake $0
Seat 1: XFa6sBGjP2gxoIvxR3fZIg (big blind) collected ($0.50)
Seat 2: 5IBeOgaApY1Bvzv2P8X4EA (button) (small blind) folded before Flop



PokerStars Game #59940017408:  Hold'em No Limit ($0.25/$0.50) - 2009/07/01 0:55:02 ET
Table 'kgbJRsxfv64KrErDRBAkcw' 6-max Seat #1 is the button
Seat 1: w2dj3tZyWCX7+wEKRi0AVw ($14.60 in chips)
Seat 2: AdS8BJMOheS01zjCDfPMFg ($48.50 in chips)
Seat 3: c4MNIaIyPMOMxrgT8FT5nA ($128.10 in chips)
Seat 4: qanMEqjABjWxC/JgQ/0l7w ($58 in chips)
Seat 5: eUBBn2R56C1IQ6Cs/vitwg ($50 in chips)
Seat 6: 1b+2BbjMN8qhR1WPqdE9VQ ($50 in chips)
AdS8BJMOheS01zjCDfPMFg: posts small blind $0.25
c4MNIaIyPMOMxrgT8FT5nA: posts big blind $0.50
*** HOLE CARDS ***
qanMEqjABjWxC/JgQ/0l7w: folds
eUBBn2R56C1IQ6Cs/vitwg: folds
1b+2BbjMN8qhR1WPqdE9VQ: raises $1 to $1.50
w2dj3tZyWCX7+wEKRi0AVw: folds
AdS8BJMOheS01zjCDfPMFg: folds
c4MNIaIyPMOMxrgT8FT5nA: calls $1
*** FLOP *** [5h 8c Ah]
c4MNIaIyPMOMxrgT8FT5nA: bets $2
1b+2BbjMN8qhR1WPqdE9VQ: raises $4 to $6
c4MNIaIyPMOMxrgT8FT5nA: folds
1b+2BbjMN8qhR1WPqdE9VQ collected $6.90 from pot
1b+2BbjMN8qhR1WPqdE9VQ: doesn't show hand
*** SUMMARY ***
Total pot $7.25 | Rake $0.35
Board [5h 8c Ah]
Seat 1: w2dj3tZyWCX7+wEKRi0AVw (button) folded before Flop (didn't bet)
Seat 2: AdS8BJMOheS01zjCDfPMFg (small blind) folded before Flop
Seat 3: c4MNIaIyPMOMxrgT8FT5nA (big blind) folded on the Flop
Seat 4: qanMEqjABjWxC/JgQ/0l7w folded before Flop (didn't bet)
Seat 5: eUBBn2R56C1IQ6Cs/vitwg folded before Flop (didn't bet)
Seat 6: 1b+2BbjMN8qhR1WPqdE9VQ collected ($6.90)



PokerStars Game #59940017998:  Hold'em No Limit ($0.25/$0.50) - 2009/07/01 0:55:03 ET
Table 'E7bWJ45aoFXRpyRv2gw+Ig' 2-max Seat #2 is the button
Seat 1: FRkiRasEGlHUeLrEl+k/nA ($112.75 in chips)
Seat 2: 3Wro85I7472vJ4Wkpneo9A ($79.15 in chips)
3Wro85I7472vJ4Wkpneo9A: posts small blind $0.25
FRkiRasEGlHUeLrEl+k/nA: posts big blind $0.50
*** HOLE CARDS ***
3Wro85I7472vJ4Wkpneo9A: raises $1 to $1.50
FRkiRasEGlHUeLrEl+k/nA: folds
3Wro85I7472vJ4Wkpneo9A collected $1 from pot
3Wro85I7472vJ4Wkpneo9A: doesn't show hand
*** SUMMARY ***
Total pot $1 | Rake $0
Seat 1: FRkiRasEGlHUeLrEl+k/nA (big blind) folded before Flop
Seat 2: 3Wro85I7472vJ4Wkpneo9A (button) (small blind) collected ($1)



PokerStars Game #59940017824:  Hold'em No Limit ($0.25/$0.50) - 2009/07/01 0:55:03 ET
Table 'Nz0Vr7WMHL2g5Uk7dDZjpw' 9-max Seat #9 is the button
Seat 1: tLkxo7JgV+WWI0UBw44K5A ($109.35 in chips)
Seat 2: XNMDwbXt/Q4jM99AXnbJDw ($67.35 in chips)
Seat 3: uw9QayAAxLM3Hb+HR7mSkg ($10.75 in chips)
Seat 4: 75K2MXwN65Sjfp1yHd50Hg ($9.25 in chips)
Seat 5: WGW0DgjBUXs1ylURHG8vnQ ($27.50 in chips)
Seat 6: 997ViqAtWn1FPjJqcffwcA ($61.30 in chips)
Seat 7: KPLH0gELgFe2OuAnhJFI5w ($17.85 in chips)
Seat 8: HkZI6g4zl83TDTA7SRspmQ ($18.45 in chips)
Seat 9: mSD1pginDsyHG5PDfqzphw ($10 in chips)
tLkxo7JgV+WWI0UBw44K5A: posts small blind $0.25
XNMDwbXt/Q4jM99AXnbJDw: posts big blind $0.50
*** HOLE CARDS ***
uw9QayAAxLM3Hb+HR7mSkg: folds
75K2MXwN65Sjfp1yHd50Hg: raises $1.50 to $2
WGW0DgjBUXs1ylURHG8vnQ: folds
997ViqAtWn1FPjJqcffwcA: folds
KPLH0gELgFe2OuAnhJFI5w: folds
HkZI6g4zl83TDTA7SRspmQ: calls $2
mSD1pginDsyHG5PDfqzphw: raises $8 to $10 and is all-in
tLkxo7JgV+WWI0UBw44K5A: folds
XNMDwbXt/Q4jM99AXnbJDw: raises $11.50 to $21.50
75K2MXwN65Sjfp1yHd50Hg: calls $7.25 and is all-in
HkZI6g4zl83TDTA7SRspmQ: folds
*** FLOP *** [Qc 4s 5c]
*** TURN *** [Qc 4s 5c] [2c]
*** RIVER *** [Qc 4s 5c 2c] [2s]
*** SHOW DOWN ***
XNMDwbXt/Q4jM99AXnbJDw: shows [Ks Ah] (a pair of Deuces)
mSD1pginDsyHG5PDfqzphw: shows [Tc Ts] (two pair, Tens and Deuces)
mSD1pginDsyHG5PDfqzphw collected $1.45 from side pot
75K2MXwN65Sjfp1yHd50Hg: shows [Jh Js] (two pair, Jacks and Deuces)
75K2MXwN65Sjfp1yHd50Hg collected $28.50 from main pot
*** SUMMARY ***
Total pot $31.50 Main pot $28.50. Side pot $1.45. | Rake $1.55
Board [Qc 4s 5c 2c 2s]
Seat 1: tLkxo7JgV+WWI0UBw44K5A (small blind) folded before Flop
Seat 2: XNMDwbXt/Q4jM99AXnbJDw (big blind) showed [Ks Ah] and lost with a pair of Deuces
Seat 3: uw9QayAAxLM3Hb+HR7mSkg folded before Flop (didn't bet)
Seat 4: 75K2MXwN65Sjfp1yHd50Hg showed [Jh Js] and won ($28.50) with two pair, Jacks and Deuces
Seat 5: WGW0DgjBUXs1ylURHG8vnQ folded before Flop (didn't bet)
Seat 6: 997ViqAtWn1FPjJqcffwcA folded before Flop (didn't bet)
Seat 7: KPLH0gELgFe2OuAnhJFI5w folded before Flop (didn't bet)
Seat 8: HkZI6g4zl83TDTA7SRspmQ folded before Flop
Seat 9: mSD1pginDsyHG5PDfqzphw (button) showed [Tc Ts] and won ($1.45) with two pair, Tens and Deuces



PokerStars Game #59940018404:  Hold'em No Limit ($0.25/$0.50) - 2009/07/01 0:55:04 ET
Table 'lSisgp6H7Fg1hH5VfjEjYQ' 9-max Seat #8 is the button
Seat 1: 5k9fvXD9suIgCxU4HLQjTw ($50 in chips)
Seat 2: UrcnkQOiLVk8BlKDPJSy7Q ($76.10 in chips)
Seat 3: aTkyjTh3w5YLWiIERupZOA ($51.20 in chips)
Seat 4: bwv/rbH/hHhPhY6u9mu04w ($33.60 in chips)
Seat 5: mSD1pginDsyHG5PDfqzphw ($12.60 in chips)
Seat 6: +k7T5ocke8UwavtgUHm+Cg ($52.15 in chips)
Seat 7: IDtNLR9uFCDdjNsJWMHA5Q ($19.85 in chips)
Seat 8: a4JDWmpFQkL10XfAyuF51A ($29.50 in chips)
Seat 9: gsyXT42WLEcOS4DdEk2wlw ($42.55 in chips)
gsyXT42WLEcOS4DdEk2wlw: posts small blind $0.25
5k9fvXD9suIgCxU4HLQjTw: posts big blind $0.50
*** HOLE CARDS ***
UrcnkQOiLVk8BlKDPJSy7Q: folds
aTkyjTh3w5YLWiIERupZOA: folds
bwv/rbH/hHhPhY6u9mu04w: calls $0.50
mSD1pginDsyHG5PDfqzphw: folds
+k7T5ocke8UwavtgUHm+Cg: calls $0.50
IDtNLR9uFCDdjNsJWMHA5Q: folds
a4JDWmpFQkL10XfAyuF51A: calls $0.50
gsyXT42WLEcOS4DdEk2wlw: calls $0.25
5k9fvXD9suIgCxU4HLQjTw: checks
*** FLOP *** [8h 8s 2h]
gsyXT42WLEcOS4DdEk2wlw: checks
5k9fvXD9suIgCxU4HLQjTw: checks
bwv/rbH/hHhPhY6u9mu04w: checks
+k7T5ocke8UwavtgUHm+Cg: checks
a4JDWmpFQkL10XfAyuF51A: checks
*** TURN *** [8h 8s 2h] [4c]
gsyXT42WLEcOS4DdEk2wlw: checks
5k9fvXD9suIgCxU4HLQjTw: checks
bwv/rbH/hHhPhY6u9mu04w: checks
+k7T5ocke8UwavtgUHm+Cg: checks
a4JDWmpFQkL10XfAyuF51A: checks
*** RIVER *** [8h 8s 2h 4c] [5d]
gsyXT42WLEcOS4DdEk2wlw: checks
5k9fvXD9suIgCxU4HLQjTw: checks
bwv/rbH/hHhPhY6u9mu04w: bets $1
+k7T5ocke8UwavtgUHm+Cg: raises $3 to $4
a4JDWmpFQkL10XfAyuF51A: folds
gsyXT42WLEcOS4DdEk2wlw: folds
5k9fvXD9suIgCxU4HLQjTw: folds
bwv/rbH/hHhPhY6u9mu04w: folds
+k7T5ocke8UwavtgUHm+Cg collected $4.30 from pot
+k7T5ocke8UwavtgUHm+Cg: doesn't show hand
*** SUMMARY ***
Total pot $4.50 | Rake $0.20
Board [8h 8s 2h 4c 5d]
Seat 1: 5k9fvXD9suIgCxU4HLQjTw (big blind) folded on the River
Seat 2: UrcnkQOiLVk8BlKDPJSy7Q folded before Flop (didn't bet)
Seat 3: aTkyjTh3w5YLWiIERupZOA folded before Flop (didn't bet)
Seat 4: bwv/rbH/hHhPhY6u9mu04w folded on the River
Seat 5: mSD1pginDsyHG5PDfqzphw folded before Flop (didn't bet)
Seat 6: +k7T5ocke8UwavtgUHm+Cg collected ($4.30)
Seat 7: IDtNLR9uFCDdjNsJWMHA5Q folded before Flop (didn't bet)
Seat 8: a4JDWmpFQkL10XfAyuF51A (button) folded on the River
Seat 9: gsyXT42WLEcOS4DdEk2wlw (small blind) folded on the River



PokerStars Game #59940019342:  Hold'em No Limit ($0.25/$0.50) - 2009/07/01 0:55:05 ET
Table 'Vdlc9wqYcHTUhtdyN7CuJw' 2-max Seat #2 is the button
Seat 1: yBO+mXB6m/rCft2ErwGf/Q ($118.05 in chips)
Seat 2: NZ/5cxwnorKW2SNsWy1+8A ($6.80 in chips)
NZ/5cxwnorKW2SNsWy1+8A: posts small blind $0.25
yBO+mXB6m/rCft2ErwGf/Q: posts big blind $0.50
*** HOLE CARDS ***
NZ/5cxwnorKW2SNsWy1+8A: calls $0.25
yBO+mXB6m/rCft2ErwGf/Q: checks
*** FLOP *** [Kc 2d 9d]
yBO+mXB6m/rCft2ErwGf/Q: checks
NZ/5cxwnorKW2SNsWy1+8A: bets $0.50
yBO+mXB6m/rCft2ErwGf/Q: folds
NZ/5cxwnorKW2SNsWy1+8A collected $0.95 from pot
NZ/5cxwnorKW2SNsWy1+8A: doesn't show hand
*** SUMMARY ***
Total pot $1 | Rake $0.05
Board [Kc 2d 9d]
Seat 1: yBO+mXB6m/rCft2ErwGf/Q (big blind) folded on the Flop
Seat 2: NZ/5cxwnorKW2SNsWy1+8A (button) (small blind) collected ($0.95)



PokerStars Game #59940020050:  Hold'em No Limit ($0.25/$0.50) - 2009/07/01 0:55:06 ET
Table '+dXkOAQyS8j9PQZusUTMpg' 2-max Seat #1 is the button
Seat 1: XFa6sBGjP2gxoIvxR3fZIg ($64.95 in chips)
Seat 2: 5IBeOgaApY1Bvzv2P8X4EA ($135.90 in chips)
XFa6sBGjP2gxoIvxR3fZIg: posts small blind $0.25
5IBeOgaApY1Bvzv2P8X4EA: posts big blind $0.50
*** HOLE CARDS ***
XFa6sBGjP2gxoIvxR3fZIg: raises $1 to $1.50
5IBeOgaApY1Bvzv2P8X4EA: calls $1
*** FLOP *** [5d 4s 6c]
5IBeOgaApY1Bvzv2P8X4EA: checks
XFa6sBGjP2gxoIvxR3fZIg: checks
*** TURN *** [5d 4s 6c] [Jh]
5IBeOgaApY1Bvzv2P8X4EA: checks
XFa6sBGjP2gxoIvxR3fZIg: checks
*** RIVER *** [5d 4s 6c Jh] [As]
5IBeOgaApY1Bvzv2P8X4EA: checks
XFa6sBGjP2gxoIvxR3fZIg: checks
*** SHOW DOWN ***
5IBeOgaApY1Bvzv2P8X4EA: shows [9c 8s] (high card Ace)
XFa6sBGjP2gxoIvxR3fZIg: shows [5c Ts] (a pair of Fives)
XFa6sBGjP2gxoIvxR3fZIg collected $2.85 from pot
*** SUMMARY ***
Total pot $3 | Rake $0.15
Board [5d 4s 6c Jh As]
Seat 1: XFa6sBGjP2gxoIvxR3fZIg (button) (small blind) showed [5c Ts] and won ($2.85) with a pair of Fives
Seat 2: 5IBeOgaApY1Bvzv2P8X4EA (big blind) showed [9c 8s] and lost with high card Ace



PokerStars Game #59940020498:  Hold'em No Limit ($0.25/$0.50) - 2009/07/01 0:55:07 ET
Table '0eJtgVAXVvBgncFdcUpXcQ' 2-max Seat #2 is the button
Seat 1: Ag6DvxX4vbRheqsv2zXKTQ ($38.95 in chips)
Seat 2: KMc4R+K9ao4Ur3rF7NGe6Q ($11.95 in chips)
KMc4R+K9ao4Ur3rF7NGe6Q: posts small blind $0.25
Ag6DvxX4vbRheqsv2zXKTQ: posts big blind $0.50
*** HOLE CARDS ***
KMc4R+K9ao4Ur3rF7NGe6Q: calls $0.25
Ag6DvxX4vbRheqsv2zXKTQ: checks
*** FLOP *** [Ts 4c Th]
Ag6DvxX4vbRheqsv2zXKTQ: checks
KMc4R+K9ao4Ur3rF7NGe6Q: checks
*** TURN *** [Ts 4c Th] [Tc]
Ag6DvxX4vbRheqsv2zXKTQ: bets $0.50
KMc4R+K9ao4Ur3rF7NGe6Q: calls $0.50
*** RIVER *** [Ts 4c Th Tc] [9c]
Ag6DvxX4vbRheqsv2zXKTQ: checks
KMc4R+K9ao4Ur3rF7NGe6Q: checks
*** SHOW DOWN ***
Ag6DvxX4vbRheqsv2zXKTQ: shows [3h Ah] (three of a kind, Tens)
KMc4R+K9ao4Ur3rF7NGe6Q: shows [2d 2c] (a full house, Tens full of Deuces)
KMc4R+K9ao4Ur3rF7NGe6Q collected $1.95 from pot
*** SUMMARY ***
Total pot $2 | Rake $0.05
Board [Ts 4c Th Tc 9c]
Seat 1: Ag6DvxX4vbRheqsv2zXKTQ (big blind) showed [3h Ah] and lost with three of a kind, Tens
Seat 2: KMc4R+K9ao4Ur3rF7NGe6Q (button) (small blind) showed [2d 2c] and won ($1.95) with a full house, Tens full of Deuces



PokerStars Game #59940022404:  Hold'em No Limit ($0.25/$0.50) - 2009/07/01 0:55:10 ET
Table 'MJxeZCzYELxiIsyUZyT0jw' 6-max Seat #6 is the button
Seat 1: +Pf9jTVizYlIo+woPvptfA ($50 in chips)
Seat 2: t3GiVMzqA9Svgr5Uol32cQ ($36.10 in chips)
Seat 3: JQZew0FjzS19kTjeNtrE+A ($62.45 in chips)
Seat 4: alGiiQP/wwtYnfuXII+sgw ($48.60 in chips)
Seat 5: 3jvoOXNtXE90w2BdfNZwZQ ($50 in chips)
Seat 6: TTx3CHxyi0SObcHyMJRp5w ($59.85 in chips)
+Pf9jTVizYlIo+woPvptfA: posts small blind $0.25
t3GiVMzqA9Svgr5Uol32cQ: posts big blind $0.50
*** HOLE CARDS ***
JQZew0FjzS19kTjeNtrE+A: folds
alGiiQP/wwtYnfuXII+sgw: folds
3jvoOXNtXE90w2BdfNZwZQ: folds
TTx3CHxyi0SObcHyMJRp5w: calls $0.50
+Pf9jTVizYlIo+woPvptfA: folds
t3GiVMzqA9Svgr5Uol32cQ: checks
*** FLOP *** [9c 7c 7d]
t3GiVMzqA9Svgr5Uol32cQ: checks
TTx3CHxyi0SObcHyMJRp5w: checks
*** TURN *** [9c 7c 7d] [Kd]
t3GiVMzqA9Svgr5Uol32cQ: checks
TTx3CHxyi0SObcHyMJRp5w: bets $1
t3GiVMzqA9Svgr5Uol32cQ: folds
TTx3CHxyi0SObcHyMJRp5w collected $1.20 from pot
TTx3CHxyi0SObcHyMJRp5w: doesn't show hand
*** SUMMARY ***
Total pot $1.25 | Rake $0.05
Board [9c 7c 7d Kd]
Seat 1: +Pf9jTVizYlIo+woPvptfA (small blind) folded before Flop
Seat 2: t3GiVMzqA9Svgr5Uol32cQ (big blind) folded on the Turn
Seat 3: JQZew0FjzS19kTjeNtrE+A folded before Flop (didn't bet)
Seat 4: alGiiQP/wwtYnfuXII+sgw folded before Flop (didn't bet)
Seat 5: 3jvoOXNtXE90w2BdfNZwZQ folded before Flop (didn't bet)
Seat 6: TTx3CHxyi0SObcHyMJRp5w (button) collected ($1.20)



PokerStars Game #59940022548:  Hold'em No Limit ($0.25/$0.50) - 2009/07/01 0:55:11 ET
Table '9Puy2HWN1RQe5SSjq162gA' 2-max Seat #1 is the button
Seat 1: Fp/oksNpipCrD2MJ2pH20g ($9.50 in chips)
Seat 2: tDV+zhxH9+3DkJDzoTERyg ($20.50 in chips)
Fp/oksNpipCrD2MJ2pH20g: posts small blind $0.25
tDV+zhxH9+3DkJDzoTERyg: posts big blind $0.50
*** HOLE CARDS ***
Fp/oksNpipCrD2MJ2pH20g: raises $0.50 to $1
tDV+zhxH9+3DkJDzoTERyg: calls $0.50
*** FLOP *** [Qs Qc 9c]
tDV+zhxH9+3DkJDzoTERyg: checks
Fp/oksNpipCrD2MJ2pH20g: bets $0.50
tDV+zhxH9+3DkJDzoTERyg: folds
Fp/oksNpipCrD2MJ2pH20g collected $1.90 from pot
Fp/oksNpipCrD2MJ2pH20g: doesn't show hand
*** SUMMARY ***
Total pot $2 | Rake $0.10
Board [Qs Qc 9c]
Seat 1: Fp/oksNpipCrD2MJ2pH20g (button) (small blind) collected ($1.90)
Seat 2: tDV+zhxH9+3DkJDzoTERyg (big blind) folded on the Flop



PokerStars Game #59940023240:  Hold'em No Limit ($0.25/$0.50) - 2009/07/01 0:55:12 ET
Table '99gCy/CZQwPIjZWH+BguQgE7bWJ45aoFXRpyRv2gw+Igeat #5 is the button
Seat 2: n6VQBu6crjYjy6DxNP1NZA ($28.75 in chips)
Seat 3: qEn9ijNGtuyTxamBf07hYg ($50 in chips)
Seat 4: bxLSulbgr8LmKNjOzw8URg ($60.70 in chips)
Seat 5: DSM67hHHq1XFoEOi9p8Alw ($44.25 in chips)
Seat 7: bfSq6LBw0UvxeM5yfuWC7w ($17.35 in chips)
Seat 8: 8ehL7qlZzjgUh2H35iiWLw ($52.50 in chips)
Seat 9: j3K/Jujr7PY4ZM2RZvlH6A ($101.20 in chips)
bfSq6LBw0UvxeM5yfuWC7w: posts small blind $0.25
8ehL7qlZzjgUh2H35iiWLw: posts big blind $0.50
*** HOLE CARDS ***
j3K/Jujr7PY4ZM2RZvlH6A: folds
n6VQBu6crjYjy6DxNP1NZA: folds
qEn9ijNGtuyTxamBf07hYg: folds
bxLSulbgr8LmKNjOzw8URg: raises $1 to $1.50
DSM67hHHq1XFoEOi9p8Alw: folds
bfSq6LBw0UvxeM5yfuWC7w: folds
8ehL7qlZzjgUh2H35iiWLw: folds
bxLSulbgr8LmKNjOzw8URg collected $1.25 from pot
bxLSulbgr8LmKNjOzw8URg: doesn't show hand
*** SUMMARY ***
Total pot $1.25 | Rake $0
Seat 2: n6VQBu6crjYjy6DxNP1NZA folded before Flop (didn't bet)
Seat 3: qEn9ijNGtuyTxamBf07hYg folded before Flop (didn't bet)
Seat 4: bxLSulbgr8LmKNjOzw8URg collected ($1.25)
Seat 5: DSM67hHHq1XFoEOi9p8Alw (button) folded before Flop (didn't bet)
Seat 7: bfSq6LBw0UvxeM5yfuWC7w (small blind) folded before Flop
Seat 8: 8ehL7qlZzjgUh2H35iiWLw (big blind) folded before Flop
Seat 9: j3K/Jujr7PY4ZM2RZvlH6A folded before Flop (didn't bet)



PokerStars Game #59940023684:  Hold'em No Limit ($0.25/$0.50) - 2009/07/01 0:55:12 ET
Table 'EiNh8p/wGJ1FP575iMFnqg' 9-max Seat #2 is the button
Seat 1: r3ZqM1Mi0W3y4hOdssE+Sg ($44.85 in chips)
Seat 2: 8ehL7qlZzjgUh2H35iiWLw ($51.85 in chips)
Seat 3: ymLPoEIl7UL3TvZYmnadxQ ($52.05 in chips)
Seat 4: cMzaiXAM/ZAdNaEUu+LqhA ($55.70 in chips)
Seat 5: M+7+BTmX5vZatHVuoRB1nA ($82.20 in chips)
Seat 6: 3UmXLy3GfjC3EkOebduerQ ($65.35 in chips)
Seat 7: 997ViqAtWn1FPjJqcffwcA ($50 in chips)
Seat 8: mSD1pginDsyHG5PDfqzphw ($10 in chips)
Seat 9: NnQCepdIR/AOUQn1yhYx6Q ($10 in chips)
ymLPoEIl7UL3TvZYmnadxQ: posts small blind $0.25
cMzaiXAM/ZAdNaEUu+LqhA: posts big blind $0.50
*** HOLE CARDS ***
M+7+BTmX5vZatHVuoRB1nA: folds
3UmXLy3GfjC3EkOebduerQ: folds
997ViqAtWn1FPjJqcffwcA: folds
mSD1pginDsyHG5PDfqzphw: folds
NnQCepdIR/AOUQn1yhYx6Q: raises $1.50 to $2
r3ZqM1Mi0W3y4hOdssE+Sg: folds
8ehL7qlZzjgUh2H35iiWLw: folds
ymLPoEIl7UL3TvZYmnadxQ: folds
cMzaiXAM/ZAdNaEUu+LqhA: folds
NnQCepdIR/AOUQn1yhYx6Q collected $1.25 from pot
*** SUMMARY ***
Total pot $1.25 | Rake $0
Seat 1: r3ZqM1Mi0W3y4hOdssE+Sg folded before Flop (didn't bet)
Seat 2: 8ehL7qlZzjgUh2H35iiWLw (button) folded before Flop (didn't bet)
Seat 3: ymLPoEIl7UL3TvZYmnadxQ (small blind) folded before Flop
Seat 4: cMzaiXAM/ZAdNaEUu+LqhA (big blind) folded before Flop
Seat 5: M+7+BTmX5vZatHVuoRB1nA folded before Flop (didn't bet)
Seat 6: 3UmXLy3GfjC3EkOebduerQ folded before Flop (didn't bet)
Seat 7: 997ViqAtWn1FPjJqcffwcA folded before Flop (didn't bet)
Seat 8: mSD1pginDsyHG5PDfqzphw folded before Flop (didn't bet)
Seat 9: NnQCepdIR/AOUQn1yhYx6Q collected ($1.25)



PokerStars Game #59940026786:  Hold'em No Limit ($0.25/$0.50) - 2009/07/01 0:55:17 ET
Table 'E7bWJ45aoFXRpyRv2gw+Ig' 2-max Seat #1 is the button
Seat 1: FRkiRasEGlHUeLrEl+k/nA ($112.25 in chips)
Seat 2: 3Wro85I7472vJ4Wkpneo9A ($79.65 in chips)
FRkiRasEGlHUeLrEl+k/nA: posts small blind $0.25
3Wro85I7472vJ4Wkpneo9A: posts big blind $0.50
*** HOLE CARDS ***
FRkiRasEGlHUeLrEl+k/nA: raises $1.50 to $2
3Wro85I7472vJ4Wkpneo9A: folds
FRkiRasEGlHUeLrEl+k/nA collected $1 from pot
*** SUMMARY ***
Total pot $1 | Rake $0
Seat 1: FRkiRasEGlHUeLrEl+k/nA (button) (small blind) collected ($1)
Seat 2: 3Wro85I7472vJ4Wkpneo9A (big blind) folded before Flop



PokerStars Game #59940028860:  Hold'em No Limit ($0.25/$0.50) - 2009/07/01 0:55:21 ET
Table 'c/CRn+68J3Y8KxD5g1ek2Q' 2-max Seat #2 is the button
Seat 1: 46qCyJ6evTkHo9al5sBMNA ($90.50 in chips)
Seat 2: BypVLsYQt3ePFm2xQL/dOA ($279.75 in chips)
BypVLsYQt3ePFm2xQL/dOA: posts small blind $0.25
46qCyJ6evTkHo9al5sBMNA: posts big blind $0.50
*** HOLE CARDS ***
BypVLsYQt3ePFm2xQL/dOA: calls $0.25
46qCyJ6evTkHo9al5sBMNA: raises $1.50 to $2
BypVLsYQt3ePFm2xQL/dOA: folds
46qCyJ6evTkHo9al5sBMNA collected $1 from pot
46qCyJ6evTkHo9al5sBMNA: doesn't show hand
*** SUMMARY ***
Total pot $1 | Rake $0
Seat 1: 46qCyJ6evTkHo9al5sBMNA (big blind) collected ($1)
Seat 2: BypVLsYQt3ePFm2xQL/dOA (button) (small blind) folded before Flop



PokerStars Game #59940030040:  Hold'em No Limit ($0.25/$0.50) - 2009/07/01 0:55:23 ET
Table '0eJtgVAXVvBgncFdcUpXcQ' 2-max Seat #1 is the button
Seat 1: Ag6DvxX4vbRheqsv2zXKTQ ($37.95 in chips)
Seat 2: KMc4R+K9ao4Ur3rF7NGe6Q ($12.90 in chips)
Ag6DvxX4vbRheqsv2zXKTQ: posts small blind $0.25
KMc4R+K9ao4Ur3rF7NGe6Q: posts big blind $0.50
*** HOLE CARDS ***
Ag6DvxX4vbRheqsv2zXKTQ: raises $1 to $1.50
KMc4R+K9ao4Ur3rF7NGe6Q: calls $1
*** FLOP *** [4s 3c 8c]
KMc4R+K9ao4Ur3rF7NGe6Q: checks
Ag6DvxX4vbRheqsv2zXKTQ: checks
*** TURN *** [4s 3c 8c] [5d]
KMc4R+K9ao4Ur3rF7NGe6Q: bets $0.50
Ag6DvxX4vbRheqsv2zXKTQ: calls $0.50
*** RIVER *** [4s 3c 8c 5d] [5h]
KMc4R+K9ao4Ur3rF7NGe6Q: checks
Ag6DvxX4vbRheqsv2zXKTQ: checks
*** SHOW DOWN ***
KMc4R+K9ao4Ur3rF7NGe6Q: shows [Jh Th] (a pair of Fives)
Ag6DvxX4vbRheqsv2zXKTQ: shows [Js Ah] (a pair of Fives - Ace kicker)
Ag6DvxX4vbRheqsv2zXKTQ collected $3.85 from pot
*** SUMMARY ***
Total pot $4 | Rake $0.15
Board [4s 3c 8c 5d 5h]
Seat 1: Ag6DvxX4vbRheqsv2zXKTQ (button) (small blind) showed [Js Ah] and won ($3.85) with a pair of Fives
Seat 2: KMc4R+K9ao4Ur3rF7NGe6Q (big blind) showed [Jh Th] and lost with a pair of Fives



PokerStars Game #59940030386:  Hold'em No Limit ($0.25/$0.50) - 2009/07/01 0:55:23 ET
Table 'fx6MqwfYAj/Rt86hBz2L3Q' 9-max Seat #8 is the button
Seat 1: SegjDnMxWMujiD57ESNL+g ($10 in chips)
Seat 2: C3rGXblctNcWI6JYPHhaEg ($10 in chips)
Seat 3: iadBi5AEt7gTBXbDSSnMYQ ($77.45 in chips)
Seat 5: iAISe3dVeua8PUn2wwgDHw ($30 in chips)
Seat 6: 5k9fvXD9suIgCxU4HLQjTw ($50 in chips)
Seat 7: SKnJuWHScqetA/qG5p+wCg ($30 in chips)
Seat 8: JYwJYYV9pM5KWdSiETl8rA ($26.50 in chips)
Seat 9: HZkVla4kK2SI42CVrPZ/ig ($11.75 in chips)
HZkVla4kK2SI42CVrPZ/ig: posts small blind $0.25
SegjDnMxWMujiD57ESNL+g: posts big blind $0.50
C3rGXblctNcWI6JYPHhaEg: posts small & big blinds $0.75
75K2MXwN65Sjfp1yHd50Hg: sits out
*** HOLE CARDS ***
C3rGXblctNcWI6JYPHhaEg: raises $0.50 to $1
iadBi5AEt7gTBXbDSSnMYQ: calls $1
iAISe3dVeua8PUn2wwgDHw: calls $1
5k9fvXD9suIgCxU4HLQjTw: calls $1
SKnJuWHScqetA/qG5p+wCg: folds
JYwJYYV9pM5KWdSiETl8rA: folds
HZkVla4kK2SI42CVrPZ/ig: calls $0.75
SegjDnMxWMujiD57ESNL+g: calls $0.50
*** FLOP *** [4h 8s Kh]
HZkVla4kK2SI42CVrPZ/ig: checks
SegjDnMxWMujiD57ESNL+g: checks
C3rGXblctNcWI6JYPHhaEg: bets $2.75
iadBi5AEt7gTBXbDSSnMYQ: folds
iAISe3dVeua8PUn2wwgDHw: calls $2.75
5k9fvXD9suIgCxU4HLQjTw: raises $6.75 to $9.50
HZkVla4kK2SI42CVrPZ/ig: folds
SegjDnMxWMujiD57ESNL+g: folds
C3rGXblctNcWI6JYPHhaEg: calls $6 and is all-in
iAISe3dVeua8PUn2wwgDHw: folds
*** TURN *** [4h 8s Kh] [7s]
*** RIVER *** [4h 8s Kh 7s] [Ah]
*** SHOW DOWN ***
C3rGXblctNcWI6JYPHhaEg: shows [As Ac] (three of a kind, Aces)
5k9fvXD9suIgCxU4HLQjTw: mucks hand
C3rGXblctNcWI6JYPHhaEg collected $25.20 from pot
*** SUMMARY ***
Total pot $26.50 | Rake $1.30
Board [4h 8s Kh 7s Ah]
Seat 1: SegjDnMxWMujiD57ESNL+g (big blind) folded on the Flop
Seat 2: C3rGXblctNcWI6JYPHhaEg showed [As Ac] and won ($25.20) with three of a kind, Aces
Seat 3: iadBi5AEt7gTBXbDSSnMYQ folded on the Flop
Seat 5: iAISe3dVeua8PUn2wwgDHw folded on the Flop
Seat 6: 5k9fvXD9suIgCxU4HLQjTw mucked
Seat 7: SKnJuWHScqetA/qG5p+wCg folded before Flop (didn't bet)
Seat 8: JYwJYYV9pM5KWdSiETl8rA (button) folded before Flop (didn't bet)
Seat 9: HZkVla4kK2SI42CVrPZ/ig (small blind) folded on the Flop



PokerStars Game #59940032344:  Hold'em No Limit ($0.25/$0.50) - 2009/07/01 0:55:26 ET
Table 'E7bWJ45aoFXRpyRv2gw+Ig' 2-max Seat #2 is the button
Seat 1: FRkiRasEGlHUeLrEl+k/nA ($112.75 in chips)
Seat 2: 3Wro85I7472vJ4Wkpneo9A ($79.15 in chips)
3Wro85I7472vJ4Wkpneo9A: posts small blind $0.25
FRkiRasEGlHUeLrEl+k/nA: posts big blind $0.50
*** HOLE CARDS ***
3Wro85I7472vJ4Wkpneo9A: raises $1 to $1.50
FRkiRasEGlHUeLrEl+k/nA: raises $3 to $4.50
3Wro85I7472vJ4Wkpneo9A: calls $3
*** FLOP *** [2d 3d 9h]
FRkiRasEGlHUeLrEl+k/nA: bets $6
3Wro85I7472vJ4Wkpneo9A: calls $6
*** TURN *** [2d 3d 9h] [4c]
FRkiRasEGlHUeLrEl+k/nA: bets $12
3Wro85I7472vJ4Wkpneo9A: calls $12
*** RIVER *** [2d 3d 9h 4c] [8s]
FRkiRasEGlHUeLrEl+k/nA: bets $24
3Wro85I7472vJ4Wkpneo9A: calls $24
*** SHOW DOWN ***
FRkiRasEGlHUeLrEl+k/nA: shows [Ts Ks] (high card King)
3Wro85I7472vJ4Wkpneo9A: shows [Qd 8d] (a pair of Eights)
3Wro85I7472vJ4Wkpneo9A collected $92.50 from pot
*** SUMMARY ***
Total pot $93 | Rake $0.50
Board [2d 3d 9h 4c 8s]
Seat 1: FRkiRasEGlHUeLrEl+k/nA (big blind) showed [Ts Ks] and lost with high card King
Seat 2: 3Wro85I7472vJ4Wkpneo9A (button) (small blind) showed [Qd 8d] and won ($92.50) with a pair of Eights



PokerStars Game #59940032084:  Hold'em No Limit ($0.25/$0.50) - 2009/07/01 0:55:26 ET
Table 'GfL/No5u5PoEnU39lP5pQg' 6-max Seat #2 is the button
Seat 1: 1WUCqNG+p+vfWRTXNu4ljw ($60 in chips)
Seat 2: uVwggSetzp7d+eVgowO3vg ($50.70 in chips)
Seat 4: r6u7MWSXF30/khcTYkrG9Q ($33.70 in chips)
Seat 6: kxPhs4ePFqMy52CInAJ2aw ($55.50 in chips)
r6u7MWSXF30/khcTYkrG9Q: posts small blind $0.25
kxPhs4ePFqMy52CInAJ2aw: posts big blind $0.50
*** HOLE CARDS ***
1WUCqNG+p+vfWRTXNu4ljw: folds
uVwggSetzp7d+eVgowO3vg: raises $0.75 to $1.25
uVwggSetzp7d+eVgowO3vg said, "nh"
r6u7MWSXF30/khcTYkrG9Q said, "ty"
r6u7MWSXF30/khcTYkrG9Q said, "that J was a little rough to see"
r6u7MWSXF30/khcTYkrG9Q: folds
kxPhs4ePFqMy52CInAJ2aw: raises $4.75 to $6
r6u7MWSXF30/khcTYkrG9Q said, "could have gone harder otherwise"
uVwggSetzp7d+eVgowO3vg said, "yeah I know that's what i was hoping you would be thinking about"
uVwggSetzp7d+eVgowO3vg: folds
kxPhs4ePFqMy52CInAJ2aw collected $2.75 from pot
kxPhs4ePFqMy52CInAJ2aw: doesn't show hand
*** SUMMARY ***
Total pot $2.75 | Rake $0
Seat 1: 1WUCqNG+p+vfWRTXNu4ljw folded before Flop (didn't bet)
Seat 2: uVwggSetzp7d+eVgowO3vg (button) folded before Flop
Seat 4: r6u7MWSXF30/khcTYkrG9Q (small blind) folded before Flop
Seat 6: kxPhs4ePFqMy52CInAJ2aw (big blind) collected ($2.75)



PokerStars Game #59940032554:  Hold'em No Limit ($0.25/$0.50) - 2009/07/01 0:55:27 ET
Table 'otvGDROEDdqsabxskT79qg' 9-max Seat #5 is the button
Seat 1: 8ehL7qlZzjgUh2H35iiWLw ($57.50 in chips)
Seat 2: cCjTzH9jio8607WzjcfXlg ($14.30 in chips)
Seat 3: +k7T5ocke8UwavtgUHm+Cg ($66.50 in chips)
Seat 4: MG90wfSJZnOejs/KD3vlQQ ($73.20 in chips)
Seat 5: XNMDwbXt/Q4jM99AXnbJDw ($50 in chips)
Seat 6: bxLSulbgr8LmKNjOzw8URg ($53.20 in chips)
Seat 7: C7+tBppJrKgd/r+tuKUIpA ($33.30 in chips)
Seat 8: zE9cVigS2nW/Ljy4K4bUQA ($30 in chips)
Seat 9: KcY3X8YpD74Kw1RHkx/g4A ($57.90 in chips)
bxLSulbgr8LmKNjOzw8URg: posts small blind $0.25
C7+tBppJrKgd/r+tuKUIpA: posts big blind $0.50
*** HOLE CARDS ***
zE9cVigS2nW/Ljy4K4bUQA: folds
KcY3X8YpD74Kw1RHkx/g4A: folds
8ehL7qlZzjgUh2H35iiWLw: folds
cCjTzH9jio8607WzjcfXlg: folds
+k7T5ocke8UwavtgUHm+Cg: folds
MG90wfSJZnOejs/KD3vlQQ: folds
XNMDwbXt/Q4jM99AXnbJDw: raises $0.50 to $1
bxLSulbgr8LmKNjOzw8URg: folds
C7+tBppJrKgd/r+tuKUIpA: calls $0.50
*** FLOP *** [5s Ac Tc]
C7+tBppJrKgd/r+tuKUIpA: checks
XNMDwbXt/Q4jM99AXnbJDw: bets $2
C7+tBppJrKgd/r+tuKUIpA: folds
XNMDwbXt/Q4jM99AXnbJDw collected $2.15 from pot
XNMDwbXt/Q4jM99AXnbJDw: doesn't show hand
*** SUMMARY ***
Total pot $2.25 | Rake $0.10
Board [5s Ac Tc]
Seat 1: 8ehL7qlZzjgUh2H35iiWLw folded before Flop (didn't bet)
Seat 2: cCjTzH9jio8607WzjcfXlg folded before Flop (didn't bet)
Seat 3: +k7T5ocke8UwavtgUHm+Cg folded before Flop (didn't bet)
Seat 4: MG90wfSJZnOejs/KD3vlQQ folded before Flop (didn't bet)
Seat 5: XNMDwbXt/Q4jM99AXnbJDw (button) collected ($2.15)
Seat 6: bxLSulbgr8LmKNjOzw8URg (small blind) folded before Flop
Seat 7: C7+tBppJrKgd/r+tuKUIpA (big blind) folded on the Flop
Seat 8: zE9cVigS2nW/Ljy4K4bUQA folded before Flop (didn't bet)
Seat 9: KcY3X8YpD74Kw1RHkx/g4A folded before Flop (didn't bet)



PokerStars Game #59940032608:  Hold'em No Limit ($0.25/$0.50) - 2009/07/01 0:55:27 ET
Table '+dXkOAQyS8j9PQZusUTMpg' 2-max Seat #2 is the button
Seat 1: XFa6sBGjP2gxoIvxR3fZIg ($66.30 in chips)
Seat 2: 5IBeOgaApY1Bvzv2P8X4EA ($134.40 in chips)
5IBeOgaApY1Bvzv2P8X4EA: posts small blind $0.25
XFa6sBGjP2gxoIvxR3fZIg: posts big blind $0.50
*** HOLE CARDS ***
5IBeOgaApY1Bvzv2P8X4EA: calls $0.25
XFa6sBGjP2gxoIvxR3fZIg: raises $2 to $2.50
5IBeOgaApY1Bvzv2P8X4EA: calls $2
*** FLOP *** [Kd 5c 3h]
XFa6sBGjP2gxoIvxR3fZIg: bets $4
5IBeOgaApY1Bvzv2P8X4EA: raises $5 to $9
XFa6sBGjP2gxoIvxR3fZIg: folds
5IBeOgaApY1Bvzv2P8X4EA collected $12.50 from pot
5IBeOgaApY1Bvzv2P8X4EA: doesn't show hand
*** SUMMARY ***
Total pot $13 | Rake $0.50
Board [Kd 5c 3h]
Seat 1: XFa6sBGjP2gxoIvxR3fZIg (big blind) folded on the Flop
Seat 2: 5IBeOgaApY1Bvzv2P8X4EA (button) (small blind) collected ($12.50)



PokerStars Game #59940034812:  Hold'em No Limit ($0.25/$0.50) - 2009/07/01 0:55:30 ET
Table 'kgbJRsxfv64KrErDRBAkcw' 6-max Seat #2 is the button
Seat 1: w2dj3tZyWCX7+wEKRi0AVw ($14.60 in chips)
Seat 2: AdS8BJMOheS01zjCDfPMFg ($48.25 in chips)
Seat 3: c4MNIaIyPMOMxrgT8FT5nA ($124.60 in chips)
Seat 4: qanMEqjABjWxC/JgQ/0l7w ($58 in chips)
Seat 5: eUBBn2R56C1IQ6Cs/vitwg ($50 in chips)
Seat 6: 1b+2BbjMN8qhR1WPqdE9VQ ($53.40 in chips)
c4MNIaIyPMOMxrgT8FT5nA: posts small blind $0.25
qanMEqjABjWxC/JgQ/0l7w: posts big blind $0.50
*** HOLE CARDS ***
eUBBn2R56C1IQ6Cs/vitwg: folds
1b+2BbjMN8qhR1WPqdE9VQ: folds
w2dj3tZyWCX7+wEKRi0AVw: raises $1 to $1.50
AdS8BJMOheS01zjCDfPMFg: folds
c4MNIaIyPMOMxrgT8FT5nA: calls $1.25
qanMEqjABjWxC/JgQ/0l7w: folds
*** FLOP *** [6c 8d 9s]
c4MNIaIyPMOMxrgT8FT5nA: checks
w2dj3tZyWCX7+wEKRi0AVw: bets $2
c4MNIaIyPMOMxrgT8FT5nA: raises $3.50 to $5.50
w2dj3tZyWCX7+wEKRi0AVw: raises $7.60 to $13.10 and is all-in
c4MNIaIyPMOMxrgT8FT5nA: calls $7.60
*** TURN *** [6c 8d 9s] [4s]
*** RIVER *** [6c 8d 9s 4s] [6d]
*** SHOW DOWN ***
c4MNIaIyPMOMxrgT8FT5nA: shows [As 3h] (a pair of Sixes)
w2dj3tZyWCX7+wEKRi0AVw: shows [7d 7s] (two pair, Sevens and Sixes)
w2dj3tZyWCX7+wEKRi0AVw collected $28.25 from pot
*** SUMMARY ***
Total pot $29.70 | Rake $1.45
Board [6c 8d 9s 4s 6d]
Seat 1: w2dj3tZyWCX7+wEKRi0AVw showed [7d 7s] and won ($28.25) with two pair, Sevens and Sixes
Seat 2: AdS8BJMOheS01zjCDfPMFg (button) folded before Flop (didn't bet)
Seat 3: c4MNIaIyPMOMxrgT8FT5nA (small blind) showed [As 3h] and lost with a pair of Sixes
Seat 4: qanMEqjABjWxC/JgQ/0l7w (big blind) folded before Flop
Seat 5: eUBBn2R56C1IQ6Cs/vitwg folded before Flop (didn't bet)
Seat 6: 1b+2BbjMN8qhR1WPqdE9VQ folded before Flop (didn't bet)



PokerStars Game #59940036262:  Hold'em No Limit ($0.25/$0.50) - 2009/07/01 0:55:32 ET
Table 'c/CRn+68J3Y8KxD5g1ek2Q' 2-max Seat #1 is the button
Seat 1: 46qCyJ6evTkHo9al5sBMNA ($91 in chips)
Seat 2: BypVLsYQt3ePFm2xQL/dOA ($279.25 in chips)
46qCyJ6evTkHo9al5sBMNA: posts small blind $0.25
BypVLsYQt3ePFm2xQL/dOA: posts big blind $0.50
*** HOLE CARDS ***
46qCyJ6evTkHo9al5sBMNA: folds
BypVLsYQt3ePFm2xQL/dOA collected $0.50 from pot
BypVLsYQt3ePFm2xQL/dOA: doesn't show hand
*** SUMMARY ***
Total pot $0.50 | Rake $0
Seat 1: 46qCyJ6evTkHo9al5sBMNA (button) (small blind) folded before Flop
Seat 2: BypVLsYQt3ePFm2xQL/dOA (big blind) collected ($0.50)



PokerStars Game #59940035754:  Hold'em No Limit ($0.25/$0.50) - 2009/07/01 0:55:32 ET
Table 'Vdlc9wqYcHTUhtdyN7CuJw' 2-max Seat #1 is the button
Seat 1: yBO+mXB6m/rCft2ErwGf/Q ($117.55 in chips)
Seat 2: NZ/5cxwnorKW2SNsWy1+8A ($7.25 in chips)
yBO+mXB6m/rCft2ErwGf/Q: posts small blind $0.25
NZ/5cxwnorKW2SNsWy1+8A: posts big blind $0.50
*** HOLE CARDS ***
yBO+mXB6m/rCft2ErwGf/Q: raises $0.50 to $1
NZ/5cxwnorKW2SNsWy1+8A: calls $0.50
*** FLOP *** [3c 8s 3h]
NZ/5cxwnorKW2SNsWy1+8A: checks
yBO+mXB6m/rCft2ErwGf/Q: bets $0.50
NZ/5cxwnorKW2SNsWy1+8A: calls $0.50
*** TURN *** [3c 8s 3h] [Ks]
NZ/5cxwnorKW2SNsWy1+8A: checks
yBO+mXB6m/rCft2ErwGf/Q: checks
*** RIVER *** [3c 8s 3h Ks] [9s]
NZ/5cxwnorKW2SNsWy1+8A: checks
yBO+mXB6m/rCft2ErwGf/Q: checks
*** SHOW DOWN ***
NZ/5cxwnorKW2SNsWy1+8A: shows [6s 8d] (two pair, Eights and Threes)
yBO+mXB6m/rCft2ErwGf/Q: mucks hand
NZ/5cxwnorKW2SNsWy1+8A collected $2.90 from pot
*** SUMMARY ***
Total pot $3 | Rake $0.10
Board [3c 8s 3h Ks 9s]
Seat 1: yBO+mXB6m/rCft2ErwGf/Q (button) (small blind) mucked
Seat 2: NZ/5cxwnorKW2SNsWy1+8A (big blind) showed [6s 8d] and won ($2.90) with two pair, Eights and Threes



PokerStars Game #59940037452:  Hold'em No Limit ($0.25/$0.50) - 2009/07/01 0:55:34 ET
Table '9Puy2HWN1RQe5SSjq162gA' 2-max Seat #2 is the button
Seat 1: Fp/oksNpipCrD2MJ2pH20g ($10.40 in chips)
Seat 2: tDV+zhxH9+3DkJDzoTERyg ($19.50 in chips)
tDV+zhxH9+3DkJDzoTERyg: posts small blind $0.25
Fp/oksNpipCrD2MJ2pH20g: posts big blind $0.50
*** HOLE CARDS ***
tDV+zhxH9+3DkJDzoTERyg: folds
Fp/oksNpipCrD2MJ2pH20g collected $0.50 from pot
Fp/oksNpipCrD2MJ2pH20g: doesn't show hand
*** SUMMARY ***
Total pot $0.50 | Rake $0
Seat 1: Fp/oksNpipCrD2MJ2pH20g (big blind) collected ($0.50)
Seat 2: tDV+zhxH9+3DkJDzoTERyg (button) (small blind) folded before Flop



PokerStars Game #59940037910:  Hold'em No Limit ($0.25/$0.50) - 2009/07/01 0:55:35 ET
Table '8BQGgNetI1NOvWeu3gtMNw' 2-max Seat #2 is the button
Seat 1: bypIyrYcAAifLfhZpGlKLA ($50 in chips)
Seat 2: Z4HwehErEwzsv/noQlfUlg ($133.55 in chips)
Z4HwehErEwzsv/noQlfUlg: posts small blind $0.25
bypIyrYcAAifLfhZpGlKLA: posts big blind $0.50
*** HOLE CARDS ***
Z4HwehErEwzsv/noQlfUlg: raises $1.50 to $2
bypIyrYcAAifLfhZpGlKLA: calls $1.50
*** FLOP *** [Ad 3h 4d]
bypIyrYcAAifLfhZpGlKLA: checks
Z4HwehErEwzsv/noQlfUlg: bets $2
bypIyrYcAAifLfhZpGlKLA: raises $6 to $8
Z4HwehErEwzsv/noQlfUlg: folds
bypIyrYcAAifLfhZpGlKLA collected $7.65 from pot
bypIyrYcAAifLfhZpGlKLA: doesn't show hand
*** SUMMARY ***
Total pot $8 | Rake $0.35
Board [Ad 3h 4d]
Seat 1: bypIyrYcAAifLfhZpGlKLA (big blind) collected ($7.65)
Seat 2: Z4HwehErEwzsv/noQlfUlg (button) (small blind) folded on the Flop



PokerStars Game #59940038194:  Hold'em No Limit ($0.25/$0.50) - 2009/07/01 0:55:35 ET
Table 'QOgaEqMcJ73pcUMMxoisUg' 6-max Seat #2 is the button
Seat 1: /olYG0EzMWzADIgH1y2ySQ ($21.70 in chips)
Seat 2: 4QfsCWthT/vSLirorNXqtg ($53.70 in chips)
Seat 3: Rt6KgtZ8YaJoTc3FPim00w ($88.30 in chips)
Seat 4: zAcsDhG/T128Vn7XGVSgKg ($50.10 in chips)
Seat 5: 6vNxrjjCl6FwfaaymM9jjg ($34.25 in chips)
Seat 6: GoVjFxr3C+JO9vtJH9+IcA ($25.90 in chips)
Rt6KgtZ8YaJoTc3FPim00w: posts small blind $0.25
zAcsDhG/T128Vn7XGVSgKg: posts big blind $0.50
*** HOLE CARDS ***
6vNxrjjCl6FwfaaymM9jjg: raises $2 to $2.50
GoVjFxr3C+JO9vtJH9+IcA: folds
/olYG0EzMWzADIgH1y2ySQ: calls $2.50
4QfsCWthT/vSLirorNXqtg: raises $7.75 to $10.25
Rt6KgtZ8YaJoTc3FPim00w: folds
zAcsDhG/T128Vn7XGVSgKg: folds
6vNxrjjCl6FwfaaymM9jjg: folds
/olYG0EzMWzADIgH1y2ySQ: raises $11.45 to $21.70 and is all-in
4QfsCWthT/vSLirorNXqtg: calls $11.45
*** FLOP *** [6c 4c Qc]
*** TURN *** [6c 4c Qc] [2s]
*** RIVER *** [6c 4c Qc 2s] [9d]
*** SHOW DOWN ***
/olYG0EzMWzADIgH1y2ySQ: shows [Kd As] (high card Ace)
4QfsCWthT/vSLirorNXqtg: shows [Jc Jh] (a pair of Jacks)
4QfsCWthT/vSLirorNXqtg collected $44.35 from pot
*** SUMMARY ***
Total pot $46.65 | Rake $2.30
Board [6c 4c Qc 2s 9d]
Seat 1: /olYG0EzMWzADIgH1y2ySQ showed [Kd As] and lost with high card Ace
Seat 2: 4QfsCWthT/vSLirorNXqtg (button) showed [Jc Jh] and won ($44.35) with a pair of Jacks
Seat 3: Rt6KgtZ8YaJoTc3FPim00w (small blind) folded before Flop
Seat 4: zAcsDhG/T128Vn7XGVSgKg (big blind) folded before Flop
Seat 5: 6vNxrjjCl6FwfaaymM9jjg folded before Flop
Seat 6: GoVjFxr3C+JO9vtJH9+IcA folded before Flop (didn't bet)



PokerStars Game #59940038812:  Hold'em No Limit ($0.25/$0.50) - 2009/07/01 0:55:36 ET
Table '5EmHi+fnatGQQShcNmzOZQ' 6-max Seat #3 is the button
Seat 3: TjmTe3bhs9dFz5gXX9x7Lw ($20 in chips)
Seat 4: 1b+2BbjMN8qhR1WPqdE9VQ ($68.80 in chips)
Seat 5: kxPhs4ePFqMy52CInAJ2aw ($80.55 in chips)
Seat 6: 686aeHikcJlgKkSuIFdcXQ ($134 in chips)
1b+2BbjMN8qhR1WPqdE9VQ: posts small blind $0.25
kxPhs4ePFqMy52CInAJ2aw: posts big blind $0.50
*** HOLE CARDS ***
686aeHikcJlgKkSuIFdcXQ: folds
TjmTe3bhs9dFz5gXX9x7Lw: folds
vXIHnZ+dv/hwSBxyvGw7bQ leaves the table
1b+2BbjMN8qhR1WPqdE9VQ: folds
HGzUMAFxR1k8+S4gfnB39w leaves the table
kxPhs4ePFqMy52CInAJ2aw collected $0.50 from pot
kxPhs4ePFqMy52CInAJ2aw: doesn't show hand
*** SUMMARY ***
Total pot $0.50 | Rake $0
Seat 3: TjmTe3bhs9dFz5gXX9x7Lw (button) folded before Flop (didn't bet)
Seat 4: 1b+2BbjMN8qhR1WPqdE9VQ (small blind) folded before Flop
Seat 5: kxPhs4ePFqMy52CInAJ2aw (big blind) collected ($0.50)
Seat 6: 686aeHikcJlgKkSuIFdcXQ folded before Flop (didn't bet)



PokerStars Game #59940039226:  Hold'em No Limit ($0.25/$0.50) - 2009/07/01 0:55:37 ET
Table 'QOgaEqMcJ73pcUMMxoisUgErOuyGLI5PT3G5MnpHgC/g Seat #7 is the button
Seat 3: xZCXQSXlrZkp3pZizzVXCw ($49.50 in chips)
Seat 4: 3UmXLy3GfjC3EkOebduerQ ($50.45 in chips)
Seat 5: JwvquocWfhTVApN5t47LgA ($63.35 in chips)
Seat 6: zE9cVigS2nW/Ljy4K4bUQA ($30 in chips)
Seat 7: 90Wb75h3W1BRpbqVnuk8gw ($65.60 in chips)
Seat 8: g4k0NXISyLCqaSWZDBjfEg ($50 in chips)
Seat 9: J0W5D97jl5VLky+IoPvDeA ($53.15 in chips)
g4k0NXISyLCqaSWZDBjfEg: posts small blind $0.25
J0W5D97jl5VLky+IoPvDeA: posts big blind $0.50
eBrej2jnlUCs/JgxFCRn2g: sits out
*** HOLE CARDS ***
xZCXQSXlrZkp3pZizzVXCw: folds
3UmXLy3GfjC3EkOebduerQ: folds
JwvquocWfhTVApN5t47LgA: folds
zE9cVigS2nW/Ljy4K4bUQA: raises $1 to $1.50
90Wb75h3W1BRpbqVnuk8gw: folds
g4k0NXISyLCqaSWZDBjfEg: folds
J0W5D97jl5VLky+IoPvDeA: calls $1
*** FLOP *** [3h 8h 9c]
J0W5D97jl5VLky+IoPvDeA: checks
zE9cVigS2nW/Ljy4K4bUQA: bets $2
J0W5D97jl5VLky+IoPvDeA: folds
zE9cVigS2nW/Ljy4K4bUQA collected $3.10 from pot
*** SUMMARY ***
Total pot $3.25 | Rake $0.15
Board [3h 8h 9c]
Seat 3: xZCXQSXlrZkp3pZizzVXCw folded before Flop (didn't bet)
Seat 4: 3UmXLy3GfjC3EkOebduerQ folded before Flop (didn't bet)
Seat 5: JwvquocWfhTVApN5t47LgA folded before Flop (didn't bet)
Seat 6: zE9cVigS2nW/Ljy4K4bUQA collected ($3.10)
Seat 7: 90Wb75h3W1BRpbqVnuk8gw (button) folded before Flop (didn't bet)
Seat 8: g4k0NXISyLCqaSWZDBjfEg (small blind) folded before Flop
Seat 9: J0W5D97jl5VLky+IoPvDeA (big blind) folded on the Flop



PokerStars Game #59940039666:  Hold'em No Limit ($0.25/$0.50) - 2009/07/01 0:55:38 ET
Table '0eJtgVAXVvBgncFdcUpXcQ' 2-max Seat #2 is the button
Seat 1: Ag6DvxX4vbRheqsv2zXKTQ ($39.80 in chips)
Seat 2: KMc4R+K9ao4Ur3rF7NGe6Q ($10.90 in chips)
KMc4R+K9ao4Ur3rF7NGe6Q: posts small blind $0.25
Ag6DvxX4vbRheqsv2zXKTQ: posts big blind $0.50
*** HOLE CARDS ***
KMc4R+K9ao4Ur3rF7NGe6Q: calls $0.25
Ag6DvxX4vbRheqsv2zXKTQ: checks
*** FLOP *** [Qs 9d 2h]
Ag6DvxX4vbRheqsv2zXKTQ: checks
KMc4R+K9ao4Ur3rF7NGe6Q: checks
*** TURN *** [Qs 9d 2h] [8h]
Ag6DvxX4vbRheqsv2zXKTQ: checks
KMc4R+K9ao4Ur3rF7NGe6Q: bets $0.50
Ag6DvxX4vbRheqsv2zXKTQ: folds
KMc4R+K9ao4Ur3rF7NGe6Q collected $0.95 from pot
KMc4R+K9ao4Ur3rF7NGe6Q: doesn't show hand
*** SUMMARY ***
Total pot $1 | Rake $0.05
Board [Qs 9d 2h 8h]
Seat 1: Ag6DvxX4vbRheqsv2zXKTQ (big blind) folded on the Turn
Seat 2: KMc4R+K9ao4Ur3rF7NGe6Q (button) (small blind) collected ($0.95)



PokerStars Game #59940040324:  Hold'em No Limit ($0.25/$0.50) - 2009/07/01 0:55:39 ET
Table 'c/CRn+68J3Y8KxD5g1ek2Q' 2-max Seat #2 is the button
Seat 1: 46qCyJ6evTkHo9al5sBMNA ($90.75 in chips)
Seat 2: BypVLsYQt3ePFm2xQL/dOA ($279.50 in chips)
BypVLsYQt3ePFm2xQL/dOA: posts small blind $0.25
46qCyJ6evTkHo9al5sBMNA: posts big blind $0.50
*** HOLE CARDS ***
BypVLsYQt3ePFm2xQL/dOA: calls $0.25
46qCyJ6evTkHo9al5sBMNA: raises $1 to $1.50
BypVLsYQt3ePFm2xQL/dOA: raises $4 to $5.50
46qCyJ6evTkHo9al5sBMNA: calls $4
*** FLOP *** [9h Ks As]
46qCyJ6evTkHo9al5sBMNA: checks
BypVLsYQt3ePFm2xQL/dOA: bets $6.50
46qCyJ6evTkHo9al5sBMNA: folds
BypVLsYQt3ePFm2xQL/dOA collected $10.50 from pot
BypVLsYQt3ePFm2xQL/dOA: doesn't show hand
*** SUMMARY ***
Total pot $11 | Rake $0.50
Board [9h Ks As]
Seat 1: 46qCyJ6evTkHo9al5sBMNA (big blind) folded on the Flop
Seat 2: BypVLsYQt3ePFm2xQL/dOA (button) (small blind) collected ($10.50)



PokerStars Game #59940040960:  Hold'em No Limit ($0.25/$0.50) - 2009/07/01 0:55:40 ET
Table '9Puy2HWN1RQe5SSjq162gA' 2-max Seat #1 is the button
Seat 1: Fp/oksNpipCrD2MJ2pH20g ($10.65 in chips)
Seat 2: tDV+zhxH9+3DkJDzoTERyg ($19.25 in chips)
Fp/oksNpipCrD2MJ2pH20g: posts small blind $0.25
tDV+zhxH9+3DkJDzoTERyg: posts big blind $0.50
*** HOLE CARDS ***
Fp/oksNpipCrD2MJ2pH20g: folds
tDV+zhxH9+3DkJDzoTERyg collected $0.50 from pot
tDV+zhxH9+3DkJDzoTERyg: doesn't show hand
*** SUMMARY ***
Total pot $0.50 | Rake $0
Seat 1: Fp/oksNpipCrD2MJ2pH20g (button) (small blind) folded before Flop
Seat 2: tDV+zhxH9+3DkJDzoTERyg (big blind) collected ($0.50)



PokerStars Game #59940041132:  Hold'em No Limit ($0.25/$0.50) - 2009/07/01 0:55:40 ET
Table 'BCN5su+SsXiy1zRMJi0SJw' 6-max Seat #1 is the button
Seat 1: GxXV09ciXaOxyY2H5aMIIw ($27.85 in chips)
Seat 2: oU2kDCkT/gilYbHWrg7D8w ($22.05 in chips)
Seat 3: 6wzJiRvp8HY6t+MQGnSIzA ($19.50 in chips)
Seat 4: qfeUHOJpMYyzQcj0o2A7ng ($18.60 in chips)
Seat 5: IBNygaT1aa9Z1uPdJJilwA ($34.35 in chips)
Seat 6: b2symlOdL7+0c9Pj4N/KlA ($80.50 in chips)
oU2kDCkT/gilYbHWrg7D8w: posts small blind $0.25
6wzJiRvp8HY6t+MQGnSIzA: posts big blind $0.50
*** HOLE CARDS ***
qfeUHOJpMYyzQcj0o2A7ng: calls $0.50
IBNygaT1aa9Z1uPdJJilwA: folds
b2symlOdL7+0c9Pj4N/KlA: folds
GxXV09ciXaOxyY2H5aMIIw: raises $1.50 to $2
oU2kDCkT/gilYbHWrg7D8w: folds
6wzJiRvp8HY6t+MQGnSIzA: folds
qfeUHOJpMYyzQcj0o2A7ng: calls $1.50
*** FLOP *** [3h 3d Qc]
qfeUHOJpMYyzQcj0o2A7ng: checks
GxXV09ciXaOxyY2H5aMIIw: bets $3.50
qfeUHOJpMYyzQcj0o2A7ng: folds
GxXV09ciXaOxyY2H5aMIIw collected $4.55 from pot
*** SUMMARY ***
Total pot $4.75 | Rake $0.20
Board [3h 3d Qc]
Seat 1: GxXV09ciXaOxyY2H5aMIIw (button) collected ($4.55)
Seat 2: oU2kDCkT/gilYbHWrg7D8w (small blind) folded before Flop
Seat 3: 6wzJiRvp8HY6t+MQGnSIzA (big blind) folded before Flop
Seat 4: qfeUHOJpMYyzQcj0o2A7ng folded on the Flop
Seat 5: IBNygaT1aa9Z1uPdJJilwA folded before Flop (didn't bet)
Seat 6: b2symlOdL7+0c9Pj4N/KlA folded before Flop (didn't bet)



PokerStars Game #59940041086:  Hold'em No Limit ($0.25/$0.50) - 2009/07/01 0:55:40 ET
Table '+z1aekfHkpp09pc8F9aViw' 6-max Seat #5 is the button
Seat 1: FHilMb2i2DbUCc9lplszog ($47.05 in chips)
Seat 2: M6xK/VklCvdyyrmvzATlxQ ($34.50 in chips)
Seat 3: uUznlIMFnRUvwrBhYF73KA ($118.55 in chips)
Seat 4: RowCSpSURHTOL/dcjg/Iug ($40.30 in chips)
Seat 5: rplyldNweS6YyMNEALQrug ($11.90 in chips)
Seat 6: 686aeHikcJlgKkSuIFdcXQ ($50.25 in chips)
686aeHikcJlgKkSuIFdcXQ: posts small blind $0.25
FHilMb2i2DbUCc9lplszog: posts big blind $0.50
*** HOLE CARDS ***
M6xK/VklCvdyyrmvzATlxQ: folds
uUznlIMFnRUvwrBhYF73KA: folds
RowCSpSURHTOL/dcjg/Iug: folds
rplyldNweS6YyMNEALQrug: calls $0.50
686aeHikcJlgKkSuIFdcXQ: folds
FHilMb2i2DbUCc9lplszog: raises $2 to $2.50
rplyldNweS6YyMNEALQrug: calls $2
*** FLOP *** [5d 2c 4d]
FHilMb2i2DbUCc9lplszog: bets $3.50
rplyldNweS6YyMNEALQrug: calls $3.50
*** TURN *** [5d 2c 4d] [Jc]
FHilMb2i2DbUCc9lplszog: bets $6
rplyldNweS6YyMNEALQrug: calls $5.90 and is all-in
*** RIVER *** [5d 2c 4d Jc] [As]
*** SHOW DOWN ***
FHilMb2i2DbUCc9lplszog: shows [8s 8c] (a pair of Eights)
rplyldNweS6YyMNEALQrug: mucks hand
FHilMb2i2DbUCc9lplszog collected $22.90 from pot
*** SUMMARY ***
Total pot $24.05 | Rake $1.15
Board [5d 2c 4d Jc As]
Seat 1: FHilMb2i2DbUCc9lplszog (big blind) showed [8s 8c] and won ($22.90) with a pair of Eights
Seat 2: M6xK/VklCvdyyrmvzATlxQ folded before Flop (didn't bet)
Seat 3: uUznlIMFnRUvwrBhYF73KA folded before Flop (didn't bet)
Seat 4: RowCSpSURHTOL/dcjg/Iug folded before Flop (didn't bet)
Seat 5: rplyldNweS6YyMNEALQrug (button) mucked
Seat 6: 686aeHikcJlgKkSuIFdcXQ (small blind) folded before Flop



PokerStars Game #59940042474:  Hold'em No Limit ($0.25/$0.50) - 2009/07/01 0:55:42 ET
Table 'X6IRCRTh+20gjz8aubWnwA' 9-max Seat #2 is the button
Seat 1: DSM67hHHq1XFoEOi9p8Alw ($49.05 in chips)
Seat 2: HZkVla4kK2SI42CVrPZ/ig ($7.55 in chips)
Seat 3: SWv01peOe69QQRvhQTqjQw ($4.40 in chips)
Seat 4: M3JFBNQ8Bbw3FBZ/18MuXw ($14 in chips)
Seat 5: NnQCepdIR/AOUQn1yhYx6Q ($10 in chips)
Seat 7: cFHQjKQOOKTUzoilhrXHLg ($47.75 in chips)
Seat 8: HxeBVq06/3Bh/H986sgdbw ($25 in chips)
Seat 9: M+7+BTmX5vZatHVuoRB1nA ($46.75 in chips)
SWv01peOe69QQRvhQTqjQw: posts small blind $0.25
M3JFBNQ8Bbw3FBZ/18MuXw: posts big blind $0.50
75K2MXwN65Sjfp1yHd50Hg: sits out
*** HOLE CARDS ***
NnQCepdIR/AOUQn1yhYx6Q: folds
cFHQjKQOOKTUzoilhrXHLg: calls $0.50
HxeBVq06/3Bh/H986sgdbw: calls $0.50
M+7+BTmX5vZatHVuoRB1nA: folds
DSM67hHHq1XFoEOi9p8Alw: folds
HZkVla4kK2SI42CVrPZ/ig: folds
SWv01peOe69QQRvhQTqjQw: calls $0.25
M3JFBNQ8Bbw3FBZ/18MuXw: checks
*** FLOP *** [Ts 6s Ad]
SWv01peOe69QQRvhQTqjQw: checks
M3JFBNQ8Bbw3FBZ/18MuXw: checks
cFHQjKQOOKTUzoilhrXHLg: checks
HxeBVq06/3Bh/H986sgdbw: checks
*** TURN *** [Ts 6s Ad] [Ks]
SWv01peOe69QQRvhQTqjQw: checks
M3JFBNQ8Bbw3FBZ/18MuXw: checks
cFHQjKQOOKTUzoilhrXHLg: bets $0.50
HxeBVq06/3Bh/H986sgdbw: calls $0.50
SWv01peOe69QQRvhQTqjQw: folds
M3JFBNQ8Bbw3FBZ/18MuXw: folds
*** RIVER *** [Ts 6s Ad Ks] [Qc]
cFHQjKQOOKTUzoilhrXHLg: bets $1
HxeBVq06/3Bh/H986sgdbw: folds
cFHQjKQOOKTUzoilhrXHLg collected $2.90 from pot
*** SUMMARY ***
Total pot $3 | Rake $0.10
Board [Ts 6s Ad Ks Qc]
Seat 1: DSM67hHHq1XFoEOi9p8Alw folded before Flop (didn't bet)
Seat 2: HZkVla4kK2SI42CVrPZ/ig (button) folded before Flop (didn't bet)
Seat 3: SWv01peOe69QQRvhQTqjQw (small blind) folded on the Turn
Seat 4: M3JFBNQ8Bbw3FBZ/18MuXw (big blind) folded on the Turn
Seat 5: NnQCepdIR/AOUQn1yhYx6Q folded before Flop (didn't bet)
Seat 7: cFHQjKQOOKTUzoilhrXHLg collected ($2.90)
Seat 8: HxeBVq06/3Bh/H986sgdbw folded on the River
Seat 9: M+7+BTmX5vZatHVuoRB1nA folded before Flop (didn't bet)



PokerStars Game #59940043004:  Hold'em No Limit ($0.25/$0.50) - 2009/07/01 0:55:43 ET
Table 'MJxeZCzYELxiIsyUZyT0jw' 6-max Seat #1 is the button
Seat 1: +Pf9jTVizYlIo+woPvptfA ($50 in chips)
Seat 2: t3GiVMzqA9Svgr5Uol32cQ ($35.60 in chips)
Seat 3: JQZew0FjzS19kTjeNtrE+A ($62.45 in chips)
Seat 4: alGiiQP/wwtYnfuXII+sgw ($48.60 in chips)
Seat 5: 3jvoOXNtXE90w2BdfNZwZQ ($50 in chips)
Seat 6: TTx3CHxyi0SObcHyMJRp5w ($60.55 in chips)
t3GiVMzqA9Svgr5Uol32cQ: posts small blind $0.25
JQZew0FjzS19kTjeNtrE+A: posts big blind $0.50
*** HOLE CARDS ***
alGiiQP/wwtYnfuXII+sgw: folds
3jvoOXNtXE90w2BdfNZwZQ: folds
TTx3CHxyi0SObcHyMJRp5w: calls $0.50
+Pf9jTVizYlIo+woPvptfA: folds
t3GiVMzqA9Svgr5Uol32cQ: calls $0.25
JQZew0FjzS19kTjeNtrE+A: checks
*** FLOP *** [8s 5h Kh]
t3GiVMzqA9Svgr5Uol32cQ: checks
JQZew0FjzS19kTjeNtrE+A: checks
TTx3CHxyi0SObcHyMJRp5w: checks
*** TURN *** [8s 5h Kh] [8d]
t3GiVMzqA9Svgr5Uol32cQ: checks
JQZew0FjzS19kTjeNtrE+A: bets $1.50
TTx3CHxyi0SObcHyMJRp5w: folds
TTx3CHxyi0SObcHyMJRp5w leaves the table
t3GiVMzqA9Svgr5Uol32cQ: folds
JQZew0FjzS19kTjeNtrE+A collected $1.45 from pot
*** SUMMARY ***
Total pot $1.50 | Rake $0.05
Board [8s 5h Kh 8d]
Seat 1: +Pf9jTVizYlIo+woPvptfA (button) folded before Flop (didn't bet)
Seat 2: t3GiVMzqA9Svgr5Uol32cQ (small blind) folded on the Turn
Seat 3: JQZew0FjzS19kTjeNtrE+A (big blind) collected ($1.45)
Seat 4: alGiiQP/wwtYnfuXII+sgw folded before Flop (didn't bet)
Seat 5: 3jvoOXNtXE90w2BdfNZwZQ folded before Flop (didn't bet)
Seat 6: TTx3CHxyi0SObcHyMJRp5w folded on the Turn



PokerStars Game #59940044098:  Hold'em No Limit ($0.25/$0.50) - 2009/07/01 0:55:45 ET
Table '5EmHi+fnatGQQShcNmzOZQ' 6-max Seat #4 is the button
Seat 3: TjmTe3bhs9dFz5gXX9x7Lw ($20 in chips)
Seat 4: 1b+2BbjMN8qhR1WPqdE9VQ ($68.55 in chips)
Seat 5: kxPhs4ePFqMy52CInAJ2aw ($80.80 in chips)
Seat 6: 686aeHikcJlgKkSuIFdcXQ ($134 in chips)
kxPhs4ePFqMy52CInAJ2aw: posts small blind $0.25
686aeHikcJlgKkSuIFdcXQ: posts big blind $0.50
*** HOLE CARDS ***
TjmTe3bhs9dFz5gXX9x7Lw: folds
1b+2BbjMN8qhR1WPqdE9VQ: raises $1 to $1.50
kxPhs4ePFqMy52CInAJ2aw: folds
My8WkRtGx5FW6rJ1I4R3hg joins the table at seat #1
686aeHikcJlgKkSuIFdcXQ: folds
1b+2BbjMN8qhR1WPqdE9VQ collected $1.25 from pot
1b+2BbjMN8qhR1WPqdE9VQ: doesn't show hand
*** SUMMARY ***
Total pot $1.25 | Rake $0
Seat 3: TjmTe3bhs9dFz5gXX9x7Lw folded before Flop (didn't bet)
Seat 4: 1b+2BbjMN8qhR1WPqdE9VQ (button) collected ($1.25)
Seat 5: kxPhs4ePFqMy52CInAJ2aw (small blind) folded before Flop
Seat 6: 686aeHikcJlgKkSuIFdcXQ (big blind) folded before Flop



PokerStars Game #59940044902:  Hold'em No Limit ($0.25/$0.50) - 2009/07/01 0:55:46 ET
Table '9Puy2HWN1RQe5SSjq162gA' 2-max Seat #2 is the button
Seat 1: Fp/oksNpipCrD2MJ2pH20g ($10.40 in chips)
Seat 2: tDV+zhxH9+3DkJDzoTERyg ($19.50 in chips)
tDV+zhxH9+3DkJDzoTERyg: posts small blind $0.25
Fp/oksNpipCrD2MJ2pH20g: posts big blind $0.50
*** HOLE CARDS ***
tDV+zhxH9+3DkJDzoTERyg: raises $1 to $1.50
Fp/oksNpipCrD2MJ2pH20g: folds
tDV+zhxH9+3DkJDzoTERyg collected $1 from pot
tDV+zhxH9+3DkJDzoTERyg: doesn't show hand
*** SUMMARY ***
Total pot $1 | Rake $0
Seat 1: Fp/oksNpipCrD2MJ2pH20g (big blind) folded before Flop
Seat 2: tDV+zhxH9+3DkJDzoTERyg (button) (small blind) collected ($1)



PokerStars Game #59940047440:  Hold'em No Limit ($0.25/$0.50) - 2009/07/01 0:55:50 ET
Table '99gCy/CZQwPIjZWH+BguQgE7bWJ45aoFXRpyRv2gw+Igeat #7 is the button
Seat 2: n6VQBu6crjYjy6DxNP1NZA ($28.75 in chips)
Seat 3: qEn9ijNGtuyTxamBf07hYg ($50 in chips)
Seat 4: bxLSulbgr8LmKNjOzw8URg ($61.45 in chips)
Seat 5: DSM67hHHq1XFoEOi9p8Alw ($50 in chips)
Seat 7: bfSq6LBw0UvxeM5yfuWC7w ($17.10 in chips)
Seat 8: 8ehL7qlZzjgUh2H35iiWLw ($52 in chips)
Seat 9: j3K/Jujr7PY4ZM2RZvlH6A ($101.20 in chips)
8ehL7qlZzjgUh2H35iiWLw: posts small blind $0.25
j3K/Jujr7PY4ZM2RZvlH6A: posts big blind $0.50
*** HOLE CARDS ***
n6VQBu6crjYjy6DxNP1NZA: folds
qEn9ijNGtuyTxamBf07hYg: folds
bxLSulbgr8LmKNjOzw8URg: folds
DSM67hHHq1XFoEOi9p8Alw: folds
bfSq6LBw0UvxeM5yfuWC7w: raises $0.60 to $1.10
8ehL7qlZzjgUh2H35iiWLw: folds
OcnLOMVFdy23jXnoTyaO5Q has returned
j3K/Jujr7PY4ZM2RZvlH6A: folds
bfSq6LBw0UvxeM5yfuWC7w collected $1.25 from pot
*** SUMMARY ***
Total pot $1.25 | Rake $0
Seat 2: n6VQBu6crjYjy6DxNP1NZA folded before Flop (didn't bet)
Seat 3: qEn9ijNGtuyTxamBf07hYg folded before Flop (didn't bet)
Seat 4: bxLSulbgr8LmKNjOzw8URg folded before Flop (didn't bet)
Seat 5: DSM67hHHq1XFoEOi9p8Alw folded before Flop (didn't bet)
Seat 7: bfSq6LBw0UvxeM5yfuWC7w (button) collected ($1.25)
Seat 8: 8ehL7qlZzjgUh2H35iiWLw (small blind) folded before Flop
Seat 9: j3K/Jujr7PY4ZM2RZvlH6A (big blind) folded before Flop



PokerStars Game #59940047424:  Hold'em No Limit ($0.25/$0.50) - 2009/07/01 0:55:50 ET
Table '/cQuAT3ef4t+PGrXiNhGaQ' 9-max Seat #4 is the button
Seat 1: HZkVla4kK2SI42CVrPZ/ig ($15 in chips)
Seat 2: jXGruyaMqirTaTXNOvBdew ($72.45 in chips)
Seat 3: g4k0NXISyLCqaSWZDBjfEg ($55.75 in chips)
Seat 4: OWP/DOu+PlPK6ZZ3zYa0HA ($26.40 in chips)
Seat 5: 5SgaHdWixdClWvaEG+KUjQ ($23.60 in chips)
Seat 6: APYIOyK/4AGb+kIwlOUNBQ ($37.25 in chips)
Seat 7: J0W5D97jl5VLky+IoPvDeA ($111.40 in chips)
Seat 8: eBrej2jnlUCs/JgxFCRn2g ($40 in chips)
Seat 9: AjV5McH1KMMclY26QdLM5w ($26.45 in chips)
5SgaHdWixdClWvaEG+KUjQ: posts small blind $0.25
APYIOyK/4AGb+kIwlOUNBQ: posts big blind $0.50
*** HOLE CARDS ***
J0W5D97jl5VLky+IoPvDeA: folds
eBrej2jnlUCs/JgxFCRn2g: calls $0.50
AjV5McH1KMMclY26QdLM5w: folds
HZkVla4kK2SI42CVrPZ/ig: folds
jXGruyaMqirTaTXNOvBdew: calls $0.50
g4k0NXISyLCqaSWZDBjfEg: folds
OWP/DOu+PlPK6ZZ3zYa0HA: calls $0.50
5SgaHdWixdClWvaEG+KUjQ: calls $0.25
APYIOyK/4AGb+kIwlOUNBQ: checks
*** FLOP *** [9h 4d 6c]
5SgaHdWixdClWvaEG+KUjQ: bets $2.50
APYIOyK/4AGb+kIwlOUNBQ: folds
eBrej2jnlUCs/JgxFCRn2g: calls $2.50
jXGruyaMqirTaTXNOvBdew: folds
OWP/DOu+PlPK6ZZ3zYa0HA: folds
*** TURN *** [9h 4d 6c] [7h]
5SgaHdWixdClWvaEG+KUjQ: bets $3.50
eBrej2jnlUCs/JgxFCRn2g: calls $3.50
*** RIVER *** [9h 4d 6c 7h] [Js]
5SgaHdWixdClWvaEG+KUjQ: checks
eBrej2jnlUCs/JgxFCRn2g: bets $19.50
5SgaHdWixdClWvaEG+KUjQ: folds
eBrej2jnlUCs/JgxFCRn2g collected $13.80 from pot
*** SUMMARY ***
Total pot $14.50 | Rake $0.70
Board [9h 4d 6c 7h Js]
Seat 1: HZkVla4kK2SI42CVrPZ/ig folded before Flop (didn't bet)
Seat 2: jXGruyaMqirTaTXNOvBdew folded on the Flop
Seat 3: g4k0NXISyLCqaSWZDBjfEg folded before Flop (didn't bet)
Seat 4: OWP/DOu+PlPK6ZZ3zYa0HA (button) folded on the Flop
Seat 5: 5SgaHdWixdClWvaEG+KUjQ (small blind) folded on the River
Seat 6: APYIOyK/4AGb+kIwlOUNBQ (big blind) folded on the Flop
Seat 7: J0W5D97jl5VLky+IoPvDeA folded before Flop (didn't bet)
Seat 8: eBrej2jnlUCs/JgxFCRn2g collected ($13.80)
Seat 9: AjV5McH1KMMclY26QdLM5w folded before Flop (didn't bet)



PokerStars Game #59940048346:  Hold'em No Limit ($0.25/$0.50) - 2009/07/01 0:55:52 ET
Table '0eJtgVAXVvBgncFdcUpXcQ' 2-max Seat #1 is the button
Seat 1: Ag6DvxX4vbRheqsv2zXKTQ ($39.30 in chips)
Seat 2: KMc4R+K9ao4Ur3rF7NGe6Q ($11.35 in chips)
Ag6DvxX4vbRheqsv2zXKTQ: posts small blind $0.25
KMc4R+K9ao4Ur3rF7NGe6Q: posts big blind $0.50
*** HOLE CARDS ***
Ag6DvxX4vbRheqsv2zXKTQ: folds
KMc4R+K9ao4Ur3rF7NGe6Q collected $0.50 from pot
KMc4R+K9ao4Ur3rF7NGe6Q: doesn't show hand
*** SUMMARY ***
Total pot $0.50 | Rake $0
Seat 1: Ag6DvxX4vbRheqsv2zXKTQ (button) (small blind) folded before Flop
Seat 2: KMc4R+K9ao4Ur3rF7NGe6Q (big blind) collected ($0.50)



PokerStars Game #59940049814:  Hold'em No Limit ($0.25/$0.50) - 2009/07/01 0:55:54 ET
Table 'lpxYasB1ClBSgTpCCITwhQ' 9-max Seat #5 is the button
Seat 1: mj7PS7wCH4PAl7+eYTFs7A ($46.40 in chips)
Seat 2: OWP/DOu+PlPK6ZZ3zYa0HA ($24.10 in chips)
Seat 4: NnQCepdIR/AOUQn1yhYx6Q ($9.25 in chips)
Seat 5: IYd5zG8k7vdBNVHbHg2Pag ($36.35 in chips)
Seat 6: SegjDnMxWMujiD57ESNL+g ($12.35 in chips)
Seat 7: bmRtaIYKthN1F+B3JLZ3Jw ($29.15 in chips)
Seat 8: /mfensKw8/iZ1Vrx33S4xg ($10 in chips)
Seat 9: XNMDwbXt/Q4jM99AXnbJDw ($50.50 in chips)
SegjDnMxWMujiD57ESNL+g: posts small blind $0.25
bmRtaIYKthN1F+B3JLZ3Jw: posts big blind $0.50
caleb505: sits out
*** HOLE CARDS ***
/mfensKw8/iZ1Vrx33S4xg: raises $2 to $2.50
XNMDwbXt/Q4jM99AXnbJDw: folds
mj7PS7wCH4PAl7+eYTFs7A: folds
OWP/DOu+PlPK6ZZ3zYa0HA: calls $2.50
NnQCepdIR/AOUQn1yhYx6Q: folds
IYd5zG8k7vdBNVHbHg2Pag: folds
SegjDnMxWMujiD57ESNL+g: folds
bmRtaIYKthN1F+B3JLZ3Jw: folds
*** FLOP *** [Jh 2s Kc]
/mfensKw8/iZ1Vrx33S4xg: bets $7.50 and is all-in
OWP/DOu+PlPK6ZZ3zYa0HA: folds
/mfensKw8/iZ1Vrx33S4xg collected $5.50 from pot
/mfensKw8/iZ1Vrx33S4xg: doesn't show hand
*** SUMMARY ***
Total pot $5.75 | Rake $0.25
Board [Jh 2s Kc]
Seat 1: mj7PS7wCH4PAl7+eYTFs7A folded before Flop (didn't bet)
Seat 2: OWP/DOu+PlPK6ZZ3zYa0HA folded on the Flop
Seat 4: NnQCepdIR/AOUQn1yhYx6Q folded before Flop (didn't bet)
Seat 5: IYd5zG8k7vdBNVHbHg2Pag (button) folded before Flop (didn't bet)
Seat 6: SegjDnMxWMujiD57ESNL+g (small blind) folded before Flop
Seat 7: bmRtaIYKthN1F+B3JLZ3Jw (big blind) folded before Flop
Seat 8: /mfensKw8/iZ1Vrx33S4xg collected ($5.50)
Seat 9: XNMDwbXt/Q4jM99AXnbJDw folded before Flop (didn't bet)



PokerStars Game #59940049930:  Hold'em No Limit ($0.25/$0.50) - 2009/07/01 0:55:55 ET
Table '9Puy2HWN1RQe5SSjq162gA' 2-max Seat #1 is the button
Seat 1: Fp/oksNpipCrD2MJ2pH20g ($9.90 in chips)
Seat 2: tDV+zhxH9+3DkJDzoTERyg ($20 in chips)
Fp/oksNpipCrD2MJ2pH20g: posts small blind $0.25
tDV+zhxH9+3DkJDzoTERyg: posts big blind $0.50
*** HOLE CARDS ***
Fp/oksNpipCrD2MJ2pH20g: folds
tDV+zhxH9+3DkJDzoTERyg collected $0.50 from pot
tDV+zhxH9+3DkJDzoTERyg: doesn't show hand
*** SUMMARY ***
Total pot $0.50 | Rake $0
Seat 1: Fp/oksNpipCrD2MJ2pH20g (button) (small blind) folded before Flop
Seat 2: tDV+zhxH9+3DkJDzoTERyg (big blind) collected ($0.50)



PokerStars Game #59940050676:  Hold'em No Limit ($0.25/$0.50) - 2009/07/01 0:55:56 ET
Table '8BQGgNetI1NOvWeu3gtMNw' 2-max Seat #1 is the button
Seat 1: bypIyrYcAAifLfhZpGlKLA ($53.65 in chips)
Seat 2: Z4HwehErEwzsv/noQlfUlg ($129.55 in chips)
bypIyrYcAAifLfhZpGlKLA: posts small blind $0.25
Z4HwehErEwzsv/noQlfUlg: posts big blind $0.50
*** HOLE CARDS ***
bypIyrYcAAifLfhZpGlKLA: raises $1 to $1.50
Z4HwehErEwzsv/noQlfUlg: calls $1
*** FLOP *** [3d 6c 7h]
Z4HwehErEwzsv/noQlfUlg: checks
bypIyrYcAAifLfhZpGlKLA: bets $2.50
Z4HwehErEwzsv/noQlfUlg: calls $2.50
*** TURN *** [3d 6c 7h] [2c]
Z4HwehErEwzsv/noQlfUlg: bets $2
bypIyrYcAAifLfhZpGlKLA: calls $2
*** RIVER *** [3d 6c 7h 2c] [Jc]
Z4HwehErEwzsv/noQlfUlg: bets $7
bypIyrYcAAifLfhZpGlKLA: calls $7
*** SHOW DOWN ***
Z4HwehErEwzsv/noQlfUlg: shows [5h Jd] (a pair of Jacks)
bypIyrYcAAifLfhZpGlKLA: mucks hand
Z4HwehErEwzsv/noQlfUlg collected $25.50 from pot
*** SUMMARY ***
Total pot $26 | Rake $0.50
Board [3d 6c 7h 2c Jc]
Seat 1: bypIyrYcAAifLfhZpGlKLA (button) (small blind) mucked
Seat 2: Z4HwehErEwzsv/noQlfUlg (big blind) showed [5h Jd] and won ($25.50) with a pair of Jacks



PokerStars Game #59940051622:  Hold'em No Limit ($0.25/$0.50) - 2009/07/01 0:55:57 ET
Table '+dXkOAQyS8j9PQZusUTMpg' 2-max Seat #1 is the button
Seat 1: XFa6sBGjP2gxoIvxR3fZIg ($59.80 in chips)
Seat 2: 5IBeOgaApY1Bvzv2P8X4EA ($140.40 in chips)
XFa6sBGjP2gxoIvxR3fZIg: posts small blind $0.25
5IBeOgaApY1Bvzv2P8X4EA: posts big blind $0.50
*** HOLE CARDS ***
XFa6sBGjP2gxoIvxR3fZIg: raises $1 to $1.50
5IBeOgaApY1Bvzv2P8X4EA: folds
XFa6sBGjP2gxoIvxR3fZIg collected $1 from pot
XFa6sBGjP2gxoIvxR3fZIg: doesn't show hand
*** SUMMARY ***
Total pot $1 | Rake $0
Seat 1: XFa6sBGjP2gxoIvxR3fZIg (button) (small blind) collected ($1)
Seat 2: 5IBeOgaApY1Bvzv2P8X4EA (big blind) folded before Flop



PokerStars Game #59940051352:  Hold'em No Limit ($0.25/$0.50) - 2009/07/01 0:55:57 ET
Table 'EiNh8p/wGJ1FP575iMFnqg' 9-max Seat #3 is the button
Seat 1: r3ZqM1Mi0W3y4hOdssE+Sg ($44.85 in chips)
Seat 2: 8ehL7qlZzjgUh2H35iiWLw ($51.85 in chips)
Seat 3: ymLPoEIl7UL3TvZYmnadxQ ($51.80 in chips)
Seat 4: cMzaiXAM/ZAdNaEUu+LqhA ($55.20 in chips)
Seat 5: M+7+BTmX5vZatHVuoRB1nA ($82.20 in chips)
Seat 6: 3UmXLy3GfjC3EkOebduerQ ($65.35 in chips)
Seat 7: 997ViqAtWn1FPjJqcffwcA ($50 in chips)
Seat 8: mSD1pginDsyHG5PDfqzphw ($10 in chips)
Seat 9: NnQCepdIR/AOUQn1yhYx6Q ($10.75 in chips)
cMzaiXAM/ZAdNaEUu+LqhA: posts small blind $0.25
M+7+BTmX5vZatHVuoRB1nA: posts big blind $0.50
*** HOLE CARDS ***
3UmXLy3GfjC3EkOebduerQ: folds
997ViqAtWn1FPjJqcffwcA: folds
mSD1pginDsyHG5PDfqzphw: folds
NnQCepdIR/AOUQn1yhYx6Q has timed out
NnQCepdIR/AOUQn1yhYx6Q: folds
NnQCepdIR/AOUQn1yhYx6Q is sitting out
r3ZqM1Mi0W3y4hOdssE+Sg: folds
NnQCepdIR/AOUQn1yhYx6Q has returned
8ehL7qlZzjgUh2H35iiWLw: raises $1.50 to $2
ymLPoEIl7UL3TvZYmnadxQ: folds
cMzaiXAM/ZAdNaEUu+LqhA: folds
M+7+BTmX5vZatHVuoRB1nA: folds
8ehL7qlZzjgUh2H35iiWLw collected $1.25 from pot
8ehL7qlZzjgUh2H35iiWLw: doesn't show hand
*** SUMMARY ***
Total pot $1.25 | Rake $0
Seat 1: r3ZqM1Mi0W3y4hOdssE+Sg folded before Flop (didn't bet)
Seat 2: 8ehL7qlZzjgUh2H35iiWLw collected ($1.25)
Seat 3: ymLPoEIl7UL3TvZYmnadxQ (button) folded before Flop (didn't bet)
Seat 4: cMzaiXAM/ZAdNaEUu+LqhA (small blind) folded before Flop
Seat 5: M+7+BTmX5vZatHVuoRB1nA (big blind) folded before Flop
Seat 6: 3UmXLy3GfjC3EkOebduerQ folded before Flop (didn't bet)
Seat 7: 997ViqAtWn1FPjJqcffwcA folded before Flop (didn't bet)
Seat 8: mSD1pginDsyHG5PDfqzphw folded before Flop (didn't bet)
Seat 9: NnQCepdIR/AOUQn1yhYx6Q folded before Flop (didn't bet)



PokerStars Game #59940051896:  Hold'em No Limit ($0.25/$0.50) - 2009/07/01 0:55:58 ET
Table '0eJtgVAXVvBgncFdcUpXcQ' 2-max Seat #2 is the button
Seat 1: Ag6DvxX4vbRheqsv2zXKTQ ($39.05 in chips)
Seat 2: KMc4R+K9ao4Ur3rF7NGe6Q ($11.60 in chips)
KMc4R+K9ao4Ur3rF7NGe6Q: posts small blind $0.25
Ag6DvxX4vbRheqsv2zXKTQ: posts big blind $0.50
*** HOLE CARDS ***
KMc4R+K9ao4Ur3rF7NGe6Q: raises $1 to $1.50
Ag6DvxX4vbRheqsv2zXKTQ: folds
KMc4R+K9ao4Ur3rF7NGe6Q collected $1 from pot
KMc4R+K9ao4Ur3rF7NGe6Q: doesn't show hand
*** SUMMARY ***
Total pot $1 | Rake $0
Seat 1: Ag6DvxX4vbRheqsv2zXKTQ (big blind) folded before Flop
Seat 2: KMc4R+K9ao4Ur3rF7NGe6Q (button) (small blind) collected ($1)



PokerStars Game #59940054004:  Hold'em No Limit ($0.25/$0.50) - 2009/07/01 0:56:01 ET
Table '9Puy2HWN1RQe5SSjq162gA' 2-max Seat #2 is the button
Seat 1: Fp/oksNpipCrD2MJ2pH20g ($9.65 in chips)
Seat 2: tDV+zhxH9+3DkJDzoTERyg ($20.25 in chips)
tDV+zhxH9+3DkJDzoTERyg: posts small blind $0.25
Fp/oksNpipCrD2MJ2pH20g: posts big blind $0.50
*** HOLE CARDS ***
tDV+zhxH9+3DkJDzoTERyg: raises $1 to $1.50
Fp/oksNpipCrD2MJ2pH20g: calls $1
*** FLOP *** [Jd 5c 4d]
Fp/oksNpipCrD2MJ2pH20g: checks
tDV+zhxH9+3DkJDzoTERyg: bets $2
Fp/oksNpipCrD2MJ2pH20g: folds
tDV+zhxH9+3DkJDzoTERyg collected $2.85 from pot
tDV+zhxH9+3DkJDzoTERyg: doesn't show hand
*** SUMMARY ***
Total pot $3 | Rake $0.15
Board [Jd 5c 4d]
Seat 1: Fp/oksNpipCrD2MJ2pH20g (big blind) folded on the Flop
Seat 2: tDV+zhxH9+3DkJDzoTERyg (button) (small blind) collected ($2.85)



PokerStars Game #59940054248:  Hold'em No Limit ($0.25/$0.50) - 2009/07/01 0:56:02 ET
Table '5EmHi+fnatGQQShcNmzOZQ' 6-max Seat #5 is the button
Seat 1: My8WkRtGx5FW6rJ1I4R3hg ($10 in chips)
Seat 3: TjmTe3bhs9dFz5gXX9x7Lw ($20 in chips)
Seat 4: 1b+2BbjMN8qhR1WPqdE9VQ ($69.30 in chips)
Seat 5: kxPhs4ePFqMy52CInAJ2aw ($80.55 in chips)
Seat 6: 686aeHikcJlgKkSuIFdcXQ ($133.50 in chips)
686aeHikcJlgKkSuIFdcXQ: posts small blind $0.25
My8WkRtGx5FW6rJ1I4R3hg: posts big blind $0.50
*** HOLE CARDS ***
TjmTe3bhs9dFz5gXX9x7Lw: folds
1b+2BbjMN8qhR1WPqdE9VQ: folds
kxPhs4ePFqMy52CInAJ2aw: folds
686aeHikcJlgKkSuIFdcXQ: folds
My8WkRtGx5FW6rJ1I4R3hg collected $0.50 from pot
*** SUMMARY ***
Total pot $0.50 | Rake $0
Seat 1: My8WkRtGx5FW6rJ1I4R3hg (big blind) collected ($0.50)
Seat 3: TjmTe3bhs9dFz5gXX9x7Lw folded before Flop (didn't bet)
Seat 4: 1b+2BbjMN8qhR1WPqdE9VQ folded before Flop (didn't bet)
Seat 5: kxPhs4ePFqMy52CInAJ2aw (button) folded before Flop (didn't bet)
Seat 6: 686aeHikcJlgKkSuIFdcXQ (small blind) folded before Flop



PokerStars Game #59940055946:  Hold'em No Limit ($0.25/$0.50) - 2009/07/01 0:56:04 ET
Table 'GfL/No5u5PoEnU39lP5pQg' 6-max Seat #4 is the button
Seat 1: 1WUCqNG+p+vfWRTXNu4ljw ($60 in chips)
Seat 2: uVwggSetzp7d+eVgowO3vg ($49.45 in chips)
Seat 4: r6u7MWSXF30/khcTYkrG9Q ($33.45 in chips)
Seat 6: kxPhs4ePFqMy52CInAJ2aw ($57 in chips)
kxPhs4ePFqMy52CInAJ2aw: posts small blind $0.25
1WUCqNG+p+vfWRTXNu4ljw: posts big blind $0.50
*** HOLE CARDS ***
uVwggSetzp7d+eVgowO3vg: calls $0.50
r6u7MWSXF30/khcTYkrG9Q said, "wasn't gonna lay down kings for 5 though"
r6u7MWSXF30/khcTYkrG9Q: folds
M1KyQQvVPVuxqTAB8sR/zQ has returned
kxPhs4ePFqMy52CInAJ2aw: calls $0.25
1WUCqNG+p+vfWRTXNu4ljw: checks
*** FLOP *** [Jc Th 9d]
kxPhs4ePFqMy52CInAJ2aw: checks
uVwggSetzp7d+eVgowO3vg said, "yeah i know, didn't wanna risk too much more...if you had anything less syou probably fold"
1WUCqNG+p+vfWRTXNu4ljw: checks
r6u7MWSXF30/khcTYkrG9Q said, "ya"
uVwggSetzp7d+eVgowO3vg: bets $3
eQXFICMuu3hw6XlcmuVNEA joins the table at seat #3
r6u7MWSXF30/khcTYkrG9Q said, "definitely"
kxPhs4ePFqMy52CInAJ2aw: folds
1WUCqNG+p+vfWRTXNu4ljw: calls $3
*** TURN *** [Jc Th 9d] [Td]
1WUCqNG+p+vfWRTXNu4ljw: checks
uVwggSetzp7d+eVgowO3vg: bets $8
1WUCqNG+p+vfWRTXNu4ljw: calls $8
*** RIVER *** [Jc Th 9d Td] [7d]
r6u7MWSXF30/khcTYkrG9Q said, "if you had gone all in I probably would have as well though"
1WUCqNG+p+vfWRTXNu4ljw: checks
uVwggSetzp7d+eVgowO3vg: checks
*** SHOW DOWN ***
1WUCqNG+p+vfWRTXNu4ljw: shows [Tc Kc] (three of a kind, Tens)
uVwggSetzp7d+eVgowO3vg: shows [8s 7c] (a straight, Seven to Jack)
uVwggSetzp7d+eVgowO3vg collected $22.35 from pot
*** SUMMARY ***
Total pot $23.50 | Rake $1.15
Board [Jc Th 9d Td 7d]
Seat 1: 1WUCqNG+p+vfWRTXNu4ljw (big blind) showed [Tc Kc] and lost with three of a kind, Tens
Seat 2: uVwggSetzp7d+eVgowO3vg showed [8s 7c] and won ($22.35) with a straight, Seven to Jack
Seat 4: r6u7MWSXF30/khcTYkrG9Q (button) folded before Flop (didn't bet)
Seat 6: kxPhs4ePFqMy52CInAJ2aw (small blind) folded on the Flop



PokerStars Game #59940056392:  Hold'em No Limit ($0.25/$0.50) - 2009/07/01 0:56:05 ET
Table '0eJtgVAXVvBgncFdcUpXcQ' 2-max Seat #1 is the button
Seat 1: Ag6DvxX4vbRheqsv2zXKTQ ($38.55 in chips)
Seat 2: KMc4R+K9ao4Ur3rF7NGe6Q ($12.10 in chips)
Ag6DvxX4vbRheqsv2zXKTQ: posts small blind $0.25
KMc4R+K9ao4Ur3rF7NGe6Q: posts big blind $0.50
*** HOLE CARDS ***
Ag6DvxX4vbRheqsv2zXKTQ: calls $0.25
KMc4R+K9ao4Ur3rF7NGe6Q: checks
*** FLOP *** [2d 3s Ad]
KMc4R+K9ao4Ur3rF7NGe6Q: checks
Ag6DvxX4vbRheqsv2zXKTQ: checks
*** TURN *** [2d 3s Ad] [Qs]
KMc4R+K9ao4Ur3rF7NGe6Q: checks
Ag6DvxX4vbRheqsv2zXKTQ: checks
*** RIVER *** [2d 3s Ad Qs] [5s]
KMc4R+K9ao4Ur3rF7NGe6Q: checks
Ag6DvxX4vbRheqsv2zXKTQ: checks
*** SHOW DOWN ***
KMc4R+K9ao4Ur3rF7NGe6Q: shows [6s Kd] (high card Ace)
Ag6DvxX4vbRheqsv2zXKTQ: mucks hand
KMc4R+K9ao4Ur3rF7NGe6Q collected $0.95 from pot
*** SUMMARY ***
Total pot $1 | Rake $0.05
Board [2d 3s Ad Qs 5s]
Seat 1: Ag6DvxX4vbRheqsv2zXKTQ (button) (small blind) mucked
Seat 2: KMc4R+K9ao4Ur3rF7NGe6Q (big blind) showed [6s Kd] and won ($0.95) with high card Ace



PokerStars Game #59940056190:  Hold'em No Limit ($0.25/$0.50) - 2009/07/01 0:56:05 ET
Table '+dXkOAQyS8j9PQZusUTMpg' 2-max Seat #2 is the button
Seat 1: XFa6sBGjP2gxoIvxR3fZIg ($60.30 in chips)
Seat 2: 5IBeOgaApY1Bvzv2P8X4EA ($139.90 in chips)
5IBeOgaApY1Bvzv2P8X4EA: posts small blind $0.25
XFa6sBGjP2gxoIvxR3fZIg: posts big blind $0.50
*** HOLE CARDS ***
5IBeOgaApY1Bvzv2P8X4EA: folds
XFa6sBGjP2gxoIvxR3fZIg collected $0.50 from pot
*** SUMMARY ***
Total pot $0.50 | Rake $0
Seat 1: XFa6sBGjP2gxoIvxR3fZIg (big blind) collected ($0.50)
Seat 2: 5IBeOgaApY1Bvzv2P8X4EA (button) (small blind) folded before Flop



PokerStars Game #59940056446:  Hold'em No Limit ($0.25/$0.50) - 2009/07/01 0:56:05 ET
Table 'BCN5su+SsXiy1zRMJi0SJw' 6-max Seat #2 is the button
Seat 1: GxXV09ciXaOxyY2H5aMIIw ($30.40 in chips)
Seat 2: oU2kDCkT/gilYbHWrg7D8w ($21.80 in chips)
Seat 3: 6wzJiRvp8HY6t+MQGnSIzA ($19 in chips)
Seat 4: qfeUHOJpMYyzQcj0o2A7ng ($16.60 in chips)
Seat 5: IBNygaT1aa9Z1uPdJJilwA ($34.35 in chips)
Seat 6: b2symlOdL7+0c9Pj4N/KlA ($80.50 in chips)
6wzJiRvp8HY6t+MQGnSIzA: posts small blind $0.25
qfeUHOJpMYyzQcj0o2A7ng: posts big blind $0.50
*** HOLE CARDS ***
IBNygaT1aa9Z1uPdJJilwA: folds
b2symlOdL7+0c9Pj4N/KlA: folds
GxXV09ciXaOxyY2H5aMIIw: folds
oU2kDCkT/gilYbHWrg7D8w: folds
6wzJiRvp8HY6t+MQGnSIzA: calls $0.25
qfeUHOJpMYyzQcj0o2A7ng: checks
*** FLOP *** [Tc Jd Qd]
6wzJiRvp8HY6t+MQGnSIzA: checks
qfeUHOJpMYyzQcj0o2A7ng: checks
*** TURN *** [Tc Jd Qd] [Ac]
6wzJiRvp8HY6t+MQGnSIzA: bets $0.50
qfeUHOJpMYyzQcj0o2A7ng: folds
6wzJiRvp8HY6t+MQGnSIzA collected $0.95 from pot
6wzJiRvp8HY6t+MQGnSIzA: doesn't show hand
*** SUMMARY ***
Total pot $1 | Rake $0.05
Board [Tc Jd Qd Ac]
Seat 1: GxXV09ciXaOxyY2H5aMIIw folded before Flop (didn't bet)
Seat 2: oU2kDCkT/gilYbHWrg7D8w (button) folded before Flop (didn't bet)
Seat 3: 6wzJiRvp8HY6t+MQGnSIzA (small blind) collected ($0.95)
Seat 4: qfeUHOJpMYyzQcj0o2A7ng (big blind) folded on the Turn
Seat 5: IBNygaT1aa9Z1uPdJJilwA folded before Flop (didn't bet)
Seat 6: b2symlOdL7+0c9Pj4N/KlA folded before Flop (didn't bet)



PokerStars Game #59940057296:  Hold'em No Limit ($0.25/$0.50) - 2009/07/01 0:56:06 ET
Table 'NCiXr0d5CEKBQr/cZgLhbA' 9-max Seat #2 is the button
Seat 1: pFtzb1sR4b0d1aw6aIRgDg ($50 in chips)
Seat 2: ulxuJchBV9iguXg0FUonfg ($47 in chips)
Seat 3: xZCXQSXlrZkp3pZizzVXCw ($52.95 in chips)
Seat 4: 5k9fvXD9suIgCxU4HLQjTw ($55.95 in chips)
Seat 5: zE9cVigS2nW/Ljy4K4bUQA ($34.45 in chips)
Seat 6: SKnJuWHScqetA/qG5p+wCg ($34.75 in chips)
Seat 7: M+7+BTmX5vZatHVuoRB1nA ($52 in chips)
Seat 8: 1MJUKc3cc0QmUoz1JZLR2w ($58.25 in chips)
Seat 9: 4WLZvqBn5qv5tds5kt5A1Q ($45 in chips)
xZCXQSXlrZkp3pZizzVXCw: posts small blind $0.25
5k9fvXD9suIgCxU4HLQjTw: posts big blind $0.50
*** HOLE CARDS ***
zE9cVigS2nW/Ljy4K4bUQA: folds
SKnJuWHScqetA/qG5p+wCg: calls $0.50
M+7+BTmX5vZatHVuoRB1nA: folds
1MJUKc3cc0QmUoz1JZLR2w: folds
4WLZvqBn5qv5tds5kt5A1Q: calls $0.50
pFtzb1sR4b0d1aw6aIRgDg: folds
ulxuJchBV9iguXg0FUonfg: raises $1.50 to $2
xZCXQSXlrZkp3pZizzVXCw: folds
5k9fvXD9suIgCxU4HLQjTw: folds
SKnJuWHScqetA/qG5p+wCg: calls $1.50
4WLZvqBn5qv5tds5kt5A1Q: calls $1.50
*** FLOP *** [Ad Qd 3s]
SKnJuWHScqetA/qG5p+wCg: checks
4WLZvqBn5qv5tds5kt5A1Q: checks
ulxuJchBV9iguXg0FUonfg: bets $5.50
SKnJuWHScqetA/qG5p+wCg: folds
4WLZvqBn5qv5tds5kt5A1Q: folds
ulxuJchBV9iguXg0FUonfg collected $6.45 from pot
*** SUMMARY ***
Total pot $6.75 | Rake $0.30
Board [Ad Qd 3s]
Seat 1: pFtzb1sR4b0d1aw6aIRgDg folded before Flop (didn't bet)
Seat 2: ulxuJchBV9iguXg0FUonfg (button) collected ($6.45)
Seat 3: xZCXQSXlrZkp3pZizzVXCw (small blind) folded before Flop
Seat 4: 5k9fvXD9suIgCxU4HLQjTw (big blind) folded before Flop
Seat 5: zE9cVigS2nW/Ljy4K4bUQA folded before Flop (didn't bet)
Seat 6: SKnJuWHScqetA/qG5p+wCg folded on the Flop
Seat 7: M+7+BTmX5vZatHVuoRB1nA folded before Flop (didn't bet)
Seat 8: 1MJUKc3cc0QmUoz1JZLR2w folded before Flop (didn't bet)
Seat 9: 4WLZvqBn5qv5tds5kt5A1Q folded on the Flop



PokerStars Game #59940059818:  Hold'em No Limit ($0.25/$0.50) - 2009/07/01 0:56:10 ET
Table '37qXEp3oe+er5q4CZip9eQ' 6-max Seat #1 is the button
Seat 1: oqOqoO2AyCZenUghCxMDxw ($53.40 in chips)
Seat 2: LvH4G7n+QSjT6NDaD3cREA ($50 in chips)
Seat 3: Rt6KgtZ8YaJoTc3FPim00w ($104.05 in chips)
Seat 4: XsmE8nXMAAMFJbWaJTmHFw ($37.95 in chips)
Seat 5: VOmI0x4dDPnTESZd5B4d1Q ($45.25 in chips)
Seat 6: N50kln4negd8q7Mmoz1j4g ($17.55 in chips)
LvH4G7n+QSjT6NDaD3cREA: posts small blind $0.25
Rt6KgtZ8YaJoTc3FPim00w: posts big blind $0.50
*** HOLE CARDS ***
XsmE8nXMAAMFJbWaJTmHFw: folds
VOmI0x4dDPnTESZd5B4d1Q: folds
N50kln4negd8q7Mmoz1j4g: calls $0.50
oqOqoO2AyCZenUghCxMDxw: folds
LvH4G7n+QSjT6NDaD3cREA: folds
Rt6KgtZ8YaJoTc3FPim00w: checks
*** FLOP *** [4s 2s 7h]
Rt6KgtZ8YaJoTc3FPim00w: bets $1
N50kln4negd8q7Mmoz1j4g: folds
Rt6KgtZ8YaJoTc3FPim00w collected $1.20 from pot
*** SUMMARY ***
Total pot $1.25 | Rake $0.05
Board [4s 2s 7h]
Seat 1: oqOqoO2AyCZenUghCxMDxw (button) folded before Flop (didn't bet)
Seat 2: LvH4G7n+QSjT6NDaD3cREA (small blind) folded before Flop
Seat 3: Rt6KgtZ8YaJoTc3FPim00w (big blind) collected ($1.20)
Seat 4: XsmE8nXMAAMFJbWaJTmHFw folded before Flop (didn't bet)
Seat 5: VOmI0x4dDPnTESZd5B4d1Q folded before Flop (didn't bet)
Seat 6: N50kln4negd8q7Mmoz1j4g folded on the Flop



PokerStars Game #59940060228:  Hold'em No Limit ($0.25/$0.50) - 2009/07/01 0:56:11 ET
Table '+dXkOAQyS8j9PQZusUTMpg' 2-max Seat #1 is the button
Seat 1: XFa6sBGjP2gxoIvxR3fZIg ($60.55 in chips)
Seat 2: 5IBeOgaApY1Bvzv2P8X4EA ($139.65 in chips)
XFa6sBGjP2gxoIvxR3fZIg: posts small blind $0.25
5IBeOgaApY1Bvzv2P8X4EA: posts big blind $0.50
*** HOLE CARDS ***
XFa6sBGjP2gxoIvxR3fZIg: raises $1 to $1.50
5IBeOgaApY1Bvzv2P8X4EA: calls $1
*** FLOP *** [Ad 7s Ah]
5IBeOgaApY1Bvzv2P8X4EA: checks
XFa6sBGjP2gxoIvxR3fZIg: checks
*** TURN *** [Ad 7s Ah] [5c]
5IBeOgaApY1Bvzv2P8X4EA: checks
XFa6sBGjP2gxoIvxR3fZIg: bets $2
5IBeOgaApY1Bvzv2P8X4EA: folds
XFa6sBGjP2gxoIvxR3fZIg collected $2.85 from pot
*** SUMMARY ***
Total pot $3 | Rake $0.15
Board [Ad 7s Ah 5c]
Seat 1: XFa6sBGjP2gxoIvxR3fZIg (button) (small blind) collected ($2.85)
Seat 2: 5IBeOgaApY1Bvzv2P8X4EA (big blind) folded on the Turn



PokerStars Game #59940062158:  Hold'em No Limit ($0.25/$0.50) - 2009/07/01 0:56:14 ET
Table '99gCy/CZQwPIjZWH+BguQgE7bWJ45aoFXRpyRv2gw+Igeat #8 is the button
Seat 2: n6VQBu6crjYjy6DxNP1NZA ($28.75 in chips)
Seat 3: qEn9ijNGtuyTxamBf07hYg ($50 in chips)
Seat 4: bxLSulbgr8LmKNjOzw8URg ($61.45 in chips)
Seat 5: DSM67hHHq1XFoEOi9p8Alw ($50 in chips)
Seat 6: OcnLOMVFdy23jXnoTyaO5Q ($244.90 in chips)
Seat 7: bfSq6LBw0UvxeM5yfuWC7w ($17.85 in chips)
Seat 8: 8ehL7qlZzjgUh2H35iiWLw ($51.75 in chips)
Seat 9: j3K/Jujr7PY4ZM2RZvlH6A ($100.70 in chips)
j3K/Jujr7PY4ZM2RZvlH6A: posts small blind $0.25
n6VQBu6crjYjy6DxNP1NZA: posts big blind $0.50
OcnLOMVFdy23jXnoTyaO5Q: posts small & big blinds $0.75
*** HOLE CARDS ***
qEn9ijNGtuyTxamBf07hYg: folds
bxLSulbgr8LmKNjOzw8URg: raises $1.50 to $2
DSM67hHHq1XFoEOi9p8Alw: folds
OcnLOMVFdy23jXnoTyaO5Q: folds
bfSq6LBw0UvxeM5yfuWC7w: folds
8ehL7qlZzjgUh2H35iiWLw: folds
j3K/Jujr7PY4ZM2RZvlH6A: folds
n6VQBu6crjYjy6DxNP1NZA: folds
bxLSulbgr8LmKNjOzw8URg collected $2 from pot
bxLSulbgr8LmKNjOzw8URg: doesn't show hand
*** SUMMARY ***
Total pot $2 | Rake $0
Seat 2: n6VQBu6crjYjy6DxNP1NZA (big blind) folded before Flop
Seat 3: qEn9ijNGtuyTxamBf07hYg folded before Flop (didn't bet)
Seat 4: bxLSulbgr8LmKNjOzw8URg collected ($2)
Seat 5: DSM67hHHq1XFoEOi9p8Alw folded before Flop (didn't bet)
Seat 6: OcnLOMVFdy23jXnoTyaO5Q folded before Flop
Seat 7: bfSq6LBw0UvxeM5yfuWC7w folded before Flop (didn't bet)
Seat 8: 8ehL7qlZzjgUh2H35iiWLw (button) folded before Flop (didn't bet)
Seat 9: j3K/Jujr7PY4ZM2RZvlH6A (small blind) folded before Flop



PokerStars Game #59940064224:  Hold'em No Limit ($0.25/$0.50) - 2009/07/01 0:56:17 ET
Table 'E7bWJ45aoFXRpyRv2gw+Ig' 2-max Seat #1 is the button
Seat 1: FRkiRasEGlHUeLrEl+k/nA ($66.25 in chips)
Seat 2: 3Wro85I7472vJ4Wkpneo9A ($125.15 in chips)
FRkiRasEGlHUeLrEl+k/nA: posts small blind $0.25
3Wro85I7472vJ4Wkpneo9A: posts big blind $0.50
*** HOLE CARDS ***
FRkiRasEGlHUeLrEl+k/nA said, "Knew you missed the flush"
FRkiRasEGlHUeLrEl+k/nA: folds
3Wro85I7472vJ4Wkpneo9A collected $0.50 from pot
3Wro85I7472vJ4Wkpneo9A: doesn't show hand
*** SUMMARY ***
Total pot $0.50 | Rake $0
Seat 1: FRkiRasEGlHUeLrEl+k/nA (button) (small blind) folded before Flop
Seat 2: 3Wro85I7472vJ4Wkpneo9A (big blind) collected ($0.50)



PokerStars Game #59940063940:  Hold'em No Limit ($0.25/$0.50) - 2009/07/01 0:56:17 ET
Table '9Puy2HWN1RQe5SSjq162gA' 2-max Seat #1 is the button
Seat 1: Fp/oksNpipCrD2MJ2pH20g ($8.15 in chips)
Seat 2: tDV+zhxH9+3DkJDzoTERyg ($21.60 in chips)
Fp/oksNpipCrD2MJ2pH20g: posts small blind $0.25
tDV+zhxH9+3DkJDzoTERyg: posts big blind $0.50
*** HOLE CARDS ***
Fp/oksNpipCrD2MJ2pH20g: folds
tDV+zhxH9+3DkJDzoTERyg collected $0.50 from pot
tDV+zhxH9+3DkJDzoTERyg: doesn't show hand
*** SUMMARY ***
Total pot $0.50 | Rake $0
Seat 1: Fp/oksNpipCrD2MJ2pH20g (button) (small blind) folded before Flop
Seat 2: tDV+zhxH9+3DkJDzoTERyg (big blind) collected ($0.50)



PokerStars Game #59940064454:  Hold'em No Limit ($0.25/$0.50) - 2009/07/01 0:56:18 ET
Table 'c/CRn+68J3Y8KxD5g1ek2Q' 2-max Seat #1 is the button
Seat 1: 46qCyJ6evTkHo9al5sBMNA ($85.25 in chips)
Seat 2: BypVLsYQt3ePFm2xQL/dOA ($284.50 in chips)
46qCyJ6evTkHo9al5sBMNA: posts small blind $0.25
BypVLsYQt3ePFm2xQL/dOA: posts big blind $0.50
*** HOLE CARDS ***
46qCyJ6evTkHo9al5sBMNA: raises $1.50 to $2
BypVLsYQt3ePFm2xQL/dOA: calls $1.50
*** FLOP *** [Qs 2c Jh]
BypVLsYQt3ePFm2xQL/dOA: checks
46qCyJ6evTkHo9al5sBMNA: bets $3
BypVLsYQt3ePFm2xQL/dOA: folds
46qCyJ6evTkHo9al5sBMNA collected $3.80 from pot
46qCyJ6evTkHo9al5sBMNA: doesn't show hand
*** SUMMARY ***
Total pot $4 | Rake $0.20
Board [Qs 2c Jh]
Seat 1: 46qCyJ6evTkHo9al5sBMNA (button) (small blind) collected ($3.80)
Seat 2: BypVLsYQt3ePFm2xQL/dOA (big blind) folded on the Flop



PokerStars Game #59940064954:  Hold'em No Limit ($0.25/$0.50) - 2009/07/01 0:56:19 ET
Table 'kgbJRsxfv64KrErDRBAkcw' 6-max Seat #3 is the button
Seat 1: w2dj3tZyWCX7+wEKRi0AVw ($28.25 in chips)
Seat 2: AdS8BJMOheS01zjCDfPMFg ($48.25 in chips)
Seat 3: c4MNIaIyPMOMxrgT8FT5nA ($110 in chips)
Seat 4: qanMEqjABjWxC/JgQ/0l7w ($57.50 in chips)
Seat 5: eUBBn2R56C1IQ6Cs/vitwg ($50 in chips)
Seat 6: 1b+2BbjMN8qhR1WPqdE9VQ ($53.40 in chips)
qanMEqjABjWxC/JgQ/0l7w: posts small blind $0.25
eUBBn2R56C1IQ6Cs/vitwg: posts big blind $0.50
*** HOLE CARDS ***
1b+2BbjMN8qhR1WPqdE9VQ: folds
w2dj3tZyWCX7+wEKRi0AVw: folds
AdS8BJMOheS01zjCDfPMFg: raises $1 to $1.50
c4MNIaIyPMOMxrgT8FT5nA: folds
qanMEqjABjWxC/JgQ/0l7w: folds
eUBBn2R56C1IQ6Cs/vitwg: folds
AdS8BJMOheS01zjCDfPMFg collected $1.25 from pot
*** SUMMARY ***
Total pot $1.25 | Rake $0
Seat 1: w2dj3tZyWCX7+wEKRi0AVw folded before Flop (didn't bet)
Seat 2: AdS8BJMOheS01zjCDfPMFg collected ($1.25)
Seat 3: c4MNIaIyPMOMxrgT8FT5nA (button) folded before Flop (didn't bet)
Seat 4: qanMEqjABjWxC/JgQ/0l7w (small blind) folded before Flop
Seat 5: eUBBn2R56C1IQ6Cs/vitwg (big blind) folded before Flop
Seat 6: 1b+2BbjMN8qhR1WPqdE9VQ folded before Flop (didn't bet)



PokerStars Game #59940065206:  Hold'em No Limit ($0.25/$0.50) - 2009/07/01 0:56:19 ET
Table '+z1aekfHkpp09pc8F9aViw' 6-max Seat #6 is the button
Seat 1: FHilMb2i2DbUCc9lplszog ($58.05 in chips)
Seat 2: M6xK/VklCvdyyrmvzATlxQ ($34.50 in chips)
Seat 3: uUznlIMFnRUvwrBhYF73KA ($118.55 in chips)
Seat 4: RowCSpSURHTOL/dcjg/Iug ($40.30 in chips)
Seat 6: 686aeHikcJlgKkSuIFdcXQ ($50 in chips)
FHilMb2i2DbUCc9lplszog: posts small blind $0.25
M6xK/VklCvdyyrmvzATlxQ: posts big blind $0.50
*** HOLE CARDS ***
uUznlIMFnRUvwrBhYF73KA: folds
RowCSpSURHTOL/dcjg/Iug: folds
686aeHikcJlgKkSuIFdcXQ: raises $1 to $1.50
FHilMb2i2DbUCc9lplszog: calls $1.25
M6xK/VklCvdyyrmvzATlxQ: folds
*** FLOP *** [7h 8s Th]
FHilMb2i2DbUCc9lplszog: checks
rplyldNweS6YyMNEALQrug has returned
686aeHikcJlgKkSuIFdcXQ: checks
*** TURN *** [7h 8s Th] [6c]
FHilMb2i2DbUCc9lplszog: checks
686aeHikcJlgKkSuIFdcXQ: checks
*** RIVER *** [7h 8s Th 6c] [4c]
FHilMb2i2DbUCc9lplszog: checks
686aeHikcJlgKkSuIFdcXQ: checks
*** SHOW DOWN ***
FHilMb2i2DbUCc9lplszog: shows [Qd Jd] (high card Queen)
686aeHikcJlgKkSuIFdcXQ: shows [Qs Ac] (high card Ace)
686aeHikcJlgKkSuIFdcXQ collected $3.35 from pot
*** SUMMARY ***
Total pot $3.50 | Rake $0.15
Board [7h 8s Th 6c 4c]
Seat 1: FHilMb2i2DbUCc9lplszog (small blind) showed [Qd Jd] and lost with high card Queen
Seat 2: M6xK/VklCvdyyrmvzATlxQ (big blind) folded before Flop
Seat 3: uUznlIMFnRUvwrBhYF73KA folded before Flop (didn't bet)
Seat 4: RowCSpSURHTOL/dcjg/Iug folded before Flop (didn't bet)
Seat 6: 686aeHikcJlgKkSuIFdcXQ (button) showed [Qs Ac] and won ($3.35) with high card Ace



PokerStars Game #59940066098:  Hold'em No Limit ($0.25/$0.50) - 2009/07/01 0:56:20 ET
Table 'lSisgp6H7Fg1hH5VfjEjYQ' 9-max Seat #9 is the button
Seat 1: 5k9fvXD9suIgCxU4HLQjTw ($50 in chips)
Seat 2: UrcnkQOiLVk8BlKDPJSy7Q ($76.10 in chips)
Seat 3: aTkyjTh3w5YLWiIERupZOA ($51.20 in chips)
Seat 4: bwv/rbH/hHhPhY6u9mu04w ($32.10 in chips)
Seat 5: mSD1pginDsyHG5PDfqzphw ($12.60 in chips)
Seat 6: +k7T5ocke8UwavtgUHm+Cg ($54.95 in chips)
Seat 7: IDtNLR9uFCDdjNsJWMHA5Q ($19.85 in chips)
Seat 8: a4JDWmpFQkL10XfAyuF51A ($29 in chips)
Seat 9: gsyXT42WLEcOS4DdEk2wlw ($42.05 in chips)
5k9fvXD9suIgCxU4HLQjTw: posts small blind $0.25
UrcnkQOiLVk8BlKDPJSy7Q: posts big blind $0.50
*** HOLE CARDS ***
aTkyjTh3w5YLWiIERupZOA: raises $1 to $1.50
bwv/rbH/hHhPhY6u9mu04w: folds
mSD1pginDsyHG5PDfqzphw: folds
+k7T5ocke8UwavtgUHm+Cg: folds
IDtNLR9uFCDdjNsJWMHA5Q: folds
a4JDWmpFQkL10XfAyuF51A: folds
gsyXT42WLEcOS4DdEk2wlw: folds
5k9fvXD9suIgCxU4HLQjTw: folds
UrcnkQOiLVk8BlKDPJSy7Q: folds
aTkyjTh3w5YLWiIERupZOA collected $1.25 from pot
*** SUMMARY ***
Total pot $1.25 | Rake $0
Seat 1: 5k9fvXD9suIgCxU4HLQjTw (small blind) folded before Flop
Seat 2: UrcnkQOiLVk8BlKDPJSy7Q (big blind) folded before Flop
Seat 3: aTkyjTh3w5YLWiIERupZOA collected ($1.25)
Seat 4: bwv/rbH/hHhPhY6u9mu04w folded before Flop (didn't bet)
Seat 5: mSD1pginDsyHG5PDfqzphw folded before Flop (didn't bet)
Seat 6: +k7T5ocke8UwavtgUHm+Cg folded before Flop (didn't bet)
Seat 7: IDtNLR9uFCDdjNsJWMHA5Q folded before Flop (didn't bet)
Seat 8: a4JDWmpFQkL10XfAyuF51A folded before Flop (didn't bet)
Seat 9: gsyXT42WLEcOS4DdEk2wlw (button) folded before Flop (didn't bet)



PokerStars Game #59940066592:  Hold'em No Limit ($0.25/$0.50) - 2009/07/01 0:56:21 ET
Table '5EmHi+fnatGQQShcNmzOZQ' 6-max Seat #6 is the button
Seat 1: My8WkRtGx5FW6rJ1I4R3hg ($10.25 in chips)
Seat 3: TjmTe3bhs9dFz5gXX9x7Lw ($20 in chips)
Seat 4: 1b+2BbjMN8qhR1WPqdE9VQ ($69.30 in chips)
Seat 5: kxPhs4ePFqMy52CInAJ2aw ($80.55 in chips)
Seat 6: 686aeHikcJlgKkSuIFdcXQ ($133.25 in chips)
My8WkRtGx5FW6rJ1I4R3hg: posts small blind $0.25
TjmTe3bhs9dFz5gXX9x7Lw: posts big blind $0.50
*** HOLE CARDS ***
1b+2BbjMN8qhR1WPqdE9VQ: folds
kxPhs4ePFqMy52CInAJ2aw: folds
wlynch82 joins the table at seat #2
686aeHikcJlgKkSuIFdcXQ: raises $1 to $1.50
My8WkRtGx5FW6rJ1I4R3hg: calls $1.25
TjmTe3bhs9dFz5gXX9x7Lw: folds
*** FLOP *** [Qc 9h 9c]
My8WkRtGx5FW6rJ1I4R3hg: bets $1.50
686aeHikcJlgKkSuIFdcXQ: folds
My8WkRtGx5FW6rJ1I4R3hg collected $3.35 from pot
*** SUMMARY ***
Total pot $3.50 | Rake $0.15
Board [Qc 9h 9c]
Seat 1: My8WkRtGx5FW6rJ1I4R3hg (small blind) collected ($3.35)
Seat 3: TjmTe3bhs9dFz5gXX9x7Lw (big blind) folded before Flop
Seat 4: 1b+2BbjMN8qhR1WPqdE9VQ folded before Flop (didn't bet)
Seat 5: kxPhs4ePFqMy52CInAJ2aw folded before Flop (didn't bet)
Seat 6: 686aeHikcJlgKkSuIFdcXQ (button) folded on the Flop



PokerStars Game #59940067116:  Hold'em No Limit ($0.25/$0.50) - 2009/07/01 0:56:22 ET
Table '0eJtgVAXVvBgncFdcUpXcQ' 2-max Seat #2 is the button
Seat 1: Ag6DvxX4vbRheqsv2zXKTQ ($38.05 in chips)
Seat 2: KMc4R+K9ao4Ur3rF7NGe6Q ($12.55 in chips)
KMc4R+K9ao4Ur3rF7NGe6Q: posts small blind $0.25
Ag6DvxX4vbRheqsv2zXKTQ: posts big blind $0.50
*** HOLE CARDS ***
KMc4R+K9ao4Ur3rF7NGe6Q: raises $1 to $1.50
Ag6DvxX4vbRheqsv2zXKTQ: folds
KMc4R+K9ao4Ur3rF7NGe6Q collected $1 from pot
KMc4R+K9ao4Ur3rF7NGe6Q: doesn't show hand
*** SUMMARY ***
Total pot $1 | Rake $0
Seat 1: Ag6DvxX4vbRheqsv2zXKTQ (big blind) folded before Flop
Seat 2: KMc4R+K9ao4Ur3rF7NGe6Q (button) (small blind) collected ($1)



PokerStars Game #59940067168:  Hold'em No Limit ($0.25/$0.50) - 2009/07/01 0:56:22 ET
Table 'Vdlc9wqYcHTUhtdyN7CuJw' 2-max Seat #2 is the button
Seat 1: yBO+mXB6m/rCft2ErwGf/Q ($116.05 in chips)
Seat 2: NZ/5cxwnorKW2SNsWy1+8A ($8.65 in chips)
NZ/5cxwnorKW2SNsWy1+8A: posts small blind $0.25
yBO+mXB6m/rCft2ErwGf/Q: posts big blind $0.50
*** HOLE CARDS ***
NZ/5cxwnorKW2SNsWy1+8A: folds
yBO+mXB6m/rCft2ErwGf/Q collected $0.50 from pot
*** SUMMARY ***
Total pot $0.50 | Rake $0
Seat 1: yBO+mXB6m/rCft2ErwGf/Q (big blind) collected ($0.50)
Seat 2: NZ/5cxwnorKW2SNsWy1+8A (button) (small blind) folded before Flop



PokerStars Game #59940068086:  Hold'em No Limit ($0.25/$0.50) - 2009/07/01 0:56:24 ET
Table '9Puy2HWN1RQe5SSjq162gA' 2-max Seat #2 is the button
Seat 1: Fp/oksNpipCrD2MJ2pH20g ($7.90 in chips)
Seat 2: tDV+zhxH9+3DkJDzoTERyg ($21.85 in chips)
tDV+zhxH9+3DkJDzoTERyg: posts small blind $0.25
Fp/oksNpipCrD2MJ2pH20g: posts big blind $0.50
*** HOLE CARDS ***
tDV+zhxH9+3DkJDzoTERyg: raises $0.50 to $1
Fp/oksNpipCrD2MJ2pH20g: folds
tDV+zhxH9+3DkJDzoTERyg collected $1 from pot
*** SUMMARY ***
Total pot $1 | Rake $0
Seat 1: Fp/oksNpipCrD2MJ2pH20g (big blind) folded before Flop
Seat 2: tDV+zhxH9+3DkJDzoTERyg (button) (small blind) collected ($1)



PokerStars Game #59940068052:  Hold'em No Limit ($0.25/$0.50) - 2009/07/01 0:56:24 ET
Table 'QOgaEqMcJ73pcUMMxoisUgErOuyGLI5PT3G5MnpHgC/g Seat #8 is the button
Seat 1: eBrej2jnlUCs/JgxFCRn2g ($40 in chips)
Seat 3: xZCXQSXlrZkp3pZizzVXCw ($49.50 in chips)
Seat 4: 3UmXLy3GfjC3EkOebduerQ ($50.45 in chips)
Seat 5: JwvquocWfhTVApN5t47LgA ($63.35 in chips)
Seat 6: zE9cVigS2nW/Ljy4K4bUQA ($31.60 in chips)
Seat 7: 90Wb75h3W1BRpbqVnuk8gw ($65.60 in chips)
Seat 8: g4k0NXISyLCqaSWZDBjfEg ($50 in chips)
Seat 9: J0W5D97jl5VLky+IoPvDeA ($51.65 in chips)
J0W5D97jl5VLky+IoPvDeA: posts small blind $0.25
eBrej2jnlUCs/JgxFCRn2g: posts big blind $0.50
*** HOLE CARDS ***
xZCXQSXlrZkp3pZizzVXCw: folds
3UmXLy3GfjC3EkOebduerQ: folds
JwvquocWfhTVApN5t47LgA: folds
zE9cVigS2nW/Ljy4K4bUQA: folds
90Wb75h3W1BRpbqVnuk8gw: folds
g4k0NXISyLCqaSWZDBjfEg: folds
J0W5D97jl5VLky+IoPvDeA: folds
eBrej2jnlUCs/JgxFCRn2g collected $0.50 from pot
*** SUMMARY ***
Total pot $0.50 | Rake $0
Seat 1: eBrej2jnlUCs/JgxFCRn2g (big blind) collected ($0.50)
Seat 3: xZCXQSXlrZkp3pZizzVXCw folded before Flop (didn't bet)
Seat 4: 3UmXLy3GfjC3EkOebduerQ folded before Flop (didn't bet)
Seat 5: JwvquocWfhTVApN5t47LgA folded before Flop (didn't bet)
Seat 6: zE9cVigS2nW/Ljy4K4bUQA folded before Flop (didn't bet)
Seat 7: 90Wb75h3W1BRpbqVnuk8gw folded before Flop (didn't bet)
Seat 8: g4k0NXISyLCqaSWZDBjfEg (button) folded before Flop (didn't bet)
Seat 9: J0W5D97jl5VLky+IoPvDeA (small blind) folded before Flop



PokerStars Game #59940068036:  Hold'em No Limit ($0.25/$0.50) - 2009/07/01 0:56:24 ET
Table 'Nz0Vr7WMHL2g5Uk7dDZjpw' 9-max Seat #1 is the button
Seat 1: tLkxo7JgV+WWI0UBw44K5A ($109.10 in chips)
Seat 2: XNMDwbXt/Q4jM99AXnbJDw ($57.35 in chips)
Seat 3: uw9QayAAxLM3Hb+HR7mSkg ($10.75 in chips)
Seat 4: 75K2MXwN65Sjfp1yHd50Hg ($28.50 in chips)
Seat 5: WGW0DgjBUXs1ylURHG8vnQ ($27.50 in chips)
Seat 6: 997ViqAtWn1FPjJqcffwcA ($61.30 in chips)
Seat 7: KPLH0gELgFe2OuAnhJFI5w ($17.85 in chips)
Seat 8: HkZI6g4zl83TDTA7SRspmQ ($16.45 in chips)
Seat 9: mSD1pginDsyHG5PDfqzphw ($10 in chips)
XNMDwbXt/Q4jM99AXnbJDw: posts small blind $0.25
uw9QayAAxLM3Hb+HR7mSkg: posts big blind $0.50
*** HOLE CARDS ***
75K2MXwN65Sjfp1yHd50Hg: folds
75K2MXwN65Sjfp1yHd50Hg leaves the table
WGW0DgjBUXs1ylURHG8vnQ: folds
E2518gp4aFz1+kAgmGqeEg joins the table at seat #4
997ViqAtWn1FPjJqcffwcA: folds
KPLH0gELgFe2OuAnhJFI5w: folds
HkZI6g4zl83TDTA7SRspmQ: folds
mSD1pginDsyHG5PDfqzphw: folds
tLkxo7JgV+WWI0UBw44K5A: folds
XNMDwbXt/Q4jM99AXnbJDw: raises $1 to $1.50
uw9QayAAxLM3Hb+HR7mSkg: folds
XNMDwbXt/Q4jM99AXnbJDw collected $1 from pot
XNMDwbXt/Q4jM99AXnbJDw: doesn't show hand
*** SUMMARY ***
Total pot $1 | Rake $0
Seat 1: tLkxo7JgV+WWI0UBw44K5A (button) folded before Flop (didn't bet)
Seat 2: XNMDwbXt/Q4jM99AXnbJDw (small blind) collected ($1)
Seat 3: uw9QayAAxLM3Hb+HR7mSkg (big blind) folded before Flop
Seat 4: 75K2MXwN65Sjfp1yHd50Hg folded before Flop (didn't bet)
Seat 5: WGW0DgjBUXs1ylURHG8vnQ folded before Flop (didn't bet)
Seat 6: 997ViqAtWn1FPjJqcffwcA folded before Flop (didn't bet)
Seat 7: KPLH0gELgFe2OuAnhJFI5w folded before Flop (didn't bet)
Seat 8: HkZI6g4zl83TDTA7SRspmQ folded before Flop (didn't bet)
Seat 9: mSD1pginDsyHG5PDfqzphw folded before Flop (didn't bet)



PokerStars Game #59940070958:  Hold'em No Limit ($0.25/$0.50) - 2009/07/01 0:56:29 ET
Table '0eJtgVAXVvBgncFdcUpXcQ' 2-max Seat #1 is the button
Seat 1: Ag6DvxX4vbRheqsv2zXKTQ ($37.55 in chips)
Seat 2: KMc4R+K9ao4Ur3rF7NGe6Q ($13.05 in chips)
Ag6DvxX4vbRheqsv2zXKTQ: posts small blind $0.25
KMc4R+K9ao4Ur3rF7NGe6Q: posts big blind $0.50
*** HOLE CARDS ***
Ag6DvxX4vbRheqsv2zXKTQ: raises $1 to $1.50
KMc4R+K9ao4Ur3rF7NGe6Q: folds
Ag6DvxX4vbRheqsv2zXKTQ collected $1 from pot
*** SUMMARY ***
Total pot $1 | Rake $0
Seat 1: Ag6DvxX4vbRheqsv2zXKTQ (button) (small blind) collected ($1)
Seat 2: KMc4R+K9ao4Ur3rF7NGe6Q (big blind) folded before Flop



PokerStars Game #59940071128:  Hold'em No Limit ($0.25/$0.50) - 2009/07/01 0:56:29 ET
Table '+dXkOAQyS8j9PQZusUTMpg' 2-max Seat #2 is the button
Seat 1: XFa6sBGjP2gxoIvxR3fZIg ($61.90 in chips)
Seat 2: 5IBeOgaApY1Bvzv2P8X4EA ($138.15 in chips)
5IBeOgaApY1Bvzv2P8X4EA: posts small blind $0.25
XFa6sBGjP2gxoIvxR3fZIg: posts big blind $0.50
*** HOLE CARDS ***
5IBeOgaApY1Bvzv2P8X4EA: calls $0.25
XFa6sBGjP2gxoIvxR3fZIg: checks
*** FLOP *** [Ad Qc 4d]
XFa6sBGjP2gxoIvxR3fZIg: bets $1
5IBeOgaApY1Bvzv2P8X4EA: folds
XFa6sBGjP2gxoIvxR3fZIg collected $0.95 from pot
*** SUMMARY ***
Total pot $1 | Rake $0.05
Board [Ad Qc 4d]
Seat 1: XFa6sBGjP2gxoIvxR3fZIg (big blind) collected ($0.95)
Seat 2: 5IBeOgaApY1Bvzv2P8X4EA (button) (small blind) folded on the Flop



PokerStars Game #59940071370:  Hold'em No Limit ($0.25/$0.50) - 2009/07/01 0:56:30 ET
Table 'Vdlc9wqYcHTUhtdyN7CuJw' 2-max Seat #1 is the button
Seat 1: yBO+mXB6m/rCft2ErwGf/Q ($116.30 in chips)
Seat 2: NZ/5cxwnorKW2SNsWy1+8A ($8.40 in chips)
yBO+mXB6m/rCft2ErwGf/Q: posts small blind $0.25
NZ/5cxwnorKW2SNsWy1+8A: posts big blind $0.50
*** HOLE CARDS ***
yBO+mXB6m/rCft2ErwGf/Q: raises $1 to $1.50
NZ/5cxwnorKW2SNsWy1+8A: folds
yBO+mXB6m/rCft2ErwGf/Q collected $1 from pot
*** SUMMARY ***
Total pot $1 | Rake $0
Seat 1: yBO+mXB6m/rCft2ErwGf/Q (button) (small blind) collected ($1)
Seat 2: NZ/5cxwnorKW2SNsWy1+8A (big blind) folded before Flop



PokerStars Game #59940072058:  Hold'em No Limit ($0.25/$0.50) - 2009/07/01 0:56:31 ET
Table 'E7bWJ45aoFXRpyRv2gw+Ig' 2-max Seat #2 is the button
Seat 1: FRkiRasEGlHUeLrEl+k/nA ($66 in chips)
Seat 2: 3Wro85I7472vJ4Wkpneo9A ($125.40 in chips)
3Wro85I7472vJ4Wkpneo9A: posts small blind $0.25
FRkiRasEGlHUeLrEl+k/nA: posts big blind $0.50
*** HOLE CARDS ***
3Wro85I7472vJ4Wkpneo9A: folds
FRkiRasEGlHUeLrEl+k/nA said, "unbelievable"
FRkiRasEGlHUeLrEl+k/nA collected $0.50 from pot
*** SUMMARY ***
Total pot $0.50 | Rake $0
Seat 1: FRkiRasEGlHUeLrEl+k/nA (big blind) collected ($0.50)
Seat 2: 3Wro85I7472vJ4Wkpneo9A (button) (small blind) folded before Flop



PokerStars Game #59940072848:  Hold'em No Limit ($0.25/$0.50) - 2009/07/01 0:56:32 ET
Table '9Puy2HWN1RQe5SSjq162gA' 2-max Seat #1 is the button
Seat 1: Fp/oksNpipCrD2MJ2pH20g ($7.40 in chips)
Seat 2: tDV+zhxH9+3DkJDzoTERyg ($22.35 in chips)
Fp/oksNpipCrD2MJ2pH20g: posts small blind $0.25
tDV+zhxH9+3DkJDzoTERyg: posts big blind $0.50
*** HOLE CARDS ***
Fp/oksNpipCrD2MJ2pH20g: folds
tDV+zhxH9+3DkJDzoTERyg collected $0.50 from pot
tDV+zhxH9+3DkJDzoTERyg: doesn't show hand
*** SUMMARY ***
Total pot $0.50 | Rake $0
Seat 1: Fp/oksNpipCrD2MJ2pH20g (button) (small blind) folded before Flop
Seat 2: tDV+zhxH9+3DkJDzoTERyg (big blind) collected ($0.50)



PokerStars Game #59940073172:  Hold'em No Limit ($0.25/$0.50) - 2009/07/01 0:56:32 ET
Table 'fx6MqwfYAj/Rt86hBz2L3Q' 9-max Seat #9 is the button
Seat 1: SegjDnMxWMujiD57ESNL+g ($10 in chips)
Seat 2: C3rGXblctNcWI6JYPHhaEg ($25.20 in chips)
Seat 3: iadBi5AEt7gTBXbDSSnMYQ ($76.45 in chips)
Seat 5: iAISe3dVeua8PUn2wwgDHw ($26.25 in chips)
Seat 6: 5k9fvXD9suIgCxU4HLQjTw ($50 in chips)
Seat 7: SKnJuWHScqetA/qG5p+wCg ($30 in chips)
Seat 8: JYwJYYV9pM5KWdSiETl8rA ($26.50 in chips)
Seat 9: HZkVla4kK2SI42CVrPZ/ig ($10.75 in chips)
SegjDnMxWMujiD57ESNL+g: posts small blind $0.25
C3rGXblctNcWI6JYPHhaEg: posts big blind $0.50
75K2MXwN65Sjfp1yHd50Hg: sits out
*** HOLE CARDS ***
iadBi5AEt7gTBXbDSSnMYQ: calls $0.50
iAISe3dVeua8PUn2wwgDHw: calls $0.50
SegjDnMxWMujiD57ESNL+g said, "sick river"
5k9fvXD9suIgCxU4HLQjTw: folds
SKnJuWHScqetA/qG5p+wCg: folds
JYwJYYV9pM5KWdSiETl8rA: folds
C3rGXblctNcWI6JYPHhaEg said, "indeed -_-;"
HZkVla4kK2SI42CVrPZ/ig: calls $0.50
SegjDnMxWMujiD57ESNL+g: folds
C3rGXblctNcWI6JYPHhaEg: checks
*** FLOP *** [8h Js 3s]
C3rGXblctNcWI6JYPHhaEg: checks
iadBi5AEt7gTBXbDSSnMYQ: checks
iAISe3dVeua8PUn2wwgDHw: checks
HZkVla4kK2SI42CVrPZ/ig: checks
*** TURN *** [8h Js 3s] [5s]
C3rGXblctNcWI6JYPHhaEg: bets $1.70
iadBi5AEt7gTBXbDSSnMYQ: calls $1.70
iAISe3dVeua8PUn2wwgDHw: folds
HZkVla4kK2SI42CVrPZ/ig: folds
*** RIVER *** [8h Js 3s 5s] [5c]
C3rGXblctNcWI6JYPHhaEg: bets $3
iadBi5AEt7gTBXbDSSnMYQ: calls $3
*** SHOW DOWN ***
C3rGXblctNcWI6JYPHhaEg: shows [5d 9c] (three of a kind, Fives)
iadBi5AEt7gTBXbDSSnMYQ: mucks hand
C3rGXblctNcWI6JYPHhaEg collected $11.10 from pot
*** SUMMARY ***
Total pot $11.65 | Rake $0.55
Board [8h Js 3s 5s 5c]
Seat 1: SegjDnMxWMujiD57ESNL+g (small blind) folded before Flop
Seat 2: C3rGXblctNcWI6JYPHhaEg (big blind) showed [5d 9c] and won ($11.10) with three of a kind, Fives
Seat 3: iadBi5AEt7gTBXbDSSnMYQ mucked
Seat 5: iAISe3dVeua8PUn2wwgDHw folded on the Turn
Seat 6: 5k9fvXD9suIgCxU4HLQjTw folded before Flop (didn't bet)
Seat 7: SKnJuWHScqetA/qG5p+wCg folded before Flop (didn't bet)
Seat 8: JYwJYYV9pM5KWdSiETl8rA folded before Flop (didn't bet)
Seat 9: HZkVla4kK2SI42CVrPZ/ig (button) folded on the Turn



PokerStars Game #59940073598:  Hold'em No Limit ($0.25/$0.50) - 2009/07/01 0:56:33 ET
Table 'BCN5su+SsXiy1zRMJi0SJw' 6-max Seat #3 is the button
Seat 1: GxXV09ciXaOxyY2H5aMIIw ($30.40 in chips)
Seat 2: oU2kDCkT/gilYbHWrg7D8w ($21.80 in chips)
Seat 3: 6wzJiRvp8HY6t+MQGnSIzA ($19.45 in chips)
Seat 4: qfeUHOJpMYyzQcj0o2A7ng ($16.10 in chips)
Seat 5: IBNygaT1aa9Z1uPdJJilwA ($34.35 in chips)
Seat 6: b2symlOdL7+0c9Pj4N/KlA ($80.50 in chips)
qfeUHOJpMYyzQcj0o2A7ng: posts small blind $0.25
IBNygaT1aa9Z1uPdJJilwA: posts big blind $0.50
*** HOLE CARDS ***
b2symlOdL7+0c9Pj4N/KlA: folds
GxXV09ciXaOxyY2H5aMIIw: folds
oU2kDCkT/gilYbHWrg7D8w: folds
6wzJiRvp8HY6t+MQGnSIzA: calls $0.50
qfeUHOJpMYyzQcj0o2A7ng: raises $1 to $1.50
IBNygaT1aa9Z1uPdJJilwA: folds
6wzJiRvp8HY6t+MQGnSIzA: calls $1
*** FLOP *** [5c Th 8s]
qfeUHOJpMYyzQcj0o2A7ng: bets $1.50
6wzJiRvp8HY6t+MQGnSIzA: calls $1.50
*** TURN *** [5c Th 8s] [Tc]
qfeUHOJpMYyzQcj0o2A7ng: bets $2
6wzJiRvp8HY6t+MQGnSIzA: calls $2
*** RIVER *** [5c Th 8s Tc] [Ks]
qfeUHOJpMYyzQcj0o2A7ng: bets $3
6wzJiRvp8HY6t+MQGnSIzA: folds
qfeUHOJpMYyzQcj0o2A7ng collected $10 from pot
*** SUMMARY ***
Total pot $10.50 | Rake $0.50
Board [5c Th 8s Tc Ks]
Seat 1: GxXV09ciXaOxyY2H5aMIIw folded before Flop (didn't bet)
Seat 2: oU2kDCkT/gilYbHWrg7D8w folded before Flop (didn't bet)
Seat 3: 6wzJiRvp8HY6t+MQGnSIzA (button) folded on the River
Seat 4: qfeUHOJpMYyzQcj0o2A7ng (small blind) collected ($10)
Seat 5: IBNygaT1aa9Z1uPdJJilwA (big blind) folded before Flop
Seat 6: b2symlOdL7+0c9Pj4N/KlA folded before Flop (didn't bet)



PokerStars Game #59940075652:  Hold'em No Limit ($0.25/$0.50) - 2009/07/01 0:56:36 ET
Table 'EiNh8p/wGJ1FP575iMFnqg' 9-max Seat #4 is the button
Seat 1: r3ZqM1Mi0W3y4hOdssE+Sg ($44.85 in chips)
Seat 2: 8ehL7qlZzjgUh2H35iiWLw ($52.60 in chips)
Seat 3: ymLPoEIl7UL3TvZYmnadxQ ($51.80 in chips)
Seat 4: cMzaiXAM/ZAdNaEUu+LqhA ($54.95 in chips)
Seat 5: M+7+BTmX5vZatHVuoRB1nA ($81.70 in chips)
Seat 6: 3UmXLy3GfjC3EkOebduerQ ($65.35 in chips)
Seat 7: 997ViqAtWn1FPjJqcffwcA ($50 in chips)
Seat 8: mSD1pginDsyHG5PDfqzphw ($10 in chips)
Seat 9: NnQCepdIR/AOUQn1yhYx6Q ($10.75 in chips)
M+7+BTmX5vZatHVuoRB1nA: posts small blind $0.25
3UmXLy3GfjC3EkOebduerQ: posts big blind $0.50
*** HOLE CARDS ***
997ViqAtWn1FPjJqcffwcA: folds
mSD1pginDsyHG5PDfqzphw: folds
NnQCepdIR/AOUQn1yhYx6Q: folds
r3ZqM1Mi0W3y4hOdssE+Sg: folds
8ehL7qlZzjgUh2H35iiWLw: folds
ymLPoEIl7UL3TvZYmnadxQ: folds
cMzaiXAM/ZAdNaEUu+LqhA: raises $1.50 to $2
M+7+BTmX5vZatHVuoRB1nA: folds
3UmXLy3GfjC3EkOebduerQ: folds
cMzaiXAM/ZAdNaEUu+LqhA collected $1.25 from pot
cMzaiXAM/ZAdNaEUu+LqhA: doesn't show hand
*** SUMMARY ***
Total pot $1.25 | Rake $0
Seat 1: r3ZqM1Mi0W3y4hOdssE+Sg folded before Flop (didn't bet)
Seat 2: 8ehL7qlZzjgUh2H35iiWLw folded before Flop (didn't bet)
Seat 3: ymLPoEIl7UL3TvZYmnadxQ folded before Flop (didn't bet)
Seat 4: cMzaiXAM/ZAdNaEUu+LqhA (button) collected ($1.25)
Seat 5: M+7+BTmX5vZatHVuoRB1nA (small blind) folded before Flop
Seat 6: 3UmXLy3GfjC3EkOebduerQ (big blind) folded before Flop
Seat 7: 997ViqAtWn1FPjJqcffwcA folded before Flop (didn't bet)
Seat 8: mSD1pginDsyHG5PDfqzphw folded before Flop (didn't bet)
Seat 9: NnQCepdIR/AOUQn1yhYx6Q folded before Flop (didn't bet)



PokerStars Game #59940075800:  Hold'em No Limit ($0.25/$0.50) - 2009/07/01 0:56:37 ET
Table 'MJxeZCzYELxiIsyUZyT0jw' 6-max Seat #2 is the button
Seat 1: +Pf9jTVizYlIo+woPvptfA ($50 in chips)
Seat 2: t3GiVMzqA9Svgr5Uol32cQ ($35.10 in chips)
Seat 3: JQZew0FjzS19kTjeNtrE+A ($63.40 in chips)
Seat 4: alGiiQP/wwtYnfuXII+sgw ($48.60 in chips)
Seat 5: 3jvoOXNtXE90w2BdfNZwZQ ($50 in chips)
JQZew0FjzS19kTjeNtrE+A: posts small blind $0.25
alGiiQP/wwtYnfuXII+sgw: posts big blind $0.50
*** HOLE CARDS ***
3jvoOXNtXE90w2BdfNZwZQ: folds
+Pf9jTVizYlIo+woPvptfA: folds
t3GiVMzqA9Svgr5Uol32cQ: folds
JQZew0FjzS19kTjeNtrE+A: raises $1.50 to $2
alGiiQP/wwtYnfuXII+sgw: folds
JQZew0FjzS19kTjeNtrE+A collected $1 from pot
*** SUMMARY ***
Total pot $1 | Rake $0
Seat 1: +Pf9jTVizYlIo+woPvptfA folded before Flop (didn't bet)
Seat 2: t3GiVMzqA9Svgr5Uol32cQ (button) folded before Flop (didn't bet)
Seat 3: JQZew0FjzS19kTjeNtrE+A (small blind) collected ($1)
Seat 4: alGiiQP/wwtYnfuXII+sgw (big blind) folded before Flop
Seat 5: 3jvoOXNtXE90w2BdfNZwZQ folded before Flop (didn't bet)



PokerStars Game #59940075838:  Hold'em No Limit ($0.25/$0.50) - 2009/07/01 0:56:37 ET
Table '0eJtgVAXVvBgncFdcUpXcQ' 2-max Seat #2 is the button
Seat 1: Ag6DvxX4vbRheqsv2zXKTQ ($38.05 in chips)
Seat 2: KMc4R+K9ao4Ur3rF7NGe6Q ($12.55 in chips)
KMc4R+K9ao4Ur3rF7NGe6Q: posts small blind $0.25
Ag6DvxX4vbRheqsv2zXKTQ: posts big blind $0.50
*** HOLE CARDS ***
KMc4R+K9ao4Ur3rF7NGe6Q: folds
Ag6DvxX4vbRheqsv2zXKTQ collected $0.50 from pot
*** SUMMARY ***
Total pot $0.50 | Rake $0
Seat 1: Ag6DvxX4vbRheqsv2zXKTQ (big blind) collected ($0.50)
Seat 2: KMc4R+K9ao4Ur3rF7NGe6Q (button) (small blind) folded before Flop



PokerStars Game #59940075926:  Hold'em No Limit ($0.25/$0.50) - 2009/07/01 0:56:37 ET
Table 'E7bWJ45aoFXRpyRv2gw+Ig' 2-max Seat #1 is the button
Seat 1: FRkiRasEGlHUeLrEl+k/nA ($66.25 in chips)
Seat 2: 3Wro85I7472vJ4Wkpneo9A ($125.15 in chips)
FRkiRasEGlHUeLrEl+k/nA: posts small blind $0.25
3Wro85I7472vJ4Wkpneo9A: posts big blind $0.50
*** HOLE CARDS ***
FRkiRasEGlHUeLrEl+k/nA: folds
3Wro85I7472vJ4Wkpneo9A collected $0.50 from pot
3Wro85I7472vJ4Wkpneo9A: doesn't show hand
*** SUMMARY ***
Total pot $0.50 | Rake $0
Seat 1: FRkiRasEGlHUeLrEl+k/nA (button) (small blind) folded before Flop
Seat 2: 3Wro85I7472vJ4Wkpneo9A (big blind) collected ($0.50)



PokerStars Game #59940076220:  Hold'em No Limit ($0.25/$0.50) - 2009/07/01 0:56:37 ET
Table 'lpxYasB1ClBSgTpCCITwhQ' 9-max Seat #6 is the button
Seat 1: mj7PS7wCH4PAl7+eYTFs7A ($46.40 in chips)
Seat 2: OWP/DOu+PlPK6ZZ3zYa0HA ($21.60 in chips)
Seat 4: NnQCepdIR/AOUQn1yhYx6Q ($9.25 in chips)
Seat 5: IYd5zG8k7vdBNVHbHg2Pag ($36.35 in chips)
Seat 6: SegjDnMxWMujiD57ESNL+g ($12.10 in chips)
Seat 7: bmRtaIYKthN1F+B3JLZ3Jw ($28.65 in chips)
Seat 8: /mfensKw8/iZ1Vrx33S4xg ($13 in chips)
Seat 9: XNMDwbXt/Q4jM99AXnbJDw ($50.50 in chips)
bmRtaIYKthN1F+B3JLZ3Jw: posts small blind $0.25
/mfensKw8/iZ1Vrx33S4xg: posts big blind $0.50
caleb505: sits out
*** HOLE CARDS ***
XNMDwbXt/Q4jM99AXnbJDw: raises $1.50 to $2
mj7PS7wCH4PAl7+eYTFs7A: folds
OWP/DOu+PlPK6ZZ3zYa0HA: folds
NnQCepdIR/AOUQn1yhYx6Q: folds
IYd5zG8k7vdBNVHbHg2Pag: folds
SegjDnMxWMujiD57ESNL+g: folds
bmRtaIYKthN1F+B3JLZ3Jw: raises $3 to $5
/mfensKw8/iZ1Vrx33S4xg: calls $4.50
XNMDwbXt/Q4jM99AXnbJDw: calls $3
*** FLOP *** [4d 6h 6c]
bmRtaIYKthN1F+B3JLZ3Jw: checks
/mfensKw8/iZ1Vrx33S4xg: bets $5
XNMDwbXt/Q4jM99AXnbJDw: raises $5 to $10
bmRtaIYKthN1F+B3JLZ3Jw: raises $13.65 to $23.65 and is all-in
/mfensKw8/iZ1Vrx33S4xg: calls $3 and is all-in
XNMDwbXt/Q4jM99AXnbJDw: calls $13.65
*** TURN *** [4d 6h 6c] [Td]
*** RIVER *** [4d 6h 6c Td] [2c]
*** SHOW DOWN ***
bmRtaIYKthN1F+B3JLZ3Jw: shows [Ac As] (two pair, Aces and Sixes)
XNMDwbXt/Q4jM99AXnbJDw: mucks hand
bmRtaIYKthN1F+B3JLZ3Jw collected $30.20 from side pot
/mfensKw8/iZ1Vrx33S4xg: mucks hand
bmRtaIYKthN1F+B3JLZ3Jw collected $37.10 from main pot
*** SUMMARY ***
Total pot $70.30 Main pot $37.10. Side pot $30.20. | Rake $3
Board [4d 6h 6c Td 2c]
Seat 1: mj7PS7wCH4PAl7+eYTFs7A folded before Flop (didn't bet)
Seat 2: OWP/DOu+PlPK6ZZ3zYa0HA folded before Flop (didn't bet)
Seat 4: NnQCepdIR/AOUQn1yhYx6Q folded before Flop (didn't bet)
Seat 5: IYd5zG8k7vdBNVHbHg2Pag folded before Flop (didn't bet)
Seat 6: SegjDnMxWMujiD57ESNL+g (button) folded before Flop (didn't bet)
Seat 7: bmRtaIYKthN1F+B3JLZ3Jw (small blind) showed [Ac As] and won ($67.30) with two pair, Aces and Sixes
Seat 8: /mfensKw8/iZ1Vrx33S4xg (big blind) mucked
Seat 9: XNMDwbXt/Q4jM99AXnbJDw mucked



PokerStars Game #59940076518:  Hold'em No Limit ($0.25/$0.50) - 2009/07/01 0:56:38 ET
Table 'Vdlc9wqYcHTUhtdyN7CuJw' 2-max Seat #2 is the button
Seat 1: yBO+mXB6m/rCft2ErwGf/Q ($116.80 in chips)
Seat 2: NZ/5cxwnorKW2SNsWy1+8A ($7.90 in chips)
NZ/5cxwnorKW2SNsWy1+8A: posts small blind $0.25
yBO+mXB6m/rCft2ErwGf/Q: posts big blind $0.50
*** HOLE CARDS ***
NZ/5cxwnorKW2SNsWy1+8A: calls $0.25
yBO+mXB6m/rCft2ErwGf/Q: checks
*** FLOP *** [Jc 8d 3h]
yBO+mXB6m/rCft2ErwGf/Q: checks
NZ/5cxwnorKW2SNsWy1+8A: checks
*** TURN *** [Jc 8d 3h] [4c]
yBO+mXB6m/rCft2ErwGf/Q: checks
NZ/5cxwnorKW2SNsWy1+8A: checks
*** RIVER *** [Jc 8d 3h 4c] [6s]
yBO+mXB6m/rCft2ErwGf/Q: bets $0.50
NZ/5cxwnorKW2SNsWy1+8A: folds
yBO+mXB6m/rCft2ErwGf/Q collected $0.95 from pot
*** SUMMARY ***
Total pot $1 | Rake $0.05
Board [Jc 8d 3h 4c 6s]
Seat 1: yBO+mXB6m/rCft2ErwGf/Q (big blind) collected ($0.95)
Seat 2: NZ/5cxwnorKW2SNsWy1+8A (button) (small blind) folded on the River



PokerStars Game #59940077678:  Hold'em No Limit ($0.25/$0.50) - 2009/07/01 0:56:40 ET
Table '9Puy2HWN1RQe5SSjq162gA' 2-max Seat #2 is the button
Seat 1: Fp/oksNpipCrD2MJ2pH20g ($7.15 in chips)
Seat 2: tDV+zhxH9+3DkJDzoTERyg ($22.60 in chips)
tDV+zhxH9+3DkJDzoTERyg: posts small blind $0.25
Fp/oksNpipCrD2MJ2pH20g: posts big blind $0.50
*** HOLE CARDS ***
tDV+zhxH9+3DkJDzoTERyg: calls $0.25
Fp/oksNpipCrD2MJ2pH20g: raises $0.50 to $1
tDV+zhxH9+3DkJDzoTERyg: calls $0.50
*** FLOP *** [7d Ac As]
Fp/oksNpipCrD2MJ2pH20g: bets $1
tDV+zhxH9+3DkJDzoTERyg: folds
Fp/oksNpipCrD2MJ2pH20g collected $1.90 from pot
Fp/oksNpipCrD2MJ2pH20g: doesn't show hand
*** SUMMARY ***
Total pot $2 | Rake $0.10
Board [7d Ac As]
Seat 1: Fp/oksNpipCrD2MJ2pH20g (big blind) collected ($1.90)
Seat 2: tDV+zhxH9+3DkJDzoTERyg (button) (small blind) folded on the Flop



PokerStars Game #59940079412:  Hold'em No Limit ($0.25/$0.50) - 2009/07/01 0:56:42 ET
Table '0eJtgVAXVvBgncFdcUpXcQ' 2-max Seat #1 is the button
Seat 1: Ag6DvxX4vbRheqsv2zXKTQ ($38.30 in chips)
Seat 2: KMc4R+K9ao4Ur3rF7NGe6Q ($12.30 in chips)
Ag6DvxX4vbRheqsv2zXKTQ: posts small blind $0.25
KMc4R+K9ao4Ur3rF7NGe6Q: posts big blind $0.50
*** HOLE CARDS ***
Ag6DvxX4vbRheqsv2zXKTQ: calls $0.25
KMc4R+K9ao4Ur3rF7NGe6Q: raises $1 to $1.50
Ag6DvxX4vbRheqsv2zXKTQ: calls $1
*** FLOP *** [Ad Jd 7h]
KMc4R+K9ao4Ur3rF7NGe6Q: bets $1
Ag6DvxX4vbRheqsv2zXKTQ: calls $1
*** TURN *** [Ad Jd 7h] [3h]
KMc4R+K9ao4Ur3rF7NGe6Q: bets $1
Ag6DvxX4vbRheqsv2zXKTQ: calls $1
*** RIVER *** [Ad Jd 7h 3h] [2s]
KMc4R+K9ao4Ur3rF7NGe6Q: checks
Ag6DvxX4vbRheqsv2zXKTQ: checks
*** SHOW DOWN ***
KMc4R+K9ao4Ur3rF7NGe6Q: shows [Jh Qc] (a pair of Jacks)
Ag6DvxX4vbRheqsv2zXKTQ: shows [Jc Ts] (a pair of Jacks - lower kicker)
KMc4R+K9ao4Ur3rF7NGe6Q collected $6.70 from pot
*** SUMMARY ***
Total pot $7 | Rake $0.30
Board [Ad Jd 7h 3h 2s]
Seat 1: Ag6DvxX4vbRheqsv2zXKTQ (button) (small blind) showed [Jc Ts] and lost with a pair of Jacks
Seat 2: KMc4R+K9ao4Ur3rF7NGe6Q (big blind) showed [Jh Qc] and won ($6.70) with a pair of Jacks



PokerStars Game #59940079108:  Hold'em No Limit ($0.25/$0.50) - 2009/07/01 0:56:42 ET
Table 'c/CRn+68J3Y8KxD5g1ek2Q' 2-max Seat #2 is the button
Seat 1: 46qCyJ6evTkHo9al5sBMNA ($87.05 in chips)
Seat 2: BypVLsYQt3ePFm2xQL/dOA ($282.50 in chips)
BypVLsYQt3ePFm2xQL/dOA: posts small blind $0.25
46qCyJ6evTkHo9al5sBMNA: posts big blind $0.50
*** HOLE CARDS ***
BypVLsYQt3ePFm2xQL/dOA: calls $0.25
46qCyJ6evTkHo9al5sBMNA: checks
*** FLOP *** [Qs 3c 2h]
46qCyJ6evTkHo9al5sBMNA: checks
BypVLsYQt3ePFm2xQL/dOA: checks
*** TURN *** [Qs 3c 2h] [Jd]
46qCyJ6evTkHo9al5sBMNA: checks
BypVLsYQt3ePFm2xQL/dOA: bets $1.50
46qCyJ6evTkHo9al5sBMNA: calls $1.50
*** RIVER *** [Qs 3c 2h Jd] [8h]
46qCyJ6evTkHo9al5sBMNA: checks
BypVLsYQt3ePFm2xQL/dOA: checks
*** SHOW DOWN ***
46qCyJ6evTkHo9al5sBMNA: shows [3d 5h] (a pair of Threes)
BypVLsYQt3ePFm2xQL/dOA: mucks hand
46qCyJ6evTkHo9al5sBMNA collected $3.85 from pot
*** SUMMARY ***
Total pot $4 | Rake $0.15
Board [Qs 3c 2h Jd 8h]
Seat 1: 46qCyJ6evTkHo9al5sBMNA (big blind) showed [3d 5h] and won ($3.85) with a pair of Threes
Seat 2: BypVLsYQt3ePFm2xQL/dOA (button) (small blind) mucked



PokerStars Game #59940079632:  Hold'em No Limit ($0.25/$0.50) - 2009/07/01 0:56:43 ET
Table 'otvGDROEDdqsabxskT79qg' 9-max Seat #6 is the button
Seat 1: 8ehL7qlZzjgUh2H35iiWLw ($57.50 in chips)
Seat 2: cCjTzH9jio8607WzjcfXlg ($14.30 in chips)
Seat 3: +k7T5ocke8UwavtgUHm+Cg ($66.50 in chips)
Seat 4: MG90wfSJZnOejs/KD3vlQQ ($73.20 in chips)
Seat 5: XNMDwbXt/Q4jM99AXnbJDw ($51.15 in chips)
Seat 6: bxLSulbgr8LmKNjOzw8URg ($52.95 in chips)
Seat 7: C7+tBppJrKgd/r+tuKUIpA ($32.30 in chips)
Seat 8: zE9cVigS2nW/Ljy4K4bUQA ($30 in chips)
Seat 9: KcY3X8YpD74Kw1RHkx/g4A ($57.90 in chips)
C7+tBppJrKgd/r+tuKUIpA: posts small blind $0.25
zE9cVigS2nW/Ljy4K4bUQA: posts big blind $0.50
*** HOLE CARDS ***
KcY3X8YpD74Kw1RHkx/g4A: folds
8ehL7qlZzjgUh2H35iiWLw: folds
cCjTzH9jio8607WzjcfXlg: folds
+k7T5ocke8UwavtgUHm+Cg: folds
MG90wfSJZnOejs/KD3vlQQ: folds
XNMDwbXt/Q4jM99AXnbJDw: folds
bxLSulbgr8LmKNjOzw8URg: raises $1 to $1.50
C7+tBppJrKgd/r+tuKUIpA: folds
zE9cVigS2nW/Ljy4K4bUQA: folds
bxLSulbgr8LmKNjOzw8URg collected $1.25 from pot
bxLSulbgr8LmKNjOzw8URg: doesn't show hand
*** SUMMARY ***
Total pot $1.25 | Rake $0
Seat 1: 8ehL7qlZzjgUh2H35iiWLw folded before Flop (didn't bet)
Seat 2: cCjTzH9jio8607WzjcfXlg folded before Flop (didn't bet)
Seat 3: +k7T5ocke8UwavtgUHm+Cg folded before Flop (didn't bet)
Seat 4: MG90wfSJZnOejs/KD3vlQQ folded before Flop (didn't bet)
Seat 5: XNMDwbXt/Q4jM99AXnbJDw folded before Flop (didn't bet)
Seat 6: bxLSulbgr8LmKNjOzw8URg (button) collected ($1.25)
Seat 7: C7+tBppJrKgd/r+tuKUIpA (small blind) folded before Flop
Seat 8: zE9cVigS2nW/Ljy4K4bUQA (big blind) folded before Flop
Seat 9: KcY3X8YpD74Kw1RHkx/g4A folded before Flop (didn't bet)



PokerStars Game #59940080210:  Hold'em No Limit ($0.25/$0.50) - 2009/07/01 0:56:44 ET
Table 'E7bWJ45aoFXRpyRv2gw+Ig' 2-max Seat #2 is the button
Seat 1: FRkiRasEGlHUeLrEl+k/nA ($66 in chips)
Seat 2: 3Wro85I7472vJ4Wkpneo9A ($125.40 in chips)
3Wro85I7472vJ4Wkpneo9A: posts small blind $0.25
FRkiRasEGlHUeLrEl+k/nA: posts big blind $0.50
*** HOLE CARDS ***
3Wro85I7472vJ4Wkpneo9A: raises $1 to $1.50
FRkiRasEGlHUeLrEl+k/nA: folds
3Wro85I7472vJ4Wkpneo9A collected $1 from pot
3Wro85I7472vJ4Wkpneo9A: doesn't show hand
*** SUMMARY ***
Total pot $1 | Rake $0
Seat 1: FRkiRasEGlHUeLrEl+k/nA (big blind) folded before Flop
Seat 2: 3Wro85I7472vJ4Wkpneo9A (button) (small blind) collected ($1)



PokerStars Game #59940081030:  Hold'em No Limit ($0.25/$0.50) - 2009/07/01 0:56:45 ET
Table '8BQGgNetI1NOvWeu3gtMNw' 2-max Seat #2 is the button
Seat 1: bypIyrYcAAifLfhZpGlKLA ($50 in chips)
Seat 2: Z4HwehErEwzsv/noQlfUlg ($142.05 in chips)
Z4HwehErEwzsv/noQlfUlg: posts small blind $0.25
bypIyrYcAAifLfhZpGlKLA: posts big blind $0.50
*** HOLE CARDS ***
Z4HwehErEwzsv/noQlfUlg: raises $0.50 to $1
bypIyrYcAAifLfhZpGlKLA: calls $0.50
*** FLOP *** [Ac Tc 9c]
bypIyrYcAAifLfhZpGlKLA: checks
Z4HwehErEwzsv/noQlfUlg: checks
*** TURN *** [Ac Tc 9c] [7s]
bypIyrYcAAifLfhZpGlKLA: bets $1.50
Z4HwehErEwzsv/noQlfUlg: calls $1.50
*** RIVER *** [Ac Tc 9c 7s] [8s]
bypIyrYcAAifLfhZpGlKLA: checks
Z4HwehErEwzsv/noQlfUlg: checks
*** SHOW DOWN ***
bypIyrYcAAifLfhZpGlKLA: shows [2c 3h] (high card Ace)
Z4HwehErEwzsv/noQlfUlg: shows [7c Ks] (a pair of Sevens)
Z4HwehErEwzsv/noQlfUlg collected $4.80 from pot
*** SUMMARY ***
Total pot $5 | Rake $0.20
Board [Ac Tc 9c 7s 8s]
Seat 1: bypIyrYcAAifLfhZpGlKLA (big blind) showed [2c 3h] and lost with high card Ace
Seat 2: Z4HwehErEwzsv/noQlfUlg (button) (small blind) showed [7c Ks] and won ($4.80) with a pair of Sevens



PokerStars Game #59940081108:  Hold'em No Limit ($0.25/$0.50) - 2009/07/01 0:56:45 ET
Table 'lSisgp6H7Fg1hH5VfjEjYQ' 9-max Seat #1 is the button
Seat 1: 5k9fvXD9suIgCxU4HLQjTw ($50 in chips)
Seat 2: UrcnkQOiLVk8BlKDPJSy7Q ($75.60 in chips)
Seat 3: aTkyjTh3w5YLWiIERupZOA ($51.95 in chips)
Seat 4: bwv/rbH/hHhPhY6u9mu04w ($32.10 in chips)
Seat 5: mSD1pginDsyHG5PDfqzphw ($12.60 in chips)
Seat 6: +k7T5ocke8UwavtgUHm+Cg ($54.95 in chips)
Seat 7: IDtNLR9uFCDdjNsJWMHA5Q ($19.85 in chips)
Seat 8: a4JDWmpFQkL10XfAyuF51A ($29 in chips)
Seat 9: gsyXT42WLEcOS4DdEk2wlw ($42.05 in chips)
UrcnkQOiLVk8BlKDPJSy7Q: posts small blind $0.25
aTkyjTh3w5YLWiIERupZOA: posts big blind $0.50
*** HOLE CARDS ***
bwv/rbH/hHhPhY6u9mu04w: calls $0.50
mSD1pginDsyHG5PDfqzphw: folds
+k7T5ocke8UwavtgUHm+Cg: folds
IDtNLR9uFCDdjNsJWMHA5Q: folds
a4JDWmpFQkL10XfAyuF51A: folds
gsyXT42WLEcOS4DdEk2wlw: folds
5k9fvXD9suIgCxU4HLQjTw: folds
UrcnkQOiLVk8BlKDPJSy7Q: raises $2 to $2.50
aTkyjTh3w5YLWiIERupZOA: folds
bwv/rbH/hHhPhY6u9mu04w: folds
UrcnkQOiLVk8BlKDPJSy7Q collected $1.50 from pot
UrcnkQOiLVk8BlKDPJSy7Q: doesn't show hand
*** SUMMARY ***
Total pot $1.50 | Rake $0
Seat 1: 5k9fvXD9suIgCxU4HLQjTw (button) folded before Flop (didn't bet)
Seat 2: UrcnkQOiLVk8BlKDPJSy7Q (small blind) collected ($1.50)
Seat 3: aTkyjTh3w5YLWiIERupZOA (big blind) folded before Flop
Seat 4: bwv/rbH/hHhPhY6u9mu04w folded before Flop
Seat 5: mSD1pginDsyHG5PDfqzphw folded before Flop (didn't bet)
Seat 6: +k7T5ocke8UwavtgUHm+Cg folded before Flop (didn't bet)
Seat 7: IDtNLR9uFCDdjNsJWMHA5Q folded before Flop (didn't bet)
Seat 8: a4JDWmpFQkL10XfAyuF51A folded before Flop (didn't bet)
Seat 9: gsyXT42WLEcOS4DdEk2wlw folded before Flop (didn't bet)



PokerStars Game #59940082452:  Hold'em No Limit ($0.25/$0.50) - 2009/07/01 0:56:47 ET
Table 'QOgaEqMcJ73pcUMMxoisUg' 6-max Seat #3 is the button
Seat 2: 4QfsCWthT/vSLirorNXqtg ($76.35 in chips)
Seat 3: Rt6KgtZ8YaJoTc3FPim00w ($88.05 in chips)
Seat 4: zAcsDhG/T128Vn7XGVSgKg ($50 in chips)
Seat 5: 6vNxrjjCl6FwfaaymM9jjg ($31.75 in chips)
Seat 6: GoVjFxr3C+JO9vtJH9+IcA ($25.90 in chips)
zAcsDhG/T128Vn7XGVSgKg: posts small blind $0.25
6vNxrjjCl6FwfaaymM9jjg: posts big blind $0.50
*** HOLE CARDS ***
GoVjFxr3C+JO9vtJH9+IcA: calls $0.50
4QfsCWthT/vSLirorNXqtg: folds
/olYG0EzMWzADIgH1y2ySQ leaves the table
Rt6KgtZ8YaJoTc3FPim00w: raises $1.50 to $2
zAcsDhG/T128Vn7XGVSgKg: folds
6vNxrjjCl6FwfaaymM9jjg: calls $1.50
GoVjFxr3C+JO9vtJH9+IcA: calls $1.50
*** FLOP *** [As 8s 5d]
6vNxrjjCl6FwfaaymM9jjg: checks
GoVjFxr3C+JO9vtJH9+IcA: checks
Rt6KgtZ8YaJoTc3FPim00w: checks
*** TURN *** [As 8s 5d] [Jc]
6vNxrjjCl6FwfaaymM9jjg: checks
GoVjFxr3C+JO9vtJH9+IcA: bets $3
jpritz22 joins the table at seat #1
Rt6KgtZ8YaJoTc3FPim00w: folds
6vNxrjjCl6FwfaaymM9jjg: calls $3
*** RIVER *** [As 8s 5d Jc] [5s]
6vNxrjjCl6FwfaaymM9jjg: checks
GoVjFxr3C+JO9vtJH9+IcA: checks
*** SHOW DOWN ***
6vNxrjjCl6FwfaaymM9jjg: shows [Ah 3s] (two pair, Aces and Fives)
GoVjFxr3C+JO9vtJH9+IcA: shows [Ac Jh] (two pair, Aces and Jacks)
GoVjFxr3C+JO9vtJH9+IcA collected $11.70 from pot
*** SUMMARY ***
Total pot $12.25 | Rake $0.55
Board [As 8s 5d Jc 5s]
Seat 2: 4QfsCWthT/vSLirorNXqtg folded before Flop (didn't bet)
Seat 3: Rt6KgtZ8YaJoTc3FPim00w (button) folded on the Turn
Seat 4: zAcsDhG/T128Vn7XGVSgKg (small blind) folded before Flop
Seat 5: 6vNxrjjCl6FwfaaymM9jjg (big blind) showed [Ah 3s] and lost with two pair, Aces and Fives
Seat 6: GoVjFxr3C+JO9vtJH9+IcA showed [Ac Jh] and won ($11.70) with two pair, Aces and Jacks



PokerStars Game #59940082848:  Hold'em No Limit ($0.25/$0.50) - 2009/07/01 0:56:48 ET
Table 'Nz0Vr7WMHL2g5Uk7dDZjpw' 9-max Seat #2 is the button
Seat 1: tLkxo7JgV+WWI0UBw44K5A ($109.10 in chips)
Seat 2: XNMDwbXt/Q4jM99AXnbJDw ($57.85 in chips)
Seat 3: uw9QayAAxLM3Hb+HR7mSkg ($10.25 in chips)
Seat 4: E2518gp4aFz1+kAgmGqeEg ($11 in chips)
Seat 5: WGW0DgjBUXs1ylURHG8vnQ ($27.50 in chips)
Seat 6: 997ViqAtWn1FPjJqcffwcA ($61.30 in chips)
Seat 7: KPLH0gELgFe2OuAnhJFI5w ($17.85 in chips)
Seat 8: HkZI6g4zl83TDTA7SRspmQ ($16.45 in chips)
Seat 9: mSD1pginDsyHG5PDfqzphw ($10 in chips)
uw9QayAAxLM3Hb+HR7mSkg: posts small blind $0.25
E2518gp4aFz1+kAgmGqeEg: posts big blind $0.50
*** HOLE CARDS ***
WGW0DgjBUXs1ylURHG8vnQ: folds
997ViqAtWn1FPjJqcffwcA: folds
KPLH0gELgFe2OuAnhJFI5w: folds
HkZI6g4zl83TDTA7SRspmQ: folds
mSD1pginDsyHG5PDfqzphw: folds
tLkxo7JgV+WWI0UBw44K5A: folds
XNMDwbXt/Q4jM99AXnbJDw: raises $0.50 to $1
uw9QayAAxLM3Hb+HR7mSkg: folds
E2518gp4aFz1+kAgmGqeEg: folds
XNMDwbXt/Q4jM99AXnbJDw collected $1.25 from pot
XNMDwbXt/Q4jM99AXnbJDw: doesn't show hand
*** SUMMARY ***
Total pot $1.25 | Rake $0
Seat 1: tLkxo7JgV+WWI0UBw44K5A folded before Flop (didn't bet)
Seat 2: XNMDwbXt/Q4jM99AXnbJDw (button) collected ($1.25)
Seat 3: uw9QayAAxLM3Hb+HR7mSkg (small blind) folded before Flop
Seat 4: E2518gp4aFz1+kAgmGqeEg (big blind) folded before Flop
Seat 5: WGW0DgjBUXs1ylURHG8vnQ folded before Flop (didn't bet)
Seat 6: 997ViqAtWn1FPjJqcffwcA folded before Flop (didn't bet)
Seat 7: KPLH0gELgFe2OuAnhJFI5w folded before Flop (didn't bet)
Seat 8: HkZI6g4zl83TDTA7SRspmQ folded before Flop (didn't bet)
Seat 9: mSD1pginDsyHG5PDfqzphw folded before Flop (didn't bet)



PokerStars Game #59940082870:  Hold'em No Limit ($0.25/$0.50) - 2009/07/01 0:56:48 ET
Table '+dXkOAQyS8j9PQZusUTMpg' 2-max Seat #1 is the button
Seat 1: XFa6sBGjP2gxoIvxR3fZIg ($62.35 in chips)
Seat 2: 5IBeOgaApY1Bvzv2P8X4EA ($137.65 in chips)
XFa6sBGjP2gxoIvxR3fZIg: posts small blind $0.25
5IBeOgaApY1Bvzv2P8X4EA: posts big blind $0.50
*** HOLE CARDS ***
XFa6sBGjP2gxoIvxR3fZIg: raises $1 to $1.50
5IBeOgaApY1Bvzv2P8X4EA: folds
XFa6sBGjP2gxoIvxR3fZIg collected $1 from pot
*** SUMMARY ***
Total pot $1 | Rake $0
Seat 1: XFa6sBGjP2gxoIvxR3fZIg (button) (small blind) collected ($1)
Seat 2: 5IBeOgaApY1Bvzv2P8X4EA (big blind) folded before Flop



PokerStars Game #59940083510:  Hold'em No Limit ($0.25/$0.50) - 2009/07/01 0:56:49 ET
Table '37qXEp3oe+er5q4CZip9eQ' 6-max Seat #2 is the button
Seat 1: oqOqoO2AyCZenUghCxMDxw ($53.40 in chips)
Seat 2: LvH4G7n+QSjT6NDaD3cREA ($50 in chips)
Seat 3: Rt6KgtZ8YaJoTc3FPim00w ($104.75 in chips)
Seat 4: XsmE8nXMAAMFJbWaJTmHFw ($37.95 in chips)
Seat 5: VOmI0x4dDPnTESZd5B4d1Q ($45.25 in chips)
Seat 6: N50kln4negd8q7Mmoz1j4g ($17.05 in chips)
Rt6KgtZ8YaJoTc3FPim00w: posts small blind $0.25
XsmE8nXMAAMFJbWaJTmHFw: posts big blind $0.50
*** HOLE CARDS ***
VOmI0x4dDPnTESZd5B4d1Q: calls $0.50
N50kln4negd8q7Mmoz1j4g: calls $0.50
oqOqoO2AyCZenUghCxMDxw: folds
LvH4G7n+QSjT6NDaD3cREA: folds
Rt6KgtZ8YaJoTc3FPim00w: folds
XsmE8nXMAAMFJbWaJTmHFw: checks
*** FLOP *** [5c Jd Tc]
XsmE8nXMAAMFJbWaJTmHFw: checks
VOmI0x4dDPnTESZd5B4d1Q: bets $2
N50kln4negd8q7Mmoz1j4g: folds
XsmE8nXMAAMFJbWaJTmHFw: folds
VOmI0x4dDPnTESZd5B4d1Q collected $1.70 from pot
*** SUMMARY ***
Total pot $1.75 | Rake $0.05
Board [5c Jd Tc]
Seat 1: oqOqoO2AyCZenUghCxMDxw folded before Flop (didn't bet)
Seat 2: LvH4G7n+QSjT6NDaD3cREA (button) folded before Flop (didn't bet)
Seat 3: Rt6KgtZ8YaJoTc3FPim00w (small blind) folded before Flop
Seat 4: XsmE8nXMAAMFJbWaJTmHFw (big blind) folded on the Flop
Seat 5: VOmI0x4dDPnTESZd5B4d1Q collected ($1.70)
Seat 6: N50kln4negd8q7Mmoz1j4g folded on the Flop



PokerStars Game #59940083898:  Hold'em No Limit ($0.25/$0.50) - 2009/07/01 0:56:50 ET
Table '5EmHi+fnatGQQShcNmzOZQ' 6-max Seat #1 is the button
Seat 1: My8WkRtGx5FW6rJ1I4R3hg ($12.10 in chips)
Seat 3: TjmTe3bhs9dFz5gXX9x7Lw ($19.50 in chips)
Seat 4: 1b+2BbjMN8qhR1WPqdE9VQ ($69.30 in chips)
Seat 5: kxPhs4ePFqMy52CInAJ2aw ($80.55 in chips)
Seat 6: 686aeHikcJlgKkSuIFdcXQ ($131.75 in chips)
wlynch82 will be allowed to play after the button
TjmTe3bhs9dFz5gXX9x7Lw: posts small blind $0.25
1b+2BbjMN8qhR1WPqdE9VQ: posts big blind $0.50
*** HOLE CARDS ***
kxPhs4ePFqMy52CInAJ2aw: folds
686aeHikcJlgKkSuIFdcXQ: folds
My8WkRtGx5FW6rJ1I4R3hg: folds
TjmTe3bhs9dFz5gXX9x7Lw: calls $0.25
1b+2BbjMN8qhR1WPqdE9VQ: checks
*** FLOP *** [4d Jd Qc]
TjmTe3bhs9dFz5gXX9x7Lw: checks
1b+2BbjMN8qhR1WPqdE9VQ: bets $0.70
TjmTe3bhs9dFz5gXX9x7Lw: raises $0.70 to $1.40
1b+2BbjMN8qhR1WPqdE9VQ: calls $0.70
*** TURN *** [4d Jd Qc] [2s]
TjmTe3bhs9dFz5gXX9x7Lw: bets $2
1b+2BbjMN8qhR1WPqdE9VQ: raises $4 to $6
TjmTe3bhs9dFz5gXX9x7Lw: calls $4
*** RIVER *** [4d Jd Qc 2s] [7d]
TjmTe3bhs9dFz5gXX9x7Lw: bets $11.60 and is all-in
1b+2BbjMN8qhR1WPqdE9VQ: folds
TjmTe3bhs9dFz5gXX9x7Lw collected $15.05 from pot
TjmTe3bhs9dFz5gXX9x7Lw: doesn't show hand
*** SUMMARY ***
Total pot $15.80 | Rake $0.75
Board [4d Jd Qc 2s 7d]
Seat 1: My8WkRtGx5FW6rJ1I4R3hg (button) folded before Flop (didn't bet)
Seat 3: TjmTe3bhs9dFz5gXX9x7Lw (small blind) collected ($15.05)
Seat 4: 1b+2BbjMN8qhR1WPqdE9VQ (big blind) folded on the River
Seat 5: kxPhs4ePFqMy52CInAJ2aw folded before Flop (didn't bet)
Seat 6: 686aeHikcJlgKkSuIFdcXQ folded before Flop (didn't bet)



PokerStars Game #59940085794:  Hold'em No Limit ($0.25/$0.50) - 2009/07/01 0:56:53 ET
Table 'E7bWJ45aoFXRpyRv2gw+Ig' 2-max Seat #1 is the button
Seat 1: FRkiRasEGlHUeLrEl+k/nA ($65.50 in chips)
Seat 2: 3Wro85I7472vJ4Wkpneo9A ($125.90 in chips)
FRkiRasEGlHUeLrEl+k/nA: posts small blind $0.25
3Wro85I7472vJ4Wkpneo9A: posts big blind $0.50
*** HOLE CARDS ***
FRkiRasEGlHUeLrEl+k/nA: raises $1 to $1.50
3Wro85I7472vJ4Wkpneo9A: folds
FRkiRasEGlHUeLrEl+k/nA collected $1 from pot
*** SUMMARY ***
Total pot $1 | Rake $0
Seat 1: FRkiRasEGlHUeLrEl+k/nA (button) (small blind) collected ($1)
Seat 2: 3Wro85I7472vJ4Wkpneo9A (big blind) folded before Flop



PokerStars Game #59940088060:  Hold'em No Limit ($0.25/$0.50) - 2009/07/01 0:56:56 ET
Table '9Puy2HWN1RQe5SSjq162gA' 2-max Seat #1 is the button
Seat 1: Fp/oksNpipCrD2MJ2pH20g ($8.05 in chips)
Seat 2: tDV+zhxH9+3DkJDzoTERyg ($21.60 in chips)
Fp/oksNpipCrD2MJ2pH20g: posts small blind $0.25
tDV+zhxH9+3DkJDzoTERyg: posts big blind $0.50
*** HOLE CARDS ***
Fp/oksNpipCrD2MJ2pH20g: raises $1 to $1.50
tDV+zhxH9+3DkJDzoTERyg: raises $2.50 to $4
Fp/oksNpipCrD2MJ2pH20g: raises $4.05 to $8.05 and is all-in
tDV+zhxH9+3DkJDzoTERyg: calls $4.05
*** FLOP *** [Tc Ac 4c]
*** TURN *** [Tc Ac 4c] [9d]
*** RIVER *** [Tc Ac 4c 9d] [4d]
*** SHOW DOWN ***
tDV+zhxH9+3DkJDzoTERyg: shows [Qs Qh] (two pair, Queens and Fours)
Fp/oksNpipCrD2MJ2pH20g: shows [Kh As] (two pair, Aces and Fours)
Fp/oksNpipCrD2MJ2pH20g collected $15.60 from pot
*** SUMMARY ***
Total pot $16.10 | Rake $0.50
Board [Tc Ac 4c 9d 4d]
Seat 1: Fp/oksNpipCrD2MJ2pH20g (button) (small blind) showed [Kh As] and won ($15.60) with two pair, Aces and Fours
Seat 2: tDV+zhxH9+3DkJDzoTERyg (big blind) showed [Qs Qh] and lost with two pair, Queens and Fours



PokerStars Game #59940087722:  Hold'em No Limit ($0.25/$0.50) - 2009/07/01 0:56:56 ET
Table '+dXkOAQyS8j9PQZusUTMpg' 2-max Seat #2 is the button
Seat 1: XFa6sBGjP2gxoIvxR3fZIg ($62.85 in chips)
Seat 2: 5IBeOgaApY1Bvzv2P8X4EA ($137.15 in chips)
5IBeOgaApY1Bvzv2P8X4EA: posts small blind $0.25
XFa6sBGjP2gxoIvxR3fZIg: posts big blind $0.50
*** HOLE CARDS ***
5IBeOgaApY1Bvzv2P8X4EA: folds
XFa6sBGjP2gxoIvxR3fZIg collected $0.50 from pot
XFa6sBGjP2gxoIvxR3fZIg: doesn't show hand
*** SUMMARY ***
Total pot $0.50 | Rake $0
Seat 1: XFa6sBGjP2gxoIvxR3fZIg (big blind) collected ($0.50)
Seat 2: 5IBeOgaApY1Bvzv2P8X4EA (button) (small blind) folded before Flop



PokerStars Game #59940088660:  Hold'em No Limit ($0.25/$0.50) - 2009/07/01 0:56:57 ET
Table 'MJxeZCzYELxiIsyUZyT0jw' 6-max Seat #3 is the button
Seat 1: +Pf9jTVizYlIo+woPvptfA ($50 in chips)
Seat 2: t3GiVMzqA9Svgr5Uol32cQ ($35.10 in chips)
Seat 3: JQZew0FjzS19kTjeNtrE+A ($63.90 in chips)
Seat 4: alGiiQP/wwtYnfuXII+sgw ($48.10 in chips)
Seat 5: 3jvoOXNtXE90w2BdfNZwZQ ($50 in chips)
alGiiQP/wwtYnfuXII+sgw: posts small blind $0.25
3jvoOXNtXE90w2BdfNZwZQ: posts big blind $0.50
*** HOLE CARDS ***
+Pf9jTVizYlIo+woPvptfA: folds
t3GiVMzqA9Svgr5Uol32cQ: folds
JQZew0FjzS19kTjeNtrE+A: calls $0.50
alGiiQP/wwtYnfuXII+sgw: folds
3jvoOXNtXE90w2BdfNZwZQ: checks
*** FLOP *** [As 4d Ks]
3jvoOXNtXE90w2BdfNZwZQ: checks
JQZew0FjzS19kTjeNtrE+A: bets $1.50
c0n4hrn20AML9qzyFC2E8Q joins the table at seat #6
3jvoOXNtXE90w2BdfNZwZQ: folds
JQZew0FjzS19kTjeNtrE+A collected $1.20 from pot
*** SUMMARY ***
Total pot $1.25 | Rake $0.05
Board [As 4d Ks]
Seat 1: +Pf9jTVizYlIo+woPvptfA folded before Flop (didn't bet)
Seat 2: t3GiVMzqA9Svgr5Uol32cQ folded before Flop (didn't bet)
Seat 3: JQZew0FjzS19kTjeNtrE+A (button) collected ($1.20)
Seat 4: alGiiQP/wwtYnfuXII+sgw (small blind) folded before Flop
Seat 5: 3jvoOXNtXE90w2BdfNZwZQ (big blind) folded on the Flop



PokerStars Game #59940090094:  Hold'em No Limit ($0.25/$0.50) - 2009/07/01 0:56:59 ET
Table 'kgbJRsxfv64KrErDRBAkcw' 6-max Seat #4 is the button
Seat 1: w2dj3tZyWCX7+wEKRi0AVw ($28.25 in chips)
Seat 2: AdS8BJMOheS01zjCDfPMFg ($49 in chips)
Seat 3: c4MNIaIyPMOMxrgT8FT5nA ($110 in chips)
Seat 4: qanMEqjABjWxC/JgQ/0l7w ($57.25 in chips)
Seat 5: eUBBn2R56C1IQ6Cs/vitwg ($50 in chips)
Seat 6: 1b+2BbjMN8qhR1WPqdE9VQ ($53.40 in chips)
eUBBn2R56C1IQ6Cs/vitwg: posts small blind $0.25
1b+2BbjMN8qhR1WPqdE9VQ: posts big blind $0.50
*** HOLE CARDS ***
w2dj3tZyWCX7+wEKRi0AVw: calls $0.50
AdS8BJMOheS01zjCDfPMFg: folds
c4MNIaIyPMOMxrgT8FT5nA: folds
qanMEqjABjWxC/JgQ/0l7w: folds
eUBBn2R56C1IQ6Cs/vitwg: raises $2 to $2.50
1b+2BbjMN8qhR1WPqdE9VQ: folds
w2dj3tZyWCX7+wEKRi0AVw: raises $3 to $5.50
eUBBn2R56C1IQ6Cs/vitwg: raises $32.50 to $38
w2dj3tZyWCX7+wEKRi0AVw: folds
eUBBn2R56C1IQ6Cs/vitwg collected $11.50 from pot
*** SUMMARY ***
Total pot $11.50 | Rake $0
Seat 1: w2dj3tZyWCX7+wEKRi0AVw folded before Flop
Seat 2: AdS8BJMOheS01zjCDfPMFg folded before Flop (didn't bet)
Seat 3: c4MNIaIyPMOMxrgT8FT5nA folded before Flop (didn't bet)
Seat 4: qanMEqjABjWxC/JgQ/0l7w (button) folded before Flop (didn't bet)
Seat 5: eUBBn2R56C1IQ6Cs/vitwg (small blind) collected ($11.50)
Seat 6: 1b+2BbjMN8qhR1WPqdE9VQ (big blind) folded before Flop



PokerStars Game #59940091056:  Hold'em No Limit ($0.25/$0.50) - 2009/07/01 0:57:01 ET
Table 'GfL/No5u5PoEnU39lP5pQg' 6-max Seat #6 is the button
Seat 1: 1WUCqNG+p+vfWRTXNu4ljw ($50 in chips)
Seat 2: uVwggSetzp7d+eVgowO3vg ($60.30 in chips)
Seat 3: eQXFICMuu3hw6XlcmuVNEA ($10 in chips)
Seat 4: r6u7MWSXF30/khcTYkrG9Q ($33.45 in chips)
Seat 6: kxPhs4ePFqMy52CInAJ2aw ($56.50 in chips)
1WUCqNG+p+vfWRTXNu4ljw: posts small blind $0.25
uVwggSetzp7d+eVgowO3vg: posts big blind $0.50
eQXFICMuu3hw6XlcmuVNEA: posts big blind $0.50
M1KyQQvVPVuxqTAB8sR/zQ: sits out
*** HOLE CARDS ***
eQXFICMuu3hw6XlcmuVNEA: checks
uVwggSetzp7d+eVgowO3vg said, "I'm having a good day today"
r6u7MWSXF30/khcTYkrG9Q said, "guess you just have to choose your risks"
r6u7MWSXF30/khcTYkrG9Q: folds
r6u7MWSXF30/khcTYkrG9Q said, "I think it is a July thing"
r6u7MWSXF30/khcTYkrG9Q said, "that they haven't announced yet"
r6u7MWSXF30/khcTYkrG9Q said, "not sure though"
kxPhs4ePFqMy52CInAJ2aw: folds
1WUCqNG+p+vfWRTXNu4ljw: folds
uVwggSetzp7d+eVgowO3vg: checks
*** FLOP *** [6s 4s 5c]
uVwggSetzp7d+eVgowO3vg: checks
eQXFICMuu3hw6XlcmuVNEA: checks
*** TURN *** [6s 4s 5c] [6d]
uVwggSetzp7d+eVgowO3vg: checks
r6u7MWSXF30/khcTYkrG9Q said, "talking about the 5vpp thing"
eQXFICMuu3hw6XlcmuVNEA: checks
*** RIVER *** [6s 4s 5c 6d] [Tc]
uVwggSetzp7d+eVgowO3vg: checks
eQXFICMuu3hw6XlcmuVNEA: checks
*** SHOW DOWN ***
uVwggSetzp7d+eVgowO3vg: shows [Kc 5s] (two pair, Sixes and Fives)
eQXFICMuu3hw6XlcmuVNEA: mucks hand
uVwggSetzp7d+eVgowO3vg collected $1.20 from pot
*** SUMMARY ***
Total pot $1.25 | Rake $0.05
Board [6s 4s 5c 6d Tc]
Seat 1: 1WUCqNG+p+vfWRTXNu4ljw (small blind) folded before Flop
Seat 2: uVwggSetzp7d+eVgowO3vg (big blind) showed [Kc 5s] and won ($1.20) with two pair, Sixes and Fives
Seat 3: eQXFICMuu3hw6XlcmuVNEA mucked
Seat 4: r6u7MWSXF30/khcTYkrG9Q folded before Flop (didn't bet)
Seat 6: kxPhs4ePFqMy52CInAJ2aw (button) folded before Flop (didn't bet)



PokerStars Game #59940091330:  Hold'em No Limit ($0.25/$0.50) - 2009/07/01 0:57:02 ET
Table '0eJtgVAXVvBgncFdcUpXcQ' 2-max Seat #2 is the button
Seat 1: Ag6DvxX4vbRheqsv2zXKTQ ($34.80 in chips)
Seat 2: KMc4R+K9ao4Ur3rF7NGe6Q ($15.50 in chips)
KMc4R+K9ao4Ur3rF7NGe6Q: posts small blind $0.25
Ag6DvxX4vbRheqsv2zXKTQ: posts big blind $0.50
*** HOLE CARDS ***
KMc4R+K9ao4Ur3rF7NGe6Q: calls $0.25
Ag6DvxX4vbRheqsv2zXKTQ: checks
*** FLOP *** [2c 5s 3s]
Ag6DvxX4vbRheqsv2zXKTQ: checks
KMc4R+K9ao4Ur3rF7NGe6Q: checks
*** TURN *** [2c 5s 3s] [9d]
Ag6DvxX4vbRheqsv2zXKTQ: bets $1.50
KMc4R+K9ao4Ur3rF7NGe6Q: folds
Ag6DvxX4vbRheqsv2zXKTQ collected $0.95 from pot
*** SUMMARY ***
Total pot $1 | Rake $0.05
Board [2c 5s 3s 9d]
Seat 1: Ag6DvxX4vbRheqsv2zXKTQ (big blind) collected ($0.95)
Seat 2: KMc4R+K9ao4Ur3rF7NGe6Q (button) (small blind) folded on the Turn



PokerStars Game #59940091834:  Hold'em No Limit ($0.25/$0.50) - 2009/07/01 0:57:02 ET
Table '99gCy/CZQwPIjZWH+BguQgE7bWJ45aoFXRpyRv2gw+Igeat #9 is the button
Seat 2: n6VQBu6crjYjy6DxNP1NZA ($28.25 in chips)
Seat 3: qEn9ijNGtuyTxamBf07hYg ($50 in chips)
Seat 4: bxLSulbgr8LmKNjOzw8URg ($62.95 in chips)
Seat 5: DSM67hHHq1XFoEOi9p8Alw ($50 in chips)
Seat 6: OcnLOMVFdy23jXnoTyaO5Q ($244.15 in chips)
Seat 7: bfSq6LBw0UvxeM5yfuWC7w ($17.85 in chips)
Seat 8: 8ehL7qlZzjgUh2H35iiWLw ($51.75 in chips)
Seat 9: j3K/Jujr7PY4ZM2RZvlH6A ($100.45 in chips)
n6VQBu6crjYjy6DxNP1NZA: posts small blind $0.25
qEn9ijNGtuyTxamBf07hYg: posts big blind $0.50
*** HOLE CARDS ***
bxLSulbgr8LmKNjOzw8URg: folds
DSM67hHHq1XFoEOi9p8Alw: folds
OcnLOMVFdy23jXnoTyaO5Q: raises $1 to $1.50
bfSq6LBw0UvxeM5yfuWC7w: folds
8ehL7qlZzjgUh2H35iiWLw: folds
j3K/Jujr7PY4ZM2RZvlH6A: raises $2 to $3.50
n6VQBu6crjYjy6DxNP1NZA: folds
qEn9ijNGtuyTxamBf07hYg: folds
OcnLOMVFdy23jXnoTyaO5Q: calls $2
*** FLOP *** [4h As 9h]
OcnLOMVFdy23jXnoTyaO5Q: checks
j3K/Jujr7PY4ZM2RZvlH6A: bets $4.50
OcnLOMVFdy23jXnoTyaO5Q: calls $4.50
*** TURN *** [4h As 9h] [Qc]
OcnLOMVFdy23jXnoTyaO5Q: checks
j3K/Jujr7PY4ZM2RZvlH6A: bets $9
OcnLOMVFdy23jXnoTyaO5Q: calls $9
*** RIVER *** [4h As 9h Qc] [Kc]
OcnLOMVFdy23jXnoTyaO5Q: checks
j3K/Jujr7PY4ZM2RZvlH6A: checks
*** SHOW DOWN ***
OcnLOMVFdy23jXnoTyaO5Q: shows [Qh Kh] (two pair, Kings and Queens)
j3K/Jujr7PY4ZM2RZvlH6A: mucks hand
OcnLOMVFdy23jXnoTyaO5Q collected $33.10 from pot
*** SUMMARY ***
Total pot $34.75 | Rake $1.65
Board [4h As 9h Qc Kc]
Seat 2: n6VQBu6crjYjy6DxNP1NZA (small blind) folded before Flop
Seat 3: qEn9ijNGtuyTxamBf07hYg (big blind) folded before Flop
Seat 4: bxLSulbgr8LmKNjOzw8URg folded before Flop (didn't bet)
Seat 5: DSM67hHHq1XFoEOi9p8Alw folded before Flop (didn't bet)
Seat 6: OcnLOMVFdy23jXnoTyaO5Q showed [Qh Kh] and won ($33.10) with two pair, Kings and Queens
Seat 7: bfSq6LBw0UvxeM5yfuWC7w folded before Flop (didn't bet)
Seat 8: 8ehL7qlZzjgUh2H35iiWLw folded before Flop (didn't bet)
Seat 9: j3K/Jujr7PY4ZM2RZvlH6A (button) mucked



PokerStars Game #59940092556:  Hold'em No Limit ($0.25/$0.50) - 2009/07/01 0:57:03 ET
Table 'X6IRCRTh+20gjz8aubWnwA' 9-max Seat #3 is the button
Seat 1: DSM67hHHq1XFoEOi9p8Alw ($49.05 in chips)
Seat 2: HZkVla4kK2SI42CVrPZ/ig ($7.55 in chips)
Seat 3: SWv01peOe69QQRvhQTqjQw ($3.90 in chips)
Seat 4: M3JFBNQ8Bbw3FBZ/18MuXw ($13.50 in chips)
Seat 5: NnQCepdIR/AOUQn1yhYx6Q ($10 in chips)
Seat 7: cFHQjKQOOKTUzoilhrXHLg ($49.65 in chips)
Seat 8: HxeBVq06/3Bh/H986sgdbw ($24 in chips)
Seat 9: M+7+BTmX5vZatHVuoRB1nA ($46.75 in chips)
M3JFBNQ8Bbw3FBZ/18MuXw: posts small blind $0.25
NnQCepdIR/AOUQn1yhYx6Q: posts big blind $0.50
75K2MXwN65Sjfp1yHd50Hg: sits out
*** HOLE CARDS ***
cFHQjKQOOKTUzoilhrXHLg: calls $0.50
HxeBVq06/3Bh/H986sgdbw: folds
M+7+BTmX5vZatHVuoRB1nA: folds
DSM67hHHq1XFoEOi9p8Alw: folds
HZkVla4kK2SI42CVrPZ/ig: folds
SWv01peOe69QQRvhQTqjQw has timed out
SWv01peOe69QQRvhQTqjQw: folds
SWv01peOe69QQRvhQTqjQw is sitting out
M3JFBNQ8Bbw3FBZ/18MuXw: calls $0.25
NnQCepdIR/AOUQn1yhYx6Q: checks
*** FLOP *** [Ac 6s Th]
M3JFBNQ8Bbw3FBZ/18MuXw: checks
NnQCepdIR/AOUQn1yhYx6Q: checks
cFHQjKQOOKTUzoilhrXHLg: checks
*** TURN *** [Ac 6s Th] [Qs]
SWv01peOe69QQRvhQTqjQw has returned
M3JFBNQ8Bbw3FBZ/18MuXw: checks
NnQCepdIR/AOUQn1yhYx6Q: checks
cFHQjKQOOKTUzoilhrXHLg: checks
*** RIVER *** [Ac 6s Th Qs] [Kc]
M3JFBNQ8Bbw3FBZ/18MuXw: checks
NnQCepdIR/AOUQn1yhYx6Q: checks
cFHQjKQOOKTUzoilhrXHLg: folds
*** SHOW DOWN ***
M3JFBNQ8Bbw3FBZ/18MuXw: shows [Kh 9d] (a pair of Kings)
NnQCepdIR/AOUQn1yhYx6Q: mucks hand
M3JFBNQ8Bbw3FBZ/18MuXw collected $1.45 from pot
*** SUMMARY ***
Total pot $1.50 | Rake $0.05
Board [Ac 6s Th Qs Kc]
Seat 1: DSM67hHHq1XFoEOi9p8Alw folded before Flop (didn't bet)
Seat 2: HZkVla4kK2SI42CVrPZ/ig folded before Flop (didn't bet)
Seat 3: SWv01peOe69QQRvhQTqjQw (button) folded before Flop (didn't bet)
Seat 4: M3JFBNQ8Bbw3FBZ/18MuXw (small blind) showed [Kh 9d] and won ($1.45) with a pair of Kings
Seat 5: NnQCepdIR/AOUQn1yhYx6Q (big blind) mucked
Seat 7: cFHQjKQOOKTUzoilhrXHLg folded on the River
Seat 8: HxeBVq06/3Bh/H986sgdbw folded before Flop (didn't bet)
Seat 9: M+7+BTmX5vZatHVuoRB1nA folded before Flop (didn't bet)



PokerStars Game #59940092276:  Hold'em No Limit ($0.25/$0.50) - 2009/07/01 0:57:03 ET
Table 'E7bWJ45aoFXRpyRv2gw+Ig' 2-max Seat #2 is the button
Seat 1: FRkiRasEGlHUeLrEl+k/nA ($66 in chips)
Seat 2: 3Wro85I7472vJ4Wkpneo9A ($125.40 in chips)
3Wro85I7472vJ4Wkpneo9A: posts small blind $0.25
FRkiRasEGlHUeLrEl+k/nA: posts big blind $0.50
*** HOLE CARDS ***
3Wro85I7472vJ4Wkpneo9A: calls $0.25
FRkiRasEGlHUeLrEl+k/nA: checks
*** FLOP *** [9h Jh Th]
FRkiRasEGlHUeLrEl+k/nA: checks
3Wro85I7472vJ4Wkpneo9A: bets $1
FRkiRasEGlHUeLrEl+k/nA: calls $1
*** TURN *** [9h Jh Th] [2c]
FRkiRasEGlHUeLrEl+k/nA: checks
3Wro85I7472vJ4Wkpneo9A: bets $2
FRkiRasEGlHUeLrEl+k/nA: calls $2
*** RIVER *** [9h Jh Th 2c] [Td]
FRkiRasEGlHUeLrEl+k/nA: checks
3Wro85I7472vJ4Wkpneo9A: checks
*** SHOW DOWN ***
FRkiRasEGlHUeLrEl+k/nA: shows [6s Ts] (three of a kind, Tens)
3Wro85I7472vJ4Wkpneo9A: mucks hand
FRkiRasEGlHUeLrEl+k/nA collected $6.70 from pot
*** SUMMARY ***
Total pot $7 | Rake $0.30
Board [9h Jh Th 2c Td]
Seat 1: FRkiRasEGlHUeLrEl+k/nA (big blind) showed [6s Ts] and won ($6.70) with three of a kind, Tens
Seat 2: 3Wro85I7472vJ4Wkpneo9A (button) (small blind) mucked



PokerStars Game #59940092270:  Hold'em No Limit ($0.25/$0.50) - 2009/07/01 0:57:03 ET
Table '+dXkOAQyS8j9PQZusUTMpg' 2-max Seat #1 is the button
Seat 1: XFa6sBGjP2gxoIvxR3fZIg ($63.10 in chips)
Seat 2: 5IBeOgaApY1Bvzv2P8X4EA ($136.90 in chips)
XFa6sBGjP2gxoIvxR3fZIg: posts small blind $0.25
5IBeOgaApY1Bvzv2P8X4EA: posts big blind $0.50
*** HOLE CARDS ***
XFa6sBGjP2gxoIvxR3fZIg: raises $1 to $1.50
5IBeOgaApY1Bvzv2P8X4EA: calls $1
*** FLOP *** [2h 4c 2s]
5IBeOgaApY1Bvzv2P8X4EA: checks
XFa6sBGjP2gxoIvxR3fZIg: checks
*** TURN *** [2h 4c 2s] [4s]
5IBeOgaApY1Bvzv2P8X4EA: bets $1
XFa6sBGjP2gxoIvxR3fZIg: folds
5IBeOgaApY1Bvzv2P8X4EA collected $2.85 from pot
5IBeOgaApY1Bvzv2P8X4EA: doesn't show hand
*** SUMMARY ***
Total pot $3 | Rake $0.15
Board [2h 4c 2s 4s]
Seat 1: XFa6sBGjP2gxoIvxR3fZIg (button) (small blind) folded on the Turn
Seat 2: 5IBeOgaApY1Bvzv2P8X4EA (big blind) collected ($2.85)



PokerStars Game #59940095572:  Hold'em No Limit ($0.25/$0.50) - 2009/07/01 0:57:08 ET
Table 'NCiXr0d5CEKBQr/cZgLhbA' 9-max Seat #3 is the button
Seat 1: pFtzb1sR4b0d1aw6aIRgDg ($50 in chips)
Seat 2: ulxuJchBV9iguXg0FUonfg ($51.45 in chips)
Seat 3: xZCXQSXlrZkp3pZizzVXCw ($52.70 in chips)
Seat 4: 5k9fvXD9suIgCxU4HLQjTw ($55.45 in chips)
Seat 5: zE9cVigS2nW/Ljy4K4bUQA ($34.45 in chips)
Seat 6: SKnJuWHScqetA/qG5p+wCg ($32.75 in chips)
Seat 7: M+7+BTmX5vZatHVuoRB1nA ($52 in chips)
Seat 8: 1MJUKc3cc0QmUoz1JZLR2w ($58.25 in chips)
Seat 9: 4WLZvqBn5qv5tds5kt5A1Q ($43 in chips)
5k9fvXD9suIgCxU4HLQjTw: posts small blind $0.25
zE9cVigS2nW/Ljy4K4bUQA: posts big blind $0.50
*** HOLE CARDS ***
SKnJuWHScqetA/qG5p+wCg: folds
M+7+BTmX5vZatHVuoRB1nA: raises $1.50 to $2
1MJUKc3cc0QmUoz1JZLR2w: folds
4WLZvqBn5qv5tds5kt5A1Q: folds
pFtzb1sR4b0d1aw6aIRgDg: folds
ulxuJchBV9iguXg0FUonfg: folds
xZCXQSXlrZkp3pZizzVXCw: folds
5k9fvXD9suIgCxU4HLQjTw: folds
zE9cVigS2nW/Ljy4K4bUQA: folds
M+7+BTmX5vZatHVuoRB1nA collected $1.25 from pot
*** SUMMARY ***
Total pot $1.25 | Rake $0
Seat 1: pFtzb1sR4b0d1aw6aIRgDg folded before Flop (didn't bet)
Seat 2: ulxuJchBV9iguXg0FUonfg folded before Flop (didn't bet)
Seat 3: xZCXQSXlrZkp3pZizzVXCw (button) folded before Flop (didn't bet)
Seat 4: 5k9fvXD9suIgCxU4HLQjTw (small blind) folded before Flop
Seat 5: zE9cVigS2nW/Ljy4K4bUQA (big blind) folded before Flop
Seat 6: SKnJuWHScqetA/qG5p+wCg folded before Flop (didn't bet)
Seat 7: M+7+BTmX5vZatHVuoRB1nA collected ($1.25)
Seat 8: 1MJUKc3cc0QmUoz1JZLR2w folded before Flop (didn't bet)
Seat 9: 4WLZvqBn5qv5tds5kt5A1Q folded before Flop (didn't bet)



PokerStars Game #59940096320:  Hold'em No Limit ($0.25/$0.50) - 2009/07/01 0:57:10 ET
Table 'c/CRn+68J3Y8KxD5g1ek2Q' 2-max Seat #1 is the button
Seat 1: 46qCyJ6evTkHo9al5sBMNA ($88.90 in chips)
Seat 2: BypVLsYQt3ePFm2xQL/dOA ($280.50 in chips)
46qCyJ6evTkHo9al5sBMNA: posts small blind $0.25
BypVLsYQt3ePFm2xQL/dOA: posts big blind $0.50
*** HOLE CARDS ***
46qCyJ6evTkHo9al5sBMNA: raises $1.50 to $2
BypVLsYQt3ePFm2xQL/dOA: calls $1.50
*** FLOP *** [Qd Jd 6h]
BypVLsYQt3ePFm2xQL/dOA: checks
46qCyJ6evTkHo9al5sBMNA: checks
*** TURN *** [Qd Jd 6h] [Jc]
BypVLsYQt3ePFm2xQL/dOA: bets $1
46qCyJ6evTkHo9al5sBMNA: calls $1
*** RIVER *** [Qd Jd 6h Jc] [8h]
BypVLsYQt3ePFm2xQL/dOA: bets $2.50
46qCyJ6evTkHo9al5sBMNA: folds
BypVLsYQt3ePFm2xQL/dOA collected $5.75 from pot
BypVLsYQt3ePFm2xQL/dOA: doesn't show hand
*** SUMMARY ***
Total pot $6 | Rake $0.25
Board [Qd Jd 6h Jc 8h]
Seat 1: 46qCyJ6evTkHo9al5sBMNA (button) (small blind) folded on the River
Seat 2: BypVLsYQt3ePFm2xQL/dOA (big blind) collected ($5.75)



PokerStars Game #59940096864:  Hold'em No Limit ($0.25/$0.50) - 2009/07/01 0:57:10 ET
Table 'BCN5su+SsXiy1zRMJi0SJw' 6-max Seat #4 is the button
Seat 1: GxXV09ciXaOxyY2H5aMIIw ($30.40 in chips)
Seat 2: oU2kDCkT/gilYbHWrg7D8w ($21.80 in chips)
Seat 3: 6wzJiRvp8HY6t+MQGnSIzA ($14.45 in chips)
Seat 4: qfeUHOJpMYyzQcj0o2A7ng ($21.10 in chips)
Seat 5: IBNygaT1aa9Z1uPdJJilwA ($33.85 in chips)
Seat 6: b2symlOdL7+0c9Pj4N/KlA ($80.50 in chips)
IBNygaT1aa9Z1uPdJJilwA: posts small blind $0.25
b2symlOdL7+0c9Pj4N/KlA: posts big blind $0.50
*** HOLE CARDS ***
GxXV09ciXaOxyY2H5aMIIw: folds
oU2kDCkT/gilYbHWrg7D8w: calls $0.50
6wzJiRvp8HY6t+MQGnSIzA: raises $2 to $2.50
qfeUHOJpMYyzQcj0o2A7ng: folds
IBNygaT1aa9Z1uPdJJilwA: calls $2.25
b2symlOdL7+0c9Pj4N/KlA: folds
oU2kDCkT/gilYbHWrg7D8w: calls $2
*** FLOP *** [Tc 5h 8s]
IBNygaT1aa9Z1uPdJJilwA: checks
oU2kDCkT/gilYbHWrg7D8w: checks
6wzJiRvp8HY6t+MQGnSIzA: bets $2
IBNygaT1aa9Z1uPdJJilwA: folds
oU2kDCkT/gilYbHWrg7D8w: calls $2
*** TURN *** [Tc 5h 8s] [Jc]
oU2kDCkT/gilYbHWrg7D8w: checks
6wzJiRvp8HY6t+MQGnSIzA: bets $2
oU2kDCkT/gilYbHWrg7D8w: raises $9 to $11
6wzJiRvp8HY6t+MQGnSIzA: calls $7.95 and is all-in
*** RIVER *** [Tc 5h 8s Jc] [4c]
*** SHOW DOWN ***
oU2kDCkT/gilYbHWrg7D8w: shows [3d 3c] (a pair of Threes)
6wzJiRvp8HY6t+MQGnSIzA: shows [8h Th] (two pair, Tens and Eights)
6wzJiRvp8HY6t+MQGnSIzA collected $30.35 from pot
*** SUMMARY ***
Total pot $31.90 | Rake $1.55
Board [Tc 5h 8s Jc 4c]
Seat 1: GxXV09ciXaOxyY2H5aMIIw folded before Flop (didn't bet)
Seat 2: oU2kDCkT/gilYbHWrg7D8w showed [3d 3c] and lost with a pair of Threes
Seat 3: 6wzJiRvp8HY6t+MQGnSIzA showed [8h Th] and won ($30.35) with two pair, Tens and Eights
Seat 4: qfeUHOJpMYyzQcj0o2A7ng (button) folded before Flop (didn't bet)
Seat 5: IBNygaT1aa9Z1uPdJJilwA (small blind) folded on the Flop
Seat 6: b2symlOdL7+0c9Pj4N/KlA (big blind) folded before Flop



PokerStars Game #59940096554:  Hold'em No Limit ($0.25/$0.50) - 2009/07/01 0:57:10 ET
Table '+z1aekfHkpp09pc8F9aViw' 6-max Seat #1 is the button
Seat 1: FHilMb2i2DbUCc9lplszog ($56.55 in chips)
Seat 2: M6xK/VklCvdyyrmvzATlxQ ($34 in chips)
Seat 3: uUznlIMFnRUvwrBhYF73KA ($118.55 in chips)
Seat 4: RowCSpSURHTOL/dcjg/Iug ($40.30 in chips)
Seat 5: rplyldNweS6YyMNEALQrug ($20 in chips)
Seat 6: 686aeHikcJlgKkSuIFdcXQ ($51.85 in chips)
M6xK/VklCvdyyrmvzATlxQ: posts small blind $0.25
uUznlIMFnRUvwrBhYF73KA: posts big blind $0.50
*** HOLE CARDS ***
RowCSpSURHTOL/dcjg/Iug: folds
rplyldNweS6YyMNEALQrug: raises $2.50 to $3
686aeHikcJlgKkSuIFdcXQ: folds
FHilMb2i2DbUCc9lplszog: calls $3
M6xK/VklCvdyyrmvzATlxQ: folds
uUznlIMFnRUvwrBhYF73KA: raises $2.50 to $5.50
rplyldNweS6YyMNEALQrug: calls $2.50
FHilMb2i2DbUCc9lplszog: calls $2.50
*** FLOP *** [9s Qd Kh]
uUznlIMFnRUvwrBhYF73KA: bets $5
rplyldNweS6YyMNEALQrug: folds
FHilMb2i2DbUCc9lplszog: calls $5
*** TURN *** [9s Qd Kh] [Tc]
uUznlIMFnRUvwrBhYF73KA: checks
FHilMb2i2DbUCc9lplszog: bets $6.50
uUznlIMFnRUvwrBhYF73KA: calls $6.50
*** RIVER *** [9s Qd Kh Tc] [Ah]
uUznlIMFnRUvwrBhYF73KA: checks
FHilMb2i2DbUCc9lplszog: checks
*** SHOW DOWN ***
uUznlIMFnRUvwrBhYF73KA: shows [Qh Qs] (three of a kind, Queens)
FHilMb2i2DbUCc9lplszog: mucks hand
uUznlIMFnRUvwrBhYF73KA collected $37.85 from pot
*** SUMMARY ***
Total pot $39.75 | Rake $1.90
Board [9s Qd Kh Tc Ah]
Seat 1: FHilMb2i2DbUCc9lplszog (button) mucked
Seat 2: M6xK/VklCvdyyrmvzATlxQ (small blind) folded before Flop
Seat 3: uUznlIMFnRUvwrBhYF73KA (big blind) showed [Qh Qs] and won ($37.85) with three of a kind, Queens
Seat 4: RowCSpSURHTOL/dcjg/Iug folded before Flop (didn't bet)
Seat 5: rplyldNweS6YyMNEALQrug folded on the Flop
Seat 6: 686aeHikcJlgKkSuIFdcXQ folded before Flop (didn't bet)



PokerStars Game #59940098940:  Hold'em No Limit ($0.25/$0.50) - 2009/07/01 0:57:14 ET
Table 'lSisgp6H7Fg1hH5VfjEjYQ' 9-max Seat #2 is the button
Seat 1: 5k9fvXD9suIgCxU4HLQjTw ($50 in chips)
Seat 2: UrcnkQOiLVk8BlKDPJSy7Q ($76.60 in chips)
Seat 3: aTkyjTh3w5YLWiIERupZOA ($51.45 in chips)
Seat 4: bwv/rbH/hHhPhY6u9mu04w ($31.60 in chips)
Seat 5: mSD1pginDsyHG5PDfqzphw ($12.60 in chips)
Seat 6: +k7T5ocke8UwavtgUHm+Cg ($54.95 in chips)
Seat 7: IDtNLR9uFCDdjNsJWMHA5Q ($19.85 in chips)
Seat 8: a4JDWmpFQkL10XfAyuF51A ($29 in chips)
Seat 9: gsyXT42WLEcOS4DdEk2wlw ($42.05 in chips)
aTkyjTh3w5YLWiIERupZOA: posts small blind $0.25
bwv/rbH/hHhPhY6u9mu04w: posts big blind $0.50
*** HOLE CARDS ***
mSD1pginDsyHG5PDfqzphw: raises $1 to $1.50
+k7T5ocke8UwavtgUHm+Cg: calls $1.50
IDtNLR9uFCDdjNsJWMHA5Q: folds
a4JDWmpFQkL10XfAyuF51A: folds
gsyXT42WLEcOS4DdEk2wlw: folds
5k9fvXD9suIgCxU4HLQjTw: folds
UrcnkQOiLVk8BlKDPJSy7Q: folds
aTkyjTh3w5YLWiIERupZOA: folds
bwv/rbH/hHhPhY6u9mu04w: folds
*** FLOP *** [8c Th 5d]
mSD1pginDsyHG5PDfqzphw: bets $2
+k7T5ocke8UwavtgUHm+Cg: raises $2 to $4
mSD1pginDsyHG5PDfqzphw: raises $7.10 to $11.10 and is all-in
+k7T5ocke8UwavtgUHm+Cg: calls $7.10
*** TURN *** [8c Th 5d] [2h]
*** RIVER *** [8c Th 5d 2h] [2s]
*** SHOW DOWN ***
mSD1pginDsyHG5PDfqzphw: shows [Ts Ac] (two pair, Tens and Deuces)
+k7T5ocke8UwavtgUHm+Cg: shows [8h 8s] (a full house, Eights full of Deuces)
+k7T5ocke8UwavtgUHm+Cg collected $24.70 from pot
*** SUMMARY ***
Total pot $25.95 | Rake $1.25
Board [8c Th 5d 2h 2s]
Seat 1: 5k9fvXD9suIgCxU4HLQjTw folded before Flop (didn't bet)
Seat 2: UrcnkQOiLVk8BlKDPJSy7Q (button) folded before Flop (didn't bet)
Seat 3: aTkyjTh3w5YLWiIERupZOA (small blind) folded before Flop
Seat 4: bwv/rbH/hHhPhY6u9mu04w (big blind) folded before Flop
Seat 5: mSD1pginDsyHG5PDfqzphw showed [Ts Ac] and lost with two pair, Tens and Deuces
Seat 6: +k7T5ocke8UwavtgUHm+Cg showed [8h 8s] and won ($24.70) with a full house, Eights full of Deuces
Seat 7: IDtNLR9uFCDdjNsJWMHA5Q folded before Flop (didn't bet)
Seat 8: a4JDWmpFQkL10XfAyuF51A folded before Flop (didn't bet)
Seat 9: gsyXT42WLEcOS4DdEk2wlw folded before Flop (didn't bet)



PokerStars Game #59940100688:  Hold'em No Limit ($0.25/$0.50) - 2009/07/01 0:57:16 ET
Table 'otvGDROEDdqsabxskT79qg' 9-max Seat #7 is the button
Seat 1: 8ehL7qlZzjgUh2H35iiWLw ($57.50 in chips)
Seat 2: cCjTzH9jio8607WzjcfXlg ($14.30 in chips)
Seat 3: +k7T5ocke8UwavtgUHm+Cg ($66.50 in chips)
Seat 4: MG90wfSJZnOejs/KD3vlQQ ($73.20 in chips)
Seat 5: XNMDwbXt/Q4jM99AXnbJDw ($51.15 in chips)
Seat 6: bxLSulbgr8LmKNjOzw8URg ($53.70 in chips)
Seat 7: C7+tBppJrKgd/r+tuKUIpA ($32.05 in chips)
Seat 8: zE9cVigS2nW/Ljy4K4bUQA ($30 in chips)
Seat 9: KcY3X8YpD74Kw1RHkx/g4A ($57.90 in chips)
zE9cVigS2nW/Ljy4K4bUQA: posts small blind $0.25
KcY3X8YpD74Kw1RHkx/g4A: posts big blind $0.50
*** HOLE CARDS ***
8ehL7qlZzjgUh2H35iiWLw: folds
cCjTzH9jio8607WzjcfXlg: folds
+k7T5ocke8UwavtgUHm+Cg: calls $0.50
MG90wfSJZnOejs/KD3vlQQ: folds
XNMDwbXt/Q4jM99AXnbJDw: folds
bxLSulbgr8LmKNjOzw8URg: folds
C7+tBppJrKgd/r+tuKUIpA: folds
zE9cVigS2nW/Ljy4K4bUQA: folds
KcY3X8YpD74Kw1RHkx/g4A: checks
*** FLOP *** [2d 9c 5s]
KcY3X8YpD74Kw1RHkx/g4A: checks
+k7T5ocke8UwavtgUHm+Cg: checks
*** TURN *** [2d 9c 5s] [6s]
KcY3X8YpD74Kw1RHkx/g4A: checks
+k7T5ocke8UwavtgUHm+Cg: checks
*** RIVER *** [2d 9c 5s 6s] [Qh]
KcY3X8YpD74Kw1RHkx/g4A: checks
+k7T5ocke8UwavtgUHm+Cg: checks
*** SHOW DOWN ***
KcY3X8YpD74Kw1RHkx/g4A: shows [8s Tc] (high card Queen)
+k7T5ocke8UwavtgUHm+Cg: shows [Td Jd] (high card Queen - Jack kicker)
+k7T5ocke8UwavtgUHm+Cg collected $1.20 from pot
*** SUMMARY ***
Total pot $1.25 | Rake $0.05
Board [2d 9c 5s 6s Qh]
Seat 1: 8ehL7qlZzjgUh2H35iiWLw folded before Flop (didn't bet)
Seat 2: cCjTzH9jio8607WzjcfXlg folded before Flop (didn't bet)
Seat 3: +k7T5ocke8UwavtgUHm+Cg showed [Td Jd] and won ($1.20) with high card Queen
Seat 4: MG90wfSJZnOejs/KD3vlQQ folded before Flop (didn't bet)
Seat 5: XNMDwbXt/Q4jM99AXnbJDw folded before Flop (didn't bet)
Seat 6: bxLSulbgr8LmKNjOzw8URg folded before Flop (didn't bet)
Seat 7: C7+tBppJrKgd/r+tuKUIpA (button) folded before Flop (didn't bet)
Seat 8: zE9cVigS2nW/Ljy4K4bUQA (small blind) folded before Flop
Seat 9: KcY3X8YpD74Kw1RHkx/g4A (big blind) showed [8s Tc] and lost with high card Queen



PokerStars Game #59940100926:  Hold'em No Limit ($0.25/$0.50) - 2009/07/01 0:57:17 ET
Table '0eJtgVAXVvBgncFdcUpXcQ' 2-max Seat #1 is the button
Seat 1: Ag6DvxX4vbRheqsv2zXKTQ ($35.25 in chips)
Seat 2: KMc4R+K9ao4Ur3rF7NGe6Q ($15 in chips)
Ag6DvxX4vbRheqsv2zXKTQ: posts small blind $0.25
KMc4R+K9ao4Ur3rF7NGe6Q: posts big blind $0.50
*** HOLE CARDS ***
Ag6DvxX4vbRheqsv2zXKTQ: folds
KMc4R+K9ao4Ur3rF7NGe6Q collected $0.50 from pot
KMc4R+K9ao4Ur3rF7NGe6Q: doesn't show hand
*** SUMMARY ***
Total pot $0.50 | Rake $0
Seat 1: Ag6DvxX4vbRheqsv2zXKTQ (button) (small blind) folded before Flop
Seat 2: KMc4R+K9ao4Ur3rF7NGe6Q (big blind) collected ($0.50)



PokerStars Game #59940100874:  Hold'em No Limit ($0.25/$0.50) - 2009/07/01 0:57:17 ET
Table 'Vdlc9wqYcHTUhtdyN7CuJw' 2-max Seat #1 is the button
Seat 1: yBO+mXB6m/rCft2ErwGf/Q ($117.25 in chips)
Seat 2: NZ/5cxwnorKW2SNsWy1+8A ($7.40 in chips)
yBO+mXB6m/rCft2ErwGf/Q: posts small blind $0.25
NZ/5cxwnorKW2SNsWy1+8A: posts big blind $0.50
*** HOLE CARDS ***
yBO+mXB6m/rCft2ErwGf/Q: raises $0.50 to $1
NZ/5cxwnorKW2SNsWy1+8A: calls $0.50
*** FLOP *** [5s 9c Jd]
NZ/5cxwnorKW2SNsWy1+8A: checks
yBO+mXB6m/rCft2ErwGf/Q: bets $1.50
NZ/5cxwnorKW2SNsWy1+8A: calls $1.50
*** TURN *** [5s 9c Jd] [6s]
NZ/5cxwnorKW2SNsWy1+8A: checks
yBO+mXB6m/rCft2ErwGf/Q: bets $114.75 and is all-in
NZ/5cxwnorKW2SNsWy1+8A: folds
yBO+mXB6m/rCft2ErwGf/Q collected $4.80 from pot
*** SUMMARY ***
Total pot $5 | Rake $0.20
Board [5s 9c Jd 6s]
Seat 1: yBO+mXB6m/rCft2ErwGf/Q (button) (small blind) collected ($4.80)
Seat 2: NZ/5cxwnorKW2SNsWy1+8A (big blind) folded on the Turn



PokerStars Game #59940103214:  Hold'em No Limit ($0.25/$0.50) - 2009/07/01 0:57:21 ET
Table 'QOgaEqMcJ73pcUMMxoisUgErOuyGLI5PT3G5MnpHgC/g Seat #9 is the button
Seat 1: eBrej2jnlUCs/JgxFCRn2g ($40.25 in chips)
Seat 3: xZCXQSXlrZkp3pZizzVXCw ($49.50 in chips)
Seat 4: 3UmXLy3GfjC3EkOebduerQ ($50.45 in chips)
Seat 5: JwvquocWfhTVApN5t47LgA ($63.35 in chips)
Seat 6: zE9cVigS2nW/Ljy4K4bUQA ($31.60 in chips)
Seat 7: 90Wb75h3W1BRpbqVnuk8gw ($65.60 in chips)
Seat 8: g4k0NXISyLCqaSWZDBjfEg ($50 in chips)
Seat 9: J0W5D97jl5VLky+IoPvDeA ($51.40 in chips)
eBrej2jnlUCs/JgxFCRn2g: posts small blind $0.25
xZCXQSXlrZkp3pZizzVXCw: posts big blind $0.50
*** HOLE CARDS ***
3UmXLy3GfjC3EkOebduerQ: folds
JwvquocWfhTVApN5t47LgA: folds
zE9cVigS2nW/Ljy4K4bUQA: folds
90Wb75h3W1BRpbqVnuk8gw: raises $1.50 to $2
g4k0NXISyLCqaSWZDBjfEg: folds
J0W5D97jl5VLky+IoPvDeA: folds
eBrej2jnlUCs/JgxFCRn2g: folds
xZCXQSXlrZkp3pZizzVXCw: raises $5 to $7
90Wb75h3W1BRpbqVnuk8gw: folds
xZCXQSXlrZkp3pZizzVXCw collected $4.25 from pot
*** SUMMARY ***
Total pot $4.25 | Rake $0
Seat 1: eBrej2jnlUCs/JgxFCRn2g (small blind) folded before Flop
Seat 3: xZCXQSXlrZkp3pZizzVXCw (big blind) collected ($4.25)
Seat 4: 3UmXLy3GfjC3EkOebduerQ folded before Flop (didn't bet)
Seat 5: JwvquocWfhTVApN5t47LgA folded before Flop (didn't bet)
Seat 6: zE9cVigS2nW/Ljy4K4bUQA folded before Flop (didn't bet)
Seat 7: 90Wb75h3W1BRpbqVnuk8gw folded before Flop
Seat 8: g4k0NXISyLCqaSWZDBjfEg folded before Flop (didn't bet)
Seat 9: J0W5D97jl5VLky+IoPvDeA (button) folded before Flop (didn't bet)



PokerStars Game #59940103656:  Hold'em No Limit ($0.25/$0.50) - 2009/07/01 0:57:21 ET
Table 'EiNh8p/wGJ1FP575iMFnqg' 9-max Seat #5 is the button
Seat 1: r3ZqM1Mi0W3y4hOdssE+Sg ($44.85 in chips)
Seat 2: 8ehL7qlZzjgUh2H35iiWLw ($52.60 in chips)
Seat 3: ymLPoEIl7UL3TvZYmnadxQ ($51.80 in chips)
Seat 4: cMzaiXAM/ZAdNaEUu+LqhA ($55.70 in chips)
Seat 5: M+7+BTmX5vZatHVuoRB1nA ($81.45 in chips)
Seat 6: 3UmXLy3GfjC3EkOebduerQ ($64.85 in chips)
Seat 7: 997ViqAtWn1FPjJqcffwcA ($50 in chips)
Seat 8: mSD1pginDsyHG5PDfqzphw ($10 in chips)
Seat 9: NnQCepdIR/AOUQn1yhYx6Q ($10.75 in chips)
3UmXLy3GfjC3EkOebduerQ: posts small blind $0.25
997ViqAtWn1FPjJqcffwcA: posts big blind $0.50
*** HOLE CARDS ***
mSD1pginDsyHG5PDfqzphw: folds
NnQCepdIR/AOUQn1yhYx6Q has timed out
NnQCepdIR/AOUQn1yhYx6Q: folds
NnQCepdIR/AOUQn1yhYx6Q is sitting out
r3ZqM1Mi0W3y4hOdssE+Sg: folds
NnQCepdIR/AOUQn1yhYx6Q has returned
8ehL7qlZzjgUh2H35iiWLw: folds
ymLPoEIl7UL3TvZYmnadxQ: folds
cMzaiXAM/ZAdNaEUu+LqhA: folds
M+7+BTmX5vZatHVuoRB1nA: folds
3UmXLy3GfjC3EkOebduerQ: folds
997ViqAtWn1FPjJqcffwcA collected $0.50 from pot
*** SUMMARY ***
Total pot $0.50 | Rake $0
Seat 1: r3ZqM1Mi0W3y4hOdssE+Sg folded before Flop (didn't bet)
Seat 2: 8ehL7qlZzjgUh2H35iiWLw folded before Flop (didn't bet)
Seat 3: ymLPoEIl7UL3TvZYmnadxQ folded before Flop (didn't bet)
Seat 4: cMzaiXAM/ZAdNaEUu+LqhA folded before Flop (didn't bet)
Seat 5: M+7+BTmX5vZatHVuoRB1nA (button) folded before Flop (didn't bet)
Seat 6: 3UmXLy3GfjC3EkOebduerQ (small blind) folded before Flop
Seat 7: 997ViqAtWn1FPjJqcffwcA (big blind) collected ($0.50)
Seat 8: mSD1pginDsyHG5PDfqzphw folded before Flop (didn't bet)
Seat 9: NnQCepdIR/AOUQn1yhYx6Q folded before Flop (didn't bet)



PokerStars Game #59940104438:  Hold'em No Limit ($0.25/$0.50) - 2009/07/01 0:57:22 ET
Table '0eJtgVAXVvBgncFdcUpXcQ' 2-max Seat #2 is the button
Seat 1: Ag6DvxX4vbRheqsv2zXKTQ ($35 in chips)
Seat 2: KMc4R+K9ao4Ur3rF7NGe6Q ($15.25 in chips)
KMc4R+K9ao4Ur3rF7NGe6Q: posts small blind $0.25
Ag6DvxX4vbRheqsv2zXKTQ: posts big blind $0.50
*** HOLE CARDS ***
KMc4R+K9ao4Ur3rF7NGe6Q: raises $1 to $1.50
Ag6DvxX4vbRheqsv2zXKTQ: folds
KMc4R+K9ao4Ur3rF7NGe6Q collected $1 from pot
KMc4R+K9ao4Ur3rF7NGe6Q: doesn't show hand
*** SUMMARY ***
Total pot $1 | Rake $0
Seat 1: Ag6DvxX4vbRheqsv2zXKTQ (big blind) folded before Flop
Seat 2: KMc4R+K9ao4Ur3rF7NGe6Q (button) (small blind) collected ($1)



PokerStars Game #59940103998:  Hold'em No Limit ($0.25/$0.50) - 2009/07/01 0:57:22 ET
Table '9Puy2HWN1RQe5SSjq162gA' 2-max Seat #2 is the button
Seat 1: Fp/oksNpipCrD2MJ2pH20g ($15.60 in chips)
Seat 2: tDV+zhxH9+3DkJDzoTERyg ($13.55 in chips)
tDV+zhxH9+3DkJDzoTERyg: posts small blind $0.25
Fp/oksNpipCrD2MJ2pH20g: posts big blind $0.50
*** HOLE CARDS ***
tDV+zhxH9+3DkJDzoTERyg: raises $1 to $1.50
Fp/oksNpipCrD2MJ2pH20g: folds
tDV+zhxH9+3DkJDzoTERyg collected $1 from pot
tDV+zhxH9+3DkJDzoTERyg: doesn't show hand
*** SUMMARY ***
Total pot $1 | Rake $0
Seat 1: Fp/oksNpipCrD2MJ2pH20g (big blind) folded before Flop
Seat 2: tDV+zhxH9+3DkJDzoTERyg (button) (small blind) collected ($1)



PokerStars Game #59940104464:  Hold'em No Limit ($0.25/$0.50) - 2009/07/01 0:57:23 ET
Table '+dXkOAQyS8j9PQZusUTMpg' 2-max Seat #2 is the button
Seat 1: XFa6sBGjP2gxoIvxR3fZIg ($61.60 in chips)
Seat 2: 5IBeOgaApY1Bvzv2P8X4EA ($138.25 in chips)
5IBeOgaApY1Bvzv2P8X4EA: posts small blind $0.25
XFa6sBGjP2gxoIvxR3fZIg: posts big blind $0.50
*** HOLE CARDS ***
5IBeOgaApY1Bvzv2P8X4EA: calls $0.25
XFa6sBGjP2gxoIvxR3fZIg: checks
*** FLOP *** [4h 3s Kc]
XFa6sBGjP2gxoIvxR3fZIg: checks
5IBeOgaApY1Bvzv2P8X4EA: checks
*** TURN *** [4h 3s Kc] [Ks]
XFa6sBGjP2gxoIvxR3fZIg: checks
5IBeOgaApY1Bvzv2P8X4EA: checks
*** RIVER *** [4h 3s Kc Ks] [4s]
XFa6sBGjP2gxoIvxR3fZIg: bets $1
5IBeOgaApY1Bvzv2P8X4EA: raises $1.50 to $2.50
XFa6sBGjP2gxoIvxR3fZIg: calls $1.50
*** SHOW DOWN ***
5IBeOgaApY1Bvzv2P8X4EA: shows [Qs Ts] (a flush, King high)
XFa6sBGjP2gxoIvxR3fZIg: shows [4c 9c] (a full house, Fours full of Kings)
XFa6sBGjP2gxoIvxR3fZIg collected $5.75 from pot
*** SUMMARY ***
Total pot $6 | Rake $0.25
Board [4h 3s Kc Ks 4s]
Seat 1: XFa6sBGjP2gxoIvxR3fZIg (big blind) showed [4c 9c] and won ($5.75) with a full house, Fours full of Kings
Seat 2: 5IBeOgaApY1Bvzv2P8X4EA (button) (small blind) showed [Qs Ts] and lost with a flush, King high



PokerStars Game #59940104620:  Hold'em No Limit ($0.25/$0.50) - 2009/07/01 0:57:23 ET
Table '8BQGgNetI1NOvWeu3gtMNw' 2-max Seat #1 is the button
Seat 1: bypIyrYcAAifLfhZpGlKLA ($50 in chips)
Seat 2: Z4HwehErEwzsv/noQlfUlg ($144.35 in chips)
bypIyrYcAAifLfhZpGlKLA: posts small blind $0.25
Z4HwehErEwzsv/noQlfUlg: posts big blind $0.50
*** HOLE CARDS ***
bypIyrYcAAifLfhZpGlKLA: raises $1 to $1.50
Z4HwehErEwzsv/noQlfUlg: calls $1
*** FLOP *** [7c 8d Qc]
Z4HwehErEwzsv/noQlfUlg: checks
bypIyrYcAAifLfhZpGlKLA: bets $2.50
Z4HwehErEwzsv/noQlfUlg: calls $2.50
*** TURN *** [7c 8d Qc] [Jc]
Z4HwehErEwzsv/noQlfUlg: checks
bypIyrYcAAifLfhZpGlKLA: checks
*** RIVER *** [7c 8d Qc Jc] [2d]
Z4HwehErEwzsv/noQlfUlg: bets $4
bypIyrYcAAifLfhZpGlKLA: folds
Z4HwehErEwzsv/noQlfUlg collected $7.65 from pot
Z4HwehErEwzsv/noQlfUlg: doesn't show hand
*** SUMMARY ***
Total pot $8 | Rake $0.35
Board [7c 8d Qc Jc 2d]
Seat 1: bypIyrYcAAifLfhZpGlKLA (button) (small blind) folded on the River
Seat 2: Z4HwehErEwzsv/noQlfUlg (big blind) collected ($7.65)



PokerStars Game #59940108640:  Hold'em No Limit ($0.25/$0.50) - 2009/07/01 0:57:29 ET
Table '0eJtgVAXVvBgncFdcUpXcQ' 2-max Seat #1 is the button
Seat 1: Ag6DvxX4vbRheqsv2zXKTQ ($34.50 in chips)
Seat 2: KMc4R+K9ao4Ur3rF7NGe6Q ($15.75 in chips)
Ag6DvxX4vbRheqsv2zXKTQ: posts small blind $0.25
KMc4R+K9ao4Ur3rF7NGe6Q: posts big blind $0.50
*** HOLE CARDS ***
Ag6DvxX4vbRheqsv2zXKTQ: raises $1 to $1.50
KMc4R+K9ao4Ur3rF7NGe6Q: folds
Ag6DvxX4vbRheqsv2zXKTQ collected $1 from pot
*** SUMMARY ***
Total pot $1 | Rake $0
Seat 1: Ag6DvxX4vbRheqsv2zXKTQ (button) (small blind) collected ($1)
Seat 2: KMc4R+K9ao4Ur3rF7NGe6Q (big blind) folded before Flop



PokerStars Game #59940109882:  Hold'em No Limit ($0.25/$0.50) - 2009/07/01 0:57:31 ET
Table '9Puy2HWN1RQe5SSjq162gA' 2-max Seat #1 is the button
Seat 1: Fp/oksNpipCrD2MJ2pH20g ($15.10 in chips)
Seat 2: tDV+zhxH9+3DkJDzoTERyg ($14.05 in chips)
Fp/oksNpipCrD2MJ2pH20g: posts small blind $0.25
tDV+zhxH9+3DkJDzoTERyg: posts big blind $0.50
*** HOLE CARDS ***
Fp/oksNpipCrD2MJ2pH20g: calls $0.25
tDV+zhxH9+3DkJDzoTERyg: checks
*** FLOP *** [Js 8d 8h]
tDV+zhxH9+3DkJDzoTERyg: bets $1
Fp/oksNpipCrD2MJ2pH20g: folds
tDV+zhxH9+3DkJDzoTERyg collected $0.95 from pot
tDV+zhxH9+3DkJDzoTERyg: doesn't show hand
*** SUMMARY ***
Total pot $1 | Rake $0.05
Board [Js 8d 8h]
Seat 1: Fp/oksNpipCrD2MJ2pH20g (button) (small blind) folded on the Flop
Seat 2: tDV+zhxH9+3DkJDzoTERyg (big blind) collected ($0.95)



PokerStars Game #59940110398:  Hold'em No Limit ($0.25/$0.50) - 2009/07/01 0:57:32 ET
Table '37qXEp3oe+er5q4CZip9eQ' 6-max Seat #3 is the button
Seat 1: oqOqoO2AyCZenUghCxMDxw ($53.40 in chips)
Seat 2: LvH4G7n+QSjT6NDaD3cREA ($50 in chips)
Seat 3: Rt6KgtZ8YaJoTc3FPim00w ($104.50 in chips)
Seat 4: XsmE8nXMAAMFJbWaJTmHFw ($37.45 in chips)
Seat 5: VOmI0x4dDPnTESZd5B4d1Q ($46.45 in chips)
Seat 6: N50kln4negd8q7Mmoz1j4g ($16.55 in chips)
XsmE8nXMAAMFJbWaJTmHFw: posts small blind $0.25
VOmI0x4dDPnTESZd5B4d1Q: posts big blind $0.50
*** HOLE CARDS ***
N50kln4negd8q7Mmoz1j4g: folds
oqOqoO2AyCZenUghCxMDxw: folds
LvH4G7n+QSjT6NDaD3cREA: folds
Rt6KgtZ8YaJoTc3FPim00w: folds
XsmE8nXMAAMFJbWaJTmHFw: folds
VOmI0x4dDPnTESZd5B4d1Q collected $0.50 from pot
*** SUMMARY ***
Total pot $0.50 | Rake $0
Seat 1: oqOqoO2AyCZenUghCxMDxw folded before Flop (didn't bet)
Seat 2: LvH4G7n+QSjT6NDaD3cREA folded before Flop (didn't bet)
Seat 3: Rt6KgtZ8YaJoTc3FPim00w (button) folded before Flop (didn't bet)
Seat 4: XsmE8nXMAAMFJbWaJTmHFw (small blind) folded before Flop
Seat 5: VOmI0x4dDPnTESZd5B4d1Q (big blind) collected ($0.50)
Seat 6: N50kln4negd8q7Mmoz1j4g folded before Flop (didn't bet)



PokerStars Game #59940110588:  Hold'em No Limit ($0.25/$0.50) - 2009/07/01 0:57:32 ET
Table 'fx6MqwfYAj/Rt86hBz2L3Q' 9-max Seat #1 is the button
Seat 1: SegjDnMxWMujiD57ESNL+g ($10 in chips)
Seat 2: C3rGXblctNcWI6JYPHhaEg ($31.10 in chips)
Seat 3: iadBi5AEt7gTBXbDSSnMYQ ($71.25 in chips)
Seat 5: iAISe3dVeua8PUn2wwgDHw ($25.75 in chips)
Seat 6: 5k9fvXD9suIgCxU4HLQjTw ($50 in chips)
Seat 7: SKnJuWHScqetA/qG5p+wCg ($30 in chips)
Seat 8: JYwJYYV9pM5KWdSiETl8rA ($26.50 in chips)
Seat 9: HZkVla4kK2SI42CVrPZ/ig ($10.25 in chips)
C3rGXblctNcWI6JYPHhaEg: posts small blind $0.25
iadBi5AEt7gTBXbDSSnMYQ: posts big blind $0.50
75K2MXwN65Sjfp1yHd50Hg: sits out
*** HOLE CARDS ***
iAISe3dVeua8PUn2wwgDHw: calls $0.50
5k9fvXD9suIgCxU4HLQjTw: folds
SKnJuWHScqetA/qG5p+wCg: calls $0.50
JYwJYYV9pM5KWdSiETl8rA: raises $2 to $2.50
HZkVla4kK2SI42CVrPZ/ig: folds
SegjDnMxWMujiD57ESNL+g: folds
C3rGXblctNcWI6JYPHhaEg: calls $2.25
iadBi5AEt7gTBXbDSSnMYQ: raises $2.50 to $5
iAISe3dVeua8PUn2wwgDHw: calls $4.50
SKnJuWHScqetA/qG5p+wCg: folds
JYwJYYV9pM5KWdSiETl8rA: folds
C3rGXblctNcWI6JYPHhaEg: folds
*** FLOP *** [Kc 9c 8c]
iadBi5AEt7gTBXbDSSnMYQ: bets $8
iAISe3dVeua8PUn2wwgDHw: folds
iadBi5AEt7gTBXbDSSnMYQ collected $14.75 from pot
*** SUMMARY ***
Total pot $15.50 | Rake $0.75
Board [Kc 9c 8c]
Seat 1: SegjDnMxWMujiD57ESNL+g (button) folded before Flop (didn't bet)
Seat 2: C3rGXblctNcWI6JYPHhaEg (small blind) folded before Flop
Seat 3: iadBi5AEt7gTBXbDSSnMYQ (big blind) collected ($14.75)
Seat 5: iAISe3dVeua8PUn2wwgDHw folded on the Flop
Seat 6: 5k9fvXD9suIgCxU4HLQjTw folded before Flop (didn't bet)
Seat 7: SKnJuWHScqetA/qG5p+wCg folded before Flop
Seat 8: JYwJYYV9pM5KWdSiETl8rA folded before Flop
Seat 9: HZkVla4kK2SI42CVrPZ/ig folded before Flop (didn't bet)



PokerStars Game #59940110918:  Hold'em No Limit ($0.25/$0.50) - 2009/07/01 0:57:33 ET
Table 'MJxeZCzYELxiIsyUZyT0jw' 6-max Seat #4 is the button
Seat 1: +Pf9jTVizYlIo+woPvptfA ($50 in chips)
Seat 2: t3GiVMzqA9Svgr5Uol32cQ ($35.10 in chips)
Seat 3: JQZew0FjzS19kTjeNtrE+A ($64.60 in chips)
Seat 4: alGiiQP/wwtYnfuXII+sgw ($47.85 in chips)
Seat 5: 3jvoOXNtXE90w2BdfNZwZQ ($50 in chips)
Seat 6: c0n4hrn20AML9qzyFC2E8Q ($50 in chips)
3jvoOXNtXE90w2BdfNZwZQ: posts small blind $0.25
c0n4hrn20AML9qzyFC2E8Q: posts big blind $0.50
*** HOLE CARDS ***
+Pf9jTVizYlIo+woPvptfA: folds
t3GiVMzqA9Svgr5Uol32cQ: folds
JQZew0FjzS19kTjeNtrE+A: folds
alGiiQP/wwtYnfuXII+sgw: folds
3jvoOXNtXE90w2BdfNZwZQ: raises $1.50 to $2
c0n4hrn20AML9qzyFC2E8Q: folds
3jvoOXNtXE90w2BdfNZwZQ collected $1 from pot
3jvoOXNtXE90w2BdfNZwZQ: doesn't show hand
*** SUMMARY ***
Total pot $1 | Rake $0
Seat 1: +Pf9jTVizYlIo+woPvptfA folded before Flop (didn't bet)
Seat 2: t3GiVMzqA9Svgr5Uol32cQ folded before Flop (didn't bet)
Seat 3: JQZew0FjzS19kTjeNtrE+A folded before Flop (didn't bet)
Seat 4: alGiiQP/wwtYnfuXII+sgw (button) folded before Flop (didn't bet)
Seat 5: 3jvoOXNtXE90w2BdfNZwZQ (small blind) collected ($1)
Seat 6: c0n4hrn20AML9qzyFC2E8Q (big blind) folded before Flop



PokerStars Game #59940112210:  Hold'em No Limit ($0.25/$0.50) - 2009/07/01 0:57:35 ET
Table '0eJtgVAXVvBgncFdcUpXcQ' 2-max Seat #2 is the button
Seat 1: Ag6DvxX4vbRheqsv2zXKTQ ($35 in chips)
Seat 2: KMc4R+K9ao4Ur3rF7NGe6Q ($15.25 in chips)
KMc4R+K9ao4Ur3rF7NGe6Q: posts small blind $0.25
Ag6DvxX4vbRheqsv2zXKTQ: posts big blind $0.50
*** HOLE CARDS ***
KMc4R+K9ao4Ur3rF7NGe6Q: raises $1 to $1.50
Ag6DvxX4vbRheqsv2zXKTQ: calls $1
*** FLOP *** [7h Kd 6d]
Ag6DvxX4vbRheqsv2zXKTQ: checks
KMc4R+K9ao4Ur3rF7NGe6Q: checks
*** TURN *** [7h Kd 6d] [7s]
Ag6DvxX4vbRheqsv2zXKTQ: bets $1.50
KMc4R+K9ao4Ur3rF7NGe6Q: calls $1.50
*** RIVER *** [7h Kd 6d 7s] [6c]
Ag6DvxX4vbRheqsv2zXKTQ: checks
KMc4R+K9ao4Ur3rF7NGe6Q: bets $1
Ag6DvxX4vbRheqsv2zXKTQ: calls $1
*** SHOW DOWN ***
KMc4R+K9ao4Ur3rF7NGe6Q: shows [Qc Jd] (two pair, Sevens and Sixes)
Ag6DvxX4vbRheqsv2zXKTQ: shows [Th Qd] (two pair, Sevens and Sixes)
Ag6DvxX4vbRheqsv2zXKTQ collected $3.85 from pot
KMc4R+K9ao4Ur3rF7NGe6Q collected $3.80 from pot
*** SUMMARY ***
Total pot $8 | Rake $0.35
Board [7h Kd 6d 7s 6c]
Seat 1: Ag6DvxX4vbRheqsv2zXKTQ (big blind) showed [Th Qd] and won ($3.85) with two pair, Sevens and Sixes
Seat 2: KMc4R+K9ao4Ur3rF7NGe6Q (button) (small blind) showed [Qc Jd] and won ($3.80) with two pair, Sevens and Sixes



PokerStars Game #59940112246:  Hold'em No Limit ($0.25/$0.50) - 2009/07/01 0:57:35 ET
Table 'Nz0Vr7WMHL2g5Uk7dDZjpw' 9-max Seat #3 is the button
Seat 1: tLkxo7JgV+WWI0UBw44K5A ($109.10 in chips)
Seat 2: XNMDwbXt/Q4jM99AXnbJDw ($58.60 in chips)
Seat 3: uw9QayAAxLM3Hb+HR7mSkg ($10 in chips)
Seat 4: E2518gp4aFz1+kAgmGqeEg ($10.50 in chips)
Seat 5: WGW0DgjBUXs1ylURHG8vnQ ($27.50 in chips)
Seat 6: 997ViqAtWn1FPjJqcffwcA ($61.30 in chips)
Seat 7: KPLH0gELgFe2OuAnhJFI5w ($17.85 in chips)
Seat 8: HkZI6g4zl83TDTA7SRspmQ ($16.45 in chips)
Seat 9: mSD1pginDsyHG5PDfqzphw ($10 in chips)
E2518gp4aFz1+kAgmGqeEg: posts small blind $0.25
WGW0DgjBUXs1ylURHG8vnQ: posts big blind $0.50
*** HOLE CARDS ***
997ViqAtWn1FPjJqcffwcA: folds
KPLH0gELgFe2OuAnhJFI5w: folds
HkZI6g4zl83TDTA7SRspmQ: calls $0.50
mSD1pginDsyHG5PDfqzphw: folds
tLkxo7JgV+WWI0UBw44K5A: folds
XNMDwbXt/Q4jM99AXnbJDw: folds
uw9QayAAxLM3Hb+HR7mSkg: folds
E2518gp4aFz1+kAgmGqeEg: raises $10 to $10.50 and is all-in
WGW0DgjBUXs1ylURHG8vnQ: folds
HkZI6g4zl83TDTA7SRspmQ: folds
E2518gp4aFz1+kAgmGqeEg collected $1.50 from pot
E2518gp4aFz1+kAgmGqeEg: doesn't show hand
*** SUMMARY ***
Total pot $1.50 | Rake $0
Seat 1: tLkxo7JgV+WWI0UBw44K5A folded before Flop (didn't bet)
Seat 2: XNMDwbXt/Q4jM99AXnbJDw folded before Flop (didn't bet)
Seat 3: uw9QayAAxLM3Hb+HR7mSkg (button) folded before Flop (didn't bet)
Seat 4: E2518gp4aFz1+kAgmGqeEg (small blind) collected ($1.50)
Seat 5: WGW0DgjBUXs1ylURHG8vnQ (big blind) folded before Flop
Seat 6: 997ViqAtWn1FPjJqcffwcA folded before Flop (didn't bet)
Seat 7: KPLH0gELgFe2OuAnhJFI5w folded before Flop (didn't bet)
Seat 8: HkZI6g4zl83TDTA7SRspmQ folded before Flop
Seat 9: mSD1pginDsyHG5PDfqzphw folded before Flop (didn't bet)



PokerStars Game #59940112898:  Hold'em No Limit ($0.25/$0.50) - 2009/07/01 0:57:36 ET
Table 'NCiXr0d5CEKBQr/cZgLhbA' 9-max Seat #4 is the button
Seat 1: pFtzb1sR4b0d1aw6aIRgDg ($50 in chips)
Seat 2: ulxuJchBV9iguXg0FUonfg ($51.45 in chips)
Seat 3: xZCXQSXlrZkp3pZizzVXCw ($52.70 in chips)
Seat 4: 5k9fvXD9suIgCxU4HLQjTw ($55.20 in chips)
Seat 5: zE9cVigS2nW/Ljy4K4bUQA ($33.95 in chips)
Seat 6: SKnJuWHScqetA/qG5p+wCg ($32.75 in chips)
Seat 7: M+7+BTmX5vZatHVuoRB1nA ($52.75 in chips)
Seat 8: 1MJUKc3cc0QmUoz1JZLR2w ($58.25 in chips)
Seat 9: 4WLZvqBn5qv5tds5kt5A1Q ($43 in chips)
zE9cVigS2nW/Ljy4K4bUQA: posts small blind $0.25
SKnJuWHScqetA/qG5p+wCg: posts big blind $0.50
*** HOLE CARDS ***
M+7+BTmX5vZatHVuoRB1nA: folds
1MJUKc3cc0QmUoz1JZLR2w: folds
4WLZvqBn5qv5tds5kt5A1Q: folds
pFtzb1sR4b0d1aw6aIRgDg: folds
ulxuJchBV9iguXg0FUonfg: folds
xZCXQSXlrZkp3pZizzVXCw: folds
5k9fvXD9suIgCxU4HLQjTw: folds
zE9cVigS2nW/Ljy4K4bUQA: folds
SKnJuWHScqetA/qG5p+wCg collected $0.50 from pot
SKnJuWHScqetA/qG5p+wCg: doesn't show hand
*** SUMMARY ***
Total pot $0.50 | Rake $0
Seat 1: pFtzb1sR4b0d1aw6aIRgDg folded before Flop (didn't bet)
Seat 2: ulxuJchBV9iguXg0FUonfg folded before Flop (didn't bet)
Seat 3: xZCXQSXlrZkp3pZizzVXCw folded before Flop (didn't bet)
Seat 4: 5k9fvXD9suIgCxU4HLQjTw (button) folded before Flop (didn't bet)
Seat 5: zE9cVigS2nW/Ljy4K4bUQA (small blind) folded before Flop
Seat 6: SKnJuWHScqetA/qG5p+wCg (big blind) collected ($0.50)
Seat 7: M+7+BTmX5vZatHVuoRB1nA folded before Flop (didn't bet)
Seat 8: 1MJUKc3cc0QmUoz1JZLR2w folded before Flop (didn't bet)
Seat 9: 4WLZvqBn5qv5tds5kt5A1Q folded before Flop (didn't bet)



PokerStars Game #59940112962:  Hold'em No Limit ($0.25/$0.50) - 2009/07/01 0:57:36 ET
Table 'hWT2kq66tnKEpD26cia6fQ' 2-max Seat #1 is the button
Seat 1: nDAH8M70KzyNYO9u3Jg+JQ ($32 in chips)
Seat 2: 16tvT7AYgZ2LgiGFcvFKQg ($4.15 in chips)
nDAH8M70KzyNYO9u3Jg+JQ: posts small blind $0.25
16tvT7AYgZ2LgiGFcvFKQg: posts big blind $0.50
*** HOLE CARDS ***
nDAH8M70KzyNYO9u3Jg+JQ: calls $0.25
16tvT7AYgZ2LgiGFcvFKQg: checks
*** FLOP *** [Kh 5h 9h]
16tvT7AYgZ2LgiGFcvFKQg: bets $0.50
nDAH8M70KzyNYO9u3Jg+JQ: raises $0.50 to $1
16tvT7AYgZ2LgiGFcvFKQg: calls $0.50
*** TURN *** [Kh 5h 9h] [Kd]
16tvT7AYgZ2LgiGFcvFKQg: checks
nDAH8M70KzyNYO9u3Jg+JQ: bets $1
16tvT7AYgZ2LgiGFcvFKQg: calls $1
*** RIVER *** [Kh 5h 9h Kd] [Td]
16tvT7AYgZ2LgiGFcvFKQg: checks
nDAH8M70KzyNYO9u3Jg+JQ: bets $2
16tvT7AYgZ2LgiGFcvFKQg: calls $1.65 and is all-in
*** SHOW DOWN ***
nDAH8M70KzyNYO9u3Jg+JQ: shows [2s Ts] (two pair, Kings and Tens)
16tvT7AYgZ2LgiGFcvFKQg: shows [9s 7h] (two pair, Kings and Nines)
nDAH8M70KzyNYO9u3Jg+JQ collected $7.90 from pot
*** SUMMARY ***
Total pot $8.30 | Rake $0.40
Board [Kh 5h 9h Kd Td]
Seat 1: nDAH8M70KzyNYO9u3Jg+JQ (button) (small blind) showed [2s Ts] and won ($7.90) with two pair, Kings and Tens
Seat 2: 16tvT7AYgZ2LgiGFcvFKQg (big blind) showed [9s 7h] and lost with two pair, Kings and Nines



PokerStars Game #59940113076:  Hold'em No Limit ($0.25/$0.50) - 2009/07/01 0:57:37 ET
Table 'E7bWJ45aoFXRpyRv2gw+Ig' 2-max Seat #1 is the button
Seat 1: FRkiRasEGlHUeLrEl+k/nA ($69.20 in chips)
Seat 2: 3Wro85I7472vJ4Wkpneo9A ($121.90 in chips)
FRkiRasEGlHUeLrEl+k/nA: posts small blind $0.25
3Wro85I7472vJ4Wkpneo9A: posts big blind $0.50
*** HOLE CARDS ***
FRkiRasEGlHUeLrEl+k/nA: raises $1 to $1.50
3Wro85I7472vJ4Wkpneo9A said, "heh"
3Wro85I7472vJ4Wkpneo9A: folds
FRkiRasEGlHUeLrEl+k/nA collected $1 from pot
*** SUMMARY ***
Total pot $1 | Rake $0
Seat 1: FRkiRasEGlHUeLrEl+k/nA (button) (small blind) collected ($1)
Seat 2: 3Wro85I7472vJ4Wkpneo9A (big blind) folded before Flop



PokerStars Game #59940115968:  Hold'em No Limit ($0.25/$0.50) - 2009/07/01 0:57:41 ET
Table '/cQuAT3ef4t+PGrXiNhGaQ' 9-max Seat #5 is the button
Seat 1: HZkVla4kK2SI42CVrPZ/ig ($15 in chips)
Seat 2: jXGruyaMqirTaTXNOvBdew ($71.95 in chips)
Seat 3: g4k0NXISyLCqaSWZDBjfEg ($55.75 in chips)
Seat 4: OWP/DOu+PlPK6ZZ3zYa0HA ($25.90 in chips)
Seat 5: 5SgaHdWixdClWvaEG+KUjQ ($17.10 in chips)
Seat 6: APYIOyK/4AGb+kIwlOUNBQ ($36.75 in chips)
Seat 7: J0W5D97jl5VLky+IoPvDeA ($111.40 in chips)
Seat 8: eBrej2jnlUCs/JgxFCRn2g ($47.30 in chips)
Seat 9: AjV5McH1KMMclY26QdLM5w ($26.45 in chips)
APYIOyK/4AGb+kIwlOUNBQ: posts small blind $0.25
J0W5D97jl5VLky+IoPvDeA: posts big blind $0.50
*** HOLE CARDS ***
eBrej2jnlUCs/JgxFCRn2g: raises $0.50 to $1
AjV5McH1KMMclY26QdLM5w: folds
HZkVla4kK2SI42CVrPZ/ig: folds
jXGruyaMqirTaTXNOvBdew: folds
g4k0NXISyLCqaSWZDBjfEg: folds
OWP/DOu+PlPK6ZZ3zYa0HA: folds
5SgaHdWixdClWvaEG+KUjQ: calls $1
APYIOyK/4AGb+kIwlOUNBQ: folds
J0W5D97jl5VLky+IoPvDeA: folds
*** FLOP *** [5c 3h 6s]
eBrej2jnlUCs/JgxFCRn2g: checks
5SgaHdWixdClWvaEG+KUjQ: bets $1.50
eBrej2jnlUCs/JgxFCRn2g: calls $1.50
*** TURN *** [5c 3h 6s] [Qc]
eBrej2jnlUCs/JgxFCRn2g: checks
5SgaHdWixdClWvaEG+KUjQ: bets $2.50
eBrej2jnlUCs/JgxFCRn2g: raises $27.50 to $30
5SgaHdWixdClWvaEG+KUjQ: folds
eBrej2jnlUCs/JgxFCRn2g collected $10.25 from pot
*** SUMMARY ***
Total pot $10.75 | Rake $0.50
Board [5c 3h 6s Qc]
Seat 1: HZkVla4kK2SI42CVrPZ/ig folded before Flop (didn't bet)
Seat 2: jXGruyaMqirTaTXNOvBdew folded before Flop (didn't bet)
Seat 3: g4k0NXISyLCqaSWZDBjfEg folded before Flop (didn't bet)
Seat 4: OWP/DOu+PlPK6ZZ3zYa0HA folded before Flop (didn't bet)
Seat 5: 5SgaHdWixdClWvaEG+KUjQ (button) folded on the Turn
Seat 6: APYIOyK/4AGb+kIwlOUNBQ (small blind) folded before Flop
Seat 7: J0W5D97jl5VLky+IoPvDeA (big blind) folded before Flop
Seat 8: eBrej2jnlUCs/JgxFCRn2g collected ($10.25)
Seat 9: AjV5McH1KMMclY26QdLM5w folded before Flop (didn't bet)



PokerStars Game #59940116376:  Hold'em No Limit ($0.25/$0.50) - 2009/07/01 0:57:42 ET
Table 'c/CRn+68J3Y8KxD5g1ek2Q' 2-max Seat #2 is the button
Seat 1: 46qCyJ6evTkHo9al5sBMNA ($85.90 in chips)
Seat 2: BypVLsYQt3ePFm2xQL/dOA ($283.25 in chips)
BypVLsYQt3ePFm2xQL/dOA: posts small blind $0.25
46qCyJ6evTkHo9al5sBMNA: posts big blind $0.50
*** HOLE CARDS ***
BypVLsYQt3ePFm2xQL/dOA: raises $1.50 to $2
46qCyJ6evTkHo9al5sBMNA: raises $5 to $7
BypVLsYQt3ePFm2xQL/dOA: folds
46qCyJ6evTkHo9al5sBMNA collected $4 from pot
46qCyJ6evTkHo9al5sBMNA: doesn't show hand
*** SUMMARY ***
Total pot $4 | Rake $0
Seat 1: 46qCyJ6evTkHo9al5sBMNA (big blind) collected ($4)
Seat 2: BypVLsYQt3ePFm2xQL/dOA (button) (small blind) folded before Flop



PokerStars Game #59940117056:  Hold'em No Limit ($0.25/$0.50) - 2009/07/01 0:57:43 ET
Table '9Puy2HWN1RQe5SSjq162gA' 2-max Seat #2 is the button
Seat 1: Fp/oksNpipCrD2MJ2pH20g ($14.60 in chips)
Seat 2: tDV+zhxH9+3DkJDzoTERyg ($14.50 in chips)
tDV+zhxH9+3DkJDzoTERyg: posts small blind $0.25
Fp/oksNpipCrD2MJ2pH20g: posts big blind $0.50
*** HOLE CARDS ***
tDV+zhxH9+3DkJDzoTERyg: raises $1 to $1.50
Fp/oksNpipCrD2MJ2pH20g: folds
tDV+zhxH9+3DkJDzoTERyg collected $1 from pot
tDV+zhxH9+3DkJDzoTERyg: doesn't show hand
*** SUMMARY ***
Total pot $1 | Rake $0
Seat 1: Fp/oksNpipCrD2MJ2pH20g (big blind) folded before Flop
Seat 2: tDV+zhxH9+3DkJDzoTERyg (button) (small blind) collected ($1)



PokerStars Game #59940118510:  Hold'em No Limit ($0.25/$0.50) - 2009/07/01 0:57:46 ET
Table '+dXkOAQyS8j9PQZusUTMpg' 2-max Seat #1 is the button
Seat 1: XFa6sBGjP2gxoIvxR3fZIg ($64.35 in chips)
Seat 2: 5IBeOgaApY1Bvzv2P8X4EA ($135.25 in chips)
XFa6sBGjP2gxoIvxR3fZIg: posts small blind $0.25
5IBeOgaApY1Bvzv2P8X4EA: posts big blind $0.50
*** HOLE CARDS ***
XFa6sBGjP2gxoIvxR3fZIg: raises $1 to $1.50
5IBeOgaApY1Bvzv2P8X4EA: calls $1
*** FLOP *** [Jc 8d Jd]
5IBeOgaApY1Bvzv2P8X4EA: checks
XFa6sBGjP2gxoIvxR3fZIg: checks
*** TURN *** [Jc 8d Jd] [5h]
5IBeOgaApY1Bvzv2P8X4EA: checks
XFa6sBGjP2gxoIvxR3fZIg: checks
*** RIVER *** [Jc 8d Jd 5h] [8c]
5IBeOgaApY1Bvzv2P8X4EA: checks
XFa6sBGjP2gxoIvxR3fZIg: bets $1.50
5IBeOgaApY1Bvzv2P8X4EA: calls $1.50
*** SHOW DOWN ***
XFa6sBGjP2gxoIvxR3fZIg: shows [6d 3h] (two pair, Jacks and Eights)
5IBeOgaApY1Bvzv2P8X4EA: shows [6h Ac] (two pair, Jacks and Eights - Ace kicker)
5IBeOgaApY1Bvzv2P8X4EA collected $5.75 from pot
*** SUMMARY ***
Total pot $6 | Rake $0.25
Board [Jc 8d Jd 5h 8c]
Seat 1: XFa6sBGjP2gxoIvxR3fZIg (button) (small blind) showed [6d 3h] and lost with two pair, Jacks and Eights
Seat 2: 5IBeOgaApY1Bvzv2P8X4EA (big blind) showed [6h Ac] and won ($5.75) with two pair, Jacks and Eights



PokerStars Game #59940119666:  Hold'em No Limit ($0.25/$0.50) - 2009/07/01 0:57:47 ET
Table 'lpxYasB1ClBSgTpCCITwhQ' 9-max Seat #7 is the button
Seat 1: mj7PS7wCH4PAl7+eYTFs7A ($46.40 in chips)
Seat 2: OWP/DOu+PlPK6ZZ3zYa0HA ($21.60 in chips)
Seat 4: NnQCepdIR/AOUQn1yhYx6Q ($9.25 in chips)
Seat 5: IYd5zG8k7vdBNVHbHg2Pag ($36.35 in chips)
Seat 6: SegjDnMxWMujiD57ESNL+g ($12.10 in chips)
Seat 7: bmRtaIYKthN1F+B3JLZ3Jw ($67.30 in chips)
Seat 8: /mfensKw8/iZ1Vrx33S4xg ($10 in chips)
Seat 9: XNMDwbXt/Q4jM99AXnbJDw ($50 in chips)
/mfensKw8/iZ1Vrx33S4xg: posts small blind $0.25
XNMDwbXt/Q4jM99AXnbJDw: posts big blind $0.50
caleb505: sits out
*** HOLE CARDS ***
mj7PS7wCH4PAl7+eYTFs7A: folds
OWP/DOu+PlPK6ZZ3zYa0HA: raises $1 to $1.50
NnQCepdIR/AOUQn1yhYx6Q: folds
IYd5zG8k7vdBNVHbHg2Pag: folds
SegjDnMxWMujiD57ESNL+g: folds
bmRtaIYKthN1F+B3JLZ3Jw: folds
/mfensKw8/iZ1Vrx33S4xg: calls $1.25
XNMDwbXt/Q4jM99AXnbJDw: folds
*** FLOP *** [2h 7c 4c]
/mfensKw8/iZ1Vrx33S4xg: checks
OWP/DOu+PlPK6ZZ3zYa0HA: checks
*** TURN *** [2h 7c 4c] [9s]
/mfensKw8/iZ1Vrx33S4xg: bets $3.50
OWP/DOu+PlPK6ZZ3zYa0HA: folds
/mfensKw8/iZ1Vrx33S4xg collected $3.35 from pot
/mfensKw8/iZ1Vrx33S4xg: doesn't show hand
*** SUMMARY ***
Total pot $3.50 | Rake $0.15
Board [2h 7c 4c 9s]
Seat 1: mj7PS7wCH4PAl7+eYTFs7A folded before Flop (didn't bet)
Seat 2: OWP/DOu+PlPK6ZZ3zYa0HA folded on the Turn
Seat 4: NnQCepdIR/AOUQn1yhYx6Q folded before Flop (didn't bet)
Seat 5: IYd5zG8k7vdBNVHbHg2Pag folded before Flop (didn't bet)
Seat 6: SegjDnMxWMujiD57ESNL+g folded before Flop (didn't bet)
Seat 7: bmRtaIYKthN1F+B3JLZ3Jw (button) folded before Flop (didn't bet)
Seat 8: /mfensKw8/iZ1Vrx33S4xg (small blind) collected ($3.35)
Seat 9: XNMDwbXt/Q4jM99AXnbJDw (big blind) folded before Flop



PokerStars Game #59940120798:  Hold'em No Limit ($0.25/$0.50) - 2009/07/01 0:57:49 ET
Table 'E7bWJ45aoFXRpyRv2gw+Ig' 2-max Seat #2 is the button
Seat 1: FRkiRasEGlHUeLrEl+k/nA ($69.70 in chips)
Seat 2: 3Wro85I7472vJ4Wkpneo9A ($121.40 in chips)
3Wro85I7472vJ4Wkpneo9A: posts small blind $0.25
FRkiRasEGlHUeLrEl+k/nA: posts big blind $0.50
*** HOLE CARDS ***
3Wro85I7472vJ4Wkpneo9A: raises $1 to $1.50
FRkiRasEGlHUeLrEl+k/nA: raises $1.50 to $3
3Wro85I7472vJ4Wkpneo9A: calls $1.50
*** FLOP *** [5h Td 8s]
FRkiRasEGlHUeLrEl+k/nA said, "i suck out for 6 bux you suck out for 90"
FRkiRasEGlHUeLrEl+k/nA said, "****"
FRkiRasEGlHUeLrEl+k/nA: checks
3Wro85I7472vJ4Wkpneo9A: checks
*** TURN *** [5h Td 8s] [2c]
FRkiRasEGlHUeLrEl+k/nA: checks
3Wro85I7472vJ4Wkpneo9A: checks
*** RIVER *** [5h Td 8s 2c] [Js]
FRkiRasEGlHUeLrEl+k/nA: checks
3Wro85I7472vJ4Wkpneo9A: bets $3.50
FRkiRasEGlHUeLrEl+k/nA: folds
3Wro85I7472vJ4Wkpneo9A collected $5.70 from pot
3Wro85I7472vJ4Wkpneo9A: doesn't show hand
*** SUMMARY ***
Total pot $6 | Rake $0.30
Board [5h Td 8s 2c Js]
Seat 1: FRkiRasEGlHUeLrEl+k/nA (big blind) folded on the River
Seat 2: 3Wro85I7472vJ4Wkpneo9A (button) (small blind) collected ($5.70)



PokerStars Game #59940122168:  Hold'em No Limit ($0.25/$0.50) - 2009/07/01 0:57:52 ET
Table '9Puy2HWN1RQe5SSjq162gA' 2-max Seat #1 is the button
Seat 1: Fp/oksNpipCrD2MJ2pH20g ($14.10 in chips)
Seat 2: tDV+zhxH9+3DkJDzoTERyg ($15 in chips)
Fp/oksNpipCrD2MJ2pH20g: posts small blind $0.25
tDV+zhxH9+3DkJDzoTERyg: posts big blind $0.50
*** HOLE CARDS ***
Fp/oksNpipCrD2MJ2pH20g: raises $1 to $1.50
tDV+zhxH9+3DkJDzoTERyg: calls $1
*** FLOP *** [3s 7d Kh]
tDV+zhxH9+3DkJDzoTERyg: checks
Fp/oksNpipCrD2MJ2pH20g: bets $1
tDV+zhxH9+3DkJDzoTERyg: raises $1 to $2
Fp/oksNpipCrD2MJ2pH20g: calls $1
*** TURN *** [3s 7d Kh] [3h]
tDV+zhxH9+3DkJDzoTERyg: bets $3.50
Fp/oksNpipCrD2MJ2pH20g: folds
tDV+zhxH9+3DkJDzoTERyg collected $6.70 from pot
*** SUMMARY ***
Total pot $7 | Rake $0.30
Board [3s 7d Kh 3h]
Seat 1: Fp/oksNpipCrD2MJ2pH20g (button) (small blind) folded on the Turn
Seat 2: tDV+zhxH9+3DkJDzoTERyg (big blind) collected ($6.70)



PokerStars Game #59940122178:  Hold'em No Limit ($0.25/$0.50) - 2009/07/01 0:57:52 ET
Table 'BCN5su+SsXiy1zRMJi0SJw' 6-max Seat #5 is the button
Seat 1: GxXV09ciXaOxyY2H5aMIIw ($30.40 in chips)
Seat 2: oU2kDCkT/gilYbHWrg7D8w ($7.35 in chips)
Seat 3: 6wzJiRvp8HY6t+MQGnSIzA ($30.35 in chips)
Seat 4: qfeUHOJpMYyzQcj0o2A7ng ($21.10 in chips)
Seat 5: IBNygaT1aa9Z1uPdJJilwA ($31.35 in chips)
Seat 6: b2symlOdL7+0c9Pj4N/KlA ($80 in chips)
b2symlOdL7+0c9Pj4N/KlA: posts small blind $0.25
GxXV09ciXaOxyY2H5aMIIw: posts big blind $0.50
*** HOLE CARDS ***
oU2kDCkT/gilYbHWrg7D8w: raises $5.50 to $6
6wzJiRvp8HY6t+MQGnSIzA: folds
qfeUHOJpMYyzQcj0o2A7ng: calls $6
IBNygaT1aa9Z1uPdJJilwA: folds
b2symlOdL7+0c9Pj4N/KlA: folds
GxXV09ciXaOxyY2H5aMIIw: folds
*** FLOP *** [8d Ad 2s]
oU2kDCkT/gilYbHWrg7D8w: bets $1.35 and is all-in
qfeUHOJpMYyzQcj0o2A7ng: calls $1.35
*** TURN *** [8d Ad 2s] [Tc]
*** RIVER *** [8d Ad 2s Tc] [7d]
*** SHOW DOWN ***
oU2kDCkT/gilYbHWrg7D8w: shows [6s Ks] (high card Ace)
qfeUHOJpMYyzQcj0o2A7ng: mucks hand
oU2kDCkT/gilYbHWrg7D8w collected $14.75 from pot
*** SUMMARY ***
Total pot $15.45 | Rake $0.70
Board [8d Ad 2s Tc 7d]
Seat 1: GxXV09ciXaOxyY2H5aMIIw (big blind) folded before Flop
Seat 2: oU2kDCkT/gilYbHWrg7D8w showed [6s Ks] and won ($14.75) with high card Ace
Seat 3: 6wzJiRvp8HY6t+MQGnSIzA folded before Flop (didn't bet)
Seat 4: qfeUHOJpMYyzQcj0o2A7ng mucked
Seat 5: IBNygaT1aa9Z1uPdJJilwA (button) folded before Flop (didn't bet)
Seat 6: b2symlOdL7+0c9Pj4N/KlA (small blind) folded before Flop



PokerStars Game #59940122226:  Hold'em No Limit ($0.25/$0.50) - 2009/07/01 0:57:52 ET
Table 'QOgaEqMcJ73pcUMMxoisUg' 6-max Seat #4 is the button
Seat 2: 4QfsCWthT/vSLirorNXqtg ($76.35 in chips)
Seat 3: Rt6KgtZ8YaJoTc3FPim00w ($86.05 in chips)
Seat 4: zAcsDhG/T128Vn7XGVSgKg ($50 in chips)
Seat 5: 6vNxrjjCl6FwfaaymM9jjg ($26.75 in chips)
Seat 6: GoVjFxr3C+JO9vtJH9+IcA ($32.60 in chips)
6vNxrjjCl6FwfaaymM9jjg: posts small blind $0.25
GoVjFxr3C+JO9vtJH9+IcA: posts big blind $0.50
jpritz22: sits out
*** HOLE CARDS ***
4QfsCWthT/vSLirorNXqtg: folds
Rt6KgtZ8YaJoTc3FPim00w: folds
zAcsDhG/T128Vn7XGVSgKg: folds
6vNxrjjCl6FwfaaymM9jjg: calls $0.25
GoVjFxr3C+JO9vtJH9+IcA: checks
*** FLOP *** [Kh 2c 4c]
6vNxrjjCl6FwfaaymM9jjg: checks
GoVjFxr3C+JO9vtJH9+IcA: bets $0.50
6vNxrjjCl6FwfaaymM9jjg: folds
GoVjFxr3C+JO9vtJH9+IcA collected $0.95 from pot
*** SUMMARY ***
Total pot $1 | Rake $0.05
Board [Kh 2c 4c]
Seat 2: 4QfsCWthT/vSLirorNXqtg folded before Flop (didn't bet)
Seat 3: Rt6KgtZ8YaJoTc3FPim00w folded before Flop (didn't bet)
Seat 4: zAcsDhG/T128Vn7XGVSgKg (button) folded before Flop (didn't bet)
Seat 5: 6vNxrjjCl6FwfaaymM9jjg (small blind) folded on the Flop
Seat 6: GoVjFxr3C+JO9vtJH9+IcA (big blind) collected ($0.95)



PokerStars Game #59940123624:  Hold'em No Limit ($0.25/$0.50) - 2009/07/01 0:57:54 ET
Table 'GfL/No5u5PoEnU39lP5pQg' 6-max Seat #1 is the button
Seat 1: 1WUCqNG+p+vfWRTXNu4ljw ($50 in chips)
Seat 2: uVwggSetzp7d+eVgowO3vg ($61 in chips)
Seat 3: eQXFICMuu3hw6XlcmuVNEA ($9.50 in chips)
Seat 4: r6u7MWSXF30/khcTYkrG9Q ($33.45 in chips)
Seat 6: kxPhs4ePFqMy52CInAJ2aw ($56.50 in chips)
uVwggSetzp7d+eVgowO3vg: posts small blind $0.25
eQXFICMuu3hw6XlcmuVNEA: posts big blind $0.50
M1KyQQvVPVuxqTAB8sR/zQ: sits out
*** HOLE CARDS ***
r6u7MWSXF30/khcTYkrG9Q said, "ya I've had an okay day"
r6u7MWSXF30/khcTYkrG9Q: folds
kxPhs4ePFqMy52CInAJ2aw: folds
1WUCqNG+p+vfWRTXNu4ljw: folds
uVwggSetzp7d+eVgowO3vg: calls $0.25
eQXFICMuu3hw6XlcmuVNEA: raises $1 to $1.50
uVwggSetzp7d+eVgowO3vg: calls $1
*** FLOP *** [Qd Jd 6d]
uVwggSetzp7d+eVgowO3vg: checks
eQXFICMuu3hw6XlcmuVNEA: bets $1.50
uVwggSetzp7d+eVgowO3vg: folds
eQXFICMuu3hw6XlcmuVNEA collected $2.85 from pot
*** SUMMARY ***
Total pot $3 | Rake $0.15
Board [Qd Jd 6d]
Seat 1: 1WUCqNG+p+vfWRTXNu4ljw (button) folded before Flop (didn't bet)
Seat 2: uVwggSetzp7d+eVgowO3vg (small blind) folded on the Flop
Seat 3: eQXFICMuu3hw6XlcmuVNEA (big blind) collected ($2.85)
Seat 4: r6u7MWSXF30/khcTYkrG9Q folded before Flop (didn't bet)
Seat 6: kxPhs4ePFqMy52CInAJ2aw folded before Flop (didn't bet)



PokerStars Game #59940123916:  Hold'em No Limit ($0.25/$0.50) - 2009/07/01 0:57:54 ET
Table '37qXEp3oe+er5q4CZip9eQ' 6-max Seat #4 is the button
Seat 1: oqOqoO2AyCZenUghCxMDxw ($53.40 in chips)
Seat 2: LvH4G7n+QSjT6NDaD3cREA ($50 in chips)
Seat 3: Rt6KgtZ8YaJoTc3FPim00w ($104.50 in chips)
Seat 4: XsmE8nXMAAMFJbWaJTmHFw ($37.20 in chips)
Seat 5: VOmI0x4dDPnTESZd5B4d1Q ($46.70 in chips)
Seat 6: N50kln4negd8q7Mmoz1j4g ($16.55 in chips)
VOmI0x4dDPnTESZd5B4d1Q: posts small blind $0.25
N50kln4negd8q7Mmoz1j4g: posts big blind $0.50
*** HOLE CARDS ***
oqOqoO2AyCZenUghCxMDxw: folds
LvH4G7n+QSjT6NDaD3cREA: folds
Rt6KgtZ8YaJoTc3FPim00w: folds
XsmE8nXMAAMFJbWaJTmHFw: raises $1 to $1.50
VOmI0x4dDPnTESZd5B4d1Q: calls $1.25
N50kln4negd8q7Mmoz1j4g: folds
*** FLOP *** [5h Kh 4h]
VOmI0x4dDPnTESZd5B4d1Q: checks
XsmE8nXMAAMFJbWaJTmHFw: bets $1.70
VOmI0x4dDPnTESZd5B4d1Q: calls $1.70
*** TURN *** [5h Kh 4h] [7h]
VOmI0x4dDPnTESZd5B4d1Q: checks
XsmE8nXMAAMFJbWaJTmHFw: bets $2.80
VOmI0x4dDPnTESZd5B4d1Q said, "grr"
VOmI0x4dDPnTESZd5B4d1Q: folds
XsmE8nXMAAMFJbWaJTmHFw collected $6.60 from pot
*** SUMMARY ***
Total pot $6.90 | Rake $0.30
Board [5h Kh 4h 7h]
Seat 1: oqOqoO2AyCZenUghCxMDxw folded before Flop (didn't bet)
Seat 2: LvH4G7n+QSjT6NDaD3cREA folded before Flop (didn't bet)
Seat 3: Rt6KgtZ8YaJoTc3FPim00w folded before Flop (didn't bet)
Seat 4: XsmE8nXMAAMFJbWaJTmHFw (button) collected ($6.60)
Seat 5: VOmI0x4dDPnTESZd5B4d1Q (small blind) folded on the Turn
Seat 6: N50kln4negd8q7Mmoz1j4g (big blind) folded before Flop



PokerStars Game #59940123670:  Hold'em No Limit ($0.25/$0.50) - 2009/07/01 0:57:54 ET
Table '0eJtgVAXVvBgncFdcUpXcQ' 2-max Seat #1 is the button
Seat 1: Ag6DvxX4vbRheqsv2zXKTQ ($34.85 in chips)
Seat 2: KMc4R+K9ao4Ur3rF7NGe6Q ($15.05 in chips)
Ag6DvxX4vbRheqsv2zXKTQ: posts small blind $0.25
KMc4R+K9ao4Ur3rF7NGe6Q: posts big blind $0.50
*** HOLE CARDS ***
Ag6DvxX4vbRheqsv2zXKTQ: calls $0.25
KMc4R+K9ao4Ur3rF7NGe6Q: raises $1.50 to $2
Ag6DvxX4vbRheqsv2zXKTQ: folds
KMc4R+K9ao4Ur3rF7NGe6Q collected $1 from pot
KMc4R+K9ao4Ur3rF7NGe6Q: doesn't show hand
*** SUMMARY ***
Total pot $1 | Rake $0
Seat 1: Ag6DvxX4vbRheqsv2zXKTQ (button) (small blind) folded before Flop
Seat 2: KMc4R+K9ao4Ur3rF7NGe6Q (big blind) collected ($1)



PokerStars Game #59940124482:  Hold'em No Limit ($0.25/$0.50) - 2009/07/01 0:57:55 ET
Table 'Vdlc9wqYcHTUhtdyN7CuJw' 2-max Seat #2 is the button
Seat 1: yBO+mXB6m/rCft2ErwGf/Q ($119.55 in chips)
Seat 2: NZ/5cxwnorKW2SNsWy1+8A ($4.90 in chips)
NZ/5cxwnorKW2SNsWy1+8A: posts small blind $0.25
yBO+mXB6m/rCft2ErwGf/Q: posts big blind $0.50
*** HOLE CARDS ***
NZ/5cxwnorKW2SNsWy1+8A: folds
yBO+mXB6m/rCft2ErwGf/Q collected $0.50 from pot
*** SUMMARY ***
Total pot $0.50 | Rake $0
Seat 1: yBO+mXB6m/rCft2ErwGf/Q (big blind) collected ($0.50)
Seat 2: NZ/5cxwnorKW2SNsWy1+8A (button) (small blind) folded before Flop



PokerStars Game #59940125968:  Hold'em No Limit ($0.25/$0.50) - 2009/07/01 0:57:58 ET
Table 'EiNh8p/wGJ1FP575iMFnqg' 9-max Seat #6 is the button
Seat 1: r3ZqM1Mi0W3y4hOdssE+Sg ($44.85 in chips)
Seat 2: 8ehL7qlZzjgUh2H35iiWLw ($52.60 in chips)
Seat 3: ymLPoEIl7UL3TvZYmnadxQ ($51.80 in chips)
Seat 4: cMzaiXAM/ZAdNaEUu+LqhA ($55.70 in chips)
Seat 5: M+7+BTmX5vZatHVuoRB1nA ($81.45 in chips)
Seat 6: 3UmXLy3GfjC3EkOebduerQ ($64.60 in chips)
Seat 7: 997ViqAtWn1FPjJqcffwcA ($50.25 in chips)
Seat 8: mSD1pginDsyHG5PDfqzphw ($10 in chips)
Seat 9: NnQCepdIR/AOUQn1yhYx6Q ($10.75 in chips)
997ViqAtWn1FPjJqcffwcA: posts small blind $0.25
mSD1pginDsyHG5PDfqzphw: posts big blind $0.50
*** HOLE CARDS ***
NnQCepdIR/AOUQn1yhYx6Q: folds
r3ZqM1Mi0W3y4hOdssE+Sg: folds
8ehL7qlZzjgUh2H35iiWLw: folds
ymLPoEIl7UL3TvZYmnadxQ: raises $0.50 to $1
cMzaiXAM/ZAdNaEUu+LqhA: folds
M+7+BTmX5vZatHVuoRB1nA: folds
3UmXLy3GfjC3EkOebduerQ: folds
997ViqAtWn1FPjJqcffwcA: folds
mSD1pginDsyHG5PDfqzphw: folds
ymLPoEIl7UL3TvZYmnadxQ collected $1.25 from pot
ymLPoEIl7UL3TvZYmnadxQ: doesn't show hand
*** SUMMARY ***
Total pot $1.25 | Rake $0
Seat 1: r3ZqM1Mi0W3y4hOdssE+Sg folded before Flop (didn't bet)
Seat 2: 8ehL7qlZzjgUh2H35iiWLw folded before Flop (didn't bet)
Seat 3: ymLPoEIl7UL3TvZYmnadxQ collected ($1.25)
Seat 4: cMzaiXAM/ZAdNaEUu+LqhA folded before Flop (didn't bet)
Seat 5: M+7+BTmX5vZatHVuoRB1nA folded before Flop (didn't bet)
Seat 6: 3UmXLy3GfjC3EkOebduerQ (button) folded before Flop (didn't bet)
Seat 7: 997ViqAtWn1FPjJqcffwcA (small blind) folded before Flop
Seat 8: mSD1pginDsyHG5PDfqzphw (big blind) folded before Flop
Seat 9: NnQCepdIR/AOUQn1yhYx6Q folded before Flop (didn't bet)



PokerStars Game #59940127016:  Hold'em No Limit ($0.25/$0.50) - 2009/07/01 0:57:59 ET
Table '5EmHi+fnatGQQShcNmzOZQ' 6-max Seat #3 is the button
Seat 1: My8WkRtGx5FW6rJ1I4R3hg ($12.10 in chips)
Seat 3: TjmTe3bhs9dFz5gXX9x7Lw ($26.65 in chips)
Seat 4: 1b+2BbjMN8qhR1WPqdE9VQ ($61.40 in chips)
Seat 5: kxPhs4ePFqMy52CInAJ2aw ($80.55 in chips)
Seat 6: 686aeHikcJlgKkSuIFdcXQ ($131.75 in chips)
1b+2BbjMN8qhR1WPqdE9VQ: posts small blind $0.25
kxPhs4ePFqMy52CInAJ2aw: posts big blind $0.50
wlynch82: sits out
*** HOLE CARDS ***
686aeHikcJlgKkSuIFdcXQ: folds
My8WkRtGx5FW6rJ1I4R3hg: calls $0.50
TjmTe3bhs9dFz5gXX9x7Lw: folds
1b+2BbjMN8qhR1WPqdE9VQ: calls $0.25
kxPhs4ePFqMy52CInAJ2aw: checks
*** FLOP *** [7c 5h 2h]
1b+2BbjMN8qhR1WPqdE9VQ: bets $1
kxPhs4ePFqMy52CInAJ2aw: folds
My8WkRtGx5FW6rJ1I4R3hg: calls $1
*** TURN *** [7c 5h 2h] [6h]
1b+2BbjMN8qhR1WPqdE9VQ: bets $2.50
My8WkRtGx5FW6rJ1I4R3hg: folds
1b+2BbjMN8qhR1WPqdE9VQ collected $3.35 from pot
1b+2BbjMN8qhR1WPqdE9VQ: doesn't show hand
*** SUMMARY ***
Total pot $3.50 | Rake $0.15
Board [7c 5h 2h 6h]
Seat 1: My8WkRtGx5FW6rJ1I4R3hg folded on the Turn
Seat 3: TjmTe3bhs9dFz5gXX9x7Lw (button) folded before Flop (didn't bet)
Seat 4: 1b+2BbjMN8qhR1WPqdE9VQ (small blind) collected ($3.35)
Seat 5: kxPhs4ePFqMy52CInAJ2aw (big blind) folded on the Flop
Seat 6: 686aeHikcJlgKkSuIFdcXQ folded before Flop (didn't bet)



PokerStars Game #59940128298:  Hold'em No Limit ($0.25/$0.50) - 2009/07/01 0:58:01 ET
Table 'Vdlc9wqYcHTUhtdyN7CuJw' 2-max Seat #1 is the button
Seat 1: yBO+mXB6m/rCft2ErwGf/Q ($119.80 in chips)
Seat 2: NZ/5cxwnorKW2SNsWy1+8A ($4.65 in chips)
yBO+mXB6m/rCft2ErwGf/Q: posts small blind $0.25
NZ/5cxwnorKW2SNsWy1+8A: posts big blind $0.50
*** HOLE CARDS ***
yBO+mXB6m/rCft2ErwGf/Q: raises $0.50 to $1
NZ/5cxwnorKW2SNsWy1+8A: folds
yBO+mXB6m/rCft2ErwGf/Q collected $1 from pot
*** SUMMARY ***
Total pot $1 | Rake $0
Seat 1: yBO+mXB6m/rCft2ErwGf/Q (button) (small blind) collected ($1)
Seat 2: NZ/5cxwnorKW2SNsWy1+8A (big blind) folded before Flop



PokerStars Game #59940128386:  Hold'em No Limit ($0.25/$0.50) - 2009/07/01 0:58:02 ET
Table '0eJtgVAXVvBgncFdcUpXcQ' 2-max Seat #2 is the button
Seat 1: Ag6DvxX4vbRheqsv2zXKTQ ($34.35 in chips)
Seat 2: KMc4R+K9ao4Ur3rF7NGe6Q ($15.55 in chips)
KMc4R+K9ao4Ur3rF7NGe6Q: posts small blind $0.25
Ag6DvxX4vbRheqsv2zXKTQ: posts big blind $0.50
*** HOLE CARDS ***
KMc4R+K9ao4Ur3rF7NGe6Q: calls $0.25
Ag6DvxX4vbRheqsv2zXKTQ: checks
*** FLOP *** [Th 8d 9c]
Ag6DvxX4vbRheqsv2zXKTQ: checks
KMc4R+K9ao4Ur3rF7NGe6Q: checks
*** TURN *** [Th 8d 9c] [5s]
Ag6DvxX4vbRheqsv2zXKTQ: bets $1.50
KMc4R+K9ao4Ur3rF7NGe6Q: raises $2 to $3.50
Ag6DvxX4vbRheqsv2zXKTQ: calls $2
*** RIVER *** [Th 8d 9c 5s] [Jc]
Ag6DvxX4vbRheqsv2zXKTQ: checks
KMc4R+K9ao4Ur3rF7NGe6Q: checks
*** SHOW DOWN ***
Ag6DvxX4vbRheqsv2zXKTQ: shows [Js 8h] (two pair, Jacks and Eights)
KMc4R+K9ao4Ur3rF7NGe6Q: shows [7h 6d] (a straight, Seven to Jack)
KMc4R+K9ao4Ur3rF7NGe6Q collected $7.65 from pot
*** SUMMARY ***
Total pot $8 | Rake $0.35
Board [Th 8d 9c 5s Jc]
Seat 1: Ag6DvxX4vbRheqsv2zXKTQ (big blind) showed [Js 8h] and lost with two pair, Jacks and Eights
Seat 2: KMc4R+K9ao4Ur3rF7NGe6Q (button) (small blind) showed [7h 6d] and won ($7.65) with a straight, Seven to Jack



PokerStars Game #59940128384:  Hold'em No Limit ($0.25/$0.50) - 2009/07/01 0:58:02 ET
Table 'c/CRn+68J3Y8KxD5g1ek2Q' 2-max Seat #1 is the button
Seat 1: 46qCyJ6evTkHo9al5sBMNA ($87.90 in chips)
Seat 2: BypVLsYQt3ePFm2xQL/dOA ($281.25 in chips)
46qCyJ6evTkHo9al5sBMNA: posts small blind $0.25
BypVLsYQt3ePFm2xQL/dOA: posts big blind $0.50
*** HOLE CARDS ***
46qCyJ6evTkHo9al5sBMNA: raises $1 to $1.50
BypVLsYQt3ePFm2xQL/dOA: folds
46qCyJ6evTkHo9al5sBMNA collected $1 from pot
46qCyJ6evTkHo9al5sBMNA: doesn't show hand
*** SUMMARY ***
Total pot $1 | Rake $0
Seat 1: 46qCyJ6evTkHo9al5sBMNA (button) (small blind) collected ($1)
Seat 2: BypVLsYQt3ePFm2xQL/dOA (big blind) folded before Flop



PokerStars Game #59940129400:  Hold'em No Limit ($0.25/$0.50) - 2009/07/01 0:58:03 ET
Table 'NCiXr0d5CEKBQr/cZgLhbA' 9-max Seat #5 is the button
Seat 1: pFtzb1sR4b0d1aw6aIRgDg ($50 in chips)
Seat 2: ulxuJchBV9iguXg0FUonfg ($51.45 in chips)
Seat 3: xZCXQSXlrZkp3pZizzVXCw ($52.70 in chips)
Seat 4: 5k9fvXD9suIgCxU4HLQjTw ($55.20 in chips)
Seat 5: zE9cVigS2nW/Ljy4K4bUQA ($33.70 in chips)
Seat 6: SKnJuWHScqetA/qG5p+wCg ($33 in chips)
Seat 7: M+7+BTmX5vZatHVuoRB1nA ($52.75 in chips)
Seat 8: 1MJUKc3cc0QmUoz1JZLR2w ($58.25 in chips)
Seat 9: 4WLZvqBn5qv5tds5kt5A1Q ($43 in chips)
SKnJuWHScqetA/qG5p+wCg: posts small blind $0.25
M+7+BTmX5vZatHVuoRB1nA: posts big blind $0.50
*** HOLE CARDS ***
1MJUKc3cc0QmUoz1JZLR2w: raises $1.50 to $2
4WLZvqBn5qv5tds5kt5A1Q: calls $2
pFtzb1sR4b0d1aw6aIRgDg: folds
ulxuJchBV9iguXg0FUonfg: folds
xZCXQSXlrZkp3pZizzVXCw: folds
5k9fvXD9suIgCxU4HLQjTw: folds
zE9cVigS2nW/Ljy4K4bUQA: calls $2
SKnJuWHScqetA/qG5p+wCg: folds
M+7+BTmX5vZatHVuoRB1nA: folds
*** FLOP *** [Ac Kh Jc]
1MJUKc3cc0QmUoz1JZLR2w: bets $1.50
4WLZvqBn5qv5tds5kt5A1Q: calls $1.50
zE9cVigS2nW/Ljy4K4bUQA: folds
*** TURN *** [Ac Kh Jc] [Th]
1MJUKc3cc0QmUoz1JZLR2w: bets $10
4WLZvqBn5qv5tds5kt5A1Q: folds
1MJUKc3cc0QmUoz1JZLR2w collected $9.30 from pot
*** SUMMARY ***
Total pot $9.75 | Rake $0.45
Board [Ac Kh Jc Th]
Seat 1: pFtzb1sR4b0d1aw6aIRgDg folded before Flop (didn't bet)
Seat 2: ulxuJchBV9iguXg0FUonfg folded before Flop (didn't bet)
Seat 3: xZCXQSXlrZkp3pZizzVXCw folded before Flop (didn't bet)
Seat 4: 5k9fvXD9suIgCxU4HLQjTw folded before Flop (didn't bet)
Seat 5: zE9cVigS2nW/Ljy4K4bUQA (button) folded on the Flop
Seat 6: SKnJuWHScqetA/qG5p+wCg (small blind) folded before Flop
Seat 7: M+7+BTmX5vZatHVuoRB1nA (big blind) folded before Flop
Seat 8: 1MJUKc3cc0QmUoz1JZLR2w collected ($9.30)
Seat 9: 4WLZvqBn5qv5tds5kt5A1Q folded on the Turn



PokerStars Game #59940130034:  Hold'em No Limit ($0.25/$0.50) - 2009/07/01 0:58:04 ET
Table '8BQGgNetI1NOvWeu3gtMNw' 2-max Seat #2 is the button
Seat 1: bypIyrYcAAifLfhZpGlKLA ($50 in chips)
Seat 2: Z4HwehErEwzsv/noQlfUlg ($148 in chips)
Z4HwehErEwzsv/noQlfUlg: posts small blind $0.25
bypIyrYcAAifLfhZpGlKLA: posts big blind $0.50
*** HOLE CARDS ***
Z4HwehErEwzsv/noQlfUlg: calls $0.25
bypIyrYcAAifLfhZpGlKLA: raises $2 to $2.50
Z4HwehErEwzsv/noQlfUlg: folds
bypIyrYcAAifLfhZpGlKLA collected $1 from pot
bypIyrYcAAifLfhZpGlKLA: doesn't show hand
*** SUMMARY ***
Total pot $1 | Rake $0
Seat 1: bypIyrYcAAifLfhZpGlKLA (big blind) collected ($1)
Seat 2: Z4HwehErEwzsv/noQlfUlg (button) (small blind) folded before Flop



PokerStars Game #59940129918:  Hold'em No Limit ($0.25/$0.50) - 2009/07/01 0:58:04 ET
Table 'MJxeZCzYELxiIsyUZyT0jw' 6-max Seat #5 is the button
Seat 1: +Pf9jTVizYlIo+woPvptfA ($50 in chips)
Seat 2: t3GiVMzqA9Svgr5Uol32cQ ($35.10 in chips)
Seat 3: JQZew0FjzS19kTjeNtrE+A ($64.60 in chips)
Seat 4: alGiiQP/wwtYnfuXII+sgw ($47.85 in chips)
Seat 5: 3jvoOXNtXE90w2BdfNZwZQ ($50.50 in chips)
Seat 6: c0n4hrn20AML9qzyFC2E8Q ($49.50 in chips)
c0n4hrn20AML9qzyFC2E8Q: posts small blind $0.25
+Pf9jTVizYlIo+woPvptfA: posts big blind $0.50
*** HOLE CARDS ***
t3GiVMzqA9Svgr5Uol32cQ: folds
JQZew0FjzS19kTjeNtrE+A: folds
alGiiQP/wwtYnfuXII+sgw: raises $1 to $1.50
3jvoOXNtXE90w2BdfNZwZQ: calls $1.50
c0n4hrn20AML9qzyFC2E8Q: calls $1.25
+Pf9jTVizYlIo+woPvptfA: folds
*** FLOP *** [Jc 6h Ad]
c0n4hrn20AML9qzyFC2E8Q: checks
alGiiQP/wwtYnfuXII+sgw: bets $2
3jvoOXNtXE90w2BdfNZwZQ: calls $2
c0n4hrn20AML9qzyFC2E8Q: folds
*** TURN *** [Jc 6h Ad] [Ks]
alGiiQP/wwtYnfuXII+sgw: bets $5
3jvoOXNtXE90w2BdfNZwZQ: calls $5
*** RIVER *** [Jc 6h Ad Ks] [4s]
alGiiQP/wwtYnfuXII+sgw: checks
3jvoOXNtXE90w2BdfNZwZQ: bets $14
alGiiQP/wwtYnfuXII+sgw: folds
3jvoOXNtXE90w2BdfNZwZQ collected $18.10 from pot
3jvoOXNtXE90w2BdfNZwZQ: doesn't show hand
*** SUMMARY ***
Total pot $19 | Rake $0.90
Board [Jc 6h Ad Ks 4s]
Seat 1: +Pf9jTVizYlIo+woPvptfA (big blind) folded before Flop
Seat 2: t3GiVMzqA9Svgr5Uol32cQ folded before Flop (didn't bet)
Seat 3: JQZew0FjzS19kTjeNtrE+A folded before Flop (didn't bet)
Seat 4: alGiiQP/wwtYnfuXII+sgw folded on the River
Seat 5: 3jvoOXNtXE90w2BdfNZwZQ (button) collected ($18.10)
Seat 6: c0n4hrn20AML9qzyFC2E8Q (small blind) folded on the Flop



PokerStars Game #59940130782:  Hold'em No Limit ($0.25/$0.50) - 2009/07/01 0:58:05 ET
Table 'kgbJRsxfv64KrErDRBAkcw' 6-max Seat #5 is the button
Seat 1: w2dj3tZyWCX7+wEKRi0AVw ($22.75 in chips)
Seat 2: AdS8BJMOheS01zjCDfPMFg ($49 in chips)
Seat 3: c4MNIaIyPMOMxrgT8FT5nA ($110 in chips)
Seat 4: qanMEqjABjWxC/JgQ/0l7w ($57.25 in chips)
Seat 5: eUBBn2R56C1IQ6Cs/vitwg ($56 in chips)
Seat 6: 1b+2BbjMN8qhR1WPqdE9VQ ($52.90 in chips)
1b+2BbjMN8qhR1WPqdE9VQ: posts small blind $0.25
w2dj3tZyWCX7+wEKRi0AVw: posts big blind $0.50
*** HOLE CARDS ***
AdS8BJMOheS01zjCDfPMFg: folds
w2dj3tZyWCX7+wEKRi0AVw said, "jj"
c4MNIaIyPMOMxrgT8FT5nA: folds
qanMEqjABjWxC/JgQ/0l7w: folds
eUBBn2R56C1IQ6Cs/vitwg: folds
1b+2BbjMN8qhR1WPqdE9VQ: folds
w2dj3tZyWCX7+wEKRi0AVw collected $0.50 from pot
*** SUMMARY ***
Total pot $0.50 | Rake $0
Seat 1: w2dj3tZyWCX7+wEKRi0AVw (big blind) collected ($0.50)
Seat 2: AdS8BJMOheS01zjCDfPMFg folded before Flop (didn't bet)
Seat 3: c4MNIaIyPMOMxrgT8FT5nA folded before Flop (didn't bet)
Seat 4: qanMEqjABjWxC/JgQ/0l7w folded before Flop (didn't bet)
Seat 5: eUBBn2R56C1IQ6Cs/vitwg (button) folded before Flop (didn't bet)
Seat 6: 1b+2BbjMN8qhR1WPqdE9VQ (small blind) folded before Flop



PokerStars Game #59940131304:  Hold'em No Limit ($0.25/$0.50) - 2009/07/01 0:58:06 ET
Table 'lSisgp6H7Fg1hH5VfjEjYQ' 9-max Seat #3 is the button
Seat 1: 5k9fvXD9suIgCxU4HLQjTw ($50 in chips)
Seat 2: UrcnkQOiLVk8BlKDPJSy7Q ($76.60 in chips)
Seat 3: aTkyjTh3w5YLWiIERupZOA ($51.20 in chips)
Seat 4: bwv/rbH/hHhPhY6u9mu04w ($31.10 in chips)
Seat 5: mSD1pginDsyHG5PDfqzphw ($10 in chips)
Seat 6: +k7T5ocke8UwavtgUHm+Cg ($67.05 in chips)
Seat 7: IDtNLR9uFCDdjNsJWMHA5Q ($19.85 in chips)
Seat 8: a4JDWmpFQkL10XfAyuF51A ($29 in chips)
Seat 9: gsyXT42WLEcOS4DdEk2wlw ($42.05 in chips)
bwv/rbH/hHhPhY6u9mu04w: posts small blind $0.25
mSD1pginDsyHG5PDfqzphw: posts big blind $0.50
*** HOLE CARDS ***
+k7T5ocke8UwavtgUHm+Cg: folds
IDtNLR9uFCDdjNsJWMHA5Q: folds
a4JDWmpFQkL10XfAyuF51A: folds
gsyXT42WLEcOS4DdEk2wlw: folds
5k9fvXD9suIgCxU4HLQjTw: folds
UrcnkQOiLVk8BlKDPJSy7Q: folds
aTkyjTh3w5YLWiIERupZOA: folds
bwv/rbH/hHhPhY6u9mu04w: raises $0.50 to $1
mSD1pginDsyHG5PDfqzphw: folds
bwv/rbH/hHhPhY6u9mu04w collected $1 from pot
*** SUMMARY ***
Total pot $1 | Rake $0
Seat 1: 5k9fvXD9suIgCxU4HLQjTw folded before Flop (didn't bet)
Seat 2: UrcnkQOiLVk8BlKDPJSy7Q folded before Flop (didn't bet)
Seat 3: aTkyjTh3w5YLWiIERupZOA (button) folded before Flop (didn't bet)
Seat 4: bwv/rbH/hHhPhY6u9mu04w (small blind) collected ($1)
Seat 5: mSD1pginDsyHG5PDfqzphw (big blind) folded before Flop
Seat 6: +k7T5ocke8UwavtgUHm+Cg folded before Flop (didn't bet)
Seat 7: IDtNLR9uFCDdjNsJWMHA5Q folded before Flop (didn't bet)
Seat 8: a4JDWmpFQkL10XfAyuF51A folded before Flop (didn't bet)
Seat 9: gsyXT42WLEcOS4DdEk2wlw folded before Flop (didn't bet)



PokerStars Game #59940132426:  Hold'em No Limit ($0.25/$0.50) - 2009/07/01 0:58:08 ET
Table 'Nz0Vr7WMHL2g5Uk7dDZjpw' 9-max Seat #4 is the button
Seat 1: tLkxo7JgV+WWI0UBw44K5A ($109.10 in chips)
Seat 2: XNMDwbXt/Q4jM99AXnbJDw ($58.60 in chips)
Seat 3: uw9QayAAxLM3Hb+HR7mSkg ($10 in chips)
Seat 4: E2518gp4aFz1+kAgmGqeEg ($11.50 in chips)
Seat 5: WGW0DgjBUXs1ylURHG8vnQ ($27 in chips)
Seat 6: 997ViqAtWn1FPjJqcffwcA ($61.30 in chips)
Seat 7: KPLH0gELgFe2OuAnhJFI5w ($17.85 in chips)
Seat 8: HkZI6g4zl83TDTA7SRspmQ ($15.95 in chips)
Seat 9: mSD1pginDsyHG5PDfqzphw ($10 in chips)
WGW0DgjBUXs1ylURHG8vnQ: posts small blind $0.25
997ViqAtWn1FPjJqcffwcA: posts big blind $0.50
*** HOLE CARDS ***
KPLH0gELgFe2OuAnhJFI5w: folds
HkZI6g4zl83TDTA7SRspmQ: folds
mSD1pginDsyHG5PDfqzphw: folds
tLkxo7JgV+WWI0UBw44K5A: raises $1 to $1.50
XNMDwbXt/Q4jM99AXnbJDw: folds
uw9QayAAxLM3Hb+HR7mSkg: folds
E2518gp4aFz1+kAgmGqeEg: folds
WGW0DgjBUXs1ylURHG8vnQ: folds
997ViqAtWn1FPjJqcffwcA: folds
tLkxo7JgV+WWI0UBw44K5A collected $1.25 from pot
*** SUMMARY ***
Total pot $1.25 | Rake $0
Seat 1: tLkxo7JgV+WWI0UBw44K5A collected ($1.25)
Seat 2: XNMDwbXt/Q4jM99AXnbJDw folded before Flop (didn't bet)
Seat 3: uw9QayAAxLM3Hb+HR7mSkg folded before Flop (didn't bet)
Seat 4: E2518gp4aFz1+kAgmGqeEg (button) folded before Flop (didn't bet)
Seat 5: WGW0DgjBUXs1ylURHG8vnQ (small blind) folded before Flop
Seat 6: 997ViqAtWn1FPjJqcffwcA (big blind) folded before Flop
Seat 7: KPLH0gELgFe2OuAnhJFI5w folded before Flop (didn't bet)
Seat 8: HkZI6g4zl83TDTA7SRspmQ folded before Flop (didn't bet)
Seat 9: mSD1pginDsyHG5PDfqzphw folded before Flop (didn't bet)



PokerStars Game #59940132628:  Hold'em No Limit ($0.25/$0.50) - 2009/07/01 0:58:08 ET
Table '+dXkOAQyS8j9PQZusUTMpg' 2-max Seat #2 is the button
Seat 1: XFa6sBGjP2gxoIvxR3fZIg ($61.35 in chips)
Seat 2: 5IBeOgaApY1Bvzv2P8X4EA ($138 in chips)
5IBeOgaApY1Bvzv2P8X4EA: posts small blind $0.25
XFa6sBGjP2gxoIvxR3fZIg: posts big blind $0.50
*** HOLE CARDS ***
5IBeOgaApY1Bvzv2P8X4EA: folds
XFa6sBGjP2gxoIvxR3fZIg collected $0.50 from pot
*** SUMMARY ***
Total pot $0.50 | Rake $0
Seat 1: XFa6sBGjP2gxoIvxR3fZIg (big blind) collected ($0.50)
Seat 2: 5IBeOgaApY1Bvzv2P8X4EA (button) (small blind) folded before Flop



PokerStars Game #59940133796:  Hold'em No Limit ($0.25/$0.50) - 2009/07/01 0:58:10 ET
Table 'otvGDROEDdqsabxskT79qg' 9-max Seat #8 is the button
Seat 1: 8ehL7qlZzjgUh2H35iiWLw ($57.50 in chips)
Seat 2: cCjTzH9jio8607WzjcfXlg ($14.30 in chips)
Seat 3: +k7T5ocke8UwavtgUHm+Cg ($67.20 in chips)
Seat 4: MG90wfSJZnOejs/KD3vlQQ ($73.20 in chips)
Seat 5: XNMDwbXt/Q4jM99AXnbJDw ($51.15 in chips)
Seat 6: bxLSulbgr8LmKNjOzw8URg ($53.70 in chips)
Seat 7: C7+tBppJrKgd/r+tuKUIpA ($32.05 in chips)
Seat 8: zE9cVigS2nW/Ljy4K4bUQA ($30 in chips)
Seat 9: KcY3X8YpD74Kw1RHkx/g4A ($57.40 in chips)
KcY3X8YpD74Kw1RHkx/g4A: posts small blind $0.25
8ehL7qlZzjgUh2H35iiWLw: posts big blind $0.50
*** HOLE CARDS ***
cCjTzH9jio8607WzjcfXlg: folds
+k7T5ocke8UwavtgUHm+Cg: folds
MG90wfSJZnOejs/KD3vlQQ: raises $1 to $1.50
XNMDwbXt/Q4jM99AXnbJDw: folds
bxLSulbgr8LmKNjOzw8URg: folds
C7+tBppJrKgd/r+tuKUIpA: folds
zE9cVigS2nW/Ljy4K4bUQA: folds
KcY3X8YpD74Kw1RHkx/g4A: folds
8ehL7qlZzjgUh2H35iiWLw: folds
MG90wfSJZnOejs/KD3vlQQ collected $1.25 from pot
MG90wfSJZnOejs/KD3vlQQ: doesn't show hand
*** SUMMARY ***
Total pot $1.25 | Rake $0
Seat 1: 8ehL7qlZzjgUh2H35iiWLw (big blind) folded before Flop
Seat 2: cCjTzH9jio8607WzjcfXlg folded before Flop (didn't bet)
Seat 3: +k7T5ocke8UwavtgUHm+Cg folded before Flop (didn't bet)
Seat 4: MG90wfSJZnOejs/KD3vlQQ collected ($1.25)
Seat 5: XNMDwbXt/Q4jM99AXnbJDw folded before Flop (didn't bet)
Seat 6: bxLSulbgr8LmKNjOzw8URg folded before Flop (didn't bet)
Seat 7: C7+tBppJrKgd/r+tuKUIpA folded before Flop (didn't bet)
Seat 8: zE9cVigS2nW/Ljy4K4bUQA (button) folded before Flop (didn't bet)
Seat 9: KcY3X8YpD74Kw1RHkx/g4A (small blind) folded before Flop



PokerStars Game #59940134000:  Hold'em No Limit ($0.25/$0.50) - 2009/07/01 0:58:11 ET
Table 'c/CRn+68J3Y8KxD5g1ek2Q' 2-max Seat #2 is the button
Seat 1: 46qCyJ6evTkHo9al5sBMNA ($88.40 in chips)
Seat 2: BypVLsYQt3ePFm2xQL/dOA ($280.75 in chips)
BypVLsYQt3ePFm2xQL/dOA: posts small blind $0.25
46qCyJ6evTkHo9al5sBMNA: posts big blind $0.50
*** HOLE CARDS ***
BypVLsYQt3ePFm2xQL/dOA: calls $0.25
46qCyJ6evTkHo9al5sBMNA: checks
*** FLOP *** [9d 5c Qd]
46qCyJ6evTkHo9al5sBMNA: bets $2
BypVLsYQt3ePFm2xQL/dOA: calls $2
*** TURN *** [9d 5c Qd] [9c]
46qCyJ6evTkHo9al5sBMNA: bets $3
BypVLsYQt3ePFm2xQL/dOA: folds
46qCyJ6evTkHo9al5sBMNA collected $4.80 from pot
46qCyJ6evTkHo9al5sBMNA: doesn't show hand
*** SUMMARY ***
Total pot $5 | Rake $0.20
Board [9d 5c Qd 9c]
Seat 1: 46qCyJ6evTkHo9al5sBMNA (big blind) collected ($4.80)
Seat 2: BypVLsYQt3ePFm2xQL/dOA (button) (small blind) folded on the Turn



PokerStars Game #59940135020:  Hold'em No Limit ($0.25/$0.50) - 2009/07/01 0:58:12 ET
Table 'Vdlc9wqYcHTUhtdyN7CuJw' 2-max Seat #2 is the button
Seat 1: yBO+mXB6m/rCft2ErwGf/Q ($120.30 in chips)
Seat 2: NZ/5cxwnorKW2SNsWy1+8A ($4.15 in chips)
NZ/5cxwnorKW2SNsWy1+8A: posts small blind $0.25
yBO+mXB6m/rCft2ErwGf/Q: posts big blind $0.50
*** HOLE CARDS ***
NZ/5cxwnorKW2SNsWy1+8A: folds
yBO+mXB6m/rCft2ErwGf/Q collected $0.50 from pot
*** SUMMARY ***
Total pot $0.50 | Rake $0
Seat 1: yBO+mXB6m/rCft2ErwGf/Q (big blind) collected ($0.50)
Seat 2: NZ/5cxwnorKW2SNsWy1+8A (button) (small blind) folded before Flop



PokerStars Game #59940135440:  Hold'em No Limit ($0.25/$0.50) - 2009/07/01 0:58:13 ET
Table 'BCN5su+SsXiy1zRMJi0SJw' 6-max Seat #6 is the button
Seat 1: GxXV09ciXaOxyY2H5aMIIw ($29.90 in chips)
Seat 2: oU2kDCkT/gilYbHWrg7D8w ($14.75 in chips)
Seat 3: 6wzJiRvp8HY6t+MQGnSIzA ($30.35 in chips)
Seat 4: qfeUHOJpMYyzQcj0o2A7ng ($13.75 in chips)
Seat 5: IBNygaT1aa9Z1uPdJJilwA ($31.35 in chips)
Seat 6: b2symlOdL7+0c9Pj4N/KlA ($79.75 in chips)
GxXV09ciXaOxyY2H5aMIIw: posts small blind $0.25
oU2kDCkT/gilYbHWrg7D8w: posts big blind $0.50
*** HOLE CARDS ***
6wzJiRvp8HY6t+MQGnSIzA: folds
qfeUHOJpMYyzQcj0o2A7ng: calls $0.50
IBNygaT1aa9Z1uPdJJilwA: folds
b2symlOdL7+0c9Pj4N/KlA: raises $2 to $2.50
GxXV09ciXaOxyY2H5aMIIw: folds
oU2kDCkT/gilYbHWrg7D8w: calls $2
qfeUHOJpMYyzQcj0o2A7ng: calls $2
*** FLOP *** [2d 6d 3s]
oU2kDCkT/gilYbHWrg7D8w: bets $12.25 and is all-in
qfeUHOJpMYyzQcj0o2A7ng: folds
b2symlOdL7+0c9Pj4N/KlA: calls $12.25
*** TURN *** [2d 6d 3s] [Jh]
*** RIVER *** [2d 6d 3s Jh] [9c]
*** SHOW DOWN ***
oU2kDCkT/gilYbHWrg7D8w: shows [8h 8c] (a pair of Eights)
b2symlOdL7+0c9Pj4N/KlA: mucks hand
oU2kDCkT/gilYbHWrg7D8w collected $30.70 from pot
*** SUMMARY ***
Total pot $32.25 | Rake $1.55
Board [2d 6d 3s Jh 9c]
Seat 1: GxXV09ciXaOxyY2H5aMIIw (small blind) folded before Flop
Seat 2: oU2kDCkT/gilYbHWrg7D8w (big blind) showed [8h 8c] and won ($30.70) with a pair of Eights
Seat 3: 6wzJiRvp8HY6t+MQGnSIzA folded before Flop (didn't bet)
Seat 4: qfeUHOJpMYyzQcj0o2A7ng folded on the Flop
Seat 5: IBNygaT1aa9Z1uPdJJilwA folded before Flop (didn't bet)
Seat 6: b2symlOdL7+0c9Pj4N/KlA (button) mucked



PokerStars Game #59940136334:  Hold'em No Limit ($0.25/$0.50) - 2009/07/01 0:58:14 ET
Table '+dXkOAQyS8j9PQZusUTMpg' 2-max Seat #1 is the button
Seat 1: XFa6sBGjP2gxoIvxR3fZIg ($61.60 in chips)
Seat 2: 5IBeOgaApY1Bvzv2P8X4EA ($137.75 in chips)
XFa6sBGjP2gxoIvxR3fZIg: posts small blind $0.25
5IBeOgaApY1Bvzv2P8X4EA: posts big blind $0.50
*** HOLE CARDS ***
XFa6sBGjP2gxoIvxR3fZIg: raises $1 to $1.50
5IBeOgaApY1Bvzv2P8X4EA: folds
XFa6sBGjP2gxoIvxR3fZIg collected $1 from pot
XFa6sBGjP2gxoIvxR3fZIg: doesn't show hand
*** SUMMARY ***
Total pot $1 | Rake $0
Seat 1: XFa6sBGjP2gxoIvxR3fZIg (button) (small blind) collected ($1)
Seat 2: 5IBeOgaApY1Bvzv2P8X4EA (big blind) folded before Flop



PokerStars Game #59940138578:  Hold'em No Limit ($0.25/$0.50) - 2009/07/01 0:58:18 ET
Table '9Puy2HWN1RQe5SSjq162gA' 2-max Seat #2 is the button
Seat 1: Fp/oksNpipCrD2MJ2pH20g ($10.60 in chips)
Seat 2: tDV+zhxH9+3DkJDzoTERyg ($18.20 in chips)
tDV+zhxH9+3DkJDzoTERyg: posts small blind $0.25
Fp/oksNpipCrD2MJ2pH20g: posts big blind $0.50
*** HOLE CARDS ***
tDV+zhxH9+3DkJDzoTERyg: raises $1 to $1.50
Fp/oksNpipCrD2MJ2pH20g: calls $1
*** FLOP *** [7d 2c 9s]
Fp/oksNpipCrD2MJ2pH20g: checks
tDV+zhxH9+3DkJDzoTERyg: bets $1.50
Fp/oksNpipCrD2MJ2pH20g: raises $7.60 to $9.10 and is all-in
tDV+zhxH9+3DkJDzoTERyg: calls $7.60
*** TURN *** [7d 2c 9s] [Js]
*** RIVER *** [7d 2c 9s Js] [Ad]
*** SHOW DOWN ***
Fp/oksNpipCrD2MJ2pH20g: shows [Jc 9h] (two pair, Jacks and Nines)
tDV+zhxH9+3DkJDzoTERyg: shows [As 9d] (two pair, Aces and Nines)
tDV+zhxH9+3DkJDzoTERyg said, "GG"
tDV+zhxH9+3DkJDzoTERyg collected $20.70 from pot
*** SUMMARY ***
Total pot $21.20 | Rake $0.50
Board [7d 2c 9s Js Ad]
Seat 1: Fp/oksNpipCrD2MJ2pH20g (big blind) showed [Jc 9h] and lost with two pair, Jacks and Nines
Seat 2: tDV+zhxH9+3DkJDzoTERyg (button) (small blind) showed [As 9d] and won ($20.70) with two pair, Aces and Nines



PokerStars Game #59940139298:  Hold'em No Limit ($0.25/$0.50) - 2009/07/01 0:58:19 ET
Table '0eJtgVAXVvBgncFdcUpXcQ' 2-max Seat #1 is the button
Seat 1: Ag6DvxX4vbRheqsv2zXKTQ ($30.35 in chips)
Seat 2: KMc4R+K9ao4Ur3rF7NGe6Q ($19.20 in chips)
Ag6DvxX4vbRheqsv2zXKTQ: posts small blind $0.25
KMc4R+K9ao4Ur3rF7NGe6Q: posts big blind $0.50
*** HOLE CARDS ***
Ag6DvxX4vbRheqsv2zXKTQ said, "wow.."
Ag6DvxX4vbRheqsv2zXKTQ: folds
KMc4R+K9ao4Ur3rF7NGe6Q collected $0.50 from pot
KMc4R+K9ao4Ur3rF7NGe6Q said, "yeh"
*** SUMMARY ***
Total pot $0.50 | Rake $0
Seat 1: Ag6DvxX4vbRheqsv2zXKTQ (button) (small blind) folded before Flop
Seat 2: KMc4R+K9ao4Ur3rF7NGe6Q (big blind) collected ($0.50)



PokerStars Game #59940140000:  Hold'em No Limit ($0.25/$0.50) - 2009/07/01 0:58:20 ET
Table '8BQGgNetI1NOvWeu3gtMNw' 2-max Seat #1 is the button
Seat 1: bypIyrYcAAifLfhZpGlKLA ($50.50 in chips)
Seat 2: Z4HwehErEwzsv/noQlfUlg ($147.50 in chips)
bypIyrYcAAifLfhZpGlKLA: posts small blind $0.25
Z4HwehErEwzsv/noQlfUlg: posts big blind $0.50
*** HOLE CARDS ***
bypIyrYcAAifLfhZpGlKLA: raises $1 to $1.50
Z4HwehErEwzsv/noQlfUlg: raises $1 to $2.50
bypIyrYcAAifLfhZpGlKLA: calls $1
*** FLOP *** [8s 4c Th]
Z4HwehErEwzsv/noQlfUlg: checks
bypIyrYcAAifLfhZpGlKLA: checks
*** TURN *** [8s 4c Th] [Js]
Z4HwehErEwzsv/noQlfUlg: bets $4
bypIyrYcAAifLfhZpGlKLA: folds
Z4HwehErEwzsv/noQlfUlg collected $4.75 from pot
Z4HwehErEwzsv/noQlfUlg: doesn't show hand
*** SUMMARY ***
Total pot $5 | Rake $0.25
Board [8s 4c Th Js]
Seat 1: bypIyrYcAAifLfhZpGlKLA (button) (small blind) folded on the Turn
Seat 2: Z4HwehErEwzsv/noQlfUlg (big blind) collected ($4.75)



PokerStars Game #59940141680:  Hold'em No Limit ($0.25/$0.50) - 2009/07/01 0:58:23 ET
Table '+dXkOAQyS8j9PQZusUTMpg' 2-max Seat #2 is the button
Seat 1: XFa6sBGjP2gxoIvxR3fZIg ($62.10 in chips)
Seat 2: 5IBeOgaApY1Bvzv2P8X4EA ($137.25 in chips)
5IBeOgaApY1Bvzv2P8X4EA: posts small blind $0.25
XFa6sBGjP2gxoIvxR3fZIg: posts big blind $0.50
*** HOLE CARDS ***
5IBeOgaApY1Bvzv2P8X4EA: calls $0.25
XFa6sBGjP2gxoIvxR3fZIg: checks
*** FLOP *** [8d 8s Qc]
XFa6sBGjP2gxoIvxR3fZIg: checks
5IBeOgaApY1Bvzv2P8X4EA: checks
*** TURN *** [8d 8s Qc] [Jd]
XFa6sBGjP2gxoIvxR3fZIg: checks
5IBeOgaApY1Bvzv2P8X4EA: checks
*** RIVER *** [8d 8s Qc Jd] [5h]
XFa6sBGjP2gxoIvxR3fZIg: checks
5IBeOgaApY1Bvzv2P8X4EA: bets $0.50
XFa6sBGjP2gxoIvxR3fZIg: folds
5IBeOgaApY1Bvzv2P8X4EA collected $0.95 from pot
5IBeOgaApY1Bvzv2P8X4EA: doesn't show hand
*** SUMMARY ***
Total pot $1 | Rake $0.05
Board [8d 8s Qc Jd 5h]
Seat 1: XFa6sBGjP2gxoIvxR3fZIg (big blind) folded on the River
Seat 2: 5IBeOgaApY1Bvzv2P8X4EA (button) (small blind) collected ($0.95)



PokerStars Game #59940142120:  Hold'em No Limit ($0.25/$0.50) - 2009/07/01 0:58:24 ET
Table '+z1aekfHkpp09pc8F9aViw' 6-max Seat #2 is the button
Seat 1: FHilMb2i2DbUCc9lplszog ($39.55 in chips)
Seat 2: M6xK/VklCvdyyrmvzATlxQ ($33.75 in chips)
Seat 3: uUznlIMFnRUvwrBhYF73KA ($139.40 in chips)
Seat 4: RowCSpSURHTOL/dcjg/Iug ($40.30 in chips)
Seat 5: rplyldNweS6YyMNEALQrug ($14.50 in chips)
Seat 6: 686aeHikcJlgKkSuIFdcXQ ($51.85 in chips)
uUznlIMFnRUvwrBhYF73KA: posts small blind $0.25
RowCSpSURHTOL/dcjg/Iug: posts big blind $0.50
*** HOLE CARDS ***
rplyldNweS6YyMNEALQrug: raises $2.50 to $3
686aeHikcJlgKkSuIFdcXQ: calls $3
FHilMb2i2DbUCc9lplszog: calls $3
M6xK/VklCvdyyrmvzATlxQ: folds
uUznlIMFnRUvwrBhYF73KA: calls $2.75
RowCSpSURHTOL/dcjg/Iug: folds
*** FLOP *** [Qc 3d 8d]
uUznlIMFnRUvwrBhYF73KA: bets $2
rplyldNweS6YyMNEALQrug: raises $3 to $5
686aeHikcJlgKkSuIFdcXQ: calls $5
FHilMb2i2DbUCc9lplszog: folds
uUznlIMFnRUvwrBhYF73KA: calls $3
*** TURN *** [Qc 3d 8d] [Ks]
uUznlIMFnRUvwrBhYF73KA: checks
rplyldNweS6YyMNEALQrug: bets $6.50 and is all-in
686aeHikcJlgKkSuIFdcXQ: folds
uUznlIMFnRUvwrBhYF73KA: calls $6.50
*** RIVER *** [Qc 3d 8d Ks] [Th]
*** SHOW DOWN ***
uUznlIMFnRUvwrBhYF73KA: shows [Ah 3h] (a pair of Threes)
rplyldNweS6YyMNEALQrug: shows [Qs Ad] (a pair of Queens)
rplyldNweS6YyMNEALQrug collected $38.55 from pot
*** SUMMARY ***
Total pot $40.50 | Rake $1.95
Board [Qc 3d 8d Ks Th]
Seat 1: FHilMb2i2DbUCc9lplszog folded on the Flop
Seat 2: M6xK/VklCvdyyrmvzATlxQ (button) folded before Flop (didn't bet)
Seat 3: uUznlIMFnRUvwrBhYF73KA (small blind) showed [Ah 3h] and lost with a pair of Threes
Seat 4: RowCSpSURHTOL/dcjg/Iug (big blind) folded before Flop
Seat 5: rplyldNweS6YyMNEALQrug showed [Qs Ad] and won ($38.55) with a pair of Queens
Seat 6: 686aeHikcJlgKkSuIFdcXQ folded on the Turn



PokerStars Game #59940142436:  Hold'em No Limit ($0.25/$0.50) - 2009/07/01 0:58:25 ET
Table 'kgbJRsxfv64KrErDRBAkcw' 6-max Seat #6 is the button
Seat 1: w2dj3tZyWCX7+wEKRi0AVw ($23 in chips)
Seat 2: AdS8BJMOheS01zjCDfPMFg ($49 in chips)
Seat 3: c4MNIaIyPMOMxrgT8FT5nA ($110 in chips)
Seat 4: qanMEqjABjWxC/JgQ/0l7w ($57.25 in chips)
Seat 5: eUBBn2R56C1IQ6Cs/vitwg ($56 in chips)
Seat 6: 1b+2BbjMN8qhR1WPqdE9VQ ($52.65 in chips)
w2dj3tZyWCX7+wEKRi0AVw: posts small blind $0.25
AdS8BJMOheS01zjCDfPMFg: posts big blind $0.50
*** HOLE CARDS ***
eUBBn2R56C1IQ6Cs/vitwg said, "AJ baby"
c4MNIaIyPMOMxrgT8FT5nA: raises $1.50 to $2
qanMEqjABjWxC/JgQ/0l7w: folds
eUBBn2R56C1IQ6Cs/vitwg: folds
1b+2BbjMN8qhR1WPqdE9VQ: folds
w2dj3tZyWCX7+wEKRi0AVw: calls $1.75
AdS8BJMOheS01zjCDfPMFg: folds
*** FLOP *** [Qh Js 6h]
w2dj3tZyWCX7+wEKRi0AVw: checks
c4MNIaIyPMOMxrgT8FT5nA: bets $4.50
w2dj3tZyWCX7+wEKRi0AVw: raises $5.50 to $10
c4MNIaIyPMOMxrgT8FT5nA: calls $5.50
*** TURN *** [Qh Js 6h] [4c]
w2dj3tZyWCX7+wEKRi0AVw: bets $11 and is all-in
c4MNIaIyPMOMxrgT8FT5nA: calls $11
*** RIVER *** [Qh Js 6h 4c] [Ts]
*** SHOW DOWN ***
w2dj3tZyWCX7+wEKRi0AVw: shows [Kc Jc] (a pair of Jacks)
c4MNIaIyPMOMxrgT8FT5nA: shows [Jh Tc] (two pair, Jacks and Tens)
c4MNIaIyPMOMxrgT8FT5nA collected $44.25 from pot
*** SUMMARY ***
Total pot $46.50 | Rake $2.25
Board [Qh Js 6h 4c Ts]
Seat 1: w2dj3tZyWCX7+wEKRi0AVw (small blind) showed [Kc Jc] and lost with a pair of Jacks
Seat 2: AdS8BJMOheS01zjCDfPMFg (big blind) folded before Flop
Seat 3: c4MNIaIyPMOMxrgT8FT5nA showed [Jh Tc] and won ($44.25) with two pair, Jacks and Tens
Seat 4: qanMEqjABjWxC/JgQ/0l7w folded before Flop (didn't bet)
Seat 5: eUBBn2R56C1IQ6Cs/vitwg folded before Flop (didn't bet)
Seat 6: 1b+2BbjMN8qhR1WPqdE9VQ (button) folded before Flop (didn't bet)



PokerStars Game #59940142716:  Hold'em No Limit ($0.25/$0.50) - 2009/07/01 0:58:25 ET
Table '0eJtgVAXVvBgncFdcUpXcQ' 2-max Seat #2 is the button
Seat 1: Ag6DvxX4vbRheqsv2zXKTQ ($30.10 in chips)
Seat 2: KMc4R+K9ao4Ur3rF7NGe6Q ($19.45 in chips)
KMc4R+K9ao4Ur3rF7NGe6Q: posts small blind $0.25
Ag6DvxX4vbRheqsv2zXKTQ: posts big blind $0.50
*** HOLE CARDS ***
KMc4R+K9ao4Ur3rF7NGe6Q: folds
Ag6DvxX4vbRheqsv2zXKTQ collected $0.50 from pot
*** SUMMARY ***
Total pot $0.50 | Rake $0
Seat 1: Ag6DvxX4vbRheqsv2zXKTQ (big blind) collected ($0.50)
Seat 2: KMc4R+K9ao4Ur3rF7NGe6Q (button) (small blind) folded before Flop



PokerStars Game #59940143370:  Hold'em No Limit ($0.25/$0.50) - 2009/07/01 0:58:26 ET
Table '99gCy/CZQwPIjZWH+BguQgE7bWJ45aoFXRpyRv2gw+Igeat #2 is the button
Seat 2: n6VQBu6crjYjy6DxNP1NZA ($28 in chips)
Seat 3: qEn9ijNGtuyTxamBf07hYg ($50 in chips)
Seat 4: bxLSulbgr8LmKNjOzw8URg ($62.95 in chips)
Seat 5: DSM67hHHq1XFoEOi9p8Alw ($50 in chips)
Seat 6: OcnLOMVFdy23jXnoTyaO5Q ($260.25 in chips)
Seat 7: bfSq6LBw0UvxeM5yfuWC7w ($17.85 in chips)
Seat 8: 8ehL7qlZzjgUh2H35iiWLw ($51.75 in chips)
Seat 9: j3K/Jujr7PY4ZM2RZvlH6A ($83.45 in chips)
qEn9ijNGtuyTxamBf07hYg: posts small blind $0.25
bxLSulbgr8LmKNjOzw8URg: posts big blind $0.50
*** HOLE CARDS ***
DSM67hHHq1XFoEOi9p8Alw: folds
OcnLOMVFdy23jXnoTyaO5Q: calls $0.50
bfSq6LBw0UvxeM5yfuWC7w: folds
8ehL7qlZzjgUh2H35iiWLw: folds
j3K/Jujr7PY4ZM2RZvlH6A: raises $2 to $2.50
n6VQBu6crjYjy6DxNP1NZA: folds
qEn9ijNGtuyTxamBf07hYg: folds
bxLSulbgr8LmKNjOzw8URg: folds
OcnLOMVFdy23jXnoTyaO5Q: raises $3.50 to $6
j3K/Jujr7PY4ZM2RZvlH6A: calls $3.50
*** FLOP *** [Qs Jd 3c]
OcnLOMVFdy23jXnoTyaO5Q: bets $8
j3K/Jujr7PY4ZM2RZvlH6A: folds
OcnLOMVFdy23jXnoTyaO5Q collected $12.15 from pot
OcnLOMVFdy23jXnoTyaO5Q: doesn't show hand
*** SUMMARY ***
Total pot $12.75 | Rake $0.60
Board [Qs Jd 3c]
Seat 2: n6VQBu6crjYjy6DxNP1NZA (button) folded before Flop (didn't bet)
Seat 3: qEn9ijNGtuyTxamBf07hYg (small blind) folded before Flop
Seat 4: bxLSulbgr8LmKNjOzw8URg (big blind) folded before Flop
Seat 5: DSM67hHHq1XFoEOi9p8Alw folded before Flop (didn't bet)
Seat 6: OcnLOMVFdy23jXnoTyaO5Q collected ($12.15)
Seat 7: bfSq6LBw0UvxeM5yfuWC7w folded before Flop (didn't bet)
Seat 8: 8ehL7qlZzjgUh2H35iiWLw folded before Flop (didn't bet)
Seat 9: j3K/Jujr7PY4ZM2RZvlH6A folded on the Flop



PokerStars Game #59940143056:  Hold'em No Limit ($0.25/$0.50) - 2009/07/01 0:58:26 ET
Table 'lSisgp6H7Fg1hH5VfjEjYQ' 9-max Seat #4 is the button
Seat 1: 5k9fvXD9suIgCxU4HLQjTw ($50 in chips)
Seat 2: UrcnkQOiLVk8BlKDPJSy7Q ($76.60 in chips)
Seat 3: aTkyjTh3w5YLWiIERupZOA ($51.20 in chips)
Seat 4: bwv/rbH/hHhPhY6u9mu04w ($31.60 in chips)
Seat 5: mSD1pginDsyHG5PDfqzphw ($10 in chips)
Seat 6: +k7T5ocke8UwavtgUHm+Cg ($67.05 in chips)
Seat 7: IDtNLR9uFCDdjNsJWMHA5Q ($19.85 in chips)
Seat 8: a4JDWmpFQkL10XfAyuF51A ($29 in chips)
Seat 9: gsyXT42WLEcOS4DdEk2wlw ($42.05 in chips)
mSD1pginDsyHG5PDfqzphw: posts small blind $0.25
+k7T5ocke8UwavtgUHm+Cg: posts big blind $0.50
*** HOLE CARDS ***
IDtNLR9uFCDdjNsJWMHA5Q: folds
a4JDWmpFQkL10XfAyuF51A: folds
gsyXT42WLEcOS4DdEk2wlw: folds
5k9fvXD9suIgCxU4HLQjTw: folds
UrcnkQOiLVk8BlKDPJSy7Q: folds
aTkyjTh3w5YLWiIERupZOA: raises $1 to $1.50
bwv/rbH/hHhPhY6u9mu04w: folds
mSD1pginDsyHG5PDfqzphw: folds
+k7T5ocke8UwavtgUHm+Cg: folds
aTkyjTh3w5YLWiIERupZOA collected $1.25 from pot
aTkyjTh3w5YLWiIERupZOA: doesn't show hand
*** SUMMARY ***
Total pot $1.25 | Rake $0
Seat 1: 5k9fvXD9suIgCxU4HLQjTw folded before Flop (didn't bet)
Seat 2: UrcnkQOiLVk8BlKDPJSy7Q folded before Flop (didn't bet)
Seat 3: aTkyjTh3w5YLWiIERupZOA collected ($1.25)
Seat 4: bwv/rbH/hHhPhY6u9mu04w (button) folded before Flop (didn't bet)
Seat 5: mSD1pginDsyHG5PDfqzphw (small blind) folded before Flop
Seat 6: +k7T5ocke8UwavtgUHm+Cg (big blind) folded before Flop
Seat 7: IDtNLR9uFCDdjNsJWMHA5Q folded before Flop (didn't bet)
Seat 8: a4JDWmpFQkL10XfAyuF51A folded before Flop (didn't bet)
Seat 9: gsyXT42WLEcOS4DdEk2wlw folded before Flop (didn't bet)



PokerStars Game #59940143368:  Hold'em No Limit ($0.25/$0.50) - 2009/07/01 0:58:26 ET
Table 'fx6MqwfYAj/Rt86hBz2L3Q' 9-max Seat #2 is the button
Seat 1: SegjDnMxWMujiD57ESNL+g ($10 in chips)
Seat 2: C3rGXblctNcWI6JYPHhaEg ($28.60 in chips)
Seat 3: iadBi5AEt7gTBXbDSSnMYQ ($81 in chips)
Seat 4: 75K2MXwN65Sjfp1yHd50Hg ($10 in chips)
Seat 5: iAISe3dVeua8PUn2wwgDHw ($20.75 in chips)
Seat 6: 5k9fvXD9suIgCxU4HLQjTw ($50 in chips)
Seat 7: SKnJuWHScqetA/qG5p+wCg ($30 in chips)
Seat 8: JYwJYYV9pM5KWdSiETl8rA ($24 in chips)
Seat 9: HZkVla4kK2SI42CVrPZ/ig ($10.25 in chips)
iadBi5AEt7gTBXbDSSnMYQ: posts small blind $0.25
75K2MXwN65Sjfp1yHd50Hg: posts big blind $0.50
*** HOLE CARDS ***
iAISe3dVeua8PUn2wwgDHw: raises $0.50 to $1
5k9fvXD9suIgCxU4HLQjTw: folds
SKnJuWHScqetA/qG5p+wCg: folds
JYwJYYV9pM5KWdSiETl8rA: folds
HZkVla4kK2SI42CVrPZ/ig: folds
SegjDnMxWMujiD57ESNL+g: raises $2.50 to $3.50
C3rGXblctNcWI6JYPHhaEg: folds
iadBi5AEt7gTBXbDSSnMYQ: folds
75K2MXwN65Sjfp1yHd50Hg: folds
iAISe3dVeua8PUn2wwgDHw: raises $2.50 to $6
SegjDnMxWMujiD57ESNL+g: raises $2.50 to $8.50
iAISe3dVeua8PUn2wwgDHw: raises $2.50 to $11
SegjDnMxWMujiD57ESNL+g: calls $1.50 and is all-in
*** FLOP *** [3s 5s 2s]
*** TURN *** [3s 5s 2s] [5d]
*** RIVER *** [3s 5s 2s 5d] [4d]
*** SHOW DOWN ***
iAISe3dVeua8PUn2wwgDHw: shows [Ah 7h] (a straight, Ace to Five)
SegjDnMxWMujiD57ESNL+g: mucks hand
iAISe3dVeua8PUn2wwgDHw collected $19.75 from pot
*** SUMMARY ***
Total pot $20.75 | Rake $1
Board [3s 5s 2s 5d 4d]
Seat 1: SegjDnMxWMujiD57ESNL+g mucked
Seat 2: C3rGXblctNcWI6JYPHhaEg (button) folded before Flop (didn't bet)
Seat 3: iadBi5AEt7gTBXbDSSnMYQ (small blind) folded before Flop
Seat 4: 75K2MXwN65Sjfp1yHd50Hg (big blind) folded before Flop
Seat 5: iAISe3dVeua8PUn2wwgDHw showed [Ah 7h] and won ($19.75) with a straight, Ace to Five
Seat 6: 5k9fvXD9suIgCxU4HLQjTw folded before Flop (didn't bet)
Seat 7: SKnJuWHScqetA/qG5p+wCg folded before Flop (didn't bet)
Seat 8: JYwJYYV9pM5KWdSiETl8rA folded before Flop (didn't bet)
Seat 9: HZkVla4kK2SI42CVrPZ/ig folded before Flop (didn't bet)



PokerStars Game #59940144374:  Hold'em No Limit ($0.25/$0.50) - 2009/07/01 0:58:28 ET
Table 'hWT2kq66tnKEpD26cia6fQ' 2-max Seat #2 is the button
Seat 1: nDAH8M70KzyNYO9u3Jg+JQ ($35.75 in chips)
Seat 2: 16tvT7AYgZ2LgiGFcvFKQg ($10 in chips)
16tvT7AYgZ2LgiGFcvFKQg: posts small blind $0.25
nDAH8M70KzyNYO9u3Jg+JQ: posts big blind $0.50
*** HOLE CARDS ***
16tvT7AYgZ2LgiGFcvFKQg: calls $0.25
nDAH8M70KzyNYO9u3Jg+JQ: raises $1.50 to $2
16tvT7AYgZ2LgiGFcvFKQg: calls $1.50
*** FLOP *** [Jc Jd Th]
nDAH8M70KzyNYO9u3Jg+JQ: checks
16tvT7AYgZ2LgiGFcvFKQg: checks
*** TURN *** [Jc Jd Th] [4d]
nDAH8M70KzyNYO9u3Jg+JQ: checks
16tvT7AYgZ2LgiGFcvFKQg: checks
*** RIVER *** [Jc Jd Th 4d] [2d]
nDAH8M70KzyNYO9u3Jg+JQ: checks
16tvT7AYgZ2LgiGFcvFKQg: bets $2.50
nDAH8M70KzyNYO9u3Jg+JQ: calls $2.50
*** SHOW DOWN ***
16tvT7AYgZ2LgiGFcvFKQg: shows [Qh 7d] (a pair of Jacks)
nDAH8M70KzyNYO9u3Jg+JQ: shows [Ah 9d] (a pair of Jacks - Ace kicker)
nDAH8M70KzyNYO9u3Jg+JQ collected $8.60 from pot
*** SUMMARY ***
Total pot $9 | Rake $0.40
Board [Jc Jd Th 4d 2d]
Seat 1: nDAH8M70KzyNYO9u3Jg+JQ (big blind) showed [Ah 9d] and won ($8.60) with a pair of Jacks
Seat 2: 16tvT7AYgZ2LgiGFcvFKQg (button) (small blind) showed [Qh 7d] and lost with a pair of Jacks



PokerStars Game #59940145590:  Hold'em No Limit ($0.25/$0.50) - 2009/07/01 0:58:30 ET
Table 'GfL/No5u5PoEnU39lP5pQg' 6-max Seat #2 is the button
Seat 1: 1WUCqNG+p+vfWRTXNu4ljw ($50 in chips)
Seat 2: uVwggSetzp7d+eVgowO3vg ($59.50 in chips)
Seat 3: eQXFICMuu3hw6XlcmuVNEA ($10.85 in chips)
Seat 4: r6u7MWSXF30/khcTYkrG9Q ($33.45 in chips)
Seat 6: kxPhs4ePFqMy52CInAJ2aw ($56.50 in chips)
eQXFICMuu3hw6XlcmuVNEA: posts small blind $0.25
r6u7MWSXF30/khcTYkrG9Q: posts big blind $0.50
M1KyQQvVPVuxqTAB8sR/zQ: sits out
*** HOLE CARDS ***
kxPhs4ePFqMy52CInAJ2aw: folds
1WUCqNG+p+vfWRTXNu4ljw: folds
uVwggSetzp7d+eVgowO3vg: folds
eQXFICMuu3hw6XlcmuVNEA: calls $0.25
r6u7MWSXF30/khcTYkrG9Q: checks
*** FLOP *** [Js 3c Kc]
eQXFICMuu3hw6XlcmuVNEA: bets $1
r6u7MWSXF30/khcTYkrG9Q: calls $1
*** TURN *** [Js 3c Kc] [Tc]
eQXFICMuu3hw6XlcmuVNEA: checks
r6u7MWSXF30/khcTYkrG9Q: bets $2
eQXFICMuu3hw6XlcmuVNEA: calls $2
*** RIVER *** [Js 3c Kc Tc] [3d]
eQXFICMuu3hw6XlcmuVNEA: checks
r6u7MWSXF30/khcTYkrG9Q: checks
*** SHOW DOWN ***
eQXFICMuu3hw6XlcmuVNEA: shows [5s Kh] (two pair, Kings and Threes)
r6u7MWSXF30/khcTYkrG9Q: mucks hand
eQXFICMuu3hw6XlcmuVNEA collected $6.70 from pot
*** SUMMARY ***
Total pot $7 | Rake $0.30
Board [Js 3c Kc Tc 3d]
Seat 1: 1WUCqNG+p+vfWRTXNu4ljw folded before Flop (didn't bet)
Seat 2: uVwggSetzp7d+eVgowO3vg (button) folded before Flop (didn't bet)
Seat 3: eQXFICMuu3hw6XlcmuVNEA (small blind) showed [5s Kh] and won ($6.70) with two pair, Kings and Threes
Seat 4: r6u7MWSXF30/khcTYkrG9Q (big blind) mucked
Seat 6: kxPhs4ePFqMy52CInAJ2aw folded before Flop (didn't bet)



PokerStars Game #59940146310:  Hold'em No Limit ($0.25/$0.50) - 2009/07/01 0:58:31 ET
Table '0eJtgVAXVvBgncFdcUpXcQ' 2-max Seat #1 is the button
Seat 1: Ag6DvxX4vbRheqsv2zXKTQ ($30.35 in chips)
Seat 2: KMc4R+K9ao4Ur3rF7NGe6Q ($19.20 in chips)
Ag6DvxX4vbRheqsv2zXKTQ: posts small blind $0.25
KMc4R+K9ao4Ur3rF7NGe6Q: posts big blind $0.50
*** HOLE CARDS ***
Ag6DvxX4vbRheqsv2zXKTQ: calls $0.25
KMc4R+K9ao4Ur3rF7NGe6Q: checks
*** FLOP *** [Ac 7h Qd]
KMc4R+K9ao4Ur3rF7NGe6Q: checks
Ag6DvxX4vbRheqsv2zXKTQ: bets $1
KMc4R+K9ao4Ur3rF7NGe6Q: folds
Ag6DvxX4vbRheqsv2zXKTQ collected $0.95 from pot
*** SUMMARY ***
Total pot $1 | Rake $0.05
Board [Ac 7h Qd]
Seat 1: Ag6DvxX4vbRheqsv2zXKTQ (button) (small blind) collected ($0.95)
Seat 2: KMc4R+K9ao4Ur3rF7NGe6Q (big blind) folded on the Flop



